rank,tier,name,mmr,points,wins,losses,played,winrate,age
1,1,Memestermind,6685,934,20,3,23,87.0%,20m
2,1,[N0SCAM]NoWCSForU,6673,668,15,0,15,100.0%,38m
3,1,PartinG,6643,3381,107,19,126,84.9%,2m
4,1,lIlIlIlIlIlI,6635,1056,37,7,44,84.1%,9m
5,1,Hana,6604,1839,229,65,294,77.9%,10m
6,1,[Cl0wn]PartinG,6562,192,5,3,8,62.5%,38m
7,1,[Ex0n]Nina,6464,3928,967,318,1285,75.3%,2m
8,1,Creator,6452,48,2,1,3,66.7%,5m
9,1,[αX]Astrea,6422,144,4,2,6,66.7%,16m
10,1,[ROOT]DisK,6357,1007,29,4,33,87.9%,19m
11,1,[TeamGP]Prince,6353,1229,32,12,44,72.7%,2m
12,1,llllllllllll,6201,1371,58,23,81,71.6%,19m
12,1,Terotex,6201,0,1,0,1,100.0%,9m
14,1,[KGH]eXaScaLe,6189,2835,124,26,150,82.7%,2m
15,1,[cScNA]SKillous,6182,670,14,4,18,77.8%,14m
16,1,llllllllllll,6174,121,2,1,3,66.7%,2m
17,1,[xGenGx]PiLiPiLi,6172,3736,598,246,844,70.9%,2m
18,1,[RYE1]PtitDrogo,6158,814,18,7,25,72.0%,23m
19,1,goblin,6151,576,12,8,20,60.0%,14m
20,1,Krystianer,6140,0,1,0,1,100.0%,32m
21,1,[aXMage]cheesyToss,6113,717,64,35,99,64.6%,23m
22,1,insaneLikeMe,6107,476,11,1,12,91.7%,5m
23,1,[L0ne1y]PattyMac,6085,3592,147,70,217,67.7%,2m
24,1,[αX]Nice,6075,48,2,0,2,100.0%,32m
25,1,Grisgris,6074,144,3,4,7,42.9%,8m
26,1,[αX]Asuna,6067,0,1,1,2,50.0%,14m
27,1,[AoBDE]BossToss,6060,622,14,8,22,63.6%,37m
28,1,[AoBDE]jackson,6052,1468,32,11,43,74.4%,23m
29,1,EterNaL,6016,1406,32,11,43,74.4%,12m
30,1,TalentToss,6000,432,10,6,16,62.5%,18m
31,1,IIIIIIIIIIII,5989,101,1,11,12,8.3%,18m
32,1,ShihYat,5987,521,21,10,31,67.7%,18m
33,1,CantStopMe,5961,192,5,1,6,83.3%,32m
34,1,LiquidMaNa,5944,0,0,1,1,0.0%,9m
35,1,[Ex0n]Adonminus,5915,1529,111,21,132,84.1%,38m
36,1,[Pnamed]Slickback,5910,270,9,3,12,75.0%,9m
37,1,PatrickMac,5906,1598,35,22,57,61.4%,14m
38,1,Webster,5903,3220,135,59,194,69.6%,2m
39,1,[Ex0n]Ryan,5899,3228,265,208,473,56.0%,2m
39,1,Positivity,5899,192,5,2,7,71.4%,14m
41,1,IIIIIIIIIIII,5897,0,1,0,1,100.0%,14m
42,1,[Ex0n]Ruiyichi,5891,3515,157,129,286,54.9%,2m
43,1,Shed,5882,671,26,16,42,61.9%,5m
44,1,[MFSC2]MeomaikaFan,5875,599,25,19,44,56.8%,23m
45,1,llllllllllll,5861,432,10,4,14,71.4%,19m
46,1,llllllllllll,5858,768,35,16,51,68.6%,23m
47,1,AAAAAAAAAAAA,5854,2211,111,21,132,84.1%,4m
48,1,[HRBNGR]Grimmy,5845,452,24,19,43,55.8%,23m
49,1,[iMkS]XionS,5836,2997,157,81,238,66.0%,2m
50,1,[Quasr]printf,5824,1333,31,17,48,64.6%,16m
51,1,NotaDrRyan,5823,3166,119,88,207,57.5%,2m
52,1,[MFSC2]pezzaperry,5821,1629,55,32,87,63.2%,2m
53,1,Simplistic,5814,487,19,16,35,54.3%,23m
54,1,llllllllllll,5812,0,0,1,1,0.0%,5m
55,1,[αX]TriGGeR,5811,3461,444,324,768,57.8%,2m
55,1,RockEr,5811,3251,345,251,596,57.9%,2m
57,1,[Mapey]llllllllllll,5810,680,16,5,21,76.2%,2m
58,1,HugeOrange,5804,1221,79,47,126,62.7%,16m
59,1,Grimmy,5800,312,16,21,37,43.2%,5m
60,1,Grimmy,5798,402,19,15,34,55.9%,32m
61,1,IIIIIIIIIIII,5797,240,5,6,11,45.5%,38m
62,1,Zest,5795,2583,100,35,135,74.1%,2m
63,1,HeatmanCN,5794,96,2,1,3,66.7%,9m
64,1,HuShang,5788,0,0,1,1,0.0%,23m
65,1,[ArGNA]Rhizer,5770,1898,106,66,172,61.6%,4m
66,1,[Maplez]llllllllllll,5766,2201,101,62,163,62.0%,5m
66,1,RectumRavage,5766,360,24,19,43,55.8%,37m
66,1,Braintoss,5766,48,1,1,2,50.0%,14m
69,1,[ROOT]Robbie,5758,3440,576,361,937,61.5%,2m
70,1,[αX]Rodzyn,5751,96,3,1,4,75.0%,18m
71,1,llllllllllll,5748,0,1,1,2,50.0%,14m
72,1,[lCY]TurkeyDano,5743,2646,180,146,326,55.2%,2m
73,1,[PSISTM]MygraiN,5737,1243,49,38,87,56.3%,8m
74,1,[UpeV]Virtuoso,5733,3079,146,101,247,59.1%,2m
74,1,SlimShady,5733,2293,86,54,140,61.4%,2m
76,1,PointsThief,5732,288,7,5,12,58.3%,38m
77,1,Marshall,5727,807,29,12,41,70.7%,2m
78,1,IIIIIIIIIIII,5726,1010,99,44,143,69.2%,9m
79,1,[WarpDT]AGiantSmurf,5719,0,1,0,1,100.0%,23m
80,1,Grimmybubu,5718,1439,54,39,93,58.1%,2m
81,1,[Ris3n]FiteSumCrime,5716,48,1,3,4,25.0%,23m
82,1,[StarF]Weezy,5713,881,56,44,100,56.0%,23m
83,1,[Maplez]GosuPvP,5710,1079,43,37,80,53.8%,32m
84,1,Legacy,5707,0,0,1,1,0.0%,23m
85,1,[GRNSKN]GrimGoblin,5684,1732,73,53,126,57.9%,2m
86,1,Frustration,5674,3135,257,148,405,63.5%,2m
87,1,Larry,5662,1458,42,32,74,56.8%,2m
88,1,Calm,5655,912,39,27,66,59.1%,23m
89,1,[HRBNGR]GrimWizard,5645,1753,103,66,169,60.9%,32m
90,1,Churro,5631,1155,55,38,93,59.1%,19m
91,1,[Voidy]Grimmy,5628,1271,79,62,141,56.0%,19m
92,1,KingFelixg,5625,1385,119,85,204,58.3%,38m
93,1,[SEND]SocialSend,5616,1047,60,15,75,80.0%,4m
94,1,BlysK,5612,0,0,1,1,0.0%,9m
95,1,Amane,5611,311,38,25,63,60.3%,32m
96,1,CammyPurple,5604,916,65,40,105,61.9%,18m
97,1,[ePunks]PappiJoe,5603,1793,60,45,105,57.1%,2m
98,1,Estaebon,5601,0,0,1,1,0.0%,12m
99,1,PowrfulClown,5597,1046,42,27,69,60.9%,2m
100,1,[Ex0n]Burninator,5592,0,1,0,1,100.0%,18m
101,1,IIIIIIIIIIII,5591,1187,107,44,151,70.9%,38m
101,1,[mbDeep]Ninjinho,5591,1216,53,45,98,54.1%,5m
101,1,[ArGNA]Maplez,5591,424,9,4,13,69.2%,4m
104,1,EnigmA,5584,90,3,0,3,100.0%,9m
105,1,Lero,5579,0,0,2,2,0.0%,38m
106,1,[S7E]Lightweight,5570,240,6,2,8,75.0%,14m
107,1,llllllllllll,5569,48,4,3,7,57.1%,10m
108,1,[Msia]Ranger,5566,1502,55,36,91,60.4%,2m
109,1,[xRtG]Haffey,5561,192,4,2,6,66.7%,5m
110,1,[AoBDE]ALLIDOISWIN,5559,238,6,5,11,54.5%,23m
111,1,gamewinner,5557,933,92,75,167,55.1%,18m
111,1,BeLikeWater,5557,86,3,1,4,75.0%,23m
113,1,IIIIIIIIIIII,5552,269,27,30,57,47.4%,23m
114,1,TibetOP,5549,1230,31,23,54,57.4%,32m
115,1,llllllllllll,5548,0,1,0,1,100.0%,32m
116,1,[αX]Pacomike,5545,2949,454,377,831,54.6%,2m
116,1,[PiGPan]ProbeScout,5545,2245,347,288,635,54.6%,2m
116,1,[Th3Bad]Gauss,5545,3289,230,156,386,59.6%,2m
116,1,TheMusZero,5545,332,7,3,10,70.0%,38m
120,1,CheesyTerran,5538,48,2,0,2,100.0%,9m
121,1,GrimTrucker,5536,1846,104,79,183,56.8%,2m
122,1,Jamileon,5535,0,0,1,1,0.0%,23m
123,1,VALiS,5532,1082,53,36,89,59.6%,5m
124,1,MrShaibel,5524,2309,82,65,147,55.8%,2m
125,1,island,5522,596,15,10,25,60.0%,10m
126,1,OpTiMiStC,5521,681,24,11,35,68.6%,18m
127,1,wake,5520,768,17,6,23,73.9%,19m
128,1,[Th3Bad]nanO,5519,2802,112,82,194,57.7%,2m
129,1,rive,5518,0,0,1,1,0.0%,20m
130,1,[PSISTM]Namshar,5512,1020,42,35,77,54.5%,19m
131,1,llllllllllll,5511,92,3,6,9,33.3%,23m
131,1,CloutCobain,5511,0,2,3,5,40.0%,4m
133,1,IlllIlIIlIIl,5508,46,2,0,2,100.0%,9m
134,1,[Ex0n]ReSpOnSe,5506,3320,651,504,1155,56.4%,2m
135,1,IIIIIIIIIIII,5505,144,3,7,10,30.0%,38m
136,1,[uWu69]NuzzleNuzzle,5504,506,12,2,14,85.7%,23m
136,1,[αX]Sonny,5504,46,1,1,2,50.0%,38m
138,1,[GRNSKN]ScroteGoblin,5502,1751,73,19,92,79.3%,2m
139,1,RotterdaM,5501,619,25,9,34,73.5%,23m
140,1,VoidRaysssss,5500,568,12,16,28,42.9%,32m
141,1,[ArGNA]RaNgeD,5495,48,1,1,2,50.0%,12m
142,1,HolyHit,5494,0,0,1,1,0.0%,9m
143,1,[RnGpro]omgabanana,5493,0,0,1,1,0.0%,4m
144,1,MissFanta,5479,1369,64,39,103,62.1%,23m
145,1,[GUCCl]TheoRy,5478,2065,116,102,218,53.2%,14m
146,1,[αXLa]Dastan,5472,1006,79,60,139,56.8%,5m
147,1,[PiGPan]PiG,5471,2118,81,84,165,49.1%,2m
148,1,[BENCHH]HolidayInn,5468,0,0,2,2,0.0%,36m
149,1,kyle,5463,0,0,1,1,0.0%,14m
150,1,Hopopono,5462,564,13,7,20,65.0%,18m
151,1,[UpeV]Sepheron,5454,3191,638,415,1053,60.6%,2m
152,1,Ditrih,5453,46,2,3,5,40.0%,38m
152,1,moksha,5453,0,0,1,1,0.0%,19m
154,1,MusCLEMen,5451,2015,127,97,224,56.7%,32m
155,1,llllllllllll,5443,736,24,16,40,60.0%,2m
156,1,Spatz,5435,0,0,1,1,0.0%,23m
157,1,IIIIIIIIIIII,5431,2135,111,43,154,72.1%,2m
158,1,llllllllllll,5424,0,1,0,1,100.0%,38m
159,1,[aviG0D]aviloSoSimp,5418,288,7,4,11,63.6%,38m
160,1,[DhZCom]Filho,5416,1545,103,78,181,56.9%,19m
161,1,Trace,5415,464,11,3,14,78.6%,4m
161,1,[ArGNA]Intoowishun,5415,0,0,4,4,0.0%,32m
163,1,Trash,5413,1003,31,24,55,56.4%,2m
164,1,[Rival]MewlMewl,5412,704,56,39,95,58.9%,16m
164,1,[cl0udM]ZESTYZERATUL,5412,48,1,5,6,16.7%,23m
166,1,[GIBE]Jason,5408,389,70,61,131,53.4%,16m
167,1,[ZCAce]llllllllllll,5406,2015,73,50,123,59.3%,2m
168,1,GrimReaperUK,5402,1756,85,27,112,75.9%,2m
168,1,WhoAreYou,5402,1034,42,31,73,57.5%,38m
170,1,llllllllllll,5401,0,1,0,1,100.0%,32m
171,1,llllllllllll,5399,2291,106,64,170,62.4%,2m
172,1,IIIIIIIIIIII,5397,0,1,0,1,100.0%,23m
173,1,[Micr0]Bogwandi,5395,0,0,1,1,0.0%,20m
174,1,[Shang]HuShang,5393,1017,47,36,83,56.6%,32m
175,1,IIIIIIIIIIII,5391,267,9,14,23,39.1%,18m
176,1,[RnGpro]DDroese,5384,0,0,1,1,0.0%,14m
177,1,Ring,5380,1670,67,44,111,60.4%,32m
177,1,HOOPSAIYA,5380,175,16,17,33,48.5%,16m
177,1,HiddenSquid,5380,423,15,3,18,83.3%,9m
180,1,[Ris3n]SacDeFromage,5374,2169,123,90,213,57.7%,32m
180,1,MagicPT,5374,1371,59,31,90,65.6%,10m
182,1,NukShalah,5372,1696,213,181,394,54.1%,9m
183,1,llllllllllll,5367,170,5,3,8,62.5%,5m
183,1,[Olivia]Adonis,5367,73,0,1,1,0.0%,2m
185,1,llllllllllll,5366,1350,57,45,102,55.9%,10m
186,1,llllllllllll,5356,862,132,77,209,63.2%,23m
186,1,opne,5356,1797,114,28,142,80.3%,4m
186,1,llllllllllll,5356,804,18,16,34,52.9%,5m
189,1,Streamer,5353,860,21,5,26,80.8%,19m
189,1,[Ex0n]SpeCial,5353,224,5,2,7,71.4%,14m
191,1,[xLgNx]Holden,5352,2858,357,288,645,55.3%,2m
191,1,Starlord,5352,421,12,8,20,60.0%,8m
191,1,IIIIIIIIII,5352,119,3,0,3,100.0%,2m
194,1,llllllllllll,5348,142,4,3,7,57.1%,23m
195,1,WaveWalker,5342,286,6,8,14,42.9%,5m
196,1,WasheD,5341,48,2,1,3,66.7%,32m
197,1,Sunlight,5338,2753,146,120,266,54.9%,2m
197,1,IIIIIIIIIIII,5338,192,4,6,10,40.0%,23m
199,1,DKnight,5335,48,1,1,2,50.0%,12m
199,1,[PSISTM]Silky,5335,0,0,1,1,0.0%,19m
201,1,llllllllllll,5334,304,8,6,14,57.1%,38m
202,1,[FFJUST]StarDuck,5331,2753,232,163,395,58.7%,2m
202,1,[ELIDS]QuaNTeL,5331,0,1,0,1,100.0%,18m
204,1,JimmyBob,5330,332,12,8,20,60.0%,8m
205,1,SasukeUchiha,5326,633,21,17,38,55.3%,19m
205,1,Sagan,5326,0,1,0,1,100.0%,14m
207,1,Ancient,5325,0,1,0,1,100.0%,19m
208,1,PPower,5324,765,32,14,46,69.6%,2m
209,1,noodles,5321,433,15,12,27,55.6%,2m
210,1,NonY,5320,827,36,26,62,58.1%,23m
211,1,[AlIin]Pure,5318,613,50,32,82,61.0%,16m
212,1,[YUNHAO]Flume,5315,890,21,18,39,53.8%,12m
213,1,XsLel,5314,0,0,5,5,0.0%,14m
214,1,Mute,5313,1130,31,12,43,72.1%,38m
215,1,Early,5312,1114,40,15,55,72.7%,2m
215,1,Aiur,5312,142,3,7,10,30.0%,23m
215,1,MillForGG,5312,48,2,3,5,40.0%,23m
218,1,HeroCarrier,5311,1423,208,140,348,59.8%,8m
218,1,[TeamDG]Leo,5311,0,1,0,1,100.0%,14m
218,1,Hardwell,5311,0,0,1,1,0.0%,32m
221,1,[ShoaL]kof,5310,76,3,0,3,100.0%,9m
222,1,TwójStary,5306,0,0,2,2,0.0%,23m
223,1,Bladee,5304,1299,59,42,101,58.4%,2m
224,1,Classic,5302,0,1,25,26,3.8%,10m
225,1,Nerazim,5286,0,0,3,3,0.0%,12m
226,1,HoldMyBeer,5283,1868,140,78,218,64.2%,10m
227,1,[hTx]Shrimp,5282,2549,113,83,196,57.7%,2m
227,1,BodaciosBabe,5282,48,1,5,6,16.7%,4m
229,1,[RnGpro]Bowman,5281,186,5,1,6,83.3%,38m
230,1,CNyue,5280,0,0,1,1,0.0%,23m
231,1,[DETER]DeltaStar,5279,408,9,5,14,64.3%,32m
232,1,[LOUISV]DICEROLLER,5275,48,2,3,5,40.0%,10m
233,1,ItosI,5274,116,4,0,4,100.0%,5m
234,1,[fiverr]ibnulaffan,5273,48,1,1,2,50.0%,23m
235,1,[BoAVN]Pimba,5272,1672,91,66,157,58.0%,12m
235,1,[afterM]Voltz,5272,343,10,3,13,76.9%,2m
237,2,BoardingPear,5271,46,2,0,2,100.0%,30m
237,1,FroggyDog,5271,46,1,1,2,50.0%,5m
239,1,WindowsXD,5269,175,23,10,33,69.7%,23m
240,1,[AMZN]Mestaman,5263,1236,76,52,128,59.4%,38m
240,1,poker,5263,577,20,11,31,64.5%,2m
240,1,SykO,5263,0,1,0,1,100.0%,8m
243,1,DJDwyDecibel,5261,1111,222,152,374,59.4%,38m
244,1,[xRtG]Nesquik,5259,986,44,21,65,67.7%,19m
245,1,[AMisEZ]pimballl,5258,276,7,9,16,43.8%,14m
246,1,Samuel,5257,2456,107,88,195,54.9%,2m
246,1,[xepo]OpeX,5257,0,0,1,1,0.0%,10m
248,1,[GTMDSB]Perniciousor,5256,0,0,1,1,0.0%,16m
249,1,[NwAs]BeIieve,5255,1160,104,87,191,54.5%,8m
250,1,BolinhoFofo,5253,142,3,2,5,60.0%,23m
251,1,Russano,5239,977,500,391,891,56.1%,23m
251,1,BlueViper,5239,0,0,1,1,0.0%,38m
253,1,[LTK]Flick,5238,2128,117,93,210,55.7%,23m
254,1,armaSoAmaze,5233,586,14,8,22,63.6%,12m
255,1,Goobs,5230,234,11,3,14,78.6%,8m
256,1,[Yggr]TerribleOne,5229,224,5,4,9,55.6%,32m
256,1,[aivNA]aviloSoAmaze,5229,0,0,1,1,0.0%,20m
258,1,IIIIIIIIIIII,5226,848,178,145,323,55.1%,23m
258,1,PinkiePie,5226,0,1,0,1,100.0%,9m
260,1,Lelezinha,5224,173,7,7,14,50.0%,20m
261,1,TheKing,5223,758,47,4,51,92.2%,2m
262,1,[SsaYnS]llllllllllll,5221,46,2,0,2,100.0%,32m
263,1,llllllllllll,5218,158,4,5,9,44.4%,23m
264,1,XypheR,5215,3051,232,136,368,63.0%,2m
264,1,Bones,5215,142,4,10,14,28.6%,5m
264,1,[IShoes]Vince,5215,0,0,2,2,0.0%,32m
267,1,IIIIIIIIIIII,5212,46,2,1,3,66.7%,4m
268,1,[Ex0n]Cham,5211,0,0,1,1,0.0%,9m
269,1,WORLDPEACE,5208,385,13,17,30,43.3%,4m
270,1,IIIIIIIIIIII,5207,0,0,2,2,0.0%,38m
271,1,[ITTC]Best,5204,48,2,1,3,66.7%,18m
272,1,[eW0lfz]FeaR,5202,1012,41,23,64,64.1%,2m
272,1,PrinzEugen,5202,0,0,1,1,0.0%,32m
274,1,Wall,5201,44,2,0,2,100.0%,16m
275,1,Fujiwara,5200,506,12,7,19,63.2%,5m
275,1,[DarkAG]TwitchCurry,5200,72,2,1,3,66.7%,32m
277,1,AnNam,5199,0,1,3,4,25.0%,10m
278,1,Panic,5198,2018,105,54,159,66.0%,2m
279,1,[ROOT]PvP,5196,437,16,14,30,53.3%,4m
280,1,Leo,5195,326,29,10,39,74.4%,23m
281,1,[ANFA]Kui,5193,308,8,9,17,47.1%,38m
282,1,Mav,5190,436,11,15,26,42.3%,32m
282,1,BabySharkDDD,5190,0,0,3,3,0.0%,23m
284,1,[EvilGC]SkrOs,5189,0,1,0,1,100.0%,4m
285,1,[ShoaL]kkiii,5187,94,3,0,3,100.0%,8m
286,1,[NwAs]DestroyerTT,5185,2683,241,200,441,54.6%,2m
286,1,MikeRoss,5185,502,23,11,34,67.6%,10m
288,1,[αXi]ThiasHP,5181,1636,87,63,150,58.0%,10m
288,3,[RnGpro]Puppypaws,5181,0,2,3,5,40.0%,22m
290,1,CataliNa,5179,290,8,3,11,72.7%,4m
291,1,TangleDahee,5178,1715,109,77,186,58.6%,2m
292,1,[JIGLY]EinSlight,5176,2204,101,77,178,56.7%,2m
292,1,AdaptyR,5176,0,0,1,1,0.0%,5m
294,1,llllllllllll,5173,1801,101,76,177,57.1%,19m
295,1,Maru,5172,320,8,7,15,53.3%,23m
296,1,[αX]FEqualsMA,5171,2747,271,234,505,53.7%,2m
296,1,KimJaeHyung,5171,1762,195,133,328,59.5%,2m
296,1,Hurricane,5171,630,26,4,30,86.7%,10m
299,1,ppgBubbles,5169,1818,95,40,135,70.4%,10m
300,1,[αXLa]GutyECUADOR,5168,2723,176,156,332,53.0%,2m
300,1,[Acceso]llllllllllll,5168,603,29,12,41,70.7%,2m
300,1,Nesquik,5168,775,29,22,51,56.9%,36m
300,1,[WNTR]WinterSC,5168,0,0,2,2,0.0%,36m
304,1,JackOssan,5167,270,7,4,11,63.6%,8m
305,1,IIIIIIIIIIII,5166,1414,45,37,82,54.9%,4m
306,1,IIIIIIIIIIII,5164,2132,143,99,242,59.1%,2m
306,1,Yaegz,5164,685,27,21,48,56.2%,13m
308,1,[UofC]Pancakes,5163,2032,131,92,223,58.7%,10m
309,1,[Th3Bad]AllinsoN,5162,625,26,18,44,59.1%,2m
310,1,[TSØP]TheTRUTH,5160,711,29,38,67,43.3%,32m
310,1,IIIIIIIlllll,5160,358,9,5,14,64.3%,9m
312,1,PewpSokk,5158,0,3,2,5,60.0%,20m
313,1,[PoLC]spirit,5157,141,6,4,10,60.0%,36m
314,1,oooooooooooo,5156,48,1,1,2,50.0%,8m
315,1,Groovyman,5155,1185,68,41,109,62.4%,13m
316,1,[αX]Jettorix,5153,0,0,4,4,0.0%,9m
317,1,MrTsukimoto,5152,1168,31,22,53,58.5%,13m
318,1,[Regstr]FlexOffender,5151,94,3,4,7,42.9%,9m
319,1,WingZero,5149,450,17,13,30,56.7%,32m
320,1,proxyimba,5148,596,21,9,30,70.0%,4m
321,1,ZZeroFeniXX,5146,178,5,6,11,45.5%,5m
321,1,CannonRusher,5146,88,2,2,4,50.0%,38m
323,1,[cl0udM]putnik,5144,849,122,105,227,53.7%,19m
324,1,IIIIIIIIIIII,5141,264,25,20,45,55.6%,5m
325,1,[NalsEz]IIIIIIIIllII,5140,1862,104,50,154,67.5%,2m
325,1,[lying]playlikeStat,5140,1269,71,30,101,70.3%,14m
327,1,Bombzz,5136,948,47,31,78,60.3%,4m
327,1,[8RUH]PogChamp,5136,228,5,9,14,35.7%,14m
327,1,[ShoaL]kofkobe,5136,40,2,0,2,100.0%,13m
330,1,[ValidG]Orion,5135,2128,92,85,177,52.0%,9m
330,1,[NovaX]Bonkers,5135,972,31,29,60,51.7%,13m
330,1,ZetaStar,5135,473,12,18,30,40.0%,20m
333,1,[aviNA]aviloSoAmaze,5134,1121,219,182,401,54.6%,38m
334,1,RifleCaster,5133,204,4,4,8,50.0%,10m
335,1,[AMZN]Flopsie,5131,140,3,9,12,25.0%,5m
336,1,IlIlIlIlllIl,5128,1149,136,110,246,55.3%,23m
337,1,Shinobi,5126,3023,225,190,415,54.2%,10m
338,1,llllllllllll,5124,1052,34,25,59,57.6%,5m
339,1,OnionKnight,5122,2296,197,175,372,53.0%,38m
340,1,HonourableSC,5118,970,43,8,51,84.3%,4m
340,1,Luneth,5118,46,2,3,5,40.0%,5m
342,1,OhHoney,5117,891,46,26,72,63.9%,14m
342,1,PhOeNiX,5117,599,17,10,27,63.0%,23m
344,1,DOBRO,5115,1229,105,39,144,72.9%,5m
344,1,Punisher,5115,215,30,23,53,56.6%,5m
346,1,[αXLa]MooD,5111,2213,93,74,167,55.7%,19m
347,1,Caedus,5110,0,1,0,1,100.0%,23m
348,1,[Exehn]ExehnTV,5109,318,8,14,22,36.4%,32m
348,3,Nistic,5109,0,0,5,5,0.0%,36m
350,1,[EBIG]Eiger,5108,0,0,1,1,0.0%,10m
350,1,[αXLa]TheVirusLove,5108,0,0,2,2,0.0%,36m
352,1,[SM1L3]IlIlIlIlIlIl,5107,1840,81,47,128,63.3%,5m
352,1,[xxGMxx]eXiled,5107,0,1,0,1,100.0%,13m
354,1,[NalsEz]Timo,5106,1399,66,37,103,64.1%,32m
354,1,llllllllllll,5106,0,1,2,3,33.3%,10m
356,1,HydraulixXD,5101,1004,30,15,45,66.7%,5m
357,1,[xRtG]Void,5100,2142,105,84,189,55.6%,2m
357,1,[Ex0n]speaknow,5100,224,6,2,8,75.0%,32m
359,2,GoldenAge,5099,106,4,0,4,100.0%,4m
359,1,IIIIIIIIIIII,5099,0,0,1,1,0.0%,5m
361,1,McGregor,5098,1478,65,56,121,53.7%,23m
362,1,Adun,5097,962,42,26,68,61.8%,36m
363,1,IlIlIlIlIlIl,5095,204,6,7,13,46.2%,20m
364,1,llllllllllll,5094,634,15,14,29,51.7%,9m
365,1,SonOfBob,5091,3125,375,294,669,56.1%,4m
365,1,KimTaehyung,5091,1219,52,37,89,58.4%,32m
365,1,Fluttershy,5091,206,6,6,12,50.0%,14m
365,1,CapnFappin,5091,0,0,3,3,0.0%,5m
369,1,MalGanis,5090,3131,187,146,333,56.2%,32m
370,1,Lanthanum,5088,947,37,23,60,61.7%,14m
371,1,[tsGURU]IIIIIIIIIIII,5083,0,0,4,4,0.0%,36m
372,1,Sky,5081,1396,49,36,85,57.6%,4m
373,1,MikeRøss,5077,1581,66,21,87,75.9%,13m
373,1,[AvsA]PsYche,5077,902,33,21,54,61.1%,20m
373,1,[Groovy]Judgement,5077,173,7,9,16,43.8%,23m
373,1,TerraN,5077,188,4,5,9,44.4%,32m
373,3,Umbi,5077,0,1,0,1,100.0%,29m
373,1,Newsh,5077,0,0,1,1,0.0%,36m
379,1,IIIIIIIIIIII,5075,835,96,78,174,55.2%,19m
380,1,IIIIIIIIIIII,5073,731,59,44,103,57.3%,14m
381,1,[Hoxy]Mymura,5070,182,4,7,11,36.4%,9m
381,1,[αX]SippyCup,5070,0,1,0,1,100.0%,9m
383,1,[αX]MaidenSlayer,5069,1006,31,23,54,57.4%,13m
383,1,RuFF,5069,134,6,5,11,54.5%,32m
385,1,[eSun]maVerick,5068,3129,893,781,1674,53.3%,14m
385,1,Zeth,5068,1860,75,63,138,54.3%,5m
387,1,Panic,5067,2079,490,411,901,54.4%,5m
387,3,[LCE]ldrunk,5067,0,0,3,3,0.0%,29m
389,1,PeaKnuckles,5065,2929,282,222,504,56.0%,23m
390,1,Chugi,5063,1750,63,50,113,55.8%,23m
391,1,AkashSky,5062,2494,151,127,278,54.3%,36m
392,1,IIIIIIIIIIII,5061,1232,57,14,71,80.3%,4m
393,1,[ACSS]HeavyFresh,5060,170,4,2,6,66.7%,23m
394,1,[PTHero]MeoMKFangayy,5053,1460,51,33,84,60.7%,23m
395,1,mOsTeN,5051,0,0,1,1,0.0%,8m
396,1,[xGenGx]Galaxy,5046,3014,376,323,699,53.8%,10m
396,1,GetMeOut,5046,1322,47,43,90,52.2%,36m
398,1,IlIlIIIllIlI,5045,1390,78,50,128,60.9%,4m
398,1,[LGCANZ]Azure,5045,1511,78,51,129,60.5%,9m
400,1,[RBTH]CristianoX,5044,1162,40,24,64,62.5%,32m
401,1,daof,5041,44,1,4,5,20.0%,9m
402,1,DarkSasuke,5039,174,5,2,7,71.4%,9m
403,1,LewsTherin,5038,176,4,4,8,50.0%,32m
404,1,Stifmeister,5037,1904,78,57,135,57.8%,23m
404,1,[RUMB]CapsLock,5037,1556,57,40,97,58.8%,38m
406,1,Aeon,5033,0,0,1,1,0.0%,23m
407,1,VGVermillion,5031,958,25,25,50,50.0%,8m
408,1,Sartori,5030,0,0,1,1,0.0%,19m
409,1,[GnR]Asturias,5029,1156,132,106,238,55.5%,9m
409,1,liznewtwork,5029,0,1,0,1,100.0%,5m
411,1,[ditmew]abc,5028,0,0,1,1,0.0%,32m
412,1,IrishLad,5027,46,2,1,3,66.7%,16m
413,1,ice,5023,0,0,27,27,0.0%,10m
414,1,KoStats,5022,2616,160,101,261,61.3%,9m
414,1,PureLight,5022,815,38,23,61,62.3%,23m
416,1,IIIIIIIIIIII,5019,1661,81,64,145,55.9%,38m
416,1,[Macac0]JimRising,5019,560,15,18,33,45.5%,13m
418,1,Paparoni,5018,925,100,35,135,74.1%,14m
418,1,CCalms,5018,0,0,1,1,0.0%,14m
420,1,Zasa,5015,40,2,4,6,33.3%,19m
421,1,[Lp]pzychO,5014,1215,41,34,75,54.7%,14m
421,1,[Ex0n]Gerald,5014,266,7,1,8,87.5%,23m
423,1,[Ex0n]Jenasin,5013,266,8,2,10,80.0%,9m
423,1,TerranUser,5013,0,0,2,2,0.0%,13m
425,1,[MirG]GISH,5008,2842,159,98,257,61.9%,38m
425,1,[xRtG]BlinkGosu,5008,1935,94,79,173,54.3%,9m
425,1,llllllllllll,5008,226,6,5,11,54.5%,23m
428,1,[Yin]Jerry,5007,3027,433,370,803,53.9%,4m
429,1,Primal,5006,2615,135,106,241,56.0%,10m
429,1,[RoVG]BloodshedS,5006,34,2,2,4,50.0%,36m
431,1,ShadowThor,5005,1175,48,54,102,47.1%,32m
431,1,[αXi]arrogfire,5005,594,34,2,36,94.4%,23m
433,1,[ValidG]Thor,5004,1529,288,254,542,53.1%,13m
433,1,WhiteAunt,5004,285,90,87,177,50.8%,14m
433,1,GamIsSecHome,5004,288,8,6,14,57.1%,19m
436,1,ColiNerTiA,5003,3072,209,182,391,53.5%,20m
436,1,[RRDZ]RayReign,5003,1720,54,57,111,48.6%,38m
438,1,[LimLim]Sound,5001,980,47,31,78,60.3%,36m
439,1,[DGGxDD]RTBALOL,5000,1134,84,44,128,65.6%,16m
439,1,[EvilGC]SkrOs,5000,0,0,4,4,0.0%,14m
441,1,Immortality,4996,2725,207,178,385,53.8%,32m
441,1,ESCANOR,4996,882,25,15,40,62.5%,38m
441,1,Bobon,4996,0,0,1,1,0.0%,23m
444,1,Yoyo,4995,0,0,1,1,0.0%,19m
445,1,Bonkarooni,4994,44,2,2,4,50.0%,9m
445,1,jheffe,4994,0,0,2,2,0.0%,9m
447,1,FoxeR,4992,0,1,2,3,33.3%,10m
448,1,[ROOT]AwesomeSauce,4990,582,16,6,22,72.7%,9m
449,1,[lc9l]FrashQ,4987,2595,103,86,189,54.5%,4m
449,1,lIIIIlIIl,4987,82,2,2,4,50.0%,16m
451,1,Dreamer,4986,550,16,21,37,43.2%,4m
452,1,llllllllllll,4985,40,1,1,2,50.0%,23m
453,1,[ROOT]NoRegreT,4981,1017,32,24,56,57.1%,32m
454,1,llllllllllll,4979,1714,73,67,140,52.1%,9m
454,1,SwagSurgeon,4979,846,24,18,42,57.1%,16m
456,1,NightMare,4978,621,25,3,28,89.3%,23m
456,1,[prim8s]KFC,4978,0,1,0,1,100.0%,14m
458,1,Charlotte,4977,623,32,22,54,59.3%,9m
459,1,Twilight,4976,2608,229,205,434,52.8%,5m
459,1,ThuocLao,4976,0,1,0,1,100.0%,23m
461,1,[Twitch]WhiteRa,4974,1672,58,47,105,55.2%,23m
462,1,Katana,4970,2498,128,77,205,62.4%,23m
462,1,Simple,4970,48,1,6,7,14.3%,20m
464,1,Sohrab,4969,1413,62,36,98,63.3%,5m
465,1,[BruC]Bulmyeolja,4968,1493,81,54,135,60.0%,16m
466,1,TriuMph,4963,2995,123,103,226,54.4%,16m
466,1,[BRAAAP]GuruFan,4963,220,6,2,8,75.0%,4m
468,1,[NwAs]Angelnex,4962,2939,150,134,284,52.8%,16m
469,1,NAMacro,4960,701,32,7,39,82.1%,32m
469,1,IIIIIIIIIIII,4960,0,0,1,1,0.0%,38m
471,1,IIIIIIIIIII,4959,94,5,1,6,83.3%,5m
472,1,RiSE,4958,2980,307,278,585,52.5%,9m
473,1,Jakttornet,4955,236,7,1,8,87.5%,23m
474,1,[xRtG]NamhciR,4954,1321,58,36,94,61.7%,19m
474,1,[JIGLY]Marea,4954,46,1,3,4,25.0%,10m
476,1,[αX]Sinner,4953,327,10,10,20,50.0%,19m
476,1,[LGCANZ]MeomaikaFan,4953,130,4,2,6,66.7%,16m
476,1,[EZDUNK]Chelch,4953,0,1,0,1,100.0%,10m
479,1,IIIIIIIIIIII,4952,138,4,5,9,44.4%,5m
480,1,[αX]Vindicta,4951,592,17,10,27,63.0%,36m
481,1,Reg,4950,0,1,0,1,100.0%,20m
482,1,TED,4948,570,18,10,28,64.3%,23m
482,1,Rukia,4948,26,2,4,6,33.3%,9m
484,1,Terminus,4945,1115,56,50,106,52.8%,20m
485,1,Instigator,4943,544,17,10,27,63.0%,20m
485,1,llllllllllll,4943,396,11,6,17,64.7%,16m
487,1,[Ris3n]PBOY,4942,148,4,2,6,66.7%,19m
488,1,Joe,4939,742,22,13,35,62.9%,32m
488,1,Oppooo,4939,629,19,7,26,73.1%,23m
488,1,BamBam,4939,0,0,2,2,0.0%,4m
491,1,[ROOT]ViBE,4937,2671,324,281,605,53.6%,32m
491,1,[lLiTl]ieLLiMo,4937,0,0,1,1,0.0%,8m
493,1,[RiGO]PrayeR,4936,1166,114,110,224,50.9%,14m
493,1,SacreBleu,4936,80,3,0,3,100.0%,8m
493,1,Ruslanko,4936,40,2,1,3,66.7%,23m
496,1,[xRtG]SorroW,4935,1329,56,57,113,49.6%,23m
497,1,IlIlIlIlIlIl,4934,42,2,0,2,100.0%,32m
498,1,Brom,4933,1182,37,35,72,51.4%,32m
499,1,OREO,4932,690,21,22,43,48.8%,10m
499,1,IIIIIIIIIIII,4932,0,0,1,1,0.0%,23m
501,1,[UCSD]OrangCaramel,4931,2460,307,275,582,52.7%,23m
502,1,[αB]eXiled,4930,3043,454,385,839,54.1%,14m
503,1,[NovaX]octomologyst,4928,3011,427,431,858,49.8%,14m
503,1,[LTK]MaXiMuS,4928,2961,364,315,679,53.6%,13m
505,1,[RolIin]Dolan,4925,184,5,10,15,33.3%,23m
505,1,[RYEdge]Zest,4925,104,4,0,4,100.0%,38m
505,1,[Ex0n]Taldan,4925,0,1,2,3,33.3%,23m
508,1,Tassadar,4923,1332,44,35,79,55.7%,23m
509,1,Spork,4921,1412,42,44,86,48.8%,38m
510,1,llllllllllll,4920,1647,65,58,123,52.8%,13m
510,1,[TGosuD]DrakkenGay,4920,737,37,8,45,82.2%,19m
510,1,Brightmoon,4920,594,21,11,32,65.6%,16m
510,1,[HMTeam]Mimeron,4920,0,0,2,2,0.0%,36m
514,1,Honeybear,4919,182,4,5,9,44.4%,32m
515,1,Rocktopus,4918,3005,525,459,984,53.4%,9m
515,1,IIIIIIIIIIII,4918,231,31,17,48,64.6%,20m
515,1,MaDoMsOnIIII,4918,679,25,9,34,73.5%,23m
515,1,[HMTeam]Lovatel,4918,368,12,10,22,54.5%,5m
515,1,[TeamUR]LeBakodeu,4918,0,0,1,1,0.0%,14m
520,1,Zasa,4917,488,23,5,28,82.1%,19m
520,1,Dove,4917,0,0,1,1,0.0%,14m
522,1,WindmillMan,4916,88,2,6,8,25.0%,13m
523,1,[cl0udM]Joe,4915,46,1,3,4,25.0%,14m
524,1,SolidHas,4914,504,13,14,27,48.1%,14m
525,1,llllllllllll,4912,188,8,8,16,50.0%,23m
525,1,[αXLa]AsusWing,4912,290,7,4,11,63.6%,23m
527,1,[αB]SippyCup,4911,1018,31,30,61,50.8%,13m
527,1,IIIIllllIII,4911,518,19,7,26,73.1%,5m
527,1,Player,4911,238,6,4,10,60.0%,16m
530,1,[PTHero]ieLLiMo,4910,1695,171,158,329,52.0%,36m
530,1,XYZ,4910,1520,76,72,148,51.4%,38m
530,1,[Perfec]Zero,4910,86,3,9,12,25.0%,19m
533,1,MooNLighT,4909,2490,98,99,197,49.7%,32m
534,1,[αXLa]eGGz,4908,0,1,1,2,50.0%,9m
535,3,lIlIllIllIll,4907,34,3,0,3,100.0%,2m
536,1,[NC]Dustin,4906,0,0,1,1,0.0%,20m
537,1,IIIIIIIIIIII,4905,137,5,4,9,55.6%,9m
538,1,Yombonski,4904,1180,317,283,600,52.8%,23m
538,1,Berzerker,4904,1287,67,48,115,58.3%,8m
538,1,Krelian,4904,74,2,1,3,66.7%,36m
541,1,[aivNA]fig,4903,2966,148,127,275,53.8%,9m
541,1,llllllllll,4903,92,3,4,7,42.9%,32m
543,1,[Macac0]FasUwU,4902,843,96,42,138,69.6%,23m
543,1,[αB]Bloodless,4902,769,37,28,65,56.9%,13m
545,1,Loki,4901,42,3,0,3,100.0%,14m
545,1,[ShoaL]TaiGei,4901,0,0,1,1,0.0%,9m
547,1,Aggrandize,4898,44,2,0,2,100.0%,11m
548,1,[gromp]Luneth,4896,2089,104,80,184,56.5%,23m
549,1,universe,4895,40,1,2,3,33.3%,23m
550,1,ProxyVoidray,4894,2972,337,264,601,56.1%,9m
550,1,Smerdyakov,4894,1370,64,38,102,62.7%,32m
550,1,Vox,4894,324,9,7,16,56.2%,4m
550,1,spectre,4894,128,3,6,9,33.3%,5m
554,1,[xRtG]Lightning,4892,1448,106,102,208,51.0%,32m
554,1,Benti,4892,879,29,20,49,59.2%,5m
554,1,IIIIIIIIIIII,4892,40,2,3,5,40.0%,14m
557,1,Waloo,4891,0,1,0,1,100.0%,23m
558,1,Yesteryear,4890,1198,42,34,76,55.3%,14m
558,1,[Ris3n]CollegeWings,4890,0,1,0,1,100.0%,38m
560,1,TKL,4888,506,19,8,27,70.4%,23m
561,1,llllllllllll,4887,96,3,7,10,30.0%,14m
562,1,[omgBBC]GucciCoochie,4886,0,0,1,1,0.0%,9m
563,1,iii,4884,706,23,14,37,62.2%,14m
564,1,Dashedhopes,4883,1321,107,84,191,56.0%,14m
564,1,WhineFarmer,4883,469,17,10,27,63.0%,32m
566,1,[JOSUN]dkfofjcndjs,4881,154,5,0,5,100.0%,32m
566,1,[UVa]AceElite,4881,0,0,1,1,0.0%,19m
566,1,[VENSC2]MadBunny,4881,0,0,1,1,0.0%,16m
569,1,[THANK]Jobama,4879,74,2,2,4,50.0%,9m
570,1,llllllllll,4878,294,8,6,14,57.1%,38m
570,1,[nPnSX]Sanic,4878,150,4,1,5,80.0%,9m
570,1,[DAVFAN]MeomaikaFan,4878,0,3,2,5,60.0%,23m
573,1,[Smart]sentiNeL,4877,2919,251,221,472,53.2%,32m
573,1,[EIem]Citadel,4877,1098,61,20,81,75.3%,19m
573,1,IIIIIIIIIII,4877,690,21,30,51,41.2%,20m
576,1,Fire,4876,1690,63,55,118,53.4%,20m
576,1,[XYFAN5]DRINK,4876,246,9,8,17,52.9%,5m
578,1,IIIIIIIIIIII,4875,1977,146,131,277,52.7%,13m
578,1,CallHerDaddy,4875,759,37,20,57,64.9%,23m
578,1,TokiSada,4875,502,16,11,27,59.3%,5m
581,1,PABLITOCHILE,4874,698,40,25,65,61.5%,16m
582,1,llllllllllll,4870,2984,168,128,296,56.8%,38m
582,1,[αX]Chillyßoy,4870,1243,55,48,103,53.4%,36m
582,1,[RUMB]ÖrjanVilma,4870,48,1,1,2,50.0%,23m
585,1,[BRAAAP]Timorus,4869,0,0,1,1,0.0%,23m
586,1,llllllllllll,4868,727,32,7,39,82.1%,19m
587,1,tSunami,4865,46,1,1,2,50.0%,5m
588,1,Bumi,4864,0,1,0,1,100.0%,23m
588,1,WeBear,4864,0,0,1,1,0.0%,16m
590,3,llllllllllll,4863,232,8,1,9,88.9%,28m
591,1,BibizyanXGOD,4862,1505,58,43,101,57.4%,23m
592,1,IntotheBotto,4861,1885,91,63,154,59.1%,9m
593,1,[xRtG]FeaR,4860,577,63,54,117,53.8%,14m
593,2,Vindicarian,4860,160,5,2,7,71.4%,26m
595,1,DeepInDemTDS,4859,0,1,0,1,100.0%,8m
596,1,[TRTC]Xazae,4858,2997,569,484,1053,54.0%,9m
597,1,[SftVgn]Savi,4857,2922,476,440,916,52.0%,23m
598,1,[lLiTl]VanSCSkyman,4856,311,11,3,14,78.6%,19m
599,1,[NSKL]Tempest,4855,1156,47,38,85,55.3%,16m
600,1,IIIIIIIIIIII,4854,64,2,5,7,28.6%,36m
600,1,[F0cus]dozer,4854,0,0,1,1,0.0%,14m
602,1,IllIllIllIll,4853,1729,126,122,248,50.8%,19m
603,1,[αX]starkiller,4851,0,0,1,1,0.0%,20m
604,1,[Gpause]UareMyToy,4848,551,19,9,28,67.9%,5m
604,1,[G0G0G0]Austin,4848,0,1,0,1,100.0%,16m
604,1,BulletMagnet,4848,0,0,1,1,0.0%,37m
607,1,[xRtG]RoZ,4847,1224,39,37,76,51.3%,9m
607,1,Boulder,4847,36,2,1,3,66.7%,13m
609,1,Titan,4846,0,1,1,2,50.0%,37m
610,1,Zeus,4845,0,1,1,2,50.0%,37m
611,1,[PSC]Mokomi,4844,152,4,4,8,50.0%,14m
612,1,Vasher,4843,1992,124,113,237,52.3%,14m
613,1,[FxB]Trumpet,4842,1980,77,67,144,53.5%,5m
613,1,Predicador,4842,516,48,33,81,59.3%,16m
613,1,IIIIIIIIIIII,4842,76,2,5,7,28.6%,20m
613,1,[Aikido]Trowa,4842,0,1,0,1,100.0%,14m
613,1,Valdumiant,4842,0,0,3,3,0.0%,38m
618,1,[ZTemps]phiL,4841,1143,129,91,220,58.6%,14m
619,1,[DGGxD]Aslan,4840,1031,63,23,86,73.3%,23m
619,1,llllllllllll,4840,1094,55,29,84,65.5%,14m
619,1,[EUonNA]PlayerFromEu,4840,524,19,8,27,70.4%,23m
619,1,[xGenGx]ForeverX,4840,0,0,1,1,0.0%,18m
623,1,[xRtG]ManofMany,4839,320,9,7,16,56.2%,5m
624,1,Panic,4838,2146,85,65,150,56.7%,11m
624,1,Benni,4838,802,42,11,53,79.2%,11m
624,1,RedJohn,4838,270,10,2,12,83.3%,38m
627,1,Willy,4837,974,31,36,67,46.3%,4m
628,1,smoothbrain,4835,1266,48,45,93,51.6%,9m
628,1,RISE,4835,491,27,28,55,49.1%,8m
628,1,Iris,4835,164,5,3,8,62.5%,8m
628,1,[PSISTM]intense,4835,180,5,4,9,55.6%,32m
632,1,IIIIIIIIIIII,4834,0,0,1,1,0.0%,23m
633,1,[TEOG]AquaticRag,4833,1609,62,58,120,51.7%,14m
633,1,[Msia]TwoTrickPony,4833,1370,50,47,97,51.5%,38m
633,1,[Lp]BrEnDaN,4833,97,1,6,7,14.3%,23m
636,3,[ScSwrm]MeomaikaFan,4832,26,3,2,5,60.0%,10m
637,1,[BRAAAP]Timorus,4831,678,21,18,39,53.8%,38m
638,1,[Cryptc]CyStorm,4830,2950,364,363,727,50.1%,38m
639,1,[RBTH]sUb,4829,2876,312,270,582,53.6%,23m
639,1,IlIlllIIll,4829,591,22,12,34,64.7%,5m
641,1,[YUNHAO]HopoponoJr,4828,1290,47,43,90,52.2%,5m
642,1,Implying,4827,2287,112,88,200,56.0%,9m
643,1,LoraX,4826,1717,162,143,305,53.1%,8m
644,1,GoodGame,4825,126,4,4,8,50.0%,37m
645,1,[PiGPan]Nopret,4823,2124,80,86,166,48.2%,23m
645,1,[LoF]TheGladiator,4823,1080,37,37,74,50.0%,37m
647,1,toslivesmatr,4822,310,9,7,16,56.2%,32m
647,1,TheIronJudge,4822,182,9,9,18,50.0%,38m
647,1,goya,4822,172,7,7,14,50.0%,19m
650,1,[ROOT]RanDOOM,4821,1320,131,130,261,50.2%,23m
650,1,[DhZPro]Novais,4821,2425,103,92,195,52.8%,19m
652,1,TheDounat,4820,1878,73,64,137,53.3%,23m
652,1,llllllllllll,4820,216,10,5,15,66.7%,19m
654,1,Analmaggot,4819,1375,67,59,126,53.2%,14m
654,1,[FBK]SourSpinach,4819,210,8,6,14,57.1%,11m
656,1,[ValidG]YolBolsun,4818,2125,97,77,174,55.7%,38m
656,1,Jonathan,4818,452,13,10,23,56.5%,32m
658,1,GeNieS,4816,400,27,1,28,96.4%,13m
658,1,[xRtG]HondaCivic,4816,132,5,4,9,55.6%,9m
658,1,MAnGiuJi,4816,0,1,0,1,100.0%,23m
661,1,[UpeV]Dijovi,4815,2931,752,695,1447,52.0%,14m
661,1,[DGiT]Padre,4815,0,0,1,1,0.0%,16m
663,1,[Expand]Galeforce,4814,2342,108,100,208,51.9%,14m
663,1,Noise,4814,144,4,2,6,66.7%,23m
663,1,Shion,4814,44,1,1,2,50.0%,8m
666,1,[αX]KOBA,4813,417,19,8,27,70.4%,5m
667,1,[L4CRA]LaMamaDelron,4812,2802,187,153,340,55.0%,23m
667,1,PetiteTulipe,4812,553,23,14,37,62.2%,19m
669,1,[CDGT]Aurora,4811,0,1,0,1,100.0%,8m
670,1,Shaiden,4809,484,13,20,33,39.4%,5m
670,1,WigglyWeenie,4809,132,5,5,10,50.0%,32m
672,1,[OIGE]Andrezinho,4808,40,1,1,2,50.0%,13m
673,1,IvoryPoodle,4807,1101,39,35,74,52.7%,19m
673,1,[NalsEz]IIIIIIIIIIII,4807,358,18,7,25,72.0%,38m
673,1,[PhysRL]IIIIIIIIIIII,4807,0,1,0,1,100.0%,9m
676,1,Mephistoss,4806,236,32,24,56,57.1%,13m
676,1,Byu,4806,315,11,7,18,61.1%,14m
676,1,[NOBULY]Billy,4806,0,0,1,1,0.0%,13m
679,1,Cata,4805,1132,73,29,102,71.6%,19m
679,1,[DhZCom]DakkoN,4805,1448,57,50,107,53.3%,38m
681,1,[BmJn]marmcode,4804,119,3,1,4,75.0%,8m
682,1,[UofC]iloveoof,4803,942,132,132,264,50.0%,23m
682,1,LazyTurtle,4803,196,25,16,41,61.0%,14m
682,1,[GGBr0]YMDYUKI,4803,0,1,0,1,100.0%,19m
685,1,Zax,4801,0,0,1,1,0.0%,20m
686,1,[GRNSKN]GoochGoblin,4800,898,40,22,62,64.5%,5m
686,1,[TSØP]jomare,4800,1134,35,38,73,47.9%,5m
686,1,ezBoys,4800,671,28,16,44,63.6%,9m
686,1,CHIREN,4800,226,7,5,12,58.3%,11m
686,1,[1E100]YolBolsun,4800,74,2,3,5,40.0%,23m
691,1,ChartU,4799,160,5,15,20,25.0%,9m
691,1,[SHPony]lIlIlIlIlIlI,4799,0,0,5,5,0.0%,38m
691,1,llllllllllll,4799,0,0,6,6,0.0%,38m
694,1,Boomer,4798,467,17,12,29,58.6%,13m
694,1,CarGO,4798,0,1,0,1,100.0%,21m
696,1,IIIIIIIIIIII,4797,552,33,11,44,75.0%,38m
697,1,[TGCrew]Kamito,4796,180,13,10,23,56.5%,16m
698,1,marmcode,4795,996,33,29,62,53.2%,14m
698,1,BloOdSquad,4795,670,21,27,48,43.8%,16m
698,1,Makoto,4795,195,10,3,13,76.9%,23m
701,1,[JIGLY]Pegging,4794,151,7,1,8,87.5%,14m
701,1,tSu,4794,0,1,0,1,100.0%,9m
701,1,[LowIQ]Elryia,4794,0,1,0,1,100.0%,16m
704,1,llllllllllll,4793,0,2,6,8,25.0%,32m
705,1,ThuNdeR,4792,849,25,26,51,49.0%,23m
705,1,llllllllllll,4792,423,16,10,26,61.5%,20m
705,1,Antonio,4792,0,1,0,1,100.0%,38m
705,1,[BEANNN]Tim,4792,92,1,1,2,50.0%,37m
709,1,IIIIIIIIIIII,4791,656,45,30,75,60.0%,23m
709,1,Nate,4791,1051,35,42,77,45.5%,14m
709,1,nikwelik,4791,399,18,11,29,62.1%,23m
709,1,JonathaN,4791,129,4,2,6,66.7%,32m
709,1,[JxT]NoX,4791,91,3,0,3,100.0%,23m
714,1,Antoine,4790,2890,468,428,896,52.2%,14m
714,1,[MadK]Mavos,4790,485,22,15,37,59.5%,23m
714,1,GOOBA,4790,0,4,1,5,80.0%,8m
717,1,[Black0]Galeno,4789,103,2,2,4,50.0%,38m
717,1,[TEGRD]Sangjin,4789,0,0,1,1,0.0%,16m
719,1,Alchemist,4787,2807,442,388,830,53.3%,5m
719,1,Candle,4787,2195,116,122,238,48.7%,20m
719,1,[ICORNI]BYoneFive,4787,2282,96,85,181,53.0%,9m
719,1,[NovaX]Imagine,4787,1234,55,50,105,52.4%,19m
719,1,[TGCrew]snac,4787,570,32,18,50,64.0%,37m
719,1,[NanoX]JoooooooooO,4787,478,15,13,28,53.6%,14m
725,1,[αX]OhrlRokK,4786,2437,315,266,581,54.2%,38m
725,1,[αXLa]Supremo,4786,2188,119,106,225,52.9%,11m
725,1,Control,4786,2293,104,90,194,53.6%,8m
725,1,[prxynb]SalbeoL,4786,152,5,3,8,62.5%,19m
729,1,Detour,4785,2018,298,281,579,51.5%,19m
729,1,lllllllll,4785,320,10,17,27,37.0%,37m
731,1,cesarsavi,4784,1948,148,126,274,54.0%,38m
731,1,Arno,4784,2262,108,100,208,51.9%,38m
731,1,Freesia,4784,735,43,21,64,67.2%,19m
731,1,Clara,4784,189,10,1,11,90.9%,38m
735,1,Magicprotoss,4783,578,29,19,48,60.4%,4m
735,1,[NPhase]Eclipse,4783,574,25,26,51,49.0%,9m
737,1,IlIlIlIlIlIl,4782,1261,44,38,82,53.7%,4m
737,1,IIIIIllllIII,4782,172,6,5,11,54.5%,11m
739,2,[X17]Day,4781,1706,83,80,163,50.9%,15m
739,1,IIIIIIIIIIII,4781,244,33,4,37,89.2%,32m
741,1,[Sc9Maf]ChesterPA,4780,320,8,10,18,44.4%,8m
742,1,[KingSC]ScandalCry,4779,124,3,8,11,27.3%,11m
742,1,Chaeyong,4779,0,1,2,3,33.3%,9m
742,2,JaRdO,4779,0,0,1,1,0.0%,20m
745,1,[DETER]WESTWOOD,4778,2837,130,103,233,55.8%,16m
745,1,VeinS,4778,361,10,6,16,62.5%,5m
747,2,Nalyd,4777,0,1,0,1,100.0%,15m
747,1,[Gainss]CheeseKing,4777,0,0,2,2,0.0%,20m
749,2,JameSFlovi,4776,172,6,3,9,66.7%,4m
750,2,GambiT,4775,66,3,2,5,60.0%,15m
750,2,[FANXY]Darkwalle,4775,38,2,0,2,100.0%,4m
752,2,Cacty,4774,403,24,1,25,96.0%,20m
752,1,Goosejuice,4774,0,1,3,4,25.0%,10m
754,1,[4evr]NAchobo,4773,2655,317,282,599,52.9%,9m
754,2,[Hoxy]youboonam,4773,239,10,2,12,83.3%,22m
754,1,DISTURB,4773,282,8,7,15,53.3%,8m
754,2,SojuLover,4773,0,0,1,1,0.0%,25m
758,1,BicBoi,4772,796,26,21,47,55.3%,19m
758,1,[AlIin]Yoyo,4772,498,12,12,24,50.0%,19m
758,2,[FFAA]Batash,4772,24,1,1,2,50.0%,20m
761,1,[NeAs]MaelG,4771,0,1,0,1,100.0%,35m
762,1,[ValidG]RabidMonkey,4770,2684,341,352,693,49.2%,38m
763,1,hasuuCrAfT,4769,156,4,5,9,44.4%,5m
763,2,[GnR]MaTheuS,4769,18,1,1,2,50.0%,4m
765,1,[SsaYnS]BigDaddy,4767,2896,324,285,609,53.2%,13m
765,2,[MadK]JicD,4767,1085,80,41,121,66.1%,30m
767,2,llllllllllll,4766,662,33,8,41,80.5%,4m
767,3,Geralt,4766,0,1,0,1,100.0%,28m
769,1,llllllllllll,4765,1744,169,151,320,52.8%,9m
770,2,[B1GNut]LoadeD,4764,1622,82,72,154,53.2%,15m
770,1,[miKi1]ikoina,4764,362,14,5,19,73.7%,23m
770,1,[CaptA]Frotz,4764,0,2,3,5,40.0%,37m
770,2,everNExt,4764,0,1,0,1,100.0%,32m
774,1,LilCreator,4763,374,18,8,26,69.2%,11m
775,1,[UpeV]Tailon,4762,2547,272,237,509,53.4%,9m
776,1,[lCY]CammyGreen,4761,2896,787,717,1504,52.3%,38m
777,1,[dLife]Pursuit,4760,315,10,12,22,45.5%,14m
778,2,[M1A5]CoolFight,4759,0,0,1,1,0.0%,25m
779,1,[SsaYnS]Paladin,4758,1462,56,50,106,52.8%,13m
779,1,ShowinG,4758,592,19,23,42,45.2%,16m
779,2,[BmJn]MrHammer,4758,60,2,1,3,66.7%,25m
782,1,Decadence,4757,1611,270,241,511,52.8%,37m
783,1,[FabIed]Integral,4755,1022,39,37,76,51.3%,9m
784,1,Twachs,4754,1874,78,65,143,54.5%,19m
785,2,Gargamel,4753,0,1,0,1,100.0%,2h
786,1,IIIIIIIIIIII,4752,2899,272,248,520,52.3%,20m
786,1,December,4752,2812,205,187,392,52.3%,11m
786,1,Kurohige,4752,220,5,8,13,38.5%,5m
789,1,[UpeV]RasmusTR,4751,1960,80,74,154,51.9%,32m
789,1,llllllllllll,4751,93,2,4,6,33.3%,9m
789,2,[GnR]JongleBolls,4751,0,0,1,1,0.0%,23m
789,2,[LimaZC]steimers,4751,0,0,1,1,0.0%,23m
793,1,tipu,4748,2891,448,474,922,48.6%,20m
793,1,[UFL]Flench,4748,1038,39,29,68,57.4%,23m
795,1,llllllllllll,4747,1401,111,90,201,55.2%,5m
795,1,[DGGLOL]Pacjax,4747,698,47,23,70,67.1%,14m
797,1,KiwiTaco,4746,2888,247,226,473,52.2%,32m
797,1,[IXL]GnuGnu,4746,485,28,22,50,56.0%,14m
799,1,[eXoPH]eXoDaSh,4745,2338,257,263,520,49.4%,9m
800,2,InsideAbyss,4744,221,8,1,9,88.9%,2h
800,2,[eviNA]EVILOTOSS,4744,58,2,2,4,50.0%,19m
800,2,KillazZ,4744,18,1,1,2,50.0%,25m
803,2,Apple,4743,332,19,6,25,76.0%,19m
804,1,[SsaYnS]SaltMiner,4742,1323,63,50,113,55.8%,11m
805,2,llIIllIIllII,4741,1144,141,143,284,49.6%,37m
805,2,JumboTron,4741,697,36,11,47,76.6%,1m
805,2,Parkness,4741,0,1,0,1,100.0%,37m
808,1,[iMkS]lDunkaNl,4739,2393,593,554,1147,51.7%,38m
809,1,[PTHero]ieLLiMo,4737,1882,72,75,147,49.0%,8m
809,1,[ROCKSC]BAEM,4737,530,15,16,31,48.4%,38m
811,2,Corolla,4736,0,1,0,1,100.0%,27m
812,2,llllllllllll,4734,0,0,2,2,0.0%,32m
813,2,illusion,4733,0,1,0,1,100.0%,4m
814,1,[Exehn]Topspin,4732,2864,160,138,298,53.7%,16m
814,1,llllllllllll,4732,803,65,63,128,50.8%,16m
814,2,[Ex0n]Zen,4732,38,2,2,4,50.0%,15m
817,2,[NwAs]StarHunter,4730,330,12,10,22,54.5%,20m
817,2,[eXoNeu]Gerald,4730,110,3,1,4,75.0%,32m
817,2,edge,4730,0,0,1,1,0.0%,19m
820,3,IIIIIIIIIIII,4729,0,0,1,1,0.0%,17m
821,1,IIIIIIIIIIII,4728,2867,135,120,255,52.9%,5m
821,1,weston,4728,1540,70,82,152,46.1%,37m
821,1,llllllllllll,4728,172,4,6,10,40.0%,19m
824,1,LoneFox,4727,292,12,11,23,52.2%,23m
825,1,IIIIIIIIIIII,4726,315,32,12,44,72.7%,23m
826,1,llllllllllll,4724,761,41,16,57,71.9%,32m
826,2,[xRtG]MacUseR,4724,426,18,16,34,52.9%,27m
828,1,[G0G0G0]JoaoPistori,4722,0,2,3,5,40.0%,38m
829,1,[SCxPH]Pobbes,4721,2475,169,156,325,52.0%,38m
829,3,Pyun,4721,16,3,1,4,75.0%,10m
829,2,Parecnik,4721,0,0,1,1,0.0%,20m
832,1,hyoon,4720,1367,46,47,93,49.5%,23m
833,2,[RTN]Newbi,4719,1397,68,51,119,57.1%,17m
834,1,IllIIlIIIlII,4718,2863,360,323,683,52.7%,23m
834,1,[ValidG]Najdorf,4718,1464,54,54,108,50.0%,20m
834,1,[Shrek5]Ryuga,4718,850,31,30,61,50.8%,23m
834,2,ICE,4718,0,1,0,1,100.0%,32m
838,1,JonathanXIV,4717,1332,49,51,100,49.0%,32m
839,2,[1GODS1]UNIVERSAL,4716,234,9,3,12,75.0%,15m
840,1,MulletDog,4715,2009,454,418,872,52.1%,32m
840,1,urukabarr,4715,2904,242,199,441,54.9%,32m
840,2,Nepal,4715,32,1,3,4,25.0%,17m
840,1,Sephiroth,4715,0,0,1,1,0.0%,21m
840,2,WENDEN,4715,0,0,2,2,0.0%,22m
845,1,Zero,4714,2873,341,312,653,52.2%,23m
845,1,DirDevil,4714,536,45,15,60,75.0%,5m
847,1,[MBTW]Rowey,4713,803,26,26,52,50.0%,23m
848,1,EniGma,4712,1196,44,45,89,49.4%,19m
848,2,BamgOOraY,4712,0,1,1,2,50.0%,15m
850,1,[EEJ]hodenkobold,4711,196,7,10,17,41.2%,9m
850,2,Nontheist,4711,0,0,1,1,0.0%,19m
852,1,TerranEz,4710,2859,875,860,1735,50.4%,19m
852,2,[iMkS]SoldieR,4710,14,2,0,2,100.0%,1m
854,2,Neo,4709,174,7,8,15,46.7%,20m
855,3,Polaris,4708,121,3,0,3,100.0%,10m
855,2,[LREM]MrCastaner,4708,0,3,2,5,60.0%,15m
855,2,IIIIIIIIIIII,4708,0,0,3,3,0.0%,19m
858,2,[αX]Swaghar,4707,392,18,18,36,50.0%,30m
859,1,[BYU]DelisDaily,4706,757,60,49,109,55.0%,37m
860,1,MimonBaraka,4701,48,3,3,6,50.0%,37m
860,1,[GdAT]Nuks,4701,0,1,4,5,20.0%,23m
860,2,IlIlllIIIIII,4701,0,0,1,1,0.0%,27m
863,1,IllIIllllIIl,4700,749,41,27,68,60.3%,38m
863,1,sleepy,4700,667,27,24,51,52.9%,11m
863,2,llllllllll,4700,168,7,2,9,77.8%,2h
866,1,roachan,4699,48,2,0,2,100.0%,32m
867,2,[xRtG]Zeus,4698,2149,561,537,1098,51.1%,19m
868,1,[RnGpro]Goomba,4697,2406,97,93,190,51.1%,9m
869,2,Lampara,4696,0,0,2,2,0.0%,1m
870,2,IamSpS,4694,98,4,7,11,36.4%,17m
870,2,InsoydGaymin,4694,18,1,4,5,20.0%,1m
872,1,nilk,4692,1996,178,134,312,57.1%,19m
872,2,[UpeV]Everness,4692,2277,106,91,197,53.8%,15m
872,1,[NPhase]AsIBreathe,4692,2298,99,94,193,51.3%,11m
872,2,Stigma,4692,230,10,12,22,45.5%,23m
876,2,lIllIIllII,4691,934,56,19,75,74.7%,15m
876,2,DRCOCKTER,4691,88,3,3,6,50.0%,20m
878,2,RosscO,4689,0,1,1,2,50.0%,20m
879,1,CBK,4687,180,6,10,16,37.5%,23m
880,2,Joconut,4686,798,43,36,79,54.4%,23m
880,2,Sorrygtg,4686,257,14,4,18,77.8%,27m
880,2,[FRNAVY]Beltalowda,4686,66,4,7,11,36.4%,1m
880,2,llllllllllll,4686,0,1,0,1,100.0%,30m
884,1,chelseafan,4685,2824,257,263,520,49.4%,16m
885,2,TossPro,4684,285,31,5,36,86.1%,19m
885,2,AlanGarcia,4684,325,14,6,20,70.0%,25m
885,2,hello,4684,64,3,1,4,75.0%,22m
888,2,DontPanic,4683,1591,130,84,214,60.7%,17m
888,1,[siska]LoLy,4683,1271,48,47,95,50.5%,23m
888,2,[TXOP]Øtter,4683,668,29,32,61,47.5%,27m
888,2,ForAiur,4683,492,23,24,47,48.9%,1m
888,2,IIIIIIIIIIII,4683,402,13,13,26,50.0%,15m
893,2,[NwAs]Sebas,4681,2646,331,360,691,47.9%,19m
893,1,Finnlock,4681,0,0,1,1,0.0%,21m
895,2,[Yuhang]Guider,4680,1083,77,70,147,52.4%,2h
895,2,[EtrOy]helloworld,4680,684,33,27,60,55.0%,2h
897,2,[G0G0G0]OverHero,4679,527,27,15,42,64.3%,1m
897,1,[xTQc]InZo,4679,0,1,5,6,16.7%,16m
899,2,Spirit,4678,666,36,34,70,51.4%,25m
899,2,Enigma,4678,0,0,1,1,0.0%,22m
901,2,IIIIIIIIIIII,4677,455,28,1,29,96.6%,15m
901,2,[EPSTIN]DINTKILHMSF,4677,154,9,4,13,69.2%,25m
901,2,[ChrisM]Chris,4677,94,6,3,9,66.7%,15m
904,2,PhoenixKING,4676,149,6,5,11,54.5%,17m
905,2,BWBishOp,4675,855,48,22,70,68.6%,1m
905,2,[BmJn]OuO,4675,222,8,8,16,50.0%,32m
907,1,[FvR]Flamyblade,4674,2789,443,423,866,51.2%,23m
908,1,Bomber,4673,1255,59,48,107,55.1%,13m
909,2,llllllllllll,4672,305,24,14,38,63.2%,37m
909,2,Pachacutec,4672,326,17,10,27,63.0%,37m
909,2,[TGCrew]BasherSlice,4672,235,11,10,21,52.4%,32m
912,2,LifeBook,4671,796,42,27,69,60.9%,19m
912,1,XIX,4671,178,5,10,15,33.3%,38m
914,1,[X17]Anfield,4668,1680,210,189,399,52.6%,13m
914,1,SnapCryptic,4668,192,7,9,16,43.8%,35m
916,2,llllllllllll,4667,500,21,17,38,55.3%,4m
917,2,Mectojic,4666,1919,114,101,215,53.0%,2h
917,1,[JURT]KarrA,4666,109,4,11,15,26.7%,10m
917,2,PainGamer,4666,94,3,10,13,23.1%,25m
920,2,Ggo,4665,78,5,6,11,45.5%,27m
921,2,DFTBA,4663,2616,127,154,281,45.2%,37m
921,2,[TOYOTA]CamryPower,4663,440,16,16,32,50.0%,32m
921,2,[DeNabr]UrUncleWang,4663,0,0,2,2,0.0%,23m
924,2,[MDPKR]Walujie,4662,1981,121,101,222,54.5%,27m
924,2,[Sappho]Scarlett,4662,77,2,0,2,100.0%,2h
926,2,stephano,4658,670,49,23,72,68.1%,23m
927,2,[SttE]wam,4657,28,1,4,5,20.0%,15m
928,1,DirDevil,4656,1554,147,133,280,52.5%,19m
928,2,Thx,4656,0,0,1,1,0.0%,27m
930,1,gucci,4655,2266,131,118,249,52.6%,19m
931,1,[LCE]llllllllllll,4654,1523,58,67,125,46.4%,14m
932,1,flumph,4653,479,25,18,43,58.1%,5m
932,2,MarineKid,4653,106,3,2,5,60.0%,19m
932,2,xXHaVoCXx,4653,0,0,1,1,0.0%,20m
935,1,[ScSwrm]IronLung,4652,2816,335,380,715,46.9%,38m
935,2,[CCAV]LxAnki,4652,113,6,2,8,75.0%,37m
935,2,DataMiner,4652,108,6,6,12,50.0%,27m
935,2,[InGt]Kal,4652,0,1,0,1,100.0%,20m
939,1,LastHorizon,4651,990,43,40,83,51.8%,38m
939,1,Chimp,4651,1116,38,44,82,46.3%,20m
939,2,MMRThief,4651,183,14,1,15,93.3%,22m
939,2,[KiMBR]gringo,4651,90,4,0,4,100.0%,2h
943,2,llllllllll,4650,538,32,7,39,82.1%,1m
944,2,IIIIIIIIIIII,4649,1306,54,59,113,47.8%,1m
945,2,Chayanne,4648,1368,65,40,105,61.9%,17m
945,2,Mordrago,4648,44,3,3,6,50.0%,17m
947,1,SethN,4646,234,8,15,23,34.8%,10m
948,1,Practice,4645,1243,60,64,124,48.4%,14m
949,2,[LQV]TronBurnBant,4644,1928,286,223,509,56.2%,1m
949,2,llllllllllll,4644,58,2,1,3,66.7%,19m
951,2,Spotlight,4643,34,1,1,2,50.0%,25m
952,2,[X17]LennoxLewis,4642,174,9,1,10,90.0%,37m
953,2,Ascend,4641,2331,192,196,388,49.5%,27m
953,2,[xRtG]cHuT,4641,0,0,1,1,0.0%,32m
955,2,[AKLsc]KaganTuya,4639,0,1,0,1,100.0%,27m
955,2,Xormentor,4639,0,0,1,1,0.0%,15m
957,2,[SUOMI]Luolis,4638,132,4,3,7,57.1%,1m
958,2,[UVUSC2]DocCoaster,4637,1503,73,58,131,55.7%,23m
958,2,[inCo]Ryerye,4637,68,4,3,7,57.1%,37m
958,2,[IDFI]MeomaikaFan,4637,22,2,1,3,66.7%,15m
958,1,[Ex0n]Bioice,4637,0,0,12,12,0.0%,5m
962,2,[INextI]Bogue,4635,30,1,7,8,12.5%,15m
963,2,Jusseppe,4634,570,24,24,48,50.0%,25m
964,2,[LimaZC]steimers,4633,269,11,1,12,91.7%,25m
964,2,[mvengo]LarryCapija,4633,177,9,2,11,81.8%,27m
964,2,[X17]Green,4633,0,0,2,2,0.0%,27m
967,1,Redinferno,4632,2830,407,370,777,52.4%,38m
968,2,[G0G0G0]OverHero,4631,182,5,3,8,62.5%,27m
969,1,TwitchMaster,4630,939,34,35,69,49.3%,14m
969,2,[PeF]PENHA,4630,0,1,0,1,100.0%,27m
969,2,[LimaSC]SoldieR,4630,0,1,0,1,100.0%,2h
972,1,[GØSU]Kandrew,4629,2085,90,93,183,49.2%,23m
972,1,IlIlIlIlI,4629,343,12,17,29,41.4%,14m
972,2,[PPayne]FenrisWolf,4629,86,5,3,8,62.5%,37m
972,2,GUMGUMRuFFy,4629,0,1,1,2,50.0%,27m
976,2,[TMMM]Achilles,4628,968,47,37,84,56.0%,32m
976,2,TossDudr,4628,699,40,26,66,60.6%,30m
976,2,jaMz,4628,771,38,18,56,67.9%,15m
976,2,[LimaSC]KamoTee,4628,0,0,1,1,0.0%,15m
980,1,[ValidG]Bockelypse,4626,2697,349,344,693,50.4%,20m
980,1,[TYRNT]Yharim,4626,356,12,14,26,46.2%,38m
980,2,kappacheese,4626,0,0,1,1,0.0%,30m
983,2,[BoRnGo]Steffan,4625,1450,63,66,129,48.8%,19m
983,2,[G0G0G0]EvilHero,4625,124,4,3,7,57.1%,1m
983,2,Flos,4625,0,1,0,1,100.0%,23m
986,2,Bairdo,4624,402,22,17,39,56.4%,37m
986,2,llllllllllll,4624,180,5,8,13,38.5%,15m
986,2,Imagine,4624,122,5,10,15,33.3%,37m
986,2,Archon,4624,18,2,2,4,50.0%,27m
990,1,[CIoud9]IlllllI,4623,395,13,4,17,76.5%,32m
990,2,[ArGNA]Truth,4623,0,1,0,1,100.0%,1m
992,2,Gcy,4622,0,0,1,1,0.0%,37m
993,1,[RVluv]TLQKFSUSEMF,4621,0,2,4,6,33.3%,21m
994,2,[F0cus]crymeareaver,4620,296,15,14,29,51.7%,15m
994,2,[nG]SupeRBrutE,4620,82,3,6,9,33.3%,27m
994,2,Harbinger,4620,34,2,7,9,22.2%,20m
997,2,IIIIIIIIIIII,4619,1519,133,111,244,54.5%,37m
998,3,Trap,4618,279,10,2,12,83.3%,28m
999,2,[iMmsV]OwNaGe,4617,2447,128,130,258,49.6%,15m
999,2,IIIIIIIIIIII,4617,1137,56,31,87,64.4%,27m
999,2,ZKay,4617,908,46,34,80,57.5%,1m
999,1,lllIIIlllIII,4617,92,6,14,20,30.0%,13m
999,2,[Ris3n]MrNoBOdYZile,4617,62,4,0,4,100.0%,30m
999,1,ambient,4617,144,4,5,9,44.4%,37m
1005,1,[GRNSKN]ChiefColin,4616,1487,69,58,127,54.3%,23m
1006,1,TossNSalads,4615,2283,214,229,443,48.3%,13m
1006,2,[SydTT]ByuN,4615,767,45,38,83,54.2%,25m
1006,2,SweetChickP,4615,574,36,12,48,75.0%,30m
1009,2,[ARTY]RaiLz,4614,68,3,2,5,60.0%,32m
1009,2,[RokKU]NoFTwoToss,4614,34,2,2,4,50.0%,5m
1011,1,[NPat]SirReal,4613,2710,130,117,247,52.6%,23m
1011,2,llIlIIIllIlI,4613,26,2,0,2,100.0%,15m
1013,2,[lllI]Aerocool,4612,724,35,28,63,55.6%,5m
1013,2,ripper,4612,312,20,1,21,95.2%,20m
1013,2,Nice,4612,0,0,2,2,0.0%,17m
1016,1,BlackRa,4611,2670,210,235,445,47.2%,14m
1016,2,HAPPYGUY,4611,1104,60,28,88,68.2%,5m
1016,2,CreatorJEJA,4611,202,6,9,15,40.0%,27m
1016,2,BossK,4611,40,2,5,7,28.6%,30m
1020,2,[DirtyP]Wubbey,4610,973,42,46,88,47.7%,27m
1020,1,Xsir,4610,1012,35,46,81,43.2%,14m
1020,2,[Probuu]grub,4610,199,8,5,13,61.5%,1m
1020,2,llllllllllll,4610,99,5,4,9,55.6%,27m
1024,1,KOBA,4609,2404,143,165,308,46.4%,14m
1024,2,WatMatson,4609,0,0,1,1,0.0%,25m
1026,2,[CUTEST]Livibee,4608,1520,66,66,132,50.0%,15m
1026,2,[PCAKE]Anewb,4608,1023,54,54,108,50.0%,37m
1026,1,[UpxV]Kaguya,4608,742,22,35,57,38.6%,4m
1029,2,llllllllllll,4607,74,4,3,7,57.1%,25m
1029,2,Bonjwa,4607,0,1,4,5,20.0%,5m
1031,1,Oniichan,4606,2175,132,122,254,52.0%,23m
1031,2,MrJack,4606,994,41,42,83,49.4%,15m
1031,2,chilax,4606,48,2,1,3,66.7%,19m
1031,2,[AKLsc]Kupoop,4606,0,1,0,1,100.0%,32m
1031,2,GLHF,4606,0,1,0,1,100.0%,32m
1031,2,[TGosuB]SimplePickUp,4606,0,0,1,1,0.0%,17m
1037,2,[WarpDT]Heaven,4605,0,0,1,1,0.0%,15m
1038,2,[SABO]Saboteur,4604,559,32,22,54,59.3%,5m
1039,1,[Cryptc]Lazorcat,4603,2799,185,194,379,48.8%,5m
1039,2,DirDevil,4603,1422,71,67,138,51.4%,30m
1039,2,DUKnowKimchi,4603,80,7,6,13,53.8%,15m
1039,2,[ArGNA]Warren,4603,0,1,0,1,100.0%,15m
1039,2,[64]mbp,4603,0,1,0,1,100.0%,15m
1039,2,[JIGLY]MèoMáiKà,4603,44,1,2,3,33.3%,23m
1045,2,XIV,4602,335,16,12,28,57.1%,27m
1046,2,[AthSun]Vanillasky,4601,1155,161,175,336,47.9%,2h
1046,2,[xTQc]Freak,4601,980,43,48,91,47.3%,27m
1046,2,[Niners]kirby,4601,143,3,2,5,60.0%,17m
1049,2,Gambeulin,4600,158,12,7,19,63.2%,17m
1049,2,[CaptA]CrimsonChaos,4600,160,8,5,13,61.5%,27m
1051,2,NoMERCYSoChi,4599,951,49,42,91,53.8%,25m
1051,3,hugetjfan,4599,97,1,2,3,33.3%,9m
1053,2,Boo,4598,176,7,9,16,43.8%,25m
1053,2,Megatron,4598,146,5,11,16,31.2%,32m
1053,2,Tambi,4598,0,0,1,1,0.0%,27m
1056,2,IlIIlIIlIIIl,4597,108,3,1,4,75.0%,27m
1056,2,IIIIIIIIIIII,4597,46,3,2,5,60.0%,5m
1056,2,[G0G0G0]XingLing,4597,0,1,0,1,100.0%,19m
1059,2,llllllllllll,4596,2285,109,79,188,58.0%,19m
1059,2,[Perfec]Frontstab,4596,388,18,15,33,54.5%,25m
1059,2,Ratimus,4596,42,2,3,5,40.0%,19m
1062,2,Yugo,4595,1347,102,83,185,55.1%,15m
1062,2,[αB]Slayer,4595,297,16,9,25,64.0%,22m
1062,2,[FANXY]Tsubaki,4595,96,5,4,9,55.6%,30m
1062,2,[GTs]Lunchador,4595,16,1,1,2,50.0%,23m
1066,2,HesiHeyyyy,4594,898,68,34,102,66.7%,20m
1067,2,[CBDThc]Pureindicaaa,4593,1236,240,197,437,54.9%,32m
1067,2,[SttE]MastaBaitr,4593,203,7,3,10,70.0%,25m
1067,2,[SC2BOL]Dark,4593,108,4,2,6,66.7%,25m
1070,1,[BoAVN]AshenOne,4592,1176,67,63,130,51.5%,32m
1070,2,Gundamluis,4592,114,5,1,6,83.3%,1m
1070,2,[WeLike]TraNceFreAK,4592,52,3,2,5,60.0%,20m
1073,1,[eX]DTWB,4591,2475,362,320,682,53.1%,23m
1073,2,IIIIIIIIIIII,4591,602,35,13,48,72.9%,5m
1073,1,Skyblue,4591,48,2,0,2,100.0%,28m
1076,2,[UpeV]PicudoCDMX,4590,250,12,17,29,41.4%,20m
1076,2,[Brober]Shard,4590,0,0,1,1,0.0%,25m
1078,2,[4RUM]DerMeister,4589,770,41,38,79,51.9%,19m
1078,2,[IDFI]Demi,4589,12,1,7,8,12.5%,15m
1078,2,DarkPrelate,4589,0,0,1,1,0.0%,19m
1081,2,lllIlIlIlIlI,4588,2490,185,181,366,50.5%,30m
1081,2,CheeseKingX,4588,2222,112,96,208,53.8%,17m
1083,2,TossDudr,4587,1027,111,101,212,52.4%,15m
1083,2,GGoChio,4587,110,4,8,12,33.3%,30m
1083,2,[DETER]Elcactus,4587,0,1,0,1,100.0%,19m
1086,2,[TOXlC]eXiled,4586,78,5,7,12,41.7%,32m
1087,2,Killa,4584,1109,62,27,89,69.7%,23m
1087,2,rende,4584,687,39,22,61,63.9%,17m
1087,2,llllllllllll,4584,459,24,3,27,88.9%,15m
1087,2,[GR33D]MagiiC,4584,298,14,10,24,58.3%,1m
1091,2,[MOBO]ZergRush,4583,0,0,1,1,0.0%,2h
1092,2,[UpeV]DarkSpear,4582,987,48,40,88,54.5%,27m
1092,2,[VaLuE]PrimeHunterZ,4582,671,41,34,75,54.7%,32m
1092,2,ShadowMoon,4582,0,1,0,1,100.0%,5m
1095,2,wEEBbLORD,4581,333,24,11,35,68.6%,20m
1095,2,[MHSX]Dreadlord,4581,385,20,13,33,60.6%,20m
1097,2,lllllllllll,4580,2607,410,431,841,48.8%,32m
1098,2,IIIIIIIIIIII,4578,78,4,7,11,36.4%,5m
1099,2,SacredCocos,4577,0,0,1,1,0.0%,1m
1100,2,Joselito,4576,495,26,21,47,55.3%,5m
1101,2,llllllllllll,4575,284,17,15,32,53.1%,19m
1101,2,Gundamluis,4575,113,5,1,6,83.3%,1m
1101,2,Cypher,4575,83,1,1,2,50.0%,20m
1104,1,VoTaN,4574,407,18,0,18,100.0%,9m
1104,2,[CornZ]Primal,4574,0,1,0,1,100.0%,15m
1104,2,[BmJn]FetchGretch,4574,0,1,1,2,50.0%,25m
1107,2,[WNTR]Maddox,4573,288,16,10,26,61.5%,17m
1107,2,[NEFN]ignorant,4573,0,1,0,1,100.0%,15m
1109,2,IplayAtWork,4571,887,48,32,80,60.0%,30m
1110,2,[AUB]Valdumiant,4570,1494,80,60,140,57.1%,15m
1111,2,[TGCrew]Cognite,4569,1646,93,104,197,47.2%,5m
1111,2,BalearicSoul,4569,112,4,7,11,36.4%,30m
1111,2,llllllllllll,4569,82,4,8,12,33.3%,22m
1111,1,IIVIVIIVIVII,4569,48,2,1,3,66.7%,26m
1111,2,[1V1BRO]DarkMaximus,4569,40,1,2,3,33.3%,19m
1111,2,RoFLatYou,4569,18,1,4,5,20.0%,20m
1117,2,NandoWORD,4568,84,5,10,15,33.3%,22m
1118,2,[xRtG]Fletch,4567,2580,466,444,910,51.2%,27m
1119,2,[Bee]BerryRAWR,4566,1448,79,82,161,49.1%,23m
1119,2,[TGosuD]Dingo,4566,373,20,13,33,60.6%,25m
1121,1,Drinkwater,4565,2710,165,171,336,49.1%,8m
1121,1,[LNGang]LaughNgamez,4565,1820,77,74,151,51.0%,38m
1121,2,[MOSU]Zeaschling,4565,326,22,9,31,71.0%,1m
1121,2,SKYTOSS,4565,364,21,18,39,53.8%,25m
1121,2,BUFFCORREL,4565,285,14,11,25,56.0%,37m
1121,2,[in4v4]iCarryNoobs,4565,54,3,2,5,60.0%,37m
1127,2,[UpeV]Lionel,4564,2357,181,195,376,48.1%,32m
1127,2,IlIlllIlIlll,4564,1200,124,121,245,50.6%,32m
1127,2,[eX]Lunarium,4564,1843,92,68,160,57.5%,5m
1127,2,BIN,4564,0,1,0,1,100.0%,17m
1127,2,MrEstrelao,4564,0,0,3,3,0.0%,19m
1132,2,[cl0udM]SarsSan,4563,480,20,20,40,50.0%,27m
1132,2,[HRBNGR]SeOuLStEaL,4563,360,14,22,36,38.9%,23m
1134,2,[NOPVP]pHSPUq,4562,2507,143,147,290,49.3%,1m
1134,2,[NwAs]Dargkor,4562,82,3,2,5,60.0%,15m
1136,2,WcERefunded,4561,2473,159,152,311,51.1%,23m
1136,2,llllllllllll,4561,300,20,11,31,64.5%,23m
1136,2,AsusWing,4561,0,0,1,1,0.0%,27m
1139,1,[αB]ReaLiTy,4560,2725,227,250,477,47.6%,14m
1139,1,IIlIIlIIIl,4560,1468,65,64,129,50.4%,20m
1139,2,LaVallière,4560,218,39,42,81,48.1%,27m
1139,2,Huh,4560,218,7,7,14,50.0%,19m
1139,2,[MyLoss]feardragon,4560,76,1,1,2,50.0%,15m
1139,2,PMC,4560,0,0,1,1,0.0%,22m
1145,1,Weedamins,4559,2708,158,152,310,51.0%,38m
1145,2,MITHRIL,4559,644,80,82,162,49.4%,30m
1145,2,[cl0udM]Eurystheus,4559,899,37,42,79,46.8%,27m
1145,2,[mmmASS]bOnGdAlF,4559,0,0,1,1,0.0%,37m
1149,1,IIIIIIIIIIII,4558,97,2,2,4,50.0%,26m
1149,2,llllllllllll,4558,0,0,1,1,0.0%,32m
1151,2,Dolmant,4557,1161,67,59,126,53.2%,5m
1151,2,[NwAs]pollomex,4557,46,2,3,5,40.0%,5m
1151,2,[AthSun]Aysymer,4557,0,0,1,1,0.0%,25m
1154,1,llllllllllll,4556,2743,964,988,1952,49.4%,37m
1154,1,PenguinX,4556,2660,535,534,1069,50.0%,19m
1154,2,Novo,4556,108,4,8,12,33.3%,2h
1157,2,atom,4555,1301,70,60,130,53.8%,5m
1157,2,[PiGPan]alpaca,4555,667,36,27,63,57.1%,15m
1159,2,RobBedstain,4554,334,29,24,53,54.7%,25m
1160,2,FLiP,4553,795,46,60,106,43.4%,32m
1160,2,[KingSC]Diegøx,4553,0,0,1,1,0.0%,32m
1162,2,[NoR20M]Roach,4552,2036,240,232,472,50.8%,19m
1162,2,JustTheTip,4552,442,17,23,40,42.5%,15m
1162,2,[DarkAG]Dro,4552,161,11,3,14,78.6%,20m
1165,2,[RevAng]SHAORAN,4551,976,44,29,73,60.3%,5m
1165,2,wTinte,4551,89,5,2,7,71.4%,23m
1167,1,Chrono,4550,1825,284,278,562,50.5%,5m
1167,2,WhosSly,4550,1022,45,48,93,48.4%,19m
1167,3,[GSXR1K]TitãSagaz,4550,24,3,0,3,100.0%,18m
1167,3,[Ruse]Zephos,4550,4,2,0,2,100.0%,28m
1171,2,Uruk,4549,1677,89,85,174,51.1%,15m
1171,3,llllllllllll,4549,0,1,0,1,100.0%,39m
1171,2,trollbert,4549,0,0,2,2,0.0%,23m
1174,3,Kyzer,4548,1563,87,57,144,60.4%,14m
1174,3,[NAFish]seworstdes,4548,10,2,0,2,100.0%,18m
1176,2,HuaCheng,4547,86,3,7,10,30.0%,23m
1176,2,SunnyR,4547,0,1,0,1,100.0%,12m
1176,3,unranked,4547,12,1,1,2,50.0%,12m
1179,2,IIIIIIIIIIII,4546,226,14,10,24,58.3%,19m
1180,1,llllllllllll,4545,2682,347,340,687,50.5%,8m
1180,2,ArtOfMeme,4545,731,32,38,70,45.7%,1m
1180,2,[gothbc]Later,4545,594,21,26,47,44.7%,23m
1180,2,WinToss,4545,99,6,3,9,66.7%,22m
1180,3,FifthRom,4545,0,1,0,1,100.0%,10m
1185,2,[PiGPan]emctwo,4543,2181,135,130,265,50.9%,27m
1186,1,AmisTheApe,4542,392,17,1,18,94.4%,29m
1186,3,TossEZrace,4542,18,4,3,7,57.1%,6m
1186,2,[HKTVB]NikiChow,4542,93,3,4,7,42.9%,22m
1186,2,[Cryptc]ElNiño,4542,70,2,15,17,11.8%,17m
1190,2,PartinG,4541,746,41,23,64,64.1%,27m
1190,3,[veggee]Kalt,4541,0,0,1,1,0.0%,9m
1190,3,MarineKing,4541,0,0,2,2,0.0%,10m
1193,2,llllllllllll,4540,2536,143,146,289,49.5%,19m
1193,2,[BUER]Carnage,4540,746,86,56,142,60.6%,27m
1195,2,llllllllllll,4539,0,2,3,5,40.0%,11m
1196,2,[Fr33ze]Wombat,4538,1345,96,91,187,51.3%,37m
1196,3,bayagster,4538,328,24,26,50,48.0%,32m
1196,2,[Y0shi]Determined,4538,232,10,13,23,43.5%,30m
1196,2,Machine,4538,84,2,3,5,40.0%,5m
1200,2,Brom,4536,444,27,15,42,64.3%,5m
1200,2,LATESTARGATE,4536,264,12,19,31,38.7%,30m
1200,3,RuNnGuN,4536,48,4,0,4,100.0%,28m
1200,2,llllllllllll,4536,100,4,9,13,30.8%,19m
1204,2,[NSKL]bustA,4535,418,18,28,46,39.1%,15m
1205,1,[αB]PoNinaBox,4534,2645,619,627,1246,49.7%,20m
1205,2,[Syh]llllllllllll,4534,2249,172,156,328,52.4%,19m
1205,2,[S0Bs]aFterMath,4534,779,44,27,71,62.0%,25m
1205,2,Hank,4534,78,1,2,3,33.3%,33m
1205,3,Young,4534,0,0,1,1,0.0%,39m
1205,3,[HappyP]AiurRefugee,4534,0,0,1,1,0.0%,6m
1205,3,[Intpro]Cronos,4534,0,0,1,1,0.0%,18m
1212,2,NotMarsman,4533,248,15,18,33,45.5%,25m
1212,3,[FTII]Xymakari,4533,0,1,0,1,100.0%,4m
1212,3,SilverBullet,4533,0,0,1,1,0.0%,30m
1215,1,Aezelon,4532,1020,80,99,179,44.7%,13m
1215,3,Deklan,4532,0,1,0,1,100.0%,12m
1217,2,asdfghjkl,4531,563,25,24,49,51.0%,27m
1218,2,[TGCF]deep,4530,1743,67,65,132,50.8%,25m
1219,1,Webster,4529,146,4,3,7,57.1%,38m
1219,3,[RUMB]BrockMiester,4529,97,1,1,2,50.0%,28m
1219,3,Nickatak,4529,0,0,1,1,0.0%,30m
1222,2,lIllllIIIIlI,4528,1632,76,81,157,48.4%,37m
1222,2,[sc2rep]Breath,4528,136,6,11,17,35.3%,2m
1222,2,drzdrzt,4528,62,3,6,9,33.3%,5m
1225,3,LighterSkies,4527,0,3,2,5,60.0%,34m
1226,2,[TGCF]Pain,4526,738,41,38,79,51.9%,33m
1226,2,[NW5]YoGoldorak,4526,324,12,15,27,44.4%,27m
1226,3,[eX]Penha,4526,0,1,0,1,100.0%,26m
1226,2,[LgnTDS]NotAgain,4526,0,0,3,3,0.0%,27m
1230,2,Nipa,4525,434,53,49,102,52.0%,19m
1230,1,llllllllllll,4525,376,11,1,12,91.7%,22m
1230,2,RoomTempIQ,4525,191,9,9,18,50.0%,5m
1230,3,Eric,4525,0,1,0,1,100.0%,32m
1230,2,Kevin,4525,0,0,2,2,0.0%,33m
1235,1,[STIEMD]SYSY,4524,248,11,3,14,78.6%,30m
1235,3,[NwAs]Anibal,4524,102,11,13,24,45.8%,4m
1235,3,Fusion,4524,6,1,2,3,33.3%,10m
1235,3,MeepMeep,4524,4,1,2,3,33.3%,37m
1235,3,Marty,4524,0,0,1,1,0.0%,7m
1240,3,TelAvivBeach,4523,0,1,4,5,20.0%,28m
1241,2,Ender,4522,667,39,36,75,52.0%,27m
1241,2,Felvo,4522,90,4,8,12,33.3%,30m
1241,3,[WAFD]Anatari,4522,0,0,1,1,0.0%,37m
1244,3,Cloudy,4521,20,4,2,6,66.7%,14m
1244,3,llllllllllll,4521,0,0,1,1,0.0%,23m
1246,1,[xLgNx]Wabbit,4520,2577,419,444,863,48.6%,14m
1246,1,trayyungATL,4520,2252,124,132,256,48.4%,16m
1248,3,[TSØP]XeLa,4518,1164,61,48,109,56.0%,34m
1249,2,llllllllllll,4517,374,21,14,35,60.0%,2m
1250,2,Tronxxx,4516,280,15,15,30,50.0%,27m
1251,2,[aivNA]Devichi,4515,0,2,2,4,50.0%,3m
1252,2,[αXLa]PassWord,4514,500,39,42,81,48.1%,30m
1252,3,[ProSC]Soujiro,4514,4,1,3,4,25.0%,2h
1254,2,FairyLaw,4513,591,29,28,57,50.9%,27m
1254,3,[GØSU]Spoonmaster,4513,0,1,0,1,100.0%,39m
1254,3,Atreidis,4513,0,1,0,1,100.0%,10m
1254,3,[Th3Bad]smoke,4513,0,0,1,1,0.0%,17m
1258,1,[αXLa]PassWord,4512,2444,224,232,456,49.1%,8m
1258,2,[UpeV]Nix,4512,239,15,11,26,57.7%,22m
1258,2,UnderNexus,4512,184,12,9,21,57.1%,17m
1261,2,[inCo]BabyNeffy,4511,371,18,21,39,46.2%,33m
1261,3,llllllllllll,4511,82,9,5,14,64.3%,30m
1261,3,cheesytosser,4511,0,1,0,1,100.0%,39m
1261,3,JAY,4511,18,1,2,3,33.3%,9m
1265,2,[AlIin]zumpy,4510,2340,129,121,250,51.6%,2h
1265,3,[KANGS]Masturbinho,4510,0,1,0,1,100.0%,6m
1265,3,[JaMiT]Husky,4510,0,0,1,1,0.0%,32m
1268,3,iiiiiiiiiiii,4509,0,0,1,1,0.0%,12m
1269,2,llllllllllll,4508,154,7,8,15,46.7%,23m
1270,1,IlllllIlIlll,4506,2666,739,722,1461,50.6%,32m
1270,2,IMYURI,4506,2438,295,289,584,50.5%,17m
1270,3,[7B]BestOfSeven,4506,0,1,0,1,100.0%,6m
1273,3,Ziddy,4505,2184,208,198,406,51.2%,28m
1273,2,[eX]Lunarium,4505,1113,59,31,90,65.6%,37m
1273,2,[Busan]IIIIIIIIIIII,4505,530,32,33,65,49.2%,15m
1273,3,QuEWeZz,4505,8,1,1,2,50.0%,18m
1277,2,Dayi,4503,870,49,28,77,63.6%,15m
1277,2,MrSnrub,4503,789,44,22,66,66.7%,17m
1277,3,[NPhase]MeronG,4503,8,2,1,3,66.7%,17m
1277,3,[G0G0G0]Kienzays,4503,0,1,0,1,100.0%,30m
1281,2,GooD,4502,1549,91,87,178,51.1%,27m
1281,2,TheRock,4502,565,31,29,60,51.7%,23m
1281,3,[Atira]Akoo,4502,172,18,6,24,75.0%,6m
1284,3,RenieHouR,4501,552,38,8,46,82.6%,12m
1284,2,[VetZCo]Ben,4501,462,22,20,42,52.4%,5m
1284,3,SuperMetroid,4501,0,0,1,1,0.0%,12m
1284,3,[FANXY]Paul,4501,0,0,1,1,0.0%,7m
1288,2,[MadK]Shellbee,4500,425,26,25,51,51.0%,17m
1289,3,[zling1]stabs,4499,2315,551,557,1108,49.7%,37m
1290,3,[N0FKz]hershy,4498,0,0,1,1,0.0%,7m
1291,3,[AlIin]YoMamaCore,4497,38,5,2,7,71.4%,2h
1291,1,[GTBIG]Rayden,4497,96,2,5,7,28.6%,19m
1291,3,[PSISTM]Freeedom,4497,0,1,0,1,100.0%,11m
1291,2,DwightShrute,4497,0,1,3,4,25.0%,15m
1291,3,[YSL]Pliskin,4497,0,0,3,3,0.0%,14m
1296,3,[xUSMCx]Devildoc,4496,0,1,0,1,100.0%,30m
1296,3,[SsaYnS]Demiurge,4496,0,1,0,1,100.0%,23m
1296,3,[RVluv]RedVelvet,4496,8,1,1,2,50.0%,32m
1296,3,[CIMKR]Pillip,4496,0,0,2,2,0.0%,23m
1300,2,[M0DE]BLISSMODE,4495,1785,87,108,195,44.6%,23m
1300,3,Aurelius,4495,470,32,18,50,64.0%,14m
1300,3,HuK,4495,30,4,4,8,50.0%,38m
1300,3,[G0G0G0]BangoBonito,4495,0,1,0,1,100.0%,23m
1300,2,CharSiuBao,4495,26,1,8,9,11.1%,33m
1305,3,[G0G0G0]IIIIIIIIIIII,4494,114,9,4,13,69.2%,17m
1305,3,IIIlIllIlIll,4494,0,0,4,4,0.0%,18m
1307,2,Atuor,4493,2176,152,167,319,47.6%,33m
1307,2,Present,4493,84,3,1,4,75.0%,2h
1309,3,Grrrrrrrrrrr,4492,353,32,18,50,64.0%,7m
1309,1,llllllllllll,4492,252,18,0,18,100.0%,4m
1309,3,MoOsE,4492,0,1,3,4,25.0%,2m
1309,3,[GanGan]Turkeypapa,4492,0,0,1,1,0.0%,12m
1313,3,DragonReborn,4490,0,1,0,1,100.0%,12m
1314,2,[DNKCFT]iveseensmolr,4488,725,46,52,98,46.9%,37m
1314,2,IIIIIIIIIIII,4488,238,13,17,30,43.3%,2m
1314,3,[REPORT]Timmy,4488,14,1,2,3,33.3%,28m
1314,3,[SsaYnS]Hyuna,4488,0,1,4,5,20.0%,38m
1314,2,[1stttt]ONECHINA,4488,0,1,5,6,16.7%,27m
1319,3,UrMumMyGirl,4487,431,28,10,38,73.7%,10m
1319,3,nerftoss,4487,429,23,4,27,85.2%,34m
1321,2,[xRtG]vØlüMë,4486,154,9,13,22,40.9%,33m
1321,3,[tdrs]Lee,4486,0,0,1,1,0.0%,18m
1321,3,[CaroKa]blizzkrieg,4486,0,0,1,1,0.0%,12m
1324,3,Vii,4485,516,33,10,43,76.7%,9m
1324,2,[CodeB]stormy,4485,516,29,22,51,56.9%,2m
1324,3,[SolOGS]LavarsBalls,4485,0,1,0,1,100.0%,9m
1324,3,Rain,4485,0,1,1,2,50.0%,27m
1328,2,IIIIIIIIIIII,4484,2500,317,307,624,50.8%,15m
1328,3,Key,4484,668,48,37,85,56.5%,2m
1328,3,[HUSHrx]Interstellar,4484,228,17,19,36,47.2%,7m
1328,2,RandomName,4484,0,0,3,3,0.0%,22m
1332,2,PoisoN,4483,502,27,14,41,65.9%,30m
1332,3,Dragon,4483,287,16,8,24,66.7%,37m
1332,3,[GanGan]TheZestyZolu,4483,0,1,0,1,100.0%,12m
1332,3,LoveTraps,4483,0,1,1,2,50.0%,14m
1336,3,[HAV0C]cutegrrl,4482,152,17,12,29,58.6%,10m
1336,1,[lCY]Kozan,4482,304,10,22,32,31.2%,10m
1336,3,[TOoOT]MonkeyOoO,4482,0,0,1,1,0.0%,28m
1336,2,[ZeeIot]ZealotMailer,4482,0,0,2,2,0.0%,5m
1340,2,LyriC,4481,2132,123,120,243,50.6%,15m
1340,1,[FINDEX]StoicWilly,4481,0,0,1,1,0.0%,36m
1342,2,SemoGloBin,4480,2377,117,97,214,54.7%,5m
1342,3,[868]Mowgli,4480,0,1,1,2,50.0%,37m
1342,2,IndyKIFesijo,4480,48,1,3,4,25.0%,36m
1345,3,[KiMBR]FeraMansa,4479,66,7,2,9,77.8%,12m
1345,3,Naniwa,4479,14,3,2,5,60.0%,10m
1345,3,[LMW]Last,4479,0,1,0,1,100.0%,10m
1348,3,Freean,4478,749,72,62,134,53.7%,2h
1348,3,Tennish,4478,168,15,13,28,53.6%,2m
1348,3,[1E100]yaqh,4478,46,6,4,10,60.0%,11m
1348,3,[αB]Kyuri,4478,0,1,0,1,100.0%,4m
1348,3,Apoptosis,4478,8,1,2,3,33.3%,7m
1348,3,Rascalllllll,4478,0,0,2,2,0.0%,11m
1354,3,Sergium,4477,359,27,15,42,64.3%,32m
1354,3,[CaptA]Sentinel,4477,231,25,6,31,80.6%,10m
1356,3,[KoneOP]FearME,4476,2197,221,223,444,49.8%,11m
1356,2,Demmathine,4476,1532,117,98,215,54.4%,30m
1356,2,HumongusKimi,4476,1527,95,83,178,53.4%,27m
1356,3,Hasky,4476,0,0,1,1,0.0%,7m
1360,2,[BmJn]BombJin,4475,502,21,28,49,42.9%,27m
1360,3,Probe,4475,0,0,1,1,0.0%,17m
1360,3,[ProKRS]QQL,4475,0,0,1,1,0.0%,38m
1363,2,[UpeV]Arrow,4474,711,33,36,69,47.8%,27m
1363,3,ShineON,4474,168,7,3,10,70.0%,2m
1363,2,[425]dugo,4474,106,5,12,17,29.4%,2h
1363,3,[RnGpro]ScrubbleS,4474,0,0,1,1,0.0%,10m
1367,3,[TGCF]PlayMaker,4473,100,11,9,20,55.0%,28m
1367,3,Modena,4473,6,2,5,7,28.6%,28m
1367,3,[JAGWN]Voluzunaria,4473,0,0,2,2,0.0%,12m
1370,2,[LoF]RandomNick,4472,12,2,6,8,25.0%,17m
1371,2,[JaMiT]astroemi,4471,2507,209,213,422,49.5%,23m
1371,3,Gundam,4471,56,6,9,15,40.0%,32m
1371,3,Rain,4471,139,4,5,9,44.4%,23m
1371,3,Segin,4471,0,1,0,1,100.0%,2m
1371,3,ItzMeMarco,4471,0,0,1,1,0.0%,12m
1376,3,PenhaFARADAY,4470,0,0,1,1,0.0%,28m
1376,3,Firehazard,4470,0,0,2,2,0.0%,28m
1378,3,Wontstop,4469,28,3,2,5,60.0%,26m
1378,3,Echo,4469,0,0,2,2,0.0%,30m
1380,2,[Ris3n]ReVolt,4468,686,36,34,70,51.4%,23m
1380,3,Sips,4468,394,19,16,35,54.3%,18m
1380,2,[GUCCl]PluTo,4468,223,7,10,17,41.2%,20m
1380,1,XLIMIT,4468,120,3,3,6,50.0%,25m
1384,2,[Ris3n]MogSkynet,4467,2444,520,507,1027,50.6%,19m
1384,3,Larry,4467,220,21,24,45,46.7%,2m
1384,3,[TGCrew]Shyrshadi,4467,118,10,11,21,47.6%,28m
1384,3,NightFalllll,4467,60,5,2,7,71.4%,38m
1384,2,Stopcheesing,4467,141,5,9,14,35.7%,26m
1384,3,IllIIIllIllI,4467,26,3,3,6,50.0%,30m
1384,3,[mocat]Summer,4467,0,0,1,1,0.0%,18m
1391,3,[1E100]Alken,4466,148,22,19,41,53.7%,32m
1391,3,Golden,4466,238,17,17,34,50.0%,28m
1391,3,OOOO,4466,52,8,4,12,66.7%,30m
1391,3,Sentry,4466,0,1,0,1,100.0%,11m
1391,3,SnoKtoPus,4466,0,0,1,1,0.0%,11m
1391,2,Vanish,4466,0,0,1,1,0.0%,24m
1397,2,GabiN,4465,1911,119,119,238,50.0%,37m
1397,2,SPQR,4465,1712,71,75,146,48.6%,30m
1397,2,sensay,4465,0,1,5,6,16.7%,27m
1400,3,TSMCoffeeBoy,4464,1281,183,168,351,52.1%,28m
1400,3,[AlIin]Teo,4464,38,5,4,9,55.6%,6m
1400,3,mcVV,4464,0,0,1,1,0.0%,28m
1400,1,IIIIIIIIIIII,4464,0,0,1,1,0.0%,19m
1404,2,[TGCrew]Westopoli,4463,572,43,58,101,42.6%,33m
1404,3,[HENT4l]llllllllllll,4463,158,14,12,26,53.8%,2m
1404,3,Gosuhenke,4463,219,6,11,17,35.3%,23m
1407,2,THRILLHOUSE,4462,2076,147,110,257,57.2%,27m
1407,2,IRushPeople,4462,677,38,16,54,70.4%,19m
1407,3,BabyBackRibs,4462,0,0,2,2,0.0%,32m
1410,3,[DNKCFT]boanaan,4461,58,8,4,12,66.7%,10m
1410,3,[BoRnGo]Joeypow,4461,0,1,0,1,100.0%,12m
1412,3,[SsaYnS]BigMac,4460,1490,95,76,171,55.6%,9m
1412,2,ÒiÓ,4460,927,62,47,109,56.9%,15m
1412,3,lVlagic,4460,0,1,0,1,100.0%,12m
1412,3,[ØFoxF2]shady,4460,0,1,0,1,100.0%,26m
1412,3,chiwawa,4460,0,0,1,1,0.0%,38m
1417,2,FightSpirit,4459,1184,59,64,123,48.0%,2m
1417,3,PapaSmurf,4459,423,23,5,28,82.1%,34m
1417,3,[M1A5]Scruffy,4459,0,0,1,1,0.0%,2h
1417,3,Tirion,4459,0,0,1,1,0.0%,6m
1421,3,[Maaad]Axs,4458,360,25,32,57,43.9%,28m
1421,2,[WNTRLH]Reignandpals,4458,224,13,23,36,36.1%,37m
1421,3,Rayne,4458,0,0,1,1,0.0%,10m
1424,2,phiDANGEROUS,4457,2493,378,361,739,51.2%,27m
1424,3,LastBeer,4457,52,6,8,14,42.9%,11m
1424,3,Tyolin,4457,0,0,1,1,0.0%,17m
1424,3,[NovaX]yun,4457,0,0,1,1,0.0%,39m
1424,3,Gosu,4457,0,0,1,1,0.0%,7m
1429,2,Orion,4456,396,17,25,42,40.5%,17m
1429,3,[LowIQ]Tar,4456,12,2,3,5,40.0%,2m
1429,3,[LimaSC]brlch,4456,0,0,1,1,0.0%,4m
1432,2,lIlIIllIIII,4455,2137,294,336,630,46.7%,5m
1433,3,[NPhasA]BalletDump,4453,572,32,7,39,82.1%,12m
1433,3,ThotPatrol,4453,254,29,18,47,61.7%,17m
1433,3,Quarenten,4453,0,0,1,1,0.0%,9m
1436,3,RoMaNeT,4452,609,93,26,119,78.2%,2m
1437,3,jeanjean,4451,499,29,8,37,78.4%,27m
1437,3,[LShade]VoidDweller,4451,0,0,1,1,0.0%,39m
1439,2,SkiZzy,4450,1937,250,268,518,48.3%,30m
1439,3,[GanGan]llllllllllll,4450,97,11,10,21,52.4%,12m
1439,3,StorM,4450,8,2,0,2,100.0%,7m
1442,3,protossiimba,4449,407,22,7,29,75.9%,18m
1443,2,Wyndpulse,4448,2459,194,186,380,51.1%,5m
1443,3,YouChengLiu,4448,680,37,11,48,77.1%,27m
1443,3,[αX]taedaj,4448,72,7,7,14,50.0%,12m
1443,3,BmJake,4448,38,3,3,6,50.0%,18m
1443,3,Guillemot,4448,26,2,2,4,50.0%,10m
1443,3,IIIIIIIIIIII,4448,0,1,0,1,100.0%,10m
1449,3,[PLUM5]fOcus,4447,1452,79,72,151,52.3%,23m
1449,2,[UpeV]Shinomiya,4447,422,18,36,54,33.3%,37m
1451,2,IIIIIIIIIIII,4446,2171,287,293,580,49.5%,2h
1451,3,[dLife]BrokenLatex,4446,454,31,36,67,46.3%,18m
1451,3,[NwAs]MiCox,4446,227,21,15,36,58.3%,2h
1451,3,[Ris3n]Stephen,4446,284,12,9,21,57.1%,39m
1451,3,zuka,4446,0,0,1,1,0.0%,9m
1451,3,[UofC]Rooster,4446,0,0,4,4,0.0%,38m
1457,3,KhainGonuyo,4445,0,0,1,1,0.0%,23m
1457,3,Gandalf,4445,0,0,1,1,0.0%,18m
1459,3,IIIIIIIIIIII,4444,520,35,16,51,68.6%,10m
1459,3,[TGCF]MarcoMan,4444,78,11,5,16,68.8%,27m
1459,3,IIIIIIIIIIII,4444,141,9,3,12,75.0%,12m
1459,3,ApieceOfCake,4444,46,6,4,10,60.0%,7m
1459,3,llllllll,4444,4,2,1,3,66.7%,14m
1464,3,Mint,4443,977,147,126,273,53.8%,4m
1464,3,[TGCrew]KCal,4443,106,9,11,20,45.0%,11m
1464,3,Drew,4443,0,1,3,4,25.0%,11m
1467,2,Urza,4442,2371,245,241,486,50.4%,27m
1467,3,ExtraWetFart,4442,6,1,3,4,25.0%,26m
1469,1,BrokenLatex,4441,48,1,1,2,50.0%,7m
1469,3,[zeez]penny,4441,0,0,1,1,0.0%,11m
1471,2,[TGosuD]Lightborn,4440,1014,57,46,103,55.3%,17m
1471,3,Stormblessed,4440,372,22,4,26,84.6%,18m
1471,3,JoniMitchell,4440,58,6,3,9,66.7%,11m
1471,3,[RBTH]CedriK,4440,0,2,3,5,40.0%,38m
1475,3,[sc2rep]Bowzer,4439,1542,186,175,361,51.5%,11m
1475,3,[OSCE]Vivid,4439,34,5,6,11,45.5%,11m
1475,3,[TM]NMxTien,4439,0,0,1,1,0.0%,37m
1475,3,Loveholic,4439,0,0,1,1,0.0%,38m
1475,3,[INextI]Borking,4439,0,0,1,1,0.0%,32m
1475,3,Morpheus,4439,0,0,1,1,0.0%,7m
1481,1,Ales,4438,145,2,1,3,66.7%,21m
1481,3,abcdefghijkl,4438,0,2,3,5,40.0%,12m
1481,3,McanningsSon,4438,0,0,4,4,0.0%,10m
1484,3,Castle,4437,1296,73,78,151,48.3%,17m
1484,3,[LimaSC]Steimers,4437,168,19,16,35,54.3%,10m
1484,3,MamaLaMicra,4437,0,1,0,1,100.0%,2m
1484,3,[FU2]HacksawJet,4437,0,0,1,1,0.0%,4m
1488,3,Auditor,4435,1914,149,144,293,50.9%,17m
1488,3,[eX]Schrödinger,4435,643,58,42,100,58.0%,4m
1488,3,Smoke,4435,4,2,5,7,28.6%,39m
1488,3,[SoAN]Dim,4435,0,0,4,4,0.0%,28m
1492,3,Lancer,4434,722,84,50,134,62.7%,28m
1492,3,Shuku,4434,4,1,2,3,33.3%,14m
1494,3,[Tues]TheCommunist,4433,1868,180,180,360,50.0%,10m
1494,3,[J3wIQ]JudaicChad,4433,44,4,3,7,57.1%,23m
1496,2,[TSØP]secret,4432,1891,91,88,179,50.8%,20m
1496,3,daves,4432,271,26,20,46,56.5%,18m
1496,3,BazookaTits,4432,108,10,7,17,58.8%,37m
1496,3,ssapchobo,4432,12,4,0,4,100.0%,30m
1496,3,FlyingDragon,4432,0,0,1,1,0.0%,18m
1496,3,IlllIIIlllI,4432,0,0,1,1,0.0%,17m
1496,3,NoGGnoGirls,4432,0,0,1,1,0.0%,39m
1503,3,Paradise,4431,189,77,84,161,47.8%,11m
1503,2,Mint,4431,1063,51,50,101,50.5%,2m
1503,3,[DROWN]lethe,4431,36,6,3,9,66.7%,4m
1503,3,iStimUwin,4431,18,2,2,4,50.0%,26m
1503,3,[TJET]Bluntbread,4431,8,1,1,2,50.0%,23m
1508,3,Urgan,4430,0,1,0,1,100.0%,34m
1509,2,BiggestNoob,4429,0,5,0,5,100.0%,34m
1509,3,[1133]Cronos,4429,12,2,0,2,100.0%,10m
1509,1,[0iq]NickDickBrwn,4429,96,2,7,9,22.2%,18m
1512,2,CombatEX,4428,743,256,216,472,54.2%,27m
1512,2,Restia,4428,1250,197,220,417,47.2%,27m
1512,2,CerO,4428,484,22,28,50,44.0%,17m
1512,3,Malfy,4428,176,18,14,32,56.2%,38m
1516,3,[YEM]DogLog,4427,1252,446,486,932,47.9%,11m
1516,3,[iMkS]YeraldSC,4427,2,1,2,3,33.3%,32m
1518,2,[αXLa]Faesbuca,4425,2442,336,326,662,50.8%,30m
1518,3,llllllllllll,4425,532,76,50,126,60.3%,10m
1518,3,[GØSU]AsheuN,4425,4,2,2,4,50.0%,30m
1518,3,PewPewPewPew,4425,0,1,0,1,100.0%,9m
1518,3,GhostTemplar,4425,0,1,3,4,25.0%,34m
1518,3,[9g9g]FIX,4425,0,0,1,1,0.0%,10m
1518,3,Nostalgia,4425,0,0,3,3,0.0%,6m
1525,2,[RBTH]ShotnVelt,4424,517,22,31,53,41.5%,2h
1525,3,SiriUS,4424,238,21,22,43,48.8%,38m
1527,2,[KiMBR]Spawn,4423,1671,170,155,325,52.3%,26m
1527,1,[420NS]Deucalion,4423,1379,121,125,246,49.2%,38m
1527,3,SouL,4423,0,1,0,1,100.0%,18m
1527,3,[TobiOP]IIIIIIIIIIII,4423,0,1,0,1,100.0%,18m
1527,3,[RLR]Lusira,4423,0,0,1,1,0.0%,18m
1527,3,[bYnD]SurivEht,4423,0,0,2,2,0.0%,38m
1533,3,kami,4422,1163,59,50,109,54.1%,10m
1533,3,[SSeiya]Kanon,4422,30,13,10,23,56.5%,11m
1535,3,[αB]NeO,4421,1775,143,140,283,50.5%,26m
1535,3,TheLaw,4421,172,9,2,11,81.8%,18m
1535,3,[Morky]Purpil,4421,22,6,2,8,75.0%,18m
1538,3,Nox,4420,759,49,25,74,66.2%,28m
1538,3,Money,4420,48,5,5,10,50.0%,2m
1538,3,[FMX]Lazu,4420,0,0,1,1,0.0%,17m
1541,3,[cl0udM]Meep,4419,1276,65,54,119,54.6%,26m
1541,1,JDmind,4419,48,2,0,2,100.0%,14m
1541,3,[AoBDE]majorbacon,4419,0,0,1,1,0.0%,11m
1544,3,Dylluna,4418,1521,82,62,144,56.9%,27m
1544,3,[BRSKR]Immigrant,4418,131,10,0,10,100.0%,32m
1546,3,[AoBDE]SneezyDwarf,4417,1111,66,42,108,61.1%,34m
1547,2,llllllllllll,4416,1133,70,58,128,54.7%,15m
1547,3,[TGCF]PlayMaker,4416,8,1,1,2,50.0%,26m
1549,3,[αX]Dinkleswerve,4415,830,56,59,115,48.7%,10m
1549,3,[ConFed]Centurion,4415,128,10,15,25,40.0%,38m
1549,3,Minong,4415,143,8,5,13,61.5%,10m
1552,2,ascpraiise,4414,1476,66,70,136,48.5%,2m
1552,3,Aphex,4414,14,3,2,5,60.0%,28m
1554,2,llllllllllll,4413,2111,202,225,427,47.3%,2m
1554,3,MvP,4413,1944,113,98,211,53.6%,2h
1554,2,[DarkAG]Ngo,4413,1537,101,110,211,47.9%,5m
1554,3,Yseond,4413,149,8,2,10,80.0%,10m
1554,3,[Adwd]Dandrene,4413,115,7,4,11,63.6%,32m
1554,3,zaradron,4413,0,0,1,1,0.0%,23m
1560,3,BenchPress,4412,2114,158,162,320,49.4%,7m
1560,3,Rhapsody,4412,1066,116,89,205,56.6%,39m
1560,3,KimTaekYong,4412,1461,85,63,148,57.4%,14m
1560,3,[Brank]GatewayMan,4412,436,24,6,30,80.0%,39m
1560,3,lllllllllX,4412,0,1,0,1,100.0%,34m
1560,3,[BrnYrd]FatherRusty,4412,6,1,1,2,50.0%,28m
1560,3,Viriato,4412,0,0,1,1,0.0%,10m
1567,3,[αXLa]CEMAFATHI,4411,596,59,36,95,62.1%,10m
1567,3,BeerCraft,4411,418,22,3,25,88.0%,30m
1567,3,TwoBlaster,4411,0,1,0,1,100.0%,18m
1570,3,MudKip,4410,0,1,5,6,16.7%,32m
1571,3,[ExcIgN]IIIIIIIIIIII,4409,1549,296,262,558,53.0%,10m
1571,3,Sandtrout,4409,481,41,31,72,56.9%,37m
1571,2,[ZTemp]Cicero,4409,537,36,27,63,57.1%,23m
1571,3,[ScSwrm]FuGu,4409,145,7,2,9,77.8%,30m
1571,3,[NPhase]Contrivance,4409,10,2,3,5,40.0%,27m
1571,2,IIIIIIIIIIII,4409,0,1,4,5,20.0%,38m
1571,3,ChuckNorris,4409,0,0,4,4,0.0%,30m
1578,3,[xRtG]Vegeta,4408,394,24,28,52,46.2%,26m
1578,3,Vedita,4408,0,1,0,1,100.0%,26m
1578,3,[RICHHH]TechNo,4408,0,0,2,2,0.0%,9m
1581,3,[2TK]Rewardingly,4407,1439,101,67,168,60.1%,32m
1581,3,Aizensama,4407,1016,55,33,88,62.5%,14m
1581,3,[αX]CaptCanuck,4407,975,54,58,112,48.2%,2m
1581,3,[Chibii]Tyranus,4407,686,34,36,70,48.6%,34m
1585,3,[GrabMy]Willy,4406,0,1,0,1,100.0%,4m
1586,3,[NAGARA]Nyaong,4405,24,7,2,9,77.8%,10m
1586,3,Vision,4405,0,0,1,1,0.0%,4m
1586,3,[CWeS]MisterABC,4405,0,0,1,1,0.0%,37m
1586,3,deToth,4405,0,0,1,1,0.0%,14m
1586,3,BlackSaxon,4405,0,0,2,2,0.0%,7m
1591,3,protoss,4403,1059,210,184,394,53.3%,11m
1591,3,Kingfisher,4403,72,8,5,13,61.5%,34m
1591,3,[Salty]LebrO,4403,0,0,1,1,0.0%,10m
1594,3,happystick,4402,1404,105,85,190,55.3%,12m
1594,3,[GR33D]RogueZZ,4402,319,12,15,27,44.4%,10m
1594,2,[Kaii]DoM,4402,94,2,6,8,25.0%,27m
1594,3,[420]Oberoth,4402,6,1,2,3,33.3%,7m
1598,3,[tCo9]Syl,4400,0,0,1,1,0.0%,26m
1599,3,IIIIIIIIIIII,4399,381,21,4,25,84.0%,12m
1599,3,Poppy,4399,208,21,22,43,48.8%,2h
1599,3,[FANXY]Vex,4399,14,6,2,8,75.0%,12m
1599,3,[UpeV]fridaz,4399,0,0,1,1,0.0%,28m
1603,3,[WNTR]TheCure,4398,0,0,2,2,0.0%,17m
1604,2,UncleClimax,4397,563,169,160,329,51.4%,24m
1604,1,ZergPurée,4397,48,1,7,8,12.5%,38m
1604,3,Phive,4397,0,0,5,5,0.0%,4m
1607,3,llllllllllll,4396,377,57,64,121,47.1%,6m
1607,3,llllllllllll,4396,130,15,14,29,51.7%,12m
1609,2,Magician,4395,389,16,26,42,38.1%,27m
1609,3,lIIIIlllII,4395,12,2,4,6,33.3%,10m
1609,3,[eSun]Toshiro,4395,0,1,0,1,100.0%,27m
1609,2,[HoSeeB]Shen,4395,0,1,4,5,20.0%,14m
1609,3,[JUIN]Serp,4395,0,0,6,6,0.0%,23m
1614,2,babyboggler,4394,1651,199,205,404,49.3%,37m
1614,2,[AlIin]drumhead,4394,1274,54,62,116,46.6%,20m
1614,3,WhyTossSoOp,4394,0,0,1,1,0.0%,18m
1617,3,[Yikes]Dain,4393,52,8,9,17,47.1%,4m
1617,3,Dnine,4393,146,5,4,9,55.6%,23m
1619,3,Aspire,4392,398,24,8,32,75.0%,23m
1619,3,Xiaomo,4392,186,13,22,35,37.1%,17m
1619,3,[XIICDO]ElPepe,4392,116,3,4,7,42.9%,18m
1622,3,[USCBOY]Sansculotte,4391,0,0,1,1,0.0%,28m
1623,3,[Cryptc]Arcane,4390,1272,64,69,133,48.1%,12m
1623,3,ThotPatrol,4390,159,6,4,10,60.0%,10m
1623,3,[Gather]victorque,4390,30,4,4,8,50.0%,10m
1623,3,[geshi]llllllllllll,4390,0,0,1,1,0.0%,10m
1627,3,llllllllllll,4389,180,16,16,32,50.0%,7m
1627,3,Lisara,4389,157,7,2,9,77.8%,37m
1627,3,llllllllllll,4389,0,0,1,1,0.0%,34m
1630,3,[UpeV]blackdead,4388,2231,220,223,443,49.7%,14m
1630,1,AVE,4388,505,21,3,24,87.5%,7m
1630,3,Silent,4388,0,1,0,1,100.0%,30m
1633,3,[RoyaI]SAKA,4387,641,77,66,143,53.8%,17m
1633,3,LastBeer,4387,22,4,10,14,28.6%,26m
1635,3,[SuperZ]Gustavo,4386,2254,704,676,1380,51.0%,39m
1635,3,[xRtG]Tokuchi,4386,2036,166,171,337,49.3%,39m
1635,3,[KYLE]Prodygy,4386,18,3,7,10,30.0%,17m
1635,3,DaJo,4386,0,1,0,1,100.0%,30m
1635,3,Coucoute,4386,0,1,0,1,100.0%,12m
1640,3,[Fever]Prod,4385,1402,117,95,212,55.2%,14m
1640,3,llllllllllll,4385,367,45,25,70,64.3%,23m
1642,3,Hunterlisk,4383,700,51,46,97,52.6%,18m
1642,3,JackFrost,4383,572,31,26,57,54.4%,9m
1642,3,Steimers,4383,387,21,4,25,84.0%,23m
1642,2,[NSheer]Lumina,4383,337,18,24,42,42.9%,19m
1642,3,ToT,4383,68,9,10,19,47.4%,18m
1642,3,Vladizor,4383,8,3,0,3,100.0%,6m
1648,3,rithosDOOM,4382,582,26,8,34,76.5%,18m
1649,3,kdt,4381,2,1,1,2,50.0%,23m
1650,3,Bones,4380,1967,210,197,407,51.6%,7m
1651,3,IIIIIIIIIII,4379,2235,258,273,531,48.6%,2h
1651,2,[NwAs]Cheesus,4379,1658,169,171,340,49.7%,24m
1651,3,[WWBB]Bondrewd,4379,12,5,4,9,55.6%,10m
1651,3,printscreen,4379,24,3,8,11,27.3%,27m
1651,3,Rahl,4379,0,0,1,1,0.0%,23m
1656,2,[B00NK]Beyond,4377,2078,382,373,755,50.6%,15m
1656,3,[αB]CleaR,4377,6,2,3,5,40.0%,23m
1658,3,BigBrain,4376,312,27,4,31,87.1%,17m
1658,3,Tetris,4376,228,11,6,17,64.7%,11m
1658,3,index,4376,0,1,0,1,100.0%,10m
1661,3,[DarkAG]MichaelScott,4375,175,10,4,14,71.4%,37m
1661,3,[RØR]RoMSHoT,4375,0,0,5,5,0.0%,10m
1663,2,hazing,4374,1319,71,68,139,51.1%,15m
1663,3,ROKARMY,4374,171,9,5,14,64.3%,14m
1663,3,Qwoto,4374,0,5,0,5,100.0%,26m
1663,3,NickiMinaj,4374,97,1,2,3,33.3%,23m
1667,3,[SsaYnS]Zealot,4373,0,5,0,5,100.0%,32m
1667,3,Mothrah,4373,164,5,3,8,62.5%,10m
1667,3,[xNtG]Tasty,4373,16,5,6,11,45.5%,27m
1667,3,Matt,4373,0,0,2,2,0.0%,11m
1671,3,[AD3C]Vyse,4372,1170,61,52,113,54.0%,17m
1671,3,USNicosia,4372,112,14,12,26,53.8%,23m
1671,2,[Vizier]LarryG,4372,196,9,19,28,32.1%,5m
1671,3,FriedRice,4372,6,1,5,6,16.7%,34m
1675,3,[Scyth]WaEsOpH,4371,1101,59,63,122,48.4%,23m
1675,3,hmm,4371,347,18,8,26,69.2%,23m
1675,3,[BbTea]Freedom,4371,42,4,9,13,30.8%,37m
1675,3,SetStndbySmn,4371,0,1,0,1,100.0%,18m
1675,2,ziliboba,4371,0,1,1,2,50.0%,3m
1675,3,[PSU]OGBerM,4371,0,0,1,1,0.0%,18m
1681,3,DeadlyKitten,4370,602,31,12,43,72.1%,10m
1681,3,Eldinarcus,4370,420,31,31,62,50.0%,2m
1683,3,DMNS,4369,2207,278,288,566,49.1%,14m
1683,3,[NwAs]Draconix,4369,327,17,9,26,65.4%,4m
1683,1,[CWKz]rufio,4369,274,16,0,16,100.0%,22m
1683,3,lorik,4369,0,3,0,3,100.0%,27m
1687,3,SupersTar,4368,1890,98,104,202,48.5%,30m
1687,3,ThorRush,4368,29,18,16,34,52.9%,6m
1687,3,llllllllll,4368,109,12,4,16,75.0%,10m
1687,3,[lDream]IIIIIIIII,4368,6,1,1,2,50.0%,11m
1691,3,[iGOSU]mattjonesss,4366,2238,240,247,487,49.3%,10m
1691,3,LezardValeth,4366,336,30,34,64,46.9%,9m
1691,2,ZigSputnik,4366,163,17,24,41,41.5%,2h
1691,3,Guilty,4366,229,9,2,11,81.8%,10m
1691,3,IIIIIIIIIIII,4366,0,0,1,1,0.0%,10m
1696,3,yeunk,4365,0,0,1,1,0.0%,6m
1697,3,RONE,4364,1949,95,98,193,49.2%,28m
1697,3,[NwAs]LEINAD,4364,683,45,27,72,62.5%,4m
1697,2,llllllllllll,4364,302,15,23,38,39.5%,27m
1697,3,DeepOnes,4364,16,3,2,5,60.0%,14m
1697,3,Pianistickz,4364,96,3,4,7,42.9%,34m
1702,2,[αXLa]AcmeHero,4363,2414,322,336,658,48.9%,37m
1702,2,WingsArch,4363,1400,82,82,164,50.0%,26m
1704,3,[DthW]Astinio,4362,97,4,2,6,66.7%,27m
1704,2,llllllllllll,4362,48,4,4,8,50.0%,30m
1704,3,Supersonic,4362,6,3,2,5,60.0%,4m
1704,3,[DirtyP]Baits,4362,0,0,1,1,0.0%,7m
1708,3,[DXF91]Lupercal,4361,138,8,6,14,57.1%,2h
1708,2,EcksDee,4361,0,3,2,5,60.0%,31m
1708,3,MinBikCok,4361,0,0,2,2,0.0%,27m
1708,3,Dream,4361,0,0,3,3,0.0%,28m
1712,3,[Granpa]kOrc,4360,861,39,30,69,56.5%,10m
1712,3,[Gengar]IlIIlllIIIIl,4360,563,26,5,31,83.9%,34m
1712,3,SpeachLess,4360,245,13,7,20,65.0%,39m
1712,3,Neo,4360,96,12,12,24,50.0%,14m
1716,3,[CMU]Qoo,4359,1224,219,208,427,51.3%,32m
1716,3,IIIIIIIIIIII,4359,427,22,3,25,88.0%,23m
1716,3,TrumpMAGA,4359,126,5,1,6,83.3%,27m
1716,3,FredTiffo,4359,32,5,7,12,41.7%,26m
1716,3,NanTeSer,4359,0,1,4,5,20.0%,23m
1721,3,[INextI]RoTtiN,4358,266,23,23,46,50.0%,17m
1722,2,[ScSwrm]hunter,4357,2067,193,183,376,51.3%,15m
1722,2,Solenya,4357,1655,175,186,361,48.5%,19m
1722,3,Alan,4357,777,42,27,69,60.9%,18m
1722,3,Saliroz,4357,887,36,29,65,55.4%,14m
1722,3,PirulitO,4357,422,27,25,52,51.9%,18m
1722,3,DecentBot,4357,167,11,8,19,57.9%,2h
1722,3,[SsaYnS]Caloreen,4357,38,7,5,12,58.3%,4m
1722,3,[Ato2]FatMan,4357,0,0,1,1,0.0%,18m
1722,3,jaesu,4357,0,0,2,2,0.0%,37m
1731,2,[Sune]Smash,4356,1096,60,67,127,47.2%,26m
1731,3,[DhZone]Melo,4356,275,24,19,43,55.8%,12m
1731,3,[eX]ReMy,4356,0,1,2,3,33.3%,18m
1731,3,JoKerD,4356,0,0,1,1,0.0%,28m
1735,3,Halogen,4355,303,31,23,54,57.4%,7m
1735,3,[SCxPH]SiFu,4355,144,26,29,55,47.3%,6m
1735,3,Supermahon,4355,346,19,12,31,61.3%,23m
1735,3,wha,4355,206,12,7,19,63.2%,2m
1735,3,[UVa]cableman,4355,30,4,4,8,50.0%,7m
1735,3,mareik,4355,0,1,0,1,100.0%,28m
1735,3,[Dicboy]IAmSacul,4355,0,0,1,1,0.0%,17m
1735,3,xModen,4355,0,0,1,1,0.0%,39m
1735,3,[DDDDD]KMNZ,4355,0,0,1,1,0.0%,11m
1744,2,[DarkAG]Ace,4354,2234,532,525,1057,50.3%,18m
1744,3,Halley,4354,1695,135,85,220,61.4%,27m
1744,3,[1tWoK]Dalinar,4354,356,24,32,56,42.9%,17m
1744,3,Kotenok,4354,76,13,14,27,48.1%,30m
1744,3,ElstPizarro,4354,0,1,4,5,20.0%,14m
1744,3,mOOdY,4354,0,0,1,1,0.0%,39m
1750,3,ModusPwnens,4353,1600,311,298,609,51.1%,38m
1750,3,Kaelthalas,4353,213,21,15,36,58.3%,10m
1750,2,Cadenza,4353,0,0,1,1,0.0%,34m
1753,3,darkluster,4352,1709,99,90,189,52.4%,28m
1753,3,[BALLS]HaterDamus,4352,142,22,15,37,59.5%,17m
1753,3,aggie,4352,0,0,1,1,0.0%,7m
1756,3,[IMDSI]Funcky,4351,1908,189,175,364,51.9%,28m
1756,3,Perfection,4351,472,24,1,25,96.0%,34m
1756,3,Darrenc,4351,8,2,1,3,66.7%,6m
1756,2,Stephano,4351,0,1,4,5,20.0%,22m
1760,3,[FateTw]Neroc,4350,2099,231,217,448,51.6%,28m
1760,3,[cl0udM]Symphony,4350,421,23,23,46,50.0%,32m
1760,3,[Alpaka]Nordy,4350,0,1,0,1,100.0%,11m
1763,3,Beltrano,4349,1183,351,355,706,49.7%,7m
1763,1,hahaha,4349,336,8,11,19,42.1%,38m
1763,3,[0rdr66]TheSenate,4349,0,1,0,1,100.0%,12m
1763,3,[AoBDE]BALENCIAGA,4349,0,1,0,1,100.0%,4m
1767,2,GoblinKlaws,4348,686,39,26,65,60.0%,37m
1767,3,Noumena,4348,6,2,1,3,66.7%,37m
1769,3,Vesper,4347,1513,170,148,318,53.5%,27m
1769,3,GGBrother,4347,0,0,1,1,0.0%,28m
1769,3,[eXoPH]Floki,4347,0,0,1,1,0.0%,39m
1772,2,YouOnTilt,4346,1011,69,81,150,46.0%,15m
1772,2,[FRMAGE]ColWombaT,4346,1141,53,66,119,44.5%,15m
1772,3,Chemist,4346,128,17,18,35,48.6%,10m
1772,3,[NAKR]sOs,4346,0,0,1,1,0.0%,28m
1776,2,Halienator,4345,1975,162,169,331,48.9%,15m
1776,3,Luana,4345,1400,66,36,102,64.7%,9m
1776,3,[ezBad]rncg,4345,172,15,26,41,36.6%,2h
1776,3,IIIIIIIIIIII,4345,130,13,16,29,44.8%,2m
1776,3,[TOYOTA]CamryPower,4345,295,11,4,15,73.3%,27m
1776,2,[lNI]Eldrid,4345,0,0,3,3,0.0%,6m
1782,2,[αX]Zoun,4344,178,15,0,15,100.0%,10m
1782,3,PeaCH,4344,121,3,0,3,100.0%,2m
1782,3,TheSnaTch,4344,97,1,1,2,50.0%,2m
1782,3,Psionic,4344,0,0,1,1,0.0%,37m
1786,2,[CATFUK]NOP,4343,2410,357,347,704,50.7%,27m
1786,3,[Pig2]OldbOy,4343,1570,166,157,323,51.4%,37m
1786,3,[Ris3n]Mog,4343,1050,68,53,121,56.2%,2h
1786,3,[THYGAP]KimJongSkill,4343,220,6,5,11,54.5%,10m
1786,3,[JaMiT]BigBoyLing,4343,0,1,0,1,100.0%,2h
1786,3,[JSQD13]pooopFaceMG,4343,97,1,1,2,50.0%,9m
1786,3,PunisheR,4343,4,1,7,8,12.5%,10m
1786,3,DeathLord,4343,0,0,1,1,0.0%,28m
1786,3,[xLgNx]Dive,4343,0,0,4,4,0.0%,10m
1795,3,[PeF]TuuR,4342,1429,75,48,123,61.0%,34m
1795,3,[G0G0G0]Mayan,4342,269,11,8,19,57.9%,37m
1795,3,CoronaZerg,4342,0,0,1,1,0.0%,10m
1795,3,Chen,4342,0,0,2,2,0.0%,4m
1799,3,[Inflow]PlzSendFunds,4341,200,19,22,41,46.3%,28m
1800,2,[GRU]FapperDupley,4340,2394,1302,1350,2652,49.1%,15m
1800,2,[NM8]LilRocketMan,4340,1407,65,80,145,44.8%,37m
1800,3,Fourth,4340,484,18,4,22,81.8%,27m
1800,1,Zero,4340,278,15,3,18,83.3%,37m
1800,3,[Atira]DieselMP,4340,20,3,6,9,33.3%,11m
1800,3,[UAeSp]Torque,4340,97,1,1,2,50.0%,38m
1806,3,[GumZ]NatroNix,4339,884,77,63,140,55.0%,27m
1806,3,[nooboo]oOoOo,4339,931,43,17,60,71.7%,27m
1806,3,[CATFUK]NoEGirls,4339,509,29,21,50,58.0%,10m
1806,3,[RBTH]MakroMaraude,4339,105,6,2,8,75.0%,27m
1806,3,[PINGON]MagiK,4339,0,1,0,1,100.0%,38m
1806,3,IIIIIIIIII,4339,0,0,1,1,0.0%,10m
1806,3,[BoRnGo]Yeezus,4339,0,0,1,1,0.0%,11m
1813,3,[GanGan]cherry,4338,827,32,19,51,62.7%,30m
1813,3,Nosferatu,4338,569,22,17,39,56.4%,38m
1813,3,[YRH]DUDUDUNGA,4338,0,1,1,2,50.0%,11m
1816,3,ArtVandelay,4337,866,271,244,515,52.6%,38m
1816,3,McLovin,4337,1071,104,72,176,59.1%,18m
1816,3,BisugoPh,4337,854,80,50,130,61.5%,28m
1816,3,Archer,4337,893,51,42,93,54.8%,12m
1816,3,[112358]LaTeralus,4337,272,23,25,48,47.9%,12m
1816,3,[Lp]TheDarkOne,4337,266,9,2,11,81.8%,10m
1816,3,[LimaZC]steimers,4337,121,2,1,3,66.7%,9m
1816,3,Oresama,4337,0,0,1,1,0.0%,6m
1824,3,[FU2]StimJunky,4336,888,63,3,66,95.5%,39m
1824,3,Tread,4336,103,16,12,28,57.1%,23m
1824,3,Seahorse,4336,423,15,7,22,68.2%,10m
1827,3,[Ris3n]SticksBender,4335,835,47,52,99,47.5%,18m
1827,3,IIIIIIIIIII,4335,659,33,15,48,68.8%,34m
1827,3,starburst,4335,146,4,2,6,66.7%,28m
1827,3,Reflection,4335,125,3,3,6,50.0%,2h
1827,3,ForbZ,4335,0,1,0,1,100.0%,39m
1827,3,[nG]PraetøR,4335,0,0,1,1,0.0%,39m
1833,3,roka,4334,858,36,33,69,52.2%,32m
1833,3,dckey,4334,705,33,13,46,71.7%,2h
1833,3,[NLTTJ]Yue,4334,625,25,8,33,75.8%,34m
1833,3,Zenith,4334,197,14,10,24,58.3%,10m
1833,1,[UpeV]BLord,4334,48,1,10,11,9.1%,38m
1838,3,[NovaX]Etmajo,4333,1503,101,103,204,49.5%,2m
1838,3,llllllllllll,4333,1576,80,89,169,47.3%,18m
1838,3,MutaAutoWin,4333,259,25,18,43,58.1%,11m
1838,3,[GRNSKN]Sadist,4333,322,15,11,26,57.7%,38m
1838,3,Architorture,4333,350,14,7,21,66.7%,2h
1838,3,lllGGGXIII,4333,97,2,0,2,100.0%,10m
1844,3,Caster,4332,1011,219,150,369,59.3%,14m
1844,3,[SsaYnS]MiolO,4332,1411,73,50,123,59.3%,23m
1844,3,sposero,4332,477,22,11,33,66.7%,38m
1844,1,[BmJn]Mineral,4332,139,7,2,9,77.8%,19m
1844,3,[EZkill]Lilky,4332,244,7,4,11,63.6%,39m
1844,3,Granas,4332,148,6,2,8,75.0%,26m
1844,3,llllllllllll,4332,193,5,1,6,83.3%,18m
1844,3,[EZkill]RubyNinja,4332,40,5,11,16,31.2%,10m
1844,2,SIDINHO,4332,66,3,17,20,15.0%,24m
1844,3,BethHarmon,4332,97,2,0,2,100.0%,23m
1844,3,[eX]BUFFaLOWbill,4332,121,2,1,3,66.7%,4m
1844,3,[FateTw]strelitzia,4332,121,2,2,4,50.0%,2m
1844,3,[DarkAG]Somnium,4332,121,2,3,5,40.0%,38m
1844,3,SilentGhost,4332,0,1,0,1,100.0%,7m
1858,3,[CrzDoG]WangY,4331,1319,587,559,1146,51.2%,23m
1858,3,[McCr]GaTor,4331,1510,203,188,391,51.9%,12m
1858,3,Yeet,4331,226,67,55,122,54.9%,28m
1858,3,[NovaX]Soda,4331,933,64,47,111,57.7%,14m
1858,3,[THYGAP]ClapinCheeks,4331,419,32,24,56,57.1%,6m
1858,3,IIIIIIIIIIll,4331,334,12,0,12,100.0%,27m
1864,3,[Wrekrs]DTee,4330,1278,158,130,288,54.9%,32m
1864,2,[xRtG]theseparator,4330,2095,112,119,231,48.5%,24m
1864,3,[PwT]rockcentauro,4330,2060,103,118,221,46.6%,7m
1864,3,[MTMRK]HunterKiller,4330,377,60,31,91,65.9%,10m
1864,3,[SuperZ]Gornom,4330,173,32,31,63,50.8%,12m
1864,3,[MBR420]switch,4330,76,9,18,27,33.3%,4m
1864,2,Swan,4330,0,1,0,1,100.0%,23m
1871,3,[BRSKR]Siumo,4329,757,171,177,348,49.1%,38m
1871,3,[8iSh]Heeebster,4329,804,48,24,72,66.7%,34m
1871,3,[TGCF]GiangNeo,4329,52,15,19,34,44.1%,18m
1871,3,Ciclano,4329,46,6,17,23,26.1%,18m
1871,3,lllllllllllI,4329,130,4,5,9,44.4%,2h
1871,3,[BtnBot]tyzor,4329,97,1,1,2,50.0%,17m
1877,3,TrueNorth,4328,1406,126,110,236,53.4%,39m
1877,3,noodles,4328,304,12,14,26,46.2%,17m
1877,3,[LieFan]Chose,4328,219,11,2,13,84.6%,12m
1877,3,[Cryptc]Astra,4328,40,7,9,16,43.8%,11m
1877,3,[laDF]GrosPapa,4328,97,1,1,2,50.0%,12m
1877,3,[INSPCT]Chett,4328,0,0,1,1,0.0%,23m
1877,3,[TWoway]Sapphire,4328,0,0,3,3,0.0%,12m
1884,3,ReverendFart,4327,999,286,259,545,52.5%,14m
1884,3,Rytilu,4327,1363,197,178,375,52.5%,12m
1884,3,BlackChicken,4327,1419,81,66,147,55.1%,28m
1884,3,[CodeB]cheezeDr,4327,938,62,44,106,58.5%,30m
1884,3,[XIE233]GrandVoker,4327,361,59,45,104,56.7%,6m
1884,2,SmurfMaster,4327,306,14,0,14,100.0%,12m
1884,3,[TwHero]ShenII,4327,97,4,2,6,66.7%,23m
1884,3,SHlTSHOW,4327,0,0,1,1,0.0%,2m
1892,3,San,4326,691,76,42,118,64.4%,26m
1892,3,[La]PalaDiN,4326,946,49,22,71,69.0%,23m
1892,3,[Dadash]Sosar,4326,689,37,25,62,59.7%,12m
1892,3,Einrys,4326,163,19,13,32,59.4%,2h
1892,3,[αXi]Doudou,4326,368,13,10,23,56.5%,30m
1892,3,[sdfgh]Voidreaver,4326,97,1,1,2,50.0%,39m
1892,3,BOHR,4326,97,1,2,3,33.3%,28m
1899,3,HEILGRETA,4325,1507,186,164,350,53.1%,27m
1899,3,SGP,4325,371,64,71,135,47.4%,12m
1899,3,[TGosuA]LeChatonNoir,4325,688,27,25,52,51.9%,12m
1899,3,[fLc]Ska,4325,46,7,10,17,41.2%,12m
1899,3,[Cryptc]Krispee,4325,147,4,2,6,66.7%,27m
1899,3,[ØFoxF2]GabrielUNIMs,4325,73,2,2,4,50.0%,28m
1905,3,[GrnBrd]Notausername,4324,1463,196,171,367,53.4%,27m
1905,3,MUODY,4324,1088,51,28,79,64.6%,23m
1905,3,[αXLa]HeartBeatX,4324,399,40,23,63,63.5%,28m
1905,3,[REPORT]springland,4324,466,28,5,33,84.8%,10m
1905,3,[PaulPa]Giles,4324,714,27,22,49,55.1%,32m
1905,3,[0rdr66]Trollossus,4324,110,15,20,35,42.9%,18m
1905,3,Strker,4324,50,7,9,16,43.8%,12m
1905,3,Shibb,4324,37,7,13,20,35.0%,26m
1905,3,Ascendead,4324,122,3,2,5,60.0%,2h
1905,3,AIphaStar,4324,22,2,7,9,22.2%,9m
1905,3,[LFPrac]anarchay,4324,0,0,2,2,0.0%,10m
1916,3,Adverse,4323,1182,216,200,416,51.9%,38m
1916,3,Kamandag,4323,554,140,123,263,53.2%,9m
1916,3,[ExcIgN]JoSS,4323,1613,100,95,195,51.3%,27m
1916,3,[PCAKE]darktemplar,4323,0,0,1,1,0.0%,10m
1920,2,trivium,4322,2413,466,465,931,50.1%,27m
1920,3,Rin,4322,641,145,104,249,58.2%,28m
1920,3,[BUUREN]TraderJoe,4322,97,2,1,3,66.7%,12m
1923,3,MacMiller,4321,624,81,65,146,55.5%,9m
1923,3,LoveIsABitch,4321,525,29,17,46,63.0%,38m
1923,3,[eSun]Soita,4321,350,27,34,61,44.3%,18m
1923,3,doohanbaek,4321,425,22,5,27,81.5%,27m
1923,3,KLUFT,4321,321,20,10,30,66.7%,32m
1923,2,CHL,4321,0,0,1,1,0.0%,31m
1923,3,[unooob]dOsiZ,4321,0,0,1,1,0.0%,18m
1930,2,[Msia]Iscariot,4320,2391,287,282,569,50.4%,33m
1930,3,[ZFz]AnUglyOkapi,4320,1957,121,118,239,50.6%,18m
1930,3,[Micmac]SeverusSnape,4320,564,32,17,49,65.3%,23m
1930,1,Littlenoob,4320,878,19,19,38,50.0%,24m
1930,3,supremeBeinG,4320,0,0,1,1,0.0%,10m
1930,2,Oberoth,4320,0,0,2,2,0.0%,34m
1936,3,McBlanc,4319,1567,170,100,270,63.0%,23m
1936,3,[Golden]TheHitman,4319,292,23,23,46,50.0%,28m
1936,3,[Slayor]Noomi,4319,253,20,18,38,52.6%,32m
1936,3,Angela,4319,66,12,16,28,42.9%,12m
1936,3,IIIIIIIIII,4319,0,0,7,7,0.0%,27m
1941,3,DaveDavidson,4317,2196,297,272,569,52.2%,18m
1941,3,Makero,4317,282,128,119,247,51.8%,4m
1941,3,[Zengi]Goat,4317,14,4,8,12,33.3%,7m
1944,2,MutaPrinter,4316,1605,152,145,297,51.2%,16m
1944,3,BeserkBunnie,4316,1585,80,77,157,51.0%,10m
1944,3,root,4316,334,15,6,21,71.4%,32m
1947,3,MilkBottle,4315,914,72,81,153,47.1%,17m
1947,1,Pressure,4315,0,0,1,1,0.0%,39m
1949,3,TrueNorth,4314,1074,148,121,269,55.0%,14m
1949,3,[GdAT]Bloodbird,4314,1194,63,33,96,65.6%,27m
1949,1,Tyki,4314,0,0,1,1,0.0%,39m
1949,1,yeeesh,4314,0,0,1,1,0.0%,30m
1953,3,[UpeV]Saggy,4313,1841,98,115,213,46.0%,10m
1953,3,[cl0udM]BrenMcBash,4313,1143,60,64,124,48.4%,23m
1953,1,IIIIIIIIIIII,4313,259,8,3,11,72.7%,37m
1956,1,llllllllll,4312,1845,242,185,427,56.7%,33m
1956,1,Durham,4312,0,0,1,1,0.0%,37m
1958,3,[LAAR]Spawn,4311,0,1,1,2,50.0%,6m
1959,3,InFlames,4310,338,31,33,64,48.4%,10m
1959,3,DogFaceKilla,4310,91,4,2,6,66.7%,6m
1959,1,GlitterFart,4310,0,1,0,1,100.0%,32m
1959,3,[DNKCFT]DANKCRAFT,4310,0,1,1,2,50.0%,12m
1963,2,Archile,4309,372,17,30,47,36.2%,19m
1963,2,[RnGpro]Jamary,4309,46,2,5,7,28.6%,23m
1965,3,Autumn,4308,340,18,28,46,39.1%,7m
1965,3,Nejedly,4308,121,3,1,4,75.0%,39m
1967,3,Lanparty,4307,389,21,20,41,51.2%,23m
1968,1,SorryGTG,4306,0,4,1,5,80.0%,24m
1968,1,[BCTA]Tribais,4306,0,0,1,1,0.0%,22m
1970,3,Babivegita,4305,1594,93,99,192,48.4%,12m
1970,3,[FFJUST]Pookie,4305,569,26,19,45,57.8%,28m
1970,2,huh,4305,344,15,1,16,93.8%,38m
1970,3,Jiki,4305,367,14,8,22,63.6%,10m
1970,3,GhostTemplar,4305,52,6,10,16,37.5%,9m
1975,3,[Pharoh]BsAndDs,4304,466,34,17,51,66.7%,37m
1975,3,NoobCake,4304,392,23,24,47,48.9%,6m
1975,3,HighTempered,4304,2,2,4,6,33.3%,9m
1975,3,Kreamy,4304,0,1,4,5,20.0%,9m
1975,1,Morph,4304,0,0,1,1,0.0%,38m
1975,1,Car,4304,0,0,1,1,0.0%,9m
1981,3,[LüpCat]LampMoth,4303,1543,150,118,268,56.0%,12m
1981,1,HKcow,4303,0,1,0,1,100.0%,9m
1983,3,asdasdasd,4302,104,8,16,24,33.3%,26m
1983,3,EgorLetov,4302,0,1,1,2,50.0%,28m
1985,3,IIIIIIIIIIII,4301,546,62,20,82,75.6%,37m
1985,3,Goobey,4301,478,34,41,75,45.3%,2m
1985,3,[TGosuA]Pyra,4301,661,29,14,43,67.4%,12m
1985,3,[LTK]Redeye,4301,173,12,12,24,50.0%,10m
1985,3,ThirtyBMI,4301,121,2,3,5,40.0%,17m
1985,3,assaf,4301,12,2,5,7,28.6%,7m
1985,3,skygarden,4301,97,1,2,3,33.3%,17m
1985,1,Pastepaste,4301,0,0,1,1,0.0%,7m
1993,3,lIIIIIllllII,4300,282,15,13,28,53.6%,18m
1993,3,Akaz,4300,4,2,3,5,40.0%,23m
1993,3,[xRtG]Ambition,4300,99,2,3,5,40.0%,2m
1996,3,Zuka,4298,164,7,6,13,53.8%,6m
1996,1,HOT,4298,96,2,3,5,40.0%,19m
1996,1,Suki,4298,0,0,1,1,0.0%,10m
1999,3,superMC,4297,378,19,9,28,67.9%,11m
1999,3,IlIlIlIlIlIl,4297,191,12,14,26,46.2%,10m
1999,2,[UFL]Jushyfruit,4297,200,6,4,10,60.0%,14m
1999,1,[Yuhang]wulala,4297,238,5,6,11,45.5%,20m
1999,1,Snowy,4297,126,4,0,4,100.0%,40m
1999,1,QYQY,4297,0,0,1,1,0.0%,11m
2005,3,KoreanAir,4296,1513,74,64,138,53.6%,27m
2005,2,AKIDA,4296,189,12,12,24,50.0%,24m
2007,3,[Staraf]GoroleX,4295,2026,137,115,252,54.4%,32m
2007,3,Assassin,4295,1293,91,49,140,65.0%,32m
2007,3,[SsaYnS]Caloreen,4295,770,47,54,101,46.5%,10m
2007,3,AdZ,4295,194,6,2,8,75.0%,13m
2011,3,Gin,4294,31,31,34,65,47.7%,6m
2011,2,Ghruul,4294,224,6,0,6,100.0%,23m
2011,2,[HBOOST]sparkling,4294,0,2,2,4,50.0%,6m
2014,2,[eSun]KATSKRADLE,4293,2393,612,643,1255,48.8%,18m
2014,2,[cl0udM]KilgoreTrout,4293,836,48,49,97,49.5%,27m
2014,3,crBox,4293,101,2,4,6,33.3%,14m
2014,3,what,4293,12,2,9,11,18.2%,5m
2018,2,[sENaTe]beepis,4292,2327,199,189,388,51.3%,2m
2018,1,Austinsaurus,4292,387,19,1,20,95.0%,26m
2018,3,NHNH,4292,153,6,4,10,60.0%,34m
2018,3,Nerdling,4292,100,4,7,11,36.4%,2h
2022,1,[LimaSC]DEADLOCK,4291,1562,85,79,164,51.8%,7m
2022,3,Frazwah,4291,16,5,4,9,55.6%,26m
2022,3,llllllllllll,4291,0,0,4,4,0.0%,7m
2025,3,[bc0de]barcode,4290,242,14,12,26,53.8%,13m
2025,2,[dLife]Ascarecroww,4290,0,1,4,5,20.0%,3m
2025,2,Villain,4290,0,0,16,16,0.0%,2m
2028,3,DrRex,4289,1746,235,219,454,51.8%,13m
2028,3,[iMkS]Metallicruc,4289,0,3,3,6,50.0%,10m
2030,3,llllllllllll,4288,162,17,21,38,44.7%,5m
2030,3,[MexSex]zoe,4288,195,12,10,22,54.5%,23m
2030,3,altrdSky,4288,12,2,15,17,11.8%,34m
2033,3,[eX]NeXusRush,4286,867,128,126,254,50.4%,6m
2033,1,LNext,4286,48,1,3,4,25.0%,37m
2035,2,DaiRY,4285,226,6,0,6,100.0%,22m
2036,3,[NwAs]ILifeI,4284,1893,255,249,504,50.6%,39m
2036,2,ThisGuy,4284,2367,144,120,264,54.5%,22m
2036,1,TheThinger,4284,1584,42,36,78,53.8%,31m
2036,3,[DRKFOX]Knighter,4284,704,36,20,56,64.3%,38m
2036,3,ZaramayBaby,4284,137,4,11,15,26.7%,10m
2036,1,JohnGoodman,4284,96,2,5,7,28.6%,22m
2036,3,SNM,4284,14,2,7,9,22.2%,9m
2036,1,Pouch,4284,0,1,1,2,50.0%,22m
2036,1,PigLovesWank,4284,0,1,1,2,50.0%,35m
2045,3,[αB]Melody,4283,116,9,16,25,36.0%,17m
2045,1,IIIIIIIIIIII,4283,48,1,3,4,25.0%,18m
2047,1,NNN,4282,732,16,16,32,50.0%,2h
2047,3,Promathos,4282,111,4,7,11,36.4%,34m
2047,1,[FyHr]Bond,4282,0,0,1,1,0.0%,35m
2050,2,llllllllllll,4281,556,34,48,82,41.5%,26m
2051,3,Dadio,4280,142,16,22,38,42.1%,38m
2051,3,[GnR]LiquidSolo,4280,74,8,13,21,38.1%,17m
2051,3,[TGCF]CrEEpYCLoWn,4280,97,1,4,5,20.0%,26m
2054,3,[GØSU]bobabomber,4279,2194,184,177,361,51.0%,11m
2054,3,Sammyuel,4279,1616,85,82,167,50.9%,13m
2054,3,llllllllllll,4279,18,2,7,9,22.2%,28m
2054,3,[BEANNN]llSickGame,4279,0,0,3,3,0.0%,34m
2058,1,[WNTRCO]Brenda,4278,239,8,3,11,72.7%,17m
2058,1,PartinG,4278,332,7,3,10,70.0%,24m
2058,1,[αB]Quark,4278,240,5,1,6,83.3%,35m
2061,3,[MadK]Nullmarker,4277,1244,98,112,210,46.7%,28m
2061,1,TerranUApart,4277,1394,33,22,55,60.0%,22m
2061,1,Probe,4277,1324,31,25,56,55.4%,29m
2061,1,toribio,4277,0,1,0,1,100.0%,30m
2061,1,ManSizedPP,4277,0,0,1,1,0.0%,34m
2066,3,[GnR]DrKobra,4276,2124,182,174,356,51.1%,34m
2066,3,IAmTheSenate,4276,1096,69,50,119,58.0%,39m
2066,3,[1Synd]uMadBro,4276,246,12,4,16,75.0%,32m
2066,3,[RBTH]Zura,4276,116,11,22,33,33.3%,2h
2066,3,Kingofblades,4276,26,9,10,19,47.4%,12m
2066,2,DeepsYug,4276,0,1,0,1,100.0%,9m
2072,1,[DhZPro]Zodte,4275,1750,43,45,88,48.9%,36m
2072,2,[lLiTl]IlIIIlllIIIl,4275,0,0,1,1,0.0%,35m
2074,3,IIIIIIIIIII,4274,1008,101,110,211,47.9%,30m
2075,3,llllllllllll,4273,447,25,8,33,75.8%,13m
2076,1,[GØSU]SkyWalkeR,4272,744,16,11,27,59.3%,36m
2076,3,[NovaX]MajiNCue,4272,4,1,5,6,16.7%,10m
2078,2,RedDogRiz,4271,1934,211,207,418,50.5%,15m
2078,3,[4IUR]Araragi,4271,867,46,53,99,46.5%,6m
2078,2,Sash,4271,293,14,1,15,93.3%,26m
2078,3,Vitross,4271,238,11,10,21,52.4%,38m
2078,2,SlipperyFart,4271,134,5,7,12,41.7%,7m
2078,3,Ike,4271,18,3,7,10,30.0%,28m
2078,1,Medic,4271,0,0,1,1,0.0%,28m
2085,3,RITZZITO,4270,433,23,9,32,71.9%,26m
2085,1,Huy,4270,423,20,4,24,83.3%,22m
2085,1,AToM,4270,740,17,17,34,50.0%,7m
2088,3,BlackShell,4269,774,111,93,204,54.4%,38m
2088,1,TreantGamer,4269,947,29,19,48,60.4%,17m
2090,3,[PeppR]EvolPenguin,4268,2114,177,196,373,47.5%,34m
2090,2,[ACGFAN]Magician,4268,926,56,55,111,50.5%,26m
2090,1,[ZTemp]SayNoToStim,4268,96,2,3,5,40.0%,32m
2093,1,MorningLappy,4266,288,11,3,14,78.6%,18m
2094,3,[ØFoxF2]Destro,4265,1045,132,131,263,50.2%,10m
2095,1,CWCHW,4264,380,8,5,13,61.5%,19m
2095,3,aaa,4264,139,8,8,16,50.0%,2h
2095,3,[IMDSI]EtherNal,4264,169,8,9,17,47.1%,9m
2095,1,Sinatra,4264,144,3,1,4,75.0%,25m
2099,3,[xENTx]MTSJoo,4263,1584,146,131,277,52.7%,28m
2099,3,asapjoe,4263,74,14,15,29,48.3%,28m
2101,3,UdinF,4262,1767,489,481,970,50.4%,5m
2101,3,[425]DrW,4262,665,121,132,253,47.8%,10m
2101,3,Sochino,4262,789,81,85,166,48.8%,10m
2101,1,CoochieMan,4262,1288,40,16,56,71.4%,22m
2101,3,Gtoss,4262,473,22,14,36,61.1%,23m
2106,3,[TeamUR]davidmg,4261,693,58,62,120,48.3%,18m
2106,1,Spinozah,4261,2000,57,44,101,56.4%,32m
2106,1,Notorious,4261,860,30,12,42,71.4%,30m
2106,1,[ZTempz]PaRaGoNPasT,4261,73,0,3,3,0.0%,9m
2110,3,[nG]HazikaN,4260,1555,105,104,209,50.2%,26m
2110,1,[GGu2EZ]HeReTiC,4260,154,5,1,6,83.3%,36m
2110,1,Martin,4260,115,3,2,5,60.0%,9m
2110,2,Huha,4260,0,1,0,1,100.0%,13m
2114,3,[M4nLUV]BaldSavage,4259,632,30,39,69,43.5%,28m
2114,3,IIIIIIIIIIII,4259,322,25,33,58,43.1%,10m
2114,1,Glimli,4259,0,0,1,1,0.0%,19m
2114,1,[kØ]ShaRkO,4259,0,0,1,1,0.0%,35m
2118,3,Kitten,4258,2137,171,175,346,49.4%,11m
2118,1,Ana,4258,544,17,7,24,70.8%,19m
2118,1,llllllllllll,4258,191,5,4,9,55.6%,31m
2121,1,[RVluv]Loki,4257,378,8,10,18,44.4%,18m
2122,1,[NAis]Jamesvin,4256,1316,32,24,56,57.1%,10m
2123,2,Carts,4255,2335,306,351,657,46.6%,15m
2123,3,Voidray,4255,1746,122,133,255,47.8%,30m
2123,3,Tasty,4255,247,18,15,33,54.5%,10m
2123,1,Turtle,4255,48,2,1,3,66.7%,24m
2123,1,Lottie,4255,48,2,3,5,40.0%,18m
2128,3,[DhZon3]Rangel,4254,671,60,44,104,57.7%,28m
2128,3,[D5FTWA]TheLastMelon,4254,478,35,43,78,44.9%,28m
2128,1,Nova,4254,192,4,7,11,36.4%,26m
2128,3,[FG]EGG,4254,6,2,11,13,15.4%,2m
2128,1,HiveMind,4254,0,1,0,1,100.0%,38m
2128,2,MariahCarry,4254,0,1,0,1,100.0%,29m
2128,1,[CDJT]MrPeanut,4254,0,0,1,1,0.0%,24m
2135,1,[FyHr]Andy,4253,1721,92,80,172,53.5%,30m
2135,3,DoRiToss,4253,935,49,36,85,57.6%,23m
2137,1,mpycuku,4252,144,4,3,7,57.1%,38m
2137,3,[OD2019]DrWeasel,4252,10,3,6,9,33.3%,7m
2139,3,[TGCrew]Darkblade,4251,1073,51,46,97,52.6%,14m
2139,1,IOOI,4251,353,9,3,12,75.0%,19m
2139,1,TheSTC,4251,211,5,6,11,45.5%,37m
2142,3,BigPeet,4250,357,15,14,29,51.7%,10m
2142,1,DarknessK,4250,215,5,2,7,71.4%,22m
2144,1,[cl0udM]NinjaDoggy,4249,2158,103,82,185,55.7%,2h
2144,3,[B33RCr]McTiger,4249,889,73,71,144,50.7%,13m
2144,3,Jack,4249,967,42,51,93,45.2%,32m
2147,1,Retsof,4248,0,1,1,2,50.0%,22m
2147,1,[SNSD]Zemagdnim,4248,0,0,1,1,0.0%,10m
2147,1,KEY,4248,0,0,6,6,0.0%,32m
2150,1,DneperRisinG,4246,712,15,11,26,57.7%,38m
2150,1,WildRage,4246,0,0,1,1,0.0%,30m
2152,2,ZuluDancer,4245,1767,202,202,404,50.0%,16m
2152,3,Data,4245,1129,188,192,380,49.5%,10m
2152,2,[Ris3n]Koda,4245,2019,104,117,221,47.1%,5m
2152,1,ZugZug,4245,673,24,21,45,53.3%,30m
2152,1,IIIIIIIIIIII,4245,306,7,5,12,58.3%,10m
2152,1,[CWKz]Maker,4245,48,2,4,6,33.3%,22m
2158,2,[WNTRLY]jscabra,4244,2303,136,142,278,48.9%,5m
2158,3,LuDo,4244,782,54,37,91,59.3%,28m
2158,1,[GGBr0]hihellowhihi,4244,0,1,0,1,100.0%,4m
2161,1,WiLLiAMS,4243,1513,101,84,185,54.6%,32m
2161,1,[LEB]TSRQwertY,4243,48,2,0,2,100.0%,38m
2163,1,PRoSu,4242,1108,27,14,41,65.9%,13m
2164,3,XXXTentacion,4241,1159,232,189,421,55.1%,13m
2164,1,[IMl]KazMishima,4241,2189,98,95,193,50.8%,20m
2164,3,[PiGPan]Wobulator,4241,431,26,31,57,45.6%,10m
2167,1,Duke,4240,2146,78,42,120,65.0%,2h
2167,3,Smash,4240,50,9,15,24,37.5%,17m
2169,3,Omega,4238,2120,252,257,509,49.5%,26m
2169,1,Avdelluis,4238,1383,83,74,157,52.9%,35m
2169,3,[GGK]Metaphysics,4238,110,51,40,91,56.0%,26m
2169,1,vhapteR,4238,1026,24,20,44,54.5%,28m
2173,3,Snake,4236,258,19,27,46,41.3%,39m
2173,2,MasterKenobi,4236,265,17,23,40,42.5%,2m
2173,1,[TGosuC]Lyra,4236,96,3,0,3,100.0%,22m
2176,2,[UpeV]Lapadula,4235,118,2,14,16,12.5%,20m
2177,1,Zerz,4233,2069,83,87,170,48.8%,31m
2177,3,ArTemiSFowL,4233,56,7,13,20,35.0%,5m
2179,1,Madcat,4232,568,12,7,19,63.2%,2h
2179,1,ImFromWuhan,4232,0,1,0,1,100.0%,9m
2179,1,Stone,4232,0,0,1,1,0.0%,24m
2182,3,[FNTSTC]DJLaoZi,4231,2139,281,296,577,48.7%,30m
2182,1,moki,4231,550,20,13,33,60.6%,10m
2182,1,Gratox,4231,48,2,0,2,100.0%,30m
2182,1,[xTQc]Thor,4231,0,1,0,1,100.0%,40m
2182,3,[ValidG]Penguin,4231,97,1,5,6,16.7%,10m
2187,1,[NwAs]ROY,4230,2174,105,118,223,47.1%,40m
2187,1,Pleakley,4230,1341,41,42,83,49.4%,31m
2187,1,Excalibur,4230,328,14,0,14,100.0%,4m
2187,1,Narsil,4230,0,0,1,1,0.0%,36m
2191,3,MajorMiner,4229,2105,137,125,262,52.3%,30m
2191,2,ZapBranigan,4229,488,24,41,65,36.9%,37m
2191,1,Spiffin,4229,501,13,14,27,48.1%,9m
2191,1,Fender,4229,48,2,4,6,33.3%,22m
2195,1,MiniAussie,4228,1414,174,172,346,50.3%,37m
2196,3,FreeHongKong,4227,552,41,42,83,49.4%,26m
2196,1,Karen,4227,1050,30,16,46,65.2%,26m
2196,1,BBBBBBbbbbbb,4227,1037,25,23,48,52.1%,39m
2196,3,mgjgshxd,4227,149,5,7,12,41.7%,5m
2196,3,[X17]WinstonSmith,4227,2,2,6,8,25.0%,23m
2201,3,OnionHead,4226,1672,160,152,312,51.3%,27m
2201,1,Tiramisu,4226,2227,111,116,227,48.9%,36m
2201,1,[Nanjol]Yoshino,4226,969,24,7,31,77.4%,22m
2201,3,[Hiii]Umami,4226,292,11,13,24,45.8%,9m
2205,1,NEW,4225,1611,54,32,86,62.8%,38m
2205,1,[UpxV]llllllllll,4225,652,15,9,24,62.5%,19m
2205,1,[BmJn]Tanker,4225,0,1,0,1,100.0%,38m
2205,3,Name,4225,4,1,3,4,25.0%,2h
2209,3,BreadForceXY,4224,2137,504,499,1003,50.2%,2m
2209,2,pilipilifan,4224,86,2,2,4,50.0%,34m
2209,1,[CURBGG]Pinsa,4224,0,1,0,1,100.0%,12m
2212,3,Shadow,4223,2129,451,465,916,49.2%,11m
2212,2,GuySensei,4223,2271,132,133,265,49.8%,20m
2212,3,[So0]youkka,4223,1872,96,113,209,45.9%,5m
2212,1,[PSISTC]neutrophil,4223,1888,54,46,100,54.0%,32m
2212,1,[dBASED]Serenity,4223,746,17,18,35,48.6%,35m
2212,2,Ronny,4223,0,1,0,1,100.0%,23m
2218,1,Zeratul,4222,1247,33,34,67,49.3%,19m
2218,1,[MASTRS]Fry,4222,96,3,5,8,37.5%,35m
2220,1,JoieIsDerp,4221,678,26,12,38,68.4%,30m
2221,1,Eyetalian,4220,1504,45,28,73,61.6%,12m
2221,3,SacredCoco,4220,676,31,30,61,50.8%,28m
2223,1,Protoss,4218,1584,47,29,76,61.8%,32m
2223,1,fraggles,4218,424,10,4,14,71.4%,38m
2225,2,[FINDEX]Jackal,4217,750,37,51,88,42.0%,20m
2225,3,[BRSS]CheeseZealot,4217,197,22,28,50,44.0%,13m
2227,3,[Ris3n]Rycerj,4216,1370,121,119,240,50.4%,14m
2227,1,moki,4216,1032,49,36,85,57.6%,17m
2229,1,LOOP,4215,1606,87,75,162,53.7%,37m
2229,2,Tohatzu,4215,0,1,0,1,100.0%,5m
2231,1,cookie,4214,1807,58,36,94,61.7%,18m
2231,1,GheyDood,4214,449,19,8,27,70.4%,30m
2231,1,SunRise,4214,616,14,13,27,51.9%,22m
2234,1,Alphonse,4213,1985,54,52,106,50.9%,25m
2234,1,DarkTech,4213,560,13,7,20,65.0%,37m
2234,1,Kratom,4213,0,3,2,5,60.0%,9m
2237,3,[cl0udM]iShartNOfart,4212,1716,86,92,178,48.3%,18m
2238,3,Reddox,4211,1595,163,140,303,53.8%,34m
2238,1,[αXLa]MarinDeHELAD,4211,1880,100,36,136,73.5%,19m
2240,1,[TgAg]Friend,4210,520,12,7,19,63.2%,18m
2240,1,GengaR,4210,0,4,1,5,80.0%,32m
2242,3,[AlIin]Warlord,4209,609,46,41,87,52.9%,37m
2242,1,Fass,4209,96,3,1,4,75.0%,17m
2242,1,[xNtG]FlawlessPim,4209,0,0,1,1,0.0%,18m
2242,1,EpicBattle,4209,0,0,1,1,0.0%,30m
2246,1,megafpierdol,4208,2176,135,97,232,58.2%,34m
2246,1,VibrantBlue,4208,2207,129,135,264,48.9%,18m
2246,1,[LoF]Time,4208,1046,40,43,83,48.2%,35m
2246,1,[NPhase]Nunley,4208,0,1,0,1,100.0%,32m
2250,1,[UpeV]Ganjhaman,4207,2245,111,120,231,48.1%,4m
2250,3,Fringe,4207,230,50,43,93,53.8%,18m
2250,1,Bush,4207,654,15,9,24,62.5%,38m
2250,1,[qazar]qazarProntf,4207,240,6,6,12,50.0%,24m
2254,3,[ValidG]Sujen,4206,1850,271,265,536,50.6%,18m
2254,1,Vardek,4206,48,3,3,6,50.0%,9m
2256,1,Prime,4205,756,18,9,27,66.7%,35m
2256,1,[Igbt]Formic,4205,48,1,1,2,50.0%,9m
2258,1,OKGo,4204,1361,115,106,221,52.0%,9m
2258,1,[NZER0]AJC,4204,0,0,5,5,0.0%,38m
2260,1,[TrckPd]vVvOxOvVv,4203,2072,170,163,333,51.1%,34m
2260,1,[neuroS]Qolt,4203,516,12,4,16,75.0%,8m
2260,1,Pegasides,4203,330,7,8,15,46.7%,18m
2260,3,[xRtG]Random,4203,0,1,0,1,100.0%,14m
2260,1,llllllllllll,4203,0,0,1,1,0.0%,38m
2265,2,dirtiestdan,4202,0,0,1,1,0.0%,35m
2266,3,[CCC]ClsClassiC,4201,1060,77,85,162,47.5%,18m
2266,1,[NwAs]Draconix,4201,1320,32,32,64,50.0%,36m
2266,1,[SCxPH]Animo,4201,1346,32,42,74,43.2%,22m
2266,2,LilyRiri,4201,579,24,46,70,34.3%,24m
2266,1,Eric,4201,0,1,0,1,100.0%,4m
2271,1,MelGibson,4200,2069,173,163,336,51.5%,25m
2271,1,[6ixS]Charm,4200,1038,23,18,41,56.1%,13m
2273,3,[αX]XenoDactyl,4199,2037,225,233,458,49.1%,37m
2273,3,Largo,4199,1111,61,63,124,49.2%,39m
2273,2,Free,4199,0,1,0,1,100.0%,38m
2273,1,[NwAs]JabalsalFB,4199,48,1,1,2,50.0%,17m
2277,3,NICOSIA,4197,1518,76,92,168,45.2%,28m
2277,1,[xRtG]HaHa,4197,0,0,2,2,0.0%,25m
2279,1,[UpeV]NewEra,4196,2114,62,51,113,54.9%,8m
2279,1,Stardust,4196,2024,59,50,109,54.1%,30m
2279,1,bodek,4196,1109,49,38,87,56.3%,24m
2282,3,Dog,4195,2077,239,239,478,50.0%,2h
2282,3,[BRSKR]Washikie,4195,794,46,56,102,45.1%,10m
2282,1,Kurajber,4195,857,29,12,41,70.7%,24m
2282,1,[PTHero]Cheoklate,4195,378,9,7,16,56.2%,17m
2282,1,[R3KTM8]TehEpicCat,4195,96,3,1,4,75.0%,22m
2282,1,Sponge,4195,96,2,1,3,66.7%,22m
2282,1,Malazan,4195,0,1,0,1,100.0%,13m
2282,1,hahagotem,4195,48,1,1,2,50.0%,39m
2290,1,ICE,4194,2491,368,398,766,48.0%,23m
2290,1,strelink,4194,2214,181,164,345,52.5%,17m
2290,1,llllllllllll,4194,928,29,18,47,61.7%,9m
2290,1,CaptCheese,4194,96,3,1,4,75.0%,9m
2290,1,Solenya,4194,0,1,1,2,50.0%,36m
2290,1,Nemesis,4194,0,1,1,2,50.0%,18m
2296,1,Executor,4193,1914,110,107,217,50.7%,19m
2296,3,[IPCSI]JuamPI,4193,1376,92,84,176,52.3%,26m
2296,2,Trap,4193,281,14,1,15,93.3%,30m
2296,2,OJsimpleton,4193,0,1,0,1,100.0%,36m
2300,1,[ZTemps]TeknoHamster,4192,1759,158,143,301,52.5%,37m
2300,3,[BLKISH]BlackishWolf,4192,591,64,64,128,50.0%,2h
2300,1,AvernOLyX,4192,288,6,7,13,46.2%,30m
2303,2,[FalPal]Terronic,4191,2288,279,308,587,47.5%,27m
2303,3,Silver,4191,1639,248,249,497,49.9%,27m
2303,1,zachxxx,4191,814,19,13,32,59.4%,14m
2303,1,BoopBeep,4191,323,15,5,20,75.0%,34m
2303,1,[αX]ViruS,4191,566,12,12,24,50.0%,37m
2303,1,[hahaez]cGRoyal,4191,518,11,14,25,44.0%,8m
2303,1,piggytails,4191,96,2,6,8,25.0%,37m
2303,1,[SoVA]Shaeman,4191,0,1,0,1,100.0%,35m
2303,1,[PSlSTC]BraDaDiah,4191,0,0,2,2,0.0%,25m
2303,1,Greatpark,4191,0,0,2,2,0.0%,30m
2313,3,SkyNine,4190,1041,106,107,213,49.8%,11m
2313,1,DrCongLock,4190,1438,43,25,68,63.2%,13m
2313,1,[αX]Kunamatata,4190,192,5,5,10,50.0%,18m
2313,1,Tada,4190,0,0,1,1,0.0%,22m
2317,3,Saber,4189,1051,76,50,126,60.3%,14m
2317,1,ZUHAIR,4189,890,63,65,128,49.2%,19m
2317,1,[αB]OctiDactyl,4189,1946,51,60,111,45.9%,10m
2317,1,MANRE,4189,1918,50,42,92,54.3%,27m
2317,1,flopwinner,4189,48,1,3,4,25.0%,17m
2317,1,luvkill,4189,0,0,4,4,0.0%,22m
2323,3,Sparks,4188,1210,117,126,243,48.1%,10m
2323,1,[kØ]xink,4188,2214,105,103,208,50.5%,28m
2323,1,[GdAT]BigCarrier,4188,358,14,2,16,87.5%,5m
2323,1,[VetZCo]POODLEHAT,4188,522,12,10,22,54.5%,30m
2323,1,breaker,4188,286,7,2,9,77.8%,32m
2328,1,[UpeV]SMSakurazawa,4187,1796,53,43,96,55.2%,30m
2328,1,Redsand,4187,48,2,0,2,100.0%,36m
2330,1,GivupDaGoods,4186,1913,111,106,217,51.2%,34m
2330,1,Scoundrel,4186,1765,50,37,87,57.5%,4m
2330,3,[ConFed]ShifuNess,4186,742,38,50,88,43.2%,18m
2330,1,Blindone,4186,412,21,4,25,84.0%,37m
2330,1,GivupDaGoods,4186,0,0,1,1,0.0%,20m
2335,1,[LAAR]Spawn,4185,144,4,1,5,80.0%,10m
2335,1,Jeeb,4185,48,1,2,3,33.3%,9m
2337,1,HeaTOn,4184,0,1,2,3,33.3%,37m
2338,1,[SC2PH]Azzin,4183,96,3,6,9,33.3%,2h
2338,1,[KingSC]Smirnov,4183,0,0,2,2,0.0%,39m
2340,3,[Xpk]LeOStorM,4182,2121,481,498,979,49.1%,34m
2340,3,[DBSQ]DiZzyFingErs,4182,2113,220,243,463,47.5%,6m
2340,3,[Antui]LEE,4182,2113,202,221,423,47.8%,11m
2340,1,Dedushka,4182,991,31,15,46,67.4%,38m
2340,1,LUNATIC,4182,781,29,28,57,50.9%,32m
2345,3,[PTHero]shWall,4181,2060,184,218,402,45.8%,13m
2345,1,PeterHartz,4181,380,9,6,15,60.0%,18m
2345,3,[cl0udM]Waterdrip,4181,34,4,2,6,66.7%,34m
2345,1,Garky,4181,0,2,4,6,33.3%,9m
2345,1,[Kingx]Cye,4181,0,1,4,5,20.0%,13m
2350,1,aSpanishGoat,4180,2226,654,611,1265,51.7%,30m
2350,3,llllllllllll,4180,659,36,38,74,48.6%,23m
2350,3,jtofdiamonds,4180,4,35,40,75,46.7%,30m
2350,1,RipStarcratf,4180,284,7,3,10,70.0%,12m
2354,1,[eSun]Pen,4179,2117,94,61,155,60.6%,26m
2354,1,[PHAN]Phantom,4179,1945,62,54,116,53.4%,33m
2354,1,HugeTosser,4179,1734,45,45,90,50.0%,2h
2354,1,IIIIIIIIIIII,4179,334,8,11,19,42.1%,19m
2358,1,[HTKK]Patruck,4178,360,8,4,12,66.7%,5m
2359,1,Watergate,4177,892,20,19,39,51.3%,8m
2359,1,[Antui]KaiMinG,4177,238,6,4,10,60.0%,34m
2361,3,SnækPlatypus,4176,891,57,60,117,48.7%,23m
2361,3,[EMTRMT]RemMajiTensh,4176,390,55,39,94,58.5%,28m
2361,1,[juggr]Grahan,4176,684,15,12,27,55.6%,35m
2361,1,subterran,4176,469,15,13,28,53.6%,25m
2361,1,[xRtG]TheGiantNome,4176,144,4,3,7,57.1%,40m
2361,1,SkOOg,4176,48,2,0,2,100.0%,17m
2361,1,SoulKey,4176,0,1,0,1,100.0%,18m
2368,1,ThotPatrol,4175,2213,148,108,256,57.8%,40m
2368,1,Crash,4175,1201,147,28,175,84.0%,38m
2368,1,llllllllllll,4175,634,18,10,28,64.3%,39m
2368,1,bluecard,4175,616,16,13,29,55.2%,10m
2372,3,[TAW]FrameSticker,4174,223,26,36,62,41.9%,18m
2372,1,PexNoob,4174,896,20,18,38,52.6%,9m
2372,1,Victor,4174,144,3,3,6,50.0%,40m
2375,1,IIIIIIIIIIII,4173,2145,307,329,636,48.3%,30m
2375,1,llllllllllll,4173,455,17,3,20,85.0%,32m
2377,2,Fester,4172,2120,530,545,1075,49.3%,27m
2377,3,Lisquid,4172,696,91,75,166,54.8%,9m
2377,1,[αX]Veritas,4172,192,5,6,11,45.5%,24m
2377,3,ProtossOP,4172,4,3,8,11,27.3%,28m
2377,1,soulkey,4172,0,1,0,1,100.0%,17m
2377,1,[αX]hiohu,4172,0,1,1,2,50.0%,37m
2377,2,FlashMarine,4172,0,1,2,3,33.3%,23m
2384,1,TIERRAPLANA,4171,1679,111,71,182,61.0%,19m
2384,1,IIIIIIIIIIII,4171,48,2,4,6,33.3%,10m
2386,3,[MRCYLS]Human,4170,1210,111,121,232,47.8%,11m
2386,1,YasuoMain,4170,1034,36,8,44,81.8%,24m
2386,1,[NPhase]Caquil,4170,1016,24,16,40,60.0%,19m
2386,1,[Macac0]kpa,4170,746,22,26,48,45.8%,18m
2386,1,omop,4170,278,11,9,20,55.0%,18m
2386,1,[EZDUNK]SnoKtoPus,4170,192,4,7,11,36.4%,40m
2386,1,IIIIIIIIIIII,4170,48,2,0,2,100.0%,4m
2386,1,SupremeEthan,4170,0,0,1,1,0.0%,33m
2394,1,[NKT1]Thor,4169,1201,100,79,179,55.9%,33m
2394,1,Inkarnate,4169,778,23,19,42,54.8%,19m
2394,1,Uras,4169,144,4,3,7,57.1%,8m
2394,3,Protoss,4169,0,1,0,1,100.0%,3m
2394,1,LePetomane,4169,0,1,2,3,33.3%,30m
2394,1,[PKMSSS]VANESSA,4169,0,0,4,4,0.0%,24m
2400,1,[YE3T]RedOctober,4168,1924,145,138,283,51.2%,40m
2400,1,Predictable,4168,894,54,32,86,62.8%,35m
2400,1,YeeHaw,4168,603,23,6,29,79.3%,2h
2400,1,[GOPERÚ]SrSARCASMO,4168,798,18,10,28,64.3%,30m
2400,1,Mica,4168,192,5,4,9,55.6%,37m
2400,1,HakunaMatata,4168,0,0,4,4,0.0%,30m
2406,3,[NovaX]Njwboom,4167,440,29,46,75,38.7%,2h
2407,3,BizktsNGravy,4166,2074,378,383,761,49.7%,18m
2407,1,Alekhine,4166,884,28,11,39,71.8%,4m
2407,3,POOWHILERUN,4166,240,25,36,61,41.0%,28m
2410,2,Ryu,4165,787,152,167,319,47.6%,30m
2410,1,[M4Ge]aCanofCoke,4165,2020,123,106,229,53.7%,33m
2410,1,Spawn,4165,519,22,7,29,75.9%,40m
2410,1,GraVity,4165,948,21,27,48,43.8%,38m
2410,1,[lLgNl]Benjadeath,4165,426,9,25,34,26.5%,10m
2410,1,[ACSS]Pixel,4165,96,3,2,5,60.0%,12m
2410,3,KIMCHI,4165,0,1,4,5,20.0%,29m
2417,3,llllllllllll,4164,144,18,29,47,38.3%,18m
2417,1,[Lp]Trululu,4164,315,7,3,10,70.0%,9m
2417,1,[FANXY]llllllllllll,4164,48,2,0,2,100.0%,9m
2417,1,[TKCT]NecrO,4164,48,1,2,3,33.3%,38m
2421,1,Muffinman,4163,1276,44,34,78,56.4%,35m
2421,1,[EGx]DrIron,4163,648,15,10,25,60.0%,14m
2421,3,Shadver,4163,152,15,27,42,35.7%,2m
2421,1,ibana,4163,420,9,5,14,64.3%,30m
2421,1,eseehc,4163,332,8,0,8,100.0%,24m
2421,1,Triquetra,4163,79,3,3,6,50.0%,9m
2427,1,Termination,4162,2220,104,93,197,52.8%,25m
2427,1,BlackMamba,4162,731,18,16,34,52.9%,10m
2427,1,Chihuahua,4162,548,13,2,15,86.7%,19m
2427,1,joaquin,4162,238,6,10,16,37.5%,2h
2427,1,eagleVISION,4162,144,3,1,4,75.0%,39m
2432,1,Mumble,4161,1976,173,153,326,53.1%,9m
2432,2,PeonPants,4161,788,35,55,90,38.9%,2m
2432,1,[CDGT]sheppard,4161,326,11,13,24,45.8%,35m
2432,1,IIIIIIIIIII,4161,418,10,3,13,76.9%,35m
2432,1,HOHOHOtoss,4161,426,9,11,20,45.0%,26m
2432,1,Mogwai,4161,0,1,0,1,100.0%,10m
2432,1,[INextI]ztkumm,4161,48,1,2,3,33.3%,33m
2432,1,[PwT]Christ,4161,0,0,1,1,0.0%,34m
2432,1,SandyRavage,4161,0,0,1,1,0.0%,29m
2441,3,[apoca]Adeul,4160,320,16,20,36,44.4%,10m
2441,1,[MSFT]fuinkaze,4160,0,1,1,2,50.0%,22m
2443,3,[xRtG]xobythesword,4159,2078,131,121,252,52.0%,18m
2443,1,Nepho,4159,96,2,3,5,40.0%,35m
2445,2,Beyondexx,4157,38,1,1,2,50.0%,25m
2445,1,[5CaRy]UCantWinMeOK,4157,0,0,1,1,0.0%,19m
2447,1,RipGeoff,4156,1270,31,21,52,59.6%,4m
2447,1,Raistlin,4156,564,23,5,28,82.1%,4m
2449,1,desTilat,4155,1978,68,63,131,51.9%,12m
2449,1,[EZDUNK]Cyanine,4155,144,3,6,9,33.3%,37m
2449,1,Shaman,4155,48,2,1,3,66.7%,31m
2452,1,[had12]llllllllllll,4154,673,22,7,29,75.9%,30m
2452,1,LastSupper,4154,731,20,8,28,71.4%,19m
2452,1,[Cl3f]SMB,4154,167,5,4,9,55.6%,29m
2455,3,Taku,4153,1299,154,168,322,47.8%,10m
2455,1,[TGosuD]SouthrnGamer,4153,695,15,9,24,62.5%,9m
2455,1,[LgnTDS]OmniSkeptic,4153,378,9,7,16,56.2%,32m
2455,1,PAOLO,4153,374,8,4,12,66.7%,13m
2455,1,xOx,4153,0,0,1,1,0.0%,9m
2460,1,Sirkappuccio,4152,2186,397,403,800,49.6%,2h
2460,3,[ØFoxF2]casti,4152,2100,147,156,303,48.5%,30m
2460,1,FFF,4152,456,15,2,17,88.2%,36m
2460,1,[TzToss]KeylowBravo,4152,664,15,14,29,51.7%,4m
2460,2,AiSaranG,4152,253,6,4,10,60.0%,32m
2460,1,[PskC]Kydro,4152,192,5,2,7,71.4%,5m
2460,3,Mycatsinheat,4152,10,5,16,21,23.8%,7m
2467,1,deeplounge,4151,839,29,15,44,65.9%,19m
2467,1,BraidToss,4151,0,1,0,1,100.0%,14m
2469,3,[GWSM]Ithalos,4150,129,100,100,200,50.0%,2h
2469,2,carriermom,4150,104,6,4,10,60.0%,24m
2469,2,Cocodor,4150,84,2,2,4,50.0%,5m
2472,1,KiiiA,4149,1774,81,73,154,52.6%,20m
2472,1,[ReB]nOobO,4149,787,18,26,44,40.9%,10m
2474,1,IIIIIIIIIIII,4148,835,30,13,43,69.8%,8m
2474,2,Frums,4148,414,18,3,21,85.7%,35m
2474,1,Berserker,4148,374,9,5,14,64.3%,37m
2474,3,xelnegro,4148,0,1,0,1,100.0%,23m
2474,3,ProtossOP,4148,0,0,1,1,0.0%,30m
2474,1,SacrifuSion,4148,0,0,2,2,0.0%,9m
2480,1,[TXOP]Aquox,4147,2123,131,117,248,52.8%,30m
2480,1,PekoSuiGura,4147,96,3,4,7,42.9%,9m
2480,1,Yanzi,4147,0,1,5,6,16.7%,26m
2480,1,Nualkrid,4147,46,1,7,8,12.5%,30m
2484,1,zion,4146,1060,25,25,50,50.0%,17m
2484,1,[Peso]SupperStar,4146,992,22,14,36,61.1%,40m
2484,1,IIIllIlIlIIl,4146,374,8,5,13,61.5%,32m
2484,1,SimpStomper,4146,220,6,3,9,66.7%,34m
2484,1,EzGameEzLife,4146,240,5,8,13,38.5%,25m
2489,1,TheMuffinMan,4145,476,10,17,27,37.0%,20m
2489,1,COVID,4145,317,7,5,12,58.3%,9m
2489,2,MrBean,4145,178,5,10,15,33.3%,34m
2489,1,ZerO,4145,190,4,6,10,40.0%,39m
2493,3,[TSØP]mOntag,4144,303,33,47,80,41.2%,6m
2493,1,[xTQc]NotinMkSens,4144,96,3,2,5,60.0%,22m
2495,3,[Ris3n]Bizzaro,4143,1517,189,194,383,49.3%,34m
2495,1,Foland,4143,1463,44,28,72,61.1%,30m
2495,1,hydralisk,4143,954,24,13,37,64.9%,10m
2495,3,Grisgris,4143,285,14,18,32,43.8%,34m
2495,1,CiscoCert,4143,374,10,6,16,62.5%,32m
2495,1,[H264]EdogawaConan,4143,192,4,6,10,40.0%,39m
2495,1,BlueCuracao,4143,0,1,0,1,100.0%,10m
2495,1,[xLgNx]KinkySlinky,4143,0,0,1,1,0.0%,36m
2503,3,[PSISTM]KenjiMuyo,4142,1072,106,83,189,56.1%,15m
2503,1,KeanuReeves,4142,1443,46,30,76,60.5%,19m
2503,1,[425]MikEyMauS,4142,376,9,10,19,47.4%,10m
2503,1,llllllllllll,4142,372,8,4,12,66.7%,19m
2503,1,Denuve,4142,328,7,2,9,77.8%,18m
2503,3,vult,4142,4,6,4,10,60.0%,13m
2509,1,LioN,4141,1958,116,102,218,53.2%,25m
2509,1,IIIIIIIIIIII,4141,1933,88,64,152,57.9%,30m
2509,1,AJStyles,4141,333,17,6,23,73.9%,9m
2509,3,CanadianTire,4141,104,11,22,33,33.3%,23m
2509,1,Neisseria,4141,0,2,4,6,33.3%,31m
2509,1,llllllllllll,4141,0,1,0,1,100.0%,30m
2515,1,Parallax,4140,2200,158,155,313,50.5%,29m
2515,3,WoShiNiBa,4140,1603,145,161,306,47.4%,9m
2515,1,[G0G0G0]GOGOGO,4140,94,4,4,8,50.0%,18m
2515,1,dukdukmoose,4140,48,2,5,7,28.6%,12m
2515,1,Taimyr,4140,0,1,0,1,100.0%,9m
2515,3,[RBTH]Crown,4140,0,0,1,1,0.0%,40m
2515,1,[WNTR]Zpassion,4140,0,0,2,2,0.0%,22m
2515,2,Quavo,4140,0,0,4,4,0.0%,39m
2523,1,[SC559]AntBurglar,4139,1668,79,61,140,56.4%,30m
2523,1,llllllllllll,4139,1338,33,27,60,55.0%,8m
2523,1,pboyle,4139,144,4,7,11,36.4%,30m
2523,1,StArLiqUiD,4139,0,1,0,1,100.0%,25m
2523,1,[Msia]Animal,4139,0,1,4,5,20.0%,2h
2528,1,Clue,4138,986,85,72,157,54.1%,30m
2528,1,TitanStorm,4138,236,10,3,13,76.9%,9m
2528,1,Mongoloid,4138,0,0,1,1,0.0%,35m
2531,1,opo,4137,2174,172,147,319,53.9%,39m
2531,3,Fialka,4137,317,21,32,53,39.6%,17m
2531,2,llllllllllll,4137,0,0,1,1,0.0%,3m
2534,1,Alrob,4136,686,26,9,35,74.3%,27m
2534,1,eoS,4136,276,6,3,9,66.7%,33m
2534,1,hustle,4136,288,6,8,14,42.9%,14m
2534,1,[ConFed]Dorduradan,4136,48,1,5,6,16.7%,9m
2538,2,[xRtG]KìììÂ,4135,1716,329,320,649,50.7%,30m
2538,1,[SsaYnS]MangKanorPH,4135,876,52,46,98,53.1%,32m
2538,1,[JlHAD]Apocalyptron,4135,994,26,12,38,68.4%,22m
2541,3,Artanisph,4134,489,31,43,74,41.9%,15m
2541,3,[ValidG]IzzyMeanWeeb,4134,36,7,18,25,28.0%,38m
2541,2,TurkeyHawk,4134,0,0,2,2,0.0%,9m
2544,3,Whine,4133,1227,81,91,172,47.1%,39m
2544,1,IIIIIIIIIIII,4133,967,36,16,52,69.2%,19m
2544,1,PYPY,4133,747,26,11,37,70.3%,2h
2544,1,[P0G]ThoR,4133,0,1,0,1,100.0%,12m
2548,1,Rose,4132,1388,99,85,184,53.8%,20m
2548,1,CryLegion,4132,1701,97,76,173,56.1%,35m
2548,1,IIIIIIIIIIII,4132,415,20,4,24,83.3%,32m
2548,1,MogA,4132,708,16,11,27,59.3%,32m
2552,1,mullito,4131,779,17,17,34,50.0%,2h
2552,1,[BRSKR]Epitaph,4131,144,4,0,4,100.0%,12m
2554,1,[xRtG]TheSizzler,4130,1884,64,59,123,52.0%,10m
2554,1,[AIlin]HotboxHero,4130,1460,39,41,80,48.8%,5m
2554,1,TheBreaker,4130,803,23,11,34,67.6%,37m
2557,1,shromsdaburd,4129,1311,107,67,174,61.5%,35m
2557,1,Xier,4129,552,12,10,22,54.5%,22m
2559,3,OMardil,4128,1500,156,156,312,50.0%,13m
2559,1,[ZYZY]BbTea,4128,228,11,0,11,100.0%,24m
2559,1,[cumy]Updraft,4128,94,3,1,4,75.0%,5m
2559,1,[KSTN]AnyTime,4128,0,0,2,2,0.0%,19m
2563,3,Jyxz,4127,817,82,77,159,51.6%,18m
2563,2,Sarai,4127,42,2,0,2,100.0%,35m
2563,1,Hidra,4127,48,2,2,4,50.0%,38m
2563,1,KevinBacon,4127,0,1,0,1,100.0%,35m
2567,1,[UCI]Requiem,4126,2150,156,159,315,49.5%,2h
2567,3,[ABPK]Vyse,4126,0,2,3,5,40.0%,26m
2569,1,[G0Iden]Fire,4125,1014,23,29,52,44.2%,30m
2569,2,BernsteinD,4125,364,13,2,15,86.7%,13m
2569,3,[Z0HR]Anarchy,4125,58,3,0,3,100.0%,3m
2569,1,Amped,4125,48,1,6,7,14.3%,9m
2573,1,CaiB,4124,442,14,6,20,70.0%,35m
2573,2,[llTrap]ChoSungHo,4124,222,12,1,13,92.3%,23m
2573,1,[Bee]Athena,4124,293,8,8,16,50.0%,26m
2573,1,poizon,4124,48,2,2,4,50.0%,8m
2577,3,SmashBros,4123,2007,167,177,344,48.5%,7m
2577,1,zacarizac,4123,2141,67,57,124,54.0%,9m
2577,1,Tezu,4123,498,20,5,25,80.0%,9m
2577,1,Magic,4123,387,8,5,13,61.5%,32m
2581,1,Quixotic,4122,2172,188,189,377,49.9%,37m
2581,1,DPGPartinG,4122,1510,48,29,77,62.3%,19m
2581,1,[kØ]SeLenDiS,4122,1371,44,47,91,48.4%,36m
2581,1,[iPG]Chodder,4122,165,5,5,10,50.0%,13m
2585,1,TrueSouth,4121,1562,185,180,365,50.7%,17m
2585,3,BBx,4121,2054,165,170,335,49.3%,11m
2585,1,Autumn,4121,274,7,4,11,63.6%,19m
2585,1,TAS,4121,236,6,2,8,75.0%,30m
2585,1,[PobSC]Poblha,4121,0,0,1,1,0.0%,12m
2590,1,[ØFoxF2]markus,4120,2150,365,357,722,50.6%,36m
2590,1,TYTANIC,4120,2157,230,214,444,51.8%,20m
2590,1,[NwAs]leshrac,4120,938,21,20,41,51.2%,19m
2590,1,[GR33D]Telaranrhiod,4120,844,20,14,34,58.8%,35m
2590,1,IIIIIIIIIIII,4120,736,17,13,30,56.7%,2h
2590,1,[WaiFou]MouseMarine,4120,566,12,18,30,40.0%,30m
2590,1,Legendary,4120,192,5,11,16,31.2%,26m
2590,2,SmokeCocaine,4120,88,3,3,6,50.0%,12m
2590,1,BustmyBanes,4120,48,3,4,7,42.9%,9m
2599,1,OGcrafter,4119,1163,157,148,305,51.5%,33m
2599,3,IIIIIIIIIIII,4119,2030,137,171,308,44.5%,11m
2599,1,lllllllll,4119,613,47,20,67,70.1%,10m
2599,3,[TMGSC]Perfidy,4119,753,44,45,89,49.4%,37m
2599,1,[oJKo]IShatMyself,4119,1044,25,18,43,58.1%,14m
2599,1,XDsGrrr,4119,0,0,1,1,0.0%,37m
2599,1,IUI,4119,0,0,1,1,0.0%,34m
2599,3,metamagic,4119,0,0,5,5,0.0%,14m
2607,3,[FriGD]XenoWeapon,4118,2029,456,461,917,49.7%,30m
2607,1,GGsmile,4118,1367,46,26,72,63.9%,9m
2607,1,HackaXorean,4118,1319,34,33,67,50.7%,22m
2607,1,[CaoGe]IlI,4118,255,14,2,16,87.5%,18m
2607,1,Shimada,4118,471,11,3,14,78.6%,27m
2607,1,Avrora,4118,365,9,5,14,64.3%,20m
2613,1,[MIT]Nik,4117,2140,135,130,265,50.9%,34m
2613,1,[HØST]VicBansemer,4117,2106,119,101,220,54.1%,39m
2613,1,PacFROST,4117,933,22,17,39,56.4%,35m
2613,1,IIIIIIIIIIII,4117,178,4,0,4,100.0%,30m
2617,1,Ether,4116,1988,174,169,343,50.7%,24m
2617,1,ODIN,4116,1786,84,62,146,57.5%,30m
2617,1,Flower,4116,523,17,4,21,81.0%,9m
2620,1,[Xpk]LimeLight,4115,594,14,6,20,70.0%,34m
2620,1,AluKarD,4115,286,7,3,10,70.0%,19m
2622,1,Alan,4114,2147,99,94,193,51.3%,4m
2622,1,[Gen54]generationcw,4114,508,11,16,27,40.7%,2h
2622,1,Stealth,4114,0,0,4,4,0.0%,38m
2625,3,TerranKiller,4113,1306,69,54,123,56.1%,11m
2625,1,Nungg,4113,1586,68,46,114,59.6%,30m
2625,1,Zerg,4113,48,5,3,8,62.5%,18m
2628,1,[KingSC]IMDaggoth,4112,1749,46,47,93,49.5%,4m
2628,1,deuce,4112,48,2,8,10,20.0%,35m
2630,1,IAMCANADIAN,4111,2116,578,566,1144,50.5%,17m
2630,1,DirtDiver,4111,1960,145,129,274,52.9%,37m
2630,1,[LgnTDS]Zerg,4111,1601,54,30,84,64.3%,40m
2630,3,TheTruth,4111,388,38,35,73,52.1%,18m
2630,2,YuhangYuhang,4111,244,6,2,8,75.0%,21m
2630,1,[TGosuB]eliteslayer,4111,186,5,4,9,55.6%,4m
2630,1,[EAZDC]Jaedolph,4111,46,1,2,3,33.3%,9m
2637,1,Marty,4110,1017,79,88,167,47.3%,39m
2637,1,ALBANINJA,4110,915,32,14,46,69.6%,9m
2639,1,[HI420]WOLF,4109,1401,40,46,86,46.5%,2h
2639,1,mQvQm,4109,484,20,6,26,76.9%,27m
2639,3,[AD3C]CuBaNo,4109,212,18,38,56,32.1%,18m
2639,1,[djinni]Set,4109,200,7,4,11,63.6%,2h
2639,1,llllllllllll,4109,193,4,7,11,36.4%,2h
2639,1,[GTnLB]Ryoku,4109,48,1,1,2,50.0%,37m
2639,1,[GanSi]YTTTY,4109,0,0,1,1,0.0%,10m
2646,1,llllllllllll,4108,380,9,9,18,50.0%,9m
2646,1,RozeEagle,4108,48,2,4,6,33.3%,39m
2646,1,[Kaii]BabyDriver,4108,0,1,0,1,100.0%,19m
2646,1,[Milkrs]IJVMS,4108,0,0,1,1,0.0%,37m
2650,3,NOGG,4107,1632,156,163,319,48.9%,26m
2650,1,lllllllll,4107,1495,88,73,161,54.7%,35m
2650,1,[LoF]AndurilDH,4107,1399,43,46,89,48.3%,5m
2650,1,ineedtopeeee,4107,236,6,8,14,42.9%,12m
2650,1,Sammuelmumm,4107,96,1,1,2,50.0%,2h
2655,1,Phx,4106,1729,98,91,189,51.9%,30m
2655,1,llllllllllll,4106,1449,41,25,66,62.1%,29m
2655,1,MukohAoi,4106,1104,40,18,58,69.0%,30m
2655,1,[MtS]Shark,4106,620,14,16,30,46.7%,30m
2655,1,[ValidG]kali,4106,46,2,0,2,100.0%,8m
2655,1,[KingSC]InFected,4106,0,1,0,1,100.0%,10m
2661,1,FrozenPizza,4105,708,35,18,53,66.0%,33m
2661,1,[BJWD]llllllllllll,4105,665,22,2,24,91.7%,38m
2663,3,[HØST]DarkVorazun,4104,1260,79,95,174,45.4%,7m
2663,1,[αB]GenoaSalami,4104,1603,45,40,85,52.9%,40m
2663,1,Rumpelstilsk,4104,144,3,8,11,27.3%,34m
2663,1,[MLC]JelQQing,4104,48,1,5,6,16.7%,9m
2667,1,KowKowKow,4103,261,14,1,15,93.3%,24m
2667,1,[Luzy]Caretaker,4103,279,13,1,14,92.9%,2h
2669,1,[IMDSI]DoctorGarcía,4102,318,11,13,24,45.8%,19m
2669,1,[HankH]bobbyShmurda,4102,238,5,1,6,83.3%,5m
2669,1,Xana,4102,36,2,0,2,100.0%,8m
2669,1,gossen,4102,0,1,1,2,50.0%,9m
2673,1,SSS,4100,185,8,2,10,80.0%,2h
2673,1,SynthetiC,4100,96,2,5,7,28.6%,39m
2675,3,Law,4099,1104,51,49,100,51.0%,18m
2675,1,AnniKa,4099,838,24,19,43,55.8%,34m
2677,1,[TxC1]TakeMyHand,4098,309,10,8,18,55.6%,19m
2678,1,Foxer,4097,282,6,7,13,46.2%,38m
2678,1,Gengar,4097,48,1,9,10,10.0%,39m
2680,1,CANONBALL,4096,1754,148,103,251,59.0%,37m
2680,1,Victor,4096,460,11,6,17,64.7%,14m
2680,1,BabyTerran,4096,291,5,4,9,55.6%,37m
2680,2,Oberoth,4096,0,0,1,1,0.0%,23m
2684,3,Hobodan,4095,2050,566,574,1140,49.6%,27m
2684,1,tunnel,4095,1243,164,153,317,51.7%,39m
2684,3,MrMidnight,4095,1196,67,79,146,45.9%,7m
2684,1,SIM,4095,96,3,2,5,60.0%,9m
2684,1,[LDCO]Cronopio,4095,0,0,1,1,0.0%,4m
2689,3,[cl0udM]DeathByToss,4094,2051,296,295,591,50.1%,30m
2689,1,[LowIQ]Fergus,4094,520,11,14,25,44.0%,9m
2689,1,honker,4094,330,8,8,16,50.0%,12m
2689,1,[M4nLUV]SacSurgeon,4094,0,2,3,5,40.0%,30m
2689,1,[CRAKS]TheNewAlarak,4094,48,1,1,2,50.0%,40m
2694,1,Megumin,4093,434,16,5,21,76.2%,24m
2694,1,[TSVB]BaumesBaum,4093,333,14,2,16,87.5%,12m
2694,1,Adroseth,4093,0,0,1,1,0.0%,32m
2697,1,ruffryda,4092,0,0,1,1,0.0%,40m
2698,1,HeartOfHope,4091,2120,78,65,143,54.5%,12m
2698,1,Player,4091,1350,45,26,71,63.4%,4m
2698,1,llllllllllll,4091,651,23,10,33,69.7%,30m
2698,1,Buggsy,4091,806,19,17,36,52.8%,19m
2698,1,[NwAs]LPanda,4091,0,4,3,7,57.1%,29m
2698,1,Protosgonist,4091,0,3,2,5,60.0%,32m
2704,1,GreatRaging,4090,330,8,9,17,47.1%,34m
2704,1,Sarigden,4090,96,2,7,9,22.2%,25m
2704,1,Painism,4090,0,1,0,1,100.0%,10m
2707,3,[DhZPro]TAG,4089,902,466,477,943,49.4%,29m
2707,1,[SCTP]llllllllllll,4089,684,22,26,48,45.8%,19m
2709,3,[2LP]SynDroM,4088,2042,281,283,564,49.8%,13m
2709,1,[THYGAP]SortaSus,4088,1755,53,52,105,50.5%,19m
2709,3,[SCNS]MyNameAlice,4088,308,45,59,104,43.3%,11m
2709,1,Agnoletto,4088,606,14,14,28,50.0%,31m
2709,1,[TeamUR]KOali,4088,0,0,1,1,0.0%,10m
2714,1,[UpeV]KevinECU,4087,653,22,8,30,73.3%,13m
2714,1,ThePhoBros,4087,840,20,18,38,52.6%,36m
2714,1,PussiBarcode,4087,0,3,4,7,42.9%,24m
2714,1,Tempest,4087,0,1,0,1,100.0%,29m
2714,1,ALLBback,4087,0,1,0,1,100.0%,40m
2719,1,[Dicboy]cpark,4086,2145,195,194,389,50.1%,5m
2719,1,[HUSHrx]Stegosaurus,4086,573,34,18,52,65.4%,36m
2721,1,FinaL,4085,1897,124,132,256,48.4%,4m
2721,3,helloworld,4085,437,34,41,75,45.3%,13m
2721,2,Lukman,4085,132,4,12,16,25.0%,24m
2721,1,[InSpir]yogi,4085,48,1,2,3,33.3%,19m
2725,1,Atlas,4084,2077,241,208,449,53.7%,19m
2725,1,[cct]Moombaex,4084,2112,135,119,254,53.1%,31m
2725,1,[HyperX]BaKady,4084,140,4,0,4,100.0%,2h
2725,1,[Ozzie]Bjl,4084,0,1,0,1,100.0%,25m
2729,1,Leviatán,4083,1668,299,326,625,47.8%,19m
2729,1,[Suan]MicroBot,4083,380,9,4,13,69.2%,17m
2729,1,GapeHorn,4083,48,4,2,6,66.7%,9m
2732,1,[REPORT]SupajooflY,4082,1999,354,322,676,52.4%,30m
2732,1,DevilSeed,4082,2130,77,73,150,51.3%,9m
2732,3,callmechamp,4082,474,40,46,86,46.5%,7m
2735,1,[DHAL]SorC,4081,2132,197,175,372,53.0%,32m
2735,3,[TeamUR]FireKlaw,4081,1581,153,176,329,46.5%,11m
2737,1,Turambar,4080,190,5,1,6,83.3%,9m
2737,1,orcrine,4080,48,2,1,3,66.7%,10m
2737,1,Joey,4080,0,1,2,3,33.3%,5m
2740,1,BigotKing,4079,1454,58,72,130,44.6%,19m
2740,1,Kyezer,4079,767,38,39,77,49.4%,9m
2740,3,DonkBacon,4079,0,3,2,5,60.0%,5m
2743,1,Illllllllll,4078,1972,57,67,124,46.0%,37m
2743,1,SputniK,4078,1011,33,19,52,63.5%,10m
2743,1,[kØ]PaTheTiC,4078,592,13,6,19,68.4%,31m
2746,1,Bacontank,4077,1286,96,89,185,51.9%,40m
2746,2,[NAF]OldEvenBeard,4077,44,3,9,12,25.0%,33m
2746,1,[HUSHrx]DarkwingDuck,4077,48,2,0,2,100.0%,19m
2746,2,FeelsBadMan,4077,0,1,0,1,100.0%,17m
2746,1,[SC2PH]Shadow,4077,0,0,2,2,0.0%,39m
2751,1,Business,4076,2038,314,305,619,50.7%,40m
2751,1,[3RAI]Ender,4076,1069,28,27,55,50.9%,8m
2751,1,oGkTiny,4076,642,27,19,46,58.7%,31m
2751,2,IIIIIIIIIIII,4076,242,6,3,9,66.7%,34m
2751,1,[BbTea]TrapStats,4076,48,2,0,2,100.0%,31m
2751,1,Jenny,4076,0,1,2,3,33.3%,37m
2757,3,[scMAUI]Maxbrutus,4075,2041,126,131,257,49.0%,2m
2757,1,[SSEAS]GatewayMan,4075,764,18,12,30,60.0%,9m
2757,1,[Lp]gatoloco,4075,238,6,2,8,75.0%,10m
2757,1,[MSUsc2]SpiKeYMaN,4075,190,4,5,9,44.4%,40m
2757,1,[AYB]Kieran,4075,94,2,1,3,66.7%,22m
2757,1,Pylon,4075,0,1,0,1,100.0%,36m
2757,1,TheReapist,4075,0,1,0,1,100.0%,4m
2764,1,Genesis,4074,1881,398,394,792,50.3%,9m
2764,1,[TNoS]DaBaum,4074,2053,126,121,247,51.0%,24m
2764,1,Tenth,4074,805,33,14,47,70.2%,30m
2764,1,SicKRat,4074,869,24,21,45,53.3%,2h
2768,1,MiYaaaaaa,4073,2048,83,79,162,51.2%,10m
2768,1,Samozatebe,4073,48,1,5,6,16.7%,40m
2768,1,Timeout,4073,0,0,3,3,0.0%,5m
2771,1,NiTGriT,4072,332,8,9,17,47.1%,9m
2771,1,[H0PES]HopeTurtle,4072,0,0,4,4,0.0%,35m
2773,1,SicklySomali,4071,1119,53,25,78,67.9%,38m
2773,2,MacroMantis,4071,369,16,4,20,80.0%,14m
2773,1,Twentynine,4071,441,12,1,13,92.3%,26m
2773,1,Egwene,4071,349,10,4,14,71.4%,2h
2773,1,Bekzhan,4071,279,10,7,17,58.8%,13m
2778,1,Heemang,4070,1074,37,25,62,59.7%,8m
2779,1,[KingSC]Maydaz,4069,1668,71,56,127,55.9%,14m
2779,1,[FANXY]Elfantome,4069,46,1,1,2,50.0%,32m
2779,1,[ScSwrm]tso,4069,46,1,1,2,50.0%,27m
2779,1,[dioses]Alberthor,4069,0,0,1,1,0.0%,8m
2783,3,MatrixLegend,4068,1923,173,167,340,50.9%,11m
2783,1,[puCked]Black,4068,192,6,10,16,37.5%,37m
2783,1,[BLM4Ev]RIPGeorgeF,4068,0,1,0,1,100.0%,4m
2783,1,sirPlayALot,4068,0,1,4,5,20.0%,8m
2787,1,Whirros,4067,1004,31,31,62,50.0%,8m
2787,1,[iMkS]Antonio,4067,0,1,0,1,100.0%,9m
2787,1,[CIMKR]iiiiiiiiiiii,4067,0,0,1,1,0.0%,38m
2787,1,MrPro,4067,0,0,1,1,0.0%,18m
2791,3,KillerBeez,4066,1998,454,458,912,49.8%,15m
2791,1,[KwK]Kewekeke,4066,1313,108,100,208,51.9%,10m
2791,1,[TAW]SpaceMarine,4066,574,12,21,33,36.4%,40m
2791,1,[TVGL]Merchant,4066,0,4,1,5,80.0%,8m
2791,1,TraderJoe,4066,48,1,2,3,33.3%,9m
2791,1,[Phaaal]Asuka,4066,0,0,1,1,0.0%,31m
2797,1,SUBmyDIC,4065,2117,150,122,272,55.1%,19m
2797,1,CashMeOwside,4065,2134,124,89,213,58.2%,12m
2797,1,[AngelA]Angelus,4065,374,8,13,21,38.1%,33m
2797,1,Nero,4065,238,6,7,13,46.2%,34m
2797,1,MicrOJordaaN,4065,0,1,7,8,12.5%,19m
2797,1,[DarkAG]tunechi,4065,0,0,1,1,0.0%,19m
2803,1,Flash,4064,854,21,18,39,53.8%,35m
2803,1,[Flar3s]masterchif,4064,89,3,5,8,37.5%,24m
2803,2,David,4064,0,1,0,1,100.0%,5m
2806,1,Pexavi,4063,1830,84,77,161,52.2%,22m
2806,1,ClemenC,4063,1337,39,46,85,45.9%,10m
2806,1,GeoJE,4063,46,2,2,4,50.0%,27m
2809,1,mightyowl,4062,0,1,1,2,50.0%,39m
2809,1,[HØST]ShokWaze,4062,0,0,2,2,0.0%,32m
2811,1,ArriSTv,4061,762,18,22,40,45.0%,40m
2811,1,[TSCpro]PrObE,4061,0,0,1,1,0.0%,39m
2813,1,llll,4060,96,2,1,3,66.7%,13m
2813,1,BrazilEatsDT,4060,0,1,0,1,100.0%,12m
2815,3,[Nut69]Ike,4059,549,137,128,265,51.7%,30m
2815,1,llllllllllll,4059,1758,68,59,127,53.5%,22m
2815,3,[HF]YodeN,4059,252,38,47,85,44.7%,23m
2815,1,[Scoop]FunkyMonke,4059,1214,37,34,71,52.1%,4m
2819,3,[xRtG]Freedomflyer,4058,1998,358,374,732,48.9%,13m
2819,1,Kovaz,4058,617,24,12,36,66.7%,24m
2819,1,aFterMath,4058,461,14,7,21,66.7%,2h
2819,1,freeHK,4058,466,11,11,22,50.0%,5m
2819,2,THORISHERE,4058,206,6,1,7,85.7%,27m
2824,1,LowApm,4057,697,29,21,50,58.0%,33m
2824,1,Minerush,4057,361,12,5,17,70.6%,12m
2824,1,robih,4057,282,6,8,14,42.9%,34m
2827,1,SmellyOnion,4056,1936,62,68,130,47.7%,32m
2827,1,[FxB]caiobex,4056,1746,48,54,102,47.1%,19m
2827,1,[TG3]learytheory,4056,893,46,32,78,59.0%,37m
2827,1,HDinev,4056,957,36,20,56,64.3%,9m
2827,1,Wabble,4056,693,17,16,33,51.5%,39m
2827,1,[HOT87]HOT,4056,96,3,1,4,75.0%,9m
2827,1,Zeo,4056,0,1,1,2,50.0%,14m
2827,1,[YRH]Willow,4056,0,1,5,6,16.7%,14m
2835,3,Bongsam,4055,2015,302,304,606,49.8%,9m
2835,1,doodledinks,4055,1618,91,71,162,56.2%,38m
2835,3,Hippedfish,4055,114,79,91,170,46.5%,13m
2835,1,Influenzahah,4055,797,31,11,42,73.8%,22m
2835,3,theNuclide,4055,569,31,19,50,62.0%,5m
2835,1,zxcvf,4055,846,20,15,35,57.1%,35m
2835,1,Twentyfive,4055,623,17,6,23,73.9%,4m
2835,1,Tyve,4055,0,1,0,1,100.0%,9m
2835,1,Prsk,4055,0,0,1,1,0.0%,10m
2844,1,Vert,4054,1605,55,43,98,56.1%,29m
2844,1,Zypher,4054,993,44,33,77,57.1%,36m
2844,1,[Nu]AgentStang,4054,1147,27,30,57,47.4%,34m
2844,1,[SDC12]Viper,4054,192,4,6,10,40.0%,19m
2844,1,[MaGiK]MaGiK,4054,0,0,1,1,0.0%,19m
2849,1,Jaesung,4053,683,22,12,34,64.7%,9m
2849,1,lIlIlIIll,4053,549,22,14,36,61.1%,9m
2849,1,kali,4053,456,10,10,20,50.0%,10m
2849,1,Shaurma,4053,165,6,4,10,60.0%,34m
2853,1,[Cakius]yeskis,4052,900,24,18,42,57.1%,19m
2853,1,Icebear,4052,796,19,18,37,51.4%,10m
2853,1,NNN,4052,456,10,13,23,43.5%,2h
2853,1,MarleyLynx,4052,0,0,1,1,0.0%,8m
2857,1,[ACSS]JimmyShmo,4051,1364,37,34,71,52.1%,8m
2857,1,[iDrunk]Benevolence,4051,48,2,3,5,40.0%,34m
2859,1,[SHle]molecular,4050,1714,66,36,102,64.7%,12m
2859,1,[V3G2]CptSpaulding,4050,902,26,17,43,60.5%,25m
2861,1,Khatsalano,4049,2086,530,520,1050,50.5%,22m
2861,2,FBI,4049,0,0,1,1,0.0%,23m
2861,1,[FMX]Maya,4049,0,0,2,2,0.0%,12m
2864,1,ShadowHunter,4048,2021,155,144,299,51.8%,31m
2864,1,Twentyone,4048,650,22,7,29,75.9%,8m
2864,1,creative,4048,586,21,10,31,67.7%,29m
2864,1,enchantment,4048,92,5,4,9,55.6%,18m
2864,3,RedGears,4048,30,3,3,6,50.0%,37m
2864,1,[57717]TRiZ,4048,0,1,5,6,16.7%,12m
2870,1,iNZoLitO,4047,1869,175,168,343,51.0%,31m
2870,1,[SsaYnS]SabeRLighT,4047,2038,167,133,300,55.7%,22m
2870,2,Karpfen,4047,203,12,0,12,100.0%,19m
2870,1,[xLgNx]ColiNfsTrann,4047,535,11,6,17,64.7%,30m
2870,1,Wittgenstein,4047,378,8,15,23,34.8%,4m
2870,1,Zerg,4047,140,4,4,8,50.0%,38m
2870,1,SkytosPrintr,4047,96,3,3,6,50.0%,38m
2870,1,MeatyOwlLegs,4047,48,2,0,2,100.0%,13m
2870,1,[ArGNA]TempoJezus,4047,89,1,1,2,50.0%,30m
2870,1,chef,4047,0,0,2,2,0.0%,25m
2880,1,[SkAL]NextGen,4046,1224,31,29,60,51.7%,12m
2880,1,llllllllllll,4046,449,19,11,30,63.3%,19m
2880,2,dinnertime,4046,153,3,5,8,37.5%,21m
2880,1,ThirtyNine,4046,0,1,0,1,100.0%,38m
2884,1,[diaman]Vicariouz,4045,2026,80,65,145,55.2%,30m
2884,1,Secretariat,4045,399,14,14,28,50.0%,4m
2884,1,[DhZPro]pupu,4045,562,13,19,32,40.6%,33m
2884,1,Euterpe,4045,397,13,21,34,38.2%,9m
2884,1,fleurLee,4045,420,11,12,23,47.8%,4m
2884,1,WkDx,4045,265,7,3,10,70.0%,9m
2890,1,[xO]Gokhan,4044,1574,51,64,115,44.3%,40m
2890,1,[TGosuB]NOMAD,4044,1248,37,30,67,55.2%,9m
2890,1,Azura,4044,509,19,8,27,70.4%,39m
2890,1,[iMkS]Marduk,4044,644,15,17,32,46.9%,5m
2890,1,IIIIIIIIIIII,4044,644,14,19,33,42.4%,14m
2890,1,Exceed,4044,230,5,2,7,71.4%,26m
2896,1,[13und]bCNtheF,4043,2056,373,345,718,51.9%,18m
2896,1,llllllllllll,4043,1919,212,184,396,53.5%,2h
2896,1,Nemea,4043,1293,51,54,105,48.6%,19m
2896,1,[TGosuB]Bum,4043,188,5,1,6,83.3%,2h
2900,1,MagicTurtle,4042,1520,72,53,125,57.6%,30m
2900,2,Jabalsal,4042,188,6,0,6,100.0%,8m
2900,1,CheeseBiscit,4042,94,3,5,8,37.5%,37m
2900,1,[UAP]TheJedi,4042,0,0,1,1,0.0%,8m
2904,1,[Emb3rs]Kugel,4041,1893,191,184,375,50.9%,17m
2904,1,CTRL,4041,1228,55,27,82,67.1%,4m
2904,1,[SolOGS]Black,4041,63,2,5,7,28.6%,35m
2907,1,CrazyCharlie,4040,992,62,40,102,60.8%,25m
2907,1,[Koshka]QianBing,4040,1350,34,30,64,53.1%,38m
2907,1,LÂÑÐÓñ,4040,282,6,7,13,46.2%,38m
2907,1,PainGamer,4040,0,1,0,1,100.0%,12m
2911,1,tofu,4039,2097,144,135,279,51.6%,17m
2911,1,[MadK]Ðeejay,4039,1683,88,92,180,48.9%,4m
2911,1,[TXOP]Artekario,4039,1263,32,34,66,48.5%,9m
2914,1,Sync,4038,1092,36,40,76,47.4%,24m
2914,1,ChobitS,4038,798,31,38,69,44.9%,35m
2914,1,Duffman,4038,273,7,5,12,58.3%,31m
2914,1,Navi,4038,48,1,9,10,10.0%,12m
2914,1,milkTEA,4038,0,0,1,1,0.0%,30m
2914,1,Dresden,4038,0,0,1,1,0.0%,4m
2914,1,BlackSphinx,4038,0,0,1,1,0.0%,34m
2921,1,Dreamer,4037,1066,33,22,55,60.0%,40m
2921,1,llllllllllll,4037,818,20,15,35,57.1%,9m
2921,1,DubiouS,4037,94,3,0,3,100.0%,4m
2921,1,[αXi]TheKyoJin,4037,0,1,0,1,100.0%,19m
2925,1,MULTISSUE,4036,2084,373,363,736,50.7%,39m
2925,1,ZergOP,4036,2076,129,138,267,48.3%,8m
2925,1,smi,4036,1301,35,30,65,53.8%,26m
2925,1,llllIIIlIlll,4036,550,28,20,48,58.3%,38m
2925,1,llllllllllll,4036,759,25,20,45,55.6%,39m
2925,1,Yeet,4036,498,20,7,27,74.1%,18m
2925,1,[Cryptc]Yuey,4036,564,12,8,20,60.0%,38m
2925,1,[FFEODT]Zoro,4036,248,8,12,20,40.0%,2h
2933,3,[SydTT]wulala,4035,1895,188,214,402,46.8%,30m
2933,1,IIIIIIIIIIII,4035,320,8,5,13,61.5%,37m
2933,1,PinkBunny,4035,0,1,5,6,16.7%,12m
2936,1,BLUEBIRD,4034,1175,39,43,82,47.6%,31m
2936,1,[αX]Pensai,4034,908,22,21,43,51.2%,20m
2936,1,PrexcitedAF,4034,512,19,13,32,59.4%,32m
2936,3,BiGBoy,4034,30,1,2,3,33.3%,4m
2940,1,[C96]LeeMongChuPa,4033,574,18,8,26,69.2%,29m
2940,1,Boyo,4033,94,3,0,3,100.0%,20m
2942,1,darkchocolat,4032,1110,151,144,295,51.2%,32m
2942,1,[FANXY]David,4032,658,18,11,29,62.1%,14m
2942,1,BossToss,4032,239,7,2,9,77.8%,9m
2945,1,[BSSG]LaCucaracha,4031,1611,148,146,294,50.3%,2h
2945,1,[AKHN]Phase,4031,1100,32,29,61,52.5%,17m
2945,1,LevarBurton,4031,189,8,5,13,61.5%,2h
2945,1,SaGa,4031,192,4,14,18,22.2%,8m
2945,2,YellHo,4031,0,1,0,1,100.0%,32m
2945,1,[MassDT]feardragon,4031,0,1,0,1,100.0%,19m
2951,3,[Ris3n]butterfly,4030,1813,96,109,205,46.8%,18m
2951,1,bianzul,4030,957,36,31,67,53.7%,10m
2951,1,[MEELX]Sandstorm,4030,670,20,20,40,50.0%,35m
2951,1,Ryan,4030,326,8,10,18,44.4%,34m
2951,3,Pearcey,4030,0,3,2,5,60.0%,7m
2951,3,FreshMilkTea,4030,30,3,5,8,37.5%,38m
2951,1,David,4030,0,1,0,1,100.0%,35m
2951,1,Dubhghall,4030,48,1,3,4,25.0%,10m
2951,1,marbles,4030,0,0,1,1,0.0%,22m
2951,1,[iDrunk]BarcodeKilla,4030,0,0,2,2,0.0%,32m
2961,1,Mujzen,4029,2095,251,225,476,52.7%,8m
2961,3,[SC2Hn]reddox,4029,649,223,235,458,48.7%,19m
2963,1,[VTClan]Lovebirds,4028,1971,299,280,579,51.6%,37m
2963,1,[MS0E]Deroke,4028,1460,111,116,227,48.9%,4m
2963,1,David,4028,312,22,13,35,62.9%,35m
2963,1,[TeamUR]CatWhale,4028,534,13,12,25,52.0%,20m
2963,1,[AlIin]frugs,4028,48,2,1,3,66.7%,10m
2963,1,JUAN,4028,96,2,2,4,50.0%,37m
2969,1,Anselmo,4027,2114,435,418,853,51.0%,39m
2969,1,Dreamboat,4027,2033,269,262,531,50.7%,22m
2969,1,[SsaYnS]James,4027,1616,126,130,256,49.2%,18m
2969,1,[1E100]whoyou,4027,1632,124,112,236,52.5%,38m
2969,1,[PGoose]PurpleGoose,4027,799,54,30,84,64.3%,9m
2969,1,Bloodymary,4027,326,7,8,15,46.7%,8m
2975,1,Asmita,4026,2103,337,323,660,51.1%,8m
2975,1,fire,4026,1339,193,168,361,53.5%,37m
2975,1,[PDSPG]Bankorok,4026,1512,41,39,80,51.2%,40m
2975,1,Ares,4026,203,9,10,19,47.4%,18m
2975,1,Meikukiari,4026,96,3,0,3,100.0%,10m
2975,1,IIIIIIIIIIII,4026,68,3,0,3,100.0%,39m
2975,1,Mantra,4026,0,1,0,1,100.0%,2h
2982,1,QtoWE,4025,1574,71,48,119,59.7%,26m
2982,1,[Dundy]Cann,4025,1800,58,56,114,50.9%,9m
2982,1,PKHALF,4025,968,36,17,53,67.9%,12m
2982,1,[TØXIC]Blast,4025,230,6,1,7,85.7%,37m
2986,1,Gudas,4024,1223,61,51,112,54.5%,37m
2986,1,[αB]AZAZEL,4024,1152,43,55,98,43.9%,4m
2986,1,MikiMagic,4024,741,21,14,35,60.0%,22m
2986,1,Chirijiraden,4024,328,7,5,12,58.3%,40m
2986,1,[GRU]pstmdrnGAY,4024,0,0,2,2,0.0%,36m
2991,1,Waabbuffet,4023,1755,135,137,272,49.6%,35m
2991,1,[cl0udM]Nagaeiku,4023,1123,40,40,80,50.0%,35m
2991,1,Overside,4023,802,30,13,43,69.8%,19m
2991,1,Apparition,4023,410,9,8,17,52.9%,40m
2991,1,ZylslyZ,4023,313,6,4,10,60.0%,9m
2991,1,TheYeti,4023,0,1,0,1,100.0%,17m
2997,1,Xuan,4022,2100,670,666,1336,50.1%,8m
2997,1,[nieBla]nightmarionn,4022,2057,202,202,404,50.0%,31m
2997,1,VoidTerror,4022,1920,153,114,267,57.3%,36m
2997,1,[TAW]Nightowl,4022,1794,51,54,105,48.6%,18m
2997,1,Protoss,4022,1172,40,31,71,56.3%,22m
2997,1,[ESCEE]Koi,4022,1014,24,31,55,43.6%,31m
3003,1,Timetwister,4021,1126,111,123,234,47.4%,9m
3003,1,Bekoj,4021,1058,27,30,57,47.4%,39m
3003,1,Rodrigo,4021,792,18,25,43,41.9%,24m
3003,1,[STEM]AEgis,4021,0,1,0,1,100.0%,38m
3007,1,pianissimo,4020,661,15,9,24,62.5%,36m
3007,1,[LTK]Faye,4020,582,14,12,26,53.8%,9m
3007,1,IIIIIIIIIIII,4020,470,11,15,26,42.3%,18m
3007,2,[eX]Tricolor,4020,88,1,2,3,33.3%,5m
3011,1,lamilami,4019,1929,62,54,116,53.4%,24m
3011,1,IIIIIIIIIIII,4019,1461,46,36,82,56.1%,27m
3011,1,Stacy,4019,1232,46,38,84,54.8%,20m
3011,1,BlackBetty,4019,659,29,31,60,48.3%,9m
3011,1,LykingsProTV,4019,773,27,22,49,55.1%,9m
3011,1,HateTerrans,4019,46,4,2,6,66.7%,2h
3011,1,SuKMihDiK,4019,188,4,3,7,57.1%,9m
3011,1,[αB]Puzzle,4019,48,2,0,2,100.0%,19m
3011,1,materux,4019,0,2,3,5,40.0%,18m
3020,1,[UoM]PandaKing,4018,2076,135,115,250,54.0%,30m
3020,1,IIIlllIIIlll,4018,252,10,5,15,66.7%,25m
3020,1,Jiaell,4018,232,8,2,10,80.0%,9m
3020,1,OskO,4018,142,3,5,8,37.5%,39m
3024,1,[tr0n]TheZealot,4017,1094,131,135,266,49.2%,4m
3024,1,Cheno,4017,1943,79,71,150,52.7%,20m
3024,1,HiddenDragon,4017,1372,59,30,89,66.3%,29m
3024,1,Adamar,4017,718,55,26,81,67.9%,37m
3024,1,Acquire,4017,96,2,5,7,28.6%,5m
3024,1,zzgodmodezz,4017,0,0,1,1,0.0%,30m
3024,1,nVidiax,4017,0,0,3,3,0.0%,39m
3031,1,AHumanBean,4016,1087,75,42,117,64.1%,22m
3031,1,rem,4016,536,16,9,25,64.0%,30m
3033,1,BadManner,4015,578,14,16,30,46.7%,33m
3033,1,[Lp]Larso,4015,369,11,16,27,40.7%,24m
3033,1,[OIGE]ALEXO,4015,420,9,13,22,40.9%,35m
3033,1,[Str8]PULR,4015,234,5,5,10,50.0%,18m
3033,1,SoLo,4015,0,2,3,5,40.0%,34m
3033,2,Smart,4015,0,1,0,1,100.0%,17m
3033,1,PaulSanity,4015,0,0,1,1,0.0%,9m
3040,1,xiexing,4014,1682,100,40,140,71.4%,4m
3040,1,JustinBridou,4014,1183,46,40,86,53.5%,4m
3040,1,llllllllllll,4014,1201,37,29,66,56.1%,32m
3040,1,[ShoaL]Smile,4014,613,21,21,42,50.0%,12m
3040,3,[V6G]ZephyrBlu,4014,40,15,33,48,31.2%,26m
3040,1,aQua,4014,428,9,25,34,26.5%,8m
3040,1,MasterFred,4014,134,2,6,8,25.0%,35m
3047,1,Cade,4013,1182,30,33,63,47.6%,35m
3047,1,Mingo,4013,465,18,14,32,56.2%,34m
3047,1,gugugu,4013,406,17,10,27,63.0%,35m
3047,1,GETABETTERIQ,4013,683,15,11,26,57.7%,35m
3047,1,Corazon,4013,332,7,10,17,41.2%,39m
3047,1,[Nembot]Nemesis,4013,96,2,7,9,22.2%,9m
3053,1,[CodeB]Alakar,4012,2027,472,478,950,49.7%,34m
3053,3,FallStar,4012,169,9,0,9,100.0%,6m
3053,1,[AkaZki]wormsimon,4012,230,8,7,15,53.3%,31m
3053,1,kimnoir,4012,0,2,3,5,40.0%,31m
3057,1,[QTclub]Dust,4011,640,14,23,37,37.8%,18m
3057,1,BarrackObma,4011,144,5,7,12,41.7%,39m
3057,1,MaruWkdWkdao,4011,140,3,3,6,50.0%,34m
3060,1,Lila,4010,1543,68,43,111,61.3%,31m
3060,1,[BaCo]Lazerus,4010,449,12,13,25,48.0%,36m
3060,1,BLEE,4010,108,3,0,3,100.0%,25m
3060,1,[N2L8]StarteCh,4010,0,0,1,1,0.0%,9m
3064,1,[THYGAP]Foolish,4009,824,19,22,41,46.3%,36m
3064,1,UltraNoob,4009,322,8,8,16,50.0%,32m
3064,1,llllllllllll,4009,186,4,6,10,40.0%,39m
3067,1,[HØST]MeThOd,4008,2072,219,226,445,49.2%,32m
3067,1,Sixteen,4008,612,18,8,26,69.2%,2h
3067,1,tokyo,4008,737,17,12,29,58.6%,37m
3067,1,[BajaB]Ward,4008,192,4,15,19,21.1%,37m
3067,1,[INextI]WildStyle,4008,0,1,0,1,100.0%,31m
3067,1,MacroMozart,4008,0,0,1,1,0.0%,40m
3073,1,AirOrange,4007,2001,210,190,400,52.5%,31m
3073,1,[XpKb]Ramzzez,4007,1698,150,129,279,53.8%,20m
3073,1,[Ari0n]Iceman,4007,1788,64,49,113,56.6%,26m
3073,1,mataperuanos,4007,542,18,11,29,62.1%,18m
3077,1,Jenny,4006,943,68,52,120,56.7%,10m
3077,1,[ProSC]toutoune,4006,1992,59,63,122,48.4%,10m
3077,1,[NT4]Sunshine,4006,413,12,5,17,70.6%,39m
3077,1,KingkOng,4006,181,8,3,11,72.7%,9m
3077,1,KitzelMich,4006,144,7,0,7,100.0%,40m
3077,1,Supah,4006,222,5,14,19,26.3%,35m
3077,1,SourceDirect,4006,46,2,7,9,22.2%,33m
3084,1,Reckøner,4005,346,15,11,26,57.7%,12m
3084,1,BoBiNoU,4005,94,3,1,4,75.0%,4m
3084,1,[Jhoder]VoidSham,4005,0,1,0,1,100.0%,40m
3084,1,Jay,4005,0,1,0,1,100.0%,38m
3088,1,Eli,4004,938,38,45,83,45.8%,31m
3088,1,Goblin,4004,510,22,8,30,73.3%,2h
3088,1,[Aika2]RhombusRhino,4004,512,18,10,28,64.3%,38m
3088,1,monk,4004,638,15,14,29,51.7%,35m
3088,1,[F4GG]Fresco,4004,0,1,0,1,100.0%,13m
3088,1,kaisarkiller,4004,0,0,1,1,0.0%,26m
3094,1,prav,4003,2061,115,115,230,50.0%,32m
3094,1,Saitama,4003,1801,89,69,158,56.3%,12m
3094,1,[N0ne]IIIIIIIIIIII,4003,165,5,6,11,45.5%,12m
3097,1,blink,4002,1863,94,80,174,54.0%,37m
3097,1,[SsaYnS]rock,4002,2045,75,64,139,54.0%,8m
3097,1,Mike,4002,1505,66,60,126,52.4%,34m
3097,1,legend,4002,0,0,1,1,0.0%,36m
3097,1,Tassadar,4002,0,0,1,1,0.0%,27m
3102,1,[PK]Montero,4001,1132,130,114,244,53.3%,9m
3102,1,[clanPD]nanotubes,4001,1678,88,69,157,56.1%,9m
3102,2,Thest,4001,180,7,8,15,46.7%,39m
3102,3,Catalyst,4001,0,0,2,2,0.0%,31m
3106,1,[cl0udM]CowboyDan,4000,1188,30,35,65,46.2%,25m
3106,1,PaaT,4000,490,12,13,25,48.0%,8m
3106,2,[UCLA]QiQi,4000,0,0,1,1,0.0%,13m
3106,1,[ClanZN]EXTERMINADOR,4000,0,0,4,4,0.0%,25m
3110,1,aLtManly,3999,267,17,9,26,65.4%,15m
3110,1,[NA7]Enjoy,3999,281,11,10,21,52.4%,10m
3110,1,pray,3999,48,2,0,2,100.0%,39m
3110,1,PRIMO,3999,0,1,0,1,100.0%,9m
3114,1,Thrael,3998,705,78,53,131,59.5%,38m
3114,1,fograw,3998,1483,50,64,114,43.9%,20m
3114,1,[grity]MrKeatz,3998,1314,34,40,74,45.9%,22m
3114,1,[TGosuB]Naux,3998,0,0,3,3,0.0%,37m
3118,1,pride,3997,2074,248,251,499,49.7%,36m
3118,2,Twentythree,3997,102,3,0,3,100.0%,27m
3118,1,Laszlo,3997,92,2,1,3,66.7%,36m
3118,1,Buff,3997,92,2,4,6,33.3%,17m
3122,1,JasperNoone,3996,1719,125,111,236,53.0%,10m
3122,1,BigHoss,3996,1611,116,99,215,54.0%,38m
3122,1,luziuz,3996,48,2,4,6,33.3%,32m
3125,1,Seifer,3995,1893,263,243,506,52.0%,12m
3125,1,[neuroS]Hoplite,3995,663,146,123,269,54.3%,37m
3125,1,THEBLOB,3995,2058,115,105,220,52.3%,19m
3125,1,[UCI]NaoKyan,3995,899,24,20,44,54.5%,33m
3125,1,AlpHa,3995,0,1,0,1,100.0%,19m
3130,1,TylerOkurbak,3994,331,13,4,17,76.5%,32m
3130,1,[Chich1]Tatoks,3994,253,11,0,11,100.0%,10m
3130,1,lIIlIIlIIllI,3994,94,2,2,4,50.0%,37m
3130,3,Souplieblock,3994,0,1,1,2,50.0%,37m
3130,1,Ninja,3994,0,0,1,1,0.0%,36m
3135,1,Merlin,3993,2062,180,179,359,50.1%,39m
3135,1,[GOPERÚ]Force,3993,1383,88,70,158,55.7%,22m
3135,1,[iGOSU]drkovorkian,3993,1358,37,38,75,49.3%,39m
3135,1,[TAW]DigitZ,3993,512,12,21,33,36.4%,35m
3139,1,[GSHQ]WakeUpDead,3992,344,9,5,14,64.3%,20m
3139,1,Kami,3992,169,6,5,11,54.5%,2h
3139,1,Lemonescence,3992,0,4,1,5,80.0%,25m
3142,1,Gelos,3991,450,10,13,23,43.5%,32m
3142,1,[GOPERÚ]VentriX,3991,173,7,7,14,50.0%,19m
3142,3,XxlDoMxX,3991,0,2,1,3,66.7%,16m
3145,1,[Virtus]Myth,3990,1098,78,67,145,53.8%,35m
3145,2,PickleRick,3990,253,13,4,17,76.5%,36m
3145,2,InfVampyWorm,3990,102,2,3,5,40.0%,39m
3145,1,Sgtbeaudry,3990,0,1,1,2,50.0%,25m
3149,1,SiDeEfFeCtZ,3989,1643,72,74,146,49.3%,10m
3149,1,Somnolent,3989,92,3,1,4,75.0%,32m
3149,1,IlIIIlIlIIII,3989,96,2,11,13,15.4%,12m
3149,1,IMakeMarines,3989,0,0,1,1,0.0%,18m
3153,1,[FwithT]BIGGLESWORTH,3988,2033,166,151,317,52.4%,40m
3153,1,[akuta]Mars,3988,2045,146,142,288,50.7%,2h
3153,1,[Dicboy]Beren,3988,831,60,56,116,51.7%,9m
3153,1,PowerHouse,3988,811,29,15,44,65.9%,26m
3153,3,PuroMacho,3988,118,5,3,8,62.5%,14m
3153,1,[aFtE]Caneras,3988,186,4,7,11,36.4%,38m
3153,1,Jun,3988,0,1,0,1,100.0%,37m
3153,1,WINDYDAY,3988,46,1,2,3,33.3%,35m
3161,1,[KGH]DeltaD,3987,92,2,3,5,40.0%,36m
3162,1,Buildsniper,3986,1683,84,78,162,51.9%,12m
3162,1,[chair]sss,3986,758,58,45,103,56.3%,39m
3162,1,llllllllllll,3986,206,9,0,9,100.0%,5m
3162,1,ThirtyThree,3986,283,9,4,13,69.2%,32m
3162,1,Bango,3986,372,8,15,23,34.8%,20m
3162,1,[hOpp]ChOoA,3986,0,0,1,1,0.0%,20m
3168,1,[cl0udM]DaCooGa,3985,1662,125,111,236,53.0%,29m
3168,1,Azazel,3985,574,17,12,29,58.6%,35m
3168,1,[Ikar0s]Stefan,3985,548,13,15,28,46.4%,31m
3168,1,IIIIIIIIII,3985,236,11,2,13,84.6%,12m
3168,1,[SydTT]DeJaVu,3985,228,6,4,10,60.0%,18m
3168,1,Eulogy,3985,96,2,2,4,50.0%,29m
3174,1,Captain,3984,378,19,9,28,67.9%,20m
3174,1,TuckFrance,3984,506,12,12,24,50.0%,39m
3174,1,[DarkAG]Yoshi,3984,370,9,8,17,52.9%,10m
3174,3,yan,3984,58,3,0,3,100.0%,4m
3174,1,AIURGOLD,3984,0,1,0,1,100.0%,15m
3179,1,[ZZC]Zativiko,3983,712,22,14,36,61.1%,38m
3179,1,aldeon,3983,851,22,24,46,47.8%,36m
3179,1,glacier,3983,932,22,33,55,40.0%,19m
3179,1,llllllllllll,3983,163,5,3,8,62.5%,22m
3183,1,[PSlSTC]Reborn,3982,2077,183,193,376,48.7%,38m
3183,1,[uGG]xEnvy,3982,2089,120,80,200,60.0%,10m
3183,3,IIIIIIIIIIII,3982,1360,70,85,155,45.2%,11m
3183,1,SharkBate,3982,422,10,14,24,41.7%,33m
3183,1,[LAAR]Spawn,3982,234,5,6,11,45.5%,36m
3183,1,yehyi,3982,0,1,0,1,100.0%,36m
3183,1,[KingSC]Luigi,3982,0,1,0,1,100.0%,24m
3183,3,PeakyBlinder,3982,30,1,1,2,50.0%,37m
3183,1,Anpanman,3982,0,0,1,1,0.0%,34m
3192,1,[eznore]Montreal,3981,1588,254,242,496,51.2%,37m
3192,1,[LTlord]GokuLeGana,3981,1968,117,112,229,51.1%,17m
3192,1,ZOveride,3981,1663,50,47,97,51.5%,34m
3192,1,MacroMan,3981,828,20,20,40,50.0%,30m
3192,1,Uuid,3981,696,16,16,32,50.0%,30m
3192,1,[HØST]Kiloliuton,3981,0,3,3,6,50.0%,9m
3198,1,[TSØP]Zebra,3980,2046,654,651,1305,50.1%,22m
3198,3,[ØFoxF2]JJAE,3980,1963,542,544,1086,49.9%,3m
3198,1,Blur,3980,1609,168,155,323,52.0%,39m
3198,3,[DarkAG]PKV,3980,1304,83,96,179,46.4%,19m
3198,1,[kØ]GiFteD,3980,1359,57,56,113,50.4%,33m
3198,1,[GR33D]Nerz,3980,207,12,2,14,85.7%,4m
3198,1,Twentyfour,3980,244,9,2,11,81.8%,26m
3198,1,flawlessZ,3980,139,6,8,14,42.9%,32m
3198,1,BigBamBoo,3980,94,3,4,7,42.9%,10m
3198,1,Rxc,3980,0,0,1,1,0.0%,37m
3198,2,Yillilu,3980,0,0,3,3,0.0%,2h
3209,1,Pingu,3979,1385,166,148,314,52.9%,40m
3209,1,[PhxAge]FatmaN,3979,1081,41,25,66,62.1%,18m
3209,3,llllllllllll,3979,189,10,0,10,100.0%,3m
3209,1,[DKimba]DarkNinja,3979,464,10,13,23,43.5%,39m
3209,2,[KiMBR]Pikeno,3979,42,2,5,7,28.6%,8m
3209,1,llllllllllll,3979,0,1,0,1,100.0%,36m
3209,1,[LUE]ronm,3979,0,1,0,1,100.0%,2h
3216,1,Signal,3978,1481,238,206,444,53.6%,8m
3216,1,ImNotARappa,3978,48,1,5,6,16.7%,40m
3218,1,zativiko,3977,931,27,21,48,56.2%,8m
3218,1,george,3977,953,27,22,49,55.1%,10m
3218,3,LingBling,3977,60,3,1,4,75.0%,16m
3221,1,[cl0udM]Boreal,3976,2087,374,369,743,50.3%,9m
3221,1,SpaceApe,3976,491,21,11,32,65.6%,37m
3221,1,IIIIIIIIIIII,3976,230,5,10,15,33.3%,22m
3221,1,Wenson,3976,0,1,0,1,100.0%,22m
3221,1,ForeverBronz,3976,48,1,2,3,33.3%,22m
3221,1,[InGt]BWOdufusguy,3976,0,0,5,5,0.0%,2h
3227,1,[copain]Automne,3975,1584,144,126,270,53.3%,10m
3227,1,llllllllllll,3975,1728,52,50,102,51.0%,39m
3227,1,MILKshoot,3975,927,36,34,70,51.4%,32m
3227,1,[SWAN]Sheep,3975,740,17,18,35,48.6%,9m
3227,1,[DRKFOX]Apothenes,3975,387,15,8,23,65.2%,18m
3227,1,Macedon,3975,184,5,2,7,71.4%,33m
3227,1,[CHEVIC]Frikisama,3975,170,5,9,14,35.7%,12m
3227,1,IlIlIlIlIlIl,3975,180,4,1,5,80.0%,14m
3227,3,[CrtCrw]CrazyCritter,3975,58,3,2,5,60.0%,2h
3236,1,[PiGPan]Sorathez,3974,2071,199,222,421,47.3%,18m
3236,1,YdOOm,3974,631,25,9,34,73.5%,30m
3236,1,Rideout,3974,494,21,10,31,67.7%,4m
3236,1,IIIIIIIIIIII,3974,256,15,4,19,78.9%,26m
3236,1,[YIKERS]Karleb,3974,278,10,8,18,55.6%,14m
3241,1,ChuckNorris,3973,333,18,3,21,85.7%,24m
3241,1,Twentytwo,3973,92,2,0,2,100.0%,9m
3241,1,[fagz]HybridGnome,3973,0,1,1,2,50.0%,15m
3241,3,[PaPP]TheSpacePope,3973,0,0,1,1,0.0%,4m
3241,1,abreezy,3973,0,0,1,1,0.0%,18m
3241,1,[SABO]Colourizing,3973,0,0,5,5,0.0%,30m
3247,1,Impossibro,3972,1050,95,85,180,52.8%,18m
3247,1,JWA,3972,737,30,18,48,62.5%,40m
3247,1,pumpkin,3972,1160,28,30,58,48.3%,22m
3247,2,BgBootyProbe,3972,351,17,5,22,77.3%,6m
3247,1,ThirtyTwo,3972,380,16,8,24,66.7%,38m
3247,1,IIIIIIIIIIII,3972,326,8,19,27,29.6%,35m
3247,1,[PRTOSS]hotoke,3972,0,1,0,1,100.0%,11m
3247,1,[αX]Nemesis,3972,0,1,4,5,20.0%,12m
3255,1,YogurtBeing,3971,1810,210,198,408,51.5%,2h
3255,1,Mike,3971,1589,81,70,151,53.6%,10m
3255,1,Elfleischo,3971,586,30,12,42,71.4%,27m
3255,1,Eleven,3971,457,22,8,30,73.3%,39m
3255,1,bobshkibob,3971,437,13,12,25,52.0%,35m
3255,1,[NuAiur]Renatus,3971,127,5,8,13,38.5%,35m
3255,1,RosscO,3971,0,1,0,1,100.0%,26m
3262,1,Liouf,3970,786,80,82,162,49.4%,35m
3262,1,xprtN,3970,880,28,15,43,65.1%,14m
3262,3,llllllllllll,3970,0,2,3,5,40.0%,23m
3265,1,Dim,3969,1516,175,118,293,59.7%,30m
3265,1,Twentysix,3969,260,8,2,10,80.0%,31m
3265,1,llllllllllll,3969,0,5,0,5,100.0%,12m
3265,3,Kevin,3969,0,1,5,6,16.7%,20m
3265,3,brownhemp,3969,0,0,1,1,0.0%,23m
3265,1,ekka,3969,0,0,3,3,0.0%,20m
3271,1,llIlIHillIl,3968,1853,86,78,164,52.4%,36m
3271,1,Thisisfun,3968,2011,66,62,128,51.6%,35m
3271,1,NextBrother,3968,357,12,5,17,70.6%,2h
3271,1,IIIIIIIIIIII,3968,94,2,5,7,28.6%,30m
3271,3,[FINDEX]StoicWilly,3968,0,1,0,1,100.0%,27m
3271,1,Tsun,3968,0,0,1,1,0.0%,38m
3277,1,CannonRusher,3967,1580,67,64,131,51.1%,15m
3277,1,[afterM]Albino,3967,753,46,9,55,83.6%,25m
3277,1,[CMU]ropicophop,3967,903,22,34,56,39.3%,32m
3277,2,aPureGenius,3967,350,16,3,19,84.2%,12m
3277,1,[1E100]Cicero,3967,284,15,5,20,75.0%,25m
3277,1,[1vsM]acoolguy,3967,402,10,9,19,52.6%,37m
3277,1,EmoTurtle,3967,203,5,1,6,83.3%,18m
3277,1,[NotEQ]InEquality,3967,0,0,1,1,0.0%,36m
3277,1,[SydTT]MeEpwN,3967,0,0,3,3,0.0%,40m
3286,1,Rose,3966,1175,39,25,64,60.9%,19m
3286,1,FNX,3966,284,6,21,27,22.2%,11m
3286,3,[0rdr66]Democracy,3966,90,4,8,12,33.3%,25m
3286,1,Evolution,3966,0,1,2,3,33.3%,37m
3290,1,lazyfeet,3965,2006,473,463,936,50.5%,26m
3290,1,[ZTemps]OneMoreTime,3965,907,38,35,73,52.1%,30m
3290,1,AMoveCaptain,3965,813,28,20,48,58.3%,26m
3290,1,[PMN]LibYourLife,3965,46,1,2,3,33.3%,34m
3290,1,IIIIIIIIIIII,3965,0,0,1,1,0.0%,36m
3295,1,[KSGT]klaw,3964,1522,78,67,145,53.8%,22m
3295,1,LionKing,3964,1563,65,75,140,46.4%,4m
3295,1,[ØÛ]Aldebaran,3964,1226,37,31,68,54.4%,12m
3295,1,Oblivion,3964,297,8,7,15,53.3%,2h
3295,1,[Lp]JerrodSwag,3964,48,1,1,2,50.0%,15m
3300,1,Megatron,3963,416,10,12,22,45.5%,5m
3300,1,[LCE]Chipana,3963,334,7,16,23,30.4%,32m
3300,1,Lala,3963,274,6,8,14,42.9%,34m
3300,1,ReallyNoob,3963,174,6,9,15,40.0%,14m
3304,1,Zivaero,3962,1762,90,71,161,55.9%,30m
3304,1,Rsterminador,3962,323,29,21,50,58.0%,20m
3304,1,llllllllllll,3962,469,18,8,26,69.2%,29m
3307,1,[DarkAG]WHOSFIRST,3961,2025,186,183,369,50.4%,20m
3307,1,Subarashii,3961,140,3,3,6,50.0%,26m
3307,1,BeeMovie,3961,0,0,1,1,0.0%,36m
3310,1,[NLTN]Defeater,3960,1781,206,197,403,51.1%,33m
3310,1,inLR,3960,440,115,106,221,52.0%,36m
3310,1,[5555]Zoundz,3960,1599,76,66,142,53.5%,9m
3310,1,[Khaoz]Catscratch,3960,821,22,21,43,51.2%,24m
3310,1,[EoMX]artanis,3960,706,21,19,40,52.5%,32m
3310,1,[NPhase]ZergSucks,3960,329,16,3,19,84.2%,10m
3310,1,Nomad,3960,0,1,3,4,25.0%,32m
3310,1,[GEEKED]Laurience,3960,0,0,1,1,0.0%,33m
3318,1,ComBilLi,3959,1682,49,55,104,47.1%,12m
3318,1,Makarot,3959,48,1,2,3,33.3%,36m
3318,1,[Wiggin]GreatArchon,3959,0,0,1,1,0.0%,5m
3321,1,superneat,3958,1679,407,394,801,50.8%,33m
3321,1,Frag,3958,1785,232,221,453,51.2%,22m
3321,1,Neuropozyne,3958,1679,88,87,175,50.3%,2h
3321,3,llllllllllll,3958,279,12,0,12,100.0%,23m
3321,1,[RlSKE]assassinXY,3958,94,2,9,11,18.2%,20m
3321,1,niceguy,3958,0,1,2,3,33.3%,2h
3321,1,CherryPopper,3958,0,1,4,5,20.0%,30m
3328,1,[PiGPan]TimesChange,3957,1706,69,76,145,47.6%,40m
3328,1,[xTQc]AnzoImpact,3957,1974,65,75,140,46.4%,32m
3328,1,puzydestroye,3957,386,17,8,25,68.0%,33m
3328,1,ZOO,3957,0,0,1,1,0.0%,35m
3332,3,[ScSwrm]VaeVictus,3956,1701,323,351,674,47.9%,29m
3332,1,KERIMOVICH,3956,1459,66,63,129,51.2%,34m
3332,1,[CRAKS]Ferreira,3956,1249,63,50,113,55.8%,4m
3332,1,Ninth,3956,402,18,7,25,72.0%,10m
3332,1,shinomiya,3956,200,13,2,15,86.7%,18m
3332,1,[ARLA]FGThjklzEX,3956,0,0,1,1,0.0%,12m
3332,3,[2Pac96]monster,3956,0,0,2,2,0.0%,38m
3332,1,QueenDadDy,3956,0,0,3,3,0.0%,26m
3340,1,Solarc,3955,1415,61,66,127,48.0%,9m
3340,1,Allende,3955,1556,42,44,86,48.8%,9m
3340,1,[GdAT]Nameless,3955,998,31,21,52,59.6%,10m
3340,1,davexor,3955,779,22,21,43,51.2%,9m
3340,1,DeathKnight,3955,318,12,3,15,80.0%,11m
3340,3,[FARMS]claizen,3955,0,0,1,1,0.0%,20m
3346,1,VanDraken,3954,379,20,7,27,74.1%,25m
3346,1,Blitzkrieg,3954,412,20,12,32,62.5%,34m
3346,1,IamDerp,3954,244,15,3,18,83.3%,26m
3346,1,[LGNxx]GHOST,3954,142,4,8,12,33.3%,36m
3346,3,[MEP]Mephisto,3954,60,2,7,9,22.2%,23m
3351,1,RedarmyJedi,3953,1859,190,178,368,51.6%,27m
3351,1,Gcob,3953,1389,66,71,137,48.2%,27m
3351,1,[Cryptc]Terra,3953,630,26,16,42,61.9%,12m
3351,1,[αXLa]ROMSLY,3953,942,24,36,60,40.0%,2h
3351,1,Seventh,3953,453,20,11,31,64.5%,37m
3351,1,Nineteen,3953,146,6,0,6,100.0%,33m
3351,1,[ZTempz]SoggyInferno,3953,0,3,2,5,60.0%,32m
3351,2,GonnaGo,3953,36,3,6,9,33.3%,21m
3351,3,PedoJoeBiden,3953,0,2,3,5,40.0%,29m
3351,1,Estoisismo,3953,0,0,1,1,0.0%,25m
3351,2,IIIIIIIII,3953,0,0,1,1,0.0%,36m
3362,1,Rokodalin,3952,1991,390,365,755,51.7%,39m
3362,1,wackzilla,3952,1720,143,153,296,48.3%,36m
3362,1,twilight,3952,1978,102,117,219,46.6%,20m
3362,1,balzac,3952,867,78,62,140,55.7%,38m
3362,1,MartinOne,3952,475,11,28,39,28.2%,36m
3362,3,Gussygus,3952,168,9,0,9,100.0%,29m
3362,3,thrawn,3952,0,3,2,5,60.0%,17m
3362,1,[LgnTDS]ToZu,3952,90,3,3,6,50.0%,26m
3370,1,FentonMeeks,3951,1247,70,59,129,54.3%,39m
3370,1,marmelloh,3951,491,52,44,96,54.2%,24m
3370,1,Thirty,3951,573,23,19,42,54.8%,30m
3370,1,[BlTEL]GhosteX,3951,0,1,0,1,100.0%,17m
3374,1,DarkWarrior,3950,1815,562,558,1120,50.2%,39m
3374,1,Eighth,3950,210,31,19,50,62.0%,15m
3374,1,Twelve,3950,255,13,1,14,92.9%,20m
3374,1,FrogOfWar,3950,48,2,1,3,66.7%,32m
3374,1,[WuTang]Kappa,3950,96,2,3,5,40.0%,18m
3379,1,Moridin,3949,1227,109,40,149,73.2%,2h
3379,1,Player,3949,608,14,15,29,48.3%,2h
3379,2,[xFear]Khaos,3949,309,10,14,24,41.7%,12m
3379,1,Myelin,3949,129,3,1,4,75.0%,20m
3379,1,[GIANNI]VERSACE,3949,0,2,3,5,40.0%,26m
3379,1,Realstreetg,3949,94,2,4,6,33.3%,40m
3379,1,Ravelans,3949,92,1,1,2,50.0%,9m
3379,1,GVx,3949,0,1,3,4,25.0%,20m
3387,1,TFU,3948,1402,137,127,264,51.9%,38m
3387,1,[cLsSC]BruceLee,3948,2072,131,132,263,49.8%,27m
3387,1,Obnehz,3948,2042,93,80,173,53.8%,2h
3387,1,Newone,3948,1054,48,36,84,57.1%,22m
3387,1,[αX]Kyno,3948,760,17,23,40,42.5%,25m
3387,1,AvonMexicola,3948,396,16,9,25,64.0%,39m
3387,1,Fourteen,3948,280,12,4,16,75.0%,25m
3387,1,[GØSU]zyclon,3948,293,11,20,31,35.5%,36m
3387,1,MilkyWay,3948,196,7,4,11,63.6%,30m
3396,1,[Lp]MiniDaRkneSS,3947,1338,90,61,151,59.6%,33m
3396,1,OrteGa,3947,1074,57,34,91,62.6%,30m
3396,1,EasyAI,3947,671,55,43,98,56.1%,26m
3396,1,Garka,3947,1039,45,33,78,57.7%,30m
3396,1,YooperTown,3947,676,38,36,74,51.4%,20m
3396,1,[INextI]JUKUMARU,3947,668,27,24,51,52.9%,8m
3396,1,[KingSC]NATALI,3947,170,15,13,28,53.6%,20m
3396,1,[ZUCC]JEPH,3947,0,0,1,1,0.0%,37m
3404,1,[YD2K]You,3946,2025,219,155,374,58.6%,14m
3404,1,Azhrei,3946,883,107,63,170,62.9%,35m
3404,1,[NeAs]exeKiAz,3946,959,58,44,102,56.9%,14m
3404,1,Heimskur,3946,872,28,21,49,57.1%,4m
3404,1,Logarithm,3946,1014,25,35,60,41.7%,40m
3404,1,HaBiBiS,3946,343,12,5,17,70.6%,39m
3410,1,Recks,3945,1729,301,274,575,52.3%,40m
3410,1,Militia,3945,1714,258,240,498,51.8%,26m
3410,1,[nieBla]Woltstrider,3945,1289,66,39,105,62.9%,4m
3410,1,[NPhasA]TheHamman,3945,576,23,13,36,63.9%,18m
3410,1,Toto,3945,243,9,4,13,69.2%,24m
3410,1,ArtService,3945,94,3,12,15,20.0%,31m
3416,3,MilkBottoe,3944,1938,162,198,360,45.0%,2h
3416,1,GwaiLo,3944,1094,142,67,209,67.9%,29m
3416,1,[αB]WarbuffII,3944,2012,118,110,228,51.8%,38m
3416,1,thumsing,3944,1355,37,45,82,45.1%,30m
3416,1,HiLoSecond,3944,220,35,26,61,57.4%,38m
3416,1,[TWITS]BigBoy,3944,1135,31,26,57,54.4%,40m
3416,1,ProbeiusCorp,3944,757,26,41,67,38.8%,4m
3416,1,[LgnTDS]Ziege,3944,46,1,6,7,14.3%,24m
3424,1,[RUMB]Relinquish,3943,1059,49,36,85,57.6%,9m
3424,1,[BELDA]Geno,3943,642,28,33,61,45.9%,4m
3424,1,Artifice,3943,1042,25,27,52,48.1%,31m
3424,1,min,3943,362,9,9,18,50.0%,23m
3424,1,[juggr]Bali,3943,109,6,4,10,60.0%,35m
3424,1,[EZDUNK]deribou,3943,138,4,4,8,50.0%,30m
3424,1,[QTp2T]ShadowHunter,3943,48,2,2,4,50.0%,30m
3424,3,[BAKUGO]Katsuki,3943,0,0,6,6,0.0%,15m
3432,1,Progresser,3942,1405,123,91,214,57.5%,30m
3432,1,Azunia,3942,1859,87,61,148,58.8%,2h
3432,1,Fifth,3942,546,26,13,39,66.7%,38m
3432,1,Twenty,3942,524,23,13,36,63.9%,38m
3432,1,[pwrIX]DOOMHURT,3942,438,17,14,31,54.8%,19m
3437,1,THEKING,3941,1372,150,134,284,52.8%,26m
3437,1,Nemesis,3941,1906,86,66,152,56.6%,30m
3437,1,[SNFive]leezzang,3941,1006,30,27,57,52.6%,10m
3437,3,[Tl2ON]TRON,3941,0,1,0,1,100.0%,9m
3437,1,llllllllllll,3941,0,1,0,1,100.0%,10m
3442,1,stardust,3940,496,22,12,34,64.7%,31m
3442,1,CozyBull,3940,240,15,3,18,83.3%,9m
3442,1,[FMST]ccf,3940,243,9,4,13,69.2%,2h
3442,1,Twentyeight,3940,188,7,2,9,77.8%,40m
3442,1,[SFine]Mancilla,3940,112,4,1,5,80.0%,9m
3442,2,[Pinocc]Epitomes,3940,140,4,4,8,50.0%,6m
3442,1,AGTMR,3940,0,0,9,9,0.0%,37m
3449,1,[Astute]Innovatable,3939,1963,176,197,373,47.2%,10m
3449,1,llamasrule,3939,1537,71,42,113,62.8%,31m
3449,1,[αXLa]TuPadrastroG,3939,961,40,30,70,57.1%,23m
3449,1,tomorrow,3939,194,13,2,15,86.7%,38m
3449,1,EchoChamber,3939,130,3,1,4,75.0%,17m
3449,3,Notabarcode,3939,0,2,2,4,50.0%,29m
3449,1,[WNTRGG]Nszeth,3939,0,1,0,1,100.0%,39m
3449,1,[GDJ]DrunkMaster,3939,0,1,0,1,100.0%,4m
3449,1,Banana,3939,93,1,1,2,50.0%,19m
3449,1,[Mc]Guandal,3939,0,0,1,1,0.0%,30m
3449,1,[FrnkZ]TiNspireCX,3939,0,0,1,1,0.0%,37m
3449,1,Probe,3939,0,0,1,1,0.0%,37m
3461,1,[ValidG]Kenshin,3938,1849,206,208,414,49.8%,20m
3461,1,IlllllIIl,3938,1488,135,110,245,55.1%,19m
3461,1,[TSØP]Darkill,3938,1400,39,39,78,50.0%,17m
3461,1,AlmondMilk,3938,523,26,11,37,70.3%,12m
3461,1,[KmDeYb]NineVolt,3938,514,16,8,24,66.7%,39m
3461,1,Thirteen,3938,264,13,2,15,86.7%,33m
3461,1,Brobasaur,3938,180,4,2,6,66.7%,38m
3468,1,[AD3C]NazyBoss,3937,1698,110,94,204,53.9%,2h
3468,1,Scale,3937,1273,41,33,74,55.4%,2h
3468,1,poly,3937,1085,39,24,63,61.9%,35m
3468,3,Apple,3937,168,9,0,9,100.0%,4m
3468,1,MaruTryToss,3937,176,4,9,13,30.8%,20m
3468,1,TeppaH,3937,130,3,13,16,18.8%,37m
3468,3,maniachillo,3937,0,2,3,5,40.0%,22m
3468,1,[UATeam]Yamaga,3937,46,1,6,7,14.3%,35m
3476,1,[BRSKR]SnowEMeadowS,3936,1858,162,176,338,47.9%,9m
3476,1,Kaifat,3936,885,40,27,67,59.7%,18m
3476,1,[Reix]Kipyatych,3936,674,37,16,53,69.8%,18m
3476,1,Bluntbread,3936,980,33,30,63,52.4%,8m
3476,1,[DICBOI]BlackSplendo,3936,877,30,29,59,50.8%,25m
3476,1,Twentyseven,3936,126,4,0,4,100.0%,22m
3476,1,Killstrife,3936,140,4,3,7,57.1%,34m
3476,1,xilocamp,3936,0,1,0,1,100.0%,35m
3476,1,Hades,3936,0,1,1,2,50.0%,20m
3476,1,[TAW]TeRrAnBrOkEn,3936,0,0,1,1,0.0%,33m
3486,1,[JSLs]Caocao,3935,1605,143,116,259,55.2%,9m
3486,1,[VENSC2]SCHOMBERG,3935,2036,104,110,214,48.6%,40m
3486,1,Sunborn,3935,1312,64,40,104,61.5%,19m
3486,1,Neox,3935,1612,56,53,109,51.4%,4m
3486,1,loungedeep,3935,1514,45,52,97,46.4%,33m
3486,1,[EZDUNK]TheEvilOne,3935,500,23,12,35,65.7%,19m
3486,1,Destroyer,3935,334,22,2,24,91.7%,30m
3486,1,[FMX]Esquire,3935,0,1,0,1,100.0%,4m
3486,3,Sylvester,3935,0,0,2,2,0.0%,3m
3486,1,[NPhase]Slardak,3935,0,0,2,2,0.0%,15m
3496,1,Iridescent,3934,1670,171,169,340,50.3%,31m
3496,1,[Maegis]Nova,3934,910,108,79,187,57.8%,31m
3496,1,[LimaSC]vergas,3934,239,20,4,24,83.3%,17m
3496,1,[AKLsc]Morpheus,3934,345,12,9,21,57.1%,36m
3496,1,Piff,3934,247,11,3,14,78.6%,12m
3496,1,[wenoob]Irena,3934,326,10,5,15,66.7%,23m
3496,1,[ConFed]Kira,3934,0,0,1,1,0.0%,8m
3496,1,ThirtyFour,3934,0,0,1,1,0.0%,34m
3504,1,[DhZAc1]SkyDrago,3933,1577,148,132,280,52.9%,12m
3504,1,OHOOUO,3933,299,11,9,20,55.0%,36m
3504,1,Aithic,3933,92,3,13,16,18.8%,20m
3504,1,IIIIIIIIIIII,3933,0,2,3,5,40.0%,38m
3504,2,[Emb3rs]Orgnf,3933,36,1,1,2,50.0%,19m
3504,3,Symphony,3933,0,0,1,1,0.0%,9m
3510,1,Grandeur,3932,1240,73,57,130,56.2%,11m
3510,1,Rachael,3932,916,33,34,67,49.3%,26m
3510,1,damo,3932,496,11,11,22,50.0%,33m
3510,3,Dream,3932,45,2,3,5,40.0%,34m
3510,2,[ValidG]MetriC,3932,0,1,0,1,100.0%,11m
3515,1,Tnerb,3931,1705,51,52,103,49.5%,40m
3515,1,WillHawkins,3931,92,3,5,8,37.5%,24m
3515,2,IIIIIIIIIIII,3931,0,0,7,7,0.0%,36m
3518,1,grimZ,3930,1955,117,102,219,53.4%,39m
3518,1,[Janna]CaNut,3930,1460,80,66,146,54.8%,9m
3518,2,IIIIIIIIIIII,3930,146,5,2,7,71.4%,24m
3518,1,[xRtG]Mukiwaa,3930,144,4,9,13,30.8%,26m
3522,1,[Weac]FreezingRain,3929,1328,33,37,70,47.1%,39m
3522,2,BoiLin,3929,98,4,2,6,66.7%,35m
3522,3,[ANIMOO]Dannie,3929,0,4,2,6,66.7%,14m
3525,1,[UoM]HailStorm,3928,1659,54,43,97,55.7%,40m
3525,1,DarkStar,3928,1476,43,43,86,50.0%,10m
3525,1,[NovaX]TwoMeows,3928,381,17,12,29,58.6%,19m
3525,1,[NovaX]Atomic,3928,332,8,22,30,26.7%,15m
3525,2,SCVLife,3928,0,1,0,1,100.0%,39m
3525,1,EisensBoy,3928,0,1,1,2,50.0%,20m
3525,3,VINDICTIVE,3928,0,1,2,3,33.3%,27m
3532,1,Thirty,3927,1554,174,162,336,51.8%,18m
3532,1,SpEctrUm,3927,1936,146,139,285,51.2%,10m
3532,1,NotinMKSens,3927,351,12,14,26,46.2%,5m
3532,1,Dbeast,3927,0,1,1,2,50.0%,36m
3536,1,TaX,3926,1550,196,191,387,50.6%,18m
3536,1,FortyOne,3926,236,5,12,17,29.4%,34m
3536,2,[xRtG]SpiritOfDice,3926,0,2,3,5,40.0%,6m
3536,1,Fuaaaa,3926,48,2,3,5,40.0%,20m
3540,1,Ranglefanten,3925,1090,54,32,86,62.8%,2h
3540,2,[ZTemps]ZeN,3925,595,30,22,52,57.7%,29m
3540,1,IIIIIIIIIIII,3925,46,2,5,7,28.6%,9m
3540,2,CptTurnip,3925,0,0,1,1,0.0%,17m
3544,1,bunnychild,3924,2020,260,253,513,50.7%,23m
3544,1,[Comedy]benji,3924,1323,150,152,302,49.7%,5m
3544,1,[Lukerk]Ansgar,3924,1782,146,136,282,51.8%,35m
3544,1,ButterCup,3924,760,58,51,109,53.2%,20m
3544,1,Lock,3924,948,38,33,71,53.5%,19m
3544,1,[αB]Hyren,3924,1324,38,43,81,46.9%,36m
3544,1,[LgnTDS]Fact,3924,775,36,32,68,52.9%,36m
3544,1,GedFenir,3924,607,20,12,32,62.5%,18m
3544,2,[P4NDAS]MrCraft,3924,0,0,1,1,0.0%,15m
3544,3,[AdaptG]JoySynthetic,3924,0,0,2,2,0.0%,21m
3554,1,Peace,3923,1620,160,158,318,50.3%,36m
3554,1,[HIPASS]urexxxx,3923,688,35,18,53,66.0%,19m
3554,1,[Maaate]DocJoe,3923,510,24,9,33,72.7%,38m
3554,2,[NGRz]Fasho,3923,460,19,9,28,67.9%,34m
3554,2,Fifteen,3923,438,15,5,20,75.0%,31m
3554,3,Dan,3923,0,1,4,5,20.0%,6m
3560,1,[Digged]ChEDo,3922,1397,62,49,111,55.9%,10m
3560,1,Albalu,3922,0,1,3,4,25.0%,14m
3560,2,Animegamer,3922,0,0,1,1,0.0%,5m
3563,1,dareOfficer,3921,1301,93,71,164,56.7%,33m
3563,1,[UpeV]BlackPhillip,3921,1289,45,37,82,54.9%,25m
3563,2,ConcepT,3921,685,27,14,41,65.9%,13m
3563,1,Somethingfun,3921,354,16,10,26,61.5%,14m
3563,2,IIIIIIIIIIII,3921,40,2,0,2,100.0%,5m
3568,1,[DRKRPT]Luigi,3920,897,124,98,222,55.9%,37m
3568,1,fuquer,3920,1420,68,41,109,62.4%,19m
3568,2,GGS,3920,164,5,3,8,62.5%,6m
3568,1,toast,3920,48,2,2,4,50.0%,30m
3568,2,Darkrai,3920,0,1,0,1,100.0%,39m
3568,2,DurpDurp,3920,0,0,1,1,0.0%,10m
3568,2,[HØST]Moraes,3920,0,0,1,1,0.0%,8m
3575,1,BackFromBan,3919,2031,550,560,1110,49.5%,20m
3575,1,CatBug,3919,531,13,15,28,46.4%,18m
3577,1,Hiddenhat,3918,1789,78,78,156,50.0%,5m
3577,2,MEC,3918,98,4,4,8,50.0%,11m
3577,3,Stats,3918,60,2,2,4,50.0%,8m
3577,2,[TCPs]CowSenpai,3918,0,0,1,1,0.0%,16m
3581,1,JoshGordon,3917,181,4,3,7,57.1%,32m
3581,3,pwlngs,3917,30,2,1,3,66.7%,17m
3581,2,Zalor,3917,68,2,2,4,50.0%,5m
3581,2,[D4EVER]Mike,3917,0,1,0,1,100.0%,8m
3585,1,Aitri,3916,713,124,115,239,51.9%,4m
3585,1,[SsaYnS]Leiden,3916,1219,112,108,220,50.9%,39m
3585,1,llprnc,3916,841,105,82,187,56.1%,37m
3585,1,showIP,3916,576,20,14,34,58.8%,37m
3585,1,HapMacker,3916,185,7,3,10,70.0%,20m
3590,1,[PiGPan]ljfed,3915,647,18,15,33,54.5%,39m
3590,2,[LQV]Exo,3915,464,15,10,25,60.0%,4m
3590,3,Zoe,3915,0,1,0,1,100.0%,4m
3593,1,Cthulhu,3914,1838,150,137,287,52.3%,2h
3593,1,Python,3914,1289,55,44,99,55.6%,19m
3595,2,[SuperZ]RickRanger,3913,1722,106,73,179,59.2%,23m
3595,1,Helix,3913,94,3,4,7,42.9%,34m
3597,1,Elbandido,3912,1954,116,115,231,50.2%,4m
3597,2,liturtle,3912,630,24,11,35,68.6%,31m
3597,1,JYSG,3912,318,10,7,17,58.8%,19m
3597,3,iMolter,3912,166,9,0,9,100.0%,32m
3597,3,poll,3912,97,5,1,6,83.3%,4m
3597,1,[EGTLGL]EvilChicken,3912,153,4,4,8,50.0%,20m
3603,1,lllllll,3911,2003,1017,1033,2050,49.6%,24m
3603,1,Boomer,3911,1994,246,237,483,50.9%,8m
3603,1,[RUMB]UnitedGGK,3911,1669,77,87,164,47.0%,36m
3603,2,[FyHr]ToyecaX,3911,876,39,19,58,67.2%,22m
3603,2,[EGiggs]sOul,3911,312,11,9,20,55.0%,19m
3603,1,llllllllllll,3911,304,10,7,17,58.8%,19m
3603,2,[xGenGx]TreeStump,3911,0,2,3,5,40.0%,39m
3610,3,BlackEagles,3910,0,1,2,3,33.3%,9m
3610,2,[AlIin]Jacoshlu,3910,0,0,1,1,0.0%,33m
3612,1,[SQUADW]TOOLGTTOQYT,3909,1972,162,155,317,51.1%,23m
3612,1,ImBetter,3909,1251,115,115,230,50.0%,2h
3612,3,[NextDC]Dysix,3909,0,0,1,1,0.0%,3m
3615,1,coorslight,3908,1938,241,253,494,48.8%,39m
3615,1,[Lp]NeoShaGgy,3908,1214,43,35,78,55.1%,2h
3615,1,[GEEBS]KeefyBlunts,3908,398,10,11,21,47.6%,23m
3615,2,[Rus32]DeadPool,3908,154,5,7,12,41.7%,20m
3615,2,SharpShooter,3908,0,1,0,1,100.0%,31m
3620,1,Shrimp,3907,818,75,58,133,56.4%,37m
3620,2,lWorstGodl,3907,1029,41,32,73,56.2%,8m
3620,2,Kwamby,3907,704,32,14,46,69.6%,11m
3620,2,BlizzadSucks,3907,142,10,1,11,90.9%,29m
3620,2,[cl0udM]LiquidSun,3907,104,4,2,6,66.7%,22m
3620,2,atetwofruits,3907,38,1,2,3,33.3%,29m
3626,1,[Cryptc]Doomroca,3906,1988,138,136,274,50.4%,14m
3626,2,Mycatsinheat,3906,597,27,12,39,69.2%,6m
3626,1,Diglett,3906,682,27,20,47,57.4%,18m
3626,1,[RoB]Grufzar,3906,510,14,15,29,48.3%,26m
3626,2,xellowgetfuk,3906,212,9,3,12,75.0%,7m
3626,2,MMRdonation,3906,160,5,1,6,83.3%,12m
3626,2,slowpoke,3906,141,4,2,6,66.7%,22m
3626,1,Randomer,3906,0,0,3,3,0.0%,8m
3634,1,xdlgxtrgop,3905,1819,124,102,226,54.9%,40m
3634,1,KelviN,3905,682,26,13,39,66.7%,23m
3634,2,[UCSL]Magnet,3905,262,15,3,18,83.3%,10m
3634,2,Antiquity,3905,0,2,3,5,40.0%,16m
3634,2,HyperProtoss,3905,0,0,1,1,0.0%,4m
3639,1,KilltheVIRUS,3904,262,12,5,17,70.6%,5m
3639,2,nVidiax,3904,133,3,1,4,75.0%,16m
3641,1,[Kutsu]Aioros,3903,1948,195,201,396,49.2%,11m
3641,1,chappy,3903,316,7,10,17,41.2%,31m
3643,1,ALUCARDHELL,3902,1981,588,576,1164,50.5%,9m
3643,1,[EtrOy]NorseGoat,3902,1726,172,168,340,50.6%,5m
3643,2,[LTlord]ZON,3902,130,5,2,7,71.4%,35m
3643,2,[InGt]AtomicFather,3902,0,0,1,1,0.0%,33m
3643,3,[GUCCl]BAAZOOOMINEE,3902,0,0,1,1,0.0%,3m
3643,2,[INextI]HateF,3902,0,0,2,2,0.0%,8m
3649,2,SpamPants,3901,918,38,19,57,66.7%,35m
3649,3,[CLogic]llllllllllll,3901,62,3,4,7,42.9%,6m
3651,2,[BBN]Akamu,3900,1528,64,50,114,56.1%,22m
3651,2,Terran,3900,1004,58,39,97,59.8%,5m
3651,1,Shanx,3900,1191,32,32,64,50.0%,31m
3651,1,Kizamidal,3900,925,24,28,52,46.2%,17m
3651,3,SlayerSBat,3900,214,11,1,12,91.7%,36m
3651,2,[DETER]Substance,3900,38,1,2,3,33.3%,24m
3657,3,MrFister,3899,1522,79,106,185,42.7%,11m
3657,1,Timmybob,3899,687,65,43,108,60.2%,40m
3657,2,phantomking,3899,717,38,23,61,62.3%,31m
3657,3,FadeToBlack,3899,97,6,0,6,100.0%,24m
3657,1,[UCLA]MKSULAYMAAN,3899,200,5,5,10,50.0%,36m
3657,2,FriendlyRat,3899,138,5,5,10,50.0%,26m
3657,1,[FFAA]NewDevil,3899,46,2,3,5,40.0%,38m
3657,2,llllllllllll,3899,0,0,1,1,0.0%,29m
3657,2,Evolution,3899,0,0,2,2,0.0%,36m
3666,1,[ArGNA]BeNeFiT,3898,2041,233,241,474,49.2%,5m
3666,2,[UpeV]TyrJose,3898,1694,216,199,415,52.0%,35m
3666,2,[WiGGz]SoulPosessed,3898,145,4,2,6,66.7%,5m
3666,2,ZenStorm,3898,0,0,2,2,0.0%,29m
3670,1,Garchuu,3897,1538,70,61,131,53.4%,19m
3670,1,[Lp]DaRkneSS,3897,1495,53,54,107,49.5%,36m
3670,2,Light,3897,696,33,9,42,78.6%,27m
3670,1,XVIII,3897,454,18,13,31,58.1%,38m
3670,1,gag,3897,253,10,7,17,58.8%,24m
3675,2,[DSGs]LeoDan,3896,1670,178,175,353,50.4%,26m
3675,2,Dingles,3896,1374,103,84,187,55.1%,2h
3675,1,WadeWilson,3896,278,6,12,18,33.3%,38m
3678,1,Tyluk,3895,1931,192,182,374,51.3%,38m
3678,1,Stellar,3895,1570,170,152,322,52.8%,18m
3678,1,[DaNang]LinhSco,3895,1010,139,96,235,59.1%,5m
3678,1,LYM,3895,1645,88,85,173,50.9%,18m
3678,1,[Dadash]Jaedolph,3895,464,22,20,42,52.4%,9m
3678,2,IIIIIIIIIIII,3895,314,11,9,20,55.0%,20m
3684,1,Deathend,3894,592,52,22,74,70.3%,8m
3684,2,Tenant,3894,1073,50,35,85,58.8%,4m
3684,1,WaffL,3894,676,45,43,88,51.1%,15m
3684,1,robotic,3894,421,13,11,24,54.2%,27m
3684,2,Power,3894,214,11,2,13,84.6%,4m
3684,1,Fantasia,3894,152,5,7,12,41.7%,30m
3690,1,DexKillsDeb,3893,1922,316,305,621,50.9%,12m
3690,2,[No0Bs]Heavy,3893,1686,216,206,422,51.2%,21m
3690,1,[NFT]NflatablThor,3893,1633,72,69,141,51.1%,19m
3690,2,[DarkAG]EEZ,3893,770,28,20,48,58.3%,18m
3690,1,Hallmarks,3893,507,17,16,33,51.5%,5m
3690,2,ZetsuShoren,3893,38,2,0,2,100.0%,30m
3690,2,slugarmy,3893,36,2,1,3,66.7%,8m
3697,1,MahlerG,3892,2000,163,161,324,50.3%,23m
3697,1,Omelette,3892,1324,35,39,74,47.3%,20m
3697,1,HeadEyes,3892,536,23,9,32,71.9%,39m
3697,1,GSix,3892,812,23,32,55,41.8%,24m
3697,2,[Hauk]LightCartman,3892,529,22,11,33,66.7%,40m
3697,2,[Mc]Daxul,3892,174,6,1,7,85.7%,27m
3697,3,Phantoman,3892,30,1,1,2,50.0%,17m
3697,2,SupernOOb,3892,38,1,2,3,33.3%,2m
3697,1,[JTDPRK]kimilsong,3892,0,0,4,4,0.0%,5m
3706,1,Destructo,3891,1927,70,57,127,55.1%,19m
3706,1,Theradorei,3891,1203,34,32,66,51.5%,15m
3706,1,spaceork,3891,495,23,24,47,48.9%,20m
3706,1,[EDFsc2]Darkblade,3891,94,2,3,5,40.0%,30m
3706,2,Fate,3891,0,0,1,1,0.0%,25m
3711,1,Montecarlo,3890,1929,218,231,449,48.6%,15m
3711,1,SpiderShlong,3890,1981,133,131,264,50.4%,29m
3711,1,[Graal]SuperTramp,3890,1122,52,38,90,57.8%,30m
3711,2,[INextI]Mirage,3890,1039,39,39,78,50.0%,28m
3711,2,MisterPotato,3890,836,32,22,54,59.3%,27m
3711,2,cendilio,3890,0,0,1,1,0.0%,8m
3717,1,fireablaze,3889,1576,66,74,140,47.1%,4m
3717,1,sOs,3889,738,18,17,35,51.4%,39m
3717,1,Awake,3889,94,3,3,6,50.0%,2h
3717,2,RareBreed,3889,74,2,2,4,50.0%,19m
3717,2,yenkoc,3889,40,1,1,2,50.0%,24m
3717,2,VElociraptor,3889,36,1,2,3,33.3%,24m
3717,2,[CaveR]BhAviK,3889,0,0,1,1,0.0%,9m
3717,3,Ancient,3889,0,0,3,3,0.0%,33m
3725,1,Dumbledore,3888,1926,73,71,144,50.7%,35m
3725,1,[Cryptc]SageFantasma,3888,1673,47,50,97,48.5%,22m
3725,2,game,3888,156,6,5,11,54.5%,24m
3725,1,[Lp]dahaka,3888,176,4,5,9,44.4%,39m
3729,1,[Epic]Razed,3887,1961,464,461,925,50.2%,12m
3729,1,PincheTaco,3887,2014,278,273,551,50.5%,27m
3729,1,IIIIIIIIIIIG,3887,1030,70,72,142,49.3%,9m
3729,1,ALM,3887,175,6,4,10,60.0%,18m
3729,1,Rejuxst,3887,180,4,10,14,28.6%,38m
3729,2,[MIT]PartyToss,3887,0,1,0,1,100.0%,31m
3735,2,stOrm,3886,518,20,10,30,66.7%,8m
3735,2,Rambo,3886,430,16,10,26,61.5%,31m
3735,3,HesiJimbo,3886,195,8,5,13,61.5%,4m
3735,2,[GTWITM]zeus,3886,168,6,3,9,66.7%,5m
3735,2,RatSmacker,3886,32,2,0,2,100.0%,5m
3740,1,Fokusnik,3885,1799,57,56,113,50.4%,40m
3740,2,Drasher,3885,326,14,3,17,82.4%,16m
3740,2,Gong,3885,218,8,5,13,61.5%,24m
3740,1,[FANXY]Trololololol,3885,178,4,9,13,30.8%,39m
3740,2,PushDaButton,3885,92,3,2,5,60.0%,19m
3740,2,Schwi,3885,0,1,0,1,100.0%,21m
3740,2,[BACK2R]IamNotByun,3885,0,0,1,1,0.0%,26m
3747,1,Nightmare,3884,1579,96,78,174,55.2%,31m
3747,2,dimarks,3884,170,5,4,9,55.6%,6m
3747,2,Jossi,3884,0,4,1,5,80.0%,16m
3747,2,AronBado,3884,42,1,3,4,25.0%,4m
3747,2,Infidel,3884,0,0,1,1,0.0%,16m
3752,1,Simple,3883,1478,73,81,154,47.4%,23m
3752,1,[Amb3rs]MentalMath,3883,635,47,31,78,60.3%,32m
3752,1,Lur,3883,672,31,16,47,66.0%,19m
3752,2,ArdVark,3883,246,9,2,11,81.8%,40m
3756,1,[cl0udM]AniketosMav,3882,1996,418,423,841,49.7%,32m
3756,1,OUSooner,3882,1203,100,85,185,54.1%,40m
3756,1,moonfish,3882,687,52,48,100,52.0%,8m
3756,1,Noctis,3882,924,50,52,102,49.0%,11m
3756,2,[QTclub]niknovichkov,3882,298,11,5,16,68.8%,17m
3756,2,Saurix,3882,32,3,4,7,42.9%,11m
3762,2,[dioses]Hiunkel,3881,854,29,28,57,50.9%,31m
3762,1,GrumpyKitten,3881,452,13,12,25,52.0%,37m
3762,1,[TheDOH]loeblix,3881,192,11,2,13,84.6%,30m
3762,2,Cerulean,3881,36,2,0,2,100.0%,28m
3762,1,[SsaYnS]Tachypsychia,3881,0,1,5,6,16.7%,38m
3767,3,[UpeV]cratoss,3880,1826,182,207,389,46.8%,11m
3767,2,LosFleischos,3880,1290,62,47,109,56.9%,26m
3767,2,llllllllllll,3880,344,13,9,22,59.1%,24m
3767,1,BlessMyOPX,3880,224,13,10,23,56.5%,5m
3767,1,ApplePencil,3880,155,11,2,13,84.6%,18m
3767,2,Irv,3880,104,3,5,8,37.5%,32m
3767,1,BlackRoofGC,3880,46,1,7,8,12.5%,19m
3774,1,[CUNYC]Animostas,3879,1709,230,235,465,49.5%,5m
3774,1,DaWhiteMan,3879,1449,112,126,238,47.1%,39m
3774,2,malloc,3879,1347,49,52,101,48.5%,22m
3774,1,[GrnBrd]wiscoHC,3879,1216,48,42,90,53.3%,20m
3774,2,zmd,3879,163,18,14,32,56.2%,33m
3774,1,darksoul,3879,94,2,8,10,20.0%,20m
3780,1,TGNPS,3878,1868,90,89,179,50.3%,14m
3780,1,[2FNC]Haste,3878,1190,53,51,104,51.0%,39m
3780,2,[cLsSC]Solaries,3878,466,21,12,33,63.6%,10m
3780,2,[CYC]Snail,3878,189,12,3,15,80.0%,17m
3780,2,LifeIsPain,3878,88,8,0,8,100.0%,28m
3780,2,[pimbab]piercashuang,3878,70,2,1,3,66.7%,35m
3780,2,KaYaK,3878,0,1,0,1,100.0%,2h
3780,2,TheBabyPixel,3878,0,1,0,1,100.0%,30m
3780,2,[VFam2]TheSword,3878,0,0,1,1,0.0%,23m
3780,2,Clayster,3878,0,0,2,2,0.0%,27m
3780,2,[ShoaL]BlueCoach,3878,0,0,2,2,0.0%,23m
3780,1,AhmaudAvery,3878,0,0,6,6,0.0%,8m
3792,1,XYFans,3877,672,23,18,41,56.1%,34m
3792,2,Beruka,3877,190,9,9,18,50.0%,18m
3792,2,juLz,3877,222,6,7,13,46.2%,29m
3792,2,sleepy,3877,36,2,2,4,50.0%,22m
3792,1,fotbalexpert,3877,134,2,4,6,33.3%,25m
3797,1,DonaldTrump,3876,1994,164,177,341,48.1%,36m
3797,1,[Altf5]RORY,3876,940,118,129,247,47.8%,20m
3797,1,speedghOst,3876,832,102,94,196,52.0%,39m
3797,2,ForceMajeure,3876,648,42,27,69,60.9%,36m
3797,2,AMERICA,3876,568,28,7,35,80.0%,39m
3797,2,Caritas,3876,694,25,26,51,49.0%,26m
3803,1,[Shang]Justice,3875,1739,242,213,455,53.2%,11m
3803,1,[425]herO,3875,623,13,15,28,46.4%,26m
3803,2,[Slum]Nendan,3875,72,2,1,3,66.7%,24m
3806,1,[mocat]TBONE,3874,1013,125,126,251,49.8%,33m
3806,2,[iGOSU]PashkaRU,3874,1324,62,51,113,54.9%,8m
3806,2,Khucumber,3874,68,2,5,7,28.6%,11m
3809,1,Taka,3873,178,8,15,23,34.8%,9m
3809,2,Nexus,3873,0,0,1,1,0.0%,34m
3811,2,pipn,3872,1646,84,74,158,53.2%,11m
3811,1,[TSØP]Myxomatosis,3872,992,38,34,72,52.8%,36m
3811,2,MrSockYoHoe,3872,940,35,30,65,53.8%,23m
3811,1,gamer,3872,927,27,23,50,54.0%,17m
3811,1,Schism,3872,568,17,16,33,51.5%,39m
3811,1,[B055]ShadowVoid,3872,369,15,7,22,68.2%,19m
3811,1,[TAdR]EstLZyC,3872,319,12,18,30,40.0%,27m
3811,3,Torlock,3872,266,10,4,14,71.4%,28m
3811,2,SquatUIdiot,3872,0,0,1,1,0.0%,35m
3820,1,PORGI,3871,1959,142,143,285,49.8%,20m
3820,1,[TeamLT]Admiral,3871,1882,69,68,137,50.4%,4m
3820,1,[13und]Pwnyo,3871,657,23,16,39,59.0%,39m
3820,2,Pepper,3871,574,20,15,35,57.1%,24m
3820,1,[TSØP]MacroAKNI,3871,504,16,13,29,55.2%,30m
3820,1,NoooB,3871,332,15,8,23,65.2%,36m
3820,2,[CRAKS]schnaider,3871,380,13,11,24,54.2%,25m
3820,2,[Meguru]Ciallo,3871,132,5,3,8,62.5%,8m
3820,2,SkiHuZzZzz,3871,118,4,4,8,50.0%,24m
3820,2,spike,3871,70,3,3,6,50.0%,11m
3820,3,Stim,3871,0,1,3,4,25.0%,15m
3820,2,Third,3871,0,0,3,3,0.0%,34m
3832,1,[PSISTM]poizon,3870,1923,203,209,412,49.3%,32m
3832,3,[NZER0]OBLIVION,3870,1073,69,94,163,42.3%,12m
3832,1,[KEYSTN]BRRRRAAARRRR,3870,1463,49,51,100,49.0%,11m
3832,1,[xTQc]MatS,3870,1110,44,55,99,44.4%,32m
3832,1,IIIIIIIIIIII,3870,571,21,13,34,61.8%,9m
3832,2,rickybobby,3870,0,1,0,1,100.0%,34m
3832,2,[EoT]Lorekt,3870,0,0,1,1,0.0%,14m
3839,2,[QoG]Lexington,3869,1207,128,99,227,56.4%,18m
3839,1,Ironface,3869,1416,61,58,119,51.3%,31m
3839,2,[sblxs]Jigsaw,3869,1236,50,40,90,55.6%,34m
3839,2,Darknight,3869,732,27,21,48,56.2%,5m
3839,1,Zargg,3869,410,9,23,32,28.1%,30m
3844,1,Fusion,3868,1969,160,161,321,49.8%,40m
3844,2,[Pig2]Kawaiiprobe,3868,1520,129,121,250,51.6%,26m
3844,3,IIIIIIllllII,3868,738,47,82,129,36.4%,13m
3844,1,IIIIIIIIIIII,3868,696,28,19,47,59.6%,29m
3844,1,[Th3Bad]DeepBlue,3868,586,25,15,40,62.5%,19m
3844,1,[SYB4L]Krymming,3868,545,25,28,53,47.2%,31m
3844,1,Equinox,3868,48,1,6,7,14.3%,38m
3851,1,[DarkAG]BreaKer,3867,1586,53,52,105,50.5%,9m
3851,1,[AciNoN]llllllllllll,3867,419,21,10,31,67.7%,8m
3851,3,Byun,3867,214,6,1,7,85.7%,28m
3851,2,Heisenberg,3867,174,5,6,11,45.5%,6m
3851,2,Bjl,3867,38,2,0,2,100.0%,18m
3851,2,tubUrOnZin,3867,36,1,4,5,20.0%,26m
3851,3,[MSFT]ZergGirl,3867,0,0,1,1,0.0%,11m
3851,2,noob,3867,0,0,2,2,0.0%,5m
3851,1,BERRISWEET,3867,0,0,5,5,0.0%,17m
3860,1,[TSØP]RoBoT,3866,1161,76,70,146,52.1%,10m
3860,1,Valhalla,3866,1284,68,54,122,55.7%,34m
3860,2,[WLC]Tim,3866,265,11,6,17,64.7%,32m
3860,2,TheFTS,3866,66,3,2,5,60.0%,24m
3860,2,Bonemaw,3866,0,0,2,2,0.0%,8m
3865,3,DataRacer,3865,1849,193,171,364,53.0%,29m
3865,2,Dirtyjoe,3865,136,5,5,10,50.0%,7m
3865,2,Korbo,3865,34,1,5,6,16.7%,8m
3865,3,ElManotas,3865,0,0,3,3,0.0%,24m
3869,1,Memory,3864,1876,249,268,517,48.2%,8m
3869,1,[KAG420]IEATBOOOTY,3864,1214,51,38,89,57.3%,30m
3869,1,LisiTA,3864,948,36,38,74,48.6%,20m
3869,2,[Impact]SushiSamurai,3864,628,22,19,41,53.7%,19m
3869,2,llllllllllll,3864,226,7,4,11,63.6%,27m
3869,3,toll,3864,0,4,1,5,80.0%,24m
3869,3,[IBIMS]BoBaq,3864,0,4,1,5,80.0%,16m
3869,2,[Eunha]XenefeneX,3864,32,2,0,2,100.0%,36m
3869,2,lllllllllll,3864,34,2,0,2,100.0%,2m
3869,2,Paru,3864,36,1,1,2,50.0%,25m
3869,2,SETO,3864,0,0,1,1,0.0%,4m
3880,1,StarteCh,3863,529,26,28,54,48.1%,2h
3880,2,Aphelion,3863,406,14,11,25,56.0%,29m
3880,1,SerBronn,3863,318,7,14,21,33.3%,24m
3880,2,Ranga,3863,0,4,1,5,80.0%,31m
3884,1,Daenerys,3862,2018,74,89,163,45.4%,17m
3884,1,MadBadSad,3862,1260,35,34,69,50.7%,39m
3884,2,MayDown,3862,395,18,7,25,72.0%,24m
3884,1,Jeremy,3862,92,2,5,7,28.6%,39m
3884,3,[PCAKE]NOFLAMYBLADE,3862,0,1,1,2,50.0%,33m
3884,2,[PTHero]FireBird,3862,0,0,1,1,0.0%,21m
3884,3,JackLo,3862,0,0,6,6,0.0%,31m
3891,1,phissure,3861,1446,211,215,426,49.5%,20m
3891,1,lilbgrevol,3861,1648,110,101,211,52.1%,12m
3891,2,Alpha,3861,1186,46,38,84,54.8%,11m
3891,2,[TeamUR]Stifle,3861,76,3,4,7,42.9%,29m
3891,1,Marmelade,3861,0,1,3,4,25.0%,22m
3891,1,Cosine,3861,44,1,7,8,12.5%,38m
3891,2,Deoxite,3861,0,0,1,1,0.0%,28m
3898,1,Revmiren,3860,1713,189,119,308,61.4%,39m
3898,1,ShoeLugs,3860,1602,139,138,277,50.2%,39m
3898,1,ThorBlob,3860,1977,95,95,190,50.0%,35m
3898,2,BboySmilez,3860,427,60,60,120,50.0%,28m
3898,1,Karolyn,3860,714,18,27,45,40.0%,20m
3898,2,DigBik,3860,329,13,10,23,56.5%,5m
3898,1,Ascendead,3860,322,8,18,26,30.8%,36m
3898,2,[GRNSKN]monkaSniper,3860,100,3,7,10,30.0%,2h
3898,2,[KiMBR]Fodão,3860,0,0,1,1,0.0%,20m
3907,1,[T3T]reflection,3859,1948,198,244,442,44.8%,33m
3907,1,smilingblade,3859,1811,61,53,114,53.5%,14m
3907,2,[Skier]Jibbin,3859,776,31,18,49,63.3%,17m
3907,1,Etc,3859,348,8,12,20,40.0%,4m
3907,2,[KRNGR]ConVex,3859,34,2,3,5,40.0%,26m
3907,2,Devil,3859,0,1,0,1,100.0%,22m
3913,2,[BMBMBM]KFCZinger,3858,1588,69,50,119,58.0%,4m
3913,2,CuckoldBBC,3858,476,21,11,32,65.6%,28m
3913,2,Aristides,3858,114,4,3,7,57.1%,4m
3913,2,AinsOoalGown,3858,38,2,0,2,100.0%,4m
3917,2,Yeasayer,3857,1249,65,58,123,52.8%,32m
3917,2,[UpeV]daggermuth,3857,882,32,30,62,51.6%,32m
3917,2,[yoTN]Pipiolo,3857,403,18,7,25,72.0%,27m
3917,2,Encephalitic,3857,292,10,7,17,58.8%,37m
3917,2,Rolly,3857,330,10,14,24,41.7%,39m
3917,3,positiveduck,3857,168,9,0,9,100.0%,22m
3917,2,Deeeeeeeeerp,3857,160,9,0,9,100.0%,23m
3917,2,feisto,3857,76,3,4,7,42.9%,37m
3917,3,[HankH]DangitBobby,3857,30,1,6,7,14.3%,9m
3926,2,glaxor,3856,1144,49,41,90,54.4%,24m
3926,2,Alessfenix,3856,420,17,13,30,56.7%,28m
3926,2,[Cakius]Yëskis,3856,320,11,5,16,68.8%,2h
3926,2,Sleepy,3856,214,7,3,10,70.0%,26m
3926,2,[ConFed]Leshrac,3856,126,4,7,11,36.4%,15m
3926,2,David,3856,88,1,1,2,50.0%,6m
3926,2,[PSlSTC]MyLifeFrAiur,3856,0,1,2,3,33.3%,23m
3926,1,[TIBU]MrChicken,3856,46,1,6,7,14.3%,22m
3934,1,[BQB]Bufalusking,3855,1885,333,343,676,49.3%,4m
3934,2,GLaDOS,3855,1205,53,29,82,64.6%,10m
3934,1,Yoko,3855,716,18,21,39,46.2%,12m
3934,2,Computer,3855,280,11,0,11,100.0%,4m
3934,2,BAZAAAAAH,3855,0,1,0,1,100.0%,34m
3939,1,[xLgNx]SilentGhostt,3854,1598,154,147,301,51.2%,10m
3939,2,penguino,3854,924,76,71,147,51.7%,8m
3939,2,urixop,3854,783,34,24,58,58.6%,11m
3939,2,[INRI]Darvan,3854,708,30,19,49,61.2%,40m
3939,2,Ryugen,3854,658,25,21,46,54.3%,27m
3939,3,[SsaYnS]xxxxxxxxxxxx,3854,68,19,31,50,38.0%,12m
3939,3,llllllllllll,3854,144,8,0,8,100.0%,5m
3939,3,Goo,3854,30,2,1,3,66.7%,15m
3939,2,[lNI]pzyc,3854,68,2,6,8,25.0%,28m
3939,2,SluttyMagoo,3854,0,1,0,1,100.0%,40m
3949,1,[Th3Bad]VerdinShow,3853,1948,261,240,501,52.1%,26m
3949,1,HandOfMidas,3853,1646,147,118,265,55.5%,14m
3949,2,BrutonGaster,3853,686,32,12,44,72.7%,36m
3949,1,Solace,3853,65,4,8,12,33.3%,24m
3949,2,[GOPERÚ]GhostShadow,3853,36,1,2,3,33.3%,8m
3949,2,PSI,3853,0,0,4,4,0.0%,4m
3955,1,Broccoli,3852,1725,126,97,223,56.5%,38m
3955,2,[425]Buymyrice,3852,711,59,54,113,52.2%,29m
3955,2,Serenity,3852,238,7,9,16,43.8%,30m
3955,2,DarKnoob,3852,40,2,1,3,66.7%,40m
3955,2,silverhawk,3852,34,2,2,4,50.0%,10m
3960,2,gongbanger,3851,1660,222,215,437,50.8%,26m
3960,2,[ValidG]Indroves,3851,1582,143,130,273,52.4%,40m
3960,2,foxdoc,3851,714,43,22,65,66.2%,8m
3960,2,[LilHo]tehdoctor,3851,858,33,25,58,56.9%,29m
3960,2,IIIIIIIIIIII,3851,664,26,18,44,59.1%,11m
3960,2,Slylandro,3851,512,20,10,30,66.7%,15m
3960,2,[TMSG]Mooch,3851,0,0,1,1,0.0%,37m
3967,2,ThePolice,3850,1667,367,327,694,52.9%,39m
3967,1,Apkuhi,3850,1787,192,185,377,50.9%,30m
3967,2,OctoberTide,3850,1061,150,141,291,51.5%,29m
3967,2,Lollipop,3850,932,37,32,69,53.6%,17m
3967,1,[FL4G]Ceggindeggar,3850,1426,36,48,84,42.9%,30m
3967,2,llllllllllll,3850,272,9,3,12,75.0%,28m
3967,1,[ShoaL]Clementine,3850,204,5,7,12,41.7%,29m
3967,1,Dragonbait,3850,226,5,10,15,33.3%,31m
3975,2,chucknorris,3849,478,80,71,151,53.0%,34m
3975,1,Angel,3849,1197,36,37,73,49.3%,11m
3975,2,[GGinc]DevilPanda,3849,514,34,23,57,59.6%,36m
3975,2,gangstagoose,3849,400,14,11,25,56.0%,24m
3975,1,mattfus,3849,382,12,10,22,54.5%,38m
3975,2,[kØ]ShiNiGaMi,3849,0,0,3,3,0.0%,5m
3981,2,Pink,3848,204,7,5,12,58.3%,8m
3981,2,GeneralRL,3848,68,3,1,4,75.0%,7m
3981,2,[PerúPe]AlegriA,3848,40,2,2,4,50.0%,17m
3981,3,[WPFL]UwUTheHorde,3848,0,0,1,1,0.0%,33m
3985,1,Kakashi,3847,1909,145,129,274,52.9%,35m
3985,2,HasuObs,3847,1284,55,40,95,57.9%,28m
3985,2,[UpeV]ComeGalletas,3847,654,52,48,100,52.0%,21m
3985,2,Noble,3847,734,28,20,48,58.3%,30m
3985,2,[CAMOTE]Diegolml,3847,516,23,26,49,46.9%,20m
3985,2,Popcorn,3847,530,17,16,33,51.5%,4m
3985,2,Teo,3847,204,11,2,13,84.6%,31m
3985,1,stOic,3847,268,7,12,19,36.8%,31m
3985,2,[SydTT]CNmarineking,3847,130,5,0,5,100.0%,5m
3994,1,[eX]BACANABOY,3846,1984,281,283,564,49.8%,39m
3994,1,GuilleCorpse,3846,1772,241,251,492,49.0%,20m
3994,1,MonKey,3846,1976,159,153,312,51.0%,19m
3994,2,LittleTiger,3846,814,46,12,58,79.3%,5m
3994,1,Dresden,3846,478,22,25,47,46.8%,32m
3994,2,BlkLiesMatta,3846,319,15,9,24,62.5%,21m
3994,2,KurtBlock,3846,100,3,5,8,37.5%,14m
3994,2,[GUCCl]BOOOOOOOOOoM,3846,0,1,4,5,20.0%,8m
4002,1,[13ewbs]keyz,3845,1874,321,310,631,50.9%,2h
4002,1,[TESLAS]Crafty,3845,1619,79,63,142,55.6%,35m
4002,2,[SCaro]Mckenize,3845,285,12,4,16,75.0%,19m
4002,1,[Lyza]surpassWORLD,3845,509,12,15,27,44.4%,36m
4002,2,[aE]zedain,3845,224,7,9,16,43.8%,8m
4002,2,Atoms,3845,92,4,0,4,100.0%,36m
4008,1,[Fatty]HateLoad,3844,1746,275,269,544,50.6%,39m
4008,1,[LQV]Vexon,3844,1599,122,114,236,51.7%,31m
4008,2,[GGK]Pillowpants,3844,924,67,50,117,57.3%,35m
4008,1,[Lp]FIERAX,3844,554,30,26,56,53.6%,21m
4008,2,wat,3844,136,8,0,8,100.0%,11m
4008,2,[WuTang]Thunderstorm,3844,134,4,6,10,40.0%,21m
4008,3,Cxteam,3844,149,3,3,6,50.0%,9m
4008,2,Crono,3844,92,3,4,7,42.9%,26m
4008,2,RuluCookie,3844,0,0,1,1,0.0%,17m
4017,1,ElDonCa,3843,1929,308,323,631,48.8%,38m
4017,2,ByuN,3843,470,18,11,29,62.1%,18m
4017,2,[X17]antahoNy,3843,32,4,3,7,57.1%,15m
4017,2,[PTHero]Vales,3843,0,2,3,5,40.0%,15m
4017,2,DaviCmpBln,3843,64,2,6,8,25.0%,13m
4017,2,[VCF]Extinction,3843,0,0,5,5,0.0%,11m
4023,1,Jeremy,3842,1930,274,272,546,50.2%,26m
4023,2,[papapa]SmiLence,3842,1653,118,86,204,57.8%,36m
4023,2,Anthony,3842,73,1,7,8,12.5%,29m
4026,1,[JAYJAY]CrazyPoo,3841,1948,119,119,238,50.0%,18m
4026,2,Trayver,3841,876,58,43,101,57.4%,35m
4026,1,Dreamatose,3841,1477,40,43,83,48.2%,9m
4026,1,[uWu69]CollinCobra,3841,422,19,10,29,65.5%,30m
4026,2,jinso,3841,0,1,2,3,33.3%,6m
4031,1,IIIIIIIIIIII,3840,1662,49,53,102,48.0%,15m
4031,2,Relinquish,3840,100,3,6,9,33.3%,19m
4031,2,[420]CuteAznGirl,3840,106,3,6,9,33.3%,35m
4031,2,Kanpo,3840,62,2,1,3,66.7%,7m
4035,2,JINOOINYC,3839,1665,197,152,349,56.4%,39m
4035,1,[DhZAc1]Uranus,3839,1170,50,42,92,54.3%,12m
4035,1,GgMaChine,3839,149,3,5,8,37.5%,12m
4035,2,[KingSC]LSPisBack,3839,0,0,1,1,0.0%,8m
4039,1,[FReNs]LEGENDARY,3838,1940,217,214,431,50.3%,29m
4039,2,Cachorropato,3838,898,129,110,239,54.0%,35m
4039,1,orcrine,3838,1790,124,133,257,48.2%,20m
4039,1,IIIIIIIIIIII,3838,450,19,23,42,45.2%,36m
4039,2,BiPolarBear,3838,170,6,6,12,50.0%,25m
4039,2,[CKMON]Frost,3838,0,0,2,2,0.0%,30m
4045,1,Anomaly,3837,1930,208,206,414,50.2%,14m
4045,2,[ByuJi]NanBong,3837,704,55,38,93,59.1%,17m
4045,2,Nah,3837,264,10,4,14,71.4%,6m
4048,3,[Alphaa]DBOSS,3836,1811,359,354,713,50.4%,39m
4048,1,[SmokeH]Jdogg,3836,272,6,14,20,30.0%,11m
4048,2,[JaMiT]pooopJib,3836,92,4,1,5,80.0%,30m
4048,3,Aethereal,3836,30,2,0,2,100.0%,31m
4048,3,player,3836,30,1,2,3,33.3%,15m
4048,2,Lemiliionn,3836,0,1,2,3,33.3%,34m
4048,2,Vezza,3836,0,0,2,2,0.0%,32m
4055,2,Duan,3835,1570,122,117,239,51.0%,24m
4055,2,[HWN]babybird,3835,62,2,3,5,40.0%,32m
4055,2,teppei,3835,76,2,4,6,33.3%,32m
4058,2,kakaru,3834,867,47,8,55,85.5%,4m
4058,1,JTTizzle,3834,537,15,16,31,48.4%,31m
4058,2,[TIMBA]MaRaUdEr,3834,305,13,9,22,59.1%,36m
4058,2,BOK,3834,334,11,13,24,45.8%,8m
4058,2,Omega,3834,0,0,1,1,0.0%,36m
4063,1,heren,3833,1796,303,307,610,49.7%,4m
4063,2,[ØØ]NerfHerder,3833,1073,67,52,119,56.3%,22m
4063,2,Photon,3833,1395,57,49,106,53.8%,34m
4063,2,Pepper,3833,572,25,12,37,67.6%,21m
4063,2,[2faded]Roger,3833,519,22,16,38,57.9%,40m
4063,2,Unkempt,3833,192,6,7,13,46.2%,29m
4063,2,JamesWade,3833,0,1,0,1,100.0%,8m
4063,2,SgtFufu,3833,0,0,1,1,0.0%,15m
4063,2,Imp,3833,0,0,1,1,0.0%,11m
4072,1,[adY]awS,3832,656,28,34,62,45.2%,32m
4072,1,DangaZone,3832,452,11,16,27,40.7%,22m
4072,2,NoMicroWin,3832,240,8,10,18,44.4%,3m
4072,2,CheekClapper,3832,196,6,4,10,60.0%,6m
4072,2,BilboZeRabit,3832,0,0,2,2,0.0%,8m
4072,3,[I3mF]BeardedOne,3832,0,0,6,6,0.0%,22m
4078,1,[UpeV]chivugt,3831,1978,528,575,1103,47.9%,2h
4078,1,[PTHero]SivPax,3831,1954,290,295,585,49.6%,20m
4078,1,LiquidSnake,3831,1934,93,79,172,54.1%,27m
4078,1,[BGOK]Chickenman,3831,601,16,18,34,47.1%,30m
4078,2,GoA,3831,0,1,0,1,100.0%,7m
4078,2,Volundr,3831,0,1,0,1,100.0%,17m
4078,2,[RAMPER]Emliho,3831,0,1,0,1,100.0%,16m
4085,2,Wrecker,3830,1659,159,152,311,51.1%,39m
4085,1,[HØST]NoOne,3830,454,12,15,27,44.4%,9m
4085,2,FreshJuice,3830,88,4,1,5,80.0%,11m
4088,2,thedude,3829,1598,68,55,123,55.3%,40m
4088,1,[GdAT]Zod,3829,670,31,22,53,58.5%,19m
4088,1,[UoM]Tortle,3829,843,24,22,46,52.2%,23m
4088,2,OsmiumEyes,3829,374,12,12,24,50.0%,28m
4088,2,[ZiYou]LonelyShadow,3829,88,2,0,2,100.0%,5m
4088,2,Veerust,3829,0,1,0,1,100.0%,17m
4088,2,ZvZzzzz,3829,0,1,0,1,100.0%,23m
4088,2,Reolist,3829,0,0,2,2,0.0%,28m
4096,2,[HØST]RuiterD,3828,1082,66,61,127,52.0%,26m
4096,2,Anaya,3828,128,4,1,5,80.0%,28m
4096,2,ForCadia,3828,34,1,2,3,33.3%,31m
4096,2,Gravatik,3828,36,1,3,4,25.0%,24m
4100,2,Entro,3827,1090,105,97,202,52.0%,26m
4100,2,[JSLs]AirKing,3827,720,28,20,48,58.3%,7m
4100,2,[AciNoN]TwilightZeRR,3827,526,22,13,35,62.9%,5m
4100,2,[AoBC]shiki,3827,414,15,11,26,57.7%,11m
4100,2,støic,3827,164,9,1,10,90.0%,11m
4100,1,qweqweqw,3827,0,3,2,5,60.0%,39m
4106,2,silicon,3826,532,28,16,44,63.6%,21m
4106,1,Melbourne,3826,134,4,9,13,30.8%,38m
4108,2,[KBH]WankelEngine,3825,391,20,20,40,50.0%,18m
4108,2,Vanish,3825,510,18,17,35,51.4%,25m
4108,2,Keks,3825,310,11,8,19,57.9%,36m
4108,2,[eSun]Ciel,3825,102,4,4,8,50.0%,17m
4108,2,[OIGE]Walterex,3825,30,1,6,7,14.3%,7m
4108,3,[SSAMZI]BTS,3825,0,0,2,2,0.0%,20m
4108,2,Serenity,3825,0,0,4,4,0.0%,11m
4115,2,SneakySquid,3824,1478,143,116,259,55.2%,28m
4115,2,[Ris3n]GTKung,3824,1652,82,63,145,56.6%,4m
4115,2,[DhZPro]COSMOS,3824,929,50,30,80,62.5%,8m
4115,1,[Bloody]NotASword,3824,44,2,6,8,25.0%,40m
4115,2,llllllllllll,3824,0,1,0,1,100.0%,21m
4115,2,OFE,3824,0,0,1,1,0.0%,18m
4121,2,Kramer,3823,1031,87,78,165,52.7%,29m
4121,1,MEALPHAUBETA,3823,891,38,42,80,47.5%,22m
4121,2,Btea,3823,235,31,27,58,53.4%,39m
4121,2,[Vtta]Leveleando,3823,60,3,1,4,75.0%,17m
4121,2,rUready,3823,0,3,2,5,60.0%,35m
4121,2,UwanDisDik,3823,0,1,2,3,33.3%,4m
4127,1,sQuirel,3822,1601,301,299,600,50.2%,11m
4127,2,[ANFA]Fade,3822,1684,104,88,192,54.2%,18m
4127,2,[Xpk]kachaviejas,3822,1574,102,83,185,55.1%,35m
4127,2,[FIow]WolfdaoW,3822,373,21,4,25,84.0%,35m
4127,2,[CANONZ]serralsuncle,3822,382,21,21,42,50.0%,24m
4127,2,[Z3B1]Whitelinker,3822,400,14,11,25,56.0%,28m
4127,2,Dav,3822,220,7,11,18,38.9%,39m
4127,2,[ezzzz1]FalconPawnch,3822,204,6,12,18,33.3%,36m
4127,2,[Sr420]GaMBiTz,3822,132,4,8,12,33.3%,29m
4136,2,Wolfhead,3821,1164,67,39,106,63.2%,4m
4136,1,[Ex7rA]RaiN,3821,1570,65,75,140,46.4%,11m
4136,1,[AlIin]NineK,3821,698,17,28,45,37.8%,39m
4136,2,Blacklisted,3821,274,15,16,31,48.4%,26m
4136,2,riarty,3821,306,11,8,19,57.9%,36m
4136,2,[Aoret]Aoret,3821,200,7,3,10,70.0%,10m
4136,3,IMMvp,3821,86,3,4,7,42.9%,36m
4136,2,[iGOSU]FightZ,3821,0,0,6,6,0.0%,27m
4144,2,[LgnTDS]gtCheticus,3820,602,22,21,43,51.2%,24m
4144,1,Slovakftw,3820,314,8,13,21,38.1%,35m
4144,2,Titlis,3820,0,1,1,2,50.0%,19m
4147,1,[ACSS]soymilk,3819,1608,61,55,116,52.6%,33m
4147,1,DemonSlayer,3819,942,59,57,116,50.9%,37m
4147,2,OHelloThere,3819,530,18,14,32,56.2%,18m
4147,2,Terminator,3819,463,16,8,24,66.7%,23m
4147,2,[GrimmC]Marcelo,3819,174,6,3,9,66.7%,30m
4147,2,[PSISTM]FilthyRake,3819,0,0,1,1,0.0%,5m
4147,2,[ArGNA]kilokilo,3819,0,0,2,2,0.0%,13m
4154,1,[ZTempz]Kyleh,3818,1563,57,57,114,50.0%,39m
4154,2,richardesu,3818,880,34,28,62,54.8%,16m
4154,1,SenderBeware,3818,623,18,20,38,47.4%,10m
4154,2,[GGclan]GGRetiemble,3818,192,7,6,13,53.8%,36m
4154,2,Castplay,3818,90,4,3,7,57.1%,24m
4154,1,InitiumNovu,3818,0,3,1,4,75.0%,27m
4154,2,galena,3818,36,2,0,2,100.0%,28m
4154,2,gaulzi,3818,32,1,2,3,33.3%,36m
4162,1,LumpySpaceEa,3817,974,371,394,765,48.5%,24m
4162,1,[FotM]Lotus,3817,1956,230,234,464,49.6%,2h
4162,2,Tinker,3817,522,23,9,32,71.9%,29m
4162,2,IIIIIIIIIIII,3817,252,10,5,15,66.7%,25m
4162,2,[PGTLGL]Pochi,3817,212,7,10,17,41.2%,17m
4162,2,[JSLs]Hellscream,3817,158,5,4,9,55.6%,35m
4162,2,[KIRK]LeadFarmer,3817,40,2,4,6,33.3%,8m
4162,2,[H2L]EzLaiho,3817,0,0,3,3,0.0%,28m
4170,1,[TK3C]tretre,3816,1686,77,83,160,48.1%,39m
4170,2,Capoch,3816,0,1,0,1,100.0%,24m
4170,2,MrGoliath,3816,0,1,3,4,25.0%,23m
4170,2,gsz,3816,0,0,1,1,0.0%,36m
4174,1,Griefed,3815,534,24,13,37,64.9%,30m
4174,2,ShadowFox,3815,104,4,4,8,50.0%,21m
4174,2,[αB]Ifiwereasoup,3815,32,1,2,3,33.3%,17m
4174,2,[Ikar0s]GreyColor,3815,0,0,1,1,0.0%,2h
4178,2,GareBear,3814,1683,91,71,162,56.2%,17m
4178,2,[TGosuA]Burrell,3814,1180,84,73,157,53.5%,18m
4178,2,JustAFrog,3814,1044,44,26,70,62.9%,4m
4178,1,[Amb3rs]UGamer,3814,1002,37,29,66,56.1%,22m
4178,2,[bsaur]Fylypek,3814,229,8,2,10,80.0%,4m
4178,2,[ZTempz]Zara,3814,152,6,3,9,66.7%,19m
4178,2,[EZDUNK]Magnath,3814,34,2,1,3,66.7%,8m
4178,2,Jefflenious,3814,68,2,1,3,66.7%,36m
4186,2,[PHOEVA]dncheesmeplz,3813,32,1,2,3,33.3%,34m
4187,2,Osroni,3812,860,45,28,73,61.6%,36m
4187,3,Protossop,3812,271,13,7,20,65.0%,20m
4187,2,IIIIIIIIIIII,3812,160,9,0,9,100.0%,8m
4187,2,[TAW]Henpe,3812,0,1,0,1,100.0%,31m
4187,3,Snoooopy,3812,0,1,0,1,100.0%,27m
4187,2,Marijuander,3812,30,1,2,3,33.3%,6m
4187,2,fireduck,3812,0,0,2,2,0.0%,36m
4194,2,[KingSC]Dritpit,3811,1636,92,92,184,50.0%,32m
4194,2,AnthonellaMC,3811,860,56,44,100,56.0%,23m
4194,2,Wormh,3811,160,8,1,9,88.9%,23m
4197,2,GarbageCan,3810,1272,161,154,315,51.1%,29m
4197,2,[xRtGac]LittleJimmy,3810,228,8,8,16,50.0%,36m
4197,3,[TeChef]Briman,3810,143,6,0,6,100.0%,31m
4197,1,[G0G0G0]SiAN,3810,186,5,13,18,27.8%,36m
4201,2,[MooLA]MaGic,3809,1659,226,215,441,51.2%,6m
4201,1,[LGNxx]ZurAzzt,3809,1829,101,101,202,50.0%,33m
4201,2,LadyJade,3809,1447,81,56,137,59.1%,19m
4201,2,Smile,3809,1212,67,20,87,77.0%,31m
4201,2,wolfhead,3809,344,12,8,20,60.0%,7m
4201,2,llllllllllll,3809,311,11,7,18,61.1%,30m
4201,2,panda,3809,0,1,2,3,33.3%,17m
4208,2,Bob,3808,1657,143,146,289,49.5%,32m
4208,1,ComeAtMeBrah,3808,1176,44,40,84,52.4%,38m
4208,2,[HazIPA]Zen,3808,716,30,17,47,63.8%,32m
4208,2,Ewells,3808,663,26,18,44,59.1%,8m
4208,2,PeekaChi,3808,316,15,14,29,51.7%,5m
4208,3,Primming,3808,147,6,5,11,54.5%,24m
4208,2,[SmoK]LiquidTHC,3808,32,2,1,3,66.7%,2h
4215,1,[ValidG]KeppO,3807,1779,196,190,386,50.8%,27m
4215,2,Opticon,3807,1628,120,111,231,51.9%,18m
4215,1,[LTK]Telos,3807,1623,86,89,175,49.1%,4m
4215,2,[GEEKED]Amorfo,3807,776,55,8,63,87.3%,38m
4215,1,[BLUCKE]Hunty,3807,597,23,20,43,53.5%,13m
4215,2,[SPCBR]Barcode,3807,502,20,10,30,66.7%,28m
4215,2,[BA0]FeSTiVaL,3807,264,10,9,19,52.6%,5m
4215,2,[TushAn]SooVation,3807,86,4,0,4,100.0%,32m
4223,2,Immortal,3806,698,41,37,78,52.6%,24m
4223,2,DracoingOff,3806,344,14,9,23,60.9%,7m
4223,2,DaTomminator,3806,0,1,0,1,100.0%,20m
4223,2,jimmymicro,3806,0,0,2,2,0.0%,35m
4227,2,SebPatoche,3805,1638,90,61,151,59.6%,18m
4227,1,IIIIIIIIIIII,3805,1628,47,54,101,46.5%,39m
4227,2,[420bzr]ApeX,3805,318,12,11,23,52.2%,18m
4227,3,[GanGan]ReCall,3805,167,9,1,10,90.0%,9m
4227,3,Selendis,3805,166,9,1,10,90.0%,9m
4227,2,[GNXPOP]Merlin,3805,240,9,4,13,69.2%,8m
4227,1,Pikmet,3805,181,3,10,13,23.1%,39m
4227,2,Bubs,3805,30,1,4,5,20.0%,37m
4235,2,[ExcIgN]LisethCeva,3804,810,39,16,55,70.9%,31m
4235,2,Zerg,3804,672,35,7,42,83.3%,6m
4235,2,ººº,3804,236,9,5,14,64.3%,35m
4235,2,ELI,3804,236,9,7,16,56.2%,40m
4235,2,StaYGoLD,3804,64,2,8,10,20.0%,4m
4235,2,Practice,3804,0,1,0,1,100.0%,23m
4235,2,Matrixx,3804,32,1,1,2,50.0%,35m
4235,2,Promyvion,3804,0,0,2,2,0.0%,4m
4243,1,Urzasclaw,3803,1942,109,115,224,48.7%,26m
4243,2,CaptianThorn,3803,1061,65,56,121,53.7%,6m
4243,2,TeacherAngel,3803,501,21,9,30,70.0%,25m
4243,2,PaaT,3803,384,13,18,31,41.9%,4m
4243,2,ShadowedRadi,3803,64,3,8,11,27.3%,25m
4243,2,Dacalux,3803,0,0,1,1,0.0%,31m
4249,1,[13Pool]shogi,3802,1936,186,184,370,50.3%,38m
4249,1,[ojj]AkaK,3802,1941,85,95,180,47.2%,19m
4249,2,basedRedPill,3802,982,50,22,72,69.4%,11m
4249,2,[LQV]Slowly,3802,866,38,19,57,66.7%,25m
4249,2,ZHZ,3802,874,35,27,62,56.5%,18m
4249,2,steady,3802,806,34,21,55,61.8%,40m
4249,2,ARCH,3802,702,23,30,53,43.4%,40m
4249,2,ENaSSaJJaGa,3802,360,12,13,25,48.0%,23m
4249,2,Nocso,3802,296,10,12,22,45.5%,7m
4249,2,[cl0udM]DeDaux,3802,0,1,2,3,33.3%,34m
4259,2,DarkSeer,3801,1567,213,187,400,53.2%,36m
4259,2,legger,3801,1276,96,98,194,49.5%,21m
4259,2,DrBell,3801,1601,89,84,173,51.4%,36m
4259,2,[DrThrx]GLAToxin,3801,910,36,43,79,45.6%,36m
4259,2,TheSaintBat,3801,517,23,11,34,67.6%,9m
4259,2,[Cryptc]Tonstor,3801,204,7,7,14,50.0%,8m
4259,2,[HMTeam]Lixow,3801,38,2,2,4,50.0%,30m
4259,2,HKN,3801,0,0,1,1,0.0%,27m
4267,1,evalam,3800,1636,123,129,252,48.8%,20m
4267,1,[BQT]BIGQTBALLER,3800,1631,74,68,142,52.1%,10m
4267,2,Unclenoob,3800,1004,39,33,72,54.2%,29m
4267,2,Chocodile,3800,876,33,25,58,56.9%,8m
4267,3,BLACKPINK,3800,458,32,67,99,32.3%,12m
4267,2,Pillow,3800,324,17,4,21,81.0%,24m
4267,3,KillingEdge,3800,262,13,4,17,76.5%,38m
4267,2,[YGD]UITrA,3800,302,10,15,25,40.0%,19m
4267,2,[GOPERÚ]YosHymitsu,3800,62,2,5,7,28.6%,18m
4276,1,[iGOSU]Sublime,3799,1848,133,131,264,50.4%,5m
4276,2,[ØÛ]Vendettavic,3799,1273,97,88,185,52.4%,5m
4276,1,[2AhB]Omedon,3799,911,52,56,108,48.1%,40m
4276,2,[DaBurn]Stevie,3799,618,23,19,42,54.8%,25m
4276,2,TZimba,3799,361,18,3,21,85.7%,35m
4276,3,Nults,3799,131,12,5,17,70.6%,22m
4282,2,[YD2K]Hopium,3798,1545,116,113,229,50.7%,8m
4282,1,[KoopaZ]Maleficent,3798,1870,71,80,151,47.0%,11m
4282,2,jeon,3798,64,2,2,4,50.0%,17m
4285,2,Torkk,3797,1446,59,50,109,54.1%,17m
4285,2,JiriBird,3797,481,52,48,100,52.0%,39m
4285,2,[FvR]ShOckWavE,3797,342,12,9,21,57.1%,17m
4285,2,[TiChum]RaijiN,3797,234,8,6,14,57.1%,32m
4285,2,Dead,3797,30,4,2,6,66.7%,30m
4285,2,[iEXPO]Kudoh,3797,0,0,1,1,0.0%,26m
4285,3,[IPZerg]Hail,3797,0,0,4,4,0.0%,7m
4292,2,natty,3796,1627,151,144,295,51.2%,14m
4292,3,[Frnzy]Valentine,3796,1743,122,154,276,44.2%,24m
4292,1,[LPlay]Light,3796,1208,114,120,234,48.7%,18m
4292,2,Python,3796,1322,82,64,146,56.2%,11m
4292,2,[XpKAc]Kurama,3796,442,20,10,30,66.7%,28m
4292,2,[JIGLY]Arts,3796,232,10,14,24,41.7%,10m
4292,1,[GBros]green,3796,372,10,21,31,32.3%,36m
4292,2,Protossium,3796,175,8,1,9,88.9%,8m
4292,2,Ezekial,3796,194,7,3,10,70.0%,39m
4292,2,LastScream,3796,30,6,0,6,100.0%,34m
4292,2,[ValidG]Kappadar,3796,0,1,0,1,100.0%,7m
4292,2,slazio,3796,0,0,2,2,0.0%,24m
4304,1,Skycool,3795,1885,417,390,807,51.7%,31m
4304,1,[DRKDMN]warrior,3795,1376,53,63,116,45.7%,18m
4304,1,[lKoDl]Atila,3795,973,51,51,102,50.0%,31m
4304,2,[Igbt]LETSGOOOOOOO,3795,682,29,21,50,58.0%,35m
4304,2,ARN,3795,214,8,7,15,53.3%,17m
4304,2,[FnS]Platoon,3795,134,5,4,9,55.6%,39m
4304,2,Xormentor,3795,0,1,0,1,100.0%,24m
4304,3,[GnR]RetrO,3795,0,0,1,1,0.0%,7m
4312,2,Wisebrah,3794,360,14,8,22,63.6%,7m
4312,2,sergyo,3794,264,13,4,17,76.5%,30m
4312,2,[AtoSis]Noxly,3794,186,7,3,10,70.0%,23m
4312,2,SoWhat,3794,66,3,4,7,42.9%,32m
4312,2,[SSeiya]Camus,3794,66,2,2,4,50.0%,18m
4312,2,[BbTea]GuoSao,3794,0,1,0,1,100.0%,28m
4312,2,[NTDL]Lofty,3794,0,0,1,1,0.0%,21m
4319,2,[SsaYnS]kanstar,3793,1498,247,241,488,50.6%,6m
4319,2,[DRKAPP]Hayden,3793,422,33,29,62,53.2%,24m
4319,2,Trash,3793,34,2,0,2,100.0%,4m
4322,1,DEMONWB,3792,1915,300,293,593,50.6%,38m
4322,2,PNess,3792,1634,124,119,243,51.0%,22m
4322,1,Kuri,3792,1094,67,73,140,47.9%,19m
4322,2,elPanadero,3792,416,14,17,31,45.2%,30m
4322,2,[Dicboy]Pudgey,3792,298,10,3,13,76.9%,11m
4322,2,Dukque,3792,142,5,8,13,38.5%,8m
4322,2,TheDogDream,3792,30,2,1,3,66.7%,38m
4322,1,Crisp,3792,0,1,5,6,16.7%,10m
4330,1,Chrollo,3791,1933,125,127,252,49.6%,11m
4330,2,[IIDA]FRAGA,3791,189,6,3,9,66.7%,6m
4330,2,[Cryptc]Doije,3791,0,0,1,1,0.0%,6m
4333,2,Yoga,3790,126,4,7,11,36.4%,18m
4333,2,Necromortis,3790,66,3,4,7,42.9%,11m
4335,2,Superman,3789,1607,162,151,313,51.8%,34m
4335,2,Pollux,3789,944,39,29,68,57.4%,23m
4335,2,StinkyBrain,3789,345,21,24,45,46.7%,36m
4335,2,Naota,3789,478,18,16,34,52.9%,21m
4335,2,[ZTemp]MrMaryJane,3789,351,14,10,24,58.3%,37m
4335,2,[S2sex]ILOVESEX,3789,140,5,5,10,50.0%,40m
4335,2,[SlwPk]Sludge,3789,0,1,1,2,50.0%,18m
4335,2,CGK,3789,0,1,4,5,20.0%,10m
4335,2,Hello,3789,0,0,1,1,0.0%,34m
4344,1,somethingADO,3788,1718,200,203,403,49.6%,33m
4344,1,Doughboy,3788,1935,194,208,402,48.3%,8m
4344,2,[lLiTl]potato,3788,336,12,11,23,52.2%,23m
4344,2,Ghettomagic,3788,66,2,4,6,33.3%,36m
4344,2,[GGBr0]testguy,3788,0,0,1,1,0.0%,27m
4344,2,Cendilion,3788,0,0,2,2,0.0%,8m
4350,2,Powerover,3787,1658,199,190,389,51.2%,28m
4350,2,DeRagonSlayR,3787,1107,107,102,209,51.2%,40m
4350,1,PillowFight,3787,1056,68,50,118,57.6%,36m
4350,2,[cl0udM]shiptor,3787,766,31,17,48,64.6%,17m
4350,2,DreamBig,3787,290,14,3,17,82.4%,17m
4350,2,ChadStalker,3787,166,6,2,8,75.0%,11m
4350,2,Tyrion,3787,89,6,3,9,66.7%,39m
4350,1,[TSØP]AbOsX,3787,0,3,4,7,42.9%,20m
4350,3,DTox,3787,97,2,5,7,28.6%,2h
4350,2,[NotSry]TheAtheist,3787,30,1,1,2,50.0%,35m
4360,2,[xRtG]loafingbread,3786,1105,51,32,83,61.4%,23m
4360,2,Ahkens,3786,784,27,31,58,46.6%,7m
4360,1,jimmypoi,3786,984,24,35,59,40.7%,36m
4360,2,[mocat]HobboJim,3786,520,19,17,36,52.8%,7m
4360,2,[BSKY]Computer,3786,0,0,1,1,0.0%,7m
4360,2,MacMac,3786,0,0,2,2,0.0%,30m
4366,2,Zboss,3785,1497,153,153,306,50.0%,14m
4366,2,HYVAA,3785,868,35,26,61,57.4%,15m
4366,2,Oblong,3785,607,33,32,65,50.8%,39m
4366,2,SirWhite,3785,341,16,5,21,76.2%,7m
4366,2,Probe,3785,388,15,8,23,65.2%,31m
4366,3,[DSRL]RealSodom,3785,195,12,3,15,80.0%,9m
4366,2,EhMove,3785,304,11,8,19,57.9%,34m
4366,2,izaak,3785,282,10,8,18,55.6%,26m
4366,3,MrButtons,3785,145,4,1,5,80.0%,23m
4366,2,[xGenGx]MadneticsYT,3785,0,4,3,7,57.1%,23m
4366,2,EternityYosh,3785,0,0,1,1,0.0%,35m
4366,2,[2B1S]Chazwazza,3785,0,0,1,1,0.0%,8m
4366,2,Elemdanum,3785,0,0,1,1,0.0%,8m
4379,2,Killer,3784,1626,138,133,271,50.9%,26m
4379,1,[LgnTDS]Elegacy,3784,1061,44,38,82,53.7%,27m
4379,1,kang,3784,489,18,12,30,60.0%,12m
4379,2,IIIIIIIIIIII,3784,252,9,8,17,52.9%,6m
4379,3,Baldurans,3784,143,8,0,8,100.0%,9m
4379,2,[61]PreaTorFeniX,3784,90,3,1,4,75.0%,9m
4379,2,Prostatitis,3784,30,2,1,3,66.7%,4m
4379,2,wyguy,3784,0,1,0,1,100.0%,23m
4379,2,[ØFoxF2]Boxco,3784,0,1,0,1,100.0%,35m
4379,2,[JayRay]PizzaDream,3784,0,0,1,1,0.0%,14m
4389,2,[Th3Bad]Gabslee,3783,203,10,12,22,45.5%,30m
4389,2,wolfmanIII,3783,149,6,6,12,50.0%,35m
4389,2,[UpeV]UwUSaurio,3783,94,4,2,6,66.7%,6m
4389,2,Uniwa,3783,92,4,3,7,57.1%,11m
4389,3,ZylslyZ,3783,0,1,0,1,100.0%,18m
4389,2,MeemoSaan,3783,0,0,1,1,0.0%,6m
4395,1,Bane,3782,1921,155,165,320,48.4%,11m
4395,2,Cools,3782,1375,97,90,187,51.9%,34m
4395,1,Nhung,3782,523,16,27,43,37.2%,4m
4395,1,BiOMallron,3782,120,7,0,7,100.0%,14m
4395,2,[Dante]Dante,3782,153,3,3,6,50.0%,23m
4400,1,cuttr,3781,1851,172,181,353,48.7%,9m
4400,2,[GRMN]MrJin,3781,235,14,7,21,66.7%,2h
4400,2,Meyr,3781,188,10,2,12,83.3%,30m
4400,2,Cazdog,3781,30,2,0,2,100.0%,17m
4400,2,WaterDemon,3781,76,2,8,10,20.0%,40m
4400,2,Eggiman,3781,0,0,1,1,0.0%,13m
4400,2,SALADMENCE,3781,0,0,1,1,0.0%,2h
4400,2,ddswmv,3781,0,0,6,6,0.0%,3m
4408,2,Electricat,3780,1646,153,130,283,54.1%,23m
4408,2,[iDrunk]llllllIIIIIl,3780,222,6,7,13,46.2%,7m
4408,2,[BloodX]Elurion,3780,30,1,2,3,33.3%,34m
4408,2,[TeamUR]blank,3780,0,0,1,1,0.0%,39m
4412,2,QLmindless,3779,1247,52,53,105,49.5%,37m
4412,2,TheGreat,3779,332,13,6,19,68.4%,40m
4412,2,[xRtG]Armleg,3779,356,11,13,24,45.8%,31m
4412,2,Goooey,3779,174,7,4,11,63.6%,14m
4412,2,[M1A5]sebas,3779,58,3,1,4,75.0%,10m
4412,2,[H8T3D]ZeraSabre,3779,0,0,1,1,0.0%,36m
4418,2,[Fir3s]StillFly,3778,1519,134,131,265,50.6%,26m
4418,1,HIGHnMIGHTy,3778,1252,119,130,249,47.8%,6m
4418,1,BuddhaMonk,3778,773,65,58,123,52.8%,40m
4418,2,[Wrekrs]Sparky,3778,584,25,13,38,65.8%,31m
4418,2,CEBO,3778,205,8,2,10,80.0%,10m
4418,2,Nightfall,3778,98,3,2,5,60.0%,39m
4418,2,[cl0udM]isthisfun,3778,40,2,6,8,25.0%,3m
4418,2,[Penizz]OgloO,3778,0,1,0,1,100.0%,29m
4418,2,TABiGbiRd,3778,0,0,1,1,0.0%,3m
4427,2,revealvideos,3777,1160,180,167,347,51.9%,30m
4427,2,[ZrO2]UtteRChaoS,3777,1616,87,75,162,53.7%,39m
4427,2,[InGt]EatMyDT,3777,1159,57,29,86,66.3%,7m
4427,2,OverLoadinG,3777,266,9,12,21,42.9%,36m
4427,2,[Starky]StarLord,3777,92,4,3,7,57.1%,13m
4427,2,Seventy,3777,36,1,1,2,50.0%,18m
4427,2,NULL,3777,30,1,4,5,20.0%,9m
4434,2,[LimaSC]Disruptor,3776,1428,102,97,199,51.3%,6m
4434,2,[gimp]KraftDinner,3776,1366,79,71,150,52.7%,8m
4434,2,[HotCop]Paralysis,3776,1078,64,42,106,60.4%,8m
4434,1,CasShernD,3776,1075,48,34,82,58.5%,12m
4434,2,LoseImprove,3776,509,34,17,51,66.7%,35m
4434,1,[nucle]Evacuate,3776,997,31,35,66,47.0%,39m
4434,2,[NalsEz]TimoIstBeste,3776,206,12,6,18,66.7%,23m
4441,1,dooz,3775,1547,79,77,156,50.6%,15m
4441,2,batty,3775,911,36,33,69,52.2%,23m
4441,1,Insatiable,3775,902,33,43,76,43.4%,6m
4441,2,Eisenhart,3775,227,12,2,14,85.7%,12m
4441,2,llllllllllll,3775,219,7,8,15,46.7%,28m
4441,2,[1E100]Syzygy,3775,126,4,7,11,36.4%,9m
4441,2,Herious,3775,30,2,1,3,66.7%,36m
4448,2,MuchaLuta,3774,1655,248,229,477,52.0%,12m
4448,1,[CGGWP]Thanatos,3774,290,21,26,47,44.7%,6m
4448,2,vanilla,3774,431,17,11,28,60.7%,29m
4448,2,LSDK,3774,416,17,13,30,56.7%,30m
4448,1,Gendarme,3774,660,17,23,40,42.5%,41m
4448,2,DarkZephyr,3774,240,12,4,16,75.0%,17m
4448,2,[LGNxx]Cabs,3774,95,9,11,20,45.0%,36m
4448,2,fastr,3774,64,3,1,4,75.0%,36m
4448,1,[H264]iNOOB,3774,48,1,6,7,14.3%,29m
4457,1,Protoss,3773,1035,132,138,270,48.9%,20m
4457,3,Honor,3773,165,9,1,10,90.0%,41m
4457,2,[LgnTDS]MachoMantis,3773,198,8,0,8,100.0%,37m
4457,2,MajiNTwO,3773,208,7,7,14,50.0%,39m
4457,2,INnoVation,3773,86,4,0,4,100.0%,7m
4457,2,[MadK]Marte,3773,92,3,6,9,33.3%,4m
4457,2,wafs,3773,34,1,1,2,50.0%,6m
4464,2,RedWar,3772,927,116,95,211,55.0%,4m
4464,2,GuZrCn,3772,1525,115,97,212,54.2%,11m
4464,1,Cris,3772,1878,76,82,158,48.1%,31m
4464,1,[RUSHya]Kaizen,3772,1400,39,50,89,43.8%,6m
4464,2,Optimizer,3772,453,21,11,32,65.6%,27m
4464,1,DiegoNoBueno,3772,0,3,2,5,60.0%,38m
4470,2,Nubster,3771,464,49,40,89,55.1%,6m
4470,2,Raijingeki,3771,506,22,11,33,66.7%,7m
4470,2,[Align]RIZZTOWN,3771,396,14,16,30,46.7%,38m
4470,1,[Macac0]LittleOne,3771,436,11,20,31,35.5%,10m
4470,2,[EtrOy]synapse,3771,179,8,7,15,53.3%,17m
4470,2,Hanscastorp,3771,190,6,9,15,40.0%,34m
4470,2,[3g0]RedRibbon,3771,128,4,6,10,40.0%,10m
4470,2,[eSun]DeathBringer,3771,0,1,0,1,100.0%,34m
4470,2,PedoBiden,3771,0,1,1,2,50.0%,4m
4470,2,[0sC]Aesa,3771,0,0,1,1,0.0%,36m
4470,3,Gerald,3771,0,0,1,1,0.0%,3m
4481,2,[Cryptc]Kazooie,3770,1602,313,315,628,49.8%,14m
4481,2,Mako,3770,1312,54,47,101,53.5%,39m
4481,2,[YD2K]Brayjunaz,3770,456,22,15,37,59.5%,8m
4481,2,HappyRogue,3770,193,7,4,11,63.6%,26m
4481,2,TJS,3770,172,6,4,10,60.0%,35m
4481,3,Hollow,3770,30,3,3,6,50.0%,3m
4481,2,llllllllllll,3770,30,2,2,4,50.0%,4m
4488,2,Librattor,3769,1415,341,296,637,53.5%,27m
4488,2,[SH3]Jackson,3769,1334,76,68,144,52.8%,40m
4488,2,[cl0udM]GetSome,3769,959,46,20,66,69.7%,23m
4488,2,All,3769,546,21,22,43,48.8%,39m
4488,2,OreBaron,3769,116,4,1,5,80.0%,8m
4488,2,[AdaptG]Ecchi,3769,66,3,5,8,37.5%,13m
4488,2,Orestes,3769,38,2,8,10,20.0%,32m
4488,2,[Th3Bad]Griffih,3769,36,1,4,5,20.0%,35m
4488,2,[Shang]Akilae,3769,0,0,3,3,0.0%,36m
4497,1,MugrosoCarl,3768,1887,164,146,310,52.9%,14m
4497,2,psiOnic,3768,254,31,20,51,60.8%,36m
4497,2,CalaVera,3768,176,6,7,13,46.2%,26m
4497,2,llllllllllll,3768,128,5,5,10,50.0%,4m
4497,2,SaintBat,3768,142,4,2,6,66.7%,12m
4497,2,[SC2AU]Akiwoo,3768,124,4,10,14,28.6%,18m
4497,2,Brainstorm,3768,0,1,0,1,100.0%,9m
4497,2,[Ðay9]Boden,3768,0,0,1,1,0.0%,4m
4505,2,GorillaBoy,3767,409,30,22,52,57.7%,34m
4505,2,[Viola]Natalie,3767,684,25,19,44,56.8%,4m
4505,2,pineapplePie,3767,503,19,18,37,51.4%,4m
4505,2,Tempest,3767,358,13,10,23,56.5%,23m
4505,2,[Dicboy]DrEvil,3767,292,9,16,25,36.0%,19m
4505,3,[ZTemp]Vandy,3767,225,6,5,11,54.5%,22m
4505,2,dardour,3767,114,4,1,5,80.0%,18m
4505,2,[LHRS]Charlie,3767,0,1,2,3,33.3%,32m
4505,3,Ralphie,3767,0,1,2,3,33.3%,3m
4505,2,[DarkAG]PocketRocket,3767,0,0,5,5,0.0%,23m
4515,2,[Ssok]ian,3766,1526,64,64,128,50.0%,10m
4515,2,yusef,3766,1097,44,40,84,52.4%,6m
4515,2,[clanPD]microtubes,3766,646,28,16,44,63.6%,18m
4515,2,DonTSweat,3766,539,21,10,31,67.7%,28m
4515,1,[5CP]Lego,3766,263,8,20,28,28.6%,20m
4515,3,NeronX,3766,188,6,0,6,100.0%,30m
4521,2,KOR,3765,338,19,4,23,82.6%,11m
4521,2,carrot,3765,218,11,3,14,78.6%,17m
4521,2,Perfect,3765,90,3,3,6,50.0%,39m
4521,2,sadan,3765,60,3,4,7,42.9%,13m
4521,2,TigerLily,3765,0,0,1,1,0.0%,13m
4526,1,[Cryptc]hotdogSherif,3764,1890,564,555,1119,50.4%,31m
4526,2,[UpeV]Tilin,3764,1585,181,179,360,50.3%,8m
4526,1,scaryfire,3764,1541,131,111,242,54.1%,39m
4526,2,BastionMain,3764,1467,71,41,112,63.4%,7m
4526,2,maxQ,3764,811,38,25,63,60.3%,24m
4526,2,[Lapis]Ignia,3764,481,18,16,34,52.9%,22m
4526,2,MrWillyarms,3764,57,8,8,16,50.0%,35m
4526,2,[Gaemer]GamerRicky,3764,60,3,0,3,100.0%,4m
4526,2,IIIIIIIIIIII,3764,70,3,5,8,37.5%,14m
4526,2,SmartEntity,3764,0,1,0,1,100.0%,36m
4526,3,AKIRO,3764,0,1,0,1,100.0%,18m
4526,2,[AtL450]MastAyO,3764,0,0,1,1,0.0%,35m
4526,2,[MinzS]SwordWielder,3764,0,0,1,1,0.0%,34m
4526,2,HEAT,3764,0,0,2,2,0.0%,10m
4540,2,[TCool]Blinky,3763,794,120,103,223,53.8%,40m
4540,2,DHH,3763,621,59,39,98,60.2%,36m
4540,2,BestGameEver,3763,302,14,2,16,87.5%,8m
4540,2,[LTlord]daryl,3763,337,14,17,31,45.2%,8m
4540,2,[GuN]ekSo,3763,152,6,6,12,50.0%,6m
4540,2,Junhao,3763,72,3,6,9,33.3%,11m
4540,2,emfatic,3763,98,3,7,10,30.0%,10m
4547,2,[iGOSU]footiewookie,3762,1532,283,272,555,51.0%,11m
4547,2,Player,3762,298,20,9,29,69.0%,36m
4547,2,[Ðiçk]thatplimp,3762,286,10,9,19,52.6%,21m
4547,2,Sulk,3762,32,1,6,7,14.3%,26m
4547,2,Xetal,3762,0,0,1,1,0.0%,24m
4552,2,Present,3761,1133,100,12,112,89.3%,23m
4552,2,WikiWorm,3761,806,99,76,175,56.6%,11m
4552,2,Meow,3761,1272,58,45,103,56.3%,4m
4552,2,KiRuZ,3761,362,21,18,39,53.8%,35m
4552,2,HelltoPay,3761,280,10,6,16,62.5%,22m
4552,2,superdemon,3761,146,9,5,14,64.3%,10m
4552,2,FarI,3761,112,7,0,7,100.0%,28m
4552,2,[UnitQC]NaYa,3761,168,7,8,15,46.7%,12m
4552,1,ShoGun,3761,268,6,18,24,25.0%,33m
4552,1,[dLife]Anomie,3761,92,5,7,12,41.7%,19m
4552,2,BigData,3761,34,1,1,2,50.0%,12m
4563,2,[SsaYnS]littlefs,3760,1589,120,114,234,51.3%,21m
4563,2,CCPisEvil,3760,1374,72,62,134,53.7%,32m
4563,2,Crested,3760,1132,46,41,87,52.9%,19m
4563,2,LittleWeiner,3760,440,33,10,43,76.7%,24m
4563,2,Sirref,3760,282,12,0,12,100.0%,22m
4563,2,[AKLsc]Sabbath,3760,30,2,2,4,50.0%,6m
4563,2,[S3CLUD]carshalljd,3760,0,0,1,1,0.0%,30m
4563,2,Kuyzz,3760,0,0,3,3,0.0%,9m
4571,1,Masterbait,3759,979,87,81,168,51.8%,25m
4571,2,Oddsbodikins,3759,434,16,18,34,47.1%,26m
4571,3,moleculeman,3759,30,2,2,4,50.0%,17m
4571,3,XrayShadow,3759,0,1,0,1,100.0%,17m
4575,2,IIIIIIIIIIII,3758,898,34,33,67,50.7%,4m
4575,3,PutinKa,3758,209,10,1,11,90.9%,2h
4575,2,Heartz,3758,180,7,7,14,50.0%,26m
4575,2,TechnoO,3758,0,2,3,5,40.0%,16m
4579,2,fLoW,3757,1626,157,162,319,49.2%,35m
4579,2,[VFam]Zaechus,3757,1624,148,142,290,51.0%,10m
4579,2,[Shiit]Xenos,3757,740,55,51,106,51.9%,11m
4579,2,chaoreum,3757,572,26,17,43,60.5%,34m
4579,2,oatmeeL,3757,200,7,9,16,43.8%,40m
4579,2,Nooblet,3757,142,6,2,8,75.0%,17m
4579,2,MagiC,3757,215,6,4,10,60.0%,23m
4579,3,BsKCoto,3757,0,0,1,1,0.0%,23m
4579,1,DarkMenace,3757,0,0,2,2,0.0%,27m
4588,2,IntoTheRain,3756,765,119,94,213,55.9%,39m
4588,2,BarCraft,3756,1341,103,86,189,54.5%,13m
4588,2,Salsu,3756,1066,54,48,102,52.9%,32m
4588,3,Mahalleinir,3756,355,16,5,21,76.2%,14m
4588,2,Madison,3756,62,3,2,5,60.0%,34m
4588,2,[lLiTl]Broketail,3756,30,2,0,2,100.0%,34m
4588,3,PickleRick,3756,0,0,9,9,0.0%,17m
4595,2,[MSFT]ViceAdmiral,3755,1595,189,167,356,53.1%,20m
4595,2,Bungo,3755,1609,180,164,344,52.3%,23m
4595,2,[N4K3D]Archoff,3755,284,25,26,51,49.0%,26m
4595,2,IEATBOOOOOTY,3755,441,21,6,27,77.8%,40m
4595,2,Spur,3755,194,8,2,10,80.0%,25m
4595,2,IIIIIIIIIIII,3755,86,3,1,4,75.0%,4m
4595,3,Haggis,3755,30,1,9,10,10.0%,31m
4595,1,[TGosuA]CiTiZiN,3755,0,0,1,1,0.0%,11m
4595,2,[gHQ]NoobSauce,3755,0,0,1,1,0.0%,28m
4604,1,[xLgNx]flapjack,3754,1878,396,386,782,50.6%,10m
4604,1,[KRlSPY]Swunder,3754,856,81,83,164,49.4%,13m
4604,2,boombacs,3754,776,32,26,58,55.2%,36m
4604,2,TheKeystone,3754,500,22,18,40,55.0%,30m
4604,2,Bonjwa,3754,395,19,8,27,70.4%,24m
4604,2,Trash,3754,118,5,5,10,50.0%,27m
4604,2,dirtyplayer,3754,0,3,4,7,42.9%,34m
4604,2,redbone,3754,0,0,2,2,0.0%,6m
4612,1,BaiLLiE,3753,1894,982,977,1959,50.1%,39m
4612,1,[PrbRsh]Freeblade,3753,1717,356,325,681,52.3%,38m
4612,2,DigitalAngel,3753,1374,54,56,110,49.1%,37m
4612,2,Profisee,3753,524,21,10,31,67.7%,16m
4612,2,[2Cold]eraSe,3753,360,17,7,24,70.8%,40m
4612,2,[OakHrt]ZrenBishes,3753,292,11,7,18,61.1%,10m
4612,2,[Lp]SageRoldaN,3753,128,6,2,8,75.0%,34m
4612,2,[DarkAG]Nantrix,3753,58,4,4,8,50.0%,29m
4612,2,Wocka,3753,132,4,7,11,36.4%,18m
4612,3,River,3753,97,1,1,2,50.0%,13m
4622,1,happyterran,3752,542,19,28,47,40.4%,35m
4622,3,solowingpixy,3752,343,16,5,21,76.2%,21m
4622,2,[NPhasA]Brandol,3752,296,12,7,19,63.2%,17m
4622,2,CKCK,3752,60,4,5,9,44.4%,3m
4622,3,Paladin,3752,36,2,2,4,50.0%,5m
4622,2,DangaZone,3752,30,1,1,2,50.0%,22m
4628,1,[ZTemps]ProbeJob,3751,1901,274,279,553,49.5%,39m
4628,2,BigBeeff,3751,927,44,24,68,64.7%,17m
4628,2,Contoss,3751,372,38,20,58,65.5%,8m
4628,1,[NPhasA]wicky,3751,753,28,23,51,54.9%,35m
4628,2,RiddicKK,3751,706,28,23,51,54.9%,17m
4628,2,[ErrMaG]kaizuki,3751,468,22,10,32,68.8%,27m
4628,2,jinso,3751,351,17,7,24,70.8%,17m
4628,2,[Tyber]jameszhou,3751,171,4,5,9,44.4%,13m
4628,2,[WSCSC2]Juun,3751,60,3,1,4,75.0%,34m
4628,2,HanLin,3751,0,2,3,5,40.0%,40m
4628,2,FckingNiggaX,3751,30,1,5,6,16.7%,29m
4639,2,Sheaf,3750,1626,326,284,610,53.4%,24m
4639,1,[FFAA]konan,3750,1440,203,190,393,51.7%,31m
4639,2,[VERUM]Enigma,3750,34,2,0,2,100.0%,19m
4639,2,Leong,3750,0,0,1,1,0.0%,23m
4643,2,[SsaYnS]Boundless,3749,1591,392,377,769,51.0%,32m
4643,2,[TDX]Quirkedkirk,3749,1197,71,41,112,63.4%,38m
4643,3,UwU,3749,202,11,2,13,84.6%,4m
4643,2,dreamCBTH,3749,172,7,2,9,77.8%,2h
4643,2,MrCannon,3749,172,7,3,10,70.0%,30m
4643,3,[hTx]EXwolf,3749,197,6,9,15,40.0%,14m
4643,2,Tarvek,3749,185,6,9,15,40.0%,22m
4643,2,[FMX]PaPaCoNhUeVo,3749,139,5,5,10,50.0%,26m
4643,2,KozukiYamato,3749,64,5,7,12,41.7%,34m
4643,2,IIIIIIIIIIII,3749,92,4,2,6,66.7%,32m
4643,2,[FataI]ReBeL,3749,64,2,5,7,28.6%,31m
4643,1,[LimaSC]Yuyu,3749,46,2,9,11,18.2%,38m
4643,2,Aequitas,3749,0,1,0,1,100.0%,22m
4643,2,GhostWansui,3749,30,1,2,3,33.3%,30m
4643,2,[XpKb]ZaMiTaAAa,3749,0,0,3,3,0.0%,29m
4658,2,[iCz]Redemption,3748,322,17,13,30,56.7%,9m
4658,1,Beerwhat,3748,694,17,31,48,35.4%,28m
4658,2,Otter,3748,376,14,10,24,58.3%,8m
4658,2,town,3748,363,12,9,21,57.1%,39m
4658,2,[Macac0]Armisael,3748,166,7,3,10,70.0%,4m
4658,2,expendable,3748,156,5,6,11,45.5%,39m
4658,2,[Toxity]liberty,3748,152,5,8,13,38.5%,8m
4658,2,OhWonDer,3748,0,0,3,3,0.0%,23m
4658,3,[ZzKPC]KuroMage,3748,0,0,7,7,0.0%,34m
4667,2,DroneKing,3747,1505,169,164,333,50.8%,23m
4667,2,[urdone]Formula,3747,498,17,20,37,45.9%,17m
4667,2,[JaMiT]Trethris,3747,462,16,20,36,44.4%,36m
4667,3,ErnstRiedler,3747,211,11,3,14,78.6%,17m
4667,2,badplayer,3747,172,6,7,13,46.2%,14m
4667,3,[αB]bScherm,3747,0,1,3,4,25.0%,16m
4673,2,NickDaMan,3746,1385,151,120,271,55.7%,22m
4673,2,[IRP]IRPhumayun,3746,1311,54,40,94,57.4%,6m
4673,2,mOsT,3746,246,13,5,18,72.2%,4m
4673,2,Brioche,3746,30,2,0,2,100.0%,34m
4673,2,[ROCKSC]TroubleMaker,3746,30,1,2,3,33.3%,27m
4673,2,[9111]Insidious,3746,0,0,2,2,0.0%,24m
4679,1,[DarkAG]EarthIsFlat,3745,1692,220,212,432,50.9%,41m
4679,2,[ValidG]oldparr,3745,1400,185,166,351,52.7%,6m
4679,2,SoupRize,3745,1115,98,101,199,49.2%,26m
4679,1,[CURLS]Milkman,3745,1503,93,92,185,50.3%,36m
4679,1,LastSamurai,3745,393,47,46,93,50.5%,35m
4679,2,SouthKorean,3745,0,0,1,1,0.0%,36m
4679,2,rainbOW,3745,0,0,1,1,0.0%,3m
4679,2,[Hack69]ElTramposo,3745,0,0,1,1,0.0%,6m
4687,1,[Bee]LiviRAWR,3744,1875,152,146,298,51.0%,36m
4687,2,Nautilus,3744,938,100,78,178,56.2%,33m
4687,2,[void44]epicvoid,3744,1254,48,44,92,52.2%,33m
4687,2,Anomaly,3744,624,32,7,39,82.1%,32m
4687,2,soonsiri,3744,412,15,5,20,75.0%,28m
4687,2,EkajArmstro,3744,362,14,12,26,53.8%,23m
4687,2,[OSOHT]EScape,3744,72,3,7,10,30.0%,18m
4687,2,[Toss]LifeforAihr,3744,32,2,7,9,22.2%,8m
4695,2,[AIRBAG]Ourion,3743,1531,224,207,431,52.0%,36m
4695,1,PerpetualSki,3743,1734,68,73,141,48.2%,36m
4695,2,Zakalwe,3743,58,3,0,3,100.0%,6m
4695,3,Sandibell,3743,97,3,1,4,75.0%,27m
4695,2,Star,3743,0,1,0,1,100.0%,24m
4695,2,Enderdejoran,3743,0,1,2,3,33.3%,19m
4695,2,BISU,3743,0,0,1,1,0.0%,4m
4702,2,[DhZPro]FuSioN,3742,1611,113,106,219,51.6%,6m
4702,2,[LOOPY]drmdrm,3742,868,47,27,74,63.5%,28m
4702,2,[D0J0]Nihjanix,3742,562,22,15,37,59.5%,24m
4702,2,PlzTrump,3742,212,8,9,17,47.1%,4m
4702,2,Bowchicabow,3742,119,7,0,7,100.0%,10m
4707,2,[TeamRF]DJscrew,3741,1436,111,105,216,51.4%,35m
4707,2,BisuYa,3741,1509,75,45,120,62.5%,34m
4707,2,[DarkAG]SilentStorm,3741,822,31,25,56,55.4%,33m
4707,3,Zeratul,3741,229,11,0,11,100.0%,26m
4707,2,[UofA]HyperBolic,3741,328,11,12,23,47.8%,6m
4707,2,LordPrimus,3741,294,10,10,20,50.0%,35m
4707,3,FartinG,3741,74,9,40,49,18.4%,14m
4707,2,Sondaljan,3741,75,4,0,4,100.0%,14m
4707,2,JabonDivino,3741,0,1,0,1,100.0%,17m
4716,1,KingKev,3740,1560,103,102,205,50.2%,31m
4716,2,FuWeiKe,3740,1042,41,34,75,54.7%,4m
4716,2,NoScared,3740,239,25,4,29,86.2%,8m
4716,2,Crystal,3740,185,7,7,14,50.0%,36m
4716,2,HerO,3740,166,5,3,8,62.5%,40m
4716,2,[RLSP]light,3740,90,4,4,8,50.0%,32m
4716,1,[RwtM]Arkenstone,3740,0,2,3,5,40.0%,6m
4716,2,[Ex0n]DOlPH,3740,0,1,0,1,100.0%,29m
4716,2,NOOBSMASHER,3740,0,1,0,1,100.0%,3m
4716,2,Sage,3740,32,1,2,3,33.3%,17m
4716,2,Veracja,3740,0,0,2,2,0.0%,27m
4727,2,Horizon,3739,1650,218,198,416,52.4%,10m
4727,1,[Ris3n]Richard,3739,1742,77,95,172,44.8%,10m
4727,2,[PRDUE]Steelman,3739,234,8,6,14,57.1%,31m
4730,2,walsingham,3738,378,14,11,25,56.0%,12m
4730,2,[CadeGs]Ultimifier,3738,86,4,2,6,66.7%,24m
4730,2,SaibaJoichir,3738,118,4,6,10,40.0%,15m
4730,2,Lazy,3738,64,3,1,4,75.0%,40m
4730,2,Barkode,3738,0,1,0,1,100.0%,17m
4730,2,[MoSun]YellowLarva,3738,0,0,1,1,0.0%,21m
4736,1,egg,3737,1515,193,210,403,47.9%,20m
4736,1,llllllllllll,3737,1548,169,161,330,51.2%,10m
4736,2,Hemorrhage,3737,425,52,27,79,65.8%,35m
4736,2,llllllllllll,3737,644,23,22,45,51.1%,2h
4736,1,lilsnow,3737,442,11,19,30,36.7%,35m
4736,2,[AraMaa]Kaguya,3737,136,8,1,9,88.9%,23m
4736,2,bOOTzNcATz,3737,122,4,9,13,30.8%,18m
4736,2,TheEqualizer,3737,66,3,6,9,33.3%,17m
4736,2,PaperKut,3737,30,2,5,7,28.6%,26m
4736,2,[FeverC]MostaLord,3737,0,1,0,1,100.0%,35m
4736,2,Bubba,3737,0,1,0,1,100.0%,8m
4736,2,NormCharlton,3737,0,0,1,1,0.0%,26m
4748,2,[ACSS]SnickleFritz,3736,907,34,39,73,46.6%,6m
4748,2,[NPhase]MeltedCheese,3736,562,20,24,44,45.5%,33m
4748,2,Lazy,3736,146,6,4,10,60.0%,30m
4748,2,[Msia]Exerate,3736,122,4,3,7,57.1%,17m
4748,3,DroneRusher,3736,30,2,0,2,100.0%,33m
4748,2,plop,3736,30,2,1,3,66.7%,6m
4748,2,Enoth,3736,0,1,0,1,100.0%,11m
4748,2,[InGt]AngryMidget,3736,0,0,2,2,0.0%,6m
4748,2,[SAMANC]victorLF,3736,0,0,3,3,0.0%,6m
4757,2,lynilir,3735,835,144,134,278,51.8%,37m
4757,2,ziltoid,3735,1344,78,78,156,50.0%,8m
4757,1,[UpeV]BarCode,3735,1830,61,66,127,48.0%,28m
4757,2,BananaJumpo,3735,360,13,9,22,59.1%,26m
4757,2,[iTHC]MixxMastaJrT,3735,0,0,1,1,0.0%,7m
4762,2,Acceleraizer,3734,834,38,19,57,66.7%,32m
4762,2,[RageQQ]OTL,3734,350,17,9,26,65.4%,34m
4762,2,Cricket,3734,278,11,2,13,84.6%,30m
4762,1,DecayDikc,3734,0,5,1,6,83.3%,29m
4762,2,Dart,3734,142,5,2,7,71.4%,13m
4762,2,[NwAs]FaraonDLT,3734,62,3,1,4,75.0%,24m
4762,3,Bogue,3734,0,1,0,1,100.0%,4m
4762,2,Cruiser,3734,0,1,3,4,25.0%,4m
4770,2,SirWhite,3733,255,11,3,14,78.6%,34m
4770,3,caibi,3733,169,9,2,11,81.8%,17m
4770,2,BeerLover,3733,126,8,0,8,100.0%,10m
4770,2,[TaRus]SpeedPlay,3733,63,4,3,7,57.1%,28m
4770,2,[PlsB0s]Ocelot,3733,30,2,2,4,50.0%,7m
4770,2,[Andres]AndrescrowTV,3733,0,1,0,1,100.0%,34m
4776,2,[AD3C]Zelda,3732,1550,366,372,738,49.6%,30m
4776,2,EzioAs,3732,888,144,134,278,51.8%,29m
4776,1,[StrFre]FluidKMC,3732,1757,132,133,265,49.8%,20m
4776,2,Yenko,3732,1406,84,76,160,52.5%,37m
4776,3,Steven,3732,201,9,5,14,64.3%,33m
4776,2,[1E100]Tapirus,3732,30,2,2,4,50.0%,40m
4776,2,[NPhasA]Massari,3732,0,1,0,1,100.0%,27m
4776,2,Newbie,3732,0,0,1,1,0.0%,20m
4784,2,Kaizen,3731,1636,107,85,192,55.7%,11m
4784,2,[RedHat]ABlindMan,3731,756,55,43,98,56.1%,31m
4784,2,[OD2019]SwissCheese,3731,939,38,28,66,57.6%,26m
4784,2,secjy,3731,308,36,37,73,49.3%,21m
4784,1,Xerokul,3731,839,28,37,65,43.1%,13m
4784,2,HowToPlay,3731,466,21,12,33,63.6%,4m
4784,3,Borzinator,3731,0,1,0,1,100.0%,15m
4784,2,[UpeV]alexkitikazi,3731,0,0,2,2,0.0%,10m
4784,2,Talia,3731,0,0,3,3,0.0%,40m
4793,2,[TGCrew]Sesso,3730,1534,87,91,178,48.9%,30m
4793,2,Rarescanner,3730,505,25,20,45,55.6%,23m
4793,2,Yogapang,3730,527,20,10,30,66.7%,37m
4793,2,[TILL]oTo,3730,270,10,10,20,50.0%,23m
4793,2,Slaget,3730,184,6,9,15,40.0%,8m
4793,2,[Th3Bad]YanXII,3730,90,4,4,8,50.0%,28m
4793,3,[V13]AmunRa,3730,0,1,0,1,100.0%,23m
4793,3,Cyclops,3730,0,0,2,2,0.0%,22m
4801,2,IOwnU,3729,605,29,15,44,65.9%,4m
4801,2,LlamaKing,3729,204,7,7,14,50.0%,39m
4801,2,Skilgannon,3729,132,4,10,14,28.6%,35m
4801,2,Stodd,3729,106,3,5,8,37.5%,34m
4801,2,Caleb,3729,0,0,1,1,0.0%,19m
4806,2,SUCCESS,3728,262,14,19,33,42.4%,37m
4806,3,iMagination,3728,121,3,1,4,75.0%,18m
4806,2,Petrox,3728,64,2,4,6,33.3%,39m
4806,2,[FxB]MaeFire,3728,30,1,2,3,33.3%,29m
4806,3,NeoN,3728,0,0,1,1,0.0%,3m
4811,2,Ranran,3727,1397,309,243,552,56.0%,2h
4811,2,[RTN]FireFerret,3727,1557,228,219,447,51.0%,22m
4811,1,[xSYNx]Impaler,3727,1723,107,107,214,50.0%,20m
4811,2,Nova,3727,354,16,9,25,64.0%,27m
4811,2,BoogerSugar,3727,144,8,13,21,38.1%,26m
4811,2,BLADE,3727,0,3,2,5,60.0%,36m
4811,2,Trakia,3727,0,0,1,1,0.0%,26m
4818,2,JustChill,3726,1607,117,114,231,50.6%,4m
4818,2,Amouri,3726,1156,58,44,102,56.9%,35m
4818,2,MithrandiR,3726,30,2,1,3,66.7%,34m
4818,2,Neutrino,3726,30,2,3,5,40.0%,9m
4818,2,[NPhasA]Viral,3726,18,1,3,4,25.0%,2h
4818,2,[Phill]MethEyes,3726,0,0,1,1,0.0%,17m
4818,1,[tTZz]InitialLiMiT,3726,0,0,1,1,0.0%,27m
4818,2,[DRONGO]FirSTBloOD,3726,0,0,4,4,0.0%,31m
4826,1,[BioTek]JALNARE,3725,1791,135,136,271,49.8%,14m
4826,1,[KGH4]Wanted,3725,1525,89,80,169,52.7%,13m
4826,2,[GOPERÚ]AyaxFenix,3725,1105,64,59,123,52.0%,24m
4826,2,Hahahahaha,3725,1436,56,56,112,50.0%,17m
4826,2,Tachibana,3725,616,22,24,46,47.8%,21m
4826,1,LDraGo,3725,0,2,3,5,40.0%,18m
4826,2,[eX]TerminatoR,3725,0,0,1,1,0.0%,12m
4833,2,person,3724,1482,59,55,114,51.8%,22m
4833,2,Garfield,3724,530,20,26,46,43.5%,7m
4833,2,ZhULDeaR,3724,112,7,0,7,100.0%,12m
4833,2,[sa1t]BigFungus,3724,148,6,7,13,46.2%,35m
4833,2,Arteriuz,3724,120,5,3,8,62.5%,37m
4833,2,Cruser,3724,90,4,2,6,66.7%,36m
4833,2,Serg,3724,0,0,1,1,0.0%,16m
4840,1,SuperMan,3723,1822,239,227,466,51.3%,25m
4840,2,[Kood]Masaru,3723,1591,164,165,329,49.8%,35m
4840,2,bigdaddy,3723,761,107,103,210,51.0%,37m
4840,2,[ChfSho]Gunjamma,3723,1574,93,80,173,53.8%,28m
4840,2,[InGt]Agahnim,3723,1496,57,59,116,49.1%,9m
4840,2,omne,3723,1288,56,51,107,52.3%,35m
4840,2,[CHOLOS]NathrezimGG,3723,549,44,45,89,49.4%,14m
4840,2,FachoPobre,3723,931,37,32,69,53.6%,25m
4840,2,Shoren,3723,484,30,29,59,50.8%,28m
4840,2,[SMB]WEALTH,3723,319,24,23,47,51.1%,11m
4840,3,TerranStrAt,3723,248,11,12,23,47.8%,3m
4840,2,rafapras,3723,30,1,2,3,33.3%,37m
4840,2,Oreo,3723,0,0,3,3,0.0%,28m
4853,2,[SsaYnS]Sleeky,3722,947,62,54,116,53.4%,20m
4853,2,Incens,3722,1054,38,42,80,47.5%,31m
4853,2,blackshine,3722,218,13,1,14,92.9%,23m
4853,2,wujiang,3722,58,3,1,4,75.0%,23m
4853,2,[2faded]Random,3722,0,1,0,1,100.0%,25m
4853,2,[TK]Touche,3722,30,1,2,3,33.3%,31m
4853,2,XSAGITTARUSX,3722,36,1,4,5,20.0%,27m
4853,2,[ValidG]Kwas,3722,0,0,2,2,0.0%,35m
4861,1,xsmoothx,3721,1888,167,176,343,48.7%,20m
4861,2,CCCPPutin,3721,329,56,62,118,47.5%,28m
4861,1,[T1T5]MarineQueen,3721,431,11,24,35,31.4%,38m
4861,2,Azurebysean,3721,144,6,1,7,85.7%,18m
4861,2,Destrous,3721,86,3,1,4,75.0%,6m
4866,1,GPN,3720,1365,67,76,143,46.9%,19m
4866,2,Awol,3720,671,53,41,94,56.4%,24m
4866,2,llllllllllll,3720,154,6,8,14,42.9%,35m
4866,2,classic,3720,92,4,6,10,40.0%,10m
4866,2,[1E100]Vauxhall,3720,86,3,4,7,42.9%,9m
4866,2,TaNk,3720,0,1,1,2,50.0%,23m
4872,2,Cassiano,3719,1373,69,65,134,51.5%,40m
4872,2,LsVtec,3719,912,34,28,62,54.8%,2h
4872,2,Ftwomove,3719,185,15,22,37,40.5%,29m
4872,2,[TCity]BigMac,3719,355,13,6,19,68.4%,6m
4872,2,[NwAs]Judith,3719,122,4,4,8,50.0%,2h
4872,2,PhoenixArch,3719,0,0,2,2,0.0%,35m
4878,1,[NPhase]Bigblue,3718,1859,551,565,1116,49.4%,19m
4878,2,[SUKKME]PooButt,3718,1590,369,362,731,50.5%,14m
4878,2,balzac,3718,1001,170,166,336,50.6%,23m
4878,2,[Macac0]NANDO,3718,1447,77,61,138,55.8%,9m
4878,2,[LCE]Kageyama,3718,1243,71,10,81,87.7%,10m
4878,2,Brotoss,3718,507,34,20,54,63.0%,31m
4878,3,LockIsLit,3718,299,13,3,16,81.2%,17m
4878,2,[qT314]xXYoLoSwAgXx,3718,202,11,5,16,68.8%,2h
4878,2,[LAAR]Saitama,3718,214,11,10,21,52.4%,26m
4878,2,lIlIlIIIII,3718,230,9,6,15,60.0%,32m
4878,2,[cloudM]Yarters,3718,118,4,6,10,40.0%,40m
4878,2,KriniK,3718,0,1,0,1,100.0%,39m
4878,1,MelonBar,3718,0,1,0,1,100.0%,14m
4878,3,ProtosBOB,3718,0,0,2,2,0.0%,2h
4892,1,MuSSolinIVAN,3717,1880,369,375,744,49.6%,20m
4892,2,Jek,3717,1394,337,295,632,53.3%,40m
4892,2,snotrag,3717,1098,49,30,79,62.0%,27m
4892,2,Oracle,3717,827,39,20,59,66.1%,40m
4892,2,[LCE]JuanManuel,3717,582,22,19,41,53.7%,37m
4892,2,lIlIlIlIlIlI,3717,472,18,16,34,52.9%,30m
4892,2,llllllllllll,3717,378,15,10,25,60.0%,37m
4892,2,LegDay,3717,301,14,7,21,66.7%,24m
4892,3,[PERSIA]King,3717,306,11,2,13,84.6%,17m
4892,2,Caonidayelaj,3717,292,10,11,21,47.6%,26m
4892,3,Ezeze,3717,145,7,2,9,77.8%,6m
4892,2,Spirit,3717,168,6,3,9,66.7%,22m
4892,3,[SC2TH]CheFongWong,3717,0,0,1,1,0.0%,27m
4905,2,PartyPack,3716,1250,91,77,168,54.2%,20m
4905,2,[ZTemp]Whiskers,3716,669,77,58,135,57.0%,6m
4905,1,Einstein,3716,1183,36,44,80,45.0%,10m
4905,2,[MBQ]BoukarDiouf,3716,352,13,14,27,48.1%,6m
4905,2,[neuroW]Szerspliex,3716,0,0,1,1,0.0%,25m
4910,1,Alucard,3715,915,81,72,153,52.9%,9m
4910,2,malsem,3715,1297,67,60,127,52.8%,26m
4910,2,trololololol,3715,1442,56,55,111,50.5%,27m
4910,2,FroggyStylez,3715,364,14,16,30,46.7%,18m
4910,2,saVer,3715,186,10,3,13,76.9%,40m
4910,2,ChilmRichald,3715,88,4,5,9,44.4%,40m
4910,2,[FateTw]Chance,3715,60,3,6,9,33.3%,30m
4910,2,karatekid,3715,58,2,2,4,50.0%,14m
4918,2,ReallyManny,3714,1589,238,203,441,54.0%,4m
4918,2,[αXLa]HASSEBOSSE,3714,1583,101,104,205,49.3%,22m
4918,2,Sun,3714,1048,52,42,94,55.3%,10m
4918,1,Wai,3714,1235,51,67,118,43.2%,33m
4918,2,plateau,3714,0,1,0,1,100.0%,13m
4923,1,[H8T3D]zerg,3713,1785,87,100,187,46.5%,40m
4923,1,[LgnTDS]Demosthenes,3713,1691,75,77,152,49.3%,27m
4923,2,gTimes,3713,341,61,61,122,50.0%,25m
4923,2,Treven,3713,1110,40,45,85,47.1%,34m
4923,2,boisk,3713,585,29,30,59,49.2%,26m
4928,1,Great,3712,1520,81,83,164,49.4%,23m
4928,2,Zek,3712,675,45,36,81,55.6%,37m
4928,2,[TMGSC]DoctorSmurf,3712,573,25,25,50,50.0%,37m
4928,2,[lLiTl]Paco,3712,588,21,27,48,43.8%,40m
4932,2,Wesley,3711,1597,156,153,309,50.5%,37m
4932,2,Ares,3711,1549,75,75,150,50.0%,28m
4932,2,GLYDE,3711,1501,70,59,129,54.3%,40m
4932,2,[DarkAG]ClashRoyale,3711,1342,61,43,104,58.7%,28m
4932,2,[ØÛ]ILuvatar,3711,996,47,37,84,56.0%,23m
4932,2,[m0ld]Mick,3711,780,32,20,52,61.5%,40m
4932,2,[ArGNA]YaNaRion,3711,174,6,6,12,50.0%,22m
4932,2,[EvilPe]KaEL,3711,124,5,5,10,50.0%,9m
4932,2,Computer,3711,128,4,6,10,40.0%,25m
4932,2,Nyarlathotep,3711,60,3,3,6,50.0%,6m
4932,2,Burbn,3711,0,1,0,1,100.0%,20m
4932,3,EdvanSchleck,3711,0,0,1,1,0.0%,34m
4944,2,[m8z]Clips,3710,1442,161,149,310,51.9%,30m
4944,2,[UcHa]DarkDestiny,3710,1568,134,112,246,54.5%,23m
4944,2,Chocolate,3710,1619,118,98,216,54.6%,40m
4944,2,IIIIIIIIIIII,3710,377,20,7,27,74.1%,6m
4944,2,Ogi,3710,30,2,1,3,66.7%,13m
4944,2,[RolFac]FireStarter,3710,28,2,3,5,40.0%,39m
4944,2,Shallow,3710,30,1,2,3,33.3%,4m
4944,2,madoka,3710,0,0,1,1,0.0%,36m
4944,2,mkkingtiger,3710,0,0,4,4,0.0%,23m
4953,2,MicroJFox,3709,397,31,21,52,59.6%,18m
4953,3,BigHomieDave,3709,136,9,3,12,75.0%,37m
4953,2,dawn,3709,60,3,2,5,60.0%,35m
4953,3,MorganWallen,3709,0,0,1,1,0.0%,6m
4957,1,DeathAndPain,3708,1761,178,191,369,48.2%,6m
4957,2,HiThere,3708,1490,171,141,312,54.8%,9m
4957,2,[TSØP]CarpeDiem,3708,885,80,76,156,51.3%,8m
4957,2,[SVY]GHOSTMARINE,3708,648,24,20,44,54.5%,10m
4957,2,bearbear,3708,0,1,0,1,100.0%,3m
4957,2,Summer,3708,0,1,1,2,50.0%,36m
4957,2,[143s4]RKL,3708,0,0,1,1,0.0%,38m
4964,2,Merlin,3707,1103,80,73,153,52.3%,36m
4964,2,Brutality,3707,596,76,62,138,55.1%,6m
4964,2,Ratar,3707,580,21,23,44,47.7%,25m
4964,2,MattiCk,3707,452,17,19,36,47.2%,35m
4964,2,DarkZero,3707,400,16,14,30,53.3%,7m
4964,2,kaymord,3707,370,15,12,27,55.6%,18m
4964,2,[PSlSTC]brololo,3707,326,12,13,25,48.0%,4m
4964,2,GNR,3707,318,11,12,23,47.8%,6m
4964,2,[potle]seoulja,3707,30,2,0,2,100.0%,32m
4973,2,[grity]Acerbic,3706,1255,91,80,171,53.2%,37m
4973,1,[DarkAG]OmegaStar,3706,1826,78,93,171,45.6%,11m
4973,2,Heeebstah,3706,263,25,13,38,65.8%,2h
4973,2,Killing,3706,506,23,11,34,67.6%,25m
4973,2,[cfaftw]Pheo,3706,458,17,19,36,47.2%,8m
4973,2,[LQV]Exo,3706,238,8,8,16,50.0%,35m
4973,2,IIIIIIIIIIII,3706,30,2,1,3,66.7%,14m
4973,3,RIPhairline,3706,60,2,3,5,40.0%,15m
4973,2,[KingSC]Gonsu,3706,0,1,1,2,50.0%,2h
4973,2,Mumble,3706,30,1,1,2,50.0%,35m
4973,2,Sublux,3706,0,0,5,5,0.0%,22m
4984,1,[DoNai]corn,3705,1688,174,164,338,51.5%,30m
4984,2,[PROCK]Zazu,3705,1310,166,158,324,51.2%,37m
4984,2,TheScientist,3705,1444,155,148,303,51.2%,26m
4984,2,HalfMoon,3705,532,118,88,206,57.3%,33m
4984,2,loserian,3705,949,49,48,97,50.5%,14m
4984,2,Hoskyhosk,3705,1078,41,39,80,51.2%,13m
4984,2,[GØSU]arT,3705,270,10,4,14,71.4%,32m
4991,2,szztz,3704,850,93,57,150,62.0%,2h
4991,2,[TxT]DEW,3704,1570,60,63,123,48.8%,30m
4991,2,[YE71]aYawningLion,3704,914,34,34,68,50.0%,11m
4991,2,[S1Dr]thorshammer,3704,479,17,22,39,43.6%,11m
4991,2,adamsun,3704,438,14,22,36,38.9%,18m
4991,2,Zelkonar,3704,254,9,6,15,60.0%,6m
4991,2,[PLEBZZ]CobbleStone,3704,192,8,2,10,80.0%,28m
4991,2,GuetusS,3704,0,0,1,1,0.0%,39m
4999,2,[HYPTRN]SirSkyguy,3703,1144,44,42,86,51.2%,26m
4999,2,[UpeV]Garule,3703,324,16,3,19,84.2%,25m
4999,2,IIIIIIIIIIII,3703,166,10,1,11,90.9%,36m
4999,2,[TPGGXD]DANI,3703,218,9,6,15,60.0%,27m
4999,2,[Lp]AlejandroMVP,3703,114,4,3,7,57.1%,30m
4999,2,[SFG]Mavick,3703,0,1,0,1,100.0%,27m
5005,1,GranFromage,3702,1205,42,41,83,50.6%,10m
5005,2,[TGosuD]Jacob,3702,860,30,36,66,45.5%,8m
5005,2,INFINITY,3702,616,21,30,51,41.2%,8m
5005,2,ReDiBuLouS,3702,426,16,16,32,50.0%,20m
5005,2,Hestheone,3702,201,13,5,18,72.2%,26m
5005,2,Lypsa,3702,240,10,12,22,45.5%,14m
5005,2,Friskyqt,3702,190,9,4,13,69.2%,3m
5005,2,FLOSAN,3702,242,9,5,14,64.3%,20m
5005,2,[DASUL]Durden,3702,0,1,0,1,100.0%,18m
5014,2,[SoloAs]SoloNature,3701,1084,86,73,159,54.1%,7m
5014,2,BehHa,3701,968,39,35,74,52.7%,9m
5014,1,Zerasmasher,3701,947,29,39,68,42.6%,39m
5014,2,stone,3701,682,25,26,51,49.0%,18m
5014,2,[Fkng]Weeb,3701,508,22,22,44,50.0%,8m
5014,2,Brittany,3701,171,22,24,46,47.8%,22m
5014,2,[SuperZ]HAL,3701,120,6,6,12,50.0%,4m
5014,2,azerty,3701,0,1,0,1,100.0%,32m
5014,2,BossToss,3701,0,1,3,4,25.0%,35m
5014,2,[ZTemp]Flare,3701,0,1,7,8,12.5%,8m
5014,2,TerranOP,3701,0,0,1,1,0.0%,11m
5014,2,LetsGo,3701,0,0,1,1,0.0%,12m
5026,2,Whisky,3700,1140,45,39,84,53.6%,36m
5026,2,Valgard,3700,684,27,21,48,56.2%,24m
5026,2,chedarface,3700,668,24,24,48,50.0%,36m
5026,3,[αXLa]Deklan,3700,30,5,43,48,10.4%,14m
5026,2,[BoAVN]TUI,3700,30,2,0,2,100.0%,28m
5026,2,[LgnTDS]Yeti,3700,34,2,2,4,50.0%,7m
5026,2,[DhZPro]Paiva,3700,32,1,1,2,50.0%,17m
5026,2,[RIPOU]Matroide,3700,0,1,6,7,14.3%,20m
5034,2,nick,3699,0,1,0,1,100.0%,29m
5034,2,Arleos,3699,0,0,1,1,0.0%,20m
5036,2,Littlelead,3698,862,97,79,176,55.1%,38m
5036,2,[NSKL]Peril,3698,1490,83,64,147,56.5%,8m
5036,2,[Amiwis]dementor,3698,252,10,6,16,62.5%,39m
5036,2,BetaStar,3698,274,10,15,25,40.0%,40m
5036,2,LENNY,3698,150,9,0,9,100.0%,2h
5036,2,ShiaLaBeouf,3698,140,6,1,7,85.7%,10m
5036,2,mouse,3698,99,6,7,13,46.2%,22m
5036,2,Scorpion,3698,58,3,0,3,100.0%,34m
5036,2,[DFK]platypus,3698,0,0,1,1,0.0%,24m
5045,2,[ZTempz]zipper,3697,1610,416,391,807,51.5%,9m
5045,2,[AD3C]Gustoss,3697,1485,143,120,263,54.4%,40m
5045,2,[Italis]CrimsonHalo,3697,1312,79,71,150,52.7%,41m
5045,2,Nomo,3697,1054,47,42,89,52.8%,22m
5045,1,strikeRRose,3697,643,17,28,45,37.8%,11m
5045,2,VoidSeeker,3697,359,14,14,28,50.0%,14m
5045,2,[DontRN]Anunnaki,3697,60,2,1,3,66.7%,25m
5045,2,Bibi,3697,30,2,2,4,50.0%,16m
5045,2,PolarBear,3697,30,2,3,5,40.0%,36m
5045,2,llllllllllll,3697,0,1,0,1,100.0%,24m
5045,2,[iGOSU]Cerealkiller,3697,0,0,1,1,0.0%,29m
5045,2,[Astute]MarcDaGreat,3697,0,0,4,4,0.0%,35m
5057,2,flambourine,3696,1605,795,770,1565,50.8%,18m
5057,2,BadFrog,3696,577,27,14,41,65.9%,5m
5057,2,[GOPERÚ]SamuraiX,3696,446,18,8,26,69.2%,3m
5057,2,Seowal,3696,281,14,10,24,58.3%,35m
5057,2,speaknow,3696,330,13,9,22,59.1%,33m
5057,2,AirGoodman,3696,273,9,6,15,60.0%,20m
5057,1,IIIIIIIIIIII,3696,96,6,0,6,100.0%,2h
5057,2,Joaco,3696,83,3,2,5,60.0%,34m
5057,2,sOul,3696,0,1,0,1,100.0%,38m
5057,2,DarkAngeL,3696,0,1,0,1,100.0%,33m
5057,2,bedintruder,3696,0,0,2,2,0.0%,24m
5068,1,Fenny,3695,1737,252,258,510,49.4%,10m
5068,2,Forgotten,3695,1359,152,131,283,53.7%,23m
5068,2,StrawHat,3695,1500,75,53,128,58.6%,32m
5068,2,LeSorHaiChap,3695,721,35,15,50,70.0%,10m
5068,2,Edomous,3695,346,12,14,26,46.2%,25m
5068,2,[Pharoh]Intuition,3695,92,3,7,10,30.0%,6m
5068,2,TheOracle,3695,0,0,1,1,0.0%,25m
5068,2,Turtle,3695,0,0,1,1,0.0%,6m
5068,2,[NwAs]Gonzalo,3695,0,0,2,2,0.0%,30m
5077,2,[UCD]AgCl,3694,1592,552,564,1116,49.5%,25m
5077,2,[Emb3rs]Cryptz,3694,1526,222,215,437,50.8%,39m
5077,2,[DjKiwi]christianewi,3694,1596,182,163,345,52.8%,18m
5077,1,DamageINC,3694,1837,140,129,269,52.0%,23m
5077,2,Synergy,3694,1589,89,85,174,51.1%,33m
5077,2,[NPhase]prokiller,3694,1597,88,82,170,51.8%,34m
5077,2,RickSanchez,3694,1571,72,73,145,49.7%,24m
5077,2,[SsaYnS]KanyeEast,3694,698,43,36,79,54.4%,30m
5077,2,[APOLLO]TitanEOF,3694,454,15,22,37,40.5%,40m
5077,2,[PzC]SiNk,3694,272,9,14,23,39.1%,36m
5077,2,akenaton,3694,52,5,9,14,35.7%,14m
5077,2,Illidan,3694,30,2,6,8,25.0%,22m
5089,2,Acor,3693,1606,440,429,869,50.6%,38m
5089,2,AntonSlavik,3693,1344,93,82,175,53.1%,25m
5089,2,[LgnTDS]Acheron,3693,1613,66,55,121,54.5%,27m
5089,2,INnovation,3693,214,8,10,18,44.4%,40m
5089,2,[RLR2]valithor,3693,144,6,4,10,60.0%,26m
5094,2,[Togata]Mirio,3692,783,135,130,265,50.9%,30m
5094,2,[TeamUR]LostFafa,3692,741,66,78,144,45.8%,14m
5094,2,[MadK]ChikeN,3692,1030,65,75,140,46.4%,34m
5094,2,coco,3692,1605,63,57,120,52.5%,30m
5094,2,[TXOP]CorvoIIV,3692,854,34,29,63,54.0%,24m
5094,2,pinkpalm,3692,422,24,23,47,51.1%,41m
5094,2,[P3ru96]LunaLee,3692,158,6,3,9,66.7%,17m
5094,2,[SC2BOL]TinchO,3692,0,1,0,1,100.0%,17m
5094,2,[llIII]Probius,3692,0,1,1,2,50.0%,23m
5094,2,[ArGNA]universe,3692,73,0,4,4,0.0%,5m
5104,2,IlIlIlIIlIlI,3691,1596,125,117,242,51.7%,40m
5104,2,Dogen,3691,1543,73,78,151,48.3%,8m
5104,2,Chuckycheese,3691,357,51,53,104,49.0%,14m
5104,2,[143s4]Wenoice,3691,700,32,31,63,50.8%,33m
5104,2,Optimize,3691,497,28,29,57,49.1%,14m
5104,2,Bibimbap,3691,436,18,7,25,72.0%,22m
5104,2,BubblerBox,3691,376,15,11,26,57.7%,30m
5104,2,meva,3691,267,12,3,15,80.0%,10m
5104,2,[MSet]Disaster,3691,139,9,7,16,56.2%,30m
5104,3,AfreecaStats,3691,142,8,1,9,88.9%,6m
5104,2,Ceasar,3691,60,3,5,8,37.5%,39m
5115,1,[HEWITT]ChrisJudd,3690,975,28,35,63,44.4%,25m
5115,2,[LTlord]HermeScLL,3690,641,25,20,45,55.6%,20m
5115,2,AgentSquall,3690,0,1,0,1,100.0%,32m
5115,2,DaviX,3690,0,0,1,1,0.0%,35m
5119,2,TheUndermind,3689,1141,53,49,102,52.0%,30m
5119,2,theredone,3689,898,35,32,67,52.2%,11m
5119,3,[Wafflz]Waffelz,3689,370,17,3,20,85.0%,26m
5119,2,Quarantine,3689,330,13,10,23,56.5%,22m
5119,1,NaClFactory,3689,119,3,0,3,100.0%,38m
5119,2,SaLT,3689,0,2,3,5,40.0%,34m
5119,2,IIIIIIIIIIII,3689,0,1,1,2,50.0%,23m
5126,2,CurrentFlow,3688,1572,229,228,457,50.1%,27m
5126,2,chillybilly,3688,1207,62,40,102,60.8%,6m
5126,2,SpeCial,3688,320,12,14,26,46.2%,8m
5126,1,[imProV]Sioh,3688,142,7,1,8,87.5%,18m
5126,2,Droptuned,3688,178,6,7,13,46.2%,5m
5126,2,[Flam3s]WwWwWwWwWwWw,3688,128,4,15,19,21.1%,35m
5126,2,[LPDeTV]DieGGoth,3688,58,2,3,5,40.0%,23m
5133,2,xoxoDaddy,3687,1583,110,98,208,52.9%,39m
5133,2,TalonTromper,3687,0,1,0,1,100.0%,37m
5133,2,IDKFA,3687,0,0,1,1,0.0%,20m
5133,2,Dresden,3687,0,0,1,1,0.0%,20m
5137,2,BlueCat,3686,1418,161,151,312,51.6%,22m
5137,2,AuTisToss,3686,1515,89,71,160,55.6%,10m
5137,2,[PVZ5o]CourtGentry,3686,270,8,9,17,47.1%,30m
5137,2,ThehiddenOne,3686,60,7,1,8,87.5%,34m
5137,2,MechItHappen,3686,48,6,0,6,100.0%,14m
5137,2,HiWoxs,3686,60,2,9,11,18.2%,34m
5137,3,[nG]PerfectPlay,3686,30,1,8,9,11.1%,10m
5137,2,[UMCP]Sports,3686,0,0,1,1,0.0%,26m
5145,1,[LgnTDS]IIIITesta,3685,1848,918,916,1834,50.1%,11m
5145,2,Majento,3685,1369,100,100,200,50.0%,34m
5145,2,[SRT4]Starfire,3685,928,48,38,86,55.8%,9m
5145,2,[WNTRLY]Asacoco,3685,513,38,16,54,70.4%,37m
5145,2,ssjsc,3685,762,29,27,56,51.8%,20m
5145,1,[xLgNx]FrancoChavez,3685,698,18,33,51,35.3%,40m
5145,2,[PHIL]Sluckedup,3685,462,17,17,34,50.0%,26m
5145,2,SeanBean,3685,360,14,12,26,53.8%,20m
5145,2,ThepacmaN,3685,265,8,5,13,61.5%,35m
5145,1,Original,3685,210,6,2,8,75.0%,31m
5145,2,Riski,3685,0,5,0,5,100.0%,12m
5145,2,[HYXJM]MGJTerran,3685,0,0,1,1,0.0%,17m
5157,2,Cuberna,3684,1570,186,173,359,51.8%,30m
5157,1,Chrysalis,3684,1638,157,152,309,50.8%,37m
5157,2,GuapoWen,3684,356,69,68,137,50.4%,34m
5157,2,[GØSU]Tect,3684,1192,47,46,93,50.5%,6m
5157,2,tmog,3684,348,13,13,26,50.0%,26m
5157,2,[KTFBRO]HyanGToSS,3684,310,12,12,24,50.0%,25m
5157,2,Nicon,3684,276,11,6,17,64.7%,14m
5157,2,Malloy,3684,0,4,3,7,57.1%,28m
5165,2,REDENTOR,3683,1597,804,781,1585,50.7%,33m
5165,2,[SsaYnS]Clairvoyance,3683,120,5,3,8,62.5%,29m
5165,2,Lantzuh,3683,0,3,2,5,60.0%,12m
5165,2,SeobSeob,3683,0,0,2,2,0.0%,39m
5169,2,Nimjox,3682,1517,213,182,395,53.9%,40m
5169,2,[juggr]LunarSC,3682,506,20,13,33,60.6%,20m
5169,2,llllllllll,3682,254,8,3,11,72.7%,18m
5169,3,llllllllllll,3682,193,6,0,6,100.0%,27m
5169,2,mesh,3682,30,2,5,7,28.6%,6m
5169,2,gggggeee,3682,30,1,3,4,25.0%,31m
5169,3,LuckyStrike,3682,30,1,3,4,25.0%,9m
5176,1,Daja,3681,1790,356,342,698,51.0%,39m
5176,2,AzureMaster,3681,319,14,6,20,70.0%,40m
5176,2,nephilim,3681,174,7,5,12,58.3%,30m
5176,2,JoDuck,3681,0,0,1,1,0.0%,40m
5176,2,[YBOR]Goliath,3681,0,0,3,3,0.0%,10m
5181,1,SoLidRoarCab,3680,1726,310,303,613,50.6%,10m
5181,2,Antone,3680,1600,309,281,590,52.4%,15m
5181,2,minidaddy,3680,1544,136,130,266,51.1%,35m
5181,2,CookieWizard,3680,536,64,51,115,55.7%,7m
5181,1,[Cryptc]RainbowDash,3680,1444,43,70,113,38.1%,20m
5181,2,felpy,3680,273,16,10,26,61.5%,26m
5181,2,Monster,3680,262,11,4,15,73.3%,10m
5181,2,[Ris3n]fshhsdhf,3680,270,11,5,16,68.8%,35m
5181,2,[TM]KirA,3680,154,5,10,15,33.3%,18m
5181,2,Player,3680,0,1,0,1,100.0%,26m
5181,2,[GBros]Feisty,3680,0,0,2,2,0.0%,7m
5192,2,IIIlIlIIIIIl,3679,719,62,22,84,73.8%,36m
5192,2,DerpHerder,3679,325,15,13,28,53.6%,10m
5192,2,[TXOP]Zerolf,3679,216,9,4,13,69.2%,12m
5192,2,BAHOZ,3679,140,8,5,13,61.5%,37m
5192,3,Rockstar,3679,184,6,1,7,85.7%,32m
5192,2,bob,3679,0,1,1,2,50.0%,9m
5198,1,icarusmaeser,3678,1806,427,398,825,51.8%,20m
5198,2,xProper,3678,894,262,258,520,50.4%,25m
5198,2,[E04]GhOsT,3678,419,17,18,35,48.6%,11m
5198,2,IIIIIIIIIIII,3678,164,9,2,11,81.8%,30m
5198,2,Zaphyrae,3678,0,1,2,3,33.3%,18m
5203,2,Bernie,3677,509,131,129,260,50.4%,14m
5203,2,[xTQc]FiNiTioN,3677,1225,60,56,116,51.7%,20m
5203,2,Rune,3677,226,9,6,15,60.0%,9m
5203,2,MetalStorm,3677,180,6,9,15,40.0%,22m
5203,2,jon,3677,188,6,9,15,40.0%,25m
5203,2,PESCA,3677,156,5,10,15,33.3%,6m
5203,2,TigerYao,3677,114,4,1,5,80.0%,24m
5203,2,LivingbyFace,3677,0,1,0,1,100.0%,5m
5203,2,[MD]Grinz,3677,0,0,1,1,0.0%,38m
5212,2,Freyr,3676,1689,193,178,371,52.0%,15m
5212,2,[1SBT1]Marcotte,3676,1146,74,74,148,50.0%,9m
5212,2,InsungMungae,3676,857,50,25,75,66.7%,37m
5212,2,ZogginAround,3676,339,14,16,30,46.7%,33m
5212,2,[AthSun]SUPERTOY,3676,118,4,6,10,40.0%,24m
5212,2,Mimir,3676,0,1,0,1,100.0%,26m
5212,1,[ELE]Arbitorm,3676,0,1,1,2,50.0%,27m
5212,1,llllllllllll,3676,42,1,12,13,7.7%,20m
5212,2,DeadGame,3676,0,0,1,1,0.0%,30m
5221,1,[SsaYnS]NoGSLForYou,3675,1760,343,330,673,51.0%,36m
5221,2,[XHB]SSB,3675,1463,88,68,156,56.4%,34m
5221,2,[TGosuC]gonjareya,3675,1492,76,73,149,51.0%,18m
5221,2,[GamCub]Jean,3675,783,56,62,118,47.5%,25m
5221,2,[cl0udM]OldFashion,3675,466,20,10,30,66.7%,28m
5221,2,Probe,3675,272,11,1,12,91.7%,33m
5221,2,[DBSQ]iMacro,3675,252,11,7,18,61.1%,23m
5221,2,SpaceKitsune,3675,30,2,2,4,50.0%,40m
5221,2,MezjE,3675,0,0,1,1,0.0%,29m
5221,2,Absolution,3675,0,0,5,5,0.0%,5m
5231,2,StroWilD,3674,1597,253,239,492,51.4%,40m
5231,2,[UpeV]AtoM,3674,1354,60,51,111,54.1%,25m
5231,2,Dave,3674,1286,53,51,104,51.0%,2h
5231,2,super,3674,853,37,22,59,62.7%,13m
5231,2,GokuJonnie,3674,656,25,23,48,52.1%,33m
5231,2,XNA,3674,561,24,30,54,44.4%,24m
5231,2,WCG,3674,88,4,1,5,80.0%,30m
5231,2,DarkKnight,3674,60,2,2,4,50.0%,39m
5231,2,Frost,3674,112,2,5,7,28.6%,30m
5231,2,AndyPandy,3674,34,1,4,5,20.0%,28m
5231,2,[GØSU]PAYBACKsmj,3674,0,0,1,1,0.0%,23m
5242,2,[hfUce]Maestro,3673,1030,104,106,210,49.5%,8m
5242,2,amwayking,3673,1146,49,38,87,56.3%,28m
5242,2,PapayaNuts,3673,428,17,11,28,60.7%,28m
5242,3,WingsOfFire,3673,143,3,1,4,75.0%,32m
5242,1,[LOPELU]KriXuS,3673,48,2,1,3,66.7%,27m
5242,2,TurdSandwich,3673,0,1,0,1,100.0%,4m
5248,2,June,3672,671,33,18,51,64.7%,12m
5248,2,Chronos,3672,496,22,15,37,59.5%,4m
5248,2,[REKTQQ]Bloodjer,3672,58,2,1,3,66.7%,40m
5248,3,[Mines]Beatyourmeat,3672,30,2,3,5,40.0%,15m
5248,3,Boon,3672,0,0,2,2,0.0%,18m
5253,2,Terminator,3671,1381,58,45,103,56.3%,30m
5253,2,LaurenWitzke,3671,886,37,26,63,58.7%,17m
5253,2,SCHardNips,3671,806,35,31,66,53.0%,39m
5253,2,duke,3671,60,3,5,8,37.5%,5m
5253,2,Nobless,3671,30,2,2,4,50.0%,6m
5253,2,OZero,3671,64,2,4,6,33.3%,17m
5253,2,Peter,3671,0,1,0,1,100.0%,37m
5253,2,[D5FTWA]Mojojo,3671,0,0,1,1,0.0%,4m
5261,2,[cnboys]Xlonen,3670,1571,267,247,514,51.9%,40m
5261,2,fishninja,3670,1143,124,126,250,49.6%,30m
5261,2,Jolehot,3670,1559,121,118,239,50.6%,8m
5261,2,muriden,3670,540,29,20,49,59.2%,40m
5261,2,[YSP]WhaleHunter,3670,628,24,17,41,58.5%,28m
5261,2,llllllllllll,3670,374,13,16,29,44.8%,15m
5261,3,Poysian,3670,293,12,2,14,85.7%,19m
5261,2,[NubTos]MystP,3670,312,11,12,23,47.8%,40m
5261,2,[ggzvz]llllllllllll,3670,0,3,4,7,42.9%,30m
5261,2,IIIIIIIIIII,3670,30,1,2,3,33.3%,37m
5261,2,[UpeV]Kvothe,3670,0,0,6,6,0.0%,13m
5272,2,TeChNo,3669,1571,175,161,336,52.1%,30m
5272,2,QTIP,3669,622,75,69,144,52.1%,22m
5272,2,[CS0]Samwise,3669,834,61,57,118,51.7%,14m
5272,2,teachMe,3669,1209,54,34,88,61.4%,24m
5272,2,Therapist,3669,840,29,36,65,44.6%,25m
5272,2,AppleTV,3669,568,19,30,49,38.8%,36m
5272,2,[TeeHC]TopHat,3669,280,11,8,19,57.9%,40m
5272,1,[UNCCH]BLACKSPACE,3669,0,1,0,1,100.0%,4m
5272,2,Anarchy,3669,0,1,1,2,50.0%,26m
5272,3,[IL1]Mango,3669,30,1,2,3,33.3%,35m
5272,2,JanoyCresva,3669,30,1,3,4,25.0%,14m
5272,2,[REPORT]MindGamer,3669,0,0,3,3,0.0%,5m
5284,2,Landrew,3668,1589,112,100,212,52.8%,5m
5284,2,Axon,3668,1197,68,50,118,57.6%,5m
5284,2,Squirrel,3668,1539,68,56,124,54.8%,33m
5284,2,Cosmicstorm,3668,1054,37,43,80,46.2%,29m
5284,2,Maru,3668,0,5,0,5,100.0%,6m
5284,2,Kama,3668,114,5,1,6,83.3%,37m
5284,2,[ThNtS]MedScape,3668,58,3,2,5,60.0%,6m
5284,1,[BLMBLM]Justice,3668,97,1,1,2,50.0%,30m
5284,2,Alive,3668,0,0,1,1,0.0%,26m
5293,2,Awdle,3667,1485,130,125,255,51.0%,8m
5293,2,Nachtigallen,3667,1288,115,98,213,54.0%,34m
5293,2,[Deathn]DestinyKid,3667,1199,67,51,118,56.8%,28m
5293,2,[UpxV]ObErIn,3667,272,10,3,13,76.9%,6m
5297,2,Linker,3666,930,110,78,188,58.5%,7m
5297,2,Szczecin,3666,1200,56,55,111,50.5%,14m
5297,2,Jocker,3666,1157,55,34,89,61.8%,17m
5297,2,[Akita]CultOfCroft,3666,318,46,27,73,63.0%,24m
5297,2,ZergPro,3666,302,13,7,20,65.0%,30m
5297,2,iLeo,3666,324,11,11,22,50.0%,20m
5297,2,[PwF]PwFGroet,3666,0,5,0,5,100.0%,6m
5297,2,[GGxC]NissanZOwner,3666,146,5,5,10,50.0%,6m
5297,2,deZ,3666,152,5,7,12,41.7%,16m
5297,2,YenrabGnow,3666,0,1,0,1,100.0%,6m
5297,2,Nacho,3666,30,1,1,2,50.0%,37m
5297,2,SirCoOkie,3666,30,1,1,2,50.0%,28m
5309,2,[FxB]Squirrely,3665,1618,300,292,592,50.7%,20m
5309,2,[RUMB]SwiftDeath,3665,1611,100,80,180,55.6%,17m
5309,2,Singularity,3665,805,64,67,131,48.9%,17m
5309,2,PROXY,3665,265,58,53,111,52.3%,35m
5309,2,Barcode,3665,1107,51,29,80,63.8%,24m
5309,2,[ØÛ]Apocalipthos,3665,564,22,18,40,55.0%,36m
5309,2,DuffMcWhalen,3665,30,6,0,6,100.0%,12m
5309,2,Boatman,3665,30,6,0,6,100.0%,30m
5309,2,[INextI]Itzcoatl,3665,146,5,9,14,35.7%,12m
5309,2,[MirG]HeaT,3665,30,1,6,7,14.3%,13m
5319,2,[TBTG]glaba,3664,939,147,130,277,53.1%,35m
5319,2,SIA,3664,1393,112,87,199,56.3%,33m
5319,2,Atticus,3664,1095,44,43,87,50.6%,41m
5319,2,[ScSwrm]Coleslaw,3664,656,26,18,44,59.1%,20m
5319,2,NukeChina,3664,96,3,3,6,50.0%,18m
5319,2,[TaRus]PakCha,3664,0,0,1,1,0.0%,34m
5325,2,[KrUs]Dcha,3663,849,37,22,59,62.7%,36m
5325,2,[BIGMAN]Mike,3663,537,26,27,53,49.1%,2h
5325,2,Sweetie,3663,512,24,13,37,64.9%,32m
5325,2,SMOOTHBRAIN,3663,272,11,5,16,68.8%,33m
5325,2,[Shardz]ThatOneDude,3663,292,10,8,18,55.6%,27m
5325,2,Nightstalker,3663,202,8,6,14,57.1%,28m
5325,2,[TLibre]dbarreda,3663,0,1,0,1,100.0%,7m
5325,2,infernoboss,3663,0,1,0,1,100.0%,9m
5333,2,[neuroS]Ultrahugs,3662,1231,60,63,123,48.8%,22m
5333,2,[Flume1]FlumeJr,3662,339,18,0,18,100.0%,26m
5333,1,AmericoOlO,3662,138,6,12,18,33.3%,10m
5333,2,[INextI]ELECTRIC,3662,0,0,1,1,0.0%,28m
5337,2,Figurati,3661,1056,174,155,329,52.9%,12m
5337,2,[MluvK]MyBFMadeMe,3661,1564,118,76,194,60.8%,36m
5337,2,Swift,3661,903,96,48,144,66.7%,9m
5337,2,[F1ght]Moony,3661,638,57,52,109,52.3%,35m
5337,2,dink,3661,1433,56,61,117,47.9%,13m
5337,2,[POOiP]DarkArchon,3661,526,34,41,75,45.3%,30m
5337,2,LeftStroke,3661,399,18,10,28,64.3%,35m
5337,3,BlueWarrior,3661,0,1,0,1,100.0%,6m
5337,2,[Sliq]spoopatron,3661,0,1,1,2,50.0%,5m
5337,2,Frosty,3661,0,1,4,5,20.0%,25m
5337,2,[PTHero]BreaDsoButah,3661,0,0,2,2,0.0%,23m
5348,2,lavenderlich,3660,1439,75,63,138,54.3%,10m
5348,2,remainders,3660,1203,68,56,124,54.8%,37m
5348,2,lWorstGodl,3660,1265,68,75,143,47.6%,35m
5348,2,Dasz,3660,1207,60,45,105,57.1%,35m
5348,2,vagabunka,3660,396,14,17,31,45.2%,35m
5348,2,Rosamel,3660,312,12,9,21,57.1%,28m
5348,2,KingOfGods,3660,278,10,13,23,43.5%,33m
5348,2,Apotheosis,3660,260,9,7,16,56.2%,17m
5348,2,ShadowDragon,3660,0,0,1,1,0.0%,12m
5357,2,[Pig2]Psykkoz,3659,807,31,37,68,45.6%,32m
5357,2,Smexi,3659,356,12,19,31,38.7%,40m
5357,2,[TeamUR]Polar,3659,236,8,4,12,66.7%,39m
5357,2,nick,3659,88,3,5,8,37.5%,32m
5361,2,[nieBla]daniov,3658,1599,126,105,231,54.5%,16m
5361,2,VCERUSH,3658,475,23,7,30,76.7%,33m
5361,2,[InGt]Adeptive,3658,476,16,20,36,44.4%,33m
5361,2,oughts,3658,292,15,7,22,68.2%,40m
5361,2,Manimal,3658,42,4,4,8,50.0%,35m
5361,2,[gohchu]yubang,3658,30,2,0,2,100.0%,23m
5361,2,[TgAg]MrDrew,3658,0,1,0,1,100.0%,30m
5361,2,LimYoHwan,3658,30,1,4,5,20.0%,6m
5369,1,wildcard,3657,1286,163,159,322,50.6%,36m
5369,2,[HQ]Hyerquality,3657,592,20,25,45,44.4%,9m
5369,2,[SsaYnS]Javelot,3657,418,15,11,26,57.7%,20m
5369,2,ForcedField,3657,295,11,4,15,73.3%,17m
5369,2,[AthSun]DarkExecutor,3657,126,4,10,14,28.6%,3m
5369,1,AKASD,3657,150,3,3,6,50.0%,13m
5375,2,Arcángel,3656,1421,163,148,311,52.4%,37m
5375,2,ZeNEX,3656,1062,48,48,96,50.0%,37m
5375,1,Giga,3656,705,28,29,57,49.1%,10m
5375,2,DayNine,3656,30,2,2,4,50.0%,30m
5375,2,[GR33D]ShoTwiRe,3656,0,1,0,1,100.0%,5m
5375,2,[Cryptc]SlooTh,3656,34,1,1,2,50.0%,30m
5375,2,CsT,3656,30,1,2,3,33.3%,34m
5375,2,[JaMiT]LVMatterhorn,3656,0,1,4,5,20.0%,18m
5375,2,[GRIMEY]ojams,3656,0,0,1,1,0.0%,35m
5375,2,[Clinic]RonDon,3656,0,0,1,1,0.0%,23m
5375,2,Yoshi,3656,0,0,1,1,0.0%,36m
5375,2,BigBang,3656,0,0,2,2,0.0%,36m
5387,2,QLmindless,3655,960,133,127,260,51.2%,31m
5387,2,Patrick,3655,510,34,29,63,54.0%,30m
5387,3,ilikemen,3655,328,16,0,16,100.0%,32m
5387,2,MapleMan,3655,86,4,1,5,80.0%,26m
5387,2,MacroPhage,3655,30,2,5,7,28.6%,36m
5387,2,[Spe23]Travis,3655,0,1,0,1,100.0%,17m
5387,3,[αB]TheDetweiler,3655,0,0,2,2,0.0%,31m
5394,1,ggg,3654,1165,148,155,303,48.8%,18m
5394,2,[YD2K]MrAverage,3654,1088,104,105,209,49.8%,9m
5394,2,[Whet]CallDown,3654,985,96,92,188,51.1%,17m
5394,2,DDRToss,3654,1171,93,69,162,57.4%,12m
5394,2,xxardacoxx,3654,1562,86,76,162,53.1%,34m
5394,2,AVO,3654,1010,39,36,75,52.0%,12m
5394,2,HungryHippo,3654,453,23,10,33,69.7%,17m
5394,2,vamak,3654,266,10,8,18,55.6%,18m
5394,1,nOus,3654,169,6,10,16,37.5%,5m
5394,2,[LAGTV]alexela,3654,0,0,1,1,0.0%,34m
5404,2,llllllllllll,3653,448,18,21,39,46.2%,25m
5404,3,Frodo,3653,235,12,6,18,66.7%,32m
5404,2,[TGCrew]Function,3653,350,12,15,27,44.4%,41m
5404,2,Rethy,3653,86,8,6,14,57.1%,22m
5404,2,[iMkS]Rorro,3653,90,3,7,10,30.0%,35m
5409,2,[Over1]Manuel,3652,1575,135,128,263,51.3%,35m
5409,2,[D4KSDE]Mauri,3652,1538,118,120,238,49.6%,30m
5409,2,TheFast,3652,862,98,92,190,51.6%,34m
5409,2,Gregarious,3652,746,81,81,162,50.0%,34m
5409,2,TakTix,3652,1118,64,42,106,60.4%,37m
5409,2,[Hplus]Catalytic,3652,874,60,54,114,52.6%,26m
5409,2,bzzzzzzzzzzz,3652,551,36,16,52,69.2%,31m
5409,2,Trout,3652,362,13,13,26,50.0%,24m
5409,2,Majrostyle,3652,222,9,3,12,75.0%,22m
5409,2,pookie,3652,114,4,4,8,50.0%,30m
5409,2,Ghost,3652,58,3,1,4,75.0%,23m
5409,3,JpDestrok,3652,86,3,1,4,75.0%,39m
5409,2,dcmsQuaLL,3652,0,1,0,1,100.0%,6m
5409,2,CoronaShawn,3652,0,0,1,1,0.0%,35m
5409,2,[xnSx]SpkrFrDead,3652,0,0,3,3,0.0%,13m
5409,2,[CG]Homestar,3652,0,0,3,3,0.0%,5m
5425,2,PDPenguin,3651,1559,451,456,907,49.7%,32m
5425,1,[TCD]HabsExecutor,3651,1750,96,104,200,48.0%,41m
5425,2,disruptorOp,3651,831,64,44,108,59.3%,24m
5425,2,[VDNKh]PiScOLeiNs,3651,376,16,5,21,76.2%,30m
5425,2,[ValidG]SpoOky,3651,380,14,16,30,46.7%,12m
5425,2,Apple,3651,255,13,5,18,72.2%,28m
5425,2,llllllllllll,3651,167,9,4,13,69.2%,36m
5425,2,Defhty,3651,30,2,1,3,66.7%,35m
5433,1,delvur,3650,1757,283,315,598,47.3%,6m
5433,2,[INextI]Fenix,3650,1455,122,132,254,48.0%,30m
5433,2,UnaPapusa,3650,1051,44,31,75,58.7%,19m
5433,2,[GEEKED]Artificial,3650,746,27,34,61,44.3%,6m
5433,2,[NDN]Hackanos,3650,291,17,24,41,41.5%,27m
5433,2,LOOTBOX,3650,165,8,1,9,88.9%,34m
5433,2,theplen,3650,86,4,3,7,57.1%,34m
5433,2,[danuts]MNYODA,3650,0,0,4,4,0.0%,2h
5441,2,PussInBoots,3649,1676,241,241,482,50.0%,26m
5441,2,carne,3649,804,182,151,333,54.7%,38m
5441,2,Nosde,3649,368,38,35,73,52.1%,40m
5441,2,NoScared,3649,405,28,8,36,77.8%,22m
5441,2,Admiral,3649,136,8,3,11,72.7%,9m
5441,2,Midas,3649,0,1,1,2,50.0%,37m
5441,2,ChairmanMao,3649,30,1,2,3,33.3%,5m
5448,1,outlier,3648,1789,472,487,959,49.2%,10m
5448,2,Serpentz,3648,1578,239,247,486,49.2%,14m
5448,2,[PTHero]Heen,3648,1340,180,125,305,59.0%,37m
5448,2,Duhrdy,3648,872,128,121,249,51.4%,35m
5448,2,Megaschnell,3648,493,19,12,31,61.3%,8m
5448,2,laidianqi,3648,306,12,7,19,63.2%,17m
5448,2,[SC2IDN]Jangbingo,3648,176,6,4,10,60.0%,21m
5448,3,[TGCrew]CholmesInk,3648,30,1,1,2,50.0%,18m
5448,2,pzyc,3648,0,0,1,1,0.0%,28m
5457,2,MiDi,3647,1612,162,129,291,55.7%,26m
5457,2,History,3647,800,47,45,92,51.1%,28m
5457,2,Myro,3647,392,15,12,27,55.6%,17m
5457,2,kurama,3647,0,1,2,3,33.3%,5m
5457,2,[EUGGE]AwNotATerran,3647,30,1,2,3,33.3%,5m
5462,2,[EtrOy]lightwolf,3646,1103,58,60,118,49.2%,8m
5462,2,[M32]HOFF,3646,567,46,43,89,51.7%,18m
5462,2,[REPORT]DAYGAMER,3646,750,32,17,49,65.3%,28m
5462,2,[TSgB]BigYeezats,3646,732,28,26,54,51.9%,5m
5462,2,Cheddar,3646,401,19,24,43,44.2%,23m
5462,2,[DkOuT]Anytime,3646,320,12,6,18,66.7%,10m
5462,2,[NODANE]boofberry,3646,130,7,8,15,46.7%,35m
5462,3,[EvilCG]SkrOs,3646,114,5,1,6,83.3%,14m
5462,2,cuBe,3646,86,4,0,4,100.0%,31m
5462,2,[umadID]Boaro,3646,86,3,6,9,33.3%,20m
5462,2,[HALL]SpimanBCrt,3646,0,1,0,1,100.0%,6m
5462,2,[EtrOy]AnloreRH,3646,30,1,1,2,50.0%,37m
5474,2,MMH,3645,682,31,19,50,62.0%,5m
5474,2,Miso,3645,577,25,12,37,67.6%,38m
5474,2,[Cakius]Tavo,3645,213,10,19,29,34.5%,33m
5474,2,Santaclaws,3645,196,8,5,13,61.5%,19m
5474,2,Bchong,3645,142,6,3,9,66.7%,33m
5474,2,VelKro,3645,60,2,3,5,40.0%,17m
5474,2,Sparkly,3645,0,1,0,1,100.0%,19m
5474,2,[Galley]HaveyWavey,3645,30,1,6,7,14.3%,8m
5482,2,SoulArisen,3644,515,164,161,325,50.5%,8m
5482,2,Metrics,3644,1512,103,79,182,56.6%,36m
5482,2,[lLiTl]SimSin,3644,1572,69,64,133,51.9%,24m
5482,2,aikrash,3644,1204,44,48,92,47.8%,37m
5482,2,Stinray,3644,593,41,33,74,55.4%,28m
5482,3,[1NG]RatsAhoy,3644,283,11,2,13,84.6%,21m
5482,2,Cho,3644,166,7,3,10,70.0%,33m
5482,2,Logan,3644,150,7,4,11,63.6%,9m
5482,2,lilbuttboy,3644,208,7,13,20,35.0%,6m
5482,2,Krunk,3644,86,3,2,5,60.0%,9m
5492,2,[xLgNx]Jornada,3643,1400,126,135,261,48.3%,40m
5492,2,[DhZAc1]sterbs,3643,1066,112,126,238,47.1%,23m
5492,2,[TMSyN]Oppa,3643,682,92,56,148,62.2%,20m
5492,1,Storm,3643,1413,44,50,94,46.8%,36m
5492,2,[CHATO]PedroHBD,3643,327,18,5,23,78.3%,32m
5492,2,[8iSh]SlipJip,3643,403,12,16,28,42.9%,17m
5492,3,PapaNasty,3643,0,1,0,1,100.0%,15m
5492,3,Chewy,3643,0,1,0,1,100.0%,31m
5492,2,Ruiner,3643,0,0,1,1,0.0%,37m
5492,2,TheKing,3643,0,0,1,1,0.0%,39m
5502,1,OlderWang,3642,1665,276,274,550,50.2%,31m
5502,2,SaulGoodman,3642,734,25,31,56,44.6%,9m
5502,2,[VoHox]beastti,3642,438,16,11,27,59.3%,18m
5502,1,IIIIIIIIIIII,3642,0,3,3,6,50.0%,26m
5502,2,deylon,3642,30,2,2,4,50.0%,41m
5502,2,[3XR]ColossusBall,3642,0,1,0,1,100.0%,33m
5502,2,doge,3642,0,0,2,2,0.0%,27m
5509,2,[TTTCA]Narazaro,3641,1398,79,82,161,49.1%,35m
5509,1,Zortheus,3641,1325,45,63,108,41.7%,10m
5509,2,[FkJeff]laozi,3641,94,4,6,10,40.0%,26m
5509,2,okaRiNa,3641,0,0,1,1,0.0%,40m
5513,1,[CTsix]rei,3640,1762,123,135,258,47.7%,10m
5513,2,gekingo,3640,1117,55,42,97,56.7%,35m
5513,2,StMichael,3640,506,18,25,43,41.9%,2h
5513,2,[SsaYnS]CryonicPig,3640,148,5,9,14,35.7%,7m
5513,2,Talin,3640,147,4,2,6,66.7%,30m
5513,2,TalentedPaul,3640,0,1,0,1,100.0%,33m
5513,2,Alfonso,3640,0,0,2,2,0.0%,9m
5520,2,Jacktheriper,3639,1216,64,28,92,69.6%,7m
5520,2,Brothers,3639,298,62,56,118,52.5%,30m
5520,2,LoboNator,3639,1311,58,53,111,52.3%,26m
5520,2,[Niche]Sparrow,3639,922,47,29,76,61.8%,39m
5520,2,Probiotic,3639,559,29,9,38,76.3%,33m
5520,2,[NoBads]pimba,3639,608,22,26,48,45.8%,25m
5520,2,FrOst,3639,530,21,14,35,60.0%,5m
5520,3,[BiW]Illusion,3639,334,14,8,22,63.6%,4m
5520,2,Gron,3639,254,9,11,20,45.0%,26m
5520,2,ProbiusSC,3639,30,1,1,2,50.0%,22m
5520,2,[LPlay]winsc,3639,30,1,3,4,25.0%,8m
5520,2,BrOwNLeAdEr,3639,0,0,2,2,0.0%,9m
5520,2,Warsta,3639,0,0,4,4,0.0%,21m
5533,2,Dirty,3638,1597,548,537,1085,50.5%,33m
5533,2,WaRLoRd,3638,1503,380,366,746,50.9%,2h
5533,2,FIRE,3638,1530,315,304,619,50.9%,12m
5533,2,Lithium,3638,1613,86,81,167,51.5%,17m
5533,2,IllIIIllllll,3638,1278,62,48,110,56.4%,35m
5533,2,Serbasian,3638,971,42,34,76,55.3%,37m
5533,2,grayfinger,3638,138,8,1,9,88.9%,3m
5533,2,IIIIIIIIIIII,3638,128,7,2,9,77.8%,36m
5533,3,[xBoA]Gentasu,3638,192,6,5,11,54.5%,6m
5533,2,darkks,3638,0,3,2,5,60.0%,20m
5533,2,anger,3638,0,0,2,2,0.0%,20m
5544,2,[NPhasA]MadMax,3637,996,110,112,222,49.5%,9m
5544,2,AwwUrDead,3637,1502,105,83,188,55.9%,6m
5544,2,SpaceJustice,3637,1167,56,33,89,62.9%,28m
5544,2,RaMiThorN,3637,550,23,13,36,63.9%,26m
5544,2,Forscience,3637,0,1,0,1,100.0%,18m
5544,2,Thracian,3637,0,1,0,1,100.0%,32m
5550,2,TossSauce,3636,978,166,163,329,50.5%,20m
5550,2,RonSwanson,3636,1335,140,125,265,52.8%,20m
5550,2,aznaznazn,3636,1529,134,107,241,55.6%,34m
5550,2,[ACSS]Torn,3636,793,104,91,195,53.3%,29m
5550,2,life,3636,370,17,11,28,60.7%,21m
5550,2,fleshblade,3636,398,16,8,24,66.7%,24m
5550,3,Kevincolour,3636,214,11,4,15,73.3%,29m
5550,2,YNSN,3636,88,4,6,10,40.0%,31m
5550,2,KeemaKabab,3636,0,1,0,1,100.0%,26m
5559,2,IIIIIIIIIIII,3635,1578,113,98,211,53.6%,5m
5559,2,[PPleb]Blodzil,3635,1513,59,59,118,50.0%,32m
5559,1,Kubernetes,3635,557,39,56,95,41.1%,10m
5559,2,donz,3635,618,24,19,43,55.8%,29m
5559,2,[SsaYnS]HappyHippo,3635,513,20,13,33,60.6%,34m
5559,2,Dream,3635,184,10,0,10,100.0%,40m
5559,2,Flancern,3635,256,9,12,21,42.9%,28m
5559,2,BOONGBOONG,3635,0,5,0,5,100.0%,12m
5559,2,probeslol,3635,164,5,1,6,83.3%,28m
5559,2,SGiBalrog,3635,46,1,1,2,50.0%,26m
5559,2,Park,3635,0,0,1,1,0.0%,9m
5559,3,Werner,3635,0,0,2,2,0.0%,24m
5571,2,[xTQc]sam,3634,1577,199,194,393,50.6%,41m
5571,2,[DarkAG]ChronoCube,3634,1240,91,94,185,49.2%,5m
5571,2,[SmokeH]Leo,3634,1187,62,59,121,51.2%,5m
5571,2,[Xstorm]JOIRM,3634,1435,60,51,111,54.1%,36m
5571,2,Retsof,3634,832,33,27,60,55.0%,33m
5571,3,Dogjump,3634,237,7,3,10,70.0%,34m
5571,2,[NPhasA]Mar,3634,60,2,3,5,40.0%,37m
5571,2,KnightPimp,3634,0,1,1,2,50.0%,27m
5571,2,PULSAR,3634,0,0,1,1,0.0%,6m
5571,2,[iGOSU]Glaedr,3634,0,0,1,1,0.0%,11m
5571,2,[neuroW]Woogie,3634,0,0,2,2,0.0%,5m
5582,2,FearNot,3633,1568,222,211,433,51.3%,40m
5582,2,RogueSaint,3633,1171,181,165,346,52.3%,12m
5582,2,[LTK]CaDanGr,3633,928,86,73,159,54.1%,35m
5582,2,CroNoS,3633,698,28,26,54,51.9%,24m
5582,2,TheJayBird,3633,308,12,8,20,60.0%,20m
5582,2,Skyler,3633,58,5,4,9,55.6%,5m
5582,2,Vaw,3633,148,5,10,15,33.3%,37m
5582,2,conflict,3633,114,4,2,6,66.7%,18m
5582,2,[MinzS]Serenyde,3633,62,3,4,7,42.9%,21m
5582,2,[Frnzy]SectorMM,3633,30,2,0,2,100.0%,36m
5582,2,Nosfrost,3633,0,1,0,1,100.0%,36m
5582,2,[SSEAS]IceMan,3633,0,0,1,1,0.0%,39m
5582,1,Blunts,3633,0,0,1,1,0.0%,26m
5582,2,[RØR]HankeL,3633,0,0,1,1,0.0%,6m
5596,2,katejon,3632,1011,162,165,327,49.5%,8m
5596,2,[FQA]Shogun,3632,460,42,31,73,57.5%,35m
5596,2,Galivan,3632,640,25,22,47,53.2%,12m
5596,2,[KingSC]Android,3632,481,20,22,42,47.6%,23m
5596,2,[Sune]shadowMist,3632,175,11,14,25,44.0%,25m
5596,2,[eZzZzZ]VictuM,3632,334,11,16,27,40.7%,37m
5596,2,[PCAKE]charlie,3632,204,7,15,22,31.8%,21m
5596,2,RICKY,3632,116,5,2,7,71.4%,30m
5596,2,Ambition,3632,140,5,4,9,55.6%,20m
5596,2,RageWind,3632,114,4,6,10,40.0%,9m
5596,2,[v1rgin]Zelevin,3632,58,2,5,7,28.6%,34m
5596,2,PocketSand,3632,0,1,2,3,33.3%,17m
5596,2,kukailimoku,3632,0,0,3,3,0.0%,37m
5609,2,PinkiePie,3631,1405,251,244,495,50.7%,7m
5609,2,HeroSandwich,3631,1551,176,165,341,51.6%,22m
5609,2,Mysen,3631,1533,111,96,207,53.6%,40m
5609,2,[PTHero]CharactR,3631,1482,93,87,180,51.7%,33m
5609,2,[ODBs]KokaneeBeer,3631,1482,60,52,112,53.6%,38m
5609,2,Teemo,3631,926,41,35,76,53.9%,25m
5609,2,[NerfZg]Aguero,3631,725,35,16,51,68.6%,19m
5609,2,[TPGGXD]Smile,3631,698,27,27,54,50.0%,9m
5609,2,Fasho,3631,551,24,24,48,50.0%,30m
5609,2,[QreskT]SOVA,3631,88,6,0,6,100.0%,36m
5609,2,[SC2PH]Equinox,3631,150,6,7,13,46.2%,34m
5609,2,Welf,3631,0,5,0,5,100.0%,38m
5609,2,FlorencioFan,3631,114,5,2,7,71.4%,32m
5609,2,[vL]FerVela,3631,142,5,6,11,45.5%,24m
5609,2,Fire,3631,30,2,1,3,66.7%,14m
5609,2,[MADps]genocist,3631,0,0,1,1,0.0%,5m
5609,2,Blast,3631,0,0,1,1,0.0%,23m
5626,2,[Tweet]Zeta,3630,493,19,28,47,40.4%,21m
5626,3,Gannicus,3630,130,8,2,10,80.0%,7m
5626,2,Protoin,3630,88,6,0,6,100.0%,17m
5626,2,snAck,3630,0,3,1,4,75.0%,41m
5626,2,IIIIIIIIIIII,3630,86,3,2,5,60.0%,9m
5626,2,Hugo,3630,0,0,1,1,0.0%,37m
5632,2,[WWC]Skellen,3629,491,76,63,139,54.7%,2h
5632,2,Whatopia,3629,1139,46,35,81,56.8%,7m
5632,2,Spenouh,3629,720,41,10,51,80.4%,29m
5632,2,[HiNRG]texmix,3629,346,11,20,31,35.5%,22m
5632,2,zasheek,3629,146,5,6,11,45.5%,27m
5632,2,mcfunley,3629,46,2,1,3,66.7%,9m
5638,2,GuyInChat,3628,1539,163,151,314,51.9%,36m
5638,2,[tRP]NavYCeals,3628,1381,71,69,140,50.7%,26m
5638,2,[PSISTM]SirMalagant,3628,663,44,39,83,53.0%,33m
5638,2,Theztard,3628,508,24,12,36,66.7%,27m
5638,3,[Xpk]Colibrí,3628,257,12,4,16,75.0%,41m
5638,2,Galiadus,3628,144,6,4,10,60.0%,7m
5638,2,[WNTR]PatZeCake,3628,34,3,6,9,33.3%,35m
5638,2,llllllllllll,3628,0,0,1,1,0.0%,6m
5638,2,[1vsM]flachwichser,3628,0,0,1,1,0.0%,24m
5647,2,[EADM8]Stevos,3627,892,41,43,84,48.8%,26m
5647,2,ImpAct,3627,926,38,35,73,52.1%,7m
5647,2,[ZTemp]Goatslegs,3627,296,13,10,23,56.5%,36m
5647,2,KimchiMan,3627,215,10,3,13,76.9%,8m
5647,1,[MTSux]AntMantis,3627,259,6,15,21,28.6%,39m
5647,2,Maiev,3627,144,5,3,8,62.5%,22m
5647,2,OfrParis,3627,0,1,0,1,100.0%,28m
5654,2,jusszy,3626,1060,129,112,241,53.5%,27m
5654,1,[VKNG5]Chivkatal,3626,1477,119,122,241,49.4%,38m
5654,1,pooopman,3626,1043,31,46,77,40.3%,37m
5654,2,SquishyPig,3626,146,5,3,8,62.5%,37m
5654,2,[mYogum]Oppaya,3626,0,1,0,1,100.0%,40m
5654,2,Naraku,3626,0,1,0,1,100.0%,26m
5654,3,bloodbrother,3626,0,1,0,1,100.0%,23m
5661,2,[UpxV]tuclavo,3625,1104,162,138,300,54.0%,13m
5661,2,redturtle,3625,1461,122,122,244,50.0%,40m
5661,2,IlIlllllIIll,3625,1550,93,69,162,57.4%,27m
5661,2,Bee,3625,1084,46,32,78,59.0%,25m
5661,2,aceBatKinG,3625,204,11,2,13,84.6%,32m
5661,2,wombat,3625,122,4,6,10,40.0%,10m
5661,2,Evenstar,3625,58,2,1,3,66.7%,17m
5661,2,Macrogasm,3625,30,2,3,5,40.0%,28m
5661,2,BEM,3625,0,1,0,1,100.0%,22m
5661,2,Spooked,3625,0,1,0,1,100.0%,15m
5661,3,Maphacker,3625,0,0,1,1,0.0%,28m
5672,2,Figgy,3624,655,96,83,179,53.6%,12m
5672,2,GuardeMarine,3624,555,44,49,93,47.3%,35m
5672,2,MetalHorse,3624,525,23,16,39,59.0%,20m
5672,2,Keijo,3624,296,13,2,15,86.7%,29m
5672,3,Doyufeelgood,3624,229,6,7,13,46.2%,23m
5672,2,[TrCool]Turtle,3624,156,6,9,15,40.0%,40m
5672,1,[NPhasA]JeChuv,3624,0,1,0,1,100.0%,13m
5679,2,[SKSR]zephyr,3623,1379,158,133,291,54.3%,12m
5679,2,Zerg,3623,930,109,98,207,52.7%,40m
5679,2,Hungry,3623,1151,49,43,92,53.3%,30m
5679,2,shole,3623,1029,49,58,107,45.8%,37m
5679,2,Inspirit,3623,1238,46,44,90,51.1%,26m
5679,2,UrineTrouble,3623,226,35,17,52,67.3%,9m
5679,2,wizo,3623,176,25,31,56,44.6%,34m
5679,3,TrutY,3623,191,9,3,12,75.0%,30m
5679,2,Madoshi,3623,246,8,17,25,32.0%,6m
5679,3,[VDZ]Cynda,3623,30,1,1,2,50.0%,15m
5679,2,Father,3623,0,1,2,3,33.3%,9m
5679,2,SaucyMcPain,3623,30,1,10,11,9.1%,38m
5679,3,Sovereign,3623,0,0,1,1,0.0%,35m
5692,2,[DhZPro]POSEIDON,3622,1572,97,76,173,56.1%,5m
5692,2,[Wehavu]SpGEroS,3622,642,24,23,47,51.1%,23m
5692,2,simplejack,3622,473,24,28,52,46.2%,36m
5692,2,Cypher,3622,129,12,14,26,46.2%,25m
5696,2,[SsaYnS]DarkPrelate,3621,1608,126,122,248,50.8%,27m
5696,2,BIDENBOI,3621,919,95,86,181,52.5%,28m
5696,2,[lMathl]Doggy,3621,1342,75,66,141,53.2%,7m
5696,2,TresMargs,3621,678,54,45,99,54.5%,35m
5696,2,ScElite,3621,1264,45,54,99,45.5%,5m
5696,2,CheeseComing,3621,465,33,33,66,50.0%,25m
5696,2,beniceplease,3621,758,28,27,55,50.9%,36m
5696,3,Titi,3621,322,14,10,24,58.3%,5m
5696,2,[TSØP]starks,3621,176,11,9,20,55.0%,40m
5696,2,[TNKG]Zerwekh,3621,144,5,4,9,55.6%,41m
5696,2,Aretor,3621,86,3,1,4,75.0%,6m
5696,2,killayou,3621,60,3,2,5,60.0%,9m
5696,2,kuyen,3621,58,2,1,3,66.7%,28m
5696,2,[KJedi]thespartan,3621,0,1,0,1,100.0%,13m
5696,2,lmnsqzy,3621,0,0,1,1,0.0%,12m
5696,2,[MIT]GooseBunny,3621,0,0,3,3,0.0%,34m
5712,2,BestTTL,3620,1508,432,435,867,49.8%,9m
5712,2,[HGDO]Eternal,3620,1268,211,217,428,49.3%,14m
5712,2,saberisaboy,3620,1588,179,142,321,55.8%,5m
5712,2,Botty,3620,1087,145,129,274,52.9%,33m
5712,2,Amaterasu,3620,872,41,25,66,62.1%,17m
5712,2,Autism,3620,303,13,6,19,68.4%,29m
5712,2,Shura,3620,252,9,11,20,45.0%,17m
5712,1,[SaeKon]Azoth,3620,235,8,4,12,66.7%,17m
5712,2,VoidWanderer,3620,102,7,1,8,87.5%,36m
5712,2,DefBoBenis,3620,174,5,2,7,71.4%,10m
5712,2,[12WERT]OGFindMuck,3620,122,5,9,14,35.7%,40m
5712,3,ViruS,3620,97,2,1,3,66.7%,39m
5712,3,wipeOut,3620,30,1,5,6,16.7%,31m
5712,2,[4GH]Spooky,3620,0,0,1,1,0.0%,8m
5726,2,[cl0udM]Hunter,3619,1609,197,157,354,55.6%,28m
5726,2,Kitfox,3619,1555,104,110,214,48.6%,26m
5726,2,[FxB]MrHyde,3619,1115,50,40,90,55.6%,2h
5726,2,Moridin,3619,628,36,7,43,83.7%,28m
5726,2,WeirdRat,3619,174,6,4,10,60.0%,9m
5726,1,sosh,3619,161,5,0,5,100.0%,8m
5726,2,ChubbyCat,3619,30,2,0,2,100.0%,8m
5726,2,Bestone,3619,60,2,2,4,50.0%,17m
5726,2,[zeez]ghost,3619,0,1,0,1,100.0%,28m
5726,2,Chronos,3619,0,1,1,2,50.0%,41m
5726,2,[hTx]EyesRSquared,3619,30,1,7,8,12.5%,23m
5726,2,RoRro,3619,30,1,7,8,12.5%,9m
5726,2,ilyak,3619,0,0,1,1,0.0%,12m
5739,2,[TheDOH]ListerFiend,3618,1589,75,65,140,53.6%,6m
5739,2,[AMZN]Taeho,3618,777,64,57,121,52.9%,41m
5739,2,[IMDSI]huach,3618,893,40,32,72,55.6%,12m
5739,2,Mystic,3618,551,26,17,43,60.5%,27m
5739,2,[MilkIt]Odin,3618,586,22,23,45,48.9%,30m
5739,2,FunDumpster,3618,300,14,7,21,66.7%,9m
5739,1,hzheng,3618,263,14,10,24,58.3%,36m
5739,2,[SWD325]PrOsperity,3618,114,5,1,6,83.3%,35m
5739,2,[LifeF]iLLGATES,3618,0,2,3,5,40.0%,6m
5739,2,[BrHero]jumplnjac,3618,0,1,0,1,100.0%,33m
5749,2,themarsgolem,3617,1193,257,232,489,52.6%,19m
5749,2,IIIIIIIIIIII,3617,1294,156,140,296,52.7%,8m
5749,2,[LTK]bakla,3617,492,37,28,65,56.9%,22m
5749,2,[LoveHY]krJYS,3617,273,14,0,14,100.0%,6m
5749,2,[VENSC2]Pyro,3617,236,8,7,15,53.3%,25m
5749,2,[Junhao]IMJhz,3617,58,2,10,12,16.7%,32m
5749,2,[TossND]EnTaroAdun,3617,30,1,2,3,33.3%,25m
5749,3,SenpaiSugoi,3617,0,0,1,1,0.0%,25m
5757,2,LearningNoob,3616,1445,270,222,492,54.9%,34m
5757,2,BruceWayne,3616,1570,187,175,362,51.7%,5m
5757,2,LikeABoss,3616,1122,63,68,131,48.1%,14m
5757,2,[KoAc]PeaceOut,3616,974,42,39,81,51.9%,34m
5757,2,HATETERRAN,3616,681,39,20,59,66.1%,40m
5757,2,[BLZZ]ESXCDL,3616,967,36,48,84,42.9%,9m
5757,2,[CY]CloakedYoshi,3616,954,35,34,69,50.7%,28m
5757,2,hubs,3616,704,29,25,54,53.7%,25m
5757,2,Mateocos,3616,337,20,16,36,55.6%,35m
5757,2,scmike,3616,160,8,7,15,53.3%,7m
5757,2,[xdbx]Blade,3616,0,1,0,1,100.0%,37m
5757,1,purdy,3616,0,0,1,1,0.0%,16m
5769,2,TangoRocker,3615,889,137,106,243,56.4%,20m
5769,2,[UWSKT1]Druggist,3615,404,14,21,35,40.0%,26m
5769,2,[EZDUNK]Drift,3615,264,9,14,23,39.1%,33m
5769,2,MWD,3615,132,4,14,18,22.2%,6m
5769,2,yalajar,3615,86,3,2,5,60.0%,27m
5769,2,[NPhase]ucchi,3615,0,0,1,1,0.0%,25m
5775,2,killerass,3614,1547,148,130,278,53.2%,40m
5775,2,[TY4GG]Arcamage,3614,913,42,25,67,62.7%,37m
5775,2,[umoron]llllllllllll,3614,868,39,24,63,61.9%,40m
5775,2,[H264]VorteX,3614,322,33,20,53,62.3%,36m
5775,2,Kalguksu,3614,444,17,15,32,53.1%,5m
5775,2,[xLgNx]Kalo,3614,176,6,4,10,60.0%,5m
5775,2,IllIIlIlllI,3614,130,5,0,5,100.0%,6m
5775,2,[WPL]OverlordRL,3614,128,5,12,17,29.4%,26m
5775,2,[Shang]Zam,3614,146,4,6,10,40.0%,36m
5775,2,DiamondNA,3614,90,3,4,7,42.9%,37m
5775,2,[WNTR1]RoudoudouRou,3614,0,1,0,1,100.0%,25m
5775,2,CupcakeSatan,3614,0,1,4,5,20.0%,30m
5775,2,Pointyfern,3614,0,0,1,1,0.0%,34m
5775,2,KarlHeinz,3614,0,0,1,1,0.0%,37m
5789,2,ElCreador,3613,1431,266,243,509,52.3%,29m
5789,1,[SsaYnS]mrflamingo,3613,1731,160,168,328,48.8%,38m
5789,2,FalseHope,3613,1429,75,88,163,46.0%,22m
5789,2,Screwface,3613,1532,74,71,145,51.0%,36m
5789,2,NoNothing,3613,596,68,71,139,48.9%,22m
5789,2,[iNJC]UncleIroh,3613,587,25,16,41,61.0%,24m
5789,2,OldSnake,3613,306,11,14,25,44.0%,17m
5789,2,Sekiro,3613,185,8,16,24,33.3%,24m
5789,2,[HsDL]MiaNonnNa,3613,95,6,0,6,100.0%,15m
5798,2,yenkocamaro,3612,1634,685,678,1363,50.3%,23m
5798,2,[FyHr]Raúl,3612,1291,106,112,218,48.6%,5m
5798,2,[OD2019]HEAVYSTARCH,3612,541,24,20,44,54.5%,28m
5798,2,[IPT]Heartz,3612,339,15,9,24,62.5%,17m
5798,2,Whitelancer,3612,188,6,10,16,37.5%,40m
5798,2,[Sc2Bo]StarWalker,3612,30,2,1,3,66.7%,35m
5798,2,[Macac0]TheKevo,3612,58,2,3,5,40.0%,34m
5798,2,Noctisxiii,3612,60,2,5,7,28.6%,17m
5798,3,spireet,3612,96,1,1,2,50.0%,24m
5798,2,[pq]SaTivAs,3612,30,1,2,3,33.3%,37m
5808,2,Tankker,3611,464,248,243,491,50.5%,35m
5808,2,[DRKRIS]chickenfeed,3611,1054,45,49,94,47.9%,30m
5808,2,llllllllllll,3611,537,37,3,40,92.5%,20m
5808,2,Burger,3611,461,30,19,49,61.2%,22m
5808,2,Protoss,3611,501,29,10,39,74.4%,5m
5808,2,[DRONGO]Indominable,3611,281,19,12,31,61.3%,21m
5808,2,jiN,3611,542,19,21,40,47.5%,22m
5808,2,yeaH,3611,130,8,1,9,88.9%,29m
5808,2,baz,3611,234,8,12,20,40.0%,36m
5808,2,iGeddit,3611,135,7,1,8,87.5%,16m
5808,2,MoonLightETA,3611,95,6,0,6,100.0%,22m
5808,2,VirgeM,3611,0,5,0,5,100.0%,24m
5808,2,[HOGGED]BidenPrez,3611,86,4,1,5,80.0%,26m
5808,2,LeeSiTsyn,3611,0,3,3,6,50.0%,20m
5808,2,[EGx]DarkTiger,3611,58,2,2,4,50.0%,28m
5808,2,MaKaBrO,3611,0,0,3,3,0.0%,12m
5824,2,Paum,3610,1596,93,69,162,57.4%,30m
5824,2,[64]ZERGcraft,3610,1552,92,89,181,50.8%,2h
5824,2,[CHAPU]DARK,3610,1537,86,88,174,49.4%,27m
5824,2,ions,3610,613,28,24,52,53.8%,7m
5824,2,[BRSKR]Erujan,3610,305,10,6,16,62.5%,22m
5824,2,[Bxop]ian,3610,114,5,5,10,50.0%,2h
5824,2,Mozzer,3610,103,4,8,12,33.3%,36m
5824,3,Ztarcraft,3610,30,2,11,13,15.4%,16m
5824,2,[ArGNA]Marsman,3610,0,1,0,1,100.0%,6m
5824,3,rLemieux,3610,97,1,2,3,33.3%,28m
5824,2,traveller,3610,18,1,3,4,25.0%,9m
5824,2,[WEEEEE]jam,3610,0,0,1,1,0.0%,29m
5824,2,[EvilCa]Dragonrs,3610,0,0,1,1,0.0%,28m
5824,2,Niki,3610,0,0,2,2,0.0%,9m
5838,2,marveL,3609,1575,131,116,247,53.0%,17m
5838,2,Sonoso,3609,1433,58,48,106,54.7%,41m
5838,2,[PFC1]MtLKiLLa,3609,1008,38,37,75,50.7%,30m
5838,2,Guybrush,3609,165,8,0,8,100.0%,14m
5838,2,[BitM]Dacaster,3609,30,2,1,3,66.7%,35m
5838,2,KIN,3609,30,2,1,3,66.7%,26m
5844,2,Virtue,3608,1406,56,52,108,51.9%,7m
5844,2,Ledrash,3608,673,49,52,101,48.5%,30m
5844,2,Beluga,3608,997,44,37,81,54.3%,25m
5844,2,Yici,3608,770,28,36,64,43.8%,22m
5844,2,Raymand,3608,736,27,29,56,48.2%,9m
5844,2,iForks,3608,334,16,5,21,76.2%,29m
5844,2,Regents,3608,186,6,8,14,42.9%,12m
5844,2,BrooklynTala,3608,88,3,3,6,50.0%,3m
5844,2,BurninLegion,3608,0,2,3,5,40.0%,34m
5844,2,Dxros,3608,0,1,0,1,100.0%,27m
5844,2,TeleTubbies,3608,0,1,0,1,100.0%,5m
5844,2,[SuperZ]lIlIlIlIlIlI,3608,0,0,1,1,0.0%,24m
5856,2,[CHEEKS]Voods,3607,1071,73,65,138,52.9%,9m
5856,2,Noise,3607,1168,42,47,89,47.2%,31m
5856,3,IIIIIIIIIIII,3607,256,12,5,17,70.6%,16m
5856,1,rabblerawr,3607,143,7,2,9,77.8%,2h
5856,2,AIphaStar,3607,0,0,1,1,0.0%,37m
5856,2,[ZGRB]JESTJERVYN,3607,0,0,3,3,0.0%,11m
5862,2,[ixM]tetec,3606,1513,167,170,337,49.6%,33m
5862,1,Gabber,3606,1628,99,99,198,50.0%,20m
5862,2,[UpeV]MaXiiMoO,3606,1340,61,40,101,60.4%,17m
5862,2,[SKyber]yoshymaro,3606,1024,57,41,98,58.2%,24m
5862,2,rabblerawrer,3606,513,27,13,40,67.5%,33m
5862,3,[AoS]Chewy,3606,193,6,4,10,60.0%,30m
5862,2,TraGic,3606,0,1,0,1,100.0%,13m
5869,2,IIIIIIIIIIII,3605,1589,285,268,553,51.5%,28m
5869,2,DeezNutz,3605,787,69,34,103,67.0%,22m
5869,2,Schmidtwerd,3605,935,58,61,119,48.7%,30m
5869,1,Negative,3605,1223,48,64,112,42.9%,40m
5869,2,[LUE]OctopusBlues,3605,1138,43,43,86,50.0%,24m
5869,2,CEO,3605,374,40,42,82,48.8%,41m
5869,2,[EzyPzY]TopRahman,3605,436,21,12,33,63.6%,29m
5869,2,TOS,3605,264,17,16,33,51.5%,37m
5869,3,[BOXNET]Dieuguerre,3605,197,12,3,15,80.0%,14m
5869,2,Shrike,3605,346,12,11,23,52.2%,9m
5869,3,Protoss,3605,209,11,3,14,78.6%,25m
5869,2,Chadry,3605,196,9,1,10,90.0%,31m
5869,2,Freeze,3605,230,8,7,15,53.3%,14m
5869,2,Canopus,3605,67,6,8,14,42.9%,6m
5869,2,Fireball,3605,60,2,5,7,28.6%,9m
5869,2,SuperiaHands,3605,0,1,0,1,100.0%,29m
5869,2,Barett,3605,0,1,0,1,100.0%,25m
5869,2,[TAW]Zyndra,3605,0,1,0,1,100.0%,12m
5869,2,[PiGPan]Bali,3605,0,0,1,1,0.0%,30m
5888,2,DoctorAlex,3604,1552,373,371,744,50.1%,35m
5888,2,[KrAce]foshizzle,3604,1265,135,126,261,51.7%,25m
5888,2,Wafflez,3604,1459,109,80,189,57.7%,23m
5888,2,[FalPal]FattyESQ,3604,1324,77,79,156,49.4%,35m
5888,2,YellowBanana,3604,1554,74,48,122,60.7%,28m
5888,2,Wantoch,3604,432,70,56,126,55.6%,18m
5888,2,LMGW,3604,371,46,44,90,51.1%,20m
5888,2,[BRSKR]MUDABANG,3604,530,24,17,41,58.5%,24m
5888,2,llllllllllll,3604,453,23,13,36,63.9%,35m
5888,2,[4RLZs]Asteroc,3604,394,14,15,29,48.3%,41m
5888,2,AwfullChrono,3604,228,8,9,17,47.1%,13m
5888,2,[MAAGIC]CMarTZ,3604,58,2,5,7,28.6%,18m
5900,2,chunny,3603,580,22,23,45,48.9%,12m
5900,2,[UgrM]Bonfire,3603,231,12,4,16,75.0%,8m
5900,2,[Exa]Omnivalent,3603,94,3,10,13,23.1%,23m
5900,2,beefstew,3603,30,1,2,3,33.3%,6m
5900,2,Inertia,3603,0,0,9,9,0.0%,41m
5905,2,freedomflyer,3602,1547,433,427,860,50.3%,30m
5905,2,Yao,3602,1536,145,139,284,51.1%,40m
5905,2,JPD,3602,1579,135,130,265,50.9%,6m
5905,2,Banger,3602,1454,59,66,125,47.2%,13m
5905,2,[ShiPal]Maru,3602,925,38,29,67,56.7%,27m
5905,2,repentance,3602,568,25,28,53,47.2%,30m
5905,2,lIlIIllIlI,3602,459,16,22,38,42.1%,37m
5905,2,Jestin,3602,354,12,11,23,52.2%,5m
5905,2,jinso,3602,180,10,3,13,76.9%,3m
5905,2,[AoH]Zelniq,3602,146,5,14,19,26.3%,41m
5905,2,[Oxente]Jcaires,3602,30,2,1,3,66.7%,11m
5905,2,Pariah,3602,58,2,4,6,33.3%,33m
5905,2,llllllllllll,3602,0,0,3,3,0.0%,12m
5918,2,BenJa,3601,1604,175,151,326,53.7%,30m
5918,2,[FnATlC]OPprotoszerg,3601,422,52,35,87,59.8%,33m
5918,2,[UpeV]Mugiwara,3601,680,49,35,84,58.3%,6m
5918,2,[Zatra]blacklotus,3601,617,24,17,41,58.5%,8m
5918,2,iGreedyBoy,3601,152,9,3,12,75.0%,16m
5918,2,Victor,3601,202,7,10,17,41.2%,36m
5918,1,zicque,3601,119,3,2,5,60.0%,21m
5918,3,[TSS]Underoath,3601,30,1,1,2,50.0%,37m
5918,2,[PPGER]Amikiller,3601,0,0,1,1,0.0%,25m
5918,1,[TAsc]ToSsGirL,3601,0,0,5,5,0.0%,9m
5928,2,[SsaYnS]johnrodjohn,3600,1568,200,193,393,50.9%,25m
5928,2,[Coknut]bobcao,3600,1523,138,129,267,51.7%,9m
5928,2,[GOPERÚ]CrossStroke,3600,489,74,56,130,56.9%,23m
5928,2,xoxoHedge,3600,996,48,40,88,54.5%,36m
5928,2,masterchief,3600,199,33,20,53,62.3%,2h
5928,2,Snikerdoodle,3600,290,27,24,51,52.9%,6m
5928,2,AboveTheZero,3600,548,21,16,37,56.8%,5m
5928,2,[500CC]CoreDefender,3600,548,20,19,39,51.3%,27m
5928,3,PENUSKING,3600,245,16,5,21,76.2%,7m
5928,2,StarFiend,3600,37,4,12,16,25.0%,2h
5938,2,UBIN,3599,617,41,36,77,53.2%,21m
5938,2,Colgate,3599,964,36,39,75,48.0%,21m
5938,2,Rangdaddy,3599,314,35,21,56,62.5%,6m
5938,2,[SPV]RonDon,3599,234,27,29,56,48.2%,15m
5938,2,Dragracing,3599,237,20,8,28,71.4%,25m
5938,2,KUANG,3599,302,15,7,22,68.2%,6m
5938,2,Civil,3599,222,8,4,12,66.7%,12m
5938,2,[GFAQs]ItsSonic,3599,116,4,6,10,40.0%,38m
5938,2,gch,3599,122,2,2,4,50.0%,8m
5938,2,[TSOUR]Rheagan,3599,0,1,2,3,33.3%,16m
5948,1,[5555]DjiNN,3598,1757,131,134,265,49.4%,36m
5948,2,[SsaYnS]ShakesQQ,3598,1602,109,104,213,51.2%,25m
5948,2,Maru,3598,0,0,1,1,0.0%,30m
5948,2,hatethisgame,3598,0,0,2,2,0.0%,25m
5952,2,Haunter,3597,1583,197,204,401,49.1%,17m
5952,2,[Lp]QUICKSILVER,3597,1070,40,43,83,48.2%,24m
5952,2,SaemonDaymon,3597,682,25,28,53,47.2%,14m
5952,2,[FateTw]VOIDRAYS,3597,122,21,16,37,56.8%,14m
5952,2,[hTx]JackStark,3597,494,18,19,37,48.6%,31m
5952,2,[CDAL]Stonegiant,3597,273,13,2,15,86.7%,12m
5952,2,[NalsEz]KatzeGud,3597,165,10,2,12,83.3%,11m
5952,2,Reach,3597,242,8,17,25,32.0%,29m
5952,3,[tdrs]MyNeighbor,3597,164,5,1,6,83.3%,10m
5952,2,math,3597,30,2,0,2,100.0%,40m
5952,2,mezzanine,3597,0,0,1,1,0.0%,26m
5952,2,BilluPillu,3597,0,0,2,2,0.0%,35m
5964,1,[Pharoh]bksc,3596,1365,311,285,596,52.2%,38m
5964,2,ghosty,3596,1592,132,102,234,56.4%,11m
5964,2,Midge,3596,696,30,21,51,58.8%,12m
5964,2,[VRBL]Chuka,3596,498,18,17,35,51.4%,25m
5964,2,Miller,3596,267,10,5,15,66.7%,40m
5964,2,Dark,3596,262,10,14,24,41.7%,11m
5964,2,apple,3596,112,7,2,9,77.8%,3m
5964,2,rush,3596,0,5,0,5,100.0%,11m
5964,2,FruitDealer,3596,126,4,0,4,100.0%,12m
5964,2,RobotWizard,3596,30,1,3,4,25.0%,21m
5964,3,gibbs,3596,0,0,1,1,0.0%,40m
5975,2,InigoMontoya,3595,1377,409,412,821,49.8%,25m
5975,2,Rellic,3595,520,65,48,113,57.5%,9m
5975,2,[KGH]spargo,3595,138,3,5,8,37.5%,8m
5975,2,ChildPlease,3595,30,1,2,3,33.3%,20m
5975,2,[SC2PH]MangTomas,3595,0,0,1,1,0.0%,9m
5980,2,[NLTTJ]sohot,3594,767,37,20,57,64.9%,14m
5980,2,Ryan,3594,218,7,6,13,53.8%,34m
5980,2,chromawa,3594,94,3,11,14,21.4%,38m
5980,2,[Cryptc]Noticals,3594,0,1,10,11,9.1%,29m
5984,2,Teferisixsix,3593,951,86,97,183,47.0%,30m
5984,2,VpRainbow,3593,314,12,11,23,52.2%,22m
5984,3,IIIIIIIIIIII,3593,142,5,2,7,71.4%,15m
5984,2,BeltaLowda,3593,90,4,4,8,50.0%,9m
5984,2,[CWAL]Changsta,3593,130,3,3,6,50.0%,40m
5984,2,IIIIIIIIIIII,3593,58,2,1,3,66.7%,33m
5984,2,[ycfsb]wehaaaaa,3593,0,1,0,1,100.0%,12m
5984,2,[cl0udM]OveR,3593,0,1,2,3,33.3%,14m
5984,2,HooBoo,3593,0,0,1,1,0.0%,37m
5984,2,MetalMaestro,3593,0,0,2,2,0.0%,25m
5994,2,Terminus,3592,1535,183,179,362,50.6%,38m
5994,1,Daices,3592,1617,108,110,218,49.5%,30m
5994,2,[ROFLS]Senz,3592,963,96,75,171,56.1%,27m
5994,2,Bighentai,3592,852,91,69,160,56.9%,28m
5994,2,[R3M]rokcdrigo,3592,559,27,9,36,75.0%,17m
5994,2,KodiakBear,3592,422,20,14,34,58.8%,8m
5994,2,[LGNxx]Wither,3592,310,11,10,21,52.4%,36m
5994,2,[MacSed]llllllllllll,3592,226,8,4,12,66.7%,18m
5994,2,Arno,3592,200,7,7,14,50.0%,5m
5994,2,DaBunkaKid,3592,150,6,6,12,50.0%,6m
5994,2,[ProjD]Ogre,3592,136,6,12,18,33.3%,2h
5994,2,Drisc,3592,116,4,3,7,57.1%,17m
5994,2,Bisu,3592,0,1,0,1,100.0%,37m
5994,2,Jag,3592,30,1,1,2,50.0%,41m
6008,1,beach,3591,1287,957,972,1929,49.6%,12m
6008,2,[TXOP]Magno,3591,1410,86,91,177,48.6%,33m
6008,2,saucy,3591,340,85,30,115,73.9%,6m
6008,2,[SsWa]Kire,3591,1117,80,86,166,48.2%,33m
6008,2,DIO,3591,532,21,21,42,50.0%,15m
6008,2,Yours,3591,266,9,11,20,45.0%,23m
6008,2,GoodGameNoob,3591,30,2,2,4,50.0%,9m
6008,2,RazeriaN,3591,0,0,5,5,0.0%,36m
6016,2,RandomWasabi,3590,1602,350,303,653,53.6%,14m
6016,2,BRASKI,3590,1606,319,298,617,51.7%,33m
6016,2,[EBAGmn]GrandBK,3590,1633,301,264,565,53.3%,24m
6016,2,Cradle,3590,1202,112,88,200,56.0%,40m
6016,2,MamaniTuCapo,3590,1436,83,75,158,52.5%,27m
6016,2,LAOTIAN,3590,744,63,57,120,52.5%,38m
6016,2,player,3590,1258,52,52,104,50.0%,36m
6016,2,Inkfish,3590,220,38,34,72,52.8%,6m
6016,2,RumouRs,3590,0,1,0,1,100.0%,37m
6016,3,MrGigglez,3590,30,1,1,2,50.0%,4m
6026,2,[425]StarLighT,3589,893,50,39,89,56.2%,27m
6026,2,SpAzTiC,3589,776,48,54,102,47.1%,22m
6026,2,idiZa,3589,676,43,50,93,46.2%,29m
6026,2,asdiuhnbjkwe,3589,568,25,21,46,54.3%,25m
6026,2,[SMB]Rainstorm,3589,342,13,13,26,50.0%,41m
6026,2,[GGxC]thegreybush,3589,215,11,0,11,100.0%,37m
6026,2,MadStar,3589,270,9,12,21,42.9%,20m
6026,2,FirestarX,3589,53,7,14,21,33.3%,30m
6026,2,[SC2IDN]Seppius,3589,121,5,5,10,50.0%,37m
6026,2,Zerg,3589,0,4,0,4,100.0%,36m
6026,2,grishy,3589,88,4,1,5,80.0%,36m
6026,3,Cortell,3589,0,0,1,1,0.0%,26m
6026,2,[NZER0]Ghoul,3589,0,0,1,1,0.0%,30m
6026,2,Yooshiii,3589,0,0,4,4,0.0%,20m
6040,2,[SsaYnS]rin,3588,1526,349,326,675,51.7%,5m
6040,2,IIIIIIIIIII,3588,1541,225,191,416,54.1%,19m
6040,2,Kubrickr,3588,1435,162,149,311,52.1%,41m
6040,2,[SsaYnS]HEAVYMETAL,3588,1246,90,81,171,52.6%,27m
6040,2,[Cryptc]Balgruuf,3588,1093,42,38,80,52.5%,35m
6040,2,[xTQc]Soulkey,3588,477,39,27,66,59.1%,36m
6040,2,Trogdor,3588,686,35,31,66,53.0%,40m
6040,2,[ValidG]HailHydra,3588,670,32,19,51,62.7%,37m
6040,2,IEatNukes,3588,340,13,8,21,61.9%,22m
6040,3,josephlevita,3588,232,11,2,13,84.6%,31m
6040,2,[ShowMe]EunKyo,3588,266,10,7,17,58.8%,18m
6040,2,JuicedBox,3588,116,5,4,9,55.6%,35m
6040,2,IIIIIIIIIIII,3588,102,3,1,4,75.0%,28m
6040,2,[UrMove]MangoSpice,3588,62,2,8,10,20.0%,41m
6040,2,[BYOC]DeusX,3588,30,1,1,2,50.0%,33m
6040,2,[FMX]JamesBaxter,3588,0,0,1,1,0.0%,23m
6056,2,AriKataar,3587,1371,72,77,149,48.3%,18m
6056,2,Jek,3587,1142,69,36,105,65.7%,9m
6056,2,Alastor,3587,275,17,7,24,70.8%,15m
6056,2,miamilow,3587,272,11,15,26,42.3%,37m
6056,2,Citrus,3587,0,5,0,5,100.0%,30m
6056,2,[ValidG]Dajak,3587,134,4,1,5,80.0%,3m
6056,3,MrLingo,3587,121,3,3,6,50.0%,21m
6056,2,AAAAAAAAA,3587,0,1,0,1,100.0%,24m
6056,2,VonHugenrod,3587,0,1,1,2,50.0%,30m
6056,2,Json,3587,30,1,2,3,33.3%,2h
6066,2,[RlSKE]BigDaddy,3586,923,53,54,107,49.5%,25m
6066,2,KariTraa,3586,411,19,13,32,59.4%,28m
6066,2,IIlllIIlllIl,3586,338,12,15,27,44.4%,22m
6066,2,RadAir,3586,328,11,16,27,40.7%,24m
6066,2,dlwlxkr,3586,182,6,10,16,37.5%,2h
6066,2,IIIIIIIIIIII,3586,122,4,11,15,26.7%,8m
6066,2,Random,3586,88,3,3,6,50.0%,30m
6066,2,[AiMB]Onyx,3586,30,2,2,4,50.0%,40m
6074,2,CCS,3585,399,42,36,78,53.8%,36m
6074,2,[NovaX]HJM,3585,754,27,26,53,50.9%,33m
6074,2,WHAAAA,3585,443,24,8,32,75.0%,17m
6074,2,hashbaby,3585,157,24,28,52,46.2%,35m
6074,2,Adrenaline,3585,159,11,12,23,47.8%,2h
6074,2,DoeBy,3585,30,2,1,3,66.7%,3m
6074,2,[UpxV]sebastian,3585,0,1,3,4,25.0%,12m
6074,2,Kaizen,3585,0,1,6,7,14.3%,36m
6082,2,dotsrcool,3584,1209,117,107,224,52.2%,12m
6082,2,nyanton,3584,932,116,97,213,54.5%,16m
6082,2,[UCLA]RKStranger,3584,563,27,28,55,49.1%,22m
6082,2,fiftySupply,3584,633,24,19,43,55.8%,37m
6082,2,BrilliantPy,3584,100,12,17,29,41.4%,36m
6082,2,[ExcIgN]piñuflonter,3584,192,8,1,9,88.9%,16m
6082,2,Wolfalone,3584,30,2,4,6,33.3%,20m
6082,2,[REPORT]Credo,3584,30,1,2,3,33.3%,33m
6090,2,achillies,3583,1645,254,246,500,50.8%,41m
6090,2,luXon,3583,896,156,153,309,50.5%,9m
6090,2,FlatEarther,3583,1598,144,129,273,52.7%,17m
6090,2,[lLiTl]Swift,3583,1122,142,146,288,49.3%,33m
6090,2,SantyaGa,3583,1239,56,43,99,56.6%,18m
6090,2,EmailAddress,3583,684,26,25,51,51.0%,18m
6090,2,Lightforger,3583,576,25,15,40,62.5%,5m
6090,2,HUby,3583,559,24,17,41,58.5%,36m
6090,2,[GGDA]invictor,3583,330,19,12,31,61.3%,8m
6090,3,zerg,3583,271,10,8,18,55.6%,22m
6090,2,[7W2D]THAMUFFINMAN,3583,126,3,1,4,75.0%,36m
6090,3,[BREA]Kenny,3583,0,1,0,1,100.0%,5m
6090,2,[Pres45]TRUMP,3583,0,1,0,1,100.0%,12m
6090,2,yamz,3583,0,0,1,1,0.0%,28m
6090,2,[FMX]ElMacho,3583,0,0,1,1,0.0%,25m
6105,2,bEaNGiaNT,3582,920,181,186,367,49.3%,15m
6105,2,Iconoclast,3582,60,3,4,7,42.9%,5m
6105,2,Frosty,3582,96,3,4,7,42.9%,23m
6105,2,Professional,3582,112,2,1,3,66.7%,5m
6105,2,bluestar,3582,30,1,2,3,33.3%,2h
6105,1,AstroDroid,3582,0,0,1,1,0.0%,36m
6111,2,mingfei,3581,1540,178,165,343,51.9%,37m
6111,2,Bean,3581,654,67,73,140,47.9%,27m
6111,2,LostMyth,3581,887,40,28,68,58.8%,40m
6111,2,Rorschach,3581,577,35,33,68,51.5%,16m
6111,2,Voracity,3581,555,31,12,43,72.1%,37m
6111,2,NickTrofimuk,3581,655,24,33,57,42.1%,9m
6111,2,Eriklop,3581,416,21,8,29,72.4%,36m
6111,2,[MtrCty]Bubu,3581,88,4,2,6,66.7%,24m
6111,2,silver,3581,60,2,4,6,33.3%,40m
6111,2,[TJET]Bonein,3581,30,1,1,2,50.0%,12m
6111,2,silverhawk,3581,0,1,1,2,50.0%,24m
6122,2,Nedd,3580,1592,119,108,227,52.4%,29m
6122,2,[LgnTDS]SarahsManzXD,3580,615,100,62,162,61.7%,38m
6122,2,[SuperZ]tetrud,3580,1156,47,42,89,52.8%,35m
6122,2,[INCARD]BigRat,3580,282,9,9,18,50.0%,16m
6122,2,ImAnUmbrella,3580,262,9,10,19,47.4%,8m
6122,2,FluvsKornor,3580,88,4,2,6,66.7%,25m
6128,2,Lynx,3579,1562,395,364,759,52.0%,29m
6128,2,[FxB]Delicious,3579,1351,74,75,149,49.7%,35m
6128,2,LeoMessiFan,3579,767,34,21,55,61.8%,35m
6128,2,[DHAL]Necrys,3579,137,7,1,8,87.5%,40m
6128,2,TheBestfOu,3579,191,7,4,11,63.6%,25m
6128,2,Quarantined,3579,102,3,3,6,50.0%,30m
6128,2,[SBoys]Franco,3579,30,2,4,6,33.3%,16m
6128,2,Probed,3579,0,0,1,1,0.0%,40m
6128,2,EnTaroDHo,3579,0,0,4,4,0.0%,18m
6137,2,Sevan,3578,684,104,86,190,54.7%,5m
6137,2,[EtrOy]CptCool,3578,239,19,22,41,46.3%,18m
6137,2,Rezian,3578,354,13,10,23,56.5%,15m
6137,2,[LifeF]BuckWheat,3578,88,3,4,7,42.9%,38m
6137,1,[KUMS]TickleMiCulo,3578,0,2,3,5,40.0%,12m
6137,3,[ØÛ]KorShalaAdun,3578,0,0,1,1,0.0%,36m
6143,2,Entropy,3577,1478,102,87,189,54.0%,24m
6143,2,blue,3577,1316,50,52,102,49.0%,29m
6143,2,[zeez]zeezPanzer,3577,808,33,30,63,52.4%,40m
6143,2,[UpeV]LBlanc,3577,451,20,10,30,66.7%,32m
6143,2,[DS]BlinK,3577,199,18,20,38,47.4%,9m
6143,3,Tear,3577,148,10,4,14,71.4%,19m
6143,3,[neuroS]Keneme,3577,177,7,9,16,43.8%,9m
6143,2,[AbcCo]AxelGun,3577,167,6,2,8,75.0%,38m
6143,2,abcdefg,3577,146,5,7,12,41.7%,37m
6143,2,vJxkosHD,3577,30,2,1,3,66.7%,30m
6143,2,[DNKCFT]BarkBemplar,3577,30,2,2,4,50.0%,17m
6143,2,wtf,3577,0,0,1,1,0.0%,20m
6143,2,Oda,3577,0,0,1,1,0.0%,17m
6156,2,VanillaLove,3576,1543,302,298,600,50.3%,29m
6156,2,ModalSoul,3576,1520,87,102,189,46.0%,41m
6156,2,[Xpk]UronG,3576,381,19,6,25,76.0%,12m
6156,2,[NalsEz]TimosGirl,3576,218,10,2,12,83.3%,17m
6156,2,Zhandos,3576,96,6,2,8,75.0%,37m
6156,2,Player,3576,152,4,2,6,66.7%,38m
6156,2,Myeugle,3576,30,2,1,3,66.7%,4m
6156,2,[SNSD]DocJonson,3576,0,1,0,1,100.0%,11m
6156,2,susvara,3576,0,1,0,1,100.0%,6m
6156,2,[NPhase]Wittgenstein,3576,30,1,2,3,33.3%,33m
6156,2,[DETER]StrikerVX,3576,0,0,2,2,0.0%,25m
6167,2,MaterLord,3575,1583,130,122,252,51.6%,37m
6167,2,Ultrajohn,3575,746,125,113,238,52.5%,25m
6167,2,KoomBoom,3575,617,123,121,244,50.4%,36m
6167,2,yoyobad,3575,1022,41,32,73,56.2%,11m
6167,2,commanderh,3575,812,31,29,60,51.7%,21m
6167,2,[GØSU]Coek,3575,434,18,32,50,36.0%,35m
6167,2,[RUMB]PieForever,3575,340,12,9,21,57.1%,29m
6167,2,siaukia,3575,90,4,3,7,57.1%,30m
6167,2,Gremory,3575,116,4,4,8,50.0%,2h
6167,2,AssTier,3575,62,3,7,10,30.0%,6m
6177,2,OooOoO,3574,1078,115,88,203,56.7%,29m
6177,2,[GeekA]gelous,3574,1555,84,93,177,47.5%,30m
6177,2,[3D]rangerkaw,3574,669,58,55,113,51.3%,36m
6177,2,[JUIC3Y]Jango,3574,668,24,24,48,50.0%,30m
6177,2,[SMB]maxpower,3574,572,23,25,48,47.9%,27m
6177,2,[MutasT]Horuss,3574,346,22,37,59,37.3%,40m
6177,2,lilhaywood,3574,184,6,12,18,33.3%,40m
6177,2,[LCE]PartinG,3574,112,3,0,3,100.0%,30m
6177,2,[EFTNEN]EffTenEnn,3574,30,2,0,2,100.0%,29m
6177,2,Bearwidme,3574,88,2,0,2,100.0%,40m
6177,2,[NeAs]LaKokaKola,3574,46,2,0,2,100.0%,11m
6177,2,[dihk]GoodAz,3574,30,1,1,2,50.0%,7m
6189,2,Plucault,3573,1357,202,184,386,52.3%,8m
6189,2,exgorgitatio,3573,437,20,12,32,62.5%,12m
6189,2,BraveSamwise,3573,254,10,4,14,71.4%,25m
6189,2,Andromeda,3573,130,8,1,9,88.9%,19m
6189,2,SodaCityFunk,3573,190,7,3,10,70.0%,33m
6189,2,lampshade,3573,126,4,1,5,80.0%,29m
6189,2,[AnUB]MEGATRON,3573,30,1,1,2,50.0%,35m
6189,2,Aleko,3573,0,1,2,3,33.3%,7m
6189,2,Roma,3573,0,0,1,1,0.0%,38m
6198,2,DeGen,3572,1139,173,135,308,56.2%,5m
6198,2,Chris,3572,987,73,46,119,61.3%,8m
6198,2,JubilantCows,3572,357,19,17,36,52.8%,30m
6198,2,Scaevola,3572,289,15,10,25,60.0%,37m
6198,2,[lNI]QueensGambit,3572,285,14,7,21,66.7%,35m
6198,2,[Onnor]Kris,3572,295,12,6,18,66.7%,18m
6198,2,[iTE]SCARLIGHT,3572,334,12,12,24,50.0%,9m
6198,3,JaZ,3572,121,3,1,4,75.0%,10m
6198,2,[IMMVP]lnsanity,3572,30,2,10,12,16.7%,35m
6198,2,BOSS,3572,0,0,1,1,0.0%,2h
6198,2,[VENSC2]ViNoTintO,3572,0,0,1,1,0.0%,17m
6209,2,hootis,3571,840,82,76,158,51.9%,41m
6209,2,FreeCoaching,3571,883,72,6,78,92.3%,16m
6209,2,[sgnDK]angj,3571,152,5,13,18,27.8%,27m
6209,2,[ValidG]Irish,3571,58,3,1,4,75.0%,31m
6209,2,Stoys,3571,86,3,4,7,42.9%,7m
6209,2,[FYous]Zzzz,3571,0,0,4,4,0.0%,30m
6215,2,halcyon,3570,1579,314,308,622,50.5%,9m
6215,2,Weebles,3570,1573,116,90,206,56.3%,24m
6215,2,Rokhar,3570,1369,86,72,158,54.4%,35m
6215,2,Credit,3570,876,51,38,89,57.3%,37m
6215,2,DrunkTemplar,3570,895,49,26,75,65.3%,29m
6215,2,IIIIIIII,3570,486,26,12,38,68.4%,29m
6215,2,NousDefions,3570,422,21,11,32,65.6%,4m
6215,2,MaximusBlock,3570,258,10,11,21,47.6%,11m
6215,2,Enceladus,3570,30,2,8,10,20.0%,27m
6215,2,Pure,3570,0,1,4,5,20.0%,16m
6215,2,MeHotel,3570,0,0,1,1,0.0%,9m
6215,2,Eliot,3570,0,0,1,1,0.0%,25m
6227,2,MastrOfOrion,3569,1580,103,104,207,49.8%,21m
6227,2,fury,3569,293,38,28,66,57.6%,2h
6227,2,bluenoodle,3569,458,21,16,37,56.8%,16m
6227,2,[TGosuC]Dogfobmal,3569,341,12,14,26,46.2%,30m
6227,2,Mandragoran,3569,198,8,7,15,53.3%,19m
6227,2,[H3xPr0]Mwahaha,3569,192,6,4,10,60.0%,37m
6227,2,Moloch,3569,148,5,8,13,38.5%,5m
6227,2,[EvilGC]INAD,3569,0,1,1,2,50.0%,28m
6227,2,Todar,3569,30,1,2,3,33.3%,13m
6227,2,MasterChef,3569,0,0,1,1,0.0%,29m
6237,2,DavetheBrave,3568,1173,68,51,119,57.1%,8m
6237,2,RaulPudd,3568,425,56,41,97,57.7%,5m
6237,2,[Big117]theprobelem,3568,973,40,32,72,55.6%,35m
6237,2,llllllllllll,3568,623,30,17,47,63.8%,29m
6237,2,[S4RK]Rafo,3568,584,25,25,50,50.0%,36m
6237,2,llllllllllll,3568,391,20,7,27,74.1%,31m
6237,2,Morgasm,3568,201,19,6,25,76.0%,33m
6237,3,Borat,3568,352,16,8,24,66.7%,34m
6237,2,Ragelot,3568,363,12,11,23,52.2%,18m
6237,2,llllllllll,3568,325,11,7,18,61.1%,32m
6237,2,WellDone,3568,133,7,1,8,87.5%,17m
6237,3,Sam,3568,0,2,2,4,50.0%,32m
6237,2,DarkFart,3568,0,1,0,1,100.0%,37m
6237,2,Egoist,3568,0,1,0,1,100.0%,11m
6237,2,[EZTAXI]GreatGoomba,3568,0,0,1,1,0.0%,36m
6237,2,[DHZAcD]Andprett,3568,0,0,4,4,0.0%,24m
6237,2,llllllllllll,3568,0,0,6,6,0.0%,8m
6254,2,[YD2K]llllllllllll,3567,1466,344,321,665,51.7%,33m
6254,2,[OndaVT]Frank,3567,1405,176,175,351,50.1%,25m
6254,2,Bob,3567,1316,103,104,207,49.8%,24m
6254,2,[Frolik]jykknti,3567,1192,72,66,138,52.2%,29m
6254,2,DreamX,3567,923,56,39,95,58.9%,23m
6254,2,llllllllllll,3567,750,26,31,57,45.6%,8m
6254,2,[cloudM]ZAV,3567,345,17,9,26,65.4%,17m
6254,2,[DhZon3]Tonny,3567,329,13,12,25,52.0%,29m
6254,2,IIIIIIIIII,3567,240,12,8,20,60.0%,30m
6254,2,Magic,3567,30,2,4,6,33.3%,20m
6254,2,[αB]AlCaPwneD,3567,0,2,5,7,28.6%,29m
6254,2,Dranzer,3567,0,0,2,2,0.0%,16m
6254,2,Badboy,3567,0,0,5,5,0.0%,32m
6267,2,[OGbros]Charuka,3566,1018,37,40,77,48.1%,7m
6267,2,[ZerO]kingapes,3566,670,27,19,46,58.7%,30m
6267,2,Posey,3566,430,24,14,38,63.2%,33m
6267,2,KimchiStorm,3566,321,18,7,25,72.0%,31m
6267,2,[XpKAc]Turón,3566,184,17,13,30,56.7%,2h
6267,2,[JB]ROFLisk,3566,486,17,20,37,45.9%,12m
6267,2,Mint,3566,164,8,1,9,88.9%,14m
6267,2,Balancer,3566,192,8,4,12,66.7%,25m
6267,2,vodoi,3566,102,6,1,7,85.7%,4m
6276,2,[BruC]RSyfer,3565,1340,266,250,516,51.6%,12m
6276,2,Jeurekan,3565,1589,212,199,411,51.6%,33m
6276,2,SinGiRu,3565,1272,94,68,162,58.0%,28m
6276,2,melciro,3565,786,32,25,57,56.1%,37m
6276,2,[xLgNx]MushyMigushy,3565,369,30,22,52,57.7%,22m
6276,2,[SsaYnS]Eggnog,3565,578,28,14,42,66.7%,29m
6276,2,AlDente,3565,270,11,5,16,68.8%,7m
6276,2,KasakiNozomi,3565,168,5,3,8,62.5%,12m
6276,3,TethRa,3565,0,4,1,5,80.0%,5m
6276,3,MOMOSED,3565,0,3,2,5,60.0%,2h
6276,2,[funand]Serral,3565,60,3,5,8,37.5%,12m
6276,2,[3runo]Dhenn,3565,88,2,0,2,100.0%,24m
6276,1,KurtBlock,3565,0,1,0,1,100.0%,31m
6276,2,TANIOS,3565,0,0,1,1,0.0%,36m
6276,2,[eXoPH]eXoSkeletor,3565,0,0,2,2,0.0%,8m
6291,2,RCon,3564,1475,209,203,412,50.7%,30m
6291,2,nebule,3564,1570,135,131,266,50.8%,23m
6291,2,bnett,3564,1527,135,138,273,49.5%,17m
6291,2,[TDX]LittyKitty,3564,1574,85,72,157,54.1%,31m
6291,2,[Cheees]NickTactics,3564,1436,67,45,112,59.8%,8m
6291,2,Nimzo,3564,792,39,25,64,60.9%,40m
6291,2,Spoody,3564,749,38,28,66,57.6%,20m
6291,2,Exterminator,3564,796,29,33,62,46.8%,6m
6291,2,[oJKo]MolyPercocet,3564,427,27,16,43,62.8%,21m
6291,2,Magus,3564,580,26,21,47,55.3%,12m
6291,2,Marauder,3564,353,14,12,26,53.8%,33m
6291,2,[EtrOy]hairyewok,3564,224,10,13,23,43.5%,35m
6291,2,BoricuaMob,3564,218,9,4,13,69.2%,4m
6291,3,llllllllllll,3564,0,5,0,5,100.0%,38m
6291,3,adL,3564,0,0,1,1,0.0%,23m
6291,2,[Cind3r]FightDiaper,3564,0,0,2,2,0.0%,36m
6307,2,BillySlater,3563,1614,162,155,317,51.1%,9m
6307,2,Azrael,3563,1513,94,95,189,49.7%,9m
6307,2,ZoserMaster,3563,1293,92,89,181,50.8%,29m
6307,2,ViCE,3563,880,54,37,91,59.3%,5m
6307,2,FreeHongKong,3563,569,23,17,40,57.5%,26m
6307,2,[REALG4]yaguarii,3563,440,16,18,34,47.1%,24m
6307,2,[Ari]beanjuice,3563,265,13,15,28,46.4%,18m
6307,2,HyperDragoon,3563,254,10,10,20,50.0%,41m
6307,2,[TMEvil]wrath,3563,88,4,4,8,50.0%,22m
6307,2,Duck,3563,0,1,4,5,20.0%,24m
6317,2,Vales,3562,1072,180,145,325,55.4%,20m
6317,2,chacanal,3562,1527,107,113,220,48.6%,40m
6317,2,NoxyBo,3562,1163,101,94,195,51.8%,19m
6317,2,illfingas,3562,1098,93,85,178,52.2%,7m
6317,2,cesar,3562,1203,86,18,104,82.7%,16m
6317,2,Marcus,3562,406,60,49,109,55.0%,22m
6317,2,brofessor,3562,449,59,45,104,56.7%,25m
6317,2,[LOHs]Diogenes,3562,1143,48,41,89,53.9%,6m
6317,2,ElectricEye,3562,740,37,28,65,56.9%,27m
6317,2,[SSJ4]Kevgeta,3562,491,31,20,51,60.8%,29m
6317,2,HUASCAR,3562,532,20,19,39,51.3%,22m
6317,2,[xTQc]WishDeath,3562,206,9,3,12,75.0%,25m
6317,2,ZChen,3562,193,7,3,10,70.0%,20m
6317,2,Tosh,3562,88,4,9,13,30.8%,22m
6317,2,aaa,3562,112,3,1,4,75.0%,31m
6317,2,[WDC]arrexx,3562,0,1,0,1,100.0%,38m
6317,2,kkiatho,3562,0,0,1,1,0.0%,31m
6317,2,SwtDrms,3562,0,0,1,1,0.0%,2h
6335,2,Krabs,3561,1467,272,245,517,52.6%,35m
6335,2,[dreamT]Ragmond,3561,1555,237,221,458,51.7%,30m
6335,2,greySky,3561,1210,85,71,156,54.5%,29m
6335,2,[KiTeam]RochA,3561,1307,54,47,101,53.5%,35m
6335,2,Kariack,3561,854,49,31,80,61.2%,18m
6335,2,[DTokes]Chickenhawk,3561,1001,40,34,74,54.1%,40m
6335,2,[EZDUNK]Paradox,3561,368,14,13,27,51.9%,15m
6335,2,Slaytoven,3561,306,12,10,22,54.5%,35m
6335,2,[GR33D]Boom,3561,122,5,6,11,45.5%,41m
6335,1,Nictimus,3561,169,3,4,7,42.9%,32m
6335,2,[BobBrz]Trufflebase,3561,58,2,4,6,33.3%,41m
6335,2,[AD3C]aZoJuAnO,3561,0,0,1,1,0.0%,32m
6335,3,[EvilGC]MaxFire,3561,0,0,5,5,0.0%,21m
6348,1,[SsaYnS]Fastestcanon,3560,1742,188,185,373,50.4%,16m
6348,2,Megaman,3560,1178,156,146,302,51.7%,37m
6348,2,DABO,3560,1285,58,43,101,57.4%,4m
6348,2,Zerg,3560,865,38,29,67,56.7%,36m
6348,2,CateDraL,3560,818,37,26,63,58.7%,29m
6348,2,[FFAA]KINGWAR,3560,690,25,26,51,49.0%,41m
6348,1,[Maaate]BroodMother,3560,408,25,35,60,41.7%,40m
6348,2,[ValidG]Ins,3560,193,7,3,10,70.0%,24m
6348,2,[GIBE]Flowers,3560,142,6,5,11,54.5%,12m
6348,2,[PTHero]Ganondorf,3560,144,5,0,5,100.0%,16m
6348,2,lllllllllll,3560,130,4,2,6,66.7%,37m
6348,2,Dylsta,3560,114,4,7,11,36.4%,14m
6348,3,qqqqqq,3560,0,1,0,1,100.0%,32m
6348,2,[TRTR]Deas,3560,0,0,1,1,0.0%,24m
6348,2,TROGDOR,3560,0,0,1,1,0.0%,19m
6348,2,Terran,3560,0,0,1,1,0.0%,40m
6364,2,[AD3C]Asth,3559,842,77,64,141,54.6%,29m
6364,2,BigWolf,3559,1516,70,60,130,53.8%,2h
6364,2,Fecal,3559,1141,53,43,96,55.2%,29m
6364,2,Necro,3559,534,42,45,87,48.3%,9m
6364,2,Gamerdevotee,3559,767,38,22,60,63.3%,5m
6364,2,McWolf,3559,710,34,23,57,59.6%,4m
6364,2,XenoMorphinG,3559,422,29,3,32,90.6%,6m
6364,2,ERYZ,3559,431,20,8,28,71.4%,39m
6364,2,Maru,3559,317,14,9,23,60.9%,13m
6364,2,DeDeDeDerp,3559,88,6,0,6,100.0%,32m
6364,2,[proXG]Dashkee,3559,0,0,3,3,0.0%,24m
6375,2,CapnAmerica,3558,705,30,24,54,55.6%,37m
6375,2,[OceanT]LowLinK,3558,536,22,23,45,48.9%,27m
6375,2,Surtha,3558,208,12,7,19,63.2%,26m
6375,2,[OceanT]MarcusOS,3558,320,11,9,20,55.0%,36m
6375,2,[Zaphod]BeebleBrox,3558,0,5,0,5,100.0%,11m
6375,1,[MAGA21]ScoTT,3558,119,5,6,11,45.5%,12m
6375,2,dcfm,3558,114,4,7,11,36.4%,15m
6375,2,Battle,3558,95,1,1,2,50.0%,12m
6375,2,BigPurplDino,3558,0,1,3,4,25.0%,33m
6375,2,WhoAU,3558,0,0,2,2,0.0%,32m
6385,2,[TGosuB]Dream,3557,1564,127,110,237,53.6%,18m
6385,2,TheOx,3557,1252,66,72,138,47.8%,24m
6385,2,[NBlade]Dragonrite,3557,409,46,43,89,51.7%,9m
6385,2,[BOERUH]Kuma,3557,586,28,18,46,60.9%,25m
6385,2,[FakDia]chocointel,3557,395,17,10,27,63.0%,11m
6385,2,RoyaleWChees,3557,333,15,12,27,55.6%,24m
6385,2,UHUstic,3557,279,13,4,17,76.5%,29m
6385,2,[LMONEY]BOB,3557,306,13,7,20,65.0%,28m
6385,1,Sal,3557,232,10,3,13,76.9%,18m
6385,1,IIIIIIIIIIII,3557,237,8,6,14,57.1%,16m
6385,2,ljamericanpa,3557,191,8,8,16,50.0%,32m
6385,3,mACROpLAYER,3557,0,5,0,5,100.0%,33m
6385,2,chakattakk,3557,120,4,0,4,100.0%,35m
6385,2,[S0mBr4]MzT,3557,0,1,0,1,100.0%,38m
6385,2,NeverEnds,3557,0,1,0,1,100.0%,15m
6385,2,[DhZPro]Terranosaur,3557,30,1,3,4,25.0%,37m
6385,2,[GR33D]wert,3557,0,0,1,1,0.0%,37m
6385,1,[ExcIgN]SlayersBoxer,3557,0,0,3,3,0.0%,28m
6403,2,sausage,3556,1579,129,127,256,50.4%,22m
6403,2,[Bawler]Busdriver,3556,534,29,16,45,64.4%,30m
6403,2,[GnR]OmegaLSA,3556,574,22,25,47,46.8%,24m
6403,2,AseroPh,3556,425,17,8,25,68.0%,29m
6403,2,[Cryptc]Tiger,3556,180,9,1,10,90.0%,9m
6403,2,ANIBAL,3556,142,8,2,10,80.0%,16m
6403,2,Storm,3556,141,7,2,9,77.8%,21m
6403,2,SupPaillette,3556,0,5,0,5,100.0%,7m
6403,2,spvpsdl,3556,0,5,0,5,100.0%,30m
6403,2,Orangie,3556,172,3,8,11,27.3%,9m
6403,2,PPAP,3556,0,2,3,5,40.0%,37m
6403,1,Darees,3556,48,1,1,2,50.0%,38m
6403,2,Legolas,3556,88,1,1,2,50.0%,40m
6403,3,[B0N3R]Kino,3556,0,0,1,1,0.0%,23m
6403,2,[MdCzBd]Charkosh,3556,0,0,1,1,0.0%,7m
6418,2,Hero,3555,1574,210,199,409,51.3%,25m
6418,2,SoulArisen,3555,505,71,48,119,59.7%,41m
6418,2,[731]Underdog,3555,838,29,37,66,43.9%,20m
6418,2,Escombraura,3555,235,9,5,14,64.3%,24m
6418,2,[MdF]Domsaleo,3555,128,4,1,5,80.0%,12m
6418,2,[VNZ]LamWilliamW,3555,0,1,0,1,100.0%,35m
6424,2,Trillix,3554,674,73,56,129,56.6%,29m
6424,2,[TSFs]lmi,3554,1422,61,50,111,55.0%,8m
6424,2,[GldBoy]RaccoonMan,3554,609,34,24,58,58.6%,41m
6424,2,TRex,3554,516,30,12,42,71.4%,40m
6424,2,[XpKb]GansitoUwU,3554,335,14,8,22,63.6%,26m
6424,3,PurpleLemon,3554,266,8,7,15,53.3%,39m
6424,2,[PobSC]TommyShelby,3554,126,6,1,7,85.7%,26m
6424,2,Snøw,3554,188,6,4,10,60.0%,1m
6424,2,[MRCYLS]Wolven,3554,114,5,4,9,55.6%,36m
6424,2,[KGH]AnchorMan,3554,88,2,0,2,100.0%,17m
6424,2,[HvnDvl]Ekho,3554,0,1,0,1,100.0%,8m
6424,2,[SPARK]Wulfe,3554,0,0,1,1,0.0%,25m
6424,2,[GRNSKN]NeoZoom,3554,0,0,6,6,0.0%,18m
6437,2,Warfield,3553,655,91,94,185,49.2%,33m
6437,2,TooMuchLeaf,3553,738,70,57,127,55.1%,15m
6437,2,PriMo,3553,469,26,11,37,70.3%,7m
6437,2,Goon,3553,574,25,17,42,59.5%,10m
6437,2,curlz,3553,241,23,13,36,63.9%,25m
6437,2,[EzyPzY]EmperorKuzco,3553,415,22,15,37,59.5%,25m
6437,2,kwercu,3553,270,12,5,17,70.6%,8m
6437,2,Tossim,3553,204,11,8,19,57.9%,5m
6437,2,TZBerg,3553,236,8,12,20,40.0%,19m
6437,2,[Carton]lorecs,3553,208,7,7,14,50.0%,16m
6437,2,Kappa,3553,102,2,2,4,50.0%,7m
6437,2,[TGosuA]Purple,3553,88,1,1,2,50.0%,25m
6437,2,[TGosuB]soulninja,3553,30,1,3,4,25.0%,27m
6437,2,AlCoatk,3553,0,0,1,1,0.0%,35m
6437,3,LeToucan,3553,0,0,5,5,0.0%,20m
6452,2,TBZ,3552,898,99,84,183,54.1%,5m
6452,2,[LoF]MyMomIsAlive,3552,1074,97,104,201,48.3%,33m
6452,2,youngthug,3552,238,14,4,18,77.8%,30m
6452,2,BigDaddy,3552,338,12,15,27,44.4%,12m
6452,2,SeanKendich,3552,294,10,14,24,41.7%,30m
6452,2,PMA,3552,260,9,11,20,45.0%,33m
6452,2,Relentless,3552,0,0,3,3,0.0%,2m
6459,2,[KIOS]Tlaloc,3551,1244,235,217,452,52.0%,8m
6459,2,[KiTeam]Primo,3551,1181,53,37,90,58.9%,37m
6459,2,TooSly,3551,674,38,12,50,76.0%,7m
6459,2,Axuros,3551,753,34,23,57,59.6%,28m
6459,2,WerzMyBackup,3551,144,11,2,13,84.6%,21m
6459,2,[REALYY]hunnyzz,3551,212,11,3,14,78.6%,24m
6459,2,[Illini]ElevenPiece,3551,262,9,13,22,40.9%,24m
6459,2,RaZorX,3551,141,7,2,9,77.8%,41m
6459,2,aXBoulanger,3551,69,4,5,9,44.4%,24m
6459,1,[FEETww]FEETLOVER,3551,117,2,2,4,50.0%,18m
6459,2,exXxecutor,3551,0,2,3,5,40.0%,19m
6459,2,Specialist,3551,0,1,0,1,100.0%,12m
6459,2,Lucy,3551,88,1,1,2,50.0%,8m
6459,2,[MexSex]Lightning,3551,0,1,4,5,20.0%,33m
6473,2,[SsaYnS]wPsCheeZ,3550,1558,155,149,304,51.0%,19m
6473,2,[IWCP]snackerS,3550,1145,53,44,97,54.6%,7m
6473,2,Aporia,3550,548,42,51,93,45.2%,29m
6473,2,MrWhiskers,3550,637,38,26,64,59.4%,30m
6473,2,JETSKY,3550,490,19,15,34,55.9%,5m
6473,2,Espeon,3550,422,19,16,35,54.3%,18m
6473,2,NUKLS,3550,330,11,17,28,39.3%,8m
6473,2,[Gh0std]KobesPilotGG,3550,194,6,18,24,25.0%,25m
6473,2,MaryaReisy,3550,102,3,0,3,100.0%,12m
6473,2,ShushNoob,3550,0,0,5,5,0.0%,25m
6483,2,IPLObserver,3549,1478,71,62,133,53.4%,25m
6483,2,IIIIIIIIIIII,3549,747,53,34,87,60.9%,37m
6483,2,[TGosuA]Antilles,3549,546,27,15,42,64.3%,39m
6483,2,IlIlIlIlIlIl,3549,543,24,8,32,75.0%,24m
6483,2,SEREP,3549,241,16,10,26,61.5%,25m
6483,2,Dominants,3549,162,6,12,18,33.3%,15m
6483,2,[EZDUNK]Mindgames,3549,83,4,4,8,50.0%,27m
6490,2,[DieTry]Kira,3548,988,173,168,341,50.7%,29m
6490,1,Dutchy,3548,1687,122,140,262,46.6%,12m
6490,2,fallore,3548,876,42,50,92,45.7%,35m
6490,2,Repow,3548,258,39,20,59,66.1%,36m
6490,2,Whackatoe,3548,516,20,19,39,51.3%,40m
6490,2,black,3548,369,16,8,24,66.7%,36m
6490,3,dEaf,3548,376,15,4,19,78.9%,4m
6490,2,Quadace,3548,298,15,7,22,68.2%,18m
6490,2,[M1A5]Executor,3548,236,12,5,17,70.6%,17m
6490,2,LifeForce,3548,95,6,1,7,85.7%,40m
6490,2,[AFM]cookie,3548,167,6,2,8,75.0%,5m
6490,2,dslidd,3548,142,5,3,8,62.5%,19m
6490,2,Ayo,3548,100,3,13,16,18.8%,11m
6490,2,[WO0K]WhiteClaw,3548,0,1,0,1,100.0%,40m
6504,2,[iCOKi]RebornfOu,3547,762,54,58,112,48.2%,6m
6504,2,Chinosky,3547,808,51,55,106,48.1%,27m
6504,2,[SC2AU]vEnergyDrink,3547,924,36,39,75,48.0%,3m
6504,2,MacroPolo,3547,820,35,29,64,54.7%,11m
6504,2,[MLC]BATTLEBOY,3547,470,22,27,49,44.9%,22m
6504,1,NoName,3547,181,10,3,13,76.9%,36m
6504,2,Kogiro,3547,88,2,1,3,66.7%,35m
6504,2,IIIIIIIIIIII,3547,0,2,4,6,33.3%,31m
6504,3,[CLONEZ]KillerKoala,3547,0,0,1,1,0.0%,5m
6504,2,[AXAT]Ultramarine,3547,0,0,2,2,0.0%,9m
6504,2,Dakakal,3547,0,0,4,4,0.0%,22m
6515,2,[UpeV]ARTANIS,3546,1532,160,157,317,50.5%,10m
6515,2,Aiur,3546,646,29,19,48,60.4%,22m
6515,3,NoEffort,3546,295,14,4,18,77.8%,21m
6515,2,[werf]Bage,3546,284,11,7,18,61.1%,12m
6515,2,SeabsisKing,3546,142,7,1,8,87.5%,14m
6515,3,ASxRyan,3546,30,1,1,2,50.0%,19m
6515,2,SurySpark,3546,30,1,2,3,33.3%,36m
6515,2,dkssud,3546,30,1,2,3,33.3%,36m
6523,2,LAMOUR,3545,1504,120,131,251,47.8%,15m
6523,2,materux,3545,845,41,23,64,64.1%,31m
6523,2,[KhanTv]Khansten,3545,448,22,10,32,68.8%,5m
6523,2,JoeBidenHero,3545,339,16,25,41,39.0%,35m
6523,3,Blade,3545,0,5,0,5,100.0%,39m
6523,2,[CN123]LSAIsLoser,3545,153,5,3,8,62.5%,9m
6523,2,lamond,3545,122,4,6,10,40.0%,5m
6523,3,Kenbarria,3545,0,1,0,1,100.0%,27m
6523,3,iNeedWater,3545,30,1,1,2,50.0%,4m
6532,2,iTzOver,3544,1580,435,416,851,51.1%,29m
6532,2,djruk,3544,1585,115,99,214,53.7%,41m
6532,2,Betelgeuse,3544,430,27,28,55,49.1%,30m
6532,3,[UTS]oPsuperchan,3544,225,7,2,9,77.8%,10m
6532,3,whitebelft,3544,0,4,1,5,80.0%,25m
6532,3,ZZZ,3544,0,1,0,1,100.0%,29m
6532,3,CyberFunK,3544,0,1,0,1,100.0%,40m
6539,2,March,3543,870,116,95,211,55.0%,29m
6539,2,masterGIL,3543,777,33,25,58,56.9%,8m
6539,2,[TGosuA]Velious,3543,535,19,24,43,44.2%,24m
6539,2,TFlame,3543,146,6,5,11,54.5%,33m
6539,3,[INextI]Pain,3543,30,2,1,3,66.7%,14m
6539,3,[CAM]Khaydarin,3543,0,0,1,1,0.0%,21m
6539,3,AllMight,3543,0,0,1,1,0.0%,5m
6539,3,Infernal,3543,0,0,1,1,0.0%,31m
6547,2,Victarion,3542,1181,118,118,236,50.0%,27m
6547,2,[NPhasA]dethKraft,3542,1432,65,49,114,57.0%,35m
6547,2,[eFt0ss]Zerg,3542,1434,60,53,113,53.1%,24m
6547,2,Goon,3542,991,45,34,79,57.0%,25m
6547,2,[DarkAG]POWER,3542,810,30,37,67,44.8%,25m
6547,3,FleGiaS,3542,114,4,5,9,44.4%,17m
6547,2,Notorials,3542,90,4,6,10,40.0%,18m
6547,3,[xO]Prismal,3542,0,0,1,1,0.0%,40m
6547,2,[Pr0h4x]FiRiST,3542,0,0,2,2,0.0%,8m
6547,2,[LoFoTr]VadehT,3542,0,0,3,3,0.0%,35m
6547,2,ChairmanMaus,3542,0,0,5,5,0.0%,8m
6558,2,[Grand]CodeOfBars,3541,547,22,29,51,43.1%,15m
6558,2,Gypsy,3541,148,13,24,37,35.1%,41m
6558,3,[TR1LLY]SilenciOo,3541,314,12,7,19,63.2%,2m
6558,3,[kØ]Pain,3541,140,5,2,7,71.4%,30m
6558,3,kjpeans,3541,0,3,2,5,60.0%,22m
6558,3,Oxxus,3541,86,3,3,6,50.0%,38m
6558,2,Rowdydevil,3541,58,3,4,7,42.9%,30m
6558,2,TheArtOfWar,3541,92,3,7,10,30.0%,8m
6558,2,GuaBao,3541,30,2,3,5,40.0%,3m
6558,3,[FMX]FraperRush,3541,0,0,1,1,0.0%,17m
6558,3,IWillRushU,3541,0,0,1,1,0.0%,30m
6569,2,Jake,3540,1355,253,240,493,51.3%,38m
6569,2,[DarkAG]Horack,3540,1461,134,117,251,53.4%,2m
6569,2,RogueAI,3540,1558,120,120,240,50.0%,27m
6569,2,[plannB]Ryansdad,3540,1223,69,59,128,53.9%,27m
6569,2,[EMORY]FatGoose,3540,214,7,13,20,35.0%,19m
6569,2,steakncheese,3540,116,5,8,13,38.5%,7m
6569,2,[AIMBO]addpoke,3540,217,5,11,16,31.2%,5m
6569,3,KitoO,3540,0,4,1,5,80.0%,20m
6569,3,ASTIGER,3540,0,1,0,1,100.0%,41m
6578,2,[DarkAG]Duffy,3539,1661,800,797,1597,50.1%,16m
6578,2,PablosCruise,3539,1554,255,260,515,49.5%,41m
6578,2,[UUSoju]Wednesday,3539,1115,45,63,108,41.7%,9m
6578,3,Tursuc,3539,30,1,1,2,50.0%,29m
6578,3,Fayx,3539,30,1,2,3,33.3%,4m
6578,3,[TCAN]James,3539,0,0,1,1,0.0%,13m
6584,2,Barricade,3538,1314,154,133,287,53.7%,10m
6584,2,Invisiblesim,3538,1490,112,116,228,49.1%,37m
6584,3,heidanei,3538,1020,55,44,99,55.6%,4m
6584,2,Chris,3538,1055,45,38,83,54.2%,36m
6584,2,[SHWFTY]Seifert,3538,215,30,20,50,60.0%,31m
6584,2,IIIIIIIIIIII,3538,230,8,6,14,57.1%,25m
6584,3,MrLingo,3538,270,8,7,15,53.3%,4m
6584,2,LMAyO,3538,141,7,1,8,87.5%,30m
6584,2,TTY,3538,0,1,2,3,33.3%,38m
6584,2,[CeGa]Dave,3538,99,1,5,6,16.7%,40m
6584,3,Regis,3538,0,0,1,1,0.0%,21m
6584,1,[GBeans]SummiX,3538,0,0,5,5,0.0%,38m
6596,2,CapAmerica,3537,1529,320,320,640,50.0%,33m
6596,2,[InGt]Borss,3537,1502,126,119,245,51.4%,12m
6596,2,[PCAKE]Involution,3537,1568,68,66,134,50.7%,24m
6596,3,[NPhasA]mavrenick,3537,854,32,33,65,49.2%,20m
6596,3,[UpeV]Matt,3537,564,22,12,34,64.7%,19m
6596,2,Reyna,3537,460,17,18,35,48.6%,5m
6596,3,[xLgNx]terran,3537,412,14,14,28,50.0%,37m
6596,3,DrJAB,3537,140,5,3,8,62.5%,40m
6596,3,lllIIIlllIII,3537,86,4,0,4,100.0%,21m
6596,2,Rataerix,3537,88,4,4,8,50.0%,25m
6596,3,[PiGPan]MaruAmoriani,3537,0,3,2,5,60.0%,5m
6596,1,[AbcCo]ATField,3537,48,2,0,2,100.0%,17m
6596,2,[EZDUNK]Kriogenic,3537,30,1,6,7,14.3%,33m
6609,2,EliteTris,3536,1591,104,96,200,52.0%,20m
6609,2,statsfan,3536,736,31,23,54,57.4%,39m
6609,2,[TGCrew]Lithus,3536,116,5,6,11,45.5%,25m
6609,3,Zombielisk,3536,58,2,1,3,66.7%,10m
6609,3,PAPAMUSK,3536,0,0,1,1,0.0%,10m
6614,2,undefined,3535,1270,90,85,175,51.4%,36m
6614,3,Scruffy,3535,1261,64,51,115,55.7%,22m
6614,2,gravey,3535,1059,49,35,84,58.3%,20m
6614,2,Takra,3535,458,17,20,37,45.9%,29m
6614,2,DiaToX,3535,242,8,14,22,36.4%,1m
6614,2,[TLibre]XélHáYáotl,3535,158,6,9,15,40.0%,37m
6614,3,DUNCE,3535,0,5,0,5,100.0%,42m
6614,3,Patience,3535,0,4,0,4,100.0%,20m
6614,3,[VDNKh]ElHenryettas,3535,86,3,1,4,75.0%,18m
6614,3,Zooko,3535,0,1,0,1,100.0%,9m
6614,3,LeathalCard,3535,30,1,1,2,50.0%,38m
6614,2,oGizMo,3535,88,1,2,3,33.3%,19m
6614,3,[1414]Delusional,3535,0,0,1,1,0.0%,39m
6614,3,[TGosuA]KimJongBoom,3535,0,0,1,1,0.0%,1m
6628,2,Caluber,3534,524,25,13,38,65.8%,37m
6628,2,[IoO7]BigBoy,3534,398,18,9,27,66.7%,16m
6628,2,llllllllllll,3534,309,15,10,25,60.0%,30m
6628,2,[SHMALO]Python,3534,174,6,9,15,40.0%,25m
6628,2,YEEEEE,3534,0,1,0,1,100.0%,31m
6628,3,FiftyNinth,3534,30,1,1,2,50.0%,5m
6628,3,[999MS]RTWODOME,3534,97,1,1,2,50.0%,12m
6628,2,StOnedas,3534,30,1,14,15,6.7%,13m
6628,2,MrBadAss,3534,0,0,2,2,0.0%,31m
6637,2,[UpxV]PAINKILLER,3533,1550,440,433,873,50.4%,24m
6637,3,[AiMB]MissMicro,3533,1087,294,281,575,51.1%,30m
6637,3,[ZCCCFE]kaboom,3533,1154,80,55,135,59.3%,19m
6637,2,[GØSU]PickleWeed,3533,872,33,34,67,49.3%,17m
6637,2,Nagirrek,3533,218,8,10,18,44.4%,11m
6637,3,INeverLose,3533,0,5,0,5,100.0%,22m
6637,3,Who,3533,0,1,0,1,100.0%,35m
6637,2,Nerevar,3533,0,1,0,1,100.0%,5m
6637,2,FamilyValues,3533,0,1,4,5,20.0%,8m
6637,2,Joracon,3533,30,1,5,6,16.7%,11m
6637,3,KoeL,3533,0,0,1,1,0.0%,26m
6648,2,rnjsgusdyd,3532,1534,244,238,482,50.6%,9m
6648,2,fenor,3532,1033,53,20,73,72.6%,15m
6648,2,[Bipin]Varmina,3532,1174,46,47,93,49.5%,36m
6648,3,IIIIIIIIIIII,3532,832,38,23,61,62.3%,19m
6648,1,stärcraft,3532,212,10,3,13,76.9%,28m
6648,3,FartinG,3532,295,10,9,19,52.6%,8m
6648,3,[TSch]Trouble,3532,157,3,8,11,27.3%,35m
6648,2,MyLove,3532,94,1,1,2,50.0%,11m
6648,3,Chup,3532,0,0,1,1,0.0%,17m
6657,2,Chosen,3531,1448,126,110,236,53.4%,17m
6657,2,[BONCK]gDpaiN,3531,786,95,93,188,50.5%,9m
6657,2,[NEFN]Anachromy,3531,1043,39,48,87,44.8%,37m
6657,2,Ewanda,3531,904,38,30,68,55.9%,11m
6657,3,valithor,3531,517,24,12,36,66.7%,31m
6657,2,Bustguy,3531,281,10,9,19,52.6%,31m
6657,2,[YngGng]jimmy,3531,208,7,11,18,38.9%,18m
6657,3,Parsect,3531,86,4,1,5,80.0%,10m
6665,2,[MAFYIA]BryDollaSign,3530,1543,199,174,373,53.4%,3m
6665,2,TheEgo,3530,1329,126,119,245,51.4%,3m
6665,2,DoubleZee,3530,1070,76,73,149,51.0%,5m
6665,2,Future,3530,907,51,49,100,51.0%,38m
6665,2,Kaltmacher,3530,828,45,21,66,68.2%,40m
6665,2,MechBiden,3530,321,13,14,27,48.1%,8m
6665,2,DireBearForm,3530,274,11,10,21,52.4%,33m
6665,2,[PMSSS]Bobo,3530,166,5,3,8,62.5%,28m
6673,2,[GOPERÚ]dotaplayer,3529,913,125,107,232,53.9%,9m
6673,2,Reed,3529,578,123,122,245,50.2%,36m
6673,2,Gibs,3529,1164,56,45,101,55.4%,29m
6673,2,SirePotato,3529,1000,43,37,80,53.8%,8m
6673,3,Durkachan,3529,755,32,21,53,60.4%,14m
6673,2,Kaelus,3529,574,21,19,40,52.5%,5m
6673,2,RickDalton,3529,182,6,5,11,54.5%,6m
6673,2,[JEGUY]Halpha,3529,114,3,2,5,60.0%,6m
6673,3,[91Fans]Ezreal,3529,30,2,0,2,100.0%,2m
6673,3,Lithor,3529,0,1,0,1,100.0%,40m
6673,2,RealTalkRaVi,3529,30,1,4,5,20.0%,25m
6673,3,IFormidable,3529,0,0,1,1,0.0%,39m
6673,3,IceMan,3529,0,0,2,2,0.0%,12m
6686,3,Alekronos,3528,683,67,57,124,54.0%,34m
6686,3,[UniVV]NICE,3528,492,19,12,31,61.3%,6m
6686,2,Pizzascrolls,3528,164,8,5,13,61.5%,37m
6686,3,IIIIIIIIIIII,3528,93,6,1,7,85.7%,29m
6686,2,HolyCrap,3528,60,3,5,8,37.5%,29m
6686,2,RayShades,3528,60,3,5,8,37.5%,36m
6686,2,[GDTAzT]LSxNarGusx,3528,0,1,2,3,33.3%,40m
6686,3,[TLibre]MscalKarl,3528,0,0,1,1,0.0%,11m
6694,2,[DSGoku]ArgentSouL,3527,1621,127,114,241,52.7%,1m
6694,2,[Th3Bad]PeDroJuNiOR,3527,1497,102,93,195,52.3%,33m
6694,2,[kØ]GhOuL,3527,1443,75,64,139,54.0%,16m
6694,3,[FaseS]SAIKI,3527,538,21,12,33,63.6%,19m
6694,2,Umar,3527,0,1,0,1,100.0%,8m
6694,3,DomeREKTr,3527,0,1,0,1,100.0%,20m
6694,2,[RmH]Stickywick,3527,0,1,2,3,33.3%,24m
6701,2,[NTIC]WnManquito,3526,1546,404,403,807,50.1%,25m
6701,2,[COGN3]techboy,3526,1046,120,123,243,49.4%,30m
6701,2,[JaMiT]CareAgain,3526,257,15,39,54,27.8%,20m
6701,2,[UpeV]DayZ,3526,366,14,11,25,56.0%,20m
6701,3,[lHMOl]MooOne,3526,58,2,1,3,66.7%,35m
6701,3,TheStig,3526,58,2,1,3,66.7%,18m
6701,2,holaqhace,3526,0,0,3,3,0.0%,30m
6708,2,Solorolo,3525,1516,139,126,265,52.5%,40m
6708,2,Paoskie,3525,1499,84,82,166,50.6%,8m
6708,2,Vamos,3525,835,37,54,91,40.7%,8m
6708,2,tSsHaDoW,3525,296,10,17,27,37.0%,37m
6708,3,ReVitalized,3525,241,8,4,12,66.7%,25m
6708,2,llllllllllll,3525,167,5,5,10,50.0%,27m
6708,2,cdAuto,3525,48,3,3,6,50.0%,24m
6708,3,Raynor,3525,60,3,5,8,37.5%,10m
6708,3,Tossadar,3525,0,1,0,1,100.0%,2m
6708,2,DHustle,3525,0,0,4,4,0.0%,5m
6718,2,Piccolo,3524,1632,164,170,334,49.1%,33m
6718,3,[SAAM]PherisWiel,3524,1381,60,41,101,59.4%,21m
6718,3,EZZ,3524,220,6,7,13,46.2%,4m
6718,2,iAmZero,3524,150,6,10,16,37.5%,3m
6718,2,GPsRain,3524,130,5,2,7,71.4%,19m
6718,2,DonQuijote,3524,116,5,6,11,45.5%,27m
6718,3,JaimeL,3524,58,2,1,3,66.7%,11m
6718,3,Spiraled,3524,30,2,1,3,66.7%,23m
6726,2,[ChzMD]Cryptobiotic,3523,1559,235,239,474,49.6%,36m
6726,2,Nicodemus,3523,1538,181,168,349,51.9%,9m
6726,2,[LGNxx]Outlawz,3523,1276,47,61,108,43.5%,31m
6726,2,yoloswag,3523,335,13,10,23,56.5%,29m
6726,2,CHaSE,3523,128,4,2,6,66.7%,19m
6726,3,[PLA2N]tommygun,3523,60,3,5,8,37.5%,11m
6726,3,[aaiBBQ]MrFluffles,3523,30,2,1,3,66.7%,40m
6726,3,[touchy]Robtimus,3523,60,2,3,5,40.0%,14m
6726,3,Htown,3523,0,0,1,1,0.0%,42m
6726,2,mathew,3523,0,0,2,2,0.0%,12m
6736,2,Pwnerer,3522,1519,239,232,471,50.7%,9m
6736,2,[BWKngs]TFG,3522,1615,186,170,356,52.2%,1m
6736,2,ZeN,3522,1438,161,152,313,51.4%,27m
6736,2,[DarkAG]AeroSoap,3522,1192,54,63,117,46.2%,41m
6736,2,Primo,3522,965,43,30,73,58.9%,5m
6736,2,dead,3522,650,37,35,72,51.4%,33m
6736,2,[S0Bs]KevFabrikant,3522,266,9,8,17,52.9%,40m
6736,3,Nis,3522,0,5,0,5,100.0%,40m
6736,2,kayo,3522,143,4,3,7,57.1%,18m
6736,3,Chibabti,3522,58,2,1,3,66.7%,41m
6736,3,Jandro,3522,60,2,2,4,50.0%,31m
6736,3,[ixM]ROakenshield,3522,0,1,0,1,100.0%,8m
6736,3,RendeSZvous,3522,0,0,1,1,0.0%,40m
6736,3,[TINY]Daybreaker,3522,0,0,1,1,0.0%,42m
6750,2,RENASS,3521,1549,161,147,308,52.3%,4m
6750,3,Miyagi,3521,1615,71,58,129,55.0%,21m
6750,2,powerhouse,3521,755,35,21,56,62.5%,5m
6750,2,[NwAs]Ordin,3521,196,20,12,32,62.5%,3m
6750,3,newbie,3521,292,14,8,22,63.6%,3m
6750,2,Dylan,3521,60,3,4,7,42.9%,18m
6750,3,vme,3521,0,2,3,5,40.0%,26m
6750,3,Stramtheman,3521,0,0,1,1,0.0%,24m
6750,3,Simz,3521,0,0,1,1,0.0%,31m
6750,3,[INextI]Buho,3521,0,0,1,1,0.0%,25m
6750,3,[TGCF]Sebastiani,3521,0,0,1,1,0.0%,27m
6750,3,Pure,3521,0,0,2,2,0.0%,6m
6750,2,[FxB]zil,3521,0,0,3,3,0.0%,11m
6750,2,MrMAGII,3521,0,0,4,4,0.0%,33m
6764,2,[WCKIT]ArkhamArchon,3520,851,172,162,334,51.5%,33m
6764,3,LaquabAkhahb,3520,1515,132,75,207,63.8%,2m
6764,2,[ZTemp]Carnage,3520,612,33,40,73,45.2%,9m
6764,2,[Zyn]Zynastor,3520,487,24,14,38,63.2%,24m
6764,2,[QcScT]Roux,3520,468,24,25,49,49.0%,35m
6764,3,LudO,3520,332,12,8,20,60.0%,4m
6764,2,StarRider,3520,344,12,18,30,40.0%,26m
6764,2,Shnark,3520,154,6,2,8,75.0%,17m
6764,2,DarkNess,3520,161,5,5,10,50.0%,40m
6764,3,[SanaTW]SanaTwice,3520,0,1,0,1,100.0%,5m
6764,3,[A225]Ecnunn,3520,0,1,1,2,50.0%,35m
6764,3,[ABUSEp]MMrABUSER,3520,0,0,1,1,0.0%,4m
6776,2,NizzyP,3519,1386,78,70,148,52.7%,5m
6776,3,Angel,3519,433,53,42,95,55.8%,16m
6776,2,[PogoSq]Shenanigan,3519,609,29,21,50,58.0%,25m
6776,2,DROXS,3519,144,6,9,15,40.0%,29m
6776,2,[αX]NeRVe,3519,186,5,6,11,45.5%,15m
6776,3,Motion,3519,120,3,2,5,60.0%,14m
6776,3,[KMABKO]Stats,3519,0,0,1,1,0.0%,42m
6783,2,[BoAVN]Ice,3518,998,119,100,219,54.3%,26m
6783,2,Link,3518,1255,56,54,110,50.9%,38m
6783,2,Isu,3518,1086,56,54,110,50.9%,26m
6783,2,[CritGG]Tukatai,3518,694,29,43,72,40.3%,24m
6783,3,[KGH2]Typhon,3518,617,24,16,40,60.0%,35m
6783,3,Sakura,3518,316,14,4,18,77.8%,8m
6783,2,IlIlIlIlIlIl,3518,257,14,6,20,70.0%,40m
6783,2,xxxx,3518,186,10,4,14,71.4%,11m
6783,1,[Res1st]BigGucciSosa,3518,144,8,3,11,72.7%,26m
6783,3,DeepMind,3518,200,7,5,12,58.3%,20m
6783,3,[GrimmC]OsiRis,3518,0,5,0,5,100.0%,22m
6783,2,[Kekki]PyourK,3518,154,5,4,9,55.6%,27m
6783,3,[Satori]DjangoMan,3518,30,1,1,2,50.0%,28m
6783,3,[UFL]tianshi,3518,0,0,1,1,0.0%,35m
6783,3,[nG]KraKen,3518,0,0,1,1,0.0%,4m
6783,3,[RH]Rave,3518,0,0,1,1,0.0%,23m
6783,3,[KorWoo]woojung,3518,0,0,1,1,0.0%,23m
6783,3,hairEeE,3518,0,0,2,2,0.0%,16m
6801,2,[CD4G]Dranes,3517,1531,131,114,245,53.5%,18m
6801,2,[zeez]elegans,3517,1551,82,76,158,51.9%,23m
6801,3,IlIlIlIlIlIl,3517,0,5,0,5,100.0%,3m
6801,3,Rebent,3517,120,2,4,6,33.3%,18m
6801,3,[iMkS]KaLiD,3517,0,1,0,1,100.0%,19m
6801,3,davidit,3517,0,1,0,1,100.0%,18m
6801,3,MacroKing,3517,0,1,4,5,20.0%,20m
6801,3,cJc,3517,0,0,1,1,0.0%,1m
6809,2,Agustin,3516,828,148,144,292,50.7%,24m
6809,2,Rykes,3516,1325,147,121,268,54.9%,28m
6809,3,Hyun,3516,1250,48,46,94,51.1%,9m
6809,3,TBD,3516,563,34,12,46,73.9%,19m
6809,2,Lotus,3516,862,29,45,74,39.2%,16m
6809,2,Stumboy,3516,438,21,14,35,60.0%,37m
6809,3,maro,3516,172,10,4,14,71.4%,14m
6809,3,Avenger,3516,146,6,3,9,66.7%,28m
6809,2,[fatb0i]azaturi,3516,112,5,3,8,62.5%,27m
6809,2,[Th3Bad]TarcísioXD,3516,88,4,5,9,44.4%,7m
6809,3,DarkKnightAD,3516,30,2,1,3,66.7%,12m
6809,2,Zombiesaurus,3516,0,0,3,3,0.0%,26m
6821,2,[SCTF]Zen,3515,1257,132,117,249,53.0%,7m
6821,2,[SmUrF9]rugose,3515,607,24,24,48,50.0%,36m
6821,3,[LCKY]Lucky,3515,634,22,24,46,47.8%,19m
6821,2,[RIT]Goldy,3515,264,9,15,24,37.5%,40m
6821,3,Pong,3515,86,3,2,5,60.0%,24m
6821,2,[AngryB]Cheesy,3515,116,3,2,5,60.0%,20m
6821,3,ohey,3515,0,1,0,1,100.0%,21m
6821,3,SpiffyBiffy,3515,0,0,1,1,0.0%,24m
6829,2,[TGCF]Akima,3514,920,268,258,526,51.0%,36m
6829,3,[xRtGac]Medivac,3514,1434,59,46,105,56.2%,19m
6829,2,IIIIIIIIIIII,3514,266,9,16,25,36.0%,41m
6829,2,[MEP]TrueLegend,3514,142,5,3,8,62.5%,8m
6829,3,crunchatized,3514,0,1,0,1,100.0%,27m
6829,3,Jizzapadoo,3514,0,0,1,1,0.0%,4m
6835,2,[NPhasA]Defamation,3513,782,90,73,163,55.2%,5m
6835,2,Perry,3513,513,22,18,40,55.0%,35m
6835,2,Wolvrine,3513,438,17,22,39,43.6%,15m
6835,2,Konfusion,3513,238,9,12,21,42.9%,36m
6835,3,sonamoo,3513,0,2,3,5,40.0%,21m
6835,3,[KingSC]Gordito,3513,0,1,0,1,100.0%,40m
6835,2,Player,3513,0,0,3,3,0.0%,37m
6842,2,delay,3512,1570,99,94,193,51.3%,25m
6842,3,[EZDUNK]Alexius,3512,513,25,12,37,67.6%,38m
6842,3,[AltRT]Xerxes,3512,448,19,8,27,70.4%,13m
6842,2,[INcfan]HouseVibeZ,3512,254,12,8,20,60.0%,18m
6842,2,AMR,3512,336,12,13,25,48.0%,37m
6842,3,MingYungSon,3512,0,5,0,5,100.0%,30m
6842,2,FBHKreator,3512,152,4,6,10,40.0%,32m
6842,2,[Lp]ignacio,3512,58,3,6,9,33.3%,5m
6842,3,RaThak,3512,30,2,2,4,50.0%,5m
6842,3,Nahagliiv,3512,0,1,0,1,100.0%,5m
6842,3,DueSs,3512,0,0,1,1,0.0%,17m
6842,3,Drake,3512,0,0,1,1,0.0%,19m
6842,3,BanlieuThug,3512,0,0,1,1,0.0%,5m
6855,2,[SuperZ]Apple,3511,1129,105,97,202,52.0%,14m
6855,2,liberty,3511,517,30,36,66,45.5%,3m
6855,2,Gimmicking,3511,321,22,21,43,51.2%,40m
6855,2,[1vsM]CrimeWave,3511,504,18,21,39,46.2%,31m
6855,2,macrolord,3511,422,15,25,40,37.5%,12m
6855,2,[FxB]Dyncommon,3511,250,8,11,19,42.1%,37m
6855,3,[GGMESP]MarineQueen,3511,0,5,0,5,100.0%,6m
6855,2,MasterFree,3511,102,3,5,8,37.5%,4m
6855,3,[TYBROS]Yalmic,3511,0,0,1,1,0.0%,15m
6864,3,[ctrs]Naki,3510,1119,52,36,88,59.1%,8m
6864,3,squi,3510,828,33,23,56,58.9%,24m
6864,1,darkness,3510,840,20,49,69,29.0%,24m
6864,3,Cure,3510,383,14,8,22,63.6%,18m
6864,3,DizzyDwarf,3510,0,5,0,5,100.0%,9m
6864,3,veiledforest,3510,86,3,1,4,75.0%,4m
6864,3,HiTboXer,3510,30,1,2,3,33.3%,23m
6864,2,[NextDC]Sarasdrs,3510,30,1,4,5,20.0%,41m
6872,2,ILKETURTLES,3509,446,73,71,144,50.7%,22m
6872,2,FlavourTown,3509,213,13,17,30,43.3%,36m
6872,3,Gnomister,3509,0,5,0,5,100.0%,15m
6872,3,AnimeLove,3509,0,4,1,5,80.0%,14m
6872,3,[KiTeam]KitZoa,3509,30,2,0,2,100.0%,23m
6872,3,IIIIIIIIIIII,3509,30,1,1,2,50.0%,36m
6872,3,Blastoise,3509,30,1,2,3,33.3%,30m
6872,2,grrrrrrrrrrr,3509,0,1,2,3,33.3%,1m
6872,2,[HUSHrx]Ihaveissue,3509,88,1,3,4,25.0%,38m
6872,2,[IMDSI]Sarrel,3509,30,1,4,5,20.0%,24m
6872,3,Cassa,3509,0,0,1,1,0.0%,30m
6872,2,Remy,3509,0,0,3,3,0.0%,20m
6884,2,[AD3C]yenisimo,3508,670,127,115,242,52.5%,16m
6884,2,image,3508,284,86,85,171,50.3%,35m
6884,2,vforvicente,3508,421,36,20,56,64.3%,23m
6884,3,MKLOL,3508,302,13,6,19,68.4%,5m
6884,3,[RathFr]Perfection,3508,318,13,7,20,65.0%,4m
6884,3,KillaPat,3508,118,5,2,7,71.4%,14m
6884,3,Mentanje,3508,140,5,3,8,62.5%,35m
6884,2,FanofCloud,3508,30,2,7,9,22.2%,13m
6884,2,WhoAmI,3508,30,2,12,14,14.3%,1m
6884,3,FilthyBeaver,3508,30,1,2,3,33.3%,38m
6884,3,DasCeasar,3508,30,1,2,3,33.3%,31m
6884,3,PontiusPylon,3508,0,0,1,1,0.0%,2m
6884,3,[VENSC2]WALCER,3508,0,0,1,1,0.0%,29m
6884,3,Foltram,3508,0,0,2,2,0.0%,18m
6898,2,CallMeMike,3507,1576,267,269,536,49.8%,20m
6898,2,JeanMic,3507,1347,63,57,120,52.5%,24m
6898,2,[NIntN]Rhodesian,3507,966,43,48,91,47.3%,7m
6898,2,ASOTforever,3507,484,29,20,49,59.2%,23m
6898,2,MetaKnight,3507,682,24,31,55,43.6%,31m
6898,3,[TheReg]Frost,3507,330,13,6,19,68.4%,25m
6898,2,Swift,3507,326,11,18,29,37.9%,14m
6898,3,[GanGan]PLutO,3507,192,8,2,10,80.0%,40m
6898,3,[Xpk]LINGER,3507,86,4,1,5,80.0%,8m
6898,3,[iEtnD]Ginjutsu,3507,0,0,1,1,0.0%,10m
6898,3,smallPP,3507,0,0,2,2,0.0%,37m
6909,2,Diplomacy,3506,815,49,36,85,57.6%,25m
6909,2,Troy,3506,140,28,20,48,58.3%,9m
6909,2,ThManNervoso,3506,590,24,32,56,42.9%,9m
6909,3,[TBALL]ribwhich,3506,456,17,16,33,51.5%,16m
6909,2,[Xpk]PaTiMoViL,3506,430,17,16,33,51.5%,16m
6909,3,Spirithound,3506,120,5,3,8,62.5%,7m
6909,2,zaphyrae,3506,0,1,4,5,20.0%,36m
6909,3,CyberCorgi,3506,0,0,2,2,0.0%,6m
6917,2,[DarkAG]drolkrad,3505,1603,282,265,547,51.6%,29m
6917,2,ZestyDrink,3505,388,203,191,394,51.5%,5m
6917,2,[xLgNx]Treacherous,3505,1335,195,188,383,50.9%,17m
6917,3,NKAUL,3505,1027,175,168,343,51.0%,16m
6917,2,Devastator,3505,1151,162,169,331,48.9%,18m
6917,2,[GeM]standardNerd,3505,1114,155,141,296,52.4%,38m
6917,1,[Cryptc]EviLs,3505,1728,133,177,310,42.9%,36m
6917,2,MrDoughnuts,3505,603,98,77,175,56.0%,7m
6917,2,AngryEddie,3505,1052,87,74,161,54.0%,26m
6917,2,[2v2mas]SMAN,3505,820,34,28,62,54.8%,25m
6917,2,Snake,3505,436,22,12,34,64.7%,19m
6917,3,NerdChill,3505,354,13,8,21,61.9%,18m
6917,3,[SnDICE]IOIOII,3505,332,12,9,21,57.1%,13m
6917,3,IIIIIIIIIII,3505,192,8,2,10,80.0%,30m
6917,3,NeedApples,3505,0,4,0,4,100.0%,27m
6917,2,Syrreth,3505,92,4,8,12,33.3%,40m
6917,3,hennerox,3505,58,2,1,3,66.7%,25m
6917,3,[iCumz]JerkInHoff,3505,0,1,0,1,100.0%,30m
6935,2,triznels,3504,204,7,8,15,46.7%,35m
6935,3,Coffee,3504,193,5,2,7,71.4%,10m
6935,3,[V1RGN]Victory,3504,88,4,2,6,66.7%,5m
6935,3,[WHuaRo]HowTwo,3504,60,2,2,4,50.0%,16m
6935,2,BabyBamBoo,3504,30,2,5,7,28.6%,29m
6935,3,[NPhasA]SaitamaXDDD,3504,0,1,2,3,33.3%,2m
6941,2,[FFAA]Blackghost,3503,1516,117,109,226,51.8%,38m
6941,2,SoulArisen,3503,674,115,93,208,55.3%,13m
6941,2,[VFam2]EZDeschanel,3503,416,20,17,37,54.1%,12m
6941,3,Assassin,3503,281,12,9,21,57.1%,8m
6941,2,Amadeus,3503,124,2,6,8,25.0%,12m
6941,3,DiscountMule,3503,0,1,0,1,100.0%,15m
6941,3,ViNoTintO,3503,0,1,0,1,100.0%,7m
6941,3,BlueRare,3503,0,1,4,5,20.0%,28m
6941,3,[G1tgud]dinobear,3503,0,0,1,1,0.0%,6m
6941,3,CacheUseOnly,3503,0,0,1,1,0.0%,5m
6941,2,Renzo,3503,0,0,4,4,0.0%,21m
6952,2,SeltzerHero,3502,1530,348,333,681,51.1%,29m
6952,2,starcrap,3502,699,140,121,261,53.6%,23m
6952,2,Crusader,3502,1052,46,41,87,52.9%,3m
6952,3,DIALUP,3502,921,44,30,74,59.5%,24m
6952,3,Nerz,3502,490,24,0,24,100.0%,10m
6952,3,PyroPhoenyx,3502,213,6,5,11,54.5%,30m
6952,3,[Astute]ThaoTheSofa,3502,0,1,0,1,100.0%,13m
6952,3,MoriNana,3502,0,1,0,1,100.0%,42m
6960,2,Sherry,3501,1228,178,164,342,52.0%,8m
6960,2,[JaMiT]Nerd,3501,816,28,42,70,40.0%,11m
6960,2,IOI,3501,366,24,7,31,77.4%,7m
6960,2,Siriuz,3501,242,8,13,21,38.1%,36m
6960,3,Naigth,3501,192,7,6,13,53.8%,3m
6960,2,Kospov,3501,60,3,5,8,37.5%,5m
6960,3,moke,3501,30,1,1,2,50.0%,31m
6960,3,LSK,3501,0,0,1,1,0.0%,4m
6960,3,Yagami,3501,0,0,1,1,0.0%,38m
6960,3,[RBLLN]PadoruPadoru,3501,0,0,1,1,0.0%,16m
6970,2,JayFog,3500,1622,71,72,143,49.7%,29m
6970,2,Crim,3500,1508,66,62,128,51.6%,37m
6970,2,[OGbros]Amadeus,3500,1377,58,51,109,53.2%,2m
6970,2,yisus,3500,913,54,59,113,47.8%,24m
6970,2,BLitSon,3500,928,40,44,84,47.6%,7m
6970,2,IIIIIIIIIIII,3500,624,29,20,49,59.2%,25m
6970,2,CrazyChicken,3500,381,17,14,31,54.8%,8m
6970,3,dcare,3500,327,11,9,20,55.0%,15m
6970,3,MrPropox,3500,166,6,4,10,60.0%,39m
6970,2,[FMX]Acnologia,3500,180,6,12,18,33.3%,20m
6970,3,illionaire,3500,30,2,1,3,66.7%,14m
6970,2,AchtzehnZoll,3500,30,1,5,6,16.7%,18m
6982,3,[EvilCC]KREESTRO,3499,1632,204,195,399,51.1%,11m
6982,2,[ZOOMOB]DirtyHobo,3499,1337,60,51,111,54.1%,26m
6982,2,Pulsar,3499,708,31,23,54,57.4%,11m
6982,2,newbie,3499,402,27,40,67,40.3%,36m
6982,3,YorkHawk,3499,580,26,6,32,81.2%,27m
6982,3,potatohead,3499,372,14,10,24,58.3%,16m
6982,3,TheDudeChris,3499,258,12,6,18,66.7%,3m
6982,2,[2DVS]DiViNiTy,3499,357,12,13,25,48.0%,5m
6982,3,MiNatO,3499,40,6,1,7,85.7%,7m
6982,3,JCGamer,3499,0,5,0,5,100.0%,30m
6982,3,Jimson,3499,86,3,2,5,60.0%,39m
6982,3,[AMZN]Theios,3499,0,1,3,4,25.0%,34m
6994,2,Syzygy,3498,1124,38,51,89,42.7%,20m
6994,2,BungSai,3498,248,15,23,38,39.5%,9m
6994,2,rokgrlee,3498,348,13,10,23,56.5%,35m
6994,2,MXMEXICAN,3498,166,10,3,13,76.9%,37m
6994,2,Kaban,3498,159,7,9,16,43.8%,29m
6994,3,Dingles,3498,0,0,1,1,0.0%,10m
7000,2,Shine,3497,1634,175,161,336,52.1%,41m
7000,2,[pzv]superpants,3497,977,46,31,77,59.7%,11m
7000,3,[ML]Kronox,3497,330,26,16,42,61.9%,38m
7000,3,[CUMBAT]koi,3497,30,2,2,4,50.0%,24m
7000,3,[Cryptc]SirDidymus,3497,0,0,1,1,0.0%,27m
7005,2,DCB,3496,841,243,212,455,53.4%,38m
7005,3,Captainsalt,3496,1546,194,184,378,51.3%,20m
7005,3,GrimmingPitB,3496,1600,185,159,344,53.8%,22m
7005,2,TryHarD,3496,703,44,44,88,50.0%,7m
7005,3,ttk,3496,794,31,28,59,52.5%,22m
7005,2,[TXOP]Nimrod,3496,608,21,35,56,37.5%,2m
7005,2,Kur,3496,402,15,11,26,57.7%,38m
7005,2,CannonsSmurf,3496,274,14,10,24,58.3%,7m
7005,3,[AOTB]XxEliTeCLoWn,3496,239,12,7,19,63.2%,20m
7005,2,Thraundil,3496,178,6,8,14,42.9%,35m
7005,2,FistBruh,3496,94,5,2,7,71.4%,9m
7005,2,[LesAF]Guava,3496,146,5,12,17,29.4%,19m
7005,3,ForGlory,3496,0,4,0,4,100.0%,31m
7005,3,Barcode,3496,0,2,3,5,40.0%,29m
7005,3,[oSa]refriedbean,3496,0,1,0,1,100.0%,8m
7005,3,[LUFA]aTree,3496,0,1,0,1,100.0%,31m
7005,2,[NPhasA]Diego,3496,30,1,6,7,14.3%,10m
7005,3,Nethitters,3496,0,0,1,1,0.0%,3m
7005,1,[YD2K]KusanoYui,3496,0,0,4,4,0.0%,28m
7024,3,Acropolis,3495,860,45,33,78,57.7%,36m
7024,3,Tuxer,3495,844,38,22,60,63.3%,8m
7024,3,IUIU,3495,610,26,10,36,72.2%,16m
7024,2,llllllllllll,3495,636,25,25,50,50.0%,29m
7024,3,Reddington,3495,520,23,8,31,74.2%,1m
7024,3,[PMN]WhoGotDaMumf,3495,433,18,11,29,62.1%,3m
7024,3,[Cryptc]Legendary,3495,93,5,4,9,55.6%,2m
7024,3,sayID,3495,54,3,3,6,50.0%,32m
7024,3,Nibbler,3495,30,2,0,2,100.0%,28m
7024,3,Dingasaurus,3495,0,1,1,2,50.0%,23m
7024,1,[urdone]BrendaRush,3495,0,0,1,1,0.0%,38m
7024,3,Tanagra,3495,0,0,2,2,0.0%,21m
7036,2,[Nua]pattaya,3494,1511,160,130,290,55.2%,12m
7036,2,FrosT,3494,1147,49,40,89,55.1%,41m
7036,3,duddle,3494,160,29,25,54,53.7%,11m
7036,3,Basileus,3494,440,20,15,35,57.1%,15m
7036,2,[HOV]RAV,3494,436,15,24,39,38.5%,41m
7036,2,[SdwGmg]Sonic,3494,124,4,8,12,33.3%,34m
7036,3,[PsyNRG]fumblinghobo,3494,0,1,0,1,100.0%,23m
7036,2,goldhat,3494,0,1,2,3,33.3%,7m
7044,3,[Xpk]DarKraii,3493,1038,39,39,78,50.0%,25m
7044,3,GinebraPh,3493,448,20,2,22,90.9%,23m
7044,3,Gerlan,3493,217,18,11,29,62.1%,8m
7044,2,[prOxi]Soulcry,3493,508,18,17,35,51.4%,11m
7044,2,TheUnseen,3493,293,11,11,22,50.0%,34m
7044,2,MrRoboto,3493,316,10,16,26,38.5%,1m
7044,2,[BAUS]farQ,3493,197,8,10,18,44.4%,18m
7044,3,[TCProG]MillerLee,3493,144,6,4,10,60.0%,4m
7044,2,[ON]scargkON,3493,167,5,6,11,45.5%,5m
7044,3,homestuck,3493,86,4,3,7,57.1%,16m
7044,2,UncleRico,3493,92,3,10,13,23.1%,11m
7044,3,ShowbuTerran,3493,0,0,1,1,0.0%,36m
7056,2,Nick,3492,1503,226,218,444,50.9%,37m
7056,2,Prime,3492,1551,115,107,222,51.8%,5m
7056,2,RussianVodka,3492,931,82,89,171,48.0%,15m
7056,3,IIIIIIIIIIII,3492,388,16,5,21,76.2%,9m
7056,3,TUSCAN,3492,0,5,0,5,100.0%,37m
7056,3,[Skwirl]Gazorp,3492,116,5,2,7,71.4%,4m
7056,2,MacroPro,3492,60,2,8,10,20.0%,11m
7056,3,[DNKMEM]EdgE,3492,0,0,3,3,0.0%,19m
7064,2,Yang,3491,1458,120,91,211,56.9%,25m
7064,2,[Fever]Astra,3491,712,98,89,187,52.4%,18m
7064,3,SCatological,3491,1161,50,32,82,61.0%,7m
7064,3,VictorUtah,3491,671,31,17,48,64.6%,28m
7064,2,Zero,3491,487,25,31,56,44.6%,21m
7064,3,sciyoshi,3491,406,14,17,31,45.2%,27m
7064,3,[PERSIA]KingS,3491,0,5,0,5,100.0%,27m
7064,2,GuitarGuy,3491,120,4,13,17,23.5%,37m
7064,3,Racres,3491,0,3,2,5,60.0%,20m
7064,3,muvsbrolol,3491,0,1,0,1,100.0%,35m
7064,3,Sypher,3491,0,0,1,1,0.0%,2m
7064,3,[Emb3rs]NeveaH,3491,0,0,1,1,0.0%,3m
7064,2,AlKanNot,3491,0,0,4,4,0.0%,5m
7077,2,GoGoSqueeze,3490,1581,133,142,275,48.4%,36m
7077,3,Elivyndyr,3490,1178,129,116,245,52.7%,8m
7077,2,[lMiAl]eLephaNt,3490,778,28,35,63,44.4%,20m
7077,2,[TOOHI]JeXeD,3490,477,18,18,36,50.0%,29m
7077,3,[UpeV]TATTO,3490,218,8,5,13,61.5%,2m
7077,3,llllllllll,3490,182,6,7,13,46.2%,35m
7077,2,Emu,3490,88,3,7,10,30.0%,27m
7077,3,CrimzOn,3490,0,1,0,1,100.0%,27m
7077,3,[NXLsc]memex,3490,0,0,1,1,0.0%,24m
7077,2,StaticDis,3490,0,0,11,11,0.0%,7m
7087,2,FUTECH,3489,1550,244,240,484,50.4%,24m
7087,2,Chooee,3489,314,14,11,25,56.0%,35m
7087,3,[Exper]DYa,3489,266,10,9,19,52.6%,5m
7087,2,llllllllllll,3489,228,8,8,16,50.0%,24m
7087,2,[SenraC]Mag,3489,243,8,9,17,47.1%,8m
7087,3,Dreamatose,3489,121,6,1,7,85.7%,6m
7087,3,Noobie,3489,142,5,4,9,55.6%,20m
7087,2,[flux]Dantaro,3489,130,4,4,8,50.0%,1m
7087,2,YoonA,3489,141,3,1,4,75.0%,11m
7087,3,SlayrOfSmoke,3489,86,3,3,6,50.0%,25m
7087,3,Billybeegood,3489,30,2,4,6,33.3%,25m
7087,3,sneferu,3489,30,1,1,2,50.0%,37m
7087,3,IceFire,3489,0,0,1,1,0.0%,23m
7100,2,TheRedAngel,3488,1592,362,365,727,49.8%,29m
7100,2,[ROCKSC]NoobRuLZ,3488,1514,118,109,227,52.0%,18m
7100,2,Butternuts,3488,765,103,90,193,53.4%,15m
7100,2,KaddyGirl,3488,858,31,30,61,50.8%,14m
7100,3,[NPhase]money,3488,756,29,25,54,53.7%,25m
7100,2,TrashCan,3488,461,21,29,50,42.0%,21m
7100,2,[Sinz]alex,3488,187,8,3,11,72.7%,23m
7100,3,MasterDre,3488,202,7,8,15,46.7%,28m
7100,3,Spheonix,3488,0,1,0,1,100.0%,8m
7100,3,[LGST]Jav,3488,30,1,1,2,50.0%,31m
7100,3,chippedstick,3488,30,1,2,3,33.3%,4m
7100,3,llllllllllll,3488,0,0,1,1,0.0%,37m
7112,2,SEMINENCE,3487,1324,86,76,162,53.1%,13m
7112,2,Oumuamua,3487,691,29,24,53,54.7%,29m
7112,3,atom,3487,473,18,8,26,69.2%,2m
7112,3,[Year06]Civ,3487,366,15,7,22,68.2%,6m
7112,2,llIllIIllll,3487,296,13,14,27,48.1%,35m
7112,2,[MOUNT]Flyboy,3487,184,6,10,16,37.5%,11m
7112,3,Xero,3487,114,4,3,7,57.1%,36m
7112,3,[TELMO]Mason,3487,58,2,3,5,40.0%,9m
7112,3,MaGiCFingers,3487,30,1,1,2,50.0%,19m
7112,3,IIlllIIIlIIl,3487,30,1,3,4,25.0%,8m
7112,3,Heisman,3487,0,0,1,1,0.0%,40m
7112,3,[XpKAc]HpLoveCraFt,3487,0,0,1,1,0.0%,13m
7112,2,INLreactor,3487,0,0,1,1,0.0%,19m
7125,2,[NOMMM]Giltron,3486,1577,232,220,452,51.3%,14m
7125,3,PaGaNs,3486,285,45,34,79,57.0%,40m
7125,2,bearUSC,3486,1042,44,36,80,55.0%,18m
7125,2,Keiwi,3486,1186,44,50,94,46.8%,27m
7125,3,Arean,3486,980,43,28,71,60.6%,15m
7125,3,[Kittie]TapS,3486,278,35,30,65,53.8%,23m
7125,3,[BIaze]Grey,3486,720,31,18,49,63.3%,28m
7125,3,SoapNShampoo,3486,556,25,13,38,65.8%,35m
7125,2,Wolf,3486,543,24,17,41,58.5%,25m
7125,2,[fqboi]Advantageous,3486,622,22,26,48,45.8%,23m
7125,2,avilofan,3486,346,18,10,28,64.3%,31m
7125,3,[ZTempz]EGIRLHUNTER,3486,0,5,0,5,100.0%,29m
7125,3,kiesiew,3486,0,5,0,5,100.0%,37m
7125,3,Barcode,3486,114,4,1,5,80.0%,21m
7125,3,[Lowko]Assassin,3486,0,0,1,1,0.0%,3m
7140,2,ShoryuKen,3485,1216,109,87,196,55.6%,31m
7140,2,BabyAddict,3485,1447,105,93,198,53.0%,27m
7140,3,[KRAFTT]EluSivE,3485,1188,54,51,105,51.4%,24m
7140,2,llllllllllll,3485,425,21,26,47,44.7%,25m
7140,2,slyr,3485,240,12,13,25,48.0%,19m
7140,3,jinso,3485,60,7,2,9,77.8%,35m
7140,2,ProbeDC,3485,198,6,7,13,46.2%,18m
7140,2,[scMAUI]mbarde,3485,148,6,15,21,28.6%,18m
7140,3,[scMAUI]Razer,3485,0,4,1,5,80.0%,21m
7140,3,[Mc]Sickcore,3485,30,2,1,3,66.7%,28m
7140,3,Jaguaticrazy,3485,0,1,0,1,100.0%,22m
7140,3,[UpeV]Kelevra,3485,30,1,2,3,33.3%,36m
7140,3,[lCeMan]iCeMan,3485,0,1,4,5,20.0%,40m
7140,1,[NAGARA]llllllllllll,3485,0,0,1,1,0.0%,3m
7154,3,[GOPERÚ]iProblem,3484,829,36,16,52,69.2%,13m
7154,2,[SGxx]Eville,3484,907,34,38,72,47.2%,36m
7154,3,Nerdrrage,3484,406,18,2,20,90.0%,15m
7154,2,imnoobNMU,3484,206,10,2,12,83.3%,8m
7154,3,Dreemurr,3484,166,6,2,8,75.0%,22m
7154,3,ProzeR,3484,0,5,0,5,100.0%,7m
7154,3,reaper,3484,0,5,0,5,100.0%,11m
7154,3,Error,3484,0,3,1,4,75.0%,23m
7154,3,Dijkstra,3484,0,0,1,1,0.0%,5m
7154,3,[TAOJ]Parasite,3484,0,0,1,1,0.0%,29m
7154,3,KokeIG,3484,0,0,3,3,0.0%,15m
7165,2,[FzyDG]BLaZe,3483,676,59,47,106,55.7%,11m
7165,3,IIIIIII,3483,456,18,13,31,58.1%,36m
7165,3,[BoAVN]MrChow,3483,0,1,0,1,100.0%,6m
7165,3,DanBass,3483,0,0,1,1,0.0%,4m
7169,1,[QTF]Tabarnak,3482,1683,238,256,494,48.2%,35m
7169,2,Bisu,3482,1551,145,150,295,49.2%,32m
7169,3,[LQV]MasterYoda,3482,1182,53,27,80,66.2%,22m
7169,3,ReIgNs,3482,1164,44,40,84,52.4%,28m
7169,3,tasdingos,3482,131,8,4,12,66.7%,6m
7169,3,darkyun,3482,144,6,7,13,46.2%,40m
7169,3,spook,3482,62,2,4,6,33.3%,11m
7169,1,Migue,3482,0,0,1,1,0.0%,36m
7177,3,llllllllllll,3481,114,5,0,5,100.0%,6m
7177,3,Chepi,3481,114,5,3,8,62.5%,11m
7177,2,MitraW,3481,116,4,3,7,57.1%,27m
7177,3,[LgnTDS]Locke,3481,122,2,4,6,33.3%,42m
7177,3,[4DPS]icedbalut,3481,0,1,0,1,100.0%,6m
7177,3,Disgrace,3481,30,1,2,3,33.3%,39m
7177,3,[N0BLE]Myth,3481,0,0,1,1,0.0%,42m
7184,2,[GGK]Symmetry,3480,1453,136,110,246,55.3%,4m
7184,2,[Pharoh]TheFeared,3480,1184,59,61,120,49.2%,35m
7184,2,Acrobionic,3480,1145,54,47,101,53.5%,20m
7184,3,porkythepig,3480,1061,44,33,77,57.1%,19m
7184,3,USSYamatoJPN,3480,699,29,21,50,58.0%,11m
7184,2,[ØFoxF2]Jimmy,3480,426,17,19,36,47.2%,9m
7184,3,[QRTINE]XXIIVIII,3480,256,11,9,20,55.0%,31m
7184,1,[R4GN]NEMESIS,3480,95,2,0,2,100.0%,18m
7184,3,glhf,3480,0,2,0,2,100.0%,2m
7193,2,ndn,3479,1394,354,332,686,51.6%,18m
7193,3,kuotoss,3479,1615,190,155,345,55.1%,33m
7193,2,dimidrol,3479,1309,92,72,164,56.1%,38m
7193,3,[LGNxx]Bellephron,3479,630,35,26,61,57.4%,16m
7193,3,[Freema]MorganFreema,3479,330,23,12,35,65.7%,7m
7193,3,Peaches,3479,338,14,11,25,56.0%,10m
7193,3,[ProVZ]ghostsniper,3479,0,5,0,5,100.0%,35m
7193,3,nanogeo,3479,0,2,3,5,40.0%,9m
7193,3,Frost,3479,0,1,1,2,50.0%,10m
7193,3,Gabriel,3479,0,0,1,1,0.0%,2m
7193,3,[kolkid]Fuzzy,3479,0,0,1,1,0.0%,2m
7204,3,[EndPro]PakoMx,3478,1196,50,39,89,56.2%,42m
7204,2,HDUnicorn,3478,808,36,29,65,55.4%,35m
7204,2,YoungRob,3478,178,28,27,55,50.9%,19m
7204,2,[VGL]Kid,3478,540,19,23,42,45.2%,29m
7204,3,[RBTH]NeO,3478,86,4,4,8,50.0%,11m
7204,3,Victor,3478,120,2,1,3,66.7%,23m
7204,2,ttdffhbb,3478,93,2,1,3,66.7%,7m
7204,3,RoLLo,3478,0,1,0,1,100.0%,36m
7204,3,[MOSSIE]Rangdaddy,3478,30,1,4,5,20.0%,16m
7204,3,[Jaeg3r]MetalWarrior,3478,0,0,1,1,0.0%,6m
7204,3,[AlIin]Firestar,3478,0,0,4,4,0.0%,16m
7215,3,Pipiska,3477,643,103,83,186,55.4%,27m
7215,2,[LifeF]LilEnchilada,3477,1480,69,63,132,52.3%,12m
7215,2,[PSU]Guillermoman,3477,1596,66,67,133,49.6%,36m
7215,2,[GOPERÚ]Angeluz,3477,1180,52,41,93,55.9%,8m
7215,3,[Xpk]Acceleratør,3477,994,40,31,71,56.3%,8m
7215,3,Moridin,3477,513,38,9,47,80.9%,39m
7215,2,[ShzG]Phin,3477,590,24,18,42,57.1%,34m
7215,3,Kudohlol,3477,482,20,14,34,58.8%,24m
7215,3,AIphaStar,3477,310,12,4,16,75.0%,34m
7215,3,[AIlin]Leon,3477,312,12,6,18,66.7%,24m
7215,3,NumberSix,3477,164,7,3,10,70.0%,21m
7215,1,AyoGG,3477,138,4,4,8,50.0%,30m
7215,3,[GRU]Heelion,3477,30,1,1,2,50.0%,33m
7215,3,[Vitami]Vitamins,3477,0,0,2,2,0.0%,15m
7215,1,ZealotLord,3477,0,0,2,2,0.0%,29m
7230,2,hongstar,3476,1552,169,168,337,50.1%,36m
7230,3,PhilipJFry,3476,1545,113,104,217,52.1%,18m
7230,2,[Remy]SoulRain,3476,1439,97,101,198,49.0%,35m
7230,2,BIGBRAIN,3476,471,83,76,159,52.2%,10m
7230,2,[iMkS]PAPU,3476,1523,69,63,132,52.3%,14m
7230,2,[EasyOn]Smile,3476,509,21,24,45,46.7%,36m
7230,2,ManAtSea,3476,588,21,31,52,40.4%,7m
7230,3,Lucky,3476,280,14,8,22,63.6%,2m
7230,3,Nemu,3476,0,5,0,5,100.0%,29m
7230,3,Dekron,3476,30,2,2,4,50.0%,17m
7240,3,LuckyLuciano,3475,1413,142,136,278,51.1%,36m
7240,2,[Artyk]Richarger,3475,1466,120,111,231,51.9%,11m
7240,2,odi,3475,1622,95,98,193,49.2%,37m
7240,3,[GdAT]ScarlettUK,3475,1241,65,55,120,54.2%,7m
7240,2,Beef,3475,614,28,19,47,59.6%,2m
7240,2,[RANDYZ]PickleLo,3475,336,17,24,41,41.5%,36m
7240,3,[prim8s]JBH,3475,412,16,12,28,57.1%,15m
7240,3,[PiGPan]Mediocre,3475,384,14,13,27,51.9%,28m
7240,1,onealio,3475,159,5,4,9,55.6%,12m
7240,2,Strybosch,3475,122,4,9,13,30.8%,5m
7240,3,[xFaDe]HealZ,3475,0,1,0,1,100.0%,36m
7240,3,rEVOLVEr,3475,30,1,2,3,33.3%,16m
7240,3,SaulGoodman,3475,0,0,1,1,0.0%,29m
7240,3,Clear,3475,0,0,1,1,0.0%,25m
7240,3,[FkJeff]ZuRa,3475,0,0,1,1,0.0%,39m
7255,2,Martanis,3474,1552,304,292,596,51.0%,24m
7255,3,[SsaYnS]Bloody,3474,1586,170,166,336,50.6%,13m
7255,3,Halcyon,3474,1570,117,114,231,50.6%,1m
7255,3,[Igbt]FlyinHealBus,3474,883,34,31,65,52.3%,42m
7255,2,Kleenex,3474,87,31,21,52,59.6%,9m
7255,3,Ustam,3474,169,23,20,43,53.5%,11m
7255,2,[Year06]Equipped,3474,546,21,24,45,46.7%,15m
7255,3,klover,3474,472,19,17,36,52.8%,5m
7255,3,CannonGambit,3474,368,16,8,24,66.7%,15m
7255,3,Dmutri,3474,234,9,8,17,52.9%,40m
7255,1,jibel,3474,161,5,1,6,83.3%,1m
7255,3,zeL,3474,146,5,5,10,50.0%,7m
7255,1,[HAAAAI]MiaTheDog,3474,166,4,3,7,57.1%,21m
7255,3,ratplague,3474,58,3,1,4,75.0%,20m
7255,3,[DTXt]Deluxe,3474,0,1,0,1,100.0%,25m
7255,3,UncleDiddler,3474,0,1,0,1,100.0%,15m
7255,3,[BallX]OralDishWash,3474,0,1,1,2,50.0%,37m
7255,3,[SigmaV]johnnyvowels,3474,0,0,1,1,0.0%,6m
7273,3,[Nipnum]Xpew,3473,478,37,30,67,55.2%,5m
7273,2,TrussesSuck,3473,424,15,22,37,40.5%,30m
7273,3,[2fps]Secret,3473,378,13,9,22,59.1%,16m
7273,3,[Frzen]Lanaya,3473,202,8,6,14,57.1%,14m
7273,2,KarmaPolice,3473,224,7,11,18,38.9%,11m
7273,3,Psycho,3473,140,6,4,10,60.0%,22m
7273,3,BPR,3473,97,5,1,6,83.3%,39m
7273,1,Bumfire,3473,143,4,7,11,36.4%,3m
7273,3,[T4TG]evansb,3473,88,3,4,7,42.9%,24m
7273,3,[NyVz]Depredador,3473,0,1,0,1,100.0%,19m
7273,2,Legacy,3473,0,1,0,1,100.0%,18m
7284,2,Schnitzel,3472,786,122,100,222,55.0%,15m
7284,3,ziongeneci,3472,1623,101,94,195,51.8%,24m
7284,3,straightup,3472,363,63,21,84,75.0%,27m
7284,2,[CHEASE]Cheezelord,3472,1191,44,46,90,48.9%,17m
7284,3,WaGe,3472,140,6,1,7,85.7%,42m
7284,3,JohnnyHiland,3472,116,4,3,7,57.1%,36m
7284,2,Kraulenth,3472,94,3,11,14,21.4%,41m
7284,3,llllllllllll,3472,30,2,1,3,66.7%,6m
7284,3,RustinCohle,3472,0,1,0,1,100.0%,34m
7293,2,[Lp]rayo,3471,1527,160,157,317,50.5%,29m
7293,2,Deezer,3471,854,121,116,237,51.1%,21m
7293,2,Silence,3471,1052,103,105,208,49.5%,9m
7293,2,[iS1MP]WinterKnight,3471,1113,61,60,121,50.4%,31m
7293,2,Rhagnar,3471,399,37,48,85,43.5%,29m
7293,3,TheBigCheese,3471,588,21,18,39,53.8%,38m
7293,3,[Th3Bad]matheusT,3471,444,19,9,28,67.9%,29m
7293,3,lllllIIIIIll,3471,439,18,14,32,56.2%,29m
7293,3,Fractal,3471,396,17,9,26,65.4%,19m
7293,3,Naimad,3471,217,10,3,13,76.9%,22m
7293,3,IlluziON,3471,262,10,10,20,50.0%,14m
7293,3,[HALPME]LifeAlert,3471,140,6,3,9,66.7%,8m
7293,3,Plural,3471,0,5,0,5,100.0%,30m
7293,3,[V6G]Heliumnite,3471,114,4,1,5,80.0%,16m
7293,3,[Pdonix]Komu,3471,74,4,1,5,80.0%,11m
7293,2,[VKNG5]RedHorse,3471,90,4,7,11,36.4%,26m
7293,3,Keaiwa,3471,0,0,1,1,0.0%,37m
7293,3,[InGt]Yukon,3471,0,0,2,2,0.0%,36m
7311,2,Harry,3470,1228,559,546,1105,50.6%,19m
7311,2,SkyyCaptain,3470,1513,226,189,415,54.5%,4m
7311,3,BYEDON,3470,1168,118,117,235,50.2%,42m
7311,3,Nanite,3470,1245,48,45,93,51.6%,34m
7311,3,glhf,3470,1008,45,33,78,57.7%,17m
7311,2,polenguinho,3470,860,38,28,66,57.6%,39m
7311,3,[DoRQ]Zimphar,3470,254,10,7,17,58.8%,6m
7311,3,[DTV]DiaXis,3470,58,2,1,3,66.7%,30m
7311,3,AyyyyCorona,3470,58,2,3,5,40.0%,4m
7311,3,Dvine,3470,60,2,3,5,40.0%,10m
7311,1,LuckyTiger,3470,0,1,0,1,100.0%,40m
7311,3,Zithax,3470,0,0,1,1,0.0%,23m
7311,3,[NPhasA]nevermore,3470,0,0,2,2,0.0%,22m
7311,3,[H3xPr0]snowditer,3470,0,0,3,3,0.0%,25m
7325,3,bwag,3469,1553,129,104,233,55.4%,35m
7325,2,[SC2BOI]khronox,3469,542,23,31,54,42.6%,35m
7325,2,SlaitlyTipsy,3469,323,16,10,26,61.5%,28m
7325,3,Singularity,3469,254,10,6,16,62.5%,17m
7325,2,[OhSnap]ItSOnRaNDoM,3469,241,8,10,18,44.4%,9m
7325,3,[LlGHT]HKPuffington,3469,30,2,0,2,100.0%,18m
7325,3,Smaug,3469,0,1,0,1,100.0%,13m
7325,2,[765]Bakon,3469,0,0,1,1,0.0%,16m
7325,3,Darklo,3469,0,0,1,1,0.0%,10m
7325,3,Zero,3469,0,0,1,1,0.0%,26m
7335,2,arkin,3468,1528,195,177,372,52.4%,18m
7335,2,[REPORT]JFLife,3468,1083,93,86,179,52.0%,16m
7335,2,[Gather]Athena,3468,478,25,32,57,43.9%,19m
7335,2,Phantom,3468,533,21,24,45,46.7%,2m
7335,2,Watertop,3468,404,15,18,33,45.5%,10m
7335,3,[EvilGC]ZpectroX,3468,134,6,6,12,50.0%,19m
7335,3,Zepp,3468,94,4,8,12,33.3%,11m
7335,3,Thaen,3468,90,3,5,8,37.5%,16m
7335,3,CAGS,3468,0,1,0,1,100.0%,9m
7335,3,Jpat,3468,30,1,1,2,50.0%,40m
7335,3,Humide,3468,0,0,1,1,0.0%,22m
7335,3,[PiGPan]Passionfruit,3468,0,0,1,1,0.0%,2m
7335,3,knight,3468,0,0,3,3,0.0%,7m
7348,2,Ding,3467,1237,179,174,353,50.7%,29m
7348,3,Phobophile,3467,625,21,19,40,52.5%,3m
7348,3,Andrei,3467,348,14,9,23,60.9%,30m
7348,3,[BIGBC]LeDerp,3467,328,13,10,23,56.5%,4m
7348,2,qwerty,3467,205,9,3,12,75.0%,23m
7348,2,nani,3467,183,9,4,13,69.2%,13m
7348,3,SwankyOrc,3467,0,0,2,2,0.0%,8m
7355,2,Hitchslap,3466,844,113,109,222,50.9%,18m
7355,2,[0sC]Azwraith,3466,1353,93,99,192,48.4%,29m
7355,2,[BTSX]snaglepuss,3466,1241,78,82,160,48.8%,31m
7355,3,gaygamer,3466,834,36,26,62,58.1%,29m
7355,3,[LFC]MamMoTH,3466,656,29,18,47,61.7%,2m
7355,3,TsogiMaster,3466,363,16,5,21,76.2%,21m
7355,3,bobby,3466,262,10,11,21,47.6%,5m
7355,2,theripperr,3466,184,6,3,9,66.7%,22m
7355,2,GreyFox,3466,154,5,10,15,33.3%,38m
7355,2,losthunter,3466,60,3,6,9,33.3%,18m
7355,2,[Cind3r]dreambeing,3466,139,3,8,11,27.3%,15m
7355,3,[1944]Spiritforged,3466,0,1,1,2,50.0%,37m
7355,3,RisottoNero,3466,30,1,1,2,50.0%,42m
7355,3,[KingSC]Alemania,3466,0,0,3,3,0.0%,19m
7369,3,Massta,3465,511,49,39,88,55.7%,20m
7369,3,darxon,3465,862,35,29,64,54.7%,17m
7369,2,[Rustla]Venat,3465,294,11,9,20,55.0%,11m
7369,3,lucifroom,3465,248,10,7,17,58.8%,2m
7369,2,[H3NTAl]Wion,3465,279,10,13,23,43.5%,7m
7369,2,GEGTSnatchY,3465,96,6,2,8,75.0%,20m
7369,3,Huijie,3465,144,5,3,8,62.5%,23m
7369,3,[LoAs]BiggieNTupac,3465,0,1,0,1,100.0%,11m
7369,3,Potato,3465,0,0,1,1,0.0%,22m
7369,3,MetalHorse,3465,0,0,1,1,0.0%,7m
7379,2,DimMak,3464,1367,222,225,447,49.7%,19m
7379,2,Morianer,3464,1568,115,95,210,54.8%,30m
7379,2,[GZRx]MrRochi,3464,1327,112,110,222,50.5%,3m
7379,3,lachancla,3464,1550,59,59,118,50.0%,15m
7379,3,Rhodoknight,3464,938,38,34,72,52.8%,28m
7379,2,DrWhom,3464,382,25,25,50,50.0%,30m
7379,2,Supersockz,3464,471,19,15,34,55.9%,18m
7379,3,RauLoKo,3464,268,10,5,15,66.7%,19m
7379,2,Preyed,3464,254,10,14,24,41.7%,10m
7379,3,[RaZerz]Achadian,3464,0,1,1,2,50.0%,24m
7379,3,Entropy,3464,0,0,1,1,0.0%,4m
7379,3,Zantetsuken,3464,0,0,1,1,0.0%,31m
7379,3,SonOfRouge,3464,0,0,1,1,0.0%,13m
7379,2,Xenon,3464,0,0,2,2,0.0%,10m
7379,2,Nightmare,3464,0,0,5,5,0.0%,21m
7394,3,[FyHr]PKMNIAC,3463,1391,60,50,110,54.5%,16m
7394,3,BizzaroBird,3463,1116,45,37,82,54.9%,3m
7394,2,[TGosuB]Parmigiano,3463,464,37,44,81,45.7%,34m
7394,3,dmin,3463,730,25,28,53,47.2%,14m
7394,2,[H3xPr0]DrPlato,3463,387,17,15,32,53.1%,37m
7394,3,Addison,3463,0,1,0,1,100.0%,3m
7394,3,DonMClean,3463,30,1,1,2,50.0%,15m
7394,3,ceturion,3463,30,1,1,2,50.0%,9m
7402,2,Zerashk,3462,1545,159,147,306,52.0%,3m
7402,3,[eX]KillerBR,3462,1199,52,40,92,56.5%,14m
7402,3,Chumbawamba,3462,712,27,29,56,48.2%,36m
7402,3,VoidRayOP,3462,574,23,17,40,57.5%,42m
7402,3,RawDeluxe,3462,632,22,26,48,45.8%,7m
7402,3,UroboroS,3462,227,17,14,31,54.8%,31m
7402,3,[V1RGN]Geoff,3462,242,12,6,18,66.7%,41m
7402,2,[TGosuD]hohner,3462,267,9,13,22,40.9%,41m
7402,2,Owaka,3462,184,7,11,18,38.9%,35m
7402,2,Dostress,3462,118,3,1,4,75.0%,23m
7402,3,Bishop,3462,0,0,1,1,0.0%,23m
7413,3,[FoBro]Phish,3461,616,29,17,46,63.0%,24m
7413,2,[Zatra]zid,3461,298,10,16,26,38.5%,36m
7413,2,[BScard]BossHogg,3461,140,5,5,10,50.0%,31m
7413,3,Draven,3461,0,0,1,1,0.0%,4m
7413,3,JDP,3461,0,0,1,1,0.0%,4m
7418,2,[YD2K]Jamintpot,3460,1575,236,238,474,49.8%,40m
7418,2,KingDragon,3460,1465,109,95,204,53.4%,28m
7418,3,Moo,3460,625,63,26,89,70.8%,11m
7418,2,Sosa,3460,871,54,48,102,52.9%,13m
7418,2,ADSCFT,3460,579,31,15,46,67.4%,8m
7418,3,HughMungus,3460,540,22,13,35,62.9%,13m
7418,3,iAmNesTea,3460,202,8,7,15,53.3%,29m
7418,3,llllllllllll,3460,226,8,9,17,47.1%,19m
7418,1,Ill,3460,215,7,6,13,53.8%,31m
7418,3,[SCLA]WiperElite,3460,0,1,0,1,100.0%,26m
7418,3,[LYD]TARKANLORKY,3460,30,1,2,3,33.3%,5m
7418,3,[QTp2T]CaptAmerica,3460,30,1,3,4,25.0%,16m
7418,2,[KoSsc2]Space,3460,30,1,10,11,9.1%,25m
7418,3,[xglHDx]OfwOrlds,3460,0,0,1,1,0.0%,15m
7432,2,[Dadash]Chiewy,3459,1588,420,404,824,51.0%,29m
7432,3,[ExcIgN]sebastis,3459,1610,90,65,155,58.1%,19m
7432,2,[lLiTl]Bopper,3459,1254,51,57,108,47.2%,41m
7432,2,[TeamUR]Andacht,3459,1029,40,41,81,49.4%,26m
7432,2,Aitian,3459,634,36,37,73,49.3%,13m
7432,3,cdo,3459,354,14,14,28,50.0%,22m
7432,3,[W33b4u]Dejablue,3459,114,4,4,8,50.0%,39m
7432,2,SorroW,3459,0,3,5,8,37.5%,13m
7432,3,AllLivesMatR,3459,86,3,6,9,33.3%,11m
7432,1,DeafAndBlind,3459,0,0,1,1,0.0%,4m
7442,2,hotdog,3458,1309,353,338,691,51.1%,4m
7442,2,Moose,3458,1472,118,110,228,51.8%,5m
7442,2,[cell5]BigmaC,3458,807,118,125,243,48.6%,31m
7442,3,IIIIIIIIIIII,3458,1487,97,95,192,50.5%,10m
7442,2,[PEINF]Jounez,3458,1189,81,89,170,47.6%,9m
7442,2,[TELMO]Fraggle,3458,461,39,44,83,47.0%,9m
7442,3,[SvgApe]SquidBoi,3458,785,32,25,57,56.1%,16m
7442,3,iLBuho,3458,751,30,19,49,61.2%,11m
7442,2,[iDrunk]Zach,3458,678,22,36,58,37.9%,27m
7442,2,[FaTlAd]ProtossHero,3458,448,19,17,36,52.8%,17m
7442,3,[BiZKiT]DEATHPROOF,3458,248,10,6,16,62.5%,29m
7442,3,Boot,3458,146,9,3,12,75.0%,31m
7442,3,PickMeUpLove,3458,114,8,2,10,80.0%,10m
7442,3,GypsyDanger,3458,58,3,4,7,42.9%,37m
7442,3,[nPnSX]Hippyjet,3458,90,3,5,8,37.5%,32m
7442,3,IlIIIIIIIl,3458,60,2,6,8,25.0%,16m
7442,3,[JBRONI]TerranDan,3458,0,1,0,1,100.0%,3m
7442,3,Spike,3458,0,1,0,1,100.0%,9m
7442,3,TheDoomDonut,3458,0,1,2,3,33.3%,8m
7442,3,Quicklash,3458,0,0,4,4,0.0%,18m
7462,2,JoeMufferaw,3457,1469,687,673,1360,50.5%,14m
7462,2,[USGUI]ReaDY,3457,1475,114,95,209,54.5%,41m
7462,2,[0lCRl0]MrHobo,3457,1184,52,51,103,50.5%,1m
7462,3,nymphen,3457,356,15,4,19,78.9%,14m
7462,2,Sirius,3457,238,7,11,18,38.9%,38m
7462,3,Combobreaker,3457,86,4,1,5,80.0%,5m
7462,3,hOoLiGaN,3457,0,1,0,1,100.0%,14m
7462,3,NutsoFast,3457,0,1,0,1,100.0%,19m
7462,3,[RUMB]Daddy,3457,0,1,1,2,50.0%,2m
7462,3,[LoF]IIIIlllllIII,3457,0,1,2,3,33.3%,27m
7462,3,superhiero,3457,0,0,1,1,0.0%,42m
7473,3,[WicWac]stever,3456,1583,233,221,454,51.3%,4m
7473,3,Zealous,3456,1506,76,70,146,52.1%,6m
7473,3,[HØST]Loghy,3456,570,57,44,101,56.4%,11m
7473,3,[eX]Efemeridade,3456,458,22,11,33,66.7%,19m
7473,3,jojo,3456,138,6,3,9,66.7%,16m
7473,3,[YlKES]thereddread,3456,86,4,0,4,100.0%,6m
7473,3,Roysensei,3456,60,2,5,7,28.6%,29m
7473,3,Superman,3456,0,1,0,1,100.0%,42m
7473,3,RJC,3456,0,1,1,2,50.0%,22m
7473,3,[3D]Melkor,3456,0,1,1,2,50.0%,15m
7483,3,Dustin,3455,626,53,46,99,53.5%,9m
7483,3,MisterFicus,3455,914,46,15,61,75.4%,21m
7483,2,Shockzone,3455,396,46,31,77,59.7%,21m
7483,3,Phantom,3455,328,21,14,35,60.0%,23m
7483,3,[BRACE]Sstorm,3455,316,14,7,21,66.7%,16m
7483,3,[UCF]SbaerO,3455,142,6,6,12,50.0%,26m
7483,3,NorthKorean,3455,0,4,0,4,100.0%,42m
7483,3,KitcoMeSCBr,3455,88,3,7,10,30.0%,38m
7483,3,lIlIlIlIlIlI,3455,0,2,4,6,33.3%,31m
7483,3,Reptar,3455,58,2,5,7,28.6%,10m
7483,3,Bartomeu,3455,0,1,0,1,100.0%,11m
7483,3,elcom,3455,0,1,0,1,100.0%,38m
7483,3,ArsBlack,3455,0,0,1,1,0.0%,22m
7483,3,[MOBOZ]Dubstep,3455,0,0,1,1,0.0%,10m
7497,2,Psionic,3454,1468,160,162,322,49.7%,19m
7497,2,Storm,3454,926,46,49,95,48.4%,8m
7497,3,[tanay]squidward,3454,575,26,16,42,61.9%,5m
7497,2,[IDumb]meeees,3454,690,25,30,55,45.5%,10m
7497,3,[LexL]Archontas,3454,381,16,9,25,64.0%,16m
7497,3,Fussellino,3454,315,15,4,19,78.9%,40m
7497,3,Mopup,3454,182,8,5,13,61.5%,20m
7497,3,[ValidG]VajKilla,3454,116,8,7,15,53.3%,22m
7497,3,JimboShlice,3454,167,7,3,10,70.0%,19m
7497,3,[Dicboy]KillermonHas,3454,0,5,1,6,83.3%,38m
7497,3,[TrpleT]Enferno,3454,116,5,4,9,55.6%,41m
7497,3,unforgivable,3454,60,3,2,5,60.0%,30m
7497,3,SMOK,3454,0,1,1,2,50.0%,36m
7497,3,[xSNSDx]Taeny,3454,0,0,1,1,0.0%,6m
7511,3,[YCnk]elnastha,3453,1131,62,59,121,51.2%,6m
7511,3,[NPhase]RektTrashEZ,3453,502,18,19,37,48.6%,17m
7511,3,kentaurus,3453,116,8,3,11,72.7%,13m
7511,3,Zamite,3453,114,5,3,8,62.5%,23m
7511,3,[MEP]AkicitaWaste,3453,58,3,1,4,75.0%,2m
7511,1,[vacuum]jiYub,3453,145,3,4,7,42.9%,3m
7511,3,Newf,3453,30,2,0,2,100.0%,42m
7518,3,pixel,3452,1387,76,68,144,52.8%,34m
7518,2,Jubub,3452,1083,55,49,104,52.9%,15m
7518,2,[BGGBOI]PinkiePie,3452,479,50,33,83,60.2%,11m
7518,3,Shogun,3452,345,20,8,28,71.4%,34m
7518,2,Death,3452,285,14,9,23,60.9%,4m
7518,2,[TGCrew]FedSmoker,3452,252,10,25,35,28.6%,17m
7518,3,MojoJoGio,3452,232,9,10,19,47.4%,39m
7518,3,Roke,3452,86,6,3,9,66.7%,28m
7518,3,[BP8S]itsslowtime,3452,176,6,6,12,50.0%,22m
7518,2,Mirai,3452,140,4,2,6,66.7%,20m
7518,2,Klandestino,3452,116,3,0,3,100.0%,8m
7518,3,[SKT1]coast,3452,0,1,0,1,100.0%,17m
7518,3,Nex,3452,0,1,2,3,33.3%,39m
7518,3,TheHoff,3452,0,0,1,1,0.0%,11m
7532,2,[LQV]Fliparto,3451,1534,179,162,341,52.5%,6m
7532,2,CENTURION,3451,1526,134,132,266,50.4%,11m
7532,3,Cytrone,3451,1008,48,47,95,50.5%,24m
7532,2,Potjack,3451,242,38,42,80,47.5%,27m
7532,2,[SsaYnS]Tiz,3451,983,37,36,73,50.7%,36m
7532,3,DaveyGunface,3451,276,10,10,20,50.0%,30m
7532,3,[iBorg]ZapBraniBorg,3451,142,6,2,8,75.0%,20m
7532,3,[IBERIA]miunhauzen,3451,22,2,2,4,50.0%,4m
7532,3,[GGMESP]Olafmere,3451,0,1,0,1,100.0%,31m
7532,3,elgathoo,3451,30,1,3,4,25.0%,30m
7532,3,[UpeV]Radstok,3451,0,0,1,1,0.0%,26m
7543,2,[B055]ShadowTiger,3450,1578,189,168,357,52.9%,23m
7543,3,ProtossKing,3450,1571,113,93,206,54.9%,17m
7543,2,[Lowko]Velharnin,3450,974,48,45,93,51.6%,14m
7543,3,[F0D]Spizella,3450,854,32,31,63,50.8%,17m
7543,3,MLN,3450,662,26,23,49,53.1%,30m
7543,3,Kris,3450,590,22,24,46,47.8%,1m
7543,3,[UpxV]EDMER,3450,172,10,3,13,76.9%,39m
7543,2,javajava,3450,222,7,19,26,26.9%,35m
7543,3,[BTRS]argOtian,3450,0,1,1,2,50.0%,19m
7543,3,Prost,3450,97,1,1,2,50.0%,5m
7553,2,OldPork,3449,1657,159,155,314,50.6%,34m
7553,3,SlerpDerp,3449,936,91,91,182,50.0%,10m
7553,2,lllllllllll,3449,1300,57,49,106,53.8%,18m
7553,3,YayMoveRace,3449,1083,46,34,80,57.5%,39m
7553,3,dcare,3449,492,22,11,33,66.7%,26m
7553,3,RainDrop,3449,473,20,14,34,58.8%,11m
7553,3,[unwoke]Chattetueur,3449,323,11,5,16,68.8%,25m
7553,2,[lSFGl]Ellipses,3449,264,9,17,26,34.6%,18m
7553,3,[FalPal]Umbra,3449,186,7,6,13,53.8%,25m
7553,3,WhoAU,3449,30,2,1,3,66.7%,33m
7553,2,Mercer,3449,58,2,8,10,20.0%,10m
7553,3,Kijuro,3449,30,1,1,2,50.0%,17m
7553,3,ParkBoGeom,3449,30,1,3,4,25.0%,5m
7553,3,[ExLa]Exclux,3449,0,0,3,3,0.0%,11m
7567,2,EzRA,3448,1600,193,173,366,52.7%,8m
7567,2,AbsolutePLUS,3448,503,27,24,51,52.9%,34m
7567,3,iiiiiiiiiiii,3448,382,17,11,28,60.7%,29m
7567,3,[NPhasA]Duran,3448,200,7,6,13,53.8%,11m
7567,3,[WIDOWZ]Mendokusee,3448,211,6,7,13,46.2%,30m
7567,3,[UpeV]Maverick,3448,174,6,9,15,40.0%,36m
7567,3,ZylslyZ,3448,58,5,1,6,83.3%,40m
7567,3,[Potate]Xecutioner,3448,116,4,2,6,66.7%,6m
7567,3,Chaos,3448,62,3,4,7,42.9%,30m
7567,3,PaRaDoX,3448,58,2,1,3,66.7%,10m
7567,3,[trolz]Dino,3448,0,2,3,5,40.0%,28m
7567,2,TheMauryShow,3448,96,1,2,3,33.3%,31m
7567,3,Allday,3448,0,0,1,1,0.0%,2m
7567,3,CtaiXtine,3448,0,0,2,2,0.0%,4m
7567,3,[AthSun]LuciusAterna,3448,0,0,3,3,0.0%,11m
7582,3,Jackazoid,3447,1570,178,125,303,58.7%,23m
7582,3,heywo,3447,1281,145,138,283,51.2%,34m
7582,3,LEET,3447,612,55,49,104,52.9%,24m
7582,3,[ssexxy]Corvus,3447,518,20,18,38,52.6%,10m
7582,3,[Bee]BrownBear,3447,292,17,13,30,56.7%,14m
7582,2,GoodP,3447,324,16,14,30,53.3%,37m
7582,2,[kalC]trueNorth,3447,123,15,18,33,45.5%,27m
7582,3,zerick,3447,114,7,3,10,70.0%,17m
7582,3,[TgAg]Hirakact,3447,0,1,1,2,50.0%,30m
7582,3,Dionysus,3447,30,1,3,4,25.0%,17m
7582,3,[iDrunk]Loocsinatas,3447,0,0,1,1,0.0%,26m
7582,3,[NOZO]IngPin,3447,0,0,1,1,0.0%,8m
7582,3,Slowtoss,3447,0,0,3,3,0.0%,3m
7582,3,[KoopaZ]Thumper,3447,0,0,5,5,0.0%,3m
7596,2,[LNWLF]ForceMajeure,3446,384,65,63,128,50.8%,10m
7596,3,icantenglish,3446,367,15,16,31,48.4%,15m
7596,3,[EvilCC]RAIIZEN,3446,202,7,6,13,53.8%,14m
7596,3,teca,3446,216,7,12,19,36.8%,5m
7596,2,CyanideByte,3446,88,3,8,11,27.3%,13m
7596,3,WyteRyce,3446,58,2,5,7,28.6%,5m
7596,3,vvoven,3446,0,1,1,2,50.0%,6m
7596,3,[CFSM]Freja,3446,0,1,1,2,50.0%,37m
7596,3,[MSFT]rpenguin,3446,30,1,2,3,33.3%,19m
7596,3,llllllllllll,3446,30,1,2,3,33.3%,23m
7596,3,Whispers,3446,0,0,3,3,0.0%,9m
7607,3,[Takagi]meow,3445,1337,98,86,184,53.3%,4m
7607,2,warboy,3445,1581,82,90,172,47.7%,2m
7607,2,EddyTwoHands,3445,384,55,55,110,50.0%,7m
7607,3,Learningnoob,3445,1084,52,24,76,68.4%,22m
7607,2,Jupiter,3445,457,47,46,93,50.5%,21m
7607,3,SneezyProbe,3445,394,26,18,44,59.1%,30m
7607,3,[INextI]Forezion,3445,508,18,21,39,46.2%,2m
7607,3,Terry,3445,369,15,16,31,48.4%,19m
7607,3,Novorosi,3445,258,10,6,16,62.5%,24m
7607,3,Nomad,3445,121,6,1,7,85.7%,23m
7607,3,[xSPHx]Zamiel,3445,146,5,6,11,45.5%,16m
7607,3,[GIM]WHTMORPHEUS,3445,30,4,2,6,66.7%,35m
7607,3,[Schwar]Sky,3445,114,4,3,7,57.1%,18m
7607,2,BowtiE,3445,90,3,9,12,25.0%,16m
7607,3,revolution,3445,0,0,1,1,0.0%,3m
7607,3,[Th3Bad]firebat,3445,0,0,1,1,0.0%,39m
7623,2,[BoAVN]HieuTran,3444,1566,706,692,1398,50.5%,39m
7623,1,Sulluukun,3444,1290,120,134,254,47.2%,24m
7623,3,AsusTwo,3444,1249,67,50,117,57.3%,24m
7623,3,[HaMz]Parm,3444,785,32,31,63,50.8%,42m
7623,3,gooseduck,3444,764,28,27,55,50.9%,8m
7623,3,anaD,3444,470,18,11,29,62.1%,19m
7623,3,DivineCraft,3444,500,17,20,37,45.9%,28m
7623,3,IcyFather,3444,200,12,4,16,75.0%,19m
7623,3,GoldenArmada,3444,355,12,9,21,57.1%,10m
7623,3,TenaciousD,3444,118,4,3,7,57.1%,8m
7623,2,rakshin,3444,48,3,7,10,30.0%,10m
7623,1,PuFF,3444,0,2,1,3,66.7%,2h
7623,2,[UpeV]TheStreet,3444,88,1,6,7,14.3%,18m
7623,1,lllllllllll,3444,0,0,1,1,0.0%,28m
7623,3,[Gouda2]EnemTau,3444,0,0,2,2,0.0%,30m
7638,3,Skyoden,3443,1609,127,114,241,52.7%,18m
7638,3,[R33D]ryuzaqui,3443,369,52,46,98,53.1%,24m
7638,2,[WNTRLH]Reiiken,3443,1282,51,49,100,51.0%,38m
7638,2,[SCRlM]UberMentch,3443,1047,38,42,80,47.5%,26m
7638,2,[Yuko]Chiristinayo,3443,566,25,19,44,56.8%,2m
7638,3,Mikki,3443,601,24,18,42,57.1%,6m
7638,3,[8kPLUS]Moradagh,3443,348,12,15,27,44.4%,2m
7638,3,[MLPog]Astealthyko,3443,0,1,0,1,100.0%,16m
7638,3,[9000]gthx,3443,0,1,0,1,100.0%,42m
7638,3,harlock,3443,0,1,0,1,100.0%,13m
7638,3,[Diors]OHyes,3443,0,1,3,4,25.0%,22m
7638,3,CenTurioN,3443,0,0,1,1,0.0%,15m
7650,2,[YD2K]TheMIHM,3442,1470,91,88,179,50.8%,25m
7650,2,Metalhorse,3442,426,15,21,36,41.7%,7m
7650,3,SSSD,3442,160,13,6,19,68.4%,40m
7650,3,[xGenGx]LeRuJ,3442,318,12,10,22,54.5%,24m
7650,3,WhiteNova,3442,288,10,11,21,47.6%,35m
7650,3,[xLgNx]GunnerBlade,3442,0,1,0,1,100.0%,37m
7650,3,[APM9k]Nitrix,3442,0,1,0,1,100.0%,40m
7650,3,Fear,3442,30,1,1,2,50.0%,29m
7650,3,Abner,3442,0,0,1,1,0.0%,20m
7659,3,Tyler,3441,514,45,35,80,56.2%,16m
7659,3,[NeOx1]resOrt,3441,777,43,29,72,59.7%,6m
7659,2,Vas,3441,529,19,26,45,42.2%,7m
7659,3,McCrazy,3441,466,16,20,36,44.4%,31m
7659,3,[eRc]FortyFs,3441,392,15,10,25,60.0%,10m
7659,3,TheKaiser,3441,378,15,11,26,57.7%,5m
7659,3,StickyDude,3441,116,4,3,7,57.1%,30m
7659,3,diksuckr,3441,86,3,6,9,33.3%,14m
7659,3,Somme,3441,30,2,0,2,100.0%,29m
7659,3,WAKE,3441,60,2,2,4,50.0%,14m
7659,3,Critter,3441,0,1,0,1,100.0%,37m
7659,3,[SMB]ShaDoW,3441,0,1,0,1,100.0%,19m
7659,2,[VENSC2]Husky,3441,0,0,2,2,0.0%,9m
7659,3,Inxanity,3441,0,0,2,2,0.0%,42m
7673,2,Audioslave,3440,1572,133,135,268,49.6%,26m
7673,2,TheRustic,3440,1463,84,72,156,53.8%,37m
7673,3,[CASS]Cassidy,3440,1319,53,51,104,51.0%,28m
7673,2,AnyWan,3440,326,15,12,27,55.6%,41m
7673,3,DeBugs,3440,352,14,9,23,60.9%,33m
7673,3,[SpJm]DaRkFaCtOR,3440,0,1,0,1,100.0%,11m
7673,3,Montevideo,3440,0,1,4,5,20.0%,39m
7673,3,Aven,3440,0,0,1,1,0.0%,14m
7681,3,DraxThDstryr,3439,1602,122,115,237,51.5%,39m
7681,2,saken,3439,1437,68,62,130,52.3%,36m
7681,2,leo,3439,817,32,45,77,41.6%,8m
7681,3,JulzTheBulz,3439,313,28,28,56,50.0%,19m
7681,3,Hocotate,3439,378,13,16,29,44.8%,27m
7681,3,[DMADG]Elpelado,3439,120,4,6,10,40.0%,34m
7687,1,Libertarian,3438,1668,343,350,693,49.5%,21m
7687,3,[Yoonsp]Crescent,3438,1608,129,121,250,51.6%,36m
7687,2,BuDz,3438,937,91,101,192,47.4%,15m
7687,2,BravenTTV,3438,1140,83,76,159,52.2%,13m
7687,2,[ZDE20]llllllllllll,3438,1306,66,53,119,55.5%,35m
7687,3,KeyBlader,3438,728,27,26,53,50.9%,8m
7687,3,[AiMB]CavortinOgre,3438,120,4,7,11,36.4%,21m
7687,3,[DonTr]Pants,3438,30,1,3,4,25.0%,39m
7695,3,TarMinyatur,3437,1519,213,199,412,51.7%,16m
7695,3,[H4RLEM]Probetrotter,3437,1414,84,87,171,49.1%,18m
7695,2,[ValidG]StepSister,3437,1178,44,47,91,48.4%,27m
7695,3,[Exper]Earendil,3437,1020,38,41,79,48.1%,31m
7695,2,[NPhasA]florencio,3437,777,33,42,75,44.0%,23m
7695,3,Badliar,3437,196,11,13,24,45.8%,8m
7695,2,DAW,3437,224,7,20,27,25.9%,9m
7695,3,Gatsby,3437,179,6,3,9,66.7%,11m
7695,3,HKTG,3437,116,5,4,9,55.6%,19m
7695,1,HungryWolf,3437,0,3,1,4,75.0%,1h
7695,3,BADPLAYERUR,3437,30,2,1,3,66.7%,11m
7695,3,Nilitsu,3437,0,1,0,1,100.0%,35m
7695,3,Moonerz,3437,0,0,5,5,0.0%,7m
7708,2,Whoa,3436,1212,49,44,93,52.7%,18m
7708,2,gkgkgk,3436,1166,45,50,95,47.4%,18m
7708,2,[iDrunk]LulisBay,3436,487,20,18,38,52.6%,21m
7708,3,[LU]LegionGhost,3436,362,16,5,21,76.2%,19m
7708,2,Care,3436,328,15,15,30,50.0%,36m
7708,3,BOB,3436,394,14,14,28,50.0%,30m
7708,3,DESMX,3436,242,12,10,22,54.5%,20m
7708,3,Reginald,3436,316,11,12,23,47.8%,7m
7708,3,[2214]Jtrax,3436,152,10,7,17,58.8%,20m
7708,3,[RePlz]HazelGreenz,3436,196,7,6,13,53.8%,38m
7708,3,[SRJC]hexy,3436,114,5,2,7,71.4%,4m
7708,3,[SKRN]ElMemino,3436,30,2,0,2,100.0%,11m
7708,3,[WTZ]ZugZagZug,3436,30,1,2,3,33.3%,39m
7708,3,GrosDBill,3436,0,1,3,4,25.0%,20m
7708,3,[420whg]Avaek,3436,0,1,4,5,20.0%,25m
7723,3,[KSGT]Suebee,3435,1614,219,212,431,50.8%,40m
7723,2,ArthurDent,3435,1621,165,167,332,49.7%,10m
7723,2,MadDog,3435,1389,148,142,290,51.0%,21m
7723,3,Xeconds,3435,1385,82,64,146,56.2%,13m
7723,2,adre,3435,170,33,37,70,47.1%,35m
7723,3,[TELMO]Stalker,3435,688,26,22,48,54.2%,36m
7723,3,[IJKI]Abagus,3435,366,16,11,27,59.3%,3m
7723,3,[WNTRLY]Leethor,3435,168,9,4,13,69.2%,10m
7723,3,[PxQ]Jabu,3435,114,5,6,11,45.5%,37m
7723,3,DentalDan,3435,78,4,5,9,44.4%,5m
7723,3,OddiE,3435,42,3,5,8,37.5%,38m
7723,3,LiquidClem,3435,0,0,1,1,0.0%,16m
7735,2,Laughter,3434,1254,337,360,697,48.4%,41m
7735,2,ObamaOnCRACK,3434,1635,145,146,291,49.8%,24m
7735,3,timeless,3434,1583,128,116,244,52.5%,3m
7735,2,Source,3434,465,80,91,171,46.8%,34m
7735,2,[fiea]WaSiD,3434,1195,68,28,96,70.8%,11m
7735,3,[MaxraX]Banchan,3434,211,22,22,44,50.0%,16m
7735,2,[KingSC]Eddy,3434,258,10,15,25,40.0%,21m
7735,2,[BGOK]JUSTICE,3434,182,9,5,14,64.3%,31m
7735,3,Relkin,3434,148,4,2,6,66.7%,26m
7735,3,Niravroh,3434,90,3,7,10,30.0%,20m
7735,2,zTadictionz,3434,60,2,11,13,15.4%,42m
7735,3,[EvilGC]mgostarck,3434,0,1,0,1,100.0%,18m
7735,3,BloodyDeath,3434,0,1,1,2,50.0%,31m
7735,3,[BoRnGo]ACuteSnek,3434,0,0,1,1,0.0%,29m
7735,3,Maple,3434,0,0,2,2,0.0%,19m
7750,3,OwlSlake,3433,394,30,24,54,55.6%,16m
7750,3,ErdosZero,3433,364,16,8,24,66.7%,18m
7750,3,BerserK,3433,238,8,13,21,38.1%,38m
7750,3,[UoM]SparkleHands,3433,172,7,4,11,63.6%,28m
7750,3,naablet,3433,30,2,0,2,100.0%,25m
7750,3,[PMT]spinnercat,3433,30,2,4,6,33.3%,4m
7750,3,[mvcs]biaji,3433,60,2,4,6,33.3%,11m
7750,3,Exoticfritos,3433,0,0,1,1,0.0%,18m
7750,3,Dusan,3433,0,0,3,3,0.0%,14m
7750,2,SushiChef,3433,0,0,6,6,0.0%,9m
7760,2,SpyKer,3432,1536,344,316,660,52.1%,6m
7760,2,AyeMeng,3432,1406,173,182,355,48.7%,10m
7760,3,IIIIIIIIIIII,3432,1329,51,50,101,50.5%,28m
7760,3,Gilgamesh,3432,954,47,23,70,67.1%,41m
7760,3,Goodie,3432,1096,47,34,81,58.0%,7m
7760,3,[SCTues]Centoss,3432,538,21,15,36,58.3%,31m
7760,3,Crimson,3432,315,18,22,40,45.0%,17m
7760,3,TheRinger,3432,436,17,14,31,54.8%,26m
7760,2,Ozzy,3432,508,17,32,49,34.7%,18m
7760,2,[DETER]Mirko,3432,302,11,19,30,36.7%,15m
7760,3,[BoRnGo]MooCowThon,3432,295,10,7,17,58.8%,6m
7760,2,[CRAKS]kakaroto,3432,288,9,21,30,30.0%,13m
7760,3,[XpKAc]iShiMuRa,3432,155,5,0,5,100.0%,23m
7760,1,Snufkin,3432,142,3,3,6,50.0%,37m
7760,3,supermech,3432,86,3,19,22,13.6%,36m
7760,3,[Vampyr]HotBrushings,3432,0,1,0,1,100.0%,25m
7760,3,cricketstomp,3432,30,1,4,5,20.0%,34m
7760,3,[ANIMOO]hurdler,3432,0,0,3,3,0.0%,38m
7778,2,Loub,3431,1515,505,516,1021,49.5%,9m
7778,2,IIIIIIIIIIII,3431,1055,146,150,296,49.3%,9m
7778,3,[MSotU]Mustang,3431,1602,70,65,135,51.9%,36m
7778,2,Zangetsu,3431,447,50,65,115,43.5%,23m
7778,3,OneandOnlyMC,3431,631,48,34,82,58.5%,26m
7778,3,aDago,3431,269,9,3,12,75.0%,42m
7778,3,DrPNess,3431,195,8,2,10,80.0%,24m
7778,3,[biigpp]BlipDoolPoon,3431,30,2,1,3,66.7%,30m
7778,3,[EzGaym]xALiENWArsXx,3431,0,1,0,1,100.0%,30m
7778,3,[ZTemps]Bokes,3431,94,1,2,3,33.3%,28m
7778,3,Sarah,3431,0,0,1,1,0.0%,27m
7789,2,Probius,3430,1427,260,267,527,49.3%,28m
7789,3,MonkeySpawnX,3430,1545,259,248,507,51.1%,40m
7789,2,Beluga,3430,1506,88,82,170,51.8%,42m
7789,3,[xLgNx]shummy,3430,1034,46,37,83,55.4%,36m
7789,3,DarkMark,3430,988,39,28,67,58.2%,26m
7789,3,[Zynist]VforVivaldi,3430,702,30,18,48,62.5%,40m
7789,3,Elfy,3430,540,23,15,38,60.5%,28m
7789,3,[HOMOF]GreenYoshi,3430,86,4,3,7,57.1%,27m
7789,3,[RathFr]Kinghonj,3430,58,2,3,5,40.0%,9m
7789,3,MechncSpecal,3430,30,1,1,2,50.0%,2m
7789,3,[lLiTl]Veryrare,3430,0,1,3,4,25.0%,15m
7789,3,[proChi]Demonios,3430,0,0,1,1,0.0%,29m
7789,3,[TBHA]DATCHIEF,3430,0,0,1,1,0.0%,17m
7789,3,[ONWD]nick,3430,0,0,1,1,0.0%,2m
7803,2,[M1A5]Eliadar,3429,1037,171,151,322,53.1%,26m
7803,3,POWER,3429,560,21,20,41,51.2%,11m
7803,3,Fsd,3429,58,3,6,9,33.3%,14m
7803,2,Plexi,3429,140,3,6,9,33.3%,41m
7803,1,FaceBones,3429,0,2,2,4,50.0%,2h
7803,3,[KingSC]Pxnditx,3429,0,1,3,4,25.0%,40m
7803,3,PoisonM,3429,0,0,1,1,0.0%,5m
7803,3,Nahara,3429,0,0,2,2,0.0%,42m
7811,2,TanK,3428,1312,232,237,469,49.5%,35m
7811,3,BladeKain,3428,1146,69,67,136,50.7%,34m
7811,3,eScala,3428,701,45,29,74,60.8%,6m
7811,3,[Majinn]PrinceVegeta,3428,1030,41,35,76,53.9%,5m
7811,3,activated,3428,872,39,35,74,52.7%,17m
7811,3,[Kaiba]Tankore,3428,696,29,24,53,54.7%,31m
7811,3,Hamsung,3428,58,7,1,8,87.5%,40m
7811,3,[3nTar0]Zeratul,3428,144,6,4,10,60.0%,14m
7811,3,DrPepper,3428,0,5,0,5,100.0%,18m
7811,3,[PTHero]Knails,3428,58,5,1,6,83.3%,41m
7811,3,[Toker]PuffSwishers,3428,114,5,2,7,71.4%,39m
7811,2,[AbcCo]AlexG,3428,154,4,0,4,100.0%,42m
7811,2,DARK,3428,159,4,2,6,66.7%,42m
7811,3,[NFCS]JuggO,3428,60,3,6,9,33.3%,28m
7811,3,CarlosWonton,3428,0,1,0,1,100.0%,10m
7811,3,[TgAg]ExoYimmY,3428,0,0,1,1,0.0%,16m
7811,3,John,3428,0,0,1,1,0.0%,16m
7811,3,SodiumBarcod,3428,0,0,1,1,0.0%,10m
7829,2,[Ier]Wesker,3427,1489,208,212,420,49.5%,26m
7829,2,MAP,3427,1268,103,92,195,52.8%,40m
7829,3,Armistice,3427,820,56,61,117,47.9%,25m
7829,3,annbenji,3427,742,30,24,54,55.6%,15m
7829,3,[PES]Silver,3427,694,25,24,49,51.0%,42m
7829,3,[GCells]PsYoNiK,3427,374,15,7,22,68.2%,5m
7829,3,Grandma,3427,97,5,2,7,71.4%,16m
7829,3,JBeyer,3427,58,3,1,4,75.0%,11m
7829,3,xYz,3427,0,2,4,6,33.3%,23m
7829,3,Mantis,3427,30,2,4,6,33.3%,42m
7829,1,MrVine,3427,0,1,0,1,100.0%,22m
7829,3,BoomBabyBoom,3427,0,1,0,1,100.0%,39m
7829,3,Air,3427,0,0,2,2,0.0%,25m
7842,3,Swarmdeath,3426,1524,69,51,120,57.5%,19m
7842,3,Paul,3426,1283,51,44,95,53.7%,5m
7842,3,IIIIIIIIIIII,3426,0,5,1,6,83.3%,14m
7842,2,Rage,3426,212,5,11,16,31.2%,36m
7842,3,EVAG,3426,30,2,0,2,100.0%,38m
7842,3,[MeLFtw]MaverickOca,3426,0,1,0,1,100.0%,20m
7842,3,Imreallybad,3426,0,1,0,1,100.0%,29m
7842,3,MalbertoM,3426,0,0,1,1,0.0%,15m
7850,3,[GØSU]Virtual,3425,1418,169,158,327,51.7%,31m
7850,3,CatsRCool,3425,1585,122,107,229,53.3%,5m
7850,3,mac,3425,1022,45,35,80,56.2%,16m
7850,3,GrimLock,3425,553,30,19,49,61.2%,22m
7850,3,JackDaniel,3425,349,14,10,24,58.3%,42m
7850,1,[RBs]Pact,3425,234,11,5,16,68.8%,32m
7850,2,Stopher,3425,187,10,2,12,83.3%,21m
7850,2,ButtDonkey,3425,143,7,3,10,70.0%,11m
7850,3,[eXoNC]Snowwy,3425,178,7,10,17,41.2%,4m
7850,3,illuSiOn,3425,196,7,11,18,38.9%,4m
7850,3,[LQV]Raccoon,3425,78,5,5,10,50.0%,38m
7850,3,historian,3425,30,2,0,2,100.0%,21m
7850,3,[EvilCC]AMON,3425,0,1,4,5,20.0%,7m
7850,3,[DhZPro]MATADORSCII,3425,0,0,1,1,0.0%,17m
7864,2,DoM,3424,925,61,53,114,53.5%,29m
7864,3,razor,3424,918,57,44,101,56.4%,7m
7864,2,[AwePos]TABTemplar,3424,593,43,40,83,51.8%,10m
7864,2,chanman,3424,1042,41,38,79,51.9%,29m
7864,3,CVDDissident,3424,635,37,24,61,60.7%,40m
7864,3,JuliusCheesR,3424,392,17,7,24,70.8%,41m
7864,3,pawel,3424,356,14,15,29,48.3%,40m
7864,3,Cowsrule,3424,275,11,14,25,44.0%,6m
7864,3,[RedHat]Philosotoss,3424,218,9,3,12,75.0%,39m
7864,3,[LGRW]Stuke,3424,166,7,2,9,77.8%,42m
7864,3,[cl0udM]gRiT,3424,0,1,0,1,100.0%,34m
7864,3,Ridiculous,3424,0,1,0,1,100.0%,21m
7864,3,Doopian,3424,30,1,1,2,50.0%,41m
7864,3,[AZBZ]NARF,3424,0,0,2,2,0.0%,19m
7878,2,sundaybrunch,3423,1647,137,130,267,51.3%,6m
7878,3,Blade,3423,279,58,29,87,66.7%,17m
7878,3,[WNTRLH]CaoCao,3423,1315,55,50,105,52.4%,10m
7878,2,[cl0udM]Ubasterd,3423,907,34,38,72,47.2%,29m
7878,3,rSLagLovah,3423,300,13,6,19,68.4%,2m
7878,3,AxesNPowers,3423,135,9,11,20,45.0%,34m
7878,1,[FMTD]Gwindor,3423,97,6,0,6,100.0%,2h
7878,3,foREVer,3423,60,6,2,8,75.0%,21m
7878,1,Scamander,3423,165,5,4,9,55.6%,3m
7878,1,SierraSix,3423,142,3,2,5,60.0%,36m
7878,3,[tTZz]TheG,3423,58,2,1,3,66.7%,31m
7878,3,[TBPP]enDyeAh,3423,30,2,1,3,66.7%,29m
7878,3,lIlIlIIIlIII,3423,0,1,0,1,100.0%,31m
7878,3,Draconis,3423,0,0,2,2,0.0%,16m
7892,2,PolloLoco,3422,1260,99,106,205,48.3%,14m
7892,3,VoteByMail,3422,829,58,21,79,73.4%,29m
7892,3,Clue,3422,171,8,2,10,80.0%,2m
7892,3,Cystemic,3422,149,8,6,14,57.1%,17m
7892,3,Prost,3422,58,3,2,5,60.0%,7m
7892,3,[HigNRG]KaelThas,3422,80,3,3,6,50.0%,36m
7892,3,Mephiz,3422,58,2,2,4,50.0%,22m
7892,3,[αB]ZAWGURN,3422,30,2,3,5,40.0%,11m
7892,3,[XLNT]kije,3422,0,0,1,1,0.0%,19m
7892,3,lllIIIIllll,3422,0,0,1,1,0.0%,27m
7902,2,BakkaBot,3421,1473,138,141,279,49.5%,13m
7902,3,KannOx,3421,1146,54,44,98,55.1%,36m
7902,3,JCCE,3421,661,33,21,54,61.1%,20m
7902,3,[FnaTYC]LaPAJArita,3421,564,20,24,44,45.5%,37m
7902,3,Bob,3421,344,16,6,22,72.7%,7m
7902,3,[CH3ES3]ColonelHamm,3421,94,2,5,7,28.6%,29m
7902,3,[p90z]alexpoopers,3421,0,1,0,1,100.0%,20m
7902,3,PandaUser,3421,0,0,2,2,0.0%,9m
7910,2,[H3RB]artdur,3420,1616,174,153,327,53.2%,9m
7910,2,Vrock,3420,1544,108,105,213,50.7%,37m
7910,2,BetaStar,3420,734,79,81,160,49.4%,11m
7910,3,Orion,3420,1153,68,68,136,50.0%,36m
7910,3,[xRtGac]DrWidowMine,3420,1004,64,60,124,51.6%,30m
7910,2,WolfieRa,3420,425,47,49,96,49.0%,27m
7910,3,Creamy,3420,980,43,32,75,57.3%,30m
7910,3,Olympian,3420,812,36,30,66,54.5%,11m
7910,3,[FXXKER]OrdiNaryIce,3420,355,16,8,24,66.7%,34m
7910,3,Senpai,3420,172,7,5,12,58.3%,31m
7910,3,[gGoO]icTo,3420,148,6,4,10,60.0%,25m
7910,3,[EZDUNK]Hornet,3420,86,4,0,4,100.0%,31m
7910,3,[SIClan]INnoVation,3420,0,1,0,1,100.0%,32m
7910,3,[EGx]baphomet,3420,30,1,2,3,33.3%,6m
7910,3,[HiLife]Hammer,3420,30,1,3,4,25.0%,39m
7910,3,[scMAUI]Salemance,3420,0,0,1,1,0.0%,5m
7910,3,Wildcide,3420,0,0,2,2,0.0%,9m
7927,3,[Pig2]PussSlayerPd,3419,1653,454,429,883,51.4%,16m
7927,3,commandant,3419,1666,183,165,348,52.6%,10m
7927,2,Rixilius,3419,1527,128,111,239,53.6%,7m
7927,3,pandafloo,3419,1454,61,48,109,56.0%,29m
7927,2,Adre,3419,420,56,62,118,47.5%,36m
7927,3,[LFUT]Magno,3419,994,39,31,70,55.7%,39m
7927,2,TINO,3419,798,27,37,64,42.2%,36m
7927,3,[GGBr0]starzzang,3419,444,15,19,34,44.1%,36m
7927,3,[Brslov]PeterAn,3419,256,10,11,21,47.6%,2m
7927,3,yeimcool,3419,58,3,0,3,100.0%,22m
7927,3,Robotopia,3419,58,2,2,4,50.0%,10m
7927,3,Kafu,3419,58,2,3,5,40.0%,32m
7927,3,[InGt]Fig,3419,0,1,1,2,50.0%,35m
7940,2,FiXxiiUs,3418,1465,312,306,618,50.5%,35m
7940,3,DiccCheney,3418,1590,305,292,597,51.1%,36m
7940,3,grinding,3418,1499,108,104,212,50.9%,5m
7940,3,[Binghi]RastaMon,3418,1297,58,52,110,52.7%,12m
7940,2,ecksdee,3418,845,36,34,70,51.4%,18m
7940,3,[Kendog]Kroy,3418,585,23,20,43,53.5%,36m
7940,3,Aver,3418,378,15,11,26,57.7%,2m
7940,3,HellraiserX,3418,157,7,3,10,70.0%,10m
7940,3,RealVelour,3418,0,1,0,1,100.0%,30m
7940,1,IIIIlllIlIII,3418,0,1,4,5,20.0%,1h
7940,3,DarkWhalburg,3418,0,0,1,1,0.0%,2m
7940,3,[TGCrew]dipsco,3418,0,0,2,2,0.0%,26m
7952,2,PuckyounoGG,3417,1536,403,408,811,49.7%,38m
7952,2,JohnyisBack,3417,1541,348,346,694,50.1%,40m
7952,2,Pogo,3417,1532,169,163,332,50.9%,36m
7952,3,[tired]Winter,3417,1029,85,86,171,49.7%,39m
7952,3,[DETER]SOL,3417,421,26,14,40,65.0%,34m
7952,3,Nukeball,3417,399,16,9,25,64.0%,22m
7952,3,Symphony,3417,58,4,2,6,66.7%,40m
7952,3,Chaos,3417,30,3,4,7,42.9%,7m
7952,3,Cruze,3417,30,2,0,2,100.0%,2m
7952,3,tutter,3417,0,2,3,5,40.0%,10m
7952,3,Darkdemon,3417,0,0,1,1,0.0%,6m
7952,3,Cloud,3417,0,0,2,2,0.0%,14m
7964,2,[1PA]streamteam,3416,1461,92,111,203,45.3%,27m
7964,2,JackSmack,3416,629,25,27,52,48.1%,14m
7964,3,[Jokn]Pippin,3416,472,19,14,33,57.6%,10m
7964,3,[DRKESP]Bas,3416,376,14,13,27,51.9%,36m
7964,3,Atom,3416,406,14,17,31,45.2%,26m
7964,3,EatOrBeEaten,3416,309,11,9,20,55.0%,22m
7964,2,Morpheus,3416,244,10,13,23,43.5%,41m
7964,3,Luke,3416,0,5,1,6,83.3%,39m
7964,3,LILrocketMAN,3416,124,4,10,14,28.6%,10m
7964,3,twicetherice,3416,0,1,1,2,50.0%,8m
7964,3,Beni,3416,0,0,1,1,0.0%,16m
7975,3,GDOG,3415,1053,110,93,203,54.2%,41m
7975,3,[NPhasA]MuckStar,3415,1584,85,78,163,52.1%,36m
7975,2,TomiGunz,3415,1363,62,71,133,46.6%,31m
7975,3,ukiya,3415,747,32,31,63,50.8%,40m
7975,3,SadMachine,3415,452,20,16,36,55.6%,6m
7975,3,[DTpro]Drago,3415,313,14,10,24,58.3%,2m
7975,3,PAPABLANCA,3415,60,7,3,10,70.0%,11m
7975,3,ImMINING,3415,30,4,3,7,57.1%,7m
7975,3,James,3415,0,0,5,5,0.0%,9m
7984,2,[UAK]anBEl,3414,1526,297,274,571,52.0%,31m
7984,2,Koalas,3414,1534,243,221,464,52.4%,31m
7984,2,llllllllllll,3414,1234,69,50,119,58.0%,17m
7984,2,[LQV]IlIlIlIlIl,3414,1127,49,47,96,51.0%,20m
7984,2,[HvnDvl]Drath,3414,600,21,32,53,39.6%,26m
7984,3,triumph,3414,274,14,7,21,66.7%,36m
7984,3,[VoidEC]Tossyde,3414,322,12,5,17,70.6%,19m
7984,3,NightKnight,3414,187,11,17,28,39.3%,19m
7984,3,Driftking,3414,120,6,1,7,85.7%,12m
7984,3,[DIS]TonyStark,3414,96,2,0,2,100.0%,24m
7984,1,lotsofwind,3414,0,2,3,5,40.0%,17m
7984,3,[r4mp4g]RamJam,3414,0,1,0,1,100.0%,15m
7996,1,Jim,3413,1539,205,230,435,47.1%,4m
7996,2,CREW,3413,1585,181,183,364,49.7%,13m
7996,3,[Dusky]mexorcist,3413,889,156,113,269,58.0%,12m
7996,2,[LoT]ShotoKat,3413,1299,110,123,233,47.2%,41m
7996,2,wonder,3413,1412,55,61,116,47.4%,36m
7996,3,[NPhase]Droneicus,3413,786,36,35,71,50.7%,42m
7996,2,bryguy,3413,610,30,29,59,50.8%,14m
7996,3,[YD2K]LinHan,3413,361,16,10,26,61.5%,14m
7996,3,VodkaForAll,3413,246,10,2,12,83.3%,6m
7996,3,DankSaVaGe,3413,166,10,3,13,76.9%,17m
7996,2,ZarKo,3413,204,7,10,17,41.2%,6m
7996,3,Outridair,3413,146,5,5,10,50.0%,40m
7996,3,airgeo,3413,195,5,7,12,41.7%,9m
7996,3,pipos,3413,90,4,2,6,66.7%,39m
7996,3,Tito,3413,30,2,1,3,66.7%,21m
7996,3,Artanis,3413,0,1,0,1,100.0%,5m
7996,3,MrPeeKaBoO,3413,30,1,2,3,33.3%,34m
7996,3,Seven,3413,0,0,1,1,0.0%,27m
8014,3,[UBmail]Mithridates,3412,1551,94,77,171,55.0%,30m
8014,3,[ctrlF]BalphEubank,3412,1403,59,44,103,57.3%,16m
8014,3,Hiramekarei,3412,480,22,23,45,48.9%,6m
8014,3,[TCook]TopCheddar,3412,254,21,23,44,47.7%,16m
8014,2,BlueLeaf,3412,290,14,9,23,60.9%,31m
8014,3,[Dchk]Kestal,3412,340,13,12,25,52.0%,10m
8014,3,[FrdMs]FioFox,3412,58,6,4,10,60.0%,30m
8014,1,Bushido,3412,0,5,0,5,100.0%,2h
8014,3,satiety,3412,42,2,1,3,66.7%,38m
8014,3,Ertazul,3412,30,2,2,4,50.0%,13m
8014,3,Lslurpeek,3412,0,1,0,1,100.0%,31m
8014,3,wowaka,3412,0,1,0,1,100.0%,36m
8014,3,[ORT1]AzAlexZ,3412,0,1,1,2,50.0%,30m
8027,2,[SolOGS]llllllllllll,3411,1561,277,281,558,49.6%,3m
8027,3,Harry,3411,1193,145,108,253,57.3%,40m
8027,2,EvilHR,3411,853,94,64,158,59.5%,39m
8027,3,[WHYYYY]WEEBRIOSIS,3411,1115,80,61,141,56.7%,26m
8027,3,Bloodstar,3411,1036,69,54,123,56.1%,42m
8027,3,devzero,3411,822,44,40,84,52.4%,21m
8027,2,[Globe]kimkim,3411,509,25,29,54,46.3%,38m
8027,2,abraKadabra,3411,271,11,4,15,73.3%,22m
8027,3,ExTrEaM,3411,130,4,10,14,28.6%,17m
8027,3,Levi,3411,126,4,11,15,26.7%,18m
8027,2,[TOYOTA]CamryPower,3411,128,4,12,16,25.0%,41m
8027,3,habeo,3411,30,2,5,7,28.6%,24m
8027,3,[TOYOTA]Kira,3411,0,1,0,1,100.0%,34m
8027,3,Citra,3411,0,1,0,1,100.0%,3m
8027,3,LtJayVick,3411,0,0,1,1,0.0%,3m
8027,3,[Gx2]SGTpenguin,3411,0,0,1,1,0.0%,8m
8027,2,Bliutwo,3411,0,0,12,12,0.0%,8m
8044,3,zen,3410,1020,80,78,158,50.6%,35m
8044,3,[TAC05]iBeatAlfaStr,3410,405,25,19,44,56.8%,26m
8044,3,MoLLusK,3410,516,21,12,33,63.6%,4m
8044,3,IIIIlIIlIIlI,3410,252,9,7,16,56.2%,22m
8044,3,[Trixie]rainbow,3410,222,9,9,18,50.0%,5m
8044,3,RELOAD,3410,208,8,9,17,47.1%,27m
8044,3,Qayleb,3410,60,3,3,6,50.0%,24m
8044,3,HunterKiller,3410,0,0,1,1,0.0%,11m
8044,3,LinkTuner,3410,0,0,1,1,0.0%,19m
8053,2,[THC420]HYPNOTOAD,3409,1558,221,210,431,51.3%,10m
8053,3,[cl0udM]AIphaStar,3409,1005,154,146,300,51.3%,16m
8053,3,ProNoob,3409,1243,54,43,97,55.7%,19m
8053,3,XxSergioPSxX,3409,1124,47,42,89,52.8%,23m
8053,3,sudo,3409,667,46,42,88,52.3%,12m
8053,3,Diablillo,3409,525,18,23,41,43.9%,18m
8053,3,MaCroN,3409,283,14,10,24,58.3%,40m
8053,2,[ZTemps]Fibonacci,3409,338,11,16,27,40.7%,2m
8053,2,[ScSwrm]Matsukawa,3409,88,3,10,13,23.1%,9m
8053,3,KCGoku,3409,0,0,1,1,0.0%,4m
8063,3,BRaZiLiaNKid,3408,564,51,55,106,48.1%,17m
8063,2,Starbuck,3408,326,11,19,30,36.7%,27m
8063,1,[NLTN]Tarkor,3408,258,7,9,16,43.8%,3m
8063,3,[xRtGac]ArmyHavoc,3408,58,3,0,3,100.0%,2m
8063,3,Valjean,3408,58,2,1,3,66.7%,40m
8063,3,[Risque]LDOGPANKAKE,3408,119,2,4,6,33.3%,40m
8063,3,Raiten,3408,30,1,2,3,33.3%,13m
8063,3,PABLO,3408,30,1,3,4,25.0%,6m
8063,3,[Wndrrs]QuipQuop,3408,0,0,1,1,0.0%,11m
8063,3,Trainbike,3408,0,0,2,2,0.0%,22m
8063,3,[Bee]Lightning,3408,0,0,4,4,0.0%,3m
8063,1,[SlayrS]MMA,3408,0,0,5,5,0.0%,2h
8075,2,Mormegil,3407,1340,167,178,345,48.4%,19m
8075,3,Tazerface,3407,1567,78,48,126,61.9%,22m
8075,3,[iGGe]MiniNineteen,3407,672,28,21,49,57.1%,18m
8075,3,[Carat]Hanzos,3407,474,21,14,35,60.0%,26m
8075,3,[TITSSS]Dalgalak,3407,0,5,0,5,100.0%,24m
8075,3,[nubPWR]SlubberScrub,3407,0,3,2,5,60.0%,18m
8075,3,Orthonormal,3407,30,2,0,2,100.0%,6m
8075,3,manbearpig,3407,60,2,2,4,50.0%,21m
8075,3,OJay,3407,30,2,3,5,40.0%,9m
8075,3,Insight,3407,62,2,5,7,28.6%,27m
8075,3,[FU2]BlackSlice,3407,0,1,0,1,100.0%,10m
8075,3,[SANA78]SMlife,3407,30,1,1,2,50.0%,29m
8075,1,Mackky,3407,0,1,1,2,50.0%,29m
8075,3,[Madnss]Madness,3407,0,1,3,4,25.0%,28m
8075,3,[APSEW]Niyanyo,3407,0,0,1,1,0.0%,15m
8075,3,TimoCore,3407,0,0,1,1,0.0%,13m
8091,3,SoySauce,3406,491,21,17,38,55.3%,2m
8091,2,[HID3]TheRest,3406,364,12,22,34,35.3%,22m
8091,3,Mercurial,3406,220,8,7,15,53.3%,22m
8091,3,Khazri,3406,224,8,9,17,47.1%,39m
8091,3,llllllllllll,3406,204,7,12,19,36.8%,30m
8091,2,CDNLandmine,3406,108,7,12,19,36.8%,42m
8091,3,Alkaiser,3406,144,6,4,10,60.0%,33m
8091,3,YipYip,3406,90,4,3,7,57.1%,24m
8091,3,[Chibii]BrokenJarX,3406,97,2,5,7,28.6%,7m
8091,3,Zeke,3406,0,1,0,1,100.0%,16m
8091,3,Nevarion,3406,0,1,0,1,100.0%,34m
8091,2,VonKilla,3406,0,1,0,1,100.0%,30m
8091,3,[RtKa]Enn,3406,30,1,2,3,33.3%,5m
8104,2,Pulpa,3405,1617,1104,1040,2144,51.5%,20m
8104,3,mimori,3405,1295,390,383,773,50.5%,34m
8104,3,Cotab,3405,818,34,21,55,61.8%,32m
8104,3,SpicySmegma,3405,498,20,10,30,66.7%,29m
8104,3,[kØ]Nicoo,3405,580,20,26,46,43.5%,3m
8104,3,[MYST]fishkiller,3405,476,18,20,38,47.4%,5m
8104,3,Hanzos,3405,194,7,4,11,63.6%,26m
8104,2,IIIIIIIIIIII,3405,184,6,1,7,85.7%,7m
8104,3,Hawtshawt,3405,86,6,3,9,66.7%,2m
8104,3,ArgiesDario,3405,116,4,4,8,50.0%,16m
8104,3,BearLeG,3405,84,4,4,8,50.0%,17m
8104,3,momasbiscuit,3405,0,0,1,1,0.0%,38m
8116,2,[TpLn]Brdi,3404,1546,264,230,494,53.4%,35m
8116,3,[DNKCFT]lIlIlIlIlI,3404,1218,54,35,89,60.7%,5m
8116,2,[Test42]dbrophy,3404,914,32,40,72,44.4%,26m
8116,3,[DuCKen]Gastritis,3404,390,13,18,31,41.9%,22m
8116,3,MAttOx,3404,262,11,2,13,84.6%,13m
8116,2,[BTown]LyBchopstiks,3404,143,7,5,12,58.3%,21m
8116,1,[LCE]Wizard,3404,134,5,1,6,83.3%,37m
8116,2,[QP]SEAhidraz,3404,162,5,15,20,25.0%,9m
8116,3,Sakuya,3404,153,4,2,6,66.7%,28m
8116,3,llllllllllll,3404,88,4,4,8,50.0%,11m
8116,3,TheArbiter,3404,58,2,4,6,33.3%,11m
8116,1,Ravek,3404,0,0,1,1,0.0%,13m
8116,3,[JaMiT]TerrorToad,3404,0,0,1,1,0.0%,34m
8116,3,MissingNo,3404,0,0,1,1,0.0%,40m
8116,3,Nick,3404,0,0,3,3,0.0%,19m
8131,2,Pangaea,3403,1601,367,355,722,50.8%,26m
8131,2,StickyRice,3403,1451,134,154,288,46.5%,30m
8131,2,Gladiator,3403,1399,115,100,215,53.5%,29m
8131,2,Lukelberry,3403,1174,44,44,88,50.0%,14m
8131,3,grosstoss,3403,393,22,18,40,55.0%,22m
8131,3,Hawks,3403,521,21,13,34,61.8%,30m
8131,3,surefire,3403,168,7,2,9,77.8%,3m
8131,1,[GGMESP]TossOP,3403,0,5,0,5,100.0%,38m
8131,3,sonnenkind,3403,0,3,2,5,60.0%,26m
8131,3,[CHEK]Maluu,3403,58,3,2,5,60.0%,32m
8131,3,Unavailable,3403,96,2,0,2,100.0%,40m
8131,3,pyle,3403,0,2,3,5,40.0%,9m
8131,3,geightman,3403,30,2,3,5,40.0%,24m
8131,3,[eXeS]Luc,3403,60,2,4,6,33.3%,11m
8131,2,PingPongRice,3403,0,0,2,2,0.0%,12m
8146,2,[Q4Life]Vapour,3402,1570,181,175,356,50.8%,37m
8146,2,Snivy,3402,1458,151,158,309,48.9%,37m
8146,2,Fuzzydeath,3402,1102,136,133,269,50.6%,6m
8146,3,[ZTemp]Observer,3402,1320,89,52,141,63.1%,18m
8146,2,[DarkAG]Pamanos,3402,1550,85,99,184,46.2%,30m
8146,3,[USWAG]xxSauuLxx,3402,1579,83,86,169,49.1%,39m
8146,3,Grombulus,3402,750,30,24,54,55.6%,18m
8146,2,SuperDog,3402,404,15,23,38,39.5%,21m
8146,3,LaLechuga,3402,370,14,7,21,66.7%,5m
8146,2,[TRETER]Wavic,3402,414,13,17,30,43.3%,42m
8146,3,StinkoMan,3402,137,11,4,15,73.3%,32m
8146,2,Hastings,3402,210,6,2,8,75.0%,12m
8146,3,cAKEs,3402,109,6,6,12,50.0%,17m
8146,3,Tandris,3402,146,6,9,15,40.0%,19m
8146,3,Swattie,3402,0,1,0,1,100.0%,6m
8146,3,Lenskey,3402,0,1,0,1,100.0%,14m
8146,3,Bonjwa,3402,0,0,1,1,0.0%,40m
8146,3,[iGUARD]Death,3402,0,0,1,1,0.0%,13m
8164,2,[OIGE]ELEONORE,3401,1547,142,148,290,49.0%,31m
8164,3,Deadman,3401,609,43,29,72,59.7%,35m
8164,3,carrydacarro,3401,582,25,13,38,65.8%,40m
8164,2,[V501st]MaulerX,3401,513,23,27,50,46.0%,18m
8164,3,[CatRG]ZergButchery,3401,449,17,16,33,51.5%,30m
8164,3,[Astute]Anomalist,3401,422,16,21,37,43.2%,29m
8164,1,Hyde,3401,321,14,7,21,66.7%,28m
8164,3,[TCGsP]Iglooburner,3401,265,9,6,15,60.0%,9m
8164,3,boombledoor,3401,220,8,12,20,40.0%,17m
8164,3,[LimaSC]Shield,3401,60,3,1,4,75.0%,26m
8164,3,menono,3401,30,2,1,3,66.7%,9m
8164,3,ForAiur,3401,60,2,3,5,40.0%,19m
8164,3,Fokkert,3401,0,1,0,1,100.0%,20m
8164,3,Kinliss,3401,0,0,1,1,0.0%,21m
8178,3,[TRILST]Rexxor,3400,1386,135,131,266,50.8%,21m
8178,2,Vertigo,3400,989,81,82,163,49.7%,37m
8178,3,Terminology,3400,1261,59,32,91,64.8%,16m
8178,3,bigwaN,3400,814,35,23,58,60.3%,10m
8178,3,BlinkFloyd,3400,490,34,18,52,65.4%,30m
8178,3,StormDragon,3400,389,21,23,44,47.7%,40m
8178,3,[αXLa]CHEF,3400,310,14,6,20,70.0%,30m
8178,1,TriPPySkiLLs,3400,215,12,7,19,63.2%,39m
8178,3,retinagel,3400,246,9,6,15,60.0%,13m
8178,3,Abaddon,3400,264,9,9,18,50.0%,19m
8178,3,gorrienea,3400,280,9,13,22,40.9%,22m
8178,3,ReNaYUl,3400,119,5,2,7,71.4%,34m
8178,3,[YD2K]thewetlegend,3400,90,4,6,10,40.0%,11m
8178,3,dulcedeleche,3400,58,2,9,11,18.2%,16m
8178,3,[GIBE]AlfieStar,3400,0,1,1,2,50.0%,20m
8178,3,HFSProdigy,3400,0,0,1,1,0.0%,2m
8178,3,jaydahitta,3400,0,0,1,1,0.0%,5m
8195,3,[EhTeam]Duke,3399,1577,100,76,176,56.8%,19m
8195,3,PDXPanda,3399,1537,68,52,120,56.7%,26m
8195,2,[503ES]NecroProto,3399,938,34,40,74,45.9%,38m
8195,2,llllllllllll,3399,570,24,22,46,52.2%,12m
8195,3,DogChasnTail,3399,140,8,4,12,66.7%,11m
8195,3,KHALTHEBOLD,3399,77,8,12,20,40.0%,12m
8195,3,ostreech,3399,192,7,2,9,77.8%,41m
8195,1,[5oh1st]Tronzer,3399,0,5,0,5,100.0%,1h
8195,2,Jacobyjones,3399,180,5,2,7,71.4%,14m
8195,3,ManZ,3399,114,5,3,8,62.5%,30m
8195,3,lanaxes,3399,193,5,5,10,50.0%,36m
8195,3,[Prison]REV,3399,118,4,5,9,44.4%,10m
8195,2,ItsMe,3399,97,3,7,10,30.0%,29m
8195,2,[LTK]Sabo,3399,0,1,0,1,100.0%,15m
8195,3,[MikAlx]SetoKaiba,3399,0,1,0,1,100.0%,24m
8195,3,jpaulson,3399,30,1,1,2,50.0%,11m
8195,3,[BTace]BTAred,3399,0,0,1,1,0.0%,14m
8212,3,[UpxV]RennerHalley,3398,1598,66,59,125,52.8%,9m
8212,2,SciMech,3398,722,32,28,60,53.3%,35m
8212,3,ptero,3398,722,29,25,54,53.7%,24m
8212,3,danny,3398,655,28,14,42,66.7%,3m
8212,2,[Macac0]Lucho,3398,578,22,26,48,45.8%,24m
8212,3,[EpicD]SadFace,3398,449,19,9,28,67.9%,30m
8212,3,Bors,3398,476,19,10,29,65.5%,5m
8212,2,nyx,3398,516,17,26,43,39.5%,38m
8212,3,Janus,3398,178,7,9,16,43.8%,11m
8212,3,PerAspera,3398,114,5,0,5,100.0%,34m
8212,3,Forty,3398,30,5,1,6,83.3%,17m
8212,3,[Chizu]MaRuchan,3398,0,1,0,1,100.0%,31m
8212,3,jdsarge,3398,0,0,1,1,0.0%,26m
8212,3,Sheep,3398,0,0,1,1,0.0%,18m
8212,3,Cheesey,3398,0,0,1,1,0.0%,22m
8227,2,[Viola]Dnasty,3397,1543,334,340,674,49.6%,36m
8227,3,[OGbros]Roda,3397,994,83,74,157,52.9%,5m
8227,2,LionS,3397,1430,48,65,113,42.5%,37m
8227,2,[SolOGS]assassin,3397,1148,44,51,95,46.3%,13m
8227,3,Memeling,3397,652,34,1,35,97.1%,40m
8227,2,IRateALot,3397,755,31,32,63,49.2%,10m
8227,3,Catroa,3397,547,21,15,36,58.3%,5m
8227,3,[TPGGXD]KRHIZ,3397,472,19,12,31,61.3%,10m
8227,3,IlIllllIllI,3397,423,14,20,34,41.2%,20m
8227,2,[mSlaw]ocmu,3397,342,12,19,31,38.7%,3m
8227,3,[LEBL]Master,3397,340,11,19,30,36.7%,16m
8227,3,Antibiotics,3397,227,7,2,9,77.8%,8m
8227,3,PIGPIG,3397,166,6,3,9,66.7%,18m
8227,3,[CBAS]DaGuill,3397,88,4,6,10,40.0%,40m
8227,3,Cerebros,3397,0,0,1,1,0.0%,2m
8242,1,Mastercakes,3396,1632,469,490,959,48.9%,38m
8242,3,MuerteSubita,3396,1587,157,139,296,53.0%,30m
8242,3,Wildfire,3396,933,60,35,95,63.2%,11m
8242,3,Andrew,3396,546,22,13,35,62.9%,29m
8242,3,xoxo,3396,346,16,12,28,57.1%,11m
8242,1,DieNAGranate,3396,263,11,7,18,61.1%,28m
8242,3,[dLife]Monkey,3396,300,11,8,19,57.9%,5m
8242,3,DeusRekt,3396,0,3,2,5,60.0%,22m
8242,1,lilac,3396,0,0,1,1,0.0%,1h
8242,3,Impalpable,3396,0,0,1,1,0.0%,30m
8242,3,SourPatch,3396,0,0,1,1,0.0%,42m
8253,3,Fooly,3395,1629,155,127,282,55.0%,30m
8253,3,Cyrano,3395,208,8,9,17,47.1%,29m
8253,3,Chicholito,3395,106,4,3,7,57.1%,36m
8253,3,ICEMAN,3395,90,4,4,8,50.0%,10m
8253,3,BTCUPUPUP,3395,30,1,1,2,50.0%,38m
8253,3,[QTclub]NightCaller,3395,0,0,1,1,0.0%,19m
8253,3,sharpshooter,3395,0,0,1,1,0.0%,9m
8260,2,Competitive,3394,1450,188,195,383,49.1%,25m
8260,3,[AD3C]YOYI,3394,624,26,11,37,70.3%,6m
8260,3,MASSUKKAMURA,3394,481,22,9,31,71.0%,6m
8260,3,Stevano,3394,418,19,7,26,73.1%,31m
8260,3,scared,3394,220,19,11,30,63.3%,5m
8260,3,TeaRy,3394,316,13,10,23,56.5%,8m
8260,3,[LCE]GaToo,3394,298,11,11,22,50.0%,6m
8260,3,[MIT]flyingtaco,3394,253,10,12,22,45.5%,25m
8260,3,DyMsYm,3394,140,6,3,9,66.7%,22m
8260,3,[SunWar]Doppelganger,3394,168,6,3,9,66.7%,3m
8260,1,Dakalo,3394,97,5,2,7,71.4%,35m
8260,3,[xxGMxx]Cosmic,3394,116,5,4,9,55.6%,11m
8260,3,ALLAN,3394,124,5,6,11,45.5%,31m
8260,3,Daniel,3394,86,4,1,5,80.0%,29m
8260,2,Mrcursed,3394,0,3,4,7,42.9%,8m
8260,1,TadëOz,3394,0,0,1,1,0.0%,2h
8276,3,BunkerBuster,3393,1550,91,79,170,53.5%,16m
8276,3,elmataperras,3393,1479,67,62,129,51.9%,36m
8276,2,[SsaYnS]Rain,3393,719,56,63,119,47.1%,27m
8276,3,Skullz,3393,996,38,36,74,51.4%,21m
8276,2,Homicide,3393,1062,37,45,82,45.1%,21m
8276,3,[PasT1]SebCMoi,3393,936,34,35,69,49.3%,10m
8276,3,[Muph]BigKahuna,3393,322,13,7,20,65.0%,8m
8276,2,Shamanix,3393,360,11,17,28,39.3%,37m
8276,3,Elmatapollos,3393,132,10,12,22,45.5%,4m
8276,3,[BRUTAL]FeedtheFeet,3393,230,8,8,16,50.0%,16m
8276,3,AlcatraZ,3393,86,7,2,9,77.8%,9m
8276,3,Skewmer,3393,196,7,7,14,50.0%,38m
8276,3,alvarouribe,3393,176,7,7,14,50.0%,34m
8276,3,FrOst,3393,204,7,8,15,46.7%,32m
8276,3,[PlyBro]redraccoon,3393,198,7,10,17,41.2%,29m
8276,2,JPJP,3393,14,7,14,21,33.3%,28m
8276,3,StorM,3393,146,5,5,10,50.0%,10m
8276,3,[REPORT]Skibo,3393,97,2,0,2,100.0%,35m
8276,3,[GØSU]FiDell,3393,30,2,2,4,50.0%,24m
8276,3,WangChijeu,3393,0,2,3,5,40.0%,12m
8276,3,[YD2K]AoNxWookie,3393,58,2,6,8,25.0%,42m
8276,3,Cara,3393,0,1,0,1,100.0%,24m
8276,3,Rave,3393,30,1,3,4,25.0%,19m
8276,3,OpTikZeisure,3393,0,0,1,1,0.0%,6m
8276,3,Mayucchi,3393,0,0,1,1,0.0%,20m
8276,3,SlurpMe,3393,0,0,1,1,0.0%,10m
8302,3,[ZTempz]chikennunget,3392,1273,74,59,133,55.6%,18m
8302,3,VeganDeity,3392,463,51,43,94,54.3%,20m
8302,3,[80SS]ItzMuNkyy,3392,1108,45,36,81,55.6%,24m
8302,3,PLAYLIKEDUMB,3392,923,40,22,62,64.5%,10m
8302,3,[LOHd]NinjaBear,3392,490,19,10,29,65.5%,5m
8302,2,Lennek,3392,240,9,18,27,33.3%,21m
8302,3,ShyoriOni,3392,86,7,3,10,70.0%,24m
8302,3,Aldaris,3392,144,5,4,9,55.6%,6m
8302,3,Drawing,3392,153,3,2,5,60.0%,22m
8302,3,hero,3392,58,2,3,5,40.0%,21m
8302,3,Jimothy,3392,0,1,0,1,100.0%,24m
8302,1,Hugbleem,3392,95,1,1,2,50.0%,18m
8302,3,Gpremier,3392,0,1,3,4,25.0%,20m
8315,2,MAJE,3391,1508,65,61,126,51.6%,6m
8315,3,FiveFiveOpen,3391,1513,64,62,126,50.8%,21m
8315,2,Vietboy,3391,956,40,40,80,50.0%,12m
8315,3,Softpaws,3391,522,21,13,34,61.8%,24m
8315,3,[UpeV]GUERRERØX,3391,216,8,4,12,66.7%,15m
8315,3,Snaxcinto,3391,0,1,0,1,100.0%,30m
8321,3,xuisp,3390,974,58,54,112,51.8%,41m
8321,3,iTL,3390,678,28,20,48,58.3%,32m
8321,2,SolidSKD,3390,696,23,33,56,41.1%,18m
8321,3,Pantera,3390,440,16,16,32,50.0%,25m
8321,3,Doomsday,3390,216,8,4,12,66.7%,32m
8321,3,MortTheBort,3390,145,7,3,10,70.0%,22m
8321,1,Shmantalope,3390,218,7,5,12,58.3%,37m
8321,3,jess,3390,170,6,6,12,50.0%,8m
8321,3,Tosserz,3390,117,2,2,4,50.0%,19m
8321,3,[asaa]BaldOnion,3390,60,2,4,6,33.3%,17m
8321,2,OZOZozozzzZZ,3390,99,2,7,9,22.2%,31m
8321,3,[JOSUN]Sylar,3390,0,1,0,1,100.0%,30m
8321,3,[αXLa]Mabels,3390,0,1,1,2,50.0%,20m
8321,1,[BRAP]Overdriven,3390,0,1,2,3,33.3%,33m
8321,3,PattyWee,3390,0,0,1,1,0.0%,38m
8336,2,[GOPERÚ]Danatextraño,3389,1591,230,225,455,50.5%,18m
8336,3,Nutmegg,3389,1335,178,174,352,50.6%,24m
8336,2,[ReX416]Canolio,3389,1157,100,95,195,51.3%,6m
8336,3,wishstudio,3389,1165,95,82,177,53.7%,6m
8336,3,[AIRBAG]speedplay,3389,1569,86,71,157,54.8%,5m
8336,2,byMonkeys,3389,1551,70,78,148,47.3%,8m
8336,2,wesley,3389,674,36,32,68,52.9%,30m
8336,2,CMPUNK,3389,543,23,24,47,48.9%,28m
8336,3,[SD760]Flarer,3389,410,20,7,27,74.1%,35m
8336,3,Kankedort,3389,320,15,7,22,68.2%,22m
8336,3,QRcode,3389,314,13,11,24,54.2%,6m
8336,3,BustOnYou,3389,237,9,9,18,50.0%,34m
8336,3,Plott,3389,166,6,5,11,54.5%,3m
8336,3,Obama,3389,30,2,1,3,66.7%,8m
8336,3,[DWbr]joedbat,3389,30,2,3,5,40.0%,35m
8336,3,Teo,3389,30,1,7,8,12.5%,10m
8336,3,GoooGiE,3389,0,0,1,1,0.0%,9m
8336,3,Paranormal,3389,0,0,2,2,0.0%,22m
8336,3,[ValidG]anfurrax,3389,0,0,5,5,0.0%,5m
8355,2,Prole,3388,618,87,74,161,54.0%,14m
8355,3,barcode,3388,650,33,28,61,54.1%,32m
8355,3,Kronus,3388,622,25,24,49,51.0%,5m
8355,1,IIllIlIlIIl,3388,0,5,0,5,100.0%,7m
8355,3,MongShell,3388,30,2,0,2,100.0%,26m
8355,3,[Dicboy]marmelloh,3388,30,1,2,3,33.3%,5m
8355,3,Lemoncup,3388,0,1,3,4,25.0%,2m
8362,3,[AquaZ]PangeaArchon,3387,1060,145,133,278,52.2%,6m
8362,3,NihilDaste,3387,1423,86,76,162,53.1%,13m
8362,3,[LTlord]shakon,3387,1616,85,58,143,59.4%,18m
8362,2,RootBeer,3387,1555,84,96,180,46.7%,7m
8362,2,[SMount]SpiderGuard,3387,1294,68,68,136,50.0%,25m
8362,3,LoveToAMove,3387,715,44,37,81,54.3%,11m
8362,2,Machine,3387,779,37,49,86,43.0%,36m
8362,3,WhiteWolf,3387,488,23,23,46,50.0%,31m
8362,3,MrWin,3387,352,13,10,23,56.5%,14m
8362,3,DarkFox,3387,220,9,9,18,50.0%,6m
8362,3,TheKhangster,3387,243,7,5,12,58.3%,29m
8362,3,HerOSteve,3387,0,0,2,2,0.0%,34m
8362,3,suabe,3387,0,0,2,2,0.0%,42m
8362,3,[500IQ]dElm,3387,0,0,5,5,0.0%,28m
8376,3,MNVikings,3386,1581,101,104,205,49.3%,30m
8376,3,Colossus,3386,1060,54,40,94,57.4%,5m
8376,3,[Raze]KlepToManiaK,3386,1356,54,51,105,51.4%,27m
8376,3,[KGC]LvLOneNinja,3386,1202,48,42,90,53.3%,10m
8376,2,[WpoA]RedXios,3386,649,33,27,60,55.0%,37m
8376,3,GavinSachs,3386,471,20,8,28,71.4%,38m
8376,3,StonedGnome,3386,440,17,14,31,54.8%,30m
8376,3,[SLOP]Dangermouse,3386,302,12,6,18,66.7%,20m
8376,1,[INI]benny,3386,97,4,2,6,66.7%,35m
8376,3,Ragnar,3386,0,0,1,1,0.0%,27m
8376,3,PylonTheWins,3386,0,0,5,5,0.0%,41m
8387,2,BloodyRabbit,3385,1247,111,100,211,52.6%,29m
8387,3,ALDASAM,3385,1423,68,56,124,54.8%,13m
8387,3,[ZTemp]karen,3385,629,43,12,55,78.2%,20m
8387,2,ExiA,3385,516,20,21,41,48.8%,11m
8387,3,DANI,3385,456,17,16,33,51.5%,25m
8387,3,[Chizu]Innovaciones,3385,290,12,3,15,80.0%,36m
8387,2,ohno,3385,178,12,24,36,33.3%,27m
8387,2,[NinTe]Hellpug,3385,251,11,21,32,34.4%,7m
8387,3,[AWNA]Initiator,3385,116,8,4,12,66.7%,15m
8387,3,[813ice]AntxTen,3385,114,5,1,6,83.3%,42m
8387,3,AClick,3385,81,4,1,5,80.0%,17m
8387,3,AnKrehax,3385,86,3,2,5,60.0%,19m
8387,3,[YD2K]winning,3385,0,1,4,5,20.0%,23m
8387,3,PANICMODE,3385,0,0,3,3,0.0%,9m
8387,3,JMG,3385,0,0,5,5,0.0%,6m
8402,3,[tCo9]Kindred,3384,1584,304,286,590,51.5%,36m
8402,2,Scandell,3384,1228,268,237,505,53.1%,6m
8402,3,Vahl,3384,768,66,61,127,52.0%,18m
8402,3,TSQN,3384,824,53,53,106,50.0%,17m
8402,3,rextor,3384,1226,51,38,89,57.3%,39m
8402,3,Hydriad,3384,734,48,30,78,61.5%,23m
8402,3,Pdot,3384,360,18,6,24,75.0%,18m
8402,3,Slayer,3384,338,13,7,20,65.0%,9m
8402,3,AriZZe,3384,30,3,1,4,75.0%,40m
8402,3,AugustoJ,3384,30,2,0,2,100.0%,22m
8402,3,llllllllllll,3384,58,2,1,3,66.7%,20m
8402,2,TitanOfChaos,3384,64,2,13,15,13.3%,36m
8402,3,Aksar,3384,0,1,0,1,100.0%,42m
8402,3,Bluki,3384,30,1,5,6,16.7%,35m
8402,3,FooFoo,3384,30,1,6,7,14.3%,42m
8402,2,[8kPLUS]KimJungNuke,3384,0,1,8,9,11.1%,38m
8402,3,[WW1]KravenII,3384,0,0,2,2,0.0%,17m
8402,3,squeeeeeb,3384,0,0,2,2,0.0%,34m
8402,3,JOHNCENA,3384,0,0,4,4,0.0%,20m
8421,2,[GOPERÚ]deathwork,3383,1592,211,199,410,51.5%,18m
8421,3,Esarel,3383,1588,110,84,194,56.7%,18m
8421,3,Reggimiah,3383,1478,110,103,213,51.6%,24m
8421,3,Shepherd,3383,1547,71,77,148,48.0%,11m
8421,2,[PTHero]Chuck,3383,1294,52,57,109,47.7%,32m
8421,3,JonXnoL,3383,902,37,32,69,53.6%,15m
8421,3,[Pharoh]snowdrop,3383,459,19,6,25,76.0%,22m
8421,3,Ads,3383,304,13,8,21,61.9%,7m
8421,3,klink,3383,220,8,13,21,38.1%,16m
8421,3,Trynda,3383,114,4,4,8,50.0%,23m
8421,3,Detiner,3383,58,3,0,3,100.0%,22m
8421,3,Arsenal,3383,30,2,1,3,66.7%,29m
8421,3,FourFeathers,3383,0,1,0,1,100.0%,28m
8421,3,[UpeV]PLATANO,3383,0,1,0,1,100.0%,11m
8421,3,Neo,3383,0,0,1,1,0.0%,40m
8421,3,[NPhasA]kuppo,3383,0,0,6,6,0.0%,26m
8437,2,[M1A5]ddms,3382,1177,193,178,371,52.0%,30m
8437,2,Generate,3382,1388,98,90,188,52.1%,9m
8437,3,[RokKU]timik,3382,1390,77,80,157,49.0%,5m
8437,3,[UpeV]AfterHours,3382,626,22,28,50,44.0%,5m
8437,2,GTRgodzilla,3382,478,16,25,41,39.0%,30m
8437,3,[DRS]Kraze,3382,254,12,8,20,60.0%,34m
8437,2,Asmodeus,3382,312,10,22,32,31.2%,35m
8437,3,[M1A5]GeneTonic,3382,224,9,6,15,60.0%,24m
8437,1,RubyTopaz,3382,120,6,1,7,85.7%,38m
8437,1,[GWL]Brotoss,3382,97,4,2,6,66.7%,2h
8437,3,[TCRC]duncgardner,3382,88,4,3,7,57.1%,16m
8437,3,FatalglorY,3382,118,4,5,9,44.4%,25m
8437,3,Immortal,3382,144,3,4,7,42.9%,19m
8437,1,Topgun,3382,46,1,1,2,50.0%,27m
8437,3,KriXuS,3382,96,1,1,2,50.0%,36m
8437,3,Anele,3382,30,1,6,7,14.3%,18m
8437,3,Solidarity,3382,0,0,1,1,0.0%,23m
8437,3,Kingantiuwan,3382,0,0,7,7,0.0%,10m
8455,2,Ollraaaa,3381,1416,221,201,422,52.4%,9m
8455,2,[OhMG]TheMOO,3381,1502,83,90,173,48.0%,18m
8455,2,Odyssey,3381,1127,62,66,128,48.4%,36m
8455,2,[DNYO]Sorry,3381,189,40,24,64,62.5%,37m
8455,3,[DuJour]CelebiPZ,3381,660,25,25,50,50.0%,7m
8455,3,XenoMorphKai,3381,534,21,15,36,58.3%,3m
8455,3,llPerfection,3381,219,10,5,15,66.7%,5m
8455,3,[BYOD]GWkey,3381,254,10,7,17,58.8%,17m
8455,3,[TCook]Beercules,3381,88,4,1,5,80.0%,14m
8455,3,[jCp]Billiardwolf,3381,0,4,1,5,80.0%,3m
8455,3,titan,3381,60,2,3,5,40.0%,5m
8455,3,MarckLiaM,3381,62,2,9,11,18.2%,26m
8455,1,[CBO]Vromrig,3381,0,1,4,5,20.0%,29m
8455,3,Judo,3381,0,0,1,1,0.0%,6m
8469,3,BarCode,3380,1613,783,760,1543,50.7%,5m
8469,3,[NFLDs]Imperator,3380,1578,185,183,368,50.3%,22m
8469,2,[SsaYnS]Formic,3380,322,11,15,26,42.3%,6m
8469,3,Gentleman,3380,226,9,4,13,69.2%,8m
8469,2,fasterrcnn,3380,144,5,8,13,38.5%,29m
8469,3,[Lp]LONG,3380,58,3,1,4,75.0%,5m
8469,3,Doucher,3380,86,3,4,7,42.9%,18m
8469,3,Anti,3380,30,2,3,5,40.0%,23m
8469,3,[Fir3s]LiquidCurage,3380,0,1,0,1,100.0%,31m
8469,3,Thexycuuuunt,3380,0,1,0,1,100.0%,38m
8479,2,[TeamUR]Deep,3379,1516,187,192,379,49.3%,32m
8479,2,WizarD,3379,1550,71,82,153,46.4%,20m
8479,3,[SHle]Sergio,3379,812,35,34,69,50.7%,38m
8479,3,Jimbo,3379,868,33,27,60,55.0%,22m
8479,3,[B2TF]Lox,3379,678,24,26,50,48.0%,17m
8479,3,NeronX,3379,535,21,10,31,67.7%,34m
8479,3,gwu,3379,402,16,7,23,69.6%,34m
8479,3,Limon,3379,144,7,0,7,100.0%,28m
8479,3,llllllllllll,3379,0,1,0,1,100.0%,30m
8479,3,[Qu4ntm]lChingonl,3379,30,1,2,3,33.3%,6m
8479,3,[lemur]Potatoes,3379,0,0,1,1,0.0%,19m
8479,3,[DRKAPP]OCOMON,3379,0,0,1,1,0.0%,27m
8479,3,[FxB]Visser,3379,0,0,2,2,0.0%,19m
8492,3,TheMentalist,3378,1592,589,583,1172,50.3%,36m
8492,3,[NOMMM]rofltarts,3378,1367,101,74,175,57.7%,26m
8492,3,ShriekinGeek,3378,1242,48,44,92,52.2%,25m
8492,2,[NPhasA]ThreeBarrack,3378,676,22,33,55,40.0%,38m
8492,2,PunyBoy,3378,503,20,22,42,47.6%,38m
8492,3,BroastGarlic,3378,416,14,19,33,42.4%,13m
8492,2,Sin,3378,352,12,24,36,33.3%,8m
8492,3,Rudais,3378,276,10,11,21,47.6%,26m
8492,1,Pantoufle,3378,145,7,2,9,77.8%,35m
8492,3,[EIder]Drift,3378,146,5,5,10,50.0%,35m
8492,3,Cito,3378,60,2,7,9,22.2%,9m
8492,3,Zombieloco,3378,0,1,0,1,100.0%,9m
8492,3,WeeWoo,3378,0,1,0,1,100.0%,36m
8492,3,[DmEs]IIIIIIIIIIII,3378,30,1,7,8,12.5%,4m
8492,3,Dopen,3378,0,0,1,1,0.0%,19m
8492,3,funkygiant,3378,0,0,5,5,0.0%,15m
8508,2,[GOPERÚ]TRAX,3377,1559,236,236,472,50.0%,30m
8508,2,namos,3377,1556,216,211,427,50.6%,8m
8508,3,[nieBla]Axwel,3377,1584,107,82,189,56.6%,29m
8508,3,[DPAS]Expendable,3377,1025,67,53,120,55.8%,11m
8508,2,ThatGinger,3377,1420,52,61,113,46.0%,13m
8508,3,HarryLu,3377,762,32,21,53,60.4%,29m
8508,3,Lockheed,3377,588,26,19,45,57.8%,19m
8508,3,Rexraynor,3377,568,24,13,37,64.9%,20m
8508,3,[DRKRPT]WAFFLES,3377,524,19,19,38,50.0%,40m
8508,3,[BIIID]IIIIIIIIIIII,3377,352,14,10,24,58.3%,4m
8508,3,balbalta,3377,0,3,3,6,50.0%,18m
8508,3,llllllllllll,3377,97,1,1,2,50.0%,25m
8508,3,stemgg,3377,0,0,3,3,0.0%,6m
8521,2,kimjang,3376,1239,94,86,180,52.2%,26m
8521,3,[ØÛ]StartinHP,3376,701,56,35,91,61.5%,6m
8521,3,FosTA,3376,533,20,25,45,44.4%,27m
8521,3,HDRghdr,3376,502,19,19,38,50.0%,25m
8521,3,Vend,3376,496,18,20,38,47.4%,25m
8521,3,Polarity,3376,322,12,15,27,44.4%,25m
8521,3,Stress,3376,146,8,4,12,66.7%,9m
8521,3,[LIR]TheSergeant,3376,200,7,7,14,50.0%,30m
8521,3,Claudio,3376,142,6,5,11,54.5%,35m
8521,3,GrumpyMonk,3376,182,6,11,17,35.3%,37m
8521,3,[PL0TE]Nicklo,3376,90,4,4,8,50.0%,28m
8521,3,sincostan,3376,58,2,1,3,66.7%,7m
8521,3,[AutoT]Hefesto,3376,58,2,2,4,50.0%,26m
8521,3,Scaomin,3376,30,2,3,5,40.0%,30m
8535,2,[LQV]TheHetero,3375,1342,590,561,1151,51.3%,9m
8535,2,KarlConrad,3375,1508,275,275,550,50.0%,38m
8535,2,[NoeBW]HHit,3375,1548,264,262,526,50.2%,18m
8535,2,Poiskail,3375,1468,251,246,497,50.5%,18m
8535,2,[MDLP]BlackFalcon,3375,1399,199,178,377,52.8%,30m
8535,2,[SyLx]Rhayne,3375,1535,137,106,243,56.4%,13m
8535,2,[TSOUR]Moritz,3375,1413,89,84,173,51.4%,2m
8535,2,[Pelzy]Gluten,3375,780,76,83,159,47.8%,10m
8535,3,RyAMystic,3375,1031,60,50,110,54.5%,30m
8535,3,[Th3Bad]Shark,3375,802,39,29,68,57.4%,31m
8535,3,TrumpCard,3375,785,32,19,51,62.7%,7m
8535,3,[umoron]Doombats,3375,448,16,19,35,45.7%,3m
8535,3,[a55a55]Dirtynammer,3375,218,10,3,13,76.9%,41m
8535,3,Phaedrus,3375,224,8,11,19,42.1%,26m
8535,3,ROBOT,3375,60,7,1,8,87.5%,26m
8535,1,DaBeast,3375,120,6,1,7,85.7%,7m
8535,3,Deathkillerz,3375,170,6,4,10,60.0%,39m
8535,3,[NPhasA]dadada,3375,177,5,5,10,50.0%,2m
8535,3,Schorn,3375,86,4,3,7,57.1%,11m
8535,3,FunnyUndies,3375,120,4,6,10,40.0%,16m
8535,3,JMC,3375,60,3,1,4,75.0%,18m
8535,1,stigmurder,3375,0,1,0,1,100.0%,1h
8535,3,SideShow,3375,0,1,0,1,100.0%,10m
8558,2,[Weac]bananaman,3374,1100,65,57,122,53.3%,2m
8558,3,[AiMB]CeeDee,3374,1209,53,40,93,57.0%,30m
8558,3,[HoB0]TheJudge,3374,1030,40,40,80,50.0%,24m
8558,3,llllllllllll,3374,307,29,16,45,64.4%,41m
8558,3,NNNostaliii,3374,600,23,20,43,53.5%,18m
8558,3,Lyonsy,3374,443,19,17,36,52.8%,42m
8558,3,[Dumfuk]BloodyBottom,3374,382,16,8,24,66.7%,14m
8558,3,[iREKT]guiguicool,3374,228,8,7,15,53.3%,10m
8558,3,[DRKRIS]woshinidaye,3374,148,6,10,16,37.5%,25m
8558,3,PepgaPower,3374,30,5,1,6,83.3%,11m
8558,3,Hysteric,3374,114,5,3,8,62.5%,40m
8558,3,Bearoo,3374,0,4,1,5,80.0%,30m
8558,3,[lNI]AlwaysHigh,3374,0,0,1,1,0.0%,9m
8571,3,[FU2]MrJack,3373,1543,144,134,278,51.8%,41m
8571,3,HarKon,3373,1598,104,83,187,55.6%,19m
8571,3,[Elder]pieguy,3373,1178,44,39,83,53.0%,36m
8571,3,zergRush,3373,443,29,19,48,60.4%,39m
8571,2,Bacchus,3373,725,25,33,58,43.1%,34m
8571,3,Peter,3373,432,16,11,27,59.3%,5m
8571,3,[Yamaha]FATCHOOCHIE,3373,444,16,20,36,44.4%,16m
8571,3,[HSOS]EzNoob,3373,360,14,5,19,73.7%,11m
8571,3,[ØFoxF2]Moxterr,3373,402,13,15,28,46.4%,13m
8571,3,[xENTx]Simo,3373,207,9,8,17,52.9%,13m
8571,3,Ammelon,3373,142,7,2,9,77.8%,4m
8571,3,Insatiable,3373,146,6,4,10,60.0%,11m
8571,3,Smokahontuss,3373,188,5,2,7,71.4%,35m
8571,3,TtGjacOb,3373,0,2,3,5,40.0%,3m
8571,3,[Lp]RaidBudao,3373,0,0,1,1,0.0%,5m
8586,2,DevilFrank,3372,1544,217,212,429,50.6%,30m
8586,3,BUBU,3372,128,19,21,40,47.5%,19m
8586,3,morfy,3372,322,11,18,29,37.9%,2m
8586,3,PanCakeMix,3372,252,10,14,24,41.7%,36m
8586,3,Sentry,3372,94,4,5,9,44.4%,15m
8586,1,IMOp,3372,91,2,0,2,100.0%,22m
8586,3,ENTUCULO,3372,58,2,3,5,40.0%,34m
8586,3,WhiteMonster,3372,0,2,3,5,40.0%,17m
8586,3,Zanderman,3372,0,1,0,1,100.0%,31m
8595,3,[TSFs]olivia,3371,1197,61,68,129,47.3%,29m
8595,2,Deylinia,3371,860,33,32,65,50.8%,41m
8595,3,iwantsnacks,3371,357,16,11,27,59.3%,18m
8595,1,[UnitQC]Gates,3371,119,6,1,7,85.7%,14m
8595,3,Leo,3371,58,5,4,9,55.6%,30m
8595,1,Soul,3371,0,3,2,5,60.0%,2h
8595,1,[SkAL]Skalinas,3371,0,1,0,1,100.0%,40m
8595,3,senbonzakura,3371,0,1,0,1,100.0%,19m
8595,3,PantsMcEnzie,3371,0,1,0,1,100.0%,27m
8595,3,[DN3]ARTHISTA,3371,0,0,1,1,0.0%,25m
8605,2,[JTRUMP]MilesCru,3370,978,198,208,406,48.8%,30m
8605,3,[SCVM]NoblePhoenix,3370,559,21,13,34,61.8%,30m
8605,3,Tiburcio,3370,312,12,13,25,48.0%,36m
8605,3,SmilyBane,3370,114,5,3,8,62.5%,22m
8605,3,ViKinG,3370,118,5,6,11,45.5%,42m
8605,3,rapidarray,3370,30,2,1,3,66.7%,7m
8605,3,NurfQT,3370,30,2,2,4,50.0%,27m
8605,3,[CRAZY]Heeler,3370,0,1,0,1,100.0%,19m
8605,3,FingerSmash,3370,0,0,1,1,0.0%,12m
8614,3,[CRAKS]RaOnFire,3369,1261,73,47,120,60.8%,6m
8614,2,[Pig2]Snelly,3369,495,64,63,127,50.4%,4m
8614,3,CSantder,3369,998,43,29,72,59.7%,17m
8614,2,[LSU]Bizzell,3369,782,37,56,93,39.8%,26m
8614,3,MMMM,3369,0,1,1,2,50.0%,24m
8614,3,[KOATS]ChillBot,3369,0,1,2,3,33.3%,14m
8614,3,[MCHG]lXBoss,3369,30,1,5,6,16.7%,3m
8621,2,nakster,3368,1510,176,185,361,48.8%,36m
8621,3,McCracken,3368,383,99,96,195,50.8%,13m
8621,3,ITBYY,3368,716,87,74,161,54.0%,41m
8621,3,PizzaGuy,3368,1482,58,54,112,51.8%,3m
8621,3,wiblyspceman,3368,631,28,15,43,65.1%,20m
8621,3,[budYu]bud,3368,554,21,24,45,46.7%,2m
8621,3,TReXXX,3368,520,20,18,38,52.6%,17m
8621,3,[xEUGMx]Shaarik,3368,217,17,13,30,56.7%,17m
8621,1,Gabagool,3368,195,14,6,20,70.0%,5m
8621,3,[NextDC]SnOw,3368,293,12,16,28,42.9%,19m
8621,1,[FofS]Rain,3368,273,11,7,18,61.1%,2m
8621,2,[GGBGll]SColddriver,3368,170,10,18,28,35.7%,31m
8621,3,Prince,3368,170,7,4,11,63.6%,10m
8621,3,IIIII,3368,200,7,8,15,46.7%,18m
8621,3,AyeCaptain,3368,168,6,4,10,60.0%,22m
8621,3,[DarkAG]Jaicir,3368,170,6,5,11,54.5%,4m
8621,3,JonnyCraig,3368,133,5,4,9,55.6%,7m
8621,3,FLasH,3368,122,4,10,14,28.6%,30m
8621,2,PruneHead,3368,64,2,12,14,14.3%,13m
8621,3,Tanubis,3368,0,1,0,1,100.0%,13m
8621,3,DaRcKcHeMaN,3368,30,1,1,2,50.0%,38m
8621,2,Zerglot,3368,0,0,1,1,0.0%,7m
8643,2,AnyoneHighRN,3367,1376,84,93,177,47.5%,30m
8643,2,doran,3367,588,29,36,65,44.6%,7m
8643,3,Punky,3367,442,19,18,37,51.4%,25m
8643,3,IIIIIIIIIIII,3367,413,17,11,28,60.7%,3m
8643,3,darksolo,3367,460,16,18,34,47.1%,32m
8643,3,[SDC12]VictoR,3367,202,8,10,18,44.4%,16m
8643,3,spacecake,3367,90,7,3,10,70.0%,30m
8643,3,[Frnzy]SHELTERin,3367,200,6,3,9,66.7%,5m
8643,3,ggez,3367,30,5,1,6,83.3%,42m
8643,3,[SANGRE]JaYiSiS,3367,0,1,0,1,100.0%,13m
8643,3,uwu,3367,0,1,0,1,100.0%,19m
8643,1,sboxer,3367,97,1,1,2,50.0%,2h
8643,3,Frisch,3367,0,0,1,1,0.0%,5m
8643,3,CodeDjinn,3367,0,0,1,1,0.0%,25m
8643,3,xiaochun,3367,0,0,1,1,0.0%,24m
8643,3,[ZTemp]NantenKnight,3367,0,0,1,1,0.0%,19m
8659,2,[SsaYnS]Whorgez,3366,1063,295,287,582,50.7%,24m
8659,3,[YD2K]BlueDucky,3366,1520,132,112,244,54.1%,42m
8659,3,[nd83]RoboBear,3366,680,82,72,154,53.2%,21m
8659,3,[ACSS]CoBro,3366,1214,48,43,91,52.7%,26m
8659,3,eZZeCuTeR,3366,1098,41,41,82,50.0%,34m
8659,3,TheStig,3366,365,19,8,27,70.4%,6m
8659,3,KevMcAlister,3366,295,15,15,30,50.0%,2m
8659,3,[SsaYnS]JiaoBaBa,3366,272,14,11,25,56.0%,36m
8659,3,[CHEE53]BitsPlease,3366,372,13,19,32,40.6%,9m
8659,3,[lNI]PrismMike,3366,290,11,8,19,57.9%,3m
8659,3,RatsAhoy,3366,239,10,5,15,66.7%,22m
8659,1,Grant,3366,96,5,1,6,83.3%,40m
8659,2,Knify,3366,102,4,5,9,44.4%,7m
8659,1,[NeAs]LiquidADS,3366,0,3,1,4,75.0%,7m
8659,3,[Dbird]DancingBird,3366,86,3,3,6,50.0%,26m
8659,3,Thorpe,3366,0,1,0,1,100.0%,41m
8659,3,[tets]VichipomS,3366,0,1,0,1,100.0%,42m
8659,2,LUNi,3366,0,1,11,12,8.3%,6m
8659,3,[Wndrrs]QuipQuop,3366,0,0,1,1,0.0%,9m
8659,1,[bLuu]bLuuPylon,3366,0,0,1,1,0.0%,3h
8679,3,SeBoM,3365,623,132,91,223,59.2%,5m
8679,3,Rigel,3365,629,122,111,233,52.4%,38m
8679,2,[RS69]Toxin,3365,1354,115,111,226,50.9%,28m
8679,3,[QTclub]SrLobo,3365,878,41,24,65,63.1%,20m
8679,3,Knazovv,3365,607,26,19,45,57.8%,19m
8679,3,flop,3365,461,20,16,36,55.6%,29m
8679,3,LonelyProbe,3365,304,13,5,18,72.2%,25m
8679,3,[UAK]DragonLord,3365,144,9,6,15,60.0%,40m
8679,2,[LimLim]ngsWarning,3365,156,9,11,20,45.0%,21m
8679,1,[CoolLC]Tenyasha,3365,126,6,4,10,60.0%,38m
8679,3,[NairX]MeDiX,3365,116,6,6,12,50.0%,26m
8679,1,[CHEE53]Harsh,3365,97,5,1,6,83.3%,7m
8679,3,Ziggy,3365,30,3,3,6,50.0%,9m
8679,3,[CnfOD]iacta,3365,0,2,5,7,28.6%,22m
8679,3,QuaintPi,3365,0,1,0,1,100.0%,14m
8679,3,Lacross,3365,30,1,1,2,50.0%,35m
8679,3,Scozac,3365,0,0,3,3,0.0%,32m
8679,3,BerrDandi,3365,0,0,3,3,0.0%,20m
8697,3,Pituco,3364,1675,182,144,326,55.8%,42m
8697,2,[iB1]JavierMontes,3364,1375,162,156,318,50.9%,16m
8697,3,Infinite,3364,1588,143,107,250,57.2%,17m
8697,3,Cyclops,3364,1156,136,116,252,54.0%,39m
8697,3,Don,3364,507,84,84,168,50.0%,5m
8697,2,[H8T3D]PeonSlayer,3364,1232,42,59,101,41.6%,22m
8697,3,leavethegun,3364,832,31,37,68,45.6%,6m
8697,2,nocannobb,3364,188,10,4,14,71.4%,13m
8697,1,LazyTurtle,3364,118,6,1,7,85.7%,2h
8697,3,Paladin,3364,146,6,5,11,54.5%,19m
8697,2,Tiath,3364,149,4,2,6,66.7%,3m
8697,3,JcR,3364,58,3,3,6,50.0%,40m
8697,3,Naiqey,3364,30,2,0,2,100.0%,38m
8697,3,Datrix,3364,0,1,0,1,100.0%,36m
8697,3,[iGOSU]FFEorDie,3364,0,0,1,1,0.0%,5m
8712,3,jimmer,3363,1567,75,73,148,50.7%,26m
8712,3,Julius,3363,1434,61,48,109,56.0%,41m
8712,3,Stardu,3363,868,33,31,64,51.6%,17m
8712,3,BlackLancer,3363,542,24,29,53,45.3%,31m
8712,2,Karihara,3363,95,6,3,9,66.7%,18m
8712,3,onakua,3363,182,6,13,19,31.6%,21m
8712,3,BLACKPAPPER,3363,138,4,1,5,80.0%,35m
8712,3,SmoothKuo,3363,104,4,9,13,30.8%,3m
8712,3,Chee,3363,58,3,1,4,75.0%,24m
8712,3,qqq,3363,0,1,0,1,100.0%,32m
8712,3,Moridin,3363,0,1,0,1,100.0%,29m
8712,2,FrostBiTE,3363,0,0,1,1,0.0%,31m
8712,3,[xLgNx]MajinUub,3363,0,0,1,1,0.0%,22m
8712,3,Chikaboom,3363,0,0,2,2,0.0%,10m
8712,3,PowerGrub,3363,0,0,2,2,0.0%,8m
8727,2,BenchmarK,3362,1566,198,207,405,48.9%,38m
8727,3,Kenyu,3362,1189,132,107,239,55.2%,18m
8727,3,iamvoodoo,3362,998,110,116,226,48.7%,36m
8727,3,weenuk,3362,1324,71,56,127,55.9%,7m
8727,3,[LgnTDS]DrWerm,3362,606,68,51,119,57.1%,20m
8727,2,[Moo0]SCvirgin,3362,1164,66,66,132,50.0%,7m
8727,3,[UpeV]Prometeo,3362,912,44,44,88,50.0%,20m
8727,3,Zildy,3362,536,18,23,41,43.9%,10m
8727,1,FourGate,3362,230,7,11,18,38.9%,40m
8727,3,ztek,3362,86,3,2,5,60.0%,21m
8727,3,MysticGx,3362,136,3,2,5,60.0%,25m
8727,3,Hisoka,3362,0,1,0,1,100.0%,42m
8727,3,[FenGCN]MrMeepO,3362,0,0,1,1,0.0%,8m
8740,3,SpineshanK,3361,1658,356,315,671,53.1%,40m
8740,3,[BroBlo]Axumi,3361,1419,66,48,114,57.9%,24m
8740,2,Denis,3361,956,60,56,116,51.7%,21m
8740,3,Mlepnos,3361,1001,42,27,69,60.9%,11m
8740,3,[iDrunk]MaxLarger,3361,856,34,30,64,53.1%,30m
8740,3,[DxP]INJUNDIA,3361,594,31,28,59,52.5%,19m
8740,3,sykeasaurus,3361,479,27,20,47,57.4%,39m
8740,2,[SuperZ]COVIDXIX,3361,656,23,36,59,39.0%,18m
8740,3,Epitometric,3361,473,21,12,33,63.6%,30m
8740,2,Bulbafett,3361,258,10,14,24,41.7%,26m
8740,3,Canuck,3361,241,8,5,13,61.5%,26m
8740,1,NickNickson,3361,97,5,1,6,83.3%,2h
8740,3,[TGosuC]Maliss,3361,150,5,12,17,29.4%,15m
8740,3,Pere,3361,30,1,1,2,50.0%,9m
8740,3,BossGreek,3361,30,1,4,5,20.0%,11m
8740,3,[KR20]WISDOM,3361,0,0,1,1,0.0%,25m
8756,3,DaneelOlivaw,3360,1035,124,93,217,57.1%,30m
8756,3,[Th3Bad]Bondrewd,3360,1081,115,106,221,52.0%,36m
8756,3,LoKuS,3360,961,91,72,163,55.8%,25m
8756,2,cheesebatt,3360,681,87,87,174,50.0%,6m
8756,3,[FROMOZ]Bluee,3360,1627,83,74,157,52.9%,42m
8756,3,HULKAMANIA,3360,1063,80,75,155,51.6%,17m
8756,3,[UpeV]Electricmano,3360,645,25,22,47,53.2%,3m
8756,1,[VH]Rollo,3360,275,9,12,21,42.9%,2m
8756,3,[Cryptc]KRUM,3360,182,6,11,17,35.3%,17m
8756,3,[LIMSC2]MagicSocks,3360,58,3,5,8,37.5%,9m
8756,3,[Toiley]Klog,3360,0,1,1,2,50.0%,30m
8756,3,[Meute]iRushAlways,3360,0,1,1,2,50.0%,29m
8768,3,[ZCCCFE]KeyzerSoze,3359,1590,165,160,325,50.8%,36m
8768,3,[UpeV]VIKTHOR,3359,1275,65,60,125,52.0%,35m
8768,2,PrbeLfeMafia,3359,1019,47,54,101,46.5%,23m
8768,3,Salicornia,3359,424,16,17,33,48.5%,22m
8768,3,[XCPT]TheJuicer,3359,384,15,12,27,55.6%,22m
8768,3,[Cryptc]ChaozFantasy,3359,380,13,16,29,44.8%,3m
8768,3,Cerulean,3359,254,9,15,24,37.5%,39m
8768,3,Gouda,3359,208,8,6,14,57.1%,5m
8768,3,Monsuno,3359,76,7,8,15,46.7%,32m
8768,3,Various,3359,116,4,2,6,66.7%,14m
8768,2,Loko,3359,42,2,0,2,100.0%,21m
8768,3,yourleftball,3359,0,1,0,1,100.0%,42m
8768,1,[9Slash]Cirno,3359,0,0,1,1,0.0%,29m
8768,3,IIIIIIIIIIII,3359,0,0,3,3,0.0%,22m
8782,3,chaejungeun,3358,1626,115,100,215,53.5%,36m
8782,3,Chris,3358,1488,63,64,127,49.6%,12m
8782,3,YawarMayu,3358,924,42,25,67,62.7%,32m
8782,3,[BlubLo]Skele,3358,356,17,11,28,60.7%,6m
8782,3,[UnPhuk]TheFlamingo,3358,305,15,12,27,55.6%,39m
8782,3,[FkHost]Altectech,3358,119,11,9,20,55.0%,17m
8782,1,[JayRay]Dopamisuga,3358,165,8,6,14,57.1%,13m
8782,3,IIIIIIIIIIII,3358,183,5,1,6,83.3%,39m
8782,3,Taeyeon,3358,0,3,2,5,60.0%,9m
8782,3,[APM9k]ProfessionaL,3358,0,0,1,1,0.0%,38m
8782,3,[dime]Wyvern,3358,0,0,1,1,0.0%,2m
8782,3,[Xpk]lechuga,3358,0,0,1,1,0.0%,24m
8782,3,Talon,3358,0,0,2,2,0.0%,5m
8795,2,anaujiraM,3357,1552,577,554,1131,51.0%,6m
8795,2,Cadrigar,3357,1571,247,231,478,51.7%,2m
8795,3,Arax,3357,1594,87,92,179,48.6%,6m
8795,3,[KhanTv]konodioda,3357,532,22,15,37,59.5%,16m
8795,3,shaumbs,3357,305,15,6,21,71.4%,9m
8795,3,Timeless,3357,214,11,2,13,84.6%,22m
8795,3,[Zatra]itzlogan,3357,252,10,6,16,62.5%,32m
8795,3,PoonZ,3357,233,10,14,24,41.7%,22m
8795,3,Kevz,3357,279,9,8,17,52.9%,11m
8795,3,Kaloonks,3357,196,6,2,8,75.0%,22m
8795,1,Rip,3357,122,6,2,8,75.0%,30m
8795,1,toMMMMMMMMMM,3357,90,3,5,8,37.5%,20m
8795,3,DaOne,3357,58,2,1,3,66.7%,20m
8795,3,[TX]Rud,3357,0,0,1,1,0.0%,19m
8809,3,[sLuxx]Ladster,3356,896,82,72,154,53.2%,36m
8809,3,[HØST]EliasParrini,3356,1590,80,80,160,50.0%,11m
8809,3,Csuth,3356,1650,67,57,124,54.0%,32m
8809,3,JuhwanJeong,3356,884,33,36,69,47.8%,35m
8809,3,ChopperDave,3356,322,14,11,25,56.0%,7m
8809,3,funnyZEALOT,3356,0,5,0,5,100.0%,34m
8809,3,[Hunny]Starlett,3356,86,4,5,9,44.4%,12m
8809,3,Arcamage,3356,86,3,1,4,75.0%,24m
8809,3,[haidua]Casey,3356,60,3,2,5,60.0%,6m
8809,3,Sprite,3356,60,2,2,4,50.0%,21m
8809,3,[WW1]ProHunter,3356,97,2,5,7,28.6%,39m
8809,3,[JABW]aRcAngel,3356,60,2,8,10,20.0%,24m
8809,3,village,3356,0,1,0,1,100.0%,34m
8809,3,KalnDharky,3356,0,1,6,7,14.3%,3m
8809,3,Kestnuts,3356,30,1,8,9,11.1%,36m
8809,3,[Macac0]SoyDePapel,3356,0,0,1,1,0.0%,13m
8825,3,boubou,3355,1015,57,31,88,64.8%,8m
8825,3,[BoAVN]PythonVN,3355,696,57,46,103,55.3%,37m
8825,3,Hobbes,3355,1226,48,40,88,54.5%,17m
8825,3,[TSWlFT]TheTortoise,3355,546,24,14,38,63.2%,11m
8825,3,dvi,3355,490,20,12,32,62.5%,17m
8825,3,metropolitan,3355,298,14,6,20,70.0%,4m
8825,3,[NPhasA]TTTGGG,3355,226,10,9,19,52.6%,10m
8825,3,[TOYOTA]CamryPower,3355,0,1,0,1,100.0%,17m
8825,3,NeoBlade,3355,30,1,1,2,50.0%,15m
8825,3,[LAREV]maxTREX,3355,0,0,1,1,0.0%,19m
8825,3,[LPACL]TheMAuRo,3355,0,0,1,1,0.0%,37m
8836,2,DeathBald,3354,1552,718,714,1432,50.1%,10m
8836,3,Gianzex,3354,1541,192,183,375,51.2%,5m
8836,3,ELROnaldoH,3354,1041,56,39,95,58.9%,17m
8836,3,Odysseus,3354,995,52,41,93,55.9%,22m
8836,1,Fow,3354,1320,43,65,108,39.8%,27m
8836,3,JimBoogie,3354,781,36,20,56,64.3%,25m
8836,3,[SqR]SchoolBus,3354,825,31,26,57,54.4%,5m
8836,3,KnightMares,3354,559,29,16,45,64.4%,7m
8836,3,Buricle,3354,619,28,24,52,53.8%,40m
8836,3,Xylocarp,3354,282,19,10,29,65.5%,36m
8836,3,otk,3354,198,8,8,16,50.0%,26m
8836,3,Moistanator,3354,240,7,2,9,77.8%,7m
8836,3,NoProButToss,3354,121,5,6,11,45.5%,13m
8836,3,Patches,3354,156,5,13,18,27.8%,5m
8836,3,ForWarD,3354,142,4,2,6,66.7%,35m
8836,3,Soxxii,3354,60,4,7,11,36.4%,5m
8836,3,Zoonik,3354,0,0,1,1,0.0%,35m
8853,3,[DarkAG]MinajestY,3353,1625,141,127,268,52.6%,36m
8853,2,[PvZMa]CONTRA,3353,1397,78,59,137,56.9%,25m
8853,3,LEDalogen,3353,1531,71,73,144,49.3%,24m
8853,3,xDAVx,3353,1179,68,42,110,61.8%,27m
8853,3,[Kixeye]Kukuro,3353,581,60,49,109,55.0%,24m
8853,3,FUBUKI,3353,1188,56,29,85,65.9%,7m
8853,3,phil,3353,328,12,9,21,57.1%,15m
8853,3,[Mellow]MellowKuo,3353,196,8,6,14,57.1%,9m
8853,3,DiS,3353,196,8,10,18,44.4%,8m
8853,3,[OD2019]alllucky,3353,192,7,10,17,41.2%,40m
8853,3,[2Pac96]Zebulon,3353,140,6,12,18,33.3%,40m
8853,3,[AD3C]Sasuke,3353,78,3,4,7,42.9%,14m
8853,2,IlIlIlIlIlIl,3353,0,3,5,8,37.5%,37m
8853,3,[PointW]Zurnar,3353,58,2,1,3,66.7%,5m
8853,3,zekimar,3353,0,1,0,1,100.0%,5m
8853,3,[SXTeam]TempestFT,3353,30,1,2,3,33.3%,40m
8853,3,[Fluxy]gdolphin,3353,0,1,2,3,33.3%,32m
8853,3,Bierboot,3353,30,1,5,6,16.7%,21m
8853,3,Dunkalicious,3353,0,0,1,1,0.0%,20m
8853,3,OpaqueOne,3353,0,0,1,1,0.0%,5m
8853,1,ChipS,3353,0,0,5,5,0.0%,13m
8874,3,[αXLa]PrinceMarine,3352,930,54,47,101,53.5%,36m
8874,3,NervE,3352,730,31,22,53,58.5%,34m
8874,3,[TGosuA]CLOUD,3352,662,29,23,52,55.8%,40m
8874,3,molleee,3352,250,10,5,15,66.7%,18m
8874,3,[JustFF]Toshee,3352,209,9,5,14,64.3%,41m
8874,1,Razor,3352,0,2,2,4,50.0%,3h
8874,3,Taoki,3352,30,1,2,3,33.3%,14m
8874,3,princesasuke,3352,0,1,4,5,20.0%,10m
8874,3,ZEROSTAR,3352,0,0,1,1,0.0%,23m
8874,2,UdUwUdU,3352,0,0,1,1,0.0%,18m
8884,3,[FxB]sherpard,3351,1620,282,253,535,52.7%,12m
8884,2,Jeramir,3351,1551,179,169,348,51.4%,21m
8884,3,[TeamUR]Magyner,3351,1495,84,71,155,54.2%,24m
8884,2,[DhZPro]mwaltr,3351,870,53,65,118,44.9%,21m
8884,3,TheOtherOne,3351,598,24,16,40,60.0%,14m
8884,3,Namster,3351,302,12,6,18,66.7%,13m
8884,3,SuaVv,3351,266,10,12,22,45.5%,29m
8884,3,[cl0udM]Divi,3351,172,7,4,11,63.6%,21m
8884,1,ViVaFrAnCia,3351,142,6,2,8,75.0%,2h
8884,3,[TB303]inFOCUS,3351,166,6,4,10,60.0%,10m
8884,3,[ValidG]JIMMY,3351,60,3,9,12,25.0%,14m
8884,3,ooksei,3351,30,1,5,6,16.7%,40m
8884,3,Boom,3351,0,0,3,3,0.0%,9m
8897,2,[UpeV]KevinBcX,3350,1305,162,170,332,48.8%,26m
8897,2,ishi,3350,713,77,80,157,49.0%,13m
8897,3,bing,3350,1482,72,59,131,55.0%,19m
8897,3,[Kleets]Kolado,3350,512,20,20,40,50.0%,25m
8897,3,Harusame,3350,313,14,9,23,60.9%,29m
8897,3,dlwlrmafans,3350,274,8,11,19,42.1%,12m
8897,3,Darkanus,3350,159,4,2,6,66.7%,20m
8897,3,[GnR]GoodBoy,3350,88,4,4,8,50.0%,18m
8897,3,DoGG,3350,92,3,7,10,30.0%,21m
8897,3,[MATTO]Milquetoast,3350,0,1,0,1,100.0%,31m
8897,3,[DarkAG]LUDEMEISTER,3350,0,1,1,2,50.0%,38m
8897,3,[TGosuB]Pcolahitman,3350,30,1,3,4,25.0%,24m
8897,3,Tiars,3350,0,0,1,1,0.0%,31m
8897,3,[PobSC]Folka,3350,0,0,7,7,0.0%,29m
8911,3,[NAisOK]WEEBRATOR,3349,1610,199,195,394,50.5%,10m
8911,3,[439]yoSaku,3349,1602,133,133,266,50.0%,38m
8911,3,QuiDx,3349,1452,56,54,110,50.9%,17m
8911,3,screenslaver,3349,612,25,30,55,45.5%,29m
8911,3,NormaStits,3349,299,13,9,22,59.1%,19m
8911,3,cooc,3349,330,11,19,30,36.7%,20m
8911,3,Degnoob,3349,202,9,9,18,50.0%,29m
8911,3,Crewmate,3349,121,6,2,8,75.0%,10m
8911,2,AnchorMan,3349,158,4,4,8,50.0%,18m
8911,3,ReZ,3349,88,3,4,7,42.9%,30m
8911,2,[YD2K]mikeho,3349,44,2,4,6,33.3%,9m
8911,3,MyherO,3349,62,2,5,7,28.6%,38m
8911,2,BLADE,3349,93,1,3,4,25.0%,17m
8911,3,Mimmoh,3349,0,0,1,1,0.0%,29m
8911,3,[KICKED]flashbrown,3349,0,0,3,3,0.0%,2m
8926,2,JUBEI,3348,1200,194,185,379,51.2%,26m
8926,3,Etno,3348,1300,115,101,216,53.2%,7m
8926,3,PenusChamp,3348,703,66,19,85,77.6%,10m
8926,3,[LowIQ]Kard,3348,1056,45,35,80,56.2%,20m
8926,3,tablecables,3348,935,44,35,79,55.7%,20m
8926,3,[RLA]Maladon,3348,410,24,19,43,55.8%,32m
8926,3,SadGamer,3348,393,16,9,25,64.0%,5m
8926,3,TheMegaBambi,3348,118,5,5,10,50.0%,22m
8926,2,Quarantino,3348,96,2,5,7,28.6%,19m
8926,3,Velocitas,3348,0,0,1,1,0.0%,8m
8936,3,Windy,3347,1567,339,316,655,51.8%,19m
8936,2,[BBYFUR]Barfur,3347,1487,123,131,254,48.4%,25m
8936,3,CheeseFry,3347,1080,39,40,79,49.4%,11m
8936,3,[Lp]ElNoob,3347,542,20,18,38,52.6%,34m
8936,3,[TeamUR]Parka,3347,469,18,14,32,56.2%,7m
8936,3,[KAGUSA]WifePWNer,3347,432,14,23,37,37.8%,32m
8936,3,[Kappa8]TricoCV,3347,153,9,10,19,47.4%,25m
8936,2,BananaStand,3347,182,6,17,23,26.1%,8m
8936,3,[RakF]kakoki,3347,90,3,6,9,33.3%,6m
8936,2,EliteDragon,3347,30,3,9,12,25.0%,12m
8936,3,Duran,3347,60,2,3,5,40.0%,35m
8936,3,Fliper,3347,30,2,5,7,28.6%,3m
8936,1,Squat,3347,0,1,4,5,20.0%,1h
8936,3,AnimalKing,3347,0,0,3,3,0.0%,29m
8950,3,[BrknPp]lankylad,3346,1367,105,88,193,54.4%,20m
8950,2,[Bee]TseLess,3346,1524,91,96,187,48.7%,4m
8950,3,[iDrunk]eric,3346,263,17,9,26,65.4%,7m
8950,3,[xLgNx]Calm,3346,309,11,8,19,57.9%,13m
8950,3,[NrFms]LingLeadeR,3346,220,9,3,12,75.0%,15m
8950,3,AidenHero,3346,168,6,7,13,46.2%,13m
8950,3,badassburito,3346,142,5,7,12,41.7%,3m
8950,3,Zero,3346,40,2,1,3,66.7%,21m
8950,3,[NwAs]Odinsc,3346,0,1,0,1,100.0%,40m
8950,3,QuanticPsych,3346,0,1,0,1,100.0%,10m
8960,2,BackdoorDan,3345,1511,173,168,341,50.7%,9m
8960,3,Optical,3345,1353,103,97,200,51.5%,11m
8960,3,BoggsDiamond,3345,1577,85,71,156,54.5%,40m
8960,3,Fromagerie,3345,1429,58,50,108,53.7%,20m
8960,3,pylosRevenge,3345,488,56,56,112,50.0%,36m
8960,3,[EZAnts]ImNotSneaky,3345,352,14,6,20,70.0%,16m
8960,3,JEFF,3345,340,13,8,21,61.9%,25m
8960,3,Petrucci,3345,247,7,14,21,33.3%,36m
8960,3,ErlantZ,3345,182,6,9,15,40.0%,9m
8960,3,[eXtra1]TheFerretKin,3345,116,4,4,8,50.0%,21m
8960,3,IIIIllllIIlI,3345,30,2,0,2,100.0%,29m
8960,3,LillySatou,3345,30,1,2,3,33.3%,20m
8960,3,Bezbel,3345,30,1,3,4,25.0%,12m
8960,3,SteEZySteve,3345,0,0,1,1,0.0%,40m
8960,3,Reno,3345,0,0,1,1,0.0%,25m
8960,3,ThinkTank,3345,0,0,1,1,0.0%,21m
8960,3,EnTaroGeoff,3345,0,0,1,1,0.0%,12m
8977,3,Anna,3344,1343,232,204,436,53.2%,40m
8977,3,TuLobaSucia,3344,1338,199,177,376,52.9%,27m
8977,3,[VRBama]Hamato,3344,407,104,104,208,50.0%,9m
8977,3,EnergyDrank,3344,721,34,27,61,55.7%,7m
8977,3,PacoTaco,3344,830,32,34,66,48.5%,28m
8977,3,Protege,3344,508,22,13,35,62.9%,22m
8977,3,TerranPatch,3344,600,21,22,43,48.8%,16m
8977,3,Meatpuller,3344,326,12,7,19,63.2%,38m
8977,3,SaltyCore,3344,185,10,9,19,52.6%,17m
8977,3,TheFrantics,3344,154,5,11,16,31.2%,15m
8977,3,[PhxDyn]Xazuh,3344,90,3,8,11,27.3%,19m
8977,3,Player,3344,0,2,3,5,40.0%,13m
8977,2,Penguin,3344,0,1,1,2,50.0%,8m
8977,3,[TFEC]adept,3344,0,1,1,2,50.0%,13m
8977,3,marmParm,3344,0,0,1,1,0.0%,5m
8977,3,DEEPDIVEANUS,3344,0,0,3,3,0.0%,37m
8993,3,Temo,3343,1149,137,97,234,58.5%,25m
8993,3,JoJo,3343,1192,109,112,221,49.3%,34m
8993,3,Executor,3343,1561,77,79,156,49.4%,36m
8993,3,YiSuS,3343,830,59,48,107,55.1%,16m
8993,2,[STSP]booyachaka,3343,1120,39,45,84,46.4%,27m
8993,3,GoudaNuff,3343,586,19,28,47,40.4%,24m
8993,3,gapple,3343,181,15,24,39,38.5%,17m
8993,1,ZeromuS,3343,258,11,8,19,57.9%,4m
8993,3,Light,3343,170,6,6,12,50.0%,40m
8993,3,[SsaYnS]Schwinny,3343,174,6,7,13,46.2%,29m
8993,3,[Lp]Slayertoss,3343,88,4,4,8,50.0%,9m
8993,3,[Joseph]FatalNoogie,3343,86,3,4,7,42.9%,12m
8993,3,[LgnTDS]shivi,3343,30,2,1,3,66.7%,9m
8993,1,IIIIIIIIIIII,3343,48,2,1,3,66.7%,1h
8993,3,mythal,3343,0,1,0,1,100.0%,27m
8993,3,FreePizza,3343,0,1,0,1,100.0%,5m
8993,3,Shrike,3343,30,1,1,2,50.0%,30m
8993,3,SleepyBear,3343,97,1,1,2,50.0%,7m
8993,3,Cardumen,3343,0,0,1,1,0.0%,7m
9012,2,UncLeToBy,3342,1574,223,216,439,50.8%,19m
9012,3,wayhara,3342,1593,99,73,172,57.6%,21m
9012,3,Camembert,3342,826,61,23,84,72.6%,10m
9012,3,rizK,3342,1159,49,39,88,55.7%,15m
9012,2,[Macac0]EsKiaf,3342,815,48,52,100,48.0%,38m
9012,3,NEOGenesis,3342,1049,44,34,78,56.4%,27m
9012,3,alex,3342,613,37,26,63,58.7%,26m
9012,3,scaryPURPLE,3342,482,18,13,31,58.1%,17m
9012,3,Dares,3342,350,13,1,14,92.9%,25m
9012,3,Mazgaroth,3342,182,11,18,29,37.9%,17m
9012,2,[TeriS]rollinondubs,3342,198,10,12,22,45.5%,39m
9012,3,MindGrapes,3342,218,8,4,12,66.7%,32m
9012,3,Matix,3342,137,6,2,8,75.0%,29m
9012,3,[RumG]Vynillia,3342,144,6,6,12,50.0%,7m
9012,3,[BoAVN]PapaYaGa,3342,88,4,2,6,66.7%,3m
9012,3,[FUUD]nonissue,3342,30,2,0,2,100.0%,43m
9012,3,Naizhu,3342,30,1,1,2,50.0%,34m
9012,3,KYJealous,3342,30,1,2,3,33.3%,39m
9012,2,[ZLot]DirtMan,3342,88,1,5,6,16.7%,13m
9012,3,Hyunseok,3342,0,0,1,1,0.0%,22m
9032,3,Gsword,3341,1475,280,229,509,55.0%,13m
9032,3,DaFunkNade,3341,1397,229,222,451,50.8%,17m
9032,3,PinkiePie,3341,1000,80,32,112,71.4%,8m
9032,2,Caton,3341,1058,73,81,154,47.4%,13m
9032,3,Button,3341,1084,62,9,71,87.3%,7m
9032,3,dolosus,3341,954,47,37,84,56.0%,38m
9032,3,KaImix,3341,421,33,30,63,52.4%,25m
9032,3,Starscream,3341,625,24,26,50,48.0%,30m
9032,3,[TGosuA]Kyroh,3341,287,19,11,30,63.3%,37m
9032,3,[lXlXl]Crame,3341,520,18,27,45,40.0%,25m
9032,3,[iMx]Hero,3341,456,16,19,35,45.7%,40m
9032,3,LsSc,3341,180,7,6,13,53.8%,11m
9032,3,[IICWYD]Battlecroft,3341,201,6,3,9,66.7%,2m
9032,3,MiAstErDoOm,3341,62,3,4,7,42.9%,25m
9032,3,XANDER,3341,0,2,3,5,40.0%,13m
9032,3,IIIIIIIIIIII,3341,58,2,6,8,25.0%,29m
9032,3,PLPLlama,3341,0,1,0,1,100.0%,17m
9032,3,CrazyCat,3341,0,1,3,4,25.0%,13m
9032,3,[AlIin]panic,3341,0,0,3,3,0.0%,25m
9051,3,ZweiRu,3340,1495,155,150,305,50.8%,16m
9051,3,llllllllllll,3340,1602,121,69,190,63.7%,31m
9051,3,[ICL]Karthdaddy,3340,830,49,48,97,50.5%,5m
9051,3,[Flam3s]yenisimo,3340,529,25,20,45,55.6%,12m
9051,3,[Asar]SnoW,3340,505,23,8,31,74.2%,23m
9051,3,EvO,3340,364,13,11,24,54.2%,17m
9051,3,Leviatan,3340,114,5,0,5,100.0%,32m
9051,1,RadamanthiS,3340,0,1,0,1,100.0%,39m
9051,3,[Ikar0s]ExecutorFil,3340,0,1,0,1,100.0%,27m
9051,1,Brook,3340,0,0,4,4,0.0%,1h
9061,2,[JEUB]AmbitionsEnd,3339,1496,240,235,475,50.5%,12m
9061,3,Abstemius,3339,759,37,32,69,53.6%,41m
9061,3,Intermittent,3339,798,29,29,58,50.0%,37m
9061,3,[FyHr]CharlyCox,3339,718,27,24,51,52.9%,24m
9061,3,TwinkleToes,3339,584,25,14,39,64.1%,5m
9061,3,SmrtAsianGuy,3339,378,22,17,39,56.4%,37m
9061,3,[Khalta]Akrenar,3339,364,14,10,24,58.3%,5m
9061,3,Noobtastic,3339,112,9,9,18,50.0%,36m
9061,3,TAYLOW,3339,274,9,14,23,39.1%,9m
9061,3,ThyPower,3339,198,7,1,8,87.5%,41m
9061,3,KillerOB,3339,148,6,10,16,37.5%,30m
9061,3,MeomaikaFan,3339,30,5,1,6,83.3%,14m
9061,3,DeroW,3339,67,5,3,8,62.5%,17m
9061,2,[runnn]GenBuboniC,3339,139,3,3,6,50.0%,20m
9061,3,Ahihi,3339,30,2,0,2,100.0%,22m
9061,3,Insight,3339,58,2,1,3,66.7%,36m
9061,3,[XtNcN]gezza,3339,0,1,0,1,100.0%,7m
9078,2,Mknight,3338,1592,287,282,569,50.4%,37m
9078,2,destricslayr,3338,1455,285,296,581,49.1%,42m
9078,2,lostranger,3338,1228,202,194,396,51.0%,30m
9078,3,DrewShow,3338,1642,73,68,141,51.8%,11m
9078,1,gravitOn,3338,422,55,82,137,40.1%,26m
9078,3,[UTSEGG]Firia,3338,378,53,54,107,49.5%,15m
9078,2,[PTHero]Janpol,3338,1303,49,53,102,48.0%,4m
9078,3,YellowOrange,3338,530,46,24,70,65.7%,19m
9078,3,Xorn,3338,604,21,30,51,41.2%,39m
9078,3,Gurrpah,3338,524,19,20,39,48.7%,25m
9078,3,[0825]LisaCookie,3338,355,17,13,30,56.7%,11m
9078,3,[IMDSI]AlbertoOtaku,3338,263,12,3,15,80.0%,26m
9078,2,nONE,3338,336,12,22,34,35.3%,20m
9078,3,[Peeepz]rocky,3338,230,8,7,15,53.3%,24m
9078,3,[GLG]FiNiTE,3338,113,7,12,19,36.8%,4m
9078,3,RedStorm,3338,86,4,0,4,100.0%,29m
9078,3,Yoshi,3338,86,4,3,7,57.1%,3m
9078,3,dldkfma,3338,0,3,2,5,60.0%,10m
9078,3,[nfr]Santander,3338,30,2,0,2,100.0%,13m
9078,3,scumbag,3338,58,2,1,3,66.7%,34m
9078,3,[HUSHrx]Celestiall,3338,0,1,0,1,100.0%,25m
9078,3,BishopGainzz,3338,0,0,1,1,0.0%,29m
9100,3,madwill,3337,1547,392,384,776,50.5%,17m
9100,3,dante,3337,614,39,37,76,51.3%,35m
9100,3,[75]Khanti,3337,944,37,34,71,52.1%,11m
9100,3,uiucSkyGrand,3337,298,24,18,42,57.1%,21m
9100,3,Probefessor,3337,306,12,9,21,57.1%,21m
9100,3,FreshBrotato,3337,208,8,11,19,42.1%,16m
9100,1,SparkySparky,3337,166,7,2,9,77.8%,26m
9100,3,[dikboi]FruitStand,3337,132,7,4,11,63.6%,25m
9100,1,[KyIe]Gravitas,3337,119,2,1,3,66.7%,2h
9100,3,iiiiiiii,3337,60,2,9,11,18.2%,24m
9100,3,[ClanZN]YumKimil,3337,0,0,1,1,0.0%,18m
9111,3,UrineTrouble,3336,993,62,54,116,53.4%,8m
9111,3,SwigLee,3336,1524,62,62,124,50.0%,35m
9111,3,[cell5]KongShlong,3336,516,20,18,38,52.6%,20m
9111,2,Schmidty,3336,204,7,8,15,46.7%,9m
9111,1,HooLiganI,3336,0,3,2,5,60.0%,30m
9111,3,Plejaran,3336,15,3,5,8,37.5%,36m
9111,3,Squiggleyy,3336,30,2,2,4,50.0%,25m
9111,3,bolt,3336,58,2,2,4,50.0%,16m
9111,3,prttygrlrock,3336,60,2,6,8,25.0%,41m
9111,3,GoldLeaguer,3336,0,1,0,1,100.0%,7m
9111,3,[Xpk]JasonKillerX,3336,0,0,1,1,0.0%,43m
9122,2,Zymosis,3335,1539,361,337,698,51.7%,38m
9122,3,[ZTemp]VolkerBall,3335,1570,289,265,554,52.2%,40m
9122,3,ColdZero,3335,466,77,62,139,55.4%,40m
9122,3,[3ms]JACOBIS,3335,271,61,49,110,55.5%,9m
9122,3,CORN,3335,1325,58,41,99,58.6%,30m
9122,3,[GGxC]MoriOptans,3335,855,50,50,100,50.0%,2m
9122,3,MedicsUp,3335,894,34,29,63,54.0%,25m
9122,3,LVOwner,3335,288,22,12,34,64.7%,33m
9122,3,[QCPB]MasterCheese,3335,410,14,18,32,43.8%,39m
9122,3,[BIZCUT]Quarky,3335,330,13,11,24,54.2%,7m
9122,3,llllllllllll,3335,316,13,12,25,52.0%,35m
9122,3,ChadBroChill,3335,230,8,9,17,47.1%,26m
9122,3,[LQV]Starklok,3335,232,8,11,19,42.1%,23m
9122,3,[ScSwrm]Apoptosis,3335,141,6,8,14,42.9%,19m
9122,3,[ZTemp]GameofDrones,3335,86,3,4,7,42.9%,24m
9122,3,guyincognito,3335,30,2,0,2,100.0%,2m
9122,3,[HnY]Force,3335,0,1,0,1,100.0%,37m
9122,3,[iTHC]HiTeK,3335,96,1,3,4,25.0%,40m
9122,1,[RS69]DiRtYMeIsTeR,3335,0,1,3,4,25.0%,7m
9122,1,DatGuyGaming,3335,0,0,2,2,0.0%,29m
9122,3,[SC2IDN]tempefly,3335,0,0,2,2,0.0%,14m
9143,3,[MM5k]Beefcake,3334,271,55,50,105,52.4%,37m
9143,3,[LVerdá]ELITALIANO,3334,1178,51,38,89,57.3%,6m
9143,3,[TSMGG]MPsinXtan,3334,478,20,14,34,58.8%,16m
9143,3,snapcall,3334,301,13,9,22,59.1%,27m
9143,3,cam,3334,86,4,1,5,80.0%,36m
9143,3,Aimee,3334,86,4,2,6,66.7%,11m
9143,3,Matt,3334,64,2,10,12,16.7%,5m
9143,3,[KiMBR]Brucutu,3334,0,1,0,1,100.0%,37m
9143,3,FlickFiebeR,3334,0,1,0,1,100.0%,19m
9143,3,FullmetalZim,3334,0,0,1,1,0.0%,7m
9143,3,Nightmare,3334,0,0,1,1,0.0%,41m
9143,3,SCBoyIsRich,3334,0,0,1,1,0.0%,25m
9155,3,sankar,3333,1522,187,181,368,50.8%,39m
9155,3,ZackAttack,3333,846,135,118,253,53.4%,29m
9155,3,[DRKAPP]Phase,3333,1593,90,79,169,53.3%,5m
9155,3,Pygy,3333,1345,59,48,107,55.1%,41m
9155,3,[TUTTER]Cubra,3333,863,50,38,88,56.8%,36m
9155,3,[meobol]moriarty,3333,789,35,21,56,62.5%,30m
9155,3,samaitch,3333,474,30,23,53,56.6%,21m
9155,3,Rekzul,3333,301,19,18,37,51.4%,7m
9155,3,unorderedMap,3333,413,18,11,29,62.1%,19m
9155,3,NullVoid,3333,195,6,5,11,54.5%,5m
9155,3,FatKid,3333,170,6,6,12,50.0%,3m
9155,3,EvilOlive,3333,148,6,6,12,50.0%,26m
9155,3,[Igbt]FlyinHurtBus,3333,0,4,1,5,80.0%,14m
9155,3,[LowIQ]eSKo,3333,177,4,4,8,50.0%,34m
9155,3,KinguvcheeZL,3333,114,4,14,18,22.2%,24m
9155,2,[VTClan]Galaxy,3333,167,3,4,7,42.9%,8m
9155,3,[Fronds]DarkPRamza,3333,90,3,9,12,25.0%,18m
9155,3,Jujuba,3333,0,0,1,1,0.0%,35m
9155,2,[zzzzz]Zur,3333,0,0,3,3,0.0%,17m
9174,2,Atom,3332,1535,101,100,201,50.2%,38m
9174,3,[MadK]Kevin,3332,1241,62,46,108,57.4%,11m
9174,3,[TFOS]zOne,3332,758,27,31,58,46.6%,40m
9174,3,Ceejathin,3332,500,23,12,35,65.7%,12m
9174,3,[Sn50]evilhologram,3332,446,19,14,33,57.6%,9m
9174,3,Kerrigan,3332,361,18,10,28,64.3%,9m
9174,1,Montag,3332,311,13,8,21,61.9%,37m
9174,3,CatsThirdPaw,3332,121,6,2,8,75.0%,20m
9174,1,STAR,3332,97,5,1,6,83.3%,2h
9174,1,[QbcGld]MAD,3332,0,4,1,5,80.0%,12m
9174,3,clemi,3332,0,1,0,1,100.0%,26m
9174,3,IIIIIIIIIII,3332,0,1,0,1,100.0%,34m
9174,3,[OGbros]GypsyQueen,3332,0,1,0,1,100.0%,41m
9174,3,surreal,3332,30,1,1,2,50.0%,18m
9174,3,Acheron,3332,30,1,2,3,33.3%,19m
9174,3,[maj]GarmBrood,3332,0,1,5,6,16.7%,42m
9174,3,IIIIIIIIIIII,3332,0,0,1,1,0.0%,26m
9174,3,Mistaclean,3332,0,0,1,1,0.0%,11m
9174,3,Love,3332,0,0,1,1,0.0%,4m
9193,3,[TGCF]Yuki,3331,1553,163,140,303,53.8%,9m
9193,3,HARrassment,3331,1496,118,93,211,55.9%,25m
9193,3,Playmate,3331,1573,111,94,205,54.1%,14m
9193,3,echarlesss,3331,1356,51,49,100,51.0%,9m
9193,2,[SiCo]Malus,3331,1293,46,60,106,43.4%,20m
9193,3,Jeezy,3331,432,16,21,37,43.2%,43m
9193,3,[AntNob]destroyer,3331,386,15,20,35,42.9%,12m
9193,3,[BoAVN]HungChan,3331,310,11,11,22,50.0%,24m
9193,3,ArieS,3331,146,6,3,9,66.7%,7m
9193,1,Wicle,3331,233,6,7,13,46.2%,18m
9193,3,Grimoldi,3331,86,3,4,7,42.9%,35m
9193,3,[xTz]PedoG,3331,117,3,6,9,33.3%,31m
9193,3,[Kcnsky]Aerabula,3331,0,1,0,1,100.0%,5m
9193,3,djcg,3331,30,1,2,3,33.3%,41m
9193,3,[GGCG]Pernicious,3331,30,1,4,5,20.0%,7m
9193,3,[Ari]windOw,3331,30,1,5,6,16.7%,36m
9193,3,smokem,3331,30,1,5,6,16.7%,7m
9193,3,NomaD,3331,0,0,1,1,0.0%,27m
9193,1,mom,3331,0,0,4,4,0.0%,3h
9212,3,Solanin,3330,1488,333,300,633,52.6%,6m
9212,3,Sionicmatrix,3330,1261,233,205,438,53.2%,40m
9212,3,[DarkAG]Rapz,3330,1116,167,131,298,56.0%,30m
9212,3,FkingWankz,3330,884,50,33,83,60.2%,5m
9212,3,bobbywhisky,3330,992,43,47,90,47.8%,13m
9212,3,lbc,3330,889,38,22,60,63.3%,15m
9212,3,[Bc]jcpman,3330,685,33,33,66,50.0%,17m
9212,2,[KingSC]leon,3330,594,20,40,60,33.3%,25m
9212,3,Spirit,3330,375,17,11,28,60.7%,17m
9212,3,Hoovie,3330,256,11,3,14,78.6%,15m
9212,3,[FAYSN]LIARS,3330,314,11,14,25,44.0%,32m
9212,2,Twizzy,3330,189,8,6,14,57.1%,10m
9212,3,PROTOSS,3330,116,5,4,9,55.6%,17m
9212,3,Delusion,3330,112,4,1,5,80.0%,28m
9212,3,Chaos,3330,120,4,8,12,33.3%,40m
9212,3,[BSSG]TheFlippity,3330,85,3,4,7,42.9%,35m
9212,3,Crillin,3330,58,2,3,5,40.0%,33m
9212,3,SaintSnack,3330,0,2,3,5,40.0%,18m
9212,3,Shooa,3330,0,1,0,1,100.0%,27m
9212,1,[Kappa]Wormlips,3330,0,0,1,1,0.0%,30m
9212,3,[BNITOS]Adrianks,3330,0,0,1,1,0.0%,41m
9233,2,Benovak,3329,1503,228,248,476,47.9%,21m
9233,3,LucaBrasi,3329,675,28,18,46,60.9%,25m
9233,3,[SBlock]Omar,3329,684,28,22,50,56.0%,25m
9233,3,aBarcode,3329,680,26,21,47,55.3%,9m
9233,3,[ØÛ]SanDeR,3329,362,14,16,30,46.7%,36m
9233,3,KEN,3329,351,13,5,18,72.2%,7m
9233,3,llllllllllll,3329,290,13,7,20,65.0%,31m
9233,3,[GOPERÚ]pandafloo,3329,232,8,9,17,47.1%,3m
9233,3,[GOPERÚ]ShadowBoy,3329,185,7,1,8,87.5%,16m
9233,3,Sunstrider,3329,114,5,5,10,50.0%,8m
9233,3,Sonic,3329,120,4,11,15,26.7%,43m
9233,1,Person,3329,140,3,1,4,75.0%,21m
9233,3,[FFAA]DARKSLAYER,3329,0,1,0,1,100.0%,30m
9233,3,[TOR0]Arkutunus,3329,0,1,0,1,100.0%,7m
9233,1,Patate,3329,0,1,2,3,33.3%,2m
9233,3,HomerSimpson,3329,30,1,4,5,20.0%,23m
9249,3,Mapaf,3328,1605,153,122,275,55.6%,17m
9249,3,[ZDE20]MoonLight,3328,1596,88,59,147,59.9%,14m
9249,3,[0PGC0]Betho,3328,1229,77,74,151,51.0%,31m
9249,3,Dayvon,3328,660,26,20,46,56.5%,35m
9249,3,esarj,3328,295,23,11,34,67.6%,20m
9249,3,Predator,3328,493,22,18,40,55.0%,28m
9249,3,Annnnqi,3328,532,19,22,41,46.3%,20m
9249,3,[TGCrew]FoxCatcher,3328,276,10,8,18,55.6%,19m
9249,3,[1A2A]Hyouka,3328,191,7,3,10,70.0%,7m
9249,3,ipv,3328,118,4,3,7,57.1%,19m
9249,3,WoodBridge,3328,127,3,2,5,60.0%,4m
9249,3,hero,3328,30,2,1,3,66.7%,4m
9249,3,WellFedSyco,3328,0,1,0,1,100.0%,6m
9249,3,[ACSS]Lanthus,3328,0,1,0,1,100.0%,22m
9249,3,[IMDSI]RAMEN,3328,0,1,0,1,100.0%,40m
9249,3,TER,3328,0,1,0,1,100.0%,7m
9249,3,[SlipZ]ALBAMAGUSH,3328,30,1,2,3,33.3%,25m
9249,3,FirstBlood,3328,30,1,2,3,33.3%,5m
9249,3,Pragmatist,3328,30,1,5,6,16.7%,32m
9268,3,[xRS]Punisher,3327,1580,127,115,242,52.5%,6m
9268,3,Gengis,3327,731,30,18,48,62.5%,4m
9268,3,tellahsg,3327,303,23,24,47,48.9%,31m
9268,3,FFforGG,3327,324,10,9,19,52.6%,9m
9268,3,BluShifT,3327,240,9,4,13,69.2%,33m
9268,3,IIIIIIIIII,3327,113,9,16,25,36.0%,36m
9268,3,[QTp2T]GGAllin,3327,200,8,10,18,44.4%,5m
9268,3,[HORSE]Pariah,3327,150,6,8,14,42.9%,26m
9268,3,IlIlIlIlIlIl,3327,184,5,2,7,71.4%,29m
9268,3,[GGSC2]FREY,3327,30,2,1,3,66.7%,34m
9268,2,saMe,3327,0,2,1,3,66.7%,23m
9268,3,Piglet,3327,30,2,3,5,40.0%,6m
9268,3,Hizzay,3327,30,1,1,2,50.0%,3m
9268,3,Markiavelo,3327,0,1,2,3,33.3%,13m
9268,3,[TERROS]fraternity,3327,0,1,5,6,16.7%,37m
9268,1,[INextI]MachinClaun,3327,48,1,9,10,10.0%,14m
9268,3,ProbeRush,3327,0,0,1,1,0.0%,19m
9285,2,[opDNS]Krassel,3326,1489,257,253,510,50.4%,37m
9285,3,Tethgret,3326,1002,104,89,193,53.9%,40m
9285,3,fnord,3326,1205,47,47,94,50.0%,6m
9285,3,MauRuS,3326,884,37,34,71,52.1%,24m
9285,3,[AbcCo]JävlyatNej,3326,350,25,21,46,54.3%,19m
9285,3,[CRAKS]NightWolf,3326,260,13,11,24,54.2%,11m
9285,2,Arxya,3326,209,11,4,15,73.3%,24m
9285,3,HaveFun,3326,204,8,8,16,50.0%,37m
9285,3,PinkFrog,3326,71,4,6,10,40.0%,3m
9285,3,[Macac0]HeartAttack,3326,0,3,3,6,50.0%,4m
9285,3,Redbaron,3326,30,2,0,2,100.0%,25m
9285,1,hyulch,3326,0,0,1,1,0.0%,2h
9285,3,[TRTLSQ]VIRIDEUS,3326,0,0,2,2,0.0%,18m
9298,3,RSC,3325,1565,362,308,670,54.0%,26m
9298,2,Tentative,3325,1526,95,84,179,53.1%,14m
9298,3,[AKRG]Avatar,3325,1512,71,71,142,50.0%,8m
9298,3,DuckY,3325,204,17,8,25,68.0%,25m
9298,3,Crank,3325,391,13,13,26,50.0%,25m
9298,3,PlinPlinPlon,3325,218,11,8,19,57.9%,23m
9298,3,Rabbit,3325,220,8,9,17,47.1%,6m
9298,3,[lHMNGl]SCmenace,3325,176,6,7,13,46.2%,26m
9298,3,ThatOneDude,3325,30,5,1,6,83.3%,41m
9298,3,Riffdoctor,3325,30,5,1,6,83.3%,15m
9298,3,shockleeX,3325,114,4,5,9,44.4%,30m
9298,3,[ZWars]Tta,3325,124,4,14,18,22.2%,15m
9298,2,Hulk,3325,0,1,3,4,25.0%,26m
9298,3,[HVK]HaVoKAndre,3325,0,0,1,1,0.0%,3m
9298,3,Karizma,3325,0,0,1,1,0.0%,11m
9298,2,MooseInHeat,3325,0,0,1,1,0.0%,3m
9314,3,Huckey,3324,510,61,57,118,51.7%,6m
9314,3,[Ne0x1]AARON,3324,725,38,21,59,64.4%,25m
9314,3,JOJO,3324,175,29,26,55,52.7%,11m
9314,3,[Monado]Mechonis,3324,477,19,10,29,65.5%,24m
9314,3,[GEEKED]CoronaMarine,3324,410,15,13,28,53.6%,17m
9314,3,tgLthpLsrIV,3324,426,14,19,33,42.4%,25m
9314,1,Tilting,3324,258,12,7,19,63.2%,9m
9314,3,sparkster,3324,229,8,6,14,57.1%,16m
9314,3,EchoForever,3324,170,6,7,13,46.2%,20m
9314,3,[Goguma]Goguma,3324,0,4,1,5,80.0%,14m
9314,3,NotOffensive,3324,118,4,10,14,28.6%,14m
9314,3,singlemom,3324,120,3,2,5,60.0%,41m
9314,3,Chamillitary,3324,86,3,3,6,50.0%,26m
9314,3,[PD2D]Killakure,3324,90,3,4,7,42.9%,20m
9314,3,InnerOrbiter,3324,0,1,1,2,50.0%,22m
9314,3,[GOPERÚ]RampagePks,3324,30,1,3,4,25.0%,28m
9314,3,vodkalemin,3324,0,0,2,2,0.0%,9m
9331,3,Shaepe,3323,1643,297,252,549,54.1%,2m
9331,3,[Jam]Spooky,3323,1616,257,249,506,50.8%,36m
9331,3,[SmokeH]HtUnity,3323,1350,177,168,345,51.3%,30m
9331,2,PremierBush,3323,1219,90,98,188,47.9%,42m
9331,3,[GOPERÚ]cristian,3323,383,68,69,137,49.6%,21m
9331,2,Prontier,3323,1158,56,69,125,44.8%,39m
9331,3,[TGosuB]PureVoltage,3323,926,49,48,97,50.5%,8m
9331,3,Acetate,3323,653,27,23,50,54.0%,4m
9331,2,[YAS]Knowledge,3323,284,9,16,25,36.0%,34m
9331,3,[REALG4]Anderson,3323,190,7,4,11,63.6%,13m
9331,3,Ulrezaj,3323,201,7,11,18,38.9%,10m
9331,3,Penicide,3323,0,1,0,1,100.0%,30m
9343,2,GBA,3322,1441,368,364,732,50.3%,19m
9343,3,IntelSoap,3322,1543,302,284,586,51.5%,20m
9343,3,BubbleMagic,3322,1550,110,112,222,49.5%,40m
9343,3,[YD2K]GBFK,3322,815,58,51,109,53.2%,39m
9343,3,[kvac]Kremer,3322,1522,55,57,112,49.1%,19m
9343,3,Zerg,3322,308,15,8,23,65.2%,17m
9343,3,[RwtM]TheReaper,3322,226,9,4,13,69.2%,37m
9343,3,glide,3322,166,7,3,10,70.0%,6m
9343,3,Thetarbolof,3322,96,5,7,12,41.7%,24m
9343,3,Indigos,3322,0,4,1,5,80.0%,20m
9343,3,Mogruu,3322,54,2,1,3,66.7%,37m
9354,3,[Pig2]Ambrose,3321,782,218,204,422,51.7%,39m
9354,3,Nivektis,3321,1219,129,116,245,52.7%,30m
9354,3,itsanap,3321,486,21,17,38,55.3%,3m
9354,3,PooCreator,3321,394,16,7,23,69.6%,15m
9354,3,llllllllllll,3321,152,6,7,13,46.2%,35m
9354,3,[SIClan]Apothecary,3321,60,3,1,4,75.0%,12m
9354,3,aker,3321,76,3,2,5,60.0%,37m
9354,3,[UTK]Kevin,3321,40,2,3,5,40.0%,25m
9354,3,Truco,3321,30,2,9,11,18.2%,26m
9354,3,Stroganoff,3321,0,1,0,1,100.0%,22m
9354,3,Synrgy,3321,30,1,1,2,50.0%,25m
9354,3,ozge,3321,0,0,1,1,0.0%,25m
9354,3,[KingSC]TheSayan,3321,0,0,2,2,0.0%,3m
9367,3,Fracture,3320,1593,209,182,391,53.5%,23m
9367,3,oasis,3320,1459,167,149,316,52.8%,17m
9367,2,rockhead,3320,1548,135,124,259,52.1%,20m
9367,3,SnowOwl,3320,863,100,100,200,50.0%,2m
9367,3,Dking,3320,1576,78,57,135,57.8%,22m
9367,3,[HKA]Gwak,3320,798,44,26,70,62.9%,30m
9367,3,Push,3320,636,24,23,47,51.1%,11m
9367,3,Arki,3320,559,20,28,48,41.7%,32m
9367,3,Claw,3320,382,14,8,22,63.6%,26m
9367,3,tgfdp,3320,0,5,1,6,83.3%,17m
9367,3,Mossy,3320,116,5,6,11,45.5%,41m
9367,3,[NPhasA]Antares,3320,148,5,6,11,45.5%,19m
9367,3,eXit,3320,141,4,1,5,80.0%,29m
9367,1,Rokman,3320,97,3,2,5,60.0%,13m
9367,3,[Mago]Mago,3320,0,0,2,2,0.0%,14m
9367,3,kadoeo,3320,0,0,3,3,0.0%,25m
9383,2,[P00P2]RocketMan,3319,982,88,91,179,49.2%,39m
9383,2,LazyElm,3319,635,28,27,55,50.9%,2m
9383,3,thiouk,3319,587,25,9,34,73.5%,20m
9383,3,Atos,3319,434,19,11,30,63.3%,41m
9383,3,Mijob,3319,384,18,12,30,60.0%,18m
9383,3,Noodlelisk,3319,454,18,19,37,48.6%,18m
9383,3,[SeemN]Spooge,3319,452,17,14,31,54.8%,6m
9383,2,[MSFT]LightBrigade,3319,234,9,14,23,39.1%,39m
9383,3,AiurLife,3319,217,7,12,19,36.8%,25m
9383,3,DarkWolfdog,3319,140,6,1,7,85.7%,10m
9383,3,chrome,3319,188,6,11,17,35.3%,5m
9383,2,Vuvuzela,3319,0,2,3,5,40.0%,2h
9383,3,ReFuGee,3319,0,1,0,1,100.0%,36m
9396,3,[cluez]Neeb,3318,1550,591,580,1171,50.5%,30m
9396,3,GoodBacteria,3318,1591,256,237,493,51.9%,30m
9396,3,Pepe,3318,1716,245,236,481,50.9%,2m
9396,2,Blake,3318,1524,243,238,481,50.5%,6m
9396,3,Clairvoyant,3318,587,42,31,73,57.5%,2m
9396,3,[TWS]Toto,3318,1074,41,41,82,50.0%,30m
9396,2,AluPIgus,3318,728,31,34,65,47.7%,9m
9396,2,BigFungus,3318,726,31,34,65,47.7%,13m
9396,3,JupJup,3318,668,27,23,50,54.0%,28m
9396,3,Leafstep,3318,327,19,7,26,73.1%,17m
9396,2,beh,3318,211,9,6,15,60.0%,12m
9396,3,[QuAzar]Tibearius,3318,116,5,2,7,71.4%,14m
9396,3,LordZealot,3318,46,2,1,3,66.7%,22m
9396,3,RoachWarden,3318,0,1,4,5,20.0%,16m
9396,3,[SyLx]Sam,3318,0,0,1,1,0.0%,29m
9396,3,TrutleMagic,3318,0,0,1,1,0.0%,19m
9396,3,[KANGS]TalkShlt,3318,0,0,2,2,0.0%,8m
9413,2,fridor,3317,1346,117,127,244,48.0%,37m
9413,3,dSchneider,3317,1459,66,59,125,52.8%,39m
9413,3,jirlnb,3317,558,26,21,47,55.3%,15m
9413,3,Vyrn,3317,200,21,22,43,48.8%,20m
9413,3,therialumon,3317,223,10,4,14,71.4%,18m
9413,3,loit,3317,200,8,6,14,57.1%,38m
9413,3,Sinnamain,3317,156,6,3,9,66.7%,20m
9413,3,EloZero,3317,0,4,1,5,80.0%,10m
9413,3,Bushwack,3317,30,1,2,3,33.3%,20m
9413,3,[DLe]BigPimpin,3317,0,0,1,1,0.0%,3m
9413,3,[Gilga]Sloop,3317,0,0,1,1,0.0%,25m
9413,3,[lula]lulaleil,3317,0,0,1,1,0.0%,29m
9413,3,ZynKy,3317,0,0,1,1,0.0%,21m
9413,3,[LGNxx]SauceX,3317,0,0,5,5,0.0%,36m
9427,3,Juice,3316,1626,315,284,599,52.6%,2m
9427,3,slider,3316,1023,199,195,394,50.5%,12m
9427,3,[m4hire]BeetrootBro,3316,983,46,43,89,51.7%,37m
9427,3,[GoBrrr]Shockwave,3316,722,31,19,50,62.0%,25m
9427,3,skilet,3316,658,22,30,52,42.3%,17m
9427,3,James,3316,483,18,11,29,62.1%,20m
9427,3,[YOUMB]greazybaby,3316,482,17,23,40,42.5%,18m
9427,2,[Turdz]Jibs,3316,250,11,5,16,68.8%,22m
9427,1,Aenima,3316,96,5,1,6,83.3%,2h
9427,3,Goky,3316,166,5,4,9,55.6%,14m
9427,3,Pootisman,3316,0,1,2,3,33.3%,29m
9427,3,[ScrBnG]SCArium,3316,30,1,5,6,16.7%,28m
9427,3,Shivyk,3316,0,0,1,1,0.0%,25m
9440,3,EDWARSACE,3315,1582,110,106,216,50.9%,19m
9440,3,Jolt,3315,1549,69,67,136,50.7%,38m
9440,3,lIIIllllllll,3315,600,30,17,47,63.8%,14m
9440,3,IronCore,3315,272,11,9,20,55.0%,10m
9440,3,[PELO]Iceman,3315,217,11,9,20,55.0%,8m
9440,3,Soulseptem,3315,214,10,2,12,83.3%,24m
9440,3,[Sky]KsH,3315,111,6,4,10,60.0%,7m
9440,3,[PNDub]Greg,3315,118,4,5,9,44.4%,25m
9440,3,MedioToss,3315,60,3,4,7,42.9%,40m
9440,3,Ikepono,3315,58,2,3,5,40.0%,25m
9440,3,matheius,3315,0,1,0,1,100.0%,26m
9440,1,Omnivore,3315,48,1,2,3,33.3%,2h
9440,3,Leonidas,3315,30,1,3,4,25.0%,6m
9440,3,[nieBla]Alexander,3315,30,1,8,9,11.1%,31m
9440,3,yolkyasian,3315,0,0,3,3,0.0%,39m
9455,3,Crimson,3314,1663,103,89,192,53.6%,23m
9455,3,Aiur,3314,1561,97,93,190,51.1%,43m
9455,3,Wolverine,3314,573,59,37,96,61.5%,29m
9455,3,Momin,3314,793,36,16,52,69.2%,25m
9455,3,[Xpk]marinero,3314,716,30,22,52,57.7%,22m
9455,3,Name,3314,639,29,23,52,55.8%,36m
9455,3,[Meseek]Joker,3314,506,22,16,38,57.9%,15m
9455,3,Azamantes,3314,410,21,2,23,91.3%,40m
9455,3,klrlll,3314,213,10,2,12,83.3%,43m
9455,3,[Crew]RallosZek,3314,242,9,11,20,45.0%,24m
9455,2,mineeater,3314,193,9,11,20,45.0%,2m
9455,3,junhur,3314,246,9,14,23,39.1%,16m
9455,3,Tommy,3314,58,3,0,3,100.0%,43m
9455,3,[sa1t]BigPlumbus,3314,58,2,2,4,50.0%,40m
9455,3,[TpIn]Bot,3314,0,1,0,1,100.0%,16m
9470,3,MIGKTYPS,3313,1516,192,191,383,50.1%,8m
9470,3,BigPapaKrap,3313,494,118,103,221,53.4%,21m
9470,3,[Khalta]ARCANGEL,3313,1635,114,112,226,50.4%,40m
9470,2,eightbit,3313,306,113,113,226,50.0%,33m
9470,3,[NutLow]TheMadBomber,3313,271,25,33,58,43.1%,6m
9470,3,Chaos,3313,536,19,21,40,47.5%,25m
9470,3,[SANGRE]hijodeodin,3313,318,12,5,17,70.6%,42m
9470,3,iNSTINCT,3313,248,8,15,23,34.8%,3m
9470,3,[AbcCo]slenderman,3313,202,7,9,16,43.8%,6m
9470,3,[CRAKS]defiler,3313,153,6,4,10,60.0%,24m
9470,3,Oscar,3313,122,4,6,10,40.0%,4m
9470,3,[143s4]Kaizen,3313,142,3,1,4,75.0%,28m
9470,3,DarkTemplar,3313,58,2,1,3,66.7%,20m
9470,3,[GR33D]SilentFight,3313,0,1,0,1,100.0%,10m
9470,3,IGARASHI,3313,0,1,0,1,100.0%,13m
9470,3,[ShoaL]Red,3313,0,1,4,5,20.0%,41m
9470,3,[HOV]vivialdi,3313,0,0,4,4,0.0%,18m
9487,2,Ivan,3312,1491,392,394,786,49.9%,8m
9487,3,Bryce,3312,1620,158,166,324,48.8%,2m
9487,3,[oJKo]Vittorio,3312,1551,86,76,162,53.1%,32m
9487,2,Caul,3312,1393,84,87,171,49.1%,6m
9487,3,jblxx,3312,1047,83,78,161,51.6%,19m
9487,2,[cl0udM]JDSXqqq,3312,1154,74,79,153,48.4%,26m
9487,3,[CPRx]LifeLine,3312,899,58,53,111,52.3%,36m
9487,3,[BOTA]Move,3312,819,39,30,69,56.5%,9m
9487,3,HiiiPower,3312,665,29,21,50,58.0%,26m
9487,3,wepoopnloopn,3312,740,25,30,55,45.5%,36m
9487,3,SirNemo,3312,656,24,26,50,48.0%,14m
9487,3,ThePunisher,3312,453,22,2,24,91.7%,41m
9487,3,Barcode,3312,438,18,11,29,62.1%,42m
9487,3,Jeff,3312,455,18,15,33,54.5%,29m
9487,3,Wodan,3312,378,16,9,25,64.0%,41m
9487,3,fireegg,3312,250,13,10,23,56.5%,11m
9487,3,Barcode,3312,304,12,9,21,57.1%,7m
9487,3,[SkEE]CyN,3312,222,7,10,17,41.2%,40m
9487,3,Toombs,3312,214,7,16,23,30.4%,11m
9487,3,Donatello,3312,0,5,2,7,71.4%,4m
9487,3,[sMi]Coramoor,3312,90,4,4,8,50.0%,36m
9487,3,Octopus,3312,96,4,7,11,36.4%,3m
9487,3,llllllllllll,3312,0,3,2,5,60.0%,31m
9487,3,qnzp,3312,30,3,4,7,42.9%,17m
9487,3,RonDamon,3312,30,2,2,4,50.0%,36m
9487,3,Praetor,3312,0,0,1,1,0.0%,24m
9487,3,Job,3312,0,0,2,2,0.0%,17m
9514,3,SUPERTIM,3311,1617,71,57,128,55.5%,7m
9514,3,Dino,3311,1568,71,71,142,50.0%,20m
9514,3,Ynot,3311,1126,63,65,128,49.2%,17m
9514,3,Brachydios,3311,575,34,34,68,50.0%,5m
9514,3,Gozu,3311,322,25,16,41,61.0%,25m
9514,3,NsSentry,3311,165,7,3,10,70.0%,35m
9514,3,GentleMessia,3311,140,5,4,9,55.6%,41m
9514,3,LiquidGrass,3311,165,4,2,6,66.7%,2m
9514,3,RedSteel,3311,119,4,3,7,57.1%,15m
9514,3,PeterPiper,3311,60,3,4,7,42.9%,6m
9514,3,Sifu,3311,30,2,0,2,100.0%,20m
9514,3,[αB]theepotatolo,3311,30,2,0,2,100.0%,32m
9514,3,SodaGrackers,3311,0,2,4,6,33.3%,7m
9514,3,[Th3Bad]oathiago,3311,0,1,0,1,100.0%,17m
9514,3,[Hsiao]TheSmallOne,3311,0,1,0,1,100.0%,29m
9514,3,thotleader,3311,0,1,2,3,33.3%,3m
9514,3,Mocorongo,3311,30,1,4,5,20.0%,40m
9514,3,Herman,3311,0,0,1,1,0.0%,3m
9514,3,CaptBigBoss,3311,0,0,2,2,0.0%,10m
9514,3,PLOM,3311,0,0,2,2,0.0%,2m
9514,3,iVersePros,3311,0,0,2,2,0.0%,20m
9535,3,[UpxV]sumel,3310,1561,189,172,361,52.4%,31m
9535,3,Satsuri,3310,1337,175,171,346,50.6%,25m
9535,2,Hemloch,3310,449,146,129,275,53.1%,21m
9535,3,spaik,3310,1294,52,45,97,53.6%,40m
9535,3,spydamayn,3310,810,35,39,74,47.3%,8m
9535,3,[TLAN]SuperZorg,3310,632,25,20,45,55.6%,3m
9535,3,[WarCom]Yarev,3310,256,14,13,27,51.9%,13m
9535,3,rookywu,3310,218,9,4,13,69.2%,23m
9535,3,Raider,3310,174,6,14,20,30.0%,5m
9535,3,IIIIIIIIIIII,3310,30,5,2,7,71.4%,14m
9535,3,[TPGGXD]ELRICK,3310,138,5,8,13,38.5%,25m
9535,3,Dambi,3310,0,3,2,5,60.0%,16m
9535,3,[Jointz]Matt,3310,58,2,2,4,50.0%,26m
9535,1,IIIIIIIII,3310,0,1,0,1,100.0%,18m
9535,3,TheStiggi,3310,0,0,1,1,0.0%,8m
9550,3,[UpxV]Shinobu,3309,1263,82,29,111,73.9%,5m
9550,3,Peteski,3309,1026,42,32,74,56.8%,19m
9550,3,[LPG2]GABRIELPEREZ,3309,735,35,20,55,63.6%,20m
9550,2,Gouda,3309,465,21,19,40,52.5%,32m
9550,3,boom,3309,281,18,13,31,58.1%,31m
9550,3,newbyjourney,3309,343,17,9,26,65.4%,16m
9550,1,StefanLöfven,3309,218,7,3,10,70.0%,17m
9550,3,NBK,3309,145,7,3,10,70.0%,12m
9550,3,Zyklon,3309,88,3,5,8,37.5%,12m
9550,3,marco,3309,30,2,1,3,66.7%,37m
9550,3,[BoAVN]AsuraSC,3309,60,2,5,7,28.6%,36m
9550,3,[DASUL]Mach,3309,0,1,0,1,100.0%,24m
9550,1,Locke,3309,48,1,2,3,33.3%,15m
9550,3,PubScrub,3309,0,0,2,2,0.0%,22m
9564,3,[IiUiI]MAXPOWER,3308,1521,68,72,140,48.6%,35m
9564,3,Taka,3308,1555,65,66,131,49.6%,7m
9564,3,Rook,3308,512,35,32,67,52.2%,17m
9564,3,kisipisi,3308,399,18,7,25,72.0%,29m
9564,3,Baxtor,3308,418,15,12,27,55.6%,24m
9564,3,[YF25]CocoChanel,3308,238,8,13,21,38.1%,6m
9564,3,ChurchGoer,3308,114,5,0,5,100.0%,23m
9564,3,Theory,3308,120,5,8,13,38.5%,20m
9564,3,[SCTRRA]cerebrate,3308,97,4,4,8,50.0%,37m
9564,3,MyTeammteNub,3308,120,4,11,15,26.7%,2m
9564,3,qjjj,3308,58,3,1,4,75.0%,29m
9564,3,MarcosR,3308,58,2,4,6,33.3%,17m
9564,1,MontyBurns,3308,0,2,4,6,33.3%,37m
9564,3,[GiDx]KimCheese,3308,0,1,0,1,100.0%,38m
9564,3,[QTclub]Vision,3308,0,1,1,2,50.0%,30m
9564,3,[iMkS]TSyBoOT,3308,0,1,2,3,33.3%,24m
9564,3,drstampy,3308,0,1,3,4,25.0%,7m
9564,1,keitron,3308,0,0,1,1,0.0%,16m
9564,3,Pieroles,3308,0,0,1,1,0.0%,8m
9564,3,Elkahest,3308,0,0,2,2,0.0%,19m
9564,3,CKPE,3308,0,0,4,4,0.0%,6m
9564,3,Professor,3308,0,0,4,4,0.0%,35m
9586,2,[FANXY]ShinySalt,3307,1498,110,123,233,47.2%,42m
9586,3,Pacific,3307,1020,91,92,183,49.7%,12m
9586,3,[LGNxx]Darigaz,3307,1265,74,78,152,48.7%,3m
9586,3,PabloSanchez,3307,1339,53,52,105,50.5%,6m
9586,3,Damagekill,3307,1163,45,43,88,51.1%,8m
9586,3,[TxT]Cynich,3307,495,37,29,66,56.1%,17m
9586,3,Dawserg,3307,504,35,31,66,53.0%,32m
9586,1,[Atone]Eboelachan,3307,1048,34,61,95,35.8%,2m
9586,3,krazie,3307,592,23,18,41,56.1%,5m
9586,2,Mukram,3307,470,16,28,44,36.4%,26m
9586,3,spatiager,3307,170,7,3,10,70.0%,2m
9586,3,[EThugz]Andotron,3307,186,7,10,17,41.2%,31m
9586,3,PamPam,3307,196,6,5,11,54.5%,24m
9586,3,[EZkill]xxReBroxx,3307,170,6,8,14,42.9%,26m
9586,3,syrianthunda,3307,116,4,5,9,44.4%,3m
9586,1,[EpicG]elAdmin,3307,97,2,0,2,100.0%,15m
9586,3,upyours,3307,58,2,2,4,50.0%,40m
9586,3,[NM8]Matt,3307,58,2,3,5,40.0%,5m
9586,3,dexter,3307,30,2,3,5,40.0%,39m
9586,3,[ISCF]Bozi,3307,30,2,7,9,22.2%,29m
9586,3,Run,3307,0,0,1,1,0.0%,16m
9586,3,[GOPERÚ]KanMachine,3307,0,0,1,1,0.0%,4m
9608,3,PandaExpress,3306,1222,89,59,148,60.1%,23m
9608,3,[TGosuA]Dezzy,3306,1195,61,52,113,54.0%,12m
9608,1,[TUNAME]darkchild,3306,980,56,91,147,38.1%,38m
9608,3,IIIIIIIIIIII,3306,240,37,32,69,53.6%,41m
9608,3,llllllllllll,3306,711,31,37,68,45.6%,37m
9608,3,ChickFilA,3306,458,20,4,24,83.3%,11m
9608,3,tblack,3306,478,18,12,30,60.0%,16m
9608,3,[Sune]Karfados,3306,408,15,16,31,48.4%,10m
9608,3,ASTONESTHROW,3306,328,12,16,28,42.9%,3m
9608,3,Varys,3306,176,9,6,15,60.0%,15m
9608,3,lucifer,3306,58,2,3,5,40.0%,17m
9608,3,Player,3306,0,2,5,7,28.6%,39m
9608,3,rhubarb,3306,0,1,0,1,100.0%,43m
9608,1,Reprobate,3306,0,1,0,1,100.0%,2h
9608,3,TonyStark,3306,0,1,0,1,100.0%,21m
9608,1,IMBAstarsea,3306,0,0,2,2,0.0%,2h
9624,3,ZumaBird,3305,1577,180,163,343,52.5%,7m
9624,3,[SiG7]Chiffins,3305,740,92,70,162,56.8%,40m
9624,3,Spartan,3305,378,17,8,25,68.0%,3m
9624,3,Groobz,3305,256,10,10,20,50.0%,26m
9624,3,Nicaruga,3305,206,7,10,17,41.2%,17m
9624,3,Wind,3305,140,5,6,11,45.5%,17m
9624,3,DDAY,3305,94,3,12,15,20.0%,28m
9624,3,ELYAY,3305,30,1,1,2,50.0%,12m
9624,3,BigChamp,3305,0,1,2,3,33.3%,5m
9624,3,Rapage,3305,30,1,3,4,25.0%,9m
9624,3,FoRtHeSwArM,3305,0,0,3,3,0.0%,43m
9635,3,Cleaner,3304,1714,219,192,411,53.3%,43m
9635,2,kris,3304,1271,211,203,414,51.0%,22m
9635,3,[SULFER]steventoast,3304,1156,89,71,160,55.6%,23m
9635,3,joker,3304,599,81,75,156,51.9%,17m
9635,2,[UpxV]Raydesu,3304,1379,73,80,153,47.7%,30m
9635,3,UrineTrouble,3304,794,72,71,143,50.3%,12m
9635,3,Gladiator,3304,1381,61,55,116,52.6%,41m
9635,3,Nizahe,3304,617,50,53,103,48.5%,40m
9635,3,[hTx]Kit,3304,968,37,36,73,50.7%,6m
9635,3,[LgnTDS]Mold,3304,656,25,26,51,49.0%,43m
9635,3,[EBAGmn]theswarm,3304,355,20,3,23,87.0%,26m
9635,3,Dards,3304,314,13,12,25,52.0%,27m
9635,2,[CBAS2]GiantReaver,3304,242,10,17,27,37.0%,6m
9635,3,CupidStunt,3304,204,8,6,14,57.1%,41m
9635,3,dmorill,3304,155,5,13,18,27.8%,8m
9635,3,[EoMX]Korax,3304,30,1,7,8,12.5%,19m
9635,3,[UpeV]KaelThas,3304,0,0,1,1,0.0%,20m
9652,3,[i86]PHoBeToR,3303,1325,223,204,427,52.2%,17m
9652,3,Alzales,3303,1538,207,209,416,49.8%,7m
9652,3,[CBAS]MGDaGuill,3303,279,20,13,33,60.6%,9m
9652,3,kiukia,3303,306,12,11,23,52.2%,35m
9652,3,[m8z]ladygaga,3303,254,9,7,16,56.2%,41m
9652,2,HeLioS,3303,158,8,2,10,80.0%,20m
9652,3,[ELTEMW]Nyquist,3303,220,8,9,17,47.1%,19m
9652,3,Eddie,3303,85,5,2,7,71.4%,17m
9652,3,eric,3303,148,5,7,12,41.7%,6m
9652,2,[AbcCo]Frost,3303,162,4,4,8,50.0%,8m
9652,3,RageQuitPliz,3303,169,4,7,11,36.4%,17m
9652,3,[CDAL]Tucano,3303,0,1,0,1,100.0%,18m
9652,1,DontRunNow,3303,0,1,0,1,100.0%,3h
9652,3,Heart,3303,0,0,1,1,0.0%,35m
9652,3,Myk,3303,0,0,2,2,0.0%,29m
9667,3,[nieBla]ZoneZero,3302,1621,123,121,244,50.4%,25m
9667,3,iAM,3302,266,106,94,200,53.0%,35m
9667,3,TheBlitz,3302,614,44,39,83,53.0%,21m
9667,3,Alyeva,3302,868,35,30,65,53.8%,27m
9667,3,Eitchen,3302,378,19,14,33,57.6%,17m
9667,3,[ConFed]drgreenthumb,3302,303,16,23,39,41.0%,28m
9667,3,SuperSpreadr,3302,222,9,4,13,69.2%,12m
9667,3,[TOCUBA]Maximus,3302,192,8,4,12,66.7%,39m
9667,3,Raphtalia,3302,135,6,8,14,42.9%,30m
9667,2,VolkoIvan,3302,0,4,1,5,80.0%,9m
9667,3,[GAMBOL]HkTossIsBoss,3302,86,4,2,6,66.7%,35m
9667,3,Cty,3302,30,2,0,2,100.0%,17m
9667,1,Easydoesit,3302,145,2,7,9,22.2%,1h
9667,3,[TrumpN]ClydeFrog,3302,0,1,2,3,33.3%,11m
9667,3,[EnTrpY]Suicideking,3302,0,1,4,5,20.0%,5m
9667,3,[ANFA]Super,3302,0,0,1,1,0.0%,24m
9667,3,Mrizzo,3302,0,0,1,1,0.0%,23m
9684,2,[DORF]Yeomen,3301,647,92,95,187,49.2%,36m
9684,3,Willkillls,3301,846,34,28,62,54.8%,4m
9684,2,Cocamaster,3301,870,32,35,67,47.8%,41m
9684,3,[NOllll]IIIIIIIIIIII,3301,458,18,13,31,58.1%,40m
9684,3,ggTOP,3301,396,17,14,31,54.8%,28m
9684,3,Badam,3301,430,15,16,31,48.4%,19m
9684,3,[BlackF]Kyu,3301,152,10,8,18,55.6%,43m
9684,1,[FEARZ]Vexful,3301,141,7,1,8,87.5%,37m
9684,3,paul,3301,166,7,5,12,58.3%,11m
9684,3,[FU2]Skull,3301,176,7,8,15,46.7%,21m
9684,3,Skoda,3301,179,6,6,12,50.0%,30m
9684,3,Kobooey,3301,139,4,2,6,66.7%,17m
9684,3,[7IP]Escanor,3301,30,2,3,5,40.0%,4m
9697,3,SpinInertia,3300,696,99,95,194,51.0%,14m
9697,3,[OTWAG]RectSqG,3300,1426,65,40,105,61.9%,14m
9697,3,Jabooobooo,3300,1091,49,30,79,62.0%,5m
9697,3,Keyzer,3300,654,28,20,48,58.3%,17m
9697,3,ribbie,3300,695,27,23,50,54.0%,36m
9697,3,Blackbird,3300,438,19,10,29,65.5%,8m
9697,2,Random,3300,359,9,23,32,28.1%,25m
9697,3,[EtrOy]Meatball,3300,194,7,5,12,58.3%,17m
9697,3,TheChosenOne,3300,121,6,3,9,66.7%,6m
9697,3,BluEdash,3300,58,5,3,8,62.5%,43m
9697,3,Zaur,3300,90,4,7,11,36.4%,21m
9697,2,WindWIn,3300,0,3,2,5,60.0%,13m
9697,3,MasterAndrew,3300,30,2,0,2,100.0%,15m
9697,3,BrianWobbles,3300,58,2,4,6,33.3%,23m
9697,3,Platahalcon,3300,0,1,0,1,100.0%,40m
9697,3,Snoky,3300,0,1,2,3,33.3%,25m
9697,3,Rasgard,3300,30,1,4,5,20.0%,25m
9697,3,[NwAs]speakdown,3300,0,0,1,1,0.0%,23m
9697,3,Aspera,3300,0,0,3,3,0.0%,14m
9697,3,Darknight,3300,0,0,7,7,0.0%,30m
9717,3,[NSLB]Chuff,3299,1115,43,37,80,53.8%,37m
9717,3,[M4G4]MoreThor,3299,522,21,19,40,52.5%,9m
9717,3,[TGosuA]TheRomanian,3299,395,17,12,29,58.6%,30m
9717,3,danny,3299,196,8,5,13,61.5%,32m
9717,2,Toko,3299,184,6,4,10,60.0%,38m
9717,2,Felisbino,3299,95,5,1,6,83.3%,2h
9717,3,Nosferatu,3299,0,1,0,1,100.0%,29m
9717,3,Cracks,3299,30,1,1,2,50.0%,3m
9717,3,Tron,3299,0,0,1,1,0.0%,20m
9717,2,MacrO,3299,0,0,1,1,0.0%,2h
9717,3,[JAGWN]NightBreaker,3299,0,0,1,1,0.0%,30m
9717,3,Eurynomus,3299,0,0,1,1,0.0%,35m
9729,2,kRissOn,3298,1562,1144,1127,2271,50.4%,24m
9729,3,Esno,3298,1535,243,239,482,50.4%,37m
9729,3,Omega,3298,1081,143,142,285,50.2%,16m
9729,3,PankchO,3298,1162,142,122,264,53.8%,12m
9729,3,CerTaiN,3298,1103,74,54,128,57.8%,42m
9729,3,Tyranotaurix,3298,658,24,21,45,53.3%,11m
9729,3,draconian,3298,409,16,9,25,64.0%,6m
9729,3,DeDoSo,3298,440,15,19,34,44.1%,31m
9729,2,goblin,3298,274,14,12,26,53.8%,12m
9729,3,HighlandSoul,3298,204,7,11,18,38.9%,30m
9729,3,[ArcN9]Yaygir,3298,103,5,8,13,38.5%,17m
9729,2,Kaddy,3298,0,4,1,5,80.0%,2h
9729,3,Aiden,3298,86,3,1,4,75.0%,36m
9729,3,thral,3298,60,3,3,6,50.0%,29m
9729,3,dracoKnights,3298,0,0,2,2,0.0%,6m
9744,2,Bisso,3297,1565,631,628,1259,50.1%,12m
9744,2,GreenCRV,3297,1536,194,190,384,50.5%,32m
9744,3,[cbox]dhn,3297,984,43,28,71,60.6%,16m
9744,3,[FyHr]Tartus,3297,938,36,27,63,57.1%,16m
9744,3,OpenMisere,3297,399,18,12,30,60.0%,17m
9744,2,[0iq]ZlingPrinter,3297,518,16,33,49,32.7%,12m
9744,3,Kow,3297,220,14,16,30,46.7%,4m
9744,3,MintyFresh,3297,318,12,9,21,57.1%,22m
9744,3,[KingSC]Montana,3297,176,7,7,14,50.0%,29m
9744,3,Blink,3297,145,5,4,9,55.6%,3m
9744,3,TheD,3297,145,4,3,7,57.1%,39m
9744,3,FlamingPanda,3297,58,3,0,3,100.0%,31m
9744,3,[AiMB]Weandro,3297,58,3,1,4,75.0%,28m
9744,2,BadTouch,3297,0,2,4,6,33.3%,13m
9744,3,Lasagna,3297,30,2,4,6,33.3%,16m
9744,3,[UTK]RZGRZ,3297,0,1,0,1,100.0%,9m
9744,3,Orca,3297,0,0,5,5,0.0%,17m
9761,2,Slackmaster,3296,1529,311,306,617,50.4%,40m
9761,2,Kalium,3296,1575,252,241,493,51.1%,30m
9761,3,[iDeX]ForaBolsonar,3296,1148,54,33,87,62.1%,35m
9761,3,blackjack,3296,913,41,28,69,59.4%,43m
9761,3,[xLgNx]silvermoon,3296,417,18,15,33,54.5%,39m
9761,3,[Macac0]RickRoss,3296,354,13,12,25,52.0%,14m
9761,3,Vaknazz,3296,86,4,0,4,100.0%,16m
9761,3,KelThuzad,3296,86,3,6,9,33.3%,30m
9761,3,[ZOOMOB]Clarity,3296,30,2,0,2,100.0%,41m
9761,3,[SsaYnS]Matt,3296,60,2,9,11,18.2%,12m
9761,3,[NPhasA]Cutepants,3296,0,1,9,10,10.0%,30m
9761,3,Monkey,3296,0,0,1,1,0.0%,18m
9761,3,[0l0l0]TERKANO,3296,0,0,2,2,0.0%,10m
9774,3,PinkiePie,3295,748,140,95,235,59.6%,20m
9774,3,Sadie,3295,260,24,12,36,66.7%,12m
9774,3,BabyProbe,3295,633,24,19,43,55.8%,8m
9774,2,[HOMOF]likeSON,3295,398,17,14,31,54.8%,30m
9774,3,cocone,3295,180,8,3,11,72.7%,22m
9774,1,NoScared,3295,204,7,3,10,70.0%,13m
9774,2,Onixzet,3295,0,4,1,5,80.0%,1h
9774,3,JJeezy,3295,0,2,3,5,40.0%,30m
9774,3,Tykim,3295,0,1,0,1,100.0%,31m
9774,3,Golan,3295,30,1,1,2,50.0%,27m
9774,3,Alyatasy,3295,30,1,1,2,50.0%,10m
9774,3,[cl0udM]Kakarott,3295,0,0,1,1,0.0%,5m
9774,3,[SC2IDN]FireKing,3295,0,0,1,1,0.0%,18m
9774,3,Ninx,3295,0,0,1,1,0.0%,9m
9788,2,BaseDrifter,3294,1527,480,477,957,50.2%,39m
9788,3,Ghost,3294,1580,279,242,521,53.6%,8m
9788,3,timeless,3294,886,72,75,147,49.0%,32m
9788,3,Sarlekk,3294,1124,42,42,84,50.0%,29m
9788,3,shibe,3294,458,17,13,30,56.7%,40m
9788,3,slicedbread,3294,58,3,1,4,75.0%,35m
9788,3,[icekin]greghatch,3294,88,1,1,2,50.0%,29m
9788,1,Guile,3294,0,0,1,1,0.0%,39m
9788,3,fOxViktOR,3294,0,0,1,1,0.0%,15m
9797,3,[sm0oth]brainedPony,3293,571,176,185,361,48.8%,17m
9797,3,VooDooJuice,3293,1023,113,93,206,54.9%,26m
9797,3,[UpxV]CondorAlfa,3293,1574,92,71,163,56.4%,27m
9797,3,[neuroW]Tialary,3293,445,30,38,68,44.1%,23m
9797,3,XxSCOTTxX,3293,588,26,3,29,89.7%,7m
9797,3,Esco,3293,708,26,20,46,56.5%,20m
9797,3,bobtoss,3293,550,22,22,44,50.0%,18m
9797,2,[USEhh]ZerglingOP,3293,281,12,6,18,66.7%,10m
9797,3,hoobaba,3293,85,9,12,21,42.9%,41m
9797,3,Willowent,3293,156,5,11,16,31.2%,20m
9797,2,Ticonderoga,3293,147,4,2,6,66.7%,18m
9797,3,FIZIK,3293,146,3,5,8,37.5%,10m
9797,3,VeinStain,3293,0,2,3,5,40.0%,17m
9797,3,CanCel,3293,0,2,3,5,40.0%,29m
9797,3,[SALTTT]TehPwnerer,3293,0,1,0,1,100.0%,9m
9797,3,Kairyu,3293,0,1,0,1,100.0%,12m
9813,3,SilianRail,3292,1563,141,132,273,51.6%,36m
9813,2,Pantera,3292,1377,136,152,288,47.2%,20m
9813,3,[UCI]katiedonut,3292,658,25,22,47,53.2%,25m
9813,3,Random,3292,216,7,12,19,36.8%,7m
9813,3,RefleX,3292,146,5,4,9,55.6%,9m
9813,3,[GGCGG]HaRpsEaL,3292,157,5,6,11,45.5%,15m
9813,3,[Astute]Rtardu,3292,86,4,0,4,100.0%,43m
9813,3,[5150BB]JJMax,3292,153,4,6,10,40.0%,34m
9813,3,Pinche,3292,0,3,2,5,60.0%,22m
9813,3,Lotus,3292,58,2,1,3,66.7%,41m
9813,3,[Core]HndleMyDeeps,3292,0,1,0,1,100.0%,31m
9813,3,[iMECH]KolosS,3292,0,1,0,1,100.0%,19m
9813,3,thebert,3292,0,1,2,3,33.3%,4m
9826,3,[1ofth7]Brett,3291,622,114,104,218,52.3%,17m
9826,3,Pyromancer,3291,545,22,17,39,56.4%,25m
9826,3,Plas,3291,532,20,13,33,60.6%,17m
9826,3,[OvrDsd]Curse,3291,255,15,10,25,60.0%,12m
9826,3,SewageSmurf,3291,363,14,4,18,77.8%,43m
9826,3,Wolf,3291,330,13,10,23,56.5%,27m
9826,3,[EnTrpY]WilliamTell,3291,306,11,7,18,61.1%,23m
9826,3,[LTlord]Nevada,3291,174,7,4,11,63.6%,3m
9826,3,LightNinja,3291,86,3,2,5,60.0%,20m
9826,3,[GBros]sSFeisty,3291,30,2,0,2,100.0%,33m
9826,3,meme,3291,58,2,1,3,66.7%,23m
9826,3,[QCHFLT]FoxMulder,3291,0,2,1,3,66.7%,7m
9826,3,leavethegame,3291,58,2,4,6,33.3%,37m
9826,3,KBphan,3291,0,1,0,1,100.0%,40m
9826,3,Moridin,3291,0,1,0,1,100.0%,29m
9826,3,[L0B]Bane,3291,0,0,1,1,0.0%,32m
9826,3,ChiLeNo,3291,0,0,1,1,0.0%,12m
9826,3,[CraftK]Luizinhio,3291,0,0,3,3,0.0%,33m
9844,3,BetaStar,3290,1554,475,441,916,51.9%,15m
9844,3,DMasther,3290,669,93,90,183,50.8%,7m
9844,2,Gingulous,3290,1142,82,67,149,55.0%,32m
9844,2,Phoenix,3290,652,22,37,59,37.3%,22m
9844,3,ViciousV,3290,440,17,23,40,42.5%,29m
9844,3,Conotor,3290,397,16,16,32,50.0%,12m
9844,3,Serral,3290,342,15,6,21,71.4%,36m
9844,2,[TCOFL]TUIdmSC,3290,260,11,7,18,61.1%,33m
9844,3,Zontron,3290,250,9,8,17,52.9%,6m
9844,2,[ChoCo]eCharizard,3290,160,8,5,13,61.5%,9m
9844,3,[afterM]kaRmy,3290,150,8,6,14,57.1%,30m
9844,2,cesarz,3290,0,4,1,5,80.0%,9m
9844,3,kaykoose,3290,0,1,1,2,50.0%,6m
9844,3,GameIsShiat,3290,0,1,3,4,25.0%,29m
9844,3,[ConFed]MCRN,3290,30,1,7,8,12.5%,3m
9844,3,Hex,3290,0,0,1,1,0.0%,17m
9844,3,Nemesis,3290,0,0,1,1,0.0%,6m
9861,3,Rocksteady,3289,1595,527,502,1029,51.2%,36m
9861,3,[FFAA]EFRAIN,3289,1594,116,117,233,49.8%,31m
9861,3,llllllllllll,3289,756,35,25,60,58.3%,23m
9861,1,Tom,3289,142,6,2,8,75.0%,2h
9861,3,[eXeSFR]Yuden,3289,30,5,2,7,71.4%,16m
9861,3,Draculino,3289,58,2,2,4,50.0%,26m
9861,3,[Awooos]water,3289,60,2,6,8,25.0%,31m
9861,3,[UpeV]Sweader,3289,0,1,0,1,100.0%,40m
9861,3,[DASUL]LaloAssassin,3289,0,1,1,2,50.0%,14m
9861,3,[57717]Jerry,3289,0,0,2,2,0.0%,25m
9861,3,Deepo,3289,0,0,2,2,0.0%,7m
9872,3,[SCVM]nightkiller,3288,1524,100,71,171,58.5%,14m
9872,3,PleaseNo,3288,331,16,12,28,57.1%,20m
9872,3,Admiral,3288,312,13,1,14,92.9%,15m
9872,3,OnEWiPe,3288,317,11,15,26,42.3%,11m
9872,3,Ancalagon,3288,260,11,15,26,42.3%,21m
9872,3,OhMyZeRo,3288,308,10,16,26,38.5%,12m
9872,3,Zelif,3288,146,9,7,16,56.2%,9m
9872,3,Bannor,3288,152,6,8,14,42.9%,43m
9872,3,Stonewall,3288,166,5,1,6,83.3%,21m
9872,3,COALMAN,3288,178,5,4,9,55.6%,6m
9872,3,Venom,3288,33,2,1,3,66.7%,37m
9872,3,[EtrOy]Ferk,3288,58,2,2,4,50.0%,7m
9872,3,[CCUO]BirchTree,3288,0,1,0,1,100.0%,27m
9872,3,TheZVirus,3288,0,1,5,6,16.7%,28m
9872,3,IzayaDerek,3288,0,0,2,2,0.0%,5m
9887,3,RockmSockm,3287,1250,116,106,222,52.3%,17m
9887,3,Zero,3287,1636,97,88,185,52.4%,24m
9887,3,[Colrs]VeryCool,3287,1589,89,69,158,56.3%,11m
9887,3,[Snooot]moose,3287,1270,48,47,95,50.5%,36m
9887,3,TheDub,3287,434,20,12,32,62.5%,14m
9887,2,turokoktel,3287,142,6,6,12,50.0%,10m
9887,2,laba,3287,95,5,1,6,83.3%,37m
9887,3,Starscream,3287,165,4,2,6,66.7%,14m
9887,3,Church,3287,60,3,1,4,75.0%,35m
9887,3,Cackumbabo,3287,0,3,1,4,75.0%,11m
9887,3,[GOPERÚ]BellCranel,3287,60,2,3,5,40.0%,18m
9887,3,Zaraki,3287,60,2,6,8,25.0%,27m
9887,3,pSyche,3287,0,1,1,2,50.0%,27m
9887,3,Norwegia,3287,30,1,3,4,25.0%,3m
9887,3,[O2H]yoshi,3287,30,1,4,5,20.0%,22m
9902,3,chunkybaby,3286,1588,155,121,276,56.2%,32m
9902,3,Luonidas,3286,1388,100,101,201,49.8%,26m
9902,3,CeberousMan,3286,688,27,26,53,50.9%,37m
9902,3,skybeaver,3286,512,22,19,41,53.7%,8m
9902,3,llllllllllll,3286,474,18,21,39,46.2%,23m
9902,3,[UpxV]VANTRUYGEN,3286,368,14,10,24,58.3%,25m
9902,3,Stingray,3286,350,12,8,20,60.0%,23m
9902,3,Aseos,3286,258,10,6,16,62.5%,41m
9902,3,Donkeystorm,3286,288,10,14,24,41.7%,40m
9902,3,McDonalds,3286,169,8,11,19,42.1%,41m
9902,3,lIlIlIIIIl,3286,0,4,1,5,80.0%,23m
9902,3,skyghost,3286,58,3,1,4,75.0%,29m
9902,3,[GOBBIE]Sekt,3286,30,1,2,3,33.3%,6m
9915,3,MechNCheese,3285,1583,469,455,924,50.8%,19m
9915,3,Celestic,3285,562,25,21,46,54.3%,23m
9915,3,SirK,3285,433,22,16,38,57.9%,40m
9915,3,[PwT]RaZoR,3285,426,14,23,37,37.8%,30m
9915,3,[BlTEL]Ryub,3285,274,11,11,22,50.0%,12m
9915,3,bruh,3285,148,9,12,21,42.9%,7m
9915,3,HighDied,3285,236,8,12,20,40.0%,2m
9915,3,Moonstuck,3285,200,7,8,15,46.7%,15m
9915,3,HokusPolokus,3285,0,5,2,7,71.4%,15m
9915,3,CatheaD,3285,0,4,2,6,66.7%,11m
9915,3,[11001]Rheinmetal,3285,88,4,7,11,36.4%,6m
9915,3,WorstSuccess,3285,0,1,0,1,100.0%,37m
9915,3,[ExcIgN]PanCnCasuela,3285,0,1,0,1,100.0%,35m
9915,1,nGGnoReSpeCT,3285,0,1,2,3,33.3%,27m
9915,3,BlueMaserati,3285,0,1,3,4,25.0%,3m
9915,3,AllStimmedUp,3285,0,0,1,1,0.0%,6m
9931,3,snowmanboy,3284,1545,228,215,443,51.5%,23m
9931,3,TurdGolem,3284,709,51,33,84,60.7%,11m
9931,3,Boubz,3284,874,37,27,64,57.8%,29m
9931,3,cope,3284,854,34,37,71,47.9%,3m
9931,3,TheShadow,3284,766,33,18,51,64.7%,22m
9931,3,[Pikmin]Metrick,3284,556,21,16,37,56.8%,29m
9931,3,llllllll,3284,537,18,24,42,42.9%,9m
9931,3,SuperMutyQc,3284,424,16,19,35,45.7%,35m
9931,3,[TeamGP]ThebarTV,3284,413,15,9,24,62.5%,20m
9931,3,[KaGaN]lwlwllwl,3284,358,13,12,25,52.0%,40m
9931,3,brotato,3284,116,6,1,7,85.7%,41m
9931,3,[10YoP]FReaK,3284,118,5,2,7,71.4%,30m
9931,3,Zockerbabba,3284,138,4,0,4,100.0%,28m
9931,3,VitorHugo,3284,60,3,2,5,60.0%,17m
9931,3,[ZTempz]EmpressLumi,3284,0,1,0,1,100.0%,3m
9931,3,DumDum,3284,30,1,1,2,50.0%,22m
9931,3,[TGosuB]Snailbait,3284,0,0,1,1,0.0%,39m
9931,3,Meemoo,3284,0,0,2,2,0.0%,10m
9949,3,legionn,3283,1580,203,183,386,52.6%,32m
9949,3,Safonte,3283,1472,183,163,346,52.9%,25m
9949,3,warstb,3283,1506,94,81,175,53.7%,12m
9949,3,tqkudhea,3283,1472,73,70,143,51.0%,30m
9949,3,[Recall]Vonix,3283,966,67,48,115,58.3%,8m
9949,3,[MarCo]Coala,3283,1243,51,39,90,56.7%,5m
9949,3,DreamX,3283,1088,44,39,83,53.0%,38m
9949,3,[EvilGC]Quetzalcóatl,3283,532,22,16,38,57.9%,18m
9949,3,Style,3283,588,22,19,41,53.7%,21m
9949,3,Dorime,3283,205,7,1,8,87.5%,20m
9949,3,Capn,3283,152,6,5,11,54.5%,32m
9949,1,DarkShadow,3283,97,5,2,7,71.4%,1h
9949,3,[HANYU]HotdogBoi,3283,30,2,1,3,66.7%,14m
9949,3,BladeMaster,3283,30,2,1,3,66.7%,3m
9949,3,YeePs,3283,0,2,3,5,40.0%,41m
9949,3,[TgAg]ItsRichieBTW,3283,58,2,3,5,40.0%,32m
9949,3,Avantasia,3283,30,2,5,7,28.6%,24m
9949,3,[PHOEVA]PisoMojado,3283,30,1,1,2,50.0%,26m
9949,3,Acai,3283,30,1,1,2,50.0%,28m
9949,3,Herrcombs,3283,94,1,2,3,33.3%,25m
9949,3,Meiji,3283,0,0,1,1,0.0%,7m
9949,3,[DTBLNK]WhaleSpark,3283,0,0,1,1,0.0%,32m
9971,3,Vector,3282,759,116,101,217,53.5%,20m
9971,3,thisisnickc,3282,1354,55,52,107,51.4%,32m
9971,3,Etchi,3282,814,46,34,80,57.5%,4m
9971,3,Haybale,3282,601,38,32,70,54.3%,37m
9971,1,Jump,3282,345,15,9,24,62.5%,31m
9971,3,Wolfshund,3282,160,6,3,9,66.7%,26m
9971,3,IgotoHarvard,3282,60,3,2,5,60.0%,28m
9971,3,Jimmi,3282,0,3,2,5,60.0%,41m
9971,3,GeneralZ,3282,0,2,2,4,50.0%,7m
9971,3,[DRKESP]LEFTY,3282,58,2,4,6,33.3%,37m
9971,3,[d1ldo]Tonkatwuck,3282,62,2,7,9,22.2%,40m
9971,1,dfwTrainWrek,3282,0,1,0,1,100.0%,30m
9971,3,[GRNSKN]Ebondawn,3282,0,0,2,2,0.0%,8m
9984,3,CrAzZy,3281,1556,225,213,438,51.4%,29m
9984,3,TrevorSeeth,3281,1383,147,141,288,51.0%,6m
9984,3,[NPhasA]Khaospenguin,3281,1584,119,115,234,50.9%,37m
9984,3,Xithe,3281,1586,75,72,147,51.0%,12m
9984,3,Nitz,3281,1542,67,75,142,47.2%,15m
9984,3,eninyaD,3281,1134,49,32,81,60.5%,30m
9984,3,DocAper,3281,888,34,31,65,52.3%,15m
9984,3,HorseForce,3281,365,18,24,42,42.9%,12m
9984,3,[LaCreW]PachulAndre,3281,390,16,4,20,80.0%,20m
9984,3,SmoknCaliBud,3281,328,13,9,22,59.1%,43m
9984,3,wellness,3281,206,7,8,15,46.7%,3m
9984,3,[FROMOZ]EmilysDad,3281,140,6,0,6,100.0%,16m
9984,3,Ratatouille,3281,163,5,1,6,83.3%,23m
9984,2,Jakararuus,3281,0,4,1,5,80.0%,2h
9984,3,Messi,3281,150,4,6,10,40.0%,41m
9984,3,[SSCB24]HeluvaBosnia,3281,86,3,6,9,33.3%,31m
9984,3,DancingDean,3281,60,2,3,5,40.0%,6m
9984,3,Ishmish,3281,0,2,3,5,40.0%,41m
9984,3,deluxetreat,3281,0,1,0,1,100.0%,40m
9984,3,noGGforyoU,3281,30,1,2,3,33.3%,37m
9984,3,Slim,3281,30,1,3,4,25.0%,39m
9984,3,[KingSC]Garr,3281,0,0,1,1,0.0%,17m
9984,3,Dragonizer,3281,0,0,1,1,0.0%,6m
10007,2,Kilby,3280,1618,272,272,544,50.0%,10m
10007,3,lukas,3280,1189,61,59,120,50.8%,35m
10007,2,Coinflip,3280,365,47,42,89,52.8%,15m
10007,3,[DSKapa]MIke,3280,899,46,41,87,52.9%,6m
10007,3,[78RUS]evgen,3280,385,17,10,27,63.0%,12m
10007,3,Duard,3280,326,13,11,24,54.2%,18m
10007,3,Depth,3280,226,12,9,21,57.1%,11m
10007,3,[5555]RickSanchez,3280,301,11,10,21,52.4%,43m
10007,3,[RnM4EV]MortestMorty,3280,287,10,11,21,47.6%,5m
10007,3,[FyHr]Axión,3280,92,5,2,7,71.4%,19m
10007,2,coffee,3280,0,4,1,5,80.0%,1h
10007,3,okboyok,3280,92,4,3,7,57.1%,33m
10007,3,[RathFr]Raws,3280,86,4,4,8,50.0%,6m
10007,3,[Nuggin]PaZuzUu,3280,0,3,2,5,60.0%,30m
10007,3,lllllllll,3280,58,2,5,7,28.6%,22m
10022,3,Candalistic,3279,1514,174,160,334,52.1%,27m
10022,3,[UpeV]LegendHero,3279,1159,103,107,210,49.0%,19m
10022,3,Fresh,3279,818,32,29,61,52.5%,9m
10022,3,[LTK]Medix,3279,426,29,16,45,64.4%,12m
10022,3,MrDiarrhea,3279,371,16,9,25,64.0%,9m
10022,3,[FiMo]kiyogu,3279,332,13,10,23,56.5%,30m
10022,2,Broside,3279,340,11,25,36,30.6%,17m
10022,3,[Tdog4e]Lore,3279,222,7,4,11,63.6%,17m
10022,3,rednelB,3279,147,7,4,11,63.6%,15m
10022,3,HeroSlayer,3279,184,7,14,21,33.3%,20m
10022,3,llllllllllll,3279,0,5,0,5,100.0%,20m
10022,3,elo,3279,150,5,6,11,45.5%,40m
10022,3,Eldraziac,3279,0,4,1,5,80.0%,14m
10022,2,murph,3279,106,2,1,3,66.7%,24m
10022,3,tQCheerMe,3279,30,1,4,5,20.0%,5m
10022,3,Nevy,3279,0,0,1,1,0.0%,20m
10022,2,disciple,3279,0,0,1,1,0.0%,38m
10039,3,HappyDance,3278,1596,236,221,457,51.6%,6m
10039,3,Colwell,3278,1402,140,125,265,52.8%,22m
10039,3,Darkneos,3278,981,113,98,211,53.6%,11m
10039,3,[RGNK]Sursurrus,3278,303,36,26,62,58.1%,37m
10039,3,[Curds]Fushickut,3278,746,30,27,57,52.6%,28m
10039,3,PersonNight,3278,530,27,3,30,90.0%,6m
10039,3,BADD,3278,684,27,18,45,60.0%,26m
10039,3,Mitch,3278,366,13,16,29,44.8%,30m
10039,3,[EvilGC]iTzfurius,3278,350,12,16,28,42.9%,18m
10039,3,CaravelCoin,3278,181,8,5,13,61.5%,43m
10039,3,Lavo,3278,200,8,5,13,61.5%,6m
10039,3,[1vs1vs]skykiller,3278,218,7,7,14,50.0%,26m
10039,3,less,3278,88,3,3,6,50.0%,24m
10039,3,BINI,3278,30,2,3,5,40.0%,24m
10039,1,ERichtofen,3278,0,1,0,1,100.0%,23m
10054,3,Arkan,3277,1561,151,149,300,50.3%,32m
10054,2,DarthGlader,3277,946,111,118,229,48.5%,24m
10054,3,[DaBeRz]Dzy,3277,1048,84,84,168,50.0%,25m
10054,3,KillerWhale,3277,448,61,54,115,53.0%,17m
10054,3,Khazetul,3277,679,30,19,49,61.2%,3m
10054,3,[WAF]Yankee,3277,316,20,16,36,55.6%,37m
10054,3,[RaNGS]Decar,3277,310,12,5,17,70.6%,28m
10054,1,fatbellly,3277,184,8,3,11,72.7%,26m
10054,3,LittleFoot,3277,0,4,1,5,80.0%,41m
10054,1,Ledger,3277,0,1,0,1,100.0%,14m
10054,3,penywise,3277,30,1,4,5,20.0%,37m
10054,3,DizzyOG,3277,0,0,1,1,0.0%,27m
10054,3,Sun,3277,0,0,1,1,0.0%,3m
10054,3,BabyRage,3277,0,0,1,1,0.0%,31m
10068,3,ForrestGerar,3276,1556,106,99,205,51.7%,38m
10068,3,Deathcall,3276,549,94,69,163,57.7%,19m
10068,3,Yaksa,3276,1621,85,87,172,49.4%,22m
10068,2,FaShoTiNy,3276,866,67,70,137,48.9%,27m
10068,3,[eX]ftBrancO,3276,296,48,31,79,60.8%,37m
10068,3,[NrFms]RenegadeX,3276,530,23,21,44,52.3%,37m
10068,3,DCAngelo,3276,668,23,26,49,46.9%,26m
10068,3,[22IQ]Blitzer,3276,384,14,7,21,66.7%,22m
10068,3,Jackson,3276,206,14,16,30,46.7%,40m
10068,3,DiucaLoca,3276,334,13,15,28,46.4%,35m
10068,3,HANSMAGES,3276,204,8,5,13,61.5%,31m
10068,3,Romulus,3276,214,8,7,15,53.3%,3m
10068,3,Sneakattack,3276,86,4,1,5,80.0%,25m
10068,2,[SCCoop]BachVN,3276,0,1,0,1,100.0%,1h
10068,3,LiToNell,3276,30,1,2,3,33.3%,9m
10068,3,[Theee]BigDaddy,3276,30,1,2,3,33.3%,42m
10068,3,Love,3276,0,0,1,1,0.0%,9m
10068,3,[SMB]SebbieMikos,3276,0,0,1,1,0.0%,39m
10068,3,[B3RW1K]marcindadark,3276,0,0,1,1,0.0%,32m
10068,3,Zeratul,3276,0,0,1,1,0.0%,40m
10068,3,EDOvermazter,3276,0,0,2,2,0.0%,8m
10068,3,HeroicMeat,3276,0,0,4,4,0.0%,3m
10090,2,Hobbes,3275,1440,177,179,356,49.7%,26m
10090,3,tluongMD,3275,1587,166,158,324,51.2%,38m
10090,3,[KiDo]agodeli,3275,1527,98,82,180,54.4%,15m
10090,3,Hardstem,3275,1070,71,57,128,55.5%,25m
10090,3,[GEEKED]HaiLRaiser,3275,611,24,15,39,61.5%,4m
10090,3,lIlIlIlIlI,3275,516,20,21,41,48.8%,17m
10090,3,lexad,3275,60,3,1,4,75.0%,20m
10090,3,protoTYP,3275,30,2,3,5,40.0%,15m
10090,1,Chanwich,3275,0,1,0,1,100.0%,2h
10090,3,FatboyStim,3275,30,1,2,3,33.3%,30m
10100,3,MaJoR,3274,1663,263,247,510,51.6%,3m
10100,3,[CANATT]CannonRusher,3274,1389,156,133,289,54.0%,6m
10100,3,[AMZN]Kisa,3274,1103,83,73,156,53.2%,26m
10100,3,[Connah]Lancelot,3274,717,69,63,132,52.3%,20m
10100,3,[GnR]Redgunnerguy,3274,616,30,21,51,58.8%,26m
10100,3,[AOSsc]IIIIIIITW,3274,437,16,21,37,43.2%,14m
10100,3,[Emb3rs]Neeblet,3274,168,6,8,14,42.9%,12m
10100,3,[Goku]Michael,3274,150,6,10,16,37.5%,18m
10100,3,IIIIIIIIIIII,3274,0,4,1,5,80.0%,18m
10100,3,[TKS]Alanix,3274,0,0,2,2,0.0%,18m
10110,3,ChobBob,3273,1607,120,95,215,55.8%,3m
10110,3,Bateman,3273,1611,85,71,156,54.5%,43m
10110,3,[NrFms]Matriarchy,3273,1222,56,57,113,49.6%,4m
10110,3,[AFSC]FooD,3273,336,48,41,89,53.9%,22m
10110,3,[NPhase]PrbeLfeMatta,3273,1216,47,47,94,50.0%,26m
10110,3,pAtientoNe,3273,1050,40,46,86,46.5%,14m
10110,2,GunnerStahl,3273,737,33,31,64,51.6%,8m
10110,3,Shesha,3273,374,17,13,30,56.7%,8m
10110,3,[GOPERÚ]Edward,3273,412,16,15,31,51.6%,26m
10110,3,[RUMB]TyDo,3273,266,10,14,24,41.7%,23m
10110,3,Olivier,3273,178,7,8,15,46.7%,31m
10110,3,JustInCase,3273,30,5,2,7,71.4%,6m
10110,3,[BoRnGo]RushP,3273,0,1,0,1,100.0%,23m
10110,3,[KFClub]Relayer,3273,0,1,0,1,100.0%,23m
10110,1,Daishi,3273,0,1,2,3,33.3%,30m
10110,3,[BONCK]Nizuto,3273,0,0,1,1,0.0%,26m
10110,3,OpJeof,3273,0,0,2,2,0.0%,43m
10127,3,[2fTz]fixerjj,3272,1527,304,290,594,51.2%,37m
10127,3,Gyome,3272,1580,196,188,384,51.0%,35m
10127,3,UsaMajac,3272,1535,184,169,353,52.1%,12m
10127,3,ElArZaS,3272,1286,93,85,178,52.2%,7m
10127,3,[kØ]DeiDarA,3272,770,73,55,128,57.0%,17m
10127,3,Pakamalaka,3272,990,54,54,108,50.0%,41m
10127,3,Phirrup,3272,1027,44,36,80,55.0%,28m
10127,3,Summer,3272,921,37,31,68,54.4%,6m
10127,3,Otitag,3272,520,24,28,52,46.2%,12m
10127,3,Cheddar,3272,440,19,15,34,55.9%,17m
10127,3,flapjackcarl,3272,403,15,22,37,40.5%,8m
10127,2,[dreamG]Ryun,3272,170,7,9,16,43.8%,41m
10127,3,[KrAce]cris,3272,58,3,3,6,50.0%,22m
10127,3,Hunter,3272,127,3,5,8,37.5%,28m
10127,3,Goose,3272,60,3,8,11,27.3%,12m
10127,3,[Calx]Ferdinan,3272,30,1,3,4,25.0%,32m
10127,3,mindgames,3272,30,1,7,8,12.5%,41m
10127,3,JoesAhoge,3272,0,0,1,1,0.0%,19m
10145,2,Lobão,3271,1182,200,191,391,51.2%,15m
10145,2,llllllllllll,3271,1303,105,105,210,50.0%,20m
10145,3,Hexenreise,3271,1537,88,87,175,50.3%,8m
10145,3,[TapeS]Leafs,3271,1396,86,89,175,49.1%,40m
10145,3,GoldenArcan,3271,1097,52,39,91,57.1%,11m
10145,3,[spa3c]stonecoat,3271,1294,49,51,100,49.0%,32m
10145,3,Renzokuken,3271,232,45,37,82,54.9%,25m
10145,3,jeorge,3271,1106,41,40,81,50.6%,22m
10145,3,HwaLiM,3271,916,40,43,83,48.2%,37m
10145,3,floatingbase,3271,933,38,32,70,54.3%,28m
10145,3,Polux,3271,599,33,11,44,75.0%,11m
10145,3,[CLOWNF]FreeArtsakh,3271,717,29,25,54,53.7%,17m
10145,3,choiboi,3271,567,28,19,47,59.6%,33m
10145,3,[TGCF]Random,3271,525,23,22,45,51.1%,10m
10145,3,[RINGTA]KinkajouVice,3271,534,21,19,40,52.5%,20m
10145,3,[SoSMD]Flauros,3271,386,14,21,35,40.0%,36m
10145,3,[DhZAc1]Reef,3271,312,12,9,21,57.1%,12m
10145,3,[FOOK]AyrtonLoko,3271,211,11,4,15,73.3%,26m
10145,3,[BUTFUQ]HappyStorm,3271,270,10,7,17,58.8%,40m
10145,3,Aronoslo,3271,140,7,2,9,77.8%,18m
10145,3,xiaojifan,3271,60,7,4,11,63.6%,18m
10145,3,breakingwind,3271,144,7,5,12,58.3%,8m
10145,3,IamBog,3271,0,4,1,5,80.0%,19m
10145,3,SherifofAiur,3271,58,3,0,3,100.0%,29m
10145,1,hiyo,3271,97,3,4,7,42.9%,15m
10145,2,[IiUiI]Antisaint,3271,0,1,0,1,100.0%,2h
10145,3,LionHeart,3271,0,1,0,1,100.0%,3m
10145,3,Latreasy,3271,30,1,5,6,16.7%,37m
10145,3,cyphdigity,3271,0,0,1,1,0.0%,3m
10174,2,ASlowLoris,3270,1444,92,101,193,47.7%,41m
10174,3,Thugrant,3270,1534,74,77,151,49.0%,25m
10174,3,Push,3270,763,32,23,55,58.2%,24m
10174,3,[PobSC]Miracle,3270,542,31,18,49,63.3%,9m
10174,3,oldkiper,3270,404,25,15,40,62.5%,8m
10174,3,Luvistras,3270,412,16,16,32,50.0%,36m
10174,3,MAGA,3270,303,14,7,21,66.7%,22m
10174,1,GeneralBags,3270,225,10,8,18,55.6%,20m
10174,3,Mophideus,3270,176,7,5,12,58.3%,40m
10174,3,LUFYOJ,3270,174,7,7,14,50.0%,25m
10174,3,BudgetSteak,3270,174,7,8,15,46.7%,41m
10174,1,darkFoxyy,3270,119,6,2,8,75.0%,36m
10174,2,DumbRace,3270,119,5,2,7,71.4%,38m
10174,3,Worst,3270,0,4,3,7,57.1%,19m
10174,3,[PvZMa]BlueBob,3270,92,4,8,12,33.3%,19m
10174,3,ShadowSwords,3270,58,3,1,4,75.0%,29m
10174,3,FatherDrift,3270,58,3,1,4,75.0%,27m
10174,3,Eugenie,3270,38,2,1,3,66.7%,24m
10174,3,Kesutny,3270,30,2,2,4,50.0%,2m
10174,3,Fishbed,3270,0,0,1,1,0.0%,19m
10174,3,bartlln,3270,0,0,2,2,0.0%,20m
10195,3,GRAP,3269,1143,66,55,121,54.5%,42m
10195,3,lacouleuvre,3269,1440,57,60,117,48.7%,41m
10195,1,LisaSu,3269,397,17,7,24,70.8%,5m
10195,3,daymiel,3269,284,10,10,20,50.0%,25m
10195,2,[SSEAS]EricLamFan,3269,206,9,6,15,60.0%,35m
10195,3,DrOctopulus,3269,83,9,8,17,52.9%,21m
10195,1,VXstarfallXV,3269,142,8,1,9,88.9%,26m
10195,3,Nergal,3269,178,7,9,16,43.8%,16m
10195,3,[OdVark]Dorime,3269,116,5,2,7,71.4%,18m
10195,3,YakuzaMan,3269,116,5,2,7,71.4%,7m
10195,3,[GaTech]Gimbap,3269,0,1,0,1,100.0%,43m
10195,3,[TGosuC]Moglie,3269,0,1,0,1,100.0%,26m
10195,3,[PCAKE]billythekid,3269,0,0,1,1,0.0%,34m
10195,3,[182]DAVID,3269,0,0,1,1,0.0%,39m
10209,3,parksangyeon,3268,1393,316,279,595,53.1%,11m
10209,3,Kam,3268,1504,173,138,311,55.6%,19m
10209,2,Bloodwolf,3268,1484,151,156,307,49.2%,11m
10209,3,Vasilis,3268,1624,125,112,237,52.7%,11m
10209,3,ROOKIE,3268,1516,64,61,125,51.2%,41m
10209,3,[33rd]Mozzi,3268,784,34,26,60,56.7%,3m
10209,3,OxdeadcOde,3268,730,26,28,54,48.1%,27m
10209,3,TMcorvo,3268,618,22,23,45,48.9%,6m
10209,3,Semiw,3268,446,21,15,36,58.3%,29m
10209,3,sulkosaurus,3268,190,9,4,13,69.2%,40m
10209,3,[MMyDIS]darentkx,3268,220,7,15,22,31.8%,25m
10209,1,TheOutCome,3268,142,6,3,9,66.7%,1h
10209,3,ScFlameY,3268,172,6,7,13,46.2%,8m
10209,2,Gleeton,3268,0,5,0,5,100.0%,1h
10209,3,kushinhaler,3268,62,3,4,7,42.9%,20m
10209,3,Acehigh,3268,58,3,4,7,42.9%,42m
10209,3,Hasted,3268,30,2,1,3,66.7%,11m
10209,3,[Barbac]CarniTaz,3268,0,1,0,1,100.0%,11m
10209,1,IIIIIIIIIIII,3268,0,1,0,1,100.0%,2h
10209,3,zzzzmodule,3268,30,1,2,3,33.3%,16m
10209,3,[RJK]Elementary,3268,30,1,2,3,33.3%,25m
10230,3,[LBanda]polo,3267,1604,167,156,323,51.7%,6m
10230,3,[ToOr]ApexLogic,3267,1638,164,165,329,49.8%,15m
10230,3,Zandre,3267,1084,42,37,79,53.2%,43m
10230,3,Sherpad,3267,871,41,42,83,49.4%,7m
10230,3,Texas,3267,255,20,15,35,57.1%,14m
10230,3,[CUCKSS]OpMagic,3267,226,9,5,14,64.3%,6m
10230,1,SportageR,3267,138,7,1,8,87.5%,2h
10230,3,Rapier,3267,170,7,4,11,63.6%,25m
10230,3,systemd,3267,0,4,1,5,80.0%,41m
10230,2,UnLiMited,3267,90,2,3,5,40.0%,26m
10230,3,StefanSC,3267,30,2,5,7,28.6%,11m
10230,3,Asdqwdfas,3267,0,1,0,1,100.0%,17m
10230,3,RazerNaga,3267,30,1,3,4,25.0%,18m
10230,3,[Pig2]QuIVeR,3267,0,0,2,2,0.0%,40m
10244,3,CabCaramelo,3266,1136,176,172,348,50.6%,32m
10244,2,[NwAs]PinkFloyd,3266,996,35,49,84,41.7%,40m
10244,3,cfmm,3266,854,30,36,66,45.5%,29m
10244,3,[46]ERTA,3266,349,17,8,25,68.0%,5m
10244,2,Scoub,3266,400,13,26,39,33.3%,38m
10244,3,[CUMING]maxwelljones,3266,284,10,12,22,45.5%,12m
10244,3,Vague,3266,0,3,2,5,60.0%,27m
10244,3,[Petsen]Mastershaft,3266,30,2,2,4,50.0%,20m
10244,1,CHOEzilla,3266,111,2,3,5,40.0%,29m
10244,2,[Fir3s]Saviour,3266,0,1,0,1,100.0%,2h
10244,3,uriline,3266,0,1,0,1,100.0%,29m
10244,3,terranstyle,3266,0,0,1,1,0.0%,7m
10244,3,[ASC1]USSR,3266,0,0,2,2,0.0%,27m
10257,2,TaZ,3265,1214,91,96,187,48.7%,12m
10257,3,DrunkMaru,3265,310,36,24,60,60.0%,39m
10257,3,Stein,3265,415,17,6,23,73.9%,31m
10257,3,[ShoaL]JJThree,3265,249,13,4,17,76.5%,15m
10257,3,MooStar,3265,170,8,6,14,57.1%,40m
10257,3,Swift,3265,204,8,14,22,36.4%,23m
10257,3,Locke,3265,168,7,3,10,70.0%,25m
10257,3,[CBAS]chessiiimate,3265,114,5,5,10,50.0%,18m
10257,3,JefazoGT,3265,0,4,1,5,80.0%,27m
10257,3,Kira,3265,0,4,1,5,80.0%,43m
10257,3,Utope,3265,116,4,3,7,57.1%,38m
10257,3,Zoomix,3265,58,2,2,4,50.0%,26m
10257,3,[ELIDS]ManMallow,3265,30,1,1,2,50.0%,18m
10257,2,AIphaStar,3265,96,1,1,2,50.0%,2h
10257,3,AverageJoe,3265,0,0,1,1,0.0%,7m
10257,3,JoeyPick,3265,0,0,1,1,0.0%,15m
10273,3,[KGH]Optimus,3264,1559,429,433,862,49.8%,3m
10273,3,Hegbert,3264,1225,109,87,196,55.6%,27m
10273,3,Bertxi,3264,1517,106,97,203,52.2%,19m
10273,3,Abernasty,3264,1122,102,96,198,51.5%,26m
10273,3,Bot,3264,355,70,53,123,56.9%,12m
10273,3,[GGMESP]Linko,3264,682,52,49,101,51.5%,33m
10273,3,[ORTSS]VeganDragon,3264,997,39,39,78,50.0%,11m
10273,3,[IiUiI]donjimon,3264,838,32,30,62,51.6%,17m
10273,3,Arcangel,3264,546,23,15,38,60.5%,31m
10273,3,COVIDSUXX,3264,441,18,9,27,66.7%,3m
10273,3,SuperMage,3264,202,7,6,13,53.8%,15m
10273,3,brotoss,3264,95,5,1,6,83.3%,25m
10273,3,dropthebeat,3264,166,4,5,9,44.4%,31m
10273,3,[lLiTl]Voper,3264,30,2,2,4,50.0%,14m
10273,3,primussux,3264,0,1,0,1,100.0%,20m
10273,3,[Parkto]COULDBE,3264,0,0,1,1,0.0%,22m
10289,3,[SsaYnS]Kiar,3263,880,53,48,101,52.5%,42m
10289,3,Sandtrap,3263,782,35,22,57,61.4%,11m
10289,3,[P07470]Conquistador,3263,829,34,32,66,51.5%,31m
10289,3,Shootz,3263,772,30,31,61,49.2%,41m
10289,3,[ExcIgN]Dedicated,3263,452,20,15,35,57.1%,3m
10289,3,Aramil,3263,452,17,14,31,54.8%,35m
10289,3,[MPA]OldManBen,3263,306,14,9,23,60.9%,31m
10289,3,[GdAT]xyxer,3263,333,13,2,15,86.7%,19m
10289,3,Cantataz,3263,149,10,4,14,71.4%,7m
10289,3,[Arete]unseenfire,3263,238,9,2,11,81.8%,23m
10289,1,LighT,3263,193,5,2,7,71.4%,23m
10289,3,DemoDude,3263,106,5,2,7,71.4%,35m
10289,1,[QQoo]Achilles,3263,0,2,5,7,28.6%,2h
10289,3,NYCnosukja,3263,0,1,0,1,100.0%,37m
10289,2,sickviscious,3263,0,0,1,1,0.0%,1h
10289,3,Jeffkhan,3263,0,0,3,3,0.0%,9m
10305,3,Takateru,3262,1544,188,172,360,52.2%,12m
10305,3,ArchAshaman,3262,1674,166,155,321,51.7%,11m
10305,3,[TPGGXD]Infected,3262,1342,94,76,170,55.3%,31m
10305,3,[NVYTE]YaelEithanS,3262,1493,76,79,155,49.0%,12m
10305,3,[TMSG]Narwhal,3262,1024,44,31,75,58.7%,35m
10305,3,PsiMatrix,3262,824,29,38,67,43.3%,6m
10305,3,AntiXero,3262,294,22,23,45,48.9%,37m
10305,3,voinsveta,3262,294,14,7,21,66.7%,20m
10305,3,[trolz]Hakase,3262,302,14,11,25,56.0%,11m
10305,3,[eXtra1]BlueTurtle,3262,317,12,15,27,44.4%,18m
10305,3,SewerMerMAN,3262,273,10,8,18,55.6%,10m
10305,3,Freak,3262,165,5,1,6,83.3%,33m
10305,3,[Nestea]Ghoststrikes,3262,114,5,1,6,83.3%,9m
10305,3,[JoyofP]BobRoss,3262,126,5,13,18,27.8%,10m
10305,3,SelFelatio,3262,0,2,3,5,40.0%,14m
10305,3,dreambeing,3262,0,1,0,1,100.0%,17m
10305,3,starjoy,3262,30,1,4,5,20.0%,23m
10322,3,[EzyPzY]raydo,3261,1269,163,131,294,55.4%,26m
10322,3,tolss,3261,949,73,69,142,51.4%,41m
10322,3,[AxM]Umbra,3261,1165,63,53,116,54.3%,10m
10322,3,Doom,3261,1302,57,51,108,52.8%,20m
10322,3,Ryahri,3261,467,45,48,93,48.4%,36m
10322,3,alberttt,3261,864,36,24,60,60.0%,11m
10322,3,DontSneezeMe,3261,894,35,42,77,45.5%,6m
10322,3,Javm,3261,399,22,16,38,57.9%,8m
10322,3,[FateTw]Soapyjeans,3261,422,16,19,35,45.7%,9m
10322,3,Goldo,3261,58,6,3,9,66.7%,39m
10322,3,[TimTom]Zzoram,3261,184,6,15,21,28.6%,22m
10322,2,IIIIIIIIIIII,3261,48,4,3,7,57.1%,2h
10322,3,Pwnography,3261,0,1,2,3,33.3%,31m
10322,3,Orbitrax,3261,0,1,2,3,33.3%,43m
10322,3,Nefarious,3261,0,0,1,1,0.0%,41m
10322,3,[propvz]satansbro,3261,0,0,2,2,0.0%,34m
10322,3,[PwT]gabrielbr,3261,0,0,4,4,0.0%,9m
10339,3,MarkyFenRuvO,3260,1585,187,157,344,54.4%,23m
10339,2,[500CC]lllll,3260,1264,115,123,238,48.3%,7m
10339,3,TTw,3260,1179,82,77,159,51.6%,6m
10339,3,[GlRTH]Oniontears,3260,1355,55,46,101,54.5%,31m
10339,3,Grim,3260,958,48,28,76,63.2%,5m
10339,3,AkanuWolf,3260,1050,40,39,79,50.6%,8m
10339,3,[PTHero]zax,3260,577,22,15,37,59.5%,31m
10339,3,Feyd,3260,490,20,18,38,52.6%,3m
10339,3,[BTSbr]Zeratur,3260,278,10,3,13,76.9%,16m
10339,3,[BTSbr]BORUTO,3260,314,10,19,29,34.5%,3m
10339,3,[KG73]Atzuky,3260,260,8,3,11,72.7%,20m
10339,3,[PPKDC]HTEXECUTIVE,3260,239,8,4,12,66.7%,12m
10339,2,[Swage]RogerFederer,3260,182,5,1,6,83.3%,8m
10339,3,Shadow,3260,185,5,1,6,83.3%,7m
10339,3,lllllllllIll,3260,114,5,3,8,62.5%,23m
10339,1,Leaky,3260,146,3,3,6,50.0%,9m
10339,3,Simple,3260,60,2,5,7,28.6%,26m
10339,3,lapengu,3260,0,1,0,1,100.0%,41m
10339,3,WhalterWhite,3260,0,1,0,1,100.0%,19m
10339,3,[IiUiI]KoshNaranek,3260,0,1,0,1,100.0%,19m
10339,2,Inchoatus,3260,0,0,1,1,0.0%,1h
10339,3,iseefar,3260,0,0,1,1,0.0%,9m
10339,3,Corvo,3260,0,0,1,1,0.0%,3m
10339,3,JohnJiang,3260,0,0,4,4,0.0%,41m
10363,2,Jav,3259,1519,159,159,318,50.0%,42m
10363,3,[CoPa]Lexicon,3259,897,150,137,287,52.3%,30m
10363,3,[Xpk]Jedi,3259,1010,57,54,111,51.4%,40m
10363,3,PBnJ,3259,1207,52,34,86,60.5%,15m
10363,3,[Fever]obamasmom,3259,427,16,10,26,61.5%,43m
10363,3,ObserveHer,3259,184,9,3,12,75.0%,7m
10363,3,Untalented,3259,145,6,7,13,46.2%,39m
10363,1,[flac]stapler,3259,190,5,3,8,62.5%,9m
10363,2,AceOfWar,3259,96,2,0,2,100.0%,10m
10363,1,[1E100]yajupadu,3259,97,2,3,5,40.0%,16m
10363,3,Zakarumae,3259,0,1,0,1,100.0%,42m
10363,3,[PTHero]JTgalactica,3259,0,1,0,1,100.0%,17m
10363,3,HeavyBolter,3259,0,0,1,1,0.0%,22m
10363,3,[Cryptc]draingang,3259,0,0,1,1,0.0%,20m
10363,3,mrlittle,3259,0,0,1,1,0.0%,3m
10363,3,cccccccccccc,3259,0,0,1,1,0.0%,40m
10363,3,[DETER]Jererere,3259,0,0,2,2,0.0%,17m
10380,3,GGWP,3258,1082,158,126,284,55.6%,43m
10380,3,Lers,3258,1478,91,76,167,54.5%,20m
10380,3,[TPGGXD]BallsDeep,3258,1212,43,51,94,45.7%,34m
10380,3,DruMMonD,3258,530,23,13,36,63.9%,11m
10380,3,Franchise,3258,298,9,8,17,52.9%,12m
10380,3,Chemikal,3258,208,7,13,20,35.0%,43m
10380,3,Nope,3258,30,6,0,6,100.0%,11m
10380,3,[xLsROC]CHV,3258,148,5,0,5,100.0%,6m
10380,3,justinweaver,3258,114,4,8,12,33.3%,36m
10380,3,Glaedr,3258,90,3,9,12,25.0%,4m
10380,3,UpGrade,3258,58,2,2,4,50.0%,32m
10380,1,[dBASED]KotShaman,3258,0,1,0,1,100.0%,2h
10380,3,iNguyen,3258,30,1,5,6,16.7%,19m
10393,3,theSadZealoT,3257,546,104,80,184,56.5%,25m
10393,3,[XDRAX8]RaitoKun,3257,1458,104,97,201,51.7%,5m
10393,3,jojodemighty,3257,1148,85,69,154,55.2%,23m
10393,3,eXtremeFTW,3257,489,50,34,84,59.5%,8m
10393,3,Shadow,3257,896,34,36,70,48.6%,22m
10393,3,[MaxWin]BRODOZING,3257,564,22,19,41,53.7%,35m
10393,3,Grosjambon,3257,493,21,11,32,65.6%,24m
10393,3,Fubar,3257,452,17,16,33,51.5%,27m
10393,3,[TS2L]Karpetburns,3257,282,10,8,18,55.6%,39m
10393,3,FunkyPants,3257,190,8,5,13,61.5%,39m
10393,3,[1Fenix]luky,3257,146,5,4,9,55.6%,25m
10393,3,crazyman,3257,63,5,25,30,16.7%,37m
10393,3,sEmtEx,3257,0,4,1,5,80.0%,18m
10393,3,Knicks,3257,88,4,4,8,50.0%,6m
10393,3,RUSHBANSHEE,3257,0,3,2,5,60.0%,21m
10393,3,Geoth,3257,58,3,4,7,42.9%,3m
10393,3,[NLTN]Innerself,3257,30,2,0,2,100.0%,15m
10393,3,JoNtheGrEAT,3257,0,1,0,1,100.0%,7m
10393,3,[FZ]Bagelz,3257,0,1,1,2,50.0%,31m
10393,3,[25ml]Csheef,3257,30,1,3,4,25.0%,14m
10393,3,Bozo,3257,0,0,1,1,0.0%,19m
10393,3,[ArGNA]AutoNAtic,3257,0,0,1,1,0.0%,23m
10415,3,[3DLANS]joyo,3256,606,266,238,504,52.8%,24m
10415,3,malice,3256,912,206,182,388,53.1%,42m
10415,3,PROTOSS,3256,1175,165,151,316,52.2%,14m
10415,3,[dtwist]DOMAH,3256,1569,110,103,213,51.6%,6m
10415,3,[GLP]Jah,3256,666,42,26,68,61.8%,26m
10415,3,[PRT]Tavo,3256,710,26,27,53,49.1%,15m
10415,3,[198019]JSKP,3256,424,23,23,46,50.0%,32m
10415,3,thebigzit,3256,352,15,13,28,53.6%,18m
10415,3,SMO,3256,349,14,7,21,66.7%,8m
10415,3,Snowman,3256,356,13,6,19,68.4%,39m
10415,3,[PobSC]ChicoCuagulo,3256,315,11,5,16,68.8%,3m
10415,3,sekondChoice,3256,148,5,6,11,45.5%,3m
10415,3,[Flar3s]LrdCraniaL,3256,116,4,5,9,44.4%,3m
10415,3,[lLiTl]Acey,3256,60,3,1,4,75.0%,31m
10415,2,[N1GO]SloppyMayor,3256,0,3,2,5,60.0%,7m
10415,3,Mulletface,3256,64,2,10,12,16.7%,3m
10415,3,[RUMB]VippiN,3256,0,1,0,1,100.0%,31m
10415,3,Douglie,3256,0,1,0,1,100.0%,17m
10415,3,BGBOY,3256,0,0,1,1,0.0%,43m
10415,3,[hTx]DiOrcus,3256,0,0,2,2,0.0%,11m
10415,3,[ExcIgN]Raiter,3256,0,0,7,7,0.0%,39m
10436,3,Saitama,3255,1603,181,161,342,52.9%,7m
10436,3,Dracarys,3255,1513,170,144,314,54.1%,28m
10436,3,[NIF]Funjunky,3255,1544,149,153,302,49.3%,11m
10436,3,PoisonBird,3255,1285,126,116,242,52.1%,41m
10436,3,Riaz,3255,1493,125,109,234,53.4%,17m
10436,3,Andromedus,3255,1572,114,94,208,54.8%,43m
10436,3,Dmo,3255,1562,79,81,160,49.4%,10m
10436,2,ASSHQLEisbak,3255,1448,68,70,138,49.3%,19m
10436,3,[FIow]Synergyst,3255,602,23,23,46,50.0%,6m
10436,3,[Korps]SupaFly,3255,363,14,5,19,73.7%,14m
10436,3,Macheji,3255,303,14,7,21,66.7%,15m
10436,3,Faceless,3255,264,8,4,12,66.7%,17m
10436,3,[Dicboy]Mannheim,3255,184,6,16,22,27.3%,5m
10436,3,Psyber,3255,116,5,7,12,41.7%,17m
10436,3,Gerard,3255,146,4,3,7,57.1%,15m
10436,3,[FlagJP]Mathtack,3255,113,3,1,4,75.0%,41m
10436,3,OpWaNaGeThY,3255,30,2,1,3,66.7%,3m
10436,3,[UberEL]Catfish,3255,53,2,4,6,33.3%,29m
10436,3,Adapt,3255,0,1,0,1,100.0%,39m
10436,3,MiKa,3255,0,0,1,1,0.0%,15m
10456,3,Infinity,3254,1126,63,43,106,59.4%,37m
10456,3,StupidProbe,3254,1006,58,47,105,55.2%,41m
10456,3,[Shang]Killa,3254,1156,54,62,116,46.6%,32m
10456,3,Winner,3254,1224,52,38,90,57.8%,23m
10456,3,Necrotic,3254,951,36,33,69,52.2%,36m
10456,3,Chozo,3254,656,28,20,48,58.3%,28m
10456,3,Jzaan,3254,451,20,31,51,39.2%,9m
10456,3,GNS,3254,509,18,19,37,48.6%,27m
10456,3,MyDadLeft,3254,340,11,16,27,40.7%,31m
10456,3,Spring,3254,245,8,8,16,50.0%,29m
10456,3,Tettarus,3254,172,6,6,12,50.0%,12m
10456,3,[KGH]smoOthster,3254,217,6,11,17,35.3%,26m
10456,3,FANATICK,3254,0,4,1,5,80.0%,18m
10456,3,GuywithGUNZ,3254,114,4,3,7,57.1%,26m
10456,3,Seikabutsu,3254,59,3,2,5,60.0%,15m
10456,3,eschelon,3254,60,3,4,7,42.9%,10m
10456,2,[CR100]SubSeven,3254,0,1,0,1,100.0%,12m
10456,3,DaRealDeal,3254,0,1,0,1,100.0%,32m
10456,3,piglal,3254,0,1,1,2,50.0%,39m
10456,3,sacred,3254,0,0,1,1,0.0%,18m
10456,2,RandyBeans,3254,0,0,4,4,0.0%,36m
10456,1,[O5HIT]bondca,3254,0,0,6,6,0.0%,2h
10478,3,KwiefHits,3253,1185,539,529,1068,50.5%,6m
10478,3,Auraphauna,3253,1447,68,65,133,51.1%,36m
10478,3,[LAMDA]Lezber,3253,1481,62,67,129,48.1%,18m
10478,3,HotKeyPlayer,3253,906,52,20,72,72.2%,17m
10478,3,Lebigduck,3253,637,24,26,50,48.0%,6m
10478,3,EATKIMCHPLZ,3253,474,20,11,31,64.5%,23m
10478,3,[SkBn]SikutoR,3253,285,18,17,35,51.4%,22m
10478,3,WeNoTrumpWon,3253,252,17,27,44,38.6%,40m
10478,3,[LowIQ]GetSmacked,3253,332,11,14,25,44.0%,6m
10478,3,Cinnamonlrv,3253,236,9,10,19,47.4%,26m
10478,3,[7C]Steve,3253,152,6,9,15,40.0%,17m
10478,2,Othail,3253,48,5,2,7,71.4%,24m
10478,3,Barcode,3253,0,4,0,4,100.0%,7m
10478,3,BlueBalls,3253,0,4,1,5,80.0%,27m
10478,2,Rage,3253,0,2,1,3,66.7%,2h
10478,3,[KingSC]POPO,3253,0,1,0,1,100.0%,37m
10478,3,CHILI,3253,0,1,1,2,50.0%,40m
10478,3,NotAGlassCan,3253,92,1,1,2,50.0%,41m
10478,3,[A5]JunLong,3253,30,1,1,2,50.0%,11m
10478,3,[CSK]Blakey,3253,30,1,3,4,25.0%,20m
10478,2,[BIGSTD]Syphilis,3253,0,0,1,1,0.0%,24m
10478,3,Eun,3253,0,0,1,1,0.0%,16m
10478,3,marteaux,3253,0,0,1,1,0.0%,39m
10478,3,zerg,3253,0,0,1,1,0.0%,14m
10478,3,[Lp]DarkChris,3253,0,0,2,2,0.0%,41m
10503,3,[Flam3s]Rivenscryr,3252,671,144,146,290,49.7%,33m
10503,3,[RBTH]Charlie,3252,1503,94,89,183,51.4%,17m
10503,3,Shmelyfinger,3252,1220,54,41,95,56.8%,31m
10503,3,[AiMB]ASH,3252,402,15,16,31,48.4%,6m
10503,3,[GMBRs]GANK,3252,430,15,18,33,45.5%,32m
10503,3,[NextDC]Lanzelot,3252,258,14,12,26,53.8%,32m
10503,3,MastaRoyal,3252,290,10,4,14,71.4%,32m
10503,3,GameStrength,3252,224,8,11,19,42.1%,36m
10503,3,[Ash3s]Halipeno,3252,90,7,4,11,63.6%,15m
10503,3,Death,3252,108,7,5,12,58.3%,19m
10503,3,lllllllIIIIl,3252,60,6,3,9,66.7%,23m
10503,3,HASSIUM,3252,0,5,0,5,100.0%,43m
10503,3,Wreck,3252,114,5,2,7,71.4%,21m
10503,2,[BeSuzy]ARAGONK,3252,40,2,3,5,40.0%,10m
10503,3,Bubba,3252,0,1,0,1,100.0%,12m
10503,3,Yuzu,3252,0,1,0,1,100.0%,15m
10503,3,[DugNut]BgDrtyBonjwa,3252,0,1,0,1,100.0%,9m
10503,3,RavenHex,3252,0,1,0,1,100.0%,27m
10503,3,NastyNugs,3252,0,0,1,1,0.0%,12m
10503,3,[UpxV]ramper,3252,0,0,1,1,0.0%,26m
10503,3,TYTY,3252,0,0,1,1,0.0%,11m
10524,3,WuttaRichard,3251,1484,138,141,279,49.5%,12m
10524,3,BadGateway,3251,1539,118,109,227,52.0%,11m
10524,3,Spazmo,3251,842,59,53,112,52.7%,14m
10524,3,[GOPERÚ]lllllllllll,3251,813,35,22,57,61.4%,25m
10524,3,StixZadinia,3251,544,17,31,48,35.4%,3m
10524,3,Avallach,3251,366,15,16,31,48.4%,15m
10524,3,Neechay,3251,298,14,9,23,60.9%,21m
10524,3,Peej,3251,307,12,15,27,44.4%,17m
10524,2,Picard,3251,182,10,14,24,41.7%,20m
10524,3,ilovekitkat,3251,58,3,2,5,60.0%,25m
10524,3,[IlIII]Hasuta,3251,86,3,4,7,42.9%,11m
10524,3,GroinShark,3251,30,2,3,5,40.0%,10m
10524,3,[Wehavu]Frizzle,3251,30,1,1,2,50.0%,15m
10524,3,Emperor,3251,0,1,1,2,50.0%,11m
10524,3,[aSALTu]FallenSaints,3251,0,0,1,1,0.0%,15m
10524,3,Tattersail,3251,0,0,2,2,0.0%,26m
10540,3,chem,3250,1274,202,176,378,53.4%,25m
10540,3,[GOPERÚ]Time,3250,1239,190,184,374,50.8%,23m
10540,3,Jezzalenko,3250,871,117,102,219,53.4%,17m
10540,3,kobebest,3250,1304,49,55,104,47.1%,25m
10540,3,wushwush,3250,769,36,29,65,55.4%,39m
10540,3,PMAN,3250,894,32,40,72,44.4%,31m
10540,3,Calcifer,3250,499,30,28,58,51.7%,31m
10540,3,Aeon,3250,546,27,23,50,54.0%,22m
10540,2,OrganEyes,3250,864,27,56,83,32.5%,15m
10540,3,BadPlayer,3250,553,24,15,39,61.5%,8m
10540,3,[eznore]KDT,3250,479,17,23,40,42.5%,31m
10540,3,[Fir3s]HomeTownCrib,3250,308,12,9,21,57.1%,18m
10540,3,[PINGON]estafadnegro,3250,322,11,7,18,61.1%,20m
10540,3,Motamus,3250,173,6,4,10,60.0%,24m
10540,3,[Kusshh]Chiu,3250,142,6,6,12,50.0%,12m
10540,2,TossboySYF,3250,0,4,1,5,80.0%,2h
10540,2,deamonoxmage,3250,0,4,1,5,80.0%,3h
10540,1,Shinch,3250,96,3,2,5,60.0%,11m
10540,3,Zhies,3250,0,1,0,1,100.0%,10m
10540,3,GeardFord,3250,0,1,1,2,50.0%,28m
10540,2,Brofish,3250,0,1,2,3,33.3%,1h
10540,3,omgitsduane,3250,30,1,4,5,20.0%,20m
10540,3,RonKing,3250,0,0,1,1,0.0%,11m
10540,3,mhobbit,3250,0,0,1,1,0.0%,12m
10540,3,[DarkAG]MicroJackson,3250,0,0,2,2,0.0%,35m
10540,3,[Italis]ttime,3250,0,0,4,4,0.0%,17m
10566,3,GuiltySpark,3249,1569,233,223,456,51.1%,35m
10566,3,MysterY,3249,759,54,48,102,52.9%,25m
10566,3,Gary,3249,352,33,20,53,62.3%,17m
10566,3,KnightCX,3249,371,23,25,48,47.9%,18m
10566,3,HellFat,3249,400,14,13,27,51.9%,19m
10566,3,Ducken,3249,233,10,6,16,62.5%,32m
10566,3,Cronodynamic,3249,114,6,4,10,60.0%,14m
10566,2,DVE,3249,183,5,4,9,55.6%,8m
10566,2,[EzyPzY]Balance,3249,139,4,2,6,66.7%,31m
10566,3,[GuaPi]Rionash,3249,60,2,5,7,28.6%,14m
10566,2,tgood,3249,91,1,1,2,50.0%,42m
10577,3,ShipWreack,3248,1607,118,114,232,50.9%,42m
10577,3,MeusPesames,3248,1150,59,27,86,68.6%,7m
10577,3,awker,3248,427,45,41,86,52.3%,43m
10577,3,[DarkAG]cbearfresh,3248,962,39,34,73,53.4%,19m
10577,3,GauchoBagual,3248,439,19,20,39,48.7%,23m
10577,3,SpartanGhost,3248,283,9,8,17,52.9%,37m
10577,3,Gandalf,3248,0,4,1,5,80.0%,15m
10577,3,MoYu,3248,0,4,1,5,80.0%,8m
10577,3,Richardt,3248,30,2,4,6,33.3%,24m
10577,3,Bunchydoor,3248,0,1,0,1,100.0%,6m
10577,3,Shadowstorm,3248,0,1,0,1,100.0%,7m
10577,3,bowsting,3248,0,1,0,1,100.0%,32m
10577,3,[SCboys]LoveXN,3248,89,1,3,4,25.0%,15m
10577,3,doublespace,3248,0,0,1,1,0.0%,12m
10577,3,[VFam]Isosceles,3248,0,0,1,1,0.0%,24m
10592,3,sLOwLy,3247,1060,98,75,173,56.6%,27m
10592,3,PERROBRUJO,3247,1444,87,88,175,49.7%,9m
10592,3,balls,3247,1080,45,48,93,48.4%,31m
10592,3,EmSO,3247,972,38,34,72,52.8%,25m
10592,3,[yBooT]JanJan,3247,621,32,27,59,54.2%,7m
10592,3,serg,3247,456,23,8,31,74.2%,37m
10592,3,[SFUSC]MingA,3247,479,18,14,32,56.2%,20m
10592,3,[Tripod]Albert,3247,337,16,10,26,61.5%,4m
10592,3,GLOG,3247,324,16,13,29,55.2%,21m
10592,3,Incognita,3247,166,7,2,9,77.8%,6m
10592,3,ratz,3247,170,7,4,11,63.6%,23m
10592,3,boboo,3247,94,6,0,6,100.0%,23m
10592,3,[heroez]GOSpheNiX,3247,124,5,6,11,45.5%,12m
10592,1,MORPHEUS,3247,144,2,2,4,50.0%,3h
10592,3,[AchroA]AchromicWht,3247,60,2,2,4,50.0%,14m
10592,3,[QTclub]GenghisSwan,3247,58,2,3,5,40.0%,7m
10592,1,[hTs]theLiminator,3247,0,0,1,1,0.0%,2h
10609,3,tMpistolpete,3246,1558,255,257,512,49.8%,21m
10609,2,MarquitosGG,3246,1555,171,171,342,50.0%,10m
10609,3,PleaseCheese,3246,1431,115,101,216,53.2%,35m
10609,3,[TSRz]Crownless,3246,1091,115,103,218,52.8%,41m
10609,3,snakeson,3246,1557,87,73,160,54.4%,25m
10609,3,[VKGs]GoodDeath,3246,559,83,75,158,52.5%,17m
10609,3,Keyli,3246,1444,63,55,118,53.4%,25m
10609,3,[57717]SolemnWookie,3246,846,42,16,58,72.4%,21m
10609,2,Badloss,3246,632,28,30,58,48.3%,11m
10609,3,PURGE,3246,422,16,14,30,53.3%,17m
10609,3,eclipser,3246,228,9,7,16,56.2%,5m
10609,3,[SHAFT]ProToAsT,3246,255,8,6,14,57.1%,17m
10609,3,PigFan,3246,30,4,2,6,66.7%,18m
10609,2,[TXA]BusinessCat,3246,46,3,1,4,75.0%,24m
10609,3,[4Grush]Scodelario,3246,88,3,12,15,20.0%,20m
10609,3,[DEADX]DOS,3246,0,1,0,1,100.0%,37m
10625,2,[JaMiT]SickJameS,3245,1466,358,371,729,49.1%,30m
10625,3,[Havoc1]Hamster,3245,1579,354,352,706,50.1%,15m
10625,2,SmokeDro,3245,1505,200,199,399,50.1%,7m
10625,3,MrGlassAnkle,3245,511,67,55,122,54.9%,35m
10625,3,CanadianBakn,3245,551,24,16,40,60.0%,22m
10625,3,GimpyMcLimp,3245,474,20,16,36,55.6%,8m
10625,3,[OvrDsd]MikeU,3245,228,9,7,16,56.2%,4m
10625,3,NiC,3245,90,7,4,11,63.6%,26m
10625,3,BuildAWall,3245,174,6,8,14,42.9%,43m
10625,3,Mengsk,3245,118,5,3,8,62.5%,6m
10625,3,[TPGGXD]Kilpinga,3245,126,4,0,4,100.0%,41m
10625,3,TWillG,3245,0,1,0,1,100.0%,3m
10625,3,XelKira,3245,0,1,0,1,100.0%,40m
10625,3,BigSmoke,3245,30,1,4,5,20.0%,20m
10625,3,JoffreyCones,3245,0,0,1,1,0.0%,27m
10625,3,[ZTemps]Oloyii,3245,0,0,6,6,0.0%,11m
10641,3,KingsnO,3244,1398,376,352,728,51.6%,26m
10641,3,[UberAw]Jimmy,3244,1363,119,124,243,49.0%,36m
10641,3,Killua,3244,1558,117,119,236,49.6%,26m
10641,3,Zem,3244,712,39,26,65,60.0%,17m
10641,3,sactun,3244,146,6,8,14,42.9%,12m
10641,3,Kimaring,3244,0,4,1,5,80.0%,24m
10641,3,[MOBOZ]Axiom,3244,117,3,3,6,50.0%,3m
10641,3,Mathias,3244,30,3,4,7,42.9%,28m
10641,1,IIIIIIIIIIII,3244,0,0,1,1,0.0%,2h
10650,3,Gorgoron,3243,1552,293,276,569,51.5%,24m
10650,3,Calvin,3243,705,93,90,183,50.8%,22m
10650,3,[Exper]ERICK,3243,1011,52,50,102,51.0%,31m
10650,3,Grinya,3243,575,21,21,42,50.0%,21m
10650,3,[TeaPI]Saj,3243,240,10,4,14,71.4%,28m
10650,3,ATMACS,3243,198,7,6,13,53.8%,35m
10650,2,[UI]ihowardlin,3243,0,5,0,5,100.0%,2h
10650,3,MuscleMilk,3243,0,5,0,5,100.0%,30m
10650,2,IIIIIIIIIIII,3243,0,4,1,5,80.0%,2h
10650,3,[PTHero]Neutralis,3243,60,3,4,7,42.9%,10m
10650,3,[MCSC]Chasmic,3243,0,2,3,5,40.0%,31m
10650,3,[ZTempz]Nosetham,3243,30,1,1,2,50.0%,42m
10650,3,CLiu,3243,0,0,1,1,0.0%,12m
10663,3,Gordon,3242,1525,325,319,644,50.5%,6m
10663,3,[VOLKDS]soulas,3242,1032,60,38,98,61.2%,23m
10663,3,LoriLoughlin,3242,1065,52,35,87,59.8%,26m
10663,3,YUMC,3242,175,8,4,12,66.7%,23m
10663,3,[Ec0s]ToxicGenius,3242,96,3,12,15,20.0%,7m
10663,3,Rage,3242,58,2,4,6,33.3%,10m
10663,3,EazyE,3242,62,2,5,7,28.6%,32m
10663,3,[GEEKED]Oglop,3242,0,0,1,1,0.0%,7m
10663,3,Fang,3242,0,0,2,2,0.0%,36m
10663,2,SToRm,3242,0,0,5,5,0.0%,1h
10673,3,ThoughtEater,3241,1423,115,110,225,51.1%,26m
10673,3,miegog,3241,1522,103,101,204,50.5%,3m
10673,3,ENDERWIGGIN,3241,530,41,35,76,53.9%,21m
10673,3,NoMad,3241,641,25,19,44,56.8%,12m
10673,3,GEANTOR,3241,580,22,20,42,52.4%,32m
10673,3,[MCSVG]Arreidem,3241,318,14,16,30,46.7%,5m
10673,3,[1234SC]BoopieBlast,3241,291,12,9,21,57.1%,7m
10673,3,PEDROLANE,3241,185,5,6,11,45.5%,6m
10673,3,FlyingZipper,3241,30,2,3,5,40.0%,20m
10673,3,Tweeter,3241,0,1,0,1,100.0%,23m
10673,3,MiTCologne,3241,0,1,2,3,33.3%,20m
10673,3,[NFL]TheConqueror,3241,0,0,3,3,0.0%,17m
10685,3,jono,3240,1597,74,84,158,46.8%,4m
10685,3,[soypro]cangre,3240,964,43,32,75,57.3%,19m
10685,3,[TSØP]GosuGhost,3240,830,33,40,73,45.2%,40m
10685,3,[SloShk]RLK,3240,747,32,24,56,57.1%,35m
10685,3,Chaos,3240,489,21,9,30,70.0%,23m
10685,3,[Lowko]Artanis,3240,434,17,15,32,53.1%,3m
10685,3,[TheRs]vis,3240,156,14,4,18,77.8%,37m
10685,3,BYBY,3240,271,12,7,19,63.2%,40m
10685,3,RedFm,3240,207,7,1,8,87.5%,21m
10685,3,[DHZ0ne]Excallybur,3240,184,7,10,17,41.2%,11m
10685,2,Amnesia,3240,0,4,1,5,80.0%,2h
10685,2,Bratkuchen,3240,90,2,0,2,100.0%,19m
10685,3,[GidBoy]AlbertaBeef,3240,30,2,2,4,50.0%,30m
10685,3,[DNKCFT]OhStephy,3240,0,1,0,1,100.0%,25m
10685,3,[GR33D]Zonex,3240,0,0,1,1,0.0%,32m
10685,3,Delta,3240,0,0,1,1,0.0%,23m
10701,3,Agrippa,3239,1566,114,99,213,53.5%,23m
10701,3,[AbcCo]peqaso,3239,1210,48,45,93,51.6%,14m
10701,3,[MERTZ]BetaStar,3239,628,40,36,76,52.6%,36m
10701,3,Infer,3239,976,39,35,74,52.7%,14m
10701,3,TouchMe,3239,633,28,19,47,59.6%,41m
10701,3,Skeetlump,3239,356,13,11,24,54.2%,39m
10701,3,Konfushus,3239,208,8,11,19,42.1%,30m
10701,3,[PNS]Tek,3239,140,6,2,8,75.0%,21m
10701,3,[CMBP]ZackalJackal,3239,114,5,3,8,62.5%,11m
10701,3,Rush,3239,30,4,5,9,44.4%,10m
10701,3,WirdNah,3239,144,3,3,6,50.0%,43m
10701,3,BouncyKnight,3239,90,3,3,6,50.0%,17m
10701,3,[GTMDSB]Rheinpw,3239,30,1,7,8,12.5%,18m
10714,3,[ValidG]MysterEWisp,3238,1291,71,81,152,46.7%,7m
10714,3,EnTaroTofu,3238,573,24,14,38,63.2%,19m
10714,3,[Emb3rs]Mania,3238,592,22,18,40,55.0%,9m
10714,3,Ajuran,3238,620,21,24,45,46.7%,33m
10714,3,[B1GDic]MajorLazer,3238,322,13,10,23,56.5%,19m
10714,1,KristyDisij,3238,278,12,10,22,54.5%,5m
10714,3,Berkoff,3238,203,5,14,19,26.3%,31m
10714,3,JimmyRecard,3238,0,4,1,5,80.0%,39m
10714,3,goodgame,3238,88,4,5,9,44.4%,7m
10714,3,Microman,3238,124,4,7,11,36.4%,6m
10714,3,[boatz]Freethinker,3238,49,4,14,18,22.2%,41m
10714,3,Terran,3238,137,3,4,7,42.9%,4m
10714,3,Elosai,3238,58,2,1,3,66.7%,6m
10727,3,ePatron,3237,1580,271,264,535,50.7%,7m
10727,3,WIN,3237,1082,82,74,156,52.6%,10m
10727,3,ManBearPig,3237,775,61,47,108,56.5%,30m
10727,3,Kre,3237,771,56,43,99,56.6%,19m
10727,3,xSPHxChill,3237,1101,45,40,85,52.9%,30m
10727,3,dripallszn,3237,349,31,35,66,47.0%,3m
10727,3,[MDCo]siskel,3237,712,26,36,62,41.9%,9m
10727,3,[Doct]DocZed,3237,282,9,9,18,50.0%,14m
10727,1,Titan,3237,212,8,4,12,66.7%,30m
10727,3,LANDA,3237,146,5,10,15,33.3%,23m
10727,3,iLEIF,3237,0,4,1,5,80.0%,39m
10727,3,[WNTRLY]Athol,3237,30,1,2,3,33.3%,26m
10727,3,Talo,3237,0,0,1,1,0.0%,7m
10727,2,[SOFA]Drayne,3237,0,0,1,1,0.0%,2h
10741,3,[FF7RM]barnaclejunk,3236,1415,173,159,332,52.1%,19m
10741,2,[iGOSU]liQuid,3236,1489,88,100,188,46.8%,14m
10741,2,Kerensky,3236,842,61,72,133,45.9%,5m
10741,3,rabbied,3236,1167,59,47,106,55.7%,30m
10741,3,SkY,3236,843,36,28,64,56.2%,30m
10741,3,[ROnSC]Syre,3236,833,33,32,65,50.8%,23m
10741,3,[IMDSI]ArkMico,3236,373,29,28,57,50.9%,32m
10741,3,[Chibii]BloodOrange,3236,538,24,10,34,70.6%,18m
10741,3,[LATERs]EAGames,3236,514,23,19,42,54.8%,7m
10741,3,yOkai,3236,590,21,20,41,51.2%,19m
10741,3,[FROMOZ]Nitro,3236,377,14,20,34,41.2%,15m
10741,3,[R00KS]CAPTAIN,3236,296,11,5,16,68.8%,23m
10741,1,LearnTerran,3236,164,8,1,9,88.9%,1h
10741,3,Beren,3236,234,8,19,27,29.6%,19m
10741,2,Life,3236,0,4,0,4,100.0%,2h
10741,3,Bars,3236,86,3,3,6,50.0%,24m
10741,3,[Jointz]MacroMaster,3236,30,2,1,3,66.7%,8m
10741,3,[DhZAc1]Zeusgf,3236,30,2,7,9,22.2%,10m
10741,1,FromParis,3236,0,0,1,1,0.0%,31m
10741,3,Fishy,3236,0,0,1,1,0.0%,12m
10761,3,Zmei,3235,1606,97,90,187,51.9%,20m
10761,2,Gumbo,3235,1472,64,72,136,47.1%,35m
10761,3,Burrito,3235,1147,60,34,94,63.8%,40m
10761,3,[OLDE]joaks,3235,904,34,33,67,50.7%,19m
10761,3,Cray,3235,522,19,16,35,54.3%,7m
10761,3,wbckulty,3235,324,13,9,22,59.1%,23m
10761,2,MJS,3235,247,10,8,18,55.6%,28m
10761,3,[AUNI]foREVer,3235,161,7,7,14,50.0%,30m
10761,3,Sedca,3235,180,6,15,21,28.6%,10m
10761,3,[Cryptc]SevenLions,3235,126,4,0,4,100.0%,4m
10761,3,[NotADr]PirateJet,3235,0,4,1,5,80.0%,25m
10761,2,[IIDA]FEIJÓO,3235,0,4,1,5,80.0%,2h
10761,3,Jmpzisbad,3235,0,1,0,1,100.0%,20m
10761,3,Malbolge,3235,0,1,2,3,33.3%,12m
10761,3,jaypow,3235,0,0,2,2,0.0%,33m
10761,3,[UpeV]SrPipeneisho,3235,0,0,2,2,0.0%,27m
10777,3,[LCE]Draco,3234,1428,117,111,228,51.3%,4m
10777,3,TROLLMAN,3234,1565,116,98,214,54.2%,11m
10777,3,LustRanja,3234,1579,95,79,174,54.6%,15m
10777,3,ItsDaewoo,3234,637,51,48,99,51.5%,40m
10777,3,[INextI]Skyder,3234,141,9,11,20,45.0%,32m
10777,3,Amaryllis,3234,114,5,3,8,62.5%,23m
10777,3,Lelouch,3234,86,3,5,8,37.5%,27m
10777,3,Tronsticky,3234,58,2,6,8,25.0%,19m
10777,3,jabs,3234,0,1,0,1,100.0%,33m
10777,3,Huitza,3234,0,1,0,1,100.0%,19m
10777,3,llllllllllll,3234,0,1,1,2,50.0%,15m
10777,3,yeeyoo,3234,0,0,1,1,0.0%,36m
10777,1,Conejo,3234,0,0,1,1,0.0%,23m
10790,3,JRH,3233,1478,188,167,355,53.0%,11m
10790,3,[αXLa]Nocturnal,3233,1553,99,97,196,50.5%,25m
10790,3,Tobi,3233,704,27,26,53,50.9%,6m
10790,3,Buttface,3233,345,19,16,35,54.3%,19m
10790,3,WorkWork,3233,144,10,3,13,76.9%,25m
10790,3,[VFam]Rayvn,3233,182,7,13,20,35.0%,35m
10790,3,[CITM]NightTiMe,3233,122,5,7,12,41.7%,36m
10790,3,BiGBoY,3233,133,3,1,4,75.0%,31m
10790,3,[LFUT]Alexis,3233,58,3,1,4,75.0%,10m
10790,3,[weFish]YoloSwaggins,3233,172,3,6,9,33.3%,41m
10790,3,MadeYouLook,3233,0,2,6,8,25.0%,19m
10790,3,[HPOT]Renaissance,3233,0,1,1,2,50.0%,8m
10790,3,MineMasters,3233,30,1,3,4,25.0%,6m
10803,3,Sounder,3232,874,264,245,509,51.9%,10m
10803,3,[killpp]Bloodinface,3232,1454,108,106,214,50.5%,42m
10803,3,iTALiANiiCE,3232,1299,58,66,124,46.8%,12m
10803,2,Smith,3232,830,51,59,110,46.4%,8m
10803,3,Epsilon,3232,887,49,43,92,53.3%,6m
10803,3,Cobra,3232,1077,46,30,76,60.5%,27m
10803,3,sdf,3232,438,15,17,32,46.9%,26m
10803,3,[WPiggy]TheOneSmurf,3232,0,4,1,5,80.0%,23m
10803,2,Draycop,3232,0,4,1,5,80.0%,2h
10803,3,Duffman,3232,94,3,3,6,50.0%,23m
10803,3,Kurare,3232,58,3,3,6,50.0%,14m
10803,3,[TSØP]Denexuz,3232,58,2,1,3,66.7%,30m
10803,3,[SLAPD]AscenT,3232,58,2,1,3,66.7%,30m
10803,3,[Pharoh]JoMaC,3232,0,1,0,1,100.0%,12m
10803,1,Darkfurios,3232,0,0,2,2,0.0%,10m
10803,3,[EZDUNK]GuyInTheChat,3232,0,0,3,3,0.0%,27m
10803,3,[KELLY]Kelly,3232,0,0,5,5,0.0%,37m
10820,3,rookie,3231,1615,442,418,860,51.4%,21m
10820,3,TheGame,3231,1257,237,236,473,50.1%,19m
10820,2,hsecurity,3231,785,55,48,103,53.4%,43m
10820,3,aleKSander,3231,414,14,16,30,46.7%,43m
10820,3,[SuperZ]Cloverfield,3231,216,11,3,14,78.6%,35m
10820,3,CERC,3231,191,5,2,7,71.4%,18m
10820,3,[Elings]Vous,3231,142,5,4,9,55.6%,20m
10820,3,DNO,3231,146,5,7,12,41.7%,21m
10820,3,[RushA]SuperKingdom,3231,30,2,1,3,66.7%,21m
10820,3,Asberic,3231,30,1,4,5,20.0%,6m
10820,3,ZenKraken,3231,30,1,5,6,16.7%,3m
10820,3,LuckyOwl,3231,0,0,1,1,0.0%,10m
10832,3,UWBADGERS,3230,1505,428,410,838,51.1%,4m
10832,3,[JRT]DrCacho,3230,1500,80,71,151,53.0%,26m
10832,3,KaiGreene,3230,723,71,39,110,64.5%,6m
10832,3,[DNKCFT]Aerialace,3230,564,21,19,40,52.5%,18m
10832,3,Nachito,3230,546,18,25,43,41.9%,4m
10832,3,[ØÛ]Skull,3230,370,13,8,21,61.9%,17m
10832,3,scotty,3230,100,8,6,14,57.1%,22m
10832,3,Kaiser,3230,184,7,6,13,53.8%,11m
10832,2,jubadubwub,3230,0,4,1,5,80.0%,39m
10832,3,[SoaP42]Pie,3230,0,1,2,3,33.3%,10m
10832,3,[SBLAC]IIIIIII,3230,0,0,1,1,0.0%,43m
10832,3,Graham,3230,0,0,2,2,0.0%,41m
10832,3,thulstein,3230,0,0,5,5,0.0%,6m
10845,3,[PERUOP]TheDoctor,3229,1547,137,130,267,51.3%,7m
10845,3,hydro,3229,1126,127,113,240,52.9%,18m
10845,3,SilentDeath,3229,1417,74,55,129,57.4%,15m
10845,3,[SBFS]Zread,3229,1168,46,45,91,50.5%,7m
10845,3,[Hakir0]Infarto,3229,986,42,31,73,57.5%,18m
10845,3,[OD2019]sTatToN,3229,364,18,18,36,50.0%,8m
10845,3,Tempestor,3229,181,12,17,29,41.4%,35m
10845,3,psycho,3229,247,11,1,12,91.7%,41m
10845,3,[SuperZ]Meat,3229,332,11,8,19,57.9%,23m
10845,3,Eskimofö,3229,97,8,4,12,66.7%,22m
10845,3,HANS,3229,123,6,2,8,75.0%,41m
10845,3,LongJohnson,3229,157,5,1,6,83.3%,12m
10845,3,DreamX,3229,60,3,2,5,60.0%,7m
10845,3,[MLU]jason,3229,60,3,4,7,42.9%,20m
10845,3,Shadowsun,3229,30,2,2,4,50.0%,22m
10845,3,LoveHate,3229,58,2,8,10,20.0%,10m
10845,3,Brotoss,3229,0,0,1,1,0.0%,6m
10845,3,[lendas]octavio,3229,0,0,1,1,0.0%,41m
10845,3,[chair]SuperKitty,3229,0,0,2,2,0.0%,22m
10845,2,Thanatos,3229,0,0,5,5,0.0%,2h
10865,2,[PeePz]MadeInChina,3228,1493,226,223,449,50.3%,8m
10865,3,Malupeyt,3228,650,24,22,46,52.2%,10m
10865,3,llllllllllll,3228,437,18,9,27,66.7%,17m
10865,3,StarRage,3228,436,17,10,27,63.0%,3m
10865,3,FrAnTwO,3228,315,15,10,25,60.0%,11m
10865,3,Dayman,3228,194,12,20,32,37.5%,37m
10865,3,Luck,3228,83,10,10,20,50.0%,21m
10865,3,MasonisHiga,3228,114,4,5,9,44.4%,38m
10865,1,oromeo,3228,136,3,4,7,42.9%,33m
10865,3,ShadowDragon,3228,58,3,5,8,37.5%,7m
10865,3,[MacrOP]NobleJBlaze,3228,0,1,0,1,100.0%,17m
10865,3,Polarbear,3228,30,1,1,2,50.0%,41m
10865,3,TemplarJez,3228,30,1,2,3,33.3%,29m
10865,3,[flyrev]flyrev,3228,0,1,4,5,20.0%,43m
10865,3,Thron,3228,0,0,6,6,0.0%,7m
10880,3,Brady,3227,1552,127,99,226,56.2%,24m
10880,3,who,3227,1609,119,101,220,54.1%,21m
10880,3,Rhotar,3227,1052,113,112,225,50.2%,31m
10880,3,[LSDX3]frijOlitO,3227,980,68,73,141,48.2%,25m
10880,3,Dolodiar,3227,849,54,34,88,61.4%,31m
10880,3,soren,3227,1163,52,54,106,49.1%,26m
10880,3,feebdaed,3227,1002,46,23,69,66.7%,31m
10880,3,[RevL]Eliezar,3227,955,42,33,75,56.0%,24m
10880,3,[BONCK]Nizuto,3227,782,36,43,79,45.6%,24m
10880,3,[Ever]TinkerJoe,3227,585,21,23,44,47.7%,17m
10880,3,[MxSC]Reaper,3227,334,13,12,25,52.0%,43m
10880,3,[BMGT]Modsoul,3227,318,11,6,17,64.7%,19m
10880,3,Ghost,3227,239,8,5,13,61.5%,23m
10880,3,esotericg,3227,174,7,8,15,46.7%,3m
10880,3,cowboy,3227,188,6,6,12,50.0%,31m
10880,3,KuJambrE,3227,0,5,0,5,100.0%,27m
10880,3,Alejandro,3227,94,4,2,6,66.7%,25m
10880,3,Drizzt,3227,150,4,4,8,50.0%,24m
10880,3,Rapture,3227,118,2,1,3,66.7%,21m
10880,3,[LaDn]ZERATUL,3227,30,2,2,4,50.0%,26m
10880,3,Puff,3227,60,2,2,4,50.0%,16m
10880,3,Scarfoo,3227,58,2,6,8,25.0%,14m
10880,3,ThePaleKing,3227,0,1,0,1,100.0%,16m
10880,3,Cookie,3227,0,1,0,1,100.0%,29m
10880,1,Adapt,3227,91,1,1,2,50.0%,38m
10880,3,Witty,3227,30,1,4,5,20.0%,17m
10880,3,gotaprobelem,3227,0,0,1,1,0.0%,24m
10880,2,[Pton]Deathenator,3227,0,0,5,5,0.0%,4m
10908,3,NullObject,3226,1636,318,302,620,51.3%,10m
10908,3,Louis,3226,1624,149,136,285,52.3%,41m
10908,3,[ICBA]Younglin,3226,644,26,26,52,50.0%,41m
10908,3,Barcode,3226,306,18,24,42,42.9%,6m
10908,3,Zero,3226,322,14,8,22,63.6%,12m
10908,3,Loris,3226,255,13,12,25,52.0%,4m
10908,3,YangGang,3226,128,5,12,17,29.4%,19m
10908,2,CreepDead,3226,0,4,1,5,80.0%,2h
10908,3,Drcesar,3226,0,1,0,1,100.0%,39m
10908,3,Calcifer,3226,30,1,5,6,16.7%,41m
10908,3,KrapTacular,3226,0,0,1,1,0.0%,28m
10919,3,aris,3225,1083,81,74,155,52.3%,31m
10919,3,[EvilGC]Dmentor,3225,912,43,51,94,45.7%,37m
10919,2,[Cart]Preposterous,3225,310,12,8,20,60.0%,12m
10919,3,avilo,3225,340,11,18,29,37.9%,13m
10919,3,[AoBDE]Jupiter,3225,157,8,8,16,50.0%,7m
10919,2,driveahonda,3225,0,4,1,5,80.0%,1h
10919,3,IlIlllIllI,3225,122,4,11,15,26.7%,4m
10919,2,python,3225,0,2,3,5,40.0%,2h
10919,3,[Thanat]woderif,3225,60,2,4,6,33.3%,41m
10919,1,potato,3225,0,1,0,1,100.0%,30m
10919,3,[KiTeam]KiTScarleTT,3225,0,1,0,1,100.0%,13m
10919,3,Skye,3225,0,1,1,2,50.0%,18m
10919,3,[mocat]Sisu,3225,0,0,1,1,0.0%,31m
10919,3,Ivaro,3225,0,0,1,1,0.0%,32m
10919,3,NighTshade,3225,0,0,1,1,0.0%,39m
10919,3,[FSid3]Finch,3225,0,0,2,2,0.0%,18m
10935,3,SnowPython,3224,1397,127,125,252,50.4%,26m
10935,3,Halon,3224,1282,100,76,176,56.8%,31m
10935,3,[LAGGT]protthor,3224,1483,71,65,136,52.2%,10m
10935,3,[ZTemp]burn,3224,1145,63,58,121,52.1%,31m
10935,3,Nightmare,3224,1302,62,57,119,52.1%,24m
10935,3,Rastafarai,3224,579,25,15,40,62.5%,43m
10935,3,cryer,3224,321,24,15,39,61.5%,37m
10935,3,LiTrox,3224,248,12,5,17,70.6%,24m
10935,3,AngryEddie,3224,208,11,11,22,50.0%,24m
10935,3,Zahit,3224,275,9,5,14,64.3%,7m
10935,1,Halion,3224,164,7,3,10,70.0%,2h
10935,3,gambolano,3224,0,1,0,1,100.0%,12m
10935,1,KillerApe,3224,0,1,0,1,100.0%,18m
10935,3,[INextI]Gergy,3224,30,1,3,4,25.0%,18m
10935,3,Davastator,3224,0,0,2,2,0.0%,31m
10935,3,[FL9]Souljerr,3224,0,0,2,2,0.0%,26m
10935,3,lilSenpai,3224,0,0,2,2,0.0%,15m
10935,3,XxGamearayxX,3224,0,0,3,3,0.0%,27m
10953,3,cupcake,3223,898,57,37,94,60.6%,21m
10953,3,raziel,3223,840,33,31,64,51.6%,8m
10953,3,[APM999]Mark,3223,366,17,17,34,50.0%,33m
10953,3,Eliptic,3223,380,15,13,28,53.6%,13m
10953,3,[9thAve]ShoeBaD,3223,317,12,5,17,70.6%,12m
10953,3,Syncretic,3223,263,11,9,20,55.0%,15m
10953,3,[UpxV]goher,3223,151,11,11,22,50.0%,36m
10953,1,[Alpaka]Socky,3223,141,6,3,9,66.7%,2h
10953,2,Hellokitty,3223,0,5,0,5,100.0%,2h
10953,2,amrRamil,3223,94,5,1,6,83.3%,2h
10953,1,NasP,3223,141,5,2,7,71.4%,1h
10953,3,Hyperion,3223,118,5,8,13,38.5%,7m
10953,3,Mayhem,3223,58,3,0,3,100.0%,38m
10953,3,[Sc2Maf]KiMjongSkiLL,3223,112,3,2,5,60.0%,18m
10953,2,Odds,3223,132,3,5,8,37.5%,27m
10953,3,BrianZoubek,3223,30,2,2,4,50.0%,20m
10953,3,[Champs]RorK,3223,0,0,1,1,0.0%,11m
10953,3,Varentou,3223,0,0,1,1,0.0%,8m
10953,3,[TTT]chente,3223,0,0,7,7,0.0%,18m
10972,3,[TheB4d]MagicMushrom,3222,1144,199,191,390,51.0%,3m
10972,3,ablaze,3222,1529,100,93,193,51.8%,26m
10972,3,xTwilight,3222,1577,77,64,141,54.6%,6m
10972,3,[LGNxx]klanosk,3222,736,33,16,49,67.3%,25m
10972,3,ThePylonHoe,3222,569,26,21,47,55.3%,21m
10972,1,PhatCat,3222,508,17,36,53,32.1%,12m
10972,3,[PacheK]thedickdans,3222,404,15,13,28,53.6%,7m
10972,3,Hyo,3222,281,12,13,25,48.0%,26m
10972,3,JotaDe,3222,204,7,7,14,50.0%,3m
10972,3,Drax,3222,0,4,1,5,80.0%,32m
10972,2,jrkirby,3222,0,4,1,5,80.0%,4m
10972,3,Shredling,3222,139,4,1,5,80.0%,18m
10972,3,[M2A5]BEERGUYYYY,3222,30,2,1,3,66.7%,31m
10972,3,ShaCk,3222,0,1,0,1,100.0%,15m
10972,3,Jeatall,3222,0,1,0,1,100.0%,7m
10972,3,Ham,3222,30,1,1,2,50.0%,32m
10988,3,Whisper,3221,1528,67,57,124,54.0%,36m
10988,3,Winddrop,3221,599,65,58,123,52.8%,19m
10988,3,[fatb0i]stufffffs,3221,888,45,44,89,50.6%,38m
10988,3,desty,3221,573,36,35,71,50.7%,21m
10988,3,rittlewolf,3221,802,35,31,66,53.0%,27m
10988,3,[OKUMA]shinjp,3221,363,17,18,35,48.6%,22m
10988,3,filterblade,3221,514,17,22,39,43.6%,37m
10988,3,Falco,3221,209,9,5,14,64.3%,31m
10988,2,[RBTH]Soza,3221,278,8,7,15,53.3%,8m
10988,3,Actum,3221,150,6,5,11,54.5%,3m
10988,2,badmouse,3221,0,5,0,5,100.0%,1h
10988,3,EUrefugee,3221,0,4,1,5,80.0%,17m
10988,3,zakguo,3221,62,2,6,8,25.0%,12m
10988,2,sanZeNeX,3221,0,1,0,1,100.0%,28m
10988,3,YoussefJ,3221,30,1,5,6,16.7%,18m
10988,3,[GuN]Silas,3221,0,0,1,1,0.0%,21m
10988,3,[DRONGO]bega,3221,0,0,1,1,0.0%,18m
11005,3,Crisp,3220,1571,153,144,297,51.5%,33m
11005,3,Twasapug,3220,855,115,101,216,53.2%,38m
11005,2,[PISCO]CAPITAN,3220,1539,101,102,203,49.8%,31m
11005,3,[CHILN]Graytide,3220,566,77,63,140,55.0%,6m
11005,3,Bean,3220,1443,75,58,133,56.4%,6m
11005,3,Allrighting,3220,548,26,31,57,45.6%,40m
11005,3,[UDTna]JacDraco,3220,499,21,18,39,53.8%,29m
11005,3,JosephGonzV,3220,195,20,26,46,43.5%,20m
11005,3,[t0p9un]Goose,3220,180,6,8,14,42.9%,26m
11005,3,PoonHerder,3220,186,6,18,24,25.0%,10m
11005,3,Waloche,3220,0,4,1,5,80.0%,30m
11005,2,[Conway]gurakz,3220,0,4,2,6,66.7%,14m
11005,3,Young,3220,30,1,2,3,33.3%,6m
11005,1,ZMWP,3220,0,0,1,1,0.0%,3m
11005,3,[iGOSU]Losss,3220,0,0,1,1,0.0%,36m
11005,3,Draxyr,3220,0,0,2,2,0.0%,18m
11005,3,IceTech,3220,0,0,3,3,0.0%,31m
11005,3,[druqks]paradox,3220,0,0,4,4,0.0%,25m
11023,3,[GeM]Krimson,3219,978,99,75,174,56.9%,42m
11023,3,Faith,3219,1450,88,67,155,56.8%,14m
11023,3,ShadHunt,3219,1049,71,78,149,47.7%,36m
11023,3,froddparents,3219,1349,65,57,122,53.3%,43m
11023,3,[UpxV]MbretC,3219,1517,62,57,119,52.1%,6m
11023,3,ArtosisPylon,3219,379,23,23,46,50.0%,38m
11023,3,[ZTempz]SilentReaver,3219,396,15,16,31,48.4%,10m
11023,3,Posey,3219,352,12,17,29,41.4%,16m
11023,3,[Illapu]VIRACOCHA,3219,240,10,5,15,66.7%,41m
11023,3,jason,3219,165,9,3,12,75.0%,37m
11023,3,Jatlantis,3219,62,5,5,10,50.0%,37m
11023,3,[WHSc]navenitram,3219,58,3,2,5,60.0%,21m
11023,3,DeGreatest,3219,30,2,8,10,20.0%,15m
11023,3,toyorom,3219,0,0,1,1,0.0%,21m
11023,3,HighQ,3219,0,0,2,2,0.0%,6m
11038,3,BeachBoy,3218,1582,258,248,506,51.0%,7m
11038,3,Falafel,3218,1310,136,128,264,51.5%,8m
11038,3,[Lpaz]XaviiH,3218,1076,53,37,90,58.9%,19m
11038,3,MrFrodo,3218,175,23,17,40,57.5%,26m
11038,3,Mekstor,3218,374,16,8,24,66.7%,26m
11038,3,[SUNBRA]thatsjustice,3218,340,13,11,24,54.2%,12m
11038,3,[LoGiQ]Voges,3218,208,7,4,11,63.6%,40m
11038,3,RuFF,3218,0,5,0,5,100.0%,24m
11038,2,Vayne,3218,0,4,1,5,80.0%,1h
11038,3,Romeo,3218,48,4,8,12,33.3%,37m
11038,3,[TRNST]NOLOGY,3218,30,2,0,2,100.0%,31m
11038,3,[WaP]bewdah,3218,30,2,8,10,20.0%,11m
11038,3,Pokketz,3218,0,1,0,1,100.0%,29m
11038,3,[FatMom]edceeyy,3218,0,1,0,1,100.0%,27m
11038,3,Eremite,3218,30,1,1,2,50.0%,31m
11038,1,Toasty,3218,48,1,2,3,33.3%,37m
11038,3,Techno,3218,0,1,4,5,20.0%,31m
11038,3,Pheonix,3218,0,0,1,1,0.0%,3m
11038,3,Dordido,3218,0,0,1,1,0.0%,14m
11038,3,HowlandReed,3218,0,0,3,3,0.0%,30m
11058,2,hobbi,3217,1523,202,209,411,49.1%,22m
11058,3,[TGP]chadbrochill,3217,1491,167,165,332,50.3%,12m
11058,3,Nat,3217,1015,74,60,134,55.2%,13m
11058,3,KingOfKings,3217,1522,72,56,128,56.2%,18m
11058,3,skyG,3217,1048,52,43,95,54.7%,19m
11058,3,RaptorJeesus,3217,380,24,19,43,55.8%,18m
11058,3,[αXLa]KvrvTrewa,3217,470,17,16,33,51.5%,29m
11058,3,Stormrider,3217,218,12,6,18,66.7%,22m
11058,3,XCI,3217,216,11,6,17,64.7%,13m
11058,3,[B0oZ3]AleaIactaEst,3217,264,10,10,20,50.0%,35m
11058,3,[MoistB]skinnybenis,3217,60,3,3,6,50.0%,15m
11058,3,Ghost,3217,60,2,4,6,33.3%,11m
11058,3,Javo,3217,0,1,0,1,100.0%,15m
11058,3,SeveralDucks,3217,30,1,1,2,50.0%,26m
11058,3,pylons,3217,30,1,1,2,50.0%,20m
11058,1,RayShades,3217,0,1,1,2,50.0%,2h
11074,3,MadaFaka,3216,1493,103,90,193,53.4%,41m
11074,3,iTzXxxLimp,3216,1080,68,55,123,55.3%,30m
11074,3,vnmZor,3216,579,26,11,37,70.3%,16m
11074,3,[ÐMÐ]Orechron,3216,394,24,19,43,55.8%,6m
11074,3,PewPewPew,3216,389,15,7,22,68.2%,12m
11074,3,loveandmusic,3216,358,15,14,29,51.7%,6m
11074,3,MyThOs,3216,302,13,4,17,76.5%,23m
11074,3,NotACop,3216,350,12,16,28,42.9%,23m
11074,3,Zero,3216,236,8,4,12,66.7%,3m
11074,3,IIIIIIIIIIII,3216,124,6,2,8,75.0%,23m
11074,3,Denzille,3216,203,6,3,9,66.7%,15m
11074,3,[TGosuA]Boots,3216,137,5,2,7,71.4%,5m
11074,3,Matt,3216,140,5,4,9,55.6%,3m
11074,3,[AiMB]Rudolpho,3216,191,5,5,10,50.0%,36m
11074,1,qwertyui,3216,121,3,1,4,75.0%,3m
11074,3,Maclaren,3216,0,1,0,1,100.0%,41m
11074,3,[BuQiHM]ianianqq,3216,0,1,0,1,100.0%,23m
11074,3,[Yiiis]Snoman,3216,0,1,0,1,100.0%,32m
11074,3,hummusai,3216,0,0,2,2,0.0%,3m
11074,3,anpholeon,3216,0,0,3,3,0.0%,25m
11094,3,royliuboy,3215,1390,188,197,385,48.8%,7m
11094,3,[DhZAc1]Carpano,3215,590,151,129,280,53.9%,11m
11094,3,RakeEmUp,3215,526,142,141,283,50.2%,6m
11094,3,[Fokuri]PylonWizard,3215,688,111,103,214,51.9%,30m
11094,3,Zorba,3215,1541,72,56,128,56.2%,41m
11094,3,[GoPctm]Bari,3215,983,42,43,85,49.4%,36m
11094,3,[GOPERÚ]EDWINCQ,3215,438,21,12,33,63.6%,18m
11094,3,Zeusc,3215,212,11,4,15,73.3%,18m
11094,2,[sk3tch]Music,3215,249,10,9,19,52.6%,14m
11094,3,Anarchy,3215,201,9,5,14,64.3%,15m
11094,3,BallzDeep,3215,0,5,2,7,71.4%,14m
11094,3,[McPhe]Bijan,3215,0,4,1,5,80.0%,8m
11094,3,[Brunch]Zed,3215,30,1,1,2,50.0%,12m
11094,3,[SCPO]Rawr,3215,0,0,2,2,0.0%,16m
11094,3,[WRnbs]Renat,3215,0,0,2,2,0.0%,17m
11109,3,boxmander,3214,1340,192,178,370,51.9%,12m
11109,2,Zeolite,3214,1471,191,189,380,50.3%,22m
11109,3,[SALTDY]inEVItabLe,3214,1528,107,108,215,49.8%,30m
11109,3,GSLegacy,3214,579,25,14,39,64.1%,42m
11109,3,[Shalom]CremeBrulee,3214,566,25,17,42,59.5%,11m
11109,3,Tacobell,3214,265,23,20,43,53.5%,7m
11109,3,ROUGH,3214,374,19,28,47,40.4%,7m
11109,3,[cl0udM]aButtPirate,3214,485,17,27,44,38.6%,15m
11109,3,Zepp,3214,227,12,13,25,48.0%,36m
11109,3,[ZFC]Seb,3214,293,10,10,20,50.0%,25m
11109,3,tfarcrats,3214,135,7,3,10,70.0%,25m
11109,3,Kamyu,3214,173,7,6,13,53.8%,42m
11109,3,[lKoDl]Choreza,3214,220,6,5,11,54.5%,37m
11109,1,tarita,3214,216,5,7,12,41.7%,38m
11109,3,dreamx,3214,122,5,8,13,38.5%,21m
11109,3,Ryan,3214,90,4,2,6,66.7%,32m
11109,3,Orbion,3214,30,1,4,5,20.0%,22m
11109,3,[TeamLT]Manoch,3214,30,1,4,5,20.0%,25m
11127,3,[RogueW]DarkTemplar,3213,1349,251,217,468,53.6%,36m
11127,3,SnacK,3213,1645,95,67,162,58.6%,23m
11127,3,[FaO]TheBeesKnees,3213,1294,84,54,138,60.9%,8m
11127,3,friend,3213,1455,80,78,158,50.6%,23m
11127,3,[TheRs]Rynomasher,3213,1151,78,80,158,49.4%,40m
11127,3,Serfio,3213,636,28,21,49,57.1%,6m
11127,3,sevenOfour,3213,748,27,32,59,45.8%,30m
11127,3,[EvilGC]Leonidas,3213,582,22,25,47,46.8%,22m
11127,3,iamcomma,3213,368,15,12,27,55.6%,6m
11127,2,RYNSLYSDRGNS,3213,289,12,9,21,57.1%,14m
11127,3,Thanatos,3213,226,10,5,15,66.7%,12m
11127,3,supermage,3213,201,6,2,8,75.0%,26m
11127,3,[UpeV]ExegoL,3213,168,5,1,6,83.3%,6m
11127,3,RedMachine,3213,186,5,3,8,62.5%,26m
11127,3,[Pig2]DiVizioN,3213,0,3,2,5,60.0%,22m
11127,3,Garfunko,3213,0,0,1,1,0.0%,3m
11143,3,Octave,3212,1360,119,104,223,53.4%,36m
11143,3,ZeProzin,3212,694,113,83,196,57.7%,35m
11143,3,[TNBII]wzqwzq,3212,464,63,56,119,52.9%,16m
11143,3,Marjimmy,3212,440,19,16,35,54.3%,8m
11143,3,[No0Bs]Gintoki,3212,379,16,17,33,48.5%,11m
11143,3,MadMan,3212,343,14,11,25,56.0%,13m
11143,3,planetninex,3212,341,13,5,18,72.2%,23m
11143,3,CPA,3212,246,11,7,18,61.1%,39m
11143,3,KingBonobo,3212,202,7,9,16,43.8%,16m
11143,3,razE,3212,138,6,3,9,66.7%,10m
11143,3,Monkezzz,3212,0,5,3,8,62.5%,3m
11143,3,Moki,3212,60,2,2,4,50.0%,6m
11143,3,[R4NK3D]burn,3212,0,0,2,2,0.0%,16m
11143,3,FriendlyToss,3212,0,0,4,4,0.0%,23m
11157,1,llllllllllll,3211,1508,505,551,1056,47.8%,13m
11157,3,Milo,3211,1570,76,63,139,54.7%,16m
11157,3,[FalPal]Alchemy,3211,1457,70,63,133,52.6%,10m
11157,3,[iDrunk]xplicity,3211,978,59,52,111,53.2%,19m
11157,3,mmdkt,3211,681,48,50,98,49.0%,38m
11157,3,PingAite,3211,1083,47,31,78,60.3%,43m
11157,3,[DarkAG]LvlTwoNinja,3211,1040,41,36,77,53.2%,17m
11157,3,MUQUIWARA,3211,207,39,32,71,54.9%,18m
11157,3,IIIIIIIIIIII,3211,658,33,18,51,64.7%,4m
11157,3,Red,3211,321,28,22,50,56.0%,9m
11157,3,[xWoNx]new,3211,632,23,22,45,51.1%,3m
11157,3,orangepeel,3211,382,15,19,34,44.1%,19m
11157,3,ShadowDragon,3211,307,11,11,22,50.0%,3m
11157,3,[AreE]SiCkKenshin,3211,305,10,13,23,43.5%,4m
11157,3,MadeInQuebec,3211,90,7,5,12,58.3%,16m
11157,3,Windy,3211,184,6,0,6,100.0%,27m
11157,3,ChadRays,3211,144,6,7,13,46.2%,25m
11157,3,Sillyfoxy,3211,60,3,3,6,50.0%,12m
11157,3,IlIlIlIlIlIl,3211,30,2,2,4,50.0%,23m
11157,3,Winger,3211,60,2,3,5,40.0%,10m
11157,3,MaGestic,3211,0,1,1,2,50.0%,10m
11157,3,steve,3211,30,1,3,4,25.0%,7m
11157,3,Bondskill,3211,0,0,1,1,0.0%,3m
11157,3,[uwuSCA]xxxdethic,3211,0,0,1,1,0.0%,36m
11181,3,JoeStarman,3210,1522,62,55,117,53.0%,7m
11181,3,Yúgen,3210,965,49,32,81,60.5%,30m
11181,3,dreambeing,3210,912,43,31,74,58.1%,8m
11181,3,ANDRENCIO,3210,958,37,34,71,52.1%,26m
11181,3,[LBHS]Tebas,3210,768,33,22,55,60.0%,20m
11181,3,[TGCF]ace,3210,330,11,16,27,40.7%,33m
11181,2,Ret,3210,279,10,10,20,50.0%,34m
11181,3,SAIKI,3210,222,8,10,18,44.4%,25m
11181,2,[KUMS]BrainRapist,3210,165,6,3,9,66.7%,2h
11181,3,[lLiTl]WackoAssassi,3210,174,6,5,11,54.5%,8m
11181,3,EnolaGay,3210,120,5,6,11,45.5%,15m
11181,3,TSnake,3210,118,4,1,5,80.0%,25m
11181,3,FPV,3210,60,4,2,6,66.7%,18m
11181,1,[GangR]MattMac,3210,119,2,2,4,50.0%,1h
11181,3,Raul,3210,0,1,0,1,100.0%,10m
11181,3,[SPSC]Chalaza,3210,0,0,1,1,0.0%,9m
11181,3,Hardlinemonk,3210,0,0,2,2,0.0%,25m
11198,2,[RUSC]AviPT,3209,1320,450,448,898,50.1%,20m
11198,3,Drew,3209,1588,340,317,657,51.8%,43m
11198,3,[Xpk]YELSIN,3209,1511,236,223,459,51.4%,35m
11198,2,GromiT,3209,1206,91,96,187,48.7%,3m
11198,3,Chimera,3209,1165,79,78,157,50.3%,25m
11198,3,BigDaddy,3209,1553,77,76,153,50.3%,26m
11198,3,Luru,3209,488,64,23,87,73.6%,23m
11198,3,Phoenix,3209,942,64,69,133,48.1%,36m
11198,3,Raptor,3209,1046,41,38,79,51.9%,16m
11198,3,[GOPERÚ]irvin,3209,523,41,46,87,47.1%,36m
11198,3,[3shade]Wings,3209,268,11,9,20,55.0%,14m
11198,3,JukeLuke,3209,254,10,10,20,50.0%,10m
11198,3,[fagz]HarstemPupil,3209,212,7,2,9,77.8%,9m
11198,3,esSBee,3209,213,7,3,10,70.0%,12m
11198,1,[4DPS]Ana,3209,138,4,1,5,80.0%,31m
11198,3,[HARLET]SENJUxMIGUEL,3209,90,4,2,6,66.7%,36m
11198,3,[Lynn]Fair,3209,90,4,3,7,57.1%,26m
11198,3,BennyBoo,3209,118,4,7,11,36.4%,37m
11198,3,Scandalous,3209,83,3,3,6,50.0%,18m
11198,3,[PvZMa]KingCoN,3209,0,1,0,1,100.0%,12m
11198,3,[TESTI]Alvarofrk,3209,0,0,1,1,0.0%,33m
11219,3,Sebaroo,3208,1437,66,65,131,50.4%,5m
11219,3,BLEST,3208,888,47,14,61,77.0%,19m
11219,3,Koro,3208,882,35,30,65,53.8%,20m
11219,3,Raggant,3208,891,33,34,67,49.3%,8m
11219,3,[DHZ0ne]Pedra,3208,560,29,26,55,52.7%,37m
11219,3,Geezer,3208,722,25,36,61,41.0%,6m
11219,3,[Wutzu]croberts,3208,626,23,25,48,47.9%,21m
11219,3,[AXIOS]SimaYi,3208,312,17,15,32,53.1%,30m
11219,3,YanYan,3208,225,8,12,20,40.0%,13m
11219,3,[HaYn]Cario,3208,184,7,13,20,35.0%,12m
11219,3,renoB,3208,58,3,0,3,100.0%,20m
11219,3,Huszar,3208,0,1,0,1,100.0%,22m
11219,3,[SCmTS]unreaL,3208,0,1,0,1,100.0%,42m
11219,3,AristØcles,3208,0,0,1,1,0.0%,19m
11233,3,Wonderweiss,3207,336,55,42,97,56.7%,22m
11233,3,[Pig2]Kestrel,3207,488,38,46,84,45.2%,37m
11233,3,[SyLx]Bomber,3207,576,20,21,41,48.8%,17m
11233,3,jrdnRabbit,3207,458,16,27,43,37.2%,15m
11233,3,Pebo,3207,234,7,4,11,63.6%,29m
11233,3,[GRUMEC]ornstein,3207,182,5,3,8,62.5%,24m
11233,3,[αXLa]MCcardo,3207,120,5,7,12,41.7%,37m
11233,3,SHoCK,3207,165,4,2,6,66.7%,3m
11233,3,[qt]Mugen,3207,92,4,7,11,36.4%,4m
11233,3,yeeyoo,3207,119,3,0,3,100.0%,14m
11233,3,[X22]StarScream,3207,90,3,4,7,42.9%,37m
11233,3,[Ar4]Miyeon,3207,58,2,4,6,33.3%,3m
11233,3,PROTOSSLORD,3207,0,1,1,2,50.0%,17m
11233,3,[CLan12]GATO,3207,0,0,1,1,0.0%,3m
11233,3,Foozbond,3207,0,0,1,1,0.0%,33m
11233,3,[SBlock]Alan,3207,0,0,1,1,0.0%,23m
11249,3,Destroyer,3206,1224,129,130,259,49.8%,37m
11249,3,Jackal,3206,839,64,50,114,56.1%,23m
11249,3,homunculus,3206,1238,59,40,99,59.6%,25m
11249,3,[TwitcX]AminoX,3206,1075,58,18,76,76.3%,26m
11249,3,First,3206,814,53,57,110,48.2%,23m
11249,3,scraul,3206,868,52,42,94,55.3%,12m
11249,3,[sMi]sMiLucky,3206,631,24,24,48,50.0%,6m
11249,3,Math,3206,598,23,21,44,52.3%,5m
11249,3,[EtrOy]Turby,3206,662,23,29,52,44.2%,31m
11249,3,JChul,3206,542,22,19,41,53.7%,12m
11249,3,Kilgrow,3206,467,21,18,39,53.8%,32m
11249,3,[AbcCo]Mugroso,3206,430,20,12,32,62.5%,20m
11249,1,deathmonkey,3206,371,16,10,26,61.5%,38m
11249,3,Agrodotus,3206,332,15,12,27,55.6%,40m
11249,3,NguyenLopez,3206,220,7,3,10,70.0%,36m
11249,3,Wingent,3206,60,7,4,11,63.6%,17m
11249,3,CactusKidd,3206,118,5,3,8,62.5%,20m
11249,1,Chacal,3206,119,5,3,8,62.5%,2h
11249,1,[WdTd]Hoju,3206,0,4,3,7,57.1%,41m
11249,3,[NYESS]Grundle,3206,58,3,1,4,75.0%,24m
11249,3,TerdFerguson,3206,97,2,0,2,100.0%,39m
11249,3,[NoSA]DyDer,3206,30,1,1,2,50.0%,26m
11249,3,Daemon,3206,0,1,3,4,25.0%,37m
11249,3,SonG,3206,0,0,1,1,0.0%,43m
11273,2,Akihito,3205,1387,346,346,692,50.0%,5m
11273,3,[IMl]Cruise,3205,1576,223,196,419,53.2%,16m
11273,3,[GOPERÚ]PsychoBanana,3205,1481,195,190,385,50.6%,19m
11273,3,[NZER0]Ghost,3205,1172,139,124,263,52.9%,35m
11273,3,fabricio,3205,1519,116,86,202,57.4%,26m
11273,3,Twiceratops,3205,812,69,62,131,52.7%,41m
11273,3,LtdEdition,3205,873,54,51,105,51.4%,29m
11273,3,[BaIIz]almightyalf,3205,1008,50,33,83,60.2%,6m
11273,3,[NPhase]Swiftdaddy,3205,939,47,36,83,56.6%,30m
11273,3,Sabuvok,3205,892,40,25,65,61.5%,16m
11273,3,Cobruhz,3205,838,40,38,78,51.3%,23m
11273,2,[PoSu]Sariel,3205,1008,39,44,83,47.0%,13m
11273,3,Edufel,3205,602,22,24,46,47.8%,12m
11273,3,Barkcode,3205,211,18,3,21,85.7%,12m
11273,3,ilililililil,3205,176,6,8,14,42.9%,23m
11273,3,verjox,3205,174,5,1,6,83.3%,8m
11273,3,Slagsdale,3205,88,4,4,8,50.0%,6m
11273,3,[SC0DE]BlizzOmega,3205,94,1,1,2,50.0%,41m
11273,3,[WNTRLH]MrPicard,3205,0,0,1,1,0.0%,15m
11273,3,Persona,3205,0,0,1,1,0.0%,17m
11293,3,[DGCIM]torto,3204,1584,292,279,571,51.1%,4m
11293,3,GERTY,3204,1637,130,127,257,50.6%,6m
11293,3,NightTrundle,3204,1547,94,75,169,55.6%,12m
11293,3,[ValidG]hdmark,3204,959,70,63,133,52.6%,14m
11293,2,Okami,3204,1212,66,93,159,41.5%,7m
11293,3,[AlIin]DaBoss,3204,1036,48,36,84,57.1%,23m
11293,3,[VoF]ZealotRQ,3204,304,12,10,22,54.5%,4m
11293,3,[Nag]FrOgMaN,3204,163,11,0,11,100.0%,10m
11293,3,[6IXX]TenaciousD,3204,109,5,2,7,71.4%,15m
11293,3,BlUeTeE,3204,116,5,5,10,50.0%,10m
11293,3,[RtKa]Enn,3204,30,4,4,8,50.0%,23m
11293,3,MlonEusk,3204,90,3,3,6,50.0%,11m
11293,3,[MEMSTR]iLLuSiNz,3204,88,3,4,7,42.9%,28m
11293,3,Gregor,3204,121,2,4,6,33.3%,10m
11293,3,[420CC]UncleDrew,3204,30,2,4,6,33.3%,15m
11293,3,Jakked,3204,0,1,0,1,100.0%,21m
11293,3,Maximus,3204,0,0,1,1,0.0%,43m
11293,3,Azreal,3204,0,0,1,1,0.0%,30m
11311,3,gaBufS,3203,1314,137,130,267,51.3%,37m
11311,3,ZoNo,3203,1446,69,59,128,53.9%,42m
11311,3,[ShNK]DeathGun,3203,1388,68,53,121,56.2%,25m
11311,3,Sveeja,3203,463,26,25,51,51.0%,33m
11311,3,[MarinC]lIIlIIIIIIlI,3203,330,14,9,23,60.9%,42m
11311,3,NachosDelQue,3203,221,7,9,16,43.8%,25m
11311,3,soft,3203,203,6,2,8,75.0%,20m
11311,3,IIlIIIlIlII,3203,86,4,7,11,36.4%,28m
11311,3,Dextrocity,3203,60,3,3,6,50.0%,6m
11311,3,Faded,3203,60,3,5,8,37.5%,29m
11311,3,Jack,3203,60,2,4,6,33.3%,19m
11311,3,[KOYOMI]PROBER,3203,0,1,1,2,50.0%,11m
11311,3,RAMBO,3203,0,1,2,3,33.3%,30m
11311,3,[FTTD]PetirBuas,3203,0,0,1,1,0.0%,6m
11311,3,[Chikki]Cantankerous,3203,0,0,1,1,0.0%,32m
11311,3,Pubby,3203,0,0,1,1,0.0%,27m
11311,3,llllllllllll,3203,0,0,2,2,0.0%,39m
11328,3,IMMORTAL,3202,1474,169,131,300,56.3%,37m
11328,3,had,3202,510,79,72,151,52.3%,36m
11328,3,ImaDiffBreed,3202,590,63,54,117,53.8%,23m
11328,3,Kuwabara,3202,1120,50,34,84,59.5%,27m
11328,3,Metrobius,3202,452,41,29,70,58.6%,26m
11328,3,Troltof,3202,335,32,16,48,66.7%,36m
11328,3,Jollum,3202,237,19,8,27,70.4%,7m
11328,3,cocoloco,3202,223,12,4,16,75.0%,41m
11328,3,KalulIIIIIII,3202,160,10,8,18,55.6%,41m
11328,1,[Atone]Dragora,3202,167,8,4,12,66.7%,18m
11328,3,[WBDS]zmap,3202,0,4,1,5,80.0%,20m
11328,3,RandyJoe,3202,106,3,1,4,75.0%,12m
11328,3,Computer,3202,0,1,0,1,100.0%,25m
11328,3,Ares,3202,30,1,1,2,50.0%,20m
11328,3,[KGC]slyp,3202,30,1,3,4,25.0%,6m
11328,3,Lutris,3202,0,1,4,5,20.0%,3m
11328,3,Matt,3202,0,0,1,1,0.0%,2h
11328,3,[CDiez9]BruJo,3202,0,0,1,1,0.0%,15m
11328,3,Velocipastor,3202,0,0,1,1,0.0%,43m
11328,3,[DarkLS]BlueNait,3202,0,0,1,1,0.0%,12m
11348,3,Gonzo,3201,1136,50,36,86,58.1%,22m
11348,3,Raymon,3201,686,35,37,72,48.6%,39m
11348,3,Max,3201,313,15,5,20,75.0%,30m
11348,3,sdfgsdfg,3201,145,7,3,10,70.0%,15m
11348,3,Jehee,3201,203,6,5,11,54.5%,31m
11348,3,[LcH]Wyverno,3201,0,4,1,5,80.0%,20m
11348,2,Ukyo,3201,95,4,1,5,80.0%,6m
11348,3,Thunderjunk,3201,122,4,11,15,26.7%,7m
11348,3,Chislic,3201,144,3,6,9,33.3%,17m
11348,3,XxDago,3201,0,1,0,1,100.0%,6m
11348,3,MrTerribad,3201,30,1,3,4,25.0%,9m
11348,3,[BITEL]FMP,3201,0,0,1,1,0.0%,6m
11360,2,YourLover,3200,1419,227,241,468,48.5%,7m
11360,3,[TRVMPD]TurboB,3200,1548,188,180,368,51.1%,27m
11360,3,[Macac0]yengerdipsi,3200,1485,94,97,191,49.2%,20m
11360,3,cannon,3200,1350,63,49,112,56.2%,29m
11360,3,Samaitch,3200,1348,55,61,116,47.4%,33m
11360,3,[RustLg]XxkilljoyxX,3200,973,49,24,73,67.1%,4m
11360,3,TheWildWeast,3200,800,44,28,72,61.1%,26m
11360,3,[xLgNx]Badawii,3200,584,29,29,58,50.0%,22m
11360,2,[Igbt]FlyinHealBus,3200,553,27,34,61,44.3%,14m
11360,3,Salamander,3200,670,25,26,51,49.0%,3m
11360,2,IIlIlIlIlIlI,3200,0,1,0,1,100.0%,22m
11360,3,Kippi,3200,0,1,1,2,50.0%,23m
11360,2,MorningWood,3200,0,1,1,2,50.0%,1h
11360,3,Azepro,3200,0,1,4,5,20.0%,15m
11360,3,[iGOSU]Flamewarrior,3200,0,0,1,1,0.0%,33m
11360,2,[Thanat]InviShadow,3200,0,0,1,1,0.0%,8m
11360,3,[iHCE]nova,3200,0,0,2,2,0.0%,6m
11377,3,WSC,3199,1526,269,244,513,52.4%,24m
11377,3,[FU2]safemephit,3199,1529,247,213,460,53.7%,23m
11377,3,Flipcoin,3199,522,83,58,141,58.9%,26m
11377,3,hackertitan,3199,1182,46,39,85,54.1%,4m
11377,3,MicrO,3199,610,27,19,46,58.7%,26m
11377,3,[SsaYnS]Needs,3199,455,24,7,31,77.4%,3m
11377,3,xDiShPiGx,3199,579,23,18,41,56.1%,42m
11377,3,SoulG,3199,275,22,28,50,44.0%,30m
11377,3,Momo,3199,237,19,21,40,47.5%,8m
11377,3,catukun,3199,548,19,22,41,46.3%,37m
11377,3,[INextI]Fenix,3199,272,10,10,20,50.0%,39m
11377,3,thecrazyone,3199,118,4,4,8,50.0%,6m
11377,2,[NYOOM]Johann,3199,0,3,3,6,50.0%,2h
11377,3,Jinchuraki,3199,93,2,0,2,100.0%,13m
11377,3,Blondes,3199,30,2,2,4,50.0%,4m
11377,3,[OmNi4]Grownoff,3199,0,1,0,1,100.0%,37m
11377,1,DarkFate,3199,92,1,1,2,50.0%,19m
11377,2,[TSOUP]OverMatter,3199,0,1,6,7,14.3%,1h
11377,3,[GnR]CrabeCéleste,3199,0,0,1,1,0.0%,38m
11377,3,DarkDino,3199,0,0,1,1,0.0%,6m
11377,3,[Sense]Psycho,3199,0,0,1,1,0.0%,20m
11398,3,[GoDk]oPKingTroy,3198,1500,210,202,412,51.0%,26m
11398,3,SoCo,3198,533,117,89,206,56.8%,33m
11398,3,IIiiIIiiII,3198,1559,110,91,201,54.7%,18m
11398,3,hani,3198,1448,92,97,189,48.7%,4m
11398,3,Lifedata,3198,587,28,17,45,62.2%,42m
11398,3,SkyNet,3198,452,21,10,31,67.7%,41m
11398,3,Grrrr,3198,395,20,6,26,76.9%,21m
11398,3,Strawbs,3198,173,17,4,21,81.0%,14m
11398,1,[Carb]Carb,3198,374,16,8,24,66.7%,40m
11398,3,Williams,3198,443,16,14,30,53.3%,14m
11398,3,TheCourier,3198,260,13,4,17,76.5%,16m
11398,3,Oenari,3198,213,9,6,15,60.0%,21m
11398,3,MagicTerran,3198,210,9,6,15,60.0%,26m
11398,3,[G79]Buckstar,3198,182,7,6,13,53.8%,32m
11398,3,TheLegiOn,3198,218,6,5,11,54.5%,19m
11398,2,[CoCoWa]TrashPanda,3198,216,5,15,20,25.0%,18m
11398,3,[NKT1]JERRY,3198,124,4,12,16,25.0%,32m
11398,3,Exavier,3198,118,2,1,3,66.7%,31m
11398,3,[nieBla]Paneton,3198,30,2,1,3,66.7%,41m
11398,3,[HaCoLa]Krabator,3198,0,1,0,1,100.0%,20m
11398,3,Bega,3198,0,1,0,1,100.0%,10m
11398,3,LemonCake,3198,0,1,0,1,100.0%,17m
11398,3,Moridin,3198,0,1,0,1,100.0%,21m
11398,1,[GRMN]Velvacaine,3198,0,1,1,2,50.0%,10m
11398,3,[EvilGC]Searching,3198,30,1,2,3,33.3%,32m
11398,2,[FaeG]TotesMaGoats,3198,0,0,1,1,0.0%,2h
11398,2,[Kaiba]BenAffleck,3198,0,0,1,1,0.0%,2h
11398,3,FrozenIce,3198,0,0,1,1,0.0%,22m
11398,3,[RiseOf]VillageIdiot,3198,0,0,1,1,0.0%,23m
11398,3,[EtrOy]Lucuus,3198,0,0,1,1,0.0%,32m
11398,3,[DarkLS]Arphoenyx,3198,0,0,1,1,0.0%,12m
11398,3,[Moo0]Smuckers,3198,0,0,1,1,0.0%,17m
11430,3,[YD2K]oldschool,3197,1335,162,160,322,50.3%,44m
11430,3,piliaborza,3197,1558,76,75,151,50.3%,7m
11430,3,[BEEBOY]Andalvis,3197,704,31,17,48,64.6%,28m
11430,3,Persiville,3197,614,27,12,39,69.2%,36m
11430,3,FEsT,3197,555,26,10,36,72.2%,31m
11430,3,cbrennan,3197,658,23,30,53,43.4%,19m
11430,3,minimin,3197,439,18,10,28,64.3%,31m
11430,3,GrandMaster,3197,232,10,9,19,52.6%,16m
11430,3,food,3197,253,9,5,14,64.3%,23m
11430,3,[DXPCA]Sebastian,3197,122,3,4,7,42.9%,26m
11430,3,[Khng]KhangSlayer,3197,0,1,0,1,100.0%,38m
11430,3,lIlIlIlIlIl,3197,0,1,0,1,100.0%,22m
11430,3,[BTRBYZ]Yoillownya,3197,0,0,1,1,0.0%,17m
11430,3,sangrefria,3197,0,0,1,1,0.0%,25m
11444,3,HADDEN,3196,1467,164,163,327,50.2%,18m
11444,3,FebgarciaTTV,3196,1584,113,101,214,52.8%,31m
11444,3,ihascupcakes,3196,900,43,20,63,68.3%,13m
11444,3,JayMunger,3196,984,37,33,70,52.9%,30m
11444,3,[SBlock]Chebas,3196,320,32,24,56,57.1%,43m
11444,3,Kinesin,3196,422,16,9,25,64.0%,17m
11444,2,Bruh,3196,281,11,9,20,55.0%,32m
11444,2,Alex,3196,151,7,6,13,53.8%,28m
11444,3,[Sc9Maf]bigxd,3196,0,4,1,5,80.0%,3m
11444,1,IllI,3196,0,4,2,6,66.7%,38m
11444,2,InDIGo,3196,144,4,3,7,57.1%,24m
11444,3,BADLIAR,3196,0,3,2,5,60.0%,16m
11444,3,WKiller,3196,88,3,5,8,37.5%,3m
11444,3,cheesy,3196,30,2,8,10,20.0%,39m
11444,3,CondePatula,3196,0,1,0,1,100.0%,20m
11444,1,[U2EZGG]ÜbermEnSCh,3196,0,1,0,1,100.0%,3h
11444,3,GuZZZiOQ,3196,0,1,0,1,100.0%,10m
11444,3,ButtsCarlton,3196,30,1,11,12,8.3%,12m
11444,3,RxDealer,3196,0,0,1,1,0.0%,23m
11444,3,ReggaeShark,3196,0,0,1,1,0.0%,6m
11464,3,[5Svrt]Nyctor,3195,706,33,38,71,46.5%,42m
11464,3,[TGCF]Paimon,3195,697,32,15,47,68.1%,27m
11464,3,Relentless,3195,466,32,21,53,60.4%,18m
11464,3,Baobab,3195,471,28,22,50,56.0%,4m
11464,3,Clearblood,3195,392,27,25,52,51.9%,37m
11464,3,[Æsir]THOR,3195,601,25,23,48,52.1%,31m
11464,3,Speedy,3195,386,18,11,29,62.1%,42m
11464,3,[AR]Azrael,3195,440,16,10,26,61.5%,17m
11464,3,[MLPog]TastyBacon,3195,440,15,16,31,48.4%,25m
11464,2,Raccoon,3195,300,13,6,19,68.4%,9m
11464,3,imdrunkgoez,3195,274,11,5,16,68.8%,24m
11464,3,[Cryptc]Nefarious,3195,248,8,17,25,32.0%,41m
11464,3,baM,3195,130,6,17,23,26.1%,16m
11464,3,undertone,3195,172,5,8,13,38.5%,20m
11464,3,[MD]LeeOh,3195,0,4,1,5,80.0%,19m
11464,3,[INB4U]Kerby,3195,86,4,3,7,57.1%,38m
11464,3,Kraven,3195,118,3,0,3,100.0%,6m
11464,3,drawXsoul,3195,30,2,0,2,100.0%,35m
11464,3,Makø,3195,0,1,0,1,100.0%,25m
11464,3,Kairos,3195,95,1,1,2,50.0%,16m
11464,3,thetagang,3195,0,0,1,1,0.0%,8m
11485,3,Popols,3194,1520,271,251,522,51.9%,23m
11485,3,hnrcbx,3194,1589,164,155,319,51.4%,19m
11485,3,IIIIIIIIIZ,3194,1531,110,114,224,49.1%,8m
11485,3,[LITW]MOMO,3194,1329,72,70,142,50.7%,20m
11485,3,MadZealot,3194,555,33,36,69,47.8%,16m
11485,3,[BRSKR]ToxicChicken,3194,187,9,5,14,64.3%,30m
11485,2,jaselahAtlas,3194,234,8,7,15,53.3%,16m
11485,2,[NiMei]best,3194,94,5,2,7,71.4%,2h
11485,3,[TGosuC]Lucid,3194,140,5,7,12,41.7%,19m
11485,3,Tranhonor,3194,0,4,1,5,80.0%,15m
11485,3,OnlyLoveYou,3194,122,4,9,13,30.8%,23m
11485,3,stonks,3194,117,3,0,3,100.0%,30m
11485,3,RicardoToss,3194,58,3,1,4,75.0%,20m
11485,3,[FxB]Duttles,3194,90,3,5,8,37.5%,20m
11485,2,Mari,3194,166,3,9,12,25.0%,14m
11485,3,Shadowstorm,3194,30,2,0,2,100.0%,15m
11485,3,SoftSoap,3194,30,2,1,3,66.7%,18m
11485,3,llIllIlIl,3194,0,1,0,1,100.0%,7m
11485,3,SilverHawk,3194,0,0,1,1,0.0%,38m
11485,3,Freks,3194,0,0,1,1,0.0%,28m
11485,3,Stephano,3194,0,0,2,2,0.0%,36m
11506,2,Ksni,3193,1119,244,216,460,53.0%,14m
11506,3,tonbob,3193,1295,109,94,203,53.7%,6m
11506,3,Grif,3193,1356,65,49,114,57.0%,30m
11506,3,[cl0udM]Deftruptor,3193,319,62,50,112,55.4%,41m
11506,3,AwesomeSauce,3193,959,48,28,76,63.2%,30m
11506,3,Bassboat,3193,1044,37,46,83,44.6%,26m
11506,3,SgtRatlaGOD,3193,420,15,17,32,46.9%,17m
11506,3,Cosmicen,3193,193,6,3,9,66.7%,29m
11506,3,osasuneirok,3193,168,6,6,12,50.0%,30m
11506,2,[1for2]dtwo,3193,118,3,0,3,100.0%,8m
11506,3,Hikikomori,3193,95,2,0,2,100.0%,33m
11506,3,AleX,3193,30,1,1,2,50.0%,20m
11506,3,IIIlllIIllII,3193,30,1,2,3,33.3%,6m
11506,3,[RU5HY]Luke,3193,0,0,1,1,0.0%,30m
11506,3,UncommonN,3193,0,0,1,1,0.0%,32m
11506,3,killonater,3193,0,0,4,4,0.0%,6m
11522,3,[QOSQO]daX,3192,1538,127,132,259,49.0%,9m
11522,3,Trollger,3192,596,45,54,99,45.5%,37m
11522,3,[αXLa]Eintrag,3192,631,28,26,54,51.9%,26m
11522,3,Light,3192,670,24,25,49,49.0%,8m
11522,3,Moltar,3192,458,19,12,31,61.3%,23m
11522,3,TheE,3192,492,18,24,42,42.9%,23m
11522,3,Paladin,3192,176,7,10,17,41.2%,27m
11522,3,Razor,3192,186,6,2,8,75.0%,29m
11522,1,theBALLS,3192,93,5,1,6,83.3%,21m
11522,1,mmun,3192,48,2,7,9,22.2%,2h
11522,3,Garal,3192,0,1,0,1,100.0%,42m
11522,2,TheNumberJ,3192,0,1,0,1,100.0%,34m
11522,2,[BuCaSD]TortugaVIl,3192,0,1,0,1,100.0%,22m
11522,3,DarkReaper,3192,0,0,1,1,0.0%,8m
11522,3,HypnoToad,3192,0,0,1,1,0.0%,30m
11522,3,Helloladys,3192,0,0,1,1,0.0%,40m
11522,3,dardo,3192,0,0,2,2,0.0%,41m
11539,3,[1TL]Coalltrain,3191,1588,207,183,390,53.1%,39m
11539,3,Swather,3191,1577,174,181,355,49.0%,18m
11539,3,GLZM,3191,1547,106,88,194,54.6%,25m
11539,3,Korya,3191,810,37,26,63,58.7%,8m
11539,3,awesomeofAZ,3191,603,34,31,65,52.3%,25m
11539,3,Whoknows,3191,586,22,24,46,47.8%,26m
11539,3,Pekorekt,3191,352,14,16,30,46.7%,28m
11539,3,slayercc,3191,222,10,6,16,62.5%,41m
11539,3,[BearMe]NightOwl,3191,130,7,3,10,70.0%,19m
11539,3,blackhand,3191,192,6,4,10,60.0%,44m
11539,3,Canti,3191,58,2,4,6,33.3%,22m
11539,3,[NLTN]Yoshimitsu,3191,30,2,6,8,25.0%,35m
11551,3,Panthre,3190,1147,200,193,393,50.9%,30m
11551,3,[MacMic]AngelOfGod,3190,260,67,0,67,100.0%,29m
11551,3,[LilBuk]JohnnyUtah,3190,1178,45,43,88,51.1%,10m
11551,3,JABERVSKI,3190,926,44,39,83,53.0%,22m
11551,3,FEDERER,3190,866,40,44,84,47.6%,31m
11551,3,CONRADtheSLY,3190,642,31,22,53,58.5%,42m
11551,3,[HnTr]Xyron,3190,580,26,13,39,66.7%,6m
11551,3,Renegade,3190,628,24,26,50,48.0%,42m
11551,3,microjr,3190,545,21,18,39,53.8%,20m
11551,3,[ZTempz]Diobetes,3190,262,14,12,26,53.8%,19m
11551,3,GSM,3190,277,12,8,20,60.0%,21m
11551,3,Joonho,3190,263,10,3,13,76.9%,36m
11551,3,ZergerKing,3190,244,8,12,20,40.0%,17m
11551,3,Solace,3190,196,6,2,8,75.0%,31m
11551,3,free,3190,127,6,7,13,46.2%,21m
11551,3,CoolBreeze,3190,117,5,6,11,45.5%,8m
11551,3,FoBuLouS,3190,140,5,7,12,41.7%,20m
11551,3,llllllll,3190,0,4,0,4,100.0%,38m
11551,3,xDiShPiGx,3190,58,3,10,13,23.1%,26m
11551,3,SauceBoss,3190,113,2,1,3,66.7%,7m
11551,3,JACKJAS,3190,30,1,2,3,33.3%,27m
11551,3,Quest,3190,91,1,4,5,20.0%,4m
11551,3,Squawk,3190,0,0,1,1,0.0%,30m
11551,3,sLaViC,3190,0,0,1,1,0.0%,21m
11575,3,SwarmStorm,3189,570,200,195,395,50.6%,14m
11575,3,Baloneus,3189,1581,64,59,123,52.0%,12m
11575,3,[GnR]Baratheon,3189,832,55,60,115,47.8%,22m
11575,3,[xVALx]Yorkuchu,3189,917,38,28,66,57.6%,27m
11575,3,Huddorenge,3189,919,38,52,90,42.2%,13m
11575,3,RyderB,3189,695,30,17,47,63.8%,8m
11575,3,[XpKb]Rterrakion,3189,452,22,7,29,75.9%,20m
11575,3,IIIIIIIIIIII,3189,430,16,11,27,59.3%,17m
11575,3,Verjo,3189,470,16,21,37,43.2%,10m
11575,3,Josu,3189,380,16,24,40,40.0%,20m
11575,3,dogjlao,3189,305,15,8,23,65.2%,15m
11575,3,Unreliable,3189,258,11,4,15,73.3%,27m
11575,3,[McCr]Merciless,3189,289,11,7,18,61.1%,38m
11575,3,[JABW]Incense,3189,268,11,17,28,39.3%,6m
11575,2,Morpheus,3189,141,9,9,18,50.0%,3m
11575,3,Corea,3189,214,8,0,8,100.0%,6m
11575,3,Naruto,3189,167,4,3,7,57.1%,44m
11575,3,Gamma,3189,60,3,2,5,60.0%,37m
11575,3,CcE,3189,30,2,1,3,66.7%,41m
11575,3,[MiniC]Fera,3189,0,1,0,1,100.0%,17m
11575,3,WhiteEye,3189,0,1,0,1,100.0%,25m
11575,2,Muse,3189,0,1,2,3,33.3%,2h
11575,3,Straiden,3189,0,0,1,1,0.0%,3m
11575,3,[Tiddy]Lawlpop,3189,0,0,1,1,0.0%,11m
11575,3,BlackOp,3189,0,0,1,1,0.0%,12m
11575,3,misterbasic,3189,0,0,1,1,0.0%,6m
11601,3,RareHabit,3188,625,131,110,241,54.4%,36m
11601,3,[GGMESP]llllllllllll,3188,1019,115,98,213,54.0%,33m
11601,3,tatarana,3188,1529,105,111,216,48.6%,41m
11601,3,[WubLub]Daryus,3188,1437,95,101,196,48.5%,22m
11601,3,iTsJuStAfLu,3188,570,81,85,166,48.8%,6m
11601,3,Blink,3188,1556,72,79,151,47.7%,26m
11601,3,[iDrunk]SlurpSack,3188,576,53,39,92,57.6%,10m
11601,3,[Kusshh]Dondiablo,3188,1119,51,33,84,60.7%,27m
11601,3,NESS,3188,874,35,30,65,53.8%,43m
11601,3,[grity]lastofmike,3188,777,30,26,56,53.6%,23m
11601,3,[Foood]Helado,3188,310,30,29,59,50.8%,26m
11601,3,HERMESE,3188,383,27,18,45,60.0%,21m
11601,3,GameBoy,3188,457,20,10,30,66.7%,29m
11601,3,MattAK,3188,344,19,22,41,46.3%,37m
11601,3,[JOSUN]KHANee,3188,417,18,12,30,60.0%,11m
11601,3,eyyitspaul,3188,381,16,16,32,50.0%,4m
11601,2,[GaTech]Merakai,3188,309,13,11,24,54.2%,35m
11601,3,Miro,3188,182,8,5,13,61.5%,17m
11601,3,[TROP]ZeroNoShogun,3188,204,7,6,13,53.8%,42m
11601,3,Zugg,3188,170,7,6,13,53.8%,26m
11601,3,Devil,3188,206,7,8,15,46.7%,41m
11601,2,Mpjhoopsorgy,3188,142,6,3,9,66.7%,12m
11601,3,[SCN]Stevefrench,3188,196,6,9,15,40.0%,44m
11601,3,Bob,3188,0,4,1,5,80.0%,3m
11601,3,Silver,3188,0,2,3,5,40.0%,26m
11601,3,[WRuniv]STRENTWILL,3188,0,1,0,1,100.0%,18m
11601,3,XenomorpH,3188,30,1,6,7,14.3%,28m
11601,3,[PROG]GuruInfernal,3188,0,0,1,1,0.0%,12m
11601,3,[MNGOMN]JAS,3188,0,0,1,1,0.0%,33m
11601,3,GammaGhost,3188,0,0,1,1,0.0%,10m
11601,3,[Nag]Josher,3188,0,0,2,2,0.0%,22m
11601,3,KrAuti,3188,0,0,5,5,0.0%,39m
11633,3,gaborocks,3187,1523,98,97,195,50.3%,13m
11633,3,sleep,3187,1015,57,39,96,59.4%,31m
11633,3,[NZER0]Trogdar,3187,738,29,29,58,50.0%,22m
11633,3,TonyStark,3187,629,28,23,51,54.9%,40m
11633,3,Castalot,3187,497,24,8,32,75.0%,24m
11633,3,KingSlayer,3187,521,19,16,35,54.3%,44m
11633,2,Seraphim,3187,236,13,9,22,59.1%,16m
11633,3,Superbia,3187,241,8,5,13,61.5%,37m
11633,3,[LBHS]Luis,3187,112,5,3,8,62.5%,27m
11633,3,MannypacmaN,3187,30,4,1,5,80.0%,8m
11633,3,Fruit,3187,90,4,4,8,50.0%,18m
11633,3,[DNKCFT]HoRNET,3187,30,2,5,7,28.6%,21m
11633,3,[nieBla]QQuisoteSan,3187,0,1,0,1,100.0%,18m
11633,3,MkQ,3187,94,1,5,6,16.7%,27m
11633,3,Archangel,3187,0,0,1,1,0.0%,26m
11633,3,[HCAZ]HCAZ,3187,0,0,2,2,0.0%,26m
11649,3,[FACKER]Kobe,3186,1616,175,161,336,52.1%,37m
11649,3,[NLTN]carlostito,3186,868,131,105,236,55.5%,26m
11649,3,[Trump6]PatchAdams,3186,1469,99,100,199,49.7%,18m
11649,3,Pepsi,3186,591,85,96,181,47.0%,37m
11649,3,bisQuid,3186,1352,68,66,134,50.7%,30m
11649,3,DoJja,3186,362,14,15,29,48.3%,23m
11649,3,[UpeV]Aioria,3186,314,12,6,18,66.7%,11m
11649,3,Grimreaper,3186,219,9,4,13,69.2%,7m
11649,3,Nero,3186,240,7,6,13,53.8%,9m
11649,3,Survival,3186,203,6,5,11,54.5%,37m
11649,3,sanguine,3186,168,6,6,12,50.0%,6m
11649,3,[JChill]stickerplane,3186,116,4,7,11,36.4%,22m
11649,3,[PAGE5]Laevus,3186,58,3,1,4,75.0%,8m
11649,3,shadow,3186,78,3,4,7,42.9%,10m
11649,3,Stillearning,3186,90,3,6,9,33.3%,23m
11649,3,Trainbarf,3186,60,2,6,8,25.0%,8m
11649,3,[Dnwlkr]DFL,3186,0,1,0,1,100.0%,30m
11649,3,ImbaRageQuit,3186,0,0,2,2,0.0%,16m
11667,3,SuperAmerica,3185,1528,153,134,287,53.3%,12m
11667,3,Capac,3185,1597,89,72,161,55.3%,21m
11667,3,[Ldybys]Almaviva,3185,475,17,14,31,54.8%,29m
11667,3,Inferno,3185,360,12,23,35,34.3%,21m
11667,3,PulloutKing,3185,197,8,5,13,61.5%,27m
11667,3,[sOLsc]Gajeel,3185,245,8,9,17,47.1%,15m
11667,3,[TGosuD]ChaOtic,3185,200,7,7,14,50.0%,13m
11667,3,Zergycount,3185,122,6,3,9,66.7%,30m
11667,1,Legion,3185,177,6,6,12,50.0%,7m
11667,3,[TSFs]Grimm,3185,114,4,6,10,40.0%,21m
11667,3,drip,3185,140,3,2,5,60.0%,29m
11667,2,[DRL]Jojbean,3185,113,3,5,8,37.5%,1h
11667,3,[SLAMT]Syn,3185,0,2,3,5,40.0%,17m
11667,3,malahaas,3185,30,1,1,2,50.0%,12m
11667,2,MrBaloo,3185,88,1,1,2,50.0%,42m
11667,3,Taydon,3185,30,1,3,4,25.0%,41m
11667,3,Tangy,3185,30,1,4,5,20.0%,7m
11667,3,vixolin,3185,0,1,4,5,20.0%,16m
11667,3,[PuStLe]infestorOP,3185,0,0,1,1,0.0%,5m
11667,3,glhf,3185,0,0,1,1,0.0%,24m
11667,3,FishSangwich,3185,0,0,2,2,0.0%,2h
11688,3,Britney,3184,1192,109,89,198,55.1%,16m
11688,3,[Zulu]King,3184,1364,58,46,104,55.8%,42m
11688,3,[H264]JackyIcie,3184,1194,47,46,93,50.5%,26m
11688,3,[TY4GG]EasyComputer,3184,773,33,21,54,61.1%,15m
11688,3,SillySausage,3184,675,27,20,47,57.4%,26m
11688,3,HedonismBot,3184,732,25,34,59,42.4%,32m
11688,3,WorldCrusher,3184,562,23,20,43,53.5%,13m
11688,3,IordOfFlies,3184,575,21,31,52,40.4%,26m
11688,3,IlIlIlIlIlIl,3184,359,13,12,25,52.0%,20m
11688,3,[Flacyd]NatPort,3184,135,4,1,5,80.0%,20m
11688,3,Caution,3184,120,4,10,14,28.6%,31m
11688,3,[GRBP]Rubicon,3184,92,3,4,7,42.9%,12m
11688,3,[UCI]QuickDraw,3184,0,1,0,1,100.0%,27m
11688,3,RobTenken,3184,0,1,2,3,33.3%,37m
11688,3,[GnR]Kingbenjamin,3184,0,0,1,1,0.0%,32m
11703,3,Fox,3183,1032,122,120,242,50.4%,21m
11703,3,zed,3183,1543,94,84,178,52.8%,32m
11703,3,[UpxV]Centurion,3183,1089,51,38,89,57.3%,13m
11703,3,[LMen]trenchshot,3183,1012,38,40,78,48.7%,12m
11703,3,BuffettGamer,3183,617,27,21,48,56.2%,39m
11703,3,GrumpyPants,3183,544,24,15,39,61.5%,42m
11703,3,[Macac0]pungthewolf,3183,594,21,27,48,43.8%,43m
11703,3,[CodeA]Beatme,3183,307,16,0,16,100.0%,29m
11703,3,fatman,3183,458,16,18,34,47.1%,12m
11703,3,[VINGAD]cnd,3183,376,15,7,22,68.2%,26m
11703,3,JazZz,3183,206,11,8,19,57.9%,16m
11703,3,[GdAT]Righteousnes,3183,185,9,4,13,69.2%,16m
11703,3,CaptainYU,3183,203,9,5,14,64.3%,16m
11703,1,bigbootybob,3183,187,8,4,12,66.7%,1h
11703,3,WeeYoungLad,3183,232,8,18,26,30.8%,30m
11703,3,[Rated]Jakolokol,3183,174,7,7,14,50.0%,18m
11703,3,[SC2IDN]Klappertaart,3183,191,6,3,9,66.7%,11m
11703,3,[InGt]NrGYuY,3183,30,5,2,7,71.4%,6m
11703,3,eimang,3183,148,4,2,6,66.7%,11m
11703,3,jbroscII,3183,60,3,1,4,75.0%,30m
11703,3,[IpTime]DestinyCake,3183,0,3,1,4,75.0%,24m
11703,3,bandolero,3183,92,3,7,10,30.0%,27m
11703,3,abdullah,3183,95,2,0,2,100.0%,5m
11703,2,Noodle,3183,0,1,0,1,100.0%,1h
11703,3,NewNetCity,3183,95,1,1,2,50.0%,21m
11703,3,[a99]Bloodbyte,3183,30,1,2,3,33.3%,36m
11703,3,Rob,3183,30,1,2,3,33.3%,10m
11703,3,Sagi,3183,0,0,1,1,0.0%,5m
11703,3,[C2N]DeathBringer,3183,0,0,2,2,0.0%,20m
11703,3,[1vsM]charlie,3183,0,0,3,3,0.0%,37m
11733,3,bannie,3182,1557,82,79,161,50.9%,12m
11733,3,VRman,3182,1216,59,29,88,67.0%,26m
11733,3,oscarluq,3182,847,38,23,61,62.3%,15m
11733,3,AeruTea,3182,986,35,43,78,44.9%,37m
11733,3,[glhfSC]rafayel,3182,734,33,20,53,62.3%,27m
11733,3,Barcode,3182,107,5,2,7,71.4%,42m
11733,3,CORVIDSUX,3182,140,4,2,6,66.7%,7m
11733,1,Hinundweg,3182,119,4,2,6,66.7%,28m
11733,1,[DIQPTE]aaaaaaaaab,3182,94,2,4,6,33.3%,6m
11733,3,BadreligioN,3182,0,1,0,1,100.0%,19m
11733,3,KIWIBSC,3182,0,0,1,1,0.0%,24m
11733,3,smoothieyum,3182,0,0,1,1,0.0%,26m
11733,3,DTwiz,3182,0,0,2,2,0.0%,22m
11733,3,[SlPt]Proston,3182,0,0,5,5,0.0%,23m
11747,3,[OGbros]StarMax,3181,1542,172,145,317,54.3%,42m
11747,3,Demon,3181,1481,131,110,241,54.4%,42m
11747,3,Rooks,3181,835,74,63,137,54.0%,7m
11747,3,[BUTIFL]Zeebz,3181,1515,70,66,136,51.5%,32m
11747,3,[LQV]chikbi,3181,1619,67,61,128,52.3%,26m
11747,3,Funkmasta,3181,242,17,11,28,60.7%,18m
11747,3,MonkeyArms,3181,384,13,16,29,44.8%,21m
11747,3,[jCp]sTandUhmAn,3181,308,12,19,31,38.7%,43m
11747,3,[EZkill]iwasafatkid,3181,291,11,5,16,68.8%,43m
11747,3,[BIaze]Rhino,3181,240,9,13,22,40.9%,10m
11747,3,marmelloh,3181,171,7,8,15,46.7%,37m
11747,3,Gerxian,3181,0,4,1,5,80.0%,30m
11747,3,Klocks,3181,161,4,8,12,33.3%,38m
11747,3,CSEddieEdit,3181,94,3,3,6,50.0%,16m
11747,2,LICHTKRIEGER,3181,42,2,0,2,100.0%,12m
11747,3,SpeedRacer,3181,0,1,0,1,100.0%,7m
11747,3,Sirhc,3181,0,1,0,1,100.0%,38m
11747,3,[SQUEE]Castaway,3181,0,0,1,1,0.0%,6m
11747,3,[neuroW]omegatrox,3181,0,0,4,4,0.0%,29m
11766,3,ZergVSAny,3180,1490,123,116,239,51.5%,36m
11766,3,GOODFRIDAY,3180,1168,98,69,167,58.7%,16m
11766,3,[IRL]Cooler,3180,1144,93,95,188,49.5%,34m
11766,3,banana,3180,576,57,54,111,51.4%,21m
11766,3,Tiffin,3180,446,43,31,74,58.1%,21m
11766,3,[ZTemps]Diobetes,3180,136,31,19,50,62.0%,21m
11766,3,Dawse,3180,652,23,28,51,45.1%,36m
11766,3,[RustLg]BoogieBot,3180,300,14,10,24,58.3%,19m
11766,3,XNewGod,3180,296,12,13,25,48.0%,29m
11766,3,[Fir3s]xtreme,3180,236,8,5,13,61.5%,26m
11766,3,Noobforreal,3180,93,4,2,6,66.7%,21m
11766,3,Ravend,3180,96,2,0,2,100.0%,4m
11766,3,[AD3C]Whisper,3180,0,1,0,1,100.0%,30m
11766,3,Schlumkatze,3180,96,1,1,2,50.0%,3m
11766,3,Siberia,3180,94,1,1,2,50.0%,42m
11766,3,JaeDuck,3180,0,0,1,1,0.0%,12m
11766,3,Ascel,3180,0,0,1,1,0.0%,7m
11766,3,Pswift,3180,0,0,1,1,0.0%,13m
11766,3,KickAss,3180,0,0,1,1,0.0%,4m
11766,3,rexofired,3180,0,0,1,1,0.0%,10m
11766,2,MSKNA,3180,0,0,1,1,0.0%,2h
11766,1,Dakota,3180,0,0,2,2,0.0%,1h
11788,3,[TuBE]Woltube,3179,1595,308,284,592,52.0%,37m
11788,3,MindGrape,3179,1358,115,106,221,52.0%,30m
11788,3,TheEvilKnox,3179,1587,112,95,207,54.1%,17m
11788,3,TechSwitch,3179,1026,76,79,155,49.0%,40m
11788,3,Superfly,3179,993,63,47,110,57.3%,26m
11788,3,[CalArc]XCEKKMTX,3179,241,40,30,70,57.1%,41m
11788,3,ZYKING,3179,707,30,21,51,58.8%,6m
11788,3,TecFenix,3179,554,22,22,44,50.0%,16m
11788,3,[F3DUp]kevlar,3179,442,15,20,35,42.9%,12m
11788,3,TITAN,3179,344,12,26,38,31.6%,37m
11788,3,fourfingers,3179,236,9,10,19,47.4%,15m
11788,3,Oslemin,3179,139,7,2,9,77.8%,4m
11788,3,Bryanliang,3179,137,7,3,10,70.0%,27m
11788,3,[DEFUP]Aummadour,3179,116,4,6,10,40.0%,33m
11788,3,[NPhasA]NeoHanzo,3179,86,3,4,7,42.9%,17m
11788,3,LiquidSemen,3179,115,2,1,3,66.7%,41m
11788,3,evilcupcakes,3179,30,1,2,3,33.3%,18m
11788,3,Neldoreth,3179,0,1,4,5,20.0%,20m
11788,3,[UJGS]MurrMaster,3179,0,0,1,1,0.0%,26m
11788,3,[ZTemps]iPnTheElder,3179,0,0,1,1,0.0%,23m
11788,3,[OGbros]POSIDEN,3179,0,0,2,2,0.0%,40m
11809,3,[8OO8S]LucidChess,3178,1497,235,210,445,52.8%,13m
11809,3,[Bsk]sAvkO,3178,1593,151,153,304,49.7%,21m
11809,3,Plusaq,3178,1026,103,78,181,56.9%,3m
11809,3,[TYA]FazZ,3178,836,92,84,176,52.3%,21m
11809,3,Spectactix,3178,1334,84,76,160,52.5%,30m
11809,3,[LOHs]BrOkEn,3178,1542,70,80,150,46.7%,15m
11809,3,[PanAm]fidzysss,3178,1583,66,56,122,54.1%,25m
11809,3,Capitalism,3178,1379,58,49,107,54.2%,25m
11809,3,Anxienty,3178,1036,42,32,74,56.8%,32m
11809,3,Getafix,3178,950,36,38,74,48.6%,43m
11809,3,[notRa]WashUrHands,3178,552,32,12,44,72.7%,12m
11809,3,ZirLanceloT,3178,814,28,36,64,43.8%,10m
11809,3,[Ruined]GenghisKhan,3178,759,27,26,53,50.9%,37m
11809,3,[EZTZPZ]Blank,3178,583,25,14,39,64.1%,37m
11809,3,[mpgg]Shangster,3178,463,22,13,35,62.9%,26m
11809,3,TheEND,3178,586,20,20,40,50.0%,18m
11809,3,[NwAs]Kche,3178,348,19,1,20,95.0%,10m
11809,3,[Phetus]ZeN,3178,261,10,4,14,71.4%,9m
11809,1,Tamamo,3178,189,8,5,13,61.5%,30m
11809,3,EZarMaDa,3178,146,6,14,20,30.0%,36m
11809,3,bamboosheet,3178,170,5,2,7,71.4%,38m
11809,3,Salad,3178,30,2,1,3,66.7%,40m
11809,2,Radamanthis,3178,96,1,6,7,14.3%,2h
11809,3,Serenity,3178,0,0,1,1,0.0%,15m
11809,3,[MCFLY]MicroJFox,3178,0,0,1,1,0.0%,22m
11809,3,Insulate,3178,0,0,1,1,0.0%,22m
11835,3,fish,3177,1621,197,175,372,53.0%,21m
11835,3,Onein,3177,1535,192,139,331,58.0%,42m
11835,3,Croissant,3177,838,87,74,161,54.0%,9m
11835,3,RockEnRolla,3177,990,45,35,80,56.2%,43m
11835,3,LeBas,3177,532,42,20,62,67.7%,42m
11835,3,[OndaVT]Jorm,3177,626,33,28,61,54.1%,35m
11835,3,Waimea,3177,767,32,23,55,58.2%,18m
11835,3,ThEMaNtArAy,3177,640,24,24,48,50.0%,39m
11835,3,[ARIER]HairBert,3177,448,22,13,35,62.9%,17m
11835,3,MATHEMATIK,3177,226,13,13,26,50.0%,41m
11835,3,[NLTTJ]ParadOx,3177,284,10,5,15,66.7%,29m
11835,3,IPMan,3177,259,10,11,21,47.6%,18m
11835,3,Anti,3177,232,9,14,23,39.1%,41m
11835,3,[KAMEH]TeddyBSmith,3177,221,8,3,11,72.7%,31m
11835,1,garlicbread,3177,217,8,5,13,61.5%,1h
11835,3,[NwAs]Abdiel,3177,201,7,2,9,77.8%,16m
11835,3,JustClick,3177,86,7,4,11,63.6%,12m
11835,3,BearCub,3177,214,7,5,12,58.3%,39m
11835,3,[ZCLEET]Marv,3177,0,5,0,5,100.0%,24m
11835,3,BlueSol,3177,117,5,3,8,62.5%,33m
11835,2,Hector,3177,192,5,3,8,62.5%,8m
11835,3,[SiiR]Sanguine,3177,159,5,3,8,62.5%,7m
11835,3,ZombieFire,3177,108,3,0,3,100.0%,6m
11835,3,Rateezy,3177,90,3,9,12,25.0%,36m
11835,3,Puffalumpz,3177,0,2,0,2,100.0%,37m
11835,3,IIIIIIIIIIII,3177,0,2,1,3,66.7%,20m
11835,3,[ScSwrm]Robertoson,3177,30,2,2,4,50.0%,4m
11835,3,Valkyrie,3177,0,1,0,1,100.0%,21m
11835,2,[urEZaF]Nerd,3177,0,1,0,1,100.0%,3h
11835,3,EstivoKun,3177,30,1,2,3,33.3%,21m
11835,3,VanSCmax,3177,30,1,4,5,20.0%,38m
11835,3,PemaleBacon,3177,0,0,1,1,0.0%,26m
11835,3,EternallySD,3177,0,0,1,1,0.0%,26m
11835,3,haan,3177,0,0,1,1,0.0%,10m
11835,3,MrBIGDADDY,3177,0,0,1,1,0.0%,6m
11835,3,Crafty,3177,0,0,1,1,0.0%,4m
11835,3,BlizzAdmin,3177,0,0,1,1,0.0%,23m
11835,1,ohjoshho,3177,0,0,3,3,0.0%,12m
11873,3,Pezmerga,3176,1547,458,413,871,52.6%,27m
11873,3,driver,3176,1610,281,284,565,49.7%,21m
11873,3,Adeth,3176,1467,91,78,169,53.8%,11m
11873,3,HiddenHand,3176,437,51,35,86,59.3%,6m
11873,3,sunjay,3176,314,51,45,96,53.1%,21m
11873,3,IIIIIIlIlIlI,3176,934,47,34,81,58.0%,13m
11873,3,[Inner]Beast,3176,1148,42,41,83,50.6%,12m
11873,3,Anti,3176,216,39,38,77,50.6%,36m
11873,3,[iTrolI]Badgerfc,3176,792,31,31,62,50.0%,22m
11873,3,SpectreNinja,3176,658,30,13,43,69.8%,40m
11873,3,nissin,3176,627,26,20,46,56.5%,42m
11873,3,[TATR]StreetSharx,3176,375,25,28,53,47.2%,12m
11873,3,[dBASED]BigFloppa,3176,503,22,12,34,64.7%,16m
11873,3,Usernemo,3176,288,15,6,21,71.4%,16m
11873,3,[Poway]StormBringer,3176,385,14,17,31,45.2%,29m
11873,3,Charles,3176,327,13,6,19,68.4%,25m
11873,3,[1TL]Simbaa,3176,177,12,5,17,70.6%,43m
11873,3,[kØ]Huasozerlin,3176,289,11,7,18,61.1%,15m
11873,3,FYODOR,3176,179,10,17,27,37.0%,37m
11873,3,Dreeper,3176,60,6,3,9,66.7%,44m
11873,3,[ACM1TP]ZAZ,3176,0,5,0,5,100.0%,29m
11873,3,IIIIIllllIII,3176,0,4,1,5,80.0%,20m
11873,3,Snorlax,3176,0,4,1,5,80.0%,41m
11873,3,sPaAsM,3176,58,2,5,7,28.6%,26m
11873,3,MagicProtoss,3176,0,1,0,1,100.0%,41m
11873,3,BigRed,3176,30,1,3,4,25.0%,31m
11873,3,aeiou,3176,0,1,4,5,20.0%,43m
11873,3,PlasmaWaffle,3176,0,0,1,1,0.0%,29m
11873,3,[αB]Mercy,3176,0,0,1,1,0.0%,16m
11873,3,fireblaze,3176,0,0,1,1,0.0%,9m
11873,3,[LIBRTD]Simba,3176,0,0,2,2,0.0%,23m
11904,3,JWellz,3175,1515,271,251,522,51.9%,23m
11904,3,[5CP]Viligance,3175,1447,257,230,487,52.8%,6m
11904,3,Bob,3175,1008,100,72,172,58.1%,27m
11904,3,Sombra,3175,1617,91,70,161,56.5%,43m
11904,3,BRod,3175,1443,77,67,144,53.5%,13m
11904,3,WuTang,3175,1191,75,76,151,49.7%,18m
11904,3,YOLOguy,3175,582,73,53,126,57.9%,33m
11904,3,[CLPRTY]Beenk,3175,1354,53,52,105,50.5%,11m
11904,3,[cluez]AbGolfing,3175,772,37,21,58,63.8%,28m
11904,3,bakihanma,3175,485,20,12,32,62.5%,6m
11904,3,DIO,3175,455,19,17,36,52.8%,5m
11904,3,PhantomThief,3175,397,16,9,25,64.0%,21m
11904,3,[SC2IDN]SolidSnake,3175,365,14,20,34,41.2%,18m
11904,3,Nightblade,3175,241,10,7,17,58.8%,15m
11904,3,[Pro2os]FireFistAce,3175,280,10,8,18,55.6%,19m
11904,3,Sung,3175,209,10,9,19,52.6%,14m
11904,3,lmc,3175,256,10,11,21,47.6%,41m
11904,3,pocker,3175,224,7,17,24,29.2%,39m
11904,3,dangree,3175,125,6,2,8,75.0%,17m
11904,3,ColonelW,3175,0,5,0,5,100.0%,27m
11904,3,Static,3175,30,2,5,7,28.6%,26m
11904,3,SouthKeeble,3175,0,1,0,1,100.0%,25m
11904,3,TakeToSky,3175,30,1,7,8,12.5%,17m
11904,3,[HDRP]Mojobinks,3175,0,0,1,1,0.0%,11m
11928,2,dragonfist,3174,1445,471,468,939,50.2%,3m
11928,3,[SWOU]Zera,3174,1556,198,195,393,50.4%,7m
11928,3,[LunchZ]Lunchbox,3174,1565,178,167,345,51.6%,17m
11928,3,Elarionus,3174,863,134,94,228,58.8%,13m
11928,3,[BOLSCZ]Caín,3174,1505,97,85,182,53.3%,20m
11928,3,Troy,3174,1476,79,71,150,52.7%,31m
11928,3,Creager,3174,1075,70,48,118,59.3%,23m
11928,3,Boudichon,3174,923,68,53,121,56.2%,13m
11928,3,CaneCorso,3174,785,57,61,118,48.3%,13m
11928,3,[n3wk1d]shishkaberb,3174,214,54,38,92,58.7%,29m
11928,3,[ZNsc]Nanozstorm,3174,956,35,38,73,47.9%,6m
11928,3,[UpxV]MiGueL,3174,525,29,17,46,63.0%,13m
11928,3,Random,3174,605,27,16,43,62.8%,13m
11928,3,[NLTN]LeJorge,3174,551,23,15,38,60.5%,19m
11928,3,blinkSCV,3174,518,22,14,36,61.1%,5m
11928,3,MasterSquid,3174,507,21,16,37,56.8%,17m
11928,3,ZestisBest,3174,353,18,6,24,75.0%,27m
11928,3,Aiden,3174,294,15,11,26,57.7%,18m
11928,2,HaSingPlay,3174,260,10,9,19,52.6%,14m
11928,1,MadDogWest,3174,140,7,4,11,63.6%,2h
11928,3,masbot,3174,186,6,4,10,60.0%,13m
11928,3,[Alpha8]Paleocon,3174,189,6,5,11,54.5%,17m
11928,3,Yair,3174,93,4,0,4,100.0%,6m
11928,3,JFurtive,3174,76,3,6,9,33.3%,7m
11928,3,Solarian,3174,94,2,0,2,100.0%,11m
11928,3,DemiurgeF,3174,95,2,0,2,100.0%,34m
11928,3,Problems,3174,0,1,1,2,50.0%,36m
11955,3,[LQV]THEPRODUCTOR,3173,1579,363,369,732,49.6%,7m
11955,3,[Th3Bad]LadyDasCasta,3173,1549,156,129,285,54.7%,38m
11955,3,[D0J0]Trijiro,3173,1542,119,97,216,55.1%,23m
11955,3,TamBerry,3173,1052,106,103,209,50.7%,20m
11955,3,Scorpion,3173,1425,74,27,101,73.3%,42m
11955,3,[LgnTDS]Rhasta,3173,423,65,49,114,57.0%,5m
11955,3,ArctuL,3173,1428,56,55,111,50.5%,38m
11955,3,[BGPP]NatchArc,3173,931,55,28,83,66.3%,30m
11955,3,Barry,3173,1244,54,43,97,55.7%,13m
11955,3,[REIKI]NonMeltIce,3173,1054,50,31,81,61.7%,16m
11955,3,RevlutionMan,3173,494,22,12,34,64.7%,12m
11955,3,valasco,3173,380,21,17,38,55.3%,42m
11955,3,IlIlIlIlIlIl,3173,362,16,5,21,76.2%,24m
11955,3,IronMario,3173,326,15,14,29,51.7%,4m
11955,2,piofagivens,3173,166,7,2,9,77.8%,2h
11955,2,RogueProbe,3173,151,5,1,6,83.3%,42m
11955,3,Jyten,3173,125,5,4,9,55.6%,16m
11955,3,[NoTeam]Density,3173,114,4,5,9,44.4%,25m
11955,3,[WOTDL]ALUCARD,3173,115,3,1,4,75.0%,31m
11955,3,Zurat,3173,115,2,2,4,50.0%,15m
11955,3,Schuman,3173,62,2,4,6,33.3%,6m
11955,3,[PiGPan]Singularity,3173,30,1,4,5,20.0%,7m
11955,3,BrentheGreat,3173,0,0,1,1,0.0%,18m
11955,3,[HAV0C]Nitrobilly,3173,0,0,1,1,0.0%,26m
11955,3,Basik,3173,0,0,1,1,0.0%,18m
11955,2,[nieBla]Heinsenberg,3173,0,0,1,1,0.0%,13m
11981,3,[WyWs]Scottyflip,3172,1135,127,132,259,49.0%,21m
11981,3,[xARGx]FallpaESP,3172,1521,102,81,183,55.7%,29m
11981,3,CobraLin,3172,872,82,72,154,53.2%,12m
11981,3,[gotBTC]Revenant,3172,939,57,44,101,56.4%,39m
11981,3,Saskuk,3172,1196,44,48,92,47.8%,37m
11981,3,[ZTemp]Sequence,3172,867,35,31,66,53.0%,14m
11981,3,[xTQc]PokeToss,3172,658,34,18,52,65.4%,17m
11981,3,thatguy,3172,756,33,42,75,44.0%,28m
11981,3,[JaMiT]BLiTzD,3172,730,27,28,55,49.1%,10m
11981,3,Prometheus,3172,574,25,15,40,62.5%,27m
11981,3,Phantera,3172,664,25,27,52,48.1%,23m
11981,3,AREPO,3172,494,21,12,33,63.6%,28m
11981,3,Rolendubs,3172,457,17,15,32,53.1%,27m
11981,3,backspace,3172,414,17,16,33,51.5%,23m
11981,3,Zeratul,3172,283,16,4,20,80.0%,42m
11981,3,[ML]Evilmeow,3172,229,11,7,18,61.1%,13m
11981,3,[DpY]ionCaNNoN,3172,304,10,8,18,55.6%,28m
11981,3,SadKingBilly,3172,146,7,4,11,63.6%,21m
11981,3,[SsaYnS]ArsisThesis,3172,203,6,4,10,60.0%,41m
11981,3,[LPEM]mercenarioas,3172,0,5,0,5,100.0%,7m
11981,3,Lamboemp,3172,30,5,2,7,71.4%,25m
11981,3,[LCE]WilliamsDK,3172,191,5,5,10,50.0%,42m
11981,3,INGFERNUS,3172,0,4,1,5,80.0%,4m
11981,3,Smithsonian,3172,134,3,3,6,50.0%,32m
11981,3,[PLOY]Nuffen,3172,60,3,5,8,37.5%,24m
11981,3,Takuah,3172,0,1,0,1,100.0%,20m
11981,3,Gamblelord,3172,0,0,1,1,0.0%,12m
11981,3,[DKGLL]KALDALIZ,3172,0,0,2,2,0.0%,32m
12009,3,[Ash3s]OMNIPOTENT,3171,1196,191,156,347,55.0%,31m
12009,3,CaptainHook,3171,685,92,15,107,86.0%,14m
12009,3,klye,3171,1191,86,79,165,52.1%,20m
12009,3,TotalDamage,3171,490,71,60,131,54.2%,21m
12009,3,syrus,3171,541,53,48,101,52.5%,31m
12009,3,[GanGan]KleberKM,3171,920,44,37,81,54.3%,25m
12009,3,Altervise,3171,763,42,33,75,56.0%,12m
12009,3,StackinSats,3171,462,42,36,78,53.8%,12m
12009,3,Seveso,3171,835,42,40,82,51.2%,25m
12009,3,[Flam3s]UncleElroy,3171,1031,41,41,82,50.0%,26m
12009,3,[3210]countzero,3171,785,34,24,58,58.6%,36m
12009,3,Vague,3171,802,33,26,59,55.9%,42m
12009,3,[5Head]MacroToss,3171,511,21,13,34,61.8%,20m
12009,3,[cbox]Aronator,3171,262,10,3,13,76.9%,36m
12009,3,Choukaki,3171,195,7,4,11,63.6%,30m
12009,3,Samxad,3171,176,6,10,16,37.5%,6m
12009,3,ChugCafeBro,3171,158,5,2,7,71.4%,7m
12009,3,NoobGaming,3171,135,4,0,4,100.0%,27m
12009,1,[CatRG]Harambe,3171,192,4,3,7,57.1%,10m
12009,3,Nukular,3171,117,3,0,3,100.0%,5m
12009,3,PresterJohn,3171,120,3,1,4,75.0%,9m
12009,1,mosu,3171,120,3,2,5,60.0%,13m
12009,3,PatatoBRAINS,3171,0,2,0,2,100.0%,2h
12009,3,Murica,3171,30,2,1,3,66.7%,30m
12009,3,Elucidated,3171,0,2,2,4,50.0%,21m
12009,3,[PFartz]Retwep,3171,0,2,3,5,40.0%,41m
12009,3,PeaceKeeper,3171,30,1,3,4,25.0%,17m
12009,3,RYAN,3171,0,0,1,1,0.0%,27m
12037,3,Socvam,3170,1585,414,398,812,51.0%,15m
12037,3,Arael,3170,1497,111,112,223,49.8%,18m
12037,3,BenRichards,3170,295,62,69,131,47.3%,21m
12037,3,[HBNC]hbdisfoo,3170,370,54,45,99,54.5%,5m
12037,3,BonerGuideMe,3170,957,47,32,79,59.5%,20m
12037,3,[MDKftw]DbleAron,3170,1167,45,44,89,50.6%,7m
12037,3,Nycrande,3170,444,21,9,30,70.0%,6m
12037,3,Gale,3170,476,21,9,30,70.0%,26m
12037,3,GhostDog,3170,219,20,6,26,76.9%,18m
12037,2,afuzzybird,3170,320,15,5,20,75.0%,41m
12037,2,MoistCheeser,3170,350,15,7,22,68.2%,35m
12037,3,SleepyJoe,3170,206,9,4,13,69.2%,11m
12037,3,DraboK,3170,230,9,11,20,45.0%,12m
12037,3,Seafoam,3170,198,7,3,10,70.0%,4m
12037,3,[Tensor]sLing,3170,93,3,3,6,50.0%,21m
12037,3,Petrichor,3170,111,2,2,4,50.0%,44m
12037,3,[SANGRE]index,3170,0,1,0,1,100.0%,13m
12037,3,[9bit]TheVoice,3170,30,1,3,4,25.0%,37m
12037,3,KingDice,3170,0,0,1,1,0.0%,7m
12056,3,chris,3169,1299,222,195,417,53.2%,12m
12056,3,HEXLET,3169,1481,137,111,248,55.2%,39m
12056,3,[FxB]dere,3169,1310,130,120,250,52.0%,11m
12056,3,IamMrV,3169,392,54,49,103,52.4%,8m
12056,3,KdxA,3169,1549,54,72,126,42.9%,21m
12056,3,[YWIG]Kitoragi,3169,496,53,42,95,55.8%,6m
12056,3,etxeberrik,3169,432,46,37,83,55.4%,17m
12056,3,[ALaCR]Drunko,3169,163,44,29,73,60.3%,40m
12056,3,[Shota]Lakshmi,3169,1005,42,35,77,54.5%,21m
12056,3,Kioal,3169,498,36,9,45,80.0%,28m
12056,3,Mabrox,3169,954,35,37,72,48.6%,18m
12056,3,Volley,3169,375,30,13,43,69.8%,4m
12056,3,Xin,3169,296,26,12,38,68.4%,36m
12056,3,skeith,3169,551,25,24,49,51.0%,21m
12056,3,Anthonee,3169,248,15,12,27,55.6%,6m
12056,3,Dovle,3169,341,13,6,19,68.4%,25m
12056,3,DYLue,3169,273,12,2,14,85.7%,33m
12056,3,[lNno]Obzidion,3169,332,12,14,26,46.2%,21m
12056,3,JKD,3169,149,12,15,27,44.4%,38m
12056,3,BioHazard,3169,148,6,5,11,54.5%,38m
12056,3,Pencil,3169,184,5,3,8,62.5%,25m
12056,3,RedPepper,3169,113,5,3,8,62.5%,42m
12056,3,Prawn,3169,90,5,4,9,55.6%,22m
12056,3,KORllllll,3169,151,5,5,10,50.0%,5m
12056,3,Assissino,3169,170,5,8,13,38.5%,36m
12056,3,Tyrcelin,3169,60,3,2,5,60.0%,26m
12056,3,SkynetIII,3169,0,3,3,6,50.0%,4m
12056,1,MegaMariner,3169,87,3,4,7,42.9%,32m
12056,2,PCB,3169,139,2,3,5,40.0%,1h
12056,3,[Golds]PyeonSukkk,3169,58,2,4,6,33.3%,40m
12056,2,BlueBear,3169,0,1,0,1,100.0%,2h
12056,3,Quackpork,3169,0,0,1,1,0.0%,40m
12056,3,lemonseeds,3169,0,0,1,1,0.0%,23m
12056,3,[TnE]EdZ,3169,0,0,4,4,0.0%,25m
12090,3,Schweder,3168,988,336,310,646,52.0%,39m
12090,3,[ZpaceX]KingGuacamol,3168,1571,335,322,657,51.0%,10m
12090,3,MarauderHK,3168,1502,252,254,506,49.8%,25m
12090,3,[GT2020]Estiven,3168,781,174,151,325,53.5%,20m
12090,3,ceru,3168,1473,169,160,329,51.4%,18m
12090,3,Cream,3168,1558,154,133,287,53.7%,27m
12090,3,XxDurielxX,3168,1588,120,125,245,49.0%,36m
12090,3,slackTOSS,3168,1299,113,81,194,58.2%,13m
12090,3,homosexaul,3168,1440,79,56,135,58.5%,30m
12090,3,iamTomSawyer,3168,1564,65,64,129,50.4%,20m
12090,3,kimchee,3168,1368,56,52,108,51.9%,30m
12090,3,iLoveCrack,3168,421,55,31,86,64.0%,6m
12090,3,Wooli,3168,567,46,5,51,90.2%,17m
12090,3,Phoenix,3168,447,38,37,75,50.7%,13m
12090,3,[Mc]IMHulk,3168,692,30,25,55,54.5%,42m
12090,3,Atlas,3168,645,29,16,45,64.4%,21m
12090,3,[909090]MrDavJux,3168,573,27,12,39,69.2%,39m
12090,3,DarkKnight,3168,541,27,16,43,62.8%,21m
12090,3,DidUrSisGood,3168,196,26,19,45,57.8%,17m
12090,3,[Xpk]kairos,3168,462,17,18,35,48.6%,4m
12090,3,IHATEGAMES,3168,256,12,7,19,63.2%,41m
12090,3,[DRKAPP]YOLO,3168,318,11,18,29,37.9%,3m
12090,3,luisito,3168,248,10,3,13,76.9%,30m
12090,3,DreWRanger,3168,148,4,3,7,57.1%,6m
12090,3,RaynorsRaid,3168,58,4,5,9,44.4%,20m
12090,3,Titin,3168,0,3,2,5,60.0%,43m
12090,3,NiceHat,3168,0,3,2,5,60.0%,37m
12090,3,[DTALK]SnowKong,3168,95,2,0,2,100.0%,3m
12090,3,BlackVoid,3168,0,1,0,1,100.0%,20m
12090,3,BossTossJr,3168,0,1,0,1,100.0%,30m
12090,3,[PTHero]Vampire,3168,0,1,1,2,50.0%,27m
12090,3,NoFear,3168,0,0,1,1,0.0%,5m
12090,3,ANDROS,3168,0,0,1,1,0.0%,12m
12123,3,[GdAT]Polaris,3167,1553,302,292,594,50.8%,20m
12123,3,Teleren,3167,1502,253,202,455,55.6%,11m
12123,3,Buck,3167,1569,132,126,258,51.2%,42m
12123,3,[NoSlep]ProtossDeity,3167,1191,76,72,148,51.4%,30m
12123,3,STATS,3167,1611,71,72,143,49.7%,20m
12123,3,Survive,3167,347,47,32,79,59.5%,6m
12123,3,[DhZAc1]VERDÃO,3167,864,44,29,73,60.3%,26m
12123,3,[PNS]Pretu,3167,572,42,30,72,58.3%,15m
12123,3,honk,3167,871,37,31,68,54.4%,27m
12123,3,imlizzing,3167,947,36,34,70,51.4%,42m
12123,3,[SASC]GingerRabbit,3167,1004,36,44,80,45.0%,37m
12123,3,FartGoblin,3167,344,25,22,47,53.2%,6m
12123,3,YaMajesty,3167,631,24,25,49,49.0%,26m
12123,3,Pwnography,3167,106,21,14,35,60.0%,34m
12123,3,[tCo9]Archcamus,3167,546,21,20,41,51.2%,30m
12123,3,[4LOBOS]Anibal,3167,537,19,17,36,52.8%,21m
12123,3,HappY,3167,387,16,13,29,55.2%,44m
12123,3,SENDEL,3167,368,13,10,23,56.5%,24m
12123,3,[CNSC]Aleire,3167,165,5,2,7,71.4%,31m
12123,3,xXRhyex,3167,134,4,1,5,80.0%,31m
12123,3,Oracle,3167,94,4,2,6,66.7%,19m
12123,3,LeoMinelli,3167,111,2,2,4,50.0%,18m
12123,3,mapletree,3167,93,1,1,2,50.0%,10m
12123,2,[SBoys]sPiN,3167,94,1,1,2,50.0%,2h
12123,3,[YS420]Shaffty,3167,0,0,1,1,0.0%,30m
12123,2,[WlLLYS]FirstToDie,3167,0,0,2,2,0.0%,21m
12149,3,Wolverine,3166,1402,213,191,404,52.7%,41m
12149,3,[Calx]SindeL,3166,1547,123,129,252,48.8%,40m
12149,3,urlose,3166,1498,75,38,113,66.4%,42m
12149,3,Qikaiyao,3166,1347,68,66,134,50.7%,26m
12149,3,PotatoPc,3166,463,49,33,82,59.8%,42m
12149,3,CobbSalad,3166,603,48,39,87,55.2%,36m
12149,3,SharkBait,3166,354,32,31,63,50.8%,9m
12149,3,AngelAlado,3166,666,25,36,61,41.0%,42m
12149,3,NullPointer,3166,532,19,23,42,45.2%,22m
12149,3,hereicome,3166,460,16,20,36,44.4%,37m
12149,3,pog,3166,372,15,12,27,55.6%,27m
12149,3,Jello,3166,154,14,13,27,51.9%,40m
12149,3,MrBigshot,3166,396,14,18,32,43.8%,38m
12149,3,GoldenPants,3166,293,10,6,16,62.5%,10m
12149,3,Eldnor,3166,187,9,5,14,64.3%,11m
12149,3,Saulo,3166,234,8,13,21,38.1%,38m
12149,3,DrCharles,3166,216,7,5,12,58.3%,8m
12149,3,MrMad,3166,239,7,7,14,50.0%,26m
12149,3,CRUNCHYNUHT,3166,156,5,14,19,26.3%,30m
12149,3,Teogenes,3166,143,4,2,6,66.7%,40m
12149,3,FretfuL,3166,0,3,3,6,50.0%,16m
12149,3,kado,3166,30,2,1,3,66.7%,8m
12149,2,sKout,3166,0,0,1,1,0.0%,3h
12149,3,Alexinds,3166,0,0,1,1,0.0%,30m
12149,3,Alicc,3166,0,0,1,1,0.0%,14m
12174,2,[DNKCFT]Glowfly,3165,1549,255,249,504,50.6%,19m
12174,3,[UpxV]tonylechuga,3165,1558,240,205,445,53.9%,11m
12174,3,spacecawk,3165,1532,194,185,379,51.2%,6m
12174,3,Saicess,3165,1218,156,132,288,54.2%,29m
12174,3,[GYEA]HoneyPops,3165,1379,131,117,248,52.8%,44m
12174,3,PATAR,3165,749,112,96,208,53.8%,30m
12174,2,UNCLEWESSY,3165,1204,85,92,177,48.0%,23m
12174,3,Dante,3165,1260,70,46,116,60.3%,37m
12174,3,PurpleInvazn,3165,738,65,50,115,56.5%,35m
12174,3,Bear,3165,1038,48,30,78,61.5%,13m
12174,3,Herb,3165,585,26,16,42,61.9%,42m
12174,3,[LgnTDS]Hawking,3165,484,16,23,39,41.0%,10m
12174,3,[EpicG]ElPatrick,3165,324,14,4,18,77.8%,25m
12174,3,[BoosS]OGTXIIIxBoSs,3165,285,13,7,20,65.0%,41m
12174,3,Entropy,3165,263,12,14,26,46.2%,39m
12174,3,PNUTBTRFLCN,3165,226,10,11,21,47.6%,30m
12174,3,[EBOD]Harbinger,3165,279,9,9,18,50.0%,38m
12174,1,Vesser,3165,235,8,2,10,80.0%,19m
12174,3,BeerCode,3165,189,7,1,8,87.5%,21m
12174,3,[PTHero]ConciseAlloy,3165,185,7,2,9,77.8%,42m
12174,3,PinoyPlayer,3165,209,6,6,12,50.0%,36m
12174,3,[DenSC2]Bear,3165,130,4,0,4,100.0%,38m
12174,3,Royal,3165,141,3,3,6,50.0%,6m
12174,1,[αX]Rushi,3165,130,3,15,18,16.7%,3m
12174,3,Jaiba,3165,94,2,0,2,100.0%,33m
12174,3,VSEPR,3165,30,2,2,4,50.0%,17m
12174,3,Amish,3165,111,2,2,4,50.0%,16m
12201,3,Lartith,3164,1138,214,195,409,52.3%,22m
12201,3,Nala,3164,1547,186,177,363,51.2%,43m
12201,3,WatterMelons,3164,1505,162,125,287,56.4%,22m
12201,3,Luddite,3164,1149,133,121,254,52.4%,18m
12201,3,GeneralJM,3164,887,73,51,124,58.9%,5m
12201,3,[REPORT]RaNdOmIzE,3164,690,66,43,109,60.6%,24m
12201,3,Greed,3164,866,51,36,87,58.6%,12m
12201,3,[GRUMEC]NabucAo,3164,1060,51,43,94,54.3%,42m
12201,3,PoCoYo,3164,314,50,28,78,64.1%,10m
12201,3,DarkFish,3164,921,48,29,77,62.3%,5m
12201,3,DirtyMick,3164,915,45,32,77,58.4%,18m
12201,3,SunDowner,3164,229,37,35,72,51.4%,12m
12201,3,GINTOKI,3164,690,31,19,50,62.0%,42m
12201,3,StarBaby,3164,619,25,23,48,52.1%,31m
12201,3,[αB]CaptainClub,3164,515,20,14,34,58.8%,29m
12201,3,Stanky,3164,345,14,7,21,66.7%,36m
12201,3,[RustLg]Akwala,3164,303,13,5,18,72.2%,13m
12201,3,Sidra,3164,303,10,8,18,55.6%,22m
12201,3,Trollmode,3164,286,10,9,19,52.6%,28m
12201,3,[SDC12]AltOfCtrl,3164,253,8,8,16,50.0%,17m
12201,3,alberttttttt,3164,214,7,4,11,63.6%,15m
12201,3,Jeff,3164,209,6,5,11,54.5%,27m
12201,3,Bajuware,3164,0,5,0,5,100.0%,11m
12201,3,[BTMold]twostreampee,3164,0,5,0,5,100.0%,23m
12201,3,[DC420]DanCLan,3164,142,5,8,13,38.5%,18m
12201,2,[JUIC3Y]WangerBanger,3164,142,4,1,5,80.0%,24m
12201,3,sharp,3164,147,4,2,6,66.7%,21m
12201,1,Bankai,3164,163,4,2,6,66.7%,2h
12201,3,Hydracus,3164,116,4,6,10,40.0%,13m
12201,3,Ace,3164,114,3,0,3,100.0%,16m
12201,2,ironlawyer,3164,94,2,0,2,100.0%,2h
12201,3,gravyBEAM,3164,92,2,0,2,100.0%,41m
12201,2,[OPGame]Vistatus,3164,91,2,0,2,100.0%,14m
12201,3,SoManySmurf,3164,30,2,1,3,66.7%,43m
12201,2,Chronic,3164,92,2,1,3,66.7%,2h
12201,3,jadO,3164,120,2,2,4,50.0%,5m
12201,3,[Krimsn]nevc,3164,0,2,3,5,40.0%,22m
12201,3,[AIlin]SickJan,3164,58,2,4,6,33.3%,38m
12201,3,Megahertz,3164,62,2,6,8,25.0%,42m
12201,3,JiisusChrist,3164,0,1,0,1,100.0%,15m
12201,3,Sum,3164,0,1,0,1,100.0%,33m
12201,2,Camo,3164,0,1,1,2,50.0%,24m
12201,3,sincostan,3164,0,1,2,3,33.3%,39m
12201,3,noobbz,3164,92,1,3,4,25.0%,24m
12201,3,[SOP]SOPbFresh,3164,0,0,1,1,0.0%,41m
12201,3,[VOLKDS]ElOriginal,3164,0,0,1,1,0.0%,8m
12201,2,Flyers,3164,0,0,1,1,0.0%,1h
12201,3,add,3164,0,0,2,2,0.0%,11m
12249,3,TifaTelui,3163,1301,150,110,260,57.7%,11m
12249,3,TANKnelson,3163,1533,136,122,258,52.7%,38m
12249,3,TheGosuPanda,3163,1002,125,109,234,53.4%,25m
12249,3,swish,3163,925,124,108,232,53.4%,24m
12249,3,Jaraxxus,3163,660,88,79,167,52.7%,11m
12249,3,JoJo,3163,688,69,53,122,56.6%,8m
12249,3,HeirApparent,3163,1394,67,72,139,48.2%,21m
12249,3,[Vales]Kalthazard,3163,551,40,15,55,72.7%,26m
12249,3,SickFlick,3163,378,38,21,59,64.4%,5m
12249,3,MagicPants,3163,533,23,14,37,62.2%,21m
12249,3,[blmp]mustardonrye,3163,496,20,13,33,60.6%,41m
12249,2,[FxB]Remain,3163,430,16,27,43,37.2%,28m
12249,3,[theBSL]Guyza,3163,351,14,8,22,63.6%,26m
12249,3,MacroKING,3163,259,9,5,14,64.3%,42m
12249,2,DAYULOUOXUAN,3163,239,9,6,15,60.0%,10m
12249,3,AsherBro,3163,168,5,2,7,71.4%,6m
12249,3,[GvSQD]GoveaKun,3163,177,5,3,8,62.5%,15m
12249,3,Snowman,3163,168,4,4,8,50.0%,18m
12249,3,Fixedhawnk,3163,114,3,0,3,100.0%,27m
12249,3,OLordHelmet,3163,30,2,2,4,50.0%,41m
12249,3,[ValidG]SafteScizors,3163,60,2,3,5,40.0%,5m
12249,3,YuriOrlov,3163,30,2,4,6,33.3%,39m
12249,3,Emily,3163,0,1,0,1,100.0%,21m
12249,3,eVo,3163,0,0,1,1,0.0%,17m
12249,3,Roach,3163,0,0,1,1,0.0%,27m
12249,3,[maSC]AKHUNTHELAR,3163,0,0,2,2,0.0%,12m
12249,3,IIIKalELIII,3163,0,0,2,2,0.0%,18m
12249,3,legacy,3163,0,0,2,2,0.0%,30m
12277,3,elhicham,3162,1635,608,590,1198,50.8%,5m
12277,3,[TPGGXD]turbonic,3162,1556,445,436,881,50.5%,18m
12277,3,Novixion,3162,1429,348,319,667,52.2%,31m
12277,3,Moose,3162,1470,161,159,320,50.3%,27m
12277,3,TSMsucks,3162,1513,152,120,272,55.9%,44m
12277,3,Jude,3162,1352,119,106,225,52.9%,42m
12277,3,Boondoggle,3162,1577,110,99,209,52.6%,17m
12277,3,Rabscuttle,3162,1465,99,87,186,53.2%,17m
12277,3,ChocoShadowx,3162,836,55,38,93,59.1%,4m
12277,3,Communist,3162,706,51,30,81,63.0%,10m
12277,3,doublespace,3162,526,41,31,72,56.9%,13m
12277,3,[TGosuA]OtterFamily,3162,910,37,30,67,55.2%,33m
12277,3,Andross,3162,371,33,28,61,54.1%,42m
12277,3,[DaeNA]will,3162,721,31,31,62,50.0%,32m
12277,3,Cheese,3162,344,26,9,35,74.3%,6m
12277,3,Mojo,3162,192,12,8,20,60.0%,26m
12277,3,Graham,3162,302,10,10,20,50.0%,8m
12277,3,Nystagmus,3162,265,9,7,16,56.2%,21m
12277,3,EnTaTassadar,3162,204,9,13,22,40.9%,15m
12277,3,HamChoi,3162,200,8,10,18,44.4%,7m
12277,3,ShadyDealer,3162,144,6,6,12,50.0%,36m
12277,3,Frankimahri,3162,126,4,2,6,66.7%,36m
12277,3,Dye,3162,0,3,2,5,60.0%,15m
12277,3,[CLEM]Soul,3162,102,2,2,4,50.0%,42m
12277,3,Sumpfdotter,3162,121,2,2,4,50.0%,24m
12277,3,[lPROGl]Kaster,3162,30,1,2,3,33.3%,21m
12277,3,EzTony,3162,0,0,1,1,0.0%,21m
12277,3,[TheGS]xXAmazingXx,3162,0,0,1,1,0.0%,12m
12277,3,HeckFrig,3162,0,0,2,2,0.0%,11m
12306,3,Neato,3161,1531,238,211,449,53.0%,13m
12306,3,SUN,3161,1493,168,167,335,50.1%,24m
12306,3,TheKraken,3161,1135,107,89,196,54.6%,7m
12306,3,Auditor,3161,1439,88,37,125,70.4%,31m
12306,3,Rizlatnar,3161,1427,82,72,154,53.2%,20m
12306,3,[SANGRE]Yamil,3161,748,57,41,98,58.2%,32m
12306,3,Remaining,3161,1324,55,54,109,50.5%,12m
12306,3,StalkHer,3161,1233,53,43,96,55.2%,44m
12306,3,[Quetza]Warsong,3161,1113,51,37,88,58.0%,29m
12306,3,anthracryt,3161,1030,49,32,81,60.5%,11m
12306,3,SavirNitram,3161,498,22,11,33,66.7%,8m
12306,3,[TGosuB]GreenDevil,3161,311,20,10,30,66.7%,38m
12306,3,PeaCe,3161,392,18,15,33,54.5%,23m
12306,3,cshep,3161,330,13,8,21,61.9%,8m
12306,3,IIIIIIIIIIII,3161,305,13,10,23,56.5%,8m
12306,3,matoskunk,3161,265,10,5,15,66.7%,24m
12306,3,[BeDilf]iPhoneWHO,3161,230,10,6,16,62.5%,28m
12306,3,[Pharoh]Erikor,3161,229,8,4,12,66.7%,22m
12306,3,poisonlight,3161,245,8,4,12,66.7%,13m
12306,3,[OPOUI]themadnoah,3161,237,8,10,18,44.4%,44m
12306,3,Borg,3161,166,7,2,9,77.8%,32m
12306,3,[CSUF]ImGMbtw,3161,214,7,4,11,63.6%,12m
12306,3,[revix]Generaxor,3161,196,6,2,8,75.0%,24m
12306,3,[CGJB]JeanBart,3161,172,6,3,9,66.7%,28m
12306,3,BoosterGold,3161,97,5,1,6,83.3%,32m
12306,3,Eskae,3161,170,5,3,8,62.5%,7m
12306,3,Joey,3161,175,5,4,9,55.6%,26m
12306,3,[Devout]CountAlias,3161,188,5,4,9,55.6%,28m
12306,3,[TGCF]SneekySheeks,3161,0,4,1,5,80.0%,31m
12306,3,[CotN]Nemitor,3161,0,3,0,3,100.0%,37m
12306,3,BigWish,3161,115,2,1,3,66.7%,36m
12306,3,JENKINS,3161,0,1,0,1,100.0%,20m
12306,3,YouBryant,3161,0,1,0,1,100.0%,32m
12306,3,nebrkeronios,3161,0,0,1,1,0.0%,30m
12340,3,Pranaria,3160,1453,203,197,400,50.8%,38m
12340,3,SteelBoots,3160,1557,153,146,299,51.2%,20m
12340,3,FancyBear,3160,1628,115,100,215,53.5%,21m
12340,3,BalRog,3160,1521,99,68,167,59.3%,24m
12340,3,xlx,3160,1505,74,74,148,50.0%,30m
12340,3,LuckyLarry,3160,475,69,38,107,64.5%,10m
12340,3,[Msia]lOOO,3160,913,40,27,67,59.7%,17m
12340,3,superNinja,3160,892,39,32,71,54.9%,36m
12340,3,[Larvax]FcoMD,3160,326,17,6,23,73.9%,30m
12340,3,llllllllll,3160,414,15,12,27,55.6%,13m
12340,3,Woweyz,3160,364,15,12,27,55.6%,24m
12340,3,heartbreakr,3160,229,11,6,17,64.7%,13m
12340,1,llllllllllll,3160,243,9,4,13,69.2%,1h
12340,2,Success,3160,168,7,3,10,70.0%,1h
12340,3,JtheNinja,3160,222,7,6,13,53.8%,10m
12340,3,Ghostface,3160,0,5,0,5,100.0%,2h
12340,1,KAEL,3160,166,4,2,6,66.7%,6m
12340,3,plsdont,3160,142,3,3,6,50.0%,20m
12340,3,Arthur,3160,86,3,6,9,33.3%,21m
12340,3,[HGDO]ColdHands,3160,96,2,1,3,66.7%,22m
12340,3,Dominus,3160,121,2,7,9,22.2%,8m
12340,1,BearGrylls,3160,0,1,0,1,100.0%,9m
12340,3,TurnipHead,3160,0,1,4,5,20.0%,2h
12340,3,doidenho,3160,0,0,2,2,0.0%,29m
12364,3,BluBlaBleBla,3159,1580,155,155,310,50.0%,21m
12364,3,Maduin,3159,716,77,64,141,54.6%,31m
12364,3,Rascal,3159,316,49,36,85,57.6%,4m
12364,3,BENTANCUR,3159,1043,39,38,77,50.6%,19m
12364,3,[Heath]Ragnarath,3159,280,20,27,47,42.6%,27m
12364,1,Aragorn,3159,430,18,11,29,62.1%,25m
12364,3,Gamuda,3159,276,16,7,23,69.6%,26m
12364,1,aners,3159,315,12,7,19,63.2%,17m
12364,3,SAM,3159,247,10,5,15,66.7%,39m
12364,1,[KORLuV]TWICE,3159,208,9,4,13,69.2%,2h
12364,3,Liminal,3159,217,6,7,13,46.2%,32m
12364,1,WillSTwister,3159,0,4,1,5,80.0%,36m
12364,1,Curtmasterfl,3159,173,4,2,6,66.7%,36m
12364,1,ThePatriot,3159,120,3,1,4,75.0%,38m
12364,3,Kashkavala,3159,135,3,5,8,37.5%,20m
12364,3,Egoist,3159,30,2,2,4,50.0%,26m
12364,1,bronzehero,3159,0,1,0,1,100.0%,37m
12364,3,LAN,3159,0,1,1,2,50.0%,33m
12364,3,[PASTY]rootbeer,3159,0,0,1,1,0.0%,29m
12364,1,Khonsu,3159,0,0,1,1,0.0%,42m
12364,1,Takú,3159,0,0,1,1,0.0%,23m
12385,3,Garbage,3158,1503,70,50,120,58.3%,28m
12385,3,Andersong,3158,896,68,45,113,60.2%,12m
12385,3,[CrnKy]MeoMaikasCat,3158,1568,64,56,120,53.3%,36m
12385,3,Kessel,3158,502,52,51,103,50.5%,38m
12385,3,paul,3158,814,27,46,73,37.0%,24m
12385,3,[αB]Duckpool,3158,341,11,10,21,52.4%,6m
12385,3,roroo,3158,0,4,1,5,80.0%,23m
12385,3,ChozoToss,3158,122,4,10,14,28.6%,3m
12385,3,Buckinbean,3158,58,3,6,9,33.3%,33m
12385,3,DreamAtlas,3158,32,2,3,5,40.0%,40m
12395,3,Eclipse,3157,1348,170,150,320,53.1%,38m
12395,3,Mousline,3157,575,57,48,105,54.3%,13m
12395,1,Lulbino,3157,723,41,28,69,59.4%,31m
12395,3,TheMondays,3157,1039,41,38,79,51.9%,29m
12395,2,Nihilist,3157,119,5,5,10,50.0%,42m
12395,3,Beta,3157,121,2,10,12,16.7%,43m
12395,3,[1PA]FTW,3157,0,1,2,3,33.3%,30m
12395,1,Dhjon,3157,0,0,3,3,0.0%,38m
12403,3,[22Corp]Odarnoc,3156,1180,154,150,304,50.7%,27m
12403,3,[eX]Koébro,3156,992,68,58,126,54.0%,8m
12403,3,SAC,3156,529,47,57,104,45.2%,44m
12403,1,McBreez,3156,877,33,17,50,66.0%,35m
12403,3,SKLLKRSH,3156,866,32,38,70,45.7%,20m
12403,3,Logoz,3156,562,29,10,39,74.4%,40m
12403,3,Trips,3156,632,28,26,54,51.9%,10m
12403,1,polololo,3156,694,21,18,39,53.8%,4m
12403,3,Noxious,3156,289,12,7,19,63.2%,16m
12403,3,Granulaat,3156,297,10,7,17,58.8%,14m
12403,3,[ouin]Wyck,3156,95,2,1,3,66.7%,11m
12403,3,Discord,3156,0,1,2,3,33.3%,44m
12403,3,Phoenix,3156,0,0,1,1,0.0%,8m
12403,1,[SRiC]Obsidian,3156,0,0,1,1,0.0%,32m
12403,1,[BONES]Knight,3156,0,0,1,1,0.0%,40m
12403,3,HeyPerson,3156,0,0,3,3,0.0%,17m
12419,3,Gorgon,3155,1574,205,186,391,52.4%,33m
12419,3,BearFighter,3155,1531,181,187,368,49.2%,41m
12419,3,Vince,3155,1396,128,117,245,52.2%,42m
12419,2,IJVH,3155,482,60,62,122,49.2%,27m
12419,3,MeowMaster,3155,1402,54,52,106,50.9%,26m
12419,1,[DR4G]PwndaBear,3155,476,25,13,38,65.8%,25m
12419,3,mrweinen,3155,556,25,20,45,55.6%,27m
12419,3,Kagumi,3155,475,20,19,39,51.3%,28m
12419,3,HappyPants,3155,140,4,2,6,66.7%,8m
12419,2,Doughboy,3155,0,4,2,6,66.7%,2h
12419,1,Crethzor,3155,184,4,2,6,66.7%,14m
12419,1,ENIAC,3155,143,3,7,10,30.0%,3h
12419,3,[SH0]Primous,3155,123,2,2,4,50.0%,25m
12419,1,Darling,3155,0,0,1,1,0.0%,16m
12433,3,MakeMake,3154,807,38,26,64,59.4%,7m
12433,1,TeamAwesome,3154,872,36,27,63,57.1%,17m
12433,3,Jessiebot,3154,405,22,22,44,50.0%,22m
12433,3,[GgARMY]TaitaCáceres,3154,400,16,10,26,61.5%,11m
12433,3,LaBonte,3154,318,11,19,30,36.7%,13m
12433,3,acesino,3154,344,11,22,33,33.3%,20m
12433,3,IUsaures,3154,86,7,4,11,63.6%,7m
12433,3,iCreal,3154,139,6,4,10,60.0%,32m
12433,1,YenYeri,3154,213,6,11,17,35.3%,32m
12433,1,[8iSh]TheKazootie,3154,196,5,3,8,62.5%,28m
12433,3,[AWU]Psamathos,3154,0,4,1,5,80.0%,2h
12433,1,ferdbold,3154,0,4,1,5,80.0%,35m
12433,2,DuxDucis,3154,115,4,4,8,50.0%,2h
12433,3,Johan,3154,32,4,7,11,36.4%,6m
12433,3,NotAKorean,3154,146,3,4,7,42.9%,16m
12433,1,[7APM]WiToWsky,3154,40,2,0,2,100.0%,37m
12433,1,[Unlike]Shinigamy,3154,0,1,0,1,100.0%,16m
12433,1,ASong,3154,44,1,1,2,50.0%,38m
12433,3,DTeezNutz,3154,0,0,1,1,0.0%,8m
12452,3,TripleDeke,3153,1505,253,245,498,50.8%,20m
12452,3,[Gaemer]IIIIIIIIIIII,3153,1283,109,85,194,56.2%,6m
12452,3,FishAndChips,3153,404,77,56,133,57.9%,4m
12452,3,[Hesa]flanaganapus,3153,1130,45,45,90,50.0%,9m
12452,1,iSoberbia,3153,1162,43,33,76,56.6%,6m
12452,3,[InGt]Sleepycook,3153,234,9,9,18,50.0%,5m
12452,3,ParanoidMarv,3153,209,8,11,19,42.1%,22m
12452,3,hyrican,3153,190,6,4,10,60.0%,11m
12452,2,Spoon,3153,95,5,3,8,62.5%,4m
12452,3,Citizenkangg,3153,0,3,2,5,60.0%,1h
12452,3,[tCo9]THExOMEGA,3153,30,2,2,4,50.0%,38m
12452,3,[NPhasA]Sketch,3153,116,2,2,4,50.0%,4m
12452,3,[ScSwrm]Kaigem,3153,30,2,9,11,18.2%,30m
12452,3,[TMxA]MightyPear,3153,30,1,8,9,11.1%,7m
12452,1,Fadatats,3153,0,0,1,1,0.0%,31m
12452,3,[LGNxx]eVoPopo,3153,0,0,6,6,0.0%,33m
12468,3,TrumpTrain,3152,1572,127,119,246,51.6%,12m
12468,1,Mark,3152,1194,91,75,166,54.8%,29m
12468,3,[lLiTl]Maykoto,3152,1519,76,67,143,53.1%,27m
12468,3,Jack,3152,574,44,51,95,46.3%,10m
12468,3,Shnurb,3152,880,30,41,71,42.3%,21m
12468,3,whitecrusada,3152,564,28,11,39,71.8%,31m
12468,3,[MOMRF]flamingcheto,3152,596,23,19,42,54.8%,26m
12468,3,oTIMELESSo,3152,662,23,29,52,44.2%,42m
12468,3,[GOURDS]APD,3152,489,21,17,38,55.3%,21m
12468,3,Zorba,3152,184,19,20,39,48.7%,8m
12468,3,narghwar,3152,358,13,11,24,54.2%,26m
12468,3,Gamma,3152,268,9,15,24,37.5%,28m
12468,2,[1vsM]NovasKotiA,3152,142,6,3,9,66.7%,27m
12468,3,SYLAR,3152,176,6,4,10,60.0%,8m
12468,3,Verticoli,3152,42,5,2,7,71.4%,1h
12468,3,[flexed]AIDAN,3152,122,5,6,11,45.5%,13m
12468,1,ega,3152,0,4,1,5,80.0%,29m
12468,1,imCookies,3152,0,3,2,5,60.0%,40m
12468,1,Saga,3152,42,2,0,2,100.0%,15m
12468,1,Jargazes,3152,84,2,2,4,50.0%,41m
12468,1,Nubskillz,3152,0,1,0,1,100.0%,6m
12468,2,[xeMgx]PepperMaromi,3152,0,1,0,1,100.0%,2h
12468,3,Svyn,3152,0,0,2,2,0.0%,4m
12468,3,TostadaLoca,3152,0,0,4,4,0.0%,19m
12492,3,Hex,3151,1273,105,96,201,52.2%,16m
12492,3,BarbadosSlim,3151,563,84,95,179,46.9%,21m
12492,3,nevus,3151,1574,70,54,124,56.5%,13m
12492,3,robbie,3151,1425,68,54,122,55.7%,42m
12492,3,[KODO19]kbev,3151,1426,68,55,123,55.3%,4m
12492,3,DaytimeNight,3151,954,60,53,113,53.1%,29m
12492,3,[SKES]SubMarine,3151,1286,54,41,95,56.8%,15m
12492,3,Zenith,3151,136,24,20,44,54.5%,21m
12492,3,xalalaô,3151,584,23,21,44,52.3%,4m
12492,1,Imperium,3151,400,14,11,25,56.0%,16m
12492,3,[SMB]GameOfDrones,3151,369,14,12,26,53.8%,6m
12492,1,SOS,3151,162,8,8,16,50.0%,20m
12492,3,Mingy,3151,103,8,17,25,32.0%,33m
12492,3,zeb,3151,146,7,9,16,43.8%,40m
12492,2,CrossS,3151,94,5,2,7,71.4%,2h
12492,1,Sora,3151,122,4,1,5,80.0%,23m
12492,3,ElleWhySee,3151,0,2,4,6,33.3%,18m
12492,1,yNeris,3151,96,1,2,3,33.3%,16m
12492,1,shcoffin,3151,0,0,1,1,0.0%,6m
12492,1,Androide,3151,0,0,1,1,0.0%,23m
12492,1,[SC2ADD]PORTY,3151,0,0,1,1,0.0%,30m
12513,3,[DNKCFT]FappyToad,3150,1562,285,275,560,50.9%,20m
12513,3,ricardo,3150,1486,249,236,485,51.3%,9m
12513,3,[SurfC]Maths,3150,1163,126,119,245,51.4%,44m
12513,3,XONJONES,3150,1286,109,77,186,58.6%,27m
12513,3,[JRT]ReaperPy,3150,1100,109,86,195,55.9%,24m
12513,3,Waffle,3150,1109,96,85,181,53.0%,28m
12513,3,[SWlNE]Exedo,3150,1164,45,41,86,52.3%,12m
12513,3,ImbaSimba,3150,596,39,33,72,54.2%,29m
12513,3,ParAruia,3150,546,23,14,37,62.2%,24m
12513,3,[SIClan]morulis,3150,245,11,12,23,47.8%,38m
12513,3,MPL,3150,186,9,7,16,56.2%,10m
12513,3,Lumen,3150,86,4,5,9,44.4%,19m
12513,3,GeneralHam,3150,114,4,6,10,40.0%,16m
12513,3,[NwAs]Chero,3150,118,4,10,14,28.6%,19m
12513,1,Firewall,3150,40,2,0,2,100.0%,38m
12513,3,ggf,3150,0,1,0,1,100.0%,11m
12513,2,Soadaa,3150,94,1,1,2,50.0%,1h
12513,3,BeepBeepJeep,3150,0,1,3,4,25.0%,38m
12513,3,Arkham,3150,0,1,3,4,25.0%,5m
12513,1,SeungJae,3150,0,0,1,1,0.0%,25m
12513,3,BigUzii,3150,0,0,6,6,0.0%,24m
12534,3,Flurry,3149,1213,86,71,157,54.8%,22m
12534,3,Terran,3149,1325,64,59,123,52.0%,11m
12534,1,Biggidibbi,3149,339,14,2,16,87.5%,41m
12534,3,Protozoo,3149,397,14,11,25,56.0%,30m
12534,1,sleepybear,3149,165,7,2,9,77.8%,19m
12534,3,Light,3149,0,5,4,9,55.6%,6m
12534,1,schasmyvcard,3149,0,3,2,5,60.0%,11m
12534,1,RascaL,3149,0,1,0,1,100.0%,6m
12534,3,Siegelink,3149,0,1,1,2,50.0%,10m
12534,3,Nico,3149,95,1,2,3,33.3%,25m
12544,3,[Th3Bad]ToadPoa,3148,1501,132,135,267,49.4%,18m
12544,3,Garden,3148,1035,89,74,163,54.6%,19m
12544,3,Setsuna,3148,1560,67,58,125,53.6%,21m
12544,1,ElMano,3148,938,58,29,87,66.7%,6m
12544,3,CycloG,3148,219,38,32,70,54.3%,24m
12544,3,InspireAloha,3148,620,28,15,43,65.1%,17m
12544,3,orion,3148,485,25,18,43,58.1%,10m
12544,1,ABC,3148,547,21,5,26,80.8%,16m
12544,3,BiggJoe,3148,238,15,11,26,57.7%,36m
12544,3,Kramer,3148,252,9,5,14,64.3%,4m
12544,3,CREAMPIELORD,3148,242,9,11,20,45.0%,3m
12544,3,Ender,3148,252,8,6,14,57.1%,26m
12544,3,Grybyx,3148,56,5,8,13,38.5%,41m
12544,3,[HOMOF]PurpleYoshi,3148,156,4,3,7,57.1%,8m
12544,3,tInyHMAN,3148,144,4,5,9,44.4%,21m
12544,1,Paradox,3148,42,2,1,3,66.7%,16m
12544,3,Profit,3148,30,2,2,4,50.0%,41m
12544,3,[TMKOs]Sebantegui,3148,60,2,4,6,33.3%,12m
12544,1,YuKsS,3148,0,1,6,7,14.3%,2h
12544,1,[425]DMike,3148,0,0,1,1,0.0%,12m
12544,3,[TgAg]Sony,3148,0,0,2,2,0.0%,31m
12565,3,rafocaina,3147,1598,325,299,624,52.1%,17m
12565,3,Noja,3147,1573,75,58,133,56.4%,17m
12565,3,[ExMn]npnp,3147,1316,53,52,105,50.5%,26m
12565,3,[VFam2]Sirgamermore,3147,733,35,26,61,57.4%,20m
12565,3,Templar,3147,852,34,42,76,44.7%,37m
12565,3,[THESG]Giant,3147,530,26,22,48,54.2%,6m
12565,3,[TGosuA]GrimGhost,3147,486,17,21,38,44.7%,27m
12565,3,AssHQLE,3147,70,11,21,32,34.4%,22m
12565,1,Dagestan,3147,234,9,5,14,64.3%,8m
12565,3,ThemStar,3147,158,8,4,12,66.7%,40m
12565,3,NoBuildOrder,3147,174,7,7,14,50.0%,44m
12565,3,[Mammal]MeowMeow,3147,184,6,10,16,37.5%,9m
12565,3,[Amb3rs]Nicolas,3147,114,5,6,11,45.5%,6m
12565,3,raizen,3147,146,5,7,12,41.7%,32m
12565,1,[I3ro]Donjuancho,3147,196,5,8,13,38.5%,31m
12565,3,Stcalde,3147,122,4,10,14,28.6%,4m
12565,1,Gundobadus,3147,38,2,1,3,66.7%,5m
12565,2,[GHS]HideYoKids,3147,0,1,0,1,100.0%,39m
12565,3,[3D]TrencH,3147,0,1,1,2,50.0%,30m
12565,1,[RUnoob]MrBuckLee,3147,0,0,1,1,0.0%,27m
12565,3,AlivEMouZ,3147,0,0,2,2,0.0%,31m
12586,3,[1623]pluk,3146,1515,276,267,543,50.8%,16m
12586,3,FartBox,3146,1086,160,140,300,53.3%,18m
12586,3,[AMBP]HotAmbush,3146,768,33,25,58,56.9%,44m
12586,3,Orthuzad,3146,633,31,20,51,60.8%,33m
12586,2,DisToPieselo,3146,0,5,1,6,83.3%,42m
12586,3,[Cryptc]Soul,3146,42,4,3,7,57.1%,33m
12586,2,StevieJay,3146,144,4,4,8,50.0%,4m
12586,3,ILOVEYOUALL,3146,0,3,1,4,75.0%,35m
12586,3,Greeko,3146,97,2,0,2,100.0%,37m
12586,3,[UFC]KrazyDago,3146,30,2,2,4,50.0%,36m
12586,3,[AiMB]FallowWing,3146,58,2,9,11,18.2%,20m
12586,3,Razor,3146,93,1,2,3,33.3%,21m
12586,1,[JPLobs]Proseidon,3146,0,0,1,1,0.0%,17m
12586,3,Narwal,3146,0,0,4,4,0.0%,35m
12600,3,DonaldChump,3145,1580,327,312,639,51.2%,19m
12600,3,AsTyAnaX,3145,1555,221,212,433,51.0%,8m
12600,3,[XpKb]SONDA,3145,1533,173,182,355,48.7%,18m
12600,3,Apagon,3145,1624,154,147,301,51.2%,9m
12600,3,kingkyon,3145,1525,100,93,193,51.8%,19m
12600,3,IIIIIIIIIIII,3145,1532,97,93,190,51.1%,38m
12600,3,JohnnyP,3145,395,92,80,172,53.5%,24m
12600,3,GuyintheChat,3145,677,75,41,116,64.7%,28m
12600,1,Terran,3145,1467,68,60,128,53.1%,3m
12600,1,MeatPienSce,3145,520,20,15,35,57.1%,40m
12600,1,bluefyre,3145,515,18,11,29,62.1%,38m
12600,3,Reaper,3145,356,13,11,24,54.2%,17m
12600,3,sally,3145,302,11,7,18,61.1%,42m
12600,1,ILikeToFart,3145,385,9,10,19,47.4%,40m
12600,3,RowRowRowlan,3145,148,6,6,12,50.0%,19m
12600,3,[SuperZ]NorthAnor,3145,58,2,4,6,33.3%,5m
12600,3,liquidsnake,3145,62,2,4,6,33.3%,29m
12600,1,ElkKiller,3145,0,1,0,1,100.0%,40m
12600,1,Toxic,3145,0,1,0,1,100.0%,1h
12600,3,Brar,3145,0,1,2,3,33.3%,32m
12600,1,Hades,3145,0,0,1,1,0.0%,15m
12600,3,Suner,3145,0,0,2,2,0.0%,33m
12622,3,Ren,3144,1520,166,135,301,55.1%,28m
12622,3,Leónidas,3144,1505,69,55,124,55.6%,27m
12622,3,Squirrel,3144,1460,67,59,126,53.2%,8m
12622,3,IIIIIIIIIIII,3144,153,58,67,125,46.4%,38m
12622,1,DeepNet,3144,1292,50,26,76,65.8%,7m
12622,3,Pandadeath,3144,1248,46,52,98,46.9%,44m
12622,1,Nonzero,3144,938,44,36,80,55.0%,13m
12622,3,OmAr,3144,423,33,22,55,60.0%,11m
12622,3,[Stale]Swerve,3144,396,28,17,45,62.2%,12m
12622,3,MingVase,3144,251,22,19,41,53.7%,17m
12622,1,IIIIIIIIIIII,3144,270,8,3,11,72.7%,38m
12622,3,Reezaw,3144,0,5,0,5,100.0%,1h
12622,2,[LDCO]COLD,3144,129,3,5,8,37.5%,27m
12622,1,[8kPLUS]RadarBoy,3144,0,1,0,1,100.0%,38m
12622,1,[BOOT]Goldo,3144,42,1,1,2,50.0%,20m
12622,1,[GN5]izz,3144,0,0,1,1,0.0%,1h
12638,3,Chrno,3143,1534,232,207,439,52.8%,13m
12638,3,Brometheus,3143,1044,143,113,256,55.9%,13m
12638,3,[69rs]Infintium,3143,593,77,75,152,50.7%,7m
12638,3,SmirkingRam,3143,1420,74,73,147,50.3%,27m
12638,3,beaconlight,3143,780,27,35,62,43.5%,40m
12638,3,AttackTurtle,3143,639,23,24,47,48.9%,30m
12638,3,Incenstious,3143,307,18,18,36,50.0%,39m
12638,2,Theswan,3143,392,15,6,21,71.4%,16m
12638,3,doopypoopy,3143,276,10,12,22,45.5%,15m
12638,1,[VXTV]psiANIDe,3143,196,6,2,8,75.0%,12m
12638,1,Doozins,3143,120,6,4,10,60.0%,2h
12638,3,[ASPIE]BanayadWsky,3143,202,6,6,12,50.0%,23m
12638,1,Jurojin,3143,0,5,0,5,100.0%,41m
12638,1,Cancel,3143,0,4,1,5,80.0%,16m
12638,2,jackman,3143,0,4,2,6,66.7%,2h
12638,1,SeNenGoroshi,3143,110,3,1,4,75.0%,32m
12638,3,[SC2MOO]Butnuckle,3143,115,3,2,5,60.0%,4m
12638,2,NoobsRUs,3143,0,3,3,6,50.0%,42m
12638,2,UDFaith,3143,0,2,2,4,50.0%,1h
12638,3,[69Rx69]Assprin,3143,0,1,3,4,25.0%,3h
12638,3,[Boboyz]Davidovo,3143,18,1,4,5,20.0%,7m
12659,3,Quintus,3142,1609,220,211,431,51.0%,21m
12659,3,tbonehmb,3142,936,88,80,168,52.4%,9m
12659,3,[TASP]Robert,3142,1488,70,54,124,56.5%,30m
12659,3,william,3142,670,64,64,128,50.0%,42m
12659,3,jinneeking,3142,1305,59,61,120,49.2%,13m
12659,3,AssyMcgee,3142,906,49,41,90,54.4%,27m
12659,3,[RLRZ]Fluffy,3142,522,43,27,70,61.4%,13m
12659,3,[AlIin]Raikkles,3142,217,31,28,59,52.5%,34m
12659,3,Quelijah,3142,878,31,34,65,47.7%,19m
12659,1,Santana,3142,371,17,8,25,68.0%,3m
12659,3,Bowser,3142,386,17,16,33,51.5%,17m
12659,3,[CHEE53]MADscientist,3142,293,13,12,25,52.0%,38m
12659,3,biggaj,3142,374,13,17,30,43.3%,8m
12659,1,TheJtol,3142,183,7,2,9,77.8%,33m
12659,3,Titanflash,3142,58,3,7,10,30.0%,21m
12659,3,[ZLT]KombatWombat,3142,62,2,9,11,18.2%,39m
12659,2,elevenS,3142,0,0,1,1,0.0%,21m
12659,3,mAKU,3142,0,0,2,2,0.0%,13m
12677,3,[WNTR]Liko,3141,366,97,95,192,50.5%,13m
12677,3,[EFNQ]Albatrocity,3141,772,28,44,72,38.9%,41m
12677,3,[GR33D]Ritho,3141,418,18,9,27,66.7%,4m
12677,3,Supermarmota,3141,468,15,22,37,40.5%,7m
12677,1,dOOmSlaYer,3141,253,12,4,16,75.0%,29m
12677,1,Drakkus,3141,303,11,7,18,61.1%,19m
12677,3,Thadux,3141,233,7,6,13,53.8%,44m
12677,3,KikiOG,3141,60,6,4,10,60.0%,42m
12677,3,IIIIIIIIIIII,3141,0,4,1,5,80.0%,3h
12677,3,matterhorne,3141,0,3,2,5,60.0%,2h
12677,3,DieLebron,3141,30,1,13,14,7.1%,7m
12677,1,[SyL]BlueEyes,3141,0,0,1,1,0.0%,31m
12677,1,NotSmurf,3141,0,0,1,1,0.0%,16m
12677,1,AimYisus,3141,0,0,2,2,0.0%,27m
12677,1,[Dlphns]Ironslug,3141,0,0,2,2,0.0%,3m
12677,3,DecoyOctopus,3141,0,0,5,5,0.0%,20m
12693,3,Overkill,3140,1583,431,426,857,50.3%,33m
12693,3,OrangeManGud,3140,1493,293,278,571,51.3%,19m
12693,3,SisNab,3140,1501,89,76,165,53.9%,27m
12693,1,[Scanes]Gottagobad,3140,1291,88,78,166,53.0%,17m
12693,3,[HURSES]ManCannon,3140,1466,84,68,152,55.3%,21m
12693,3,lumps,3140,439,59,53,112,52.7%,37m
12693,3,SarthorioFgR,3140,318,31,28,59,52.5%,8m
12693,3,[MadK]Fenrir,3140,450,30,23,53,56.6%,27m
12693,3,Itzakaya,3140,469,21,11,32,65.6%,17m
12693,3,Jarra,3140,464,16,15,31,51.6%,41m
12693,3,[TONIC]OpuS,3140,200,11,14,25,44.0%,42m
12693,1,[WiNgSS]Rachyr,3140,369,9,7,16,56.2%,29m
12693,3,[iDrunk]OttoTek,3140,176,7,8,15,46.7%,13m
12693,1,DaNoob,3140,244,6,6,12,50.0%,43m
12693,1,Defqon,3140,206,5,10,15,33.3%,2h
12693,2,[BIDENN]Morty,3140,0,4,2,6,66.7%,39m
12693,3,MaruTheBest,3140,42,4,3,7,57.1%,2h
12693,3,Osprey,3140,138,4,4,8,50.0%,40m
12693,1,JlLopaTpax,3140,0,3,2,5,60.0%,21m
12693,3,[CHNboy]hanbing,3140,96,2,1,3,66.7%,8m
12693,1,[WONGS]Hopz,3140,0,2,3,5,40.0%,8m
12693,3,DIOMEDES,3140,58,2,5,7,28.6%,20m
12693,1,[No0Bs]FluffyZling,3140,0,1,0,1,100.0%,30m
12693,1,[LowIQ]jacktdnguyen,3140,42,1,2,3,33.3%,31m
12693,1,toshy,3140,0,0,1,1,0.0%,22m
12693,3,Ling,3140,0,0,2,2,0.0%,4m
12693,3,Vato,3140,0,0,3,3,0.0%,13m
12720,3,[G9PM]Tonalbunk,3139,1461,116,106,222,52.3%,7m
12720,1,[DCDC]Bombadil,3139,1804,111,92,203,54.7%,9m
12720,3,kaboosH,3139,1501,90,88,178,50.6%,12m
12720,1,Jesibet,3139,449,85,75,160,53.1%,12m
12720,3,Campte,3139,1423,70,69,139,50.4%,16m
12720,3,Jiban,3139,1377,64,61,125,51.2%,21m
12720,3,Twiz,3139,832,31,36,67,46.3%,22m
12720,3,[LEMEX]Aralak,3139,628,21,38,59,35.6%,26m
12720,1,loliSlayer,3139,571,16,12,28,57.1%,41m
12720,3,MiLToN,3139,233,11,7,18,61.1%,9m
12720,1,CUERVOROJO,3139,356,10,4,14,71.4%,29m
12720,3,[TDXb]Breeze,3139,30,2,4,6,33.3%,21m
12720,1,Piperjim,3139,0,0,1,1,0.0%,25m
12733,1,ptaamdree,3138,1798,299,274,573,52.2%,25m
12733,3,Iantacular,3138,1325,183,174,357,51.3%,7m
12733,3,LittleHands,3138,875,160,135,295,54.2%,7m
12733,1,Ddpskizzle,3138,1330,68,54,122,55.7%,8m
12733,3,Statistician,3138,970,37,36,73,50.7%,32m
12733,3,cwlvc,3138,308,29,34,63,46.0%,22m
12733,3,Taos,3138,656,28,23,51,54.9%,32m
12733,3,nickray,3138,402,14,17,31,45.2%,18m
12733,1,[AD3C]Sensus,3138,240,10,4,14,71.4%,9m
12733,1,HighPeaks,3138,312,9,5,14,64.3%,13m
12733,3,[T1xG]Vexal,3138,262,9,15,24,37.5%,44m
12733,1,Nematic,3138,160,5,3,8,62.5%,31m
12733,3,Jass,3138,146,5,10,15,33.3%,42m
12733,1,[FVCK1N]PurpleKush,3138,80,3,0,3,100.0%,26m
12733,3,[Sires]Amerit,3138,92,3,6,9,33.3%,32m
12733,2,IIIIIIIIIIII,3138,96,2,1,3,66.7%,21m
12733,1,Effervescent,3138,86,2,2,4,50.0%,17m
12733,1,[OpT1cZ]Potato,3138,0,1,0,1,100.0%,17m
12733,2,AuReaper,3138,0,1,0,1,100.0%,16m
12733,3,LazyTitan,3138,0,1,2,3,33.3%,38m
12733,3,Thedestroyer,3138,30,1,4,5,20.0%,7m
12733,1,Loritolord,3138,0,0,1,1,0.0%,7m
12733,3,Brandstar,3138,0,0,7,7,0.0%,40m
12756,3,NadaPure,3137,1553,156,149,305,51.1%,12m
12756,3,[DHZ0ne]MORGAN,3137,738,102,93,195,52.3%,32m
12756,3,sausey,3137,1596,96,100,196,49.0%,16m
12756,3,BLACKSHAQ,3137,1534,89,73,162,54.9%,31m
12756,3,smokem,3137,832,30,36,66,45.5%,18m
12756,1,sClassy,3137,248,10,6,16,62.5%,29m
12756,3,[RepOP]Frenzy,3137,260,10,12,22,45.5%,32m
12756,1,xenathode,3137,338,9,7,16,56.2%,16m
12756,1,[ESPY]Karnetic,3137,153,9,10,19,47.4%,9m
12756,1,[MPcrew]Doominator,3137,122,5,2,7,71.4%,17m
12756,3,WartenLKW,3137,30,5,3,8,62.5%,29m
12756,3,signroyal,3137,118,5,12,17,29.4%,22m
12756,3,Donutt,3137,119,3,3,6,50.0%,18m
12756,3,[DuB415]Thizzle,3137,60,3,5,8,37.5%,39m
12756,1,[FALURS]Marvel,3137,0,1,0,1,100.0%,3m
12756,1,[TushAn]Macrodove,3137,0,1,0,1,100.0%,37m
12756,3,leowh,3137,30,1,8,9,11.1%,38m
12756,1,[CTLJ]LiquidWater,3137,0,0,1,1,0.0%,11m
12756,1,[TheDOH]luna,3137,0,0,1,1,0.0%,41m
12775,1,[ValidG]Blitz,3136,1515,85,68,153,55.6%,17m
12775,3,Dunsidian,3136,1351,54,57,111,48.6%,7m
12775,3,[Pharoh]Rainyforest,3136,500,20,15,35,57.1%,29m
12775,3,[New2it]oMISTICo,3136,310,11,19,30,36.7%,26m
12775,3,Tiger,3136,321,10,15,25,40.0%,33m
12775,1,[IMDSI]SMURFIN,3136,200,6,6,12,50.0%,16m
12775,1,[Verley]Duncan,3136,0,4,1,5,80.0%,8m
12775,3,[FFAA]archdegreed,3136,0,1,1,2,50.0%,24m
12775,3,[LPrusa]Choripan,3136,0,1,4,5,20.0%,15m
12775,3,Danny,3136,0,1,6,7,14.3%,26m
12775,1,Zyr,3136,0,0,1,1,0.0%,8m
12775,1,Anderson,3136,0,0,1,1,0.0%,20m
12775,1,Capybara,3136,0,0,2,2,0.0%,11m
12788,3,WallStBets,3135,836,158,165,323,48.9%,32m
12788,3,Slinks,3135,1528,101,105,206,49.0%,15m
12788,3,[MCPWN]Vindicator,3135,1147,86,92,178,48.3%,40m
12788,1,[NAUG3]CrazyJezuz,3135,1721,68,57,125,54.4%,5m
12788,1,Forkster,3135,864,53,17,70,75.7%,8m
12788,3,Bix,3135,723,47,50,97,48.5%,36m
12788,3,Fred,3135,1080,41,38,79,51.9%,7m
12788,1,Zaratul,3135,869,34,18,52,65.4%,8m
12788,1,WiseKoala,3135,759,28,22,50,56.0%,17m
12788,3,briznokovic,3135,666,27,28,55,49.1%,42m
12788,3,[AbcCo]BlackScorpio,3135,239,10,6,16,62.5%,21m
12788,3,Shinato,3135,222,8,9,17,47.1%,8m
12788,3,FULLNA,3135,120,5,8,13,38.5%,34m
12788,2,Kimchijjigae,3135,0,1,0,1,100.0%,1h
12788,1,PyroRyan,3135,0,1,0,1,100.0%,9m
12788,2,[CHEWIN]Protoss,3135,95,1,2,3,33.3%,2h
12788,1,Erik,3135,0,0,1,1,0.0%,20m
12788,1,DuxVindex,3135,0,0,1,1,0.0%,8m
12788,3,MonkeyGenius,3135,0,0,4,4,0.0%,7m
12788,3,GroundhogDay,3135,0,0,6,6,0.0%,20m
12808,3,[Mumble]KIL,3134,1486,99,77,176,56.2%,8m
12808,1,Seefour,3134,834,26,23,49,53.1%,41m
12808,1,Grabgesänge,3134,351,10,4,14,71.4%,4m
12808,1,[PTZop]Lacrimosa,3134,279,10,5,15,66.7%,11m
12808,3,Sebastian,3134,197,8,4,12,66.7%,13m
12808,2,MirPapa,3134,0,4,2,6,66.7%,7m
12808,1,Logan,3134,0,3,0,3,100.0%,38m
12808,3,JakeCoDonuts,3134,0,3,2,5,60.0%,2h
12808,1,NOOBYTERRAN,3134,0,2,0,2,100.0%,38m
12808,1,Strange,3134,82,2,2,4,50.0%,20m
12808,3,[SAUC3]OsmOse,3134,0,2,4,6,33.3%,27m
12808,3,Xylen,3134,94,1,2,3,33.3%,16m
12808,1,[VFam2]Kaladin,3134,0,0,1,1,0.0%,4m
12821,3,Bob,3133,1087,331,323,654,50.6%,8m
12821,3,Damon,3133,630,115,87,202,56.9%,11m
12821,3,[UpxV]BENZ,3133,1529,59,65,124,47.6%,12m
12821,3,Haymitch,3133,511,52,52,104,50.0%,15m
12821,3,redgold,3133,1130,51,38,89,57.3%,24m
12821,3,[220ms]Mightily,3133,1007,37,36,73,50.7%,26m
12821,1,Chikoro,3133,944,29,27,56,51.8%,30m
12821,3,NestorHead,3133,624,25,29,54,46.3%,8m
12821,3,ragnarwin,3133,692,22,37,59,37.3%,32m
12821,3,MetalMan,3133,312,21,18,39,53.8%,33m
12821,1,Sausage,3133,478,20,12,32,62.5%,40m
12821,3,Phlinx,3133,272,15,7,22,68.2%,7m
12821,3,MrMcNasty,3133,428,15,23,38,39.5%,17m
12821,3,EbE,3133,310,11,15,26,42.3%,4m
12821,3,[Bommmm]DOMINUS,3133,203,6,7,13,46.2%,27m
12821,3,Bazinga,3133,0,5,0,5,100.0%,2h
12821,1,Kusaji,3133,160,5,2,7,71.4%,31m
12821,1,condurr,3133,148,4,4,8,50.0%,20m
12821,3,Casavir,3133,0,3,2,5,60.0%,3h
12821,1,[KN0B]FranktheTank,3133,0,0,1,1,0.0%,23m
12841,3,Vlek,3132,1533,340,328,668,50.9%,21m
12841,3,Zav,3132,1323,153,152,305,50.2%,13m
12841,2,ynelm,3132,1348,133,146,279,47.7%,41m
12841,3,Moist,3132,1283,125,124,249,50.2%,7m
12841,1,[PTHero]ibuildmarine,3132,905,100,83,183,54.6%,11m
12841,3,Anasazi,3132,942,71,58,129,55.0%,29m
12841,3,[BRSKR]DreamerToss,3132,1020,48,42,90,53.3%,8m
12841,3,JAIVA,3132,904,46,42,88,52.3%,21m
12841,3,Costa,3132,168,23,26,49,46.9%,12m
12841,3,TuculoTesuda,3132,347,17,11,28,60.7%,44m
12841,3,NNB,3132,338,13,7,20,65.0%,20m
12841,1,Estrong,3132,362,11,6,17,64.7%,13m
12841,1,Mistgun,3132,206,10,6,16,62.5%,8m
12841,1,[SCST]Gieve,3132,208,6,13,19,31.6%,8m
12841,1,luvmytitz,3132,0,5,0,5,100.0%,31m
12841,2,Zerceo,3132,46,5,3,8,62.5%,42m
12841,3,Zunnyn,3132,0,4,2,6,66.7%,24m
12841,1,[YEAHH]Alerion,3132,40,1,2,3,33.3%,41m
12841,1,Orano,3132,0,0,1,1,0.0%,21m
12841,1,Arcangell,3132,0,0,2,2,0.0%,16m
12861,3,LizardHerder,3131,1608,217,213,430,50.5%,33m
12861,1,pewp,3131,1750,181,162,343,52.8%,30m
12861,1,ImOnlyEight,3131,1611,90,69,159,56.6%,26m
12861,3,Bibulus,3131,977,82,69,151,54.3%,24m
12861,3,JohnnySinz,3131,816,30,31,61,49.2%,24m
12861,3,ILikeBread,3131,683,25,23,48,52.1%,9m
12861,3,Eliasdelacru,3131,485,22,21,43,51.2%,27m
12861,3,Xelendor,3131,471,20,16,36,55.6%,29m
12861,3,[TwiLit]BlueJay,3131,386,13,17,30,43.3%,36m
12861,3,TheOneking,3131,264,11,12,23,47.8%,20m
12861,1,RuneHopper,3131,328,10,5,15,66.7%,17m
12861,3,[Kappa]sweffymo,3131,274,10,14,24,41.7%,40m
12861,1,[TrpleT]Croaker,3131,304,8,5,13,61.5%,34m
12861,1,red,3131,192,8,6,14,57.1%,37m
12861,3,Labattoire,3131,124,7,2,9,77.8%,11m
12861,1,Ratgoof,3131,0,5,0,5,100.0%,29m
12861,1,Doneskis,3131,0,4,1,5,80.0%,40m
12861,1,IIInnovation,3131,42,2,0,2,100.0%,41m
12861,1,thewizardgap,3131,0,1,0,1,100.0%,12m
12861,3,OffaLion,3131,0,0,3,3,0.0%,12m
12881,3,[spunky]leterally,3130,957,158,157,315,50.2%,13m
12881,3,VoltZ,3130,1509,121,88,209,57.9%,28m
12881,3,Nathan,3130,1231,76,77,153,49.7%,38m
12881,1,[KUMITE]SpeedKing,3130,1090,72,62,134,53.7%,34m
12881,3,TParr,3130,556,71,60,131,54.2%,24m
12881,3,PongO,3130,463,70,62,132,53.0%,40m
12881,1,KainGonuyo,3130,1098,48,22,70,68.6%,31m
12881,3,FierceFirst,3130,893,38,35,73,52.1%,8m
12881,3,[500CC]Natum,3130,313,14,9,23,60.9%,24m
12881,1,FuriusGame,3130,152,7,5,12,58.3%,38m
12881,3,stargodzilla,3130,157,4,3,7,57.1%,33m
12881,1,WaynaTakiri,3130,78,3,3,6,50.0%,29m
12881,1,Titan,3130,0,1,0,1,100.0%,37m
12881,2,Swarm,3130,0,1,0,1,100.0%,28m
12881,1,[MrtN]ebok,3130,38,1,3,4,25.0%,16m
12881,1,KEN,3130,0,0,1,1,0.0%,41m
12897,3,DoctorGentle,3129,1474,101,102,203,49.8%,31m
12897,1,Samstar,3129,1643,63,54,117,53.8%,20m
12897,3,[PNS]Ziguela,3129,1242,58,44,102,56.9%,18m
12897,3,EliteGhost,3129,309,58,50,108,53.7%,27m
12897,3,Daskper,3129,1149,50,47,97,51.5%,24m
12897,1,Umu,3129,543,19,9,28,67.9%,21m
12897,3,Mechulus,3129,397,14,17,31,45.2%,21m
12897,3,Harambe,3129,113,11,13,24,45.8%,40m
12897,1,Jerm,3129,203,6,1,7,85.7%,29m
12897,3,LordMendigao,3129,92,3,7,10,30.0%,21m
12897,3,Eugene,3129,97,2,0,2,100.0%,38m
12897,1,ceon,3129,84,2,3,5,40.0%,18m
12897,3,DaHyun,3129,0,1,2,3,33.3%,19m
12897,1,KainPrime,3129,0,0,1,1,0.0%,37m
12911,3,[AIlin]grandPaToss,3128,1574,103,110,213,48.4%,8m
12911,3,CrediNation,3128,1597,79,88,167,47.3%,28m
12911,3,Napoleon,3128,786,49,38,87,56.3%,13m
12911,3,[Atira]Atira,3128,371,19,24,43,44.2%,14m
12911,3,CraZyKaun,3128,188,7,13,20,35.0%,20m
12911,1,GatoBot,3128,182,5,2,7,71.4%,32m
12911,2,llllllllllll,3128,0,4,2,6,66.7%,1h
12911,1,gasbreakdip,3128,139,2,9,11,18.2%,30m
12911,3,ALuCARD,3128,30,2,9,11,18.2%,43m
12911,3,TheSense,3128,0,2,9,11,18.2%,23m
12911,1,MKZED,3128,44,1,1,2,50.0%,24m
12911,1,[FMX]Jackblaster,3128,0,0,1,1,0.0%,32m
12911,1,Centaurus,3128,0,0,2,2,0.0%,4m
12924,3,WavyBaby,3127,1204,266,247,513,51.9%,24m
12924,3,thesextoy,3127,1509,240,231,471,51.0%,28m
12924,3,Phantom,3127,954,34,38,72,47.2%,16m
12924,3,Duckdive,3127,447,25,29,54,46.3%,16m
12924,3,dookie,3127,424,22,10,32,68.8%,18m
12924,3,AndrewL,3127,470,15,32,47,31.9%,41m
12924,1,[CH3ES3]FluffyKitten,3127,311,9,2,11,81.8%,4m
12924,1,KrOnUs,3127,207,9,5,14,64.3%,1h
12924,1,ExpressImba,3127,195,8,2,10,80.0%,34m
12924,3,[NLK]Wormsign,3127,168,6,9,15,40.0%,13m
12924,1,Daniel,3127,0,5,0,5,100.0%,8m
12924,3,Driven,3127,0,5,4,9,55.6%,24m
12924,1,[HPOT]blood,3127,0,3,2,5,60.0%,37m
12924,1,Strategic,3127,40,2,0,2,100.0%,29m
12924,1,StonedCraft,3127,40,2,0,2,100.0%,17m
12924,1,Avefenix,3127,116,2,2,4,50.0%,22m
12924,1,NyaaaGrill,3127,42,1,2,3,33.3%,30m
12924,3,abc,3127,0,0,1,1,0.0%,31m
12924,1,[GGDA]HeavyDuty,3127,0,0,1,1,0.0%,16m
12943,3,Nex,3126,1552,1111,1032,2143,51.8%,11m
12943,3,Umm,3126,1419,120,115,235,51.1%,28m
12943,3,EvoLovE,3126,710,27,27,54,50.0%,12m
12943,3,Creed,3126,538,19,19,38,50.0%,5m
12943,3,Chrisdad,3126,342,18,14,32,56.2%,20m
12943,3,TorontoMans,3126,508,18,23,41,43.9%,24m
12943,3,[NLTTJ]Crawfish,3126,234,9,10,19,47.4%,38m
12943,1,Saitama,3126,252,8,3,11,72.7%,20m
12943,1,Proton,3126,90,4,2,6,66.7%,40m
12943,2,WeTheBest,3126,0,4,2,6,66.7%,25m
12943,1,Salient,3126,44,2,0,2,100.0%,16m
12943,3,AJD,3126,94,2,2,4,50.0%,17m
12943,1,RoBoT,3126,42,1,1,2,50.0%,30m
12943,1,moose,3126,42,1,1,2,50.0%,24m
12943,1,ASHURA,3126,44,1,1,2,50.0%,39m
12943,1,Christoph,3126,0,0,1,1,0.0%,8m
12943,3,IIIIIIIIIIII,3126,0,0,4,4,0.0%,9m
12960,3,ReivaX,3125,1542,459,447,906,50.7%,33m
12960,3,ChadMason,3125,1485,113,122,235,48.1%,19m
12960,3,Michael,3125,950,96,95,191,50.3%,18m
12960,3,Misterfed,3125,949,79,81,160,49.4%,37m
12960,3,Blacksteel,3125,1081,43,41,84,51.2%,15m
12960,3,SneakyTurtle,3125,340,21,8,29,72.4%,30m
12960,1,[GGMESP]RICKY,3125,497,17,8,25,68.0%,43m
12960,3,[Dadash]ARMIN,3125,389,14,12,26,53.8%,21m
12960,3,[Maaate]IkeaRat,3125,240,8,7,15,53.3%,17m
12960,3,ElPezcadin,3125,115,7,3,10,70.0%,8m
12960,3,mrmanatee,3125,148,7,10,17,41.2%,8m
12960,3,Defender,3125,166,5,4,9,55.6%,31m
12960,3,[GURO]bns,3125,170,5,6,11,45.5%,42m
12960,1,[NwAs]chicho,3125,112,4,0,4,100.0%,21m
12960,3,PickACard,3125,118,4,13,17,23.5%,13m
12960,1,[PtheG]Pendragon,3125,116,3,5,8,37.5%,35m
12960,1,Caliburn,3125,0,2,2,4,50.0%,37m
12960,3,TheVelorFog,3125,30,1,5,6,16.7%,31m
12960,1,Blueserpent,3125,0,0,1,1,0.0%,35m
12960,3,Fantinatti,3125,0,0,7,7,0.0%,13m
12980,3,BadatGames,3124,1370,129,103,232,55.6%,10m
12980,1,Vlady,3124,1626,128,113,241,53.1%,5m
12980,3,beatua,3124,1580,121,117,238,50.8%,42m
12980,3,[ßÞÐ]Nakim,3124,1496,120,82,202,59.4%,9m
12980,3,[UpeV]CerVeruS,3124,1533,105,109,214,49.1%,6m
12980,1,elefander,3124,797,96,81,177,54.2%,22m
12980,1,WhiskyNWaves,3124,1427,82,73,155,52.9%,32m
12980,3,Entropian,3124,942,75,64,139,54.0%,42m
12980,3,[AbcCo]Eivici,3124,933,56,59,115,48.7%,19m
12980,3,Kenshi,3124,634,29,35,64,45.3%,19m
12980,3,lxky,3124,703,27,28,55,49.1%,22m
12980,1,Spirit,3124,366,17,10,27,63.0%,31m
12980,3,[lLiTl]Suspicious,3124,442,16,13,29,55.2%,27m
12980,3,NikoN,3124,318,12,13,25,48.0%,43m
12980,1,[MLPQTP]nixtamal,3124,148,8,5,13,61.5%,2h
12980,2,StarChip,3124,162,7,3,10,70.0%,2h
12980,3,SgtTucker,3124,146,6,11,17,35.3%,42m
12980,1,IsaacsPERU,3124,112,4,3,7,57.1%,19m
12980,1,ArchyDevil,3124,0,3,2,5,60.0%,29m
12980,1,Murkadin,3124,82,3,2,5,60.0%,29m
12980,2,shjOoR,3124,36,2,2,4,50.0%,9m
12980,3,ChaosTheory,3124,0,2,3,5,40.0%,1h
12980,1,[LOES]Lizzardking,3124,0,1,1,2,50.0%,30m
12980,1,backstabber,3124,0,1,1,2,50.0%,44m
12980,1,vector,3124,0,0,2,2,0.0%,36m
13005,2,Important,3123,1073,229,222,451,50.8%,39m
13005,3,heterosis,3123,1578,158,154,312,50.6%,4m
13005,1,[gGgO]SummerZerg,3123,1320,50,45,95,52.6%,13m
13005,3,Stryfe,3123,1228,44,53,97,45.4%,16m
13005,1,Ratu,3123,948,40,21,61,65.6%,42m
13005,3,HankTheTank,3123,798,37,30,67,55.2%,37m
13005,3,Optimism,3123,731,35,19,54,64.8%,25m
13005,3,Latlante,3123,283,14,8,22,63.6%,31m
13005,1,NoeL,3123,342,11,3,14,78.6%,44m
13005,3,reflection,3123,319,11,11,22,50.0%,24m
13005,3,[trash0]TWhiteKnight,3123,240,10,5,15,66.7%,40m
13005,1,nameless,3123,196,6,2,8,75.0%,24m
13005,3,Thal,3123,110,4,5,9,44.4%,28m
13005,1,slikpnot,3123,108,3,3,6,50.0%,7m
13005,1,[ValidG]GrumpyGills,3123,0,1,0,1,100.0%,22m
13005,2,Luchito,3123,0,1,1,2,50.0%,43m
13005,1,[ZTemp]BombSquad,3123,0,0,1,1,0.0%,38m
13005,1,FLYSON,3123,0,0,1,1,0.0%,29m
13005,3,LuckyPants,3123,0,0,1,1,0.0%,23m
13024,3,Ramirotrox,3122,1622,261,237,498,52.4%,36m
13024,1,[H0D0R]chris,3122,1564,65,60,125,52.0%,4m
13024,3,TTVBrokenLaw,3122,953,43,45,88,48.9%,28m
13024,3,[BLuRJr]jghytfot,3122,681,39,39,78,50.0%,30m
13024,3,[daelan]Nandito,3122,684,23,39,62,37.1%,17m
13024,3,[Tyber]albarodrigo,3122,382,13,12,25,52.0%,12m
13024,1,[SIMPLY]Dave,3122,263,8,5,13,61.5%,36m
13024,1,RandomMan,3122,0,3,2,5,60.0%,16m
13024,3,Razor,3122,30,2,6,8,25.0%,13m
13024,1,kaokao,3122,0,1,0,1,100.0%,24m
13024,1,llllllllllll,3122,40,1,2,3,33.3%,37m
13024,2,LingZerg,3122,95,1,7,8,12.5%,2h
13036,3,[TeriS]TotallyJutsu,3121,947,201,169,370,54.3%,26m
13036,3,TinyDemon,3121,1470,171,156,327,52.3%,42m
13036,3,NoRelax,3121,708,37,37,74,50.0%,5m
13036,3,[αB]Mythikdawn,3121,424,15,31,46,32.6%,20m
13036,3,Hexidecimal,3121,369,13,10,23,56.5%,26m
13036,1,TheCurian,3121,301,11,10,21,52.4%,23m
13036,3,[SPACEF]SpaceForceXX,3121,233,6,9,15,40.0%,21m
13036,1,WTFthatDyude,3121,192,5,3,8,62.5%,37m
13036,3,amumu,3121,60,4,6,10,40.0%,11m
13036,1,[PreBc]Hotmail,3121,82,3,1,4,75.0%,32m
13036,2,[SCDs]amagi,3121,0,3,2,5,60.0%,2h
13036,3,[fn1]fnicmogk,3121,0,1,0,1,100.0%,28m
13036,1,Demael,3121,0,1,0,1,100.0%,44m
13036,1,grrr,3121,38,1,1,2,50.0%,34m
13036,1,[0825]MegaAnimal,3121,36,1,1,2,50.0%,17m
13036,3,[SSH7]Apocalipsis,3121,24,1,5,6,16.7%,38m
13036,3,intelliJ,3121,0,0,5,5,0.0%,21m
13053,3,Nikelaos,3120,1476,387,357,744,52.0%,29m
13053,3,Centipede,3120,1219,234,228,462,50.6%,41m
13053,3,Megatron,3120,1559,221,215,436,50.7%,7m
13053,3,physikat,3120,1590,150,152,302,49.7%,12m
13053,1,[Boooiz]SourDough,3120,1446,131,106,237,55.3%,29m
13053,1,[PTHero]RespeCT,3120,1564,75,56,131,57.3%,8m
13053,3,BatChat,3120,351,68,56,124,54.8%,38m
13053,3,HANS,3120,1204,58,54,112,51.8%,37m
13053,3,Decreed,3120,1113,52,38,90,57.8%,12m
13053,1,IIIIIIIIIIII,3120,745,38,30,68,55.9%,32m
13053,3,PinGorOcho,3120,391,31,28,59,52.5%,24m
13053,3,AtoTheK,3120,484,21,12,33,63.6%,21m
13053,3,[DE]Ashlyn,3120,484,21,13,34,61.8%,13m
13053,3,Ace,3120,532,19,19,38,50.0%,42m
13053,1,[Xpk]RaulCarpio,3120,411,14,12,26,53.8%,41m
13053,1,ZagrE,3120,211,8,6,14,57.1%,1h
13053,3,[SUDAKA]DMart,3120,208,8,8,16,50.0%,22m
13053,1,[JKNT]JadyKnight,3120,186,6,4,10,60.0%,10m
13053,3,[GRNSKN]Ashiro,3120,105,5,8,13,38.5%,4m
13053,3,Krycek,3120,154,5,14,19,26.3%,41m
13053,1,Typhooey,3120,88,4,1,5,80.0%,19m
13053,2,CFAdun,3120,0,4,2,6,66.7%,2h
13053,2,[Subaru]Nardii,3120,139,3,3,6,50.0%,11m
13053,1,maximus,3120,0,2,3,5,40.0%,20m
13053,3,AZShortBus,3120,30,2,8,10,20.0%,28m
13053,1,ZeroAPM,3120,72,2,8,10,20.0%,17m
13053,1,TudorE,3120,0,1,0,1,100.0%,16m
13053,1,reddiyx,3120,0,1,0,1,100.0%,20m
13053,1,[CrnKy]Yakuzaku,3120,38,1,1,2,50.0%,34m
13053,1,NandJ,3120,44,1,2,3,33.3%,41m
13053,1,Vitalius,3120,0,0,1,1,0.0%,22m
13084,3,[DETER]BananaPants,3119,1386,89,96,185,48.1%,37m
13084,1,funnychunny,3119,1492,74,69,143,51.7%,44m
13084,3,[Morky]Seaturkey,3119,960,36,38,74,48.6%,8m
13084,1,BRSoldier,3119,286,13,6,19,68.4%,38m
13084,1,higl,3119,207,9,5,14,64.3%,2h
13084,1,OneTwoTwelve,3119,135,6,4,10,60.0%,2h
13084,3,Skallywags,3119,112,2,3,5,40.0%,27m
13084,1,afatsack,3119,0,1,0,1,100.0%,30m
13084,1,phasesmith,3119,36,1,2,3,33.3%,20m
13084,3,drivby,3119,0,0,1,1,0.0%,3h
13094,1,brickwall,3118,1806,250,236,486,51.4%,24m
13094,3,TheSkyRiser,3118,353,47,46,93,50.5%,13m
13094,3,[xAEx]Powersranger,3118,434,32,29,61,52.5%,7m
13094,1,[SPCTAC]PullTheBOYS,3118,640,20,14,34,58.8%,11m
13094,3,[BSL]SgtPepper,3118,470,20,23,43,46.5%,22m
13094,3,TheSurikat,3118,512,18,23,41,43.9%,26m
13094,3,Antares,3118,307,12,4,16,75.0%,29m
13094,3,CrazeX,3118,133,12,16,28,42.9%,41m
13094,1,Trout,3118,394,11,11,22,50.0%,23m
13094,1,IIIIIIIIIIII,3118,293,10,2,12,83.3%,4m
13094,3,[GNXPOP]QuantaCntrn,3118,185,9,8,17,52.9%,19m
13094,3,PAPANEGRA,3118,218,7,11,18,38.9%,36m
13094,1,angel,3118,0,4,1,5,80.0%,25m
13094,1,[Kappa]Kyle,3118,0,2,1,3,66.7%,42m
13094,1,Carpo,3118,42,2,1,3,66.7%,41m
13094,1,wetsis,3118,68,2,4,6,33.3%,17m
13094,1,Planetes,3118,42,1,3,4,25.0%,37m
13094,1,greatfroman,3118,0,0,1,1,0.0%,38m
13094,3,Donatbomber,3118,0,0,1,1,0.0%,1h
13113,3,Yinzknow,3117,1478,176,176,352,50.0%,36m
13113,1,FatterAndy,3117,1232,100,80,180,55.6%,37m
13113,3,[O6ama]CatStrom,3117,1331,97,78,175,55.4%,15m
13113,3,[CS0]Supersquare,3117,1246,91,66,157,58.0%,8m
13113,1,Martorix,3117,1715,64,57,121,52.9%,22m
13113,3,LaNdMaStEr,3117,954,45,35,80,56.2%,4m
13113,3,POWERFENIX,3117,703,45,46,91,49.5%,33m
13113,3,Fresh,3117,986,42,37,79,53.2%,37m
13113,1,[LDCO]darkjulio,3117,799,33,29,62,53.2%,24m
13113,3,Dreier,3117,784,33,34,67,49.3%,31m
13113,3,SaltyBalz,3117,659,28,25,53,52.8%,24m
13113,1,[BNNN]Mystery,3117,719,27,16,43,62.8%,8m
13113,3,[BoAVN]tumulu,3117,128,25,20,45,55.6%,19m
13113,3,[N664]Kfed,3117,506,22,19,41,53.7%,28m
13113,3,Umnums,3117,592,20,25,45,44.4%,22m
13113,3,[YouGet]vagin,3117,396,14,13,27,51.9%,26m
13113,3,Erich,3117,372,13,14,27,48.1%,4m
13113,3,OOkillerFgR,3117,325,11,11,22,50.0%,4m
13113,3,Khensu,3117,43,6,14,20,30.0%,26m
13113,3,nicnac,3117,121,5,2,7,71.4%,12m
13113,1,[SuprD]gshxd,3117,93,3,2,5,60.0%,30m
13113,3,Raize,3117,30,2,4,6,33.3%,19m
13113,3,salty,3117,95,1,3,4,25.0%,8m
13113,1,ChingoBungus,3117,0,0,1,1,0.0%,32m
13113,3,[QMS]MarsAlpha,3117,0,0,3,3,0.0%,22m
13138,3,[G79]TcSgtPhilly,3116,1418,68,77,145,46.9%,15m
13138,1,[1KrK1]KillerRabbit,3116,910,44,27,71,62.0%,42m
13138,1,[KRAK3N]Vanilla,3116,1132,44,33,77,57.1%,17m
13138,3,[bLoser]LOSE,3116,882,32,37,69,46.4%,20m
13138,3,ChefBacon,3116,259,30,30,60,50.0%,18m
13138,1,[Bobjr]bobjr,3116,590,28,7,35,80.0%,20m
13138,1,SagatibaWay,3116,402,21,9,30,70.0%,38m
13138,3,Drift,3116,441,19,26,45,42.2%,26m
13138,1,ihatezvz,3116,396,15,9,24,62.5%,36m
13138,1,Sirius,3116,406,14,5,19,73.7%,34m
13138,3,PapaSpaceman,3116,92,13,13,26,50.0%,23m
13138,1,[TPGGXD]DarKar,3116,406,12,6,18,66.7%,26m
13138,1,[Cind3r]grimblin,3116,286,8,5,13,61.5%,7m
13138,1,[Nfreak]Kerplunk,3116,236,7,3,10,70.0%,31m
13138,1,[CUC]mike,3116,176,5,2,7,71.4%,18m
13138,1,aMan,3116,148,5,4,9,55.6%,16m
13138,3,Tycho,3116,106,3,4,7,42.9%,37m
13138,1,[UpxV]MkJorvil,3116,0,1,0,1,100.0%,38m
13138,1,[danuts]BBox,3116,0,1,0,1,100.0%,26m
13138,1,DefiantBeard,3116,0,0,1,1,0.0%,22m
13138,1,Littleman,3116,0,0,1,1,0.0%,29m
13138,1,[VENSC2]Lucho,3116,0,0,1,1,0.0%,2h
13138,1,[TGosuC]Dimaria,3116,0,0,1,1,0.0%,4m
13138,1,iGetBuckets,3116,0,0,1,1,0.0%,17m
13138,3,TomatoHorse,3116,0,0,1,1,0.0%,43m
13163,3,[GgARMY]CutoGuadaluP,3115,449,131,129,260,50.4%,19m
13163,3,Oppenheimer,3115,1366,87,73,160,54.4%,25m
13163,1,Maorijosh,3115,1126,63,38,101,62.4%,6m
13163,2,Rupphire,3115,752,52,73,125,41.6%,23m
13163,3,Weep,3115,614,22,26,48,45.8%,25m
13163,3,naba,3115,492,18,23,41,43.9%,5m
13163,2,SniperRaynor,3115,301,10,7,17,58.8%,23m
13163,3,bobbe,3115,137,5,3,8,62.5%,26m
13163,1,poorboy,3115,131,3,3,6,50.0%,31m
13163,1,NakSuKao,3115,40,2,1,3,66.7%,41m
13163,1,Carcajou,3115,0,1,0,1,100.0%,39m
13163,1,Giorgio,3115,0,0,2,2,0.0%,39m
13175,3,fantasyz,3114,1433,135,128,263,51.3%,30m
13175,3,[DarkAG]Zergasm,3114,1458,71,65,136,52.2%,40m
13175,3,[Boys]Legobuilder,3114,1212,45,48,93,48.4%,42m
13175,3,Sharts,3114,490,21,12,33,63.6%,17m
13175,3,[OhNoIZ]stevo,3114,412,16,20,36,44.4%,19m
13175,1,ThatGuy,3114,462,14,10,24,58.3%,36m
13175,2,Esojnauj,3114,192,8,3,11,72.7%,38m
13175,1,YaaR,3114,0,1,0,1,100.0%,10m
13175,1,[Wat3rs]slyfox,3114,40,1,1,2,50.0%,31m
13175,1,[M8cr0]MEMESnDREAMS,3114,46,1,1,2,50.0%,38m
13175,1,nOnsa,3114,42,1,2,3,33.3%,34m
13175,1,[Straub]hotwings,3114,0,0,1,1,0.0%,6m
13175,3,[EtrOy]dougt,3114,0,0,5,5,0.0%,21m
13188,3,drkpng,3113,1392,73,63,136,53.7%,29m
13188,3,[DXPCA]FJgg,3113,1506,61,58,119,51.3%,23m
13188,3,[MALCMX]OprahWinfrey,3113,1091,48,48,96,50.0%,37m
13188,1,coastaverde,3113,1143,40,32,72,55.6%,41m
13188,1,[xGashx]Sumhungyungi,3113,904,29,25,54,53.7%,15m
13188,1,Compostela,3113,833,28,23,51,54.9%,37m
13188,3,Superslimey,3113,493,25,27,52,48.1%,16m
13188,1,[S7L]MADNESS,3113,482,16,7,23,69.6%,37m
13188,3,Craussie,3113,434,16,15,31,51.6%,11m
13188,1,Artanis,3113,343,11,4,15,73.3%,32m
13188,3,Kakaroth,3113,149,11,16,27,40.7%,8m
13188,3,[iDrunk]Aram,3113,250,9,14,23,39.1%,20m
13188,1,[TPGGXD]adrian,3113,244,7,6,13,53.8%,37m
13188,1,Yes,3113,119,6,3,9,66.7%,29m
13188,3,[33sh33]wWshinWw,3113,114,5,8,13,38.5%,24m
13188,1,Shortandfat,3113,114,3,3,6,50.0%,30m
13188,3,TWICE,3113,133,3,4,7,42.9%,40m
13188,1,WaLLL,3113,92,2,0,2,100.0%,18m
13188,1,Nick,3113,0,1,2,3,33.3%,39m
13188,1,panqueque,3113,0,0,1,1,0.0%,30m
13188,1,[YPR]YPR,3113,0,0,2,2,0.0%,17m
13188,3,Nukormur,3113,0,0,4,4,0.0%,34m
13210,1,IIIIIIIIIIII,3112,747,86,72,158,54.4%,23m
13210,3,[BatiT]DAED,3112,1547,76,65,141,53.9%,27m
13210,3,[MMICE]Mighty,3112,934,38,34,72,52.8%,44m
13210,1,Enable,3112,621,31,8,39,79.5%,3m
13210,3,[iMkS]Dnzo,3112,620,30,28,58,51.7%,38m
13210,1,CaptainStank,3112,867,27,22,49,55.1%,24m
13210,3,HERO,3112,586,26,29,55,47.3%,22m
13210,3,Inferno,3112,439,18,16,34,52.9%,28m
13210,1,DidntDoNuthn,3112,418,16,11,27,59.3%,40m
13210,3,Brobz,3112,430,15,15,30,50.0%,20m
13210,3,YoloSwagtron,3112,246,15,16,31,48.4%,20m
13210,3,Marco,3112,258,14,6,20,70.0%,11m
13210,1,[InTG]ThePeasident,3112,242,7,8,15,46.7%,15m
13210,1,Hal,3112,144,4,0,4,100.0%,16m
13210,3,LuckyOwl,3112,42,2,5,7,28.6%,1h
13210,1,Phenom,3112,0,1,0,1,100.0%,39m
13210,1,[Clan11]nolifeking,3112,0,1,0,1,100.0%,15m
13210,1,[Ash3s]ExMachina,3112,42,1,2,3,33.3%,20m
13210,1,bagofsalt,3112,0,0,1,1,0.0%,8m
13210,1,ReideN,3112,0,0,1,1,0.0%,4m
13230,3,breadfit,3111,1358,367,346,713,51.5%,7m
13230,3,[NLTN]SkengDON,3111,1553,173,179,352,49.1%,22m
13230,3,ROUTE,3111,1468,108,103,211,51.2%,24m
13230,3,Grishka,3111,966,50,35,85,58.8%,8m
13230,3,HELPMEDECIDE,3111,887,50,38,88,56.8%,21m
13230,3,Deneb,3111,576,20,31,51,39.2%,2m
13230,1,Jesse,3111,356,10,10,20,50.0%,17m
13230,3,LUKEforHIM,3111,234,8,12,20,40.0%,38m
13230,2,Iamadagger,3111,165,7,3,10,70.0%,2h
13230,1,duSitio,3111,182,5,3,8,62.5%,31m
13230,3,DesertFox,3111,176,5,6,11,45.5%,9m
13230,3,KiRiTo,3111,177,5,6,11,45.5%,22m
13230,3,Poins,3111,0,4,2,6,66.7%,18m
13230,1,[GeekA]DarthJulius,3111,83,4,7,11,36.4%,1m
13230,3,UvIm,3111,30,2,1,3,66.7%,43m
13230,1,Alex,3111,42,2,1,3,66.7%,1m
13230,1,[cxzczx]Knightmare,3111,0,0,1,1,0.0%,30m
13247,1,AmigoZargon,3110,1486,144,130,274,52.6%,29m
13247,3,[AofS]SpadeJr,3110,1168,73,56,129,56.6%,38m
13247,3,Heisenberg,3110,1572,64,69,133,48.1%,7m
13247,1,Buttercream,3110,484,19,14,33,57.6%,8m
13247,3,[UrBX]Callnoway,3110,490,17,22,39,43.6%,4m
13247,3,[CntPnt]HunterTCP,3110,272,11,9,20,55.0%,5m
13247,3,MEGALOVANIA,3110,304,11,16,27,40.7%,6m
13247,2,Platnumvirus,3110,246,9,16,25,36.0%,20m
13247,1,[DwlD]Locopedro,3110,170,8,3,11,72.7%,3m
13247,1,[xTQc]Maz,3110,214,7,2,9,77.8%,3m
13247,1,FimTiggle,3110,145,6,6,12,50.0%,1h
13247,3,MagicHeart,3110,156,5,10,15,33.3%,20m
13247,3,[GOK]mackenzie,3110,0,4,1,5,80.0%,2h
13247,1,Aspros,3110,156,4,2,6,66.7%,29m
13247,1,[HoFoCo]spoonodoom,3110,177,4,2,6,66.7%,31m
13247,3,SlayerSBeaST,3110,92,4,7,11,36.4%,13m
13247,3,Odin,3110,66,3,15,18,16.7%,30m
13247,1,Hello,3110,38,2,1,3,66.7%,13m
13247,1,mind,3110,0,1,0,1,100.0%,41m
13247,3,[EoC]Luxsong,3110,0,1,3,4,25.0%,2h
13267,3,never,3109,1543,337,288,625,53.9%,19m
13267,1,Xeagle,3109,1578,154,124,278,55.4%,16m
13267,3,KiPlayer,3109,1460,111,117,228,48.7%,19m
13267,3,Lexxi,3109,865,104,87,191,54.5%,13m
13267,3,Atmosfear,3109,868,36,30,66,54.5%,32m
13267,3,Castle,3109,389,35,24,59,59.3%,7m
13267,3,[eN3Ma]Player,3109,458,25,27,52,48.1%,4m
13267,1,[YOSHII]GomichiX,3109,725,21,22,43,48.8%,2m
13267,3,[D1KS]Gido,3109,319,12,8,20,60.0%,16m
13267,1,[UoM]Dactaxx,3109,361,12,10,22,54.5%,28m
13267,3,babytofu,3109,166,8,4,12,66.7%,19m
13267,1,AnungUnRama,3109,216,7,3,10,70.0%,34m
13267,3,DeadDevil,3109,190,7,8,15,46.7%,5m
13267,3,mistercorea,3109,127,6,13,19,31.6%,1m
13267,1,cpfakf,3109,158,5,3,8,62.5%,24m
13267,1,itsatrap,3109,144,3,1,4,75.0%,16m
13267,1,[MLG69]Peperino,3109,74,3,1,4,75.0%,18m
13267,1,JKell,3109,42,2,0,2,100.0%,34m
13267,3,[Meadow]detour,3109,94,2,5,7,28.6%,27m
13267,1,nomad,3109,0,0,1,1,0.0%,31m
13267,1,[GEEKED]MOON,3109,0,0,1,1,0.0%,12m
13267,1,[PobSC]Isfergoler,3109,0,0,1,1,0.0%,34m
13267,1,ProduceGuy,3109,0,0,3,3,0.0%,31m
13290,3,DrPhoton,3108,1538,156,126,282,55.3%,28m
13290,3,RAMCHITRIBE,3108,1412,150,146,296,50.7%,3m
13290,3,Rheese,3108,1372,101,79,180,56.1%,18m
13290,3,[eSx]Strider,3108,1316,94,85,179,52.5%,24m
13290,3,[proDS]Wahish,3108,1468,77,76,153,50.3%,12m
13290,3,Envy,3108,995,66,58,124,53.2%,43m
13290,3,[anti5z]Aldaris,3108,970,49,52,101,48.5%,23m
13290,1,Proverbs,3108,1028,40,31,71,56.3%,29m
13290,1,[DWH]CinosRepus,3108,695,28,19,47,59.6%,4m
13290,1,[GaOn]Reznik,3108,517,18,9,27,66.7%,38m
13290,3,[Eks7]VicMuller,3108,330,15,9,24,62.5%,31m
13290,2,CoachLarry,3108,325,14,9,23,60.9%,43m
13290,3,Sirghanistan,3108,322,13,9,22,59.1%,16m
13290,3,[Apprvd]Soup,3108,273,13,13,26,50.0%,19m
13290,3,jeanfranco,3108,232,11,8,19,57.9%,21m
13290,3,[Z0HR]MacroZerg,3108,257,7,8,15,46.7%,15m
13290,1,[dreamG]lorienGA,3108,225,6,2,8,75.0%,30m
13290,1,CaM,3108,194,6,5,11,54.5%,30m
13290,1,Zorb,3108,149,5,4,9,55.6%,34m
13290,3,Majesty,3108,114,3,4,7,42.9%,3m
13290,3,[Baraka]DjDannyTV,3108,0,2,3,5,40.0%,38m
13290,3,SKYTOSS,3108,38,2,3,5,40.0%,19m
13290,1,Muhibet,3108,0,2,3,5,40.0%,38m
13290,1,GRIMLOCK,3108,0,1,0,1,100.0%,16m
13290,1,Iolo,3108,0,1,0,1,100.0%,16m
13290,1,Quarms,3108,0,1,7,8,12.5%,2h
13290,1,TrollingPoll,3108,0,0,1,1,0.0%,34m
13290,2,Zilk,3108,0,0,1,1,0.0%,28m
13290,1,haritoxs,3108,0,0,1,1,0.0%,26m
13290,3,[Imperi]AngryMango,3108,0,0,2,2,0.0%,8m
13320,3,Nhranagacon,3107,1484,586,565,1151,50.9%,32m
13320,3,IceRunner,3107,1032,224,226,450,49.8%,24m
13320,1,Rupphire,3107,1769,133,99,232,57.3%,3m
13320,3,[Mc]Fenrir,3107,1461,105,114,219,47.9%,30m
13320,3,Tommed,3107,983,49,26,75,65.3%,25m
13320,2,[Ris3n]PhoenixKing,3107,865,43,64,107,40.2%,17m
13320,3,Cayeuf,3107,940,36,41,77,46.8%,15m
13320,3,FallenMonk,3107,608,21,22,43,48.8%,4m
13320,1,raymadereck,3107,329,20,10,30,66.7%,20m
13320,3,Morgeno,3107,461,19,13,32,59.4%,34m
13320,1,demchi,3107,504,14,15,29,48.3%,8m
13320,3,Goliath,3107,262,11,8,19,57.9%,32m
13320,1,[IPCSI]BARBOL,3107,266,8,6,14,57.1%,15m
13320,1,Woody,3107,123,7,4,11,63.6%,33m
13320,3,OKOKOK,3107,200,7,10,17,41.2%,26m
13320,1,[YLG]NuTz,3107,222,6,4,10,60.0%,22m
13320,3,PowerQueso,3107,121,5,2,7,71.4%,2h
13320,1,ALCHEMIC,3107,160,5,3,8,62.5%,8m
13320,1,melciromelon,3107,97,4,2,6,66.7%,2h
13320,3,[SaintJ]Anakin,3107,94,4,9,13,30.8%,44m
13320,1,TheDumbOx,3107,116,3,3,6,50.0%,22m
13320,3,StoneyBalony,3107,94,3,10,13,23.1%,9m
13320,1,ImABaller,3107,86,2,2,4,50.0%,4m
13320,1,Peen,3107,95,2,6,8,25.0%,40m
13320,1,[PSlSTC]cyan,3107,0,1,1,2,50.0%,39m
13320,1,ClubGlam,3107,42,1,3,4,25.0%,39m
13320,3,[TxPain]IIcptII,3107,93,1,4,5,20.0%,1m
13320,1,enterprise,3107,0,1,7,8,12.5%,8m
13320,1,Peugeot,3107,0,0,1,1,0.0%,31m
13320,1,Mike,3107,0,0,2,2,0.0%,31m
13320,1,[LCE]PULPIN,3107,0,0,3,3,0.0%,25m
13351,1,[KGH6]Liberator,3106,941,109,108,217,50.2%,15m
13351,3,[TGosuB]BisDaQ,3106,1387,95,93,188,50.5%,7m
13351,1,[K0T]Megalimus,3106,1064,56,12,68,82.4%,38m
13351,3,[xLgNx]MrsAhrim,3106,372,15,18,33,45.5%,33m
13351,3,jedicouncil,3106,279,11,7,18,61.1%,4m
13351,3,REDBAR,3106,161,9,5,14,64.3%,25m
13351,2,[UWCSC]ctat,3106,182,6,0,6,100.0%,11m
13351,1,[YSHI]Aibi,3106,202,5,2,7,71.4%,25m
13351,1,Nicolodian,3106,0,4,1,5,80.0%,4m
13351,1,[PERUII]AngryZealot,3106,116,3,2,5,60.0%,3m
13351,1,[ZNsc]Nationwide,3106,80,2,2,4,50.0%,22m
13351,1,Gandalf,3106,0,1,0,1,100.0%,3m
13351,3,Kore,3106,0,1,0,1,100.0%,38m
13351,2,[Drakes]Manuel,3106,91,1,1,2,50.0%,11m
13351,3,staskesensei,3106,44,1,2,3,33.3%,36m
13351,1,ENDER,3106,0,0,1,1,0.0%,41m
13351,1,Reconus,3106,0,0,2,2,0.0%,25m
13368,3,[TPGGXD]ManneRBeeR,3105,1599,206,205,411,50.1%,42m
13368,3,Ciberdiablo,3105,1189,102,94,196,52.0%,34m
13368,3,Ichigo,3105,464,18,16,34,52.9%,31m
13368,3,Daddy,3105,508,17,19,36,47.2%,16m
13368,3,Brandon,3105,206,7,7,14,50.0%,21m
13368,1,boogeh,3105,193,6,3,9,66.7%,3m
13368,1,Shivers,3105,208,5,3,8,62.5%,2h
13368,1,GhostDragon,3105,159,3,1,4,75.0%,3h
13368,1,icheese,3105,116,3,3,6,50.0%,4m
13368,3,hydrokilla,3105,30,2,6,8,25.0%,9m
13368,1,Majitsu,3105,0,1,2,3,33.3%,33m
13368,1,[UCSD]nobodywonder,3105,0,1,2,3,33.3%,4m
13368,1,[GIBE]Enigma,3105,0,0,2,2,0.0%,25m
13381,3,Jauvil,3104,788,334,314,648,51.5%,3m
13381,3,LeonAioria,3104,1538,242,227,469,51.6%,34m
13381,3,YamKay,3104,1387,159,153,312,51.0%,1m
13381,1,Guackamo,3104,1199,98,75,173,56.6%,16m
13381,3,Sinow,3104,1403,83,78,161,51.6%,31m
13381,3,Trapnasty,3104,1267,61,60,121,50.4%,13m
13381,3,RastaPigg,3104,1017,42,42,84,50.0%,33m
13381,3,[OHS]Kojol,3104,672,26,27,53,49.1%,7m
13381,1,Happyfeet,3104,493,19,15,34,55.9%,20m
13381,1,[C3PO]Nio,3104,356,16,10,26,61.5%,4m
13381,1,[LowIQ]EvolFighter,3104,417,12,8,20,60.0%,2m
13381,3,JaBc,3104,306,11,11,22,50.0%,22m
13381,3,BadManner,3104,238,8,10,18,44.4%,24m
13381,2,[PAJ]llllllllllll,3104,117,6,3,9,66.7%,27m
13381,3,igoairok,3104,164,6,5,11,54.5%,26m
13381,3,Move,3104,128,4,10,14,28.6%,38m
13381,2,[CEng]wawdj,3104,0,2,5,7,28.6%,11m
13381,1,ByNight,3104,0,0,1,1,0.0%,40m
13381,1,DeanoRino,3104,0,0,1,1,0.0%,18m
13381,1,Bainz,3104,0,0,2,2,0.0%,1h
13381,1,Mok,3104,0,0,2,2,0.0%,41m
13381,3,[SuperZ]BroToss,3104,0,0,6,6,0.0%,7m
13403,3,WAP,3103,1535,733,708,1441,50.9%,32m
13403,3,[vNc]Wannaspeed,3103,1619,328,310,638,51.4%,28m
13403,1,PArkanian,3103,910,29,31,60,48.3%,22m
13403,1,nooob,3103,293,23,14,37,62.2%,15m
13403,1,Pavblo,3103,503,15,16,31,48.4%,19m
13403,1,[CS0]ShadowWil,3103,305,13,1,14,92.9%,32m
13403,1,Lehdari,3103,374,11,8,19,57.9%,3m
13403,3,QWERTY,3103,277,11,8,19,57.9%,13m
13403,3,IAmTheWalrus,3103,272,9,15,24,37.5%,30m
13403,2,[GnR]Strafe,3103,176,7,6,13,53.8%,9m
13403,3,Lestat,3103,122,6,4,10,60.0%,31m
13403,1,Kaiser,3103,196,6,5,11,54.5%,28m
13403,1,Aqua,3103,89,4,2,6,66.7%,12m
13403,1,SmurfDaddy,3103,0,2,3,5,40.0%,26m
13403,1,Nightmare,3103,0,1,0,1,100.0%,29m
13403,1,[Jungy]SHiZL,3103,0,0,1,1,0.0%,18m
13403,1,ChrisFive,3103,0,0,1,1,0.0%,4m
13420,2,Logun,3102,1606,346,361,707,48.9%,27m
13420,3,StewphieConn,3102,1264,124,114,238,52.1%,10m
13420,3,turbokid,3102,814,60,64,124,48.4%,11m
13420,3,CarpAngler,3102,969,39,33,72,54.2%,13m
13420,3,Solaris,3102,746,27,33,60,45.0%,39m
13420,3,[TPGGXD]GeekRaynor,3102,425,16,14,30,53.3%,28m
13420,1,FerRizo,3102,520,16,16,32,50.0%,41m
13420,3,LeAgente,3102,272,15,15,30,50.0%,11m
13420,1,Legion,3102,373,14,6,20,70.0%,6m
13420,1,ISUCKATTHIS,3102,516,14,13,27,51.9%,32m
13420,3,[DGP]Osukaru,3102,390,13,20,33,39.4%,23m
13420,3,Richard,3102,354,13,22,35,37.1%,24m
13420,3,Xakari,3102,221,10,7,17,58.8%,44m
13420,1,[iMkS]Dax,3102,296,9,8,17,52.9%,18m
13420,1,Anticlimaxic,3102,330,9,10,19,47.4%,24m
13420,2,[deezy]Cenanin,3102,227,8,6,14,57.1%,33m
13420,3,ThrillaSC,3102,234,8,11,19,42.1%,27m
13420,1,Cesar,3102,0,1,0,1,100.0%,40m
13438,3,superpants,3101,1638,225,219,444,50.7%,28m
13438,3,SolidState,3101,736,165,137,302,54.6%,28m
13438,1,[EdeN]Pangloss,3101,1776,69,59,128,53.9%,10m
13438,3,markzor,3101,736,64,62,126,50.8%,32m
13438,3,Pmoss,3101,608,58,53,111,52.3%,7m
13438,1,Vendetta,3101,1108,39,32,71,54.9%,41m
13438,3,[iS1MP]Feather,3101,531,31,26,57,54.4%,5m
13438,3,[TEAMOD]Charge,3101,714,27,32,59,45.8%,23m
13438,1,[EZDUNK]chuckdoodle,3101,414,11,11,22,50.0%,11m
13438,3,KingBytor,3101,201,8,3,11,72.7%,20m
13438,1,kevin,3101,296,8,6,14,57.1%,2m
13438,1,Redeemer,3101,165,4,3,7,57.1%,2h
13438,1,[DEPRS]Eauxcaigh,3101,125,3,0,3,100.0%,2m
13438,3,[kunts]mightymitten,3101,86,3,7,10,30.0%,24m
13438,1,Miguel,3101,0,0,1,1,0.0%,2h
13438,3,PRPL,3101,0,0,4,4,0.0%,1m
13454,3,TimTan,3100,1524,93,78,171,54.4%,15m
13454,3,[WSBBC]Ebbitten,3100,958,38,45,83,45.8%,18m
13454,1,VaLi,3100,433,16,12,28,57.1%,16m
13454,3,Skyholder,3100,318,12,9,21,57.1%,12m
13454,3,[MeS0]Bepis,3100,337,11,11,22,50.0%,21m
13454,3,bigBo,3100,0,4,2,6,66.7%,36m
13454,3,darkmoon,3100,88,3,8,11,27.3%,28m
13454,3,[CT6OG]NDNPancake,3100,0,2,1,3,66.7%,3h
13454,1,peraples,3100,72,2,1,3,66.7%,39m
13454,1,MpK,3100,80,2,3,5,40.0%,13m
13454,3,[NGS616]Towel,3100,58,2,12,14,14.3%,42m
13454,1,[NwAs]noke,3100,0,1,0,1,100.0%,1m
13454,1,ued,3100,42,1,2,3,33.3%,4m
13454,1,YEETMAS,3100,0,0,3,3,0.0%,19m
13468,3,KAT,3099,1601,699,656,1355,51.6%,12m
13468,1,Deasy,3099,1698,152,140,292,52.1%,18m
13468,3,Unranked,3099,1081,101,95,196,51.5%,3m
13468,3,[VFam]Fury,3099,1480,81,73,154,52.6%,11m
13468,3,Raedin,3099,1054,64,51,115,55.7%,31m
13468,3,PatrioticP,3099,1241,55,57,112,49.1%,41m
13468,3,Khanta,3099,795,33,27,60,55.0%,29m
13468,3,[GTDR]StevO,3099,357,31,26,57,54.4%,30m
13468,1,Riker,3099,333,23,20,43,53.5%,10m
13468,3,Cestructor,3099,325,20,23,43,46.5%,19m
13468,1,Jordis,3099,325,15,5,20,75.0%,31m
13468,3,[CRAKS]KAUR,3099,324,12,14,26,46.2%,13m
13468,1,Flash,3099,296,8,8,16,50.0%,20m
13468,1,deviantbum,3099,235,7,4,11,63.6%,2h
13468,1,[Shrek2]Kalderasha,3099,143,7,9,16,43.8%,34m
13468,3,SciFoxWitch,3099,30,4,4,8,50.0%,11m
13468,3,apetrooper,3099,146,4,5,9,44.4%,41m
13468,1,Fluffhead,3099,78,2,1,3,66.7%,32m
13468,1,[BlTEL]HidenTiger,3099,0,1,0,1,100.0%,15m
13468,1,[RED3Y3]apocalipt,3099,0,1,0,1,100.0%,13m
13468,1,[hando]BlueBlobbidy,3099,0,1,0,1,100.0%,4m
13468,1,Viir,3099,0,0,1,1,0.0%,25m
13468,1,nrse,3099,0,0,1,1,0.0%,38m
13491,1,[LaOr]Thorrox,3098,1726,159,141,300,53.0%,29m
13491,1,HeresyReznor,3098,1292,133,110,243,54.7%,8m
13491,3,Crunklord,3098,1509,129,127,256,50.4%,7m
13491,3,rRokKnRolL,3098,1114,101,100,201,50.2%,27m
13491,3,[AbcCo]Amir,3098,1514,85,88,173,49.1%,32m
13491,1,JCookie,3098,1741,79,73,152,52.0%,2m
13491,1,[SISR]Phasing,3098,616,19,16,35,54.3%,42m
13491,3,Mikro,3098,483,18,19,37,48.6%,8m
13491,1,jerzyn,3098,391,11,12,23,47.8%,1m
13491,1,Michilover,3098,216,6,4,10,60.0%,40m
13491,3,Incognito,3098,106,6,9,15,40.0%,4m
13491,1,Lando,3098,156,5,4,9,55.6%,15m
13491,1,bluebandit,3098,162,4,6,10,40.0%,12m
13491,1,Knowledge,3098,0,2,3,5,40.0%,10m
13491,3,[HØST]Koss,3098,62,2,7,9,22.2%,44m
13491,1,Tornado,3098,0,1,0,1,100.0%,29m
13491,1,Leaf,3098,0,1,0,1,100.0%,19m
13491,1,PANDARINMAN,3098,0,1,1,2,50.0%,26m
13491,1,llllllllllll,3098,0,1,1,2,50.0%,13m
13491,2,Trixta,3098,46,1,4,5,20.0%,29m
13491,1,[GOPERÚ]ELGRANn,3098,0,0,1,1,0.0%,30m
13512,3,ccIIIIIyyIII,3097,1559,350,342,692,50.6%,22m
13512,1,David,3097,1785,328,304,632,51.9%,23m
13512,1,[8iSh]Protossible,3097,1609,88,79,167,52.7%,8m
13512,1,QplantiumP,3097,1028,66,50,116,56.9%,41m
13512,3,[GGK]sage,3097,1570,65,63,128,50.8%,21m
13512,3,poodoo,3097,1229,52,42,94,55.3%,28m
13512,3,VVingless,3097,1018,44,34,78,56.4%,25m
13512,3,[zelniq]HogNiqqa,3097,473,43,46,89,48.3%,21m
13512,3,WHTVRTTKS,3097,970,39,35,74,52.7%,26m
13512,3,Bryce,3097,636,23,29,52,44.2%,1m
13512,3,[IPCSI]Mithrandir,3097,485,21,20,41,51.2%,4m
13512,1,psykosenator,3097,404,12,11,23,52.2%,1m
13512,3,[lLiTl]HektorOfTroy,3097,368,12,22,34,35.3%,7m
13512,1,Shivana,3097,232,7,3,10,70.0%,20m
13512,1,FlyingHorse,3097,124,4,3,7,57.1%,29m
13512,1,Kav,3097,38,2,1,3,66.7%,20m
13512,1,[JUGOSP]starcrafiano,3097,40,2,1,3,66.7%,34m
13512,3,[34]Danimal,3097,60,2,7,9,22.2%,44m
13512,1,[IroMan]Eicr,3097,42,1,2,3,33.3%,17m
13512,3,VladImpaler,3097,0,0,1,1,0.0%,1h
13512,1,[Macac0]Yorkatt,3097,0,0,1,1,0.0%,2m
13533,3,Panoramic,3096,698,92,97,189,48.7%,23m
13533,1,Mars,3096,667,42,35,77,54.5%,10m
13533,3,[SpLoMe]Butters,3096,674,30,27,57,52.6%,24m
13533,3,ZDoritoSan,3096,284,13,10,23,56.5%,1m
13533,3,[TCHNO]UncleBanjo,3096,225,11,7,18,61.1%,20m
13533,1,titan,3096,270,7,9,16,43.8%,19m
13533,3,Ulvkirg,3096,148,5,13,18,27.8%,21m
13533,3,nika,3096,0,4,1,5,80.0%,23m
13533,1,[MSCE]MADCERBERO,3096,80,2,1,3,66.7%,39m
13533,3,acidplayer,3096,95,2,1,3,66.7%,28m
13533,3,Lumer,3096,0,2,4,6,33.3%,21m
13533,3,inoukchouck,3096,58,2,6,8,25.0%,13m
13533,1,[Moneey]Gryzm,3096,0,1,0,1,100.0%,19m
13533,1,Petrovich,3096,0,1,0,1,100.0%,24m
13533,1,AzazelPoeta,3096,0,1,0,1,100.0%,26m
13533,1,erunky,3096,40,1,2,3,33.3%,18m
13533,1,Ghetszu,3096,0,0,1,1,0.0%,1m
13533,2,Arklite,3096,0,0,1,1,0.0%,1h
13551,3,Alexandros,3095,1197,116,113,229,50.7%,4m
13551,3,ZeroHedge,3095,1355,83,70,153,54.2%,19m
13551,3,ShrekBaggins,3095,1092,73,70,143,51.0%,29m
13551,1,vicTTor,3095,770,49,39,88,55.7%,4m
13551,1,Burningcrow,3095,1128,47,38,85,55.3%,29m
13551,3,[Bet0]snOwcOne,3095,1222,42,62,104,40.4%,9m
13551,3,GustavLauben,3095,814,38,44,82,46.3%,33m
13551,1,STEER,3095,606,24,17,41,58.5%,2m
13551,1,[BRSKR]WookieMonsta,3095,572,19,13,32,59.4%,13m
13551,3,FlameEssence,3095,461,18,13,31,58.1%,24m
13551,3,Dayman,3095,372,14,24,38,36.8%,34m
13551,3,[MaAtMo]MooCow,3095,212,9,17,26,34.6%,24m
13551,1,darkdiamond,3095,229,8,4,12,66.7%,18m
13551,3,Gnova,3095,145,6,2,8,75.0%,23m
13551,3,Aliean,3095,0,4,2,6,66.7%,26m
13551,3,[RSGP]Elking,3095,86,3,11,14,21.4%,5m
13551,1,[SGSPP]Sushiagogo,3095,40,1,1,2,50.0%,10m
13551,1,EpicD,3095,0,1,2,3,33.3%,3m
13551,1,ghosttemplar,3095,0,0,1,1,0.0%,23m
13570,3,JamesBond,3094,1128,423,423,846,50.0%,1m
13570,3,Nytro,3094,1599,360,348,708,50.8%,43m
13570,3,GrandMaster,3094,1592,217,214,431,50.3%,6m
13570,3,[C66]Bigpoppa,3094,1511,191,175,366,52.2%,32m
13570,3,cTxavier,3094,1586,125,122,247,50.6%,42m
13570,3,BluePellican,3094,1308,82,84,166,49.4%,44m
13570,1,[platin]GrOoViE,3094,317,33,14,47,70.2%,10m
13570,3,Dulcet,3094,678,25,29,54,46.3%,21m
13570,1,[AbcCo]Endimión,3094,437,21,4,25,84.0%,32m
13570,3,ZergTooEasy,3094,297,18,19,37,48.6%,25m
13570,3,LaughingGoat,3094,304,10,16,26,38.5%,10m
13570,3,[DHZAcD]Diamonaizer,3094,227,9,10,19,47.4%,8m
13570,3,DIZ,3094,122,8,9,17,47.1%,41m
13570,3,[GChees]ShyGuy,3094,266,8,9,17,47.1%,4m
13570,1,brad,3094,168,7,3,10,70.0%,22m
13570,3,Braveblue,3094,157,6,3,9,66.7%,3h
13570,3,[New2it]ARabidDogg,3094,146,6,9,15,40.0%,34m
13570,1,Shadula,3094,101,5,2,7,71.4%,3m
13570,3,NeoModern,3094,30,5,4,9,55.6%,17m
13570,1,[KGH3]BlackHydra,3094,112,3,3,6,50.0%,18m
13570,1,pancakefoo,3094,82,2,4,6,33.3%,29m
13570,1,asd,3094,0,1,0,1,100.0%,12m
13570,1,knighty,3094,0,1,0,1,100.0%,25m
13593,3,AdmiralWok,3093,1020,108,115,223,48.4%,23m
13593,3,[BlTEL]Bru,3093,1524,106,105,211,50.2%,34m
13593,1,DrNeptune,3093,1498,85,81,166,51.2%,24m
13593,1,SCJONES,3093,1763,76,70,146,52.1%,20m
13593,3,[LprtsK]Shagrat,3093,695,60,63,123,48.8%,1m
13593,1,wolfgang,3093,879,41,39,80,51.2%,23m
13593,3,[XpKb]Nada,3093,933,39,35,74,52.7%,42m
13593,1,[OlVera]Edaliz,3093,772,35,28,63,55.6%,4m
13593,1,[Zatra]Xforce,3093,477,27,13,40,67.5%,15m
13593,1,rbax,3093,654,23,21,44,52.3%,42m
13593,1,[xHRx]whenInRome,3093,668,21,22,43,48.8%,4m
13593,3,Maicke,3093,612,21,25,46,45.7%,3m
13593,3,[The248]LTon,3093,317,19,13,32,59.4%,30m
13593,3,JKPW,3093,468,17,21,38,44.7%,9m
13593,3,Automatic,3093,393,15,16,31,48.4%,38m
13593,1,Metradime,3093,426,12,8,20,60.0%,32m
13593,3,Chaos,3093,285,9,12,21,42.9%,12m
13593,1,[MTiger]majesticdude,3093,188,5,4,9,55.6%,20m
13593,3,Kiryu,3093,145,4,4,8,50.0%,2h
13593,1,Seiya,3093,0,1,0,1,100.0%,31m
13593,1,kylos,3093,0,1,0,1,100.0%,8m
13593,1,llllllllllll,3093,42,1,2,3,33.3%,16m
13615,3,Voodoochild,3092,1289,285,262,547,52.1%,10m
13615,3,Rudra,3092,1460,78,87,165,47.3%,15m
13615,3,alphonzo,3092,757,48,40,88,54.5%,42m
13615,1,Rigel,3092,927,42,23,65,64.6%,6m
13615,1,[ValidG]BiggusProbus,3092,463,34,21,55,61.8%,32m
13615,3,HenRays,3092,443,28,24,52,53.8%,24m
13615,3,TheMuffinMan,3092,662,25,22,47,53.2%,26m
13615,3,[RQsc]Impstomper,3092,523,23,19,42,54.8%,27m
13615,3,Floyd,3092,608,23,27,50,46.0%,22m
13615,3,Awkrunch,3092,504,20,15,35,57.1%,24m
13615,3,[TeamUR]Chip,3092,305,13,7,20,65.0%,26m
13615,1,You,3092,323,11,4,15,73.3%,29m
13615,1,Dibs,3092,252,10,8,18,55.6%,29m
13615,1,Gelo,3092,279,9,5,14,64.3%,32m
13615,1,[SLAMT]ElecTrAsY,3092,114,7,1,8,87.5%,29m
13615,1,lappy,3092,162,5,5,10,50.0%,34m
13615,3,Fleck,3092,97,4,2,6,66.7%,1h
13615,1,sUPerSMuRf,3092,121,3,1,4,75.0%,29m
13615,1,WulfBane,3092,0,1,0,1,100.0%,19m
13615,1,[ØÛ]Kurt,3092,0,1,2,3,33.3%,6m
13615,1,HYRULE,3092,0,0,1,1,0.0%,32m
13615,1,Robtek,3092,0,0,1,1,0.0%,11m
13637,3,Ralos,3091,1504,157,153,310,50.6%,7m
13637,3,[TTKOPF]daniel,3091,1511,154,137,291,52.9%,33m
13637,1,myladderpts,3091,1302,114,109,223,51.1%,41m
13637,3,Woweyz,3091,1058,44,39,83,53.0%,21m
13637,1,DireRaven,3091,1116,38,37,75,50.7%,33m
13637,3,Ozy,3091,525,22,36,58,37.9%,7m
13637,1,[tay]MooGoo,3091,445,15,18,33,45.5%,1m
13637,1,[HPing]Armadesdons,3091,398,14,5,19,73.7%,18m
13637,3,MilfHunter,3091,402,14,15,29,48.3%,28m
13637,1,LLLLLLLLLLl,3091,288,12,2,14,85.7%,16m
13637,1,[MISIP]CipheR,3091,230,9,5,14,64.3%,41m
13637,1,PelicanWhomp,3091,152,5,4,9,55.6%,21m
13637,3,Vaala,3091,148,4,4,8,50.0%,8m
13637,1,Tdevil,3091,108,3,1,4,75.0%,13m
13637,1,Toast,3091,78,2,3,5,40.0%,40m
13637,1,Brr,3091,0,1,0,1,100.0%,40m
13653,3,Loop,3090,1256,388,389,777,49.9%,26m
13653,3,[WASM]Buster,3090,1489,143,140,283,50.5%,24m
13653,3,Bovice,3090,1230,142,148,290,49.0%,18m
13653,1,[ØÛ]JoseEddie,3090,1243,47,41,88,53.4%,27m
13653,1,Patrick,3090,1225,45,36,81,55.6%,42m
13653,1,Tassadar,3090,994,37,29,66,56.1%,6m
13653,1,icarooo,3090,1052,37,30,67,55.2%,4m
13653,1,xQcAlinity,3090,638,24,16,40,60.0%,18m
13653,1,ToastProxy,3090,547,23,22,45,51.1%,22m
13653,3,NUGGETHEAD,3090,508,21,18,39,53.8%,7m
13653,3,deadhero,3090,424,19,12,31,61.3%,12m
13653,3,zMuffinManZz,3090,336,14,13,27,51.9%,16m
13653,2,[aIiens]plasma,3090,184,9,4,13,69.2%,2h
13653,1,DeathByPants,3090,184,8,8,16,50.0%,24m
13653,1,[Madn3s]MeatXD,3090,0,3,2,5,60.0%,2h
13653,1,Camysae,3090,88,3,3,6,50.0%,24m
13653,1,niubi,3090,82,3,7,10,30.0%,18m
13653,1,Gollum,3090,38,2,1,3,66.7%,32m
13653,1,Metric,3090,74,2,2,4,50.0%,2m
13653,1,Bacon,3090,38,2,2,4,50.0%,4m
13653,1,FTJ,3090,0,1,0,1,100.0%,6m
13653,1,LeWildWolf,3090,0,1,0,1,100.0%,28m
13653,1,SlugHam,3090,0,1,4,5,20.0%,31m
13653,1,Fallenleaves,3090,0,0,3,3,0.0%,2m
13677,1,Ardantis,3089,1762,102,94,196,52.0%,2m
13677,3,[SC2BOL]JJVO,3089,416,61,54,115,53.0%,41m
13677,3,Nodre,3089,1121,54,40,94,57.4%,18m
13677,3,[SMSH]maccabe,3089,583,42,45,87,48.3%,7m
13677,1,Heliotropic,3089,734,27,17,44,61.4%,25m
13677,3,JacksMedula,3089,628,25,25,50,50.0%,12m
13677,3,Zenit,3089,149,13,16,29,44.8%,7m
13677,2,Luxior,3089,203,8,3,11,72.7%,2h
13677,3,[DNuts]CoKiller,3089,224,6,13,19,31.6%,24m
13677,1,[NiERDS]bohdan,3089,174,5,0,5,100.0%,42m
13677,1,MonsteR,3089,190,5,4,9,55.6%,13m
13677,3,xwikx,3089,0,4,2,6,66.7%,39m
13677,1,[TheDOH]MartinMese,3089,42,2,1,3,66.7%,42m
13677,3,[Seinfd]George,3089,62,2,8,10,20.0%,9m
13677,1,ComarPers,3089,34,1,1,2,50.0%,39m
13677,1,[Outset]Triskaideka,3089,0,0,1,1,0.0%,41m
13693,2,[TheDOH]MelchorRochi,3088,1519,539,535,1074,50.2%,25m
13693,1,[Potate]Myollneer,3088,1506,82,73,155,52.9%,33m
13693,3,Bryson,3088,1215,46,44,90,51.1%,4m
13693,3,Deymar,3088,1018,42,31,73,57.5%,15m
13693,1,[GdAT]WithoutAclue,3088,1172,42,38,80,52.5%,34m
13693,1,[ZCCCFE]Eric,3088,802,31,18,49,63.3%,18m
13693,3,FriendlyBug,3088,664,29,24,53,54.7%,17m
13693,1,[iTE]CableBaby,3088,725,22,18,40,55.0%,7m
13693,1,Armamani,3088,618,21,15,36,58.3%,7m
13693,3,IconicKnight,3088,136,7,3,10,70.0%,16m
13693,2,Why,3088,205,7,5,12,58.3%,23m
13693,2,Bigfoot,3088,94,5,3,8,62.5%,2h
13693,1,IIIIIIIII,3088,174,4,1,5,80.0%,16m
13693,1,cusio,3088,146,4,4,8,50.0%,2h
13693,1,vlad,3088,88,1,1,2,50.0%,29m
13693,3,UndeadRanger,3088,0,1,3,4,25.0%,40m
13693,1,mantis,3088,73,0,2,2,0.0%,12m
13693,2,[xRFR]PretendBeast,3088,0,0,2,2,0.0%,2h
13693,1,IlIlIlIlIlII,3088,0,0,3,3,0.0%,2m
13712,3,Arcane,3087,1533,216,189,405,53.3%,16m
13712,3,fuluves,3087,1428,157,128,285,55.1%,34m
13712,3,Gygy,3087,1405,145,139,284,51.1%,7m
13712,3,Khumbu,3087,607,74,78,152,48.7%,22m
13712,1,Nilosaur,3087,1585,64,55,119,53.8%,27m
13712,1,CrazyDiamond,3087,1012,49,38,87,56.3%,43m
13712,1,Fins,3087,460,19,13,32,59.4%,32m
13712,2,device,3087,338,13,9,22,59.1%,44m
13712,1,Paris,3087,161,10,10,20,50.0%,12m
13712,3,cacheMoney,3087,258,8,19,27,29.6%,23m
13712,1,Crown,3087,182,7,4,11,63.6%,27m
13712,3,[iCrapp]MrPooped,3087,218,7,12,19,36.8%,18m
13712,3,iReach,3087,94,4,4,8,50.0%,21m
13712,1,[loTicI]TyphoonKW,3087,89,3,2,5,60.0%,12m
13712,1,[STAS]Apex,3087,42,2,1,3,66.7%,12m
13712,1,EPICFPV,3087,40,1,4,5,20.0%,8m
13712,1,Jonny,3087,0,0,1,1,0.0%,34m
13712,3,[4aRaza]LUCIFER,3087,0,0,1,1,0.0%,9m
13730,3,[CoKill]IceFang,3086,1220,60,56,116,51.7%,17m
13730,3,PointCook,3086,1050,43,41,84,51.2%,30m
13730,3,OpticalPunch,3086,425,27,32,59,45.8%,11m
13730,1,Kmonster,3086,483,21,17,38,55.3%,43m
13730,1,Nite,3086,470,19,14,33,57.6%,7m
13730,3,VincentK,3086,383,16,11,27,59.3%,18m
13730,3,[Foton]Pulsar,3086,395,13,14,27,48.1%,7m
13730,1,FaithlessT,3086,283,12,9,21,57.1%,22m
13730,3,Ramon,3086,342,12,19,31,38.7%,32m
13730,3,IMSleeping,3086,122,4,8,12,33.3%,34m
13730,1,NightScorpio,3086,186,4,8,12,33.3%,2h
13730,1,spookali,3086,38,2,0,2,100.0%,7m
13730,1,[YEETED]Damien,3086,76,2,1,3,66.7%,14m
13730,1,Dabillitator,3086,42,2,2,4,50.0%,31m
13730,3,Journey,3086,0,0,6,6,0.0%,39m
13745,3,scv,3085,1508,105,105,210,50.0%,21m
13745,3,Protoszoario,3085,1699,99,100,199,49.7%,16m
13745,1,impatienceSC,3085,1407,87,61,148,58.8%,25m
13745,3,MURDOCK,3085,767,33,27,60,55.0%,10m
13745,1,mastertiger,3085,453,19,7,26,73.1%,31m
13745,1,PaltryNewt,3085,590,19,13,32,59.4%,16m
13745,1,bustercat,3085,430,12,10,22,54.5%,34m
13745,3,[TACTEC]awfulplayer,3085,282,12,10,22,54.5%,32m
13745,1,selym,3085,330,9,7,16,56.2%,29m
13745,1,[UpxV]spedross,3085,264,8,5,13,61.5%,20m
13745,3,[TheRMs]ChinChillax,3085,241,8,9,17,47.1%,7m
13745,2,Evelios,3085,141,6,4,10,60.0%,1h
13745,3,Doom,3085,60,6,5,11,54.5%,43m
13745,1,Prodigy,3085,190,5,5,10,50.0%,43m
13745,1,Shieldofaiur,3085,122,3,4,7,42.9%,19m
13745,3,[heyGUY]Rachmaninov,3085,94,2,2,4,50.0%,31m
13745,1,Sooriukengg,3085,0,2,3,5,40.0%,29m
13745,1,Sophon,3085,0,1,0,1,100.0%,41m
13745,1,[TPGGXD]NeronN,3085,0,1,2,3,33.3%,39m
13764,3,[TmGt]Headtrap,3084,1598,126,121,247,51.0%,7m
13764,3,makcre,3084,1452,114,119,233,48.9%,33m
13764,3,Donnadiee,3084,1534,96,98,194,49.5%,23m
13764,3,SpineEater,3084,914,82,77,159,51.6%,19m
13764,3,SerialKiller,3084,946,52,41,93,55.9%,28m
13764,3,Orator,3084,1225,51,43,94,54.3%,33m
13764,3,[Cind3r]Sly,3084,1150,41,51,92,44.6%,28m
13764,3,[Wutzu]sOuLsUrGe,3084,989,39,37,76,51.3%,34m
13764,1,ProToZ,3084,734,24,22,46,52.2%,16m
13764,1,[ZPB]Blindantilop,3084,571,21,17,38,55.3%,2m
13764,1,Fracture,3084,208,6,6,12,50.0%,42m
13764,1,[YWings]Boomz,3084,118,4,1,5,80.0%,41m
13764,1,[POZOS]Capm,3084,0,3,2,5,60.0%,2h
13764,1,[lashgo]eLLODAXi,3084,74,3,2,5,60.0%,8m
13764,1,LosInmensos,3084,38,2,0,2,100.0%,34m
13764,1,DragonShadow,3084,40,2,1,3,66.7%,42m
13764,1,natedog,3084,80,2,3,5,40.0%,4m
13764,1,[neuroW]Dedication,3084,0,0,1,1,0.0%,22m
13764,1,MERINOXD,3084,0,0,1,1,0.0%,32m
13764,1,[LCE]rosedo,3084,0,0,1,1,0.0%,8m
13764,1,BigDicBoi,3084,0,0,1,1,0.0%,2m
13764,1,Mantecrise,3084,0,0,2,2,0.0%,7m
13786,3,Deado,3083,1604,227,204,431,52.7%,40m
13786,3,TaiwanIIIIII,3083,1261,63,45,108,58.3%,26m
13786,1,Iminthebox,3083,641,34,29,63,54.0%,1m
13786,3,[WHlTES]Harry,3083,511,27,31,58,46.6%,7m
13786,3,Trokaneon,3083,708,23,36,59,39.0%,7m
13786,1,TheEase,3083,491,19,12,31,61.3%,14m
13786,1,Tyme,3083,612,19,18,37,51.4%,26m
13786,3,Chronosapien,3083,552,19,28,47,40.4%,1m
13786,1,[BONES]KingSage,3083,411,13,19,32,40.6%,32m
13786,1,OmarCa,3083,302,10,4,14,71.4%,15m
13786,1,eLNoLo,3083,256,10,6,16,62.5%,40m
13786,1,argonkingdom,3083,342,10,8,18,55.6%,42m
13786,3,PoethePug,3083,200,9,6,15,60.0%,33m
13786,3,Solilonarova,3083,206,7,12,19,36.8%,42m
13786,3,[FSTM]steez,3083,0,4,2,6,66.7%,16m
13786,1,reapergoblin,3083,128,3,1,4,75.0%,32m
13786,1,[FMX]Archivo,3083,122,3,7,10,30.0%,8m
13786,1,IIIIIIIIIIII,3083,82,2,3,5,40.0%,41m
13786,1,Tin,3083,0,1,1,2,50.0%,6m
13805,3,Sharky,3082,1479,129,119,248,52.0%,21m
13805,1,Table,3082,1319,97,96,193,50.3%,33m
13805,1,MarkReactor,3082,464,92,74,166,55.4%,26m
13805,1,JOEROGAN,3082,1618,83,82,165,50.3%,15m
13805,3,Rocco,3082,1543,65,62,127,51.2%,42m
13805,3,ZARD,3082,1383,63,56,119,52.9%,26m
13805,1,HiTmaN,3082,1288,49,43,92,53.3%,3m
13805,1,[MP1]CODEX,3082,1091,47,40,87,54.0%,41m
13805,3,KingNothing,3082,1032,44,34,78,56.4%,24m
13805,3,kaboo,3082,705,44,42,86,51.2%,17m
13805,1,[SC2DD]MadSon,3082,750,25,20,45,55.6%,24m
13805,1,[LHdH]EdEvans,3082,512,24,12,36,66.7%,8m
13805,1,DrCarlosSaul,3082,568,24,14,38,63.2%,39m
13805,3,Vindicare,3082,169,11,9,20,55.0%,10m
13805,3,[GRMN]Sunflasher,3082,262,10,8,18,55.6%,41m
13805,3,ForTheHorde,3082,30,6,1,7,85.7%,21m
13805,1,Zeratul,3082,178,6,2,8,75.0%,41m
13805,1,[200107]SunnyJM,3082,227,6,2,8,75.0%,39m
13805,3,Balink,3082,139,5,3,8,62.5%,37m
13805,2,[DEEFY]NattyNJL,3082,118,3,1,4,75.0%,2h
13805,1,Trophysniper,3082,76,3,2,5,60.0%,31m
13805,1,TerranTears,3082,73,1,1,2,50.0%,40m
13805,1,GetRekt,3082,0,1,2,3,33.3%,26m
13805,1,EluSivE,3082,0,0,1,1,0.0%,18m
13805,1,InhWindfist,3082,0,0,1,1,0.0%,16m
13830,1,DaRK,3081,848,285,265,550,51.8%,8m
13830,1,HANS,3081,1699,95,74,169,56.2%,29m
13830,3,[GaaaSQ]iSrAlex,3081,1444,86,76,162,53.1%,39m
13830,1,Astral,3081,781,47,38,85,55.3%,29m
13830,1,Terse,3081,932,44,41,85,51.8%,31m
13830,3,Ether,3081,605,30,35,65,46.2%,9m
13830,1,ELBOTINO,3081,446,15,8,23,65.2%,22m
13830,1,[LGNxx]RobStark,3081,400,11,10,21,52.4%,1m
13830,3,superkiller,3081,268,10,8,18,55.6%,27m
13830,1,[SPokes]ZalocH,3081,203,7,2,9,77.8%,32m
13830,3,Gooolati,3081,62,6,6,12,50.0%,27m
13830,1,[EpicG]Marquis,3081,202,6,6,12,50.0%,29m
13830,1,CptPlanet,3081,154,5,3,8,62.5%,27m
13830,1,Nimrod,3081,156,5,5,10,50.0%,15m
13830,1,tgsgds,3081,122,3,1,4,75.0%,40m
13830,1,Kiddeu,3081,0,1,0,1,100.0%,29m
13830,1,Jebo,3081,38,1,2,3,33.3%,41m
13830,1,SLEEZYCHEEZY,3081,95,1,3,4,25.0%,14m
13830,3,[WNTRLH]PrototypeN,3081,30,1,7,8,12.5%,28m
13830,3,[KhanZ]radaguest,3081,0,0,1,1,0.0%,20m
13850,2,[xLgNx]Iron,3080,1375,259,264,523,49.5%,10m
13850,3,[TgJc]ThatGuyJorge,3080,340,111,75,186,59.7%,7m
13850,3,UraMesHi,3080,1300,90,90,180,50.0%,27m
13850,1,[FFA2]ppjoey,3080,1737,68,62,130,52.3%,10m
13850,1,Wrathknight,3080,800,50,45,95,52.6%,4m
13850,3,BaradatKural,3080,732,34,27,61,55.7%,21m
13850,3,Hebe,3080,857,32,32,64,50.0%,7m
13850,1,Aeon,3080,630,28,23,51,54.9%,11m
13850,3,IIIlIllIlIll,3080,829,28,44,72,38.9%,7m
13850,1,Philzz,3080,705,26,21,47,55.3%,29m
13850,3,Fresh,3080,276,11,11,22,50.0%,26m
13850,1,CryMeARiver,3080,398,11,12,23,47.8%,2m
13850,1,[GAMZ]Heunny,3080,236,7,5,12,58.3%,31m
13850,1,IIIIIIIIIIII,3080,191,7,7,14,50.0%,2h
13850,1,[WOW2EZ]ChinChillin,3080,36,6,1,7,85.7%,22m
13850,1,[BEEBS]jbdude,3080,164,5,5,10,50.0%,4m
13850,1,BladeRunner,3080,114,4,4,8,50.0%,18m
13850,3,BigDlckproxy,3080,44,2,0,2,100.0%,2h
13850,1,TonyBananas,3080,44,2,1,3,66.7%,18m
13850,1,maultaschen,3080,0,0,1,1,0.0%,19m
13850,1,[TGSirs]uiui,3080,73,0,2,2,0.0%,6m
13871,3,Silverfox,3079,1503,198,194,392,50.5%,41m
13871,1,[JRT]yryvu,3079,730,59,36,95,62.1%,6m
13871,1,Arostegui,3079,411,14,8,22,63.6%,33m
13871,3,[Pig2]MaelStorm,3079,370,13,15,28,46.4%,30m
13871,1,groobz,3079,208,7,0,7,100.0%,2m
13871,3,Soptich,3079,119,6,3,9,66.7%,23m
13871,1,alastor,3079,165,5,8,13,38.5%,20m
13871,1,Lambchops,3079,112,4,1,5,80.0%,30m
13871,3,Salchipapa,3079,121,4,3,7,57.1%,3h
13871,3,[No1v1]Remus,3079,92,4,9,13,30.8%,2m
13871,1,Adept,3079,72,2,3,5,40.0%,22m
13871,1,[WFV]freya,3079,0,1,0,1,100.0%,25m
13871,1,Lezaf,3079,0,1,1,2,50.0%,27m
13871,1,[NeAs]fullermarcus,3079,40,1,2,3,33.3%,43m
13871,1,Deoreus,3079,40,1,4,5,20.0%,3m
13871,1,SuperNinja,3079,0,0,1,1,0.0%,16m
13871,1,GOBLIN,3079,0,0,1,1,0.0%,41m
13871,1,ThisDamnGame,3079,0,0,1,1,0.0%,15m
13889,1,botch,3078,1610,107,91,198,54.0%,29m
13889,1,pabolmortis,3078,1696,88,74,162,54.3%,16m
13889,3,JoaquinTRex,3078,1177,61,49,110,55.5%,19m
13889,3,loldonkament,3078,1496,60,63,123,48.8%,27m
13889,1,[DarkAG]Solas,3078,1174,43,34,77,55.8%,32m
13889,1,[KDcb]WuchiKomi,3078,968,37,30,67,55.2%,23m
13889,1,[PPLe]Alfanhui,3078,1009,37,31,68,54.4%,7m
13889,1,[Hawkey]SirHazer,3078,804,25,23,48,52.1%,29m
13889,3,[FFAA]INFRAROJOWL,3078,612,22,27,49,44.9%,30m
13889,1,UltraLing,3078,239,11,3,14,78.6%,4m
13889,1,[Dicboy]Aethros,3078,298,9,9,18,50.0%,15m
13889,3,[2V2G0d]iHasTHIGHS,3078,195,8,8,16,50.0%,15m
13889,3,chickenkid,3078,210,7,12,19,36.8%,11m
13889,1,[WNTRLH]Picc,3078,203,5,3,8,62.5%,24m
13889,1,ShadowDemon,3078,160,4,0,4,100.0%,41m
13889,1,Olaf,3078,0,4,1,5,80.0%,29m
13889,3,Kneaf,3078,154,4,7,11,36.4%,31m
13889,1,[GSND]koehl,3078,78,3,1,4,75.0%,8m
13889,1,NeoSecond,3078,0,1,0,1,100.0%,31m
13889,1,PoKwan,3078,0,1,0,1,100.0%,3m
13889,1,noAPM,3078,0,1,1,2,50.0%,4m
13889,1,Sully,3078,30,1,2,3,33.3%,8m
13889,3,[Black0]xXDaganonXx,3078,0,0,1,1,0.0%,36m
13889,1,alexdrg,3078,0,0,1,1,0.0%,41m
13913,3,[PNS]Makabro,3077,1558,97,79,176,55.1%,19m
13913,3,zerloc,3077,1058,50,35,85,58.8%,17m
13913,1,Yggdrasil,3077,924,45,30,75,60.0%,7m
13913,1,[Lp]Iniwalker,3077,406,14,7,21,66.7%,20m
13913,1,[SuperZ]MINiUltra,3077,247,11,0,11,100.0%,43m
13913,1,ruo,3077,248,7,2,9,77.8%,26m
13913,1,[sblxs]CXKmyson,3077,255,7,9,16,43.8%,29m
13913,1,[Poodin]Penguin,3077,191,6,6,12,50.0%,2h
13913,3,BudMaster,3077,146,5,6,11,45.5%,17m
13913,3,Packerkid,3077,178,5,7,12,41.7%,13m
13913,1,[25ZAIS]llllllllllll,3077,124,4,2,6,66.7%,39m
13913,1,Jupe,3077,150,4,4,8,50.0%,25m
13913,1,[13377]Deathdunks,3077,160,3,3,6,50.0%,10m
13913,1,Link,3077,0,1,0,1,100.0%,27m
13913,1,[Asalto]Zearinox,3077,0,1,0,1,100.0%,6m
13913,1,RyanChobo,3077,0,0,1,1,0.0%,2m
13913,1,[Weac]SOFTANDWET,3077,0,0,1,1,0.0%,42m
13913,1,DayKnight,3077,0,0,3,3,0.0%,26m
13931,3,SargeLausage,3076,581,374,371,745,50.2%,10m
13931,1,irascible,3076,1561,169,156,325,52.0%,8m
13931,3,andyman,3076,1486,121,109,230,52.6%,33m
13931,3,Cptnemo,3076,541,26,21,47,55.3%,11m
13931,1,[TGosuD]swister,3076,594,18,14,32,56.2%,32m
13931,3,Bob,3076,295,14,12,26,53.8%,20m
13931,1,Eiger,3076,202,6,2,8,75.0%,6m
13931,3,IIIIIIIIIIII,3076,30,6,4,10,60.0%,44m
13931,1,HomerovCv,3076,146,5,2,7,71.4%,8m
13931,1,bobi,3076,0,4,0,4,100.0%,2h
13931,1,Display,3076,0,4,1,5,80.0%,16m
13931,1,[notCo]Yaddle,3076,181,4,3,7,57.1%,3m
13931,1,NoFeedPLZ,3076,0,1,0,1,100.0%,29m
13931,1,Beeraxxx,3076,40,1,1,2,50.0%,39m
13931,1,Sylricc,3076,0,1,2,3,33.3%,35m
13931,1,Eigenvector,3076,0,0,1,1,0.0%,39m
13931,1,Oliverfast,3076,0,0,2,2,0.0%,24m
13948,3,[SkAL]blackmoon,3075,1480,220,229,449,49.0%,20m
13948,3,Dethan,3075,1479,70,68,138,50.7%,40m
13948,1,Janice,3075,1490,51,51,102,50.0%,16m
13948,1,Moridin,3075,658,33,6,39,84.6%,12m
13948,3,SnowSoup,3075,423,30,26,56,53.6%,45m
13948,1,[BIGPPS]Newtreeant,3075,628,29,24,53,54.7%,41m
13948,1,ZeroCool,3075,436,20,20,40,50.0%,16m
13948,1,[bEbaA]PapiSideral,3075,476,14,10,24,58.3%,6m
13948,3,loosecannon,3075,314,14,20,34,41.2%,19m
13948,3,ThriceX,3075,279,12,9,21,57.1%,41m
13948,3,JANK,3075,262,11,16,27,40.7%,21m
13948,1,Icetea,3075,266,10,7,17,58.8%,29m
13948,1,[ExceI]Dan,3075,276,8,8,16,50.0%,41m
13948,1,MacGruber,3075,230,7,5,12,58.3%,30m
13948,2,FreYja,3075,111,6,3,9,66.7%,2h
13948,3,[Lp]Oniontears,3075,30,5,4,9,55.6%,42m
13948,3,OldGeroTook,3075,44,2,1,3,66.7%,39m
13948,3,[DKGLL]Gabtaro,3075,64,2,9,11,18.2%,19m
13948,1,Narize,3075,0,1,0,1,100.0%,18m
13948,1,Splitch,3075,40,1,1,2,50.0%,44m
13948,3,prometheus,3075,30,1,8,9,11.1%,35m
13948,1,Edgex,3075,0,0,1,1,0.0%,22m
13970,3,Poseidon,3074,1487,177,188,365,48.5%,3m
13970,3,[UTS]simumu,3074,535,63,61,124,50.8%,19m
13970,3,toastking,3074,1141,48,48,96,50.0%,43m
13970,3,EGxDRAGONITE,3074,702,27,35,62,43.5%,2m
13970,1,Option,3074,654,20,20,40,50.0%,24m
13970,3,TimeBones,3074,353,12,12,24,50.0%,39m
13970,3,[Yuko]Nanamichiaki,3074,183,9,5,14,64.3%,9m
13970,1,[OpTiCx]FKNTempo,3074,229,9,9,18,50.0%,2h
13970,3,[SWORD7]Bill,3074,219,9,10,19,47.4%,18m
13970,1,HotdogFinger,3074,266,8,7,15,53.3%,23m
13970,3,BigBoss,3074,118,8,7,15,53.3%,21m
13970,1,IlIIllllIIIl,3074,152,7,4,11,63.6%,29m
13970,1,FreNuLuM,3074,114,3,3,6,50.0%,20m
13970,3,kvv,3074,30,2,3,5,40.0%,6m
13970,1,[IDDS]InNoVaTiOn,3074,44,2,4,6,33.3%,12m
13970,1,STeven,3074,86,2,5,7,28.6%,1m
13970,2,[L3]chiubaka,3074,0,1,0,1,100.0%,1h
13970,1,AtiniuM,3074,38,1,1,2,50.0%,18m
13970,3,skrtskrrrrt,3074,0,1,7,8,12.5%,41m
13970,3,[EvilGC]SkillHunter,3074,30,1,9,10,10.0%,24m
13970,1,[QMS]TheVoid,3074,0,0,1,1,0.0%,34m
13970,1,ydestroyer,3074,0,0,1,1,0.0%,6m
13970,1,ChouPaMinhX,3074,0,0,1,1,0.0%,3m
13970,1,Someyoungguy,3074,0,0,5,5,0.0%,2h
13994,1,Inception,3073,1526,109,102,211,51.7%,16m
13994,1,TechMaGiC,3073,530,95,88,183,51.9%,12m
13994,3,[BT44]Mako,3073,1214,69,65,134,51.5%,24m
13994,3,TossCraftSux,3073,1309,54,46,100,54.0%,33m
13994,3,MasterOfKarm,3073,266,48,47,95,50.5%,4m
13994,3,[StarCT]Elstubert,3073,1134,47,49,96,49.0%,28m
13994,1,[XpKb]WhiteVoid,3073,873,38,21,59,64.4%,29m
13994,1,Nelson,3073,991,36,30,66,54.5%,20m
13994,1,bread,3073,142,7,5,12,58.3%,35m
13994,3,ALTLSnine,3073,128,6,5,11,54.5%,43m
13994,1,Condor,3073,202,5,3,8,62.5%,14m
13994,1,Mezlond,3073,124,4,6,10,40.0%,10m
13994,1,[DRFS]Dysutopia,3073,88,2,4,6,33.3%,6m
13994,1,[FLW]LastFighter,3073,0,0,1,1,0.0%,20m
13994,1,Gamewiz,3073,0,0,1,1,0.0%,18m
13994,1,[HDTPM]Nightwing,3073,0,0,1,1,0.0%,25m
13994,3,Neltharion,3073,0,0,1,1,0.0%,2h
13994,1,AcidRAIN,3073,0,0,2,2,0.0%,12m
13994,1,Nik,3073,0,0,2,2,0.0%,1h
14013,3,Arcadia,3072,588,94,83,177,53.1%,5m
14013,1,august,3072,1159,92,86,178,51.7%,20m
14013,3,Starius,3072,1401,67,75,142,47.2%,26m
14013,1,[LBanda]pirinqui,3072,1350,54,41,95,56.8%,32m
14013,3,SkidRow,3072,482,16,28,44,36.4%,14m
14013,1,Mike,3072,406,13,16,29,44.8%,42m
14013,1,Augustus,3072,339,12,11,23,52.2%,9m
14013,3,OOOOOOOOOOOO,3072,121,6,0,6,100.0%,19m
14013,1,MasterMind,3072,233,6,3,9,66.7%,24m
14013,1,ElEmpalador,3072,221,6,4,10,60.0%,39m
14013,1,Kaladin,3072,145,6,8,14,42.9%,4m
14013,1,Maixz,3072,180,5,5,10,50.0%,42m
14013,1,DarkBlade,3072,182,4,2,6,66.7%,3m
14013,3,[BRSKR]Bootyslaya,3072,94,3,10,13,23.1%,17m
14013,1,[0BAMA]ObmaAteMaKFC,3072,42,2,0,2,100.0%,6m
14013,1,groinChowder,3072,0,0,1,1,0.0%,21m
14013,1,AlanEspinoza,3072,0,0,1,1,0.0%,20m
14013,1,RokkoMaerson,3072,0,0,2,2,0.0%,19m
14031,3,Zillion,3071,1630,317,291,608,52.1%,33m
14031,1,GrovePark,3071,1611,211,201,412,51.2%,25m
14031,1,DarkHunter,3071,880,103,98,201,51.2%,44m
14031,1,spaaaaaaaace,3071,1626,98,100,198,49.5%,8m
14031,3,funney,3071,1091,53,46,99,53.5%,43m
14031,1,WangChungFu,3071,790,24,27,51,47.1%,3m
14031,3,[DHZ0ne]xSpiNx,3071,369,21,40,61,34.4%,27m
14031,1,[Emb3rs]Atum,3071,408,13,7,20,65.0%,8m
14031,1,MedivhWu,3071,366,13,9,22,59.1%,23m
14031,1,[TMDK]Saifa,3071,88,4,1,5,80.0%,22m
14031,3,[iL]Timdoozy,3071,134,4,4,8,50.0%,2h
14031,1,ReeeP,3071,175,4,7,11,36.4%,4m
14031,2,[LTWAR]krazykid,3071,0,1,0,1,100.0%,1h
14031,1,hosswagon,3071,40,1,1,2,50.0%,42m
14031,1,Wake,3071,0,0,1,1,0.0%,7m
14031,1,[Bonoo]JonSnow,3071,0,0,1,1,0.0%,43m
14031,2,NoMoRe,3071,0,0,1,1,0.0%,14m
14031,1,Yuyungs,3071,0,0,3,3,0.0%,24m
14049,3,Cochis,3070,1204,71,74,145,49.0%,7m
14049,3,potato,3070,1398,50,60,110,45.5%,2m
14049,1,jqju,3070,329,14,11,25,56.0%,42m
14049,1,[LOLASO]hansiro,3070,378,12,7,19,63.2%,32m
14049,1,Maxos,3070,336,9,12,21,42.9%,31m
14049,1,Wisp,3070,186,6,4,10,60.0%,19m
14049,3,SilverFenyx,3070,62,5,7,12,41.7%,31m
14049,1,SuperHonger,3070,0,1,0,1,100.0%,8m
14049,1,[XxITxX]Joker,3070,38,1,1,2,50.0%,24m
14049,1,Overkill,3070,0,0,1,1,0.0%,29m
14049,1,miniwd,3070,0,0,2,2,0.0%,3m
14049,1,SirChristoff,3070,0,0,3,3,0.0%,8m
14061,1,BustertheDOG,3069,1737,272,253,525,51.8%,34m
14061,3,[high]zTkerub,3069,911,202,182,384,52.6%,25m
14061,1,OrganicOwl,3069,1752,140,130,270,51.9%,40m
14061,3,Rapperzz,3069,1325,132,131,263,50.2%,20m
14061,1,Bushido,3069,1704,114,93,207,55.1%,25m
14061,1,Hasnt,3069,1572,66,56,122,54.1%,22m
14061,1,SUDSYGOODz,3069,887,36,26,62,58.1%,12m
14061,1,SKYNET,3069,831,30,22,52,57.7%,39m
14061,3,[YE71]Faceless,3069,758,29,28,57,50.9%,32m
14061,1,[Peso]HoBag,3069,523,19,16,35,54.3%,10m
14061,1,[NrFms]MaD,3069,362,10,10,20,50.0%,32m
14061,3,[DrgnEg]MAHLERHAMMER,3069,207,9,9,18,50.0%,34m
14061,3,Beginner,3069,126,6,4,10,60.0%,13m
14061,1,Louis,3069,100,5,2,7,71.4%,32m
14061,2,[awa666]ElGatako,3069,138,4,1,5,80.0%,11m
14061,3,Britago,3069,0,4,2,6,66.7%,1h
14061,1,Mace,3069,36,2,0,2,100.0%,43m
14061,1,SUPREME,3069,0,2,1,3,66.7%,34m
14061,1,[ScSwrm]Aldric,3069,0,2,3,5,40.0%,2h
14061,1,DEVIL,3069,30,1,3,4,25.0%,7m
14061,3,[RLA]Shinyhero,3069,0,1,6,7,14.3%,9m
14061,3,Zappy,3069,0,0,1,1,0.0%,9m
14083,3,Refeli,3068,1577,519,512,1031,50.3%,35m
14083,3,efrain,3068,1483,130,120,250,52.0%,43m
14083,1,CuteHusky,3068,1434,97,54,151,64.2%,29m
14083,3,[MERICA]SirPsychoSxy,3068,598,71,69,140,50.7%,22m
14083,3,HighGround,3068,968,67,58,125,53.6%,26m
14083,1,KevinMarket,3068,982,61,62,123,49.6%,20m
14083,3,[CLT]BaCoNsLiCe,3068,1578,61,65,126,48.4%,1m
14083,1,Razorsedge,3068,860,55,27,82,67.1%,16m
14083,1,TheJay,3068,1432,51,45,96,53.1%,16m
14083,3,[Lament]Raven,3068,394,47,42,89,52.8%,23m
14083,1,Ponyboy,3068,1295,46,45,91,50.5%,4m
14083,1,MainIsBronze,3068,296,14,1,15,93.3%,18m
14083,1,[TheDOH]MonkyeMan,3068,164,5,6,11,45.5%,39m
14083,3,LatexhotOO,3068,121,4,3,7,57.1%,39m
14083,1,StormGoesBZZ,3068,97,3,0,3,100.0%,2h
14083,1,Legnacra,3068,96,3,7,10,30.0%,29m
14083,2,zenus,3068,0,2,4,6,33.3%,11m
14083,1,ShakaLaka,3068,40,1,1,2,50.0%,2m
14083,1,[DrgnEg]Grievous,3068,40,1,1,2,50.0%,6m
14083,1,[KSTONE]KaiZiLvBu,3068,40,1,2,3,33.3%,29m
14083,1,[DFNCÉ]JoeKony,3068,0,0,1,1,0.0%,12m
14083,1,madman,3068,0,0,2,2,0.0%,25m
14083,1,xboxsignout,3068,0,0,2,2,0.0%,4m
14083,1,[Ayhur]SuperBlazer,3068,0,0,3,3,0.0%,21m
14107,3,[Mc]Psylocibe,3067,1623,287,282,569,50.4%,45m
14107,3,[LY0]TheCareCuy,3067,1556,253,225,478,52.9%,30m
14107,1,[M0UZ]Parasite,3067,1523,63,54,117,53.8%,22m
14107,3,GeorgeSoros,3067,948,52,54,106,49.1%,10m
14107,3,Spite,3067,672,51,49,100,51.0%,15m
14107,1,Tekrebel,3067,1031,50,41,91,54.9%,39m
14107,1,sanibelle,3067,803,34,23,57,59.6%,19m
14107,1,nicco,3067,532,21,14,35,60.0%,10m
14107,1,ANORMAL,3067,583,20,17,37,54.1%,41m
14107,3,gimmeyomoney,3067,387,16,11,27,59.3%,21m
14107,1,Smllar,3067,456,15,16,31,48.4%,19m
14107,1,Chio,3067,342,13,12,25,52.0%,29m
14107,1,Fergy,3067,231,8,2,10,80.0%,29m
14107,1,[EvilGC]barcodexd,3067,230,7,5,12,58.3%,44m
14107,1,Dafei,3067,167,7,6,13,53.8%,16m
14107,1,Moleman,3067,134,5,6,11,45.5%,41m
14107,1,goatsc,3067,0,4,1,5,80.0%,29m
14107,3,SrRed,3067,0,4,2,6,66.7%,7m
14107,1,Blakin,3067,194,4,3,7,57.1%,17m
14107,3,[xDropx]DropTester,3067,97,3,1,4,75.0%,2h
14107,1,Katana,3067,114,3,3,6,50.0%,25m
14107,2,Cowgirl,3067,99,3,8,11,27.3%,5m
14107,3,Swan,3067,120,2,1,3,66.7%,42m
14107,3,ryux,3067,0,1,0,1,100.0%,20m
14107,1,Sevi,3067,0,0,1,1,0.0%,22m
14107,3,xSvDGen,3067,0,0,2,2,0.0%,18m
14107,1,hacklink,3067,0,0,2,2,0.0%,12m
14134,3,Fizzle,3066,1534,158,152,310,51.0%,32m
14134,2,DrGG,3066,1475,95,118,213,44.6%,8m
14134,1,[BlHawk]Quantum,3066,439,22,12,34,64.7%,33m
14134,1,AntM,3066,465,18,13,31,58.1%,41m
14134,3,EugeneKim,3066,122,14,24,38,36.8%,19m
14134,2,Heisenzerg,3066,219,6,8,14,42.9%,1h
14134,3,[UpxV]rodricel,3066,144,6,10,16,37.5%,10m
14134,1,Calmhands,3066,181,5,4,9,55.6%,42m
14134,1,Adinix,3066,0,3,2,5,60.0%,1h
14134,1,Driscoll,3066,120,3,4,7,42.9%,10m
14134,1,ZestHZ,3066,40,2,1,3,66.7%,18m
14134,1,[RecTom]megacom,3066,0,1,0,1,100.0%,4m
14134,1,[bOvOd]VIOLstar,3066,0,1,0,1,100.0%,6m
14134,1,[GOPERÚ]Jamj,3066,38,1,1,2,50.0%,43m
14134,1,[VagMax]Spongy,3066,0,1,2,3,33.3%,31m
14134,1,[CBA]SgtRock,3066,0,0,1,1,0.0%,40m
14134,1,raVage,3066,0,0,3,3,0.0%,3m
14151,3,PresKamala,3065,948,408,376,784,52.0%,3m
14151,3,[nieBla]ZERUEL,3065,1569,104,91,195,53.3%,10m
14151,3,[TmL]thealbus,3065,1512,78,72,150,52.0%,44m
14151,3,Scipio,3065,1361,60,70,130,46.2%,5m
14151,1,Hippery,3065,1250,58,41,99,58.6%,29m
14151,1,AHanes,3065,909,55,43,98,56.1%,32m
14151,3,idaniel,3065,1040,48,56,104,46.2%,18m
14151,1,[LHSC]SebaOfTime,3065,985,42,36,78,53.8%,8m
14151,3,[LgnTDS]fatnice,3065,716,30,28,58,51.7%,12m
14151,3,FreeHongKong,3065,693,29,24,53,54.7%,17m
14151,1,DrBratwurst,3065,452,20,7,27,74.1%,31m
14151,1,nEttik,3065,302,9,8,17,52.9%,24m
14151,1,PPPPPPP,3065,162,7,8,15,46.7%,16m
14151,3,[EZkill]Felipe,3065,164,4,3,7,57.1%,30m
14151,1,[LOPELU]dEvDaR,3065,159,3,2,5,60.0%,26m
14151,1,[THEV]Swider,3065,106,3,4,7,42.9%,18m
14151,2,Pcemaker,3065,130,3,4,7,42.9%,32m
14151,1,ElephantInk,3065,97,2,2,4,50.0%,43m
14151,1,thePRINCE,3065,134,2,2,4,50.0%,32m
14151,1,Frieddirt,3065,42,2,3,5,40.0%,2m
14151,1,ImNakedATM,3065,74,2,3,5,40.0%,30m
14151,1,Goatse,3065,0,1,0,1,100.0%,34m
14151,1,Senpi,3065,0,1,0,1,100.0%,35m
14151,1,coronavirus,3065,42,1,3,4,25.0%,34m
14151,3,[MacJu]Beginner,3065,0,1,6,7,14.3%,14m
14151,1,aLeX,3065,0,0,1,1,0.0%,12m
14151,1,Sunblast,3065,0,0,1,1,0.0%,9m
14178,3,DarthWeiner,3064,1376,106,109,215,49.3%,8m
14178,1,newplayer,3064,1608,85,56,141,60.3%,32m
14178,3,[PRTOSS]Frijoles,3064,537,22,22,44,50.0%,27m
14178,1,Cortian,3064,610,18,21,39,46.2%,30m
14178,3,nYm,3064,375,16,14,30,53.3%,5m
14178,1,NorthernCroz,3064,510,15,14,29,51.7%,39m
14178,1,snuflufugus,3064,293,9,6,15,60.0%,25m
14178,1,unleashed,3064,210,7,3,10,70.0%,41m
14178,3,RuskuL,3064,184,7,13,20,35.0%,7m
14178,1,[Amb3rs]DrpShipMagic,3064,180,5,6,11,45.5%,18m
14178,1,javascript,3064,76,3,2,5,60.0%,44m
14178,1,TroudBâl,3064,0,3,2,5,60.0%,29m
14178,1,[J4NMP4]Furius,3064,97,2,2,4,50.0%,13m
14178,1,eMaL,3064,0,1,0,1,100.0%,18m
14178,1,Pirulito,3064,0,1,0,1,100.0%,8m
14178,1,Jason,3064,0,1,1,2,50.0%,33m
14178,1,[VENSC2]WolfitO,3064,0,1,2,3,33.3%,2h
14178,1,[FyHr]RyukOmg,3064,40,1,2,3,33.3%,16m
14178,1,[KSC2]ISSProxima,3064,0,0,1,1,0.0%,29m
14178,1,[TaKGaM]taKMashido,3064,0,0,1,1,0.0%,20m
14178,1,[NSTYBZ]matus,3064,0,0,4,4,0.0%,31m
14199,3,Ihogl,3063,1570,326,316,642,50.8%,43m
14199,3,qoiliop,3063,977,194,181,375,51.7%,13m
14199,3,Sneakerhead,3063,1077,109,106,215,50.7%,34m
14199,3,PlebsFebs,3063,1298,72,58,130,55.4%,14m
14199,3,Ants,3063,928,40,35,75,53.3%,24m
14199,3,Animocity,3063,899,39,25,64,60.9%,6m
14199,3,maddasher,3063,275,39,40,79,49.4%,27m
14199,1,yderf,3063,553,18,14,32,56.2%,7m
14199,1,[TwiLit]bitgrind,3063,286,9,12,21,42.9%,7m
14199,1,[FSCN]Salvatore,3063,260,8,8,16,50.0%,31m
14199,3,Cepiyito,3063,119,7,3,10,70.0%,32m
14199,1,Locrian,3063,268,7,8,15,46.7%,14m
14199,3,BlueSilenceX,3063,182,7,11,18,38.9%,19m
14199,1,Louisvillian,3063,178,6,5,11,54.5%,29m
14199,1,General,3063,152,5,5,10,50.0%,18m
14199,1,[HypE]ElvenRogue,3063,196,5,8,13,38.5%,31m
14199,1,streeD,3063,142,5,10,15,33.3%,1h
14199,1,JiNyoGi,3063,112,2,3,5,40.0%,20m
14199,1,Hasenpflug,3063,0,1,4,5,20.0%,2m
14199,1,dreff,3063,0,0,1,1,0.0%,22m
14199,1,[Pharoh]MadeInCanada,3063,0,0,2,2,0.0%,18m
14220,1,BARCODE,3062,1481,131,106,237,55.3%,16m
14220,1,Silky,3062,1753,129,112,241,53.5%,31m
14220,1,Aligne,3062,949,82,65,147,55.8%,9m
14220,1,[GLHFAG]skhighcraft,3062,1676,63,58,121,52.1%,10m
14220,1,[Nonja]HuntedHope,3062,1157,49,36,85,57.6%,12m
14220,1,WhatIsHoodTV,3062,894,38,33,71,53.5%,39m
14220,1,BlowinWater,3062,790,37,30,67,55.2%,41m
14220,1,BrightViSion,3062,752,35,26,61,57.4%,29m
14220,3,DIOS,3062,456,26,19,45,57.8%,35m
14220,1,[Squidy]ThrillHo,3062,486,23,5,28,82.1%,32m
14220,1,AerLingus,3062,463,20,13,33,60.6%,29m
14220,1,WatermelnMan,3062,381,18,17,35,51.4%,24m
14220,1,EmperorPain,3062,530,15,18,33,45.5%,15m
14220,1,Feelsbad,3062,88,4,2,6,66.7%,3m
14220,1,Tajun,3062,129,3,0,3,100.0%,20m
14220,1,gamboneee,3062,0,3,2,5,60.0%,29m
14220,1,[TLAN]Timbits,3062,44,3,4,7,42.9%,3m
14220,3,joesba,3062,96,2,1,3,66.7%,41m
14220,1,Vaos,3062,0,1,2,3,33.3%,41m
14220,1,redmaster,3062,0,0,4,4,0.0%,6m
14240,3,[cluez]halfE,3061,1566,295,268,563,52.4%,8m
14240,3,thepolinator,3061,1490,172,155,327,52.6%,23m
14240,3,KARAX,3061,1005,70,66,136,51.5%,20m
14240,1,[hikari]lilystar,3061,440,47,27,74,63.5%,22m
14240,1,Satori,3061,660,20,18,38,52.6%,41m
14240,1,BannedSCV,3061,336,16,7,23,69.6%,13m
14240,1,shiaonan,3061,331,14,6,20,70.0%,15m
14240,1,DrDrew,3061,129,4,3,7,57.1%,13m
14240,1,[M3A5]JHL,3061,110,4,4,8,50.0%,20m
14240,1,NYK,3061,168,4,9,13,30.8%,29m
14240,1,Archonic,3061,80,2,3,5,40.0%,31m
14240,1,DennyDeniro,3061,124,2,3,5,40.0%,31m
14240,3,TypicoTerran,3061,58,2,9,11,18.2%,22m
14240,1,[GROG]Dodec,3061,0,1,0,1,100.0%,6m
14240,1,TheShy,3061,40,1,2,3,33.3%,10m
14240,1,Hassan,3061,0,1,3,4,25.0%,39m
14256,3,[SDTe]vichoCAD,3060,1548,301,285,586,51.4%,13m
14256,1,Element,3060,984,96,65,161,59.6%,8m
14256,1,Ericbiteback,3060,740,42,42,84,50.0%,39m
14256,3,UIIIIUIII,3060,598,31,30,61,50.8%,38m
14256,1,[ktkzs]HSM,3060,623,23,18,41,56.1%,27m
14256,1,[Sune]Galactus,3060,574,17,19,36,47.2%,39m
14256,1,Cyprezs,3060,249,9,9,18,50.0%,31m
14256,1,FierceBADGER,3060,0,2,3,5,40.0%,2h
14256,1,America,3060,42,2,4,6,33.3%,15m
14256,1,BoganArmy,3060,0,1,0,1,100.0%,4m
14256,1,[Lp]lllIlIlIIlIl,3060,34,1,1,2,50.0%,20m
14256,3,Jimothy,3060,0,1,9,10,10.0%,21m
14256,1,Oddjob,3060,0,0,5,5,0.0%,35m
14269,3,PantlegGreg,3059,1607,237,233,470,50.4%,3m
14269,1,[TMSyN]Hakop,3059,1001,88,72,160,55.0%,39m
14269,1,XelNiqqa,3059,808,53,32,85,62.4%,18m
14269,3,Haven,3059,402,14,25,39,35.9%,32m
14269,1,Bearclaw,3059,208,6,1,7,85.7%,42m
14269,1,xSilencedRPG,3059,186,5,5,10,50.0%,33m
14269,1,Jcommando,3059,48,4,2,6,66.7%,15m
14269,3,[Zzone]Arth,3059,144,4,8,12,33.3%,32m
14269,1,MAYEN,3059,88,2,0,2,100.0%,29m
14269,3,YoshiCity,3059,97,2,5,7,28.6%,41m
14269,1,sunshine,3059,0,1,0,1,100.0%,22m
14269,3,Min,3059,0,0,1,1,0.0%,20m
14269,1,Neurobear,3059,0,0,2,2,0.0%,10m
14282,1,Bala,3058,1729,139,134,273,50.9%,18m
14282,1,zealous,3058,885,73,52,125,58.4%,20m
14282,1,Xanthus,3058,1062,60,54,114,52.6%,6m
14282,1,Choco,3058,1270,59,44,103,57.3%,40m
14282,3,iqSixtyFive,3058,1070,49,43,92,53.3%,27m
14282,1,Tehque,3058,544,22,15,37,59.5%,20m
14282,1,[HDL]Raklann,3058,395,17,8,25,68.0%,41m
14282,3,JUICE,3058,454,17,21,38,44.7%,33m
14282,1,[Over1]joel,3058,448,15,11,26,57.7%,39m
14282,2,MrPaul,3058,297,13,11,24,54.2%,11m
14282,1,Caseysgay,3058,239,12,7,19,63.2%,1m
14282,3,[TGosuB]XLBeastmode,3058,312,11,13,24,45.8%,41m
14282,3,LoveYou,3058,269,9,4,13,69.2%,9m
14282,1,[UpeV]LuisSanHer,3058,294,9,10,19,47.4%,13m
14282,3,Cast,3058,217,6,14,20,30.0%,20m
14282,1,PariahJun,3058,78,5,4,9,55.6%,42m
14282,1,Poleman,3058,155,4,1,5,80.0%,40m
14282,1,[Cliaos]Bestian,3058,114,4,3,7,57.1%,31m
14282,3,Sunevztlow,3058,0,2,4,6,33.3%,14m
14282,3,Acradem,3058,0,1,0,1,100.0%,12m
14282,1,ADRIANO,3058,40,1,1,2,50.0%,6m
14282,1,maikestokes,3058,0,0,1,1,0.0%,35m
14304,3,[G79]Lagunitas,3057,1470,196,193,389,50.4%,41m
14304,3,Castrator,3057,1491,122,130,252,48.4%,14m
14304,1,[Cheees]sweetsalad,3057,1091,54,26,80,67.5%,42m
14304,3,Peatree,3057,811,40,38,78,51.3%,21m
14304,1,[HAWD]hulksmash,3057,740,30,22,52,57.7%,39m
14304,1,Legion,3057,906,29,30,59,49.2%,33m
14304,3,KyZer,3057,533,25,19,44,56.8%,13m
14304,1,[BucBim]Qwerty,3057,521,19,14,33,57.6%,13m
14304,1,GrandAutismo,3057,392,18,16,34,52.9%,22m
14304,3,NOISYBOY,3057,500,17,18,35,48.6%,17m
14304,3,[GRNSKN]LenweTurtle,3057,224,13,19,32,40.6%,1m
14304,1,LTSmash,3057,438,12,15,27,44.4%,2m
14304,1,[HØST]hugobw,3057,444,12,17,29,41.4%,7m
14304,3,Hydrus,3057,311,11,11,22,50.0%,40m
14304,1,Sarandia,3057,252,9,9,18,50.0%,24m
14304,1,fofafi,3057,94,7,5,12,58.3%,2h
14304,3,[1DEAD1]Haiduk,3057,0,3,2,5,60.0%,2h
14304,1,Oreki,3057,0,3,2,5,60.0%,4m
14304,1,Nice,3057,0,3,2,5,60.0%,33m
14304,3,FuNdaMentaL,3057,90,3,10,13,23.1%,22m
14304,1,[B4M]ghost,3057,40,2,1,3,66.7%,20m
14304,1,[N0TD]Extinction,3057,0,1,0,1,100.0%,3m
14304,1,Phsyco,3057,0,0,1,1,0.0%,18m
14327,1,Ebenn,3056,1745,277,245,522,53.1%,39m
14327,3,Cherryboba,3056,902,88,78,166,53.0%,44m
14327,1,Nigeeeeeeeer,3056,821,45,24,69,65.2%,7m
14327,3,TheFleet,3056,720,28,23,51,54.9%,2m
14327,1,Nerdking,3056,475,21,8,29,72.4%,10m
14327,1,StreetFIend,3056,500,16,13,29,55.2%,32m
14327,1,Bjornbrandr,3056,250,9,7,16,56.2%,16m
14327,1,[phew]mobius,3056,316,9,11,20,45.0%,41m
14327,1,[ANlME]Chase,3056,151,4,1,5,80.0%,32m
14327,1,SilverLegion,3056,88,4,2,6,66.7%,6m
14327,3,Lucki,3056,97,3,4,7,42.9%,12m
14327,3,[TILL]LiQuiDPaPeR,3056,153,3,7,10,30.0%,9m
14327,1,[xGPLx]IndigoStorm,3056,78,2,2,4,50.0%,8m
14327,3,VeN,3056,0,1,3,4,25.0%,1h
14327,1,Projectt,3056,0,0,1,1,0.0%,4m
14327,1,Intangible,3056,0,0,1,1,0.0%,10m
14343,3,Maxaroni,3055,1574,627,625,1252,50.1%,13m
14343,3,Triton,3055,1428,251,235,486,51.6%,14m
14343,3,Jimbean,3055,1449,88,84,172,51.2%,20m
14343,3,Sky,3055,1337,88,93,181,48.6%,29m
14343,1,GeneralWisco,3055,1732,73,65,138,52.9%,18m
14343,1,[IiUiI]demon,3055,1240,50,42,92,54.3%,16m
14343,1,JosephCT,3055,517,25,9,34,73.5%,27m
14343,1,Odin,3055,741,25,23,48,52.1%,4m
14343,1,radar,3055,494,19,13,32,59.4%,14m
14343,1,flowers,3055,297,15,10,25,60.0%,29m
14343,1,MSTY,3055,240,10,3,13,76.9%,41m
14343,1,noilion,3055,290,9,9,18,50.0%,16m
14343,1,cosmoton,3055,48,4,2,6,66.7%,4m
14343,3,OcarinOfTime,3055,0,4,2,6,66.7%,42m
14343,1,King,3055,80,2,2,4,50.0%,10m
14343,1,Ophidias,3055,36,2,2,4,50.0%,19m
14343,1,Mörder,3055,0,1,0,1,100.0%,42m
14343,1,Ralicious,3055,36,1,1,2,50.0%,10m
14343,1,DJDespawn,3055,42,1,2,3,33.3%,6m
14343,1,MercMadness,3055,93,1,2,3,33.3%,11m
14343,1,SCalbin,3055,30,1,4,5,20.0%,9m
14343,1,SouP,3055,0,0,1,1,0.0%,2m
14343,1,Rock,3055,0,0,3,3,0.0%,31m
14366,1,[TGosuA]belly,3054,1733,128,117,245,52.2%,31m
14366,3,FatherZeus,3054,837,92,92,184,50.0%,20m
14366,1,Dero,3054,1476,90,82,172,52.3%,14m
14366,3,tpk,3054,1555,74,72,146,50.7%,22m
14366,3,Pook,3054,1519,72,75,147,49.0%,17m
14366,1,[MDwarz]Ryanwarrior,3054,1374,52,46,98,53.1%,15m
14366,1,RebelChara,3054,873,46,13,59,78.0%,25m
14366,1,kche,3054,483,21,20,41,51.2%,32m
14366,1,FoxMacher,3054,498,20,12,32,62.5%,4m
14366,1,Kinpatsu,3054,593,19,15,34,55.9%,4m
14366,1,[PooNys]Chuncocoo,3054,490,15,12,27,55.6%,20m
14366,1,lIlllIIIll,3054,280,12,5,17,70.6%,26m
14366,3,Valanoir,3054,177,9,5,14,64.3%,3m
14366,1,Squash,3054,271,8,6,14,57.1%,33m
14366,1,koros,3054,48,3,3,6,50.0%,2h
14366,1,Rat,3054,42,2,1,3,66.7%,41m
14366,1,hanko,3054,78,2,4,6,33.3%,31m
14366,1,[EoMX]Felpas,3054,0,1,1,2,50.0%,13m
14366,1,Galoonga,3054,40,1,2,3,33.3%,20m
14366,1,[MLC]killswitch,3054,36,1,4,5,20.0%,39m
14366,1,[H0T3R]BlizzGeek,3054,40,1,4,5,20.0%,35m
14366,1,Dee,3054,0,0,5,5,0.0%,41m
14388,1,cavercito,3053,1750,350,338,688,50.9%,10m
14388,1,[LQV]OldFossil,3053,1617,118,106,224,52.7%,33m
14388,1,Anaxifrish,3053,1616,76,66,142,53.5%,22m
14388,3,[Airpod]hypertanker,3053,358,75,66,141,53.2%,11m
14388,1,undeadfotr,3053,516,20,17,37,54.1%,40m
14388,1,Merthos,3053,347,16,5,21,76.2%,39m
14388,1,ZroXD,3053,349,13,6,19,68.4%,25m
14388,1,[FOOB]HICCUP,3053,284,9,6,15,60.0%,16m
14388,1,Sher,3053,160,7,4,11,63.6%,42m
14388,3,TMGOtis,3053,58,6,4,10,60.0%,43m
14388,1,[Petsen]Shaky,3053,123,5,3,8,62.5%,29m
14388,1,PunisherJ,3053,96,5,4,9,55.6%,2h
14388,1,Abraxas,3053,110,4,2,6,66.7%,11m
14388,1,Yarooski,3053,42,4,3,7,57.1%,2m
14388,3,PettingYoda,3053,92,4,9,13,30.8%,34m
14388,1,[GoG]StarLord,3053,78,3,3,6,50.0%,4m
14388,1,[TGosuA]BadHairDayX,3053,40,2,0,2,100.0%,33m
14388,1,[eyedea]abilities,3053,44,2,2,4,50.0%,20m
14388,3,ChaosEmperor,3053,94,2,6,8,25.0%,32m
14388,1,Nivek,3053,0,1,0,1,100.0%,2h
14388,1,[WOOP]Whipples,3053,0,0,1,1,0.0%,30m
14388,1,OGDerJager,3053,0,0,1,1,0.0%,16m
14388,1,SuhDude,3053,0,0,1,1,0.0%,41m
14388,1,Corsair,3053,0,0,3,3,0.0%,32m
14412,3,MechnCheese,3052,1628,281,281,562,50.0%,11m
14412,3,AIUR,3052,1534,241,232,473,51.0%,40m
14412,3,Pulpoel,3052,1486,177,182,359,49.3%,19m
14412,3,garyfiis,3052,1060,106,106,212,50.0%,24m
14412,3,SandBox,3052,1464,97,97,194,50.0%,31m
14412,3,JamesBreznev,3052,1587,56,66,122,45.9%,22m
14412,3,Thormush,3052,1486,55,57,112,49.1%,22m
14412,3,Who,3052,1056,51,49,100,51.0%,31m
14412,3,swtch,3052,1171,50,39,89,56.2%,21m
14412,1,eastcommon,3052,1044,44,34,78,56.4%,17m
14412,3,RTST,3052,1032,36,43,79,45.6%,7m
14412,1,[Canela]ToribioGamer,3052,1020,35,31,66,53.0%,39m
14412,1,SpetsnazHero,3052,566,27,20,47,57.4%,21m
14412,1,SpinW,3052,638,25,22,47,53.2%,43m
14412,1,[EODL]PlaidPancake,3052,470,19,18,37,51.4%,16m
14412,1,RavenousOne,3052,245,16,11,27,59.3%,31m
14412,1,KEDI,3052,351,14,7,21,66.7%,9m
14412,3,[nieBla]BERNAMTY,3052,399,13,17,30,43.3%,27m
14412,1,[TGosuC]Flux,3052,302,9,6,15,60.0%,29m
14412,1,jed,3052,254,9,12,21,42.9%,19m
14412,1,NDKyouknow,3052,154,6,3,9,66.7%,29m
14412,3,box,3052,155,6,5,11,54.5%,19m
14412,1,Seb,3052,180,5,6,11,45.5%,4m
14412,1,[DKY]Shocker,3052,0,4,1,5,80.0%,15m
14412,1,giesecke,3052,0,4,1,5,80.0%,10m
14412,1,HybridXZ,3052,138,4,5,9,44.4%,39m
14412,1,Alextf,3052,0,3,1,4,75.0%,4m
14412,1,sointoyou,3052,48,3,3,6,50.0%,2h
14412,1,defeponatltq,3052,82,3,3,6,50.0%,18m
14412,1,[M1XX]Hannable,3052,116,3,4,7,42.9%,13m
14412,1,[CLAM]FwAnK,3052,44,2,3,5,40.0%,32m
14412,1,PlumpAvo,3052,0,2,4,6,33.3%,24m
14412,1,Dobban,3052,0,1,0,1,100.0%,42m
14412,1,Britney,3052,0,1,0,1,100.0%,30m
14412,1,[fl0wer]DDream,3052,0,1,0,1,100.0%,18m
14412,1,KalVentis,3052,42,1,2,3,33.3%,39m
14412,1,[LØGIA]KSangel,3052,0,0,1,1,0.0%,33m
14412,1,[Macac0]Nirvanero,3052,0,0,1,1,0.0%,14m
14450,3,rpmdevcl,3051,1410,121,111,232,52.2%,39m
14450,3,Haste,3051,1430,90,93,183,49.2%,44m
14450,3,lllIIIllllII,3051,994,71,72,143,49.7%,3m
14450,3,WildCrane,3051,1585,63,66,129,48.8%,5m
14450,3,AVF,3051,836,50,48,98,51.0%,28m
14450,1,Helix,3051,700,48,44,92,52.2%,13m
14450,1,dyto,3051,876,43,37,80,53.8%,20m
14450,1,[NWOver]HellsWinter,3051,828,29,25,54,53.7%,8m
14450,1,Posted,3051,787,26,24,50,52.0%,6m
14450,1,[NXLsc]Diaval,3051,745,24,21,45,53.3%,42m
14450,3,Rayn,3051,521,24,25,49,49.0%,4m
14450,1,MTRLRX,3051,582,21,13,34,61.8%,31m
14450,1,Lenin,3051,257,7,5,12,58.3%,39m
14450,1,How,3051,236,7,10,17,41.2%,26m
14450,1,Balerionn,3051,212,6,9,15,40.0%,16m
14450,3,[URNOOB]DrEasyEzNoob,3051,128,5,15,20,25.0%,21m
14450,1,[HENT4l]GoingPostal,3051,119,4,0,4,100.0%,15m
14450,1,Chammam,3051,158,4,7,11,36.4%,12m
14450,1,Balanar,3051,104,3,0,3,100.0%,4m
14450,1,Souup,3051,140,3,2,5,60.0%,29m
14450,1,xJugGernautx,3051,0,1,0,1,100.0%,20m
14450,1,Sol,3051,0,0,1,1,0.0%,41m
14450,1,destructor,3051,0,0,1,1,0.0%,22m
14450,1,INeedFood,3051,0,0,1,1,0.0%,32m
14450,1,Yoxinator,3051,0,0,4,4,0.0%,41m
14450,1,[Fever]Decay,3051,0,0,9,9,0.0%,2h
14476,1,[PRONUB]SeeRaft,3050,830,68,59,127,53.5%,34m
14476,1,SgtSchultz,3050,1154,59,54,113,52.2%,35m
14476,1,[THDT]WaRMahO,3050,1229,50,39,89,56.2%,13m
14476,3,LeopoldSkank,3050,661,35,34,69,50.7%,42m
14476,2,[CiRcL3]cslacker,3050,590,34,40,74,45.9%,34m
14476,3,Bob,3050,742,31,28,59,52.5%,5m
14476,1,Tathaemet,3050,647,30,17,47,63.8%,25m
14476,1,TaskForce,3050,841,26,29,55,47.3%,24m
14476,1,[Broxit]SeansFriend,3050,485,17,12,29,58.6%,6m
14476,1,Axiom,3050,215,10,6,16,62.5%,22m
14476,1,[FVCES]lolmattlol,3050,146,6,5,11,54.5%,27m
14476,1,MikeRoxx,3050,0,1,0,1,100.0%,4m
14476,1,Probetoss,3050,0,1,2,3,33.3%,22m
14476,1,MrMcDirtNsty,3050,0,0,4,4,0.0%,27m
14490,3,Demolisher,3049,1542,196,193,389,50.4%,44m
14490,3,lllllbarcOde,3049,1617,195,187,382,51.0%,31m
14490,3,EARFQUAKE,3049,788,117,92,209,56.0%,43m
14490,3,[Talio]starpig,3049,1573,80,86,166,48.2%,6m
14490,3,Casorus,3049,935,72,75,147,49.0%,11m
14490,1,DronGamer,3049,1398,66,34,100,66.0%,18m
14490,3,[REPORT]Fearless,3049,634,26,24,50,52.0%,27m
14490,3,Milan,3049,628,25,25,50,50.0%,39m
14490,1,Britney,3049,414,17,8,25,68.0%,9m
14490,3,Kipo,3049,310,11,18,29,37.9%,7m
14490,1,matyatya,3049,250,9,7,16,56.2%,2h
14490,1,[SsaYnS]Khaine,3049,338,9,12,21,42.9%,41m
14490,1,Janke,3049,168,8,4,12,66.7%,33m
14490,1,[R4NK3D]Mau,3049,266,8,8,16,50.0%,42m
14490,1,[420Maf]Moon,3049,101,7,5,12,58.3%,10m
14490,1,[IFNT]SammeH,3049,196,5,2,7,71.4%,4m
14490,1,[CCCT]RadarPrince,3049,120,4,4,8,50.0%,4m
14490,1,Dread,3049,156,4,10,14,28.6%,29m
14490,1,Aiomon,3049,105,3,0,3,100.0%,29m
14490,1,JJONG,3049,0,3,2,5,60.0%,6m
14490,1,[FyHr]YanFranco,3049,120,3,2,5,60.0%,6m
14490,1,[Pig2]NukeTheBunny,3049,77,2,5,7,28.6%,31m
14490,1,Exsedol,3049,0,1,1,2,50.0%,39m
14490,1,batatose,3049,0,0,2,2,0.0%,42m
14514,3,Alternity,3048,1363,333,299,632,52.7%,23m
14514,1,Matiro,3048,1578,256,233,489,52.4%,18m
14514,1,jnhockey,3048,1606,244,236,480,50.8%,42m
14514,3,GrandCaravan,3048,1150,186,175,361,51.5%,26m
14514,3,thewitherest,3048,1488,140,133,273,51.3%,32m
14514,1,[Fr0nt]Midnitegyro,3048,1443,86,76,162,53.1%,30m
14514,3,llFreedoMll,3048,131,29,30,59,49.2%,13m
14514,1,Andelaisi,3048,532,24,25,49,49.0%,19m
14514,3,PokemonBlue,3048,400,18,15,33,54.5%,16m
14514,1,[SsaYnS]Anubis,3048,456,16,11,27,59.3%,25m
14514,1,ZvedaSevera,3048,40,4,3,7,57.1%,29m
14514,1,[FYous]GotTakeADump,3048,0,2,3,5,40.0%,10m
14514,1,ExtraLarge,3048,76,2,4,6,33.3%,31m
14514,1,[D3A]Kaelen,3048,0,1,0,1,100.0%,32m
14514,1,[woot]Dshark,3048,91,1,1,2,50.0%,30m
14514,1,Manabu,3048,0,0,1,1,0.0%,25m
14514,1,SiNtEcLaDo,3048,0,0,1,1,0.0%,22m
14514,1,[Enig]Tyjay,3048,0,0,4,4,0.0%,33m
14532,3,AlphaLynx,3047,1520,221,213,434,50.9%,22m
14532,1,Porterble,3047,1172,104,79,183,56.8%,42m
14532,1,ClassIc,3047,1204,79,54,133,59.4%,6m
14532,3,[SoSt]BalamQuantum,3047,1035,72,84,156,46.2%,14m
14532,3,[HØST]Salgarello,3047,658,32,27,59,54.2%,27m
14532,1,CharlC,3047,502,28,32,60,46.7%,13m
14532,1,tommy,3047,464,14,16,30,46.7%,20m
14532,3,SharpEdge,3047,196,12,6,18,66.7%,24m
14532,1,[FFAA]Nappa,3047,193,8,2,10,80.0%,45m
14532,1,[NPhasA]Chow,3047,154,6,3,9,66.7%,24m
14532,3,[D4DDY5]Rhapsody,3047,155,5,3,8,62.5%,2h
14532,1,Blackheart,3047,202,5,4,9,55.6%,17m
14532,3,Soapysoap,3047,0,1,0,1,100.0%,6m
14532,1,Wempy,3047,0,0,5,5,0.0%,43m
14546,1,[Bee]AgentX,3046,1727,149,139,288,51.7%,4m
14546,1,[LOHs]popin,3046,296,53,41,94,56.4%,18m
14546,1,[TPGGXD]DARONSUE,3046,737,31,21,52,59.6%,30m
14546,3,ace,3046,655,22,25,47,46.8%,25m
14546,1,[tGosu]Zenden,3046,694,22,28,50,44.0%,34m
14546,1,ELBERGALARGA,3046,397,20,10,30,66.7%,22m
14546,1,baduserna,3046,349,17,8,25,68.0%,4m
14546,3,[Intpro]Emanuelgame,3046,314,15,14,29,51.7%,28m
14546,1,Murphyslaw,3046,179,7,5,12,58.3%,29m
14546,1,chuy,3046,280,7,6,13,53.8%,3m
14546,3,chesaman,3046,187,5,4,9,55.6%,33m
14546,3,America,3046,60,2,10,12,16.7%,9m
14546,1,Hardcase,3046,30,1,3,4,25.0%,17m
14546,1,Feddas,3046,0,0,1,1,0.0%,2h
14546,1,[lDEATH]PenaBranca,3046,0,0,1,1,0.0%,12m
14561,3,comet,3045,1081,269,243,512,52.5%,5m
14561,3,Molganes,3045,1281,67,53,120,55.8%,32m
14561,1,eric,3045,1230,52,46,98,53.1%,42m
14561,3,Blacksheep,3045,1111,44,46,90,48.9%,28m
14561,3,MisterFork,3045,417,42,41,83,50.6%,7m
14561,1,Lumon,3045,731,40,23,63,63.5%,11m
14561,1,[ICMSc2]Leriox,3045,606,35,30,65,53.8%,29m
14561,1,[STAN]atomicBEAR,3045,758,34,23,57,59.6%,42m
14561,1,mirageC,3045,727,28,22,50,56.0%,31m
14561,1,meteor,3045,522,21,16,37,56.8%,34m
14561,3,scottimus,3045,404,18,13,31,58.1%,42m
14561,1,Nightshade,3045,430,17,11,28,60.7%,18m
14561,1,Nerdsie,3045,362,9,9,18,50.0%,7m
14561,1,Toafer,3045,184,6,5,11,54.5%,33m
14561,1,CodadMasters,3045,194,6,8,14,42.9%,15m
14561,1,[xCRUSH]Trazz,3045,30,3,2,5,60.0%,30m
14561,1,Khallarion,3045,0,1,0,1,100.0%,20m
14561,1,Shrimpfork,3045,38,1,4,5,20.0%,31m
14561,1,[MooSha]regulator,3045,0,0,1,1,0.0%,3m
14561,1,DeX,3045,0,0,2,2,0.0%,7m
14561,1,buckviker,3045,0,0,3,3,0.0%,33m
14582,3,[TMSTP]Acidknight,3044,1430,65,68,133,48.9%,3m
14582,3,[VFam]Louvrissa,3044,687,53,64,117,45.3%,23m
14582,1,althewarrior,3044,1115,48,28,76,63.2%,30m
14582,1,HuskenCG,3044,401,38,33,71,53.5%,41m
14582,3,[αXLa]Fox,3044,812,35,33,68,51.5%,16m
14582,1,tacozaregood,3044,495,35,34,69,50.7%,31m
14582,3,Glephnir,3044,753,32,26,58,55.2%,18m
14582,3,SCAChoi,3044,278,8,21,29,27.6%,8m
14582,1,TargetMe,3044,179,7,2,9,77.8%,25m
14582,1,Balvinn,3044,213,7,9,16,43.8%,18m
14582,1,FireMage,3044,208,6,8,14,42.9%,24m
14582,3,[RBP3]KOVALSKI,3044,30,5,3,8,62.5%,31m
14582,3,DrRotinaj,3044,94,4,11,15,26.7%,4m
14582,2,Gray,3044,139,3,2,5,60.0%,15m
14582,3,koolaid,3044,62,3,5,8,37.5%,23m
14582,1,Bobby,3044,89,2,0,2,100.0%,33m
14582,1,Sazor,3044,38,2,1,3,66.7%,18m
14582,1,BigRona,3044,106,2,2,4,50.0%,41m
14582,1,firsttimesc,3044,118,2,2,4,50.0%,31m
14582,3,whiteknight,3044,94,2,6,8,25.0%,22m
14582,1,Alex,3044,0,1,0,1,100.0%,4m
14582,1,[SKyber]sirfelipe,3044,42,1,3,4,25.0%,31m
14582,1,TheKing,3044,0,0,1,1,0.0%,22m
14582,2,ANnihilatioN,3044,0,0,2,2,0.0%,1h
14606,1,Obzedat,3043,1601,95,81,176,54.0%,30m
14606,1,[12YD]Skrumpf,3043,1168,74,54,128,57.8%,12m
14606,1,Stelina,3043,859,48,30,78,61.5%,43m
14606,1,Andrew,3043,813,39,26,65,60.0%,4m
14606,1,Raka,3043,703,37,32,69,53.6%,18m
14606,1,chunchunmaru,3043,864,30,30,60,50.0%,20m
14606,1,RDHAYATE,3043,690,29,26,55,52.7%,26m
14606,1,[C08]Moose,3043,634,27,14,41,65.9%,42m
14606,3,Mark,3043,516,22,24,46,47.8%,12m
14606,3,[ÐxStar]JORGEX,3043,652,22,31,53,41.5%,27m
14606,3,Taylor,3043,608,21,30,51,41.2%,43m
14606,3,Wildwolf,3043,384,20,28,48,41.7%,24m
14606,1,GrumpyNoob,3043,233,13,8,21,61.9%,33m
14606,1,Tasteless,3043,264,11,7,18,61.1%,40m
14606,3,[TnKn]Dolodiar,3043,338,11,19,30,36.7%,22m
14606,1,[2xXxX]BARTOLOLEO,3043,266,8,10,18,44.4%,24m
14606,1,[HEPCC]BrockLee,3043,310,8,12,20,40.0%,24m
14606,1,oldmanthinke,3043,70,6,3,9,66.7%,17m
14606,1,Battlemaster,3043,144,5,5,10,50.0%,31m
14606,3,TylerDurden,3043,144,5,8,13,38.5%,31m
14606,3,Bud,3043,121,4,1,5,80.0%,12m
14606,1,Darknos,3043,139,4,3,7,57.1%,44m
14606,2,Saibogu,3043,95,4,5,9,44.4%,13m
14606,1,Luke,3043,119,3,1,4,75.0%,18m
14606,3,Bulls,3043,56,3,10,13,23.1%,17m
14606,1,bLiNd,3043,103,2,2,4,50.0%,23m
14606,1,GunSmoke,3043,38,2,2,4,50.0%,6m
14606,1,XenoN,3043,62,2,3,5,40.0%,42m
14606,1,Robertronix,3043,0,1,0,1,100.0%,33m
14606,1,[gaPe]Siv,3043,0,1,1,2,50.0%,26m
14606,1,Lycosa,3043,0,1,4,5,20.0%,17m
14606,1,[PYSCH0]Resteral,3043,0,0,2,2,0.0%,31m
14638,1,[tCo9]silvtown,3042,1497,221,200,421,52.5%,42m
14638,1,SeriousGoose,3042,1651,106,87,193,54.9%,30m
14638,3,CastroIsCool,3042,1346,101,110,211,47.9%,8m
14638,3,annaKIN,3042,1523,62,70,132,47.0%,11m
14638,3,msowrex,3042,606,41,39,80,51.2%,14m
14638,1,MolarBear,3042,534,16,14,30,53.3%,3m
14638,1,PIMBA,3042,295,14,9,23,60.9%,17m
14638,1,[GreeDy]JteCreme,3042,306,12,9,21,57.1%,9m
14638,3,Mertaugh,3042,318,11,6,17,64.7%,28m
14638,1,Psi,3042,179,10,5,15,66.7%,31m
14638,1,StorM,3042,315,10,15,25,40.0%,41m
14638,1,[Squidy]RavinBailiff,3042,185,7,2,9,77.8%,41m
14638,1,GhosT,3042,0,5,0,5,100.0%,31m
14638,1,[DiaOrg]Stormer,3042,133,4,1,5,80.0%,30m
14638,1,speedyss,3042,162,4,4,8,50.0%,2h
14638,1,pier,3042,142,4,4,8,50.0%,10m
14638,3,Kapai,3042,174,4,7,11,36.4%,20m
14638,3,Ares,3042,97,3,3,6,50.0%,35m
14638,1,Creepus,3042,116,3,6,9,33.3%,16m
14638,1,[JSLs]SunQuan,3042,114,3,8,11,27.3%,13m
14638,3,Emily,3042,121,2,1,3,66.7%,41m
14638,3,LeoDC,3042,42,1,8,9,11.1%,1h
14660,1,EightBaller,3041,1610,294,272,566,51.9%,17m
14660,1,billyb,3041,1675,107,92,199,53.8%,4m
14660,1,[SORSC]CooLpeepito,3041,1163,97,78,175,55.4%,42m
14660,3,Tailon,3041,1553,74,78,152,48.7%,14m
14660,3,BleuElephant,3041,1591,72,78,150,48.0%,19m
14660,1,lennytheboi,3041,731,34,20,54,63.0%,39m
14660,1,HotMercy,3041,737,33,21,54,61.1%,19m
14660,1,[pXo]BLADE,3041,465,28,19,47,59.6%,6m
14660,3,chloesaurus,3041,57,24,26,50,48.0%,35m
14660,1,waves,3041,393,17,11,28,60.7%,4m
14660,1,MrMcnuggets,3041,387,11,8,19,57.9%,2m
14660,1,Heisy,3041,226,10,5,15,66.7%,31m
14660,1,Raaaawr,3041,328,9,8,17,52.9%,31m
14660,1,[EBAGmn]BabyKangaroo,3041,194,8,6,14,57.1%,39m
14660,1,maras,3041,228,6,8,14,42.9%,18m
14660,1,dyme,3041,88,4,2,6,66.7%,41m
14660,3,ioiio,3041,125,3,5,8,37.5%,33m
14660,1,Yxela,3041,89,2,0,2,100.0%,10m
14660,1,[SKO303]MastaBlasta,3041,90,2,4,6,33.3%,18m
14660,1,Loki,3041,40,2,4,6,33.3%,33m
14660,1,ErickX,3041,0,1,0,1,100.0%,26m
14660,1,Conrad,3041,32,1,2,3,33.3%,16m
14660,1,skim,3041,0,1,3,4,25.0%,10m
14660,1,[KingSC]Zero,3041,0,0,1,1,0.0%,14m
14660,1,[WOTDL]zergio,3041,0,0,1,1,0.0%,34m
14660,1,Jose,3041,0,0,1,1,0.0%,24m
14686,1,[nieBla]AgReSoR,3040,1735,275,246,521,52.8%,17m
14686,1,Nodoyuna,3040,1304,193,165,358,53.9%,30m
14686,1,[VRGA]RamonShatter,3040,1737,176,164,340,51.8%,11m
14686,3,oges,3040,1016,157,129,286,54.9%,10m
14686,3,Riley,3040,1153,50,52,102,49.0%,13m
14686,1,[KingSC]triki,3040,1100,41,36,77,53.2%,4m
14686,1,Jayden,3040,807,37,22,59,62.7%,41m
14686,1,nano,3040,436,25,11,36,69.4%,11m
14686,1,Freaking,3040,550,22,21,43,51.2%,25m
14686,3,[LGNxx]Asher,3040,513,18,22,40,45.0%,45m
14686,3,Monolite,3040,353,15,8,23,65.2%,30m
14686,1,[GlRTH]SpeaKyy,3040,312,9,9,18,50.0%,7m
14686,1,SuicideMemes,3040,234,6,4,10,60.0%,32m
14686,3,StaMic,3040,30,5,3,8,62.5%,9m
14686,1,JeanFer,3040,129,3,3,6,50.0%,35m
14686,1,[Ch3ck]CrossPhire,3040,158,3,3,6,50.0%,39m
14686,1,APOLO,3040,112,3,4,7,42.9%,29m
14686,1,[DETER]Willy,3040,74,2,3,5,40.0%,25m
14686,3,[l3l3l]SpaceSteak,3040,68,2,8,10,20.0%,8m
14686,1,[GaMTaK]TaKMashido,3040,0,1,2,3,33.3%,7m
14686,1,Vaseline,3040,38,1,4,5,20.0%,10m
14686,1,[KiMBR]JBCARMO,3040,0,1,4,5,20.0%,2h
14686,1,SilentSword,3040,0,0,1,1,0.0%,25m
14686,1,Olmeca,3040,0,0,3,3,0.0%,2h
14710,1,Ryan,3039,1011,62,45,107,57.9%,9m
14710,1,chronic,3039,953,47,26,73,64.4%,41m
14710,1,cosecant,3039,885,30,27,57,52.6%,39m
14710,3,jakelee,3039,703,29,28,57,50.9%,21m
14710,1,Killix,3039,270,12,5,17,70.6%,35m
14710,1,ARealBoi,3039,228,8,3,11,72.7%,12m
14710,1,Idisappoint,3039,193,8,5,13,61.5%,39m
14710,1,GDLK,3039,166,7,5,12,58.3%,17m
14710,3,Alcarav,3039,161,7,6,13,53.8%,32m
14710,1,[Cullen]israeldelafe,3039,230,7,7,14,50.0%,9m
14710,1,[TURD5]RoiSqueebs,3039,133,5,0,5,100.0%,33m
14710,1,[N9]StrixteR,3039,48,4,2,6,66.7%,1h
14710,1,Muaddib,3039,107,3,0,3,100.0%,34m
14710,1,Rurtur,3039,34,2,1,3,66.7%,4m
14710,1,nfgrawker,3039,32,2,1,3,66.7%,41m
14710,3,Hercules,3039,93,2,6,8,25.0%,29m
14710,3,Isabella,3039,121,2,8,10,20.0%,18m
14710,1,STARFLTCDRJR,3039,40,1,3,4,25.0%,13m
14710,3,[R2F]Dazalot,3039,0,0,2,2,0.0%,41m
14729,1,xRed,3038,1498,222,216,438,50.7%,29m
14729,3,[INCW]MORONI,3038,1640,184,188,372,49.5%,26m
14729,1,Monsoon,3038,1572,132,107,239,55.2%,4m
14729,3,[LoTD]Afora,3038,1488,116,117,233,49.8%,22m
14729,1,Doxylamine,3038,1258,95,77,172,55.2%,6m
14729,1,DeadCell,3038,962,43,27,70,61.4%,18m
14729,1,[ExcIgN]Gerxo,3038,258,36,24,60,60.0%,16m
14729,1,Che,3038,1034,35,31,66,53.0%,43m
14729,1,jaiprime,3038,675,30,18,48,62.5%,32m
14729,1,[RCA]Monti,3038,529,21,17,38,55.3%,26m
14729,3,[Ex0n]iveseenbiggr,3038,502,18,25,43,41.9%,13m
14729,1,herOS,3038,522,16,16,32,50.0%,41m
14729,1,Qreamy,3038,373,15,11,26,57.7%,4m
14729,3,TheKingMelon,3038,416,14,25,39,35.9%,42m
14729,3,ZakathBC,3038,209,11,8,19,57.9%,8m
14729,3,mago,3038,243,11,9,20,55.0%,18m
14729,1,[GGMESP]roge,3038,167,5,2,7,71.4%,33m
14729,1,[CNDCT]Drake,3038,97,4,2,6,66.7%,1h
14729,1,[hz21]hectorcito,3038,88,4,2,6,66.7%,2m
14729,1,[GRNSKN]SlubberBub,3038,105,3,0,3,100.0%,41m
14729,1,[SsaYnS]Jdban,3038,122,3,5,8,37.5%,41m
14729,1,[HØST]Gyako,3038,0,1,0,1,100.0%,31m
14729,1,VIP,3038,0,1,1,2,50.0%,4m
14729,1,Uni,3038,0,1,1,2,50.0%,26m
14729,1,GrumpyKitten,3038,38,1,3,4,25.0%,25m
14729,3,Striker,3038,0,0,7,7,0.0%,9m
14755,3,workwork,3037,1575,577,540,1117,51.7%,2m
14755,1,ChoachOhhh,3037,1580,210,176,386,54.4%,33m
14755,1,Sterlix,3037,1354,153,125,278,55.0%,3m
14755,3,Jakon,3037,854,113,98,211,53.6%,19m
14755,3,Ackbar,3037,1550,95,88,183,51.9%,42m
14755,3,[lmrt]lamuerte,3037,935,92,103,195,47.2%,33m
14755,3,alpogru,3037,1000,65,63,128,50.8%,29m
14755,3,MoreLife,3037,1558,64,63,127,50.4%,16m
14755,1,NotSteve,3037,1052,42,32,74,56.8%,42m
14755,1,Bereaved,3037,927,32,32,64,50.0%,22m
14755,3,seraph,3037,774,26,35,61,42.6%,27m
14755,1,[JOOO]DPatty,3037,530,16,14,30,53.3%,9m
14755,3,[WWP2]DogMan,3037,215,11,8,19,57.9%,26m
14755,1,Trigger,3037,325,11,9,20,55.0%,14m
14755,1,Bassman,3037,225,6,4,10,60.0%,11m
14755,1,pablin,3037,0,1,0,1,100.0%,27m
14755,1,[HØST]Hotfy,3037,89,1,1,2,50.0%,24m
14755,1,FrozenCloud,3037,92,1,1,2,50.0%,16m
14755,3,[ZTemps]LostP,3037,0,1,3,4,25.0%,28m
14755,1,[SigmaV]GegMopak,3037,0,0,1,1,0.0%,29m
14755,1,Threegnomes,3037,0,0,2,2,0.0%,1m
14755,1,Dean,3037,0,0,4,4,0.0%,21m
14777,1,[TaCl]Wernier,3036,1594,326,317,643,50.7%,39m
14777,1,KhAnN,3036,1127,168,152,320,52.5%,44m
14777,1,[KanZan]KanSanZio,3036,1074,99,94,193,51.3%,10m
14777,3,[OceanT]Lucas,3036,1005,97,96,193,50.3%,23m
14777,3,MacDaddyMC,3036,1215,92,94,186,49.5%,18m
14777,3,Pibkabu,3036,966,41,46,87,47.1%,41m
14777,1,HARO,3036,389,39,26,65,60.0%,4m
14777,1,IIIIIIIIII,3036,810,28,25,53,52.8%,6m
14777,1,[Trons1]Luis,3036,481,25,18,43,58.1%,41m
14777,1,TheJhnny,3036,334,11,7,18,61.1%,40m
14777,1,[GgARMY]akuntelar,3036,204,8,3,11,72.7%,34m
14777,3,[MNFF]Northern,3036,195,6,11,17,35.3%,13m
14777,1,FxcKenBEAST,3036,123,4,4,8,50.0%,24m
14777,1,[BaSci]Bananashell,3036,0,3,2,5,60.0%,2h
14777,2,[Mc]MelKoR,3036,94,2,1,3,66.7%,2h
14777,1,[UberEL]JiasuChen,3036,0,1,0,1,100.0%,4m
14777,1,SirShorty,3036,0,0,1,1,0.0%,30m
14777,3,Saraphira,3036,0,0,2,2,0.0%,2h
14795,1,PROTOSAURUS,3035,1654,132,107,239,55.2%,29m
14795,3,Daijoubu,3035,1441,117,116,233,50.2%,11m
14795,3,[NwAs]martinez,3035,1519,89,81,170,52.4%,26m
14795,1,Cro,3035,1743,75,68,143,52.4%,25m
14795,3,Mitch,3035,1359,75,86,161,46.6%,23m
14795,3,mrchEn,3035,1027,45,47,92,48.9%,8m
14795,1,Bubble,3035,800,36,33,69,52.2%,31m
14795,1,[Cl1ckr]ClickerTown,3035,399,20,15,35,57.1%,33m
14795,1,Jukazem,3035,417,16,12,28,57.1%,29m
14795,3,HugeTree,3035,376,14,16,30,46.7%,25m
14795,1,[T4TG]Tuky,3035,320,12,9,21,57.1%,33m
14795,1,[XpKb]Hackmalware,3035,262,9,8,17,52.9%,29m
14795,1,Europa,3035,118,6,2,8,75.0%,30m
14795,1,[EK65]MacandCheese,3035,48,4,2,6,66.7%,2h
14795,1,[ValidG]SimplyYellow,3035,116,4,7,11,36.4%,6m
14795,1,wEe,3035,116,3,1,4,75.0%,39m
14795,1,Paradoxy,3035,0,3,2,5,60.0%,2h
14795,1,ThenAndNow,3035,78,2,6,8,25.0%,9m
14795,1,[Th3Bad]crazydogbr,3035,0,1,0,1,100.0%,43m
14795,1,IIIIIIIIIIII,3035,0,1,1,2,50.0%,39m
14795,1,OBPagan,3035,0,0,1,1,0.0%,17m
14795,1,Richardo,3035,0,0,1,1,0.0%,30m
14795,1,Shmatar,3035,0,0,1,1,0.0%,42m
14795,1,[PhdX]Mentat,3035,0,0,1,1,0.0%,43m
14795,1,Clockwork,3035,0,0,3,3,0.0%,2m
14795,1,eazyono,3035,0,0,4,4,0.0%,43m
14821,3,stupidanimal,3034,1549,175,176,351,49.9%,2m
14821,1,VARMEC,3034,1151,58,23,81,71.6%,22m
14821,1,PremisseS,3034,1470,54,51,105,51.4%,12m
14821,1,KibeXx,3034,1211,51,30,81,63.0%,10m
14821,1,[xRtGac]Achillies,3034,695,31,20,51,60.8%,41m
14821,1,[dioses]CHAMPEX,3034,537,29,24,53,54.7%,22m
14821,1,brianxxx,3034,305,27,22,49,55.1%,29m
14821,1,[HØST]NyKoN,3034,775,27,28,55,49.1%,42m
14821,1,[S980K]juanitoOo,3034,724,23,24,47,48.9%,31m
14821,1,Decunut,3034,337,15,13,28,53.6%,39m
14821,1,[GOPERÚ]Alan,3034,363,13,7,20,65.0%,30m
14821,3,HAHAJustin,3034,358,12,17,29,41.4%,33m
14821,1,Cixelsyd,3034,196,11,12,23,47.8%,2m
14821,1,Waterson,3034,286,9,8,17,52.9%,33m
14821,1,muntuk,3034,261,7,6,13,53.8%,3m
14821,1,bokchoy,3034,89,6,0,6,100.0%,4m
14821,3,[TELMO]SLASH,3034,145,6,3,9,66.7%,14m
14821,1,CaptainHook,3034,120,5,3,8,62.5%,30m
14821,3,swh,3034,0,4,2,6,66.7%,23m
14821,2,Xoldin,3034,0,4,3,7,57.1%,2h
14821,1,[OneHP]adApt,3034,117,2,2,4,50.0%,38m
14821,3,Gonza,3034,122,2,6,8,25.0%,9m
14821,1,Maverik,3034,0,1,2,3,33.3%,41m
14821,1,Schizen,3034,38,1,2,3,33.3%,4m
14821,1,Xae,3034,38,1,2,3,33.3%,23m
14821,1,[WNTRCO]Jrblood,3034,0,0,1,1,0.0%,2h
14821,1,[FCoE]SmokePing,3034,0,0,4,4,0.0%,9m
14848,3,SoldieRT,3033,1460,113,103,216,52.3%,25m
14848,3,Marduck,3033,875,94,94,188,50.0%,28m
14848,3,Vixaso,3033,1142,72,66,138,52.2%,14m
14848,1,Effect,3033,1377,51,54,105,48.6%,30m
14848,1,[GOPERÚ]LORKAOS,3033,830,35,20,55,63.6%,39m
14848,1,xhaviera,3033,1038,35,35,70,50.0%,35m
14848,1,[Fir3s]GOON,3033,749,32,23,55,58.2%,2m
14848,1,[Cind3r]AsHnFiRe,3033,480,18,15,33,54.5%,18m
14848,1,[XpKAc]Koin,3033,125,9,5,14,64.3%,16m
14848,1,[LHDSC]Calsifer,3033,248,7,10,17,41.2%,40m
14848,2,llllllllllll,3033,187,5,3,8,62.5%,28m
14848,2,Domino,3033,0,4,3,7,57.1%,22m
14848,2,cotorrakl,3033,0,3,2,5,60.0%,2h
14848,1,TOSSIMBALOL,3033,0,1,1,2,50.0%,1h
14848,1,[ThCz]JordWick,3033,0,0,1,1,0.0%,17m
14848,1,TheLionEye,3033,0,0,3,3,0.0%,30m
14864,3,[nieBla]MetalMilitiA,3032,1259,171,166,337,50.7%,40m
14864,1,noble,3032,1653,82,73,155,52.9%,13m
14864,3,RyDan,3032,944,49,46,95,51.6%,21m
14864,1,FerSimonds,3032,1017,46,28,74,62.2%,18m
14864,1,Cancelled,3032,825,44,40,84,52.4%,6m
14864,1,[JaMiT]FourHorsemen,3032,1082,43,42,85,50.6%,18m
14864,3,StolenSnail,3032,1198,43,51,94,45.7%,3m
14864,1,Tenko,3032,797,41,19,60,68.3%,17m
14864,1,Grimkz,3032,868,35,28,63,55.6%,33m
14864,1,Rajms,3032,476,21,15,36,58.3%,41m
14864,3,Stephenhbs,3032,656,21,34,55,38.2%,3m
14864,1,Gratzkul,3032,455,17,12,29,58.6%,20m
14864,1,[Th3Bad]Brulissan,3032,492,15,16,31,48.4%,22m
14864,1,MethodMan,3032,282,11,11,22,50.0%,41m
14864,1,HelloThere,3032,214,8,6,14,57.1%,43m
14864,1,Finality,3032,103,5,2,7,71.4%,26m
14864,3,[421]Tyho,3032,172,4,5,9,44.4%,41m
14864,1,JimmyDiesel,3032,156,4,7,11,36.4%,41m
14864,3,withkorean,3032,94,2,4,6,33.3%,15m
14864,3,[APK]MrPoPo,3032,44,2,6,8,25.0%,21m
14864,3,Spaceman,3032,0,1,0,1,100.0%,42m
14864,1,[therat]JuanPunchMan,3032,89,1,1,2,50.0%,35m
14864,2,ICY,3032,94,1,1,2,50.0%,43m
14864,1,[xdddxd]cocainomano,3032,40,1,3,4,25.0%,18m
14864,1,Sirrus,3032,0,1,4,5,20.0%,18m
14864,1,zero,3032,0,1,4,5,20.0%,2h
14864,1,[Toats]Yaking,3032,0,0,1,1,0.0%,26m
14864,1,[JAGWN]RaDo,3032,0,0,2,2,0.0%,22m
14892,3,[LOOPY]ThexbigxJ,3031,958,122,118,240,50.8%,42m
14892,1,Tankman,3031,1634,91,92,183,49.7%,13m
14892,1,bunnyyy,3031,250,19,12,31,61.3%,25m
14892,1,Zaktorra,3031,226,15,9,24,62.5%,22m
14892,1,NohVarr,3031,299,11,8,19,57.9%,26m
14892,1,[ROSC2]JagassarBR,3031,304,10,6,16,62.5%,34m
14892,1,Anakin,3031,238,8,5,13,61.5%,22m
14892,1,[GOPERÚ]Josero,3031,218,7,6,13,53.8%,9m
14892,1,Elias,3031,131,7,12,19,36.8%,3m
14892,1,[TriFP]Engineer,3031,134,5,0,5,100.0%,24m
14892,1,[UpeV]PortentousTV,3031,188,4,8,12,33.3%,4m
14892,1,[RHGP]archon,3031,91,2,0,2,100.0%,35m
14892,1,Lawlderp,3031,0,1,0,1,100.0%,18m
14892,1,[lKoDl]DevilDog,3031,0,0,2,2,0.0%,12m
14906,3,[Litez]Krullus,3030,1502,485,485,970,50.0%,13m
14906,1,Lane,3030,1573,194,171,365,53.2%,4m
14906,1,DSwift,3030,1706,115,107,222,51.8%,3m
14906,1,[3DVN]Thinkfast,3030,635,90,76,166,54.2%,41m
14906,1,Radamanthis,3030,1081,82,57,139,59.0%,41m
14906,1,[Parry]FeedAndLeave,3030,1332,73,51,124,58.9%,17m
14906,1,Fenix,3030,862,36,43,79,45.6%,33m
14906,3,Manawks,3030,401,18,17,35,51.4%,29m
14906,1,DebugCode,3030,332,16,6,22,72.7%,30m
14906,1,[URSC]Checho,3030,476,16,19,35,45.7%,39m
14906,1,[SD760]IIIIIIIIII,3030,260,12,3,15,80.0%,9m
14906,1,Skittles,3030,284,10,6,16,62.5%,16m
14906,1,IIIIIIIIIIII,3030,166,10,8,18,55.6%,9m
14906,1,[αX]Pearl,3030,130,5,0,5,100.0%,6m
14906,1,[UpxV]Marrows,3030,117,4,0,4,100.0%,4m
14906,1,WookE,3030,34,2,2,4,50.0%,20m
14906,1,[biboi]Gushee,3030,0,1,0,1,100.0%,26m
14906,1,JJSpacer,3030,0,1,2,3,33.3%,6m
14906,1,filthlord,3030,36,1,4,5,20.0%,4m
14906,1,PinkZebra,3030,0,0,1,1,0.0%,39m
14906,1,[GØSU]badnickton,3030,0,0,2,2,0.0%,42m
14927,1,BiTterswEet,3029,1729,360,337,697,51.6%,7m
14927,3,KnightofNi,3029,1555,255,260,515,49.5%,21m
14927,1,LittleJoe,3029,806,89,75,164,54.3%,18m
14927,1,Feivel,3029,1025,48,39,87,55.2%,6m
14927,3,EnsisMoebius,3029,725,48,56,104,46.2%,3m
14927,3,Malikknight,3029,949,38,43,81,46.9%,25m
14927,1,Jebuss,3029,903,33,30,63,52.4%,42m
14927,1,[ZCCCFE]mas,3029,399,14,11,25,56.0%,27m
14927,2,Tempest,3029,232,7,12,19,36.8%,4m
14927,3,KachunK,3029,176,7,14,21,33.3%,7m
14927,1,[GdAT]Phayld,3029,0,4,1,5,80.0%,17m
14927,1,Wohodix,3029,103,4,2,6,66.7%,39m
14927,1,KoraBeullu,3029,30,4,3,7,57.1%,18m
14927,1,Talo,3029,48,3,3,6,50.0%,1h
14927,1,KamalaHaRriS,3029,114,3,5,8,37.5%,10m
14927,3,Shoefish,3029,112,3,7,10,30.0%,7m
14927,1,[AD3C]rathmA,3029,0,1,0,1,100.0%,9m
14927,1,SewerSquirel,3029,0,1,1,2,50.0%,39m
14927,1,THOR,3029,0,0,1,1,0.0%,12m
14946,3,[NPhase]sol,3028,946,253,259,512,49.4%,44m
14946,1,Kimyishin,3028,1133,212,185,397,53.4%,6m
14946,3,[Fir3s]RisingSun,3028,1515,202,176,378,53.4%,22m
14946,1,[LASG]iychang,3028,1614,87,85,172,50.6%,3m
14946,1,[UpxV]CPDciv,3028,1471,59,48,107,55.1%,18m
14946,1,[krAMsI]Bassistant,3028,759,54,42,96,56.2%,39m
14946,1,snipedurast,3028,816,38,23,61,62.3%,22m
14946,1,[APK]SAnjos,3028,527,25,18,43,58.1%,31m
14946,1,Machiavelli,3028,396,25,25,50,50.0%,3m
14946,1,Turtleshell,3028,549,21,9,30,70.0%,41m
14946,1,kevshoe,3028,439,20,12,32,62.5%,4m
14946,1,JimyTBG,3028,450,19,15,34,55.9%,21m
14946,1,TheCrazyGoat,3028,384,16,12,28,57.1%,10m
14946,1,[7IP]Bael,3028,238,11,7,18,61.1%,30m
14946,1,PartinGG,3028,135,9,6,15,60.0%,10m
14946,1,RoyalSm,3028,165,8,5,13,61.5%,42m
14946,1,[TVHENZ]SknyZlotLegs,3028,138,5,7,12,41.7%,35m
14946,3,Becks,3028,0,4,2,6,66.7%,41m
14946,1,SorrySerral,3028,102,4,4,8,50.0%,42m
14946,1,onecool,3028,110,4,5,9,44.4%,31m
14946,1,[MilkPi]DrLiberty,3028,121,3,1,4,75.0%,2m
14946,1,RobinHood,3028,0,1,0,1,100.0%,29m
14946,3,TomTomTommy,3028,0,1,0,1,100.0%,23m
14946,1,Ardent,3028,38,1,3,4,25.0%,44m
14946,1,[FalPal]computer,3028,0,0,1,1,0.0%,32m
14971,3,[FFAA]Ikoga,3027,1467,173,150,323,53.6%,13m
14971,1,skanks,3027,1043,90,69,159,56.6%,41m
14971,1,Sklaper,3027,1148,54,37,91,59.3%,18m
14971,3,Evan,3027,799,54,59,113,47.8%,21m
14971,1,RhYno,3027,753,51,43,94,54.3%,45m
14971,1,David,3027,796,33,31,64,51.6%,10m
14971,1,[TGosuA]TORPADEKA,3027,873,30,25,55,54.5%,5m
14971,1,zojefski,3027,439,17,13,30,56.7%,16m
14971,1,[IMDSI]jhonatan,3027,373,15,10,25,60.0%,4m
14971,1,CrowOfLight,3027,239,14,1,15,93.3%,9m
14971,1,squarepusher,3027,392,12,11,23,52.2%,21m
14971,1,Off,3027,380,11,14,25,44.0%,7m
14971,1,EUposter,3027,237,10,7,17,58.8%,2h
14971,2,AdemStiner,3027,202,7,9,16,43.8%,15m
14971,1,qGhee,3027,151,5,1,6,83.3%,31m
14971,1,agustinbalda,3027,118,5,2,7,71.4%,35m
14971,1,silksauce,3027,186,5,4,9,55.6%,21m
14971,1,noxiD,3027,48,4,2,6,66.7%,16m
14971,1,Hoody,3027,116,4,3,7,57.1%,13m
14971,2,Brosal,3027,0,4,3,7,57.1%,2h
14971,3,michealean,3027,145,4,3,7,57.1%,22m
14971,1,MintRoyale,3027,162,3,4,7,42.9%,30m
14971,3,DeKu,3027,98,3,11,14,21.4%,9m
14971,1,[SYNDCT]AngelofSc,3027,70,2,4,6,33.3%,39m
14971,1,[Inseto]Conatus,3027,0,1,0,1,100.0%,17m
14971,1,ahno,3027,0,1,0,1,100.0%,6m
14971,2,Valyrion,3027,0,1,1,2,50.0%,2h
14971,1,[RinNya]Alice,3027,0,0,1,1,0.0%,42m
14971,1,TheCodFather,3027,0,0,5,5,0.0%,9m
15000,1,Erebus,3026,1644,431,404,835,51.6%,12m
15000,3,IMSORRYLOLGG,3026,1515,223,215,438,50.9%,25m
15000,1,[ssexxy]Artemis,3026,1332,97,79,176,55.1%,10m
15000,1,IIIIIIIIIIII,3026,1465,62,44,106,58.5%,41m
15000,1,[UpxV]RealSC,3026,1660,62,61,123,50.4%,10m
15000,2,Vaporflare,3026,1148,59,39,98,60.2%,4m
15000,3,Blackbeard,3026,1095,56,53,109,51.4%,6m
15000,3,[1LPD]Darkmerlinn,3026,1329,53,57,110,48.2%,27m
15000,2,Altecman,3026,612,44,14,58,75.9%,26m
15000,3,[UpxV]shaka,3026,376,43,47,90,47.8%,41m
15000,1,[Grayon]CPCHOWDER,3026,789,31,24,55,56.4%,16m
15000,1,JzCannon,3026,537,18,15,33,54.5%,33m
15000,3,[Eboys]Cryas,3026,275,14,16,30,46.7%,25m
15000,1,Prabhdas,3026,342,12,8,20,60.0%,2h
15000,2,[lHMOl]TheGeneral,3026,294,10,3,13,76.9%,23m
15000,1,DarkTemplar,3026,200,9,4,13,69.2%,30m
15000,3,AlfredsDaddy,3026,166,6,3,9,66.7%,39m
15000,2,[hTx]Joker,3026,96,4,2,6,66.7%,11m
15000,3,jonskma,3026,0,4,2,6,66.7%,3h
15000,3,ZeroRequiem,3026,40,2,2,4,50.0%,2h
15000,1,[QTclub]CrusaderKing,3026,78,2,5,7,28.6%,40m
15000,1,[CHARR]Tmoy,3026,78,2,9,11,18.2%,42m
15000,2,UsmininO,3026,0,1,0,1,100.0%,28m
15000,3,LGBTandBLM,3026,0,1,1,2,50.0%,42m
15000,1,[SC2IDN]Rhenka,3026,0,1,5,6,16.7%,31m
15000,1,ImPulsE,3026,0,0,2,2,0.0%,44m
15026,1,iMposter,3025,1733,654,587,1241,52.7%,41m
15026,1,[SBlock]conejo,3025,1149,209,172,381,54.9%,40m
15026,3,GershonJonez,3025,952,197,188,385,51.2%,28m
15026,3,fhsa,3025,963,91,81,172,52.9%,34m
15026,1,[Calx]Lemaitre,3025,778,71,56,127,55.9%,40m
15026,3,CptKreep,3025,1524,64,65,129,49.6%,26m
15026,1,[0clã]Pwz,3025,343,37,23,60,61.7%,10m
15026,1,BlueBanana,3025,837,32,26,58,55.2%,41m
15026,3,[BIKBOY]Sqwinee,3025,128,31,28,59,52.5%,42m
15026,3,XXXBlumpkin,3025,321,11,14,25,44.0%,22m
15026,2,Ikanous,3025,176,9,6,15,60.0%,4m
15026,3,ErrorZERO,3025,226,7,3,10,70.0%,2m
15026,1,kobelord,3025,226,6,9,15,40.0%,24m
15026,1,[xO]DukeSilver,3025,133,4,0,4,100.0%,2h
15026,1,Kendman,3025,182,4,4,8,50.0%,31m
15026,2,[GrimmC]llllllllllll,3025,32,2,0,2,100.0%,21m
15026,3,Ayyy,3025,58,2,9,11,18.2%,14m
15026,1,[1Cat1]StingrayVoid,3025,0,0,1,1,0.0%,26m
15026,2,Blake,3025,0,0,1,1,0.0%,19m
15045,1,Warrior,3024,1031,104,96,200,52.0%,35m
15045,3,[juggr]NapTime,3024,1497,61,70,131,46.6%,14m
15045,3,[HØST]Executor,3024,918,40,36,76,52.6%,13m
15045,1,Chonny,3024,494,36,23,59,61.0%,41m
15045,1,SCVKing,3024,674,35,32,67,52.2%,14m
15045,1,[IL1]ArbiterZero,3024,724,31,25,56,55.4%,5m
15045,3,dacker,3024,285,13,8,21,61.9%,34m
15045,1,[KySs]Kyler,3024,302,10,9,19,52.6%,23m
15045,1,Simplified,3024,268,10,11,21,47.6%,33m
15045,2,[QGR]ImmoLord,3024,95,5,3,8,62.5%,2h
15045,3,Tiozin,3024,122,5,3,8,62.5%,2h
15045,3,EggyAzalea,3024,0,2,2,4,50.0%,43m
15045,2,[DSGs]Tsubasa,3024,0,0,1,1,0.0%,6m
15045,2,[ScSwrm]FutureNights,3024,0,0,3,3,0.0%,2h
15059,3,FullTuna,3023,1499,158,151,309,51.1%,29m
15059,3,TakaJoebacca,3023,1559,118,112,230,51.3%,32m
15059,1,Slowpoke,3023,1575,70,52,122,57.4%,5m
15059,1,[YKJK]thunderman,3023,1235,48,45,93,51.6%,2m
15059,1,Nicee,3023,1247,44,41,85,51.8%,25m
15059,3,[GTFO]BlackHole,3023,863,43,46,89,48.3%,3m
15059,1,IIIIIIIIIIII,3023,495,29,25,54,53.7%,14m
15059,3,Slawsh,3023,736,28,31,59,47.5%,16m
15059,1,RyGuy,3023,534,27,15,42,64.3%,2m
15059,1,CalySwish,3023,300,9,7,16,56.2%,25m
15059,1,Arkuss,3023,298,8,10,18,44.4%,10m
15059,2,Hiyori,3023,211,7,7,14,50.0%,18m
15059,2,Tictock,3023,88,6,3,9,66.7%,25m
15059,2,[KiMBR]FeniX,3023,148,5,1,6,83.3%,31m
15059,1,HonestIago,3023,114,5,6,11,45.5%,31m
15059,1,[WofA]Theads,3023,188,5,7,12,41.7%,33m
15059,2,Xaz,3023,0,3,2,5,60.0%,2m
15059,1,DrunkDoozins,3023,121,3,2,5,60.0%,9m
15059,1,Ether,3023,140,3,3,6,50.0%,26m
15059,1,Terminator,3023,114,3,4,7,42.9%,35m
15059,1,Evertale,3023,138,3,6,9,33.3%,9m
15059,1,IIIlll,3023,78,2,9,11,18.2%,7m
15059,2,Mac,3023,0,1,0,1,100.0%,24m
15059,3,[LoF]Malignant,3023,0,0,1,1,0.0%,42m
15083,1,Chooligan,3022,998,123,111,234,52.6%,42m
15083,2,[Peww]icecoldjuice,3022,1561,82,68,150,54.7%,21m
15083,1,JimmySeri,3022,423,70,59,129,54.3%,40m
15083,1,SirBings,3022,516,40,32,72,55.6%,4m
15083,1,[EvilGC]yarley,3022,1082,37,40,77,48.1%,42m
15083,3,Phaledax,3022,501,25,23,48,52.1%,26m
15083,1,[ALQ]ReAdosS,3022,601,22,18,40,55.0%,12m
15083,1,[CnD]RoyalKing,3022,539,18,16,34,52.9%,33m
15083,1,REPTILE,3022,317,11,7,18,61.1%,22m
15083,1,Armin,3022,423,11,12,23,47.8%,34m
15083,1,Marximus,3022,388,11,13,24,45.8%,24m
15083,2,gsxr,3022,194,8,3,11,72.7%,15m
15083,1,iDoGayStrats,3022,154,4,7,11,36.4%,10m
15083,1,[SsaYnS]Yeena,3022,148,4,10,14,28.6%,10m
15083,1,JohnLennown,3022,104,3,9,12,25.0%,39m
15083,1,[OKz]Jesse,3022,80,2,5,7,28.6%,40m
15083,1,Shane,3022,84,2,9,11,18.2%,31m
15083,1,[VRGM]AtreidesII,3022,0,1,1,2,50.0%,30m
15083,1,[JAZ]SKIKS,3022,97,1,6,7,14.3%,5m
15083,2,RileyReid,3022,0,0,1,1,0.0%,22m
15083,1,DanPochii,3022,0,0,2,2,0.0%,29m
15083,2,Insanity,3022,0,0,2,2,0.0%,2h
15105,2,giansa,3021,1660,147,115,262,56.1%,31m
15105,3,juniorfpf,3021,898,129,117,246,52.4%,28m
15105,3,Gulain,3021,1522,78,89,167,46.7%,42m
15105,1,[SFUSC]Eugoogalizer,3021,792,32,26,58,55.2%,3m
15105,1,[XpKAc]TouchMe,3021,793,30,26,56,53.6%,23m
15105,1,Billybob,3021,682,29,26,55,52.7%,20m
15105,1,Destro,3021,703,27,19,46,58.7%,40m
15105,1,SCL,3021,490,22,14,36,61.1%,40m
15105,1,Chaos,3021,405,14,11,25,56.0%,34m
15105,1,IIIIIIIIIIII,3021,374,14,11,25,56.0%,30m
15105,1,Mitch,3021,305,11,8,19,57.9%,2h
15105,2,TheDarkLord,3021,251,9,7,16,56.2%,2h
15105,2,LoliComunist,3021,248,9,7,16,56.2%,2h
15105,2,Pancakes,3021,276,9,9,18,50.0%,19m
15105,1,[TRASHH]PukimakCibai,3021,237,8,4,12,66.7%,41m
15105,2,IIIIIIIIIIII,3021,184,8,4,12,66.7%,8m
15105,2,llllllllllll,3021,168,7,2,9,77.8%,10m
15105,1,DJTORY,3021,150,6,3,9,66.7%,13m
15105,2,[Nuken]Furiouskill,3021,0,1,0,1,100.0%,40m
15105,2,Trayis,3021,0,1,0,1,100.0%,11m
15105,2,[WeDry]Snakebyte,3021,32,1,1,2,50.0%,17m
15105,2,Dargon,3021,0,0,1,1,0.0%,30m
15105,2,[FTArk]vilageidot,3021,0,0,1,1,0.0%,17m
15128,3,RobotWizard,3020,1131,169,161,330,51.2%,20m
15128,1,Tank,3020,1585,157,142,299,52.5%,23m
15128,1,abliviax,3020,1649,116,107,223,52.0%,26m
15128,1,Michael,3020,954,36,33,69,52.2%,2m
15128,1,Biden,3020,629,26,14,40,65.0%,7m
15128,1,DuskTower,3020,660,25,18,43,58.1%,5m
15128,1,BigBadWolf,3020,372,17,13,30,56.7%,32m
15128,1,jhonatandsm,3020,310,15,9,24,62.5%,17m
15128,1,Faiya,3020,443,15,12,27,55.6%,5m
15128,1,Whiteguy,3020,349,12,13,25,48.0%,10m
15128,1,KROMAK,3020,378,12,15,27,44.4%,30m
15128,1,aaa,3020,160,8,6,14,57.1%,12m
15128,1,IceHut,3020,215,7,3,10,70.0%,40m
15128,3,Phenomenon,3020,0,5,1,6,83.3%,1h
15128,3,GPOTHREE,3020,143,5,3,8,62.5%,7m
15128,1,Jiga,3020,0,4,1,5,80.0%,2h
15128,2,Bread,3020,0,3,2,5,60.0%,34m
15128,3,KimJongUn,3020,30,2,9,11,18.2%,39m
15128,3,lonelyturtle,3020,96,1,2,3,33.3%,18m
15128,2,bigdickdan,3020,30,1,2,3,33.3%,11m
15128,2,HeroicCookie,3020,0,0,1,1,0.0%,34m
15128,1,MisQ,3020,0,0,3,3,0.0%,34m
15128,1,[NPhase]Maximilien,3020,0,0,3,3,0.0%,39m
15151,3,javifishy,3019,1536,157,146,303,51.8%,18m
15151,1,[Softy]tatertoss,3019,1704,137,131,268,51.1%,19m
15151,3,Lego,3019,1602,120,107,227,52.9%,34m
15151,3,HartreeFock,3019,1384,100,111,211,47.4%,2m
15151,2,[FuTD]Rockfenix,3019,508,21,12,33,63.6%,9m
15151,2,Kiang,3019,522,19,17,36,52.8%,14m
15151,3,Synexi,3019,266,11,9,20,55.0%,25m
15151,2,NobleGenesis,3019,191,7,6,13,53.8%,2h
15151,1,Samaranth,3019,224,5,6,11,45.5%,3m
15151,2,Silverity,3019,30,4,2,6,66.7%,20m
15151,2,yocha,3019,30,4,3,7,57.1%,19m
15151,2,NoMad,3019,88,3,1,4,75.0%,44m
15151,2,aaShaun,3019,58,2,1,3,66.7%,21m
15151,1,dryson,3019,0,2,4,6,33.3%,2m
15151,2,RooK,3019,36,1,1,2,50.0%,23m
15151,1,[4lulz]PaulFiend,3019,0,1,2,3,33.3%,7m
15151,1,DeWulfman,3019,0,1,2,3,33.3%,40m
15151,3,AquaBadger,3019,0,1,6,7,14.3%,12m
15169,3,SupremeQueer,3018,466,136,125,261,52.1%,13m
15169,1,Parsirius,3018,1304,100,89,189,52.9%,33m
15169,1,Griesy,3018,1288,43,46,89,48.3%,33m
15169,1,[SGSPP]SkChaoz,3018,862,32,27,59,54.2%,31m
15169,1,Tyler,3018,601,19,20,39,48.7%,31m
15169,1,zylia,3018,212,13,8,21,61.9%,24m
15169,1,NeoSecondSEA,3018,334,12,8,20,60.0%,4m
15169,1,[FFAA]shinji,3018,182,5,9,14,35.7%,33m
15169,1,Wakka,3018,42,3,3,6,50.0%,31m
15169,2,TYFan,3018,94,2,2,4,50.0%,11m
15169,2,Harpalyke,3018,112,2,5,7,28.6%,30m
15169,2,klepsveiks,3018,0,1,0,1,100.0%,35m
15169,2,MayhemComes,3018,34,1,1,2,50.0%,33m
15169,2,[PlMP]dolberman,3018,46,1,4,5,20.0%,1h
15169,2,vástago,3018,0,0,1,1,0.0%,21m
15184,1,[dLife]Solaris,3017,1651,319,310,629,50.7%,35m
15184,3,BadPinG,3017,1431,137,133,270,50.7%,11m
15184,1,Cartman,3017,1730,67,64,131,51.1%,12m
15184,1,[JaMiT]StarToss,3017,1277,47,51,98,48.0%,19m
15184,2,SoloXman,3017,529,45,34,79,57.0%,34m
15184,1,WalrusBaws,3017,404,29,19,48,60.4%,24m
15184,2,PenguinGamer,3017,480,20,9,29,69.0%,21m
15184,2,IIURANOSII,3017,394,15,9,24,62.5%,10m
15184,1,Andrew,3017,317,13,11,24,54.2%,31m
15184,2,EyeSoberbia,3017,270,11,10,21,52.4%,34m
15184,3,NEOLIBERATE,3017,70,6,4,10,60.0%,2h
15184,1,[SnW]Lashiec,3017,216,6,11,17,35.3%,1h
15184,1,[Lp]martincito,3017,133,5,1,6,83.3%,44m
15184,1,Catlubber,3017,95,5,3,8,62.5%,2m
15184,2,[KICT]Klondike,3017,94,4,8,12,33.3%,2h
15184,2,[XTGZ]XtremeNubi,3017,62,2,2,4,50.0%,26m
15184,1,Microman,3017,36,2,2,4,50.0%,2m
15184,1,[Chrev]Tahnks,3017,0,1,1,2,50.0%,39m
15184,2,[xRtGac]Zippy,3017,0,0,1,1,0.0%,24m
15184,2,[LGNxx]Shar,3017,0,0,1,1,0.0%,8m
15184,1,[SV]FErNanDo,3017,0,0,2,2,0.0%,4m
15205,1,Brisingr,3016,1526,241,217,458,52.6%,42m
15205,1,Loki,3016,1722,186,155,341,54.5%,30m
15205,1,SluttySloth,3016,647,60,34,94,63.8%,40m
15205,3,Sniker,3016,497,28,31,59,47.5%,21m
15205,2,papa,3016,384,15,7,22,68.2%,22m
15205,3,maurice,3016,293,14,10,24,58.3%,3m
15205,3,ThaKid,3016,265,12,9,21,57.1%,22m
15205,3,Alfazar,3016,166,9,18,27,33.3%,39m
15205,3,[zeez]Bruce,3016,166,5,3,8,62.5%,7m
15205,1,WizKhalifa,3016,148,5,6,11,45.5%,4m
15205,1,Blizzfreak,3016,0,4,1,5,80.0%,2m
15205,1,Dace,3016,97,4,2,6,66.7%,2h
15205,3,[TGosuC]DillyWilly,3016,30,2,4,6,33.3%,17m
15205,1,IIIIIIIIIIII,3016,66,2,4,6,33.3%,5m
15205,2,[TOMACO]Ricardo,3016,0,1,0,1,100.0%,18m
15205,2,Mosckvin,3016,0,1,0,1,100.0%,4m
15205,1,TeletobyROK,3016,0,1,0,1,100.0%,2h
15205,3,[FacTat]Jizzles,3016,40,1,7,8,12.5%,1h
15205,2,[TeamUR]Rainbowly,3016,0,0,1,1,0.0%,10m
15205,2,Cloak,3016,0,0,1,1,0.0%,21m
15205,1,Ansale,3016,0,0,5,5,0.0%,30m
15205,3,yena,3016,0,0,16,16,0.0%,20m
15227,1,TIDUS,3015,1706,493,448,941,52.4%,17m
15227,3,Naviester,3015,1589,66,60,126,52.4%,32m
15227,2,DUMMYTHICC,3015,891,36,24,60,60.0%,18m
15227,1,[4Karl]Nebula,3015,365,13,8,21,61.9%,30m
15227,1,ZipLock,3015,286,9,6,15,60.0%,17m
15227,3,Potato,3015,166,8,6,14,57.1%,33m
15227,2,Bolsteen,3015,155,4,1,5,80.0%,15m
15227,2,Geofro,3015,118,4,4,8,50.0%,19m
15227,2,[AiMB]fiziokrat,3015,138,3,6,9,33.3%,40m
15227,2,WarLord,3015,0,1,0,1,100.0%,42m
15227,1,[USSAF]Commodore,3015,0,1,0,1,100.0%,14m
15227,1,Ethereum,3015,0,1,0,1,100.0%,2h
15227,1,MasterWind,3015,90,1,2,3,33.3%,32m
15227,2,Gathunox,3015,32,1,2,3,33.3%,6m
15227,2,buyukibne,3015,0,0,1,1,0.0%,43m
15227,2,[HUSTLA]minkus,3015,0,0,1,1,0.0%,11m
15227,2,Swell,3015,0,0,1,1,0.0%,26m
15227,1,lucho,3015,0,0,2,2,0.0%,16m
15227,1,perex,3015,0,0,2,2,0.0%,40m
15246,3,[VFam2]TopSecret,3014,1514,291,290,581,50.1%,14m
15246,1,[FIow]madSCIeNTiSt,3014,1490,168,156,324,51.9%,23m
15246,1,ARTANIS,3014,1206,159,150,309,51.5%,42m
15246,1,Siggnos,3014,953,101,80,181,55.8%,30m
15246,1,poxxop,3014,1690,98,91,189,51.9%,30m
15246,1,Forestaurora,3014,1258,70,54,124,56.5%,4m
15246,3,Jinx,3014,1219,45,58,103,43.7%,30m
15246,2,[GC2042]sooopersonic,3014,466,18,13,31,58.1%,10m
15246,1,[FARNS]danielpimp,3014,341,17,18,35,48.6%,10m
15246,1,EsoOmni,3014,177,8,4,12,66.7%,18m
15246,2,TheDark,3014,244,8,7,15,53.3%,24m
15246,2,[DIRSTK]JaySin,3014,32,4,2,6,66.7%,10m
15246,2,VIDHARDT,3014,120,4,3,7,57.1%,42m
15246,1,Dancore,3014,161,4,4,8,50.0%,20m
15246,2,[SoAC]Sharkboticus,3014,66,3,0,3,100.0%,25m
15246,1,Kubbie,3014,110,3,6,9,33.3%,4m
15246,1,SiRe,3014,36,2,4,6,33.3%,9m
15246,1,Mercer,3014,76,2,5,7,28.6%,10m
15246,2,DegradedMeat,3014,30,1,1,2,50.0%,6m
15246,3,[Fir3s]StporA,3014,0,0,1,1,0.0%,34m
15246,2,Panzer,3014,0,0,1,1,0.0%,16m
15246,2,[BD911]Ryde,3014,0,0,1,1,0.0%,18m
15246,2,DrProbeJV,3014,0,0,1,1,0.0%,2h
15246,1,dasadsadsa,3014,0,0,2,2,0.0%,7m
15246,1,[dK]DarkLord,3014,0,0,3,3,0.0%,4m
15271,1,[OtakMs]RicardoMS,3013,1718,170,143,313,54.3%,26m
15271,1,SuperiorX,3013,1241,73,46,119,61.3%,10m
15271,1,Sputnik,3013,1447,62,65,127,48.8%,21m
15271,3,Crescent,3013,651,56,53,109,51.4%,5m
15271,1,thinktank,3013,866,48,37,85,56.5%,20m
15271,1,TrashPanda,3013,921,34,32,66,51.5%,34m
15271,1,HANS,3013,780,29,27,56,51.8%,3m
15271,1,lampheN,3013,554,27,14,41,65.9%,41m
15271,1,BellaChance,3013,798,26,27,53,49.1%,17m
15271,3,RungeKutta,3013,515,21,24,45,46.7%,28m
15271,1,ButterSkates,3013,542,15,22,37,40.5%,42m
15271,1,[PobSC]Shigure,3013,372,11,13,24,45.8%,25m
15271,1,DoDawn,3013,127,9,4,13,69.2%,18m
15271,2,[s1s]Khadgar,3013,192,8,6,14,57.1%,14m
15271,3,Goobster,3013,188,6,4,10,60.0%,21m
15271,1,Smiling,3013,155,5,3,8,62.5%,17m
15271,3,kami,3013,0,4,2,6,66.7%,2h
15271,3,Kalebur,3013,0,4,2,6,66.7%,1h
15271,2,PSyCongroo,3013,0,3,2,5,60.0%,4m
15271,1,PartinG,3013,0,3,2,5,60.0%,2h
15271,2,Asnofyx,3013,32,2,1,3,66.7%,19m
15271,1,Farkas,3013,76,2,4,6,33.3%,9m
15271,1,ElLameBotas,3013,40,2,6,8,25.0%,24m
15271,2,[SocDis]IlIlllIlllII,3013,0,1,0,1,100.0%,31m
15295,1,[TLCE]PetitJoe,3012,1392,151,93,244,61.9%,7m
15295,1,Básquias,3012,1703,96,87,183,52.5%,3m
15295,1,[TekNiQ]TekNiQlogic,3012,1132,52,42,94,55.3%,31m
15295,1,HairyProbe,3012,1142,48,36,84,57.1%,9m
15295,1,[11001]Yggdrasil,3012,728,35,24,59,59.3%,32m
15295,2,BigBalls,3012,618,30,14,44,68.2%,14m
15295,1,[TCFE]poolman,3012,578,26,17,43,60.5%,22m
15295,1,guevarodrigo,3012,467,19,14,33,57.6%,30m
15295,1,Alect,3012,396,15,12,27,55.6%,26m
15295,1,Vegeta,3012,376,13,9,22,59.1%,2m
15295,1,[ZC]MinuteMan,3012,254,11,7,18,61.1%,31m
15295,1,frankisfrunk,3012,302,9,10,19,47.4%,35m
15295,2,TeraRaptor,3012,30,4,3,7,57.1%,21m
15295,2,[RePlz]CedrictheDog,3012,0,3,2,5,60.0%,2m
15295,2,nemuritai,3012,0,3,2,5,60.0%,31m
15295,1,QuangDepZai,3012,106,3,2,5,60.0%,35m
15295,1,[RlSKE]Ether,3012,91,2,1,3,66.7%,5m
15295,2,Cromulent,3012,0,2,3,5,40.0%,42m
15295,2,MajorBooty,3012,0,1,0,1,100.0%,11m
15295,2,[XDRAX8]DraXSlave,3012,0,0,1,1,0.0%,17m
15295,2,RaMM,3012,0,0,1,1,0.0%,44m
15295,1,Mechtallica,3012,0,0,2,2,0.0%,20m
15295,2,[CWRU]BBaller,3012,0,0,4,4,0.0%,2h
15318,3,StokesANTH,3011,1405,356,340,696,51.1%,9m
15318,1,AbusePedro,3011,1157,133,97,230,57.8%,11m
15318,1,LuckyPig,3011,822,64,37,101,63.4%,8m
15318,1,Mac,3011,1477,56,48,104,53.8%,30m
15318,1,[VENSC2]Wasabi,3011,1056,39,34,73,53.4%,29m
15318,2,kevlp,3011,957,38,27,65,58.5%,25m
15318,1,Gravitation,3011,798,25,28,53,47.2%,39m
15318,1,Icarus,3011,230,11,7,18,61.1%,40m
15318,2,[EvilGC]chero,3011,193,8,4,12,66.7%,17m
15318,2,américo,3011,90,4,2,6,66.7%,40m
15318,2,[iMECH]CALL,3011,30,4,2,6,66.7%,21m
15318,1,[kOuT]DjPaNcHokO,3011,118,4,4,8,50.0%,8m
15318,2,[UFC]BenCor,3011,0,1,0,1,100.0%,34m
15318,2,[KeithM]TangyStupid,3011,0,1,0,1,100.0%,6m
15318,1,[Borgas]Berio,3011,46,1,2,3,33.3%,10m
15318,2,[EvilCC]EDUARS,3011,34,1,2,3,33.3%,12m
15318,2,Rocker,3011,0,0,1,1,0.0%,21m
15335,3,[UpxV]MrLimn,3010,1532,203,189,392,51.8%,22m
15335,1,Sgtmajorlee,3010,1692,115,99,214,53.7%,30m
15335,1,Bitmin,3010,1547,108,93,201,53.7%,22m
15335,1,MsJackson,3010,1310,57,41,98,58.2%,40m
15335,1,XDARKWOLF,3010,960,36,31,67,53.7%,8m
15335,1,hunglo,3010,735,29,27,56,51.8%,10m
15335,3,PapuGuapu,3010,278,12,9,21,57.1%,27m
15335,2,[TGosuB]ShinyDialga,3010,315,12,14,26,46.2%,13m
15335,2,MrPuTiNN,3010,222,7,2,9,77.8%,2h
15335,1,[GOPERÚ]Davulgani,3010,246,7,7,14,50.0%,4m
15335,2,[MiaoM]Tonytan,3010,60,5,3,8,62.5%,15m
15335,2,UncleRoger,3010,131,5,3,8,62.5%,18m
15335,2,[cl0udM]TaggedOnce,3010,136,4,0,4,100.0%,21m
15335,3,Deathpierce,3010,145,4,0,4,100.0%,2h
15335,1,[ARGENT]Khamus,3010,108,4,4,8,50.0%,34m
15335,2,Escala,3010,58,3,1,4,75.0%,28m
15335,1,Fate,3010,105,2,2,4,50.0%,39m
15335,1,DrDoom,3010,111,2,5,7,28.6%,18m
15335,1,[MBS209]Gzus,3010,74,2,6,8,25.0%,43m
15335,1,[SC2MOO]MSiNO,3010,0,0,2,2,0.0%,25m
15355,1,[SANGRE]Ankiseth,3009,1416,78,73,151,51.7%,22m
15355,1,cubical,3009,1680,72,63,135,53.3%,39m
15355,1,knivusa,3009,1314,60,45,105,57.1%,11m
15355,1,Pete,3009,1020,37,33,70,52.9%,31m
15355,2,[CTCiav]MKiller,3009,798,33,23,56,58.9%,11m
15355,1,MANGDOONG,3009,444,22,18,40,55.0%,17m
15355,1,NiceBoulder,3009,385,17,13,30,56.7%,25m
15355,2,METALHAMMER,3009,356,16,3,19,84.2%,35m
15355,3,DaSwarm,3009,335,12,9,21,57.1%,7m
15355,1,[TlTANS]Archangel,3009,239,9,12,21,42.9%,4m
15355,3,kokot,3009,162,8,6,14,57.1%,9m
15355,3,MrDaepa,3009,161,6,5,11,54.5%,1h
15355,1,[tCo9]thor,3009,144,4,6,10,40.0%,3m
15355,2,[DTML]Polyknikes,3009,0,3,2,5,60.0%,4m
15355,1,TheWayfarer,3009,105,2,2,4,50.0%,17m
15355,1,[GGclan]SirChefo,3009,40,2,8,10,20.0%,41m
15355,2,Julio,3009,30,1,1,2,50.0%,33m
15355,2,ZODIAC,3009,32,1,1,2,50.0%,30m
15355,1,KillVector,3009,0,1,3,4,25.0%,10m
15355,1,Sarek,3009,0,0,1,1,0.0%,17m
15355,2,[Mldr]stefanova,3009,0,0,1,1,0.0%,16m
15376,1,[REPORT]Fetor,3008,1437,412,461,873,47.2%,30m
15376,3,DarkxChains,3008,1556,350,329,679,51.5%,34m
15376,3,[BBLINE]MarkMiller,3008,909,111,94,205,54.1%,20m
15376,1,Afourteen,3008,1496,104,105,209,49.8%,13m
15376,1,ChairmanMao,3008,1405,88,79,167,52.7%,18m
15376,1,Alexis,3008,1087,46,33,79,58.2%,33m
15376,1,Offer,3008,555,26,11,37,70.3%,32m
15376,1,Thanatos,3008,641,26,19,45,57.8%,7m
15376,1,Blackmind,3008,633,23,22,45,51.1%,3m
15376,1,Alexander,3008,624,20,22,42,47.6%,32m
15376,1,AnthonioRC,3008,337,18,6,24,75.0%,6m
15376,1,[BoAVN]Legosii,3008,510,18,16,34,52.9%,21m
15376,1,Almarez,3008,406,17,17,34,50.0%,17m
15376,1,[AbcCo]Kaminav,3008,253,11,6,17,64.7%,10m
15376,1,Hesky,3008,208,9,8,17,52.9%,2h
15376,1,Tech,3008,278,9,9,18,50.0%,33m
15376,2,Bowser,3008,166,8,3,11,72.7%,28m
15376,1,TheDj,3008,245,8,6,14,57.1%,9m
15376,2,[TKON]NEL,3008,60,6,2,8,75.0%,22m
15376,3,KONGAR,3008,158,6,18,24,25.0%,24m
15376,2,DawgyDawg,3008,0,3,2,5,60.0%,18m
15376,1,TastyLimes,3008,78,3,4,7,42.9%,31m
15376,1,Priapizm,3008,90,2,1,3,66.7%,41m
15376,1,[SDC13]Staeg,3008,40,2,2,4,50.0%,2m
15376,2,Julius,3008,0,1,0,1,100.0%,13m
15376,2,[T0PK3K]fuzzyBUNNY,3008,0,1,0,1,100.0%,20m
15376,2,[eaea]DProtokiller,3008,0,1,0,1,100.0%,14m
15376,2,Maww,3008,30,1,1,2,50.0%,22m
15376,1,[SMB]zart,3008,38,1,3,4,25.0%,26m
15376,2,[DubDom]LeafyAcorn,3008,0,0,1,1,0.0%,42m
15376,2,[RAND0M]Juxtapolemic,3008,0,0,1,1,0.0%,21m
15407,1,Heist,3007,1716,138,127,265,52.1%,8m
15407,3,Bobbydou,3007,1418,99,78,177,55.9%,16m
15407,1,SelendisOWO,3007,1209,43,42,85,50.6%,2m
15407,1,[Legndr]Bananasplit,3007,627,28,22,50,56.0%,3m
15407,1,Cuchitto,3007,493,21,16,37,56.8%,31m
15407,2,llIIIllIIIll,3007,474,19,15,34,55.9%,35m
15407,1,David,3007,460,18,16,34,52.9%,39m
15407,1,Wongster,3007,377,16,12,28,57.1%,39m
15407,2,[MIRV]Nasax,3007,283,13,5,18,72.2%,31m
15407,2,[ExcIgN]Meigo,3007,316,12,8,20,60.0%,15m
15407,1,Sniper,3007,360,11,10,21,52.4%,45m
15407,2,Atopos,3007,281,10,11,21,47.6%,45m
15407,2,Nakhti,3007,232,9,3,12,75.0%,1h
15407,2,Firywynter,3007,213,9,5,14,64.3%,2h
15407,1,[DOOHS]Artiiistx,3007,336,9,13,22,40.9%,42m
15407,1,starstrucky,3007,0,3,2,5,60.0%,4m
15407,1,kulas,3007,154,3,3,6,50.0%,10m
15407,2,[rPrx]CaptainPiff,3007,94,2,1,3,66.7%,8m
15407,1,[JUGOSH]brianxd,3007,32,2,3,5,40.0%,35m
15407,3,doubledragon,3007,0,1,0,1,100.0%,19m
15407,2,isaactlv,3007,0,1,0,1,100.0%,34m
15407,2,[SCX2]CRIAGarm,3007,30,1,2,3,33.3%,31m
15407,1,unknown,3007,91,1,3,4,25.0%,9m
15407,1,CorgiTerrier,3007,0,0,1,1,0.0%,4m
15431,3,[MMSC]kumaGamer,3006,1570,293,300,593,49.4%,33m
15431,3,serialkiller,3006,1534,127,114,241,52.7%,22m
15431,3,Integrity,3006,1393,74,65,139,53.2%,34m
15431,3,[501sq]BossNoss,3006,878,64,55,119,53.8%,41m
15431,3,BrokenTusk,3006,761,52,60,112,46.4%,21m
15431,2,[dMdC]SuperHella,3006,651,45,43,88,51.1%,20m
15431,2,[BoAVN]ProPK,3006,1023,42,33,75,56.0%,28m
15431,1,Zaklee,3006,711,28,20,48,58.3%,18m
15431,1,[XLNT]bowlpho,3006,640,25,23,48,52.1%,6m
15431,2,Geber,3006,448,17,8,25,68.0%,25m
15431,1,[ALTF04]Mike,3006,452,15,13,28,53.6%,14m
15431,1,Quackers,3006,152,6,7,13,46.2%,43m
15431,2,Riesenlurch,3006,0,4,1,5,80.0%,21m
15431,3,Computer,3006,97,4,3,7,57.1%,44m
15431,1,SADforYOU,3006,48,4,3,7,57.1%,1h
15431,2,battlesquid,3006,0,2,2,4,50.0%,45m
15431,1,[LgnTDS]Ignat,3006,40,2,3,5,40.0%,19m
15431,1,oneshot,3006,68,2,4,6,33.3%,18m
15431,2,lllllllllll,3006,0,1,0,1,100.0%,21m
15431,1,lililililili,3006,48,1,1,2,50.0%,37m
15431,1,bonebreaker,3006,0,1,2,3,33.3%,3m
15431,3,[TechN]Stein,3006,30,1,5,6,16.7%,25m
15431,2,[WrShrK]Koby,3006,0,0,1,1,0.0%,40m
15431,2,feierlaune,3006,0,0,1,1,0.0%,42m
15431,2,jojoispig,3006,0,0,2,2,0.0%,34m
15456,1,Rayken,3005,1522,68,65,133,51.1%,45m
15456,2,Gaia,3005,1106,48,35,83,57.8%,4m
15456,2,[EGiD]Braxton,3005,604,21,20,41,51.2%,12m
15456,3,wzq,3005,364,16,26,42,38.1%,11m
15456,1,MindWalkerX,3005,502,15,19,34,44.1%,5m
15456,2,cplusplus,3005,248,9,7,16,56.2%,45m
15456,1,[unliph]attornikko,3005,289,8,7,15,53.3%,5m
15456,1,Zdebyman,3005,177,6,3,9,66.7%,2h
15456,1,[Macac0]Mayhem,3005,230,6,6,12,50.0%,4m
15456,1,Justitia,3005,196,6,9,15,40.0%,19m
15456,2,ButtRipper,3005,163,4,2,6,66.7%,1h
15456,1,Ghost,3005,148,4,9,13,30.8%,32m
15456,1,FFXIVqueue,3005,0,3,3,6,50.0%,2h
15456,2,[Ikar0s]ComanderNate,3005,32,3,4,7,42.9%,31m
15456,1,[DB420]JDilla,3005,42,3,5,8,37.5%,45m
15456,1,Eternal,3005,80,3,8,11,27.3%,30m
15456,2,KingEmre,3005,68,2,2,4,50.0%,5m
15456,2,eMaL,3005,0,1,0,1,100.0%,45m
15456,2,[GdAT]Legendk,3005,0,1,1,2,50.0%,1h
15456,1,Cabral,3005,89,1,2,3,33.3%,30m
15456,2,[xMCx]DarkenesS,3005,0,0,1,1,0.0%,12m
15456,2,Syphonize,3005,0,0,2,2,0.0%,28m
15456,1,Xepto,3005,0,0,3,3,0.0%,5m
15456,1,NinjaBorn,3005,0,0,3,3,0.0%,33m
15480,3,Geezer,3004,1352,526,511,1037,50.7%,27m
15480,1,sinear,3004,1695,220,210,430,51.2%,13m
15480,1,elfripton,3004,1421,54,49,103,52.4%,9m
15480,3,clockwork,3004,1276,44,60,104,42.3%,25m
15480,1,penguino,3004,787,32,28,60,53.3%,22m
15480,1,arno,3004,556,19,22,41,46.3%,17m
15480,1,PSulich,3004,329,18,19,37,48.6%,2m
15480,3,[UFC]KittyCow,3004,468,17,17,34,50.0%,14m
15480,2,Dokdo,3004,210,9,7,16,56.2%,18m
15480,2,Brickashaw,3004,182,7,6,13,53.8%,15m
15480,1,[FINDEX]MyKill,3004,212,6,5,11,54.5%,2m
15480,2,Kevindevin,3004,162,4,5,9,44.4%,14m
15480,1,[BUTIFL]Daoh,3004,142,4,7,11,36.4%,4m
15480,2,[DRAKE7]FosterGIZMO,3004,66,3,1,4,75.0%,18m
15480,1,AmongYou,3004,0,3,2,5,60.0%,35m
15480,2,bEkAchI,3004,0,1,0,1,100.0%,6m
15480,2,[hxhchi]TAUTOS,3004,0,1,0,1,100.0%,40m
15480,2,Ratatouille,3004,0,1,0,1,100.0%,21m
15480,1,IIIIIIIIII,3004,48,1,7,8,12.5%,30m
15480,2,[NOOBMS]JasonTodd,3004,0,0,1,1,0.0%,39m
15480,2,[INextI]sirlorddavid,3004,0,0,1,1,0.0%,25m
15480,2,tomthetrader,3004,0,0,2,2,0.0%,14m
15502,3,Diggidy,3003,1419,184,163,347,53.0%,13m
15502,3,realone,3003,906,142,125,267,53.2%,22m
15502,3,[420kil]CoronaVirus,3003,1605,90,115,205,43.9%,19m
15502,2,ASAPDuBz,3003,1015,72,68,140,51.4%,17m
15502,3,[Snooot]meRhNa,3003,929,72,74,146,49.3%,27m
15502,1,Idolsenpai,3003,942,43,49,92,46.7%,23m
15502,1,[Cactus]asillie,3003,840,34,25,59,57.6%,42m
15502,2,[DEoC]CkOwnage,3003,770,30,21,51,58.8%,19m
15502,2,nimu,3003,378,30,23,53,56.6%,19m
15502,1,Revanite,3003,710,29,20,49,59.2%,9m
15502,1,Xerxes,3003,461,26,21,47,55.3%,44m
15502,2,BattlePants,3003,445,19,13,32,59.4%,16m
15502,1,[GBW]Blackmind,3003,556,16,21,37,43.2%,35m
15502,1,Hellteck,3003,334,15,19,34,44.1%,45m
15502,2,BCxNightmare,3003,204,7,4,11,63.6%,45m
15502,3,Marian,3003,150,5,7,12,41.7%,39m
15502,1,[ZTempz]squealer,3003,0,4,1,5,80.0%,2h
15502,1,PussiDstryer,3003,89,4,8,12,33.3%,34m
15502,1,Parthax,3003,140,4,9,13,30.8%,19m
15502,2,fisioterapi,3003,58,3,0,3,100.0%,10m
15502,2,GalaxyBrain,3003,106,3,2,5,60.0%,2m
15502,2,Venom,3003,126,3,5,8,37.5%,13m
15502,2,Vance,3003,36,2,1,3,66.7%,25m
15502,3,Buffer,3003,120,2,1,3,66.7%,8m
15502,2,[CaXaSc]DESTRUCT,3003,0,1,1,2,50.0%,22m
15527,1,SittingDuck,3002,1714,217,208,425,51.1%,42m
15527,2,[XDRAX8]Krocodilo,3002,1056,41,34,75,54.7%,21m
15527,1,[TXOP]Milo,3002,929,38,31,69,55.1%,30m
15527,1,HanDSomeP,3002,677,35,40,75,46.7%,11m
15527,3,[beef69]Chodemuffin,3002,534,23,18,41,56.1%,39m
15527,1,[ICBA]Alienrobot,3002,627,23,19,42,54.8%,31m
15527,3,AsTlas,3002,487,20,18,38,52.6%,32m
15527,1,Piertxo,3002,385,19,14,33,57.6%,20m
15527,3,[TgAg]SyNeRgY,3002,428,16,23,39,41.0%,13m
15527,2,ElRichiRicon,3002,358,13,9,22,59.1%,11m
15527,1,Noobtoss,3002,251,7,6,13,53.8%,22m
15527,1,[MSet]tomzZor,3002,226,7,9,16,43.8%,17m
15527,1,YellowBanana,3002,66,5,4,9,55.6%,10m
15527,1,[VALHL]GopherChucks,3002,48,4,2,6,66.7%,33m
15527,2,BattleToad,3002,0,3,2,5,60.0%,21m
15527,2,DeadMemes,3002,30,2,1,3,66.7%,28m
15527,2,socksoff,3002,0,1,0,1,100.0%,28m
15527,2,smOkInGPriMe,3002,0,1,1,2,50.0%,38m
15527,2,Mozart,3002,30,1,1,2,50.0%,15m
15527,1,[aIMIa]Cebuano,3002,93,1,4,5,20.0%,41m
15527,2,iZergYou,3002,0,1,4,5,20.0%,45m
15527,1,Crickanos,3002,42,1,9,10,10.0%,42m
15527,2,CaptainKelly,3002,0,0,1,1,0.0%,18m
15527,1,[61]mrpolk,3002,0,0,4,4,0.0%,42m
15551,3,[PAWPAT]RealNoFake,3001,1506,122,101,223,54.7%,32m
15551,1,pygmygeneral,3001,1708,120,120,240,50.0%,25m
15551,3,[ZTempz]Psyvv,3001,874,87,79,166,52.4%,4m
15551,2,Ares,3001,536,60,38,98,61.2%,17m
15551,2,AceAceAceAce,3001,805,44,33,77,57.1%,24m
15551,1,joinDSAbro,3001,174,43,33,76,56.6%,35m
15551,2,BrIGht,3001,633,33,21,54,61.1%,15m
15551,1,Inneluki,3001,677,32,26,58,55.2%,13m
15551,1,[Taller]TMOE,3001,994,32,35,67,47.8%,21m
15551,3,profire,3001,774,27,34,61,44.3%,23m
15551,1,Necrid,3001,395,16,12,28,57.1%,32m
15551,1,Preston,3001,352,14,11,25,56.0%,6m
15551,1,FrankyJr,3001,274,10,7,17,58.8%,4m
15551,2,[GTnLB]Enderson,3001,214,7,8,15,46.7%,20m
15551,1,TwoDblDbls,3001,175,6,5,11,54.5%,35m
15551,2,Unforgivable,3001,191,5,4,9,55.6%,13m
15551,1,[lMathl]Blue,3001,223,5,7,12,41.7%,14m
15551,2,[420]PuNK,3001,34,2,0,2,100.0%,25m
15551,1,garrosh,3001,0,2,3,5,40.0%,2h
15551,1,[TMFraC]Jabbypappy,3001,42,2,3,5,40.0%,4m
15551,2,llllllllllll,3001,58,2,6,8,25.0%,21m
15551,2,[YGD]MerfolK,3001,0,1,0,1,100.0%,8m
15551,1,[Axioms]Praxedis,3001,0,1,1,2,50.0%,18m
15551,2,[iDrunk]Terminator,3001,30,1,1,2,50.0%,45m
15551,3,Wavycakes,3001,0,1,2,3,33.3%,20m
15551,1,commanderLC,3001,0,0,2,2,0.0%,2h
15551,1,Earthwolf,3001,0,0,3,3,0.0%,21m
15578,3,Fortified,3000,1482,361,361,722,50.0%,27m
15578,3,emjaypeepee,3000,1512,178,154,332,53.6%,33m
15578,1,Raven,3000,1571,154,156,310,49.7%,2m
15578,1,Cashicoi,3000,1622,90,85,175,51.4%,27m
15578,2,DuMa,3000,779,34,20,54,63.0%,21m
15578,1,Golem,3000,404,19,15,34,55.9%,32m
15578,3,JseusChicken,3000,472,19,18,37,51.4%,24m
15578,1,[EzWinn]NoobSAUCE,3000,522,16,15,31,51.6%,9m
15578,1,ThatGuy,3000,288,9,7,16,56.2%,20m
15578,2,[DEANIM]ZeroTheHero,3000,174,7,4,11,63.6%,19m
15578,1,[IAku]Squiggly,3000,281,7,13,20,35.0%,13m
15578,2,Dora,3000,140,6,2,8,75.0%,26m
15578,1,Rikiya,3000,97,4,2,6,66.7%,2h
15578,3,RiverFlows,3000,97,4,3,7,57.1%,22m
15578,2,Freedom,3000,0,3,2,5,60.0%,31m
15578,3,MacroFree,3000,42,2,0,2,100.0%,1h
15578,3,RandomName,3000,44,2,2,4,50.0%,2h
15578,3,llllllllllll,3000,0,2,5,7,28.6%,2h
15578,2,[F33D]MOSTKILL,3000,0,1,0,1,100.0%,3m
15578,2,herculito,3000,0,1,0,1,100.0%,9m
15578,2,iAdroit,3000,30,1,1,2,50.0%,12m
15578,2,Brotoss,3000,0,0,2,2,0.0%,22m
15578,2,BigZ,3000,0,0,2,2,0.0%,4m
15578,3,Zudapiggy,3000,0,0,3,3,0.0%,1h
15602,3,Kaz,2999,1355,70,78,148,47.3%,16m
15602,1,[UFIS]CodeRed,2999,827,67,65,132,50.8%,44m
15602,1,Solar,2999,1087,54,50,104,51.9%,17m
15602,2,Lsaddler,2999,1076,41,35,76,53.9%,24m
15602,1,[ScScUr]Donald,2999,769,30,20,50,60.0%,16m
15602,1,Kini,2999,424,25,4,29,86.2%,18m
15602,2,GunR,2999,618,24,21,45,53.3%,25m
15602,2,[Arcus]Kvothe,2999,458,18,11,29,62.1%,20m
15602,3,MrPerfect,2999,321,14,9,23,60.9%,7m
15602,2,TomboLover,2999,332,12,8,20,60.0%,24m
15602,1,Vagabondyjx,2999,290,12,8,20,60.0%,17m
15602,2,Dabiuteef,2999,112,6,1,7,85.7%,44m
15602,2,lechiang,2999,112,6,2,8,75.0%,28m
15602,1,RedBeard,2999,204,6,6,12,50.0%,2h
15602,2,SgtSeastand,2999,174,6,7,13,46.2%,43m
15602,2,Privitna,2999,112,5,2,7,71.4%,45m
15602,1,SauceyRo,2999,174,5,8,13,38.5%,6m
15602,1,MCRide,2999,0,3,2,5,60.0%,2h
15602,2,[FeverC]TeaLo,2999,0,3,2,5,60.0%,42m
15602,1,Maximus,2999,0,3,2,5,60.0%,19m
15602,1,Fury,2999,74,3,5,8,37.5%,5m
15602,1,webo,2999,108,3,6,9,33.3%,39m
15602,2,[BBBTC]MarineKondo,2999,99,2,1,3,66.7%,34m
15602,2,[EGx]SuperSonic,2999,32,1,1,2,50.0%,31m
15602,1,[EzyPzY]Darkness,2999,0,0,1,1,0.0%,2h
15627,1,TuPapi,2998,1562,112,111,223,50.2%,16m
15627,1,StaticMoment,2998,1110,67,63,130,51.5%,20m
15627,1,[DASUL]Nibek,2998,1333,56,54,110,50.9%,21m
15627,2,Roku,2998,740,55,42,97,56.7%,33m
15627,1,blindfolded,2998,1241,50,41,91,54.9%,30m
15627,1,[eX]EFFECT,2998,1363,49,46,95,51.6%,33m
15627,2,Magno,2998,631,41,37,78,52.6%,6m
15627,1,ERICBITEBACK,2998,854,34,29,63,54.0%,9m
15627,2,[XTACe]WeAreGods,2998,713,29,23,52,55.8%,34m
15627,2,[AGRUM]IIIIIIIIIIII,2998,441,26,27,53,49.1%,44m
15627,1,bigbozzz,2998,250,20,16,36,55.6%,20m
15627,1,[3eve]jslocum,2998,473,17,15,32,53.1%,30m
15627,2,Sidhwen,2998,430,16,9,25,64.0%,6m
15627,1,[InDoGa]BakBak,2998,204,15,6,21,71.4%,13m
15627,1,Polar,2998,218,6,9,15,40.0%,31m
15627,2,[boomyo]PerplexedLZY,2998,94,4,0,4,100.0%,1h
15627,3,OkaComp,2998,0,4,2,6,66.7%,1h
15627,1,[anggg]RoKal,2998,116,4,6,10,40.0%,30m
15627,1,Skull,2998,102,3,2,5,60.0%,33m
15627,2,[4K4K4K]telaenbanano,2998,60,2,1,3,66.7%,30m
15627,2,Tragedijus,2998,0,1,0,1,100.0%,34m
15627,2,FURY,2998,0,1,0,1,100.0%,26m
15627,2,HappyHour,2998,0,1,0,1,100.0%,45m
15627,2,Raven,2998,0,1,0,1,100.0%,30m
15627,2,Barbi,2998,30,1,1,2,50.0%,24m
15627,2,IIIIIIIIIIII,2998,0,0,1,1,0.0%,34m
15627,2,LloydAurion,2998,0,0,2,2,0.0%,2h
15627,2,ChicoBento,2998,0,0,2,2,0.0%,43m
15655,3,sdqpds,2997,834,198,180,378,52.4%,45m
15655,1,Ortegius,2997,1637,194,175,369,52.6%,30m
15655,2,[cx4]Blank,2997,770,138,107,245,56.3%,45m
15655,1,Lavaa,2997,1432,122,95,217,56.2%,41m
15655,1,Jumelson,2997,1122,103,87,190,54.2%,40m
15655,1,[AbcCo]FleshMan,2997,986,77,74,151,51.0%,30m
15655,3,Rascal,2997,458,74,61,135,54.8%,5m
15655,2,[d0ngs]InitialR,2997,1021,46,31,77,59.7%,28m
15655,1,GranBajoPode,2997,1146,40,42,82,48.8%,3m
15655,1,Mrevub,2997,918,30,34,64,46.9%,6m
15655,2,[cl0udM]KindOf,2997,697,28,19,47,59.6%,30m
15655,3,[EIyM]BNLightened,2997,724,25,29,54,46.3%,41m
15655,2,Setz,2997,586,24,14,38,63.2%,16m
15655,1,WaquaPictdom,2997,523,24,18,42,57.1%,44m
15655,3,[gromp]Ragnarokette,2997,566,19,25,44,43.2%,3m
15655,1,[WNTRGG]Kaotik,2997,416,13,18,31,41.9%,45m
15655,1,Mango,2997,220,8,10,18,44.4%,2h
15655,1,ONEEEPUNCHHH,2997,152,7,5,12,58.3%,23m
15655,3,UleakRed,2997,191,5,5,10,50.0%,30m
15655,2,Wintergrasp,2997,116,4,2,6,66.7%,41m
15655,2,[Kaii]zeronui,2997,118,4,4,8,50.0%,13m
15655,3,[ROYALz]mrjakk,2997,60,3,11,14,21.4%,17m
15655,1,exama,2997,38,1,4,5,20.0%,4m
15655,2,[Kaii]Yaguar,2997,0,0,1,1,0.0%,34m
15655,2,oPAPABEARo,2997,0,0,1,1,0.0%,24m
15680,1,SUNTZU,2996,1712,267,246,513,52.0%,23m
15680,3,coreanotico,2996,1571,210,207,417,50.4%,28m
15680,3,SlyDog,2996,1171,150,132,282,53.2%,10m
15680,3,liu,2996,1300,98,92,190,51.6%,16m
15680,1,Immunoglobin,2996,868,45,36,81,55.6%,18m
15680,1,Lobo,2996,484,17,16,33,51.5%,17m
15680,1,HellscreaM,2996,449,16,13,29,55.2%,11m
15680,3,SquishySquid,2996,339,13,9,22,59.1%,24m
15680,2,[ExcIgN]InsertText,2996,220,9,4,13,69.2%,10m
15680,1,BlueTerran,2996,252,9,11,20,45.0%,17m
15680,2,Espoir,2996,0,3,2,5,60.0%,18m
15680,2,william,2996,30,2,1,3,66.7%,34m
15680,2,TheBozozo,2996,58,2,2,4,50.0%,30m
15680,2,kng,2996,0,1,0,1,100.0%,18m
15680,2,[MHWI]pelalex,2996,0,1,0,1,100.0%,5m
15680,2,dorxter,2996,0,1,0,1,100.0%,39m
15680,1,Crescenzo,2996,89,1,3,4,25.0%,32m
15680,1,Lyk,2996,38,1,5,6,16.7%,9m
15680,2,[UpeV]elwither,2996,0,0,1,1,0.0%,2h
15680,2,Leozin,2996,0,0,1,1,0.0%,6m
15680,2,TinLeague,2996,0,0,2,2,0.0%,42m
15680,1,Icarus,2996,0,0,7,7,0.0%,25m
15702,1,SHARpsHOOT,2995,1265,49,42,91,53.8%,30m
15702,1,Scharf,2995,1106,42,37,79,53.2%,30m
15702,1,Nexus,2995,944,37,34,71,52.1%,32m
15702,2,ricjamesbtch,2995,554,21,17,38,55.3%,29m
15702,1,SgtTennessee,2995,466,15,14,29,51.7%,35m
15702,3,[MoreGG]KateWissen,2995,246,9,18,27,33.3%,14m
15702,2,[Fir3s]BRIGHT,2995,226,8,5,13,61.5%,25m
15702,2,Borna,2995,241,8,8,16,50.0%,14m
15702,1,Warthog,2995,204,6,4,10,60.0%,13m
15702,1,Piao,2995,218,6,8,14,42.9%,40m
15702,1,jose,2995,168,5,9,14,35.7%,17m
15702,2,Oofsmoofs,2995,30,4,3,7,57.1%,5m
15702,1,Goku,2995,0,3,2,5,60.0%,37m
15702,2,[FkEUKS]Roule,2995,0,3,2,5,60.0%,21m
15702,2,Asmodeus,2995,60,3,2,5,60.0%,11m
15702,2,Unusual,2995,30,2,0,2,100.0%,12m
15702,2,[TPGGXD]drko,2995,62,2,2,4,50.0%,17m
15702,1,CoR,2995,88,1,2,3,33.3%,45m
15702,2,[Lepraa]JHOSS,2995,36,1,2,3,33.3%,11m
15702,2,[DSGoku]JovietUnion,2995,32,1,3,4,25.0%,11m
15702,2,normanjr,2995,0,0,1,1,0.0%,5m
15702,1,[DRKNS]LucaDeSupply,2995,0,0,1,1,0.0%,2h
15702,2,[CORON4]vIrUS,2995,0,0,1,1,0.0%,4m
15702,2,Puqui,2995,0,0,1,1,0.0%,13m
15702,2,TheBlackOne,2995,0,0,1,1,0.0%,34m
15727,2,Pacox,2994,1336,123,106,229,53.7%,34m
15727,1,Paragas,2994,1601,105,80,185,56.8%,33m
15727,2,jWizzle,2994,1152,51,41,92,55.4%,29m
15727,1,gnil,2994,1060,46,33,79,58.2%,3m
15727,2,Zeracile,2994,384,28,21,49,57.1%,17m
15727,2,[Kixeye]Bensg,2994,572,24,11,35,68.6%,16m
15727,1,[EMP451]Winter,2994,338,22,22,44,50.0%,31m
15727,2,Cyrex,2994,486,18,13,31,58.1%,34m
15727,1,YodaSlim,2994,469,17,14,31,54.8%,21m
15727,2,Leoooo,2994,398,14,14,28,50.0%,13m
15727,1,Bleak,2994,498,14,19,33,42.4%,33m
15727,2,Chateaux,2994,316,13,12,25,52.0%,45m
15727,3,[HODE]xploD,2994,261,11,11,22,50.0%,41m
15727,1,[RAMorz]LargeCharles,2994,304,10,4,14,71.4%,1h
15727,2,Quackadoolde,2994,118,6,3,9,66.7%,2h
15727,2,Psiyan,2994,119,6,4,10,60.0%,44m
15727,1,lGoDaRkMaNll,2994,157,6,5,11,54.5%,30m
15727,3,Avatarmike,2994,168,5,1,6,83.3%,8m
15727,2,Erik,2994,126,5,4,9,55.6%,16m
15727,2,[D5FTWA]AaronAA,2994,90,4,1,5,80.0%,17m
15727,2,VotePlease,2994,160,4,2,6,66.7%,24m
15727,3,Jusssig,2994,96,3,11,14,21.4%,3m
15727,2,Geanthor,2994,0,2,3,5,40.0%,22m
15727,2,ZenZen,2994,0,1,1,2,50.0%,16m
15727,2,[Hidden]FRame,2994,0,1,1,2,50.0%,34m
15727,3,bringdead,2994,97,1,2,3,33.3%,21m
15753,3,Chuqui,2993,1362,221,198,419,52.7%,30m
15753,3,Masa,2993,1535,105,93,198,53.0%,32m
15753,3,[NA7]Thatch,2993,207,64,77,141,45.4%,15m
15753,1,Neaplo,2993,1464,56,54,110,50.9%,33m
15753,1,[Exist]DroneRush,2993,927,35,25,60,58.3%,42m
15753,1,fatdodobird,2993,686,34,16,50,68.0%,19m
15753,3,[Macac0]Conker,2993,313,14,20,34,41.2%,20m
15753,2,[lAmMe]BOOTYSHAKIN,2993,226,10,6,16,62.5%,5m
15753,1,lifeforaiur,2993,224,10,11,21,47.6%,23m
15753,2,BigTone,2993,91,9,7,16,56.2%,16m
15753,1,HiLoser,2993,280,8,13,21,38.1%,18m
15753,2,[TheOST]Goblin,2993,168,6,5,11,54.5%,10m
15753,1,xYoungjedixx,2993,0,4,1,5,80.0%,2h
15753,1,CyberViking,2993,0,4,1,5,80.0%,1h
15753,1,[FU2]TheFatOne,2993,141,4,3,7,57.1%,22m
15753,2,[KiMBR]SaBReron,2993,0,3,2,5,60.0%,42m
15753,2,[Hngr18]WrathOfCain,2993,60,3,2,5,60.0%,12m
15753,2,[AMFT]BluePenguin,2993,0,3,2,5,60.0%,34m
15753,2,[UpxV]Drezz,2993,62,3,2,5,60.0%,10m
15753,1,MajorSeventh,2993,95,2,3,5,40.0%,2h
15753,2,[10Scop]Midget,2993,88,2,4,6,33.3%,2h
15753,2,[SCFun]SiM,2993,0,1,0,1,100.0%,19m
15775,3,AronDaUser,2992,1492,542,502,1044,51.9%,30m
15775,1,goose,2992,1558,103,87,190,54.2%,30m
15775,2,[MABOY]Bora,2992,1346,74,41,115,64.3%,22m
15775,2,BaZinga,2992,548,23,18,41,56.1%,28m
15775,1,[Unfad]Demise,2992,604,23,20,43,53.5%,35m
15775,1,[PoLC]FoRFuN,2992,345,15,11,26,57.7%,44m
15775,1,[LiViN]iRage,2992,484,14,18,32,43.8%,12m
15775,1,[ShoT]SendauTPeru,2992,314,13,13,26,50.0%,42m
15775,3,[dLife]Bardolatry,2992,403,13,21,34,38.2%,3m
15775,1,[KiMBR]Leonardo,2992,384,12,10,22,54.5%,3m
15775,1,samimagoon,2992,280,11,7,18,61.1%,11m
15775,3,[GiLLs]FDSBosox,2992,273,11,11,22,50.0%,23m
15775,1,WiDoWMaKeR,2992,248,9,9,18,50.0%,3m
15775,3,TheRock,2992,218,8,15,23,34.8%,33m
15775,2,[mator]Slayer,2992,169,5,1,6,83.3%,16m
15775,1,Invictus,2992,160,5,3,8,62.5%,2m
15775,2,RanoxSad,2992,139,4,0,4,100.0%,2h
15775,2,Veight,2992,92,4,4,8,50.0%,11m
15775,1,nezash,2992,80,2,5,7,28.6%,34m
15775,1,[delTRN]SwarmyBoi,2992,0,1,2,3,33.3%,12m
15775,1,Lenodz,2992,0,1,2,3,33.3%,2h
15775,2,[papayo]LJAS,2992,0,0,1,1,0.0%,14m
15775,2,[NLTN]Domi,2992,0,0,2,2,0.0%,12m
15798,2,SewerWizard,2991,425,115,93,208,55.3%,11m
15798,3,byfar,2991,449,59,69,128,46.1%,34m
15798,1,ObsidianNine,2991,509,35,36,71,49.3%,44m
15798,2,Barn,2991,706,28,19,47,59.6%,13m
15798,1,[RH]Seth,2991,451,24,19,43,55.8%,13m
15798,2,[ffaaak]iqui,2991,618,22,18,40,55.0%,16m
15798,1,JamesBond,2991,484,20,18,38,52.6%,43m
15798,1,Angelmaker,2991,456,13,18,31,41.9%,4m
15798,2,daFisherman,2991,288,11,10,21,52.4%,35m
15798,1,[TFinal]Lucky,2991,203,10,8,18,55.6%,25m
15798,3,FLEATICK,2991,162,9,6,15,60.0%,14m
15798,2,Drakeor,2991,238,9,8,17,52.9%,31m
15798,2,[NUGT]biloulebilou,2991,88,3,3,6,50.0%,15m
15798,1,Tearhere,2991,90,1,3,4,25.0%,16m
15798,2,dOg,2991,0,0,1,1,0.0%,15m
15798,2,Jenny,2991,0,0,2,2,0.0%,18m
15814,1,BattleSmurf,2990,1693,341,337,678,50.3%,3m
15814,3,FuuriousD,2990,1529,232,222,454,51.1%,32m
15814,3,BlackZeros,2990,743,169,151,320,52.8%,13m
15814,3,[G79]bakemonoken,2990,1562,152,162,314,48.4%,22m
15814,1,ssjchuck,2990,1643,107,96,203,52.7%,24m
15814,3,[turds1]GralBanzer,2990,1364,86,95,181,47.5%,26m
15814,2,Polar,2990,1541,68,54,122,55.7%,4m
15814,1,spaceman,2990,1512,55,54,109,50.5%,35m
15814,1,gustducin,2990,866,47,38,85,55.3%,40m
15814,1,stepie,2990,1154,47,43,90,52.2%,7m
15814,1,[SKyber]ivicaos,2990,309,27,21,48,56.2%,39m
15814,2,[oPu]lCharizardl,2990,451,19,9,28,67.9%,12m
15814,2,Freki,2990,364,15,5,20,75.0%,19m
15814,3,SpYderSam,2990,319,13,7,20,65.0%,33m
15814,3,Aili,2990,212,10,10,20,50.0%,2m
15814,2,[Skwirl]Hamsterdam,2990,246,9,6,15,60.0%,2h
15814,2,LicoPe,2990,222,7,4,11,63.6%,18m
15814,2,Peter,2990,30,6,1,7,85.7%,3m
15814,1,[VPB]FalconX,2990,121,5,7,12,41.7%,2h
15814,1,sincerebnana,2990,154,5,7,12,41.7%,17m
15814,3,[SSPU]solinar,2990,0,4,3,7,57.1%,13m
15814,2,AXELAY,2990,202,4,4,8,50.0%,39m
15814,1,spineforest,2990,120,4,7,11,36.4%,13m
15814,1,Champs,2990,80,3,4,7,42.9%,23m
15814,2,[RaZerz]DeadlyStrike,2990,62,2,2,4,50.0%,12m
15814,1,Baco,2990,74,2,8,10,20.0%,33m
15814,1,[206B]Kaga,2990,0,1,0,1,100.0%,3h
15814,2,SKELEER,2990,0,1,0,1,100.0%,11m
15814,3,Coldferret,2990,0,1,2,3,33.3%,1h
15814,3,Zillo,2990,44,1,3,4,25.0%,21m
15814,1,Naruhito,2990,0,1,3,4,25.0%,45m
15814,2,SugarDaddy,2990,0,0,1,1,0.0%,22m
15814,2,VAPORDizzy,2990,0,0,1,1,0.0%,30m
15814,2,reDLine,2990,0,0,2,2,0.0%,5m
15814,1,dighggh,2990,0,0,3,3,0.0%,30m
15849,3,GizmoDuck,2989,977,140,138,278,50.4%,35m
15849,3,RealDeal,2989,1430,121,132,253,47.8%,16m
15849,1,BeefyZeaLoT,2989,1162,92,83,175,52.6%,30m
15849,2,SyNaps,2989,895,54,31,85,63.5%,19m
15849,2,cloud,2989,510,45,38,83,54.2%,15m
15849,1,Miles,2989,944,39,30,69,56.5%,32m
15849,1,Fingolfin,2989,828,36,35,71,50.7%,32m
15849,1,[WytGrl]SmrtAsianGuy,2989,688,30,29,59,50.8%,32m
15849,1,Peatree,2989,461,26,24,50,52.0%,18m
15849,2,Phalanx,2989,576,25,22,47,53.2%,6m
15849,1,kgadon,2989,311,10,7,17,58.8%,14m
15849,1,YofreBLCK,2989,264,10,8,18,55.6%,11m
15849,1,Roh,2989,242,8,11,19,42.1%,17m
15849,1,[KKandK]Fisknylle,2989,206,7,5,12,58.3%,3m
15849,1,tnispceo,2989,234,6,14,20,30.0%,30m
15849,2,Brailthor,2989,144,5,2,7,71.4%,31m
15849,1,Qiin,2989,62,5,4,9,55.6%,10m
15849,1,HelixOxford,2989,188,5,9,14,35.7%,42m
15849,1,AdultShoes,2989,97,4,2,6,66.7%,2h
15849,1,Ninjam,2989,0,3,2,5,60.0%,1h
15849,2,ScarletYNEZ,2989,88,2,2,4,50.0%,13m
15849,1,RanGOo,2989,0,0,3,3,0.0%,31m
15849,1,[Brober]knowhow,2989,0,0,4,4,0.0%,32m
15872,3,[YD2K]BlaqSasQuach,2988,1519,424,405,829,51.1%,13m
15872,3,ProblemMaker,2988,1163,180,173,353,51.0%,8m
15872,1,Corvelton,2988,1362,55,49,104,52.9%,3m
15872,2,caffice,2988,287,37,24,61,60.7%,18m
15872,1,GrandBahumba,2988,267,32,31,63,50.8%,3m
15872,2,[WNTRGG]Wolf,2988,588,23,14,37,62.2%,17m
15872,2,LaCroix,2988,358,16,12,28,57.1%,35m
15872,2,[2Hott]Daddy,2988,383,14,10,24,58.3%,15m
15872,1,[DarkAG]Red,2988,410,13,17,30,43.3%,11m
15872,1,Polay,2988,264,10,8,18,55.6%,22m
15872,3,[AIAV]yeehaw,2988,241,10,11,21,47.6%,30m
15872,1,skAvatar,2988,0,10,13,23,43.5%,25m
15872,1,smoking,2988,264,8,12,20,40.0%,18m
15872,2,Nefastuss,2988,218,7,2,9,77.8%,34m
15872,1,iSiege,2988,250,7,8,15,46.7%,9m
15872,2,Eliza,2988,96,4,2,6,66.7%,14m
15872,3,Chimo,2988,144,3,5,8,37.5%,25m
15872,1,Dirk,2988,0,1,5,6,16.7%,2h
15872,2,Spacemace,2988,0,0,1,1,0.0%,22m
15872,2,[EZkill]SpaceJanitor,2988,0,0,1,1,0.0%,12m
15872,2,Plutoneus,2988,0,0,1,1,0.0%,4m
15872,2,[B3Pros]ProfEmeritus,2988,0,0,1,1,0.0%,10m
15872,1,kIngpIn,2988,0,0,2,2,0.0%,30m
15872,1,Bdox,2988,0,0,2,2,0.0%,16m
15896,3,CanCauser,2987,1237,224,210,434,51.6%,6m
15896,1,Arbutus,2987,1621,142,125,267,53.2%,32m
15896,1,Kronos,2987,1386,69,58,127,54.3%,30m
15896,1,Sipecor,2987,828,43,25,68,63.2%,26m
15896,1,[DXPCA]KaZiel,2987,519,24,15,39,61.5%,18m
15896,3,[Gouda]Bunsen,2987,441,18,21,39,46.2%,13m
15896,1,[BraziI]Baikal,2987,170,14,3,17,82.4%,23m
15896,3,DEATH,2987,132,12,17,29,41.4%,4m
15896,1,[TY4GG]Dominator,2987,388,11,17,28,39.3%,32m
15896,1,[anti5z]Angelous,2987,316,9,13,22,40.9%,41m
15896,2,cemt,2987,174,6,5,11,54.5%,24m
15896,1,llllllllllll,2987,0,4,1,5,80.0%,3h
15896,2,[icCCce]InfernoForce,2987,0,0,1,1,0.0%,19m
15896,2,CannonRusher,2987,0,0,1,1,0.0%,12m
15910,3,Popin,2986,1531,424,415,839,50.5%,8m
15910,1,HiChiefQuaz,2986,1598,187,184,371,50.4%,21m
15910,1,Tony,2986,845,40,36,76,52.6%,27m
15910,2,otterpop,2986,318,28,24,52,53.8%,19m
15910,1,[EMAT]TAME,2986,671,27,23,50,54.0%,23m
15910,3,meaningless,2986,612,25,33,58,43.1%,44m
15910,2,GoCougs,2986,401,23,10,33,69.7%,22m
15910,3,bubiuNet,2986,514,23,27,50,46.0%,22m
15910,2,Classic,2986,490,20,15,35,57.1%,17m
15910,2,Tommy,2986,326,12,5,17,70.6%,3m
15910,2,[SQWRTL]Nomrom,2986,252,12,8,20,60.0%,6m
15910,1,snake,2986,238,11,5,16,68.8%,19m
15910,2,[TSMGG]leadingTone,2986,276,10,7,17,58.8%,2h
15910,1,Forkey,2986,279,9,7,16,56.2%,8m
15910,1,GilbertSicot,2986,269,8,14,22,36.4%,27m
15910,3,Snuggle,2986,86,7,8,15,46.7%,43m
15910,1,Pwrhouse,2986,112,4,5,9,44.4%,11m
15910,1,Galaxy,2986,71,4,7,11,36.4%,34m
15910,1,wewe,2986,153,4,7,11,36.4%,5m
15910,2,Player,2986,0,3,2,5,60.0%,43m
15910,2,PvP,2986,0,3,2,5,60.0%,27m
15910,2,JCS,2986,0,3,2,5,60.0%,5m
15910,3,Gorpse,2986,97,2,6,8,25.0%,14m
15910,2,JoelFromIowa,2986,0,1,0,1,100.0%,42m
15910,2,TimeMaster,2986,0,1,0,1,100.0%,22m
15910,2,[nOpeeP]Veranis,2986,0,1,1,2,50.0%,18m
15910,2,[FxB]DJCylon,2986,0,1,4,5,20.0%,34m
15910,2,CootsMalone,2986,0,0,1,1,0.0%,29m
15938,1,BrenHawk,2985,1360,135,126,261,51.7%,3m
15938,1,IkutoHyuga,2985,1674,112,110,222,50.5%,4m
15938,3,Mark,2985,823,99,92,191,51.8%,23m
15938,2,[FyHr]ShadyStyle,2985,1444,67,58,125,53.6%,12m
15938,1,[ScSwrm]JaXoN,2985,1460,65,46,111,58.6%,41m
15938,2,shinaldo,2985,1120,61,51,112,54.5%,16m
15938,1,[Ricky]MrThePlague,2985,525,39,28,67,58.2%,7m
15938,3,FaddyJosh,2985,480,20,15,35,57.1%,26m
15938,2,[Zesttt]JustPlayLike,2985,478,19,12,31,61.3%,11m
15938,1,monkey,2985,449,18,14,32,56.2%,19m
15938,2,capslocking,2985,307,11,7,18,61.1%,31m
15938,1,[ZGZGZG]ultralisc,2985,327,11,8,19,57.9%,19m
15938,1,ABIMAEL,2985,290,10,11,21,47.6%,30m
15938,3,ricecube,2985,102,8,24,32,25.0%,23m
15938,2,[TeamNH]ItsASecretSF,2985,230,7,4,11,63.6%,26m
15938,1,ClydeDaPanda,2985,0,3,2,5,60.0%,30m
15938,2,lowtone,2985,90,3,3,6,50.0%,22m
15938,1,Snail,2985,46,2,2,4,50.0%,2h
15938,2,[SCch]Blunk,2985,0,1,0,1,100.0%,19m
15938,2,[BSNK]Ciryusken,2985,0,1,0,1,100.0%,34m
15938,2,[bfBE]GEN,2985,0,1,0,1,100.0%,13m
15938,2,RedBeard,2985,0,1,1,2,50.0%,25m
15938,2,PrimalOoze,2985,32,1,1,2,50.0%,33m
15938,2,[ATEJI]Karlmaov,2985,0,0,1,1,0.0%,24m
15938,2,BiGSchleiN,2985,0,0,3,3,0.0%,6m
15938,1,TeKniQ,2985,0,0,3,3,0.0%,28m
15964,3,Whoobor,2984,692,302,282,584,51.7%,19m
15964,2,GhostRider,2984,1612,135,122,257,52.5%,24m
15964,1,Zeint,2984,1620,89,81,170,52.4%,40m
15964,2,Kingsmile,2984,1492,84,71,155,54.2%,43m
15964,2,GregeN,2984,1192,58,28,86,67.4%,45m
15964,3,brotoss,2984,990,56,56,112,50.0%,5m
15964,1,[AbcCo]papibatman,2984,1113,47,37,84,56.0%,17m
15964,3,[GTWITM]MrKwan,2984,872,31,43,74,41.9%,29m
15964,3,Asherbanipal,2984,423,18,15,33,54.5%,43m
15964,1,[Nia2u]Interference,2984,352,18,30,48,37.5%,40m
15964,2,Shroud,2984,277,11,7,18,61.1%,30m
15964,2,Guardian,2984,200,8,6,14,57.1%,29m
15964,2,[ValidG]PoisonTrail,2984,170,7,2,9,77.8%,29m
15964,1,Modra,2984,178,7,6,13,53.8%,9m
15964,2,[R3K]LiuBei,2984,0,4,1,5,80.0%,5m
15964,2,Theseuss,2984,152,4,3,7,57.1%,25m
15964,2,Artanis,2984,0,3,2,5,60.0%,3m
15964,1,TeddyG,2984,0,3,2,5,60.0%,36m
15964,2,skfksmsrhlaf,2984,0,3,2,5,60.0%,4m
15964,1,GhostMJM,2984,38,2,3,5,40.0%,9m
15964,3,[McFIy]CharlieDangr,2984,60,2,12,14,14.3%,31m
15964,2,Jacob,2984,0,1,0,1,100.0%,24m
15964,1,Lock,2984,0,1,2,3,33.3%,32m
15964,2,[GUERHT]Josh,2984,0,0,1,1,0.0%,35m
15988,3,FemurHarvest,2983,1433,270,238,508,53.1%,13m
15988,2,valeragf,2983,1516,246,229,475,51.8%,24m
15988,3,Zest,2983,1583,186,177,363,51.2%,13m
15988,3,MaurICE,2983,1480,143,132,275,52.0%,14m
15988,1,[UofC]Maladroit,2983,1605,82,66,148,55.4%,20m
15988,3,KTrooper,2983,1342,81,62,143,56.6%,18m
15988,1,UntouchableJ,2983,1192,76,70,146,52.1%,22m
15988,1,NotoriousBLT,2983,923,42,41,83,50.6%,22m
15988,1,[Jerkz]freshkeeper,2983,910,36,30,66,54.5%,45m
15988,1,[sk3tch]MegaDancerZF,2983,795,33,28,61,54.1%,23m
15988,1,[INXS]Juunt,2983,461,19,16,35,54.3%,20m
15988,2,Jawmare,2983,411,16,16,32,50.0%,13m
15988,1,armada,2983,397,14,17,31,45.2%,23m
15988,2,modcrac,2983,316,13,13,26,50.0%,9m
15988,1,[Lepraa]JCharles,2983,346,12,12,24,50.0%,41m
15988,2,[eTc]Voodoo,2983,238,9,2,11,81.8%,42m
15988,2,Playsumgames,2983,178,7,5,12,58.3%,2m
15988,2,[DoRQ]TheLordGersh,2983,202,7,6,13,53.8%,27m
15988,2,Omgilyuwu,2983,186,6,1,7,85.7%,10m
15988,3,HobbyNerd,2983,153,6,5,11,54.5%,12m
15988,3,zeeds,2983,224,6,14,20,30.0%,22m
15988,3,Jerb,2983,121,5,4,9,55.6%,24m
15988,1,BigDaddy,2983,182,5,10,15,33.3%,23m
15988,1,[AXIOS]TeRRoR,2983,164,4,4,8,50.0%,14m
15988,1,Akkaidian,2983,0,2,1,3,66.7%,1h
15988,2,BluRay,2983,30,2,3,5,40.0%,25m
15988,2,monkaS,2983,0,1,0,1,100.0%,29m
15988,1,[ToHoG]warbullet,2983,0,1,0,1,100.0%,2h
15988,2,[IGWT]TheIsraelite,2983,32,1,2,3,33.3%,15m
15988,2,[PHAN]Phantom,2983,30,1,2,3,33.3%,24m
15988,2,[TYNXT]DoubleCat,2983,32,1,3,4,25.0%,22m
15988,2,mavrick,2983,0,0,1,1,0.0%,4m
15988,2,[zxczx]Remdeex,2983,0,0,1,1,0.0%,42m
16021,1,VaroClaw,2982,495,32,32,64,50.0%,5m
16021,3,NeXTLoop,2982,625,31,29,60,51.7%,32m
16021,3,special,2982,264,21,27,48,43.8%,45m
16021,2,Sparky,2982,402,14,14,28,50.0%,15m
16021,1,TroUble,2982,296,11,8,19,57.9%,19m
16021,1,[inHell]TheSirFM,2982,318,10,12,22,45.5%,13m
16021,2,[SLan]BlueSteel,2982,220,8,2,10,80.0%,27m
16021,1,BoGrIM,2982,289,8,8,16,50.0%,19m
16021,1,[JSLs]MengNanZionL,2982,176,7,5,12,58.3%,30m
16021,2,DinoScience,2982,198,7,5,12,58.3%,11m
16021,1,[REPORT]VeRvE,2982,121,5,2,7,71.4%,1h
16021,2,SFlame,2982,46,5,5,10,50.0%,2h
16021,3,[Bozi]Concise,2982,121,4,3,7,57.1%,2h
16021,1,ETERNY,2982,95,2,1,3,66.7%,10m
16021,2,Varimatas,2982,30,2,1,3,66.7%,16m
16021,1,Pangolin,2982,90,2,3,5,40.0%,17m
16021,2,Exarch,2982,60,2,3,5,40.0%,11m
16021,2,[Exper]Monu,2982,0,1,2,3,33.3%,2h
16021,1,llllllllllll,2982,32,1,4,5,20.0%,5m
16021,2,Bahram,2982,0,0,1,1,0.0%,30m
16021,2,keno,2982,0,0,1,1,0.0%,12m
16021,2,Neuromancer,2982,0,0,1,1,0.0%,8m
16021,1,Maximilion,2982,0,0,4,4,0.0%,42m
16044,1,llllllllllll,2981,1664,150,146,296,50.7%,45m
16044,1,Skepticism,2981,1671,97,90,187,51.9%,33m
16044,1,[qTr]macross,2981,1564,90,78,168,53.6%,4m
16044,1,MrBossPimp,2981,1580,76,76,152,50.0%,29m
16044,1,Dohhhnuts,2981,1261,54,46,100,54.0%,24m
16044,3,Nooge,2981,374,50,53,103,48.5%,3m
16044,2,Gabito,2981,554,24,11,35,68.6%,27m
16044,1,[10cm]Gunnar,2981,559,22,19,41,53.7%,17m
16044,1,[TPC]Brahm,2981,561,19,20,39,48.7%,16m
16044,3,Prierg,2981,255,13,10,23,56.5%,35m
16044,2,xray,2981,250,10,7,17,58.8%,6m
16044,1,finkinboutU,2981,210,8,5,13,61.5%,5m
16044,1,[DxP]MAPOCHO,2981,229,7,14,21,33.3%,39m
16044,3,onlynukes,2981,121,4,5,9,44.4%,2h
16044,3,[DHZ0ne]matcos,2981,58,4,8,12,33.3%,26m
16044,2,Prometheus,2981,30,3,2,5,60.0%,20m
16044,2,[FLU5H]ArchonToilet,2981,90,3,2,5,60.0%,26m
16044,1,[NVYTE]axtoncommand,2981,0,3,3,6,50.0%,41m
16044,3,[Dist9]XxEvolutionX,2981,96,2,0,2,100.0%,17m
16044,2,Thunderga,2981,30,2,0,2,100.0%,22m
16044,2,Ragnarok,2981,58,2,3,5,40.0%,11m
16044,1,MaxPower,2981,0,1,0,1,100.0%,2h
16044,3,JcOmC,2981,0,1,0,1,100.0%,27m
16044,2,Daptar,2981,0,1,1,2,50.0%,45m
16044,1,Crylog,2981,42,1,6,7,14.3%,20m
16044,2,DarkGhost,2981,0,0,1,1,0.0%,41m
16044,3,jazzneel,2981,0,0,1,1,0.0%,24m
16044,2,YeoSK,2981,0,0,1,1,0.0%,24m
16072,3,IllllIllll,2980,1446,123,114,237,51.9%,45m
16072,3,Ursa,2980,1236,48,47,95,50.5%,30m
16072,1,McSpankyyy,2980,399,29,18,47,61.7%,5m
16072,2,DirgeClades,2980,604,26,18,44,59.1%,14m
16072,1,[GOPERÚ]JorgeMA,2980,684,24,23,47,51.1%,8m
16072,2,[Ditxiz]Ditxiz,2980,298,18,10,28,64.3%,20m
16072,1,Zerglaive,2980,394,16,6,22,72.7%,9m
16072,2,lIlIIIlI,2980,259,11,10,21,52.4%,22m
16072,2,[Ob0]Goco,2980,268,9,7,16,56.2%,7m
16072,1,windowsXP,2980,280,8,8,16,50.0%,26m
16072,3,HellYeahVain,2980,0,5,2,7,71.4%,10m
16072,1,SerralJR,2980,160,5,7,12,41.7%,30m
16072,1,LazyTapir,2980,97,4,2,6,66.7%,3h
16072,2,jnpzc,2980,139,4,3,7,57.1%,1h
16072,1,Ryon,2980,122,4,8,12,33.3%,35m
16072,2,PinPonWea,2980,44,3,8,11,27.3%,6m
16072,1,Invio,2980,0,2,1,3,66.7%,3h
16072,3,Fluoxetine,2980,96,2,2,4,50.0%,17m
16072,2,[KingSC]Nexus,2980,56,2,5,7,28.6%,9m
16072,2,[SAT]Othonsant,2980,0,0,1,1,0.0%,33m
16072,2,Hero,2980,0,0,1,1,0.0%,30m
16072,2,[Tflaps]Oatzor,2980,0,0,2,2,0.0%,34m
16072,2,DeenineZ,2980,0,0,2,2,0.0%,26m
16072,2,SMKmurk,2980,0,0,3,3,0.0%,10m
16096,3,[UpxV]GianSSC,2979,1091,161,150,311,51.8%,23m
16096,2,CerNu,2979,1629,120,100,220,54.5%,30m
16096,1,ximperialx,2979,1648,75,65,140,53.6%,8m
16096,2,[4KILL]ToxicTreta,2979,857,36,27,63,57.1%,30m
16096,2,eEkOoK,2979,526,20,14,34,58.8%,11m
16096,3,RGB,2979,352,15,20,35,42.9%,8m
16096,2,[THICCQ]Coler,2979,238,8,9,17,47.1%,17m
16096,2,[NSTYBO]SBDTooter,2979,141,7,4,11,63.6%,2h
16096,2,[BOvLs]Mac,2979,200,7,6,13,53.8%,25m
16096,2,BronzeProtos,2979,132,7,7,14,50.0%,2h
16096,2,[Ninjas]Buzzkill,2979,86,4,1,5,80.0%,40m
16096,2,Gnomulus,2979,0,4,1,5,80.0%,22m
16096,3,Sarb,2979,0,4,3,7,57.1%,28m
16096,1,WindGain,2979,0,3,2,5,60.0%,13m
16096,1,VxAnime,2979,0,3,3,6,50.0%,2h
16096,3,Alpha,2979,97,2,1,3,66.7%,1h
16096,1,nGsDangerous,2979,0,1,0,1,100.0%,2h
16096,2,susurrador,2979,0,1,0,1,100.0%,13m
16096,2,seriosblack,2979,30,1,1,2,50.0%,17m
16096,2,Zerbi,2979,0,1,1,2,50.0%,24m
16096,2,Renegade,2979,0,0,1,1,0.0%,12m
16096,2,Zero,2979,0,0,1,1,0.0%,6m
16096,2,Reynor,2979,0,0,2,2,0.0%,30m
16119,1,llllllllllll,2978,1696,170,153,323,52.6%,30m
16119,3,[GdAT]Xenolight,2978,1488,125,117,242,51.7%,9m
16119,1,Mew,2978,1601,95,72,167,56.9%,41m
16119,1,Deadlock,2978,928,50,44,94,53.2%,12m
16119,2,Jex,2978,495,40,34,74,54.1%,27m
16119,1,LilPinkyToe,2978,410,37,25,62,59.7%,16m
16119,2,[Sm0kE]KoreanStyle,2978,821,35,26,61,57.4%,42m
16119,1,Ragnarok,2978,650,28,22,50,56.0%,26m
16119,2,Hummus,2978,720,26,22,48,54.2%,41m
16119,1,Bisu,2978,694,21,28,49,42.9%,32m
16119,2,[96661]Centurion,2978,470,18,10,28,64.3%,16m
16119,2,[rEpReS]Lokator,2978,380,16,12,28,57.1%,31m
16119,2,Apeist,2978,272,10,9,19,52.6%,29m
16119,2,[OceanT]Soulzzas,2978,232,9,4,13,69.2%,4m
16119,3,Thethinker,2978,207,8,3,11,72.7%,1h
16119,2,Eulalia,2978,201,8,7,15,53.3%,8m
16119,1,HarambeFrPrz,2978,136,7,6,13,53.8%,2h
16119,2,[SCVM]FlySlendyGG,2978,186,6,1,7,85.7%,29m
16119,3,IlIllllIIIII,2978,62,6,5,11,54.5%,27m
16119,3,Squish,2978,122,5,4,9,55.6%,30m
16119,2,FunkyJeff,2978,148,4,0,4,100.0%,12m
16119,2,[MJSTIC]NiC,2978,0,3,2,5,60.0%,28m
16119,2,[SCVM]slaughter,2978,0,3,2,5,60.0%,28m
16119,2,[BNK48]Spidersense,2978,88,3,2,5,60.0%,14m
16119,2,Magicguy,2978,112,2,1,3,66.7%,16m
16119,2,Farathiel,2978,30,2,1,3,66.7%,34m
16119,2,[MAPLE]ttjf,2978,30,2,2,4,50.0%,14m
16119,2,Skynet,2978,60,2,2,4,50.0%,41m
16119,1,[Pizzy]Sakura,2978,120,2,7,9,22.2%,8m
16119,3,[NEmber]nordicskiah,2978,0,1,0,1,100.0%,24m
16119,2,[1Fenix]MASIVO,2978,0,1,0,1,100.0%,11m
16119,2,[KneBys]ZealotMaster,2978,0,0,1,1,0.0%,23m
16119,2,DMANXIII,2978,0,0,1,1,0.0%,42m
16119,2,SantaClause,2978,0,0,1,1,0.0%,4m
16153,1,JhonDarkness,2977,1670,107,91,198,54.0%,3m
16153,1,CaptainSams,2977,1377,86,66,152,56.6%,41m
16153,3,MAGNETO,2977,1499,68,76,144,47.2%,18m
16153,2,[pepis]ClownGamer,2977,483,28,13,41,68.3%,16m
16153,2,Ariadust,2977,587,24,17,41,58.5%,45m
16153,3,Kirito,2977,278,13,11,24,54.2%,28m
16153,3,korridor,2977,241,11,8,19,57.9%,43m
16153,2,CrucibleFour,2977,318,11,11,22,50.0%,10m
16153,1,PETTER,2977,242,10,6,16,62.5%,4m
16153,3,TheBoxeR,2977,282,10,15,25,40.0%,22m
16153,2,MacroKing,2977,269,8,6,14,57.1%,12m
16153,2,SireLeon,2977,216,8,7,15,53.3%,2h
16153,1,[αXLa]SlaveGael,2977,150,5,2,7,71.4%,11m
16153,2,eNVy,2977,120,5,4,9,55.6%,30m
16153,2,EnverHoxha,2977,172,4,8,12,33.3%,16m
16153,2,lllllll,2977,0,3,2,5,60.0%,35m
16153,1,Chris,2977,0,3,3,6,50.0%,28m
16153,2,[lab317]kaapsingle,2977,30,2,3,5,40.0%,14m
16153,2,cannonRush,2977,0,1,1,2,50.0%,12m
16153,1,Mamajaga,2977,38,1,7,8,12.5%,41m
16153,2,[JB]modelo,2977,0,0,1,1,0.0%,5m
16153,2,LuizPaulo,2977,0,0,2,2,0.0%,18m
16153,2,bubba,2977,0,0,2,2,0.0%,42m
16176,1,PucioHenZap,2976,1500,112,90,202,55.4%,40m
16176,1,qrtz,2976,1481,107,96,203,52.7%,3m
16176,1,ThreeOhThree,2976,1546,105,101,206,51.0%,33m
16176,2,Sqoyd,2976,580,29,14,43,67.4%,4m
16176,2,[XpKAc]PeXan,2976,276,9,5,14,64.3%,12m
16176,1,MasterDiablo,2976,189,9,5,14,64.3%,39m
16176,3,[UMCP]leopluradon,2976,223,9,11,20,45.0%,14m
16176,1,[AbcCo]RatStyle,2976,326,9,12,21,42.9%,16m
16176,2,goqsane,2976,224,8,6,14,57.1%,45m
16176,3,OGDrDre,2976,182,7,20,27,25.9%,10m
16176,3,Zero,2976,148,4,1,5,80.0%,29m
16176,2,SyQo,2976,32,4,3,7,57.1%,30m
16176,1,RedHorse,2976,185,4,6,10,40.0%,45m
16176,2,[109X]mmaverick,2976,90,3,1,4,75.0%,15m
16176,1,XENORACE,2976,147,3,5,8,37.5%,35m
16176,2,ytrewq,2976,68,3,6,9,33.3%,23m
16176,3,[STWin]Aldoenova,2976,0,0,3,3,0.0%,43m
16176,2,[POBDM]blademaster,2976,0,0,3,3,0.0%,10m
16194,3,franktankboi,2975,1388,126,128,254,49.6%,14m
16194,3,[MLGB]AOldDustShoe,2975,987,64,69,133,48.1%,20m
16194,1,EnTaroDEHAKA,2975,1293,53,48,101,52.5%,11m
16194,2,Kian,2975,873,42,33,75,56.0%,12m
16194,2,intrepidmonk,2975,1108,42,43,85,49.4%,35m
16194,2,Magic,2975,770,29,25,54,53.7%,26m
16194,1,poggers,2975,493,22,14,36,61.1%,17m
16194,1,SROpressor,2975,192,17,14,31,54.8%,8m
16194,2,Shabatch,2975,366,13,11,24,54.2%,4m
16194,2,KirihaKaisei,2975,248,8,5,13,61.5%,7m
16194,2,Zannall,2975,86,4,2,6,66.7%,35m
16194,2,CanadianToss,2975,98,4,3,7,57.1%,33m
16194,3,[SABO]Zig,2975,121,3,1,4,75.0%,12m
16194,2,Sirn,2975,60,3,1,4,75.0%,7m
16194,1,Flameg,2975,103,3,3,6,50.0%,19m
16194,1,[SDMG]Fazmataz,2975,74,3,6,9,33.3%,35m
16194,2,[Broxit]NotKlinch,2975,58,2,2,4,50.0%,45m
16194,2,[Gees]carvalho,2975,0,1,0,1,100.0%,7m
16194,3,[salman]TeHNooP,2975,0,1,1,2,50.0%,31m
16194,2,[aplol]Broadwing,2975,30,1,1,2,50.0%,42m
16194,2,OCDAnarchist,2975,32,1,2,3,33.3%,4m
16194,3,GalaxyStorm,2975,0,0,1,1,0.0%,3m
16194,2,[Nek0es]Azure,2975,0,0,1,1,0.0%,6m
16194,3,AldoChillBro,2975,0,0,1,1,0.0%,13m
16194,2,[TPLUSS]marsman,2975,0,0,3,3,0.0%,15m
16219,2,idk,2974,1643,247,230,477,51.8%,23m
16219,3,Mierdaz,2974,620,245,246,491,49.9%,12m
16219,1,[GRUMEC]MiniNinja,2974,1672,223,201,424,52.6%,24m
16219,1,LolassoBoy,2974,1585,183,188,371,49.3%,3m
16219,1,Hafoc,2974,1660,132,133,265,49.8%,42m
16219,1,[illers]Westend,2974,1556,127,102,229,55.5%,28m
16219,2,MohammerD,2974,1194,48,40,88,54.5%,23m
16219,3,IceFox,2974,991,45,51,96,46.9%,20m
16219,1,HellSorC,2974,885,36,29,65,55.4%,4m
16219,3,DylanJohn,2974,536,25,32,57,43.9%,32m
16219,2,ichich,2974,525,21,11,32,65.6%,18m
16219,2,IWILLWIN,2974,472,19,13,32,59.4%,16m
16219,3,Topher,2974,507,19,23,42,45.2%,29m
16219,2,[NoGood]Sodamoeba,2974,452,17,12,29,58.6%,45m
16219,1,[GØSU]Tracker,2974,454,13,21,34,38.2%,26m
16219,2,cheras,2974,30,5,2,7,71.4%,28m
16219,1,Dave,2974,121,5,4,9,55.6%,17m
16219,1,chunky,2974,128,5,9,14,35.7%,30m
16219,2,[FxB]Coast,2974,90,3,6,9,33.3%,12m
16219,2,[SBlock]AxelOrion,2974,34,2,0,2,100.0%,14m
16219,2,LegacyOfVoid,2974,30,1,1,2,50.0%,30m
16219,2,SuperSrl,2974,30,1,1,2,50.0%,16m
16219,2,[DOIOM]Fatality,2974,0,0,1,1,0.0%,12m
16219,1,[TGosuC]Kloof,2974,0,0,4,4,0.0%,21m
16219,1,ksw,2974,0,0,6,6,0.0%,42m
16244,3,ricecube,2973,729,54,62,116,46.6%,23m
16244,2,atomicdog,2973,1042,47,45,92,51.1%,16m
16244,2,[maj]Daddio,2973,1042,39,38,77,50.6%,17m
16244,2,YoYoMa,2973,645,29,31,60,48.3%,34m
16244,1,[Rtaz]MarioJosefo,2973,598,26,24,50,52.0%,5m
16244,2,shadowhand,2973,584,25,25,50,50.0%,10m
16244,1,aiRInHale,2973,602,24,19,43,55.8%,42m
16244,1,TourizT,2973,597,24,23,47,51.1%,19m
16244,2,AhrimanTS,2973,510,19,13,32,59.4%,25m
16244,2,doud,2973,408,18,12,30,60.0%,25m
16244,1,llllllllllll,2973,368,13,9,22,59.1%,2h
16244,2,[Whaaaa]Mathurin,2973,272,10,3,13,76.9%,22m
16244,1,[TILM]Asasquatchah,2973,178,8,5,13,61.5%,30m
16244,2,Carbonshadow,2973,229,7,4,11,63.6%,30m
16244,2,monkeywre,2973,204,7,8,15,46.7%,7m
16244,1,SKINET,2973,203,6,9,15,40.0%,27m
16244,2,xMRxGNDFx,2973,60,5,2,7,71.4%,31m
16244,1,FlamBerGe,2973,96,5,4,9,55.6%,45m
16244,2,[lober]Glowymeteor,2973,0,3,2,5,60.0%,23m
16244,2,Metronomes,2973,60,2,4,6,33.3%,22m
16244,3,TheBOMB,2973,60,2,15,17,11.8%,45m
16244,2,[New2it]Carmax,2973,0,1,0,1,100.0%,5m
16244,2,[NNA]PillowScream,2973,0,0,1,1,0.0%,19m
16244,2,john,2973,0,0,1,1,0.0%,12m
16244,2,adamk,2973,0,0,1,1,0.0%,35m
16269,1,cinderlord,2972,1646,165,142,307,53.7%,39m
16269,3,[NYHU]Holidayboy,2972,851,149,140,289,51.6%,8m
16269,1,[PoSSuM]grEsyCornDog,2972,1533,74,64,138,53.6%,32m
16269,2,Nuclear,2972,1242,55,41,96,57.3%,8m
16269,1,Lostname,2972,485,44,36,80,55.0%,27m
16269,2,[ANGST]SideShow,2972,592,23,17,40,57.5%,30m
16269,1,ajota,2972,696,23,23,46,50.0%,35m
16269,1,Cryo,2972,390,14,11,25,56.0%,13m
16269,1,NewBeginning,2972,296,13,11,24,54.2%,9m
16269,1,LoneWolf,2972,304,9,13,22,40.9%,20m
16269,1,[ISDP]Taco,2972,270,8,13,21,38.1%,13m
16269,3,[S14]DLago,2972,258,8,24,32,25.0%,16m
16269,1,[LVARW]Oomi,2972,214,6,12,18,33.3%,7m
16269,2,[UnsTll]DragonFH,2972,120,5,2,7,71.4%,10m
16269,2,koyo,2972,124,4,5,9,44.4%,19m
16269,3,onYourOwn,2972,97,4,5,9,44.4%,7m
16269,2,JadenSmith,2972,60,3,1,4,75.0%,24m
16269,1,Chichi,2972,0,3,2,5,60.0%,1h
16269,2,[SCxRH]TylerJohnson,2972,30,2,0,2,100.0%,45m
16269,2,Hiemal,2972,58,2,1,3,66.7%,23m
16269,1,Mothership,2972,90,2,3,5,40.0%,8m
16269,2,Geo,2972,0,1,0,1,100.0%,20m
16269,2,[BVRDVR]Spartacan,2972,0,1,0,1,100.0%,22m
16269,1,Chaospheres,2972,0,1,3,4,25.0%,32m
16269,3,Rytro,2972,0,0,1,1,0.0%,8m
16269,2,Perebro,2972,0,0,1,1,0.0%,28m
16269,2,[TuTuxC]MiT,2972,0,0,1,1,0.0%,33m
16296,3,Archon,2971,1556,302,291,593,50.9%,14m
16296,2,michealaa,2971,1225,189,165,354,53.4%,17m
16296,3,galaxar,2971,1475,158,165,323,48.9%,19m
16296,1,DaClap,2971,1664,124,129,253,49.0%,33m
16296,1,Glacius,2971,1403,116,116,232,50.0%,22m
16296,3,[NLTN]War,2971,1241,110,116,226,48.7%,25m
16296,1,fallenking,2971,1600,67,66,133,50.4%,43m
16296,3,Tgirl,2971,199,38,41,79,48.1%,11m
16296,3,Figmentx,2971,765,36,47,83,43.4%,25m
16296,3,MikeSoldier,2971,491,30,32,62,48.4%,8m
16296,1,TakT,2971,644,21,22,43,48.8%,25m
16296,3,inLeaD,2971,316,10,19,29,34.5%,6m
16296,3,[CToL]FractalSky,2971,245,8,5,13,61.5%,16m
16296,3,llllllllllll,2971,178,7,4,11,63.6%,2h
16296,1,GetPolitical,2971,218,7,9,16,43.8%,33m
16296,2,Chronic,2971,90,4,3,7,57.1%,17m
16296,2,Skateboard,2971,58,4,4,8,50.0%,4m
16296,2,YellowPink,2971,58,3,1,4,75.0%,28m
16296,3,TAK,2971,121,3,3,6,50.0%,39m
16296,2,[LCE]ZeraKhan,2971,0,1,0,1,100.0%,12m
16296,1,[TRR]Nechi,2971,0,1,1,2,50.0%,2h
16296,2,Deadwinter,2971,0,1,1,2,50.0%,30m
16296,2,eyemhy,2971,0,0,1,1,0.0%,17m
16296,2,SevenTolBees,2971,0,0,1,1,0.0%,29m
16296,1,Paulomtr,2971,0,0,1,1,0.0%,7m
16296,2,[DoRQ]GaseousDeath,2971,0,0,1,1,0.0%,24m
16296,2,Arcana,2971,0,0,1,1,0.0%,10m
16323,1,Dare,2970,1369,186,168,354,52.5%,2m
16323,1,traisle,2970,1337,168,161,329,51.1%,17m
16323,3,LeonEdu,2970,1522,153,146,299,51.2%,41m
16323,1,[Sune]HavelTheRock,2970,1647,131,119,250,52.4%,3m
16323,2,lowcandrew,2970,1622,124,88,212,58.5%,28m
16323,3,Joannaho,2970,1473,102,84,186,54.8%,12m
16323,2,Mawk,2970,1456,89,81,170,52.4%,18m
16323,2,[097]XXXanin,2970,1470,66,63,129,51.2%,22m
16323,1,SirWiggles,2970,622,65,59,124,52.4%,16m
16323,3,Daark,2970,532,17,25,42,40.5%,15m
16323,2,SuperTets,2970,291,14,5,19,73.7%,4m
16323,1,VibeScholar,2970,252,11,8,19,57.9%,2h
16323,3,[Hawkz]Colson,2970,250,8,9,17,47.1%,6m
16323,2,[xMEGAx]AllahIsALie,2970,179,7,1,8,87.5%,21m
16323,2,Adrieltuf,2970,172,7,6,13,53.8%,29m
16323,1,Airen,2970,0,3,2,5,60.0%,2h
16323,2,[3Btchs]MadMax,2970,30,2,1,3,66.7%,9m
16323,2,[GoobSQ]DaZergAnator,2970,0,1,0,1,100.0%,23m
16323,2,Frict,2970,0,1,0,1,100.0%,18m
16323,2,HighAsHell,2970,32,1,3,4,25.0%,6m
16323,2,Destiny,2970,32,1,3,4,25.0%,18m
16323,2,[KGH]Ajaxx,2970,30,1,4,5,20.0%,29m
16323,3,Tabbris,2970,34,1,6,7,14.3%,1h
16323,2,[UoM]SLadE,2970,0,0,1,1,0.0%,4m
16323,2,Svensen,2970,0,0,1,1,0.0%,42m
16323,3,[BfLaD]DensitY,2970,0,0,3,3,0.0%,18m
16349,2,slimjim,2969,1444,269,252,521,51.6%,4m
16349,2,Qriator,2969,1573,216,196,412,52.4%,7m
16349,3,[EZTAXI]Beast,2969,1549,168,173,341,49.3%,33m
16349,1,DeafKillerz,2969,1368,115,77,192,59.9%,9m
16349,3,RandybAMG,2969,1324,108,112,220,49.1%,20m
16349,1,StarAsia,2969,891,39,28,67,58.2%,26m
16349,2,luckyterran,2969,551,24,13,37,64.9%,33m
16349,1,Cchimbooo,2969,479,23,25,48,47.9%,25m
16349,1,[RUMB]Moustro,2969,462,23,27,50,46.0%,20m
16349,2,[QTclub]Arsteel,2969,444,20,6,26,76.9%,41m
16349,1,Sonda,2969,471,17,19,36,47.2%,9m
16349,3,youroutofgas,2969,126,4,14,18,22.2%,9m
16349,2,[DmgBtn]Raishiwi,2969,58,3,1,4,75.0%,17m
16349,2,Starback,2969,0,3,2,5,60.0%,30m
16349,2,Jehudda,2969,37,2,2,4,50.0%,9m
16349,2,BlameMe,2969,30,2,2,4,50.0%,19m
16349,2,[DarkAG]catzilla,2969,0,1,0,1,100.0%,1h
16349,2,SoiBoi,2969,0,1,0,1,100.0%,12m
16349,2,imarogue,2969,32,1,2,3,33.3%,12m
16349,1,[RVNSBL]PakJungHe,2969,0,1,5,6,16.7%,5m
16349,2,[ClemA]DerpySquid,2969,30,1,6,7,14.3%,4m
16349,2,[YStars]AlphaSystems,2969,0,0,1,1,0.0%,27m
16349,2,Sucitraf,2969,0,0,1,1,0.0%,4m
16349,2,[BuGang]FullySick,2969,0,0,2,2,0.0%,28m
16349,2,[Egos]Rampage,2969,0,0,2,2,0.0%,6m
16374,1,[nieBla]SNKvsBLIZZAR,2968,1690,310,283,593,52.3%,13m
16374,1,ACT,2968,1639,109,106,215,50.7%,26m
16374,3,[Ba1t]ranger,2968,1461,89,79,168,53.0%,32m
16374,3,Hope,2968,1561,84,81,165,50.9%,20m
16374,1,DavO,2968,1093,51,46,97,52.6%,21m
16374,3,SparkSix,2968,773,30,34,64,46.9%,10m
16374,1,nayakai,2968,587,23,21,44,52.3%,30m
16374,1,[420NS]OmegaZ,2968,563,19,18,37,51.4%,26m
16374,1,NbKnighT,2968,434,17,14,31,54.8%,8m
16374,2,[SHorse]Flecha,2968,94,11,12,23,47.8%,17m
16374,1,darksouls,2968,204,8,4,12,66.7%,4m
16374,2,Nyaoctix,2968,186,7,6,13,53.8%,2h
16374,1,Rayzor,2968,240,6,8,14,42.9%,42m
16374,2,Terranasaur,2968,186,5,2,7,71.4%,34m
16374,2,xiboloxd,2968,86,4,3,7,57.1%,25m
16374,2,denito,2968,86,3,2,5,60.0%,12m
16374,2,Galla,2968,140,3,3,6,50.0%,35m
16374,2,messix,2968,34,2,3,5,40.0%,32m
16374,2,FeedDaMonkey,2968,88,2,4,6,33.3%,23m
16374,2,CplHicks,2968,0,1,2,3,33.3%,22m
16374,2,[lLiTl]Abyssional,2968,30,1,2,3,33.3%,18m
16374,2,Honeyryerye,2968,0,0,1,1,0.0%,18m
16374,2,DarkEclipse,2968,0,0,1,1,0.0%,28m
16374,2,ZeroZero,2968,0,0,1,1,0.0%,21m
16374,2,Verdugo,2968,0,0,3,3,0.0%,45m
16399,1,ApacheKiller,2967,1566,225,200,425,52.9%,28m
16399,1,Pendragon,2967,1644,217,205,422,51.4%,11m
16399,2,zUnOriginalz,2967,1548,76,63,139,54.7%,7m
16399,2,[Defole]Machiken,2967,1492,66,58,124,53.2%,42m
16399,3,stokes,2967,941,41,44,85,48.2%,30m
16399,2,oreo,2967,686,26,23,49,53.1%,33m
16399,2,BadgerCraft,2967,386,16,8,24,66.7%,23m
16399,1,[TGosuD]Chibinator,2967,400,15,13,28,53.6%,16m
16399,2,TESla,2967,288,12,3,15,80.0%,35m
16399,1,[EreQc]Adrix,2967,333,11,9,20,55.0%,33m
16399,1,[DXPCA]PAULOMF,2967,359,11,12,23,47.8%,12m
16399,2,[nieBla]GhostKiller,2967,266,10,8,18,55.6%,7m
16399,1,ayeyo,2967,216,9,12,21,42.9%,41m
16399,1,[PAICHE]KIOUJI,2967,213,7,5,12,58.3%,1h
16399,1,Chiz,2967,158,6,5,11,54.5%,22m
16399,2,[TENDbo]Gerardeitor,2967,132,5,2,7,71.4%,18m
16399,2,Basir,2967,71,5,5,10,50.0%,12m
16399,2,CptCuddles,2967,146,5,5,10,50.0%,23m
16399,2,Jackblack,2967,94,4,3,7,57.1%,35m
16399,2,Eddy,2967,0,3,2,5,60.0%,35m
16399,2,Maureencita,2967,30,2,1,3,66.7%,41m
16399,1,wehttam,2967,0,2,1,3,66.7%,44m
16399,2,[Paus3d]GrundleLickr,2967,62,2,3,5,40.0%,23m
16399,2,Joe,2967,0,1,0,1,100.0%,32m
16399,1,SALCHICHÓN,2967,0,1,0,1,100.0%,3h
16399,1,[JWC]JWCxSylar,2967,0,1,1,2,50.0%,37m
16399,1,[DJJ]JAMER,2967,38,1,5,6,16.7%,32m
16399,3,SoggyBiscuit,2967,0,0,8,8,0.0%,22m
16427,2,IDONTPLAY,2966,1553,115,84,199,57.8%,4m
16427,1,Player,2966,1460,60,61,121,49.6%,30m
16427,2,Singularity,2966,956,47,31,78,60.3%,26m
16427,3,JuanitoOoO,2966,1318,46,58,104,44.2%,34m
16427,1,[FSTM]FireStar,2966,1043,38,36,74,51.4%,42m
16427,1,CloudBoi,2966,935,31,33,64,48.4%,13m
16427,2,Manners,2966,339,20,15,35,57.1%,14m
16427,2,RedAsh,2966,214,8,2,10,80.0%,42m
16427,1,Greendot,2966,268,8,11,19,42.1%,9m
16427,1,[DarkAG]Sleepy,2966,222,7,11,18,38.9%,40m
16427,2,DivineSalmon,2966,148,5,9,14,35.7%,22m
16427,2,HierarchAdun,2966,62,3,2,5,60.0%,12m
16427,1,Light,2966,68,3,6,9,33.3%,25m
16427,2,[iMkS]MVP,2966,30,2,1,3,66.7%,35m
16427,1,SPAWN,2966,72,2,4,6,33.3%,17m
16427,2,StEeZe,2966,0,1,0,1,100.0%,15m
16427,2,stonefiend,2966,0,1,0,1,100.0%,26m
16427,2,seb,2966,93,1,2,3,33.3%,2h
16427,2,zonor,2966,0,1,2,3,33.3%,4m
16427,2,[AoBDE]popslaw,2966,30,1,3,4,25.0%,17m
16427,2,JVitor,2966,0,0,1,1,0.0%,17m
16448,2,easeryder,2965,1504,172,160,332,51.8%,34m
16448,1,[FORCE9]MARINER,2965,1702,132,127,259,51.0%,7m
16448,1,Syilon,2965,941,37,37,74,50.0%,30m
16448,2,[TSM88]JOHNANDBUDDY,2965,885,36,25,61,59.0%,6m
16448,1,starrulz,2965,737,24,24,48,50.0%,17m
16448,2,redsmurf,2965,382,15,13,28,53.6%,17m
16448,2,wir,2965,278,12,9,21,57.1%,7m
16448,2,Larhar,2965,294,11,7,18,61.1%,20m
16448,3,[EGRILL]FeedMe,2965,212,9,4,13,69.2%,2h
16448,2,digitaldave,2965,0,3,2,5,60.0%,40m
16448,1,Hades,2965,0,2,0,2,100.0%,2h
16448,2,TalentedArc,2965,0,1,0,1,100.0%,21m
16448,1,SkyTyman,2965,0,1,0,1,100.0%,33m
16448,2,AgentTucker,2965,30,1,1,2,50.0%,21m
16448,2,magicleaf,2965,0,0,1,1,0.0%,11m
16463,1,Therapist,2964,1660,98,96,194,50.5%,27m
16463,2,[TSLRC]MustardBoy,2964,1584,63,55,118,53.4%,7m
16463,2,[CrazyC]MXGRE,2964,931,42,22,64,65.6%,23m
16463,3,Rufio,2964,1050,39,45,84,46.4%,12m
16463,2,SantaClaws,2964,812,37,25,62,59.7%,28m
16463,1,CLaUs,2964,577,27,21,48,56.2%,17m
16463,2,Heemlo,2964,580,20,21,41,48.8%,25m
16463,1,Diosteama,2964,482,15,22,37,40.5%,40m
16463,2,ClownWithGun,2964,280,11,6,17,64.7%,12m
16463,1,Cream,2964,137,11,13,24,45.8%,34m
16463,2,cows,2964,214,8,7,15,53.3%,27m
16463,2,[GldBoy]GoldenEagle,2964,230,7,9,16,43.8%,12m
16463,1,SCPXelborn,2964,48,4,3,7,57.1%,30m
16463,3,Vvin,2964,97,4,4,8,50.0%,2h
16463,2,[FORCE9]Rhazz,2964,96,3,3,6,50.0%,28m
16463,2,oGreZerGameR,2964,0,1,0,1,100.0%,6m
16463,2,[GlRTH]Dan,2964,0,1,0,1,100.0%,41m
16463,2,kazyllis,2964,32,1,2,3,33.3%,4m
16463,2,joacoSanna,2964,0,1,2,3,33.3%,34m
16463,2,Arkalinoso,2964,0,1,3,4,25.0%,4m
16463,2,[zeez]VoidPhallus,2964,0,0,1,1,0.0%,20m
16463,2,[wOaS]BlackSheriff,2964,0,0,1,1,0.0%,32m
16485,1,Rumpelstinsk,2963,1678,173,167,340,50.9%,41m
16485,2,MartR,2963,1590,148,122,270,54.8%,40m
16485,3,Scar,2963,1469,139,143,282,49.3%,28m
16485,3,SkullCrater,2963,381,56,64,120,46.7%,14m
16485,1,Snittzle,2963,814,53,44,97,54.6%,3m
16485,3,[ORNG]TheHappyRaid,2963,1098,46,45,91,50.5%,35m
16485,2,moist,2963,618,26,20,46,56.5%,45m
16485,2,Merlock,2963,358,19,13,32,59.4%,12m
16485,2,PonnySalvaje,2963,230,9,8,17,52.9%,21m
16485,2,GetOffMyBoat,2963,190,7,7,14,50.0%,22m
16485,2,max,2963,138,5,5,10,50.0%,35m
16485,2,[Xe1nal]IVAN,2963,0,4,1,5,80.0%,4m
16485,1,fvelmntnja,2963,0,4,2,6,66.7%,2m
16485,2,cartman,2963,82,4,2,6,66.7%,9m
16485,2,MicroJackson,2963,88,4,2,6,66.7%,32m
16485,2,ArkKnight,2963,169,4,6,10,40.0%,15m
16485,2,[ZLS]koydarkness,2963,30,1,2,3,33.3%,18m
16485,2,[TCD]Neferio,2963,30,1,5,6,16.7%,24m
16485,2,[Prelud]Staple,2963,0,0,3,3,0.0%,22m
16504,1,Callywally,2962,1285,92,78,170,54.1%,5m
16504,3,bobtubba,2962,1316,47,56,103,45.6%,35m
16504,3,ZergOP,2962,979,39,37,76,51.3%,13m
16504,2,postmortem,2962,901,35,33,68,51.5%,12m
16504,2,RickeyBobby,2962,670,26,22,48,54.2%,10m
16504,2,Chirp,2962,459,25,18,43,58.1%,10m
16504,2,[801]Wildfire,2962,568,22,13,35,62.9%,7m
16504,1,BillClitton,2962,314,10,5,15,66.7%,2h
16504,1,Jenova,2962,222,7,7,14,50.0%,11m
16504,1,[I6I9I]CoughTots,2962,258,7,14,21,33.3%,40m
16504,2,[BigDE]Jericoice,2962,166,6,6,12,50.0%,23m
16504,1,fluxquantum,2962,184,6,9,15,40.0%,21m
16504,2,CandyMan,2962,159,4,4,8,50.0%,19m
16504,2,Tower,2962,30,2,0,2,100.0%,45m
16504,1,KingBobVII,2962,0,1,0,1,100.0%,9m
16504,3,DantheChef,2962,0,1,1,2,50.0%,1h
16504,2,LapsoPatton,2962,30,1,4,5,20.0%,4m
16504,2,[HOBOZ]DezoForezo,2962,0,0,1,1,0.0%,4m
16504,2,UtilityFan,2962,0,0,1,1,0.0%,45m
16523,1,[TILL]Clamseur,2961,1133,95,81,176,54.0%,12m
16523,3,AzaSMtt,2961,1577,75,87,162,46.3%,21m
16523,2,[EZkill]AgentVX,2961,1246,57,40,97,58.8%,15m
16523,1,Opponent,2961,1042,47,47,94,50.0%,31m
16523,3,Adam,2961,1319,47,52,99,47.5%,43m
16523,1,[KDD]Hierophant,2961,1131,40,38,78,51.3%,8m
16523,1,ZergRush,2961,934,36,38,74,48.6%,18m
16523,2,NoGGNoSkill,2961,888,35,32,67,52.2%,28m
16523,2,Yalla,2961,700,28,20,48,58.3%,16m
16523,2,KawaiiKY,2961,478,21,17,38,55.3%,15m
16523,3,Destroctoid,2961,458,19,0,19,100.0%,4m
16523,3,SwarmySteve,2961,347,15,8,23,65.2%,24m
16523,1,[tNEXUS]Winston,2961,432,14,13,27,51.9%,32m
16523,1,schterlo,2961,272,10,10,20,50.0%,1h
16523,1,rusty,2961,234,8,10,18,44.4%,33m
16523,3,[MD]Raedium,2961,184,6,7,13,46.2%,1h
16523,1,[UpxV]astana,2961,138,5,11,16,31.2%,42m
16523,1,StarDust,2961,150,4,9,13,30.8%,30m
16523,3,[NPA]Phump,2961,30,3,8,11,27.3%,12m
16523,1,Cormick,2961,68,3,8,11,27.3%,42m
16523,2,[SBlock]Anderson,2961,30,2,2,4,50.0%,25m
16523,1,substrate,2961,131,2,5,7,28.6%,11m
16523,2,[Design]Cemzx,2961,0,1,0,1,100.0%,12m
16523,1,rocklobster,2961,48,1,1,2,50.0%,2h
16523,3,[XpKAc]Harris,2961,42,1,4,5,20.0%,40m
16523,2,Kenunot,2961,0,0,1,1,0.0%,22m
16523,2,Brixos,2961,0,0,1,1,0.0%,23m
16550,2,XxIRONSIDExX,2960,1511,122,115,237,51.5%,42m
16550,2,iota,2960,1411,74,62,136,54.4%,25m
16550,1,[ESfs]SiKai,2960,1482,69,72,141,48.9%,18m
16550,2,[IGeaL]repanpan,2960,1508,66,61,127,52.0%,23m
16550,1,[UpxV]Jimbo,2960,1273,60,56,116,51.7%,18m
16550,3,Rodrihunter,2960,1359,57,52,109,52.3%,22m
16550,1,sPecOpNewNom,2960,1426,51,53,104,49.0%,22m
16550,3,Minkeys,2960,1000,44,49,93,47.3%,21m
16550,2,[VAMP2]neoweed,2960,837,36,25,61,59.0%,26m
16550,1,Breadmaster,2960,736,29,30,59,49.2%,26m
16550,3,nanogeo,2960,500,22,20,42,52.4%,32m
16550,1,[DHZ0ne]mario,2960,276,17,17,34,50.0%,31m
16550,1,problems,2960,244,10,8,18,55.6%,2h
16550,1,DriftKing,2960,224,9,7,16,56.2%,34m
16550,2,bdaniels,2960,268,9,8,17,52.9%,23m
16550,1,[LBHS]BladeRatchet,2960,199,8,7,15,53.3%,4m
16550,3,Zeratul,2960,205,7,15,22,31.8%,44m
16550,3,Red,2960,169,5,3,8,62.5%,42m
16550,2,[TYANO]Caine,2960,46,4,7,11,36.4%,1h
16550,1,[IiUiI]Aquilesparto,2960,102,4,9,13,30.8%,13m
16550,2,freya,2960,134,3,0,3,100.0%,2h
16550,2,Matt,2960,119,3,2,5,60.0%,18m
16550,1,Savage,2960,0,3,2,5,60.0%,2h
16550,2,MorcY,2960,34,2,1,3,66.7%,12m
16550,1,[TPGGXD]ULIGJ,2960,38,2,6,8,25.0%,36m
16550,2,JayKay,2960,0,1,0,1,100.0%,40m
16550,1,Humongous,2960,0,1,0,1,100.0%,2h
16550,2,PanDa,2960,0,0,1,1,0.0%,7m
16550,2,Forthenco,2960,0,0,2,2,0.0%,26m
16550,1,[WAYV]billsthedog,2960,0,0,8,8,0.0%,11m
16580,1,ZergXR,2959,1202,60,44,104,57.7%,32m
16580,1,[BATA]BICHI,2959,887,48,50,98,49.0%,35m
16580,1,Stinko,2959,862,42,40,82,51.2%,9m
16580,2,Hateme,2959,578,39,33,72,54.2%,19m
16580,3,[XpKAc]RafanliX,2959,522,37,50,87,42.5%,27m
16580,1,[MIT]vEnhance,2959,1028,34,40,74,45.9%,10m
16580,2,[DMONlC]SonofMan,2959,352,14,12,26,53.8%,15m
16580,1,LinGniL,2959,279,10,10,20,50.0%,4m
16580,3,Laverga,2959,167,7,3,10,70.0%,24m
16580,2,Viciad,2959,138,7,8,15,46.7%,2h
16580,3,AverageMan,2959,208,7,21,28,25.0%,16m
16580,2,kanjiman,2959,146,6,3,9,66.7%,10m
16580,2,MinoS,2959,88,5,1,6,83.3%,18m
16580,2,[BlTEL]SKARNDJ,2959,210,5,7,12,41.7%,22m
16580,1,worbuk,2959,193,4,5,9,44.4%,2h
16580,2,Gum,2959,124,4,7,11,36.4%,23m
16580,2,ApolloCreed,2959,0,3,1,4,75.0%,18m
16580,2,[CRAKS]RaYo,2959,32,2,1,3,66.7%,14m
16580,1,DiSifo,2959,30,2,2,4,50.0%,33m
16580,1,brushfire,2959,0,0,1,1,0.0%,7m
16580,2,PilotOfEarth,2959,0,0,1,1,0.0%,45m
16601,2,[TY4GG]orientalboy,2958,1466,173,141,314,55.1%,42m
16601,1,[WR0NG]WrongHero,2958,426,89,67,156,57.1%,40m
16601,3,KoralOcean,2958,1348,53,56,109,48.6%,14m
16601,1,Julio,2958,566,27,17,44,61.4%,4m
16601,2,Zonaballer,2958,683,27,18,45,60.0%,21m
16601,1,[hTx]MCBunnyPants,2958,235,10,10,20,50.0%,34m
16601,2,Dasbooty,2958,180,6,6,12,50.0%,40m
16601,2,JusticeBunny,2958,114,5,2,7,71.4%,14m
16601,3,Forsaken,2958,182,5,3,8,62.5%,22m
16601,2,pink,2958,0,3,2,5,60.0%,36m
16601,2,Tulkas,2958,0,3,2,5,60.0%,40m
16601,3,Shion,2958,144,3,7,10,30.0%,42m
16601,2,[VOIDS]KukyCream,2958,64,2,6,8,25.0%,16m
16601,2,[EKRS]Enki,2958,0,1,0,1,100.0%,33m
16601,2,[P4BR4]Progler,2958,0,1,3,4,25.0%,6m
16601,3,VonDoom,2958,0,0,1,1,0.0%,13m
16601,2,[PLMT]DrakkosCrl,2958,0,0,1,1,0.0%,45m
16601,2,Guyles,2958,0,0,3,3,0.0%,21m
16619,1,WilyWIly,2957,1644,181,159,340,53.2%,4m
16619,2,LEoN,2957,1643,167,140,307,54.4%,43m
16619,3,dragojaco,2957,1531,164,170,334,49.1%,20m
16619,2,GunNut,2957,1308,133,120,253,52.6%,6m
16619,2,Dezard,2957,934,90,91,181,49.7%,2m
16619,2,Hank,2957,1286,60,39,99,60.6%,44m
16619,2,[ffaaak]queenbeetch,2957,848,35,25,60,58.3%,12m
16619,1,Boomstick,2957,729,30,22,52,57.7%,23m
16619,2,CrashCourse,2957,558,20,18,38,52.6%,20m
16619,1,ZenBonsai,2957,354,16,12,28,57.1%,4m
16619,2,[bitsec]Awy,2957,342,15,9,24,62.5%,4m
16619,1,Hallu,2957,314,10,17,27,37.0%,3m
16619,1,Nice,2957,368,10,18,28,35.7%,5m
16619,2,zwtassadar,2957,239,8,7,15,53.3%,43m
16619,1,Profet,2957,187,7,9,16,43.8%,44m
16619,2,kuvall,2957,0,4,1,5,80.0%,23m
16619,2,Deathnukem,2957,0,4,1,5,80.0%,45m
16619,3,Ross,2957,97,4,4,8,50.0%,7m
16619,2,coverfire,2957,60,3,2,5,60.0%,33m
16619,2,[KTBOSS]xShadowx,2957,60,3,4,7,42.9%,16m
16619,2,[GnR]Moss,2957,30,2,3,5,40.0%,22m
16619,2,mree,2957,30,2,3,5,40.0%,36m
16619,1,[VTClan]DaBigKevocho,2957,0,1,0,1,100.0%,7m
16619,2,[elLS]elLuisShare,2957,0,1,0,1,100.0%,33m
16619,2,[BWSC]Rath,2957,30,1,2,3,33.3%,19m
16619,2,Apex,2957,30,1,2,3,33.3%,17m
16619,2,LaptopGamer,2957,0,0,1,1,0.0%,17m
16619,2,wetNfishy,2957,0,0,1,1,0.0%,44m
16619,2,NeoTronS,2957,0,0,1,1,0.0%,6m
16619,1,[InGt]Cold,2957,0,0,3,3,0.0%,34m
16619,2,[ValidG]Wanderer,2957,0,0,3,3,0.0%,40m
16650,1,Xavier,2956,1684,221,216,437,50.6%,32m
16650,1,Woods,2956,1677,193,180,373,51.7%,24m
16650,1,WillyBombBay,2956,1240,159,154,313,50.8%,40m
16650,1,[UpxV]lautitoplus,2956,1347,144,106,250,57.6%,7m
16650,2,[UpxV]iXplode,2956,1005,67,42,109,61.5%,35m
16650,1,Tovarish,2956,751,65,59,124,52.4%,23m
16650,1,hitch,2956,1298,42,46,88,47.7%,40m
16650,1,Oldman,2956,812,28,32,60,46.7%,26m
16650,2,[TChamp]HeroHawk,2956,676,27,23,50,54.0%,9m
16650,2,[SWOU]FIDALGO,2956,538,22,15,37,59.5%,3m
16650,2,GoatBeef,2956,340,15,4,19,78.9%,42m
16650,2,[BAU]OBeLisk,2956,338,14,11,25,56.0%,12m
16650,2,AmazingBob,2956,349,12,9,21,57.1%,44m
16650,1,RRC,2956,337,10,10,20,50.0%,19m
16650,2,highflyer,2956,242,8,7,15,53.3%,25m
16650,2,TYK,2956,112,6,5,11,54.5%,2h
16650,2,dragon,2956,224,6,6,12,50.0%,18m
16650,3,Allenosaurus,2956,62,6,6,12,50.0%,17m
16650,2,Sparta,2956,131,5,3,8,62.5%,28m
16650,2,[Dskwlf]Danable,2956,92,5,4,9,55.6%,17m
16650,1,ProblyStoned,2956,157,4,8,12,33.3%,25m
16650,2,locoman,2956,0,3,2,5,60.0%,44m
16650,2,Marcelo,2956,0,1,0,1,100.0%,31m
16650,2,[IAMI]Tharkus,2956,0,1,0,1,100.0%,15m
16650,2,Heisenberg,2956,0,1,0,1,100.0%,16m
16650,2,PewPewPew,2956,0,0,1,1,0.0%,4m
16650,2,Mimir,2956,0,0,1,1,0.0%,16m
16650,3,[ZOMO]Edu,2956,0,0,6,6,0.0%,29m
16678,3,[LaOr]TheArchitect,2955,1647,284,273,557,51.0%,23m
16678,1,brotoss,2955,1470,108,108,216,50.0%,12m
16678,3,baKZ,2955,1254,82,79,161,50.9%,30m
16678,2,CappinCrunch,2955,1597,80,60,140,57.1%,30m
16678,3,Flophead,2955,1090,63,75,138,45.7%,20m
16678,1,Scrufferdog,2955,880,59,55,114,51.8%,5m
16678,2,Legosi,2955,1261,51,40,91,56.0%,44m
16678,1,IIIIIIIIII,2955,470,26,15,41,63.4%,17m
16678,3,Chronous,2955,620,25,26,51,49.0%,27m
16678,2,BloodTitan,2955,522,18,21,39,46.2%,12m
16678,2,[TUF2MX]ULTRAjim,2955,209,11,5,16,68.8%,10m
16678,2,[GDJ]AbsenT,2955,295,10,9,19,52.6%,18m
16678,2,Koopa,2955,228,9,7,16,56.2%,23m
16678,2,[NWAro]TAVI,2955,209,7,2,9,77.8%,33m
16678,2,BuDo,2955,165,7,6,13,53.8%,2h
16678,1,peruvian,2955,243,7,9,16,43.8%,14m
16678,2,Solarbird,2955,208,6,3,9,66.7%,19m
16678,2,ThunderBlaZe,2955,166,6,4,10,60.0%,27m
16678,2,trina,2955,156,6,6,12,50.0%,12m
16678,1,HighTemplar,2955,218,6,12,18,33.3%,23m
16678,2,[9g9g]Cryo,2955,110,5,4,9,55.6%,4m
16678,1,HandofDog,2955,0,3,2,5,60.0%,1h
16678,1,Exia,2955,0,3,2,5,60.0%,2h
16678,2,[GeekA]Hznx,2955,80,3,4,7,42.9%,5m
16678,2,Kioelf,2955,88,2,0,2,100.0%,40m
16678,2,[roclan]Metabaron,2955,30,2,1,3,66.7%,19m
16678,1,BMTenoch,2955,96,2,7,9,22.2%,1h
16678,2,Ramseus,2955,0,1,0,1,100.0%,12m
16678,2,Doctore,2955,0,1,4,5,20.0%,21m
16678,2,Jasper,2955,0,0,1,1,0.0%,18m
16678,2,Blastjet,2955,0,0,2,2,0.0%,15m
16678,2,Smores,2955,0,0,2,2,0.0%,6m
16678,2,MagicTurtle,2955,0,0,2,2,0.0%,27m
16678,2,[Ex7rA]Chaos,2955,0,0,3,3,0.0%,1h
16712,1,[LTK]Rancor,2954,1508,165,149,314,52.5%,18m
16712,2,Keshik,2954,893,58,33,91,63.7%,7m
16712,1,Allesa,2954,1217,50,55,105,47.6%,45m
16712,1,marton,2954,1060,46,38,84,54.8%,30m
16712,1,[AD3C]RoCkEt,2954,576,30,29,59,50.8%,40m
16712,3,Patrick,2954,717,30,37,67,44.8%,18m
16712,1,ScottyDoes,2954,682,25,24,49,51.0%,23m
16712,2,EyeHoles,2954,406,18,11,29,62.1%,35m
16712,1,[Chizu]Serralberto,2954,584,17,25,42,40.5%,17m
16712,1,Grogu,2954,385,16,16,32,50.0%,24m
16712,2,[Zulu]ReiGn,2954,296,10,7,17,58.8%,11m
16712,2,Titan,2954,312,10,8,18,55.6%,3m
16712,2,[UpxV]HarDan,2954,230,9,6,15,60.0%,25m
16712,2,Triseven,2954,165,6,4,10,60.0%,21m
16712,1,Dugra,2954,48,4,3,7,57.1%,1h
16712,2,TNT,2954,86,3,2,5,60.0%,18m
16712,1,PandorasBox,2954,0,3,2,5,60.0%,1h
16712,2,[AbcCo]HojuelaDMaiz,2954,0,2,1,3,66.7%,10m
16712,2,CHROME,2954,30,2,2,4,50.0%,16m
16712,2,[FROMOZ]TheKing,2954,0,1,0,1,100.0%,14m
16712,2,TheTemplar,2954,0,1,3,4,25.0%,18m
16712,1,Winterfreak,2954,0,1,4,5,20.0%,41m
16712,2,Silverhand,2954,0,0,1,1,0.0%,26m
16712,1,Adrenaline,2954,0,0,1,1,0.0%,2h
16712,2,Randy,2954,0,0,1,1,0.0%,29m
16737,3,janez,2953,1582,243,239,482,50.4%,32m
16737,2,OrdinaryNot,2953,751,80,45,125,64.0%,27m
16737,1,yes,2953,1528,55,63,118,46.6%,41m
16737,2,[EvilCC]mcfly,2953,536,26,18,44,59.1%,22m
16737,2,DVince,2953,420,19,6,25,76.0%,15m
16737,2,DarkVhyll,2953,368,13,12,25,52.0%,21m
16737,2,Lauerto,2953,247,11,7,18,61.1%,46m
16737,1,ChrisJob,2953,258,10,10,20,50.0%,2h
16737,2,[eThugs]JizzJunkie,2953,236,8,3,11,72.7%,44m
16737,1,PitchPine,2953,217,7,6,13,53.8%,2h
16737,2,Bittering,2953,232,7,7,14,50.0%,14m
16737,2,lilwookies,2953,154,5,4,9,55.6%,14m
16737,1,SoapSum,2953,162,4,6,10,40.0%,2m
16737,2,Alakaid,2953,60,3,0,3,100.0%,6m
16737,1,BorneyG,2953,0,3,2,5,60.0%,32m
16737,2,Vince,2953,90,3,4,7,42.9%,16m
16737,2,[AbcCo]UnknownStorm,2953,30,2,0,2,100.0%,14m
16737,1,Sublime,2953,97,2,1,3,66.7%,2h
16737,2,AmUnknown,2953,117,2,1,3,66.7%,10m
16737,2,djayfeel,2953,0,1,0,1,100.0%,11m
16737,2,maria,2953,0,1,0,1,100.0%,27m
16737,1,Sebastis,2953,0,1,0,1,100.0%,2h
16737,2,Narkobear,2953,30,1,1,2,50.0%,18m
16737,2,Whiplash,2953,0,1,1,2,50.0%,6m
16737,2,[REDEYE]Bobandy,2953,0,1,2,3,33.3%,31m
16737,1,[STPL]Potato,2953,0,0,1,1,0.0%,1h
16737,2,Cruze,2953,0,0,1,1,0.0%,17m
16737,2,eLFix,2953,0,0,1,1,0.0%,42m
16737,2,[arum]SubparMar,2953,0,0,2,2,0.0%,18m
16766,2,CDiazG,2952,1438,102,87,189,54.0%,20m
16766,1,FuryOne,2952,1172,44,43,87,50.6%,3m
16766,1,[xTQc]Moulehumide,2952,1222,42,52,94,44.7%,30m
16766,1,[xTQc]Katamundi,2952,481,22,19,41,53.7%,43m
16766,2,LarryHolmes,2952,426,21,5,26,80.8%,15m
16766,2,Nextle,2952,413,18,7,25,72.0%,31m
16766,2,Chel,2952,386,15,13,28,53.6%,12m
16766,2,ASDF,2952,403,14,12,26,53.8%,17m
16766,2,BlindMan,2952,288,10,6,16,62.5%,17m
16766,1,[APR]PRIMUS,2952,280,8,14,22,36.4%,40m
16766,2,JMagnus,2952,99,5,2,7,71.4%,34m
16766,2,Brythebeast,2952,114,5,3,8,62.5%,6m
16766,2,lIlIIlIlIIll,2952,60,5,5,10,50.0%,19m
16766,2,TheNightMare,2952,86,4,0,4,100.0%,16m
16766,1,ErOs,2952,0,4,2,6,66.7%,23m
16766,1,Fullspeed,2952,0,3,2,5,60.0%,2h
16766,2,Inticito,2952,0,3,2,5,60.0%,44m
16766,2,[SoloOp]DMK,2952,88,3,3,6,50.0%,45m
16766,2,[BL]Kevingalls,2952,62,2,2,4,50.0%,23m
16766,2,[StarCT]ForTheSwarm,2952,58,2,3,5,40.0%,26m
16766,2,[LQV]AProtossBoi,2952,0,2,3,5,40.0%,26m
16766,1,[FYD]SilkyJenkins,2952,66,2,5,7,28.6%,33m
16766,2,Supreme,2952,0,0,1,1,0.0%,19m
16766,2,[DLXCH]Oowha,2952,0,0,3,3,0.0%,29m
16766,2,Google,2952,0,0,3,3,0.0%,22m
16791,2,lAraeLl,2951,1503,107,87,194,55.2%,22m
16791,2,chechme,2951,1091,47,33,80,58.8%,15m
16791,3,[tCo9]Schistosoma,2951,563,28,35,63,44.4%,16m
16791,1,RUST,2951,574,23,22,45,51.1%,18m
16791,2,wowzaz,2951,488,22,17,39,56.4%,14m
16791,3,Zalanax,2951,222,8,21,29,27.6%,33m
16791,3,Jeremylin,2951,182,6,4,10,60.0%,2h
16791,2,DARKDUCK,2951,148,5,6,11,45.5%,12m
16791,2,elCallado,2951,88,4,1,5,80.0%,19m
16791,3,Jrocksy,2951,154,4,1,5,80.0%,21m
16791,2,Risky,2951,58,3,1,4,75.0%,11m
16791,2,Kinney,2951,60,3,2,5,60.0%,44m
16791,2,AngeldMuerte,2951,133,3,3,6,50.0%,45m
16791,1,[MNDA]huno,2951,76,3,8,11,27.3%,7m
16791,2,Grayskull,2951,58,2,1,3,66.7%,35m
16791,2,[WOTG]Fantasma,2951,58,2,2,4,50.0%,25m
16791,2,sillycookies,2951,34,2,3,5,40.0%,21m
16791,1,Pooisfun,2951,40,2,6,8,25.0%,5m
16791,2,[cl0udM]IIIIIIIIIIII,2951,0,1,0,1,100.0%,28m
16791,2,[ObM]OniBoss,2951,0,1,1,2,50.0%,16m
16791,1,[Nine25]xoxoxo,2951,0,1,1,2,50.0%,2h
16791,2,[LIEF]Panquesito,2951,30,1,3,4,25.0%,34m
16791,2,Fabian,2951,0,0,1,1,0.0%,34m
16791,2,[HardCo]Wompas,2951,0,0,1,1,0.0%,11m
16791,2,gteche,2951,0,0,1,1,0.0%,34m
16791,2,Pandom,2951,0,0,2,2,0.0%,26m
16791,2,acccky,2951,0,0,2,2,0.0%,35m
16791,2,TheEndBoss,2951,0,0,3,3,0.0%,11m
16819,3,Vicebacker,2950,1531,120,121,241,49.8%,8m
16819,2,Heathen,2950,1559,94,90,184,51.1%,4m
16819,1,[zelniq]Starkilla,2950,984,91,99,190,47.9%,3m
16819,1,Slaybird,2950,775,70,68,138,50.7%,42m
16819,2,Milton,2950,556,48,39,87,55.2%,23m
16819,2,Evan,2950,894,41,25,66,62.1%,40m
16819,2,meow,2950,536,39,30,69,56.5%,6m
16819,3,[mSlaw]Stringer,2950,1052,39,49,88,44.3%,40m
16819,3,hardwork,2950,237,36,22,58,62.1%,34m
16819,1,Kyoumadess,2950,761,26,30,56,46.4%,25m
16819,2,RobotWizard,2950,344,20,18,38,52.6%,12m
16819,2,haoxianghe,2950,431,17,13,30,56.7%,16m
16819,1,Blizzaro,2950,226,14,17,31,45.2%,33m
16819,1,fluff,2950,385,13,20,33,39.4%,4m
16819,3,Bedsoap,2950,141,13,24,37,35.1%,19m
16819,1,Throwback,2950,324,11,13,24,45.8%,44m
16819,2,GreetingLady,2950,270,9,11,20,45.0%,3m
16819,3,Nubb,2950,164,7,7,14,50.0%,26m
16819,2,Dertyreu,2950,135,6,4,10,60.0%,30m
16819,2,yucklfoultoo,2950,0,4,1,5,80.0%,35m
16819,1,Guzzington,2950,0,3,2,5,60.0%,2h
16819,3,LuciusRV,2950,94,2,0,2,100.0%,13m
16819,2,[FRKSs]busterz,2950,46,2,3,5,40.0%,2h
16819,3,Yojimbo,2950,97,1,1,2,50.0%,45m
16819,2,[Celts]Dargon,2950,30,1,2,3,33.3%,15m
16819,1,[LMDS]Tony,2950,0,1,2,3,33.3%,11m
16819,2,[ClanHs]GriZlI,2950,0,0,1,1,0.0%,41m
16819,2,projectdp,2950,0,0,2,2,0.0%,43m
16847,2,noeyes,2949,1596,177,145,322,55.0%,36m
16847,2,JDBOSU,2949,792,30,28,58,51.7%,3m
16847,2,[Pinoys]HaniSalam,2949,550,20,18,38,52.6%,26m
16847,1,Iseefor,2949,608,19,24,43,44.2%,19m
16847,2,viber,2949,468,17,11,28,60.7%,19m
16847,2,[ZTemp]ShadowZero,2949,416,16,10,26,61.5%,22m
16847,2,DOK,2949,295,13,12,25,52.0%,19m
16847,2,[OGbudz]YumShots,2949,224,8,3,11,72.7%,18m
16847,1,Valerie,2949,256,8,9,17,47.1%,10m
16847,2,[AiME]Barrena,2949,143,4,6,10,40.0%,18m
16847,1,gafferoo,2949,0,3,2,5,60.0%,7m
16847,2,RaithSensei,2949,58,2,2,4,50.0%,22m
16847,2,[Lac10]brujochilote,2949,34,2,3,5,40.0%,7m
16847,1,Jellyfish,2949,0,1,5,6,16.7%,21m
16847,1,SuperNova,2949,0,0,1,1,0.0%,25m
16847,2,Finerian,2949,0,0,2,2,0.0%,45m
16863,3,[IDoom]Harbinger,2948,1143,270,268,538,50.2%,6m
16863,1,[VEoC]newplan,2948,1334,182,169,351,51.9%,21m
16863,3,KungFu,2948,806,122,113,235,51.9%,32m
16863,1,[MEP]smegryan,2948,1567,86,79,165,52.1%,23m
16863,2,Joy,2948,947,38,29,67,56.7%,23m
16863,2,Sojourner,2948,639,30,26,56,53.6%,11m
16863,2,Aragorn,2948,646,24,20,44,54.5%,31m
16863,2,kobe,2948,364,13,20,33,39.4%,15m
16863,2,SOCCIA,2948,276,11,7,18,61.1%,12m
16863,2,Aurumai,2948,96,6,7,13,46.2%,46m
16863,2,Iggmastaflex,2948,121,5,5,10,50.0%,10m
16863,2,Bullitt,2948,88,4,2,6,66.7%,3m
16863,3,Khalu,2948,36,4,4,8,50.0%,15m
16863,2,[CHZSCT]MorphingTime,2948,112,3,0,3,100.0%,43m
16863,2,Vision,2948,0,3,2,5,60.0%,9m
16863,2,[420SMO]OneWhoRuns,2948,30,2,1,3,66.7%,12m
16863,2,[ØÛ]Noroox,2948,58,2,1,3,66.7%,24m
16863,2,karolis,2948,30,1,3,4,25.0%,45m
16863,2,WooriJib,2948,0,1,4,5,20.0%,23m
16863,2,[cl0udM]MrChaCha,2948,0,1,4,5,20.0%,35m
16863,3,Dahlmann,2948,30,1,10,11,9.1%,27m
16863,1,[Impact]ninjadog,2948,0,0,1,1,0.0%,3h
16863,2,Drigo,2948,0,0,1,1,0.0%,20m
16863,1,MaKoBlooD,2948,0,0,1,1,0.0%,5m
16863,2,[tCo9]SuperJoshua,2948,0,0,1,1,0.0%,10m
16863,2,[HBNC]puddlez,2948,0,0,2,2,0.0%,18m
16889,2,YungGooby,2947,1383,273,236,509,53.6%,10m
16889,3,sniperbolt,2947,1580,263,256,519,50.7%,14m
16889,3,Jeryhn,2947,1337,231,226,457,50.5%,31m
16889,1,[GOPERÚ]PACHAKUTEQ,2947,1478,147,128,275,53.5%,5m
16889,2,pewpew,2947,799,58,50,108,53.7%,34m
16889,2,Frosé,2947,1249,54,43,97,55.7%,43m
16889,3,zealis,2947,1190,54,63,117,46.2%,17m
16889,2,Glow,2947,1072,44,40,84,52.4%,6m
16889,1,wildebeest,2947,800,30,26,56,53.6%,42m
16889,1,Hukmoth,2947,590,21,24,45,46.7%,41m
16889,1,IIIIIIII,2947,367,16,12,28,57.1%,19m
16889,2,flaccidtuna,2947,362,15,14,29,51.7%,21m
16889,2,[NAGY]shihao,2947,314,11,10,21,52.4%,16m
16889,1,Drake,2947,200,10,4,14,71.4%,1h
16889,2,smokedleader,2947,261,9,6,15,60.0%,26m
16889,1,FKCHINAGOHK,2947,241,8,6,14,57.1%,4m
16889,2,[JaMiT]Greenknight,2947,208,6,4,10,60.0%,31m
16889,2,[haut]grep,2947,32,5,3,8,62.5%,11m
16889,2,Vindaloo,2947,33,4,6,10,40.0%,12m
16889,2,HAYVAR,2947,62,3,2,5,60.0%,13m
16889,2,Topen,2947,0,3,2,5,60.0%,41m
16889,2,KuntmalaHarr,2947,122,2,2,4,50.0%,31m
16889,1,Gabriel,2947,0,1,3,4,25.0%,14m
16889,2,[HaZaR]Infinity,2947,32,1,6,7,14.3%,18m
16889,2,Euco,2947,0,0,1,1,0.0%,13m
16889,2,Michael,2947,0,0,2,2,0.0%,7m
16915,1,Chiwasam,2946,1568,216,185,401,53.9%,18m
16915,1,[JaMiT]SyFy,2946,1555,120,110,230,52.2%,30m
16915,1,Tyler,2946,1476,81,76,157,51.6%,8m
16915,1,NOOOOOOOOOBZ,2946,1624,75,66,141,53.2%,30m
16915,1,Spudnuts,2946,762,62,57,119,52.1%,11m
16915,2,[H264]arcHon,2946,792,29,31,60,48.3%,36m
16915,2,MeatLicker,2946,514,23,26,49,46.9%,18m
16915,1,Tropiczz,2946,531,18,21,39,46.2%,33m
16915,1,Snb,2946,358,13,14,27,48.1%,42m
16915,2,[SABO]ChewChilla,2946,316,10,8,18,55.6%,30m
16915,1,[TIJUAS]superinsane,2946,256,7,12,19,36.8%,32m
16915,1,sphinx,2946,96,6,3,9,66.7%,33m
16915,1,StinG,2946,193,6,4,10,60.0%,2h
16915,2,[BORGES]Shakal,2946,138,6,6,12,50.0%,11m
16915,3,pusydestroer,2946,187,6,8,14,42.9%,11m
16915,1,DIMOED,2946,144,5,3,8,62.5%,18m
16915,2,RiceBowl,2946,0,3,2,5,60.0%,23m
16915,2,[TAILED]Noobsprinter,2946,0,3,2,5,60.0%,35m
16915,2,trenty,2946,0,3,2,5,60.0%,4m
16915,2,VraX,2946,58,2,1,3,66.7%,4m
16915,2,[BoAVN]jager,2946,68,2,3,5,40.0%,11m
16915,2,Clegger,2946,62,2,4,6,33.3%,16m
16915,2,[Poway]uwu,2946,114,2,4,6,33.3%,4m
16915,2,[Chiwua]abadon,2946,0,1,0,1,100.0%,41m
16915,1,Koro,2946,88,1,2,3,33.3%,19m
16915,2,changhavv,2946,0,0,1,1,0.0%,34m
16915,2,AlphaOmega,2946,0,0,1,1,0.0%,15m
16942,1,Niner,2945,989,179,159,338,53.0%,42m
16942,1,[ZTempz]Rachon,2945,1641,92,83,175,52.6%,15m
16942,1,Robi,2945,975,71,57,128,55.5%,43m
16942,2,Zinloos,2945,806,30,27,57,52.6%,15m
16942,2,Link,2945,536,26,24,50,52.0%,35m
16942,1,vulak,2945,261,24,24,48,50.0%,45m
16942,2,Eywa,2945,380,16,13,29,55.2%,34m
16942,2,Cosmicraider,2945,269,13,12,25,52.0%,19m
16942,2,WildWolf,2945,290,11,5,16,68.8%,7m
16942,1,Imperium,2945,314,8,12,20,40.0%,30m
16942,2,[MAYN]twitchChat,2945,154,6,3,9,66.7%,31m
16942,1,RedRuin,2945,193,6,4,10,60.0%,16m
16942,2,[EFENI]Entheas,2945,102,5,3,8,62.5%,23m
16942,2,Jackfrozt,2945,120,5,5,10,50.0%,18m
16942,1,Jon,2945,0,4,1,5,80.0%,5m
16942,2,StarRaft,2945,166,4,3,7,57.1%,15m
16942,2,Glass,2945,149,4,6,10,40.0%,21m
16942,2,[UNCO]carrsdoom,2945,88,3,2,5,60.0%,12m
16942,1,[WZ]DaKeeza,2945,88,3,3,6,50.0%,8m
16942,2,Random,2945,92,2,2,4,50.0%,29m
16942,2,lockon,2945,60,2,3,5,40.0%,13m
16942,2,kevinjoe,2945,0,1,2,3,33.3%,35m
16942,2,BigBoss,2945,0,0,1,1,0.0%,4m
16942,2,NightRaven,2945,0,0,4,4,0.0%,30m
16966,2,mat,2944,1160,94,89,183,51.4%,24m
16966,2,Hallahan,2944,1115,81,72,153,52.9%,4m
16966,1,Drumkillz,2944,1207,67,57,124,54.0%,21m
16966,1,khuaikhema,2944,887,41,28,69,59.4%,31m
16966,1,Aresmar,2944,780,37,36,73,50.7%,17m
16966,2,RyanKoeh,2944,761,35,20,55,63.6%,22m
16966,1,[clanPD]Sleepmaster,2944,750,26,26,52,50.0%,13m
16966,1,RabbiDefiler,2944,314,22,22,44,50.0%,8m
16966,1,[StheC]Apostolos,2944,503,21,16,37,56.8%,40m
16966,3,PrinterGoBrr,2944,418,20,18,38,52.6%,40m
16966,2,Spencer,2944,524,19,19,38,50.0%,10m
16966,2,[HOOKEM]BigPapi,2944,420,14,18,32,43.8%,15m
16966,2,[XTULAX]zeratulghost,2944,317,13,8,21,61.9%,18m
16966,1,Hoobawapa,2944,427,13,17,30,43.3%,5m
16966,2,opoek,2944,276,12,8,20,60.0%,28m
16966,2,Blobs,2944,248,11,7,18,61.1%,28m
16966,2,Omnia,2944,177,8,7,15,53.3%,2h
16966,2,[YLG]YinYan,2944,140,5,1,6,83.3%,6m
16966,1,Bman,2944,114,4,5,9,44.4%,24m
16966,2,willfrodo,2944,133,3,10,13,23.1%,45m
16966,1,MadKingStan,2944,89,2,2,4,50.0%,5m
16966,2,VVV,2944,60,2,3,5,40.0%,44m
16966,2,[SCST]gerrer,2944,58,2,4,6,33.3%,12m
16966,2,SpaceInvader,2944,30,1,1,2,50.0%,25m
16966,1,BLUEDEVIL,2944,0,1,2,3,33.3%,2h
16966,2,[RLA]Aether,2944,0,0,1,1,0.0%,16m
16966,2,Darkfuzion,2944,0,0,1,1,0.0%,19m
16966,1,Shivvy,2944,0,0,5,5,0.0%,18m
16994,1,Spleenface,2943,1643,332,311,643,51.6%,18m
16994,3,STYX,2943,1521,298,305,603,49.4%,34m
16994,1,cilantro,2943,1632,191,187,378,50.5%,18m
16994,1,Sandrooo,2943,1075,97,78,175,55.4%,17m
16994,1,Jun,2943,1674,84,82,166,50.6%,36m
16994,2,Advaita,2943,560,63,52,115,54.8%,17m
16994,2,VaeVictisSC,2943,1425,59,51,110,53.6%,15m
16994,2,gooki,2943,398,41,31,72,56.9%,13m
16994,2,Bonesaw,2943,937,37,34,71,52.1%,21m
16994,1,CapnRedB,2943,566,19,22,41,46.3%,27m
16994,2,RainyDays,2943,464,18,16,34,52.9%,21m
16994,1,KRCP,2943,530,17,21,38,44.7%,25m
16994,2,jaydubzsc,2943,448,16,12,28,57.1%,7m
16994,1,[UpxV]Michoalberto,2943,496,16,18,34,47.1%,42m
16994,3,[GrnBrd]OGnut,2943,333,14,10,24,58.3%,13m
16994,1,[GnR]TitsMcgee,2943,384,12,18,30,40.0%,26m
16994,2,justagoon,2943,123,9,4,13,69.2%,26m
16994,1,Benjamin,2943,202,7,11,18,38.9%,44m
16994,2,lich,2943,154,5,2,7,71.4%,22m
16994,3,BotFlamer,2943,170,5,3,8,62.5%,19m
16994,1,hydra,2943,0,4,1,5,80.0%,3m
16994,2,SuccMyGochu,2943,106,4,3,7,57.1%,16m
16994,3,[FyBs]GeNeSiS,2943,146,4,8,12,33.3%,21m
16994,1,denan,2943,110,4,10,14,28.6%,4m
16994,2,[ClanM]Ravenor,2943,60,3,1,4,75.0%,7m
16994,2,[TurNT]Coletrain,2943,60,3,2,5,60.0%,31m
16994,1,GuzzleMe,2943,0,3,2,5,60.0%,2h
16994,2,shuckles,2943,27,2,2,4,50.0%,12m
16994,2,[LgnTDS]CORNIJA,2943,60,2,3,5,40.0%,36m
16994,2,Piche,2943,0,1,0,1,100.0%,45m
16994,2,[KGH]darkpickle,2943,0,1,1,2,50.0%,24m
16994,2,[SC2BOL]RUDDY,2943,30,1,1,2,50.0%,16m
16994,2,SmokeyDragon,2943,30,1,1,2,50.0%,45m
16994,2,[8read]Bhutthead,2943,0,1,2,3,33.3%,16m
16994,2,RandyBobandy,2943,0,0,1,1,0.0%,35m
17029,1,YawningPoet,2942,1371,74,68,142,52.1%,36m
17029,2,Irootoko,2942,416,24,22,46,52.2%,26m
17029,2,[MZD]Slanish,2942,333,12,8,20,60.0%,6m
17029,2,Nattura,2942,190,11,1,12,91.7%,35m
17029,2,Electro,2942,311,11,8,19,57.9%,12m
17029,1,FUNK,2942,284,8,15,23,34.8%,5m
17029,2,SiegfrieD,2942,212,7,3,10,70.0%,12m
17029,2,NoName,2942,168,7,10,17,41.2%,11m
17029,2,SupBoy,2942,176,6,1,7,85.7%,5m
17029,1,dejavuu,2942,214,6,11,17,35.3%,30m
17029,1,Fern,2942,74,5,6,11,45.5%,5m
17029,2,[KofW]TheSandman,2942,114,4,3,7,57.1%,10m
17029,2,GNAK,2942,0,3,2,5,60.0%,5m
17029,2,[RknStn]Alusletle,2942,0,3,2,5,60.0%,31m
17029,2,Butch,2942,0,3,2,5,60.0%,15m
17029,2,[sk3tch]MRGoldenPaws,2942,0,1,0,1,100.0%,45m
17029,2,[glgghf]Illidan,2942,0,1,0,1,100.0%,11m
17029,2,[Atena]commonbile,2942,30,1,1,2,50.0%,23m
17029,2,Durotar,2942,30,1,1,2,50.0%,35m
17029,2,WalrusCow,2942,30,1,3,4,25.0%,17m
17029,2,Alfa,2942,0,0,1,1,0.0%,4m
17029,2,[HighKo]TheBlank,2942,0,0,1,1,0.0%,12m
17029,2,THEFALLENONE,2942,0,0,1,1,0.0%,5m
17052,1,Moon,2941,1510,379,349,728,52.1%,8m
17052,3,AchachR,2941,1531,171,182,353,48.4%,17m
17052,2,Anxthz,2941,982,108,91,199,54.3%,10m
17052,2,Darklo,2941,1427,88,70,158,55.7%,7m
17052,2,Radfiddler,2941,1038,70,47,117,59.8%,27m
17052,1,axel,2941,1542,66,65,131,50.4%,33m
17052,1,Rezz,2941,1491,62,58,120,51.7%,19m
17052,2,[WWP2]Hinzuuki,2941,493,21,13,34,61.8%,1m
17052,2,VonOnagi,2941,393,18,10,28,64.3%,30m
17052,2,GenSwift,2941,496,18,17,35,51.4%,32m
17052,2,Jarjarbinks,2941,398,16,9,25,64.0%,31m
17052,1,lllllllll,2941,372,10,19,29,34.5%,2m
17052,3,[Chrisp]AngrySheep,2941,237,9,5,14,64.3%,23m
17052,1,zaboomafoo,2941,174,6,1,7,85.7%,14m
17052,1,losthack,2941,68,5,5,10,50.0%,34m
17052,3,NightHawk,2941,181,4,1,5,80.0%,15m
17052,2,Beekz,2941,88,4,3,7,57.1%,41m
17052,1,ILoveGold,2941,88,4,3,7,57.1%,32m
17052,1,MetaGP,2941,120,3,1,4,75.0%,38m
17052,2,Water,2941,0,3,2,5,60.0%,11m
17052,2,JACK,2941,0,3,2,5,60.0%,5m
17052,1,Thrasher,2941,0,2,2,4,50.0%,2h
17052,1,Kalmarian,2941,0,1,0,1,100.0%,3h
17052,1,Victor,2941,0,1,1,2,50.0%,2h
17052,1,[FL4G]OakenBorn,2941,97,1,1,2,50.0%,2h
17052,2,evarlast,2941,0,1,2,3,33.3%,3m
17052,2,[SMHC]XilentSKY,2941,32,1,3,4,25.0%,35m
17079,2,[usbr]Broformist,2940,1455,118,92,210,56.2%,41m
17079,2,Supremo,2940,1381,61,44,105,58.1%,43m
17079,2,[GDKND]DeathLotus,2940,1097,59,43,102,57.8%,4m
17079,2,SonnyDeez,2940,1044,42,34,76,55.3%,6m
17079,2,WhiteWolf,2940,992,38,38,76,50.0%,31m
17079,2,KimJongSkill,2940,571,23,24,47,48.9%,5m
17079,2,[sOLsc]Zeiko,2940,344,21,27,48,43.8%,24m
17079,2,[lober]Shadowmeteor,2940,464,18,11,29,62.1%,14m
17079,2,Fallout,2940,347,14,19,33,42.4%,21m
17079,1,Lila,2940,352,13,13,26,50.0%,17m
17079,2,brachyspira,2940,272,10,11,21,47.6%,18m
17079,1,[TX]ChuckWagon,2940,282,9,12,21,42.9%,21m
17079,1,TaeKwonDOH,2940,132,8,6,14,57.1%,31m
17079,3,Meteor,2940,184,7,5,12,58.3%,33m
17079,2,[st0bs]CupCokeYum,2940,179,5,8,13,38.5%,35m
17079,2,Cress,2940,86,4,1,5,80.0%,18m
17079,1,[SLATT]drifted,2940,0,4,2,6,66.7%,2h
17079,3,BroodWarrior,2940,0,4,3,7,57.1%,1h
17079,2,Vincini,2940,60,3,3,6,50.0%,43m
17079,2,Iplayfalcon,2940,30,2,1,3,66.7%,36m
17079,2,[CAM]KingKhano,2940,58,2,1,3,66.7%,19m
17079,1,SmellyButt,2940,78,2,12,14,14.3%,11m
17079,2,crispyapples,2940,0,1,0,1,100.0%,21m
17079,2,XXTASY,2940,0,1,0,1,100.0%,2h
17079,2,LiChInGu,2940,0,1,0,1,100.0%,22m
17079,1,Red,2940,0,1,0,1,100.0%,2h
17079,2,BlazingNinja,2940,30,1,1,2,50.0%,25m
17079,2,Drago,2940,0,0,1,1,0.0%,5m
17079,2,BizLeZ,2940,0,0,1,1,0.0%,18m
17079,2,[Bee]holepercent,2940,0,0,1,1,0.0%,18m
17079,2,SpideyJohn,2940,0,0,2,2,0.0%,4m
17110,2,Bytor,2939,1514,282,259,541,52.1%,22m
17110,3,Resol,2939,1445,279,292,571,48.9%,43m
17110,1,Conos,2939,1186,167,157,324,51.5%,34m
17110,2,KetamineYoda,2939,1035,62,46,108,57.4%,29m
17110,3,cassius,2939,392,13,26,39,33.3%,15m
17110,2,[AngDem]Artainis,2939,360,12,13,25,48.0%,12m
17110,2,[Gr33zy]Skipper,2939,330,11,9,20,55.0%,21m
17110,2,nightknight,2939,194,8,4,12,66.7%,27m
17110,2,Deluzio,2939,232,8,8,16,50.0%,21m
17110,2,SourVegie,2939,136,6,5,11,54.5%,25m
17110,1,ALEXAVIER,2939,97,5,1,6,83.3%,2h
17110,2,Artanis,2939,168,5,2,7,71.4%,28m
17110,1,[JRB]Henri,2939,32,5,3,8,62.5%,28m
17110,2,Ira,2939,114,5,5,10,50.0%,35m
17110,1,TheKingMoose,2939,179,4,8,12,33.3%,31m
17110,2,Sakthepro,2939,0,3,2,5,60.0%,35m
17110,2,Gooz,2939,40,2,3,5,40.0%,45m
17110,2,DaTooth,2939,0,1,1,2,50.0%,31m
17110,1,CUTTERS,2939,97,1,1,2,50.0%,27m
17110,1,GreasyJoe,2939,0,1,4,5,20.0%,32m
17110,2,Medved,2939,30,1,4,5,20.0%,13m
17110,2,Lastresort,2939,0,0,1,1,0.0%,19m
17110,2,lunajrq,2939,0,0,1,1,0.0%,44m
17133,1,blay,2938,1465,116,114,230,50.4%,11m
17133,1,CabaggeRed,2938,1555,95,91,186,51.1%,11m
17133,2,nkiixv,2938,1373,65,40,105,61.9%,27m
17133,1,OGguapoh,2938,614,58,54,112,51.8%,42m
17133,2,DeFogo,2938,958,40,30,70,57.1%,1m
17133,2,oldmadcrazy,2938,251,39,33,72,54.2%,34m
17133,1,Zealot,2938,550,27,14,41,65.9%,30m
17133,2,Enzo,2938,624,23,19,42,54.8%,17m
17133,2,ECROM,2938,508,21,11,32,65.6%,34m
17133,2,evilme,2938,411,17,13,30,56.7%,22m
17133,1,Shmelly,2938,384,17,16,33,51.5%,15m
17133,2,gostking,2938,328,14,8,22,63.6%,24m
17133,2,mageetheg,2938,262,9,10,19,47.4%,22m
17133,1,[REPORT]PlayDaMasta,2938,286,9,15,24,37.5%,10m
17133,2,[AbcCo]UnGato,2938,204,7,7,14,50.0%,3m
17133,2,[DarkLS]hamburguesa,2938,216,7,10,17,41.2%,41m
17133,3,Mars,2938,171,6,5,11,54.5%,13m
17133,1,Gugi,2938,48,4,3,7,57.1%,45m
17133,2,barcode,2938,62,3,1,4,75.0%,20m
17133,2,DarkCloud,2938,0,3,2,5,60.0%,23m
17133,1,KOR,2938,0,1,0,1,100.0%,2h
17133,3,[kayi]Wazza,2938,34,1,2,3,33.3%,2h
17133,2,Lynx,2938,30,1,3,4,25.0%,18m
17133,2,[ZTempz]Taucer,2938,0,0,1,1,0.0%,13m
17133,2,[TGPT]MLPTrixie,2938,0,0,1,1,0.0%,7m
17133,2,[Amb3rs]Michael,2938,0,0,1,1,0.0%,35m
17133,1,ImmortalOrc,2938,0,0,2,2,0.0%,2h
17133,2,IIIIIIIIIIII,2938,0,0,2,2,0.0%,23m
17133,1,Coffee,2938,0,0,4,4,0.0%,5m
17162,1,KEN,2937,939,117,96,213,54.9%,34m
17162,1,[SFx]Iporazzam,2937,1608,105,100,205,51.2%,5m
17162,2,kalimba,2937,1027,57,51,108,52.8%,12m
17162,2,DiamondKing,2937,906,38,31,69,55.1%,32m
17162,2,BOLIVIAFORCE,2937,669,26,19,45,57.8%,26m
17162,2,nobody,2937,676,25,26,51,49.0%,5m
17162,2,KpOweRN,2937,591,24,19,43,55.8%,34m
17162,2,TesseracT,2937,594,22,20,42,52.4%,23m
17162,2,Alejandrvilc,2937,382,15,11,26,57.7%,28m
17162,2,GoodByeUSA,2937,250,14,10,24,58.3%,23m
17162,2,Apple,2937,373,14,12,26,53.8%,43m
17162,2,[Cryptc]RagnarDnskld,2937,420,14,17,31,45.2%,22m
17162,2,WolfGang,2937,154,13,7,20,65.0%,24m
17162,2,obeyHim,2937,328,12,8,20,60.0%,31m
17162,2,gambitmonk,2937,314,12,11,23,52.2%,11m
17162,2,IENJOYSTDS,2937,262,9,8,17,52.9%,5m
17162,1,Achilles,2937,97,4,3,7,57.1%,18m
17162,1,DrFranco,2937,96,4,4,8,50.0%,2h
17162,1,Zatch,2937,0,3,2,5,60.0%,1h
17162,2,[xRtGac]Goob,2937,0,1,1,2,50.0%,12m
17162,2,NIXED,2937,88,1,1,2,50.0%,5m
17162,2,chris,2937,30,1,2,3,33.3%,20m
17162,2,[lefuk]LePeq,2937,34,1,2,3,33.3%,16m
17162,2,Salchaket,2937,0,0,2,2,0.0%,27m
17162,3,[RdLzrd]SinkSwim,2937,0,0,7,7,0.0%,2h
17187,3,TheDude,2936,1412,349,360,709,49.2%,8m
17187,2,Exo,2936,1614,270,241,511,52.8%,14m
17187,1,[TFGID]Dreknal,2936,1000,45,36,81,55.6%,1m
17187,1,[DarkPG]Mardowyn,2936,917,36,33,69,52.2%,2m
17187,1,ToiletPaper,2936,589,23,19,42,54.8%,1m
17187,1,Vuk,2936,603,20,28,48,41.7%,19m
17187,3,KittyLove,2936,516,19,20,39,48.7%,14m
17187,2,zigbey,2936,477,17,12,29,58.6%,19m
17187,3,Rave,2936,392,15,22,37,40.5%,43m
17187,2,[DarkAG]Meta,2936,208,8,7,15,53.3%,31m
17187,2,amipooping,2936,225,7,6,13,53.8%,4m
17187,2,Blanck,2936,118,5,3,8,62.5%,14m
17187,2,TMfromPL,2936,58,5,4,9,55.6%,27m
17187,3,SWARM,2936,198,5,12,17,29.4%,22m
17187,1,[IGCOYF]Spencer,2936,0,3,2,5,60.0%,7m
17187,2,FreeStyle,2936,0,3,2,5,60.0%,17m
17187,1,Brightside,2936,103,2,3,5,40.0%,13m
17187,2,Teronius,2936,0,1,0,1,100.0%,19m
17187,1,voldemort,2936,0,0,1,1,0.0%,2h
17187,2,[BEEBOY]Antonicus,2936,0,0,1,1,0.0%,16m
17187,2,skadoosh,2936,0,0,1,1,0.0%,34m
17208,3,Lancefer,2935,749,94,83,177,53.1%,20m
17208,1,[sk3tch]theman,2935,1101,41,44,85,48.2%,7m
17208,2,Freezingsoul,2935,582,24,23,47,51.1%,23m
17208,1,[JJPOOR]UzziDarwesh,2935,534,20,20,40,50.0%,24m
17208,2,Edge,2935,261,18,12,30,60.0%,11m
17208,1,rain,2935,348,11,14,25,44.0%,25m
17208,2,[HaMz]yrrebeulb,2935,270,9,9,18,50.0%,2h
17208,3,CumBuble,2935,197,7,6,13,53.8%,2h
17208,1,JAEHYUK,2935,174,5,5,10,50.0%,42m
17208,2,Foe,2935,136,4,0,4,100.0%,1m
17208,2,[Thong]WWWWWWWWWWWW,2935,86,3,3,6,50.0%,7m
17208,1,[Abncay]Aedys,2935,38,3,6,9,33.3%,34m
17208,2,[DRKFOX]XUPAK,2935,30,2,4,6,33.3%,35m
17208,2,[SIClan]DARTHDALEK,2935,0,1,0,1,100.0%,35m
17208,2,pijaman,2935,30,1,1,2,50.0%,11m
17208,2,sqaz,2935,0,0,2,2,0.0%,43m
17224,1,[MPE]Calamardo,2934,1626,201,200,401,50.1%,13m
17224,3,SpiritFriend,2934,1032,195,176,371,52.6%,31m
17224,1,[4444]Cheese,2934,1524,160,156,316,50.6%,8m
17224,2,SangueNoZoio,2934,1532,100,84,184,54.3%,35m
17224,2,Psychonaut,2934,1557,88,80,168,52.4%,9m
17224,2,Treher,2934,1223,76,70,146,52.1%,26m
17224,1,JeanValjean,2934,1069,50,47,97,51.5%,27m
17224,3,[INHNJA]Thewarhammer,2934,334,47,43,90,52.2%,15m
17224,2,[cl0udM]Prismatic,2934,1053,44,34,78,56.4%,12m
17224,2,[GRNSKN]DLCForcesTTV,2934,674,39,20,59,66.1%,45m
17224,2,[GnR]Robot,2934,190,29,16,45,64.4%,16m
17224,2,trunks,2934,404,16,12,28,57.1%,2m
17224,1,tigre,2934,172,15,19,34,44.1%,21m
17224,2,MarCraft,2934,348,14,7,21,66.7%,9m
17224,3,[peepoC]Cascade,2934,326,13,18,31,41.9%,30m
17224,1,[VENSC2]JerVzla,2934,208,7,14,21,33.3%,21m
17224,1,[QTp2T]Felicity,2934,214,7,17,24,29.2%,11m
17224,1,blink,2934,36,5,3,8,62.5%,31m
17224,1,Farhao,2934,162,5,7,12,41.7%,25m
17224,2,Mariano,2934,149,5,7,12,41.7%,2h
17224,2,[Albino]ItsHappening,2934,140,4,2,6,66.7%,3h
17224,3,KEKW,2934,38,4,6,10,40.0%,25m
17224,2,[CRAKS]Hector,2934,60,3,1,4,75.0%,19m
17224,2,[0H10]Fishsticks,2934,0,3,2,5,60.0%,9m
17224,2,fartburn,2934,30,2,3,5,40.0%,5m
17224,2,Deathskippy,2934,96,2,4,6,33.3%,11m
17224,2,[Ling03]TBatlas,2934,0,1,0,1,100.0%,45m
17224,1,SUPETEN,2934,0,1,0,1,100.0%,18m
17224,2,mongo,2934,0,1,2,3,33.3%,2h
17224,2,dilondon,2934,42,1,2,3,33.3%,2h
17224,1,UMADBRO,2934,0,0,1,1,0.0%,1h
17224,2,Stouticuss,2934,0,0,1,1,0.0%,18m
17224,2,[YSP]Shiro,2934,0,0,1,1,0.0%,17m
17224,1,Scrublet,2934,0,0,1,1,0.0%,2h
17224,1,Mars,2934,0,0,3,3,0.0%,40m
17224,3,proskilla,2934,0,0,12,12,0.0%,30m
17260,1,Tuga,2933,1639,255,246,501,50.9%,30m
17260,1,codered,2933,1613,181,185,366,49.5%,19m
17260,2,dabers,2933,1539,164,153,317,51.7%,2m
17260,1,Bunder,2933,1528,153,149,302,50.7%,19m
17260,2,Blue,2933,682,134,124,258,51.9%,15m
17260,2,Woogs,2933,1606,133,120,253,52.6%,26m
17260,2,Rioking,2933,226,95,73,168,56.5%,16m
17260,1,Dugiker,2933,1404,82,76,158,51.9%,31m
17260,2,[6ixS]quaranscheme,2933,1390,60,49,109,55.0%,31m
17260,2,choiiiboiii,2933,909,56,48,104,53.8%,43m
17260,2,GammaRae,2933,966,42,32,74,56.8%,15m
17260,2,iJoKeRi,2933,812,35,23,58,60.3%,26m
17260,2,JTKmonkey,2933,495,21,14,35,60.0%,16m
17260,1,[Taasty]Cocothunda,2933,624,19,25,44,43.2%,7m
17260,1,coldcuttrae,2933,334,13,12,25,52.0%,31m
17260,2,DarkyiesLord,2933,256,9,10,19,47.4%,34m
17260,2,AlexDanilo,2933,104,5,4,9,55.6%,19m
17260,2,RaccoonV,2933,0,4,1,5,80.0%,44m
17260,1,bugu,2933,97,4,2,6,66.7%,12m
17260,1,DrewBdew,2933,48,4,3,7,57.1%,2h
17260,2,[VlPeRz]SkullStew,2933,120,4,5,9,44.4%,23m
17260,2,henari,2933,122,4,8,12,33.3%,12m
17260,2,tkadwell,2933,0,3,2,5,60.0%,19m
17260,1,dReamOn,2933,85,2,5,7,28.6%,3m
17260,2,Nguyenth,2933,88,2,7,9,22.2%,2h
17260,2,offset,2933,0,1,0,1,100.0%,32m
17260,2,bigrob,2933,0,1,0,1,100.0%,35m
17260,2,[TheReg]Couscous,2933,0,1,2,3,33.3%,25m
17288,1,ethos,2932,546,137,133,270,50.7%,43m
17288,1,ZiSAlex,2932,1507,100,91,191,52.4%,44m
17288,1,cacharpo,2932,1648,77,76,153,50.3%,31m
17288,3,Microangelo,2932,1433,58,75,133,43.6%,46m
17288,1,GetBONKED,2932,551,54,51,105,51.4%,1m
17288,3,Lua,2932,1070,40,46,86,46.5%,6m
17288,1,RoLDy,2932,745,37,36,73,50.7%,2m
17288,2,Blank,2932,709,35,16,51,68.6%,18m
17288,1,RuZted,2932,893,29,34,63,46.0%,2m
17288,2,DistantDeath,2932,603,26,14,40,65.0%,19m
17288,2,[Exper]Hasziel,2932,564,21,19,40,52.5%,41m
17288,2,DeathStriker,2932,448,16,16,32,50.0%,5m
17288,2,Brynxi,2932,379,14,14,28,50.0%,19m
17288,2,DwayneBarry,2932,272,12,7,19,63.2%,2h
17288,2,xZTzl,2932,226,10,7,17,58.8%,43m
17288,2,Johny,2932,200,8,8,16,50.0%,14m
17288,2,BluePanda,2932,119,6,4,10,60.0%,16m
17288,2,SoapEater,2932,174,6,6,12,50.0%,3m
17288,1,[LY]millionthant,2932,254,6,11,17,35.3%,6m
17288,2,TheslaveD,2932,146,5,6,11,45.5%,41m
17288,1,Ayax,2932,0,4,2,6,66.7%,43m
17288,3,Hastatii,2932,97,4,4,8,50.0%,43m
17288,2,Meeeet,2932,122,4,4,8,50.0%,43m
17288,2,Theifz,2932,120,3,1,4,75.0%,43m
17288,1,TheWhaler,2932,0,3,2,5,60.0%,2h
17288,2,frigox,2932,0,3,2,5,60.0%,31m
17288,1,[FFTC]ecotec,2932,95,3,10,13,23.1%,21m
17288,1,Mëdüsðzðå,2932,90,2,1,3,66.7%,11m
17288,2,Mustack,2932,66,2,6,8,25.0%,22m
17288,1,Pepega,2932,0,1,0,1,100.0%,2h
17288,2,Taeyeon,2932,0,1,0,1,100.0%,24m
17288,2,GoodBoy,2932,0,1,1,2,50.0%,19m
17288,2,[Calx]Chambito,2932,30,1,3,4,25.0%,46m
17288,2,taylorx,2932,0,0,1,1,0.0%,35m
17288,2,Kwanana,2932,0,0,1,1,0.0%,35m
17323,3,Lampshade,2931,1312,151,151,302,50.0%,4m
17323,2,Omelette,2931,1473,86,62,148,58.1%,22m
17323,2,SpaceFroggy,2931,944,86,79,165,52.1%,31m
17323,2,Felix,2931,816,48,38,86,55.8%,11m
17323,2,Runningbear,2931,902,45,38,83,54.2%,5m
17323,2,Steven,2931,318,36,30,66,54.5%,29m
17323,2,[Exper]JuanPlatanit,2931,299,13,4,17,76.5%,3m
17323,3,bLue,2931,327,13,11,24,54.2%,34m
17323,1,Rayzer,2931,238,7,8,15,46.7%,19m
17323,1,ItsReRay,2931,224,6,13,19,31.6%,25m
17323,1,[LOHs]Wraggles,2931,154,5,7,12,41.7%,31m
17323,2,comandocxcxc,2931,126,4,1,5,80.0%,16m
17323,2,venim,2931,81,4,7,11,36.4%,34m
17323,2,Gerard,2931,0,3,2,5,60.0%,2m
17323,2,ORION,2931,0,3,2,5,60.0%,5m
17323,2,Maxlin,2931,0,3,2,5,60.0%,23m
17323,2,TZangetsu,2931,30,2,2,4,50.0%,7m
17323,2,HardTime,2931,94,1,2,3,33.3%,29m
17323,3,[WF]Tucker,2931,0,0,1,1,0.0%,1h
17323,2,Thrawn,2931,0,0,2,2,0.0%,16m
17343,1,fer,2930,1645,130,117,247,52.6%,19m
17343,1,Dani,2930,1620,117,87,204,57.4%,31m
17343,2,illy,2930,1626,88,85,173,50.9%,26m
17343,1,Krat,2930,554,52,43,95,54.7%,31m
17343,2,JOY,2930,1282,50,45,95,52.6%,35m
17343,1,SpiritnBlack,2930,1078,45,51,96,46.9%,17m
17343,1,ClpHewitt,2930,786,32,34,66,48.5%,34m
17343,2,Pistol,2930,337,30,25,55,54.5%,19m
17343,2,Neeb,2930,656,23,29,52,44.2%,10m
17343,2,Yami,2930,282,11,12,23,47.8%,34m
17343,2,DiamondSutra,2930,341,11,13,24,45.8%,36m
17343,2,Rize,2930,210,7,8,15,46.7%,13m
17343,2,Shine,2930,0,3,2,5,60.0%,15m
17343,3,murkleston,2930,30,3,8,11,27.3%,14m
17343,2,Kavskar,2930,34,2,0,2,100.0%,17m
17343,3,CancerESTJ,2930,96,2,1,3,66.7%,31m
17343,2,Jondar,2930,112,2,2,4,50.0%,9m
17343,2,maujimsal,2930,30,2,3,5,40.0%,32m
17343,2,IIIIIIIIIIII,2930,58,2,3,5,40.0%,24m
17343,3,WgnDrgn,2930,0,1,0,1,100.0%,3h
17343,1,Markartur,2930,0,1,0,1,100.0%,1h
17343,2,Slicy,2930,0,1,2,3,33.3%,23m
17343,2,beatboxbear,2930,30,1,5,6,16.7%,45m
17343,2,[GGu2EZ]GhettoSmurf,2930,0,0,1,1,0.0%,21m
17367,1,Garth,2929,1586,330,300,630,52.4%,2m
17367,1,[ZpaceX]miAmor,2929,1356,218,215,433,50.3%,7m
17367,2,CHUNCHUNMARU,2929,1334,71,50,121,58.7%,29m
17367,2,BIGsad,2929,1151,54,34,88,61.4%,11m
17367,2,Lennox,2929,826,47,41,88,53.4%,17m
17367,2,[ARGSC]Rencarnate,2929,444,45,35,80,56.2%,22m
17367,2,zzz,2929,144,15,5,20,75.0%,29m
17367,1,Derailleur,2929,314,10,18,28,35.7%,36m
17367,2,Basicallly,2929,196,8,7,15,53.3%,11m
17367,2,djtoastytoes,2929,204,7,10,17,41.2%,45m
17367,2,ChubbyCheeto,2929,64,5,5,10,50.0%,45m
17367,1,[77WEST]Laymonane,2929,48,4,4,8,50.0%,2h
17367,1,TheTool,2929,170,4,5,9,44.4%,2h
17367,1,DarthBalls,2929,145,3,2,5,60.0%,33m
17367,3,Vampyro,2929,114,3,4,7,42.9%,19m
17367,2,skyhuayra,2929,64,3,4,7,42.9%,7m
17367,1,Psyduck,2929,80,2,8,10,20.0%,10m
17367,1,BRtist,2929,0,1,0,1,100.0%,27m
17367,1,[VFam]Wookieson,2929,0,1,0,1,100.0%,2h
17367,2,[Sobro]Raynor,2929,92,1,4,5,20.0%,35m
17367,2,Crowdotexe,2929,0,0,1,1,0.0%,3m
17367,2,[D3m0N]Shadow,2929,0,0,1,1,0.0%,27m
17367,1,Phronesis,2929,0,0,9,9,0.0%,36m
17390,1,[Drug]ColdChi,2928,1664,118,115,233,50.6%,20m
17390,2,[DFWU]HateGames,2928,1149,109,81,190,57.4%,21m
17390,2,ATLien,2928,390,76,61,137,55.5%,36m
17390,2,LiOH,2928,1046,70,73,143,49.0%,11m
17390,1,dunkedon,2928,929,35,34,69,50.7%,8m
17390,1,krey,2928,538,34,35,69,49.3%,32m
17390,1,Hawkeye,2928,956,32,37,69,46.4%,32m
17390,3,VALAR,2928,625,31,43,74,41.9%,4m
17390,2,Slicer,2928,672,27,21,48,56.2%,29m
17390,2,javiboltdas,2928,568,24,18,42,57.1%,44m
17390,1,soco,2928,560,17,22,39,43.6%,8m
17390,1,mikoohij,2928,402,14,11,25,56.0%,1m
17390,3,HavocWreaker,2928,290,14,16,30,46.7%,25m
17390,2,camelfarmer,2928,119,11,4,15,73.3%,26m
17390,2,Striker,2928,270,10,6,16,62.5%,7m
17390,1,Danyel,2928,305,9,12,21,42.9%,8m
17390,2,Azrapsel,2928,168,8,9,17,47.1%,11m
17390,1,[Cheees]Daniel,2928,256,8,11,19,42.1%,40m
17390,2,StarWolf,2928,152,4,3,7,57.1%,7m
17390,1,Phili,2928,88,4,4,8,50.0%,27m
17390,2,[FPS]LifeBlood,2928,129,3,2,5,60.0%,2h
17390,2,Squid,2928,0,3,2,5,60.0%,29m
17390,1,Leftarms,2928,0,3,3,6,50.0%,46m
17390,1,ketherio,2928,0,1,0,1,100.0%,12m
17390,2,Reldes,2928,0,0,2,2,0.0%,19m
17415,1,[SC2BOL]Edward,2927,1589,198,193,391,50.6%,13m
17415,2,Peregrinus,2927,1555,170,170,340,50.0%,12m
17415,3,ifomas,2927,376,89,82,171,52.0%,15m
17415,1,coldhand,2927,1155,51,51,102,50.0%,44m
17415,2,[PPTr]SpruceTurtle,2927,498,34,22,56,60.7%,24m
17415,1,JustAnother,2927,515,34,35,69,49.3%,2m
17415,1,Doggie,2927,804,29,30,59,49.2%,36m
17415,2,Angrycow,2927,567,26,18,44,59.1%,35m
17415,2,ZumbaArg,2927,420,15,11,26,57.7%,20m
17415,2,BIANG,2927,334,15,13,28,53.6%,35m
17415,2,darkmage,2927,386,14,14,28,50.0%,18m
17415,2,abcdefghijkl,2927,229,11,13,24,45.8%,27m
17415,2,[NKINGS]DemonNinja,2927,334,11,15,26,42.3%,35m
17415,3,Rareform,2927,192,7,5,12,58.3%,2h
17415,2,Macpie,2927,256,7,8,15,46.7%,3h
17415,1,[QTp2T]ARc,2927,184,6,11,17,35.3%,5m
17415,2,Veinz,2927,94,5,3,8,62.5%,18m
17415,1,Odiseo,2927,146,5,11,16,31.2%,8m
17415,2,Zadkiel,2927,140,4,1,5,80.0%,21m
17415,2,[NPhase]Kmerengetsum,2927,126,3,1,4,75.0%,21m
17415,2,gnostic,2927,0,3,2,5,60.0%,19m
17415,2,Moose,2927,112,2,1,3,66.7%,41m
17415,1,theweagls,2927,68,2,8,10,20.0%,4m
17415,1,[LimaSC]KaMui,2927,40,2,9,11,18.2%,33m
17415,2,[Steve1]Steveatron,2927,30,1,1,2,50.0%,19m
17415,2,EquiNoX,2927,0,0,1,1,0.0%,16m
17415,2,MrSunrise,2927,0,0,1,1,0.0%,35m
17415,2,jjmm,2927,0,0,1,1,0.0%,46m
17415,2,Defadog,2927,0,0,2,2,0.0%,34m
17444,2,Naethon,2926,1586,181,167,348,52.0%,29m
17444,1,prChaos,2926,1242,104,105,209,49.8%,36m
17444,2,Slavczar,2926,1186,68,60,128,53.1%,22m
17444,2,robotninja,2926,1157,50,34,84,59.5%,22m
17444,2,Juul,2926,522,19,16,35,54.3%,13m
17444,2,ReDDoG,2926,265,12,9,21,57.1%,24m
17444,1,Smykea,2926,288,11,10,21,52.4%,18m
17444,2,[0GFY0]Lateralus,2926,30,4,3,7,57.1%,21m
17444,2,[FTTD]sLyMeR,2926,128,4,5,9,44.4%,6m
17444,1,EzxrageUls,2926,0,3,2,5,60.0%,36m
17444,1,Nugg,2926,0,3,3,6,50.0%,2h
17444,2,[BAAF]wargazmz,2926,0,1,0,1,100.0%,12m
17444,2,pikachu,2926,0,1,0,1,100.0%,24m
17444,2,Halcyon,2926,0,1,0,1,100.0%,31m
17444,1,[Four2o]jamchgo,2926,42,1,1,2,50.0%,2h
17444,2,[Vulk]WALTERO,2926,0,1,1,2,50.0%,21m
17444,3,medusa,2926,97,1,1,2,50.0%,3h
17444,2,hungphan,2926,0,1,1,2,50.0%,22m
17444,2,GGDduLL,2926,30,1,3,4,25.0%,12m
17444,2,iMPRo,2926,88,1,5,6,16.7%,43m
17444,2,ridik,2926,0,0,1,1,0.0%,22m
17444,2,[XpKAc]alvarojurado,2926,0,0,1,1,0.0%,24m
17466,1,[XpKAc]Mak,2925,1577,111,96,207,53.6%,4m
17466,1,Bicboooi,2925,989,52,48,100,52.0%,21m
17466,2,shadowwaddle,2925,1127,47,34,81,58.0%,21m
17466,1,SkullCapVR,2925,1190,44,45,89,49.4%,30m
17466,2,[AD3C]ZeraTulKinG,2925,388,37,22,59,62.7%,27m
17466,2,SuedePritch,2925,533,34,28,62,54.8%,1m
17466,2,Sideburnz,2925,469,29,25,54,53.7%,34m
17466,2,SkynetII,2925,561,18,20,38,47.4%,35m
17466,2,Faded,2925,400,17,9,26,65.4%,36m
17466,2,Gaijin,2925,391,15,12,27,55.6%,19m
17466,2,jeanuxi,2925,382,13,12,25,52.0%,16m
17466,2,[PwnCat]MrBojangles,2925,275,11,9,20,55.0%,29m
17466,2,Jangus,2925,167,7,1,8,87.5%,35m
17466,2,Plasma,2925,164,7,5,12,58.3%,12m
17466,1,[wyd420]Omar,2925,251,7,7,14,50.0%,2h
17466,2,[PREGG]SpartanG,2925,94,4,5,9,44.4%,35m
17466,2,oDiNe,2925,118,4,5,9,44.4%,29m
17466,1,Trogdor,2925,106,4,8,12,33.3%,7m
17466,2,Fino,2925,128,4,8,12,33.3%,17m
17466,2,[SunTzu]FSGCastiel,2925,94,3,3,6,50.0%,24m
17466,2,[biboi]NecroN,2925,94,3,7,10,30.0%,46m
17466,2,Micfetzer,2925,88,2,0,2,100.0%,16m
17466,1,jayber,2925,48,2,1,3,66.7%,2h
17466,2,BigTepija,2925,30,1,2,3,33.3%,16m
17466,1,Talkmix,2925,94,1,3,4,25.0%,2h
17466,2,Garett,2925,30,1,3,4,25.0%,16m
17466,3,[mtcL]zerg,2925,0,0,1,1,0.0%,37m
17466,2,WNTRALEX,2925,0,0,1,1,0.0%,27m
17466,2,Endless,2925,0,0,1,1,0.0%,36m
17495,2,Steel,2924,1629,222,204,426,52.1%,20m
17495,2,BalanceSheet,2924,1519,70,54,124,56.5%,35m
17495,2,[GGCL]Paradojamc,2924,1150,66,59,125,52.8%,17m
17495,1,lilTRexArms,2924,1508,59,59,118,50.0%,11m
17495,2,NavinJohnson,2924,937,42,27,69,60.9%,11m
17495,1,[EpicG]Fantom,2924,1040,40,39,79,50.6%,21m
17495,2,[Macac0]Oturanx,2924,840,32,30,62,51.6%,11m
17495,3,Lister,2924,751,30,29,59,50.8%,13m
17495,2,Sodacan,2924,672,26,24,50,52.0%,35m
17495,1,bru,2924,546,22,20,42,52.4%,9m
17495,2,Arrhythmia,2924,638,22,27,49,44.9%,13m
17495,1,[T3rT0s]SwiftNoca,2924,577,17,23,40,42.5%,15m
17495,2,fate,2924,373,14,12,26,53.8%,12m
17495,2,Kragorix,2924,290,10,13,23,43.5%,31m
17495,1,[FDK]Mayhem,2924,349,10,14,24,41.7%,9m
17495,2,localhoney,2924,209,9,1,10,90.0%,1m
17495,2,BennyBlanco,2924,168,6,2,8,75.0%,16m
17495,3,[iGOSU]PillClinton,2924,170,6,5,11,54.5%,44m
17495,2,DanVader,2924,110,6,5,11,54.5%,20m
17495,1,HoTCHoCo,2924,96,5,4,9,55.6%,17m
17495,3,Killberos,2924,185,5,5,10,50.0%,1h
17495,1,IAMCHEESEND,2924,121,5,5,10,50.0%,18m
17495,1,[SCX2]Rooncardo,2924,138,4,11,15,26.7%,4m
17495,2,ytteyzjs,2924,112,3,0,3,100.0%,21m
17495,1,Silver,2924,0,3,2,5,60.0%,8m
17495,2,[juggr]PinkFloyd,2924,58,3,4,7,42.9%,42m
17495,2,NYK,2924,0,2,1,3,66.7%,35m
17495,2,OmfgLaaggg,2924,58,2,2,4,50.0%,23m
17495,2,troll,2924,0,1,0,1,100.0%,30m
17495,2,[GOPERÚ]PXS,2924,0,0,1,1,0.0%,9m
17495,2,[CuBTaK]llllllllllll,2924,0,0,2,2,0.0%,29m
17526,1,[Primum]NASP,2923,1523,279,266,545,51.2%,20m
17526,1,Killuminati,2923,1587,148,137,285,51.9%,14m
17526,2,DINGLEHOPPER,2923,1531,132,121,253,52.2%,35m
17526,2,julius,2923,824,50,42,92,54.3%,35m
17526,1,PREDATOR,2923,314,43,38,81,53.1%,45m
17526,1,[KiMBR]JeanPaul,2923,264,34,27,61,55.7%,34m
17526,2,Solindar,2923,757,30,23,53,56.6%,17m
17526,1,RareLNO,2923,727,26,32,58,44.8%,3m
17526,2,Porcupine,2923,608,25,19,44,56.8%,16m
17526,1,Marlborox,2923,549,22,19,41,53.7%,24m
17526,3,TheMilkMan,2923,354,14,21,35,40.0%,34m
17526,2,Fonlon,2923,286,10,7,17,58.8%,35m
17526,1,JapJap,2923,282,8,11,19,42.1%,5m
17526,2,SunaArashi,2923,162,6,6,12,50.0%,43m
17526,1,TheIronPine,2923,97,4,2,6,66.7%,2h
17526,2,RamenCraves,2923,116,4,4,8,50.0%,12m
17526,2,Zapwai,2923,0,1,0,1,100.0%,35m
17526,2,[DADrUS]Dax,2923,30,1,1,2,50.0%,15m
17526,1,SORROW,2923,73,1,7,8,12.5%,24m
17526,2,Polux,2923,0,0,1,1,0.0%,18m
17526,1,NaZguLiaN,2923,0,0,2,2,0.0%,2h
17526,3,Carz,2923,0,0,3,3,0.0%,19m
17548,2,MelonLord,2922,1604,228,226,454,50.2%,12m
17548,1,bossdawg,2922,1499,78,78,156,50.0%,23m
17548,1,Jamthenam,2922,761,73,75,148,49.3%,8m
17548,2,[PHUDDU]Rush,2922,1449,69,59,128,53.9%,5m
17548,2,Revanite,2922,731,52,30,82,63.4%,22m
17548,2,Luca,2922,1264,49,47,96,51.0%,35m
17548,3,ChibiDragon,2922,952,32,46,78,41.0%,42m
17548,2,Nihs,2922,643,27,22,49,55.1%,44m
17548,2,AceDee,2922,173,23,14,37,62.2%,12m
17548,1,chileverde,2922,374,23,18,41,56.1%,3m
17548,1,[Nuutzz]ToxicJackal,2922,568,18,25,43,41.9%,1m
17548,2,[HØST]LeoWalker,2922,202,14,10,24,58.3%,16m
17548,1,[ZTemp]DujekOnearm,2922,407,13,20,33,39.4%,14m
17548,2,Choka,2922,268,10,9,19,52.6%,12m
17548,2,ligion,2922,176,6,3,9,66.7%,16m
17548,1,ICitwmineIs,2922,120,5,4,9,55.6%,43m
17548,1,Kstor,2922,194,5,12,17,29.4%,22m
17548,2,abaddon,2922,0,4,1,5,80.0%,16m
17548,2,[TPTS]notofimport,2922,140,4,2,6,66.7%,20m
17548,2,[NwAs]ArfenixGamer,2922,88,4,6,10,40.0%,26m
17548,2,[MBPug]Kaypee,2922,0,3,2,5,60.0%,45m
17548,1,NiggaDiy,2922,0,3,2,5,60.0%,45m
17548,2,SecretSora,2922,0,3,2,5,60.0%,35m
17548,2,RefinedMetal,2922,0,3,2,5,60.0%,7m
17548,1,LayZJC,2922,96,3,5,8,37.5%,2h
17548,2,OblivionCall,2922,88,2,0,2,100.0%,41m
17548,1,gun,2922,119,2,5,7,28.6%,1h
17548,3,[RH]DrG,2922,30,2,12,14,14.3%,18m
17548,1,[NoUpSS]KawaiiNeko,2922,0,1,0,1,100.0%,1h
17548,2,[DMT1]bigcHENDO,2922,0,1,1,2,50.0%,27m
17548,2,[fknRee]Dmart,2922,0,0,2,2,0.0%,25m
17548,2,[LQV]DMCAshirel,2922,0,0,2,2,0.0%,35m
17548,2,[KSRP]JackiePwnAss,2922,0,0,3,3,0.0%,46m
17581,1,Stark,2921,1664,286,240,526,54.4%,32m
17581,2,Hypersonic,2921,763,263,239,502,52.4%,28m
17581,1,schopenhauer,2921,1360,86,81,167,51.5%,23m
17581,1,xGodSlaya,2921,1001,38,39,77,49.4%,2m
17581,2,DrummerMerv,2921,304,16,13,29,55.2%,25m
17581,2,stackof,2921,378,14,10,24,58.3%,12m
17581,2,nirvash,2921,303,13,17,30,43.3%,15m
17581,1,[MafiaZ]Auwt,2921,254,11,8,19,57.9%,18m
17581,2,Darksifo,2921,330,11,14,25,44.0%,25m
17581,2,Suave,2921,179,8,6,14,57.1%,1h
17581,2,[TCoSt]Smile,2921,150,6,7,13,46.2%,23m
17581,2,DaBestKS,2921,0,5,1,6,83.3%,2m
17581,1,Nikka,2921,96,5,1,6,83.3%,44m
17581,2,Carcarjou,2921,177,5,8,13,38.5%,6m
17581,1,Wubb,2921,144,3,4,7,42.9%,5m
17581,3,VLADEX,2921,60,3,8,11,27.3%,34m
17581,1,[PLA2N]TeRRa,2921,0,1,2,3,33.3%,31m
17581,2,[BlTEL]rasalghul,2921,30,1,3,4,25.0%,18m
17581,2,Jordheim,2921,0,0,1,1,0.0%,19m
17600,1,shadowsword,2920,1655,77,78,155,49.7%,19m
17600,2,[TILL]AFOD,2920,446,16,14,30,53.3%,25m
17600,1,Kyosai,2920,246,15,16,31,48.4%,22m
17600,3,Ecumene,2920,442,14,27,41,34.1%,14m
17600,2,Compulsion,2920,344,13,8,21,61.9%,26m
17600,2,Gilgamesh,2920,287,13,14,27,48.1%,29m
17600,2,ThanhThanh,2920,205,8,2,10,80.0%,16m
17600,2,DanDayn,2920,170,7,7,14,50.0%,46m
17600,2,stationaryEU,2920,30,4,3,7,57.1%,31m
17600,1,Beast,2920,0,3,2,5,60.0%,27m
17600,2,Wolfbear,2920,90,3,5,8,37.5%,31m
17600,2,BadgerMole,2920,60,2,3,5,40.0%,23m
17600,3,bingus,2920,0,1,0,1,100.0%,2h
17600,2,[sk3tch]Calm,2920,0,0,1,1,0.0%,13m
17600,2,[Steezy]ConMan,2920,0,0,2,2,0.0%,35m
17600,2,KostaNasty,2920,0,0,2,2,0.0%,3h
17616,1,kjulmt,2919,1607,209,196,405,51.6%,43m
17616,2,TheamazingG,2919,1505,142,133,275,51.6%,34m
17616,1,[TTR]Fahshizzle,2919,1619,140,138,278,50.4%,19m
17616,3,alchemist,2919,625,63,56,119,52.9%,15m
17616,2,[BigBrd]hazelnut,2919,1255,59,58,117,50.4%,16m
17616,2,[ExcIgN]Yanzo,2919,739,45,34,79,57.0%,26m
17616,1,randompoop,2919,603,40,49,89,44.9%,19m
17616,1,SoftCatM,2919,861,37,41,78,47.4%,2m
17616,2,[BRODY]elNuv,2919,696,32,17,49,65.3%,30m
17616,1,SmartMunion,2919,161,7,6,13,53.8%,2m
17616,1,[DlNG]Gunther,2919,216,6,5,11,54.5%,2h
17616,1,[TTGO]ivauir,2919,204,6,10,16,37.5%,34m
17616,2,[CNG]Job,2919,112,5,3,8,62.5%,4m
17616,2,DEAFXROBOT,2919,138,4,2,6,66.7%,42m
17616,1,IBleedRed,2919,121,4,3,7,57.1%,2h
17616,2,Unrider,2919,105,3,0,3,100.0%,9m
17616,2,[Dmonik]Belial,2919,112,3,0,3,100.0%,17m
17616,1,Sakinam,2919,145,3,1,4,75.0%,36m
17616,1,laosiji,2919,126,3,2,5,60.0%,15m
17616,2,Sam,2919,0,1,0,1,100.0%,35m
17616,1,ryidk,2919,48,1,3,4,25.0%,46m
17616,2,CRAYT,2919,0,0,1,1,0.0%,12m
17616,2,darksalvador,2919,0,0,4,4,0.0%,23m
17639,2,Dkz,2918,1259,71,69,140,50.7%,3m
17639,2,theunknown,2918,1283,66,26,92,71.7%,4m
17639,2,Pantherfame,2918,116,39,59,98,39.8%,17m
17639,1,UnclearSky,2918,758,37,33,70,52.9%,2m
17639,2,zealot,2918,718,28,26,54,51.9%,11m
17639,1,ArAgOoX,2918,355,22,27,49,44.9%,2m
17639,2,Kerberos,2918,472,20,17,37,54.1%,23m
17639,2,maos,2918,223,16,8,24,66.7%,19m
17639,2,Indianadrone,2918,348,14,12,26,53.8%,11m
17639,2,AydahBR,2918,272,11,8,19,57.9%,45m
17639,1,[TGCrew]Duceman,2918,267,9,12,21,42.9%,13m
17639,2,eldesk,2918,118,5,5,10,50.0%,13m
17639,2,[Hilas2]manoyyy,2918,140,4,2,6,66.7%,4m
17639,2,baecb,2918,96,4,4,8,50.0%,2h
17639,3,Advncd,2918,131,4,5,9,44.4%,2h
17639,2,xuzyit,2918,124,4,7,11,36.4%,6m
17639,2,Aquro,2918,88,3,4,7,42.9%,28m
17639,2,PastorRussel,2918,64,3,7,10,30.0%,35m
17639,2,CandyLove,2918,30,2,3,5,40.0%,42m
17639,2,josees,2918,58,2,4,6,33.3%,3m
17639,1,[8318]TheSlap,2918,74,2,10,12,16.7%,43m
17639,2,quanto,2918,0,1,0,1,100.0%,15m
17639,2,JHSk,2918,0,1,0,1,100.0%,12m
17639,1,[LOHs]VashTzP,2918,97,1,2,3,33.3%,2h
17639,2,[ItsDad]Amida,2918,0,0,1,1,0.0%,46m
17639,2,naband,2918,0,0,1,1,0.0%,16m
17665,1,EnderWiggin,2917,1049,166,179,345,48.1%,36m
17665,2,[MrSolo]LELHIATH,2917,1494,124,120,244,50.8%,19m
17665,1,Kenny,2917,1378,95,95,190,50.0%,10m
17665,2,JaymesReady,2917,982,73,51,124,58.9%,18m
17665,2,[6ixS]Carbon,2917,584,50,47,97,51.5%,27m
17665,2,[xLOLx]PavMastaP,2917,878,38,28,66,57.6%,7m
17665,2,[BrnchB]PancakeFlip,2917,468,28,24,52,53.8%,35m
17665,2,HeyBlake,2917,451,24,22,46,52.2%,10m
17665,1,Eurmalui,2917,320,10,14,24,41.7%,9m
17665,2,Phyume,2917,220,9,6,15,60.0%,2h
17665,2,Apple,2917,204,8,6,14,57.1%,12m
17665,1,Nighthawk,2917,274,8,9,17,47.1%,31m
17665,3,Scurrilous,2917,229,7,15,22,31.8%,30m
17665,2,Chupacabra,2917,188,6,4,10,60.0%,17m
17665,2,Alexander,2917,137,6,4,10,60.0%,46m
17665,2,PanTo,2917,205,6,8,14,42.9%,15m
17665,2,[GSF91]bonxiakalaka,2917,154,5,1,6,83.3%,22m
17665,2,[dGG]ChiliPepperS,2917,0,4,4,8,50.0%,1h
17665,2,Hatz,2917,88,4,4,8,50.0%,27m
17665,2,TheRock,2917,135,3,2,5,60.0%,43m
17665,2,Pokeee,2917,0,3,2,5,60.0%,26m
17665,2,PuzzleMoon,2917,0,3,2,5,60.0%,2m
17665,2,oooooooooooo,2917,0,3,3,6,50.0%,35m
17665,2,Gravity,2917,102,2,1,3,66.7%,5m
17665,2,[TGULS]miko,2917,0,1,1,2,50.0%,5m
17665,1,[ABWE]Dave,2917,0,0,1,1,0.0%,2h
17665,2,[VMVM]Aimer,2917,0,0,2,2,0.0%,7m
17665,2,MustBeHaxBro,2917,0,0,2,2,0.0%,12m
17693,3,Botswaa,2916,1542,134,111,245,54.7%,24m
17693,3,[GRUDGE]KraMBCooL,2916,1452,114,113,227,50.2%,14m
17693,2,[ARGENT]Tutsinator,2916,1406,67,58,125,53.6%,29m
17693,1,bakram,2916,1396,59,56,115,51.3%,31m
17693,1,DerpVader,2916,967,56,57,113,49.6%,6m
17693,2,tex,2916,1022,50,33,83,60.2%,15m
17693,1,SpIN,2916,560,43,42,85,50.6%,36m
17693,1,HeavenBlue,2916,989,35,41,76,46.1%,32m
17693,2,MagicTerran,2916,728,30,20,50,60.0%,13m
17693,2,BANA,2916,549,23,20,43,53.5%,32m
17693,2,Freecss,2916,522,19,17,36,52.8%,26m
17693,3,[VAMPR]ahegalisk,2916,427,19,30,49,38.8%,13m
17693,2,Chronos,2916,462,18,19,37,48.6%,35m
17693,1,Timmy,2916,494,16,24,40,40.0%,14m
17693,2,[GarP]Parches,2916,330,14,11,25,56.0%,35m
17693,2,Defection,2916,345,12,14,26,46.2%,14m
17693,1,forklifter,2916,314,10,16,26,38.5%,1m
17693,2,Tocque,2916,194,8,7,15,53.3%,13m
17693,2,FarSeer,2916,161,6,5,11,54.5%,5m
17693,2,MCnookies,2916,188,6,12,18,33.3%,16m
17693,1,Walkietalkie,2916,192,6,13,19,31.6%,45m
17693,2,Darknight,2916,0,2,4,6,33.3%,30m
17693,2,bart,2916,0,1,0,1,100.0%,23m
17693,2,mataca,2916,0,0,1,1,0.0%,12m
17693,2,[kayi]ZAX,2916,0,0,1,1,0.0%,1m
17693,2,bsdsbgmm,2916,73,0,5,5,0.0%,35m
17719,2,GrumpPants,2915,587,115,115,230,50.0%,18m
17719,3,DoooM,2915,1293,100,91,191,52.4%,9m
17719,3,spartan,2915,1541,55,65,120,45.8%,26m
17719,2,MrKB,2915,678,29,19,48,60.4%,21m
17719,2,[GGMESP]AberamaGold,2915,574,20,22,42,47.6%,13m
17719,2,ALEXANDROS,2915,468,18,12,30,60.0%,46m
17719,2,StarPeluche,2915,381,16,17,33,48.5%,11m
17719,2,BabyShoes,2915,452,16,21,37,43.2%,13m
17719,2,icyrail,2915,249,14,4,18,77.8%,25m
17719,2,Nephira,2915,286,12,4,16,75.0%,35m
17719,1,Drocky,2915,356,12,11,23,52.2%,33m
17719,1,[B2TW]WAREWOLF,2915,357,12,14,26,46.2%,4m
17719,2,Commando,2915,288,11,10,21,52.4%,45m
17719,1,deffno,2915,325,11,14,25,44.0%,33m
17719,2,Minkasaki,2915,212,8,10,18,44.4%,27m
17719,2,CAPA,2915,206,7,7,14,50.0%,18m
17719,2,TRaMiTiZe,2915,30,5,2,7,71.4%,8m
17719,2,Constantine,2915,155,5,2,7,71.4%,6m
17719,1,BlueMarble,2915,192,4,1,5,80.0%,27m
17719,1,CNplayerLTQ,2915,97,4,4,8,50.0%,43m
17719,2,Xian,2915,0,4,4,8,50.0%,1h
17719,2,Demoncrest,2915,53,4,7,11,36.4%,11m
17719,2,[MFNS]Potatozombie,2915,30,1,3,4,25.0%,9m
17719,2,Drain,2915,0,0,1,1,0.0%,17m
17719,2,[imN0ob]axelspider,2915,0,0,1,1,0.0%,16m
17719,2,JORCHINOOI,2915,0,0,2,2,0.0%,25m
17719,2,[TAKAX2]OnceAgain,2915,0,0,2,2,0.0%,18m
17746,1,Malthael,2914,1232,212,194,406,52.2%,21m
17746,2,TenaciousDB,2914,390,68,59,127,53.5%,12m
17746,1,Kado,2914,765,65,72,137,47.4%,15m
17746,2,Rodger,2914,285,45,33,78,57.7%,31m
17746,2,[LCE]KosaNosTTra,2914,644,33,29,62,53.2%,13m
17746,2,YUM,2914,908,33,34,67,49.3%,30m
17746,2,[PGlx]DesolatioN,2914,599,22,22,44,50.0%,28m
17746,2,JoeMama,2914,445,21,6,27,77.8%,18m
17746,2,BarraxObama,2914,566,21,21,42,50.0%,31m
17746,2,UltraLaser,2914,355,15,12,27,55.6%,8m
17746,2,KnightZ,2914,371,14,11,25,56.0%,16m
17746,2,[PàllyT]Oldarthur,2914,275,11,7,18,61.1%,2h
17746,1,DarkHades,2914,308,10,14,24,41.7%,26m
17746,2,Einarin,2914,167,7,2,9,77.8%,44m
17746,2,Reaps,2914,154,6,3,9,66.7%,24m
17746,2,grappa,2914,132,5,3,8,62.5%,17m
17746,1,mirnuri,2914,91,5,5,10,50.0%,31m
17746,2,Poblhaa,2914,90,4,3,7,57.1%,22m
17746,2,Pieman,2914,90,4,6,10,40.0%,31m
17746,1,[Curse]chugachuga,2914,0,3,2,5,60.0%,2h
17746,2,Kalasyrus,2914,0,3,2,5,60.0%,35m
17746,2,[xDYEx]RaEcOn,2914,102,2,2,4,50.0%,16m
17746,2,[Antss]Zawaz,2914,30,2,3,5,40.0%,30m
17746,2,FastExpand,2914,88,2,4,6,33.3%,23m
17746,2,Otsuka,2914,60,2,5,7,28.6%,46m
17746,2,lexus,2914,0,1,0,1,100.0%,22m
17746,2,[LTlord]Sombra,2914,0,0,1,1,0.0%,11m
17746,2,HoesHoender,2914,0,0,1,1,0.0%,36m
17746,2,[Xpk]yourdead,2914,0,0,1,1,0.0%,18m
17746,2,AraAra,2914,0,0,1,1,0.0%,23m
17746,2,faradal,2914,0,0,3,3,0.0%,46m
17777,1,Sick,2913,1574,283,264,547,51.7%,36m
17777,2,Rynot,2913,1074,194,169,363,53.4%,18m
17777,2,chargelot,2913,1597,135,125,260,51.9%,14m
17777,2,Apple,2913,1576,92,82,174,52.9%,5m
17777,2,henriqueser,2913,984,61,44,105,58.1%,22m
17777,2,ThanosSnap,2913,692,32,23,55,58.2%,29m
17777,3,KasSadaR,2913,764,31,33,64,48.4%,23m
17777,1,XxOdiseoxX,2913,630,24,26,50,48.0%,24m
17777,2,ogzxro,2913,468,23,21,44,52.3%,11m
17777,2,xtremeplayer,2913,468,22,9,31,71.0%,16m
17777,1,TheFrost,2913,553,18,21,39,46.2%,33m
17777,1,Yoaquim,2913,385,13,14,27,48.1%,9m
17777,1,HornySCV,2913,330,11,20,31,35.5%,36m
17777,2,TheStilkeeN,2913,246,10,8,18,55.6%,17m
17777,2,[Mitsu]EmiCco,2913,258,10,8,18,55.6%,43m
17777,3,[NrFms]hunter,2913,195,9,4,13,69.2%,1h
17777,2,BlackNoir,2913,120,8,5,13,61.5%,12m
17777,2,Sevriety,2913,104,4,3,7,57.1%,23m
17777,2,[GnR]Natedogg,2913,62,3,5,8,37.5%,22m
17777,1,ElZombie,2913,106,3,7,10,30.0%,15m
17777,1,[VST]Lionhard,2913,0,2,1,3,66.7%,33m
17777,1,SonofNichols,2913,0,1,0,1,100.0%,18m
17777,2,[LY]LionHeart,2913,0,1,0,1,100.0%,25m
17777,2,FearthePanda,2913,0,0,1,1,0.0%,4m
17777,2,[DINOCB]Worek,2913,0,0,1,1,0.0%,20m
17802,2,lobstertube,2912,1551,140,132,272,51.5%,27m
17802,1,Arnyyy,2912,1645,103,107,210,49.0%,32m
17802,2,Toto,2912,557,31,25,56,55.4%,26m
17802,1,[iMOAN]Necroxion,2912,757,27,27,54,50.0%,32m
17802,2,[GGBaka]DJRADE,2912,430,19,7,26,73.1%,11m
17802,1,DonaldTrump,2912,582,19,24,43,44.2%,46m
17802,1,Static,2912,416,16,12,28,57.1%,5m
17802,1,DIEGO,2912,472,15,15,30,50.0%,43m
17802,1,Legendling,2912,267,10,7,17,58.8%,6m
17802,3,WhiteLight,2912,232,9,6,15,60.0%,2h
17802,2,[NYMZ]Disboi,2912,242,8,3,11,72.7%,23m
17802,3,BicoPreto,2912,86,7,7,14,50.0%,33m
17802,2,[RDQ]Rambo,2912,130,5,1,6,83.3%,46m
17802,1,shadowstorm,2912,96,5,4,9,55.6%,5m
17802,1,PhúÔngNghèo,2912,140,4,10,14,28.6%,26m
17802,2,Nick,2912,0,3,2,5,60.0%,34m
17802,2,[LuVz]TheThigh,2912,0,3,2,5,60.0%,23m
17802,2,xTRippNx,2912,0,3,2,5,60.0%,45m
17802,2,Lit,2912,60,3,5,8,37.5%,21m
17802,2,Gravy,2912,88,3,5,8,37.5%,46m
17802,2,TYyayayay,2912,114,2,2,4,50.0%,7m
17802,2,salamandah,2912,0,2,3,5,40.0%,13m
17802,2,[AiMB]kagongorr,2912,0,1,0,1,100.0%,30m
17802,2,Jibz,2912,0,1,1,2,50.0%,29m
17802,2,mersault,2912,0,1,2,3,33.3%,31m
17802,2,Jabstep,2912,0,0,2,2,0.0%,41m
17828,3,[GrnBrd]BREAKR,2911,703,107,108,215,49.8%,13m
17828,2,lIIIIIlll,2911,1136,46,43,89,51.7%,3m
17828,2,worthlesshum,2911,696,31,26,57,54.4%,7m
17828,1,BlackBox,2911,672,26,21,47,55.3%,36m
17828,1,[NYOOM]klekky,2911,531,24,27,51,47.1%,43m
17828,1,[ExcIgN]LeCake,2911,612,22,23,45,48.9%,7m
17828,2,Plug,2911,280,18,19,37,48.6%,30m
17828,2,[SJLM]trulien,2911,259,16,11,27,59.3%,12m
17828,2,LumDiDum,2911,255,11,5,16,68.8%,6m
17828,2,Shikamaru,2911,157,6,5,11,54.5%,31m
17828,1,Marodox,2911,121,5,5,10,50.0%,10m
17828,2,Kimon,2911,116,5,8,13,38.5%,29m
17828,2,BananaLegs,2911,92,4,4,8,50.0%,16m
17828,2,brrrrrrr,2911,88,4,7,11,36.4%,5m
17828,1,TeamScvLife,2911,130,3,0,3,100.0%,30m
17828,1,Lechuga,2911,0,3,3,6,50.0%,1h
17828,2,[Wat3rs]Colder,2911,30,2,1,3,66.7%,12m
17828,2,[MaxWin]GirthQuake,2911,112,2,2,4,50.0%,24m
17828,2,MajorSparkle,2911,60,2,3,5,40.0%,35m
17828,2,[ethicc]Yackob,2911,0,1,0,1,100.0%,2m
17828,2,mosca,2911,30,1,2,3,33.3%,43m
17828,2,nobody,2911,0,0,1,1,0.0%,43m
17828,2,[Xpk]Antarez,2911,0,0,1,1,0.0%,26m
17828,1,Jat,2911,0,0,1,1,0.0%,35m
17852,1,Masteryul,2910,1367,193,190,383,50.4%,43m
17852,3,[XGang]AESCALANTEY,2910,1125,141,131,272,51.8%,23m
17852,1,LIlIIiil,2910,1050,103,86,189,54.5%,10m
17852,2,Sensei,2910,1079,100,86,186,53.8%,16m
17852,1,Serral,2910,1385,99,70,169,58.6%,27m
17852,2,HerboLeon,2910,647,83,65,148,56.1%,25m
17852,2,IlIlIlIlIlIl,2910,926,46,28,74,62.2%,4m
17852,2,[5252]Jokertrue,2910,386,27,14,41,65.9%,13m
17852,1,[Pig2]Teach,2910,702,25,27,52,48.1%,9m
17852,2,MajorSoup,2910,458,21,9,30,70.0%,44m
17852,2,[ExcIgN]DalakStrik,2910,453,18,7,25,72.0%,17m
17852,1,[KYLE2]JebronLames,2910,510,15,21,36,41.7%,6m
17852,2,ComputerEasy,2910,328,12,14,26,46.2%,15m
17852,2,Riudes,2910,199,9,2,11,81.8%,31m
17852,2,ThethinkerLA,2910,213,8,7,15,53.3%,31m
17852,1,Sisco,2910,238,8,16,24,33.3%,14m
17852,2,Liia,2910,180,7,6,13,53.8%,29m
17852,2,Piero,2910,217,7,6,13,53.8%,18m
17852,3,[xO]BigZam,2910,166,6,5,11,54.5%,3h
17852,1,BigJohnson,2910,222,6,14,20,30.0%,10m
17852,2,[iFree]FreeAcctGood,2910,102,5,2,7,71.4%,20m
17852,2,Tarv,2910,121,5,8,13,38.5%,10m
17852,2,AnonymousGuy,2910,124,4,2,6,66.7%,24m
17852,2,Heresy,2910,69,4,6,10,40.0%,30m
17852,1,[Tiddys]NightSoul,2910,97,3,3,6,50.0%,22m
17852,1,[bearsx]LaCaiii,2910,0,2,0,2,100.0%,36m
17852,2,[HIKERS]Battlestrike,2910,102,2,1,3,66.7%,41m
17852,2,[tCo9]spanky,2910,30,2,2,4,50.0%,7m
17852,2,FoAChazZ,2910,0,1,0,1,100.0%,5m
17852,2,[AK48]Aeneas,2910,0,1,1,2,50.0%,5m
17852,2,OberdeR,2910,0,0,1,1,0.0%,15m
17852,2,speedy,2910,0,0,1,1,0.0%,16m
17852,1,nobuild,2910,0,0,3,3,0.0%,2h
17852,2,tig,2910,0,0,4,4,0.0%,7m
17886,2,[PuffWC]aiur,2909,1571,143,132,275,52.0%,7m
17886,2,Bruh,2909,1260,136,134,270,50.4%,5m
17886,2,chubbylove,2909,1243,104,106,210,49.5%,16m
17886,3,AlexOooooooo,2909,1449,98,93,191,51.3%,9m
17886,2,xBluestar,2909,1583,86,64,150,57.3%,32m
17886,3,LaughingPug,2909,1382,73,77,150,48.7%,30m
17886,2,[DarkPG]AnArDi,2909,919,68,70,138,49.3%,16m
17886,3,[HENT4l]Stock,2909,1083,68,72,140,48.6%,23m
17886,1,Ragna,2909,1194,65,56,121,53.7%,6m
17886,2,[LGL]Siul,2909,1306,52,47,99,52.5%,43m
17886,2,DonEnzone,2909,537,27,18,45,60.0%,12m
17886,2,NightRaven,2909,487,23,10,33,69.7%,20m
17886,2,toofattotype,2909,412,19,9,28,67.9%,16m
17886,2,[UNIE]KANGREBURGER,2909,421,16,13,29,55.2%,35m
17886,2,Sorrow,2909,372,16,15,31,51.6%,14m
17886,2,Xenocide,2909,249,12,3,15,80.0%,12m
17886,2,Yakab,2909,286,10,10,20,50.0%,18m
17886,2,[TGCrew]SandyLyle,2909,252,9,8,17,52.9%,16m
17886,2,bugatti,2909,166,5,3,8,62.5%,45m
17886,2,[LQV]Philip,2909,196,5,5,10,50.0%,42m
17886,1,HoneyDeeeew,2909,89,4,4,8,50.0%,33m
17886,2,[TGosuA]bunK,2909,122,4,6,10,40.0%,4m
17886,3,TWH,2909,90,3,10,13,23.1%,3m
17886,2,[UAK]Dextrus,2909,0,2,3,5,40.0%,2m
17886,2,suyiii,2909,60,2,3,5,40.0%,13m
17886,1,[TRKPAD]Dwarfe,2909,97,2,4,6,33.3%,2h
17886,2,[DNKCFT]llllllllllll,2909,0,1,0,1,100.0%,35m
17886,2,IImasterII,2909,0,1,1,2,50.0%,12m
17886,2,Yuyuko,2909,92,1,1,2,50.0%,2h
17886,2,Toaster,2909,30,1,2,3,33.3%,35m
17886,2,Casper,2909,0,0,1,1,0.0%,18m
17886,2,bigsmoke,2909,0,0,3,3,0.0%,25m
17918,1,RingoS,2908,1514,286,247,533,53.7%,43m
17918,1,Petra,2908,1615,225,187,412,54.6%,2m
17918,2,Babylon,2908,1581,126,108,234,53.8%,44m
17918,2,krcknbrg,2908,1554,117,110,227,51.5%,7m
17918,1,[LMI42]iNkA,2908,610,100,95,195,51.3%,46m
17918,2,[RdLzrd]PotatoPanini,2908,1512,86,62,148,58.1%,15m
17918,1,raf,2908,580,84,78,162,51.9%,8m
17918,1,Heyzuse,2908,740,83,69,152,54.6%,2m
17918,2,desertion,2908,1167,79,66,145,54.5%,11m
17918,2,[VIOLDR]ORO,2908,992,75,69,144,52.1%,35m
17918,2,Zejktus,2908,960,70,64,134,52.2%,6m
17918,2,[1vsM]ONEVSMANY,2908,1059,46,31,77,59.7%,29m
17918,2,EarnsTurns,2908,776,39,20,59,66.1%,31m
17918,2,IIIIIIIIIIII,2908,450,30,13,43,69.8%,3m
17918,2,Cartz,2908,267,11,4,15,73.3%,35m
17918,2,KanyeBest,2908,275,10,4,14,71.4%,22m
17918,2,stenfi,2908,292,10,8,18,55.6%,35m
17918,1,defn,2908,244,7,12,19,36.8%,43m
17918,1,gagag,2908,150,5,13,18,27.8%,4m
17918,1,gokamo,2908,0,3,1,4,75.0%,17m
17918,2,DMZ,2908,98,3,1,4,75.0%,34m
17918,2,[GØSU]TomboKai,2908,60,3,3,6,50.0%,34m
17918,2,Booyah,2908,117,3,3,6,50.0%,9m
17918,1,[xxxbow]Glub,2908,95,2,1,3,66.7%,1h
17918,1,clampKK,2908,0,1,0,1,100.0%,1h
17918,2,Samwise,2908,0,1,0,1,100.0%,23m
17918,2,Jezuz,2908,88,1,1,2,50.0%,36m
17918,2,Golden,2908,0,1,1,2,50.0%,23m
17918,2,[JUGOS]MOCR,2908,0,0,1,1,0.0%,26m
17918,2,[LOHs]SSummer,2908,0,0,1,1,0.0%,15m
17918,2,ladkos,2908,0,0,3,3,0.0%,17m
17918,2,Jag,2908,0,0,4,4,0.0%,26m
17950,1,Archibaldman,2907,1235,112,85,197,56.9%,22m
17950,2,[ZCMD]MISTERX,2907,1579,103,94,197,52.3%,2m
17950,2,MacroPolo,2907,999,81,63,144,56.2%,13m
17950,2,Minesweeper,2907,357,36,25,61,59.0%,14m
17950,1,kjj,2907,795,32,29,61,52.5%,43m
17950,2,kekkers,2907,591,30,30,60,50.0%,19m
17950,2,[ZergW]Babushka,2907,593,27,19,46,58.7%,18m
17950,3,StaggerLee,2907,630,26,27,53,49.1%,21m
17950,2,[CraCan]Haste,2907,613,25,19,44,56.8%,25m
17950,2,huntdog,2907,577,24,20,44,54.5%,4m
17950,2,[SG]SGMattC,2907,450,19,16,35,54.3%,23m
17950,2,[SCMAST]ColonelDeath,2907,365,13,11,24,54.2%,28m
17950,2,ElisioN,2907,356,12,17,29,41.4%,34m
17950,2,[Colrs]jacob,2907,320,11,16,27,40.7%,11m
17950,1,Native,2907,299,10,11,21,47.6%,2m
17950,3,[S0O]FIREGROUND,2907,207,6,1,7,85.7%,13m
17950,2,pLEITE,2907,176,5,4,9,55.6%,7m
17950,2,Cesra,2907,190,5,8,13,38.5%,17m
17950,2,Nyaruko,2907,30,4,3,7,57.1%,5m
17950,2,shadow,2907,150,4,6,10,40.0%,35m
17950,2,[TACOST]Balthier,2907,165,4,6,10,40.0%,11m
17950,3,SuSy,2907,127,3,1,4,75.0%,37m
17950,1,[imvb]Golden,2907,0,3,2,5,60.0%,32m
17950,1,IlIlIllIIIII,2907,0,3,2,5,60.0%,2h
17950,1,FXmarc,2907,110,3,14,17,17.6%,46m
17950,2,Fallenhero,2907,88,2,0,2,100.0%,21m
17950,2,Throllax,2907,30,2,1,3,66.7%,23m
17950,2,[YD2K]Blood,2907,0,2,3,5,40.0%,36m
17950,2,Flank,2907,0,1,0,1,100.0%,25m
17950,2,Azula,2907,0,1,1,2,50.0%,35m
17950,2,Tatoks,2907,0,1,5,6,16.7%,46m
17981,1,SoyBoy,2906,1647,428,411,839,51.0%,2m
17981,2,[AZMX]Lorrigo,2906,1476,104,86,190,54.7%,26m
17981,2,DodoX,2906,1605,81,71,152,53.3%,6m
17981,2,WildCat,2906,1391,59,49,108,54.6%,32m
17981,2,[Cov818]RhinoBlaster,2906,1189,48,41,89,53.9%,18m
17981,2,Krzy,2906,205,30,23,53,56.6%,11m
17981,2,WoOwOo,2906,558,20,22,42,47.6%,43m
17981,2,Prominence,2906,388,14,9,23,60.9%,43m
17981,2,llllllllllll,2906,303,13,7,20,65.0%,16m
17981,2,bla,2906,292,12,9,21,57.1%,35m
17981,2,IIIIIIIIIIII,2906,157,6,2,8,75.0%,34m
17981,1,job,2906,102,4,10,14,28.6%,22m
17981,2,bernhardbaum,2906,0,3,2,5,60.0%,23m
17981,2,Edammer,2906,139,3,7,10,30.0%,17m
17981,2,HithePig,2906,0,2,3,5,40.0%,42m
17981,2,Example,2906,30,2,4,6,33.3%,13m
17981,2,[CCCMF]testicana,2906,30,1,2,3,33.3%,12m
17981,2,FranUY,2906,42,1,4,5,20.0%,2h
17981,2,[J3BUS]Hawkeye,2906,0,0,1,1,0.0%,2m
17981,2,[LosK]Stiffmaister,2906,0,0,2,2,0.0%,23m
17981,2,HAXOR,2906,0,0,5,5,0.0%,46m
18002,2,mrscientist,2905,1373,200,176,376,53.2%,19m
18002,2,Macroni,2905,1055,195,181,376,51.9%,15m
18002,1,eliias,2905,824,118,114,232,50.9%,6m
18002,1,Jenkins,2905,1493,82,71,153,53.6%,46m
18002,2,OKBoomer,2905,1505,68,56,124,54.8%,4m
18002,1,SGoodman,2905,1509,68,67,135,50.4%,10m
18002,2,Pepperoni,2905,1383,64,45,109,58.7%,32m
18002,2,mandanson,2905,991,45,40,85,52.9%,26m
18002,1,ChEnTeR,2905,780,42,35,77,54.5%,10m
18002,1,Gullinkambi,2905,1031,39,38,77,50.6%,32m
18002,1,Nide,2905,560,26,20,46,56.5%,33m
18002,2,[SHPK]BigAristotle,2905,278,18,15,33,54.5%,25m
18002,2,Pellaeon,2905,352,13,10,23,56.5%,11m
18002,3,Fireball,2905,195,10,3,13,76.9%,2h
18002,2,Sniffer,2905,164,7,3,10,70.0%,31m
18002,1,DarkTemplar,2905,216,7,4,11,63.6%,19m
18002,2,AllIn,2905,146,6,7,13,46.2%,17m
18002,2,[EndPro]Juls,2905,168,5,3,8,62.5%,9m
18002,2,Reaver,2905,116,5,4,9,55.6%,18m
18002,2,BicepsAtMid,2905,132,5,4,9,55.6%,11m
18002,2,[Bee]Sharkbait,2905,130,4,1,5,80.0%,5m
18002,3,ChenRiFeng,2905,0,4,4,8,50.0%,2h
18002,2,kenzington,2905,140,3,1,4,75.0%,17m
18002,2,HOUSE,2905,0,3,2,5,60.0%,4m
18002,2,[L4Life]Threeppholes,2905,139,3,2,5,60.0%,20m
18002,2,[KOTLC]UnSeen,2905,0,3,2,5,60.0%,39m
18002,2,[Gotti]Buggatiii,2905,64,3,5,8,37.5%,21m
18002,2,CheezToss,2905,102,2,2,4,50.0%,5m
18002,2,IIIIIIIIIIII,2905,30,2,2,4,50.0%,35m
18002,1,NellyHoHo,2905,0,1,0,1,100.0%,3h
18002,1,JeanP,2905,97,1,1,2,50.0%,2h
18002,1,[SCTR]CapMurica,2905,48,1,6,7,14.3%,2h
18002,2,EXTREMEGAME,2905,0,0,1,1,0.0%,7m
18035,2,[SPQ]RMJ,2904,1037,57,54,111,51.4%,18m
18035,1,zouman,2904,1102,41,44,85,48.2%,21m
18035,2,[ThW]CaioRavi,2904,683,27,27,54,50.0%,13m
18035,2,lllllllgllll,2904,404,17,16,33,51.5%,23m
18035,1,FARTxMASTERx,2904,357,15,9,24,62.5%,21m
18035,1,nanu,2904,434,14,17,31,45.2%,9m
18035,2,[Jruk]Coress,2904,194,8,7,15,53.3%,42m
18035,2,Octas,2904,116,5,5,10,50.0%,23m
18035,2,Greenz,2904,120,5,5,10,50.0%,35m
18035,2,AgentRooty,2904,30,4,3,7,57.1%,23m
18035,2,DKR,2904,90,4,4,8,50.0%,7m
18035,1,Socrates,2904,128,4,11,15,26.7%,4m
18035,3,KXMoon,2904,121,2,2,4,50.0%,20m
18035,2,[6CCL]Ghost,2904,99,2,6,8,25.0%,8m
18035,2,[XpKAc]Miyyyon,2904,0,1,1,2,50.0%,2h
18035,2,mirreyMX,2904,30,1,2,3,33.3%,23m
18035,2,Mathword,2904,30,1,3,4,25.0%,23m
18035,3,TheGuardian,2904,40,1,4,5,20.0%,44m
18035,2,[dixaxo]SaTzo,2904,30,1,7,8,12.5%,14m
18035,2,eCakes,2904,0,0,1,1,0.0%,25m
18035,2,torro,2904,0,0,1,1,0.0%,43m
18035,2,SilverStar,2904,0,0,2,2,0.0%,19m
18035,2,Snait,2904,0,0,3,3,0.0%,18m
18058,1,Vangelic,2903,1530,107,102,209,51.2%,21m
18058,1,[FyHr]cheche,2903,1094,49,46,95,51.6%,17m
18058,1,FlyinJDeezle,2903,886,34,33,67,50.7%,33m
18058,2,[Y4NG20]natedoggg,2903,743,33,20,53,62.3%,35m
18058,2,Kefka,2903,708,29,29,58,50.0%,3m
18058,2,broadcast,2903,670,28,26,54,51.9%,18m
18058,2,JOEY,2903,532,21,16,37,56.8%,27m
18058,1,[Atone]Base,2903,499,21,20,41,51.2%,5m
18058,1,[AKHN]Akira,2903,252,21,22,43,48.8%,26m
18058,2,[LMI42]OverlordRush,2903,426,18,10,28,64.3%,18m
18058,2,Uberrific,2903,378,14,15,29,48.3%,11m
18058,1,ChuckNorris,2903,320,10,10,20,50.0%,4m
18058,1,FridCR,2903,255,10,11,21,47.6%,26m
18058,2,bilboswagins,2903,218,9,6,15,60.0%,8m
18058,1,Diesel,2903,146,6,2,8,75.0%,29m
18058,2,[icon]Galaga,2903,120,6,7,13,46.2%,15m
18058,2,[HaMz]ManUnitdPete,2903,130,4,4,8,50.0%,5m
18058,2,idkhowtoplay,2903,88,4,4,8,50.0%,5m
18058,1,MrSmiley,2903,0,3,3,6,50.0%,2h
18058,1,zxc,2903,0,3,3,6,50.0%,2h
18058,1,[Macac0]Selxtop,2903,97,2,0,2,100.0%,15m
18058,2,TimeBonez,2903,102,2,1,3,66.7%,36m
18058,2,orcarod,2903,108,2,2,4,50.0%,13m
18058,2,TemplarKing,2903,44,2,3,5,40.0%,13m
18058,1,Scully,2903,0,1,0,1,100.0%,2h
18058,2,Jobin,2903,0,1,0,1,100.0%,43m
18058,2,Athelas,2903,0,1,1,2,50.0%,2h
18058,2,Servz,2903,30,1,3,4,25.0%,5m
18058,1,Pain,2903,38,1,5,6,16.7%,33m
18058,2,RamenEmpire,2903,0,0,1,1,0.0%,19m
18058,2,Shahaka,2903,0,0,1,1,0.0%,12m
18058,2,TZxSuperkorn,2903,0,0,1,1,0.0%,16m
18090,3,COPERNICO,2902,1588,640,621,1261,50.8%,3m
18090,2,afterfpv,2902,1567,213,195,408,52.2%,13m
18090,3,Lifeforce,2902,1382,143,147,290,49.3%,43m
18090,1,laote,2902,1609,137,111,248,55.2%,2m
18090,2,NightRaven,2902,652,59,46,105,56.2%,17m
18090,1,kimJONGiL,2902,408,54,61,115,47.0%,30m
18090,1,sosaTC,2902,409,24,26,50,48.0%,2m
18090,1,Blooduster,2902,647,23,26,49,46.9%,46m
18090,2,Xuron,2902,468,19,8,27,70.4%,43m
18090,1,Greengame,2902,378,17,16,33,51.5%,31m
18090,2,DisturbedMat,2902,180,8,1,9,88.9%,4m
18090,2,[FIFON]Filou,2902,244,8,6,14,57.1%,46m
18090,2,Kaballa,2902,142,6,5,11,54.5%,46m
18090,1,Bloodpack,2902,156,6,10,16,37.5%,32m
18090,1,Smierc,2902,145,5,4,9,55.6%,2h
18090,2,CoinFlip,2902,88,4,2,6,66.7%,32m
18090,2,[Macac0]PuNiShEr,2902,102,2,1,3,66.7%,5m
18090,2,Kale,2902,30,2,2,4,50.0%,45m
18090,2,Taucher,2902,0,2,3,5,40.0%,7m
18090,2,LiuBei,2902,0,2,3,5,40.0%,2h
18090,2,[W3Mod]Dad,2902,30,2,4,6,33.3%,45m
18090,2,PairDanyxT,2902,0,1,0,1,100.0%,45m
18090,2,mia,2902,0,0,1,1,0.0%,45m
18090,2,wtf,2902,0,0,1,1,0.0%,46m
18090,2,[CAMS]Magipe,2902,0,0,2,2,0.0%,36m
18090,1,Tazel,2902,0,0,7,7,0.0%,17m
18116,2,whyalwaysme,2901,1518,103,83,186,55.4%,31m
18116,2,JokingForYou,2901,1515,60,54,114,52.6%,5m
18116,2,ReptarKing,2901,1358,52,51,103,50.5%,29m
18116,2,ZHC,2901,724,48,41,89,53.9%,35m
18116,2,Ted,2901,628,27,23,50,54.0%,24m
18116,2,JohnWick,2901,405,19,12,31,61.3%,16m
18116,2,PhaseShift,2901,419,19,15,34,55.9%,22m
18116,2,SilverDey,2901,305,18,12,30,60.0%,17m
18116,2,[Wolfen]Guardian,2901,444,15,16,31,48.4%,23m
18116,2,[PSF]Matik,2901,420,14,14,28,50.0%,45m
18116,2,frontbutfevr,2901,318,12,8,20,60.0%,13m
18116,2,antiperras,2901,243,10,5,15,66.7%,46m
18116,2,COOPERSEN,2901,188,9,3,12,75.0%,19m
18116,3,metric,2901,246,9,7,16,56.2%,2h
18116,2,[MPWNZ]Dream,2901,232,9,11,20,45.0%,31m
18116,2,RyseMan,2901,177,7,6,13,53.8%,2h
18116,2,ROSMS,2901,212,7,11,18,38.9%,44m
18116,2,[Lp]KuxO,2901,203,6,4,10,60.0%,25m
18116,2,[ALQ]Gorilla,2901,176,6,9,15,40.0%,12m
18116,2,Elite,2901,164,4,4,8,50.0%,26m
18116,2,[ºgXñº]Ðøxxëñ,2901,111,4,7,11,36.4%,45m
18116,2,Suttilus,2901,0,3,2,5,60.0%,30m
18116,1,llllllllllll,2901,0,3,3,6,50.0%,26m
18116,2,Yosai,2901,30,2,1,3,66.7%,31m
18116,2,Etna,2901,0,2,3,5,40.0%,18m
18116,1,Valynah,2901,0,2,5,7,28.6%,1h
18116,2,[NPhasA]lvkeat,2901,60,2,6,8,25.0%,17m
18116,2,[SHKNG]JASOX,2901,0,1,0,1,100.0%,42m
18116,2,[BIEF]TheRustyNail,2901,0,1,0,1,100.0%,11m
18116,2,ENGLISH,2901,88,1,1,2,50.0%,35m
18116,2,pennywise,2901,91,1,1,2,50.0%,2h
18116,2,ButWait,2901,88,1,1,2,50.0%,11m
18116,2,[WarLT]DrDre,2901,0,1,3,4,25.0%,13m
18116,2,[KxH]Oathkeeper,2901,95,1,6,7,14.3%,2h
18116,2,[DarkPG]JULIOVERNE,2901,0,0,1,1,0.0%,16m
18116,2,Mezmerist,2901,0,0,3,3,0.0%,28m
18116,2,[4IUR]Marcello,2901,0,0,4,4,0.0%,27m
18153,2,Sarekk,2900,1637,583,554,1137,51.3%,12m
18153,1,Johnny,2900,1549,145,133,278,52.2%,11m
18153,1,Skye,2900,1327,135,114,249,54.2%,33m
18153,2,[Goldem]Thatguy,2900,759,75,61,136,55.1%,13m
18153,2,[TimTom]Bob,2900,479,46,33,79,58.2%,11m
18153,2,KumaR,2900,773,28,27,55,50.9%,44m
18153,1,Mihaha,2900,587,26,31,57,45.6%,21m
18153,1,MaeRa,2900,634,24,26,50,48.0%,19m
18153,1,[DBZK]TheKhala,2900,578,18,26,44,40.9%,2m
18153,2,StepBrother,2900,325,15,14,29,51.7%,6m
18153,2,ked,2900,143,11,11,22,50.0%,13m
18153,2,[1T]Rias,2900,195,8,2,10,80.0%,35m
18153,2,PizzaChrono,2900,187,8,6,14,57.1%,32m
18153,2,Enantiomers,2900,206,8,8,16,50.0%,15m
18153,2,Akuro,2900,174,7,8,15,46.7%,23m
18153,1,MikeChicken,2900,187,6,6,12,50.0%,33m
18153,1,GaijinSan,2900,90,6,6,12,50.0%,12m
18153,2,Smart,2900,0,4,2,6,66.7%,7m
18153,2,Sekizou,2900,0,3,2,5,60.0%,14m
18153,2,[SJB]DroneTMX,2900,140,3,4,7,42.9%,46m
18153,2,[INCARD]Brownard,2900,90,3,5,8,37.5%,3m
18153,2,karantan,2900,88,2,0,2,100.0%,36m
18153,2,[Kyush0]Tabris,2900,30,2,1,3,66.7%,9m
18153,3,[GudC]Lightworker,2900,34,2,3,5,40.0%,3h
18153,1,JordanGamer,2900,0,1,0,1,100.0%,5m
18153,2,yoo,2900,0,1,1,2,50.0%,25m
18153,2,[0kyun0]SpyShadow,2900,30,1,3,4,25.0%,12m
18153,2,Reborn,2900,0,0,1,1,0.0%,21m
18153,2,Ben,2900,0,0,1,1,0.0%,18m
18153,2,TitaN,2900,0,0,1,1,0.0%,23m
18153,1,[WNTRCO]Kiljaden,2900,0,0,9,9,0.0%,19m
18184,2,SmRTneZ,2899,1627,247,211,458,53.9%,15m
18184,1,srseis,2899,1419,183,169,352,52.0%,8m
18184,2,Kyle,2899,1575,125,107,232,53.9%,21m
18184,2,Zazriel,2899,1647,124,100,224,55.4%,44m
18184,2,Shaepe,2899,1011,102,93,195,52.3%,16m
18184,3,[sk3tch]DarkVil,2899,973,81,83,164,49.4%,9m
18184,2,reyalsreggin,2899,1241,78,67,145,53.8%,19m
18184,2,[ººDKºº]VelvetJester,2899,1239,55,42,97,56.7%,2m
18184,2,JAVI,2899,888,38,27,65,58.5%,35m
18184,2,iDanTty,2899,608,27,19,46,58.7%,23m
18184,1,Sespino,2899,794,26,33,59,44.1%,43m
18184,1,FallenMechX,2899,560,23,21,44,52.3%,20m
18184,2,[FrH]Karrde,2899,538,20,17,37,54.1%,12m
18184,2,[Wufei]Kipiko,2899,393,18,15,33,54.5%,20m
18184,3,Blade,2899,370,18,29,47,38.3%,21m
18184,2,[Jimson]Roo,2899,448,16,15,31,51.6%,18m
18184,2,[BPM]basketcase,2899,276,13,8,21,61.9%,11m
18184,2,ThinkTwice,2899,358,13,14,27,48.1%,35m
18184,2,[LoF]DanubeDrop,2899,313,10,18,28,35.7%,46m
18184,2,grunt,2899,240,8,6,14,57.1%,16m
18184,2,[4KILL]GCaponi,2899,205,8,7,15,53.3%,2h
18184,1,Superion,2899,40,5,4,9,55.6%,12m
18184,2,Somnus,2899,148,5,7,12,41.7%,19m
18184,1,Agreda,2899,136,4,11,15,26.7%,18m
18184,2,StrikeForceQ,2899,102,3,1,4,75.0%,21m
18184,2,[YTOWN]Cocoqui,2899,0,3,2,5,60.0%,2h
18184,2,Precision,2899,0,3,2,5,60.0%,31m
18184,1,chaochao,2899,135,3,3,6,50.0%,2h
18184,2,Merlin,2899,88,3,4,7,42.9%,25m
18184,2,Firescout,2899,66,3,5,8,37.5%,28m
18184,2,moonrise,2899,0,2,3,5,40.0%,36m
18184,2,[VAPE7]THEGUY,2899,88,2,4,6,33.3%,17m
18184,2,Benjamin,2899,0,1,1,2,50.0%,15m
18184,2,WongAWitZ,2899,0,1,3,4,25.0%,12m
18184,2,KHALA,2899,0,0,1,1,0.0%,46m
18184,1,[NO0OBZ]Wysper,2899,0,0,1,1,0.0%,44m
18184,2,Terror,2899,0,0,3,3,0.0%,17m
18184,2,dolfin,2899,0,0,3,3,0.0%,13m
18222,2,Sarak,2898,1245,217,196,413,52.5%,14m
18222,2,daiwb,2898,1474,176,160,336,52.4%,4m
18222,2,Alcon,2898,789,32,28,60,53.3%,17m
18222,1,[Pig2]Whackmeat,2898,920,29,35,64,45.3%,21m
18222,2,BrazzaDiesel,2898,262,24,23,47,51.1%,27m
18222,2,DarkstonEr,2898,503,20,15,35,57.1%,5m
18222,2,Messorem,2898,133,15,19,34,44.1%,45m
18222,1,Amon,2898,330,13,12,25,52.0%,4m
18222,1,species,2898,132,11,12,23,47.8%,22m
18222,1,Deadking,2898,178,10,10,20,50.0%,2h
18222,2,NOUB,2898,288,10,12,22,45.5%,42m
18222,2,GuRuDeEp,2898,331,9,15,24,37.5%,23m
18222,2,nitsuJ,2898,176,8,7,15,53.3%,23m
18222,2,Cazinator,2898,214,8,12,20,40.0%,35m
18222,2,KindSir,2898,172,7,8,15,46.7%,23m
18222,2,[BPC]JFresh,2898,188,6,4,10,60.0%,19m
18222,2,[Y4NG20]Vengir,2898,204,6,7,13,46.2%,26m
18222,2,[CLCHOW]Gray,2898,30,4,3,7,57.1%,9m
18222,2,[AMPRO]Slugo,2898,86,4,5,9,44.4%,16m
18222,2,KILLAGUNFISH,2898,114,4,5,9,44.4%,10m
18222,2,BongBruiser,2898,0,3,1,4,75.0%,43m
18222,2,Challenger,2898,116,3,1,4,75.0%,43m
18222,2,ABCD,2898,0,3,2,5,60.0%,2h
18222,2,Aries,2898,128,3,3,6,50.0%,45m
18222,1,DrMario,2898,0,3,5,8,37.5%,32m
18222,2,DrBowMan,2898,0,1,0,1,100.0%,11m
18222,2,Earthquake,2898,0,1,1,2,50.0%,25m
18222,1,ZOLA,2898,48,1,2,3,33.3%,2h
18222,2,[WoodQc]GrapeJuice,2898,0,0,1,1,0.0%,13m
18222,2,Nine,2898,0,0,1,1,0.0%,20m
18222,3,nicematt,2898,0,0,8,8,0.0%,23m
18253,2,[INextI]cgiron,2897,1377,270,247,517,52.2%,19m
18253,2,Ejackulate,2897,1576,80,56,136,58.8%,15m
18253,2,[CFCoV]Vooner,2897,1397,77,71,148,52.0%,2m
18253,2,HoHoWizard,2897,1563,76,53,129,58.9%,16m
18253,2,NeoHopper,2897,387,67,64,131,51.1%,28m
18253,2,[Swtnss]ToXiCpRoToSs,2897,538,29,13,42,69.0%,12m
18253,1,COWABUNGA,2897,664,27,23,50,54.0%,12m
18253,2,twOhearts,2897,540,21,19,40,52.5%,30m
18253,2,[TOCUBA]TheMiner,2897,513,19,15,34,55.9%,28m
18253,2,[DRKDMN]cibergdf,2897,448,18,11,29,62.1%,44m
18253,2,therat,2897,420,15,16,31,48.4%,27m
18253,2,[AlIin]Ewendolus,2897,221,15,18,33,45.5%,26m
18253,2,[Cind3r]Hayes,2897,261,13,14,27,48.1%,3m
18253,2,[Cind3r]Amotokai,2897,299,11,7,18,61.1%,35m
18253,2,[TriFP]VicThor,2897,256,9,6,15,60.0%,4m
18253,2,[cuak64]Hellsen,2897,190,9,8,17,52.9%,31m
18253,3,chexmex,2897,170,7,5,12,58.3%,2h
18253,2,frog,2897,184,7,8,15,46.7%,25m
18253,1,pat,2897,220,7,14,21,33.3%,14m
18253,2,[Tiddys]Vendetta,2897,152,5,3,8,62.5%,15m
18253,2,[TheB4d]LazyMetroid,2897,153,5,3,8,62.5%,2m
18253,1,[nieBla]DarkLucifer,2897,48,4,4,8,50.0%,2h
18253,2,wazon,2897,88,4,6,10,40.0%,5m
18253,2,Garfield,2897,0,3,2,5,60.0%,2h
18253,2,Cleverbot,2897,0,3,2,5,60.0%,7m
18253,1,Ttori,2897,97,2,0,2,100.0%,15m
18253,1,[DogSma]Zime,2897,97,2,2,4,50.0%,1h
18253,2,[Xpk]Allegseu,2897,30,2,3,5,40.0%,17m
18253,2,pasteypickle,2897,0,1,0,1,100.0%,5m
18253,2,poWerStriKe,2897,0,1,0,1,100.0%,27m
18253,2,dsfgd,2897,88,1,1,2,50.0%,12m
18253,2,[DRKPMT]Gambling,2897,30,1,2,3,33.3%,9m
18253,3,llBalanaRll,2897,97,1,3,4,25.0%,30m
18253,2,Drewbear,2897,30,1,5,6,16.7%,25m
18253,2,[NextDC]Øµßø,2897,30,1,5,6,16.7%,36m
18253,2,RaYnPZ,2897,0,0,1,1,0.0%,25m
18253,2,GeneralSwift,2897,0,0,1,1,0.0%,24m
18290,2,apcslater,2896,1434,100,90,190,52.6%,43m
18290,1,CookieTime,2896,1191,69,75,144,47.9%,32m
18290,2,mariano,2896,926,38,27,65,58.5%,22m
18290,2,Yanixx,2896,588,21,23,44,47.7%,27m
18290,2,BunnyReborn,2896,374,15,10,25,60.0%,7m
18290,1,brian,2896,279,13,12,25,52.0%,36m
18290,2,Micront,2896,298,12,12,24,50.0%,9m
18290,2,TrashPleb,2896,303,11,8,19,57.9%,7m
18290,2,Stinger,2896,293,11,9,20,55.0%,15m
18290,1,kurby,2896,256,11,17,28,39.3%,36m
18290,3,[543253]Amon,2896,244,9,7,16,56.2%,44m
18290,2,Spartan,2896,191,7,3,10,70.0%,43m
18290,1,Acidix,2896,125,5,8,13,38.5%,9m
18290,2,Stefou,2896,132,3,1,4,75.0%,26m
18290,2,KINGSAINT,2896,0,3,2,5,60.0%,28m
18290,2,BABAKOLBEN,2896,144,2,4,6,33.3%,13m
18290,1,[HØST]hOREIA,2896,0,1,1,2,50.0%,5m
18290,1,TerranisBad,2896,48,1,3,4,25.0%,36m
18290,2,[Nestle]Denesis,2896,30,1,4,5,20.0%,17m
18290,2,Sourmintz,2896,0,0,1,1,0.0%,18m
18290,2,coorsllte,2896,0,0,1,1,0.0%,32m
18290,2,Ruthar,2896,0,0,1,1,0.0%,31m
18312,2,[cluez]laMusashi,2895,1206,160,143,303,52.8%,23m
18312,2,Depredador,2895,1515,140,121,261,53.6%,13m
18312,2,Vladyslav,2895,1558,97,77,174,55.7%,42m
18312,2,Decreed,2895,1476,81,88,169,47.9%,7m
18312,1,KPisNOOB,2895,714,51,45,96,53.1%,21m
18312,2,MacroMaster,2895,880,44,29,73,60.3%,5m
18312,1,killbutt,2895,928,39,53,92,42.4%,33m
18312,2,Yoon,2895,165,25,24,49,51.0%,45m
18312,2,yachster,2895,282,10,11,21,47.6%,26m
18312,2,IMaximus,2895,193,9,8,17,52.9%,11m
18312,1,Swagsterdoge,2895,251,7,4,11,63.6%,2h
18312,1,Yosefer,2895,145,5,2,7,71.4%,34m
18312,2,[AnimaS]StarkeRath,2895,183,5,6,11,45.5%,36m
18312,2,OsCeZrCd,2895,138,4,3,7,57.1%,11m
18312,1,[KANGS]Taco,2895,134,4,13,17,23.5%,32m
18312,2,BoneHunter,2895,0,3,2,5,60.0%,29m
18312,1,[WafTV]Wafer,2895,147,3,4,7,42.9%,2h
18312,2,[void44]Lilac,2895,114,2,2,4,50.0%,31m
18312,2,ianjianggg,2895,32,2,5,7,28.6%,16m
18312,2,GuitarNerd,2895,0,1,0,1,100.0%,3m
18312,2,[viwar]Megaroth,2895,0,1,0,1,100.0%,22m
18312,2,[FL4]PoCoYo,2895,0,1,0,1,100.0%,11m
18334,2,[NLTN]RickJames,2894,1553,148,143,291,50.9%,26m
18334,2,Yodabeast,2894,1557,107,94,201,53.2%,43m
18334,2,[queret]GhostMoiKaS,2894,1569,103,80,183,56.3%,36m
18334,3,ImpotantTime,2894,1559,88,106,194,45.4%,21m
18334,1,Fafner,2894,1525,57,59,116,49.1%,2m
18334,2,BruteLocket,2894,729,32,21,53,60.4%,24m
18334,1,blackforest,2894,798,31,30,61,50.8%,44m
18334,2,Sihv,2894,617,30,29,59,50.8%,27m
18334,1,Lemon,2894,727,29,28,57,50.9%,20m
18334,2,Mindtaker,2894,482,22,11,33,66.7%,7m
18334,2,[sc2ded]ninjamagics,2894,410,21,17,38,55.3%,13m
18334,2,Chiburashka,2894,415,17,15,32,53.1%,13m
18334,2,BascH,2894,296,11,16,27,40.7%,12m
18334,2,DeMiZeD,2894,260,9,6,15,60.0%,4m
18334,3,Tangruler,2894,235,9,7,16,56.2%,6m
18334,2,BIGPP,2894,166,9,11,20,45.0%,26m
18334,2,[NOKARL]GralHALLFIRE,2894,185,5,5,10,50.0%,46m
18334,2,aza,2894,0,4,1,5,80.0%,14m
18334,2,[PRVD]Oracle,2894,0,3,2,5,60.0%,2h
18334,2,Hextia,2894,0,3,2,5,60.0%,25m
18334,2,bbbbbbbutter,2894,0,3,2,5,60.0%,45m
18334,1,WorldPeace,2894,96,3,3,6,50.0%,17m
18334,1,Julian,2894,74,3,6,9,33.3%,43m
18334,2,dragonfly,2894,102,2,2,4,50.0%,11m
18334,2,Farsgull,2894,0,1,0,1,100.0%,5m
18334,2,[MCSC]Blade,2894,0,1,0,1,100.0%,31m
18334,2,EatBluBerry,2894,0,1,0,1,100.0%,1h
18334,3,[NMPro]Megatron,2894,0,1,1,2,50.0%,2h
18334,2,[TGosuC]Kind,2894,88,1,1,2,50.0%,36m
18334,3,[QTp2T]Voden,2894,36,1,2,3,33.3%,6m
18334,2,ultramega,2894,0,0,1,1,0.0%,20m
18365,2,[GOOOSE]mooplet,2893,1495,178,156,334,53.3%,15m
18365,2,Littlebee,2893,476,118,60,178,66.3%,24m
18365,1,Poohoombah,2893,1187,50,48,98,51.0%,8m
18365,1,jacob,2893,551,44,39,83,53.0%,13m
18365,2,Barvazz,2893,838,41,47,88,46.6%,16m
18365,1,likwid,2893,641,23,27,50,46.0%,24m
18365,3,[fui]hazenblaze,2893,274,22,10,32,68.8%,20m
18365,1,zZThuyZz,2893,473,20,16,36,55.6%,2m
18365,2,JudoKris,2893,474,20,21,41,48.8%,19m
18365,2,RonaldoJr,2893,441,17,14,31,54.8%,21m
18365,1,HughHoney,2893,320,9,12,21,42.9%,11m
18365,3,Captain,2893,185,8,4,12,66.7%,28m
18365,2,ZeitsAdes,2893,176,7,7,14,50.0%,12m
18365,2,Lamaza,2893,60,6,3,9,66.7%,13m
18365,2,MikuOkazaki,2893,215,6,11,17,35.3%,1h
18365,2,[STG]ElTrujas,2893,126,4,3,7,57.1%,6m
18365,2,koo,2893,79,4,5,9,44.4%,15m
18365,3,XtrainIII,2893,0,3,0,3,100.0%,17m
18365,2,[MoHo]Garf,2893,136,3,3,6,50.0%,46m
18365,2,Gcorcorann,2893,88,3,4,7,42.9%,17m
18365,2,light,2893,102,2,2,4,50.0%,22m
18365,2,[LTlord]elmormon,2893,34,2,6,8,25.0%,17m
18365,2,barcode,2893,0,1,0,1,100.0%,31m
18365,3,KAPETEBKA,2893,0,1,0,1,100.0%,9m
18365,2,[N4S]Zephyr,2893,30,1,2,3,33.3%,13m
18365,3,HaoD,2893,0,0,1,1,0.0%,5m
18365,2,TERRANZ,2893,0,0,2,2,0.0%,16m
18365,2,[UTMVAN]Whycolt,2893,0,0,3,3,0.0%,19m
18365,2,nåthan,2893,0,0,4,4,0.0%,10m
18394,3,basHimura,2892,1277,389,368,757,51.4%,30m
18394,1,Ostrich,2892,1131,235,216,451,52.1%,8m
18394,2,Zeddicus,2892,975,146,138,284,51.4%,11m
18394,1,Starkiller,2892,1463,84,80,164,51.2%,6m
18394,2,Biggerboot,2892,1145,70,70,140,50.0%,42m
18394,3,Legendary,2892,1156,51,31,82,62.2%,9m
18394,3,Gryphon,2892,1112,46,36,82,56.1%,36m
18394,3,[nieBla]Ridley,2892,817,36,24,60,60.0%,27m
18394,2,[DGotO]Dervish,2892,378,17,9,26,65.4%,36m
18394,2,TokerPrime,2892,348,16,10,26,61.5%,11m
18394,1,[xLgNx]DANTE,2892,496,16,19,35,45.7%,10m
18394,1,Koffy,2892,351,15,12,27,55.6%,17m
18394,2,lasag,2892,419,15,13,28,53.6%,42m
18394,1,FissionCorps,2892,369,15,22,37,40.5%,30m
18394,1,bronzERG,2892,343,13,10,23,56.5%,2h
18394,3,PriklyPuffer,2892,291,12,10,22,54.5%,29m
18394,2,[EZYtgt]Torn,2892,293,11,7,18,61.1%,7m
18394,2,[PpK69]MacroJordn,2892,289,11,8,19,57.9%,43m
18394,1,Kythera,2892,250,9,14,23,39.1%,12m
18394,2,kazaaiiiieee,2892,288,7,11,18,38.9%,35m
18394,3,Bukowskinatr,2892,154,6,5,11,54.5%,38m
18394,2,NubbyNubbs,2892,150,6,10,16,37.5%,11m
18394,1,Nikopol,2892,97,5,1,6,83.3%,2h
18394,1,Ben,2892,48,5,2,7,71.4%,21m
18394,2,Alex,2892,187,5,4,9,55.6%,13m
18394,3,[Raisin]Casszd,2892,30,4,3,7,57.1%,35m
18394,3,Feuer,2892,58,3,0,3,100.0%,2m
18394,2,Folconpunch,2892,128,3,3,6,50.0%,24m
18394,3,ivSeenBigger,2892,135,3,5,8,37.5%,11m
18394,2,Zedak,2892,114,2,3,5,40.0%,19m
18394,1,[Yeee]YaoMing,2892,0,1,0,1,100.0%,2h
18394,3,[4GH]thepatchman,2892,0,1,0,1,100.0%,36m
18394,3,[Lb7u7]MNTRXR,2892,0,1,0,1,100.0%,22m
18394,2,KabooNN,2892,88,1,2,3,33.3%,13m
18394,2,Vault,2892,94,1,4,5,20.0%,17m
18394,1,[USOMAD]MadMo,2892,0,1,6,7,14.3%,17m
18394,2,[178]Vajra,2892,30,1,6,7,14.3%,29m
18394,3,[SuperZ]JoHidding,2892,30,1,15,16,6.2%,46m
18394,2,Randy,2892,0,0,2,2,0.0%,13m
18394,1,[WDRE]BDsnickers,2892,0,0,8,8,0.0%,8m
18434,1,HornyZealot,2891,1616,165,156,321,51.4%,32m
18434,2,Sting,2891,1517,145,147,292,49.7%,26m
18434,2,Yorzh,2891,654,126,96,222,56.8%,23m
18434,1,[Aiuur]GillesDeRais,2891,1259,83,70,153,54.2%,8m
18434,3,Doraste,2891,1248,60,31,91,65.9%,22m
18434,2,LuCkSs,2891,1089,45,36,81,55.6%,8m
18434,2,[DB420]Balfarg,2891,492,33,25,58,56.9%,23m
18434,2,llEDll,2891,814,32,31,63,50.8%,11m
18434,2,[TLibre]keikito,2891,440,21,13,34,61.8%,43m
18434,2,Tankamaya,2891,438,16,14,30,53.3%,25m
18434,2,[WeGoon]bobjoe,2891,168,8,5,13,61.5%,19m
18434,2,lryS,2891,119,6,6,12,50.0%,2h
18434,1,[LFTEAM]TheGentleman,2891,190,5,16,21,23.8%,4m
18434,3,wcjerky,2891,0,4,3,7,57.1%,3h
18434,2,[Pirobo]PowerDC,2891,162,4,4,8,50.0%,24m
18434,3,Fatsopuff,2891,0,3,1,4,75.0%,8m
18434,3,Agentx,2891,0,3,2,5,60.0%,45m
18434,3,Gossamer,2891,0,3,2,5,60.0%,25m
18434,3,JimRaynor,2891,148,3,4,7,42.9%,37m
18434,3,uzer,2891,0,0,1,1,0.0%,8m
18434,2,Kilgore,2891,0,0,4,4,0.0%,19m
18455,1,Soil,2890,1629,118,112,230,51.3%,43m
18455,2,Kome,2890,1388,73,65,138,52.9%,5m
18455,1,Tiger,2890,1473,64,52,116,55.2%,10m
18455,1,[XDRAX8]Pupi,2890,1084,46,40,86,53.5%,27m
18455,3,[Pharoh]OMGitsNoob,2890,965,44,26,70,62.9%,21m
18455,2,Zero,2890,442,36,17,53,67.9%,7m
18455,1,Anyunitsbro,2890,508,24,20,44,54.5%,18m
18455,2,FreshestJeff,2890,352,15,7,22,68.2%,25m
18455,3,[Saludo]BRAD,2890,291,10,2,12,83.3%,32m
18455,2,Sindoray,2890,210,7,11,18,38.9%,19m
18455,1,PADADAPO,2890,96,4,5,9,44.4%,8m
18455,2,noot,2890,92,4,7,11,36.4%,13m
18455,3,SgtHattie,2890,131,4,7,11,36.4%,40m
18455,3,Shelly,2890,0,3,2,5,60.0%,8m
18455,1,LaughingMan,2890,96,3,3,6,50.0%,2h
18455,3,Wes,2890,30,2,0,2,100.0%,35m
18455,3,chelotus,2890,30,2,0,2,100.0%,24m
18455,3,Bane,2890,58,2,1,3,66.7%,25m
18455,2,Scorpio,2890,114,2,3,5,40.0%,7m
18455,2,[koook]Lahey,2890,60,2,3,5,40.0%,36m
18455,2,Kirito,2890,0,1,1,2,50.0%,19m
18455,3,john,2890,0,0,1,1,0.0%,2h
18477,1,[UpxV]Dumosday,2889,1574,204,187,391,52.2%,43m
18477,1,Asystole,2889,1426,133,132,265,50.2%,12m
18477,1,lux,2889,1221,96,80,176,54.5%,44m
18477,2,VeNoMoUzShOt,2889,607,76,71,147,51.7%,23m
18477,3,OldManWillow,2889,1199,59,63,122,48.4%,34m
18477,2,Explosivo,2889,1133,45,41,86,52.3%,35m
18477,1,Thrand,2889,900,37,32,69,53.6%,31m
18477,2,[PVZ50]VodkaApple,2889,396,31,30,61,50.8%,23m
18477,3,Netslayer,2889,429,18,4,22,81.8%,33m
18477,2,Yang,2889,525,18,18,36,50.0%,16m
18477,2,dandan,2889,362,12,13,25,48.0%,5m
18477,2,JhuN,2889,197,9,8,17,52.9%,1h
18477,2,[FxL]Eruci,2889,282,9,14,23,39.1%,12m
18477,2,[SkAL]watapinoy,2889,138,7,4,11,63.6%,6m
18477,1,IIIIIIIIIIII,2889,122,5,3,8,62.5%,2h
18477,3,Sebs,2889,131,3,3,6,50.0%,9m
18477,3,[ChCd]Marauder,2889,30,2,0,2,100.0%,5m
18477,1,Fusioncore,2889,97,2,0,2,100.0%,22m
18477,1,Conker,2889,48,2,1,3,66.7%,2h
18477,2,[PePOsO]Hanzo,2889,120,2,3,5,40.0%,24m
18477,2,[InDoGa]COWBOYBEEBOP,2889,0,1,1,2,50.0%,25m
18477,3,[NoiZ]TongXinLian,2889,0,1,4,5,20.0%,3m
18477,3,[LCLP]zerOvirus,2889,0,0,1,1,0.0%,11m
18477,3,Mogrom,2889,0,0,1,1,0.0%,16m
18477,1,jojo,2889,0,0,1,1,0.0%,3h
18477,2,FenLore,2889,0,0,2,2,0.0%,19m
18503,2,Bert,2888,1361,94,81,175,53.7%,19m
18503,2,Kizzal,2888,1598,88,75,163,54.0%,7m
18503,2,[BANZ]Kinufix,2888,1615,83,80,163,50.9%,34m
18503,2,[OnStiM]RedViper,2888,1036,71,56,127,55.9%,12m
18503,2,EMP,2888,869,59,52,111,53.2%,16m
18503,2,SlootyLoots,2888,1387,57,52,109,52.3%,12m
18503,1,Edril,2888,1012,51,60,111,45.9%,10m
18503,1,gEnibrE,2888,788,27,34,61,44.3%,45m
18503,1,Luigifila,2888,714,23,34,57,40.4%,22m
18503,1,[VLQL]Quebexico,2888,392,15,19,34,44.1%,34m
18503,2,[UpxV]RisingStar,2888,377,14,12,26,53.8%,42m
18503,2,Gztmo,2888,264,12,7,19,63.2%,12m
18503,2,[Black0]CHELOMANO,2888,241,8,6,14,57.1%,19m
18503,3,RoMaNeT,2888,178,7,4,11,63.6%,5m
18503,1,TeamMVP,2888,167,7,7,14,50.0%,13m
18503,1,[TeamUR]iPerspective,2888,83,6,10,16,37.5%,22m
18503,3,ONEmoreTIME,2888,97,5,3,8,62.5%,3h
18503,3,BernieSander,2888,0,4,1,5,80.0%,32m
18503,2,JMC,2888,0,3,2,5,60.0%,45m
18503,2,[tehbut]Voketo,2888,60,3,4,7,42.9%,45m
18503,1,GREMORY,2888,96,3,5,8,37.5%,17m
18503,3,[Normie]Nathan,2888,0,1,0,1,100.0%,37m
18503,3,[RolIin]Clown,2888,30,1,2,3,33.3%,24m
18503,3,Bazooka,2888,0,1,2,3,33.3%,40m
18503,3,Breeze,2888,0,1,4,5,20.0%,34m
18503,3,HybriD,2888,0,0,1,1,0.0%,27m
18503,3,[PHRMCY]Kryptonian,2888,0,0,1,1,0.0%,20m
18503,3,Profit,2888,0,0,1,1,0.0%,10m
18531,2,[ValidG]wdestop,2887,1615,305,271,576,53.0%,16m
18531,1,[dBASED]GrumpyMonk,2887,1622,298,277,575,51.8%,20m
18531,3,Goofball,2887,1469,120,93,213,56.3%,29m
18531,1,Demarr,2887,1137,77,82,159,48.4%,10m
18531,2,[sDADs]PROBEsweat,2887,1224,57,55,112,50.9%,26m
18531,1,Nelmen,2887,726,52,53,105,49.5%,45m
18531,2,AlphaPack,2887,534,29,25,54,53.7%,16m
18531,2,Carba,2887,678,23,27,50,46.0%,23m
18531,1,[RndNgr]WhimsOfFate,2887,515,21,14,35,60.0%,12m
18531,2,MintyFresh,2887,444,16,18,34,47.1%,12m
18531,3,[CHEE53]MOSFET,2887,381,15,10,25,60.0%,14m
18531,2,Mafiot,2887,380,15,13,28,53.6%,13m
18531,2,[AssSZN]SpankMaster,2887,343,13,11,24,54.2%,10m
18531,2,[VFam]LoveMachine,2887,374,13,12,25,52.0%,24m
18531,2,[SkAL]FrostyFenix,2887,256,10,10,20,50.0%,15m
18531,2,qwertycopter,2887,234,8,11,19,42.1%,28m
18531,2,FatWerm,2887,208,7,6,13,53.8%,35m
18531,2,Rabito,2887,176,7,7,14,50.0%,16m
18531,3,Velzix,2887,194,6,7,13,46.2%,4m
18531,3,Kundera,2887,142,5,4,9,55.6%,31m
18531,2,[JUGOS]MIAU,2887,152,5,7,12,41.7%,11m
18531,1,SnakeEater,2887,201,5,12,17,29.4%,9m
18531,3,MTHREE,2887,118,4,8,12,33.3%,34m
18531,2,theGoodWin,2887,126,3,3,6,50.0%,21m
18531,3,Flytrap,2887,30,2,0,2,100.0%,44m
18531,3,[AnT101]destyni,2887,97,2,1,3,66.7%,2h
18531,3,[SsSsX2]shniped,2887,0,1,0,1,100.0%,21m
18531,3,Ickle,2887,0,1,0,1,100.0%,46m
18531,1,[TpLn]JackedX,2887,0,1,0,1,100.0%,1h
18531,2,Fallout,2887,30,1,3,4,25.0%,15m
18531,3,[Weac]Sean,2887,0,0,1,1,0.0%,8m
18531,1,Rene,2887,0,0,2,2,0.0%,3h
18531,2,HahneBadger,2887,0,0,4,4,0.0%,45m
18564,2,DeMenD,2886,1558,65,54,119,54.6%,45m
18564,3,Rifshadow,2886,944,58,44,102,56.9%,36m
18564,2,[Ballz]Kaisad,2886,1025,52,43,95,54.7%,17m
18564,2,[BNKRZ]Jeffy,2886,787,33,35,68,48.5%,5m
18564,2,[uSuck]Freddeh,2886,636,26,23,49,53.1%,29m
18564,2,bilboswagins,2886,503,21,17,38,55.3%,46m
18564,2,IIIIII,2886,293,10,10,20,50.0%,18m
18564,2,brainsrgood,2886,232,9,7,16,56.2%,35m
18564,3,NaCHO,2886,185,8,5,13,61.5%,2h
18564,3,Naxo,2886,165,7,4,11,63.6%,23m
18564,3,Sarge,2886,97,6,2,8,75.0%,1h
18564,2,[Sune]Pilaf,2886,167,6,3,9,66.7%,24m
18564,3,[YEOBO]nahcaD,2886,0,5,0,5,100.0%,22m
18564,2,KingSimp,2886,192,5,6,11,45.5%,31m
18564,1,Already,2886,160,5,8,13,38.5%,31m
18564,1,[FDM]kyle,2886,141,4,2,6,66.7%,2h
18564,2,[WED]Magick,2886,92,3,6,9,33.3%,21m
18564,2,ditron,2886,94,3,6,9,33.3%,37m
18564,2,AMON,2886,90,3,11,14,21.4%,5m
18564,2,[TGCF]Matt,2886,88,2,1,3,66.7%,23m
18564,2,[DontRN]GerarldH,2886,112,2,3,5,40.0%,35m
18564,2,Herbmann,2886,0,2,3,5,40.0%,2h
18564,2,AMANGBS,2886,112,2,3,5,40.0%,17m
18564,2,Vivaldi,2886,30,2,6,8,25.0%,5m
18564,2,[XNo1]shimakaze,2886,0,1,0,1,100.0%,42m
18564,3,SieurLeFist,2886,30,1,10,11,9.1%,43m
18564,3,TheForce,2886,0,0,1,1,0.0%,28m
18564,1,[CMH]Giant,2886,0,0,1,1,0.0%,2h
18564,3,[Daimyo]Draconis,2886,0,0,1,1,0.0%,33m
18564,2,BUYUKIBNE,2886,0,0,3,3,0.0%,22m
18594,1,[Wienie]DuFF,2885,1623,249,226,475,52.4%,22m
18594,3,BigKahuna,2885,1563,244,249,493,49.5%,25m
18594,2,ado,2885,1576,155,145,300,51.7%,13m
18594,1,Thiccbagel,2885,1621,120,114,234,51.3%,8m
18594,2,[TPGGXD]Oxxoman,2885,1350,76,73,149,51.0%,10m
18594,2,[1MH1]Can,2885,1448,75,79,154,48.7%,28m
18594,2,Blacknight,2885,810,34,30,64,53.1%,17m
18594,2,BOSU,2885,361,15,18,33,45.5%,16m
18594,3,ZeNEXJaned,2885,338,15,23,38,39.5%,43m
18594,2,ComradeMitch,2885,280,11,9,20,55.0%,43m
18594,2,ricosuave,2885,310,11,10,21,52.4%,45m
18594,2,[SyL]Spencer,2885,290,9,6,15,60.0%,11m
18594,3,[BLOML]CygnusXone,2885,145,6,3,9,66.7%,2h
18594,2,YSC,2885,143,5,2,7,71.4%,17m
18594,3,jhimysenpai,2885,171,5,3,8,62.5%,28m
18594,2,[MCRmy]CutMESilly,2885,148,5,10,15,33.3%,3m
18594,1,DarkMonarch,2885,96,4,2,6,66.7%,3m
18594,2,MellowsDad,2885,170,4,5,9,44.4%,19m
18594,3,Shipa,2885,137,4,8,12,33.3%,28m
18594,3,VaGmastRson,2885,58,3,0,3,100.0%,22m
18594,2,raynor,2885,0,3,3,6,50.0%,24m
18594,2,SgtWuddel,2885,162,3,4,7,42.9%,2h
18594,1,Montassiner,2885,0,3,4,7,42.9%,2h
18594,1,Mamak,2885,0,2,2,4,50.0%,37m
18594,2,Geoff,2885,32,2,3,5,40.0%,37m
18594,1,[BOTA]Salorah,2885,96,2,3,5,40.0%,17m
18594,1,[C2N]McCain,2885,0,2,5,7,28.6%,8m
18594,1,Marinah,2885,90,2,8,10,20.0%,21m
18594,3,Zergi,2885,0,1,0,1,100.0%,9m
18594,1,Swords,2885,0,1,1,2,50.0%,15m
18594,3,Odyssey,2885,30,1,1,2,50.0%,25m
18594,2,IIIIllllIII,2885,30,1,3,4,25.0%,21m
18594,1,TheAssassin,2885,0,0,8,8,0.0%,9m
18627,2,LazyGoat,2884,1404,144,124,268,53.7%,17m
18627,2,HellBoy,2884,1615,127,120,247,51.4%,5m
18627,1,[xABQx]HerrDoktor,2884,1221,117,117,234,50.0%,20m
18627,2,[Dicboy]JohnnyUtah,2884,1358,55,48,103,53.4%,17m
18627,1,Eduarever,2884,414,55,58,113,48.7%,31m
18627,2,[BALAUR]Grekor,2884,969,38,34,72,52.8%,5m
18627,1,Gas,2884,714,28,29,57,49.1%,5m
18627,2,Realphil,2884,446,20,18,38,52.6%,10m
18627,2,gus,2884,464,19,18,37,51.4%,31m
18627,2,xprincesax,2884,213,13,12,25,52.0%,17m
18627,3,[JOOMA]moon,2884,302,11,6,17,64.7%,47m
18627,3,[213T]Jeremy,2884,193,8,6,14,57.1%,7m
18627,3,[3HMONG]Danny,2884,144,7,4,11,63.6%,22m
18627,1,lumps,2884,216,6,6,12,50.0%,15m
18627,2,[EtrOy]Magneto,2884,168,5,4,9,55.6%,14m
18627,3,Ges,2884,126,5,12,17,29.4%,44m
18627,2,Bargosk,2884,88,2,1,3,66.7%,46m
18627,2,Gator,2884,30,2,2,4,50.0%,2m
18627,2,[Wonkru]Xpyosckio,2884,102,2,2,4,50.0%,5m
18627,3,ToySoldier,2884,0,2,2,4,50.0%,15m
18627,2,[Z00]LoreHound,2884,108,2,3,5,40.0%,19m
18627,2,Tsunami,2884,135,2,6,8,25.0%,3h
18627,3,KingKiller,2884,0,1,0,1,100.0%,29m
18627,3,rubrapter,2884,30,1,1,2,50.0%,19m
18627,2,FUNDAYMONDAY,2884,0,1,4,5,20.0%,16m
18627,3,Graphite,2884,0,0,1,1,0.0%,26m
18627,3,DyrtyByrd,2884,0,0,1,1,0.0%,42m
18627,3,BIGJUICY,2884,0,0,1,1,0.0%,34m
18627,2,BoboKassidy,2884,0,0,3,3,0.0%,16m
18656,2,Inti,2883,1522,197,179,376,52.4%,36m
18656,2,TyCoAvenger,2883,1527,109,77,186,58.6%,5m
18656,2,Funky,2883,1597,100,101,201,49.8%,11m
18656,2,mothoglan,2883,1568,95,82,177,53.7%,29m
18656,2,[PiGPan]MaxxSann,2883,1547,83,82,165,50.3%,17m
18656,2,RoadDoc,2883,1302,78,78,156,50.0%,14m
18656,2,[MZOWZ]Mealz,2883,1411,73,68,141,51.8%,35m
18656,2,PinkFreud,2883,661,73,70,143,51.0%,13m
18656,2,Fate,2883,770,63,37,100,63.0%,29m
18656,2,[DETER]DRock,2883,1010,61,62,123,49.6%,24m
18656,2,palespartan,2883,905,38,33,71,53.5%,5m
18656,2,[Prison]Ishmael,2883,737,37,44,81,45.7%,10m
18656,2,ForAiur,2883,713,28,35,63,44.4%,33m
18656,2,improvise,2883,573,24,18,42,57.1%,19m
18656,2,[KhanZ]jrock,2883,588,23,19,42,54.8%,24m
18656,1,[rshDIE]Baconidas,2883,559,23,22,45,51.1%,8m
18656,2,[xNGx]WokeAssClown,2883,394,18,12,30,60.0%,14m
18656,1,[SDTL]Ian,2883,504,18,25,43,41.9%,43m
18656,2,[cl0udM]burmel,2883,307,13,11,24,54.2%,13m
18656,1,CrabPulsar,2883,300,12,15,27,44.4%,4m
18656,2,BarrelRoll,2883,262,9,9,18,50.0%,1h
18656,2,Kohinoor,2883,330,9,19,28,32.1%,24m
18656,2,[Flam3s]Link,2883,182,6,7,13,46.2%,19m
18656,2,GaryIndiana,2883,210,6,7,13,46.2%,7m
18656,2,Salo,2883,150,6,8,14,42.9%,46m
18656,2,gogogo,2883,132,5,4,9,55.6%,12m
18656,1,AgentSmith,2883,95,4,2,6,66.7%,3h
18656,3,[4x4]Blazebot,2883,117,4,3,7,57.1%,25m
18656,2,SprProPlayer,2883,90,3,6,9,33.3%,18m
18656,2,Joshua,2883,0,2,3,5,40.0%,1h
18656,2,dogdickdaddy,2883,30,2,3,5,40.0%,30m
18656,1,[BaT]Thyralas,2883,97,1,2,3,33.3%,1h
18656,2,bee,2883,30,1,3,4,25.0%,36m
18656,3,HASHTAGBLM,2883,0,1,3,4,25.0%,2h
18656,1,joemeister,2883,0,1,6,7,14.3%,18m
18656,3,[DI3FT]LAVAL,2883,0,0,1,1,0.0%,14m
18656,3,StyliAnT,2883,0,0,1,1,0.0%,43m
18656,3,[ÆON]Zerg,2883,0,0,1,1,0.0%,23m
18694,2,FAHIM,2882,1538,156,137,293,53.2%,5m
18694,2,Eon,2882,1131,58,41,99,58.6%,17m
18694,2,IIIIIIIIIIII,2882,922,36,32,68,52.9%,42m
18694,2,[RW5150]ogzxro,2882,852,32,32,64,50.0%,23m
18694,3,Kylobe,2882,458,31,20,51,60.8%,22m
18694,2,Kevin,2882,707,25,28,53,47.2%,25m
18694,2,HerHuchu,2882,489,23,17,40,57.5%,19m
18694,3,Ethanalev,2882,556,21,16,37,56.8%,29m
18694,3,[xNPGx]Jhandro,2882,296,12,0,12,100.0%,46m
18694,2,CowTipper,2882,236,9,11,20,45.0%,13m
18694,1,[TREXX]Rexhanh,2882,220,8,10,18,44.4%,29m
18694,1,GGgame,2882,30,6,3,9,66.7%,12m
18694,2,[IMDSI]JepitoBv,2882,130,5,1,6,83.3%,19m
18694,2,Andrew,2882,120,5,8,13,38.5%,27m
18694,3,Frost,2882,86,4,1,5,80.0%,16m
18694,3,Infrared,2882,0,4,1,5,80.0%,8m
18694,2,russyg,2882,116,4,3,7,57.1%,30m
18694,2,Ghost,2882,0,3,3,6,50.0%,21m
18694,2,[LNJ]Marten,2882,30,2,2,4,50.0%,11m
18694,2,Roach,2882,30,2,3,5,40.0%,3m
18694,3,DameWinPLIS,2882,118,2,4,6,33.3%,28m
18694,3,frogician,2882,30,1,1,2,50.0%,27m
18694,2,Hariel,2882,0,1,1,2,50.0%,43m
18694,1,Maarten,2882,48,1,2,3,33.3%,3h
18694,2,jedii,2882,30,1,5,6,16.7%,16m
18694,3,Shwein,2882,0,0,1,1,0.0%,10m
18694,2,[XZL]Mantequilla,2882,0,0,2,2,0.0%,31m
18694,2,Zimap,2882,0,0,3,3,0.0%,19m
18722,3,Timshel,2881,1625,140,112,252,55.6%,8m
18722,2,Plumbus,2881,1735,132,210,342,38.6%,27m
18722,3,PlayerTwo,2881,1542,123,96,219,56.2%,8m
18722,1,STORM,2881,1569,114,91,205,55.6%,34m
18722,1,Earlobe,2881,1457,83,82,165,50.3%,21m
18722,2,CenoraBronze,2881,1249,59,35,94,62.8%,45m
18722,2,Wanderus,2881,585,53,48,101,52.5%,11m
18722,3,lllllllllll,2881,1003,52,10,62,83.9%,13m
18722,2,Ariel,2881,1340,52,54,106,49.1%,5m
18722,1,[LCE]FranciscoG,2881,1240,46,50,96,47.9%,26m
18722,2,Troddler,2881,375,35,23,58,60.3%,17m
18722,2,[GFUEL]iamBAM,2881,339,25,21,46,54.3%,26m
18722,2,GreccoF,2881,487,18,17,35,51.4%,34m
18722,3,[xEx]monash,2881,464,17,16,33,51.5%,33m
18722,1,IMZercker,2881,308,11,10,21,52.4%,2h
18722,2,[FxA]PasQ,2881,338,11,16,27,40.7%,28m
18722,2,kistakonypoc,2881,204,10,9,19,52.6%,19m
18722,2,[shd0w]ShadowWalker,2881,241,8,7,15,53.3%,10m
18722,2,TheStarMusic,2881,133,7,11,18,38.9%,27m
18722,2,GOLDENEAGLE,2881,130,5,1,6,83.3%,29m
18722,3,[notCo]Raistlin,2881,115,4,3,7,57.1%,28m
18722,2,TaCoMunCher,2881,0,3,1,4,75.0%,2h
18722,2,Souldeceiver,2881,0,3,2,5,60.0%,29m
18722,1,[BlTEL]Lurp,2881,0,3,3,6,50.0%,17m
18722,2,Mythrandir,2881,98,3,6,9,33.3%,39m
18722,2,[KOOMER]PIPES,2881,60,2,4,6,33.3%,11m
18722,3,Quilna,2881,0,1,0,1,100.0%,46m
18722,2,VoidRayChrLs,2881,0,1,0,1,100.0%,1h
18722,3,SCNESS,2881,0,1,0,1,100.0%,13m
18722,2,ScarleTFever,2881,88,1,2,3,33.3%,30m
18722,2,BulldozedAU,2881,34,1,4,5,20.0%,17m
18722,3,Braindead,2881,0,0,1,1,0.0%,28m
18722,3,Martinator,2881,0,0,1,1,0.0%,5m
18722,2,[Onward]Raxor,2881,0,0,2,2,0.0%,8m
18756,2,[TVN]KKanalonga,2880,1542,138,112,250,55.2%,17m
18756,2,Sephiroth,2880,1382,94,80,174,54.0%,46m
18756,2,mrcrs,2880,864,79,59,138,57.2%,21m
18756,1,eleden,2880,1338,78,65,143,54.5%,20m
18756,1,specialed,2880,1045,40,42,82,48.8%,27m
18756,2,Wonder,2880,762,35,22,57,61.4%,18m
18756,2,[NOBDGR]QBLA,2880,803,29,31,60,48.3%,8m
18756,1,[HZxZ]Warwind,2880,582,23,25,48,47.9%,27m
18756,2,ZAGA,2880,160,21,18,39,53.8%,11m
18756,2,OldGameboy,2880,604,21,27,48,43.8%,30m
18756,1,Ckl,2880,443,18,19,37,48.6%,5m
18756,2,CerroAzul,2880,252,16,21,37,43.2%,13m
18756,1,Nicole,2880,504,16,27,43,37.2%,20m
18756,2,Hadrian,2880,421,15,14,29,51.7%,21m
18756,3,Deputy,2880,271,13,15,28,46.4%,5m
18756,3,CountDooku,2880,339,12,5,17,70.6%,5m
18756,1,chris,2880,256,11,10,21,52.4%,17m
18756,1,NewToSC,2880,277,11,12,23,47.8%,41m
18756,1,Eibud,2880,328,11,18,29,37.9%,28m
18756,3,[TTKOPF]GrajoSombrío,2880,150,6,5,11,54.5%,4m
18756,2,Wicholmaster,2880,120,5,7,12,41.7%,21m
18756,3,Star,2880,58,2,1,3,66.7%,9m
18756,2,[Astute]BroodKingEXE,2880,114,2,3,5,40.0%,22m
18756,1,[Alown]CYY,2880,0,1,1,2,50.0%,1h
18756,1,[Ex7rA]Pan,2880,0,1,4,5,20.0%,5m
18756,1,[AwaR]Fenix,2880,0,0,1,1,0.0%,3h
18756,3,thanes,2880,0,0,1,1,0.0%,5m
18756,3,GBL,2880,0,0,1,1,0.0%,16m
18756,1,Eco,2880,0,0,1,1,0.0%,2h
18756,2,[LRN]xWaRxVolratx,2880,0,0,2,2,0.0%,36m
18786,3,Costilla,2879,1265,166,144,310,53.5%,33m
18786,2,[JOSOWE]HeroZealot,2879,1481,134,94,228,58.8%,23m
18786,1,[BoRnGo]DarthJulius,2879,1486,83,86,169,49.1%,22m
18786,2,[GOPERÚ]Nagato,2879,323,34,12,46,73.9%,35m
18786,3,SuperNinja,2879,515,29,13,42,69.0%,5m
18786,2,[VFam]Andrew,2879,644,27,22,49,55.1%,29m
18786,1,ElCocumbre,2879,438,19,17,36,52.8%,20m
18786,3,Flower,2879,351,16,6,22,72.7%,3m
18786,3,[OhhGG]Landwalker,2879,400,16,11,27,59.3%,27m
18786,3,Renduras,2879,287,15,12,27,55.6%,14m
18786,2,Snij,2879,390,14,7,21,66.7%,35m
18786,2,AsIWasSaying,2879,392,14,13,27,51.9%,13m
18786,2,Zwei,2879,292,10,12,22,45.5%,33m
18786,2,joehuaman,2879,208,8,4,12,66.7%,11m
18786,3,Precise,2879,196,7,6,13,53.8%,34m
18786,3,Future,2879,192,6,12,18,33.3%,23m
18786,1,cpt,2879,145,5,4,9,55.6%,6m
18786,2,BattleMech,2879,122,5,8,13,38.5%,27m
18786,3,bluemage,2879,67,4,3,7,57.1%,25m
18786,2,SnappierOwl,2879,0,3,2,5,60.0%,2h
18786,2,Goojie,2879,58,3,4,7,42.9%,22m
18786,2,Jeramaya,2879,60,3,5,8,37.5%,28m
18786,2,[Fellaz]Wheels,2879,62,3,5,8,37.5%,7m
18786,3,Taroro,2879,0,2,3,5,40.0%,32m
18786,2,Papanek,2879,0,2,3,5,40.0%,2h
18786,2,ZUBS,2879,0,1,1,2,50.0%,43m
18786,3,CartoonBox,2879,0,1,1,2,50.0%,13m
18786,1,Mithrandir,2879,0,1,2,3,33.3%,25m
18786,3,skarloey,2879,0,1,2,3,33.3%,3h
18786,2,GayMaster,2879,0,1,2,3,33.3%,42m
18786,1,aQa,2879,0,1,2,3,33.3%,2h
18786,3,[XTGZ]Zhubouchi,2879,0,0,1,1,0.0%,11m
18786,3,Ethereal,2879,0,0,1,1,0.0%,11m
18786,2,TataPinochet,2879,0,0,2,2,0.0%,31m
18786,2,Doctor,2879,0,0,3,3,0.0%,2m
18821,1,Rodriguex,2878,1155,128,126,254,50.4%,23m
18821,2,[AdapTs]Sleepwalker,2878,1524,69,64,133,51.9%,2m
18821,3,Stef,2878,1175,44,48,92,47.8%,34m
18821,1,Tearbath,2878,687,42,47,89,47.2%,45m
18821,2,yeeeeeeeeeet,2878,749,41,19,60,68.3%,5m
18821,2,[OPbois]PassiveFist,2878,1028,37,39,76,48.7%,45m
18821,2,TigOlBitties,2878,770,27,28,55,49.1%,23m
18821,1,Dietgasoline,2878,148,20,23,43,46.5%,21m
18821,2,[GoMeLZ]Fabb,2878,394,13,13,26,50.0%,17m
18821,2,EvgenAvt,2878,288,13,16,29,44.8%,22m
18821,2,GVIA,2878,304,12,10,22,54.5%,33m
18821,2,Laertes,2878,324,11,11,22,50.0%,21m
18821,3,Bruce,2878,226,10,17,27,37.0%,18m
18821,1,PingPOngne,2878,207,6,12,18,33.3%,2h
18821,1,iogo,2878,0,5,2,7,71.4%,18m
18821,2,[TØXIC]ilovececy,2878,112,5,3,8,62.5%,36m
18821,2,FORTRESS,2878,58,5,6,11,45.5%,20m
18821,3,[Rela]JamirL,2878,114,4,3,7,57.1%,10m
18821,3,[FARIS]Sovereign,2878,0,3,2,5,60.0%,13m
18821,2,[FyHr]Melichan,2878,140,3,5,8,37.5%,34m
18821,3,[WNTRCH]Broomhill,2878,60,2,3,5,40.0%,32m
18821,3,MxGDrek,2878,0,1,0,1,100.0%,6m
18821,2,bsuperkid,2878,0,1,2,3,33.3%,13m
18821,3,Mckay,2878,0,0,1,1,0.0%,22m
18821,3,[AIlin]Ballod,2878,0,0,1,1,0.0%,30m
18821,2,Fulo,2878,0,0,3,3,0.0%,42m
18847,1,sLiCk,2877,1635,198,183,381,52.0%,27m
18847,2,moonlight,2877,1462,142,133,275,51.6%,18m
18847,2,littleduck,2877,300,108,93,201,53.7%,25m
18847,2,Tiger,2877,1284,69,54,123,56.1%,21m
18847,2,GrayFox,2877,1585,66,67,133,49.6%,22m
18847,3,izuru,2877,910,34,33,67,50.7%,7m
18847,2,Mictlan,2877,795,33,24,57,57.9%,6m
18847,2,dominic,2877,620,29,20,49,59.2%,21m
18847,2,[Crazed]CrazyCritter,2877,511,21,17,38,55.3%,43m
18847,1,[L3GND]Light,2877,331,20,23,43,46.5%,5m
18847,3,Emracool,2877,350,16,9,25,64.0%,32m
18847,2,[QMS]Harbinger,2877,448,16,13,29,55.2%,19m
18847,1,YungShinji,2877,475,16,23,39,41.0%,11m
18847,2,Endless,2877,284,12,6,18,66.7%,22m
18847,2,eletari,2877,312,12,9,21,57.1%,17m
18847,1,[ZTemps]Dumbeldombor,2877,326,11,18,29,37.9%,46m
18847,3,[cluez]ArcticMonkey,2877,226,9,4,13,69.2%,20m
18847,2,[Onnor]colonelxc,2877,294,9,8,17,52.9%,35m
18847,2,botoxman,2877,200,9,10,19,47.4%,13m
18847,3,DoubleEdge,2877,163,5,0,5,100.0%,2h
18847,3,Raindog,2877,144,5,4,9,55.6%,44m
18847,3,[dLife]CDNshepard,2877,173,5,8,13,38.5%,3h
18847,3,IIIIIIIIII,2877,86,4,1,5,80.0%,7m
18847,2,FaceToucher,2877,92,3,6,9,33.3%,35m
18847,2,WoTiF,2877,88,3,7,10,30.0%,26m
18847,2,fizzwiththiz,2877,90,3,8,11,27.3%,22m
18847,2,Rugarug,2877,88,2,1,3,66.7%,25m
18847,3,SixtyNine,2877,58,2,1,3,66.7%,46m
18847,2,[ExcIgN]Raúl,2877,30,2,2,4,50.0%,18m
18847,2,WinStonSC,2877,88,2,5,7,28.6%,29m
18847,1,Dodgson,2877,58,2,9,11,18.2%,12m
18847,2,demonioloco,2877,0,1,1,2,50.0%,43m
18847,2,Nightman,2877,30,1,6,7,14.3%,12m
18847,3,[Build]Crabalanche,2877,0,0,1,1,0.0%,7m
18847,3,melville,2877,0,0,1,1,0.0%,8m
18847,2,ZeroMan,2877,0,0,5,5,0.0%,42m
18883,3,AlacranRojo,2876,1556,413,414,827,49.9%,13m
18883,2,HiddenPants,2876,1091,134,121,255,52.5%,20m
18883,2,nuttysquirel,2876,1581,103,92,195,52.8%,25m
18883,2,nowins,2876,1377,81,93,174,46.6%,21m
18883,2,Wileykyoti,2876,1530,67,59,126,53.2%,6m
18883,1,FogSpecter,2876,1473,59,55,114,51.8%,5m
18883,1,elim,2876,612,50,38,88,56.8%,24m
18883,2,VLIXES,2876,784,37,32,69,53.6%,17m
18883,2,BARON,2876,710,28,27,55,50.9%,24m
18883,2,[Just1n]Trudeau,2876,571,28,28,56,50.0%,16m
18883,2,[FFBP]Stirfryed,2876,366,14,10,24,58.3%,36m
18883,3,Tempo,2876,343,14,11,25,56.0%,21m
18883,2,Selluriah,2876,178,9,8,17,52.9%,33m
18883,1,TJosh,2876,308,9,19,28,32.1%,43m
18883,3,Sitruc,2876,211,8,6,14,57.1%,45m
18883,2,BabyZergling,2876,60,5,5,10,50.0%,42m
18883,2,[1vsM]Kibblznbitz,2876,152,5,11,16,31.2%,33m
18883,3,Proffit,2876,86,4,1,5,80.0%,21m
18883,2,Luck,2876,86,4,4,8,50.0%,31m
18883,2,alemanu,2876,90,4,5,9,44.4%,34m
18883,1,hotcheese,2876,0,3,3,6,50.0%,2h
18883,3,Fabrebel,2876,0,2,2,4,50.0%,11m
18883,2,[USOMAD]NameHere,2876,60,2,4,6,33.3%,17m
18883,2,[IBIAl]wesmantooth,2876,58,2,5,7,28.6%,20m
18883,2,PhoenixOne,2876,0,1,0,1,100.0%,17m
18883,3,ImBad,2876,0,1,0,1,100.0%,3h
18883,3,BlackSwarm,2876,96,1,1,2,50.0%,12m
18883,3,LDYZnGENTLMN,2876,0,0,1,1,0.0%,28m
18883,3,RANDOM,2876,0,0,1,1,0.0%,32m
18883,3,keyren,2876,0,0,1,1,0.0%,29m
18913,1,Eraser,2875,791,134,124,258,51.9%,34m
18913,1,DJR,2875,1122,64,53,117,54.7%,31m
18913,1,Nesto,2875,1385,52,57,109,47.7%,43m
18913,2,HairyOlives,2875,505,40,29,69,58.0%,8m
18913,2,[Exper]Tanus,2875,537,27,18,45,60.0%,35m
18913,3,issue,2875,670,25,22,47,53.2%,28m
18913,2,Ritchan,2875,310,20,20,40,50.0%,18m
18913,3,iiiiiiiiiiii,2875,389,16,9,25,64.0%,28m
18913,2,ElTemido,2875,454,16,16,32,50.0%,32m
18913,2,Bekom,2875,350,13,11,24,54.2%,36m
18913,2,fryzee,2875,244,11,9,20,55.0%,28m
18913,2,Flex,2875,254,10,7,17,58.8%,2h
18913,3,SpaceGator,2875,134,9,4,13,69.2%,25m
18913,2,[KOTZ]Dawson,2875,260,9,9,18,50.0%,23m
18913,2,Augusto,2875,145,6,9,15,40.0%,10m
18913,3,JoshuaAL,2875,30,5,1,6,83.3%,28m
18913,2,UncleMagic,2875,92,4,10,14,28.6%,35m
18913,1,Clancy,2875,46,4,10,14,28.6%,2h
18913,2,westview,2875,126,3,3,6,50.0%,18m
18913,2,[Chaims]Jamescell,2875,138,3,4,7,42.9%,11m
18913,3,Arceus,2875,58,2,1,3,66.7%,9m
18913,3,Nautilus,2875,0,1,0,1,100.0%,32m
18935,2,SgRedeemer,2874,1690,753,715,1468,51.3%,46m
18935,2,DrStrangeluv,2874,1588,213,189,402,53.0%,19m
18935,2,Scotty,2874,902,136,111,247,55.1%,35m
18935,2,Roland,2874,798,122,104,226,54.0%,27m
18935,2,[MPC]ThexArtistx,2874,1589,99,85,184,53.8%,29m
18935,2,Rory,2874,549,22,21,43,51.2%,8m
18935,2,Karaage,2874,362,13,13,26,50.0%,13m
18935,2,Haz,2874,269,12,7,19,63.2%,10m
18935,2,[Jamin]SbCarrisai,2874,266,10,7,17,58.8%,27m
18935,2,WalrusFangs,2874,170,6,3,9,66.7%,13m
18935,2,Duet,2874,128,4,2,6,66.7%,19m
18935,1,Ricodius,2874,122,4,3,7,57.1%,2h
18935,2,Shen,2874,0,3,2,5,60.0%,28m
18935,3,sebO,2874,0,3,2,5,60.0%,45m
18935,3,chip,2874,0,3,2,5,60.0%,46m
18935,2,TomBrady,2874,90,3,7,10,30.0%,16m
18935,2,Pootis,2874,88,2,1,3,66.7%,24m
18935,1,[xLgNx]IamGroot,2874,84,2,11,13,15.4%,18m
18935,1,[WAAL]themooingpig,2874,0,1,0,1,100.0%,2h
18935,3,[Potate]Xecutioner,2874,30,1,1,2,50.0%,32m
18935,1,[REPORT]Bloodbath,2874,0,1,2,3,33.3%,2h
18935,2,ChrisUnknown,2874,0,1,4,5,20.0%,1h
18935,3,PonySoprano,2874,0,0,1,1,0.0%,24m
18935,3,[Isight]Silence,2874,0,0,1,1,0.0%,34m
18935,2,BMcFatty,2874,0,0,1,1,0.0%,1h
18935,2,VkS,2874,0,0,2,2,0.0%,8m
18961,1,Fade,2873,1606,96,92,188,51.1%,31m
18961,2,MagnusXtian,2873,1608,81,79,160,50.6%,24m
18961,3,Gneric,2873,630,69,52,121,57.0%,5m
18961,3,DontRushMe,2873,561,65,56,121,53.7%,17m
18961,2,CnonRushIsHo,2873,1453,62,53,115,53.9%,17m
18961,1,LiquidSoap,2873,1369,57,61,118,48.3%,5m
18961,2,[TiibaG]LoboJosh,2873,694,28,23,51,54.9%,2m
18961,1,[DSAL]XsouskeX,2873,744,27,30,57,47.4%,43m
18961,3,Crucian,2873,639,23,20,43,53.5%,32m
18961,2,ILoveWhiskey,2873,556,21,23,44,47.7%,3m
18961,3,Noobler,2873,423,19,13,32,59.4%,33m
18961,3,[eli]Jared,2873,239,8,8,16,50.0%,2h
18961,3,IIIIIIIIIIII,2873,163,8,8,16,50.0%,25m
18961,2,[BoAVN]ForAiur,2873,128,7,8,15,46.7%,32m
18961,1,Shingurai,2873,192,6,4,10,60.0%,1h
18961,2,[FalPal]Olozzalap,2873,119,6,4,10,60.0%,33m
18961,3,Humaku,2873,174,6,6,12,50.0%,13m
18961,2,SmurfysLaw,2873,146,6,6,12,50.0%,8m
18961,1,MarCraft,2873,97,4,2,6,66.7%,2h
18961,3,Sundawgsmexy,2873,30,4,3,7,57.1%,32m
18961,1,Trululu,2873,48,4,4,8,50.0%,8m
18961,3,WeiR,2873,86,3,1,4,75.0%,26m
18961,3,Mist,2873,30,2,1,3,66.7%,22m
18961,1,[Ec0s]Pancho,2873,0,2,2,4,50.0%,20m
18961,2,jotap,2873,64,2,7,9,22.2%,12m
18961,3,mattster,2873,0,1,1,2,50.0%,33m
18961,2,[AltQQ]Mystiq,2873,88,1,2,3,33.3%,8m
18961,2,[LQV]IJGI,2873,0,1,2,3,33.3%,36m
18961,2,Vanillag,2873,30,1,3,4,25.0%,34m
18961,3,StyleOfMe,2873,0,0,1,1,0.0%,24m
18961,2,[FwithT]Night,2873,0,0,3,3,0.0%,23m
18961,2,enroca,2873,0,0,3,3,0.0%,5m
18993,1,[MexTab]Santiago,2872,1614,302,293,595,50.8%,27m
18993,2,etzhang,2872,1568,85,76,161,52.8%,16m
18993,2,[churrr]Iroh,2872,1340,57,56,113,50.4%,13m
18993,3,[SC2Hn]orion,2872,864,55,34,89,61.8%,19m
18993,2,WhiteLie,2872,1147,50,41,91,54.9%,36m
18993,2,Mursaat,2872,731,45,35,80,56.2%,5m
18993,1,Dulvalius,2872,624,44,44,88,50.0%,43m
18993,2,hardbasset,2872,685,29,31,60,48.3%,12m
18993,1,RRRRRRRRRRRR,2872,404,12,25,37,32.4%,46m
18993,3,JSJS,2872,326,11,6,17,64.7%,4m
18993,2,SkyNet,2872,167,7,8,15,46.7%,7m
18993,2,[WNDF]Gfunkhouse,2872,188,7,10,17,41.2%,13m
18993,1,DddLll,2872,118,4,3,7,57.1%,2h
18993,1,RedDuck,2872,0,3,4,7,42.9%,35m
18993,2,chooochooo,2872,0,2,3,5,40.0%,2h
18993,2,ARTHUR,2872,30,2,6,8,25.0%,36m
18993,1,Eidolon,2872,96,2,9,11,18.2%,3h
18993,3,Exile,2872,0,1,2,3,33.3%,25m
18993,3,[MCHG]SaveD,2872,0,0,1,1,0.0%,27m
18993,3,Hydargos,2872,0,0,1,1,0.0%,28m
19013,2,Gabriel,2871,1612,574,539,1113,51.6%,21m
19013,1,Disto,2871,1380,161,158,319,50.5%,8m
19013,2,RaphaelGa,2871,1281,51,51,102,50.0%,46m
19013,2,Jeeewlyfe,2871,265,29,27,56,51.8%,19m
19013,2,[ThEps]Dread,2871,673,28,21,49,57.1%,46m
19013,2,[GRNDMA]Oranos,2871,464,20,18,38,52.6%,27m
19013,3,[BLZN]JORDANJ,2871,457,18,11,29,62.1%,32m
19013,1,Addamere,2871,349,17,22,39,43.6%,43m
19013,3,EinDalton,2871,354,15,11,26,57.7%,8m
19013,2,Nujabes,2871,232,13,14,27,48.1%,24m
19013,3,[Antoin]alex,2871,295,10,3,13,76.9%,20m
19013,2,[4Vic]TurnItUP,2871,251,10,9,19,52.6%,28m
19013,1,Eldetha,2871,344,10,20,30,33.3%,20m
19013,3,IAN,2871,184,7,3,10,70.0%,19m
19013,1,[GOPERÚ]Acel,2871,239,7,10,17,41.2%,20m
19013,3,Adam,2871,166,6,2,8,75.0%,22m
19013,3,Wisdom,2871,86,4,6,10,40.0%,32m
19013,2,[XZEROX]VoidWolf,2871,58,3,3,6,50.0%,37m
19013,2,[UNBA]AizatXtreme,2871,60,3,4,7,42.9%,4m
19013,2,[INextI]Shadow,2871,140,3,5,8,37.5%,30m
19013,3,Jimmy,2871,58,2,2,4,50.0%,25m
19013,3,HanSolo,2871,58,2,3,5,40.0%,21m
19013,1,RKN,2871,97,2,4,6,33.3%,40m
19013,1,CdnMafia,2871,0,1,0,1,100.0%,1h
19013,3,Pastre,2871,0,1,0,1,100.0%,4m
19013,3,ForevrADrone,2871,0,0,1,1,0.0%,46m
19013,3,Maya,2871,0,0,1,1,0.0%,44m
19040,1,Rex,2870,1516,494,480,974,50.7%,25m
19040,2,Alibaba,2870,1556,261,230,491,53.2%,11m
19040,1,SharkEagle,2870,1599,218,213,431,50.6%,11m
19040,1,[RatsPE]MaXxX,2870,1616,142,139,281,50.5%,10m
19040,2,[boijwa]yrDaddy,2870,477,114,101,215,53.0%,26m
19040,1,[GFP]Valhanis,2870,1507,79,78,157,50.3%,18m
19040,2,Tenoch,2870,1410,69,57,126,54.8%,46m
19040,2,HPL,2870,699,55,52,107,51.4%,27m
19040,2,ChoopyChoops,2870,1143,53,47,100,53.0%,18m
19040,2,Antonio,2870,933,42,28,70,60.0%,8m
19040,2,iceaxe,2870,524,33,20,53,62.3%,36m
19040,1,Yani,2870,896,33,47,80,41.2%,2m
19040,2,Atamu,2870,433,17,13,30,56.7%,34m
19040,2,Alphoyce,2870,338,17,16,33,51.5%,27m
19040,2,PsychoMantis,2870,472,17,19,36,47.2%,24m
19040,2,Scofield,2870,274,13,4,17,76.5%,29m
19040,1,OverZero,2870,334,13,11,24,54.2%,45m
19040,1,[ch33z3]SpicyPonzu,2870,279,11,15,26,42.3%,43m
19040,2,Borzinator,2870,256,10,11,21,47.6%,19m
19040,3,[AGDAGD]SuperDave,2870,230,8,7,15,53.3%,14m
19040,2,[buenos]CAYORATE,2870,182,7,7,14,50.0%,31m
19040,2,Radioactive,2870,191,6,10,16,37.5%,29m
19040,1,ScottsTots,2870,202,5,6,11,45.5%,2h
19040,2,Viktor,2870,152,4,4,8,50.0%,13m
19040,2,Warsailor,2870,0,3,0,3,100.0%,36m
19040,2,[BrNzUP]Tiny,2870,0,3,3,6,50.0%,19m
19040,3,Chronophobia,2870,30,2,0,2,100.0%,5m
19040,1,BinaryClock,2870,48,2,0,2,100.0%,2h
19040,3,Matark,2870,58,2,1,3,66.7%,32m
19040,2,BLANDIN,2870,88,2,1,3,66.7%,3m
19040,2,[LgnTDS]Timmy,2870,62,2,6,8,25.0%,36m
19040,3,Ícaro,2870,0,1,0,1,100.0%,28m
19040,3,vector,2870,0,0,1,1,0.0%,28m
19040,3,[TITC]Hamburgler,2870,0,0,1,1,0.0%,35m
19040,3,PEG,2870,0,0,2,2,0.0%,8m
19040,2,lucasxbr,2870,0,0,3,3,0.0%,32m
19076,2,WARHUMMER,2869,1043,135,107,242,55.8%,19m
19076,3,[LCE]InnoVation,2869,1622,90,71,161,55.9%,11m
19076,2,ajb,2869,1404,85,91,176,48.3%,13m
19076,2,Deft,2869,1394,55,53,108,50.9%,14m
19076,2,Omnipotent,2869,738,38,31,69,55.1%,36m
19076,3,Teshnuburr,2869,315,30,16,46,65.2%,44m
19076,2,Batman,2869,684,25,30,55,45.5%,18m
19076,3,HailKamala,2869,552,22,16,38,57.9%,28m
19076,1,Aiursengard,2869,314,11,17,28,39.3%,18m
19076,2,Skyre,2869,254,10,10,20,50.0%,13m
19076,3,[PneqNP]butterfinger,2869,256,9,8,17,52.9%,25m
19076,2,DRoxxy,2869,339,9,13,22,40.9%,27m
19076,1,Nag,2869,255,8,5,13,61.5%,1h
19076,2,[Over1]NerVIOCida,2869,58,6,3,9,66.7%,42m
19076,2,JustDerpin,2869,206,6,5,11,54.5%,14m
19076,3,HDH,2869,30,4,2,6,66.7%,21m
19076,2,[BWLL]Marusvineyrd,2869,0,3,2,5,60.0%,2h
19076,1,[Ins8G]Mai,2869,193,3,4,7,42.9%,2h
19076,1,[KO8E]Highcon,2869,119,2,1,3,66.7%,2h
19076,3,[BJMan]slicedbread,2869,0,1,0,1,100.0%,8m
19076,3,[EtrOy]Jingleheimer,2869,30,1,2,3,33.3%,28m
19076,2,[ViP3Rs]Dres,2869,0,1,2,3,33.3%,19m
19076,3,[ScEsCl]Trend,2869,0,0,1,1,0.0%,5m
19076,3,SentaoDePana,2869,0,0,1,1,0.0%,24m
19076,3,daniel,2869,0,0,1,1,0.0%,45m
19101,2,CoolFace,2868,1523,188,181,369,50.9%,18m
19101,3,Carbumax,2868,1603,126,114,240,52.5%,22m
19101,2,caBRalera,2868,588,98,89,187,52.4%,27m
19101,2,Strut,2868,723,85,79,164,51.8%,36m
19101,1,KernelPanic,2868,1066,84,68,152,55.3%,45m
19101,1,[CMVP]DragonKing,2868,818,65,64,129,50.4%,27m
19101,2,[Shout]Lyro,2868,1194,54,36,90,60.0%,45m
19101,3,Cidragon,2868,553,47,15,62,75.8%,12m
19101,3,NeZeK,2868,726,30,36,66,45.5%,30m
19101,2,HeyDoc,2868,713,27,25,52,51.9%,3m
19101,1,[diaman]Lefor,2868,400,17,24,41,41.5%,27m
19101,3,PotatoTerran,2868,314,12,9,21,57.1%,29m
19101,2,MasterMind,2868,320,12,13,25,48.0%,20m
19101,2,[YD2K]YannisYiros,2868,156,9,8,17,52.9%,13m
19101,2,Quixotic,2868,216,8,8,16,50.0%,25m
19101,2,[pepis]BwahGamer,2868,232,8,8,16,50.0%,36m
19101,3,Alejandro,2868,184,6,3,9,66.7%,25m
19101,2,Warsonix,2868,190,6,9,15,40.0%,42m
19101,2,Seth,2868,158,6,9,15,40.0%,7m
19101,2,Predictable,2868,156,5,5,10,50.0%,11m
19101,2,dæmon,2868,132,5,5,10,50.0%,16m
19101,2,[Chrev]Chriskler,2868,167,5,12,17,29.4%,8m
19101,2,[RPRM]AlexombiePGN,2868,0,4,1,5,80.0%,1h
19101,1,xiArtanis,2868,167,3,1,4,75.0%,44m
19101,3,freakidz,2868,76,3,3,6,50.0%,44m
19101,3,[GOPERÚ]Cama,2868,30,2,0,2,100.0%,7m
19101,3,Ryder,2868,0,2,3,5,40.0%,14m
19101,1,[ConFed]Chawls,2868,92,2,10,12,16.7%,45m
19101,3,BuildTheWall,2868,0,1,0,1,100.0%,29m
19101,1,saturnity,2868,0,1,0,1,100.0%,1h
19101,2,[5O3]Appleton,2868,46,1,2,3,33.3%,39m
19101,2,[CLan12]PiJiRoNy,2868,30,1,3,4,25.0%,22m
19101,3,Mycelium,2868,0,1,4,5,20.0%,45m
19101,2,ChuckSharts,2868,30,1,5,6,16.7%,13m
19101,2,[GGMESP]SNELX,2868,0,0,1,1,0.0%,2h
19101,3,marns,2868,0,0,1,1,0.0%,28m
19137,2,Matttyb,2867,1522,515,520,1035,49.8%,5m
19137,1,[Emb3rs]Deltastorm,2867,1642,355,353,708,50.1%,31m
19137,1,MasterChief,2867,1486,93,95,188,49.5%,21m
19137,1,EarnsTurns,2867,730,62,73,135,45.9%,15m
19137,2,Smiley,2867,456,59,59,118,50.0%,37m
19137,3,Huh,2867,614,36,21,57,63.2%,16m
19137,1,Karrgo,2867,915,36,37,73,49.3%,29m
19137,2,[R3SET]RenegadeX,2867,875,32,35,67,47.8%,25m
19137,2,Spike,2867,626,26,20,46,56.5%,13m
19137,3,[M1A5]ita,2867,564,20,37,57,35.1%,43m
19137,1,moistchip,2867,367,19,27,46,41.3%,32m
19137,2,PenduLum,2867,400,15,17,32,46.9%,24m
19137,2,[AiMB]BiggaJigga,2867,210,7,6,13,53.8%,15m
19137,3,larrydizzle,2867,208,6,2,8,75.0%,43m
19137,2,TossYouUp,2867,126,5,9,14,35.7%,8m
19137,2,Windz,2867,88,4,3,7,57.1%,29m
19137,2,TrashCan,2867,94,4,8,12,33.3%,13m
19137,3,DrSeuss,2867,0,3,2,5,60.0%,29m
19137,3,DarkTavion,2867,0,2,3,5,40.0%,22m
19137,2,ERGHEIZ,2867,30,2,3,5,40.0%,13m
19137,3,[MEELX]DuffBeer,2867,122,2,4,6,33.3%,40m
19137,2,Midnight,2867,30,2,5,7,28.6%,23m
19137,2,[DRDOOM]Enotic,2867,112,2,7,9,22.2%,5m
19137,3,[Berryz]slyknight,2867,0,0,1,1,0.0%,9m
19137,1,patton,2867,0,0,1,1,0.0%,1h
19137,1,Edwin,2867,0,0,6,6,0.0%,8m
19163,3,[SMRT]dampen,2866,1535,211,198,409,51.6%,3m
19163,2,Pastynailer,2866,1563,151,131,282,53.5%,24m
19163,1,Shenanigans,2866,1636,80,86,166,48.2%,8m
19163,1,Aiur,2866,959,41,42,83,49.4%,24m
19163,2,Scorpion,2866,488,26,28,54,48.1%,24m
19163,3,Macaca,2866,496,24,17,41,58.5%,24m
19163,2,[F2AAA]pvalue,2866,262,10,15,25,40.0%,42m
19163,1,Kael,2866,356,10,18,28,35.7%,25m
19163,2,GLHF,2866,220,9,7,16,56.2%,32m
19163,2,[TeamUR]ckreon,2866,238,8,15,23,34.8%,8m
19163,2,YOSHI,2866,222,7,8,15,46.7%,24m
19163,2,skidooguy,2866,58,6,4,10,60.0%,3m
19163,1,Noelgeezy,2866,48,4,5,9,44.4%,6m
19163,3,Baconator,2866,121,3,1,4,75.0%,1h
19163,3,[BigPin]Seb,2866,60,3,1,4,75.0%,28m
19163,2,[Cind3r]DrumDeDumb,2866,86,3,5,8,37.5%,23m
19163,1,SoEasy,2866,97,2,0,2,100.0%,2h
19163,3,Cytokine,2866,38,2,1,3,66.7%,2h
19163,2,jrstars,2866,0,2,3,5,40.0%,29m
19163,3,[TheRMs]TossedSalad,2866,0,1,0,1,100.0%,6m
19163,1,Eskcool,2866,0,1,1,2,50.0%,1h
19163,3,[Scroof]iReckon,2866,0,0,1,1,0.0%,20m
19163,3,JuanPablo,2866,0,0,1,1,0.0%,19m
19163,3,pryme,2866,0,0,1,1,0.0%,35m
19163,3,rob,2866,0,0,1,1,0.0%,30m
19163,3,[BfsA]klitroke,2866,0,0,1,1,0.0%,20m
19189,2,Ender,2865,1361,275,273,548,50.2%,16m
19189,3,GalanOfTaa,2865,1283,72,62,134,53.7%,43m
19189,1,veggiedealer,2865,871,67,74,141,47.5%,18m
19189,2,multifaZ,2865,1280,62,36,98,63.3%,18m
19189,3,pep,2865,439,43,24,67,64.2%,8m
19189,1,OurLives,2865,700,32,38,70,45.7%,12m
19189,3,Zound,2865,669,30,16,46,65.2%,33m
19189,2,dvdseller,2865,499,25,25,50,50.0%,11m
19189,2,Robotick,2865,556,22,26,48,45.8%,12m
19189,2,cadc,2865,312,19,19,38,50.0%,19m
19189,1,[Preach]Killface,2865,580,19,25,44,43.2%,28m
19189,2,[lLgNl]Prime,2865,256,9,7,16,56.2%,24m
19189,1,Sunshine,2865,247,9,10,19,47.4%,44m
19189,2,[JAFY]SCVReady,2865,145,8,3,11,72.7%,19m
19189,2,Jericho,2865,206,8,12,20,40.0%,25m
19189,3,Sonny,2865,96,6,0,6,100.0%,33m
19189,1,Zero,2865,196,6,6,12,50.0%,1h
19189,2,Nixxon,2865,30,5,3,8,62.5%,6m
19189,3,Gizmo,2865,160,4,3,7,57.1%,8m
19189,1,Themeze,2865,48,4,4,8,50.0%,45m
19189,3,Phalanx,2865,114,4,5,9,44.4%,44m
19189,3,SChit,2865,60,3,2,5,60.0%,8m
19189,2,Vandertoss,2865,58,3,4,7,42.9%,23m
19189,3,[TrpleT]Ytragof,2865,0,0,1,1,0.0%,28m
19189,3,ElGuido,2865,0,0,1,1,0.0%,44m
19189,3,pingasolina,2865,0,0,1,1,0.0%,8m
19189,2,DeathHammer,2865,0,0,3,3,0.0%,42m
19216,1,[JaMiT]Appoloin,2864,1612,148,139,287,51.6%,21m
19216,2,StyleBender,2864,1568,147,119,266,55.3%,24m
19216,2,DEADPOOL,2864,1350,143,145,288,49.7%,12m
19216,2,TiMmAiR,2864,1084,101,94,195,51.8%,19m
19216,2,llllllllllll,2864,1207,98,95,193,50.8%,8m
19216,1,tertian,2864,1604,92,87,179,51.4%,5m
19216,1,[B33R]Aviendha,2864,398,82,78,160,51.2%,33m
19216,2,[LORDx]hunter,2864,1413,72,63,135,53.3%,23m
19216,2,[NVYTE]SmokingShot,2864,1342,70,39,109,64.2%,47m
19216,3,Cavadrio,2864,1000,38,33,71,53.5%,42m
19216,3,Charito,2864,790,29,26,55,52.7%,43m
19216,3,valentino,2864,466,20,7,27,74.1%,19m
19216,2,[LOOPY]Scheyla,2864,530,19,21,40,47.5%,12m
19216,3,[copain]Solinvictus,2864,288,12,13,25,48.0%,2m
19216,1,Hemlock,2864,363,12,17,29,41.4%,45m
19216,3,theDreamKing,2864,231,9,8,17,52.9%,2m
19216,2,Dafirst,2864,184,8,8,16,50.0%,3m
19216,2,[KiMBR]FatalisK,2864,254,8,9,17,47.1%,20m
19216,3,LimeNuke,2864,179,6,1,7,85.7%,23m
19216,3,Wukey,2864,169,4,4,8,50.0%,1h
19216,3,[EzE]Nyma,2864,135,4,7,11,36.4%,1h
19216,2,[SJCBBC]BBC,2864,122,4,7,11,36.4%,24m
19216,3,[iDrunk]Laccery,2864,86,3,2,5,60.0%,47m
19216,2,Meow,2864,0,3,2,5,60.0%,2h
19216,3,SamAlmighty,2864,86,3,3,6,50.0%,28m
19216,2,SandKing,2864,112,3,3,6,50.0%,15m
19216,3,xupulo,2864,0,1,0,1,100.0%,9m
19216,3,[w0rm]Jeff,2864,30,1,1,2,50.0%,8m
19216,3,[plplpl]Meroveo,2864,0,0,1,1,0.0%,5m
19216,3,ElvenOrc,2864,0,0,1,1,0.0%,45m
19216,2,APOW,2864,0,0,7,7,0.0%,7m
19247,2,[cl0udM]Nastynaz,2863,1569,192,174,366,52.5%,17m
19247,2,Mandala,2863,1430,161,148,309,52.1%,5m
19247,2,Singularity,2863,1033,71,65,136,52.2%,16m
19247,2,[XpKAc]Lorsond,2863,1018,64,50,114,56.1%,16m
19247,2,[SsaYnS]amgine,2863,1229,52,44,96,54.2%,6m
19247,1,[Chiile]Potatooo,2863,362,35,39,74,47.3%,12m
19247,2,[Q4Life]Lionheart,2863,793,34,33,67,50.7%,35m
19247,2,nowwissonn,2863,682,32,28,60,53.3%,34m
19247,2,[UpxV]angel,2863,676,28,24,52,53.8%,24m
19247,2,SgtMac,2863,490,21,21,42,50.0%,34m
19247,2,[GAlNZ]TRUST,2863,382,14,20,34,41.2%,46m
19247,1,bazz,2863,464,14,26,40,35.0%,2m
19247,2,TurboPotato,2863,280,9,9,18,50.0%,36m
19247,1,[porbe]woooooober,2863,147,5,5,10,50.0%,3h
19247,2,[ANKL]Ghost,2863,88,4,3,7,57.1%,14m
19247,2,[NPhasA]MarinePrince,2863,90,4,5,9,44.4%,36m
19247,3,Sheldor,2863,30,2,1,3,66.7%,47m
19247,3,[TNiNJA]Julio,2863,30,2,2,4,50.0%,36m
19247,3,kaito,2863,0,1,0,1,100.0%,15m
19247,3,[Huntrs]KingJames,2863,30,1,2,3,33.3%,20m
19247,2,[Cind3r]gobow,2863,30,1,5,6,16.7%,14m
19247,3,Rainbow,2863,0,0,1,1,0.0%,36m
19247,3,kornhouser,2863,0,0,1,1,0.0%,25m
19247,3,Firebat,2863,0,0,1,1,0.0%,5m
19247,2,Zicova,2863,0,0,1,1,0.0%,2h
19272,1,RangeRex,2862,1633,169,152,321,52.6%,10m
19272,2,Lucifer,2862,1571,142,127,269,52.8%,29m
19272,1,[UpxV]MigueBS,2862,1556,79,72,151,52.3%,5m
19272,2,XxSensuixX,2862,598,59,44,103,57.3%,26m
19272,3,[iIoveU]Aphroditeve,2862,403,18,4,22,81.8%,8m
19272,2,[LIFTY]Raphelos,2862,427,18,14,32,56.2%,33m
19272,2,Tato,2862,413,15,14,29,51.7%,15m
19272,2,Soulrender,2862,326,11,13,24,45.8%,21m
19272,3,Maru,2862,294,10,15,25,40.0%,25m
19272,3,Therad,2862,254,9,9,18,50.0%,46m
19272,2,Alexstrasza,2862,266,9,9,18,50.0%,33m
19272,3,Topotamdr,2862,172,7,4,11,63.6%,7m
19272,3,Davoh,2862,172,7,7,14,50.0%,4m
19272,2,LetsMacro,2862,204,6,7,13,46.2%,36m
19272,1,[BSQUAD]BigGuwap,2862,96,6,7,13,46.2%,36m
19272,3,TITAN,2862,212,6,8,14,42.9%,16m
19272,2,Talisker,2862,172,5,3,8,62.5%,2h
19272,1,Maxemus,2862,193,5,5,10,50.0%,1h
19272,2,KiBeN,2862,94,4,8,12,33.3%,27m
19272,1,[xEAx]DeadlyKitten,2862,116,3,2,5,60.0%,6m
19272,2,Boyd,2862,0,3,2,5,60.0%,41m
19272,3,[WZ]luisbc,2862,90,3,3,6,50.0%,22m
19272,1,Azri,2862,0,3,3,6,50.0%,19m
19272,2,[Sune]StarGhost,2862,60,3,4,7,42.9%,24m
19272,2,Billnobi,2862,60,3,9,12,25.0%,16m
19272,1,cloud,2862,143,2,1,3,66.7%,3h
19272,3,ridgediffine,2862,30,1,2,3,33.3%,46m
19272,2,[GØSU]ULIKEIT,2862,30,1,6,7,14.3%,27m
19272,3,MadKappa,2862,0,0,1,1,0.0%,25m
19301,3,Gudao,2861,1628,117,91,208,56.2%,13m
19301,1,jerry,2861,1614,111,115,226,49.1%,16m
19301,2,MortyHot,2861,909,72,72,144,50.0%,12m
19301,3,Tyrant,2861,428,26,10,36,72.2%,9m
19301,3,ThorKen,2861,646,26,21,47,55.3%,11m
19301,2,Jarebear,2861,560,22,21,43,51.2%,45m
19301,3,Marv,2861,490,18,15,33,54.5%,2m
19301,2,Sundown,2861,398,16,11,27,59.3%,36m
19301,2,HappySteaks,2861,416,15,17,32,46.9%,42m
19301,2,Chewy,2861,331,13,10,23,56.5%,36m
19301,2,Phantasma,2861,375,13,13,26,50.0%,32m
19301,2,[JOOO]BaldSeagull,2861,254,12,17,29,41.4%,36m
19301,3,elixire,2861,267,11,7,18,61.1%,32m
19301,1,lizardace,2861,340,11,15,26,42.3%,6m
19301,2,Falgoo,2861,203,10,7,17,58.8%,24m
19301,3,WHLordAOF,2861,244,7,4,11,63.6%,2h
19301,2,javi,2861,115,5,2,7,71.4%,44m
19301,1,Pandora,2861,214,4,3,7,57.1%,1h
19301,2,[Æsir]FORSETI,2861,88,4,6,10,40.0%,26m
19301,3,TossGarbage,2861,58,3,1,4,75.0%,46m
19301,3,waterbottle,2861,0,2,2,4,50.0%,13m
19301,3,Vayeate,2861,30,1,3,4,25.0%,8m
19301,2,[TlLT]gollahon,2861,0,1,4,5,20.0%,32m
19301,3,NibbleZits,2861,0,0,1,1,0.0%,29m
19301,3,[Fum3s]Drinky,2861,0,0,2,2,0.0%,15m
19301,3,IzzBizz,2861,0,0,2,2,0.0%,9m
19327,1,FlossToss,2860,1626,191,191,382,50.0%,34m
19327,2,comunista,2860,1549,87,66,153,56.9%,16m
19327,1,Tautomer,2860,1415,76,71,147,51.7%,28m
19327,1,Lorena,2860,1048,75,75,150,50.0%,6m
19327,2,StarSauce,2860,1433,68,61,129,52.7%,2m
19327,2,[angsub]Dark,2860,1261,49,47,96,51.0%,16m
19327,3,GreGo,2860,769,32,22,54,59.3%,20m
19327,3,[Worrmy]RuFrigerator,2860,278,11,7,18,61.1%,5m
19327,2,Gilgamesh,2860,244,10,7,17,58.8%,26m
19327,3,IIIIIIIIIIII,2860,250,9,8,17,52.9%,15m
19327,2,CrazyM,2860,168,6,3,9,66.7%,23m
19327,3,Oblique,2860,205,5,4,9,55.6%,2h
19327,1,littlezerg,2860,217,4,3,7,57.1%,17m
19327,2,Disruptr,2860,0,3,2,5,60.0%,43m
19327,2,hdgo,2860,102,2,2,4,50.0%,16m
19327,3,Shattered,2860,60,2,3,5,40.0%,28m
19327,2,UnikChezze,2860,114,2,3,5,40.0%,6m
19327,2,Dishen,2860,102,2,4,6,33.3%,25m
19327,3,txNexaS,2860,123,2,5,7,28.6%,20m
19327,2,PnC,2860,0,1,1,2,50.0%,39m
19327,3,Rartusman,2860,30,1,2,3,33.3%,30m
19327,3,[AESCII]Fsoto,2860,0,0,1,1,0.0%,46m
19349,1,blackdog,2859,1614,220,210,430,51.2%,43m
19349,2,BIGGUYYY,2859,1385,150,144,294,51.0%,36m
19349,2,DimitriKrups,2859,1341,90,82,172,52.3%,44m
19349,2,Metallica,2859,1023,70,56,126,55.6%,46m
19349,3,jomaal,2859,672,59,47,106,55.7%,23m
19349,2,CopperPanMan,2859,1284,56,59,115,48.7%,44m
19349,2,Platinum,2859,887,51,42,93,54.8%,35m
19349,2,kryshor,2859,269,38,25,63,60.3%,20m
19349,3,Sacc,2859,544,36,18,54,66.7%,35m
19349,2,lostoid,2859,750,32,25,57,56.1%,24m
19349,3,[RUMB]Fishlobs,2859,851,31,26,57,54.4%,32m
19349,2,[NwAs]Legacy,2859,600,30,13,43,69.8%,8m
19349,3,[nwBEAR]bear,2859,601,25,15,40,62.5%,30m
19349,1,Orkin,2859,662,21,30,51,41.2%,26m
19349,1,Revision,2859,452,17,23,40,42.5%,8m
19349,1,RTHII,2859,404,16,15,31,51.6%,43m
19349,2,Aslan,2859,387,14,21,35,40.0%,13m
19349,2,WGFURY,2859,337,12,11,23,52.2%,11m
19349,1,runinmonkey,2859,231,10,11,21,47.6%,2h
19349,3,Ahiram,2859,200,8,3,11,72.7%,5m
19349,3,Leader,2859,176,7,6,13,53.8%,32m
19349,3,[CITIOS]Matabug,2859,204,7,7,14,50.0%,5m
19349,3,[Zosha]tOmOrrOw,2859,214,6,4,10,60.0%,29m
19349,3,Malice,2859,57,5,2,7,71.4%,5m
19349,3,Sunshine,2859,114,5,3,8,62.5%,44m
19349,3,tommyzxy,2859,119,4,3,7,57.1%,22m
19349,3,Jake,2859,0,3,1,4,75.0%,20m
19349,3,KAMENRAIDER,2859,86,3,2,5,60.0%,33m
19349,2,peas,2859,0,3,2,5,60.0%,2h
19349,3,[MFH]medabot,2859,30,2,1,3,66.7%,22m
19349,2,aleksey,2859,94,2,1,3,66.7%,16m
19349,3,Soapy,2859,0,2,3,5,40.0%,29m
19349,3,[ClanCT]Jzerglings,2859,0,0,1,1,0.0%,45m
19349,3,Cirrus,2859,0,0,1,1,0.0%,11m
19383,1,Sol,2858,1384,156,141,297,52.5%,31m
19383,3,blaylock,2858,1307,81,66,147,55.1%,6m
19383,2,TerHan,2858,415,30,23,53,56.6%,21m
19383,2,kingslayer,2858,679,30,32,62,48.4%,27m
19383,3,lawlmart,2858,498,21,10,31,67.7%,33m
19383,2,Goliath,2858,199,21,24,45,46.7%,12m
19383,3,Marvelous,2858,410,15,8,23,65.2%,16m
19383,1,Falcon,2858,272,9,16,25,36.0%,11m
19383,1,SMERO,2858,234,7,5,12,58.3%,3h
19383,3,SilentStorm,2858,118,6,2,8,75.0%,28m
19383,3,Destierro,2858,0,4,1,5,80.0%,8m
19383,3,Jampamane,2858,30,2,0,2,100.0%,45m
19383,2,Dolmesk,2858,114,2,4,6,33.3%,19m
19383,3,OtakuSlave,2858,0,1,0,1,100.0%,9m
19383,3,[ExcIgN]TOUCH,2858,0,1,0,1,100.0%,15m
19383,3,XxBloodredxX,2858,0,1,0,1,100.0%,25m
19383,3,Arkrez,2858,30,1,1,2,50.0%,29m
19383,3,GGu,2858,0,0,5,5,0.0%,21m
19401,2,sjcomp,2857,1555,155,143,298,52.0%,32m
19401,2,Eskate,2857,1181,76,63,139,54.7%,45m
19401,2,[Zelern]ezbake,2857,1473,71,65,136,52.2%,45m
19401,2,Ato,2857,977,57,55,112,50.9%,12m
19401,2,proper,2857,1197,49,51,100,49.0%,27m
19401,3,willjog,2857,799,37,13,50,74.0%,34m
19401,3,Howl,2857,559,30,34,64,46.9%,6m
19401,2,[BfLaD]AdmiralKwan,2857,270,28,31,59,47.5%,4m
19401,1,[SNeS]GOOMBA,2857,776,24,39,63,38.1%,2m
19401,3,Alphaeus,2857,534,19,17,36,52.8%,44m
19401,2,[2faded]NautMe,2857,368,18,15,33,54.5%,11m
19401,2,malibu,2857,370,15,11,26,57.7%,36m
19401,2,ELCAZADORZ,2857,250,9,14,23,39.1%,47m
19401,2,SEA,2857,168,7,6,13,53.8%,13m
19401,3,Losphoenix,2857,58,5,4,9,55.6%,47m
19401,1,JonathanD,2857,159,5,6,11,45.5%,44m
19401,1,whiterice,2857,0,4,2,6,66.7%,37m
19401,3,venom,2857,0,3,2,5,60.0%,32m
19401,3,queequeg,2857,0,3,2,5,60.0%,4m
19401,1,Cyrali,2857,97,3,2,5,60.0%,2h
19401,3,HalFdan,2857,30,2,1,3,66.7%,25m
19401,3,Captianstar,2857,30,2,1,3,66.7%,19m
19401,3,Adam,2857,0,0,1,1,0.0%,19m
19401,3,[SMSS]MacroJackson,2857,0,0,2,2,0.0%,1h
19401,2,Fransisco,2857,0,0,9,9,0.0%,32m
19426,2,billy,2856,1631,192,183,375,51.2%,19m
19426,2,Sunshine,2856,1534,97,65,162,59.9%,29m
19426,2,ConNatural,2856,890,95,86,181,52.5%,28m
19426,2,[ZTemp]Drucifer,2856,1324,75,71,146,51.4%,17m
19426,2,MatCauthon,2856,1281,61,66,127,48.0%,19m
19426,2,Gilden,2856,975,41,38,79,51.9%,32m
19426,2,SimpleJACK,2856,778,40,36,76,52.6%,45m
19426,3,Keps,2856,589,23,16,39,59.0%,46m
19426,3,IIIIIIIIII,2856,434,19,8,27,70.4%,28m
19426,3,Spoon,2856,423,16,7,23,69.6%,16m
19426,2,ArT,2856,390,15,15,30,50.0%,23m
19426,1,[Macac0]xLoro,2856,166,8,6,14,57.1%,2h
19426,1,[FanSu]lllllllllll,2856,224,8,10,18,44.4%,44m
19426,1,Emperor,2856,166,7,7,14,50.0%,32m
19426,3,PROtoss,2856,60,5,3,8,62.5%,22m
19426,2,Tych,2856,122,5,8,13,38.5%,12m
19426,1,[BONCK]DiolaH,2856,158,5,14,19,26.3%,37m
19426,3,Misha,2856,86,4,1,5,80.0%,28m
19426,3,[LHdH]Kimblee,2856,114,4,1,5,80.0%,10m
19426,3,PURPLESUCKS,2856,60,3,2,5,60.0%,35m
19426,2,[JUGOS]juanchasOWO,2856,58,3,5,8,37.5%,36m
19426,3,[MoonR]Alicorn,2856,30,2,1,3,66.7%,12m
19426,2,[NPhase]Jcbball,2856,58,2,5,7,28.6%,12m
19426,3,[5Tango]likeaboss,2856,0,2,9,11,18.2%,29m
19426,3,SwarmsofZerg,2856,0,1,2,3,33.3%,6m
19426,3,[TamuSC]IAmRadon,2856,0,0,1,1,0.0%,6m
19426,3,Rogue,2856,0,0,1,1,0.0%,44m
19426,3,XIII,2856,0,0,5,5,0.0%,22m
19454,2,sergio,2855,1483,133,110,243,54.7%,24m
19454,1,Moonlight,2855,1504,111,109,220,50.5%,35m
19454,2,joelsuo,2855,1401,60,49,109,55.0%,24m
19454,2,[GTHS]oswill,2855,941,55,49,104,52.9%,17m
19454,2,TheGambler,2855,1173,52,50,102,51.0%,14m
19454,3,Jomama,2855,1014,48,37,85,56.5%,28m
19454,1,Aurelius,2855,1322,47,54,101,46.5%,5m
19454,3,[WarCo]Marko,2855,920,38,32,70,54.3%,8m
19454,2,Entropy,2855,834,36,30,66,54.5%,24m
19454,3,POLLUXcastor,2855,934,36,30,66,54.5%,22m
19454,3,MacCactus,2855,842,34,33,67,50.7%,23m
19454,1,[WLFSPK]WolfsButcher,2855,978,33,40,73,45.2%,18m
19454,2,FENRIR,2855,671,28,31,59,47.5%,13m
19454,3,Perreault,2855,512,19,18,37,51.4%,8m
19454,3,onemore,2855,391,16,13,29,55.2%,10m
19454,3,[MdCzBd]Sorrow,2855,245,11,8,19,57.9%,4m
19454,3,Ares,2855,243,9,7,16,56.2%,2h
19454,3,Pandemic,2855,250,8,7,15,53.3%,11m
19454,3,garde,2855,0,3,2,5,60.0%,47m
19454,1,grrr,2855,122,2,3,5,40.0%,17m
19454,3,[NPhasA]asheZ,2855,0,1,0,1,100.0%,12m
19454,3,ZIDHARD,2855,0,1,0,1,100.0%,28m
19454,3,[b3n]sixpi,2855,30,1,1,2,50.0%,12m
19454,3,jabr,2855,30,1,2,3,33.3%,14m
19454,3,[ARM]TIBURON,2855,0,0,1,1,0.0%,3h
19454,3,Lkeskic,2855,0,0,1,1,0.0%,12m
19480,2,Jahrobokahn,2854,1556,125,123,248,50.4%,23m
19480,2,Riketorian,2854,1154,95,88,183,51.9%,5m
19480,1,macroKing,2854,771,71,59,130,54.6%,31m
19480,2,Justin,2854,1070,38,44,82,46.3%,13m
19480,3,Violentllama,2854,467,18,11,29,62.1%,22m
19480,3,Namei,2854,347,10,20,30,33.3%,42m
19480,1,MjrWilson,2854,111,7,3,10,70.0%,38m
19480,3,[GØSU]bobthunicorn,2854,208,6,2,8,75.0%,43m
19480,2,ReisenUsagi,2854,191,6,6,12,50.0%,28m
19480,1,[JACPAR]Fardaddy,2854,142,5,2,7,71.4%,30m
19480,3,mtbor,2854,30,5,2,7,71.4%,4m
19480,3,WINTERGREEN,2854,0,4,1,5,80.0%,13m
19480,3,[DISC]hfd,2854,60,4,4,8,50.0%,32m
19480,3,LastHope,2854,58,3,2,5,60.0%,6m
19480,3,Fortesque,2854,0,3,2,5,60.0%,29m
19480,3,[GDJ]ThelOniouS,2854,86,3,2,5,60.0%,20m
19480,3,RiseRay,2854,0,3,2,5,60.0%,8m
19480,3,blitz,2854,119,3,6,9,33.3%,27m
19480,2,[9C]FoxySocks,2854,90,3,6,9,33.3%,47m
19480,2,Wildmilf,2854,0,2,1,3,66.7%,1h
19480,2,Yangkai,2854,88,2,3,5,40.0%,24m
19480,2,Malamute,2854,60,2,6,8,25.0%,6m
19480,1,[WuTang]Hurky,2854,118,2,7,9,22.2%,42m
19480,1,Fallen,2854,97,1,1,2,50.0%,2h
19504,1,Tsukani,2853,1196,267,247,514,51.9%,16m
19504,2,Wilith,2853,1574,220,191,411,53.5%,21m
19504,3,TiKa,2853,1657,175,169,344,50.9%,8m
19504,3,tehnice,2853,1301,158,151,309,51.1%,8m
19504,1,Socoroco,2853,1637,153,148,301,50.8%,35m
19504,1,ProbeGoBrr,2853,1342,150,123,273,54.9%,12m
19504,1,wtchhnt,2853,737,46,37,83,55.4%,8m
19504,2,[1PA]BeNgay,2853,820,30,35,65,46.2%,45m
19504,2,aftr,2853,716,26,27,53,49.1%,27m
19504,2,numbernumber,2853,488,25,9,34,73.5%,15m
19504,3,[MCY]JpBlacker,2853,590,25,13,38,65.8%,30m
19504,3,Psilos,2853,432,16,18,34,47.1%,2m
19504,3,[Ftroll]JCwasAHippY,2853,165,7,6,13,53.8%,24m
19504,3,[Silica]Hadez,2853,202,7,6,13,53.8%,27m
19504,1,[MUGI]TimERTy,2853,97,4,3,7,57.1%,2h
19504,2,KaiZeE,2853,126,3,5,8,37.5%,23m
19504,1,[Kood]Avenge,2853,48,2,2,4,50.0%,3h
19504,3,LiquidFusion,2853,0,1,0,1,100.0%,34m
19504,3,Thor,2853,0,1,0,1,100.0%,46m
19504,2,PriusPower,2853,0,1,3,4,25.0%,13m
19504,3,Rorschach,2853,0,0,1,1,0.0%,9m
19504,3,LuckyMoney,2853,0,0,1,1,0.0%,20m
19504,2,[TBWC22]Candylovers,2853,0,0,3,3,0.0%,12m
19527,2,Predator,2852,1617,150,128,278,54.0%,13m
19527,3,bhanley,2852,1606,104,99,203,51.2%,5m
19527,2,[OndaVT]exotico,2852,1613,79,68,147,53.7%,22m
19527,3,starprick,2852,1383,78,50,128,60.9%,11m
19527,2,[FK0USA]FKUTRUMP,2852,1271,66,48,114,57.9%,32m
19527,3,[b00ts]BattleSightZ,2852,1062,49,29,78,62.8%,28m
19527,3,OhAshley,2852,1077,49,30,79,62.0%,15m
19527,2,INNIE,2852,1105,49,40,89,55.1%,4m
19527,3,Exterminator,2852,520,48,38,86,55.8%,34m
19527,1,[IIDFUS]Niner,2852,367,44,48,92,47.8%,32m
19527,3,DefundCops,2852,866,33,32,65,50.8%,10m
19527,1,bloodydragon,2852,838,30,33,63,47.6%,33m
19527,1,Groove,2852,736,28,36,64,43.8%,33m
19527,2,FlatCircle,2852,219,26,21,47,55.3%,35m
19527,1,MeatDealer,2852,689,24,35,59,40.7%,22m
19527,2,Voulskin,2852,125,16,18,34,47.1%,22m
19527,3,Azazel,2852,424,15,14,29,51.7%,35m
19527,2,LAgres,2852,214,12,14,26,46.2%,12m
19527,2,[PvsZ]BananaMan,2852,304,11,15,26,42.3%,36m
19527,3,Shakazulu,2852,254,10,9,19,52.6%,45m
19527,2,Jwhit,2852,315,10,11,21,47.6%,8m
19527,3,[TxT]DarthStorm,2852,256,8,9,17,47.1%,45m
19527,2,HugeMcLovins,2852,167,7,6,13,53.8%,16m
19527,1,[ToxicP]XYDHZ,2852,143,5,4,9,55.6%,1h
19527,3,[TK4L]Crazyman,2852,192,5,5,10,50.0%,19m
19527,2,[BLZ]Blaze,2852,60,4,6,10,40.0%,22m
19527,3,pistolon,2852,121,4,6,10,40.0%,9m
19527,2,TimonTilT,2852,144,3,6,9,33.3%,33m
19527,3,Therightside,2852,30,2,0,2,100.0%,36m
19527,3,Shady,2852,30,2,3,5,40.0%,19m
19527,3,Icarus,2852,0,2,3,5,40.0%,8m
19527,2,SirSoDerp,2852,30,2,4,6,33.3%,8m
19527,2,PyDev,2852,0,2,7,9,22.2%,24m
19527,3,Mhayden,2852,30,1,1,2,50.0%,44m
19527,2,Plunger,2852,0,1,1,2,50.0%,8m
19527,3,robotussin,2852,0,1,1,2,50.0%,43m
19527,3,Pukk,2852,0,0,1,1,0.0%,29m
19527,3,Polymorph,2852,0,0,1,1,0.0%,13m
19527,3,[wNt]JamesLawson,2852,0,0,2,2,0.0%,23m
19566,2,Jacones,2851,1566,189,165,354,53.4%,23m
19566,2,[wwin]Neckhairhunt,2851,1577,63,63,126,50.0%,13m
19566,3,fang,2851,1112,48,36,84,57.1%,30m
19566,2,[LgnTDS]yumRiCExP,2851,574,45,43,88,51.1%,22m
19566,1,CannonRusher,2851,957,40,42,82,48.8%,14m
19566,3,Millzinator,2851,599,26,24,50,52.0%,10m
19566,2,dynamics,2851,440,19,14,33,57.6%,33m
19566,3,owen,2851,477,19,15,34,55.9%,6m
19566,2,Chadders,2851,401,16,15,31,51.6%,13m
19566,2,cain,2851,148,13,13,26,50.0%,13m
19566,2,FiveLady,2851,143,13,14,27,48.1%,19m
19566,3,Xstub,2851,330,12,10,22,54.5%,2m
19566,3,[GOPERÚ]RonalFlores,2851,241,9,1,10,90.0%,5m
19566,2,Cocomoco,2851,135,8,9,17,47.1%,21m
19566,1,Minski,2851,240,8,16,24,33.3%,12m
19566,2,[ELE]Engineer,2851,176,7,7,14,50.0%,45m
19566,3,fangel,2851,30,5,1,6,83.3%,13m
19566,3,Chody,2851,90,4,3,7,57.1%,15m
19566,3,Ninsei,2851,0,3,2,5,60.0%,14m
19566,3,[NDEAHH]Desperado,2851,32,3,8,11,27.3%,2h
19566,1,LanguiDSkill,2851,48,2,0,2,100.0%,2h
19566,2,[Ophis]CapitanYes,2851,88,2,2,4,50.0%,12m
19566,3,Gaba,2851,60,2,2,4,50.0%,29m
19566,3,baikun,2851,0,2,2,4,50.0%,9m
19566,3,[shd0w]shadowlord,2851,0,1,0,1,100.0%,25m
19566,3,[0sC]Flake,2851,0,1,1,2,50.0%,42m
19566,2,[DarkLS]SLimE,2851,30,1,7,8,12.5%,14m
19566,3,[Gibz]LiquidGibz,2851,0,0,1,1,0.0%,11m
19566,3,[INGAMZ]Iscariote,2851,0,0,1,1,0.0%,31m
19566,1,theArtist,2851,0,0,1,1,0.0%,2h
19566,3,Itztli,2851,0,0,2,2,0.0%,32m
19597,1,doctorfrag,2850,1612,295,280,575,51.3%,6m
19597,1,JFCD,2850,1474,190,164,354,53.7%,15m
19597,3,Cattledebt,2850,1135,178,167,345,51.6%,33m
19597,2,DaneOMite,2850,1214,155,152,307,50.5%,36m
19597,3,Scythy,2850,1100,153,130,283,54.1%,5m
19597,1,CMGtml,2850,1617,118,114,232,50.9%,31m
19597,1,MasterOfYou,2850,1060,113,92,205,55.1%,44m
19597,2,Cherryboba,2850,1214,108,77,185,58.4%,17m
19597,3,[WCSOil]Windedpie,2850,783,104,81,185,56.2%,43m
19597,2,Fisher,2850,724,36,37,73,49.3%,30m
19597,2,StimToWin,2850,790,29,31,60,48.3%,32m
19597,2,cacktissmire,2850,340,26,13,39,66.7%,17m
19597,2,hunter,2850,644,24,26,50,48.0%,35m
19597,1,XXDONOBANXX,2850,681,22,29,51,43.1%,4m
19597,2,Speedracer,2850,524,19,17,36,52.8%,8m
19597,2,[IiUiI]BACKSTAB,2850,363,16,8,24,66.7%,30m
19597,3,captainG,2850,375,14,7,21,66.7%,19m
19597,2,wiggles,2850,315,12,10,22,54.5%,18m
19597,3,Chozo,2850,248,9,8,17,52.9%,44m
19597,1,EyeOfSiiren,2850,187,5,5,10,50.0%,2h
19597,2,ggMANDA,2850,60,5,5,10,50.0%,6m
19597,1,[nbgPH]dyetdyet,2850,166,5,11,16,31.2%,16m
19597,2,[JeZ]russelkiller,2850,0,4,1,5,80.0%,2h
19597,2,KidThomas,2850,0,4,1,5,80.0%,2h
19597,3,DrThug,2850,0,3,2,5,60.0%,13m
19597,2,KanT,2850,0,3,3,6,50.0%,3m
19597,2,HappyJoy,2850,46,3,3,6,50.0%,1h
19597,2,MichaelZC,2850,0,2,2,4,50.0%,40m
19597,3,[JLSc2]Brotoss,2850,60,2,3,5,40.0%,27m
19597,3,[bulo]halfsteel,2850,0,2,3,5,40.0%,25m
19597,2,Rankfield,2850,0,2,3,5,40.0%,2h
19597,3,[PiGPan]Ricez,2850,0,2,3,5,40.0%,22m
19597,2,RafalexF,2850,30,2,5,7,28.6%,37m
19597,3,LaArepa,2850,0,1,0,1,100.0%,24m
19597,3,Chatiko,2850,0,1,1,2,50.0%,43m
19597,3,Locoster,2850,30,1,3,4,25.0%,25m
19597,2,[DASJ3W]Hodorbig,2850,0,1,4,5,20.0%,38m
19597,3,[cl0udM]Hellfire,2850,0,0,1,1,0.0%,10m
19597,3,Wintance,2850,0,0,1,1,0.0%,45m
19597,3,[FlavT]oprawindfury,2850,0,0,2,2,0.0%,35m
19597,3,Alatriste,2850,0,0,2,2,0.0%,10m
19597,2,Moosemandude,2850,0,0,3,3,0.0%,8m
19597,1,MurderTrain,2850,0,0,4,4,0.0%,2h
19597,2,ColBuendia,2850,0,0,4,4,0.0%,33m
19597,2,Moss,2850,0,0,4,4,0.0%,5m
19597,1,[YZYSZN]TREYTREYTREY,2850,0,0,8,8,0.0%,8m
19643,3,[b1azin]littleboots,2849,1602,174,159,333,52.3%,24m
19643,2,MarcusVader,2849,1242,128,97,225,56.9%,23m
19643,2,ChadPasta,2849,1275,83,77,160,51.9%,14m
19643,2,Game,2849,1034,42,36,78,53.8%,37m
19643,1,ThirdWheeler,2849,828,36,31,67,53.7%,8m
19643,2,Juggernaut,2849,702,32,19,51,62.7%,8m
19643,2,[SANGRE]daniel,2849,784,31,31,62,50.0%,19m
19643,3,Spiraling,2849,554,20,22,42,47.6%,44m
19643,2,MJX,2849,380,15,16,31,48.4%,24m
19643,3,hazer,2849,368,14,11,25,56.0%,18m
19643,3,kimjubo,2849,118,13,12,25,52.0%,46m
19643,3,Ares,2849,254,9,3,12,75.0%,28m
19643,2,[xNATIx]Schmuck,2849,293,9,9,18,50.0%,17m
19643,3,PapaNuke,2849,192,7,4,11,63.6%,29m
19643,3,Barthim,2849,172,7,5,12,58.3%,22m
19643,3,Iceberg,2849,174,7,6,13,53.8%,25m
19643,2,[RdLzrd]BebopByshop,2849,216,7,8,15,46.7%,30m
19643,2,Overlisk,2849,175,5,6,11,45.5%,28m
19643,3,Joel,2849,30,4,2,6,66.7%,12m
19643,3,PizzaRolls,2849,114,4,5,9,44.4%,12m
19643,2,gabicho,2849,0,3,1,4,75.0%,2h
19643,1,johntitor,2849,167,3,3,6,50.0%,2h
19643,1,Imperador,2849,97,2,0,2,100.0%,2h
19643,2,bto,2849,60,2,6,8,25.0%,36m
19643,3,[AGHS]heby,2849,0,1,0,1,100.0%,8m
19643,3,HighStoryBro,2849,30,1,1,2,50.0%,24m
19643,3,[XpKAc]Keyn,2849,30,1,3,4,25.0%,16m
19643,2,Polar,2849,29,1,6,7,14.3%,4m
19643,3,airfrog,2849,0,0,1,1,0.0%,14m
19643,3,MuzafAs,2849,0,0,1,1,0.0%,4m
19643,3,RandySavage,2849,0,0,2,2,0.0%,36m
19674,2,[HØST]Krovak,2848,1527,153,138,291,52.6%,17m
19674,1,StevieNicks,2848,1543,135,137,272,49.6%,35m
19674,3,[GZRx]DrStone,2848,1216,110,110,220,50.0%,6m
19674,2,ThreshHawk,2848,1336,90,82,172,52.3%,44m
19674,2,Pablioto,2848,1114,88,64,152,57.9%,5m
19674,1,PickleRickk,2848,1621,78,73,151,51.7%,19m
19674,2,[Manics]AAABattery,2848,1525,78,76,154,50.6%,45m
19674,3,Hippylad,2848,1238,53,46,99,53.5%,33m
19674,2,GilGaWech,2848,503,42,33,75,56.0%,30m
19674,3,[ZpaceX]RcoronaVirus,2848,1034,42,34,76,55.3%,45m
19674,3,TheGrc,2848,683,31,17,48,64.6%,34m
19674,3,heldmar,2848,534,28,7,35,80.0%,42m
19674,3,[HBad]Chonkadee,2848,587,23,12,35,65.7%,26m
19674,3,[DgDzNt]XMuffinX,2848,585,21,20,41,51.2%,28m
19674,3,[xEx]rosen,2848,273,17,10,27,63.0%,8m
19674,1,[DNEdge]Nagasaki,2848,313,13,13,26,50.0%,2m
19674,2,auRElIiuz,2848,261,12,9,21,57.1%,13m
19674,3,Guigou,2848,350,11,17,28,39.3%,20m
19674,1,BigShrewd,2848,230,8,5,13,61.5%,2h
19674,2,MashedTaters,2848,155,7,2,9,77.8%,2h
19674,3,Napkins,2848,204,7,7,14,50.0%,3h
19674,2,[UpxV]Gwyndd,2848,178,7,11,18,38.9%,46m
19674,1,Bryan,2848,167,5,3,8,62.5%,2h
19674,3,Pnuemonia,2848,120,5,19,24,20.8%,7m
19674,1,origin,2848,48,3,6,9,33.3%,6m
19674,1,[Smegz]quah,2848,96,2,0,2,100.0%,2h
19674,1,[Augghh]Scorpius,2848,97,2,0,2,100.0%,2h
19674,1,Ochre,2848,0,2,4,6,33.3%,20m
19674,3,Ciffs,2848,0,1,0,1,100.0%,28m
19674,3,Darklust,2848,0,1,0,1,100.0%,10m
19674,3,earads,2848,0,0,1,1,0.0%,20m
19674,3,[ÐOOKS]Siege,2848,0,0,2,2,0.0%,18m
19706,3,mStacks,2847,1632,142,124,266,53.4%,8m
19706,2,Reshion,2847,1560,122,112,234,52.1%,44m
19706,1,battlingbard,2847,1602,104,109,213,48.8%,7m
19706,2,camelCase,2847,1554,75,73,148,50.7%,33m
19706,2,Zakk,2847,1253,49,44,93,52.7%,44m
19706,2,CheesePizza,2847,1016,48,37,85,56.5%,20m
19706,3,[ACSS]Pylonman,2847,998,42,30,72,58.3%,24m
19706,3,PamelaUwU,2847,752,34,25,59,57.6%,33m
19706,3,Rizuu,2847,728,33,21,54,61.1%,43m
19706,3,Fourlan,2847,864,32,30,62,51.6%,7m
19706,2,[P00PZZ]phargen,2847,511,28,25,53,52.8%,28m
19706,1,Pretzel,2847,694,24,32,56,42.9%,15m
19706,2,[KurWa]NefariouS,2847,473,21,21,42,50.0%,36m
19706,3,mark,2847,451,19,14,33,57.6%,12m
19706,3,Jeed,2847,417,17,14,31,54.8%,29m
19706,1,puppycat,2847,562,17,28,45,37.8%,18m
19706,2,inHALEN,2847,418,15,18,33,45.5%,22m
19706,2,Strife,2847,294,12,12,24,50.0%,6m
19706,3,[Labor]Probe,2847,218,10,4,14,71.4%,5m
19706,2,Macromyers,2847,164,7,6,13,53.8%,20m
19706,3,protoaST,2847,206,7,7,14,50.0%,14m
19706,3,[FGeek]chAnO,2847,211,7,8,15,46.7%,29m
19706,2,JackHindell,2847,0,5,5,10,50.0%,2h
19706,2,MicroJackson,2847,150,5,12,17,29.4%,46m
19706,3,[GTAB]Consensual,2847,0,4,1,5,80.0%,4m
19706,3,[10JQKA]Baller,2847,30,4,2,6,66.7%,33m
19706,2,NoBrainTrump,2847,60,4,5,9,44.4%,2m
19706,2,[xNPGx]PaPu,2847,88,4,5,9,44.4%,18m
19706,2,bang,2847,90,4,6,10,40.0%,28m
19706,2,freedom,2847,120,4,8,12,33.3%,19m
19706,3,Karmaeleon,2847,58,3,0,3,100.0%,5m
19706,3,EhWhoAmI,2847,58,3,1,4,75.0%,44m
19706,3,[BRSKR]Nuke,2847,60,2,2,4,50.0%,28m
19706,3,[2faded]koadyawn,2847,0,2,3,5,40.0%,3m
19706,2,[TPGGXD]Dark,2847,30,2,5,7,28.6%,36m
19706,3,[Stigma]BouncyBear,2847,0,1,0,1,100.0%,28m
19706,3,ZMBMN,2847,0,1,2,3,33.3%,44m
19706,3,Ishmael,2847,30,1,2,3,33.3%,45m
19706,3,misterpipol,2847,0,0,1,1,0.0%,28m
19706,3,[LAGTV]Trudeth,2847,0,0,2,2,0.0%,8m
19706,3,Wrath,2847,0,0,4,4,0.0%,2h
19747,2,Arcontes,2846,1583,265,259,524,50.6%,19m
19747,1,[CAPI]Diego,2846,1598,157,151,308,51.0%,45m
19747,1,[cl0udM]xBallsDeepx,2846,1544,123,126,249,49.4%,20m
19747,3,Labronze,2846,1545,68,60,128,53.1%,32m
19747,2,Ironhide,2846,1420,66,42,108,61.1%,24m
19747,3,[Lp]FORoMIZ,2846,558,38,23,61,62.3%,12m
19747,2,panchito,2846,234,22,19,41,53.7%,17m
19747,3,logix,2846,414,15,9,24,62.5%,32m
19747,1,[1vsM]Bacon,2846,273,13,10,23,56.5%,43m
19747,3,[VEEV]ShadowZuljin,2846,324,11,7,18,61.1%,44m
19747,1,[ABITA]Austin,2846,313,11,13,24,45.8%,12m
19747,2,BreezyDonkey,2846,167,11,13,24,45.8%,19m
19747,3,xEcsharp,2846,252,10,5,15,66.7%,26m
19747,3,[TEMT]Dion,2846,212,8,9,17,47.1%,14m
19747,1,VapoR,2846,236,6,7,13,46.2%,1h
19747,2,LycheeLuke,2846,141,4,1,5,80.0%,1h
19747,3,TrOyHaRd,2846,153,4,5,9,44.4%,30m
19747,2,Stronghold,2846,0,3,2,5,60.0%,13m
19747,2,PoundingDeer,2846,60,3,5,8,37.5%,44m
19747,2,[Ozzie]Lotherien,2846,60,3,6,9,33.3%,12m
19747,2,DarthTanks,2846,0,2,0,2,100.0%,2h
19747,3,RaulCastro,2846,30,2,1,3,66.7%,45m
19747,3,[Mrows1]AlienCats,2846,110,2,1,3,66.7%,19m
19747,3,[DCNG]DylanZoster,2846,0,2,3,5,40.0%,45m
19747,2,Wootfish,2846,0,2,5,7,28.6%,11m
19747,3,Prospero,2846,0,1,1,2,50.0%,47m
19747,3,[Downs1]wagonofthing,2846,30,1,3,4,25.0%,28m
19747,3,[Oruu]AleOruu,2846,0,0,1,1,0.0%,1h
19747,3,mojo,2846,0,0,1,1,0.0%,13m
19747,3,[CIAD]XeJiK,2846,0,0,1,1,0.0%,3m
19747,3,Loodah,2846,0,0,1,1,0.0%,27m
19747,3,[froz3n]silverkaze,2846,0,0,1,1,0.0%,11m
19747,3,SkyBreaker,2846,0,0,2,2,0.0%,21m
19747,1,Vexx,2846,0,0,2,2,0.0%,34m
19781,2,Sojourner,2845,1595,219,188,407,53.8%,35m
19781,2,[V3n0m]VenomBlack,2845,1308,162,149,311,52.1%,12m
19781,1,flypeach,2845,981,153,137,290,52.8%,20m
19781,3,Chicolz,2845,1594,83,69,152,54.6%,12m
19781,3,protADN,2845,1508,82,76,158,51.9%,47m
19781,2,BARCODE,2845,828,70,74,144,48.6%,21m
19781,3,Whiitez,2845,789,48,40,88,54.5%,33m
19781,3,aehu,2845,826,34,24,58,58.6%,33m
19781,3,ImPickleRick,2845,532,33,14,47,70.2%,8m
19781,2,FancySauce,2845,810,30,33,63,47.6%,11m
19781,1,seungwoonyc,2845,578,25,26,51,49.0%,33m
19781,2,RickConor,2845,290,24,24,48,50.0%,46m
19781,1,Mors,2845,633,24,28,52,46.2%,12m
19781,1,Sonicboom,2845,389,18,13,31,58.1%,44m
19781,3,halec,2845,414,17,12,29,58.6%,10m
19781,3,Mithrandir,2845,379,14,11,25,56.0%,28m
19781,3,HappyTwoBe,2845,234,9,7,16,56.2%,20m
19781,3,[sENaTe]Retribution,2845,224,7,6,13,53.8%,16m
19781,3,[Winsor]gribble,2845,172,6,5,11,54.5%,28m
19781,2,[BASCII]BedlessBean,2845,142,6,9,15,40.0%,23m
19781,3,[FAECES]Uriel,2845,192,5,5,10,50.0%,26m
19781,2,Stigma,2845,150,5,9,14,35.7%,20m
19781,3,MaRiNe,2845,0,4,1,5,80.0%,19m
19781,2,jake,2845,46,4,2,6,66.7%,2h
19781,2,[Topos]Frijolito,2845,0,4,2,6,66.7%,22m
19781,3,[Exitus]Miro,2845,60,3,1,4,75.0%,25m
19781,2,lunaflower,2845,0,3,2,5,60.0%,46m
19781,3,[ChDe]Izaul,2845,62,3,3,6,50.0%,16m
19781,2,[SkAL]ViewtifulJoe,2845,156,3,19,22,13.6%,18m
19781,1,soniiC,2845,96,2,5,7,28.6%,37m
19781,3,[LsL]LoCuRa,2845,0,1,0,1,100.0%,9m
19781,2,[iTE]KingKO,2845,0,1,0,1,100.0%,13m
19781,3,Sulfur,2845,0,1,1,2,50.0%,32m
19781,1,[Chikki]Hershey,2845,0,1,2,3,33.3%,2h
19781,1,Huntfalow,2845,93,1,3,4,25.0%,2h
19781,1,BigDelicious,2845,0,0,1,1,0.0%,2h
19781,2,Marine,2845,0,0,2,2,0.0%,14m
19818,2,[BlTEL]XPamTomX,2844,1595,423,416,839,50.4%,47m
19818,1,AFSchmidt,2844,1346,152,145,297,51.2%,6m
19818,2,LionOfJudea,2844,1602,69,60,129,53.5%,31m
19818,2,[Rakau]Dubz,2844,1307,64,45,109,58.7%,28m
19818,1,ZCE,2844,1334,58,66,124,46.8%,9m
19818,1,[NM8]Spade,2844,1367,48,54,102,47.1%,14m
19818,3,Lifeforce,2844,964,41,33,74,55.4%,47m
19818,2,Kiostrip,2844,292,34,27,61,55.7%,13m
19818,2,Broach,2844,535,31,32,63,49.2%,36m
19818,3,[TuxG]Bhola,2844,534,23,14,37,62.2%,47m
19818,2,JJJJJJJJ,2844,209,20,20,40,50.0%,28m
19818,1,RickHarrison,2844,356,17,15,32,53.1%,43m
19818,3,[Danilo]Pardas,2844,375,16,7,23,69.6%,44m
19818,3,ManBearPig,2844,460,16,17,33,48.5%,45m
19818,2,Klimtog,2844,332,12,12,24,50.0%,21m
19818,2,[Meower]Bootycat,2844,278,11,14,25,44.0%,13m
19818,2,Greengimp,2844,141,9,7,16,56.2%,14m
19818,2,Nitsuj,2844,234,9,12,21,42.9%,15m
19818,3,sant,2844,147,6,4,10,60.0%,14m
19818,3,ASYM,2844,174,6,9,15,40.0%,8m
19818,1,Igris,2844,131,5,2,7,71.4%,13m
19818,2,[UFC]BoiixWhite,2844,0,4,1,5,80.0%,2h
19818,3,Dbone,2844,114,4,6,10,40.0%,34m
19818,3,ZepplinBoss,2844,0,3,2,5,60.0%,13m
19818,2,zPillowfight,2844,33,3,7,10,30.0%,35m
19818,3,[1030]TEMPLAR,2844,30,2,0,2,100.0%,20m
19818,3,[Imr]Chaino,2844,30,2,1,3,66.7%,34m
19818,2,WuTang,2844,0,2,3,5,40.0%,27m
19818,3,Awfeel,2844,0,1,0,1,100.0%,8m
19818,3,Zirilan,2844,0,1,0,1,100.0%,28m
19818,3,Leixx,2844,30,1,1,2,50.0%,9m
19818,2,KiliWattz,2844,48,1,1,2,50.0%,37m
19818,3,HORUS,2844,0,0,1,1,0.0%,9m
19818,2,Ion,2844,0,0,1,1,0.0%,2h
19818,2,[REPORT]Seabee,2844,0,0,2,2,0.0%,46m
19818,3,Xenios,2844,0,0,2,2,0.0%,8m
19854,1,aletzzz,2843,1589,191,189,380,50.3%,18m
19854,1,deywa,2843,935,115,102,217,53.0%,4m
19854,2,ozZiz,2843,1483,56,61,117,47.9%,46m
19854,3,[THESG]IMoGsPrime,2843,918,40,26,66,60.6%,33m
19854,3,[WinD]Gis,2843,506,39,29,68,57.4%,44m
19854,2,pfemano,2843,948,38,36,74,51.4%,32m
19854,2,Richard,2843,712,32,27,59,54.2%,36m
19854,2,ChEnTeR,2843,505,21,16,37,56.8%,6m
19854,2,[Appa]VNET,2843,539,19,21,40,47.5%,7m
19854,3,[HØST]FrankBegins,2843,424,15,15,30,50.0%,2m
19854,3,pidgey,2843,366,13,12,25,52.0%,16m
19854,3,[Quackk]Rovek,2843,314,11,11,22,50.0%,7m
19854,2,THIRBASUPER,2843,58,5,4,9,55.6%,24m
19854,2,RobotNinja,2843,0,3,3,6,50.0%,10m
19854,3,[SANGRE]Frank,2843,90,3,5,8,37.5%,19m
19854,3,eightTWELVE,2843,58,2,3,5,40.0%,43m
19854,2,MegaMan,2843,0,1,0,1,100.0%,2h
19854,1,TreVVeK,2843,0,1,0,1,100.0%,2h
19854,3,Depression,2843,0,1,0,1,100.0%,43m
19854,3,pEpEeLtOrO,2843,0,1,0,1,100.0%,36m
19854,2,Superstar,2843,48,1,1,2,50.0%,2h
19854,1,EZHukRC,2843,97,1,1,2,50.0%,2h
19854,3,[neuroW]Seperthar,2843,30,1,2,3,33.3%,5m
19854,3,[OPERA]MRUIJIAKING,2843,0,1,2,3,33.3%,21m
19854,1,lejlot,2843,0,1,3,4,25.0%,20m
19854,3,[BioDeg]DrPrefect,2843,0,0,1,1,0.0%,28m
19854,3,[FLT]OverHere,2843,0,0,1,1,0.0%,36m
19881,1,ZOSO,2842,1604,531,496,1027,51.7%,7m
19881,2,Andromeda,2842,1577,282,262,544,51.8%,46m
19881,2,CareBear,2842,1578,262,240,502,52.2%,26m
19881,3,[UpxV]Saviour,2842,1515,248,239,487,50.9%,19m
19881,2,[MCOS]aguila,2842,1394,167,160,327,51.1%,24m
19881,2,FASC,2842,1485,135,133,268,50.4%,43m
19881,2,[GpoABX]Avikla,2842,1500,121,126,247,49.0%,13m
19881,2,noobOmaster,2842,1334,70,58,128,54.7%,17m
19881,2,FilthyCasual,2842,621,45,43,88,51.1%,46m
19881,1,[INextI]WackO,2842,1163,41,46,87,47.1%,4m
19881,3,Vofman,2842,823,34,23,57,59.6%,31m
19881,2,YouDoUBoo,2842,834,31,36,67,46.3%,32m
19881,3,[WTFNEL]AngeloPiasZ,2842,415,23,12,35,65.7%,10m
19881,1,[WDS]SwayyLee,2842,469,18,18,36,50.0%,34m
19881,1,LudwigVMises,2842,264,9,7,16,56.2%,19m
19881,3,[Pig2]Wizard,2842,166,7,5,12,58.3%,20m
19881,2,spartageuls,2842,168,7,8,15,46.7%,2h
19881,1,Snoopyy,2842,259,6,7,13,46.2%,2h
19881,3,[PKMSSS]SUNHEE,2842,43,5,3,8,62.5%,24m
19881,1,Harrison,2842,156,5,4,9,55.6%,1h
19881,1,Majora,2842,48,5,4,9,55.6%,1h
19881,3,sean,2842,139,5,4,9,55.6%,47m
19881,2,Eternal,2842,60,5,5,10,50.0%,23m
19881,2,SoulGlow,2842,224,5,6,11,45.5%,2h
19881,2,[xNPGx]AnThoN,2842,181,5,6,11,45.5%,2h
19881,3,Moremost,2842,116,4,2,6,66.7%,43m
19881,1,Marshmello,2842,119,4,4,8,50.0%,2h
19881,2,Kjubaran,2842,30,3,5,8,37.5%,17m
19881,3,SpaceCaptain,2842,149,3,6,9,33.3%,35m
19881,2,BringMyMeme,2842,48,2,1,3,66.7%,2h
19881,3,Chazzwozzles,2842,60,2,5,7,28.6%,30m
19881,2,KING,2842,0,1,0,1,100.0%,2h
19881,3,qrtpasdca,2842,30,1,3,4,25.0%,32m
19881,3,DarkWing,2842,0,0,1,1,0.0%,10m
19881,3,complex,2842,0,0,1,1,0.0%,16m
19881,3,Nathan,2842,0,0,2,2,0.0%,25m
19917,3,ronian,2841,976,137,149,286,47.9%,16m
19917,3,uberalles,2841,1252,116,106,222,52.3%,27m
19917,2,Corrision,2841,938,45,32,77,58.4%,17m
19917,2,TrickyZerg,2841,334,36,32,68,52.9%,16m
19917,2,Hathors,2841,588,24,19,43,55.8%,28m
19917,3,AcarajeX,2841,554,21,22,43,48.8%,46m
19917,3,mangeboule,2841,384,15,15,30,50.0%,34m
19917,2,hughy,2841,322,13,15,28,46.4%,22m
19917,3,[Tuple]Haderach,2841,306,12,9,21,57.1%,47m
19917,2,[LHRS]Kanji,2841,264,10,12,22,45.5%,15m
19917,3,NzaR,2841,237,9,8,17,52.9%,1h
19917,3,Orion,2841,202,8,6,14,57.1%,19m
19917,3,[RUMB]Azreark,2841,226,8,7,15,53.3%,34m
19917,2,[JOE7]Wagwil,2841,186,7,13,20,35.0%,14m
19917,3,Hylonman,2841,170,6,5,11,54.5%,29m
19917,1,Edelweiss,2841,145,5,4,9,55.6%,2h
19917,2,IcomefromEU,2841,141,5,7,12,41.7%,12m
19917,3,adfshsjhds,2841,139,4,2,6,66.7%,32m
19917,1,smothercomet,2841,97,4,3,7,57.1%,1h
19917,2,Xray,2841,128,3,5,8,37.5%,16m
19917,3,Mike,2841,30,2,0,2,100.0%,10m
19917,3,Nando,2841,30,2,0,2,100.0%,32m
19917,1,Joker,2841,0,2,2,4,50.0%,33m
19917,2,Parry,2841,0,2,3,5,40.0%,2h
19917,3,[Phishy]EnjoiJM,2841,58,2,4,6,33.3%,35m
19917,3,Eko,2841,0,1,0,1,100.0%,34m
19917,3,BluZeal,2841,0,1,0,1,100.0%,29m
19917,1,[SJK]SJK,2841,0,1,1,2,50.0%,36m
19917,3,[sk3tch]Richarddaddy,2841,0,1,2,3,33.3%,5m
19917,3,[DarkAG]Terranitup,2841,0,0,1,1,0.0%,44m
19917,2,[ØÛ]gorilarosado,2841,0,0,1,1,0.0%,27m
19917,3,[KSGT]qqqqq,2841,0,0,1,1,0.0%,33m
19949,1,Slarck,2840,1140,82,64,146,56.2%,22m
19949,3,Daplrth,2840,1480,66,47,113,58.4%,28m
19949,1,Yossarian,2840,848,56,55,111,50.5%,28m
19949,3,[LOLITO]Lumpitaz,2840,423,16,8,24,66.7%,19m
19949,3,killafrog,2840,151,7,1,8,87.5%,28m
19949,2,Markle,2840,234,7,9,16,43.8%,35m
19949,2,[DPRKor]KimJongUn,2840,114,6,3,9,66.7%,25m
19949,2,[Altism]Budvig,2840,146,6,9,15,40.0%,19m
19949,3,[NA7]beXcellent,2840,114,5,1,6,83.3%,14m
19949,3,PaNaChE,2840,58,5,4,9,55.6%,4m
19949,3,[LuxVI]Faust,2840,116,5,4,9,55.6%,30m
19949,3,[VKOA]Seraph,2840,144,5,6,11,45.5%,29m
19949,1,BigBoss,2840,170,5,15,20,25.0%,14m
19949,1,xyyyyy,2840,48,4,4,8,50.0%,2h
19949,2,Moon,2840,0,4,5,9,44.4%,3h
19949,2,Anep,2840,116,3,4,7,42.9%,17m
19949,3,Randomised,2840,0,1,0,1,100.0%,13m
19949,3,[REPORT]multiplyAU,2840,0,1,0,1,100.0%,10m
19949,3,QueensOnly,2840,0,1,0,1,100.0%,33m
19949,2,[1NoM]AlienLLama,2840,0,1,3,4,25.0%,23m
19949,2,Zizu,2840,0,1,3,4,25.0%,37m
19949,2,Solarity,2840,0,1,6,7,14.3%,13m
19949,3,[Noon]kerntastic,2840,0,0,1,1,0.0%,9m
19949,3,Wyler,2840,0,0,2,2,0.0%,8m
19973,2,Wiley,2839,1566,186,185,371,50.1%,36m
19973,3,zooker,2839,1344,50,51,101,49.5%,22m
19973,2,Zeratul,2839,1010,38,38,76,50.0%,13m
19973,2,[DRKESP]Alim,2839,571,38,40,78,48.7%,24m
19973,1,bignickyg,2839,1056,37,48,85,43.5%,20m
19973,3,[WOTG]Felipe,2839,808,33,26,59,55.9%,27m
19973,3,Shinkiro,2839,583,27,13,40,67.5%,23m
19973,1,grasewicz,2839,672,26,28,54,48.1%,24m
19973,3,[TPGGXD]elTipo,2839,439,19,6,25,76.0%,8m
19973,2,PIA,2839,425,18,13,31,58.1%,14m
19973,3,[DSoW]Skywalker,2839,389,17,12,29,58.6%,44m
19973,1,Mythicalz,2839,351,14,14,28,50.0%,44m
19973,2,[AbcCo]ZDoritoSan,2839,287,12,9,21,57.1%,24m
19973,3,KevM,2839,266,10,9,19,52.6%,44m
19973,2,ZooKeeper,2839,258,9,9,18,50.0%,21m
19973,2,Fenix,2839,115,4,4,8,50.0%,20m
19973,3,hawksai,2839,0,3,2,5,60.0%,31m
19973,3,tony,2839,58,3,3,6,50.0%,42m
19973,2,Anonymous,2839,46,2,4,6,33.3%,1h
19973,3,[MEP]Koozer,2839,0,1,1,2,50.0%,16m
19973,3,[TheSix]CerpinTaxt,2839,30,1,3,4,25.0%,9m
19973,2,[RaZerz]SteveSleaver,2839,0,1,3,4,25.0%,28m
19995,2,jon,2838,1480,168,160,328,51.2%,22m
19995,1,Voltaire,2838,1594,147,144,291,50.5%,44m
19995,2,Darwin,2838,1312,105,93,198,53.0%,33m
19995,2,arTex,2838,1607,86,76,162,53.1%,22m
19995,2,Yoda,2838,1637,72,73,145,49.7%,14m
19995,3,HappyPanda,2838,450,34,22,56,60.7%,8m
19995,2,[NBHI]Seter,2838,543,20,23,43,46.5%,45m
19995,2,Uetzi,2838,460,18,13,31,58.1%,3m
19995,2,[H1M1D]Jonny,2838,469,18,18,36,50.0%,45m
19995,2,Aurumai,2838,433,17,17,34,50.0%,24m
19995,3,Kurley,2838,416,15,15,30,50.0%,19m
19995,2,Pogo,2838,251,14,17,31,45.2%,28m
19995,3,ProbablyHyde,2838,211,9,6,15,60.0%,45m
19995,3,Shackwell,2838,177,7,9,16,43.8%,13m
19995,2,Mongose,2838,204,7,15,22,31.8%,35m
19995,3,SniperElite,2838,216,6,5,11,54.5%,4m
19995,2,pancho,2838,132,6,10,16,37.5%,12m
19995,2,Quetzalcoatl,2838,130,5,2,7,71.4%,23m
19995,3,Trump,2838,121,5,5,10,50.0%,33m
19995,3,Telion,2838,58,3,1,4,75.0%,44m
19995,2,Ronaldo,2838,0,3,2,5,60.0%,1h
19995,2,TakeCare,2838,0,3,2,5,60.0%,19m
19995,3,WzrdSingSong,2838,30,3,3,6,50.0%,12m
19995,2,IIIlIIIlIII,2838,60,3,5,8,37.5%,21m
19995,3,Hauby,2838,30,2,0,2,100.0%,44m
19995,3,Dreadsiete,2838,58,2,1,3,66.7%,5m
19995,3,[KDST]Grappler,2838,58,2,2,4,50.0%,26m
19995,3,Lokye,2838,30,2,2,4,50.0%,16m
19995,3,ELITON,2838,0,1,0,1,100.0%,47m
19995,2,[DarkLS]SnikeProXP,2838,0,1,2,3,33.3%,12m
19995,2,hellrazer,2838,36,1,7,8,12.5%,21m
19995,3,[EGx]Essential,2838,0,0,1,1,0.0%,9m
19995,3,TTVYTSTREAM,2838,0,0,1,1,0.0%,43m
19995,2,NickGor,2838,0,0,1,1,0.0%,2h
19995,3,Goku,2838,0,0,2,2,0.0%,30m
20030,2,GDucky,2837,1565,138,125,263,52.5%,7m
20030,1,SnotLicker,2837,1603,125,127,252,49.6%,33m
20030,2,JohnyClassic,2837,1124,80,81,161,49.7%,21m
20030,1,Lecram,2837,1275,77,77,154,50.0%,46m
20030,3,GoodPapoose,2837,675,61,51,112,54.5%,25m
20030,2,HowDoIType,2837,1164,58,52,110,52.7%,45m
20030,2,Jhomalex,2837,1112,46,42,88,52.3%,23m
20030,2,[SwOoNz]Goatboy,2837,1009,43,37,80,53.8%,46m
20030,2,TumerzuKING,2837,1012,40,37,77,51.9%,18m
20030,2,RAMSES,2837,669,27,24,51,52.9%,30m
20030,2,Charlsdicken,2837,754,26,34,60,43.3%,27m
20030,3,mathematico,2837,566,23,12,35,65.7%,44m
20030,3,Sean,2837,567,21,15,36,58.3%,33m
20030,2,Lottabullets,2837,374,15,13,28,53.6%,28m
20030,1,ARzR,2837,357,13,11,24,54.2%,27m
20030,3,[246810]ingiman,2837,202,12,4,16,75.0%,10m
20030,3,Benaiah,2837,306,11,6,17,64.7%,43m
20030,2,[tCo9]Bubzee,2837,252,8,11,19,42.1%,19m
20030,3,leonidas,2837,212,7,2,9,77.8%,3m
20030,1,VividV,2837,216,7,4,11,63.6%,1h
20030,3,SilverWings,2837,218,7,8,15,46.7%,44m
20030,3,Syair,2837,204,7,8,15,46.7%,4m
20030,1,Push,2837,88,5,3,8,62.5%,29m
20030,3,[Alown]Amats,2837,90,4,5,9,44.4%,11m
20030,3,Trot,2837,0,3,2,5,60.0%,19m
20030,3,sagas,2837,0,3,2,5,60.0%,4m
20030,3,[CHARR]AsicAbyss,2837,58,3,3,6,50.0%,23m
20030,3,Dachloe,2837,0,1,0,1,100.0%,33m
20030,3,[HJSDS]Danielx,2837,0,1,1,2,50.0%,12m
20030,3,uuuuuuuuuuuu,2837,0,1,3,4,25.0%,1h
20030,3,TheFunk,2837,0,0,1,1,0.0%,11m
20030,2,blrcx,2837,0,0,7,7,0.0%,15m
20062,3,Jfthegreat,2836,1592,287,274,561,51.2%,16m
20062,2,Grandpa,2836,1440,154,137,291,52.9%,13m
20062,2,[NPFR]bootykong,2836,1516,152,129,281,54.1%,10m
20062,2,bacolicious,2836,1595,97,90,187,51.9%,16m
20062,2,[THCC]Looney,2836,1441,95,87,182,52.2%,32m
20062,3,jsrao,2836,1519,82,56,138,59.4%,33m
20062,3,MadbrahXD,2836,1488,57,56,113,50.4%,8m
20062,3,canadabis,2836,1355,51,51,102,50.0%,7m
20062,3,[SizZIe]RaynorsRaper,2836,1151,50,35,85,58.8%,9m
20062,2,Zannzen,2836,758,45,27,72,62.5%,32m
20062,1,astigflip,2836,691,28,27,55,50.9%,10m
20062,2,ZebraHoedown,2836,469,19,16,35,54.3%,36m
20062,3,confuzed,2836,405,15,7,22,68.2%,5m
20062,2,mingcn,2836,235,11,8,19,57.9%,7m
20062,2,GeneralAmazz,2836,285,11,9,20,55.0%,24m
20062,1,NightFox,2836,266,11,13,24,45.8%,42m
20062,3,Shazmo,2836,275,10,8,18,55.6%,33m
20062,3,Shock,2836,244,9,8,17,52.9%,9m
20062,2,alexsebasxd,2836,180,7,6,13,53.8%,13m
20062,3,TossImba,2836,85,5,6,11,45.5%,27m
20062,2,BirdyCephon,2836,0,4,1,5,80.0%,12m
20062,1,[AOK]Robertoss,2836,168,4,2,6,66.7%,38m
20062,3,Vástago,2836,109,4,3,7,57.1%,45m
20062,1,[LWBB]Kemo,2836,104,4,7,11,36.4%,2m
20062,2,Eldarith,2836,0,3,2,5,60.0%,2h
20062,3,Onichancho,2836,86,3,2,5,60.0%,43m
20062,1,Tiger,2836,168,3,3,6,50.0%,2h
20062,1,[DBasH]Damph,2836,0,3,3,6,50.0%,2h
20062,3,Intro,2836,88,3,3,6,50.0%,16m
20062,3,Ert,2836,88,3,6,9,33.3%,9m
20062,3,Alebris,2836,0,1,0,1,100.0%,2h
20062,3,[FyHr]NaxosII,2836,0,1,0,1,100.0%,23m
20062,2,Zerg,2836,30,1,6,7,14.3%,8m
20062,3,GhostKing,2836,38,1,11,12,8.3%,38m
20062,3,FrameBonjwa,2836,0,0,1,1,0.0%,19m
20097,2,NeaS,2835,1212,160,134,294,54.4%,30m
20097,3,CidBR,2835,1303,108,104,212,50.9%,6m
20097,1,[ZTemps]IShootUDie,2835,1389,82,85,167,49.1%,25m
20097,2,AlphaBobcat,2835,606,80,64,144,55.6%,26m
20097,3,RAZGUT,2835,1543,71,60,131,54.2%,14m
20097,2,nitechaos,2835,436,56,56,112,50.0%,13m
20097,3,NicFit,2835,365,52,48,100,52.0%,35m
20097,2,Scufflaw,2835,1198,45,49,94,47.9%,20m
20097,1,[FFAA]CarEdu,2835,105,19,27,46,41.3%,35m
20097,2,Papashlapa,2835,410,14,16,30,46.7%,30m
20097,2,RoidVoid,2835,279,11,9,20,55.0%,14m
20097,2,GlitchSupply,2835,118,9,6,15,60.0%,24m
20097,1,ziache,2835,261,9,14,23,39.1%,22m
20097,3,AnToDjol,2835,143,7,7,14,50.0%,40m
20097,3,Nugs,2835,170,4,2,6,66.7%,40m
20097,3,Ganjalf,2835,58,3,0,3,100.0%,25m
20097,3,loic,2835,58,3,2,5,60.0%,9m
20097,2,FRANCHU,2835,0,3,2,5,60.0%,2h
20097,1,cLasSiC,2835,145,3,3,6,50.0%,15m
20097,1,[Nutr]Wolfstep,2835,119,3,6,9,33.3%,2h
20097,2,GetSome,2835,92,2,2,4,50.0%,30m
20097,3,[SRKS]Fattmatt,2835,30,2,3,5,40.0%,11m
20097,3,Assassin,2835,30,2,3,5,40.0%,12m
20097,3,nemesis,2835,60,2,4,6,33.3%,35m
20097,3,[Raip]Ghost,2835,0,1,2,3,33.3%,44m
20097,3,Amphipoda,2835,0,1,3,4,25.0%,1h
20097,3,[xSPTx]FerNix,2835,0,0,1,1,0.0%,44m
20097,3,PieroM,2835,0,0,1,1,0.0%,3m
20097,3,TKSikNasty,2835,0,0,1,1,0.0%,47m
20097,3,ArtileryOnly,2835,0,0,2,2,0.0%,6m
20127,2,SSA,2834,1591,359,339,698,51.4%,30m
20127,2,FDJC,2834,1544,138,141,279,49.5%,23m
20127,2,AeaMan,2834,828,55,42,97,56.7%,6m
20127,2,Zartarr,2834,788,38,30,68,55.9%,30m
20127,3,IronCurtain,2834,603,28,21,49,57.1%,5m
20127,3,IIIIIIIIIIII,2834,590,25,14,39,64.1%,37m
20127,3,PotatoMine,2834,519,21,13,34,61.8%,20m
20127,1,Focus,2834,569,18,24,42,42.9%,21m
20127,2,Zilk,2834,422,15,18,33,45.5%,44m
20127,2,[oGsBR]lIIIlIIIIlll,2834,338,12,18,30,40.0%,13m
20127,3,Geeongee,2834,141,8,3,11,72.7%,37m
20127,2,Katanary,2834,186,6,6,12,50.0%,16m
20127,3,SoulJive,2834,147,6,7,13,46.2%,30m
20127,3,LAD,2834,0,5,0,5,100.0%,9m
20127,3,[SLAMT]Enclave,2834,116,5,2,7,71.4%,27m
20127,2,[WZLN]WholeBread,2834,144,5,4,9,55.6%,44m
20127,1,[TMSyN]PinkSlip,2834,96,5,5,10,50.0%,2h
20127,2,ppitaggi,2834,30,4,4,8,50.0%,23m
20127,3,WuhanPeople,2834,0,3,2,5,60.0%,28m
20127,3,Arthos,2834,93,3,3,6,50.0%,8m
20127,2,Viatã,2834,129,3,10,13,23.1%,47m
20127,1,TKboldimeR,2834,48,2,2,4,50.0%,3h
20127,3,[VFam2]WTJAG,2834,62,2,4,6,33.3%,30m
20127,3,[ESL]Eyescar,2834,58,2,4,6,33.3%,8m
20127,3,[GnR]Descending,2834,30,1,1,2,50.0%,11m
20127,3,BIANCHIROCK,2834,18,1,2,3,33.3%,23m
20127,3,[DYM]Nel,2834,97,1,4,5,20.0%,14m
20127,3,GolongLatte,2834,0,0,1,1,0.0%,14m
20155,1,CalvinHobbes,2833,1571,292,277,569,51.3%,18m
20155,3,Qaid,2833,1089,106,103,209,50.7%,32m
20155,3,Probetoss,2833,1451,61,54,115,53.0%,26m
20155,2,EarthenKiwi,2833,1214,49,51,100,49.0%,25m
20155,2,xOff,2833,1094,48,41,89,53.9%,24m
20155,2,[ML]archon,2833,1164,45,42,87,51.7%,23m
20155,2,Eurotrix,2833,909,36,37,73,49.3%,20m
20155,2,Riofacer,2833,792,32,25,57,56.1%,8m
20155,3,Deliverance,2833,516,31,27,58,53.4%,23m
20155,3,ArmoredBus,2833,632,30,18,48,62.5%,4m
20155,2,Sonny,2833,489,19,18,37,51.4%,47m
20155,3,Shadowdog,2833,462,17,15,32,53.1%,4m
20155,3,Ribenas,2833,304,11,11,22,50.0%,15m
20155,2,Anandamide,2833,234,9,7,16,56.2%,6m
20155,3,[kaYomi]pokefeli,2833,164,7,3,10,70.0%,10m
20155,2,crentist,2833,204,6,8,14,42.9%,8m
20155,3,[TinyED]TinYsOs,2833,142,5,3,8,62.5%,28m
20155,3,[BooKng]Onda,2833,116,5,6,11,45.5%,44m
20155,1,RaphThePaf,2833,137,4,2,6,66.7%,1h
20155,3,GitGud,2833,120,4,6,10,40.0%,43m
20155,2,Atomos,2833,126,4,10,14,28.6%,13m
20155,2,TKOL,2833,0,3,3,6,50.0%,35m
20155,3,Wallace,2833,30,2,3,5,40.0%,8m
20155,3,shadowmonk,2833,58,2,4,6,33.3%,30m
20155,3,Wandrative,2833,60,2,5,7,28.6%,29m
20155,3,Zerovelocity,2833,0,1,0,1,100.0%,29m
20155,1,Calicrisis,2833,0,1,1,2,50.0%,3h
20155,2,JUSTWINBABY,2833,0,1,4,5,20.0%,8m
20155,3,[FFAA]hyperion,2833,0,1,4,5,20.0%,9m
20155,3,josephckcere,2833,30,1,4,5,20.0%,17m
20155,3,King,2833,0,0,1,1,0.0%,43m
20155,3,Rem,2833,0,0,2,2,0.0%,8m
20187,3,WallyWilde,2832,1561,183,172,355,51.5%,28m
20187,2,SHATTERSTAR,2832,363,16,11,27,59.3%,47m
20187,2,eigenrosen,2832,434,15,18,33,45.5%,17m
20187,3,[XpKAc]lenin,2832,346,14,15,29,48.3%,34m
20187,2,NoCanAttack,2832,307,13,8,21,61.9%,2h
20187,2,fliptofps,2832,365,12,15,27,44.4%,22m
20187,3,ThisIsJimmy,2832,284,11,10,21,52.4%,13m
20187,1,[squad1]Monke,2832,342,10,10,20,50.0%,12m
20187,1,Polo,2832,273,9,9,18,50.0%,2h
20187,3,ROOM,2832,137,7,0,7,100.0%,32m
20187,3,Coffee,2832,175,7,3,10,70.0%,4m
20187,3,DieBorg,2832,171,6,6,12,50.0%,9m
20187,2,Sety,2832,154,6,11,17,35.3%,13m
20187,2,brinky,2832,200,6,15,21,28.6%,35m
20187,2,Rmao,2832,120,5,8,13,38.5%,19m
20187,3,Xerolag,2832,114,4,2,6,66.7%,32m
20187,3,[Magic3]DEADSNAKE,2832,90,4,2,6,66.7%,8m
20187,1,Dkai,2832,97,4,3,7,57.1%,1h
20187,1,Nicolove,2832,0,3,3,6,50.0%,1h
20187,2,sleepy,2832,48,3,4,7,42.9%,1h
20187,3,geozdiegoXD,2832,58,2,1,3,66.7%,46m
20187,2,TriTon,2832,128,2,2,4,50.0%,3m
20187,2,[T0S]Earsauce,2832,93,2,5,7,28.6%,2h
20187,3,SuhaleS,2832,0,1,0,1,100.0%,45m
20187,3,[AFTMTH]Thatbobguy,2832,0,1,2,3,33.3%,28m
20187,1,valentino,2832,0,0,1,1,0.0%,1h
20187,2,Samkeit,2832,0,0,4,4,0.0%,19m
20214,1,[SpJm]YoStanky,2831,1507,128,114,242,52.9%,33m
20214,3,Asylum,2831,1087,101,98,199,50.8%,9m
20214,3,SmartAsp,2831,821,83,59,142,58.5%,4m
20214,3,Luch,2831,1426,63,47,110,57.3%,6m
20214,1,FrontierBro,2831,801,60,60,120,50.0%,18m
20214,2,IIIIIIII,2831,198,28,24,52,53.8%,32m
20214,2,Potoquis,2831,341,17,19,36,47.2%,12m
20214,3,[N0M]Monsanto,2831,227,9,1,10,90.0%,8m
20214,3,[USWAG]Xiuhcoatl,2831,142,5,5,10,50.0%,5m
20214,2,xublauzinho,2831,60,5,6,11,45.5%,13m
20214,2,Pwyff,2831,30,4,4,8,50.0%,32m
20214,2,Evets,2831,92,4,6,10,40.0%,7m
20214,2,[SoVA]CaptainFudge,2831,0,3,2,5,60.0%,2h
20214,1,Sean,2831,46,2,5,7,28.6%,1h
20214,3,[Xpk]Mapazhe,2831,0,1,0,1,100.0%,43m
20214,3,Honk,2831,0,1,2,3,33.3%,1h
20214,3,[asdf12]cau,2831,30,1,2,3,33.3%,11m
20214,3,[Zin]Truean,2831,0,0,1,1,0.0%,36m
20214,1,[C2N]epicbeast,2831,0,0,2,2,0.0%,44m
20233,2,NEPO,2830,1420,160,138,298,53.7%,33m
20233,2,Rebelonme,2830,1506,148,138,286,51.7%,6m
20233,2,BurlyBanana,2830,818,63,54,117,53.8%,4m
20233,2,Jlpk,2830,746,37,37,74,50.0%,13m
20233,2,Eusung,2830,297,27,22,49,55.1%,21m
20233,2,[NVYTE]robicheaux,2830,660,27,23,50,54.0%,21m
20233,3,OAO,2830,327,12,9,21,57.1%,34m
20233,3,DoubleD,2830,266,9,3,12,75.0%,15m
20233,3,DreamJob,2830,240,7,6,13,53.8%,45m
20233,1,BLOODBATH,2830,100,6,3,9,66.7%,43m
20233,3,Darklaw,2830,216,6,3,9,66.7%,14m
20233,3,[Koshka]SureShot,2830,178,6,6,12,50.0%,43m
20233,2,[Wizerd]Jafar,2830,180,6,11,17,35.3%,19m
20233,2,JOHANrc,2830,162,5,4,9,55.6%,30m
20233,3,NoSkills,2830,86,4,2,6,66.7%,16m
20233,2,CritYoClit,2830,0,4,2,6,66.7%,30m
20233,3,Mineralthief,2830,58,3,0,3,100.0%,32m
20233,3,[BigOlD]TooTLooPs,2830,95,3,1,4,75.0%,12m
20233,3,Turtleswan,2830,0,3,2,5,60.0%,20m
20233,3,Drambush,2830,62,3,4,7,42.9%,8m
20233,1,[TrDoS]Gokit,2830,96,2,0,2,100.0%,16m
20233,3,[MinzS]Andrene,2830,30,2,1,3,66.7%,42m
20233,3,YasserKim,2830,30,2,3,5,40.0%,42m
20233,3,hers,2830,0,2,3,5,40.0%,31m
20233,3,FireSquid,2830,0,2,3,5,40.0%,29m
20233,1,[TPGGXD]LinKras,2830,0,0,1,1,0.0%,2h
20233,3,Inmortal,2830,0,0,1,1,0.0%,5m
20260,1,thrillhouse,2829,1604,266,270,536,49.6%,35m
20260,2,OKCthunder,2829,1581,222,206,428,51.9%,36m
20260,3,[toki]obmitnia,2829,1537,146,136,282,51.8%,37m
20260,3,[5252]Starstriker,2829,1143,57,22,79,72.2%,28m
20260,2,Seyo,2829,1382,56,51,107,52.3%,18m
20260,2,dbhamster,2829,1215,52,40,92,56.5%,36m
20260,2,ThiccJav,2829,556,43,33,76,56.6%,43m
20260,2,Eidos,2829,980,34,42,76,44.7%,19m
20260,3,CaPiXaBa,2829,857,33,24,57,57.9%,26m
20260,3,DreadWander,2829,697,29,30,59,49.2%,28m
20260,1,JohnHenry,2829,777,28,34,62,45.2%,35m
20260,1,KenChicKen,2829,426,27,30,57,47.4%,24m
20260,3,PoopLord,2829,363,22,14,36,61.1%,9m
20260,2,ProYOLOtoss,2829,324,20,24,44,45.5%,14m
20260,1,ImBehind,2829,243,19,31,50,38.0%,27m
20260,3,[GGTOEZ]Microjackson,2829,364,18,13,31,58.1%,32m
20260,3,Plattsy,2829,372,16,6,22,72.7%,43m
20260,2,[Astute]HazyVisions,2829,312,14,9,23,60.9%,16m
20260,3,drpthehammer,2829,282,10,12,22,45.5%,44m
20260,2,JPX,2829,284,9,10,19,47.4%,24m
20260,1,IIIIIIIIIIII,2829,241,7,5,12,58.3%,35m
20260,2,codebreaker,2829,214,7,7,14,50.0%,36m
20260,3,TROLLCOOKIE,2829,152,6,7,13,46.2%,9m
20260,2,eZxD,2829,46,5,2,7,71.4%,40m
20260,3,Habeeb,2829,86,4,1,5,80.0%,29m
20260,3,DatBoi,2829,0,4,1,5,80.0%,46m
20260,3,ZeTH,2829,11,2,2,4,50.0%,42m
20260,3,Yalos,2829,0,2,3,5,40.0%,28m
20260,3,[DeBoyz]Sniper,2829,30,1,1,2,50.0%,34m
20260,3,EarthII,2829,30,1,1,2,50.0%,28m
20260,3,[DRKRPT]LOLwhat,2829,30,1,5,6,16.7%,13m
20260,2,Smoke,2829,30,1,6,7,14.3%,17m
20260,3,[RUMB]BASHER,2829,0,0,1,1,0.0%,4m
20260,3,[PGOAT]Pinery,2829,0,0,1,1,0.0%,29m
20260,3,DrRockso,2829,0,0,1,1,0.0%,10m
20260,3,[KVR]SINA,2829,0,0,1,1,0.0%,45m
20260,3,Blazek,2829,0,0,1,1,0.0%,32m
20260,3,[CUKZ]Shorttown,2829,0,0,1,1,0.0%,16m
20260,1,MountainofCJ,2829,0,0,1,1,0.0%,19m
20260,3,Mtt,2829,0,0,1,1,0.0%,21m
20260,3,Jepdiv,2829,0,0,3,3,0.0%,6m
20301,2,VonBergen,2828,1019,229,220,449,51.0%,43m
20301,2,Skeebopstop,2828,1615,163,147,310,52.6%,26m
20301,1,ConnorDotCom,2828,1575,86,82,168,51.2%,18m
20301,1,dvelz,2828,1177,64,65,129,49.6%,23m
20301,3,AndresJE,2828,613,28,26,54,51.9%,27m
20301,3,ahahahhahaha,2828,425,16,11,27,59.3%,9m
20301,3,[Rocket]Vivi,2828,407,14,10,24,58.3%,4m
20301,1,savior,2828,480,14,26,40,35.0%,6m
20301,3,TheStarPlane,2828,225,9,3,12,75.0%,11m
20301,1,Julian,2828,181,8,8,16,50.0%,32m
20301,2,angelblack,2828,205,6,9,15,40.0%,23m
20301,2,[ARVL]freaknflow,2828,0,4,2,6,66.7%,3m
20301,3,[TGosuD]tik,2828,94,4,2,6,66.7%,31m
20301,2,[TDirT]BubbleGum,2828,141,3,1,4,75.0%,12m
20301,2,jseashell,2828,0,3,2,5,60.0%,37m
20301,3,[TGosuA]Patata,2828,60,3,2,5,60.0%,7m
20301,3,[CPiece]Bill,2828,58,2,4,6,33.3%,16m
20301,1,ZPM,2828,0,2,6,8,25.0%,2h
20301,3,[NuTFuW]Funkshunator,2828,0,1,0,1,100.0%,43m
20301,2,[CdA]skylake,2828,0,0,1,1,0.0%,2h
20301,3,Deane,2828,0,0,1,1,0.0%,26m
20301,3,BausSaus,2828,0,0,1,1,0.0%,25m
20301,3,[UAK]bondzin,2828,0,0,1,1,0.0%,6m
20301,3,[LifeF]Prometeo,2828,0,0,1,1,0.0%,47m
20301,3,Animus,2828,0,0,1,1,0.0%,27m
20301,1,SirChaos,2828,0,0,2,2,0.0%,19m
20301,3,grappa,2828,0,0,2,2,0.0%,23m
20301,2,LineTwist,2828,0,0,6,6,0.0%,9m
20329,1,BurntSynapse,2827,1596,570,573,1143,49.9%,20m
20329,2,Andorian,2827,1561,205,194,399,51.4%,47m
20329,2,computer,2827,1551,181,169,350,51.7%,6m
20329,2,bayareaJacky,2827,1546,167,142,309,54.0%,5m
20329,2,Ranger,2827,1532,149,138,287,51.9%,5m
20329,2,[LYBF91]zzz,2827,890,108,107,215,50.2%,19m
20329,3,[UKNOME]Rooki,2827,1612,93,82,175,53.1%,14m
20329,2,BOCAVERA,2827,729,65,50,115,56.5%,29m
20329,2,FranJa,2827,900,56,57,113,49.6%,14m
20329,3,Donoblaine,2827,613,46,38,84,54.8%,36m
20329,3,[Mitsu]TheMule,2827,295,32,30,62,51.6%,28m
20329,2,Klappertaart,2827,338,30,27,57,52.6%,22m
20329,1,Zatrux,2827,744,24,36,60,40.0%,37m
20329,3,JuhBusto,2827,534,22,20,42,52.4%,26m
20329,2,Sentizzle,2827,556,21,22,43,48.8%,46m
20329,3,Star,2827,418,16,14,30,53.3%,21m
20329,1,HappyNomad,2827,273,9,14,23,39.1%,9m
20329,3,ELMERO,2827,152,7,4,11,63.6%,9m
20329,1,Vito,2827,100,5,4,9,55.6%,19m
20329,2,LuckDragon,2827,120,4,9,13,30.8%,6m
20329,3,ErnestoV,2827,58,3,2,5,60.0%,43m
20329,2,Chrono,2827,126,3,6,9,33.3%,23m
20329,2,[HGG]Oxygen,2827,30,2,3,5,40.0%,30m
20329,2,Butterfinger,2827,91,2,3,5,40.0%,2h
20329,3,[WNTRLY]leadtech,2827,0,1,0,1,100.0%,47m
20329,3,EndlesDragon,2827,30,1,3,4,25.0%,20m
20329,2,MBZ,2827,0,0,1,1,0.0%,3h
20329,3,[Truies]Pretzel,2827,0,0,1,1,0.0%,12m
20329,3,Snap,2827,0,0,2,2,0.0%,7m
20358,1,PsiC,2826,1609,960,952,1912,50.2%,44m
20358,2,thelasthomo,2826,1610,194,177,371,52.3%,24m
20358,3,DREWPICKLES,2826,735,104,91,195,53.3%,47m
20358,2,[Vzla]Cavalgo,2826,512,80,66,146,54.8%,24m
20358,2,Enk,2826,1182,74,70,144,51.4%,26m
20358,3,[HOTC]DARKz,2826,1080,49,50,99,49.5%,15m
20358,3,FionaHippo,2826,124,18,19,37,48.6%,6m
20358,2,Terminator,2826,353,15,12,27,55.6%,6m
20358,2,howdoizerg,2826,260,10,17,27,37.0%,43m
20358,3,Blue,2826,222,9,7,16,56.2%,23m
20358,3,SwtAdeline,2826,283,9,10,19,47.4%,27m
20358,3,Cherry,2826,174,7,7,14,50.0%,1h
20358,3,Tenderoni,2826,144,6,2,8,75.0%,47m
20358,1,CheezeBreeze,2826,100,6,3,9,66.7%,18m
20358,1,[GDKND]xSkyFirex,2826,191,6,5,11,54.5%,8m
20358,3,[ZTemp]GrimKeeper,2826,168,6,5,11,54.5%,28m
20358,3,RødGrødFløde,2826,155,5,5,10,50.0%,26m
20358,2,Rob,2826,142,4,5,9,44.4%,36m
20358,3,[PTBJ]Janus,2826,60,3,1,4,75.0%,16m
20358,1,[XMX]Fehnryr,2826,94,3,3,6,50.0%,47m
20358,3,rockatrion,2826,139,3,3,6,50.0%,43m
20358,3,Jinx,2826,86,3,5,8,37.5%,7m
20358,3,Pejelargarto,2826,90,3,6,9,33.3%,34m
20358,3,SeeNoEvill,2826,0,1,1,2,50.0%,27m
20358,3,[2Z1MTV]Tempesta,2826,30,1,2,3,33.3%,15m
20358,3,Abner,2826,30,1,2,3,33.3%,3m
20358,2,OutCold,2826,0,1,5,6,16.7%,13m
20358,3,Joe,2826,0,0,1,1,0.0%,1h
20358,3,Jdogg,2826,0,0,1,1,0.0%,4m
20358,3,[PRZM]MiKeJoNeS,2826,0,0,1,1,0.0%,10m
20358,3,xFASTx,2826,0,0,1,1,0.0%,29m
20358,3,[MLKMEN]Milkman,2826,0,0,3,3,0.0%,36m
20390,3,Cokedajoke,2825,1591,546,518,1064,51.3%,14m
20390,1,NIHAOKAILAN,2825,1546,342,313,655,52.2%,23m
20390,2,SheinWeng,2825,1640,160,136,296,54.1%,22m
20390,3,[IiUiI]Scavenger,2825,1659,116,108,224,51.8%,10m
20390,1,ARTperverso,2825,1214,81,91,172,47.1%,37m
20390,3,dartelaryon,2825,845,70,58,128,54.7%,16m
20390,2,[TB225]BubbaGumpz,2825,1535,65,67,132,49.2%,24m
20390,2,Messymess,2825,985,42,34,76,55.3%,15m
20390,3,Bossman,2825,797,32,30,62,51.6%,43m
20390,3,HENTAl,2825,685,28,28,56,50.0%,32m
20390,3,[FØX]Zpeedlin,2825,488,22,11,33,66.7%,3m
20390,3,ElisilverxD,2825,594,22,20,42,52.4%,33m
20390,1,Bull,2825,418,19,26,45,42.2%,19m
20390,3,SmrtyCakes,2825,395,16,12,28,57.1%,47m
20390,2,SyaroKirima,2825,145,12,11,23,52.2%,21m
20390,2,BuzzKill,2825,200,11,9,20,55.0%,25m
20390,3,[TAKAX2]ReturN,2825,246,10,6,16,62.5%,7m
20390,2,Ktonamor,2825,241,10,9,19,52.6%,17m
20390,3,[CBAS3]VoidTemplar,2825,208,8,7,15,53.3%,43m
20390,2,[tCo9]Stoics,2825,228,7,10,17,41.2%,5m
20390,2,SubZeroMotor,2825,144,4,5,9,44.4%,20m
20390,2,Currynut,2825,96,3,2,5,60.0%,1h
20390,3,FreeTNE,2825,86,3,3,6,50.0%,47m
20390,2,[60053]Ifeqevron,2825,91,2,2,4,50.0%,14m
20390,3,[MSLB]Nikhi,2825,58,2,4,6,33.3%,44m
20390,3,BigMaddoDado,2825,0,2,5,7,28.6%,41m
20390,2,NoNamEr,2825,0,1,0,1,100.0%,2h
20390,3,SnAfU,2825,30,1,1,2,50.0%,31m
20390,3,papir,2825,30,1,3,4,25.0%,14m
20390,3,[CesCRU]Kovacs,2825,0,1,3,4,25.0%,43m
20390,3,Lemma,2825,30,1,4,5,20.0%,18m
20390,3,Jamieson,2825,30,1,4,5,20.0%,17m
20390,3,EasyTee,2825,0,0,1,1,0.0%,33m
20390,3,[Dlphns]pdkiller,2825,0,0,1,1,0.0%,8m
20390,3,ArqLeO,2825,0,0,1,1,0.0%,9m
20390,3,[Xpk]mxpandrax,2825,0,0,1,1,0.0%,27m
20390,3,LAWLeIkt,2825,0,0,1,1,0.0%,16m
20390,2,Tangiblebat,2825,0,0,1,1,0.0%,2h
20428,1,[EpicG]Davirex,2824,1593,139,146,285,48.8%,3m
20428,2,[AbcCo]Lothacan,2824,1340,101,82,183,55.2%,17m
20428,3,Blisterin,2824,540,31,27,58,53.4%,13m
20428,3,shawman,2824,568,28,6,34,82.4%,28m
20428,2,Tekoshii,2824,738,27,32,59,45.8%,20m
20428,3,JazZzoN,2824,396,15,12,27,55.6%,9m
20428,3,PotatoAssasn,2824,351,13,14,27,48.1%,43m
20428,2,llllllllllll,2824,213,8,6,14,57.1%,16m
20428,3,ALMANEGRA,2824,176,7,9,16,43.8%,30m
20428,2,Joshytime,2824,79,6,7,13,46.2%,19m
20428,1,JJbiggles,2824,267,6,12,18,33.3%,34m
20428,2,PLATUS,2824,121,4,5,9,44.4%,4m
20428,2,acsro,2824,88,4,6,10,40.0%,13m
20428,3,[GOPERÚ]NIKOLAI,2824,86,3,3,6,50.0%,6m
20428,3,EnigmaTome,2824,30,2,0,2,100.0%,6m
20428,3,[HDFs]Lprett,2824,30,2,3,5,40.0%,33m
20428,3,Stasis,2824,0,1,0,1,100.0%,27m
20428,3,pch,2824,0,1,0,1,100.0%,29m
20428,3,[JACPAR]fartsotutti,2824,0,1,0,1,100.0%,26m
20428,3,Ozz,2824,30,1,2,3,33.3%,45m
20428,3,[0825]Sacred,2824,0,0,1,1,0.0%,23m
20428,3,OmniKai,2824,0,0,1,1,0.0%,28m
20428,3,Salas,2824,0,0,1,1,0.0%,43m
20428,1,LukeSkywalkr,2824,0,0,2,2,0.0%,8m
20428,3,XSuzumiyaX,2824,0,0,4,4,0.0%,33m
20453,1,OneAmillion,2823,1605,308,299,607,50.7%,34m
20453,2,Tony,2823,1149,163,142,305,53.4%,10m
20453,1,Belvedere,2823,1605,142,143,285,49.8%,15m
20453,3,[DLe]chatoworld,2823,1584,113,107,220,51.4%,26m
20453,2,bearclaw,2823,1493,83,84,167,49.7%,24m
20453,2,HungAnh,2823,1257,54,44,98,55.1%,32m
20453,3,ATS,2823,498,25,22,47,53.2%,35m
20453,2,IllIIlIIllII,2823,486,20,18,38,52.6%,24m
20453,3,[diaman]SIODOS,2823,362,16,6,22,72.7%,10m
20453,3,reneGade,2823,367,14,10,24,58.3%,4m
20453,3,PiktrMeRolin,2823,215,10,7,17,58.8%,37m
20453,3,DasSchwerin,2823,127,8,0,8,100.0%,13m
20453,2,MangRenAnMo,2823,262,8,13,21,38.1%,47m
20453,1,Lanzelot,2823,189,7,2,9,77.8%,1h
20453,3,[SL3ePY]Rampart,2823,60,7,4,11,63.6%,14m
20453,1,Firefly,2823,145,6,4,10,60.0%,2h
20453,1,Trapsrealbig,2823,96,5,5,10,50.0%,2h
20453,2,Dyetaet,2823,46,5,7,12,41.7%,2h
20453,2,hurrycane,2823,0,4,1,5,80.0%,13m
20453,2,Mandoo,2823,0,4,1,5,80.0%,2h
20453,1,ZEROFox,2823,97,4,4,8,50.0%,3m
20453,3,MechunT,2823,146,3,5,8,37.5%,7m
20453,3,FOX,2823,30,2,0,2,100.0%,34m
20453,3,[tdrs]eyecomehonor,2823,30,2,0,2,100.0%,29m
20453,3,[DRKAPP]Wish,2823,30,2,1,3,66.7%,35m
20453,3,MattyJ,2823,97,1,1,2,50.0%,7m
20453,3,[TPGGXD]alecsander,2823,30,1,2,3,33.3%,14m
20453,3,BloodPixy,2823,30,1,2,3,33.3%,14m
20453,2,dabi,2823,0,1,5,6,16.7%,17m
20453,3,Abandon,2823,0,0,1,1,0.0%,32m
20453,2,Weldon,2823,0,0,1,1,0.0%,2h
20453,3,Scarface,2823,0,0,2,2,0.0%,8m
20485,1,SlayerBbahr,2822,1472,325,319,644,50.5%,44m
20485,1,[N2F]MARIO,2822,1561,159,153,312,51.0%,34m
20485,2,[MexTec]FLXROGO,2822,936,109,90,199,54.8%,27m
20485,3,Axelot,2822,957,43,27,70,61.4%,45m
20485,2,[TitEs]Breazeale,2822,738,25,30,55,45.5%,24m
20485,3,Walleye,2822,417,20,17,37,54.1%,7m
20485,2,wingwanglo,2822,417,17,16,33,51.5%,29m
20485,2,Kratel,2822,374,12,21,33,36.4%,14m
20485,2,TomTom,2822,278,9,14,23,39.1%,47m
20485,2,Apothecera,2822,228,8,16,24,33.3%,35m
20485,3,[CUKES]Reaver,2822,184,7,6,13,53.8%,5m
20485,2,[USWAG]iLBraenz,2822,214,7,8,15,46.7%,47m
20485,3,TIOOO,2822,120,5,4,9,55.6%,33m
20485,3,BUnzaga,2822,0,4,1,5,80.0%,23m
20485,2,[CLAM]somar,2822,58,4,5,9,44.4%,6m
20485,3,StuKov,2822,114,4,5,9,44.4%,12m
20485,2,dlpjdlpj,2822,0,3,2,5,60.0%,2h
20485,3,[AiMB]RaTe,2822,58,3,2,5,60.0%,34m
20485,2,FacePuff,2822,0,3,2,5,60.0%,23m
20485,2,DeMoNzZ,2822,46,3,3,6,50.0%,40m
20485,2,crazybear,2822,60,3,7,10,30.0%,24m
20485,3,Hyunookie,2822,0,2,3,5,40.0%,26m
20485,2,Pitufo,2822,0,1,0,1,100.0%,2h
20485,3,[MEEE]Junior,2822,0,1,0,1,100.0%,23m
20485,3,[ITEM9]Narcosis,2822,0,1,1,2,50.0%,12m
20485,3,lother,2822,30,1,1,2,50.0%,33m
20485,3,[Wee]LilProbe,2822,30,1,2,3,33.3%,30m
20485,3,bonrgoo,2822,30,1,3,4,25.0%,9m
20485,3,Guido,2822,30,1,5,6,16.7%,23m
20485,3,chipmonklord,2822,0,0,1,1,0.0%,1h
20485,3,[SFN]DOHCDragon,2822,0,0,1,1,0.0%,30m
20485,3,[CHEF]Tassadar,2822,0,0,1,1,0.0%,23m
20485,3,Mithrandir,2822,0,0,1,1,0.0%,9m
20485,3,ElWeirdo,2822,0,0,1,1,0.0%,12m
20485,3,[jacasb]VELKAN,2822,0,0,1,1,0.0%,35m
20520,3,[CLord]VilugArZa,2821,1583,222,197,419,53.0%,31m
20520,3,Fritzmeister,2821,998,85,68,153,55.6%,6m
20520,3,JimHalpert,2821,388,50,22,72,69.4%,44m
20520,3,[1for2]Billgates,2821,1010,45,33,78,57.7%,19m
20520,3,Trovao,2821,430,17,13,30,56.7%,3m
20520,1,Solrac,2821,401,16,18,34,47.1%,22m
20520,3,ReTuNe,2821,197,14,16,30,46.7%,22m
20520,3,jizzlips,2821,208,11,6,17,64.7%,14m
20520,3,VcSProphet,2821,330,11,14,25,44.0%,14m
20520,2,vinniboi,2821,245,10,8,18,55.6%,12m
20520,2,AnimeBoy,2821,298,10,10,20,50.0%,12m
20520,3,nbadrektul,2821,238,10,11,21,47.6%,5m
20520,1,[Lchro]AgPlata,2821,322,10,21,31,32.3%,22m
20520,3,[Sqnch]Slaz,2821,240,9,9,18,50.0%,43m
20520,1,Stickman,2821,167,7,3,10,70.0%,2h
20520,2,[KiMBR]NabucAo,2821,214,7,8,15,46.7%,19m
20520,3,[500CC]Guitha,2821,182,5,2,7,71.4%,14m
20520,2,ProudDad,2821,48,4,3,7,57.1%,2h
20520,2,harvey,2821,88,4,5,9,44.4%,5m
20520,3,mar,2821,60,3,2,5,60.0%,11m
20520,3,[CRAKS]LaGaRTo,2821,30,2,3,5,40.0%,14m
20520,3,thestoic,2821,0,1,1,2,50.0%,3m
20520,3,kalli,2821,30,1,3,4,25.0%,21m
20520,2,dirtslayer,2821,0,0,1,1,0.0%,38m
20520,3,[DRKPMT]Kollin,2821,0,0,2,2,0.0%,8m
20520,3,wendyskitty,2821,0,0,2,2,0.0%,15m
20520,3,Thunder,2821,0,0,4,4,0.0%,2h
20520,3,[Rasen1]Rayven,2821,0,0,4,4,0.0%,10m
20548,2,[tCo9]DreamyBudder,2820,1556,447,430,877,51.0%,14m
20548,2,fArtanis,2820,1169,102,99,201,50.7%,6m
20548,3,Nitrous,2820,1549,85,72,157,54.1%,31m
20548,1,Theokiedoke,2820,818,66,71,137,48.2%,34m
20548,3,Kelric,2820,429,25,20,45,55.6%,45m
20548,3,PwAhN,2820,477,20,18,38,52.6%,31m
20548,3,Funkypants,2820,342,18,5,23,78.3%,30m
20548,2,BlueDragon,2820,95,14,16,30,46.7%,12m
20548,2,[DubDom]LithicLeafy,2820,274,13,19,32,40.6%,30m
20548,3,Jashin,2820,223,8,4,12,66.7%,17m
20548,3,CURTOPALISS,2820,227,7,2,9,77.8%,12m
20548,3,NexusKing,2820,208,7,3,10,70.0%,46m
20548,2,NightSky,2820,184,7,11,18,38.9%,17m
20548,2,briarwoods,2820,86,6,6,12,50.0%,8m
20548,2,TheMagician,2820,94,6,6,12,50.0%,24m
20548,2,Zzat,2820,121,5,6,11,45.5%,24m
20548,2,[CUUMX]Masterblade,2820,192,5,9,14,35.7%,27m
20548,3,Bloodychaos,2820,86,4,2,6,66.7%,34m
20548,3,Meep,2820,120,4,5,9,44.4%,9m
20548,2,MrE,2820,0,3,2,5,60.0%,2h
20548,2,MahMahMalibu,2820,0,3,2,5,60.0%,2h
20548,3,abe,2820,60,2,2,4,50.0%,12m
20548,2,aguabuffalo,2820,102,2,6,8,25.0%,12m
20548,1,[BVR]cuts,2820,0,1,0,1,100.0%,13m
20548,3,persidann,2820,0,1,0,1,100.0%,29m
20548,3,ShowTc,2820,0,1,1,2,50.0%,37m
20548,3,[TCAZN]Doraken,2820,0,1,1,2,50.0%,10m
20548,2,Traumatize,2820,48,1,1,2,50.0%,2h
20548,3,zdyx,2820,30,1,2,3,33.3%,10m
20548,2,[Kray]FleX,2820,0,0,5,5,0.0%,23m
20578,3,KayNow,2819,1486,284,259,543,52.3%,17m
20578,3,Clayton,2819,1429,135,112,247,54.7%,14m
20578,3,FRASZ,2819,1602,126,119,245,51.4%,9m
20578,2,bobnelson,2819,1523,67,73,140,47.9%,16m
20578,2,SSdank,2819,901,51,45,96,53.1%,19m
20578,3,[LOHs]ErwOfHedeby,2819,661,29,19,48,60.4%,26m
20578,3,biiiiiiird,2819,549,26,9,35,74.3%,23m
20578,2,Revanite,2819,601,26,14,40,65.0%,44m
20578,3,[Pyl0nZ]porkey,2819,565,22,16,38,57.9%,13m
20578,2,Mtb,2819,536,21,26,47,44.7%,3m
20578,2,Joker,2819,526,18,20,38,47.4%,36m
20578,2,[BROZZ]thedudeman,2819,436,17,21,38,44.7%,4m
20578,3,WarsBlkGhs,2819,289,10,7,17,58.8%,45m
20578,2,JaCeR,2819,216,10,7,17,58.8%,37m
20578,2,Chonoon,2819,293,10,8,18,55.6%,14m
20578,3,Ilusion,2819,250,8,2,10,80.0%,43m
20578,3,ezusserver,2819,177,7,7,14,50.0%,46m
20578,3,[Th3Bad]ralphwbms,2819,172,7,8,15,46.7%,40m
20578,2,KNIGHTDOMING,2819,88,6,2,8,75.0%,33m
20578,2,JuanMi,2819,95,5,1,6,83.3%,2h
20578,3,AliaS,2819,86,4,2,6,66.7%,18m
20578,1,RedruM,2819,145,4,5,9,44.4%,1h
20578,3,Neriw,2819,58,3,1,4,75.0%,23m
20578,3,Barn,2819,93,3,3,6,50.0%,31m
20578,3,SpeedySloth,2819,0,2,3,5,40.0%,46m
20578,3,CamachoVaca,2819,0,1,0,1,100.0%,13m
20578,3,PNP,2819,0,1,0,1,100.0%,35m
20578,3,pesy,2819,0,0,1,1,0.0%,5m
20578,3,Ezkill,2819,0,0,1,1,0.0%,11m
20578,3,FredB,2819,0,0,1,1,0.0%,32m
20578,1,WreCkerD,2819,0,0,2,2,0.0%,2h
20578,3,Ivkzy,2819,0,0,2,2,0.0%,9m
20578,3,[UnPhuk]SUBMITANAL,2819,0,0,3,3,0.0%,11m
20611,2,mboyle,2818,1466,119,111,230,51.7%,32m
20611,2,Sildenafil,2818,1585,87,90,177,49.2%,27m
20611,3,[iTE]Jed,2818,454,74,60,134,55.2%,34m
20611,2,rookie,2818,857,61,65,126,48.4%,27m
20611,3,Nutek,2818,492,50,27,77,64.9%,9m
20611,3,[OWLsc2]NightOWL,2818,802,50,38,88,56.8%,21m
20611,3,[Kunz]MElegend,2818,1102,46,41,87,52.9%,20m
20611,3,Magicdoer,2818,354,34,33,67,50.7%,21m
20611,2,[CRA]keter,2818,656,30,28,58,51.7%,24m
20611,3,bzzb,2818,549,29,10,39,74.4%,8m
20611,3,Killjoy,2818,420,17,13,30,56.7%,31m
20611,2,Mykollo,2818,434,15,19,34,44.1%,13m
20611,1,Starfighter,2818,271,15,23,38,39.5%,27m
20611,3,GuruSnot,2818,383,14,10,24,58.3%,9m
20611,3,Latross,2818,257,9,3,12,75.0%,5m
20611,3,Jerry,2818,282,9,8,17,52.9%,1h
20611,3,HUNTER,2818,0,4,1,5,80.0%,12m
20611,1,[eX]saxopanda,2818,97,4,3,7,57.1%,1h
20611,3,Reformed,2818,60,3,2,5,60.0%,44m
20611,1,snare,2818,0,3,3,6,50.0%,39m
20611,2,ShoWTimEFaN,2818,62,3,6,9,33.3%,24m
20611,3,Lance,2818,0,1,0,1,100.0%,29m
20611,3,Azgalor,2818,0,1,0,1,100.0%,15m
20611,2,Appollo,2818,0,1,1,2,50.0%,30m
20611,3,Serral,2818,30,1,2,3,33.3%,30m
20611,3,QuonricO,2818,0,0,1,1,0.0%,4m
20637,2,CGKarnage,2817,1437,176,161,337,52.2%,23m
20637,3,Majaax,2817,1575,108,98,206,52.4%,19m
20637,3,[BmGZ]Wolfgang,2817,1390,78,63,141,55.3%,8m
20637,3,Quovatis,2817,1376,66,55,121,54.5%,45m
20637,3,[GIFT]TempO,2817,1102,47,35,82,57.3%,23m
20637,3,[sk3tch]Jensen,2817,506,28,19,47,59.6%,43m
20637,3,cooX,2817,512,18,14,32,56.2%,43m
20637,2,BunsenHnydew,2817,216,10,6,16,62.5%,20m
20637,3,gemuadrken,2817,30,5,6,11,45.5%,34m
20637,3,[MoAA]MasterOfATK,2817,116,4,4,8,50.0%,12m
20637,1,Borisbritva,2817,0,3,3,6,50.0%,38m
20637,3,wingsofheart,2817,60,3,4,7,42.9%,17m
20637,3,Cienfuegos,2817,30,2,1,3,66.7%,8m
20637,2,jakobi,2817,0,2,3,5,40.0%,2h
20637,3,[VTMUWU]ElGabo,2817,30,1,1,2,50.0%,8m
20637,3,[TPGGXD]AncstralGrNv,2817,30,1,2,3,33.3%,23m
20637,3,cornholio,2817,0,1,2,3,33.3%,12m
20637,2,protoss,2817,0,1,2,3,33.3%,24m
20637,2,Dukxing,2817,0,0,1,1,0.0%,2h
20656,2,Tunamelt,2816,810,132,124,256,51.6%,25m
20656,2,Akroma,2816,1440,87,79,166,52.4%,31m
20656,2,Guigo,2816,859,79,64,143,55.2%,17m
20656,3,Clam,2816,1564,71,43,114,62.3%,28m
20656,3,Batesh,2816,575,56,48,104,53.8%,18m
20656,2,[PUSA]ILoveMariahC,2816,702,34,35,69,49.3%,18m
20656,3,[PiGPan]Draknas,2816,792,29,30,59,49.2%,9m
20656,2,yaplex,2816,588,28,22,50,56.0%,6m
20656,2,[TwiLit]khellendross,2816,438,26,18,44,59.1%,20m
20656,2,Samishine,2816,492,23,21,44,52.3%,6m
20656,2,blurr,2816,382,15,20,35,42.9%,6m
20656,3,July,2816,248,9,6,15,60.0%,16m
20656,3,LingLing,2816,194,8,5,13,61.5%,25m
20656,3,TheMaster,2816,115,7,0,7,100.0%,9m
20656,3,[PsyD]Deeeth,2816,203,7,1,8,87.5%,21m
20656,3,BillyJohnson,2816,172,7,5,12,58.3%,20m
20656,3,Firebirds,2816,196,7,7,14,50.0%,9m
20656,2,Bigboss,2816,204,7,13,20,35.0%,21m
20656,2,HiddenAgenda,2816,180,7,14,21,33.3%,32m
20656,1,Eaugh,2816,121,6,3,9,66.7%,9m
20656,2,[NLTN]lazvar,2816,182,6,10,16,37.5%,21m
20656,2,[YD2K]Ark,2816,177,5,8,13,38.5%,1h
20656,3,TheLordNukem,2816,152,5,9,14,35.7%,19m
20656,2,EUREKA,2816,86,4,9,13,30.8%,15m
20656,3,Noobling,2816,60,3,1,4,75.0%,34m
20656,1,Mbutcher,2816,0,3,4,7,42.9%,33m
20656,1,Kuzurii,2816,0,3,5,8,37.5%,32m
20656,3,Saffa,2816,20,2,2,4,50.0%,22m
20656,1,Darkblade,2816,145,2,3,5,40.0%,2h
20656,3,Lehzee,2816,0,2,3,5,40.0%,32m
20656,3,xBrAvExLuv,2816,0,1,0,1,100.0%,25m
20656,3,Aion,2816,0,1,0,1,100.0%,27m
20656,3,icantwin,2816,0,1,0,1,100.0%,6m
20656,3,[Schwar]Artem,2816,0,1,0,1,100.0%,18m
20656,2,MaoShiSi,2816,0,1,0,1,100.0%,1h
20656,3,tazzzy,2816,30,1,1,2,50.0%,43m
20656,3,kungpowjeff,2816,30,1,1,2,50.0%,17m
20656,1,[Goof]Odin,2816,97,1,2,3,33.3%,37m
20656,3,[lmbaF]Agustín,2816,0,0,1,1,0.0%,4m
20656,3,[TEQ]Almightysoul,2816,0,0,1,1,0.0%,31m
20656,3,Fiddlefiend,2816,0,0,3,3,0.0%,21m
20656,2,Ragnarok,2816,0,0,6,6,0.0%,24m
20698,1,TANGO,2815,1608,293,291,584,50.2%,15m
20698,2,Hyperion,2815,1203,143,132,275,52.0%,45m
20698,1,[UxL]Flash,2815,1584,140,125,265,52.8%,7m
20698,3,Monkey,2815,1100,89,75,164,54.3%,5m
20698,3,GalaxySea,2815,558,66,64,130,50.8%,8m
20698,2,cimplex,2815,990,53,40,93,57.0%,24m
20698,3,FuzzyGiraffe,2815,226,27,20,47,57.4%,28m
20698,3,Jonerys,2815,692,27,22,49,55.1%,7m
20698,1,itzahael,2815,672,25,28,53,47.2%,7m
20698,2,Ilúvatar,2815,403,17,15,32,53.1%,25m
20698,1,Spacegoatse,2815,333,14,16,30,46.7%,29m
20698,3,Spleer,2815,309,12,9,21,57.1%,3m
20698,2,BondJimBond,2815,302,12,10,22,54.5%,45m
20698,3,IsThisReal,2815,230,9,7,16,56.2%,44m
20698,3,CheeseLovers,2815,237,7,2,9,77.8%,2h
20698,1,HalfAsleep,2815,168,7,4,11,63.6%,45m
20698,3,abrA,2815,212,7,11,18,38.9%,22m
20698,3,XxPerverzoxX,2815,162,6,7,13,46.2%,28m
20698,3,Hazel,2815,114,5,3,8,62.5%,18m
20698,1,SadBeans,2815,48,4,4,8,50.0%,29m
20698,1,HydricAcid,2815,30,4,6,10,40.0%,21m
20698,3,[TMSyN]Zirou,2815,58,3,0,3,100.0%,45m
20698,3,[HGL]IMMvp,2815,117,2,3,5,40.0%,9m
20698,2,eYang,2815,0,2,3,5,40.0%,42m
20698,3,[ACDBRz]Alex,2815,58,2,4,6,33.3%,27m
20698,2,[WNTRCH]JoeLeBrown,2815,81,2,6,8,25.0%,12m
20698,1,FizzyElf,2815,0,1,0,1,100.0%,2h
20698,3,[XZL]leon,2815,0,1,0,1,100.0%,30m
20698,3,Hesh,2815,30,1,2,3,33.3%,22m
20698,1,[Dac]elPadrino,2815,96,1,2,3,33.3%,2h
20698,3,Ghost,2815,0,0,1,1,0.0%,18m
20698,3,shadow,2815,0,0,1,1,0.0%,4m
20698,3,mightymouse,2815,0,0,1,1,0.0%,27m
20698,2,[DTE]Camulas,2815,0,0,7,7,0.0%,18m
20732,2,Atof,2814,1291,268,252,520,51.5%,20m
20732,2,skullcrisis,2814,1504,186,183,369,50.4%,22m
20732,3,[UpxV]PapaDopulos,2814,1042,58,40,98,59.2%,19m
20732,3,LION,2814,707,50,38,88,56.8%,11m
20732,2,Qrsmith,2814,373,47,47,94,50.0%,13m
20732,3,Thulohot,2814,796,40,29,69,58.0%,20m
20732,3,PompousDingo,2814,899,38,32,70,54.3%,22m
20732,3,Probelims,2814,650,29,15,44,65.9%,14m
20732,3,[GDSC]Clyde,2814,675,26,21,47,55.3%,10m
20732,2,BlazeBrain,2814,488,24,21,45,53.3%,44m
20732,2,DestrucSean,2814,550,24,25,49,49.0%,47m
20732,3,[JACPAR]KittyRoy,2814,593,23,16,39,59.0%,46m
20732,1,noba,2814,585,22,26,48,45.8%,9m
20732,2,[77over]ROMANO,2814,570,20,26,46,43.5%,46m
20732,2,Xiao,2814,236,9,2,11,81.8%,3h
20732,3,BandNerd,2814,263,9,7,16,56.2%,1h
20732,2,zuse,2814,252,9,17,26,34.6%,26m
20732,3,blackychan,2814,216,8,7,15,53.3%,26m
20732,1,Luludoobee,2814,141,8,7,15,53.3%,9m
20732,3,[AmaSua]Stefano,2814,199,7,1,8,87.5%,10m
20732,3,[TMKOs]rushya,2814,160,7,4,11,63.6%,20m
20732,3,[ValidG]Creature,2814,58,3,0,3,100.0%,34m
20732,3,Ruzzo,2814,58,2,1,3,66.7%,44m
20732,3,Bayard,2814,0,1,0,1,100.0%,8m
20732,3,TRUMP,2814,0,1,1,2,50.0%,24m
20732,3,Maximus,2814,92,1,1,2,50.0%,14m
20732,3,[HSiYA]Eraa,2814,30,1,1,2,50.0%,3h
20732,3,Kryoschdr,2814,30,1,3,4,25.0%,32m
20732,2,worthoponent,2814,0,0,1,1,0.0%,42m
20732,3,Cerix,2814,0,0,2,2,0.0%,34m
20762,3,[vNAM]picklez,2813,1630,77,64,141,54.6%,12m
20762,3,Maverick,2813,1520,66,52,118,55.9%,22m
20762,3,mew,2813,595,51,39,90,56.7%,35m
20762,2,CmrdFish,2813,1020,41,43,84,48.8%,12m
20762,2,[BPunch]plusmental,2813,515,22,26,48,45.8%,8m
20762,3,BrettFavre,2813,597,21,17,38,55.3%,34m
20762,3,Yanthekicker,2813,443,17,15,32,53.1%,31m
20762,3,DatuPuti,2813,351,14,6,20,70.0%,28m
20762,3,Psilocybin,2813,400,14,14,28,50.0%,9m
20762,2,[PJCWNT]Fred,2813,434,14,18,32,43.8%,24m
20762,3,[GGMESP]NERISEND,2813,316,11,12,23,47.8%,9m
20762,2,Terentius,2813,195,8,12,20,40.0%,21m
20762,3,Twona,2813,112,7,0,7,100.0%,9m
20762,3,Miloko,2813,30,5,2,7,71.4%,33m
20762,1,Killmexica,2813,36,5,5,10,50.0%,45m
20762,1,[Lp]CtmVieneAndi,2813,167,5,5,10,50.0%,2h
20762,2,memory,2813,30,4,4,8,50.0%,30m
20762,3,[SV]Favorecido,2813,90,3,3,6,50.0%,12m
20762,3,Killercam,2813,92,3,3,6,50.0%,32m
20762,3,[WNTRLH]Delnoir,2813,30,2,0,2,100.0%,21m
20762,3,[FFAA]MxMauricio,2813,0,1,0,1,100.0%,44m
20762,3,[RacAtk]woof,2813,0,1,1,2,50.0%,4m
20762,2,[Craftr]JMan,2813,0,1,1,2,50.0%,19m
20762,1,Creature,2813,97,1,1,2,50.0%,31m
20762,2,NoVaFoRcE,2813,0,1,3,4,25.0%,32m
20762,3,monsoone,2813,30,1,5,6,16.7%,27m
20762,3,MacroJorda,2813,0,0,1,1,0.0%,10m
20762,3,Tylerzing,2813,0,0,1,1,0.0%,9m
20762,3,[HØST]gustavolokko,2813,0,0,1,1,0.0%,46m
20762,3,ADCool,2813,0,0,1,1,0.0%,43m
20762,3,oiuytu,2813,0,0,2,2,0.0%,12m
20793,2,TheMedic,2812,1438,301,268,569,52.9%,7m
20793,2,LuisBarzola,2812,975,102,96,198,51.5%,32m
20793,3,ForThebugs,2812,1424,85,61,146,58.2%,47m
20793,3,FDen,2812,977,80,73,153,52.3%,26m
20793,2,MacDaddy,2812,1583,76,70,146,52.1%,33m
20793,3,[Kodos]OttO,2812,1038,71,56,127,55.9%,33m
20793,2,DGr,2812,1283,55,55,110,50.0%,3m
20793,2,Thrascall,2812,835,37,33,70,52.9%,28m
20793,2,LTH,2812,497,17,22,39,43.6%,25m
20793,2,CodeAka,2812,322,15,10,25,60.0%,25m
20793,2,TheBanshee,2812,381,15,14,29,51.7%,29m
20793,3,Snaw,2812,382,13,10,23,56.5%,8m
20793,3,gooselinG,2812,229,8,10,18,44.4%,14m
20793,1,[FlTM]CasperTienS,2812,215,6,6,12,50.0%,16m
20793,3,elusuario,2812,146,5,7,12,41.7%,14m
20793,1,Zodiac,2812,145,4,4,8,50.0%,2h
20793,3,Pims,2812,136,3,2,5,60.0%,19m
20793,3,Dsmjak,2812,60,3,2,5,60.0%,26m
20793,3,[ChiFan]MindSpiritG,2812,58,2,1,3,66.7%,8m
20793,3,SEQUEL,2812,58,2,2,4,50.0%,14m
20793,3,BattleOX,2812,30,2,2,4,50.0%,17m
20793,2,BioH,2812,0,2,3,5,40.0%,2h
20793,3,Thechef,2812,30,2,3,5,40.0%,10m
20793,2,NoMaskNoRona,2812,0,2,5,7,28.6%,6m
20793,2,Karizma,2812,112,2,8,10,20.0%,18m
20793,3,[FkRFgt]SonGokuYolo,2812,30,1,2,3,33.3%,19m
20793,2,Taube,2812,30,1,6,7,14.3%,20m
20793,2,Alfoelsky,2812,0,0,4,4,0.0%,37m
20821,2,Blackbird,2811,1559,392,376,768,51.0%,27m
20821,2,Blackstone,2811,933,133,135,268,49.6%,13m
20821,1,[T4gzus]BAMnicka,2811,1403,110,106,216,50.9%,26m
20821,2,SHICE,2811,1514,97,98,195,49.7%,32m
20821,3,[LGNxx]macdwest,2811,919,60,63,123,48.8%,12m
20821,2,Rajinazn,2811,916,60,65,125,48.0%,21m
20821,3,BenVinc,2811,803,35,23,58,60.3%,23m
20821,2,gpsugy,2811,766,28,29,57,49.1%,14m
20821,2,ispirit,2811,630,24,25,49,49.0%,26m
20821,2,[WTTA]LeoSC,2811,577,23,26,49,46.9%,18m
20821,2,[SABO]ORAGNA,2811,440,17,16,33,51.5%,30m
20821,3,[iGae]Pharm,2811,339,14,4,18,77.8%,30m
20821,3,KATARI,2811,324,14,13,27,51.9%,33m
20821,3,[BOR8iz]ojinchung,2811,338,13,15,28,46.4%,34m
20821,1,defaspect,2811,444,13,25,38,34.2%,47m
20821,2,[EOKA]Spartacus,2811,328,12,16,28,42.9%,32m
20821,3,[SHLA]PartinG,2811,225,8,2,10,80.0%,28m
20821,2,Yevoc,2811,116,7,6,13,53.8%,7m
20821,3,MoneyGame,2811,88,7,9,16,43.8%,4m
20821,3,[TaPX]EqUiLlIbRiUm,2811,0,4,1,5,80.0%,9m
20821,3,bloob,2811,60,3,2,5,60.0%,11m
20821,3,Bracho,2811,88,3,3,6,50.0%,5m
20821,1,[DMONlC]DEMONIC,2811,48,2,1,3,66.7%,3h
20821,3,Aelin,2811,30,2,2,4,50.0%,25m
20821,2,babyboi,2811,116,2,6,8,25.0%,27m
20821,3,Zericc,2811,0,1,0,1,100.0%,44m
20821,3,Shadow,2811,0,1,0,1,100.0%,33m
20821,2,FirstToFire,2811,0,1,0,1,100.0%,2h
20821,3,Death,2811,30,1,2,3,33.3%,20m
20821,3,Curupira,2811,30,1,2,3,33.3%,31m
20821,3,InManEx,2811,30,1,3,4,25.0%,15m
20821,3,[OOMOHM]pphunk,2811,30,1,4,5,20.0%,35m
20821,2,Tom,2811,0,0,1,1,0.0%,2h
20821,1,SunCorax,2811,0,0,1,1,0.0%,22m
20821,2,ALLAHGOLD,2811,0,0,5,5,0.0%,3m
20856,1,[BzT]NeoDeltaBrun,2810,676,244,230,474,51.5%,34m
20856,1,phatpharm,2810,1594,232,239,471,49.3%,33m
20856,2,ZEALOP,2810,1499,176,171,347,50.7%,43m
20856,2,ImHere,2810,1498,164,155,319,51.4%,27m
20856,2,xblitzx,2810,1423,65,68,133,48.9%,9m
20856,3,[Meek]MotherGoose,2810,1333,55,53,108,50.9%,21m
20856,2,[AbcCo]JhonnySas,2810,829,51,55,106,48.1%,36m
20856,3,Death,2810,394,44,46,90,48.9%,6m
20856,2,Drew,2810,695,33,33,66,50.0%,8m
20856,3,[AD3C]Shaser,2810,625,24,16,40,60.0%,26m
20856,3,QuBuS,2810,445,22,6,28,78.6%,35m
20856,2,Zeregtor,2810,420,18,12,30,60.0%,31m
20856,3,Plaiides,2810,241,15,15,30,50.0%,43m
20856,3,Psuedo,2810,320,12,12,24,50.0%,36m
20856,3,Warren,2810,254,11,7,18,61.1%,9m
20856,3,Gomiles,2810,229,8,3,11,72.7%,9m
20856,1,[xBFMx]CheckURsix,2810,198,7,16,23,30.4%,24m
20856,2,PandaInc,2810,212,7,18,25,28.0%,14m
20856,3,jimraynor,2810,142,5,5,10,50.0%,16m
20856,3,[1PA]PWNerOfSouls,2810,58,3,0,3,100.0%,35m
20856,3,HERO,2810,0,3,2,5,60.0%,16m
20856,1,Serosy,2810,0,3,3,6,50.0%,9m
20856,3,[RIVENS]Reclaimed,2810,0,1,0,1,100.0%,22m
20856,3,Hustle,2810,97,1,2,3,33.3%,40m
20856,2,ComAkbar,2810,0,1,4,5,20.0%,40m
20856,2,avoca,2810,0,1,5,6,16.7%,14m
20856,3,Deivid,2810,0,0,1,1,0.0%,12m
20883,2,[FFAA]Kira,2809,1584,362,350,712,50.8%,24m
20883,3,[cl0udM]Asone,2809,1616,236,234,470,50.2%,43m
20883,2,Anpaul,2809,1059,133,111,244,54.5%,36m
20883,2,RoDriX,2809,1094,115,92,207,55.6%,24m
20883,2,[LZCHEE]Shaun,2809,555,82,72,154,53.2%,16m
20883,2,DarkLight,2809,985,71,57,128,55.5%,28m
20883,3,mrmedix,2809,824,32,30,62,51.6%,8m
20883,2,Systematik,2809,743,29,30,59,49.2%,26m
20883,3,[Piiom]TioAantion,2809,494,25,4,29,86.2%,22m
20883,3,[TAWP69]GaryJohnston,2809,586,25,17,42,59.5%,27m
20883,3,[SSBic]Kirasteel,2809,649,25,19,44,56.8%,22m
20883,3,[TeaTym]OpticSeagull,2809,550,21,19,40,52.5%,34m
20883,3,kayne,2809,403,17,16,33,51.5%,31m
20883,3,Nikky,2809,188,8,0,8,100.0%,30m
20883,3,VERNER,2809,181,8,4,12,66.7%,25m
20883,3,Smokey,2809,178,7,10,17,41.2%,47m
20883,3,[LHA]AGERA,2809,176,6,6,12,50.0%,22m
20883,3,KLLQKZD,2809,93,5,1,6,83.3%,47m
20883,3,[GnR]Hatchery,2809,194,5,3,8,62.5%,43m
20883,2,terranmaster,2809,124,5,8,13,38.5%,17m
20883,3,Aerilithiel,2809,86,4,2,6,66.7%,47m
20883,3,Valkyrie,2809,86,3,3,6,50.0%,44m
20883,2,[Dikbub]Orbital,2809,58,3,4,7,42.9%,31m
20883,2,[ØFoxF2]DohKo,2809,109,3,5,8,37.5%,2h
20883,2,dime,2809,84,3,6,9,33.3%,24m
20883,2,[2City]Tarakin,2809,130,3,7,10,30.0%,43m
20883,3,TheKaiserZD,2809,18,2,2,4,50.0%,15m
20883,3,Hellscythe,2809,0,1,0,1,100.0%,11m
20883,2,Crackerjacks,2809,0,1,0,1,100.0%,2h
20883,2,Kush,2809,0,1,7,8,12.5%,13m
20883,3,[nietos]KingQuetz,2809,0,0,3,3,0.0%,13m
20883,3,Isaac,2809,0,0,3,3,0.0%,4m
20883,2,Mrkill,2809,0,0,5,5,0.0%,46m
20883,2,CorporalSky,2809,0,0,7,7,0.0%,5m
20917,3,MastaKilla,2808,923,89,68,157,56.7%,45m
20917,2,Ellusion,2808,1492,88,81,169,52.1%,20m
20917,2,[UpxV]GLECTRIC,2808,1577,79,82,161,49.1%,20m
20917,3,[No0Bs]ProKaoS,2808,1338,50,56,106,47.2%,5m
20917,3,Biceps,2808,707,30,25,55,54.5%,31m
20917,3,JonhSunday,2808,366,26,24,50,52.0%,30m
20917,2,IIIIIIIIIIII,2808,646,25,25,50,50.0%,20m
20917,3,Interceptor,2808,516,19,12,31,61.3%,46m
20917,3,[IMDSI]Arkoboz,2808,407,18,5,23,78.3%,33m
20917,2,Gravidi,2808,242,9,11,20,45.0%,2h
20917,3,LoviufNA,2808,160,6,5,11,54.5%,3m
20917,3,Silverthorn,2808,166,6,6,12,50.0%,37m
20917,3,MataMuta,2808,93,3,3,6,50.0%,35m
20917,3,TheBraxis,2808,31,3,4,7,42.9%,25m
20917,3,SlappyFarts,2808,92,3,6,9,33.3%,10m
20917,3,[H0wMad]Robinct,2808,30,1,1,2,50.0%,29m
20917,3,[TRVMPD]skinnyM,2808,0,0,1,1,0.0%,9m
20917,3,[xCULTx]ClownAss,2808,0,0,2,2,0.0%,12m
20917,3,krnnoobie,2808,0,0,3,3,0.0%,5m
20936,2,BARCODE,2807,1590,208,217,425,48.9%,24m
20936,2,JTheSparrow,2807,1117,64,59,123,52.0%,31m
20936,3,Nikku,2807,639,51,42,93,54.8%,37m
20936,3,[ILK]JOSHUACFARlA,2807,918,42,22,64,65.6%,16m
20936,3,FXmarc,2807,595,27,15,42,64.3%,14m
20936,2,PopPop,2807,662,26,27,53,49.1%,28m
20936,3,ICE,2807,196,18,13,31,58.1%,27m
20936,2,Gorillaforce,2807,245,16,19,35,45.7%,29m
20936,2,[QA]Frost,2807,352,12,13,25,48.0%,27m
20936,1,[ThDead]SoNdrKoMaNdO,2807,239,7,6,13,53.8%,18m
20936,3,WizardBear,2807,129,5,8,13,38.5%,44m
20936,3,Savage,2807,166,4,2,6,66.7%,17m
20936,1,Toothless,2807,142,4,19,23,17.4%,13m
20936,1,[Snarty]SnartHero,2807,105,3,0,3,100.0%,1h
20936,3,[MRHAND]GreenTea,2807,119,2,3,5,40.0%,30m
20936,3,SillaVegana,2807,0,2,3,5,40.0%,24m
20936,3,[tlwby]damianffg,2807,30,1,1,2,50.0%,46m
20936,3,[YZY]PerfecTiming,2807,0,1,1,2,50.0%,30m
20936,3,[YAFM]jayjaytee,2807,0,0,1,1,0.0%,9m
20936,3,[XXYZ]Izzule,2807,0,0,1,1,0.0%,28m
20936,3,StaticVoid,2807,0,0,1,1,0.0%,2h
20957,1,Madrock,2806,1610,339,308,647,52.4%,18m
20957,2,Tyeru,2806,1619,322,296,618,52.1%,37m
20957,3,choasong,2806,1392,137,126,263,52.1%,28m
20957,2,Fixxxer,2806,1525,125,117,242,51.7%,8m
20957,3,[AbcCo]Loko,2806,1548,92,88,180,51.1%,27m
20957,3,rasec,2806,1604,70,60,130,53.8%,44m
20957,3,poiv,2806,981,64,53,117,54.7%,36m
20957,3,lonepine,2806,905,63,43,106,59.4%,44m
20957,2,WorraLL,2806,1396,57,60,117,48.7%,46m
20957,3,[steel]Aion,2806,430,35,27,62,56.5%,5m
20957,3,Manic,2806,823,35,32,67,52.2%,34m
20957,3,SerQwaez,2806,768,32,29,61,52.5%,8m
20957,2,TiPtOP,2806,818,30,30,60,50.0%,31m
20957,3,BuffTerranPl,2806,631,26,17,43,60.5%,32m
20957,3,INNOVA,2806,635,24,19,43,55.8%,9m
20957,3,Racoon,2806,579,23,16,39,59.0%,46m
20957,3,Elsergii,2806,284,10,6,16,62.5%,25m
20957,3,Mak,2806,243,10,7,17,58.8%,28m
20957,3,Diegox,2806,159,10,7,17,58.8%,43m
20957,2,Asharon,2806,182,10,14,24,41.7%,25m
20957,2,zealk,2806,142,6,8,14,42.9%,10m
20957,3,Superkewl,2806,0,5,3,8,62.5%,28m
20957,3,Akwaman,2806,120,5,3,8,62.5%,20m
20957,2,nickyfett,2806,180,5,10,15,33.3%,29m
20957,2,stanly,2806,139,4,4,8,50.0%,24m
20957,3,Blizen,2806,30,2,0,2,100.0%,29m
20957,2,King,2806,62,2,7,9,22.2%,12m
20957,3,Kris,2806,0,1,1,2,50.0%,9m
20957,3,LAUNDRY,2806,30,1,4,5,20.0%,16m
20957,3,DavidSSure,2806,30,1,5,6,16.7%,43m
20957,2,[HD7K]SkueruolJ,2806,0,0,1,1,0.0%,1h
20957,3,aaa,2806,0,0,2,2,0.0%,13m
20957,2,Ruiya,2806,0,0,3,3,0.0%,2h
20957,3,Suyeon,2806,0,0,18,18,0.0%,34m
20991,1,DVNintervent,2805,1574,156,152,308,50.6%,21m
20991,3,thegaijin,2805,1201,68,61,129,52.7%,23m
20991,2,MaiPai,2805,1214,53,51,104,51.0%,32m
20991,3,Wolf,2805,1209,51,46,97,52.6%,33m
20991,3,[Scro]ValleyForge,2805,574,47,28,75,62.7%,12m
20991,2,anglerFish,2805,690,27,24,51,52.9%,36m
20991,3,blight,2805,497,24,10,34,70.6%,10m
20991,3,Marcus,2805,550,23,13,36,63.9%,27m
20991,3,RomanticHero,2805,369,19,17,36,52.8%,36m
20991,2,Manson,2805,298,18,24,42,42.9%,11m
20991,3,qimufev,2805,407,17,13,30,56.7%,47m
20991,2,Matador,2805,444,16,16,32,50.0%,3m
20991,3,GGAllin,2805,359,14,7,21,66.7%,10m
20991,3,[AngryB]Relapse,2805,370,14,7,21,66.7%,36m
20991,3,Daelus,2805,353,14,10,24,58.3%,8m
20991,3,ScvLivesMttr,2805,264,11,7,18,61.1%,26m
20991,1,[1FC]chrygore,2805,122,5,5,10,50.0%,44m
20991,2,Nilbog,2805,124,3,1,4,75.0%,2h
20991,2,[HAPE]IkarusAlpha,2805,145,3,5,8,37.5%,27m
20991,3,Butters,2805,109,2,1,3,66.7%,22m
20991,3,[XFL]Meccaz,2805,30,2,4,6,33.3%,24m
20991,3,MOMMH,2805,0,1,0,1,100.0%,16m
20991,3,BLUEDEMON,2805,0,1,3,4,25.0%,26m
20991,2,ThisIsJimmy,2805,0,0,1,1,0.0%,2h
20991,3,[LAMMS]Lammy,2805,0,0,1,1,0.0%,3m
21016,2,[XpKAc]superikardo,2804,1505,170,160,330,51.5%,47m
21016,2,MATADOR,2804,1575,157,150,307,51.1%,8m
21016,2,OoTsBoyoO,2804,1488,56,57,113,49.6%,12m
21016,2,Bepulse,2804,620,28,24,52,53.8%,8m
21016,3,[SIClan]bushido,2804,730,27,24,51,52.9%,6m
21016,3,GusPer,2804,439,25,16,41,61.0%,29m
21016,3,MercYD,2804,480,21,15,36,58.3%,6m
21016,3,TensaiBoy,2804,228,16,16,32,50.0%,27m
21016,1,WarmSausage,2804,542,16,29,45,35.6%,9m
21016,3,[UZD4S]Nudge,2804,276,13,13,26,50.0%,8m
21016,2,PeaTree,2804,368,12,21,33,36.4%,44m
21016,3,[ODR626]HoJayTee,2804,236,8,8,16,50.0%,11m
21016,3,[AIN]jaimenak,2804,266,8,9,17,47.1%,22m
21016,3,[ExcIgN]Mateo,2804,104,4,5,9,44.4%,31m
21016,3,Opal,2804,93,3,0,3,100.0%,31m
21016,1,[guud]Tigos,2804,192,3,4,7,42.9%,2h
21016,3,[imN0ob]LgdOscurO,2804,58,2,1,3,66.7%,30m
21016,3,Next,2804,30,2,4,6,33.3%,30m
21016,2,[heXnab]Avion,2804,30,2,4,6,33.3%,46m
21016,1,Falmeer,2804,0,1,2,3,33.3%,1h
21016,3,[WNTR]Perfect,2804,0,0,1,1,0.0%,47m
21016,3,Collectibles,2804,0,0,1,1,0.0%,30m
21016,3,AmarisRed,2804,0,0,2,2,0.0%,9m
21016,3,[UpxV]escaver,2804,0,0,2,2,0.0%,28m
21040,2,chris,2803,1562,221,209,430,51.4%,47m
21040,1,cire,2803,1519,79,92,171,46.2%,11m
21040,2,Kent,2803,1555,67,62,129,51.9%,19m
21040,3,stams,2803,785,65,62,127,51.2%,27m
21040,2,[BUKÉ]Zepol,2803,1101,52,47,99,52.5%,36m
21040,3,[PTHero]HyperTurtle,2803,682,25,21,46,54.3%,25m
21040,3,NiNJa,2803,564,24,17,41,58.5%,26m
21040,2,noflo,2803,655,24,26,50,48.0%,32m
21040,3,IIIIIIIIIIII,2803,440,23,15,38,60.5%,16m
21040,3,Bountie,2803,588,23,21,44,52.3%,45m
21040,3,Belzedar,2803,577,22,20,42,52.4%,35m
21040,1,suavacado,2803,273,22,26,48,45.8%,23m
21040,3,[NTrio]Zandel,2803,451,20,7,27,74.1%,44m
21040,2,Chainmail,2803,510,20,22,42,47.6%,44m
21040,2,Almuliman,2803,414,19,18,37,51.4%,9m
21040,2,MaZWaRrIoR,2803,488,17,15,32,53.1%,33m
21040,3,Telano,2803,473,16,14,30,53.3%,25m
21040,3,wildfighter,2803,360,14,11,25,56.0%,33m
21040,3,Carlos,2803,364,13,15,28,46.4%,26m
21040,2,Demosthenes,2803,214,11,9,20,55.0%,17m
21040,3,veritaserum,2803,153,9,4,13,69.2%,19m
21040,2,Cállate,2803,258,9,12,21,42.9%,8m
21040,2,Alex,2803,174,7,12,19,36.8%,8m
21040,1,AresSindal,2803,145,5,4,9,55.6%,2h
21040,2,[NEIGER]cheedynasty,2803,150,5,8,13,38.5%,24m
21040,3,ImWuggles,2803,0,4,1,5,80.0%,23m
21040,1,PhalanX,2803,97,4,4,8,50.0%,18m
21040,3,[AlIin]Wizzer,2803,30,2,0,2,100.0%,28m
21040,3,Maniqui,2803,97,2,3,5,40.0%,46m
21040,3,Nicros,2803,0,1,0,1,100.0%,14m
21040,3,EliTON,2803,0,1,0,1,100.0%,29m
21040,3,Frontalier,2803,30,1,1,2,50.0%,29m
21040,2,Andrew,2803,30,1,5,6,16.7%,44m
21040,2,NGSerenity,2803,0,0,1,1,0.0%,2h
21074,3,[EpicG]ctm,2802,1654,178,152,330,53.9%,22m
21074,3,AFK,2802,701,32,17,49,65.3%,13m
21074,1,GacoPL,2802,477,25,28,53,47.2%,21m
21074,3,Whitewash,2802,493,22,17,39,56.4%,33m
21074,3,[USplan]aLi,2802,624,22,24,46,47.8%,12m
21074,3,Andrew,2802,600,21,24,45,46.7%,28m
21074,3,[LdeA]Diethrel,2802,409,17,10,27,63.0%,8m
21074,2,Tyber,2802,309,10,14,24,41.7%,14m
21074,2,AppleMidget,2802,128,6,5,11,54.5%,31m
21074,3,Twohey,2802,120,5,5,10,50.0%,26m
21074,2,Arthasvien,2802,210,5,7,12,41.7%,2h
21074,3,[KhanZ]Dubassi,2802,0,4,1,5,80.0%,33m
21074,3,Ath,2802,25,2,2,4,50.0%,43m
21074,3,[anti5z]Osoman,2802,0,1,0,1,100.0%,29m
21074,3,iluvatár,2802,0,1,0,1,100.0%,12m
21074,3,Thazar,2802,0,1,2,3,33.3%,20m
21074,3,Bulletcradle,2802,0,0,1,1,0.0%,10m
21074,3,SuperJohn,2802,0,0,1,1,0.0%,16m
21074,2,NeCrOsS,2802,0,0,1,1,0.0%,6m
21093,3,Ironman,2801,684,114,112,226,50.4%,27m
21093,2,Xanthor,2801,1131,89,73,162,54.9%,23m
21093,1,ShadowHunter,2801,1402,89,92,181,49.2%,21m
21093,3,[InGt]Bjexpert,2801,1586,81,64,145,55.9%,23m
21093,1,Sicarii,2801,1329,69,83,152,45.4%,29m
21093,3,DarthRevan,2801,780,30,30,60,50.0%,14m
21093,3,strei,2801,658,28,23,51,54.9%,23m
21093,2,AlanarKo,2801,528,28,35,63,44.4%,28m
21093,1,nothavephone,2801,608,23,32,55,41.8%,7m
21093,2,[BttStf]Nishiki,2801,348,16,9,25,64.0%,28m
21093,3,[ELLOCO]Starscream,2801,188,8,5,13,61.5%,28m
21093,3,[Nitho]TheThisTroye,2801,168,7,1,8,87.5%,31m
21093,3,Walk,2801,170,5,2,7,71.4%,33m
21093,3,HavelTheRock,2801,163,4,2,6,66.7%,8m
21093,3,WarinDgN,2801,168,4,7,11,36.4%,28m
21093,3,Iconic,2801,133,3,2,5,60.0%,6m
21093,3,[4BDSM]MagoNegro,2801,58,2,3,5,40.0%,27m
21093,3,Fia,2801,0,2,3,5,40.0%,9m
21093,3,[LGNxx]Shadow,2801,0,1,0,1,100.0%,36m
21093,3,Ira,2801,30,1,1,2,50.0%,25m
21093,3,[DRKSD]DarthJulius,2801,0,1,2,3,33.3%,15m
21093,3,GranSGhun,2801,0,1,8,9,11.1%,2h
21093,3,[KerriS]Llamallab,2801,0,0,1,1,0.0%,9m
21093,3,MjrHardNips,2801,0,0,1,1,0.0%,15m
21093,3,[ZLS]FulkerGG,2801,0,0,1,1,0.0%,12m
21093,3,[Chozn1]WOLFKING,2801,0,0,4,4,0.0%,8m
21119,2,Fauch,2800,1551,220,204,424,51.9%,44m
21119,1,RRC,2800,1543,166,164,330,50.3%,9m
21119,1,CGBarca,2800,1374,130,136,266,48.9%,37m
21119,3,ProtossPanda,2800,1344,126,120,246,51.2%,8m
21119,3,SaggyCashews,2800,1490,77,51,128,60.2%,21m
21119,2,ihaxzs,2800,1251,72,69,141,51.1%,31m
21119,2,[ILikeU]YOUNgLUCKy,2800,1373,67,63,130,51.5%,20m
21119,3,[PUPUS]Gabo,2800,1509,66,50,116,56.9%,10m
21119,2,MACK,2800,501,59,50,109,54.1%,12m
21119,3,asdsa,2800,901,45,24,69,65.2%,20m
21119,3,Lightning,2800,820,30,33,63,47.6%,24m
21119,3,valkiryion,2800,686,29,20,49,59.2%,33m
21119,3,Array,2800,180,14,12,26,53.8%,26m
21119,2,Ender,2800,186,9,7,16,56.2%,23m
21119,3,Crescendo,2800,260,8,7,15,53.3%,15m
21119,3,[ducks]quack,2800,145,7,10,17,41.2%,10m
21119,2,TSWRA,2800,194,7,13,20,35.0%,21m
21119,3,Jdiaz,2800,142,5,7,12,41.7%,45m
21119,3,liquidsnake,2800,109,4,3,7,57.1%,23m
21119,1,Roofies,2800,48,4,4,8,50.0%,2h
21119,3,[TTFG]Stalix,2800,92,3,3,6,50.0%,28m
21119,3,Thechol,2800,115,3,5,8,37.5%,38m
21119,3,jpppppp,2800,94,3,6,9,33.3%,6m
21119,3,Bob,2800,86,3,7,10,30.0%,9m
21119,2,VanNasty,2800,94,3,10,13,23.1%,20m
21119,2,Phoebe,2800,0,1,1,2,50.0%,5m
21119,3,BTMM,2800,30,1,3,4,25.0%,23m
21119,3,[NPhasA]HASPEL,2800,0,1,4,5,20.0%,3m
21119,3,DrJ,2800,0,0,1,1,0.0%,6m
21119,1,javabean,2800,0,0,1,1,0.0%,2h
21119,2,ACiD,2800,0,0,1,1,0.0%,38m
21119,3,Hurricane,2800,0,0,1,1,0.0%,12m
21119,2,aSgNitzer,2800,0,0,3,3,0.0%,2h
21119,3,SuperiorRace,2800,0,0,4,4,0.0%,6m
21119,2,[SKAFTW]SLAYKINGANDY,2800,0,0,6,6,0.0%,46m
21154,2,MARINASILVA,2799,1513,121,106,227,53.3%,17m
21154,1,MiniPanCake,2799,869,113,92,205,55.1%,34m
21154,2,[Sailx]AHZeus,2799,1465,112,106,218,51.4%,7m
21154,3,[FFAA]Enmanuel,2799,1402,103,88,191,53.9%,46m
21154,2,Adimus,2799,413,71,65,136,52.2%,14m
21154,2,[FaTlAd]Dragonfable,2799,1310,63,50,113,55.8%,30m
21154,3,ZULU,2799,478,61,63,124,49.2%,29m
21154,3,Zupper,2799,1355,53,55,108,49.1%,45m
21154,3,Sebbie,2799,897,36,32,68,52.9%,34m
21154,2,[A1B2C3]DonKeigh,2799,814,35,40,75,46.7%,21m
21154,3,Frozenyeti,2799,697,27,23,50,54.0%,5m
21154,2,[ZTempz]parmesan,2799,365,23,28,51,45.1%,38m
21154,3,[maSC]Igneel,2799,410,19,7,26,73.1%,33m
21154,3,Schweinsteig,2799,399,18,5,23,78.3%,47m
21154,2,Torbjörn,2799,426,16,21,37,43.2%,29m
21154,1,[LQV]Socrator,2799,490,15,23,38,39.5%,37m
21154,3,Sworf,2799,327,14,6,20,70.0%,11m
21154,1,CaimX,2799,338,14,10,24,58.3%,2h
21154,3,Derange,2799,306,14,11,25,56.0%,10m
21154,3,Chris,2799,282,12,9,21,57.1%,30m
21154,3,AraGooN,2799,324,12,12,24,50.0%,33m
21154,1,ChapSlop,2799,293,10,14,24,41.7%,32m
21154,1,KickRox,2799,256,9,12,21,42.9%,42m
21154,3,ZacAiur,2799,247,8,7,15,53.3%,43m
21154,3,xXCrudeXx,2799,248,7,6,13,53.8%,14m
21154,2,AncientAstra,2799,60,6,4,10,60.0%,47m
21154,3,[Bento]Eternity,2799,116,4,5,9,44.4%,7m
21154,2,satsuki,2799,30,4,5,9,44.4%,23m
21154,3,[kdUb]INcrypted,2799,58,3,1,4,75.0%,33m
21154,3,Thaddeus,2799,110,3,4,7,42.9%,16m
21154,1,Lucifer,2799,145,3,4,7,42.9%,18m
21154,3,Siven,2799,0,2,3,5,40.0%,9m
21154,3,Violino,2799,0,2,3,5,40.0%,30m
21154,3,Sigismundo,2799,0,1,2,3,33.3%,45m
21154,1,Poozy,2799,0,1,4,5,20.0%,2h
21154,3,foxwoods,2799,30,1,5,6,16.7%,33m
21154,2,MieRCieLaGo,2799,0,1,6,7,14.3%,17m
21154,3,PORCINO,2799,0,0,1,1,0.0%,16m
21154,2,Youwinilose,2799,0,0,3,3,0.0%,32m
21154,3,[FCBM]xPOSEIDONx,2799,0,0,5,5,0.0%,30m
21194,3,AapixX,2798,834,61,52,113,54.0%,12m
21194,2,Ecological,2798,1276,47,48,95,49.5%,14m
21194,2,Audyappy,2798,978,45,33,78,57.7%,36m
21194,3,orz,2798,875,38,34,72,52.8%,33m
21194,3,Virus,2798,827,37,29,66,56.1%,12m
21194,2,SpecialK,2798,644,30,24,54,55.6%,20m
21194,3,Blardin,2798,429,24,12,36,66.7%,11m
21194,1,MarkoAK,2798,488,22,23,45,48.9%,19m
21194,2,AlphaGG,2798,522,20,24,44,45.5%,37m
21194,3,GeoSonis,2798,332,16,3,19,84.2%,13m
21194,3,EpiCLappy,2798,330,15,11,26,57.7%,13m
21194,3,SeanOverLuck,2798,264,14,5,19,73.7%,2h
21194,1,Viscount,2798,274,13,11,24,54.2%,1h
21194,3,[GLHFMP]senaf,2798,162,7,7,14,50.0%,12m
21194,2,diegonta,2798,0,5,4,9,55.6%,2h
21194,3,[FMX]Restaurador,2798,161,5,6,11,45.5%,46m
21194,3,Crusader,2798,60,3,1,4,75.0%,28m
21194,3,FertsHd,2798,94,3,3,6,50.0%,9m
21194,3,pierreyaser,2798,58,3,5,8,37.5%,6m
21194,2,[519mob]xAmImacroOox,2798,114,3,6,9,33.3%,44m
21194,2,Rosson,2798,84,3,7,10,30.0%,3h
21194,3,erichthered,2798,64,2,5,7,28.6%,9m
21194,3,dayHaas,2798,0,1,0,1,100.0%,23m
21194,3,JoTa,2798,0,1,0,1,100.0%,26m
21194,3,[RLA]Sheepy,2798,0,1,0,1,100.0%,12m
21194,3,ToppGonZz,2798,0,1,0,1,100.0%,5m
21194,2,[kØ]Srpankeke,2798,46,1,1,2,50.0%,1h
21194,3,DarkJunkie,2798,30,1,2,3,33.3%,8m
21194,1,[SIGAH]HunkOCheese,2798,48,1,3,4,25.0%,3h
21194,3,Bae,2798,0,0,1,1,0.0%,36m
21194,2,[eOWN]MasterMind,2798,0,0,1,1,0.0%,42m
21194,3,xNataS,2798,0,0,1,1,0.0%,9m
21194,3,FEODAL,2798,0,0,1,1,0.0%,12m
21194,3,ZeeP,2798,0,0,3,3,0.0%,12m
21228,2,[UpxV]Snow,2797,1576,255,252,507,50.3%,37m
21228,3,Dre,2797,1028,97,72,169,57.4%,10m
21228,1,timetodead,2797,1607,86,81,167,51.5%,28m
21228,3,StoneSoldier,2797,1399,79,56,135,58.5%,33m
21228,3,Entropy,2797,451,47,42,89,52.8%,11m
21228,2,Jeff,2797,184,32,29,61,52.5%,13m
21228,3,xHAx,2797,716,31,23,54,57.4%,4m
21228,3,heff,2797,601,28,13,41,68.3%,6m
21228,2,Paradox,2797,582,28,24,52,53.8%,4m
21228,3,Skyguy,2797,413,22,8,30,73.3%,9m
21228,2,BetaDeeds,2797,411,14,20,34,41.2%,14m
21228,3,[Tasteb]DDugi,2797,251,11,6,17,64.7%,35m
21228,3,[Narval]Dragor,2797,216,9,7,16,56.2%,1h
21228,3,[t3k]Lep,2797,196,9,7,16,56.2%,3m
21228,3,wcsharp,2797,200,7,9,16,43.8%,47m
21228,3,Jamin,2797,144,6,5,11,54.5%,23m
21228,2,Supreme,2797,0,5,2,7,71.4%,25m
21228,3,LastWordGf,2797,60,5,5,10,50.0%,10m
21228,1,Hasaki,2797,144,5,5,10,50.0%,2h
21228,3,Kena,2797,58,3,1,4,75.0%,15m
21228,3,[WarAnt]TheDarkKing,2797,28,3,3,6,50.0%,25m
21228,3,Jynx,2797,30,2,3,5,40.0%,28m
21228,3,Treatment,2797,0,1,0,1,100.0%,14m
21228,3,crater,2797,30,1,2,3,33.3%,29m
21228,3,Sles,2797,0,1,2,3,33.3%,28m
21228,3,SWgallery,2797,0,0,1,1,0.0%,28m
21228,3,antagomiR,2797,0,0,1,1,0.0%,26m
21228,1,Guardian,2797,0,0,5,5,0.0%,17m
21256,3,LeTurkeh,2796,1164,81,76,157,51.6%,47m
21256,2,Magistrate,2796,1519,76,64,140,54.3%,26m
21256,3,[nieBla]DonkomanTHC,2796,987,44,28,72,61.1%,12m
21256,3,[MtnDwd]Biscuits,2796,989,42,37,79,53.2%,46m
21256,2,whereisyourg,2796,1089,42,40,82,51.2%,18m
21256,3,Creative,2796,387,35,25,60,58.3%,16m
21256,2,SweetDylz,2796,740,34,33,67,50.7%,26m
21256,3,[SSVG]Ozmerg,2796,617,27,17,44,61.4%,29m
21256,2,SpaceDude,2796,338,12,16,28,42.9%,19m
21256,3,TheUndermind,2796,144,6,5,11,54.5%,23m
21256,3,Hilario,2796,142,5,5,10,50.0%,20m
21256,1,[LOOPY]Open,2796,97,4,5,9,44.4%,45m
21256,3,[Rastah]Xerxes,2796,58,3,1,4,75.0%,6m
21256,2,dumpstermike,2796,0,3,2,5,60.0%,42m
21256,2,[CHAN4]RonBurgundy,2796,0,3,3,6,50.0%,41m
21256,2,Boris,2796,60,2,11,13,15.4%,26m
21256,2,Balzamer,2796,88,1,1,2,50.0%,2h
21273,3,[FMX]LaReata,2795,1516,183,162,345,53.0%,26m
21273,2,clarkwan,2795,1609,179,172,351,51.0%,16m
21273,2,RiOt,2795,1301,138,132,270,51.1%,47m
21273,3,eels,2795,1502,126,120,246,51.2%,26m
21273,2,HertzBr,2795,1582,86,83,169,50.9%,25m
21273,2,IIIIIIIIIIII,2795,1529,81,80,161,50.3%,5m
21273,3,typicallucas,2795,1418,65,40,105,61.9%,44m
21273,3,bEkAchI,2795,583,50,45,95,52.6%,27m
21273,3,[GRNSKN]Skynet,2795,1098,44,39,83,53.0%,31m
21273,3,[Exper]miguel,2795,704,34,28,62,54.8%,22m
21273,3,illadanius,2795,572,28,24,52,53.8%,14m
21273,3,WrathBringer,2795,313,11,15,26,42.3%,32m
21273,2,YouKnowWho,2795,337,11,15,26,42.3%,31m
21273,3,Sunshine,2795,246,10,1,11,90.9%,17m
21273,3,Zafyrch,2795,200,8,6,14,57.1%,4m
21273,3,Lois,2795,201,7,8,15,46.7%,21m
21273,3,Genesis,2795,140,6,5,11,54.5%,29m
21273,3,KilleR,2795,90,5,6,11,45.5%,5m
21273,3,Deeznuts,2795,142,5,6,11,45.5%,45m
21273,3,[mS2]flanker,2795,170,4,4,8,50.0%,12m
21273,3,zazaza,2795,112,3,1,4,75.0%,43m
21273,3,Marles,2795,93,2,2,4,50.0%,29m
21273,1,[RIPWoL]gravytrain,2795,121,2,3,5,40.0%,1h
21273,1,Ergo,2795,96,2,7,9,22.2%,2h
21273,3,[DASU]KillaBees,2795,0,1,0,1,100.0%,8m
21273,3,TrippelM,2795,0,1,0,1,100.0%,15m
21273,3,[EoC]VolsKnox,2795,0,1,0,1,100.0%,35m
21273,3,QueerMohamad,2795,0,1,0,1,100.0%,26m
21273,3,Jiska,2795,0,1,0,1,100.0%,16m
21273,3,akira,2795,0,1,0,1,100.0%,6m
21273,3,[AK48]RayKnight,2795,30,1,1,2,50.0%,37m
21273,3,[d0t]Segfault,2795,30,1,1,2,50.0%,44m
21273,3,BlackSoul,2795,0,0,1,1,0.0%,5m
21306,3,Chinook,2794,1275,124,113,237,52.3%,47m
21306,2,Yaotzin,2794,1300,120,109,229,52.4%,20m
21306,3,[PudS1]FazzyJ,2794,1559,116,113,229,50.7%,6m
21306,2,Jonny,2794,1433,102,100,202,50.5%,37m
21306,2,[Wesye]Wesye,2794,794,95,83,178,53.4%,37m
21306,2,THCodb,2794,1181,47,42,89,52.8%,9m
21306,2,[1C1C]JTF,2794,1054,39,47,86,45.3%,32m
21306,2,Check,2794,690,26,31,57,45.6%,11m
21306,3,Vanders,2794,607,24,25,49,49.0%,36m
21306,3,HighPlayer,2794,401,17,11,28,60.7%,36m
21306,3,Etrain,2794,409,15,9,24,62.5%,12m
21306,3,[GOPERÚ]chupas,2794,332,13,15,28,46.4%,47m
21306,2,[SUPRE]Jawsthehobo,2794,276,11,10,21,52.4%,23m
21306,3,Kenfucious,2794,262,10,7,17,58.8%,9m
21306,2,letztewelt,2794,282,9,15,24,37.5%,46m
21306,3,Dario,2794,218,7,5,12,58.3%,2h
21306,3,orangeapple,2794,90,6,5,11,54.5%,26m
21306,2,[SCJL]HEKK,2794,184,6,9,15,40.0%,16m
21306,3,[AbcCo]CaritaFeliz,2794,124,5,5,10,50.0%,29m
21306,1,Ryry,2794,239,5,7,12,41.7%,1h
21306,3,Col,2794,30,4,4,8,50.0%,31m
21306,3,Irreantum,2794,90,3,6,9,33.3%,43m
21306,3,iWind,2794,0,1,0,1,100.0%,4m
21306,3,WintermelonT,2794,0,1,0,1,100.0%,20m
21306,3,Szczechmate,2794,30,1,2,3,33.3%,36m
21306,3,Parzival,2794,30,1,2,3,33.3%,11m
21306,2,PnP,2794,88,1,3,4,25.0%,43m
21306,3,Anasati,2794,0,0,1,1,0.0%,43m
21334,3,Skyman,2793,1106,308,286,594,51.9%,14m
21334,3,CtrlAltDel,2793,565,111,97,208,53.4%,16m
21334,3,SinEater,2793,1586,100,77,177,56.5%,9m
21334,2,Mmg,2793,1482,100,89,189,52.9%,11m
21334,3,Ellipsey,2793,354,85,58,143,59.4%,36m
21334,2,Paused,2793,1090,67,62,129,51.9%,31m
21334,3,proggleyes,2793,945,43,30,73,58.9%,21m
21334,3,Remilo,2793,903,40,32,72,55.6%,21m
21334,3,Greg,2793,561,39,25,64,60.9%,45m
21334,3,neno,2793,633,38,33,71,53.5%,44m
21334,3,SoNiC,2793,673,26,27,53,49.1%,34m
21334,3,proxicon,2793,443,20,8,28,71.4%,17m
21334,2,AcroJames,2793,348,19,22,41,46.3%,9m
21334,3,Destroya,2793,309,12,7,19,63.2%,44m
21334,3,[CCCP1]chilakill,2793,338,12,10,22,54.5%,29m
21334,3,[ARGENT]NITRAM,2793,316,10,17,27,37.0%,17m
21334,3,ZerO,2793,191,7,1,8,87.5%,34m
21334,3,AJRon,2793,174,6,7,13,46.2%,17m
21334,2,deerod,2793,133,6,8,14,42.9%,18m
21334,3,TacoWolf,2793,30,4,2,6,66.7%,47m
21334,2,IlIlllllIIII,2793,115,4,3,7,57.1%,2h
21334,1,mehlord,2793,97,3,2,5,60.0%,2h
21334,3,Uguluk,2793,93,3,3,6,50.0%,47m
21334,3,Ken,2793,62,3,5,8,37.5%,33m
21334,3,[MtnDwd]MuchosPylons,2793,30,2,0,2,100.0%,25m
21334,3,YOSHI,2793,30,2,0,2,100.0%,11m
21334,3,YeeeeOuO,2793,97,2,3,5,40.0%,3h
21334,1,Rylandorr,2793,96,2,4,6,33.3%,47m
21334,3,Fenrir,2793,30,2,5,7,28.6%,22m
21334,2,Workerrush,2793,30,2,7,9,22.2%,14m
21334,3,[ZAVC]Echo,2793,0,1,0,1,100.0%,8m
21334,3,onegu,2793,0,1,1,2,50.0%,36m
21334,3,[LYON]Baron,2793,0,0,1,1,0.0%,6m
21334,3,Intricate,2793,0,0,2,2,0.0%,9m
21334,3,StoneHand,2793,0,0,3,3,0.0%,44m
21334,3,potatina,2793,0,0,4,4,0.0%,33m
21370,3,Mostdope,2792,1566,136,106,242,56.2%,14m
21370,2,Notib,2792,1513,99,92,191,51.8%,21m
21370,2,Flash,2792,1269,66,59,125,52.8%,21m
21370,2,theprobe,2792,1508,63,55,118,53.4%,25m
21370,3,Fireflyy,2792,1209,55,42,97,56.7%,4m
21370,3,[Tang]Azurak,2792,785,46,37,83,55.4%,29m
21370,3,ProtosMangas,2792,619,34,17,51,66.7%,12m
21370,2,Derek,2792,878,31,33,64,48.4%,13m
21370,3,Frostytatas,2792,527,28,15,43,65.1%,44m
21370,3,Yes,2792,462,19,18,37,51.4%,10m
21370,3,Ramone,2792,397,17,13,30,56.7%,3m
21370,3,DarkSapphire,2792,355,15,11,26,57.7%,25m
21370,3,[cyberw]SlurmeyKing,2792,403,14,13,27,51.9%,16m
21370,1,[S1BJ]Zealous,2792,269,12,13,25,48.0%,2h
21370,3,kobetj,2792,331,11,10,21,52.4%,16m
21370,1,badfish,2792,250,11,10,21,52.4%,45m
21370,2,TSandwich,2792,258,11,15,26,42.3%,20m
21370,3,Void,2792,162,7,5,12,58.3%,33m
21370,2,Mittwoch,2792,212,7,13,20,35.0%,27m
21370,3,Blake,2792,123,5,4,9,55.6%,10m
21370,3,mishan,2792,0,4,1,5,80.0%,37m
21370,3,rapscallion,2792,136,4,2,6,66.7%,43m
21370,3,Fullmetal,2792,30,4,5,9,44.4%,46m
21370,3,SkerpEEp,2792,116,4,6,10,40.0%,11m
21370,2,[Breez]Phidippides,2792,130,4,7,11,36.4%,14m
21370,3,[IMDSI]Murillox,2792,133,3,1,4,75.0%,13m
21370,1,Blatz,2792,96,3,10,13,23.1%,2h
21370,3,JEGABAHU,2792,0,2,2,4,50.0%,30m
21370,3,Ursher,2792,0,1,1,2,50.0%,47m
21370,2,Deadly,2792,0,1,4,5,20.0%,2h
21370,3,Kojopko,2792,0,0,1,1,0.0%,47m
21370,2,Artanis,2792,0,0,5,5,0.0%,2h
21402,1,[PobSC]Ragnar,2791,1488,265,240,505,52.5%,28m
21402,2,GrosMou,2791,1565,98,94,192,51.0%,34m
21402,3,beejay,2791,940,76,69,145,52.4%,30m
21402,2,Xandrar,2791,1381,66,44,110,60.0%,47m
21402,3,[iKing]Blue,2791,972,57,51,108,52.8%,15m
21402,1,HENRYHOBO,2791,1251,44,57,101,43.6%,22m
21402,3,LargeBass,2791,754,27,26,53,50.9%,10m
21402,3,[Exper]Enomujashik,2791,597,24,20,44,54.5%,4m
21402,3,BzKTab,2791,471,18,20,38,47.4%,33m
21402,3,OriginalG,2791,387,14,12,26,53.8%,22m
21402,3,[neuroS]PonyBoy,2791,334,13,6,19,68.4%,21m
21402,3,xRuin,2791,301,12,8,20,60.0%,43m
21402,3,Junin,2791,262,11,8,19,57.9%,10m
21402,3,Genadi,2791,285,10,8,18,55.6%,33m
21402,3,WEONxFEO,2791,215,8,4,12,66.7%,24m
21402,3,superkyler,2791,228,7,4,11,63.6%,43m
21402,2,TooL,2791,232,7,11,18,38.9%,7m
21402,3,[ROCKSC]Netisis,2791,182,6,2,8,75.0%,31m
21402,3,[EndPro]YeIBoRG,2791,58,3,2,5,60.0%,10m
21402,3,[GRNSKN]zenden,2791,0,3,2,5,60.0%,9m
21402,1,Gillarith,2791,48,2,3,5,40.0%,34m
21402,3,iseebugs,2791,0,1,1,2,50.0%,37m
21402,3,xOPTI,2791,0,1,1,2,50.0%,29m
21402,3,[PINGP]Supers,2791,0,0,1,1,0.0%,6m
21402,3,[95G]Justin,2791,0,0,1,1,0.0%,7m
21402,3,Odina,2791,0,0,1,1,0.0%,35m
21402,3,[Truies]JayPercent,2791,0,0,1,1,0.0%,34m
21402,3,[HCFSC]Dreamer,2791,0,0,1,1,0.0%,7m
21430,1,[Lp]Blessmen,2790,1630,203,189,392,51.8%,9m
21430,2,pewpew,2790,1506,80,86,166,48.2%,14m
21430,3,[LGDI]Arenium,2790,1416,53,58,111,47.7%,4m
21430,3,[blubr]Phlothsenes,2790,1067,47,34,81,58.0%,22m
21430,3,BigLunatic,2790,892,40,26,66,60.6%,33m
21430,3,iiGospel,2790,559,23,19,42,54.8%,5m
21430,3,[CraCan]Holysheva,2790,442,20,13,33,60.6%,4m
21430,3,Anymore,2790,498,19,13,32,59.4%,38m
21430,3,SoaringQuail,2790,311,17,15,32,53.1%,33m
21430,3,[ºEGUº]deleigox,2790,426,15,14,29,51.7%,9m
21430,3,SuperKing,2790,173,8,6,14,57.1%,37m
21430,3,BloodyHunter,2790,220,8,11,19,42.1%,24m
21430,2,[JaMiT]Justin,2790,248,8,16,24,33.3%,25m
21430,3,Exodus,2790,170,7,6,13,53.8%,6m
21430,2,[towor]egrot,2790,204,6,9,15,40.0%,20m
21430,2,samurairiver,2790,188,6,14,20,30.0%,44m
21430,3,rAkEn,2790,118,5,5,10,50.0%,43m
21430,3,TheCrounge,2790,130,4,0,4,100.0%,34m
21430,2,Kiwi,2790,154,4,6,10,40.0%,28m
21430,3,ThatGuy,2790,131,3,2,5,60.0%,8m
21430,3,Hammy,2790,0,3,2,5,60.0%,31m
21430,1,[JUGOS]escalerin,2790,97,3,2,5,60.0%,3h
21430,2,Thomas,2790,0,3,2,5,60.0%,20m
21430,3,[ymbk]Saaya,2790,30,2,1,3,66.7%,45m
21430,2,Holle,2790,0,2,2,4,50.0%,16m
21430,3,[QP]FredQuebec,2790,62,2,4,6,33.3%,25m
21430,3,Kangnite,2790,60,2,4,6,33.3%,36m
21430,3,Bravehydra,2790,62,2,5,7,28.6%,30m
21430,3,[ssexxy]Covaena,2790,62,2,5,7,28.6%,18m
21430,3,[Sune]ArcangelCR,2790,0,1,0,1,100.0%,29m
21430,3,Thox,2790,0,1,0,1,100.0%,26m
21430,2,[BLuRJr]BLuRJr,2790,0,1,0,1,100.0%,13m
21430,3,[XpKAc]bleephk,2790,0,1,1,2,50.0%,35m
21430,2,[NOAFK]VampirTurtle,2790,0,1,1,2,50.0%,2h
21430,3,[MaxWin]Grefoli,2790,30,1,3,4,25.0%,9m
21430,1,JuicyJuice,2790,0,0,1,1,0.0%,2h
21430,3,Dweloren,2790,0,0,1,1,0.0%,29m
21430,3,Phyt,2790,0,0,1,1,0.0%,44m
21468,1,Deeznutz,2789,1556,139,133,272,51.1%,9m
21468,1,[UpxV]Reeaper,2789,1053,132,95,227,58.1%,7m
21468,3,Ataraxia,2789,1313,127,109,236,53.8%,34m
21468,3,flash,2789,1637,125,121,246,50.8%,29m
21468,2,WashNMachine,2789,1482,100,93,193,51.8%,31m
21468,2,[urdone]Allerum,2789,1199,87,77,164,53.0%,44m
21468,2,Tsujasa,2789,1322,84,75,159,52.8%,11m
21468,2,Witcher,2789,1347,77,60,137,56.2%,23m
21468,3,icemanida,2789,1552,75,56,131,57.3%,5m
21468,2,[OGblue]Justin,2789,1531,61,70,131,46.6%,13m
21468,3,Rynar,2789,530,25,9,34,73.5%,30m
21468,3,BuTTeR,2789,268,18,15,33,54.5%,26m
21468,2,SylvanNight,2789,496,18,19,37,48.6%,12m
21468,3,Cackenroo,2789,380,16,7,23,69.6%,6m
21468,3,Kryshien,2789,452,16,17,33,48.5%,6m
21468,2,[InGt]clancy,2789,396,14,17,31,45.2%,44m
21468,3,[RCR]FRANKENSTEIN,2789,307,13,3,16,81.2%,29m
21468,3,TestEagle,2789,308,12,9,21,57.1%,33m
21468,2,EAD,2789,124,11,10,21,52.4%,1h
21468,3,fmonkey,2789,232,9,3,12,75.0%,28m
21468,3,onimansza,2789,132,9,9,18,50.0%,19m
21468,1,Monk,2789,251,8,6,14,57.1%,35m
21468,3,MirroRcoLE,2789,118,5,7,12,41.7%,8m
21468,3,RedLabelL,2789,0,4,1,5,80.0%,9m
21468,3,Urushihara,2789,103,4,3,7,57.1%,14m
21468,3,[N3RD5]Lawlzer,2789,86,4,5,9,44.4%,11m
21468,2,ChromeShell,2789,94,3,3,6,50.0%,2h
21468,3,DarkDaisy,2789,94,3,3,6,50.0%,4m
21468,3,HappyFace,2789,121,2,1,3,66.7%,30m
21468,3,Marshall,2789,0,1,2,3,33.3%,1h
21468,3,Giovanni,2789,30,1,4,5,20.0%,3m
21468,3,Vagabond,2789,0,0,3,3,0.0%,2h
21468,3,Shiloh,2789,0,0,3,3,0.0%,11m
21501,2,Reaver,2788,1605,170,160,330,51.5%,22m
21501,2,bigcyp,2788,932,45,28,73,61.6%,23m
21501,3,SeguinINC,2788,820,45,36,81,55.6%,17m
21501,3,Jtekill,2788,844,35,31,66,53.0%,47m
21501,2,[KREAP]FlamingPie,2788,665,34,23,57,59.6%,36m
21501,3,Thunderthwat,2788,406,17,13,30,56.7%,6m
21501,3,[SsaYnS]SiLVeRLeAF,2788,398,15,10,25,60.0%,47m
21501,3,[GGCGG]RichardLi,2788,239,11,6,17,64.7%,2h
21501,3,Ravidel,2788,149,7,4,11,63.6%,16m
21501,3,miniSHAKA,2788,161,5,2,7,71.4%,5m
21501,2,connor,2788,92,5,8,13,38.5%,13m
21501,3,Pamir,2788,190,5,8,13,38.5%,9m
21501,3,[iMkS]Stimpack,2788,141,4,3,7,57.1%,4m
21501,3,[HENT4l]Rambo,2788,86,4,3,7,57.1%,18m
21501,1,[SloBum]FrankCastle,2788,145,4,6,10,40.0%,1h
21501,3,[eXeS]Suricatta,2788,145,3,6,9,33.3%,3h
21501,3,DragonHunter,2788,30,2,0,2,100.0%,30m
21501,3,DizzyWizz,2788,0,2,3,5,40.0%,4m
21501,3,[nieBla]ElSemental,2788,30,2,4,6,33.3%,31m
21501,1,DirePants,2788,0,2,5,7,28.6%,1h
21501,3,lackofit,2788,0,1,0,1,100.0%,33m
21501,2,Renstar,2788,0,1,4,5,20.0%,2h
21501,2,FilthyBeaver,2788,0,1,6,7,14.3%,26m
21501,1,Dante,2788,0,0,1,1,0.0%,2h
21501,3,oso,2788,0,0,1,1,0.0%,22m
21501,3,Kou,2788,0,0,1,1,0.0%,11m
21527,1,[Wizzy]Mongoose,2787,1631,268,238,506,53.0%,46m
21527,2,NickArrow,2787,1546,199,183,382,52.1%,4m
21527,3,symptoms,2787,1060,175,158,333,52.6%,6m
21527,2,[copain]BillyBob,2787,711,154,98,252,61.1%,32m
21527,3,[1025]HyperVirus,2787,1234,98,90,188,52.1%,37m
21527,3,Wydwen,2787,1474,67,46,113,59.3%,4m
21527,2,Kurisu,2787,1368,57,50,107,53.3%,9m
21527,2,[BMaD]Prodigy,2787,851,36,35,71,50.7%,33m
21527,3,Manta,2787,359,12,11,23,52.2%,33m
21527,2,Stygian,2787,241,9,9,18,50.0%,47m
21527,3,Sieve,2787,163,8,3,11,72.7%,4m
21527,2,SuperDRY,2787,216,8,15,23,34.8%,18m
21527,3,zeratul,2787,241,7,4,11,63.6%,17m
21527,2,[Cryptc]chaoz,2787,162,5,3,8,62.5%,2h
21527,1,Facemurder,2787,165,5,5,10,50.0%,3h
21527,3,[AOAWOL]Haochey,2787,147,5,6,11,45.5%,31m
21527,3,ledevourer,2787,144,5,6,11,45.5%,31m
21527,2,Slid,2787,126,4,12,16,25.0%,20m
21527,3,[7eZ]Kakarrot,2787,0,2,3,5,40.0%,30m
21527,2,BlackHammer,2787,0,2,3,5,40.0%,31m
21527,3,CellProfille,2787,0,2,3,5,40.0%,29m
21527,3,SmugBanana,2787,0,2,3,5,40.0%,33m
21527,2,Eldrik,2787,92,2,6,8,25.0%,2h
21527,3,[JaMiT]TrinalG,2787,0,1,0,1,100.0%,47m
21527,3,Rosalina,2787,0,0,1,1,0.0%,7m
21527,3,GUNDAM,2787,0,0,1,1,0.0%,19m
21553,3,Katsumoto,2786,1549,127,117,244,52.0%,29m
21553,3,BSmooth,2786,824,123,113,236,52.1%,16m
21553,3,Inzania,2786,1593,90,77,167,53.9%,20m
21553,2,reutak,2786,1081,63,52,115,54.8%,16m
21553,3,OrcoMalo,2786,1329,59,44,103,57.3%,16m
21553,3,Wreckon,2786,1191,56,39,95,58.9%,16m
21553,3,[BSB69]Paaaaaatrick,2786,650,48,45,93,51.6%,34m
21553,3,Rose,2786,597,44,25,69,63.8%,34m
21553,3,Jarf,2786,889,41,20,61,67.2%,20m
21553,3,DankDrizzo,2786,962,38,32,70,54.3%,3m
21553,3,[Shardz]nhduia,2786,886,37,31,68,54.4%,12m
21553,3,Tripleipa,2786,663,30,16,46,65.2%,38m
21553,2,Caligula,2786,462,25,23,48,52.1%,24m
21553,2,Fishmael,2786,658,25,27,52,48.1%,12m
21553,2,[GnR]Syblix,2786,586,24,19,43,55.8%,47m
21553,3,somerandomgy,2786,432,20,10,30,66.7%,31m
21553,3,Snakeballz,2786,425,19,10,29,65.5%,4m
21553,3,Frosty,2786,185,18,16,34,52.9%,6m
21553,3,Unorthodox,2786,402,15,16,31,48.4%,43m
21553,3,Diao,2786,243,13,6,19,68.4%,23m
21553,3,Imperious,2786,297,11,5,16,68.8%,45m
21553,3,Nate,2786,309,11,6,17,64.7%,47m
21553,3,Altros,2786,287,11,12,23,47.8%,16m
21553,3,Kirynite,2786,56,10,12,22,45.5%,6m
21553,3,[AlIin]wocks,2786,92,4,8,12,33.3%,9m
21553,3,HeebusJeebus,2786,88,3,6,9,33.3%,8m
21553,3,[Lp]IrOnAnGeL,2786,94,2,0,2,100.0%,31m
21553,3,[NM8]MAICKOLXD,2786,58,2,3,5,40.0%,23m
21553,1,[AllTim]Azurelen,2786,97,2,4,6,33.3%,2h
21553,3,FanTom,2786,0,1,0,1,100.0%,15m
21553,2,Roxin,2786,0,1,0,1,100.0%,6m
21553,2,Sirmagicman,2786,0,1,3,4,25.0%,4m
21553,3,[StmBrk]GeckO,2786,0,0,1,1,0.0%,3m
21553,3,RumNCoke,2786,0,0,1,1,0.0%,34m
21553,3,Robin,2786,0,0,1,1,0.0%,9m
21553,3,[BBB420]Kleonitus,2786,0,0,6,6,0.0%,14m
21589,3,Sylphrena,2785,925,91,68,159,57.2%,15m
21589,2,Pumpkinpod,2785,999,59,47,106,55.7%,29m
21589,1,Vermillion,2785,1374,54,58,112,48.2%,19m
21589,3,BLEIKIRI,2785,1015,47,40,87,54.0%,6m
21589,2,[ARCsc2]Wrynn,2785,1032,42,48,90,46.7%,37m
21589,3,MagicFlea,2785,591,33,17,50,66.0%,33m
21589,3,SaulHudson,2785,652,25,21,46,54.3%,29m
21589,3,PABLOKX,2785,539,23,15,38,60.5%,34m
21589,2,xSoulzz,2785,593,23,27,50,46.0%,18m
21589,3,Rexx,2785,464,18,17,35,51.4%,21m
21589,2,BabyFaceSJ,2785,378,17,15,32,53.1%,45m
21589,3,beach,2785,426,15,16,31,48.4%,6m
21589,3,[TriFP]JotaJonas,2785,331,14,6,20,70.0%,28m
21589,2,Garnett,2785,313,11,12,23,47.8%,33m
21589,3,[AbcCo]Blanka,2785,278,10,7,17,58.8%,8m
21589,2,odinthebrave,2785,230,9,10,19,47.4%,2h
21589,3,[VIMP]NaCl,2785,183,6,1,7,85.7%,44m
21589,3,[Luxae]LuxaNova,2785,60,5,4,9,55.6%,5m
21589,2,[OndaVT]Chato,2785,108,4,1,5,80.0%,2h
21589,3,[ZCMD]MiniPike,2785,133,4,3,7,57.1%,46m
21589,3,Fattylumpkin,2785,30,4,4,8,50.0%,46m
21589,3,Naruto,2785,0,3,2,5,60.0%,28m
21589,1,DrFrantz,2785,138,3,7,10,30.0%,19m
21589,3,Olecranon,2785,30,2,1,3,66.7%,34m
21589,3,Kamuix,2785,30,2,1,3,66.7%,9m
21589,2,[MAGA20]hevyFKNmetal,2785,30,2,10,12,16.7%,18m
21589,3,Medvedev,2785,0,1,0,1,100.0%,5m
21589,3,CapitalJH,2785,0,1,1,2,50.0%,14m
21589,3,FlawlesHater,2785,30,1,2,3,33.3%,29m
21589,3,Elements,2785,30,1,2,3,33.3%,33m
21589,3,SMH,2785,30,1,2,3,33.3%,29m
21589,3,Publius,2785,30,1,3,4,25.0%,9m
21589,3,[CdRo]ResortLight,2785,0,0,1,1,0.0%,33m
21589,3,hybridmaar,2785,0,0,1,1,0.0%,12m
21623,2,OneAndOnlyAB,2784,1472,218,208,426,51.2%,20m
21623,1,Oodawn,2784,1578,160,155,315,50.8%,45m
21623,1,[TGCF]TrogDor,2784,1595,142,138,280,50.7%,28m
21623,2,kokakola,2784,827,88,83,171,51.5%,47m
21623,2,[EEES2]DothrakScrmr,2784,364,71,63,134,53.0%,31m
21623,3,Rhino,2784,950,46,39,85,54.1%,17m
21623,1,zUnicorn,2784,1165,42,51,93,45.2%,3m
21623,3,VictoriouS,2784,705,29,24,53,54.7%,44m
21623,3,Chookity,2784,528,23,20,43,53.5%,38m
21623,2,Amsterdam,2784,286,21,12,33,63.6%,16m
21623,3,[ZLO]PABON,2784,377,16,12,28,57.1%,44m
21623,1,[Nitmar]FishCrab,2784,374,16,19,35,45.7%,48m
21623,3,Shed,2784,424,16,19,35,45.7%,34m
21623,3,[MO8]silentvoice,2784,404,14,20,34,41.2%,28m
21623,3,Sound,2784,346,12,9,21,57.1%,29m
21623,3,[HBR15]Deathtraim,2784,222,8,9,17,47.1%,27m
21623,3,Kapis,2784,133,7,3,10,70.0%,5m
21623,2,Coágulo,2784,230,7,10,17,41.2%,6m
21623,2,[æTsOæ]JavierPBR,2784,114,6,3,9,66.7%,14m
21623,1,Alejo,2784,198,6,4,10,60.0%,2h
21623,2,KiRA,2784,142,6,7,13,46.2%,12m
21623,3,[HEZUS]DietProtoss,2784,163,5,3,8,62.5%,12m
21623,3,WrestlaBman,2784,120,5,5,10,50.0%,23m
21623,1,Director,2784,96,5,6,11,45.5%,1h
21623,2,glycerine,2784,163,4,4,8,50.0%,28m
21623,3,blankyeti,2784,30,4,4,8,50.0%,47m
21623,2,ECHO,2784,0,3,2,5,60.0%,1h
21623,2,Danarvep,2784,96,3,3,6,50.0%,2h
21623,3,PsiBook,2784,60,3,4,7,42.9%,6m
21623,3,KrakenSlayer,2784,30,2,0,2,100.0%,26m
21623,3,Bareleon,2784,30,2,1,3,66.7%,6m
21623,3,Skyline,2784,0,2,3,5,40.0%,5m
21623,3,[JrMafi]Guegui,2784,0,1,0,1,100.0%,25m
21623,3,Cahizaaa,2784,0,1,0,1,100.0%,9m
21623,3,AlexVanEyck,2784,0,1,1,2,50.0%,45m
21623,3,Quickhitta,2784,0,1,4,5,20.0%,37m
21623,3,[M00SE]zero,2784,0,0,1,1,0.0%,6m
21623,2,DROOJ,2784,0,0,5,5,0.0%,7m
21661,2,[TY4GG]Crisps,2783,965,109,96,205,53.2%,9m
21661,2,ExpertniDelo,2783,1116,88,84,172,51.2%,20m
21661,1,Maniack,2783,571,43,57,100,43.0%,34m
21661,2,ThegodFather,2783,587,42,39,81,51.9%,31m
21661,2,Sneakerbeef,2783,386,23,15,38,60.5%,19m
21661,1,Hanszio,2783,389,15,17,32,46.9%,44m
21661,2,[LOHs]radio,2783,406,15,20,35,42.9%,27m
21661,3,[DarkLS]ZaRu,2783,334,12,16,28,42.9%,34m
21661,3,[FLUME]OGCharmander,2783,277,10,11,21,47.6%,13m
21661,2,Tydro,2783,308,10,17,27,37.0%,12m
21661,2,deFox,2783,322,10,19,29,34.5%,33m
21661,3,Tamamo,2783,194,7,10,17,41.2%,32m
21661,3,apocalypse,2783,198,6,5,11,54.5%,5m
21661,1,[MITO22]Stepbrother,2783,194,6,5,11,54.5%,3h
21661,3,blowpez,2783,114,5,4,9,55.6%,19m
21661,3,IvanaAlawi,2783,114,5,6,11,45.5%,29m
21661,3,David,2783,150,5,7,12,41.7%,23m
21661,3,Triumph,2783,116,5,7,12,41.7%,26m
21661,3,Marclox,2783,0,4,1,5,80.0%,21m
21661,2,[BigSak]BOATS,2783,135,4,4,8,50.0%,2h
21661,2,robdog,2783,96,4,12,16,25.0%,12m
21661,3,[SSkull]khaosser,2783,88,3,3,6,50.0%,34m
21661,2,IIIIIIIII,2783,0,3,4,7,42.9%,7m
21661,3,ELTORITO,2783,86,3,4,7,42.9%,34m
21661,3,DIGAF,2783,93,2,0,2,100.0%,21m
21661,3,PWNDralisk,2783,118,2,2,4,50.0%,11m
21661,3,ElSebasVT,2783,58,2,3,5,40.0%,33m
21661,3,SoccerMom,2783,45,2,4,6,33.3%,15m
21661,3,Grimn,2783,62,2,7,9,22.2%,13m
21661,3,[AFE]DrJinAfe,2783,0,1,0,1,100.0%,12m
21661,3,Shell,2783,0,1,1,2,50.0%,3m
21661,3,Emhey,2783,0,0,1,1,0.0%,9m
21661,3,MilkMan,2783,0,0,3,3,0.0%,47m
21694,3,[DhZone]Guima,2782,1546,319,322,641,49.8%,29m
21694,2,[sLuxx]SparkOMatic,2782,1528,158,146,304,52.0%,3m
21694,3,TLA,2782,1498,109,87,196,55.6%,34m
21694,2,joojieman,2782,1506,95,88,183,51.9%,9m
21694,1,Vertical,2782,1242,76,83,159,47.8%,25m
21694,1,[xWoNx]Planner,2782,1466,62,77,139,44.6%,3m
21694,2,[Chupac]MrZerker,2782,1144,54,39,93,58.1%,46m
21694,2,MosHar,2782,499,37,41,78,47.4%,46m
21694,2,DNR,2782,474,36,35,71,50.7%,43m
21694,2,AbsoluteNoob,2782,664,23,31,54,42.6%,9m
21694,3,[TheDOH]wenwen,2782,203,7,4,11,63.6%,46m
21694,3,Voltuxx,2782,226,7,6,13,53.8%,21m
21694,1,blackmind,2782,239,7,7,14,50.0%,1h
21694,1,Adac,2782,142,6,4,10,60.0%,20m
21694,3,TMALsem,2782,188,5,5,10,50.0%,2h
21694,3,flufluf,2782,30,3,4,7,42.9%,9m
21694,2,[vcool]Jokema,2782,0,2,1,3,66.7%,2h
21694,3,FrankPZT,2782,0,2,3,5,40.0%,20m
21694,3,Tenshi,2782,0,2,3,5,40.0%,4m
21694,2,Warriorbaha,2782,0,1,1,2,50.0%,1h
21694,2,Baldinio,2782,0,1,4,5,20.0%,2h
21694,3,MOZART,2782,0,0,1,1,0.0%,10m
21694,3,[OST1]Clocktwerk,2782,0,0,2,2,0.0%,30m
21717,2,PopeLeo,2781,1543,98,96,194,50.5%,21m
21717,2,DROWNALD,2781,1452,95,80,175,54.3%,4m
21717,3,Vidyavaan,2781,1549,79,67,146,54.1%,32m
21717,2,Wrash,2781,1592,71,78,149,47.7%,37m
21717,3,Danilord,2781,1215,67,70,137,48.9%,45m
21717,3,Kevin,2781,724,31,24,55,56.4%,9m
21717,3,ChuttMcBugg,2781,700,27,26,53,50.9%,23m
21717,3,HotDog,2781,261,11,3,14,78.6%,6m
21717,3,Birdbath,2781,278,9,8,17,52.9%,6m
21717,2,squid,2781,219,6,6,12,50.0%,33m
21717,2,BobDole,2781,58,5,4,9,55.6%,25m
21717,3,victinisunny,2781,162,5,4,9,55.6%,12m
21717,2,[Bruste]DwightShrute,2781,0,3,3,6,50.0%,38m
21717,2,VladTImpaler,2781,0,3,3,6,50.0%,2h
21717,2,Dethwater,2781,58,3,8,11,27.3%,33m
21717,3,GICR,2781,94,2,0,2,100.0%,30m
21717,3,[TGBM]Ethos,2781,119,2,3,5,40.0%,25m
21717,3,SglSqz,2781,0,2,3,5,40.0%,33m
21717,3,GriiconStar,2781,60,2,3,5,40.0%,47m
21717,3,Cal,2781,0,2,3,5,40.0%,7m
21717,3,DocLobster,2781,58,2,5,7,28.6%,47m
21717,3,BurtMacklin,2781,0,1,0,1,100.0%,37m
21717,3,WinterHawk,2781,30,1,4,5,20.0%,4m
21717,2,Guinu,2781,0,0,1,1,0.0%,2h
21741,3,JoJotaro,2780,1063,171,159,330,51.8%,48m
21741,3,[LLSC2]Rubixdoed,2780,1233,94,69,163,57.7%,9m
21741,3,lensherr,2780,1432,90,72,162,55.6%,25m
21741,3,[SBoys]Elterranazul,2780,1432,90,74,164,54.9%,25m
21741,3,monSTEARCK,2780,475,57,47,104,54.8%,6m
21741,3,Glasslord,2780,991,57,51,108,52.8%,45m
21741,2,Baratao,2780,718,51,41,92,55.4%,26m
21741,2,Mev,2780,512,42,46,88,47.7%,13m
21741,3,Cwide,2780,505,24,7,31,77.4%,17m
21741,3,[Mahou]UnaArmina,2780,502,20,21,41,48.8%,9m
21741,3,clay,2780,309,13,12,25,52.0%,45m
21741,3,GatitaGolosa,2780,274,10,7,17,58.8%,12m
21741,3,serbnz,2780,208,9,2,11,81.8%,6m
21741,3,Joffy,2780,257,9,4,13,69.2%,20m
21741,1,HeavyMetal,2780,216,7,6,13,53.8%,12m
21741,1,HoroBoro,2780,190,6,6,12,50.0%,2h
21741,3,WarMachine,2780,172,6,7,13,46.2%,4m
21741,3,[KIOS]Draxys,2780,152,6,8,14,42.9%,36m
21741,1,[puppy]DarkASE,2780,209,5,5,10,50.0%,1h
21741,3,AlveeZ,2780,147,4,4,8,50.0%,42m
21741,1,Bubbadamis,2780,118,4,4,8,50.0%,2h
21741,1,[ShNK]MEGUITA,2780,0,3,4,7,42.9%,1h
21741,3,Malziekam,2780,90,3,8,11,27.3%,4m
21741,3,[tCo9]Ace,2780,94,2,0,2,100.0%,21m
21741,3,Gear,2780,30,2,0,2,100.0%,29m
21741,3,nick,2780,93,2,1,3,66.7%,45m
21741,3,[SSJs11]ScWraith,2780,0,1,0,1,100.0%,10m
21741,3,[PBGx]slashy,2780,0,1,1,2,50.0%,33m
21741,3,CHILLA,2780,30,1,3,4,25.0%,8m
21741,2,Shadowblade,2780,0,1,4,5,20.0%,37m
21741,3,Oscar,2780,30,1,6,7,14.3%,34m
21741,3,BustaGusta,2780,0,0,1,1,0.0%,8m
21741,3,Bratwurst,2780,0,0,1,1,0.0%,33m
21741,3,[proDS]Satanis,2780,0,0,1,1,0.0%,34m
21741,3,GLHF,2780,0,0,1,1,0.0%,4m
21741,3,[TGosuB]JohanBastion,2780,0,0,2,2,0.0%,18m
21741,3,Overhaul,2780,0,0,3,3,0.0%,29m
21778,3,DarkanghelL,2779,1136,143,123,266,53.8%,6m
21778,3,Cronos,2779,1230,54,48,102,52.9%,37m
21778,3,Lingxi,2779,1148,51,38,89,57.3%,46m
21778,2,RAVEN,2779,964,43,38,81,53.1%,25m
21778,3,Velken,2779,1111,43,43,86,50.0%,23m
21778,2,JIM,2779,404,41,45,86,47.7%,31m
21778,2,[AbcCo]Nueve,2779,815,31,32,63,49.2%,14m
21778,3,Natesurf,2779,601,29,28,57,50.9%,30m
21778,3,[LARM]Beregonds,2779,539,25,23,48,52.1%,33m
21778,2,dalashinikov,2779,458,25,27,52,48.1%,16m
21778,3,WhatFun,2779,331,23,21,44,52.3%,36m
21778,3,[INextI]OnefOXPrime,2779,504,18,14,32,56.2%,34m
21778,3,[EvilGC]Groncalonca,2779,442,17,16,33,51.5%,44m
21778,3,[YD2K]Crino,2779,364,16,5,21,76.2%,31m
21778,3,[Wulrus]mrDsamps,2779,373,16,11,27,59.3%,34m
21778,2,Naxymus,2779,324,12,15,27,44.4%,21m
21778,3,ButterflyFX,2779,182,11,2,13,84.6%,6m
21778,3,Jorz,2779,105,10,9,19,52.6%,13m
21778,3,SGTbOBsAGeT,2779,199,8,9,17,47.1%,47m
21778,3,Murdock,2779,178,5,2,7,71.4%,14m
21778,3,Harkonnen,2779,116,5,7,12,41.7%,9m
21778,3,QuietMind,2779,125,4,4,8,50.0%,5m
21778,3,GenKenobi,2779,92,4,4,8,50.0%,47m
21778,2,iAmFreedom,2779,0,4,4,8,50.0%,8m
21778,3,fortninja,2779,86,3,9,12,25.0%,17m
21778,2,[BlTEL]DYNaMo,2779,34,2,0,2,100.0%,31m
21778,3,AurA,2779,93,2,0,2,100.0%,8m
21778,1,SidewaySeven,2779,48,2,3,5,40.0%,2h
21778,2,Sigma,2779,0,2,3,5,40.0%,2h
21778,1,HorusAmunRa,2779,0,1,0,1,100.0%,2h
21778,3,[Bl3B]mykim,2779,0,1,0,1,100.0%,36m
21778,3,[xVIPx]nekroslutfvk,2779,0,1,5,6,16.7%,2h
21778,3,[EvilGC]Zeratul,2779,0,0,4,4,0.0%,3m
21811,1,BlackPlague,2778,1592,451,449,900,50.1%,14m
21811,3,Knellers,2778,892,79,66,145,54.5%,26m
21811,3,dango,2778,183,64,61,125,51.2%,6m
21811,3,Aperture,2778,1371,56,52,108,51.9%,31m
21811,3,llllllllllll,2778,754,55,49,104,52.9%,33m
21811,3,ZeRo,2778,1231,51,51,102,50.0%,6m
21811,3,[Broxit]NostrilLicke,2778,960,45,33,78,57.7%,46m
21811,3,Peebers,2778,1003,42,44,86,48.8%,48m
21811,2,XJaymon,2778,918,41,33,74,55.4%,24m
21811,2,DirtyWatah,2778,1128,40,44,84,47.6%,14m
21811,3,Abuse,2778,692,33,26,59,55.9%,31m
21811,3,LightyBulby,2778,449,24,18,42,57.1%,6m
21811,3,Icarus,2778,345,17,11,28,60.7%,34m
21811,1,PoGs,2778,510,15,25,40,37.5%,6m
21811,3,runutz,2778,181,13,15,28,46.4%,33m
21811,3,Stoop,2778,253,11,1,12,91.7%,37m
21811,2,[pTFBq]Brennan,2778,140,11,18,29,37.9%,31m
21811,3,[BMGMS]IVIastor,2778,217,10,4,14,71.4%,20m
21811,3,[ALTF04]Alexander,2778,260,9,6,15,60.0%,28m
21811,3,Jakeafer,2778,201,8,7,15,53.3%,33m
21811,3,AndyPan,2778,219,7,4,11,63.6%,43m
21811,1,WHatThePuck,2778,174,7,6,13,53.8%,34m
21811,3,Alouette,2778,210,7,11,18,38.9%,45m
21811,1,Clocking,2778,190,6,6,12,50.0%,35m
21811,1,ltjuk,2778,137,5,4,9,55.6%,3h
21811,3,[xARGx]MataPros,2778,111,5,4,9,55.6%,20m
21811,3,frnkjr,2778,114,5,5,10,50.0%,30m
21811,3,[BNUwU]Force,2778,38,5,6,11,45.5%,42m
21811,2,TouchMyBelly,2778,150,5,12,17,29.4%,46m
21811,3,mason,2778,0,4,1,5,80.0%,12m
21811,3,YUCK,2778,190,4,8,12,33.3%,26m
21811,2,Rios,2778,0,3,2,5,60.0%,2h
21811,2,Tandu,2778,95,3,3,6,50.0%,36m
21811,3,BloodTemplar,2778,97,2,0,2,100.0%,10m
21811,3,Toyla,2778,114,2,1,3,66.7%,29m
21811,3,[SdA]Gangrena,2778,118,2,2,4,50.0%,48m
21811,3,[PNKN]Peadan,2778,0,1,0,1,100.0%,6m
21811,3,Knight,2778,34,1,1,2,50.0%,35m
21811,1,[KTWN]Woorijip,2778,0,0,1,1,0.0%,9m
21811,2,EmoSnek,2778,0,0,2,2,0.0%,2h
21851,3,KingSTiiG,2777,1558,199,170,369,53.9%,3m
21851,3,Baitall,2777,976,128,114,242,52.9%,15m
21851,3,Atlanta,2777,940,122,102,224,54.5%,33m
21851,3,Fropez,2777,1342,55,49,104,52.9%,23m
21851,2,Zalxander,2777,1099,47,43,90,52.2%,37m
21851,3,Cerro,2777,883,45,39,84,53.6%,44m
21851,3,[LA13]Tlky,2777,858,38,29,67,56.7%,46m
21851,3,Hideo,2777,676,31,19,50,62.0%,20m
21851,3,[TFMG]Roma,2777,591,27,29,56,48.2%,44m
21851,2,[REXB]Submunition,2777,563,25,17,42,59.5%,22m
21851,1,NoMads,2777,404,24,34,58,41.4%,32m
21851,3,[cluez]BoV,2777,619,22,21,43,51.2%,9m
21851,3,KnightOfHell,2777,482,20,11,31,64.5%,44m
21851,3,Rasengan,2777,217,12,7,19,63.2%,2h
21851,3,SrChoripan,2777,286,10,11,21,47.6%,43m
21851,3,TôTranquilo,2777,199,8,3,11,72.7%,9m
21851,3,[detres]minyaron,2777,150,7,5,12,58.3%,12m
21851,1,[1Ec0n1]Pinsir,2777,74,7,6,13,53.8%,36m
21851,2,[VagMax]MrKidkill,2777,189,5,8,13,38.5%,5m
21851,3,iloveketamin,2777,90,4,3,7,57.1%,28m
21851,1,KToos,2777,160,4,6,10,40.0%,2h
21851,3,Intersteyler,2777,138,4,6,10,40.0%,29m
21851,3,rxmirojuana,2777,119,3,1,4,75.0%,11m
21851,2,Xeqter,2777,0,3,3,6,50.0%,2h
21851,3,Neodragon,2777,0,3,3,6,50.0%,10m
21851,1,Neptis,2777,0,3,3,6,50.0%,2h
21851,3,[F1CTI0]DVDVD,2777,48,3,5,8,37.5%,11m
21851,3,[RUINPP]BugsBunny,2777,116,2,1,3,66.7%,14m
21851,3,jimmithy,2777,58,2,3,5,40.0%,9m
21851,2,Azarsi,2777,0,2,3,5,40.0%,2h
21851,3,deepDish,2777,0,1,0,1,100.0%,9m
21851,1,[FalPal]SuperAng,2777,0,1,0,1,100.0%,3h
21851,3,[Hosts]LRDpara,2777,0,1,4,5,20.0%,17m
21851,2,Tuckahoe,2777,0,0,1,1,0.0%,18m
21851,3,dorkslayer,2777,0,0,1,1,0.0%,29m
21886,2,ytROSE,2776,1509,122,108,230,53.0%,17m
21886,1,MrYellow,2776,1117,117,124,241,48.5%,7m
21886,3,[PTHero]lizard,2776,1352,116,94,210,55.2%,26m
21886,3,Elpepe,2776,1559,104,75,179,58.1%,21m
21886,3,[ZHK]wayo,2776,1458,95,87,182,52.2%,4m
21886,3,FLOPPA,2776,643,48,28,76,63.2%,48m
21886,3,ZergChipVN,2776,1083,44,41,85,51.8%,23m
21886,3,lucaspro,2776,967,39,35,74,52.7%,9m
21886,3,mendelian,2776,676,31,19,50,62.0%,20m
21886,3,Sushina,2776,715,30,24,54,55.6%,29m
21886,3,MauroCL,2776,740,28,23,51,54.9%,9m
21886,3,Laksa,2776,633,24,14,38,63.2%,20m
21886,3,Azeta,2776,568,22,18,40,55.0%,26m
21886,2,Ibakecookies,2776,648,22,27,49,44.9%,28m
21886,3,Vysedomo,2776,458,18,14,32,56.2%,36m
21886,3,Ormuz,2776,378,14,14,28,50.0%,45m
21886,3,IamDepth,2776,204,9,11,20,45.0%,30m
21886,3,Papachin,2776,210,8,2,10,80.0%,33m
21886,3,wafermaker,2776,246,8,5,13,61.5%,20m
21886,3,NotIanRead,2776,110,6,1,7,85.7%,28m
21886,1,[p4j4]khairos,2776,120,6,3,9,66.7%,18m
21886,3,moridinamael,2776,90,4,4,8,50.0%,33m
21886,3,SatriX,2776,92,4,5,9,44.4%,32m
21886,3,Momanon,2776,136,3,2,5,60.0%,31m
21886,3,forgetone,2776,92,3,3,6,50.0%,14m
21886,3,eXitiuM,2776,92,3,7,10,30.0%,10m
21886,3,Madness,2776,45,2,3,5,40.0%,36m
21886,2,Jirik,2776,0,2,3,5,40.0%,40m
21886,3,[WNTRBL]Daishan,2776,0,1,0,1,100.0%,33m
21886,3,Name,2776,0,1,1,2,50.0%,21m
21886,1,[TLibre]patal,2776,0,1,1,2,50.0%,1h
21886,3,[INRVDG]Spitnuk,2776,0,1,2,3,33.3%,23m
21886,2,[xGLUEx]tbone,2776,30,1,4,5,20.0%,18m
21886,3,Rawksarz,2776,0,0,4,4,0.0%,6m
21920,1,[LY0]BigXavy,2775,1569,335,330,665,50.4%,44m
21920,2,GUNGNIR,2775,1222,78,58,136,57.4%,4m
21920,3,Bdev,2775,1004,54,51,105,51.4%,45m
21920,2,[C34858]PlaYBooY,2775,845,54,54,108,50.0%,28m
21920,3,Rhinoceron,2775,884,34,35,69,49.3%,29m
21920,3,Steezy,2775,453,32,24,56,57.1%,6m
21920,2,Stephen,2775,658,30,29,59,50.8%,32m
21920,3,[JSBNMB]BulrogNinja,2775,606,28,27,55,50.9%,33m
21920,2,liljoe,2775,419,26,28,54,48.1%,13m
21920,3,PonchoTree,2775,456,21,20,41,51.2%,15m
21920,3,Puffinboi,2775,510,20,13,33,60.6%,34m
21920,1,[KGH]Kevii,2775,336,20,27,47,42.6%,24m
21920,3,Almightysoul,2775,478,18,17,35,51.4%,7m
21920,2,[CCBB]IVHalo,2775,309,14,10,24,58.3%,14m
21920,3,wellardia,2775,108,10,5,15,66.7%,47m
21920,3,misterE,2775,162,8,5,13,61.5%,9m
21920,3,[TESLAS]juggalo,2775,180,7,9,16,43.8%,4m
21920,2,Zeus,2775,159,6,1,7,85.7%,2h
21920,3,Mylo,2775,199,6,5,11,54.5%,12m
21920,1,Aspassia,2775,144,6,8,14,42.9%,2h
21920,2,[Calx]Decker,2775,200,6,11,17,35.3%,47m
21920,2,Iconkalashka,2775,0,5,0,5,100.0%,2h
21920,2,Sunniiboii,2775,106,5,4,9,55.6%,25m
21920,3,Xclash,2775,0,3,3,6,50.0%,32m
21920,1,[FMX]ItekLion,2775,30,3,10,13,23.1%,36m
21920,3,[HØST]Snakespe,2775,114,2,1,3,66.7%,46m
21920,2,Stoic,2775,46,2,5,7,28.6%,2h
21920,3,elviolatumba,2775,0,1,0,1,100.0%,33m
21920,3,Crocop,2775,95,1,1,2,50.0%,34m
21920,3,Korcholata,2775,91,1,1,2,50.0%,24m
21920,3,Ger,2775,93,1,1,2,50.0%,18m
21920,3,SHINSEJI,2775,84,1,1,2,50.0%,13m
21920,3,Seth,2775,30,1,2,3,33.3%,15m
21920,3,[OEG]Pain,2775,0,0,1,1,0.0%,15m
21920,2,llllllllllll,2775,0,0,2,2,0.0%,1h
21920,1,MrSpecial,2775,0,0,3,3,0.0%,9m
21956,3,iceyeti,2774,1612,189,179,368,51.4%,6m
21956,3,Protossexual,2774,1537,127,123,250,50.8%,28m
21956,3,NationalFire,2774,1346,60,44,104,57.7%,33m
21956,3,[Exist]Finnholio,2774,999,45,27,72,62.5%,28m
21956,3,MishkaUnRani,2774,771,40,38,78,51.3%,27m
21956,3,MrEMan,2774,589,35,39,74,47.3%,29m
21956,3,Mitrelmax,2774,737,29,26,55,52.7%,36m
21956,3,[Sail]Cytotonik,2774,780,28,30,58,48.3%,48m
21956,3,UncleGubsy,2774,414,26,22,48,54.2%,44m
21956,3,[TYDR]Tydrous,2774,532,22,21,43,51.2%,5m
21956,3,[ZTempz]Mike,2774,360,21,19,40,52.5%,9m
21956,3,[C49]Sleepless,2774,486,20,19,39,51.3%,48m
21956,3,Clossius,2774,529,19,15,34,55.9%,35m
21956,3,starzero,2774,518,18,19,37,48.6%,35m
21956,3,[NM8]JAIMELEPROX,2774,322,13,8,21,61.9%,33m
21956,3,Stevius,2774,288,11,7,18,61.1%,2h
21956,3,[sk3tch]BillDipperly,2774,277,9,7,16,56.2%,7m
21956,3,Sirxch,2774,206,8,9,17,47.1%,43m
21956,1,Vizerai,2774,183,6,4,10,60.0%,41m
21956,1,Cryo,2774,142,5,4,9,55.6%,3h
21956,2,SkeViHuE,2774,58,5,5,10,50.0%,33m
21956,3,AkilaeTribe,2774,88,4,3,7,57.1%,28m
21956,3,lumpyspheres,2774,30,4,4,8,50.0%,9m
21956,1,Lunaris,2774,48,4,5,9,44.4%,2h
21956,3,Freek,2774,90,4,8,12,33.3%,3m
21956,3,[CfnDgr]GGYaDingus,2774,92,3,3,6,50.0%,35m
21956,3,[ORNG]EnVy,2774,36,3,5,8,37.5%,47m
21956,3,Dart,2774,34,2,1,3,66.7%,9m
21956,3,Sammy,2774,120,2,2,4,50.0%,5m
21956,3,[Kaii]RnGDaN,2774,120,2,4,6,33.3%,4m
21956,3,[ØÛ]Arepakun,2774,58,2,4,6,33.3%,13m
21956,3,ChickenSalt,2774,0,1,0,1,100.0%,47m
21956,3,Frenjyboi,2774,0,1,1,2,50.0%,12m
21956,2,VoltageGrunt,2774,30,1,9,10,10.0%,20m
21956,3,[Astute]Quickfire,2774,0,0,1,1,0.0%,6m
21991,2,NeoZen,2773,1371,151,139,290,52.1%,29m
21991,1,PlanckTime,2773,1374,131,126,257,51.0%,33m
21991,3,[TGosuB]Spawtan,2773,1166,110,100,210,52.4%,9m
21991,3,futurism,2773,1128,73,50,123,59.3%,9m
21991,3,deathbyinch,2773,1073,58,45,103,56.3%,12m
21991,3,BigTotoros,2773,730,50,40,90,55.6%,45m
21991,2,[KBL]akano,2773,1069,46,50,96,47.9%,9m
21991,3,[GRNSKN]MasterJames,2773,975,40,30,70,57.1%,21m
21991,3,pasterostar,2773,1038,38,37,75,50.7%,30m
21991,3,KotW,2773,716,30,26,56,53.6%,5m
21991,3,[NutLow]CptMorgan,2773,656,28,25,53,52.8%,9m
21991,3,minikatz,2773,460,22,14,36,61.1%,8m
21991,3,Reeek,2773,536,22,16,38,57.9%,7m
21991,3,monkeyfeces,2773,483,20,14,34,58.8%,23m
21991,3,ORIN,2773,470,20,18,38,52.6%,26m
21991,3,DarckMaster,2773,336,16,2,18,88.9%,30m
21991,3,Kahn,2773,376,15,11,26,57.7%,30m
21991,3,Sune,2773,294,12,9,21,57.1%,28m
21991,3,Zmyth,2773,182,11,10,21,52.4%,6m
21991,3,[TVV]TWSolar,2773,242,10,3,13,76.9%,16m
21991,2,Eimin,2773,260,10,19,29,34.5%,12m
21991,3,SledgeHead,2773,227,7,3,10,70.0%,1h
21991,3,Cosmic,2773,161,6,0,6,100.0%,16m
21991,1,Vipor,2773,152,6,5,11,54.5%,7m
21991,1,[harvey]allmight,2773,88,5,4,9,55.6%,20m
21991,1,Levi,2773,140,5,5,10,50.0%,33m
21991,3,JuneZerg,2773,30,4,3,7,57.1%,32m
21991,3,asfd,2773,60,3,2,5,60.0%,29m
21991,3,ForTheWin,2773,0,3,3,6,50.0%,23m
21991,2,seeingdouble,2773,48,3,4,7,42.9%,2h
21991,3,jBones,2773,93,2,0,2,100.0%,21m
21991,2,NastyFarts,2773,46,2,6,8,25.0%,7m
21991,3,Starchild,2773,58,2,7,9,22.2%,27m
21991,3,[SpcyPk]MoistJowls,2773,0,1,1,2,50.0%,37m
21991,3,Alpha,2773,30,1,2,3,33.3%,11m
21991,1,[TMN]Gabe,2773,0,0,1,1,0.0%,1h
21991,3,[RMPR]Traxlenak,2773,0,0,1,1,0.0%,34m
21991,3,itachi,2773,0,0,1,1,0.0%,35m
22029,3,yuushoukouho,2772,1556,166,140,306,54.2%,28m
22029,3,Jimi,2772,1621,138,136,274,50.4%,15m
22029,2,[UWISH]GrewalB,2772,1073,103,96,199,51.8%,47m
22029,2,[PRlME]llllllllll,2772,1151,92,83,175,52.6%,33m
22029,3,CowonAPlane,2772,1496,84,60,144,58.3%,5m
22029,3,[PaKAr]LocoTetrico,2772,1403,67,51,118,56.8%,29m
22029,3,MagicofPlaye,2772,713,65,54,119,54.6%,27m
22029,1,cash,2772,854,59,59,118,50.0%,13m
22029,1,GLHF,2772,1016,49,54,103,47.6%,3m
22029,1,noelopaN,2772,915,38,36,74,51.4%,7m
22029,3,Florencio,2772,734,35,10,45,77.8%,30m
22029,3,NAKAMA,2772,241,33,27,60,55.0%,6m
22029,2,Steve,2772,666,24,34,58,41.4%,13m
22029,2,[LGNxx]LePotter,2772,350,12,20,32,37.5%,6m
22029,3,Steve,2772,220,11,5,16,68.8%,45m
22029,2,ffffffffffff,2772,306,10,17,27,37.0%,14m
22029,2,[TWA]Gorfrind,2772,162,7,7,14,50.0%,17m
22029,1,[Bid]Mark,2772,163,6,3,9,66.7%,2h
22029,1,diNg,2772,118,6,9,15,40.0%,1h
22029,3,[XpKAc]Hoperrs,2772,128,5,4,9,55.6%,18m
22029,3,[DarkAG]JKOBE,2772,142,5,6,11,45.5%,7m
22029,3,[XpKAc]BulucChabtan,2772,30,3,4,7,42.9%,34m
22029,3,exile,2772,30,2,2,4,50.0%,20m
22029,3,Kryptosis,2772,0,2,3,5,40.0%,14m
22029,2,[Drakes]SRpugo,2772,0,1,1,2,50.0%,2h
22029,2,Garma,2772,0,1,3,4,25.0%,36m
22029,3,CyMyRy,2772,0,1,4,5,20.0%,1h
22029,3,ZerO,2772,0,0,1,1,0.0%,21m
22029,3,Apollyon,2772,0,0,1,1,0.0%,21m
22029,3,Kactra,2772,0,0,1,1,0.0%,14m
22029,3,DoctorGonzo,2772,0,0,5,5,0.0%,6m
22029,3,thestorm,2772,0,0,6,6,0.0%,7m
22061,1,CIRILO,2771,1599,215,219,434,49.5%,23m
22061,3,ViBE,2771,1347,212,217,429,49.4%,29m
22061,3,JamesBond,2771,1076,90,72,162,55.6%,23m
22061,3,sadada,2771,1563,89,68,157,56.7%,46m
22061,3,ManofHonor,2771,1572,82,64,146,56.2%,16m
22061,3,Jacques,2771,447,79,71,150,52.7%,3m
22061,1,Tamashi,2771,1383,72,69,141,51.1%,16m
22061,3,toto,2771,816,62,55,117,53.0%,34m
22061,3,[TWNNO1]Master,2771,1541,60,54,114,52.6%,12m
22061,2,Charito,2771,1102,44,52,96,45.8%,35m
22061,3,Joker,2771,761,40,10,50,80.0%,27m
22061,2,Pentazimyn,2771,706,29,25,54,53.7%,9m
22061,2,Carnium,2771,495,26,29,55,47.3%,9m
22061,3,TerraTelui,2771,454,19,18,37,51.4%,16m
22061,3,xXStrikerXx,2771,366,14,10,24,58.3%,12m
22061,3,AbeLincoIn,2771,320,12,10,22,54.5%,29m
22061,3,Fighter,2771,289,9,13,22,40.9%,7m
22061,3,Light,2771,149,6,6,12,50.0%,5m
22061,3,yfamily,2771,161,5,3,8,62.5%,22m
22061,1,Bronsky,2771,170,4,4,8,50.0%,1h
22061,1,dirk,2771,48,4,5,9,44.4%,1h
22061,1,[Onixx]BeepNerf,2771,145,3,1,4,75.0%,1h
22061,2,Scorpion,2771,0,3,3,6,50.0%,41m
22061,3,zerling,2771,43,3,5,8,37.5%,29m
22061,3,[LapisL]Elaina,2771,90,2,0,2,100.0%,29m
22061,3,Shinokami,2771,60,2,5,7,28.6%,21m
22061,3,Drin,2771,123,2,9,11,18.2%,14m
22061,3,[JUGOS]AzRael,2771,0,1,0,1,100.0%,20m
22061,3,blakier,2771,30,1,3,4,25.0%,6m
22061,3,ThatGuyy,2771,0,0,1,1,0.0%,34m
22061,3,Velhinho,2771,0,0,2,2,0.0%,9m
22061,2,NumberSix,2771,0,0,4,4,0.0%,22m
22061,3,[Shanks]ThunderWrath,2771,0,0,4,4,0.0%,33m
22061,2,CalmDownBro,2771,0,0,5,5,0.0%,2h
22095,3,[UofC]gday,2770,1582,183,166,349,52.4%,11m
22095,3,DontSquirt,2770,331,91,90,181,50.3%,33m
22095,2,[DarkLS]Jou,2770,1339,68,58,126,54.0%,37m
22095,2,Willy,2770,954,57,58,115,49.6%,20m
22095,2,StrafeBoy,2770,1235,52,44,96,54.2%,28m
22095,3,Sike,2770,1163,50,37,87,57.5%,12m
22095,3,Mydogsmia,2770,920,41,35,76,53.9%,34m
22095,3,AboutToBoke,2770,696,32,28,60,53.3%,44m
22095,3,[SV]MolinaLee,2770,644,31,19,50,62.0%,21m
22095,3,jag,2770,519,29,31,60,48.3%,45m
22095,3,DBullet,2770,542,25,12,37,67.6%,29m
22095,2,[TheDOH]Dark,2770,492,18,22,40,45.0%,7m
22095,3,Riddle,2770,230,15,21,36,41.7%,7m
22095,3,Cegax,2770,270,13,15,28,46.4%,35m
22095,3,[QP]Mrfarfadet,2770,442,13,40,53,24.5%,35m
22095,3,[WSA]PayStation,2770,345,11,11,22,50.0%,15m
22095,3,BlackWolf,2770,202,7,12,19,36.8%,9m
22095,3,kvAlarc,2770,144,6,6,12,50.0%,28m
22095,3,DPOD,2770,142,6,6,12,50.0%,15m
22095,1,GARRUS,2770,148,5,4,9,55.6%,1h
22095,2,[HBDO]DELIVEROO,2770,140,5,6,11,45.5%,32m
22095,2,therensse,2770,0,4,1,5,80.0%,28m
22095,3,PacoElTaco,2770,0,3,2,5,60.0%,28m
22095,3,Dogtornado,2770,62,3,4,7,42.9%,34m
22095,3,veryNiuBi,2770,112,2,1,3,66.7%,46m
22095,3,Olka,2770,0,2,3,5,40.0%,9m
22095,3,ArtaniS,2770,0,1,0,1,100.0%,5m
22095,2,MISTERDUCK,2770,96,1,1,2,50.0%,46m
22095,3,[TGosuC]Reason,2770,0,0,1,1,0.0%,47m
22095,3,Prufrock,2770,0,0,1,1,0.0%,9m
22095,3,[Weac]diSoriEntEd,2770,0,0,1,1,0.0%,36m
22095,1,kevo,2770,0,0,1,1,0.0%,2h
22127,3,popSmoke,2769,1550,410,376,786,52.2%,46m
22127,1,BubblyBlubby,2769,1574,158,155,313,50.5%,25m
22127,3,KRTizzle,2769,1579,93,74,167,55.7%,16m
22127,3,Jyoon,2769,1494,69,52,121,57.0%,33m
22127,2,HotDryNoodle,2769,297,58,52,110,52.7%,14m
22127,3,cholo,2769,846,55,44,99,55.6%,29m
22127,3,[NM8]Maximilian,2769,992,54,45,99,54.5%,47m
22127,3,iTwoCaits,2769,361,53,45,98,54.1%,13m
22127,3,Tarzul,2769,991,38,36,74,51.4%,29m
22127,2,BigKeithNRG,2769,814,28,37,65,43.1%,23m
22127,3,sinister,2769,654,25,25,50,50.0%,33m
22127,2,[SPARKL]Lathentar,2769,538,21,25,46,45.7%,3m
22127,3,Cyberfire,2769,431,19,8,27,70.4%,26m
22127,3,ABYSS,2769,482,16,22,38,42.1%,6m
22127,3,IryS,2769,244,15,11,26,57.7%,6m
22127,3,KingZeo,2769,375,14,13,27,51.9%,6m
22127,3,Zakso,2769,121,12,4,16,75.0%,28m
22127,2,Kiernan,2769,255,10,10,20,50.0%,9m
22127,3,[KRTs]Cheesus,2769,219,7,5,12,58.3%,6m
22127,3,deezy,2769,165,6,7,13,46.2%,3h
22127,3,[TGosuD]Warchief,2769,151,5,3,8,62.5%,5m
22127,3,benniblake,2769,109,4,1,5,80.0%,26m
22127,3,JWSF,2769,88,4,3,7,57.1%,24m
22127,3,SIW,2769,114,4,4,8,50.0%,33m
22127,2,pancakes,2769,40,4,8,12,33.3%,29m
22127,1,Confetti,2769,119,3,0,3,100.0%,14m
22127,3,urek,2769,115,3,0,3,100.0%,35m
22127,3,Glorify,2769,89,3,1,4,75.0%,33m
22127,2,science,2769,95,3,3,6,50.0%,2h
22127,2,Chungusisyum,2769,113,3,4,7,42.9%,2h
22127,2,starjunkie,2769,88,3,5,8,37.5%,7m
22127,1,TopSprouter,2769,58,3,9,12,25.0%,46m
22127,3,kurtox,2769,0,2,3,5,40.0%,20m
22127,3,sneetch,2769,60,2,7,9,22.2%,45m
22127,3,starveliz,2769,60,2,7,9,22.2%,44m
22127,3,Cyax,2769,92,1,1,2,50.0%,17m
22127,1,[TGCrew]TheLimester,2769,97,1,2,3,33.3%,20m
22127,3,neo,2769,30,1,3,4,25.0%,9m
22127,1,JKGRainX,2769,0,0,4,4,0.0%,1h
22127,3,iLLuziOn,2769,0,0,5,5,0.0%,9m
22167,3,Undeniable,2768,1581,293,279,572,51.2%,16m
22167,3,Shinji,2768,563,105,94,199,52.8%,13m
22167,2,Mattbig,2768,1523,99,91,190,52.1%,20m
22167,2,SnapKing,2768,1294,60,53,113,53.1%,17m
22167,3,NoOpponent,2768,492,53,23,76,69.7%,5m
22167,3,NavySil,2768,612,53,56,109,48.6%,36m
22167,2,Vorazun,2768,720,27,28,55,49.1%,29m
22167,3,[KYLE2]VikseveN,2768,446,24,5,29,82.8%,20m
22167,3,Tafirol,2768,560,23,14,37,62.2%,4m
22167,2,Vortextron,2768,135,23,22,45,51.1%,14m
22167,3,DrFauchiMD,2768,313,21,23,44,47.7%,6m
22167,3,aversabilis,2768,229,19,16,35,54.3%,25m
22167,1,crash,2768,478,18,21,39,46.2%,9m
22167,3,[SE4]DarthExecute,2768,307,16,14,30,53.3%,10m
22167,3,[95O]Kaito,2768,220,11,9,20,55.0%,33m
22167,2,eNVy,2768,296,9,14,23,39.1%,23m
22167,3,SamPPsmol,2768,163,8,4,12,66.7%,35m
22167,3,Tavano,2768,202,8,7,15,53.3%,30m
22167,3,[BlTEL]masterlol,2768,214,7,4,11,63.6%,7m
22167,1,[RTCLAN]tienluu,2768,183,6,6,12,50.0%,2h
22167,3,Shwing,2768,146,5,9,14,35.7%,44m
22167,3,Veloce,2768,173,4,9,13,30.8%,34m
22167,3,AngeluS,2768,93,3,3,6,50.0%,33m
22167,1,[Noubs]Yaoung,2768,97,3,5,8,37.5%,1h
22167,2,[CMAX]chrisgam,2768,94,3,9,12,25.0%,14m
22167,2,Metronome,2768,46,2,1,3,66.7%,3h
22167,3,Danimal,2768,110,2,1,3,66.7%,20m
22167,3,Benalow,2768,30,2,1,3,66.7%,46m
22167,3,[0d1N5]Anubis,2768,30,2,2,4,50.0%,48m
22167,3,killerpansy,2768,0,1,0,1,100.0%,34m
22167,3,Zerg,2768,0,1,0,1,100.0%,28m
22167,3,salchi,2768,0,1,0,1,100.0%,20m
22167,2,[SASHA1]Bunny,2768,0,1,1,2,50.0%,2h
22167,3,SantaPresent,2768,93,1,1,2,50.0%,12m
22167,3,oldskool,2768,0,1,2,3,33.3%,25m
22167,3,DooZeyy,2768,0,1,5,6,16.7%,7m
22167,3,mrkiller,2768,0,0,1,1,0.0%,5m
22167,3,Spawn,2768,0,0,1,1,0.0%,32m
22167,3,[B0n3Z]GravyLlama,2768,0,0,2,2,0.0%,34m
22167,3,FactoR,2768,0,0,2,2,0.0%,21m
22167,3,GreyOcelot,2768,0,0,3,3,0.0%,35m
22208,1,CraigMaxtor,2767,1421,313,304,617,50.7%,34m
22208,3,[CODI]Candlejack,2767,1516,143,122,265,54.0%,29m
22208,2,[Cyto]XaNatosS,2767,511,68,61,129,52.7%,28m
22208,2,[Zatra]ChinoBlack,2767,1524,65,65,130,50.0%,34m
22208,3,Shinwelwensa,2767,949,53,39,92,57.6%,17m
22208,3,WAVEdash,2767,634,51,47,98,52.0%,10m
22208,3,[MKzip]snooze,2767,1000,41,38,79,51.9%,33m
22208,3,Tenko,2767,824,32,28,60,53.3%,10m
22208,2,LikeAToss,2767,749,32,30,62,51.6%,25m
22208,3,[SCR0TE]WrathOfBong,2767,770,30,30,60,50.0%,5m
22208,2,berryboy,2767,740,28,31,59,47.5%,45m
22208,2,[PaC]Fulgore,2767,606,21,28,49,42.9%,13m
22208,3,echo,2767,583,20,20,40,50.0%,30m
22208,3,[A3XTR]SgtSpaghetti,2767,330,14,5,19,73.7%,9m
22208,3,[TRASHH]blackside,2767,295,11,7,18,61.1%,5m
22208,3,IlkanAli,2767,248,9,10,19,47.4%,31m
22208,2,lcsulla,2767,250,8,12,20,40.0%,28m
22208,2,[mGbyts]Pookala,2767,251,7,11,18,38.9%,16m
22208,2,[QUDS]Kerberus,2767,184,7,12,19,36.8%,47m
22208,1,ScrotemPole,2767,225,6,2,8,75.0%,38m
22208,3,Tadenshi,2767,0,4,1,5,80.0%,10m
22208,3,gsfagesf,2767,86,4,4,8,50.0%,26m
22208,3,Noctis,2767,115,3,1,4,75.0%,46m
22208,3,Tigerbombz,2767,114,3,1,4,75.0%,21m
22208,3,McFalopa,2767,113,3,1,4,75.0%,22m
22208,2,Inquisitor,2767,94,3,3,6,50.0%,14m
22208,3,ISwipe,2767,30,3,4,7,42.9%,26m
22208,3,grelezmrze,2767,0,3,4,7,42.9%,30m
22208,2,MellowYellow,2767,94,2,0,2,100.0%,44m
22208,3,[NCEs]Raycu,2767,30,2,1,3,66.7%,9m
22208,2,Bob,2767,0,2,3,5,40.0%,1h
22208,2,Napse,2767,0,2,3,5,40.0%,1h
22208,3,Nayr,2767,62,2,7,9,22.2%,10m
22208,3,TROYANO,2767,93,1,1,2,50.0%,12m
22208,1,RyboRage,2767,46,1,2,3,33.3%,2h
22208,2,Sammysamsam,2767,0,1,3,4,25.0%,2h
22208,3,[Serene]Serenity,2767,0,0,1,1,0.0%,22m
22208,3,Threeee,2767,0,0,1,1,0.0%,19m
22208,3,BoHateTerran,2767,0,0,1,1,0.0%,7m
22208,1,Luc,2767,0,0,1,1,0.0%,1h
22248,2,Queequeg,2766,1585,414,403,817,50.7%,12m
22248,2,TheAvenger,2766,1516,218,206,424,51.4%,24m
22248,3,lilas,2766,749,91,60,151,60.3%,16m
22248,3,mazoozoo,2766,1402,69,52,121,57.0%,10m
22248,3,YoshiMitsu,2766,1567,67,59,126,53.2%,28m
22248,3,[AOrder]SpiritEater,2766,1373,58,46,104,55.8%,12m
22248,2,Arcadius,2766,1266,57,42,99,57.6%,18m
22248,3,[Toiley]Seconds,2766,1144,50,47,97,51.5%,9m
22248,3,TheMan,2766,520,46,41,87,52.9%,7m
22248,3,[VGOsc2]Vertigo,2766,205,29,6,35,82.9%,6m
22248,3,DeadlyKitten,2766,610,25,11,36,69.4%,3m
22248,3,Wormy,2766,519,24,9,33,72.7%,13m
22248,2,Comrade,2766,624,23,26,49,46.9%,20m
22248,3,rage,2766,413,21,6,27,77.8%,3m
22248,3,Raiden,2766,339,12,8,20,60.0%,24m
22248,3,[LOSPLR]Volfield,2766,292,11,11,22,50.0%,19m
22248,3,BORED,2766,274,10,8,18,55.6%,12m
22248,3,Ezzy,2766,178,7,9,16,43.8%,29m
22248,2,Rhaegar,2766,30,4,4,8,50.0%,30m
22248,3,RoseGoldKen,2766,94,2,3,5,40.0%,47m
22248,3,justrandhere,2766,0,1,0,1,100.0%,44m
22248,3,JhayrROCK,2766,30,1,3,4,25.0%,5m
22248,3,[SuSC]Keysar,2766,0,0,1,1,0.0%,45m
22248,3,EmpireWasted,2766,0,0,1,1,0.0%,22m
22248,3,vdrean,2766,0,0,1,1,0.0%,15m
22248,3,DrBlowbangMD,2766,0,0,1,1,0.0%,33m
22248,3,oiL,2766,0,0,6,6,0.0%,14m
22275,3,MurderMage,2765,1064,57,49,106,53.8%,34m
22275,2,Telemachus,2765,1270,48,54,102,47.1%,17m
22275,3,[XpKAc]AxelWolf,2765,719,42,32,74,56.8%,45m
22275,3,Murphy,2765,686,30,23,53,56.6%,32m
22275,3,[TvagP]Dender,2765,771,27,27,54,50.0%,11m
22275,3,Toleo,2765,488,20,17,37,54.1%,10m
22275,3,DRiVE,2765,457,19,11,30,63.3%,20m
22275,3,[FALE]Phoenix,2765,436,18,12,30,60.0%,9m
22275,3,JohnyUtah,2765,422,16,13,29,55.2%,32m
22275,3,GGOAT,2765,382,16,15,31,51.6%,13m
22275,3,Ichi,2765,435,16,18,34,47.1%,19m
22275,2,Winbar,2765,314,12,14,26,46.2%,18m
22275,2,[MNDR]Menderbones,2765,311,12,19,31,38.7%,18m
22275,3,Schism,2765,238,11,10,21,52.4%,9m
22275,2,Sareth,2765,258,9,9,18,50.0%,4m
22275,2,[Athena]Tassadar,2765,224,8,8,16,50.0%,37m
22275,3,nikuisgay,2765,228,6,6,12,50.0%,20m
22275,2,BlueSandwich,2765,204,6,12,18,33.3%,37m
22275,2,NNHappyGirl,2765,0,4,1,5,80.0%,36m
22275,3,Silas,2765,167,4,4,8,50.0%,29m
22275,3,madmanAA,2765,88,4,5,9,44.4%,44m
22275,3,[1623]Pepius,2765,118,4,5,9,44.4%,29m
22275,3,RickyAJS,2765,76,4,6,10,40.0%,47m
22275,2,Wetty,2765,204,4,6,10,40.0%,2h
22275,2,epicwamm,2765,0,3,1,4,75.0%,2h
22275,2,art,2765,44,3,4,7,42.9%,2h
22275,2,TBD,2765,46,2,0,2,100.0%,29m
22275,3,PCGamer,2765,0,2,3,5,40.0%,15m
22275,2,ostran,2765,0,2,3,5,40.0%,2h
22275,3,Madhin,2765,30,2,5,7,28.6%,9m
22275,3,groverian,2765,0,0,1,1,0.0%,25m
22275,3,[Asilo]PiterAntony,2765,0,0,1,1,0.0%,31m
22275,3,[rpsc]NiceGuy,2765,0,0,1,1,0.0%,33m
22275,3,trikxizzle,2765,0,0,1,1,0.0%,5m
22275,3,HDRePaNdIDrO,2765,0,0,1,1,0.0%,15m
22310,3,Gual,2764,1492,326,309,635,51.3%,24m
22310,2,Zaglil,2764,980,128,117,245,52.2%,17m
22310,1,Dxito,2764,1485,118,111,229,51.5%,12m
22310,1,evolsteve,2764,1469,99,107,206,48.1%,19m
22310,2,[QcK]therhon,2764,1535,92,85,177,52.0%,33m
22310,3,[Exehn]HeroOfHyrule,2764,1094,77,78,155,49.7%,27m
22310,3,llllllllllll,2764,649,29,16,45,64.4%,44m
22310,3,Microondas,2764,717,29,22,51,56.9%,37m
22310,3,Rayko,2764,627,27,19,46,58.7%,9m
22310,3,[LPrD]Tri,2764,521,25,14,39,64.1%,5m
22310,3,serenitynow,2764,676,25,26,51,49.0%,10m
22310,3,Cloud,2764,525,21,30,51,41.2%,9m
22310,3,ProtCantLose,2764,426,19,9,28,67.9%,16m
22310,3,Purity,2764,508,19,18,37,51.4%,27m
22310,3,creator,2764,410,16,9,25,64.0%,29m
22310,2,[AbcCo]Megab,2764,382,14,16,30,46.7%,33m
22310,3,duomaxwell,2764,331,12,10,22,54.5%,34m
22310,1,Fenser,2764,248,12,12,24,50.0%,29m
22310,2,[YePeS]Hellslol,2764,244,8,12,20,40.0%,14m
22310,3,Tata,2764,148,6,6,12,50.0%,28m
22310,3,BrknTime,2764,225,6,9,15,40.0%,2h
22310,1,SparkleBuns,2764,211,5,3,8,62.5%,2h
22310,3,RicocheT,2764,0,4,1,5,80.0%,5m
22310,3,Gavin,2764,88,4,3,7,57.1%,33m
22310,3,[EtrOy]Fonzy,2764,96,2,0,2,100.0%,34m
22310,3,Maximus,2764,30,2,2,4,50.0%,26m
22310,2,Saruman,2764,0,2,3,5,40.0%,2h
22310,3,Zombie,2764,0,2,3,5,40.0%,34m
22310,3,[GØSU]Gabriel,2764,58,2,4,6,33.3%,14m
22310,3,RichL,2764,0,1,0,1,100.0%,9m
22310,3,[R3K]ZhangFei,2764,30,1,3,4,25.0%,2h
22310,3,Shadows,2764,30,1,3,4,25.0%,19m
22310,3,Yone,2764,0,1,5,6,16.7%,5m
22310,2,DanJones,2764,30,1,8,9,11.1%,16m
22310,3,Alistair,2764,0,0,1,1,0.0%,28m
22310,2,raigomaru,2764,0,0,1,1,0.0%,38m
22310,3,[Mgumin]IventHalcon,2764,0,0,2,2,0.0%,37m
22347,1,dafuq,2763,1534,568,570,1138,49.9%,11m
22347,2,Elax,2763,1478,115,102,217,53.0%,28m
22347,3,torichan,2763,1594,113,102,215,52.6%,29m
22347,3,Instability,2763,1307,96,76,172,55.8%,30m
22347,3,[r4mp4g]Bokonon,2763,1111,95,78,173,54.9%,20m
22347,3,[Altari]SebaXsss,2763,1382,61,53,114,53.5%,10m
22347,3,FUNKYFUNTIME,2763,658,59,55,114,51.8%,35m
22347,3,Buhn,2763,587,33,32,65,50.8%,43m
22347,3,DDan,2763,743,32,28,60,53.3%,36m
22347,2,seb,2763,384,15,19,34,44.1%,16m
22347,3,SlowMan,2763,196,14,15,29,48.3%,6m
22347,2,Johnjohn,2763,132,13,15,28,46.4%,18m
22347,3,Sirus,2763,227,12,4,16,75.0%,16m
22347,3,Delthorin,2763,363,12,13,25,48.0%,24m
22347,3,Lucifer,2763,239,9,5,14,64.3%,10m
22347,3,[G79]imzesok,2763,220,8,4,12,66.7%,12m
22347,3,Bling,2763,178,7,6,13,53.8%,34m
22347,3,christia,2763,196,7,8,15,46.7%,4m
22347,2,CostaRica,2763,210,7,15,22,31.8%,15m
22347,2,Zunn,2763,180,6,4,10,60.0%,33m
22347,3,SgtJames,2763,144,6,5,11,54.5%,30m
22347,2,MTeg,2763,158,5,13,18,27.8%,23m
22347,3,[Ozzie]vergil,2763,118,4,6,10,40.0%,20m
22347,3,ToxicFumes,2763,126,3,2,5,60.0%,13m
22347,3,ChanManX,2763,109,3,4,7,42.9%,9m
22347,2,[xLgNx]Frug,2763,60,2,10,12,16.7%,32m
22347,3,[FSF]Impulse,2763,0,1,0,1,100.0%,20m
22347,3,CaptainBurnz,2763,0,1,1,2,50.0%,6m
22347,3,MarineThots,2763,94,1,2,3,33.3%,34m
22347,3,Marineford,2763,30,1,5,6,16.7%,10m
22347,2,[T30r]YouDontSay,2763,0,0,1,1,0.0%,41m
22347,3,AnanZero,2763,0,0,1,1,0.0%,26m
22379,3,[4L0k0]Pipe,2762,1596,361,342,703,51.4%,21m
22379,3,CRiMiNaL,2762,922,123,102,225,54.7%,12m
22379,3,Serch,2762,695,102,84,186,54.8%,44m
22379,3,chemlab,2762,1483,75,71,146,51.4%,48m
22379,3,[BCBZ]Newton,2762,1443,63,40,103,61.2%,24m
22379,3,ShortToGroun,2762,934,44,24,68,64.7%,38m
22379,3,FDenc,2762,213,28,16,44,63.6%,11m
22379,3,TheGodmentha,2762,570,27,10,37,73.0%,48m
22379,3,lRedRaynorl,2762,358,24,20,44,54.5%,48m
22379,3,Stymee,2762,499,18,16,34,52.9%,30m
22379,3,IIIIIIIIIIII,2762,319,14,8,22,63.6%,33m
22379,3,Gromdown,2762,58,3,2,5,60.0%,28m
22379,3,Charly,2762,145,3,3,6,50.0%,10m
22379,1,[WarBro]MisterWiggle,2762,0,3,5,8,37.5%,34m
22379,3,NombreBacán,2762,30,2,3,5,40.0%,28m
22379,3,Gaara,2762,0,2,4,6,33.3%,22m
22379,2,Matte,2762,0,1,0,1,100.0%,2h
22379,3,Salem,2762,0,1,0,1,100.0%,19m
22379,3,heman,2762,94,1,2,3,33.3%,16m
22379,1,DevitcaRed,2762,46,1,2,3,33.3%,33m
22379,3,Poosehil,2762,0,0,1,1,0.0%,7m
22379,3,JoeyC,2762,0,0,2,2,0.0%,46m
22379,3,[xATx]Fanboyftw,2762,0,0,4,4,0.0%,9m
22402,3,[Nihity]Danithewolf,2761,928,195,185,380,51.3%,37m
22402,3,MurilloCR,2761,1548,124,85,209,59.3%,31m
22402,3,[ZTemps]Tengu,2761,1329,107,95,202,53.0%,10m
22402,3,Doctoss,2761,1219,92,78,170,54.1%,9m
22402,3,Bigdickbison,2761,1031,70,40,110,63.6%,10m
22402,3,[D3m0N]ZepoL,2761,716,57,52,109,52.3%,4m
22402,2,EmperorBiden,2761,960,41,42,83,49.4%,37m
22402,2,AbeNoKai,2761,934,36,34,70,51.4%,23m
22402,3,MrChuck,2761,523,30,33,63,47.6%,13m
22402,3,LilBomby,2761,171,19,11,30,63.3%,9m
22402,3,[NuEra]Wolf,2761,540,19,24,43,44.2%,8m
22402,3,dotablaze,2761,380,17,10,27,63.0%,10m
22402,3,Rodolfinho,2761,404,17,16,33,51.5%,46m
22402,3,Mentos,2761,326,14,5,19,73.7%,13m
22402,3,KaiHayabusa,2761,241,10,10,20,50.0%,30m
22402,2,CronFizzle,2761,81,10,13,23,43.5%,13m
22402,3,[PvZAll]Hope,2761,188,9,5,14,64.3%,4m
22402,3,[AbcCo]elvilca,2761,195,8,1,9,88.9%,24m
22402,3,Andy,2761,152,6,7,13,46.2%,33m
22402,3,[SM0K3]PurpleHaze,2761,135,5,5,10,50.0%,31m
22402,1,Fruitcake,2761,96,5,7,12,41.7%,2h
22402,3,[aq]Dankrupt,2761,106,4,3,7,57.1%,44m
22402,3,[TMSyN]bobs,2761,169,4,4,8,50.0%,44m
22402,3,JacenSolo,2761,30,4,4,8,50.0%,5m
22402,1,kingnoob,2761,97,4,5,9,44.4%,12m
22402,3,guise,2761,58,3,2,5,60.0%,29m
22402,3,DragonBerry,2761,92,3,3,6,50.0%,43m
22402,2,YourFather,2761,0,3,3,6,50.0%,29m
22402,3,xuaeval,2761,92,3,3,6,50.0%,33m
22402,2,[JUGOS2]Crynux,2761,0,2,1,3,66.7%,2h
22402,3,Guyledouche,2761,30,2,2,4,50.0%,5m
22402,3,Kad,2761,30,2,3,5,40.0%,29m
22402,3,SoLegit,2761,0,2,3,5,40.0%,22m
22402,1,CrazySushi,2761,121,2,7,9,22.2%,35m
22402,3,Doruru,2761,0,1,0,1,100.0%,33m
22402,3,Sheepy,2761,30,1,2,3,33.3%,29m
22402,3,[GaiLo]Everest,2761,30,1,2,3,33.3%,29m
22402,3,Eckart,2761,0,1,2,3,33.3%,8m
22402,3,[ICES]tyron,2761,0,1,4,5,20.0%,11m
22402,2,Aniko,2761,0,0,1,1,0.0%,24m
22442,2,Ramil,2760,649,87,76,163,53.4%,29m
22442,3,TheLegend,2760,1224,59,38,97,60.8%,29m
22442,3,[Pig2]DEMONDRAGON,2760,1100,53,45,98,54.1%,45m
22442,3,kobrahunter,2760,260,50,39,89,56.2%,18m
22442,3,lll,2760,945,46,32,78,59.0%,37m
22442,3,[TPGGXD]sebmati,2760,973,46,34,80,57.5%,48m
22442,3,Niko,2760,532,39,34,73,53.4%,6m
22442,2,Ynsane,2760,546,19,26,45,42.2%,7m
22442,1,llllllll,2760,354,15,16,31,48.4%,35m
22442,2,TheKing,2760,370,13,20,33,39.4%,20m
22442,1,Camith,2760,275,9,5,14,64.3%,31m
22442,3,Harmony,2760,236,8,5,13,61.5%,22m
22442,2,[SMOL]QueerMuhamad,2760,130,8,6,14,57.1%,4m
22442,1,LongMeat,2760,280,8,7,15,53.3%,2h
22442,1,GreyFox,2760,138,5,4,9,55.6%,2h
22442,1,NaDa,2760,165,5,6,11,45.5%,1h
22442,3,AlteredBeast,2760,132,4,1,5,80.0%,21m
22442,3,IlIlIlIlIlIl,2760,137,4,2,6,66.7%,47m
22442,3,prodigg,2760,0,1,0,1,100.0%,31m
22442,1,[malloc]stevesnemesi,2760,0,1,0,1,100.0%,2h
22442,3,HeisenZerg,2760,0,1,1,2,50.0%,45m
22442,3,[Banqe]Leo,2760,0,1,3,4,25.0%,23m
22442,3,Chrispy,2760,0,1,3,4,25.0%,33m
22442,3,Kukuri,2760,0,0,1,1,0.0%,16m
22442,3,GreenMachine,2760,0,0,2,2,0.0%,9m
22442,3,[KPx]Elmigue,2760,0,0,2,2,0.0%,17m
22442,3,MittRomney,2760,0,0,3,3,0.0%,29m
22442,1,Jerryums,2760,0,0,3,3,0.0%,2h
22442,3,SERGIOJR,2760,0,0,6,6,0.0%,23m
22471,1,deyeplz,2759,1158,420,414,834,50.4%,7m
22471,3,Katuzara,2759,1029,212,199,411,51.6%,6m
22471,3,ZehWallace,2759,1086,160,148,308,51.9%,17m
22471,3,[GBOYZ]Dondroid,2759,1360,105,80,185,56.8%,12m
22471,3,Awakened,2759,682,104,88,192,54.2%,24m
22471,3,snezzy,2759,1572,96,73,169,56.8%,15m
22471,2,MrMeeseeks,2759,1528,89,77,166,53.6%,8m
22471,2,DawnsElite,2759,1031,52,47,99,52.5%,34m
22471,3,[TgAg]lushina,2759,1028,40,37,77,51.9%,26m
22471,3,[DToS]Zendorhan,2759,688,32,25,57,56.1%,31m
22471,3,[OCBO]chickenlota,2759,404,27,25,52,51.9%,20m
22471,1,vvolfie,2759,494,21,35,56,37.5%,34m
22471,3,JackDupp,2759,451,18,15,33,54.5%,12m
22471,2,[HRZCOK]sPiKe,2759,505,18,22,40,45.0%,36m
22471,2,[ZOMO]Edufardo,2759,185,8,10,18,44.4%,11m
22471,3,DeltaAlphaNu,2759,104,6,2,8,75.0%,2h
22471,3,[GOPERÚ]Rohan,2759,120,5,5,10,50.0%,14m
22471,3,SoundandFury,2759,120,5,7,12,41.7%,12m
22471,2,leatherneck,2759,0,4,1,5,80.0%,41m
22471,1,mrchuseau,2759,144,3,8,11,27.3%,2h
22471,1,[Manco5]Xuiz,2759,141,3,9,12,25.0%,2h
22471,1,Reihatsu,2759,0,2,3,5,40.0%,12m
22471,1,aldezerg,2759,0,1,0,1,100.0%,2h
22471,3,[W00D]Bamboo,2759,0,0,1,1,0.0%,2h
22471,1,Bojangles,2759,0,0,1,1,0.0%,2h
22471,3,zackman,2759,0,0,1,1,0.0%,2h
22471,1,wwr,2759,0,0,1,1,0.0%,2h
22498,1,Suntzu,2758,1500,142,139,281,50.5%,12m
22498,1,dethbiphartz,2758,1424,52,66,118,44.1%,38m
22498,3,javier,2758,221,41,26,67,61.2%,22m
22498,3,henessyXO,2758,567,34,29,63,54.0%,36m
22498,1,Zosma,2758,656,31,41,72,43.1%,10m
22498,3,[KSTONE]Ninju,2758,276,21,26,47,44.7%,35m
22498,3,KopiOAis,2758,396,15,11,26,57.7%,26m
22498,1,PltrgstCCH,2758,335,12,7,19,63.2%,31m
22498,2,cummyblanket,2758,346,12,9,21,57.1%,1h
22498,3,Safetyman,2758,158,10,11,21,47.6%,4m
22498,3,[WubLub]rayongw,2758,240,9,11,20,45.0%,48m
22498,3,Ghost,2758,202,8,7,15,53.3%,10m
22498,3,Powerhaus,2758,156,6,7,13,46.2%,24m
22498,1,Szaron,2758,208,6,8,14,42.9%,24m
22498,3,DeathAngelHN,2758,111,5,7,12,41.7%,5m
22498,3,Vaeleran,2758,164,5,7,12,41.7%,45m
22498,3,mEDiocrLemur,2758,116,5,8,13,38.5%,36m
22498,3,[a99]Megabyte,2758,124,4,11,15,26.7%,29m
22498,3,Punisher,2758,119,3,2,5,60.0%,4m
22498,1,Pubbbb,2758,120,3,2,5,60.0%,1h
22498,3,YoungMoney,2758,60,3,3,6,50.0%,17m
22498,2,Unity,2758,60,2,6,8,25.0%,16m
22498,1,StarsAbove,2758,0,1,0,1,100.0%,1h
22498,1,DarkMaster,2758,0,1,1,2,50.0%,2h
22498,1,CubeEarth,2758,42,1,1,2,50.0%,2h
22498,3,Rocko,2758,24,1,4,5,20.0%,26m
22498,1,[KTAUD1]nemownz,2758,0,0,1,1,0.0%,2h
22498,2,herO,2758,0,0,1,1,0.0%,25m
22498,1,Kubes,2758,0,0,1,1,0.0%,22m
22498,1,DinkMeeker,2758,0,0,2,2,0.0%,2h
22498,2,Berezovsky,2758,0,0,2,2,0.0%,2h
22529,3,Alexander,2757,1534,124,97,221,56.1%,15m
22529,2,Feinrandir,2757,986,84,80,164,51.2%,48m
22529,3,[4aRaza]KakashiSan,2757,908,42,39,81,51.9%,34m
22529,3,[Gooman]TonyChunga,2757,534,26,11,37,70.3%,46m
22529,3,Jerry,2757,260,9,14,23,39.1%,28m
22529,1,Tony,2757,254,8,5,13,61.5%,12m
22529,1,REDvBLUE,2757,214,8,6,14,57.1%,32m
22529,3,[Apan]jims,2757,197,6,4,10,60.0%,44m
22529,2,Ninjaboy,2757,190,6,19,25,24.0%,48m
22529,3,VODKANCRAN,2757,163,5,2,7,71.4%,6m
22529,2,KeyLock,2757,92,4,3,7,57.1%,2h
22529,3,AionSoul,2757,60,3,2,5,60.0%,47m
22529,2,[LifeF]keLp,2757,0,3,3,6,50.0%,2h
22529,1,Blue,2757,42,2,0,2,100.0%,1h
22529,3,ditto,2757,115,2,2,4,50.0%,26m
22529,1,ZEUS,2757,0,2,3,5,40.0%,17m
22529,1,[tCo9]Voidwarrior,2757,0,0,1,1,0.0%,1h
22529,1,SomEonEsbuTT,2757,0,0,1,1,0.0%,3h
22547,2,ICE,2756,1389,264,258,522,50.6%,31m
22547,3,[EZTZPZ]ArchSyntropy,2756,967,53,46,99,53.5%,26m
22547,1,JKa,2756,967,36,25,61,59.0%,1h
22547,3,[SKSR]FukdUpBack,2756,533,24,14,38,63.2%,44m
22547,3,TheBoulder,2756,471,18,14,32,56.2%,48m
22547,3,seansc,2756,369,17,15,32,53.1%,29m
22547,3,[OhSoEz]Jamm,2756,222,16,18,34,47.1%,11m
22547,3,Hector,2756,288,13,13,26,50.0%,32m
22547,2,mattluke,2756,282,10,17,27,37.0%,17m
22547,1,Gtc,2756,354,9,8,17,52.9%,2h
22547,2,noruego,2756,102,6,3,9,66.7%,9m
22547,2,llllllllllll,2756,149,5,3,8,62.5%,29m
22547,2,[TSCP]Ashtah,2756,58,5,5,10,50.0%,45m
22547,1,INFINITE,2756,103,5,7,12,41.7%,33m
22547,1,AbztraK,2756,117,4,8,12,33.3%,48m
22547,2,tehsumo,2756,0,3,2,5,60.0%,2h
22547,2,Telepaper,2756,94,3,2,5,60.0%,2h
22547,3,kvothee,2756,60,3,3,6,50.0%,9m
22547,1,Airusj,2756,0,3,6,9,33.3%,33m
22547,2,TehRaS,2756,48,2,1,3,66.7%,2h
22547,3,trinket,2756,93,2,1,3,66.7%,37m
22547,2,bigAL,2756,38,2,2,4,50.0%,1h
22547,3,LisaSCToo,2756,60,2,7,9,22.2%,46m
22547,3,MrPomPay,2756,0,1,1,2,50.0%,11m
22547,2,AVNG,2756,46,1,1,2,50.0%,42m
22547,1,MagicJohnson,2756,40,1,1,2,50.0%,42m
22547,1,dead,2756,0,0,1,1,0.0%,2h
22547,1,Carmesi,2756,0,0,1,1,0.0%,2h
22547,3,Hurricane,2756,0,0,2,2,0.0%,29m
22576,1,[tCo9]RnchroCsmico,2755,1538,251,249,500,50.2%,4m
22576,2,QamFour,2755,1532,211,204,415,50.8%,31m
22576,3,cykablyat,2755,1036,135,123,258,52.3%,45m
22576,3,FoRAiuR,2755,841,109,96,205,53.2%,23m
22576,2,Rathemos,2755,1304,75,69,144,52.1%,11m
22576,2,[EDMN]Velcius,2755,1128,42,44,86,48.8%,17m
22576,3,Zealoids,2755,437,36,29,65,55.4%,16m
22576,2,[N3RDST]BigJoeLogs,2755,756,29,31,60,48.3%,31m
22576,3,MaiLyf,2755,527,22,17,39,56.4%,10m
22576,3,Russell,2755,421,17,17,34,50.0%,16m
22576,2,[αB]LiquidFate,2755,402,15,18,33,45.5%,20m
22576,3,TheBoomer,2755,344,12,8,20,60.0%,2h
22576,3,Slappy,2755,268,9,7,16,56.2%,48m
22576,3,YoungTiger,2755,268,9,8,17,52.9%,29m
22576,3,[GØSU]Daxon,2755,213,8,9,17,47.1%,16m
22576,1,[WWP2]shaGz,2755,182,8,9,17,47.1%,40m
22576,1,[BTRS]BateriaSeria,2755,159,7,4,11,63.6%,3h
22576,3,[RLRC]BreaktheSky,2755,190,6,4,10,60.0%,10m
22576,1,FourTwentyXD,2755,0,4,1,5,80.0%,1h
22576,1,[JDPWN]Collamus,2755,116,4,2,6,66.7%,2h
22576,1,imnotoped,2755,116,3,2,5,60.0%,2h
22576,3,Jigokudo,2755,60,3,3,6,50.0%,6m
22576,3,[ZTempz]Microvawe,2755,58,3,4,7,42.9%,12m
22576,3,[TNBII]barry,2755,88,3,9,12,25.0%,14m
22576,3,Friedrich,2755,60,2,5,7,28.6%,19m
22576,1,ShadowMercs,2755,0,1,0,1,100.0%,2h
22576,3,ryanfury,2755,0,1,2,3,33.3%,22m
22576,1,TheBadBoss,2755,0,0,1,1,0.0%,17m
22576,2,ruppanator,2755,0,0,6,6,0.0%,2h
22605,2,Reflect,2754,1385,227,218,445,51.0%,38m
22605,3,lowkey,2754,1292,115,102,217,53.0%,23m
22605,3,JCupcakes,2754,537,74,43,117,63.2%,36m
22605,2,susilo,2754,470,74,67,141,52.5%,26m
22605,2,Disco,2754,1000,63,55,118,53.4%,14m
22605,3,CerealKiller,2754,1181,46,45,91,50.5%,9m
22605,3,[Fr0nt]stacker,2754,251,44,44,88,50.0%,15m
22605,1,Orami,2754,541,42,42,84,50.0%,16m
22605,3,[DUMY]lujer,2754,746,33,26,59,55.9%,13m
22605,2,Hoostin,2754,565,19,25,44,43.2%,23m
22605,3,ReyBear,2754,415,17,15,32,53.1%,19m
22605,1,DubiousMD,2754,211,8,6,14,57.1%,3h
22605,2,DigitalBath,2754,229,8,11,19,42.1%,8m
22605,2,Corik,2754,114,3,5,8,37.5%,28m
22605,1,Issac,2754,58,3,9,12,25.0%,29m
22605,1,[TCoAz]Soccergoalie,2754,42,2,0,2,100.0%,45m
22605,1,[BOBAC]Kabbale,2754,76,2,2,4,50.0%,3h
22605,3,SpicyTime,2754,0,1,2,3,33.3%,36m
22605,3,Vespertinian,2754,30,1,4,5,20.0%,45m
22605,1,[Onward]Entelechy,2754,0,0,1,1,0.0%,39m
22605,1,[Ratty]TheRealFatty,2754,0,0,5,5,0.0%,1h
22626,2,ilikeladies,2753,1543,413,405,818,50.5%,20m
22626,1,MincheRrat,2753,878,73,63,136,53.7%,29m
22626,3,ninecorpses,2753,609,63,45,108,58.3%,34m
22626,1,Crayak,2753,837,34,45,79,43.0%,4m
22626,3,Rocketdevil,2753,660,33,24,57,57.9%,47m
22626,3,[TTKOPF]Arrow,2753,351,13,8,21,61.9%,25m
22626,3,EricJ,2753,120,10,8,18,55.6%,1h
22626,1,Lazypanda,2753,294,9,3,12,75.0%,1h
22626,1,[JINGO]Bluecat,2753,229,9,3,12,75.0%,29m
22626,3,[P3AC3]Reflection,2753,324,9,13,22,40.9%,10m
22626,1,James,2753,210,8,10,18,44.4%,5m
22626,3,OblivionKing,2753,58,5,5,10,50.0%,28m
22626,2,Daywalker,2753,0,4,3,7,57.1%,31m
22626,3,[90RN]thehump,2753,30,4,3,7,57.1%,29m
22626,1,Edufardo,2753,127,4,4,8,50.0%,4m
22626,2,Mabel,2753,0,3,3,6,50.0%,41m
22626,1,Zekefreid,2753,90,3,3,6,50.0%,2h
22626,1,jmartin,2753,80,2,1,3,66.7%,28m
22626,1,Elgimpo,2753,48,2,3,5,40.0%,2h
22626,1,Orbod,2753,0,1,0,1,100.0%,2h
22626,3,Chiddybang,2753,0,1,1,2,50.0%,35m
22626,1,Blenger,2753,42,1,1,2,50.0%,17m
22626,3,WHAT,2753,0,1,1,2,50.0%,5m
22626,3,Darkmaster,2753,0,1,2,3,33.3%,17m
22626,1,Wrex,2753,94,1,2,3,33.3%,12m
22651,2,AresComplex,2752,261,124,112,236,52.5%,9m
22651,2,Natethegreat,2752,1226,91,92,183,49.7%,48m
22651,3,[GOOBUE]TheWalrus,2752,1549,63,51,114,55.3%,32m
22651,3,[KGB]kushinator,2752,880,55,47,102,53.9%,48m
22651,2,cakeledgend,2752,1080,43,36,79,54.4%,25m
22651,1,aaronblue,2752,666,24,19,43,55.8%,2h
22651,2,GLADIADOR,2752,371,23,25,48,47.9%,47m
22651,3,[zeez]lolbuttes,2752,361,16,10,26,61.5%,33m
22651,3,[FNDog]FNDAlTheLiar,2752,407,16,17,33,48.5%,29m
22651,3,cucasxdxdxd,2752,342,15,13,28,53.6%,46m
22651,1,Titans,2752,430,13,13,26,50.0%,1h
22651,1,hatchet,2752,335,11,13,24,45.8%,2h
22651,3,liquidpain,2752,310,11,15,26,42.3%,6m
22651,3,TrieLa,2752,205,8,7,15,53.3%,30m
22651,2,[DRKDNA]Shilowind,2752,184,7,15,22,31.8%,26m
22651,1,WoodLeague,2752,265,6,8,14,42.9%,2h
22651,3,shortcutz,2752,147,5,1,6,83.3%,13m
22651,1,Shuann,2752,188,5,4,9,55.6%,43m
22651,2,DarkAdino,2752,94,5,5,10,50.0%,2h
22651,3,myNINJAjoe,2752,62,3,4,7,42.9%,44m
22651,1,[OverW]SilkySmooth,2752,96,2,1,3,66.7%,45m
22651,3,[EcoWar]bobelidude,2752,30,2,2,4,50.0%,9m
22651,2,Gunmiles,2752,0,2,3,5,40.0%,3h
22651,1,Mira,2752,0,2,3,5,40.0%,1h
22651,1,Raphael,2752,0,1,0,1,100.0%,1h
22651,1,[DugNut]JuiceOfDaBox,2752,0,1,0,1,100.0%,2h
22651,1,[JFeedZ]MouzShin,2752,44,1,5,6,16.7%,16m
22651,1,frankay,2752,0,0,1,1,0.0%,1h
22679,3,Diegth,2751,1591,170,155,325,52.3%,44m
22679,3,Steok,2751,1262,138,125,263,52.5%,29m
22679,3,Bren,2751,1344,126,108,234,53.8%,9m
22679,2,[LNTM]SpartanTy,2751,1572,74,75,149,49.7%,45m
22679,3,robocaller,2751,965,46,32,78,59.0%,16m
22679,3,MadeofStars,2751,533,32,21,53,60.4%,44m
22679,3,[sk3tch]ANestesiA,2751,408,21,16,37,56.8%,22m
22679,1,dayton,2751,612,21,35,56,37.5%,7m
22679,3,RRRMMM,2751,399,17,8,25,68.0%,33m
22679,3,Staltronus,2751,402,16,14,30,53.3%,28m
22679,3,[Dogee]biznatch,2751,324,14,8,22,63.6%,47m
22679,3,[NXLsc]SiCaRiO,2751,406,14,12,26,53.8%,11m
22679,3,Conde,2751,338,13,13,26,50.0%,33m
22679,3,Samtehman,2751,326,12,8,20,60.0%,31m
22679,3,WillahG,2751,245,8,6,14,57.1%,48m
22679,1,EazyE,2751,223,7,10,17,41.2%,12m
22679,3,ZakNakuAfal,2751,107,5,4,9,55.6%,29m
22679,1,[HW420]DroPê,2751,122,4,0,4,100.0%,14m
22679,3,matracas,2751,106,3,2,5,60.0%,15m
22679,1,Zlatan,2751,0,3,2,5,60.0%,2h
22679,3,NouBHawj,2751,123,3,5,8,37.5%,2h
22679,3,SpaceFrog,2751,95,2,1,3,66.7%,4m
22679,1,RageForger,2751,34,1,2,3,33.3%,2h
22679,3,chaifalooda,2751,0,0,2,2,0.0%,10m
22703,3,clarkritenow,2750,817,613,616,1229,49.9%,6m
22703,2,Jangkrikmuda,2750,1396,102,99,201,50.7%,34m
22703,2,Hajunpla,2750,1334,89,95,184,48.4%,26m
22703,3,MieresDEgo,2750,950,69,61,130,53.1%,29m
22703,1,Heated,2750,1444,65,53,118,55.1%,35m
22703,1,Jamgasm,2750,1192,49,31,80,61.2%,17m
22703,2,[RCSM]Frankkexx,2750,1063,41,42,83,49.4%,15m
22703,3,[LMS69]Bane,2750,944,36,37,73,49.3%,18m
22703,2,Damiao,2750,625,34,45,79,43.0%,25m
22703,2,Shrimpy,2750,313,12,8,20,60.0%,31m
22703,3,[HiNRG]BzKTatir,2750,293,12,11,23,52.2%,23m
22703,3,[TCProG]BigAlGouda,2750,305,10,10,20,50.0%,37m
22703,2,[MexTab]Mewo,2750,182,7,15,22,31.8%,9m
22703,3,MissIodine,2750,166,6,2,8,75.0%,21m
22703,1,Mills,2750,214,6,5,11,54.5%,19m
22703,1,Lorcan,2750,144,6,7,13,46.2%,2h
22703,3,[KingSC]JotaCe,2750,191,5,5,10,50.0%,16m
22703,1,Nietzsche,2750,204,5,10,15,33.3%,2h
22703,1,alghouti,2750,96,3,4,7,42.9%,42m
22703,3,Grubox,2750,90,3,5,8,37.5%,48m
22703,3,[LoT]Juicyja,2750,30,2,2,4,50.0%,36m
22703,1,[codaru]NEODAEDALUS,2750,80,2,2,4,50.0%,2h
22703,1,nebbeth,2750,0,2,3,5,40.0%,24m
22703,2,[BATTOD]AngryElf,2750,0,1,0,1,100.0%,1h
22703,1,BUZZ,2750,0,1,0,1,100.0%,29m
22703,3,Tigger,2750,0,1,1,2,50.0%,10m
22703,3,Nubtorious,2750,0,1,1,2,50.0%,30m
22703,1,lmbrjaksoldr,2750,0,0,1,1,0.0%,3h
22703,1,Monstrosity,2750,0,0,1,1,0.0%,2h
22703,1,pbi,2750,0,0,1,1,0.0%,2h
22703,3,LordG,2750,0,0,2,2,0.0%,10m
22703,3,Raze,2750,0,0,3,3,0.0%,34m
22703,3,Losteffect,2750,0,0,4,4,0.0%,34m
22736,3,Jellydonut,2749,1581,225,216,441,51.0%,9m
22736,2,[309]Art,2749,1105,187,179,366,51.1%,27m
22736,3,Lescaut,2749,1137,106,99,205,51.7%,10m
22736,3,SolArgenti,2749,662,54,28,82,65.9%,29m
22736,1,MasterParrot,2749,1095,43,31,74,58.1%,2h
22736,2,TopHatRhino,2749,618,28,36,64,43.8%,14m
22736,1,[KoHa]phantom,2749,504,15,13,28,53.6%,1h
22736,1,EthicitE,2749,182,5,1,6,83.3%,16m
22736,3,panda,2749,166,5,2,7,71.4%,27m
22736,3,Magdalenita,2749,93,5,7,12,41.7%,30m
22736,1,WWolf,2749,126,4,3,7,57.1%,2h
22736,3,[INextI]IMomotaro,2749,90,4,5,9,44.4%,24m
22736,1,PotatoMan,2749,0,2,3,5,40.0%,2h
22736,1,ReventaCulos,2749,0,2,4,6,33.3%,2h
22736,1,[rh1no]nothership,2749,38,1,1,2,50.0%,2h
22736,1,SirAndrius,2749,40,1,1,2,50.0%,2h
22736,3,[MTLG]Noah,2749,30,1,3,4,25.0%,48m
22736,3,[LIONES]PerroRabioso,2749,30,1,3,4,25.0%,35m
22736,3,[DNKCFT]ePHeCt,2749,30,1,3,4,25.0%,26m
22736,3,Curley,2749,30,1,3,4,25.0%,12m
22736,1,Lycog,2749,0,0,1,1,0.0%,40m
22757,3,Xact,2748,1207,195,174,369,52.8%,23m
22757,1,xac,2748,1786,130,115,245,53.1%,1h
22757,3,coffee,2748,1077,92,59,151,60.9%,46m
22757,3,Nyoei,2748,922,73,64,137,53.3%,44m
22757,3,[Shang]Scythe,2748,1497,71,45,116,61.2%,13m
22757,3,terminator,2748,1504,62,53,115,53.9%,10m
22757,2,Thanos,2748,1366,60,59,119,50.4%,18m
22757,3,[6G]clauser,2748,511,31,19,50,62.0%,44m
22757,3,EnemyAI,2748,575,22,20,42,52.4%,28m
22757,3,Slim,2748,501,18,16,34,52.9%,32m
22757,3,SaltyMeat,2748,406,16,15,31,51.6%,29m
22757,3,GeneralJJ,2748,414,15,12,27,55.6%,30m
22757,1,[Z4TS]Evanator,2748,411,14,4,18,77.8%,1h
22757,1,[AbcCo]FinnyInLove,2748,368,14,4,18,77.8%,2h
22757,3,jimrusher,2748,300,11,15,26,42.3%,35m
22757,2,[escape]idleworker,2748,302,11,16,27,40.7%,9m
22757,3,HighFlyer,2748,259,10,5,15,66.7%,45m
22757,3,SMNs,2748,247,8,9,17,47.1%,36m
22757,3,diego,2748,199,8,10,18,44.4%,2h
22757,2,[HENT4l]mdPePPer,2748,30,5,5,10,50.0%,37m
22757,1,[MadMON]MELEKAI,2748,0,4,1,5,80.0%,2h
22757,3,yleM,2748,0,3,3,6,50.0%,14m
22757,1,[IGeass]KnightOfZero,2748,44,2,0,2,100.0%,1h
22757,1,[1E100]halflings,2748,0,1,0,1,100.0%,1h
22757,2,Quezendogger,2748,48,1,1,2,50.0%,30m
22757,1,AdunxZeratul,2748,44,1,1,2,50.0%,32m
22757,3,RainbowDash,2748,30,1,3,4,25.0%,12m
22757,2,ATunaOnWhite,2748,0,0,1,1,0.0%,2h
22757,1,petchayatorn,2748,0,0,1,1,0.0%,2h
22757,3,Dodyer,2748,0,0,3,3,0.0%,45m
22787,3,Ronico,2747,1550,107,105,212,50.5%,32m
22787,1,EnderWiggin,2747,1479,92,84,176,52.3%,2h
22787,3,natetawn,2747,1224,64,63,127,50.4%,10m
22787,1,Caemil,2747,1016,62,49,111,55.9%,17m
22787,2,lIKOREANlI,2747,955,46,47,93,49.5%,29m
22787,3,[DXPCA]BondFire,2747,637,31,18,49,63.3%,32m
22787,2,Netero,2747,564,26,19,45,57.8%,14m
22787,3,[REDI]AeonStrife,2747,226,16,16,32,50.0%,29m
22787,3,Poseidon,2747,316,11,8,19,57.9%,26m
22787,3,[ValidG]Willwillwin,2747,320,10,11,21,47.6%,18m
22787,3,Bobber,2747,221,9,9,18,50.0%,25m
22787,3,Spu,2747,167,6,2,8,75.0%,10m
22787,3,DrCyborg,2747,184,6,13,19,31.6%,18m
22787,1,[pajaro]ELE,2747,122,4,1,5,80.0%,2h
22787,1,[KingSC]PlasmaHN,2747,192,4,5,9,44.4%,3h
22787,2,Orange,2747,30,4,5,9,44.4%,18m
22787,2,DAF,2747,92,3,4,7,42.9%,2h
22787,3,[PTHero]Unrefined,2747,107,2,2,4,50.0%,45m
22787,2,[NNW]Fettison,2747,0,2,3,5,40.0%,2h
22787,2,Karandras,2747,0,2,3,5,40.0%,2h
22787,1,Trichomonas,2747,42,1,1,2,50.0%,1h
22787,3,Saldanha,2747,0,1,1,2,50.0%,7m
22787,3,Sterben,2747,0,1,2,3,33.3%,5m
22787,3,Pouding,2747,0,0,2,2,0.0%,9m
22787,3,yoSandman,2747,0,0,5,5,0.0%,36m
22812,2,[T4Y]SgtBaker,2746,1119,272,253,525,51.8%,26m
22812,2,FluffyPuppy,2746,1541,204,197,401,50.9%,14m
22812,1,Gelo,2746,1308,131,121,252,52.0%,36m
22812,3,Madmonk,2746,1155,121,107,228,53.1%,29m
22812,3,[GGMESP]Mozart,2746,700,74,62,136,54.4%,8m
22812,2,[SWlNE]Depre,2746,797,31,38,69,44.9%,32m
22812,2,piXelchiX,2746,724,30,32,62,48.4%,48m
22812,1,Shadow,2746,592,27,24,51,52.9%,2h
22812,2,Izzy,2746,686,27,29,56,48.2%,24m
22812,2,BJP,2746,736,27,30,57,47.4%,12m
22812,3,Ferg,2746,439,25,28,53,47.2%,30m
22812,2,AplBMcFriday,2746,365,23,30,53,43.4%,20m
22812,3,itchyrear,2746,430,18,15,33,54.5%,16m
22812,3,Biggy,2746,402,18,15,33,54.5%,29m
22812,3,[40oztF]Nilloc,2746,381,16,8,24,66.7%,33m
22812,2,LUCIFER,2746,311,12,22,34,35.3%,22m
22812,2,Icebrush,2746,272,9,10,19,47.4%,15m
22812,3,KuroNekoII,2746,230,7,6,13,53.8%,45m
22812,2,[PCQ]BeastLight,2746,155,6,2,8,75.0%,2h
22812,3,Ketch,2746,171,5,3,8,62.5%,22m
22812,3,HowlingElf,2746,120,5,9,14,35.7%,28m
22812,1,ChapDaddy,2746,100,3,1,4,75.0%,1h
22812,1,IdrA,2746,38,3,3,6,50.0%,17m
22812,3,supraspeed,2746,122,3,3,6,50.0%,16m
22812,1,PhaseLethal,2746,40,2,0,2,100.0%,23m
22812,3,StriklyDikly,2746,58,2,4,6,33.3%,47m
22812,1,Leonardo,2746,97,2,4,6,33.3%,2h
22812,1,KnowBody,2746,0,1,0,1,100.0%,2h
22812,3,Lachy,2746,0,1,1,2,50.0%,15m
22812,3,TheWatcher,2746,30,1,3,4,25.0%,29m
22812,3,IIIIIIIIIIII,2746,30,1,4,5,20.0%,32m
22812,2,Drakekiler,2746,0,0,1,1,0.0%,2h
22844,2,Swanofavon,2745,1497,162,145,307,52.8%,21m
22844,3,[iGOSU]ClaireCosmic,2745,1510,97,81,178,54.5%,29m
22844,3,[An1me1]YouAreClown,2745,789,37,19,56,66.1%,24m
22844,3,RiZuU,2745,842,36,32,68,52.9%,4m
22844,3,[YZGG]HoshiYake,2745,775,32,25,57,56.1%,9m
22844,3,[BGATTI]YehSame,2745,641,24,21,45,53.3%,12m
22844,3,Techko,2745,634,23,27,50,46.0%,17m
22844,3,[DETER]ChaosSquirre,2745,463,18,15,33,54.5%,21m
22844,3,Archer,2745,290,13,9,22,59.1%,9m
22844,3,[ALSB]Andaya,2745,382,13,18,31,41.9%,7m
22844,3,vug,2745,86,6,5,11,54.5%,29m
22844,1,[0PGC0]Marat,2745,170,5,1,6,83.3%,2h
22844,1,Parzibal,2745,144,5,1,6,83.3%,1h
22844,1,IIIIIIIIIIII,2745,177,5,2,7,71.4%,2h
22844,1,TMNTWEBB,2745,168,5,6,11,45.5%,2h
22844,1,[TECPLA]wilder,2745,110,4,1,5,80.0%,17m
22844,3,Drakkae,2745,116,4,8,12,33.3%,45m
22844,3,JohnWarosa,2745,30,2,0,2,100.0%,42m
22844,3,KorOdai,2745,110,2,2,4,50.0%,29m
22844,1,Skynet,2745,0,2,3,5,40.0%,46m
22844,3,Dewbie,2745,121,2,3,5,40.0%,29m
22844,1,[LoZOoT]new,2745,0,1,0,1,100.0%,2h
22844,1,remi,2745,0,1,0,1,100.0%,2h
22844,1,GreatGatsby,2745,0,1,4,5,20.0%,1h
22844,3,Jessica,2745,30,1,4,5,20.0%,27m
22844,1,[tpzt]GeneralRex,2745,0,0,1,1,0.0%,6m
22844,1,[Luntik]Shinzon,2745,0,0,1,1,0.0%,2h
22844,1,[X17]SCV,2745,0,0,1,1,0.0%,15m
22844,1,[Sune]yermi,2745,0,0,1,1,0.0%,2h
22844,3,Tika,2745,0,0,6,6,0.0%,29m
22874,3,Smokie,2744,540,81,80,161,50.3%,24m
22874,3,arbiter,2744,1298,72,63,135,53.3%,12m
22874,2,[Astute]Earlyreraise,2744,1252,56,58,114,49.1%,14m
22874,1,ggyo,2744,727,29,14,43,67.4%,1h
22874,3,[CeMx]Vryko,2744,593,26,27,53,49.1%,12m
22874,3,patrox,2744,335,19,15,34,55.9%,12m
22874,1,Matt,2744,432,14,8,22,63.6%,2h
22874,1,Decay,2744,415,12,6,18,66.7%,2h
22874,3,Mindtaker,2744,337,12,13,25,48.0%,28m
22874,3,[ch33z3]ziggerNAUT,2744,241,9,9,18,50.0%,25m
22874,3,INerTiA,2744,275,8,8,16,50.0%,27m
22874,3,[INextI]MechaMarine,2744,172,7,10,17,41.2%,24m
22874,2,[4Proft]DaddyProphit,2744,183,4,11,15,26.7%,34m
22874,3,[AFI]arceus,2744,142,3,3,6,50.0%,10m
22874,3,Cloudy,2744,34,2,0,2,100.0%,2h
22874,1,Kronos,2744,38,2,0,2,100.0%,46m
22874,2,[Ash3s]StarsFallDim,2744,114,2,8,10,20.0%,21m
22874,1,GQD,2744,0,1,0,1,100.0%,4m
22874,1,Ndras,2744,0,1,0,1,100.0%,40m
22874,1,Douglina,2744,0,1,0,1,100.0%,1h
22874,1,Tmoney,2744,42,1,1,2,50.0%,3h
22874,3,[CroMag]InfinityEcho,2744,0,1,2,3,33.3%,29m
22874,2,SaraStorM,2744,96,1,3,4,25.0%,25m
22874,1,[d0ngs]FartDemon,2744,0,1,3,4,25.0%,2h
22898,1,[PUPUS]Doom,2743,1476,244,241,485,50.3%,8m
22898,1,ebadawy,2743,1243,233,233,466,50.0%,12m
22898,3,sardur,2743,792,60,53,113,53.1%,4m
22898,3,[Cseoul]LiSyaorang,2743,992,44,31,75,58.7%,48m
22898,1,Adelante,2743,1083,40,31,71,56.3%,2h
22898,1,leo,2743,978,40,39,79,50.6%,1h
22898,2,Herpderk,2743,865,33,36,69,47.8%,18m
22898,3,[Absorb]syakunetsu,2743,735,32,28,60,53.3%,29m
22898,3,GangstaRap,2743,253,31,30,61,50.8%,29m
22898,3,Novicebater,2743,647,27,16,43,62.8%,29m
22898,3,[DkVb]DTCory,2743,499,21,14,35,60.0%,20m
22898,3,DrXanax,2743,406,15,17,32,46.9%,29m
22898,3,[bysa]BederIchDei,2743,339,14,15,29,48.3%,48m
22898,3,[Toiley]Quash,2743,333,14,17,31,45.2%,36m
22898,1,TwoFtNYoChst,2743,463,12,16,28,42.9%,19m
22898,2,[Kayoz]BullDestro,2743,246,8,18,26,30.8%,28m
22898,1,Snow,2743,121,6,3,9,66.7%,3h
22898,1,BluePanda,2743,119,5,4,9,55.6%,1h
22898,1,Dashti,2743,163,5,4,9,55.6%,3h
22898,1,[PPAP]SmartSputnik,2743,119,4,2,6,66.7%,2h
22898,1,SlayA,2743,97,4,5,9,44.4%,12m
22898,1,sasson,2743,42,3,3,6,50.0%,1h
22898,3,ImANoob,2743,97,2,1,3,66.7%,8m
22898,3,Dew,2743,30,2,3,5,40.0%,7m
22898,1,[StarCv]Andromeda,2743,0,2,3,5,40.0%,12m
22898,1,BeNice,2743,0,1,0,1,100.0%,1h
22898,3,zzz,2743,0,1,2,3,33.3%,37m
22898,3,droppingload,2743,30,1,3,4,25.0%,16m
22898,3,[THDuma]loki,2743,30,1,5,6,16.7%,29m
22898,1,Skitzoshift,2743,0,0,1,1,0.0%,32m
22898,2,Surprise,2743,0,0,1,1,0.0%,1h
22898,1,[NI66A]ItsYaBoi,2743,0,0,1,1,0.0%,1h
22898,2,Jammer,2743,0,0,2,2,0.0%,2h
22898,3,TheEx,2743,0,0,3,3,0.0%,37m
22898,3,onslaught,2743,0,0,3,3,0.0%,43m
22898,3,hsgy,2743,0,0,3,3,0.0%,9m
22934,1,[WOTG]legolas,2742,1781,178,140,318,56.0%,12m
22934,3,Slag,2742,1168,156,150,306,51.0%,29m
22934,2,Silariandi,2742,1548,127,118,245,51.8%,9m
22934,3,SoulAnthony,2742,1544,102,80,182,56.0%,36m
22934,3,axios,2742,1555,78,52,130,60.0%,13m
22934,3,[GBombs]Tallahassee,2742,1183,76,77,153,49.7%,19m
22934,3,[NwAs]KillerGhost,2742,920,65,48,113,57.5%,12m
22934,2,[ZUCCED]Capnjazz,2742,427,47,45,92,51.1%,13m
22934,3,DoToRi,2742,427,27,24,51,52.9%,5m
22934,3,IronGear,2742,665,26,27,53,49.1%,5m
22934,3,livefreeordi,2742,555,25,19,44,56.8%,4m
22934,3,Blümchen,2742,493,22,12,34,64.7%,15m
22934,3,[ChFo]pablofc,2742,530,19,22,41,46.3%,8m
22934,3,SofaKing,2742,412,18,18,36,50.0%,6m
22934,3,bblueberryy,2742,354,15,13,28,53.6%,30m
22934,2,danielobao,2742,206,9,10,19,47.4%,31m
22934,2,Zombiellama,2742,210,9,10,19,47.4%,7m
22934,3,BRIVOLBNQ,2742,173,6,8,14,42.9%,42m
22934,3,DarkSlug,2742,60,4,6,10,40.0%,24m
22934,2,ale,2742,0,3,2,5,60.0%,2h
22934,2,[AFMA]Deadblinx,2742,0,3,3,6,50.0%,32m
22934,2,[BraziI]Darking,2742,88,3,5,8,37.5%,33m
22934,1,Smree,2742,42,2,0,2,100.0%,24m
22934,1,[JDG]Argentina,2742,86,2,2,4,50.0%,2h
22934,3,JexD,2742,113,2,2,4,50.0%,34m
22934,2,Cryn,2742,0,2,3,5,40.0%,2h
22934,1,aztechhh,2742,93,2,4,6,33.3%,19m
22934,1,Darkstorm,2742,94,2,4,6,33.3%,28m
22934,1,Blank,2742,42,1,1,2,50.0%,2h
22934,1,Mhao,2742,48,1,2,3,33.3%,1h
22934,3,NEO,2742,30,1,4,5,20.0%,24m
22934,2,Arc,2742,0,0,1,1,0.0%,7m
22934,2,VipeR,2742,0,0,1,1,0.0%,1h
22934,3,MadaxOlimpus,2742,0,0,2,2,0.0%,15m
22934,3,Kounotori,2742,0,0,5,5,0.0%,4m
22969,2,Gav,2741,1499,324,302,626,51.8%,14m
22969,3,BlackAce,2741,1241,118,101,219,53.9%,22m
22969,3,bighead,2741,1555,92,85,177,52.0%,48m
22969,3,Squall,2741,1236,78,68,146,53.4%,24m
22969,3,[UpxV]TYTY,2741,1309,78,78,156,50.0%,22m
22969,3,ElConejito,2741,1313,61,55,116,52.6%,26m
22969,3,NateBlatz,2741,482,35,25,60,58.3%,45m
22969,3,[TheRs]StarShrew,2741,338,32,28,60,53.3%,7m
22969,2,[OpPl]Playguuuu,2741,400,32,36,68,47.1%,37m
22969,3,[iRISE]Theseus,2741,547,26,18,44,59.1%,17m
22969,3,BlackHawk,2741,433,24,19,43,55.8%,10m
22969,2,Axtlan,2741,304,20,23,43,46.5%,15m
22969,3,blueballed,2741,450,16,22,38,42.1%,9m
22969,2,WDNMD,2741,291,13,9,22,59.1%,2h
22969,1,Ranger,2741,185,6,5,11,54.5%,2h
22969,3,MercuryX,2741,165,6,6,12,50.0%,9m
22969,2,Jin,2741,180,6,8,14,42.9%,18m
22969,1,snoisiv,2741,80,3,2,5,60.0%,42m
22969,1,[VikE]IZZievil,2741,0,2,3,5,40.0%,2h
22969,1,[DarkAG]llllllllllll,2741,0,2,3,5,40.0%,1h
22969,2,NATURAL,2741,0,1,0,1,100.0%,2h
22969,1,PícaroVeloz,2741,0,1,0,1,100.0%,1h
22969,3,[IPFC]VUWO,2741,0,1,1,2,50.0%,44m
22969,3,turtlehat,2741,0,1,3,4,25.0%,23m
22969,1,Pfelgar,2741,0,0,1,1,0.0%,24m
22969,3,Fingon,2741,0,0,5,5,0.0%,33m
22995,2,[UpxV]Jupiter,2740,1538,167,153,320,52.2%,48m
22995,1,senier,2740,1752,105,93,198,53.0%,17m
22995,3,DrDrenato,2740,860,86,74,160,53.8%,32m
22995,3,ThePvK,2740,1192,55,47,102,53.9%,46m
22995,3,Stacks,2740,578,48,35,83,57.8%,23m
22995,1,Chris,2740,778,46,41,87,52.9%,41m
22995,1,Skwid,2740,1094,38,35,73,52.1%,20m
22995,3,Quick,2740,443,32,29,61,52.5%,6m
22995,1,piggy,2740,774,30,19,49,61.2%,12m
22995,3,Diocletian,2740,386,23,34,57,40.4%,24m
22995,1,Wehrmacht,2740,459,17,16,33,51.5%,1h
22995,3,Vownstille,2740,390,16,9,25,64.0%,7m
22995,3,llllllllllll,2740,326,12,11,23,52.2%,10m
22995,2,Canopus,2740,356,12,17,29,41.4%,30m
22995,1,Fercho,2740,349,10,5,15,66.7%,12m
22995,2,BISION,2740,290,10,21,31,32.3%,33m
22995,3,Rescue,2740,241,9,4,13,69.2%,26m
22995,1,Glem,2740,252,8,7,15,53.3%,2h
22995,1,KyonKnight,2740,158,5,2,7,71.4%,2h
22995,3,dirty,2740,118,5,4,9,55.6%,24m
22995,1,[NeoTos]npSalmao,2740,48,4,6,10,40.0%,19m
22995,2,Dragonz,2740,178,4,7,11,36.4%,11m
22995,2,ImpellitterI,2740,0,3,2,5,60.0%,2h
22995,1,Stylo,2740,34,3,3,6,50.0%,12m
22995,3,MATIMAN,2740,119,3,4,7,42.9%,28m
22995,2,[WWP2]eYeSpY,2740,97,3,4,7,42.9%,3h
22995,1,CNation,2740,97,3,5,8,37.5%,2h
22995,1,Ludophobia,2740,38,2,0,2,100.0%,2h
22995,2,[NO0OBZ]MAKO,2740,0,1,0,1,100.0%,40m
22995,2,IIIIIIIIIlll,2740,0,1,7,8,12.5%,37m
22995,2,[GHAD69]MKBFearless,2740,0,0,1,1,0.0%,47m
23026,3,FauxPhoenix,2739,1052,126,118,244,51.6%,22m
23026,3,[Vtta]diegodavila,2739,1409,117,101,218,53.7%,27m
23026,3,Hell,2739,1498,86,83,169,50.9%,27m
23026,3,[KR20]TOXOPLASMA,2739,1296,56,45,101,55.4%,13m
23026,3,Gladiator,2739,935,43,38,81,53.1%,16m
23026,1,Jude,2739,587,30,25,55,54.5%,35m
23026,3,Denbrough,2739,652,29,18,47,61.7%,15m
23026,3,GEMINUS,2739,379,15,14,29,51.7%,26m
23026,3,[IMDSI]Hiroshima,2739,392,14,12,26,53.8%,12m
23026,3,[NKT1]YuiHatano,2739,239,10,4,14,71.4%,5m
23026,3,tehNice,2739,165,9,7,16,56.2%,22m
23026,1,[SANGRE]Yeska,2739,142,5,5,10,50.0%,40m
23026,1,Econfordays,2739,116,4,0,4,100.0%,15m
23026,1,sephiroth,2739,89,3,3,6,50.0%,3h
23026,2,RustyPwner,2739,0,2,3,5,40.0%,2h
23026,1,CarrierMaker,2739,48,2,3,5,40.0%,38m
23026,1,UncleDrew,2739,0,2,3,5,40.0%,3h
23026,2,GuyB,2739,0,2,5,7,28.6%,2h
23026,1,[xENTx]SIRCOL,2739,40,1,2,3,33.3%,12m
23026,3,TobieYou,2739,93,1,2,3,33.3%,33m
23026,2,minispender,2739,0,1,2,3,33.3%,46m
23026,1,migue,2739,34,1,2,3,33.3%,32m
23026,1,[xAMENx]LxZeus,2739,0,0,1,1,0.0%,39m
23026,1,[DryHop]xmikage,2739,0,0,1,1,0.0%,2h
23026,1,Dan,2739,0,0,1,1,0.0%,13m
23026,1,Misael,2739,0,0,1,1,0.0%,46m
23026,1,Zeke,2739,0,0,1,1,0.0%,1h
23026,1,Goliath,2739,0,0,2,2,0.0%,2h
23026,3,[SxyMxN]Quetzalcoatl,2739,0,0,6,6,0.0%,24m
23055,2,[lUSMCl]BeasyBaby,2738,1500,119,119,238,50.0%,47m
23055,2,Dang,2738,888,115,131,246,46.7%,30m
23055,3,GhostXNinja,2738,412,72,51,123,58.5%,19m
23055,3,bolso,2738,1473,65,55,120,54.2%,15m
23055,2,SKING,2738,1451,57,57,114,50.0%,21m
23055,2,[DETER]Alsadair,2738,726,42,36,78,53.8%,20m
23055,3,Luthtar,2738,450,38,31,69,55.1%,44m
23055,3,Rhiom,2738,880,38,31,69,55.1%,38m
23055,1,[DSN]Archon,2738,1018,36,28,64,56.2%,28m
23055,2,Megami,2738,196,27,33,60,45.0%,44m
23055,3,Dragon,2738,500,25,25,50,50.0%,30m
23055,3,StarSim,2738,516,20,20,40,50.0%,46m
23055,3,[SyLx]jack,2738,344,13,13,26,50.0%,10m
23055,3,bestprotoss,2738,290,13,14,27,48.1%,31m
23055,3,Dusk,2738,220,10,8,18,55.6%,24m
23055,1,SquirtSauce,2738,246,9,9,18,50.0%,2h
23055,3,BEGWorthing,2738,146,8,5,13,61.5%,47m
23055,3,Void,2738,210,8,8,16,50.0%,10m
23055,3,PearlMilkTea,2738,122,5,5,10,50.0%,9m
23055,1,KarateMonkey,2738,168,5,7,12,41.7%,2h
23055,1,[G00SE]MicroJackson,2738,82,3,1,4,75.0%,2h
23055,2,Tony,2738,0,2,3,5,40.0%,20m
23055,3,[BoAVN]reko,2738,0,1,4,5,20.0%,24m
23055,3,yehosua,2738,30,1,6,7,14.3%,11m
23055,1,FartOfDaSwrm,2738,0,0,1,1,0.0%,44m
23055,1,[AoS2]DarkAvenger,2738,0,0,1,1,0.0%,2h
23055,1,[LHLT]Gecko,2738,0,0,1,1,0.0%,1h
23082,3,[DarkAG]Ocelot,2737,1605,264,258,522,50.6%,48m
23082,3,dogsong,2737,1570,173,165,338,51.2%,16m
23082,1,Ryze,2737,1504,155,140,295,52.5%,30m
23082,1,BoomGoesDaDP,2737,1364,91,87,178,51.1%,32m
23082,1,TassadarX,2737,738,71,58,129,55.0%,2h
23082,3,ELSpartano,2737,914,45,34,79,57.0%,34m
23082,3,PowerSoviet,2737,894,39,31,70,55.7%,46m
23082,3,monkemaster,2737,389,32,3,35,91.4%,30m
23082,3,AthenaSword,2737,578,24,29,53,45.3%,27m
23082,3,Firestone,2737,606,22,26,48,45.8%,10m
23082,3,[UncrNa]Pegge,2737,438,18,13,31,58.1%,34m
23082,2,Tsias,2737,317,17,19,36,47.2%,36m
23082,3,Smushface,2737,330,12,8,20,60.0%,10m
23082,1,kangpunge,2737,390,11,9,20,55.0%,42m
23082,2,Matt,2737,204,7,8,15,46.7%,33m
23082,1,FightingMole,2737,200,5,4,9,55.6%,14m
23082,1,[VFam]DaZergGuyrls,2737,114,4,1,5,80.0%,14m
23082,1,ElKingz,2737,116,3,1,4,75.0%,17m
23082,1,Dackson,2737,191,3,3,6,50.0%,2h
23082,2,[FUndSI]Nukey,2737,0,3,4,7,42.9%,30m
23082,1,llllllllllll,2737,0,2,2,4,50.0%,2h
23082,2,fryzee,2737,0,2,3,5,40.0%,3h
23082,3,Serral,2737,93,1,2,3,33.3%,10m
23082,1,[ulost]Trump,2737,0,0,1,1,0.0%,2h
23082,1,Mokinono,2737,0,0,1,1,0.0%,32m
23107,3,Moontari,2736,1171,280,271,551,50.8%,9m
23107,1,Pidgy,2736,1396,142,151,293,48.5%,24m
23107,2,Nemesis,2736,1560,103,104,207,49.8%,20m
23107,3,Astraea,2736,690,51,49,100,51.0%,13m
23107,3,TheAx,2736,956,43,35,78,55.1%,10m
23107,1,[OhhGG]ACEsch,2736,1041,39,45,84,46.4%,6m
23107,3,[LaOr]Serwolf,2736,454,29,30,59,49.2%,7m
23107,3,ExIBanker,2736,583,21,27,48,43.8%,10m
23107,3,WreckItPaul,2736,397,20,8,28,71.4%,21m
23107,1,[M1A5]AbsintheNova,2736,435,16,7,23,69.6%,2h
23107,3,MarineChien,2736,359,14,18,32,43.8%,33m
23107,1,RaF,2736,336,13,12,25,52.0%,35m
23107,3,Maduros,2736,194,10,4,14,71.4%,5m
23107,3,Haku,2736,210,7,10,17,41.2%,24m
23107,1,RavenGloodus,2736,115,6,2,8,75.0%,32m
23107,3,Patriot,2736,30,5,3,8,62.5%,27m
23107,3,[Perú08]Dragones,2736,174,5,5,10,50.0%,16m
23107,2,Rebel,2736,94,4,15,19,21.1%,25m
23107,1,JamaisVu,2736,86,2,1,3,66.7%,2h
23107,3,[OSS]Nite,2736,118,2,4,6,33.3%,12m
23107,3,Fading,2736,30,2,7,9,22.2%,30m
23107,1,rougezerglin,2736,0,1,0,1,100.0%,2h
23107,3,ScumGuzzler,2736,30,1,2,3,33.3%,47m
23107,1,Sanctuary,2736,0,0,1,1,0.0%,3h
23107,3,Ender,2736,0,0,2,2,0.0%,4m
23107,3,DirtyTWillis,2736,0,0,2,2,0.0%,27m
23107,3,Mezuza,2736,0,0,3,3,0.0%,11m
23134,3,Kman,2735,1057,207,187,394,52.5%,44m
23134,1,OGMR,2735,1620,159,166,325,48.9%,44m
23134,3,Burow,2735,1590,90,64,154,58.4%,24m
23134,3,MrBangoJango,2735,1027,62,60,122,50.8%,12m
23134,3,Optomistic,2735,248,44,48,92,47.8%,29m
23134,3,[PMN]aKaGCurse,2735,625,31,28,59,52.5%,10m
23134,3,[swag47]Zerlow,2735,327,14,13,27,51.9%,21m
23134,3,[Hosts]Mace,2735,279,13,6,19,68.4%,26m
23134,3,Star,2735,342,12,16,28,42.9%,47m
23134,3,SilverCrow,2735,266,10,12,22,45.5%,9m
23134,1,[RSpctr]Tychlo,2735,136,7,6,13,53.8%,29m
23134,1,Jacoren,2735,172,6,4,10,60.0%,19m
23134,1,Twentytwenty,2735,154,5,0,5,100.0%,1h
23134,3,SweetNLo,2735,94,5,14,19,26.3%,25m
23134,3,JkFrmStFrm,2735,146,4,1,5,80.0%,46m
23134,1,ThyAnswer,2735,40,4,3,7,57.1%,2h
23134,2,Humbin,2735,151,3,1,4,75.0%,2h
23134,3,QiuYin,2735,94,2,1,3,66.7%,4m
23134,1,Condo,2735,0,1,0,1,100.0%,3h
23134,1,UrdnotMark,2735,0,1,0,1,100.0%,2h
23134,1,[UpeV]JACO,2735,32,1,1,2,50.0%,2h
23134,2,Angel,2735,42,1,3,4,25.0%,2h
23134,2,[SP1622]SuperPenguin,2735,90,1,4,5,20.0%,2h
23134,1,Phoenix,2735,0,0,1,1,0.0%,2h
23134,1,[MDU]Pitohui,2735,0,0,2,2,0.0%,15m
23134,3,jeibox,2735,0,0,3,3,0.0%,22m
23134,3,SCLSymbian,2735,0,0,3,3,0.0%,11m
23134,3,Cazbius,2735,0,0,7,7,0.0%,38m
23162,1,ferg,2734,1758,252,227,479,52.6%,2h
23162,3,Oozi,2734,1557,159,144,303,52.5%,30m
23162,2,[VARIAN]Angelus,2734,1500,147,137,284,51.8%,25m
23162,1,Absel,2734,1753,114,90,204,55.9%,2h
23162,3,Nubbin,2734,563,110,85,195,56.4%,28m
23162,3,Wasp,2734,1526,101,93,194,52.1%,31m
23162,3,[JCN]ACDCLIVE,2734,1157,66,59,125,52.8%,20m
23162,3,Vicious,2734,1238,45,48,93,48.4%,27m
23162,3,ChillPenguin,2734,760,28,27,55,50.9%,19m
23162,3,Ssibal,2734,330,24,16,40,60.0%,14m
23162,3,Shogo,2734,450,18,15,33,54.5%,48m
23162,3,[sk3tch]TokesMcGanja,2734,168,15,13,28,53.6%,44m
23162,1,Netilda,2734,399,14,14,28,50.0%,2h
23162,2,eyza,2734,298,10,17,27,37.0%,45m
23162,3,WhiteTiger,2734,248,9,10,19,47.4%,18m
23162,1,HappyBob,2734,249,9,10,19,47.4%,2h
23162,3,PainTrain,2734,133,6,4,10,60.0%,16m
23162,1,slippycat,2734,192,4,3,7,57.1%,6m
23162,2,[Bander]RetroNuva,2734,113,4,4,8,50.0%,2h
23162,1,Muzicos,2734,177,4,5,9,44.4%,15m
23162,3,shaaa,2734,113,3,1,4,75.0%,30m
23162,1,zDreamz,2734,53,3,1,4,75.0%,1h
23162,1,ROGERMOOOORE,2734,0,3,2,5,60.0%,1h
23162,1,[asaa]BlackSun,2734,0,3,2,5,60.0%,2h
23162,1,MakkO,2734,40,3,3,6,50.0%,1h
23162,2,Chulymiaw,2734,0,3,4,7,42.9%,20m
23162,1,Lieutenant,2734,42,2,0,2,100.0%,19m
23162,1,[AoG]GaloVeio,2734,0,2,1,3,66.7%,2h
23162,1,chrisownsall,2734,0,1,0,1,100.0%,2h
23162,1,[ffaaak]bigdaddy,2734,0,1,1,2,50.0%,20m
23162,3,[AmaSua]Warsong,2734,0,1,2,3,33.3%,22m
23162,1,RaGinGFoX,2734,0,0,1,1,0.0%,17m
23162,2,DeadbeatDads,2734,0,0,1,1,0.0%,42m
23162,1,www,2734,0,0,1,1,0.0%,23m
23162,2,[HHCorp]Moebius,2734,0,0,2,2,0.0%,1h
23162,1,mividaxaiur,2734,0,0,2,2,0.0%,2h
23162,3,[LQV]NoobT,2734,0,0,3,3,0.0%,29m
23162,1,Bolita,2734,0,0,5,5,0.0%,2h
23162,3,SugarPuff,2734,0,0,7,7,0.0%,30m
23201,2,Xpo,2733,1502,136,144,280,48.6%,37m
23201,2,Hobgoblin,2733,1433,103,92,195,52.8%,16m
23201,3,TheOne,2733,1023,54,47,101,53.5%,47m
23201,2,Viper,2733,706,31,34,65,47.7%,38m
23201,3,MikeVo,2733,348,16,16,32,50.0%,31m
23201,1,Braaap,2733,302,10,3,13,76.9%,2h
23201,1,[G501st]IIIIIIIIIIII,2733,330,10,5,15,66.7%,15m
23201,3,coward,2733,60,6,5,11,54.5%,11m
23201,2,[DROM]Alux,2733,95,4,2,6,66.7%,38m
23201,1,Jhakrem,2733,178,4,4,8,50.0%,42m
23201,3,Leonidas,2733,90,4,5,9,44.4%,33m
23201,3,LilEugene,2733,120,4,7,11,36.4%,30m
23201,2,Canadian,2733,0,3,2,5,60.0%,24m
23201,3,DaftGemini,2733,138,3,3,6,50.0%,28m
23201,1,Sulphis,2733,0,2,3,5,40.0%,2h
23201,1,gabavelpo,2733,36,2,4,6,33.3%,45m
23201,1,Dzmitry,2733,0,1,0,1,100.0%,2h
23201,1,NotToGood,2733,0,1,0,1,100.0%,14m
23201,1,Anomolis,2733,0,1,1,2,50.0%,2h
23201,1,[FTLT]SuperJonas,2733,0,1,2,3,33.3%,2h
23201,3,Aaron,2733,30,1,5,6,16.7%,38m
23201,1,EmmetFitzhum,2733,0,0,1,1,0.0%,1h
23201,1,CAMHAMMER,2733,0,0,1,1,0.0%,2h
23201,1,Zeeaan,2733,0,0,1,1,0.0%,1h
23201,1,Zeratul,2733,0,0,1,1,0.0%,32m
23201,1,Golden,2733,0,0,1,1,0.0%,2h
23227,2,Chumbeke,2732,751,30,30,60,50.0%,28m
23227,3,[TrueBL]Tellyandrew,2732,407,29,24,53,54.7%,22m
23227,1,Alexander,2732,770,24,24,48,50.0%,2h
23227,3,GatorPit,2732,422,16,20,36,44.4%,7m
23227,1,EoS,2732,370,11,7,18,61.1%,1h
23227,1,Lalolink,2732,252,10,7,17,58.8%,1h
23227,2,CAPTAINDINGU,2732,230,10,9,19,52.6%,44m
23227,1,Maitoparta,2732,224,7,7,14,50.0%,35m
23227,3,Heileos,2732,233,7,7,14,50.0%,17m
23227,2,DrunkDwarf,2732,210,6,5,11,54.5%,2h
23227,3,Easty,2732,203,6,6,12,50.0%,20m
23227,2,[xEx]Addeour,2732,210,6,6,12,50.0%,1h
23227,1,khoa,2732,146,4,5,9,44.4%,2h
23227,1,[LosHua]Yamahara,2732,122,3,2,5,60.0%,2h
23227,1,MelIris,2732,0,3,2,5,60.0%,39m
23227,1,Ackbar,2732,42,2,0,2,100.0%,2h
23227,1,Lithonobio,2732,82,2,2,4,50.0%,2h
23227,3,BBTRekhyt,2732,121,2,3,5,40.0%,23m
23227,3,[s33n]BLKSTARSHAMN,2732,60,2,5,7,28.6%,45m
23227,1,[AbcCo]PecesitoUwU,2732,42,1,1,2,50.0%,3h
23227,1,adderlinUNI,2732,0,1,1,2,50.0%,42m
23227,3,[GnR]evilpretzel,2732,30,1,4,5,20.0%,24m
23227,1,Franko,2732,42,1,5,6,16.7%,13m
23227,1,sniperrobotz,2732,0,0,1,1,0.0%,17m
23227,1,XCrazyKillaX,2732,0,0,2,2,0.0%,2h
23227,3,[awko]NoFearNasir,2732,0,0,4,4,0.0%,45m
23253,2,zero,2731,1215,132,111,243,54.3%,47m
23253,2,PraetorPlato,2731,1503,132,123,255,51.8%,7m
23253,3,[INRI]Dystar,2731,1573,132,127,259,51.0%,9m
23253,3,[NPhasA]alex,2731,1054,43,48,91,47.3%,45m
23253,1,roughninja,2731,837,35,19,54,64.8%,1h
23253,3,HiddenSquid,2731,590,31,34,65,47.7%,18m
23253,1,Morning,2731,789,27,36,63,42.9%,27m
23253,3,ZynKa,2731,586,22,20,42,52.4%,5m
23253,3,Slater,2731,404,18,16,34,52.9%,10m
23253,2,zero,2731,528,18,27,45,40.0%,47m
23253,3,[ORUS]Simple,2731,354,17,12,29,58.6%,44m
23253,3,Subtookie,2731,452,16,21,37,43.2%,48m
23253,3,MakoSOLDIER,2731,166,13,13,26,50.0%,10m
23253,1,Ace,2731,431,12,9,21,57.1%,45m
23253,1,Pelucche,2731,284,10,6,16,62.5%,2h
23253,3,Dragon,2731,254,9,6,15,60.0%,34m
23253,3,Ladu,2731,242,8,8,16,50.0%,9m
23253,3,Lizandroxd,2731,201,6,6,12,50.0%,33m
23253,2,[Dnwlkr]AGGROCRAG,2731,140,2,1,3,66.7%,2h
23253,1,ghostsnstuff,2731,0,2,3,5,40.0%,46m
23253,1,NicaGizmody,2731,0,2,3,5,40.0%,28m
23253,2,Loiosh,2731,0,2,3,5,40.0%,36m
23253,1,Char,2731,0,1,0,1,100.0%,2h
23253,1,StormzBG,2731,40,1,2,3,33.3%,23m
23253,1,meddle,2731,42,1,3,4,25.0%,12m
23253,1,[QcScT]WestSpirit,2731,0,0,1,1,0.0%,1h
23253,1,[AdVic]Fenix,2731,0,0,1,1,0.0%,39m
23253,3,mzula,2731,0,0,3,3,0.0%,26m
23281,1,FubDaddy,2730,1430,54,42,96,56.2%,46m
23281,1,ThiccThocc,2730,970,54,57,111,48.6%,8m
23281,3,[cov3n]PlanB,2730,642,23,21,44,52.3%,29m
23281,1,Ranger,2730,406,20,24,44,45.5%,6m
23281,3,Fredis,2730,514,19,17,36,52.8%,46m
23281,3,[Might]Shadowmaster,2730,382,16,14,30,53.3%,4m
23281,1,SleepSaX,2730,391,13,13,26,50.0%,2h
23281,1,Gforce,2730,336,9,13,22,40.9%,2h
23281,3,Cannon,2730,212,7,5,12,58.3%,29m
23281,3,[ITF]ITFpeeps,2730,176,7,6,13,53.8%,9m
23281,2,Kis,2730,212,7,13,20,35.0%,36m
23281,1,Camlost,2730,226,6,5,11,54.5%,2h
23281,3,Dmitry,2730,173,5,8,13,38.5%,8m
23281,3,htiffirg,2730,206,5,8,13,38.5%,2h
23281,2,DrG,2730,142,5,8,13,38.5%,37m
23281,3,Skiar,2730,76,5,9,14,35.7%,26m
23281,1,zenki,2730,89,3,3,6,50.0%,2h
23281,1,Migz,2730,0,3,4,7,42.9%,2h
23281,1,reefes,2730,40,2,1,3,66.7%,13m
23281,1,Entertainer,2730,40,2,2,4,50.0%,2h
23281,1,[Best01]Daniel,2730,80,2,3,5,40.0%,14m
23281,2,yonko,2730,0,2,3,5,40.0%,2h
23281,1,Qvothe,2730,0,1,0,1,100.0%,22m
23281,1,[X17]kerrDOG,2730,44,1,2,3,33.3%,1h
23281,1,[TAKANA]Wulfrano,2730,0,0,1,1,0.0%,20m
23281,1,ANDYBLACK,2730,0,0,1,1,0.0%,17m
23281,3,WolfGang,2730,0,0,3,3,0.0%,7m
23308,1,Chocoprispri,2729,1755,219,211,430,50.9%,2h
23308,3,[PobSC]PssDestroyer,2729,1571,202,181,383,52.7%,5m
23308,1,[Elys]RatlerX,2729,1125,109,93,202,54.0%,2h
23308,3,wulfpolo,2729,1586,102,108,210,48.6%,47m
23308,1,[R2nt5]TheMoeHawk,2729,1590,96,102,198,48.5%,23m
23308,2,[Cryptc]Stealth,2729,682,70,61,131,53.4%,33m
23308,3,[Calx]guillermo,2729,1415,69,58,127,54.3%,12m
23308,1,dark,2729,1295,65,77,142,45.8%,38m
23308,3,FlokY,2729,737,38,34,72,52.8%,44m
23308,1,Teaming,2729,892,37,25,62,59.7%,20m
23308,3,MasterOogway,2729,455,32,20,52,61.5%,6m
23308,3,Delta,2729,669,25,20,45,55.6%,36m
23308,3,KernelSC,2729,667,24,24,48,50.0%,4m
23308,3,[xLiTx]HoboMcGavs,2729,435,20,20,40,50.0%,15m
23308,3,Starssong,2729,421,18,10,28,64.3%,32m
23308,3,llllllllllll,2729,451,17,16,33,51.5%,31m
23308,1,Pazuzu,2729,544,16,11,27,59.3%,12m
23308,1,[CrTr]officer,2729,284,9,7,16,56.2%,2h
23308,3,Mong,2729,168,5,5,10,50.0%,14m
23308,3,alucard,2729,182,5,5,10,50.0%,44m
23308,1,Bosatsu,2729,122,4,3,7,57.1%,2h
23308,2,[NEBUGA]Hiiro,2729,0,3,5,8,37.5%,10m
23308,1,Ipsi,2729,0,2,3,5,40.0%,2h
23308,1,jamestkirk,2729,70,2,3,5,40.0%,2h
23308,2,Ajax,2729,88,2,7,9,22.2%,7m
23308,1,BustardoS,2729,0,1,0,1,100.0%,2h
23308,1,[VL31]Zergixz,2729,0,1,0,1,100.0%,31m
23308,1,Momario,2729,0,1,1,2,50.0%,1h
23308,3,Bdubbs,2729,0,1,3,4,25.0%,45m
23308,2,[DRKOWL]Chrome,2729,0,0,1,1,0.0%,1h
23308,1,Tyrone,2729,0,0,2,2,0.0%,2h
23308,3,Elanuc,2729,0,0,3,3,0.0%,26m
23308,2,NordicMoose,2729,0,0,4,4,0.0%,39m
23341,3,famerica,2728,1620,269,265,534,50.4%,10m
23341,1,MarketForces,2728,1508,172,177,349,49.3%,19m
23341,3,[CBCQC]Tidom,2728,1479,169,171,340,49.7%,46m
23341,3,elChule,2728,537,70,56,126,55.6%,48m
23341,1,[UoM]Emaps,2728,776,67,61,128,52.3%,44m
23341,3,[cnboys]UhOhStinky,2728,472,21,14,35,60.0%,21m
23341,3,SneakyBooger,2728,217,19,16,35,54.3%,45m
23341,3,ChaosTheory,2728,501,18,17,35,51.4%,7m
23341,3,[ACGI]SuspectJojo,2728,447,17,17,34,50.0%,10m
23341,1,dahaka,2728,577,15,16,31,48.4%,1h
23341,3,Shifter,2728,310,12,15,27,44.4%,17m
23341,3,Squanchy,2728,266,11,14,25,44.0%,35m
23341,3,Shadow,2728,269,10,4,14,71.4%,1h
23341,2,Charmander,2728,216,10,11,21,47.6%,40m
23341,1,PokpokBen,2728,281,9,7,16,56.2%,31m
23341,1,MRREEEEETTV,2728,212,8,6,14,57.1%,2h
23341,1,Charstuky,2728,260,7,6,13,53.8%,2h
23341,1,DemonMaster,2728,158,5,6,11,45.5%,2h
23341,3,[BYU]Andystan,2728,193,5,7,12,41.7%,4m
23341,1,BabaYaga,2728,93,4,2,6,66.7%,37m
23341,3,[PaStiS]AspikBardamu,2728,110,4,4,8,50.0%,32m
23341,3,SilentWolf,2728,108,4,4,8,50.0%,17m
23341,3,FragOnly,2728,90,4,5,9,44.4%,31m
23341,1,Siecje,2728,160,4,6,10,40.0%,2h
23341,3,htviva,2728,94,3,4,7,42.9%,5m
23341,3,[GRYRE]BilboBaggins,2728,94,2,2,4,50.0%,47m
23341,1,Nautilus,2728,92,2,3,5,40.0%,2h
23341,3,sleep,2728,109,2,3,5,40.0%,9m
23341,2,BIDASS,2728,0,2,3,5,40.0%,2h
23341,3,[IVVVI]Zoboomafoo,2728,62,2,6,8,25.0%,34m
23341,1,CoronaVirus,2728,0,1,0,1,100.0%,2h
23341,1,[UpxV]RAYDER,2728,0,1,1,2,50.0%,2h
23341,1,Busters,2728,38,1,2,3,33.3%,13m
23341,1,[IvD]GosuAppa,2728,42,1,3,4,25.0%,2h
23341,2,deVas,2728,48,1,4,5,20.0%,2h
23341,1,[CaveR]vitaminTuna,2728,0,0,1,1,0.0%,16m
23341,1,exzplosive,2728,0,0,1,1,0.0%,25m
23341,2,[LQV]starwarex,2728,0,0,1,1,0.0%,2h
23341,2,Veracity,2728,0,0,1,1,0.0%,1h
23341,2,[GTnLB]ilusionista,2728,0,0,2,2,0.0%,9m
23341,1,NivixParadox,2728,0,0,2,2,0.0%,1h
23341,1,InThEdArK,2728,0,0,2,2,0.0%,36m
23383,2,[SANGRE]DEADROGER,2727,1266,275,250,525,52.4%,22m
23383,1,Endro,2727,1674,115,95,210,54.8%,46m
23383,2,TheDarkLord,2727,1534,63,70,133,47.4%,44m
23383,3,ChimSeDiMua,2727,1063,46,39,85,54.1%,23m
23383,3,[ÆON]gammullus,2727,476,38,42,80,47.5%,24m
23383,3,MiniLobo,2727,192,32,18,50,64.0%,23m
23383,3,LittleBoats,2727,464,19,18,37,51.4%,38m
23383,3,jack,2727,390,13,16,29,44.8%,9m
23383,3,IIIIIIIIIIII,2727,146,10,8,18,55.6%,24m
23383,1,valaka,2727,212,7,3,10,70.0%,1h
23383,1,Morphilator,2727,224,6,0,6,100.0%,39m
23383,3,DocWatts,2727,157,6,6,12,50.0%,15m
23383,3,Iceberg,2727,200,6,10,16,37.5%,29m
23383,3,Pzkp,2727,180,6,12,18,33.3%,4m
23383,3,Shoosta,2727,60,5,6,11,45.5%,23m
23383,3,THESLAYA,2727,142,5,7,12,41.7%,9m
23383,1,OutlawTorn,2727,96,5,7,12,41.7%,2h
23383,1,JustCrazy,2727,158,4,6,10,40.0%,2h
23383,1,AgentAkbar,2727,0,3,4,7,42.9%,3h
23383,3,FakeMoon,2727,36,3,5,8,37.5%,25m
23383,1,mcjagger,2727,0,2,0,2,100.0%,43m
23383,3,CompasionTdT,2727,30,2,3,5,40.0%,7m
23383,1,[Illll]deShii,2727,0,1,0,1,100.0%,2h
23383,1,Firepop,2727,48,1,10,11,9.1%,2h
23383,2,Antoni,2727,30,1,11,12,8.3%,25m
23383,1,dArchon,2727,0,0,1,1,0.0%,2h
23383,3,Astrotune,2727,0,0,1,1,0.0%,8m
23383,3,Triggered,2727,0,0,2,2,0.0%,7m
23383,1,Loxos,2727,0,0,2,2,0.0%,13m
23412,2,DoomWyteShro,2726,1418,146,151,297,49.2%,30m
23412,2,Lokrin,2726,1475,76,81,157,48.4%,29m
23412,3,[ValidG]daveyboy,2726,1493,64,53,117,54.7%,15m
23412,3,BriGro,2726,1010,41,37,78,52.6%,32m
23412,3,Karmakaze,2726,605,26,18,44,59.1%,34m
23412,1,DarthJynx,2726,539,23,12,35,65.7%,1h
23412,3,Archangelmoo,2726,742,23,55,78,29.5%,23m
23412,3,[Flar3s]MaximuS,2726,355,16,12,28,57.1%,44m
23412,1,sxtycat,2726,502,14,14,28,50.0%,43m
23412,3,Primordial,2726,322,13,12,25,52.0%,36m
23412,3,axiom,2726,260,13,15,28,46.4%,16m
23412,3,[ZDE20]Brian,2726,296,12,9,21,57.1%,24m
23412,3,icarus,2726,252,10,10,20,50.0%,29m
23412,3,BokalLotku,2726,258,10,13,23,43.5%,6m
23412,3,Higuma,2726,180,8,6,14,57.1%,13m
23412,3,[MRKN]Mark,2726,231,7,7,14,50.0%,11m
23412,3,freethrows,2726,219,6,7,13,46.2%,28m
23412,3,[KSRP]LizardPity,2726,168,4,5,9,44.4%,7m
23412,2,saw,2726,93,3,1,4,75.0%,32m
23412,1,Greatniz,2726,0,3,2,5,60.0%,46m
23412,2,Prometheus,2726,95,3,3,6,50.0%,2h
23412,2,[PoSu]PurpleAzn,2726,97,3,4,7,42.9%,42m
23412,2,BubbaHotep,2726,97,2,0,2,100.0%,43m
23412,1,AnubiS,2726,96,2,1,3,66.7%,3h
23412,2,TheKreator,2726,0,2,2,4,50.0%,2h
23412,1,Moenghus,2726,38,2,2,4,50.0%,2h
23412,1,Fermam,2726,0,2,3,5,40.0%,19m
23412,3,akaAVK,2726,123,2,5,7,28.6%,41m
23412,1,[AbcCo]proxyThor,2726,0,1,0,1,100.0%,16m
23412,3,[XNANIX]juanpax,2726,95,1,3,4,25.0%,33m
23412,1,muninn,2726,0,0,1,1,0.0%,1h
23412,1,[VECT]seanzor,2726,0,0,1,1,0.0%,33m
23412,1,UnGato,2726,0,0,1,1,0.0%,46m
23412,1,artanis,2726,0,0,2,2,0.0%,42m
23412,1,jangolover,2726,0,0,3,3,0.0%,2h
23447,2,Psycho,2725,1486,142,144,286,49.7%,19m
23447,3,Martz,2725,1362,132,114,246,53.7%,33m
23447,2,Humi,2725,976,125,130,255,49.0%,7m
23447,1,Fifi,2725,1593,93,84,177,52.5%,2h
23447,3,Preminition,2725,588,47,45,92,51.1%,31m
23447,3,[FEEKAL]BanjoMan,2725,962,42,38,80,52.5%,21m
23447,3,yuvius,2725,630,27,20,47,57.4%,32m
23447,3,LemonTek,2725,340,25,26,51,49.0%,29m
23447,3,Joe,2725,610,22,21,43,51.2%,20m
23447,3,Drale,2725,401,17,10,27,63.0%,32m
23447,2,EIO,2725,238,17,18,35,48.6%,32m
23447,1,ZionT,2725,470,15,24,39,38.5%,19m
23447,3,Swiftly,2725,328,13,11,24,54.2%,21m
23447,1,HOPLITE,2725,257,10,8,18,55.6%,1h
23447,1,aRogueShark,2725,244,8,4,12,66.7%,1h
23447,1,HmLee,2725,195,8,7,15,53.3%,2h
23447,1,ÐixieRëkt,2725,260,8,7,15,53.3%,2h
23447,3,TYMYOTUL,2725,143,8,11,19,42.1%,31m
23447,3,EderAu,2725,176,7,11,18,38.9%,10m
23447,1,FudgyXD,2725,116,3,3,6,50.0%,19m
23447,1,Koroz,2725,0,3,4,7,42.9%,3h
23447,2,[ZTempz]Phonexia,2725,0,2,3,5,40.0%,2h
23447,3,Panther,2725,62,2,8,10,20.0%,12m
23447,1,Bendomatic,2725,34,1,1,2,50.0%,13m
23447,1,Inkleth,2725,0,1,4,5,20.0%,2h
23447,1,[EndPro]victor,2725,0,0,1,1,0.0%,1h
23473,2,Alastor,2724,943,148,132,280,52.9%,9m
23473,1,Billy,2724,1598,125,114,239,52.3%,24m
23473,1,christopher,2724,1482,100,75,175,57.1%,44m
23473,3,JFGadita,2724,1384,82,71,153,53.6%,10m
23473,2,[sk3tch]Nomoreeliot,2724,1307,81,78,159,50.9%,48m
23473,3,ALPHA,2724,1554,80,62,142,56.3%,29m
23473,2,Romanrat,2724,1263,47,57,104,45.2%,46m
23473,3,[LTBV]gabriel,2724,906,33,35,68,48.5%,30m
23473,1,[PHNTMS]jonomosquito,2724,526,31,16,47,66.0%,1h
23473,1,BillBob,2724,880,30,27,57,52.6%,40m
23473,1,TzelDaru,2724,606,23,14,37,62.2%,19m
23473,3,Anducrazzzyy,2724,452,16,15,31,51.6%,29m
23473,3,NameWasTaken,2724,421,15,13,28,53.6%,27m
23473,3,[boooT]joker,2724,372,13,13,26,50.0%,48m
23473,1,BLANK,2724,266,9,4,13,69.2%,16m
23473,2,Fuzzy,2724,138,7,4,11,63.6%,2h
23473,3,Cortcyber,2724,232,7,7,14,50.0%,11m
23473,3,Magistrate,2724,169,6,4,10,60.0%,29m
23473,3,CaptainPlz,2724,30,5,8,13,38.5%,20m
23473,1,Tumbao,2724,78,3,0,3,100.0%,2h
23473,1,Naza,2724,0,3,5,8,37.5%,2h
23473,1,[HNPro]Wolfy,2724,42,2,2,4,50.0%,3h
23473,3,SubThreeHour,2724,30,2,2,4,50.0%,27m
23473,3,Blarg,2724,95,2,3,5,40.0%,45m
23473,1,shorty,2724,0,2,3,5,40.0%,19m
23473,2,Telomeres,2724,0,2,3,5,40.0%,42m
23473,3,[Assoc]WhEy,2724,60,2,6,8,25.0%,9m
23473,2,Nargothrond,2724,46,1,2,3,33.3%,2h
23473,1,iGauU,2724,0,0,1,1,0.0%,17m
23473,3,Zyone,2724,0,0,7,7,0.0%,2h
23503,3,Rocky,2723,1499,100,84,184,54.3%,10m
23503,1,Riku,2723,1400,52,46,98,53.1%,3h
23503,3,[PobSC]Donate,2723,1067,47,43,90,52.2%,21m
23503,1,TwoFaces,2723,856,42,7,49,85.7%,2h
23503,3,EvaParadise,2723,787,36,31,67,53.7%,11m
23503,3,Alex,2723,331,14,7,21,66.7%,45m
23503,1,[GOTG1]THUNDER,2723,425,14,8,22,63.6%,32m
23503,3,[MSHS09]OSIRIS,2723,329,13,8,21,61.9%,32m
23503,3,[iMkS]Sebastián,2723,325,11,12,23,47.8%,23m
23503,3,supernova,2723,269,11,15,26,42.3%,20m
23503,1,battlepants,2723,215,10,5,15,66.7%,1h
23503,1,Jollyyy,2723,0,4,1,5,80.0%,46m
23503,3,ronronvachon,2723,94,3,4,7,42.9%,15m
23503,1,Elevation,2723,38,2,0,2,100.0%,13m
23503,2,YahwehKing,2723,0,2,3,5,40.0%,24m
23503,2,MajorlyGamin,2723,0,2,3,5,40.0%,2h
23503,2,[G4M3RS]Xenagos,2723,0,2,3,5,40.0%,43m
23503,2,dankassmemes,2723,0,2,3,5,40.0%,2h
23503,2,PsycoDentist,2723,0,0,1,1,0.0%,14m
23522,3,Tassadar,2722,1578,169,150,319,53.0%,34m
23522,2,YagamiLight,2722,392,94,73,167,56.3%,15m
23522,1,willyam,2722,1478,75,56,131,57.3%,13m
23522,1,Ztigus,2722,1704,71,51,122,58.2%,1h
23522,3,Abandonation,2722,479,55,44,99,55.6%,34m
23522,1,locowarpro,2722,1020,41,26,67,61.2%,28m
23522,3,[DRU1DS]aaldwyn,2722,762,27,32,59,45.8%,10m
23522,1,THEDEMONKING,2722,541,20,14,34,58.8%,1h
23522,3,[GØSU]VonBiggCatt,2722,362,20,21,41,48.8%,48m
23522,3,[EViLE]tbworld,2722,376,15,14,29,51.7%,21m
23522,3,clio,2722,424,15,18,33,45.5%,11m
23522,3,[YBDBD]LastRebel,2722,322,11,12,23,47.8%,10m
23522,3,TrustChrist,2722,306,11,16,27,40.7%,48m
23522,1,[TGosuB]PROMETHIUM,2722,303,10,2,12,83.3%,42m
23522,3,[RwtM]Machaube,2722,253,10,5,15,66.7%,9m
23522,3,gotenks,2722,179,9,5,14,64.3%,38m
23522,1,Raiden,2722,288,8,5,13,61.5%,1h
23522,2,[C2N]GeneralGnome,2722,173,6,6,12,50.0%,11m
23522,2,Joei,2722,142,5,1,6,83.3%,13m
23522,3,[UGDC]convictioN,2722,177,5,5,10,50.0%,31m
23522,3,Sydirian,2722,106,3,2,5,60.0%,9m
23522,3,djt,2722,112,3,3,6,50.0%,24m
23522,2,vOiD,2722,0,3,4,7,42.9%,6m
23522,2,[GeekA]Fargos,2722,53,3,10,13,23.1%,12m
23522,3,[Guile]Vertex,2722,30,2,3,5,40.0%,30m
23522,1,[TgAg]UndeadBird,2722,0,2,3,5,40.0%,39m
23522,1,FrostyDog,2722,0,2,3,5,40.0%,2h
23522,2,Legolas,2722,0,2,3,5,40.0%,2h
23522,1,Evaneslink,2722,74,2,4,6,33.3%,2h
23522,3,AGoldenKey,2722,0,1,0,1,100.0%,23m
23522,1,Noblefire,2722,44,1,1,2,50.0%,2h
23522,1,ivanproo,2722,40,1,3,4,25.0%,24m
23522,2,Zaizoh,2722,0,0,1,1,0.0%,2h
23522,3,ChaosPigeon,2722,0,0,2,2,0.0%,34m
23522,3,BlackJack,2722,0,0,3,3,0.0%,10m
23522,3,[SICPe]dredsstone,2722,0,0,4,4,0.0%,48m
23558,3,Pip,2721,1478,359,339,698,51.4%,27m
23558,2,[MwaH]rocknroll,2721,293,80,76,156,51.3%,36m
23558,3,[Wehavu]AmonRa,2721,1308,51,48,99,51.5%,27m
23558,1,Flax,2721,797,43,54,97,44.3%,45m
23558,1,Nonimba,2721,486,16,10,26,61.5%,12m
23558,3,Niconiconi,2721,402,14,16,30,46.7%,16m
23558,3,MEDIC,2721,308,13,20,33,39.4%,7m
23558,3,PoppaMitch,2721,326,12,15,27,44.4%,4m
23558,1,LLCoolDrew,2721,425,11,9,20,55.0%,43m
23558,2,[meme]Tercac,2721,208,9,9,18,50.0%,34m
23558,2,BetterThanU,2721,278,9,19,28,32.1%,33m
23558,1,[zeez]Skeetskie,2721,210,8,10,18,44.4%,24m
23558,2,Politiks,2721,0,4,1,5,80.0%,32m
23558,1,[LuvPPs]Shag,2721,44,2,2,4,50.0%,16m
23558,1,Sabinfig,2721,0,1,0,1,100.0%,2h
23558,2,ArKain,2721,0,1,0,1,100.0%,2h
23558,3,ShepherdFire,2721,0,1,1,2,50.0%,34m
23558,2,Negan,2721,0,1,1,2,50.0%,3h
23558,1,Zelgadis,2721,0,1,1,2,50.0%,30m
23558,1,[AIURxT]DragonSlayer,2721,0,1,2,3,33.3%,48m
23558,1,[REEFR]purplekush,2721,0,0,1,1,0.0%,2h
23558,1,[GOPERÚ]Ashiran,2721,0,0,1,1,0.0%,40m
23558,3,BaliHai,2721,0,0,5,5,0.0%,5m
23581,1,[JUGOSC]Arthas,2720,434,36,18,54,66.7%,15m
23581,1,[xUGRx]Bean,2720,1022,35,33,68,51.5%,32m
23581,3,Demento,2720,699,30,23,53,56.6%,6m
23581,3,wolajacy,2720,727,30,29,59,50.8%,30m
23581,1,[4LOBOS]xXTheLionXx,2720,584,20,11,31,64.5%,36m
23581,1,Daicho,2720,344,12,14,26,46.2%,2h
23581,3,Kevinblaze,2720,326,11,19,30,36.7%,35m
23581,3,UHCHU,2720,250,8,6,14,57.1%,4m
23581,1,BdubzThaG,2720,197,7,3,10,70.0%,15m
23581,1,Fragolds,2720,132,5,5,10,50.0%,2h
23581,2,AgentOfChaos,2720,92,4,5,9,44.4%,2h
23581,2,[TG0]DANGO,2720,120,4,11,15,26.7%,21m
23581,1,TuMaMa,2720,112,3,3,6,50.0%,2h
23581,1,[Picard]xSol,2720,80,2,2,4,50.0%,2h
23581,2,craftking,2720,0,2,3,5,40.0%,2h
23581,1,Xottz,2720,0,1,0,1,100.0%,12m
23581,1,SkepticSloth,2720,0,1,0,1,100.0%,32m
23581,2,Findrell,2720,0,1,0,1,100.0%,2h
23581,3,[IPCSI]Carmesino,2720,0,1,4,5,20.0%,29m
23581,2,Kasshern,2720,0,0,1,1,0.0%,20m
23581,1,NOVA,2720,0,0,1,1,0.0%,3h
23581,3,Domecq,2720,0,0,5,5,0.0%,22m
23603,3,brseiye,2719,1589,408,406,814,50.1%,5m
23603,3,rodrigoelcid,2719,1603,285,280,565,50.4%,16m
23603,1,[AD3C]Aldeano,2719,1326,248,248,496,50.0%,38m
23603,3,TigerFish,2719,1268,107,80,187,57.2%,27m
23603,3,veqgooff,2719,1581,106,106,212,50.0%,16m
23603,1,LazyTurtle,2719,1580,80,78,158,50.6%,12m
23603,3,JoseAbel,2719,898,36,34,70,51.4%,44m
23603,3,[PobSC]Spaceman,2719,932,33,36,69,47.8%,7m
23603,3,[EZYtgt]BLAQNOVA,2719,439,17,14,31,54.8%,6m
23603,1,HigherPower,2719,405,11,14,25,44.0%,1h
23603,3,[HYDRAS]LoordTywin,2719,163,10,7,17,58.8%,7m
23603,2,Tranzige,2719,261,10,11,21,47.6%,13m
23603,2,Albare,2719,176,9,11,20,45.0%,4m
23603,1,rui,2719,0,4,1,5,80.0%,25m
23603,2,Rijndael,2719,0,4,2,6,66.7%,2h
23603,3,Quinardium,2719,133,3,4,7,42.9%,46m
23603,2,jose,2719,0,3,4,7,42.9%,19m
23603,1,[RaMpXx]NightShade,2719,44,2,1,3,66.7%,44m
23603,3,[FuNg]Mushroom,2719,60,2,7,9,22.2%,29m
23603,1,soN,2719,0,1,0,1,100.0%,2h
23603,2,Igloo,2719,0,1,1,2,50.0%,2h
23603,3,Wegman,2719,30,1,4,5,20.0%,27m
23603,1,selfmadesb,2719,0,0,1,1,0.0%,2h
23603,1,[BBDB]Zalathor,2719,0,0,2,2,0.0%,43m
23627,1,sean,2718,1426,207,205,412,50.2%,15m
23627,3,starkiller,2718,1497,82,86,168,48.8%,27m
23627,2,[ExecUt]Weetermachin,2718,771,43,45,88,48.9%,18m
23627,3,vladi,2718,889,35,35,70,50.0%,48m
23627,1,igorallycatz,2718,520,32,27,59,54.2%,1h
23627,1,Devastator,2718,764,31,22,53,58.5%,2h
23627,1,Remalaz,2718,529,24,9,33,72.7%,13m
23627,1,Vick,2718,493,20,18,38,52.6%,4m
23627,1,Sieghart,2718,401,15,5,20,75.0%,1h
23627,1,Consumed,2718,213,10,4,14,71.4%,2h
23627,3,SuperCop,2718,242,10,10,20,50.0%,48m
23627,1,LogiMcBear,2718,248,8,7,15,53.3%,2h
23627,3,[Raperz]Creamy,2718,118,7,7,14,50.0%,37m
23627,3,jungman,2718,245,7,8,15,46.7%,34m
23627,1,Cosmo,2718,159,6,6,12,50.0%,3h
23627,1,Elyas,2718,186,5,1,6,83.3%,2h
23627,3,mrprotodolo,2718,60,3,4,7,42.9%,10m
23627,3,seeque,2718,92,2,3,5,40.0%,19m
23627,3,Avocado,2718,0,2,4,6,33.3%,34m
23627,1,VinCenT,2718,0,1,1,2,50.0%,2h
23627,3,IxIST,2718,0,1,2,3,33.3%,46m
23627,3,Seajay,2718,0,1,4,5,20.0%,2h
23627,3,[UAK]Crispa,2718,30,1,8,9,11.1%,11m
23627,1,Hullmo,2718,0,0,1,1,0.0%,2h
23627,1,[WTSH]Luffman,2718,0,0,1,1,0.0%,1h
23627,3,Solace,2718,0,0,3,3,0.0%,10m
23627,2,Ribbons,2718,0,0,6,6,0.0%,2h
23654,3,[BTSRMY]LeeMinHo,2717,1222,77,58,135,57.0%,30m
23654,1,SaltShaker,2717,1473,67,37,104,64.4%,2h
23654,3,[F2AAA]coco,2717,774,33,27,60,55.0%,10m
23654,3,BrightSkull,2717,494,24,18,42,57.1%,27m
23654,1,SteinsStar,2717,524,19,27,46,41.3%,6m
23654,3,ohdoylerules,2717,467,18,18,36,50.0%,31m
23654,1,Probe,2717,396,14,12,26,53.8%,2h
23654,2,fenix,2717,280,10,13,23,43.5%,30m
23654,1,loner,2717,214,7,7,14,50.0%,2h
23654,1,Metric,2717,258,7,9,16,43.8%,2h
23654,3,Sebasthiian,2717,172,6,9,15,40.0%,16m
23654,3,AnArKyA,2717,156,6,9,15,40.0%,7m
23654,3,Sgnimm,2717,142,5,9,14,35.7%,37m
23654,1,cumberland,2717,0,4,1,5,80.0%,12m
23654,2,Ryan,2717,94,3,1,4,75.0%,2h
23654,2,duralumin,2717,0,3,4,7,42.9%,2h
23654,3,Simonsaysz,2717,30,3,5,8,37.5%,10m
23654,1,HertzBr,2717,48,3,5,8,37.5%,1h
23654,1,[AYAYAY]Dilmaster,2717,0,2,3,5,40.0%,13m
23654,3,Philthy,2717,0,2,3,5,40.0%,2h
23654,1,chocosnowman,2717,0,1,0,1,100.0%,1h
23654,1,liva,2717,0,1,1,2,50.0%,2h
23654,2,MERiUH,2717,95,1,1,2,50.0%,2h
23654,2,kerbells,2717,0,1,1,2,50.0%,14m
23654,1,monkeyking,2717,36,1,1,2,50.0%,19m
23654,1,Mobilize,2717,0,0,1,1,0.0%,2h
23654,1,[SIoth]omegabanana,2717,0,0,1,1,0.0%,1h
23654,1,llllllllllll,2717,0,0,1,1,0.0%,2h
23654,1,Nelonenon,2717,0,0,1,1,0.0%,7m
23654,1,[slvHRo]BrOnzeHerO,2717,0,0,8,8,0.0%,3h
23684,2,Wallaby,2716,1628,221,209,430,51.4%,27m
23684,3,zanuf,2716,1196,139,127,266,52.3%,8m
23684,3,Manguy,2716,1510,68,65,133,51.1%,10m
23684,2,Qshampoo,2716,943,37,36,73,50.7%,10m
23684,2,Duong,2716,490,33,35,68,48.5%,27m
23684,3,musclesmark,2716,482,17,20,37,45.9%,46m
23684,3,[ISTOP]PoOM,2716,348,13,13,26,50.0%,17m
23684,3,Selrahc,2716,354,13,15,28,46.4%,38m
23684,3,OriginZero,2716,368,13,19,32,40.6%,10m
23684,1,AbiFaith,2716,286,11,11,22,50.0%,2h
23684,1,[Rang3r]BDizzy,2716,314,10,2,12,83.3%,42m
23684,3,hylia,2716,151,7,5,12,58.3%,47m
23684,1,Destructor,2716,88,3,3,6,50.0%,4m
23684,3,protossx,2716,62,3,5,8,37.5%,29m
23684,1,[XpKb]Chiltonb,2716,96,2,1,3,66.7%,45m
23684,2,Rick,2716,0,1,0,1,100.0%,41m
23684,1,pabloariza,2716,36,1,2,3,33.3%,1h
23684,1,[FWWAB]Persistence,2716,0,0,1,1,0.0%,17m
23684,1,Zerodyme,2716,0,0,1,1,0.0%,4m
23684,1,[DukBrg]twoez,2716,0,0,1,1,0.0%,15m
23704,2,Trump,2715,1604,206,192,398,51.8%,20m
23704,3,Alex,2715,718,79,67,146,54.1%,18m
23704,1,[QcSuB]Grimmjow,2715,1651,74,63,137,54.0%,2h
23704,1,LadyNoob,2715,687,39,23,62,62.9%,2h
23704,3,LIGHT,2715,836,38,23,61,62.3%,13m
23704,2,[Msia]Firedamage,2715,639,21,28,49,42.9%,15m
23704,3,WizardJump,2715,404,15,18,33,45.5%,29m
23704,3,ShadowDragon,2715,338,11,8,19,57.9%,33m
23704,3,kyza,2715,254,9,8,17,52.9%,22m
23704,3,Grrmph,2715,217,8,9,17,47.1%,34m
23704,3,[Philos]Lebowski,2715,236,8,12,20,40.0%,12m
23704,2,[FFTC]Sugarzest,2715,0,4,2,6,66.7%,40m
23704,1,hunter,2715,88,4,2,6,66.7%,2h
23704,1,Hydra,2715,110,3,2,5,60.0%,2h
23704,2,Sindwarf,2715,0,3,4,7,42.9%,2h
23704,3,[Targus]dobisPR,2715,92,3,7,10,30.0%,27m
23704,1,[FACEEE]JRock,2715,0,2,1,3,66.7%,2h
23704,1,TigerNuts,2715,0,1,0,1,100.0%,1h
23704,1,GorillaKing,2715,0,0,1,1,0.0%,17m
23704,2,Kingpin,2715,0,0,2,2,0.0%,1h
23704,1,arcHIVE,2715,0,0,3,3,0.0%,1m
23725,2,DevOnCycle,2714,1525,279,276,555,50.3%,37m
23725,2,MikeHoncho,2714,1525,72,70,142,50.7%,31m
23725,3,Aline,2714,1162,60,63,123,48.8%,9m
23725,1,pumba,2714,1185,54,34,88,61.4%,3h
23725,3,[Asilo]Delonk,2714,754,45,35,80,56.2%,21m
23725,1,Drip,2714,581,22,16,38,57.9%,2h
23725,1,BigChungus,2714,647,21,15,36,58.3%,1h
23725,1,Burner,2714,178,11,16,27,40.7%,2h
23725,3,DangerusDino,2714,269,10,10,20,50.0%,23m
23725,1,[LUVMOM]DUDEWHOA,2714,259,7,4,11,63.6%,30m
23725,2,Hammburglar,2714,94,5,1,6,83.3%,29m
23725,2,Grudgebearer,2714,118,4,2,6,66.7%,2h
23725,3,LANDMASTER,2714,149,4,4,8,50.0%,1h
23725,1,[OGDRTY]FrankyMerman,2714,156,4,5,9,44.4%,2h
23725,3,Faje,2714,126,4,9,13,30.8%,31m
23725,1,crossmity,2714,76,3,2,5,60.0%,3h
23725,1,NachoZ,2714,93,3,3,6,50.0%,24m
23725,3,[PUlink]Unknown,2714,88,3,4,7,42.9%,10m
23725,1,Blitz,2714,97,2,1,3,66.7%,2h
23725,1,Gavist,2714,0,2,3,5,40.0%,1h
23725,1,[xLCx]Astral,2714,0,1,0,1,100.0%,2h
23725,1,[N006s]naruto,2714,0,1,0,1,100.0%,2h
23725,3,Edriel,2714,30,1,7,8,12.5%,16m
23725,1,Stav,2714,0,0,3,3,0.0%,2h
23749,1,Antreus,2713,1527,187,184,371,50.4%,48m
23749,3,[NM8]ROnDEAu,2713,1009,146,138,284,51.4%,15m
23749,3,tBmBdL,2713,1383,55,48,103,53.4%,38m
23749,3,[CHONK]HIJACK,2713,1032,44,37,81,54.3%,1m
23749,1,[FiFo]Verblazo,2713,925,39,24,63,61.9%,2h
23749,1,Souvenyr,2713,788,31,24,55,56.4%,1h
23749,2,Jibzip,2713,751,31,38,69,44.9%,27m
23749,3,zezima,2713,674,29,28,57,50.9%,6m
23749,1,Luisito,2713,328,14,5,19,73.7%,19m
23749,1,[TheSix]BigPuddin,2713,476,14,11,25,56.0%,25m
23749,3,Pieroagw,2713,230,13,13,26,50.0%,1m
23749,1,Lancelot,2713,299,8,4,12,66.7%,32m
23749,1,Jacpar,2713,256,7,5,12,58.3%,2h
23749,3,Boson,2713,120,6,7,13,46.2%,29m
23749,3,GeneralVidel,2713,168,6,9,15,40.0%,28m
23749,1,ghoster,2713,104,4,2,6,66.7%,46m
23749,1,YEET,2713,0,3,2,5,60.0%,1h
23749,2,pahxora,2713,90,3,3,6,50.0%,1h
23749,1,sYn,2713,163,3,3,6,50.0%,19m
23749,1,[KofW]Korbin,2713,0,3,4,7,42.9%,23m
23749,3,KingOHyrule,2713,121,2,3,5,40.0%,2h
23749,3,InvazorPer,2713,60,2,6,8,25.0%,48m
23749,1,DonPajerin,2713,0,1,0,1,100.0%,17m
23749,1,maestro,2713,0,1,0,1,100.0%,2h
23749,1,[ArnC]Xiidra,2713,0,1,3,4,25.0%,15m
23749,1,[ZsDrag]DragonZeus,2713,30,1,3,4,25.0%,36m
23749,1,Dpope,2713,0,0,1,1,0.0%,3h
23749,3,BananaLisk,2713,0,0,6,6,0.0%,34m
23777,1,[4GATE]Zandur,2712,1579,361,358,719,50.2%,22m
23777,3,RainbowStorm,2712,1486,114,110,224,50.9%,32m
23777,3,Commy,2712,1037,82,69,151,54.3%,23m
23777,3,[uepa]DANIEL,2712,1153,77,65,142,54.2%,35m
23777,2,[XpKAc]GlorioSoS,2712,786,53,54,107,49.5%,33m
23777,3,Mundinho,2712,852,37,30,67,55.2%,5m
23777,1,[TPGGXD]supermancito,2712,816,35,30,65,53.8%,2h
23777,3,Belbrose,2712,533,33,25,58,56.9%,13m
23777,3,[PROG]chaplin,2712,715,29,24,53,54.7%,27m
23777,1,[BLKOPS]Mellomike,2712,588,28,16,44,63.6%,20m
23777,1,[FalPal]FireEye,2712,603,27,13,40,67.5%,32m
23777,1,Zollagins,2712,686,25,19,44,56.8%,33m
23777,1,mcnugger,2712,616,23,14,37,62.2%,2h
23777,1,[GAA20]daniangel,2712,420,15,8,23,65.2%,3m
23777,1,[OTEL]ROOMMAA,2712,424,12,8,20,60.0%,15m
23777,3,Zero,2712,306,11,15,26,42.3%,16m
23777,1,SaladToss,2712,256,8,4,12,66.7%,2h
23777,3,ProMyToss,2712,204,7,10,17,41.2%,13m
23777,3,Sailax,2712,197,6,5,11,54.5%,36m
23777,1,HIENGHOST,2712,106,4,1,5,80.0%,46m
23777,2,DeSender,2712,140,4,5,9,44.4%,2h
23777,1,Crystal,2712,42,2,0,2,100.0%,17m
23777,1,LeoMelbourne,2712,105,2,3,5,40.0%,2h
23777,3,[LMI42]FragMAN,2712,58,2,9,11,18.2%,13m
23777,3,Stingººpac,2712,0,1,0,1,100.0%,40m
23777,1,[AbcCo]samuel,2712,0,1,0,1,100.0%,19m
23777,1,[Galley]Atticade,2712,0,1,0,1,100.0%,2h
23777,3,Xavier,2712,0,1,1,2,50.0%,46m
23777,1,Mitochondria,2712,30,1,2,3,33.3%,24m
23777,1,ErosGG,2712,42,1,3,4,25.0%,2h
23777,1,Pingu,2712,34,1,4,5,20.0%,1h
23777,1,Cycomaniack,2712,0,1,4,5,20.0%,13m
23777,2,MasterChief,2712,0,0,1,1,0.0%,2h
23810,2,Andromeda,2711,1193,179,182,361,49.6%,2m
23810,1,pacompia,2711,1361,132,130,262,50.4%,3h
23810,1,Olds,2711,1321,98,97,195,50.3%,20m
23810,2,misticum,2711,501,25,33,58,43.1%,28m
23810,1,IIIIIllIlIll,2711,546,21,18,39,53.8%,13m
23810,3,Smiles,2711,375,15,12,27,55.6%,32m
23810,3,MysterE,2711,226,8,9,17,47.1%,27m
23810,3,[FrnkZ]Newbish,2711,161,6,10,16,37.5%,6m
23810,3,StarFox,2711,60,3,4,7,42.9%,18m
23810,3,azzurro,2711,88,3,6,9,33.3%,48m
23810,3,[DETER]Dan,2711,92,3,9,12,25.0%,2m
23810,3,GamerShezma,2711,68,3,10,13,23.1%,36m
23810,3,Turing,2711,0,2,3,5,40.0%,2h
23810,3,kush,2711,60,2,12,14,14.3%,2h
23810,1,[xMETAx]EdmondDantes,2711,0,1,0,1,100.0%,17m
23810,2,Trotsky,2711,0,1,0,1,100.0%,2h
23810,1,Amdall,2711,0,1,0,1,100.0%,36m
23810,1,aeggin,2711,46,1,2,3,33.3%,1h
23810,1,Wolla,2711,34,1,2,3,33.3%,2h
23810,3,Biocide,2711,30,1,7,8,12.5%,22m
23810,1,EYEN,2711,0,0,1,1,0.0%,39m
23810,3,[QST]vizsion,2711,0,0,3,3,0.0%,10m
23810,2,Sirokuma,2711,0,0,8,8,0.0%,34m
23833,1,SadPanda,2710,1649,194,158,352,55.1%,2h
23833,1,BlackSky,2710,1632,146,118,264,55.3%,1h
23833,1,Lethaltempho,2710,1720,135,118,253,53.4%,2h
23833,3,WildOne,2710,1035,120,114,234,51.3%,8m
23833,2,Regri,2710,972,114,94,208,54.8%,23m
23833,1,[143s4]MidaS,2710,1469,84,68,152,55.3%,12m
23833,3,Suppressor,2710,1491,71,73,144,49.3%,21m
23833,1,[ExcIgN]Psychology,2710,1429,63,47,110,57.3%,13m
23833,1,zilitor,2710,663,37,32,69,53.6%,15m
23833,3,Blackstone,2710,795,36,30,66,54.5%,34m
23833,3,LaChatumare,2710,807,32,30,62,51.6%,11m
23833,1,LuVul,2710,699,27,21,48,56.2%,39m
23833,3,starpimp,2710,453,26,27,53,49.1%,27m
23833,1,MuDrone,2710,575,22,20,42,52.4%,13m
23833,1,Crazed,2710,382,15,5,20,75.0%,36m
23833,3,[Gnomed]YouGotGnomed,2710,378,15,17,32,46.9%,13m
23833,2,Sam,2710,141,4,2,6,66.7%,1h
23833,3,[ReB3L]KoRe,2710,118,4,10,14,28.6%,5m
23833,3,mentchstof,2710,93,3,4,7,42.9%,13m
23833,3,agustingamer,2710,86,3,7,10,30.0%,30m
23833,3,Marcus,2710,0,2,3,5,40.0%,1h
23833,1,jepi,2710,0,2,3,5,40.0%,19m
23833,1,terrapin,2710,67,2,7,9,22.2%,47m
23833,1,DarKSooN,2710,0,1,0,1,100.0%,13m
23833,1,ZzguerreroxX,2710,0,0,1,1,0.0%,31m
23833,1,vryvel,2710,0,0,1,1,0.0%,13m
23833,2,Gankage,2710,0,0,1,1,0.0%,1h
23860,3,xXTuxerXx,2709,1125,132,125,257,51.4%,31m
23860,3,Trunko,2709,1520,113,102,215,52.6%,39m
23860,2,Dennas,2709,1256,91,91,182,50.0%,17m
23860,3,[nieBla]allmikey,2709,1260,81,78,159,50.9%,16m
23860,2,viashino,2709,803,70,69,139,50.4%,15m
23860,3,Stinger,2709,1057,63,60,123,51.2%,24m
23860,3,WILY,2709,849,40,19,59,67.8%,5m
23860,3,Grateful,2709,934,36,33,69,52.2%,24m
23860,3,Tesla,2709,912,35,31,66,53.0%,10m
23860,3,Lazenca,2709,410,16,15,31,51.6%,15m
23860,3,ERRE,2709,306,12,13,25,48.0%,15m
23860,3,Redzone,2709,221,12,13,25,48.0%,48m
23860,1,[CARO]AfterNoonD,2709,321,12,18,30,40.0%,8m
23860,3,[αXLa]ZerGAcTiOn,2709,167,9,7,16,56.2%,27m
23860,3,[Simen]Winterfell,2709,199,8,7,15,53.3%,5m
23860,3,[LOHd]Survivor,2709,209,8,7,15,53.3%,32m
23860,3,Versace,2709,194,7,8,15,46.7%,11m
23860,3,[T1G]ThatOneGuy,2709,220,7,13,20,35.0%,27m
23860,1,DOMIxNATE,2709,96,5,7,12,41.7%,28m
23860,3,JonesTour,2709,173,5,8,13,38.5%,31m
23860,3,Hoss,2709,141,5,9,14,35.7%,23m
23860,1,Precision,2709,148,4,5,9,44.4%,2h
23860,1,SpaceRanger,2709,0,3,2,5,60.0%,2h
23860,3,Kiveling,2709,0,3,3,6,50.0%,10m
23860,1,[potind]Quantum,2709,97,2,1,3,66.7%,2h
23860,1,FénixHertz,2709,116,2,2,4,50.0%,1h
23860,2,sizedlyric,2709,0,2,3,5,40.0%,7m
23860,1,EzeCb,2709,0,2,3,5,40.0%,2h
23860,1,[ESTEQ]Dakyo,2709,0,1,1,2,50.0%,2h
23860,1,Axle,2709,30,1,3,4,25.0%,45m
23860,1,[CU1T]DaTa,2709,0,0,1,1,0.0%,2h
23891,3,Haindall,2708,1578,109,98,207,52.7%,28m
23891,1,Saiclops,2708,1587,66,46,112,58.9%,2h
23891,1,[cluez]ThedoctorS,2708,981,45,20,65,69.2%,1h
23891,3,Tisartktw,2708,1003,37,35,72,51.4%,24m
23891,3,[RULES]Norman,2708,922,34,35,69,49.3%,7m
23891,3,jefforces,2708,868,29,37,66,43.9%,3m
23891,3,STOOPS,2708,666,26,29,55,47.3%,10m
23891,1,[Ikar0s]ShaoFeiLon,2708,516,17,11,28,60.7%,31m
23891,1,FionaTheHipO,2708,531,17,13,30,56.7%,13m
23891,1,Paul,2708,454,16,10,26,61.5%,2h
23891,3,xhutrx,2708,296,11,11,22,50.0%,9m
23891,1,Sneakysnakez,2708,297,8,3,11,72.7%,32m
23891,1,REDRUM,2708,208,7,4,11,63.6%,2h
23891,1,HelloWorld,2708,222,7,4,11,63.6%,31m
23891,2,Odnal,2708,232,7,13,20,35.0%,21m
23891,1,Okkie,2708,172,6,3,9,66.7%,32m
23891,3,Thrang,2708,162,6,12,18,33.3%,11m
23891,1,Hachibobo,2708,159,5,5,10,50.0%,2h
23891,1,ScottAbrams,2708,203,5,7,12,41.7%,43m
23891,3,VelariTribe,2708,0,4,1,5,80.0%,28m
23891,1,MxCatC,2708,78,3,0,3,100.0%,2h
23891,1,serge,2708,78,3,3,6,50.0%,2h
23891,3,[Ichnac]Fideox,2708,131,3,4,7,42.9%,24m
23891,3,WhiteBoy,2708,90,3,6,9,33.3%,12m
23891,2,Kyo,2708,44,2,0,2,100.0%,1h
23891,1,WildHopper,2708,60,2,1,3,66.7%,44m
23891,1,Mio,2708,0,2,3,5,40.0%,3h
23891,1,SouL,2708,0,1,0,1,100.0%,17m
23891,1,[LMBD]Lambda,2708,0,1,0,1,100.0%,2h
23891,1,Taeyang,2708,0,1,0,1,100.0%,39m
23891,1,[nieBla]waINe,2708,0,1,1,2,50.0%,13m
23891,1,Xiu,2708,42,1,1,2,50.0%,19m
23891,1,Akolatroink,2708,38,1,3,4,25.0%,47m
23891,1,[danuts]tonsofdamage,2708,0,1,3,4,25.0%,1h
23891,1,captainGeech,2708,0,0,1,1,0.0%,30m
23891,1,JOSE,2708,0,0,2,2,0.0%,32m
23927,3,[αXLa]Jopipemi,2707,1569,267,242,509,52.5%,32m
23927,3,Zaraki,2707,1163,132,129,261,50.6%,37m
23927,3,CPLMWU,2707,1585,109,112,221,49.3%,3m
23927,3,Skyronz,2707,1134,82,57,139,59.0%,24m
23927,1,Krystek,2707,983,43,32,75,57.3%,2h
23927,1,NoelGeezy,2707,1150,43,52,95,45.3%,11m
23927,3,[MAXTRX]MAXTORX,2707,877,40,43,83,48.2%,27m
23927,3,SuperPlayer,2707,796,30,31,61,49.2%,12m
23927,2,Azareel,2707,664,28,25,53,52.8%,25m
23927,3,SirNoob,2707,551,24,22,46,52.2%,5m
23927,1,negus,2707,628,23,14,37,62.2%,2h
23927,3,[PMgaf]napoleon,2707,472,18,15,33,54.5%,34m
23927,1,[SobH]tingales,2707,338,14,11,25,56.0%,13m
23927,3,shdwpuppet,2707,349,14,14,28,50.0%,16m
23927,3,FXmarc,2707,311,13,13,26,50.0%,27m
23927,3,Vison,2707,155,12,12,24,50.0%,30m
23927,2,cipcop,2707,228,10,12,22,45.5%,31m
23927,2,joerabbit,2707,212,8,10,18,44.4%,20m
23927,1,fitOx,2707,182,7,4,11,63.6%,30m
23927,1,Mikey,2707,169,7,7,14,50.0%,2h
23927,1,whitecats,2707,199,6,5,11,54.5%,1h
23927,2,[FyHr]MaEkoLe,2707,92,4,5,9,44.4%,34m
23927,1,Kaisher,2707,40,2,0,2,100.0%,2h
23927,1,Jaredishott,2707,42,2,2,4,50.0%,36m
23927,1,[TOOFTC]nessagirl,2707,0,2,3,5,40.0%,4m
23927,3,levy,2707,0,2,3,5,40.0%,9m
23927,1,[AQM]Tyer,2707,0,1,0,1,100.0%,1h
23927,1,sKINdIAMOND,2707,0,1,2,3,33.3%,2h
23927,3,LRDRAPESLOTH,2707,0,1,3,4,25.0%,32m
23927,1,[SFx]SFxOnoratodu,2707,97,1,4,5,20.0%,8m
23927,2,AndysHyper,2707,0,1,4,5,20.0%,1h
23927,2,MDMA,2707,0,0,1,1,0.0%,2h
23927,1,skytum,2707,0,0,1,1,0.0%,32m
23960,3,SSS,2706,925,162,158,320,50.6%,29m
23960,1,Enkidu,2706,1270,152,126,278,54.7%,4m
23960,3,MarTinGusTav,2706,1539,97,85,182,53.3%,4m
23960,1,[TGosuB]DeadDumble,2706,1194,93,72,165,56.4%,19m
23960,3,[CscE]Chakal,2706,571,43,40,83,51.8%,9m
23960,1,Zolek,2706,826,35,17,52,67.3%,2h
23960,3,[ROYALS]SlowNSteady,2706,535,20,19,39,51.3%,34m
23960,3,Victory,2706,377,16,16,32,50.0%,7m
23960,2,chafanet,2706,326,13,14,27,48.1%,29m
23960,3,[AFLOZE]JADCM,2706,344,11,13,24,45.8%,34m
23960,1,KoutaKun,2706,235,10,6,16,62.5%,30m
23960,3,Dizzy,2706,251,10,10,20,50.0%,2h
23960,3,Pita,2706,249,10,12,22,45.5%,48m
23960,3,[Slipp]ThePloof,2706,237,8,7,15,53.3%,47m
23960,1,ricko,2706,217,7,3,10,70.0%,2h
23960,2,Signicher,2706,216,7,12,19,36.8%,24m
23960,2,[KING3]tehpenix,2706,224,6,2,8,75.0%,2h
23960,1,Sakuragi,2706,146,6,3,9,66.7%,1h
23960,1,ThreeFour,2706,97,4,5,9,44.4%,2h
23960,1,Alandri,2706,0,3,2,5,60.0%,2h
23960,1,DukeNukem,2706,120,3,6,9,33.3%,2h
23960,3,DimebagOz,2706,48,3,9,12,25.0%,24m
23960,1,camilo,2706,76,2,1,3,66.7%,3h
23960,1,[NOODLS]Luna,2706,34,2,2,4,50.0%,2h
23960,3,Squirrlz,2706,0,2,3,5,40.0%,1h
23960,1,IDK,2706,0,2,4,6,33.3%,35m
23960,3,Seven,2706,30,2,6,8,25.0%,35m
23960,1,hahaveryfun,2706,0,1,0,1,100.0%,2h
23960,1,vongroa,2706,0,1,0,1,100.0%,20m
23960,1,OwLHaiR,2706,42,1,1,2,50.0%,2h
23960,1,NPCmajor,2706,0,0,1,1,0.0%,2h
23960,2,ZaNfeR,2706,0,0,1,1,0.0%,2h
23960,1,Titans,2706,0,0,2,2,0.0%,47m
23960,3,ExerTus,2706,0,0,4,4,0.0%,6m
23994,2,FMFO,2705,1161,137,123,260,52.7%,48m
23994,1,Spock,2705,1572,86,76,162,53.1%,13m
23994,3,Menfrii,2705,274,69,50,119,58.0%,30m
23994,3,[PobSC]Apare,2705,945,42,34,76,55.3%,6m
23994,1,ELMEJORPVP,2705,746,39,33,72,54.2%,23m
23994,3,Kelm,2705,426,36,41,77,46.8%,26m
23994,3,DeathPasta,2705,754,33,27,60,55.0%,9m
23994,1,LOCOTAKU,2705,646,27,14,41,65.9%,1h
23994,3,Garyk,2705,414,21,16,37,56.8%,3m
23994,1,Husker,2705,358,13,13,26,50.0%,19m
23994,1,zara,2705,362,13,16,29,44.8%,2h
23994,3,[DhZAc1]VeiD,2705,317,12,12,24,50.0%,31m
23994,1,Octavian,2705,262,10,10,20,50.0%,3h
23994,1,RichardA,2705,335,9,6,15,60.0%,7m
23994,1,Chadwick,2705,234,8,7,15,53.3%,47m
23994,3,[YGOMFP]kaiba,2705,176,8,9,17,47.1%,21m
23994,1,jsviau,2705,106,6,3,9,66.7%,2h
23994,3,LATAR,2705,135,6,4,10,60.0%,6m
23994,1,Turbulent,2705,204,6,5,11,54.5%,23m
23994,3,Kree,2705,150,5,2,7,71.4%,11m
23994,1,ChirpyBird,2705,122,3,2,5,60.0%,20m
23994,1,ErnestoFM,2705,18,2,0,2,100.0%,2h
23994,1,[NextDC]IceDRothen,2705,74,2,1,3,66.7%,2h
23994,1,Syzygy,2705,118,2,1,3,66.7%,2h
23994,1,[LGNxx]Gouda,2705,0,1,0,1,100.0%,36m
23994,2,KushUps,2705,0,1,0,1,100.0%,2h
23994,1,csk,2705,0,1,0,1,100.0%,46m
23994,3,Myrias,2705,97,1,1,2,50.0%,8m
23994,1,CoMpLeXnAmE,2705,0,1,5,6,16.7%,2h
23994,3,StimPackFury,2705,0,0,1,1,0.0%,2h
24024,1,[xTWx]Attilles,2704,1546,262,254,516,50.8%,47m
24024,3,Gufaza,2704,608,52,44,96,54.2%,30m
24024,1,[Raytar]Everett,2704,1494,52,52,104,50.0%,2h
24024,1,GypsyDanger,2704,734,31,18,49,63.3%,2h
24024,1,[αB]Darren,2704,773,31,20,51,60.8%,2h
24024,1,marcusvs,2704,613,21,15,36,58.3%,15m
24024,3,[neuroS]Pseudoboss,2704,317,12,12,24,50.0%,3m
24024,1,supirionxD,2704,306,10,8,18,55.6%,2h
24024,3,[LOPELU]DanCR,2704,315,9,12,21,42.9%,23m
24024,3,Siopaopaopao,2704,191,8,7,15,53.3%,32m
24024,1,[Kalra]Angelic,2704,260,7,7,14,50.0%,20m
24024,1,Animus,2704,201,6,7,13,46.2%,22m
24024,3,Jhousef,2704,156,6,8,14,42.9%,10m
24024,3,[XpKAc]dieguito,2704,191,5,2,7,71.4%,3h
24024,2,[iMpB]Armarus,2704,107,5,5,10,50.0%,33m
24024,1,ArcoKodiak,2704,0,4,1,5,80.0%,42m
24024,3,rasencio,2704,0,3,3,6,50.0%,15m
24024,3,nOOl,2704,89,3,4,7,42.9%,31m
24024,1,Nicodemus,2704,0,1,0,1,100.0%,2h
24024,1,Minecraft,2704,0,1,1,2,50.0%,2h
24024,1,[A225]Luuser,2704,40,1,1,2,50.0%,2h
24024,1,coffeeco,2704,0,1,2,3,33.3%,1m
24024,2,TrueArteest,2704,44,1,2,3,33.3%,2h
24024,1,Blitz,2704,0,0,1,1,0.0%,15m
24048,3,Benji,2703,1307,214,218,432,49.5%,34m
24048,3,Roger,2703,1524,152,128,280,54.3%,6m
24048,3,aNoNyMoUs,2703,1574,132,110,242,54.5%,7m
24048,3,georgebro,2703,1245,99,88,187,52.9%,47m
24048,2,DarkTeMpLaR,2703,1350,91,90,181,50.3%,29m
24048,3,[GFP]Quake,2703,1234,53,43,96,55.2%,26m
24048,1,[Hakir0]RobStark,2703,823,45,40,85,52.9%,2h
24048,2,Bloodfuser,2703,1090,37,45,82,45.1%,10m
24048,1,donmono,2703,968,33,32,65,50.8%,2h
24048,3,donito,2703,673,26,23,49,53.1%,30m
24048,2,[Saltye]DragL,2703,511,19,21,40,47.5%,24m
24048,2,llllllllllll,2703,338,12,18,30,40.0%,16m
24048,3,Scythe,2703,261,11,11,22,50.0%,2h
24048,1,mazzy,2703,302,9,7,16,56.2%,2h
24048,1,Derpfestor,2703,212,7,3,10,70.0%,2h
24048,2,tsd,2703,207,7,4,11,63.6%,1h
24048,1,Frank,2703,203,7,7,14,50.0%,3h
24048,1,[1318]IndyMan,2703,152,5,2,7,71.4%,2h
24048,1,[WOBA]Mira,2703,138,5,2,7,71.4%,13m
24048,1,LSabroso,2703,160,5,2,7,71.4%,47m
24048,3,revek,2703,152,4,2,6,66.7%,26m
24048,1,Seabizzle,2703,126,4,5,9,44.4%,46m
24048,3,[SABO]Alditux,2703,0,3,1,4,75.0%,2h
24048,3,MMM,2703,93,3,4,7,42.9%,39m
24048,1,Petrichor,2703,72,2,1,3,66.7%,2h
24048,3,oaxsAtrus,2703,0,2,3,5,40.0%,2h
24048,3,lolkopf,2703,0,2,3,5,40.0%,34m
24048,1,[SLPDKY]Bondzai,2703,0,2,3,5,40.0%,1h
24048,1,Stick,2703,0,1,0,1,100.0%,2h
24048,1,Yamaxanadu,2703,38,1,3,4,25.0%,42m
24048,2,[StHd]Khalioz,2703,30,1,8,9,11.1%,15m
24048,1,[DeCan]DeLiverShot,2703,0,0,1,1,0.0%,39m
24048,1,Kael,2703,0,0,1,1,0.0%,2h
24048,1,Slugster,2703,0,0,2,2,0.0%,23m
24048,1,Flaky,2703,0,0,4,4,0.0%,2h
24083,2,[16424]Mandingo,2702,1342,63,72,135,46.7%,18m
24083,3,Endlestorm,2702,781,54,50,104,51.9%,22m
24083,2,Hateable,2702,612,30,34,64,46.9%,15m
24083,2,Rex,2702,418,28,29,57,49.1%,22m
24083,3,[ArmyGG]Akiva,2702,678,25,27,52,48.1%,7m
24083,2,[Cryptc]Syngularity,2702,746,25,39,64,39.1%,28m
24083,1,Santini,2702,547,22,12,34,64.7%,2h
24083,1,lagent,2702,478,19,11,30,63.3%,2h
24083,1,KickAss,2702,397,18,9,27,66.7%,12m
24083,3,Darknorth,2702,358,12,17,29,41.4%,29m
24083,3,[PN]Gillkin,2702,291,11,12,23,47.8%,43m
24083,3,[Titti]CodeScreds,2702,303,11,13,24,45.8%,15m
24083,1,double,2702,188,6,5,11,54.5%,2h
24083,3,Jamepok,2702,88,4,5,9,44.4%,35m
24083,1,Jawbreaker,2702,0,3,2,5,60.0%,13m
24083,2,SkyrimFan,2702,0,3,4,7,42.9%,25m
24083,1,AndyRewFoo,2702,0,2,3,5,40.0%,1h
24083,2,BBSolarwind,2702,0,1,0,1,100.0%,1h
24083,1,Kvothe,2702,0,0,2,2,0.0%,13m
24102,2,NSwarrior,2701,1286,103,105,208,49.5%,6m
24102,2,ATTICUSPRIME,2701,478,60,68,128,46.9%,18m
24102,2,MrRoschar,2701,1368,56,55,111,50.5%,7m
24102,1,pipo,2701,1154,42,36,78,53.8%,13m
24102,2,[ZTemps]LevelNN,2701,445,28,34,62,45.2%,29m
24102,1,Hermes,2701,542,18,12,30,60.0%,22m
24102,1,[MPC]JaySmiles,2701,430,18,13,31,58.1%,2h
24102,1,[AnWVS]Ivan,2701,432,16,8,24,66.7%,45m
24102,2,Fisch,2701,326,14,15,29,48.3%,5m
24102,3,Nitz,2701,303,11,10,21,52.4%,37m
24102,1,Yodaman,2701,200,6,6,12,50.0%,2h
24102,3,Pinion,2701,0,4,6,10,40.0%,2h
24102,1,[MadK]ChatarraSS,2701,86,3,1,4,75.0%,30m
24102,1,[BeGees]Sensei,2701,0,3,2,5,60.0%,2h
24102,1,[Bento]ZANjapan,2701,125,3,3,6,50.0%,1h
24102,1,YoshinonHero,2701,118,3,3,6,50.0%,24m
24102,2,KaiKaiV,2701,0,3,4,7,42.9%,3m
24102,1,[GClan]Focus,2701,42,1,2,3,33.3%,13m
24102,3,[uT4]Overkill,2701,0,1,3,4,25.0%,28m
24102,1,Zapperman,2701,42,1,3,4,25.0%,1h
24102,1,Joeski,2701,0,0,2,2,0.0%,1h
24102,1,[TSLS]drew,2701,0,0,3,3,0.0%,2h
24102,1,Carpenteria,2701,0,0,4,4,0.0%,33m
24125,3,KBroomes,2700,1367,118,118,236,50.0%,3m
24125,2,GideonKing,2700,1364,102,93,195,52.3%,20m
24125,3,[2027]HolySquid,2700,1521,81,62,143,56.6%,48m
24125,3,Valentine,2700,1223,62,41,103,60.2%,47m
24125,1,[CosEng]spectRUM,2700,1325,55,40,95,57.9%,2h
24125,2,RailGun,2700,908,37,34,71,52.1%,3m
24125,3,SloppyJoeBid,2700,757,33,23,56,58.9%,35m
24125,1,[SC2B]FunkiDunki,2700,587,26,8,34,76.5%,19m
24125,3,[BGI]Solitude,2700,460,26,25,51,51.0%,13m
24125,1,Cowclops,2700,726,24,19,43,55.8%,3h
24125,2,BAYACETO,2700,416,13,20,33,39.4%,24m
24125,1,[DARKLP]MuffinTop,2700,314,11,11,22,50.0%,19m
24125,1,CutUpKiwi,2700,308,9,7,16,56.2%,42m
24125,3,[Eorzea]Wolrund,2700,121,7,6,13,53.8%,35m
24125,3,heyya,2700,216,7,15,22,31.8%,47m
24125,1,MioFx,2700,230,6,5,11,54.5%,3h
24125,1,mathyou,2700,194,5,5,10,50.0%,2h
24125,3,TENET,2700,149,5,7,12,41.7%,35m
24125,3,GregoryMrMan,2700,90,5,7,12,41.7%,13m
24125,2,handyman,2700,162,5,16,21,23.8%,19m
24125,2,Naomi,2700,91,3,3,6,50.0%,2h
24125,3,Hateless,2700,0,2,3,5,40.0%,2h
24125,1,[SigmaV]Ice,2700,0,1,0,1,100.0%,2h
24125,1,RiceNinja,2700,95,1,2,3,33.3%,46m
24125,1,[SCboys]Coopernana,2700,0,0,1,1,0.0%,1h
24125,1,[MSTRO]HUSSAMA,2700,0,0,1,1,0.0%,2h
24125,1,blade,2700,0,0,1,1,0.0%,1m
24125,1,RIXIZEUS,2700,0,0,1,1,0.0%,2h
24125,2,llllllllllll,2700,0,0,1,1,0.0%,47m
24154,2,Peter,2699,1076,164,157,321,51.1%,3m
24154,2,SuperSterlin,2699,1494,97,95,192,50.5%,9m
24154,3,[Haze4z]Bluedreamz,2699,1484,60,63,123,48.8%,7m
24154,3,[SReis]AngeluUwU,2699,601,34,28,62,54.8%,2m
24154,2,Blue,2699,642,27,23,50,54.0%,38m
24154,3,Inzider,2699,453,25,17,42,59.5%,12m
24154,2,[Makia]ChuckNorris,2699,525,17,25,42,40.5%,16m
24154,3,Tommy,2699,367,15,16,31,48.4%,18m
24154,1,TheHolyAsdf,2699,269,12,6,18,66.7%,2h
24154,1,[Young]CastinStorms,2699,389,12,7,19,63.2%,2h
24154,3,Ssserbberus,2699,159,11,12,23,47.8%,24m
24154,3,oze,2699,294,9,12,21,42.9%,27m
24154,1,JEREMYVII,2699,230,6,8,14,42.9%,2h
24154,3,PetitFromage,2699,204,6,12,18,33.3%,23m
24154,2,russo,2699,196,5,4,9,55.6%,20m
24154,1,HumbleCat,2699,144,5,7,12,41.7%,21m
24154,1,FORD,2699,104,3,1,4,75.0%,1h
24154,1,wafflefriez,2699,134,3,1,4,75.0%,3h
24154,1,[SHLA]VacancyYY,2699,106,3,2,5,60.0%,2h
24154,1,[FGHER]Ben,2699,116,3,4,7,42.9%,1h
24154,3,Lemon,2699,96,3,5,8,37.5%,34m
24154,3,AlEHaD,2699,90,3,7,10,30.0%,1m
24154,3,Joss,2699,0,2,3,5,40.0%,2h
24154,2,TheOne,2699,0,1,0,1,100.0%,47m
24154,2,GoldK,2699,89,1,1,2,50.0%,39m
24154,1,hunterbscm,2699,40,1,2,3,33.3%,2h
24154,3,[xPNTx]Ulrezaj,2699,0,1,4,5,20.0%,10m
24154,1,BalanceThis,2699,0,0,1,1,0.0%,1h
24154,1,oncProNinety,2699,0,0,2,2,0.0%,46m
24183,1,MaxHeadroom,2698,1619,213,192,405,52.6%,1h
24183,3,[GGLMNX]Lancastrater,2698,1263,69,59,128,53.9%,48m
24183,3,[0cool]Leetsteele,2698,517,34,28,62,54.8%,7m
24183,2,radu,2698,536,20,23,43,46.5%,10m
24183,3,[CNBNZ]Doraleix,2698,475,18,16,34,52.9%,35m
24183,1,ItsGeomecraf,2698,359,11,6,17,64.7%,1h
24183,2,Mustache,2698,310,10,21,31,32.3%,38m
24183,3,[720p]Snapperkai,2698,250,9,14,23,39.1%,7m
24183,3,hamel,2698,261,8,12,20,40.0%,35m
24183,1,[zernex]STETMANN,2698,239,7,3,10,70.0%,3h
24183,3,[ML4WD]bossdog,2698,168,6,7,13,46.2%,34m
24183,3,[MLWK]Vepeerre,2698,194,5,8,13,38.5%,8m
24183,3,AnoffeX,2698,97,4,6,10,40.0%,2h
24183,3,[AUSMAN]Zoolies,2698,144,3,6,9,33.3%,8m
24183,1,[GgRiCe]Killernator,2698,0,2,3,5,40.0%,40m
24183,2,killu,2698,0,1,1,2,50.0%,2h
24183,2,RawDawg,2698,0,0,1,1,0.0%,2h
24183,1,JollyGren,2698,0,0,2,2,0.0%,2h
24183,1,Logic,2698,73,0,4,4,0.0%,22m
24202,2,ChetUbetcha,2697,1368,349,344,693,50.4%,16m
24202,2,[Wehavu]Tactical,2697,1563,218,223,441,49.4%,15m
24202,2,neomatrix,2697,1540,146,136,282,51.8%,38m
24202,3,phlanic,2697,1534,123,109,232,53.0%,3m
24202,3,[Epokhé]Gamaliel,2697,1547,117,108,225,52.0%,21m
24202,1,[Tyber]Badgingworth,2697,1697,116,92,208,55.8%,2h
24202,1,micaly,2697,1151,63,48,111,56.8%,2h
24202,3,PcpHappyFace,2697,433,61,47,108,56.5%,2m
24202,3,[CatMou]alex,2697,890,34,33,67,50.7%,3m
24202,1,Alex,2697,436,19,13,32,59.4%,1h
24202,1,Bobblehead,2697,402,15,8,23,65.2%,25m
24202,1,Casval,2697,406,15,17,32,46.9%,2h
24202,3,[CGB]Zelek,2697,370,14,10,24,58.3%,28m
24202,1,[PRB4SL]Seph,2697,324,11,11,22,50.0%,1m
24202,1,Angainor,2697,104,7,3,10,70.0%,1h
24202,1,david,2697,221,6,2,8,75.0%,2h
24202,2,[KI00]Noble,2697,198,6,6,12,50.0%,2h
24202,1,[FxB]Lunarstorm,2697,226,6,7,13,46.2%,40m
24202,3,Omar,2697,0,4,1,5,80.0%,2h
24202,1,Khan,2697,165,3,2,5,60.0%,46m
24202,3,Sqigy,2697,0,3,3,6,50.0%,15m
24202,2,HotSoupForJD,2697,0,3,4,7,42.9%,10m
24202,1,Blazebolts,2697,38,2,0,2,100.0%,17m
24202,3,Imaorta,2697,0,2,3,5,40.0%,2h
24202,1,jonflybynigh,2697,0,2,3,5,40.0%,2h
24202,1,Justiceiro,2697,0,1,0,1,100.0%,2h
24202,1,captainkerk,2697,0,0,1,1,0.0%,2h
24229,2,[Lotr1]Ben,2696,1537,275,276,551,49.9%,25m
24229,1,Yeshua,2696,833,37,25,62,59.7%,1h
24229,1,Southpaw,2696,633,27,22,49,55.1%,44m
24229,1,decross,2696,757,26,24,50,52.0%,7m
24229,1,Grumion,2696,652,21,20,41,51.2%,18m
24229,2,NIUHURRU,2696,564,19,28,47,40.4%,14m
24229,3,kalamaco,2696,316,17,10,27,63.0%,33m
24229,3,Belwas,2696,391,17,14,31,54.8%,24m
24229,3,[SLKNM]Rapmona,2696,479,16,20,36,44.4%,17m
24229,3,[TGosuD]PDubs,2696,261,11,13,24,45.8%,30m
24229,3,MagnusDeyker,2696,322,11,14,25,44.0%,37m
24229,1,Cebrius,2696,193,6,0,6,100.0%,2h
24229,3,Beastmode,2696,193,6,5,11,54.5%,16m
24229,1,ThreeBeans,2696,176,6,5,11,54.5%,25m
24229,1,[Atone]Dadbod,2696,198,6,6,12,50.0%,1m
24229,3,ayroyalty,2696,96,6,10,16,37.5%,34m
24229,2,[WofA]BigMeatLarry,2696,138,5,8,13,38.5%,26m
24229,1,Ubereem,2696,107,3,4,7,42.9%,2h
24229,1,MajesticRoar,2696,0,2,3,5,40.0%,17m
24229,1,[CHAOSV]Griffin,2696,0,1,0,1,100.0%,44m
24229,1,spam,2696,42,1,3,4,25.0%,1h
24229,3,[iCade]gtr,2696,30,1,4,5,20.0%,10m
24229,1,Max,2696,0,1,4,5,20.0%,1h
24229,1,Zerax,2696,0,0,1,1,0.0%,2h
24253,3,[TGosuD]Nam,2695,1534,186,159,345,53.9%,34m
24253,3,[SWOU]Amagno,2695,1518,133,126,259,51.4%,34m
24253,3,DonPablo,2695,1576,91,77,168,54.2%,6m
24253,1,SirZechs,2695,1191,79,79,158,50.0%,37m
24253,1,Kedgann,2695,835,64,33,97,66.0%,13m
24253,3,TheProbe,2695,578,61,66,127,48.0%,37m
24253,3,MarceloT,2695,566,41,28,69,59.4%,37m
24253,1,MonkEllipse,2695,787,31,22,53,58.5%,2h
24253,2,Voltic,2695,408,18,17,35,51.4%,3m
24253,1,[Mexxco]thebebo,2695,343,13,29,42,31.0%,22m
24253,1,ERICISABROAD,2695,260,10,2,12,83.3%,43m
24253,1,Stem,2695,252,9,8,17,52.9%,2h
24253,3,Rudolph,2695,249,9,14,23,39.1%,9m
24253,3,SalmonYogurt,2695,169,8,6,14,57.1%,29m
24253,1,Jasian,2695,276,8,8,16,50.0%,25m
24253,3,Witon,2695,0,3,2,5,60.0%,2h
24253,1,[JEC1]SwingFox,2695,71,3,4,7,42.9%,3h
24253,3,Genie,2695,95,3,4,7,42.9%,35m
24253,3,[EXGG]RayYellow,2695,86,3,7,10,30.0%,49m
24253,3,Gurrinho,2695,0,2,3,5,40.0%,32m
24253,1,FuGgErNaUt,2695,0,2,3,5,40.0%,2h
24253,2,Barnabas,2695,0,1,1,2,50.0%,2h
24253,1,PacoCoss,2695,38,1,1,2,50.0%,2h
24253,1,[POL]WildRage,2695,0,1,1,2,50.0%,17m
24253,1,Basualt,2695,0,0,1,1,0.0%,45m
24253,1,[Optim5]Negativity,2695,0,0,2,2,0.0%,2h
24253,1,Garfias,2695,0,0,2,2,0.0%,18m
24253,1,[JUGOS]tuto,2695,0,0,3,3,0.0%,13m
24253,3,CubeCow,2695,0,0,6,6,0.0%,27m
24282,3,[EpicG]Ramci,2694,1440,229,209,438,52.3%,2m
24282,3,Eggyokeo,2694,1247,115,124,239,48.1%,23m
24282,1,DOOMSDAY,2694,1631,95,85,180,52.8%,1m
24282,3,WEISSLOCK,2694,1377,95,95,190,50.0%,9m
24282,3,Relic,2694,1482,80,76,156,51.3%,34m
24282,3,ESPsparky,2694,1485,72,66,138,52.2%,31m
24282,2,Chandika,2694,1396,50,62,112,44.6%,29m
24282,3,Bambi,2694,779,45,45,90,50.0%,7m
24282,3,Fikri,2694,892,35,30,65,53.8%,34m
24282,1,Markp,2694,887,34,26,60,56.7%,46m
24282,3,Tork,2694,808,33,33,66,50.0%,27m
24282,3,Fenixfallen,2694,676,28,26,54,51.9%,48m
24282,3,YungGohan,2694,782,27,43,70,38.6%,21m
24282,1,[XxPwnX]LLShadowsX,2694,594,26,16,42,61.9%,2h
24282,3,MrFreeze,2694,371,14,16,30,46.7%,4m
24282,1,Syrupy,2694,373,13,10,23,56.5%,2h
24282,3,[RngRng]SLeeP,2694,322,11,16,27,40.7%,6m
24282,3,[dodgy]LukaLuka,2694,200,8,6,14,57.1%,30m
24282,3,Matticus,2694,244,8,12,20,40.0%,13m
24282,3,[BMGT]KingKiz,2694,238,8,13,21,38.1%,10m
24282,1,SethSorenson,2694,241,7,7,14,50.0%,2h
24282,3,ARKHAM,2694,200,7,15,22,31.8%,8m
24282,1,Hellen,2694,205,6,11,17,35.3%,39m
24282,3,MupMup,2694,226,6,11,17,35.3%,6m
24282,1,ericcartman,2694,148,4,8,12,33.3%,2h
24282,1,Mastacheff,2694,126,3,11,14,21.4%,8m
24282,1,[AZPK]KDIGGITYDIZZ,2694,97,2,0,2,100.0%,29m
24282,1,Ruso,2694,0,2,3,5,40.0%,3h
24282,1,Riblet,2694,0,1,0,1,100.0%,2h
24282,1,Emselar,2694,48,1,1,2,50.0%,2h
24282,1,jbjoker,2694,97,1,3,4,25.0%,13m
24282,1,[StrDrk]Alexbay,2694,0,0,1,1,0.0%,2h
24282,3,TwoEZ,2694,0,0,2,2,0.0%,2h
24282,1,Dolzy,2694,0,0,2,2,0.0%,2h
24316,1,[ZTemps]dayodave,2693,1563,204,180,384,53.1%,13m
24316,1,[RAP]MrTWrecks,2693,1376,79,61,140,56.4%,2h
24316,3,[Pig2]Utlagi,2693,1094,48,48,96,50.0%,6m
24316,3,RodríGAtoR,2693,398,18,15,33,54.5%,13m
24316,3,Arios,2693,411,14,18,32,43.8%,25m
24316,1,cris,2693,306,10,6,16,62.5%,13m
24316,1,[MuFns]Patches,2693,220,7,4,11,63.6%,35m
24316,1,Albinosmurfs,2693,232,7,7,14,50.0%,2h
24316,1,Coolwhip,2693,155,5,1,6,83.3%,2h
24316,1,KCMill,2693,199,4,3,7,57.1%,2h
24316,1,[N0one]sunRay,2693,90,3,3,6,50.0%,2h
24316,1,Garak,2693,38,2,12,14,14.3%,34m
24316,1,[Hopper]enzokain,2693,0,1,0,1,100.0%,3h
24316,1,[DhZAc1]OlavinhoXD,2693,34,1,1,2,50.0%,3h
24316,1,Sinergize,2693,44,1,4,5,20.0%,3h
24316,1,Gustavo,2693,0,1,4,5,20.0%,21m
24316,3,Skarlowy,2693,30,1,4,5,20.0%,47m
24333,2,[MPPA]FitzRoyRas,2692,1577,197,182,379,52.0%,26m
24333,3,Empho,2692,1565,175,171,346,50.6%,10m
24333,2,Bushwhacker,2692,1470,110,110,220,50.0%,17m
24333,2,Venom,2692,1531,106,112,218,48.6%,24m
24333,1,Aalleyway,2692,1202,77,72,149,51.7%,2h
24333,3,HitMan,2692,1351,75,65,140,53.6%,24m
24333,3,Pwnography,2692,458,29,31,60,48.3%,2m
24333,3,[NA7]Pikey,2692,502,20,23,43,46.5%,29m
24333,1,BELATOR,2692,430,14,10,24,58.3%,36m
24333,3,[THDT]Mortadela,2692,319,12,16,28,42.9%,7m
24333,1,ankel,2692,209,11,3,14,78.6%,45m
24333,3,Curry,2692,149,11,6,17,64.7%,34m
24333,3,Milli,2692,334,11,16,27,40.7%,4m
24333,1,EliteHunter,2692,332,10,9,19,52.6%,2h
24333,3,RomanuS,2692,262,10,10,20,50.0%,1h
24333,1,LOLPRO,2692,237,8,3,11,72.7%,2h
24333,1,SyrrelSnir,2692,196,8,5,13,61.5%,2h
24333,2,[PCNL]zadelyin,2692,241,8,10,18,44.4%,10m
24333,1,[TMU500]MFRax,2692,206,7,5,12,58.3%,2h
24333,1,[ELNENE]Furan,2692,189,7,6,13,53.8%,10m
24333,1,Travis,2692,233,7,8,15,46.7%,2h
24333,1,[ZTemp]withLoveUSA,2692,156,5,3,8,62.5%,2h
24333,1,Ambyre,2692,96,5,7,12,41.7%,2h
24333,3,ForGG,2692,156,5,13,18,27.8%,14m
24333,3,jonsnow,2692,0,4,2,6,66.7%,33m
24333,1,[NEEGZ]Ephemeral,2692,80,3,4,7,42.9%,5m
24333,1,ohana,2692,40,2,0,2,100.0%,32m
24333,3,Noodle,2692,93,2,2,4,50.0%,6m
24333,1,Apulsive,2692,93,2,4,6,33.3%,42m
24333,1,[GGMESP]Gipsy,2692,96,2,8,10,20.0%,2h
24333,1,Talibus,2692,0,1,2,3,33.3%,1h
24333,2,greenmeansgo,2692,0,0,1,1,0.0%,26m
24333,1,Infernus,2692,0,0,1,1,0.0%,3m
24333,1,Mattzke,2692,0,0,3,3,0.0%,1h
24367,3,Soonerrad,2691,1556,273,263,536,50.9%,37m
24367,1,DRAzodo,2691,1626,258,225,483,53.4%,19m
24367,1,[GanNuk]jimmy,2691,1602,78,67,145,53.8%,1h
24367,1,TheLordHS,2691,1221,62,44,106,58.5%,42m
24367,1,SomewhatOdd,2691,1401,54,48,102,52.9%,2h
24367,3,icchansama,2691,755,29,30,59,49.2%,13m
24367,1,Binro,2691,763,28,20,48,58.3%,1h
24367,3,PIPELON,2691,706,28,22,50,56.0%,30m
24367,3,iEatGlue,2691,666,27,28,55,49.1%,34m
24367,1,DrgnSlayer,2691,835,27,28,55,49.1%,18m
24367,1,KaizeR,2691,366,16,4,20,80.0%,2h
24367,1,BlueIbaneZac,2691,416,16,8,24,66.7%,2h
24367,3,Davestator,2691,309,14,9,23,60.9%,24m
24367,1,Dovi,2691,324,10,9,19,52.6%,1h
24367,3,Fasola,2691,226,8,9,17,47.1%,14m
24367,1,Tlaloc,2691,132,5,3,8,62.5%,39m
24367,2,MrSilva,2691,181,5,5,10,50.0%,7m
24367,3,DarkSide,2691,114,5,8,13,38.5%,24m
24367,3,[CfnDgr]ceczar,2691,92,3,4,7,42.9%,6m
24367,1,[Titans]ISSUR,2691,97,3,6,9,33.3%,2h
24367,1,Therbear,2691,95,2,0,2,100.0%,2h
24367,2,[FFAA]Sico,2691,116,2,2,4,50.0%,1h
24367,1,EGP,2691,0,2,3,5,40.0%,2h
24367,1,[xLiTx]Ryuzaki,2691,120,2,3,5,40.0%,3h
24367,1,[Weac]SkyFlame,2691,80,2,3,5,40.0%,3h
24367,1,ksiavenga,2691,44,2,3,5,40.0%,2h
24367,3,Doom,2691,0,2,3,5,40.0%,35m
24367,1,[Pro999]gabox,2691,44,1,1,2,50.0%,36m
24367,1,Suspicious,2691,0,0,1,1,0.0%,23m
24367,1,rafaMEN,2691,0,0,2,2,0.0%,2h
24367,1,MoisésZkzk,2691,0,0,3,3,0.0%,2h
24398,3,Brobocop,2690,1574,165,162,327,50.5%,7m
24398,3,zeus,2690,1356,118,91,209,56.5%,47m
24398,3,KillerClown,2690,870,41,27,68,60.3%,7m
24398,3,ZombiegNice,2690,1028,40,45,85,47.1%,28m
24398,2,Bones,2690,382,32,41,73,43.8%,13m
24398,1,[LAGCR]ZzelL,2690,704,31,28,59,52.5%,24m
24398,3,ColtronHamer,2690,275,21,19,40,52.5%,9m
24398,1,GenarelAggro,2690,347,13,5,18,72.2%,13m
24398,3,LeRedoutable,2690,250,9,11,20,45.0%,11m
24398,3,CCAdv,2690,124,7,16,23,30.4%,34m
24398,1,SuperWok,2690,148,6,6,12,50.0%,39m
24398,3,Dispo,2690,156,5,13,18,27.8%,28m
24398,1,Ragorr,2690,116,4,4,8,50.0%,19m
24398,3,Xerses,2690,153,4,8,12,33.3%,13m
24398,3,[MexTab]Chelozskyy,2690,88,4,9,13,30.8%,13m
24398,2,RONIN,2690,124,4,15,19,21.1%,15m
24398,2,[DSGs]Roquefort,2690,0,3,4,7,42.9%,47m
24398,3,Wonderwall,2690,60,3,9,12,25.0%,4m
24398,1,WERNIX,2690,116,2,1,3,66.7%,46m
24398,1,[TAKANA]robert,2690,0,1,0,1,100.0%,1h
24398,1,RABS,2690,0,1,0,1,100.0%,1h
24398,1,Yako,2690,0,1,1,2,50.0%,2h
24398,1,LegitLegacy,2690,0,1,3,4,25.0%,17m
24398,3,[Picard]NterpriseNCC,2690,30,1,4,5,20.0%,18m
24398,1,killerwolf,2690,0,0,1,1,0.0%,1h
24398,1,Penguins,2690,0,0,1,1,0.0%,2h
24398,1,eternalnoobj,2690,0,0,2,2,0.0%,2h
24398,1,Rodion,2690,0,0,3,3,0.0%,42m
24398,3,Rossco,2690,0,0,7,7,0.0%,10m
24427,3,[IIFE]SineTheta,2689,1596,83,85,168,49.4%,22m
24427,3,Pete,2689,272,69,63,132,52.3%,38m
24427,3,Azelius,2689,1421,65,53,118,55.1%,10m
24427,1,Gloat,2689,1306,56,39,95,58.9%,2h
24427,1,quicklyspent,2689,1236,43,41,84,51.2%,13m
24427,3,Zhukov,2689,960,38,37,75,50.7%,30m
24427,3,MediOgre,2689,946,33,44,77,42.9%,6m
24427,3,Zvezda,2689,660,27,33,60,45.0%,7m
24427,3,LazyTurtle,2689,520,24,24,48,50.0%,21m
24427,3,[QcScT]jayneral,2689,289,20,25,45,44.4%,23m
24427,2,Baines,2689,610,20,33,53,37.7%,7m
24427,1,[Keagle]BigGuns,2689,310,14,3,17,82.4%,15m
24427,3,macros,2689,272,11,13,24,45.8%,49m
24427,2,baxter,2689,270,9,20,29,31.0%,27m
24427,1,MooN,2689,181,6,2,8,75.0%,1h
24427,1,FJJI,2689,216,6,9,15,40.0%,2h
24427,3,EJECUTOR,2689,156,6,11,17,35.3%,25m
24427,1,BenArnold,2689,160,4,4,8,50.0%,23m
24427,1,RIP,2689,0,3,2,5,60.0%,2h
24427,1,Warspite,2689,94,3,4,7,42.9%,2m
24427,3,[xDBZx]AlfredoCruz,2689,155,3,8,11,27.3%,3h
24427,1,[cRTS]wHATEver,2689,30,2,0,2,100.0%,31m
24427,1,titoca,2689,0,2,3,5,40.0%,45m
24427,1,bishop,2689,0,2,3,5,40.0%,33m
24427,1,[UpxV]Parre,2689,0,1,1,2,50.0%,2h
24427,3,Nanology,2689,0,0,2,2,0.0%,10m
24427,1,[LQV]kfcnhl,2689,0,0,2,2,0.0%,2h
24454,1,Tuco,2688,459,40,24,64,62.5%,1h
24454,1,imaFurryxD,2688,878,34,28,62,54.8%,2h
24454,1,[DZNUT5]ghds,2688,827,34,30,64,53.1%,25m
24454,2,[PiN0YS]Gelo,2688,774,30,40,70,42.9%,21m
24454,1,Mammoth,2688,805,29,24,53,54.7%,20m
24454,3,Pinkerton,2688,600,22,26,48,45.8%,12m
24454,3,BigBoss,2688,628,21,27,48,43.8%,22m
24454,3,[812]RedREAPER,2688,391,16,22,38,42.1%,26m
24454,1,QStorm,2688,321,13,4,17,76.5%,21m
24454,3,OniiChan,2688,237,11,8,19,57.9%,30m
24454,1,[F2AAA]yikedami,2688,306,9,8,17,52.9%,1h
24454,3,Gregh,2688,268,8,9,17,47.1%,13m
24454,1,[Cabana]EvilSteel,2688,286,8,12,20,40.0%,2h
24454,3,Lee,2688,202,6,7,13,46.2%,37m
24454,1,[DICBOI]Oniichan,2688,156,4,2,6,66.7%,23m
24454,3,[FJLAK]ddmpc,2688,146,3,6,9,33.3%,11m
24454,1,[Chalas]McCobb,2688,42,2,3,5,40.0%,35m
24454,1,Solaris,2688,88,2,4,6,33.3%,25m
24454,2,Lambshaker,2688,0,1,0,1,100.0%,32m
24454,1,[PY]shpshp,2688,0,1,0,1,100.0%,15m
24454,1,[TDirT]Critical,2688,0,1,1,2,50.0%,2h
24454,1,llllllllllll,2688,0,1,5,6,16.7%,2h
24454,1,odiseo,2688,0,0,1,1,0.0%,1h
24454,1,OGMarvel,2688,0,0,1,1,0.0%,2h
24454,2,bryan,2688,0,0,1,1,0.0%,2h
24454,1,[ITCx]Dradika,2688,0,0,1,1,0.0%,2h
24454,2,Estiblet,2688,0,0,2,2,0.0%,2h
24454,1,chuushi,2688,0,0,3,3,0.0%,2h
24482,3,Double,2687,1580,512,482,994,51.5%,22m
24482,2,Lekkii,2687,1050,141,130,271,52.0%,14m
24482,3,KillerBee,2687,921,91,87,178,51.1%,10m
24482,3,Aurora,2687,1439,76,74,150,50.7%,27m
24482,3,[MKING]ZERO,2687,954,67,53,120,55.8%,11m
24482,3,Ghost,2687,931,44,50,94,46.8%,27m
24482,1,VonHoos,2687,1013,37,37,74,50.0%,1h
24482,3,krlrlklkr,2687,855,31,32,63,49.2%,31m
24482,1,[DefNot]Lacrimah,2687,419,22,13,35,62.9%,2h
24482,3,[XpKAc]OsoMaloso,2687,481,22,16,38,57.9%,22m
24482,1,Leofrancis,2687,404,19,8,27,70.4%,2h
24482,3,filoulam,2687,412,18,17,35,51.4%,23m
24482,3,[MandJ]Dangerwaite,2687,464,16,21,37,43.2%,36m
24482,3,Cuong,2687,282,9,10,19,47.4%,6m
24482,1,ProOthon,2687,302,8,9,17,47.1%,2h
24482,3,MiguelPérez,2687,204,8,9,17,47.1%,11m
24482,3,Substance,2687,164,5,5,10,50.0%,24m
24482,2,Harpua,2687,30,4,5,9,44.4%,31m
24482,3,IIIIIIIII,2687,48,4,7,11,36.4%,6m
24482,3,Mikhail,2687,113,3,3,6,50.0%,39m
24482,1,Nathan,2687,0,1,0,1,100.0%,3m
24482,1,bean,2687,0,1,1,2,50.0%,13m
24482,2,[SURUPA]VaLeskA,2687,88,1,3,4,25.0%,8m
24482,1,eduardoalvm,2687,0,0,1,1,0.0%,2h
24482,1,Clockwork,2687,0,0,1,1,0.0%,2h
24482,1,Delha,2687,0,0,1,1,0.0%,29m
24482,3,Spinky,2687,0,0,1,1,0.0%,36m
24482,3,Elzizel,2687,0,0,6,6,0.0%,30m
24510,3,Desolation,2686,1175,92,80,172,53.5%,22m
24510,3,SnobbyOcto,2686,588,38,30,68,55.9%,21m
24510,1,axman,2686,759,28,26,54,51.9%,47m
24510,1,Thomasblue,2686,829,28,27,55,50.9%,2h
24510,1,Sonic,2686,498,18,12,30,60.0%,18m
24510,1,[XpKAc]MEGATUNIX,2686,414,15,9,24,62.5%,2h
24510,1,Angel,2686,423,14,8,22,63.6%,29m
24510,1,Davey,2686,291,11,3,14,78.6%,2h
24510,3,BootyButt,2686,277,9,10,19,47.4%,27m
24510,3,Jackermeen,2686,222,6,8,14,42.9%,2h
24510,3,Aegon,2686,184,6,13,19,31.6%,22m
24510,2,Henso,2686,0,3,4,7,42.9%,4m
24510,1,[DhZone]Shion,2686,0,2,5,7,28.6%,3h
24510,1,slowbro,2686,74,2,5,7,28.6%,33m
24510,1,[SnDICE]Random,2686,0,0,1,1,0.0%,2h
24510,1,Bigazzfries,2686,0,0,3,3,0.0%,24m
24510,2,[HBNC]QuipsQuaff,2686,0,0,6,6,0.0%,15m
24527,1,Alex,2685,1736,263,256,519,50.7%,7m
24527,3,BCLG,2685,1537,159,169,328,48.5%,21m
24527,1,[ØÛ]THEEXECUTOR,2685,1634,130,95,225,57.8%,1h
24527,2,Savageinhell,2685,1319,82,81,163,50.3%,20m
24527,2,dessertlover,2685,1487,79,92,171,46.2%,48m
24527,1,Eido,2685,1626,70,65,135,51.9%,20m
24527,3,Goldsound,2685,364,55,49,104,52.9%,48m
24527,1,Dillwinn,2685,1019,49,28,77,63.6%,14m
24527,1,[iTE]Invincible,2685,1229,44,39,83,53.0%,13m
24527,1,ChampCheese,2685,972,40,31,71,56.3%,24m
24527,3,[Macac0]David,2685,537,30,29,59,50.8%,20m
24527,1,Tholin,2685,733,24,21,45,53.3%,1h
24527,3,[TmKr]Kilgore,2685,297,19,24,43,44.2%,23m
24527,3,janosabeee,2685,436,15,20,35,42.9%,7m
24527,1,UNREAL,2685,345,13,6,19,68.4%,43m
24527,1,[XpKAc]Rhaegal,2685,421,13,8,21,61.9%,2h
24527,2,[sk3tch]Vawk,2685,267,12,11,23,52.2%,21m
24527,1,Dildow,2685,263,11,9,20,55.0%,2h
24527,3,[GRUSP]oriedson,2685,265,11,9,20,55.0%,2h
24527,1,[tCo9]steelgrim,2685,294,10,8,18,55.6%,19m
24527,1,ButterSnapps,2685,191,9,8,17,52.9%,2h
24527,3,BurntMoon,2685,174,6,11,17,35.3%,3m
24527,2,[SNlFF]Elmscent,2685,162,5,5,10,50.0%,2h
24527,1,Phyloxera,2685,108,4,2,6,66.7%,5m
24527,1,[LHA]MorningstarL,2685,152,4,4,8,50.0%,44m
24527,3,Miracle,2685,168,4,5,9,44.4%,31m
24527,3,HawkeyeG,2685,178,4,9,13,30.8%,48m
24527,1,StylesC,2685,107,3,0,3,100.0%,2h
24527,3,Particle,2685,0,2,3,5,40.0%,1h
24527,1,Samhain,2685,0,2,3,5,40.0%,42m
24527,3,Hendo,2685,30,2,5,7,28.6%,21m
24527,3,TelegraphGo,2685,60,2,8,10,20.0%,36m
24527,1,EchoTango,2685,0,1,0,1,100.0%,39m
24527,1,Twothousand,2685,30,1,1,2,50.0%,2h
24527,2,llllllllllll,2685,0,1,1,2,50.0%,2h
24527,3,Waddles,2685,96,1,3,4,25.0%,27m
24527,3,jcrellik,2685,30,1,9,10,10.0%,18m
24527,2,JAYONER,2685,0,0,1,1,0.0%,41m
24527,2,[NePe]KLADE,2685,0,0,2,2,0.0%,25m
24527,1,Ceezy,2685,0,0,4,4,0.0%,35m
24567,1,manutatu,2684,1739,112,103,215,52.1%,30m
24567,1,Ekchuah,2684,1291,83,67,150,55.3%,2h
24567,1,MiltHinton,2684,1103,83,69,152,54.6%,46m
24567,1,BrickWiggles,2684,1034,62,56,118,52.5%,18m
24567,3,[YipYip]Smokey,2684,1323,59,61,120,49.2%,37m
24567,3,chibs,2684,648,51,43,94,54.3%,10m
24567,3,eddie,2684,797,30,32,62,48.4%,16m
24567,1,falconlm,2684,444,18,6,24,75.0%,13m
24567,1,BillyDaChamp,2684,516,17,11,28,60.7%,2h
24567,1,YsterVuis,2684,381,16,11,27,59.3%,2h
24567,1,trixiee,2684,297,12,5,17,70.6%,30m
24567,1,Deathmist,2684,342,11,7,18,61.1%,13m
24567,1,minifrawls,2684,270,11,13,24,45.8%,1h
24567,1,[MJ23]VooDoo,2684,223,8,16,24,33.3%,2h
24567,3,stuplified,2684,128,7,12,19,36.8%,9m
24567,2,shindofusi,2684,132,5,2,7,71.4%,2h
24567,1,Storm,2684,140,4,0,4,100.0%,2h
24567,3,[MoopyS]Survivornoob,2684,34,3,0,3,100.0%,2h
24567,2,lingmaster,2684,0,2,3,5,40.0%,2h
24567,3,xCiritox,2684,0,2,3,5,40.0%,2h
24567,2,Edgar,2684,0,2,4,6,33.3%,2h
24567,1,davrostheIV,2684,0,1,0,1,100.0%,25m
24567,1,enzo,2684,38,1,5,6,16.7%,1h
24567,2,alucard,2684,0,0,3,3,0.0%,41m
24567,1,Robespierre,2684,0,0,3,3,0.0%,3h
24567,3,Danyk,2684,0,0,7,7,0.0%,49m
24567,1,Anders,2684,0,0,11,11,0.0%,21m
24594,3,BlackOut,2683,1548,248,233,481,51.6%,30m
24594,3,WeaponX,2683,1183,71,64,135,52.6%,11m
24594,3,DjMex,2683,1523,63,63,126,50.0%,7m
24594,3,Goldcore,2683,680,59,61,120,49.2%,22m
24594,3,Qoo,2683,1208,52,53,105,49.5%,3m
24594,1,googogogogo,2683,756,24,29,53,45.3%,15m
24594,1,[ccbi]Miklul,2683,461,17,11,28,60.7%,2h
24594,1,Mack,2683,317,13,15,28,46.4%,19m
24594,3,[FmHere]Elesett,2683,266,10,14,24,41.7%,10m
24594,3,Jose,2683,218,8,8,16,50.0%,12m
24594,1,WilliamIce,2683,226,6,6,12,50.0%,2h
24594,1,Terror,2683,137,5,3,8,62.5%,2h
24594,3,skchimera,2683,30,2,2,4,50.0%,31m
24594,3,Grape,2683,0,2,4,6,33.3%,31m
24594,1,CabooseDOV,2683,0,2,4,6,33.3%,2h
24594,1,VJMetz,2683,0,1,0,1,100.0%,24m
24594,1,Gianca,2683,0,1,0,1,100.0%,21m
24594,3,SurplusRage,2683,0,1,1,2,50.0%,2h
24594,1,[EOSD]Telanamus,2683,0,0,1,1,0.0%,1h
24594,1,Anton,2683,0,0,1,1,0.0%,13m
24594,1,Crunchybacon,2683,0,0,1,1,0.0%,13m
24594,2,[LifeF]SharkTooth,2683,0,0,2,2,0.0%,29m
24594,1,LowPotato,2683,0,0,2,2,0.0%,19m
24617,2,Arodelmal,2682,1107,58,61,119,48.7%,30m
24617,1,ducksgoquook,2682,842,31,21,52,59.6%,2h
24617,1,NEVERLAND,2682,622,30,19,49,61.2%,13m
24617,1,BossKunG,2682,676,22,38,60,36.7%,22m
24617,3,nan,2682,636,21,24,45,46.7%,13m
24617,3,CommonCold,2682,463,18,18,36,50.0%,30m
24617,3,QuBuS,2682,369,16,5,21,76.2%,22m
24617,1,DarkTamplar,2682,155,8,6,14,57.1%,18m
24617,1,Pandarax,2682,254,7,8,15,46.7%,17m
24617,1,Wolf,2682,266,7,11,18,38.9%,19m
24617,1,cookymonster,2682,224,6,6,12,50.0%,24m
24617,1,[BURS]ColdSpark,2682,76,3,0,3,100.0%,24m
24617,1,MrWasteland,2682,66,3,1,4,75.0%,3h
24617,1,Azzer,2682,70,3,2,5,60.0%,2h
24617,1,Enemigo,2682,76,3,2,5,60.0%,2h
24617,2,Stonecash,2682,93,3,4,7,42.9%,32m
24617,1,[POROSS]xkensyt,2682,124,2,1,3,66.7%,2h
24617,1,BirbyBoi,2682,0,2,3,5,40.0%,45m
24617,1,[neuroW]DuBxz,2682,0,0,1,1,0.0%,1h
24636,1,[TOPUA]MaDDoG,2681,1674,214,202,416,51.4%,13m
24636,3,BiGby,2681,1489,196,187,383,51.2%,21m
24636,1,yarc,2681,1650,152,136,288,52.8%,1h
24636,3,Teej,2681,504,87,71,158,55.1%,48m
24636,3,Bohno,2681,1526,78,66,144,54.2%,3m
24636,3,Darkkagefox,2681,944,62,43,105,59.0%,11m
24636,3,[GGMESP]THEINIUQ,2681,388,18,15,33,54.5%,35m
24636,1,BUJIGANOMEMI,2681,467,17,10,27,63.0%,1h
24636,1,[Girls]LePoopEater,2681,286,10,6,16,62.5%,23m
24636,3,JacobWolves,2681,278,9,19,28,32.1%,27m
24636,3,Flaste,2681,248,8,10,18,44.4%,49m
24636,3,Abacoot,2681,219,7,11,18,38.9%,2h
24636,3,IIIIIIIII,2681,219,6,10,16,37.5%,13m
24636,1,Ender,2681,156,5,6,11,45.5%,32m
24636,3,Londonium,2681,130,5,6,11,45.5%,47m
24636,1,nuYOmaYO,2681,184,5,8,13,38.5%,2h
24636,2,Chae,2681,250,5,16,21,23.8%,20m
24636,1,RickVF,2681,148,4,3,7,57.1%,19m
24636,3,cachabreno,2681,93,3,4,7,42.9%,15m
24636,3,CESCHBK,2681,97,3,4,7,42.9%,14m
24636,1,[1EOM]Edom,2681,36,2,0,2,100.0%,2h
24636,1,JOSEWAN,2681,36,2,0,2,100.0%,2h
24636,3,Grimsdottir,2681,0,2,3,5,40.0%,2h
24636,1,Descendant,2681,0,2,3,5,40.0%,1h
24636,1,Memo,2681,96,1,1,2,50.0%,20m
24636,1,Gizmo,2681,40,1,2,3,33.3%,42m
24636,1,Elifton,2681,0,0,1,1,0.0%,2h
24636,1,sambomaster,2681,0,0,2,2,0.0%,3h
24636,3,[ScScUr]Smatty,2681,0,0,3,3,0.0%,15m
24636,3,Malygos,2681,0,0,6,6,0.0%,48m
24666,1,frugele,2680,1585,133,109,242,55.0%,2h
24666,2,LockHard,2680,864,39,48,87,44.8%,14m
24666,1,chou,2680,586,27,14,41,65.9%,1h
24666,1,BigWolfBroth,2680,512,21,12,33,63.6%,19m
24666,1,Profesitor,2680,388,16,9,25,64.0%,2h
24666,3,[Fir3s]ToxicMilk,2680,248,11,12,23,47.8%,11m
24666,2,Terran,2680,263,10,7,17,58.8%,28m
24666,3,[GO0NS]REVELATIONS,2680,281,9,11,20,45.0%,29m
24666,1,OUOU,2680,240,8,11,19,42.1%,45m
24666,1,Voltar,2680,238,7,4,11,63.6%,20m
24666,3,bnz,2680,182,7,10,17,41.2%,11m
24666,1,[Spodes]OWEEE,2680,0,3,2,5,60.0%,2h
24666,1,MCmaniacman,2680,108,3,4,7,42.9%,21m
24666,3,[CV0101]AmonRA,2680,30,2,2,4,50.0%,47m
24666,3,[later]Daga,2680,0,2,3,5,40.0%,2h
24666,1,LFxDyablo,2680,84,2,4,6,33.3%,3h
24666,2,ShadowStorm,2680,0,2,4,6,33.3%,29m
24666,2,Freedom,2680,0,2,6,8,25.0%,24m
24666,1,WILLYARIEL,2680,36,1,3,4,25.0%,24m
24666,1,DemiGaud,2680,0,0,11,11,0.0%,11m
24686,3,[KIRIOS]ARTIMUL,2679,677,68,70,138,49.3%,31m
24686,1,RoastSalmon,2679,1104,61,37,98,62.2%,33m
24686,3,SangDang,2679,700,41,35,76,53.9%,22m
24686,1,ataklos,2679,875,38,18,56,67.9%,2h
24686,3,snowblack,2679,1022,35,43,78,44.9%,2m
24686,3,Venoma,2679,498,21,20,41,51.2%,37m
24686,3,paperjawa,2679,511,18,19,37,48.6%,48m
24686,3,Mach,2679,332,17,11,28,60.7%,30m
24686,1,Maz,2679,307,15,9,24,62.5%,13m
24686,1,FrenzyMaster,2679,360,13,7,20,65.0%,2h
24686,3,Morcleon,2679,344,13,13,26,50.0%,35m
24686,1,[KREAP]Grassassin,2679,300,9,9,18,50.0%,1h
24686,2,LegalxBR,2679,178,6,20,26,23.1%,20m
24686,1,DaNoobinator,2679,155,5,1,6,83.3%,2h
24686,1,[ROSC2]zika,2679,122,4,5,9,44.4%,13m
24686,3,Fckem,2679,90,4,10,14,28.6%,30m
24686,2,HOLYGOST,2679,136,3,5,8,37.5%,2h
24686,1,enssco,2679,30,2,1,3,66.7%,2h
24686,3,imnoob,2679,0,2,3,5,40.0%,16m
24686,1,Howl,2679,0,1,0,1,100.0%,2h
24686,1,[NLTN]QuirkyTurtle,2679,0,1,0,1,100.0%,2h
24686,1,weedlock,2679,0,1,1,2,50.0%,2h
24686,2,Roti,2679,34,1,17,18,5.6%,39m
24686,2,Continentals,2679,0,0,2,2,0.0%,1h
24686,1,RCDC,2679,0,0,3,3,0.0%,2h
24711,3,leito,2678,1057,74,60,134,55.2%,35m
24711,1,[ETSs]TATORREA,2678,1591,73,71,144,50.7%,2h
24711,2,QuantumK,2678,1189,59,53,112,52.7%,8m
24711,3,JmoneyFish,2678,1158,42,46,88,47.7%,9m
24711,1,Deco,2678,689,27,19,46,58.7%,1h
24711,1,EricCartman,2678,674,26,22,48,54.2%,33m
24711,1,BillNye,2678,605,22,19,41,53.7%,13m
24711,3,Alphabetsoup,2678,455,19,14,33,57.6%,6m
24711,3,Roy,2678,542,18,20,38,47.4%,34m
24711,3,Cocosaurio,2678,416,16,15,31,51.6%,29m
24711,3,llScorPionll,2678,444,15,16,31,48.4%,49m
24711,1,Ruuku,2678,255,9,4,13,69.2%,3h
24711,1,AdmiralWen,2678,291,9,10,19,47.4%,21m
24711,1,Silverghost,2678,157,7,4,11,63.6%,1h
24711,1,SgKroll,2678,200,6,4,10,60.0%,39m
24711,1,[C10097]VictorNZ,2678,146,4,6,10,40.0%,32m
24711,3,Kapowy,2678,64,4,13,17,23.5%,26m
24711,1,[GEMC]Faithless,2678,193,3,5,8,37.5%,2h
24711,3,[sinner]Convicted,2678,0,1,0,1,100.0%,1h
24711,1,Atraedies,2678,36,1,1,2,50.0%,2h
24711,1,[NLTN]Duff,2678,0,1,1,2,50.0%,2h
24711,3,[JRT]Hikikomori,2678,89,1,4,5,20.0%,28m
24711,1,Brickwound,2678,0,0,1,1,0.0%,33m
24711,1,Espectro,2678,0,0,2,2,0.0%,2h
24711,1,Everminded,2678,0,0,2,2,0.0%,5m
24736,1,SPIKE,2677,1520,77,65,142,54.2%,1h
24736,3,Alright,2677,1527,73,67,140,52.1%,30m
24736,3,Eggster,2677,1295,48,52,100,48.0%,29m
24736,1,Luzvelt,2677,478,45,33,78,57.7%,42m
24736,3,Sejaay,2677,859,36,30,66,54.5%,25m
24736,2,Apenade,2677,743,26,33,59,44.1%,19m
24736,1,lllllIIIllll,2677,659,25,23,48,52.1%,1h
24736,1,ARAGOR,2677,341,22,13,35,62.9%,2h
24736,3,SukMyDkPls,2677,525,21,19,40,52.5%,31m
24736,1,Bullshooter,2677,557,19,19,38,50.0%,18m
24736,1,[ALTF04]Gilgamesh,2677,356,15,5,20,75.0%,35m
24736,1,Steelheart,2677,276,14,7,21,66.7%,2h
24736,3,ziriguidum,2677,268,14,10,24,58.3%,13m
24736,2,Kashberry,2677,301,13,15,28,46.4%,25m
24736,3,SkyFighter,2677,398,13,19,32,40.6%,11m
24736,3,Aura,2677,298,10,11,21,47.6%,16m
24736,1,Cheruvin,2677,274,9,13,22,40.9%,3h
24736,1,[MEEGS]Pathogen,2677,250,7,9,16,43.8%,20m
24736,1,erbol,2677,154,5,2,7,71.4%,3h
24736,1,Carrascal,2677,174,5,6,11,45.5%,18m
24736,1,OKY,2677,89,4,2,6,66.7%,2h
24736,1,VIDIX,2677,114,4,4,8,50.0%,43m
24736,1,Abdunm,2677,76,3,1,4,75.0%,2h
24736,1,Demora,2677,48,3,5,8,37.5%,2h
24736,3,PyroViper,2677,30,2,1,3,66.7%,2h
24736,1,APHELION,2677,74,2,3,5,40.0%,2h
24736,3,GrzyTortilla,2677,0,1,0,1,100.0%,22m
24736,1,HelloWorld,2677,0,1,2,3,33.3%,2h
24736,1,Truth,2677,0,0,1,1,0.0%,5m
24736,1,SeñorLore,2677,0,0,1,1,0.0%,29m
24736,3,Jermie,2677,0,0,15,15,0.0%,13m
24767,3,Hodor,2676,1244,178,161,339,52.5%,12m
24767,3,[C96741]sunho,2676,1299,64,62,126,50.8%,23m
24767,3,Troudebeigne,2676,1257,59,54,113,52.2%,30m
24767,1,Wolf,2676,1206,53,45,98,54.1%,13m
24767,1,[1snD]AvoidedHades,2676,863,50,49,99,50.5%,2h
24767,1,KHYRIOS,2676,770,41,36,77,53.2%,3m
24767,1,ahtahrim,2676,700,27,20,47,57.4%,47m
24767,1,Haloedge,2676,410,25,16,41,61.0%,2h
24767,1,PJLO,2676,329,24,15,39,61.5%,3m
24767,1,vicccccccccc,2676,687,21,20,41,51.2%,41m
24767,1,[SMRT]OoObernOOb,2676,567,20,22,42,47.6%,2h
24767,3,Anka,2676,512,19,24,43,44.2%,24m
24767,1,RenAir,2676,385,16,9,25,64.0%,2h
24767,3,llllllllllll,2676,468,16,23,39,41.0%,10m
24767,3,[MA9A]Dussel,2676,361,13,13,26,50.0%,26m
24767,3,Adrian,2676,219,9,17,26,34.6%,20m
24767,3,Walty,2676,92,8,14,22,36.4%,7m
24767,1,Bob,2676,248,7,4,11,63.6%,2h
24767,1,badrobot,2676,168,7,6,13,53.8%,1h
24767,1,[Dindon]Bonasse,2676,179,6,4,10,60.0%,2h
24767,2,provenstud,2676,183,5,6,11,45.5%,2h
24767,2,CHIMICHURRI,2676,185,4,2,6,66.7%,2h
24767,1,BIGBOSSMAN,2676,97,4,5,9,44.4%,25m
24767,3,AnorLondo,2676,114,3,5,8,37.5%,19m
24767,3,[gat0]RatStar,2676,60,3,6,9,33.3%,8m
24767,1,Kaishin,2676,130,2,1,3,66.7%,3h
24767,3,BDog,2676,0,2,3,5,40.0%,2h
24767,1,Strixie,2676,0,2,3,5,40.0%,25m
24767,3,BlackFlag,2676,76,2,6,8,25.0%,9m
24767,1,TheHiveMind,2676,0,1,0,1,100.0%,2h
24767,1,stgeorge,2676,0,1,0,1,100.0%,2h
24767,1,[PTHero]Kurowasun,2676,38,1,1,2,50.0%,24m
24767,1,KungFooPanDa,2676,42,1,3,4,25.0%,2h
24767,3,[C0MR4D]Gabagool,2676,0,1,3,4,25.0%,30m
24767,1,fatman,2676,42,1,3,4,25.0%,16m
24767,1,Spot,2676,0,0,1,1,0.0%,1h
24767,3,[SBlock]UwU,2676,0,0,1,1,0.0%,2h
24767,1,Sedio,2676,0,0,1,1,0.0%,2h
24767,1,Kierhel,2676,0,0,2,2,0.0%,1h
24767,2,Drake,2676,0,0,5,5,0.0%,2h
24807,1,Hamburgers,2675,1614,63,59,122,51.6%,2h
24807,3,[ISTOP]CRAMYZ,2675,838,41,37,78,52.6%,31m
24807,3,Kerrigan,2675,357,40,28,68,58.8%,3m
24807,1,Crabapple,2675,560,39,31,70,55.7%,2h
24807,3,[SBXX]Permahost,2675,687,27,26,53,50.9%,27m
24807,3,BucketMan,2675,604,21,26,47,44.7%,34m
24807,3,[DhZAc1]Irreal,2675,504,18,22,40,45.0%,10m
24807,1,Survivalism,2675,296,9,7,16,56.2%,18m
24807,1,lazerbolt,2675,262,9,8,17,52.9%,2h
24807,3,[ZTemps]Sonder,2675,270,9,17,26,34.6%,9m
24807,3,Vegetable,2675,236,8,14,22,36.4%,13m
24807,3,HikeGhost,2675,218,7,9,16,43.8%,37m
24807,1,Zipper,2675,192,5,6,11,45.5%,41m
24807,2,franco,2675,0,3,2,5,60.0%,21m
24807,3,Grambo,2675,0,3,4,7,42.9%,15m
24807,2,NightRaven,2675,0,3,4,7,42.9%,12m
24807,1,MeeMeeSiku,2675,110,3,4,7,42.9%,2h
24807,1,Sparklefart,2675,40,2,1,3,66.7%,16m
24807,1,[Yampis]diego,2675,74,2,2,4,50.0%,40m
24807,3,Maximilian,2675,0,2,3,5,40.0%,16m
24807,1,Neko,2675,0,2,3,5,40.0%,1h
24807,1,Thiago,2675,0,1,0,1,100.0%,2h
24807,1,IDKmyBffJill,2675,0,1,0,1,100.0%,2h
24807,3,METALger,2675,0,0,1,1,0.0%,31m
24807,1,[CLWA]kazuto,2675,0,0,1,1,0.0%,2m
24807,1,[TBPP]LeaNuz,2675,0,0,1,1,0.0%,23m
24807,1,Ronin,2675,0,0,2,2,0.0%,2h
24807,1,Astronomync,2675,0,0,3,3,0.0%,21m
24835,1,Mackensen,2674,1746,638,600,1238,51.5%,43m
24835,1,lIlIlIlIlIlI,2674,1727,104,99,203,51.2%,3m
24835,3,Ruglar,2674,1439,85,76,161,52.8%,48m
24835,2,DokBane,2674,1154,81,88,169,47.9%,22m
24835,1,JakeRyan,2674,1224,64,51,115,55.7%,2h
24835,3,RosePetalCat,2674,125,56,49,105,53.3%,49m
24835,3,PegLeg,2674,463,43,35,78,55.1%,3m
24835,3,SJJS,2674,795,38,26,64,59.4%,39m
24835,1,PapaSmurf,2674,419,20,16,36,55.6%,2h
24835,3,Ballz,2674,235,19,26,45,42.2%,32m
24835,2,taint,2674,538,18,29,47,38.3%,24m
24835,3,[DMONlC]DEMONIC,2674,322,12,17,29,41.4%,30m
24835,2,Tincho,2674,169,9,8,17,52.9%,22m
24835,1,NitroToluene,2674,204,8,8,16,50.0%,2h
24835,1,THORON,2674,200,7,3,10,70.0%,30m
24835,2,Japtin,2674,115,5,1,6,83.3%,2h
24835,2,gubby,2674,92,5,6,11,45.5%,2h
24835,2,[F0]Domdelcash,2674,113,4,5,9,44.4%,3h
24835,3,Bilbo,2674,0,3,2,5,60.0%,2h
24835,1,Leeroy,2674,97,3,3,6,50.0%,2h
24835,2,GalaxyFalcon,2674,48,3,5,8,37.5%,18m
24835,2,Shalashaska,2674,115,2,2,4,50.0%,32m
24835,3,fire,2674,0,2,3,5,40.0%,2h
24835,2,Heofon,2674,0,1,0,1,100.0%,8m
24835,1,xMakinox,2674,0,1,0,1,100.0%,2h
24835,1,[MNG]eXePATT,2674,89,1,1,2,50.0%,46m
24835,1,CheG,2674,0,1,1,2,50.0%,18m
24835,1,Avefenix,2674,0,0,1,1,0.0%,39m
24835,3,ReapeR,2674,0,0,5,5,0.0%,13m
24864,2,Rauc,2673,1207,406,385,791,51.3%,17m
24864,3,[Blacer]Rocha,2673,1571,286,265,551,51.9%,16m
24864,3,CommandCentr,2673,1148,118,109,227,52.0%,10m
24864,2,Goku,2673,1620,102,97,199,51.3%,25m
24864,1,Hammer,2673,1559,63,53,116,54.3%,2h
24864,1,jtTraz,2673,1025,51,45,96,53.1%,2h
24864,3,[forces]CooperTrosky,2673,812,36,31,67,53.7%,27m
24864,1,[ThW]Bill,2673,911,33,28,61,54.1%,1h
24864,3,Stigma,2673,847,32,34,66,48.5%,31m
24864,1,Atlas,2673,615,26,16,42,61.9%,25m
24864,3,LifeSlay,2673,438,19,16,35,54.3%,30m
24864,3,Skeleton,2673,459,19,22,41,46.3%,5m
24864,1,[Erik]ZtingeR,2673,387,16,3,19,84.2%,23m
24864,1,KnightZone,2673,250,8,3,11,72.7%,1h
24864,3,Capablanca,2673,199,7,9,16,43.8%,6m
24864,2,Refresh,2673,117,5,2,7,71.4%,2h
24864,2,[Dudss]Shopa,2673,46,5,3,8,62.5%,2h
24864,3,[1Ec0n1]PowerRanger,2673,30,5,3,8,62.5%,10m
24864,3,STVAj,2673,0,4,2,6,66.7%,6m
24864,2,RodMan,2673,32,4,6,10,40.0%,5m
24864,3,Sopaipleto,2673,86,4,7,11,36.4%,13m
24864,3,Wiverno,2673,0,2,3,5,40.0%,1h
24864,1,BigParma,2673,0,1,0,1,100.0%,18m
24864,2,Minscandpoo,2673,0,1,0,1,100.0%,2h
24864,1,ScorpionX,2673,0,1,1,2,50.0%,32m
24864,1,ByTheCode,2673,34,1,5,6,16.7%,2h
24864,1,mrwatt,2673,73,1,5,6,16.7%,43m
24864,1,OneUp,2673,73,1,6,7,14.3%,1h
24864,1,[YGD]Sephiroth,2673,36,1,7,8,12.5%,1h
24864,2,Dreamville,2673,0,0,1,1,0.0%,3h
24864,1,bobo,2673,0,0,1,1,0.0%,2h
24864,1,SilentHippo,2673,0,0,2,2,0.0%,15m
24864,1,[FENC]DrgonCN,2673,0,0,2,2,0.0%,23m
24897,1,Cach,2672,1594,123,110,233,52.8%,2h
24897,3,[Zooka]DankTemplar,2672,1535,112,85,197,56.9%,15m
24897,1,RitchieLiu,2672,1715,102,93,195,52.3%,2h
24897,3,TetoPreto,2672,1599,64,72,136,47.1%,21m
24897,1,Polaris,2672,1295,46,44,90,51.1%,7m
24897,3,[Kixeye]Seek,2672,901,43,27,70,61.4%,17m
24897,1,TrumpyBear,2672,826,33,28,61,54.1%,2h
24897,3,Loaded,2672,660,28,27,55,50.9%,35m
24897,1,[B4RCD3]IIIIIIIIII,2672,514,21,17,38,55.3%,2m
24897,2,ianqwert,2672,461,19,22,41,46.3%,10m
24897,3,Krakovsk,2672,193,17,9,26,65.4%,4m
24897,3,kichpan,2672,426,17,11,28,60.7%,35m
24897,2,Artanis,2672,208,16,31,47,34.0%,19m
24897,1,ascio,2672,468,15,17,32,46.9%,2h
24897,1,Alank,2672,456,14,10,24,58.3%,33m
24897,3,KillerRa,2672,359,13,13,26,50.0%,28m
24897,3,KimchiKiller,2672,289,13,13,26,50.0%,3m
24897,1,Broly,2672,346,12,9,21,57.1%,1h
24897,1,[ECL]WolfLord,2672,322,9,10,19,47.4%,2h
24897,3,ToastDragon,2672,222,7,17,24,29.2%,2m
24897,1,Egghead,2672,188,6,5,11,54.5%,2h
24897,1,Bebashis,2672,187,6,5,11,54.5%,2h
24897,1,LeatherySock,2672,214,6,7,13,46.2%,2h
24897,1,Daigle,2672,198,5,10,15,33.3%,2h
24897,1,goose,2672,162,4,1,5,80.0%,46m
24897,1,Yael,2672,0,3,2,5,60.0%,13m
24897,1,[Ntshls]Kramer,2672,144,3,3,6,50.0%,3m
24897,1,Flomotion,2672,129,2,3,5,40.0%,2h
24897,2,Cronus,2672,44,2,3,5,40.0%,2h
24897,3,[Mammy]Tomhumfree,2672,0,2,5,7,28.6%,7m
24897,3,Drake,2672,58,2,7,9,22.2%,3m
24897,1,Abbas,2672,0,1,0,1,100.0%,2h
24897,1,[aaaCTM]zebbus,2672,38,1,1,2,50.0%,2h
24897,1,BrothaG,2672,0,1,1,2,50.0%,2m
24897,1,hughGrection,2672,42,1,2,3,33.3%,2h
24897,1,Errorpi,2672,48,1,3,4,25.0%,23m
24897,1,Benevolence,2672,0,0,1,1,0.0%,5m
24897,3,JuuzouSuzuya,2672,0,0,1,1,0.0%,25m
24897,1,[63slas]Sivart,2672,0,0,2,2,0.0%,2h
24936,1,RavenSteele,2671,1750,580,574,1154,50.3%,3h
24936,3,alpha,2671,1343,101,94,195,51.8%,11m
24936,3,Saga,2671,921,50,43,93,53.8%,29m
24936,3,moki,2671,1171,43,62,105,41.0%,2m
24936,3,TheZonaBliz,2671,771,34,26,60,56.7%,26m
24936,1,mandalf,2671,668,32,28,60,53.3%,2h
24936,2,[LifeF]Nimo,2671,545,32,37,69,46.4%,38m
24936,3,Hurtcules,2671,548,21,21,42,50.0%,49m
24936,3,Benny,2671,465,18,20,38,47.4%,3m
24936,1,DeadDingo,2671,308,13,9,22,59.1%,1h
24936,1,CanonRussian,2671,244,10,2,12,83.3%,2h
24936,3,ICannonRushU,2671,270,8,11,19,42.1%,2m
24936,1,[navis]GZgatos,2671,174,5,5,10,50.0%,2h
24936,1,Crestatu,2671,152,4,3,7,57.1%,2m
24936,3,FreeHugz,2671,30,4,5,9,44.4%,35m
24936,3,Gabito,2671,30,4,5,9,44.4%,49m
24936,1,Webmercenary,2671,90,3,3,6,50.0%,2h
24936,1,HuberLord,2671,0,3,5,8,37.5%,2h
24936,1,Jimmaye,2671,94,3,6,9,33.3%,16m
24936,1,[BoAVN]CCnight,2671,38,2,0,2,100.0%,2h
24936,1,Haywire,2671,0,2,3,5,40.0%,2h
24936,1,Kryptonite,2671,76,2,7,9,22.2%,1h
24936,1,Allon,2671,0,1,0,1,100.0%,40m
24936,1,SilentDeath,2671,0,1,1,2,50.0%,2h
24936,1,MineShaft,2671,0,0,1,1,0.0%,1h
24936,1,harbinger,2671,0,0,1,1,0.0%,2m
24936,1,[ÆON]DarkRost,2671,0,0,2,2,0.0%,1h
24936,1,[MPKK]Batman,2671,0,0,3,3,0.0%,2h
24936,1,Amcore,2671,0,0,3,3,0.0%,24m
24936,1,[Bunge]Roadkill,2671,0,0,3,3,0.0%,2h
24936,2,Risperidona,2671,0,0,5,5,0.0%,30m
24967,3,DrCheng,2670,1040,128,104,232,55.2%,11m
24967,3,TooLate,2670,1080,74,78,152,48.7%,38m
24967,2,Tennishot,2670,1114,39,48,87,44.8%,28m
24967,3,[788954]Creator,2670,604,26,26,52,50.0%,30m
24967,3,[ExcIgN]eloy,2670,572,19,28,47,40.4%,30m
24967,1,Alterach,2670,526,18,15,33,54.5%,2h
24967,3,HeroGT,2670,426,14,23,37,37.8%,30m
24967,1,Romario,2670,302,13,8,21,61.9%,2h
24967,1,SANDRAFEEDS,2670,192,10,1,11,90.9%,1h
24967,2,[6G]Denisplayer,2670,92,6,9,15,40.0%,37m
24967,1,VictorTM,2670,162,5,2,7,71.4%,2h
24967,3,TheMan,2670,106,4,3,7,57.1%,29m
24967,1,Galletita,2670,116,3,0,3,100.0%,3h
24967,1,Tattoo,2670,74,3,2,5,60.0%,2h
24967,3,Comrade,2670,32,3,3,6,50.0%,38m
24967,3,SamO,2670,122,3,5,8,37.5%,2h
24967,3,Papple,2670,30,2,3,5,40.0%,33m
24967,1,MORTANIUS,2670,0,2,3,5,40.0%,13m
24967,1,doctordangle,2670,0,2,3,5,40.0%,2h
24967,2,Chris,2670,113,2,6,8,25.0%,2h
24967,1,[NEO]Divine,2670,38,1,1,2,50.0%,2h
24967,1,BORNTODIE,2670,30,1,1,2,50.0%,19m
24967,3,Tdogg,2670,0,1,3,4,25.0%,10m
24967,3,[RALF]Arcticfox,2670,30,1,4,5,20.0%,2h
24967,2,[Cind3r]ZeDuctTape,2670,0,0,1,1,0.0%,2h
24967,1,TonyDanza,2670,0,0,1,1,0.0%,7m
24967,1,Obstruction,2670,0,0,1,1,0.0%,1h
24994,3,platonsio,2669,1399,151,146,297,50.8%,25m
24994,3,black,2669,1341,110,82,192,57.3%,27m
24994,2,RainbowFruit,2669,1128,95,77,172,55.2%,33m
24994,1,XLATUS,2669,1132,54,24,78,69.2%,32m
24994,2,erikk,2669,1139,43,46,89,48.3%,39m
24994,3,Waddles,2669,570,25,30,55,45.5%,10m
24994,3,jorDz,2669,577,22,21,43,51.2%,29m
24994,1,Omega,2669,405,12,11,23,52.2%,19m
24994,3,[FRESHH]DeceptioN,2669,260,12,12,24,50.0%,30m
24994,3,beru,2669,200,11,11,22,50.0%,2h
24994,1,[AbcCo]LaMorza,2669,386,11,12,23,47.8%,17m
24994,1,whistleblowr,2669,184,7,6,13,53.8%,2h
24994,3,[ESRR]Thunderduck,2669,141,7,9,16,43.8%,7m
24994,1,[xXGDXx]XxHyperRXx,2669,0,4,1,5,80.0%,46m
24994,3,DarkoDan,2669,0,4,1,5,80.0%,1h
24994,1,foxuno,2669,0,3,2,5,60.0%,24m
24994,1,FRLrandom,2669,82,2,4,6,33.3%,32m
24994,1,[GnR]Onions,2669,0,1,0,1,100.0%,2h
24994,3,Triklino,2669,0,1,0,1,100.0%,17m
24994,1,Barbaro,2669,30,1,2,3,33.3%,32m
25014,3,DamnSon,2668,1378,164,161,325,50.5%,25m
25014,1,noisy,2668,1306,68,58,126,54.0%,2h
25014,3,[Lurch]Dronious,2668,1434,68,69,137,49.6%,2m
25014,2,[DRKACE]Hayden,2668,505,54,61,115,47.0%,13m
25014,2,[SLIKDX]COLDONE,2668,1131,44,49,93,47.3%,28m
25014,1,Avitus,2668,753,32,23,55,58.2%,2h
25014,1,KarlWells,2668,598,19,19,38,50.0%,2h
25014,3,[copain]HImaNs,2668,349,16,16,32,50.0%,11m
25014,3,[TMSyN]oxjosh,2668,418,16,20,36,44.4%,30m
25014,1,DraGzZzZz,2668,405,12,10,22,54.5%,2h
25014,1,[INextI]Cheesos,2668,334,9,10,19,47.4%,24m
25014,1,Frost,2668,218,8,2,10,80.0%,2h
25014,1,Krasmars,2668,203,7,7,14,50.0%,2h
25014,1,MusicGame,2668,213,6,3,9,66.7%,2h
25014,3,[GILLY]Kyean,2668,142,4,0,4,100.0%,3h
25014,3,[bcheez]MrFkTacoInc,2668,0,4,3,7,57.1%,48m
25014,1,pupperoni,2668,125,4,5,9,44.4%,2h
25014,2,epicbanana,2668,140,3,1,4,75.0%,7m
25014,3,[RCSM]clovis,2668,0,2,2,4,50.0%,13m
25014,3,CreamCorn,2668,0,2,3,5,40.0%,2h
25014,3,XxNoobxX,2668,0,2,3,5,40.0%,4m
25014,1,Dpp,2668,0,2,3,5,40.0%,2h
25014,3,Kaisen,2668,0,2,3,5,40.0%,2h
25014,1,[AkNi]NicKracken,2668,74,2,5,7,28.6%,2h
25014,1,Bibble,2668,0,1,0,1,100.0%,2h
25014,1,[LDCO]patron,2668,0,1,1,2,50.0%,41m
25014,2,Baldenebroz,2668,92,1,1,2,50.0%,2h
25014,1,[fgs]DanDaMan,2668,0,1,1,2,50.0%,2h
25014,1,[INVT]yosmar,2668,90,1,1,2,50.0%,1h
25014,3,ItsNotButler,2668,30,1,3,4,25.0%,40m
25014,1,sheeperson,2668,0,0,1,1,0.0%,14m
25014,2,[MH]DarkLee,2668,0,0,1,1,0.0%,2h
25014,1,Barrier,2668,0,0,1,1,0.0%,21m
25014,3,Pandabear,2668,0,0,2,2,0.0%,35m
25048,2,DontSpkEngsh,2667,1463,65,69,134,48.5%,9m
25048,3,venize,2667,1439,64,59,123,52.0%,11m
25048,3,Crim,2667,1044,39,43,82,47.6%,27m
25048,1,Norris,2667,472,38,27,65,58.5%,33m
25048,1,[T4Y]GladHeAteHer,2667,685,28,20,48,58.3%,21m
25048,1,locojuhi,2667,527,24,13,37,64.9%,2h
25048,1,Corporate,2667,510,18,17,35,51.4%,1h
25048,1,[ThicAF]Gorgatron,2667,572,18,18,36,50.0%,44m
25048,3,[Fever]AggrievedFry,2667,325,12,13,25,48.0%,27m
25048,1,HumaneTrout,2667,287,11,11,22,50.0%,2h
25048,1,TRICKKY,2667,172,9,6,15,60.0%,46m
25048,3,killerinsct,2667,58,7,4,11,63.6%,33m
25048,1,[RedSup]Fatpig,2667,228,7,8,15,46.7%,32m
25048,1,[SMilK]SKimMilk,2667,253,7,9,16,43.8%,2h
25048,1,[PAJERO]Marceloide,2667,206,7,9,16,43.8%,2h
25048,2,Billy,2667,95,4,3,7,57.1%,2h
25048,1,[ruchca]Flippo,2667,108,3,5,8,37.5%,2h
25048,1,GhostWalk,2667,104,2,1,3,66.7%,43m
25048,1,[3DuDez]Lazzino,2667,97,2,5,7,28.6%,2h
25048,1,[BOBudz]BhabiStriker,2667,0,1,0,1,100.0%,44m
25048,1,[G79]Crayton,2667,0,1,1,2,50.0%,21m
25048,1,[DeBoyz]Athuya,2667,42,1,4,5,20.0%,2h
25048,1,Benev,2667,0,0,1,1,0.0%,40m
25048,1,inoscopedJFK,2667,0,0,1,1,0.0%,2h
25048,2,Computer,2667,0,0,1,1,0.0%,2h
25048,1,[Neil]Berno,2667,0,0,2,2,0.0%,2h
25048,3,mistanity,2667,0,0,6,6,0.0%,3m
25075,1,[XpKAc]Evilwings,2666,1549,140,139,279,50.2%,2h
25075,1,LionMan,2666,1593,85,69,154,55.2%,2h
25075,3,Tim,2666,1236,74,73,147,50.3%,47m
25075,1,Liminator,2666,1352,52,48,100,52.0%,2h
25075,3,[LOHd]ITFANS,2666,1174,51,56,107,47.7%,29m
25075,3,FancyHippo,2666,629,26,28,54,48.1%,6m
25075,1,[Th3Bad]SKS,2666,477,21,12,33,63.6%,2h
25075,3,[forces]DeathRaven,2666,309,12,9,21,57.1%,35m
25075,1,JackalSbPeru,2666,333,12,9,21,57.1%,46m
25075,1,JENSEN,2666,202,7,6,13,53.8%,15m
25075,1,Mersaree,2666,197,6,2,8,75.0%,2h
25075,1,Remy,2666,209,6,7,13,46.2%,2h
25075,3,[kapas]Aldo,2666,148,6,10,16,37.5%,24m
25075,1,[UPL]MCLWarrior,2666,152,5,8,13,38.5%,1h
25075,3,[cluez]SpaceObama,2666,209,5,10,15,33.3%,38m
25075,1,GOSICK,2666,63,4,4,8,50.0%,16m
25075,1,Wodensito,2666,114,4,5,9,44.4%,2h
25075,1,MiguelBAM,2666,144,4,6,10,40.0%,17m
25075,2,Youkelele,2666,0,3,4,7,42.9%,35m
25075,1,Malthael,2666,72,2,2,4,50.0%,2h
25075,3,Gotcha,2666,0,2,3,5,40.0%,3m
25075,3,XiajiaBang,2666,0,2,3,5,40.0%,2h
25075,1,MrShackly,2666,0,1,0,1,100.0%,2h
25075,1,[AbcCo]ELWACHIN,2666,0,1,0,1,100.0%,41m
25075,1,[NK401]DaSaniDaKid,2666,40,1,1,2,50.0%,2h
25075,3,Perppetuo,2666,97,1,1,2,50.0%,46m
25075,1,FeralPig,2666,0,1,2,3,33.3%,17m
25075,1,Kevlar,2666,0,1,2,3,33.3%,3h
25075,1,Goobenhiemen,2666,32,1,3,4,25.0%,44m
25075,1,Dollynho,2666,97,1,4,5,20.0%,1h
25075,1,[oltea]SipOfTea,2666,0,0,1,1,0.0%,2h
25075,1,Sleepy,2666,0,0,1,1,0.0%,3h
25075,1,[SKyber]Pipekiller,2666,0,0,1,1,0.0%,2h
25075,1,[JUGOS]sahid,2666,0,0,1,1,0.0%,2h
25075,1,Kustom,2666,0,0,2,2,0.0%,2h
25110,3,VoidWar,2665,1531,524,514,1038,50.5%,33m
25110,3,jboogie,2665,1582,140,145,285,49.1%,3m
25110,3,[MCLRSN]MichaelRosen,2665,962,83,72,155,53.5%,23m
25110,3,REX,2665,1109,61,51,112,54.5%,25m
25110,3,Cameron,2665,1323,60,56,116,51.7%,27m
25110,1,MewMew,2665,1434,58,45,103,56.3%,33m
25110,1,[oneTop]chronis,2665,1303,51,40,91,56.0%,2h
25110,1,Alejosaurio,2665,1205,45,42,87,51.7%,2h
25110,1,[Macac0]sakura,2665,868,34,26,60,56.7%,2h
25110,3,[LGNxx]AiDz,2665,623,33,31,64,51.6%,15m
25110,1,Achilles,2665,712,30,26,56,53.6%,2h
25110,1,Jota,2665,601,26,14,40,65.0%,30m
25110,1,Meals,2665,604,25,15,40,62.5%,1h
25110,3,[KWG]Luny,2665,635,23,27,50,46.0%,2m
25110,3,LOFUEN,2665,233,22,25,47,46.8%,10m
25110,1,[HDIN]TestiCOOL,2665,520,16,15,31,51.6%,2h
25110,1,ArkannoSol,2665,442,15,13,28,53.6%,15m
25110,1,AJPC,2665,369,13,9,22,59.1%,2h
25110,1,HARMICHAEL,2665,253,10,10,20,50.0%,16m
25110,3,PepeSilva,2665,284,10,17,27,37.0%,15m
25110,1,Gatu,2665,245,9,8,17,52.9%,1h
25110,3,LaLibertÉ,2665,79,9,12,21,42.9%,43m
25110,1,Institute,2665,190,7,7,14,50.0%,2h
25110,3,Andythenerd,2665,201,7,8,15,46.7%,11m
25110,1,Ziggie,2665,185,7,8,15,46.7%,11m
25110,1,Austinyang,2665,192,5,4,9,55.6%,2h
25110,1,[Poiint]EndShield,2665,154,4,9,13,30.8%,32m
25110,1,[BoAVN]Caspper,2665,70,3,3,6,50.0%,7m
25110,1,leonardo,2665,88,3,3,6,50.0%,21m
25110,1,Toenails,2665,96,3,5,8,37.5%,21m
25110,1,[RAMEN]ouTlier,2665,0,2,3,5,40.0%,18m
25110,1,[FSCC]Sleepers,2665,0,2,3,5,40.0%,20m
25110,1,DankCrank,2665,94,2,4,6,33.3%,20m
25110,1,IEATPLANETS,2665,0,1,0,1,100.0%,32m
25110,3,Calvin,2665,0,1,0,1,100.0%,38m
25110,1,mapuchanel,2665,0,1,0,1,100.0%,3h
25110,1,MichConner,2665,0,1,0,1,100.0%,16m
25110,1,Dementor,2665,0,1,0,1,100.0%,2h
25110,3,life,2665,0,1,2,3,33.3%,2m
25110,1,JulianMontes,2665,0,1,2,3,33.3%,1h
25110,1,Matalcaru,2665,32,1,3,4,25.0%,14m
25110,1,miner,2665,95,1,3,4,25.0%,13m
25110,3,[PAsaga]jarhead,2665,91,1,6,7,14.3%,36m
25110,1,[OceanT]Hikui,2665,0,0,1,1,0.0%,16m
25110,2,IntotheSky,2665,0,0,1,1,0.0%,15m
25110,1,WARHATE,2665,0,0,3,3,0.0%,2h
25156,1,RaZeD,2664,1364,108,105,213,50.7%,2h
25156,1,[DntWin]Magno,2664,633,39,31,70,55.7%,15m
25156,1,PureIce,2664,875,33,30,63,52.4%,1h
25156,1,[0825]kadaskyy,2664,424,18,12,30,60.0%,17m
25156,1,ToganX,2664,538,17,16,33,51.5%,32m
25156,1,PapelVegetal,2664,418,16,11,27,59.3%,1h
25156,1,Squatch,2664,376,13,7,20,65.0%,2h
25156,3,hailtome,2664,324,13,9,22,59.1%,2h
25156,1,RootsyBoi,2664,280,12,11,23,52.2%,29m
25156,3,[Macac0]KillerViods,2664,288,11,17,28,39.3%,18m
25156,3,CptPickle,2664,276,10,14,24,41.7%,27m
25156,1,Kidmad,2664,258,7,6,13,53.8%,21m
25156,1,[syKer]DeadHead,2664,183,6,3,9,66.7%,2h
25156,1,[420710]StickyIcky,2664,124,6,6,12,50.0%,21m
25156,1,silentwraith,2664,146,5,6,11,45.5%,46m
25156,1,[WOTDL]xiozone,2664,145,4,2,6,66.7%,42m
25156,2,LTpecker,2664,46,4,5,9,44.4%,31m
25156,1,HÿÐÐEN,2664,125,2,1,3,66.7%,15m
25156,2,[DMWGF]Sublam,2664,141,2,2,4,50.0%,7m
25156,3,ElFipe,2664,0,2,3,5,40.0%,2h
25156,3,CuckyCheese,2664,0,2,3,5,40.0%,1h
25156,2,Boom,2664,0,2,5,7,28.6%,42m
25156,1,Ger,2664,0,1,0,1,100.0%,3h
25156,1,[KnOSh]LazyFrost,2664,0,0,1,1,0.0%,2h
25156,1,[LoShay]Karter,2664,0,0,1,1,0.0%,2h
25156,1,dnjstjr,2664,0,0,1,1,0.0%,13m
25156,1,[FALURS]Squeeky,2664,0,0,1,1,0.0%,1h
25156,2,Obelisk,2664,0,0,1,1,0.0%,2h
25156,2,iAmEAZY,2664,0,0,1,1,0.0%,2h
25156,3,[XHILE]Garham,2664,0,0,1,1,0.0%,2h
25186,1,happysc,2663,867,31,33,64,48.4%,43m
25186,3,[ARCHIE]AleeSxander,2663,603,23,26,49,46.9%,23m
25186,2,[GZRx]Bardock,2663,322,11,18,29,37.9%,48m
25186,1,Zmordron,2663,365,9,9,18,50.0%,19m
25186,3,Kortuz,2663,202,6,3,9,66.7%,15m
25186,3,[P4NDAS]Hammerhead,2663,183,6,7,13,46.2%,7m
25186,1,Areck,2663,238,6,10,16,37.5%,40m
25186,1,LittleFinBoy,2663,175,4,3,7,57.1%,2h
25186,1,Furax,2663,189,4,6,10,40.0%,2h
25186,1,sadescu,2663,107,3,0,3,100.0%,5m
25186,2,[GØSU]dex,2663,60,3,11,14,21.4%,14m
25186,3,coldsteel,2663,0,2,0,2,100.0%,35m
25186,1,TheWiz,2663,123,2,2,4,50.0%,40m
25186,1,[SCSS]DireDingo,2663,0,2,3,5,40.0%,2m
25186,1,SkoloVakarus,2663,48,2,3,5,40.0%,34m
25186,1,Garbanzo,2663,97,2,3,5,40.0%,2m
25186,1,gumpo,2663,0,2,3,5,40.0%,2h
25186,1,Korfuffle,2663,0,1,1,2,50.0%,1h
25186,1,[CDXXL]LiamPatrick,2663,38,1,2,3,33.3%,46m
25186,1,[EZkill]shawnjr,2663,40,1,4,5,20.0%,32m
25186,1,Malakias,2663,0,0,1,1,0.0%,14m
25186,1,CHINGCHANG,2663,0,0,1,1,0.0%,2h
25186,1,Justiceiro,2663,0,0,2,2,0.0%,5m
25186,1,[TGCrew]Bendo,2663,0,0,2,2,0.0%,2m
25186,1,MartinFrost,2663,0,0,3,3,0.0%,2h
25211,3,GridLocK,2662,1501,139,135,274,50.7%,7m
25211,1,InsaneDemon,2662,1565,70,59,129,54.3%,2h
25211,1,Conan,2662,1150,49,41,90,54.4%,13m
25211,2,[Atone]fukthisgame,2662,764,28,32,60,46.7%,39m
25211,1,Bearforceone,2662,527,24,16,40,60.0%,2h
25211,1,ChuckNorrisX,2662,560,17,16,33,51.5%,29m
25211,1,Beast,2662,452,15,12,27,55.6%,2h
25211,1,Lagols,2662,370,12,12,24,50.0%,30m
25211,1,Neocor,2662,347,10,8,18,55.6%,23m
25211,1,[TOSU]forly,2662,133,3,1,4,75.0%,2h
25211,1,WannaCry,2662,0,3,2,5,60.0%,1h
25211,1,[1Fenix]mackigamer,2662,40,2,3,5,40.0%,13m
25211,1,SmirPio,2662,38,2,5,7,28.6%,1h
25211,1,Theory,2662,44,2,5,7,28.6%,2h
25211,1,Tolkir,2662,0,0,1,1,0.0%,24m
25211,1,Korkee,2662,0,0,1,1,0.0%,2h
25211,1,Drexton,2662,0,0,3,3,0.0%,2h
25211,1,Chody,2662,0,0,5,5,0.0%,2h
25229,2,REEactive,2661,1522,232,197,429,54.1%,38m
25229,3,General,2661,1526,173,169,342,50.6%,22m
25229,1,Favhos,2661,1113,49,34,83,59.0%,2h
25229,1,TomTomTom,2661,520,44,42,86,51.2%,2h
25229,1,Gtast,2661,428,18,20,38,47.4%,22m
25229,1,PeaceKeeper,2661,387,16,15,31,51.6%,7m
25229,3,Phrygian,2661,414,15,14,29,51.7%,23m
25229,1,Coconuter,2661,421,11,10,21,52.4%,2h
25229,3,Crimson,2661,290,10,14,24,41.7%,34m
25229,1,Alarak,2661,215,9,6,15,60.0%,1h
25229,1,gohanngasusu,2661,219,7,5,12,58.3%,1h
25229,1,BenSoto,2661,261,7,9,16,43.8%,21m
25229,1,Dun,2661,134,5,3,8,62.5%,2h
25229,1,MWFriesen,2661,88,3,3,6,50.0%,42m
25229,1,Merlin,2661,30,2,0,2,100.0%,1h
25229,1,Sigma,2661,88,2,0,2,100.0%,2h
25229,1,CaribouJoe,2661,74,2,2,4,50.0%,2h
25229,1,Paton,2661,0,2,3,5,40.0%,3h
25229,1,AzNfLiPmOdE,2661,0,1,0,1,100.0%,20m
25229,1,[UED1]TUTI,2661,0,1,2,3,33.3%,30m
25229,1,[PSlSTC]reaper,2661,96,1,3,4,25.0%,13m
25229,1,[Juneau]Uder,2661,0,1,4,5,20.0%,3m
25229,1,smola,2661,48,1,6,7,14.3%,2h
25229,1,TioZezim,2661,0,0,1,1,0.0%,45m
25253,3,vash,2660,1260,72,69,141,51.1%,37m
25253,3,SurpriseMF,2660,961,67,60,127,52.8%,34m
25253,1,Firestarter,2660,1008,35,31,66,53.0%,18m
25253,3,radix,2660,694,25,28,53,47.2%,11m
25253,1,BlackAlert,2660,513,22,18,40,55.0%,1h
25253,2,Xyzen,2660,221,9,12,21,42.9%,31m
25253,1,Everost,2660,184,7,4,11,63.6%,2h
25253,1,GrandHazard,2660,191,5,6,11,45.5%,2h
25253,1,[URUS]GaLuK,2660,192,5,7,12,41.7%,40m
25253,1,Marvin,2660,131,4,1,5,80.0%,2h
25253,1,SirJames,2660,104,4,2,6,66.7%,1h
25253,2,crocker,2660,135,4,5,9,44.4%,3h
25253,1,[DATM]kirito,2660,150,4,7,11,36.4%,18m
25253,3,Monte,2660,42,3,3,6,50.0%,2h
25253,1,heyhen,2660,36,2,1,3,66.7%,7m
25253,1,ArtiC,2660,42,2,3,5,40.0%,33m
25253,1,WelHungSloth,2660,0,2,3,5,40.0%,24m
25253,1,[Boboyz]spacerandy,2660,0,1,0,1,100.0%,2h
25253,3,sOnnet,2660,0,1,2,3,33.3%,14m
25253,1,ComDAC,2660,36,1,3,4,25.0%,36m
25253,1,[oHHo]Sick,2660,0,0,1,1,0.0%,2h
25253,1,[xDead]BlLLMURRAY,2660,0,0,1,1,0.0%,18m
25253,1,Evolution,2660,0,0,1,1,0.0%,2h
25276,1,Corvus,2659,1740,201,194,395,50.9%,2h
25276,1,LiveLaughLuv,2659,1526,161,159,320,50.3%,12m
25276,3,Roy,2659,1236,52,46,98,53.1%,37m
25276,3,rickybobby,2659,845,36,33,69,52.2%,27m
25276,1,SinfulBread,2659,717,34,25,59,57.6%,36m
25276,3,JPAdun,2659,826,28,34,62,45.2%,8m
25276,1,lyubisebya,2659,733,27,24,51,52.9%,2h
25276,1,UltimateEnd,2659,756,25,25,50,50.0%,2h
25276,1,Zergling,2659,612,21,21,42,50.0%,20m
25276,1,strabla,2659,464,19,11,30,63.3%,2h
25276,1,[UpeV]viperKingHG,2659,110,18,6,24,75.0%,24m
25276,3,Eleazar,2659,352,14,11,25,56.0%,2m
25276,2,Salardin,2659,214,10,12,22,45.5%,16m
25276,1,Mrartanis,2659,296,9,6,15,60.0%,20m
25276,1,Ralbi,2659,312,9,8,17,52.9%,33m
25276,3,BosulakeBass,2659,256,9,15,24,37.5%,27m
25276,1,[FxB]munchies,2659,277,8,6,14,57.1%,2h
25276,2,[Meower]KassiCat,2659,132,7,5,12,58.3%,40m
25276,2,Lacrimosa,2659,88,4,4,8,50.0%,10m
25276,1,Spamland,2659,128,3,2,5,60.0%,33m
25276,1,Artgael,2659,88,3,3,6,50.0%,1h
25276,3,Keyfur,2659,86,3,12,15,20.0%,13m
25276,1,lucifer,2659,89,2,0,2,100.0%,2h
25276,3,CaptianSlaug,2659,0,2,3,5,40.0%,2h
25276,1,[GOURDS]Creakybones,2659,38,1,2,3,33.3%,33m
25276,2,[NOFEAT]RAZIELEITOR,2659,0,1,5,6,16.7%,2h
25276,1,VoidSeeker,2659,0,0,1,1,0.0%,47m
25276,3,Rafterman,2659,0,0,5,5,0.0%,2h
25304,1,novo,2658,1130,44,39,83,53.0%,2h
25304,3,BeefSausage,2658,708,37,34,71,52.1%,7m
25304,3,[YALL]greywolf,2658,928,36,38,74,48.6%,11m
25304,1,PapaFrita,2658,791,33,25,58,56.9%,2h
25304,3,ZASZER,2658,893,31,37,68,45.6%,49m
25304,3,jack,2658,567,29,22,51,56.9%,28m
25304,2,SkateBumNut,2658,504,20,26,46,43.5%,34m
25304,1,SENS,2658,411,18,10,28,64.3%,40m
25304,3,[Calx]Danador,2658,496,18,25,43,41.9%,37m
25304,1,VonGottfried,2658,424,13,15,28,46.4%,1h
25304,1,[GOPERÚ]MACHERFL,2658,315,11,7,18,61.1%,15m
25304,1,HoneyReeRee,2658,261,7,5,12,58.3%,2h
25304,1,OwO,2658,124,6,5,11,54.5%,2h
25304,1,ZERG,2658,92,6,5,11,54.5%,25m
25304,1,DoUNOKimchi,2658,167,5,8,13,38.5%,13m
25304,3,[LMI42]Sadik,2658,129,5,9,14,35.7%,27m
25304,1,Jet,2658,69,4,7,11,36.4%,2h
25304,2,[haZe]Soapdish,2658,109,3,2,5,60.0%,42m
25304,2,Scully,2658,0,3,3,6,50.0%,2h
25304,1,Trell,2658,106,3,4,7,42.9%,1h
25304,1,Yahmo,2658,0,1,0,1,100.0%,2h
25304,1,[XATUBA]Gozawr,2658,0,1,0,1,100.0%,43m
25304,1,Remymartin,2658,0,1,0,1,100.0%,1h
25327,1,[SWOU]Anominacion,2657,1405,137,110,247,55.5%,25m
25327,1,GnarFury,2657,1573,107,87,194,55.2%,2h
25327,1,bao,2657,1684,89,82,171,52.0%,3h
25327,1,Damix,2657,1642,69,55,124,55.6%,3h
25327,1,adaxian,2657,317,46,42,88,52.3%,2h
25327,3,llllllll,2657,753,45,38,83,54.2%,17m
25327,1,ENDER,2657,814,35,23,58,60.3%,1h
25327,1,mrvrmiko,2657,1002,34,39,73,46.6%,3h
25327,1,terraz,2657,277,10,7,17,58.8%,44m
25327,1,Castro,2657,232,9,9,18,50.0%,2h
25327,1,Jish,2657,36,2,1,3,66.7%,7m
25327,1,[3DLANS]Ocram,2657,38,2,2,4,50.0%,41m
25327,1,fiicere,2657,0,2,3,5,40.0%,25m
25327,2,LumTheSpider,2657,90,1,1,2,50.0%,2h
25327,3,Eternal,2657,97,1,2,3,33.3%,35m
25327,1,osyris,2657,0,1,4,5,20.0%,2h
25327,1,domda,2657,0,1,5,6,16.7%,2h
25327,1,Fanttom,2657,0,0,1,1,0.0%,1h
25327,1,[XYangX]Diego,2657,0,0,1,1,0.0%,3h
25327,1,NCE,2657,0,0,1,1,0.0%,33m
25327,1,ZeroReaper,2657,0,0,2,2,0.0%,1h
25327,1,Bagelstein,2657,73,0,4,4,0.0%,2h
25349,1,Revoke,2656,1694,77,82,159,48.4%,2h
25349,1,[2CREW]WhattheDeuce,2656,1263,56,48,104,53.8%,2h
25349,1,PinguThePeng,2656,1231,52,39,91,57.1%,33m
25349,1,[RN]RNtristan,2656,1280,52,46,98,53.1%,2h
25349,1,mrkisawsome,2656,1280,47,42,89,52.8%,2h
25349,1,snail,2656,546,24,12,36,66.7%,1h
25349,1,Hatzman,2656,674,21,22,43,48.8%,2h
25349,1,VIPER,2656,378,19,7,26,73.1%,2h
25349,1,Saitake,2656,513,19,11,30,63.3%,43m
25349,1,[SxyMxN]Sants,2656,458,19,14,33,57.6%,14m
25349,2,Gracchi,2656,431,19,34,53,35.8%,19m
25349,1,[cluez]Bionicle,2656,216,14,9,23,60.9%,24m
25349,3,rammingspeed,2656,390,14,19,33,42.4%,11m
25349,1,arichnad,2656,234,8,6,14,57.1%,2h
25349,1,Fragile,2656,244,8,9,17,47.1%,3h
25349,1,Viktortio,2656,209,6,3,9,66.7%,15m
25349,1,neeb,2656,131,5,5,10,50.0%,36m
25349,1,Miqueagul,2656,0,4,1,5,80.0%,1h
25349,3,EchelonEx,2656,30,3,3,6,50.0%,29m
25349,1,[alphox]yolo,2656,104,2,2,4,50.0%,1h
25349,1,[Kerak]CHOFIYEAAAH,2656,36,2,3,5,40.0%,15m
25349,1,Toxic,2656,0,2,3,5,40.0%,2h
25349,3,TLOislife,2656,0,2,3,5,40.0%,2h
25349,1,[cluez]RazerNaga,2656,91,1,4,5,20.0%,2h
25349,1,Parasite,2656,0,0,1,1,0.0%,1h
25349,1,profblix,2656,0,0,1,1,0.0%,2h
25349,1,[MaLiZ]Tangobsesion,2656,0,0,2,2,0.0%,2h
25349,1,[YGH]ShadowRICE,2656,0,0,3,3,0.0%,2h
25349,1,WErDNA,2656,0,0,3,3,0.0%,18m
25378,1,[OS4L]DCLWood,2655,1525,375,368,743,50.5%,2h
25378,2,[WALKZ]Chronos,2655,1510,187,181,368,50.8%,2m
25378,1,Qyxyr,2655,1404,89,65,154,57.8%,23m
25378,1,NicsTan,2655,1439,60,60,120,50.0%,47m
25378,1,[Nitmar]Arken,2655,599,26,19,45,57.8%,3h
25378,1,Phoenix,2655,481,23,17,40,57.5%,2h
25378,1,[Mayku]Atreyu,2655,554,18,15,33,54.5%,15m
25378,3,ROMAvSPQR,2655,268,18,22,40,45.0%,49m
25378,1,LEONAR,2655,325,16,9,25,64.0%,2h
25378,2,[NM8]sTony,2655,296,13,15,28,46.4%,35m
25378,1,Jellyman,2655,344,12,9,21,57.1%,2h
25378,1,ARot,2655,294,10,4,14,71.4%,1h
25378,1,RavenLord,2655,298,10,7,17,58.8%,21m
25378,3,dasdsaf,2655,270,9,12,21,42.9%,49m
25378,1,LooneyToon,2655,241,6,5,11,54.5%,2h
25378,3,NiGhtCourT,2655,130,5,15,20,25.0%,11m
25378,1,[UQQ2ME]BIG,2655,132,4,5,9,44.4%,2m
25378,1,ItThatBetray,2655,156,4,7,11,36.4%,3h
25378,3,BOB,2655,0,2,3,5,40.0%,2h
25378,1,CinnaBunZ,2655,0,2,3,5,40.0%,2h
25378,1,[ØÛ]DarkBeast,2655,0,1,0,1,100.0%,2h
25378,1,Erik,2655,0,0,1,1,0.0%,2h
25378,3,Shroots,2655,0,0,1,1,0.0%,2h
25378,1,andiro,2655,0,0,1,1,0.0%,2h
25378,1,kingpenguin,2655,0,0,2,2,0.0%,2h
25403,2,SuperPants,2654,1543,139,141,280,49.6%,15m
25403,2,JoshKnight,2654,590,98,73,171,57.3%,37m
25403,1,[exPFC]Jenckes,2654,1171,98,88,186,52.7%,40m
25403,1,EDDY,2654,1563,65,56,121,53.7%,2h
25403,1,[Ootz]wingethingy,2654,1127,42,35,77,54.5%,2h
25403,1,[Kixeye]hungkodak,2654,506,18,12,30,60.0%,15m
25403,1,Kill,2654,311,15,5,20,75.0%,2h
25403,1,RedSeven,2654,220,15,10,25,60.0%,2h
25403,1,[ExecUt]Alienshark,2654,304,8,11,19,42.1%,2h
25403,1,dkam,2654,250,7,7,14,50.0%,2h
25403,1,Sasha,2654,176,6,2,8,75.0%,20m
25403,1,dizzle,2654,102,5,3,8,62.5%,18m
25403,1,Apple,2654,107,3,4,7,42.9%,20m
25403,1,[xLgNx]Emzyrose,2654,89,2,0,2,100.0%,40m
25403,3,Asparagus,2654,0,2,4,6,33.3%,3m
25403,1,Nooby,2654,0,1,0,1,100.0%,2h
25403,2,ToTosiTo,2654,0,1,0,1,100.0%,2h
25403,1,Knives,2654,0,0,2,2,0.0%,5m
25403,1,Sanparo,2654,0,0,3,3,0.0%,40m
25422,2,KIRBY,2653,1508,206,215,421,48.9%,22m
25422,3,pipoop,2653,1450,103,98,201,51.2%,14m
25422,1,Shiho,2653,1552,58,50,108,53.7%,3h
25422,3,GooseWillis,2653,820,58,57,115,50.4%,13m
25422,2,[NXLsc]betu,2653,960,57,63,120,47.5%,38m
25422,2,DaftTank,2653,966,52,59,111,46.8%,9m
25422,1,mocksol,2653,769,36,24,60,60.0%,20m
25422,1,[AD3C]Silver,2653,768,25,23,48,52.1%,2h
25422,1,Keuper,2653,340,13,11,24,54.2%,13m
25422,3,VikingSkull,2653,171,7,7,14,50.0%,25m
25422,1,Osiris,2653,211,7,9,16,43.8%,14m
25422,3,[JUGOS]Lucifer,2653,0,3,2,5,60.0%,23m
25422,2,[VGRiD]Heatwave,2653,182,3,3,6,50.0%,42m
25422,1,SrZombie,2653,76,3,3,6,50.0%,2h
25422,2,Null,2653,94,3,4,7,42.9%,2h
25422,1,John,2653,0,2,3,5,40.0%,40m
25422,1,Pato,2653,0,2,3,5,40.0%,2h
25422,1,[ClanHs]Aryk,2653,74,2,4,6,33.3%,15m
25422,3,EndOfTheory,2653,62,2,8,10,20.0%,34m
25422,1,Piccoro,2653,0,1,0,1,100.0%,20m
25422,1,KDragonM,2653,88,1,1,2,50.0%,1h
25422,1,BnZnK,2653,0,1,1,2,50.0%,2h
25422,1,SeiyaDK,2653,34,1,2,3,33.3%,2h
25422,1,Pieronor,2653,34,1,3,4,25.0%,46m
25422,3,[RdLzrd]MadRaccoon,2653,0,1,4,5,20.0%,29m
25422,1,gthiv,2653,0,0,1,1,0.0%,2h
25422,2,irunoverkids,2653,0,0,2,2,0.0%,2h
25449,2,oblissvious,2652,1547,476,473,949,50.2%,22m
25449,1,[m3lm4c]CPZ,2652,1702,164,145,309,53.1%,16m
25449,1,bghost,2652,1564,147,129,276,53.3%,2h
25449,1,CROGIOSNELSO,2652,1506,86,66,152,56.6%,3m
25449,3,spacesloth,2652,1507,73,71,144,50.7%,35m
25449,2,maru,2652,225,57,61,118,48.3%,18m
25449,1,[N2F]sludge,2652,1330,55,43,98,56.1%,2h
25449,3,[FATwS]FatIsaac,2652,889,46,53,99,46.5%,8m
25449,1,[GDCL]Tassadar,2652,998,35,33,68,51.5%,2h
25449,2,jheryko,2652,573,22,26,48,45.8%,35m
25449,3,milkaholic,2652,538,18,28,46,39.1%,20m
25449,1,[PRSM]Kael,2652,343,16,10,26,61.5%,25m
25449,3,GrandAssault,2652,343,14,20,34,41.2%,13m
25449,3,Caesarastar,2652,337,12,14,26,46.2%,14m
25449,1,[VRGA]SANDUNGUERO,2652,260,10,5,15,66.7%,1h
25449,1,Regentrelics,2652,306,9,7,16,56.2%,2h
25449,1,JukeSkywalke,2652,128,5,4,9,55.6%,2h
25449,1,qewe,2652,176,5,5,10,50.0%,45m
25449,1,JLGX,2652,0,4,1,5,80.0%,24m
25449,2,kaveziya,2652,46,4,4,8,50.0%,46m
25449,1,Milleto,2652,122,3,1,4,75.0%,36m
25449,1,[MTMGG]MasonOR,2652,132,3,6,9,33.3%,13m
25449,1,bennyzilla,2652,0,2,3,5,40.0%,25m
25449,1,MacacoBranco,2652,0,2,3,5,40.0%,40m
25449,1,xiego,2652,0,1,0,1,100.0%,33m
25449,1,grubb,2652,92,1,1,2,50.0%,46m
25449,1,SWAGpocalyps,2652,42,1,2,3,33.3%,2h
25449,2,PhilTheLuv,2652,46,1,2,3,33.3%,8m
25449,2,pop,2652,0,1,2,3,33.3%,2h
25449,1,KOOQIE,2652,0,0,1,1,0.0%,20m
25449,1,Andrew,2652,0,0,4,4,0.0%,24m
25480,2,JupiterOM,2651,1224,102,110,212,48.1%,8m
25480,3,Dewman,2651,960,98,97,195,50.3%,13m
25480,1,Redskull,2651,1114,54,39,93,58.1%,25m
25480,1,Dire,2651,690,44,33,77,57.1%,2h
25480,2,[SWRqc]LayeX,2651,1007,39,46,85,45.9%,26m
25480,1,Tupac,2651,1031,37,33,70,52.9%,1h
25480,3,Zangief,2651,621,24,30,54,44.4%,31m
25480,1,[PTHero]Drizzt,2651,452,22,8,30,73.3%,2h
25480,1,[ScScUr]DDD,2651,662,21,20,41,51.2%,1h
25480,1,[QWARK]Blaze,2651,710,21,28,49,42.9%,2h
25480,3,MidnyteOne,2651,454,18,23,41,43.9%,11m
25480,1,ChronoXzX,2651,363,11,10,21,52.4%,1h
25480,1,Tom,2651,272,8,11,19,42.1%,3h
25480,1,CollegeParkF,2651,238,7,9,16,43.8%,42m
25480,3,Kaneda,2651,180,6,16,22,27.3%,3m
25480,1,jupi,2651,142,5,6,11,45.5%,5m
25480,1,Xbuster,2651,133,4,1,5,80.0%,41m
25480,1,valerian,2651,88,4,2,6,66.7%,32m
25480,1,[CRAKS]DeadHeart,2651,123,4,4,8,50.0%,1h
25480,3,SirCharles,2651,122,4,12,16,25.0%,24m
25480,3,ParanOidaL,2651,0,3,2,5,60.0%,2h
25480,3,Diger,2651,0,2,3,5,40.0%,25m
25480,3,Pelikantapet,2651,0,2,3,5,40.0%,1h
25480,1,HunterKiller,2651,0,1,2,3,33.3%,2h
25480,1,JJlin,2651,0,0,1,1,0.0%,17m
25480,1,TABARNAK,2651,0,0,1,1,0.0%,18m
25506,3,baboo,2650,1508,159,157,316,50.3%,16m
25506,3,Arim,2650,1374,66,76,142,46.5%,28m
25506,3,[NGRKKK]LGCY,2650,1470,65,73,138,47.1%,35m
25506,1,FrostyFeet,2650,1284,47,43,90,52.2%,2h
25506,1,Boss,2650,892,39,29,68,57.4%,2h
25506,1,TheChefsito,2650,801,38,24,62,61.3%,2h
25506,1,tbizzle,2650,756,33,22,55,60.0%,13m
25506,3,Solorn,2650,788,32,32,64,50.0%,3m
25506,3,Birthday,2650,687,24,30,54,44.4%,23m
25506,1,[xFsNxx]sPeCtRuM,2650,622,20,21,41,48.8%,25m
25506,1,Freedbird,2650,562,18,21,39,46.2%,46m
25506,1,AgentVenom,2650,340,17,8,25,68.0%,2h
25506,1,twoers,2650,335,12,7,19,63.2%,2h
25506,3,BlackBull,2650,272,10,12,22,45.5%,39m
25506,1,BlitZxWolF,2650,304,8,8,16,50.0%,1h
25506,1,Juanpavz,2650,136,4,2,6,66.7%,25m
25506,1,Inquisitor,2650,143,4,3,7,57.1%,33m
25506,1,StinkyLeaf,2650,114,4,4,8,50.0%,2h
25506,2,DazPetty,2650,46,4,4,8,50.0%,1h
25506,3,[GRNSKN]tehbigdirty,2650,126,3,1,4,75.0%,43m
25506,1,[ZCMD]Paper,2650,118,3,1,4,75.0%,2h
25506,3,[TK3]FdGodVinc,2650,38,3,3,6,50.0%,2h
25506,1,Enki,2650,0,3,3,6,50.0%,46m
25506,1,Lurenman,2650,88,2,0,2,100.0%,13m
25506,3,TheGiantham,2650,0,2,3,5,40.0%,16m
25506,1,[LCE]ansioso,2650,0,1,1,2,50.0%,2h
25506,3,lombardo,2650,30,1,8,9,11.1%,8m
25506,1,Ted,2650,0,0,1,1,0.0%,23m
25506,1,[Ch0nk]tofuisland,2650,0,0,1,1,0.0%,40m
25506,1,ThirdPlace,2650,0,0,1,1,0.0%,2h
25506,1,[Xpk]zeratul,2650,0,0,1,1,0.0%,46m
25506,1,TurtlePace,2650,0,0,1,1,0.0%,2h
25538,3,Snide,2649,1504,66,72,138,47.8%,2m
25538,1,[WeRaD]opop,2649,1166,50,40,90,55.6%,40m
25538,1,Illlllllllll,2649,592,24,14,38,63.2%,2h
25538,1,MOYQUECO,2649,568,24,22,46,52.2%,2h
25538,1,Jockling,2649,539,22,16,38,57.9%,2h
25538,1,Austerity,2649,607,22,22,44,50.0%,2h
25538,1,Drakien,2649,504,19,18,37,51.4%,47m
25538,1,Meatballer,2649,490,16,14,30,53.3%,40m
25538,1,[lwhy]RealLeader,2649,420,13,14,27,48.1%,2h
25538,1,Mahambah,2649,286,10,10,20,50.0%,13m
25538,1,Snowbllind,2649,326,10,12,22,45.5%,15m
25538,1,kyosai,2649,200,8,5,13,61.5%,13m
25538,1,[N0BLE]Freak,2649,152,4,2,6,66.7%,15m
25538,1,lime,2649,133,4,3,7,57.1%,43m
25538,1,imscuk,2649,109,4,5,9,44.4%,13m
25538,2,Stalaa,2649,0,3,4,7,42.9%,2h
25538,2,SoFat,2649,0,3,5,8,37.5%,3h
25538,3,Mexifry,2649,141,3,6,9,33.3%,35m
25538,1,JohnyFive,2649,91,2,0,2,100.0%,44m
25538,1,[TheRs]powerful,2649,0,2,3,5,40.0%,1h
25538,1,Kraw,2649,88,2,4,6,33.3%,3h
25538,3,[xSWFx]TheSilence,2649,30,2,5,7,28.6%,22m
25538,3,[3ADC]wezzo,2649,0,1,2,3,33.3%,2h
25538,3,SrOscuro,2649,0,1,3,4,25.0%,4m
25538,2,[SOLNEM]SolNemesis,2649,0,0,1,1,0.0%,1h
25538,1,AssCutter,2649,0,0,2,2,0.0%,13m
25564,3,[Epokhé]gallitodeoro,2648,983,181,172,353,51.3%,39m
25564,1,[pandem]oggrr,2648,1639,72,59,131,55.0%,2h
25564,3,Darkside,2648,531,18,22,40,45.0%,31m
25564,3,[cnoRSH]Turbo,2648,172,7,12,19,36.8%,23m
25564,3,Socalfer,2648,0,5,4,9,55.6%,3h
25564,3,Blackbear,2648,97,4,2,6,66.7%,33m
25564,1,IlIlIlIlIlIl,2648,88,2,0,2,100.0%,30m
25564,3,AhnHEL,2648,0,2,3,5,40.0%,2h
25564,3,[Cnada]Dimmadome,2648,0,2,3,5,40.0%,2h
25564,1,nako,2648,0,2,3,5,40.0%,3h
25564,3,[UFC]BurnTurn,2648,30,2,10,12,16.7%,25m
25564,1,NightRaven,2648,0,1,0,1,100.0%,3h
25564,2,Unknown,2648,0,1,0,1,100.0%,2h
25564,1,Kei,2648,0,1,1,2,50.0%,2h
25564,1,BobBonheur,2648,105,1,4,5,20.0%,47m
25564,2,HYZENTHLEY,2648,0,0,2,2,0.0%,39m
25564,3,llllllllllll,2648,0,0,2,2,0.0%,22m
25564,1,Sullaa,2648,0,0,3,3,0.0%,2h
25582,1,cTHREE,2647,1541,91,80,171,53.2%,1h
25582,3,[cluez]Psychowind,2647,601,58,59,117,49.6%,29m
25582,3,Billzworth,2647,1080,47,46,93,50.5%,23m
25582,3,Hyvo,2647,934,38,39,77,49.4%,35m
25582,1,[GgARMY]RechM,2647,733,37,20,57,64.9%,40m
25582,1,[Carton]Aventurero,2647,882,34,26,60,56.7%,13m
25582,1,tofumonster,2647,854,32,28,60,53.3%,1h
25582,3,Porkguy,2647,341,15,12,27,55.6%,49m
25582,3,rhetroic,2647,400,14,19,33,42.4%,18m
25582,1,[TRR]ventfan,2647,334,11,10,21,52.4%,44m
25582,1,dagio,2647,356,11,10,21,52.4%,2m
25582,1,[Bee]SpaceDucK,2647,256,9,7,16,56.2%,2h
25582,2,shadowlord,2647,0,3,3,6,50.0%,46m
25582,1,[DHCPs]FrEdAuM,2647,32,2,2,4,50.0%,1h
25582,1,[chull]Sweeney,2647,0,2,3,5,40.0%,33m
25582,2,Carnage,2647,0,2,4,6,33.3%,2h
25582,1,[UFC]poppills,2647,0,1,0,1,100.0%,1h
25582,1,BePositive,2647,0,1,0,1,100.0%,1h
25582,1,skyblue,2647,0,1,0,1,100.0%,20m
25582,1,QoPs,2647,0,1,0,1,100.0%,26m
25582,2,SnakeDT,2647,0,1,1,2,50.0%,2h
25582,2,Laughingman,2647,0,1,1,2,50.0%,2h
25582,1,iondune,2647,0,1,1,2,50.0%,36m
25582,1,Caballero,2647,0,1,4,5,20.0%,18m
25582,3,khoi,2647,0,0,1,1,0.0%,2h
25582,1,[Targus]saladfingers,2647,0,0,2,2,0.0%,2h
25582,1,mwthink,2647,0,0,2,2,0.0%,2h
25609,3,DmS,2646,1602,183,178,361,50.7%,19m
25609,3,Leo,2646,1542,134,123,257,52.1%,39m
25609,1,Schumie,2646,1333,129,121,250,51.6%,29m
25609,1,Atu,2646,1580,104,89,193,53.9%,20m
25609,3,Docterran,2646,1226,45,53,98,45.9%,10m
25609,1,ClownFiesta,2646,1085,43,46,89,48.3%,40m
25609,1,Alejandro,2646,754,42,36,78,53.8%,44m
25609,1,Vaega,2646,440,36,28,64,56.2%,3h
25609,1,Bargosk,2646,859,34,27,61,55.7%,2h
25609,3,[SpBa]warlord,2646,925,32,36,68,47.1%,3m
25609,3,AXELV,2646,572,24,21,45,53.3%,30m
25609,3,JoeMVC,2646,543,22,26,48,45.8%,21m
25609,1,pompousunset,2646,646,20,21,41,48.8%,1h
25609,3,[LCE]zeth,2646,461,17,21,38,44.7%,17m
25609,1,[AbcCo]xXMelvinGVXx,2646,375,14,10,24,58.3%,47m
25609,1,Symonomicon,2646,279,13,5,18,72.2%,2h
25609,1,Wayne,2646,306,12,6,18,66.7%,1h
25609,1,[kØ]MurDeR,2646,203,9,35,44,20.5%,29m
25609,1,PeioMax,2646,225,7,5,12,58.3%,14m
25609,1,Atomica,2646,205,6,3,9,66.7%,20m
25609,2,JonManatee,2646,153,5,5,10,50.0%,40m
25609,1,Sethdragon,2646,177,5,5,10,50.0%,40m
25609,1,Loser,2646,118,4,4,8,50.0%,2h
25609,1,Vile,2646,76,4,6,10,40.0%,20m
25609,1,Cheezus,2646,142,3,2,5,60.0%,2h
25609,1,AwakenToGrey,2646,0,3,2,5,60.0%,2h
25609,2,BEETLESCABC,2646,96,3,4,7,42.9%,1h
25609,1,Amaanji,2646,88,2,0,2,100.0%,2h
25609,1,Spooky,2646,103,2,2,4,50.0%,14m
25609,3,DTKing,2646,0,2,3,5,40.0%,16m
25609,1,NIGHTFURY,2646,0,2,3,5,40.0%,2h
25609,1,[GØSU]Typo,2646,0,0,1,1,0.0%,36m
25609,1,Floop,2646,0,0,1,1,0.0%,2h
25642,1,[MLG69]MechLurkeR,2645,1581,674,669,1343,50.2%,21m
25642,2,Blaze,2645,1531,267,251,518,51.5%,2m
25642,3,KillerAZ,2645,1114,80,77,157,51.0%,8m
25642,1,lowkei,2645,1092,52,27,79,65.8%,13m
25642,1,Biggs,2645,515,37,25,62,59.7%,2h
25642,3,mariah,2645,852,37,29,66,56.1%,33m
25642,1,Tsum,2645,638,24,25,49,49.0%,2h
25642,1,[yBooT]Newbee,2645,283,12,6,18,66.7%,2h
25642,3,Pharaoh,2645,265,11,11,22,50.0%,1h
25642,1,Tempest,2645,266,10,3,13,76.9%,1h
25642,1,[SCVM]NightKnight,2645,288,9,11,20,45.0%,41m
25642,2,Jeff,2645,228,8,21,29,27.6%,21m
25642,1,BigPoppy,2645,138,6,7,13,46.2%,13m
25642,2,[JACKY]Ingsanity,2645,44,5,3,8,62.5%,2h
25642,3,Tycho,2645,0,4,1,5,80.0%,35m
25642,1,[iar]Impulse,2645,150,4,3,7,57.1%,2h
25642,2,binox,2645,140,4,5,9,44.4%,2h
25642,3,yOOK,2645,118,4,9,13,30.8%,10m
25642,1,nikusRSS,2645,89,3,3,6,50.0%,30m
25642,1,SmartTopHat,2645,89,3,4,7,42.9%,14m
25642,2,HyroLisk,2645,95,3,5,8,37.5%,2h
25642,1,[BOLEY]HarveyFace,2645,80,3,7,10,30.0%,1h
25642,3,[CLan12]jalter,2645,149,3,8,11,27.3%,29m
25642,3,[Bats]corpsegrindr,2645,40,2,0,2,100.0%,2h
25642,1,SoilingSmile,2645,124,2,2,4,50.0%,2h
25642,1,Ezra,2645,0,2,3,5,40.0%,43m
25642,1,Phosphoid,2645,0,2,3,5,40.0%,14m
25642,1,Matfoxbidule,2645,38,2,4,6,33.3%,3h
25642,1,Tenfold,2645,72,2,4,6,33.3%,2h
25642,1,Will,2645,38,2,5,7,28.6%,2h
25642,1,SniperElGato,2645,0,1,0,1,100.0%,2h
25642,1,Datedorck,2645,0,1,0,1,100.0%,30m
25642,3,RaGePwN,2645,42,1,1,2,50.0%,33m
25642,1,[Daggy]ghostkill,2645,0,1,2,3,33.3%,2h
25642,1,FTCA,2645,0,0,2,2,0.0%,1h
25642,1,[Emb3rs]thisisfine,2645,0,0,5,5,0.0%,2h
25678,3,Gigaplex,2644,590,32,32,64,50.0%,29m
25678,1,burntoast,2644,565,25,16,41,61.0%,2h
25678,2,Tubbs,2644,516,22,24,46,47.8%,15m
25678,1,Acechador,2644,454,15,17,32,46.9%,17m
25678,1,davichony,2644,400,13,14,27,48.1%,2h
25678,3,[DoVOID]madkorean,2644,373,13,22,35,37.1%,4m
25678,1,edrtsmda,2644,222,10,2,12,83.3%,2h
25678,1,Olly,2644,320,10,12,22,45.5%,2h
25678,1,FearlessFrog,2644,123,5,5,10,50.0%,1h
25678,3,Poligney,2644,88,5,10,15,33.3%,24m
25678,2,overpowerd,2644,154,4,5,9,44.4%,2h
25678,2,jaku,2644,94,3,3,6,50.0%,2h
25678,1,Anthares,2644,70,3,3,6,50.0%,2h
25678,1,Slapfunk,2644,89,2,0,2,100.0%,33m
25678,1,AllahAkbar,2644,102,2,1,3,66.7%,2h
25678,1,BearyHamsup,2644,0,2,2,4,50.0%,13m
25678,1,HighElf,2644,0,1,1,2,50.0%,46m
25678,1,swarlos,2644,96,1,4,5,20.0%,3h
25678,1,[xHTx]Avalanche,2644,0,0,1,1,0.0%,15m
25678,1,fernandio,2644,0,0,1,1,0.0%,36m
25678,1,crocodoyle,2644,0,0,1,1,0.0%,33m
25678,1,Jupiter,2644,0,0,5,5,0.0%,2h
25700,3,[FK0USA]FkTrump,2643,1138,199,173,372,53.5%,8m
25700,1,Leftraru,2643,1604,68,63,131,51.9%,20m
25700,3,Anders,2643,1016,44,51,95,46.3%,2m
25700,1,JJJ,2643,750,33,25,58,56.9%,2h
25700,1,jimmy,2643,631,29,14,43,67.4%,2h
25700,1,NATAS,2643,671,28,23,51,54.9%,13m
25700,1,Pagnotta,2643,499,19,16,35,54.3%,2h
25700,1,llllllllllll,2643,274,13,7,20,65.0%,20m
25700,1,[bReD]mitchellm,2643,335,13,13,26,50.0%,2h
25700,1,Helk,2643,366,13,15,28,46.4%,47m
25700,3,bobthebuilde,2643,192,12,11,23,52.2%,12m
25700,1,[Gatinn]ravk,2643,281,10,15,25,40.0%,3h
25700,1,Umaker,2643,254,7,5,12,58.3%,15m
25700,1,[TGosuB]NotVanilla,2643,186,6,9,15,40.0%,13m
25700,1,Jlingtozz,2643,163,5,4,9,55.6%,3h
25700,1,les,2643,140,5,5,10,50.0%,42m
25700,1,PLUMBUM,2643,106,4,4,8,50.0%,2h
25700,3,YelloWood,2643,0,3,2,5,60.0%,41m
25700,3,eddi,2643,93,3,5,8,37.5%,35m
25700,1,[uDuh]XpermentorX,2643,110,3,6,9,33.3%,43m
25700,1,Chaos,2643,140,2,2,4,50.0%,1h
25700,1,SignumMortis,2643,70,2,3,5,40.0%,3h
25700,1,[SINSTR]emmanuelgx,2643,0,1,0,1,100.0%,29m
25700,1,[SEY]HellSpawn,2643,89,1,1,2,50.0%,2h
25700,1,scplayeer,2643,36,1,2,3,33.3%,3h
25700,3,[DFDub]conkermaster,2643,0,1,2,3,33.3%,10m
25726,1,OvaderFader,2642,1434,120,116,236,50.8%,2h
25726,3,Striker,2642,532,57,58,115,49.6%,38m
25726,3,Skullbasher,2642,1052,47,42,89,52.8%,26m
25726,1,sfhuh,2642,997,45,33,78,57.7%,2m
25726,1,KHANG,2642,619,36,34,70,51.4%,2h
25726,1,lili,2642,661,29,27,56,51.8%,24m
25726,1,Gothex,2642,532,22,15,37,59.5%,24m
25726,2,AlexPrime,2642,341,22,27,49,44.9%,16m
25726,1,[XpKAc]marinexd,2642,496,18,13,31,58.1%,3h
25726,1,[HotsPL]isoka,2642,419,16,11,27,59.3%,1h
25726,1,[VFam2]MonCapitain,2642,304,14,5,19,73.7%,33m
25726,1,[REPORT]Starzergian,2642,317,13,9,22,59.1%,2h
25726,1,name,2642,388,13,16,29,44.8%,2h
25726,1,Azazel,2642,265,9,5,14,64.3%,1h
25726,3,[DBers]LetsBFriends,2642,239,8,9,17,47.1%,34m
25726,1,aLittleSniff,2642,150,4,7,11,36.4%,4m
25726,1,Joel,2642,106,3,2,5,60.0%,40m
25726,3,[ProToX]TrollKiller,2642,0,3,3,6,50.0%,18m
25726,1,TheMalard,2642,132,3,5,8,37.5%,2h
25726,2,Kobe,2642,58,3,6,9,33.3%,16m
25726,1,Berymanchuck,2642,96,2,2,4,50.0%,18m
25726,1,Sorry,2642,36,2,6,8,25.0%,26m
25726,1,JohnRedcorn,2642,0,1,0,1,100.0%,14m
25726,3,[SCLK]Zero,2642,0,1,0,1,100.0%,42m
25726,1,[Zeiv]katsuo,2642,88,1,1,2,50.0%,3h
25726,3,[ARKEN]SirChow,2642,0,1,6,7,14.3%,44m
25726,2,Stepper,2642,0,0,1,1,0.0%,2h
25726,1,Biccboii,2642,0,0,1,1,0.0%,14m
25726,1,RGCC,2642,0,0,3,3,0.0%,49m
25755,3,CCC,2641,1385,113,101,214,52.8%,32m
25755,1,drcracker,2641,1142,48,44,92,52.2%,17m
25755,1,[XpKAc]JorgeV,2641,960,42,36,78,53.8%,2h
25755,3,DarzaTM,2641,765,29,33,62,46.8%,31m
25755,1,Stu,2641,714,25,28,53,47.2%,2h
25755,3,[InstaF]AtNano,2641,542,23,22,45,51.1%,31m
25755,1,efefFD,2641,221,20,20,40,50.0%,15m
25755,1,FatAgnus,2641,432,18,9,27,66.7%,2h
25755,1,PaybacK,2641,245,9,4,13,69.2%,2h
25755,1,[TITSQ]Xuron,2641,240,8,6,14,57.1%,3h
25755,1,Superjamez,2641,229,8,6,14,57.1%,2h
25755,2,Jenesis,2641,146,8,10,18,44.4%,2m
25755,1,FREDDY,2641,250,7,5,12,58.3%,3h
25755,1,NachoToNaiz,2641,208,6,5,11,54.5%,2h
25755,1,ShadowAngell,2641,177,6,7,13,46.2%,2h
25755,1,Sublime,2641,190,6,7,13,46.2%,2h
25755,1,Muse,2641,144,6,8,14,42.9%,2m
25755,1,[WSMERC]DragonSlayer,2641,126,3,1,4,75.0%,2h
25755,2,SOK,2641,127,3,1,4,75.0%,2h
25755,3,suuyo,2641,40,3,4,7,42.9%,24m
25755,3,Abbakus,2641,0,2,2,4,50.0%,24m
25755,3,ShaidarHaran,2641,0,2,3,5,40.0%,2h
25755,1,Celtic,2641,0,2,3,5,40.0%,2m
25755,3,Kei,2641,117,2,4,6,33.3%,10m
25755,3,Bortoch,2641,0,1,0,1,100.0%,1h
25755,1,Dahn,2641,0,1,0,1,100.0%,2h
25755,1,Skeletor,2641,38,1,5,6,16.7%,1h
25755,1,BirdUp,2641,0,0,1,1,0.0%,2h
25755,1,hellokitty,2641,0,0,2,2,0.0%,16m
25784,1,tonton,2640,1708,165,159,324,50.9%,2h
25784,2,RagingMonkey,2640,1058,158,153,311,50.8%,24m
25784,2,ProteusKel,2640,1066,136,138,274,49.6%,38m
25784,2,Shameless,2640,1401,120,97,217,55.3%,2h
25784,1,[ØÛ]matiBTC,2640,1077,55,41,96,57.3%,5m
25784,1,[RXZ]DOMINATOR,2640,682,50,27,77,64.9%,2h
25784,1,Gutok,2640,1150,47,36,83,56.6%,2h
25784,3,Tyzel,2640,344,42,42,84,50.0%,15m
25784,2,[JACKY]Paperanemone,2640,757,32,24,56,57.1%,2h
25784,1,Srhank,2640,484,18,18,36,50.0%,2h
25784,2,tobione,2640,338,14,16,30,46.7%,22m
25784,3,hotshotkelly,2640,317,12,12,24,50.0%,13m
25784,1,[WNTRLH]Futaci,2640,406,11,13,24,45.8%,2h
25784,1,ZergRush,2640,234,7,10,17,41.2%,3h
25784,3,FlJoe,2640,222,7,10,17,41.2%,39m
25784,1,Sarcasmonk,2640,186,6,8,14,42.9%,3h
25784,1,pdACE,2640,145,5,7,12,41.7%,2h
25784,1,[TSOHG]Verserker,2640,106,3,2,5,60.0%,2h
25784,2,patrick,2640,0,3,2,5,60.0%,1h
25784,1,Dant,2640,137,3,2,5,60.0%,1h
25784,3,Paradise,2640,0,3,2,5,60.0%,37m
25784,1,weaghjjhfdss,2640,0,3,3,6,50.0%,20m
25784,1,NotDivine,2640,89,2,0,2,100.0%,18m
25784,2,Legendofwars,2640,64,2,1,3,66.7%,43m
25784,2,Manowar,2640,0,2,3,5,40.0%,2h
25784,3,[NOLAN]Elainaloo,2640,0,2,3,5,40.0%,1h
25784,2,[BRevng]Aden,2640,0,1,0,1,100.0%,20m
25784,1,Search,2640,0,1,0,1,100.0%,2h
25784,2,[Pharoh]JDM,2640,0,1,0,1,100.0%,32m
25784,1,[ExcIgN]ShadowDragon,2640,90,1,1,2,50.0%,40m
25784,1,DojaSmokA,2640,36,1,2,3,33.3%,30m
25784,1,LakersPanda,2640,91,1,2,3,33.3%,2h
25784,2,smitty,2640,0,0,1,1,0.0%,33m
25817,3,yabooty,2639,1598,178,180,358,49.7%,17m
25817,1,[OndaVT]JRM,2639,451,130,118,248,52.4%,16m
25817,3,Nyamco,2639,1514,129,130,259,49.8%,16m
25817,1,[VMW3]Dorpapu,2639,763,32,21,53,60.4%,2h
25817,1,[BWVC]Dinamito,2639,756,28,23,51,54.9%,45m
25817,1,VDvicios,2639,371,11,11,22,50.0%,2h
25817,2,OptimusRhyme,2639,256,9,6,15,60.0%,2h
25817,1,[B3H0LD]ZerathianPie,2639,256,8,10,18,44.4%,1h
25817,1,Sasha,2639,264,7,13,20,35.0%,2h
25817,1,Fulgrim,2639,104,6,5,11,54.5%,13m
25817,3,Vinild,2639,175,5,6,11,45.5%,2h
25817,3,Younge,2639,120,5,9,14,35.7%,36m
25817,2,Nelson,2639,30,2,0,2,100.0%,2h
25817,3,[CADIVI]Okarin,2639,0,2,3,5,40.0%,2h
25817,1,RDawg,2639,76,2,7,9,22.2%,13m
25817,2,DomChambo,2639,32,1,2,3,33.3%,15m
25817,2,[Undone]UndoneXP,2639,0,0,1,1,0.0%,30m
25817,2,KimJongLi,2639,0,0,1,1,0.0%,3m
25817,2,[Litez]Shadowslayer,2639,0,0,1,1,0.0%,32m
25817,2,ToTLe,2639,0,0,1,1,0.0%,5m
25817,3,Trollzorlawl,2639,0,0,1,1,0.0%,2h
25817,1,CarolBaskin,2639,0,0,2,2,0.0%,24m
25817,1,Ranes,2639,0,0,3,3,0.0%,2h
25840,2,Panfilo,2638,1564,620,601,1221,50.8%,34m
25840,2,[NA7]Messerschmit,2638,786,181,179,360,50.3%,31m
25840,3,stefanstev,2638,1542,101,97,198,51.0%,21m
25840,1,[BigMcS]Opaloso,2638,812,90,82,172,52.3%,5m
25840,1,Chemyst,2638,1373,65,45,110,59.1%,25m
25840,1,RET,2638,1192,49,39,88,55.7%,40m
25840,3,VDRWASHERE,2638,1036,37,42,79,46.8%,7m
25840,1,SellJamHere,2638,1007,35,34,69,50.7%,45m
25840,3,[WAYRA]Helendor,2638,501,19,19,38,50.0%,37m
25840,1,[ZpaceX]XIIITijax,2638,525,17,16,33,51.5%,18m
25840,1,Alexisherre,2638,427,13,12,25,52.0%,2h
25840,1,[LpSqC]kloap,2638,278,13,14,27,48.1%,2h
25840,1,bismuto,2638,318,12,7,19,63.2%,2h
25840,3,scnightfire,2638,319,10,21,31,32.3%,15m
25840,1,Akrux,2638,184,7,8,15,46.7%,3m
25840,1,Snapdragon,2638,157,6,3,9,66.7%,2h
25840,1,theguypod,2638,157,4,2,6,66.7%,3h
25840,1,pepito,2638,204,4,9,13,30.8%,2h
25840,2,[2v1ptz]zelestrial,2638,90,3,3,6,50.0%,2h
25840,2,Westrice,2638,88,3,3,6,50.0%,30m
25840,2,Rikardus,2638,48,3,5,8,37.5%,15m
25840,2,VisibleIvan,2638,30,2,0,2,100.0%,15m
25840,1,Apollo,2638,137,2,4,6,33.3%,33m
25840,1,StarKiller,2638,0,1,3,4,25.0%,2h
25840,2,JoeBlow,2638,46,1,3,4,25.0%,2h
25840,3,seriousgreen,2638,30,1,8,9,11.1%,29m
25866,3,MiguelTrillo,2637,1594,649,630,1279,50.7%,5m
25866,2,wulf,2637,1165,212,203,415,51.1%,8m
25866,1,dde,2637,1478,138,109,247,55.9%,1h
25866,1,Swagikarp,2637,1518,89,61,150,59.3%,26m
25866,1,Smedlon,2637,1378,60,54,114,52.6%,2h
25866,3,[mator]ZadicoxXx,2637,1035,37,40,77,48.1%,9m
25866,3,popsongprof,2637,563,25,31,56,44.6%,8m
25866,3,[Lowko]SuperSloth,2637,600,22,23,45,48.9%,49m
25866,3,XPC,2637,111,14,14,28,50.0%,32m
25866,1,Lexcyn,2637,317,13,7,20,65.0%,2h
25866,1,kaishakunin,2637,388,11,14,25,44.0%,2h
25866,2,Ladranix,2637,232,9,3,12,75.0%,29m
25866,1,MacK,2637,284,8,10,18,44.4%,2h
25866,2,Gonzy,2637,190,7,0,7,100.0%,2h
25866,1,[ExcIgN]victor,2637,252,7,6,13,53.8%,2h
25866,1,Jellymage,2637,169,7,7,14,50.0%,24m
25866,1,aritanis,2637,214,7,8,15,46.7%,37m
25866,3,[RectEm]TriP,2637,180,6,13,19,31.6%,14m
25866,1,LinDrb,2637,110,4,4,8,50.0%,2h
25866,3,Tokedyamama,2637,34,3,4,7,42.9%,1h
25866,3,Chrizzo,2637,0,2,0,2,100.0%,2h
25866,2,[PrA26]Levftraru,2637,38,2,1,3,66.7%,2h
25866,2,axsl,2637,30,1,1,2,50.0%,1h
25866,1,Kimchiman,2637,0,1,1,2,50.0%,2h
25866,2,Marcelo,2637,30,1,2,3,33.3%,5m
25866,1,Gorilon,2637,89,1,2,3,33.3%,21m
25866,3,Ghostlypuddl,2637,30,1,3,4,25.0%,24m
25866,2,DoughbEE,2637,0,0,1,1,0.0%,2h
25866,1,AdOracle,2637,0,0,2,2,0.0%,2h
25895,2,Mondragon,2636,1585,159,143,302,52.6%,5m
25895,2,Nyzzar,2636,1544,104,104,208,50.0%,25m
25895,1,Sinrob,2636,944,81,65,146,55.5%,41m
25895,1,gem,2636,1354,57,49,106,53.8%,14m
25895,1,Gogabal,2636,862,40,18,58,69.0%,24m
25895,1,[Kopi]killerchef,2636,1036,35,37,72,48.6%,46m
25895,1,[nieBla]STARSET,2636,387,13,11,24,54.2%,47m
25895,3,BLACKMAN,2636,291,13,21,34,38.2%,25m
25895,2,Carlitos,2636,252,9,4,13,69.2%,32m
25895,2,Balhae,2636,210,7,6,13,53.8%,48m
25895,3,paladindk,2636,191,7,13,20,35.0%,28m
25895,2,COLOSUSS,2636,118,6,8,14,42.9%,25m
25895,1,Toodles,2636,234,6,10,16,37.5%,31m
25895,1,wasd,2636,119,5,5,10,50.0%,2h
25895,1,[MadK]pachitox,2636,156,5,6,11,45.5%,1h
25895,2,Markus,2636,137,4,6,10,40.0%,1h
25895,1,[TF11]Raider,2636,106,3,1,4,75.0%,14m
25895,3,Dogecoin,2636,120,3,3,6,50.0%,12m
25895,1,STALKER,2636,91,2,1,3,66.7%,44m
25895,3,wpGRichard,2636,0,2,3,5,40.0%,36m
25895,3,Alina,2636,0,2,3,5,40.0%,2h
25895,2,[0BS]DrChron,2636,36,1,1,2,50.0%,31m
25895,1,Cronos,2636,0,1,1,2,50.0%,1h
25895,2,SCCD,2636,44,1,2,3,33.3%,26m
25895,2,Lackskills,2636,44,1,3,4,25.0%,30m
25895,1,iSUCK,2636,0,0,2,2,0.0%,20m
25921,1,tictoc,2635,1605,239,225,464,51.5%,2h
25921,2,IconicEnvy,2635,553,198,204,402,49.3%,29m
25921,3,destructor,2635,1633,168,175,343,49.0%,25m
25921,1,[CLogic]Projectshady,2635,913,75,61,136,55.1%,33m
25921,2,TitaN,2635,575,32,0,32,100.0%,30m
25921,3,[EZDUNK]holleeze,2635,781,31,38,69,44.9%,20m
25921,3,Barcode,2635,567,29,31,60,48.3%,7m
25921,1,BearKing,2635,592,25,24,49,51.0%,2h
25921,1,Arvizo,2635,70,3,4,7,42.9%,2h
25921,3,SweetBaxter,2635,0,2,3,5,40.0%,24m
25921,2,[FEEDS]vaccjr,2635,103,2,3,5,40.0%,8m
25921,2,Mazer,2635,0,2,3,5,40.0%,2h
25921,2,Kazolas,2635,30,2,4,6,33.3%,5m
25921,2,Kairus,2635,44,2,5,7,28.6%,48m
25921,2,dunny,2635,0,1,0,1,100.0%,2h
25921,1,ChadTheDude,2635,42,1,5,6,16.7%,2h
25921,2,Jozz,2635,0,0,1,1,0.0%,2h
25921,2,CHUNKY,2635,0,0,1,1,0.0%,2h
25921,1,SirZAR,2635,0,0,2,2,0.0%,2h
25940,1,Nope,2634,1416,80,74,154,51.9%,32m
25940,1,Tavinho,2634,938,34,28,62,54.8%,2h
25940,1,Stektree,2634,406,27,19,46,58.7%,1h
25940,2,[BO0MER]KDS,2634,502,18,17,35,51.4%,2h
25940,1,pepegrillo,2634,505,17,18,35,48.6%,36m
25940,1,[ValidG]radio,2634,351,14,13,27,51.9%,1h
25940,3,[WINO]ToysThatKill,2634,355,11,21,32,34.4%,29m
25940,1,[papayo]frandux,2634,233,8,6,14,57.1%,43m
25940,2,Dogman,2634,212,7,4,11,63.6%,3m
25940,3,zxuGx,2634,209,7,6,13,53.8%,49m
25940,2,Saskatoon,2634,130,5,2,7,71.4%,3h
25940,1,Darkego,2634,164,5,6,11,45.5%,13m
25940,3,ImperialYT,2634,202,5,9,14,35.7%,38m
25940,3,Boboski,2634,34,3,3,6,50.0%,2h
25940,1,Danielson,2634,124,3,7,10,30.0%,2h
25940,1,TypHooN,2634,114,2,2,4,50.0%,2h
25940,3,Perhalik,2634,0,2,3,5,40.0%,2h
25940,2,POLLO,2634,0,1,0,1,100.0%,4m
25940,3,llllllllllll,2634,0,1,4,5,20.0%,1h
25940,1,[PWNDya]RajaSonu,2634,0,0,2,2,0.0%,5m
25940,2,munger,2634,0,0,2,2,0.0%,26m
25940,1,Paskurva,2634,0,0,4,4,0.0%,2h
25962,3,AbyssWalker,2633,1514,265,258,523,50.7%,35m
25962,1,[TinyED]aaa,2633,1283,193,187,380,50.8%,14m
25962,2,anthonyquest,2633,1629,180,161,341,52.8%,3h
25962,3,Macuack,2633,557,64,55,119,53.8%,38m
25962,2,XiniuX,2633,1362,61,44,105,58.1%,38m
25962,3,AlonsoSTM,2633,743,42,25,67,62.7%,7m
25962,1,imabeast,2633,554,40,26,66,60.6%,43m
25962,1,Pyro,2633,179,37,5,42,88.1%,2h
25962,3,Alexander,2633,540,26,25,51,51.0%,26m
25962,3,KamalaHarris,2633,600,25,28,53,47.2%,6m
25962,2,UByuL,2633,359,17,8,25,68.0%,2h
25962,1,PsiLemon,2633,410,14,19,33,42.4%,2h
25962,1,Chud,2633,256,11,15,26,42.3%,2h
25962,1,Kathy,2633,237,10,1,11,90.9%,29m
25962,1,doumie,2633,231,7,8,15,46.7%,2h
25962,2,[TONIC]Alternity,2633,148,5,5,10,50.0%,16m
25962,1,TreeMeister,2633,136,4,2,6,66.7%,24m
25962,2,Rence,2633,141,4,6,10,40.0%,37m
25962,2,YoruOokami,2633,0,3,4,7,42.9%,2h
25962,1,agamenon,2633,76,3,5,8,37.5%,37m
25962,1,giova,2633,108,3,6,9,33.3%,2h
25962,1,jish,2633,118,3,9,12,25.0%,20m
25962,3,[BNJWA]NuclearTaco,2633,32,2,2,4,50.0%,2h
25962,2,Jeuie,2633,48,2,3,5,40.0%,2h
25962,3,Homunculus,2633,0,2,3,5,40.0%,2h
25962,3,FlemSnopes,2633,0,2,3,5,40.0%,33m
25962,3,reeetacNA,2633,0,2,3,5,40.0%,34m
25962,1,xourge,2633,0,1,1,2,50.0%,40m
25962,1,Fishy,2633,0,1,3,4,25.0%,2h
25962,2,Colton,2633,0,0,1,1,0.0%,41m
25992,1,SuperSonicEJ,2632,1559,155,139,294,52.7%,1h
25992,3,shamoixlaine,2632,1281,89,83,172,51.7%,7m
25992,3,rookie,2632,1200,51,52,103,49.5%,22m
25992,1,Doppelift,2632,700,49,33,82,59.8%,20m
25992,1,Pointy,2632,737,29,22,51,56.9%,2h
25992,1,SirStichUp,2632,574,26,16,42,61.9%,47m
25992,1,Arjay,2632,602,26,19,45,57.8%,14m
25992,1,LankyManky,2632,557,26,27,53,49.1%,37m
25992,2,juliannovent,2632,435,17,10,27,63.0%,2h
25992,1,Snappor,2632,259,16,14,30,53.3%,2h
25992,1,Bayne,2632,366,13,12,25,52.0%,2h
25992,3,Dyro,2632,349,12,15,27,44.4%,12m
25992,1,Matt,2632,197,8,5,13,61.5%,2h
25992,2,AWQA,2632,207,8,8,16,50.0%,2h
25992,2,ITzExort,2632,206,7,5,12,58.3%,32m
25992,2,ABAR,2632,208,7,5,12,58.3%,2h
25992,1,[SPARK3]sincroknight,2632,258,7,14,21,33.3%,14m
25992,1,Potts,2632,232,6,7,13,46.2%,1h
25992,1,mjm,2632,104,4,3,7,57.1%,24m
25992,2,kaka,2632,165,4,5,9,44.4%,2h
25992,1,Gatt,2632,172,4,16,20,20.0%,1h
25992,1,[PTHero]Gaddict,2632,78,3,3,6,50.0%,20m
25992,2,MaCau,2632,0,3,4,7,42.9%,2h
25992,1,[EnTrpY]Jack,2632,112,3,9,12,25.0%,2h
25992,2,Chapinballs,2632,39,2,2,4,50.0%,20m
25992,1,Morne,2632,120,2,3,5,40.0%,18m
25992,2,[SoCh1]thecurl,2632,0,1,0,1,100.0%,16m
25992,1,Superman,2632,0,1,1,2,50.0%,20m
25992,2,NachoZG,2632,0,1,1,2,50.0%,2h
25992,2,Daghot,2632,0,0,1,1,0.0%,5m
25992,2,BadWolf,2632,0,0,2,2,0.0%,26m
26023,3,JDonC,2631,1525,715,716,1431,50.0%,16m
26023,3,Xcne,2631,1247,219,197,416,52.6%,49m
26023,1,DJKod,2631,1587,162,147,309,52.4%,13m
26023,1,TheSinister,2631,1597,103,89,192,53.6%,13m
26023,1,Heinz,2631,993,46,40,86,53.5%,2h
26023,1,Splat,2631,657,25,21,46,54.3%,2m
26023,1,TheAtheist,2631,534,22,18,40,55.0%,3h
26023,1,jman,2631,468,19,19,38,50.0%,2h
26023,1,idnester,2631,488,14,16,30,46.7%,2h
26023,1,charlemunger,2631,232,10,4,14,71.4%,31m
26023,3,[Fnland]CoyFish,2631,218,10,10,20,50.0%,3h
26023,3,Arbiter,2631,315,10,14,24,41.7%,10m
26023,2,WebCorno,2631,273,9,5,14,64.3%,2h
26023,2,[iar]THEBUTLER,2631,212,7,4,11,63.6%,42m
26023,1,Saieie,2631,212,7,7,14,50.0%,1h
26023,1,MagicTurtle,2631,219,6,5,11,54.5%,41m
26023,2,CriticalM,2631,171,5,2,7,71.4%,2h
26023,1,rZoiFlaming,2631,72,4,5,9,44.4%,20m
26023,1,XxXSaDXxX,2631,72,3,3,6,50.0%,1h
26023,1,Amove,2631,74,3,4,7,42.9%,14m
26023,3,Aqua,2631,42,2,0,2,100.0%,2h
26023,1,Seabass,2631,42,2,3,5,40.0%,2h
26023,1,Matthius,2631,84,2,5,7,28.6%,2h
26023,2,[LMI42]DookieToe,2631,0,1,0,1,100.0%,16m
26023,2,Farex,2631,0,1,0,1,100.0%,2h
26023,1,aceTulip,2631,0,1,2,3,33.3%,3h
26023,1,TraxFive,2631,0,1,3,4,25.0%,44m
26023,1,Scalped,2631,0,1,3,4,25.0%,3h
26023,2,ChefJ,2631,0,0,1,1,0.0%,2h
26023,2,Benktoostron,2631,0,0,1,1,0.0%,16m
26053,1,Sam,2630,966,84,60,144,58.3%,29m
26053,1,[Fronds]icanfly,2630,645,22,18,40,55.0%,2h
26053,2,LitaDEBORALO,2630,493,21,16,37,56.8%,30m
26053,2,chopper,2630,316,12,5,17,70.6%,2h
26053,1,XCESS,2630,378,12,12,24,50.0%,2h
26053,1,[SI4yeR]xxxZHITZUxxx,2630,190,11,6,17,64.7%,2h
26053,3,Goose,2630,191,11,12,23,47.8%,3h
26053,1,Vegeta,2630,367,9,11,20,45.0%,2h
26053,2,Jshizzle,2630,229,7,5,12,58.3%,27m
26053,1,rysb,2630,140,4,6,10,40.0%,47m
26053,3,SaxOfAtoms,2630,90,4,12,16,25.0%,29m
26053,2,Sphenny,2630,118,3,1,4,75.0%,2h
26053,1,oJeDo,2630,90,3,4,7,42.9%,2h
26053,1,[xSPTx]Bektro,2630,68,2,3,5,40.0%,2h
26053,3,[fromQc]matraka,2630,0,2,3,5,40.0%,33m
26053,3,[mGG]JuggerGOOSE,2630,0,2,3,5,40.0%,1h
26053,2,RhusBVelez,2630,0,2,3,5,40.0%,38m
26053,2,Glider,2630,0,2,3,5,40.0%,1h
26053,2,[SanTos]SaInTBuddy,2630,30,1,1,2,50.0%,43m
26053,2,SoulRaeb,2630,97,1,2,3,33.3%,2h
26053,2,woo,2630,0,0,1,1,0.0%,1h
26053,2,GenetiX,2630,0,0,1,1,0.0%,17m
26075,1,Gold,2629,1461,74,73,147,50.3%,2h
26075,1,[CITIOS]TheFK,2629,1148,53,38,91,58.2%,15m
26075,1,Cyro,2629,577,33,10,43,76.7%,13m
26075,1,AsaZiN,2629,560,22,17,39,56.4%,33m
26075,3,Chaotic,2629,604,21,25,46,45.7%,25m
26075,2,Skynet,2629,468,18,15,33,54.5%,2h
26075,1,jujubeez,2629,462,17,20,37,45.9%,2h
26075,2,Slaughma,2629,418,15,15,30,50.0%,2h
26075,1,Chosen,2629,454,14,13,27,51.9%,2h
26075,2,Runslow,2629,256,10,5,15,66.7%,2h
26075,1,alphacuremom,2629,254,8,7,15,53.3%,2h
26075,1,Zergioelzerg,2629,301,8,10,18,44.4%,2h
26075,1,ajavisk,2629,186,7,12,19,36.8%,7m
26075,1,[TheDOH]murcoff,2629,129,4,5,9,44.4%,20m
26075,2,Rubythegreat,2629,30,3,3,6,50.0%,2h
26075,3,[Pizzy]smooveAlv,2629,0,3,5,8,37.5%,13m
26075,1,ViceUp,2629,88,2,1,3,66.7%,2h
26075,1,ChefCurry,2629,38,2,2,4,50.0%,21m
26075,2,[TR1912]rasputin,2629,0,2,3,5,40.0%,2m
26075,3,ELPRODELPERU,2629,0,2,4,6,33.3%,1h
26075,2,BiteME,2629,0,1,0,1,100.0%,3h
26075,1,Morko,2629,0,1,3,4,25.0%,37m
26075,1,[VlPeRz]ANICKNAMEtwo,2629,30,1,3,4,25.0%,2h
26075,2,Agron,2629,0,0,1,1,0.0%,43m
26075,1,BinLaden,2629,0,0,5,5,0.0%,2h
26100,3,admiral,2628,1516,172,168,340,50.6%,36m
26100,3,KingJames,2628,1384,57,55,112,50.9%,6m
26100,1,SilkyMcNasty,2628,328,32,40,72,44.4%,2h
26100,2,Blar,2628,808,31,25,56,55.4%,2h
26100,1,PATOPARODI,2628,622,22,20,42,52.4%,5m
26100,1,RhuGOD,2628,476,20,17,37,54.1%,3h
26100,1,Straw,2628,268,10,5,15,66.7%,47m
26100,1,Toker,2628,212,9,6,15,60.0%,2h
26100,2,Junglists,2628,124,5,0,5,100.0%,29m
26100,3,supertulon,2628,133,5,2,7,71.4%,1h
26100,2,[SCIIpy]Vash,2628,0,4,1,5,80.0%,2h
26100,1,BluTxtOvrGrn,2628,114,4,4,8,50.0%,2h
26100,2,ctwo,2628,66,3,0,3,100.0%,2h
26100,1,JBalla,2628,78,3,3,6,50.0%,4m
26100,2,ScruffrNuttr,2628,32,3,4,7,42.9%,15m
26100,2,Stargazer,2628,34,2,0,2,100.0%,2h
26100,3,OVAL,2628,36,2,1,3,66.7%,1h
26100,2,[Groovy]eryo,2628,0,2,2,4,50.0%,2h
26100,2,pupsnkits,2628,0,2,3,5,40.0%,30m
26100,3,Vayra,2628,0,2,3,5,40.0%,2h
26100,3,Tornor,2628,23,2,7,9,22.2%,25m
26100,2,Escendo,2628,0,1,0,1,100.0%,27m
26100,1,GreenPunch,2628,0,1,2,3,33.3%,2h
26100,3,Vorzogoth,2628,0,1,2,3,33.3%,2h
26100,1,MadeULook,2628,42,1,4,5,20.0%,2h
26100,3,[Random]Taz,2628,30,1,4,5,20.0%,11m
26100,3,RadioGear,2628,0,0,4,4,0.0%,11m
26100,1,Hsiaoboy,2628,0,0,5,5,0.0%,15m
26100,1,[CF1]Shiksa,2628,0,0,6,6,0.0%,2h
26100,3,Patrovsky,2628,0,0,6,6,0.0%,31m
26130,2,[RE34]MinH,2627,866,189,176,365,51.8%,22m
26130,1,assemblythre,2627,1699,138,124,262,52.7%,2h
26130,1,Ammonium,2627,1628,100,78,178,56.2%,24m
26130,3,[TsKs]Illorum,2627,1574,66,75,141,46.8%,11m
26130,1,McGlovins,2627,1272,59,43,102,57.8%,2h
26130,2,[ffaaak]raven,2627,784,51,42,93,54.8%,2h
26130,1,Lingo,2627,943,39,40,79,49.4%,2h
26130,1,NieL,2627,674,21,26,47,44.7%,2h
26130,2,rubenei,2627,457,18,25,43,41.9%,19m
26130,1,Kryptake,2627,500,17,17,34,50.0%,2h
26130,1,Daedalus,2627,289,16,15,31,51.6%,8m
26130,3,shadowbrock,2627,401,14,17,31,45.2%,21m
26130,1,[CHAOS]Joebombs,2627,344,11,12,23,47.8%,1h
26130,2,Jungle,2627,232,11,14,25,44.0%,4m
26130,2,Gregor,2627,253,8,3,11,72.7%,2h
26130,1,Sleuy,2627,262,8,9,17,47.1%,14m
26130,1,Nybs,2627,252,7,10,17,41.2%,3h
26130,1,EDonKillah,2627,237,6,6,12,50.0%,24m
26130,2,[MoLaMa]PoofyRhino,2627,166,5,7,12,41.7%,1h
26130,2,magnetikal,2627,0,4,1,5,80.0%,3m
26130,2,Gravey,2627,46,2,1,3,66.7%,41m
26130,3,[EffM]Tavis,2627,0,2,3,5,40.0%,2h
26130,2,wml,2627,0,2,3,5,40.0%,20m
26130,1,Gredo,2627,38,2,4,6,33.3%,41m
26130,1,NoHotKeys,2627,0,2,4,6,33.3%,2h
26130,3,Kay,2627,44,2,5,7,28.6%,1h
26130,1,Sindark,2627,0,1,1,2,50.0%,37m
26130,1,Ohm,2627,0,1,2,3,33.3%,3h
26130,3,Craving,2627,0,1,4,5,20.0%,1h
26159,2,[PKMSSS]RAICHU,2626,1483,149,144,293,50.9%,21m
26159,2,MrCheese,2626,1070,77,74,151,51.0%,15m
26159,1,Naranya,2626,1180,61,53,114,53.5%,1h
26159,1,bomberice,2626,790,32,27,59,54.2%,44m
26159,1,Malaack,2626,408,16,11,27,59.3%,2h
26159,1,[yukup]ARFifteenkil,2626,218,10,17,27,37.0%,33m
26159,2,ChessMaster,2626,256,8,5,13,61.5%,17m
26159,3,[4amigo]JHolden,2626,180,7,15,22,31.8%,29m
26159,3,[KGH4]AaronEIRL,2626,170,6,7,13,46.2%,11m
26159,2,NightKnight,2626,88,4,2,6,66.7%,2h
26159,3,[RODANT]Subspacers,2626,97,4,2,6,66.7%,36m
26159,1,TruffleTeam,2626,120,4,4,8,50.0%,2h
26159,1,PROTOTYPE,2626,48,4,6,10,40.0%,20m
26159,2,greenhorn,2626,0,2,4,6,33.3%,2h
26159,1,llllllllllll,2626,0,2,4,6,33.3%,34m
26159,2,WILLDATHRILL,2626,0,1,0,1,100.0%,2h
26159,2,[C70]Avisuara,2626,0,1,0,1,100.0%,2m
26159,2,Van,2626,30,1,1,2,50.0%,18m
26159,3,memerweiner,2626,0,1,1,2,50.0%,28m
26159,3,naftar,2626,0,1,2,3,33.3%,1h
26159,3,Axton,2626,0,1,4,5,20.0%,2h
26159,3,Frost,2626,0,1,5,6,16.7%,1h
26159,1,Peencognito,2626,40,1,5,6,16.7%,32m
26159,2,popikciu,2626,0,0,1,1,0.0%,2h
26159,3,richeee,2626,0,0,1,1,0.0%,2h
26159,3,[Apug]Rockassist,2626,0,0,3,3,0.0%,2h
26185,1,LonePorpoise,2625,580,78,67,145,53.8%,2h
26185,3,Timmeh,2625,935,58,52,110,52.7%,11m
26185,1,[f331]Grimlock,2625,1003,47,38,85,55.3%,2h
26185,1,buru,2625,660,35,24,59,59.3%,24m
26185,3,SweetMonkey,2625,607,33,39,72,45.8%,17m
26185,1,Rust,2625,878,32,32,64,50.0%,1h
26185,3,blitzkriegHD,2625,516,32,39,71,45.1%,2m
26185,1,[3v4]Jeff,2625,675,28,21,49,57.1%,2h
26185,1,River,2625,636,26,20,46,56.5%,1h
26185,1,longheaduk,2625,342,15,10,25,60.0%,2h
26185,3,yChewy,2625,401,15,17,32,46.9%,23m
26185,3,Shane,2625,279,14,17,31,45.2%,2m
26185,3,[TRETER]Sueltox,2625,378,12,18,30,40.0%,48m
26185,1,TMT,2625,276,10,8,18,55.6%,14m
26185,2,BrownWook,2625,256,10,11,21,47.6%,28m
26185,1,[DETER]Nom,2625,346,10,16,26,38.5%,2h
26185,3,SilentSwordX,2625,308,10,16,26,38.5%,14m
26185,2,Archimedes,2625,178,9,8,17,52.9%,18m
26185,2,[CAPI]Olympus,2625,274,8,4,12,66.7%,3h
26185,2,PTNXLO,2625,164,7,1,8,87.5%,2h
26185,1,[FzzBNS]Yashinator,2625,166,7,8,15,46.7%,25m
26185,3,fred,2625,188,7,8,15,46.7%,4m
26185,3,Vrael,2625,210,6,6,12,50.0%,2h
26185,2,Grixis,2625,112,4,5,9,44.4%,43m
26185,1,Zedd,2625,152,4,11,15,26.7%,2h
26185,1,Justiceiro,2625,80,3,3,6,50.0%,16m
26185,2,zergxsiempre,2625,94,3,4,7,42.9%,32m
26185,3,PrOGress,2625,129,3,4,7,42.9%,2h
26185,2,Knightmare,2625,0,3,6,9,33.3%,5m
26185,1,[FxTF]Mejle,2625,114,3,8,11,27.3%,47m
26185,1,pLaTo,2625,118,3,8,11,27.3%,2h
26185,2,[WRFs87]Soriano,2625,30,2,0,2,100.0%,32m
26185,2,sonic,2625,0,2,3,5,40.0%,20m
26185,2,[ZTemps]Vayne,2625,0,1,0,1,100.0%,2h
26185,2,tracer,2625,0,1,0,1,100.0%,2m
26185,1,Templar,2625,0,1,1,2,50.0%,14m
26185,2,[ShiPal]SuWu,2625,30,1,2,3,33.3%,1h
26185,2,[IBIB]juggernaut,2625,0,0,1,1,0.0%,2h
26185,3,yumylollypop,2625,0,0,1,1,0.0%,13m
26224,3,YOGOTES,2624,1553,332,308,640,51.9%,35m
26224,3,Peanut,2624,1452,189,180,369,51.2%,37m
26224,3,Irreverent,2624,1516,148,143,291,50.9%,28m
26224,3,TIcktockman,2624,1563,137,140,277,49.5%,14m
26224,1,Binks,2624,779,50,47,97,51.5%,2h
26224,2,Hawke,2624,490,43,26,69,62.3%,3h
26224,3,[FyHr]MacKayA,2624,762,32,33,65,49.2%,19m
26224,2,SandDemon,2624,584,22,20,42,52.4%,1h
26224,3,TobyMcShane,2624,524,22,27,49,44.9%,11m
26224,1,[0d1N5]Kyros,2624,622,20,20,40,50.0%,24m
26224,1,[Pnoys]Sausage,2624,452,16,18,34,47.1%,3h
26224,1,Learner,2624,534,16,20,36,44.4%,2h
26224,1,NationalFire,2624,396,12,12,24,50.0%,1h
26224,2,Ventulus,2624,240,9,10,19,47.4%,1h
26224,2,ColeBurns,2624,170,8,5,13,61.5%,2h
26224,1,[UpxV]rach,2624,162,6,1,7,85.7%,36m
26224,1,[PaO2]Jimmy,2624,154,6,2,8,75.0%,36m
26224,1,[NrFms]KarmaPolice,2624,191,4,4,8,50.0%,2h
26224,1,RAYMANKAPEEN,2624,142,4,9,13,30.8%,1h
26224,2,Renlothar,2624,114,3,0,3,100.0%,2h
26224,1,LoudMetal,2624,139,2,2,4,50.0%,2h
26224,3,[1WAR8]WhiteChad,2624,0,2,3,5,40.0%,33m
26224,3,XinJinThug,2624,0,2,3,5,40.0%,2h
26224,2,Jason,2624,0,2,3,5,40.0%,2h
26224,2,perustyle,2624,0,2,3,5,40.0%,2h
26224,1,GrandManco,2624,66,2,4,6,33.3%,1h
26224,1,[xLgNx]Weeber,2624,0,1,1,2,50.0%,1h
26224,2,RayJFTW,2624,0,1,4,5,20.0%,15m
26224,2,Skrambled,2624,0,0,1,1,0.0%,2h
26224,1,[GayLuv]AvatarGensil,2624,0,0,2,2,0.0%,44m
26254,1,WaffleDaze,2623,1284,64,55,119,53.8%,23m
26254,3,Mithrandir,2623,952,59,55,114,51.8%,27m
26254,2,[LOHd]FreyasGuard,2623,1442,58,55,113,51.3%,41m
26254,3,[GpsyDg]Shadow,2623,367,40,40,80,50.0%,12m
26254,1,BadxMannered,2623,968,39,38,77,50.6%,16m
26254,1,[Fir3s]CapnpwnZr,2623,1022,34,37,71,47.9%,2h
26254,2,IVXX,2623,672,31,12,43,72.1%,1h
26254,2,ArthurTei,2623,611,25,15,40,62.5%,2h
26254,1,IndraRinne,2623,405,14,14,28,50.0%,47m
26254,3,[US]theFuzzyNeck,2623,295,12,3,15,80.0%,2h
26254,1,Hoid,2623,282,11,8,19,57.9%,14m
26254,1,Jamerc,2623,171,5,4,9,55.6%,2h
26254,2,[K3oudy]Koudy,2623,62,3,0,3,100.0%,1h
26254,3,lib,2623,141,3,4,7,42.9%,2h
26254,3,WorstNoob,2623,38,3,4,7,42.9%,2h
26254,1,LiLCeasar,2623,61,3,6,9,33.3%,2h
26254,1,Alex,2623,88,2,1,3,66.7%,3h
26254,2,LixoMolhado,2623,72,2,2,4,50.0%,2h
26254,3,Redundancy,2623,121,2,3,5,40.0%,2h
26254,2,Jona,2623,0,2,3,5,40.0%,5m
26254,2,Kirrav,2623,0,2,4,6,33.3%,26m
26254,1,ElFossa,2623,86,2,5,7,28.6%,14m
26254,2,pablolechuga,2623,0,1,0,1,100.0%,2h
26254,2,Predator,2623,0,1,0,1,100.0%,44m
26254,2,MontanaLogan,2623,34,1,1,2,50.0%,48m
26254,3,lee,2623,0,1,1,2,50.0%,29m
26254,1,[MCOS]Frutilloso,2623,0,1,9,10,10.0%,1h
26254,1,MrAlpaca,2623,0,0,1,1,0.0%,2h
26254,3,Valkire,2623,0,0,3,3,0.0%,13m
26283,2,MsSlick,2622,1530,189,187,376,50.3%,28m
26283,3,Zutka,2622,1506,106,109,215,49.3%,8m
26283,1,XxBenjixX,2622,1472,65,56,121,53.7%,3h
26283,1,pungkow,2622,1257,51,43,94,54.3%,2h
26283,1,DaNuSkA,2622,596,24,18,42,57.1%,2h
26283,1,DrK,2622,490,21,13,34,61.8%,3h
26283,1,Shehyn,2622,315,13,11,24,54.2%,13m
26283,1,PROTOSAURUS,2622,372,11,14,25,44.0%,1h
26283,3,CptFalcon,2622,270,9,17,26,34.6%,31m
26283,2,RAWR,2622,230,8,5,13,61.5%,42m
26283,1,[Lato]Schlossberg,2622,176,7,6,13,53.8%,1h
26283,1,[TGosuC]necrotik,2622,117,6,7,13,46.2%,2h
26283,2,Flavor,2622,114,5,2,7,71.4%,20m
26283,3,[PuffWC]AnimalMother,2622,178,5,8,13,38.5%,5m
26283,1,Daystar,2622,146,4,3,7,57.1%,2h
26283,1,BoKoR,2622,172,4,8,12,33.3%,8m
26283,2,Topher,2622,95,3,4,7,42.9%,2h
26283,2,Leo,2622,115,3,5,8,37.5%,2h
26283,2,[UrMove]Tuhklok,2622,44,3,5,8,37.5%,15m
26283,2,vyra,2622,34,2,0,2,100.0%,20m
26283,2,WhiteRa,2622,0,2,3,5,40.0%,3h
26283,1,sNoobDogg,2622,78,2,13,15,13.3%,2h
26283,3,[InGt]jenkins,2622,0,1,2,3,33.3%,40m
26283,3,[ButtSB]Gobbstopper,2622,0,1,4,5,20.0%,10m
26283,2,Saint,2622,0,0,1,1,0.0%,3h
26283,1,smile,2622,0,0,1,1,0.0%,1h
26283,1,Crepuscular,2622,0,0,5,5,0.0%,2h
26310,1,SoZborasBE,2621,1617,127,127,254,50.0%,1h
26310,1,MrMayhem,2621,1109,116,98,214,54.2%,2h
26310,1,Neanderthal,2621,573,84,68,152,55.3%,36m
26310,3,DreamCrusher,2621,1463,80,70,150,53.3%,12m
26310,3,ToysforTrots,2621,892,75,72,147,51.0%,3m
26310,1,xxKINGREKTxx,2621,823,35,24,59,59.3%,43m
26310,1,Aweishibashi,2621,956,35,32,67,52.2%,44m
26310,3,SCVready,2621,929,34,42,76,44.7%,30m
26310,1,Anekdotin,2621,631,20,20,40,50.0%,1h
26310,1,AppleBloomy,2621,484,18,17,35,51.4%,1h
26310,2,gongor,2621,424,17,13,30,56.7%,2h
26310,1,ReaListic,2621,520,17,15,32,53.1%,2h
26310,2,EbilDibl,2621,266,9,6,15,60.0%,20m
26310,2,SwordmanJ,2621,184,9,12,21,42.9%,13m
26310,3,[ConFed]EpicPenguin,2621,275,8,14,22,36.4%,23m
26310,1,NighGith,2621,226,7,11,18,38.9%,16m
26310,1,svenzitoprok,2621,186,5,9,14,35.7%,2h
26310,2,[TURDOS]VetleSucks,2621,132,4,5,9,44.4%,1h
26310,2,Raspova,2621,60,4,5,9,44.4%,31m
26310,2,Troll,2621,86,3,1,4,75.0%,43m
26310,2,[codahq]Majestas,2621,100,3,3,6,50.0%,43m
26310,2,[0clã]Ribeirovisk,2621,0,2,3,5,40.0%,31m
26310,1,Skeletor,2621,137,2,5,7,28.6%,2h
26310,1,smilekiller,2621,0,1,0,1,100.0%,2h
26310,2,parkmaster,2621,0,1,0,1,100.0%,2h
26310,1,NeOH,2621,34,1,3,4,25.0%,2h
26310,1,DarkSkies,2621,42,1,4,5,20.0%,23m
26310,1,lIIllIllIllI,2621,42,1,4,5,20.0%,3h
26310,1,Soulfly,2621,0,1,5,6,16.7%,18m
26310,2,SALT,2621,0,0,1,1,0.0%,15m
26310,2,RougeMort,2621,0,0,1,1,0.0%,2h
26310,1,Lightswell,2621,0,0,2,2,0.0%,45m
26342,1,McMinn,2620,1472,69,71,140,49.3%,30m
26342,1,ReguluS,2620,1187,50,53,103,48.5%,24m
26342,3,Aerodactyl,2620,656,28,26,54,51.9%,23m
26342,1,Anezthetik,2620,558,18,21,39,46.2%,2h
26342,1,[iTE]DaWarrior,2620,308,9,12,21,42.9%,2h
26342,1,BigTeddies,2620,196,8,9,17,47.1%,47m
26342,3,MikeT,2620,30,5,2,7,71.4%,2h
26342,1,[PvZm]Dekaron,2620,144,5,3,8,62.5%,44m
26342,1,Bob,2620,146,5,3,8,62.5%,2h
26342,1,Quintopulous,2620,132,5,6,11,45.5%,3h
26342,1,[IMGY]Chelyabinsk,2620,217,5,7,12,41.7%,40m
26342,2,Benz,2620,43,3,1,4,75.0%,18m
26342,1,[Enable]BoOYaz,2620,117,3,3,6,50.0%,20m
26342,3,INnoVatino,2620,30,3,3,6,50.0%,2h
26342,2,[GRU]Fabroskii,2620,96,3,4,7,42.9%,6m
26342,1,Ghost,2620,97,2,3,5,40.0%,21m
26342,2,DarC,2620,0,2,3,5,40.0%,2h
26342,1,Zeratulgost,2620,92,2,4,6,33.3%,2h
26342,2,Jochu,2620,0,2,4,6,33.3%,2h
26342,1,[Hilas2]JRCP,2620,127,2,6,8,25.0%,1h
26342,2,Vellmyster,2620,0,1,0,1,100.0%,2h
26342,1,Weeny,2620,0,1,3,4,25.0%,1h
26342,1,montaguy,2620,30,1,4,5,20.0%,2h
26342,2,JungleBridge,2620,0,0,1,1,0.0%,4m
26342,1,DEADPOOL,2620,0,0,2,2,0.0%,2h
26342,1,[CBAS3]NAGALEJEAN,2620,0,0,2,2,0.0%,2h
26342,1,Omega,2620,0,0,3,3,0.0%,2h
26369,3,[LMI42]Wulfgar,2619,1494,192,189,381,50.4%,13m
26369,2,[TMU500]WeedWizard,2619,1159,149,129,278,53.6%,41m
26369,2,Plexo,2619,1572,106,106,212,50.0%,49m
26369,3,Goochlore,2619,485,104,100,204,51.0%,18m
26369,1,juan,2619,1552,82,60,142,57.7%,4m
26369,1,Darkdaley,2619,931,80,69,149,53.7%,2h
26369,2,Iboga,2619,546,56,54,110,50.9%,2h
26369,2,Exodor,2619,613,31,15,46,67.4%,14m
26369,1,LilSavage,2619,438,16,17,33,48.5%,21m
26369,1,cannonrush,2619,299,13,7,20,65.0%,1h
26369,3,Reaper,2619,318,12,19,31,38.7%,32m
26369,2,Jeuger,2619,217,11,7,18,61.1%,3m
26369,2,[Jnsten]Blaze,2619,272,9,6,15,60.0%,2h
26369,1,Hero,2619,251,9,9,18,50.0%,2h
26369,1,REnoVation,2619,176,5,4,9,55.6%,16m
26369,3,[TVtwit]CheeseTroll,2619,117,4,0,4,100.0%,2h
26369,2,chris,2619,121,3,3,6,50.0%,2h
26369,1,[DNKCET]KloacaHarris,2619,88,2,1,3,66.7%,47m
26369,2,Quickdeath,2619,46,2,2,4,50.0%,1h
26369,1,DEAFFOREVER,2619,88,2,2,4,50.0%,1h
26369,3,Legion,2619,0,2,3,5,40.0%,16m
26369,2,Saltyriver,2619,0,1,0,1,100.0%,2h
26369,1,Bijlee,2619,0,1,1,2,50.0%,1h
26369,1,AndroniusMax,2619,96,1,2,3,33.3%,2m
26369,1,Jerian,2619,97,1,4,5,20.0%,34m
26369,2,[NoBads]NepeGigante,2619,0,0,1,1,0.0%,43m
26369,2,SBlack,2619,0,0,1,1,0.0%,32m
26369,1,Jimmyb,2619,0,0,2,2,0.0%,2h
26369,3,Zambowskie,2619,0,0,7,7,0.0%,14m
26398,1,[SCI]paulyworld,2618,1544,255,239,494,51.6%,44m
26398,3,[JAEGER]Arminius,2618,1460,92,90,182,50.5%,31m
26398,1,[DRGNS]PeruvnSwarm,2618,1381,56,47,103,54.4%,2h
26398,1,poLycromatic,2618,564,30,23,53,56.6%,2h
26398,3,Luciooz,2618,566,23,19,42,54.8%,27m
26398,1,Petey,2618,429,20,17,37,54.1%,4m
26398,3,joon,2618,535,20,20,40,50.0%,32m
26398,2,lllllllllll,2618,492,19,10,29,65.5%,1h
26398,2,ShroudWalker,2618,333,11,20,31,35.5%,43m
26398,3,Redskull,2618,241,10,12,22,45.5%,11m
26398,2,[KHMU]SuperiorAron,2618,152,9,6,15,60.0%,2h
26398,2,SeaHunt,2618,261,9,6,15,60.0%,2h
26398,1,IIIIIIIIIIII,2618,279,9,9,18,50.0%,49m
26398,1,[ALTF04]Alastor,2618,199,8,6,14,57.1%,2h
26398,1,DrMoose,2618,202,8,9,17,47.1%,14m
26398,2,ISIS,2618,270,8,9,17,47.1%,12m
26398,1,[TGosuA]Halcyonic,2618,248,7,6,13,53.8%,2h
26398,1,SMOG,2618,124,4,5,9,44.4%,13m
26398,2,RareBlue,2618,68,4,6,10,40.0%,8m
26398,2,Whocares,2618,84,3,2,5,60.0%,8m
26398,2,NerdLinger,2618,0,3,5,8,37.5%,2h
26398,1,yervx,2618,116,3,7,10,30.0%,3h
26398,2,dragoon,2618,0,2,3,5,40.0%,1h
26398,3,longhair,2618,0,2,4,6,33.3%,2h
26398,2,BodyFeeder,2618,0,1,0,1,100.0%,2h
26398,2,Euber,2618,0,1,1,2,50.0%,2h
26424,1,hydra,2617,1597,115,100,215,53.5%,1h
26424,2,MRhaegar,2617,1495,72,64,136,52.9%,2h
26424,2,crysys,2617,1209,50,41,91,54.9%,1h
26424,2,YinYang,2617,904,39,27,66,59.1%,2h
26424,2,TSquared,2617,679,36,17,53,67.9%,2h
26424,2,sacmaggot,2617,411,23,23,46,50.0%,2h
26424,1,[PobSC]Mahesvara,2617,487,17,17,34,50.0%,19m
26424,3,Vegita,2617,231,11,9,20,55.0%,37m
26424,1,Forber,2617,392,11,18,29,37.9%,2h
26424,3,DRIGOX,2617,262,10,11,21,47.6%,31m
26424,3,CornNuGgeT,2617,287,9,14,23,39.1%,2h
26424,1,MurdereR,2617,218,7,7,14,50.0%,20m
26424,1,Cenarii,2617,193,6,9,15,40.0%,4m
26424,1,Andrew,2617,170,5,8,13,38.5%,2h
26424,1,NoTvT,2617,158,5,11,16,31.2%,37m
26424,1,Minus,2617,191,4,6,10,40.0%,2h
26424,3,killgun,2617,0,3,3,6,50.0%,2h
26424,1,south,2617,93,3,5,8,37.5%,2h
26424,1,TiGuai,2617,68,3,6,9,33.3%,2h
26424,1,AntDoggG,2617,104,2,2,4,50.0%,2h
26424,2,[EZDUNK]GrannyWatta,2617,0,1,0,1,100.0%,42m
26424,2,Destroyer,2617,0,0,1,1,0.0%,18m
26424,2,DethKnight,2617,0,0,2,2,0.0%,31m
26424,1,Danimoth,2617,0,0,6,6,0.0%,2h
26424,2,dillyo,2617,0,0,8,8,0.0%,2h
26449,3,[AmonRa]EvilMorty,2616,1398,129,112,241,53.5%,20m
26449,2,LadiesMan,2616,668,103,95,198,52.0%,45m
26449,1,[Fr3d0m]SonOfLiberty,2616,776,91,80,171,53.2%,2h
26449,1,[NoBads]Halcyon,2616,1451,64,54,118,54.2%,2h
26449,1,[raa]deathbat,2616,724,34,27,61,55.7%,26m
26449,3,Cosi,2616,441,34,29,63,54.0%,39m
26449,2,[LY0]JOEL,2616,596,22,23,45,48.9%,29m
26449,2,[FFAA]EthanR,2616,544,21,14,35,60.0%,3h
26449,3,[INCW]Ghost,2616,582,19,31,50,38.0%,30m
26449,1,[SkAL]Khiva,2616,386,11,17,28,39.3%,17m
26449,1,Virus,2616,251,7,7,14,50.0%,2h
26449,1,ultimant,2616,228,7,8,15,46.7%,2h
26449,1,HoyaDorko,2616,0,4,2,6,66.7%,47m
26449,1,[LCE]Roots,2616,154,4,4,8,50.0%,2h
26449,1,DaBuDing,2616,106,4,24,28,14.3%,49m
26449,3,Performapal,2616,146,3,3,6,50.0%,23m
26449,1,[Stukov]WanaNanaBrah,2616,30,3,4,7,42.9%,26m
26449,2,[rSz]OrbitalObs,2616,60,2,2,4,50.0%,2h
26449,3,bother,2616,0,2,2,4,50.0%,2h
26449,2,[SIPA]IIIIIIIIIIII,2616,30,1,1,2,50.0%,2h
26449,2,KingDuncan,2616,30,1,2,3,33.3%,6m
26449,2,McBanhammer,2616,0,0,1,1,0.0%,18m
26449,2,ChickenBoi,2616,0,0,1,1,0.0%,1h
26449,3,[FalPal]CrestForever,2616,0,0,1,1,0.0%,9m
26449,1,Littlerob,2616,0,0,2,2,0.0%,2h
26449,1,FANTADUDE,2616,0,0,3,3,0.0%,2h
26475,1,Sprinter,2615,1674,277,260,537,51.6%,2h
26475,3,phenomenom,2615,724,207,213,420,49.3%,9m
26475,1,NoCheesePlz,2615,1534,178,155,333,53.5%,18m
26475,1,SirEbrawl,2615,1230,111,113,224,49.6%,3m
26475,1,[420SC2]barbarian,2615,1538,76,75,151,50.3%,2h
26475,3,Scarecrow,2615,1329,66,62,128,51.6%,36m
26475,3,STORMER,2615,1195,46,43,89,51.7%,25m
26475,1,Solevita,2615,1125,44,41,85,51.8%,33m
26475,2,Tiberius,2615,982,43,26,69,62.3%,6m
26475,2,sjnin,2615,886,35,34,69,50.7%,2h
26475,1,Ted,2615,761,29,19,48,60.4%,20m
26475,2,DoodyBomb,2615,613,24,13,37,64.9%,31m
26475,1,Idontknow,2615,626,22,22,44,50.0%,24m
26475,3,boukyaku,2615,178,21,20,41,51.2%,2m
26475,2,Gusto,2615,507,20,25,45,44.4%,6m
26475,1,GroundHawk,2615,592,20,39,59,33.9%,15m
26475,3,Vapor,2615,402,13,21,34,38.2%,14m
26475,2,Spondylo,2615,216,10,5,15,66.7%,2h
26475,1,Yeti,2615,276,8,8,16,50.0%,30m
26475,2,ZxTArpeTxZ,2615,244,6,3,9,66.7%,19m
26475,1,iLuMiNaTi,2615,107,3,3,6,50.0%,2h
26475,1,GoldenLegacy,2615,145,3,5,8,37.5%,2h
26475,3,dan,2615,115,3,7,10,30.0%,18m
26475,2,DitchWIzard,2615,30,2,1,3,66.7%,48m
26475,2,eNDERMAN,2615,68,2,3,5,40.0%,19m
26475,2,hafdecent,2615,0,2,3,5,40.0%,2h
26475,2,Unununium,2615,30,2,4,6,33.3%,2h
26475,1,MicroMachine,2615,38,2,4,6,33.3%,36m
26475,2,daniboy,2615,90,2,4,6,33.3%,1h
26475,1,[XpKAc]ska,2615,30,2,5,7,28.6%,41m
26475,1,Sleepbringer,2615,80,2,6,8,25.0%,32m
26475,2,SCVRUSH,2615,0,1,1,2,50.0%,2h
26475,1,MagoCosta,2615,0,1,1,2,50.0%,2h
26475,1,Papagal,2615,0,1,2,3,33.3%,16m
26475,1,[DIQPTE]beerandmath,2615,30,1,6,7,14.3%,37m
26475,2,SoldierKiler,2615,0,0,1,1,0.0%,30m
26475,2,[NuTFuW]KayElBee,2615,0,0,1,1,0.0%,3h
26475,2,SAK,2615,0,0,2,2,0.0%,2h
26475,1,killerXD,2615,0,0,3,3,0.0%,2h
26514,2,Fred,2614,1337,234,224,458,51.1%,49m
26514,3,Bigstuff,2614,1503,179,176,355,50.4%,19m
26514,3,Bermang,2614,1038,110,107,217,50.7%,27m
26514,1,[NOLA1]Sultan,2614,1080,67,61,128,52.3%,2h
26514,3,voodoogoats,2614,1238,42,53,95,44.2%,14m
26514,3,Benepene,2614,804,32,33,65,49.2%,4m
26514,2,[HaMz]ebilice,2614,495,23,4,27,85.2%,2h
26514,1,Angmar,2614,631,21,20,41,51.2%,20m
26514,2,Mister,2614,460,18,10,28,64.3%,45m
26514,2,Sceptical,2614,455,16,11,27,59.3%,2h
26514,1,bentobenito,2614,524,16,21,37,43.2%,1h
26514,2,cal,2614,426,15,17,32,46.9%,49m
26514,1,Shiagure,2614,387,13,12,25,52.0%,43m
26514,1,[KAAPPA]Gueris,2614,466,13,17,30,43.3%,30m
26514,1,[Cadete]DarielDelgad,2614,320,10,13,23,43.5%,3h
26514,1,odin,2614,227,9,9,18,50.0%,2h
26514,2,[6G]Seal,2614,94,6,2,8,75.0%,2h
26514,1,LavarBall,2614,228,6,8,14,42.9%,26m
26514,1,Steve,2614,212,6,10,16,37.5%,44m
26514,2,IMSorryManGG,2614,62,5,8,13,38.5%,27m
26514,2,Sepherin,2614,140,4,6,10,40.0%,37m
26514,3,AsuraE,2614,0,2,3,5,40.0%,2h
26514,2,[BDnrgy]SmokedGouda,2614,30,2,4,6,33.3%,31m
26514,2,Harmode,2614,91,2,6,8,25.0%,45m
26514,2,Yoshiyahoo,2614,0,1,1,2,50.0%,2h
26514,2,[MrBu]Insyza,2614,30,1,1,2,50.0%,2h
26514,2,Meixin,2614,0,0,1,1,0.0%,2h
26514,2,[Hayze]ARedTornadO,2614,0,0,1,1,0.0%,2h
26542,2,WadeWatts,2613,1581,414,387,801,51.7%,21m
26542,1,Marcuxx,2613,1332,103,92,195,52.8%,2h
26542,1,aaron,2613,1613,87,72,159,54.7%,31m
26542,3,[ELLOCO]Starship,2613,997,52,52,104,50.0%,37m
26542,1,[SWOU]Cuper,2613,701,28,24,52,53.8%,41m
26542,3,Kien,2613,710,24,33,57,42.1%,3m
26542,2,JackSparrow,2613,459,18,15,33,54.5%,2h
26542,2,[T4Y]KingVasa,2613,456,17,14,31,54.8%,2h
26542,3,NANDOX,2613,256,17,24,41,41.5%,28m
26542,1,cristak,2613,312,13,13,26,50.0%,2h
26542,2,KingKenny,2613,296,11,5,16,68.8%,19m
26542,2,AZXZC,2613,279,11,9,20,55.0%,3h
26542,1,[Sune]Cabutt,2613,374,10,11,21,47.6%,19m
26542,1,[Wehavu]saltvein,2613,214,5,6,11,45.5%,1h
26542,1,Fuego,2613,144,5,8,13,38.5%,36m
26542,2,Blackjack,2613,118,4,4,8,50.0%,2h
26542,1,Paeter,2613,117,4,6,10,40.0%,40m
26542,2,[Pharoh]Dalamar,2613,88,3,2,5,60.0%,43m
26542,3,akdx,2613,0,3,3,6,50.0%,2h
26542,2,[CYMAF]Myndestorm,2613,96,3,4,7,42.9%,1h
26542,3,[MyButt]MrTuggles,2613,120,3,8,11,27.3%,28m
26542,1,[ZTemps]PSYCH,2613,96,2,0,2,100.0%,1h
26542,1,Brummbrumm,2613,116,2,2,4,50.0%,2h
26542,3,Nicolai,2613,0,2,3,5,40.0%,1h
26542,3,melon,2613,0,2,3,5,40.0%,35m
26542,1,[TMO]dragon,2613,0,2,4,6,33.3%,32m
26542,2,[Akeno]GOTMEGAMILK,2613,0,1,1,2,50.0%,3h
26542,2,Chelino,2613,30,1,2,3,33.3%,2h
26542,2,Tywin,2613,0,0,1,1,0.0%,38m
26542,2,[GLit]LiquidNature,2613,0,0,1,1,0.0%,2h
26542,2,kevo,2613,0,0,1,1,0.0%,32m
26573,2,llllllllllll,2612,1620,154,135,289,53.3%,1h
26573,1,[cluez]DanChida,2612,1152,152,147,299,50.8%,2h
26573,1,Lan,2612,1159,91,69,160,56.9%,48m
26573,1,XenoKai,2612,1664,67,66,133,50.4%,32m
26573,1,FrostyDog,2612,706,65,61,126,51.6%,41m
26573,2,Insomnia,2612,964,46,25,71,64.8%,15m
26573,2,[GRNSKN]Lurker,2612,880,36,29,65,55.4%,2h
26573,1,TemZeratul,2612,806,31,31,62,50.0%,32m
26573,1,hung,2612,557,23,20,43,53.5%,14m
26573,1,KosmicSlop,2612,606,22,21,43,51.2%,3h
26573,2,[HMTeam]KoyaTeckKpv,2612,334,13,7,20,65.0%,2h
26573,2,CBRahn,2612,223,9,10,19,47.4%,34m
26573,2,WhaToDo,2612,178,7,5,12,58.3%,31m
26573,2,Arctes,2612,231,7,6,13,53.8%,2h
26573,3,[5X5]Losermobile,2612,174,6,19,25,24.0%,4m
26573,2,[PKCR]Oblivion,2612,110,4,5,9,44.4%,2h
26573,1,[TAC05]ShadowEagle,2612,144,4,9,13,30.8%,2h
26573,1,[xEx]Folklore,2612,150,4,9,13,30.8%,2h
26573,2,[Viola]neotheone,2612,90,3,3,6,50.0%,2h
26573,3,Shadowbee,2612,146,3,3,6,50.0%,48m
26573,2,ElSuper,2612,102,3,3,6,50.0%,3h
26573,3,deadboltz,2612,62,3,12,15,20.0%,24m
26573,3,[ooPLoo]QuBuS,2612,119,2,1,3,66.7%,2h
26573,3,HedCHILE,2612,0,2,3,5,40.0%,1h
26573,2,StayHydrated,2612,0,1,0,1,100.0%,3m
26573,2,Honyla,2612,0,1,0,1,100.0%,38m
26573,2,Snowcow,2612,30,1,2,3,33.3%,2h
26573,2,[AOAWOL]pixel,2612,0,0,1,1,0.0%,49m
26573,1,Sacot,2612,0,0,1,1,0.0%,2h
26573,1,Alvaro,2612,0,0,4,4,0.0%,18m
26573,3,Guitarman,2612,0,0,5,5,0.0%,25m
26604,3,Snakob,2611,1547,267,262,529,50.5%,19m
26604,3,Kucci,2611,592,109,80,189,57.7%,35m
26604,1,Mordarus,2611,1337,76,63,139,54.7%,1h
26604,2,Imperius,2611,991,40,28,68,58.8%,2h
26604,2,Niki,2611,580,27,13,40,67.5%,2h
26604,1,xxxKIRAxxx,2611,558,26,19,45,57.8%,8m
26604,1,Benjy,2611,227,22,16,38,57.9%,2h
26604,2,[MOAV]TANKITTT,2611,409,14,10,24,58.3%,3m
26604,1,GarouxZx,2611,270,11,5,16,68.8%,5m
26604,2,[KRAFTT]WolfsRain,2611,251,9,2,11,81.8%,2h
26604,1,Schmidty,2611,207,8,7,15,53.3%,2h
26604,2,Khal,2611,177,6,6,12,50.0%,20m
26604,2,[VOLKDS]ElGatoAraña,2611,157,5,4,9,55.6%,42m
26604,1,[aBom]Yeti,2611,119,3,4,7,42.9%,43m
26604,1,bassface,2611,148,3,5,8,37.5%,33m
26604,1,sebastian,2611,70,3,5,8,37.5%,2h
26604,2,PERMAFROST,2611,32,2,0,2,100.0%,6m
26604,2,[yukup]Banshee,2611,30,2,1,3,66.7%,2h
26604,1,[Merkd]Lerolim,2611,0,2,4,6,33.3%,18m
26604,3,[XAIRX]Huneph,2611,0,2,4,6,33.3%,2h
26604,2,ShowTime,2611,0,2,4,6,33.3%,2h
26604,1,[ZTempz]WeaponX,2611,38,2,5,7,28.6%,2h
26604,2,SirDox,2611,30,1,1,2,50.0%,2h
26604,1,FrOsTBiTE,2611,34,1,4,5,20.0%,2h
26604,2,[K1R1]Lightweight,2611,0,0,1,1,0.0%,16m
26604,2,Huicho,2611,0,0,1,1,0.0%,2h
26604,2,Konig,2611,0,0,1,1,0.0%,20m
26604,2,Chockas,2611,0,0,2,2,0.0%,2h
26604,1,Runescape,2611,0,0,4,4,0.0%,2h
26633,2,bapolex,2610,1222,103,73,176,58.5%,2h
26633,1,Fax,2610,1479,84,79,163,51.5%,2h
26633,2,NoAgain,2610,1235,58,37,95,61.1%,3h
26633,1,Phoenix,2610,1285,51,50,101,50.5%,2h
26633,1,ZOHANIV,2610,1067,46,39,85,54.1%,14m
26633,1,[TMKOs]Chasky,2610,721,31,21,52,59.6%,5m
26633,1,Emamnuel,2610,715,22,26,48,45.8%,37m
26633,3,[LY]llllleo,2610,400,14,24,38,36.8%,36m
26633,1,ArchDruid,2610,291,13,6,19,68.4%,33m
26633,3,David,2610,277,12,12,24,50.0%,11m
26633,1,REDSILENCEX,2610,343,11,14,25,44.0%,44m
26633,2,[mewth]Catman,2610,266,9,7,16,56.2%,1h
26633,2,[ENCE]ByOzito,2610,255,8,8,16,50.0%,2h
26633,2,massivekilla,2610,150,6,3,9,66.7%,16m
26633,1,Creativename,2610,194,6,7,13,46.2%,20m
26633,2,Loboman,2610,144,5,4,9,55.6%,2h
26633,3,[SCPROZ]Deathmatch,2610,167,5,5,10,50.0%,14m
26633,1,apocalipse,2610,189,5,9,14,35.7%,37m
26633,2,XBlackDracoX,2610,86,4,1,5,80.0%,43m
26633,2,hagar,2610,64,3,2,5,60.0%,4m
26633,1,Ohm,2610,110,3,7,10,30.0%,2h
26633,2,LoQuAt,2610,48,2,0,2,100.0%,16m
26633,3,HoneyBadger,2610,30,2,10,12,16.7%,12m
26633,2,zuluwarrior,2610,0,1,0,1,100.0%,2h
26633,2,MeWantDinDin,2610,0,1,1,2,50.0%,1h
26633,2,Leopard,2610,94,1,2,3,33.3%,31m
26633,2,KillerX,2610,0,0,1,1,0.0%,30m
26633,2,[FLOW1]XICOALT,2610,0,0,1,1,0.0%,1h
26633,3,VkBest,2610,0,0,1,1,0.0%,2h
26633,2,lparanoico,2610,0,0,1,1,0.0%,27m
26633,2,[Gbm0d]CrainXo,2610,0,0,1,1,0.0%,10m
26664,3,Anubis,2609,1425,301,284,585,51.5%,22m
26664,1,Masterh,2609,1616,245,229,474,51.7%,26m
26664,1,BetaStar,2609,1677,236,214,450,52.4%,2h
26664,1,PPskeet,2609,1557,105,103,208,50.5%,1h
26664,1,Mortisant,2609,1243,54,53,107,50.5%,1h
26664,1,SamuraiNinja,2609,688,45,35,80,56.2%,2h
26664,2,EpicJagrTime,2609,1038,42,40,82,51.2%,31m
26664,2,LeeManChild,2609,816,28,38,66,42.4%,39m
26664,1,DoricOrange,2609,792,27,28,55,49.1%,3h
26664,1,Style,2609,532,16,19,35,45.7%,44m
26664,1,[NGAP]Payku,2609,350,14,12,26,53.8%,24m
26664,1,MaTeTas,2609,91,11,7,18,61.1%,2h
26664,3,Rockandroll,2609,247,10,11,21,47.6%,5m
26664,2,[PQL]micelio,2609,210,8,4,12,66.7%,1h
26664,3,CremeFraishe,2609,221,8,10,18,44.4%,25m
26664,3,Zerathul,2609,164,8,11,19,42.1%,31m
26664,2,SaintProsvet,2609,0,4,1,5,80.0%,29m
26664,2,KyrRoyale,2609,119,4,5,9,44.4%,2h
26664,1,[Taco4u]DoctorSatan,2609,122,4,6,10,40.0%,14m
26664,2,ANonimus,2609,30,3,3,6,50.0%,2h
26664,1,ChrisLob,2609,132,3,4,7,42.9%,2h
26664,3,[PKSC]Jayle,2609,121,3,5,8,37.5%,47m
26664,1,[secks]Rice,2609,108,3,7,10,30.0%,21m
26664,1,[ZTemp]Wolv,2609,118,2,2,4,50.0%,2h
26664,1,[T1C2]Combination,2609,40,2,3,5,40.0%,2h
26664,2,[SBoys]DangerMarine,2609,0,1,0,1,100.0%,35m
26664,2,ThufirHawat,2609,0,1,1,2,50.0%,45m
26664,2,Adamolish,2609,30,1,1,2,50.0%,31m
26664,2,[Au4evr]Crocopotkine,2609,30,1,1,2,50.0%,2h
26664,1,Celesarn,2609,0,1,2,3,33.3%,33m
26664,1,DarkEvil,2609,0,1,2,3,33.3%,19m
26664,2,Tank,2609,96,1,2,3,33.3%,2h
26664,2,[Atoq]jackstark,2609,32,1,3,4,25.0%,2h
26664,3,Hatee,2609,38,1,7,8,12.5%,33m
26664,3,Iceman,2609,0,0,1,1,0.0%,2h
26664,2,GareBear,2609,73,0,3,3,0.0%,2h
26700,3,jimbo,2608,1486,118,115,233,50.6%,6m
26700,1,KingXvPvX,2608,1329,49,47,96,51.0%,2h
26700,3,[SHlTTY]StupidNoob,2608,792,31,28,59,52.5%,36m
26700,1,Monty,2608,770,29,23,52,55.8%,33m
26700,2,GBraver,2608,468,25,26,51,49.0%,2h
26700,1,[nomame]minifig,2608,491,18,19,37,48.6%,1h
26700,1,MTLSPN,2608,498,17,19,36,47.2%,2h
26700,1,Jundie,2608,506,15,18,33,45.5%,21m
26700,3,GazzyBoy,2608,253,14,24,38,36.8%,35m
26700,2,FrozenMage,2608,340,12,6,18,66.7%,31m
26700,1,PiVowNage,2608,277,9,9,18,50.0%,48m
26700,1,JimmiPop,2608,270,9,9,18,50.0%,37m
26700,1,StockSensei,2608,307,8,11,19,42.1%,2h
26700,1,angel,2608,280,8,13,21,38.1%,41m
26700,2,electric,2608,202,6,2,8,75.0%,2h
26700,2,DARKJR,2608,140,5,2,7,71.4%,2h
26700,2,Klutz,2608,124,5,5,10,50.0%,48m
26700,2,CoolCatWoWoW,2608,92,4,1,5,80.0%,2h
26700,3,TesteServer,2608,161,3,1,4,75.0%,24m
26700,2,Humberto,2608,60,3,2,5,60.0%,16m
26700,2,IIIIIIIIIIII,2608,64,3,2,5,60.0%,2h
26700,3,CricketsRvng,2608,97,3,3,6,50.0%,4m
26700,2,Dominator,2608,30,3,4,7,42.9%,4m
26700,1,SahbasWrath,2608,44,3,5,8,37.5%,2h
26700,2,Jedi,2608,30,2,1,3,66.7%,2h
26700,3,KingArthur,2608,30,2,3,5,40.0%,14m
26700,2,ParThree,2608,0,1,0,1,100.0%,43m
26700,2,NewLife,2608,0,1,0,1,100.0%,2h
26700,2,traps,2608,36,1,3,4,25.0%,42m
26700,2,itachi,2608,0,1,4,5,20.0%,2h
26700,2,ojotaAsesina,2608,0,0,3,3,0.0%,2h
26731,2,[TeamKL]Arcanista,2607,1494,114,103,217,52.5%,2h
26731,2,nicolas,2607,1284,84,80,164,51.2%,15m
26731,3,Stevo,2607,954,47,46,93,50.5%,12m
26731,3,[DXPCA]FMCBotGamer,2607,1244,47,47,94,50.0%,18m
26731,3,[6G]CRIMINAL,2607,978,38,38,76,50.0%,9m
26731,1,DeathisUponU,2607,571,36,34,70,51.4%,1h
26731,2,Focho,2607,734,32,22,54,59.3%,2h
26731,1,Priest,2607,733,24,26,50,48.0%,30m
26731,2,billy,2607,569,22,16,38,57.9%,43m
26731,2,NovaTwist,2607,445,17,21,38,44.7%,39m
26731,3,[Ec0s]Hellrazor,2607,295,13,24,37,35.1%,13m
26731,1,Parenthi,2607,272,7,14,21,33.3%,18m
26731,1,[BiBlak]Thepizzaman,2607,96,5,9,14,35.7%,2h
26731,1,[Rosie]srikar,2607,128,3,3,6,50.0%,2h
26731,2,[TDMT]TotoX,2607,30,3,4,7,42.9%,24m
26731,1,Zurc,2607,96,3,6,9,33.3%,14m
26731,2,[S1BJ]PhillyCheese,2607,86,3,8,11,27.3%,15m
26731,3,[TMKOs]XYEARZ,2607,62,2,10,12,16.7%,8m
26731,2,[Suns]nirv,2607,0,1,0,1,100.0%,16m
26731,2,Outlaw,2607,0,1,1,2,50.0%,2h
26731,2,thedestroyer,2607,30,1,2,3,33.3%,2h
26731,2,evilpem,2607,32,1,3,4,25.0%,29m
26731,3,gggggggggggg,2607,0,1,3,4,25.0%,2h
26731,1,jmudukes,2607,0,1,5,6,16.7%,48m
26731,3,SomiK,2607,0,0,1,1,0.0%,1h
26731,1,[Atena]NaHueL,2607,0,0,2,2,0.0%,2h
26731,1,[SC2Hn]TheDTDr,2607,0,0,3,3,0.0%,2h
26731,2,maruuuis,2607,0,0,5,5,0.0%,2h
26759,2,EricLuve,2606,1513,365,356,721,50.6%,8m
26759,2,Folken,2606,1326,215,222,437,49.2%,39m
26759,1,ToneOSarcasm,2606,862,42,34,76,55.3%,2h
26759,3,Higgs,2606,818,31,35,66,47.0%,7m
26759,3,Phaorpha,2606,829,27,33,60,45.0%,25m
26759,3,[JAR]awakenedhaki,2606,796,27,37,64,42.2%,6m
26759,1,[Pig2]Nimor,2606,691,26,27,53,49.1%,2h
26759,2,[AIRBAG]Jybe,2606,330,12,17,29,41.4%,26m
26759,1,PCerDock,2606,197,10,5,15,66.7%,8m
26759,2,Imangry,2606,210,8,7,15,53.3%,33m
26759,1,WaDzA,2606,248,7,12,19,36.8%,3h
26759,3,sagnew,2606,218,7,15,22,31.8%,3h
26759,1,Czab,2606,188,6,7,13,46.2%,41m
26759,1,BearProtoss,2606,89,5,2,7,71.4%,33m
26759,1,zZKerriganZz,2606,124,5,5,10,50.0%,2h
26759,1,Turff,2606,167,4,4,8,50.0%,2h
26759,1,[En3rgy]NotSuspicous,2606,114,4,5,9,44.4%,19m
26759,2,SoMLic,2606,90,3,3,6,50.0%,2m
26759,2,Keladn,2606,94,3,6,9,33.3%,2h
26759,2,DirtyDude,2606,30,2,0,2,100.0%,2h
26759,3,snaketime,2606,0,2,3,5,40.0%,1h
26759,3,HybridMarco,2606,0,2,3,5,40.0%,2h
26759,1,Chaotic,2606,0,2,5,7,28.6%,19m
26759,2,mike,2606,0,1,0,1,100.0%,43m
26759,2,Korlim,2606,0,1,0,1,100.0%,2h
26759,1,stlouis,2606,0,1,2,3,33.3%,36m
26759,3,MuddyNutts,2606,0,1,2,3,33.3%,2h
26786,2,Cheddar,2605,1496,337,319,656,51.4%,39m
26786,3,Avatuar,2605,1595,210,202,412,51.0%,11m
26786,1,Ultim,2605,752,157,123,280,56.1%,48m
26786,3,[DaFew]Shawdster,2605,1176,46,51,97,47.4%,32m
26786,1,LtDerp,2605,863,28,31,59,47.5%,1h
26786,1,Psycho,2605,190,25,7,32,78.1%,3h
26786,1,JohnBD,2605,492,23,19,42,54.8%,2m
26786,1,xzrz,2605,472,20,15,35,57.1%,41m
26786,3,funymudpee,2605,546,18,32,50,36.0%,32m
26786,1,Holyflygon,2605,357,15,16,31,48.4%,16m
26786,3,[Yoga1]Perfectus,2605,204,11,17,28,39.3%,19m
26786,1,[LAGGT]Minimi,2605,212,7,10,17,41.2%,2h
26786,3,[DarkAG]BattlePants,2605,131,6,8,14,42.9%,2h
26786,2,tossnb,2605,0,5,0,5,100.0%,2h
26786,1,assaro,2605,163,4,6,10,40.0%,2h
26786,2,Rags,2605,0,3,3,6,50.0%,2h
26786,3,[GJoyy]idowd,2605,40,3,4,7,42.9%,17m
26786,2,UnAvailable,2605,58,2,1,3,66.7%,32m
26786,3,Alarak,2605,0,2,3,5,40.0%,2h
26786,1,SEASA,2605,0,1,0,1,100.0%,40m
26786,2,[Patas]FuNNY,2605,0,1,0,1,100.0%,2h
26786,2,Nocturnus,2605,0,1,0,1,100.0%,3m
26786,2,Renko,2605,0,1,0,1,100.0%,1h
26786,1,MonkeyBreath,2605,0,0,8,8,0.0%,4m
26810,2,[ASS10]BirdsoPrey,2604,1308,256,272,528,48.5%,15m
26810,3,Highriser,2604,1505,149,154,303,49.2%,28m
26810,3,[GDClan]Swaly,2604,1031,51,51,102,50.0%,33m
26810,2,Quill,2604,989,42,33,75,56.0%,4m
26810,2,scsteve,2604,703,30,21,51,58.8%,1h
26810,1,Aries,2604,285,14,11,25,56.0%,8m
26810,1,numberone,2604,272,13,10,23,56.5%,47m
26810,2,RolandAuron,2604,333,13,12,25,52.0%,2h
26810,1,vichizdev,2604,370,10,17,27,37.0%,2h
26810,2,Insurrection,2604,208,8,5,13,61.5%,2h
26810,1,ElJefe,2604,118,6,7,13,46.2%,31m
26810,2,[JUGOS]LuckyAli,2604,136,4,0,4,100.0%,2h
26810,1,KillahHunt,2604,146,4,3,7,57.1%,8m
26810,2,ILikeWaffles,2604,64,3,2,5,60.0%,6m
26810,1,OGhupeng,2604,118,3,3,6,50.0%,43m
26810,2,Epsilon,2604,58,2,1,3,66.7%,2h
26810,2,NoName,2604,0,2,6,8,25.0%,3h
26810,2,AppleJax,2604,0,1,0,1,100.0%,2h
26810,2,Bot,2604,0,1,0,1,100.0%,20m
26810,2,Azamat,2604,0,0,1,1,0.0%,2h
26810,1,[KtGosu]tnerb,2604,0,0,4,4,0.0%,2h
26810,3,[BoXLyF]GloopGlorp,2604,0,0,5,5,0.0%,2h
26810,3,[SEEXEE]Aisthesis,2604,0,0,12,12,0.0%,38m
26833,3,MORTOCK,2603,1529,285,279,564,50.5%,17m
26833,1,[tsmph]Spencer,2603,1677,117,111,228,51.3%,1h
26833,2,Drannin,2603,1372,86,93,179,48.0%,38m
26833,3,GangstrChimp,2603,1029,85,98,183,46.4%,8m
26833,1,WONDERBOY,2603,1428,51,55,106,48.1%,2h
26833,1,RolloTomassi,2603,797,50,49,99,50.5%,48m
26833,3,Chaz,2603,270,39,45,84,46.4%,35m
26833,2,GhostDemon,2603,922,36,31,67,53.7%,2h
26833,1,Zeryz,2603,663,32,21,53,60.4%,26m
26833,1,[AlIin]Kartoffel,2603,708,29,30,59,49.2%,2h
26833,1,[BSW]Zahorath,2603,381,23,24,47,48.9%,2h
26833,1,Matigigio,2603,545,21,20,41,51.2%,1h
26833,2,Arkham,2603,290,11,10,21,52.4%,44m
26833,1,Arturo,2603,305,10,12,22,45.5%,2h
26833,1,KostoF,2603,293,8,8,16,50.0%,34m
26833,2,AshyLarry,2603,169,7,4,11,63.6%,39m
26833,1,Raider,2603,138,6,5,11,54.5%,41m
26833,1,Kaichou,2603,130,5,7,12,41.7%,2h
26833,2,matchsticks,2603,124,4,4,8,50.0%,2h
26833,3,Alakazam,2603,145,4,4,8,50.0%,26m
26833,2,Berzerker,2603,172,4,7,11,36.4%,2h
26833,2,[LeGG]MrPurple,2603,92,3,1,4,75.0%,2h
26833,3,Scratum,2603,131,3,4,7,42.9%,2h
26833,2,CATALIN,2603,0,3,5,8,37.5%,1h
26833,3,natsume,2603,0,2,3,5,40.0%,1h
26833,3,EDawg,2603,0,2,3,5,40.0%,2h
26833,2,LukeSkywalka,2603,0,2,3,5,40.0%,49m
26833,1,LightZero,2603,22,2,4,6,33.3%,18m
26833,2,Leekorean,2603,0,1,0,1,100.0%,2h
26833,1,[420QC]smokekush,2603,36,1,4,5,20.0%,2h
26833,2,[imbaGG]Avast,2603,0,0,1,1,0.0%,30m
26833,2,erius,2603,0,0,1,1,0.0%,2h
26833,3,Reign,2603,0,0,2,2,0.0%,13m
26833,1,iMPRo,2603,0,0,6,6,0.0%,40m
26867,1,[SGK1]HineyKin,2602,1700,230,229,459,50.1%,2h
26867,2,Believe,2602,1043,90,76,166,54.2%,3m
26867,1,MABA,2602,657,64,58,122,52.5%,1h
26867,3,buggang,2602,872,64,68,132,48.5%,12m
26867,1,DeceRoach,2602,1265,52,47,99,52.5%,2h
26867,1,[DRKL0R]Viper,2602,1019,42,34,76,55.3%,1h
26867,1,Breadsticks,2602,957,36,32,68,52.9%,3h
26867,1,Renegade,2602,788,32,32,64,50.0%,2h
26867,1,NARSONER,2602,251,9,8,17,52.9%,2h
26867,2,coronavirus,2602,176,7,4,11,63.6%,1h
26867,2,guerokno,2602,144,5,3,8,62.5%,19m
26867,1,[TGosuD]TopShotta,2602,72,4,5,9,44.4%,2h
26867,2,[GOPERÚ]Marinechan,2602,64,3,1,4,75.0%,48m
26867,2,Panzas,2602,63,3,1,4,75.0%,16m
26867,1,mTor,2602,0,3,3,6,50.0%,47m
26867,2,[ValidG]CrazyPylon,2602,30,2,0,2,100.0%,19m
26867,1,HOPE,2602,36,2,2,4,50.0%,26m
26867,1,wyernerth,2602,0,2,4,6,33.3%,2h
26867,1,BadPro,2602,74,2,5,7,28.6%,2h
26867,2,[BO1Z]landoskape,2602,30,1,1,2,50.0%,44m
26867,2,wkNg,2602,0,0,2,2,0.0%,1h
26867,1,mikey,2602,0,0,3,3,0.0%,8m
26867,1,Drak,2602,0,0,4,4,0.0%,40m
26867,1,JohnHughes,2602,0,0,4,4,0.0%,1h
26891,2,[DhZAc1]Santoliver,2601,411,172,157,329,52.3%,20m
26891,3,[OceanT]Fabusnardo,2601,1326,82,82,164,50.0%,6m
26891,1,waytooshifty,2601,462,43,27,70,61.4%,14m
26891,1,cyrius,2601,900,33,35,68,48.5%,1h
26891,2,[0469]Alebread,2601,281,13,8,21,61.9%,2h
26891,1,turdface,2601,306,10,11,21,47.6%,17m
26891,2,Russty,2601,211,8,6,14,57.1%,2h
26891,2,FrankStillz,2601,158,6,1,7,85.7%,2h
26891,1,GILL,2601,212,6,6,12,50.0%,2h
26891,2,BigDubbz,2601,169,6,9,15,40.0%,3m
26891,2,TitanNose,2601,148,6,9,15,40.0%,28m
26891,3,Preacher,2601,42,5,1,6,83.3%,19m
26891,2,Etheron,2601,158,5,7,12,41.7%,2h
26891,3,[Dunkel]hbdike,2601,0,4,1,5,80.0%,2h
26891,2,Sev,2601,122,3,1,4,75.0%,2h
26891,2,Thyrone,2601,132,3,5,8,37.5%,2h
26891,1,rastaper,2601,40,3,5,8,37.5%,31m
26891,2,psycho,2601,34,2,1,3,66.7%,45m
26891,2,Varkie,2601,94,2,1,3,66.7%,44m
26891,2,Yas,2601,66,2,2,4,50.0%,45m
26891,3,Pyrowarden,2601,0,2,4,6,33.3%,2h
26891,3,jizzcannon,2601,0,2,5,7,28.6%,36m
26891,2,MGG,2601,0,1,0,1,100.0%,2h
26891,3,Lasgo,2601,0,1,2,3,33.3%,11m
26891,3,[FL4]LUSETATO,2601,0,0,1,1,0.0%,2h
26891,2,UltimaDeath,2601,0,0,2,2,0.0%,2h
26891,2,PotilloCerda,2601,0,0,2,2,0.0%,2h
26918,3,Stalker,2600,1410,160,155,315,50.8%,7m
26918,1,[CRAKS]Radix,2600,1617,107,104,211,50.7%,19m
26918,1,superpraw,2600,1387,57,55,112,50.9%,36m
26918,2,HermannBalck,2600,715,56,45,101,55.4%,2m
26918,1,[RUD3]Hydropotamus,2600,751,29,27,56,51.8%,3h
26918,1,ElChapo,2600,703,27,25,52,51.9%,2h
26918,2,ScottWick,2600,465,18,16,34,52.9%,2h
26918,1,[E10G]Bannanfage,2600,297,12,7,19,63.2%,11m
26918,1,Rasolisk,2600,148,12,11,23,52.2%,41m
26918,3,Rourke,2600,238,11,12,23,47.8%,48m
26918,2,Bonhomme,2600,200,8,5,13,61.5%,48m
26918,1,william,2600,235,8,6,14,57.1%,17m
26918,3,Adapt,2600,169,6,9,15,40.0%,33m
26918,1,KALUNE,2600,227,5,4,9,55.6%,2h
26918,2,NaNaKoi,2600,114,5,8,13,38.5%,2h
26918,1,BeyondGone,2600,188,5,9,14,35.7%,2h
26918,2,ShadowDragon,2600,88,4,2,6,66.7%,1h
26918,2,LaidbackJ,2600,30,4,6,10,40.0%,35m
26918,2,Gungar,2600,0,3,4,7,42.9%,2h
26918,2,InfernEx,2600,30,2,0,2,100.0%,2h
26918,2,Perraian,2600,32,2,1,3,66.7%,2h
26918,3,Emily,2600,0,2,3,5,40.0%,34m
26918,2,[SOA200]MrSprinkles,2600,0,2,3,5,40.0%,15m
26918,1,Starfish,2600,42,2,4,6,33.3%,19m
26918,2,iTzfer,2600,0,1,0,1,100.0%,2h
26918,2,[VietG]baobao,2600,30,1,2,3,33.3%,15m
26918,2,JackattacK,2600,0,1,4,5,20.0%,14m
26918,2,Chrono,2600,0,0,1,1,0.0%,2h
26918,1,Peach,2600,0,0,3,3,0.0%,44m
26918,1,ShockSword,2600,0,0,6,6,0.0%,1h
26948,2,isded,2599,1636,279,274,553,50.5%,2h
26948,1,MastersChaos,2599,1696,235,234,469,50.1%,3h
26948,1,Aryo,2599,1487,125,108,233,53.6%,30m
26948,2,[Cov818]BigLerm,2599,1598,72,63,135,53.3%,16m
26948,2,Frank,2599,308,67,77,144,46.5%,28m
26948,3,carlos,2599,638,22,29,51,43.1%,28m
26948,2,SaTaNaS,2599,494,16,15,31,51.6%,16m
26948,1,GOÐ,2599,484,15,19,34,44.1%,3h
26948,2,Jakileo,2599,348,13,5,18,72.2%,16m
26948,2,Goibniu,2599,296,9,6,15,60.0%,2h
26948,1,llllIIIIllII,2599,347,8,14,22,36.4%,34m
26948,2,Hiroshima,2599,208,7,1,8,87.5%,1h
26948,1,ElTesla,2599,216,6,6,12,50.0%,44m
26948,2,SuperGrim,2599,140,5,2,7,71.4%,19m
26948,1,KORIOTO,2599,90,3,4,7,42.9%,14m
26948,3,yarly,2599,0,2,3,5,40.0%,2h
26948,2,TingLouie,2599,0,2,3,5,40.0%,2h
26948,2,Fenix,2599,0,1,0,1,100.0%,2h
26948,2,Jango,2599,0,1,0,1,100.0%,20m
26948,2,Dusk,2599,30,1,3,4,25.0%,2h
26948,2,snoor,2599,0,0,1,1,0.0%,20m
26948,1,Legendstrike,2599,0,0,5,5,0.0%,2h
26970,1,VirusHunter,2598,1621,165,146,311,53.1%,25m
26970,1,jeql,2598,1597,151,127,278,54.3%,19m
26970,1,AMS,2598,956,131,121,252,52.0%,2h
26970,3,Starfox,2598,795,88,89,177,49.7%,30m
26970,1,Joshpiolin,2598,928,58,48,106,54.7%,2h
26970,1,[FyHr]RicardinniZ,2598,1350,56,42,98,57.1%,19m
26970,3,[aqocea]Shadow,2598,1312,50,59,109,45.9%,40m
26970,2,Sunkist,2598,1144,43,41,84,51.2%,2h
26970,1,camper,2598,580,20,23,43,46.5%,2h
26970,1,David,2598,464,15,16,31,48.4%,41m
26970,1,NRG,2598,220,12,7,19,63.2%,3m
26970,2,Svein,2598,244,11,5,16,68.8%,2h
26970,1,Zhoilet,2598,286,9,13,22,40.9%,21m
26970,1,Junior,2598,318,9,15,24,37.5%,25m
26970,2,Lentex,2598,224,6,7,13,46.2%,45m
26970,2,Dyxxxito,2598,112,5,6,11,45.5%,19m
26970,1,BigHammer,2598,141,5,6,11,45.5%,2h
26970,1,[GOPERÚ]FULCRUM,2598,121,4,3,7,57.1%,48m
26970,2,[Mixear]hawksJhonSC,2598,137,4,5,9,44.4%,2h
26970,2,[APR]frankmax,2598,64,3,1,4,75.0%,48m
26970,2,MajorMichael,2598,30,2,2,4,50.0%,10m
26970,1,MartínVizcar,2598,89,2,2,4,50.0%,45m
26970,1,Pushfart,2598,38,2,3,5,40.0%,40m
26970,3,[Sentry]desi,2598,0,1,0,1,100.0%,2h
26970,2,lllIIIlllIII,2598,0,1,0,1,100.0%,32m
26970,1,cheesytaters,2598,0,1,3,4,25.0%,17m
26970,3,cXnPlaymaker,2598,0,0,1,1,0.0%,23m
26970,2,Matthew,2598,0,0,1,1,0.0%,2h
26970,1,[TFCqs]Dooper,2598,0,0,1,1,0.0%,2h
26970,2,RudyGhost,2598,0,0,1,1,0.0%,2h
26970,2,Brohammid,2598,0,0,2,2,0.0%,2h
26970,2,Sunstrider,2598,0,0,2,2,0.0%,6m
27002,2,FULGORE,2597,1458,65,53,118,55.1%,42m
27002,1,YokitoFokyto,2597,797,35,28,63,55.6%,25m
27002,3,DeltaCommand,2597,483,30,34,64,46.9%,27m
27002,2,PiterFuentes,2597,451,18,12,30,60.0%,1h
27002,1,[SWOU]RayZero,2597,469,18,15,33,54.5%,2h
27002,1,RaMz,2597,486,17,19,36,47.2%,2h
27002,2,Ironshoes,2597,303,15,18,33,45.5%,16m
27002,1,RaulRabbit,2597,491,14,17,31,45.2%,36m
27002,2,HenceThu,2597,294,11,12,23,47.8%,2h
27002,1,[JdV]Edarcox,2597,272,10,10,20,50.0%,1h
27002,1,[CL3V3R]DawsBoss,2597,368,10,11,21,47.6%,3h
27002,1,[M0lST]MeatyFlaps,2597,233,8,8,16,50.0%,2h
27002,3,IIIIIIIIIII,2597,205,8,10,18,44.4%,32m
27002,2,Trumptard,2597,198,7,6,13,53.8%,1h
27002,2,version,2597,124,5,2,7,71.4%,2h
27002,2,[HiNRG]HallsCamp,2597,142,5,4,9,55.6%,2h
27002,2,Heracles,2597,155,5,7,12,41.7%,2h
27002,2,Suh,2597,0,4,4,8,50.0%,2h
27002,2,Tomorrow,2597,32,3,2,5,60.0%,2h
27002,2,KomodoOdomok,2597,117,3,6,9,33.3%,3m
27002,2,Zamyk,2597,115,2,3,5,40.0%,40m
27002,3,pyroticaster,2597,0,2,3,5,40.0%,50m
27002,1,SkyPnD,2597,34,2,4,6,33.3%,44m
27002,2,edge,2597,0,1,0,1,100.0%,24m
27002,2,[LoShay]Zaun,2597,0,1,1,2,50.0%,20m
27002,2,Arc,2597,30,1,1,2,50.0%,2h
27002,2,theonendonly,2597,30,1,2,3,33.3%,20m
27002,1,EpicBioHacks,2597,0,0,1,1,0.0%,2h
27002,2,Cosmoz,2597,0,0,1,1,0.0%,2h
27002,2,HCovidH,2597,0,0,3,3,0.0%,2h
27002,2,[iMkS]WildWolf,2597,0,0,3,3,0.0%,10m
27033,3,ManonMasse,2596,1282,263,251,514,51.2%,3m
27033,1,Beanflicker,2596,1680,261,245,506,51.6%,2h
27033,2,Tegridad,2596,1281,93,71,164,56.7%,16m
27033,2,KingMaverick,2596,1134,53,43,96,55.2%,2h
27033,1,Imprezzive,2596,420,53,46,99,53.5%,2h
27033,3,ABabyKoala,2596,1221,48,45,93,51.6%,32m
27033,2,dreikot,2596,312,29,19,48,60.4%,15m
27033,1,PeterPan,2596,809,29,24,53,54.7%,40m
27033,1,Hendrix,2596,807,29,26,55,52.7%,2h
27033,1,BlackZe,2596,714,23,27,50,46.0%,16m
27033,2,[GOOOSE]tpafs,2596,447,18,9,27,66.7%,4m
27033,2,GAOTU,2596,467,17,19,36,47.2%,2h
27033,2,Deadlock,2596,311,13,6,19,68.4%,1h
27033,2,shagy,2596,333,13,12,25,52.0%,2h
27033,3,danray,2596,244,11,12,23,47.8%,11m
27033,1,TwizzeD,2596,326,10,14,24,41.7%,2m
27033,3,Dogmeat,2596,276,10,20,30,33.3%,28m
27033,2,Kiom,2596,216,8,8,16,50.0%,6m
27033,3,Julius,2596,149,7,6,13,53.8%,11m
27033,3,CptJSparrow,2596,0,2,3,5,40.0%,35m
27033,1,Desamunt,2596,42,1,8,9,11.1%,2h
27033,2,FatMonk,2596,0,0,1,1,0.0%,31m
27033,2,Stairs,2596,0,0,1,1,0.0%,12m
27033,2,xShadow,2596,0,0,1,1,0.0%,31m
27033,2,[WWP2]Bunsenburner,2596,0,0,1,1,0.0%,41m
27058,2,Zelph,2595,1479,161,170,331,48.6%,24m
27058,1,Skipow,2595,1637,144,135,279,51.6%,2h
27058,1,Hermione,2595,1152,40,41,81,49.4%,14m
27058,1,Risuvirus,2595,1014,39,39,78,50.0%,16m
27058,1,mathisfun,2595,929,35,31,66,53.0%,2h
27058,2,Jonnyquest,2595,782,31,36,67,46.3%,31m
27058,1,KillaWatts,2595,493,24,11,35,68.6%,2h
27058,2,Yomobrojoe,2595,497,23,16,39,59.0%,3h
27058,1,Redskull,2595,615,23,19,42,54.8%,2h
27058,3,[MTMOON]Paladin,2595,510,21,24,45,46.7%,1m
27058,2,PhanToM,2595,362,12,11,23,52.2%,2h
27058,2,DrEvil,2595,318,10,13,23,43.5%,16m
27058,2,Santiago,2595,192,6,1,7,85.7%,15m
27058,1,cybaix,2595,139,6,6,12,50.0%,4m
27058,1,DavidYeung,2595,152,6,9,15,40.0%,2h
27058,1,[xwx]Autumn,2595,177,5,7,12,41.7%,2h
27058,2,Firefrog,2595,109,2,2,4,50.0%,2h
27058,1,nicole,2595,109,2,5,7,28.6%,2h
27058,1,[KingSC]DarkSoul,2595,36,2,6,8,25.0%,2h
27058,1,RageMonster,2595,0,1,0,1,100.0%,9m
27058,2,Monkeyguy,2595,0,1,1,2,50.0%,45m
27058,2,[SL0]WreakinHavoc,2595,96,1,4,5,20.0%,1h
27058,2,IIIIIIIIIIII,2595,0,1,6,7,14.3%,2h
27058,1,[LOHs]Bortolindo,2595,32,1,8,9,11.1%,2h
27082,3,paggie,2594,1519,154,163,317,48.6%,31m
27082,2,Luciferous,2594,1136,150,147,297,50.5%,2h
27082,1,WIZVENGEANCE,2594,1466,141,140,281,50.2%,21m
27082,1,ShiftyHP,2594,1308,133,128,261,51.0%,2h
27082,1,Seth,2594,1649,69,71,140,49.3%,2h
27082,3,MiloLissn,2594,1332,67,81,148,45.3%,31m
27082,1,Mythos,2594,1114,54,51,105,51.4%,2h
27082,3,DvjNayko,2594,1163,49,53,102,48.0%,35m
27082,2,OptimusPrime,2594,961,38,36,74,51.4%,2h
27082,1,Jos,2594,749,32,33,65,49.2%,3h
27082,2,Turock,2594,478,18,12,30,60.0%,2h
27082,1,Dallas,2594,272,9,8,17,52.9%,46m
27082,2,DanielJMTB,2594,247,8,7,15,53.3%,2h
27082,2,bluntnstunt,2594,214,7,7,14,50.0%,42m
27082,2,Bobazoide,2594,140,6,5,11,54.5%,24m
27082,1,Din,2594,204,6,5,11,54.5%,2h
27082,1,oli,2594,134,6,6,12,50.0%,34m
27082,1,Koop,2594,235,5,8,13,38.5%,2h
27082,2,Sam,2594,90,4,1,5,80.0%,2h
27082,2,GoldenEEL,2594,139,4,5,9,44.4%,3m
27082,1,Kevin,2594,148,4,8,12,33.3%,2h
27082,2,RichardButte,2594,62,2,3,5,40.0%,2h
27082,2,xKhaosx,2594,0,1,0,1,100.0%,33m
27082,2,MrWizard,2594,0,1,1,2,50.0%,6m
27082,2,[SC2PH]rei,2594,0,0,1,1,0.0%,2h
27107,2,Forger,2593,1668,204,215,419,48.7%,27m
27107,1,OOOOOO,2593,1252,174,160,334,52.1%,11m
27107,1,TeslaCoils,2593,1682,145,142,287,50.5%,8m
27107,2,suarez,2593,1401,114,118,232,49.1%,21m
27107,1,EzGamer,2593,1597,99,103,202,49.0%,3h
27107,2,Zalnex,2593,1437,90,88,178,50.6%,24m
27107,1,Gedy,2593,683,59,51,110,53.6%,30m
27107,1,blink,2593,758,29,26,55,52.7%,19m
27107,2,Wutsherface,2593,630,23,20,43,53.5%,43m
27107,2,[CLVLY]uwuboy,2593,309,15,9,24,62.5%,2m
27107,2,Greygoo,2593,193,11,7,18,61.1%,2h
27107,2,[GRNrx]slurpdeznuts,2593,174,6,4,10,60.0%,17m
27107,2,goatkiller,2593,44,5,3,8,62.5%,34m
27107,3,[4L0k0]chokusan,2593,169,5,7,12,41.7%,1h
27107,1,Baba,2593,261,5,9,14,35.7%,9m
27107,3,Claudio,2593,0,2,3,5,40.0%,2h
27107,2,Isaku,2593,0,2,3,5,40.0%,15m
27107,1,Gruntex,2593,80,2,7,9,22.2%,2h
27107,2,[LPrusa]SaMprOXx,2593,0,1,0,1,100.0%,48m
27107,3,bart,2593,0,1,1,2,50.0%,23m
27107,1,[TGosuB]Senshikaze,2593,89,1,3,4,25.0%,31m
27107,2,ibenedict,2593,0,0,1,1,0.0%,2h
27107,3,rad,2593,0,0,1,1,0.0%,2h
27107,2,MarchyDQ,2593,0,0,1,1,0.0%,20m
27107,2,ratwesi,2593,0,0,2,2,0.0%,9m
27132,2,untouchable,2592,1538,173,178,351,49.3%,7m
27132,1,ssBsKEE,2592,1477,130,114,244,53.3%,24m
27132,1,Freemason,2592,1703,97,86,183,53.0%,2h
27132,1,Ekikouki,2592,674,79,63,142,55.6%,2h
27132,3,Rampage,2592,929,60,64,124,48.4%,14m
27132,1,Forger,2592,754,28,29,57,49.1%,2h
27132,1,Pieaces,2592,707,26,27,53,49.1%,16m
27132,1,Dyl,2592,705,23,25,48,47.9%,2h
27132,2,[SCROT]SMoney,2592,613,22,24,46,47.8%,3h
27132,1,MasdeM,2592,237,17,17,34,50.0%,24m
27132,1,SlowMonkey,2592,336,15,14,29,51.7%,14m
27132,2,Zercules,2592,324,14,14,28,50.0%,2h
27132,1,[TWL20]hoaZg,2592,373,13,12,25,52.0%,2h
27132,2,Vanipede,2592,306,12,10,22,54.5%,2h
27132,2,redbaron,2592,226,8,2,10,80.0%,2h
27132,2,IIIIIIIIIIII,2592,154,8,7,15,53.3%,15m
27132,3,[1131]Agnanum,2592,191,8,10,18,44.4%,1m
27132,2,teemojun,2592,228,7,3,10,70.0%,2h
27132,2,[xLgNx]walker,2592,118,5,2,7,71.4%,2h
27132,2,IsTheShadow,2592,176,5,7,12,41.7%,20m
27132,1,HandBanana,2592,95,3,4,7,42.9%,2m
27132,2,Renouf,2592,32,2,2,4,50.0%,2h
27132,2,ConfidentMop,2592,66,2,6,8,25.0%,2h
27132,1,Sparkzey,2592,80,2,8,10,20.0%,48m
27132,2,Daniel,2592,0,1,0,1,100.0%,9m
27132,1,Baiter,2592,0,1,0,1,100.0%,2h
27132,2,[OvG]Wempenaya,2592,0,1,0,1,100.0%,2h
27132,2,CheungCheung,2592,0,1,0,1,100.0%,2h
27132,2,largeDog,2592,0,0,2,2,0.0%,15m
27161,2,Ulgrim,2591,1616,211,202,413,51.1%,2h
27161,1,TonyBaloney,2591,1412,65,58,123,52.8%,33m
27161,2,AstroApollo,2591,870,64,55,119,53.8%,45m
27161,1,rayetran,2591,873,45,39,84,53.6%,2h
27161,2,SilkyJohnson,2591,441,30,21,51,58.8%,45m
27161,2,[JtMax]AssassinsHac,2591,561,21,18,39,53.8%,33m
27161,1,Theophili,2591,447,21,23,44,47.7%,19m
27161,2,[AbcCo]NITRAM,2591,382,17,10,27,63.0%,2h
27161,1,Gary,2591,223,17,14,31,54.8%,2m
27161,2,zJessez,2591,291,13,9,22,59.1%,1h
27161,2,[ILAGI]Tragic,2591,346,12,12,24,50.0%,16m
27161,1,zloy,2591,364,12,14,26,46.2%,2h
27161,2,TossOP,2591,198,11,0,11,100.0%,2h
27161,2,[NR6]ZEUS,2591,232,8,2,10,80.0%,2h
27161,1,NemV,2591,201,8,7,15,53.3%,14m
27161,2,Xulld,2591,114,5,5,10,50.0%,2h
27161,3,MyLord,2591,60,5,7,12,41.7%,33m
27161,2,[NastyB]zeroworld,2591,179,5,8,13,38.5%,9m
27161,3,Leverage,2591,0,3,2,5,60.0%,2h
27161,2,TrackPadHero,2591,92,3,2,5,60.0%,1h
27161,2,[LOHd]NeOJbenz,2591,36,2,2,4,50.0%,32m
27161,2,doomarang,2591,0,1,0,1,100.0%,6m
27161,2,nohair,2591,0,1,0,1,100.0%,39m
27161,1,greenVomit,2591,38,1,4,5,20.0%,2h
27161,2,zedd,2591,0,0,1,1,0.0%,2h
27161,3,NewNate,2591,0,0,1,1,0.0%,36m
27161,2,randomzebra,2591,0,0,1,1,0.0%,3h
27161,1,InvertedVeer,2591,0,0,2,2,0.0%,2h
27161,3,[JUC2TZ]KryptoniK,2591,0,0,2,2,0.0%,1h
27161,2,raulerg,2591,0,0,2,2,0.0%,6m
27161,2,ernesto,2591,0,0,3,3,0.0%,2h
27161,2,Itolav,2591,0,0,4,4,0.0%,27m
27193,2,wolfcasl,2590,1439,107,111,218,49.1%,39m
27193,1,SGTSkywalker,2590,1530,57,54,111,51.4%,2h
27193,1,[HFWJC]FJAMBER,2590,1078,40,38,78,51.3%,2h
27193,1,[iMPG]LOCO,2590,858,34,33,67,50.7%,2h
27193,1,Alobar,2590,544,27,22,49,55.1%,3m
27193,1,JeezisShiva,2590,524,22,19,41,53.7%,19m
27193,1,Hue,2590,523,21,19,40,52.5%,15m
27193,2,PineSol,2590,386,14,15,29,48.3%,9m
27193,3,MrEpants,2590,332,13,11,24,54.2%,7m
27193,2,Change,2590,212,8,6,14,57.1%,1h
27193,2,zelothero,2590,160,5,12,17,29.4%,7m
27193,2,JUSTICE,2590,122,4,20,24,16.7%,50m
27193,2,Soljah,2590,58,3,2,5,60.0%,13m
27193,2,Adgor,2590,0,3,2,5,60.0%,2h
27193,3,[iKegel]Sebulba,2590,0,3,2,5,60.0%,2h
27193,2,[SWIGY]tRoLlFuX,2590,94,3,4,7,42.9%,2h
27193,1,JUGGERRNAUT,2590,102,2,2,4,50.0%,1h
27193,3,Traucochino,2590,0,2,3,5,40.0%,1h
27193,3,Necros,2590,0,2,4,6,33.3%,2h
27193,1,[PSYON]Maz,2590,0,2,4,6,33.3%,31m
27193,1,Walker,2590,0,2,4,6,33.3%,2h
27193,2,Pulzatio,2590,0,1,1,2,50.0%,39m
27193,2,Ice,2590,0,1,2,3,33.3%,3h
27193,2,Deller,2590,0,1,2,3,33.3%,31m
27193,2,[FFAA]Santorio,2590,32,1,4,5,20.0%,29m
27193,2,fluffhead,2590,0,0,1,1,0.0%,2h
27193,1,Rett,2590,0,0,1,1,0.0%,48m
27220,1,Crazyhorse,2589,1625,111,102,213,52.1%,2h
27220,1,Jose,2589,978,42,39,81,51.9%,22m
27220,3,[VRC]ChunchuMaru,2589,910,32,41,73,43.8%,19m
27220,1,vorian,2589,656,29,25,54,53.7%,47m
27220,3,clyde,2589,400,21,22,43,48.8%,11m
27220,2,HandiQuacked,2589,449,20,5,25,80.0%,42m
27220,2,[GOPERÚ]AZOPOTAMO,2589,516,20,16,36,55.6%,2h
27220,1,orlos,2589,579,18,22,40,45.0%,2h
27220,1,Gucci,2589,316,17,20,37,45.9%,1h
27220,3,nOObonator,2589,466,17,29,46,37.0%,30m
27220,2,Schwenck,2589,461,15,12,27,55.6%,2h
27220,2,Limnt,2589,284,11,11,22,50.0%,27m
27220,1,TheLesser,2589,330,10,12,22,45.5%,37m
27220,3,Alpha,2589,256,10,18,28,35.7%,38m
27220,1,BTomzzz,2589,248,9,10,19,47.4%,1m
27220,3,heftynomad,2589,133,7,11,18,38.9%,33m
27220,2,CapitalSky,2589,170,6,5,11,54.5%,2h
27220,2,NoOneNoName,2589,60,3,4,7,42.9%,31m
27220,2,Orimageddon,2589,58,2,1,3,66.7%,32m
27220,3,JIMBO,2589,0,2,1,3,66.7%,50m
27220,3,IlIIllIIllII,2589,0,2,3,5,40.0%,2h
27220,3,[1516]Spetsnaz,2589,0,2,3,5,40.0%,33m
27220,3,Red,2589,92,2,3,5,40.0%,36m
27220,2,Vox,2589,0,2,3,5,40.0%,31m
27220,2,MacroToss,2589,32,1,2,3,33.3%,43m
27220,1,isythebeast,2589,0,1,2,3,33.3%,2h
27220,3,BATMAN,2589,0,0,2,2,0.0%,1h
27247,3,rhino,2588,1469,180,173,353,51.0%,39m
27247,1,Wolf,2588,1433,136,136,272,50.0%,2h
27247,1,Rioku,2588,1075,131,126,257,51.0%,2h
27247,2,nescaltoddy,2588,1500,119,87,206,57.8%,1h
27247,1,HuevoSplash,2588,722,119,99,218,54.6%,16m
27247,1,[TTSP]NotaLok,2588,1601,79,75,154,51.3%,44m
27247,2,Marius,2588,716,48,41,89,53.9%,2h
27247,1,Panda,2588,730,35,36,71,49.3%,2h
27247,2,Alvaro,2588,617,32,34,66,48.5%,19m
27247,2,yourdaddy,2588,736,31,27,58,53.4%,2h
27247,2,Raptor,2588,585,28,16,44,63.6%,2h
27247,2,Nicorus,2588,268,12,17,29,41.4%,2h
27247,3,Shakuras,2588,303,11,20,31,35.5%,16m
27247,1,Thugonomics,2588,217,9,10,19,47.4%,2h
27247,1,Tekno,2588,267,9,10,19,47.4%,2h
27247,1,MRX,2588,260,8,8,16,50.0%,2h
27247,2,VERGAtron,2588,130,6,5,11,54.5%,20m
27247,2,Kanzen,2588,170,6,7,13,46.2%,22m
27247,2,WILLIAMS,2588,160,5,4,9,55.6%,1h
27247,1,Jeremy,2588,148,5,8,13,38.5%,19m
27247,1,[PONCH]ErikEstrada,2588,36,3,6,9,33.3%,47m
27247,3,Badbaby,2588,0,2,2,4,50.0%,41m
27247,2,DERGON,2588,0,2,3,5,40.0%,2h
27247,3,Colby,2588,0,2,3,5,40.0%,1h
27247,1,Diantre,2588,68,2,5,7,28.6%,2h
27247,2,lololololol,2588,0,1,0,1,100.0%,38m
27247,2,MARCHBANK,2588,0,1,0,1,100.0%,2h
27247,3,[xGGTx]Grim,2588,0,1,2,3,33.3%,2h
27247,2,rúnico,2588,30,1,3,4,25.0%,2h
27247,2,HEXKamiKaze,2588,0,0,1,1,0.0%,1h
27247,3,Slid,2588,0,0,1,1,0.0%,2h
27278,3,PieRun,2587,1470,123,124,247,49.8%,19m
27278,3,[SGsc18]ManyFeathers,2587,527,82,77,159,51.6%,35m
27278,3,[MEP]hunterofomeg,2587,760,76,83,159,47.8%,21m
27278,1,Dnysc,2587,889,62,62,124,50.0%,2m
27278,2,hoodhose,2587,1186,46,40,86,53.5%,1h
27278,1,[SANGRE]Arcangel,2587,1299,46,47,93,49.5%,2h
27278,1,[nieBla]ELJAJAS,2587,747,31,23,54,57.4%,36m
27278,3,PorkUnit,2587,789,28,35,63,44.4%,34m
27278,2,DAVID,2587,555,25,22,47,53.2%,43m
27278,1,[Calx]Gravity,2587,700,24,27,51,47.1%,2h
27278,1,FroPenguin,2587,462,15,20,35,42.9%,48m
27278,3,jelipe,2587,284,14,24,38,36.8%,17m
27278,2,[ph0t0n]MinuteHand,2587,315,12,13,25,48.0%,32m
27278,1,JordyJoesta,2587,294,10,10,20,50.0%,20m
27278,1,TheExecutor,2587,314,9,14,23,39.1%,19m
27278,1,Jono,2587,210,8,11,19,42.1%,33m
27278,1,BronzeLegend,2587,200,7,8,15,46.7%,40m
27278,1,Traus,2587,0,5,4,9,55.6%,6m
27278,1,Foladan,2587,168,5,7,12,41.7%,33m
27278,3,Gentou,2587,118,4,6,10,40.0%,12m
27278,1,MajestiChaos,2587,131,4,8,12,33.3%,42m
27278,2,[Gasai]Yuno,2587,64,3,2,5,60.0%,3h
27278,2,[REPORT]PwROvRwLmNg,2587,0,3,2,5,60.0%,15m
27278,3,soulbinder,2587,58,3,13,16,18.8%,27m
27278,1,Krush,2587,91,2,3,5,40.0%,2h
27278,3,Gilthane,2587,0,2,3,5,40.0%,34m
27278,3,SacForRansom,2587,0,1,1,2,50.0%,2m
27278,2,GuamBum,2587,0,1,2,3,33.3%,2h
27278,2,Phi,2587,30,1,3,4,25.0%,15m
27278,2,Kaligula,2587,30,1,4,5,20.0%,2h
27278,1,[LevelR]StonedCat,2587,38,1,7,8,12.5%,16m
27278,2,[RStarP]Chubakka,2587,0,0,1,1,0.0%,2h
27278,2,Boot,2587,0,0,1,1,0.0%,2h
27278,1,antonioFK,2587,0,0,1,1,0.0%,2h
27278,2,[ZTJ]mobuis,2587,0,0,2,2,0.0%,2h
27278,1,Elbuen,2587,0,0,6,6,0.0%,2h
27314,1,Owen,2586,985,46,35,81,56.8%,2h
27314,2,Tantrum,2586,180,21,10,31,67.7%,21m
27314,1,JaYHoO,2586,549,18,20,38,47.4%,41m
27314,1,[FMX]RoboSynth,2586,151,15,14,29,51.7%,2h
27314,2,Brent,2586,236,8,3,11,72.7%,39m
27314,2,[GRUMEC]Hades,2586,146,4,1,5,80.0%,43m
27314,1,ams,2586,0,4,2,6,66.7%,1h
27314,2,BTPaladin,2586,86,3,3,6,50.0%,2h
27314,2,Dragos,2586,30,3,4,7,42.9%,42m
27314,1,drakkarNOIR,2586,88,3,4,7,42.9%,26m
27314,2,ALLAHUAKVAR,2586,86,3,7,10,30.0%,3m
27314,3,[T1AM]KHOSH,2586,0,2,3,5,40.0%,2h
27314,2,Primordius,2586,62,2,4,6,33.3%,2h
27314,3,DivideByZerO,2586,0,2,4,6,33.3%,30m
27314,2,GoobJoob,2586,112,2,6,8,25.0%,31m
27314,2,RustyHelix,2586,0,1,2,3,33.3%,16m
27314,3,Zulkin,2586,0,1,4,5,20.0%,2h
27314,1,pip,2586,34,1,5,6,16.7%,2h
27314,2,bewm,2586,0,0,2,2,0.0%,24m
27333,3,mecanu,2585,1513,187,174,361,51.8%,9m
27333,1,dafayceee,2585,1377,132,119,251,52.6%,2h
27333,2,DeutschMark,2585,1167,51,46,97,52.6%,21m
27333,1,Gnikwoc,2585,811,44,41,85,51.8%,15m
27333,1,JohnConnor,2585,1235,42,44,86,48.8%,2h
27333,1,Briefs,2585,320,12,10,22,54.5%,2h
27333,1,Babyteeth,2585,404,12,16,28,42.9%,45m
27333,1,[Growl]Kjal,2585,342,11,15,26,42.3%,36m
27333,2,Nox,2585,242,9,8,17,52.9%,4m
27333,2,XRyotasX,2585,242,9,9,18,50.0%,2h
27333,1,MaJin,2585,134,5,3,8,62.5%,3h
27333,2,DarkRed,2585,62,5,9,14,35.7%,16m
27333,1,Tracer,2585,100,4,6,10,40.0%,21m
27333,1,Goonta,2585,106,4,9,13,30.8%,1h
27333,1,AzWraithz,2585,126,3,4,7,42.9%,47m
27333,1,Slappuku,2585,154,3,5,8,37.5%,40m
27333,2,[NYRwin]MuleFromMars,2585,62,2,1,3,66.7%,45m
27333,2,XtremeTSFran,2585,48,2,3,5,40.0%,3m
27333,1,LegoMan,2585,36,2,3,5,40.0%,44m
27333,3,[MNVN]Nanwan,2585,0,2,3,5,40.0%,2h
27333,3,Jadch,2585,0,0,1,1,0.0%,39m
27333,2,Dirotem,2585,0,0,1,1,0.0%,2h
27333,1,Inferno,2585,0,0,1,1,0.0%,2h
27333,2,Bobloblaw,2585,0,0,2,2,0.0%,9m
27357,1,Nekri,2584,1630,190,182,372,51.1%,2h
27357,2,Dethlich,2584,1528,150,144,294,51.0%,49m
27357,1,Ottogi,2584,1153,60,54,114,52.6%,34m
27357,2,[1943]zorro,2584,988,52,45,97,53.6%,2h
27357,2,SpecCop,2584,880,36,29,65,55.4%,3m
27357,2,sleazypnut,2584,846,33,34,67,49.3%,2h
27357,1,HerrKamerad,2584,571,20,19,39,51.3%,3h
27357,2,Alex,2584,588,20,20,40,50.0%,6m
27357,2,Garnet,2584,487,18,12,30,60.0%,31m
27357,1,[TWAS]ChopSuey,2584,370,17,18,35,48.6%,2h
27357,2,Dulala,2584,330,12,10,22,54.5%,2h
27357,2,[PCNTE]Jambalaya,2584,282,11,9,20,55.0%,33m
27357,2,ItachiUchiha,2584,280,10,5,15,66.7%,33m
27357,2,ttorrrr,2584,222,9,2,11,81.8%,2h
27357,1,VegaSky,2584,36,5,3,8,62.5%,1h
27357,2,seaworm,2584,114,3,5,8,37.5%,49m
27357,3,[idscom]LuuStuul,2584,93,3,5,8,37.5%,4m
27357,2,SENICH,2584,44,2,1,3,66.7%,2h
27357,2,dys,2584,30,2,2,4,50.0%,2h
27357,2,mejai,2584,60,2,2,4,50.0%,27m
27357,3,Nezzak,2584,0,2,3,5,40.0%,2h
27357,2,uFFo,2584,0,1,0,1,100.0%,47m
27357,1,GreenJacket,2584,0,1,1,2,50.0%,18m
27357,2,iooi,2584,0,0,1,1,0.0%,2h
27357,2,senoran,2584,0,0,3,3,0.0%,29m
27357,1,LacronoS,2584,0,0,4,4,0.0%,26m
27357,1,[s1]Zerafool,2584,0,0,5,5,0.0%,2h
27357,1,Pulse,2584,0,0,7,7,0.0%,2h
27385,1,NoObMove,2583,1392,322,313,635,50.7%,24m
27385,1,ToffyUK,2583,1684,182,178,360,50.6%,3h
27385,3,[MLPx]Suchomimus,2583,1547,179,168,347,51.6%,7m
27385,3,[EGx]Varitech,2583,1535,169,168,337,50.1%,12m
27385,3,[NorK]TheInnKeeper,2583,1212,99,105,204,48.5%,31m
27385,1,Supe,2583,576,39,30,69,56.5%,2h
27385,2,Quiroz,2583,608,22,18,40,55.0%,3m
27385,2,[nomame]brawgy,2583,582,20,20,40,50.0%,18m
27385,2,ToTheStars,2583,341,13,14,27,48.1%,2h
27385,1,Strajack,2583,342,12,15,27,44.4%,15m
27385,1,DaBi,2583,136,8,3,11,72.7%,2h
27385,1,Oarthodoxz,2583,244,8,11,19,42.1%,8m
27385,3,Heasimitore,2583,197,7,9,16,43.8%,32m
27385,1,Ham,2583,245,6,9,15,40.0%,2h
27385,2,IIIIIIIIIIII,2583,118,3,0,3,100.0%,2m
27385,2,Akmyn,2583,0,3,2,5,60.0%,2h
27385,2,[TGosuD]Beetlejuice,2583,32,2,1,3,66.7%,31m
27385,2,[BLN]SirWilliam,2583,58,2,2,4,50.0%,2h
27385,3,BluenoserGuy,2583,0,2,3,5,40.0%,2h
27385,3,[R3Ds]QtheKilla,2583,0,2,3,5,40.0%,2h
27385,2,DLCbimboXXX,2583,0,2,3,5,40.0%,29m
27385,2,BadNewsBears,2583,0,1,0,1,100.0%,2h
27385,2,DalekPrime,2583,0,1,1,2,50.0%,2h
27385,2,KBack,2583,30,1,1,2,50.0%,2h
27385,1,WolfJohnson,2583,88,1,6,7,14.3%,2h
27385,2,XiitOnXi,2583,30,1,6,7,14.3%,2h
27385,2,Ninja,2583,0,0,1,1,0.0%,31m
27385,2,RealGLife,2583,0,0,2,2,0.0%,39m
27385,1,[T1AM]Leo,2583,0,0,6,6,0.0%,2h
27414,1,River,2582,1548,221,229,450,49.1%,11m
27414,2,Brokn,2582,1385,180,160,340,52.9%,33m
27414,1,ProtossFS,2582,1571,147,123,270,54.4%,2h
27414,3,oooooooooooo,2582,787,118,114,232,50.9%,3m
27414,1,KGBeast,2582,831,66,60,126,52.4%,3h
27414,2,BlindPride,2582,954,40,30,70,57.1%,19m
27414,2,Monkeylord,2582,899,39,28,67,58.2%,2h
27414,2,turron,2582,403,28,14,42,66.7%,43m
27414,1,Vibb,2582,588,22,22,44,50.0%,2h
27414,1,LukeAdams,2582,632,22,22,44,50.0%,2h
27414,2,vvvscs,2582,276,16,6,22,72.7%,20m
27414,1,siggy,2582,411,13,14,27,48.1%,1h
27414,3,RAVENOUS,2582,410,13,22,35,37.1%,10m
27414,1,Teslon,2582,294,12,12,24,50.0%,6m
27414,1,uglykid,2582,412,12,18,30,40.0%,41m
27414,2,[FaIlen]FTWpoppy,2582,286,11,8,19,57.9%,1h
27414,1,FrankSinatra,2582,203,8,9,17,47.1%,42m
27414,1,somuch,2582,200,8,13,21,38.1%,2h
27414,1,Funhole,2582,172,6,5,11,54.5%,18m
27414,1,[DASUL]Eonixyn,2582,168,6,8,14,42.9%,2h
27414,2,[NctrnL]Ruptured,2582,148,5,6,11,45.5%,49m
27414,1,Tersy,2582,166,4,6,10,40.0%,3m
27414,2,Jlerms,2582,30,3,4,7,42.9%,2h
27414,3,Ehie,2582,0,3,4,7,42.9%,1m
27414,1,Nomisha,2582,108,3,8,11,27.3%,2h
27414,2,BlackObama,2582,30,2,0,2,100.0%,21m
27414,2,[Cullen]Alcatranz,2582,30,2,2,4,50.0%,19m
27414,2,[Best01]MaverickPerú,2582,60,2,4,6,33.3%,2h
27414,1,moondogg,2582,0,2,6,8,25.0%,2h
27414,1,Chocapick,2582,0,1,0,1,100.0%,2h
27414,1,Lightspectre,2582,0,1,3,4,25.0%,2h
27414,1,chucklez,2582,88,1,4,5,20.0%,2h
27414,2,SashaCoulter,2582,0,0,1,1,0.0%,13m
27414,2,THOTWHIPPER,2582,0,0,1,1,0.0%,2h
27448,1,[51H8]Jameson,2581,1499,247,239,486,50.8%,25m
27448,1,GzuL,2581,1272,112,110,222,50.5%,2h
27448,1,fryzie,2581,1187,91,87,178,51.1%,6m
27448,2,GaryPoolBoy,2581,1389,57,51,108,52.8%,39m
27448,2,PapaSmurf,2581,1049,53,19,72,73.6%,2h
27448,2,Masetín,2581,1185,52,36,88,59.1%,2h
27448,2,masterbeef,2581,1104,50,49,99,50.5%,19m
27448,1,[CqAce]AceAceAce,2581,657,47,43,90,52.2%,36m
27448,1,Nateychan,2581,1208,44,46,90,48.9%,24m
27448,1,moooilkshake,2581,572,27,24,51,52.9%,2h
27448,2,BoomerTown,2581,688,25,23,48,52.1%,21m
27448,2,Lemillon,2581,684,25,23,48,52.1%,2h
27448,1,OtticusRex,2581,500,18,20,38,47.4%,42m
27448,2,Arcannas,2581,348,11,9,20,55.0%,2h
27448,1,Infamousxft,2581,107,7,14,21,33.3%,19m
27448,2,LongShlong,2581,210,6,3,9,66.7%,2h
27448,2,[TWL20]drewzy,2581,210,6,4,10,60.0%,2h
27448,1,Perisma,2581,186,6,6,12,50.0%,2m
27448,2,OmarPeralta,2581,175,4,2,6,66.7%,2h
27448,2,frenetix,2581,124,4,6,10,40.0%,2h
27448,2,[KmKzs]Atecubanos,2581,40,4,6,10,40.0%,2h
27448,3,aKaMaikol,2581,0,2,3,5,40.0%,2h
27448,2,leviathan,2581,30,2,3,5,40.0%,24m
27448,2,Ramso,2581,0,2,3,5,40.0%,2h
27448,2,mna,2581,60,2,3,5,40.0%,48m
27448,2,Krelis,2581,92,2,4,6,33.3%,2h
27448,1,[Shang]Penamat,2581,88,2,5,7,28.6%,14m
27448,1,aje,2581,76,2,8,10,20.0%,2h
27448,2,CombatXXL,2581,0,1,0,1,100.0%,2h
27448,2,Asoloso,2581,0,1,0,1,100.0%,33m
27448,2,RPRCloaK,2581,30,1,2,3,33.3%,48m
27448,3,exL,2581,97,1,3,4,25.0%,35m
27448,2,[KerriS]Beyongsong,2581,30,1,4,5,20.0%,2h
27448,1,[0825]fittneszerg,2581,0,1,5,6,16.7%,2h
27448,3,[DRKESP]Jon,2581,38,1,6,7,14.3%,1h
27448,2,Vezon,2581,0,0,1,1,0.0%,19m
27448,2,infamous,2581,0,0,1,1,0.0%,29m
27448,2,[SC2PH]Deadtrooper,2581,0,0,1,1,0.0%,2h
27448,2,FreshDeli,2581,0,0,2,2,0.0%,2h
27448,1,Beerserkr,2581,0,0,3,3,0.0%,3h
27488,3,izzo,2580,1524,250,239,489,51.1%,2m
27488,1,STARK,2580,1373,139,131,270,51.5%,3h
27488,1,YOLOSWAGTRON,2580,1505,101,88,189,53.4%,16m
27488,1,Volc,2580,698,96,96,192,50.0%,41m
27488,1,EnriqueVPrz,2580,1401,74,75,149,49.7%,2h
27488,3,Joker,2580,910,48,47,95,50.5%,50m
27488,1,Slay,2580,916,34,36,70,48.6%,2h
27488,1,Baki,2580,950,33,34,67,49.3%,2h
27488,2,SaltLakers,2580,667,26,23,49,53.1%,2h
27488,2,MakeitRaynor,2580,434,25,11,36,69.4%,14m
27488,2,[Gh0sty]PsyDaddy,2580,570,24,14,38,63.2%,1h
27488,2,Madness,2580,379,20,4,24,83.3%,2h
27488,2,Powpoper,2580,416,16,14,30,53.3%,45m
27488,1,CaBeLLoSs,2580,448,15,17,32,46.9%,42m
27488,2,Dang,2580,233,12,9,21,57.1%,16m
27488,1,GamerGamer,2580,397,12,14,26,46.2%,25m
27488,2,[RULES]andyn,2580,234,8,6,14,57.1%,17m
27488,3,EmperorChan,2580,267,8,9,17,47.1%,2h
27488,2,[catcat]Anubis,2580,212,6,3,9,66.7%,21m
27488,3,Dale,2580,171,6,9,15,40.0%,6m
27488,1,[secta]ramadantix,2580,148,5,7,12,41.7%,3h
27488,2,[blacLM]SOS,2580,138,5,7,12,41.7%,31m
27488,1,Syrthe,2580,272,5,8,13,38.5%,16m
27488,1,GhostWhite,2580,140,3,7,10,30.0%,2m
27488,2,HKHK,2580,30,2,0,2,100.0%,14m
27488,2,[OEF]Justin,2580,0,2,2,4,50.0%,2h
27488,2,Nazgul,2580,30,2,3,5,40.0%,2h
27488,2,archon,2580,46,2,3,5,40.0%,2h
27488,1,ReDRuM,2580,0,2,4,6,33.3%,47m
27488,2,SirBlahDBlah,2580,30,1,1,2,50.0%,2h
27488,2,CrimnsonZ,2580,30,1,2,3,33.3%,2h
27488,1,jayden,2580,0,1,2,3,33.3%,14m
27488,3,Garrett,2580,42,1,3,4,25.0%,2h
27488,2,Bloodyhood,2580,0,0,1,1,0.0%,2h
27488,2,SiNine,2580,0,0,1,1,0.0%,2h
27488,2,DLT,2580,0,0,1,1,0.0%,2h
27488,2,Carpiquet,2580,0,0,1,1,0.0%,2h
27525,2,Jarclock,2579,1551,77,77,154,50.0%,2h
27525,3,darkline,2579,1086,52,55,107,48.6%,11m
27525,2,Franco,2579,601,30,6,36,83.3%,17m
27525,3,Cynkar,2579,554,20,22,42,47.6%,31m
27525,2,[ReVamp]Caronte,2579,425,17,10,27,63.0%,2h
27525,2,Reed,2579,281,11,5,16,68.8%,2h
27525,1,BAPHOMET,2579,215,9,8,17,52.9%,1h
27525,1,[BKaG]Drguau,2579,228,8,9,17,47.1%,2h
27525,1,Matabug,2579,244,8,9,17,47.1%,2m
27525,3,TheMagicMan,2579,151,7,6,13,53.8%,16m
27525,1,Augustinosdv,2579,48,6,6,12,50.0%,2h
27525,2,GKL,2579,184,6,7,13,46.2%,24m
27525,3,sparky,2579,121,5,3,8,62.5%,1h
27525,3,Wulf,2579,62,5,7,12,41.7%,2m
27525,3,Ethselion,2579,174,5,12,17,29.4%,11m
27525,2,RawbDoggy,2579,88,4,2,6,66.7%,2h
27525,2,ETdeVarginha,2579,86,4,3,7,57.1%,17m
27525,1,INTIMIDATOR,2579,162,4,6,10,40.0%,1h
27525,1,Chameleon,2579,92,2,1,3,66.7%,21m
27525,2,[Sc2F]ToaFolks,2579,66,2,2,4,50.0%,2h
27525,1,lesnah,2579,0,2,4,6,33.3%,3h
27525,1,Dafet,2579,0,2,4,6,33.3%,2h
27525,2,Kris,2579,0,1,0,1,100.0%,27m
27525,2,Rorinth,2579,36,1,1,2,50.0%,45m
27525,1,Leined,2579,48,1,1,2,50.0%,2h
27525,2,Saimon,2579,73,1,1,2,50.0%,45m
27525,2,[cluez]samuwel,2579,30,1,4,5,20.0%,1h
27525,3,Zhimiao,2579,0,1,4,5,20.0%,1h
27525,2,IIIIIIII,2579,0,0,1,1,0.0%,1h
27525,2,[DarkW]king,2579,0,0,2,2,0.0%,2h
27525,2,Duckii,2579,0,0,2,2,0.0%,2h
27525,2,boris,2579,0,0,2,2,0.0%,1h
27557,1,TwoStep,2578,1660,137,123,260,52.7%,3h
27557,2,ylac,2578,1280,48,46,94,51.1%,14m
27557,2,lookout,2578,758,43,40,83,51.8%,2h
27557,1,Stash,2578,848,35,34,69,50.7%,2h
27557,1,FrismFrasm,2578,476,27,31,58,46.6%,19m
27557,1,Hamots,2578,255,9,10,19,47.4%,2h
27557,2,Xenome,2578,204,7,3,10,70.0%,31m
27557,2,steve,2578,154,5,1,6,83.3%,17m
27557,3,GroutOut,2578,120,5,4,9,55.6%,1m
27557,2,Neon,2578,146,5,4,9,55.6%,2h
27557,2,Mrbaird,2578,172,5,6,11,45.5%,35m
27557,3,DRAKOSLAYER,2578,132,5,13,18,27.8%,33m
27557,1,CapRato,2578,108,4,6,10,40.0%,3h
27557,3,BigFeet,2578,132,4,16,20,20.0%,26m
27557,2,[αXLa]terreviento,2578,96,3,4,7,42.9%,31m
27557,2,Drock,2578,30,2,2,4,50.0%,4m
27557,2,Kinglonewolf,2578,0,2,3,5,40.0%,4m
27557,3,renoXed,2578,0,2,3,5,40.0%,1h
27557,3,Makavelius,2578,0,2,3,5,40.0%,2h
27557,2,[QOSQO]HarrYTM,2578,64,2,4,6,33.3%,35m
27557,1,[GAA20]DeathAngel,2578,38,2,4,6,33.3%,2h
27557,2,marcelo,2578,0,1,0,1,100.0%,2h
27557,1,dudeitsdan,2578,0,0,2,2,0.0%,2h
27557,1,ULTRATLC,2578,0,0,4,4,0.0%,2h
27581,3,BUZU,2577,1420,272,270,542,50.2%,22m
27581,3,Nitis,2577,1559,108,101,209,51.7%,35m
27581,1,Ord,2577,1668,102,93,195,52.3%,3h
27581,1,BlueFlame,2577,859,96,89,185,51.9%,2h
27581,1,TrumpLost,2577,908,35,37,72,48.6%,24m
27581,1,ArsMed,2577,831,29,32,61,47.5%,2h
27581,1,Madcat,2577,886,29,33,62,46.8%,22m
27581,1,Jugulator,2577,593,27,24,51,52.9%,2h
27581,1,OndaVital,2577,595,27,30,57,47.4%,2h
27581,1,shinohir,2577,778,27,30,57,47.4%,2h
27581,1,Jul,2577,588,20,20,40,50.0%,44m
27581,2,FrutillitA,2577,440,18,10,28,64.3%,2h
27581,2,geflügelt,2577,488,18,16,34,52.9%,16m
27581,2,XIPETOTEC,2577,328,12,11,23,52.2%,1h
27581,2,Kratthul,2577,302,11,11,22,50.0%,2h
27581,1,[OGSKNK]Jodajr,2577,295,10,11,21,47.6%,26m
27581,2,DAKTARI,2577,278,10,12,22,45.5%,2h
27581,2,Rayford,2577,220,8,9,17,47.1%,1h
27581,2,TúpacPushaq,2577,186,7,7,14,50.0%,3h
27581,1,GiantsBane,2577,150,5,9,14,35.7%,2m
27581,2,[SCboys]Imagination,2577,122,4,6,10,40.0%,17m
27581,3,Daltonius,2577,42,3,4,7,42.9%,50m
27581,1,heeyupchung,2577,64,3,7,10,30.0%,45m
27581,2,MrHush,2577,30,2,0,2,100.0%,2h
27581,2,Mulakh,2577,62,2,3,5,40.0%,3m
27581,2,CAT,2577,60,2,3,5,40.0%,33m
27581,2,vicieta,2577,0,2,3,5,40.0%,2h
27581,2,Archer,2577,30,1,3,4,25.0%,2h
27581,2,DerPadawan,2577,30,1,3,4,25.0%,2h
27581,2,darkstar,2577,0,0,1,1,0.0%,3h
27581,2,unuuna,2577,0,0,1,1,0.0%,3h
27581,2,Visionz,2577,0,0,1,1,0.0%,2h
27581,3,fernando,2577,0,0,2,2,0.0%,2m
27614,1,[Y4NG20]Zaider,2576,1684,207,207,414,50.0%,37m
27614,1,[C32]OzLonghorn,2576,1540,85,71,156,54.5%,2h
27614,1,[Ash3s]Carlangas,2576,857,34,32,66,51.5%,2h
27614,2,CRiXA,2576,656,25,21,46,54.3%,1h
27614,2,MagicMan,2576,363,14,6,20,70.0%,35m
27614,1,dinochap,2576,284,12,14,26,46.2%,2h
27614,1,[LowMen]Kalvinx,2576,240,9,10,19,47.4%,2h
27614,2,NEO,2576,188,5,4,9,55.6%,2h
27614,2,TeamChatan,2576,176,5,10,15,33.3%,2h
27614,3,bobby,2576,0,4,1,5,80.0%,2m
27614,1,IIIIIII,2576,97,4,4,8,50.0%,22m
27614,2,Gumii,2576,88,3,3,6,50.0%,1h
27614,3,[SORSC]Beto,2576,0,3,3,6,50.0%,2h
27614,2,Jumnag,2576,146,3,4,7,42.9%,2h
27614,2,Paradonian,2576,0,2,3,5,40.0%,2h
27614,2,Wizzleli,2576,0,1,0,1,100.0%,2h
27614,2,Lehzee,2576,0,1,0,1,100.0%,2h
27614,2,Npc,2576,30,1,1,2,50.0%,10m
27614,1,TheElite,2576,0,1,5,6,16.7%,2h
27614,2,killrbee,2576,0,0,1,1,0.0%,1h
27614,2,ViolentFlame,2576,0,0,1,1,0.0%,1h
27614,2,[awa666]GsA,2576,0,0,3,3,0.0%,1h
27614,1,[xlVlen]Xavier,2576,0,0,5,5,0.0%,47m
27637,2,Shade,2575,1310,198,178,376,52.7%,2h
27637,1,GrassTree,2575,1645,182,196,378,48.1%,8m
27637,2,MuddyWauters,2575,1601,137,120,257,53.3%,17m
27637,2,BenY,2575,1458,102,116,218,46.8%,24m
27637,3,DralaFi,2575,1010,93,80,173,53.8%,28m
27637,2,Tuzain,2575,1197,90,71,161,55.9%,2h
27637,2,[MBPS]manbearpig,2575,1317,54,44,98,55.1%,2h
27637,3,WhySoHot,2575,463,22,27,49,44.9%,37m
27637,2,Hatski,2575,334,12,12,24,50.0%,17m
27637,2,Leonardo,2575,262,10,8,18,55.6%,2h
27637,2,PsychoMatrix,2575,263,9,6,15,60.0%,32m
27637,3,Hellder,2575,226,9,14,23,39.1%,40m
27637,2,lookatall,2575,222,7,7,14,50.0%,2h
27637,2,[LY0]ELSULTAN,2575,185,6,4,10,60.0%,2h
27637,1,drago,2575,58,4,5,9,44.4%,2h
27637,2,[HBB]DiorGalore,2575,137,4,6,10,40.0%,16m
27637,2,Darkzero,2575,118,4,8,12,33.3%,2h
27637,2,NeVeRMiND,2575,108,3,1,4,75.0%,19m
27637,3,[PZ]Ross,2575,42,3,4,7,42.9%,34m
27637,2,MilesDavis,2575,69,3,4,7,42.9%,3m
27637,2,QuackDragon,2575,95,3,5,8,37.5%,2h
27637,2,[QMS]TRILL,2575,30,2,1,3,66.7%,2h
27637,2,FishFry,2575,0,2,5,7,28.6%,2h
27637,1,DiceRoll,2575,40,2,7,9,22.2%,1h
27637,2,Jenga,2575,0,1,4,5,20.0%,2h
27637,2,[Forsa]claudg,2575,0,0,1,1,0.0%,2h
27637,2,clifor,2575,0,0,1,1,0.0%,2h
27637,2,PANDAIUR,2575,0,0,2,2,0.0%,2h
27637,2,waikeong,2575,0,0,2,2,0.0%,2h
27666,2,SteveS,2574,1391,128,112,240,53.3%,49m
27666,2,richyqtqt,2574,1583,128,112,240,53.3%,45m
27666,1,xxvii,2574,662,84,73,157,53.5%,2h
27666,2,[AQP4]OPTIMUS,2574,1127,69,65,134,51.5%,10m
27666,3,Tabender,2574,845,41,46,87,47.1%,3m
27666,2,[4aRaza]Koagulo,2574,586,24,13,37,64.9%,31m
27666,1,smellyfeet,2574,435,17,17,34,50.0%,2h
27666,2,Muaygor,2574,434,17,18,35,48.6%,3m
27666,1,KINGDANK,2574,315,12,11,23,52.2%,25m
27666,1,[SYNDCT]Jongsongs,2574,386,11,17,28,39.3%,2h
27666,2,Nwpmen,2574,218,9,6,15,60.0%,18m
27666,1,MedApolopolo,2574,194,9,8,17,52.9%,37m
27666,1,Evelitemp,2574,122,7,12,19,36.8%,9m
27666,2,[cxzczx]StaticToss,2574,122,5,5,10,50.0%,2h
27666,2,GooseKeeper,2574,116,4,4,8,50.0%,30m
27666,2,[M1A5]Xavier,2574,0,3,2,5,60.0%,21m
27666,3,[C0NC1L]Cabbage,2574,32,3,4,7,42.9%,26m
27666,3,Herodot,2574,122,3,5,8,37.5%,1h
27666,2,StarLight,2574,0,2,3,5,40.0%,2h
27666,3,darkdan,2574,97,2,4,6,33.3%,2h
27666,3,Fazootle,2574,0,1,0,1,100.0%,42m
27666,2,connectfour,2574,0,1,0,1,100.0%,2h
27666,2,WHYerenWHY,2574,0,1,1,2,50.0%,49m
27666,2,Croat,2574,32,1,4,5,20.0%,2h
27666,2,Vudoo,2574,0,0,1,1,0.0%,3h
27666,2,DarkTalon,2574,0,0,1,1,0.0%,43m
27692,3,balduvian,2573,1563,224,223,447,50.1%,50m
27692,3,oxne,2573,644,62,32,94,66.0%,12m
27692,2,[Pharoh]Daredevil,2573,645,24,20,44,54.5%,33m
27692,2,satyamDaBest,2573,320,20,19,39,51.3%,3m
27692,2,rubbersponge,2573,376,16,13,29,55.2%,19m
27692,1,Swifty,2573,364,15,15,30,50.0%,2h
27692,2,[BLHL]Iamcute,2573,302,10,8,18,55.6%,33m
27692,1,maxamus,2573,142,5,8,13,38.5%,20m
27692,2,ToXic,2573,86,4,2,6,66.7%,2h
27692,2,[BCBP5]ZeroTM,2573,0,3,2,5,60.0%,2h
27692,1,Dago,2573,89,3,3,6,50.0%,2h
27692,3,KillaCajun,2573,34,3,4,7,42.9%,1h
27692,3,Ngulu,2573,40,3,5,8,37.5%,41m
27692,2,WOLVERINE,2573,0,3,6,9,33.3%,31m
27692,3,[BRAPX]llllllllllll,2573,0,2,2,4,50.0%,24m
27692,2,Ruckus,2573,38,2,2,4,50.0%,3h
27692,2,YouCanWin,2573,30,2,3,5,40.0%,3m
27692,3,Zilo,2573,0,2,3,5,40.0%,2h
27692,3,niveK,2573,0,2,4,6,33.3%,10m
27692,2,Mike,2573,0,1,1,2,50.0%,3h
27692,2,OutlawStar,2573,0,1,2,3,33.3%,2h
27692,2,Mat,2573,88,1,3,4,25.0%,2h
27692,2,LilloSucks,2573,0,0,1,1,0.0%,30m
27692,2,oibr,2573,0,0,1,1,0.0%,3h
27692,2,[EseNcE]BERZERKER,2573,0,0,3,3,0.0%,20m
27717,1,[LOHe]blargon,2572,1590,327,308,635,51.5%,2h
27717,1,RolanGab,2572,1662,223,220,443,50.3%,2h
27717,1,Nomad,2572,1528,102,99,201,50.7%,45m
27717,2,dictator,2572,969,47,46,93,50.5%,1h
27717,2,Cruss,2572,572,41,21,62,66.1%,30m
27717,1,Artorias,2572,957,39,38,77,50.6%,33m
27717,2,SATURNOvO,2572,589,28,21,49,57.1%,21m
27717,2,TayzzerLord,2572,620,24,23,47,51.1%,2h
27717,1,Legacy,2572,620,19,24,43,44.2%,19m
27717,2,SwampDonkey,2572,454,18,15,33,54.5%,43m
27717,1,OmegaRed,2572,318,15,22,37,40.5%,19m
27717,2,Mantou,2572,237,12,8,20,60.0%,2h
27717,2,guts,2572,290,11,5,16,68.8%,9m
27717,2,TrumGaVN,2572,216,9,4,13,69.2%,2h
27717,2,Demonsgate,2572,226,8,8,16,50.0%,44m
27717,2,[SWOU]RITMO,2572,168,7,5,12,58.3%,34m
27717,3,dounut,2572,161,7,9,16,43.8%,46m
27717,1,llllllllllll,2572,248,7,16,23,30.4%,2h
27717,2,AverageJoe,2572,0,4,1,5,80.0%,2h
27717,2,aresel,2572,141,4,2,6,66.7%,2h
27717,2,PorkJaw,2572,114,4,3,7,57.1%,2h
27717,2,star,2572,120,4,6,10,40.0%,1h
27717,1,ZLog,2572,175,4,8,12,33.3%,2h
27717,3,kaiser,2572,0,3,2,5,60.0%,2h
27717,2,Deathknight,2572,92,3,4,7,42.9%,31m
27717,3,Barcode,2572,0,2,3,5,40.0%,2h
27717,3,BigMike,2572,0,1,0,1,100.0%,2h
27717,2,logikk,2572,30,1,2,3,33.3%,18m
27717,1,[Viola]Zyreath,2572,0,1,3,4,25.0%,25m
27717,2,PizziaRolls,2572,0,0,3,3,0.0%,2h
27747,1,AvatarDevil,2571,1506,161,139,300,53.7%,21m
27747,2,unKempt,2571,1617,92,78,170,54.1%,25m
27747,1,IIIIIIIIIIII,2571,807,73,52,125,58.4%,16m
27747,1,[PAWG]Snakeman,2571,566,25,24,49,51.0%,3h
27747,1,[TWRKN]Narocku,2571,122,20,9,29,69.0%,2m
27747,2,WarMachine,2571,508,20,13,33,60.6%,2h
27747,2,Rowend,2571,514,19,24,43,44.2%,20m
27747,2,chaos,2571,404,15,14,29,51.7%,33m
27747,1,[GOPERÚ]WARG,2571,436,14,16,30,46.7%,2h
27747,1,[eWolve]Stahtwo,2571,408,13,14,27,48.1%,34m
27747,2,Kahuna,2571,280,13,15,28,46.4%,19m
27747,2,Uppercut,2571,280,10,6,16,62.5%,2h
27747,1,MeatSalad,2571,340,10,14,24,41.7%,41m
27747,2,Pepinbombin,2571,196,8,5,13,61.5%,1h
27747,2,War,2571,122,7,10,17,41.2%,22m
27747,2,Serral,2571,178,6,8,14,42.9%,2h
27747,2,Aiur,2571,186,5,3,8,62.5%,2h
27747,3,Loop,2571,30,5,4,9,55.6%,35m
27747,3,RufusFenriz,2571,92,5,9,14,35.7%,11m
27747,2,[Grills]Ffgehrke,2571,113,4,5,9,44.4%,2h
27747,2,Loxik,2571,58,3,1,4,75.0%,17m
27747,2,Ukraine,2571,86,3,2,5,60.0%,2h
27747,1,Pheonix,2571,88,3,4,7,42.9%,21m
27747,2,[O215]Typhaerion,2571,36,2,4,6,33.3%,1h
27747,1,Arkelf,2571,0,2,4,6,33.3%,21m
27747,1,Mathblasta,2571,80,2,7,9,22.2%,16m
27747,2,Divinejas,2571,0,1,0,1,100.0%,2h
27747,1,PolyPslinger,2571,73,1,3,4,25.0%,2h
27747,2,israelsoto,2571,42,1,5,6,16.7%,2h
27747,1,Lopikong,2571,18,1,6,7,14.3%,3h
27747,2,TurdFerguson,2571,0,0,1,1,0.0%,2h
27747,2,elbartofake,2571,0,0,2,2,0.0%,2h
27779,1,NikoCrow,2570,1529,305,292,597,51.1%,2h
27779,1,MooSe,2570,1677,224,216,440,50.9%,2h
27779,1,[WAGWAN]NYAAEHHH,2570,1005,78,78,156,50.0%,2h
27779,2,[H0D0R]NannerBeanz,2570,1407,53,60,113,46.9%,2m
27779,1,Lydious,2570,1352,50,50,100,50.0%,2h
27779,2,Almost,2570,625,26,15,41,63.4%,2h
27779,1,Druggy,2570,461,16,18,34,47.1%,3h
27779,2,sinbee,2570,414,16,18,34,47.1%,26m
27779,2,Kremer,2570,191,8,12,20,40.0%,45m
27779,1,TwinkyIsHere,2570,172,7,13,20,35.0%,33m
27779,1,[diaman]DjembZone,2570,136,5,8,13,38.5%,2h
27779,3,[DGotO]Grizzslays,2570,94,5,9,14,35.7%,36m
27779,1,Moroboshi,2570,154,5,12,17,29.4%,2h
27779,2,[VCE]begopashibal,2570,60,4,4,8,50.0%,1h
27779,2,Sterth,2570,97,4,6,10,40.0%,34m
27779,2,Nivrass,2570,0,3,2,5,60.0%,39m
27779,2,TeachMe,2570,30,2,0,2,100.0%,2h
27779,2,[danima]ryry,2570,0,2,3,5,40.0%,17m
27779,2,[AIRBAG]diggz,2570,0,2,3,5,40.0%,2h
27779,2,[MLKMEN]saweder,2570,30,2,4,6,33.3%,16m
27779,2,Silentdead,2570,0,2,5,7,28.6%,2h
27779,3,sheaeat,2570,0,1,0,1,100.0%,34m
27779,1,Edgar,2570,40,1,6,7,14.3%,3h
27779,2,Silas,2570,0,0,1,1,0.0%,30m
27779,2,[LgnTDS]Chester,2570,0,0,1,1,0.0%,6m
27779,2,BlackFish,2570,0,0,2,2,0.0%,2h
27805,1,atlbraves,2569,1496,250,227,477,52.4%,26m
27805,1,KraKenetic,2569,1616,239,241,480,49.8%,25m
27805,2,Emperor,2569,1549,162,160,322,50.3%,21m
27805,1,ready,2569,1438,134,130,264,50.8%,34m
27805,1,[UKNOME]QuiRepublic,2569,653,54,50,104,51.9%,2h
27805,2,MMRGiver,2569,903,39,26,65,60.0%,2h
27805,1,[Po0pY]Assadar,2569,899,39,39,78,50.0%,44m
27805,3,Cros,2569,958,38,42,80,47.5%,22m
27805,2,[STDnbs]Cooleo,2569,466,17,16,33,51.5%,2h
27805,1,Strider,2569,289,9,4,13,69.2%,38m
27805,1,thePhoenix,2569,270,8,13,21,38.1%,2h
27805,1,JunTheGoon,2569,154,7,6,13,53.8%,33m
27805,1,Ares,2569,142,5,4,9,55.6%,2h
27805,1,Sandéconné,2569,166,5,12,17,29.4%,2h
27805,2,[SSC]DeepWade,2569,30,4,3,7,57.1%,2h
27805,1,[GyB]urielcarlos,2569,96,3,3,6,50.0%,2h
27805,2,LeBronzeAims,2569,60,2,2,4,50.0%,3h
27805,2,DVoid,2569,0,2,2,4,50.0%,2h
27805,3,[fUUL]EthanolMike,2569,0,1,0,1,100.0%,6m
27805,2,[PCAKE]InFaMouS,2569,0,1,1,2,50.0%,1h
27805,1,Dngercarrot,2569,0,1,4,5,20.0%,2h
27805,2,[HDOG]Ephaestus,2569,0,0,1,1,0.0%,4m
27805,2,[SHCORP]starhunter,2569,0,0,1,1,0.0%,31m
27805,1,Mauri,2569,0,0,1,1,0.0%,2h
27829,1,Alexsomer,2568,1582,85,79,164,51.8%,2h
27829,1,GOLDENBOY,2568,1410,58,51,109,53.2%,2h
27829,2,SaltyDave,2568,1050,43,40,83,51.8%,17m
27829,1,rexx,2568,796,30,28,58,51.7%,47m
27829,2,GotGates,2568,571,25,21,46,54.3%,2h
27829,1,Kellen,2568,713,24,25,49,49.0%,15m
27829,2,Vorta,2568,511,22,20,42,52.4%,2h
27829,2,Greatesgta,2568,568,21,25,46,45.7%,46m
27829,2,Billberto,2568,428,19,11,30,63.3%,10m
27829,2,DogBearPig,2568,139,15,12,27,55.6%,49m
27829,2,Drugo,2568,258,9,7,16,56.2%,16m
27829,1,Hindrance,2568,305,8,8,16,50.0%,1h
27829,1,[VRC]ChuquiMaster,2568,289,8,10,18,44.4%,3h
27829,1,AlleinAllein,2568,144,6,9,15,40.0%,33m
27829,2,Hopital,2568,155,5,7,12,41.7%,16m
27829,3,Vitaruto,2568,155,4,4,8,50.0%,4m
27829,2,WzLang,2568,125,4,6,10,40.0%,22m
27829,2,BeBop,2568,46,3,5,8,37.5%,2h
27829,1,[ktkzs]XycoDelics,2568,145,3,6,9,33.3%,2h
27829,2,TARS,2568,30,2,1,3,66.7%,2h
27829,3,LittleLlama,2568,0,2,3,5,40.0%,10m
27829,3,Strub,2568,0,2,4,6,33.3%,25m
27829,2,harogorgeous,2568,0,1,0,1,100.0%,2h
27829,2,[MAQTAS]XCAR,2568,0,1,1,2,50.0%,34m
27829,2,WneveEsser,2568,30,1,2,3,33.3%,3m
27829,2,sixxtynein,2568,0,0,1,1,0.0%,2h
27829,2,Huevito,2568,0,0,1,1,0.0%,1h
27829,3,gilderjajaxd,2568,0,0,1,1,0.0%,27m
27829,3,namaste,2568,0,0,1,1,0.0%,14m
27829,2,Carlos,2568,0,0,2,2,0.0%,32m
27829,2,Mainxenocide,2568,0,0,2,2,0.0%,2h
27860,1,vitaminbf,2567,586,74,75,149,49.7%,2h
27860,3,Moikano,2567,1501,70,70,140,50.0%,28m
27860,2,[TFTG]Heven,2567,1021,47,30,77,61.0%,2h
27860,3,[LQV]Dalabaya,2567,735,46,47,93,49.5%,38m
27860,2,[CrazyC]Antaury,2567,830,44,20,64,68.8%,39m
27860,1,Smacko,2567,738,28,27,55,50.9%,4m
27860,3,[QcScT]BilL,2567,628,22,36,58,37.9%,32m
27860,2,darthawsome,2567,331,16,13,29,55.2%,43m
27860,2,ZBLade,2567,420,15,11,26,57.7%,2h
27860,1,DaVincci,2567,189,13,16,29,44.8%,19m
27860,1,[cluez]iminyourbase,2567,354,12,11,23,52.2%,34m
27860,2,[TRASHH]Beowolf,2567,257,11,4,15,73.3%,31m
27860,2,BrainMachine,2567,228,9,2,11,81.8%,2h
27860,3,Ragna,2567,256,8,21,29,27.6%,21m
27860,2,Pyloski,2567,146,5,7,12,41.7%,31m
27860,1,Lustrous,2567,0,2,5,7,28.6%,2h
27860,1,Havoc,2567,60,2,8,10,20.0%,2h
27860,1,zzViruzzzz,2567,0,1,3,4,25.0%,2h
27860,3,LOLZNGIGGLES,2567,0,1,4,5,20.0%,1h
27860,1,TheWizard,2567,32,1,4,5,20.0%,1h
27860,2,Eeks,2567,0,0,1,1,0.0%,2h
27860,2,Varum,2567,0,0,1,1,0.0%,17m
27882,1,chris,2566,1677,641,636,1277,50.2%,2h
27882,1,slorg,2566,1603,225,213,438,51.4%,26m
27882,3,ShanYangII,2566,1304,209,211,420,49.8%,50m
27882,1,Billoman,2566,1445,159,159,318,50.0%,2h
27882,1,Splash,2566,1012,68,52,120,56.7%,4m
27882,3,GaBo,2566,1539,66,64,130,50.8%,50m
27882,1,[XpKAc]naiser,2566,1456,55,59,114,48.2%,42m
27882,1,[NM8]Shmuck,2566,612,21,26,47,44.7%,17m
27882,1,Rampage,2566,388,16,14,30,53.3%,2h
27882,2,sanz,2566,347,14,6,20,70.0%,2h
27882,2,Spinoza,2566,263,9,14,23,39.1%,1h
27882,2,Legacybacon,2566,174,7,4,11,63.6%,2h
27882,2,VTrider,2566,253,7,6,13,53.8%,2h
27882,1,WindlessWit,2566,275,6,6,12,50.0%,24m
27882,3,ElHombre,2566,124,5,15,20,25.0%,34m
27882,1,tomthegreat,2566,68,4,6,10,40.0%,21m
27882,2,[dodgy]TorpicalFish,2566,0,3,3,6,50.0%,49m
27882,3,bluewhale,2566,147,3,11,14,21.4%,26m
27882,3,[SHPK]OPticSQuare,2566,0,1,0,1,100.0%,23m
27882,1,MisMish,2566,0,1,4,5,20.0%,3h
27882,1,FinnMB,2566,0,0,1,1,0.0%,39m
27882,1,[NeRB]Chuk,2566,0,0,2,2,0.0%,2h
27904,3,AwesomeShot,2565,1391,81,86,167,48.5%,31m
27904,2,BrawlingBear,2565,1352,66,53,119,55.5%,16m
27904,2,StarSlayer,2565,1143,61,49,110,55.5%,31m
27904,3,Mapache,2565,1178,44,47,91,48.4%,15m
27904,3,NorthStar,2565,408,35,41,76,46.1%,11m
27904,1,IIIIIIII,2565,483,17,19,36,47.2%,2h
27904,1,Acrimonious,2565,321,11,11,22,50.0%,31m
27904,2,[VM]shiro,2565,254,9,8,17,52.9%,3m
27904,2,SmeagleRoots,2565,152,8,12,20,40.0%,9m
27904,2,Alpacalypse,2565,198,7,3,10,70.0%,31m
27904,2,EricL,2565,93,7,6,13,53.8%,19m
27904,2,Tuenchi,2565,152,6,4,10,60.0%,2h
27904,1,Hashi,2565,140,6,10,16,37.5%,37m
27904,2,TheBrown,2565,123,5,7,12,41.7%,2h
27904,1,Raziel,2565,88,5,9,14,35.7%,17m
27904,2,MATASUAVES,2565,30,3,4,7,42.9%,1h
27904,3,COFRAN,2565,0,2,2,4,50.0%,2h
27904,2,Rohan,2565,32,2,2,4,50.0%,2h
27904,2,TheBean,2565,0,1,0,1,100.0%,17m
27904,2,Zdog,2565,0,1,0,1,100.0%,2h
27904,2,Grimcraft,2565,0,1,0,1,100.0%,2h
27904,2,KLOUGH,2565,0,0,1,1,0.0%,17m
27904,2,FunkyMonkey,2565,0,0,2,2,0.0%,2h
27927,3,[UpxV]ShadowKnight,2564,1557,75,60,135,55.6%,1m
27927,3,MrBushido,2564,301,72,63,135,53.3%,31m
27927,2,AKILAE,2564,1578,72,70,142,50.7%,17m
27927,1,UncleIroh,2564,1242,48,45,93,51.6%,34m
27927,2,seniorbances,2564,608,45,24,69,65.2%,2h
27927,1,lazyboy,2564,712,45,37,82,54.9%,2h
27927,1,xcvxc,2564,567,40,33,73,54.8%,2h
27927,2,MacroKing,2564,748,36,20,56,64.3%,3h
27927,2,zdexor,2564,306,11,12,23,47.8%,2h
27927,1,[PERUII]NoirCroix,2564,215,9,10,19,47.4%,2h
27927,1,AAA,2564,225,9,14,23,39.1%,2h
27927,2,SnThanos,2564,242,8,4,12,66.7%,2h
27927,1,[SkAL]Socrispy,2564,30,5,8,13,38.5%,3m
27927,1,[lulzzz]IIIIIIIIIIII,2564,178,5,10,15,33.3%,2m
27927,2,TRUMPWIN,2564,132,4,5,9,44.4%,43m
27927,3,[McT]Sixpounder,2564,72,3,0,3,100.0%,2h
27927,2,[DNGTO]Bullss,2564,58,3,0,3,100.0%,3h
27927,2,SakumaMayu,2564,159,3,1,4,75.0%,2h
27927,2,CHAUCER,2564,139,3,1,4,75.0%,14m
27927,2,JohnKimYaY,2564,88,3,3,6,50.0%,2h
27927,2,PUF,2564,92,3,4,7,42.9%,3h
27927,1,[BCNa]Tater,2564,109,3,5,8,37.5%,1h
27927,2,vunconker,2564,30,2,3,5,40.0%,15m
27927,3,BigBoris,2564,0,2,3,5,40.0%,14m
27927,1,JimmySCW,2564,0,2,4,6,33.3%,2h
27927,1,noobiz,2564,36,2,4,6,33.3%,2h
27927,3,BOM,2564,0,2,4,6,33.3%,2h
27927,1,[CovRay]Lawrence,2564,32,2,8,10,20.0%,2h
27927,2,MrDrakecus,2564,0,0,1,1,0.0%,2h
27956,1,MITREUSMC,2563,1431,165,181,346,47.7%,4m
27956,1,Rasikan,2563,1626,141,144,285,49.5%,2h
27956,2,BWon,2563,457,106,88,194,54.6%,2h
27956,2,[1Fenix]bolgamary,2563,1619,106,92,198,53.5%,3h
27956,1,Crillic,2563,1372,64,68,132,48.5%,37m
27956,2,Sigmar,2563,926,35,32,67,52.2%,15m
27956,1,[EXTC]Arthur,2563,664,32,27,59,54.2%,45m
27956,2,Royalxnder,2563,631,31,31,62,50.0%,45m
27956,2,Raiya,2563,718,23,36,59,39.0%,23m
27956,2,[BESTED]EvilJerks,2563,228,22,18,40,55.0%,18m
27956,2,[Naglan]Sergeant,2563,304,11,6,17,64.7%,2h
27956,1,[ExcIgN]Grondow,2563,264,11,9,20,55.0%,26m
27956,2,EduardoO,2563,206,8,8,16,50.0%,21m
27956,1,leguy,2563,174,7,7,14,50.0%,2h
27956,1,TLKdaz,2563,160,6,9,15,40.0%,4m
27956,2,MinersCorp,2563,0,4,1,5,80.0%,2h
27956,2,[DMONlC]DroneZilla,2563,115,4,4,8,50.0%,2h
27956,2,DarKnight,2563,112,4,5,9,44.4%,1h
27956,2,Ashram,2563,112,3,0,3,100.0%,2h
27956,2,Shervert,2563,0,1,0,1,100.0%,3h
27956,1,Rain,2563,96,1,2,3,33.3%,2h
27956,2,SaltySandJr,2563,0,0,1,1,0.0%,2h
27956,2,[pSC20]ZERO,2563,0,0,1,1,0.0%,21m
27956,2,Maverick,2563,0,0,2,2,0.0%,21m
27956,2,SeaSky,2563,0,0,2,2,0.0%,25m
27981,3,WoLfRahM,2562,621,121,104,225,53.8%,4m
27981,1,Lavan,2562,1026,75,64,139,54.0%,46m
27981,2,Quinault,2562,817,57,71,128,44.5%,30m
27981,2,Gamz,2562,1067,53,42,95,55.8%,31m
27981,1,Bandito,2562,747,30,33,63,47.6%,19m
27981,2,PMCA,2562,424,25,10,35,71.4%,45m
27981,2,Zea,2562,389,15,14,29,51.7%,34m
27981,2,Wells,2562,197,8,7,15,53.3%,1h
27981,2,Hando,2562,177,8,8,16,50.0%,21m
27981,1,Bhaisajya,2562,227,7,9,16,43.8%,2h
27981,2,Crow,2562,173,6,5,11,54.5%,39m
27981,2,[EZDUNK]Monkie,2562,166,4,4,8,50.0%,4m
27981,2,Infused,2562,102,3,0,3,100.0%,31m
27981,2,Templario,2562,60,3,1,4,75.0%,16m
27981,1,LuckyTerran,2562,134,3,2,5,60.0%,2h
27981,2,fluffs,2562,88,3,4,7,42.9%,43m
27981,1,RBG,2562,30,3,5,8,37.5%,3h
27981,3,[LOHs]ArMada,2562,97,2,2,4,50.0%,48m
27981,1,Krakens,2562,96,2,7,9,22.2%,24m
27981,2,[kien]PerroMalo,2562,0,1,0,1,100.0%,13m
27981,2,Amelin,2562,0,1,0,1,100.0%,2h
27981,2,Keelobight,2562,0,1,1,2,50.0%,2h
27981,2,DMC,2562,30,1,1,2,50.0%,2h
27981,2,[Biag]Narzse,2562,0,1,1,2,50.0%,48m
27981,2,manh,2562,0,0,1,1,0.0%,3h
27981,2,crazyshot,2562,0,0,2,2,0.0%,33m
27981,2,maicra,2562,0,0,2,2,0.0%,2h
27981,1,Ryan,2562,0,0,5,5,0.0%,44m
28009,1,ChilenoSinga,2561,1669,95,94,189,50.3%,33m
28009,1,RmasterJ,2561,774,57,38,95,60.0%,18m
28009,1,NameAnxiety,2561,1263,47,47,94,50.0%,2h
28009,3,Vyrkolakas,2561,878,35,37,72,48.6%,12m
28009,3,RocketMan,2561,609,35,51,86,40.7%,36m
28009,1,[DCDC]JohnnyRehab,2561,945,34,36,70,48.6%,2m
28009,1,[CaXaSc]Scarface,2561,928,30,33,63,47.6%,2h
28009,1,arthurking,2561,718,25,29,54,46.3%,2h
28009,2,CakePie,2561,546,24,16,40,60.0%,2h
28009,2,Swindyy,2561,444,19,9,28,67.9%,49m
28009,2,Ultimatero,2561,435,16,13,29,55.2%,42m
28009,1,Xandros,2561,362,14,7,21,66.7%,2h
28009,2,Malkavian,2561,202,7,8,15,46.7%,2h
28009,1,sonicwu,2561,124,6,8,14,42.9%,3h
28009,1,WetBiscuit,2561,206,6,11,17,35.3%,38m
28009,1,chief,2561,104,3,3,6,50.0%,2h
28009,2,Zarathos,2561,92,3,3,6,50.0%,1h
28009,2,[PEINF]SirFrancO,2561,64,2,3,5,40.0%,2h
28009,1,Qdawg,2561,0,1,0,1,100.0%,38m
28009,2,ArtVandelay,2561,30,1,1,2,50.0%,3h
28009,2,Funeralheart,2561,88,1,5,6,16.7%,2h
28030,1,ElCapitan,2560,1494,88,87,175,50.3%,16m
28030,2,[PNboyz]PiNNacleDMG,2560,1152,44,41,85,51.8%,2h
28030,3,PBee,2560,770,41,44,85,48.2%,36m
28030,3,thrmyc,2560,868,30,42,72,41.7%,11m
28030,2,[AQP4]Ironbross,2560,295,25,17,42,59.5%,1h
28030,2,[PiGPan]conn,2560,378,19,15,34,55.9%,46m
28030,2,Reesepup,2560,374,13,13,26,50.0%,2h
28030,2,[GrnBrd]Titan,2560,320,11,8,19,57.9%,2h
28030,1,[KUUSH]pattycakes,2560,195,10,8,18,55.6%,2h
28030,1,danzelot,2560,263,9,10,19,47.4%,1h
28030,2,ZipperLine,2560,270,8,8,16,50.0%,1h
28030,2,[TEKN]Unicable,2560,240,8,9,17,47.1%,2h
28030,1,Kreamz,2560,222,8,12,20,40.0%,2h
28030,2,RatSlayer,2560,178,7,5,12,58.3%,2h
28030,1,[GRUSP]Waldersaint,2560,258,7,11,18,38.9%,48m
28030,2,PPGiant,2560,152,6,4,10,60.0%,32m
28030,1,ScreenLooker,2560,145,5,7,12,41.7%,2h
28030,2,Robbie,2560,120,4,5,9,44.4%,30m
28030,2,Boom,2560,112,3,0,3,100.0%,15m
28030,2,Diaz,2560,36,2,1,3,66.7%,3m
28030,2,Lombardo,2560,30,2,1,3,66.7%,2h
28030,3,Whitess,2560,0,2,1,3,66.7%,1h
28030,2,[ANFA]SIXTIUM,2560,60,2,2,4,50.0%,2h
28030,2,viruz,2560,119,2,2,4,50.0%,2h
28030,2,SerguezNO,2560,0,2,3,5,40.0%,17m
28030,3,sbs,2560,0,2,3,5,40.0%,2h
28030,2,catman,2560,0,1,0,1,100.0%,1h
28030,2,Raskolnikov,2560,0,1,0,1,100.0%,2h
28030,2,WishMeLuck,2560,0,1,1,2,50.0%,2h
28030,2,TheDarkiller,2560,34,1,2,3,33.3%,29m
28030,2,Sbsb,2560,0,0,1,1,0.0%,2h
28030,2,Ace,2560,0,0,2,2,0.0%,1h
28062,1,Slyndovv,2559,1628,131,115,246,53.3%,19m
28062,2,[PUSA]flowsipher,2559,864,63,53,116,54.3%,35m
28062,1,menace,2559,938,48,40,88,54.5%,21m
28062,2,[EpicG]EvaParadise,2559,670,46,32,78,59.0%,2h
28062,2,[BO0MER]Konvicka,2559,1048,43,31,74,58.1%,16m
28062,2,OneMind,2559,477,42,30,72,58.3%,2h
28062,2,Crow,2559,987,39,34,73,53.4%,13m
28062,2,Kenshin,2559,577,31,16,47,66.0%,3m
28062,2,Plagues,2559,208,8,2,10,80.0%,33m
28062,1,WhatAmIDoing,2559,242,7,9,16,43.8%,3h
28062,2,nunu,2559,148,5,2,7,71.4%,2h
28062,1,rebel,2559,146,5,7,12,41.7%,14m
28062,1,jdb,2559,142,5,12,17,29.4%,3h
28062,2,JTD,2559,139,4,7,11,36.4%,45m
28062,2,Nguyen,2559,124,3,7,10,30.0%,2h
28062,3,ExtremeJoy,2559,0,2,4,6,33.3%,35m
28062,3,Schere,2559,0,1,1,2,50.0%,37m
28062,2,kamistri,2559,30,1,1,2,50.0%,16m
28062,3,ChApnU,2559,0,1,2,3,33.3%,23m
28062,2,Cavanagh,2559,0,0,1,1,0.0%,31m
28082,2,YEY,2558,1318,73,55,128,57.0%,2h
28082,2,MsVanG,2558,1572,73,64,137,53.3%,2h
28082,2,unionScare,2558,1047,46,36,82,56.1%,32m
28082,3,Trippin,2558,872,33,40,73,45.2%,20m
28082,1,Jehdo,2558,419,17,13,30,56.7%,2h
28082,2,zerohora,2558,442,16,16,32,50.0%,9m
28082,2,[C66]sumfattytuna,2558,382,16,20,36,44.4%,11m
28082,1,RaZoR,2558,395,15,17,32,46.9%,1h
28082,2,[760]Phoodisgood,2558,321,14,16,30,46.7%,2h
28082,1,manuel,2558,352,14,21,35,40.0%,19m
28082,1,Matt,2558,263,12,10,22,54.5%,2h
28082,2,deat,2558,227,12,14,26,46.2%,3h
28082,2,Ben,2558,241,9,13,22,40.9%,27m
28082,2,Cardozo,2558,160,5,2,7,71.4%,2h
28082,1,DarkKnight,2558,30,5,3,8,62.5%,47m
28082,2,[LBP]Nate,2558,116,4,4,8,50.0%,1h
28082,2,Anubis,2558,86,4,5,9,44.4%,49m
28082,2,[BEEFER]Oblivion,2558,118,4,5,9,44.4%,2h
28082,2,lmX,2558,148,3,2,5,60.0%,38m
28082,2,Rockdg,2558,112,3,5,8,37.5%,2h
28082,2,ZEVILLANO,2558,58,2,2,4,50.0%,31m
28082,2,Skatedivona,2558,30,2,2,4,50.0%,3h
28082,2,snacko,2558,60,2,4,6,33.3%,9m
28082,2,[GeTBTC]XBTbitcoin,2558,0,1,0,1,100.0%,3h
28082,2,Sumimasen,2558,0,1,0,1,100.0%,17m
28082,2,[RustLg]sctwosuxcoc,2558,0,1,4,5,20.0%,1h
28082,1,LuftBahn,2558,30,1,5,6,16.7%,2h
28082,2,[UpxV]TheBullyMan,2558,0,0,1,1,0.0%,2h
28082,2,Kryptix,2558,0,0,1,1,0.0%,2h
28082,2,[PurgT]Robbs,2558,0,0,2,2,0.0%,2h
28112,1,naquos,2557,1580,148,142,290,51.0%,1h
28112,2,gnilwod,2557,757,64,57,121,52.9%,2h
28112,2,Jason,2557,723,33,25,58,56.9%,2h
28112,3,Eric,2557,686,28,26,54,51.9%,7m
28112,1,fmL,2557,630,24,24,48,50.0%,14m
28112,2,newgate,2557,323,21,16,37,56.8%,2h
28112,2,HURM,2557,366,15,12,27,55.6%,17m
28112,1,OverLord,2557,258,10,10,20,50.0%,2h
28112,2,igotdembombs,2557,206,7,7,14,50.0%,2h
28112,2,DAVISITO,2557,171,6,2,8,75.0%,31m
28112,1,Hamburglar,2557,153,6,4,10,60.0%,2h
28112,2,LOLKFC,2557,85,6,5,11,54.5%,2h
28112,1,SirBeaker,2557,144,6,10,16,37.5%,21m
28112,1,Dandy,2557,189,5,5,10,50.0%,48m
28112,2,SebasElNoob,2557,128,4,0,4,100.0%,2h
28112,2,Biorex,2557,168,4,3,7,57.1%,2h
28112,2,EyeWeaver,2557,122,4,6,10,40.0%,31m
28112,1,Lui,2557,100,3,10,13,23.1%,19m
28112,2,Woosa,2557,88,2,0,2,100.0%,1h
28112,2,SubZero,2557,0,2,0,2,100.0%,4m
28112,2,LeoCalintz,2557,30,2,1,3,66.7%,39m
28112,2,Hinekan,2557,109,2,1,3,66.7%,2h
28112,2,Borealis,2557,114,2,3,5,40.0%,2h
28112,1,vanPire,2557,0,2,4,6,33.3%,2h
28112,2,papalo,2557,0,1,1,2,50.0%,2h
28112,2,Human,2557,44,1,3,4,25.0%,2h
28112,3,[LegSC]pichichax,2557,0,1,4,5,20.0%,35m
28112,2,[iECO]JonSnow,2557,0,0,1,1,0.0%,2h
28112,1,KITON,2557,0,0,1,1,0.0%,2h
28112,2,lexvid,2557,0,0,4,4,0.0%,49m
28142,3,AkumuD,2556,1596,165,151,316,52.2%,26m
28142,2,Tensor,2556,1541,131,120,251,52.2%,2h
28142,3,llllllllllll,2556,1393,94,99,193,48.7%,26m
28142,2,CombatEX,2556,1437,67,68,135,49.6%,2h
28142,1,Jbayy,2556,627,40,39,79,50.6%,34m
28142,2,[boeuf]Gateaux,2556,846,36,28,64,56.2%,2h
28142,2,AshY,2556,846,31,31,62,50.0%,2h
28142,2,Luglug,2556,292,20,11,31,64.5%,2h
28142,2,Syphallus,2556,517,20,15,35,57.1%,2h
28142,2,Whipface,2556,502,18,18,36,50.0%,21m
28142,2,shrmkng,2556,356,15,5,20,75.0%,2h
28142,1,[CGB]TOSSIngEmUp,2556,321,15,17,32,46.9%,3h
28142,2,Hauntedmist,2556,400,14,14,28,50.0%,4m
28142,2,DARKERG,2556,184,7,7,14,50.0%,2h
28142,2,Quarantino,2556,218,6,5,11,54.5%,3h
28142,2,[Gideon]Smiteyou,2556,196,6,12,18,33.3%,33m
28142,2,Percius,2556,142,5,1,6,83.3%,21m
28142,3,Jang,2556,0,4,2,6,66.7%,25m
28142,2,[XpKAc]Eurotruck,2556,30,2,1,3,66.7%,1h
28142,2,[WSCSC2]styla,2556,115,2,1,3,66.7%,46m
28142,2,ironman,2556,0,2,3,5,40.0%,1h
28142,3,maçã,2556,97,2,4,6,33.3%,2h
28142,2,CrovanDan,2556,88,2,4,6,33.3%,39m
28142,2,TwitchAWAKEN,2556,64,2,6,8,25.0%,35m
28142,3,ElOniiChan,2556,0,2,6,8,25.0%,29m
28142,2,[WLHM]LUCASARR,2556,0,1,0,1,100.0%,2h
28142,2,KaptinBadruk,2556,30,1,4,5,20.0%,2h
28142,3,DethGoat,2556,0,0,1,1,0.0%,10m
28142,2,llllllllllll,2556,0,0,2,2,0.0%,2h
28142,3,moose,2556,0,0,3,3,0.0%,1h
28172,2,[Dedez]MikhailTal,2555,1098,67,48,115,58.3%,2h
28172,1,eliteboyer,2555,1442,60,52,112,53.6%,25m
28172,2,[A55555]MoreCowbell,2555,1060,40,56,96,41.7%,36m
28172,3,[0825]cptsparrow,2555,653,32,44,76,42.1%,37m
28172,2,CDIO,2555,742,29,27,56,51.8%,2h
28172,2,Phalynx,2555,597,22,20,42,52.4%,2h
28172,2,[ICMSc2]Akadio,2555,414,21,17,38,55.3%,2h
28172,2,Clueless,2555,531,20,21,41,48.8%,44m
28172,1,Clegane,2555,472,19,25,44,43.2%,2h
28172,1,ElderWu,2555,354,14,19,33,42.4%,44m
28172,2,dinosaurio,2555,140,8,11,19,42.1%,36m
28172,2,KingZ,2555,170,6,1,7,85.7%,2h
28172,2,[NCMpe]CapitanDutiz,2555,167,6,2,8,75.0%,3h
28172,1,HumanShield,2555,196,6,8,14,42.9%,45m
28172,3,JLeoawsome,2555,191,6,8,14,42.9%,34m
28172,2,Keeshig,2555,86,5,6,11,45.5%,2h
28172,3,[GINW]Claricorn,2555,151,4,4,8,50.0%,4m
28172,1,INnoJing,2555,136,4,14,18,22.2%,6m
28172,2,jorgeneo,2555,141,3,2,5,60.0%,1h
28172,2,[1MH1]DaBerns,2555,30,2,1,3,66.7%,2h
28172,2,[Thisbe]TheMystery,2555,34,2,1,3,66.7%,2h
28172,2,Darklord,2555,0,2,2,4,50.0%,2h
28172,2,sebas,2555,60,2,5,7,28.6%,49m
28172,2,[PwT]lucasmarcucc,2555,0,1,0,1,100.0%,13m
28172,2,shrooooooomz,2555,0,1,1,2,50.0%,15m
28172,2,XeTream,2555,30,1,1,2,50.0%,2h
28172,3,Mecas,2555,38,1,2,3,33.3%,2h
28172,2,imfudgededup,2555,0,0,1,1,0.0%,2h
28172,1,Lucifer,2555,0,0,2,2,0.0%,21m
28172,2,PROPHET,2555,0,0,3,3,0.0%,5m
28202,3,[M4E]Alex,2554,1444,189,189,378,50.0%,11m
28202,2,Giogrande,2554,1572,175,168,343,51.0%,34m
28202,2,StreakyBacon,2554,631,42,40,82,51.2%,32m
28202,1,[Kco]dirrlei,2554,1105,42,42,84,50.0%,35m
28202,3,LoomiNaughty,2554,1054,42,45,87,48.3%,13m
28202,1,Macro,2554,279,40,42,82,48.8%,2h
28202,1,SKG,2554,565,23,17,40,57.5%,26m
28202,2,[SyLx]blackbelt,2554,415,17,14,31,54.8%,25m
28202,2,TrueHero,2554,363,16,10,26,61.5%,2h
28202,1,tagman,2554,357,12,11,23,52.2%,2h
28202,2,BobGraham,2554,290,11,8,19,57.9%,1h
28202,2,Icaruzts,2554,170,7,4,11,63.6%,41m
28202,2,Shift,2554,168,7,8,15,46.7%,2h
28202,2,Dagan,2554,200,6,6,12,50.0%,39m
28202,1,Smith,2554,214,6,9,15,40.0%,35m
28202,3,EssteeKay,2554,166,6,10,16,37.5%,17m
28202,1,[RuS98]UberNOobster,2554,108,3,10,13,23.1%,26m
28202,2,Paradax,2554,88,2,3,5,40.0%,49m
28202,3,lMercuryl,2554,0,2,4,6,33.3%,2h
28202,3,slumlord,2554,0,2,4,6,33.3%,26m
28202,2,JaquenHghar,2554,0,0,1,1,0.0%,32m
28202,2,Jonstons,2554,0,0,1,1,0.0%,17m
28202,2,[clan23]MagmaMammoth,2554,0,0,1,1,0.0%,1h
28202,2,[Macac0]juangoil,2554,0,0,1,1,0.0%,15m
28202,3,Badger,2554,0,0,5,5,0.0%,50m
28202,1,chrispy,2554,0,0,6,6,0.0%,2h
28228,2,CPayne,2553,745,66,55,121,54.5%,32m
28228,1,[BW7]Debian,2553,678,60,63,123,48.8%,5m
28228,1,GrubHerder,2553,623,46,43,89,51.7%,2h
28228,1,noobfiveever,2553,951,40,37,77,51.9%,2h
28228,1,Moist,2553,1072,39,37,76,51.3%,2h
28228,1,Drizzzzzzy,2553,952,33,36,69,47.8%,1h
28228,2,Chauncey,2553,558,21,17,38,55.3%,2h
28228,2,Kurokage,2553,413,19,17,36,52.8%,17m
28228,1,Hercules,2553,400,12,17,29,41.4%,1h
28228,3,DARTHTEMPLAR,2553,216,10,10,20,50.0%,12m
28228,1,[ACRE]Keniow,2553,278,9,15,24,37.5%,2h
28228,2,Bulloch,2553,167,8,4,12,66.7%,2h
28228,1,Afflicion,2553,170,7,8,15,46.7%,2m
28228,2,lex,2553,184,7,8,15,46.7%,2h
28228,1,Almver,2553,242,7,15,22,31.8%,21m
28228,1,echo,2553,204,6,6,12,50.0%,1h
28228,1,jhon,2553,185,6,8,14,42.9%,2h
28228,1,Tapia,2553,183,6,10,16,37.5%,2h
28228,1,Habaxrolxd,2553,148,5,2,7,71.4%,35m
28228,1,thesmokingma,2553,94,5,7,12,41.7%,48m
28228,1,[carnal]Morfox,2553,216,5,8,13,38.5%,21m
28228,2,DKingLinch,2553,126,4,4,8,50.0%,1h
28228,1,General,2553,74,4,7,11,36.4%,2h
28228,2,Chips,2553,0,3,2,5,60.0%,17m
28228,3,woodsmoneys,2553,40,3,3,6,50.0%,6m
28228,2,CapMarmota,2553,18,2,0,2,100.0%,2h
28228,2,Juliano,2553,68,2,2,4,50.0%,21m
28228,2,KeitokuCR,2553,60,2,2,4,50.0%,2h
28228,2,hongmoney,2553,88,1,1,2,50.0%,2h
28228,2,epidemiK,2553,46,1,1,2,50.0%,27m
28228,2,lissis,2553,91,1,1,2,50.0%,2h
28228,1,[FASTR]Tincho,2553,0,1,3,4,25.0%,2h
28228,2,dantron,2553,32,1,4,5,20.0%,46m
28228,2,[TBRMX]Juaniz,2553,34,1,5,6,16.7%,2h
28228,2,Bambang,2553,0,0,1,1,0.0%,17m
28228,1,Protoss,2553,0,0,11,11,0.0%,1h
28264,1,[SWOU]maxpoint,2552,1568,125,115,240,52.1%,3m
28264,2,Mike,2552,1569,76,71,147,51.7%,2h
28264,3,[cluez]KillaJeenyis,2552,983,69,74,143,48.3%,31m
28264,2,XxxManatexxX,2552,888,52,41,93,55.9%,1h
28264,1,Germ,2552,1276,50,52,102,49.0%,1h
28264,1,ralph,2552,496,18,18,36,50.0%,35m
28264,2,[JISL]toony,2552,340,15,19,34,44.1%,36m
28264,2,BOSSPROPHET,2552,364,13,15,28,46.4%,31m
28264,1,mshadow,2552,186,8,10,18,44.4%,2h
28264,2,Zupain,2552,178,7,4,11,63.6%,48m
28264,1,Gelkatc,2552,145,7,6,13,53.8%,1h
28264,2,villevalo,2552,178,7,9,16,43.8%,49m
28264,2,Jason,2552,192,6,3,9,66.7%,2h
28264,1,[Spain]frankk,2552,198,6,9,15,40.0%,1h
28264,2,[RNIG]Ghost,2552,126,4,0,4,100.0%,15m
28264,2,[MEP]SoulCarver,2552,0,4,3,7,57.1%,2h
28264,2,[LDHero]smellyarmpit,2552,88,3,3,6,50.0%,2h
28264,3,DarkSoul,2552,0,3,3,6,50.0%,12m
28264,1,bpnuke,2552,143,3,7,10,30.0%,19m
28264,3,Alejandro,2552,0,2,3,5,40.0%,34m
28264,3,gummie,2552,0,2,4,6,33.3%,2h
28264,2,[P3R]Georgetown,2552,30,2,5,7,28.6%,15m
28264,2,jjessec,2552,0,2,5,7,28.6%,27m
28264,2,Kylerson,2552,0,2,5,7,28.6%,34m
28264,3,ANTONY,2552,0,1,0,1,100.0%,2m
28264,2,cesarbh,2552,0,1,1,2,50.0%,16m
28264,2,xBlueMarinex,2552,30,1,2,3,33.3%,32m
28264,2,snoopdawg,2552,88,1,4,5,20.0%,2h
28264,2,TeaSnack,2552,0,1,5,6,16.7%,2h
28264,2,[SmartD]Monster,2552,30,1,6,7,14.3%,2h
28264,2,brighamtm,2552,0,0,1,1,0.0%,2h
28264,3,[Metric]SkyLighter,2552,0,0,1,1,0.0%,34m
28264,1,Odizeuz,2552,0,0,2,2,0.0%,3m
28264,2,Jay,2552,0,0,2,2,0.0%,2h
28264,2,[Royal7]Gyro,2552,0,0,3,3,0.0%,2h
28299,3,AnimeGirlirl,2551,1577,131,123,254,51.6%,25m
28299,2,SunTzu,2551,531,97,73,170,57.1%,16m
28299,3,Merit,2551,1021,96,80,176,54.5%,50m
28299,2,mastershek,2551,1585,96,83,179,53.6%,2h
28299,2,[AOAWOL]HHELL,2551,1354,73,64,137,53.3%,19m
28299,2,charlicc,2551,1242,67,67,134,50.0%,32m
28299,1,NudeDude,2551,916,63,58,121,52.1%,30m
28299,1,MrSaturn,2551,457,48,49,97,49.5%,17m
28299,1,JonManTorr,2551,1098,43,36,79,54.4%,2h
28299,3,[Subaru]tixop,2551,866,34,42,76,44.7%,29m
28299,2,slug,2551,854,32,35,67,47.8%,49m
28299,2,StrangeMage,2551,446,27,20,47,57.4%,48m
28299,2,JordanElFake,2551,370,15,7,22,68.2%,2h
28299,2,MacroGamer,2551,399,14,15,29,48.3%,3m
28299,2,Leulz,2551,320,12,11,23,52.2%,6m
28299,1,casH,2551,317,8,15,23,34.8%,21m
28299,2,TheDeus,2551,218,7,4,11,63.6%,33m
28299,1,Venum,2551,161,6,5,11,54.5%,1h
28299,2,doingurmom,2551,46,5,5,10,50.0%,16m
28299,2,MagicTurtle,2551,90,5,6,11,45.5%,35m
28299,1,Player,2551,138,5,12,17,29.4%,2h
28299,2,[litr]Shukaku,2551,140,3,2,5,60.0%,2h
28299,2,WoodenFloors,2551,156,3,5,8,37.5%,2h
28299,2,Tark,2551,0,2,3,5,40.0%,16m
28299,3,MrMan,2551,0,2,3,5,40.0%,42m
28299,2,MJGamer,2551,0,2,3,5,40.0%,35m
28299,3,IanAgush,2551,0,2,4,6,33.3%,2h
28299,2,[goodho]ajam,2551,0,1,0,1,100.0%,4m
28299,2,[RON1N]RevMatch,2551,30,1,1,2,50.0%,2h
28299,2,Evolver,2551,30,1,1,2,50.0%,2h
28299,2,[KoAv]Aleschyr,2551,0,1,1,2,50.0%,2h
28299,2,CapA,2551,0,0,1,1,0.0%,2h
28299,3,Chizerson,2551,0,0,1,1,0.0%,5m
28299,2,[YBDBD]Tabitheus,2551,0,0,2,2,0.0%,17m
28299,2,SonOfMorning,2551,0,0,3,3,0.0%,2h
28299,2,MaStYlCrIsTa,2551,0,0,3,3,0.0%,21m
28335,1,StriKer,2550,1661,226,216,442,51.1%,14m
28335,2,Cavewert,2550,1140,101,91,192,52.6%,2h
28335,2,Gfc,2550,1299,62,56,118,52.5%,2h
28335,1,Gagarmayang,2550,815,51,59,110,46.4%,2h
28335,2,GANGHAPS,2550,734,32,19,51,62.7%,39m
28335,3,NmE,2550,523,20,24,44,45.5%,2m
28335,1,chris,2550,487,19,17,36,52.8%,48m
28335,1,Timejuice,2550,205,9,9,18,50.0%,35m
28335,1,MasterNothin,2550,193,8,7,15,53.3%,2h
28335,2,Eyen,2550,248,8,10,18,44.4%,2h
28335,2,elmichi,2550,128,7,2,9,77.8%,5m
28335,2,Capinsano,2550,146,6,4,10,60.0%,1h
28335,2,Scurred,2550,158,5,3,8,62.5%,2h
28335,2,CannonFodder,2550,154,5,6,11,45.5%,2h
28335,2,Ermaagurd,2550,0,4,3,7,57.1%,34m
28335,3,DJBroken,2550,181,4,5,9,44.4%,2h
28335,2,SidVicious,2550,136,4,5,9,44.4%,32m
28335,2,youGotREKT,2550,119,3,0,3,100.0%,2h
28335,3,lolzebra,2550,97,3,3,6,50.0%,1h
28335,2,[Cind3r]smirnoft,2550,60,2,2,4,50.0%,3m
28335,2,Libertadores,2550,30,2,3,5,40.0%,29m
28335,2,[UFC]Marcus,2550,46,2,4,6,33.3%,19m
28335,3,FENIX,2550,0,2,4,6,33.3%,1h
28335,1,[LaCraG]Ferna,2550,72,2,12,14,14.3%,33m
28335,2,[UpxV]Coronavirus,2550,0,1,0,1,100.0%,46m
28335,2,CGA,2550,30,1,1,2,50.0%,31m
28335,2,Gigglin,2550,0,0,2,2,0.0%,1h
28335,2,sstrunks,2550,0,0,4,4,0.0%,17m
28335,1,Katharus,2550,0,0,6,6,0.0%,46m
28364,3,UncleBilbo,2549,1475,209,206,415,50.4%,12m
28364,2,ant,2549,1489,131,121,252,52.0%,31m
28364,1,[Damasc]inoosukee,2549,1517,75,70,145,51.7%,2h
28364,1,Flanbie,2549,1059,74,77,151,49.0%,34m
28364,2,Vegeta,2549,1588,65,68,133,48.9%,2h
28364,1,[Dicboy]INeedHelp,2549,1427,57,52,109,52.3%,27m
28364,1,Kohel,2549,1155,53,46,99,53.5%,6m
28364,3,[DhZAc1]TheMarine,2549,618,53,49,102,52.0%,36m
28364,3,Traven,2549,785,46,42,88,52.3%,19m
28364,3,Tweak,2549,799,45,43,88,51.1%,19m
28364,2,martinsiete,2549,729,30,24,54,55.6%,2h
28364,2,DougieBurger,2549,764,30,28,58,51.7%,2h
28364,2,Kikkelitikku,2549,713,29,23,52,55.8%,2h
28364,2,Kabraxis,2549,515,20,15,35,57.1%,2h
28364,2,[a1vNA]blackstar,2549,458,16,13,29,55.2%,9m
28364,3,Sandwichpak,2549,496,16,30,46,34.8%,31m
28364,1,bobe,2549,335,13,13,26,50.0%,1h
28364,2,[SthEst]Wunna,2549,285,10,7,17,58.8%,2h
28364,1,LEZARD,2549,334,10,13,23,43.5%,14m
28364,1,[PpK69]Fozi,2549,258,9,10,19,47.4%,2h
28364,1,WildRage,2549,265,9,11,20,45.0%,2h
28364,2,MemesterOPs,2549,212,7,6,13,53.8%,1h
28364,2,phatchicken,2549,260,7,9,16,43.8%,45m
28364,2,PECSwatCat,2549,242,7,22,29,24.1%,11m
28364,2,Ranorith,2549,207,6,5,11,54.5%,3h
28364,1,Belial,2549,88,4,3,7,57.1%,3h
28364,3,EduChira,2549,0,3,3,6,50.0%,42m
28364,3,[VODK]Fuquito,2549,40,3,5,8,37.5%,2h
28364,1,quest,2549,92,3,10,13,23.1%,2h
28364,3,Vulgarian,2549,0,2,3,5,40.0%,25m
28364,3,siglemic,2549,0,2,4,6,33.3%,2h
28364,3,JOSCO,2549,0,2,4,6,33.3%,2h
28364,2,PiGCommander,2549,0,1,5,6,16.7%,49m
28364,2,DUTzerg,2549,0,0,1,1,0.0%,32m
28364,3,elrompeanexo,2549,0,0,1,1,0.0%,17m
28364,2,Pawee,2549,0,0,2,2,0.0%,2h
28400,2,Antyga,2548,1491,248,263,511,48.5%,17m
28400,1,Wes,2548,1554,161,152,313,51.4%,2h
28400,2,Donte,2548,1349,84,81,165,50.9%,25m
28400,2,eetmabalz,2548,623,79,79,158,50.0%,2h
28400,2,SlagBuster,2548,766,69,51,120,57.5%,2h
28400,2,size,2548,1215,46,45,91,50.5%,1h
28400,3,[UpxV]gufuhack,2548,453,17,21,38,44.7%,15m
28400,2,Spartan,2548,274,12,11,23,52.2%,19m
28400,2,Chicago,2548,309,11,4,15,73.3%,2h
28400,2,[EpicG]Hiromi,2548,286,9,13,22,40.9%,4m
28400,2,CropDrop,2548,204,8,8,16,50.0%,3h
28400,1,[DenuxD]MisterCricro,2548,162,6,7,13,46.2%,2h
28400,3,Minato,2548,92,6,8,14,42.9%,28m
28400,2,AeIOwnedU,2548,92,6,12,18,33.3%,11m
28400,2,ENaZty,2548,166,5,2,7,71.4%,6m
28400,1,Supremode,2548,152,5,9,14,35.7%,3h
28400,1,RequiemRust,2548,176,5,11,16,31.2%,2h
28400,2,Chanito,2548,88,3,4,7,42.9%,32m
28400,1,[Nuggin]Finglonger,2548,0,3,4,7,42.9%,48m
28400,1,GalacticUni,2548,159,3,8,11,27.3%,2h
28400,2,Negan,2548,95,2,4,6,33.3%,32m
28400,2,Alex,2548,88,2,4,6,33.3%,2h
28400,2,[FyHr]Nacho,2548,0,1,0,1,100.0%,3m
28400,2,val,2548,0,1,0,1,100.0%,2h
28400,2,BOBDAFISH,2548,30,1,1,2,50.0%,42m
28400,1,kiaaaaaaaaaa,2548,0,0,8,8,0.0%,2h
28426,1,daveruski,2547,1502,238,221,459,51.9%,21m
28426,2,Commander,2547,1381,137,111,248,55.2%,16m
28426,2,ricardowong,2547,1492,101,94,195,51.8%,21m
28426,2,[ICTH]JohnWilliams,2547,1524,68,56,124,54.8%,25m
28426,1,[FyHr]Setban,2547,853,51,48,99,51.5%,1h
28426,1,Channels,2547,469,43,43,86,50.0%,17m
28426,1,SayHerName,2547,1004,42,34,76,55.3%,48m
28426,2,cdubbz,2547,1060,38,36,74,51.4%,2h
28426,1,[Eñders]SARGENTO,2547,826,37,33,70,52.9%,2h
28426,2,[qbit]Hoist,2547,854,34,35,69,49.3%,11m
28426,2,Essentia,2547,382,30,27,57,52.6%,3m
28426,2,funkyavocado,2547,544,23,16,39,59.0%,5m
28426,1,Maurice,2547,354,18,18,36,50.0%,17m
28426,2,rookshanks,2547,462,17,13,30,56.7%,2h
28426,1,Xulio,2547,359,14,14,28,50.0%,2h
28426,1,culleNfay,2547,393,14,15,29,48.3%,27m
28426,2,OreoSleeves,2547,354,13,13,26,50.0%,2h
28426,1,Coconut,2547,326,10,16,26,38.5%,2h
28426,2,bob,2547,308,10,16,26,38.5%,2h
28426,1,Stormy,2547,217,7,13,20,35.0%,2h
28426,2,[nCrphL]TigerSpider,2547,169,5,6,11,45.5%,18m
28426,2,Protoss,2547,0,3,2,5,60.0%,33m
28426,2,croc,2547,94,3,5,8,37.5%,2h
28426,3,tMFsneeringr,2547,0,2,3,5,40.0%,30m
28426,2,CrOOked,2547,0,1,0,1,100.0%,2h
28426,2,Tru,2547,0,1,0,1,100.0%,2h
28426,2,[UoN]Tarsonis,2547,79,1,3,4,25.0%,2h
28426,3,BitinG,2547,0,1,5,6,16.7%,2h
28426,2,[BigBrd]ApuZ,2547,0,0,1,1,0.0%,1h
28426,2,kuhntucker,2547,0,0,1,1,0.0%,2h
28456,1,Izanagi,2546,1128,58,54,112,51.8%,30m
28456,2,AlEltz,2546,636,37,29,66,56.1%,2h
28456,1,voidraygobrr,2546,688,24,27,51,47.1%,35m
28456,2,DanWolfgang,2546,324,14,15,29,48.3%,2h
28456,2,thedecider,2546,294,13,11,24,54.2%,31m
28456,1,Twiddlestorm,2546,270,10,10,20,50.0%,15m
28456,2,Xero,2546,250,7,11,18,38.9%,1h
28456,2,[Macac0]Malthael,2546,96,4,6,10,40.0%,2h
28456,2,DynastyElves,2546,122,4,6,10,40.0%,32m
28456,3,BEEFYSUPREME,2546,168,4,8,12,33.3%,31m
28456,2,[ZroWng]RBelongToUs,2546,144,3,2,5,60.0%,1h
28456,2,Chatsworth,2546,88,3,4,7,42.9%,29m
28456,2,beginng,2546,88,2,5,7,28.6%,2h
28456,1,[JBG123]jeremykiller,2546,38,2,6,8,25.0%,38m
28456,1,Letsu,2546,127,2,7,9,22.2%,17m
28456,3,Jacky,2546,0,1,0,1,100.0%,1h
28456,2,Microfon,2546,0,1,1,2,50.0%,30m
28456,3,BlackFire,2546,0,0,1,1,0.0%,2h
28456,2,[NXLsc]xuexue,2546,0,0,2,2,0.0%,4m
28456,2,CommanderJ,2546,0,0,2,2,0.0%,21m
28476,2,UpInSmoke,2545,1579,90,82,172,52.3%,1h
28476,3,Coconut,2545,1275,83,80,163,50.9%,14m
28476,3,MinecraftPro,2545,1155,52,46,98,53.1%,34m
28476,2,Døyhar,2545,993,41,26,67,61.2%,2h
28476,2,Illidan,2545,841,34,28,62,54.8%,2h
28476,2,SummOOn,2545,529,23,12,35,65.7%,31m
28476,2,[blub0i]Kirazoya,2545,353,13,10,23,56.5%,2h
28476,1,FlyBoy,2545,359,13,16,29,44.8%,16m
28476,2,[xXGDXx]bruno,2545,254,12,2,14,85.7%,1h
28476,1,Fourplay,2545,324,11,13,24,45.8%,45m
28476,1,MisterDisco,2545,220,11,17,28,39.3%,2h
28476,3,[HOMOF]ShankABee,2545,348,11,21,32,34.4%,22m
28476,2,DaveBarry,2545,256,10,7,17,58.8%,2h
28476,2,Swankypants,2545,140,8,4,12,66.7%,32m
28476,2,Macaron,2545,191,7,5,12,58.3%,16m
28476,2,LWD,2545,184,6,7,13,46.2%,6m
28476,2,Alucard,2545,116,5,6,11,45.5%,31m
28476,2,[TTHHCC]CoronaTime,2545,130,4,1,5,80.0%,43m
28476,2,[USUCC]LargeDiK,2545,117,3,5,8,37.5%,1h
28476,1,[Pizzy]Bot,2545,30,3,6,9,33.3%,2h
28476,2,LamDaiHiep,2545,88,2,0,2,100.0%,4m
28476,3,Heaviside,2545,0,2,3,5,40.0%,37m
28476,3,ColdCultist,2545,0,2,3,5,40.0%,1h
28476,2,Bawlzdep,2545,30,1,2,3,33.3%,21m
28476,2,Goodbye,2545,0,1,4,5,20.0%,3h
28476,2,[1vsM]devilsonso,2545,0,0,1,1,0.0%,1h
28476,1,HoneyBadger,2545,0,0,1,1,0.0%,41m
28503,1,NotTheFace,2544,1515,98,75,173,56.6%,18m
28503,1,acsimpson,2544,1518,85,84,169,50.3%,34m
28503,1,[cluez]Moonbeam,2544,1613,80,87,167,47.9%,1h
28503,2,[ExcIgN]GaBiTo,2544,1219,60,44,104,57.7%,2h
28503,2,BlessedG,2544,874,38,31,69,55.1%,9m
28503,1,mcd,2544,804,30,35,65,46.2%,2m
28503,1,Finest,2544,448,20,14,34,58.8%,2h
28503,2,Darkrider,2544,417,18,19,37,48.6%,2h
28503,2,[SHMT]ToneBone,2544,426,16,11,27,59.3%,2h
28503,1,Spyder,2544,325,15,17,32,46.9%,2h
28503,2,[8kPLUS]CrackLing,2544,425,15,17,32,46.9%,2h
28503,2,[Tehs]tehGrunge,2544,310,12,16,28,42.9%,2h
28503,3,TheHunter,2544,224,10,10,20,50.0%,22m
28503,2,ferror,2544,166,7,8,15,46.7%,15m
28503,2,Phosphorium,2544,126,4,2,6,66.7%,17m
28503,3,Rodolfo,2544,0,4,3,7,57.1%,36m
28503,2,BishopTS,2544,175,4,6,10,40.0%,2h
28503,2,Zeddricon,2544,116,4,8,12,33.3%,27m
28503,2,SkullConfeti,2544,112,3,0,3,100.0%,2h
28503,2,Killer,2544,37,3,1,4,75.0%,3h
28503,2,Ikonic,2544,58,3,2,5,60.0%,15m
28503,2,ateus,2544,106,3,2,5,60.0%,1h
28503,3,Keyzx,2544,135,2,1,3,66.7%,2h
28503,2,[HBDO]UBEREATS,2544,0,2,4,6,33.3%,32m
28503,1,Patagonia,2544,0,1,1,2,50.0%,2h
28503,2,osigato,2544,0,1,1,2,50.0%,2h
28503,2,[KaGaN]Warmachine,2544,30,1,1,2,50.0%,2h
28503,2,[TH2]Daniel,2544,30,1,5,6,16.7%,2h
28503,2,SudoSu,2544,0,1,7,8,12.5%,2h
28503,3,crazycat,2544,0,0,2,2,0.0%,37m
28503,3,KIngKunn,2544,0,0,2,2,0.0%,35m
28503,3,BootySweat,2544,0,0,3,3,0.0%,42m
28503,2,saMMbal,2544,0,0,4,4,0.0%,2h
28536,1,sebtiny,2543,1168,47,42,89,52.8%,19m
28536,2,Sbeek,2543,1131,47,46,93,50.5%,2h
28536,3,[MaxWin]SkyKai,2543,983,36,47,83,43.4%,10m
28536,3,MikeHunt,2543,900,33,43,76,43.4%,5m
28536,2,[HYXJM]Aieagle,2543,661,28,15,43,65.1%,32m
28536,2,Gabrielche,2543,512,21,21,42,50.0%,2h
28536,2,Luminous,2543,541,20,22,42,47.6%,42m
28536,2,PDK,2543,128,15,19,34,44.1%,1h
28536,2,Arkeyn,2543,353,14,11,25,56.0%,17m
28536,2,LastMohican,2543,392,14,12,26,53.8%,2h
28536,2,[TgAg]Furion,2543,360,14,14,28,50.0%,2h
28536,2,[lowAPM]Somuchtosay,2543,314,12,15,27,44.4%,16m
28536,2,Dedac,2543,296,10,8,18,55.6%,2h
28536,2,SmartAlek,2543,193,7,2,9,77.8%,25m
28536,3,Furbi,2543,241,7,10,17,41.2%,40m
28536,2,Murakami,2543,156,6,8,14,42.9%,2h
28536,1,PMBishop,2543,191,6,8,14,42.9%,2h
28536,2,Wick,2543,114,5,3,8,62.5%,2h
28536,2,[ConFed]Deathletter,2543,93,5,4,9,55.6%,19m
28536,3,DiggiD,2543,135,4,4,8,50.0%,1h
28536,3,IIIIIIIIII,2543,169,4,5,9,44.4%,2h
28536,2,perfectwork,2543,140,4,6,10,40.0%,43m
28536,2,[ValidG]Druidic,2543,126,3,1,4,75.0%,31m
28536,1,noobles,2543,68,3,9,12,25.0%,2h
28536,2,[NexGen]Argos,2543,111,2,1,3,66.7%,2h
28536,2,night,2543,30,2,1,3,66.7%,2h
28536,2,QuelpoHelpo,2543,102,2,2,4,50.0%,32m
28536,2,GOLDENS,2543,0,2,3,5,40.0%,39m
28536,2,AzComBaT,2543,0,2,3,5,40.0%,29m
28536,3,GypsyJoufie,2543,0,2,4,6,33.3%,2h
28536,2,Matt,2543,88,2,4,6,33.3%,21m
28536,2,Bromenda,2543,0,1,0,1,100.0%,6m
28536,2,OzBrYaNzO,2543,0,1,0,1,100.0%,2h
28536,2,[MCRN]FlyingHusky,2543,30,1,2,3,33.3%,1h
28536,2,BananaPuddin,2543,0,0,1,1,0.0%,26m
28536,2,Matho,2543,0,0,1,1,0.0%,5m
28536,2,PunisherThor,2543,0,0,1,1,0.0%,2h
28536,2,[ZTemp]Chesshire,2543,0,0,2,2,0.0%,19m
28536,2,BleX,2543,0,0,2,2,0.0%,46m
28536,3,Palayoh,2543,0,0,2,2,0.0%,37m
28576,1,[SUNBRA]NoobMaster,2542,1437,125,110,235,53.2%,2h
28576,1,Azuna,2542,1441,93,86,179,52.0%,1h
28576,2,[BRSKR]CrystalPepsy,2542,1407,90,83,173,52.0%,2h
28576,2,MonoDSL,2542,1098,48,37,85,56.5%,2h
28576,2,[AOdA]gaga,2542,483,26,23,49,53.1%,6m
28576,2,levacian,2542,564,23,18,41,56.1%,32m
28576,2,[BOLVIA]VICTUM,2542,585,22,21,43,51.2%,43m
28576,2,[Chummp]DALEG,2542,194,20,18,38,52.6%,33m
28576,2,Overlord,2542,478,18,15,33,54.5%,1h
28576,1,Hectoraldo,2542,368,14,16,30,46.7%,2h
28576,2,Nolack,2542,338,12,14,26,46.2%,2h
28576,3,[ConFed]gerdel,2542,312,11,22,33,33.3%,16m
28576,2,Heatseeker,2542,177,7,3,10,70.0%,2h
28576,2,Lem,2542,223,7,4,11,63.6%,42m
28576,2,[SIClan]Bushido,2542,168,6,20,26,23.1%,6m
28576,2,[ADDU]MangKated,2542,155,4,4,8,50.0%,1h
28576,2,Rayne,2542,0,3,2,5,60.0%,2h
28576,2,Tomás,2542,30,2,2,4,50.0%,3h
28576,2,sakura,2542,30,2,4,6,33.3%,18m
28576,2,Atrius,2542,88,2,5,7,28.6%,2h
28576,2,[Epokhé]RaZoR,2542,0,0,1,1,0.0%,2h
28576,2,[PBNQ]ZOLRAK,2542,0,0,1,1,0.0%,2h
28598,3,FerWolf,2541,1398,262,247,509,51.5%,32m
28598,2,Deadwing,2541,1406,95,85,180,52.8%,2h
28598,2,rricolas,2541,1647,94,82,176,53.4%,33m
28598,2,Chounman,2541,1348,56,50,106,52.8%,2h
28598,2,cashew,2541,1190,55,50,105,52.4%,2h
28598,1,Bariclaw,2541,580,35,43,78,44.9%,2h
28598,1,SomeOtherShi,2541,549,25,23,48,52.1%,2h
28598,2,LatinSlave,2541,644,24,23,47,51.1%,33m
28598,1,[VAP0R]SKOOS,2541,615,22,23,45,48.9%,3m
28598,2,[AIN]lfhl,2541,483,20,17,37,54.1%,42m
28598,1,BattleBowb,2541,464,17,17,34,50.0%,35m
28598,2,Paperplate,2541,416,16,16,32,50.0%,5m
28598,2,Amalthea,2541,207,9,6,15,60.0%,21m
28598,3,[WndRun]Kaladin,2541,148,9,9,18,50.0%,34m
28598,3,[FxB]Brosek,2541,75,9,11,20,45.0%,24m
28598,1,GregoryPie,2541,220,7,13,20,35.0%,31m
28598,2,[PRTOS]CaptainLevi,2541,260,6,8,14,42.9%,2h
28598,2,Mattax,2541,0,4,1,5,80.0%,2h
28598,2,cody,2541,184,4,8,12,33.3%,44m
28598,2,[Howce]Twink,2541,116,3,0,3,100.0%,49m
28598,1,Garavou,2541,0,3,7,10,30.0%,2h
28598,1,XeroKuhl,2541,104,3,9,12,25.0%,19m
28598,2,LoneRanger,2541,30,2,2,4,50.0%,2h
28598,2,Ares,2541,60,2,4,6,33.3%,2h
28598,2,Loki,2541,0,2,6,8,25.0%,1h
28598,2,DrAcula,2541,0,1,4,5,20.0%,3h
28598,2,buttfor,2541,0,0,1,1,0.0%,1h
28598,3,PemDaddy,2541,0,0,1,1,0.0%,32m
28598,2,Randolf,2541,0,0,2,2,0.0%,2h
28598,2,[PiGPan]Brain,2541,0,0,2,2,0.0%,17m
28598,1,TheLex,2541,0,0,6,6,0.0%,3h
28629,2,Diotrephes,2540,1466,82,76,158,51.9%,2h
28629,1,[XDRAX8]crist,2540,1186,81,81,162,50.0%,2h
28629,3,[GGMESP]Escanor,2540,1044,65,78,143,45.5%,9m
28629,2,Wazren,2540,1496,58,55,113,51.3%,2h
28629,2,Zoltan,2540,1084,46,43,89,51.7%,43m
28629,1,FiQ,2540,829,43,51,94,45.7%,2h
28629,1,rekrap,2540,857,32,32,64,50.0%,2h
28629,2,[RCSM]dapperboxer,2540,498,21,14,35,60.0%,1h
28629,3,vscAloha,2540,552,21,30,51,41.2%,31m
28629,2,[TGosuA]Ramshack,2540,197,20,17,37,54.1%,33m
28629,2,Straika,2540,295,12,13,25,48.0%,2h
28629,1,ColdIce,2540,336,11,11,22,50.0%,11m
28629,1,DecrepitAPK,2540,199,10,6,16,62.5%,1h
28629,2,BloodReaver,2540,153,9,9,18,50.0%,43m
28629,1,Exodus,2540,235,8,10,18,44.4%,10m
28629,2,Grendalyn,2540,198,7,8,15,46.7%,49m
28629,2,KernelKiller,2540,168,7,10,17,41.2%,6m
28629,2,TheAmandoo,2540,121,6,1,7,85.7%,1h
28629,2,QuirkyToss,2540,106,6,7,13,46.2%,41m
28629,2,histrionic,2540,198,6,11,17,35.3%,21m
28629,2,bruhmoment,2540,177,5,6,11,45.5%,41m
28629,1,lemine,2540,135,4,4,8,50.0%,34m
28629,2,James,2540,30,2,1,3,66.7%,17m
28629,1,Chiggs,2540,32,2,3,5,40.0%,33m
28629,2,Twizzler,2540,60,2,3,5,40.0%,2h
28629,3,fonetic,2540,0,2,3,5,40.0%,2h
28629,2,Leanfijo,2540,0,2,4,6,33.3%,16m
28629,2,[Msia]MiEHV,2540,0,1,2,3,33.3%,2h
28629,3,[TheRs]Grumpyninja,2540,0,1,3,4,25.0%,26m
28629,1,GrimReaper,2540,0,1,6,7,14.3%,2h
28629,3,angelGX,2540,0,0,1,1,0.0%,2h
28629,2,[ABSLT]Vira,2540,0,0,2,2,0.0%,2h
28629,1,[L3]scrs,2540,0,0,6,6,0.0%,15m
28662,2,[QFTA]Chanute,2539,1624,123,111,234,52.6%,2h
28662,1,volatile,2539,1560,113,110,223,50.7%,2h
28662,2,Rollins,2539,1625,100,96,196,51.0%,2h
28662,1,NICODEMUS,2539,1438,88,77,165,53.3%,32m
28662,1,[whalez]Galorn,2539,854,40,36,76,52.6%,2h
28662,1,KramerSpaz,2539,413,22,23,45,48.9%,34m
28662,2,XardasZ,2539,389,18,15,33,54.5%,13m
28662,1,[TWI]Shadow,2539,496,16,20,36,44.4%,1h
28662,1,Artanis,2539,463,15,17,32,46.9%,1h
28662,2,Kinex,2539,340,13,11,24,54.2%,2h
28662,2,Harry,2539,243,10,6,16,62.5%,2h
28662,2,ricci,2539,232,8,12,20,40.0%,44m
28662,2,ParadoX,2539,216,7,5,12,58.3%,25m
28662,2,Holz,2539,196,6,6,12,50.0%,2h
28662,2,KhalDrog,2539,150,5,2,7,71.4%,13m
28662,2,Telomin,2539,155,5,5,10,50.0%,2h
28662,2,ASTROMIC,2539,140,4,2,6,66.7%,36m
28662,2,LuckyHartzog,2539,117,4,2,6,66.7%,19m
28662,3,Ghost,2539,133,3,5,8,37.5%,10m
28662,3,Paveeeez,2539,0,2,3,5,40.0%,37m
28662,1,[churrr]ohomairangi,2539,104,2,3,5,40.0%,2h
28662,2,Sapphira,2539,0,2,4,6,33.3%,5m
28662,3,hydra,2539,0,1,0,1,100.0%,26m
28662,2,Blank,2539,88,1,1,2,50.0%,3h
28662,2,DEADLYPANTS,2539,30,1,4,5,20.0%,1h
28662,3,[GTLS]SUNDOG,2539,0,0,1,1,0.0%,10m
28662,2,[Kex]Xtfirstblood,2539,0,0,1,1,0.0%,7m
28662,3,CemNoSupino,2539,0,0,1,1,0.0%,34m
28690,1,Peter,2538,1358,128,129,257,49.8%,2h
28690,2,[LAAR]Osirisgirls,2538,1226,60,34,94,63.8%,1h
28690,2,[II7]BananaJoe,2538,984,60,49,109,55.0%,11m
28690,2,[PRATAZ]Dengue,2538,1049,41,33,74,55.4%,17m
28690,1,MVillaG,2538,695,25,30,55,45.5%,2h
28690,2,Follamadres,2538,606,24,20,44,54.5%,17m
28690,1,[GRNSKN]Neroxas,2538,607,23,27,50,46.0%,17m
28690,1,BobSanders,2538,511,21,24,45,46.7%,21m
28690,1,Solitude,2538,520,17,21,38,44.7%,5m
28690,2,[DOVA]Wolf,2538,424,15,17,32,46.9%,2h
28690,2,Barrikade,2538,306,13,9,22,59.1%,46m
28690,2,SamBo,2538,256,12,9,21,57.1%,2h
28690,2,[JM2]StarCRACK,2538,267,11,5,16,68.8%,1h
28690,1,Fab,2538,371,11,15,26,42.3%,2h
28690,1,ski,2538,216,10,8,18,55.6%,2h
28690,2,[1123]Czar,2538,148,6,5,11,54.5%,44m
28690,3,Okor,2538,153,5,3,8,62.5%,5m
28690,2,[SC2PH]Kircheis,2538,193,5,4,9,55.6%,2h
28690,2,HarbingerGun,2538,151,5,5,10,50.0%,32m
28690,3,[RUSHya]Baldur,2538,30,4,6,10,40.0%,12m
28690,2,VoodooChild,2538,118,3,2,5,60.0%,1h
28690,3,[AlexK]JJRedeck,2538,0,3,2,5,60.0%,1h
28690,2,DarkFlamez,2538,120,3,4,7,42.9%,17m
28690,3,[OnFght]Founiman,2538,0,2,3,5,40.0%,2h
28690,2,MagicTracy,2538,62,2,4,6,33.3%,3h
28690,2,Grootosfull,2538,30,2,5,7,28.6%,5m
28690,2,GeezBlecheez,2538,0,1,0,1,100.0%,2h
28690,2,[kien]Master,2538,0,1,0,1,100.0%,2h
28718,1,eldritch,2537,1557,241,213,454,53.1%,2h
28718,1,Ttot,2537,1636,124,123,247,50.2%,1h
28718,1,[PO342]Toxic,2537,1588,70,60,130,53.8%,2h
28718,2,hansenrw,2537,1194,50,34,84,59.5%,5m
28718,2,ssenaM,2537,533,49,35,84,58.3%,28m
28718,1,Sildenafil,2537,1347,49,51,100,49.0%,2h
28718,3,Shensin,2537,945,37,43,80,46.2%,6m
28718,1,Tiction,2537,666,37,43,80,46.2%,2h
28718,2,Hiroshneeb,2537,915,36,30,66,54.5%,43m
28718,2,tatavo,2537,840,31,30,61,50.8%,30m
28718,2,parkyourbike,2537,733,30,24,54,55.6%,2h
28718,2,Vvitali,2537,744,28,27,55,50.9%,49m
28718,1,Charlito,2537,626,23,23,46,50.0%,2h
28718,2,pipiopi,2537,266,20,18,38,52.6%,17m
28718,2,[LMI42]DyE,2537,588,19,20,39,48.7%,2h
28718,2,defango,2537,290,12,11,23,52.2%,1h
28718,2,Urm,2537,358,12,15,27,44.4%,17m
28718,1,KKangs,2537,192,9,10,19,47.4%,45m
28718,3,Gaspert,2537,226,9,10,19,47.4%,17m
28718,2,[SqTDT]exist,2537,267,9,13,22,40.9%,2h
28718,1,MisterMaster,2537,196,8,10,18,44.4%,12m
28718,1,nougats,2537,229,8,11,19,42.1%,25m
28718,2,okra,2537,188,6,3,9,66.7%,15m
28718,2,Adullboy,2537,190,6,4,10,60.0%,4m
28718,2,stranger,2537,159,6,8,14,42.9%,2h
28718,3,PopeDiedLol,2537,30,5,5,10,50.0%,33m
28718,2,Emmand,2537,159,5,8,13,38.5%,17m
28718,1,Petri,2537,131,4,3,7,57.1%,2h
28718,2,joaco,2537,126,4,6,10,40.0%,2h
28718,2,Theboss,2537,48,4,7,11,36.4%,2h
28718,1,aSherGamer,2537,46,2,2,4,50.0%,2h
28718,1,kerpon,2537,0,1,0,1,100.0%,2h
28718,2,IronHeadKid,2537,0,1,0,1,100.0%,1h
28718,2,[3XQ]BobZhang,2537,93,1,1,2,50.0%,2h
28718,2,AngryGiraffe,2537,30,1,1,2,50.0%,2h
28718,2,TJRC,2537,30,1,4,5,20.0%,18m
28718,2,NAMELESS,2537,0,1,5,6,16.7%,33m
28718,2,Blazer,2537,0,0,1,1,0.0%,39m
28718,2,chileIbeetle,2537,0,0,1,1,0.0%,1h
28718,3,LortEctro,2537,0,0,1,1,0.0%,42m
28718,2,[00o0O]elnoobXD,2537,0,0,2,2,0.0%,2h
28718,2,CtownsFinest,2537,0,0,3,3,0.0%,2h
28718,2,[GGK]Paumer,2537,0,0,4,4,0.0%,15m
28761,2,PaPaRaZee,2536,362,42,11,53,79.2%,2h
28761,2,[Bommmm]Bryanelf,2536,401,32,22,54,59.3%,2h
28761,2,Joe,2536,598,25,25,50,50.0%,46m
28761,1,xlPinheadlx,2536,461,18,18,36,50.0%,37m
28761,3,[MadK]heymikey,2536,436,16,25,41,39.0%,13m
28761,2,bumberbelly,2536,345,13,18,31,41.9%,5m
28761,2,Men,2536,284,12,12,24,50.0%,2h
28761,2,Deathgear,2536,340,12,13,25,48.0%,44m
28761,2,SpaceProject,2536,205,8,4,12,66.7%,4m
28761,2,Skipper,2536,235,8,6,14,57.1%,31m
28761,1,[DSGods]KingJxeyy,2536,182,8,11,19,42.1%,41m
28761,2,Dignity,2536,238,8,12,20,40.0%,1h
28761,3,SilentStorm,2536,199,8,14,22,36.4%,2h
28761,2,Artfulninja,2536,239,7,7,14,50.0%,3h
28761,2,[QuenSC]ANDRES,2536,86,4,9,13,30.8%,38m
28761,3,LuckThirteen,2536,30,3,3,6,50.0%,2h
28761,2,raitorockett,2536,92,3,4,7,42.9%,1h
28761,2,gabriel,2536,90,3,7,10,30.0%,2h
28761,1,[TlTS]gasman,2536,0,2,4,6,33.3%,24m
28761,3,Eagle,2536,97,2,4,6,33.3%,2h
28761,2,dirjthemirge,2536,0,2,5,7,28.6%,2h
28761,2,[UCCS]Zebulander,2536,0,0,1,1,0.0%,17m
28761,2,Windmount,2536,0,0,1,1,0.0%,2h
28761,2,Emilio,2536,0,0,1,1,0.0%,32m
28785,1,Samurai,2535,1656,111,107,218,50.9%,2h
28785,2,Bigwilly,2535,1375,105,83,188,55.9%,3h
28785,2,helio,2535,1453,57,52,109,52.3%,2h
28785,2,[GgARMY]fishman,2535,794,36,30,66,54.5%,44m
28785,2,[UFC]InvaderZim,2535,774,33,24,57,57.9%,2h
28785,1,Merpetual,2535,1002,33,44,77,42.9%,2h
28785,2,QwertyBalls,2535,480,19,20,39,48.7%,11m
28785,2,Salamandar,2535,241,16,19,35,45.7%,2h
28785,2,EsPaSoL,2535,281,15,13,28,53.6%,18m
28785,1,THEbobsaget,2535,336,11,13,24,45.8%,2h
28785,2,IIIIlIIIlllI,2535,327,10,11,21,47.6%,2h
28785,2,MAKSV,2535,266,9,7,16,56.2%,2h
28785,2,YrDeadCowboy,2535,282,8,10,18,44.4%,2h
28785,2,Erenler,2535,0,3,5,8,37.5%,42m
28785,2,[PiN0YS]Parusa,2535,105,3,5,8,37.5%,17m
28785,2,StervenKill,2535,0,2,5,7,28.6%,1h
28785,2,[GnR]Airosskopf,2535,0,1,0,1,100.0%,2h
28785,2,fongg,2535,0,1,0,1,100.0%,43m
28785,3,[SDC12]QuantosWeb,2535,0,1,1,2,50.0%,34m
28785,2,spirit,2535,0,1,1,2,50.0%,2h
28785,2,AmeanGecko,2535,30,1,4,5,20.0%,7m
28785,2,McPalo,2535,0,0,1,1,0.0%,2h
28785,2,Paradox,2535,0,0,1,1,0.0%,2h
28785,2,gattuso,2535,0,0,1,1,0.0%,2h
28785,2,DrkEngel,2535,0,0,1,1,0.0%,25m
28785,2,Jetrider,2535,0,0,1,1,0.0%,34m
28785,2,DBLPumpTrump,2535,0,0,2,2,0.0%,13m
28812,1,FREDERYCK,2534,1654,169,163,332,50.9%,2h
28812,2,Nakedeyes,2534,1549,93,73,166,56.0%,4m
28812,2,Bean,2534,1363,92,68,160,57.5%,2h
28812,2,Insoo,2534,1548,58,59,117,49.6%,7m
28812,1,[EvilCC]CHEESER,2534,750,41,44,85,48.2%,17m
28812,1,[0div]theBishop,2534,358,30,34,64,46.9%,2h
28812,1,JPE,2534,840,30,48,78,38.5%,15m
28812,3,BODIN,2534,291,24,27,51,47.1%,11m
28812,1,NightKnight,2534,629,23,30,53,43.4%,3h
28812,2,aluvius,2534,359,13,16,29,44.8%,2h
28812,1,BupplySlock,2534,270,9,10,19,47.4%,33m
28812,2,Kit,2534,208,8,8,16,50.0%,7m
28812,2,[UHBG]sobigNiuzi,2534,96,4,4,8,50.0%,7m
28812,2,Stormagedon,2534,149,4,4,8,50.0%,4m
28812,3,AznCdn,2534,137,4,5,9,44.4%,2m
28812,1,Flippo,2534,48,4,7,11,36.4%,2h
28812,2,Freestyle,2534,128,3,3,6,50.0%,2h
28812,2,Pvnisher,2534,107,3,4,7,42.9%,32m
28812,2,KillerClown,2534,88,2,0,2,100.0%,2h
28812,2,mouse,2534,38,2,1,3,66.7%,2h
28812,3,[lTACl]KptKittyBuck,2534,97,2,5,7,28.6%,35m
28812,1,Lestat,2534,34,2,8,10,20.0%,2h
28812,2,[loliDS]mbreton,2534,0,1,0,1,100.0%,2h
28812,2,Meebly,2534,0,1,1,2,50.0%,43m
28812,2,ZONIKSRR,2534,0,0,1,1,0.0%,1h
28812,3,ActualDeath,2534,0,0,5,5,0.0%,2h
28838,2,WMONEY,2533,1623,230,214,444,51.8%,21m
28838,1,Masterchief,2533,1234,135,107,242,55.8%,2h
28838,2,[S1MPZ]Zinclord,2533,1422,70,55,125,56.0%,33m
28838,2,killbot,2533,813,47,46,93,50.5%,21m
28838,2,Sylar,2533,841,35,31,66,53.0%,2h
28838,1,Tiberius,2533,974,33,38,71,46.5%,2h
28838,1,[YUDAS]SecretJudas,2533,202,15,16,31,48.4%,22m
28838,2,Moose,2533,334,12,12,24,50.0%,49m
28838,2,[RONM]Jizzypoo,2533,242,11,4,15,73.3%,43m
28838,1,TheGC,2533,330,11,19,30,36.7%,2h
28838,2,MrOvo,2533,277,10,6,16,62.5%,1h
28838,2,Barra,2533,228,8,5,13,61.5%,2h
28838,2,[ÐarK]VOLCANO,2533,200,6,7,13,46.2%,2h
28838,2,Pop,2533,126,4,1,5,80.0%,2h
28838,2,Lazer,2533,140,4,2,6,66.7%,17m
28838,3,TheWombat,2533,93,3,6,9,33.3%,23m
28838,2,KnifeGrind,2533,94,3,8,11,27.3%,2h
28838,2,Lenore,2533,88,2,0,2,100.0%,2h
28838,2,Oumuamua,2533,0,2,3,5,40.0%,2h
28838,2,Kingauggie,2533,0,2,3,5,40.0%,17m
28838,3,ZergYunior,2533,97,2,4,6,33.3%,1h
28838,2,deimost,2533,18,1,2,3,33.3%,1h
28838,2,Slayer,2533,0,1,5,6,16.7%,32m
28838,2,Noxus,2533,0,0,1,1,0.0%,46m
28838,2,Helical,2533,0,0,1,1,0.0%,17m
28838,2,Labryth,2533,0,0,1,1,0.0%,2h
28838,2,Spartan,2533,0,0,3,3,0.0%,1h
28838,3,zenith,2533,0,0,5,5,0.0%,2h
28866,1,[1for2]Felipe,2532,875,82,63,145,56.6%,49m
28866,2,IamTayBob,2532,870,41,31,72,56.9%,2h
28866,2,pennington,2532,803,40,38,78,51.3%,2h
28866,1,andrewster,2532,830,34,31,65,52.3%,2h
28866,2,[IH8TOS]waltiostias,2532,465,22,18,40,55.0%,49m
28866,2,Kroos,2532,538,21,24,45,46.7%,28m
28866,2,PyroMeerkat,2532,296,17,14,31,54.8%,2h
28866,3,DerGeneral,2532,388,14,24,38,36.8%,23m
28866,2,[SyLx]NightFury,2532,280,10,5,15,66.7%,4m
28866,2,DedeJeronski,2532,282,10,7,17,58.8%,2h
28866,2,ZZATU,2532,243,9,6,15,60.0%,1h
28866,2,Dafresh,2532,222,9,11,20,45.0%,17m
28866,2,[Aquino]SilicomGames,2532,239,8,2,10,80.0%,2h
28866,2,Soraldin,2532,260,8,7,15,53.3%,2h
28866,2,DarkSoul,2532,181,7,2,9,77.8%,2h
28866,2,TomatoFarmer,2532,88,7,6,13,53.8%,1h
28866,2,Runnerrupert,2532,144,7,6,13,53.8%,44m
28866,2,assassinz,2532,178,7,9,16,43.8%,2h
28866,2,Ahri,2532,136,6,7,13,46.2%,2h
28866,1,[qoou]Dean,2532,182,6,14,20,30.0%,6m
28866,2,[LoShay]Draiquin,2532,118,5,7,12,41.7%,17m
28866,2,Loconet,2532,130,4,1,5,80.0%,1h
28866,2,[sk3tch]hydra,2532,92,4,4,8,50.0%,2h
28866,2,LaserBear,2532,90,4,5,9,44.4%,15m
28866,2,DonOso,2532,126,4,7,11,36.4%,7m
28866,2,Yanus,2532,30,2,3,5,40.0%,21m
28866,3,dnlprck,2532,0,2,3,5,40.0%,40m
28866,2,Thius,2532,34,2,4,6,33.3%,20m
28866,2,BlackManta,2532,0,1,0,1,100.0%,3h
28866,2,Artemis,2532,0,1,0,1,100.0%,2h
28866,2,Ultra,2532,0,1,0,1,100.0%,3m
28866,2,BattIenet,2532,0,1,2,3,33.3%,2h
28866,3,LIME,2532,0,0,1,1,0.0%,2h
28899,1,PLazaZerg,2531,1642,587,587,1174,50.0%,2h
28899,2,Jon,2531,1593,185,175,360,51.4%,2h
28899,3,Muzick,2531,1108,74,85,159,46.5%,11m
28899,2,CoronaVirus,2531,1260,60,38,98,61.2%,1h
28899,3,Runnyknots,2531,956,47,53,100,47.0%,11m
28899,3,dubu,2531,1023,46,57,103,44.7%,37m
28899,1,LuckyEight,2531,485,20,18,38,52.6%,34m
28899,3,MaxSlayer,2531,271,20,30,50,40.0%,33m
28899,2,[Nose02]Djokovic,2531,446,15,18,33,45.5%,20m
28899,1,kihun,2531,321,12,10,22,54.5%,2h
28899,2,[NwAs]yashiro,2531,140,9,10,19,47.4%,20m
28899,1,lodgoro,2531,302,9,15,24,37.5%,2h
28899,2,zIn,2531,235,8,8,16,50.0%,2h
28899,2,Dill,2531,267,8,10,18,44.4%,2h
28899,1,Laharl,2531,94,6,7,13,46.2%,1h
28899,2,Tyler,2531,164,5,3,8,62.5%,3h
28899,2,SrGato,2531,133,4,1,5,80.0%,17m
28899,2,Lombomombo,2531,36,4,4,8,50.0%,2h
28899,3,SilentRED,2531,97,3,4,7,42.9%,2h
28899,2,[dress]yitr,2531,58,2,2,4,50.0%,2h
28899,2,KtimeC,2531,0,1,0,1,100.0%,2h
28899,2,[CRAKS]GoliatKing,2531,30,1,2,3,33.3%,2h
28899,2,SpaceRaptor,2531,30,1,3,4,25.0%,2h
28899,2,Keatton,2531,0,0,1,1,0.0%,2h
28899,2,[JUICEY]Kev,2531,0,0,1,1,0.0%,2h
28899,2,thighgang,2531,0,0,1,1,0.0%,2h
28899,2,BrojayBombs,2531,0,0,1,1,0.0%,1h
28899,3,mspc,2531,0,0,2,2,0.0%,1h
28899,2,Susuwatt,2531,0,0,2,2,0.0%,2h
28899,2,Pineapple,2531,0,0,3,3,0.0%,1h
28929,2,[SLKNM]Arryman,2530,1559,154,131,285,54.0%,2h
28929,2,[VFam2]GeneralTazz,2530,1484,144,133,277,52.0%,16m
28929,1,[NARA]alon,2530,843,132,122,254,52.0%,2h
28929,1,ender,2530,1494,100,94,194,51.5%,1h
28929,2,Nattzerimr,2530,990,49,43,92,53.3%,2h
28929,2,Bobby,2530,1073,47,42,89,52.8%,2h
28929,2,Predator,2530,778,37,38,75,49.3%,2h
28929,2,TMoney,2530,437,16,16,32,50.0%,17m
28929,2,Firefrizzle,2530,284,15,8,23,65.2%,45m
28929,2,KaloAgo,2530,384,15,16,31,48.4%,2h
28929,2,Darkness,2530,327,12,12,24,50.0%,2h
28929,2,[Mammal]moomoo,2530,170,7,5,12,58.3%,2h
28929,2,Praesidium,2530,116,4,0,4,100.0%,2h
28929,1,YTODU,2530,142,4,6,10,40.0%,2h
28929,2,[WDTF]Darktide,2530,86,3,4,7,42.9%,4m
28929,2,FirmCheeks,2530,155,3,4,7,42.9%,2h
28929,2,Fenix,2530,90,3,6,9,33.3%,2h
28929,2,[Koiwai]Bikko,2530,102,2,1,3,66.7%,2h
28929,2,Thony,2530,114,2,2,4,50.0%,16m
28929,2,ProximaZ,2530,30,2,3,5,40.0%,44m
28929,1,[MooSha]Coach,2530,119,2,5,7,28.6%,24m
28929,2,DrToad,2530,0,1,1,2,50.0%,50m
28929,2,Tronks,2530,0,1,3,4,25.0%,17m
28929,2,[Aparic]CiKillerMark,2530,0,0,1,1,0.0%,19m
28929,2,Cochinosapo,2530,0,0,1,1,0.0%,17m
28954,1,SuperPant,2529,1673,159,155,314,50.6%,2h
28954,1,swy,2529,953,106,88,194,54.6%,45m
28954,1,Feather,2529,1606,82,82,164,50.0%,2h
28954,3,SPANKLEFRANK,2529,1091,48,50,98,49.0%,25m
28954,2,Inferno,2529,1108,41,42,83,49.4%,2h
28954,1,PamerShow,2529,256,35,32,67,52.2%,38m
28954,2,Gusbgog,2529,912,33,36,69,47.8%,2h
28954,2,Raiden,2529,768,31,31,62,50.0%,2h
28954,1,gimpus,2529,766,26,30,56,46.4%,33m
28954,2,[Macac0]Luis,2529,351,26,31,57,45.6%,2h
28954,1,[Sune]Heaven,2529,600,22,18,40,55.0%,35m
28954,2,[Trebol]Kikex,2529,374,17,7,24,70.8%,31m
28954,1,Ender,2529,246,9,13,22,40.9%,2h
28954,2,[BALIZ]DroneProbe,2529,206,7,7,14,50.0%,2h
28954,2,TableNaCl,2529,136,6,2,8,75.0%,2h
28954,2,shagito,2529,206,6,5,11,54.5%,32m
28954,2,Cercopes,2529,60,5,9,14,35.7%,21m
28954,2,[LOHs]hero,2529,30,2,1,3,66.7%,7m
28954,2,ShAkAlAkA,2529,96,1,5,6,16.7%,2h
28954,2,[Ak47s]Cheesenberg,2529,0,0,1,1,0.0%,33m
28954,2,FUnDaMEntALs,2529,0,0,1,1,0.0%,2h
28954,2,Scoopdiwoop,2529,0,0,1,1,0.0%,44m
28976,2,Kingslayer,2528,1583,182,163,345,52.8%,50m
28976,1,PrettyRicky,2528,789,141,125,266,53.0%,22m
28976,2,Sandman,2528,1579,84,90,174,48.3%,49m
28976,1,Jim,2528,979,55,47,102,53.9%,3h
28976,2,NinjaGamerTV,2528,1072,50,28,78,64.1%,2h
28976,2,CheetoPuffs,2528,1066,49,29,78,62.8%,1h
28976,2,Darkxne,2528,1097,45,38,83,54.2%,1h
28976,3,[NEW]MORTE,2528,833,31,37,68,45.6%,12m
28976,2,Tincho,2528,738,29,29,58,50.0%,2h
28976,2,[1488HH]Player,2528,706,28,24,52,53.8%,2h
28976,2,[VtBoot]DaZerganator,2528,527,27,7,34,79.4%,2h
28976,2,[KoAv]Rökkur,2528,514,19,18,37,51.4%,2h
28976,1,zelot,2528,384,17,20,37,45.9%,2h
28976,2,Esaliine,2528,366,13,16,29,44.8%,2h
28976,1,Converge,2528,418,13,18,31,41.9%,3h
28976,1,[ohMYES]awesomeben,2528,224,8,12,20,40.0%,18m
28976,2,Patitodegoma,2528,194,6,9,15,40.0%,1h
28976,2,[TOYK]TOYKronic,2528,214,5,6,11,45.5%,32m
28976,1,[DDST]Jokester,2528,145,5,7,12,41.7%,3h
28976,2,FrozenSabre,2528,66,3,3,6,50.0%,44m
28976,2,Keriggan,2528,58,3,3,6,50.0%,49m
28976,2,Gamelen,2528,179,3,4,7,42.9%,44m
28976,2,Crazykid,2528,0,1,0,1,100.0%,33m
28976,2,Sioux,2528,88,1,1,2,50.0%,2h
28976,2,Sloughterpig,2528,88,1,2,3,33.3%,2h
28976,2,Hosty,2528,30,1,4,5,20.0%,1h
28976,2,[SCIIpy]RegenteInvid,2528,0,0,1,1,0.0%,2h
29003,2,MaysLanding,2527,1621,236,223,459,51.4%,44m
29003,2,[dK]Corruptor,2527,1476,229,221,450,50.9%,30m
29003,2,[ALTF04]Rorro,2527,860,68,51,119,57.1%,1h
29003,2,Dragonezzzze,2527,913,40,31,71,56.3%,2h
29003,2,NYSurfer,2527,645,28,27,55,50.9%,25m
29003,1,MrNoOB,2527,700,27,25,52,51.9%,2h
29003,2,alejandropy,2527,546,23,17,40,57.5%,25m
29003,3,[Skim]DAK,2527,500,16,29,45,35.6%,9m
29003,2,NYuukigood,2527,249,13,6,19,68.4%,25m
29003,2,[RINGTA]CrimeLemur,2527,345,13,12,25,52.0%,1h
29003,2,Fliegen,2527,333,13,17,30,43.3%,2h
29003,1,BeanslyJones,2527,352,12,15,27,44.4%,2h
29003,2,WeeklyJeans,2527,247,9,10,19,47.4%,34m
29003,1,BlueAlert,2527,184,6,10,16,37.5%,27m
29003,2,BluddFlagg,2527,117,5,4,9,55.6%,2h
29003,1,Kolya,2527,150,5,8,13,38.5%,19m
29003,2,[DV]Lerris,2527,109,2,2,4,50.0%,2h
29003,2,CodyG,2527,93,2,2,4,50.0%,2h
29003,1,[Glizzy]Hayden,2527,0,2,3,5,40.0%,2h
29003,1,Jaxon,2527,0,2,3,5,40.0%,45m
29003,1,KaGe,2527,0,2,4,6,33.3%,21m
29003,2,ASD,2527,0,2,4,6,33.3%,2h
29003,2,[0M6M]Mijael,2527,0,1,0,1,100.0%,2h
29003,3,cRYZ,2527,0,1,1,2,50.0%,14m
29003,2,ZonateSaturn,2527,0,0,3,3,0.0%,2h
29028,1,Raven,2526,1389,263,240,503,52.3%,2h
29028,3,CobraKai,2526,1225,102,97,199,51.3%,2m
29028,2,Syke,2526,983,95,89,184,51.6%,1h
29028,2,GAM,2526,1368,74,72,146,50.7%,2h
29028,1,Trigger,2526,1675,71,69,140,50.7%,2h
29028,2,[ZTemp]amitcher,2526,776,43,31,74,58.1%,2h
29028,2,llllIIIllIlI,2526,673,33,18,51,64.7%,1h
29028,1,JimRaynor,2526,619,20,31,51,39.2%,2h
29028,2,ToiletPaper,2526,242,14,7,21,66.7%,21m
29028,2,benjiman,2526,410,14,15,29,48.3%,13m
29028,2,ElVergas,2526,324,12,13,25,48.0%,17m
29028,2,[ProW]AtomicWaffle,2526,342,11,11,22,50.0%,50m
29028,2,luriel,2526,206,8,5,13,61.5%,43m
29028,2,Thumaya,2526,251,8,6,14,57.1%,16m
29028,3,Kmina,2526,149,7,6,13,53.8%,17m
29028,2,Snakegreen,2526,165,7,6,13,53.8%,2h
29028,3,Sicarius,2526,148,6,8,14,42.9%,25m
29028,2,pbfrank,2526,116,4,7,11,36.4%,2h
29028,2,croctears,2526,144,3,1,4,75.0%,1h
29028,3,[420SD]xLuisk,2526,30,3,4,7,42.9%,2h
29028,2,StuffedGuy,2526,0,2,3,5,40.0%,40m
29028,3,GhostMarine,2526,0,2,3,5,40.0%,40m
29028,2,Undyingbane,2526,88,2,4,6,33.3%,2h
29028,2,[L3GI0N]madthunder,2526,88,1,1,2,50.0%,2h
29028,2,[nieBla]supermago,2526,0,1,1,2,50.0%,2h
29028,2,CoLYammz,2526,0,1,2,3,33.3%,33m
29028,2,AgentGhost,2526,30,1,3,4,25.0%,3h
29028,3,[LOHe]Chirunco,2526,0,0,1,1,0.0%,1h
29028,2,FelpFelpers,2526,0,0,2,2,0.0%,2h
29028,2,Haaa,2526,0,0,2,2,0.0%,2h
29028,2,[REALG4]Grux,2526,0,0,3,3,0.0%,9m
29059,3,[SWOU]viskiner,2525,1528,158,168,326,48.5%,2m
29059,3,[TGCF]yoloallday,2525,1517,121,117,238,50.8%,13m
29059,2,Deezy,2525,849,99,90,189,52.4%,36m
29059,2,CosmicTurtle,2525,1569,98,74,172,57.0%,3h
29059,1,[VMW3]Octans,2525,1171,95,101,196,48.5%,2h
29059,2,Chibus,2525,1116,79,65,144,54.9%,2h
29059,2,zealofwar,2525,344,65,75,140,46.4%,32m
29059,2,jTrus,2525,1253,57,43,100,57.0%,33m
29059,2,arturoooawes,2525,902,33,34,67,49.3%,1h
29059,1,[90RN]Hess,2525,674,22,28,50,44.0%,2h
29059,2,Verni,2525,408,18,12,30,60.0%,34m
29059,2,[ViP3Rs]Anderson,2525,344,16,7,23,69.6%,34m
29059,1,snaddladd,2525,425,15,18,33,45.5%,15m
29059,3,LifePoint,2525,203,9,13,22,40.9%,35m
29059,1,Goni,2525,311,8,14,22,36.4%,44m
29059,1,Bert,2525,217,6,11,17,35.3%,2h
29059,2,rip,2525,183,5,7,12,41.7%,2h
29059,2,NEWT,2525,152,5,9,14,35.7%,10m
29059,2,Alexain,2525,140,4,3,7,57.1%,20m
29059,2,ShEYeNne,2525,145,4,7,11,36.4%,33m
29059,1,[JGG]ishatmypants,2525,146,4,13,17,23.5%,32m
29059,2,Skillson,2525,58,3,2,5,60.0%,16m
29059,1,riskman,2525,114,3,3,6,50.0%,37m
29059,2,Frisk,2525,137,3,3,6,50.0%,2h
29059,2,DRex,2525,60,3,4,7,42.9%,32m
29059,2,Madmartigan,2525,40,2,2,4,50.0%,2h
29059,3,BrYaLeXander,2525,131,2,2,4,50.0%,17m
29059,2,StriderHiryu,2525,0,2,3,5,40.0%,2h
29059,1,Nalisha,2525,48,2,6,8,25.0%,48m
29059,1,[Rx69xx]Lucky,2525,0,1,0,1,100.0%,2h
29059,2,Leo,2525,0,1,0,1,100.0%,46m
29059,3,Necromancer,2525,36,1,1,2,50.0%,25m
29059,2,hampants,2525,0,1,1,2,50.0%,31m
29059,2,[INRI]Atheshar,2525,0,1,1,2,50.0%,2h
29059,2,ThEgEneral,2525,30,1,2,3,33.3%,1h
29059,2,Cyclone,2525,0,0,1,1,0.0%,2h
29095,1,FBHC,2524,1636,344,336,680,50.6%,19m
29095,2,flipper,2524,1339,55,46,101,54.5%,2h
29095,2,Hector,2524,906,36,28,64,56.2%,2h
29095,2,CEROCUATRO,2524,651,32,26,58,55.2%,49m
29095,2,PEGUACHY,2524,778,30,30,60,50.0%,2h
29095,1,lIIIlIIIlIII,2524,746,25,31,56,44.6%,22m
29095,2,Alphabet,2524,559,23,26,49,46.9%,10m
29095,2,Parzival,2524,658,23,29,52,44.2%,3h
29095,2,Nikolaes,2524,435,20,9,29,69.0%,2h
29095,2,[BS1]Gargolos,2524,395,17,6,23,73.9%,3m
29095,2,SiCKO,2524,312,12,6,18,66.7%,32m
29095,2,hERO,2524,333,12,9,21,57.1%,33m
29095,2,Stubbs,2524,293,11,9,20,55.0%,2h
29095,2,TrumpEatsPoo,2524,129,9,5,14,64.3%,30m
29095,1,[XDRAX8]butterbiscut,2524,186,9,9,18,50.0%,21m
29095,2,[Mun50N]Ross,2524,210,7,5,12,58.3%,11m
29095,2,[xCTx]Armyofone,2524,185,7,5,12,58.3%,2h
29095,1,starborn,2524,186,7,9,16,43.8%,4m
29095,2,[Puerko]PuerkoSenpai,2524,212,7,9,16,43.8%,2h
29095,2,[SKTT1]SGTxMookie,2524,154,6,8,14,42.9%,2h
29095,2,Chris,2524,186,5,5,10,50.0%,3h
29095,2,Raclem,2524,0,4,1,5,80.0%,19m
29095,1,[CHAAMP]AlphaGinger,2524,0,4,2,6,66.7%,19m
29095,2,rki,2524,122,4,5,9,44.4%,25m
29095,2,[HOT69]Moosgoo,2524,114,4,6,10,40.0%,2h
29095,2,zerico,2524,122,4,8,12,33.3%,5m
29095,2,MINIWING,2524,90,3,9,12,25.0%,30m
29095,1,canbozkurt,2524,78,3,28,31,9.7%,33m
29095,3,Chamahuin,2524,0,2,4,6,33.3%,34m
29095,2,SingyuChan,2524,88,2,4,6,33.3%,2h
29095,1,gas,2524,74,2,8,10,20.0%,49m
29095,3,[D0M0]xXXLustXxx,2524,0,1,1,2,50.0%,10m
29095,2,PISSsmoker,2524,0,1,4,5,20.0%,5m
29095,3,[Chrisp]Jdog,2524,0,0,1,1,0.0%,37m
29095,2,[maes]craftthis,2524,0,0,1,1,0.0%,43m
29095,3,PMSAnimal,2524,0,0,1,1,0.0%,25m
29131,1,Walter,2523,1566,111,109,220,50.5%,2h
29131,2,Gonz,2523,908,64,54,118,54.2%,2h
29131,2,[SN3KS]meansssnake,2523,1503,58,54,112,51.8%,2h
29131,2,Jijodelmaiz,2523,1495,57,61,118,48.3%,2h
29131,2,[IBLC]Grimza,2523,1007,41,41,82,50.0%,2h
29131,2,Briareos,2523,939,40,39,79,50.6%,2h
29131,1,Foky,2523,609,37,36,73,50.7%,5m
29131,1,KickAss,2523,906,30,40,70,42.9%,3h
29131,2,FOX,2523,695,28,18,46,60.9%,32m
29131,2,Kane,2523,540,26,27,53,49.1%,2h
29131,2,drogadicto,2523,462,23,19,42,54.8%,2h
29131,2,luis,2523,323,22,18,40,55.0%,2h
29131,2,RocketAngel,2523,291,16,5,21,76.2%,15m
29131,2,[HvnDvl]DROOF,2523,469,16,17,33,48.5%,11m
29131,2,Handsome,2523,355,15,19,34,44.1%,11m
29131,1,Trooper,2523,361,13,10,23,56.5%,23m
29131,2,[CV0101]memo,2523,126,5,7,12,41.7%,49m
29131,2,SpoonLord,2523,126,4,6,10,40.0%,50m
29131,1,DeaDbYDawN,2523,138,4,10,14,28.6%,2h
29131,3,ThousandFang,2523,155,3,3,6,50.0%,2h
29131,2,Granpapi,2523,90,3,5,8,37.5%,32m
29131,3,[Points]TKillSpider,2523,70,3,6,9,33.3%,2h
29131,3,[BrnzPr]LAMPSone,2523,137,2,1,3,66.7%,34m
29131,2,LeeminKappa,2523,0,1,0,1,100.0%,2h
29131,2,OsirisSOR,2523,0,1,4,5,20.0%,2h
29131,2,milorde,2523,0,1,4,5,20.0%,33m
29131,1,Razakili,2523,0,1,4,5,20.0%,2h
29131,3,Furby,2523,0,0,1,1,0.0%,2h
29131,2,Kratos,2523,0,0,1,1,0.0%,7m
29131,1,BigD,2523,0,0,1,1,0.0%,13m
29131,3,nicemonkey,2523,0,0,1,1,0.0%,2h
29131,2,Alex,2523,0,0,3,3,0.0%,2h
29163,2,[nieBla]kmShyO,2522,1556,178,162,340,52.4%,2h
29163,1,HuskyFolower,2522,1638,145,148,293,49.5%,35m
29163,3,bbb,2522,1522,81,91,172,47.1%,12m
29163,2,[GOPERÚ]acechador,2522,761,51,46,97,52.6%,2h
29163,2,zach,2522,878,36,31,67,53.7%,21m
29163,2,ChullaVida,2522,684,23,31,54,42.6%,2h
29163,3,NeutralLock,2522,288,11,20,31,35.5%,34m
29163,2,HonestAbe,2522,188,9,9,18,50.0%,1h
29163,1,Neuer,2522,209,8,1,9,88.9%,37m
29163,3,wonboi,2522,180,8,12,20,40.0%,26m
29163,2,DefconVII,2522,175,7,7,14,50.0%,2h
29163,1,ObamaGaming,2522,174,7,9,16,43.8%,46m
29163,2,SkimDoo,2522,158,6,9,15,40.0%,2h
29163,2,[ValidG]GoodTrip,2522,126,4,1,5,80.0%,2h
29163,2,Pulpo,2522,60,4,6,10,40.0%,34m
29163,2,MarsGuo,2522,128,3,2,5,60.0%,1h
29163,1,Plucky,2522,139,3,3,6,50.0%,50m
29163,1,RGB,2522,122,3,5,8,37.5%,3h
29163,1,Morlar,2522,32,3,6,9,33.3%,2h
29163,3,crazyivan,2522,0,2,2,4,50.0%,2h
29163,2,CaptKeiv,2522,0,2,3,5,40.0%,2h
29163,2,[Mitsu]IIIIlllIIlIl,2522,30,2,5,7,28.6%,21m
29163,2,Artemis,2522,0,2,5,7,28.6%,34m
29163,2,JillThompson,2522,0,2,5,7,28.6%,2h
29163,2,[JUGOS2]Miltoniuss,2522,0,1,0,1,100.0%,3h
29163,2,ALQuinder,2522,0,1,2,3,33.3%,2h
29163,2,JagoShadow,2522,0,1,4,5,20.0%,17m
29190,1,IRRITATING,2521,1544,195,187,382,51.0%,2m
29190,2,Yuri,2521,1298,107,101,208,51.4%,2h
29190,1,AndreBurn,2521,1400,84,85,169,49.7%,1h
29190,2,paoizard,2521,1549,77,95,172,44.8%,24m
29190,2,[oRuRo]NISHINOYA,2521,918,52,35,87,59.8%,2h
29190,2,Trax,2521,1105,48,50,98,49.0%,2h
29190,2,kingbitty,2521,506,46,39,85,54.1%,49m
29190,2,Nueiradotcom,2521,640,38,33,71,53.5%,1h
29190,2,[SyLx]Odiseo,2521,855,30,32,62,48.4%,7m
29190,2,gusman,2521,614,23,20,43,53.5%,31m
29190,2,elMANCO,2521,470,19,15,34,55.9%,50m
29190,2,oRoJirpy,2521,514,18,21,39,46.2%,2h
29190,1,Pidner,2521,344,12,18,30,40.0%,38m
29190,1,[DBHDM]Grantg,2521,247,9,11,20,45.0%,42m
29190,2,Jimmy,2521,232,8,5,13,61.5%,2h
29190,2,RodryGO,2521,192,7,4,11,63.6%,19m
29190,2,Primetime,2521,205,7,8,15,46.7%,1h
29190,2,[OKC]dArchon,2521,0,5,0,5,100.0%,11m
29190,3,ToasterPC,2521,201,5,6,11,45.5%,2h
29190,2,Sceth,2521,88,2,1,3,66.7%,30m
29190,3,[Genus]DarkTemplari,2521,0,2,3,5,40.0%,25m
29190,2,imNameless,2521,30,2,3,5,40.0%,1h
29190,2,Bunkers,2521,62,2,4,6,33.3%,20m
29190,3,Casey,2521,97,2,4,6,33.3%,2h
29190,1,BukakheeSake,2521,0,1,0,1,100.0%,2h
29190,2,CABAPROMO,2521,0,1,1,2,50.0%,2h
29190,2,darc,2521,0,0,1,1,0.0%,1h
29190,1,Bustarhymes,2521,0,0,3,3,0.0%,19m
29218,3,Primordial,2520,1517,328,331,659,49.8%,31m
29218,3,[Area51]WarLorD,2520,1625,123,105,228,53.9%,2h
29218,3,OtoothVaho,2520,1423,81,78,159,50.9%,34m
29218,2,Conrad,2520,1571,81,94,175,46.3%,9m
29218,2,Nazer,2520,869,68,37,105,64.8%,13m
29218,3,Pain,2520,1148,59,44,103,57.3%,2h
29218,2,Stoltis,2520,932,45,37,82,54.9%,4m
29218,2,arbitRAGE,2520,642,38,32,70,54.3%,36m
29218,1,azZurri,2520,707,27,28,55,49.1%,1h
29218,2,HonestAbe,2520,622,26,22,48,54.2%,1h
29218,2,Plauge,2520,530,18,22,40,45.0%,17m
29218,2,LucidAnon,2520,142,9,5,14,64.3%,2h
29218,2,SeaBreeze,2520,238,8,9,17,47.1%,1h
29218,2,[GURTHY]Eggroll,2520,60,6,4,10,60.0%,16m
29218,1,[5Gwang]SoulPanda,2520,183,6,6,12,50.0%,2h
29218,2,[tCo9]Jodaz,2520,134,4,2,6,66.7%,10m
29218,3,[VlPeRz]Charcoal,2520,0,4,2,6,66.7%,25m
29218,2,MrGrim,2520,149,4,6,10,40.0%,1h
29218,2,[JuuC]SilverDemon,2520,58,3,2,5,60.0%,2h
29218,2,Techmo,2520,30,2,1,3,66.7%,28m
29218,2,Davester,2520,30,2,3,5,40.0%,31m
29218,1,[AntRuS]DenimChicken,2520,0,2,3,5,40.0%,2h
29218,3,BronzeSheik,2520,97,2,4,6,33.3%,1h
29218,3,ldkska,2520,0,2,4,6,33.3%,1h
29218,2,vuoseck,2520,30,2,5,7,28.6%,43m
29218,1,Ramatuscus,2520,120,2,9,11,18.2%,47m
29218,2,BlindWolf,2520,0,1,0,1,100.0%,2h
29218,3,RockyStone,2520,0,1,0,1,100.0%,2h
29218,1,MGUPCHIEN,2520,0,1,0,1,100.0%,2h
29218,2,[NM8]Buckeye,2520,0,1,1,2,50.0%,2h
29218,2,Goose,2520,0,1,1,2,50.0%,2h
29218,2,mgspunk,2520,38,1,5,6,16.7%,20m
29218,3,Kuro,2520,0,0,1,1,0.0%,1h
29218,3,Lucky,2520,0,0,1,1,0.0%,2h
29218,2,TioTonio,2520,0,0,1,1,0.0%,32m
29218,2,babyknight,2520,0,0,1,1,0.0%,1h
29218,2,[SWOU]Wbrz,2520,0,0,1,1,0.0%,33m
29255,1,fernasiy,2519,1567,537,531,1068,50.3%,7m
29255,1,[3M2]Zodiac,2519,1608,151,144,295,51.2%,16m
29255,3,METRIKAL,2519,1602,91,83,174,52.3%,26m
29255,1,Grimmage,2519,1054,85,93,178,47.8%,44m
29255,2,HalconNegro,2519,1183,58,52,110,52.7%,4m
29255,2,Atlas,2519,867,49,35,84,58.3%,2h
29255,2,Naltherion,2519,955,40,44,84,47.6%,33m
29255,2,[Alarak]Nurrdeer,2519,904,35,38,73,47.9%,9m
29255,3,Mook,2519,716,30,27,57,52.6%,1h
29255,2,Majic,2519,511,22,12,34,64.7%,2h
29255,2,Eldrad,2519,331,15,16,31,48.4%,1h
29255,1,[Y0Y0]HoneyBadger,2519,366,13,16,29,44.8%,37m
29255,3,GranLouis,2519,134,9,4,13,69.2%,3m
29255,2,Topsideolive,2519,205,6,8,14,42.9%,7m
29255,2,Scootydooter,2519,120,4,1,5,80.0%,5m
29255,3,KarateKid,2519,120,4,3,7,57.1%,2h
29255,2,AlexysRY,2519,70,3,4,7,42.9%,21m
29255,3,[neuroW]waterydirt,2519,123,3,5,8,37.5%,3h
29255,1,[SNOW1]EBeast,2519,0,2,3,5,40.0%,50m
29255,2,Moose,2519,0,2,4,6,33.3%,1h
29255,2,Haseo,2519,0,1,2,3,33.3%,16m
29255,1,MikeyTrump,2519,0,1,3,4,25.0%,2h
29255,1,pls,2519,0,1,6,7,14.3%,2h
29255,3,PsychoToss,2519,0,0,1,1,0.0%,2h
29279,1,Bloodshedy,2518,1572,207,200,407,50.9%,49m
29279,2,Wiebles,2518,1480,136,138,274,49.6%,1h
29279,2,Killz,2518,1613,66,67,133,49.6%,32m
29279,3,PINKSTARFISH,2518,1575,60,70,130,46.2%,10m
29279,3,Hyrax,2518,1332,55,49,104,52.9%,3h
29279,1,LesterHolmz,2518,1130,38,48,86,44.2%,20m
29279,1,RazerTeran,2518,792,31,30,61,50.8%,3h
29279,1,[SCX2]BakiHanma,2518,777,30,29,59,50.8%,1h
29279,2,[zeez]DQuad,2518,719,29,19,48,60.4%,5m
29279,3,PooHerder,2518,450,18,7,25,72.0%,2h
29279,2,[Kusshh]COCOLITO,2518,366,17,16,33,51.5%,2h
29279,2,Sandinista,2518,141,6,6,12,50.0%,2h
29279,2,[DarkPG]Akyaabil,2518,166,6,7,13,46.2%,2h
29279,2,[ØÛ]Alxa,2518,141,5,2,7,71.4%,25m
29279,3,Zeus,2518,120,4,3,7,57.1%,2h
29279,1,OxDEADBEEF,2518,48,4,8,12,33.3%,49m
29279,1,Rodrigo,2518,148,4,8,12,33.3%,2h
29279,3,[P3T3S]Avicknash,2518,0,3,3,6,50.0%,2h
29279,3,Robs,2518,97,3,3,6,50.0%,37m
29279,2,Yeezus,2518,90,3,6,9,33.3%,1h
29279,3,Duchess,2518,36,3,6,9,33.3%,2h
29279,2,TGK,2518,34,2,2,4,50.0%,28m
29279,2,[PATM]Typhoon,2518,0,1,1,2,50.0%,15m
29279,2,Spetsnaz,2518,88,1,1,2,50.0%,2h
29279,2,Vespasian,2518,95,1,3,4,25.0%,2h
29279,2,Shless,2518,0,1,5,6,16.7%,25m
29279,3,salimama,2518,0,0,1,1,0.0%,2h
29279,3,Ascendacy,2518,0,0,1,1,0.0%,1h
29279,2,JMS,2518,0,0,2,2,0.0%,32m
29308,2,Brandon,2517,1624,170,156,326,52.1%,17m
29308,1,Wingbox,2517,1247,56,42,98,57.1%,2h
29308,2,TinfoilHat,2517,1108,53,41,94,56.4%,2h
29308,2,[KGH4]SirJohny,2517,1347,52,50,102,51.0%,4m
29308,2,RobbieBaba,2517,725,35,33,68,51.5%,43m
29308,3,Vicum,2517,653,28,17,45,62.2%,3h
29308,2,ryojavi,2517,565,23,17,40,57.5%,7m
29308,2,Cracken,2517,612,22,26,48,45.8%,2h
29308,2,demetrio,2517,386,16,16,32,50.0%,2h
29308,3,biwie,2517,404,14,13,27,51.9%,2h
29308,2,[vbAD]gauss,2517,371,13,13,26,50.0%,2h
29308,1,Blaster,2517,288,12,13,25,48.0%,15m
29308,2,Dacz,2517,131,10,9,19,52.6%,19m
29308,1,Nerd,2517,222,9,9,18,50.0%,20m
29308,2,[quercu]Nacho,2517,212,7,8,15,46.7%,2h
29308,3,Ghakajin,2517,185,7,13,20,35.0%,51m
29308,2,Blackout,2517,112,5,2,7,71.4%,17m
29308,2,LewsTherin,2517,162,5,5,10,50.0%,1h
29308,3,vnvthedark,2517,145,4,0,4,100.0%,4m
29308,2,eldelicioso,2517,96,3,7,10,30.0%,44m
29308,3,DevilD,2517,58,2,2,4,50.0%,1h
29308,3,XDnUWUnRAWR,2517,0,2,2,4,50.0%,42m
29308,3,[vbAD]noU,2517,0,2,5,7,28.6%,11m
29308,3,[Its]DarcZaFire,2517,97,1,4,5,20.0%,36m
29308,3,Alouiscious,2517,0,0,1,1,0.0%,39m
29308,2,Reaper,2517,0,0,2,2,0.0%,2h
29334,2,antisheep,2516,1089,99,87,186,53.2%,2h
29334,2,Backspace,2516,1506,96,99,195,49.2%,2h
29334,1,Greg,2516,1134,39,43,82,47.6%,7m
29334,2,cuulaid,2516,792,38,31,69,55.1%,2h
29334,2,Cordial,2516,447,20,14,34,58.8%,11m
29334,2,Rickster,2516,426,17,14,31,54.8%,17m
29334,3,[Huffs]Imposter,2516,420,15,9,24,62.5%,2h
29334,2,HungLo,2516,205,13,16,29,44.8%,20m
29334,2,laracraft,2516,388,12,16,28,42.9%,17m
29334,2,[Chbeer]uchiha,2516,278,11,10,21,52.4%,32m
29334,3,xluisitox,2516,204,8,7,15,53.3%,3h
29334,3,[GTFO]Supernova,2516,168,6,3,9,66.7%,2h
29334,2,joc,2516,86,4,5,9,44.4%,11m
29334,2,Zemira,2516,118,4,10,14,28.6%,19m
29334,2,JONES,2516,48,3,2,5,60.0%,17m
29334,3,Jumper,2516,0,3,6,9,33.3%,3m
29334,3,[THlNG]Rakuoha,2516,0,2,3,5,40.0%,1h
29334,1,Enigma,2516,0,2,3,5,40.0%,2h
29334,3,LyfeforChar,2516,0,2,3,5,40.0%,28m
29334,3,Toni,2516,0,2,4,6,33.3%,2h
29334,2,TranQ,2516,34,2,5,7,28.6%,2h
29334,2,holymanz,2516,88,2,5,7,28.6%,50m
29334,3,Thumos,2516,0,1,0,1,100.0%,3m
29334,2,Torbaz,2516,93,1,2,3,33.3%,2h
29334,2,ThiefOfEden,2516,30,1,5,6,16.7%,7m
29334,3,Igorotak,2516,0,0,1,1,0.0%,31m
29360,3,Phos,2515,1438,158,155,313,50.5%,31m
29360,3,jclee,2515,1532,75,81,156,48.1%,12m
29360,2,[Sn50]PsiLon,2515,1049,58,54,112,51.8%,2h
29360,1,Miky,2515,620,31,41,72,43.1%,2h
29360,2,Marco,2515,610,22,25,47,46.8%,45m
29360,2,[GTO4]AkhunDelar,2515,534,21,15,36,58.3%,16m
29360,3,glhfImTroll,2515,281,13,13,26,50.0%,3h
29360,2,EVØLVE,2515,312,12,12,24,50.0%,2h
29360,1,SombraLetal,2515,202,10,8,18,55.6%,1h
29360,2,TheHunger,2515,228,9,6,15,60.0%,25m
29360,1,[PugSqd]Patron,2515,197,8,9,17,47.1%,15m
29360,2,Soap,2515,90,6,7,13,46.2%,32m
29360,3,TheBazinga,2515,30,4,3,7,57.1%,2h
29360,1,[cnuo]Santiago,2515,137,3,0,3,100.0%,12m
29360,3,Creplord,2515,75,3,1,4,75.0%,1h
29360,2,spartan,2515,64,3,4,7,42.9%,1h
29360,1,Gnatally,2515,38,3,7,10,30.0%,2h
29360,3,[eroko]Duke,2515,97,2,0,2,100.0%,34m
29360,1,gearsofwar,2515,0,1,0,1,100.0%,2h
29360,3,QtPotato,2515,30,1,1,2,50.0%,3h
29360,2,RickRossBoss,2515,0,1,2,3,33.3%,17m
29360,3,firebatCosby,2515,0,1,4,5,20.0%,2h
29360,2,Prometheus,2515,0,0,2,2,0.0%,7m
29360,2,[TDirT]BigBowser,2515,0,0,2,2,0.0%,20m
29360,2,bor,2515,0,0,2,2,0.0%,17m
29360,1,ArEs,2515,0,0,3,3,0.0%,2h
29360,2,[Pig2]Kranlor,2515,0,0,6,6,0.0%,1h
29387,1,Pepe,2514,1538,239,272,511,46.8%,16m
29387,3,Marlon,2514,1183,114,123,237,48.1%,18m
29387,1,Prexel,2514,1635,111,111,222,50.0%,2h
29387,3,HogwildMcgee,2514,912,103,102,205,50.2%,9m
29387,1,idontknow,2514,832,40,41,81,49.4%,17m
29387,1,labestia,2514,664,33,20,53,62.3%,2h
29387,2,[PiN0YS]Mithraic,2514,740,28,33,61,45.9%,32m
29387,2,[MSUsc2]YuriMM,2514,383,24,29,53,45.3%,45m
29387,1,CasualBuddha,2514,456,17,20,37,45.9%,23m
29387,1,Phase,2514,493,16,20,36,44.4%,32m
29387,2,Lathorius,2514,161,6,5,11,54.5%,31m
29387,3,Pierasoo,2514,162,5,1,6,83.3%,10m
29387,2,TiananmenV,2514,103,5,3,8,62.5%,2h
29387,1,Psycho,2514,181,5,7,12,41.7%,2h
29387,2,PiPPiNRuDeS,2514,122,4,6,10,40.0%,36m
29387,2,jackdaddy,2514,44,4,6,10,40.0%,16m
29387,3,Tasonir,2514,119,3,2,5,60.0%,2h
29387,2,Parzival,2514,88,3,6,9,33.3%,17m
29387,2,winning,2514,92,2,2,4,50.0%,2h
29387,2,[TKU101]mbeezy,2514,58,2,4,6,33.3%,32m
29387,3,MajorSpeed,2514,0,2,5,7,28.6%,14m
29387,3,DruNkeNLeMuR,2514,0,2,5,7,28.6%,1h
29387,3,Soleus,2514,0,1,0,1,100.0%,11m
29387,3,Skepticalguy,2514,0,1,0,1,100.0%,3h
29387,3,[AD3C]Draco,2514,0,1,0,1,100.0%,42m
29387,3,Jurachi,2514,30,1,1,2,50.0%,2h
29387,2,Grandloth,2514,88,1,2,3,33.3%,1h
29387,2,SleepyBear,2514,30,1,3,4,25.0%,2h
29387,3,[umadID]BlackWidow,2514,96,1,5,6,16.7%,28m
29387,3,Logeeker,2514,0,0,1,1,0.0%,1h
29387,3,Apollozaz,2514,0,0,1,1,0.0%,17m
29387,3,Wake,2514,0,0,2,2,0.0%,39m
29387,2,Knohart,2514,0,0,2,2,0.0%,2h
29387,1,Warsnake,2514,0,0,8,8,0.0%,2h
29421,2,tortuga,2513,1603,160,170,330,48.5%,2h
29421,2,Megatron,2513,990,110,106,216,50.9%,21m
29421,3,Aspy,2513,289,37,27,64,57.8%,44m
29421,2,Goku,2513,372,28,24,52,53.8%,4m
29421,1,[LprtsK]Pablitem,2513,596,21,26,47,44.7%,2h
29421,2,[NeMOP]vdmai,2513,380,15,15,30,50.0%,43m
29421,1,TheJangler,2513,299,7,9,16,43.8%,41m
29421,2,NoInnovation,2513,239,7,11,18,38.9%,2h
29421,3,[D3MON]Jestorick,2513,146,6,4,10,60.0%,42m
29421,3,[EDBPN]iScarLxrd,2513,191,5,2,7,71.4%,2h
29421,3,Jezus,2513,139,4,5,9,44.4%,2h
29421,3,Vituxesh,2513,30,4,7,11,36.4%,31m
29421,3,ritual,2513,88,2,1,3,66.7%,2h
29421,3,[LQV]Blackwing,2513,58,2,3,5,40.0%,34m
29421,1,wEMBLI,2513,0,2,3,5,40.0%,2h
29421,3,Fluffy,2513,0,1,2,3,33.3%,18m
29421,1,Terminator,2513,0,1,2,3,33.3%,2h
29421,1,blandboss,2513,88,1,4,5,20.0%,2h
29421,2,[CryTek]ILLUMINATED,2513,30,1,5,6,16.7%,17m
29421,3,MrBerry,2513,0,0,1,1,0.0%,26m
29421,3,Narwhal,2513,0,0,1,1,0.0%,2h
29421,2,JaggerJack,2513,0,0,2,2,0.0%,42m
29421,2,DarkShroud,2513,0,0,5,5,0.0%,2h
29444,2,AGR,2512,1571,107,90,197,54.3%,50m
29444,1,Velath,2512,1215,85,84,169,50.3%,2h
29444,1,xkenshinx,2512,1634,67,68,135,49.6%,2h
29444,3,yaboiii,2512,541,21,20,41,51.2%,11m
29444,2,[INXS]Mycroft,2512,441,18,15,33,54.5%,46m
29444,1,[DoRQ]Ripley,2512,422,14,17,31,45.2%,2h
29444,2,Bemo,2512,276,10,12,22,45.5%,2h
29444,2,Jimmy,2512,86,7,5,12,58.3%,13m
29444,1,MrChimmie,2512,149,7,8,15,46.7%,43m
29444,3,SrJoSe,2512,145,5,1,6,83.3%,34m
29444,2,Andrsito,2512,124,5,6,11,45.5%,2h
29444,1,AngeLook,2512,163,5,8,13,38.5%,25m
29444,1,[theNF]AiMTwOeXHaLe,2512,120,5,9,14,35.7%,3h
29444,2,[sLlpk]Ulra,2512,138,4,2,6,66.7%,2h
29444,2,NMsinse,2512,162,4,5,9,44.4%,2h
29444,1,Hoz,2512,64,4,8,12,33.3%,2h
29444,2,[SCVM]DespritLoon,2512,102,3,1,4,75.0%,16m
29444,2,Admiral,2512,60,3,2,5,60.0%,1h
29444,1,Vandire,2512,131,3,2,5,60.0%,2h
29444,3,VeteranToker,2512,30,2,0,2,100.0%,2h
29444,2,GeauxFast,2512,102,2,2,4,50.0%,16m
29444,3,BagOfLettuce,2512,30,2,5,7,28.6%,1h
29444,3,darinel,2512,0,1,0,1,100.0%,49m
29444,3,[SDRZK]ARgelRzk,2512,32,1,2,3,33.3%,42m
29444,3,[UpxV]DarkSoul,2512,30,1,9,10,10.0%,24m
29444,3,[LgnTDS]Azulbi,2512,0,0,1,1,0.0%,2h
29444,2,Whitey,2512,0,0,4,4,0.0%,45m
29471,3,lIlIlIIIIIII,2511,1449,251,249,500,50.2%,29m
29471,1,HardOffender,2511,1045,69,61,130,53.1%,35m
29471,2,OIIIIIIIO,2511,1498,62,62,124,50.0%,28m
29471,1,[2027]fancystar,2511,1320,48,50,98,49.0%,1h
29471,2,Panda,2511,984,42,32,74,56.8%,2h
29471,3,AtomicEarwax,2511,1034,41,35,76,53.9%,36m
29471,2,[LETAL]pap,2511,613,23,21,44,52.3%,21m
29471,1,Jandar,2511,521,17,21,38,44.7%,21m
29471,2,FaceSpanking,2511,428,15,16,31,48.4%,2h
29471,2,HereItComes,2511,358,14,13,27,51.9%,32m
29471,3,Richie,2511,352,12,12,24,50.0%,2h
29471,2,Gabriel,2511,260,11,7,18,61.1%,2h
29471,2,Charon,2511,288,9,9,18,50.0%,2h
29471,3,MiniNinja,2511,174,8,9,17,47.1%,2h
29471,2,Impulse,2511,194,6,6,12,50.0%,2h
29471,3,illuminatist,2511,162,4,2,6,66.7%,2h
29471,1,ImanC,2511,0,4,2,6,66.7%,2h
29471,2,Censored,2511,90,4,5,9,44.4%,2h
29471,2,Mutedhorn,2511,102,3,5,8,37.5%,33m
29471,3,[KaCr]SkeletonKey,2511,0,2,4,6,33.3%,1h
29471,1,[GSP0T]Gaben,2511,91,1,1,2,50.0%,12m
29471,2,[2xGNGR]Shoosh,2511,0,1,3,4,25.0%,2h
29471,3,jader,2511,0,0,1,1,0.0%,28m
29471,3,Achilles,2511,0,0,1,1,0.0%,2h
29471,3,peepeepoopoo,2511,0,0,1,1,0.0%,25m
29471,3,[Zno]yomama,2511,0,0,1,1,0.0%,2h
29497,2,xxbongsmoker,2510,1618,86,78,164,52.4%,32m
29497,2,xFistedHobox,2510,1043,80,78,158,50.6%,1h
29497,1,SIRTOKEALOT,2510,810,43,47,90,47.8%,38m
29497,3,Schnitz,2510,894,40,40,80,50.0%,42m
29497,2,XvaT,2510,773,30,26,56,53.6%,28m
29497,2,[RAINBO]Touchoflove,2510,640,22,25,47,46.8%,2h
29497,2,King,2510,535,21,20,41,51.2%,32m
29497,2,MrFreeze,2510,580,21,21,42,50.0%,7m
29497,2,Probinho,2510,458,18,12,30,60.0%,1h
29497,1,ZEN,2510,539,18,23,41,43.9%,1h
29497,2,Pablotes,2510,421,17,13,30,56.7%,36m
29497,1,Alejandro,2510,460,17,19,36,47.2%,15m
29497,1,hades,2510,122,9,11,20,45.0%,39m
29497,2,TrumpFTW,2510,310,9,14,23,39.1%,2h
29497,3,HyperionX,2510,204,8,6,14,57.1%,2h
29497,3,[GØ]Lemurian,2510,233,7,2,9,77.8%,1h
29497,3,Oozawr,2510,88,6,8,14,42.9%,25m
29497,3,Voidsworth,2510,160,5,3,8,62.5%,2h
29497,3,[Xe1nal]SkyWalker,2510,140,5,4,9,55.6%,2h
29497,3,ropzfan,2510,0,3,2,5,60.0%,50m
29497,2,[dg3n]Nylon,2510,102,3,2,5,60.0%,2h
29497,3,STiLED,2510,0,2,4,6,33.3%,1h
29497,3,unsoldepan,2510,0,2,4,6,33.3%,2h
29497,3,Hipley,2510,0,1,1,2,50.0%,2h
29497,3,[Po0pY]Nostrils,2510,0,1,2,3,33.3%,2h
29497,2,[ProSC]Angelo,2510,30,1,4,5,20.0%,1h
29497,3,[hxhchi]Espectrum,2510,0,0,1,1,0.0%,2h
29497,3,longruner,2510,0,0,1,1,0.0%,28m
29525,2,BigRic,2509,1574,191,188,379,50.4%,2h
29525,3,amazingsax,2509,1241,63,41,104,60.6%,2h
29525,3,Asha,2509,276,62,50,112,55.4%,26m
29525,1,[MPA]Mexpipe,2509,1049,52,58,110,47.3%,38m
29525,1,NewBone,2509,1215,51,50,101,50.5%,3h
29525,2,[DARKCO]radiocraft,2509,493,45,42,87,51.7%,19m
29525,1,Kshooter,2509,544,44,52,96,45.8%,34m
29525,2,[LgnTDS]Ovis,2509,930,39,36,75,52.0%,32m
29525,1,ObiTrice,2509,981,36,41,77,46.8%,20m
29525,3,KingOfPop,2509,977,36,44,80,45.0%,24m
29525,3,[TJFK]kingsblood,2509,520,21,18,39,53.8%,50m
29525,2,[Venudo]FLEIA,2509,436,19,10,29,65.5%,2h
29525,2,Sjet,2509,494,18,20,38,47.4%,2h
29525,2,Wuzsubi,2509,438,17,17,34,50.0%,32m
29525,3,Mope,2509,337,13,11,24,54.2%,2h
29525,2,[MFNS]PiKe,2509,230,9,3,12,75.0%,2h
29525,1,[nSGI]alwaysTrigrd,2509,209,9,10,19,47.4%,2h
29525,2,Ono,2509,100,4,6,10,40.0%,1h
29525,2,[Canti]MallaMike,2509,124,4,8,12,33.3%,2h
29525,3,[N2D]HybridPanda,2509,36,3,5,8,37.5%,2h
29525,3,Leosin,2509,30,2,1,3,66.7%,2h
29525,3,[XpKAc]alberto,2509,0,1,0,1,100.0%,2h
29525,3,BakedBean,2509,0,1,0,1,100.0%,14m
29525,2,lucasini,2509,0,1,1,2,50.0%,18m
29525,2,husty,2509,95,1,2,3,33.3%,33m
29525,3,chupacabras,2509,0,1,2,3,33.3%,34m
29525,3,systomasys,2509,97,1,2,3,33.3%,14m
29525,2,[YetiFC]DrkYeti,2509,30,1,4,5,20.0%,32m
29525,3,codingly,2509,0,0,1,1,0.0%,10m
29525,2,Krutk,2509,0,0,2,2,0.0%,15m
29555,2,[SGCC]ReaperGRiM,2508,1591,411,416,827,49.7%,2h
29555,3,Shag,2508,1472,174,174,348,50.0%,39m
29555,1,[SLKNM]RainbowTOOL,2508,1334,167,166,333,50.2%,2h
29555,1,TOM,2508,1597,107,98,205,52.2%,2h
29555,1,[PERGT]WilliaM,2508,1179,56,54,110,50.9%,2h
29555,2,Adep,2508,650,29,24,53,54.7%,50m
29555,2,mIKE,2508,700,25,26,51,49.0%,49m
29555,3,[IMDSI]DonFiDeoS,2508,612,24,20,44,54.5%,30m
29555,3,WizardDog,2508,640,24,24,48,50.0%,28m
29555,3,RoorinRyan,2508,306,20,15,35,57.1%,2h
29555,2,Storm,2508,400,15,15,30,50.0%,2h
29555,3,dark,2508,322,11,7,18,61.1%,45m
29555,1,CDONE,2508,306,9,19,28,32.1%,15m
29555,2,OuRenjie,2508,221,7,10,17,41.2%,36m
29555,1,eve,2508,66,5,7,12,41.7%,2h
29555,2,Pachanko,2508,154,4,4,8,50.0%,2h
29555,1,kkoma,2508,104,4,10,14,28.6%,3h
29555,3,[AD3C]HeavenSDevil,2508,88,3,2,5,60.0%,2h
29555,2,nightscall,2508,94,2,1,3,66.7%,4m
29555,3,SuperNova,2508,58,2,1,3,66.7%,10m
29555,2,CoolguyAL,2508,0,1,1,2,50.0%,2h
29555,2,Henritus,2508,89,1,2,3,33.3%,2h
29555,3,gsonerdxoxo,2508,0,1,6,7,14.3%,2h
29555,3,SevenTwentyP,2508,0,0,1,1,0.0%,45m
29555,3,[4K4K4K]TelaEnBanano,2508,0,0,1,1,0.0%,10m
29555,3,DrugFreeBoy,2508,0,0,2,2,0.0%,30m
29555,3,SlimSaxxy,2508,0,0,5,5,0.0%,2h
29582,3,BeanlyOrange,2507,1465,213,219,432,49.3%,37m
29582,1,hydro,2507,1544,118,118,236,50.0%,2h
29582,2,LoTuSsSs,2507,757,29,30,59,49.2%,2h
29582,1,ByunsUncle,2507,798,28,31,59,47.5%,2h
29582,2,[TGosuC]Mirage,2507,590,22,24,46,47.8%,2h
29582,2,[Elemnt]AlxStormFist,2507,486,20,24,44,45.5%,19m
29582,2,daddykisser,2507,482,20,25,45,44.4%,2h
29582,2,[FUFXx]IIIIIIIIIIII,2507,414,15,18,33,45.5%,46m
29582,2,[Giorg]Sergiojj,2507,263,11,8,19,57.9%,2h
29582,2,[Test42]CodyB,2507,256,10,6,16,62.5%,2h
29582,2,TomCruiser,2507,229,8,6,14,57.1%,5m
29582,2,Mauloco,2507,149,6,8,14,42.9%,32m
29582,3,[SoKiLi]DggrJ,2507,140,5,1,6,83.3%,18m
29582,3,TeaQuickly,2507,90,4,2,6,66.7%,42m
29582,2,zergkiller,2507,90,4,3,7,57.1%,32m
29582,2,BirdmanXD,2507,126,3,3,6,50.0%,2h
29582,3,HarlemShake,2507,0,3,5,8,37.5%,12m
29582,3,ElMojooN,2507,0,3,5,8,37.5%,15m
29582,3,Dango,2507,0,2,3,5,40.0%,2h
29582,3,jorgezno,2507,0,1,0,1,100.0%,30m
29582,2,alejocometa,2507,0,1,1,2,50.0%,2h
29582,2,[TPGGXD]jhair,2507,30,1,3,4,25.0%,17m
29582,1,[OOCG]sycoticjason,2507,0,1,4,5,20.0%,24m
29582,2,VoidCugar,2507,0,1,4,5,20.0%,44m
29582,3,FatSquanchy,2507,0,1,6,7,14.3%,5m
29582,1,[xXxVxX]Gnix,2507,0,0,1,1,0.0%,2h
29582,3,stalker,2507,0,0,1,1,0.0%,2h
29582,2,JarJar,2507,0,0,2,2,0.0%,2h
29582,3,Shadows,2507,0,0,3,3,0.0%,17m
29582,2,[MickyD]MacForBLT,2507,0,0,3,3,0.0%,5m
29582,3,GrumpyKitten,2507,0,0,3,3,0.0%,33m
29613,2,Soondae,2506,1581,124,107,231,53.7%,18m
29613,2,MENGSK,2506,805,53,50,103,51.5%,1h
29613,2,[PWands]GallardoO,2506,1094,48,34,82,58.5%,2h
29613,1,JakAttK,2506,810,27,31,58,46.6%,42m
29613,3,CORSARIO,2506,644,24,24,48,50.0%,3m
29613,2,DonComedia,2506,323,22,12,34,64.7%,31m
29613,3,[ONG]SUPAI,2506,366,20,12,32,62.5%,10m
29613,2,poe,2506,554,20,20,40,50.0%,2h
29613,3,HeartOfHate,2506,426,19,22,41,46.3%,20m
29613,3,BlueTopaz,2506,200,10,3,13,76.9%,24m
29613,2,NOBODY,2506,176,9,9,18,50.0%,1h
29613,2,TIDES,2506,133,6,4,10,60.0%,2h
29613,1,IxooxI,2506,164,6,7,13,46.2%,2h
29613,1,Roscoe,2506,238,6,8,14,42.9%,3h
29613,3,[ZFMs]Sicario,2506,36,2,0,2,100.0%,24m
29613,2,[TKRP]LoganBr,2506,0,2,4,6,33.3%,1h
29613,3,TorchDelta,2506,0,2,4,6,33.3%,2h
29613,2,[YouNo]BaitsbyDre,2506,60,2,6,8,25.0%,32m
29613,2,Pumpkin,2506,60,2,7,9,22.2%,2h
29613,3,[XerQ]SteeZ,2506,0,1,0,1,100.0%,2h
29613,2,HydroSpectre,2506,0,1,0,1,100.0%,2h
29613,1,KoolAidLings,2506,0,1,6,7,14.3%,42m
29613,3,naive,2506,0,0,1,1,0.0%,3h
29613,3,Danium,2506,0,0,1,1,0.0%,10m
29613,2,draihl,2506,0,0,2,2,0.0%,46m
29638,1,DarcStar,2505,1603,204,196,400,51.0%,2h
29638,2,[LCE]LexJauregui,2505,1430,110,109,219,50.2%,5m
29638,1,Apolum,2505,1503,74,67,141,52.5%,22m
29638,2,[LVTEAM]Escipion,2505,792,60,45,105,57.1%,2h
29638,2,[cluez]Hastur,2505,805,54,50,104,51.9%,2h
29638,2,[MSganG]Shazrock,2505,1236,46,51,97,47.4%,7m
29638,3,[123125]Temination,2505,891,45,5,50,90.0%,34m
29638,2,Wilblur,2505,959,43,35,78,55.1%,17m
29638,1,BARCODE,2505,547,38,34,72,52.8%,2h
29638,2,Airellis,2505,787,33,28,61,54.1%,2h
29638,3,Touchingz,2505,750,29,23,52,55.8%,3m
29638,2,Redmerlin,2505,466,21,15,36,58.3%,32m
29638,1,Emet,2505,415,21,22,43,48.8%,2h
29638,1,Durden,2505,322,11,19,30,36.7%,2h
29638,3,haribro,2505,291,10,11,21,47.6%,26m
29638,2,NovaStar,2505,200,10,14,24,41.7%,28m
29638,3,RabbidLesbo,2505,179,9,2,11,81.8%,3h
29638,3,[Nighbr]Statric,2505,251,9,13,22,40.9%,1h
29638,2,Luras,2505,210,8,11,19,42.1%,1h
29638,3,Scalaburn,2505,146,7,2,9,77.8%,2h
29638,2,AONEC,2505,190,7,7,14,50.0%,2h
29638,2,[UFIS]Kabadi,2505,154,5,9,14,35.7%,32m
29638,3,DownyFlames,2505,119,4,3,7,57.1%,2h
29638,3,LitMinder,2505,122,2,2,4,50.0%,37m
29638,2,[DgDzNt]Trogdor,2505,0,1,1,2,50.0%,36m
29638,2,Virtue,2505,0,1,11,12,8.3%,14m
29638,3,Danny,2505,0,0,1,1,0.0%,2h
29638,3,[LAT18]Sval,2505,0,0,1,1,0.0%,45m
29638,2,vuitron,2505,0,0,1,1,0.0%,2h
29667,1,nOObTropiK,2504,1629,93,104,197,47.2%,15m
29667,2,[cuak64]Varbeast,2504,843,44,39,83,53.0%,33m
29667,2,Spud,2504,297,14,9,23,60.9%,11m
29667,2,JOHNBOY,2504,293,10,12,22,45.5%,32m
29667,1,Honda,2504,140,10,18,28,35.7%,2h
29667,2,HasLeft,2504,230,8,9,17,47.1%,16m
29667,3,[Z1O1]MLordSkyler,2504,140,6,2,8,75.0%,11m
29667,2,Firedome,2504,212,6,9,15,40.0%,3h
29667,2,llllllllllll,2504,212,6,12,18,33.3%,2h
29667,2,Terrydactyl,2504,157,5,2,7,71.4%,28m
29667,3,[Fl4ams]Ibrahim,2504,161,5,2,7,71.4%,39m
29667,2,Glazed,2504,180,5,3,8,62.5%,49m
29667,2,Sugar,2504,165,5,4,9,55.6%,34m
29667,1,MrToss,2504,175,5,7,12,41.7%,48m
29667,2,[VL31]Daviid,2504,140,3,4,7,42.9%,33m
29667,1,BakedLizard,2504,118,3,7,10,30.0%,2h
29667,2,Sandbag,2504,0,2,4,6,33.3%,4m
29667,2,Redbeard,2504,0,2,4,6,33.3%,2h
29667,1,DeceiT,2504,0,2,6,8,25.0%,2h
29667,2,Friesanyone,2504,0,1,1,2,50.0%,2h
29667,3,[ChiFan]Quetzal,2504,0,0,1,1,0.0%,2h
29688,3,[ShiPal]DrNexium,2503,1246,71,58,129,55.0%,14m
29688,1,Butlera,2503,657,63,55,118,53.4%,1h
29688,3,ahdes,2503,912,35,39,74,47.3%,32m
29688,2,NoJokeMstDpe,2503,481,21,18,39,53.8%,32m
29688,2,Zephyr,2503,427,19,15,34,55.9%,2h
29688,3,dune,2503,493,19,16,35,54.3%,1h
29688,2,Rajauskas,2503,343,13,10,23,56.5%,32m
29688,2,youngrichc,2503,289,11,14,25,44.0%,14m
29688,1,TÝR,2503,249,10,11,21,47.6%,2h
29688,2,TomTheBoom,2503,200,10,14,24,41.7%,30m
29688,2,Sorrow,2503,116,6,7,13,46.2%,2h
29688,2,escudero,2503,192,5,6,11,45.5%,45m
29688,3,Howades,2503,121,3,5,8,37.5%,2h
29688,1,Polly,2503,0,3,7,10,30.0%,3h
29688,3,Lastexit,2503,58,2,3,5,40.0%,2h
29688,3,ForestKing,2503,0,2,4,6,33.3%,36m
29688,3,[atrox]ZimbobwayOrp,2503,0,2,5,7,28.6%,14m
29688,2,[FWS]Sora,2503,60,2,6,8,25.0%,28m
29688,3,Ryan,2503,0,1,0,1,100.0%,2h
29688,2,Atila,2503,30,1,3,4,25.0%,1h
29688,2,JeveStobs,2503,34,1,5,6,16.7%,1h
29688,3,GlaDiaToR,2503,0,0,1,1,0.0%,1h
29688,3,maxrhcp,2503,0,0,1,1,0.0%,3h
29688,2,pcisbest,2503,0,0,2,2,0.0%,43m
29688,2,Veigas,2503,0,0,4,4,0.0%,2h
29688,2,[GnR]happybythree,2503,0,0,5,5,0.0%,2h
29714,1,spectrum,2502,1542,135,137,272,49.6%,2h
29714,3,PraetorianB,2502,442,93,81,174,53.4%,40m
29714,2,[TY4GG]Stogen,2502,1654,81,73,154,52.6%,3h
29714,2,PipeMadafaka,2502,843,67,47,114,58.8%,2h
29714,3,EddardStark,2502,1404,52,65,117,44.4%,36m
29714,2,KahlForPrez,2502,686,28,23,51,54.9%,11m
29714,1,[EBAGmn]QuechoPulga,2502,607,24,26,50,48.0%,2h
29714,2,[kins]Joskin,2502,358,13,13,26,50.0%,1h
29714,2,[DarkC]BigCharles,2502,144,13,15,28,46.4%,22m
29714,3,[Mlnz]Panander,2502,293,10,5,15,66.7%,2h
29714,2,Cuckophany,2502,294,10,9,19,52.6%,2h
29714,3,Zeuz,2502,226,8,2,10,80.0%,2h
29714,3,[SBINC]SoiBoi,2502,190,5,1,6,83.3%,1h
29714,3,MrMiyagi,2502,140,5,2,7,71.4%,2h
29714,3,[1E100]Atlantean,2502,144,5,3,8,62.5%,3h
29714,3,BigMath,2502,150,5,8,13,38.5%,27m
29714,1,CptSpinout,2502,60,4,4,8,50.0%,27m
29714,3,Valkyrie,2502,30,4,6,10,40.0%,23m
29714,1,Chuckles,2502,66,4,7,11,36.4%,1h
29714,3,asix,2502,0,3,2,5,60.0%,2h
29714,1,Overmiind,2502,150,3,5,8,37.5%,27m
29714,3,danner,2502,0,1,0,1,100.0%,37m
29714,3,eduardo,2502,30,1,1,2,50.0%,39m
29714,3,IAMTHATIAM,2502,18,1,16,17,5.9%,25m
29714,2,Jeyplay,2502,0,0,2,2,0.0%,1h
29714,2,[TGCrew]koszonom,2502,0,0,2,2,0.0%,7m
29740,1,[TGosuD]Fullmetal,2501,1343,117,97,214,54.7%,2h
29740,2,notabarcode,2501,637,111,104,215,51.6%,46m
29740,2,Losche,2501,824,74,68,142,52.1%,28m
29740,2,ThizzFace,2501,399,48,36,84,57.1%,16m
29740,3,oxidonítrico,2501,1002,44,38,82,53.7%,35m
29740,2,MysticRacer,2501,1022,39,36,75,52.0%,16m
29740,2,UnOso,2501,571,35,33,68,51.5%,2h
29740,1,Xnimous,2501,449,34,39,73,46.6%,2h
29740,2,[INKA5]ElGatoGordo,2501,684,27,25,52,51.9%,32m
29740,3,NeDo,2501,634,24,23,47,51.1%,2h
29740,2,Kroeker,2501,532,20,18,38,52.6%,4m
29740,3,cooking,2501,497,18,11,29,62.1%,33m
29740,2,[PPQQ]Rump,2501,497,18,19,37,48.6%,31m
29740,2,bourne,2501,306,16,18,34,47.1%,34m
29740,2,BelowAvg,2501,271,12,3,15,80.0%,3h
29740,2,Denim,2501,191,6,5,11,54.5%,2h
29740,2,[TGosuA]DookieButter,2501,150,5,8,13,38.5%,2h
29740,3,Juancho,2501,62,5,8,13,38.5%,38m
29740,1,criss,2501,146,5,8,13,38.5%,2h
29740,2,Luke,2501,88,4,5,9,44.4%,2h
29740,2,WalterWhite,2501,149,4,5,9,44.4%,2h
29740,3,ARTORIUS,2501,58,3,1,4,75.0%,2h
29740,2,gabrieleitor,2501,149,3,4,7,42.9%,15m
29740,1,[Lp]Nyker,2501,48,2,3,5,40.0%,25m
29740,1,Anialater,2501,48,2,4,6,33.3%,47m
29740,2,[WLD1s]Katsa,2501,30,2,4,6,33.3%,2h
29740,2,Jeff,2501,0,1,5,6,16.7%,2h
29740,3,[SC2PL]Bleak,2501,0,0,1,1,0.0%,45m
29768,3,[nieBla]Skull,2500,1444,61,42,103,59.2%,2h
29768,2,STEVE,2500,872,43,26,69,62.3%,17m
29768,2,JMV,2500,773,33,30,63,52.4%,5m
29768,2,EroLesbian,2500,700,28,28,56,50.0%,3h
29768,1,Chandl,2500,639,21,28,49,42.9%,34m
29768,1,Lozz,2500,586,18,28,46,39.1%,1h
29768,2,[b33f]Upchuck,2500,263,17,12,29,58.6%,2h
29768,2,Moscadx,2500,380,16,13,29,55.2%,2h
29768,3,Azathoth,2500,380,13,15,28,46.4%,3h
29768,3,Deces,2500,270,11,14,25,44.0%,47m
29768,1,Terra,2500,230,10,14,24,41.7%,10m
29768,3,[LTWAR]bsap,2500,94,8,11,19,42.1%,1h
29768,3,MitchConner,2500,219,7,7,14,50.0%,2h
29768,3,LiLFunNy,2500,175,7,8,15,46.7%,35m
29768,2,Elpatas,2500,242,7,9,16,43.8%,19m
29768,2,anuk,2500,92,6,11,17,35.3%,40m
29768,2,Starcrap,2500,140,5,7,12,41.7%,50m
29768,1,DdAlDdAl,2500,30,3,7,10,30.0%,15m
29768,3,Razul,2500,30,2,0,2,100.0%,49m
29768,3,Red,2500,96,2,4,6,33.3%,2h
29768,3,ismael,2500,0,1,0,1,100.0%,1h
29768,2,[Z69]SpacedDude,2500,0,1,1,2,50.0%,15m
29768,2,[gumba]THEreaper,2500,0,1,1,2,50.0%,2h
29768,2,retune,2500,0,1,4,5,20.0%,2h
29768,3,Kidsey,2500,0,0,1,1,0.0%,20m
29768,3,[sa1t]AlphaDog,2500,0,0,1,1,0.0%,2h
29794,1,LillysDdy,2499,1633,750,765,1515,49.5%,2h
29794,1,Woden,2499,1630,158,150,308,51.3%,2h
29794,2,KMU,2499,1523,151,142,293,51.5%,2h
29794,1,Girotzu,2499,1498,94,86,180,52.2%,15m
29794,1,Elric,2499,1007,86,87,173,49.7%,2h
29794,3,Lllllluke,2499,897,54,53,107,50.5%,4m
29794,2,[STBs54]magasho,2499,788,38,34,72,52.8%,2h
29794,1,ANTHOLOGY,2499,582,38,35,73,52.1%,31m
29794,3,GrimFate,2499,482,20,6,26,76.9%,3h
29794,3,Pantybottom,2499,519,19,21,40,47.5%,36m
29794,2,mezmarize,2499,466,19,23,42,45.2%,22m
29794,3,Jubiaba,2499,376,15,3,18,83.3%,2h
29794,2,[CPN]ThurQuan,2499,363,14,19,33,42.4%,19m
29794,3,[senKta]Dainmishima,2499,205,9,5,14,64.3%,2h
29794,2,[NKW]Crosen,2499,232,9,5,14,64.3%,16m
29794,2,[SWOU]ISAEL,2499,204,9,8,17,52.9%,2h
29794,2,wolf,2499,238,8,7,15,53.3%,2h
29794,2,TreefurHighe,2499,156,7,2,9,77.8%,2h
29794,1,[TOG]DruidProtoss,2499,168,5,14,19,26.3%,48m
29794,3,trainednoob,2499,30,4,7,11,36.4%,9m
29794,3,INSOLID,2499,60,3,1,4,75.0%,1h
29794,3,kai,2499,60,3,2,5,60.0%,30m
29794,2,mcxlee,2499,140,3,4,7,42.9%,32m
29794,2,PandaShampoo,2499,88,2,2,4,50.0%,44m
29794,3,[TxT]Rinn,2499,0,1,0,1,100.0%,40m
29794,3,Killface,2499,30,1,1,2,50.0%,2h
29794,3,Arcei,2499,97,1,2,3,33.3%,1h
29794,3,slash,2499,0,1,4,5,20.0%,35m
29794,3,FourtyFives,2499,0,1,4,5,20.0%,2h
29794,3,GrimReaper,2499,0,1,5,6,16.7%,2h
29794,1,[SWOU]XxXFlashXxX,2499,36,1,11,12,8.3%,20m
29794,3,RAY,2499,0,0,2,2,0.0%,2h
29794,2,OrKKA,2499,0,0,3,3,0.0%,11m
29794,1,Kwargs,2499,0,0,3,3,0.0%,48m
29828,2,NESTA,2498,1544,163,168,331,49.2%,19m
29828,3,Sillonson,2498,1523,80,86,166,48.2%,9m
29828,1,Hoot,2498,992,51,60,111,45.9%,2h
29828,2,Badcatito,2498,1178,46,41,87,52.9%,2h
29828,1,ZmanZimms,2498,579,18,24,42,42.9%,2h
29828,1,KosEnetek,2498,458,18,26,44,40.9%,33m
29828,2,[LOHd]BigPWNer,2498,430,17,16,33,51.5%,2h
29828,1,[Myaaa]Slothington,2498,294,15,17,32,46.9%,19m
29828,3,[SyLx]hoss,2498,313,13,9,22,59.1%,20m
29828,1,killhoax,2498,398,10,18,28,35.7%,32m
29828,2,AndrePerez,2498,239,8,7,15,53.3%,2h
29828,2,Fragments,2498,256,8,12,20,40.0%,2h
29828,3,Beans,2498,220,6,5,11,54.5%,2h
29828,3,[ZOOMOB]magno,2498,187,6,5,11,54.5%,2h
29828,1,Bob,2498,165,6,10,16,37.5%,49m
29828,3,YALEO,2498,120,5,2,7,71.4%,2h
29828,3,Planchet,2498,0,1,1,2,50.0%,25m
29828,2,santigold,2498,0,1,5,6,16.7%,10m
29828,3,KerrosiveUS,2498,0,0,1,1,0.0%,2h
29828,3,Logan,2498,0,0,1,1,0.0%,27m
29828,3,diegobnrata,2498,0,0,1,1,0.0%,39m
29828,2,ElTrapito,2498,0,0,2,2,0.0%,15m
29828,2,ZachAttack,2498,0,0,2,2,0.0%,43m
29851,2,Finger,2497,1352,105,104,209,50.2%,43m
29851,3,KOSSAZ,2497,1467,89,67,156,57.1%,1h
29851,2,[NtRv]ribarraa,2497,1557,76,71,147,51.7%,46m
29851,2,lzbthb,2497,1485,72,58,130,55.4%,17m
29851,1,Xenocide,2497,1386,56,53,109,51.4%,2h
29851,2,Miles,2497,700,27,26,53,50.9%,49m
29851,2,DonQuiXote,2497,510,25,19,44,56.8%,5m
29851,3,daboss,2497,560,23,26,49,46.9%,39m
29851,3,mojo,2497,480,21,17,38,55.3%,36m
29851,1,RudyGooliani,2497,441,14,22,36,38.9%,2h
29851,2,elchocoo,2497,215,9,8,17,52.9%,2h
29851,3,StoatGobbler,2497,173,8,14,22,36.4%,1h
29851,3,Alucard,2497,99,6,4,10,60.0%,45m
29851,1,Jalopyy,2497,118,5,12,17,29.4%,2h
29851,3,Lastday,2497,97,3,3,6,50.0%,18m
29851,3,BIGBOIJAY,2497,30,2,1,3,66.7%,2h
29851,1,ELITE,2497,0,2,3,5,40.0%,40m
29851,3,WiggleWinnie,2497,0,2,4,6,33.3%,2h
29851,3,WreckCenter,2497,0,1,0,1,100.0%,11m
29851,2,Scantron,2497,0,1,1,2,50.0%,10m
29851,1,ImmatureDust,2497,0,1,4,5,20.0%,2h
29851,3,ChronicAttak,2497,0,0,1,1,0.0%,35m
29851,3,dallreyn,2497,0,0,4,4,0.0%,27m
29874,2,[D0NGL]skyoctopi,2496,1532,157,154,311,50.5%,40m
29874,2,Yiseba,2496,502,25,21,46,54.3%,2h
29874,1,Shifsters,2496,479,20,22,42,47.6%,2h
29874,2,HEREJE,2496,475,18,19,37,48.6%,2h
29874,3,Timalta,2496,470,17,9,26,65.4%,2h
29874,3,FurryTime,2496,371,14,6,20,70.0%,2h
29874,2,tanijuas,2496,368,12,10,22,54.5%,2h
29874,2,Dufrense,2496,307,12,15,27,44.4%,45m
29874,2,DrMuelitas,2496,285,11,11,22,50.0%,34m
29874,2,Winterfall,2496,241,10,10,20,50.0%,2h
29874,2,Chee,2496,219,8,5,13,61.5%,44m
29874,3,TheJackal,2496,189,8,6,14,57.1%,44m
29874,1,[scMAUI]BunnerIsGone,2496,247,8,8,16,50.0%,35m
29874,2,LegendOfLonk,2496,249,8,11,19,42.1%,31m
29874,2,Cheesus,2496,81,7,2,9,77.8%,44m
29874,2,[ZMBELT]FrzStar,2496,90,6,7,13,46.2%,16m
29874,3,[KJedi]BigDuke,2496,148,6,9,15,40.0%,17m
29874,2,GenPurge,2496,199,5,4,9,55.6%,2h
29874,2,KapiKrunch,2496,128,4,3,7,57.1%,4m
29874,1,[CRAKS]ShauN,2496,124,3,5,8,37.5%,2h
29874,2,bigdogg,2496,97,2,1,3,66.7%,2h
29874,1,Cataroux,2496,46,2,2,4,50.0%,5m
29874,3,HumYaiTH,2496,60,2,3,5,40.0%,50m
29874,2,[Bullys]Nyarlathotep,2496,62,2,5,7,28.6%,5m
29874,2,[Sol0]MajinBuu,2496,30,1,3,4,25.0%,2h
29874,3,ETermin,2496,0,0,1,1,0.0%,2h
29874,2,Vizagoth,2496,0,0,1,1,0.0%,34m
29874,3,Wibze,2496,0,0,1,1,0.0%,2h
29902,2,Augustus,2495,1375,197,192,389,50.6%,2h
29902,3,[NLTN]bigdirty,2495,1592,96,96,192,50.0%,12m
29902,2,CHARLIE,2495,1410,87,75,162,53.7%,1h
29902,3,Shan,2495,878,85,88,173,49.1%,15m
29902,3,MarioDevment,2495,1222,49,47,96,51.0%,50m
29902,2,BeefyCow,2495,640,30,25,55,54.5%,40m
29902,2,[NLTTJ]onemolroach,2495,454,26,16,42,61.9%,28m
29902,1,lkcadiz,2495,780,25,36,61,41.0%,2h
29902,3,AyeAye,2495,426,21,18,39,53.8%,1h
29902,2,Obliviator,2495,423,16,15,31,51.6%,2h
29902,3,[GOPERÚ]DAIRANIS,2495,275,11,13,24,45.8%,50m
29902,2,[SafDan]Nightpriest,2495,304,10,13,23,43.5%,45m
29902,1,Valhalla,2495,231,9,8,17,52.9%,19m
29902,1,VonByvel,2495,207,6,10,16,37.5%,2h
29902,3,MoorerFraga,2495,30,5,5,10,50.0%,34m
29902,2,[LBGF]anslod,2495,114,3,3,6,50.0%,1h
29902,3,Nerito,2495,64,3,10,13,23.1%,45m
29902,3,Morpheus,2495,58,2,2,4,50.0%,1h
29902,2,[t3k]DokutahPup,2495,32,2,5,7,28.6%,33m
29902,3,LegoMyFuego,2495,38,1,2,3,33.3%,24m
29902,3,owldamage,2495,0,0,1,1,0.0%,2h
29902,3,[Meech]Bloodlust,2495,0,0,2,2,0.0%,2h
29902,2,Kash,2495,0,0,3,3,0.0%,34m
29925,1,arnolfini,2494,1646,129,129,258,50.0%,20m
29925,2,iwllkillU,2494,1583,66,62,128,51.6%,50m
29925,2,Farsight,2494,664,37,26,63,58.7%,2h
29925,1,[bngs]Shomuted,2494,651,35,39,74,47.3%,34m
29925,1,SparkleWater,2494,817,32,36,68,47.1%,42m
29925,1,billythekid,2494,717,29,36,65,44.6%,43m
29925,2,Herpi,2494,630,26,21,47,55.3%,18m
29925,3,Cutuvelo,2494,672,24,19,43,55.8%,42m
29925,1,HamesJarden,2494,486,16,24,40,40.0%,35m
29925,2,Thepacker,2494,174,12,10,22,54.5%,4m
29925,3,pulse,2494,311,11,9,20,55.0%,2h
29925,2,jagoogala,2494,254,9,10,19,47.4%,1h
29925,3,VINCENTVLOGS,2494,146,5,2,7,71.4%,34m
29925,3,Chad,2494,163,4,7,11,36.4%,2h
29925,3,BlaKiN,2494,58,3,1,4,75.0%,2h
29925,3,Crayven,2494,58,3,1,4,75.0%,2h
29925,1,[PPwhiz]crafternoon,2494,165,3,4,7,42.9%,42m
29925,3,[Epokhé]Juannjose,2494,34,3,5,8,37.5%,37m
29925,3,JuacoV,2494,30,2,0,2,100.0%,2h
29925,3,scoria,2494,109,2,2,4,50.0%,2h
29925,3,ELserbio,2494,0,2,4,6,33.3%,2h
29925,2,butterboy,2494,0,2,5,7,28.6%,3h
29925,3,LITTLESTARS,2494,0,1,0,1,100.0%,30m
29925,2,Mooalally,2494,88,1,2,3,33.3%,46m
29925,2,coundukki,2494,30,1,6,7,14.3%,2h
29925,3,[ILY2]ILY,2494,0,0,1,1,0.0%,50m
29925,3,Hacker,2494,0,0,1,1,0.0%,29m
29925,3,LeoHuach,2494,0,0,1,1,0.0%,50m
29925,2,Flow,2494,0,0,1,1,0.0%,2h
29925,3,captainhjy,2494,0,0,2,2,0.0%,11m
29955,2,BIGNEO,2493,1541,193,191,384,50.3%,2h
29955,2,Dugarr,2493,1270,166,164,330,50.3%,2h
29955,2,brendenator,2493,966,50,50,100,50.0%,2h
29955,2,Battlesteak,2493,1256,49,47,96,51.0%,2h
29955,2,FuzzyWuzzy,2493,672,33,35,68,48.5%,28m
29955,3,[ProCol]ChaloII,2493,806,30,25,55,54.5%,3h
29955,2,MrUnpossible,2493,616,22,26,48,45.8%,2h
29955,3,[sk3tch]CptDanK,2493,517,19,14,33,57.6%,2h
29955,2,Anathema,2493,510,18,22,40,45.0%,28m
29955,3,Kabilla,2493,444,16,17,33,48.5%,36m
29955,3,[BlakMa]ATAT,2493,363,13,10,23,56.5%,28m
29955,2,elmachaco,2493,331,13,16,29,44.8%,19m
29955,2,Matthew,2493,205,11,4,15,73.3%,1h
29955,2,[SAIDA]Fosox,2493,212,7,7,14,50.0%,21m
29955,2,Betoso,2493,179,6,8,14,42.9%,2h
29955,3,MANHAMMER,2493,153,5,3,8,62.5%,2h
29955,3,[osR]Belius,2493,30,5,5,10,50.0%,34m
29955,3,steven,2493,130,4,2,6,66.7%,2h
29955,2,[MaCro1]FriedKimChi,2493,88,3,4,7,42.9%,2h
29955,2,[Perú08]JAVACOM,2493,96,3,9,12,25.0%,46m
29955,3,Shaxxi,2493,30,2,1,3,66.7%,3m
29955,3,[F10RQU]YourFather,2493,0,2,1,3,66.7%,34m
29955,3,[KGH2]MetalCrysis,2493,0,2,3,5,40.0%,3h
29955,2,Phoxx,2493,62,2,6,8,25.0%,3h
29955,3,Rasputin,2493,0,0,1,1,0.0%,2h
29980,2,sharky,2492,1577,90,93,183,49.2%,15m
29980,3,Lukicies,2492,677,69,86,155,44.5%,30m
29980,1,DragonSlayer,2492,977,54,58,112,48.2%,19m
29980,3,[Sc2Maf]Tossangel,2492,509,38,45,83,45.8%,30m
29980,2,Brahms,2492,672,36,23,59,61.0%,2h
29980,3,Ziggy,2492,926,36,32,68,52.9%,2h
29980,3,Nirat,2492,572,25,16,41,61.0%,2h
29980,3,BRZhadouken,2492,422,17,16,33,51.5%,45m
29980,2,Randir,2492,403,17,17,34,50.0%,34m
29980,1,Socrates,2492,536,17,25,42,40.5%,38m
29980,2,Alryeth,2492,421,16,14,30,53.3%,2h
29980,1,marcanator,2492,325,14,14,28,50.0%,2h
29980,2,[4Sci]Skepsis,2492,406,14,17,31,45.2%,32m
29980,2,tbirdxi,2492,308,12,10,22,54.5%,2h
29980,2,redfenix,2492,182,5,6,11,45.5%,1h
29980,2,MacrodrniNcz,2492,142,4,5,9,44.4%,3h
29980,2,AMCC,2492,88,3,9,12,25.0%,2h
29980,3,Filentrain,2492,30,2,0,2,100.0%,41m
29980,3,Luffy,2492,32,2,1,3,66.7%,1h
29980,3,DanLou,2492,34,2,1,3,66.7%,1h
29980,2,[SC2IDN]Ameyaali,2492,88,2,2,4,50.0%,4m
29980,2,Stinker,2492,30,2,3,5,40.0%,2h
29980,2,shimoney,2492,62,2,4,6,33.3%,14m
29980,3,CodA,2492,0,2,4,6,33.3%,24m
29980,3,scrAtch,2492,0,1,0,1,100.0%,28m
29980,3,[UnkHD]KingSC,2492,0,1,1,2,50.0%,40m
29980,2,[Pig2]Kybrit,2492,0,1,2,3,33.3%,2h
29980,3,[NoH2O]Tynamo,2492,30,1,3,4,25.0%,2h
29980,2,RES,2492,0,1,4,5,20.0%,22m
29980,2,BooknightZ,2492,30,1,4,5,20.0%,3h
29980,3,losoas,2492,30,1,6,7,14.3%,50m
29980,3,ACE,2492,0,0,1,1,0.0%,24m
29980,3,[WDS]Winfield,2492,0,0,1,1,0.0%,47m
29980,2,Gamerving,2492,0,0,2,2,0.0%,4m
30014,1,Ardas,2491,1136,162,141,303,53.5%,23m
30014,1,Ñaqui,2491,1448,96,90,186,51.6%,2h
30014,1,JARHEAD,2491,906,35,38,73,47.9%,2h
30014,3,RoadToBronze,2491,807,33,26,59,55.9%,25m
30014,1,HeatGuyJ,2491,460,32,30,62,51.6%,2h
30014,2,MasteroDeath,2491,780,31,25,56,55.4%,2h
30014,1,TiGoon,2491,524,23,24,47,48.9%,20m
30014,3,Zerocross,2491,567,21,15,36,58.3%,1h
30014,3,SHAWNER,2491,463,19,14,33,57.6%,3h
30014,2,[cluez]WILLED,2491,309,14,11,25,56.0%,46m
30014,3,Tricknasty,2491,371,14,16,30,46.7%,33m
30014,3,Pixo,2491,362,12,8,20,60.0%,45m
30014,2,thehawkman,2491,235,11,7,18,61.1%,2h
30014,2,DarkFenixx,2491,346,11,13,24,45.8%,2h
30014,1,Proteinovich,2491,250,10,12,22,45.5%,2h
30014,3,[WNTRG]luckymansogo,2491,184,9,17,26,34.6%,38m
30014,3,Nevvy,2491,198,8,10,18,44.4%,45m
30014,1,TPA,2491,48,6,7,13,46.2%,43m
30014,2,[PobSC]FallenArmy,2491,67,6,10,16,37.5%,20m
30014,3,Sunstriker,2491,148,5,4,9,55.6%,2h
30014,2,Seamurda,2491,88,2,1,3,66.7%,2h
30014,3,ferd,2491,0,2,1,3,66.7%,2h
30014,3,dotdot,2491,0,2,2,4,50.0%,18m
30014,2,[XpKAc]Pendulum,2491,74,2,2,4,50.0%,45m
30014,3,[Hemm]yesmeow,2491,0,2,6,8,25.0%,3m
30014,3,Jerraine,2491,0,1,0,1,100.0%,47m
30014,3,TSMfaker,2491,0,1,0,1,100.0%,2h
30014,3,Josue,2491,30,1,2,3,33.3%,18m
30014,2,HotSauce,2491,0,0,3,3,0.0%,2h
30043,2,[Wat3rs]TheEnforcer,2490,1592,73,73,146,50.0%,3h
30043,2,RMSEA,2490,548,40,28,68,58.8%,1h
30043,3,[xHtsx]MirandaBlack,2490,656,36,47,83,43.4%,15m
30043,3,[TGosuD]jakeadoo,2490,737,34,19,53,64.2%,2h
30043,3,Zeniba,2490,771,30,30,60,50.0%,50m
30043,1,howrutoday,2490,748,29,35,64,45.3%,2h
30043,1,SonarEclipse,2490,757,25,31,56,44.6%,2h
30043,3,[PTHero]RoguePianist,2490,383,15,5,20,75.0%,2h
30043,2,[AbcCo]SapitoFacha,2490,308,13,11,24,54.2%,46m
30043,3,Dan,2490,330,12,9,21,57.1%,15m
30043,3,Cetthilddar,2490,240,9,8,17,52.9%,27m
30043,1,senjo,2490,222,9,11,20,45.0%,2h
30043,1,Nuaj,2490,234,7,13,20,35.0%,31m
30043,3,UNEVEN,2490,172,6,6,12,50.0%,50m
30043,2,ChikGoesBok,2490,179,5,7,12,41.7%,2h
30043,2,LeonardoSt,2490,86,5,7,12,41.7%,46m
30043,3,DedicationOP,2490,139,5,8,13,38.5%,31m
30043,3,Ziarnaq,2490,0,4,5,9,44.4%,34m
30043,2,SurPriseMDF,2490,58,4,6,10,40.0%,2h
30043,1,UnWilling,2490,155,3,7,10,30.0%,2h
30043,2,TheSauce,2490,30,2,3,5,40.0%,2h
30043,2,deadlykitten,2490,0,2,4,6,33.3%,18m
30043,2,ElAraucano,2490,138,2,9,11,18.2%,44m
30043,3,[ZFC]daewongtse,2490,0,1,1,2,50.0%,30m
30043,3,[TYBROS]Probnificint,2490,30,1,1,2,50.0%,2h
30043,3,[GOPERÚ]Edukill,2490,0,0,1,1,0.0%,45m
30043,3,harrypostres,2490,0,0,1,1,0.0%,26m
30043,1,Ares,2490,0,0,5,5,0.0%,2h
30043,3,[NAGGR5]Cirrus,2490,0,0,7,7,0.0%,2h
30072,2,Frutillita,2489,558,87,63,150,58.0%,2h
30072,1,Todd,2489,1505,81,80,161,50.3%,25m
30072,2,Apocalypse,2489,1372,75,66,141,53.2%,46m
30072,1,Vicler,2489,1159,57,63,120,47.5%,21m
30072,1,JKGODYT,2489,1243,49,53,102,48.0%,2h
30072,2,KenshinX,2489,531,45,44,89,50.6%,2h
30072,2,Rick,2489,786,39,26,65,60.0%,4m
30072,3,PapaSita,2489,828,31,38,69,44.9%,35m
30072,2,[ZTemp]WTFork,2489,465,21,14,35,60.0%,2h
30072,2,ManEatingDog,2489,308,13,17,30,43.3%,2h
30072,1,[TsHo]GhOsT,2489,332,12,10,22,54.5%,4m
30072,2,Cahuide,2489,211,8,9,17,47.1%,20m
30072,2,ROst,2489,174,7,7,14,50.0%,2h
30072,1,SquidVicious,2489,184,7,11,18,38.9%,2h
30072,1,Bruno,2489,181,6,6,12,50.0%,2h
30072,3,Faker,2489,200,6,11,17,35.3%,39m
30072,1,[AthSun]Crusader,2489,224,6,12,18,33.3%,2h
30072,3,stiuvenelvro,2489,121,5,11,16,31.2%,11m
30072,3,Gargamel,2489,141,4,4,8,50.0%,15m
30072,2,Narlim,2489,27,4,5,9,44.4%,45m
30072,2,HarzerRoller,2489,36,4,6,10,40.0%,2h
30072,3,SukDikIsFun,2489,162,4,7,11,36.4%,2h
30072,2,SkyMaster,2489,154,3,5,8,37.5%,1h
30072,2,KooLKei,2489,0,2,4,6,33.3%,32m
30072,3,benkadosh,2489,0,1,1,2,50.0%,42m
30072,3,KissMyAsthma,2489,0,1,2,3,33.3%,1h
30072,1,[VCR]Killhorn,2489,0,1,4,5,20.0%,2h
30072,3,Balinn,2489,0,0,2,2,0.0%,2h
30100,1,pedroraptor,2488,1632,169,162,331,51.1%,2h
30100,2,PUTEYPIE,2488,1096,122,110,232,52.6%,2h
30100,3,DasHighci,2488,1621,109,102,211,51.7%,28m
30100,2,Shinji,2488,1372,75,61,136,55.1%,26m
30100,2,SrChan,2488,933,58,54,112,51.8%,2h
30100,1,deadlift,2488,801,52,49,101,51.5%,2h
30100,3,TheGrinch,2488,503,47,30,77,61.0%,2h
30100,1,kronos,2488,672,41,45,86,47.7%,2h
30100,2,jeanfes,2488,552,28,24,52,53.8%,2h
30100,2,[MutasT]Mac,2488,567,26,12,38,68.4%,33m
30100,3,alonestar,2488,656,25,21,46,54.3%,18m
30100,2,Jlarz,2488,520,23,23,46,50.0%,2h
30100,3,Kenji,2488,279,18,17,35,51.4%,44m
30100,2,[ZTempz]Everest,2488,419,16,17,33,48.5%,1h
30100,2,searching,2488,206,9,10,19,47.4%,2h
30100,2,Nymesis,2488,148,5,7,12,41.7%,2h
30100,3,sealius,2488,119,4,3,7,57.1%,3h
30100,2,Baron,2488,90,4,5,9,44.4%,2h
30100,3,Terrano,2488,94,4,5,9,44.4%,39m
30100,3,Envypee,2488,146,3,2,5,60.0%,50m
30100,3,SCOUTWITHBCS,2488,30,2,1,3,66.7%,2h
30100,3,harryman,2488,0,1,0,1,100.0%,18m
30100,3,Dangernoodle,2488,0,1,0,1,100.0%,29m
30100,2,[A225]jihadmaster,2488,0,1,1,2,50.0%,2h
30100,3,Phanxy,2488,30,1,3,4,25.0%,39m
30100,2,careta,2488,0,1,3,4,25.0%,28m
30100,2,Capitalist,2488,30,1,5,6,16.7%,2h
30100,3,jokes,2488,0,0,1,1,0.0%,11m
30100,2,deathcyth,2488,0,0,5,5,0.0%,2h
30100,2,blackFlame,2488,0,0,5,5,0.0%,3h
30130,1,TheFollower,2487,1538,182,185,367,49.6%,42m
30130,2,Deku,2487,950,48,23,71,67.6%,2h
30130,2,BatmanChile,2487,1121,45,52,97,46.4%,3h
30130,2,Hurzal,2487,652,41,31,72,56.9%,7m
30130,1,zachMAINE,2487,920,34,39,73,46.6%,1h
30130,1,TheZergling,2487,364,18,27,45,40.0%,2h
30130,2,Lugia,2487,287,9,11,20,45.0%,28m
30130,2,boat,2487,86,5,7,12,41.7%,11m
30130,3,HELLFLAME,2487,145,4,4,8,50.0%,2h
30130,3,aggpee,2487,116,3,4,7,42.9%,34m
30130,1,Errantom,2487,95,2,3,5,40.0%,2h
30130,3,Fluffles,2487,30,1,3,4,25.0%,39m
30130,2,[SICPe]axsnake,2487,67,1,3,4,25.0%,19m
30130,3,[NextDC]Adrián,2487,0,0,2,2,0.0%,47m
30130,1,lucasmm,2487,0,0,2,2,0.0%,7m
30130,2,Flameze,2487,0,0,3,3,0.0%,4m
30146,3,OrangeWine,2486,1523,245,265,510,48.0%,5m
30146,2,MrPenguin,2486,1053,80,57,137,58.4%,2h
30146,3,Quantum,2486,1351,55,60,115,47.8%,34m
30146,3,KFCnBIGLIPS,2486,1021,51,72,123,41.5%,34m
30146,2,mist,2486,1074,46,43,89,51.7%,2h
30146,3,Spartz,2486,1030,40,38,78,51.3%,2h
30146,2,EmilyFox,2486,674,23,42,65,35.4%,20m
30146,3,[YS850H]BigKev,2486,275,18,19,37,48.6%,2h
30146,2,[CHOLOS]Master,2486,252,9,8,17,52.9%,2h
30146,2,ChinoSidlem,2486,207,6,10,16,37.5%,2h
30146,3,[UpxV]Erennor,2486,88,5,15,20,25.0%,3h
30146,2,Tomas,2486,122,4,7,11,36.4%,2h
30146,1,[FAECES]TypicalGenra,2486,145,3,5,8,37.5%,20m
30146,3,[XpKAc]EDY,2486,30,2,0,2,100.0%,1h
30146,3,Puyo,2486,30,2,2,4,50.0%,13m
30146,3,DarthPreator,2486,0,1,0,1,100.0%,2h
30146,3,SaverioUSA,2486,0,1,0,1,100.0%,1h
30146,3,BSaber,2486,0,1,0,1,100.0%,28m
30146,3,Patrick,2486,0,1,2,3,33.3%,24m
30146,2,Xero,2486,44,1,5,6,16.7%,2h
30146,3,[SDTL]Kham,2486,0,1,7,8,12.5%,2h
30146,3,Fransua,2486,0,0,1,1,0.0%,1h
30146,3,BingoBango,2486,0,0,2,2,0.0%,2h
30146,2,[CLNA]LawfulVr,2486,0,0,4,4,0.0%,2h
30170,2,Ben,2485,1480,240,223,463,51.8%,35m
30170,1,Dopey,2485,1598,118,119,237,49.8%,5m
30170,2,SteveFrench,2485,1373,91,94,185,49.2%,32m
30170,1,Isfahan,2485,491,87,88,175,49.7%,2h
30170,3,Blackram,2485,970,67,52,119,56.3%,28m
30170,2,Kenchin,2485,1278,58,45,103,56.3%,26m
30170,1,Xeras,2485,695,50,48,98,51.0%,26m
30170,2,Page,2485,213,48,41,89,53.9%,2h
30170,2,[2G4U]Malnayil,2485,469,43,41,84,51.2%,2h
30170,1,FateYeah,2485,1128,42,47,89,47.2%,48m
30170,2,Moniker,2485,438,36,35,71,50.7%,50m
30170,2,tallgeese,2485,785,31,32,63,49.2%,2h
30170,2,cnnn,2485,310,29,30,59,49.2%,2h
30170,3,cgcerda,2485,628,23,20,43,53.5%,33m
30170,1,josh,2485,616,22,22,44,50.0%,5m
30170,1,bladex,2485,551,21,25,46,45.7%,15m
30170,2,luisenano,2485,515,18,19,37,48.6%,2h
30170,1,DanielR,2485,390,16,19,35,45.7%,38m
30170,2,Tentacruel,2485,243,13,12,25,52.0%,5m
30170,1,Izuel,2485,353,12,15,27,44.4%,2h
30170,2,[sk3tch]Blade,2485,270,12,16,28,42.9%,10m
30170,2,Baltazar,2485,217,9,7,16,56.2%,2h
30170,2,Coraje,2485,238,8,17,25,32.0%,2h
30170,2,IlIlIlIlIlIl,2485,159,6,4,10,60.0%,15m
30170,3,ALDEBARÁN,2485,114,4,2,6,66.7%,11m
30170,3,[M1A5]kano,2485,97,4,3,7,57.1%,25m
30170,3,gabucho,2485,120,4,6,10,40.0%,18m
30170,3,jbad,2485,121,3,4,7,42.9%,2h
30170,2,MajinCroix,2485,62,3,5,8,37.5%,20m
30170,2,QuePasoAqui,2485,93,3,7,10,30.0%,17m
30170,3,Hoss,2485,30,2,0,2,100.0%,1h
30170,3,[Cagon]HerrPaolo,2485,58,2,1,3,66.7%,2h
30170,3,[MaxWin]Mazz,2485,30,1,1,2,50.0%,30m
30170,3,[WNTRBL]Jpoole,2485,0,0,1,1,0.0%,42m
30170,3,TheVamp,2485,0,0,1,1,0.0%,25m
30170,3,[LDCO]sha,2485,0,0,1,1,0.0%,2h
30170,1,DeMindcast,2485,0,0,5,5,0.0%,48m
30207,1,AngryDonut,2484,1572,67,71,138,48.6%,2h
30207,3,zsaw,2484,997,48,28,76,63.2%,2h
30207,2,LeKingsnatc,2484,359,42,39,81,51.9%,2h
30207,1,WeOutBoys,2484,708,31,28,59,52.5%,2h
30207,3,Denyz,2484,300,29,18,47,61.7%,2h
30207,3,chicles,2484,344,18,16,34,52.9%,3m
30207,3,Atlas,2484,432,17,14,31,54.8%,2h
30207,3,[ThxN]Smoke,2484,335,15,2,17,88.2%,41m
30207,3,AgentX,2484,423,15,14,29,51.7%,2h
30207,3,Lippy,2484,368,12,9,21,57.1%,28m
30207,2,[GenF]Wolfie,2484,356,12,18,30,40.0%,43m
30207,3,CAPTnCRUNCH,2484,203,10,2,12,83.3%,2h
30207,3,[chair]KalEl,2484,126,7,11,18,38.9%,14m
30207,3,[R3KT3M]Aothien,2484,224,6,8,14,42.9%,39m
30207,1,Muney,2484,150,5,14,19,26.3%,2h
30207,3,[gRgL]Zerg,2484,142,4,1,5,80.0%,2h
30207,2,Ariel,2484,140,4,4,8,50.0%,50m
30207,1,[PobSC]MgkCrewRick,2484,146,4,6,10,40.0%,3h
30207,3,BeliasAybara,2484,58,3,0,3,100.0%,2h
30207,3,NoseTypist,2484,86,3,3,6,50.0%,2h
30207,3,Romanda,2484,30,3,4,7,42.9%,4m
30207,1,FartinG,2484,159,3,5,8,37.5%,2h
30207,3,[LTBV]CIOWgame,2484,58,2,1,3,66.7%,45m
30207,1,BattleElf,2484,0,2,3,5,40.0%,2h
30207,3,Rinama,2484,60,2,3,5,40.0%,2h
30207,3,Geralarry,2484,0,1,0,1,100.0%,2h
30207,3,Aarodynamix,2484,0,1,0,1,100.0%,2h
30207,3,Landoran,2484,0,1,1,2,50.0%,41m
30207,3,SHUVinator,2484,30,1,1,2,50.0%,2h
30207,2,Advocate,2484,0,1,2,3,33.3%,2h
30207,1,ExtremePlaY,2484,48,1,5,6,16.7%,2h
30207,3,[Yaoiii]LePusiHunter,2484,0,0,1,1,0.0%,2h
30239,3,Wave,2483,1420,189,169,358,52.8%,2h
30239,1,Namechange,2483,1086,111,116,227,48.9%,2h
30239,2,ManazoZ,2483,906,105,122,227,46.3%,12m
30239,3,JOZZZE,2483,595,56,48,104,53.8%,2h
30239,2,[ProCol]Andres,2483,1046,47,35,82,57.3%,34m
30239,2,Morok,2483,573,40,32,72,55.6%,47m
30239,2,kyrie,2483,937,40,34,74,54.1%,5m
30239,2,BALLOONDAY,2483,506,32,35,67,47.8%,2h
30239,2,xKIRAx,2483,635,26,19,45,57.8%,32m
30239,2,crazylegz,2483,508,17,21,38,44.7%,32m
30239,2,Lotso,2483,474,17,21,38,44.7%,2h
30239,3,Axl,2483,405,16,7,23,69.6%,2h
30239,3,juneyi,2483,303,11,3,14,78.6%,13m
30239,1,PhúPT,2483,201,7,10,17,41.2%,8m
30239,1,Xende,2483,218,6,14,20,30.0%,7m
30239,2,lonerogue,2483,175,5,3,8,62.5%,2h
30239,2,Hype,2483,182,5,7,12,41.7%,2h
30239,3,Ter,2483,30,2,0,2,100.0%,49m
30239,1,Sporkredfox,2483,96,2,0,2,100.0%,2h
30239,3,[GØSU]Cov,2483,30,2,0,2,100.0%,1h
30239,2,shacuras,2483,104,2,2,4,50.0%,2h
30239,3,Ray,2483,0,2,3,5,40.0%,34m
30239,1,Tizwiz,2483,0,2,5,7,28.6%,2h
30239,1,[ATLsOs]Aquinas,2483,0,2,5,7,28.6%,3h
30239,2,[TheB4d]lucas,2483,0,1,0,1,100.0%,2h
30239,3,AdjutantCore,2483,30,1,1,2,50.0%,2h
30239,2,[Vrgns]STARCHANCE,2483,91,1,1,2,50.0%,2h
30239,2,ElfoFuerte,2483,0,1,2,3,33.3%,2h
30239,2,Faust,2483,30,1,4,5,20.0%,33m
30239,1,VergaHumilde,2483,0,1,4,5,20.0%,26m
30239,3,BigPapaPimp,2483,0,0,1,1,0.0%,44m
30239,1,[Boboyz]SteveCherry,2483,0,0,1,1,0.0%,3h
30239,2,[SPKL]TheOnePes,2483,0,0,2,2,0.0%,2h
30239,2,Shenster,2483,0,0,4,4,0.0%,2h
30273,1,GrosMalin,2482,1540,120,117,237,50.6%,3m
30273,1,ZionChris,2482,1613,87,83,170,51.2%,7m
30273,2,DomWantsRice,2482,1149,73,61,134,54.5%,2h
30273,2,Wise,2482,1247,50,42,92,54.3%,2h
30273,3,HahaStoned,2482,597,25,13,38,65.8%,2h
30273,2,WarmSause,2482,442,15,20,35,42.9%,20m
30273,2,[VODK]POROTOTITO,2482,429,13,19,32,40.6%,4m
30273,2,luisxd,2482,283,11,8,19,57.9%,2h
30273,2,Inittowinit,2482,271,8,11,19,42.1%,2h
30273,2,Tanling,2482,140,7,7,14,50.0%,18m
30273,2,[LTCent]slydemon,2482,150,6,7,13,46.2%,4m
30273,2,[Vroom]WahDiTah,2482,140,5,6,11,45.5%,2h
30273,3,Raiderp,2482,0,2,3,5,40.0%,42m
30273,2,reggie,2482,112,2,4,6,33.3%,50m
30273,2,bolvahr,2482,0,2,4,6,33.3%,2h
30273,3,Whoofhearted,2482,97,2,5,7,28.6%,1h
30273,1,BlackZero,2482,0,2,5,7,28.6%,2h
30273,3,Guywithgun,2482,0,1,0,1,100.0%,2h
30273,3,Sancheez,2482,0,1,0,1,100.0%,2h
30273,2,Ian,2482,0,1,5,6,16.7%,49m
30273,2,LeoGaming,2482,30,1,7,8,12.5%,2h
30273,3,[sk3tch]scribbles,2482,0,0,1,1,0.0%,27m
30273,3,DamdSaint,2482,0,0,1,1,0.0%,3h
30273,1,phoders,2482,0,0,1,1,0.0%,2h
30273,2,Vinyl,2482,0,0,5,5,0.0%,2h
30298,2,[ZRGFRT]LuckyDuck,2481,1493,158,148,306,51.6%,40m
30298,3,KimbapBoy,2481,1068,44,40,84,52.4%,27m
30298,1,MCSquared,2481,758,28,34,62,45.2%,2h
30298,1,FearTurkey,2481,772,26,36,62,41.9%,18m
30298,3,Kishr,2481,159,17,11,28,60.7%,2h
30298,2,Germz,2481,356,13,20,33,39.4%,2h
30298,1,RockMachine,2481,283,11,12,23,47.8%,42m
30298,1,Superior,2481,189,9,14,23,39.1%,2h
30298,2,Endolite,2481,244,8,13,21,38.1%,32m
30298,2,OolongTea,2481,267,8,14,22,36.4%,2h
30298,1,BABYFire,2481,283,8,14,22,36.4%,2h
30298,2,[SECT4]Amras,2481,168,7,5,12,58.3%,2h
30298,2,lucasnet,2481,114,7,7,14,50.0%,2h
30298,2,mike,2481,109,6,2,8,75.0%,2h
30298,2,BlizzyB,2481,181,6,8,14,42.9%,2h
30298,2,[BrVoS]Skywalker,2481,122,5,8,13,38.5%,2h
30298,2,PsychoMuphin,2481,145,5,8,13,38.5%,33m
30298,3,Jake,2481,30,4,2,6,66.7%,2h
30298,3,Taras,2481,117,4,8,12,33.3%,37m
30298,1,Karltomwaffe,2481,140,3,10,13,23.1%,1h
30298,1,kolakakao,2481,0,2,3,5,40.0%,48m
30298,3,McBane,2481,0,1,0,1,100.0%,33m
30298,3,[FFAA]titopsk,2481,0,1,0,1,100.0%,49m
30298,2,[JAGWN]Kakaroto,2481,0,1,3,4,25.0%,1h
30298,2,[Shaky]Refrigerador,2481,28,1,3,4,25.0%,2h
30298,3,raspberrySC,2481,30,1,4,5,20.0%,33m
30298,3,[AFtK]Lightdarkace,2481,0,1,5,6,16.7%,2h
30298,3,ace,2481,0,0,1,1,0.0%,1h
30298,1,[QUEENz]Graeme,2481,0,0,2,2,0.0%,2h
30327,3,SKWaterMouth,2480,1614,445,447,892,49.9%,2h
30327,3,classycat,2480,1643,121,124,245,49.4%,39m
30327,3,Grimra,2480,599,45,28,73,61.6%,45m
30327,3,LukeNukem,2480,678,24,21,45,53.3%,2h
30327,1,Bocephus,2480,437,17,17,34,50.0%,38m
30327,3,[Renan]xXTHORXx,2480,380,13,8,21,61.9%,2h
30327,3,[DUSKPT]DerpTemplar,2480,142,5,4,9,55.6%,18m
30327,2,DjJazzyGeoff,2480,157,5,5,10,50.0%,44m
30327,2,Ice,2480,154,5,8,13,38.5%,49m
30327,3,RACSO,2480,114,4,3,7,57.1%,1h
30327,2,Starlord,2480,132,4,3,7,57.1%,2h
30327,1,fukwitme,2480,97,4,8,12,33.3%,25m
30327,3,[DvaRKA]Blikman,2480,92,3,1,4,75.0%,11m
30327,2,LeTomate,2480,144,3,2,5,60.0%,1h
30327,2,[Marcos]Necropotence,2480,30,2,3,5,40.0%,49m
30327,3,[4BN]INFECTUSS,2480,38,1,1,2,50.0%,1h
30327,3,Kyerion,2480,30,1,1,2,50.0%,7m
30327,1,LuanOwnedz,2480,0,1,4,5,20.0%,2h
30327,3,Lastdude,2480,0,1,4,5,20.0%,11m
30327,3,Skullbreaker,2480,97,1,7,8,12.5%,18m
30327,3,XeroBlue,2480,0,0,1,1,0.0%,24m
30327,3,CHAMACO,2480,0,0,1,1,0.0%,2h
30327,3,SicksHeaven,2480,0,0,1,1,0.0%,14m
30327,1,feruz,2480,0,0,3,3,0.0%,15m
30351,2,Hoovehearted,2479,1463,120,98,218,55.0%,2h
30351,3,Lowenbehold,2479,1608,101,95,196,51.5%,3m
30351,2,Destruction,2479,1308,65,47,112,58.0%,1h
30351,3,miroslav,2479,1574,64,59,123,52.0%,2h
30351,3,DarkSteel,2479,884,33,33,66,50.0%,15m
30351,2,MattHoffman,2479,560,26,25,51,51.0%,2h
30351,2,AgentSmith,2479,411,25,23,48,52.1%,17m
30351,1,Afy,2479,662,25,29,54,46.3%,2h
30351,3,valladolid,2479,406,14,9,23,60.9%,26m
30351,1,Angel,2479,322,10,11,21,47.6%,3h
30351,2,[JUGOS]Aiolia,2479,208,8,13,21,38.1%,2h
30351,2,Dinkleberg,2479,156,7,3,10,70.0%,2h
30351,3,Batwing,2479,171,6,2,8,75.0%,2h
30351,3,Newool,2479,166,6,5,11,54.5%,45m
30351,3,Deadly,2479,146,6,6,12,50.0%,2h
30351,2,NightKnight,2479,138,5,7,12,41.7%,2h
30351,1,Random,2479,120,4,6,10,40.0%,2h
30351,3,Liao,2479,161,4,7,11,36.4%,36m
30351,2,Teeth,2479,90,2,2,4,50.0%,2h
30351,3,Yago,2479,58,2,2,4,50.0%,27m
30351,3,Sakel,2479,0,2,3,5,40.0%,2h
30351,3,Scáthach,2479,40,2,6,8,25.0%,2h
30351,2,Gared,2479,0,1,2,3,33.3%,44m
30351,3,[Mecha]Maximus,2479,0,0,1,1,0.0%,2h
30351,3,[TGCrew]JDShinsk,2479,0,0,1,1,0.0%,27m
30351,2,Protoss,2479,0,0,5,5,0.0%,3h
30351,2,[Khaoz]Olovcrashzes,2479,0,0,5,5,0.0%,3h
30378,3,[llKSll]LizStir,2478,1519,366,367,733,49.9%,32m
30378,2,wedawn,2478,1294,66,65,131,50.4%,2h
30378,2,WRHUEZOSV,2478,1050,55,54,109,50.5%,2h
30378,3,Joaquin,2478,416,35,22,57,61.4%,42m
30378,1,Itkovian,2478,1010,35,44,79,44.3%,1h
30378,2,MrMonacle,2478,808,34,25,59,57.6%,43m
30378,2,[SftVgn]Necrosdrack,2478,881,33,37,70,47.1%,2h
30378,3,Honcho,2478,846,33,38,71,46.5%,8m
30378,2,SNUGGLE,2478,672,32,25,57,56.1%,40m
30378,2,[BILSON]Trollingborn,2478,702,27,25,52,51.9%,18m
30378,2,[Th3Bad]Trexi,2478,728,25,33,58,43.1%,4m
30378,3,[HTYOLO]Terminator,2478,212,11,17,28,39.3%,31m
30378,3,zasianman,2478,261,10,5,15,66.7%,2h
30378,3,Raziel,2478,272,8,7,15,53.3%,11m
30378,1,ReotardoDV,2478,135,7,6,13,53.8%,39m
30378,2,DaBlackMac,2478,159,7,10,17,41.2%,2h
30378,3,Squid,2478,181,7,10,17,41.2%,34m
30378,2,[Atoq]vnunonca,2478,246,7,10,17,41.2%,43m
30378,2,duro,2478,182,6,7,13,46.2%,17m
30378,2,gerp,2478,118,6,8,14,42.9%,2h
30378,2,PsiAlr,2478,194,5,5,10,50.0%,43m
30378,2,[QCV]Cyrus,2478,246,5,7,12,41.7%,2h
30378,3,Tanster,2478,88,4,6,10,40.0%,50m
30378,3,Cmon,2478,165,4,9,13,30.8%,1h
30378,2,[GGMESP]SilverHawk,2478,94,4,9,13,30.8%,2h
30378,3,[Aethus]BreakerFist,2478,0,3,2,5,60.0%,28m
30378,3,CrAzYdRiVeR,2478,121,3,4,7,42.9%,2h
30378,2,aztec,2478,88,3,6,9,33.3%,2h
30378,1,Roubel,2478,38,3,6,9,33.3%,43m
30378,2,[ACSS]Petrocules,2478,30,2,3,5,40.0%,2h
30378,3,[SbroG]Peaknuckle,2478,0,1,0,1,100.0%,2h
30378,3,Everett,2478,0,1,0,1,100.0%,24m
30378,2,Santiago,2478,0,1,2,3,33.3%,3h
30378,3,[GOOOAT]auX,2478,30,1,2,3,33.3%,39m
30378,3,[UCHlH4]Amibech,2478,30,1,3,4,25.0%,27m
30378,2,Diegopm,2478,30,1,6,7,14.3%,2h
30378,1,gomu,2478,0,1,8,9,11.1%,35m
30378,1,Rowdy,2478,0,0,1,1,0.0%,2h
30378,3,[EmSvg]Felipegf,2478,0,0,1,1,0.0%,2h
30378,3,shadowwull,2478,0,0,2,2,0.0%,2h
30378,3,IamHIM,2478,0,0,2,2,0.0%,2h
30378,3,Educado,2478,0,0,2,2,0.0%,18m
30378,2,Uzbek,2478,0,0,4,4,0.0%,47m
30378,2,BakeEyes,2478,0,0,7,7,0.0%,22m
30422,2,Rubbish,2477,1467,58,60,118,49.2%,2h
30422,2,Pandaslayer,2477,1007,55,54,109,50.5%,50m
30422,2,Hero,2477,1360,51,56,107,47.7%,19m
30422,3,Shuriken,2477,873,39,34,73,53.4%,18m
30422,1,MrHacker,2477,833,34,38,72,47.2%,2h
30422,3,[ValarM]Parker,2477,249,18,15,33,54.5%,44m
30422,1,Tassader,2477,484,15,26,41,36.6%,3h
30422,2,Daquevius,2477,179,12,10,22,54.5%,47m
30422,3,Supaplex,2477,294,11,4,15,73.3%,2h
30422,2,Anthony,2477,298,10,11,21,47.6%,34m
30422,2,fungk,2477,280,9,11,20,45.0%,33m
30422,1,Greedo,2477,307,9,14,23,39.1%,2h
30422,2,wally,2477,221,7,4,11,63.6%,33m
30422,3,SwarthyMcTit,2477,183,5,4,9,55.6%,18m
30422,3,maicol,2477,96,5,7,12,41.7%,2h
30422,2,celestia,2477,92,5,7,12,41.7%,1h
30422,3,[GC2042]Axolotl,2477,165,4,2,6,66.7%,2h
30422,3,[Xpk]thelast,2477,97,2,0,2,100.0%,43m
30422,3,[PobSC]HankScorpio,2477,60,2,2,4,50.0%,20m
30422,3,Ourus,2477,121,2,3,5,40.0%,43m
30422,2,vlexoo,2477,48,2,5,7,28.6%,2h
30422,3,Bloody,2477,0,2,5,7,28.6%,2h
30422,3,[Trlvla]ULayYeMyat,2477,0,1,1,2,50.0%,39m
30422,2,Killmachine,2477,88,1,3,4,25.0%,2h
30422,1,ConchSeed,2477,0,1,4,5,20.0%,7m
30422,3,Yamato,2477,95,1,5,6,16.7%,34m
30422,2,[BR33D]Nlghok,2477,0,1,6,7,14.3%,2h
30422,3,Rabajaka,2477,0,0,2,2,0.0%,2h
30422,2,Vrixen,2477,0,0,3,3,0.0%,2h
30451,1,Mandown,2476,989,36,39,75,48.0%,1h
30451,2,zarchon,2476,872,32,35,67,47.8%,2h
30451,2,NationalFail,2476,720,27,26,53,50.9%,26m
30451,2,Kyle,2476,633,26,22,48,54.2%,5m
30451,2,CPTSmAcKaHo,2476,465,17,16,33,51.5%,2h
30451,3,Ghost,2476,481,17,16,33,51.5%,2h
30451,3,[PeePz]border,2476,276,16,14,30,53.3%,27m
30451,2,rorriM,2476,362,13,16,29,44.8%,2h
30451,3,MapleShade,2476,324,12,8,20,60.0%,28m
30451,2,zachvara,2476,215,9,7,16,56.2%,2h
30451,1,InUrFace,2476,200,7,5,12,58.3%,2h
30451,2,[Arions]jeyson,2476,208,7,6,13,53.8%,5m
30451,2,[PERUII]iohato,2476,152,5,6,11,45.5%,2h
30451,3,ZINO,2476,167,5,6,11,45.5%,2h
30451,2,[Mankis]mastero,2476,0,4,4,8,50.0%,2h
30451,3,TerranFreak,2476,133,3,3,6,50.0%,33m
30451,2,ReKLiS,2476,93,3,6,9,33.3%,2h
30451,3,mfchris,2476,80,3,7,10,30.0%,27m
30451,1,Antonio,2476,137,3,8,11,27.3%,2h
30451,3,Alpha,2476,0,2,3,5,40.0%,3h
30451,1,Tesla,2476,48,2,4,6,33.3%,44m
30451,3,[xDYEx]Spectre,2476,30,1,2,3,33.3%,3h
30451,2,yoyo,2476,42,1,2,3,33.3%,2h
30451,1,Hellion,2476,0,1,4,5,20.0%,2h
30451,2,shivez,2476,0,0,3,3,0.0%,3h
30451,2,Chingda,2476,0,0,3,3,0.0%,2h
30451,2,leoaliens,2476,0,0,4,4,0.0%,2h
30478,3,GangstaBling,2475,1348,216,214,430,50.2%,19m
30478,2,RastaManKing,2475,1463,104,87,191,54.5%,33m
30478,2,[ZTemps]MystixW,2475,568,95,81,176,54.0%,47m
30478,3,NakedNinja,2475,1229,59,57,116,50.9%,13m
30478,3,XxxTheSamxxX,2475,868,43,18,61,70.5%,13m
30478,3,DarthConnor,2475,761,29,25,54,53.7%,11m
30478,2,[Necron]TheDoomBlade,2475,572,26,16,42,61.9%,22m
30478,3,Driver,2475,547,24,20,44,54.5%,1h
30478,2,Ramjo,2475,478,23,11,34,67.6%,2h
30478,2,JGA,2475,589,22,25,47,46.8%,30m
30478,3,devastator,2475,553,21,13,34,61.8%,7m
30478,3,BigEasy,2475,443,20,17,37,54.1%,2h
30478,3,ishayar,2475,423,17,14,31,54.8%,2h
30478,2,LicanX,2475,409,17,18,35,48.6%,2h
30478,2,Zamii,2475,240,9,11,20,45.0%,3h
30478,2,JeremySolo,2475,238,8,13,21,38.1%,2h
30478,2,ChumChum,2475,159,5,8,13,38.5%,1h
30478,3,vikinghammer,2475,162,5,21,26,19.2%,16m
30478,3,[LASK]Defender,2475,144,4,4,8,50.0%,2h
30478,1,TheAids,2475,0,4,7,11,36.4%,25m
30478,2,NaCl,2475,78,3,6,9,33.3%,34m
30478,1,Xaaloo,2475,48,2,4,6,33.3%,2h
30478,3,[Atena]Gerarca,2475,0,1,0,1,100.0%,2h
30478,3,[7EK]Shishkabob,2475,0,1,2,3,33.3%,2h
30478,3,ChrisDonDada,2475,0,0,1,1,0.0%,41m
30478,1,WXmaster,2475,0,0,1,1,0.0%,2h
30478,3,Paul,2475,0,0,3,3,0.0%,1h
30478,1,EuraRa,2475,0,0,5,5,0.0%,2h
30506,3,ChowderSnake,2474,1522,286,273,559,51.2%,13m
30506,1,GallAnt,2474,694,169,166,335,50.4%,2h
30506,2,InfinityRex,2474,1593,160,155,315,50.8%,2h
30506,1,[Dnwlkr]Lithius,2474,1565,109,115,224,48.7%,1h
30506,1,Proteux,2474,950,38,38,76,50.0%,31m
30506,2,Dockavok,2474,386,24,23,47,51.1%,30m
30506,3,[xGDIsx]Bdawg,2474,556,21,21,42,50.0%,2h
30506,2,Zeroflare,2474,352,20,19,39,51.3%,34m
30506,3,Xavier,2474,366,16,5,21,76.2%,36m
30506,1,Rebelderp,2474,514,16,26,42,38.1%,2h
30506,3,HiFiDude,2474,364,13,10,23,56.5%,43m
30506,1,Saint,2474,307,10,17,27,37.0%,1h
30506,1,Spartan,2474,334,10,21,31,32.3%,2h
30506,3,[Gnomed]Leonen,2474,156,6,2,8,75.0%,1h
30506,3,Romantic,2474,178,6,5,11,54.5%,7m
30506,3,MrAcorn,2474,58,3,2,5,60.0%,33m
30506,3,KgZNachos,2474,86,3,2,5,60.0%,36m
30506,3,Spazzy,2474,62,3,3,6,50.0%,3m
30506,1,Emandarx,2474,0,3,5,8,37.5%,49m
30506,2,Geosensation,2474,42,3,7,10,30.0%,2h
30506,1,QuBuS,2474,116,2,2,4,50.0%,2h
30506,2,Babytosser,2474,120,2,5,7,28.6%,17m
30506,3,luiyox,2474,0,1,0,1,100.0%,3h
30506,3,Zelias,2474,0,1,0,1,100.0%,20m
30506,2,[AGC]GeniusGamer,2474,0,1,1,2,50.0%,2h
30506,3,JuanxD,2474,30,1,3,4,25.0%,2h
30506,2,jam,2474,0,1,4,5,20.0%,5m
30506,3,Thumper,2474,0,0,1,1,0.0%,4m
30506,3,TaiMaiShu,2474,0,0,3,3,0.0%,26m
30506,3,TonyU,2474,0,0,3,3,0.0%,2h
30506,1,ChestRockwel,2474,0,0,5,5,0.0%,27m
30537,2,carlos,2473,1570,185,183,368,50.3%,20m
30537,2,thonixxx,2473,1602,69,79,148,46.6%,6m
30537,3,Bobert,2473,1232,50,42,92,54.3%,33m
30537,2,DarkHorse,2473,846,47,43,90,52.2%,2h
30537,3,dan,2473,567,23,25,48,47.9%,29m
30537,2,[x5MeOx]Rezlin,2473,484,17,24,41,41.5%,34m
30537,2,[RatsPE]enlabe,2473,378,14,14,28,50.0%,49m
30537,3,Flimmy,2473,314,12,13,25,48.0%,25m
30537,2,Picotto,2473,178,6,12,18,33.3%,29m
30537,3,Enmamurder,2473,98,5,3,8,62.5%,45m
30537,3,audio,2473,68,5,6,11,45.5%,2h
30537,2,[AbcCo]GianMarco,2473,144,5,8,13,38.5%,18m
30537,2,DArk,2473,150,5,10,15,33.3%,12m
30537,2,[CTsix]Danimal,2473,116,4,3,7,57.1%,12m
30537,2,DANTESINFER,2473,114,4,9,13,30.8%,35m
30537,2,[xAK7x]Coto,2473,111,3,1,4,75.0%,2h
30537,3,Ropz,2473,58,3,3,6,50.0%,2h
30537,2,killzer,2473,134,3,4,7,42.9%,44m
30537,3,[DXoP]Khundelar,2473,30,2,1,3,66.7%,1h
30537,3,Donator,2473,30,2,2,4,50.0%,7m
30537,2,darcharchon,2473,88,2,5,7,28.6%,2h
30537,1,Laidyn,2473,0,0,1,1,0.0%,48m
30537,3,[ShTiLe]FoDrizzle,2473,0,0,1,1,0.0%,2h
30537,3,yoisan,2473,0,0,2,2,0.0%,2h
30561,1,SapperKick,2472,1611,155,161,316,49.1%,42m
30561,2,TiredofLife,2472,698,124,114,238,52.1%,2h
30561,1,Toasteen,2472,737,96,91,187,51.3%,2h
30561,3,hevel,2472,708,70,50,120,58.3%,33m
30561,2,LambKebab,2472,1487,64,64,128,50.0%,49m
30561,2,Batousai,2472,842,64,68,132,48.5%,2h
30561,2,jjGuevara,2472,1200,48,42,90,53.3%,33m
30561,3,[bergh]deyl,2472,1104,47,41,88,53.4%,2h
30561,3,Encantador,2472,1026,40,36,76,52.6%,50m
30561,2,Trust,2472,836,32,31,63,50.8%,2h
30561,1,Shadow,2472,826,32,34,66,48.5%,16m
30561,1,BESTPLAYER,2472,749,25,33,58,43.1%,16m
30561,3,ToxxicImpact,2472,422,15,16,31,48.4%,13m
30561,2,Raziel,2472,331,11,8,19,57.9%,2h
30561,2,FBSUPER,2472,264,10,12,22,45.5%,16m
30561,3,BrookzDERP,2472,184,9,9,18,50.0%,1h
30561,3,Midori,2472,144,6,3,9,66.7%,24m
30561,2,arrayzer,2472,158,6,8,14,42.9%,2h
30561,3,weiweipoopoo,2472,118,5,4,9,55.6%,2h
30561,2,PapaSmith,2472,120,5,7,12,41.7%,31m
30561,1,NinjaStatten,2472,119,4,6,10,40.0%,22m
30561,2,HEDG,2472,116,4,6,10,40.0%,39m
30561,3,[MAdice]silent,2472,86,3,3,6,50.0%,2h
30561,2,ItzJustJohn,2472,30,3,3,6,50.0%,2h
30561,2,Shadowentity,2472,30,3,4,7,42.9%,2h
30561,3,Silverstrike,2472,40,3,6,9,33.3%,2h
30561,2,shmagmhar,2472,115,3,7,10,30.0%,2h
30561,3,[Silica]herzenlayana,2472,30,2,0,2,100.0%,11m
30561,3,ThatGuy,2472,30,2,0,2,100.0%,15m
30561,2,JezuzLOLYOO,2472,0,1,0,1,100.0%,28m
30561,1,[DRKORD]Donny,2472,0,1,4,5,20.0%,24m
30561,3,Doflamingo,2472,0,0,1,1,0.0%,2h
30561,3,[PaE]euRad,2472,0,0,1,1,0.0%,3h
30561,3,Tootsfamous,2472,0,0,1,1,0.0%,3h
30561,2,[FTLTX]nivelk,2472,0,0,1,1,0.0%,42m
30561,3,Fhurer,2472,0,0,2,2,0.0%,51m
30561,3,Totakeke,2472,0,0,3,3,0.0%,28m
30561,1,abas,2472,0,0,4,4,0.0%,2h
30599,3,Titan,2471,1662,347,325,672,51.6%,2h
30599,2,WaRLoK,2471,591,111,96,207,53.6%,2h
30599,3,[PMgaf]GoodUsopp,2471,1375,67,45,112,59.8%,2h
30599,1,andy,2471,1613,65,70,135,48.1%,3m
30599,2,AshDragoon,2471,670,64,52,116,55.2%,2h
30599,2,SausageCat,2471,681,58,54,112,51.8%,2h
30599,3,KSCZAFYP,2471,1130,48,34,82,58.5%,7m
30599,3,lalo,2471,759,37,34,71,52.1%,48m
30599,1,Executor,2471,827,30,38,68,44.1%,2h
30599,2,[IIIY]ddd,2471,625,28,30,58,48.3%,2h
30599,3,scott,2471,555,21,14,35,60.0%,50m
30599,3,botsmasher,2471,558,20,15,35,57.1%,30m
30599,2,[Ventr2]Suagalishes,2471,529,20,18,38,52.6%,22m
30599,2,EpikFrost,2471,518,17,21,38,44.7%,2h
30599,3,MagicTerran,2471,290,10,10,20,50.0%,48m
30599,3,[aIien]letsplay,2471,196,8,5,13,61.5%,1h
30599,1,EndersGame,2471,261,8,7,15,53.3%,26m
30599,2,Chabon,2471,238,8,7,15,53.3%,19m
30599,3,matadol,2471,161,6,5,11,54.5%,11m
30599,3,[Ch3s3]WildWolf,2471,150,5,6,11,45.5%,35m
30599,2,[DROM]BichoMena,2471,128,4,4,8,50.0%,18m
30599,1,[TK]Lowjack,2471,146,4,10,14,28.6%,10m
30599,3,TheLichKING,2471,88,3,0,3,100.0%,2h
30599,2,[SRCHA]KrisKon,2471,62,3,5,8,37.5%,16m
30599,1,CaseyWilson,2471,0,2,5,7,28.6%,2h
30599,2,Computer,2471,58,2,6,8,25.0%,2h
30599,2,Jolova,2471,0,1,1,2,50.0%,2h
30599,3,Murphy,2471,30,1,2,3,33.3%,3m
30599,3,COSSY,2471,0,0,1,1,0.0%,36m
30599,3,[PvZMa]xsaberdragon,2471,0,0,1,1,0.0%,30m
30599,3,[TTKOPF]Blitztod,2471,0,0,1,1,0.0%,35m
30630,2,Tyy,2470,1585,246,243,489,50.3%,2h
30630,1,[ValidG]Aberic,2470,729,54,52,106,50.9%,22m
30630,2,[D10S]Arthas,2470,1018,45,55,100,45.0%,23m
30630,2,Abstract,2470,865,36,35,71,50.7%,7m
30630,2,Dorgis,2470,828,33,32,65,50.8%,2h
30630,2,[PlsDie]KittenNugget,2470,779,31,32,63,49.2%,6m
30630,3,dcfobreezy,2470,776,30,26,56,53.6%,7m
30630,2,BigÐickRick,2470,599,24,25,49,49.0%,2h
30630,3,aDOm,2470,608,23,16,39,59.0%,2h
30630,2,Tony,2470,591,23,24,47,48.9%,36m
30630,2,ConVexPrime,2470,321,22,19,41,53.7%,19m
30630,3,StarKiLLer,2470,363,14,7,21,66.7%,36m
30630,2,[DhZAc1]Sadhak,2470,386,14,14,28,50.0%,2h
30630,2,TheWarlord,2470,198,7,9,16,43.8%,2h
30630,3,Peixian,2470,139,4,0,4,100.0%,45m
30630,1,Thanos,2470,48,4,3,7,57.1%,2h
30630,2,Bash,2470,106,4,4,8,50.0%,34m
30630,2,king,2470,118,4,7,11,36.4%,2h
30630,3,ZachariEl,2470,60,3,2,5,60.0%,2h
30630,2,Rabbit,2470,30,3,5,8,37.5%,22m
30630,3,Nasheik,2470,30,2,1,3,66.7%,2h
30630,3,[MPC]elfman,2470,0,1,0,1,100.0%,2h
30630,3,[XpKAc]WOLFS,2470,0,1,1,2,50.0%,15m
30630,3,Dicer,2470,30,1,1,2,50.0%,18m
30630,1,LetoAtreides,2470,0,1,4,5,20.0%,47m
30630,1,EastLaBeast,2470,0,1,4,5,20.0%,2h
30630,3,Nerrkod,2470,0,0,1,1,0.0%,2h
30657,2,[Epokhé]PingPongGirl,2469,1570,128,124,252,50.8%,2h
30657,3,mehmehmeh,2469,880,44,21,65,67.7%,49m
30657,2,[AbcCo]alpaco,2469,1008,42,37,79,53.2%,33m
30657,3,[KBTCT]Gurpta,2469,722,26,20,46,56.5%,2h
30657,2,Piwo,2469,506,21,14,35,60.0%,43m
30657,1,AiurBlade,2469,572,20,27,47,42.6%,3h
30657,2,[T4TG]kurbo,2469,230,14,12,26,53.8%,45m
30657,3,[INKA5]abathur,2469,357,13,14,27,48.1%,3h
30657,3,[cuak64]ChichaMorada,2469,182,9,8,17,52.9%,1h
30657,1,illusion,2469,328,9,16,25,36.0%,20m
30657,3,NoChzMACplz,2469,234,8,9,17,47.1%,29m
30657,2,[secta]jorgeprotoss,2469,151,6,8,14,42.9%,2h
30657,2,[TH0T5]Greenkid,2469,116,5,6,11,45.5%,47m
30657,3,ASDNZ,2469,0,4,1,5,80.0%,2h
30657,2,[latrom]Exothermic,2469,88,4,3,7,57.1%,1h
30657,3,[VVA]Belyeomans,2469,0,3,2,5,60.0%,3h
30657,1,[gksrnr]Class,2469,0,3,2,5,60.0%,2h
30657,1,CHABRAAAAAH,2469,94,3,3,6,50.0%,2h
30657,2,[TWL20]sokDAO,2469,130,3,4,7,42.9%,17m
30657,3,[ICSC2]Music,2469,38,3,6,9,33.3%,2h
30657,3,[scMAUI]Jayden,2469,0,1,0,1,100.0%,2h
30657,2,[Ta130O]Dragah,2469,0,1,1,2,50.0%,19m
30657,2,BeHeAdEr,2469,0,1,1,2,50.0%,2h
30657,3,ranier,2469,30,1,2,3,33.3%,35m
30657,2,ViolenciA,2469,0,1,3,4,25.0%,2h
30657,3,Dom,2469,0,0,2,2,0.0%,19m
30657,2,Sherifs,2469,0,0,2,2,0.0%,2h
30684,1,[LMI42]fatbaldoldma,2468,1233,141,145,286,49.3%,26m
30684,2,[dede]Walruscan,2468,1494,74,64,138,53.6%,1h
30684,3,Gutz,2468,1540,64,53,117,54.7%,2h
30684,3,Killstatic,2468,1137,53,55,108,49.1%,30m
30684,3,AlexBlikerd,2468,952,35,36,71,49.3%,18m
30684,2,Lacera,2468,351,31,24,55,56.4%,10m
30684,2,[ILMG]PuraVida,2468,441,18,17,35,51.4%,33m
30684,3,[LEC]Lucky,2468,478,16,10,26,61.5%,13m
30684,3,[HeLiuM]Creefter,2468,247,15,16,31,48.4%,30m
30684,2,[KiDo]beluluba,2468,414,14,14,28,50.0%,36m
30684,3,Learning,2468,337,13,9,22,59.1%,19m
30684,2,flight,2468,296,10,11,21,47.6%,2h
30684,2,Slug,2468,219,8,10,18,44.4%,2h
30684,1,[RNSF]Ricen,2468,193,8,11,19,42.1%,4m
30684,3,[KhanZ]sanagus,2468,146,5,6,11,45.5%,2h
30684,3,Red,2468,146,3,2,5,60.0%,18m
30684,2,Newen,2468,0,3,5,8,37.5%,39m
30684,2,hogker,2468,140,3,7,10,30.0%,1h
30684,3,[TTSP]UrLastSight,2468,58,2,2,4,50.0%,2h
30684,3,FFCBooid,2468,60,2,2,4,50.0%,2h
30684,2,ImSkills,2468,0,2,4,6,33.3%,2h
30684,3,Rakzo,2468,30,1,2,3,33.3%,40m
30684,3,Nicarus,2468,0,0,1,1,0.0%,2h
30684,3,Tatomoca,2468,0,0,1,1,0.0%,3h
30684,3,BluEyeZ,2468,0,0,1,1,0.0%,2h
30684,3,[AntLYF]DarkTemplar,2468,0,0,1,1,0.0%,51m
30684,3,[SMos]samuelius,2468,0,0,3,3,0.0%,2h
30711,2,Higgons,2467,1428,161,142,303,53.1%,2h
30711,2,Guterbaljo,2467,1297,97,85,182,53.3%,20m
30711,3,InstaQuasar,2467,910,83,71,154,53.9%,3h
30711,1,Hoosierboi,2467,1605,78,86,164,47.6%,2h
30711,2,[SyLx]JulioTche,2467,1078,40,39,79,50.6%,1h
30711,3,Xenorf,2467,884,33,28,61,54.1%,24m
30711,2,Jez,2467,628,24,24,48,50.0%,2h
30711,1,Alucard,2467,479,22,24,46,47.8%,27m
30711,2,[zeez]Carnivorous,2467,562,20,25,45,44.4%,30m
30711,2,Ivanoso,2467,422,17,17,34,50.0%,18m
30711,3,[TY4GG]DukeY,2467,404,15,5,20,75.0%,2h
30711,2,GrFrHuki,2467,423,15,15,30,50.0%,2h
30711,2,Bardzini,2467,420,14,16,30,46.7%,7m
30711,1,EmpireSelknm,2467,458,14,24,38,36.8%,2h
30711,3,Bixby,2467,350,13,12,25,52.0%,49m
30711,1,Zafe,2467,316,13,15,28,46.4%,20m
30711,3,Mybaran,2467,302,10,10,20,50.0%,39m
30711,3,Samantha,2467,262,8,4,12,66.7%,18m
30711,3,DoudGeorges,2467,204,7,9,16,43.8%,2h
30711,2,fabian,2467,295,7,13,20,35.0%,9m
30711,2,JAYK,2467,30,5,3,8,62.5%,2h
30711,2,IrishZiggy,2467,121,5,7,12,41.7%,2h
30711,3,caotuongvy,2467,86,4,1,5,80.0%,46m
30711,2,Satin,2467,108,3,2,5,60.0%,2h
30711,3,[TX8]ShadowRPK,2467,86,3,3,6,50.0%,2h
30711,2,Stormwolf,2467,0,3,4,7,42.9%,18m
30711,2,PsYcHO,2467,30,3,5,8,37.5%,2h
30711,3,konano,2467,30,2,2,4,50.0%,39m
30711,3,hugo,2467,70,2,3,5,40.0%,6m
30711,3,[ConFed]Python,2467,0,1,0,1,100.0%,18m
30711,3,Suun,2467,40,1,4,5,20.0%,38m
30711,3,[Trujil]despiaDADO,2467,0,0,1,1,0.0%,1h
30711,3,paRaDe,2467,0,0,1,1,0.0%,2h
30711,3,XIX,2467,0,0,1,1,0.0%,24m
30711,3,Kawkaro,2467,0,0,2,2,0.0%,2h
30711,2,Shadowstorm,2467,0,0,2,2,0.0%,2h
30711,1,Evils,2467,0,0,3,3,0.0%,2h
30711,1,MambaTUTERRO,2467,0,0,5,5,0.0%,26m
30749,3,Xsilverhit,2466,1610,103,94,197,52.3%,42m
30749,2,Roflsquad,2466,1586,103,101,204,50.5%,3h
30749,2,[PuffWC]VaporGhost,2466,1220,84,83,167,50.3%,2h
30749,3,DustandAshes,2466,1589,68,61,129,52.7%,2h
30749,2,NDFS,2466,1202,66,79,145,45.5%,39m
30749,1,Mithrandir,2466,1026,48,51,99,48.5%,2h
30749,2,BananaKush,2466,629,38,30,68,55.9%,3h
30749,3,Gnuts,2466,780,31,27,58,53.4%,3h
30749,2,ImKorean,2466,821,31,34,65,47.7%,5m
30749,2,TERRIANN,2466,527,23,21,44,52.3%,2h
30749,2,AnviD,2466,550,23,24,47,48.9%,1h
30749,2,RattusRattus,2466,406,17,17,34,50.0%,50m
30749,3,JIMBO,2466,344,13,5,18,72.2%,34m
30749,2,alex,2466,375,13,21,34,38.2%,2h
30749,3,denver,2466,336,11,7,18,61.1%,1h
30749,1,commando,2466,280,11,11,22,50.0%,2h
30749,1,Thorin,2466,303,11,12,23,47.8%,2h
30749,3,YeshuaReigns,2466,268,10,10,20,50.0%,40m
30749,3,[Preran]guachimiri,2466,171,9,2,11,81.8%,30m
30749,3,NECRODRAGON,2466,313,9,10,19,47.4%,26m
30749,2,[OD2019]Raise,2466,246,9,13,22,40.9%,34m
30749,2,Crazyspx,2466,253,8,8,16,50.0%,35m
30749,2,GamenDeaD,2466,162,5,3,8,62.5%,2h
30749,3,Xddgame,2466,129,5,4,9,55.6%,2h
30749,2,SneakyAF,2466,92,5,7,12,41.7%,1h
30749,3,SantiXtreme,2466,0,4,1,5,80.0%,2h
30749,3,Sociopath,2466,0,3,3,6,50.0%,2h
30749,1,[Otlndr]TOSSedSalad,2466,34,3,6,9,33.3%,48m
30749,3,saxus,2466,42,3,6,9,33.3%,26m
30749,3,sneakyshogun,2466,30,2,0,2,100.0%,14m
30749,3,Dutonius,2466,0,2,3,5,40.0%,41m
30749,3,fox,2466,60,2,6,8,25.0%,1h
30749,3,nzAbyssal,2466,0,1,0,1,100.0%,2h
30749,2,RidenX,2466,0,1,2,3,33.3%,1h
30749,3,Klaudio,2466,0,1,3,4,25.0%,30m
30749,1,SkySyke,2466,0,1,4,5,20.0%,2h
30749,3,Assiance,2466,0,0,1,1,0.0%,2h
30749,3,VictoriuzPRD,2466,0,0,1,1,0.0%,1h
30749,3,[YNV]DeViouS,2466,0,0,5,5,0.0%,2h
30788,3,yuyo,2465,1548,276,266,542,50.9%,2h
30788,2,CaptJager,2465,1143,175,156,331,52.9%,2h
30788,3,XelDarim,2465,1605,160,151,311,51.4%,1h
30788,2,shadow,2465,1602,108,101,209,51.7%,2h
30788,2,dlo,2465,1584,70,64,134,52.2%,2h
30788,3,JDetective,2465,1019,55,60,115,47.8%,34m
30788,2,Emmax,2465,951,35,38,73,47.9%,43m
30788,2,Thornado,2465,695,29,32,61,47.5%,34m
30788,3,Jungki,2465,650,27,17,44,61.4%,2h
30788,2,JWJW,2465,607,26,18,44,59.1%,2h
30788,3,PartyPolice,2465,424,24,16,40,60.0%,25m
30788,3,Lord,2465,508,21,12,33,63.6%,14m
30788,2,Bethechange,2465,572,21,28,49,42.9%,17m
30788,1,[0A0]FiloD,2465,620,20,31,51,39.2%,42m
30788,3,lonecraft,2465,444,19,11,30,63.3%,2h
30788,2,[WSpros]Artanis,2465,436,16,19,35,45.7%,2h
30788,2,Weezer,2465,432,15,17,32,46.9%,2h
30788,3,SilenceSword,2465,255,13,5,18,72.2%,7m
30788,3,Tenseigan,2465,242,9,6,15,60.0%,7m
30788,1,Cartell,2465,267,9,10,19,47.4%,3h
30788,2,[RawDog]DrPoopyHands,2465,210,7,13,20,35.0%,42m
30788,2,Redman,2465,262,6,8,14,42.9%,2h
30788,2,server,2465,150,5,5,10,50.0%,33m
30788,3,Sonansadaxi,2465,146,5,5,10,50.0%,2h
30788,2,[GCCLAN]ItsFrankYz,2465,114,4,7,11,36.4%,2h
30788,3,elwampas,2465,0,3,2,5,60.0%,35m
30788,3,prometeo,2465,58,3,2,5,60.0%,50m
30788,3,ChingonX,2465,86,3,3,6,50.0%,25m
30788,3,hayhaycool,2465,38,2,0,2,100.0%,2h
30788,3,Garrett,2465,30,2,2,4,50.0%,49m
30788,3,QueenGee,2465,96,2,2,4,50.0%,2h
30788,3,Hakujin,2465,96,2,4,6,33.3%,2h
30788,1,handsomeeeee,2465,46,2,4,6,33.3%,2h
30788,3,andrejmj,2465,60,2,5,7,28.6%,19m
30788,3,Weesan,2465,0,1,0,1,100.0%,3h
30788,3,Elwaifu,2465,0,1,0,1,100.0%,13m
30788,3,[AbcCo]genjiro,2465,0,1,0,1,100.0%,2h
30788,3,[xMSx]GENERALZON,2465,30,1,1,2,50.0%,33m
30788,1,[500CC]Artgamer,2465,0,1,4,5,20.0%,3m
30827,3,LanceyLance,2464,1327,84,60,144,58.3%,35m
30827,2,[LOHs]RdmFlyingCow,2464,909,60,62,122,49.2%,2h
30827,3,Kratos,2464,1245,55,39,94,58.5%,28m
30827,3,Wombosi,2464,705,53,30,83,63.9%,2h
30827,2,Nooze,2464,817,37,37,74,50.0%,37m
30827,2,Conerak,2464,312,12,12,24,50.0%,43m
30827,1,JDiesel,2464,273,10,7,17,58.8%,2h
30827,3,[JBU33]Hatchet,2464,228,9,7,16,56.2%,2h
30827,3,Nubcakes,2464,276,9,12,21,42.9%,3m
30827,3,[MexTec]BillytheKid,2464,172,7,7,14,50.0%,2h
30827,3,GCKALLDAY,2464,116,7,11,18,38.9%,32m
30827,3,kkiller,2464,176,6,5,11,54.5%,2h
30827,3,Noada,2464,118,5,2,7,71.4%,44m
30827,3,shmily,2464,120,4,4,8,50.0%,49m
30827,1,Mesa,2464,30,3,6,9,33.3%,2h
30827,3,KingEagle,2464,94,2,4,6,33.3%,2h
30827,3,kirlionik,2464,96,2,4,6,33.3%,2h
30827,2,Tatzel,2464,30,2,9,11,18.2%,20m
30827,3,[Qu4ntm]OMGTHISGUY,2464,0,1,0,1,100.0%,30m
30827,3,Veseluxa,2464,0,1,1,2,50.0%,50m
30827,1,Alk,2464,0,1,2,3,33.3%,2h
30827,3,Genesis,2464,0,1,4,5,20.0%,2h
30827,3,IIlIlllI,2464,0,1,4,5,20.0%,50m
30827,3,Joan,2464,30,1,4,5,20.0%,49m
30827,3,Rastreador,2464,0,1,4,5,20.0%,13m
30827,3,FlashPoint,2464,0,0,1,1,0.0%,2h
30827,3,[PSTRAT]Yeti,2464,0,0,1,1,0.0%,26m
30827,3,[FNLP]Nemmy,2464,0,0,1,1,0.0%,18m
30855,1,Popeye,2463,1338,66,66,132,50.0%,2h
30855,2,war,2463,1218,54,63,117,46.2%,2h
30855,3,Tzieh,2463,704,33,24,57,57.9%,3h
30855,3,sosuke,2463,688,27,26,53,50.9%,35m
30855,2,SirNathaniel,2463,566,23,17,40,57.5%,1h
30855,3,Notlim,2463,558,21,14,35,60.0%,42m
30855,2,[αB]SniperSC,2463,556,20,23,43,46.5%,33m
30855,3,TNOZADAR,2463,478,17,20,37,45.9%,2h
30855,1,[W1C]Rivermethis,2463,259,16,16,32,50.0%,2h
30855,3,alanlord,2463,406,15,13,28,53.6%,27m
30855,2,[SM0K3]minjhoppa,2463,270,11,12,23,47.8%,49m
30855,1,MRSUN,2463,277,10,12,22,45.5%,3m
30855,2,Smiley,2463,257,9,6,15,60.0%,2h
30855,1,SoulReviver,2463,208,9,11,20,45.0%,3m
30855,1,Joni,2463,247,9,12,21,42.9%,1h
30855,3,Starblade,2463,205,8,6,14,57.1%,18m
30855,1,Name,2463,129,6,7,13,46.2%,42m
30855,1,[MA21]kennyhong,2463,116,5,5,10,50.0%,2h
30855,3,BobertRoss,2463,116,4,3,7,57.1%,47m
30855,1,Lyle,2463,104,4,9,13,30.8%,3h
30855,3,BroodKing,2463,0,2,1,3,66.7%,2h
30855,3,MotorMax,2463,30,2,2,4,50.0%,30m
30855,3,chinomite,2463,60,2,4,6,33.3%,40m
30855,3,EXECUTOR,2463,0,1,0,1,100.0%,13m
30855,3,WineMom,2463,30,1,3,4,25.0%,28m
30855,3,[lab317]MRALEXANDER,2463,0,0,1,1,0.0%,2h
30855,3,wickedftw,2463,0,0,1,1,0.0%,1h
30855,3,grouch,2463,0,0,2,2,0.0%,3m
30883,2,PiPe,2462,1499,125,107,232,53.9%,3h
30883,1,jiminlee,2462,862,29,42,71,40.8%,3h
30883,1,Zapora,2462,540,21,25,46,45.7%,3h
30883,1,Beegbean,2462,607,21,28,49,42.9%,38m
30883,3,BeardCraft,2462,452,20,20,40,50.0%,43m
30883,3,Contrasena,2462,426,15,17,32,46.9%,2h
30883,1,[xf3]nApAlm,2462,430,13,26,39,33.3%,2h
30883,2,strangel,2462,329,12,13,25,48.0%,2h
30883,2,[xMETAx]GavaBoo,2462,264,10,11,21,47.6%,2h
30883,3,[464]Radamanthys,2462,237,9,7,16,56.2%,43m
30883,2,[SANGRE]sergio,2462,225,7,7,14,50.0%,3h
30883,2,[BkD34]Django,2462,214,7,8,15,46.7%,2h
30883,3,[OceanT]MarceloV,2462,216,6,3,9,66.7%,50m
30883,3,Qix,2462,170,6,9,15,40.0%,2h
30883,3,[BR33D]Minos,2462,30,5,6,11,45.5%,30m
30883,1,madumlao,2462,136,5,12,17,29.4%,2h
30883,3,Native,2462,0,3,2,5,60.0%,4m
30883,3,Dbelzberg,2462,60,3,4,7,42.9%,2h
30883,3,akien,2462,58,3,4,7,42.9%,45m
30883,2,hkxstyle,2462,107,3,5,8,37.5%,1h
30883,2,WiseAsian,2462,114,3,6,9,33.3%,2h
30883,3,FireStar,2462,32,3,6,9,33.3%,2h
30883,2,[UAK]joe,2462,92,3,7,10,30.0%,2h
30883,1,[SRNT]Shihao,2462,0,2,3,5,40.0%,46m
30883,3,Fer,2462,0,2,3,5,40.0%,2h
30883,1,BadRandon,2462,48,2,4,6,33.3%,2h
30883,3,iCeFuRy,2462,0,1,4,5,20.0%,35m
30883,3,Duo,2462,0,0,1,1,0.0%,7m
30883,3,CHALLENGER,2462,0,0,1,1,0.0%,3h
30883,3,GoldPhantom,2462,0,0,1,1,0.0%,2h
30883,3,comicman,2462,0,0,3,3,0.0%,12m
30883,3,DopeyKoala,2462,0,0,5,5,0.0%,4m
30915,2,TipsyAndy,2461,1538,127,118,245,51.8%,32m
30915,3,[VFam2]Peets,2461,1298,48,48,96,50.0%,2h
30915,2,RangerEd,2461,604,36,34,70,51.4%,4m
30915,2,[GINO]Whitey,2461,715,30,27,57,52.6%,40m
30915,2,Decepticon,2461,375,23,27,50,46.0%,2h
30915,3,iloveoov,2461,523,21,15,36,58.3%,2h
30915,2,[GiLLs]Smacknally,2461,443,18,12,30,60.0%,29m
30915,3,SmellyYeti,2461,225,15,3,18,83.3%,33m
30915,3,[ITGT]Fernando,2461,418,15,11,26,57.7%,35m
30915,3,Cruizieduzie,2461,409,14,9,23,60.9%,19m
30915,3,[464]kingZERATUL,2461,191,9,10,19,47.4%,14m
30915,3,Illlllllllll,2461,259,8,3,11,72.7%,2h
30915,1,CrankyPants,2461,267,8,7,15,53.3%,8m
30915,3,herculeboss,2461,176,7,7,14,50.0%,2h
30915,1,notefive,2461,94,5,9,14,35.7%,28m
30915,1,[EvilGC]Fenrir,2461,154,4,2,6,66.7%,13m
30915,3,justhavefunn,2461,95,3,0,3,100.0%,3m
30915,3,GetAHelmet,2461,0,3,2,5,60.0%,2h
30915,3,noobmaster,2461,40,3,5,8,37.5%,2h
30915,1,Keamon,2461,46,2,7,9,22.2%,12m
30915,1,NebulaDesign,2461,0,1,0,1,100.0%,2h
30915,3,[FFAA]MaxiD,2461,30,1,1,2,50.0%,28m
30915,3,profmaurod,2461,0,1,4,5,20.0%,46m
30915,3,FlashSpeed,2461,0,1,4,5,20.0%,2h
30915,3,[wertb]speedthunder,2461,0,0,1,1,0.0%,18m
30940,1,puzzykiller,2460,1214,129,128,257,50.2%,43m
30940,2,BundlOfStiks,2460,1606,93,87,180,51.7%,3h
30940,1,SgtoTony,2460,1350,80,86,166,48.2%,6m
30940,3,ARTANIS,2460,988,41,32,73,56.2%,1h
30940,2,ZzZz,2460,345,14,9,23,60.9%,45m
30940,3,ParanoidGou,2460,356,14,9,23,60.9%,50m
30940,1,lemonade,2460,360,13,10,23,56.5%,31m
30940,2,[ZergW]Fad,2460,244,12,11,23,52.2%,44m
30940,2,Gery,2460,280,11,11,22,50.0%,2h
30940,3,LocutusDBorg,2460,180,7,5,12,58.3%,45m
30940,1,Draynan,2460,30,5,13,18,27.8%,33m
30940,1,Buzzkilla,2460,90,4,6,10,40.0%,2h
30940,1,brainnagi,2460,97,3,4,7,42.9%,48m
30940,3,JAN,2460,123,3,5,8,37.5%,2h
30940,3,sean,2460,0,3,6,9,33.3%,16m
30940,3,ujiha,2460,147,3,7,10,30.0%,25m
30940,2,Freeze,2460,88,3,7,10,30.0%,18m
30940,3,ccash,2460,0,2,4,6,33.3%,2h
30940,3,xombie,2460,0,2,5,7,28.6%,2h
30940,3,CookieCannon,2460,0,1,0,1,100.0%,47m
30940,3,asasinender,2460,30,1,1,2,50.0%,3m
30940,3,Flash,2460,30,1,1,2,50.0%,16m
30940,3,RandKaz,2460,0,1,1,2,50.0%,2h
30940,1,[MFerss]dac,2460,0,1,4,5,20.0%,24m
30940,2,Navidson,2460,0,0,1,1,0.0%,37m
30940,3,[Asmbly]Smith,2460,0,0,1,1,0.0%,33m
30940,2,babyboy,2460,0,0,1,1,0.0%,42m
30940,3,ILLBKILLIN,2460,0,0,2,2,0.0%,39m
30940,3,Keenstar,2460,0,0,2,2,0.0%,41m
30940,2,kanuk,2460,0,0,3,3,0.0%,16m
30970,2,MarineLord,2459,464,132,142,274,48.2%,40m
30970,2,[PobSC]Elesho,2459,1444,85,78,163,52.1%,3h
30970,3,Arkoudaki,2459,1569,68,64,132,51.5%,18m
30970,2,[ML4WD]MadamSandler,2459,1236,59,50,109,54.1%,47m
30970,2,[TILtd]Fisk,2459,941,52,49,101,51.5%,2h
30970,2,Elfuego,2459,778,39,33,72,54.2%,49m
30970,2,iATechnique,2459,400,26,17,43,60.5%,2h
30970,3,Cavlor,2459,681,26,25,51,51.0%,2h
30970,3,Carlyle,2459,577,23,21,44,52.3%,35m
30970,3,[TGosuB]Nukemaster,2459,418,16,4,20,80.0%,46m
30970,3,[T600]FeatAlex,2459,275,11,7,18,61.1%,2h
30970,1,TheCrudMan,2459,339,11,15,26,42.3%,36m
30970,3,DiegoStanden,2459,276,10,9,19,52.6%,13m
30970,2,[opWeed]Accelerator,2459,317,10,14,24,41.7%,14m
30970,3,[NotZ]NakedPancake,2459,230,6,7,13,46.2%,38m
30970,3,bbuba,2459,187,4,7,11,36.4%,2h
30970,3,KloudNine,2459,126,4,7,11,36.4%,2h
30970,3,Pistallion,2459,58,3,1,4,75.0%,34m
30970,2,CarloR,2459,0,3,3,6,50.0%,2h
30970,2,Renegade,2459,0,3,4,7,42.9%,2h
30970,1,WcSkratos,2459,0,1,4,5,20.0%,2h
30970,3,AZTECA,2459,0,0,1,1,0.0%,2h
30970,1,nigitynig,2459,0,0,7,7,0.0%,36m
30993,2,ChuckChunder,2458,1300,62,59,121,51.2%,2h
30993,2,Countersmell,2458,934,30,52,82,36.6%,40m
30993,2,FGDFG,2458,714,29,27,56,51.8%,2h
30993,2,xero,2458,584,20,27,47,42.6%,2h
30993,2,[fOrEvR]yOungOne,2458,534,19,22,41,46.3%,32m
30993,2,OhCamembert,2458,489,18,19,37,48.6%,2h
30993,2,FlyinPenguin,2458,468,17,19,36,47.2%,10m
30993,1,Cecil,2458,306,13,25,38,34.2%,17m
30993,3,BigMart,2458,213,8,7,15,53.3%,3h
30993,2,Aress,2458,236,8,16,24,33.3%,34m
30993,2,Evdog,2458,62,6,9,15,40.0%,6m
30993,3,twhittles,2458,0,4,3,7,57.1%,6m
30993,3,Supertask,2458,137,4,5,9,44.4%,27m
30993,3,Joasj,2458,62,3,1,4,75.0%,19m
30993,3,Conspiration,2458,60,3,2,5,60.0%,18m
30993,2,DARTHVADER,2458,119,3,2,5,60.0%,47m
30993,2,[CITIOS]Isaiash,2458,138,3,6,9,33.3%,2h
30993,2,Deathbringer,2458,150,3,7,10,30.0%,2h
30993,2,Chhogori,2458,86,3,10,13,23.1%,2h
30993,2,Dudemeister,2458,30,2,7,9,22.2%,2h
30993,3,Yeti,2458,0,1,1,2,50.0%,11m
30993,2,Reagan,2458,0,1,3,4,25.0%,35m
30993,2,[HEZUS]Boff,2458,0,1,3,4,25.0%,46m
30993,1,[XpKAc]Dresjo,2458,0,1,4,5,20.0%,1h
30993,3,ChewyCheese,2458,0,1,4,5,20.0%,2h
30993,3,Legion,2458,0,1,4,5,20.0%,28m
30993,3,ALLEGADOTHOR,2458,0,0,1,1,0.0%,2h
30993,3,kingpotato,2458,0,0,1,1,0.0%,13m
30993,3,HighLordBean,2458,0,0,1,1,0.0%,2h
30993,3,Insanity,2458,0,0,2,2,0.0%,2h
30993,3,XavierLol,2458,0,0,4,4,0.0%,40m
30993,2,caxla,2458,0,0,4,4,0.0%,2h
31025,3,darkos,2457,1354,61,52,113,54.0%,2h
31025,2,jheferson,2457,994,48,34,82,58.5%,2h
31025,2,CptBoring,2457,890,37,41,78,47.4%,34m
31025,1,Armodizzle,2457,323,26,35,61,42.6%,2h
31025,3,Jimmy,2457,634,24,19,43,55.8%,18m
31025,1,Mindmaster,2457,545,24,27,51,47.1%,34m
31025,2,[PobSC]VocaloidBot,2457,441,18,15,33,54.5%,2h
31025,2,Bobbus,2457,440,16,22,38,42.1%,35m
31025,2,TheZickness,2457,340,11,19,30,36.7%,2h
31025,3,TechCraft,2457,266,10,8,18,55.6%,2h
31025,3,jesuwolf,2457,260,9,3,12,75.0%,28m
31025,1,JoeyBee,2457,90,7,6,13,53.8%,1h
31025,3,theblue,2457,30,4,2,6,66.7%,2h
31025,3,YoYo,2457,147,4,6,10,40.0%,43m
31025,3,msbaits,2457,72,4,7,11,36.4%,1h
31025,1,[MFNS]Yargh,2457,97,2,2,4,50.0%,2h
31025,3,Dozer,2457,0,2,5,7,28.6%,2h
31025,3,ATrueDean,2457,131,2,5,7,28.6%,7m
31025,3,Mitsuha,2457,0,1,0,1,100.0%,41m
31025,3,subjectzero,2457,0,1,1,2,50.0%,49m
31025,1,Bohjaangles,2457,94,1,2,3,33.3%,6m
31046,3,AngryEarl,2456,1545,193,198,391,49.4%,40m
31046,2,RonnyDaBear,2456,699,109,104,213,51.2%,32m
31046,3,[KKMM]Káiser,2456,1414,106,98,204,52.0%,33m
31046,2,[NeAs]Zippo,2456,980,96,84,180,53.3%,43m
31046,3,CCyanzong,2456,930,86,100,186,46.2%,38m
31046,3,Dreamwalker,2456,1593,80,59,139,57.6%,2h
31046,3,dyun,2456,707,39,24,63,61.9%,30m
31046,3,FlyFresno,2456,653,26,22,48,54.2%,28m
31046,2,[CoPiTo]JorgeTdin,2456,504,18,23,41,43.9%,45m
31046,3,BlindingSW,2456,479,17,19,36,47.2%,39m
31046,2,JLennon,2456,367,14,21,35,40.0%,18m
31046,3,Taxonman,2456,338,12,9,21,57.1%,36m
31046,2,Vietoronto,2456,293,11,18,29,37.9%,2h
31046,3,bicboi,2456,247,8,10,18,44.4%,36m
31046,2,ThatWasQuick,2456,176,6,6,12,50.0%,47m
31046,2,Flavious,2456,202,6,9,15,40.0%,33m
31046,2,Reichjanz,2456,128,5,11,16,31.2%,18m
31046,2,XjesseX,2456,168,4,8,12,33.3%,2h
31046,3,[WolfX]SINVERGUENZA,2456,30,2,1,3,66.7%,2h
31046,3,BearRammidge,2456,0,1,4,5,20.0%,38m
31046,3,[LOHs]bcack,2456,96,1,4,5,20.0%,2h
31046,1,arthanis,2456,0,1,4,5,20.0%,2h
31046,3,Quazleplemp,2456,0,1,4,5,20.0%,50m
31046,3,Kirito,2456,0,1,4,5,20.0%,2h
31046,3,Overlord,2456,0,0,1,1,0.0%,13m
31046,3,nicoseaman,2456,0,0,1,1,0.0%,2h
31046,3,Rhemmy,2456,0,0,2,2,0.0%,2h
31073,2,gimone,2455,1564,131,129,260,50.4%,1h
31073,1,Rage,2455,1299,90,85,175,51.4%,28m
31073,3,cheesybread,2455,1357,89,74,163,54.6%,1h
31073,2,Anthony,2455,747,65,50,115,56.5%,47m
31073,2,Dimoschemo,2455,1175,53,49,102,52.0%,21m
31073,3,WhiteClaw,2455,1105,43,45,88,48.9%,34m
31073,3,MASTERED,2455,872,38,24,62,61.3%,18m
31073,3,ohmeingott,2455,434,36,21,57,63.2%,45m
31073,3,DeTuBR,2455,687,28,21,49,57.1%,18m
31073,3,uforgottodie,2455,702,26,25,51,51.0%,43m
31073,1,percman,2455,606,26,33,59,44.1%,39m
31073,2,Lou,2455,617,25,24,49,51.0%,2h
31073,3,[FyHr]Takaro,2455,666,24,27,51,47.1%,28m
31073,3,[BorgC]bart,2455,375,15,12,27,55.6%,46m
31073,3,GoodyTwo,2455,360,13,13,26,50.0%,25m
31073,3,TimmyJ,2455,260,10,10,20,50.0%,2h
31073,3,brogrimfall,2455,265,9,5,14,64.3%,50m
31073,1,TwistedMood,2455,194,9,12,21,42.9%,3m
31073,1,VirtuosoGl,2455,160,6,0,6,100.0%,1h
31073,1,gounteur,2455,176,6,9,15,40.0%,2h
31073,2,Stunner,2455,0,4,2,6,66.7%,1h
31073,3,[ZTemp]Chesshire,2455,86,4,3,7,57.1%,14m
31073,3,IIIIIIIIIIII,2455,116,4,4,8,50.0%,4m
31073,1,DoggishBeast,2455,129,4,5,9,44.4%,2h
31073,3,Diligence,2455,60,3,4,7,42.9%,43m
31073,2,Petoria,2455,94,3,11,14,21.4%,1h
31073,3,stargamer,2455,60,2,3,5,40.0%,8m
31073,3,nightknight,2455,0,2,3,5,40.0%,2h
31073,2,trailerzs,2455,0,2,4,6,33.3%,17m
31073,3,[BVR]emaster,2455,97,2,5,7,28.6%,35m
31073,3,[Dimand]MenYmaN,2455,30,1,1,2,50.0%,26m
31073,2,Khayen,2455,0,1,1,2,50.0%,35m
31073,3,Animationz,2455,30,1,2,3,33.3%,2h
31073,1,Qrow,2455,0,1,4,5,20.0%,2h
31073,1,ProtoKid,2455,0,1,4,5,20.0%,2h
31073,3,[Ash3s]Optimus,2455,0,0,1,1,0.0%,28m
31073,3,Barcode,2455,0,0,1,1,0.0%,40m
31073,3,[RRC]EXODIUS,2455,0,0,1,1,0.0%,38m
31073,3,Scottomon,2455,0,0,1,1,0.0%,2h
31112,2,Procriador,2454,1555,287,290,577,49.7%,2h
31112,3,Harbinger,2454,920,67,57,124,54.0%,3h
31112,2,Law,2454,636,31,32,63,49.2%,34m
31112,1,[BlesSD]RSdeCSA,2454,435,19,21,40,47.5%,20m
31112,2,[Th3Bad]MName,2454,409,17,19,36,47.2%,2h
31112,3,[DSRL]swine,2454,466,16,18,34,47.1%,2h
31112,3,bkuze,2454,422,15,14,29,51.7%,39m
31112,3,DonMoses,2454,393,14,17,31,45.2%,45m
31112,3,PoKa,2454,316,11,14,25,44.0%,1h
31112,2,[scMAUI]Endymion,2454,306,11,14,25,44.0%,2h
31112,3,JMS,2454,225,8,5,13,61.5%,35m
31112,3,lennon,2454,172,7,4,11,63.6%,46m
31112,3,EndersisxEW,2454,173,6,1,7,85.7%,28m
31112,1,[SMBBD]gordo,2454,128,6,10,16,37.5%,27m
31112,2,[nieBla]Sanborn,2454,88,5,2,7,71.4%,2h
31112,1,[1snD]Xylithol,2454,116,4,7,11,36.4%,2h
31112,3,CarlosObo,2454,58,3,0,3,100.0%,1h
31112,3,SaintSaucy,2454,119,3,1,4,75.0%,2h
31112,3,[ÆON]cazar,2454,90,3,5,8,37.5%,2h
31112,3,ACELIGHT,2454,121,3,5,8,37.5%,21m
31112,1,NFA,2454,48,2,4,6,33.3%,40m
31112,3,[C49]Jalu,2454,0,2,5,7,28.6%,38m
31112,1,JoMamma,2454,0,1,0,1,100.0%,47m
31112,3,Andy,2454,30,1,1,2,50.0%,2h
31112,2,[Kymer]Kryptic,2454,0,1,1,2,50.0%,2h
31112,3,[LIPESC]Biaggio,2454,30,1,1,2,50.0%,12m
31112,3,Leon,2454,30,1,2,3,33.3%,2h
31112,3,Templar,2454,0,0,1,1,0.0%,34m
31112,3,JohnDanaher,2454,0,0,5,5,0.0%,2h
31141,2,[wrrd]Raptor,2453,1284,73,76,149,49.0%,39m
31141,3,Gingerbaker,2453,1267,70,69,139,50.4%,2h
31141,2,GoingJamon,2453,759,63,61,124,50.8%,8m
31141,3,Woplick,2453,1114,46,43,89,51.7%,3h
31141,3,GoMarines,2453,650,39,31,70,55.7%,2h
31141,3,[YomYom]ButterNugget,2453,702,28,26,54,51.9%,30m
31141,2,[Mlol]Nane,2453,383,14,16,30,46.7%,47m
31141,3,Seraphim,2453,198,10,9,19,52.6%,3h
31141,2,Bekrom,2453,202,8,14,22,36.4%,50m
31141,2,ZeroX,2453,138,7,11,18,38.9%,18m
31141,2,CAPITANASO,2453,165,5,7,12,41.7%,2h
31141,3,Leonitis,2453,203,4,7,11,36.4%,18m
31141,3,[SNIP]MGreezy,2453,60,3,1,4,75.0%,35m
31141,2,[WAAC]ItsSmokieFTW,2453,114,2,3,5,40.0%,8m
31141,2,Caerrean,2453,0,2,5,7,28.6%,50m
31141,3,denis,2453,95,1,1,2,50.0%,49m
31141,3,BrunoGianni,2453,30,1,4,5,20.0%,2h
31141,2,Vandraus,2453,0,1,4,5,20.0%,14m
31141,3,agro,2453,0,1,5,6,16.7%,2h
31141,3,[Weac]zare,2453,0,0,1,1,0.0%,26m
31141,1,JDlove,2453,0,0,1,1,0.0%,2h
31141,3,joenurble,2453,0,0,2,2,0.0%,2h
31141,1,[NwAs]DoctorGamer,2453,0,0,2,2,0.0%,2h
31164,1,Bart,2452,1602,180,178,358,50.3%,2h
31164,1,[kisay]Relover,2452,1494,177,178,355,49.9%,23m
31164,2,Lucy,2452,1086,116,113,229,50.7%,33m
31164,3,[AbcCo]Washovietic,2452,1117,65,51,116,56.0%,43m
31164,3,Xam,2452,757,32,31,63,50.8%,19m
31164,3,Catalina,2452,374,23,12,35,65.7%,2h
31164,1,seunghwan,2452,526,20,26,46,43.5%,3h
31164,2,SirRupert,2452,433,17,24,41,41.5%,34m
31164,2,[GGqpEZ]FASZ,2452,424,14,22,36,38.9%,37m
31164,1,WoosterSt,2452,392,12,23,35,34.3%,2h
31164,2,Raymond,2452,230,7,9,16,43.8%,1h
31164,3,Donkeynuts,2452,114,5,6,11,45.5%,2h
31164,1,John,2452,97,4,4,8,50.0%,2h
31164,3,[ITPros]omega,2452,179,4,5,9,44.4%,7m
31164,3,Ymit,2452,133,4,6,10,40.0%,1h
31164,3,Cory,2452,138,4,6,10,40.0%,28m
31164,2,[ABorn]BlackSnow,2452,132,4,7,11,36.4%,17m
31164,3,lllllllll,2452,121,3,2,5,60.0%,12m
31164,3,Paladin,2452,86,3,3,6,50.0%,2h
31164,2,dylpickle,2452,0,3,5,8,37.5%,46m
31164,3,MitakoXx,2452,30,3,5,8,37.5%,1h
31164,3,Madenlee,2452,0,1,0,1,100.0%,28m
31164,3,GFreeman,2452,0,1,1,2,50.0%,45m
31164,3,MingLingYi,2452,30,1,1,2,50.0%,2h
31164,3,Rabbit,2452,0,1,3,4,25.0%,2h
31164,3,benja,2452,0,0,1,1,0.0%,2h
31164,3,Redd,2452,0,0,1,1,0.0%,2h
31164,3,[Pharoh]GorillaPug,2452,0,0,1,1,0.0%,1h
31164,3,[TeamUR]SirVilder,2452,0,0,2,2,0.0%,35m
31164,3,[ALTF04]Barbanegra,2452,0,0,3,3,0.0%,3h
31194,3,art,2451,1586,108,104,212,50.9%,27m
31194,2,SpaceTiger,2451,672,55,52,107,51.4%,2h
31194,3,[Beer20]BeerMMXX,2451,1255,50,46,96,52.1%,2h
31194,3,Nakas,2451,926,35,30,65,53.8%,40m
31194,2,[xXGDXx]Zero,2451,690,32,33,65,49.2%,2h
31194,1,Torrero,2451,856,29,37,66,43.9%,1h
31194,2,Boneless,2451,564,21,22,43,48.8%,18m
31194,2,Brayn,2451,529,19,21,40,47.5%,1h
31194,3,KIRK,2451,334,13,6,19,68.4%,11m
31194,2,zerbear,2451,324,11,15,26,42.3%,22m
31194,3,franzbeets,2451,276,10,4,14,71.4%,50m
31194,2,MaeGovannen,2451,268,9,9,18,50.0%,33m
31194,2,Mizurai,2451,243,8,7,15,53.3%,2h
31194,1,Zao,2451,190,7,11,18,38.9%,2h
31194,3,Buck,2451,192,5,3,8,62.5%,1h
31194,3,ºWARººººFSAº,2451,58,3,0,3,100.0%,49m
31194,3,Ares,2451,138,3,2,5,60.0%,46m
31194,3,Yarvtek,2451,64,3,3,6,50.0%,2h
31194,2,Zodiac,2451,130,3,6,9,33.3%,2h
31194,1,xDestroy,2451,0,1,4,5,20.0%,32m
31194,1,Tim,2451,0,1,4,5,20.0%,25m
31194,2,foxinsocks,2451,30,1,4,5,20.0%,2h
31194,3,Stark,2451,0,0,1,1,0.0%,2h
31194,3,SJS,2451,0,0,1,1,0.0%,1h
31218,2,Huck,2450,1551,102,106,208,49.0%,2h
31218,2,FOPIPOWER,2450,1346,57,49,106,53.8%,40m
31218,3,[ConFed]LadyParts,2450,1218,48,51,99,48.5%,2h
31218,3,Jeeho,2450,968,45,41,86,52.3%,2h
31218,1,EpicSchiPhy,2450,950,35,44,79,44.3%,2h
31218,2,akkarin,2450,650,28,22,50,56.0%,35m
31218,2,SuperDW,2450,472,26,33,59,44.1%,44m
31218,2,[cluez]DesdaNova,2450,499,26,33,59,44.1%,34m
31218,1,alienbaby,2450,354,26,43,69,37.7%,2h
31218,2,Melkor,2450,541,22,21,43,51.2%,8m
31218,2,Emilll,2450,507,20,18,38,52.6%,50m
31218,1,Guhl,2450,623,20,28,48,41.7%,3h
31218,2,Bonefish,2450,397,14,16,30,46.7%,2h
31218,3,druidlad,2450,387,13,12,25,52.0%,2h
31218,2,eatmasoul,2450,206,8,6,14,57.1%,18m
31218,2,Karnage,2450,186,8,10,18,44.4%,33m
31218,3,LewsTherin,2450,116,4,5,9,44.4%,48m
31218,3,[FoxBR]ZéRuela,2450,122,4,5,9,44.4%,2h
31218,3,THESALTLORD,2450,30,2,1,3,66.7%,1h
31218,2,Valiantly,2450,82,2,5,7,28.6%,21m
31218,3,WARnock,2450,0,1,0,1,100.0%,2h
31218,3,Gabriel,2450,30,1,1,2,50.0%,30m
31218,3,Arthas,2450,0,1,4,5,20.0%,1h
31218,3,Murilin,2450,0,0,1,1,0.0%,1h
31218,3,Aligence,2450,0,0,1,1,0.0%,10m
31243,3,sans,2449,1477,131,118,249,52.6%,40m
31243,2,InForTheKill,2449,1600,101,94,195,51.8%,2h
31243,3,RushEm,2449,1576,89,64,153,58.2%,2h
31243,3,DonaldTrump,2449,1533,65,64,129,50.4%,13m
31243,2,andrwdnnis,2449,1437,63,56,119,52.9%,2h
31243,2,OldSock,2449,675,31,21,52,59.6%,22m
31243,3,MaUkTaY,2449,618,25,24,49,51.0%,34m
31243,3,Dayobi,2449,528,22,16,38,57.9%,49m
31243,1,Schmulah,2449,444,19,21,40,47.5%,15m
31243,3,Hour,2449,397,15,13,28,53.6%,3h
31243,1,[MMINGU]Mrwarp,2449,372,12,23,35,34.3%,2h
31243,3,mirage,2449,306,11,11,22,50.0%,13m
31243,3,[SA2SE]Aron,2449,216,9,6,15,60.0%,2h
31243,1,WAREGG,2449,252,9,13,22,40.9%,2h
31243,1,[PvZMa]toastyface,2449,177,7,5,12,58.3%,39m
31243,3,[TossXD]Takashiro,2449,116,5,3,8,62.5%,49m
31243,3,MediAzero,2449,140,5,4,9,55.6%,2h
31243,3,[FNDog]theredone,2449,138,4,6,10,40.0%,34m
31243,3,Soodlenoup,2449,42,3,6,9,33.3%,2h
31243,3,Tong,2449,0,2,3,5,40.0%,36m
31243,2,marchelose,2449,0,2,5,7,28.6%,26m
31243,1,SgtUnknown,2449,0,2,5,7,28.6%,2h
31243,3,Stropko,2449,0,1,0,1,100.0%,2h
31243,3,NinjaINC,2449,0,1,0,1,100.0%,45m
31243,2,[NR2O]BigAz,2449,46,1,3,4,25.0%,2h
31243,1,Mamee,2449,0,1,4,5,20.0%,25m
31243,3,[NexGen]raft,2449,0,0,1,1,0.0%,35m
31243,2,SuperMan,2449,0,0,3,3,0.0%,50m
31271,3,vtflea,2448,1552,352,349,701,50.2%,24m
31271,2,Fokus,2448,1124,117,112,229,51.1%,2h
31271,1,Max,2448,892,75,80,155,48.4%,32m
31271,2,Dust,2448,661,52,46,98,53.1%,50m
31271,3,[Drakes]Xoltyz,2448,675,44,31,75,58.7%,2h
31271,2,OumaRusks,2448,962,37,36,73,50.7%,2h
31271,2,zergswarm,2448,759,32,30,62,51.6%,2h
31271,2,[CCBB]TrainXII,2448,819,31,28,59,52.5%,2h
31271,1,TheFishGuy,2448,791,31,29,60,51.7%,2h
31271,3,Noogie,2448,668,28,29,57,49.1%,4m
31271,2,Doce,2448,490,22,11,33,66.7%,1h
31271,3,Sepharite,2448,500,21,9,30,70.0%,19m
31271,3,MisterBuddy,2448,327,15,17,32,46.9%,40m
31271,3,CrisPeeBacon,2448,328,12,17,29,41.4%,48m
31271,3,Wildcat,2448,256,11,7,18,61.1%,3h
31271,2,McMeager,2448,230,10,9,19,52.6%,1h
31271,2,vethor,2448,291,8,12,20,40.0%,2h
31271,3,[VALHL]Aragorn,2448,146,7,6,13,53.8%,2h
31271,3,tubesock,2448,0,5,6,11,45.5%,2h
31271,3,Serials,2448,144,4,0,4,100.0%,39m
31271,3,Poegan,2448,147,4,6,10,40.0%,2h
31271,3,Rickyguz,2448,30,4,7,11,36.4%,37m
31271,2,BANSHEERUSH,2448,131,3,3,6,50.0%,2h
31271,1,veglia,2448,97,2,1,3,66.7%,1h
31271,3,Reedyseth,2448,0,2,3,5,40.0%,2h
31271,1,THCxMatthew,2448,30,2,3,5,40.0%,27m
31271,2,CptComeback,2448,0,1,0,1,100.0%,2h
31271,1,Stock,2448,0,1,0,1,100.0%,6m
31271,3,Timoncito,2448,0,1,2,3,33.3%,2h
31271,3,[Macac0]osomaduro,2448,30,1,3,4,25.0%,2h
31271,3,ImNotTheNoob,2448,0,1,4,5,20.0%,2h
31271,3,Nacho,2448,0,0,1,1,0.0%,2h
31271,1,Harold,2448,0,0,1,1,0.0%,2h
31271,3,Zero,2448,0,0,3,3,0.0%,36m
31305,2,[BrUtO]Maxis,2447,1154,89,78,167,53.3%,26m
31305,2,thatbroc,2447,1567,80,83,163,49.1%,2h
31305,3,Dragneel,2447,1315,54,45,99,54.5%,2h
31305,3,Razmataz,2447,732,44,42,86,51.2%,2h
31305,3,rodemito,2447,524,22,18,40,55.0%,2h
31305,3,Audiofile,2447,398,19,18,37,51.4%,2h
31305,2,MeatJP,2447,435,18,22,40,45.0%,34m
31305,1,Couver,2447,438,16,22,38,42.1%,2h
31305,1,BlackSoul,2447,477,15,23,38,39.5%,42m
31305,3,Steel,2447,287,12,14,26,46.2%,1h
31305,2,Hamson,2447,286,10,13,23,43.5%,2h
31305,3,jelv,2447,146,7,2,9,77.8%,18m
31305,3,irishkid,2447,184,7,12,19,36.8%,2h
31305,2,Lunkface,2447,144,6,8,14,42.9%,1h
31305,3,peyton,2447,95,5,1,6,83.3%,2h
31305,3,LeeHarvey,2447,116,5,4,9,55.6%,2h
31305,3,TheKing,2447,148,5,6,11,45.5%,49m
31305,2,[FxB]Mudflap,2447,81,5,15,20,25.0%,44m
31305,2,sanzen,2447,0,4,4,8,50.0%,42m
31305,3,Longclaw,2447,118,4,5,9,44.4%,2h
31305,3,Leon,2447,0,2,1,3,66.7%,2h
31305,3,[FaTlAd]TerranMaster,2447,141,2,4,6,33.3%,2h
31305,1,Jeremiah,2447,48,2,4,6,33.3%,2h
31305,2,pelao,2447,0,2,4,6,33.3%,46m
31305,3,Jirobow,2447,0,2,5,7,28.6%,2h
31305,3,SansFace,2447,0,2,8,10,20.0%,32m
31305,2,[H0DORS]bkf,2447,0,1,0,1,100.0%,48m
31305,3,[WiNgSS]cwolfcfbp,2447,0,1,0,1,100.0%,19m
31305,3,[SpaceK]CORVENDALLAS,2447,30,1,2,3,33.3%,3h
31305,2,[XDRAX8]Jake,2447,34,1,8,9,11.1%,37m
31305,3,blackgendro,2447,0,0,1,1,0.0%,19m
31305,3,[CeRr]Adicts,2447,0,0,1,1,0.0%,41m
31305,3,coaliz,2447,0,0,2,2,0.0%,2h
31338,2,Andrew,2446,1552,172,160,332,51.8%,35m
31338,2,Jinxy,2446,1074,127,116,243,52.3%,2h
31338,2,COFRAN,2446,1505,76,72,148,51.4%,35m
31338,2,ZEDANLIR,2446,1471,63,61,124,50.8%,2h
31338,1,[TDX]HepatitisM,2446,842,32,34,66,48.5%,2h
31338,3,amanster,2446,562,24,24,48,50.0%,48m
31338,2,Andre,2446,394,20,17,37,54.1%,45m
31338,3,DICER,2446,338,13,11,24,54.2%,27m
31338,2,Intuitron,2446,388,12,39,51,23.5%,10m
31338,3,darksider,2446,291,11,12,23,47.8%,4m
31338,3,Telvare,2446,324,11,15,26,42.3%,30m
31338,3,MonkeyButt,2446,235,7,5,12,58.3%,2h
31338,2,goeasyonme,2446,204,7,10,17,41.2%,2h
31338,3,[nochee]Wolfe,2446,142,5,5,10,50.0%,12m
31338,1,ohyesdanny,2446,162,5,8,13,38.5%,2h
31338,3,Zephirine,2446,140,4,1,5,80.0%,18m
31338,3,alanpv,2446,162,4,4,8,50.0%,46m
31338,3,piter,2446,30,4,4,8,50.0%,35m
31338,3,Dan,2446,118,4,6,10,40.0%,19m
31338,2,[SaltyJ]NoodleMASTA,2446,58,4,6,10,40.0%,2h
31338,2,alex,2446,82,4,8,12,33.3%,46m
31338,3,SKYLEADER,2446,0,3,1,4,75.0%,4m
31338,1,jppmang,2446,0,3,2,5,60.0%,2h
31338,3,frijoles,2446,33,3,3,6,50.0%,49m
31338,1,Isaac,2446,48,2,1,3,66.7%,2h
31338,3,deyver,2446,60,2,3,5,40.0%,28m
31338,3,WeaponX,2446,0,1,0,1,100.0%,2h
31338,3,PoisonMiST,2446,30,1,2,3,33.3%,40m
31338,2,pinguchingu,2446,0,1,2,3,33.3%,1h
31338,3,NerO,2446,0,1,2,3,33.3%,27m
31338,1,neruvius,2446,0,1,4,5,20.0%,18m
31338,3,Pbhuh,2446,0,1,4,5,20.0%,2h
31338,3,skyjumper,2446,0,0,1,1,0.0%,10m
31338,3,TOFFEPANDERO,2446,0,0,2,2,0.0%,2h
31372,2,VespinKahn,2445,1554,114,113,227,50.2%,1h
31372,3,MrDoom,2445,1599,100,92,192,52.1%,2h
31372,2,NightRaven,2445,882,55,55,110,50.0%,2h
31372,3,AlredyTaken,2445,754,36,20,56,64.3%,42m
31372,3,[PL4SM4]PhaseBeam,2445,791,35,21,56,62.5%,4m
31372,2,JXM,2445,570,23,20,43,53.5%,2h
31372,2,BroCareToLax,2445,406,16,22,38,42.1%,2h
31372,3,Tichoundrius,2445,182,7,9,16,43.8%,3h
31372,2,Snorlax,2445,200,6,8,14,42.9%,2h
31372,3,miguel,2445,144,5,5,10,50.0%,4m
31372,3,amberprey,2445,196,5,6,11,45.5%,18m
31372,3,Sukanogi,2445,72,4,5,9,44.4%,2h
31372,3,AllenIverson,2445,66,4,8,12,33.3%,2h
31372,3,xxxxxxxxxxxx,2445,58,3,0,3,100.0%,41m
31372,3,[LACRAS]RATAMASTA,2445,78,3,3,6,50.0%,2h
31372,3,PewDieCent,2445,123,3,6,9,33.3%,1h
31372,3,[JeNiX]Cochecho,2445,95,2,1,3,66.7%,2h
31372,3,bjarte,2445,121,2,2,4,50.0%,39m
31372,3,[AQP4]Zambo,2445,110,2,2,4,50.0%,3m
31372,3,Wilma,2445,96,2,4,6,33.3%,1h
31372,3,CosmicCop,2445,60,2,4,6,33.3%,27m
31372,3,SparkyStar,2445,30,1,3,4,25.0%,42m
31372,1,Milotook,2445,0,1,4,5,20.0%,2h
31372,3,Sauverk,2445,0,1,4,5,20.0%,28m
31372,3,Redjac,2445,0,0,1,1,0.0%,3h
31372,3,[XHM]Vanquish,2445,0,0,1,1,0.0%,2h
31372,3,[xSSCx]bassmaster,2445,0,0,2,2,0.0%,28m
31372,3,FHmarshy,2445,0,0,2,2,0.0%,2h
31372,3,[kitty1]ShadowPigz,2445,0,0,2,2,0.0%,2h
31372,3,MARIOtaylor,2445,0,0,2,2,0.0%,35m
31402,2,WoodBaril,2444,1590,157,147,304,51.6%,2h
31402,2,Null,2444,1552,126,124,250,50.4%,20m
31402,2,vlay,2444,1586,66,68,134,49.3%,1h
31402,3,[Mc]Jupiter,2444,1328,57,52,109,52.3%,49m
31402,2,Shadowstorm,2444,1461,57,59,116,49.1%,11m
31402,3,roidontairk,2444,992,56,41,97,57.7%,35m
31402,3,PANDAyoFACE,2444,1122,44,42,86,51.2%,31m
31402,2,[PiN0YS]Xzecutive,2444,720,36,33,69,52.2%,2h
31402,3,jamaldo,2444,828,35,28,63,55.6%,3h
31402,2,Proto,2444,371,18,17,35,51.4%,2h
31402,3,Corderito,2444,402,16,15,31,51.6%,13m
31402,1,CRISFER,2444,201,15,24,39,38.5%,2h
31402,3,Robert,2444,266,12,2,14,85.7%,2h
31402,2,Mend,2444,254,12,15,27,44.4%,29m
31402,3,mythex,2444,309,11,13,24,45.8%,46m
31402,3,Judicator,2444,208,6,5,11,54.5%,2h
31402,1,Saqo,2444,181,6,10,16,37.5%,2h
31402,1,[owOOwo]Birdy,2444,220,5,5,10,50.0%,2h
31402,2,DiesIrae,2444,116,5,6,11,45.5%,2h
31402,3,NewCoat,2444,123,3,1,4,75.0%,2h
31402,2,asdf,2444,0,3,3,6,50.0%,33m
31402,1,jjijjipong,2444,141,3,4,7,42.9%,3h
31402,3,Papadzul,2444,30,3,4,7,42.9%,2h
31402,3,[Fefe]Zergantor,2444,30,3,6,9,33.3%,2h
31402,3,[ANTARS]Chemoundsky,2444,30,2,1,3,66.7%,10m
31402,3,FearMeAndDie,2444,58,2,2,4,50.0%,46m
31402,1,Hawk,2444,0,2,3,5,40.0%,25m
31402,1,OhOneThree,2444,48,2,4,6,33.3%,18m
31402,3,Draxem,2444,97,2,5,7,28.6%,6m
31402,3,Lemons,2444,96,2,6,8,25.0%,46m
31402,3,GudStuff,2444,0,1,0,1,100.0%,1h
31402,3,[BBCIT0]PanaMiguel,2444,0,1,0,1,100.0%,2h
31402,3,[KD]decclok,2444,30,1,1,2,50.0%,2h
31402,3,DrLuis,2444,0,1,1,2,50.0%,11m
31402,3,[SNICKL]WATERmouth,2444,0,1,1,2,50.0%,2h
31402,1,Perseus,2444,0,1,4,5,20.0%,2h
31402,1,ELxTIRRI,2444,0,1,4,5,20.0%,2h
31402,2,Tenamaztle,2444,30,1,6,7,14.3%,5m
31402,3,Licus,2444,0,0,1,1,0.0%,34m
31402,2,PMAMODE,2444,0,0,1,1,0.0%,2h
31442,2,vuaanmay,2443,1168,119,113,232,51.3%,2h
31442,1,Clarus,2443,686,114,124,238,47.9%,3h
31442,1,FatSuzzie,2443,1573,113,109,222,50.9%,2h
31442,3,Larrybob,2443,910,70,61,131,53.4%,3h
31442,2,Allezo,2443,376,67,66,133,50.4%,2h
31442,3,XxBlxdezxX,2443,552,43,35,78,55.1%,3h
31442,3,CoyaBot,2443,959,40,28,68,58.8%,4m
31442,2,marceloco,2443,763,32,24,56,57.1%,2h
31442,2,alexspach,2443,632,22,27,49,44.9%,22m
31442,2,YogaFire,2443,391,20,21,41,48.8%,44m
31442,3,Tyrops,2443,473,18,18,36,50.0%,1h
31442,3,Sean,2443,466,16,15,31,51.6%,19m
31442,3,VirtyDagina,2443,258,9,10,19,47.4%,28m
31442,3,Albee,2443,229,8,8,16,50.0%,2h
31442,1,Clonemaster,2443,179,8,10,18,44.4%,48m
31442,2,feren,2443,205,7,11,18,38.9%,46m
31442,3,FINISTERRA,2443,60,3,1,4,75.0%,19m
31442,3,whiteasian,2443,0,3,2,5,60.0%,3h
31442,3,DentedArmor,2443,36,3,6,9,33.3%,11m
31442,3,Max,2443,120,2,1,3,66.7%,2h
31442,3,grink,2443,36,2,1,3,66.7%,4m
31442,3,[Petz]PiewPiewBoom,2443,60,2,5,7,28.6%,48m
31442,3,Kruel,2443,30,1,1,2,50.0%,2h
31442,1,Frithogar,2443,0,1,4,5,20.0%,2h
31442,3,[Shout]DWolves,2443,0,0,1,1,0.0%,2h
31442,3,Oldtown,2443,0,0,1,1,0.0%,2h
31442,3,Thrawn,2443,0,0,1,1,0.0%,2h
31442,3,Teem,2443,0,0,3,3,0.0%,24m
31470,1,YSAC,2442,1581,111,101,212,52.4%,3m
31470,3,[D4Bros]SynCere,2442,1220,49,50,99,49.5%,4m
31470,3,[INextI]OmegaNaga,2442,255,36,33,69,52.2%,2h
31470,3,Iceman,2442,727,34,43,77,44.2%,27m
31470,3,ReJoyce,2442,738,28,24,52,53.8%,2h
31470,2,LynchGuilt,2442,593,22,27,49,44.9%,2h
31470,3,[Batmam]Felipe,2442,525,20,17,37,54.1%,27m
31470,2,ArcadiumRice,2442,390,18,18,36,50.0%,2h
31470,3,DrVindaloo,2442,246,14,13,27,51.9%,2h
31470,3,Bladez,2442,282,10,4,14,71.4%,2h
31470,1,ShaKaZu,2442,322,10,14,24,41.7%,2h
31470,3,Majero,2442,57,5,4,9,55.6%,2h
31470,3,DOTAFOREVER,2442,61,5,4,9,55.6%,16m
31470,2,MrDarcy,2442,201,5,9,14,35.7%,2h
31470,3,[VIRGII]Zod,2442,125,4,4,8,50.0%,2h
31470,2,Fireworks,2442,114,3,3,6,50.0%,2h
31470,2,[lvg]LeSeparatist,2442,129,3,6,9,33.3%,43m
31470,3,Titan,2442,32,3,6,9,33.3%,15m
31470,3,CrimsonChin,2442,0,2,3,5,40.0%,2h
31470,3,[GINO]joshasaurus,2442,0,2,3,5,40.0%,50m
31470,3,ProperTalent,2442,58,2,4,6,33.3%,2h
31470,3,voidwalker,2442,95,2,4,6,33.3%,2h
31470,3,Vegitachu,2442,0,2,4,6,33.3%,6m
31470,2,CherFalcon,2442,0,1,0,1,100.0%,2h
31470,1,Mobley,2442,0,1,0,1,100.0%,26m
31470,3,BattleDruxs,2442,0,0,1,1,0.0%,2h
31470,3,Wimwardius,2442,0,0,1,1,0.0%,2h
31470,3,Diego,2442,0,0,2,2,0.0%,2h
31470,3,GriPs,2442,0,0,2,2,0.0%,4m
31470,2,Blaster,2442,0,0,3,3,0.0%,2h
31500,3,[Zno]Jammer,2441,1580,114,102,216,52.8%,8m
31500,3,Gatsu,2441,1442,71,66,137,51.8%,27m
31500,3,wherswallace,2441,1420,67,50,117,57.3%,10m
31500,2,Slime,2441,761,60,50,110,54.5%,32m
31500,2,RWSoul,2441,1010,52,42,94,55.3%,44m
31500,2,TaLoN,2441,703,51,59,110,46.4%,2h
31500,3,Nelson,2441,666,26,21,47,55.3%,48m
31500,1,Atrain,2441,782,26,34,60,43.3%,2h
31500,2,SqirlMaster,2441,524,24,21,45,53.3%,2h
31500,3,Calcifer,2441,520,21,19,40,52.5%,30m
31500,2,ArycrackYT,2441,470,19,19,38,50.0%,2h
31500,2,[Boba07]Jephph,2441,490,19,21,40,47.5%,33m
31500,3,TerranKilla,2441,186,14,17,31,45.2%,49m
31500,2,Heisenberg,2441,357,13,18,31,41.9%,37m
31500,2,Naysayer,2441,239,8,10,18,44.4%,1h
31500,2,Sejun,2441,211,7,5,12,58.3%,37m
31500,3,MasterLuke,2441,159,4,3,7,57.1%,2h
31500,3,[MyT]Blatherinon,2441,142,3,2,5,60.0%,35m
31500,1,[xGGTx]llllllllllll,2441,0,3,2,5,60.0%,2h
31500,2,Lunar,2441,148,3,2,5,60.0%,1h
31500,3,[KingSC]tonox,2441,90,3,5,8,37.5%,14m
31500,3,[LOHd]Bella,2441,145,3,7,10,30.0%,3h
31500,3,NovaTitan,2441,30,2,3,5,40.0%,2h
31500,3,Minibboy,2441,118,2,5,7,28.6%,36m
31500,3,Michh,2441,0,1,0,1,100.0%,50m
31500,1,BUSSINhedz,2441,0,1,0,1,100.0%,2h
31500,3,[macsad]chaosscdoor,2441,30,1,1,2,50.0%,31m
31500,3,AmerikaBaKa,2441,30,1,4,5,20.0%,18m
31500,3,fingerlegs,2441,0,1,4,5,20.0%,3h
31500,1,cloiszav,2441,0,1,4,5,20.0%,18m
31500,1,Assjooc,2441,0,0,1,1,0.0%,2h
31500,3,cbSugar,2441,0,0,2,2,0.0%,2h
31532,1,UNOCHEESE,2440,1622,472,472,944,50.0%,2h
31532,2,NullSet,2440,1324,156,139,295,52.9%,17m
31532,2,Mukk,2440,905,81,69,150,54.0%,8m
31532,3,elvenegas,2440,1021,62,71,133,46.6%,33m
31532,3,jean,2440,1228,51,42,93,54.8%,2h
31532,2,newchienbinh,2440,497,44,27,71,62.0%,2h
31532,3,Dizzyfalcon,2440,850,32,28,60,53.3%,50m
31532,2,[Ohboy]Huzaifa,2440,798,28,36,64,43.8%,2h
31532,2,EscherichiaC,2440,294,27,19,46,58.7%,45m
31532,2,[TOYOTA]CelicaPower,2440,587,26,22,48,54.2%,2h
31532,2,[KUKLX]destroyer,2440,690,23,26,49,46.9%,1h
31532,3,Trinity,2440,372,17,1,18,94.4%,18m
31532,2,TheRGBGuy,2440,388,17,15,32,53.1%,2h
31532,2,[CHAKA]BloodpooL,2440,331,16,12,28,57.1%,16m
31532,3,Ransenryu,2440,414,16,19,35,45.7%,13m
31532,3,zuke,2440,192,11,6,17,64.7%,2h
31532,2,robbyP,2440,273,11,12,23,47.8%,2h
31532,2,kim,2440,309,10,10,20,50.0%,2h
31532,3,Mandrake,2440,214,6,3,9,66.7%,2h
31532,2,radman,2440,134,4,4,8,50.0%,26m
31532,2,thelastsith,2440,60,4,7,11,36.4%,2h
31532,1,Rorrihim,2440,116,3,3,6,50.0%,1h
31532,3,[xbLaSt]Takucharael,2440,116,3,5,8,37.5%,49m
31532,1,MrDisruptor,2440,30,3,7,10,30.0%,2h
31532,2,eriicko,2440,0,2,4,6,33.3%,2h
31532,3,[SCIIpy]TerranPy,2440,0,1,0,1,100.0%,2h
31532,1,[PROMX]XxAaronSsjxX,2440,0,1,1,2,50.0%,1h
31532,3,[RwtM]Blaze,2440,30,1,1,2,50.0%,4m
31532,3,ALSdjkas,2440,0,1,4,5,20.0%,2h
31532,1,Tonn,2440,0,1,4,5,20.0%,14m
31532,3,[SxyMxN]iPalafoxC,2440,0,0,2,2,0.0%,13m
31563,2,UNDERLAY,2439,973,59,46,105,56.2%,19m
31563,2,[WCSOil]OctopusMan,2439,520,40,34,74,54.1%,50m
31563,2,TheLostSoul,2439,788,32,31,63,50.8%,5m
31563,3,lilwolf,2439,749,28,26,54,51.9%,2h
31563,3,Stemm,2439,590,26,21,47,55.3%,2h
31563,2,RedRaven,2439,639,21,31,52,40.4%,14m
31563,2,Bakuro,2439,338,16,18,34,47.1%,4m
31563,1,Giga,2439,435,16,21,37,43.2%,23m
31563,2,[Trance]Domadie,2439,354,14,17,31,45.2%,22m
31563,3,Pederneras,2439,286,10,17,27,37.0%,1h
31563,2,Spastik,2439,274,7,8,15,46.7%,42m
31563,3,ShadowMe,2439,197,7,8,15,46.7%,28m
31563,3,kvang,2439,169,6,7,13,46.2%,35m
31563,1,[PRX]Pavlov,2439,153,6,8,14,42.9%,2h
31563,3,Thor,2439,62,5,8,13,38.5%,42m
31563,3,[CHUNK]reddotsniper,2439,58,3,1,4,75.0%,2h
31563,3,vvtrcc,2439,60,3,4,7,42.9%,30m
31563,3,RowdyOpossum,2439,100,3,4,7,42.9%,31m
31563,3,Maximus,2439,34,3,5,8,37.5%,2h
31563,3,Darakay,2439,135,3,6,9,33.3%,37m
31563,1,Elflako,2439,46,3,7,10,30.0%,2h
31563,3,warfare,2439,97,2,3,5,40.0%,2h
31563,1,Bropoe,2439,0,2,4,6,33.3%,2h
31563,2,kingmare,2439,0,2,6,8,25.0%,2h
31563,3,ClearMonocle,2439,0,1,0,1,100.0%,36m
31563,3,Lezter,2439,0,1,1,2,50.0%,2h
31563,3,OrcBolg,2439,30,1,2,3,33.3%,29m
31563,3,FraNki,2439,30,1,2,3,33.3%,2h
31563,2,Cacao,2439,88,1,5,6,16.7%,47m
31563,3,Thesseus,2439,0,0,1,1,0.0%,2h
31563,3,daisy,2439,0,0,1,1,0.0%,2h
31563,3,StarryNeko,2439,0,0,1,1,0.0%,1h
31595,2,Ronin,2438,1434,277,259,536,51.7%,14m
31595,1,Scharfff,2438,1579,174,159,333,52.3%,2h
31595,3,Kulzokid,2438,1337,156,138,294,53.1%,40m
31595,3,Logum,2438,1515,77,64,141,54.6%,28m
31595,1,vasdeferens,2438,586,54,65,119,45.4%,20m
31595,1,[YEGG]Kasnio,2438,346,14,15,29,48.3%,2h
31595,2,[RUSHya]RayCharles,2438,297,12,14,26,46.2%,2h
31595,2,juampi,2438,260,11,9,20,55.0%,2h
31595,2,Skyywalkerr,2438,229,8,5,13,61.5%,33m
31595,3,Stryker,2438,262,8,9,17,47.1%,2h
31595,2,DirtbikerEX,2438,162,5,7,12,41.7%,18m
31595,3,Charbaken,2438,172,5,8,13,38.5%,2h
31595,3,birdman,2438,68,3,3,6,50.0%,46m
31595,3,XxelpapixX,2438,100,3,7,10,30.0%,39m
31595,3,SnipeRouse,2438,58,2,4,6,33.3%,2h
31595,3,NACHOB,2438,0,1,0,1,100.0%,39m
31595,3,RockstarBaby,2438,30,1,2,3,33.3%,2h
31595,3,elkum,2438,30,1,3,4,25.0%,29m
31595,3,[MutasT]Zodak,2438,0,1,4,5,20.0%,12m
31595,3,[TmGt]Aníbal,2438,0,1,4,5,20.0%,41m
31595,3,[STE]ThisIsTravis,2438,0,1,4,5,20.0%,28m
31595,3,Ali,2438,0,1,4,5,20.0%,8m
31595,3,corruption,2438,0,1,4,5,20.0%,2h
31595,2,IIIIIIIIIIII,2438,36,1,7,8,12.5%,2h
31595,3,LeSaux,2438,0,0,1,1,0.0%,2h
31595,3,Silverblade,2438,0,0,2,2,0.0%,38m
31621,2,NoMirrorGame,2437,678,130,129,259,50.2%,2h
31621,2,Ryuzakill,2437,1018,90,80,170,52.9%,29m
31621,3,[NSMR]acdcrulz,2437,1409,89,105,194,45.9%,25m
31621,2,sofacking,2437,1341,77,74,151,51.0%,1h
31621,3,MAI,2437,999,69,52,121,57.0%,2h
31621,3,SamuraiFunn,2437,1408,58,53,111,52.3%,40m
31621,2,DingleBarry,2437,1439,54,63,117,46.2%,2h
31621,3,MilkAndMoney,2437,1183,48,50,98,49.0%,28m
31621,2,niko,2437,910,33,37,70,47.1%,2h
31621,3,Risen,2437,482,22,10,32,68.8%,50m
31621,2,genghiscat,2437,551,22,28,50,44.0%,35m
31621,3,PizzaZubuzo,2437,549,19,16,35,54.3%,29m
31621,3,[PTHero]oSeabass,2437,342,18,13,31,58.1%,43m
31621,3,YeahItsPanda,2437,470,17,14,31,54.8%,2h
31621,1,Keijo,2437,200,9,7,16,56.2%,2h
31621,2,Rizbits,2437,210,7,6,13,53.8%,2h
31621,1,Quasar,2437,221,6,8,14,42.9%,2h
31621,3,[FyHr]PepeELPollo,2437,187,5,2,7,71.4%,13m
31621,2,Oromë,2437,102,5,4,9,55.6%,35m
31621,3,marcosbru,2437,142,5,10,15,33.3%,25m
31621,1,sourfang,2437,0,4,1,5,80.0%,2h
31621,3,RJrulesSF,2437,107,4,4,8,50.0%,2h
31621,2,ExinJealousy,2437,136,4,7,11,36.4%,18m
31621,3,norrisbeer,2437,60,3,1,4,75.0%,16m
31621,1,[KMages]Hachi,2437,92,3,3,6,50.0%,48m
31621,3,[ALTF04]cris,2437,0,1,0,1,100.0%,14m
31621,2,KrazyTedd,2437,88,1,1,2,50.0%,36m
31621,3,SkrtSkrtEd,2437,30,1,1,2,50.0%,29m
31621,2,[IKs]vaudomingos,2437,38,1,6,7,14.3%,32m
31621,3,Zeratul,2437,0,0,1,1,0.0%,19m
31621,1,[dCL]Ravage,2437,0,0,5,5,0.0%,21m
31652,2,TrueLotus,2436,1306,105,103,208,50.5%,33m
31652,3,Guti,2436,1030,41,40,81,50.6%,25m
31652,3,Sicario,2436,391,27,14,41,65.9%,39m
31652,3,[LONSTR]veboswa,2436,628,26,17,43,60.5%,46m
31652,3,DIegoS,2436,536,23,23,46,50.0%,2h
31652,3,ShdowNight,2436,520,20,19,39,51.3%,2h
31652,1,PandaKudux,2436,442,16,18,34,47.1%,2h
31652,2,[RSBR]NEFILIM,2436,398,13,21,34,38.2%,2h
31652,2,Brasides,2436,324,12,18,30,40.0%,33m
31652,3,Ninjaadrian,2436,222,8,4,12,66.7%,21m
31652,2,Sada,2436,204,7,3,10,70.0%,45m
31652,2,[Falme]Warrior,2436,195,7,10,17,41.2%,5m
31652,3,barcode,2436,62,5,9,14,35.7%,14m
31652,2,[TxC1]Vacon,2436,166,5,13,18,27.8%,2h
31652,1,nino,2436,88,4,4,8,50.0%,2h
31652,3,PoseidonRage,2436,118,4,5,9,44.4%,2h
31652,2,TheLastWord,2436,30,3,6,9,33.3%,2h
31652,3,Arcane,2436,58,2,2,4,50.0%,3h
31652,3,Aomy,2436,0,2,5,7,28.6%,35m
31652,3,Ambrosia,2436,0,1,0,1,100.0%,2h
31652,3,John,2436,97,1,2,3,33.3%,26m
31652,1,dinobooot,2436,0,1,2,3,33.3%,27m
31652,3,dragonOG,2436,0,1,3,4,25.0%,45m
31652,1,DatBombKush,2436,0,1,4,5,20.0%,32m
31652,1,DNGR,2436,0,1,4,5,20.0%,2h
31652,2,DRACO,2436,32,1,5,6,16.7%,17m
31652,3,Hotdog,2436,0,0,1,1,0.0%,3h
31652,2,Myself,2436,0,0,2,2,0.0%,2h
31680,3,eigenvec,2435,1591,72,71,143,50.3%,2h
31680,1,ggcring,2435,1013,38,50,88,43.2%,43m
31680,1,Semi,2435,840,34,32,66,51.5%,2h
31680,3,Kayzerg,2435,703,32,22,54,59.3%,2h
31680,2,CAZPER,2435,730,27,26,53,50.9%,2h
31680,2,BOAZ,2435,488,19,21,40,47.5%,2h
31680,3,GnarCraft,2435,405,16,19,35,45.7%,49m
31680,2,Adequatesass,2435,283,12,11,23,52.2%,6m
31680,3,Yedrimos,2435,296,12,16,28,42.9%,19m
31680,3,HighLordKhay,2435,310,11,11,22,50.0%,2h
31680,2,[TCook]SnipeYourAss,2435,328,10,20,30,33.3%,2h
31680,3,[CFHfh]mvanucci,2435,282,9,6,15,60.0%,1h
31680,1,IIIIIIIIIIII,2435,143,5,10,15,33.3%,13m
31680,3,Nukeapple,2435,145,4,6,10,40.0%,35m
31680,3,joakc,2435,171,4,7,11,36.4%,2h
31680,3,Gnkku,2435,104,4,7,11,36.4%,18m
31680,1,ExoDuz,2435,0,3,1,4,75.0%,2h
31680,2,XxDMCDxX,2435,0,3,3,6,50.0%,2h
31680,3,Leeshinobi,2435,90,3,4,7,42.9%,29m
31680,1,DontStop,2435,48,3,5,8,37.5%,2h
31680,2,yumedoko,2435,0,2,4,6,33.3%,32m
31680,3,[Aiur17]Spike,2435,0,1,1,2,50.0%,2h
31680,3,legacy,2435,97,1,1,2,50.0%,12m
31680,1,[PiN0YS]Grey,2435,0,1,4,5,20.0%,38m
31680,3,QueDog,2435,0,0,1,1,0.0%,14m
31680,2,martin,2435,0,0,1,1,0.0%,2h
31680,3,MaikolTKG,2435,0,0,1,1,0.0%,2h
31680,3,hungryboi,2435,0,0,2,2,0.0%,29m
31680,3,Karachtor,2435,0,0,2,2,0.0%,46m
31680,3,solremedy,2435,0,0,3,3,0.0%,2h
31710,3,MFGATRUMP,2434,1553,97,90,187,51.9%,2h
31710,2,areesu,2434,1312,92,87,179,51.4%,19m
31710,2,Rolooo,2434,1064,85,67,152,55.9%,6m
31710,3,Minime,2434,1191,61,55,116,52.6%,2h
31710,2,baleeet,2434,603,24,22,46,52.2%,2h
31710,2,FlyingCircus,2434,434,22,29,51,43.1%,2h
31710,3,[wheres]vvaldo,2434,579,21,19,40,52.5%,49m
31710,2,Christoph,2434,610,21,28,49,42.9%,22m
31710,2,[Macac0]MoisesOtaku,2434,493,20,18,38,52.6%,2h
31710,2,Boehmi,2434,211,16,16,32,50.0%,2h
31710,3,mGaHypocrite,2434,264,10,5,15,66.7%,2h
31710,3,AFA,2434,251,10,9,19,52.6%,31m
31710,3,ZombieCG,2434,260,8,11,19,42.1%,51m
31710,3,[xLOUDx]KillaRich,2434,189,6,2,8,75.0%,2h
31710,3,BrandonUMG,2434,204,6,9,15,40.0%,5m
31710,1,Gggggggggggg,2434,180,6,13,19,31.6%,32m
31710,3,Arya,2434,146,5,5,10,50.0%,3h
31710,3,[BSauce]Tsuki,2434,122,5,5,10,50.0%,6m
31710,2,Nazgoth,2434,60,4,7,11,36.4%,21m
31710,3,SodaPop,2434,70,4,7,11,36.4%,2h
31710,3,riben,2434,142,3,2,5,60.0%,3h
31710,3,[KOPPN]RollinPaper,2434,128,3,5,8,37.5%,2h
31710,3,Malorn,2434,30,2,0,2,100.0%,2h
31710,3,DarkWolf,2434,96,2,0,2,100.0%,2h
31710,2,Joputa,2434,109,2,2,4,50.0%,2h
31710,1,IgorCravinch,2434,48,2,5,7,28.6%,3h
31710,3,Shadow,2434,0,1,0,1,100.0%,2h
31710,3,IIIIIIIIIIII,2434,0,1,0,1,100.0%,2h
31710,3,Jackboy,2434,0,1,1,2,50.0%,28m
31710,3,Beeky,2434,0,1,4,5,20.0%,2h
31710,2,[LOTV7]ALEXLCX,2434,46,1,4,5,20.0%,2h
31710,3,MrThirtyAPM,2434,0,0,1,1,0.0%,1h
31710,3,Genii,2434,0,0,1,1,0.0%,28m
31710,3,Iwantbapo,2434,0,0,1,1,0.0%,43m
31710,3,KenJi,2434,0,0,2,2,0.0%,2h
31710,3,SpartanGuy,2434,0,0,3,3,0.0%,2h
31710,3,Paralax,2434,0,0,3,3,0.0%,39m
31710,3,ELTERRAN,2434,0,0,3,3,0.0%,2h
31710,2,fasito,2434,0,0,4,4,0.0%,33m
31749,2,QDandE,2433,1245,103,97,200,51.5%,2h
31749,3,NickSwisk,2433,760,52,43,95,54.7%,1h
31749,3,Underscore,2433,1458,52,62,114,45.6%,30m
31749,3,freshfroot,2433,741,29,29,58,50.0%,2h
31749,1,[xVx]jaldir,2433,590,20,27,47,42.6%,1h
31749,3,eagle,2433,471,18,16,34,52.9%,46m
31749,2,DHester,2433,247,18,19,37,48.6%,22m
31749,3,tetelestai,2433,296,11,11,22,50.0%,36m
31749,1,Artruder,2433,256,10,14,24,41.7%,1h
31749,2,[Capkin]Dicius,2433,188,9,17,26,34.6%,36m
31749,2,[XpKAc]BJÓ,2433,210,8,12,20,40.0%,1h
31749,3,ilios,2433,210,6,4,10,60.0%,2h
31749,3,[IRnewb]VladditZ,2433,170,6,7,13,46.2%,28m
31749,2,geku,2433,222,6,7,13,46.2%,34m
31749,3,xxVidalxx,2433,159,5,2,7,71.4%,2h
31749,3,ProtoTipo,2433,120,5,7,12,41.7%,48m
31749,3,Arkont,2433,131,5,8,13,38.5%,37m
31749,3,Mat,2433,145,3,3,6,50.0%,12m
31749,3,Steve,2433,90,3,5,8,37.5%,46m
31749,3,Isilmo,2433,94,3,5,8,37.5%,8m
31749,3,astralwraith,2433,137,3,6,9,33.3%,1h
31749,2,DxRxIxZxY,2433,138,3,8,11,27.3%,1h
31749,3,xxuuxxooo,2433,30,2,0,2,100.0%,41m
31749,3,Rance,2433,30,2,2,4,50.0%,40m
31749,3,cyb,2433,60,2,3,5,40.0%,2h
31749,1,StickFigure,2433,46,2,5,7,28.6%,2h
31749,3,Vormav,2433,0,1,1,2,50.0%,32m
31749,3,zuka,2433,0,0,1,1,0.0%,3h
31749,3,[QRDZ]Cyrup,2433,0,0,1,1,0.0%,30m
31749,3,Thewolf,2433,0,0,3,3,0.0%,2h
31779,1,[EZkill]pengsoo,2432,1597,117,118,235,49.8%,2h
31779,2,MAJCHRISTIAN,2432,1591,90,89,179,50.3%,6m
31779,2,batlecruser,2432,1241,49,45,94,52.1%,17m
31779,1,Calixto,2432,961,41,44,85,48.2%,35m
31779,2,WilFromEarth,2432,413,25,29,54,46.3%,4m
31779,3,MichaelJordn,2432,375,19,12,31,61.3%,2h
31779,3,Biggsly,2432,321,15,9,24,62.5%,18m
31779,2,Jroosta,2432,456,15,23,38,39.5%,2h
31779,3,Royaltomato,2432,360,12,9,21,57.1%,2h
31779,3,Blutarsky,2432,283,11,14,25,44.0%,29m
31779,3,Jealousbean,2432,321,11,14,25,44.0%,40m
31779,2,Rimctto,2432,231,11,18,29,37.9%,16m
31779,3,Brotoss,2432,278,9,6,15,60.0%,12m
31779,3,LooP,2432,216,8,7,15,53.3%,29m
31779,3,RPepez,2432,212,8,10,18,44.4%,2h
31779,2,Tachometer,2432,214,7,10,17,41.2%,45m
31779,1,Kraytin,2432,192,6,5,11,54.5%,2h
31779,3,[Dolor]JAVIEROK,2432,110,5,6,11,45.5%,2h
31779,3,Legendary,2432,94,5,8,13,38.5%,2h
31779,3,Lazerbang,2432,95,4,2,6,66.7%,35m
31779,3,[MNDA]Fenix,2432,116,4,4,8,50.0%,3h
31779,3,Billman,2432,88,4,5,9,44.4%,2h
31779,3,Iso,2432,128,3,1,4,75.0%,1h
31779,1,Erick,2432,0,3,2,5,60.0%,41m
31779,3,Anolo,2432,0,3,4,7,42.9%,37m
31779,1,mfinstarboy,2432,30,3,6,9,33.3%,1h
31779,3,[NooU]blink,2432,30,2,0,2,100.0%,39m
31779,3,volker,2432,30,2,1,3,66.7%,43m
31779,3,Archiwarior,2432,0,2,4,6,33.3%,2h
31779,3,[EPCK]gabgus,2432,40,2,6,8,25.0%,39m
31779,3,MinscBoo,2432,0,2,7,9,22.2%,26m
31779,3,MachineOsaur,2432,30,1,2,3,33.3%,2h
31779,3,[SyLx]Hornext,2432,0,1,2,3,33.3%,3h
31779,3,RagnarokSoul,2432,30,1,3,4,25.0%,25m
31779,3,TheZapper,2432,0,1,4,5,20.0%,2h
31779,2,TooDownMan,2432,0,0,1,1,0.0%,46m
31779,3,zougoulou,2432,0,0,1,1,0.0%,36m
31816,3,[diaman]Tkerma,2431,1577,98,93,191,51.3%,35m
31816,1,Haxula,2431,1641,96,106,202,47.5%,2h
31816,3,Dimlinear,2431,1262,66,60,126,52.4%,49m
31816,3,[FAQWAY]Way,2431,692,48,45,93,51.6%,29m
31816,1,fdsfsfs,2431,185,27,24,51,52.9%,39m
31816,3,[LUNKER]KDeagle,2431,570,23,18,41,56.1%,2h
31816,3,HotShotBen,2431,528,19,23,42,45.2%,35m
31816,3,santi,2431,430,16,10,26,61.5%,2h
31816,1,Sakku,2431,283,14,10,24,58.3%,1h
31816,3,SluffyG,2431,353,13,7,20,65.0%,2h
31816,3,Whishterak,2431,264,12,11,23,52.2%,34m
31816,2,Execution,2431,92,11,14,25,44.0%,4m
31816,1,lotus,2431,165,11,24,35,31.4%,27m
31816,3,AiorosSG,2431,266,9,4,13,69.2%,2h
31816,2,Lolz,2431,210,8,10,18,44.4%,2h
31816,3,secrets,2431,198,6,2,8,75.0%,2h
31816,3,Tsubasa,2431,207,6,8,14,42.9%,2h
31816,1,rankiwh,2431,171,6,11,17,35.3%,2h
31816,3,tedyelcrak,2431,164,5,3,8,62.5%,51m
31816,3,stickineye,2431,138,5,5,10,50.0%,31m
31816,3,tugfa,2431,56,4,5,9,44.4%,2h
31816,2,nadonia,2431,122,4,10,14,28.6%,2h
31816,3,[ADDU]VanHoenheim,2431,117,3,4,7,42.9%,2h
31816,2,Jethro,2431,112,3,7,10,30.0%,2h
31816,2,Ivellios,2431,84,2,5,7,28.6%,2h
31816,3,Forsaken,2431,97,2,5,7,28.6%,2h
31816,3,Bizcuit,2431,97,2,6,8,25.0%,2h
31816,3,[SUDAKA]SrInmortal,2431,0,1,0,1,100.0%,2h
31816,3,[kokisa]DaddyDuong,2431,0,1,0,1,100.0%,27m
31816,3,XXyoshiXX,2431,0,1,1,2,50.0%,49m
31816,3,haylander,2431,0,1,1,2,50.0%,25m
31816,3,naygiggas,2431,0,1,1,2,50.0%,2h
31816,3,Cajual,2431,0,1,1,2,50.0%,34m
31816,3,Adiepd,2431,0,1,2,3,33.3%,25m
31816,3,[BoRnGo]Rikki,2431,30,1,4,5,20.0%,2h
31816,3,ftJinJow,2431,0,1,4,5,20.0%,46m
31816,1,Light,2431,0,1,4,5,20.0%,41m
31816,1,Hankthetank,2431,0,1,4,5,20.0%,48m
31816,1,zarrya,2431,0,1,4,5,20.0%,2h
31816,3,Attilkan,2431,0,0,1,1,0.0%,14m
31816,3,Osmel,2431,0,0,1,1,0.0%,40m
31816,3,Hammurabi,2431,0,0,2,2,0.0%,2h
31816,3,alvaro,2431,0,0,2,2,0.0%,2h
31816,3,StarDrake,2431,0,0,2,2,0.0%,35m
31816,2,DonkeyRunner,2431,0,0,4,4,0.0%,2h
31861,1,OSOLI,2430,1592,222,219,441,50.3%,1h
31861,1,SageCharlie,2430,1254,119,123,242,49.2%,2h
31861,2,Biscuit,2430,719,72,75,147,49.0%,20m
31861,2,[CrnKy]pseudocoder,2430,969,72,83,155,46.5%,5m
31861,3,TheGhostOne,2430,259,10,9,19,52.6%,2h
31861,3,Shanks,2430,268,10,10,20,50.0%,2h
31861,3,Xeitch,2430,212,6,4,10,60.0%,18m
31861,3,Professor,2430,86,4,4,8,50.0%,2h
31861,3,Zeus,2430,34,4,5,9,44.4%,2h
31861,3,[KABN]MorbidSemen,2430,60,3,1,4,75.0%,28m
31861,3,Dunnyslice,2430,40,3,2,5,60.0%,19m
31861,1,Norik,2430,0,3,3,6,50.0%,8m
31861,3,[GGMB]Fritigern,2430,30,2,0,2,100.0%,2h
31861,3,[ImbTos]DontRushMe,2430,30,2,1,3,66.7%,35m
31861,1,Razgriz,2430,48,2,2,4,50.0%,22m
31861,3,biuwdel,2430,30,2,4,6,33.3%,51m
31861,3,Haz,2430,62,2,5,7,28.6%,1h
31861,2,tokus,2430,0,2,5,7,28.6%,6m
31861,1,[IMTY]YuNaul,2430,94,2,7,9,22.2%,37m
31861,3,spida,2430,0,1,0,1,100.0%,40m
31861,1,Czarchasm,2430,0,1,4,5,20.0%,2h
31861,3,[INF3ST]justin,2430,0,0,1,1,0.0%,2h
31861,2,[DETER]Bluestar,2430,0,0,1,1,0.0%,2h
31861,3,theChicken,2430,0,0,1,1,0.0%,12m
31861,3,[STHL]stonts,2430,0,0,1,1,0.0%,2h
31861,3,GrasDBacon,2430,0,0,2,2,0.0%,1h
31861,3,Firzen,2430,0,0,4,4,0.0%,1h
31861,3,Blaze,2430,0,0,4,4,0.0%,2h
31889,1,Nedak,2429,1591,100,102,202,49.5%,3h
31889,2,Cliver,2429,1526,73,73,146,50.0%,2h
31889,3,DarkLordMatt,2429,985,60,39,99,60.6%,2h
31889,3,[pl4boy]goldielocks,2429,478,19,25,44,43.2%,28m
31889,3,[ALTF04]Geo,2429,340,14,11,25,56.0%,3h
31889,3,MumenRider,2429,370,13,14,27,48.1%,2h
31889,3,[ELLOCO]Mayota,2429,328,11,9,20,55.0%,34m
31889,3,TDS,2429,216,8,2,10,80.0%,50m
31889,3,Parity,2429,187,8,6,14,57.1%,1h
31889,3,jwbrain,2429,155,7,3,10,70.0%,2h
31889,2,Narzako,2429,177,7,14,21,33.3%,21m
31889,1,Zile,2429,256,7,22,29,24.1%,17m
31889,2,[alahua]Miguel,2429,116,5,8,13,38.5%,2h
31889,3,[LimaSC]LorKaos,2429,141,4,0,4,100.0%,39m
31889,3,ProbeRush,2429,142,4,1,5,80.0%,13m
31889,3,Pueriko,2429,47,4,7,11,36.4%,49m
31889,3,lightsleeper,2429,58,3,1,4,75.0%,35m
31889,1,[LFMR]Slinky,2429,113,3,2,5,60.0%,2h
31889,1,[NM8]ACE,2429,97,3,3,6,50.0%,2h
31889,3,mommymilkers,2429,96,2,0,2,100.0%,1h
31889,3,memame,2429,121,2,2,4,50.0%,1h
31889,3,[FTTD]Damson,2429,0,2,2,4,50.0%,1h
31889,3,Doge,2429,0,2,3,5,40.0%,1h
31889,3,jebsen,2429,0,2,3,5,40.0%,18m
31889,3,Proboss,2429,0,1,0,1,100.0%,2h
31889,3,yarashkirk,2429,0,1,0,1,100.0%,18m
31889,3,Stout,2429,0,1,0,1,100.0%,28m
31889,3,AeoMaxiamus,2429,0,0,1,1,0.0%,14m
31889,3,Tucanius,2429,0,0,1,1,0.0%,11m
31889,3,Asimov,2429,0,0,1,1,0.0%,46m
31919,3,[dobo]Diezel,2428,1582,74,49,123,60.2%,11m
31919,2,Shanly,2428,795,51,57,108,47.2%,2h
31919,2,Tylenita,2428,775,33,27,60,55.0%,31m
31919,3,[DgDzNt]pingpongchap,2428,782,30,26,56,53.6%,1h
31919,3,Kamus,2428,672,28,18,46,60.9%,2h
31919,2,Shakyamuni,2428,634,26,23,49,53.1%,3h
31919,3,[oRuRo]elboliviano,2428,522,21,11,32,65.6%,2h
31919,3,[FFAA]CHIKIMASTER,2428,380,16,6,22,72.7%,3h
31919,3,yeetermeiste,2428,272,12,18,30,40.0%,6m
31919,3,Josu,2428,256,10,11,21,47.6%,2h
31919,3,Geminus,2428,244,9,9,18,50.0%,1h
31919,3,Luda,2428,223,7,1,8,87.5%,50m
31919,2,[LForce]RaphaPhilipe,2428,240,7,11,18,38.9%,35m
31919,3,Locky,2428,197,6,8,14,42.9%,1h
31919,2,Halion,2428,46,5,5,10,50.0%,2h
31919,1,[xXGDXx]Godoy,2428,0,4,1,5,80.0%,2h
31919,3,Nando,2428,30,4,3,7,57.1%,3h
31919,1,LTCage,2428,111,3,0,3,100.0%,2h
31919,3,PhamNuwen,2428,0,3,2,5,60.0%,18m
31919,3,alex,2428,148,3,3,6,50.0%,50m
31919,3,ScumbagSteve,2428,96,3,3,6,50.0%,2h
31919,3,[USWAG]Tenkinoko,2428,147,3,5,8,37.5%,2h
31919,3,[Justis]etrain,2428,30,1,1,2,50.0%,50m
31919,3,jairomistic,2428,30,1,3,4,25.0%,28m
31919,3,[cluez]crashx,2428,0,1,4,5,20.0%,2h
31919,3,FLu,2428,0,1,4,5,20.0%,2h
31919,3,Amon,2428,0,0,1,1,0.0%,1h
31919,3,Rome,2428,0,0,1,1,0.0%,46m
31919,1,Ezerner,2428,0,0,2,2,0.0%,2h
31919,3,KELLERdos,2428,0,0,3,3,0.0%,34m
31949,2,Surfiesmurf,2427,1432,180,181,361,49.9%,47m
31949,3,DiabolikMX,2427,1582,73,66,139,52.5%,1h
31949,3,PlayDeD,2427,999,44,38,82,53.7%,2h
31949,2,[Softy]AttackMan,2427,947,43,43,86,50.0%,6m
31949,2,SERRALNO,2427,951,42,39,81,51.9%,2h
31949,3,Luka,2427,873,34,30,64,53.1%,28m
31949,3,garubal,2427,699,29,25,54,53.7%,29m
31949,3,Arkantos,2427,528,28,25,53,52.8%,2h
31949,2,SNOWMAN,2427,623,25,24,49,51.0%,2h
31949,3,Crownlyi,2427,581,22,21,43,51.2%,35m
31949,3,CaptRadPants,2427,503,21,16,37,56.8%,4m
31949,1,Jhologan,2427,684,21,34,55,38.2%,18m
31949,3,[IPFC]Kunioh,2427,421,18,18,36,50.0%,50m
31949,3,[trash0]Ellisonetic,2427,485,17,15,32,53.1%,14m
31949,3,ushiocham,2427,216,8,10,18,44.4%,27m
31949,3,Vinex,2427,95,5,4,9,55.6%,2h
31949,3,Omarion,2427,140,5,8,13,38.5%,2h
31949,3,Skytoss,2427,121,4,4,8,50.0%,2h
31949,3,Sicarius,2427,58,4,5,9,44.4%,8m
31949,1,wilshire,2427,145,3,0,3,100.0%,2h
31949,1,Ariston,2427,0,3,1,4,75.0%,4m
31949,1,Athrun,2427,0,3,2,5,60.0%,2h
31949,3,SweetDream,2427,121,2,1,3,66.7%,2h
31949,2,mayaltika,2427,88,2,5,7,28.6%,2h
31949,3,Noobs,2427,0,2,6,8,25.0%,31m
31949,1,JON,2427,0,1,1,2,50.0%,49m
31949,3,[S4R0]Vita,2427,96,1,1,2,50.0%,30m
31949,2,TYYT,2427,30,1,7,8,12.5%,2h
31949,3,[NMKs]LightHouse,2427,0,0,2,2,0.0%,2h
31949,3,[EcdW]kesha,2427,0,0,2,2,0.0%,18m
31979,3,BruGT,2426,1613,160,141,301,53.2%,35m
31979,3,Blackshape,2426,1291,65,51,116,56.0%,3h
31979,3,[4xDRG]Jelleton,2426,812,34,24,58,58.6%,35m
31979,3,tigre,2426,596,26,12,38,68.4%,35m
31979,3,Ecliptic,2426,349,12,9,21,57.1%,14m
31979,3,[ZKGame]RenZoRS,2426,287,12,10,22,54.5%,2h
31979,3,[ExcIgN]OoUgWaY,2426,341,12,10,22,54.5%,2h
31979,3,[XpKAc]Santyboongy,2426,309,11,7,18,61.1%,2h
31979,3,[TGosuA]Rolch,2426,276,10,2,12,83.3%,2h
31979,2,thatmadyoke,2426,176,8,10,18,44.4%,4m
31979,2,Gildrean,2426,211,7,9,16,43.8%,1h
31979,3,Xanndra,2426,118,5,4,9,55.6%,2h
31979,2,QuanChi,2426,165,5,8,13,38.5%,3h
31979,1,Gaston,2426,138,4,3,7,57.1%,2h
31979,3,WaveringEyes,2426,86,4,5,9,44.4%,30m
31979,3,[TmGEN]EdoVision,2426,0,3,2,5,60.0%,35m
31979,3,Jackinthebox,2426,30,2,1,3,66.7%,43m
31979,3,Jesuus,2426,0,2,5,7,28.6%,2h
31979,3,SDMX,2426,0,1,0,1,100.0%,2h
31979,3,Bulby,2426,0,1,1,2,50.0%,34m
31979,3,wilber,2426,0,1,1,2,50.0%,1h
31979,3,Maximilian,2426,30,1,2,3,33.3%,1h
31979,3,[LOHd]minCemeaT,2426,0,1,4,5,20.0%,2h
31979,3,Stucks,2426,0,1,4,5,20.0%,18m
31979,3,LittleMarsh,2426,0,0,1,1,0.0%,21m
31979,3,AgentHippo,2426,0,0,1,1,0.0%,46m
32005,1,elganzo,2425,1417,188,194,382,49.2%,2h
32005,2,PizzaDog,2425,1388,53,53,106,50.0%,33m
32005,3,niran,2425,347,40,28,68,58.8%,2h
32005,3,Ferris,2425,729,28,27,55,50.9%,46m
32005,1,LonelySumo,2425,649,23,29,52,44.2%,36m
32005,2,Tobi,2425,434,19,13,32,59.4%,44m
32005,2,imhigh,2425,518,19,20,39,48.7%,16m
32005,1,Bonitao,2425,412,17,16,33,51.5%,2h
32005,2,monolicho,2425,434,17,20,37,45.9%,2h
32005,3,DmdWt,2425,310,12,6,18,66.7%,41m
32005,3,TheEndDragon,2425,310,12,11,23,52.2%,27m
32005,1,Rubicon,2425,329,11,12,23,47.8%,2h
32005,3,SHoodaB,2425,270,9,11,20,45.0%,2h
32005,1,[PHNIX]YeomansIII,2425,165,9,14,23,39.1%,16m
32005,3,cuNAHH,2425,195,7,7,14,50.0%,2h
32005,2,[AoftV]WildmanFree,2425,235,7,10,17,41.2%,10m
32005,3,Dsboy,2425,142,6,4,10,60.0%,11m
32005,1,mithrandir,2425,48,5,2,7,71.4%,2h
32005,3,Yesselm,2425,172,5,7,12,41.7%,27m
32005,2,LeDude,2425,182,5,9,14,35.7%,2h
32005,3,Drewman,2425,58,3,2,5,60.0%,35m
32005,3,SANGUINIUZ,2425,58,3,2,5,60.0%,2h
32005,3,Caleb,2425,62,3,3,6,50.0%,2h
32005,3,CadenShrip,2425,60,3,3,6,50.0%,18m
32005,3,Manasume,2425,90,3,5,8,37.5%,29m
32005,2,Ufkell,2425,30,3,6,9,33.3%,35m
32005,3,Tekniques,2425,100,3,6,9,33.3%,8m
32005,2,[clow]Guerrero,2425,94,3,6,9,33.3%,2h
32005,3,Moloch,2425,0,2,4,6,33.3%,2h
32005,3,[TxPain]TechnicalBG,2425,0,1,0,1,100.0%,2h
32005,2,StruckMachin,2425,0,1,4,5,20.0%,2h
32005,3,reue,2425,0,1,4,5,20.0%,2h
32005,3,jaystrict,2425,0,0,1,1,0.0%,1h
32005,3,Skyfalling,2425,0,0,2,2,0.0%,28m
32005,3,Cthulhu,2425,0,0,2,2,0.0%,28m
32005,3,Panda,2425,0,0,2,2,0.0%,3h
32005,1,GlueSniffer,2425,0,0,3,3,0.0%,2h
32005,3,ChewChow,2425,0,0,5,5,0.0%,2h
32043,2,AstroTrypp,2424,620,137,124,261,52.5%,2h
32043,3,OGnerdballer,2424,949,67,89,156,42.9%,10m
32043,3,Danaku,2424,705,49,47,96,51.0%,2h
32043,3,Heizt,2424,1206,45,48,93,48.4%,49m
32043,2,SamelCamel,2424,459,40,49,89,44.9%,18m
32043,3,xFickle,2424,957,39,35,74,52.7%,2h
32043,1,Dedalus,2424,783,30,38,68,44.1%,1h
32043,2,ShadowStar,2424,538,22,28,50,44.0%,5m
32043,3,[Ohyo]Filibus,2424,315,21,11,32,65.6%,2h
32043,3,brainbug,2424,448,15,14,29,51.7%,40m
32043,2,RAGNAROK,2424,360,15,20,35,42.9%,2h
32043,3,[VINGAD]cerrado,2424,360,14,13,27,51.9%,1h
32043,2,Darwin,2424,282,13,5,18,72.2%,2h
32043,3,[SCVM]SubaUgUlan,2424,329,12,7,19,63.2%,2h
32043,1,[BURNIN]VulvaTronics,2424,263,10,15,25,40.0%,1h
32043,3,Todynho,2424,276,10,15,25,40.0%,2h
32043,3,[gam30n]Chub,2424,150,9,0,9,100.0%,27m
32043,3,MrSparkle,2424,120,5,7,12,41.7%,4m
32043,3,[Nraged]Clyde,2424,121,3,5,8,37.5%,37m
32043,3,Vancharekke,2424,32,3,6,9,33.3%,37m
32043,3,Klutt,2424,30,2,1,3,66.7%,29m
32043,3,TheJoker,2424,97,2,1,3,66.7%,43m
32043,3,Leviatán,2424,0,1,0,1,100.0%,2h
32043,3,PregoArgtano,2424,0,1,0,1,100.0%,2h
32043,2,[RRC]DorthVordar,2424,0,1,2,3,33.3%,2h
32043,3,[MIIllM]IlII,2424,30,1,4,5,20.0%,11m
32043,3,chip,2424,30,1,4,5,20.0%,2h
32043,1,Juy,2424,0,1,4,5,20.0%,3h
32043,3,terrangama,2424,0,0,2,2,0.0%,2h
32072,3,BichoOscuro,2423,949,40,27,67,59.7%,19m
32072,3,JuanBobo,2423,880,34,50,84,40.5%,5m
32072,2,Demexo,2423,713,27,32,59,45.8%,2h
32072,3,[ExcIgN]Charlie,2423,577,22,21,43,51.2%,5m
32072,3,[P3ru96]BETO,2423,614,19,39,58,32.8%,9m
32072,3,blowfish,2423,374,13,14,27,48.1%,2h
32072,3,Multiman,2423,333,12,6,18,66.7%,1h
32072,2,NeoSatori,2423,269,11,12,23,47.8%,2h
32072,3,SerghioMart,2423,223,8,3,11,72.7%,2h
32072,2,Death,2423,148,8,8,16,50.0%,1h
32072,1,cornshrimp,2423,167,5,11,16,31.2%,5m
32072,1,Beamer,2423,195,5,15,20,25.0%,32m
32072,3,Rogue,2423,173,4,1,5,80.0%,35m
32072,3,UltimateNoob,2423,90,4,2,6,66.7%,3h
32072,3,Instance,2423,68,4,7,11,36.4%,38m
32072,3,midge,2423,146,3,3,6,50.0%,4m
32072,3,Marler,2423,121,3,5,8,37.5%,11m
32072,3,[EPCK]joaquinad,2423,121,3,6,9,33.3%,2h
32072,3,Grav,2423,96,2,0,2,100.0%,2h
32072,3,Aqua,2423,30,2,4,6,33.3%,4m
32072,3,KIRITOYK,2423,30,1,2,3,33.3%,21m
32072,3,Heroxilies,2423,30,1,3,4,25.0%,27m
32072,1,uiohgcx,2423,0,1,4,5,20.0%,18m
32072,3,[KAGUSA]EpsteinsBoss,2423,0,0,2,2,0.0%,3h
32072,3,Joshuaxw,2423,0,0,2,2,0.0%,1h
32072,3,Drinkcup,2423,0,0,4,4,0.0%,2h
32098,1,Amuro,2422,1279,355,353,708,50.1%,2h
32098,3,mirzakhani,2422,1604,149,132,281,53.0%,18m
32098,1,LungSmalls,2422,1569,115,127,242,47.5%,2h
32098,1,btt,2422,1544,96,86,182,52.7%,2h
32098,3,xiaomiredmi,2422,1444,66,51,117,56.4%,2h
32098,2,[SWOU]RoNs,2422,1549,64,68,132,48.5%,2h
32098,1,[HRLOCA]DeiAurea,2422,1035,64,80,144,44.4%,2h
32098,3,[MeanM]Alaren,2422,1338,63,53,116,54.3%,16m
32098,2,LengeLenge,2422,1042,58,61,119,48.7%,2h
32098,1,PanSeco,2422,668,48,35,83,57.8%,2h
32098,2,Cognition,2422,1183,43,48,91,47.3%,35m
32098,3,Ontologist,2422,785,38,27,65,58.5%,14m
32098,3,Folstag,2422,530,19,19,38,50.0%,1h
32098,2,Ansell,2422,497,18,20,38,47.4%,2h
32098,2,[NLTN]GGdarius,2422,552,17,24,41,41.5%,11m
32098,1,ZOCALEBZRG,2422,494,16,27,43,37.2%,2h
32098,3,[R4MR0D]Xerxes,2422,268,10,10,20,50.0%,2h
32098,3,PhilOsophy,2422,251,8,5,13,61.5%,2h
32098,3,Zeross,2422,210,7,11,18,38.9%,2h
32098,3,ERock,2422,212,6,4,10,60.0%,40m
32098,3,bestofdonkey,2422,172,6,6,12,50.0%,2h
32098,3,[CoopVN]akabavuong,2422,163,5,6,11,45.5%,40m
32098,1,[BlGD]ghost,2422,66,4,9,13,30.8%,2h
32098,2,QuebecPiggy,2422,126,4,14,18,22.2%,2h
32098,3,Slaytanic,2422,149,3,2,5,60.0%,18m
32098,1,Richter,2422,0,1,1,2,50.0%,2h
32098,3,Benzo,2422,30,1,2,3,33.3%,2h
32098,3,[BEHH]spacedude,2422,0,1,4,5,20.0%,49m
32098,3,Hyke,2422,0,1,4,5,20.0%,35m
32098,3,[b1azin]TEUFELHUNDEN,2422,0,0,1,1,0.0%,6m
32098,3,Destrukto,2422,0,0,1,1,0.0%,4m
32098,3,[notBAD]TheDesertFox,2422,0,0,2,2,0.0%,29m
32130,3,Anankke,2421,1193,159,150,309,51.5%,51m
32130,2,Sosaia,2421,1458,81,70,151,53.6%,1h
32130,2,nerad,2421,1322,62,64,126,49.2%,1h
32130,3,[nieBla]Supre,2421,693,37,30,67,55.2%,1h
32130,3,TOSSNMYSALAD,2421,569,33,29,62,53.2%,31m
32130,3,Renzo,2421,848,31,34,65,47.7%,41m
32130,3,Yuuta,2421,290,28,18,46,60.9%,3h
32130,2,Mateo,2421,562,23,20,43,53.5%,33m
32130,3,[ARNAIZ]BASTHORK,2421,585,21,18,39,53.8%,3h
32130,3,Choseph,2421,556,21,23,44,47.7%,2h
32130,3,KillaKat,2421,396,13,13,26,50.0%,43m
32130,2,Chard,2421,323,13,14,27,48.1%,41m
32130,3,[CWF]JeangamerXD,2421,244,9,2,11,81.8%,2h
32130,2,[LastKT]Ridley,2421,249,9,2,11,81.8%,24m
32130,1,Hollywood,2421,258,9,12,21,42.9%,28m
32130,3,Muddy,2421,170,7,3,10,70.0%,43m
32130,3,[OD2019]Horus,2421,226,7,22,29,24.1%,25m
32130,3,Zephrene,2421,185,6,0,6,100.0%,14m
32130,2,DKamm,2421,156,5,5,10,50.0%,51m
32130,2,mac,2421,178,5,9,14,35.7%,2h
32130,3,ROCKlord,2421,0,4,1,5,80.0%,2h
32130,3,ZelDrick,2421,160,4,1,5,80.0%,2h
32130,2,Brando,2421,158,3,1,4,75.0%,46m
32130,3,LUIZ,2421,125,3,2,5,60.0%,46m
32130,3,Muse,2421,42,3,6,9,33.3%,36m
32130,1,Xyth,2421,30,3,7,10,30.0%,2h
32130,3,[Metric]saY,2421,119,2,2,4,50.0%,2h
32130,2,MackimGson,2421,46,2,3,5,40.0%,2h
32130,3,FLATLINE,2421,60,2,5,7,28.6%,51m
32130,3,JulianoVerma,2421,0,2,5,7,28.6%,2h
32130,3,dambao,2421,0,2,6,8,25.0%,15m
32130,2,RogueConvict,2421,0,1,0,1,100.0%,2h
32130,2,Zentenk,2421,0,1,0,1,100.0%,2h
32130,3,IIIIIIIIIIII,2421,0,1,0,1,100.0%,40m
32130,3,Quiz,2421,0,1,2,3,33.3%,2h
32130,1,Warrior,2421,0,1,4,5,20.0%,2h
32130,3,Cannabliss,2421,0,0,2,2,0.0%,31m
32130,1,ElCore,2421,0,0,3,3,0.0%,46m
32130,3,Maddoggiedog,2421,0,0,4,4,0.0%,7m
32169,2,LosChurros,2420,1426,112,99,211,53.1%,2h
32169,3,SleepnSentry,2420,1211,62,65,127,48.8%,49m
32169,3,PumaSphere,2420,1021,58,49,107,54.2%,14m
32169,2,AlfayOmega,2420,722,58,59,117,49.6%,6m
32169,3,[DACKS]silkyjohnson,2420,1376,55,51,106,51.9%,29m
32169,3,Saturnal,2420,1132,53,45,98,54.1%,50m
32169,3,[Altari]Shuvilar,2420,987,41,36,77,53.2%,14m
32169,3,XDCesarDX,2420,874,33,33,66,50.0%,3h
32169,3,LagMan,2420,696,31,27,58,53.4%,49m
32169,2,Ilyrius,2420,352,12,17,29,41.4%,3h
32169,3,Nogards,2420,230,9,3,12,75.0%,2h
32169,2,corbinator,2420,195,8,4,12,66.7%,1h
32169,1,DeLaVega,2420,178,8,16,24,33.3%,2h
32169,3,[ZTemp]Alfred,2420,132,6,6,12,50.0%,16m
32169,3,[ClanPH]Foxhunter,2420,179,6,7,13,46.2%,6m
32169,2,Voltarez,2420,116,5,12,17,29.4%,21m
32169,3,spent,2420,143,4,7,11,36.4%,2h
32169,3,Brad,2420,120,3,1,4,75.0%,2h
32169,3,[Apixel]gabriel,2420,122,3,5,8,37.5%,41m
32169,1,bob,2420,110,3,9,12,25.0%,2h
32169,3,BenJAMMIN,2420,30,2,1,3,66.7%,35m
32169,3,Franklin,2420,30,2,2,4,50.0%,29m
32169,1,Daybreakz,2420,48,2,3,5,40.0%,40m
32169,1,[NXLsc]CrimsonAA,2420,0,2,4,6,33.3%,33m
32169,2,luas,2420,0,2,5,7,28.6%,2h
32169,3,[BQB]BaleiaDumba,2420,0,1,0,1,100.0%,2h
32169,3,[Gatinn]gatinyooo,2420,0,1,0,1,100.0%,5m
32169,3,Soundblaster,2420,0,1,2,3,33.3%,3h
32169,3,hustlermind,2420,0,1,2,3,33.3%,2h
32169,3,Waracle,2420,0,1,3,4,25.0%,2h
32169,3,Hegonex,2420,0,1,4,5,20.0%,5m
32169,1,Cass,2420,0,0,1,1,0.0%,40m
32201,1,Lobo,2419,1585,341,338,679,50.2%,22m
32201,2,Sid,2419,1253,77,88,165,46.7%,37m
32201,3,palmach,2419,937,58,53,111,52.3%,2h
32201,3,EnjoyShine,2419,1223,55,55,110,50.0%,2h
32201,3,EyeOfHorus,2419,1026,47,25,72,65.3%,2h
32201,3,Kazid,2419,820,29,32,61,47.5%,1h
32201,3,Thyme,2419,510,21,24,45,46.7%,31m
32201,2,Makinon,2419,556,19,26,45,42.2%,2h
32201,3,Viper,2419,417,18,16,34,52.9%,28m
32201,2,Starlord,2419,483,18,19,37,48.6%,2h
32201,1,KILIMINI,2419,270,10,13,23,43.5%,23m
32201,2,Ramkid,2419,231,7,11,18,38.9%,2h
32201,3,TheCarlosMan,2419,153,6,4,10,60.0%,1h
32201,3,dlx,2419,142,6,6,12,50.0%,2h
32201,3,FiftyCal,2419,181,6,7,13,46.2%,35m
32201,3,PIT,2419,114,5,9,14,35.7%,2h
32201,2,[KICKED]StalkerEyes,2419,120,5,10,15,33.3%,11m
32201,3,Graves,2419,139,3,1,4,75.0%,29m
32201,3,[NSushi]nighthawk,2419,100,3,4,7,42.9%,2h
32201,3,Calzer,2419,30,2,2,4,50.0%,2h
32201,2,Imm,2419,0,2,4,6,33.3%,51m
32201,3,Untitled,2419,30,1,1,2,50.0%,2h
32201,3,JBli,2419,32,1,1,2,50.0%,2h
32201,3,AwesomeGuy,2419,30,1,2,3,33.3%,2h
32201,1,DirtyBushRag,2419,0,1,4,5,20.0%,2h
32201,3,Jugyon,2419,0,1,5,6,16.7%,2h
32201,3,[G4M3R5]Jaydogs,2419,0,0,1,1,0.0%,27m
32201,3,[LQV]lor,2419,0,0,3,3,0.0%,2h
32201,3,WtSucks,2419,0,0,3,3,0.0%,8m
32230,2,[IllIlI]SERFAS,2418,1463,272,276,548,49.6%,41m
32230,3,natalya,2418,1688,238,228,466,51.1%,2h
32230,3,MrLetter,2418,1174,123,113,236,52.1%,50m
32230,3,Master,2418,1582,114,108,222,51.4%,3h
32230,2,Geladeira,2418,1615,72,85,157,45.9%,2h
32230,3,[Atone]Clothes,2418,1084,55,52,107,51.4%,2h
32230,2,viper,2418,466,54,64,118,45.8%,23m
32230,3,Talnorosh,2418,1083,47,34,81,58.0%,2h
32230,3,RaNNo,2418,830,41,24,65,63.1%,2h
32230,1,Unnu,2418,1027,37,46,83,44.6%,2h
32230,3,EvilMorty,2418,402,29,28,57,50.9%,2h
32230,3,ShadowMonk,2418,564,25,25,50,50.0%,21m
32230,3,[KRKEN]David,2418,503,23,14,37,62.2%,51m
32230,3,TheBest,2418,600,23,18,41,56.1%,2h
32230,3,Lallaar,2418,518,22,16,38,57.9%,2h
32230,3,[nbgPH]Napster,2418,435,19,17,36,52.8%,40m
32230,3,Lemaroy,2418,289,11,6,17,64.7%,2h
32230,3,[ZTemp]PercyX,2418,171,11,9,20,55.0%,2h
32230,2,[LOHs]Spanky,2418,276,10,11,21,47.6%,2h
32230,2,BrotatoChip,2418,246,9,10,19,47.4%,2h
32230,2,[Dark20]MaestroDark,2418,220,7,16,23,30.4%,18m
32230,3,TrueBlue,2418,171,5,4,9,55.6%,8m
32230,1,SomeLink,2418,136,5,9,14,35.7%,23m
32230,3,Ameren,2418,156,4,2,6,66.7%,12m
32230,3,Abraxas,2418,0,4,4,8,50.0%,9m
32230,3,Viking,2418,116,4,7,11,36.4%,4m
32230,1,foxmcccloud,2418,0,3,2,5,60.0%,27m
32230,3,Zits,2418,60,3,3,6,50.0%,46m
32230,2,NightstarAce,2418,86,3,9,12,25.0%,2h
32230,3,Wymiatacz,2418,95,2,0,2,100.0%,2h
32230,1,MrFurious,2418,0,2,2,4,50.0%,3h
32230,3,TheLich,2418,0,2,3,5,40.0%,39m
32230,3,[LOHd]galloazul,2418,62,2,4,6,33.3%,2h
32230,3,[TOFF]Fluid,2418,96,1,1,2,50.0%,2h
32230,3,[TDT]Aspire,2418,0,1,4,5,20.0%,14m
32230,3,RNS,2418,30,1,4,5,20.0%,2h
32230,3,[Swage]Jacob,2418,0,1,4,5,20.0%,31m
32230,1,AlCaPOONE,2418,0,0,3,3,0.0%,49m
32230,3,roditene,2418,0,0,3,3,0.0%,36m
32269,2,sossy,2417,1535,368,387,755,48.7%,2h
32269,3,TheGoat,2417,1167,52,48,100,52.0%,2h
32269,1,Elementre,2417,901,50,51,101,49.5%,21m
32269,3,edy,2417,522,31,22,53,58.5%,48m
32269,3,Amon,2417,544,23,21,44,52.3%,18m
32269,3,[Mataco]Yorick,2417,470,20,18,38,52.6%,40m
32269,3,[CADIVI]UIO,2417,469,19,19,38,50.0%,2h
32269,2,NotSure,2417,328,17,27,44,38.6%,2h
32269,3,Necro,2417,255,12,7,19,63.2%,12m
32269,2,stryker,2417,329,12,13,25,48.0%,2h
32269,2,Flarisyea,2417,178,8,11,19,42.1%,2h
32269,3,Maigawd,2417,30,4,2,6,66.7%,41m
32269,3,[ShTiLe]sludgeminer,2417,92,4,5,9,44.4%,2h
32269,3,Arimus,2417,105,3,1,4,75.0%,43m
32269,3,[fatb0i]Jacaranda,2417,58,3,2,5,60.0%,42m
32269,2,Phoenix,2417,119,3,5,8,37.5%,2h
32269,2,[IIIY]GOB,2417,142,3,6,9,33.3%,34m
32269,3,Sudz,2417,116,3,6,9,33.3%,46m
32269,3,Zephyria,2417,30,2,5,7,28.6%,46m
32269,3,Jericho,2417,97,2,5,7,28.6%,2h
32269,3,MeiLaut,2417,0,1,4,5,20.0%,2h
32269,2,bdfg,2417,0,0,1,1,0.0%,35m
32269,3,CptnBuckaroo,2417,0,0,1,1,0.0%,2h
32269,3,Mikkimim,2417,0,0,2,2,0.0%,50m
32269,3,ozkar,2417,0,0,2,2,0.0%,50m
32269,3,stevill,2417,0,0,4,4,0.0%,1h
32295,2,Heartless,2416,1456,148,127,275,53.8%,17m
32295,3,[Nu]kilcupcake,2416,1323,119,116,235,50.6%,3h
32295,2,xavra,2416,1179,48,54,102,47.1%,20m
32295,3,Stilgar,2416,640,47,41,88,53.4%,26m
32295,1,SwonkSwoonk,2416,798,28,35,63,44.4%,4m
32295,3,[I3L]Radrappy,2416,389,21,19,40,52.5%,2h
32295,3,Gonzalo,2416,466,17,15,32,53.1%,43m
32295,3,Betrayer,2416,392,14,15,29,48.3%,40m
32295,3,kevinbuu,2416,373,13,10,23,56.5%,2h
32295,3,weeblord,2416,284,12,13,25,48.0%,25m
32295,3,Kaphis,2416,315,12,19,31,38.7%,3m
32295,3,[GOPERÚ]killadiction,2416,295,11,8,19,57.9%,2h
32295,2,Naypolian,2416,256,11,14,25,44.0%,23m
32295,1,Vendetha,2416,198,8,12,20,40.0%,2h
32295,3,[ZTemp]Goliath,2416,148,5,5,10,50.0%,25m
32295,3,DoZerhell,2416,121,2,2,4,50.0%,37m
32295,3,Unrolled,2416,118,2,2,4,50.0%,2h
32295,3,CrispyGT,2416,0,1,0,1,100.0%,3h
32295,2,LettuxeYT,2416,42,1,1,2,50.0%,2h
32295,3,Rafa,2416,0,1,1,2,50.0%,36m
32295,3,[TESE]TELLEZ,2416,42,1,3,4,25.0%,2h
32295,3,Daxster,2416,0,1,4,5,20.0%,2h
32295,3,[4GL]klammy,2416,0,1,4,5,20.0%,2h
32295,3,hiroshijag,2416,0,0,1,1,0.0%,2h
32295,3,Techno,2416,0,0,1,1,0.0%,25m
32295,1,drewdearing,2416,0,0,1,1,0.0%,2h
32295,2,SHIAMYR,2416,0,0,1,1,0.0%,32m
32322,3,Victor,2415,1532,589,601,1190,49.5%,27m
32322,2,Arem,2415,1574,66,78,144,45.8%,2h
32322,1,MrPickles,2415,744,32,30,62,51.6%,2h
32322,3,[UCF]TitanWarrior,2415,591,22,18,40,55.0%,2h
32322,1,[ANTT]McPherson,2415,638,20,32,52,38.5%,27m
32322,3,Kricilio,2415,402,19,8,27,70.4%,1h
32322,2,[ScSwrm]Proboarder,2415,332,13,16,29,44.8%,11m
32322,3,EdPwns,2415,256,9,7,16,56.2%,2h
32322,3,Farruks,2415,227,7,2,9,77.8%,2h
32322,3,Leoxddx,2415,237,7,5,12,58.3%,5m
32322,3,Hidralisk,2415,210,7,11,18,38.9%,2h
32322,3,Morphy,2415,161,5,3,8,62.5%,2h
32322,3,Marvelous,2415,116,5,8,13,38.5%,16m
32322,3,[KerriS]NeroKaijin,2415,158,5,9,14,35.7%,2h
32322,3,Prince,2415,88,4,4,8,50.0%,2h
32322,3,TequilaSam,2415,86,4,6,10,40.0%,2h
32322,1,Konov,2415,60,4,8,12,33.3%,3h
32322,3,Logan,2415,97,3,4,7,42.9%,2h
32322,3,[SINSTR]roberhpp,2415,60,3,4,7,42.9%,1h
32322,3,Nano,2415,0,3,5,8,37.5%,25m
32322,2,PILO,2415,44,3,8,11,27.3%,2h
32322,3,blaze,2415,30,2,1,3,66.7%,4m
32322,2,Benrar,2415,40,2,1,3,66.7%,21m
32322,3,ArthurDent,2415,60,2,4,6,33.3%,28m
32322,3,Scott,2415,58,2,4,6,33.3%,8m
32322,2,jhan,2415,0,2,6,8,25.0%,2h
32322,1,Leito,2415,0,1,1,2,50.0%,2h
32322,3,SpyCMeatBall,2415,30,1,2,3,33.3%,3h
32322,3,[ExcIgN]Wolfrem,2415,30,1,2,3,33.3%,1h
32322,3,MiSt,2415,0,1,3,4,25.0%,28m
32322,3,[BW7]Mÿth,2415,0,0,1,1,0.0%,1h
32322,2,zelinhhh,2415,0,0,1,1,0.0%,3h
32322,2,Platius,2415,0,0,2,2,0.0%,2h
32322,3,IonicVoid,2415,0,0,2,2,0.0%,51m
32356,2,Jeffz,2414,1213,124,120,244,50.8%,35m
32356,3,ATonOfBacon,2414,825,52,37,89,58.4%,2h
32356,3,noobynewbs,2414,566,22,24,46,47.8%,49m
32356,3,farry,2414,470,18,11,29,62.1%,2h
32356,3,CodyiakBear,2414,225,17,13,30,56.7%,2h
32356,3,Willzyx,2414,381,16,4,20,80.0%,2h
32356,3,[LZTs]Dolundesu,2414,463,16,15,31,51.6%,2h
32356,1,Niku,2414,257,9,14,23,39.1%,2h
32356,2,[FSS1]Beastish,2414,144,8,13,21,38.1%,11m
32356,3,[BATMF]Mauro,2414,120,6,0,6,100.0%,2h
32356,3,kakaname,2414,194,5,4,9,55.6%,2h
32356,3,PlagatH,2414,158,5,9,14,35.7%,2h
32356,3,FusionRanger,2414,181,5,10,15,33.3%,2h
32356,3,katana,2414,157,4,2,6,66.7%,2h
32356,3,WonderousAss,2414,153,4,7,11,36.4%,2h
32356,3,vinniecent,2414,122,4,9,13,30.8%,38m
32356,3,papu,2414,58,3,2,5,60.0%,16m
32356,1,Epsil,2414,48,3,5,8,37.5%,45m
32356,3,darvar,2414,108,3,6,9,33.3%,34m
32356,2,[SAMBO]solidangle,2414,74,2,2,4,50.0%,2h
32356,3,[STZ]warth,2414,30,2,3,5,40.0%,12m
32356,3,Darthballs,2414,58,2,3,5,40.0%,2h
32356,3,Wraz,2414,0,2,5,7,28.6%,19m
32356,1,Silentremark,2414,60,2,11,13,15.4%,33m
32356,3,Toast,2414,30,1,2,3,33.3%,31m
32356,3,terraqueo,2414,30,1,3,4,25.0%,2h
32356,1,LeksPanter,2414,0,1,4,5,20.0%,2h
32356,3,Shadowsightz,2414,0,1,4,5,20.0%,28m
32356,3,Diego,2414,0,1,5,6,16.7%,2h
32356,1,[Mkx]Albatraoz,2414,0,0,1,1,0.0%,2h
32356,3,sTran,2414,0,0,1,1,0.0%,2h
32356,3,KERRIGANPRO,2414,0,0,1,1,0.0%,1h
32356,3,Overlord,2414,0,0,2,2,0.0%,43m
32356,3,[LHDSC]cdml,2414,0,0,2,2,0.0%,2h
32356,1,KINGofF,2414,0,0,4,4,0.0%,2h
32391,3,FuriousMK,2413,1580,233,229,462,50.4%,48m
32391,3,quetzal,2413,625,60,60,120,50.0%,16m
32391,3,Bracken,2413,1258,41,56,97,42.3%,24m
32391,3,[ALTF04]SAMISHERMES,2413,887,37,30,67,55.2%,29m
32391,2,[Damasc]Azulito,2413,686,26,28,54,48.1%,2h
32391,3,Jaroslaw,2413,412,17,12,29,58.6%,37m
32391,2,Kai,2413,448,16,19,35,45.7%,6m
32391,3,[BR3]EagleSD,2413,396,14,10,24,58.3%,2h
32391,3,KARATECOMPA,2413,297,11,9,20,55.0%,2h
32391,2,[chzbyz]iDunWanaDiee,2413,272,10,14,24,41.7%,32m
32391,3,[WWP2]CeresManenes,2413,222,8,2,10,80.0%,12m
32391,2,AdX,2413,174,8,10,18,44.4%,45m
32391,2,GEEn,2413,284,8,14,22,36.4%,8m
32391,3,ApmTen,2413,244,7,7,14,50.0%,39m
32391,3,SpinyShell,2413,157,6,7,13,46.2%,2h
32391,2,SKiDoP,2413,117,5,5,10,50.0%,2h
32391,3,[2AND80]MaClayN,2413,86,3,5,8,37.5%,2h
32391,3,Pong,2413,60,3,6,9,33.3%,8m
32391,3,KamerDeep,2413,74,3,7,10,30.0%,46m
32391,2,[Blader]UnityKhala,2413,106,2,3,5,40.0%,2h
32391,1,[NtBh]CRABRAGOON,2413,48,2,4,6,33.3%,41m
32391,3,[LACRAS]Gambex,2413,60,2,6,8,25.0%,2h
32391,3,OmgItsVlad,2413,0,1,0,1,100.0%,2h
32391,3,DonAle,2413,0,1,1,2,50.0%,12m
32391,2,Salchipapu,2413,90,1,2,3,33.3%,38m
32391,1,UNICORNZZ,2413,0,1,4,5,20.0%,33m
32391,3,bobsaget,2413,0,1,4,5,20.0%,14m
32391,2,Vetro,2413,32,1,5,6,16.7%,2h
32391,2,[LANEX]AiurEnergyCo,2413,0,0,1,1,0.0%,2h
32391,3,[TPGGXD]noeaguantaa,2413,0,0,1,1,0.0%,2h
32391,1,GinjaNinja,2413,0,0,1,1,0.0%,4m
32391,3,Anton,2413,0,0,1,1,0.0%,2h
32391,3,InfernoMoose,2413,0,0,2,2,0.0%,46m
32424,2,ANUBIS,2412,1454,113,113,226,50.0%,1h
32424,3,Halloumi,2412,651,85,67,152,55.9%,21m
32424,3,RedMoonKing,2412,1502,85,82,167,50.9%,2h
32424,3,Arkyom,2412,1118,77,61,138,55.8%,2h
32424,3,FatMangos,2412,1373,66,60,126,52.4%,19m
32424,3,[UpxV]batimanias,2412,1137,43,40,83,51.8%,29m
32424,3,[K1yomi]sqrefff,2412,537,22,25,47,46.8%,2h
32424,3,JuniorBacon,2412,383,21,5,26,80.8%,51m
32424,1,Goukisan,2412,628,20,27,47,42.6%,16m
32424,2,trNt,2412,544,19,25,44,43.2%,2h
32424,2,Cylar,2412,480,18,22,40,45.0%,1h
32424,2,[SBCG]Judson,2412,446,14,20,34,41.2%,5m
32424,2,PapaWhiskey,2412,98,12,19,31,38.7%,46m
32424,3,CoolGuy,2412,268,11,7,18,61.1%,3h
32424,3,sapphisylph,2412,290,11,12,23,47.8%,2h
32424,3,itsmejamison,2412,297,9,8,17,52.9%,2h
32424,3,pRoBe,2412,198,8,7,15,53.3%,14m
32424,3,[2faded]Ghost,2412,238,8,7,15,53.3%,2h
32424,3,[4332]ghost,2412,184,5,3,8,62.5%,14m
32424,3,[ZFVet]REG,2412,126,4,8,12,33.3%,1h
32424,3,DavidCapy,2412,155,4,9,13,30.8%,2h
32424,3,donutLORD,2412,95,3,0,3,100.0%,8m
32424,3,Mindgamer,2412,123,3,1,4,75.0%,2h
32424,3,Exusiai,2412,60,2,2,4,50.0%,1h
32424,3,[RuNx]DeNtheKing,2412,90,2,4,6,33.3%,2h
32424,3,[JKR]JeGz,2412,0,1,0,1,100.0%,2h
32424,1,YaMz,2412,97,1,1,2,50.0%,2h
32424,3,Rides,2412,96,1,1,2,50.0%,14m
32424,3,JafinWabba,2412,0,0,1,1,0.0%,19m
32424,3,jjsky,2412,0,0,1,1,0.0%,2h
32424,3,[Ace]Morza,2412,0,0,2,2,0.0%,31m
32424,3,fizzfizz,2412,0,0,2,2,0.0%,14m
32424,1,Beercules,2412,0,0,3,3,0.0%,2h
32457,1,[F1ght]Mrbluskyy,2411,921,61,66,127,48.0%,2h
32457,3,Sepo,2411,668,45,35,80,56.2%,40m
32457,3,PsySpyPsycho,2411,920,42,35,77,54.5%,4m
32457,3,iceinfernal,2411,683,38,42,80,47.5%,31m
32457,2,Lariat,2411,894,37,37,74,50.0%,2h
32457,3,Balvenie,2411,227,35,20,55,63.6%,14m
32457,3,MetalX,2411,554,30,18,48,62.5%,25m
32457,3,[Ayynus]Lebeauner,2411,659,27,20,47,57.4%,2h
32457,3,bmac,2411,599,25,28,53,47.2%,1h
32457,3,Salutations,2411,360,19,10,29,65.5%,16m
32457,3,naisu,2411,434,17,15,32,53.1%,1h
32457,3,iThreeX,2411,365,16,9,25,64.0%,8m
32457,3,[CzdT]neurOKiller,2411,347,14,5,19,73.7%,51m
32457,3,Plumage,2411,333,13,7,20,65.0%,48m
32457,2,[StrkZ]Wraith,2411,242,11,9,20,55.0%,34m
32457,2,lReyNorZz,2411,292,10,11,21,47.6%,1h
32457,3,[Mazter]Bobatronio,2411,168,7,5,12,58.3%,2h
32457,3,LoganArakune,2411,204,6,5,11,54.5%,28m
32457,3,[DSAL]GOLIAT,2411,229,6,6,12,50.0%,1h
32457,3,Alitogdl,2411,170,5,7,12,41.7%,2h
32457,3,[ffaaak]POKEMONMEN,2411,86,4,5,9,44.4%,37m
32457,3,WAVE,2411,118,4,7,11,36.4%,2h
32457,1,Ratatat,2411,122,3,2,5,60.0%,49m
32457,1,nabedo,2411,0,2,4,6,33.3%,2h
32457,2,Gage,2411,0,2,5,7,28.6%,33m
32457,2,goose,2411,0,1,7,8,12.5%,35m
32457,3,[SoGayy]Wonka,2411,0,0,1,1,0.0%,19m
32457,3,Stirfry,2411,0,0,1,1,0.0%,2h
32457,3,[DXoP]Samael,2411,0,0,1,1,0.0%,2h
32457,3,newbie,2411,0,0,1,1,0.0%,31m
32457,1,[Hats]Learnmore,2411,0,0,3,3,0.0%,39m
32488,1,TAL,2410,1562,198,210,408,48.5%,1h
32488,1,zuela,2410,674,91,72,163,55.8%,36m
32488,1,Donut,2410,1574,82,81,163,50.3%,2h
32488,2,JDUNIT,2410,1466,64,68,132,48.5%,2h
32488,2,PeePeePooPoo,2410,430,63,61,124,50.8%,2h
32488,2,[SAUCEo]baller,2410,817,47,49,96,49.0%,2h
32488,3,Nightfire,2410,701,31,21,52,59.6%,2h
32488,3,TheToadLord,2410,182,28,20,48,58.3%,2h
32488,3,[GLHFJJ]AlarakSTX,2410,673,28,23,51,54.9%,2h
32488,3,TuKchero,2410,544,27,23,50,54.0%,2h
32488,3,Zebgoraj,2410,605,26,27,53,49.1%,31m
32488,3,Guilherme,2410,495,21,16,37,56.8%,2h
32488,3,BulletFly,2410,180,18,21,39,46.2%,46m
32488,3,ReidoArrocha,2410,278,10,11,21,47.6%,2h
32488,3,Bengence,2410,255,9,4,13,69.2%,2h
32488,1,KingNegus,2410,212,7,12,19,36.8%,16m
32488,1,Fox,2410,122,6,10,16,37.5%,2h
32488,2,jdmbucket,2410,127,4,4,8,50.0%,47m
32488,3,Nidhogg,2410,0,3,2,5,60.0%,46m
32488,3,[IoO7]TheArchitect,2410,86,3,5,8,37.5%,2h
32488,3,DanishBag,2410,119,3,5,8,37.5%,2h
32488,3,[NnRs]ZLog,2410,88,3,6,9,33.3%,4m
32488,1,NEMESIS,2410,96,3,6,9,33.3%,4m
32488,3,[ROPG]Ryjito,2410,42,3,7,10,30.0%,2h
32488,3,MATCHLESS,2410,92,2,0,2,100.0%,46m
32488,3,[UpxV]aletonii,2410,30,2,1,3,66.7%,2h
32488,3,Illidan,2410,0,2,1,3,66.7%,3h
32488,3,YodaJedi,2410,60,2,5,7,28.6%,14m
32488,3,Avion,2410,93,1,1,2,50.0%,2h
32488,1,Zero,2410,0,1,4,5,20.0%,2h
32488,3,Sylvanoshei,2410,0,1,4,5,20.0%,11m
32488,3,GViper,2410,0,0,1,1,0.0%,46m
32488,3,[P1N0Ys]PIKOY,2410,0,0,1,1,0.0%,2h
32488,3,[OR2016]DRACUL,2410,0,0,3,3,0.0%,1h
32522,3,AlexisZa,2409,1566,125,123,248,50.4%,50m
32522,3,Garm,2409,1006,83,68,151,55.0%,3h
32522,3,[CaC4s]BobEsponja,2409,1147,49,41,90,54.4%,28m
32522,2,[cluez]DiscoKruse,2409,753,46,53,99,46.5%,2h
32522,2,[Sabo0]Ethical,2409,986,41,39,80,51.2%,33m
32522,1,Torukmakto,2409,315,37,39,76,48.7%,39m
32522,2,[scvpog]Pann,2409,842,32,34,66,48.5%,2h
32522,2,nono,2409,741,30,28,58,51.7%,2h
32522,1,Pebble,2409,724,27,33,60,45.0%,2h
32522,3,[LMI42]Hoehammer,2409,606,24,18,42,57.1%,2h
32522,3,TuToyerLCiel,2409,523,23,16,39,59.0%,3h
32522,3,aggresor,2409,496,19,22,41,46.3%,2h
32522,2,DoctorZeuss,2409,288,12,13,25,48.0%,2h
32522,3,Woodish,2409,337,12,14,26,46.2%,2h
32522,3,Swimmerbuff,2409,338,11,16,27,40.7%,12m
32522,3,NurSpielen,2409,270,10,7,17,58.8%,26m
32522,3,MinedConch,2409,120,8,7,15,53.3%,1h
32522,3,[M0SCAS]NotCopyright,2409,150,7,2,9,77.8%,27m
32522,3,[UNEF]Albertobetan,2409,198,7,9,16,43.8%,42m
32522,1,Drdumais,2409,160,6,14,20,30.0%,24m
32522,3,RAGE,2409,146,5,6,11,45.5%,49m
32522,3,Quinte,2409,122,4,7,11,36.4%,50m
32522,3,Surfcash,2409,97,3,3,6,50.0%,2h
32522,3,BoutDestroya,2409,38,3,6,9,33.3%,36m
32522,3,Renrag,2409,60,2,5,7,28.6%,12m
32522,3,andone,2409,0,1,0,1,100.0%,3h
32522,3,KingFlarken,2409,0,1,0,1,100.0%,20m
32522,3,DAVICHUS,2409,30,1,2,3,33.3%,29m
32522,3,[LAMDA]RAAM,2409,0,1,2,3,33.3%,1h
32522,3,Brod,2409,30,1,4,5,20.0%,29m
32522,3,ScvAssassin,2409,0,1,7,8,12.5%,2h
32522,3,LotusstormTV,2409,0,0,1,1,0.0%,1h
32522,3,[Abisma]Banceline,2409,0,0,1,1,0.0%,21m
32522,1,DrMikOkizard,2409,0,0,1,1,0.0%,24m
32556,1,[OceanT]DetonaFunk,2408,1486,142,137,279,50.9%,2h
32556,1,Vince,2408,1545,83,88,171,48.5%,49m
32556,3,ZohanIv,2408,1197,67,67,134,50.0%,12m
32556,2,Serlion,2408,1125,46,50,96,47.9%,2h
32556,3,[Lp]FanniaBoT,2408,878,38,25,63,60.3%,35m
32556,2,[Fever]Phatricia,2408,744,34,32,66,51.5%,2h
32556,3,[KGH6]lingsauce,2408,749,32,24,56,57.1%,2h
32556,3,Avut,2408,471,27,18,45,60.0%,43m
32556,3,[Pizzy]Chipokaw,2408,512,21,21,42,50.0%,2h
32556,2,[ABIO12]JefDahmrsKid,2408,433,19,22,41,46.3%,2h
32556,1,Alan,2408,582,19,34,53,35.8%,2h
32556,3,disruptor,2408,448,17,11,28,60.7%,2h
32556,2,Protoss,2408,428,15,23,38,39.5%,35m
32556,3,ninñawwwwwpp,2408,265,10,7,17,58.8%,40m
32556,3,AlissYourQn,2408,164,8,3,11,72.7%,4m
32556,2,[PAPSUM]GolumLeSourn,2408,205,8,13,21,38.1%,5m
32556,2,Anonymous,2408,238,6,13,19,31.6%,2h
32556,2,[TypeZ]haven,2408,60,5,7,12,41.7%,27m
32556,1,Battyboy,2408,121,5,7,12,41.7%,28m
32556,2,Sfogliatella,2408,125,4,9,13,30.8%,2h
32556,3,IIIIIIIIIIII,2408,155,4,13,17,23.5%,8m
32556,3,MRaynor,2408,94,2,0,2,100.0%,1h
32556,1,Kkerseki,2408,0,2,4,6,33.3%,2h
32556,3,Supplies,2408,0,2,5,7,28.6%,2h
32556,2,[BiBiTE]nubulator,2408,0,1,1,2,50.0%,5m
32556,3,LISTERINE,2408,0,1,1,2,50.0%,15m
32556,3,[PSUMHA]HydeShepard,2408,38,1,4,5,20.0%,2h
32556,2,Coletrane,2408,92,1,4,5,20.0%,2h
32556,3,padrino,2408,0,1,5,6,16.7%,46m
32556,3,SkyPiglet,2408,0,0,1,1,0.0%,42m
32556,3,[tLoL]Cyrus,2408,0,0,1,1,0.0%,46m
32556,1,rudex,2408,0,0,2,2,0.0%,2h
32556,3,odaesu,2408,0,0,3,3,0.0%,40m
32556,3,[SanTos]SaInTBruno,2408,0,0,4,4,0.0%,2h
32590,1,[Savage]JMKChaos,2407,1446,77,82,159,48.4%,3h
32590,3,[BTUG]Andro,2407,1570,67,64,131,51.1%,11m
32590,3,leo,2407,1560,62,60,122,50.8%,19m
32590,1,Masv,2407,1513,60,64,124,48.4%,27m
32590,3,[Umizoo]BloodSparrow,2407,757,29,39,68,42.6%,41m
32590,3,[FSCN]JUMATTO,2407,671,25,20,45,55.6%,2h
32590,2,yyyyyyyyyyyy,2407,606,23,26,49,46.9%,44m
32590,3,SCUD,2407,698,22,37,59,37.3%,28m
32590,3,deathgods,2407,575,21,20,41,51.2%,35m
32590,3,Watson,2407,506,19,17,36,52.8%,29m
32590,3,FutureTrees,2407,442,17,17,34,50.0%,28m
32590,3,FatKakashi,2407,430,16,19,35,45.7%,46m
32590,3,kksjfkl,2407,388,15,9,24,62.5%,40m
32590,1,Chumbiwayo,2407,267,13,6,19,68.4%,27m
32590,3,TUMACHO,2407,217,13,9,22,59.1%,2h
32590,3,Ehecatl,2407,282,10,10,20,50.0%,20m
32590,3,LOMZO,2407,198,10,18,28,35.7%,2h
32590,1,Blazeibwater,2407,266,8,12,20,40.0%,2h
32590,3,[Ckq]shp,2407,187,6,3,9,66.7%,2h
32590,3,winniethepoo,2407,170,6,8,14,42.9%,26m
32590,2,EnderAtomos,2407,94,6,11,17,35.3%,37m
32590,2,speedsnail,2407,160,5,15,20,25.0%,19m
32590,1,basisay,2407,176,4,3,7,57.1%,2h
32590,3,MartinPlan,2407,139,4,5,9,44.4%,2h
32590,2,DogOfWar,2407,60,3,5,8,37.5%,2h
32590,3,Kazilla,2407,117,3,5,8,37.5%,2h
32590,2,laynestaley,2407,135,3,6,9,33.3%,2h
32590,2,SaltMaster,2407,112,3,6,9,33.3%,2h
32590,3,[CeGeTe]UnWorthy,2407,58,2,3,5,40.0%,51m
32590,3,Tehufn,2407,60,2,8,10,20.0%,2h
32590,2,MoDen,2407,38,2,9,11,18.2%,36m
32590,3,[USBDS]Quangus,2407,0,1,4,5,20.0%,51m
32590,1,RaNdU,2407,0,1,4,5,20.0%,2h
32590,3,MrTea,2407,0,1,4,5,20.0%,2h
32590,3,BeTheChange,2407,0,0,2,2,0.0%,1h
32625,3,[LaTW]Peste,2406,1580,248,235,483,51.3%,36m
32625,3,SanVyrish,2406,1177,84,70,154,54.5%,2h
32625,3,[XANNY]AfterDark,2406,1262,58,41,99,58.6%,16m
32625,3,Zehs,2406,895,40,33,73,54.8%,1h
32625,2,[DRKDMN]GreenDeath,2406,896,37,43,80,46.2%,3h
32625,2,[Kodos]Nicofersar,2406,742,29,32,61,47.5%,12m
32625,3,[ZTemp]akotea,2406,673,27,19,46,58.7%,2h
32625,3,Karmakaze,2406,566,25,22,47,53.2%,29m
32625,3,Jandro,2406,550,24,11,35,68.6%,30m
32625,3,Pok,2406,307,21,20,41,51.2%,2h
32625,3,GSirlak,2406,543,20,18,38,52.6%,2h
32625,3,[AKNewb]Twiner,2406,504,20,19,39,51.3%,29m
32625,3,[SHCrew]Luxes,2406,358,15,13,28,53.6%,19m
32625,3,Angeblow,2406,288,10,5,15,66.7%,2h
32625,3,[PobSC]latineltunas,2406,245,9,2,11,81.8%,2h
32625,3,LightWolf,2406,223,7,4,11,63.6%,50m
32625,2,Azgul,2406,0,5,2,7,71.4%,1h
32625,3,Arphios,2406,141,5,5,10,50.0%,2h
32625,3,JARDINEIRO,2406,30,5,6,11,45.5%,33m
32625,3,ProbingTime,2406,164,4,3,7,57.1%,2h
32625,1,Lemonade,2406,30,4,7,11,36.4%,1h
32625,3,SpreadRed,2406,74,4,7,11,36.4%,2h
32625,3,alberta,2406,86,3,5,8,37.5%,14m
32625,1,Yoxr,2406,48,2,3,5,40.0%,3h
32625,3,bastet,2406,60,2,3,5,40.0%,2h
32625,2,MOTS,2406,95,2,3,5,40.0%,2h
32625,3,MiMarido,2406,94,2,4,6,33.3%,43m
32625,1,lucidxeye,2406,0,2,4,6,33.3%,46m
32625,2,CoGbubbles,2406,0,2,4,6,33.3%,2h
32625,3,[GGdogs]Postre,2406,50,2,5,7,28.6%,31m
32625,1,TuéTué,2406,95,2,5,7,28.6%,36m
32625,1,Primigenia,2406,48,2,6,8,25.0%,39m
32625,3,[Nat20s]TVE,2406,121,2,6,8,25.0%,2h
32625,3,[DANKEM]Cæsarius,2406,0,1,0,1,100.0%,1h
32625,2,nlists,2406,0,1,0,1,100.0%,36m
32625,3,Kilope,2406,0,1,1,2,50.0%,2h
32625,3,ZAMBULA,2406,0,1,4,5,20.0%,42m
32625,1,raptor,2406,0,1,4,5,20.0%,2h
32625,3,ErickDM,2406,30,1,6,7,14.3%,31m
32625,3,wAlucardw,2406,0,0,1,1,0.0%,28m
32625,3,Shadows,2406,0,0,1,1,0.0%,2h
32625,1,Striker,2406,0,0,6,6,0.0%,46m
32667,1,OGsan,2405,1588,199,201,400,49.8%,2h
32667,2,[LMI42]DaBoss,2405,1248,126,132,258,48.8%,2h
32667,2,rizzo,2405,891,60,52,112,53.6%,3h
32667,3,FozFyt,2405,1422,57,51,108,52.8%,5m
32667,1,Hollywood,2405,1373,54,60,114,47.4%,16m
32667,1,Dvious,2405,925,49,52,101,48.5%,2h
32667,3,Pyro,2405,578,43,39,82,52.4%,40m
32667,3,pazzz,2405,808,33,32,65,50.8%,2h
32667,3,Wizzour,2405,560,30,31,61,49.2%,25m
32667,3,Kaladin,2405,600,24,16,40,60.0%,1h
32667,3,stu,2405,464,22,8,30,73.3%,3h
32667,3,LittleFat,2405,181,17,5,22,77.3%,3h
32667,3,[CRABBR]MthaFkaJones,2405,463,16,16,32,50.0%,14m
32667,2,Black,2405,307,15,18,33,45.5%,47m
32667,3,CommandoBdog,2405,372,14,14,28,50.0%,2h
32667,2,[NPMM]AkMystery,2405,199,14,20,34,41.2%,19m
32667,3,[OlNA]Olimpos,2405,355,13,9,22,59.1%,19m
32667,3,Wraith,2405,205,6,7,13,46.2%,2h
32667,3,ReadingIsFun,2405,201,6,10,16,37.5%,2h
32667,1,Teallbugs,2405,171,6,12,18,33.3%,2h
32667,1,anonimoxd,2405,88,5,4,9,55.6%,2h
32667,3,[michel]cheezweed,2405,194,5,5,10,50.0%,2h
32667,3,Rynondar,2405,167,4,6,10,40.0%,2h
32667,2,Bossu,2405,46,4,8,12,33.3%,2h
32667,3,[MªnCºs]HHMM,2405,60,3,3,6,50.0%,43m
32667,3,[jeje]THEMASTER,2405,142,3,3,6,50.0%,2h
32667,3,Pkto,2405,36,3,5,8,37.5%,25m
32667,1,jsong,2405,88,3,6,9,33.3%,16m
32667,3,david,2405,139,3,7,10,30.0%,8m
32667,3,YonArias,2405,0,3,7,10,30.0%,19m
32667,3,[DSFTWA]TheGodfather,2405,0,1,0,1,100.0%,30m
32667,3,[AHHH]inkytheghost,2405,30,1,2,3,33.3%,1h
32667,3,SupSup,2405,0,1,4,5,20.0%,36m
32667,2,MindofMimir,2405,0,1,5,6,16.7%,2h
32667,3,KujoForTwnty,2405,0,0,2,2,0.0%,43m
32667,3,Kraken,2405,0,0,2,2,0.0%,1h
32703,3,Yankees,2404,1550,577,596,1173,49.2%,6m
32703,1,Raphael,2404,1505,173,177,350,49.4%,2h
32703,2,Ferghost,2404,728,84,80,164,51.2%,37m
32703,3,Lunchbox,2404,1529,76,53,129,58.9%,2h
32703,3,aMover,2404,1441,64,51,115,55.7%,2h
32703,1,Dopamine,2404,1402,54,59,113,47.8%,23m
32703,2,[PRI]JuanmaMB,2404,818,41,47,88,46.6%,31m
32703,3,[KoT]Zava,2404,1028,37,40,77,48.1%,26m
32703,3,Balrog,2404,612,30,36,66,45.5%,4m
32703,2,[S3XYAF]PootieTang,2404,224,12,12,24,50.0%,2h
32703,3,KillerTito,2404,270,10,10,20,50.0%,2h
32703,3,TheWarDuck,2404,228,8,6,14,57.1%,36m
32703,3,[SkAL]Manafiend,2404,122,8,13,21,38.1%,46m
32703,2,Ace,2404,120,7,12,19,36.8%,52m
32703,3,[zerg39]DXG,2404,195,6,5,11,54.5%,2h
32703,3,Xyon,2404,94,6,10,16,37.5%,4m
32703,3,[DUT1]diegox,2404,177,5,2,7,71.4%,21m
32703,3,Nickarate,2404,168,4,2,6,66.7%,21m
32703,3,[NerdTC]lilKdoggie,2404,86,4,3,7,57.1%,2h
32703,3,[EvilGC]ratx,2404,148,4,3,7,57.1%,1h
32703,3,Azatarck,2404,88,4,3,7,57.1%,50m
32703,3,sewage,2404,147,3,3,6,50.0%,42m
32703,3,dravid,2404,46,3,3,6,50.0%,1h
32703,3,TonyTone,2404,58,2,3,5,40.0%,2h
32703,3,HotRod,2404,95,2,4,6,33.3%,12m
32703,1,yyy,2404,97,2,4,6,33.3%,4m
32703,3,TomyJo,2404,0,1,0,1,100.0%,19m
32703,3,Insanity,2404,96,1,1,2,50.0%,2h
32703,3,Werm,2404,0,1,1,2,50.0%,46m
32703,2,fugughoul,2404,0,1,1,2,50.0%,2h
32703,1,Agnieszka,2404,0,1,4,5,20.0%,3h
32703,1,Viper,2404,0,0,1,1,0.0%,41m
32703,3,Jorge,2404,0,0,1,1,0.0%,2h
32703,3,[SWOU]bisbey,2404,0,0,1,1,0.0%,4m
32703,3,iyc,2404,0,0,4,4,0.0%,31m
32738,1,learner,2403,1503,773,753,1526,50.7%,8m
32738,2,RJStar,2403,1502,202,200,402,50.2%,1h
32738,1,BlkMrRogers,2403,1034,81,78,159,50.9%,2h
32738,3,wuhanjiayou,2403,952,58,49,107,54.2%,14m
32738,2,ACBLACK,2403,1216,47,51,98,48.0%,1h
32738,2,CobraFist,2403,744,25,33,58,43.1%,44m
32738,3,simichan,2403,520,20,20,40,50.0%,2h
32738,3,[AbcCo]JorgeGamer,2403,320,19,12,31,61.3%,3h
32738,3,ELSam,2403,452,18,10,28,64.3%,5m
32738,3,toditron,2403,312,12,13,25,48.0%,2h
32738,3,zebidy,2403,310,11,10,21,52.4%,2h
32738,3,SoMbRa,2403,159,9,5,14,64.3%,2h
32738,2,[Vnoobs]IXGamingXI,2403,174,8,11,19,42.1%,2h
32738,3,jerico,2403,141,6,4,10,60.0%,4m
32738,3,ChillJacket,2403,203,6,8,14,42.9%,2h
32738,2,Dragunov,2403,109,4,5,9,44.4%,1h
32738,3,Hellishero,2403,30,4,8,12,33.3%,38m
32738,3,[SL0PPY]BananaJuice,2403,122,4,9,13,30.8%,25m
32738,3,ChAoS,2403,112,3,4,7,42.9%,2h
32738,3,Arngrim,2403,96,2,5,7,28.6%,2h
32738,3,[mijin]Esthum,2403,0,2,5,7,28.6%,44m
32738,3,[Th3Bad]maua,2403,0,1,0,1,100.0%,2h
32738,3,[XIL]Carnage,2403,30,1,4,5,20.0%,2h
32738,1,Soulstorm,2403,0,1,4,5,20.0%,2h
32738,3,bobbypigaa,2403,0,1,4,5,20.0%,2h
32738,3,Tomeczek,2403,0,1,4,5,20.0%,2h
32738,3,Hades,2403,0,0,1,1,0.0%,36m
32738,3,kickstand,2403,0,0,1,1,0.0%,46m
32738,3,TerdSupreme,2403,0,0,2,2,0.0%,51m
32767,1,WarDog,2402,1122,264,281,545,48.4%,21m
32767,3,[Ayhur]RemJoan,2402,1033,71,57,128,55.5%,2h
32767,3,Angel,2402,679,50,38,88,56.8%,2h
32767,3,fraudolives,2402,1219,50,44,94,53.2%,29m
32767,2,Pebbo,2402,740,44,35,79,55.7%,2h
32767,3,[DXPCA]more,2402,676,31,14,45,68.9%,2h
32767,3,FelipeII,2402,674,29,26,55,52.7%,51m
32767,3,Lawliet,2402,338,27,26,53,50.9%,20m
32767,2,UncleJeff,2402,312,24,24,48,50.0%,51m
32767,2,lugia,2402,538,21,18,39,53.8%,2h
32767,3,Beargar,2402,400,16,10,26,61.5%,2h
32767,3,noobiz,2402,147,12,12,24,50.0%,2h
32767,3,badplayer,2402,285,10,12,22,45.5%,2h
32767,3,wolfsora,2402,290,10,16,26,38.5%,32m
32767,2,Burn,2402,255,8,12,20,40.0%,2h
32767,3,kraken,2402,222,7,5,12,58.3%,48m
32767,3,Executor,2402,171,5,6,11,45.5%,3h
32767,3,Nyi,2402,142,4,1,5,80.0%,21m
32767,3,[WAAL]Masturbazn,2402,171,4,4,8,50.0%,26m
32767,2,dinin,2402,36,2,1,3,66.7%,2h
32767,3,[Poise]Taylor,2402,30,2,2,4,50.0%,2h
32767,3,[Vtta]tadicles,2402,62,2,3,5,40.0%,1h
32767,3,[Oopsy]ZeeWes,2402,62,2,6,8,25.0%,2h
32767,3,[RedSup]Tony,2402,96,1,2,3,33.3%,2h
32767,3,Nerdatwork,2402,0,1,4,5,20.0%,35m
32767,1,zerafuls,2402,96,1,7,8,12.5%,2h
32767,3,passerby,2402,0,0,2,2,0.0%,2h
32767,3,Elements,2402,0,0,3,3,0.0%,46m
32795,1,[Pyr3s]Studley,2401,1243,123,125,248,49.6%,35m
32795,3,WOJTEK,2401,1566,117,117,234,50.0%,2h
32795,3,MethodInvoke,2401,1647,112,101,213,52.6%,50m
32795,3,FindingMyslf,2401,745,91,85,176,51.7%,2h
32795,3,AnGGELLo,2401,1009,76,77,153,49.7%,3h
32795,3,[FyHr]IronIc,2401,652,25,20,45,55.6%,50m
32795,3,[XANNY]BigSmoke,2401,525,24,9,33,72.7%,2h
32795,3,uncleDumDum,2401,583,21,19,40,52.5%,2h
32795,3,Gammawatt,2401,220,10,5,15,66.7%,2h
32795,1,Robinwongg,2401,219,10,8,18,55.6%,3h
32795,2,Vankisher,2401,266,10,9,19,52.6%,2h
32795,3,[SCROT]saltydog,2401,251,9,9,18,50.0%,37m
32795,2,Ripley,2401,310,9,12,21,42.9%,2h
32795,3,sherminatorr,2401,234,8,5,13,61.5%,3h
32795,3,AlexeiStucov,2401,202,8,7,15,53.3%,2h
32795,2,SquishyFish,2401,182,8,8,16,50.0%,2h
32795,3,[mmKay]ARTEMIS,2401,213,6,9,15,40.0%,2h
32795,3,ChetManley,2401,97,5,4,9,55.6%,31m
32795,3,JahRockasha,2401,120,5,8,13,38.5%,35m
32795,1,JoPumbaa,2401,64,5,8,13,38.5%,2h
32795,2,JackAttack,2401,60,4,7,11,36.4%,51m
32795,2,chrisuave,2401,44,4,8,12,33.3%,2h
32795,3,[4Vic]AllAmKorean,2401,120,3,7,10,30.0%,2h
32795,3,PrimerOneQc,2401,131,3,8,11,27.3%,2h
32795,3,froodo,2401,0,2,3,5,40.0%,2h
32795,3,[OGB]YungSwagLord,2401,0,1,0,1,100.0%,15m
32795,3,Silisco,2401,95,1,1,2,50.0%,37m
32795,1,[Spoof]HEISENBERG,2401,0,1,1,2,50.0%,2h
32795,3,[HOTDAM]Kira,2401,0,1,2,3,33.3%,2h
32795,1,XxwarXx,2401,48,1,2,3,33.3%,22m
32795,3,AgentNoir,2401,0,1,4,5,20.0%,37m
32795,3,RadioSilent,2401,0,1,4,5,20.0%,29m
32795,2,edudarkes,2401,0,0,1,1,0.0%,2h
32795,3,xXLandonSVXx,2401,0,0,1,1,0.0%,29m
32795,1,PistoLs,2401,0,0,1,1,0.0%,3h
32795,3,Jmrc,2401,0,0,4,4,0.0%,2h
32831,3,coleykens,2400,1576,166,148,314,52.9%,42m
32831,3,cybertronph,2400,1523,128,140,268,47.8%,51m
32831,2,chad,2400,1163,51,58,109,46.8%,23m
32831,3,[Perma]GabbaGabbaGa,2400,757,31,29,60,51.7%,2h
32831,2,JohnyDaMylla,2400,401,20,24,44,45.5%,5m
32831,3,theguillee,2400,374,14,13,27,51.9%,4m
32831,1,[CNOB]justin,2400,414,14,25,39,35.9%,24m
32831,3,mgsmid,2400,177,6,1,7,85.7%,2h
32831,3,Killerfridge,2400,202,6,4,10,60.0%,29m
32831,3,Slick,2400,211,6,9,15,40.0%,46m
32831,3,TheProphet,2400,174,5,4,9,55.6%,28m
32831,3,Church,2400,96,4,3,7,57.1%,50m
32831,3,Ahj,2400,116,3,1,4,75.0%,2h
32831,3,[EPGS]pultMANG,2400,64,3,2,5,60.0%,2h
32831,3,aLovedHater,2400,30,3,4,7,42.9%,2h
32831,2,[xXGDXx]thesteban,2400,116,3,5,8,37.5%,24m
32831,3,Fernando,2400,86,3,6,9,33.3%,2h
32831,3,[WeGoon]hiig,2400,0,1,0,1,100.0%,2h
32831,3,[Vtta]NIEHLK,2400,0,1,1,2,50.0%,31m
32831,1,Gustavus,2400,0,0,1,1,0.0%,2h
32831,1,CasaMax,2400,0,0,1,1,0.0%,49m
32831,2,Snocone,2400,0,0,3,3,0.0%,2h
32831,3,[HdV22]nemesis,2400,0,0,5,5,0.0%,2h
32854,3,bjj,2399,1412,72,61,133,54.1%,2h
32854,3,[Pgna]ArtVandeley,2399,635,71,65,136,52.2%,2h
32854,1,khoatong,2399,1138,40,35,75,53.3%,2h
32854,1,[Exper]ghostofevil,2399,605,38,44,82,46.3%,2h
32854,2,Chey,2399,936,35,39,74,47.3%,15m
32854,3,MAQUIAVEL,2399,664,27,27,54,50.0%,4m
32854,1,glhf,2399,750,27,54,81,33.3%,6m
32854,3,vol,2399,253,23,20,43,53.5%,2h
32854,1,RayMaster,2399,501,20,0,20,100.0%,2h
32854,3,Dagrooms,2399,455,17,20,37,45.9%,1h
32854,2,EDD,2399,352,16,13,29,55.2%,2h
32854,3,jamjest,2399,388,15,14,29,51.7%,2h
32854,3,PlanB,2399,282,8,8,16,50.0%,2h
32854,3,Testi,2399,190,6,3,9,66.7%,28m
32854,1,blop,2399,160,6,5,11,54.5%,3h
32854,2,Alaskna,2399,156,5,12,17,29.4%,45m
32854,1,PinguCrushes,2399,130,4,2,6,66.7%,2h
32854,3,tiocosa,2399,122,4,8,12,33.3%,40m
32854,3,Mitch,2399,66,3,3,6,50.0%,2h
32854,2,peterwashere,2399,132,3,4,7,42.9%,24m
32854,3,[Newbi3]Arkahas,2399,60,3,5,8,37.5%,42m
32854,3,WizardLog,2399,30,2,1,3,66.7%,2h
32854,1,Xavier,2399,130,2,5,7,28.6%,3h
32854,3,[YoIo]Esaspaul,2399,0,2,5,7,28.6%,2h
32854,3,xFrOzEnUs,2399,30,2,5,7,28.6%,2h
32854,2,MAYCOL,2399,30,2,8,10,20.0%,2h
32854,3,[DaFo]Aionz,2399,0,1,0,1,100.0%,36m
32854,3,WoOdPuShEr,2399,0,1,2,3,33.3%,19m
32854,1,Darksun,2399,0,1,4,5,20.0%,7m
32854,1,Annihilator,2399,0,1,4,5,20.0%,2h
32854,1,BadWolf,2399,0,0,1,1,0.0%,21m
32854,1,timto,2399,0,0,1,1,0.0%,2h
32854,1,Ritm,2399,0,0,1,1,0.0%,2h
32854,1,SirTurtles,2399,0,0,1,1,0.0%,3h
32854,3,Matthew,2399,0,0,2,2,0.0%,2h
32889,2,[std69]Gollithor,2398,1377,123,117,240,51.2%,19m
32889,3,StinkJake,2398,990,41,37,78,52.6%,20m
32889,3,[RknStn]WeirdoDeardo,2398,562,34,18,52,65.4%,12m
32889,1,pChowski,2398,850,33,38,71,46.5%,21m
32889,3,[RUMB]Marcus,2398,738,31,24,55,56.4%,14m
32889,3,nashetee,2398,448,19,17,36,52.8%,1h
32889,3,MorbiLudio,2398,341,13,10,23,56.5%,34m
32889,3,megatruong,2398,195,7,7,14,50.0%,2h
32889,1,Azure,2398,176,6,14,20,30.0%,21m
32889,1,Cheesus,2398,214,5,2,7,71.4%,2h
32889,3,[Pirobo]Mayher,2398,143,4,1,5,80.0%,28m
32889,3,[AOrder]viper,2398,144,4,2,6,66.7%,48m
32889,3,RasAlGhul,2398,94,4,6,10,40.0%,51m
32889,1,Brenda,2398,130,3,1,4,75.0%,2h
32889,3,[HeoAL]Atlante,2398,30,2,1,3,66.7%,2h
32889,3,Aderlas,2398,0,2,5,7,28.6%,2h
32889,2,DarkKnight,2398,30,2,8,10,20.0%,19m
32889,1,LazyTitan,2398,0,1,0,1,100.0%,2h
32889,1,ALSC,2398,0,1,0,1,100.0%,2h
32889,3,[oRuRo]ERICKSON,2398,30,1,2,3,33.3%,2h
32889,1,[RS6]Windersan,2398,0,1,3,4,25.0%,1h
32889,3,Kaelthalaz,2398,30,1,3,4,25.0%,4m
32889,1,DirtyDiesel,2398,0,1,4,5,20.0%,2h
32889,1,JonSnow,2398,0,1,4,5,20.0%,43m
32889,1,[Rataz]Tiranus,2398,0,1,4,5,20.0%,22m
32889,3,HornyHealer,2398,0,1,5,6,16.7%,11m
32889,1,[TnKn]graphmar,2398,0,0,1,1,0.0%,2h
32889,1,SimmieG,2398,0,0,1,1,0.0%,2h
32889,1,LUTZ,2398,0,0,1,1,0.0%,2h
32889,1,Yellowb,2398,0,0,1,1,0.0%,41m
32919,2,Hanibaleater,2397,1532,191,185,376,50.8%,46m
32919,3,Pelantaru,2397,1534,83,73,156,53.2%,51m
32919,3,LaRopa,2397,430,63,55,118,53.4%,42m
32919,2,[JACPAR]FARAJ,2397,1091,45,46,91,49.5%,2h
32919,3,thanared,2397,568,43,40,83,51.8%,2h
32919,2,Tickles,2397,895,36,38,74,48.6%,2h
32919,1,WhyLordWhy,2397,846,29,23,52,55.8%,12m
32919,3,Thelerk,2397,438,27,32,59,45.8%,2h
32919,3,[RAX14]XxReimsSC,2397,679,25,23,48,52.1%,31m
32919,3,ReyOfLight,2397,381,19,11,30,63.3%,2h
32919,3,[1NTAMA]yusepe,2397,296,11,6,17,64.7%,40m
32919,3,RiKcYK,2397,279,8,10,18,44.4%,26m
32919,2,Grewi,2397,202,7,9,16,43.8%,36m
32919,1,Broski,2397,222,6,9,15,40.0%,37m
32919,2,jmgzch,2397,142,4,8,12,33.3%,21m
32919,3,FinnLockwood,2397,30,3,5,8,37.5%,22m
32919,1,RPalmzy,2397,42,2,4,6,33.3%,2h
32919,1,DOOM,2397,48,2,5,7,28.6%,2h
32919,1,joe,2397,0,1,0,1,100.0%,2h
32919,3,DonnieNarko,2397,30,1,2,3,33.3%,2h
32919,1,Reckvus,2397,0,1,4,5,20.0%,2h
32919,1,[DGwynB]akilommar,2397,0,0,1,1,0.0%,2h
32919,1,Alejandro,2397,0,0,1,1,0.0%,1h
32919,3,Latteforlife,2397,0,0,2,2,0.0%,2h
32943,1,Sharknado,2396,1603,766,773,1539,49.8%,40m
32943,2,[XpKAc]RASEB,2396,1029,128,122,250,51.2%,2h
32943,1,MrSnappy,2396,1483,114,105,219,52.1%,2h
32943,1,TokaioGKM,2396,1499,104,111,215,48.4%,1h
32943,3,Kozac,2396,1505,61,54,115,53.0%,26m
32943,3,stritlybinis,2396,960,54,52,106,50.9%,27m
32943,3,[AUSMAN]cheeseman,2396,705,54,60,114,47.4%,40m
32943,2,Winihutjr,2396,880,35,31,66,53.0%,6m
32943,3,Rupicols,2396,637,27,17,44,61.4%,37m
32943,3,[RawBBC]Mittens,2396,659,27,29,56,48.2%,2h
32943,1,Meeqs,2396,464,20,7,27,74.1%,3h
32943,2,enrrique,2396,502,20,19,39,51.3%,2h
32943,3,Caspurr,2396,489,18,26,44,40.9%,40m
32943,3,[N1nj9S]war,2396,466,15,17,32,46.9%,1h
32943,1,Edimaker,2396,502,13,9,22,59.1%,3h
32943,3,[AUDI]chillydog,2396,384,13,15,28,46.4%,14m
32943,3,Khas,2396,203,10,10,20,50.0%,12m
32943,3,Phantros,2396,116,8,5,13,61.5%,49m
32943,3,[PSTRAT]GoldCaesar,2396,114,7,6,13,53.8%,2h
32943,2,RidleyRanger,2396,226,6,13,19,31.6%,2h
32943,1,StealthyE,2396,34,2,0,2,100.0%,43m
32943,1,[x98]SevenOfNine,2396,0,2,4,6,33.3%,2h
32943,1,Eduardo,2396,97,2,4,6,33.3%,8m
32943,1,Aaron,2396,30,2,10,12,16.7%,2h
32943,1,destruptor,2396,0,1,0,1,100.0%,16m
32943,1,Ozzy,2396,0,1,0,1,100.0%,27m
32943,3,Kuso,2396,0,1,1,2,50.0%,2h
32943,3,[SCK3]ThEOffSpRlNG,2396,0,1,1,2,50.0%,28m
32943,3,Endbringer,2396,30,1,4,5,20.0%,2h
32943,2,zZlactroiZz,2396,40,1,5,6,16.7%,2h
32973,3,[QBALL]Houndz,2395,1589,114,108,222,51.4%,2h
32973,3,YeetMachine,2395,1176,104,92,196,53.1%,2h
32973,3,[FFAA]Toffee,2395,951,42,26,68,61.8%,25m
32973,3,[AnUB]CIRILOPAWER,2395,438,22,10,32,68.8%,36m
32973,2,DRoyalArmy,2395,579,22,28,50,44.0%,33m
32973,3,[SkAL]Ozlord,2395,416,17,17,34,50.0%,31m
32973,2,Nonsense,2395,406,17,18,35,48.6%,2h
32973,3,ImSingle,2395,321,12,12,24,50.0%,1h
32973,3,[PL347]QuBuS,2395,269,11,6,17,64.7%,2h
32973,3,rene,2395,179,8,10,18,44.4%,35m
32973,3,vakita,2395,174,7,7,14,50.0%,31m
32973,3,[AbcCo]Nicolass,2395,144,5,8,13,38.5%,3h
32973,1,[jajas]JHOKAN,2395,88,3,0,3,100.0%,1h
32973,3,XColshiX,2395,143,3,2,5,60.0%,45m
32973,1,jadgamester,2395,36,3,7,10,30.0%,36m
32973,1,JOSEKRLO,2395,46,2,1,3,66.7%,2h
32973,1,[PZTT]Ghost,2395,0,2,3,5,40.0%,29m
32973,1,DEADMACHINE,2395,0,1,1,2,50.0%,2h
32973,3,Apache,2395,0,1,1,2,50.0%,11m
32973,1,RaiZor,2395,0,0,1,1,0.0%,3h
32973,1,shadowAQP,2395,0,0,1,1,0.0%,1h
32973,1,xXMADRIDXx,2395,0,0,3,3,0.0%,3h
32973,1,bsxs,2395,0,0,3,3,0.0%,2h
32996,2,Malphador,2394,1353,213,206,419,50.8%,5m
32996,3,WarLard,2394,1631,154,150,304,50.7%,16m
32996,1,[2tits]KevZilla,2394,1549,80,91,171,46.8%,16m
32996,3,PichuloskY,2394,1625,75,71,146,51.4%,2h
32996,3,Aarrows,2394,656,31,28,59,52.5%,2h
32996,3,OmnNoMBomB,2394,659,28,19,47,59.6%,2h
32996,3,[AFLOZE]ZEST,2394,690,25,29,54,46.3%,2h
32996,2,Sickspinda,2394,432,23,19,42,54.8%,1h
32996,3,[fancyb]FancyBoi,2394,486,21,19,40,52.5%,15m
32996,3,[TY4GG]BlessedG,2394,447,17,12,29,58.6%,2h
32996,3,TrumpFanMAGA,2394,312,13,10,23,56.5%,2h
32996,1,Ithaka,2394,441,13,14,27,48.1%,2h
32996,3,maliwanag,2394,276,12,14,26,46.2%,2h
32996,3,Croesus,2394,342,11,13,24,45.8%,2h
32996,3,BattlePants,2394,268,10,5,15,66.7%,31m
32996,1,MasterDeluxe,2394,318,9,0,9,100.0%,39m
32996,3,gustavo,2394,258,9,12,21,42.9%,2h
32996,3,[OAFAF]ViChO,2394,218,8,8,16,50.0%,11m
32996,1,hiro,2394,186,7,12,19,36.8%,37m
32996,3,[H2]Vazagho,2394,176,6,8,14,42.9%,12m
32996,3,CnelSheppard,2394,177,4,3,7,57.1%,2h
32996,3,spacecowboy,2394,149,4,3,7,57.1%,4m
32996,1,RekiAr,2394,169,4,7,11,36.4%,1h
32996,3,Bazum,2394,0,1,1,2,50.0%,2h
32996,1,Jlarge,2394,0,1,4,5,20.0%,26m
32996,1,FloppyMcNuts,2394,0,1,4,5,20.0%,44m
32996,1,zergforever,2394,0,0,1,1,0.0%,21m
33023,3,Jooply,2393,1434,89,80,169,52.7%,35m
33023,2,jimmyjimjam,2393,1449,67,63,130,51.5%,33m
33023,2,fetwoplus,2393,1376,62,62,124,50.0%,46m
33023,3,[126]snopon,2393,456,47,41,88,53.4%,1h
33023,2,Rashielf,2393,1101,45,41,86,52.3%,7m
33023,2,CanSerberO,2393,990,43,41,84,51.2%,17m
33023,2,ergo,2393,798,38,37,75,50.7%,2h
33023,2,DarkMaster,2393,740,28,27,55,50.9%,2h
33023,3,SnickersII,2393,458,19,10,29,65.5%,44m
33023,3,matheusmt,2393,435,18,18,36,50.0%,2h
33023,1,PandaStorm,2393,353,11,20,31,35.5%,2h
33023,3,[LBanda]Cris,2393,287,10,7,17,58.8%,2h
33023,2,idacrap,2393,193,7,9,16,43.8%,12m
33023,3,jauryelmalo,2393,227,6,7,13,46.2%,4m
33023,3,joesmith,2393,170,6,7,13,46.2%,2h
33023,1,IGD,2393,176,5,1,6,83.3%,2h
33023,3,Betelgeuse,2393,171,4,5,9,44.4%,3h
33023,2,Daybreaker,2393,207,4,9,13,30.8%,2h
33023,1,KRIS,2393,84,3,6,9,33.3%,2h
33023,3,Kymry,2393,30,3,9,12,25.0%,31m
33023,3,[salvo]devilhand,2393,96,2,1,3,66.7%,2h
33023,1,Violett,2393,104,2,1,3,66.7%,3h
33023,1,Emprorpinapl,2393,0,2,3,5,40.0%,29m
33023,1,Exoskull,2393,48,2,4,6,33.3%,2h
33023,1,[sLuxx]Joon,2393,42,1,1,2,50.0%,1h
33023,1,Ranfrell,2393,0,1,3,4,25.0%,5m
33023,1,ALEXANDER,2393,0,1,4,5,20.0%,3h
33023,1,Thuguto,2393,0,1,4,5,20.0%,2h
33023,1,[BBR]RAPHAEL,2393,0,0,1,1,0.0%,1h
33023,1,[LoliMF]Jigax,2393,0,0,1,1,0.0%,2h
33023,1,DDeSCLanes,2393,0,0,1,1,0.0%,2h
33023,3,Asda,2393,0,0,2,2,0.0%,2h
33055,1,artur,2392,1399,229,230,459,49.9%,2h
33055,1,[NM8]redrum,2392,1563,144,161,305,47.2%,2h
33055,1,Formic,2392,1186,53,61,114,46.5%,2h
33055,3,[Carb]Babushka,2392,1231,51,42,93,54.8%,2h
33055,2,Bdangles,2392,572,32,44,76,42.1%,37m
33055,2,SockGiant,2392,534,20,23,43,46.5%,2h
33055,2,[SLDSNK]devonthedude,2392,488,19,23,42,45.2%,35m
33055,3,deathfiend,2392,412,14,18,32,43.8%,36m
33055,2,Tovarisch,2392,276,10,20,30,33.3%,3h
33055,3,Solagnas,2392,202,6,8,14,42.9%,32m
33055,1,Tonks,2392,208,5,1,6,83.3%,37m
33055,3,DukeAndy,2392,30,5,3,8,62.5%,2h
33055,3,[2UPs]REDRUM,2392,152,5,7,12,41.7%,30m
33055,3,TriL,2392,120,5,8,13,38.5%,2h
33055,1,[DETER]Kasuno,2392,227,4,4,8,50.0%,49m
33055,1,SCV,2392,0,2,4,6,33.3%,2h
33055,3,Yobosaeyo,2392,0,2,4,6,33.3%,36m
33055,1,Norden,2392,0,1,4,5,20.0%,44m
33055,1,[DoRQ]RionSnow,2392,0,0,5,5,0.0%,3h
33055,1,Juggernaught,2392,0,0,5,5,0.0%,2h
33075,1,Baker,2391,1251,59,61,120,49.2%,18m
33075,3,bleedart,2391,405,37,29,66,56.1%,20m
33075,2,NinjaJedi,2391,666,34,29,63,54.0%,2h
33075,3,baba,2391,556,33,35,68,48.5%,1h
33075,3,Dammaverick,2391,708,27,27,54,50.0%,2h
33075,2,Imakillu,2391,403,22,27,49,44.9%,2h
33075,3,dogfish,2391,524,19,24,43,44.2%,1h
33075,3,[DXPCA]XxBasilisxX,2391,419,15,13,28,53.6%,2h
33075,3,DeadHunter,2391,368,13,10,23,56.5%,3h
33075,1,tan,2391,409,13,23,36,36.1%,2h
33075,3,SneakyTurtle,2391,235,8,3,11,72.7%,1h
33075,3,Mordecai,2391,236,8,11,19,42.1%,1h
33075,3,supreme,2391,245,8,13,21,38.1%,2h
33075,3,JokerJ,2391,180,5,2,7,71.4%,29m
33075,1,Cassidy,2391,0,3,3,6,50.0%,2h
33075,1,Grypus,2391,118,3,5,8,37.5%,23m
33075,2,pwndy,2391,46,3,8,11,27.3%,1h
33075,1,[3333]ThatsSoRaven,2391,97,2,2,4,50.0%,2h
33075,3,kevezfx,2391,30,2,4,6,33.3%,46m
33075,2,logyko,2391,88,2,6,8,25.0%,34m
33075,2,CorbinRay,2391,0,1,0,1,100.0%,28m
33075,1,Kirito,2391,0,1,0,1,100.0%,3h
33075,1,aweonaonico,2391,0,1,4,5,20.0%,40m
33075,3,KrasHDaiX,2391,0,0,1,1,0.0%,2h
33075,3,Alexandr,2391,0,0,2,2,0.0%,21m
33100,3,deathbringer,2390,1511,343,336,679,50.5%,12m
33100,3,[SWOU]spartanops,2390,863,54,41,95,56.8%,3h
33100,3,harley,2390,1154,51,47,98,52.0%,2h
33100,3,Agecraft,2390,1051,50,54,104,48.1%,49m
33100,3,[DryHop]ISMADARLING,2390,724,28,24,52,53.8%,2h
33100,3,[Larvax]Maquina,2390,431,20,23,43,46.5%,3h
33100,1,Dizzy,2390,619,19,30,49,38.8%,2h
33100,2,Frijolito,2390,436,18,19,37,48.6%,19m
33100,1,[CJT]Lody,2390,158,9,9,18,50.0%,36m
33100,1,leviathan,2390,186,7,11,18,38.9%,2h
33100,3,jimmy,2390,118,5,5,10,50.0%,2h
33100,2,yerbs,2390,42,5,8,13,38.5%,2h
33100,1,Dancraft,2390,88,3,2,5,60.0%,2h
33100,2,[mustaf]protosusalad,2390,116,3,7,10,30.0%,3h
33100,1,DOOMETALYSK,2390,0,2,4,6,33.3%,2h
33100,1,Globehopper,2390,48,2,5,7,28.6%,48m
33100,1,LtDan,2390,48,2,5,7,28.6%,2h
33100,1,[TETR]killaguy,2390,0,1,1,2,50.0%,2h
33100,1,Muffle,2390,46,1,2,3,33.3%,43m
33100,1,Jackdaniel,2390,0,1,4,5,20.0%,2h
33100,1,Cackus,2390,0,1,4,5,20.0%,2h
33100,1,Exterminator,2390,0,1,4,5,20.0%,2h
33100,1,VIPERJ,2390,0,0,1,1,0.0%,2h
33100,2,VelvetViper,2390,0,0,1,1,0.0%,2h
33100,1,mrvulturi,2390,0,0,1,1,0.0%,47m
33125,2,hasudrone,2389,1490,62,67,129,48.1%,48m
33125,3,JasonJinX,2389,911,61,49,110,55.5%,36m
33125,2,MACNTAKE,2389,957,43,33,76,56.6%,34m
33125,3,blank,2389,910,38,31,69,55.1%,36m
33125,3,benji,2389,655,31,26,57,54.4%,3h
33125,3,wombatvilage,2389,630,24,28,52,46.2%,2h
33125,3,Blinded,2389,421,16,21,37,43.2%,29m
33125,3,Gobelet,2389,499,15,31,46,32.6%,10m
33125,1,badass,2389,282,11,14,25,44.0%,2h
33125,3,SamXtreme,2389,234,8,4,12,66.7%,14m
33125,2,Paul,2389,202,8,15,23,34.8%,31m
33125,3,Maruhachi,2389,188,7,7,14,50.0%,1h
33125,3,SilentDeath,2389,174,7,11,18,38.9%,45m
33125,3,Jeffry,2389,169,5,8,13,38.5%,2h
33125,3,Clavo,2389,143,4,2,6,66.7%,3h
33125,1,warslv,2389,166,4,3,7,57.1%,3m
33125,2,alx,2389,144,4,9,13,30.8%,2h
33125,1,McVillaLobos,2389,96,3,7,10,30.0%,12m
33125,1,AgentK,2389,0,3,9,12,25.0%,41m
33125,1,kajev,2389,0,2,3,5,40.0%,23m
33125,3,GergtheGreat,2389,30,2,4,6,33.3%,15m
33125,3,[JUGOS]Ozzymandyas,2389,30,2,5,7,28.6%,2h
33125,1,TheBorsalino,2389,0,1,0,1,100.0%,16m
33125,1,Pabztoss,2389,0,1,3,4,25.0%,2h
33125,1,Chickamunk,2389,0,1,4,5,20.0%,3h
33125,1,Tosylate,2389,0,1,4,5,20.0%,14m
33125,1,Spartacus,2389,0,1,4,5,20.0%,2h
33125,1,FunkyMonkey,2389,0,1,5,6,16.7%,7m
33125,1,[CGLAN]tian,2389,0,0,1,1,0.0%,1h
33125,1,TheVeno,2389,0,0,1,1,0.0%,2h
33125,1,[COKEup]FreedomCast,2389,73,0,2,2,0.0%,3h
33125,2,Silhouetic,2389,0,0,2,2,0.0%,2h
33157,1,JCSuperstar,2388,1375,784,788,1572,49.9%,16m
33157,3,Dauntith,2388,1403,182,179,361,50.4%,31m
33157,3,[HØST]guilherme,2388,1593,92,94,186,49.5%,49m
33157,3,[XpKAc]JorgeRPV,2388,1293,62,71,133,46.6%,31m
33157,3,ptyred,2388,1038,47,38,85,55.3%,8m
33157,3,Mike,2388,852,44,44,88,50.0%,2h
33157,2,[TTRT]BDT,2388,983,39,39,78,50.0%,2h
33157,3,Aayuiasesino,2388,546,24,17,41,58.5%,2h
33157,2,Sharax,2388,508,23,21,44,52.3%,2h
33157,3,Jerd,2388,501,20,20,40,50.0%,2h
33157,2,wisthons,2388,427,17,22,39,43.6%,2h
33157,3,akirakato,2388,433,15,15,30,50.0%,2h
33157,1,apocal,2388,283,12,12,24,50.0%,2h
33157,2,StarLord,2388,166,9,8,17,52.9%,2h
33157,3,ThisbeKline,2388,202,8,7,15,53.3%,30m
33157,3,[CeHood]INTOTHEMAW,2388,280,8,14,22,36.4%,35m
33157,3,ELPERROPUCHY,2388,200,7,9,16,43.8%,31m
33157,1,Albi,2388,233,6,4,10,60.0%,10m
33157,1,Teramin,2388,178,5,3,8,62.5%,5m
33157,3,Probezilla,2388,140,4,2,6,66.7%,2h
33157,1,kix,2388,129,3,3,6,50.0%,3h
33157,3,IWantoBeliev,2388,123,2,2,4,50.0%,1h
33157,1,MaGeBaN,2388,0,1,0,1,100.0%,1h
33157,3,MadVolf,2388,0,1,1,2,50.0%,48m
33157,1,[DNKCFT]ZepZepZep,2388,0,1,4,5,20.0%,40m
33157,1,PhilMcGlackn,2388,0,0,1,1,0.0%,2h
33157,3,Terline,2388,0,0,2,2,0.0%,38m
33157,3,blodycottn,2388,0,0,2,2,0.0%,8m
33185,3,Amon,2387,1190,719,719,1438,50.0%,14m
33185,1,SavageOpress,2387,1553,106,111,217,48.8%,2h
33185,1,[FTLT]angelo,2387,994,53,60,113,46.9%,2h
33185,3,Dezanis,2387,1060,53,62,115,46.1%,29m
33185,3,lodi,2387,1230,50,50,100,50.0%,19m
33185,3,Yolorc,2387,523,22,22,44,50.0%,31m
33185,1,Adep,2387,520,19,9,28,67.9%,1h
33185,3,[josee]DonaldTrump,2387,438,18,18,36,50.0%,45m
33185,3,LightningXD,2387,368,15,12,27,55.6%,2h
33185,3,Maurinaz,2387,370,13,16,29,44.8%,46m
33185,3,Cyberdog,2387,306,10,15,25,40.0%,2h
33185,1,BlackIce,2387,226,9,13,22,40.9%,2h
33185,3,AdalantBroga,2387,270,9,14,23,39.1%,3h
33185,1,LAGNIC,2387,230,8,2,10,80.0%,34m
33185,2,Zerallamvuut,2387,166,8,11,19,42.1%,2h
33185,3,Dog,2387,202,7,4,11,63.6%,36m
33185,1,Danny,2387,214,7,13,20,35.0%,16m
33185,3,[M1N1]ThreeEyeDuck,2387,144,6,8,14,42.9%,2h
33185,2,[DInf]Crack,2387,185,5,6,11,45.5%,33m
33185,3,defo,2387,190,5,6,11,45.5%,39m
33185,3,Atreides,2387,137,4,5,9,44.4%,46m
33185,1,swiss,2387,88,3,0,3,100.0%,52m
33185,1,JATAMA,2387,134,3,1,4,75.0%,44m
33185,3,[Re4Ze]Gatongo,2387,40,3,7,10,30.0%,2h
33185,3,Tehobit,2387,30,3,7,10,30.0%,2h
33185,3,Mora,2387,30,2,2,4,50.0%,2h
33185,1,nick,2387,48,2,3,5,40.0%,23m
33185,1,Protosopic,2387,0,2,3,5,40.0%,2h
33185,1,Wraith,2387,48,2,5,7,28.6%,15m
33185,1,[WZLN]DrMopper,2387,97,2,5,7,28.6%,3h
33185,3,ANT,2387,0,2,5,7,28.6%,2h
33185,3,CHICKEN,2387,62,2,5,7,28.6%,2h
33185,2,[KoneOP]Konecthor,2387,0,1,0,1,100.0%,2h
33185,1,[R3Ds]REdDeViL,2387,0,1,0,1,100.0%,2h
33185,1,Black,2387,91,1,1,2,50.0%,52m
33185,3,[NYTRAM]Nytram,2387,30,1,4,5,20.0%,20m
33185,3,Majnun,2387,0,0,2,2,0.0%,2h
33185,1,TaLGhost,2387,0,0,2,2,0.0%,48m
33185,3,junior,2387,0,0,5,5,0.0%,51m
33224,3,PROTHORMAN,2386,1611,164,164,328,50.0%,50m
33224,2,atree,2386,410,49,50,99,49.5%,2h
33224,2,DrGekko,2386,564,22,25,47,46.8%,23m
33224,1,Dangelo,2386,597,21,24,45,46.7%,2h
33224,2,kingsingh,2386,395,16,21,37,43.2%,3h
33224,3,witch,2386,332,13,15,28,46.4%,37m
33224,1,Mahonry,2386,420,12,3,15,80.0%,2h
33224,2,Deto,2386,208,8,13,21,38.1%,2h
33224,1,MyndWlkr,2386,294,7,9,16,43.8%,32m
33224,3,coawhite,2386,141,6,9,15,40.0%,47m
33224,2,Crunchpoint,2386,119,6,10,16,37.5%,2h
33224,3,[35of35]Spindle,2386,30,5,6,11,45.5%,52m
33224,3,marcus,2386,150,5,7,12,41.7%,2h
33224,3,VArDarkSepu,2386,170,5,7,12,41.7%,37m
33224,1,[400s]Project,2386,48,4,3,7,57.1%,45m
33224,3,CrazyRocket,2386,151,4,3,7,57.1%,11m
33224,3,sad,2386,92,4,8,12,33.3%,36m
33224,2,AlchemyMF,2386,128,3,4,7,42.9%,2h
33224,2,CAPTAINblack,2386,146,3,9,12,25.0%,2h
33224,3,[RS69]Dudemeister,2386,30,2,4,6,33.3%,2h
33224,3,SgtStraken,2386,96,2,5,7,28.6%,36m
33224,1,HybridXIII,2386,111,2,6,8,25.0%,10m
33224,2,ScvRdy,2386,34,2,10,12,16.7%,2h
33224,3,Terius,2386,0,1,1,2,50.0%,52m
33224,1,DenSirkor,2386,0,1,1,2,50.0%,2h
33224,3,BRUMHILDA,2386,0,1,3,4,25.0%,40m
33224,1,WETxMooppy,2386,0,1,4,5,20.0%,15m
33224,3,Skyster,2386,0,0,1,1,0.0%,2h
33224,1,Firechrome,2386,0,0,1,1,0.0%,52m
33253,3,Commander,2385,1599,242,241,483,50.1%,2h
33253,2,[1Fenix]PapitoRICO,2385,671,66,62,128,51.6%,32m
33253,3,Griffin,2385,1288,64,46,110,58.2%,35m
33253,3,Whopper,2385,1031,53,45,98,54.1%,37m
33253,2,Sizzlee,2385,295,38,37,75,50.7%,2h
33253,3,[TITODO]MrCoyote,2385,815,31,27,58,53.4%,35m
33253,3,moneybags,2385,722,28,27,55,50.9%,2h
33253,2,shadow,2385,355,13,8,21,61.9%,2h
33253,1,[Raver2]WorldRaver,2385,326,12,5,17,70.6%,2h
33253,3,MaxCargo,2385,334,12,17,29,41.4%,14m
33253,3,Twidizle,2385,299,11,8,19,57.9%,46m
33253,1,Thurman,2385,122,6,5,11,54.5%,2h
33253,3,OdotheCrone,2385,184,6,9,15,40.0%,1h
33253,2,ehNuno,2385,180,5,4,9,55.6%,3h
33253,3,Death,2385,170,5,7,12,41.7%,21m
33253,3,[OADGQ]arthaz,2385,175,5,7,12,41.7%,2h
33253,3,NOVA,2385,86,4,3,7,57.1%,43m
33253,1,clauknot,2385,0,3,8,11,27.3%,32m
33253,1,[Epokhé]grosso,2385,92,2,1,3,66.7%,2h
33253,1,[LOHs]alexlim,2385,0,2,1,3,66.7%,2h
33253,3,blkbelt,2385,67,2,4,6,33.3%,42m
33253,1,Melfice,2385,0,1,0,1,100.0%,2h
33253,1,TIMMY,2385,0,1,0,1,100.0%,12m
33253,3,Bongmaster,2385,0,1,0,1,100.0%,2h
33253,1,SaVokY,2385,0,1,0,1,100.0%,35m
33253,2,[AZPK]Trucker,2385,0,1,0,1,100.0%,2h
33253,1,[TCJN]tacoman,2385,0,0,1,1,0.0%,2h
33280,1,RodoAQP,2384,1146,129,135,264,48.9%,2h
33280,1,Computer,2384,1498,56,54,110,50.9%,1h
33280,1,Sethracido,2384,750,32,22,54,59.3%,2h
33280,3,[zeita1]SOYTUCACHERO,2384,339,11,12,23,47.8%,2h
33280,3,[DRGNS]GivenToFly,2384,276,9,7,16,56.2%,1h
33280,3,ZergPower,2384,90,8,4,12,66.7%,35m
33280,2,Tommy,2384,235,7,11,18,38.9%,34m
33280,2,Sephiroth,2384,217,6,11,17,35.3%,51m
33280,1,ChristianRG,2384,220,5,2,7,71.4%,2h
33280,1,[AOSsc]Sinchijackal,2384,168,5,3,8,62.5%,2h
33280,3,Elsolapa,2384,175,4,10,14,28.6%,3h
33280,1,WildApache,2384,0,3,2,5,60.0%,2h
33280,3,ConZ,2384,148,3,3,6,50.0%,2h
33280,3,pSlycho,2384,123,3,5,8,37.5%,2h
33280,2,HeroNova,2384,95,3,7,10,30.0%,2h
33280,1,BlakcfoxCaos,2384,145,2,2,4,50.0%,15m
33280,3,Infamous,2384,30,2,4,6,33.3%,3h
33280,1,Dstrange,2384,30,2,10,12,16.7%,2h
33280,1,[sk3tch]dogsquad,2384,0,1,0,1,100.0%,43m
33280,1,taeyun,2384,0,1,0,1,100.0%,2h
33280,3,Mok,2384,0,1,2,3,33.3%,32m
33280,1,Raj,2384,0,0,1,1,0.0%,14m
33280,1,TANKSHOW,2384,0,0,1,1,0.0%,2h
33280,1,miluX,2384,0,0,2,2,0.0%,48m
33280,3,[Azteka]TEMPLARIO,2384,0,0,3,3,0.0%,2h
33280,1,Swoi,2384,0,0,5,5,0.0%,47m
33280,2,Ricardo,2384,0,0,6,6,0.0%,2h
33307,3,Xavier,2383,1476,91,93,184,49.5%,3h
33307,2,Beardo,2383,1554,84,79,163,51.5%,2h
33307,2,Wscan,2383,211,26,24,50,52.0%,2h
33307,3,Hotaki,2383,540,20,18,38,52.6%,3h
33307,3,[CH0DE]MidgetBooty,2383,466,19,17,36,52.8%,3h
33307,3,jrpascal,2383,454,18,13,31,58.1%,3h
33307,1,Matheus,2383,296,8,5,13,61.5%,2h
33307,3,Blackbriar,2383,246,7,9,16,43.8%,2h
33307,1,James,2383,218,6,5,11,54.5%,1h
33307,1,apocalysis,2383,220,5,4,9,55.6%,2h
33307,3,Kardia,2383,97,2,1,3,66.7%,2h
33307,3,mosan,2383,30,2,3,5,40.0%,35m
33307,3,[VAMPR]zanta,2383,30,2,4,6,33.3%,11m
33307,3,Kaning,2383,0,1,2,3,33.3%,3h
33307,1,cool,2383,44,1,3,4,25.0%,2h
33307,3,JhonyLeon,2383,30,1,7,8,12.5%,2h
33307,2,[isEpic]AshtonDaDuck,2383,0,0,1,1,0.0%,38m
33307,3,knightmare,2383,0,0,1,1,0.0%,2h
33307,3,[OD2019]TypeReaL,2383,0,0,2,2,0.0%,1h
33307,3,MinorityKing,2383,0,0,2,2,0.0%,3h
33307,3,NiceGuyJr,2383,0,0,3,3,0.0%,3h
33328,2,BethLoggins,2382,1127,200,196,396,50.5%,15m
33328,3,[FSID]Damos,2382,1589,74,70,144,51.4%,11m
33328,3,binho,2382,348,72,62,134,53.7%,2h
33328,3,ToeNaiL,2382,1202,46,44,90,51.1%,8m
33328,3,Floki,2382,467,43,43,86,50.0%,31m
33328,2,[xHC]Sone,2382,793,32,33,65,49.2%,2h
33328,3,PAVE,2382,669,25,22,47,53.2%,3h
33328,3,ElPalomoxD,2382,646,24,23,47,51.1%,2h
33328,1,btrog,2382,656,21,14,35,60.0%,2h
33328,3,Ghost,2382,466,20,21,41,48.8%,29m
33328,1,Thermo,2382,569,19,13,32,59.4%,16m
33328,1,iDontCareOk,2382,519,18,29,47,38.3%,2h
33328,2,jungro,2382,484,17,22,39,43.6%,2h
33328,3,TacticalCow,2382,385,14,12,26,53.8%,13m
33328,2,MooMooJuice,2382,295,11,12,23,47.8%,2h
33328,2,Shadowker,2382,265,10,10,20,50.0%,1h
33328,3,xayizu,2382,85,6,7,13,46.2%,46m
33328,1,Jose,2382,172,5,1,6,83.3%,42m
33328,1,Sterber,2382,128,3,1,4,75.0%,2h
33328,3,abc,2382,122,3,2,5,60.0%,2h
33328,1,Kacindamouf,2382,0,3,2,5,60.0%,2h
33328,3,Samrouman,2382,95,3,4,7,42.9%,2h
33328,1,jswag,2382,96,3,7,10,30.0%,48m
33328,1,Chris,2382,0,3,7,10,30.0%,1h
33328,3,[EvilGC]richie,2382,96,2,2,4,50.0%,31m
33328,3,maligator,2382,119,2,2,4,50.0%,2h
33328,1,[AOeOP]CreepBlitz,2382,97,2,2,4,50.0%,10m
33328,1,Haverix,2382,48,2,6,8,25.0%,2h
33328,1,PennyBoy,2382,0,1,0,1,100.0%,23m
33328,3,AGNTofDOOM,2382,94,1,2,3,33.3%,2h
33328,1,[Turdie]SckMyDickins,2382,0,0,1,1,0.0%,2h
33328,1,[michel]BillSmith,2382,0,0,1,1,0.0%,3h
33360,1,Gharadarn,2381,1503,113,102,215,52.6%,4m
33360,2,ShaSpd,2381,921,105,100,205,51.2%,13m
33360,3,[Macac0]belmont,2381,1270,47,51,98,48.0%,25m
33360,1,[T0ss]StarLord,2381,1142,40,52,92,43.5%,2h
33360,3,MedmanX,2381,693,28,22,50,56.0%,2h
33360,3,jhhon,2381,429,17,9,26,65.4%,2h
33360,3,jrummy,2381,344,14,14,28,50.0%,11m
33360,2,MASTERSUPLI,2381,338,13,16,29,44.8%,2h
33360,1,SpykeAK,2381,377,10,4,14,71.4%,10m
33360,3,cardenasq,2381,284,8,13,21,38.1%,1h
33360,3,Dusty,2381,92,5,8,13,38.5%,1h
33360,2,[MC40]KaveBlack,2381,124,5,11,16,31.2%,2h
33360,3,solidvhero,2381,142,4,3,7,57.1%,2h
33360,3,InNovAtiOn,2381,90,3,7,10,30.0%,1h
33360,1,Sapientem,2381,44,2,0,2,100.0%,2h
33360,1,[Pig2]Lillia,2381,0,2,3,5,40.0%,1h
33360,3,oraculo,2381,0,2,6,8,25.0%,37m
33360,1,NoNaME,2381,0,1,4,5,20.0%,2h
33360,1,icemanll,2381,0,1,4,5,20.0%,14m
33360,1,[Astute]Mago,2381,0,0,1,1,0.0%,2h
33360,1,KiraKari,2381,0,0,5,5,0.0%,2h
33381,3,mojorito,2380,1568,174,166,340,51.2%,3h
33381,2,Veterano,2380,1483,103,106,209,49.3%,2h
33381,3,Nico,2380,1184,64,54,118,54.2%,2h
33381,1,Ulfhedinn,2380,924,55,64,119,46.2%,4m
33381,1,quien,2380,1170,39,39,78,50.0%,23m
33381,3,melturBRAIN,2380,704,38,28,66,57.6%,26m
33381,3,SPOOPMASTERX,2380,656,24,27,51,47.1%,2h
33381,3,[MaxWin]tychoon,2380,452,21,13,34,61.8%,2h
33381,2,RemFox,2380,256,10,15,25,40.0%,2h
33381,2,[CRushs]SiriusCrack,2380,240,8,16,24,33.3%,33m
33381,3,Jefferson,2380,178,6,8,14,42.9%,34m
33381,1,Nutcracker,2380,168,4,2,6,66.7%,2h
33381,2,[TENO]CrazySC,2380,62,4,9,13,30.8%,44m
33381,1,Clandestine,2380,0,3,2,5,60.0%,42m
33381,3,Kietzmanc,2380,121,3,6,9,33.3%,2h
33381,2,ImBlackGG,2380,58,3,9,12,25.0%,2h
33381,1,arturito,2380,48,2,4,6,33.3%,2h
33381,2,lusciousnoob,2380,30,2,6,8,25.0%,35m
33381,3,itzMoy,2380,0,1,1,2,50.0%,29m
33381,1,Atymus,2380,48,1,2,3,33.3%,2h
33381,3,Jsnkemp,2380,0,1,3,4,25.0%,2h
33381,1,Supernova,2380,112,1,3,4,25.0%,1h
33381,3,Cade,2380,92,1,4,5,20.0%,51m
33381,1,Encanzo,2380,0,1,5,6,16.7%,2h
33381,2,[FatNlG]PhucNiGGAR,2380,30,1,9,10,10.0%,2h
33381,1,squirrel,2380,0,0,1,1,0.0%,2h
33407,2,NeoLord,2379,1535,251,252,503,49.9%,19m
33407,3,[TPGGXD]ChristianB,2379,1492,86,77,163,52.8%,51m
33407,2,Jasper,2379,1279,81,97,178,45.5%,2h
33407,3,thedude,2379,825,31,31,62,50.0%,2h
33407,3,Pancho,2379,653,30,26,56,53.6%,31m
33407,1,AlbinoRhino,2379,813,26,25,51,51.0%,2h
33407,3,Pysical,2379,684,26,26,52,50.0%,4m
33407,1,CaptainxCoCo,2379,605,22,19,41,53.7%,23m
33407,3,TheFourth,2379,468,19,19,38,50.0%,3h
33407,1,Nrfonten,2379,573,18,18,36,50.0%,2h
33407,1,OzzyValkyriE,2379,590,17,14,31,54.8%,2h
33407,3,Waverr,2379,486,17,30,47,36.2%,41m
33407,3,[OPDA]Dallo,2379,325,14,12,26,53.8%,2h
33407,3,ShOn,2379,194,7,2,9,77.8%,2h
33407,2,[SC1]jacktequila,2379,0,4,6,10,40.0%,2h
33407,3,SmoteurGoat,2379,94,4,7,11,36.4%,3h
33407,1,[GnR]Hawkmoon,2379,88,3,2,5,60.0%,2h
33407,3,XKMX,2379,0,3,6,9,33.3%,33m
33407,3,imatzel,2379,58,3,6,9,33.3%,4m
33407,3,Helya,2379,62,3,8,11,27.3%,13m
33407,2,[PiRats]Cavedog,2379,92,3,12,15,20.0%,2h
33407,1,TalitumZi,2379,0,2,3,5,40.0%,2h
33407,3,jollyrancher,2379,0,2,4,6,33.3%,11m
33407,1,MrCat,2379,0,1,0,1,100.0%,7m
33407,1,Afterburn,2379,0,1,3,4,25.0%,24m
33407,1,GORDINGIN,2379,0,1,4,5,20.0%,2h
33407,3,Emers,2379,18,1,5,6,16.7%,46m
33407,1,Ricky,2379,0,0,1,1,0.0%,16m
33435,2,[pelima]CHACHO,2378,1467,110,106,216,50.9%,2h
33435,3,RawBeef,2378,1331,54,45,99,54.5%,2h
33435,3,[sLowAf]CheeeseLouis,2378,1230,50,45,95,52.6%,1h
33435,2,Pineconehead,2378,1012,45,37,82,54.9%,1h
33435,3,Dodogama,2378,432,30,19,49,61.2%,29m
33435,3,[LMdB]ShmVrolok,2378,621,26,18,44,59.1%,36m
33435,1,Patticus,2378,540,22,23,45,48.9%,2h
33435,3,Adoy,2378,537,21,14,35,60.0%,42m
33435,3,GoldLabel,2378,490,18,22,40,45.0%,2h
33435,1,Zantiago,2378,468,17,6,23,73.9%,2h
33435,3,NocturnKilla,2378,346,12,14,26,46.2%,52m
33435,3,WinningOctoi,2378,314,11,13,24,45.8%,1h
33435,3,Saaomi,2378,266,9,11,20,45.0%,43m
33435,2,nomadic,2378,249,8,12,20,40.0%,49m
33435,3,dcfosho,2378,164,6,10,16,37.5%,44m
33435,2,opie,2378,166,5,1,6,83.3%,2h
33435,3,[PAJERO]jesuuuus,2378,187,5,5,10,50.0%,32m
33435,3,[Repahs]Tuguy,2378,92,4,5,9,44.4%,3h
33435,1,Dragon,2378,30,2,0,2,100.0%,52m
33435,3,luvReynor,2378,123,2,3,5,40.0%,25m
33435,3,Feaross,2378,30,2,5,7,28.6%,2h
33435,2,LegitBrit,2378,30,2,7,9,22.2%,17m
33435,1,lindyhopper,2378,0,1,1,2,50.0%,42m
33435,3,AquaManCo,2378,79,1,3,4,25.0%,46m
33435,1,GenDissaray,2378,0,0,1,1,0.0%,52m
33435,3,Sarpedon,2378,0,0,1,1,0.0%,2h
33435,1,TheWeaponsX,2378,0,0,2,2,0.0%,2h
33462,1,[TPGGXD]phoenix,2377,1550,899,903,1802,49.9%,6m
33462,3,Slay,2377,1576,138,126,264,52.3%,36m
33462,1,Juszczyk,2377,1476,85,84,169,50.3%,27m
33462,2,Brent,2377,1604,72,70,142,50.7%,2h
33462,3,dabl,2377,1520,65,50,115,56.5%,2h
33462,1,Quetzalcoatl,2377,956,42,35,77,54.5%,13m
33462,2,Erod,2377,896,35,39,74,47.3%,1h
33462,2,THepeRinllAA,2377,478,20,22,42,47.6%,2h
33462,2,[iDrunk]Optimus,2377,522,17,23,40,42.5%,2h
33462,1,[WECRKT]Iconophile,2377,434,17,25,42,40.5%,39m
33462,1,Sadian,2377,374,11,12,23,47.8%,2h
33462,3,LiNo,2377,275,10,6,16,62.5%,11m
33462,1,Rschacko,2377,256,6,4,10,60.0%,43m
33462,1,Eclipse,2377,166,4,2,6,66.7%,2h
33462,1,Kreutz,2377,120,4,2,6,66.7%,3h
33462,2,SkeeZeL,2377,128,4,6,10,40.0%,23m
33462,2,JaeMongRyong,2377,0,2,5,7,28.6%,18m
33462,2,Guduranis,2377,0,1,0,1,100.0%,5m
33462,3,zazie,2377,0,1,1,2,50.0%,2h
33462,1,feverlaser,2377,0,1,4,5,20.0%,2h
33462,1,RobbMack,2377,0,0,1,1,0.0%,44m
33462,1,Lambo,2377,0,0,1,1,0.0%,4m
33462,2,kowo,2377,0,0,1,1,0.0%,2h
33462,1,[NLTN]Hacker,2377,0,0,1,1,0.0%,2h
33486,1,Mixen,2376,1549,141,153,294,48.0%,2h
33486,2,GenesisP,2376,1576,108,114,222,48.6%,6m
33486,3,Swarley,2376,1043,92,86,178,51.7%,14m
33486,2,Jack,2376,1510,80,68,148,54.1%,38m
33486,2,[FromLA]Berty,2376,505,46,54,100,46.0%,11m
33486,3,NICE,2376,775,35,23,58,60.3%,36m
33486,3,bobtheslayer,2376,811,30,30,60,50.0%,1h
33486,3,SaitoRijikou,2376,803,30,31,61,49.2%,3h
33486,2,wasito,2376,388,25,32,57,43.9%,11m
33486,3,premiere,2376,263,17,22,39,43.6%,19m
33486,3,Plague,2376,376,14,26,40,35.0%,3h
33486,3,Ralxx,2376,357,13,17,30,43.3%,2h
33486,3,Sacred,2376,371,12,20,32,37.5%,31m
33486,3,Abram,2376,278,9,13,22,40.9%,20m
33486,2,[McT]Doomhammer,2376,192,8,2,10,80.0%,2h
33486,3,Chet,2376,224,8,9,17,47.1%,15m
33486,3,fiNNish,2376,196,6,5,11,54.5%,2h
33486,1,Biz,2376,216,6,6,12,50.0%,25m
33486,3,[3Drs]rObOdOg,2376,188,5,5,10,50.0%,3h
33486,3,Viper,2376,142,5,5,10,50.0%,26m
33486,1,Mavien,2376,98,5,10,15,33.3%,3h
33486,1,PiRANHA,2376,30,3,7,10,30.0%,2h
33486,3,Proteus,2376,94,3,7,10,30.0%,2h
33486,1,[KGH7]ColeMichael,2376,0,1,1,2,50.0%,2h
33486,1,Naiko,2376,46,1,3,4,25.0%,11m
33486,1,Moss,2376,0,1,4,5,20.0%,48m
33486,3,Sophistar,2376,0,1,4,5,20.0%,46m
33486,1,[catcat]TerranFNG,2376,0,0,1,1,0.0%,2h
33486,3,decapitador,2376,0,0,2,2,0.0%,2h
33486,1,dingohoarder,2376,0,0,5,5,0.0%,1h
33516,1,ULTRALISK,2375,1301,50,36,86,58.1%,35m
33516,3,[Lotr1]UrbanChronic,2375,925,36,39,75,48.0%,34m
33516,2,Badger,2375,591,34,33,67,50.7%,33m
33516,2,ZamStark,2375,340,32,31,63,50.8%,2h
33516,2,WINDWOLF,2375,539,19,25,44,43.2%,2h
33516,1,jagrjagr,2375,483,18,22,40,45.0%,5m
33516,3,Wayne,2375,381,16,18,34,47.1%,37m
33516,3,GzombieMAN,2375,331,15,16,31,48.4%,2h
33516,3,[G0BBLE]BWOODO,2375,360,12,13,25,48.0%,3h
33516,1,[Severe]StormCluster,2375,208,8,21,29,27.6%,2h
33516,1,xDurillo,2375,154,5,1,6,83.3%,2h
33516,3,DrunkCat,2375,115,3,1,4,75.0%,15m
33516,1,tylerman,2375,44,3,3,6,50.0%,6m
33516,1,[TMCsc]Jaltaro,2375,130,3,3,6,50.0%,39m
33516,3,Hyperion,2375,58,3,5,8,37.5%,19m
33516,3,Bossballoon,2375,88,3,8,11,27.3%,2h
33516,1,GameTruck,2375,46,2,0,2,100.0%,52m
33516,3,reizercris,2375,0,2,4,6,33.3%,2h
33516,3,Spellbinder,2375,0,2,5,7,28.6%,3h
33516,1,eldarion,2375,46,2,6,8,25.0%,2h
33516,2,SlicenDice,2375,132,2,6,8,25.0%,2h
33516,1,cazanova,2375,0,2,8,10,20.0%,47m
33516,1,GirlForces,2375,0,1,0,1,100.0%,2h
33516,1,FormVII,2375,40,1,1,2,50.0%,2h
33516,1,zLOsCAr,2375,42,1,2,3,33.3%,2h
33516,1,urdang,2375,42,1,2,3,33.3%,2h
33516,1,Phayzee,2375,0,1,4,5,20.0%,1h
33516,3,Awful,2375,30,1,4,5,20.0%,1h
33516,1,Mysteus,2375,0,1,4,5,20.0%,2h
33516,1,MateiT,2375,0,1,4,5,20.0%,22m
33516,2,Ghostrider,2375,96,1,5,6,16.7%,2h
33516,1,Syluna,2375,0,0,1,1,0.0%,2h
33516,1,thecatdragon,2375,0,0,2,2,0.0%,27m
33549,3,Duffman,2374,1475,140,138,278,50.4%,37m
33549,1,UnlimitedxIQ,2374,1177,43,45,88,48.9%,40m
33549,1,[waRp1]antaras,2374,915,32,43,75,42.7%,21m
33549,1,SOYNOB,2374,766,31,17,48,64.6%,50m
33549,3,CHOLNKE,2374,351,12,15,27,44.4%,31m
33549,2,xigency,2374,189,9,14,23,39.1%,34m
33549,2,bkl,2374,142,5,7,12,41.7%,7m
33549,1,Nateissadead,2374,48,4,3,7,57.1%,1h
33549,1,joshallen,2374,96,3,5,8,37.5%,44m
33549,1,[LosRam]KillerZopp,2374,42,2,1,3,66.7%,2h
33549,1,Joshie,2374,0,2,3,5,40.0%,2h
33549,3,CNNsucks,2374,66,2,6,8,25.0%,2h
33549,1,DragonFang,2374,0,0,2,2,0.0%,5m
33549,2,CannonFiesta,2374,0,0,7,7,0.0%,42m
33563,3,[LvTrAn]micko,2373,1553,98,112,210,46.7%,2h
33563,1,itwasntme,2373,1825,93,91,184,50.5%,2h
33563,3,kailand,2373,1567,86,65,151,57.0%,35m
33563,3,poodragon,2373,1390,79,82,161,49.1%,17m
33563,3,PROTOSS,2373,827,36,36,72,50.0%,2h
33563,2,BattleBoy,2373,914,35,36,71,49.3%,17m
33563,3,nemc,2373,584,34,34,68,50.0%,1h
33563,2,MendoSlay,2373,691,33,27,60,55.0%,2h
33563,2,Nemesis,2373,597,23,31,54,42.6%,35m
33563,2,SVTAndrew,2373,574,21,30,51,41.2%,33m
33563,3,Stza,2373,396,20,7,27,74.1%,27m
33563,3,samson,2373,542,19,21,40,47.5%,2h
33563,3,[M4SS1V]ITURTLEI,2373,354,12,18,30,40.0%,14m
33563,2,Broly,2373,331,11,15,26,42.3%,2h
33563,3,JucaBala,2373,232,9,9,18,50.0%,28m
33563,2,[GoaOLD]Beluga,2373,178,6,10,16,37.5%,2h
33563,3,RanggaNs,2373,120,5,4,9,55.6%,2h
33563,3,Brant,2373,146,5,7,12,41.7%,2h
33563,3,KIRITO,2373,150,5,8,13,38.5%,2h
33563,3,Gamalas,2373,147,4,2,6,66.7%,2h
33563,3,Kevincap,2373,88,4,4,8,50.0%,2h
33563,1,Xenos,2373,48,2,1,3,66.7%,2h
33563,3,Kyle,2373,0,2,4,6,33.3%,2h
33563,1,[OCTA]Phoenix,2373,80,2,5,7,28.6%,5m
33563,1,Lunatic,2373,48,2,6,8,25.0%,8m
33563,1,[C38108]JackBauer,2373,0,1,1,2,50.0%,2h
33563,1,[IMN]Spy,2373,0,1,4,5,20.0%,2h
33563,1,bolsominion,2373,0,1,4,5,20.0%,2h
33563,1,Nicolas,2373,0,1,5,6,16.7%,7m
33563,3,Maki,2373,0,0,1,1,0.0%,40m
33563,1,sjgasoo,2373,0,0,1,1,0.0%,2h
33563,3,Mordecai,2373,0,0,2,2,0.0%,14m
33595,3,TRippyGypsy,2372,1422,94,92,186,50.5%,31m
33595,3,[grches]datNiebs,2372,612,25,20,45,55.6%,2h
33595,1,FakeDecoy,2372,808,24,17,41,58.5%,2h
33595,3,TolietSkunk,2372,683,24,25,49,49.0%,2h
33595,2,[Emb3rs]Tell,2372,534,20,33,53,37.7%,19m
33595,3,Rubens,2372,514,19,20,39,48.7%,12m
33595,3,suchpro,2372,448,17,16,33,51.5%,2h
33595,2,[ZITAB1]Vtreeun,2372,287,9,7,16,56.2%,3h
33595,3,[S8E]Mikeanike,2372,214,8,11,19,42.1%,43m
33595,3,cardtoon,2372,234,8,12,20,40.0%,2h
33595,3,josdan,2372,212,6,7,13,46.2%,3h
33595,1,benjamin,2372,144,6,7,13,46.2%,2m
33595,1,[rusmer]Gherol,2372,0,4,5,9,44.4%,5m
33595,1,Bluejayz,2372,90,3,1,4,75.0%,2h
33595,3,goodmen,2372,116,3,1,4,75.0%,4m
33595,1,xizi,2372,93,1,3,4,25.0%,51m
33595,1,LUFFY,2372,0,1,4,5,20.0%,22m
33595,3,MetalLaw,2372,0,1,5,6,16.7%,32m
33595,2,[CROUCH]Jake,2372,0,0,1,1,0.0%,1h
33595,1,Grunt,2372,0,0,1,1,0.0%,3m
33595,1,Luiz,2372,0,0,2,2,0.0%,2h
33595,1,imawinsorry,2372,0,0,2,2,0.0%,2h
33617,3,BUBU,2371,1591,231,215,446,51.8%,2h
33617,2,fiascoavertd,2371,1531,179,173,352,50.9%,2h
33617,1,Forgotten,2371,1064,112,115,227,49.3%,2h
33617,2,ninja,2371,1263,62,70,132,47.0%,19m
33617,3,KiLLeR,2371,1111,45,38,83,54.2%,2h
33617,3,xPakky,2371,532,31,36,67,46.3%,43m
33617,1,[GTWITM]wolfrain,2371,887,27,25,52,51.9%,2h
33617,2,Gruul,2371,586,23,24,47,48.9%,2h
33617,3,Bombadil,2371,511,19,27,46,41.3%,11m
33617,3,methodL,2371,394,15,12,27,55.6%,19m
33617,3,TAZADAR,2371,376,14,15,29,48.3%,19m
33617,3,Pantera,2371,294,10,13,23,43.5%,2h
33617,2,TaylorD,2371,173,5,10,15,33.3%,2h
33617,1,ManiManitoXD,2371,136,3,2,5,60.0%,34m
33617,3,DMDM,2371,95,2,1,3,66.7%,2h
33617,1,Dib,2371,44,2,5,7,28.6%,10m
33617,2,Ben,2371,116,2,9,11,18.2%,2h
33617,1,memen,2371,44,1,2,3,33.3%,49m
33617,1,[KAAPPA]Higa,2371,36,1,3,4,25.0%,2h
33617,1,Rawr,2371,0,0,1,1,0.0%,4m
33617,1,[GDPx]oPkongasaur,2371,0,0,1,1,0.0%,2h
33617,1,loboselvagem,2371,0,0,1,1,0.0%,2h
33617,1,[ImBean]Imm,2371,0,0,1,1,0.0%,2h
33617,1,[Gooons]lumberjack,2371,0,0,5,5,0.0%,2h
33617,3,wheel,2371,0,0,5,5,0.0%,2h
33617,3,FakeAsian,2371,0,0,6,6,0.0%,37m
33643,2,DustDoesGood,2370,1116,68,67,135,50.4%,18m
33643,1,Fiky,2370,1505,63,58,121,52.1%,2h
33643,3,eliteleadrr,2370,1107,55,52,107,51.4%,35m
33643,1,[FBoy]Orbitals,2370,633,49,54,103,47.6%,1h
33643,3,[cfaftw]BoneSaw,2370,920,40,38,78,51.3%,2h
33643,1,HeHateMe,2370,1019,38,46,84,45.2%,51m
33643,1,[Ash3s]LiTuS,2370,911,35,17,52,67.3%,3h
33643,2,Sirante,2370,711,25,31,56,44.6%,36m
33643,2,[nieBla]TastosisLova,2370,493,19,17,36,52.8%,3h
33643,3,Aneustart,2370,347,14,12,26,53.8%,2h
33643,3,Ghostman,2370,428,14,15,29,48.3%,13m
33643,1,[xMPTx]sheepherder,2370,396,14,16,30,46.7%,3m
33643,3,SamyzerA,2370,366,13,13,26,50.0%,35m
33643,1,[XpKAc]Diaguita,2370,486,12,16,28,42.9%,1m
33643,2,Austin,2370,320,11,15,26,42.3%,2h
33643,3,Kevin,2370,251,8,12,20,40.0%,14m
33643,3,tomax,2370,183,7,8,15,46.7%,35m
33643,3,kaan,2370,142,6,10,16,37.5%,1h
33643,1,[ZTemp]Jataru,2370,218,5,5,10,50.0%,27m
33643,1,Ghost,2370,73,4,3,7,57.1%,2h
33643,3,SerNineSeven,2370,88,4,5,9,44.4%,35m
33643,1,SCV,2370,73,4,6,10,40.0%,53m
33643,1,Suzuno,2370,84,3,1,4,75.0%,2h
33643,2,KevinLeyva,2370,0,3,5,8,37.5%,3h
33643,3,LightGoneBad,2370,30,2,3,5,40.0%,2h
33643,3,SorryForWhat,2370,0,2,6,8,25.0%,27m
33643,1,Gronkmen,2370,0,1,0,1,100.0%,14m
33643,1,johnjohn,2370,0,1,0,1,100.0%,2h
33643,1,Harmoxio,2370,0,1,4,5,20.0%,3h
33643,3,BillyBobBob,2370,0,1,5,6,16.7%,2h
33643,1,Wreqz,2370,0,0,1,1,0.0%,3h
33674,3,Trawg,2369,1433,70,71,141,49.6%,2h
33674,2,Enkin,2369,428,61,69,130,46.9%,23m
33674,2,Lawrence,2369,1087,54,37,91,59.3%,6m
33674,3,Savaki,2369,1122,43,50,93,46.2%,43m
33674,3,Matrek,2369,646,35,38,73,47.9%,44m
33674,3,[n1zzle]Ethan,2369,620,31,30,61,50.8%,1h
33674,3,KingJ,2369,569,28,23,51,54.9%,51m
33674,3,gJaxx,2369,512,17,21,38,44.7%,29m
33674,1,[KRAFTT]Chamelio,2369,502,15,12,27,55.6%,25m
33674,1,Demali,2369,451,14,13,27,51.9%,2h
33674,3,Eliaquin,2369,354,12,12,24,50.0%,47m
33674,1,WarGodOdin,2369,438,11,12,23,47.8%,4m
33674,3,CreapNCrawl,2369,334,10,35,45,22.2%,29m
33674,2,[cl0udM]Cryogenes,2369,218,7,11,18,38.9%,2h
33674,2,[MI31]Jorge,2369,158,7,13,20,35.0%,6m
33674,1,[XxDSxX]TheDarkCanuc,2369,104,5,10,15,33.3%,2h
33674,1,Seasick,2369,132,4,3,7,57.1%,3h
33674,3,[NE0]SeuMadruga,2369,86,4,3,7,57.1%,28m
33674,3,wika,2369,0,3,3,6,50.0%,9m
33674,3,RonaldRaygun,2369,60,3,5,8,37.5%,1h
33674,3,Tyranasaurus,2369,131,3,7,10,30.0%,38m
33674,1,UltimateMike,2369,134,2,6,8,25.0%,1h
33674,3,Computer,2369,97,1,2,3,33.3%,16m
33674,1,Vile,2369,0,0,1,1,0.0%,1h
33674,1,[Nukes]Masr,2369,0,0,2,2,0.0%,2m
33674,3,JuanJo,2369,0,0,4,4,0.0%,1h
33700,2,fizzyelf,2368,1245,126,120,246,51.2%,2h
33700,3,[SWOU]darkfox,2368,1448,113,101,214,52.8%,5m
33700,2,SirGerard,2368,1171,93,88,181,51.4%,17m
33700,3,[XGang]JayKay,2368,1566,83,76,159,52.2%,9m
33700,3,Sinaps,2368,791,47,42,89,52.8%,2h
33700,3,PeeInButt,2368,414,42,43,85,49.4%,2h
33700,3,[uKnR]Fullmetal,2368,602,21,23,44,47.7%,47m
33700,3,Potato,2368,512,20,24,44,45.5%,31m
33700,2,templariobr,2368,428,19,21,40,47.5%,2h
33700,2,Chappy,2368,428,16,20,36,44.4%,2h
33700,3,TheRevenant,2368,321,11,9,20,55.0%,2h
33700,3,Chroniclez,2368,315,10,11,21,47.6%,2h
33700,3,Cheeburashka,2368,224,9,5,14,64.3%,2h
33700,1,tossomesalad,2368,238,7,9,16,43.8%,40m
33700,2,OfficerNasty,2368,223,7,13,20,35.0%,2h
33700,1,razord,2368,0,4,1,5,80.0%,2h
33700,3,Billy,2368,173,4,7,11,36.4%,52m
33700,1,JakesDMolay,2368,94,3,2,5,60.0%,1h
33700,1,Zodd,2368,143,3,3,6,50.0%,2h
33700,3,KaizzerVanAs,2368,121,3,3,6,50.0%,31m
33700,3,Flexnuttz,2368,138,3,4,7,42.9%,2h
33700,3,Mandy,2368,155,3,4,7,42.9%,2h
33700,1,Esteban,2368,40,3,4,7,42.9%,2h
33700,3,llllllllll,2368,140,3,4,7,42.9%,29m
33700,1,[Chaz69]Nightmare,2368,82,2,2,4,50.0%,20m
33700,1,Diegoishyan,2368,46,2,2,4,50.0%,44m
33700,1,[1vsM]Rhone,2368,0,2,3,5,40.0%,2h
33700,1,[SM0K3]Quaid,2368,0,2,3,5,40.0%,2h
33700,1,LGSN,2368,88,2,3,5,40.0%,10m
33700,1,wujem,2368,48,2,5,7,28.6%,1h
33700,1,nogadist,2368,44,2,5,7,28.6%,39m
33700,1,[TGULS]jannboy,2368,0,1,0,1,100.0%,53m
33700,1,Fonzo,2368,0,1,1,2,50.0%,3h
33700,1,GeneralAwsum,2368,0,1,1,2,50.0%,2h
33700,1,Marcoscsh,2368,0,1,2,3,33.3%,2h
33700,1,illinem,2368,0,1,4,5,20.0%,2h
33700,1,[DLe]RevJoe,2368,0,1,4,5,20.0%,33m
33700,1,Cloudchaser,2368,0,1,4,5,20.0%,41m
33700,1,smashedyou,2368,0,0,1,1,0.0%,2h
33700,1,[NEW]FavelaRJ,2368,0,0,1,1,0.0%,2h
33700,1,wilson,2368,0,0,1,1,0.0%,2h
33700,1,starghost,2368,0,0,1,1,0.0%,50m
33700,3,MonkMmkay,2368,0,0,2,2,0.0%,2h
33743,2,pants,2367,1255,202,186,388,52.1%,22m
33743,3,ClapYoCheekz,2367,395,64,49,113,56.6%,2h
33743,3,PARKER,2367,919,44,47,91,48.4%,1h
33743,3,[deegg]Carrot,2367,922,38,33,71,53.5%,2h
33743,1,[TPN3X]LUKZ,2367,813,25,20,45,55.6%,1m
33743,1,[ELLOCO]Slugok,2367,604,22,8,30,73.3%,2h
33743,3,anglofro,2367,565,20,20,40,50.0%,28m
33743,3,lucas,2367,508,18,16,34,52.9%,2h
33743,2,RudyLopes,2367,437,18,26,44,40.9%,2h
33743,1,Armadica,2367,410,12,6,18,66.7%,5m
33743,2,Cannacoop,2367,268,11,11,22,50.0%,33m
33743,2,[AKMRD]Titomg,2367,280,10,14,24,41.7%,23m
33743,2,Yugo,2367,203,7,11,18,38.9%,42m
33743,3,[uepa]Rod,2367,206,6,5,11,54.5%,27m
33743,3,kukuro,2367,42,5,4,9,55.6%,2h
33743,3,Toni,2367,60,5,5,10,50.0%,3h
33743,1,StormLord,2367,72,3,0,3,100.0%,14m
33743,1,[DVHSC]RATMATAZZ,2367,0,3,3,6,50.0%,7m
33743,3,WarPig,2367,60,3,4,7,42.9%,2h
33743,1,Killer,2367,130,3,5,8,37.5%,50m
33743,3,manu,2367,30,3,5,8,37.5%,50m
33743,3,BattleSpud,2367,85,2,3,5,40.0%,1h
33743,1,dkman,2367,0,1,0,1,100.0%,1h
33743,1,Kaitabch,2367,48,1,2,3,33.3%,49m
33743,3,Villager,2367,0,1,3,4,25.0%,2h
33743,1,Bjorklund,2367,0,1,4,5,20.0%,7m
33743,1,Swaahp,2367,0,1,4,5,20.0%,2h
33743,1,Isaac,2367,0,1,4,5,20.0%,2h
33743,3,walkingfish,2367,0,1,5,6,16.7%,42m
33743,2,[ATEA]GayAngel,2367,0,1,5,6,16.7%,2h
33743,1,CDman,2367,0,0,1,1,0.0%,2h
33743,1,Axtence,2367,0,0,1,1,0.0%,2h
33743,1,selendis,2367,0,0,1,1,0.0%,7m
33743,1,Obbit,2367,0,0,2,2,0.0%,2h
33777,2,GoTime,2366,1585,247,253,500,49.4%,19m
33777,1,Muadib,2366,1083,81,75,156,51.9%,2h
33777,3,Zebulan,2366,1335,59,53,112,52.7%,36m
33777,1,elcachero,2366,1092,36,24,60,60.0%,2h
33777,3,Beasthorn,2366,965,36,38,74,48.6%,41m
33777,2,[eXtra1]DEVILinBLACK,2366,546,18,24,42,42.9%,2h
33777,1,Ocdi,2366,620,17,12,29,58.6%,2h
33777,2,[ZTemp]Dufresne,2366,284,11,6,17,64.7%,33m
33777,1,BDeezy,2366,191,9,6,15,60.0%,13m
33777,3,FriskyTango,2366,150,9,8,17,52.9%,1h
33777,1,PotasiumGirl,2366,40,6,8,14,42.9%,3h
33777,2,Diego,2366,180,6,8,14,42.9%,2h
33777,3,[KMELA]paphecito,2366,172,6,12,18,33.3%,29m
33777,3,Frints,2366,194,5,3,8,62.5%,2h
33777,3,charizar,2366,154,5,10,15,33.3%,2h
33777,1,[XTLGX]JorfranMore,2366,126,4,2,6,66.7%,27m
33777,1,[BCBZ]KissedUrDad,2366,44,2,1,3,66.7%,2h
33777,1,Viper,2366,84,2,3,5,40.0%,2h
33777,1,Tom,2366,0,2,4,6,33.3%,2h
33777,1,[Falme]Kylixir,2366,48,2,5,7,28.6%,2h
33777,1,SpaceNomad,2366,0,1,1,2,50.0%,2h
33777,1,peggels,2366,0,1,1,2,50.0%,2h
33777,1,[SkAL]holydiver,2366,44,1,2,3,33.3%,2h
33777,3,RickDumaL,2366,0,1,3,4,25.0%,9m
33777,3,darkknigth,2366,30,1,4,5,20.0%,31m
33777,1,BlueAeon,2366,0,1,4,5,20.0%,2h
33777,3,Galaxy,2366,0,1,5,6,16.7%,1h
33777,1,element,2366,0,0,1,1,0.0%,10m
33777,1,Luke,2366,0,0,2,2,0.0%,2h
33806,2,Naitnoum,2365,1538,92,91,183,50.3%,12m
33806,3,Assembly,2365,953,72,67,139,51.8%,20m
33806,3,[IPOI2]HeadySativa,2365,761,26,37,63,41.3%,2h
33806,3,wrandas,2365,532,23,13,36,63.9%,2h
33806,2,Effortless,2365,527,21,20,41,51.2%,34m
33806,3,[FKAHTK]DirtySoup,2365,477,19,19,38,50.0%,3h
33806,3,[TIC]TipTop,2365,335,13,22,35,37.1%,41m
33806,1,DontEven,2365,409,11,14,25,44.0%,2h
33806,1,leysempai,2365,284,10,10,20,50.0%,38m
33806,3,Tysonian,2365,328,10,11,21,47.6%,2h
33806,2,[Pinoys]SeAeinerlabs,2365,269,10,11,21,47.6%,36m
33806,2,Zyxven,2365,254,10,12,22,45.5%,11m
33806,3,PRES,2365,214,7,12,19,36.8%,22m
33806,1,Juice,2365,162,7,12,19,36.8%,21m
33806,3,[usuc]PPTenshi,2365,209,6,7,13,46.2%,2h
33806,3,[YD2K]Daniel,2365,196,6,7,13,46.2%,1h
33806,1,[LETAL]Rasthak,2365,199,6,11,17,35.3%,3h
33806,1,Solo,2365,172,5,2,7,71.4%,2h
33806,1,FISHgoosie,2365,97,4,2,6,66.7%,50m
33806,1,LOBITO,2365,167,4,3,7,57.1%,2h
33806,3,jackfoo,2365,32,4,5,9,44.4%,2h
33806,1,[yito]JJay,2365,199,4,7,11,36.4%,2h
33806,1,cristonz,2365,88,3,1,4,75.0%,14m
33806,1,Reshirom,2365,0,3,2,5,60.0%,2h
33806,3,GxbElement,2365,62,3,6,9,33.3%,40m
33806,1,BigDikMick,2365,96,3,6,9,33.3%,2h
33806,1,[MAYN]Smallpox,2365,38,2,0,2,100.0%,34m
33806,3,elnoob,2365,0,2,5,7,28.6%,1h
33806,1,Leonardo,2365,0,1,0,1,100.0%,2h
33806,3,Addiction,2365,30,1,4,5,20.0%,3h
33806,1,Carl,2365,0,0,1,1,0.0%,2h
33806,1,MrsThrax,2365,0,0,2,2,0.0%,2h
33806,3,gettingud,2365,0,0,3,3,0.0%,2h
33806,2,BroteinBar,2365,0,0,4,4,0.0%,1h
33840,2,Ruc,2364,1475,170,171,341,49.9%,36m
33840,2,[SpaceJ]machetazo,2364,1521,164,156,320,51.2%,15m
33840,1,Guilherme,2364,1270,51,39,90,56.7%,3h
33840,3,TikTok,2364,492,27,17,44,61.4%,3h
33840,1,TiLTED,2364,787,24,22,46,52.2%,21m
33840,3,BunkerWolf,2364,631,23,24,47,48.9%,5m
33840,2,[NSOP]Arrownite,2364,495,21,25,46,45.7%,17m
33840,1,PALACIOS,2364,458,20,15,35,57.1%,2h
33840,1,[BNKRZ]Tyler,2364,348,12,29,41,29.3%,12m
33840,2,[Choice]Xaeroxe,2364,262,9,12,21,42.9%,46m
33840,3,Supermago,2364,116,3,5,8,37.5%,20m
33840,2,jojulien,2364,34,2,1,3,66.7%,2h
33840,1,bergstrome,2364,0,2,2,4,50.0%,2h
33840,3,Volg,2364,30,2,6,8,25.0%,2h
33840,1,lylou,2364,0,2,6,8,25.0%,1m
33840,3,Bacchus,2364,30,2,7,9,22.2%,44m
33840,1,Vivalavida,2364,0,1,0,1,100.0%,44m
33840,1,[POEA]TWadleDZNuts,2364,0,1,1,2,50.0%,2h
33840,3,Cutialcapro,2364,0,1,1,2,50.0%,2h
33840,1,SirWinsAlot,2364,46,1,2,3,33.3%,4m
33840,1,WolfRunner,2364,44,1,2,3,33.3%,2h
33840,1,Pedro,2364,44,1,2,3,33.3%,10m
33840,1,maxwou,2364,0,1,4,5,20.0%,2h
33840,1,arraes,2364,0,1,4,5,20.0%,2h
33840,1,Asternine,2364,0,1,5,6,16.7%,2h
33840,3,TrizBoy,2364,30,1,5,6,16.7%,47m
33840,1,Bjornsen,2364,0,0,3,3,0.0%,3h
33867,3,Bootsie,2363,1281,100,93,193,51.8%,2h
33867,3,mewthree,2363,1293,53,47,100,53.0%,26m
33867,1,beaterthayoU,2363,1306,50,43,93,53.8%,40m
33867,3,Noctrnal,2363,771,38,31,69,55.1%,2h
33867,3,[Zno]CaptainTuna,2363,796,28,32,60,46.7%,2h
33867,3,SrSQUANCHYdc,2363,551,20,25,45,44.4%,1h
33867,3,UnxplndBacon,2363,470,18,23,41,43.9%,14m
33867,1,Xeerok,2363,414,13,15,28,46.4%,1h
33867,3,[STBX]Turtlezzz,2363,342,12,14,26,46.2%,46m
33867,1,Zerashk,2363,272,8,4,12,66.7%,10m
33867,1,Mansi,2363,250,6,4,10,60.0%,5m
33867,1,EasyHyung,2363,208,6,9,15,40.0%,2h
33867,3,BonsaY,2363,120,5,8,13,38.5%,2h
33867,3,Ashmax,2363,58,3,4,7,42.9%,40m
33867,1,paperchaser,2363,91,3,7,10,30.0%,17m
33867,3,BattleBro,2363,92,3,8,11,27.3%,2h
33867,3,PrevJames,2363,36,2,4,6,33.3%,42m
33867,1,[HitBox]ToeKnee,2363,42,2,5,7,28.6%,12m
33867,3,[Crip1]Gustavo,2363,60,2,5,7,28.6%,2h
33867,3,[AN4I]MartinSsempa,2363,30,2,6,8,25.0%,36m
33867,1,Gladiator,2363,0,1,0,1,100.0%,2h
33867,2,PWRDark,2363,0,1,0,1,100.0%,2h
33867,1,flo,2363,40,1,1,2,50.0%,43m
33867,1,Yahaans,2363,0,1,3,4,25.0%,2h
33867,3,proop,2363,0,1,6,7,14.3%,39m
33867,1,RiceofLight,2363,0,0,1,1,0.0%,6m
33867,3,AyMathias,2363,0,0,1,1,0.0%,2h
33867,2,AICP,2363,0,0,2,2,0.0%,2h
33895,3,acundelar,2362,1208,159,168,327,48.6%,29m
33895,3,[maSC]chack,2362,845,77,78,155,49.7%,2h
33895,1,JimBo,2362,1482,60,44,104,57.7%,2h
33895,1,GOTNUKED,2362,1178,42,33,75,56.0%,14m
33895,1,chickeneater,2362,1177,41,34,75,54.7%,3h
33895,3,POMITS,2362,980,37,39,76,48.7%,37m
33895,3,bluzz,2362,626,25,26,51,49.0%,37m
33895,1,[WHoC]KilgoreTrout,2362,764,22,16,38,57.9%,2h
33895,3,BigDaddy,2362,378,12,18,30,40.0%,2h
33895,3,Exile,2362,274,10,15,25,40.0%,31m
33895,2,Darboux,2362,278,7,14,21,33.3%,51m
33895,3,Hyper,2362,149,6,4,10,60.0%,37m
33895,3,Kintull,2362,144,6,10,16,37.5%,2h
33895,1,NoScope,2362,153,5,8,13,38.5%,2h
33895,3,DrFapJacks,2362,144,4,4,8,50.0%,2h
33895,3,xplodus,2362,89,4,5,9,44.4%,37m
33895,1,Inkcontrol,2362,42,3,3,6,50.0%,2h
33895,3,Ders,2362,30,3,5,8,37.5%,29m
33895,3,Kel,2362,121,3,6,9,33.3%,9m
33895,1,DDtheking,2362,145,2,2,4,50.0%,2h
33895,3,Darkzephyr,2362,60,2,5,7,28.6%,2h
33895,2,CaptSquid,2362,0,2,5,7,28.6%,3h
33895,3,Dab,2362,0,2,6,8,25.0%,2h
33895,1,Okamiyasha,2362,44,1,1,2,50.0%,2h
33895,3,Kalon,2362,0,1,3,4,25.0%,14m
33895,2,[NKWY]ThNotkreatur,2362,30,1,5,6,16.7%,13m
33895,1,Shades,2362,0,1,5,6,16.7%,47m
33895,2,Crybaby,2362,0,1,6,7,14.3%,17m
33895,1,FarmerGiles,2362,0,0,1,1,0.0%,52m
33895,1,eidikoz,2362,0,0,1,1,0.0%,2h
33895,3,JoNy,2362,0,0,1,1,0.0%,1h
33895,3,AntiHeRo,2362,0,0,2,2,0.0%,32m
33895,1,Kemosabe,2362,0,0,2,2,0.0%,14m
33928,3,MICHELLIN,2361,1561,352,363,715,49.2%,50m
33928,2,SmackWitch,2361,1527,219,220,439,49.9%,23m
33928,2,Pancho,2361,1444,195,200,395,49.4%,23m
33928,3,[TY4GG]Greeenacres,2361,1491,166,144,310,53.5%,35m
33928,2,[MIDMX]Ale,2361,1266,77,71,148,52.0%,35m
33928,2,[kGreen]Nate,2361,1379,64,74,138,46.4%,2h
33928,3,[KEILZ]Whitezero,2361,1157,46,49,95,48.4%,2h
33928,2,Zentrix,2361,628,43,48,91,47.3%,2h
33928,3,[m0r74I]Diabolic,2361,885,38,38,76,50.0%,3h
33928,1,MagicAstro,2361,716,23,16,39,59.0%,19m
33928,3,Deiva,2361,312,13,5,18,72.2%,9m
33928,1,Pheeps,2361,292,8,4,12,66.7%,14m
33928,3,[IDoom]Patrin,2361,240,8,10,18,44.4%,35m
33928,2,[4C35]Chronicator,2361,214,7,19,26,26.9%,30m
33928,3,AdultBrian,2361,158,6,13,19,31.6%,2h
33928,1,Muffwrangler,2361,90,3,1,4,75.0%,52m
33928,1,Ulysses,2361,169,3,5,8,37.5%,52m
33928,1,Panchrist,2361,89,3,7,10,30.0%,4m
33928,2,cOmpleX,2361,95,3,8,11,27.3%,2h
33928,3,MiyanoShiho,2361,0,2,5,7,28.6%,2h
33928,1,Doomrider,2361,44,1,1,2,50.0%,2h
33928,1,xSockDreamsx,2361,0,1,2,3,33.3%,2h
33928,1,Norgoth,2361,0,1,4,5,20.0%,2h
33928,1,LSJC,2361,0,1,4,5,20.0%,2h
33928,2,kimjiye,2361,30,1,11,12,8.3%,2h
33928,1,TRUxSlayz,2361,0,0,1,1,0.0%,26m
33954,2,[HF007]Cerkill,2360,1619,293,298,591,49.6%,2h
33954,2,Connor,2360,1474,111,107,218,50.9%,19m
33954,3,[zxczx]Eclipse,2360,848,36,30,66,54.5%,20m
33954,3,DrunknNinja,2360,642,25,23,48,52.1%,36m
33954,1,ButtaBall,2360,519,22,36,58,37.9%,20m
33954,3,Eason,2360,299,19,17,36,52.8%,4m
33954,3,yony,2360,461,18,20,38,47.4%,19m
33954,3,HAJINVATOR,2360,462,17,19,36,47.2%,2h
33954,1,[EpicG]Juanma,2360,478,16,14,30,53.3%,23m
33954,1,SlimShady,2360,440,13,6,19,68.4%,43m
33954,3,Swanzokills,2360,342,13,7,20,65.0%,47m
33954,3,Southbound,2360,340,12,15,27,44.4%,3h
33954,2,HormelChavez,2360,358,12,16,28,42.9%,46m
33954,1,[TK3]JeanFelix,2360,117,3,4,7,42.9%,2h
33954,2,asdfjkl,2360,38,2,0,2,100.0%,33m
33954,2,[Wint]MiniNinja,2360,0,1,0,1,100.0%,34m
33954,1,[xTNTx]Doc,2360,0,1,1,2,50.0%,27m
33954,1,FENIX,2360,34,1,2,3,33.3%,35m
33954,1,ThatGuYonder,2360,0,0,1,1,0.0%,1h
33954,3,CamAndrews,2360,0,0,1,1,0.0%,36m
33954,1,scooterdog,2360,0,0,1,1,0.0%,14m
33975,1,BlueSea,2359,1315,272,277,549,49.5%,2h
33975,3,[TyN4Vi]Jonathaine,2359,1555,235,235,470,50.0%,2h
33975,2,iTK,2359,1498,88,92,180,48.9%,1h
33975,2,Armas,2359,1494,72,80,152,47.4%,2h
33975,1,MagicTurtle,2359,1441,49,43,92,53.3%,44m
33975,3,deepdish,2359,1093,47,52,99,47.5%,44m
33975,3,crescendoooo,2359,1148,45,53,98,45.9%,2h
33975,1,MarcoCat,2359,949,31,22,53,58.5%,2h
33975,1,squarebeak,2359,608,17,14,31,54.8%,3h
33975,3,[Ricers]PatrickB,2359,311,11,8,19,57.9%,2h
33975,3,StarCruiser,2359,274,10,12,22,45.5%,30m
33975,1,shadowbenic,2359,172,8,6,14,57.1%,44m
33975,3,CaptainCrnch,2359,181,7,12,19,36.8%,26m
33975,1,oswald,2359,198,6,4,10,60.0%,2h
33975,1,KingOfClouds,2359,143,2,2,4,50.0%,2h
33975,1,UNDERTAKER,2359,0,2,3,5,40.0%,35m
33975,1,bigtaitor,2359,0,1,0,1,100.0%,48m
33992,3,Milamber,2358,1410,172,163,335,51.3%,34m
33992,3,[br0cef]NetSurge,2358,1092,116,104,220,52.7%,26m
33992,1,XxDrAigNorXx,2358,1399,47,42,89,52.8%,2h
33992,3,BERCERKER,2358,851,41,35,76,53.9%,2h
33992,2,CashMunie,2358,358,41,48,89,46.1%,21m
33992,1,ppsmalls,2358,613,21,10,31,67.7%,3h
33992,3,Lolis,2358,426,19,22,41,46.3%,2h
33992,3,[M1A5]Kman,2358,337,15,18,33,45.5%,17m
33992,3,[Bajos]Cadmusdr,2358,380,14,17,31,45.2%,17m
33992,1,Nicka,2358,390,10,10,20,50.0%,52m
33992,1,Charot,2358,328,10,13,23,43.5%,14m
33992,1,jerzy,2358,368,9,8,17,52.9%,2h
33992,3,Etherburn,2358,268,9,14,23,39.1%,2h
33992,3,Orgkhan,2358,258,9,15,24,37.5%,2h
33992,1,[FF]Misenfather,2358,235,6,13,19,31.6%,2h
33992,3,KimchiMan,2358,169,5,6,11,45.5%,5m
33992,1,MrPlopPlop,2358,150,5,7,12,41.7%,2h
33992,3,RekklesRoy,2358,30,4,5,9,44.4%,2h
33992,1,Psymon,2358,214,4,6,10,40.0%,9m
33992,1,dmob,2358,155,3,1,4,75.0%,2h
33992,1,DarkXtm,2358,132,3,3,6,50.0%,4m
33992,1,[MaxWin]Watain,2358,90,3,5,8,37.5%,16m
33992,1,Tournevis,2358,88,3,6,9,33.3%,2h
33992,3,AGITO,2358,0,2,5,7,28.6%,2h
33992,2,[Epokhé]dark,2358,0,1,2,3,33.3%,3m
33992,1,Fumo,2358,0,1,4,5,20.0%,39m
33992,1,BingGou,2358,0,1,4,5,20.0%,52m
33992,1,Narnny,2358,0,1,4,5,20.0%,2h
33992,1,PapaNewShoes,2358,0,1,4,5,20.0%,2h
33992,1,Zeratul,2358,0,0,1,1,0.0%,2h
33992,1,ButtCustard,2358,0,0,1,1,0.0%,2h
33992,1,Goldwing,2358,0,0,2,2,0.0%,2h
34024,2,ZEN,2357,939,328,331,659,49.8%,9m
34024,3,Mercurius,2357,1336,167,161,328,50.9%,13m
34024,1,becquer,2357,1759,83,69,152,54.6%,25m
34024,1,GUS,2357,1513,77,61,138,55.8%,13m
34024,2,postpunk,2357,826,71,59,130,54.6%,36m
34024,2,[missA]jman,2357,999,46,34,80,57.5%,35m
34024,1,[PY]Arzhael,2357,975,33,31,64,51.6%,2h
34024,1,VillanFarT,2357,661,25,18,43,58.1%,3h
34024,1,llllllllllll,2357,505,23,10,33,69.7%,2h
34024,2,Shinta,2357,508,22,22,44,50.0%,34m
34024,3,[PCNTE]LubbDubb,2357,393,13,17,30,43.3%,46m
34024,1,KRONOX,2357,134,8,15,23,34.8%,27m
34024,1,vanflek,2357,174,5,2,7,71.4%,2h
34024,1,Elan,2357,44,2,2,4,50.0%,2h
34024,3,Firestone,2357,121,2,2,4,50.0%,32m
34024,2,Francocala,2357,105,2,2,4,50.0%,2h
34024,3,[UMCP]AmazingDH,2357,60,2,6,8,25.0%,35m
34024,2,Assassin,2357,88,2,6,8,25.0%,2h
34024,3,tbthoiol,2357,92,2,6,8,25.0%,31m
34024,3,PaulyD,2357,0,1,1,2,50.0%,36m
34024,1,Neocr,2357,73,1,4,5,20.0%,2h
34024,1,Shura,2357,0,1,4,5,20.0%,30m
34024,1,Armis,2357,91,1,7,8,12.5%,26m
34024,1,Frostmure,2357,0,0,1,1,0.0%,2h
34024,1,[SC2PH]cookieslyer,2357,0,0,1,1,0.0%,2h
34024,1,SweetNSalty,2357,0,0,2,2,0.0%,40m
34024,1,[USplan]HellFire,2357,73,0,3,3,0.0%,3h
34024,1,ofmexico,2357,0,0,5,5,0.0%,2h
34052,2,PandaJer,2356,1233,49,53,102,48.0%,52m
34052,1,mkomp,2356,1090,34,36,70,48.6%,9m
34052,3,HunterDefend,2356,823,31,32,63,49.2%,9m
34052,3,SCII,2356,739,29,29,58,50.0%,20m
34052,3,NoisE,2356,642,25,22,47,53.2%,9m
34052,3,Olgoth,2356,586,24,29,53,45.3%,5m
34052,1,ROGUEFIVE,2356,763,23,24,47,48.9%,10m
34052,1,chupameesta,2356,340,14,11,25,56.0%,10m
34052,1,annihilator,2356,96,6,3,9,66.7%,2h
34052,3,[4z04z0]Stickmen,2356,168,5,5,10,50.0%,26m
34052,3,lazytitan,2356,66,4,6,10,40.0%,5m
34052,1,[LosCra]Chriscraft,2356,88,3,6,9,33.3%,23m
34052,3,[TJFK]Jeelaze,2356,97,2,0,2,100.0%,2h
34052,1,Xtian,2356,76,2,3,5,40.0%,52m
34052,1,badcredit,2356,0,2,3,5,40.0%,2h
34052,3,Treble,2356,97,1,1,2,50.0%,2h
34052,1,Archer,2356,0,1,4,5,20.0%,2h
34052,1,kirky,2356,0,0,1,1,0.0%,24m
34052,1,Miner,2356,0,0,1,1,0.0%,2h
34052,1,[Drider]Ramcj,2356,0,0,1,1,0.0%,23m
34052,3,Rambo,2356,0,0,4,4,0.0%,2h
34073,2,Cabral,2355,832,153,146,299,51.2%,17m
34073,3,Hostil,2355,904,66,60,126,52.4%,2h
34073,1,Jarvey,2355,1300,47,37,84,56.0%,40m
34073,1,Denniskyc,2355,950,34,26,60,56.7%,14m
34073,1,nekko,2355,610,23,29,52,44.2%,21m
34073,3,PacoBear,2355,442,21,21,42,50.0%,22m
34073,1,Fish,2355,475,13,19,32,40.6%,2h
34073,1,IIIIIIIII,2355,290,8,4,12,66.7%,2h
34073,1,FuzzyAngel,2355,258,6,8,14,42.9%,12m
34073,3,xVigelantex,2355,120,5,5,10,50.0%,28m
34073,2,SaltyNuggets,2355,253,5,10,15,33.3%,2h
34073,3,[TwiLit]SONICLust,2355,154,5,11,16,31.2%,15m
34073,3,PXMODE,2355,152,5,11,16,31.2%,2h
34073,1,Jimmy,2355,132,5,12,17,29.4%,2h
34073,1,[SsSsX2]Wyeth,2355,177,3,3,6,50.0%,9m
34073,3,[CUNYC]chmullig,2355,0,3,4,7,42.9%,52m
34073,3,treebeard,2355,0,3,4,7,42.9%,2h
34073,1,OBSERVER,2355,86,2,1,3,66.7%,12m
34073,3,Amz,2355,0,2,2,4,50.0%,2h
34073,1,BLHero,2355,145,2,2,4,50.0%,46m
34073,1,Murdermitten,2355,48,2,5,7,28.6%,3h
34073,3,Zed,2355,0,2,6,8,25.0%,16m
34073,1,RockyBixby,2355,0,1,0,1,100.0%,2h
34073,3,Devils,2355,0,1,1,2,50.0%,2h
34073,1,Krabbugz,2355,0,1,1,2,50.0%,12m
34073,1,[HD7K]Eduardoprox,2355,0,1,4,5,20.0%,2h
34073,1,DarkShadovv,2355,0,0,1,1,0.0%,2h
34073,1,Damastaleo,2355,0,0,3,3,0.0%,39m
34101,2,CrazyScript,2354,1485,131,131,262,50.0%,2h
34101,2,[8BB]aqueronte,2354,1495,113,121,234,48.3%,6m
34101,3,Johnson,2354,1584,80,86,166,48.2%,2h
34101,3,hegelbagel,2354,1590,72,76,148,48.6%,30m
34101,3,TheLastMage,2354,576,71,53,124,57.3%,1h
34101,1,iFukedYourMo,2354,1111,54,68,122,44.3%,2h
34101,3,[TeamUR]DrEuclidean,2354,493,17,27,44,38.6%,3m
34101,3,nyancat,2354,358,13,10,23,56.5%,11m
34101,3,datmanametom,2354,347,13,11,24,54.2%,2h
34101,1,[MuSaFi]Mexa,2354,343,10,11,21,47.6%,38m
34101,2,MegaBoss,2354,218,6,6,12,50.0%,2h
34101,3,[Huffs]Imposter,2354,102,5,8,13,38.5%,1h
34101,3,Andy,2354,108,5,9,14,35.7%,1h
34101,1,dprsn,2354,0,4,1,5,80.0%,2h
34101,2,Deadbeat,2354,0,4,3,7,57.1%,1h
34101,1,spacecruiser,2354,127,4,7,11,36.4%,36m
34101,1,KingerJJ,2354,174,4,10,14,28.6%,3h
34101,2,Scorne,2354,0,3,4,7,42.9%,42m
34101,1,Dreadnought,2354,107,3,7,10,30.0%,2h
34101,1,Sluug,2354,42,2,4,6,33.3%,2h
34101,3,Waru,2354,58,2,8,10,20.0%,2h
34101,1,zumokaro,2354,0,1,0,1,100.0%,2h
34101,1,perseo,2354,0,1,0,1,100.0%,44m
34101,1,PixelHero,2354,0,1,1,2,50.0%,2h
34101,1,Rambus,2354,0,1,4,5,20.0%,2h
34101,1,gravmoto,2354,0,1,4,5,20.0%,3h
34101,2,Freedan,2354,0,1,5,6,16.7%,1h
34101,1,[LAAR]Hulk,2354,0,0,1,1,0.0%,3h
34101,1,Byloo,2354,0,0,1,1,0.0%,3h
34101,1,Starjitsu,2354,0,0,2,2,0.0%,3m
34131,2,Kev,2353,1381,141,142,283,49.8%,2h
34131,3,DarthKan,2353,1035,137,126,263,52.1%,2h
34131,3,TheKingBeck,2353,1242,96,85,181,53.0%,30m
34131,1,[GiLLs]Dalton,2353,1856,89,78,167,53.3%,2h
34131,3,Sparty,2353,1548,55,62,117,47.0%,36m
34131,3,Krota,2353,1076,41,40,81,50.6%,20m
34131,3,SrHuerta,2353,505,31,21,52,59.6%,2h
34131,3,Paparenzo,2353,488,16,17,33,48.5%,14m
34131,3,BETROX,2353,398,15,17,32,46.9%,51m
34131,3,EazyPeazy,2353,411,14,15,29,48.3%,3h
34131,3,[ITUSKI]GetProbed,2353,378,13,18,31,41.9%,26m
34131,3,Raynilton,2353,162,8,9,17,47.1%,8m
34131,2,Darknight,2353,256,7,15,22,31.8%,7m
34131,1,Mamuri,2353,168,6,6,12,50.0%,2h
34131,3,Xavier,2353,146,6,6,12,50.0%,2h
34131,3,Templario,2353,224,6,9,15,40.0%,46m
34131,2,isolation,2353,213,6,10,16,37.5%,2h
34131,3,[ZTempz]Blitz,2353,121,5,4,9,55.6%,44m
34131,1,JustSeth,2353,239,5,6,11,45.5%,12m
34131,3,poupousensei,2353,121,3,6,9,33.3%,7m
34131,3,Innerlight,2353,162,3,8,11,27.3%,20m
34131,3,Vitojuice,2353,0,2,4,6,33.3%,32m
34131,3,Apkar,2353,97,2,4,6,33.3%,28m
34131,3,manquique,2353,30,2,5,7,28.6%,47m
34131,3,chubias,2353,97,2,6,8,25.0%,41m
34131,1,[DTML]Woundwort,2353,0,1,0,1,100.0%,32m
34131,1,YourDemise,2353,0,1,1,2,50.0%,35m
34131,1,SirPhobos,2353,0,1,4,5,20.0%,2h
34131,1,CogentDefier,2353,0,1,4,5,20.0%,10m
34131,1,Hiashi,2353,0,1,5,6,16.7%,2h
34131,1,Murlock,2353,0,1,5,6,16.7%,48m
34131,1,DaveGuldur,2353,0,1,5,6,16.7%,2h
34131,1,[TeamUR]Brigandy,2353,0,0,1,1,0.0%,2h
34131,1,Vorbeck,2353,0,0,1,1,0.0%,2h
34131,1,FractlBreach,2353,0,0,2,2,0.0%,2h
34166,1,SaiKisaragi,2352,1480,69,58,127,54.3%,2h
34166,1,radagast,2352,1239,44,36,80,55.0%,2h
34166,3,Lex,2352,604,22,31,53,41.5%,4m
34166,1,[Khalta]milcerelpro,2352,606,16,14,30,53.3%,2h
34166,3,InspectrDoom,2352,386,15,10,25,60.0%,3h
34166,1,Jaren,2352,216,9,5,14,64.3%,50m
34166,2,[KiMBR]TASSADAR,2352,235,9,7,16,56.2%,2h
34166,2,Braynztorm,2352,254,9,16,25,36.0%,2h
34166,1,Darvein,2352,292,7,6,13,53.8%,24m
34166,3,[MNVN]Perdue,2352,133,5,7,12,41.7%,2h
34166,3,CrownedClown,2352,60,4,7,11,36.4%,37m
34166,3,SubPenguin,2352,148,4,7,11,36.4%,37m
34166,1,MaDeLene,2352,80,3,0,3,100.0%,14m
34166,3,Racsito,2352,58,3,7,10,30.0%,51m
34166,1,Vassili,2352,46,2,2,4,50.0%,2h
34166,1,Tunynx,2352,0,1,0,1,100.0%,53m
34166,1,Sebas,2352,46,1,1,2,50.0%,2h
34166,1,FireFlamer,2352,0,1,2,3,33.3%,50m
34166,1,Scott,2352,44,1,3,4,25.0%,3m
34166,1,Artrank,2352,0,1,4,5,20.0%,2h
34166,1,jhonWick,2352,0,1,4,5,20.0%,2h
34166,1,Juanelus,2352,73,1,6,7,14.3%,2h
34166,1,WhiteShadow,2352,0,0,1,1,0.0%,2h
34166,1,leplusbeau,2352,0,0,1,1,0.0%,2h
34190,1,Ace,2351,1680,125,118,243,51.4%,14m
34190,1,[lab317]goodoldman,2351,1858,109,104,213,51.2%,2h
34190,3,[DII]roberto,2351,1586,103,96,199,51.8%,2h
34190,3,CachaCholas,2351,1125,53,44,97,54.6%,36m
34190,1,kAmote,2351,1306,44,44,88,50.0%,7m
34190,2,REFB,2351,437,39,38,77,50.6%,30m
34190,3,[FYous]IamAsh,2351,786,36,39,75,48.0%,1h
34190,1,[FTLT]ElCastor,2351,904,33,21,54,61.1%,35m
34190,3,Pharell,2351,811,30,36,66,45.5%,17m
34190,3,Cannedhodge,2351,341,27,26,53,50.9%,2h
34190,1,Bruce,2351,666,19,15,34,55.9%,1h
34190,3,MrSoloTolo,2351,385,14,10,24,58.3%,2h
34190,3,FullHalfie,2351,296,11,7,18,61.1%,3h
34190,3,Joel,2351,209,9,11,20,45.0%,2h
34190,2,[RSoBS]Ilich,2351,208,8,14,22,36.4%,2h
34190,1,neJANIS,2351,248,6,6,12,50.0%,53m
34190,3,DreazLy,2351,184,6,11,17,35.3%,29m
34190,3,DoMaPotrAs,2351,116,5,6,11,45.5%,3h
34190,1,Megashark,2351,84,2,3,5,40.0%,10m
34190,1,SnakeholeRON,2351,90,2,4,6,33.3%,2h
34190,2,Jimmy,2351,0,2,5,7,28.6%,2h
34190,1,DutCh,2351,0,1,0,1,100.0%,2h
34190,1,Flactron,2351,0,1,0,1,100.0%,43m
34190,1,[OPBR]RxP,2351,0,1,0,1,100.0%,3h
34190,1,Afonse,2351,0,1,0,1,100.0%,2h
34190,3,Phil,2351,0,1,1,2,50.0%,27m
34190,1,JuanchoIV,2351,0,1,4,5,20.0%,2h
34190,1,facoud,2351,0,1,4,5,20.0%,24m
34190,1,Knero,2351,0,0,1,1,0.0%,2h
34190,1,illidan,2351,0,0,1,1,0.0%,44m
34190,1,cryveryheavy,2351,0,0,1,1,0.0%,13m
34190,1,ChugaJS,2351,0,0,1,1,0.0%,3h
34222,3,Ganpow,2350,1563,179,172,351,51.0%,1h
34222,3,Genieh,2350,1602,158,146,304,52.0%,49m
34222,1,[Pig2]GGCowabunga,2350,920,36,44,80,45.0%,46m
34222,3,Incablood,2350,686,31,30,61,50.8%,26m
34222,3,Shippy,2350,814,27,35,62,43.5%,30m
34222,3,stonehtoneh,2350,573,25,22,47,53.2%,2h
34222,3,Entropy,2350,599,24,23,47,51.1%,3h
34222,1,renegado,2350,814,22,24,46,47.8%,2h
34222,3,reteP,2350,552,21,19,40,52.5%,3h
34222,1,chilifries,2350,639,17,9,26,65.4%,2h
34222,1,SomeCuck,2350,543,17,22,39,43.6%,43m
34222,3,Exodia,2350,313,15,12,27,55.6%,28m
34222,2,NiserXhell,2350,346,14,15,29,48.3%,20m
34222,1,XhdogX,2350,351,13,14,27,48.1%,3h
34222,3,Warrpath,2350,382,13,31,44,29.5%,4m
34222,3,Didacta,2350,228,11,7,18,61.1%,2h
34222,2,Madness,2350,244,11,8,19,57.9%,2h
34222,1,Neeek,2350,230,11,15,26,42.3%,2h
34222,1,Wargian,2350,286,9,7,16,56.2%,26m
34222,3,Kip,2350,114,9,10,19,47.4%,2h
34222,1,IkarosRT,2350,290,8,2,10,80.0%,52m
34222,3,FGT,2350,250,7,8,15,46.7%,51m
34222,3,Dragonfla,2350,180,7,9,16,43.8%,2h
34222,1,[UKNOME]xsickBoy,2350,212,5,5,10,50.0%,3h
34222,1,[AQP]Apocalipziz,2350,223,5,10,15,33.3%,1m
34222,2,Chillibutt,2350,204,5,13,18,27.8%,36m
34222,3,Sarge,2350,30,4,5,9,44.4%,11m
34222,3,[Z03F4M]Steef,2350,122,3,6,9,33.3%,2h
34222,1,tumbling,2350,88,2,2,4,50.0%,24m
34222,1,BOB,2350,46,1,1,2,50.0%,45m
34222,1,[AbcCo]LuisLipaXD,2350,0,1,2,3,33.3%,27m
34222,1,MetriCsucks,2350,0,1,4,5,20.0%,2h
34222,1,Ogey,2350,0,1,5,6,16.7%,4m
34222,3,Nessfreak,2350,0,0,1,1,0.0%,2h
34222,1,[Atena]wickywoo,2350,0,0,1,1,0.0%,3h
34222,3,[SsaYnS]Shane,2350,0,0,9,9,0.0%,11m
34258,1,TIGERKING,2349,1557,161,160,321,50.2%,2h
34258,1,cguajardo,2349,1887,109,107,216,50.5%,4m
34258,3,bigbear,2349,1380,76,79,155,49.0%,3h
34258,3,Etelios,2349,1515,72,67,139,51.8%,2h
34258,1,DustyDusters,2349,1051,47,47,94,50.0%,2h
34258,3,Nethmes,2349,672,46,45,91,50.5%,32m
34258,1,Swoop,2349,1338,45,43,88,51.1%,52m
34258,1,Martron,2349,1020,37,24,61,60.7%,4m
34258,3,Yamiseta,2349,820,35,35,70,50.0%,2h
34258,3,[HBDO]MENULOG,2349,852,29,41,70,41.4%,2h
34258,3,[CqmB]SpaceRunner,2349,522,19,30,49,38.8%,26m
34258,2,[P1N0Ys]SuperNinja,2349,534,18,29,47,38.3%,2h
34258,3,Jeskai,2349,448,16,20,36,44.4%,2h
34258,3,RITFIT,2349,399,14,14,28,50.0%,47m
34258,1,YOunreggie,2349,322,12,17,29,41.4%,2h
34258,3,huevasoxd,2349,300,11,14,25,44.0%,17m
34258,1,LeTare,2349,253,7,8,15,46.7%,7m
34258,1,Philosopher,2349,209,6,8,14,42.9%,21m
34258,3,Dainsleif,2349,86,5,7,12,41.7%,3h
34258,3,WIchawin,2349,30,2,0,2,100.0%,26m
34258,1,Ryuichi,2349,90,2,4,6,33.3%,2h
34258,1,Warantino,2349,0,1,0,1,100.0%,19m
34258,1,ProtoSSSeal,2349,0,1,0,1,100.0%,2h
34258,1,Simbob,2349,0,1,4,5,20.0%,43m
34258,1,Reaper,2349,0,1,4,5,20.0%,2h
34258,1,Mrspikes,2349,0,0,1,1,0.0%,2h
34258,1,[LoloM]HurRy,2349,0,0,1,1,0.0%,3h
34258,3,[StepUp]DirtyFlamer,2349,0,0,5,5,0.0%,1h
34286,3,jazonn,2348,1413,164,155,319,51.4%,1h
34286,2,Juakinosky,2348,1540,105,105,210,50.0%,2h
34286,3,Reveen,2348,1036,57,51,108,52.8%,26m
34286,1,Trululu,2348,1232,48,36,84,57.1%,4m
34286,3,xSpanki,2348,525,25,29,54,46.3%,2h
34286,3,Tempest,2348,520,20,25,45,44.4%,14m
34286,1,PlayerOne,2348,597,18,11,29,62.1%,1m
34286,3,[INVADS]Mandalorian,2348,182,18,24,42,42.9%,2h
34286,1,Darren,2348,209,6,1,7,85.7%,3h
34286,1,[TY4GG]Broken,2348,167,5,3,8,62.5%,30m
34286,3,Quantinum,2348,170,5,4,9,55.6%,2h
34286,1,luxide,2348,130,4,4,8,50.0%,2h
34286,3,Jadwick,2348,151,4,9,13,30.8%,2h
34286,1,LazyTurtle,2348,78,3,0,3,100.0%,25m
34286,1,StormShadow,2348,0,2,3,5,40.0%,2h
34286,1,[SEALND]jackster,2348,97,2,4,6,33.3%,34m
34286,1,[sLuxx]Mrgoodcat,2348,0,2,6,8,25.0%,23m
34286,1,primehat,2348,0,1,1,2,50.0%,2h
34286,1,[9spide]Tauranga,2348,44,1,1,2,50.0%,2h
34286,1,AsesinoNorti,2348,0,1,2,3,33.3%,2h
34286,1,LFNIGHTMARE,2348,0,1,4,5,20.0%,48m
34286,1,Drawde,2348,0,1,4,5,20.0%,35m
34286,3,Iron,2348,36,1,6,7,14.3%,32m
34286,1,Joeygotgame,2348,0,0,1,1,0.0%,36m
34286,1,Mackyclap,2348,0,0,1,1,0.0%,17m
34311,1,Ren,2347,1895,131,131,262,50.0%,2h
34311,1,[Buried]Neonlight,2347,852,95,99,194,49.0%,2h
34311,2,Jake,2347,778,61,63,124,49.2%,2h
34311,3,BLON,2347,915,43,40,83,51.8%,32m
34311,3,dpro,2347,1128,42,50,92,45.7%,2h
34311,1,Lightmoon,2347,629,34,35,69,49.3%,26m
34311,1,Barin,2347,963,27,24,51,52.9%,2h
34311,1,killercow,2347,592,19,17,36,52.8%,2h
34311,2,Universalink,2347,462,14,22,36,38.9%,17m
34311,1,TerranLima,2347,472,13,13,26,50.0%,36m
34311,3,Boxxheadx,2347,277,11,13,24,45.8%,52m
34311,2,kepler,2347,231,9,10,19,47.4%,2h
34311,3,squibbbo,2347,178,9,14,23,39.1%,29m
34311,1,BreathUnseen,2347,286,7,5,12,58.3%,27m
34311,1,yourface,2347,220,7,6,13,53.8%,3h
34311,3,rootspeople,2347,71,7,12,19,36.8%,2h
34311,1,dogsquad,2347,206,5,1,6,83.3%,2h
34311,3,Boushiki,2347,149,5,5,10,50.0%,2h
34311,3,redmid,2347,171,4,7,11,36.4%,20m
34311,1,Morgion,2347,0,3,2,5,60.0%,2h
34311,1,[SJT]Billybob,2347,44,3,3,6,50.0%,2h
34311,2,[Flexy]FarenHaight,2347,129,2,3,5,40.0%,3h
34311,1,SirFoxAlot,2347,0,2,7,9,22.2%,9m
34311,1,[TCProG]KyGuy,2347,42,1,2,3,33.3%,2h
34311,1,Hypeeeeeeeee,2347,0,1,4,5,20.0%,2h
34311,1,alexanderfd,2347,0,1,4,5,20.0%,2h
34311,1,Kohrnbread,2347,0,1,4,5,20.0%,7m
34311,1,dealedep,2347,0,0,1,1,0.0%,2h
34339,3,TeosExMakina,2346,1342,121,115,236,51.3%,13m
34339,3,Willzy,2346,1579,112,108,220,50.9%,22m
34339,3,[CS0]UndeadPants,2346,808,46,35,81,56.8%,3h
34339,1,Hypno,2346,678,27,30,57,47.4%,2h
34339,1,Dart,2346,605,20,21,41,48.8%,2h
34339,1,SteveHarvey,2346,337,12,13,25,48.0%,40m
34339,2,[LoE1]BDizlFoShizl,2346,364,12,20,32,37.5%,34m
34339,1,JefryEpstein,2346,323,11,16,27,40.7%,2h
34339,1,naaman,2346,238,11,16,27,40.7%,2h
34339,1,[LTWAR]Boogieman,2346,333,10,16,26,38.5%,3h
34339,1,RaBidChicken,2346,370,10,19,29,34.5%,6m
34339,1,Nando,2346,0,4,1,5,80.0%,2h
34339,1,JAMES,2346,132,3,2,5,60.0%,2h
34339,1,Tomboneitor,2346,62,3,3,6,50.0%,26m
34339,3,Gauss,2346,30,2,2,4,50.0%,7m
34339,3,Bookakey,2346,0,2,4,6,33.3%,2h
34339,3,DarkHunter,2346,0,2,4,6,33.3%,2h
34339,1,kyleslizard,2346,38,2,4,6,33.3%,2h
34339,2,[waRp1]DMPlay,2346,0,2,6,8,25.0%,3h
34339,2,jicano,2346,88,2,6,8,25.0%,36m
34339,1,GTO,2346,0,1,4,5,20.0%,30m
34339,3,reeper,2346,0,1,5,6,16.7%,2h
34339,3,Zanendithas,2346,0,1,5,6,16.7%,20m
34339,1,JSJSJS,2346,0,0,1,1,0.0%,3h
34339,1,Tigerush,2346,0,0,2,2,0.0%,39m
34364,3,Axy,2345,1051,242,223,465,52.0%,44m
34364,3,WillSurf,2345,1534,196,189,385,50.9%,2h
34364,2,blogzor,2345,1442,152,159,311,48.9%,34m
34364,2,likmedik,2345,1399,147,141,288,51.0%,18m
34364,3,picatrix,2345,918,134,135,269,49.8%,2h
34364,3,Mollyarty,2345,1438,86,89,175,49.1%,36m
34364,1,CYPH,2345,1085,60,50,110,54.5%,2h
34364,1,Diegojafth,2345,980,41,27,68,60.3%,3h
34364,1,Ian,2345,859,36,19,55,65.5%,2h
34364,1,betelgeuse,2345,694,23,14,37,62.2%,2h
34364,3,JKILLA,2345,542,22,14,36,61.1%,30m
34364,1,sOsOmOn,2345,695,22,15,37,59.5%,37m
34364,1,bitfighter,2345,377,15,14,29,51.7%,14m
34364,1,Giafar,2345,398,10,5,15,66.7%,2h
34364,1,[SWOU]Radamanthys,2345,190,6,4,10,60.0%,10m
34364,1,Slartibart,2345,206,6,6,12,50.0%,2h
34364,1,[Carton]elmamao,2345,156,5,4,9,55.6%,2h
34364,1,Snake,2345,141,3,1,4,75.0%,2h
34364,1,vooz,2345,126,3,5,8,37.5%,27m
34364,3,Arostegui,2345,139,3,7,10,30.0%,2h
34364,3,sbmc,2345,90,3,8,11,27.3%,22m
34364,1,RAMX,2345,44,2,0,2,100.0%,7m
34364,1,fredmar,2345,42,2,3,5,40.0%,3h
34364,1,mArK,2345,48,2,5,7,28.6%,2h
34364,1,CrabKake,2345,0,2,6,8,25.0%,34m
34364,1,[FAKUU]Molicopter,2345,0,1,1,2,50.0%,4m
34364,1,Inkling,2345,0,1,4,5,20.0%,3m
34364,1,PizzaTheHut,2345,0,1,4,5,20.0%,30m
34364,1,[xXGDXx]joel,2345,0,0,1,1,0.0%,13m
34364,1,nilgara,2345,0,0,3,3,0.0%,19m
34394,3,NECRON,2344,585,59,45,104,56.7%,46m
34394,3,Framarlon,2344,1559,58,62,120,48.3%,1h
34394,2,Borne,2344,657,44,52,96,45.8%,23m
34394,1,EARL,2344,987,37,29,66,56.1%,23m
34394,3,[DFWU]Caveman,2344,766,36,28,64,56.2%,36m
34394,1,Matt,2344,797,36,39,75,48.0%,2h
34394,1,Creisler,2344,637,32,26,58,55.2%,2h
34394,1,Warp,2344,992,31,29,60,51.7%,21m
34394,3,rocio,2344,333,27,32,59,45.8%,2h
34394,1,amoelpan,2344,643,26,18,44,59.1%,2h
34394,3,renatotrool,2344,432,16,18,34,47.1%,36m
34394,3,Roro,2344,377,13,11,24,54.2%,47m
34394,3,Jagermester,2344,238,8,12,20,40.0%,35m
34394,1,grecoman,2344,278,8,27,35,22.9%,2h
34394,1,Ginonino,2344,296,7,8,15,46.7%,27m
34394,3,Reddlake,2344,239,7,10,17,41.2%,30m
34394,1,HiddenEmber,2344,212,6,3,9,66.7%,3h
34394,1,Alfredoo,2344,242,6,8,14,42.9%,2h
34394,1,Reyko,2344,260,6,9,15,40.0%,2h
34394,3,Murtage,2344,145,6,10,16,37.5%,36m
34394,3,Theivan,2344,189,5,6,11,45.5%,12m
34394,1,ZzzangelzzZ,2344,176,4,6,10,40.0%,1m
34394,1,[101001]Archetype,2344,44,2,0,2,100.0%,45m
34394,3,[TNTRED]mrfister,2344,121,2,4,6,33.3%,28m
34394,3,CPTJARREL,2344,96,2,5,7,28.6%,2h
34394,1,DraZec,2344,0,2,6,8,25.0%,2h
34394,3,WillTao,2344,60,2,11,13,15.4%,2h
34394,1,Flickshot,2344,58,2,20,22,9.1%,2h
34394,1,[ROS8th]Butter,2344,97,1,2,3,33.3%,22m
34394,1,Edu,2344,48,1,2,3,33.3%,26m
34394,1,[catcat]Matthew,2344,44,1,4,5,20.0%,14m
34394,1,Somniadolor,2344,0,1,4,5,20.0%,38m
34394,3,ThirteenEn,2344,0,1,5,6,16.7%,20m
34394,1,[2nd]VandeZande,2344,0,0,1,1,0.0%,2h
34394,1,[G79]NeoRemnant,2344,0,0,1,1,0.0%,21m
34394,1,xSkyEater,2344,0,0,1,1,0.0%,2h
34394,1,Watty,2344,0,0,2,2,0.0%,2h
34431,1,Cartush,2343,1886,256,255,511,50.1%,40m
34431,1,TeloPongo,2343,1298,123,118,241,51.0%,22m
34431,2,[Hayze]RONALDO,2343,898,123,129,252,48.8%,18m
34431,3,liljohnnyjr,2343,642,121,126,247,49.0%,22m
34431,1,Livingston,2343,1701,90,79,169,53.3%,3h
34431,3,Zepol,2343,1373,89,80,169,52.7%,44m
34431,3,Zalem,2343,1123,60,54,114,52.6%,2h
34431,3,azure,2343,718,27,33,60,45.0%,26m
34431,1,Yossarian,2343,568,21,26,47,44.7%,28m
34431,1,Sputnik,2343,506,15,9,24,62.5%,43m
34431,1,[THBF]Kawaii,2343,338,12,8,20,60.0%,2h
34431,1,Pagonas,2343,388,11,11,22,50.0%,2h
34431,3,Rain,2343,190,8,8,16,50.0%,36m
34431,1,turkNluck,2343,250,6,3,9,66.7%,52m
34431,2,[GgARMY]Jardshock,2343,158,6,4,10,60.0%,2h
34431,3,CiroGames,2343,142,6,7,13,46.2%,2h
34431,2,reaper,2343,120,6,11,17,35.3%,2h
34431,1,lucK,2343,172,5,1,6,83.3%,10m
34431,3,[CPN]JERSEYKING,2343,127,4,7,11,36.4%,13m
34431,3,[JAAM]JAAM,2343,122,4,8,12,33.3%,5m
34431,1,[Gesos]leetlankan,2343,130,3,3,6,50.0%,3h
34431,3,WackyMallard,2343,58,3,5,8,37.5%,2h
34431,3,Ralpcz,2343,135,3,7,10,30.0%,41m
34431,1,luquoo,2343,92,2,0,2,100.0%,21m
34431,1,[PobSC]Rasghul,2343,84,2,4,6,33.3%,9m
34431,1,Lawrencio,2343,97,2,5,7,28.6%,39m
34431,3,Allanlima,2343,97,2,6,8,25.0%,35m
34431,1,Havaron,2343,0,2,7,9,22.2%,2h
34431,1,MOSHE,2343,0,1,0,1,100.0%,2h
34431,2,Tooka,2343,0,0,1,1,0.0%,2h
34431,1,FunkyMonk,2343,0,0,1,1,0.0%,2h
34431,1,birby,2343,0,0,1,1,0.0%,27m
34431,1,Nate,2343,0,0,2,2,0.0%,2h
34464,3,Gatts,2342,1421,169,169,338,50.0%,17m
34464,2,[C31081]JackAttack,2342,831,144,145,289,49.8%,2h
34464,3,Byte,2342,1393,141,140,281,50.2%,2h
34464,1,Tripp,2342,1446,73,69,142,51.4%,44m
34464,3,locopangolin,2342,1183,49,43,92,53.3%,26m
34464,2,nemostar,2342,666,34,47,81,42.0%,22m
34464,1,[M1V1P]Immortal,2342,714,25,10,35,71.4%,2h
34464,3,mhaley,2342,549,23,17,40,57.5%,41m
34464,1,MaxUltron,2342,514,14,10,24,58.3%,2h
34464,3,Andrinea,2342,405,14,15,29,48.3%,3h
34464,1,DevilDog,2342,391,11,12,23,47.8%,25m
34464,1,Swimmer,2342,381,10,9,19,52.6%,2h
34464,3,popsodaguy,2342,247,9,5,14,64.3%,19m
34464,1,jacklow,2342,250,7,2,9,77.8%,43m
34464,2,Jehielbv,2342,202,7,14,21,33.3%,28m
34464,1,KingGlock,2342,141,5,8,13,38.5%,50m
34464,1,Blackhole,2342,97,3,3,6,50.0%,2h
34464,3,breistar,2342,34,3,8,11,27.3%,36m
34464,1,[NM8]XcrixosX,2342,0,1,0,1,100.0%,2h
34464,1,alittleasia,2342,0,1,4,5,20.0%,2h
34464,3,Bondy,2342,30,1,5,6,16.7%,2h
34464,1,solarknight,2342,42,1,6,7,14.3%,1h
34464,1,[JusfFF]SoPlayNet,2342,0,0,1,1,0.0%,2h
34464,1,dieZomby,2342,0,0,1,1,0.0%,2h
34464,3,[Kako]Charguy,2342,0,0,9,9,0.0%,19m
34489,3,imer,2341,1521,166,157,323,51.4%,35m
34489,3,ElGordoT,2341,1228,53,44,97,54.6%,2h
34489,1,DanTran,2341,1336,45,38,83,54.2%,2h
34489,3,[Mooky]Jibblewagon,2341,337,32,20,52,61.5%,31m
34489,1,Galimatías,2341,904,28,25,53,52.8%,25m
34489,3,grypsus,2341,652,26,24,50,52.0%,15m
34489,3,Bavatar,2341,598,21,19,40,52.5%,15m
34489,3,Devastador,2341,597,21,24,45,46.7%,2h
34489,1,Biaggio,2341,715,21,24,45,46.7%,14m
34489,1,gui,2341,263,10,15,25,40.0%,2h
34489,1,Albard,2341,349,8,4,12,66.7%,2h
34489,3,thyme,2341,236,8,12,20,40.0%,2h
34489,3,fercho,2341,204,8,14,22,36.4%,2h
34489,3,Thalson,2341,177,5,9,14,35.7%,1h
34489,1,[C4Max]Jovani,2341,185,5,16,21,23.8%,22m
34489,1,Locust,2341,84,3,1,4,75.0%,2h
34489,1,[BUTTES]Distracted,2341,143,3,5,8,37.5%,2h
34489,3,Torneko,2341,0,2,5,7,28.6%,2h
34489,1,KelesoKMS,2341,0,1,1,2,50.0%,8m
34489,1,Dragonmaster,2341,0,1,5,6,16.7%,2h
34489,1,lazerbrain,2341,0,0,1,1,0.0%,10m
34489,1,[PrknQl]Spektras,2341,0,0,1,1,0.0%,50m
34489,1,swoohn,2341,0,0,1,1,0.0%,2h
34489,1,ChubbyPanda,2341,0,0,2,2,0.0%,2h
34489,1,VPom,2341,0,0,3,3,0.0%,2h
34489,1,thregg,2341,0,0,4,4,0.0%,2h
34515,1,[TSBr2]ShangTsung,2340,1799,144,151,295,48.8%,50m
34515,3,MDoGG,2340,1518,83,77,160,51.9%,2h
34515,3,[Pirobo]CareGuama,2340,887,34,31,65,52.3%,29m
34515,1,BoonesZoomie,2340,622,19,22,41,46.3%,24m
34515,3,[LOHe]DEMNTE,2340,353,14,20,34,41.2%,2h
34515,3,RAMOHC,2340,346,13,13,26,50.0%,12m
34515,3,Crown,2340,258,12,9,21,57.1%,2h
34515,3,[D4AUC]ClanTiger,2340,186,8,11,19,42.1%,5m
34515,1,FrankCf,2340,272,7,9,16,43.8%,2h
34515,3,Chaingunsaw,2340,76,4,9,13,30.8%,7m
34515,1,ElmerQrio,2340,0,3,2,5,60.0%,19m
34515,1,Archimago,2340,170,3,4,7,42.9%,2h
34515,2,Davilongo,2340,94,3,8,11,27.3%,45m
34515,1,EadG,2340,44,2,0,2,100.0%,2h
34515,1,GLADIADORvVv,2340,42,2,1,3,66.7%,24m
34515,1,matt,2340,128,2,5,7,28.6%,3m
34515,1,PalitoPele,2340,0,1,0,1,100.0%,5m
34515,3,EMizzle,2340,97,1,2,3,33.3%,1h
34515,3,nallymeister,2340,0,1,4,5,20.0%,2h
34515,3,Starlord,2340,32,1,4,5,20.0%,2m
34515,1,Durrpah,2340,73,1,5,6,16.7%,2h
34515,1,Estympy,2340,0,0,1,1,0.0%,35m
34537,1,Xitch,2339,663,56,47,103,54.4%,3h
34537,2,spiderpig,2339,1043,39,43,82,47.6%,34m
34537,3,dellano,2339,641,36,36,72,50.0%,3h
34537,3,Atreides,2339,522,20,18,38,52.6%,15m
34537,1,Pumpkin,2339,266,7,4,11,63.6%,40m
34537,3,samanticz,2339,86,7,5,12,58.3%,36m
34537,1,IchimaruGin,2339,210,6,8,14,42.9%,2h
34537,1,MrMurder,2339,164,5,4,9,55.6%,12m
34537,3,Crocop,2339,178,5,9,14,35.7%,44m
34537,3,[BlTEL]glaurung,2339,130,4,2,6,66.7%,47m
34537,1,[Awiiir]Engrim,2339,88,3,2,5,60.0%,2h
34537,1,[We5uck]Homeboy,2339,97,3,3,6,50.0%,1h
34537,1,iffysolution,2339,88,2,1,3,66.7%,2h
34537,1,PerfectDay,2339,0,2,3,5,40.0%,33m
34537,2,MagmaShark,2339,44,2,3,5,40.0%,11m
34537,1,Cephiro,2339,82,2,6,8,25.0%,2h
34537,1,Barange,2339,0,2,6,8,25.0%,2h
34537,1,Yosoytupapi,2339,48,1,2,3,33.3%,2h
34537,1,Jellobomber,2339,0,1,4,5,20.0%,2h
34537,1,Entropy,2339,0,1,5,6,16.7%,2h
34537,3,[WarLT]illidam,2339,22,1,8,9,11.1%,2h
34537,1,[PATM]SirCharles,2339,0,0,1,1,0.0%,2h
34537,3,Gourdo,2339,0,0,2,2,0.0%,29m
34537,2,[PY]Uil,2339,0,0,2,2,0.0%,2h
34561,3,Touchme,2338,1072,60,53,113,53.1%,2h
34561,1,superman,2338,832,55,54,109,50.5%,40m
34561,2,Jtsnow,2338,1012,37,44,81,45.7%,7m
34561,1,PrinCz,2338,724,26,17,43,60.5%,35m
34561,1,Astroguy,2338,582,23,25,48,47.9%,50m
34561,3,KazaGontae,2338,235,18,20,38,47.4%,2h
34561,3,ZergBJsFTL,2338,372,14,22,36,38.9%,52m
34561,3,KNIGHT,2338,306,13,17,30,43.3%,47m
34561,3,Dirtstick,2338,147,7,5,12,58.3%,2h
34561,3,AJay,2338,86,5,15,20,25.0%,33m
34561,1,Dufflit,2338,162,4,1,5,80.0%,2h
34561,1,Breakthree,2338,48,4,2,6,66.7%,2h
34561,3,albatoss,2338,166,4,2,6,66.7%,2h
34561,2,[iRQ]Clark,2338,140,4,9,13,30.8%,2h
34561,1,Smalls,2338,86,3,3,6,50.0%,52m
34561,3,ELPAPAS,2338,145,3,7,10,30.0%,15m
34561,1,WilsonPlay,2338,42,2,3,5,40.0%,2h
34561,2,Padraic,2338,0,2,5,7,28.6%,34m
34561,3,Cisio,2338,119,2,5,7,28.6%,5m
34561,2,Monstrum,2338,0,2,5,7,28.6%,2h
34561,1,CamoKat,2338,0,1,0,1,100.0%,2h
34561,1,[fap69]MaKySan,2338,0,1,2,3,33.3%,50m
34561,1,BardiaElBard,2338,0,1,4,5,20.0%,2h
34561,1,Charcoal,2338,0,1,4,5,20.0%,7m
34561,1,Aurelicus,2338,0,0,1,1,0.0%,2h
34586,2,nurek,2337,1173,107,116,223,48.0%,6m
34586,2,Bigmichael,2337,1507,91,79,170,53.5%,36m
34586,2,[R4NK3D]BJDSR,2337,1543,83,85,168,49.4%,34m
34586,1,Pingu,2337,599,61,60,121,50.4%,2h
34586,1,HotMikeNFS,2337,808,47,34,81,58.0%,2h
34586,3,[RogueW]PookieWon,2337,541,42,23,65,64.6%,2h
34586,3,[Elit3C]SwankyPants,2337,397,23,26,49,46.9%,2h
34586,3,Baker,2337,624,23,30,53,43.4%,3h
34586,3,tptsmith,2337,285,16,20,36,44.4%,17m
34586,3,[DRKDNA]Lythander,2337,392,15,17,32,46.9%,2h
34586,3,Cristigamer,2337,184,7,14,21,33.3%,36m
34586,3,lLuisdwtl,2337,148,5,4,9,55.6%,3h
34586,1,Fatcat,2337,121,5,5,10,50.0%,2h
34586,1,YtterbiumRoc,2337,132,4,2,6,66.7%,24m
34586,1,KingMercer,2337,58,4,9,13,30.8%,50m
34586,3,LargePizza,2337,0,3,3,6,50.0%,2h
34586,1,Nstaff,2337,97,3,3,6,50.0%,27m
34586,1,Cupofpie,2337,42,1,2,3,33.3%,44m
34586,1,KEONS,2337,0,1,2,3,33.3%,15m
34586,3,eXiled,2337,0,1,2,3,33.3%,5m
34586,1,Soupy,2337,0,1,4,5,20.0%,42m
34586,1,Gobalt,2337,0,0,1,1,0.0%,15m
34586,1,GOSUreforged,2337,0,0,2,2,0.0%,15m
34586,1,[seattl]Arock,2337,0,0,4,4,0.0%,33m
34610,3,RogueDragon,2336,1547,212,198,410,51.7%,2h
34610,3,WolfEkins,2336,1281,72,67,139,51.8%,2h
34610,3,josheroo,2336,1334,53,58,111,47.7%,15m
34610,2,tbird,2336,1324,49,57,106,46.2%,19m
34610,3,artanis,2336,1289,47,47,94,50.0%,27m
34610,1,[TROLL]DarkWnd,2336,670,43,48,91,47.3%,2h
34610,1,Mike,2336,1038,31,31,62,50.0%,40m
34610,3,[Cadre]Toc,2336,598,24,26,50,48.0%,26m
34610,3,[0825]blackjezus,2336,502,21,12,33,63.6%,50m
34610,1,starkilla,2336,600,15,13,28,53.6%,24m
34610,1,Dadbod,2336,361,10,11,21,47.6%,2h
34610,3,Anubis,2336,290,10,12,22,45.5%,2h
34610,1,ACR,2336,326,8,5,13,61.5%,2h
34610,3,StarAnkh,2336,268,8,11,19,42.1%,27m
34610,3,ECLIPSAUN,2336,200,7,12,19,36.8%,2h
34610,1,Bhizzle,2336,168,6,4,10,60.0%,2h
34610,3,Fontenele,2336,147,4,7,11,36.4%,53m
34610,1,Aros,2336,0,3,2,5,60.0%,2h
34610,1,jrl,2336,132,3,4,7,42.9%,2h
34610,1,Orcson,2336,90,2,3,5,40.0%,2h
34610,1,photon,2336,0,2,4,6,33.3%,2h
34610,1,SchultesZ,2336,0,1,2,3,33.3%,2h
34610,1,JRoh,2336,0,1,3,4,25.0%,2h
34610,1,Chipper,2336,48,1,7,8,12.5%,22m
34610,3,[Truce]ProPlayz,2336,0,0,1,1,0.0%,2h
34610,1,josepler,2336,0,0,3,3,0.0%,27m
34610,1,[BCU]ramuh,2336,0,0,3,3,0.0%,2h
34637,1,[MrSolo]pmanriquez,2335,895,68,68,136,50.0%,28m
34637,3,eidolon,2335,742,64,61,125,51.2%,2h
34637,3,bubblehead,2335,1599,61,69,130,46.9%,2h
34637,3,[FatMom]Jason,2335,1253,51,49,100,51.0%,50m
34637,1,TrickyKnight,2335,1242,41,48,89,46.1%,14m
34637,3,Scotter,2335,371,39,41,80,48.8%,50m
34637,2,nullnvoid,2335,848,31,34,65,47.7%,20m
34637,3,PoohBear,2335,347,16,16,32,50.0%,35m
34637,1,ian,2335,358,10,6,16,62.5%,2h
34637,1,AVA,2335,270,8,5,13,61.5%,7m
34637,2,askmenow,2335,203,7,11,18,38.9%,46m
34637,1,Mpopper,2335,218,6,5,11,54.5%,53m
34637,3,PixelNinja,2335,0,4,5,9,44.4%,27m
34637,3,andrea,2335,70,4,10,14,28.6%,2h
34637,1,Anacap,2335,84,3,3,6,50.0%,2h
34637,1,Renatexsctlv,2335,88,3,5,8,37.5%,2h
34637,1,ManoWar,2335,102,2,1,3,66.7%,3h
34637,1,[ZOOMOB]savage,2335,48,1,2,3,33.3%,48m
34637,2,maxent,2335,0,1,2,3,33.3%,48m
34637,1,Hertz,2335,0,1,4,5,20.0%,2h
34637,1,Draguito,2335,0,1,4,5,20.0%,40m
34637,1,PureJank,2335,44,1,5,6,16.7%,9m
34637,1,Blind,2335,0,1,5,6,16.7%,9m
34637,1,Chime,2335,0,0,1,1,0.0%,7m
34637,1,SoManyBees,2335,0,0,1,1,0.0%,2h
34637,1,vaportrail,2335,0,0,2,2,0.0%,3h
34637,1,xGekko,2335,0,0,2,2,0.0%,27m
34637,1,[Grayon]Alak,2335,0,0,2,2,0.0%,1m
34637,3,TheElite,2335,0,0,3,3,0.0%,44m
34666,3,TheOne,2334,648,61,47,108,56.5%,2h
34666,2,Blazing,2334,753,58,53,111,52.3%,13m
34666,3,Isaac,2334,288,37,31,68,54.4%,30m
34666,3,IrishJohn,2334,858,31,35,66,47.0%,15m
34666,3,[Pharoh]Innkeeper,2334,584,25,26,51,49.0%,44m
34666,3,Martinick,2334,440,17,15,32,53.1%,2h
34666,3,jeremiaz,2334,366,12,19,31,38.7%,17m
34666,3,Llanowarelf,2334,304,10,16,26,38.5%,2h
34666,1,Soapstone,2334,201,6,3,9,66.7%,53m
34666,1,stormshadow,2334,214,6,5,11,54.5%,2h
34666,1,Saundo,2334,156,5,2,7,71.4%,44m
34666,1,[TRFNTM]MrGrec,2334,176,5,4,9,55.6%,4m
34666,2,[RELAX]inyourhead,2334,172,5,5,10,50.0%,2h
34666,1,heirofp,2334,82,3,4,7,42.9%,17m
34666,1,Calo,2334,46,2,1,3,66.7%,2h
34666,1,AlphaOneIV,2334,111,2,3,5,40.0%,2h
34666,1,Cafezituz,2334,0,1,0,1,100.0%,2h
34666,3,ChemicalX,2334,30,1,1,2,50.0%,43m
34666,1,EndeTod,2334,44,1,3,4,25.0%,2h
34666,1,Blaik,2334,0,1,4,5,20.0%,26m
34666,1,Matybizarro,2334,0,1,4,5,20.0%,34m
34666,3,Xerdo,2334,30,1,9,10,10.0%,29m
34666,1,Arrilious,2334,0,0,1,1,0.0%,2h
34666,1,Tjbrown,2334,0,0,1,1,0.0%,2h
34666,1,BoBoFraggles,2334,0,0,2,2,0.0%,6m
34666,1,[1VE]WALEXN,2334,0,0,2,2,0.0%,38m
34666,3,Behbehbear,2334,0,0,5,5,0.0%,2h
34693,1,Doop,2333,1292,87,85,172,50.6%,2h
34693,3,BloodLeon,2333,1216,77,78,155,49.7%,2h
34693,3,BonesThGhost,2333,1301,77,80,157,49.0%,2h
34693,3,[SSkull]TDAUE,2333,499,55,50,105,52.4%,2h
34693,2,Aerxsi,2333,1488,53,65,118,44.9%,36m
34693,1,Augusto,2333,977,30,24,54,55.6%,2h
34693,2,[D666]psycko,2333,760,30,34,64,46.9%,36m
34693,3,GrimChipmunk,2333,520,22,22,44,50.0%,32m
34693,2,NiNJAxBiiGxT,2333,527,21,27,48,43.8%,2h
34693,3,FahrenHeit,2333,407,18,9,27,66.7%,29m
34693,1,spaceman,2333,639,17,12,29,58.6%,2h
34693,1,Monolicho,2333,505,13,11,24,54.2%,39m
34693,1,ashrigo,2333,315,13,19,32,40.6%,2h
34693,1,loser,2333,363,10,8,18,55.6%,10m
34693,3,Churcho,2333,295,10,9,19,52.6%,36m
34693,1,Anbespe,2333,206,9,13,22,40.9%,2h
34693,1,[DDCaea]lechetibia,2333,284,7,7,14,50.0%,25m
34693,2,masterfish,2333,193,7,21,28,25.0%,24m
34693,1,Ice,2333,193,5,5,10,50.0%,50m
34693,3,[Rona]batllebuddy,2333,119,4,5,9,44.4%,2h
34693,3,CKArakawa,2333,155,4,6,10,40.0%,1h
34693,1,Mike,2333,120,4,9,13,30.8%,2h
34693,1,BazookaFace,2333,140,3,1,4,75.0%,2h
34693,3,[ISNULL]MajorOwnage,2333,136,3,8,11,27.3%,13m
34693,3,[bolsac]Fyrebrand,2333,121,2,4,6,33.3%,26m
34693,3,[EPCK]anchante,2333,0,2,5,7,28.6%,40m
34693,3,Dark,2333,30,2,6,8,25.0%,19m
34693,1,[lDawNl]Amooki,2333,0,1,0,1,100.0%,2h
34693,1,SpeedyGee,2333,0,1,0,1,100.0%,38m
34693,1,PEKMAN,2333,0,1,0,1,100.0%,2h
34693,1,PotatoMan,2333,0,1,1,2,50.0%,46m
34693,1,[Hormig]Josecarlos,2333,0,1,1,2,50.0%,2h
34693,1,Manipapa,2333,0,1,2,3,33.3%,2h
34693,1,Dovakin,2333,0,1,4,5,20.0%,34m
34693,1,iownuandu,2333,0,0,1,1,0.0%,2h
34728,2,PotterxD,2332,1191,74,66,140,52.9%,2h
34728,3,Rhyno,2332,1561,60,63,123,48.8%,2h
34728,3,[IBIU]Shadow,2332,1365,51,52,103,49.5%,13m
34728,1,WarBob,2332,1076,42,38,80,52.5%,5m
34728,1,Dbaze,2332,956,28,29,57,49.1%,27m
34728,2,lightpure,2332,480,18,21,39,46.2%,2h
34728,3,pyro,2332,328,12,17,29,41.4%,44m
34728,3,DeepFireCola,2332,241,10,4,14,71.4%,2h
34728,3,Tyman,2332,302,10,11,21,47.6%,2h
34728,3,Lucius,2332,181,9,11,20,45.0%,2h
34728,1,[Khillr]BadBoyRoRo,2332,277,8,8,16,50.0%,15m
34728,1,Fenix,2332,224,7,1,8,87.5%,3h
34728,1,VisualSlinky,2332,170,6,3,9,66.7%,2h
34728,1,uRpLeZ,2332,126,4,2,6,66.7%,33m
34728,2,magboat,2332,149,4,8,12,33.3%,20m
34728,1,Kendor,2332,174,4,9,13,30.8%,17m
34728,1,luis,2332,42,2,1,3,66.7%,3h
34728,1,BlothimGor,2332,80,2,3,5,40.0%,2h
34728,1,ryanogryan,2332,88,2,3,5,40.0%,2h
34728,3,Poison,2332,0,2,4,6,33.3%,2h
34728,2,[ClanK]Narwhal,2332,92,2,6,8,25.0%,46m
34728,3,troyanos,2332,30,2,9,11,18.2%,2h
34728,1,[C57640]EvolvedMatt,2332,0,1,0,1,100.0%,2h
34728,1,[Biden]Joe,2332,48,1,2,3,33.3%,7m
34728,1,[VISNZ]XIIIPyrotek,2332,0,0,1,1,0.0%,2h
34728,3,Heeonit,2332,0,0,7,7,0.0%,1h
34754,3,[LOHd]AlraK,2331,1104,47,45,92,51.1%,2h
34754,3,GioCrimi,2331,401,39,39,78,50.0%,2h
34754,1,Sarge,2331,691,18,14,32,56.2%,2h
34754,1,[CobraC]Destro,2331,462,13,11,24,54.2%,2h
34754,1,FunkyPants,2331,453,12,10,22,54.5%,14m
34754,3,mizu,2331,337,12,11,23,52.2%,47m
34754,1,LetterW,2331,343,11,17,28,39.3%,2h
34754,3,Titan,2331,220,7,13,20,35.0%,2h
34754,2,Gyro,2331,129,6,5,11,54.5%,48m
34754,1,camionsito,2331,132,4,3,7,57.1%,2h
34754,1,tadashi,2331,0,3,3,6,50.0%,2h
34754,1,[GTFO]Hyperon,2331,46,2,2,4,50.0%,44m
34754,1,InvoquerM,2331,42,2,5,7,28.6%,50m
34754,2,KalTar,2331,121,2,10,12,16.7%,1h
34754,1,[SI4yeR]Redjohn,2331,44,1,1,2,50.0%,2h
34754,1,[BPV1]GamerGirl,2331,0,1,4,5,20.0%,2h
34754,3,demth,2331,0,1,4,5,20.0%,50m
34754,1,Zack,2331,0,1,5,6,16.7%,3h
34754,3,Mosh,2331,30,1,8,9,11.1%,29m
34754,1,Lockbox,2331,0,0,1,1,0.0%,2h
34754,1,euphoria,2331,0,0,1,1,0.0%,3h
34754,1,Invictus,2331,0,0,1,1,0.0%,15m
34754,1,EpicGamer,2331,73,0,3,3,0.0%,2h
34777,3,JMAN,2330,1266,73,77,150,48.7%,1h
34777,3,Sucafish,2330,1056,50,51,101,49.5%,32m
34777,3,[PG101]LilChungis,2330,1026,48,45,93,51.6%,27m
34777,3,PEEpee,2330,1226,46,50,96,47.9%,29m
34777,1,JSAA,2330,1283,44,41,85,51.8%,2h
34777,1,DrPootytang,2330,1200,40,38,78,51.3%,38m
34777,3,MisterViau,2330,843,32,34,66,48.5%,47m
34777,1,orellanag,2330,723,21,17,38,55.3%,1h
34777,3,Cryptic,2330,517,19,19,38,50.0%,2h
34777,1,Pipeline,2330,479,13,18,31,41.9%,10m
34777,3,Punisher,2330,146,6,4,10,60.0%,37m
34777,1,Tommy,2330,226,5,4,9,55.6%,53m
34777,1,JERSTAR,2330,0,4,1,5,80.0%,28m
34777,1,HeWhoKnows,2330,164,4,8,12,33.3%,2h
34777,3,[MisW]GurthyGreg,2330,58,3,5,8,37.5%,5m
34777,1,[BCRUSE]Phil,2330,44,2,3,5,40.0%,25m
34777,1,getblamed,2330,48,2,5,7,28.6%,46m
34777,3,Aleksandr,2330,0,1,5,6,16.7%,20m
34777,1,Nomada,2330,0,0,1,1,0.0%,2h
34796,2,BABYone,2329,1188,146,147,293,49.8%,13m
34796,1,methodman,2329,1002,34,26,60,56.7%,2h
34796,1,alien,2329,788,27,15,42,64.3%,2h
34796,1,shinkansen,2329,783,25,16,41,61.0%,2h
34796,3,[Cntz]Chewy,2329,319,10,9,19,52.6%,2h
34796,1,Hotdog,2329,362,9,9,18,50.0%,7m
34796,1,Alphacrux,2329,234,7,9,16,43.8%,45m
34796,1,derp,2329,205,7,10,17,41.2%,2h
34796,1,sabalj,2329,214,5,7,12,41.7%,2h
34796,3,Hsnake,2329,0,3,5,8,37.5%,2h
34796,3,Bernie,2329,30,3,5,8,37.5%,30m
34796,1,Arctanis,2329,42,2,0,2,100.0%,40m
34796,3,DaggerRPM,2329,0,1,0,1,100.0%,43m
34796,1,Edwardo,2329,0,1,0,1,100.0%,2h
34796,1,ChiMartian,2329,0,1,0,1,100.0%,45m
34796,1,Schwardix,2329,42,1,2,3,33.3%,3h
34796,1,Ryeezy,2329,0,1,4,5,20.0%,2h
34796,3,tshot,2329,0,1,6,7,14.3%,2h
34796,1,boss,2329,0,0,1,1,0.0%,15m
34796,1,Shrug,2329,0,0,1,1,0.0%,38m
34816,2,Karna,2328,1090,169,168,337,50.1%,2h
34816,3,ozuwarudo,2328,1021,85,79,164,51.8%,15m
34816,1,danielfranco,2328,1335,47,45,92,51.1%,44m
34816,3,Reverence,2328,1230,46,52,98,46.9%,2h
34816,1,lacontraseña,2328,890,33,47,80,41.2%,2h
34816,1,[SWOU]Bregains,2328,602,20,15,35,57.1%,2h
34816,1,RentIsDue,2328,442,11,15,26,42.3%,44m
34816,2,CEleven,2328,286,11,17,28,39.3%,2h
34816,1,Mullhaulen,2328,406,10,10,20,50.0%,28m
34816,1,[ZergPE]Atherionte,2328,314,9,4,13,69.2%,44m
34816,2,chipermonkey,2328,270,8,12,20,40.0%,2h
34816,3,jakesbar,2328,275,8,12,20,40.0%,28m
34816,3,ThePhantom,2328,186,7,12,19,36.8%,3h
34816,2,Toomral,2328,163,5,3,8,62.5%,46m
34816,3,Riggs,2328,147,4,8,12,33.3%,41m
34816,1,SirCornmeal,2328,173,4,9,13,30.8%,2h
34816,3,Jaihen,2328,30,3,5,8,37.5%,15m
34816,3,[prise]Drako,2328,127,3,6,9,33.3%,2m
34816,2,Aguaciel,2328,30,3,7,10,30.0%,3h
34816,2,james,2328,102,2,1,3,66.7%,2h
34816,3,Glipys,2328,0,2,6,8,25.0%,2h
34816,1,Deadlife,2328,0,1,0,1,100.0%,1h
34816,1,[Oshyn]Chiefsito,2328,0,1,0,1,100.0%,4m
34816,1,Misio,2328,0,1,1,2,50.0%,2h
34816,1,Ernietitmoos,2328,0,1,4,5,20.0%,3h
34816,1,Vexationz,2328,0,1,4,5,20.0%,35m
34816,1,sponsorable,2328,0,1,5,6,16.7%,19m
34816,1,[DarkPG]Platino,2328,0,0,2,2,0.0%,51m
34816,3,[BnZi]Winfestor,2328,0,0,4,4,0.0%,52m
34816,3,Pisnug,2328,0,0,6,6,0.0%,2h
34816,2,GusElMacho,2328,0,0,6,6,0.0%,2h
34847,1,[CRRSCS]VikingoChain,2327,1562,187,203,390,47.9%,3h
34847,1,Shunzilla,2327,1765,149,144,293,50.9%,2h
34847,3,Sherlock,2327,1476,107,98,205,52.2%,2h
34847,2,[cluez]royery,2327,1537,73,72,145,50.3%,2h
34847,1,[NwAs]KKaIZeR,2327,979,35,29,64,54.7%,15m
34847,1,Crackaa,2327,1010,30,36,66,45.5%,50m
34847,3,deeznutz,2327,789,29,33,62,46.8%,52m
34847,3,protwolf,2327,678,23,26,49,46.9%,3h
34847,1,RjBa,2327,551,19,20,39,48.7%,2h
34847,3,Pitts,2327,501,18,19,37,48.6%,32m
34847,1,Reivax,2327,572,16,15,31,51.6%,21m
34847,1,Mrowsudyn,2327,462,15,17,32,46.9%,2h
34847,1,Jm,2327,429,13,4,17,76.5%,4m
34847,3,[GLHFGG]Wake,2327,322,13,18,31,41.9%,2h
34847,1,AgentZero,2327,278,11,15,26,42.3%,2h
34847,3,Chilongo,2327,328,10,14,24,41.7%,2h
34847,1,CaptainSiek,2327,281,9,11,20,45.0%,53m
34847,1,Ender,2327,204,9,13,22,40.9%,50m
34847,2,GaboHero,2327,274,8,17,25,32.0%,6m
34847,1,SoulTrigger,2327,176,7,6,13,53.8%,24m
34847,3,[DEREZZ]ACM,2327,146,5,10,15,33.3%,1h
34847,1,[LOHd]Liam,2327,68,4,8,12,33.3%,3h
34847,3,Xlaw,2327,60,3,9,12,25.0%,2h
34847,1,Mynok,2327,46,2,1,3,66.7%,9m
34847,1,dTeksta,2327,0,2,5,7,28.6%,2h
34847,1,matadorx,2327,42,2,5,7,28.6%,2h
34847,1,[AbcCo]sopaxx,2327,42,1,1,2,50.0%,2h
34847,1,Walloflight,2327,96,1,1,2,50.0%,2h
34847,1,geeekdup,2327,0,1,5,6,16.7%,2h
34847,3,[Milkyy]decurion,2327,0,0,2,2,0.0%,2h
34877,3,jonrocks,2326,1134,87,83,170,51.2%,2h
34877,3,sbroker,2326,1610,82,81,163,50.3%,2h
34877,3,Vergueta,2326,1020,48,44,92,52.2%,2h
34877,2,talentless,2326,1065,48,50,98,49.0%,46m
34877,3,VETIVE,2326,1140,42,47,89,47.2%,2h
34877,2,AndrossTrue,2326,830,39,45,84,46.4%,19m
34877,1,Maru,2326,850,28,23,51,54.9%,2h
34877,3,Onerb,2326,626,24,32,56,42.9%,17m
34877,1,ShoeBomb,2326,687,21,21,42,50.0%,40m
34877,1,Phinks,2326,577,21,27,48,43.8%,2h
34877,1,Hiperion,2326,593,17,12,29,58.6%,45m
34877,3,Lonestar,2326,202,7,11,18,38.9%,15m
34877,3,MORIYA,2326,121,5,5,10,50.0%,2h
34877,2,Dorghul,2326,60,5,7,12,41.7%,2h
34877,1,[FalPal]Zanwaan,2326,132,4,6,10,40.0%,2h
34877,3,Hideonbarrel,2326,92,3,7,10,30.0%,2h
34877,3,Reventian,2326,86,3,9,12,25.0%,15m
34877,2,GlassCannon,2326,44,3,9,12,25.0%,2h
34877,1,Hanxy,2326,145,2,1,3,66.7%,50m
34877,1,GaryRules,2326,155,2,2,4,50.0%,45m
34877,1,oetamodel,2326,0,1,1,2,50.0%,13m
34877,1,[TAPERS]vonmanstein,2326,48,1,3,4,25.0%,19m
34877,2,[sg24]JackofIce,2326,38,1,3,4,25.0%,2h
34877,1,TossZeRang,2326,0,1,4,5,20.0%,3h
34877,1,Hyper,2326,0,1,4,5,20.0%,2h
34877,1,Banicent,2326,0,1,4,5,20.0%,4m
34877,1,heavycheese,2326,0,0,1,1,0.0%,2h
34904,2,[SWOU]JEFESAPO,2325,1274,230,226,456,50.4%,2h
34904,1,ciberninja,2325,1456,130,139,269,48.3%,14m
34904,1,TUMACHO,2325,1738,81,76,157,51.6%,21m
34904,3,Anonymous,2325,940,34,39,73,46.6%,2h
34904,2,sprayden,2325,422,29,38,67,43.3%,7m
34904,1,brokenblind,2325,298,10,6,16,62.5%,14m
34904,3,[5689]darwar,2325,248,9,7,16,56.2%,44m
34904,1,sombra,2325,243,7,6,13,53.8%,39m
34904,1,Ghost,2325,210,7,11,18,38.9%,2h
34904,3,envokezYT,2325,140,6,14,20,30.0%,2h
34904,1,[T0T0]MikeSum,2325,170,5,4,9,55.6%,45m
34904,1,[GWM8]DandieGuy,2325,234,5,7,12,41.7%,3h
34904,3,foodyummy,2325,173,5,8,13,38.5%,20m
34904,1,elpadrino,2325,170,4,3,7,57.1%,2h
34904,2,zbird,2325,0,4,5,9,44.4%,41m
34904,3,[FatMom]Xenocide,2325,86,4,7,11,36.4%,46m
34904,1,Billetsteel,2325,132,3,6,9,33.3%,3h
34904,3,CrazySK,2325,121,3,7,10,30.0%,2h
34904,2,Patateka,2325,0,2,6,8,25.0%,2h
34904,1,Spartan,2325,0,1,0,1,100.0%,2h
34904,1,[PUF]brendan,2325,0,1,4,5,20.0%,2h
34904,1,Nice,2325,97,1,5,6,16.7%,15m
34904,3,FAMILYBARROS,2325,0,1,5,6,16.7%,2h
34904,3,Jackfrost,2325,30,1,6,7,14.3%,46m
34904,1,wacko,2325,0,0,1,1,0.0%,2h
34904,3,LPMuseFan,2325,0,0,1,1,0.0%,2h
34904,2,Hedu,2325,0,0,1,1,0.0%,2h
34904,1,[DaPeep]DarkBullet,2325,0,0,1,1,0.0%,2h
34904,1,ShinobI,2325,0,0,1,1,0.0%,45m
34904,1,Psinstein,2325,0,0,1,1,0.0%,15m
34904,1,xxxx,2325,0,0,2,2,0.0%,2h
34904,3,asomraze,2325,0,0,2,2,0.0%,1h
34904,3,Yayuenque,2325,0,0,7,7,0.0%,2h
34937,1,Eddy,2324,1574,204,199,403,50.6%,27m
34937,1,grantemplari,2324,1871,127,121,248,51.2%,3h
34937,1,Minji,2324,584,19,18,37,51.4%,10m
34937,3,cyril,2324,158,15,19,34,44.1%,47m
34937,2,Zappa,2324,381,14,19,33,42.4%,2h
34937,1,DhulQarnayn,2324,458,14,33,47,29.8%,19m
34937,2,TheMajor,2324,151,11,7,18,61.1%,4m
34937,1,Mariano,2324,300,9,11,20,45.0%,30m
34937,3,[4IUR]Ruzonfar,2324,178,6,11,17,35.3%,2h
34937,1,VickVinegar,2324,168,5,2,7,71.4%,2h
34937,1,[LWTB]Cheese,2324,174,4,5,9,44.4%,2h
34937,1,deloby,2324,128,3,5,8,37.5%,25m
34937,3,KaelSwan,2324,114,3,6,9,33.3%,2h
34937,3,ElBarto,2324,30,3,6,9,33.3%,2h
34937,1,DannyM,2324,86,2,3,5,40.0%,3h
34937,1,Shigeo,2324,0,2,5,7,28.6%,2h
34937,1,[SOOSK]dubFire,2324,0,1,1,2,50.0%,2h
34937,1,Kapnoc,2324,40,1,1,2,50.0%,7m
34937,1,redman,2324,0,1,4,5,20.0%,3h
34937,1,NightRaven,2324,0,0,1,1,0.0%,21m
34937,1,[Winsor]Magic,2324,0,0,1,1,0.0%,3h
34937,1,Syyrup,2324,0,0,1,1,0.0%,2h
34937,3,Boomheadshot,2324,0,0,2,2,0.0%,42m
34937,1,[69boyz]max,2324,0,0,4,4,0.0%,39m
34961,2,scouter,2323,943,167,177,344,48.5%,2h
34961,3,Crutches,2323,1533,80,80,160,50.0%,2h
34961,3,Lelk,2323,813,72,67,139,51.8%,2h
34961,3,[FiFF]Kwyjibo,2323,1108,55,55,110,50.0%,21m
34961,1,[ZvP]Bushidoninja,2323,963,37,51,88,42.0%,2h
34961,1,Zut,2323,864,26,23,49,53.1%,38m
34961,3,Aydo,2323,399,16,16,32,50.0%,28m
34961,1,CDogg,2323,478,15,36,51,29.4%,22m
34961,3,MeAndTheBoyS,2323,301,9,12,21,42.9%,2h
34961,1,mega,2323,163,4,2,6,66.7%,9m
34961,3,VIXCO,2323,0,4,3,7,57.1%,2h
34961,1,Daniel,2323,136,4,4,8,50.0%,45m
34961,1,DJHugo,2323,158,4,4,8,50.0%,2h
34961,1,PAGF,2323,80,3,2,5,60.0%,12m
34961,1,vonMises,2323,122,3,6,9,33.3%,52m
34961,1,[Sneaky]FrostyTheApe,2323,88,3,6,9,33.3%,1h
34961,3,[Ohboy]Nipsian,2323,95,2,1,3,66.7%,2h
34961,2,Zpoletita,2323,30,2,2,4,50.0%,2h
34961,1,Axeman,2323,0,2,3,5,40.0%,3h
34961,3,Ducky,2323,0,2,4,6,33.3%,30m
34961,1,Wroci,2323,48,2,6,8,25.0%,2h
34961,1,[DRKLRD]Jin,2323,0,1,0,1,100.0%,3h
34961,1,MoeMoe,2323,0,1,0,1,100.0%,2h
34961,1,Lichbich,2323,0,1,4,5,20.0%,15m
34961,1,DePyro,2323,0,1,6,7,14.3%,15m
34961,1,[ZSpawn]MrZealot,2323,0,0,1,1,0.0%,2h
34961,1,exogram,2323,0,0,2,2,0.0%,2h
34961,1,Austin,2323,0,0,3,3,0.0%,3h
34989,3,SweatStain,2322,1172,39,65,104,37.5%,31m
34989,3,STATS,2322,811,29,31,60,48.3%,30m
34989,1,Raiden,2322,593,23,14,37,62.2%,44m
34989,3,[d0ngZi]chaosjon,2322,398,14,20,34,41.2%,52m
34989,1,UltraKael,2322,467,12,10,22,54.5%,40m
34989,1,tommy,2322,236,8,8,16,50.0%,2h
34989,1,bobgui,2322,168,6,11,17,35.3%,2h
34989,1,FalconPunch,2322,176,5,6,11,45.5%,2h
34989,1,Deathwing,2322,132,4,1,5,80.0%,41m
34989,3,MURDERUS,2322,136,4,8,12,33.3%,2h
34989,1,GSWIZZLE,2322,122,3,4,7,42.9%,50m
34989,1,toro,2322,0,2,3,5,40.0%,8m
34989,1,[CRAKS]johnnyflores,2322,46,2,3,5,40.0%,24m
34989,1,optimuschwdr,2322,90,2,4,6,33.3%,51m
34989,3,Lithinos,2322,0,2,4,6,33.3%,2h
34989,2,Reven,2322,0,1,0,1,100.0%,2h
34989,1,[DKMC]Mercy,2322,0,1,1,2,50.0%,2h
34989,1,[Auth]Anthatar,2322,44,1,2,3,33.3%,13m
34989,1,SupremeWill,2322,48,1,2,3,33.3%,2h
34989,1,KamiRoku,2322,46,1,3,4,25.0%,2h
34989,1,schickdizzle,2322,0,1,3,4,25.0%,2h
34989,1,KanzakiHAria,2322,0,1,4,5,20.0%,2h
34989,1,Groveer,2322,0,1,5,6,16.7%,19m
34989,3,troy,2322,0,0,1,1,0.0%,2h
34989,1,Sagittarius,2322,0,0,3,3,0.0%,51m
35014,3,Beastman,2321,917,180,180,360,50.0%,1h
35014,1,malcolm,2321,917,133,117,250,53.2%,1h
35014,1,Demetro,2321,1230,75,72,147,51.0%,44m
35014,1,letal,2321,1507,54,43,97,55.7%,2h
35014,1,Eccentrix,2321,1229,42,43,85,49.4%,2h
35014,3,BBYAmuB,2321,647,24,30,54,44.4%,2h
35014,1,xXdanngXx,2321,621,22,14,36,61.1%,30m
35014,1,TheSnake,2321,502,15,15,30,50.0%,8m
35014,1,Exciel,2321,312,11,11,22,50.0%,2h
35014,1,Gefebus,2321,388,11,12,23,47.8%,51m
35014,1,Zestal,2321,349,10,5,15,66.7%,2h
35014,2,BARCODE,2321,221,10,8,18,55.6%,2h
35014,1,Monstro,2321,366,10,8,18,55.6%,34m
35014,2,DownSkyward,2321,259,9,11,20,45.0%,2h
35014,2,[M4nLUV]Insect,2321,238,8,6,14,57.1%,2h
35014,3,terrorblack,2321,206,8,7,15,53.3%,2h
35014,1,[fUUL]ChUcKDiEsEl,2321,188,6,5,11,54.5%,6m
35014,1,[420v69]ButtFeast,2321,0,5,2,7,71.4%,3m
35014,3,[LnR]Sprinter,2321,191,5,7,12,41.7%,2h
35014,1,CEO,2321,97,4,3,7,57.1%,2h
35014,1,juantrap,2321,97,3,2,5,60.0%,13m
35014,2,AMan,2321,164,3,6,9,33.3%,1h
35014,2,[dengue]WillisMeat,2321,80,3,8,11,27.3%,34m
35014,2,Tiketh,2321,34,3,8,11,27.3%,2h
35014,1,Butterburg,2321,40,2,1,3,66.7%,2h
35014,1,pretorale,2321,44,2,2,4,50.0%,2h
35014,1,[MacJu]BloodHound,2321,113,2,5,7,28.6%,3h
35014,1,NOC,2321,44,1,2,3,33.3%,2h
35014,1,Corto,2321,48,1,3,4,25.0%,5m
35014,1,Skittles,2321,0,1,4,5,20.0%,13m
35014,1,Hitman,2321,0,1,5,6,16.7%,2h
35014,1,[BBLINE]Kazzar,2321,0,1,5,6,16.7%,2h
35014,3,[II4WI]mcdoogs,2321,0,1,5,6,16.7%,2h
35014,1,oOGoSuOo,2321,0,0,1,1,0.0%,2h
35014,1,CycloneFire,2321,0,0,1,1,0.0%,27m
35014,1,[4bronz]Heirarch,2321,0,0,1,1,0.0%,39m
35014,1,laxvega,2321,0,0,2,2,0.0%,3h
35051,3,Rick,2320,1592,141,136,277,50.9%,51m
35051,3,AngelOfDeath,2320,931,47,53,100,47.0%,2h
35051,3,THEKILLER,2320,760,29,31,60,48.3%,2h
35051,1,PollSed,2320,698,20,23,43,46.5%,2h
35051,3,Jvlivs,2320,292,19,21,40,47.5%,2h
35051,3,MyZenHammer,2320,265,16,17,33,48.5%,1h
35051,1,[URBAIN]chivesoup,2320,251,15,14,29,51.7%,44m
35051,3,Dominator,2320,378,13,16,29,44.8%,32m
35051,1,NEVERMIND,2320,286,11,16,27,40.7%,2h
35051,3,[kØ]FireBaTH,2320,315,10,9,19,52.6%,29m
35051,1,KIRRI,2320,268,9,8,17,52.9%,7m
35051,3,kirito,2320,296,9,13,22,40.9%,2h
35051,1,[MPC02]Bleezzy,2320,240,6,4,10,60.0%,2h
35051,1,MARVIN,2320,214,6,5,11,54.5%,4m
35051,1,KaKaY,2320,40,5,1,6,83.3%,10m
35051,1,Bugachug,2320,144,5,4,9,55.6%,2h
35051,3,[MLTN]Mattarayer,2320,161,5,9,14,35.7%,30m
35051,1,daimremREWES,2320,122,4,0,4,100.0%,51m
35051,1,[SC2EFS]JaKz,2320,128,4,1,5,80.0%,2h
35051,1,Marogan,2320,60,4,9,13,30.8%,2h
35051,3,BigBalloni,2320,151,3,5,8,37.5%,2h
35051,1,Mack,2320,78,2,3,5,40.0%,2h
35051,1,[HSPLR]JimHolden,2320,44,2,4,6,33.3%,26m
35051,3,lowkey,2320,0,2,5,7,28.6%,2h
35051,1,TavisAvis,2320,42,1,1,2,50.0%,2h
35051,1,mrmooshy,2320,48,1,2,3,33.3%,3h
35051,1,WarLinG,2320,0,1,4,5,20.0%,3h
35051,1,Savage,2320,0,1,5,6,16.7%,28m
35051,2,Zordon,2320,0,1,6,7,14.3%,35m
35051,1,qkle,2320,38,1,8,9,11.1%,3h
35051,1,RAWDOG,2320,0,0,1,1,0.0%,2h
35051,1,hellstorm,2320,0,0,1,1,0.0%,2h
35083,1,Garraca,2319,1822,108,89,197,54.8%,2h
35083,3,ECHOLION,2319,1479,102,104,206,49.5%,12m
35083,1,Tsorovan,2319,1727,80,76,156,51.3%,9m
35083,2,Praetorian,2319,1574,78,79,157,49.7%,51m
35083,2,[WSCON]Styles,2319,1402,62,74,136,45.6%,19m
35083,3,YoloDemShots,2319,1367,61,53,114,53.5%,52m
35083,3,[TYM]BestCarlNA,2319,890,49,52,101,48.5%,3h
35083,1,Mordent,2319,1242,47,43,90,52.2%,17m
35083,3,EucaliptoSor,2319,986,40,51,91,44.0%,2h
35083,1,FriendlyChem,2319,372,31,43,74,41.9%,2h
35083,3,Caterpie,2319,634,29,20,49,59.2%,32m
35083,1,ErreMoreno,2319,779,24,22,46,52.2%,25m
35083,1,proximate,2319,242,9,15,24,37.5%,28m
35083,1,Brotus,2319,158,4,4,8,50.0%,39m
35083,1,LaidToRest,2319,170,4,5,9,44.4%,2h
35083,2,SumBu,2319,158,4,8,12,33.3%,6m
35083,3,WarJester,2319,128,4,9,13,30.8%,52m
35083,2,ren,2319,132,4,11,15,26.7%,2h
35083,1,[hxhchi]FABLetaL,2319,0,3,2,5,60.0%,2h
35083,1,Adimatic,2319,132,3,3,6,50.0%,44m
35083,1,BlackDiamond,2319,44,2,1,3,66.7%,8m
35083,2,SuperBoxer,2319,0,1,0,1,100.0%,2h
35083,1,[Btwn]MortalRexx,2319,0,1,3,4,25.0%,2h
35083,1,deathmaster,2319,0,1,4,5,20.0%,1h
35083,1,gatoloco,2319,0,1,4,5,20.0%,46m
35083,1,[DDM]Sinicio,2319,0,1,5,6,16.7%,2h
35083,1,Krown,2319,0,0,1,1,0.0%,40m
35083,1,[HTSS]javila,2319,0,0,1,1,0.0%,2h
35083,1,[4GL]jay,2319,0,0,1,1,0.0%,2h
35083,3,Logiibear,2319,0,0,3,3,0.0%,35m
35083,3,kev,2319,0,0,6,6,0.0%,29m
35114,1,simon,2318,1588,338,352,690,49.0%,2h
35114,1,johncrow,2318,1860,270,285,555,48.6%,2h
35114,3,DragónLeón,2318,1553,117,117,234,50.0%,49m
35114,3,snezze,2318,421,63,63,126,50.0%,42m
35114,1,PROTOTYPE,2318,1372,48,42,90,53.3%,2h
35114,3,Muzzinguava,2318,739,46,38,84,54.8%,50m
35114,3,Vav,2318,641,43,52,95,45.3%,2h
35114,1,FrostyFlakes,2318,556,19,11,30,63.3%,2h
35114,1,RedderButton,2318,656,18,22,40,45.0%,2h
35114,3,Knightcm,2318,237,14,22,36,38.9%,47m
35114,3,HelpfulNavi,2318,326,11,17,28,39.3%,13m
35114,1,AlmaDorada,2318,198,8,6,14,57.1%,2h
35114,1,CLlTORlSLSD,2318,296,8,7,15,53.3%,2h
35114,1,dragonfly,2318,247,8,8,16,50.0%,1h
35114,3,GKC,2318,208,7,13,20,35.0%,2h
35114,1,[MLP0NY]BubbaG,2318,218,6,5,11,54.5%,2h
35114,1,WASB,2318,242,6,7,13,46.2%,52m
35114,1,HungrBatl,2318,97,3,3,6,50.0%,1h
35114,3,jeddy,2318,146,3,7,10,30.0%,28m
35114,3,clonemax,2318,97,2,6,8,25.0%,2m
35114,1,Roakin,2318,0,1,1,2,50.0%,2h
35114,1,Arstaliin,2318,40,1,2,3,33.3%,2h
35114,3,acxzxca,2318,0,1,5,6,16.7%,28m
35114,3,ralphie,2318,0,1,5,6,16.7%,2h
35114,1,Striker,2318,0,0,1,1,0.0%,3h
35114,1,PAX,2318,0,0,1,1,0.0%,2h
35114,1,BigBlackBob,2318,0,0,1,1,0.0%,27m
35114,1,Puchi,2318,0,0,1,1,0.0%,2m
35114,1,mcflea,2318,0,0,1,1,0.0%,2h
35114,1,lionarz,2318,0,0,2,2,0.0%,2h
35114,1,[ZPT019]superhero,2318,0,0,3,3,0.0%,2h
35114,1,MaruJR,2318,0,0,3,3,0.0%,52m
35114,1,Lwang,2318,0,0,3,3,0.0%,2h
35147,1,CHRISCO,2317,1060,63,78,141,44.7%,37m
35147,2,stronz,2317,680,60,63,123,48.8%,34m
35147,3,DJD,2317,856,33,33,66,50.0%,30m
35147,3,Ruffeo,2317,647,28,25,53,52.8%,6m
35147,1,[VDA]chansec,2317,564,18,15,33,54.5%,2h
35147,3,MathFerret,2317,489,18,20,38,47.4%,47m
35147,2,Pistol,2317,237,9,3,12,75.0%,2h
35147,1,ButAidsNoPlz,2317,288,8,8,16,50.0%,3h
35147,3,Caster,2317,174,6,9,15,40.0%,2h
35147,3,[ELMALO]MACABRE,2317,194,6,13,19,31.6%,2h
35147,1,ARTRAS,2317,145,5,4,9,55.6%,8m
35147,1,magicahn,2317,178,5,7,12,41.7%,2h
35147,1,[SEMPAY]Marcus,2317,136,4,1,5,80.0%,2h
35147,1,Rasti,2317,40,4,3,7,57.1%,25m
35147,1,chronicsmoke,2317,166,4,4,8,50.0%,2h
35147,1,MACHIN,2317,125,4,6,10,40.0%,1h
35147,1,MuseMe,2317,172,4,8,12,33.3%,2h
35147,1,[PuffWC]starcaft,2317,92,3,3,6,50.0%,9m
35147,3,Labbiell,2317,44,3,8,11,27.3%,2h
35147,1,Tormenta,2317,42,2,1,3,66.7%,25m
35147,1,sharksforarm,2317,82,2,1,3,66.7%,2h
35147,1,MrFufu,2317,44,2,4,6,33.3%,2h
35147,3,Zendlo,2317,0,2,6,8,25.0%,2h
35147,1,Karsk,2317,0,1,1,2,50.0%,42m
35147,1,RideTheTiger,2317,0,1,1,2,50.0%,3h
35147,1,Cuber,2317,0,1,5,6,16.7%,8m
35147,1,DBorgesRS,2317,0,0,1,1,0.0%,9m
35147,1,jackJR,2317,0,0,1,1,0.0%,2h
35147,1,[RomPK3]Oscraft,2317,0,0,2,2,0.0%,4m
35176,2,BladeKnight,2316,1469,138,135,273,50.5%,34m
35176,3,Markozillida,2316,1503,103,102,205,50.2%,2h
35176,2,JonCrushing,2316,1428,98,99,197,49.7%,9m
35176,1,Reaper,2316,945,36,27,63,57.1%,24m
35176,1,[VTSC]Stargarbage,2316,530,15,12,27,55.6%,2h
35176,3,BGERO,2316,308,11,15,26,42.3%,2h
35176,3,Edu,2316,330,10,12,22,45.5%,2h
35176,1,charles,2316,238,7,3,10,70.0%,2h
35176,1,[DaFish]XxCHAOSxX,2316,272,7,8,15,46.7%,3h
35176,3,SchruteFarms,2316,229,7,12,19,36.8%,2h
35176,3,[xVIPx]SativaSlayer,2316,155,6,11,17,35.3%,2h
35176,1,Earlsling,2316,88,5,10,15,33.3%,2h
35176,3,[NHNGNM]Spyder,2316,5,5,15,20,25.0%,47m
35176,1,Gryffion,2316,171,4,0,4,100.0%,6m
35176,1,Kanye,2316,168,4,6,10,40.0%,2h
35176,3,Peter,2316,62,3,1,4,75.0%,20m
35176,1,HaPeniss,2316,82,2,2,4,50.0%,2h
35176,1,ImAdams,2316,0,1,0,1,100.0%,24m
35176,2,SOLRAC,2316,88,1,1,2,50.0%,46m
35176,1,JPAvelino,2316,113,1,4,5,20.0%,24m
35176,1,hqfighter,2316,0,0,1,1,0.0%,28m
35197,3,EVT,2315,1169,68,67,135,50.4%,16m
35197,1,gumball,2315,970,32,34,66,48.5%,3h
35197,3,WangHangLow,2315,461,17,16,33,51.5%,26m
35197,1,jrmf,2315,560,16,13,29,55.2%,2h
35197,1,beavis,2315,489,14,11,25,56.0%,2h
35197,1,PUFF,2315,346,12,16,28,42.9%,34m
35197,3,FearBlack,2315,328,12,21,33,36.4%,30m
35197,3,Fletched,2315,244,9,11,20,45.0%,27m
35197,1,[Helsm]WolfParkEstr,2315,303,7,4,11,63.6%,14m
35197,1,[YPIKÏ]nicolqs,2315,148,7,15,22,31.8%,2h
35197,1,[YlwWfr]BloodKing,2315,157,6,6,12,50.0%,14m
35197,1,xENZOx,2315,180,4,3,7,57.1%,2h
35197,3,DollaDame,2315,38,3,7,10,30.0%,2h
35197,1,tigerkiller,2315,0,1,0,1,100.0%,2h
35197,1,BioMattTv,2315,0,1,4,5,20.0%,2h
35197,2,Axeminister,2315,0,1,6,7,14.3%,36m
35197,3,TLtommu,2315,0,0,1,1,0.0%,1h
35214,3,TheDude,2314,1219,106,101,207,51.2%,37m
35214,1,CrewGooner,2314,1231,78,87,165,47.3%,2h
35214,2,Vincent,2314,581,71,73,144,49.3%,2h
35214,1,Zaisov,2314,1517,50,47,97,51.5%,50m
35214,1,Cronos,2314,1010,33,32,65,50.8%,2h
35214,1,KZM,2314,806,31,23,54,57.4%,24m
35214,1,Wehasor,2314,946,28,25,53,52.8%,2h
35214,2,Asuka,2314,591,25,23,48,52.1%,2m
35214,3,Constantine,2314,486,19,27,46,41.3%,2h
35214,1,Crazysouls,2314,461,18,10,28,64.3%,50m
35214,1,FyrECatZ,2314,366,16,0,16,100.0%,45m
35214,1,ROCKER,2314,554,15,20,35,42.9%,2h
35214,2,mooze,2314,350,14,16,30,46.7%,36m
35214,1,Mjoenir,2314,312,12,6,18,66.7%,2h
35214,2,HowSad,2314,315,10,13,23,43.5%,18m
35214,1,[CRABBR]SwankyPants,2314,351,9,9,18,50.0%,12m
35214,1,SalimFahhah,2314,234,6,9,15,40.0%,3h
35214,1,[H2ERO]Weeaboo,2314,160,5,1,6,83.3%,2h
35214,1,[CMGC]Timeshift,2314,208,5,7,12,41.7%,2h
35214,3,Jeguhu,2314,121,3,7,10,30.0%,20m
35214,3,lolenricoxd,2314,0,2,6,8,25.0%,2h
35214,1,Carnalitos,2314,0,1,0,1,100.0%,53m
35214,1,[TGosuC]urlag,2314,42,1,1,2,50.0%,2h
35214,1,Sirius,2314,42,1,2,3,33.3%,2h
35214,1,Sheogorath,2314,0,1,4,5,20.0%,40m
35214,1,Homesliceboy,2314,0,1,4,5,20.0%,2h
35214,1,alex,2314,46,1,6,7,14.3%,3h
35214,3,[iRango]panatela,2314,0,0,1,1,0.0%,2h
35214,1,pepito,2314,0,0,1,1,0.0%,49m
35214,3,Speltz,2314,0,0,3,3,0.0%,2h
35214,1,[Center]CovidVirous,2314,0,0,3,3,0.0%,34m
35245,2,dps,2313,1610,522,520,1042,50.1%,2h
35245,2,[a1vNA]pEePsKiLlZ,2313,1588,169,172,341,49.6%,46m
35245,3,starfenix,2313,1547,165,168,333,49.5%,30m
35245,3,SnareheadCJ,2313,1527,128,114,242,52.9%,52m
35245,1,Hizi,2313,1736,64,67,131,48.9%,3h
35245,3,[bysa]MiguelThor,2313,166,44,41,85,51.8%,2h
35245,1,EMKalexis,2313,607,18,13,31,58.1%,2h
35245,3,Jedi,2313,317,11,13,24,45.8%,2h
35245,2,TWAssasin,2313,173,6,4,10,60.0%,2h
35245,3,Akcarr,2313,165,5,8,13,38.5%,36m
35245,1,Backblech,2313,227,5,8,13,38.5%,38m
35245,1,Mintwight,2313,86,3,4,7,42.9%,2h
35245,1,Augural,2313,36,2,3,5,40.0%,3h
35245,1,Destroid,2313,0,1,0,1,100.0%,2h
35245,1,KaioFox,2313,48,1,2,3,33.3%,42m
35245,3,ESCANOR,2313,30,1,3,4,25.0%,45m
35245,1,Morivala,2313,0,1,4,5,20.0%,2h
35245,3,Frenzy,2313,0,1,5,6,16.7%,31m
35245,1,SDTimbox,2313,0,0,2,2,0.0%,3h
35245,1,[dLife]Nemesis,2313,0,0,3,3,0.0%,1h
35265,1,[Curtis]WolfPack,2312,1571,111,108,219,50.7%,2h
35265,1,UniCorndog,2312,1340,75,65,140,53.6%,2h
35265,1,azapheus,2312,1051,36,25,61,59.0%,3h
35265,2,Venom,2312,793,30,40,70,42.9%,9m
35265,1,[GOOOAT]PullyDan,2312,900,29,31,60,48.3%,2h
35265,2,Aviox,2312,470,22,28,50,44.0%,9m
35265,1,[YODEL]LFVelaochaga,2312,621,18,15,33,54.5%,2h
35265,3,[GGMESP]MORNUN,2312,476,17,22,39,43.6%,2h
35265,3,Alchemyy,2312,336,14,17,31,45.2%,52m
35265,2,Xasdex,2312,243,8,12,20,40.0%,1h
35265,3,KaiKai,2312,188,7,12,19,36.8%,40m
35265,2,Eris,2312,0,4,4,8,50.0%,2h
35265,1,MrTlatoani,2312,124,4,8,12,33.3%,3h
35265,1,[xDYEx]MikeRoPenus,2312,126,3,3,6,50.0%,2h
35265,1,[Nose02]MrPotato,2312,112,3,3,6,50.0%,42m
35265,3,Tor,2312,0,3,5,8,37.5%,2h
35265,3,sPIES,2312,114,3,6,9,33.3%,2h
35265,1,SAINT,2312,0,2,3,5,40.0%,2h
35265,1,Metatron,2312,44,2,3,5,40.0%,21m
35265,1,OsitoGominol,2312,46,1,1,2,50.0%,3h
35265,1,ElzarC,2312,0,1,1,2,50.0%,15m
35265,1,[6801]tECh,2312,42,1,2,3,33.3%,2h
35265,1,BeatCobra,2312,0,1,4,5,20.0%,2h
35265,1,Skovran,2312,0,1,4,5,20.0%,2h
35265,3,[Rohiov]Rohiov,2312,0,0,1,1,0.0%,5m
35265,1,JPEsp,2312,0,0,1,1,0.0%,43m
35265,2,AppleAtCha,2312,0,0,1,1,0.0%,2h
35265,1,Chrono,2312,0,0,2,2,0.0%,39m
35265,1,RexXoxX,2312,0,0,3,3,0.0%,15m
35294,3,Meekis,2311,1208,66,71,137,48.2%,52m
35294,3,Fred,2311,226,58,53,111,52.3%,5m
35294,1,ELNegro,2311,1401,55,46,101,54.5%,25m
35294,1,[LegSC]Baldur,2311,989,39,32,71,54.9%,26m
35294,1,Jon,2311,1030,33,39,72,45.8%,45m
35294,3,VisceralX,2311,868,32,34,66,48.5%,2h
35294,3,Cloaking,2311,694,31,41,72,43.1%,2h
35294,3,KingSmash,2311,454,29,28,57,50.9%,2h
35294,2,ThiccMama,2311,238,28,36,64,43.8%,3h
35294,3,[4aRaza]ToXoNiUs,2311,548,22,27,49,44.9%,2h
35294,1,Volume,2311,674,18,15,33,54.5%,3h
35294,1,RyzeerDC,2311,482,12,16,28,42.9%,8m
35294,3,pinaple,2311,319,11,21,32,34.4%,10m
35294,2,Pedrofrank,2311,268,10,2,12,83.3%,2h
35294,1,WOMBAT,2311,384,10,12,22,45.5%,2h
35294,1,jeffrey,2311,322,9,8,17,52.9%,24m
35294,3,XXXcheapstuf,2311,232,8,9,17,47.1%,36m
35294,1,Tezul,2311,303,8,14,22,36.4%,2h
35294,1,[Sahk]OutTheWazoo,2311,207,6,4,10,60.0%,27m
35294,1,Prizior,2311,126,4,5,9,44.4%,2h
35294,1,GIG,2311,82,3,3,6,50.0%,2h
35294,1,PyschoShark,2311,124,3,3,6,50.0%,2h
35294,1,Clarity,2311,193,3,7,10,30.0%,28m
35294,2,theongamer,2311,90,3,9,12,25.0%,1h
35294,1,Meraxes,2311,30,2,0,2,100.0%,2h
35294,1,TERRANSAURUS,2311,40,2,1,3,66.7%,45m
35294,1,BloodDrogon,2311,0,1,4,5,20.0%,2h
35294,1,GoldenPants,2311,0,1,5,6,16.7%,34m
35294,3,FerBo,2311,0,0,1,1,0.0%,38m
35294,1,DadsLasagna,2311,0,0,1,1,0.0%,2h
35294,1,NomadicDruid,2311,0,0,2,2,0.0%,2h
35294,1,kaykay,2311,0,0,2,2,0.0%,1h
35326,3,Merodomax,2310,1466,101,91,192,52.6%,2h
35326,1,Ghost,2310,1430,87,94,181,48.1%,3h
35326,2,Ender,2310,736,27,37,64,42.2%,2h
35326,1,[nieBla]SOLDADOP,2310,652,18,18,36,50.0%,2h
35326,1,Pride,2310,468,15,12,27,55.6%,3h
35326,3,SigmaMayeroC,2310,352,14,11,25,56.0%,51m
35326,3,[TCD]LcrdSnccp,2310,93,8,7,15,53.3%,2h
35326,1,Pat,2310,365,8,10,18,44.4%,15m
35326,3,Realism,2310,144,5,6,11,45.5%,2h
35326,3,Spud,2310,30,4,5,9,44.4%,2h
35326,1,Nitromech,2310,166,4,8,12,33.3%,3h
35326,3,balantay,2310,145,4,9,13,30.8%,2h
35326,1,Barry,2310,120,3,2,5,60.0%,2h
35326,3,Whipped,2310,113,2,4,6,33.3%,26m
35326,3,zenob,2310,30,2,4,6,33.3%,2h
35326,1,mike,2310,92,2,5,7,28.6%,2h
35326,1,[UnTr]fregolotbrok,2310,48,2,5,7,28.6%,2h
35326,1,zephan,2310,0,1,1,2,50.0%,2h
35326,1,Mysterio,2310,0,1,4,5,20.0%,49m
35326,1,Korsair,2310,0,1,6,7,14.3%,2h
35326,1,Cinch,2310,0,0,1,1,0.0%,2h
35326,3,Technomancer,2310,0,0,1,1,0.0%,1h
35326,1,AwesomeGuy,2310,0,0,1,1,0.0%,33m
35326,1,RADICAL,2310,0,0,2,2,0.0%,2h
35326,1,Naxsho,2310,0,0,2,2,0.0%,28m
35326,1,[NCrew]theplaymovil,2310,0,0,3,3,0.0%,2h
35326,1,[JUGOS]DCASAPTM,2310,0,0,3,3,0.0%,2h
35353,3,martkorat,2309,1375,181,196,377,48.0%,22m
35353,1,[SWOU]DarthOzz,2309,1651,82,87,169,48.5%,2h
35353,3,Gabo,2309,1559,77,71,148,52.0%,12m
35353,1,ACEVEDITO,2309,1318,48,39,87,55.2%,2h
35353,1,[etah]heartless,2309,835,30,32,62,48.4%,53m
35353,3,CupInAMug,2309,499,27,28,55,49.1%,2h
35353,3,Piscolero,2309,520,21,25,46,45.7%,2h
35353,1,Expendable,2309,513,14,15,29,48.3%,2h
35353,3,[TnEv]StayTrue,2309,244,10,8,18,55.6%,2h
35353,3,MrDistroya,2309,186,6,14,20,30.0%,47m
35353,1,saulgudman,2309,86,3,4,7,42.9%,45m
35353,2,[4fun4]Matt,2309,93,2,4,6,33.3%,2h
35353,1,AlmaDeDragon,2309,48,2,5,7,28.6%,2h
35353,3,Worms,2309,97,2,7,9,22.2%,2h
35353,1,KENT,2309,0,1,3,4,25.0%,49m
35353,1,Borisshoes,2309,0,1,3,4,25.0%,2h
35353,1,Aaskasa,2309,0,1,4,5,20.0%,53m
35353,2,ElVato,2309,0,0,1,1,0.0%,2h
35353,2,BETO,2309,0,0,1,1,0.0%,2h
35353,1,MacroKing,2309,0,0,2,2,0.0%,2h
35353,1,MATAI,2309,0,0,2,2,0.0%,2h
35353,1,WorstOne,2309,0,0,3,3,0.0%,20m
35353,1,[YALL]MrPothead,2309,0,0,4,4,0.0%,2h
35353,1,Nidalee,2309,0,0,5,5,0.0%,13m
35377,1,Handle,2308,1390,87,89,176,49.4%,2h
35377,3,Ethan,2308,1013,54,50,104,51.9%,2h
35377,3,derick,2308,798,35,30,65,53.8%,2h
35377,1,bofish,2308,540,20,34,54,37.0%,3h
35377,3,Padrino,2308,403,19,25,44,43.2%,20m
35377,2,Optyx,2308,436,15,19,34,44.1%,1h
35377,1,TorvaMessor,2308,367,13,9,22,59.1%,30m
35377,1,SrPapafrita,2308,372,11,8,19,57.9%,3h
35377,3,[ANUNAK]REX,2308,185,10,15,25,40.0%,26m
35377,3,Fumakotaro,2308,240,8,18,26,30.8%,41m
35377,1,Frozenpepsi,2308,168,6,11,17,35.3%,2h
35377,2,[ESTF]Rodro,2308,109,5,2,7,71.4%,2h
35377,1,Plutarch,2308,210,5,10,15,33.3%,2h
35377,1,TheHolyPizza,2308,0,3,3,6,50.0%,3m
35377,1,[Pervz]Kevin,2308,120,3,5,8,37.5%,2h
35377,3,chqis,2308,150,3,6,9,33.3%,2h
35377,1,argetwydra,2308,44,2,1,3,66.7%,45m
35377,1,Greasy,2308,48,2,4,6,33.3%,2h
35377,1,THG,2308,64,2,5,7,28.6%,39m
35377,1,ShiShi,2308,48,2,6,8,25.0%,3h
35377,1,RooWattsBalí,2308,44,1,1,2,50.0%,4m
35377,3,Invation,2308,0,1,2,3,33.3%,2h
35377,1,GrimRipper,2308,0,1,2,3,33.3%,12m
35377,1,Brvce,2308,0,1,3,4,25.0%,1h
35377,1,[FOFD]Jsantillan,2308,0,1,4,5,20.0%,35m
35377,1,[PchBgs]jpiznips,2308,0,1,4,5,20.0%,42m
35377,1,Alectryon,2308,0,1,4,5,20.0%,1h
35377,1,CLaYDoH,2308,0,0,1,1,0.0%,41m
35377,1,striker,2308,0,0,1,1,0.0%,2h
35406,1,MEGAorc,2307,1347,45,45,90,50.0%,2h
35406,1,Fatso,2307,1141,36,33,69,52.2%,38m
35406,3,Yoda,2307,896,33,40,73,45.2%,2h
35406,2,[RchChn]oberststen,2307,884,33,42,75,44.0%,45m
35406,3,SonicDragon,2307,457,27,27,54,50.0%,2h
35406,1,Prawnstar,2307,485,19,7,26,73.1%,41m
35406,1,Kingfish,2307,407,17,21,38,44.7%,36m
35406,3,[JBU33]WhipCrackJac,2307,342,11,17,28,39.3%,2h
35406,1,HoodieDude,2307,371,10,14,24,41.7%,2h
35406,2,[STUART]DJKg,2307,205,7,12,19,36.8%,2h
35406,3,BigKapp,2307,118,6,10,16,37.5%,9m
35406,1,HAVOK,2307,230,4,4,8,50.0%,25m
35406,3,tallon,2307,144,4,7,11,36.4%,2h
35406,2,Deathstalker,2307,60,4,8,12,33.3%,20m
35406,1,PerraSalvaje,2307,146,4,16,20,20.0%,51m
35406,1,reno,2307,48,3,4,7,42.9%,2h
35406,3,Mystic,2307,36,2,4,6,33.3%,23m
35406,1,ShibaInu,2307,0,2,5,7,28.6%,2h
35406,3,Montu,2307,0,2,6,8,25.0%,2h
35406,1,Luis,2307,105,2,6,8,25.0%,30m
35406,1,Studly,2307,0,1,2,3,33.3%,26m
35406,1,ImNooB,2307,0,1,4,5,20.0%,22m
35406,1,polako,2307,0,1,5,6,16.7%,2h
35406,1,ZachitulZ,2307,44,1,5,6,16.7%,2h
35406,1,Chiral,2307,0,0,1,1,0.0%,2h
35406,3,HangukMan,2307,0,0,2,2,0.0%,2h
35432,1,Zombie,2306,1169,73,73,146,50.0%,2h
35432,1,OddBlood,2306,1112,44,39,83,53.0%,36m
35432,1,Blastark,2306,883,36,41,77,46.8%,2h
35432,1,[SANGRE]SMach,2306,588,32,14,46,69.6%,38m
35432,3,llllllll,2306,880,31,40,71,43.7%,17m
35432,1,Sooperdork,2306,968,29,30,59,49.2%,20m
35432,1,CIPHER,2306,830,26,22,48,54.2%,2h
35432,1,aaaaaaaaaaaa,2306,692,24,22,46,52.2%,2h
35432,2,[LeMeil]RaiyanK,2306,615,22,29,51,43.1%,2h
35432,1,Bysharp,2306,409,14,7,21,66.7%,2h
35432,1,[SCCoop]CôEmMaCàRông,2306,284,7,10,17,41.2%,7m
35432,1,[TFFO]Meh,2306,170,5,0,5,100.0%,2h
35432,1,[MRDPOT]DeathOmen,2306,148,4,3,7,57.1%,2h
35432,1,Keylogram,2306,133,3,5,8,37.5%,2h
35432,2,KOROLA,2306,116,3,7,10,30.0%,1h
35432,2,tiffany,2306,70,2,4,6,33.3%,2h
35432,3,WhiteRose,2306,30,2,6,8,25.0%,44m
35432,1,serg,2306,0,1,0,1,100.0%,10m
35432,1,ULTRAHAXOR,2306,0,1,0,1,100.0%,10m
35432,1,Luis,2306,0,1,1,2,50.0%,3h
35432,1,METTAK,2306,0,1,3,4,25.0%,22m
35432,1,DJWHALE,2306,0,1,4,5,20.0%,2h
35432,1,ghostdog,2306,48,1,13,14,7.1%,24m
35432,1,alexlsaint,2306,0,0,1,1,0.0%,34m
35432,1,mummynapkin,2306,0,0,1,1,0.0%,2h
35432,1,Mujinma,2306,0,0,2,2,0.0%,24m
35432,1,Mixalot,2306,0,0,5,5,0.0%,3h
35459,2,jason,2305,1559,91,94,185,49.2%,20m
35459,2,BrokenTwig,2305,806,67,67,134,50.0%,2h
35459,3,snowgo,2305,1080,41,49,90,45.6%,3h
35459,1,Blankman,2305,1050,30,29,59,50.8%,50m
35459,1,Seismic,2305,1021,30,32,62,48.4%,50m
35459,3,buddhacraft,2305,646,23,25,48,47.9%,2h
35459,1,IIIIIIIIIIII,2305,682,19,20,39,48.7%,2h
35459,1,bathory,2305,496,13,13,26,50.0%,4m
35459,2,Suunnn,2305,271,10,11,21,47.6%,3h
35459,3,Maestro,2305,230,9,15,24,37.5%,2h
35459,1,Sleepy,2305,212,8,17,25,32.0%,7m
35459,3,[DivEx]Darnaka,2305,199,7,14,21,33.3%,41m
35459,1,DRTBOT,2305,194,6,6,12,50.0%,45m
35459,1,[imN0ob]Francis,2305,148,5,3,8,62.5%,2h
35459,3,Mshtc,2305,150,5,12,17,29.4%,32m
35459,1,benwonwen,2305,80,3,6,9,33.3%,2h
35459,1,JOSEPH,2305,134,3,8,11,27.3%,17m
35459,1,Chaotic,2305,42,2,2,4,50.0%,2h
35459,1,IUlove,2305,0,2,3,5,40.0%,15m
35459,1,Littytitty,2305,95,2,5,7,28.6%,2h
35459,3,Bfox,2305,30,2,6,8,25.0%,2h
35459,1,[ThHord]Johinro,2305,0,1,0,1,100.0%,2h
35459,1,CptTom,2305,45,1,2,3,33.3%,2h
35459,3,[DJRD]TheMan,2305,0,1,5,6,16.7%,15m
35459,3,Steeldriver,2305,0,1,5,6,16.7%,2h
35459,1,[JOSOWE]mighty,2305,0,1,5,6,16.7%,51m
35459,1,SunTzu,2305,0,0,2,2,0.0%,49m
35459,1,WitchDoctor,2305,0,0,2,2,0.0%,2h
35459,1,[CTBD]IronScorpio,2305,0,0,2,2,0.0%,26m
35459,1,Lucifer,2305,0,0,5,5,0.0%,3h
35489,3,KoKo,2304,1404,97,83,180,53.9%,3h
35489,2,[SCTF]StarLord,2304,674,82,86,168,48.8%,2h
35489,1,DanniMC,2304,1546,54,49,103,52.4%,1h
35489,1,Swata,2304,519,30,25,55,54.5%,50m
35489,3,CARIBDIS,2304,598,23,33,56,41.1%,2h
35489,1,JuulJedi,2304,518,19,17,36,52.8%,2h
35489,1,flibber,2304,653,18,19,37,48.6%,3h
35489,1,Abaddon,2304,485,15,12,27,55.6%,2h
35489,3,AuRoRA,2304,352,12,18,30,40.0%,2h
35489,1,bdfg,2304,310,9,7,16,56.2%,2h
35489,1,duckychan,2304,330,9,12,21,42.9%,45m
35489,1,KillerJPG,2304,286,8,10,18,44.4%,2h
35489,1,TqTninja,2304,243,7,8,15,46.7%,50m
35489,3,EstrateGama,2304,173,7,9,16,43.8%,28m
35489,1,CannonRushU,2304,200,6,5,11,54.5%,15m
35489,1,[ALTF04]zeuzgrande,2304,160,5,3,8,62.5%,45m
35489,2,Nakiri,2304,193,5,8,13,38.5%,30m
35489,3,bigjon,2304,76,4,10,14,28.6%,2h
35489,1,cajachan,2304,38,3,5,8,37.5%,2h
35489,1,Northside,2304,0,2,3,5,40.0%,1h
35489,1,nate,2304,128,2,3,5,40.0%,2h
35489,2,coolmc,2304,0,1,0,1,100.0%,48m
35489,1,Eradicator,2304,0,1,0,1,100.0%,2h
35489,1,Hazzy,2304,44,1,2,3,33.3%,13m
35489,1,khaldrogo,2304,0,1,3,4,25.0%,36m
35489,1,Pissfoot,2304,0,1,4,5,20.0%,3m
35489,3,Baloo,2304,0,1,5,6,16.7%,2h
35489,1,Monster,2304,0,0,1,1,0.0%,16m
35489,1,Erebus,2304,0,0,1,1,0.0%,26m
35489,1,SomiSomi,2304,0,0,1,1,0.0%,25m
35489,1,Bumblebee,2304,0,0,1,1,0.0%,15m
35520,1,juggernaught,2303,1850,121,126,247,49.0%,2h
35520,1,PurpleQUAVE,2303,1855,80,76,156,51.3%,2h
35520,3,oneeye,2303,1262,54,55,109,49.5%,9m
35520,2,juan,2303,852,42,48,90,46.7%,19m
35520,3,Toxicity,2303,829,35,37,72,48.6%,51m
35520,3,NotSure,2303,631,25,22,47,53.2%,52m
35520,1,bobin,2303,679,23,15,38,60.5%,2h
35520,3,Fedasus,2303,554,21,26,47,44.7%,41m
35520,3,Mayu,2303,492,20,23,43,46.5%,2h
35520,1,xerito,2303,512,15,10,25,60.0%,2h
35520,1,NeoMartel,2303,445,15,15,30,50.0%,2h
35520,1,Mizu,2303,305,11,15,26,42.3%,2h
35520,2,teem,2303,316,11,24,35,31.4%,2h
35520,1,NeckbeardBra,2303,248,10,19,29,34.5%,2h
35520,2,Shadowfox,2303,228,8,15,23,34.8%,12m
35520,2,Andz,2303,94,5,5,10,50.0%,33m
35520,1,MayGun,2303,170,5,9,14,35.7%,2h
35520,1,[NeoHex]Dennace,2303,133,4,3,7,57.1%,35m
35520,3,battleon,2303,86,4,3,7,57.1%,2h
35520,3,[No0Bs]ProStyle,2303,32,2,3,5,40.0%,45m
35520,1,[SUDAKA]Luchin,2303,84,2,4,6,33.3%,3h
35520,1,sirfelix,2303,82,2,5,7,28.6%,7m
35520,1,frog,2303,0,1,2,3,33.3%,2h
35520,1,Snifflets,2303,0,1,4,5,20.0%,3h
35520,1,[7FP]YEETdaWHEAT,2303,0,0,3,3,0.0%,2m
35545,2,BADSIM,2302,1499,130,133,263,49.4%,16m
35545,1,Hakwazkal,2302,868,31,32,63,49.2%,2h
35545,1,tom,2302,607,30,27,57,52.6%,2h
35545,1,[800]ProKiller,2302,714,19,20,39,48.7%,53m
35545,1,Gelroos,2302,397,13,21,34,38.2%,18m
35545,1,EagleEye,2302,289,12,14,26,46.2%,2h
35545,1,PauloXD,2302,348,9,8,17,52.9%,41m
35545,3,Czarkiroz,2302,219,8,10,18,44.4%,2h
35545,2,jamesepewpew,2302,226,7,19,26,26.9%,35m
35545,1,[xLgNx]skullyboii,2302,210,6,3,9,66.7%,2h
35545,3,DirtySlides,2302,198,6,10,16,37.5%,2h
35545,1,IIIIIIIIII,2302,202,6,47,53,11.3%,7m
35545,1,Vilsmay,2302,137,5,3,8,62.5%,3h
35545,1,FilthyPigDog,2302,116,4,4,8,50.0%,2h
35545,1,Majestic,2302,132,4,4,8,50.0%,2h
35545,1,Drankuz,2302,224,4,7,11,36.4%,1h
35545,2,KILLA,2302,108,3,7,10,30.0%,2h
35545,1,[BCKt]mikashi,2302,0,2,4,6,33.3%,46m
35545,1,Spence,2302,44,1,1,2,50.0%,45m
35545,1,THEShooter,2302,0,1,3,4,25.0%,53m
35545,3,[AXIES]ThrushBigmac,2302,0,1,5,6,16.7%,52m
35545,1,tieso,2302,0,0,1,1,0.0%,2h
35545,1,KreemO,2302,0,0,2,2,0.0%,2h
35545,3,Sanjay,2302,0,0,3,3,0.0%,2h
35545,1,CarRamRod,2302,0,0,4,4,0.0%,2h
35570,1,AdultNapper,2301,940,186,172,358,52.0%,2h
35570,1,Jonas,2301,1260,105,97,202,52.0%,20m
35570,1,RuCan,2301,386,37,7,44,84.1%,2h
35570,1,Arturo,2301,1075,36,35,71,50.7%,2h
35570,1,CyberSloth,2301,1070,34,34,68,50.0%,2h
35570,1,Flyingprube,2301,924,30,25,55,54.5%,4m
35570,3,[KhanZ]SOFTKILLER,2301,665,27,22,49,55.1%,45m
35570,1,[SHMEAT]MeakWemes,2301,530,26,23,49,53.1%,44m
35570,1,Pongoloco,2301,643,23,17,40,57.5%,2h
35570,3,CuatroVeinte,2301,544,23,25,48,47.9%,2h
35570,3,epicpeanut,2301,606,22,29,51,43.1%,30m
35570,2,therompster,2301,461,20,24,44,45.5%,2h
35570,3,[C31081]ISRAELKHAN,2301,203,18,22,40,45.0%,2h
35570,1,[AbcCo]Eurodance,2301,612,16,17,33,48.5%,45m
35570,1,TheColtrane,2301,155,12,13,25,48.0%,2h
35570,1,Harw,2301,220,10,13,23,43.5%,51m
35570,3,Sauron,2301,253,9,12,21,42.9%,41m
35570,3,Orgianna,2301,193,9,15,24,37.5%,2h
35570,3,DUTCH,2301,264,9,19,28,32.1%,13m
35570,1,Ninelivez,2301,311,8,3,11,72.7%,50m
35570,1,[xXGDXx]xXROBOCOPYxX,2301,300,8,9,17,47.1%,40m
35570,1,Thatman,2301,300,8,10,18,44.4%,2h
35570,1,Cid,2301,240,6,3,9,66.7%,25m
35570,1,Leerox,2301,140,5,7,12,41.7%,2h
35570,1,kashyyyk,2301,84,3,0,3,100.0%,2h
35570,3,Hedzu,2301,68,3,4,7,42.9%,41m
35570,1,[SCMK]Negas,2301,121,2,3,5,40.0%,38m
35570,1,Loki,2301,48,2,6,8,25.0%,23m
35570,1,[hehePP]Cat,2301,0,1,0,1,100.0%,2h
35570,1,[MyLast]Master,2301,0,1,0,1,100.0%,13m
35570,1,Terran,2301,0,1,1,2,50.0%,40m
35570,2,PlayaG,2301,36,1,6,7,14.3%,2h
35570,1,NateZach,2301,0,0,1,1,0.0%,2h
35570,3,chris,2301,0,0,2,2,0.0%,53m
35570,1,WaffleMoff,2301,0,0,2,2,0.0%,2h
35570,1,[Tubbys]ItalianSauce,2301,0,0,3,3,0.0%,41m
35570,3,Hammer,2301,0,0,3,3,0.0%,2h
35607,3,fibonacci,2300,1561,234,234,468,50.0%,2h
35607,3,IMMORTAL,2300,1478,145,156,301,48.2%,15m
35607,3,faRLuc,2300,990,107,110,217,49.3%,17m
35607,3,[N0FKz]EviLxSToNeR,2300,1447,67,66,133,50.4%,2h
35607,3,YesMeLord,2300,1189,47,48,95,49.5%,37m
35607,1,Cryntowel,2300,954,46,34,80,57.5%,2h
35607,1,babayagaNOIR,2300,1030,36,30,66,54.5%,2h
35607,1,Jonrix,2300,933,34,36,70,48.6%,2h
35607,1,Tachel,2300,1083,33,29,62,53.2%,43m
35607,1,GasMaskGhost,2300,863,28,20,48,58.3%,35m
35607,1,tatchka,2300,659,27,19,46,58.7%,2h
35607,1,ZingZeng,2300,718,27,26,53,50.9%,26m
35607,1,Gabrielcam,2300,555,19,13,32,59.4%,2m
35607,1,FleshPoet,2300,246,7,5,12,58.3%,2h
35607,1,kazefujin,2300,289,7,9,16,43.8%,2h
35607,1,[iambad]wulfyluv,2300,253,6,2,8,75.0%,2h
35607,1,lancelot,2300,144,6,6,12,50.0%,2h
35607,1,[ScSwrm]Seqarian,2300,236,6,7,13,46.2%,50m
35607,1,Pancakes,2300,176,5,7,12,41.7%,2h
35607,3,dspecialist,2300,195,5,10,15,33.3%,2h
35607,1,Grouna,2300,178,4,1,5,80.0%,2h
35607,3,DonPablo,2300,145,4,7,11,36.4%,8m
35607,1,Avla,2300,80,3,4,7,42.9%,45m
35607,1,Argos,2300,124,3,5,8,37.5%,2h
35607,1,YaboyNick,2300,48,3,5,8,37.5%,2h
35607,1,Near,2300,36,2,3,5,40.0%,41m
35607,1,BuffTerran,2300,0,1,0,1,100.0%,2h
35607,1,SinOverCos,2300,0,1,1,2,50.0%,2h
35607,1,RIANA,2300,0,1,5,6,16.7%,49m
35607,1,papasmurf,2300,0,0,1,1,0.0%,48m
35607,2,arKhanHell,2300,0,0,4,4,0.0%,45m
35607,1,MASTERALEX,2300,0,0,5,5,0.0%,2h
35639,1,Booiby,2299,1799,206,203,409,50.4%,2h
35639,3,GabrielChada,2299,1034,167,188,355,47.0%,38m
35639,1,edcoochiecoo,2299,1856,135,138,273,49.5%,2h
35639,3,[nieBla]LOKOMACHINE,2299,1547,102,94,196,52.0%,37m
35639,3,[LCE]Aragon,2299,979,93,99,192,48.4%,32m
35639,2,xelo,2299,1293,50,65,115,43.5%,2h
35639,3,EMath,2299,1161,43,55,98,43.9%,5m
35639,1,LloydTu,2299,776,21,26,47,44.7%,2h
35639,1,Morp,2299,543,21,26,47,44.7%,2h
35639,1,[FalPal]Eidolon,2299,375,14,4,18,77.8%,2h
35639,1,Murdura,2299,446,13,9,22,59.1%,12m
35639,1,ColonelPanic,2299,299,11,15,26,42.3%,2h
35639,1,Korhyu,2299,288,11,17,28,39.3%,1h
35639,1,[USplan]bobgokou,2299,276,7,7,14,50.0%,45m
35639,1,kashyk,2299,231,7,10,17,41.2%,1h
35639,1,ELVERGALARGA,2299,275,7,12,19,36.8%,2h
35639,2,Kenpachi,2299,185,6,11,17,35.3%,44m
35639,1,DriftyBits,2299,122,4,4,8,50.0%,10m
35639,1,ThePuni,2299,96,3,8,11,27.3%,2h
35639,1,[lit4u]Mandingo,2299,44,2,1,3,66.7%,2h
35639,3,Dredorak,2299,30,2,6,8,25.0%,15m
35639,1,[GOLLUM]Bobthemighty,2299,97,2,7,9,22.2%,2h
35639,1,Kinkon,2299,42,1,2,3,33.3%,51m
35639,3,SHROOM,2299,0,1,3,4,25.0%,2h
35639,2,XelNaga,2299,0,1,4,5,20.0%,2h
35639,2,Imflyinxd,2299,0,1,4,5,20.0%,45m
35639,1,Justin,2299,0,1,4,5,20.0%,3h
35639,1,doan,2299,0,1,5,6,16.7%,53m
35639,1,LaSade,2299,0,1,5,6,16.7%,2h
35639,1,Pixel,2299,0,0,1,1,0.0%,15m
35639,1,Pieroyya,2299,0,0,1,1,0.0%,2h
35639,1,HookTurn,2299,0,0,3,3,0.0%,7m
35639,1,Lighwave,2299,0,0,5,5,0.0%,4m
35672,3,PoiSonMonkee,2298,1416,114,110,224,50.9%,21m
35672,3,[1988]Rhaegar,2298,1261,78,81,159,49.1%,4m
35672,2,crash,2298,878,66,70,136,48.5%,9m
35672,3,[CRAKS]OmniEvO,2298,650,28,38,66,42.4%,20m
35672,1,Overmind,2298,467,23,1,24,95.8%,2h
35672,3,StanDward,2298,162,21,19,40,52.5%,2h
35672,3,Baagii,2298,282,12,13,25,48.0%,2h
35672,1,TenaciousL,2298,324,9,9,18,50.0%,39m
35672,1,Abominous,2298,332,8,9,17,47.1%,23m
35672,1,Cannonrusher,2298,330,8,10,18,44.4%,2h
35672,1,[GEKO]GusNar,2298,192,6,1,7,85.7%,2h
35672,3,[Pig2]Breaker,2298,154,5,11,16,31.2%,2h
35672,1,Paul,2298,124,4,2,6,66.7%,2h
35672,1,[SyLx]drmich,2298,132,4,6,10,40.0%,2h
35672,1,Torrems,2298,111,4,8,12,33.3%,26m
35672,3,DAFTPUNKER,2298,116,3,3,6,50.0%,9m
35672,1,AlphaArturis,2298,123,3,6,9,33.3%,31m
35672,2,Riptider,2298,116,3,8,11,27.3%,34m
35672,1,MilenaColyer,2298,0,2,4,6,33.3%,2h
35672,1,[HiKine]DoubleDown,2298,117,2,5,7,28.6%,2h
35672,3,Nick,2298,94,2,5,7,28.6%,2h
35672,3,GRAF,2298,30,2,9,11,18.2%,20m
35672,3,Fantas,2298,97,1,1,2,50.0%,2m
35672,1,Mito,2298,97,1,5,6,16.7%,53m
35672,3,slayer,2298,0,1,5,6,16.7%,2h
35672,3,[PUPUS]LtntMork,2298,0,1,7,8,12.5%,2h
35672,1,[sk3tch]damdam,2298,0,0,1,1,0.0%,6m
35672,1,Vebb,2298,0,0,6,6,0.0%,38m
35700,1,Micheurope,2297,1675,192,183,375,51.2%,52m
35700,3,[HSCT]SquashedDuck,2297,1296,89,95,184,48.4%,3h
35700,1,criss,2297,1055,69,61,130,53.1%,45m
35700,3,[MBurns]killazerg,2297,1009,37,41,78,47.4%,2h
35700,3,Snowden,2297,718,30,36,66,45.5%,3m
35700,1,shupys,2297,689,20,14,34,58.8%,44m
35700,1,Fesuko,2297,333,15,9,24,62.5%,5m
35700,1,ASOLATION,2297,508,14,17,31,45.2%,45m
35700,1,DTMaster,2297,405,11,5,16,68.8%,26m
35700,1,[TSOHG]ejecutor,2297,414,11,8,19,57.9%,2h
35700,1,Theriph,2297,376,10,5,15,66.7%,2h
35700,1,GJG,2297,306,8,5,13,61.5%,2h
35700,1,RoCkeT,2297,226,6,8,14,42.9%,12m
35700,1,Listerin,2297,96,3,6,9,33.3%,2h
35700,3,[SN3KS]Crotalus,2297,123,3,7,10,30.0%,13m
35700,3,Mands,2297,121,2,1,3,66.7%,2h
35700,1,[SoBros]TheEvil,2297,88,2,2,4,50.0%,4m
35700,3,matCHEW,2297,60,2,5,7,28.6%,31m
35700,3,Zeratul,2297,92,2,6,8,25.0%,2h
35700,1,ckvoss,2297,0,1,0,1,100.0%,2h
35700,1,Rob,2297,0,1,0,1,100.0%,2h
35700,1,[FTTD]roxx,2297,46,1,1,2,50.0%,5m
35700,1,THEGOVNER,2297,0,1,5,6,16.7%,2h
35700,1,alarak,2297,0,0,1,1,0.0%,2h
35700,1,LeiTO,2297,0,0,1,1,0.0%,2h
35725,1,Wilqm,2296,1352,123,124,247,49.8%,3h
35725,2,Adrii,2296,385,75,79,154,48.7%,20m
35725,3,[GUKS]Mochi,2296,1212,62,70,132,47.0%,32m
35725,3,Breau,2296,1354,49,54,103,47.6%,2h
35725,1,Meeko,2296,1250,46,40,86,53.5%,2h
35725,1,Quasar,2296,808,29,24,53,54.7%,2h
35725,1,[tCo9]boyschilling,2296,894,26,23,49,53.1%,17m
35725,3,Waddar,2296,215,21,12,33,63.6%,2h
35725,1,[MoBaW]Deflecto,2296,514,21,14,35,60.0%,26m
35725,1,[Iwdb]SadSalad,2296,494,13,15,28,46.4%,2h
35725,1,eightndeuce,2296,428,13,16,29,44.8%,2h
35725,2,manuelthunde,2296,225,11,12,23,47.8%,2h
35725,1,Artanisone,2296,305,10,6,16,62.5%,2h
35725,1,[Fever]Kultheel,2296,362,10,7,17,58.8%,2h
35725,1,loko,2296,276,8,5,13,61.5%,3h
35725,2,tito,2296,217,8,10,18,44.4%,2h
35725,3,[ANSC]DarKSidE,2296,206,8,12,20,40.0%,31m
35725,2,[TeamLT]bOOthie,2296,293,7,12,19,36.8%,2h
35725,3,[Th3Bad]XKappa,2296,196,6,9,15,40.0%,1h
35725,2,smokingdoink,2296,173,5,4,9,55.6%,3h
35725,1,[Etfine]Drixenol,2296,90,3,1,4,75.0%,40m
35725,1,[SinSK]JaeYun,2296,96,3,7,10,30.0%,2h
35725,1,Inkling,2296,86,2,3,5,40.0%,2h
35725,1,PlzDntHurtMe,2296,96,2,3,5,40.0%,50m
35725,1,SanStorms,2296,91,2,4,6,33.3%,2h
35725,1,TreeFiddy,2296,38,1,3,4,25.0%,2h
35725,1,sylfaen,2296,40,1,3,4,25.0%,2h
35725,1,DaOriginalGG,2296,46,1,3,4,25.0%,33m
35725,2,Crusher,2296,0,1,4,5,20.0%,41m
35725,2,[FeCl]Yar,2296,0,1,4,5,20.0%,39m
35725,1,lunasol,2296,0,1,5,6,16.7%,3h
35725,1,TigerKing,2296,0,1,5,6,16.7%,7m
35725,1,TAZAR,2296,0,0,1,1,0.0%,53m
35725,1,Nicotine,2296,0,0,1,1,0.0%,2h
35725,2,ElAmir,2296,0,0,1,1,0.0%,2h
35760,1,DarkPhalus,2295,1521,76,70,146,52.1%,3h
35760,1,Trix,2295,1625,76,76,152,50.0%,2h
35760,3,WamBamTYCam,2295,1331,65,56,121,53.7%,2h
35760,3,aiola,2295,1011,57,60,117,48.7%,2h
35760,1,arthur,2295,1373,54,34,88,61.4%,2h
35760,3,xDarkFaze,2295,645,43,38,81,53.1%,13m
35760,2,McLOVIN,2295,1077,40,48,88,45.5%,19m
35760,3,Raoul,2295,752,34,38,72,47.2%,5m
35760,3,[OceanT]BLACK,2295,627,29,38,67,43.3%,2h
35760,2,darkwarrior,2295,855,29,39,68,42.6%,47m
35760,1,FoREVer,2295,850,28,33,61,45.9%,2h
35760,1,RedHawk,2295,688,22,17,39,56.4%,3h
35760,1,sevenonethre,2295,608,17,14,31,54.8%,10m
35760,2,Wildernsmike,2295,362,15,9,24,62.5%,2h
35760,1,yanxelvin,2295,249,10,6,16,62.5%,2h
35760,2,buddablitz,2295,278,10,12,22,45.5%,2h
35760,1,Suki,2295,372,10,14,24,41.7%,2h
35760,2,Sephirot,2295,284,10,17,27,37.0%,18m
35760,1,tomatobasil,2295,210,8,1,9,88.9%,35m
35760,1,posets,2295,225,7,6,13,53.8%,45m
35760,1,Gynko,2295,148,6,10,16,37.5%,2h
35760,2,[NM8]uBIKnEXUS,2295,220,6,11,17,35.3%,2h
35760,2,Damone,2295,48,5,7,12,41.7%,2h
35760,3,[Z6]Sicarius,2295,128,4,11,15,26.7%,35m
35760,1,[teemop]foxius,2295,44,2,1,3,66.7%,45m
35760,1,[catcat]wenitoo,2295,46,2,1,3,66.7%,3h
35760,3,UkWildcat,2295,62,2,8,10,20.0%,2h
35760,1,LostBoy,2295,0,1,0,1,100.0%,1h
35760,2,martin,2295,0,1,1,2,50.0%,2h
35760,3,Drix,2295,97,1,4,5,20.0%,8m
35760,2,[hxhchi]PhaHaNToM,2295,0,1,4,5,20.0%,12m
35760,1,animosity,2295,42,1,5,6,16.7%,38m
35760,1,SirMarc,2295,0,0,1,1,0.0%,53m
35760,1,[POCHA]SrSandía,2295,0,0,1,1,0.0%,3h
35760,2,Rampage,2295,0,0,1,1,0.0%,2h
35760,1,NOWIS,2295,0,0,2,2,0.0%,5m
35760,1,[eX]FnX,2295,0,0,5,5,0.0%,2h
35797,1,parker,2294,1862,116,115,231,50.2%,25m
35797,3,MoNoaMiNe,2294,889,53,64,117,45.3%,2h
35797,3,will,2294,1163,44,47,91,48.4%,2h
35797,1,VonTron,2294,1140,37,31,68,54.4%,2h
35797,1,WaveRider,2294,999,36,31,67,53.7%,2h
35797,1,SPYDOC,2294,779,23,20,43,53.5%,2h
35797,1,Aura,2294,631,20,18,38,52.6%,45m
35797,1,[LoF]ACM,2294,442,13,15,28,46.4%,2h
35797,1,Eliasdguezr,2294,420,11,10,21,52.4%,2h
35797,3,AironEddie,2294,246,8,10,18,44.4%,2h
35797,2,bent,2294,38,5,7,12,41.7%,19m
35797,3,Aigell,2294,194,5,9,14,35.7%,45m
35797,2,Verus,2294,168,5,22,27,18.5%,2h
35797,1,Sonlir,2294,170,4,5,9,44.4%,44m
35797,1,Strahd,2294,154,4,5,9,44.4%,2h
35797,3,Motomoto,2294,128,4,10,14,28.6%,37m
35797,1,[AOeOP]Bob,2294,135,3,2,5,60.0%,2h
35797,3,gudynator,2294,114,3,3,6,50.0%,30m
35797,1,BringItOn,2294,169,3,6,9,33.3%,4m
35797,1,CaMm,2294,90,2,0,2,100.0%,2h
35797,1,[sk3tch]ToolTime,2294,84,2,4,6,33.3%,44m
35797,3,NIGHTMARE,2294,0,2,5,7,28.6%,2h
35797,1,FrankWest,2294,0,2,7,9,22.2%,2h
35797,1,Leonidas,2294,0,1,0,1,100.0%,15m
35797,1,Gigatron,2294,44,1,1,2,50.0%,2h
35797,1,[BMamba]CAPTAINBUTT,2294,0,1,2,3,33.3%,2h
35797,1,SANTIAGO,2294,0,1,2,3,33.3%,2m
35797,1,lilhoneybee,2294,44,1,2,3,33.3%,44m
35797,2,MikolaSraka,2294,0,1,4,5,20.0%,3m
35797,3,Stovant,2294,0,1,6,7,14.3%,12m
35797,1,[Gladio]Cmicrem,2294,0,0,1,1,0.0%,38m
35797,1,PUZZYSLAYR,2294,0,0,1,1,0.0%,26m
35797,1,ochibitang,2294,0,0,1,1,0.0%,53m
35797,1,Killer,2294,73,0,2,2,0.0%,2h
35831,1,[TGosuD]Peacewind,2293,1642,72,73,145,49.7%,3h
35831,1,vegetalpro,2293,850,27,20,47,57.4%,36m
35831,3,CoolGuySteve,2293,609,27,22,49,55.1%,53m
35831,1,Zetny,2293,724,20,17,37,54.1%,8m
35831,1,Junya,2293,494,13,9,22,59.1%,15m
35831,1,GOAT,2293,324,9,14,23,39.1%,11m
35831,2,Chaca,2293,278,8,10,18,44.4%,2h
35831,1,Thegubester,2293,212,6,6,12,50.0%,2h
35831,1,Stunning,2293,160,5,0,5,100.0%,2h
35831,1,LealFernandz,2293,239,5,5,10,50.0%,2h
35831,1,PsicosiS,2293,168,4,4,8,50.0%,33m
35831,1,Ray,2293,126,3,7,10,30.0%,2h
35831,1,Proberto,2293,96,2,1,3,66.7%,23m
35831,1,Levelu,2293,86,2,5,7,28.6%,3h
35831,1,Ragnarok,2293,48,2,6,8,25.0%,28m
35831,1,DilioPV,2293,0,1,2,3,33.3%,17m
35831,1,reaper,2293,0,1,4,5,20.0%,2h
35831,3,Whoeveris,2293,0,1,6,7,14.3%,15m
35831,1,Caleb,2293,0,0,1,1,0.0%,3h
35831,1,[GGWPM8]corshy,2293,0,0,1,1,0.0%,2h
35831,1,BleedingTime,2293,0,0,1,1,0.0%,2h
35852,2,Solman,2292,681,131,130,261,50.2%,2h
35852,1,SpokenTruth,2292,1540,73,68,141,51.8%,2h
35852,1,Jusa,2292,668,46,37,83,55.4%,10m
35852,3,DeviousDump,2292,1155,44,45,89,49.4%,14m
35852,2,[LOHs]SerHei,2292,1190,39,59,98,39.8%,2h
35852,3,Johann,2292,909,38,43,81,46.9%,27m
35852,1,DAntonio,2292,854,24,21,45,53.3%,44m
35852,3,Stip,2292,305,10,14,24,41.7%,44m
35852,2,MacDati,2292,253,9,12,21,42.9%,2h
35852,1,[Zambo]Peruprotesta,2292,184,5,4,9,55.6%,53m
35852,1,[C57640]kerserk,2292,198,5,7,12,41.7%,28m
35852,2,Walrus,2292,0,3,2,5,60.0%,48m
35852,1,PuroFuego,2292,42,2,5,7,28.6%,53m
35852,1,Ryan,2292,97,2,5,7,28.6%,2h
35852,3,[R4GN]sMoKEHhh,2292,120,2,7,9,22.2%,2h
35852,1,TMSxKhoSa,2292,0,1,0,1,100.0%,1h
35852,1,Azure,2292,0,1,0,1,100.0%,53m
35852,1,[bLuu]bLuuIzzO,2292,0,1,0,1,100.0%,2h
35852,1,STARLORD,2292,42,1,4,5,20.0%,2h
35852,1,acacia,2292,0,1,4,5,20.0%,53m
35852,1,[b1azin]Script,2292,0,1,5,6,16.7%,2h
35852,3,luigriel,2292,0,1,5,6,16.7%,37m
35852,3,SantaHat,2292,0,1,6,7,14.3%,2h
35852,1,SpokenDogood,2292,0,0,2,2,0.0%,26m
35852,1,adam,2292,0,0,2,2,0.0%,2h
35877,3,teancum,2291,1592,232,230,462,50.2%,16m
35877,1,BonHaus,2291,1287,111,106,217,51.2%,25m
35877,1,[SMO]JMoney,2291,1670,64,61,125,51.2%,2h
35877,1,PopeDope,2291,897,48,42,90,53.3%,2h
35877,3,Pipli,2291,986,39,34,73,53.4%,37m
35877,1,Peganox,2291,958,29,34,63,46.0%,3h
35877,1,LostInCorn,2291,492,15,18,33,45.5%,17m
35877,3,MikeTyson,2291,425,15,20,35,42.9%,2h
35877,3,[LY]ARCANGEL,2291,234,13,17,30,43.3%,2h
35877,3,Kiyo,2291,304,11,17,28,39.3%,2h
35877,1,sisotre,2291,372,10,7,17,58.8%,7m
35877,1,Tonto,2291,358,10,11,21,47.6%,10m
35877,3,Dieguito,2291,262,10,14,24,41.7%,47m
35877,1,[420th]Hellkitten,2291,256,8,6,14,57.1%,53m
35877,2,Moreton,2291,232,8,13,21,38.1%,2h
35877,1,Avenger,2291,201,5,7,12,41.7%,7m
35877,3,Voltron,2291,104,5,8,13,38.5%,12m
35877,2,Apotheosis,2291,152,5,14,19,26.3%,3h
35877,1,Samsung,2291,164,4,9,13,30.8%,2h
35877,2,Jack,2291,138,3,2,5,60.0%,37m
35877,1,EyeZ,2291,62,3,4,7,42.9%,2h
35877,1,Amescua,2291,126,3,5,8,37.5%,2h
35877,1,[405GN]Varo,2291,96,3,6,9,33.3%,2h
35877,1,ACG,2291,42,2,0,2,100.0%,42m
35877,1,SebaProto,2291,84,2,1,3,66.7%,2h
35877,1,DEZINGUER,2291,0,2,3,5,40.0%,2h
35877,1,Risky,2291,0,2,7,9,22.2%,2h
35877,1,Kelitox,2291,0,1,0,1,100.0%,5m
35877,1,[nStars]Stoney,2291,44,1,1,2,50.0%,45m
35877,1,PineTreeMan,2291,44,1,2,3,33.3%,2h
35877,1,TheGrate,2291,0,1,2,3,33.3%,53m
35877,1,AndrewD,2291,0,1,3,4,25.0%,6m
35877,2,Tony,2291,0,1,3,4,25.0%,25m
35877,1,HOLUPIMBAD,2291,0,1,3,4,25.0%,26m
35877,1,Logan,2291,0,1,5,6,16.7%,43m
35877,3,Spardaa,2291,30,1,9,10,10.0%,36m
35877,1,ReapDcorde,2291,0,0,1,1,0.0%,2h
35914,1,SHADOWDRAGON,2290,1842,172,169,341,50.4%,2h
35914,3,rainon,2290,1544,121,123,244,49.6%,2h
35914,1,dreamkiller,2290,1539,100,92,192,52.1%,2h
35914,3,SnowWhite,2290,1515,99,96,195,50.8%,37m
35914,3,Mercury,2290,1454,60,68,128,46.9%,2h
35914,1,RedShooter,2290,803,59,52,111,53.2%,5m
35914,1,Thundercat,2290,1248,53,49,102,52.0%,15m
35914,1,BATTLERKING,2290,1173,42,39,81,51.9%,2h
35914,3,[KisaKi]RagendraDas,2290,945,35,39,74,47.3%,26m
35914,3,[C4NN0N]Conspiracy,2290,484,20,24,44,45.5%,2h
35914,1,Nicodeusss,2290,583,19,16,35,54.3%,2h
35914,3,ChuckChunder,2290,406,14,21,35,40.0%,27m
35914,1,Zeagan,2290,437,13,10,23,56.5%,45m
35914,1,DavidFastFox,2290,408,12,18,30,40.0%,38m
35914,1,damianhommie,2290,388,10,9,19,52.6%,35m
35914,1,FLoveShady,2290,231,10,15,25,40.0%,2h
35914,2,[ZTempz]ElvenGamer,2290,209,7,8,15,46.7%,19m
35914,3,CargoBandit,2290,221,6,13,19,31.6%,2h
35914,3,BountyHunter,2290,60,5,6,11,45.5%,2h
35914,3,HiroTsuguS,2290,167,5,9,14,35.7%,40m
35914,3,Halion,2290,151,4,10,14,28.6%,2h
35914,1,TheKingXx,2290,82,3,0,3,100.0%,2h
35914,1,PiscoSour,2290,96,3,6,9,33.3%,43m
35914,1,KazDKazzy,2290,36,2,2,4,50.0%,2h
35914,1,[WarAnt]MDoulos,2290,0,2,3,5,40.0%,2h
35914,1,PunZero,2290,42,2,3,5,40.0%,51m
35914,1,leogamer,2290,48,2,3,5,40.0%,2h
35914,2,Federcio,2290,111,2,4,6,33.3%,35m
35914,1,Dante,2290,0,1,0,1,100.0%,2h
35914,2,ginofo,2290,0,1,5,6,16.7%,2h
35914,1,[Au4evr]Theophraste,2290,0,0,1,1,0.0%,42m
35914,1,TheShark,2290,0,0,1,1,0.0%,9m
35914,1,FRANCISCO,2290,0,0,2,2,0.0%,3h
35914,3,[WSR]Hikeshema,2290,0,0,3,3,0.0%,44m
35914,1,[NUPHIN]KingOtisIV,2290,0,0,3,3,0.0%,33m
35949,1,Mononoke,2289,1717,87,87,174,50.0%,3h
35949,1,Cakeboss,2289,1353,61,44,105,58.1%,2h
35949,1,Ivanovsky,2289,1602,59,58,117,50.4%,2h
35949,1,philiprivers,2289,1378,45,48,93,48.4%,27m
35949,3,Tzaria,2289,317,34,39,73,46.6%,28m
35949,3,potatofilms,2289,657,25,30,55,45.5%,2h
35949,3,Falkillord,2289,480,20,20,40,50.0%,26m
35949,1,migatte,2289,432,17,5,22,77.3%,6m
35949,1,RML,2289,459,14,9,23,60.9%,21m
35949,1,[ssexxy]Fireboard,2289,468,13,9,22,59.1%,51m
35949,1,[boiss]kayoman,2289,379,13,17,30,43.3%,2h
35949,2,Ryoya,2289,261,9,10,19,47.4%,2h
35949,1,LeadsPerfect,2289,216,8,5,13,61.5%,2h
35949,1,MAIPE,2289,277,7,3,10,70.0%,17m
35949,1,PPE,2289,281,7,4,11,63.6%,2h
35949,1,tao,2289,129,6,6,12,50.0%,53m
35949,2,Lucas,2289,198,5,9,14,35.7%,2h
35949,3,mitic,2289,137,4,4,8,50.0%,2h
35949,1,[lNeDl]Drsquar,2289,168,3,7,10,30.0%,45m
35949,1,LeProtossSup,2289,96,3,7,10,30.0%,2h
35949,1,mollejita,2289,40,2,0,2,100.0%,26m
35949,2,TheShowSC,2289,0,2,0,2,100.0%,33m
35949,3,JOJO,2289,60,2,5,7,28.6%,2h
35949,1,CyberPlayer,2289,0,2,5,7,28.6%,28m
35949,1,BOSS,2289,30,2,6,8,25.0%,27m
35949,3,Shepherd,2289,30,2,6,8,25.0%,1h
35949,3,[DayJ]Darkozzy,2289,62,2,7,9,22.2%,30m
35949,3,[KNTS]jaredparker,2289,0,2,8,10,20.0%,2h
35949,1,SpaceMoose,2289,0,1,0,1,100.0%,2h
35949,3,bigt,2289,0,1,5,6,16.7%,36m
35949,1,mrpoopeyevar,2289,0,1,6,7,14.3%,9m
35949,1,bLeepBLOOp,2289,0,0,1,1,0.0%,2h
35949,3,[KSgoat]wheelz,2289,0,0,1,1,0.0%,40m
35949,1,fussnajj,2289,0,0,1,1,0.0%,5m
35949,3,HawkPuncher,2289,0,0,2,2,0.0%,2h
35949,1,Stagmender,2289,0,0,3,3,0.0%,3h
35949,1,lIliIllIIiil,2289,0,0,5,5,0.0%,2h
35986,1,WarGOOSE,2288,1724,102,89,191,53.4%,25m
35986,3,brisk,2288,1496,84,83,167,50.3%,37m
35986,1,Jads,2288,1714,71,64,135,52.6%,13m
35986,1,SpectrumNigt,2288,1718,63,55,118,53.4%,2h
35986,1,chugh,2288,997,54,48,102,52.9%,2h
35986,2,ohcannah,2288,1184,44,49,93,47.3%,20m
35986,1,Hsueypooy,2288,523,17,11,28,60.7%,2h
35986,1,Mario,2288,491,15,12,27,55.6%,2h
35986,3,Spiceitup,2288,402,15,18,33,45.5%,2h
35986,1,Ravs,2288,510,14,11,25,56.0%,15m
35986,1,PiercingMind,2288,483,13,27,40,32.5%,2h
35986,2,Dargarin,2288,285,10,14,24,41.7%,2h
35986,2,Shadowbrush,2288,182,8,12,20,40.0%,36m
35986,1,dripnathol,2288,252,7,7,14,50.0%,2h
35986,2,theviper,2288,166,7,12,19,36.8%,1h
35986,1,Himay,2288,287,6,4,10,60.0%,2h
35986,1,deakdollars,2288,116,6,4,10,60.0%,13m
35986,1,pablinflow,2288,171,3,3,6,50.0%,1h
35986,1,Etowno,2288,136,3,3,6,50.0%,5m
35986,1,[Crip1]mistiano,2288,0,1,0,1,100.0%,2h
35986,1,Batman,2288,0,1,0,1,100.0%,2h
35986,3,Beowulf,2288,0,1,5,6,16.7%,1h
35986,1,Kinklebots,2288,0,1,5,6,16.7%,2h
36009,1,Happynec,2287,1661,393,402,795,49.4%,5m
36009,1,[ZTemp]novacorps,2287,1861,186,178,364,51.1%,3h
36009,1,[A225]thuytrn,2287,1522,57,47,104,54.8%,15m
36009,3,[SWOU]Breaker,2287,726,28,33,61,45.9%,2h
36009,1,[N0BLE]Astrostrike,2287,547,15,13,28,53.6%,36m
36009,1,PacmanSuper,2287,493,13,11,24,54.2%,41m
36009,1,BattleMaraux,2287,404,11,11,22,50.0%,2h
36009,3,Kaporale,2287,268,10,15,25,40.0%,2h
36009,1,Sebastin,2287,240,7,3,10,70.0%,2h
36009,2,FapingDunder,2287,130,6,4,10,60.0%,35m
36009,1,archipzero,2287,238,6,7,13,46.2%,13m
36009,1,Conscious,2287,124,4,6,10,40.0%,1h
36009,1,[VVPPGG]Fanatic,2287,164,4,6,10,40.0%,2h
36009,3,Dream,2287,30,4,6,10,40.0%,2h
36009,2,Pjohson,2287,88,4,7,11,36.4%,24m
36009,2,gabowslo,2287,60,4,8,12,33.3%,39m
36009,1,BBANGDUCK,2287,139,3,4,7,42.9%,13m
36009,1,[Macac0]OneMonkey,2287,46,2,0,2,100.0%,2h
36009,1,Moço,2287,40,2,5,7,28.6%,23m
36009,3,[LSKBYB]juntero,2287,30,2,7,9,22.2%,38m
36009,2,GerhardtJean,2287,30,2,12,14,14.3%,35m
36009,1,igormm,2287,0,1,2,3,33.3%,3h
36009,1,rexchancho,2287,0,1,2,3,33.3%,3h
36009,1,DMPatod,2287,0,1,4,5,20.0%,2h
36009,1,[GI64]DOVAHSLAYER,2287,46,1,5,6,16.7%,2h
36009,1,[nGeKv]KeLeVraN,2287,0,1,5,6,16.7%,38m
36009,1,SoNDawn,2287,0,1,5,6,16.7%,2h
36009,3,Protolalo,2287,0,1,5,6,16.7%,3h
36009,3,LeEnder,2287,0,1,6,7,14.3%,38m
36009,1,Kozuka,2287,0,0,1,1,0.0%,2h
36009,1,XGaster,2287,0,0,1,1,0.0%,45m
36009,1,CaptLours,2287,0,0,2,2,0.0%,53m
36041,1,IkerAS,2286,1334,85,91,176,48.3%,2h
36041,2,[Damasc]RODFIC,2286,1055,59,60,119,49.6%,3h
36041,1,[Drakes]fturpin,2286,934,47,46,93,50.5%,53m
36041,1,rostislav,2286,740,24,26,50,48.0%,50m
36041,3,Ali,2286,529,22,16,38,57.9%,2h
36041,1,SoytheLB,2286,394,12,12,24,50.0%,1h
36041,1,Celvrix,2286,242,12,14,26,46.2%,2h
36041,3,needmoreammo,2286,320,10,13,23,43.5%,2h
36041,2,MetalInvader,2286,198,8,9,17,47.1%,2h
36041,1,OdebYaráPium,2286,183,7,5,12,58.3%,15m
36041,1,WaTcHdOg,2286,44,5,2,7,71.4%,2h
36041,3,Qwartres,2286,104,5,8,13,38.5%,2h
36041,1,Mygraine,2286,128,4,3,7,57.1%,2h
36041,3,BondiCastle,2286,142,3,5,8,37.5%,30m
36041,2,slash,2286,0,2,1,3,66.7%,31m
36041,3,[SuBro]DaffyDucks,2286,58,2,2,4,50.0%,27m
36041,1,Romanoff,2286,78,2,3,5,40.0%,42m
36041,2,MrAnarchy,2286,0,2,5,7,28.6%,2h
36041,1,LayoverS,2286,73,1,3,4,25.0%,2h
36041,1,JRCoyote,2286,0,0,1,1,0.0%,53m
36041,1,[ALTF04]DanielMeza,2286,0,0,1,1,0.0%,2h
36041,3,Ziglar,2286,0,0,1,1,0.0%,2h
36063,1,Scalin,2285,1776,249,256,505,49.3%,1h
36063,1,ChikkaChikka,2285,1587,109,102,211,51.7%,5m
36063,1,protntopramo,2285,1804,88,83,171,51.5%,2h
36063,1,Danyoul,2285,1435,73,66,139,52.5%,3h
36063,1,licalos,2285,1033,42,31,73,57.5%,3h
36063,1,PeterQuill,2285,997,37,35,72,51.4%,23m
36063,2,Faye,2285,556,21,24,45,46.7%,2h
36063,1,RewardHoots,2285,572,18,16,34,52.9%,2h
36063,1,Linus,2285,578,18,20,38,47.4%,2h
36063,3,[Jungy]OPRATIONFREE,2285,382,14,16,30,46.7%,2h
36063,1,ProBronzPlay,2285,344,9,11,20,45.0%,17m
36063,1,HugsForDrugs,2285,298,8,3,11,72.7%,2h
36063,1,Sinfully,2285,306,8,7,15,53.3%,44m
36063,3,AxleChill,2285,164,8,11,19,42.1%,2h
36063,2,polymesh,2285,242,8,14,22,36.4%,3h
36063,1,[L0L0L0]xCringe,2285,174,7,14,21,33.3%,5m
36063,1,[QuaSa]Lexinator,2285,82,6,2,8,75.0%,2h
36063,1,CptHuskers,2285,202,6,7,13,46.2%,2h
36063,3,[GAWDz]LTSBArachnid,2285,148,6,8,14,42.9%,18m
36063,3,WillianM,2285,186,6,13,19,31.6%,5m
36063,3,DragonDexYT,2285,0,3,3,6,50.0%,2h
36063,1,Yaminashi,2285,0,1,0,1,100.0%,4m
36063,1,Zarathushtra,2285,48,1,2,3,33.3%,2h
36063,2,Rivery,2285,0,1,4,5,20.0%,2h
36063,3,SPARTAN,2285,0,1,5,6,16.7%,1h
36063,1,Musashi,2285,0,0,1,1,0.0%,26m
36063,1,agent,2285,0,0,1,1,0.0%,2h
36090,1,KonSpiral,2284,1249,41,42,83,49.4%,2h
36090,3,Gorian,2284,854,31,32,63,49.2%,2h
36090,1,[Oxente]Bolsomito,2284,956,30,25,55,54.5%,36m
36090,1,HorokeÜsui,2284,301,19,20,39,48.7%,2h
36090,1,Puwki,2284,505,18,19,37,48.6%,2h
36090,1,Shoda,2284,501,18,27,45,40.0%,37m
36090,3,Graceofkings,2284,420,15,15,30,50.0%,2h
36090,2,hera,2284,226,7,13,20,35.0%,2h
36090,3,neowan,2284,171,5,9,14,35.7%,3h
36090,1,fernotheone,2284,145,3,5,8,37.5%,45m
36090,1,Aries,2284,36,2,2,4,50.0%,2h
36090,1,[GRNSKN]Shepherd,2284,74,2,3,5,40.0%,42m
36090,1,Eukaryota,2284,96,2,4,6,33.3%,34m
36090,1,rooster,2284,89,1,5,6,16.7%,54m
36090,1,Cjk,2284,0,1,5,6,16.7%,2h
36090,3,DaveXKent,2284,0,1,5,6,16.7%,2h
36090,1,yaji,2284,0,0,1,1,0.0%,2h
36090,3,Nyphang,2284,0,0,1,1,0.0%,2h
36090,1,BobDole,2284,0,0,3,3,0.0%,20m
36109,2,HoylKnighJaY,2283,1565,140,150,290,48.3%,39m
36109,3,JingerBread,2283,1372,75,77,152,49.3%,38m
36109,1,FlaRe,2283,1027,50,40,90,55.6%,7m
36109,2,[PiN0YS]NoisyBoy,2283,711,33,39,72,45.8%,36m
36109,3,[udcOKI]JimmyJimmy,2283,734,27,27,54,50.0%,2h
36109,1,FourSkeen,2283,629,21,17,38,55.3%,2h
36109,1,[xSzn]EILIGH,2283,324,14,11,25,56.0%,2h
36109,1,shadow,2283,363,14,13,27,51.9%,45m
36109,2,Potato,2283,371,13,19,32,40.6%,7m
36109,3,Espartano,2283,200,8,5,13,61.5%,8m
36109,1,KingOfWar,2283,188,8,8,16,50.0%,7m
36109,1,THX,2283,99,5,4,9,55.6%,2h
36109,1,absolutely,2283,210,5,5,10,50.0%,36m
36109,1,StarKnight,2283,196,5,6,11,45.5%,38m
36109,1,Gargamel,2283,150,5,8,13,38.5%,2h
36109,1,[AbcCo]Roy,2283,168,4,3,7,57.1%,42m
36109,1,PixelLaird,2283,80,3,6,9,33.3%,2h
36109,2,IgnoreTaName,2283,0,2,3,5,40.0%,45m
36109,3,Distracts,2283,96,2,6,8,25.0%,2h
36109,1,jay,2283,88,2,6,8,25.0%,2h
36109,1,overkill,2283,0,1,0,1,100.0%,2m
36109,2,Crump,2283,0,1,1,2,50.0%,4m
36109,1,[PooMG]Rohan,2283,42,1,1,2,50.0%,2h
36109,1,TheKinG,2283,0,1,5,6,16.7%,34m
36109,1,FrogQueen,2283,0,1,5,6,16.7%,48m
36109,1,Eclipse,2283,0,1,5,6,16.7%,2h
36109,1,[GAPT]carlos,2283,0,0,2,2,0.0%,13m
36136,2,LowKey,2282,1554,596,606,1202,49.6%,2h
36136,1,Tyko,2282,1538,126,115,241,52.3%,50m
36136,1,Scugua,2282,1540,59,53,112,52.7%,2m
36136,1,[OwnYou]GhostBusters,2282,1369,53,39,92,57.6%,2h
36136,1,AngelOfDeath,2282,1142,53,47,100,53.0%,5m
36136,3,Chuck,2282,1472,53,59,112,47.3%,2h
36136,1,Littleween,2282,1257,48,44,92,52.2%,2h
36136,3,Zsol,2282,1189,45,49,94,47.9%,30m
36136,1,Dankhole,2282,1076,33,35,68,48.5%,2h
36136,1,claudinho,2282,701,28,17,45,62.2%,10m
36136,3,PatoDriver,2282,736,26,35,61,42.6%,36m
36136,3,salsaverde,2282,230,24,21,45,53.3%,2h
36136,1,darkpenguin,2282,776,23,26,49,46.9%,5m
36136,1,enkidu,2282,309,13,11,24,54.2%,2h
36136,3,GeneralBallz,2282,168,13,14,27,48.1%,29m
36136,3,BloddyCoffee,2282,229,6,11,17,35.3%,9m
36136,1,[PTHero]Zerglysk,2282,242,6,11,17,35.3%,22m
36136,3,Ingenius,2282,133,4,7,11,36.4%,2h
36136,1,unerth,2282,122,3,3,6,50.0%,2h
36136,1,MILKMANZ,2282,0,3,4,7,42.9%,2h
36136,1,LGMMaverik,2282,46,2,0,2,100.0%,21m
36136,3,MAEM,2282,30,2,2,4,50.0%,1h
36136,3,SWARLEY,2282,30,2,6,8,25.0%,2h
36136,1,guilherme,2282,92,2,7,9,22.2%,2h
36136,1,Nossgoth,2282,0,1,0,1,100.0%,2h
36136,1,GoodLuckHave,2282,97,1,1,2,50.0%,2h
36136,1,[Shout]AlmaEterna,2282,42,1,4,5,20.0%,45m
36136,1,Kraft,2282,0,1,5,6,16.7%,2h
36136,1,Rebelpa,2282,0,1,5,6,16.7%,3h
36136,3,Thebigcat,2282,0,1,6,7,14.3%,37m
36136,1,[ValKil]aBove,2282,0,0,1,1,0.0%,2h
36167,3,sdeman,2281,1492,63,57,120,52.5%,15m
36167,3,honkeyslap,2281,1340,63,68,131,48.1%,2h
36167,1,zizor,2281,879,61,66,127,48.0%,2h
36167,3,Khal,2281,851,58,51,109,53.2%,20m
36167,3,[SpcBar]Xari,2281,951,46,47,93,49.5%,48m
36167,1,CARPIVANj,2281,1168,37,42,79,46.8%,2h
36167,3,zonnamothae,2281,904,33,37,70,47.1%,2h
36167,1,Joe,2281,902,27,31,58,46.6%,53m
36167,1,SteroiD,2281,618,18,19,37,48.6%,3h
36167,1,Chucumbo,2281,480,16,16,32,50.0%,2h
36167,1,[cl0udM]WyzWun,2281,476,12,19,31,38.7%,2h
36167,1,Bonesetter,2281,323,8,6,14,57.1%,3h
36167,1,[Habil]RODACKS,2281,214,6,9,15,40.0%,2h
36167,1,icmora,2281,216,5,5,10,50.0%,41m
36167,2,[Lp]CoNcE,2281,156,5,17,22,22.7%,2h
36167,3,[1623]Olix,2281,122,4,15,19,21.1%,2h
36167,1,Erwin,2281,84,3,1,4,75.0%,38m
36167,1,Ironforge,2281,130,3,7,10,30.0%,13m
36167,3,Smirk,2281,40,3,8,11,27.3%,2h
36167,1,Angel,2281,100,3,8,11,27.3%,2h
36167,1,Mayleina,2281,42,2,0,2,100.0%,2h
36167,1,[AL0NE]SittingEagle,2281,0,1,4,5,20.0%,31m
36167,3,RODRIG,2281,0,1,6,7,14.3%,27m
36167,1,Vic,2281,0,1,6,7,14.3%,2h
36167,1,JHHC,2281,0,0,1,1,0.0%,3h
36167,3,Garess,2281,0,0,1,1,0.0%,8m
36167,1,Joonyer,2281,0,0,2,2,0.0%,48m
36167,1,Nathan,2281,0,0,2,2,0.0%,50m
36167,1,ziggy,2281,0,0,3,3,0.0%,2h
36196,3,Saturnsniper,2280,1525,391,394,785,49.8%,2h
36196,3,[C0NC1L]Woozard,2280,1363,71,65,136,52.2%,2h
36196,3,Idiot,2280,1205,66,70,136,48.5%,30m
36196,3,Decker,2280,983,42,46,88,47.7%,3h
36196,1,[Michu]Baphometh,2280,782,27,17,44,61.4%,2h
36196,1,[nieBla]alefred,2280,699,21,27,48,43.8%,2h
36196,2,JackRo,2280,553,19,27,46,41.3%,36m
36196,3,SneakyGypsy,2280,428,15,22,37,40.5%,2h
36196,1,XABLAU,2280,449,11,7,18,61.1%,40m
36196,3,Palpatine,2280,282,9,9,18,50.0%,31m
36196,1,abc,2280,234,6,4,10,60.0%,2h
36196,3,BurningBath,2280,233,6,13,19,31.6%,2h
36196,1,Thorr,2280,97,3,3,6,50.0%,34m
36196,1,EberDavid,2280,130,3,6,9,33.3%,2h
36196,1,GgamNol,2280,97,2,1,3,66.7%,24m
36196,2,Alarak,2280,0,2,2,4,50.0%,3m
36196,1,[Aw00ga]GasPasser,2280,0,2,3,5,40.0%,2m
36196,1,[BMJ]glhf,2280,0,2,3,5,40.0%,2h
36196,3,DKAL,2280,0,1,2,3,33.3%,2h
36196,1,TawxikJuepo,2280,42,1,2,3,33.3%,2h
36196,1,ByuN,2280,0,1,2,3,33.3%,3h
36196,1,Printo,2280,48,1,2,3,33.3%,2h
36196,1,mrphs,2280,0,1,4,5,20.0%,2h
36196,1,Adrian,2280,0,1,4,5,20.0%,2h
36196,1,jonn,2280,0,0,1,1,0.0%,3h
36196,3,Brightsave,2280,0,0,2,2,0.0%,2h
36222,1,Naykyd,2279,1675,142,126,268,53.0%,2h
36222,1,thechosenone,2279,1826,119,120,239,49.8%,2h
36222,1,GuffyAkd,2279,1837,116,109,225,51.6%,2h
36222,1,MarkdesS,2279,1781,81,75,156,51.9%,2h
36222,3,Guns,2279,987,68,65,133,51.1%,21m
36222,1,[xNG3x]TDiddy,2279,1585,58,49,107,54.2%,3h
36222,1,Speco,2279,960,45,28,73,61.6%,24m
36222,1,[inCoEz]vwkwhw,2279,853,26,27,53,49.1%,2h
36222,3,[DANL]DVY,2279,411,16,23,39,41.0%,15m
36222,1,Jigma,2279,424,14,18,32,43.8%,21m
36222,1,dejongh,2279,334,10,7,17,58.8%,44m
36222,3,Trobjonr,2279,188,9,20,29,31.0%,2h
36222,2,Stonelar,2279,187,7,10,17,41.2%,2h
36222,2,Souvent,2279,198,6,10,16,37.5%,4m
36222,1,ELVECTOR,2279,175,5,4,9,55.6%,13m
36222,1,[YODEL]SunCe,2279,145,3,1,4,75.0%,2h
36222,1,derpinshire,2279,74,3,6,9,33.3%,2h
36222,2,[PRO24]lucho,2279,107,3,7,10,30.0%,2h
36222,1,Oversear,2279,40,2,1,3,66.7%,2h
36222,1,SNAKEBYTE,2279,44,2,2,4,50.0%,51m
36222,1,BBQmaxiXXL,2279,0,2,4,6,33.3%,2h
36222,1,IgWhitemoon,2279,96,2,5,7,28.6%,49m
36222,3,llllllllllll,2279,94,2,6,8,25.0%,2h
36222,1,TheGato,2279,44,2,6,8,25.0%,2h
36222,3,Targrath,2279,0,2,6,8,25.0%,37m
36222,1,masteroh,2279,30,2,6,8,25.0%,31m
36222,2,Snake,2279,0,1,1,2,50.0%,20m
36222,1,PLADIN,2279,0,1,1,2,50.0%,28m
36222,1,Trip,2279,0,1,1,2,50.0%,2h
36222,1,[SoOfK]DRACO,2279,42,1,2,3,33.3%,6m
36222,1,[MiniC]VicMarshall,2279,48,1,2,3,33.3%,2h
36222,1,EWE,2279,48,1,3,4,25.0%,16m
36222,1,[DE]LokiCharms,2279,44,1,6,7,14.3%,41m
36222,1,ProTossSalad,2279,0,0,2,2,0.0%,2h
36256,3,[HFWJC]CrlsTcz,2278,1451,77,81,158,48.7%,32m
36256,1,Demetriusz,2278,1187,68,59,127,53.5%,2h
36256,3,Rodrikenobi,2278,1415,65,66,131,49.6%,2h
36256,1,NotVangetti,2278,945,36,44,80,45.0%,2h
36256,1,[AllyPG]Smittyblack,2278,1065,35,32,67,52.2%,15m
36256,2,[JueCas]jcze,2278,871,35,48,83,42.2%,24m
36256,1,MaxigamerTV,2278,729,31,15,46,67.4%,25m
36256,1,lycann,2278,771,26,18,44,59.1%,2h
36256,1,BigTazz,2278,557,25,29,54,46.3%,8m
36256,1,Aethernal,2278,690,23,22,45,51.1%,2h
36256,3,AXOLOT,2278,333,10,15,25,40.0%,30m
36256,3,[Xpk]darkdragon,2278,229,10,15,25,40.0%,45m
36256,1,PotatOzuki,2278,292,10,16,26,38.5%,1h
36256,1,[Zanis]EpicLeonel,2278,254,7,5,12,58.3%,2h
36256,1,[CHKRSP]Protozoo,2278,241,5,7,12,41.7%,2h
36256,2,[lmflui]RebelPilot,2278,175,5,8,13,38.5%,2h
36256,1,luis,2278,137,3,3,6,50.0%,31m
36256,1,Bracket,2278,96,3,6,9,33.3%,2h
36256,1,boss,2278,93,3,7,10,30.0%,51m
36256,3,Sans,2278,30,2,6,8,25.0%,10m
36256,1,[ZvP]Grendel,2278,129,2,12,14,14.3%,4m
36256,1,[SyLx]Hercules,2278,0,1,0,1,100.0%,7m
36256,1,enzo,2278,0,1,3,4,25.0%,25m
36256,1,Lyenor,2278,0,1,4,5,20.0%,53m
36256,1,JanilDark,2278,0,1,4,5,20.0%,15m
36256,1,[XDRAX8]darckbird,2278,0,0,1,1,0.0%,2h
36282,3,[pobhla]ficcus,2277,1351,211,209,420,50.2%,47m
36282,1,dio,2277,1775,114,105,219,52.1%,44m
36282,3,Leonid,2277,1311,66,77,143,46.2%,2h
36282,3,MantisCZ,2277,739,51,66,117,43.6%,5m
36282,1,[KFClub]TheAmasianTJ,2277,1095,40,31,71,56.3%,2h
36282,1,EABlackCat,2277,1200,36,40,76,47.4%,2h
36282,1,funkysweater,2277,986,32,31,63,50.8%,2h
36282,1,JeanPaul,2277,752,23,17,40,57.5%,41m
36282,1,ArcaneMenace,2277,732,23,22,45,51.1%,2h
36282,2,[RUHM]Swiss,2277,528,18,27,45,40.0%,7m
36282,1,SCORPION,2277,566,15,19,34,44.1%,38m
36282,3,oioi,2277,400,14,20,34,41.2%,1h
36282,3,darkseekerx,2277,248,10,17,27,37.0%,20m
36282,3,[BoAVN]NewGenOfJer,2277,306,10,18,28,35.7%,3h
36282,1,AceInTheFace,2277,346,9,10,19,47.4%,2h
36282,1,NuubSito,2277,170,9,10,19,47.4%,2h
36282,3,[VMP]DonAlejandro,2277,236,9,13,22,40.9%,37m
36282,1,Clown,2277,247,6,10,16,37.5%,54m
36282,1,[BeTaPi]QuirkyTurtle,2277,169,3,5,8,37.5%,5m
36282,2,[MKQLEA]Hulk,2277,36,3,19,22,13.6%,2h
36282,1,Rubioch,2277,116,2,2,4,50.0%,5m
36282,1,TINMAN,2277,44,2,2,4,50.0%,2h
36282,3,Squid,2277,0,2,4,6,33.3%,2h
36282,1,HENRY,2277,0,1,4,5,20.0%,44m
36306,1,PsiPrince,2276,1806,166,176,342,48.5%,2h
36306,1,Laraz,2276,1810,137,137,274,50.0%,53m
36306,1,Mrmetralert,2276,891,100,82,182,54.9%,2h
36306,1,[L3TsGO]Deruger,2276,770,51,46,97,52.6%,2h
36306,2,TNWPWK,2276,974,37,36,73,50.7%,2h
36306,3,Ohanamontana,2276,816,28,34,62,45.2%,3h
36306,1,LuchoYh,2276,789,27,19,46,58.7%,33m
36306,1,ACE,2276,848,24,28,52,46.2%,11m
36306,1,FriskyBicky,2276,362,15,19,34,44.1%,3h
36306,1,defenestrate,2276,235,8,14,22,36.4%,18m
36306,2,IlIIIIlIllII,2276,217,7,12,19,36.8%,44m
36306,1,[ThCz]Wraith,2276,169,6,4,10,60.0%,27m
36306,1,David,2276,249,6,10,16,37.5%,52m
36306,3,ravan,2276,194,6,18,24,25.0%,2h
36306,3,PsYxX,2276,113,5,2,7,71.4%,43m
36306,2,bigsmooke,2276,60,5,6,11,45.5%,2h
36306,1,[FL1P]GeneralTedd,2276,179,5,9,14,35.7%,2h
36306,2,[VHRVNG]blarg,2276,204,5,14,19,26.3%,2h
36306,1,IIIIIIIIIIII,2276,171,4,6,10,40.0%,2h
36306,1,MitchMan,2276,96,3,7,10,30.0%,2h
36306,1,Terlen,2276,42,2,1,3,66.7%,28m
36306,2,[Sneaky]Oapt,2276,0,2,3,5,40.0%,2h
36306,1,Neryell,2276,0,2,3,5,40.0%,46m
36306,1,MXDANIEL,2276,0,1,1,2,50.0%,2h
36306,1,IvanIVI,2276,44,1,1,2,50.0%,24m
36306,1,[NVYTE]DiegoMaradon,2276,38,1,2,3,33.3%,2h
36306,1,NightmareB,2276,32,1,4,5,20.0%,14m
36306,1,LuckyDucky,2276,46,1,6,7,14.3%,2h
36306,3,DragonFiresx,2276,30,1,7,8,12.5%,2h
36306,3,SolidSwag,2276,30,1,27,28,3.6%,4m
36306,1,PatchTerran,2276,0,0,2,2,0.0%,10m
36306,3,ReadyDewy,2276,0,0,3,3,0.0%,2h
36338,2,jpnd,2275,1575,98,104,202,48.5%,2h
36338,1,Gnumer,2275,1341,75,72,147,51.0%,2h
36338,1,Layne,2275,1564,67,63,130,51.5%,54m
36338,1,RynoRyne,2275,894,31,29,60,51.7%,2h
36338,2,[B0NERS]DinkyBoy,2275,385,23,38,61,37.7%,22m
36338,1,Dinkus,2275,588,22,23,45,48.9%,6m
36338,3,[FatMom]Player,2275,284,20,25,45,44.4%,27m
36338,3,Carmean,2275,524,19,30,49,38.8%,2h
36338,2,Matt,2275,576,19,32,51,37.3%,2h
36338,2,Moos,2275,177,16,23,39,41.0%,2h
36338,1,[DhZAc1]Seven,2275,455,14,8,22,63.6%,40m
36338,1,Tigrito,2275,190,6,4,10,60.0%,2h
36338,1,LIR,2275,174,5,6,11,45.5%,2h
36338,3,ALVHP,2275,174,5,9,14,35.7%,3h
36338,2,marito,2275,158,5,9,14,35.7%,53m
36338,1,[LCE]redents,2275,57,3,2,5,60.0%,26m
36338,1,Danokoro,2275,144,3,5,8,37.5%,2h
36338,1,Executor,2275,120,2,1,3,66.7%,2h
36338,1,AdmPenguin,2275,48,2,6,8,25.0%,5m
36338,1,Aeonarth,2275,0,2,6,8,25.0%,2h
36338,1,SirKool,2275,42,2,6,8,25.0%,2h
36338,1,Dolling,2275,46,1,1,2,50.0%,10m
36338,1,[NM8]Powerfool,2275,44,1,1,2,50.0%,2h
36338,2,Ciibs,2275,30,1,2,3,33.3%,2h
36338,1,Venus,2275,0,0,1,1,0.0%,38m
36363,3,DUMPZ,2274,1440,258,263,521,49.5%,2h
36363,2,[FaTlAd]Terranhero,2274,1445,80,84,164,48.8%,4m
36363,1,Template,2274,1427,71,65,136,52.2%,1h
36363,1,[boire]Adjutant,2274,598,35,32,67,52.2%,2h
36363,3,Kosmic,2274,655,28,38,66,42.4%,45m
36363,1,GrayToar,2274,868,24,25,49,49.0%,2h
36363,1,IIIIIIII,2274,756,24,27,51,47.1%,2h
36363,1,DarkHunter,2274,832,24,28,52,46.2%,45m
36363,1,Fagulha,2274,368,18,18,36,50.0%,2h
36363,3,lucranious,2274,446,17,19,36,47.2%,2h
36363,1,Anthonito,2274,425,16,16,32,50.0%,3h
36363,1,Tehuti,2274,436,12,8,20,60.0%,2h
36363,1,masterluchon,2274,369,12,17,29,41.4%,1h
36363,3,MRHAZZARD,2274,256,8,7,15,53.3%,40m
36363,1,[TGosuB]McPotter,2274,166,5,7,12,41.7%,39m
36363,1,Penetro,2274,212,5,9,14,35.7%,2h
36363,2,deceito,2274,217,5,9,14,35.7%,2h
36363,2,RADrum,2274,94,5,10,15,33.3%,2m
36363,1,Jinn,2274,157,3,3,6,50.0%,3h
36363,1,Fortress,2274,0,3,4,7,42.9%,2h
36363,1,ProBatter,2274,88,3,4,7,42.9%,45m
36363,1,[n3wk1d]clashvalian,2274,96,2,4,6,33.3%,2h
36363,1,[TEKN]radtereon,2274,48,2,6,8,25.0%,8m
36363,1,[WCH69]DMAX,2274,42,1,2,3,33.3%,2h
36363,1,[dioses]ZannyDreamer,2274,0,1,2,3,33.3%,3h
36363,1,[ISSA]Snack,2274,97,1,3,4,25.0%,16m
36363,1,LiquidOhReal,2274,0,1,5,6,16.7%,2h
36363,1,Laxus,2274,0,0,1,1,0.0%,6m
36363,1,FloppyDisk,2274,0,0,1,1,0.0%,2h
36363,1,alexzodsedxx,2274,0,0,2,2,0.0%,3h
36393,1,Danny,2273,1639,138,134,272,50.7%,3h
36393,2,Brandon,2273,1167,75,73,148,50.7%,36m
36393,1,elefanteHOT,2273,1599,62,51,113,54.9%,3h
36393,3,[XpKAc]ElMemeX,2273,601,39,43,82,47.6%,48m
36393,1,[KingSC]LRT,2273,952,33,26,59,55.9%,2h
36393,1,LatinJoker,2273,990,31,31,62,50.0%,52m
36393,3,[ACSS]Achilles,2273,612,24,29,53,45.3%,2h
36393,3,Kontroll,2273,613,20,25,45,44.4%,2h
36393,1,ChikenNuggy,2273,488,17,19,36,47.2%,18m
36393,1,Mavekashi,2273,638,17,20,37,45.9%,2h
36393,1,Foxtrot,2273,568,16,16,32,50.0%,2h
36393,1,IIIIIIIIIIII,2273,489,13,17,30,43.3%,51m
36393,1,Quixoticelix,2273,415,13,17,30,43.3%,15m
36393,1,Effectery,2273,294,11,18,29,37.9%,2h
36393,1,Piscis,2273,313,9,7,16,56.2%,2h
36393,1,Gunslinger,2273,258,7,3,10,70.0%,17m
36393,1,Davenpbl,2273,196,7,6,13,53.8%,20m
36393,1,LMR,2273,274,7,7,14,50.0%,36m
36393,1,hicior,2273,258,6,5,11,54.5%,2h
36393,3,[BR3]neural,2273,146,5,8,13,38.5%,2h
36393,1,[8kPLUS]Hemroid,2273,48,2,1,3,66.7%,2h
36393,2,Flash,2273,30,2,5,7,28.6%,19m
36393,1,younghoon,2273,73,2,7,9,22.2%,4m
36393,3,chusteczka,2273,0,1,1,2,50.0%,2h
36393,3,victor,2273,0,1,3,4,25.0%,26m
36393,1,LGNoth,2273,40,1,4,5,20.0%,2h
36393,2,hieiwrath,2273,0,1,4,5,20.0%,2h
36393,2,SergyNazreen,2273,0,0,1,1,0.0%,29m
36393,1,Mosquito,2273,0,0,3,3,0.0%,1h
36422,2,hobosexual,2272,1542,86,94,180,47.8%,2h
36422,1,AgentFSH,2272,704,67,56,123,54.5%,51m
36422,1,AJSMB,2272,780,41,43,84,48.8%,51m
36422,1,ThiagoxD,2272,976,39,28,67,58.2%,11m
36422,1,SugarWater,2272,747,30,18,48,62.5%,2h
36422,3,DoctorJ,2272,587,25,29,54,46.3%,2h
36422,3,Nugget,2272,612,24,30,54,44.4%,2h
36422,1,Greedy,2272,740,20,21,41,48.8%,53m
36422,1,[LRN]Meenn,2272,508,16,12,28,57.1%,35m
36422,1,missil,2272,582,15,21,36,41.7%,40m
36422,1,hotrod,2272,387,12,7,19,63.2%,15m
36422,3,stewie,2272,317,10,14,24,41.7%,2h
36422,2,StealStroke,2272,314,10,14,24,41.7%,2h
36422,2,Ghost,2272,292,9,13,22,40.9%,2h
36422,1,[Crappy]ForshMulen,2272,205,8,5,13,61.5%,28m
36422,2,[DETER]Crustaoy,2272,182,6,10,16,37.5%,2h
36422,1,kam,2272,206,5,4,9,55.6%,5m
36422,1,PandaPoh,2272,149,4,6,10,40.0%,2h
36422,1,[Tiddys]Typhus,2272,121,3,3,6,50.0%,27m
36422,1,ABhargava,2272,48,2,2,4,50.0%,2h
36422,1,MIKE,2272,86,2,2,4,50.0%,31m
36422,1,ENRIQUE,2272,40,2,2,4,50.0%,2h
36422,1,Kataclist,2272,0,2,3,5,40.0%,2h
36422,1,[ZeroUm]FPMnotepad,2272,0,1,0,1,100.0%,10m
36422,1,xanbo,2272,0,1,1,2,50.0%,2h
36422,1,Parzival,2272,0,1,1,2,50.0%,38m
36422,1,NOVA,2272,97,1,3,4,25.0%,3h
36422,1,Artanis,2272,0,1,4,5,20.0%,1h
36422,1,Roberth,2272,0,0,1,1,0.0%,2h
36422,1,Rations,2272,0,0,2,2,0.0%,33m
36452,1,Drewtang,2271,1463,197,177,374,52.7%,51m
36452,1,Barney,2271,966,123,125,248,49.6%,2h
36452,1,McLightningF,2271,847,93,83,176,52.8%,20m
36452,3,Prometeo,2271,509,89,91,180,49.4%,48m
36452,3,[KhanZ]JoNuts,2271,1053,39,43,82,47.6%,52m
36452,2,kisloi,2271,166,39,51,90,43.3%,36m
36452,3,Rakham,2271,540,18,26,44,40.9%,3h
36452,1,biha,2271,447,16,15,31,51.6%,2h
36452,1,Absoul,2271,299,12,18,30,40.0%,3h
36452,2,Absulutezero,2271,310,11,4,15,73.3%,52m
36452,1,Phoenix,2271,251,10,4,14,71.4%,2h
36452,1,gatoahxcri,2271,351,10,9,19,52.6%,2h
36452,1,DavyRex,2271,357,10,11,21,47.6%,3h
36452,1,Drekgart,2271,347,10,12,22,45.5%,14m
36452,1,VALIER,2271,214,6,9,15,40.0%,2h
36452,1,Pickle,2271,196,5,10,15,33.3%,26m
36452,1,PARSIVAL,2271,97,4,2,6,66.7%,2h
36452,1,Beau,2271,168,4,4,8,50.0%,2h
36452,1,KimTaeHyung,2271,169,4,5,9,44.4%,49m
36452,1,NoDrama,2271,0,3,5,8,37.5%,24m
36452,3,Dropbear,2271,30,3,6,9,33.3%,2h
36452,1,[GuT]Lucishon,2271,0,2,4,6,33.3%,27m
36452,1,Sinn,2271,0,1,1,2,50.0%,2h
36452,1,[MSVC]javalol,2271,40,1,2,3,33.3%,2h
36452,1,AlexAnder,2271,0,1,3,4,25.0%,10m
36452,1,OneEyeJoe,2271,0,1,4,5,20.0%,11m
36478,3,Mikey,2270,1565,366,366,732,50.0%,4m
36478,1,Paladin,2270,1543,83,78,161,51.6%,2h
36478,3,[BRTHRS]Boss,2270,1527,63,76,139,45.3%,48m
36478,1,moe,2270,973,31,31,62,50.0%,2h
36478,3,Nicolas,2270,775,31,31,62,50.0%,10m
36478,1,MysterBoss,2270,668,24,27,51,47.1%,2h
36478,3,leonardsneed,2270,200,11,12,23,47.8%,43m
36478,1,Shpadoinkle,2270,368,10,15,25,40.0%,2h
36478,3,RAG,2270,218,6,3,9,66.7%,2h
36478,1,Fegelein,2270,106,5,5,10,50.0%,2h
36478,3,Marcos,2270,163,5,7,12,41.7%,2h
36478,3,Will,2270,152,5,10,15,33.3%,15m
36478,1,Zippo,2270,214,4,3,7,57.1%,2h
36478,1,william,2270,0,3,2,5,60.0%,2h
36478,1,THEDARKSTONE,2270,0,3,3,6,50.0%,2h
36478,1,[Squidy]NotThisTime,2270,118,3,4,7,42.9%,2h
36478,1,vertigo,2270,44,3,5,8,37.5%,2h
36478,3,TMBKoreN,2270,30,2,1,3,66.7%,2h
36478,1,Chunder,2270,48,2,6,8,25.0%,2h
36478,3,Herby,2270,97,1,1,2,50.0%,28m
36478,1,SóloGaming,2270,40,1,1,2,50.0%,11m
36478,1,Westonio,2270,44,1,4,5,20.0%,2h
36478,1,[GnR]boombardo,2270,0,0,1,1,0.0%,46m
36478,2,Euphoria,2270,0,0,6,6,0.0%,4m
36502,3,Drewski,2269,543,41,44,85,48.2%,32m
36502,1,Acid,2269,579,35,35,70,50.0%,22m
36502,1,Tauph,2269,808,30,27,57,52.6%,3h
36502,1,Yugoslavia,2269,713,21,21,42,50.0%,2h
36502,1,BuckShot,2269,189,4,3,7,57.1%,2h
36502,1,[CHKRSP]Tonny,2269,126,4,5,9,44.4%,36m
36502,1,Kon,2269,86,3,0,3,100.0%,1h
36502,3,staraph,2269,104,3,10,13,23.1%,2h
36502,1,elsebo,2269,97,2,1,3,66.7%,3h
36502,1,Batman,2269,42,2,3,5,40.0%,2h
36502,1,Hitch,2269,0,2,5,7,28.6%,2h
36502,1,tylor,2269,40,1,4,5,20.0%,24m
36502,1,Jaweeez,2269,91,1,5,6,16.7%,23m
36502,1,DIXTROYER,2269,0,1,5,6,16.7%,31m
36502,2,Zurn,2269,30,1,10,11,9.1%,34m
36502,2,inksoul,2269,0,0,1,1,0.0%,2h
36502,3,Swankytiger,2269,0,0,1,1,0.0%,2h
36502,2,[LeMono]PillanTheWte,2269,0,0,1,1,0.0%,48m
36502,1,Datnikka,2269,0,0,2,2,0.0%,2h
36521,3,DreadPlayer,2268,1322,258,261,519,49.7%,48m
36521,3,[TeamKL]TorresH,2268,1543,164,160,324,50.6%,2h
36521,2,Matt,2268,588,87,99,186,46.8%,47m
36521,3,Saxattack,2268,748,87,103,190,45.8%,27m
36521,1,Remilia,2268,1769,72,68,140,51.4%,22m
36521,1,OGJONNY,2268,1789,63,58,121,52.1%,2h
36521,1,Sampson,2268,1158,39,34,73,53.4%,10m
36521,1,LethalLeigh,2268,631,36,35,71,50.7%,2h
36521,3,SAVMASTER,2268,488,17,17,34,50.0%,30m
36521,1,Mike,2268,592,16,17,33,48.5%,2h
36521,1,LuckinesS,2268,322,11,14,25,44.0%,38m
36521,1,Makalele,2268,240,7,11,18,38.9%,15m
36521,3,Talida,2268,176,7,12,19,36.8%,2h
36521,1,Roasted,2268,0,2,4,6,33.3%,52m
36521,1,BandiiiT,2268,0,2,5,7,28.6%,2h
36521,1,Twitchy,2268,48,2,6,8,25.0%,45m
36521,1,Larmageddon,2268,0,1,0,1,100.0%,53m
36521,1,Fong,2268,0,1,1,2,50.0%,2h
36521,1,CrAyOn,2268,44,1,2,3,33.3%,2h
36521,1,OlKennyBoy,2268,95,1,5,6,16.7%,36m
36521,1,Shoeman,2268,0,0,2,2,0.0%,3h
36521,1,SuperAK,2268,0,0,2,2,0.0%,2h
36521,1,beefmaster,2268,0,0,2,2,0.0%,2h
36521,1,devilish,2268,0,0,2,2,0.0%,2h
36521,2,Fiirst,2268,0,0,3,3,0.0%,45m
36546,1,Vendetta,2267,1176,57,59,116,49.1%,2h
36546,1,ikermateo,2267,1250,40,43,83,48.2%,41m
36546,1,LachitoKyu,2267,1153,38,31,69,55.1%,2m
36546,1,RORRISFUZZ,2267,839,30,26,56,53.6%,2h
36546,1,contrademonx,2267,446,17,10,27,63.0%,2h
36546,1,Fiorex,2267,452,15,12,27,55.6%,44m
36546,1,RPG,2267,429,13,18,31,41.9%,3h
36546,1,[PobSC]SakuyaKnives,2267,376,13,20,33,39.4%,2h
36546,1,SANGETSU,2267,312,9,7,16,56.2%,7m
36546,1,KushCaptain,2267,256,6,11,17,35.3%,3h
36546,1,[JOSKYS]osky,2267,246,5,5,10,50.0%,2h
36546,2,ROJKA,2267,138,4,1,5,80.0%,2h
36546,2,Vint,2267,0,4,5,9,44.4%,45m
36546,1,bitcoin,2267,120,4,8,12,33.3%,45m
36546,1,[QcP]Torvic,2267,155,4,8,12,33.3%,36m
36546,1,helopilot,2267,84,3,2,5,60.0%,41m
36546,1,[WAYV]TheHunter,2267,0,1,0,1,100.0%,46m
36546,1,Enzo,2267,48,1,1,2,50.0%,2h
36546,1,Krazed,2267,0,1,2,3,33.3%,26m
36546,1,[cluez]Jsnow,2267,38,1,3,4,25.0%,2h
36546,2,TRON,2267,0,1,5,6,16.7%,36m
36546,1,Tyrandil,2267,0,0,1,1,0.0%,44m
36546,1,void,2267,0,0,1,1,0.0%,2h
36546,2,[DRKDMN]bangranjait,2267,0,0,2,2,0.0%,3h
36546,1,Giza,2267,0,0,3,3,0.0%,38m
36546,1,ukwilkie,2267,0,0,4,4,0.0%,8m
36572,3,Evilworld,2266,1564,187,221,408,45.8%,1h
36572,3,HardLine,2266,1389,144,137,281,51.2%,52m
36572,3,CaptainBlame,2266,487,93,106,199,46.7%,29m
36572,1,[ph0t0n]goonSQUAD,2266,1491,64,65,129,49.6%,25m
36572,3,Cheiseo,2266,754,61,61,122,50.0%,2h
36572,1,Kaddler,2266,627,26,25,51,51.0%,2h
36572,1,DROAUR,2266,735,26,29,55,47.3%,26m
36572,3,Monra,2266,652,24,24,48,50.0%,53m
36572,1,[FL9]ACE,2266,806,22,29,51,43.1%,46m
36572,2,Khailo,2266,193,6,14,20,30.0%,2h
36572,1,LIKASOHMBODE,2266,162,5,2,7,71.4%,31m
36572,1,Adestrin,2266,139,5,4,9,55.6%,3h
36572,3,Sirbaum,2266,169,4,4,8,50.0%,34m
36572,1,volitic,2266,74,3,2,5,60.0%,25m
36572,1,BaconTime,2266,48,2,6,8,25.0%,2h
36572,1,Steven,2266,0,1,0,1,100.0%,15m
36572,1,SoulHunter,2266,44,1,3,4,25.0%,15m
36572,2,Xoa,2266,0,1,4,5,20.0%,2h
36572,2,Vagenis,2266,46,1,5,6,16.7%,50m
36572,3,TheblackDK,2266,0,0,1,1,0.0%,28m
36572,3,Fuleyazon,2266,0,0,2,2,0.0%,41m
36593,3,[SttE]SttE,2265,1558,87,95,182,47.8%,18m
36593,1,FoNCHo,2265,1111,70,71,141,49.6%,6m
36593,3,duendeverde,2265,1436,67,47,114,58.8%,2h
36593,3,Jfern,2265,1516,56,59,115,48.7%,38m
36593,1,SweetChili,2265,726,27,36,63,42.9%,2h
36593,1,LuckyOwl,2265,759,23,22,45,51.1%,6m
36593,1,SonGoku,2265,479,19,22,41,46.3%,38m
36593,1,Toto,2265,441,18,16,34,52.9%,5m
36593,3,Varrais,2265,482,16,20,36,44.4%,12m
36593,1,Squirrellpoo,2265,326,12,15,27,44.4%,2h
36593,1,YouNeedLube,2265,263,11,6,17,64.7%,15m
36593,3,[FLlCK]CasPeR,2265,192,9,11,20,45.0%,2h
36593,2,[IronG]Eden,2265,241,8,14,22,36.4%,12m
36593,1,nissc,2265,239,6,4,10,60.0%,2h
36593,1,GiftFrmKevin,2265,204,5,7,12,41.7%,54m
36593,1,[FFAA]KaleJarret,2265,167,4,2,6,66.7%,40m
36593,1,Magus,2265,188,4,7,11,36.4%,2h
36593,1,[WJ]cmdk,2265,0,3,4,7,42.9%,5m
36593,1,[CDXXL]decky,2265,0,3,5,8,37.5%,42m
36593,3,etherk,2265,121,3,7,10,30.0%,2h
36593,1,[FROMOZ]SuperNinja,2265,42,2,1,3,66.7%,2h
36593,1,[Wainas]Tassadar,2265,48,2,3,5,40.0%,2h
36593,1,[PyTi]Kyzester,2265,42,2,4,6,33.3%,2h
36593,1,[CLERIC]TOTHER,2265,105,2,5,7,28.6%,2h
36593,1,Stevenonce,2265,0,1,0,1,100.0%,2h
36593,1,IAR,2265,0,1,0,1,100.0%,39m
36593,3,serbero,2265,0,1,0,1,100.0%,2h
36593,1,ZEUS,2265,36,1,2,3,33.3%,28m
36593,1,CruleLuck,2265,46,1,3,4,25.0%,2h
36593,1,Tepre,2265,0,1,4,5,20.0%,2h
36593,1,[CTHUL]Blax,2265,0,1,4,5,20.0%,2h
36593,2,OrbOfChaos,2265,88,1,5,6,16.7%,1h
36593,1,GuideBot,2265,0,0,1,1,0.0%,43m
36593,1,[neuroW]Tompers,2265,0,0,3,3,0.0%,2h
36627,1,[MIKES]Happy,2264,1271,46,47,93,49.5%,2h
36627,1,[BO0MER]EricTheRippr,2264,885,37,23,60,61.7%,26m
36627,3,LeoSchilling,2264,962,36,43,79,45.6%,2h
36627,1,[FFAA]Akopian,2264,976,29,31,60,48.3%,2h
36627,1,[amva]KHRATOS,2264,582,21,10,31,67.7%,2h
36627,1,uedsoldier,2264,596,16,21,37,43.2%,2h
36627,1,Solidus,2264,405,13,5,18,72.2%,2h
36627,1,Horus,2264,252,11,19,30,36.7%,2h
36627,1,Azrael,2264,266,8,12,20,40.0%,2h
36627,3,Daddy,2264,116,6,3,9,66.7%,3h
36627,1,zulo,2264,147,4,2,6,66.7%,53m
36627,1,[ApexZ]XenoMorphS,2264,120,4,3,7,57.1%,45m
36627,1,[rshhr]Royal,2264,82,3,4,7,42.9%,45m
36627,2,HellFyre,2264,156,3,6,9,33.3%,45m
36627,1,LiquidRock,2264,48,2,1,3,66.7%,2h
36627,3,preadd,2264,97,2,7,9,22.2%,39m
36627,1,SeekNDestroy,2264,48,1,1,2,50.0%,2h
36627,1,kannonc,2264,0,1,5,6,16.7%,10m
36627,1,DeividCraft,2264,85,1,10,11,9.1%,37m
36627,1,MeriKrizmaz,2264,0,0,1,1,0.0%,38m
36627,1,ruben,2264,0,0,1,1,0.0%,28m
36627,1,zaki,2264,0,0,4,4,0.0%,2h
36627,1,[Blacer]alleycat,2264,0,0,5,5,0.0%,8m
36650,1,DarthThallos,2263,1702,81,80,161,50.3%,27m
36650,3,Archaeus,2263,698,76,70,146,52.1%,18m
36650,1,tsjjm,2263,1546,75,61,136,55.1%,53m
36650,1,Heffe,2263,1342,59,39,98,60.2%,8m
36650,3,BadgerLord,2263,625,50,52,102,49.0%,48m
36650,1,Eren,2263,1064,42,41,83,50.6%,2h
36650,1,cojiatuvieja,2263,973,35,29,64,54.7%,2h
36650,1,CappMod,2263,856,34,36,70,48.6%,49m
36650,1,kstillo,2263,758,28,25,53,52.8%,2h
36650,1,[Pls]zzz,2263,835,27,25,52,51.9%,15m
36650,1,awesomesauce,2263,756,27,30,57,47.4%,2h
36650,1,logan,2263,817,25,24,49,51.0%,2h
36650,1,iMorph,2263,602,23,28,51,45.1%,2h
36650,1,Nooblet,2263,660,19,18,37,51.4%,2h
36650,3,arrollador,2263,465,18,26,44,40.9%,42m
36650,1,CryMore,2263,599,17,21,38,44.7%,13m
36650,1,Koky,2263,624,16,22,38,42.1%,52m
36650,2,FisseFredRa,2263,385,14,19,33,42.4%,36m
36650,1,ZAOLOTSUDACA,2263,440,12,10,22,54.5%,33m
36650,3,Kerchack,2263,274,12,16,28,42.9%,2h
36650,1,BrenoGoston,2263,302,10,8,18,55.6%,2h
36650,1,Jkarma,2263,244,8,5,13,61.5%,14m
36650,1,hurley,2263,330,8,14,22,36.4%,2h
36650,2,Beaker,2263,144,7,12,19,36.8%,47m
36650,1,Drakolobo,2263,244,6,8,14,42.9%,2h
36650,1,jpn,2263,84,3,4,7,42.9%,15m
36650,1,Stricken,2263,144,3,7,10,30.0%,2h
36650,1,Tooletym,2263,89,1,1,2,50.0%,2h
36650,2,Fallen,2263,0,1,4,5,20.0%,28m
36650,1,joefission,2263,88,1,5,6,16.7%,2h
36650,1,SaltyBag,2263,0,0,1,1,0.0%,13m
36650,1,Moose,2263,0,0,1,1,0.0%,22m
36650,1,MackDaddy,2263,0,0,2,2,0.0%,53m
36650,1,GLaDOS,2263,0,0,5,5,0.0%,2h
36684,1,pipo,2262,1181,42,34,76,55.3%,36m
36684,1,MrBeatbox,2262,864,35,25,60,58.3%,2h
36684,2,ZerProT,2262,880,32,39,71,45.1%,37m
36684,1,[KUMS]Miyuki,2262,785,31,26,57,54.4%,2h
36684,1,KungFunk,2262,736,21,20,41,51.2%,2h
36684,1,[PQL]Crimminal,2262,721,21,20,41,51.2%,26m
36684,1,SoorenaTV,2262,613,18,17,35,51.4%,35m
36684,1,NFS,2262,568,16,16,32,50.0%,28m
36684,1,Shaku,2262,460,12,12,24,50.0%,3h
36684,1,PFW,2262,385,12,18,30,40.0%,27m
36684,2,Mathias,2262,300,11,17,28,39.3%,2m
36684,1,BOSSNIACK,2262,216,10,2,12,83.3%,1h
36684,1,[Khalta]Leothar,2262,388,10,11,21,47.6%,8m
36684,2,Hal,2262,271,9,15,24,37.5%,2h
36684,1,ArchAngel,2262,196,7,9,16,43.8%,2h
36684,1,CabraSabia,2262,236,6,6,12,50.0%,11m
36684,1,Zeph,2262,92,4,3,7,57.1%,2h
36684,1,shi,2262,97,4,5,9,44.4%,2h
36684,3,eRRRpAKI,2262,92,4,7,11,36.4%,7m
36684,1,Fesax,2262,116,4,7,11,36.4%,2h
36684,2,Rosi,2262,140,4,10,14,28.6%,2h
36684,1,[LY]Corrupter,2262,84,3,3,6,50.0%,3h
36684,1,MegaSpeeD,2262,174,3,6,9,33.3%,3h
36684,1,theSinned,2262,42,2,0,2,100.0%,2h
36684,1,CrystalBox,2262,42,2,0,2,100.0%,2h
36684,3,PlatosBeard,2262,97,2,8,10,20.0%,17m
36684,1,[DNYO]Daniel,2262,0,1,0,1,100.0%,35m
36684,3,[SCTR]OpaGandalf,2262,0,1,1,2,50.0%,2h
36684,1,[CrUnK]EveNFloW,2262,0,1,4,5,20.0%,31m
36684,1,[WLD1s]Oopanim,2262,0,0,2,2,0.0%,45m
36684,1,Akamegy,2262,0,0,2,2,0.0%,2h
36684,1,Bentow,2262,0,0,3,3,0.0%,2h
36684,2,[NutsR]Khopax,2262,0,0,5,5,0.0%,2h
36717,3,EllenRipley,2261,809,70,72,142,49.3%,2h
36717,1,[CULTPi]Darth,2261,973,32,30,62,51.6%,1h
36717,3,Templar,2261,379,23,27,50,46.0%,18m
36717,1,[JUGOS]Mangas,2261,606,18,15,33,54.5%,53m
36717,3,[oFSTo]sgtjetson,2261,183,11,5,16,68.8%,23m
36717,2,Gorbash,2261,271,11,11,22,50.0%,7m
36717,1,NicolaiV,2261,348,10,10,20,50.0%,37m
36717,3,[BlTEL]Vakalate,2261,100,7,14,21,33.3%,2h
36717,3,Nicolai,2261,123,5,5,10,50.0%,2h
36717,1,Vilepredator,2261,213,4,8,12,33.3%,2h
36717,3,[Apixel]jobprogamer,2261,151,4,9,13,30.8%,2h
36717,1,[animaI]dirtydog,2261,142,4,12,16,25.0%,2h
36717,1,jojojau,2261,0,0,1,1,0.0%,5m
36717,1,MadMax,2261,0,0,2,2,0.0%,35m
36717,1,[BoBSti]gvmooseman,2261,0,0,4,4,0.0%,53m
36717,1,chatoroller,2261,0,0,6,6,0.0%,2h
36733,1,ZERO,2260,1751,195,199,394,49.5%,16m
36733,3,cocohearts,2260,1528,188,184,372,50.5%,2h
36733,1,Traxon,2260,1606,186,175,361,51.5%,3h
36733,3,NatanZachary,2260,1234,107,99,206,51.9%,2h
36733,3,[FatMom]Unerwunscht,2260,1268,68,73,141,48.2%,2h
36733,3,ChikiPuki,2260,844,30,36,66,45.5%,52m
36733,3,benedict,2260,649,29,18,47,61.7%,2h
36733,3,Pavel,2260,858,29,49,78,37.2%,2h
36733,3,Pulz,2260,630,25,26,51,49.0%,48m
36733,1,Hizamaru,2260,503,18,17,35,51.4%,2h
36733,1,Minhbeard,2260,390,11,13,24,45.8%,3h
36733,1,Typhon,2260,345,10,7,17,58.8%,15m
36733,3,felon,2260,246,8,8,16,50.0%,2h
36733,3,Gimbo,2260,220,6,5,11,54.5%,2h
36733,2,Sindas,2260,180,6,11,17,35.3%,2h
36733,1,llllllllllll,2260,88,5,1,6,83.3%,2h
36733,1,Jeff,2260,204,5,5,10,50.0%,3h
36733,1,Barcode,2260,147,4,8,12,33.3%,46m
36733,1,Virtas,2260,164,4,10,14,28.6%,22m
36733,1,HollowSpawn,2260,130,3,4,7,42.9%,5m
36733,1,Coldfyre,2260,96,3,7,10,30.0%,3h
36733,1,wolfikinz,2260,44,2,0,2,100.0%,5m
36733,1,HartanDimand,2260,0,1,0,1,100.0%,6m
36733,1,jabas,2260,44,1,1,2,50.0%,41m
36733,1,Jbaby,2260,44,1,3,4,25.0%,2h
36733,1,YoHindOh,2260,0,1,5,6,16.7%,1h
36733,3,[Drowi]Makto,2260,30,1,10,11,9.1%,2h
36733,1,Human,2260,0,0,1,1,0.0%,15m
36761,3,[toungy]Magus,2259,1580,60,66,126,47.6%,2h
36761,1,CLGK,2259,1233,48,40,88,54.5%,2h
36761,1,[nieBla]ALAMUERTE,2259,1150,45,38,83,54.2%,41m
36761,1,Steeko,2259,846,29,33,62,46.8%,41m
36761,1,danpunker,2259,622,18,22,40,45.0%,25m
36761,1,Nova,2259,192,16,17,33,48.5%,45m
36761,1,[FFAA]Matt,2259,204,8,7,15,53.3%,2h
36761,2,Fear,2259,216,7,13,20,35.0%,35m
36761,1,xzxzorigin,2259,110,4,5,9,44.4%,51m
36761,1,ETloNfaiRoM,2259,96,4,9,13,30.8%,2h
36761,1,Jooce,2259,48,2,4,6,33.3%,26m
36761,1,Artanis,2259,133,2,4,6,33.3%,3h
36761,1,Turtwigcool,2259,42,2,6,8,25.0%,16m
36761,3,[NTPeru]ZoideX,2259,58,2,8,10,20.0%,2h
36761,1,NoobSoup,2259,0,1,0,1,100.0%,2h
36761,1,HARBERGIN,2259,0,1,0,1,100.0%,2h
36761,1,Byrd,2259,98,1,2,3,33.3%,46m
36761,2,[BLEED]Sentenced,2259,0,1,4,5,20.0%,13m
36761,1,[MANCOr]Glacius,2259,0,1,5,6,16.7%,2h
36761,1,Skrii,2259,0,1,6,7,14.3%,51m
36761,3,Josa,2259,0,0,1,1,0.0%,38m
36761,2,[asco]MusMey,2259,0,0,1,1,0.0%,2h
36783,2,Zerg,2258,1033,185,228,413,44.8%,49m
36783,2,kakaroto,2258,1094,75,75,150,50.0%,47m
36783,1,cndnsinger,2258,1769,74,73,147,50.3%,6m
36783,1,fearsausage,2258,1215,67,73,140,47.9%,2h
36783,1,doofus,2258,1304,48,40,88,54.5%,24m
36783,3,CorvusCrits,2258,1123,46,47,93,49.5%,15m
36783,1,wildwolf,2258,1184,44,49,93,47.3%,2h
36783,1,[CHOG]CaptainRex,2258,1023,38,39,77,49.4%,2h
36783,1,[GdAT]nocTurnaL,2258,775,26,33,59,44.1%,2h
36783,1,scar,2258,630,24,22,46,52.2%,51m
36783,1,TheKliche,2258,664,23,20,43,53.5%,2h
36783,1,Denson,2258,562,19,22,41,46.3%,54m
36783,1,[SyncFr]FrankStrong,2258,510,15,37,52,28.8%,2h
36783,1,Orick,2258,404,10,12,22,45.5%,2h
36783,3,peteplantman,2258,168,5,6,11,45.5%,2h
36783,1,Chëchi,2258,186,5,7,12,41.7%,14m
36783,2,daeliin,2258,117,5,13,18,27.8%,36m
36783,1,Fortnite,2258,96,3,3,6,50.0%,14m
36783,2,chris,2258,30,3,8,11,27.3%,43m
36783,1,[RCSM]rodiux,2258,42,2,0,2,100.0%,2h
36783,1,Danzer,2258,82,2,1,3,66.7%,44m
36783,1,Dungeon,2258,111,2,1,3,66.7%,14m
36783,1,cheese,2258,42,2,3,5,40.0%,53m
36783,3,BOJANGLES,2258,97,2,7,9,22.2%,2h
36783,1,[MURDD]zorb,2258,0,2,7,9,22.2%,3h
36783,1,[cluez]NolaSaints,2258,88,2,8,10,20.0%,41m
36783,1,Abaddon,2258,0,1,1,2,50.0%,2h
36783,3,santisgamer,2258,97,1,2,3,33.3%,33m
36783,1,king,2258,0,1,4,5,20.0%,2h
36783,1,Pepov,2258,0,0,1,1,0.0%,41m
36783,1,[XANIME]SomaYukihira,2258,0,0,1,1,0.0%,44m
36814,1,Machacador,2257,1691,141,139,280,50.4%,40m
36814,1,Dabby,2257,1493,137,127,264,51.9%,25m
36814,1,Gastd,2257,1552,71,68,139,51.1%,37m
36814,3,[Msia]ChangTian,2257,1065,43,46,89,48.3%,2h
36814,1,RiCe,2257,1019,35,35,70,50.0%,2h
36814,3,WAMUX,2257,518,30,36,66,45.5%,27m
36814,1,Xathron,2257,620,18,17,35,51.4%,2h
36814,1,BrightHammer,2257,289,8,6,14,57.1%,2h
36814,1,KillerMoreyr,2257,253,8,7,15,53.3%,40m
36814,3,Heironymus,2257,224,6,8,14,42.9%,29m
36814,1,Neuman,2257,202,5,4,9,55.6%,2h
36814,3,butcher,2257,176,5,10,15,33.3%,7m
36814,1,AleDagobah,2257,120,3,3,6,50.0%,2h
36814,1,[TYFTRS]Duch,2257,146,3,4,7,42.9%,2h
36814,1,[TheCum]WpgLego,2257,0,2,3,5,40.0%,9m
36814,1,STRANGEE,2257,88,2,5,7,28.6%,40m
36814,3,Serial,2257,0,2,8,10,20.0%,14m
36814,1,killerrod,2257,0,1,0,1,100.0%,1h
36814,1,yihbag,2257,0,1,1,2,50.0%,36m
36814,1,DreamRaider,2257,0,1,4,5,20.0%,2h
36814,1,matareynor,2257,0,0,1,1,0.0%,2h
36814,1,StewdapluGG,2257,0,0,1,1,0.0%,2h
36814,1,[Pro999]GhostMen,2257,0,0,2,2,0.0%,2h
36814,1,Freeman,2257,0,0,2,2,0.0%,2h
36814,1,mangots,2257,0,0,2,2,0.0%,2h
36839,1,Whion,2256,1805,84,76,160,52.5%,2h
36839,1,JuanVicky,2256,1406,66,37,103,64.1%,28m
36839,1,TonnyUrsa,2256,922,29,30,59,49.2%,38m
36839,3,BadLadurette,2256,578,24,26,50,48.0%,2h
36839,1,CRAZYJAY,2256,627,21,23,44,47.7%,45m
36839,1,DorArmand,2256,509,15,24,39,38.5%,3h
36839,2,poon,2256,302,10,24,34,29.4%,1h
36839,1,speck,2256,234,7,12,19,36.8%,2h
36839,1,[PiN0YS]TantanPH,2256,129,5,3,8,62.5%,2h
36839,1,barto,2256,206,5,6,11,45.5%,44m
36839,1,dvgamers,2256,178,4,5,9,44.4%,2h
36839,3,ChimpManzeee,2256,176,4,11,15,26.7%,32m
36839,2,InsanePsych,2256,0,3,2,5,60.0%,48m
36839,3,Luras,2256,121,2,4,6,33.3%,2h
36839,1,[NwAs]SandiaYLimon,2256,0,1,0,1,100.0%,45m
36839,1,[G0BBLE]mewtan,2256,48,1,3,4,25.0%,1h
36839,1,darthjarjar,2256,0,1,5,6,16.7%,4m
36839,1,JMFV,2256,0,0,1,1,0.0%,31m
36857,1,KaptinKratos,2255,1177,43,36,79,54.4%,2h
36857,3,ddddd,2255,574,20,25,45,44.4%,42m
36857,1,Ace,2255,569,15,14,29,51.7%,2h
36857,1,Help,2255,532,14,14,28,50.0%,26m
36857,1,Gomer,2255,396,13,12,25,52.0%,2h
36857,1,govnr,2255,202,6,4,10,60.0%,53m
36857,1,Felex,2255,196,6,5,11,54.5%,2h
36857,1,[MAAGIC]Virego,2255,188,6,9,15,40.0%,2h
36857,1,titanyisus,2255,179,5,3,8,62.5%,2h
36857,1,Gonekix,2255,169,5,3,8,62.5%,2h
36857,1,[guest]Tricknology,2255,78,5,4,9,55.6%,2h
36857,1,KEKW,2255,140,4,3,7,57.1%,11m
36857,3,danx,2255,62,4,10,14,28.6%,42m
36857,1,[ProsSC]Santiago,2255,147,3,1,4,75.0%,31m
36857,1,[Vap]Alchy,2255,0,1,0,1,100.0%,2h
36857,1,PieIsGood,2255,46,1,11,12,8.3%,28m
36857,1,BLACKSHADOW,2255,0,0,1,1,0.0%,2h
36857,1,kuntot,2255,0,0,2,2,0.0%,53m
36857,3,oki,2255,0,0,4,4,0.0%,2h
36876,1,Reck,2254,1698,129,122,251,51.4%,15m
36876,1,smallfry,2254,933,90,93,183,49.2%,2h
36876,1,Elfich,2254,1656,66,59,125,52.8%,3h
36876,3,Eagleslayer,2254,771,41,46,87,47.1%,50m
36876,1,Amsat,2254,996,31,30,61,50.8%,2h
36876,3,Abercorn,2254,890,31,44,75,41.3%,2h
36876,1,ComeToDaddy,2254,626,23,15,38,60.5%,22m
36876,1,Acylion,2254,322,9,17,26,34.6%,34m
36876,3,[LWC]ZulKai,2254,235,8,11,19,42.1%,2h
36876,3,[GCH]Smoke,2254,186,7,14,21,33.3%,7m
36876,1,ConBen,2254,122,3,2,5,60.0%,11m
36876,1,Wesnoth,2254,128,3,8,11,27.3%,28m
36876,1,[CRAKS]CeifeiroSD,2254,44,2,0,2,100.0%,34m
36876,2,Arkragon,2254,30,2,10,12,16.7%,36m
36876,1,[GTWITM]Ecneb,2254,0,1,1,2,50.0%,2h
36876,2,Dioxcyde,2254,0,1,4,5,20.0%,2h
36876,1,DoomBanana,2254,0,1,5,6,16.7%,2h
36876,2,ikez,2254,48,1,5,6,16.7%,2h
36876,2,SwepZeratul,2254,0,0,1,1,0.0%,28m
36895,1,Alt,2253,693,26,18,44,59.1%,53m
36895,1,Joseph,2253,465,17,18,35,48.6%,2h
36895,1,Sick,2253,305,9,8,17,52.9%,41m
36895,3,tRich,2253,312,9,13,22,40.9%,2h
36895,1,DrewIQ,2253,283,9,17,26,34.6%,2h
36895,1,alester,2253,224,7,5,12,58.3%,6m
36895,1,Mozambiqued,2253,242,7,7,14,50.0%,54m
36895,1,PhantomFreq,2253,205,7,14,21,33.3%,48m
36895,1,[RW5150]amartnza,2253,142,6,7,13,46.2%,2h
36895,1,[TCFZ]LovelessMask,2253,144,5,7,12,41.7%,3h
36895,1,[ActUse]Wheezy,2253,150,4,3,7,57.1%,2h
36895,1,[DaKrew]FireBat,2253,158,4,5,9,44.4%,6m
36895,1,sixllinks,2253,170,4,12,16,25.0%,3h
36895,1,KevinYX,2253,43,2,1,3,66.7%,2h
36895,1,ronin,2253,0,2,3,5,40.0%,5m
36895,1,[SC2PH]Nicebullet,2253,42,2,5,7,28.6%,2h
36895,1,Zombie,2253,96,1,2,3,33.3%,2h
36895,2,jjprime,2253,0,1,3,4,25.0%,2h
36895,1,[kØ]CHILLAN,2253,0,1,4,5,20.0%,16m
36895,1,Aeveus,2253,48,1,6,7,14.3%,2h
36895,3,[BPT]BrokeMonkey,2253,0,0,1,1,0.0%,34m
36895,2,Finnomenon,2253,0,0,1,1,0.0%,29m
36895,1,BloodTemplar,2253,0,0,1,1,0.0%,46m
36895,1,serch,2253,73,0,2,2,0.0%,2h
36895,1,PmRyodan,2253,0,0,3,3,0.0%,2h
36895,1,JehuOni,2253,0,0,4,4,0.0%,2h
36895,1,nhat,2253,0,0,5,5,0.0%,2h
36922,2,Kantachat,2252,479,67,66,133,50.4%,23m
36922,1,amenodorime,2252,1613,64,64,128,50.0%,39m
36922,1,Archon,2252,1377,60,56,116,51.7%,2h
36922,1,Thunderthigh,2252,1352,45,40,85,52.9%,2h
36922,1,ComeInYourEy,2252,729,31,31,62,50.0%,40m
36922,1,JogoDetonado,2252,381,16,18,34,47.1%,2h
36922,1,HIKARUXYZM,2252,232,7,7,14,50.0%,2h
36922,1,Kasparov,2252,213,6,5,11,54.5%,3h
36922,1,startech,2252,142,5,7,12,41.7%,1h
36922,2,JCapa,2252,163,5,10,15,33.3%,2h
36922,1,ObamaBinLyin,2252,127,4,0,4,100.0%,2h
36922,1,[Div1]Bollinger,2252,30,3,8,11,27.3%,2h
36922,1,Nonzoe,2252,85,2,2,4,50.0%,2h
36922,1,[Azocur]Louhyzt,2252,0,1,0,1,100.0%,2h
36922,1,Xeris,2252,48,1,2,3,33.3%,2h
36922,1,Cheems,2252,40,1,4,5,20.0%,28m
36922,1,HULKEN,2252,0,1,4,5,20.0%,2h
36922,1,Kheyce,2252,0,1,4,5,20.0%,6m
36922,1,Dillathon,2252,0,0,1,1,0.0%,36m
36922,1,Phantom,2252,0,0,1,1,0.0%,28m
36922,1,remymartine,2252,0,0,1,1,0.0%,16m
36922,1,Wince,2252,0,0,1,1,0.0%,16m
36944,1,HAL,2251,1503,52,55,107,48.6%,2h
36944,1,santiii,2251,1453,51,45,96,53.1%,13m
36944,3,DevilFish,2251,920,32,40,72,44.4%,2h
36944,3,[PSYON]Royce,2251,694,26,23,49,53.1%,30m
36944,1,[KJ]LittleReaper,2251,471,18,16,34,52.9%,26m
36944,1,Agatean,2251,568,18,17,35,51.4%,7m
36944,1,Hazard,2251,332,11,13,24,45.8%,28m
36944,1,[MDCHs]sebasLA,2251,298,9,7,16,56.2%,52m
36944,1,MarcelKlaude,2251,251,7,9,16,43.8%,31m
36944,1,SheDaddyIce,2251,48,2,6,8,25.0%,2h
36944,3,Azir,2251,30,2,7,9,22.2%,30m
36944,3,thewolf,2251,0,0,3,3,0.0%,2h
36944,1,Krazykilper,2251,0,0,5,5,0.0%,2h
36957,1,Baco,2250,1382,47,43,90,52.2%,3h
36957,3,Almity,2250,828,34,34,68,50.0%,53m
36957,1,ElCanelas,2250,473,16,12,28,57.1%,15m
36957,1,GlizzyGobler,2250,267,10,9,19,52.6%,2h
36957,1,[XpKAc]DRACO,2250,249,6,3,9,66.7%,20m
36957,3,Aris,2250,170,4,4,8,50.0%,39m
36957,1,[QOSQO]Lex,2250,164,4,6,10,40.0%,2h
36957,1,[KILLFA]Ibangurmom,2250,158,4,7,11,36.4%,2h
36957,1,[xWSUx]killerkorn,2250,86,3,1,4,75.0%,15m
36957,1,Nnine,2250,0,3,4,7,42.9%,2h
36957,1,[ABWE]joeblo,2250,0,1,0,1,100.0%,11m
36957,1,[INFRNO]Darksite,2250,0,1,1,2,50.0%,27m
36957,1,Thundarella,2250,0,1,1,2,50.0%,41m
36957,3,[Chbeer]Rpinto,2250,30,1,2,3,33.3%,30m
36957,1,CamusBlue,2250,0,1,5,6,16.7%,2h
36957,1,[AbcCo]tarilon,2250,0,0,1,1,0.0%,13m
36973,2,[PartyR]Jyrian,2249,1537,605,619,1224,49.4%,2h
36973,1,jjss,2249,1605,97,102,199,48.7%,26m
36973,1,jofl,2249,1616,80,75,155,51.6%,2h
36973,3,Hugo,2249,1313,61,70,131,46.6%,2h
36973,1,moscowmitch,2249,1084,55,55,110,50.0%,45m
36973,1,AELRD,2249,1193,51,49,100,51.0%,40m
36973,1,strikereurek,2249,1284,47,36,83,56.6%,2h
36973,1,[CITIOS]nazart,2249,848,27,29,56,48.2%,2h
36973,1,[Metric]ThortraLisk,2249,695,24,19,43,55.8%,2h
36973,1,Zero,2249,356,12,14,26,46.2%,2h
36973,3,SimpleJack,2249,320,11,9,20,55.0%,2h
36973,1,shnauu,2249,295,8,11,19,42.1%,2h
36973,1,UTNHELLFIRE,2249,197,6,3,9,66.7%,6m
36973,2,Pogipinoy,2249,170,6,11,17,35.3%,44m
36973,1,Suavescroto,2249,194,5,7,12,41.7%,2h
36973,1,nactoe,2249,74,3,2,5,60.0%,2h
36973,1,ColonelW,2249,102,3,4,7,42.9%,8m
36973,3,Heisenberg,2249,38,3,8,11,27.3%,21m
36973,1,[GR33D]ShooteR,2249,0,1,1,2,50.0%,3h
36973,1,PurpleNurple,2249,0,0,1,1,0.0%,2h
36973,2,Arahgon,2249,0,0,1,1,0.0%,42m
36973,1,BenDover,2249,0,0,1,1,0.0%,3h
36995,1,XenocideX,2248,1815,135,136,271,49.8%,45m
36995,3,Otter,2248,1388,110,111,221,49.8%,48m
36995,1,skywalker,2248,1792,99,86,185,53.5%,3h
36995,3,Rex,2248,1296,99,104,203,48.8%,2h
36995,1,why,2248,1016,59,68,127,46.5%,2h
36995,1,fluufy,2248,1126,55,52,107,51.4%,3h
36995,3,qwerty,2248,696,38,49,87,43.7%,2h
36995,3,Bucknasty,2248,570,18,25,43,41.9%,1h
36995,2,[Flam3s]Salt,2248,346,13,23,36,36.1%,2h
36995,1,Muche,2248,244,10,8,18,55.6%,37m
36995,3,michael,2248,300,9,16,25,36.0%,2h
36995,1,Ladybug,2248,382,9,16,25,36.0%,37m
36995,1,Daniel,2248,265,8,3,11,72.7%,16m
36995,1,[FyHr]Cazador,2248,210,6,5,11,54.5%,2h
36995,1,Zuthanatos,2248,102,3,4,7,42.9%,2h
36995,1,StarW,2248,96,2,3,5,40.0%,2h
36995,1,[M82XS]XPULSAR,2248,0,1,1,2,50.0%,2h
36995,2,gestapo,2248,0,1,5,6,16.7%,48m
36995,1,[Bommmm]Pepitochan,2248,0,0,1,1,0.0%,2h
36995,2,kira,2248,0,0,1,1,0.0%,50m
36995,1,[2v2]Necromancer,2248,0,0,6,6,0.0%,41m
37016,3,akkbari,2247,1422,167,164,331,50.5%,42m
37016,2,Dolus,2247,1519,118,116,234,50.4%,23m
37016,1,Dexter,2247,1811,106,103,209,50.7%,35m
37016,3,[NUTZZZ]Andy,2247,1406,83,86,169,49.1%,36m
37016,1,sara,2247,1387,62,48,110,56.4%,2h
37016,3,Rez,2247,797,59,57,116,50.9%,2h
37016,1,Steph,2247,1582,59,59,118,50.0%,16m
37016,1,ikef,2247,1668,57,56,113,50.4%,2h
37016,3,[DaFew]SpiniestJoke,2247,762,57,67,124,46.0%,45m
37016,1,romario,2247,1057,53,56,109,48.6%,2h
37016,1,MrC,2247,788,36,21,57,63.2%,31m
37016,1,Sternward,2247,952,32,30,62,51.6%,2h
37016,1,Charlemagne,2247,443,26,20,46,56.5%,2h
37016,1,utntlqkf,2247,713,22,28,50,44.0%,5m
37016,1,EJOA,2247,625,16,20,36,44.4%,2h
37016,1,osEYErus,2247,451,13,17,30,43.3%,2h
37016,1,Infinite,2247,128,9,3,12,75.0%,6m
37016,3,bruiserB,2247,294,9,10,19,47.4%,2h
37016,2,texthex,2247,308,9,21,30,30.0%,2h
37016,1,[ZTemps]WTForkYo,2247,234,8,1,9,88.9%,5m
37016,3,Valyn,2247,227,7,12,19,36.8%,2h
37016,1,othin,2247,237,6,5,11,54.5%,16m
37016,3,[LosCra]PinCraft,2247,58,5,5,10,50.0%,13m
37016,1,xMu,2247,159,4,8,12,33.3%,15m
37016,1,TheBlackLion,2247,72,3,1,4,75.0%,2h
37016,1,Shoejunk,2247,110,3,2,5,60.0%,3h
37016,1,Lycan,2247,0,3,2,5,60.0%,2h
37016,1,lashdude,2247,122,3,4,7,42.9%,2h
37016,1,lowrisk,2247,124,3,4,7,42.9%,40m
37016,1,Vassili,2247,151,3,4,7,42.9%,2h
37016,1,kirally,2247,173,3,6,9,33.3%,2h
37016,1,HonorPursuit,2247,0,2,4,6,33.3%,2h
37016,3,Zeruck,2247,125,2,4,6,33.3%,2h
37016,2,Sokuda,2247,94,2,9,11,18.2%,2h
37016,2,Abramelin,2247,0,1,1,2,50.0%,2h
37016,1,[Ch33s]TimtheLucky,2247,42,1,3,4,25.0%,2h
37016,1,RaoulDuke,2247,48,1,4,5,20.0%,29m
37016,1,TheSocialist,2247,0,1,4,5,20.0%,2h
37016,1,[SCRS]NocturNkilla,2247,0,1,5,6,16.7%,2h
37016,1,Slayer,2247,0,1,5,6,16.7%,41m
37016,1,Xythe,2247,0,0,1,1,0.0%,2h
37016,3,BeNiceToMe,2247,0,0,1,1,0.0%,2h
37016,1,ReaperActual,2247,0,0,1,1,0.0%,2h
37016,2,Darfeyn,2247,0,0,1,1,0.0%,51m
37060,3,VladTidings,2246,1547,66,66,132,50.0%,37m
37060,3,Braden,2246,1137,44,54,98,44.9%,50m
37060,1,Rodrigo,2246,895,31,33,64,48.4%,13m
37060,1,Oldpirate,2246,396,21,19,40,52.5%,2h
37060,1,[MUTX]Darius,2246,397,17,13,30,56.7%,2h
37060,1,Sujay,2246,368,13,7,20,65.0%,2h
37060,1,thekiller,2246,416,13,12,25,52.0%,2h
37060,1,Ghostbr,2246,269,10,6,16,62.5%,4m
37060,1,jinkenryan,2246,406,10,12,22,45.5%,2h
37060,1,Destructor,2246,375,10,14,24,41.7%,22m
37060,1,VIG,2246,285,10,21,31,32.3%,18m
37060,1,[FMX]DarthVader,2246,316,8,13,21,38.1%,2h
37060,1,rick,2246,146,7,5,12,58.3%,16m
37060,2,MrMoon,2246,156,7,7,14,50.0%,2h
37060,1,[Macac0]AdidasBoy,2246,188,6,4,10,60.0%,26m
37060,1,[TPN3X]MRCOFFEE,2246,188,6,5,11,54.5%,3h
37060,1,Darkwolf,2246,160,6,5,11,54.5%,2h
37060,1,[SBot]FlacidFire,2246,228,6,7,13,46.2%,2h
37060,2,Balatubzz,2246,122,6,9,15,40.0%,2h
37060,1,[DSAL]djfactory,2246,162,4,7,11,36.4%,44m
37060,1,CaptnCrunch,2246,0,3,3,6,50.0%,2h
37060,1,rise,2246,124,3,5,8,37.5%,1m
37060,1,ddean,2246,132,3,7,10,30.0%,44m
37060,1,[BOTF]ZFHavox,2246,30,2,1,3,66.7%,7m
37060,2,Metal,2246,48,2,4,6,33.3%,25m
37060,1,MilLerTiMe,2246,0,1,0,1,100.0%,2h
37060,2,JawnDeep,2246,88,1,1,2,50.0%,2h
37060,1,[xRtGac]Sushis,2246,42,1,1,2,50.0%,2h
37060,2,inombrableDD,2246,48,1,2,3,33.3%,33m
37060,2,fiveton,2246,0,1,4,5,20.0%,2h
37060,1,Paranoid,2246,0,0,1,1,0.0%,15m
37060,1,[THWBED]eskimojoe,2246,73,0,4,4,0.0%,2h
37060,1,cgh,2246,0,0,7,7,0.0%,53m
37093,3,Wufferus,2245,1384,125,118,243,51.4%,42m
37093,1,Champs,2245,669,53,52,105,50.5%,2h
37093,1,orion,2245,1403,48,49,97,49.5%,2h
37093,3,Wyatt,2245,1145,44,56,100,44.0%,2h
37093,1,livexx,2245,1067,35,42,77,45.5%,14m
37093,1,[BCBZ]oddstar,2245,742,26,22,48,54.2%,2h
37093,1,CID,2245,813,25,33,58,43.1%,25m
37093,2,[ZTempz]NOOBSTAH,2245,669,24,30,54,44.4%,2h
37093,1,JOHANJ,2245,366,12,18,30,40.0%,2h
37093,1,BasuraVerde,2245,432,11,13,24,45.8%,25m
37093,1,[ATIS]pheyder,2245,396,10,13,23,43.5%,2h
37093,3,[ERFT]Teniente,2245,232,8,15,23,34.8%,39m
37093,1,[oopsee]Scissssssors,2245,232,7,4,11,63.6%,41m
37093,1,ijooz,2245,256,7,9,16,43.8%,18m
37093,2,[MLGZ]Russ,2245,0,3,3,6,50.0%,2h
37093,3,[Epokhé]Fachindor,2245,141,3,3,6,50.0%,34m
37093,1,NickYoung,2245,44,2,1,3,66.7%,2h
37093,1,Maru,2245,97,2,6,8,25.0%,2h
37093,1,Merlin,2245,0,1,0,1,100.0%,2h
37093,1,ESLAyed,2245,0,1,2,3,33.3%,25m
37093,1,SeventyFU,2245,0,1,3,4,25.0%,6m
37093,1,CaptainMorgn,2245,44,1,3,4,25.0%,25m
37093,1,Avalon,2245,0,1,5,6,16.7%,54m
37093,1,Bryson,2245,0,1,6,7,14.3%,2h
37093,1,Snowflake,2245,0,0,2,2,0.0%,2h
37093,1,butteR,2245,0,0,4,4,0.0%,2h
37119,1,ProtoRy,2244,1798,255,263,518,49.2%,2h
37119,3,SwagDuck,2244,674,64,58,122,52.5%,3h
37119,1,Ducal,2244,1668,59,60,119,49.6%,43m
37119,3,Foxdragon,2244,852,40,52,92,43.5%,45m
37119,1,Urgelgrew,2244,604,21,24,45,46.7%,2h
37119,1,BLASTING,2244,308,20,15,35,57.1%,2h
37119,3,[weekly]Annerose,2244,275,12,18,30,40.0%,19m
37119,1,emirojo,2244,297,10,14,24,41.7%,2h
37119,1,Aquilae,2244,313,10,16,26,38.5%,2h
37119,1,Amaranthine,2244,216,10,18,28,35.7%,38m
37119,1,CloudChaser,2244,340,9,11,20,45.0%,2h
37119,1,Agujaman,2244,347,9,21,30,30.0%,2h
37119,3,[αXLa]UnRepollo,2244,176,7,8,15,46.7%,43m
37119,3,Artanis,2244,148,6,11,17,35.3%,52m
37119,2,XPipecrashX,2244,0,4,0,4,100.0%,2h
37119,1,[matar]Player,2244,161,4,3,7,57.1%,27m
37119,1,iony,2244,146,4,4,8,50.0%,2h
37119,2,kimphamily,2244,36,3,9,12,25.0%,2h
37119,3,Qrinn,2244,121,2,2,4,50.0%,2h
37119,2,Xtreme,2244,34,2,6,8,25.0%,2h
37119,1,ZaGaRa,2244,42,2,6,8,25.0%,2h
37119,1,[N0BLE]Sizgil,2244,0,1,2,3,33.3%,3h
37119,1,FenrirX,2244,0,0,1,1,0.0%,39m
37119,1,StarWine,2244,0,0,2,2,0.0%,2h
37143,1,Nykidemus,2243,1420,77,84,161,47.8%,2h
37143,1,RoguePandas,2243,1035,76,74,150,50.7%,44m
37143,1,ElAjenjo,2243,1713,70,68,138,50.7%,2h
37143,2,Anonymus,2243,740,46,47,93,49.5%,46m
37143,1,Swiftty,2243,706,23,18,41,56.1%,26m
37143,1,ojncereal,2243,435,13,16,29,44.8%,51m
37143,1,NoManNo,2243,336,10,13,23,43.5%,2h
37143,1,bacura,2243,254,8,10,18,44.4%,2h
37143,1,eltikastik,2243,316,8,14,22,36.4%,2h
37143,1,[XpKAc]leo,2243,70,3,2,5,60.0%,52m
37143,3,Dhez,2243,125,3,3,6,50.0%,39m
37143,1,PoloPAC,2243,134,2,2,4,50.0%,16m
37143,1,rangertot,2243,74,2,3,5,40.0%,2h
37143,1,charlieliu,2243,82,2,3,5,40.0%,2h
37143,3,Pijonsio,2243,30,2,4,6,33.3%,2h
37143,2,Maligant,2243,60,2,11,13,15.4%,4m
37143,1,Ferg,2243,0,1,0,1,100.0%,27m
37143,2,[Lpmm]kratoz,2243,0,1,0,1,100.0%,4m
37143,1,[ZTempz]Progenex,2243,0,1,1,2,50.0%,2h
37143,1,[VSB]SilentShadow,2243,42,1,2,3,33.3%,25m
37143,3,Nine,2243,0,1,4,5,20.0%,2h
37143,3,Crouton,2243,0,1,4,5,20.0%,10m
37143,2,Fatman,2243,0,0,1,1,0.0%,2h
37143,1,StarLegions,2243,0,0,1,1,0.0%,43m
37167,1,Blitzed,2242,1800,530,537,1067,49.7%,2h
37167,1,Pumpkin,2242,1812,104,105,209,49.8%,11m
37167,1,XplooD,2242,1519,90,90,180,50.0%,2h
37167,1,helardo,2242,1395,54,52,106,50.9%,39m
37167,1,[cluez]Drako,2242,515,38,26,64,59.4%,2h
37167,1,Nerd,2242,334,18,7,25,72.0%,2h
37167,1,Polaris,2242,492,15,14,29,51.7%,2h
37167,1,Xisting,2242,376,13,13,26,50.0%,2h
37167,1,lllIIIIlllll,2242,301,10,6,16,62.5%,2h
37167,1,[HVHI]STVR,2242,338,10,8,18,55.6%,2h
37167,3,Rick,2242,264,9,17,26,34.6%,22m
37167,1,Liquidvamp,2242,226,7,7,14,50.0%,3h
37167,3,dyl,2242,199,7,11,18,38.9%,2h
37167,1,[U1KY]Lifeline,2242,220,6,2,8,75.0%,28m
37167,3,Sunday,2242,140,6,14,20,30.0%,34m
37167,1,Raypoker,2242,158,4,7,11,36.4%,36m
37167,1,[1BNG]DukeVonFool,2242,126,3,11,14,21.4%,3h
37167,3,kaos,2242,121,2,1,3,66.7%,3m
37167,3,underwhelmd,2242,0,2,7,9,22.2%,29m
37167,1,bsuga,2242,0,1,0,1,100.0%,11m
37167,1,PadanFain,2242,0,1,0,1,100.0%,2h
37167,2,aNdoRi,2242,48,1,1,2,50.0%,4m
37167,2,[Aiur23]DarkGamer,2242,0,1,2,3,33.3%,2h
37167,1,[Wetsu]YoloSwag,2242,117,1,5,6,16.7%,2h
37167,1,Hendo,2242,0,0,1,1,0.0%,2h
37167,1,Quecito,2242,0,0,2,2,0.0%,2h
37193,1,FronFace,2241,1546,67,63,130,51.5%,5m
37193,1,Religare,2241,518,61,83,144,42.4%,2h
37193,1,[HENT4I]Taquito,2241,743,27,20,47,57.4%,2h
37193,3,IGN,2241,677,26,30,56,46.4%,2h
37193,1,[aisg]Temperau,2241,524,21,15,36,58.3%,13m
37193,1,RAW,2241,494,13,11,24,54.2%,2h
37193,3,[OreBad]MiniNinja,2241,179,10,15,25,40.0%,2h
37193,1,Pricursor,2241,241,7,11,18,38.9%,22m
37193,3,Nikolazgg,2241,147,4,9,13,30.8%,2h
37193,2,sawyerCity,2241,0,3,3,6,50.0%,34m
37193,1,EvilSnowmanX,2241,122,3,8,11,27.3%,2h
37193,2,KingDavid,2241,0,1,4,5,20.0%,2h
37193,3,Slavoj,2241,0,1,6,7,14.3%,47m
37193,1,Django,2241,0,0,1,1,0.0%,2h
37193,1,TiTEPLOTTE,2241,0,0,1,1,0.0%,2h
37193,1,Benbur,2241,0,0,1,1,0.0%,2h
37193,2,omomo,2241,0,0,5,5,0.0%,3h
37193,1,[S0ft]Wamphyri,2241,0,0,6,6,0.0%,2h
37211,1,Kchorro,2240,1785,128,121,249,51.4%,52m
37211,2,sunsetsurf,2240,1206,95,103,198,48.0%,8m
37211,3,xXOverMindXx,2240,1119,41,49,90,45.6%,2h
37211,1,[αB]SizeMatters,2240,856,26,33,59,44.1%,2h
37211,3,Jester,2240,569,26,35,61,42.6%,22m
37211,1,DanKang,2240,575,24,20,44,54.5%,4m
37211,1,idrasil,2240,427,16,13,29,55.2%,2h
37211,1,Jehovay,2240,342,9,10,19,47.4%,8m
37211,3,MissMicro,2240,243,8,11,19,42.1%,2h
37211,1,[drgg]Bojangles,2240,306,8,13,21,38.1%,23m
37211,1,[TAoG]Bstrange,2240,234,8,16,24,33.3%,18m
37211,1,[TAW1]Subrat,2240,262,7,7,14,50.0%,2h
37211,3,[SBoys]THEKiwininja,2240,205,6,5,11,54.5%,3m
37211,3,[hewwo1]Rint,2240,96,5,10,15,33.3%,2h
37211,1,Jake,2240,193,4,3,7,57.1%,2h
37211,1,LillyWap,2240,86,4,6,10,40.0%,2h
37211,1,KaiserND,2240,107,3,0,3,100.0%,2h
37211,1,SlipShade,2240,124,3,8,11,27.3%,15m
37211,1,Narglfard,2240,66,2,3,5,40.0%,2h
37211,1,SuperMamani,2240,0,2,8,10,20.0%,2h
37211,1,Kral,2240,0,1,1,2,50.0%,2h
37211,1,Schnetz,2240,30,1,1,2,50.0%,3h
37211,1,Lionheart,2240,0,0,1,1,0.0%,2h
37211,1,GuineaPiglet,2240,0,0,1,1,0.0%,13m
37211,3,[DXTNY]SKSword,2240,0,0,2,2,0.0%,2h
37236,1,MasterCpu,2239,1599,154,172,326,47.2%,22m
37236,1,LazaZemun,2239,1645,99,102,201,49.3%,2h
37236,1,Atona,2239,1616,58,62,120,48.3%,2h
37236,2,VoidStrike,2239,1496,56,62,118,47.5%,2h
37236,1,[RGNMG]RAGNAROK,2239,1283,49,47,96,51.0%,11m
37236,1,[Magic]semantic,2239,839,47,51,98,48.0%,53m
37236,1,red,2239,1047,41,30,71,57.7%,3h
37236,1,Skninja,2239,920,37,38,75,49.3%,11m
37236,1,gunty,2239,1010,31,31,62,50.0%,2h
37236,1,CrazyCarl,2239,587,24,14,38,63.2%,3h
37236,1,NUSUMBA,2239,474,20,11,31,64.5%,2h
37236,1,Cyrex,2239,414,16,18,34,47.1%,16m
37236,3,[TGOOD]Serral,2239,418,15,24,39,38.5%,3h
37236,3,Zeratuldo,2239,314,11,11,22,50.0%,2h
37236,1,JoakorVF,2239,329,9,7,16,56.2%,2h
37236,1,Goldar,2239,186,6,10,16,37.5%,46m
37236,1,DarthSeverus,2239,0,3,3,6,50.0%,2h
37236,1,fadrian,2239,103,3,4,7,42.9%,43m
37236,1,Razaako,2239,104,2,2,4,50.0%,5m
37236,1,Uan,2239,90,2,4,6,33.3%,23m
37236,1,HolyWing,2239,102,2,5,7,28.6%,2h
37236,1,person,2239,0,1,5,6,16.7%,2h
37236,1,AScaryMoose,2239,0,1,5,6,16.7%,2h
37236,1,OmgItsAlx,2239,0,1,5,6,16.7%,9m
37236,1,[1Ec0n1]Katahoola,2239,0,1,6,7,14.3%,2h
37236,1,emilcat,2239,0,0,1,1,0.0%,2h
37236,1,wgc,2239,0,0,1,1,0.0%,2h
37236,1,[Vtta]juan,2239,0,0,2,2,0.0%,2h
37236,1,zerlan,2239,0,0,2,2,0.0%,49m
37236,1,Dowsky,2239,0,0,3,3,0.0%,43m
37236,1,SEAN,2239,0,0,3,3,0.0%,2h
37236,1,angjim,2239,0,0,5,5,0.0%,54m
37236,1,CACAOCHAMAN,2239,0,0,6,6,0.0%,50m
37269,1,Scoog,2238,1814,290,291,581,49.9%,25m
37269,1,TinSoldier,2238,1702,91,94,185,49.2%,16m
37269,1,addictedK,2238,529,65,61,126,51.6%,3h
37269,1,djtal,2238,699,54,51,105,51.4%,2h
37269,1,Shoshin,2238,630,22,21,43,51.2%,54m
37269,1,RandALthor,2238,383,16,8,24,66.7%,35m
37269,1,Jbaddinz,2238,464,16,10,26,61.5%,3h
37269,1,Beyonder,2238,516,15,13,28,53.6%,2h
37269,1,rodrigo,2238,284,12,16,28,42.9%,3h
37269,1,[2ES]JayD,2238,365,12,20,32,37.5%,2h
37269,2,Asakanji,2238,246,11,23,34,32.4%,24m
37269,1,CEOofKnwldge,2238,346,10,13,23,43.5%,2h
37269,3,[pSC20]IronClaD,2238,184,6,19,25,24.0%,2h
37269,1,Ritty,2238,0,3,2,5,60.0%,2h
37269,3,AverageGamez,2238,122,3,8,11,27.3%,53m
37269,1,suduman,2238,40,2,1,3,66.7%,2h
37269,1,Winger,2238,100,2,5,7,28.6%,2h
37269,2,[GTO4]GermX,2238,38,2,8,10,20.0%,2h
37269,1,ScrewDriver,2238,0,1,2,3,33.3%,11m
37269,1,macerid,2238,0,1,5,6,16.7%,13m
37269,1,BLADE,2238,0,1,6,7,14.3%,2h
37269,2,CDXF,2238,0,0,1,1,0.0%,4m
37291,2,Wah,2237,1487,132,140,272,48.5%,21m
37291,2,caraEcalzon,2237,856,96,106,202,47.5%,39m
37291,3,Erick,2237,1469,69,77,146,47.3%,6m
37291,1,[ZTemp]phillgill,2237,975,45,35,80,56.2%,39m
37291,1,Impey,2237,1160,38,39,77,49.4%,3h
37291,1,RitzNCheese,2237,916,34,26,60,56.7%,43m
37291,1,[kvac]vcitor,2237,974,31,30,61,50.8%,41m
37291,1,qbit,2237,968,31,31,62,50.0%,2h
37291,1,GeneralTso,2237,942,30,27,57,52.6%,3h
37291,1,Alpacacide,2237,932,30,33,63,47.6%,2h
37291,1,TheShrike,2237,742,27,20,47,57.4%,2h
37291,1,OuTLaw,2237,764,23,24,47,48.9%,2h
37291,1,BeepImaJeep,2237,235,7,4,11,63.6%,52m
37291,1,ivan,2237,196,7,8,15,46.7%,31m
37291,1,Santossk,2237,155,5,5,10,50.0%,2h
37291,1,dannehboy,2237,172,4,6,10,40.0%,8m
37291,1,Ocelot,2237,78,3,1,4,75.0%,39m
37291,1,DasWish,2237,107,2,6,8,25.0%,54m
37291,1,Alextay,2237,0,1,0,1,100.0%,52m
37291,1,Newroll,2237,0,1,0,1,100.0%,40m
37291,1,[ExceI]RVG,2237,0,1,1,2,50.0%,2h
37291,1,Bloomfish,2237,0,1,5,6,16.7%,18m
37291,3,skyclad,2237,30,1,5,6,16.7%,2h
37291,1,Manuel,2237,0,0,1,1,0.0%,5m
37291,1,fodder,2237,0,0,1,1,0.0%,2h
37291,3,Wonmobo,2237,0,0,2,2,0.0%,2h
37317,1,Madlib,2236,1711,85,87,172,49.4%,27m
37317,1,nimrod,2236,1061,60,52,112,53.6%,26m
37317,1,DthreeR,2236,1455,49,49,98,50.0%,2h
37317,2,Person,2236,1156,39,53,92,42.4%,2h
37317,1,Pancho,2236,889,37,39,76,48.7%,22m
37317,1,TAZ,2236,988,32,27,59,54.2%,39m
37317,1,Vicboss,2236,916,32,32,64,50.0%,8m
37317,1,ZerGi,2236,505,17,13,30,56.7%,16m
37317,3,AKellen,2236,271,11,6,17,64.7%,2h
37317,1,MelloGator,2236,326,9,6,15,60.0%,40m
37317,1,RaulRuns,2236,241,8,8,16,50.0%,2h
37317,1,celendis,2236,216,7,7,14,50.0%,4m
37317,1,[Crip1]skywardfire,2236,194,6,3,9,66.7%,54m
37317,1,ZERGslayer,2236,233,6,10,16,37.5%,36m
37317,1,monku,2236,192,5,9,14,35.7%,2h
37317,1,[IGeaL]Wuiishoo,2236,76,3,7,10,30.0%,2h
37317,1,Zerthl,2236,88,2,6,8,25.0%,40m
37317,1,IVDenisovich,2236,0,1,0,1,100.0%,4m
37317,1,[7EK]DARTHSHRDR,2236,0,0,1,1,0.0%,2h
37317,1,Remous,2236,0,0,1,1,0.0%,2h
37317,1,SiRen,2236,0,0,1,1,0.0%,46m
37317,1,MekaRaven,2236,0,0,2,2,0.0%,2h
37317,1,Fenocb,2236,0,0,4,4,0.0%,2h
37317,1,[CatImp]Iconicion,2236,0,0,5,5,0.0%,44m
37341,2,VikingDance,2235,1491,144,141,285,50.5%,2h
37341,3,jefe,2235,1394,131,137,268,48.9%,2h
37341,1,[FIEE]ToNyZeRo,2235,1566,81,76,157,51.6%,51m
37341,1,Swinestein,2235,1376,52,57,109,47.7%,2h
37341,1,PepePa,2235,838,34,31,65,52.3%,4m
37341,1,[Lion]JakDom,2235,891,34,33,67,50.7%,34m
37341,1,CristaGoga,2235,725,31,18,49,63.3%,2m
37341,1,slug,2235,277,22,16,38,57.9%,2h
37341,1,Wolfey,2235,513,21,16,37,56.8%,2h
37341,1,[TILL]ThisIstheWAY,2235,470,16,10,26,61.5%,2h
37341,3,[SyLx]snow,2235,238,9,8,17,52.9%,2h
37341,1,peec,2235,198,7,7,14,50.0%,2h
37341,3,[MexPw]VACHOS,2235,235,7,8,15,46.7%,53m
37341,1,TurfBurn,2235,230,7,8,15,46.7%,2h
37341,1,Marshy,2235,236,6,9,15,40.0%,3h
37341,1,uFFoZ,2235,208,5,8,13,38.5%,2h
37341,1,MinhDau,2235,210,5,11,16,31.2%,20m
37341,1,SolidStoner,2235,228,5,12,17,29.4%,2h
37341,1,Baujahr,2235,120,4,3,7,57.1%,2m
37341,2,[XsicX]hairyareola,2235,0,4,6,10,40.0%,38m
37341,1,Chen,2235,0,3,3,6,50.0%,16m
37341,1,axel,2235,44,3,5,8,37.5%,8m
37341,1,clouddxv,2235,0,2,4,6,33.3%,2h
37341,3,bizmofunyun,2235,97,2,7,9,22.2%,34m
37341,3,FuzzyLogic,2235,30,1,1,2,50.0%,2h
37341,1,Phoenix,2235,0,1,5,6,16.7%,20m
37341,3,thewolf,2235,30,1,6,7,14.3%,2h
37341,1,FiSTiCuFF,2235,0,0,1,1,0.0%,2h
37341,1,Kharika,2235,0,0,2,2,0.0%,2m
37341,1,MemesToAnEnd,2235,0,0,2,2,0.0%,2h
37341,3,[JB420]Nopi,2235,0,0,3,3,0.0%,38m
37341,3,BeginerE,2235,0,0,3,3,0.0%,9m
37373,1,StarPlayer,2234,1338,131,131,262,50.0%,39m
37373,1,Sickdirty,2234,1181,98,86,184,53.3%,2h
37373,1,Garradeleon,2234,1458,83,83,166,50.0%,2h
37373,1,[2IQ]SireJackson,2234,630,22,25,47,46.8%,2h
37373,1,HumbleTiger,2234,305,12,13,25,48.0%,6m
37373,1,Precision,2234,321,11,18,29,37.9%,29m
37373,1,cryston,2234,342,11,19,30,36.7%,2h
37373,1,zzzz,2234,296,9,17,26,34.6%,2h
37373,1,Tactician,2234,284,8,5,13,61.5%,2h
37373,1,Ajom,2234,210,7,3,10,70.0%,25m
37373,1,[MIKES]Mike,2234,209,6,6,12,50.0%,31m
37373,1,Maqquiez,2234,236,6,12,18,33.3%,2h
37373,2,tjshen,2234,173,5,8,13,38.5%,45m
37373,2,Talis,2234,0,2,3,5,40.0%,2h
37373,1,[M3AT]CliffxCore,2234,42,2,6,8,25.0%,3h
37373,1,darklordhill,2234,97,2,6,8,25.0%,29m
37373,1,Bjj,2234,0,2,8,10,20.0%,2h
37373,2,Justin,2234,0,1,4,5,20.0%,53m
37373,1,Maramor,2234,0,1,5,6,16.7%,2h
37373,3,CloneGhost,2234,0,0,1,1,0.0%,43m
37373,1,[ENFql]Alec,2234,0,0,1,1,0.0%,7m
37394,3,Strikofskee,2233,1559,202,212,414,48.8%,31m
37394,1,[DTML]BoomBoomWeYo,2233,1160,87,71,158,55.1%,2h
37394,1,CaptVulture,2233,1615,80,70,150,53.3%,16m
37394,1,[SWRqc]DeePhazed,2233,1697,65,63,128,50.8%,54m
37394,1,VicThor,2233,801,37,26,63,58.7%,26m
37394,1,Hexis,2233,426,34,34,68,50.0%,2h
37394,1,jpeter,2233,771,25,21,46,54.3%,2h
37394,1,Einzlander,2233,635,22,17,39,56.4%,39m
37394,1,Bronze,2233,325,20,2,22,90.9%,2m
37394,1,SoulStinger,2233,389,18,22,40,45.0%,2h
37394,1,[NSB01]Caprisun,2233,515,16,18,34,47.1%,2h
37394,1,kenneth,2233,294,15,3,18,83.3%,2h
37394,2,Whipspider,2233,251,9,14,23,39.1%,40m
37394,1,Purple,2233,308,8,13,21,38.1%,2h
37394,3,SuperZeb,2233,224,7,10,17,41.2%,2h
37394,1,Dave,2233,170,6,1,7,85.7%,2h
37394,1,destroyeric,2233,184,5,9,14,35.7%,2h
37394,1,Trock,2233,196,5,10,15,33.3%,46m
37394,2,[30G]finalfate,2233,158,5,20,25,20.0%,2h
37394,1,Kazzak,2233,178,4,7,11,36.4%,36m
37394,1,MegaNerrd,2233,93,2,0,2,100.0%,2h
37394,1,alaracpro,2233,38,2,1,3,66.7%,2h
37394,2,[Yukon]Tympanycus,2233,0,2,7,9,22.2%,37m
37394,1,BRUTUS,2233,0,1,0,1,100.0%,39m
37394,1,[1030]nestor,2233,0,1,1,2,50.0%,2h
37394,1,[MTL]MoutaZeus,2233,0,1,3,4,25.0%,2h
37394,1,ZhengTay,2233,42,1,5,6,16.7%,2h
37394,3,masseywill,2233,0,1,5,6,16.7%,45m
37394,3,Fisher,2233,0,1,6,7,14.3%,17m
37394,1,Havok,2233,0,0,1,1,0.0%,39m
37394,1,[SN4CKS]Tetsura,2233,0,0,3,3,0.0%,2h
37425,1,[LOHd]DUYHUNG,2232,1811,236,268,504,46.8%,52m
37425,1,[0425]NEMO,2232,1452,73,63,136,53.7%,2h
37425,2,glenelg,2232,1015,57,66,123,46.3%,3h
37425,1,Pheonix,2232,1345,55,42,97,56.7%,2h
37425,1,[SIMPx]TottyX,2232,1194,40,43,83,48.2%,45m
37425,1,Suamãe,2232,824,38,39,77,49.4%,2h
37425,1,sammas,2232,513,16,25,41,39.0%,2h
37425,3,marcbigfive,2232,395,14,22,36,38.9%,2h
37425,1,orthow,2232,292,10,6,16,62.5%,51m
37425,1,Cazaputas,2232,234,9,14,23,39.1%,16m
37425,1,Jhonathan,2232,264,8,8,16,50.0%,54m
37425,1,Omarwaliuz,2232,242,7,12,19,36.8%,3h
37425,1,Scaden,2232,149,6,1,7,85.7%,2h
37425,1,Sylas,2232,144,6,9,15,40.0%,2h
37425,1,[C38108]Xaviel,2232,154,5,6,11,45.5%,2h
37425,1,bitour,2232,176,5,6,11,45.5%,43m
37425,2,Deleted,2232,92,5,11,16,31.2%,2h
37425,3,[LÞ]RaZeN,2232,119,3,7,10,30.0%,2h
37425,3,[FLUFFS]KCHU,2232,97,2,1,3,66.7%,2h
37425,1,BestiaNegra,2232,133,2,5,7,28.6%,2h
37425,1,Somnus,2232,86,2,9,11,18.2%,10m
37425,1,iKiDo,2232,0,1,0,1,100.0%,40m
37425,2,ImFaDeD,2232,0,1,4,5,20.0%,14m
37425,1,hummerhumpty,2232,88,1,5,6,16.7%,25m
37425,1,jose,2232,0,0,1,1,0.0%,3m
37425,1,KingIggy,2232,0,0,1,1,0.0%,3h
37425,1,arkfire,2232,0,0,1,1,0.0%,18m
37425,1,[Covi19]Nebula,2232,0,0,1,1,0.0%,2h
37425,1,ariel,2232,0,0,1,1,0.0%,2h
37425,1,ThePainTrain,2232,0,0,6,6,0.0%,2h
37455,3,Dzulûm,2231,1421,230,236,466,49.4%,2h
37455,1,Sorim,2231,1699,112,108,220,50.9%,3h
37455,1,ZeekeTheGeek,2231,1330,50,49,99,50.5%,6m
37455,1,escanor,2231,1207,41,38,79,51.9%,2h
37455,3,Kravitz,2231,278,23,29,52,44.2%,2h
37455,1,eCakes,2231,262,8,7,15,53.3%,29m
37455,3,Steven,2231,251,8,12,20,40.0%,14m
37455,3,JagHasie,2231,220,8,15,23,34.8%,45m
37455,1,Moonkhalifa,2231,323,7,14,21,33.3%,11m
37455,1,[B51608]crushinator,2231,215,5,4,9,55.6%,2h
37455,1,NINJAAPPLE,2231,216,5,7,12,41.7%,2h
37455,3,NoWayOut,2231,197,5,11,16,31.2%,2h
37455,2,slickerd,2231,124,5,12,17,29.4%,2h
37455,1,fishfave,2231,183,4,8,12,33.3%,2h
37455,3,[F4R7Z]JackAssJr,2231,86,4,9,13,30.8%,2h
37455,3,Hellscream,2231,167,4,9,13,30.8%,2h
37455,1,SeAx,2231,124,3,1,4,75.0%,2h
37455,2,Commander,2231,0,3,2,5,60.0%,31m
37455,1,ZéRinite,2231,48,3,8,11,27.3%,35m
37455,1,Sleet,2231,44,2,2,4,50.0%,3h
37455,1,Dolokhov,2231,0,2,3,5,40.0%,2h
37455,1,Denesik,2231,48,2,7,9,22.2%,51m
37455,2,Buck,2231,0,1,0,1,100.0%,2h
37455,1,AndresD,2231,89,1,1,2,50.0%,54m
37455,1,[Wahya]TaxiSpill,2231,0,1,2,3,33.3%,52m
37455,1,SheepKiller,2231,42,1,2,3,33.3%,25m
37455,1,RicFer,2231,0,1,5,6,16.7%,2h
37455,1,Skyness,2231,88,1,5,6,16.7%,2h
37455,1,monkeyoneish,2231,0,0,2,2,0.0%,41m
37455,1,Azura,2231,0,0,2,2,0.0%,2h
37455,2,[DMONlC]movp,2231,0,0,5,5,0.0%,33m
37486,1,Lystat,2230,1756,181,186,367,49.3%,2h
37486,3,Mickdedley,2230,1271,101,92,193,52.3%,37m
37486,1,DuckODeath,2230,1051,87,88,175,49.7%,2h
37486,3,BQsauce,2230,1550,69,76,145,47.6%,32m
37486,3,CrazyKill,2230,189,49,54,103,47.6%,2h
37486,1,[TenSL]Facer,2230,995,44,41,85,51.8%,2h
37486,1,MrSparkly,2230,821,41,35,76,53.9%,5m
37486,1,[LivGam]WizardChops,2230,1024,35,33,68,51.5%,3h
37486,2,InsaneThots,2230,579,27,30,57,47.4%,2h
37486,1,[syrup]DarkSkon,2230,697,26,20,46,56.5%,25m
37486,1,[LastKT]Dubwn,2230,686,26,32,58,44.8%,2h
37486,3,Paramegarex,2230,755,25,34,59,42.4%,17m
37486,1,xaxisdix,2230,359,19,3,22,86.4%,34m
37486,1,Chilldemian,2230,569,17,23,40,42.5%,2h
37486,1,LazyTitan,2230,361,15,6,21,71.4%,2h
37486,1,Meillet,2230,398,14,18,32,43.8%,2h
37486,1,[LaOr]CacoAdodo,2230,440,13,15,28,46.4%,45m
37486,3,[NOSTV]Marcman,2230,276,10,19,29,34.5%,42m
37486,3,FlashFillet,2230,173,7,9,16,43.8%,2h
37486,1,[EDMC]OBEY,2230,238,6,7,13,46.2%,2h
37486,1,[NAFrog]werwercat,2230,132,6,13,19,31.6%,18m
37486,1,KiritoGames,2230,158,5,4,9,55.6%,2h
37486,3,[10MMR]Swarm,2230,120,5,10,15,33.3%,38m
37486,1,Jokoto,2230,117,4,4,8,50.0%,2h
37486,1,RayneFoxie,2230,150,4,8,12,33.3%,2h
37486,3,Ken,2230,151,4,10,14,28.6%,38m
37486,1,kzavitz,2230,84,3,7,10,30.0%,36m
37486,1,TukiTukiLuLu,2230,0,2,3,5,40.0%,5m
37486,1,[BScard]ScarVio,2230,0,0,1,1,0.0%,12m
37515,1,EDDYRICO,2229,1808,142,149,291,48.8%,22m
37515,2,matrix,2229,1518,60,77,137,43.8%,49m
37515,1,Shakuras,2229,1330,45,45,90,50.0%,51m
37515,1,Hunterpier,2229,943,32,34,66,48.5%,2h
37515,1,LilCosmonaut,2229,647,26,25,51,51.0%,34m
37515,1,bigman,2229,488,17,16,33,51.5%,7m
37515,2,JumpingJax,2229,378,16,22,38,42.1%,2h
37515,1,Darkn,2229,319,13,11,24,54.2%,2h
37515,1,Jayceebby,2229,466,13,15,28,46.4%,18m
37515,1,Sheed,2229,192,7,5,12,58.3%,6m
37515,1,tropicoXD,2229,127,5,0,5,100.0%,2h
37515,3,Jeremy,2229,149,4,8,12,33.3%,28m
37515,1,Daniel,2229,112,2,3,5,40.0%,3h
37515,1,Ferb,2229,0,2,4,6,33.3%,2h
37515,2,JimmyGRT,2229,46,2,5,7,28.6%,2h
37515,1,[GEMC]Sebastian,2229,0,1,0,1,100.0%,2h
37515,1,skibum,2229,0,1,1,2,50.0%,3h
37515,1,Xacolyte,2229,0,1,1,2,50.0%,2h
37515,2,Riuka,2229,0,1,4,5,20.0%,49m
37515,1,Niltevs,2229,0,1,5,6,16.7%,9m
37515,1,DoctorElkay,2229,0,1,6,7,14.3%,2h
37515,1,ViAT,2229,0,0,2,2,0.0%,31m
37515,1,ZerVencedor,2229,0,0,5,5,0.0%,11m
37538,1,Bacon,2228,1578,88,89,177,49.7%,31m
37538,1,Cobata,2228,1388,47,56,103,45.6%,5m
37538,1,DeepStrut,2228,989,36,30,66,54.5%,54m
37538,1,JACOBY,2228,806,31,38,69,44.9%,30m
37538,2,Mally,2228,438,21,31,52,40.4%,20m
37538,3,ToxicIVdrip,2228,492,18,19,37,48.6%,10m
37538,1,JaggedFel,2228,396,14,17,31,45.2%,2h
37538,3,Dblacksanta,2228,275,13,26,39,33.3%,48m
37538,1,Nile,2228,263,10,2,12,83.3%,26m
37538,1,BigjiBAA,2228,306,10,9,19,52.6%,3h
37538,1,fluff,2228,322,8,9,17,47.1%,2h
37538,3,paragontrix,2228,222,7,6,13,53.8%,29m
37538,1,Jerry,2228,188,6,10,16,37.5%,31m
37538,3,PanckeMaster,2228,171,5,12,17,29.4%,53m
37538,3,keyps,2228,174,4,10,14,28.6%,2h
37538,1,[anti5z]Gabriel,2228,79,3,7,10,30.0%,2h
37538,3,Zergg,2228,121,3,9,12,25.0%,2h
37538,1,nullPointer,2228,0,2,3,5,40.0%,12m
37538,1,[gente]karmanbro,2228,78,2,3,5,40.0%,2h
37538,1,XIAN,2228,0,1,4,5,20.0%,2h
37558,1,mukelamon,2227,1261,91,88,179,50.8%,2m
37558,1,terran,2227,1557,64,59,123,52.0%,16m
37558,3,[0825]CandyLand,2227,1282,53,53,106,50.0%,21m
37558,3,Wolfman,2227,1408,51,61,112,45.5%,6m
37558,1,[ETClan]conchimxanh,2227,1288,47,59,106,44.3%,6m
37558,1,goldspee,2227,1028,36,40,76,47.4%,46m
37558,1,LasagneWest,2227,957,32,37,69,46.4%,31m
37558,1,Ittifi,2227,705,23,22,45,51.1%,2h
37558,1,danieluna,2227,597,18,20,38,47.4%,25m
37558,1,Rice,2227,516,15,15,30,50.0%,2h
37558,3,Michael,2227,266,11,18,29,37.9%,3h
37558,1,LEO,2227,404,11,18,29,37.9%,2h
37558,1,AnaKonda,2227,249,7,8,15,46.7%,2h
37558,3,MacBeth,2227,208,7,16,23,30.4%,3h
37558,1,hantusitinh,2227,251,6,10,16,37.5%,22m
37558,1,HeroGhots,2227,161,4,1,5,80.0%,29m
37558,1,rodrigo,2227,95,4,3,7,57.1%,2h
37558,1,kanec,2227,108,4,5,9,44.4%,2h
37558,1,SmellyMcToot,2227,129,2,6,8,25.0%,8m
37558,1,BigPoppa,2227,0,1,0,1,100.0%,28m
37558,1,Alazay,2227,0,1,2,3,33.3%,27m
37558,1,Deox,2227,0,1,5,6,16.7%,26m
37558,1,luckysteel,2227,0,0,1,1,0.0%,2h
37558,1,Fixer,2227,0,0,1,1,0.0%,3h
37558,1,KLSDJDJKFHJD,2227,0,0,1,1,0.0%,12m
37558,1,diegueste,2227,0,0,3,3,0.0%,2h
37584,3,Benmoji,2226,1602,350,350,700,50.0%,2h
37584,1,Luntu,2226,1800,91,93,184,49.5%,52m
37584,1,BloodRage,2226,1716,62,57,119,52.1%,2h
37584,1,QlyonEl,2226,979,42,32,74,56.8%,2h
37584,1,ShtookManDoo,2226,1083,36,36,72,50.0%,2h
37584,1,koas,2226,1018,34,35,69,49.3%,2h
37584,1,[GOPERÚ]Eral,2226,941,33,42,75,44.0%,41m
37584,1,Ding,2226,555,19,21,40,47.5%,2h
37584,1,DippaTone,2226,602,19,23,42,45.2%,3h
37584,1,LAWZ,2226,536,16,16,32,50.0%,22m
37584,1,SIRvProtoos,2226,395,15,13,28,53.6%,3h
37584,1,Sheep,2226,552,14,20,34,41.2%,2h
37584,1,Emanuel,2226,423,12,19,31,38.7%,16m
37584,1,Blaszak,2226,329,11,10,21,52.4%,2h
37584,1,Shadovv,2226,303,11,14,25,44.0%,51m
37584,1,Cyclone,2226,140,5,2,7,71.4%,2h
37584,1,isocubed,2226,134,4,3,7,57.1%,2h
37584,1,MisterUwU,2226,46,2,2,4,50.0%,2h
37584,1,[Saiyas]elBattu,2226,34,2,2,4,50.0%,15m
37584,2,Balderdash,2226,0,2,7,9,22.2%,7m
37584,1,Joerjavi,2226,42,1,2,3,33.3%,5m
37584,1,Ger,2226,0,0,1,1,0.0%,3h
37584,1,[TGCrew]Cronosphere,2226,0,0,4,4,0.0%,2h
37607,3,[GoldPo]TRUEJUSTICE,2225,1552,210,204,414,50.7%,48m
37607,3,Elias,2225,1515,180,182,362,49.7%,2h
37607,1,mija,2225,1141,59,64,123,48.0%,45m
37607,1,[NOGGFU]Destropia,2225,919,54,9,63,85.7%,4m
37607,1,Mfernandez,2225,1206,45,49,94,47.9%,2h
37607,1,king,2225,864,25,33,58,43.1%,26m
37607,1,Mccheese,2225,555,21,18,39,53.8%,14m
37607,1,kyle,2225,413,14,12,26,53.8%,3h
37607,1,padrote,2225,288,7,12,19,36.8%,2h
37607,2,EvilMorty,2225,135,4,9,13,30.8%,2h
37607,3,Anonymous,2225,30,3,7,10,30.0%,2h
37607,1,[4bronz]DARTHZERATUL,2225,126,2,2,4,50.0%,2h
37607,1,DaBeast,2225,44,2,2,4,50.0%,36m
37607,3,Alucard,2225,123,2,4,6,33.3%,2h
37607,1,Arapo,2225,134,2,6,8,25.0%,2h
37607,1,BarcodeBill,2225,0,1,1,2,50.0%,3h
37607,1,GAMBITO,2225,88,1,5,6,16.7%,2h
37607,1,xdwarlordxd,2225,0,0,1,1,0.0%,3h
37607,1,IIIIIIIIIIII,2225,0,0,1,1,0.0%,16m
37607,1,zzyzx,2225,0,0,1,1,0.0%,27m
37607,1,Sam,2225,0,0,2,2,0.0%,25m
37607,1,SonOfClay,2225,0,0,2,2,0.0%,12m
37629,1,THROBMANMEAT,2224,1164,41,42,83,49.4%,12m
37629,1,[NSushi]APalestino,2224,1146,36,37,73,49.3%,2h
37629,1,BKLYNWarLord,2224,875,35,30,65,53.8%,15m
37629,1,chardonay,2224,669,21,18,39,53.8%,2h
37629,1,[QcScT]EoS,2224,429,15,18,33,45.5%,39m
37629,1,[1623]Char,2224,406,14,12,26,53.8%,5m
37629,1,Computer,2224,456,13,14,27,48.1%,3h
37629,1,jasonx,2224,454,13,18,31,41.9%,2h
37629,1,Devin,2224,309,10,13,23,43.5%,2h
37629,3,SneakyPigeon,2224,72,6,9,15,40.0%,38m
37629,3,Bandit,2224,129,5,7,12,41.7%,2h
37629,1,[0825]StubbyCore,2224,160,4,6,10,40.0%,2h
37629,1,AlwaysAngry,2224,164,4,8,12,33.3%,23m
37629,2,draco,2224,62,4,8,12,33.3%,48m
37629,1,Xaaron,2224,130,3,7,10,30.0%,2h
37629,1,Aldeae,2224,74,3,7,10,30.0%,2h
37629,1,[HOT69]Celt,2224,0,0,1,1,0.0%,2h
37629,1,QuickChick,2224,0,0,1,1,0.0%,2h
37629,1,KaitoKid,2224,0,0,3,3,0.0%,41m
37629,3,jwolg,2224,0,0,7,7,0.0%,2h
37649,3,Gon,2223,1570,155,140,295,52.5%,21m
37649,1,PREDADOR,2223,1753,112,114,226,49.6%,11m
37649,1,Cruzonjaos,2223,1537,79,88,167,47.3%,2h
37649,3,[Staunc]Slawmaster,2223,1296,47,55,102,46.1%,2h
37649,1,WatWatInDaBu,2223,223,8,7,15,53.3%,2h
37649,1,kueaa,2223,131,4,2,6,66.7%,2h
37649,3,Doranti,2223,149,4,9,13,30.8%,21m
37649,1,[4aRaza]Danx,2223,134,3,2,5,60.0%,2h
37649,1,Mjolnir,2223,0,3,3,6,50.0%,2h
37649,1,Chipermix,2223,96,3,9,12,25.0%,2h
37649,1,ByxAlonso,2223,89,2,0,2,100.0%,45m
37649,3,[LSEX]pasthor,2223,30,2,3,5,40.0%,2h
37649,1,Oscar,2223,48,2,3,5,40.0%,26m
37649,3,[NrFms]llllllllllll,2223,92,2,6,8,25.0%,36m
37649,1,PST,2223,0,1,1,2,50.0%,2h
37649,1,Arturis,2223,0,1,5,6,16.7%,2h
37649,1,scumbag,2223,0,1,5,6,16.7%,3m
37649,1,Sukram,2223,0,0,1,1,0.0%,2h
37649,1,Brotoss,2223,0,0,1,1,0.0%,2h
37649,1,TehEpikDuck,2223,0,0,1,1,0.0%,2m
37669,1,Kynn,2222,1667,77,77,154,50.0%,35m
37669,1,Nooob,2222,1295,44,44,88,50.0%,2h
37669,1,Surge,2222,1184,41,40,81,50.6%,3h
37669,1,LightWave,2222,967,38,42,80,47.5%,2h
37669,1,Billyenair,2222,409,37,40,77,48.1%,41m
37669,1,MITHDRAUG,2222,1011,32,33,65,49.2%,16m
37669,1,[DhZAc1]Esttorvo,2222,691,23,21,44,52.3%,5m
37669,1,JuanJo,2222,716,22,17,39,56.4%,2h
37669,1,Overlord,2222,457,14,10,24,58.3%,3h
37669,3,[USUCC]FlyAndrew,2222,319,13,9,22,59.1%,2h
37669,1,kupsman,2222,406,13,11,24,54.2%,25m
37669,1,Chalo,2222,354,10,20,30,33.3%,2h
37669,1,kevin,2222,185,9,8,17,52.9%,27m
37669,1,creich,2222,120,7,2,9,77.8%,2h
37669,1,[B4Str2]DetroidRoach,2222,178,5,7,12,41.7%,7m
37669,3,Sock,2222,166,5,8,13,38.5%,16m
37669,1,[EWM]Blueboy,2222,166,5,12,17,29.4%,45m
37669,1,Netuno,2222,137,3,2,5,60.0%,11m
37669,1,Nordy,2222,108,3,4,7,42.9%,2h
37669,3,cadre,2222,119,3,8,11,27.3%,2h
37669,1,Pablosko,2222,134,2,6,8,25.0%,3h
37669,1,RogerThat,2222,0,1,0,1,100.0%,2h
37669,1,sharknado,2222,89,1,1,2,50.0%,42m
37669,3,[LTlord]Rolax,2222,0,1,3,4,25.0%,2h
37669,1,[ZTB]Benjee,2222,42,1,4,5,20.0%,2h
37669,1,Rippitallday,2222,0,0,2,2,0.0%,2h
37669,1,supertravis,2222,0,0,2,2,0.0%,2h
37669,2,Jeducool,2222,0,0,5,5,0.0%,13m
37669,2,grayco,2222,0,0,5,5,0.0%,21m
37698,1,Raptor,2221,1794,240,241,481,49.9%,42m
37698,2,[URINE]RamMan,2221,1445,205,228,433,47.3%,23m
37698,1,Alfredete,2221,1808,192,191,383,50.1%,2h
37698,1,jBird,2221,1581,158,166,324,48.8%,4m
37698,3,CRAZYFISH,2221,1158,82,82,164,50.0%,2h
37698,1,Graynomic,2221,487,35,38,73,47.9%,13m
37698,1,ACT,2221,1000,30,35,65,46.2%,3m
37698,1,princess,2221,852,27,31,58,46.6%,2h
37698,1,molito,2221,643,20,26,46,43.5%,2h
37698,1,[gRaNNy]Beatrice,2221,224,19,15,34,55.9%,45m
37698,1,[SDLB]XCaNNzX,2221,535,17,14,31,54.8%,25m
37698,1,Grander,2221,392,15,14,29,51.7%,46m
37698,1,AnGeLuZ,2221,393,14,15,29,48.3%,46m
37698,1,[LoShay]NachoCapony,2221,334,11,7,18,61.1%,2h
37698,3,ALPINE,2221,255,8,10,18,44.4%,28m
37698,3,Renknock,2221,122,6,11,17,35.3%,43m
37698,1,Mike,2221,149,4,4,8,50.0%,23m
37698,1,SilverHawk,2221,97,4,4,8,50.0%,50m
37698,1,TpRob,2221,120,3,4,7,42.9%,8m
37698,1,StickyGreens,2221,133,3,4,7,42.9%,2h
37698,1,[coI]ThEoKoLeS,2221,86,3,6,9,33.3%,23m
37698,1,Nadando,2221,190,3,7,10,30.0%,2h
37698,1,[CASUL]carlitos,2221,48,2,1,3,66.7%,43m
37698,1,Akhundelar,2221,90,1,1,2,50.0%,3h
37698,1,snt,2221,96,1,1,2,50.0%,2h
37698,1,[gnosis]GralDanielFV,2221,0,1,1,2,50.0%,2h
37698,1,SpaceSAS,2221,0,1,2,3,33.3%,2h
37698,1,[NLDSG]Jaredare,2221,0,1,5,6,16.7%,2h
37698,2,Dapper,2221,30,1,10,11,9.1%,3h
37698,1,PsionicMango,2221,0,0,1,1,0.0%,2h
37698,1,[Msia]Milo,2221,0,0,1,1,0.0%,2h
37698,1,gonzalo,2221,0,0,1,1,0.0%,29m
37698,3,Poseidon,2221,0,0,1,1,0.0%,2h
37731,1,Mephiston,2220,1074,146,156,302,48.3%,54m
37731,1,[IMDSI]DiegoShulla,2220,783,44,39,83,53.0%,2h
37731,1,GalacticRock,2220,746,38,40,78,48.7%,2h
37731,1,[L3g10n]Soulkane,2220,674,34,31,65,52.3%,2h
37731,1,Lotsoflime,2220,915,30,29,59,50.8%,28m
37731,1,pocoyo,2220,994,29,33,62,46.8%,2h
37731,1,GouryS,2220,714,26,35,61,42.6%,5m
37731,3,pleasedaspie,2220,415,17,29,46,37.0%,2h
37731,1,DagiPls,2220,230,15,11,26,57.7%,51m
37731,1,liquidcee,2220,284,10,15,25,40.0%,2h
37731,1,[HnTr]Osiris,2220,310,9,10,19,47.4%,2h
37731,3,TRANQUANPR,2220,148,9,14,23,39.1%,10m
37731,1,Tassadar,2220,198,6,6,12,50.0%,2h
37731,1,[SCArmy]wonderer,2220,205,6,8,14,42.9%,2h
37731,3,XenoStar,2220,203,6,11,17,35.3%,31m
37731,1,ZexX,2220,140,3,6,9,33.3%,9m
37731,2,[ConFed]GucciGuilty,2220,141,3,8,11,27.3%,44m
37731,1,Kira,2220,92,2,0,2,100.0%,42m
37731,1,vichomalo,2220,48,2,3,5,40.0%,2h
37731,1,SpeedCorona,2220,76,2,10,12,16.7%,2h
37731,1,[QuAzar]Aarbear,2220,0,1,1,2,50.0%,15m
37731,1,Kleemore,2220,0,1,2,3,33.3%,2h
37731,1,zerathull,2220,0,1,3,4,25.0%,9m
37731,1,Chief,2220,0,1,4,5,20.0%,2h
37731,1,IIIIIIIIIIII,2220,88,1,5,6,16.7%,2h
37731,1,Drizzo,2220,0,1,5,6,16.7%,36m
37731,1,JYPSY,2220,0,1,6,7,14.3%,5m
37731,1,KittenMan,2220,0,1,6,7,14.3%,2h
37731,1,EXTERACTOR,2220,0,0,1,1,0.0%,2h
37760,1,[DARPA]clockwork,2219,1750,64,67,131,48.9%,5m
37760,1,[EvilCC]Dragonaid,2219,1479,53,60,113,46.9%,2h
37760,1,ThatPZT,2219,781,35,23,58,60.3%,36m
37760,1,jerle,2219,758,27,20,47,57.4%,2h
37760,1,[FrOzE]Gori,2219,509,16,17,33,48.5%,21m
37760,1,CorndogCarl,2219,458,16,20,36,44.4%,16m
37760,1,[RiftSS]Arrowblade,2219,338,11,12,23,47.8%,41m
37760,1,Farnecio,2219,273,8,10,18,44.4%,41m
37760,3,Omegaspecter,2219,106,5,12,17,29.4%,2h
37760,1,BaaruK,2219,144,4,8,12,33.3%,2h
37760,1,[C0V]ThinkLogical,2219,84,3,6,9,33.3%,23m
37760,1,zham,2219,48,2,4,6,33.3%,2h
37760,1,Jester,2219,96,2,6,8,25.0%,51m
37760,1,Esteban,2219,92,1,2,3,33.3%,11m
37760,1,[NS1933]Fluffygiggle,2219,42,1,3,4,25.0%,2m
37760,1,Snakesford,2219,0,0,1,1,0.0%,2h
37760,1,NukieEular,2219,0,0,1,1,0.0%,2m
37760,3,Chrinich,2219,0,0,3,3,0.0%,2m
37778,1,krywaj,2218,1770,155,159,314,49.4%,31m
37778,1,Franknorm,2218,1639,147,154,301,48.8%,2h
37778,3,ChinChim,2218,1551,113,102,215,52.6%,45m
37778,1,mermer,2218,1414,47,50,97,48.5%,11m
37778,1,Leupenas,2218,1079,43,35,78,55.1%,36m
37778,1,redd,2218,942,36,27,63,57.1%,3h
37778,1,Specter,2218,645,30,22,52,57.7%,2h
37778,3,[CobraE]Kenpachi,2218,275,20,29,49,40.8%,6m
37778,1,jeanralphio,2218,642,19,21,40,47.5%,54m
37778,1,RiNowIWINmix,2218,398,11,15,26,42.3%,2h
37778,1,FarkQue,2218,200,7,0,7,100.0%,5m
37778,1,[IoO7]geauxjoel,2218,251,6,6,12,50.0%,2h
37778,1,Matt,2218,128,6,7,13,46.2%,2h
37778,1,LCR,2218,119,4,1,5,80.0%,7m
37778,1,Daellex,2218,88,4,3,7,57.1%,2h
37778,3,Guido,2218,170,4,3,7,57.1%,2h
37778,3,Shhhhh,2218,58,4,7,11,36.4%,53m
37778,1,AiaraTech,2218,130,2,3,5,40.0%,34m
37778,3,biggavelli,2218,0,2,6,8,25.0%,2h
37778,1,donkey,2218,90,1,1,2,50.0%,2h
37778,1,IIIIIIIIII,2218,0,0,1,1,0.0%,2h
37799,1,[KhanZ]Twist,2217,1668,88,83,171,51.5%,5m
37799,1,URIEL,2217,1462,51,50,101,50.5%,2h
37799,1,[NUTZZZ]PewPewBngBng,2217,1027,39,47,86,45.3%,5m
37799,1,moonboots,2217,503,26,20,46,56.5%,2h
37799,3,danielkqw,2217,782,26,40,66,39.4%,36m
37799,1,[oziozi]COLL,2217,854,25,28,53,47.2%,2h
37799,1,midnitesnack,2217,553,21,17,38,55.3%,3h
37799,1,TerryDane,2217,570,21,20,41,51.2%,7m
37799,3,[LSTR4]VoidPurger,2217,236,9,8,17,52.9%,2h
37799,2,General,2217,286,9,15,24,37.5%,23m
37799,1,DingusKhan,2217,130,7,6,13,53.8%,2h
37799,3,[KGH3]GHOST,2217,118,6,5,11,54.5%,14m
37799,1,[Atira]Nutrino,2217,254,6,13,19,31.6%,2h
37799,1,[dengue]cthulhu,2217,156,5,1,6,83.3%,2h
37799,1,Skarabrae,2217,196,5,7,12,41.7%,2h
37799,1,Rodent,2217,121,4,6,10,40.0%,3h
37799,3,AEROWYVERN,2217,153,4,9,13,30.8%,6m
37799,3,[1Ec0n1]gunner,2217,32,2,0,2,100.0%,24m
37799,1,Trogdor,2217,126,2,6,8,25.0%,2h
37799,1,ThetaZero,2217,0,1,0,1,100.0%,28m
37799,1,FIVEANGELS,2217,0,1,2,3,33.3%,2h
37799,1,SilentDJ,2217,0,1,5,6,16.7%,2h
37799,1,Jose,2217,0,0,2,2,0.0%,45m
37822,1,Proam,2216,908,36,28,64,56.2%,2h
37822,1,JamesJonnes,2216,538,24,17,41,58.5%,2h
37822,1,Segatex,2216,368,16,10,26,61.5%,31m
37822,3,DangerousDan,2216,460,16,25,41,39.0%,53m
37822,1,[LosK]Masenjom,2216,329,14,7,21,66.7%,2h
37822,1,[αB]EchoSoldier,2216,298,13,12,25,52.0%,51m
37822,1,replica,2216,252,11,10,21,52.4%,2h
37822,1,CarnZarooks,2216,185,6,4,10,60.0%,8m
37822,1,Gekkostate,2216,203,6,10,16,37.5%,2h
37822,1,Veda,2216,140,5,4,9,55.6%,2h
37822,3,Hooty,2216,160,5,11,16,31.2%,37m
37822,3,[Skhrta]Velmo,2216,85,4,4,8,50.0%,34m
37822,1,kmaradarti,2216,156,4,6,10,40.0%,2h
37822,1,SilentFactor,2216,170,4,11,15,26.7%,2h
37822,3,[Forskn]DireRaven,2216,120,4,11,15,26.7%,33m
37822,1,SeanFox,2216,95,2,4,6,33.3%,25m
37822,1,MPanchez,2216,80,2,4,6,33.3%,11m
37822,1,[zLTz]LuisConte,2216,40,2,6,8,25.0%,2h
37822,1,Hoplite,2216,0,1,0,1,100.0%,42m
37822,1,ness,2216,93,1,2,3,33.3%,2h
37822,1,Blackyoid,2216,48,1,2,3,33.3%,2h
37822,1,Tacocrease,2216,0,1,4,5,20.0%,41m
37822,2,ManziKushBud,2216,0,0,1,1,0.0%,2h
37822,1,[PbFtCb]Kertic,2216,0,0,2,2,0.0%,2h
37822,1,SnowFluff,2216,0,0,5,5,0.0%,2h
37847,3,GhostDragon,2215,1572,546,546,1092,50.0%,2h
37847,1,IceMachine,2215,743,52,52,104,50.0%,3m
37847,1,Manus,2215,565,34,35,69,49.3%,18m
37847,1,[MezBlg]Fedayi,2215,663,24,28,52,46.2%,42m
37847,1,adnsaitama,2215,727,23,24,47,48.9%,2h
37847,1,Garol,2215,453,19,13,32,59.4%,2h
37847,1,[GRNSKN]SupplyZone,2215,575,18,24,42,42.9%,2h
37847,1,[FoxBR]Charlinnn,2215,377,13,12,25,52.0%,2h
37847,1,octaviotin,2215,462,13,15,28,46.4%,2h
37847,1,Castlevania,2215,294,11,15,26,42.3%,4m
37847,1,eggsaisle,2215,339,9,15,24,37.5%,51m
37847,3,[TLPD]World,2215,122,6,11,17,35.3%,38m
37847,2,AlexanderNoe,2215,143,4,2,6,66.7%,31m
37847,1,[ChiFan]dahx,2215,120,4,6,10,40.0%,26m
37847,1,iPotatoes,2215,89,2,4,6,33.3%,54m
37847,1,[ROA1]CJOEL,2215,0,1,1,2,50.0%,2h
37847,1,VEVESH,2215,40,1,3,4,25.0%,41m
37847,1,REIDESOMBRAS,2215,44,1,4,5,20.0%,2h
37847,1,[TOTALD]squid,2215,0,1,6,7,14.3%,35m
37847,1,[NM4E]REPLICATOR,2215,0,0,1,1,0.0%,43m
37847,2,AFO,2215,0,0,1,1,0.0%,40m
37847,3,Sanchis,2215,0,0,1,1,0.0%,2h
37847,1,Xeperio,2215,0,0,3,3,0.0%,3h
37870,1,BarnabyJones,2214,988,94,90,184,51.1%,18m
37870,1,genuinekilla,2214,1352,71,55,126,56.3%,2h
37870,1,Tillion,2214,1517,65,73,138,47.1%,2h
37870,1,Microjaxon,2214,1347,47,53,100,47.0%,2h
37870,1,[CHASQ]Attatrix,2214,699,25,29,54,46.3%,2h
37870,1,Noodaws,2214,518,17,15,32,53.1%,15m
37870,1,Drorlo,2214,250,10,19,29,34.5%,2h
37870,1,starliberty,2214,167,6,2,8,75.0%,2h
37870,3,SappyPine,2214,196,6,11,17,35.3%,2h
37870,1,BooMSelectA,2214,172,6,12,18,33.3%,2h
37870,1,noblesix,2214,172,4,13,17,23.5%,2h
37870,1,starlord,2214,102,3,6,9,33.3%,52m
37870,1,PooFDula,2214,48,3,7,10,30.0%,2h
37870,1,blksheepwall,2214,0,2,4,6,33.3%,3h
37870,2,[BGDK]DeepDooDoo,2214,46,2,5,7,28.6%,4m
37870,3,ThorTirol,2214,0,2,8,10,20.0%,2h
37870,1,Grundlebeard,2214,0,1,5,6,16.7%,3h
37870,3,AlbertoSauri,2214,96,1,10,11,9.1%,2h
37870,1,ACEofHARTS,2214,0,0,4,4,0.0%,2h
37889,3,[E8]Kelvinator,2213,1572,378,376,754,50.1%,2h
37889,1,[SHVDOW]Slowrage,2213,1130,45,48,93,48.4%,2h
37889,1,[urdone]InSaNiTy,2213,357,13,9,22,59.1%,2h
37889,2,Koto,2213,268,10,16,26,38.5%,22m
37889,2,MoBluntz,2213,184,6,4,10,60.0%,2h
37889,1,TheHobGobler,2213,156,4,6,10,40.0%,2h
37889,2,cheeseyfart,2213,150,3,4,7,42.9%,2h
37889,2,triple,2213,143,2,4,6,33.3%,2h
37889,2,[PacheK]Malegolante,2213,0,1,0,1,100.0%,36m
37889,1,twitch,2213,0,1,1,2,50.0%,18m
37889,3,jerrycard,2213,96,1,7,8,12.5%,2h
37889,2,[RomX]destroyer,2213,0,0,1,1,0.0%,2h
37889,1,MrImPerfect,2213,0,0,1,1,0.0%,51m
37902,1,Indigo,2212,1745,194,189,383,50.7%,2h
37902,1,griffin,2212,1564,61,59,120,50.8%,2h
37902,3,Alan,2212,646,21,32,53,39.6%,37m
37902,2,[CyS]BroBro,2212,580,20,30,50,40.0%,2h
37902,1,SIRSHANE,2212,518,16,20,36,44.4%,18m
37902,2,Jake,2212,182,6,1,7,85.7%,2h
37902,1,[DOTN]Humphris,2212,203,6,10,16,37.5%,5m
37902,1,[2K20]SDrago,2212,166,4,3,7,57.1%,2h
37902,2,barrx,2212,122,4,4,8,50.0%,2h
37902,2,DISTROYER,2212,156,4,5,9,44.4%,49m
37902,1,StarLord,2212,145,4,6,10,40.0%,24m
37902,3,Kikazo,2212,0,4,6,10,40.0%,2h
37902,1,[xEx]Haust,2212,0,3,3,6,50.0%,2h
37902,2,Tayryu,2212,0,3,3,6,50.0%,49m
37902,1,JordanSF,2212,40,2,2,4,50.0%,2h
37902,1,jungkook,2212,125,2,3,5,40.0%,54m
37902,2,paschaldig,2212,44,2,5,7,28.6%,2h
37902,1,Ogoine,2212,0,1,6,7,14.3%,24m
37902,2,Has,2212,0,0,1,1,0.0%,2h
37902,2,ooOLegionOoo,2212,0,0,1,1,0.0%,2h
37902,2,RayLiotta,2212,0,0,5,5,0.0%,44m
37902,2,[EffM]Azurite,2212,0,0,5,5,0.0%,34m
37924,1,RhinoKYS,2211,964,54,57,111,48.6%,2h
37924,1,BlackfanG,2211,1312,52,41,93,55.9%,2h
37924,1,[6661]ELFURROTAKU,2211,1064,33,36,69,47.8%,2h
37924,3,[lttdh]punteriacero,2211,867,33,39,72,45.8%,3h
37924,1,GeorgeWKush,2211,285,11,6,17,64.7%,2h
37924,2,ARGET,2211,280,10,13,23,43.5%,3h
37924,1,LightofAiur,2211,386,10,15,25,40.0%,39m
37924,3,jera,2211,232,9,11,20,45.0%,32m
37924,1,[MuSaFi]sayoonara,2211,350,9,14,23,39.1%,11m
37924,2,PureSlab,2211,218,8,5,13,61.5%,2h
37924,3,Kylar,2211,184,6,10,16,37.5%,37m
37924,3,ZergWorm,2211,161,5,10,15,33.3%,2h
37924,1,Duronimo,2211,164,4,8,12,33.3%,2h
37924,1,Raz,2211,118,3,2,5,60.0%,2h
37924,1,Phoenix,2211,0,3,3,6,50.0%,28m
37924,1,[ffaaak]candyskull,2211,126,3,7,10,30.0%,2h
37924,1,[Flam3s]TheShadowzXx,2211,92,2,3,5,40.0%,24m
37924,2,Eagle,2211,30,1,2,3,33.3%,2h
37924,2,ZeroMarine,2211,0,0,1,1,0.0%,30m
37924,2,penboy,2211,0,0,1,1,0.0%,2h
37924,3,[QcJmS]RoCkeT,2211,0,0,2,2,0.0%,2h
37924,3,ElSovino,2211,0,0,5,5,0.0%,2h
37946,3,achou,2210,844,157,161,318,49.4%,2h
37946,1,ZizouSan,2210,1509,112,130,242,46.3%,46m
37946,2,[micro]SUNG,2210,738,41,1,42,97.6%,4m
37946,3,[Pr1m0r]byparra,2210,944,38,40,78,48.7%,2h
37946,2,Phugsy,2210,906,36,45,81,44.4%,2h
37946,1,nick,2210,720,25,28,53,47.2%,36m
37946,1,FearDaHoodie,2210,716,23,27,50,46.0%,28m
37946,1,Rick,2210,458,13,10,23,56.5%,2h
37946,1,JanjoMan,2210,448,12,15,27,44.4%,2h
37946,1,BootyBreath,2210,269,8,6,14,57.1%,41m
37946,3,Echo,2210,176,7,12,19,36.8%,21m
37946,1,anthony,2210,158,4,5,9,44.4%,5m
37946,1,[MZHSTG]Mastas,2210,80,2,2,4,50.0%,2h
37946,1,EnrageJoze,2210,44,2,6,8,25.0%,37m
37946,1,TheZeldaNow,2210,0,1,2,3,33.3%,43m
37946,1,SanKeR,2210,44,1,4,5,20.0%,36m
37946,1,[001APM]Midgardawn,2210,0,1,6,7,14.3%,2h
37946,2,[xDiKx]Hijinks,2210,0,0,1,1,0.0%,2h
37946,2,Karwow,2210,0,0,1,1,0.0%,12m
37946,2,Mrbehe,2210,0,0,1,1,0.0%,2h
37966,3,Zach,2209,1554,137,134,271,50.6%,2h
37966,1,Aletra,2209,906,33,32,65,50.8%,2h
37966,1,Osam,2209,684,27,26,53,50.9%,25m
37966,2,AmE,2209,567,24,9,33,72.7%,2h
37966,1,[Lp]Torx,2209,316,23,19,42,54.8%,2h
37966,1,Melphite,2209,623,19,23,42,45.2%,12m
37966,1,DegenWeasel,2209,411,18,12,30,60.0%,11m
37966,2,Habermas,2209,476,16,18,34,47.1%,2h
37966,1,Monkey,2209,531,14,15,29,48.3%,42m
37966,2,Twin,2209,280,11,5,16,68.8%,5m
37966,1,DBae,2209,379,11,11,22,50.0%,26m
37966,2,HuySunVin,2209,272,10,13,23,43.5%,37m
37966,3,HurtConveyor,2209,229,9,10,19,47.4%,29m
37966,3,gynecologist,2209,266,8,11,19,42.1%,41m
37966,1,raiz,2209,204,7,14,21,33.3%,43m
37966,2,[ESP0RT]Maru,2209,167,4,3,7,57.1%,2h
37966,2,John,2209,145,4,9,13,30.8%,36m
37966,2,Siegfredão,2209,30,2,1,3,66.7%,5m
37966,2,LtNTheKid,2209,0,2,3,5,40.0%,30m
37966,1,Joel,2209,40,2,6,8,25.0%,2h
37966,1,Tremblayz,2209,102,2,6,8,25.0%,46m
37966,1,[8868]wboy,2209,0,1,1,2,50.0%,15m
37966,2,cheekywanker,2209,97,1,2,3,33.3%,23m
37966,3,flatboy,2209,30,1,3,4,25.0%,30m
37966,1,WOLLKATZE,2209,0,1,6,7,14.3%,41m
37966,1,Bruno,2209,93,1,6,7,14.3%,4m
37966,1,Rumplstlskin,2209,0,0,1,1,0.0%,50m
37966,1,Trey,2209,0,0,1,1,0.0%,9m
37966,1,Sen,2209,0,0,2,2,0.0%,2h
37966,1,OwLL,2209,0,0,3,3,0.0%,46m
37966,1,[MyGs]BISMARCK,2209,0,0,3,3,0.0%,2h
37966,2,ZeroAPM,2209,0,0,5,5,0.0%,2h
37998,1,laopitaev,2208,1428,78,75,153,51.0%,16m
37998,1,MatoCinza,2208,1124,75,71,146,51.4%,31m
37998,1,EddieBravo,2208,699,62,66,128,48.4%,2h
37998,3,BeneTleilax,2208,1562,60,60,120,50.0%,2h
37998,3,[JSTCE]Nismo,2208,71,37,40,77,48.1%,27m
37998,3,[Core]dominator,2208,919,33,39,72,45.8%,17m
37998,1,SirPoopins,2208,525,17,20,37,45.9%,2m
37998,3,[GRU]sinbad,2208,204,6,15,21,28.6%,21m
37998,1,Purpura,2208,166,5,6,11,45.5%,2h
37998,1,Baddubeau,2208,122,4,10,14,28.6%,2h
37998,2,CesarDTmay,2208,164,3,3,6,50.0%,2h
37998,3,[BOESCA]SonusEco,2208,159,3,4,7,42.9%,34m
37998,2,PEPINWARS,2208,75,3,11,14,21.4%,2h
37998,2,[BUKÉ]Korax,2208,97,2,0,2,100.0%,2h
37998,1,Zeloss,2208,78,2,6,8,25.0%,2h
37998,1,Mambolisk,2208,127,2,7,9,22.2%,2h
37998,1,Mothership,2208,0,1,1,2,50.0%,23m
37998,2,SupaFly,2208,30,1,2,3,33.3%,2h
37998,2,SpadeWilson,2208,0,1,4,5,20.0%,34m
37998,2,ASSAZIN,2208,0,0,1,1,0.0%,2h
37998,2,SmilePuppy,2208,0,0,2,2,0.0%,26m
38019,2,[Wat3rs]Assassino,2207,1404,202,213,415,48.7%,2h
38019,1,HunterXD,2207,1334,96,94,190,50.5%,2h
38019,3,akusstar,2207,1482,52,64,116,44.8%,7m
38019,1,Duurztz,2207,1092,46,54,100,46.0%,2h
38019,1,SuppliedWing,2207,894,37,30,67,55.2%,2h
38019,1,Aries,2207,816,25,34,59,42.4%,2h
38019,1,TehMidge,2207,318,13,12,25,52.0%,11m
38019,1,PalabokPapi,2207,312,11,18,29,37.9%,11m
38019,2,Sheks,2207,182,6,9,15,40.0%,45m
38019,1,Salsero,2207,190,5,8,13,38.5%,2h
38019,2,Oyardo,2207,172,5,9,14,35.7%,2h
38019,1,khaos,2207,144,4,8,12,33.3%,47m
38019,3,skatterbrain,2207,166,4,10,14,28.6%,2h
38019,3,Shadowbite,2207,0,3,7,10,30.0%,2h
38019,3,Rabbit,2207,86,3,15,18,16.7%,2h
38019,1,[DhZAc1]NTnikc,2207,66,2,3,5,40.0%,22m
38019,1,KingBob,2207,40,2,3,5,40.0%,16m
38019,2,freebuttouch,2207,0,2,3,5,40.0%,2h
38019,3,bob,2207,137,2,4,6,33.3%,39m
38019,1,Deadboiz,2207,82,2,4,6,33.3%,16m
38019,1,Jormugandr,2207,121,2,6,8,25.0%,2h
38019,2,HUAYRAGE,2207,0,1,0,1,100.0%,5m
38019,1,mike,2207,0,1,2,3,33.3%,2h
38019,1,Aeon,2207,38,1,3,4,25.0%,43m
38019,1,Xarth,2207,42,1,3,4,25.0%,52m
38019,1,Mose,2207,40,1,4,5,20.0%,2h
38019,1,vision,2207,0,0,4,4,0.0%,2h
38019,2,Steiger,2207,0,0,5,5,0.0%,32m
38047,1,TIGERDAVID,2206,1522,180,182,362,49.7%,2h
38047,1,malmhaus,2206,1789,164,161,325,50.5%,3m
38047,2,[LITD]BGseikatsu,2206,401,23,35,58,39.7%,2h
38047,1,candycekae,2206,455,17,14,31,54.8%,2h
38047,3,NeoMHM,2206,422,16,24,40,40.0%,32m
38047,2,Fiiishy,2206,215,11,10,21,52.4%,2m
38047,1,JeremiahCox,2206,414,11,14,25,44.0%,24m
38047,1,[char14]dark,2206,287,10,7,17,58.8%,39m
38047,2,glucster,2206,170,5,3,8,62.5%,2h
38047,1,KozukiOden,2206,168,5,6,11,45.5%,2h
38047,1,RaDaMaNtZ,2206,196,5,8,13,38.5%,45m
38047,1,NONA,2206,124,4,4,8,50.0%,2h
38047,2,MaybeElite,2206,0,2,3,5,40.0%,31m
38047,2,[GRetro]SnakeDaddy,2206,48,2,5,7,28.6%,2h
38047,2,razrivploti,2206,64,2,6,8,25.0%,2h
38047,3,[DhZAc1]stop,2206,0,2,7,9,22.2%,27m
38047,1,[LoFAc]TesseracT,2206,0,1,0,1,100.0%,2h
38047,1,[xOsx]dat,2206,0,1,0,1,100.0%,2h
38047,1,Navok,2206,0,1,1,2,50.0%,32m
38047,2,Voltaire,2206,0,1,3,4,25.0%,2h
38047,1,oXEJECUTORXo,2206,38,1,4,5,20.0%,3m
38047,2,Drugs,2206,0,0,1,1,0.0%,2h
38047,1,Mennesker,2206,0,0,6,6,0.0%,41m
38070,1,AGN,2205,1793,200,207,407,49.1%,2h
38070,1,cptmorgan,2205,885,42,33,75,56.0%,2h
38070,3,[XPPX]Arboarrutis,2205,1062,37,44,81,45.7%,33m
38070,1,TRboAssSlayR,2205,408,29,25,54,53.7%,2h
38070,1,Azzet,2205,623,24,16,40,60.0%,39m
38070,1,Matador,2205,751,24,24,48,50.0%,25m
38070,1,GameChanger,2205,360,13,22,35,37.1%,2h
38070,3,Cornbread,2205,398,13,24,37,35.1%,2h
38070,2,chunchumaru,2205,349,11,7,18,61.1%,38m
38070,2,ERR,2205,292,10,6,16,62.5%,47m
38070,1,destroyer,2205,220,7,7,14,50.0%,24m
38070,3,CASHFLOW,2205,89,5,10,15,33.3%,3h
38070,1,Harrowme,2205,141,4,7,11,36.4%,25m
38070,1,[UniVV]Pattio,2205,36,2,6,8,25.0%,2h
38070,1,[CITIOS]Jinmy,2205,84,2,6,8,25.0%,2h
38070,2,[LgnTDS]shadowhunter,2205,0,1,0,1,100.0%,2h
38070,1,[WebOS]Tlacoyito,2205,32,1,4,5,20.0%,54m
38070,2,Felipe,2205,0,1,4,5,20.0%,2h
38070,2,[Lulza]MCOP,2205,46,1,5,6,16.7%,4m
38070,1,gruilla,2205,0,1,6,7,14.3%,3h
38070,1,Slashwater,2205,112,1,7,8,12.5%,2h
38070,2,BattleTurtle,2205,0,0,1,1,0.0%,2h
38070,1,Wegality,2205,0,0,3,3,0.0%,2h
38093,1,[XpKAc]zasorin,2204,687,37,36,73,50.7%,2h
38093,1,OchoGhost,2204,660,29,21,50,58.0%,2h
38093,1,ItchyBalls,2204,659,28,22,50,56.0%,39m
38093,1,yukigira,2204,599,26,17,43,60.5%,46m
38093,1,[ALQ]Darkkiller,2204,551,19,28,47,40.4%,13m
38093,2,Allagash,2204,250,7,5,12,58.3%,2h
38093,1,anhkdoiqua,2204,217,7,5,12,58.3%,2h
38093,3,DarkDeath,2204,196,7,20,27,25.9%,36m
38093,2,Krboncito,2204,167,6,11,17,35.3%,2h
38093,2,Jeanbaptiste,2204,134,6,12,18,33.3%,2h
38093,2,[SloBum]jtwojbeast,2204,132,4,1,5,80.0%,2h
38093,1,jonthegreat,2204,170,4,3,7,57.1%,43m
38093,3,Dubji,2204,122,4,10,14,28.6%,43m
38093,2,DeanDuke,2204,126,3,1,4,75.0%,22m
38093,1,RebelDragon,2204,124,3,6,9,33.3%,3h
38093,1,javierkrg,2204,96,3,9,12,25.0%,2h
38093,3,Gnell,2204,0,2,8,10,20.0%,2h
38093,2,Kalus,2204,30,1,2,3,33.3%,2h
38093,2,Fabas,2204,88,1,3,4,25.0%,2h
38093,1,Calamity,2204,0,1,5,6,16.7%,2h
38093,2,Pdeex,2204,30,1,5,6,16.7%,37m
38093,1,DOOOM,2204,0,1,6,7,14.3%,2h
38093,2,gunndowning,2204,0,0,1,1,0.0%,2h
38093,1,Alvin,2204,0,0,3,3,0.0%,2h
38093,1,sakatoma,2204,0,0,5,5,0.0%,2h
38118,2,MightyGandhi,2203,1640,153,152,305,50.2%,47m
38118,1,kublikhan,2203,1795,107,112,219,48.9%,2h
38118,2,JediPimp,2203,1662,67,57,124,54.0%,2h
38118,1,CerealKiller,2203,1408,48,47,95,50.5%,2h
38118,1,Eclipse,2203,1195,39,40,79,49.4%,16m
38118,3,Contrai,2203,539,38,44,82,46.3%,17m
38118,1,Tuena,2203,650,22,21,43,51.2%,11m
38118,1,[clow]AndresJPZ,2203,426,14,17,31,45.2%,2h
38118,1,swole,2203,473,13,11,24,54.2%,41m
38118,1,ISTRXR,2203,388,12,11,23,52.2%,2h
38118,1,Lucho,2203,376,11,16,27,40.7%,2h
38118,3,shepeard,2203,225,9,8,17,52.9%,29m
38118,3,Draknar,2203,264,8,12,20,40.0%,41m
38118,1,Vanillian,2203,193,6,4,10,60.0%,36m
38118,2,KillSwitch,2203,92,5,14,19,26.3%,2h
38118,2,Chelo,2203,94,4,1,5,80.0%,3h
38118,2,ZERO,2203,78,2,2,4,50.0%,2m
38118,1,CHEESE,2203,40,2,6,8,25.0%,3h
38118,1,Angel,2203,0,1,2,3,33.3%,2h
38118,1,NERO,2203,48,1,3,4,25.0%,35m
38118,2,Demon,2203,0,1,4,5,20.0%,14m
38118,1,RobotJr,2203,0,1,4,5,20.0%,51m
38118,1,Booker,2203,0,1,5,6,16.7%,10m
38118,2,DarkSky,2203,0,0,1,1,0.0%,54m
38118,2,thoch,2203,0,0,1,1,0.0%,2h
38118,1,[PobSC]Setyury,2203,0,0,2,2,0.0%,2h
38144,2,GetDezBallz,2202,1097,76,90,166,45.8%,37m
38144,3,Antinomy,2202,952,56,105,161,34.8%,22m
38144,1,belikser,2202,934,31,30,61,50.8%,12m
38144,1,Octave,2202,674,21,20,41,51.2%,2h
38144,1,[wNx]swayze,2202,462,20,12,32,62.5%,2h
38144,1,EndlessMike,2202,445,18,16,34,52.9%,2h
38144,3,[LOHe]Adam,2202,546,18,32,50,36.0%,37m
38144,1,[GUARA1]InSaNiTyZz,2202,320,15,8,23,65.2%,34m
38144,1,TheBigCheese,2202,410,14,11,25,56.0%,12m
38144,1,arcturus,2202,356,13,11,24,54.2%,13m
38144,1,[HTP450]ErenJaeger,2202,290,9,6,15,60.0%,2h
38144,1,IalsoplaySTC,2202,224,5,5,10,50.0%,2h
38144,1,penguin,2202,162,4,4,8,50.0%,2h
38144,1,Guiduzanjus,2202,146,4,5,9,44.4%,2h
38144,1,Kerlif,2202,74,3,7,10,30.0%,2m
38144,1,Wyvrn,2202,86,2,5,7,28.6%,11m
38144,1,HughJass,2202,0,1,2,3,33.3%,2h
38144,2,ahotlol,2202,30,1,5,6,16.7%,40m
38144,1,TheWaphel,2202,42,1,5,6,16.7%,3m
38163,1,MOrtaLbUrN,2201,1792,111,113,224,49.6%,2h
38163,1,paranoid,2201,1400,51,53,104,49.0%,54m
38163,1,White,2201,949,30,43,73,41.1%,2h
38163,3,[iMkS]Andrei,2201,598,29,33,62,46.8%,46m
38163,1,jeffthekille,2201,611,26,21,47,55.3%,2h
38163,1,McGarnagle,2201,650,19,22,41,46.3%,39m
38163,1,brutal,2201,434,16,21,37,43.2%,29m
38163,1,Rhino,2201,522,14,24,38,36.8%,3h
38163,2,Meletil,2201,326,11,14,25,44.0%,2h
38163,3,Weezer,2201,310,10,7,17,58.8%,2h
38163,2,Mzungu,2201,315,10,16,26,38.5%,2h
38163,1,Aserterius,2201,286,9,14,23,39.1%,24m
38163,2,Kindamoist,2201,202,8,3,11,72.7%,40m
38163,2,juceito,2201,164,8,13,21,38.1%,13m
38163,3,MacZyy,2201,219,6,11,17,35.3%,41m
38163,1,ivan,2201,208,6,13,19,31.6%,27m
38163,2,FancyPants,2201,109,4,4,8,50.0%,37m
38163,1,Zealot,2201,186,4,4,8,50.0%,2h
38163,1,Roborovski,2201,40,2,2,4,50.0%,16m
38163,1,Exador,2201,0,1,6,7,14.3%,9m
38163,1,thenoob,2201,0,0,2,2,0.0%,15m
38184,1,elElegido,2200,1729,67,63,130,51.5%,12m
38184,1,Maverick,2200,1467,50,55,105,47.6%,2h
38184,1,Tempra,2200,797,24,29,53,45.3%,2h
38184,1,MasterGallo,2200,579,22,20,42,52.4%,9m
38184,2,ElysiumChase,2200,360,14,15,29,48.3%,3h
38184,2,Ashley,2200,326,10,13,23,43.5%,2h
38184,2,Skapari,2200,302,8,13,21,38.1%,49m
38184,1,Mai,2200,120,6,12,18,33.3%,19m
38184,1,Andrew,2200,172,5,6,11,45.5%,5m
38184,1,Centurion,2200,213,5,8,13,38.5%,3h
38184,3,Middieno,2200,83,5,8,13,38.5%,6m
38184,1,Sole,2200,120,4,4,8,50.0%,42m
38184,2,DixieNourmos,2200,175,4,11,15,26.7%,2h
38184,2,Rise,2200,86,3,1,4,75.0%,2h
38184,1,BowlosLegion,2200,0,3,5,8,37.5%,2h
38184,1,Duke,2200,0,3,5,8,37.5%,2h
38184,1,Tonicho,2200,96,3,8,11,27.3%,3h
38184,3,techuosuelo,2200,30,2,5,7,28.6%,2h
38184,1,soca,2200,0,2,5,7,28.6%,2h
38184,2,ddggggqb,2200,96,1,5,6,16.7%,13m
38184,1,Wantan,2200,0,1,6,7,14.3%,2h
38184,2,[b8]Zerick,2200,0,0,1,1,0.0%,23m
38184,2,JoHaN,2200,0,0,1,1,0.0%,2h
38184,1,ailime,2200,0,0,2,2,0.0%,2h
38208,1,Daydreamer,2199,1811,79,83,162,48.8%,2h
38208,1,Bolillo,2199,1350,73,73,146,50.0%,25m
38208,1,[SKyber]Arcanjo,2199,354,30,20,50,60.0%,2h
38208,1,ThinkBlue,2199,727,22,22,44,50.0%,2h
38208,2,daddypalps,2199,355,12,8,20,60.0%,2h
38208,1,Deku,2199,217,10,6,16,62.5%,32m
38208,1,Shimshon,2199,240,6,7,13,46.2%,41m
38208,3,leeler,2199,145,6,8,14,42.9%,2h
38208,1,Snorkel,2199,96,5,6,11,45.5%,2h
38208,1,[TRASHx]Detritus,2199,241,5,9,14,35.7%,50m
38208,2,BigPrez,2199,64,3,4,7,42.9%,2h
38208,1,AndrikPTMX,2199,0,2,6,8,25.0%,17m
38208,1,DelitoNoct,2199,44,2,7,9,22.2%,53m
38208,1,TouchPadPrO,2199,0,1,1,2,50.0%,2h
38208,1,Arnaldo,2199,0,1,2,3,33.3%,36m
38208,1,joaquin,2199,95,1,3,4,25.0%,5m
38208,3,GOHAN,2199,32,1,7,8,12.5%,34m
38208,2,Taikuda,2199,0,0,1,1,0.0%,2h
38208,2,ajusshi,2199,0,0,1,1,0.0%,2h
38208,1,Frelly,2199,0,0,2,2,0.0%,54m
38208,2,[Vtta]MadaraUchiha,2199,0,0,2,2,0.0%,3h
38229,1,Rapscallian,2198,1721,218,215,433,50.3%,12m
38229,3,[FFAA]NiceHand,2198,1501,61,68,129,47.3%,2h
38229,1,Trillog,2198,1545,57,57,114,50.0%,2h
38229,2,freddbliz,2198,1438,56,50,106,52.8%,47m
38229,1,Zekul,2198,1062,54,44,98,55.1%,2h
38229,2,rhomos,2198,1196,45,43,88,51.1%,2h
38229,1,ApmTen,2198,800,31,25,56,55.4%,2h
38229,1,Steelhead,2198,828,28,36,64,43.8%,42m
38229,1,Oodles,2198,652,20,25,45,44.4%,2h
38229,3,Zalbaag,2198,395,14,21,35,40.0%,31m
38229,2,Derek,2198,394,13,9,22,59.1%,3h
38229,1,Meat,2198,282,10,11,21,47.6%,2h
38229,3,yaydog,2198,292,9,15,24,37.5%,31m
38229,1,luisuchija,2198,258,8,12,20,40.0%,3h
38229,1,DRAGONMASTER,2198,231,6,4,10,60.0%,2h
38229,1,Angzt,2198,146,5,9,14,35.7%,18m
38229,3,Mjeh,2198,173,5,11,16,31.2%,2h
38229,1,Judged,2198,162,4,6,10,40.0%,3h
38229,1,Marcuskmp,2198,160,4,7,11,36.4%,16m
38229,2,inSoQ,2198,132,4,10,14,28.6%,2h
38229,2,Grant,2198,36,3,4,7,42.9%,2h
38229,1,wrothbow,2198,104,3,11,14,21.4%,13m
38229,2,CalvinH,2198,53,2,1,3,66.7%,2h
38229,2,BLONDJUSTICE,2198,68,2,2,4,50.0%,5m
38229,2,[DARPA]ghsotvinny,2198,0,2,3,5,40.0%,20m
38229,1,[AHPUCH]lion,2198,48,2,3,5,40.0%,2h
38229,1,llllll,2198,0,1,1,2,50.0%,2h
38229,1,sheaoh,2198,0,1,4,5,20.0%,2h
38229,2,bloodinhere,2198,0,0,1,1,0.0%,49m
38229,2,CraftDinner,2198,0,0,1,1,0.0%,2h
38229,2,[HNPro]Ghostman,2198,0,0,2,2,0.0%,2h
38260,3,gbdeparis,2197,1570,130,130,260,50.0%,2h
38260,1,CIA,2197,1470,62,51,113,54.9%,3h
38260,3,LilYeyo,2197,539,20,25,45,44.4%,49m
38260,3,BaSyl,2197,377,17,16,33,51.5%,2h
38260,2,[EiPvP]Catterill,2197,277,10,15,25,40.0%,2h
38260,1,[FEEDS]Erick,2197,276,8,12,20,40.0%,3h
38260,1,Bumcrust,2197,218,6,13,19,31.6%,29m
38260,1,apolo,2197,100,4,5,9,44.4%,45m
38260,2,vidaloka,2197,88,4,5,9,44.4%,20m
38260,1,LinusFaltz,2197,145,3,7,10,30.0%,28m
38260,3,Spaceman,2197,0,1,0,1,100.0%,46m
38260,1,Perzh,2197,42,1,4,5,20.0%,2h
38260,2,Cratos,2197,46,1,4,5,20.0%,49m
38260,1,[Klz]Panxo,2197,0,1,5,6,16.7%,16m
38260,1,Rosencrantz,2197,0,1,5,6,16.7%,35m
38260,2,UOENO,2197,0,0,1,1,0.0%,47m
38260,2,Crow,2197,0,0,1,1,0.0%,2h
38260,2,JPeG,2197,0,0,1,1,0.0%,48m
38278,1,AlphaAcid,2196,1159,89,92,181,49.2%,46m
38278,1,[zerpro]keospinal,2196,848,25,33,58,43.1%,2h
38278,1,andyyia,2196,502,17,20,37,45.9%,54m
38278,3,Rabies,2196,442,16,24,40,40.0%,3h
38278,3,ProbeKing,2196,462,16,25,41,39.0%,38m
38278,3,PabloNz,2196,249,9,9,18,50.0%,2h
38278,3,Ryankickass,2196,258,9,19,28,32.1%,43m
38278,2,[SOAF]ZobelPrize,2196,176,6,11,17,35.3%,17m
38278,2,[INKA5]Capricornio,2196,116,6,11,17,35.3%,20m
38278,1,QuitKilingMe,2196,44,5,5,10,50.0%,24m
38278,1,Duffman,2196,217,5,10,15,33.3%,15m
38278,2,TomCharly,2196,142,4,5,9,44.4%,2h
38278,1,WolFmaN,2196,40,3,5,8,37.5%,2h
38278,1,[ecdn]Shaynk,2196,130,3,6,9,33.3%,5m
38278,1,Hero,2196,48,3,6,9,33.3%,9m
38278,1,bthesalesman,2196,100,3,8,11,27.3%,2m
38278,2,[ZTemp]Thunder,2196,48,2,5,7,28.6%,48m
38278,1,ThornsOfThor,2196,0,1,1,2,50.0%,5m
38278,3,Cowbell,2196,0,1,1,2,50.0%,39m
38278,1,DogeLord,2196,0,1,1,2,50.0%,2h
38278,2,Ouijy,2196,30,1,5,6,16.7%,2h
38278,2,Kejawan,2196,30,1,5,6,16.7%,4m
38278,1,SayMyName,2196,0,1,6,7,14.3%,2h
38278,2,Drawer,2196,0,0,1,1,0.0%,46m
38278,2,MainUbuntu,2196,0,0,1,1,0.0%,2h
38278,3,Alarcondor,2196,0,0,2,2,0.0%,9m
38304,1,Polainas,2195,1713,127,127,254,50.0%,3h
38304,1,[Klukun]Tukmot,2195,1569,85,86,171,49.7%,2h
38304,2,[ponce]ArielLord,2195,846,35,34,69,50.7%,53m
38304,1,LazyTitan,2195,619,23,21,44,52.3%,23m
38304,1,AbyssTI,2195,438,13,19,32,40.6%,34m
38304,3,[3TT]Rhadamanthys,2195,325,12,8,20,60.0%,2h
38304,3,kvnsystem,2195,231,7,17,24,29.2%,2h
38304,2,Infowars,2195,168,5,3,8,62.5%,20m
38304,1,hungryshark,2195,162,5,7,12,41.7%,32m
38304,2,[TNTW]SaltyyMercy,2195,88,4,2,6,66.7%,2h
38304,1,Sincityflip,2195,185,4,4,8,50.0%,2h
38304,1,[Galaxy]Emortic,2195,183,4,7,11,36.4%,2h
38304,2,zerofaults,2195,80,3,1,4,75.0%,2h
38304,2,Cpkinz,2195,0,3,4,7,42.9%,46m
38304,1,PlasmaSnake,2195,97,2,2,4,50.0%,2h
38304,1,travis,2195,78,2,4,6,33.3%,36m
38304,2,caarlisle,2195,0,2,4,6,33.3%,2h
38304,1,jaktak,2195,48,2,8,10,20.0%,44m
38304,2,EvilSeed,2195,0,1,0,1,100.0%,2h
38304,2,UncleDrew,2195,0,1,0,1,100.0%,2h
38304,1,[Onixx]ICU,2195,0,0,2,2,0.0%,2h
38325,1,AwesomSparky,2194,1714,95,86,181,52.5%,25m
38325,1,KLONYAR,2194,1630,93,101,194,47.9%,2h
38325,1,[4ZKN]Qwearts,2194,1135,85,74,159,53.5%,3h
38325,3,[MGN]MarioBoss,2194,677,23,34,57,40.4%,2h
38325,1,Tube,2194,589,21,27,48,43.8%,39m
38325,2,riddle,2194,316,12,14,26,46.2%,2h
38325,1,TheScruff,2194,454,12,17,29,41.4%,9m
38325,1,BadHunter,2194,183,12,19,31,38.7%,42m
38325,1,TryAgain,2194,269,11,8,19,57.9%,2h
38325,1,[hekn]Jret,2194,316,11,12,23,47.8%,3h
38325,1,enuve,2194,274,9,6,15,60.0%,52m
38325,2,[322]Elmunstro,2194,210,8,7,15,53.3%,2h
38325,1,NutsackMcgee,2194,252,7,7,14,50.0%,2h
38325,2,[DJ411]Ironmav,2194,176,7,14,21,33.3%,37m
38325,2,Zrkha,2194,60,4,10,14,28.6%,10m
38325,2,[FlVlS]tdugz,2194,129,3,2,5,60.0%,2h
38325,2,[USWAG]AlphaWar,2194,30,1,1,2,50.0%,2h
38325,1,ArchAngelz,2194,0,1,2,3,33.3%,39m
38325,2,xibalba,2194,96,1,2,3,33.3%,40m
38325,1,Urax,2194,0,1,3,4,25.0%,2h
38325,2,Champion,2194,0,1,4,5,20.0%,2h
38325,1,greengorilla,2194,0,0,2,2,0.0%,2h
38347,1,Boonschlapp,2193,1555,98,103,201,48.8%,2h
38347,3,WhiteTiger,2193,1198,66,70,136,48.5%,52m
38347,1,[SCPER1]maza,2193,1041,48,52,100,48.0%,46m
38347,2,JSeige,2193,874,30,47,77,39.0%,25m
38347,3,[COCG]Guido,2193,768,28,37,65,43.1%,52m
38347,1,Zimlander,2193,724,24,21,45,53.3%,2h
38347,1,triplelattes,2193,510,17,19,36,47.2%,2h
38347,2,[WoLFR]GreenGold,2193,411,16,18,34,47.1%,2h
38347,1,bjai,2193,488,14,20,34,41.2%,2h
38347,1,GentKB,2193,475,13,21,34,38.2%,3h
38347,2,Schroedinger,2193,318,12,10,22,54.5%,2h
38347,2,HunterCal,2193,379,12,13,25,48.0%,21m
38347,2,GeorgeHarris,2193,289,11,13,24,45.8%,2h
38347,1,Kimmo,2193,210,6,9,15,40.0%,44m
38347,3,Keeper,2193,138,4,7,11,36.4%,2h
38347,1,hammerpie,2193,148,4,8,12,33.3%,2h
38347,1,WhiteSoul,2193,105,3,1,4,75.0%,43m
38347,1,aladepollo,2193,120,3,2,5,60.0%,2h
38347,1,ENKI,2193,84,3,3,6,50.0%,2h
38347,1,PHOFENIX,2193,125,3,3,6,50.0%,2h
38347,1,franco,2193,145,3,4,7,42.9%,54m
38347,1,[JAHA]LukaWhite,2193,40,3,5,8,37.5%,8m
38347,1,elmarim,2193,165,3,8,11,27.3%,2h
38347,2,blognof,2193,88,2,0,2,100.0%,44m
38347,3,Symbian,2193,121,2,2,4,50.0%,46m
38347,1,DKPROFANO,2193,0,2,5,7,28.6%,5m
38347,3,Kabanus,2193,30,2,8,10,20.0%,2h
38347,2,MINOS,2193,30,1,2,3,33.3%,2h
38347,2,POPka,2193,36,1,2,3,33.3%,49m
38347,2,Necreport,2193,0,1,4,5,20.0%,2h
38347,1,BURRITOALBIN,2193,0,1,6,7,14.3%,16m
38347,1,Memanoth,2193,0,0,2,2,0.0%,2h
38347,2,QED,2193,0,0,5,5,0.0%,2h
38380,1,Carmaxian,2192,1771,179,179,358,50.0%,2h
38380,2,protoss,2192,1338,52,49,101,51.5%,44m
38380,1,Piestone,2192,1112,44,46,90,48.9%,27m
38380,1,Debauch,2192,1030,35,35,70,50.0%,26m
38380,1,Kurisuten,2192,776,24,27,51,47.1%,2h
38380,1,Böhrt,2192,712,23,41,64,35.9%,50m
38380,2,Phoenix,2192,494,18,17,35,51.4%,26m
38380,1,MaleficusX,2192,427,15,18,33,45.5%,52m
38380,1,UndeadChew,2192,232,9,10,19,47.4%,2h
38380,1,confused,2192,286,9,13,22,40.9%,14m
38380,2,Chaka,2192,220,8,2,10,80.0%,2h
38380,1,Orbitalperid,2192,247,6,6,12,50.0%,25m
38380,1,Aubzstein,2192,202,6,7,13,46.2%,2h
38380,1,MAURICIO,2192,0,4,4,8,50.0%,2h
38380,1,KelsyThiccy,2192,145,4,6,10,40.0%,35m
38380,2,[MA50N]crispcheese,2192,94,3,5,8,37.5%,2h
38380,1,JON,2192,80,3,6,9,33.3%,44m
38380,1,lukitzu,2192,144,3,8,11,27.3%,2h
38380,1,ANgeL,2192,40,2,4,6,33.3%,2h
38380,1,DonAce,2192,115,2,6,8,25.0%,3h
38380,2,SCkid,2192,0,1,0,1,100.0%,2h
38380,2,Rgriff,2192,32,1,1,2,50.0%,2h
38380,1,[LgNx]Lolnoob,2192,0,1,3,4,25.0%,35m
38380,1,Divenha,2192,0,1,5,6,16.7%,2h
38380,1,[Nichol]Carefoot,2192,0,1,6,7,14.3%,50m
38380,2,Guasky,2192,0,0,1,1,0.0%,2h
38380,2,DANO,2192,0,0,1,1,0.0%,2h
38380,2,PabloLissn,2192,0,0,1,1,0.0%,2h
38408,1,toñito,2191,1331,204,204,408,50.0%,18m
38408,3,fascist,2191,1330,79,93,172,45.9%,2h
38408,1,sosa,2191,1605,65,59,124,52.4%,2h
38408,1,fission,2191,1376,55,53,108,50.9%,2h
38408,2,Slip,2191,1140,53,35,88,60.2%,2h
38408,1,zEUZ,2191,835,38,29,67,56.7%,2h
38408,1,Gabriel,2191,888,30,34,64,46.9%,2h
38408,1,Pan,2191,855,26,28,54,48.1%,3h
38408,1,Nesti,2191,728,21,24,45,46.7%,6m
38408,1,Aleekain,2191,524,17,21,38,44.7%,46m
38408,1,[F2AAA]CarrierDrake,2191,413,15,9,24,62.5%,2h
38408,2,Asad,2191,363,13,11,24,54.2%,2h
38408,1,FelipeXos,2191,282,8,16,24,33.3%,28m
38408,2,Robert,2191,152,5,6,11,45.5%,2h
38408,2,Ivan,2191,125,4,7,11,36.4%,2h
38408,1,[zXDz]Killerjp,2191,161,4,10,14,28.6%,2h
38408,2,Sebastian,2191,62,3,1,4,75.0%,47m
38408,2,[SCTF]Sushi,2191,102,3,1,4,75.0%,36m
38408,1,JoseÁguila,2191,42,2,4,6,33.3%,2h
38408,1,Snowfall,2191,120,2,6,8,25.0%,2h
38408,2,sang,2191,0,1,0,1,100.0%,2h
38408,2,Hallrunner,2191,0,0,1,1,0.0%,44m
38408,2,HiyoriKazane,2191,0,0,3,3,0.0%,2h
38431,1,voilierrouge,2190,1746,131,128,259,50.6%,14m
38431,1,return,2190,1753,129,126,255,50.6%,46m
38431,1,MegaMagz,2190,697,110,95,205,53.7%,2h
38431,2,[LOSCTM]PICHULOTOTE,2190,519,20,11,31,64.5%,2h
38431,1,Dio,2190,291,11,13,24,45.8%,2h
38431,3,Hazard,2190,155,8,5,13,61.5%,2h
38431,1,Dante,2190,249,7,6,13,53.8%,2h
38431,1,Lenin,2190,167,4,0,4,100.0%,2h
38431,3,BornToOffend,2190,173,4,7,11,36.4%,2h
38431,1,calijoe,2190,78,3,4,7,42.9%,8m
38431,3,[TY4GG]curlyfry,2190,122,3,7,10,30.0%,41m
38431,2,[Sc9Maf]PeeFace,2190,60,2,2,4,50.0%,2h
38431,1,Galveston,2190,0,1,1,2,50.0%,3h
38431,1,Donte,2190,0,1,5,6,16.7%,2h
38431,2,Remy,2190,0,0,1,1,0.0%,7m
38431,2,relentless,2190,0,0,1,1,0.0%,2h
38431,2,Logos,2190,0,0,5,5,0.0%,2h
38431,2,FyndFyre,2190,0,0,5,5,0.0%,2h
38431,2,marius,2190,0,0,5,5,0.0%,2h
38450,1,Martian,2189,957,216,218,434,49.8%,54m
38450,1,LightSorc,2189,1372,73,89,162,45.1%,3h
38450,2,HaydenW,2189,927,42,37,79,53.2%,2h
38450,1,Ravenbery,2189,627,20,23,43,46.5%,2h
38450,3,Spike,2189,350,14,25,39,35.9%,6m
38450,1,litch,2189,308,12,10,22,54.5%,2h
38450,1,DuckLuck,2189,279,9,15,24,37.5%,54m
38450,2,mcgaming,2189,180,6,5,11,54.5%,2h
38450,1,Emau,2189,232,6,8,14,42.9%,2h
38450,3,CachoSnacks,2189,172,6,15,21,28.6%,39m
38450,1,Traf,2189,130,3,3,6,50.0%,2h
38450,2,GERSnBEARS,2189,0,3,5,8,37.5%,2h
38450,1,KingSlayer,2189,0,2,5,7,28.6%,2h
38450,2,NicoPro,2189,0,1,0,1,100.0%,3h
38450,2,moximo,2189,40,1,1,2,50.0%,2h
38450,1,DocTemho,2189,48,1,3,4,25.0%,9m
38450,2,hoon,2189,0,0,1,1,0.0%,2h
38450,2,Avatar,2189,0,0,1,1,0.0%,2h
38450,1,Ziplink,2189,0,0,3,3,0.0%,46m
38450,1,[PDPGS]swordfish,2189,0,0,4,4,0.0%,3h
38470,1,ditxw,2188,890,90,80,170,52.9%,2h
38470,1,UshouldQuit,2188,1014,42,35,77,54.5%,2h
38470,1,DaniVLo,2188,632,24,21,45,53.3%,2h
38470,1,Method,2188,526,20,19,39,51.3%,2h
38470,3,[PAL]CraftStar,2188,584,19,33,52,36.5%,16m
38470,1,hanokjun,2188,436,16,20,36,44.4%,2h
38470,2,Urzu,2188,304,11,2,13,84.6%,5m
38470,1,RiUk,2188,304,9,13,22,40.9%,4m
38470,1,Eledhwen,2188,288,8,12,20,40.0%,2h
38470,2,Kyle,2188,146,6,4,10,60.0%,2h
38470,1,Neo,2188,138,6,7,13,46.2%,2h
38470,1,[BELIEF]Goober,2188,134,6,8,14,42.9%,2h
38470,2,JorgeSuarez,2188,210,6,12,18,33.3%,38m
38470,1,TimberRoof,2188,162,4,11,15,26.7%,2h
38470,1,KhalProtoss,2188,168,3,5,8,37.5%,2h
38470,3,SIDESWIPE,2188,30,1,3,4,25.0%,38m
38470,2,Hellig,2188,0,1,4,5,20.0%,42m
38470,1,JorgeA,2188,0,1,5,6,16.7%,29m
38470,3,Rideout,2188,30,1,5,6,16.7%,2h
38470,2,AlexBelmont,2188,0,0,1,1,0.0%,30m
38470,1,MightyGaw,2188,0,0,1,1,0.0%,28m
38470,2,Sickkiid,2188,0,0,5,5,0.0%,2h
38492,1,pirate,2187,952,38,45,83,45.8%,2h
38492,1,[Mdtk]DiosOtaku,2187,1129,36,35,71,50.7%,2h
38492,1,ImYoYo,2187,705,31,22,53,58.5%,2h
38492,1,[K3oudy]LUKAS,2187,580,18,22,40,45.0%,2h
38492,1,Daniel,2187,243,11,4,15,73.3%,48m
38492,2,Yatagarasu,2187,222,8,6,14,57.1%,2h
38492,1,Jettlight,2187,158,7,11,18,38.9%,8m
38492,1,Mayday,2187,161,6,5,11,54.5%,3h
38492,1,Camus,2187,144,6,8,14,42.9%,27m
38492,2,[SECT4]kuyes,2187,124,4,6,10,40.0%,2h
38492,2,[GLHISC]Neoatomaton,2187,60,3,1,4,75.0%,47m
38492,3,TheRealHan,2187,30,2,8,10,20.0%,2h
38492,1,commandc,2187,42,1,3,4,25.0%,6m
38492,1,LilSox,2187,42,1,4,5,20.0%,29m
38492,1,TENSHI,2187,0,1,5,6,16.7%,2h
38492,1,Trey,2187,96,1,6,7,14.3%,41m
38492,2,Cluntang,2187,0,0,1,1,0.0%,36m
38492,1,Woman,2187,0,0,2,2,0.0%,51m
38492,1,konstantinos,2187,0,0,3,3,0.0%,16m
38511,2,ProducePat,2186,1642,205,204,409,50.1%,34m
38511,1,Alephaltaire,2186,1776,164,190,354,46.3%,2h
38511,1,Krieger,2186,1528,70,61,131,53.4%,2h
38511,2,BvgMaster,2186,1487,61,56,117,52.1%,2h
38511,2,[QQQ]doc,2186,885,41,40,81,50.6%,2h
38511,1,Blavk,2186,643,30,30,60,50.0%,22m
38511,1,Sariel,2186,400,14,16,30,46.7%,39m
38511,1,CommunistAK,2186,383,12,14,26,46.2%,2h
38511,1,[FNC45]Leuco,2186,384,11,13,24,45.8%,46m
38511,1,Samalmi,2186,256,8,6,14,57.1%,40m
38511,1,MissZergies,2186,92,7,9,16,43.8%,36m
38511,1,castortroy,2186,90,7,15,22,31.8%,7m
38511,1,KillemALL,2186,253,6,10,16,37.5%,3h
38511,1,[L0gang]Krimourgos,2186,260,6,10,16,37.5%,6m
38511,1,Alphaleader,2186,164,5,8,13,38.5%,2h
38511,2,adriano,2186,122,4,4,8,50.0%,37m
38511,3,DukeDiggler,2186,30,3,7,10,30.0%,16m
38511,3,Sisyphus,2186,120,3,7,10,30.0%,41m
38511,1,bobbin,2186,74,2,4,6,33.3%,18m
38511,1,rexchil,2186,48,2,6,8,25.0%,2h
38511,3,TIBERIOUS,2186,97,2,8,10,20.0%,18m
38511,2,HORIZONTH,2186,0,1,1,2,50.0%,48m
38511,1,[UltraX]CombatWombat,2186,34,1,3,4,25.0%,42m
38511,3,Gustavo,2186,0,1,5,6,16.7%,2h
38511,1,ScottSizzle,2186,0,0,2,2,0.0%,2h
38511,1,[BlTEL]eduardoher,2186,0,0,4,4,0.0%,16m
38537,3,Marshall,2185,1561,413,423,836,49.4%,2h
38537,1,[MIGAN]ZiChill,2185,1722,59,58,117,50.4%,3h
38537,1,JDIDOL,2185,948,31,29,60,51.7%,2h
38537,1,[DGCIM]BOSCA,2185,894,25,36,61,41.0%,40m
38537,1,cavalier,2185,605,21,19,40,52.5%,2h
38537,1,Ikuo,2185,463,21,20,41,51.2%,2h
38537,1,VoicePowered,2185,384,15,15,30,50.0%,8m
38537,1,[Dark18]NemesiS,2185,273,11,7,18,61.1%,2h
38537,2,Photarius,2185,253,8,15,23,34.8%,2h
38537,1,GaNaRo,2185,96,7,9,16,43.8%,52m
38537,3,[hxhchi]Krom,2185,221,7,13,20,35.0%,9m
38537,2,Gforce,2185,120,5,2,7,71.4%,2h
38537,2,opticfir,2185,150,5,3,8,62.5%,2h
38537,1,LoCkRbOy,2185,174,5,12,17,29.4%,46m
38537,3,tesla,2185,60,4,7,11,36.4%,2h
38537,1,Mzum,2185,96,3,7,10,30.0%,2h
38537,2,bradjohns,2185,0,2,3,5,40.0%,2h
38537,2,AliXander,2185,64,2,4,6,33.3%,36m
38537,3,Eladio,2185,0,2,7,9,22.2%,4m
38537,2,[Nutr]ESTALKER,2185,36,1,2,3,33.3%,3h
38537,1,Keino,2185,42,1,3,4,25.0%,5m
38537,2,Shintaro,2185,0,1,4,5,20.0%,51m
38537,1,SaracenRue,2185,0,1,5,6,16.7%,2h
38560,1,martinanto,2184,1598,142,126,268,53.0%,2h
38560,1,Erre,2184,1310,56,49,105,53.3%,3h
38560,3,FebleFighter,2184,1071,38,48,86,44.2%,33m
38560,1,MemeMachine,2184,475,24,23,47,51.1%,2h
38560,1,[BalLzz]Porkins,2184,650,18,27,45,40.0%,2h
38560,2,Mizzer,2184,332,13,9,22,59.1%,40m
38560,1,hayabusa,2184,507,13,17,30,43.3%,45m
38560,1,jugernott,2184,396,11,16,27,40.7%,2h
38560,1,Genidoxian,2184,300,7,9,16,43.8%,6m
38560,1,KrazyFarm,2184,119,5,7,12,41.7%,22m
38560,3,Hanson,2184,134,5,10,15,33.3%,28m
38560,1,TahVeZ,2184,122,4,8,12,33.3%,2h
38560,2,[SCPuno]CriZtorm,2184,60,3,2,5,60.0%,2m
38560,1,Notagonist,2184,111,3,6,9,33.3%,2h
38560,1,Torch,2184,97,2,1,3,66.7%,2h
38560,2,[Stunks]NiiSaaaan,2184,0,2,7,9,22.2%,2h
38560,2,Templar,2184,0,1,3,4,25.0%,42m
38560,2,[DtAr2]LifeStyle,2184,30,1,6,7,14.3%,4m
38560,3,[sk3tch]RIMKICA,2184,0,1,8,9,11.1%,2h
38560,2,[OnlyFF]ThreeKinGs,2184,0,0,1,1,0.0%,2h
38560,3,Slacy,2184,0,0,4,4,0.0%,18m
38581,2,emperorFij,2183,1642,137,125,262,52.3%,24m
38581,1,Dant,2183,1290,74,77,151,49.0%,54m
38581,1,TheSituation,2183,1412,52,61,113,46.0%,25m
38581,2,kdope,2183,1307,47,50,97,48.5%,2h
38581,2,gbie,2183,901,32,34,66,48.5%,2h
38581,1,VirtualDhruv,2183,687,27,30,57,47.4%,51m
38581,3,MOC,2183,645,23,24,47,48.9%,2h
38581,3,lompy,2183,193,16,24,40,40.0%,49m
38581,1,[UpxV]neil,2183,462,13,17,30,43.3%,22m
38581,1,Yusse,2183,410,12,17,29,41.4%,2h
38581,1,[MBTW]Scale,2183,312,12,17,29,41.4%,5m
38581,1,[Bommmm]CapeGoblin,2183,363,11,11,22,50.0%,32m
38581,1,jlam,2183,318,11,12,23,47.8%,27m
38581,1,Iamaman,2183,300,10,11,21,47.6%,2h
38581,2,Magic,2183,306,10,13,23,43.5%,41m
38581,1,StingRay,2183,250,10,17,27,37.0%,22m
38581,1,Combustion,2183,292,9,11,20,45.0%,2h
38581,2,[CHKNS]BluUaway,2183,172,6,6,12,50.0%,39m
38581,2,alequei,2183,128,4,1,5,80.0%,2h
38581,2,cratos,2183,144,4,3,7,57.1%,13m
38581,2,TheSenate,2183,86,3,1,4,75.0%,3h
38581,3,[cocogr]KonosubaAQUA,2183,97,2,2,4,50.0%,2h
38581,1,Cangas,2183,108,2,5,7,28.6%,2h
38581,1,tonto,2183,30,2,5,7,28.6%,3h
38581,2,[AntLYF]Memebro,2183,0,1,0,1,100.0%,46m
38581,2,[Protie]Redblugray,2183,0,1,0,1,100.0%,2h
38581,2,SueZ,2183,0,1,2,3,33.3%,13m
38581,2,noobSaibott,2183,30,1,2,3,33.3%,2h
38581,2,ArvinGill,2183,0,1,4,5,20.0%,41m
38581,1,[ROSC2]DIHmaster,2183,32,1,7,8,12.5%,14m
38581,1,CmdrSlayer,2183,0,0,2,2,0.0%,43m
38581,2,[TeamEz]WarriorBoy,2183,0,0,5,5,0.0%,2h
38613,1,lilit,2182,1738,183,195,378,48.4%,2h
38613,1,Nolanic,2182,1371,53,46,99,53.5%,3h
38613,1,Stormtrooper,2182,684,37,42,79,46.8%,2h
38613,1,[SECT4]EltioZeratul,2182,810,36,41,77,46.8%,39m
38613,1,dhuangal,2182,561,29,32,61,47.5%,45m
38613,1,Rexxuz,2182,818,28,34,62,45.2%,54m
38613,1,Scootttwar,2182,799,26,24,50,52.0%,25m
38613,1,Becky,2182,497,19,26,45,42.2%,9m
38613,1,Tapzarf,2182,473,16,18,34,47.1%,2h
38613,1,UntilMonday,2182,518,16,23,39,41.0%,24m
38613,1,QCwariror,2182,289,16,24,40,40.0%,54m
38613,2,[Danilo]Andross,2182,470,15,22,37,40.5%,2h
38613,1,[D11313]FERRARI,2182,400,14,15,29,48.3%,2h
38613,1,Randhyfloo,2182,406,13,16,29,44.8%,2h
38613,1,Leiva,2182,346,12,12,24,50.0%,2h
38613,1,trackmish,2182,300,11,14,25,44.0%,22m
38613,1,FRANXESCO,2182,260,8,11,19,42.1%,39m
38613,3,[yito]Sandoodle,2182,222,7,12,19,36.8%,14m
38613,1,JostlAC,2182,198,6,9,15,40.0%,2h
38613,2,SArS,2182,30,5,4,9,55.6%,2h
38613,1,Tyler,2182,48,5,4,9,55.6%,2h
38613,1,Embersmith,2182,180,5,6,11,45.5%,2h
38613,2,SingeVolant,2182,128,4,5,9,44.4%,2h
38613,2,[gLk]SerGovna,2182,60,3,0,3,100.0%,2h
38613,1,Stags,2182,144,3,8,11,27.3%,2h
38613,2,Shadow,2182,0,1,0,1,100.0%,44m
38613,2,TerranRB,2182,30,1,2,3,33.3%,49m
38613,1,Udders,2182,0,1,6,7,14.3%,44m
38613,1,[OD2019]Victory,2182,0,1,7,8,12.5%,2h
38613,1,Wolf,2182,0,1,7,8,12.5%,49m
38613,1,Spark,2182,0,0,1,1,0.0%,3h
38613,2,OCzaplarski,2182,0,0,1,1,0.0%,3h
38613,1,netsparc,2182,0,0,2,2,0.0%,22m
38613,1,Littlepeach,2182,0,0,2,2,0.0%,2h
38613,1,[LMI42]JDOUBLE,2182,0,0,4,4,0.0%,2h
38648,1,Morty,2181,1346,53,61,114,46.5%,2h
38648,3,Pierre,2181,1142,46,49,95,48.4%,2h
38648,3,[BAMF]BadJudgment,2181,1314,46,61,107,43.0%,2h
38648,1,[KTSC2]DANIELCPS,2181,1144,38,47,85,44.7%,54m
38648,1,Hotame,2181,873,27,29,56,48.2%,27m
38648,3,Polythemus,2181,616,24,29,53,45.3%,2h
38648,2,[SARGÇ]Xandão,2181,554,22,16,38,57.9%,45m
38648,2,BaldyCron,2181,394,14,8,22,63.6%,23m
38648,1,Aaragorn,2181,426,12,19,31,38.7%,8m
38648,2,Vandersson,2181,243,7,12,19,36.8%,2h
38648,2,katikita,2181,254,6,6,12,50.0%,2h
38648,1,bsweatin,2181,140,5,9,14,35.7%,3h
38648,2,InnerLight,2181,58,3,0,3,100.0%,2h
38648,1,JokeR,2181,108,3,5,8,37.5%,4m
38648,3,mango,2181,38,3,8,11,27.3%,18m
38648,1,moko,2181,30,3,9,12,25.0%,22m
38648,1,StanSmith,2181,95,2,6,8,25.0%,4m
38648,1,[SLOR]StarKiller,2181,0,2,8,10,20.0%,2h
38648,2,captain,2181,32,1,3,4,25.0%,39m
38648,1,thugjitsu,2181,0,1,6,7,14.3%,11m
38648,2,[F0E]Trey,2181,0,0,2,2,0.0%,2h
38648,2,[valhal]Zeroneica,2181,0,0,2,2,0.0%,44m
38648,2,depredador,2181,0,0,2,2,0.0%,3h
38671,1,Turin,2180,1740,86,90,176,48.9%,11m
38671,1,[ANFA]SnowManAK,2180,1279,49,57,106,46.2%,24m
38671,3,Hitchslap,2180,340,43,51,94,45.7%,2h
38671,2,ElPasta,2180,755,29,29,58,50.0%,53m
38671,1,RodimusOne,2180,285,23,16,39,59.0%,2h
38671,3,Eyedea,2180,357,15,6,21,71.4%,2h
38671,3,GAOLANG,2180,257,10,8,18,55.6%,2h
38671,2,Mystic,2180,240,7,9,16,43.8%,2h
38671,1,Magnifeye,2180,97,5,3,8,62.5%,49m
38671,1,Alpha,2180,97,4,4,8,50.0%,3m
38671,1,sHk,2180,144,4,7,11,36.4%,42m
38671,1,FireMoose,2180,116,3,8,11,27.3%,2h
38671,1,[M3A5]Modis,2180,141,2,7,9,22.2%,25m
38671,1,Aaron,2180,48,2,7,9,22.2%,2h
38671,2,zaiken,2180,0,1,0,1,100.0%,47m
38671,2,rabitcoffet,2180,0,1,0,1,100.0%,2h
38671,3,MartyParty,2180,97,1,1,2,50.0%,2h
38671,1,AutoAutomate,2180,0,1,2,3,33.3%,2h
38671,3,RafaelCG,2180,0,0,1,1,0.0%,9m
38671,2,benjafash,2180,0,0,1,1,0.0%,2h
38671,2,ÐRACARYS,2180,0,0,1,1,0.0%,2h
38671,2,letitrain,2180,0,0,5,5,0.0%,33m
38693,1,gratatica,2179,1177,127,118,245,51.8%,2h
38693,3,[cluez]john,2179,1474,82,90,172,47.7%,2h
38693,1,Elixer,2179,494,25,27,52,48.1%,27m
38693,1,GottiBones,2179,600,16,25,41,39.0%,2h
38693,1,TAURUS,2179,542,15,16,31,48.4%,2h
38693,1,Allanon,2179,451,14,21,35,40.0%,2h
38693,1,[HDD]leafARG,2179,304,11,15,26,42.3%,2h
38693,2,Zorda,2179,168,6,3,9,66.7%,44m
38693,2,DavioS,2179,190,6,5,11,54.5%,31m
38693,2,Mono,2179,124,6,13,19,31.6%,2h
38693,3,BLUELIGHT,2179,194,5,11,16,31.2%,2h
38693,1,soga,2179,158,4,9,13,30.8%,26m
38693,2,[USRU]JIGyfry,2179,62,3,0,3,100.0%,2h
38693,2,ljdelight,2179,125,3,10,13,23.1%,20m
38693,2,kogswain,2179,30,2,3,5,40.0%,34m
38693,2,Jinx,2179,0,2,4,6,33.3%,2h
38693,1,[BoNX]NotAWalnut,2179,48,1,1,2,50.0%,2h
38693,2,Crank,2179,0,0,1,1,0.0%,13m
38693,1,gnolen,2179,0,0,1,1,0.0%,2h
38693,3,Endever,2179,0,0,1,1,0.0%,2h
38693,2,[DXPCA]Chuleton,2179,0,0,1,1,0.0%,48m
38693,1,KittyCatJoe,2179,0,0,2,2,0.0%,2h
38693,1,Murl,2179,0,0,5,5,0.0%,2h
38693,1,Ignition,2179,0,0,5,5,0.0%,2h
38693,2,[DhZAc1]KeitSunagi,2179,0,0,5,5,0.0%,14m
38718,3,CharlesVail,2178,1503,142,142,284,50.0%,28m
38718,1,mdrod,2178,897,60,59,119,50.4%,2h
38718,1,dreico,2178,1348,44,54,98,44.9%,2h
38718,1,UNKLDN,2178,901,33,30,63,52.4%,3h
38718,2,vvxxwxxvv,2178,734,28,22,50,56.0%,2h
38718,1,Gerard,2178,653,23,24,47,48.9%,2h
38718,2,Cuchito,2178,452,19,14,33,57.6%,2h
38718,2,MClegend,2178,426,16,17,33,48.5%,4m
38718,1,[xHtsx]dullahan,2178,380,14,19,33,42.4%,2h
38718,1,glhf,2178,398,12,12,24,50.0%,3m
38718,2,AVJ,2178,286,10,4,14,71.4%,2h
38718,1,JuliexAiur,2178,190,8,17,25,32.0%,7m
38718,2,Proton,2178,158,7,12,19,36.8%,47m
38718,2,[MncsGG]Fabry,2178,105,5,1,6,83.3%,2h
38718,1,darkshadow,2178,159,5,13,18,27.8%,51m
38718,2,MAUX,2178,32,2,1,3,66.7%,37m
38718,3,Tkon,2178,0,1,0,1,100.0%,2h
38718,2,DarkFire,2178,0,1,0,1,100.0%,2h
38718,1,[Brosss]Radagnir,2178,48,1,2,3,33.3%,54m
38718,1,Paul,2178,0,1,3,4,25.0%,2h
38718,1,HoratioBut,2178,0,1,5,6,16.7%,2h
38718,1,[TROLL]SoupBone,2178,0,1,7,8,12.5%,51m
38718,2,[Koxone]Koxone,2178,0,0,1,1,0.0%,3h
38741,1,DuneRider,2177,1723,109,117,226,48.2%,45m
38741,1,[wdsd]BLAZE,2177,550,36,35,71,50.7%,2h
38741,1,terasilfo,2177,662,18,28,46,39.1%,16m
38741,1,Savaron,2177,234,8,12,20,40.0%,2h
38741,1,BenDover,2177,206,7,8,15,46.7%,2h
38741,2,Prometheon,2177,30,5,1,6,83.3%,54m
38741,2,YOURMAMA,2177,77,5,4,9,55.6%,2m
38741,2,orcster,2177,34,4,2,6,66.7%,2h
38741,1,Davidavenger,2177,112,3,2,5,60.0%,54m
38741,1,woolseybaby,2177,82,3,7,10,30.0%,14m
38741,2,JACHAURU,2177,0,2,3,5,40.0%,2h
38741,1,dalektac,2177,30,2,4,6,33.3%,22m
38741,1,goldspoon,2177,102,2,6,8,25.0%,2h
38741,2,buzzlow,2177,0,1,0,1,100.0%,2h
38741,1,[mex20]ian,2177,0,1,0,1,100.0%,2h
38741,2,JimboSliceX,2177,30,1,1,2,50.0%,13m
38741,1,[DevilF]CartianGlory,2177,0,1,3,4,25.0%,18m
38741,2,VICTOR,2177,0,1,5,6,16.7%,46m
38741,1,JoeyRiot,2177,0,1,5,6,16.7%,2h
38741,2,SwampRat,2177,0,0,1,1,0.0%,3h
38741,2,[DCSK]Benji,2177,0,0,1,1,0.0%,2h
38741,2,Ozmo,2177,0,0,2,2,0.0%,2h
38741,1,Joelerch,2177,0,0,2,2,0.0%,2h
38764,1,starhue,2176,1637,92,84,176,52.3%,2h
38764,1,Verth,2176,1174,65,57,122,53.3%,2h
38764,1,[Gr33zy]Venshion,2176,999,59,57,116,50.9%,36m
38764,1,[FNES1]VIOLATER,2176,688,25,27,52,48.1%,27m
38764,1,zenkumaaa,2176,750,23,28,51,45.1%,2h
38764,1,ElSanti,2176,443,16,12,28,57.1%,41m
38764,2,Morpheus,2176,300,10,9,19,52.6%,2h
38764,1,UrMana,2176,126,7,3,10,70.0%,12m
38764,2,antonio,2176,30,6,8,14,42.9%,2h
38764,1,Dolothion,2176,0,3,3,6,50.0%,39m
38764,2,EbonyMaw,2176,167,3,8,11,27.3%,2h
38764,2,Gabroni,2176,62,2,2,4,50.0%,54m
38764,2,[DHE]Netshade,2176,58,2,3,5,40.0%,2h
38764,1,TeloSampo,2176,90,2,3,5,40.0%,27m
38764,1,anonymouse,2176,32,2,5,7,28.6%,2h
38764,2,[Apinks]Apink,2176,0,1,0,1,100.0%,13m
38764,1,winniepooh,2176,90,1,3,4,25.0%,3h
38764,1,SquintyHawk,2176,0,1,6,7,14.3%,2h
38764,1,Ogdangler,2176,42,1,7,8,12.5%,2h
38764,2,[Vault]Grimz,2176,0,0,1,1,0.0%,42m
38764,2,SOMETHING,2176,0,0,1,1,0.0%,2h
38764,2,TOxic,2176,0,0,1,1,0.0%,24m
38764,2,[4bronz]starlove,2176,0,0,2,2,0.0%,2h
38787,1,IWiLLImpale,2175,1448,64,62,126,50.8%,16m
38787,1,Devere,2175,1139,46,39,85,54.1%,16m
38787,1,Slaughterer,2175,833,41,34,75,54.7%,2h
38787,1,Ravage,2175,731,20,23,43,46.5%,3h
38787,1,fatass,2175,274,14,15,29,48.3%,3h
38787,1,[TGosuB]HSXVR,2175,208,7,11,18,38.9%,2h
38787,2,adrianriosL,2175,135,3,4,7,42.9%,2h
38787,2,KUMA,2175,30,3,8,11,27.3%,3m
38787,2,berserker,2175,0,2,3,5,40.0%,2h
38787,2,Iceignition,2175,92,2,5,7,28.6%,2h
38787,2,ASSASSINS,2175,0,1,0,1,100.0%,2h
38787,1,Proboss,2175,0,1,5,6,16.7%,2h
38787,1,Namenduro,2175,0,1,5,6,16.7%,2h
38787,2,Seductive,2175,0,0,2,2,0.0%,13m
38787,2,Fischer,2175,0,0,2,2,0.0%,2h
38802,1,JASONBOURNE,2174,1209,119,125,244,48.8%,14m
38802,3,MagicTurtle,2174,309,30,48,78,38.5%,19m
38802,1,Abdul,2174,193,12,5,17,70.6%,37m
38802,1,ZergOP,2174,270,12,6,18,66.7%,5m
38802,3,Tarvanis,2174,314,11,17,28,39.3%,3h
38802,1,zeratul,2174,171,10,13,23,43.5%,46m
38802,3,pinguino,2174,236,9,40,49,18.4%,9m
38802,2,[RUD3]jstrong,2174,217,7,10,17,41.2%,8m
38802,1,[OndaVT]Goofi,2174,296,7,16,23,30.4%,6m
38802,2,THUT,2174,86,6,9,15,40.0%,2h
38802,1,[trube]BoB,2174,212,5,11,16,31.2%,2h
38802,3,MyHiveonAiur,2174,30,3,7,10,30.0%,3h
38802,1,daster,2174,144,2,1,3,66.7%,28m
38802,2,[LOHs]Elrigo,2174,36,2,2,4,50.0%,2h
38802,2,jamesrp,2174,0,2,3,5,40.0%,31m
38802,1,Apollineo,2174,125,2,5,7,28.6%,41m
38802,2,[MncsGG]Dinkelberg,2174,0,1,0,1,100.0%,2h
38802,1,MJR,2174,0,1,6,7,14.3%,3h
38802,3,HawtLixx,2174,0,0,1,1,0.0%,46m
38802,2,[Exper]zak,2174,0,0,1,1,0.0%,35m
38802,2,NSampson,2174,0,0,1,1,0.0%,2h
38802,2,Bendy,2174,0,0,2,2,0.0%,46m
38802,1,weweweyou,2174,0,0,3,3,0.0%,2h
38825,2,Revenge,2173,1571,289,295,584,49.5%,37m
38825,1,[IoO7]EnderT,2173,1567,134,140,274,48.9%,3h
38825,1,mynameisreza,2173,1721,81,77,158,51.3%,2h
38825,1,[00SB00]SpItFiRe,2173,1193,66,68,134,49.3%,2h
38825,1,[CdA]Escudero,2173,1252,62,59,121,51.2%,21m
38825,1,KillerZone,2173,1302,55,58,113,48.7%,54m
38825,1,Trump,2173,912,32,36,68,47.1%,2h
38825,1,Tiammat,2173,726,29,32,61,47.5%,2h
38825,2,pppppppppppp,2173,336,12,4,16,75.0%,2h
38825,3,Philippe,2173,268,9,7,16,56.2%,2h
38825,2,MechEng,2173,236,8,5,13,61.5%,2h
38825,1,TyTheTemplar,2173,282,7,12,19,36.8%,53m
38825,2,[mustaf]Notlikethis,2173,190,6,7,13,46.2%,2h
38825,3,HoneyBadger,2173,152,5,16,21,23.8%,2h
38825,2,KelionS,2173,116,4,6,10,40.0%,23m
38825,1,Mscooky,2173,48,2,3,5,40.0%,44m
38825,2,Roynie,2173,0,2,3,5,40.0%,2h
38825,1,DHPC,2173,0,2,6,8,25.0%,2h
38825,2,Demolidor,2173,0,1,0,1,100.0%,2h
38825,2,STRANGER,2173,0,1,1,2,50.0%,44m
38825,2,sirswagalot,2173,0,1,4,5,20.0%,2h
38825,2,WeI,2173,0,0,1,1,0.0%,40m
38847,1,fusion,2172,1571,121,115,236,51.3%,2h
38847,2,Kaeda,2172,1646,75,63,138,54.3%,2h
38847,1,Kaleidoscope,2172,728,50,43,93,53.8%,2h
38847,1,BWills,2172,1172,45,42,87,51.7%,2h
38847,2,[WRLORD]ºSEINDELº,2172,992,34,39,73,46.6%,13m
38847,2,[Anbu]PhoenixRisin,2172,842,30,32,62,48.4%,42m
38847,3,Raposo,2172,209,26,26,52,50.0%,2h
38847,3,WildPants,2172,214,9,13,22,40.9%,2h
38847,1,maxout,2172,218,6,8,14,42.9%,2h
38847,1,Axolotl,2172,230,6,13,19,31.6%,5m
38847,2,JessR,2172,152,5,5,10,50.0%,2h
38847,1,Spradlinator,2172,192,5,8,13,38.5%,46m
38847,2,Enlightend,2172,158,5,9,14,35.7%,2h
38847,2,notMaru,2172,86,4,0,4,100.0%,32m
38847,2,Djbrohamer,2172,0,4,7,11,36.4%,48m
38847,1,Knightnight,2172,126,4,8,12,33.3%,2h
38847,1,Silviozum,2172,193,3,1,4,75.0%,2h
38847,1,bronzini,2172,96,3,9,12,25.0%,2h
38847,1,[WRLORD]BISMARCK,2172,18,3,9,12,25.0%,2h
38847,2,[TuRtel]Wreckful,2172,0,2,3,5,40.0%,2h
38847,2,Bizling,2172,0,2,3,5,40.0%,2h
38847,2,Caspian,2172,0,1,0,1,100.0%,38m
38847,3,Legend,2172,0,1,0,1,100.0%,2h
38847,2,Askedmed,2172,36,1,2,3,33.3%,2m
38847,2,Squeebee,2172,95,1,5,6,16.7%,2h
38847,3,NinthEcho,2172,0,1,7,8,12.5%,2h
38847,3,JubbyMake,2172,0,0,1,1,0.0%,6m
38847,2,Kuhl,2172,0,0,2,2,0.0%,2h
38847,2,Hekamiah,2172,0,0,2,2,0.0%,40m
38876,1,rompeimenz,2171,1617,132,125,257,51.4%,2h
38876,1,VISARII,2171,1768,77,78,155,49.7%,2h
38876,2,juvencus,2171,1647,65,62,127,51.2%,2h
38876,2,Zorrander,2171,603,42,45,87,48.3%,36m
38876,1,EduardoEku,2171,910,38,40,78,48.7%,6m
38876,2,Perera,2171,748,28,22,50,56.0%,2h
38876,1,dinkydoodle,2171,382,17,14,31,54.8%,16m
38876,3,Tipples,2171,297,11,13,24,45.8%,42m
38876,1,Player,2171,282,11,14,25,44.0%,2h
38876,2,Aiolo,2171,284,11,15,26,42.3%,2h
38876,2,Ichigo,2171,168,6,1,7,85.7%,20m
38876,1,[BrknPp]DaCookie,2171,202,5,5,10,50.0%,3h
38876,1,Rhombus,2171,122,4,10,14,28.6%,2h
38876,2,[WWP2]WolfPrince,2171,88,3,3,6,50.0%,2h
38876,2,[ALTF04]AtreUS,2171,30,2,0,2,100.0%,45m
38876,2,RyoShiroYuki,2171,62,2,2,4,50.0%,35m
38876,2,iiheartwaves,2171,36,1,1,2,50.0%,26m
38876,2,Darkslayer,2171,0,1,2,3,33.3%,2h
38876,1,[CaC4s]efrain,2171,48,1,2,3,33.3%,6m
38876,2,Esteban,2171,97,1,5,6,16.7%,2h
38876,1,FRFLhoola,2171,0,1,6,7,14.3%,2h
38876,1,sampai,2171,0,1,7,8,12.5%,2h
38876,2,Natsafu,2171,0,0,2,2,0.0%,2h
38876,2,CHOLOPOWER,2171,0,0,2,2,0.0%,2h
38900,2,STRIKER,2170,507,44,51,95,46.3%,2h
38900,2,DeathBNimble,2170,694,28,39,67,41.8%,43m
38900,2,cesar,2170,664,25,18,43,58.1%,2h
38900,2,DizzyDolphin,2170,546,18,23,41,43.9%,2h
38900,1,DantePH,2170,396,15,12,27,55.6%,2h
38900,2,[FyH]salomon,2170,406,15,13,28,53.6%,2h
38900,2,WolfmasterMx,2170,274,11,7,18,61.1%,2h
38900,1,[Year06]Ares,2170,348,10,12,22,45.5%,14m
38900,1,snacksonapln,2170,339,9,9,18,50.0%,46m
38900,1,CatmanDogman,2170,288,9,14,23,39.1%,2h
38900,3,[LhL]ComanderVolt,2170,202,6,19,25,24.0%,2h
38900,1,Leonidas,2170,158,5,7,12,41.7%,2h
38900,2,[clanSD]Judicador,2170,32,4,2,6,66.7%,2h
38900,1,Axll,2170,168,3,8,11,27.3%,2h
38900,2,jennie,2170,30,2,1,3,66.7%,2h
38900,1,skullcrusher,2170,30,2,5,7,28.6%,3h
38900,2,TUnafish,2170,0,1,2,3,33.3%,2h
38900,2,[SUDAKA]ILAN,2170,0,0,1,1,0.0%,33m
38900,2,Tapel,2170,0,0,5,5,0.0%,2h
38919,3,GonzalitRock,2169,1575,155,158,313,49.5%,22m
38919,1,MaksipadXOXO,2169,1599,127,134,261,48.7%,6m
38919,1,Silentshoot,2169,1740,76,82,158,48.1%,39m
38919,1,LomeLic,2169,1583,59,59,118,50.0%,45m
38919,1,[gbag]Opi,2169,975,51,42,93,54.8%,2h
38919,1,HITMAN,2169,1464,51,54,105,48.6%,2h
38919,1,Adfwan,2169,852,31,33,64,48.4%,25m
38919,2,Gerysomi,2169,457,16,10,26,61.5%,45m
38919,1,ChunkyMonkey,2169,411,14,12,26,53.8%,37m
38919,1,copito,2169,476,14,17,31,45.2%,2h
38919,1,[mustaf]TerranDatAss,2169,466,13,21,34,38.2%,2h
38919,1,hexapod,2169,338,10,16,26,38.5%,2h
38919,1,TupaC,2169,304,9,12,21,42.9%,2h
38919,1,TooStronk,2169,256,6,11,17,35.3%,2h
38919,2,Zayres,2169,97,3,3,6,50.0%,2h
38919,1,Dissin,2169,34,3,5,8,37.5%,54m
38919,2,Sero,2169,90,3,7,10,30.0%,2h
38919,1,Heliographer,2169,40,2,5,7,28.6%,3m
38919,2,KidOne,2169,0,2,7,9,22.2%,3h
38919,2,[Akita]Kuza,2169,113,2,8,10,20.0%,45m
38919,2,[RMW]MetalDeath,2169,0,1,0,1,100.0%,2h
38919,2,GarganticPNS,2169,0,1,0,1,100.0%,48m
38919,2,[Lukss]SARSCOV,2169,0,1,1,2,50.0%,13m
38919,3,josem,2169,0,0,1,1,0.0%,2h
38919,2,[mene]sirciro,2169,0,0,2,2,0.0%,53m
38944,1,[ZTemps]IIIIIIIIIIII,2168,1575,353,382,735,48.0%,2h
38944,1,Dstorm,2168,1753,120,113,233,51.5%,3h
38944,1,Stabathor,2168,864,80,74,154,51.9%,27m
38944,1,Tapir,2168,968,79,81,160,49.4%,27m
38944,2,Kyle,2168,674,56,53,109,51.4%,39m
38944,1,[00o0O]CdRPcHoVilla,2168,1004,39,43,82,47.6%,2h
38944,2,Church,2168,321,13,12,25,52.0%,2h
38944,3,ffasd,2168,226,9,12,21,42.9%,2h
38944,3,CAFFELATTE,2168,245,8,8,16,50.0%,46m
38944,2,JoblessMex,2168,120,6,6,12,50.0%,2h
38944,1,Vermlin,2168,102,4,5,9,44.4%,2h
38944,2,Streetmonkey,2168,216,4,13,17,23.5%,2h
38944,2,GOODYDOOD,2168,96,3,4,7,42.9%,2h
38944,3,atos,2168,123,3,7,10,30.0%,37m
38944,2,locodeis,2168,70,2,1,3,66.7%,2h
38944,2,Stefmaster,2168,34,2,2,4,50.0%,2h
38944,2,EuVenhoEmPaz,2168,64,2,5,7,28.6%,2h
38944,1,Dreadly,2168,0,2,8,10,20.0%,3h
38944,2,matusnator,2168,0,1,2,3,33.3%,2h
38944,2,RodrigoASS,2168,30,1,2,3,33.3%,53m
38944,1,BringThePain,2168,40,1,4,5,20.0%,42m
38944,2,JBW,2168,48,1,6,7,14.3%,2h
38944,1,Vince,2168,0,1,7,8,12.5%,21m
38944,1,[LTDEST]Print,2168,0,0,1,1,0.0%,2h
38944,2,trantuvann,2168,0,0,3,3,0.0%,49m
38969,3,Linfocito,2167,1544,112,113,225,49.8%,2h
38969,1,Platano,2167,1602,63,62,125,50.4%,46m
38969,3,[2211th]WIFEsMAD,2167,506,20,31,51,39.2%,2h
38969,2,[SARGÇ]CapCaverna,2167,467,19,13,32,59.4%,51m
38969,2,Fudnut,2167,429,19,22,41,46.3%,46m
38969,1,YOOFY,2167,614,18,24,42,42.9%,2h
38969,1,Fenix,2167,404,15,11,26,57.7%,23m
38969,2,WAUWANT,2167,336,14,11,25,56.0%,23m
38969,2,Tributary,2167,340,14,12,26,53.8%,24m
38969,1,Bruce,2167,337,13,12,25,52.0%,2h
38969,2,JeremyEsq,2167,318,12,8,20,60.0%,2h
38969,2,DarkHadezs,2167,347,12,10,22,54.5%,2h
38969,3,[SCGals]Karen,2167,117,9,9,18,50.0%,9m
38969,2,extrapills,2167,193,7,6,13,53.8%,49m
38969,2,maadcx,2167,150,6,5,11,54.5%,47m
38969,2,NoobyNevie,2167,124,4,2,6,66.7%,2h
38969,2,Pheniox,2167,58,3,1,4,75.0%,2h
38969,3,Steezy,2167,58,3,9,12,25.0%,8m
38969,2,acount,2167,58,2,2,4,50.0%,45m
38969,2,ZerraM,2167,68,2,3,5,40.0%,2h
38969,2,Panhada,2167,0,1,0,1,100.0%,48m
38969,2,[phofu]tht,2167,0,1,2,3,33.3%,5m
38969,1,Agustin,2167,48,1,3,4,25.0%,27m
38969,1,Jeri,2167,0,1,3,4,25.0%,3m
38969,2,[Dozys]eduardoxl,2167,0,0,2,2,0.0%,2h
38969,2,Juggernaut,2167,0,0,5,5,0.0%,2h
38995,1,[BlTEL]christoff,2166,1306,45,48,93,48.4%,2h
38995,2,twoshoes,2166,1192,41,45,86,47.7%,2h
38995,1,SoSaltySoFU,2166,985,33,32,65,50.8%,41m
38995,1,templario,2166,404,27,20,47,57.4%,34m
38995,2,gustavo,2166,428,17,15,32,53.1%,2h
38995,1,banana,2166,485,16,19,35,45.7%,2h
38995,1,[SCS]TerranItUp,2166,519,16,19,35,45.7%,16m
38995,1,domdotdoom,2166,157,13,8,21,61.9%,46m
38995,1,TuxedoMask,2166,216,12,9,21,57.1%,54m
38995,1,Manox,2166,243,10,7,17,58.8%,26m
38995,1,[Natas]killajam,2166,271,8,12,20,40.0%,6m
38995,1,Disturbed,2166,286,7,14,21,33.3%,8m
38995,1,IIIIIIIIIIII,2166,0,3,3,6,50.0%,2h
38995,2,DAPC,2166,48,3,4,7,42.9%,43m
38995,2,BobLobLaw,2166,0,2,3,5,40.0%,2h
38995,2,Demonaz,2166,96,2,4,6,33.3%,2h
38995,2,Pyronite,2166,66,2,5,7,28.6%,2h
38995,1,edwin,2166,86,2,9,11,18.2%,2h
38995,2,eGirl,2166,0,1,0,1,100.0%,2h
38995,2,Pmz,2166,0,0,1,1,0.0%,34m
38995,1,vvv,2166,0,0,1,1,0.0%,21m
38995,2,dikbut,2166,0,0,2,2,0.0%,2h
38995,2,Zeratul,2166,0,0,2,2,0.0%,51m
38995,2,AegonV,2166,0,0,2,2,0.0%,2h
38995,1,HurpDaDerp,2166,0,0,3,3,0.0%,12m
39020,3,mastermas,2165,1555,646,675,1321,48.9%,34m
39020,1,PROTOTYPEVC,2165,1360,46,54,100,46.0%,2h
39020,3,Erwin,2165,821,31,34,65,47.7%,2h
39020,2,[AbcCo]Craysit,2165,775,30,30,60,50.0%,36m
39020,1,giogrande,2165,149,3,6,9,33.3%,46m
39020,2,LeSammer,2165,36,2,4,6,33.3%,37m
39020,1,Aaron,2165,48,2,7,9,22.2%,9m
39020,1,SYLSCORPS,2165,0,2,8,10,20.0%,3h
39020,2,Draco,2165,38,1,1,2,50.0%,45m
39020,1,[F4MILY]Frezko,2165,0,1,1,2,50.0%,2h
39020,2,Fjolnir,2165,40,1,5,6,16.7%,33m
39020,1,kakakapewpew,2165,0,1,5,6,16.7%,2h
39020,1,RpgII,2165,88,1,6,7,14.3%,2h
39020,2,[OGbudz]dopefish,2165,0,0,1,1,0.0%,2h
39020,1,Geraldus,2165,0,0,1,1,0.0%,9m
39020,1,Dibs,2165,0,0,2,2,0.0%,12m
39036,2,KnockOutKay,2164,1622,126,124,250,50.4%,39m
39036,1,Vince,2164,1642,92,88,180,51.1%,40m
39036,1,NoobSauce,2164,1201,44,41,85,51.8%,29m
39036,1,Suneater,2164,953,44,41,85,51.8%,3h
39036,2,AgentFlo,2164,1117,44,44,88,50.0%,35m
39036,2,jaimitoestre,2164,676,24,21,45,53.3%,2h
39036,2,Greattales,2164,726,24,28,52,46.2%,54m
39036,2,asdf,2164,370,12,20,32,37.5%,9m
39036,2,Agalisto,2164,316,12,21,33,36.4%,2h
39036,1,NahBruh,2164,308,8,14,22,36.4%,2h
39036,1,DeadlyMouse,2164,187,7,4,11,63.6%,11m
39036,2,Guerilla,2164,122,7,4,11,63.6%,2h
39036,2,stickyfingaz,2164,200,7,5,12,58.3%,2h
39036,2,JavierAM,2164,60,3,2,5,60.0%,45m
39036,1,[NUTTT]Steel,2164,96,3,5,8,37.5%,9m
39036,2,fernan,2164,73,2,9,11,18.2%,2h
39036,3,Cannonbolt,2164,95,1,8,9,11.1%,2h
39036,2,OneWinged,2164,0,0,2,2,0.0%,2h
39054,3,Cyberphunk,2163,1155,137,149,286,47.9%,16m
39054,1,Mefistos,2163,1680,83,85,168,49.4%,2m
39054,2,Devastador,2163,492,22,5,27,81.5%,3h
39054,3,Zeigfreid,2163,618,20,34,54,37.0%,2h
39054,1,blarg,2163,431,13,15,28,46.4%,16m
39054,1,BobDole,2163,150,7,13,20,35.0%,3m
39054,1,TheNobleSixx,2163,312,6,6,12,50.0%,2h
39054,1,[tagg]Retromojo,2163,209,5,8,13,38.5%,42m
39054,1,[WEIRD]Greeeeent,2163,164,4,4,8,50.0%,21m
39054,1,[SaWu]SagaNofx,2163,126,3,6,9,33.3%,2h
39054,2,TomaterBagel,2163,26,2,1,3,66.7%,2h
39054,2,HATE,2163,46,2,2,4,50.0%,25m
39054,2,[PTHero]Strygwyr,2163,0,1,0,1,100.0%,2h
39054,2,alolemur,2163,0,1,1,2,50.0%,31m
39054,2,FiriusTrixus,2163,30,1,3,4,25.0%,2h
39054,2,ratchet,2163,0,0,1,1,0.0%,2h
39054,2,Zelot,2163,0,0,1,1,0.0%,2h
39054,2,BLaZeDReaVeR,2163,0,0,3,3,0.0%,2h
39054,2,Yummybearr,2163,0,0,5,5,0.0%,13m
39054,1,[GpsyDg]Shadow,2163,0,0,6,6,0.0%,2h
39074,1,delaneyrose,2162,1367,55,56,111,49.5%,37m
39074,2,Cysco,2162,1171,50,49,99,50.5%,53m
39074,1,DanteDiego,2162,1229,43,41,84,51.2%,45m
39074,2,[BRobli]Tdestroyer,2162,633,38,44,82,46.3%,2h
39074,2,ZombieHunter,2162,748,33,16,49,67.3%,38m
39074,3,darcktaars,2162,615,23,30,53,43.4%,2h
39074,1,ByeFelicia,2162,602,18,23,41,43.9%,2h
39074,1,keenzapa,2162,451,16,21,37,43.2%,5m
39074,1,NullSpace,2162,384,11,37,48,22.9%,2h
39074,1,Rebuildfpv,2162,374,10,11,21,47.6%,39m
39074,1,[Rach]ATTACKCHILE,2162,209,8,7,15,53.3%,2h
39074,3,Binzl,2162,243,8,14,22,36.4%,2h
39074,2,cryonics,2162,266,8,17,25,32.0%,2h
39074,2,IsaacNewton,2162,266,8,17,25,32.0%,2h
39074,3,Raphael,2162,120,6,11,17,35.3%,8m
39074,3,Andromedus,2162,145,4,0,4,100.0%,2h
39074,1,poledog,2162,84,3,6,9,33.3%,2h
39074,1,DropSudden,2162,145,3,7,10,30.0%,2h
39074,2,LoboSalvaje,2162,46,1,3,4,25.0%,2h
39074,1,MFBach,2162,0,1,6,7,14.3%,2h
39074,2,fred,2162,0,0,1,1,0.0%,2h
39074,1,Arled,2162,0,0,1,1,0.0%,2h
39074,2,YLsIntoTanks,2162,0,0,1,1,0.0%,2h
39074,1,[HmlsMx]Markku,2162,0,0,2,2,0.0%,3h
39074,2,DustRolly,2162,0,0,2,2,0.0%,40m
39074,2,ToasterBomb,2162,0,0,2,2,0.0%,47m
39074,3,ArfanRDX,2162,0,0,4,4,0.0%,31m
39101,1,zlemin,2161,1776,355,436,791,44.9%,26m
39101,2,Pojar,2161,1256,77,98,175,44.0%,25m
39101,1,Magnunn,2161,1548,60,65,125,48.0%,2h
39101,1,NightCrawler,2161,782,34,30,64,53.1%,2h
39101,2,cesar,2161,886,34,34,68,50.0%,2h
39101,1,kingtyranias,2161,827,30,29,59,50.8%,41m
39101,1,kcaspa,2161,641,28,26,54,51.9%,3h
39101,1,fraN,2161,516,14,22,36,38.9%,45m
39101,2,eerick,2161,204,8,5,13,61.5%,2h
39101,1,Jnostrils,2161,236,8,11,19,42.1%,2h
39101,1,happyliar,2161,140,3,1,4,75.0%,44m
39101,2,Kabelo,2161,34,1,1,2,50.0%,2h
39101,1,[Libra]Jerry,2161,0,1,1,2,50.0%,2h
39101,2,InPuls,2161,48,1,2,3,33.3%,2h
39101,1,AkiSukan,2161,0,1,6,7,14.3%,2h
39101,1,[QaCo]Daniel,2161,0,0,1,1,0.0%,30m
39101,2,lindo,2161,0,0,1,1,0.0%,41m
39101,1,Danymok,2161,0,0,1,1,0.0%,2h
39101,2,Elodin,2161,0,0,5,5,0.0%,2h
39101,2,Sislix,2161,0,0,6,6,0.0%,49m
39121,2,MasterCow,2160,1583,77,72,149,51.7%,24m
39121,1,EchoShib,2160,678,24,22,46,52.2%,5m
39121,1,KingLeorick,2160,371,18,20,38,47.4%,23m
39121,2,[XpKAc]Nando,2160,454,17,17,34,50.0%,2h
39121,1,Mamba,2160,291,10,10,20,50.0%,29m
39121,1,pichulatigo,2160,292,9,8,17,52.9%,3h
39121,2,SpeedKills,2160,124,7,5,12,58.3%,2h
39121,1,[Huffs]craft,2160,191,6,7,13,46.2%,2h
39121,3,boneyard,2160,173,6,11,17,35.3%,40m
39121,1,[BUKÉ]CHOROEPUENTE,2160,48,2,0,2,100.0%,28m
39121,2,sipahmagic,2160,68,2,3,5,40.0%,35m
39121,1,[SMCE]CubixTale,2160,48,2,3,5,40.0%,2h
39121,1,llllllllllll,2160,111,2,7,9,22.2%,40m
39121,2,lightning,2160,30,1,1,2,50.0%,2h
39121,2,[Pro999]Maxi,2160,0,0,1,1,0.0%,53m
39121,3,HeLLeX,2160,0,0,1,1,0.0%,4m
39121,1,Thunderpain,2160,0,0,1,1,0.0%,50m
39121,1,TheRavager,2160,0,0,4,4,0.0%,2h
39121,1,Swam,2160,0,0,4,4,0.0%,53m
39140,1,GreGore,2159,1769,227,234,461,49.2%,3h
39140,3,mawis,2159,1569,157,165,322,48.8%,2h
39140,1,InfectedSoul,2159,1651,140,145,285,49.1%,2h
39140,2,MonkeyNOSOT,2159,1083,137,137,274,50.0%,2h
39140,1,cheenda,2159,1388,86,90,176,48.9%,52m
39140,1,Nothomb,2159,1724,72,74,146,49.3%,29m
39140,1,Diamond,2159,928,36,28,64,56.2%,2h
39140,1,[WINR]Aersling,2159,340,33,32,65,50.8%,46m
39140,1,Coneylake,2159,885,30,36,66,45.5%,40m
39140,1,RaithWrath,2159,656,23,29,52,44.2%,2h
39140,1,BaToLoKOO,2159,524,15,23,38,39.5%,2h
39140,2,Xyz,2159,405,14,15,29,48.3%,40m
39140,2,liluzihurt,2159,301,11,12,23,47.8%,24m
39140,1,IOZettabytes,2159,312,9,17,26,34.6%,15m
39140,1,Doctaaaa,2159,150,6,9,15,40.0%,3h
39140,1,Acer,2159,194,6,11,17,35.3%,42m
39140,1,[LMT]Maharba,2159,162,5,11,16,31.2%,40m
39140,2,[TheDOH]Rodrigo,2159,66,3,4,7,42.9%,2h
39140,2,junborg,2159,34,2,2,4,50.0%,20m
39140,2,CrabJuice,2159,46,2,5,7,28.6%,2h
39140,2,Ghost,2159,62,2,7,9,22.2%,2m
39140,2,Kirk,2159,0,1,3,4,25.0%,49m
39140,2,tanKing,2159,30,1,5,6,16.7%,2h
39140,2,Elric,2159,0,0,5,5,0.0%,2h
39164,2,larryflins,2158,1466,115,123,238,48.3%,2h
39164,1,Lochutus,2158,1084,104,118,222,46.8%,47m
39164,2,SneakySnack,2158,966,40,33,73,54.8%,2h
39164,1,LivinThDream,2158,550,36,40,76,47.4%,2h
39164,1,xxMYMANxX,2158,497,17,20,37,45.9%,2h
39164,1,Roxic,2158,497,17,21,38,44.7%,2h
39164,2,[PbFtCb]creamygummie,2158,504,17,22,39,43.6%,2h
39164,3,DiMarco,2158,329,11,19,30,36.7%,2h
39164,2,frijotri,2158,279,10,16,26,38.5%,49m
39164,1,LGgaming,2158,319,9,11,20,45.0%,2h
39164,3,Polvoron,2158,230,7,13,20,35.0%,2h
39164,3,TheONC,2158,189,6,9,15,40.0%,17m
39164,1,Tankermp,2158,283,5,8,13,38.5%,35m
39164,2,[SCUNI2]PablitoFIQT,2158,98,4,4,8,50.0%,2h
39164,2,leoonell,2158,114,3,6,9,33.3%,38m
39164,2,Gregornot,2158,46,2,2,4,50.0%,3h
39164,1,Esnipea,2158,144,2,3,5,40.0%,2h
39164,2,meridian,2158,0,1,0,1,100.0%,2h
39164,2,maro,2158,0,1,1,2,50.0%,2h
39164,1,Ranchu,2158,48,1,6,7,14.3%,2h
39164,2,[hTx]Star,2158,0,0,1,1,0.0%,2h
39164,2,Carlos,2158,0,0,3,3,0.0%,46m
39164,2,whenurbored,2158,0,0,5,5,0.0%,31m
39164,1,Vultron,2158,0,0,9,9,0.0%,45m
39188,1,iamnoobplz,2157,1633,62,62,124,50.0%,2h
39188,1,awesOme,2157,1235,50,47,97,51.5%,2h
39188,2,CRISTIAN,2157,624,24,26,50,48.0%,3m
39188,1,ubixxx,2157,701,24,33,57,42.1%,2h
39188,1,GIBED,2157,622,19,20,39,48.7%,2h
39188,1,Banister,2157,534,17,19,36,47.2%,2h
39188,1,TonyMarkov,2157,338,13,9,22,59.1%,12m
39188,2,Morbius,2157,416,12,16,28,42.9%,43m
39188,1,Panico,2157,274,9,28,37,24.3%,7m
39188,2,Remlique,2157,273,8,14,22,36.4%,38m
39188,2,voidleecher,2157,234,7,10,17,41.2%,35m
39188,2,[ggUNlT]BlackMesaINC,2157,265,7,18,25,28.0%,2h
39188,2,MRkc,2157,186,6,12,18,33.3%,46m
39188,3,Afterdeath,2157,173,5,7,12,41.7%,41m
39188,1,Gundam,2157,145,4,7,11,36.4%,2h
39188,1,KernoInferno,2157,134,4,8,12,33.3%,17m
39188,1,[SCYT]Goulz,2157,165,3,9,12,25.0%,5m
39188,2,RickyC,2157,66,2,1,3,66.7%,3h
39188,1,Boxer,2157,115,2,6,8,25.0%,52m
39188,3,Brenzdman,2157,0,1,0,1,100.0%,2h
39188,1,Rimogard,2157,88,1,3,4,25.0%,54m
39188,1,Orangutans,2157,0,1,4,5,20.0%,2h
39188,2,GhostFace,2157,48,1,6,7,14.3%,52m
39188,2,mercrack,2157,0,0,1,1,0.0%,20m
39188,2,Adama,2157,0,0,2,2,0.0%,22m
39188,1,Dahl,2157,0,0,2,2,0.0%,29m
39188,2,patitobad,2157,0,0,6,6,0.0%,5m
39215,3,txing,2156,1395,481,512,993,48.4%,38m
39215,2,sgillen,2156,1273,58,48,106,54.7%,2h
39215,2,[10th]Badazz,2156,1326,48,49,97,49.5%,2h
39215,2,DrazzilB,2156,875,47,42,89,52.8%,36m
39215,2,HADES,2156,699,36,34,70,51.4%,13m
39215,2,jindacool,2156,846,31,30,61,50.8%,2h
39215,2,Video,2156,544,20,13,33,60.6%,2h
39215,2,PedrixWizard,2156,426,16,11,27,59.3%,43m
39215,2,[z2o]Vissionking,2156,394,15,9,24,62.5%,2h
39215,3,melkor,2156,252,12,17,29,41.4%,16m
39215,2,COVIDtheBarb,2156,236,9,17,26,34.6%,24m
39215,1,Tiago,2156,193,7,9,16,43.8%,2h
39215,2,[1v1me]SCUnicorn,2156,182,6,3,9,66.7%,2h
39215,2,ILiveForAiur,2156,148,5,7,12,41.7%,2h
39215,2,SayNoToStim,2156,162,5,8,13,38.5%,2h
39215,1,SINS,2156,166,5,10,15,33.3%,46m
39215,1,samurobot,2156,138,4,4,8,50.0%,27m
39215,1,Paulyolyoly,2156,30,3,5,8,37.5%,16m
39215,1,SlappyGJ,2156,100,3,10,13,23.1%,2h
39215,2,Hoso,2156,0,2,7,9,22.2%,2h
39215,2,HiEveryBady,2156,0,1,0,1,100.0%,31m
39215,3,Tritiont,2156,0,1,2,3,33.3%,45m
39215,2,benja,2156,32,1,3,4,25.0%,2h
39215,1,Artanis,2156,0,1,4,5,20.0%,38m
39215,1,jazz,2156,0,1,7,8,12.5%,2h
39215,2,Radius,2156,0,0,1,1,0.0%,2h
39215,2,viper,2156,0,0,5,5,0.0%,23m
39242,1,Jard,2155,1630,96,86,182,52.7%,2h
39242,1,JoseTalara,2155,1197,94,90,184,51.1%,38m
39242,2,chillhop,2155,1424,87,82,169,51.5%,2h
39242,1,[Axioms]Atzin,2155,999,68,67,135,50.4%,2h
39242,2,Raseri,2155,1624,68,69,137,49.6%,47m
39242,1,[Domare]SeanJohn,2155,1429,50,56,106,47.2%,41m
39242,1,Crake,2155,1230,43,50,93,46.2%,26m
39242,2,[GALL0S]Morrik,2155,830,39,30,69,56.5%,2h
39242,2,dumbo,2155,376,13,10,23,56.5%,2h
39242,1,Yed,2155,232,6,12,18,33.3%,2h
39242,2,morgal,2155,160,5,6,11,45.5%,2h
39242,2,[PotE]Camzz,2155,68,2,1,3,66.7%,13m
39242,1,Obelisk,2155,145,2,3,5,40.0%,43m
39242,2,ccc,2155,0,1,0,1,100.0%,2h
39242,2,FoxSpark,2155,40,1,1,2,50.0%,2h
39242,2,superman,2155,0,1,4,5,20.0%,2h
39242,1,Shadakur,2155,0,1,5,6,16.7%,14m
39242,2,zerg,2155,0,0,1,1,0.0%,2h
39242,1,Xenon,2155,0,0,1,1,0.0%,2h
39261,1,[UG15]MichaelUG,2154,481,133,118,251,53.0%,2h
39261,1,Viper,2154,1174,39,44,83,47.0%,35m
39261,1,zyklonb,2154,1145,37,40,77,48.1%,40m
39261,1,[tutin]eldaju,2154,652,19,21,40,47.5%,2h
39261,1,DarkoZ,2154,539,17,20,37,45.9%,2h
39261,1,Kongo,2154,536,15,20,35,42.9%,52m
39261,3,Gotenks,2154,402,13,20,33,39.4%,2h
39261,1,BorrySmell,2154,256,8,8,16,50.0%,2h
39261,1,visiones,2154,164,5,6,11,45.5%,15m
39261,1,[BrUtO]Francois,2154,172,4,7,11,36.4%,2h
39261,3,Grymkhaos,2154,148,3,2,5,60.0%,2h
39261,2,[72o]parkgoons,2154,76,2,5,7,28.6%,2h
39261,2,BlooDArerbaC,2154,0,1,1,2,50.0%,30m
39261,1,[Omadin]YourMudder,2154,48,1,2,3,33.3%,2h
39261,2,Paupl,2154,30,1,3,4,25.0%,21m
39261,2,Frostpyrite,2154,0,1,4,5,20.0%,14m
39261,1,Leielo,2154,0,1,5,6,16.7%,2h
39261,1,firepiro,2154,0,1,5,6,16.7%,2h
39261,2,Jonny,2154,0,0,1,1,0.0%,2h
39261,2,Natram,2154,0,0,1,1,0.0%,45m
39261,2,Vaalmyrth,2154,0,0,1,1,0.0%,2h
39261,1,Ace,2154,0,0,3,3,0.0%,11m
39261,2,Undertow,2154,0,0,3,3,0.0%,3h
39284,1,Yeshua,2153,1750,173,186,359,48.2%,2h
39284,3,Dionysus,2153,1555,91,104,195,46.7%,2h
39284,1,notstupid,2153,743,58,50,108,53.7%,2h
39284,1,langostino,2153,1011,57,50,107,53.3%,2h
39284,3,Hannibal,2153,255,50,49,99,50.5%,2h
39284,1,lart,2153,1154,43,47,90,47.8%,47m
39284,1,SQBITO,2153,857,39,33,72,54.2%,15m
39284,2,Thatguy,2153,557,32,38,70,45.7%,45m
39284,1,alibaba,2153,914,29,32,61,47.5%,3h
39284,1,Jitano,2153,454,22,21,43,51.2%,2h
39284,1,Krlitos,2153,343,17,18,35,48.6%,2h
39284,2,Whirlwind,2153,402,14,14,28,50.0%,24m
39284,2,[SDB2]Yibi,2153,368,11,13,24,45.8%,2h
39284,1,littycomitee,2153,304,10,12,22,45.5%,7m
39284,1,ACE,2153,289,9,12,21,42.9%,2h
39284,1,[GSP0T]MrPoopyButt,2153,254,7,10,17,41.2%,46m
39284,1,FATBASTURD,2153,101,5,12,17,29.4%,44m
39284,2,Sentinel,2153,167,5,13,18,27.8%,2h
39284,2,AngryDude,2153,58,3,6,9,33.3%,2h
39284,2,Vodafone,2153,0,1,0,1,100.0%,5m
39284,2,Zues,2153,30,1,1,2,50.0%,2h
39284,2,Kroniclez,2153,0,1,5,6,16.7%,41m
39284,3,FeNoM,2153,30,1,6,7,14.3%,40m
39284,2,JaVa,2153,0,0,1,1,0.0%,2h
39308,2,llllllllllll,2152,1161,267,308,575,46.4%,3h
39308,3,DACASHOES,2152,1498,129,135,264,48.9%,28m
39308,1,Ferro,2152,817,32,42,74,43.2%,53m
39308,2,EINAR,2152,512,18,17,35,51.4%,2h
39308,1,pablex,2152,451,15,15,30,50.0%,42m
39308,2,[xLCx]Shuru,2152,330,10,10,20,50.0%,3h
39308,1,[TCHNO]Octopuss,2152,279,10,10,20,50.0%,2h
39308,1,Striker,2152,326,10,17,27,37.0%,2h
39308,3,[NPCss]Flamenco,2152,240,8,15,23,34.8%,2h
39308,1,Paclord,2152,169,6,5,11,54.5%,2h
39308,1,JHCARAJOXD,2152,42,4,5,9,44.4%,2h
39308,1,DaTastyNinja,2152,166,3,4,7,42.9%,2h
39308,1,musgo,2152,80,3,9,12,25.0%,2h
39308,3,AaronWar,2152,121,3,9,12,25.0%,15m
39308,2,NBDad,2152,0,1,2,3,33.3%,39m
39308,2,Pontey,2152,30,1,2,3,33.3%,2h
39308,1,GhostNuke,2152,48,1,5,6,16.7%,2h
39308,1,Javier,2152,0,1,6,7,14.3%,2h
39308,1,photer,2152,0,0,2,2,0.0%,27m
39308,2,YoonA,2152,0,0,5,5,0.0%,2h
39328,1,darktalker,2151,1665,69,81,150,46.0%,2h
39328,2,Kronix,2151,650,29,33,62,46.8%,45m
39328,1,[LMI42]jughand,2151,526,27,27,54,50.0%,42m
39328,2,Rocher,2151,571,23,27,50,46.0%,36m
39328,1,Infrared,2151,240,7,10,17,41.2%,45m
39328,2,TMMPWNSTAR,2151,114,5,1,6,83.3%,2h
39328,2,Joefenix,2151,170,5,7,12,41.7%,2h
39328,2,Spectre,2151,86,3,1,4,75.0%,47m
39328,2,pog,2151,30,3,4,7,42.9%,2h
39328,2,Shazam,2151,62,2,2,4,50.0%,2h
39328,1,Riellic,2151,121,2,7,9,22.2%,29m
39328,2,ZERG,2151,0,1,4,5,20.0%,23m
39328,1,faker,2151,0,0,3,3,0.0%,2h
39328,3,Indomie,2151,0,0,4,4,0.0%,41m
39342,1,perezningle,2150,1720,127,140,267,47.6%,3h
39342,2,zGUNDAMz,2150,1236,47,48,95,49.5%,32m
39342,3,Parky,2150,644,25,33,58,43.1%,32m
39342,2,gonzalo,2150,644,23,35,58,39.7%,36m
39342,2,[MMSTAR]tommyrod,2150,576,22,17,39,56.4%,2h
39342,1,AztecMexico,2150,654,19,21,40,47.5%,7m
39342,2,FIRSTCANNON,2150,446,16,13,29,55.2%,2h
39342,1,Farquaad,2150,175,15,8,23,65.2%,2h
39342,2,GATYUJI,2150,312,11,7,18,61.1%,45m
39342,1,seerfax,2150,380,10,18,28,35.7%,2h
39342,2,praz,2150,158,6,4,10,60.0%,32m
39342,1,CharlesZzz,2150,144,6,5,11,54.5%,21m
39342,1,SuperStrats,2150,182,6,8,14,42.9%,9m
39342,1,[ØFoxF2]Paulina,2150,188,6,9,15,40.0%,42m
39342,1,zion,2150,154,6,11,17,35.3%,2h
39342,2,SummerRiver,2150,130,5,1,6,83.3%,2h
39342,2,[MaxWin]Hardlock,2150,132,5,4,9,55.6%,46m
39342,2,Fone,2150,90,4,2,6,66.7%,2h
39342,2,AioSly,2150,160,4,6,10,40.0%,2h
39342,2,MNSWH,2150,70,3,0,3,100.0%,48m
39342,3,DIVAIO,2150,121,3,4,7,42.9%,2h
39342,2,Krysis,2150,66,3,4,7,42.9%,2h
39342,1,jimi,2150,96,2,3,5,40.0%,2h
39342,1,seemseemo,2150,48,2,7,9,22.2%,2h
39342,2,[xABQx]Lukas,2150,0,1,0,1,100.0%,40m
39342,2,death,2150,94,1,3,4,25.0%,45m
39342,1,Hotpants,2150,0,1,6,7,14.3%,2h
39342,1,drbarnes,2150,0,1,6,7,14.3%,2h
39342,1,PapaRemus,2150,0,1,7,8,12.5%,2h
39342,2,Drewzy,2150,0,0,1,1,0.0%,20m
39342,2,BOMBSHELL,2150,0,0,5,5,0.0%,2h
39373,1,[GrnBrd]Quadrivium,2149,1649,69,56,125,55.2%,16m
39373,2,Jocasato,2149,1164,62,56,118,52.5%,5m
39373,1,[DILIH]Galaxyghost,2149,656,28,17,45,62.2%,2h
39373,2,DenilsonProo,2149,686,28,24,52,53.8%,2h
39373,1,[RePts]Bentastic,2149,467,22,15,37,59.5%,26m
39373,1,IceFox,2149,437,19,20,39,48.7%,2h
39373,1,Eskiman,2149,436,18,15,33,54.5%,2h
39373,3,piero,2149,477,16,22,38,42.1%,32m
39373,2,JOTARO,2149,327,12,13,25,48.0%,2h
39373,2,ExodialBP,2149,356,12,14,26,46.2%,2h
39373,2,Gary,2149,316,11,9,20,55.0%,2h
39373,1,BirdyVoyage,2149,176,4,6,10,40.0%,16m
39373,2,Skazzy,2149,64,3,0,3,100.0%,2h
39373,2,crimsonkid,2149,66,3,3,6,50.0%,37m
39373,1,[AxiomN]IcyRelic,2149,0,3,3,6,50.0%,54m
39373,2,Dose,2149,44,2,0,2,100.0%,36m
39373,1,HECTOR,2149,89,2,2,4,50.0%,40m
39373,2,dolphiknight,2149,0,1,0,1,100.0%,2h
39373,1,SrStudMuffin,2149,0,1,1,2,50.0%,2h
39373,1,SirSpender,2149,48,1,3,4,25.0%,2h
39373,2,BMACDADDY,2149,0,1,4,5,20.0%,2h
39373,1,Aidan,2149,0,1,5,6,16.7%,11m
39373,1,Mathi,2149,0,1,7,8,12.5%,2h
39373,2,lite,2149,0,1,10,11,9.1%,2h
39373,1,IlIlIIlI,2149,0,0,1,1,0.0%,52m
39373,2,[SACHA]Ferjah,2149,0,0,1,1,0.0%,2h
39373,2,DarkDragon,2149,0,0,1,1,0.0%,2h
39373,2,Chespirito,2149,0,0,5,5,0.0%,45m
39401,3,KingofCheese,2148,1471,486,504,990,49.1%,2h
39401,1,DarkStar,2148,1717,288,296,584,49.3%,2h
39401,1,HughMan,2148,1750,214,218,432,49.5%,23m
39401,3,woi,2148,834,105,101,206,51.0%,28m
39401,1,Chaos,2148,1528,62,54,116,53.4%,9m
39401,1,[A1312]entropia,2148,750,27,26,53,50.9%,2h
39401,1,FartinG,2148,755,26,24,50,52.0%,26m
39401,2,papitafrita,2148,426,17,14,31,54.8%,39m
39401,2,Serxus,2148,330,11,12,23,47.8%,39m
39401,2,[jajas]DAXYJOSU,2148,272,10,5,15,66.7%,2h
39401,2,bob,2148,244,10,11,21,47.6%,39m
39401,1,lich,2148,365,10,12,22,45.5%,2h
39401,1,Macloud,2148,269,9,13,22,40.9%,2h
39401,1,AndreyB,2148,260,8,19,27,29.6%,12m
39401,1,ceetabhero,2148,208,6,8,14,42.9%,2h
39401,1,Jorge,2148,194,5,7,12,41.7%,17m
39401,1,roboticFunk,2148,174,5,8,13,38.5%,36m
39401,2,what,2148,156,4,2,6,66.7%,2h
39401,2,gruntstar,2148,169,4,8,12,33.3%,54m
39401,1,SanTisimo,2148,118,4,9,13,30.8%,52m
39401,1,Merith,2148,48,2,3,5,40.0%,10m
39401,2,Rowey,2148,46,2,6,8,25.0%,2h
39401,1,exidas,2148,96,1,2,3,33.3%,30m
39401,1,ElViejoRoshi,2148,0,1,6,7,14.3%,2h
39401,2,[ExcIgN]ferand,2148,48,1,7,8,12.5%,3h
39401,2,Kevin,2148,0,0,1,1,0.0%,33m
39401,2,DarkStar,2148,0,0,2,2,0.0%,53m
39401,1,Kurogane,2148,0,0,4,4,0.0%,2h
39401,1,Gimli,2148,0,0,8,8,0.0%,2h
39430,1,Zeratul,2147,1734,217,217,434,50.0%,2h
39430,1,[nieBla]JECS,2147,1617,171,175,346,49.4%,3m
39430,1,Oscar,2147,1150,38,49,87,43.7%,16m
39430,2,PROPRO,2147,539,24,12,36,66.7%,23m
39430,3,shinigami,2147,402,13,20,33,39.4%,8m
39430,2,koop,2147,144,4,7,11,36.4%,2h
39430,1,jimmydo,2147,144,4,7,11,36.4%,51m
39430,1,[SKGS]Elydan,2147,148,4,12,16,25.0%,2h
39430,2,ItsBrayBray,2147,112,3,2,5,60.0%,31m
39430,1,LeAcH,2147,0,3,4,7,42.9%,21m
39430,1,[LQua]SupplyBlock,2147,120,3,4,7,42.9%,29m
39430,1,QuarterLife,2147,96,3,9,12,25.0%,48m
39430,1,alle,2147,118,3,10,13,23.1%,3m
39430,2,MushroomCake,2147,90,2,3,5,40.0%,2h
39430,1,Ciel,2147,70,2,4,6,33.3%,14m
39430,2,slunky,2147,0,1,0,1,100.0%,2h
39430,1,Sonrie,2147,88,1,2,3,33.3%,16m
39430,2,Diego,2147,0,1,5,6,16.7%,2h
39430,2,Mrpig,2147,0,1,5,6,16.7%,49m
39430,2,[ZTempz]belhieg,2147,30,1,6,7,14.3%,2h
39430,2,TheRock,2147,93,1,7,8,12.5%,45m
39430,2,BabyJay,2147,0,0,1,1,0.0%,2h
39452,1,[cluez]kramos,2146,524,39,44,83,47.0%,2h
39452,1,[SM0K3]RockyDodo,2146,1034,37,48,85,43.5%,2h
39452,2,[xRI]Moazzam,2146,675,35,24,59,59.3%,2h
39452,1,[4g63]Anomaly,2146,1002,33,35,68,48.5%,6m
39452,1,[KG73]AlexThor,2146,712,30,27,57,52.6%,2h
39452,2,[SBlock]Vergara,2146,577,22,14,36,61.1%,2h
39452,2,Neyen,2146,408,14,14,28,50.0%,2h
39452,2,fauxeuphoria,2146,328,12,8,20,60.0%,39m
39452,2,[EDGEz]Treefitty,2146,240,8,10,18,44.4%,2h
39452,1,[ICHIGO]kiniro,2146,171,7,10,17,41.2%,23m
39452,1,GLÜCKSTOD,2146,246,7,11,18,38.9%,16m
39452,1,FSDRKSLDR,2146,248,6,11,17,35.3%,24m
39452,2,Jukestar,2146,139,4,4,8,50.0%,2h
39452,1,cecig,2146,145,3,3,6,50.0%,3h
39452,2,DredlokShado,2146,48,2,6,8,25.0%,52m
39452,1,JPMAC,2146,36,2,7,9,22.2%,2h
39452,2,[diaman]takuH,2146,0,1,0,1,100.0%,49m
39452,1,[IF]Paul,2146,0,1,4,5,20.0%,55m
39452,2,[PANTER]ErickLopez,2146,0,0,1,1,0.0%,2h
39471,1,ChristianMZ,2145,1664,114,117,231,49.4%,37m
39471,1,eric,2145,1436,52,62,114,45.6%,2h
39471,1,Steelwind,2145,800,36,44,80,45.0%,27m
39471,2,BlackWolf,2145,534,20,15,35,57.1%,43m
39471,2,[GiLLs]JawnDope,2145,441,17,16,33,51.5%,2h
39471,1,[HD7K]mauricio,2145,400,14,14,28,50.0%,2h
39471,2,jmpshotjezus,2145,214,11,7,18,61.1%,2h
39471,2,Chan,2145,242,10,17,27,37.0%,2h
39471,1,Joseph,2145,151,6,11,17,35.3%,46m
39471,2,[iTRY]SpawSafy,2145,206,5,5,10,50.0%,51m
39471,1,[MadMON]MELEKAIJOE,2145,194,5,11,16,31.2%,45m
39471,1,Dmoney,2145,142,4,8,12,33.3%,17m
39471,2,DirkaDirka,2145,90,3,2,5,60.0%,50m
39471,2,[FL1P]MrAndersen,2145,38,2,2,4,50.0%,46m
39471,2,KAi,2145,0,1,0,1,100.0%,13m
39471,2,Whitestriker,2145,30,1,1,2,50.0%,45m
39471,1,[Zulu]Slabba,2145,97,1,3,4,25.0%,2h
39471,1,StonedTick,2145,36,1,4,5,20.0%,2h
39471,2,[ETAB]kaotik,2145,0,0,5,5,0.0%,2h
39490,3,SaburNahur,2144,1246,248,250,498,49.8%,3h
39490,1,adib,2144,1608,93,105,198,47.0%,53m
39490,1,LGTheBlue,2144,845,30,36,66,45.5%,11m
39490,1,MoonCheese,2144,734,29,34,63,46.0%,54m
39490,1,Aniki,2144,639,19,30,49,38.8%,38m
39490,2,[XPARTA]SUPERBADBOY,2144,535,18,19,37,48.6%,5m
39490,2,saaantaaaa,2144,498,18,22,40,45.0%,2h
39490,2,[ICTH]lol,2144,340,13,8,21,61.9%,2h
39490,2,FOKINI,2144,218,11,15,26,42.3%,32m
39490,1,kinoks,2144,261,8,12,20,40.0%,54m
39490,1,DIEFLIEGE,2144,260,7,14,21,33.3%,2h
39490,3,NatorNZ,2144,222,7,14,21,33.3%,2h
39490,1,lilililliili,2144,150,6,10,16,37.5%,12m
39490,2,Georges,2144,164,5,2,7,71.4%,2h
39490,2,Parzivle,2144,90,3,2,5,60.0%,2h
39490,3,Malbis,2144,121,3,4,7,42.9%,18m
39490,1,AleZaR,2144,48,2,10,12,16.7%,2h
39490,2,wubwub,2144,0,1,0,1,100.0%,2h
39490,1,prjkt,2144,0,1,1,2,50.0%,28m
39490,2,albert,2144,30,1,1,2,50.0%,2m
39490,1,OMEGA,2144,0,1,6,7,14.3%,2h
39490,3,DisasterDog,2144,42,1,7,8,12.5%,2h
39490,2,[ApmTen]Bronze,2144,0,0,1,1,0.0%,2h
39490,2,[dede]Mueksi,2144,0,0,1,1,0.0%,2h
39490,2,daabuzzkill,2144,0,0,2,2,0.0%,43m
39515,1,Silent,2143,1538,92,91,183,50.3%,40m
39515,2,Bonin,2143,982,60,41,101,59.4%,2h
39515,2,OnlyIring,2143,839,31,32,63,49.2%,48m
39515,1,PUFF,2143,438,29,31,60,48.3%,2h
39515,1,IAmcompLEX,2143,608,20,25,45,44.4%,54m
39515,1,Rony,2143,650,19,31,50,38.0%,2h
39515,1,ColdFire,2143,347,12,18,30,40.0%,12m
39515,1,Darquess,2143,352,11,22,33,33.3%,2h
39515,2,Anyeld,2143,280,10,5,15,66.7%,2h
39515,2,YEET,2143,272,9,12,21,42.9%,2h
39515,1,LOS,2143,306,9,18,27,33.3%,37m
39515,2,CORONEL,2143,244,8,7,15,53.3%,2h
39515,2,Darius,2143,243,7,8,15,46.7%,27m
39515,1,badguy,2143,169,6,4,10,60.0%,16m
39515,3,Jarontizzle,2143,196,6,12,18,33.3%,2h
39515,2,[OVRSOC]FolkRebel,2143,146,4,2,6,66.7%,2h
39515,2,chungus,2143,46,4,3,7,57.1%,2h
39515,2,Saintxanos,2143,134,4,7,11,36.4%,2h
39515,1,Lokotocho,2143,129,4,10,14,28.6%,2h
39515,1,Blade,2143,90,3,9,12,25.0%,2h
39515,2,kian,2143,32,2,1,3,66.7%,47m
39515,2,[STUB]juggalotis,2143,30,2,4,6,33.3%,23m
39515,1,HeRages,2143,48,2,7,9,22.2%,28m
39515,2,[AwnAwn]Romero,2143,0,1,0,1,100.0%,2m
39515,2,chochy,2143,0,1,3,4,25.0%,2h
39515,3,Benjinaro,2143,30,1,5,6,16.7%,45m
39515,1,ender,2143,0,1,6,7,14.3%,24m
39515,2,Carlomagno,2143,48,1,6,7,14.3%,2h
39515,2,ItzRedinator,2143,0,0,1,1,0.0%,2h
39515,2,Raffi,2143,0,0,1,1,0.0%,2h
39515,2,nickls,2143,0,0,2,2,0.0%,2h
39546,1,marchef,2142,1700,112,118,230,48.7%,6m
39546,2,Telan,2142,1200,57,68,125,45.6%,13m
39546,2,[L3GI0N]Apocalyptic,2142,436,16,13,29,55.2%,38m
39546,2,[Um2]UmDoisSnake,2142,364,14,9,23,60.9%,20m
39546,2,grimey,2142,308,10,17,27,37.0%,2h
39546,2,IvanLucas,2142,218,7,7,14,50.0%,31m
39546,1,[Stinkr]vvvvvvvvanz,2142,164,7,16,23,30.4%,19m
39546,2,kacique,2142,66,2,5,7,28.6%,20m
39546,2,JakeDaRipper,2142,138,2,5,7,28.6%,33m
39546,2,Wolfie,2142,88,1,5,6,16.7%,2h
39546,2,lethor,2142,0,0,1,1,0.0%,2h
39546,2,are,2142,0,0,5,5,0.0%,41m
39546,2,Arcavid,2142,0,0,5,5,0.0%,2h
39559,2,[GDKND]Jyphype,2141,1638,74,72,146,50.7%,37m
39559,1,Ashkael,2141,1529,67,75,142,47.2%,2m
39559,2,Bruno,2141,833,35,30,65,53.8%,47m
39559,1,Joseiza,2141,1054,33,42,75,44.0%,3h
39559,2,OGdokie,2141,698,25,29,54,46.3%,2h
39559,1,GRAVES,2141,718,25,41,66,37.9%,2h
39559,1,RattMoth,2141,367,10,17,27,37.0%,2h
39559,3,[YD2K]Zebregts,2141,275,9,15,24,37.5%,2h
39559,1,Champshot,2141,36,2,5,7,28.6%,2h
39559,2,TOC,2141,92,2,11,13,15.4%,51m
39559,2,TheHolliday,2141,32,1,2,3,33.3%,2h
39559,2,MPT,2141,0,1,2,3,33.3%,35m
39559,1,James,2141,36,1,5,6,16.7%,41m
39559,2,[Wehavu]Qetzc,2141,0,0,1,1,0.0%,2h
39559,2,IIIIIIIIIIII,2141,0,0,1,1,0.0%,2h
39559,2,Zidjian,2141,0,0,2,2,0.0%,5m
39559,2,KabroSias,2141,0,0,3,3,0.0%,2h
39559,2,[yourit]budweiser,2141,0,0,5,5,0.0%,2h
39577,1,dopehat,2140,669,29,22,51,56.9%,2h
39577,2,aRcHaNgEl,2140,603,24,22,46,52.2%,2h
39577,3,YBTC,2140,562,19,27,46,41.3%,3h
39577,2,[zerg9]zergDJ,2140,547,17,25,42,40.5%,2m
39577,2,Indistrol,2140,408,16,8,24,66.7%,21m
39577,1,Hyun,2140,418,14,18,32,43.8%,2h
39577,1,Tristan,2140,388,13,13,26,50.0%,2h
39577,1,XYZrd,2140,340,12,18,30,40.0%,47m
39577,2,RoadToPlaty,2140,270,10,8,18,55.6%,2h
39577,1,dilanquijije,2140,256,10,9,19,52.6%,26m
39577,2,Wolverine,2140,284,9,4,13,69.2%,5m
39577,2,PandreReis,2140,272,9,9,18,50.0%,2h
39577,2,EnderFrigins,2140,164,5,7,12,41.7%,2h
39577,2,VerdusPrime,2140,0,4,1,5,80.0%,5m
39577,2,MrNoisy,2140,76,3,2,5,60.0%,47m
39577,2,DuneRunner,2140,135,3,7,10,30.0%,2h
39577,1,PANDASALVAJE,2140,44,2,5,7,28.6%,53m
39577,1,Gabrielltdb,2140,48,2,7,9,22.2%,2h
39577,2,MCHamster,2140,0,1,0,1,100.0%,2h
39577,1,omarhnat,2140,48,1,1,2,50.0%,2h
39577,1,Zanzibar,2140,0,1,3,4,25.0%,26m
39577,1,outage,2140,0,1,6,7,14.3%,2h
39577,2,TOMYUMKUNG,2140,0,0,2,2,0.0%,2h
39577,2,Caligula,2140,0,0,3,3,0.0%,2h
39577,2,[nGx]TotalWar,2140,0,0,5,5,0.0%,49m
39577,2,[bsDg]DatNuNu,2140,0,0,5,5,0.0%,2h
39577,1,Qzalik,2140,0,0,14,14,0.0%,2h
39604,3,miingtastic,2139,790,85,97,182,46.7%,2h
39604,1,lmcfirst,2139,894,27,39,66,40.9%,2h
39604,1,precovidboy,2139,549,21,24,45,46.7%,3m
39604,2,Lunchpail,2139,412,14,17,31,45.2%,2h
39604,1,SlowJedi,2139,327,14,17,31,45.2%,2h
39604,1,[DBS999]Winterstein,2139,343,12,11,23,52.2%,28m
39604,1,Daviskillerz,2139,300,8,21,29,27.6%,2h
39604,1,Akhundelar,2139,220,6,13,19,31.6%,47m
39604,1,GuiltySpark,2139,170,5,7,12,41.7%,17m
39604,1,DarkDragon,2139,176,5,8,13,38.5%,12m
39604,1,VxorG,2139,70,4,7,11,36.4%,2h
39604,3,sieger,2139,190,4,10,14,28.6%,2h
39604,2,[TGosuB]RosyPosy,2139,32,2,1,3,66.7%,54m
39604,2,Death,2139,97,1,2,3,33.3%,5m
39604,2,REPLIK,2139,46,1,5,6,16.7%,2h
39604,1,[FTBALL]Steve,2139,0,0,4,4,0.0%,48m
39604,1,Dash,2139,0,0,5,5,0.0%,17m
39621,1,SneakyTurtle,2138,1653,100,104,204,49.0%,2h
39621,1,WeThaNorth,2138,1520,64,76,140,45.7%,2h
39621,2,perfectkelly,2138,497,22,13,35,62.9%,2h
39621,1,Melifire,2138,574,20,27,47,42.6%,2h
39621,2,Erick,2138,534,19,20,39,48.7%,2h
39621,1,StickyPants,2138,494,17,24,41,41.5%,2h
39621,3,osonegro,2138,342,11,20,31,35.5%,44m
39621,1,texugão,2138,160,5,11,16,31.2%,41m
39621,2,[RSGP]Aristoteles,2138,200,5,22,27,18.5%,38m
39621,2,[MRDR]fromthegetgo,2138,0,4,2,6,66.7%,3h
39621,3,[000s]Checho,2138,147,4,3,7,57.1%,2h
39621,2,MartiReyes,2138,30,4,3,7,57.1%,5m
39621,1,[NePe]Tatascan,2138,38,4,4,8,50.0%,2h
39621,2,karlosebenjp,2138,106,3,2,5,60.0%,2h
39621,2,NickNate,2138,88,3,4,7,42.9%,38m
39621,1,Jacen,2138,129,3,6,9,33.3%,26m
39621,2,[CRU5H]Hengest,2138,62,2,2,4,50.0%,47m
39621,2,caole,2138,0,2,3,5,40.0%,2h
39621,2,Niivek,2138,94,2,7,9,22.2%,43m
39621,1,ThatBoiBlue,2138,0,1,6,7,14.3%,2h
39621,2,jesuisseb,2138,46,1,6,7,14.3%,3h
39621,1,MurdaFace,2138,0,1,6,7,14.3%,2h
39621,2,TotalPenguin,2138,0,0,1,1,0.0%,20m
39621,2,austinator,2138,0,0,5,5,0.0%,15m
39621,2,SunnyD,2138,0,0,5,5,0.0%,22m
39646,1,[Popstr]delle,2137,1590,64,72,136,47.1%,14m
39646,2,UNxLimiTxED,2137,1385,63,67,130,48.5%,2h
39646,1,Quez,2137,811,25,32,57,43.9%,6m
39646,1,Boudreau,2137,632,18,25,43,41.9%,2h
39646,1,matt,2137,354,10,22,32,31.2%,3h
39646,3,[4BDSM]FelipeT,2137,174,5,12,17,29.4%,2h
39646,3,Skoorb,2137,122,5,13,18,27.8%,2h
39646,1,JAIRUS,2137,40,4,4,8,50.0%,47m
39646,2,Mikuo,2137,120,4,6,10,40.0%,2h
39646,1,Lettuce,2137,89,2,6,8,25.0%,2h
39646,1,guyisderek,2137,41,1,4,5,20.0%,3h
39646,2,Redirac,2137,30,1,6,7,14.3%,45m
39646,2,Importbeats,2137,48,1,6,7,14.3%,2h
39646,3,SuperKamiG,2137,0,1,8,9,11.1%,2h
39646,2,sando,2137,0,0,2,2,0.0%,2h
39646,1,[PobSC]Gian,2137,0,0,3,3,0.0%,2h
39646,2,Drago,2137,0,0,3,3,0.0%,2h
39663,3,Maxnóz,2136,464,238,242,480,49.6%,19m
39663,2,ifeelbutheat,2136,1553,175,173,348,50.3%,50m
39663,1,SanFru,2136,1729,150,150,300,50.0%,2h
39663,1,APOCALYPSE,2136,1179,121,124,245,49.4%,42m
39663,1,[ADIC]SealenDeals,2136,1113,101,102,203,49.8%,2h
39663,2,[N0BLE]CannabisLeaf,2136,1592,80,86,166,48.2%,2h
39663,1,[BBLINE]devvox,2136,1091,76,81,157,48.4%,2h
39663,2,monicagalind,2136,1103,59,58,117,50.4%,2h
39663,2,JMurda,2136,1182,45,41,86,52.3%,20m
39663,2,SnozRocket,2136,1040,44,39,83,53.0%,2h
39663,2,Asmodeay,2136,1023,43,33,76,56.6%,2h
39663,2,Eliyahu,2136,519,17,22,39,43.6%,2h
39663,1,[HotRod]Silverscorp,2136,342,11,16,27,40.7%,2h
39663,2,fbb,2136,226,9,16,25,36.0%,2h
39663,1,destruckr,2136,168,7,10,17,41.2%,2h
39663,1,Spartacus,2136,240,7,11,18,38.9%,2h
39663,2,[X1]ChevyNova,2136,180,6,10,16,37.5%,2h
39663,2,shrimpnoodle,2136,156,5,10,15,33.3%,2h
39663,2,[BAP01]KimJongFisto,2136,116,4,2,6,66.7%,2h
39663,1,adrianpro,2136,139,4,8,12,33.3%,9m
39663,3,HOPE,2136,60,4,11,15,26.7%,24m
39663,2,[USWAG]fcagiordan,2136,86,3,2,5,60.0%,45m
39663,1,Crow,2136,96,3,6,9,33.3%,2h
39663,1,[RSC2]Coronel,2136,162,3,6,9,33.3%,2h
39663,3,LanaKane,2136,60,2,8,10,20.0%,2h
39663,2,Hellz,2136,0,1,0,1,100.0%,40m
39663,1,ROBERTO,2136,97,1,2,3,33.3%,2h
39663,1,[maru02]MARU,2136,34,1,5,6,16.7%,2h
39663,2,jeyser,2136,0,0,1,1,0.0%,8m
39663,2,LuciferSam,2136,0,0,1,1,0.0%,2h
39663,2,[BlTEL]ELRATONPEREZ,2136,0,0,1,1,0.0%,37m
39663,2,Zreknit,2136,0,0,1,1,0.0%,3h
39695,1,VonBaron,2135,1713,232,234,466,49.8%,2h
39695,3,ZhangKaien,2135,294,23,37,60,38.3%,44m
39695,2,SeungguLee,2135,561,20,18,38,52.6%,27m
39695,2,zerk,2135,436,15,18,33,45.5%,2h
39695,3,[swaus]katino,2135,262,11,10,21,52.4%,15m
39695,2,makotoshisho,2135,245,8,9,17,47.1%,23m
39695,2,Sauron,2135,116,7,5,12,58.3%,2h
39695,2,TaBorQt,2135,44,5,2,7,71.4%,3h
39695,2,snowman,2135,142,5,4,9,55.6%,2h
39695,2,[Lecka]BonSchlonzoo,2135,168,4,7,11,36.4%,3h
39695,1,soracl,2135,0,3,5,8,37.5%,40m
39695,2,ChusingOne,2135,0,1,0,1,100.0%,2h
39695,2,HULK,2135,30,1,1,2,50.0%,5m
39695,2,Wiz,2135,32,1,3,4,25.0%,45m
39695,2,Mancusi,2135,40,1,6,7,14.3%,2h
39695,2,[IROT]IAmSin,2135,0,0,1,1,0.0%,2h
39695,2,OneLazyHero,2135,0,0,1,1,0.0%,2h
39695,3,atomicsooo,2135,0,0,1,1,0.0%,2h
39695,2,[CHEST4]Navy,2135,0,0,2,2,0.0%,39m
39695,2,Zero,2135,0,0,5,5,0.0%,43m
39695,2,Alienigena,2135,0,0,5,5,0.0%,2h
39716,1,Danobain,2134,1401,180,188,368,48.9%,2h
39716,1,thewarrior,2134,1733,90,89,179,50.3%,2h
39716,2,[tSC2LP]bocancamapna,2134,939,32,49,81,39.5%,2h
39716,2,icetrey,2134,486,18,19,37,48.6%,2h
39716,1,guilhermehrs,2134,339,11,19,30,36.7%,3h
39716,1,Fenix,2134,283,8,13,21,38.1%,47m
39716,2,[Hongos]PeterBlass,2134,202,7,6,13,53.8%,2h
39716,2,Ursss,2134,0,5,1,6,83.3%,2m
39716,2,GilgameshXXI,2134,211,5,5,10,50.0%,35m
39716,3,darkprime,2134,134,4,1,5,80.0%,11m
39716,1,NeDo,2134,147,4,8,12,33.3%,36m
39716,1,SuperJabka,2134,97,4,8,12,33.3%,3h
39716,2,GHEKEN,2134,96,4,13,17,23.5%,44m
39716,2,TheWorstAtSc,2134,58,3,2,5,60.0%,2h
39716,3,DVD,2134,70,3,11,14,21.4%,2h
39716,2,MetriK,2134,116,2,5,7,28.6%,2h
39716,3,NightMare,2134,121,2,5,7,28.6%,11m
39716,2,Shamoo,2134,0,1,1,2,50.0%,2h
39716,3,cobkillacali,2134,30,1,2,3,33.3%,42m
39716,2,Zombeca,2134,0,1,2,3,33.3%,21m
39716,1,EnDgAme,2134,0,1,3,4,25.0%,2h
39716,2,poisonrush,2134,30,1,4,5,20.0%,2h
39716,1,Kay,2134,0,1,6,7,14.3%,6m
39716,2,ryanyoung,2134,48,1,6,7,14.3%,52m
39716,2,JinRaynor,2134,0,0,1,1,0.0%,2h
39716,2,traverse,2134,0,0,3,3,0.0%,2h
39716,1,DnL,2134,0,0,3,3,0.0%,2h
39743,2,sleepy,2133,856,44,48,92,47.8%,2h
39743,2,Chiarelli,2133,889,41,31,72,56.9%,2h
39743,1,ferkel,2133,1154,40,47,87,46.0%,2h
39743,2,lynotline,2133,977,38,40,78,48.7%,38m
39743,1,Rooster,2133,957,33,35,68,48.5%,2h
39743,1,OneSlayer,2133,252,23,22,45,51.1%,2h
39743,1,[4TERRA]Redrock,2133,808,23,28,51,45.1%,2h
39743,2,AYAMLAPAR,2133,525,18,24,42,42.9%,2h
39743,2,[Sobro]blevey,2133,376,16,24,40,40.0%,37m
39743,2,kingodtop,2133,353,11,16,27,40.7%,2h
39743,2,Artanis,2133,252,9,2,11,81.8%,2h
39743,1,DGArts,2133,177,9,10,19,47.4%,54m
39743,2,Raflitz,2133,205,8,1,9,88.9%,2h
39743,2,Trystero,2133,202,8,4,12,66.7%,2h
39743,3,ashhole,2133,248,8,5,13,61.5%,2h
39743,3,Centurion,2133,60,4,13,17,23.5%,39m
39743,2,FBomb,2133,88,3,2,5,60.0%,2h
39743,2,Spartanjohn,2133,104,3,3,6,50.0%,2h
39743,2,Songa,2133,88,3,3,6,50.0%,37m
39743,2,Nish,2133,68,3,3,6,50.0%,36m
39743,2,Colin,2133,90,3,5,8,37.5%,5m
39743,2,Nope,2133,118,3,5,8,37.5%,2h
39743,2,ETE,2133,30,2,1,3,66.7%,2h
39743,1,Jaicob,2133,121,2,7,9,22.2%,2h
39743,2,Arthuro,2133,30,1,5,6,16.7%,2h
39743,2,rex,2133,0,0,1,1,0.0%,2h
39743,2,XxYOYUDOxX,2133,0,0,1,1,0.0%,48m
39743,2,Arkanot,2133,0,0,1,1,0.0%,46m
39743,2,Surge,2133,0,0,2,2,0.0%,2h
39743,1,Pasta,2133,0,0,5,5,0.0%,2h
39743,2,MrLemon,2133,0,0,5,5,0.0%,31m
39743,2,SCCroc,2133,0,0,5,5,0.0%,2h
39775,2,pridebreaker,2132,1398,258,273,531,48.6%,48m
39775,3,SrToranaga,2132,1249,73,79,152,48.0%,2h
39775,1,ChronoTriggR,2132,1087,41,37,78,52.6%,3m
39775,1,BearHunter,2132,923,36,40,76,47.4%,14m
39775,2,Leiva,2132,458,16,17,33,48.5%,2h
39775,2,Midnight,2132,436,15,19,34,44.1%,2h
39775,1,Bob,2132,318,10,19,29,34.5%,29m
39775,2,TERFW,2132,260,8,18,26,30.8%,8m
39775,3,GRED,2132,224,8,22,30,26.7%,21m
39775,2,MarineGirl,2132,190,7,5,12,58.3%,2h
39775,2,Wos,2132,204,7,6,13,53.8%,2h
39775,2,cineduar,2132,198,6,7,13,46.2%,2h
39775,3,xdanx,2132,130,6,19,25,24.0%,7m
39775,2,Malazar,2132,98,4,3,7,57.1%,2h
39775,2,MeowMrCat,2132,0,1,0,1,100.0%,2h
39775,1,Andretw,2132,0,0,5,5,0.0%,29m
39791,1,Jokesonyou,2131,1672,131,136,267,49.1%,35m
39791,1,Adamswag,2131,1187,116,119,235,49.4%,27m
39791,1,Marranzo,2131,1609,76,79,155,49.0%,14m
39791,1,RIALTRAPSDS,2131,952,39,38,77,50.6%,2h
39791,2,[HØST]Namo,2131,797,29,23,52,55.8%,50m
39791,1,Lipy,2131,938,29,40,69,42.0%,2h
39791,1,carternetty,2131,601,24,24,48,50.0%,3h
39791,2,SirJohnEh,2131,436,15,12,27,55.6%,45m
39791,2,Casimba,2131,360,14,22,36,38.9%,2h
39791,2,Prospect,2131,274,9,10,19,47.4%,2h
39791,2,TheSaltLord,2131,236,8,12,20,40.0%,2h
39791,3,ptorres,2131,272,7,17,24,29.2%,3h
39791,2,ENKI,2131,186,6,6,12,50.0%,41m
39791,2,Ranc,2131,208,6,6,12,50.0%,2h
39791,1,Zauberer,2131,214,6,14,20,30.0%,2h
39791,1,sss,2131,175,5,8,13,38.5%,26m
39791,1,Napoleon,2131,192,5,11,16,31.2%,46m
39791,2,Atlas,2131,136,4,0,4,100.0%,2h
39791,2,HcYael,2131,104,4,4,8,50.0%,2h
39791,1,MockingBird,2131,70,3,8,11,27.3%,36m
39791,1,CodeBuilder,2131,141,3,10,13,23.1%,27m
39791,2,avtec,2131,30,2,0,2,100.0%,2h
39791,2,[NLTN]TITANICO,2131,58,2,1,3,66.7%,2h
39791,2,Noobie,2131,30,2,2,4,50.0%,13m
39791,1,LBthurteen,2131,0,1,3,4,25.0%,42m
39791,2,ivanmaldonad,2131,30,1,4,5,20.0%,2h
39791,1,KWat,2131,0,1,4,5,20.0%,2h
39791,1,[Ins8G]startrail,2131,0,1,6,7,14.3%,55m
39791,3,elephant,2131,0,1,7,8,12.5%,2h
39791,2,Johnkim,2131,0,0,1,1,0.0%,2h
39791,1,lOPSlTerran,2131,0,0,3,3,0.0%,44m
39822,1,IIIIIIIIIIII,2130,1753,148,186,334,44.3%,2h
39822,1,Elmermelero,2130,1604,66,73,139,47.5%,2h
39822,1,Mirshann,2130,1509,56,57,113,49.6%,17m
39822,2,datsun,2130,1330,51,54,105,48.6%,41m
39822,3,halfdrunk,2130,837,30,36,66,45.5%,21m
39822,1,MrKoreXD,2130,807,26,29,55,47.3%,38m
39822,1,amilcar,2130,729,21,28,49,42.9%,24m
39822,1,SSJARI,2130,582,18,24,42,42.9%,2h
39822,1,funkyou,2130,253,8,11,19,42.1%,2h
39822,1,Fox,2130,222,5,9,14,35.7%,2h
39822,2,Ragabash,2130,0,3,2,5,60.0%,2h
39822,2,ChaseInvader,2130,30,3,9,12,25.0%,2m
39822,2,Execatl,2130,58,2,3,5,40.0%,27m
39822,3,MicroVillain,2130,95,2,8,10,20.0%,38m
39822,2,RazDoLBax,2130,0,1,0,1,100.0%,23m
39822,2,michaellove,2130,0,1,2,3,33.3%,2h
39822,2,ForeverHers,2130,30,1,4,5,20.0%,48m
39822,2,SerdarGazii,2130,0,0,1,1,0.0%,2h
39822,2,iLiCh,2130,0,0,5,5,0.0%,5m
39841,2,bobbyG,2129,1636,197,206,403,48.9%,2h
39841,1,[BigBrd]ppppablo,2129,1417,154,152,306,50.3%,3h
39841,1,Drakan,2129,465,62,64,126,49.2%,38m
39841,2,Cipher,2129,1113,46,56,102,45.1%,2h
39841,1,[504Hn]SeawolfHN,2129,1122,40,49,89,44.9%,2h
39841,1,redpanda,2129,324,15,19,34,44.1%,2h
39841,1,JarOfRamen,2129,154,7,3,10,70.0%,2h
39841,1,TruePotato,2129,289,6,12,18,33.3%,17m
39841,2,[LINAGE]Tivon,2129,182,4,9,13,30.8%,2h
39841,1,oweneljisus,2129,110,3,9,12,25.0%,16m
39841,2,[NoVa3]NoVa,2129,30,1,2,3,33.3%,2h
39841,2,[Alzh]Seph,2129,93,1,5,6,16.7%,15m
39841,2,frankie,2129,97,1,6,7,14.3%,22m
39841,1,Magic,2129,0,1,6,7,14.3%,29m
39841,2,[CL3V3R]Knuckles,2129,73,0,2,2,0.0%,49m
39841,2,SaltyDogg,2129,0,0,2,2,0.0%,2h
39841,2,BondiBad,2129,0,0,2,2,0.0%,2h
39841,2,Tigermanner,2129,0,0,2,2,0.0%,49m
39841,1,Bfm,2129,0,0,2,2,0.0%,2h
39841,1,RAINJORX,2129,0,0,3,3,0.0%,47m
39861,1,Raftoooorrrr,2128,1697,265,283,548,48.4%,2h
39861,2,bee,2128,1611,147,142,289,50.9%,2h
39861,2,KingKringlet,2128,1656,72,76,148,48.6%,2h
39861,2,jfranco,2128,1155,59,52,111,53.2%,3m
39861,2,Ankinator,2128,814,31,33,64,48.4%,2h
39861,1,ShaneFalco,2128,840,31,35,66,47.0%,2h
39861,2,osity,2128,818,30,29,59,50.8%,49m
39861,1,Choripan,2128,766,29,34,63,46.0%,16m
39861,3,Evan,2128,717,27,30,57,47.4%,16m
39861,2,FoxyCox,2128,230,10,13,23,43.5%,2h
39861,2,CARDOS,2128,170,7,7,14,50.0%,2h
39861,2,[YeRlN]Gfriends,2128,144,5,2,7,71.4%,2h
39861,3,BigNoobL,2128,173,5,10,15,33.3%,2h
39861,1,Korakys,2128,96,5,15,20,25.0%,2h
39861,1,[X1143]Brettx,2128,118,3,6,9,33.3%,24m
39861,2,BlackStorm,2128,0,2,3,5,40.0%,2h
39861,2,[Blokes]Tekkadan,2128,0,1,0,1,100.0%,2h
39861,2,Mrscrooge,2128,32,1,3,4,25.0%,46m
39861,2,[DBZ]PatriBatman,2128,0,1,5,6,16.7%,52m
39861,1,[L4U]TlTTIEbanger,2128,48,1,6,7,14.3%,17m
39861,3,Lionel,2128,0,1,7,8,12.5%,40m
39861,2,[SC2US]beerman,2128,0,0,1,1,0.0%,2h
39861,2,Radamantis,2128,0,0,1,1,0.0%,31m
39861,2,xXBONESXx,2128,0,0,3,3,0.0%,2h
39861,2,HKEspeon,2128,0,0,5,5,0.0%,2h
39886,1,KelaGOD,2127,1201,113,119,232,48.7%,40m
39886,1,Mazinga,2127,1720,92,87,179,51.4%,2h
39886,2,EddoMars,2127,1357,63,57,120,52.5%,2h
39886,2,Desolate,2127,1412,58,45,103,56.3%,2h
39886,1,Raider,2127,914,42,41,83,50.6%,14m
39886,1,kidzplaygame,2127,1020,33,38,71,46.5%,12m
39886,1,SonicMarine,2127,657,28,30,58,48.3%,2h
39886,2,Powers,2127,536,26,30,56,46.4%,2h
39886,1,digitizzle,2127,395,24,32,56,42.9%,52m
39886,2,MILKVGC,2127,420,19,9,28,67.9%,36m
39886,2,GatoBlanco,2127,440,19,14,33,57.6%,45m
39886,3,GAVO,2127,341,12,16,28,42.9%,2h
39886,2,GeneralJeff,2127,166,6,9,15,40.0%,2h
39886,1,RaggedMime,2127,130,6,12,18,33.3%,3h
39886,1,Boonanabob,2127,161,6,15,21,28.6%,24m
39886,1,lit,2127,175,4,9,13,30.8%,26m
39886,2,Marine,2127,94,3,2,5,60.0%,2h
39886,2,webbedfeet,2127,104,3,2,5,60.0%,50m
39886,3,EvilECP,2127,58,3,10,13,23.1%,2h
39886,2,KingTeetee,2127,32,2,1,3,66.7%,2h
39886,1,Shura,2127,90,2,9,11,18.2%,2h
39886,2,paradox,2127,0,1,2,3,33.3%,2h
39886,1,Quantico,2127,0,1,2,3,33.3%,15m
39886,2,Darkkingt,2127,88,1,5,6,16.7%,52m
39886,2,Jody,2127,0,0,1,1,0.0%,48m
39886,2,Tre,2127,0,0,1,1,0.0%,47m
39886,2,Pax,2127,0,0,1,1,0.0%,2h
39886,2,[SALADO]CristianOMG,2127,0,0,1,1,0.0%,2h
39886,2,LyghtForge,2127,73,0,2,2,0.0%,2h
39886,2,bmasta,2127,0,0,5,5,0.0%,22m
39886,2,Frank,2127,0,0,5,5,0.0%,2h
39917,1,INVESTEDT,2126,1749,248,265,513,48.3%,2h
39917,2,Folley,2126,1613,145,141,286,50.7%,2h
39917,2,[SalvA]geo,2126,1671,90,79,169,53.3%,2h
39917,2,Spacelord,2126,826,54,47,101,53.5%,8m
39917,1,xxKAZUNARIxx,2126,793,38,24,62,61.3%,2h
39917,1,GhostDragon,2126,757,29,41,70,41.4%,14m
39917,2,nazareth,2126,191,10,5,15,66.7%,2h
39917,2,Swizzle,2126,222,9,11,20,45.0%,2h
39917,1,KinkyBoots,2126,230,8,9,17,47.1%,2h
39917,1,[HOT69]Narvon,2126,279,7,10,17,41.2%,2h
39917,1,MAGNETIC,2126,184,6,10,16,37.5%,16m
39917,2,[BOTF]KillerFunk,2126,116,5,1,6,83.3%,52m
39917,2,JRA,2126,118,4,3,7,57.1%,14m
39917,2,VERA,2126,94,4,6,10,40.0%,2h
39917,2,[LOHs]MarcoPolo,2126,58,3,3,6,50.0%,5m
39917,1,SmokinCrack,2126,145,3,7,10,30.0%,55m
39917,2,cinzento,2126,30,2,0,2,100.0%,5m
39917,2,Task,2126,30,2,1,3,66.7%,2h
39917,1,SleepyShaman,2126,108,2,1,3,66.7%,5m
39917,1,FoWheel,2126,0,2,6,8,25.0%,2h
39937,1,eightalpha,2125,1664,77,78,155,49.7%,53m
39937,1,[FFAA]BERSERKER,2125,1580,68,62,130,52.3%,24m
39937,2,DAVEDBN,2125,1573,67,71,138,48.6%,47m
39937,2,elwalale,2125,1094,38,40,78,48.7%,2h
39937,2,[NTrio]MelonLord,2125,329,13,3,16,81.2%,2h
39937,1,GLNoobHF,2125,347,13,9,22,59.1%,2h
39937,1,Ephemeral,2125,408,13,16,29,44.8%,2h
39937,2,Newgen,2125,280,13,19,32,40.6%,2h
39937,2,MercilesTrol,2125,246,7,9,16,43.8%,2h
39937,1,OnePool,2125,156,6,7,13,46.2%,40m
39937,2,FBI,2125,104,5,9,14,35.7%,5m
39937,1,whitewolf,2125,78,3,7,10,30.0%,3h
39937,2,Saito,2125,0,2,3,5,40.0%,35m
39937,2,juancamaney,2125,70,2,5,7,28.6%,2h
39937,2,[LCE]Cdag,2125,35,1,2,3,33.3%,2h
39937,2,Noobtastic,2125,94,1,5,6,16.7%,5m
39937,1,sangyoon,2125,0,1,6,7,14.3%,30m
39937,1,Bishop,2125,0,1,7,8,12.5%,10m
39937,2,Xurisso,2125,0,0,1,1,0.0%,2h
39937,2,KnightKap,2125,0,0,5,5,0.0%,34m
39937,2,Nebulosa,2125,0,0,5,5,0.0%,2h
39958,1,LuigiBoom,2124,1326,84,88,172,48.8%,12m
39958,2,Shanelight,2124,620,25,21,46,54.3%,2h
39958,1,joe,2124,514,24,34,58,41.4%,42m
39958,1,jimmyczz,2124,424,11,19,30,36.7%,47m
39958,1,Heisenberg,2124,319,10,11,21,47.6%,32m
39958,3,likwidshtuff,2124,178,5,11,16,31.2%,22m
39958,2,PeppeLox,2124,135,3,3,6,50.0%,2h
39958,3,GuacamoleDip,2124,96,3,3,6,50.0%,43m
39958,2,[TxPain]TRICIAxPAIN,2124,32,2,0,2,100.0%,8m
39958,2,elpeter,2124,0,2,3,5,40.0%,48m
39958,2,[UtPowr]TopTap,2124,0,1,0,1,100.0%,2h
39958,2,Zaneakye,2124,0,1,1,2,50.0%,2h
39958,2,SpeedRacerX,2124,88,1,1,2,50.0%,5m
39958,2,Joeboo,2124,0,1,4,5,20.0%,41m
39958,2,Cybalt,2124,0,0,2,2,0.0%,32m
39958,2,XGuardianZ,2124,0,0,5,5,0.0%,34m
39974,1,[Pharoh]XxrasiixX,2123,1330,66,64,130,50.8%,14m
39974,1,ciprian,2123,1355,49,54,103,47.6%,2h
39974,2,JesterMayne,2123,589,32,28,60,53.3%,2h
39974,2,Otocani,2123,763,27,26,53,50.9%,48m
39974,1,deadawake,2123,862,24,39,63,38.1%,53m
39974,2,Doomsiren,2123,437,20,18,38,52.6%,2h
39974,1,NickJo,2123,490,18,19,37,48.6%,12m
39974,2,BOOTY,2123,399,16,9,25,64.0%,27m
39974,2,BRODAYYYYYYY,2123,350,11,7,18,61.1%,2h
39974,2,summer,2123,340,11,16,27,40.7%,48m
39974,2,[DvaRKA]Nandox,2123,121,6,1,7,85.7%,39m
39974,2,[P3RR0S]MauricioAP,2123,181,6,5,11,54.5%,54m
39974,2,Trajan,2123,203,5,4,9,55.6%,15m
39974,2,poompystink,2123,0,4,1,5,80.0%,47m
39974,2,[BlTEL]malthael,2123,102,4,4,8,50.0%,36m
39974,1,[CUNYC]calpoop,2123,64,2,5,7,28.6%,6m
39974,1,[ZyrG]Kraus,2123,48,2,8,10,20.0%,3h
39974,2,faredon,2123,0,1,0,1,100.0%,54m
39974,2,Destiny,2123,30,1,1,2,50.0%,5m
39974,1,DizzyLizzy,2123,0,0,1,1,0.0%,2h
39974,2,DRYFTER,2123,0,0,2,2,0.0%,15m
39974,2,lobo,2123,0,0,4,4,0.0%,2h
39996,2,fufusito,2122,1637,62,73,135,45.9%,2h
39996,1,Umbranite,2122,1375,51,62,113,45.1%,2h
39996,1,[Wix]jovo,2122,1121,39,43,82,47.6%,53m
39996,1,Puck,2122,537,31,34,65,47.7%,8m
39996,1,ALBORYOIN,2122,402,11,21,32,34.4%,16m
39996,2,[BYU]SirSpen,2122,311,10,12,22,45.5%,2h
39996,1,[ZTempz]Desyni,2122,177,5,6,11,45.5%,2h
39996,2,Seedling,2122,48,4,4,8,50.0%,35m
39996,2,Geobob,2122,46,2,0,2,100.0%,2h
39996,2,tsunamiarrow,2122,0,0,1,1,0.0%,2h
39996,2,Chief,2122,0,0,1,1,0.0%,15m
39996,1,willymon,2122,0,0,3,3,0.0%,3h
39996,2,ZyronD,2122,0,0,5,5,0.0%,15m
39996,2,BobWolson,2122,0,0,5,5,0.0%,54m
40010,2,Chunkysmash,2121,969,59,72,131,45.0%,2h
40010,3,Evertoss,2121,982,34,51,85,40.0%,15m
40010,1,Doombringer,2121,799,29,31,60,48.3%,2h
40010,1,Maninthebox,2121,481,21,26,47,44.7%,2h
40010,2,thiago,2121,479,20,14,34,58.8%,2h
40010,2,Taskmaster,2121,340,18,18,36,50.0%,2h
40010,2,DonChota,2121,235,13,3,16,81.2%,2h
40010,3,Xenoknight,2121,238,8,15,23,34.8%,32m
40010,1,Infinitejay,2121,166,8,17,25,32.0%,2h
40010,1,JayB,2121,314,7,11,18,38.9%,11m
40010,2,Hupli,2121,197,6,11,17,35.3%,2h
40010,2,COSMOS,2121,158,5,9,14,35.7%,39m
40010,1,brightburn,2121,62,3,12,15,20.0%,2h
40010,3,alejandro,2121,0,2,7,9,22.2%,52m
40010,1,[ybyb]AAA,2121,48,2,8,10,20.0%,2h
40010,2,Rayok,2121,30,1,1,2,50.0%,20m
40010,3,JimDawd,2121,0,1,4,5,20.0%,2h
40010,1,Tratix,2121,0,0,1,1,0.0%,44m
40010,2,swiftymcfly,2121,0,0,1,1,0.0%,51m
40010,2,jkiz,2121,0,0,5,5,0.0%,2h
40010,1,kimjiye,2121,0,0,7,7,0.0%,12m
40031,1,Pianoman,2120,1576,113,116,229,49.3%,2h
40031,1,jjaksarang,2120,500,66,71,137,48.2%,2h
40031,1,Ever,2120,1116,34,48,82,41.5%,45m
40031,3,Topher,2120,569,21,26,47,44.7%,32m
40031,2,DiazSichbear,2120,597,19,24,43,44.2%,2h
40031,2,ROC,2120,532,19,25,44,43.2%,2h
40031,1,Almadedragon,2120,441,16,22,38,42.1%,2h
40031,2,Masterwolf,2120,464,15,21,36,41.7%,2h
40031,2,crazybouncer,2120,135,14,14,28,50.0%,24m
40031,2,[TxPain]Leopardeye,2120,243,12,4,16,75.0%,2h
40031,2,MARTE,2120,382,12,18,30,40.0%,2h
40031,2,Jara,2120,306,10,12,22,45.5%,47m
40031,2,Pliavi,2120,294,10,20,30,33.3%,2h
40031,2,shootingstar,2120,176,5,2,7,71.4%,2h
40031,1,[AFOTW]Farin,2120,139,5,3,8,62.5%,5m
40031,2,sergio,2120,166,5,3,8,62.5%,2h
40031,2,[NM8]Stanler,2120,127,5,4,9,55.6%,24m
40031,2,Aegon,2120,106,4,4,8,50.0%,2h
40031,2,poe,2120,62,3,2,5,60.0%,50m
40031,1,xel,2120,96,3,10,13,23.1%,2h
40031,2,WhackMySack,2120,0,1,1,2,50.0%,2h
40031,2,hotcheetos,2120,36,1,2,3,33.3%,2h
40031,1,BigStewBeef,2120,0,1,5,6,16.7%,2h
40031,2,Viduus,2120,0,1,5,6,16.7%,2h
40031,1,[MCAD]ATOM,2120,0,1,6,7,14.3%,2h
40031,1,[jneltn]Goosh,2120,40,1,8,9,11.1%,2h
40057,2,COLT,2119,419,18,9,27,66.7%,2h
40057,1,jese,2119,392,13,16,29,44.8%,2h
40057,2,RETROPRO,2119,240,8,9,17,47.1%,37m
40057,2,Appa,2119,116,5,3,8,62.5%,2h
40057,1,[0825]Bubblez,2119,190,5,3,8,62.5%,51m
40057,2,Syrathos,2119,173,5,5,10,50.0%,2h
40057,3,ShadowDragon,2119,147,3,1,4,75.0%,29m
40057,2,willy,2119,30,2,0,2,100.0%,2h
40057,1,TIMWALLER,2119,48,2,2,4,50.0%,52m
40057,1,bubytrap,2119,44,1,7,8,12.5%,12m
40057,2,[eSx]Rave,2119,0,0,1,1,0.0%,2h
40057,1,Hoppydon,2119,0,0,1,1,0.0%,55m
40057,2,stupidtoss,2119,0,0,3,3,0.0%,43m
40057,2,josepepe,2119,0,0,5,5,0.0%,2h
40057,2,Index,2119,0,0,5,5,0.0%,35m
40072,2,Aetos,2118,952,56,58,114,49.1%,3m
40072,2,naicocraftYT,2118,974,36,43,79,45.6%,2h
40072,1,Camusgs,2118,728,24,26,50,48.0%,2h
40072,2,NerdGuy,2118,467,16,14,30,53.3%,24m
40072,2,Sirluck,2118,461,16,18,34,47.1%,46m
40072,1,JKZakamurite,2118,314,11,12,23,47.8%,2h
40072,2,vortex,2118,332,11,14,25,44.0%,2h
40072,2,[Patrol]Tmac,2118,220,9,11,20,45.0%,2h
40072,3,AcGXenoqwerp,2118,166,7,15,22,31.8%,2h
40072,2,SabuesoListr,2118,204,6,8,14,42.9%,49m
40072,2,xOhxSleeperx,2118,183,5,10,15,33.3%,2h
40072,1,Dominance,2118,200,5,14,19,26.3%,47m
40072,2,TasteOfIron,2118,88,3,2,5,60.0%,35m
40072,2,VoidStalker,2118,30,1,1,2,50.0%,48m
40072,2,MikZ,2118,0,1,1,2,50.0%,2h
40072,2,killer,2118,0,1,2,3,33.3%,14m
40072,2,[m0ld]ADHD,2118,0,0,1,1,0.0%,2m
40072,2,[CHIRP4]JimmyBoorah,2118,0,0,1,1,0.0%,45m
40072,2,Devilschild,2118,0,0,1,1,0.0%,2h
40072,2,[Topos]Raimund,2118,0,0,5,5,0.0%,2h
40092,2,jhonn,2117,1538,117,122,239,49.0%,2h
40092,1,ProjectVast,2117,1701,95,104,199,47.7%,6m
40092,1,bingu,2117,460,14,17,31,45.2%,2h
40092,2,ALP,2117,296,10,9,19,52.6%,27m
40092,2,katysakurai,2117,296,10,11,21,47.6%,2h
40092,1,Rokki,2117,336,9,14,23,39.1%,2h
40092,2,xman,2117,213,7,5,12,58.3%,2h
40092,2,Cademan,2117,198,6,1,7,85.7%,38m
40092,2,altazimuth,2117,152,5,1,6,83.3%,52m
40092,2,[FL9]tufanG,2117,48,2,4,6,33.3%,26m
40092,2,ArielPlus,2117,60,2,5,7,28.6%,54m
40092,1,Elmo,2117,48,2,8,10,20.0%,52m
40092,2,[Epokhé]alan,2117,0,1,0,1,100.0%,2h
40092,2,whatever,2117,46,1,2,3,33.3%,2h
40092,1,xlotux,2117,48,1,2,3,33.3%,2h
40092,1,FRENC,2117,0,1,6,7,14.3%,3m
40092,2,KilroyJinkin,2117,0,0,1,1,0.0%,2h
40092,2,MadScientist,2117,0,0,1,1,0.0%,2h
40092,2,eSpike,2117,0,0,2,2,0.0%,26m
40111,1,BigDaddy,2116,1659,415,422,837,49.6%,2h
40111,1,AceOne,2116,1284,85,87,172,49.4%,2h
40111,1,[iDrunk]AssForceFive,2116,1745,83,92,175,47.4%,2h
40111,2,HeavyArmodz,2116,1341,57,47,104,54.8%,14m
40111,1,HellHound,2116,957,49,45,94,52.1%,2h
40111,1,[SWOU]ShadowMoon,2116,723,29,36,65,44.6%,17m
40111,2,mightymouze,2116,835,29,44,73,39.7%,2h
40111,2,HolyPohTayTe,2116,615,24,36,60,40.0%,32m
40111,3,PositionOne,2116,648,21,37,58,36.2%,17m
40111,1,kingawesome,2116,462,15,20,35,42.9%,13m
40111,2,Roguezilla,2116,288,9,7,16,56.2%,2h
40111,1,touchpad,2116,268,7,16,23,30.4%,17m
40111,2,Alvaros,2116,222,6,5,11,54.5%,2h
40111,1,NineVoltRevo,2116,223,6,8,14,42.9%,2h
40111,2,JAML,2116,158,5,7,12,41.7%,2h
40111,2,lagoon,2116,241,4,10,14,28.6%,45m
40111,1,MagistradoAM,2116,109,3,7,10,30.0%,3h
40111,2,PEEP,2116,62,2,1,3,66.7%,14m
40111,2,XIAOHU,2116,62,2,2,4,50.0%,2h
40111,1,Aceblack,2116,0,2,7,9,22.2%,52m
40111,1,mayckel,2116,42,2,7,9,22.2%,36m
40111,1,JckDestroyer,2116,97,1,3,4,25.0%,36m
40111,1,Durandalh,2116,0,1,5,6,16.7%,2h
40111,2,lazzlow,2116,0,0,1,1,0.0%,2h
40111,2,Tacogramps,2116,0,0,1,1,0.0%,49m
40111,2,MIJAELKL,2116,0,0,1,1,0.0%,2h
40111,2,Jim,2116,0,0,1,1,0.0%,2h
40111,2,Isaac,2116,0,0,2,2,0.0%,13m
40111,2,QingFeng,2116,0,0,2,2,0.0%,47m
40111,2,CARDIA,2116,0,0,3,3,0.0%,2h
40111,2,BubbleGum,2116,0,0,5,5,0.0%,15m
40111,2,chimpandolfo,2116,0,0,5,5,0.0%,2h
40143,1,Dirtyharry,2115,1675,251,266,517,48.5%,2h
40143,1,Morduck,2115,1625,226,229,455,49.7%,2h
40143,1,Gary,2115,1679,109,108,217,50.2%,2h
40143,2,Lothlorien,2115,768,29,28,57,50.9%,2h
40143,1,Cyril,2115,816,26,29,55,47.3%,2h
40143,2,tzpr,2115,461,21,5,26,80.8%,55m
40143,1,Lancers,2115,417,17,25,42,40.5%,26m
40143,2,BooJiggeyPop,2115,438,16,14,30,53.3%,2h
40143,1,cabo,2115,576,16,25,41,39.0%,40m
40143,2,oof,2115,130,6,7,13,46.2%,38m
40143,2,tmex,2115,182,5,7,12,41.7%,2h
40143,1,[xDYEx]Portfirebird,2115,168,4,8,12,33.3%,26m
40143,2,slightlydead,2115,98,3,7,10,30.0%,5m
40143,1,GigaFlop,2115,70,3,7,10,30.0%,3h
40143,2,NicoMaster,2115,66,2,7,9,22.2%,2h
40143,2,Kristjan,2115,0,1,0,1,100.0%,31m
40143,2,FILHODELOKE,2115,38,1,1,2,50.0%,2h
40143,2,bobbywhat,2115,0,1,1,2,50.0%,2h
40143,2,[WOTDL]Camii,2115,0,1,3,4,25.0%,2h
40143,1,paperman,2115,0,1,4,5,20.0%,17m
40143,2,Defcon,2115,0,0,1,1,0.0%,47m
40143,2,AxxL,2115,0,0,1,1,0.0%,2h
40143,1,grecia,2115,0,0,2,2,0.0%,3h
40166,1,TigerKing,2114,1120,77,76,153,50.3%,53m
40166,2,Maximo,2114,1597,73,76,149,49.0%,2h
40166,2,SRZ,2114,980,65,67,132,49.2%,2h
40166,2,[WTNRCL]RyuShin,2114,1052,45,40,85,52.9%,2h
40166,1,Migbon,2114,1253,45,43,88,51.1%,2h
40166,2,MGX,2114,816,38,29,67,56.7%,2h
40166,2,Terry,2114,518,18,18,36,50.0%,2h
40166,2,BRAUSSIN,2114,239,8,12,20,40.0%,2h
40166,1,Ghost,2114,119,5,5,10,50.0%,12m
40166,2,akiyoshi,2114,221,5,11,16,31.2%,2h
40166,2,Lamq,2114,118,4,5,9,44.4%,2h
40166,2,MajorZero,2114,102,3,2,5,60.0%,27m
40166,1,Yakob,2114,94,3,8,11,27.3%,42m
40166,2,Korypzion,2114,46,1,3,4,25.0%,34m
40166,2,Maurice,2114,30,1,5,6,16.7%,39m
40166,2,Saymoua,2114,0,0,5,5,0.0%,2h
40166,1,Skaggi,2114,0,0,7,7,0.0%,42m
40183,1,[ZTemps]SeaShining,2113,738,149,137,286,52.1%,40m
40183,2,Kamikaze,2113,592,22,21,43,51.2%,2h
40183,1,eframm,2113,647,21,29,50,42.0%,2h
40183,2,JoGmlll,2113,432,16,11,27,59.3%,36m
40183,1,Specter,2113,348,11,13,24,45.8%,2h
40183,1,[Kappa8]Mmbrillo,2113,266,9,11,20,45.0%,2h
40183,2,Madmax,2113,253,9,17,26,34.6%,2h
40183,1,Dahlerious,2113,228,8,12,20,40.0%,43m
40183,1,darkondevil,2113,318,8,20,28,28.6%,27m
40183,2,MPHamilton,2113,131,7,11,18,38.9%,2h
40183,2,zaltoi,2113,171,6,1,7,85.7%,2h
40183,2,Orgon,2113,86,6,10,16,37.5%,2h
40183,1,Plasma,2113,121,5,5,10,50.0%,2h
40183,2,Ecorella,2113,194,5,6,11,45.5%,2h
40183,2,GapsMcD,2113,64,3,3,6,50.0%,2h
40183,2,[IRC]ChaoticL,2113,138,3,5,8,37.5%,2h
40183,1,Ank,2113,163,3,8,11,27.3%,26m
40183,2,BigfatGG,2113,97,3,8,11,27.3%,2h
40183,3,[NastyB]FuzzSlasher,2113,94,3,14,17,17.6%,2h
40183,3,[NYMZ]Kohaku,2113,0,2,4,6,33.3%,28m
40183,1,SOLO,2113,122,2,8,10,20.0%,37m
40183,2,Cubelife,2113,93,1,1,2,50.0%,2h
40183,2,[BBLEAN]PredictionOP,2113,0,1,4,5,20.0%,2h
40183,2,Ramoth,2113,88,1,5,6,16.7%,2h
40183,1,Ramius,2113,73,1,8,9,11.1%,17m
40183,2,willdrewp,2113,0,0,1,1,0.0%,46m
40183,2,Lanius,2113,0,0,1,1,0.0%,47m
40183,2,[NastyB]joseluis,2113,0,0,3,3,0.0%,2h
40211,2,Victor,2112,1065,82,91,173,47.4%,46m
40211,3,Drakethos,2112,1311,51,66,117,43.6%,30m
40211,2,Legacyplays,2112,579,18,24,42,42.9%,2h
40211,2,Skatobetho,2112,318,10,13,23,43.5%,2h
40211,2,[ITSDC]DarkLeont,2112,200,8,10,18,44.4%,2h
40211,1,CRISKING,2112,299,8,14,22,36.4%,2h
40211,2,DarthVador,2112,154,8,18,26,30.8%,4m
40211,1,MarkHero,2112,146,5,10,15,33.3%,44m
40211,1,RosharKnight,2112,119,4,5,9,44.4%,3h
40211,2,Jerusalén,2112,120,4,9,13,30.8%,2h
40211,1,MonstaGoliat,2112,168,3,6,9,33.3%,48m
40211,1,Wily,2112,0,1,1,2,50.0%,17m
40211,2,Roach,2112,48,1,3,4,25.0%,34m
40211,1,Vanderheidem,2112,0,1,7,8,12.5%,2h
40211,1,namotatop,2112,0,0,1,1,0.0%,2h
40211,2,ronald,2112,0,0,2,2,0.0%,2h
40211,1,[Xirius]Babar,2112,0,0,5,5,0.0%,2h
40211,2,jacky,2112,0,0,5,5,0.0%,45m
40229,2,raul,2111,981,36,34,70,51.4%,2h
40229,1,Gabotwister,2111,482,27,29,56,48.2%,2h
40229,2,SoftwareMonk,2111,652,24,22,46,52.2%,2h
40229,1,Kaiser,2111,321,23,32,55,41.8%,7m
40229,1,pumba,2111,543,21,26,47,44.7%,2h
40229,2,[Deleto]JontyTowers,2111,381,21,29,50,42.0%,2h
40229,2,Flinwazbirt,2111,452,16,16,32,50.0%,2h
40229,2,Nooth,2111,354,14,12,26,53.8%,52m
40229,1,cyberwiz,2111,328,11,16,27,40.7%,2h
40229,1,Yeertha,2111,246,9,13,22,40.9%,40m
40229,3,Tainted,2111,94,5,11,16,31.2%,2h
40229,2,[MyHase]LauraKslng,2111,173,5,13,18,27.8%,2h
40229,1,[Bee]apriorixcXx,2111,142,3,5,8,37.5%,51m
40229,2,wildz,2111,44,2,5,7,28.6%,5m
40229,1,[NN421]Midas,2111,48,2,8,10,20.0%,52m
40229,2,Beowolf,2111,30,1,1,2,50.0%,2h
40229,2,Occultas,2111,0,1,1,2,50.0%,2h
40229,1,PapitasLays,2111,0,1,4,5,20.0%,2h
40229,1,LosMOT,2111,0,0,5,5,0.0%,2h
40229,2,RAAT,2111,0,0,5,5,0.0%,2h
40249,1,URUALFA,2110,558,16,22,38,42.1%,23m
40249,2,Rino,2110,426,15,12,27,55.6%,39m
40249,2,murpbird,2110,374,13,15,28,46.4%,2h
40249,2,Chaos,2110,390,12,17,29,41.4%,37m
40249,2,Destroyer,2110,244,8,12,20,40.0%,36m
40249,1,SEVEN,2110,135,7,11,18,38.9%,40m
40249,2,carlotto,2110,142,6,4,10,60.0%,24m
40249,2,EpsilonEagle,2110,199,6,8,14,42.9%,2h
40249,1,serrrrral,2110,255,6,11,17,35.3%,2h
40249,3,DinoZerg,2110,221,6,12,18,33.3%,40m
40249,2,JerryJones,2110,58,3,0,3,100.0%,2h
40249,2,UkSrAaIsNty,2110,135,3,2,5,60.0%,2h
40249,1,Luketuner,2110,58,2,8,10,20.0%,23m
40249,2,Commie,2110,91,1,1,2,50.0%,52m
40249,2,Dimitri,2110,0,1,1,2,50.0%,36m
40249,2,ReXan,2110,30,1,4,5,20.0%,2h
40249,1,[CriHE]TimeBomb,2110,0,1,5,6,16.7%,2h
40249,1,nomadicBool,2110,0,1,7,8,12.5%,2h
40249,2,TCplus,2110,0,0,1,1,0.0%,2h
40249,2,AcidBoom,2110,0,0,1,1,0.0%,2h
40249,1,Malarkey,2110,0,0,2,2,0.0%,52m
40249,2,Spray,2110,0,0,5,5,0.0%,32m
40271,1,Ebayy,2109,672,37,43,80,46.2%,23m
40271,2,Multi,2109,521,30,29,59,50.8%,31m
40271,2,[JRT]MasacrePy,2109,653,26,20,46,56.5%,49m
40271,2,[95]EmaLord,2109,286,9,12,21,42.9%,2h
40271,2,scosco,2109,180,5,2,7,71.4%,49m
40271,2,sami,2109,48,3,0,3,100.0%,27m
40271,2,Kronx,2109,86,3,1,4,75.0%,54m
40271,1,Christxpher,2109,48,3,7,10,30.0%,2h
40271,1,Aeriello,2109,96,3,8,11,27.3%,2h
40271,1,Candit,2109,123,3,8,11,27.3%,2h
40271,1,Spacedude,2109,116,2,2,4,50.0%,17m
40271,1,[NLTN]GamiinYager,2109,0,1,1,2,50.0%,51m
40271,2,illusionfox,2109,0,1,2,3,33.3%,2h
40271,2,marcko,2109,0,0,2,2,0.0%,2h
40271,2,WAARGH,2109,73,0,3,3,0.0%,2h
40271,1,FONZ,2109,0,0,7,7,0.0%,2h
40287,2,CANCHITA,2108,1585,133,143,276,48.2%,35m
40287,2,fmeppo,2108,1526,114,111,225,50.7%,2h
40287,1,Kikito,2108,1711,104,110,214,48.6%,2h
40287,2,StarChild,2108,1178,44,42,86,51.2%,2h
40287,3,stephen,2108,991,38,48,86,44.2%,2h
40287,2,delta,2108,924,37,39,76,48.7%,38m
40287,1,SCV,2108,766,24,39,63,38.1%,52m
40287,1,Subterfuge,2108,286,9,14,23,39.1%,2h
40287,1,destiny,2108,278,9,15,24,37.5%,2h
40287,2,MSA,2108,205,8,6,14,57.1%,2h
40287,2,KILLER,2108,203,6,14,20,30.0%,54m
40287,2,[WW2LA]NinjaRobot,2108,62,3,0,3,100.0%,2h
40287,2,Bloodshot,2108,30,2,0,2,100.0%,31m
40287,2,tortugooo,2108,0,1,0,1,100.0%,2h
40287,2,Cryonaka,2108,0,1,0,1,100.0%,2h
40287,2,AnDrEs,2108,0,1,0,1,100.0%,39m
40287,2,NoMad,2108,0,1,0,1,100.0%,2h
40287,2,jserv,2108,48,1,3,4,25.0%,2h
40287,2,fenix,2108,0,1,3,4,25.0%,2h
40287,1,joomanjii,2108,88,1,6,7,14.3%,47m
40287,1,Duke,2108,0,0,3,3,0.0%,2h
40287,2,max,2108,0,0,5,5,0.0%,2h
40309,1,Skyra,2107,1700,91,91,182,50.0%,4m
40309,1,Exallos,2107,853,83,76,159,52.2%,2h
40309,1,Micromat,2107,1405,59,64,123,48.0%,42m
40309,2,doa,2107,894,35,36,71,49.3%,41m
40309,1,FrayleLord,2107,452,22,29,51,43.1%,45m
40309,2,[FFAA]humo,2107,496,18,18,36,50.0%,24m
40309,2,[HotCop]TitanicTh,2107,393,15,17,32,46.9%,39m
40309,2,Jyve,2107,276,11,12,23,47.8%,2h
40309,2,RedCliff,2107,259,9,12,21,42.9%,20m
40309,3,Joelsky,2107,166,8,13,21,38.1%,7m
40309,2,Pancho,2107,231,6,6,12,50.0%,38m
40309,1,Fingers,2107,174,6,14,20,30.0%,3h
40309,2,BlueWave,2107,48,3,5,8,37.5%,2h
40309,1,FastEddie,2107,146,3,5,8,37.5%,2h
40309,2,cronox,2107,90,3,6,9,33.3%,3h
40309,1,zram,2107,97,2,7,9,22.2%,2h
40309,2,Fridge,2107,0,1,4,5,20.0%,2h
40309,1,[USWAG]DanielC,2107,40,1,5,6,16.7%,3h
40309,2,sharminator,2107,0,0,1,1,0.0%,5m
40309,2,[JFrag]Nikouz,2107,0,0,1,1,0.0%,49m
40309,2,Xeridas,2107,0,0,2,2,0.0%,2h
40309,2,Luis,2107,0,0,3,3,0.0%,26m
40309,2,Levent,2107,0,0,4,4,0.0%,2h
40309,2,partyMatt,2107,0,0,4,4,0.0%,5m
40309,2,NoobMaster,2107,0,0,5,5,0.0%,2h
40334,2,[TRH]spacebasco,2106,1523,423,442,865,48.9%,14m
40334,3,dragon,2106,1419,191,232,423,45.2%,33m
40334,1,iXav,2106,1520,101,95,196,51.5%,2h
40334,2,Crock,2106,632,66,54,120,55.0%,6m
40334,1,KazeKage,2106,1417,55,60,115,47.8%,2h
40334,2,Protossaurio,2106,1126,44,44,88,50.0%,2h
40334,1,AlanC,2106,1051,41,52,93,44.1%,3h
40334,1,GreenWire,2106,644,21,25,46,45.7%,55m
40334,2,[BoAVN]ZRT,2106,504,20,15,35,57.1%,21m
40334,2,[PAICHE]jaisonJV,2106,389,16,3,19,84.2%,2h
40334,2,VEE,2106,204,6,9,15,40.0%,2h
40334,1,Slimey,2106,152,6,10,16,37.5%,2h
40334,2,ANTHONY,2106,62,5,5,10,50.0%,41m
40334,1,DanteInferno,2106,0,2,4,6,33.3%,44m
40334,1,[neverb]SoloOp,2106,66,2,7,9,22.2%,2h
40334,2,zerging,2106,0,1,0,1,100.0%,2h
40334,2,nottheliving,2106,30,1,3,4,25.0%,2h
40334,2,omb,2106,0,0,1,1,0.0%,35m
40334,2,SolidSnake,2106,0,0,5,5,0.0%,35m
40334,2,Spageki,2106,0,0,5,5,0.0%,2h
40354,1,VERA,2105,878,111,135,246,45.1%,48m
40354,2,Cabronazo,2105,1559,56,69,125,44.8%,2h
40354,1,AbsoliuT,2105,1179,49,41,90,54.4%,55m
40354,1,DuxTell,2105,355,14,14,28,50.0%,2h
40354,2,DOMI,2105,186,6,11,17,35.3%,2h
40354,1,[106865]AEA,2105,128,4,8,12,33.3%,12m
40354,2,Buzz,2105,100,3,4,7,42.9%,2h
40354,2,Rencee,2105,90,3,6,9,33.3%,31m
40354,3,derrickk,2105,123,3,7,10,30.0%,39m
40354,1,HentaiJessus,2105,106,3,10,13,23.1%,2h
40354,1,[kapas]Yoshi,2105,131,3,10,13,23.1%,2h
40354,3,GabrielP,2105,86,3,19,22,13.6%,34m
40354,2,Wilsoncooks,2105,0,2,3,5,40.0%,14m
40354,1,[loscau]Deimos,2105,0,2,7,9,22.2%,2h
40354,2,Otto,2105,0,0,1,1,0.0%,13m
40354,2,Killerfish,2105,0,0,2,2,0.0%,2h
40354,1,Sumyeungai,2105,0,0,3,3,0.0%,2h
40354,2,scanhort,2105,0,0,4,4,0.0%,23m
40372,1,NDubbz,2104,1087,134,127,261,51.3%,6m
40372,2,SpecForces,2104,1628,118,111,229,51.5%,2h
40372,2,automator,2104,1631,84,78,162,51.9%,35m
40372,3,Verme,2104,1432,72,74,146,49.3%,23m
40372,2,MacroNCheese,2104,202,31,9,40,77.5%,2h
40372,1,sup,2104,595,22,24,46,47.8%,2h
40372,2,CptSacTap,2104,385,18,10,28,64.3%,2h
40372,1,[EpicG]frostsoul,2104,433,18,20,38,47.4%,2h
40372,1,Lestibournes,2104,234,7,12,19,36.8%,12m
40372,2,Kormania,2104,96,5,3,8,62.5%,2h
40372,1,STRAKER,2104,143,4,3,7,57.1%,17m
40372,3,Silverdeer,2104,140,4,10,14,28.6%,2h
40372,3,Dreamsteve,2104,60,3,8,11,27.3%,2h
40372,1,Spartan,2104,36,2,6,8,25.0%,3h
40372,3,LemonSpectre,2104,0,1,0,1,100.0%,2h
40372,2,enller,2104,40,1,7,8,12.5%,50m
40372,3,[ERMDL]Lordjulio,2104,0,1,7,8,12.5%,38m
40372,2,Ramon,2104,0,0,1,1,0.0%,41m
40372,2,[CPPY]intrinsicPT,2104,0,0,1,1,0.0%,45m
40372,2,walten,2104,0,0,1,1,0.0%,39m
40372,2,GeneralBlu,2104,0,0,1,1,0.0%,2h
40372,2,Rainkiller,2104,0,0,2,2,0.0%,2h
40372,2,CoNQueRRoR,2104,0,0,3,3,0.0%,2h
40372,2,CRISTIAN,2104,0,0,5,5,0.0%,46m
40396,1,Dave,2103,1290,68,83,151,45.0%,2h
40396,2,[SyLx]Ikon,2103,610,64,69,133,48.1%,2h
40396,3,RobertEd,2103,1152,43,56,99,43.4%,2h
40396,2,Spideybih,2103,861,35,32,67,52.2%,2h
40396,2,Daniel,2103,375,17,6,23,73.9%,52m
40396,1,kuro,2103,532,17,23,40,42.5%,44m
40396,1,BetterThanU,2103,380,12,12,24,50.0%,17m
40396,2,freddy,2103,290,10,17,27,37.0%,2h
40396,3,Benji,2103,223,7,15,22,31.8%,2h
40396,2,andmoo,2103,160,5,1,6,83.3%,2h
40396,2,[Rkkla]Jack,2103,154,3,7,10,30.0%,2h
40396,2,FafaLeGrand,2103,30,2,1,3,66.7%,39m
40396,2,vinidinogs,2103,92,2,7,9,22.2%,15m
40396,2,alen,2103,46,1,2,3,33.3%,6m
40396,2,Freeclear,2103,36,1,2,3,33.3%,38m
40396,2,Dineley,2103,0,0,1,1,0.0%,31m
40396,2,donden,2103,0,0,1,1,0.0%,23m
40396,1,[hLioS]bussi,2103,0,0,2,2,0.0%,2h
40396,2,RealDiego,2103,0,0,2,2,0.0%,38m
40396,2,JhonShops,2103,0,0,5,5,0.0%,2h
40396,2,Nanonater,2103,0,0,6,6,0.0%,2h
40417,1,superdragon,2102,1050,71,64,135,52.6%,2h
40417,3,spartan,2102,1410,58,73,131,44.3%,53m
40417,2,Kang,2102,484,18,11,29,62.1%,2h
40417,1,Azn,2102,415,17,19,36,47.2%,23m
40417,2,ThotGodd,2102,388,14,18,32,43.8%,46m
40417,2,Wendigo,2102,208,9,7,16,56.2%,46m
40417,2,Globetrot,2102,258,9,12,21,42.9%,2h
40417,2,knuckles,2102,142,5,3,8,62.5%,2h
40417,2,TheWitch,2102,116,5,3,8,62.5%,2h
40417,1,chongo,2102,119,5,5,10,50.0%,2h
40417,3,Rhomark,2102,152,4,11,15,26.7%,2h
40417,2,FourJuBu,2102,38,2,1,3,66.7%,2h
40417,2,[tsmi]Moon,2102,72,2,4,6,33.3%,2h
40417,3,ChosenOne,2102,30,2,8,10,20.0%,28m
40417,1,Freek,2102,48,2,8,10,20.0%,51m
40417,1,Webbshot,2102,38,2,8,10,20.0%,3h
40417,2,[DRKFOX]lllArianalll,2102,46,1,2,3,33.3%,2h
40417,1,iponx,2102,94,1,3,4,25.0%,2h
40417,1,axton,2102,0,1,6,7,14.3%,2h
40417,2,UCMBRO,2102,0,0,1,1,0.0%,3m
40417,2,MatyGdF,2102,0,0,1,1,0.0%,39m
40438,2,seashepherd,2101,1432,75,74,149,50.3%,2h
40438,1,Tagapaslang,2101,317,13,13,26,50.0%,2h
40438,2,ActividadZ,2101,253,10,9,19,52.6%,2h
40438,2,ModenaDj,2101,306,10,12,22,45.5%,2h
40438,1,RUPAMA,2101,346,10,14,24,41.7%,35m
40438,2,Hassasin,2101,228,6,3,9,66.7%,23m
40438,2,Soren,2101,180,6,5,11,54.5%,2h
40438,2,JEDI,2101,222,6,7,13,46.2%,21m
40438,3,Cloud,2101,176,5,12,17,29.4%,38m
40438,2,nerok,2101,92,4,3,7,57.1%,48m
40438,1,xclinthonx,2101,122,4,10,14,28.6%,2h
40438,2,[JUGOS]JGRIMALDI,2101,90,3,6,9,33.3%,2h
40438,2,Shadownata,2101,0,1,0,1,100.0%,2h
40438,1,Janir,2101,0,1,6,7,14.3%,29m
40438,1,itsme,2101,0,1,6,7,14.3%,2h
40438,1,EAR,2101,0,1,7,8,12.5%,2h
40438,2,[DgPx]Allshady,2101,0,0,1,1,0.0%,2h
40438,2,[DTKing]Gorthon,2101,0,0,1,1,0.0%,2h
40438,2,Tucson,2101,0,0,1,1,0.0%,2h
40438,2,SpiderMaxio,2101,0,0,2,2,0.0%,45m
40438,1,[NNOOT]LargeOrange,2101,0,0,2,2,0.0%,2h
40438,2,Takelot,2101,0,0,2,2,0.0%,50m
40438,2,VDPtas,2101,0,0,3,3,0.0%,3h
40438,2,Hunt,2101,0,0,5,5,0.0%,32m
40462,1,Prinkipia,2100,1548,147,144,291,50.5%,2h
40462,1,LivingWater,2100,551,36,35,71,50.7%,9m
40462,2,[KhanZ]PRIETONEGRIN,2100,416,25,28,53,47.2%,2h
40462,2,EDWIN,2100,497,15,22,37,40.5%,2h
40462,2,[TJOLIN]Macedonia,2100,419,14,14,28,50.0%,37m
40462,2,HappyRangers,2100,350,12,19,31,38.7%,45m
40462,1,Neptune,2100,239,9,9,18,50.0%,2h
40462,2,Zerofsgiven,2100,98,6,5,11,54.5%,41m
40462,2,[DIZA]zanto,2100,196,5,10,15,33.3%,35m
40462,3,Veritas,2100,90,5,12,17,29.4%,2h
40462,2,AsTiGmaT,2100,221,5,13,18,27.8%,37m
40462,2,chimpanzee,2100,90,3,4,7,42.9%,2h
40462,1,JEXTAR,2100,114,3,6,9,33.3%,46m
40462,1,[zNRCz]watcheR,2100,120,2,1,3,66.7%,55m
40462,2,[JUJUY]ZeratulCor,2100,0,1,0,1,100.0%,32m
40462,2,BOBOBOBOBOBO,2100,0,1,0,1,100.0%,41m
40462,1,NalaDak,2100,0,1,6,7,14.3%,42m
40462,2,Antonio,2100,0,0,1,1,0.0%,2h
40462,2,DroidSlayer,2100,0,0,5,5,0.0%,2h
40462,1,[MMSTAR]NBR,2100,0,0,6,6,0.0%,13m
40482,3,Jmorfa,2099,1187,139,141,280,49.6%,2h
40482,2,TTH,2099,307,11,7,18,61.1%,2h
40482,2,Lucca,2099,229,11,10,21,52.4%,39m
40482,1,StarCars,2099,356,9,18,27,33.3%,3h
40482,3,Cursor,2099,184,5,14,19,26.3%,2h
40482,1,FierceDeity,2099,164,4,8,12,33.3%,15m
40482,3,HAYDO,2099,72,4,13,17,23.5%,2h
40482,2,[NR6]RICOXXX,2099,58,2,7,9,22.2%,2h
40482,3,ShadowDragon,2099,30,1,2,3,33.3%,2h
40482,2,DRONEXXX,2099,30,1,2,3,33.3%,2h
40482,2,MachineFrien,2099,30,1,4,5,20.0%,2h
40482,2,hellthunder,2099,0,0,5,5,0.0%,2h
40482,2,villaleon,2099,0,0,5,5,0.0%,50m
40495,1,Lotus,2098,1592,154,166,320,48.1%,46m
40495,1,Keifer,2098,1081,74,85,159,46.5%,41m
40495,2,[FAYA]LARAYA,2098,1005,51,57,108,47.2%,2h
40495,2,Noezu,2098,731,30,21,51,58.8%,2h
40495,2,Desriden,2098,295,13,16,29,44.8%,2h
40495,1,Topus,2098,266,9,12,21,42.9%,2h
40495,2,Skoob,2098,210,8,10,18,44.4%,2h
40495,1,[UAK]SmokingZerg,2098,262,7,14,21,33.3%,40m
40495,1,[Stokr]Aldür,2098,183,5,7,12,41.7%,15m
40495,1,botswai,2098,0,4,4,8,50.0%,2h
40495,1,JDZNUTZ,2098,96,4,11,15,26.7%,2h
40495,2,Ludo,2098,58,3,1,4,75.0%,3m
40495,1,Jester,2098,142,3,6,9,33.3%,2h
40495,2,ZTARCRAFT,2098,102,3,7,10,30.0%,2h
40495,2,KEPO,2098,32,2,2,4,50.0%,48m
40495,1,Akrilux,2098,96,2,3,5,40.0%,52m
40495,2,GmbAriola,2098,60,2,4,6,33.3%,2h
40495,2,GoyimPatrol,2098,117,2,5,7,28.6%,32m
40495,2,VanWalker,2098,0,1,0,1,100.0%,2h
40495,2,[Jhoder]Derpanadero,2098,0,1,0,1,100.0%,3m
40495,3,Cyninja,2098,97,1,2,3,33.3%,40m
40495,2,Daiggu,2098,93,1,5,6,16.7%,2h
40495,2,bandALEchuga,2098,30,1,7,8,12.5%,2h
40495,2,Crimith,2098,0,0,1,1,0.0%,2h
40495,2,massmatic,2098,0,0,3,3,0.0%,2h
40520,2,ALCHIMIUZ,2097,1454,59,54,113,52.2%,2h
40520,1,stas,2097,835,46,56,102,45.1%,3h
40520,1,Drath,2097,1040,40,42,82,48.8%,2h
40520,2,[Dvier]Cruiser,2097,907,38,36,74,51.4%,2h
40520,2,Vincent,2097,600,26,18,44,59.1%,3m
40520,2,[ssqeez]Bruce,2097,710,26,23,49,53.1%,2h
40520,1,[MARIO6]magolunatico,2097,682,21,33,54,38.9%,40m
40520,2,JerryTheFly,2097,528,18,21,39,46.2%,2h
40520,3,Blazifmosif,2097,500,18,28,46,39.1%,2h
40520,2,[xXGDXx]SleazyTrojan,2097,358,12,18,30,40.0%,48m
40520,1,LUCIFER,2097,303,9,18,27,33.3%,2h
40520,3,CringeTheory,2097,249,8,10,18,44.4%,2h
40520,2,Gryphos,2097,206,7,8,15,46.7%,2h
40520,2,badrhari,2097,214,7,12,19,36.8%,2h
40520,2,hsoj,2097,157,5,1,6,83.3%,52m
40520,2,Clougan,2097,120,5,3,8,62.5%,39m
40520,1,VictorASH,2097,224,5,11,16,31.2%,10m
40520,1,BelondBelond,2097,190,5,11,16,31.2%,2h
40520,2,Princess,2097,48,2,5,7,28.6%,51m
40520,1,[Crip1]milodon,2097,0,1,2,3,33.3%,10m
40520,2,WorgenRobot,2097,0,1,3,4,25.0%,2h
40520,2,THT,2097,0,1,3,4,25.0%,2h
40520,3,ALVARO,2097,0,1,8,9,11.1%,11m
40520,2,KJiggy,2097,0,0,1,1,0.0%,2h
40520,2,Sparticus,2097,0,0,2,2,0.0%,39m
40520,2,[cluez]Jostin,2097,0,0,2,2,0.0%,2h
40520,2,matson,2097,0,0,5,5,0.0%,2h
40547,2,SkyDrifter,2096,1627,66,70,136,48.5%,39m
40547,2,Greatheart,2096,1296,62,57,119,52.1%,41m
40547,2,Pedrinho,2096,699,28,23,51,54.9%,24m
40547,2,tazadar,2096,420,14,10,24,58.3%,2h
40547,2,Solomon,2096,412,14,17,31,45.2%,2h
40547,3,[BLT666]wil,2096,260,11,13,24,45.8%,2h
40547,1,Hodejeger,2096,206,7,4,11,63.6%,2h
40547,2,[andon]Legend,2096,150,5,5,10,50.0%,3m
40547,1,Moondog,2096,162,4,9,13,30.8%,2h
40547,2,Andrew,2096,58,2,1,3,66.7%,2h
40547,2,Cuddles,2096,30,1,2,3,33.3%,2h
40547,2,Krang,2096,0,1,5,6,16.7%,2h
40547,1,[Wat3rs]MOLA,2096,0,1,5,6,16.7%,3h
40547,1,jeanpaul,2096,0,1,7,8,12.5%,2h
40547,1,[ulost]PROGAMERXXX,2096,0,0,1,1,0.0%,2h
40547,2,Sam,2096,0,0,3,3,0.0%,2h
40547,2,Retro,2096,0,0,5,5,0.0%,2h
40564,1,Deadlykitten,2095,1719,151,157,308,49.0%,26m
40564,2,JRODBIZZO,2095,649,104,105,209,49.8%,2h
40564,1,ColTanko,2095,430,14,18,32,43.8%,2h
40564,2,jarethjl,2095,300,10,11,21,47.6%,2h
40564,2,TITAN,2095,260,8,16,24,33.3%,2h
40564,2,Ynkara,2095,307,7,16,23,30.4%,14m
40564,2,RAHL,2095,198,6,10,16,37.5%,2h
40564,2,Crazydog,2095,166,5,3,8,62.5%,2h
40564,2,[AbcCo]JorgeReyy,2095,189,5,7,12,41.7%,2h
40564,2,VinDangerous,2095,0,1,1,2,50.0%,6m
40564,2,Dex,2095,0,1,1,2,50.0%,2h
40564,1,meanie,2095,0,1,6,7,14.3%,26m
40564,1,[TMDE]Mala,2095,0,1,7,8,12.5%,52m
40564,2,[BruC]Dave,2095,0,0,1,1,0.0%,2h
40564,2,[ExcIgN]JAVICHIDO,2095,0,0,1,1,0.0%,2h
40579,2,LeeNR,2094,1324,47,60,107,43.9%,46m
40579,3,WINd,2094,976,36,45,81,44.4%,8m
40579,3,[Mecha]Cafeina,2094,1026,36,49,85,42.4%,17m
40579,1,Spanky,2094,912,30,39,69,43.5%,55m
40579,1,[NAC2]IBeetle,2094,274,11,9,20,55.0%,2h
40579,1,Minedame,2094,230,7,8,15,46.7%,17m
40579,2,Leafar,2094,154,7,8,15,46.7%,2h
40579,3,DrPepper,2094,223,7,13,20,35.0%,9m
40579,2,EvilEoz,2094,175,5,3,8,62.5%,2h
40579,1,CyberTiger,2094,154,4,8,12,33.3%,24m
40579,2,Linkkair,2094,36,3,4,7,42.9%,46m
40579,2,Shadow,2094,48,1,7,8,12.5%,5m
40579,2,demartin,2094,0,0,1,1,0.0%,34m
40579,2,nerdynomad,2094,0,0,2,2,0.0%,2h
40579,2,panda,2094,0,0,2,2,0.0%,39m
40579,2,BurritoBoy,2094,0,0,3,3,0.0%,52m
40579,2,LaPrimaNerda,2094,0,0,5,5,0.0%,26m
40579,2,lobezesno,2094,0,0,5,5,0.0%,55m
40597,1,[TXV]jetmag,2093,1662,75,85,160,46.9%,9m
40597,1,boomstick,2093,607,36,48,84,42.9%,46m
40597,2,TomTom,2093,474,20,16,36,55.6%,2h
40597,3,liljohnny,2093,412,13,28,41,31.7%,2h
40597,2,KentNizzy,2093,358,12,14,26,46.2%,3h
40597,2,Sugram,2093,348,11,12,23,47.8%,2h
40597,1,finbalor,2093,312,11,16,27,40.7%,6m
40597,1,Razevedo,2093,319,10,16,26,38.5%,2h
40597,1,poeta,2093,270,8,15,23,34.8%,2h
40597,1,Craigcellent,2093,191,7,14,21,33.3%,2h
40597,2,wheresCHAVO,2093,30,6,1,7,85.7%,45m
40597,2,UncleSam,2093,166,5,1,6,83.3%,2h
40597,2,Anluri,2093,126,5,6,11,45.5%,2h
40597,2,Makawy,2093,156,5,10,15,33.3%,2h
40597,2,Valkyrie,2093,219,4,9,13,30.8%,2h
40597,1,PenDragon,2093,112,4,9,13,30.8%,17m
40597,2,Xyclon,2093,0,3,2,5,60.0%,50m
40597,2,ElChangoFeo,2093,60,3,6,9,33.3%,24m
40597,1,ZAGO,2093,136,2,5,7,28.6%,15m
40597,2,Jonathan,2093,0,1,4,5,20.0%,2h
40597,2,Zulu,2093,0,0,1,1,0.0%,31m
40597,2,[EmKni]Khyber,2093,0,0,3,3,0.0%,2h
40619,2,[GSP0T]NachThat,2092,784,47,44,91,51.6%,2h
40619,2,NomHok,2092,513,45,62,107,42.1%,2h
40619,1,CertVic,2092,814,28,38,66,42.4%,2h
40619,1,sAz,2092,546,21,26,47,44.7%,54m
40619,1,lionpro,2092,525,20,22,42,47.6%,2h
40619,2,[PiN0YS]youngone,2092,328,12,12,24,50.0%,2h
40619,2,UncleBoy,2092,155,7,6,13,53.8%,2h
40619,2,GhengisMango,2092,86,4,2,6,66.7%,2h
40619,2,[Idea]Wingsta,2092,191,4,4,8,50.0%,2h
40619,2,ShadowTitan,2092,30,2,0,2,100.0%,45m
40619,3,CriscoDisco,2092,122,2,5,7,28.6%,2h
40619,1,juggala,2092,0,2,7,9,22.2%,2h
40619,1,obito,2092,0,1,4,5,20.0%,40m
40619,2,DontHaveID,2092,46,1,7,8,12.5%,2h
40619,2,Ismael,2092,0,0,1,1,0.0%,45m
40619,1,MemeStalker,2092,0,0,2,2,0.0%,10m
40635,2,URprllySOmad,2091,1468,78,63,141,55.3%,2h
40635,1,JCAL,2091,1458,53,52,105,50.5%,2h
40635,2,Salvador,2091,612,22,27,49,44.9%,46m
40635,2,sTrAnGeBiRd,2091,472,19,14,33,57.6%,2h
40635,1,[snafer]Mastermind,2091,571,19,21,40,47.5%,2h
40635,1,Dreadnaught,2091,458,15,22,37,40.5%,43m
40635,2,[TuxCla]Alx,2091,366,12,17,29,41.4%,54m
40635,1,[XpKAc]SeraGraM,2091,288,9,16,25,36.0%,28m
40635,2,Jetpackracer,2091,244,8,6,14,57.1%,2h
40635,2,FireNewt,2091,186,8,16,24,33.3%,54m
40635,2,[ezzzz1]JACKS,2091,178,7,9,16,43.8%,2h
40635,2,[IMDSI]sebastian,2091,182,5,7,12,41.7%,39m
40635,1,degoplay,2091,108,4,10,14,28.6%,2h
40635,2,[Sqwsh]HyperNova,2091,119,2,2,4,50.0%,2h
40635,1,[GDKND]zorg,2091,46,2,4,6,33.3%,47m
40635,3,Sidewinder,2091,95,2,4,6,33.3%,38m
40635,1,thorswrath,2091,44,2,8,10,20.0%,55m
40635,2,Hydralicious,2091,0,1,1,2,50.0%,2h
40635,2,saqra,2091,0,1,1,2,50.0%,39m
40635,1,PolixMaster,2091,0,1,3,4,25.0%,3h
40635,1,[LMI42]CoolingArc,2091,0,1,7,8,12.5%,52m
40635,1,gunbelch,2091,0,1,8,9,11.1%,2h
40635,3,NEGON,2091,0,1,9,10,10.0%,47m
40635,2,Ragnarok,2091,0,0,2,2,0.0%,50m
40635,1,CleOps,2091,0,0,2,2,0.0%,26m
40635,2,lifeson,2091,0,0,5,5,0.0%,15m
40661,2,meanstreak,2090,1603,74,73,147,50.3%,46m
40661,2,Jose,2090,435,19,14,33,57.6%,47m
40661,2,Flex,2090,492,18,20,38,47.4%,45m
40661,2,Heman,2090,284,11,9,20,55.0%,55m
40661,1,playboys,2090,337,9,11,20,45.0%,2h
40661,2,Ziegfried,2090,242,7,10,17,41.2%,2h
40661,3,MAQUINAJHON,2090,110,6,11,17,35.3%,2h
40661,1,ELSCORCH,2090,168,5,15,20,25.0%,3h
40661,2,ezeld,2090,138,4,1,5,80.0%,13m
40661,1,[GATOR1]TINOCO,2090,128,4,8,12,33.3%,2h
40661,1,Beto,2090,193,4,10,14,28.6%,2h
40661,1,Juicebox,2090,119,2,3,5,40.0%,2h
40661,1,GabrielGP,2090,36,2,7,9,22.2%,53m
40661,2,earthaven,2090,30,1,2,3,33.3%,2h
40661,2,Gilford,2090,0,0,5,5,0.0%,2h
40661,2,dunkine,2090,0,0,5,5,0.0%,2h
40661,2,AmurokDD,2090,0,0,5,5,0.0%,2h
40678,2,alex,2089,660,42,58,100,42.0%,14m
40678,2,Wind,2089,386,26,23,49,53.1%,2h
40678,2,Zergalerg,2089,457,25,29,54,46.3%,2h
40678,2,Sargasm,2089,594,21,25,46,45.7%,35m
40678,1,Mino,2089,566,17,20,37,45.9%,2h
40678,2,Dom,2089,326,12,10,22,54.5%,21m
40678,1,chaman,2089,177,6,6,12,50.0%,2h
40678,2,warlem,2089,136,5,7,12,41.7%,21m
40678,1,[z2o]ZurdO,2089,202,5,14,19,26.3%,2h
40678,2,JeffDahmer,2089,136,4,4,8,50.0%,2h
40678,2,camelloloko,2089,62,3,5,8,37.5%,2h
40678,1,RelativeID,2089,84,3,9,12,25.0%,3h
40678,2,TheArtist,2089,44,2,1,3,66.7%,51m
40678,2,Chirps,2089,44,2,2,4,50.0%,2h
40678,1,[CRaPaN]IIIIIIIIIIII,2089,96,2,7,9,22.2%,30m
40678,2,Lakvinu,2089,88,1,1,2,50.0%,32m
40678,2,enrikeal,2089,0,1,6,7,14.3%,2h
40678,3,Ricky,2089,0,1,7,8,12.5%,2h
40678,1,ketch,2089,0,0,1,1,0.0%,2h
40678,2,HappyFunBall,2089,0,0,1,1,0.0%,50m
40678,2,ZeroJL,2089,0,0,3,3,0.0%,2h
40678,2,daishix,2089,0,0,5,5,0.0%,6m
40700,1,BigLunch,2088,1589,81,88,169,47.9%,2h
40700,1,KAPUA,2088,1189,79,78,157,50.3%,2h
40700,2,Arches,2088,360,37,36,73,50.7%,31m
40700,1,quickcash,2088,1010,34,43,77,44.2%,23m
40700,2,Treze,2088,546,25,17,42,59.5%,2h
40700,1,ffsanmar,2088,720,25,35,60,41.7%,14m
40700,2,JamesThePope,2088,540,20,19,39,51.3%,8m
40700,2,Zod,2088,328,11,13,24,45.8%,48m
40700,2,inbalance,2088,227,7,4,11,63.6%,2h
40700,2,kings,2088,117,5,2,7,71.4%,46m
40700,2,Pokemoso,2088,0,3,3,6,50.0%,30m
40700,3,SpEcTrE,2088,125,3,5,8,37.5%,15m
40700,2,reaper,2088,30,2,1,3,66.7%,2h
40700,2,kloud,2088,60,2,5,7,28.6%,6m
40700,2,[LeGen7]DevilMaster,2088,0,1,1,2,50.0%,6m
40700,1,Crixi,2088,0,1,1,2,50.0%,2h
40700,2,jeysoon,2088,0,0,1,1,0.0%,52m
40700,2,supermente,2088,0,0,4,4,0.0%,2h
40700,1,[5252]YesNoah,2088,0,0,4,4,0.0%,40m
40700,2,Thesuperamo,2088,0,0,5,5,0.0%,45m
40720,3,[INCoI]Kazi,2087,1530,591,629,1220,48.4%,54m
40720,1,Intrasync,2087,1035,76,87,163,46.6%,17m
40720,1,NotSoMuch,2087,1488,49,67,116,42.2%,2h
40720,2,akd,2087,778,30,28,58,51.7%,21m
40720,2,CaptainKay,2087,538,27,30,57,47.4%,3m
40720,2,Cjkmaa,2087,363,26,21,47,55.3%,14m
40720,2,[felpa]CuunooPlay,2087,347,25,22,47,53.2%,2h
40720,2,[TGosuD]XIACOM,2087,710,25,27,52,48.1%,8m
40720,2,Rotula,2087,432,17,13,30,56.7%,39m
40720,2,Fujbawz,2087,260,13,7,20,65.0%,45m
40720,2,SORAJIANG,2087,346,11,8,19,57.9%,2h
40720,3,ADGN,2087,260,8,9,17,47.1%,30m
40720,3,mojojoe,2087,233,7,14,21,33.3%,2h
40720,3,AleFreitas,2087,249,7,16,23,30.4%,2h
40720,2,Mandrake,2087,146,6,5,11,54.5%,52m
40720,2,GohanSSJ,2087,109,4,7,11,36.4%,6m
40720,2,coconutpie,2087,0,2,2,4,50.0%,35m
40720,2,XaRdOz,2087,0,0,1,1,0.0%,47m
40720,2,ART,2087,0,0,5,5,0.0%,2h
40720,2,BaneCentral,2087,0,0,5,5,0.0%,5m
40740,2,PickleRick,2086,1579,174,180,354,49.2%,3m
40740,1,mudinholll,2086,1561,138,156,294,46.9%,2h
40740,1,[LPG2]DaigoRoca,2086,1429,71,82,153,46.4%,46m
40740,2,GatoAzul,2086,1046,43,39,82,52.4%,2h
40740,2,Elíptica,2086,1075,40,39,79,50.6%,5m
40740,2,SANTIJAZA,2086,827,31,27,58,53.4%,41m
40740,2,[420SC2]Towel,2086,235,10,10,20,50.0%,2h
40740,2,OBZERV,2086,310,10,17,27,37.0%,2h
40740,3,Zaius,2086,271,9,8,17,52.9%,40m
40740,1,Warmounger,2086,169,4,9,13,30.8%,2h
40740,2,Caco,2086,30,2,4,6,33.3%,2h
40740,2,Grogswiper,2086,0,1,0,1,100.0%,25m
40740,1,[MACETA]KILLNITRON,2086,0,1,0,1,100.0%,2h
40740,1,GlazMain,2086,0,1,0,1,100.0%,2h
40740,2,HierarchKike,2086,46,1,1,2,50.0%,41m
40740,2,NEFI,2086,88,1,1,2,50.0%,37m
40740,2,[TAKANA]AlpacaPaloza,2086,93,1,1,2,50.0%,14m
40740,2,SaberLover,2086,0,1,2,3,33.3%,2h
40740,1,Avrose,2086,0,1,7,8,12.5%,2h
40740,1,ayudxt,2086,97,1,8,9,11.1%,8m
40740,3,Kraxor,2086,30,1,9,10,10.0%,2h
40740,2,AstyanaX,2086,0,0,1,1,0.0%,2h
40740,2,toontownlego,2086,0,0,1,1,0.0%,2h
40740,2,FartOnUrBase,2086,0,0,1,1,0.0%,3m
40740,2,Carmichael,2086,0,0,1,1,0.0%,41m
40740,2,[FPMR64]Skeleboner,2086,0,0,2,2,0.0%,33m
40740,1,PachuMC,2086,0,0,4,4,0.0%,47m
40740,2,Stormblessed,2086,0,0,5,5,0.0%,2h
40768,2,[M3A5]Hamurai,2085,943,108,115,223,48.4%,48m
40768,2,kenshiro,2085,1315,103,111,214,48.1%,2h
40768,2,Pinchbeef,2085,1479,77,68,145,53.1%,2h
40768,3,LudicruSpeed,2085,1516,65,75,140,46.4%,34m
40768,2,Monteclinto,2085,1212,47,51,98,48.0%,2h
40768,2,HighestDrumr,2085,678,25,25,50,50.0%,3h
40768,2,ThanhQuang,2085,453,21,14,35,60.0%,55m
40768,3,[Chods]Boz,2085,352,11,20,31,35.5%,38m
40768,1,Raeniell,2085,0,4,6,10,40.0%,2h
40768,2,dwqdwq,2085,84,3,7,10,30.0%,2h
40768,2,[OsM]BlackBuhr,2085,80,3,11,14,21.4%,2h
40768,2,neliojr,2085,0,1,0,1,100.0%,2h
40768,2,Bobralph,2085,32,1,1,2,50.0%,3m
40768,1,WARLEGS,2085,0,1,2,3,33.3%,42m
40768,2,Ruki,2085,32,1,4,5,20.0%,2h
40768,2,[DvaRKA]AlejandroAza,2085,0,0,1,1,0.0%,48m
40768,2,Gilbert,2085,0,0,1,1,0.0%,2h
40768,2,MrAceBoogie,2085,0,0,1,1,0.0%,39m
40768,1,Xilla,2085,0,0,1,1,0.0%,2h
40768,1,wendyswings,2085,0,0,2,2,0.0%,25m
40768,2,[nieBla]Kbrown,2085,0,0,4,4,0.0%,41m
40768,2,gerardo,2085,0,0,5,5,0.0%,2h
40768,2,Hayjak,2085,0,0,6,6,0.0%,2h
40791,2,CarpyRecon,2084,1416,159,178,337,47.2%,27m
40791,2,cosmic,2084,1403,78,77,155,50.3%,2h
40791,2,[VETS]DonOmar,2084,748,28,26,54,51.9%,2h
40791,2,[SWOU]ALaN,2084,263,21,18,39,53.8%,2h
40791,3,TitanAtom,2084,496,17,28,45,37.8%,34m
40791,1,Swampton,2084,239,7,10,17,41.2%,2h
40791,2,Einstein,2084,158,6,4,10,60.0%,2h
40791,2,ForAiur,2084,129,5,5,10,50.0%,2h
40791,2,RevanitE,2084,128,3,6,9,33.3%,2h
40791,2,JayyRR,2084,30,2,0,2,100.0%,2h
40791,1,[Bommmm]ProtossStap,2084,96,2,1,3,66.7%,50m
40791,2,EkulTails,2084,46,1,6,7,14.3%,52m
40791,2,soto,2084,0,0,1,1,0.0%,43m
40791,2,fruitypebbs,2084,0,0,1,1,0.0%,46m
40791,2,inota,2084,0,0,1,1,0.0%,2h
40791,1,jaYreadY,2084,0,0,4,4,0.0%,2h
40791,2,seventy,2084,0,0,5,5,0.0%,33m
40808,1,DrDabber,2083,547,101,104,205,49.3%,3h
40808,2,MattBotosan,2083,949,66,61,127,52.0%,46m
40808,1,elias,2083,1059,41,46,87,47.1%,2h
40808,1,EEHK,2083,408,16,20,36,44.4%,28m
40808,2,[CRaPaN]IIIIIIIIIII,2083,86,4,9,13,30.8%,2h
40808,2,RUSSlANHOOKR,2083,64,3,1,4,75.0%,41m
40808,1,mclusky,2083,145,3,16,19,15.8%,2h
40808,2,blckGsus,2083,58,2,1,3,66.7%,2h
40808,2,[40oztF]Dominus,2083,30,2,3,5,40.0%,46m
40808,2,MOhawk,2083,92,2,7,9,22.2%,2h
40808,2,Starlion,2083,0,2,9,11,18.2%,3m
40808,2,brnuno,2083,30,1,2,3,33.3%,2h
40808,2,Pappy,2083,0,1,5,6,16.7%,2h
40808,2,LLENN,2083,0,0,2,2,0.0%,25m
40808,2,Luis,2083,0,0,5,5,0.0%,41m
40823,1,BubbaKiller,2082,1257,43,45,88,48.9%,53m
40823,1,KingOfNerds,2082,1156,41,57,98,41.8%,2h
40823,1,Magic,2082,774,25,31,56,44.6%,28m
40823,2,[LDTJC]JcCharly,2082,604,23,20,43,53.5%,2h
40823,3,GetReckt,2082,249,10,14,24,41.7%,2h
40823,2,Optimus,2082,280,8,15,23,34.8%,2h
40823,2,Mikey,2082,160,5,4,9,55.6%,43m
40823,1,GbrLuiz,2082,145,5,9,14,35.7%,2h
40823,2,[TR0L]Virus,2082,100,4,6,10,40.0%,2h
40823,2,[C59]MegaManny,2082,92,3,6,9,33.3%,48m
40823,1,MISTIKO,2082,40,2,7,9,22.2%,2h
40823,1,Patrick,2082,42,2,7,9,22.2%,37m
40823,1,ckkang,2082,46,2,8,10,20.0%,36m
40823,1,ragegage,2082,122,2,9,11,18.2%,44m
40823,2,IIIIIIIIIIII,2082,0,1,0,1,100.0%,43m
40823,1,lSilvaxander,2082,0,1,0,1,100.0%,2h
40823,2,[missA]FuhCough,2082,97,1,7,8,12.5%,48m
40823,1,[smowe]SeanCity,2082,44,1,9,10,10.0%,3h
40823,2,izzyrendon,2082,0,0,2,2,0.0%,2h
40823,2,ElyasToor,2082,0,0,5,5,0.0%,41m
40823,2,INVASOR,2082,0,0,5,5,0.0%,41m
40823,2,glu,2082,0,0,5,5,0.0%,2h
40823,1,Dantiac,2082,0,0,8,8,0.0%,10m
40846,2,VOIKA,2081,1582,88,90,178,49.4%,2h
40846,1,kingfighter,2081,495,23,22,45,51.1%,37m
40846,2,[ØÛ]greedxgraff,2081,535,22,16,38,57.9%,3m
40846,2,BHS,2081,354,15,10,25,60.0%,24m
40846,2,StarXStrike,2081,385,11,17,28,39.3%,2h
40846,1,TractusUO,2081,371,11,18,29,37.9%,2h
40846,2,MacroZero,2081,258,10,9,19,52.6%,2h
40846,1,XTHEMASTER,2081,341,9,20,29,31.0%,45m
40846,1,lRoda,2081,236,8,10,18,44.4%,2h
40846,2,RAmzap,2081,193,7,6,13,53.8%,2h
40846,1,Coronachina,2081,171,6,8,14,42.9%,2h
40846,1,marshmellow,2081,169,5,8,13,38.5%,2h
40846,1,TugeNeko,2081,143,3,3,6,50.0%,2h
40846,2,KnightOKiss,2081,70,2,1,3,66.7%,2h
40846,2,Lieriant,2081,0,2,3,5,40.0%,33m
40846,1,MATO,2081,99,2,6,8,25.0%,15m
40846,2,[AXIOS]Bulbasore,2081,112,2,7,9,22.2%,45m
40846,2,Nightshade,2081,32,1,3,4,25.0%,35m
40846,2,[DB4D1]KingNick,2081,0,1,3,4,25.0%,14m
40846,3,tuturu,2081,0,1,7,8,12.5%,2h
40846,2,[ppS0ft]BuzzKillnton,2081,0,0,1,1,0.0%,2h
40846,2,WoolaThark,2081,0,0,2,2,0.0%,2h
40846,2,Nova,2081,0,0,2,2,0.0%,2h
40846,2,yavaa,2081,0,0,5,5,0.0%,2h
40870,1,FrostBite,2080,348,41,43,84,48.8%,53m
40870,2,ALF,2080,789,30,27,57,52.6%,2h
40870,2,Artanix,2080,644,29,24,53,54.7%,2h
40870,2,RafySan,2080,288,11,10,21,52.4%,41m
40870,2,SkullKrusher,2080,274,11,11,22,50.0%,14m
40870,3,raftol,2080,294,11,18,29,37.9%,2h
40870,2,Coburn,2080,330,11,21,32,34.4%,9m
40870,2,ICEMAN,2080,260,9,14,23,39.1%,31m
40870,2,DeadlyKitten,2080,224,8,7,15,53.3%,2h
40870,3,BlueShadow,2080,186,8,16,24,33.3%,37m
40870,2,andrew,2080,186,6,3,9,66.7%,2h
40870,3,Dragonspirit,2080,167,5,2,7,71.4%,5m
40870,2,Ospa,2080,134,4,8,12,33.3%,39m
40870,2,Zerox,2080,38,2,1,3,66.7%,2h
40870,2,Flshrep,2080,60,2,7,9,22.2%,2h
40870,1,Raven,2080,80,2,10,12,16.7%,42m
40870,2,Wove,2080,0,0,2,2,0.0%,2h
40870,2,Asderamdom,2080,0,0,3,3,0.0%,2h
40870,2,EDDY,2080,0,0,4,4,0.0%,43m
40870,2,[Puppr]SuperHira,2080,0,0,5,5,0.0%,46m
40890,2,XNeMeSySX,2079,1575,65,73,138,47.1%,2h
40890,2,Tiger,2079,1256,46,46,92,50.0%,2h
40890,2,SonicSoul,2079,425,17,10,27,63.0%,2h
40890,2,[FTFC]NoGimmicks,2079,315,13,7,20,65.0%,2h
40890,2,Desertor,2079,266,12,12,24,50.0%,2h
40890,2,DarKudo,2079,254,6,6,12,50.0%,2h
40890,2,Dubblekiller,2079,182,5,2,7,71.4%,2h
40890,2,these,2079,60,2,2,4,50.0%,2h
40890,1,[LETAL]Amón,2079,36,2,8,10,20.0%,2h
40890,1,Cole,2079,40,2,8,10,20.0%,2h
40890,2,BananaKush,2079,0,1,4,5,20.0%,45m
40890,2,Greygore,2079,0,0,1,1,0.0%,2h
40890,2,ANTUAN,2079,0,0,1,1,0.0%,43m
40890,2,FoamPlanet,2079,0,0,3,3,0.0%,52m
40890,2,Jay,2079,0,0,3,3,0.0%,2h
40890,2,[jenkk]veganseamen,2079,0,0,4,4,0.0%,55m
40906,2,Doppler,2078,1281,70,72,142,49.3%,2h
40906,1,WinterKnight,2078,1037,66,61,127,52.0%,2h
40906,2,vilachocolat,2078,1257,62,58,120,51.7%,2h
40906,1,glOpP,2078,804,24,36,60,40.0%,53m
40906,2,[MMSTAR]Luke,2078,507,17,25,42,40.5%,2h
40906,2,Thorn,2078,347,14,12,26,53.8%,2h
40906,2,thehobotroll,2078,283,11,5,16,68.8%,2h
40906,2,RaGe,2078,124,6,13,19,31.6%,22m
40906,1,ste,2078,97,3,7,10,30.0%,26m
40906,2,dex,2078,48,2,7,9,22.2%,5m
40906,2,MaxRoentgen,2078,58,2,7,9,22.2%,2h
40906,2,ZAIDSERG,2078,0,1,0,1,100.0%,39m
40906,2,[10GD]fataldefault,2078,30,1,6,7,14.3%,2h
40906,1,Kaspar,2078,0,1,7,8,12.5%,3h
40906,2,Odarii,2078,0,0,1,1,0.0%,2h
40906,2,Inarus,2078,0,0,1,1,0.0%,2h
40906,2,HellsCuy,2078,0,0,2,2,0.0%,2h
40906,1,Sloth,2078,0,0,2,2,0.0%,49m
40906,2,[KhanZ]Skye,2078,0,0,3,3,0.0%,2h
40925,2,charules,2077,1208,48,48,96,50.0%,2h
40925,2,LMBZKT,2077,861,33,36,69,47.8%,2h
40925,2,Adventurer,2077,453,17,16,33,51.5%,2h
40925,1,hello,2077,320,11,16,27,40.7%,2h
40925,2,BlackSkull,2077,299,10,9,19,52.6%,2h
40925,1,Fxx,2077,202,6,14,20,30.0%,2h
40925,2,marcopa,2077,184,4,4,8,50.0%,3h
40925,2,[Dorkz]DemoMan,2077,46,2,0,2,100.0%,55m
40925,2,walgrenz,2077,30,2,1,3,66.7%,38m
40925,2,Kahn,2077,62,2,1,3,66.7%,2h
40925,1,[Lamort]FabroManiac,2077,48,2,4,6,33.3%,3h
40925,2,DoomRaider,2077,30,2,6,8,25.0%,2h
40925,1,BLACKSMITH,2077,97,2,7,9,22.2%,2h
40925,2,Exclusive,2077,30,2,8,10,20.0%,2h
40925,1,MoncaiTheBig,2077,48,2,8,10,20.0%,2h
40925,1,GoochSting,2077,73,2,9,11,18.2%,3h
40925,2,GaRiK,2077,0,1,2,3,33.3%,2h
40925,2,cristian,2077,96,1,3,4,25.0%,45m
40925,2,Trilaksana,2077,30,1,4,5,20.0%,2h
40925,2,Dizzy,2077,0,1,4,5,20.0%,46m
40925,2,Ricardo,2077,0,1,5,6,16.7%,2h
40925,1,BoCharkstein,2077,0,1,7,8,12.5%,2h
40925,2,PerroGelido,2077,16,1,8,9,11.1%,46m
40925,2,[bigFan]FruitDealer,2077,0,0,1,1,0.0%,25m
40925,2,StellarNYT,2077,0,0,4,4,0.0%,5m
40925,2,zergOP,2077,0,0,5,5,0.0%,3m
40925,2,LukePhysics,2077,0,0,5,5,0.0%,2h
40952,2,Brentus,2076,917,78,95,173,45.1%,2h
40952,1,Jpablo,2076,1104,70,75,145,48.3%,2h
40952,3,kingkillyo,2076,923,33,48,81,40.7%,2h
40952,2,Wulfbang,2076,350,12,16,28,42.9%,32m
40952,2,Diablos,2076,413,12,21,33,36.4%,21m
40952,1,Nebula,2076,406,11,22,33,33.3%,2h
40952,2,Mikman,2076,164,6,7,13,46.2%,2h
40952,2,callmedadi,2076,120,6,10,16,37.5%,2h
40952,2,Dud,2076,140,4,3,7,57.1%,39m
40952,1,[QQQ]mugabeobama,2076,122,3,9,12,25.0%,55m
40952,2,Vicky,2076,30,2,0,2,100.0%,2h
40952,2,joshishoard,2076,30,2,0,2,100.0%,39m
40952,2,blackmesa,2076,30,2,4,6,33.3%,2h
40952,2,Rokxbot,2076,0,1,0,1,100.0%,2h
40952,2,GhostFox,2076,46,1,6,7,14.3%,14m
40952,1,tomaxz,2076,0,1,6,7,14.3%,2h
40952,1,Davix,2076,0,1,8,9,11.1%,2h
40952,2,cRoNus,2076,0,0,1,1,0.0%,2h
40952,2,Wilhelm,2076,0,0,5,5,0.0%,14m
40952,2,JORGE,2076,0,0,5,5,0.0%,2h
40952,2,trout,2076,0,0,5,5,0.0%,2h
40973,2,IIIIIIIIIIII,2075,689,74,84,158,46.8%,46m
40973,2,Frank,2075,618,34,30,64,53.1%,25m
40973,2,Taemin,2075,913,33,34,67,49.3%,6m
40973,2,mudd,2075,739,26,24,50,52.0%,2h
40973,1,xDarko,2075,636,18,28,46,39.1%,2h
40973,2,Gobstopper,2075,406,14,17,31,45.2%,2h
40973,1,Cinder,2075,193,5,8,13,38.5%,52m
40973,1,antares,2075,0,1,4,5,20.0%,2h
40973,2,[DePhi]SLICK,2075,38,1,5,6,16.7%,2h
40973,2,Vivio,2075,0,0,1,1,0.0%,2h
40973,2,Gallowglass,2075,0,0,3,3,0.0%,15m
40973,1,mar,2075,0,0,5,5,0.0%,30m
40973,2,bizarrarama,2075,0,0,5,5,0.0%,2h
40986,2,ELSTANLEE,2074,1556,76,76,152,50.0%,2h
40986,2,Zaxz,2074,588,50,47,97,51.5%,2h
40986,2,Horizon,2074,1145,48,52,100,48.0%,2h
40986,1,Graff,2074,1368,48,57,105,45.7%,2h
40986,2,LeonHard,2074,537,24,12,36,66.7%,2h
40986,2,GGLOLO,2074,384,21,12,33,63.6%,14m
40986,2,MuSclEHam,2074,234,8,10,18,44.4%,2h
40986,1,Kruadel,2074,20,5,9,14,35.7%,20m
40986,2,LeLoupFRA,2074,0,3,1,4,75.0%,33m
40986,2,GillyG,2074,94,2,5,7,28.6%,27m
40986,2,Mati,2074,0,1,0,1,100.0%,55m
40986,3,matasanos,2074,97,1,1,2,50.0%,2h
40986,2,SwarmingCris,2074,30,1,3,4,25.0%,2h
40986,2,LITIO,2074,0,0,1,1,0.0%,3m
40986,2,FloridaMan,2074,0,0,2,2,0.0%,27m
40986,2,[SACLyf]Cameinsecond,2074,0,0,3,3,0.0%,6m
41002,1,ochese,2073,1671,116,137,253,45.8%,46m
41002,1,Argentum,2073,1720,115,135,250,46.0%,6m
41002,2,Jalimrabei,2073,1442,82,84,166,49.4%,45m
41002,2,YASHA,2073,1061,45,52,97,46.4%,2h
41002,2,Pablo,2073,712,44,35,79,55.7%,2h
41002,2,PlsStop,2073,720,29,25,54,53.7%,25m
41002,2,YesC,2073,555,23,19,42,54.8%,2h
41002,1,AkkeSmash,2073,446,21,23,44,47.7%,28m
41002,2,NovaZerg,2073,602,20,27,47,42.6%,2h
41002,2,Ivan,2073,463,19,15,34,55.9%,2h
41002,1,[XOLDX]snowden,2073,563,18,31,49,36.7%,2h
41002,2,[BW7]secuencia,2073,545,17,19,36,47.2%,27m
41002,2,ideeitboy,2073,476,16,21,37,43.2%,39m
41002,2,[ILMG]Snkbrazil,2073,360,15,15,30,50.0%,2h
41002,2,FallenAngel,2073,382,14,16,30,46.7%,2h
41002,2,Mars,2073,294,10,16,26,38.5%,2h
41002,2,Livramento,2073,0,4,1,5,80.0%,2h
41002,1,Arima,2073,139,4,5,9,44.4%,53m
41002,1,Zorbeth,2073,121,3,1,4,75.0%,2h
41002,2,CandleGoat,2073,96,3,10,13,23.1%,38m
41002,2,[ASDK]AssassinsQc,2073,121,2,3,5,40.0%,25m
41002,1,SimbaSC,2073,48,1,1,2,50.0%,29m
41002,2,jjfninja,2073,88,1,1,2,50.0%,2h
41002,2,MachineIV,2073,0,1,5,6,16.7%,30m
41002,2,TakedaShinge,2073,0,1,5,6,16.7%,52m
41002,1,[ConFed]winnethepooh,2073,0,0,1,1,0.0%,26m
41002,2,VibratingOwl,2073,0,0,5,5,0.0%,30m
41029,2,[Kudos]OutLawCore,2072,1597,574,591,1165,49.3%,8m
41029,1,StormFarron,2072,1339,48,67,115,41.7%,2h
41029,2,jcarlos,2072,965,41,39,80,51.2%,2h
41029,2,[RAR3]Nshaffer,2072,789,39,27,66,59.1%,22m
41029,2,ZAYAS,2072,690,27,25,52,51.9%,2h
41029,2,Exocet,2072,432,17,12,29,58.6%,46m
41029,1,Alxndrep,2072,264,12,19,31,38.7%,16m
41029,2,[Eggers]Larfleeze,2072,226,7,8,15,46.7%,41m
41029,2,Stub,2072,142,6,8,14,42.9%,25m
41029,2,oStratigos,2072,114,4,9,13,30.8%,2h
41029,1,CGxFatal,2072,141,3,4,7,42.9%,42m
41029,1,Drenix,2072,96,3,5,8,37.5%,51m
41029,2,heeryu,2072,30,2,1,3,66.7%,2h
41029,3,Garusix,2072,94,2,8,10,20.0%,30m
41029,1,[cranky]sonda,2072,0,1,6,7,14.3%,22m
41029,2,NotsoImba,2072,0,1,6,7,14.3%,15m
41029,2,[iTos]HawkEye,2072,0,0,1,1,0.0%,2h
41029,2,[Bhros]Feljator,2072,0,0,1,1,0.0%,5m
41029,2,luis,2072,0,0,2,2,0.0%,52m
41029,2,drak,2072,0,0,2,2,0.0%,14m
41029,1,[ConFed]StephanCF,2072,0,0,3,3,0.0%,2h
41029,2,Omar,2072,0,0,5,5,0.0%,5m
41051,2,jinmo,2071,1397,102,96,198,51.5%,36m
41051,2,Mac,2071,1469,64,62,126,50.8%,21m
41051,2,Constantine,2071,682,26,27,53,49.1%,14m
41051,1,[OMGAT]fire,2071,618,20,31,51,39.2%,43m
41051,2,BASBOIVIN,2071,416,15,16,31,48.4%,2h
41051,1,Constantine,2071,292,9,5,14,64.3%,30m
41051,1,carlosfav,2071,324,8,20,28,28.6%,3h
41051,2,GoodKnight,2071,204,7,7,14,50.0%,2h
41051,1,Outlier,2071,192,6,7,13,46.2%,7m
41051,2,imoldy,2071,149,4,10,14,28.6%,2h
41051,1,[Crxea]Shadow,2071,164,3,4,7,42.9%,29m
41051,2,[TMKOs]Grifing,2071,187,3,9,12,25.0%,2h
41051,1,Coolaid,2071,149,3,10,13,23.1%,26m
41051,1,Ender,2071,116,2,1,3,66.7%,10m
41051,2,DarkSide,2071,0,1,1,2,50.0%,2h
41051,2,[cluez]Killer,2071,0,1,4,5,20.0%,2h
41051,2,Fuino,2071,0,1,6,7,14.3%,30m
41051,2,Lenin,2071,0,0,1,1,0.0%,2h
41051,2,[a1vNA]corvus,2071,0,0,5,5,0.0%,2h
41051,2,Goomba,2071,0,0,5,5,0.0%,39m
41071,1,NEZfire,2070,1359,200,220,420,47.6%,2h
41071,1,justingold,2070,1581,174,181,355,49.0%,2h
41071,2,Mohamed,2070,1194,136,150,286,47.6%,21m
41071,1,SoulAndemian,2070,876,31,32,63,49.2%,30m
41071,2,NickGerlips,2070,335,12,8,20,60.0%,2h
41071,1,[NTINE]gabriel,2070,374,12,16,28,42.9%,2h
41071,2,Miguel,2070,273,11,14,25,44.0%,2h
41071,2,Wham,2070,291,10,7,17,58.8%,2h
41071,2,Chingomato,2070,218,9,10,19,47.4%,2h
41071,2,Shadow,2070,266,8,13,21,38.1%,2h
41071,2,theAudacity,2070,154,6,3,9,66.7%,2h
41071,2,HeroHamster,2070,159,5,4,9,55.6%,2h
41071,2,ZerTossAn,2070,158,5,10,15,33.3%,2h
41071,1,Gunningham,2070,150,5,14,19,26.3%,41m
41071,2,cheetah,2070,40,3,4,7,42.9%,2h
41071,2,MementoMori,2070,86,3,7,10,30.0%,3h
41071,1,jaipeso,2070,78,3,9,12,25.0%,22m
41071,2,Player,2070,88,2,0,2,100.0%,2h
41071,1,Minsk,2070,48,2,3,5,40.0%,55m
41071,2,Sincommitted,2070,0,0,1,1,0.0%,2h
41071,2,oliverLetsGo,2070,0,0,1,1,0.0%,2h
41071,2,Awwwsm,2070,0,0,1,1,0.0%,5m
41071,2,kamizane,2070,0,0,2,2,0.0%,52m
41071,3,Humanist,2070,0,0,5,5,0.0%,2h
41095,1,GoToSleep,2069,1315,124,128,252,49.2%,2h
41095,1,[4ZKN]HatriXXX,2069,620,104,104,208,50.0%,2h
41095,2,[USMVMC]Hooligan,2069,459,20,12,32,62.5%,3h
41095,2,Maveriik,2069,520,20,21,41,48.8%,35m
41095,2,danibkd,2069,504,17,17,34,50.0%,2h
41095,2,BigMick,2069,406,15,18,33,45.5%,14m
41095,2,Lumpy,2069,344,12,17,29,41.4%,50m
41095,2,JohnnyDeep,2069,350,11,12,23,47.8%,2h
41095,1,Dyllan,2069,195,5,7,12,41.7%,2h
41095,2,hasuprobe,2069,126,4,0,4,100.0%,45m
41095,3,BrewedWar,2069,123,3,5,8,37.5%,42m
41095,2,KobyashiMaru,2069,44,1,6,7,14.3%,50m
41095,2,Insane,2069,0,0,2,2,0.0%,2h
41108,1,Draco,2068,1386,82,90,172,47.7%,29m
41108,2,[NUBLET]Inscandence,2068,1583,68,73,141,48.2%,54m
41108,2,[2020]TALON,2068,1166,43,48,91,47.3%,39m
41108,2,[CDNB]Darkomega,2068,495,16,19,35,45.7%,46m
41108,1,charlypek,2068,367,15,23,38,39.5%,2h
41108,2,[NUFAN]zluk,2068,404,14,17,31,45.2%,2h
41108,2,FlavaFlav,2068,330,11,14,25,44.0%,38m
41108,2,arepechicos,2068,251,8,7,15,53.3%,2h
41108,3,[DASUL]SOLITARIO,2068,126,7,10,17,41.2%,7m
41108,3,IceCold,2068,87,5,12,17,29.4%,47m
41108,2,Eimfee,2068,60,3,6,9,33.3%,54m
41108,2,Dcapri,2068,34,2,6,8,25.0%,2h
41108,1,Shikoa,2068,48,2,8,10,20.0%,2h
41108,2,SwallowMyPwn,2068,0,1,0,1,100.0%,25m
41108,1,Thørn,2068,0,1,6,7,14.3%,17m
41108,2,[NM8]Zombie,2068,0,1,10,11,9.1%,2h
41108,2,STARKING,2068,0,0,1,1,0.0%,2h
41108,2,RokaCola,2068,0,0,2,2,0.0%,3h
41108,2,[etique]azure,2068,0,0,3,3,0.0%,2h
41108,2,Imrahil,2068,0,0,5,5,0.0%,2h
41128,1,hmptfrancis,2067,1639,246,269,515,47.8%,15m
41128,1,HelloKitty,2067,1142,71,101,172,41.3%,39m
41128,1,Eidean,2067,1485,51,64,115,44.3%,3h
41128,1,cmc,2067,863,44,48,92,47.8%,2h
41128,2,Chestiter,2067,247,10,12,22,45.5%,2h
41128,2,Cluitarhero,2067,172,7,4,11,63.6%,2h
41128,2,[TPGZ]JakTheRipper,2067,133,6,3,9,66.7%,2h
41128,2,dichcmnr,2067,130,5,4,9,55.6%,2h
41128,1,aaaaaaohhhh,2067,162,5,14,19,26.3%,3m
41128,2,Rustmuggins,2067,92,4,4,8,50.0%,50m
41128,2,ChiruChiru,2067,118,4,9,13,30.8%,2h
41128,1,Storyteller,2067,166,3,6,9,33.3%,2h
41128,2,kylooter,2067,46,2,2,4,50.0%,2h
41128,1,HipsterMus,2067,36,2,7,9,22.2%,23m
41128,1,jhudihangel,2067,48,2,8,10,20.0%,2h
41128,1,Alexander,2067,48,1,5,6,16.7%,22m
41128,2,KingGoonba,2067,44,1,6,7,14.3%,33m
41128,2,[lmflui]Francius,2067,30,1,6,7,14.3%,3h
41128,1,thatnoobisme,2067,46,1,7,8,12.5%,29m
41128,1,Mooncake,2067,0,1,7,8,12.5%,2h
41128,2,bettsy,2067,0,0,2,2,0.0%,31m
41128,2,Idhrenion,2067,0,0,5,5,0.0%,2h
41128,2,ETERNALDARK,2067,0,0,6,6,0.0%,22m
41128,1,xiongmaohehe,2067,0,0,7,7,0.0%,2h
41152,2,HUUTUANPRO,2066,524,19,19,38,50.0%,2h
41152,2,stormshadow,2066,482,18,18,36,50.0%,2h
41152,2,[OrNos]Telkicel,2066,158,7,19,26,26.9%,4m
41152,1,SneakyTurtle,2066,46,4,6,10,40.0%,2h
41152,1,JABC,2066,116,3,10,13,23.1%,2h
41152,2,fiftyshades,2066,60,2,4,6,33.3%,2h
41152,2,EDU,2066,0,1,0,1,100.0%,2h
41152,2,Slundy,2066,0,0,1,1,0.0%,2h
41152,2,mApleStriKe,2066,0,0,1,1,0.0%,36m
41152,2,YAMATHENA,2066,0,0,1,1,0.0%,2h
41152,2,Infestado,2066,0,0,1,1,0.0%,38m
41152,2,Pikanyaa,2066,0,0,4,4,0.0%,2h
41152,2,Abridenal,2066,0,0,5,5,0.0%,2h
41152,2,mgailuj,2066,0,0,5,5,0.0%,43m
41166,1,barcode,2065,806,91,99,190,47.9%,2h
41166,2,[RlSKE]VaeZarek,2065,386,14,16,30,46.7%,52m
41166,2,Fofenana,2065,276,10,6,16,62.5%,46m
41166,1,SOURKUSHOG,2065,354,10,15,25,40.0%,13m
41166,2,[UKNOME]HABI,2065,274,9,16,25,36.0%,2h
41166,2,pato,2065,263,8,14,22,36.4%,2h
41166,1,Predator,2065,165,6,6,12,50.0%,52m
41166,2,Mikalogical,2065,126,5,4,9,55.6%,21m
41166,2,Scooter,2065,120,4,5,9,44.4%,2h
41166,2,DeleteUser,2065,0,4,6,10,40.0%,9m
41166,2,TRESKELION,2065,0,3,3,6,50.0%,2h
41166,2,AdamBeach,2065,58,2,2,4,50.0%,2h
41166,2,[A5]Rlawless,2065,58,2,2,4,50.0%,2h
41166,2,CAMARONCIN,2065,30,1,1,2,50.0%,21m
41166,2,Papai,2065,0,1,5,6,16.7%,2h
41166,3,VendrediXIII,2065,0,0,2,2,0.0%,2h
41166,3,Thor,2065,0,0,3,3,0.0%,33m
41166,3,yazico,2065,0,0,5,5,0.0%,2h
41166,2,GunFire,2065,0,0,5,5,0.0%,25m
41185,2,barboza,2064,1531,386,466,852,45.3%,2h
41185,2,dogwit,2064,1235,46,53,99,46.5%,42m
41185,2,jason,2064,759,32,31,63,50.8%,2h
41185,2,PeanutButler,2064,722,31,36,67,46.3%,2h
41185,2,FreedomZone,2064,689,30,22,52,57.7%,2h
41185,2,[SHELL]Willavy,2064,792,30,36,66,45.5%,2h
41185,2,[W77]BaghDaddy,2064,192,7,4,11,63.6%,3m
41185,3,Edrojas,2064,201,6,14,20,30.0%,2h
41185,2,Benjamin,2064,102,3,5,8,37.5%,2h
41185,1,TheTrentster,2064,120,2,6,8,25.0%,2h
41185,2,Fabrix,2064,48,2,6,8,25.0%,2h
41185,2,gwolf,2064,60,2,8,10,20.0%,48m
41185,1,bRUCe,2064,48,2,9,11,18.2%,2h
41185,2,[Th3Bad]kombi,2064,30,1,1,2,50.0%,41m
41185,2,RodeoFiasco,2064,30,1,2,3,33.3%,2h
41185,2,bastywar,2064,34,1,2,3,33.3%,2h
41185,2,DildoBaggins,2064,0,1,3,4,25.0%,22m
41185,2,Farmist,2064,0,1,4,5,20.0%,38m
41185,2,[THD]Echohuman,2064,48,1,7,8,12.5%,34m
41185,1,Zuzu,2064,0,1,8,9,11.1%,55m
41185,2,Joe,2064,0,0,1,1,0.0%,2h
41185,2,[CaMt]pabloesc,2064,0,0,1,1,0.0%,2h
41185,2,ohBEwon,2064,0,0,4,4,0.0%,14m
41208,3,Yashija,2063,1457,98,123,221,44.3%,50m
41208,1,Biff,2063,890,30,36,66,45.5%,2h
41208,2,vornado,2063,300,16,16,32,50.0%,2h
41208,1,[NOVOPS]DILLYDOG,2063,162,8,10,18,44.4%,2h
41208,1,cytoxan,2063,220,5,5,10,50.0%,49m
41208,2,George,2063,136,4,1,5,80.0%,48m
41208,2,XoR,2063,120,4,8,12,33.3%,21m
41208,2,Eduardo,2063,116,4,11,15,26.7%,2h
41208,3,baladanelson,2063,0,2,3,5,40.0%,2h
41208,2,Zephie,2063,44,2,7,9,22.2%,30m
41208,2,sancoz,2063,30,1,3,4,25.0%,2h
41208,2,[Kipi]jorge,2063,0,0,1,1,0.0%,2h
41208,2,Kona,2063,0,0,1,1,0.0%,2h
41208,2,BlueSteel,2063,0,0,3,3,0.0%,2h
41208,2,Lucannus,2063,0,0,5,5,0.0%,2h
41223,2,SKYWALKER,2062,1051,81,78,159,50.9%,46m
41223,2,ArgentiSol,2062,1046,58,69,127,45.7%,2h
41223,2,perropatata,2062,635,38,31,69,55.1%,2h
41223,1,JKSHisoka,2062,556,20,31,51,39.2%,2h
41223,2,NaCljerky,2062,372,13,16,29,44.8%,2h
41223,1,Pappas,2062,410,12,18,30,40.0%,3h
41223,2,CrossfireFox,2062,238,9,8,17,52.9%,2h
41223,2,AsrielD,2062,264,9,9,18,50.0%,2h
41223,2,Serocks,2062,311,9,10,19,47.4%,38m
41223,2,drJetSki,2062,229,8,11,19,42.1%,2h
41223,2,BengalBamBam,2062,160,5,8,13,38.5%,2h
41223,1,Neo,2062,131,5,15,20,25.0%,2h
41223,1,Wildwater,2062,62,4,12,16,25.0%,8m
41223,2,Chris,2062,112,3,0,3,100.0%,2h
41223,2,[SPLOF]KingGiron,2062,30,2,2,4,50.0%,48m
41223,2,TripleRico,2062,0,1,0,1,100.0%,21m
41223,2,Void,2062,0,1,0,1,100.0%,2h
41223,1,gunzcuervo,2062,0,1,0,1,100.0%,51m
41223,2,[FalPal]Gogofresh,2062,30,1,2,3,33.3%,41m
41223,2,windbreaker,2062,30,1,3,4,25.0%,2h
41223,1,zaturama,2062,96,1,5,6,16.7%,15m
41223,2,Twisteck,2062,46,1,7,8,12.5%,15m
41223,2,[Smiles]Sandman,2062,0,0,1,1,0.0%,2h
41223,2,[MeLLaA]SpeedyFalcon,2062,0,0,1,1,0.0%,2h
41223,1,Yúsurus,2062,0,0,5,5,0.0%,3h
41223,2,ErnestLim,2062,0,0,5,5,0.0%,2h
41249,2,FluffyOps,2061,505,18,21,39,46.2%,2h
41249,1,ChaoticBacon,2061,358,13,19,32,40.6%,2h
41249,1,Bethuka,2061,263,9,16,25,36.0%,43m
41249,3,TerranYouUp,2061,233,6,15,21,28.6%,30m
41249,1,ChuckleBean,2061,190,5,6,11,45.5%,3h
41249,2,BigDo,2061,70,4,8,12,33.3%,24m
41249,2,Protoss,2061,118,4,9,13,30.8%,40m
41249,2,ElfoOscuro,2061,60,3,3,6,50.0%,2h
41249,1,[mMEGA]SAGA,2061,0,3,4,7,42.9%,22m
41249,2,WolfFlair,2061,125,3,4,7,42.9%,43m
41249,2,Janzstone,2061,0,1,0,1,100.0%,2h
41249,2,Ptosis,2061,0,0,2,2,0.0%,46m
41261,2,[464]erick,2060,1584,151,158,309,48.9%,2h
41261,1,brunao,2060,1504,133,146,279,47.7%,46m
41261,1,Lukexd,2060,888,40,41,81,49.4%,2h
41261,2,[TDRGN]Aramis,2060,530,26,5,31,83.9%,46m
41261,1,Dacatapiller,2060,700,24,33,57,42.1%,40m
41261,3,BlueRose,2060,638,24,35,59,40.7%,38m
41261,2,DiegoXD,2060,354,12,18,30,40.0%,3m
41261,2,ELGGNOMAS,2060,154,8,2,10,80.0%,2h
41261,2,Brian,2060,232,8,8,16,50.0%,46m
41261,2,ShotgunB,2060,282,8,12,20,40.0%,2h
41261,3,amom,2060,162,7,16,23,30.4%,2h
41261,3,esclerglade,2060,177,4,8,12,33.3%,39m
41261,2,Allunak,2060,88,3,4,7,42.9%,42m
41261,2,[F1aG]Pezz,2060,48,3,5,8,37.5%,2h
41261,2,Nathanplays,2060,144,3,8,11,27.3%,2h
41261,3,Santitix,2060,115,3,11,14,21.4%,35m
41261,2,[SCVM]NightTrain,2060,119,2,2,4,50.0%,2h
41261,2,Yanko,2060,34,2,5,7,28.6%,33m
41261,2,KalaNoa,2060,30,2,5,7,28.6%,2h
41261,3,rogueknight,2060,30,2,10,12,16.7%,3h
41261,2,cuervo,2060,0,1,0,1,100.0%,25m
41261,2,Bigboy,2060,0,1,1,2,50.0%,55m
41261,2,Joachim,2060,93,1,1,2,50.0%,2h
41261,2,ADHD,2060,30,1,3,4,25.0%,46m
41261,2,Charizard,2060,30,1,6,7,14.3%,2h
41261,2,chandler,2060,0,0,1,1,0.0%,2h
41261,2,IdLE,2060,0,0,6,6,0.0%,2h
41288,1,legion,2059,1505,211,223,434,48.6%,2h
41288,2,Fenolok,2059,1338,55,63,118,46.6%,2h
41288,2,brauliovilla,2059,249,8,7,15,53.3%,38m
41288,2,swootton,2059,172,6,8,14,42.9%,22m
41288,2,DoNkY,2059,118,5,10,15,33.3%,5m
41288,2,llllllllllll,2059,107,3,4,7,42.9%,2h
41288,2,DerpestWolf,2059,30,2,3,5,40.0%,2h
41288,1,Terrible,2059,96,2,6,8,25.0%,2h
41288,2,Potatsu,2059,108,2,6,8,25.0%,5m
41288,2,Unsolid,2059,0,1,0,1,100.0%,2h
41288,2,Zeca,2059,0,1,0,1,100.0%,5m
41288,3,[JUGOS2]aldevaran,2059,0,1,2,3,33.3%,2h
41288,2,Nancy,2059,46,1,2,3,33.3%,2h
41288,1,dimos,2059,0,1,8,9,11.1%,7m
41288,2,loidster,2059,0,0,2,2,0.0%,2h
41288,1,SkUnCh,2059,0,0,4,4,0.0%,3h
41288,2,Slingriver,2059,0,0,4,4,0.0%,37m
41288,2,Endrows,2059,0,0,5,5,0.0%,3m
41306,2,kenpokilla,2058,760,27,30,57,47.4%,52m
41306,2,Duckier,2058,291,11,7,18,61.1%,2h
41306,2,PPsneeze,2058,361,11,10,21,52.4%,9m
41306,2,craneoroto,2058,224,8,4,12,66.7%,2h
41306,2,cheeseRus,2058,58,7,2,9,77.8%,2h
41306,2,Enforcer,2058,92,3,4,7,42.9%,2h
41306,2,DragonTamer,2058,94,3,4,7,42.9%,33m
41306,3,DPiddy,2058,121,2,4,6,33.3%,47m
41306,1,Razgreize,2058,48,2,8,10,20.0%,18m
41306,2,grizmark,2058,30,1,1,2,50.0%,21m
41306,2,mangekyu,2058,0,1,1,2,50.0%,36m
41306,2,seppyanda,2058,0,1,2,3,33.3%,2h
41306,2,Calsifer,2058,48,1,3,4,25.0%,50m
41306,1,Kitt,2058,0,0,3,3,0.0%,2h
41306,2,ZergMaster,2058,0,0,6,6,0.0%,46m
41321,1,ThisIsAWar,2057,1548,103,108,211,48.8%,2h
41321,2,DESTROY,2057,1596,80,82,162,49.4%,40m
41321,2,Seporath,2057,1619,74,77,151,49.0%,21m
41321,2,BABYHULK,2057,1502,70,56,126,55.6%,2h
41321,1,sece,2057,1058,62,63,125,49.6%,15m
41321,2,robvandang,2057,1047,39,40,79,49.4%,55m
41321,2,freddy,2057,445,22,18,40,55.0%,2h
41321,2,[SCUnal]Kathartes,2057,540,19,24,43,44.2%,2h
41321,3,Laura,2057,250,9,15,24,37.5%,2h
41321,2,Scott,2057,148,5,8,13,38.5%,2h
41321,2,AusangateCSC,2057,102,3,0,3,100.0%,2h
41321,2,itzimperial,2057,42,3,4,7,42.9%,2h
41321,2,DarthSpencer,2057,88,1,5,6,16.7%,2h
41321,2,Whatshisface,2057,0,0,1,1,0.0%,2h
41321,1,Maticalz,2057,0,0,1,1,0.0%,2h
41321,2,Sibbs,2057,0,0,2,2,0.0%,2h
41337,1,Hellsuponus,2056,1679,131,137,268,48.9%,2h
41337,2,[AKWarr]TimmyVader,2056,484,17,16,33,51.5%,49m
41337,1,vonguyengiap,2056,324,11,18,29,37.9%,25m
41337,3,adoodas,2056,259,10,21,31,32.3%,2h
41337,2,McJoey,2056,221,8,5,13,61.5%,39m
41337,2,Ioas,2056,149,4,4,8,50.0%,2h
41337,1,Boxxxx,2056,213,4,5,9,44.4%,2h
41337,2,Gretsch,2056,122,4,8,12,33.3%,2h
41337,2,Erio,2056,116,3,2,5,60.0%,2h
41337,2,[ThShMe]drumpil,2056,133,3,2,5,60.0%,2h
41337,2,TheFrEAk,2056,96,3,8,11,27.3%,52m
41337,1,Rebootmagi,2056,74,3,9,12,25.0%,2h
41337,2,TwEeKs,2056,109,2,1,3,66.7%,2h
41337,1,[JBSE]BIGCNL,2056,144,2,3,5,40.0%,2h
41337,1,[ValpoK]elmatapaco,2056,48,2,4,6,33.3%,18m
41337,2,[lolzzz]Kikiriskiaga,2056,0,1,1,2,50.0%,3m
41337,2,PukPuk,2056,0,1,2,3,33.3%,2h
41337,2,[xAK7x]Carlangas,2056,0,1,2,3,33.3%,33m
41337,2,Dandoh,2056,0,1,3,4,25.0%,2h
41337,2,zergatoss,2056,0,0,1,1,0.0%,36m
41337,3,[Mugre]termolar,2056,0,0,1,1,0.0%,3h
41337,2,maxwell,2056,0,0,1,1,0.0%,14m
41337,2,ashri,2056,0,0,2,2,0.0%,2h
41337,1,ThePresident,2056,0,0,6,6,0.0%,13m
41361,2,mayoflavored,2055,1292,51,50,101,50.5%,2h
41361,3,caramaldita,2055,390,37,56,93,39.8%,31m
41361,2,Destructor,2055,358,13,14,27,48.1%,2h
41361,2,BlueMachine,2055,330,12,17,29,41.4%,6m
41361,2,[PTT]bluehash,2055,258,10,14,24,41.7%,2h
41361,2,[ALTF04]DALTHON,2055,295,9,8,17,52.9%,2h
41361,1,Durch,2055,214,7,11,18,38.9%,9m
41361,1,Jimmy,2055,232,6,12,18,33.3%,2h
41361,2,JOSFER,2055,241,5,9,14,35.7%,2h
41361,3,ParadoxLogic,2055,169,5,12,17,29.4%,2h
41361,2,Hrothgar,2055,46,4,4,8,50.0%,5m
41361,1,CrankyHero,2055,180,4,13,17,23.5%,42m
41361,2,Gomerson,2055,106,3,9,12,25.0%,2h
41361,2,EvolveKH,2055,30,2,0,2,100.0%,2h
41361,2,gomez,2055,112,2,1,3,66.7%,37m
41361,2,FRAUD,2055,60,2,2,4,50.0%,2h
41361,2,[VINGAD]Fabricio,2055,0,1,4,5,20.0%,6m
41361,2,Iamtheman,2055,30,1,4,5,20.0%,37m
41361,1,leo,2055,0,0,1,1,0.0%,2h
41361,1,Xenfurion,2055,0,0,2,2,0.0%,2h
41361,2,Pundo,2055,0,0,3,3,0.0%,35m
41361,3,Chris,2055,0,0,4,4,0.0%,2h
41361,2,madmonte,2055,0,0,5,5,0.0%,39m
41361,2,Zeratul,2055,0,0,5,5,0.0%,2h
41385,2,Hayman,2054,1445,69,64,133,51.9%,2h
41385,2,HiDef,2054,642,22,29,51,43.1%,2h
41385,1,Saxon,2054,532,18,27,45,40.0%,9m
41385,3,ZondaLegs,2054,418,16,25,41,39.0%,3h
41385,2,MENDEZ,2054,273,11,11,22,50.0%,2h
41385,1,CHATO,2054,178,10,15,25,40.0%,2h
41385,1,ROMARIO,2054,342,10,19,29,34.5%,2h
41385,1,ThallysTox,2054,249,7,9,16,43.8%,4m
41385,2,Kowalski,2054,166,5,4,9,55.6%,2h
41385,2,Erick,2054,154,5,9,14,35.7%,22m
41385,3,Leghtion,2054,192,5,13,18,27.8%,14m
41385,2,kaiba,2054,73,4,10,14,28.6%,2h
41385,1,murder,2054,159,4,12,16,25.0%,2h
41385,2,FLAGDAWG,2054,100,2,1,3,66.7%,2h
41385,1,Storm,2054,66,2,7,9,22.2%,3h
41385,2,Awesomazing,2054,30,1,4,5,20.0%,45m
41385,2,MarineMan,2054,0,1,5,6,16.7%,2h
41385,2,shadowgenji,2054,94,1,5,6,16.7%,2h
41385,2,Williams,2054,93,1,6,7,14.3%,2h
41385,1,ANGELFIRE,2054,97,1,6,7,14.3%,2h
41385,2,jimraynor,2054,0,0,2,2,0.0%,34m
41406,1,oasub,2053,1533,74,80,154,48.1%,2h
41406,2,[CADIVI]Rduran,2053,1485,61,53,114,53.5%,6m
41406,2,[Watame]ReinerBraun,2053,502,29,31,60,48.3%,33m
41406,2,Darkhorse,2053,542,19,21,40,47.5%,2h
41406,2,VicariousSin,2053,308,11,8,19,57.9%,2h
41406,2,ASequoiaTree,2053,142,9,13,22,40.9%,38m
41406,2,JHOELORD,2053,241,8,14,22,36.4%,2h
41406,1,HNN,2053,114,7,9,16,43.8%,25m
41406,1,hoouwishuwer,2053,308,7,25,32,21.9%,10m
41406,2,Danterux,2053,152,6,11,17,35.3%,2h
41406,2,pplarge,2053,184,6,13,19,31.6%,2h
41406,2,[xDYEx]manzur,2053,134,5,5,10,50.0%,2h
41406,1,Vastatur,2053,190,5,11,16,31.2%,3h
41406,2,Maar,2053,162,4,4,8,50.0%,14m
41406,1,ZODIAC,2053,145,3,9,12,25.0%,18m
41406,1,Mark,2053,48,2,1,3,66.7%,10m
41406,2,nexus,2053,30,2,1,3,66.7%,49m
41406,1,TheCanadian,2053,38,2,8,10,20.0%,7m
41406,2,Ledian,2053,92,1,6,7,14.3%,15m
41406,3,[YAGS]Yavin,2053,0,0,1,1,0.0%,33m
41406,2,NOZGOTH,2053,0,0,1,1,0.0%,46m
41406,2,HappyPlu,2053,0,0,1,1,0.0%,54m
41406,3,Benito,2053,0,0,2,2,0.0%,3h
41406,2,PROTOSS,2053,0,0,5,5,0.0%,46m
41430,1,RedQuill,2052,1162,61,68,129,47.3%,30m
41430,3,Ceonotido,2052,1234,46,55,101,45.5%,34m
41430,1,Romano,2052,557,31,42,73,42.5%,2h
41430,1,[mythik]cmdrRetardo,2052,776,27,43,70,38.6%,2h
41430,1,Luminoc,2052,651,23,35,58,39.7%,26m
41430,2,Yaldi,2052,297,15,13,28,53.6%,3h
41430,1,Hamster,2052,394,12,22,34,35.3%,2h
41430,1,AndreyCR,2052,250,8,22,30,26.7%,40m
41430,2,[lttdh]llAriesll,2052,114,4,4,8,50.0%,2h
41430,2,[platos]GigaTom,2052,90,3,8,11,27.3%,40m
41430,2,doubleaa,2052,0,1,3,4,25.0%,2h
41430,1,tinman,2052,48,1,4,5,20.0%,12m
41430,2,Ledhrox,2052,30,1,8,9,11.1%,49m
41430,2,acdc,2052,0,0,1,1,0.0%,22m
41430,2,eldeon,2052,0,0,1,1,0.0%,2h
41430,2,skrtskrt,2052,0,0,2,2,0.0%,2h
41446,2,comoscraft,2051,1588,294,320,614,47.9%,47m
41446,2,diamond,2051,746,65,59,124,52.4%,2h
41446,1,Chriztian,2051,1138,53,55,108,49.1%,17m
41446,2,kerim,2051,684,38,31,69,55.1%,2h
41446,2,yMoi,2051,815,33,30,63,52.4%,2h
41446,2,CERBERUS,2051,538,19,23,42,45.2%,2h
41446,1,[BYU]DragonMage,2051,570,19,25,44,43.2%,46m
41446,2,Joedan,2051,291,10,8,18,55.6%,3h
41446,2,Benjaimer,2051,219,9,5,14,64.3%,2h
41446,2,RopaDope,2051,278,9,15,24,37.5%,2h
41446,2,mana,2051,212,8,9,17,47.1%,2h
41446,2,RevlutionMan,2051,174,6,5,11,54.5%,2h
41446,1,Wainfleet,2051,218,6,12,18,33.3%,6m
41446,2,xTimooo,2051,75,5,10,15,33.3%,2h
41446,1,OREO,2051,48,2,4,6,33.3%,2h
41446,1,Nimbus,2051,91,2,7,9,22.2%,17m
41446,2,Andy,2051,30,1,1,2,50.0%,2h
41446,2,Monge,2051,0,1,1,2,50.0%,2h
41446,1,yAGO,2051,0,1,8,9,11.1%,3h
41446,2,sandstriker,2051,0,0,1,1,0.0%,2h
41446,2,Colocoy,2051,0,0,1,1,0.0%,2h
41446,3,shawn,2051,0,0,5,5,0.0%,36m
41446,2,DoomTune,2051,0,0,5,5,0.0%,2h
41446,2,xxdrakixx,2051,0,0,5,5,0.0%,2h
41470,2,identical,2050,1234,47,46,93,50.5%,49m
41470,2,PipeN,2050,644,30,8,38,78.9%,2h
41470,2,Ascended,2050,341,13,20,33,39.4%,2h
41470,1,Luther,2050,370,13,27,40,32.5%,24m
41470,2,TankDank,2050,237,10,17,27,37.0%,46m
41470,2,shinjiuchiha,2050,337,9,12,21,42.9%,2h
41470,2,FlensiGER,2050,176,8,11,19,42.1%,2h
41470,2,[valhal]SGVA,2050,196,7,7,14,50.0%,2h
41470,2,piero,2050,224,6,12,18,33.3%,46m
41470,3,Gilgabro,2050,214,6,15,21,28.6%,15m
41470,2,Rhino,2050,120,5,10,15,33.3%,55m
41470,2,Germán,2050,0,4,3,7,57.1%,26m
41470,2,[Chibii]SiikeZ,2050,0,3,2,5,60.0%,2h
41470,2,Jaefcope,2050,141,2,3,5,40.0%,2h
41470,2,Daniel,2050,48,2,5,7,28.6%,31m
41470,1,yippykayaay,2050,30,2,7,9,22.2%,2h
41470,2,DocHolliday,2050,48,2,7,9,22.2%,3h
41470,2,Joker,2050,92,2,8,10,20.0%,2h
41470,1,[oye]VirusNK,2050,0,1,0,1,100.0%,42m
41470,1,Deranan,2050,0,1,8,9,11.1%,55m
41470,1,SarSanbir,2050,34,1,8,9,11.1%,4m
41470,2,plex,2050,0,0,2,2,0.0%,2h
41470,1,IGGI,2050,0,0,3,3,0.0%,2h
41470,3,Iamman,2050,0,0,5,5,0.0%,2h
41494,2,Ronaldino,2049,1114,39,42,81,48.1%,2h
41494,1,Cucowisc,2049,760,26,38,64,40.6%,41m
41494,2,KingGedorah,2049,702,25,30,55,45.5%,2h
41494,2,Andalur,2049,319,13,15,28,46.4%,2h
41494,2,Jurookie,2049,339,13,21,34,38.2%,2h
41494,2,loloyui,2049,295,12,14,26,46.2%,2h
41494,1,CREATIVE,2049,193,7,8,15,46.7%,2h
41494,1,Jhaiisiin,2049,197,6,10,16,37.5%,2h
41494,2,Dennis,2049,163,5,5,10,50.0%,49m
41494,2,Spirit,2049,162,4,3,7,57.1%,2h
41494,1,Laggan,2049,128,4,9,13,30.8%,28m
41494,2,[HSCT]LoafOfStoaf,2049,128,3,9,12,25.0%,6m
41494,2,[Hilas2]Kramolous,2049,30,2,1,3,66.7%,37m
41494,2,ChrisWhyTY,2049,30,2,1,3,66.7%,21m
41494,1,orion,2049,96,1,2,3,33.3%,3h
41494,3,TearBear,2049,0,1,4,5,20.0%,2h
41494,2,[TEVÉZ]akitaxi,2049,0,0,1,1,0.0%,2h
41494,1,Chimpa,2049,0,0,2,2,0.0%,2h
41494,2,ACE,2049,0,0,5,5,0.0%,50m
41494,2,Tekknetic,2049,0,0,6,6,0.0%,2h
41514,2,[TY4GG]Grandma,2048,1546,105,114,219,47.9%,21m
41514,2,Ivo,2048,1492,78,86,164,47.6%,2h
41514,2,[Fever]Gloriserve,2048,1504,65,62,127,51.2%,2h
41514,1,Heffy,2048,1319,59,56,115,51.3%,2h
41514,2,IIIIIIIIII,2048,718,28,25,53,52.8%,2h
41514,1,Snakkerd,2048,526,20,27,47,42.6%,53m
41514,2,Duckwhite,2048,461,15,25,40,37.5%,2h
41514,2,theimmortal,2048,367,12,17,29,41.4%,49m
41514,2,Hellprince,2048,283,10,8,18,55.6%,2h
41514,2,ChronoKaton,2048,241,9,6,15,60.0%,41m
41514,3,kRoNvIcT,2048,286,9,15,24,37.5%,40m
41514,2,KermitDaFrog,2048,211,7,4,11,63.6%,14m
41514,2,Fruits,2048,94,4,6,10,40.0%,2h
41514,2,HaiseSkgchi,2048,30,2,1,3,66.7%,6m
41514,2,Fabulouslife,2048,34,2,2,4,50.0%,14m
41514,2,SonicYouth,2048,30,1,2,3,33.3%,6m
41514,2,tygur,2048,0,1,4,5,20.0%,2h
41514,1,JINKS,2048,0,1,7,8,12.5%,13m
41514,1,Kott,2048,0,1,8,9,11.1%,2h
41514,2,neeatstere,2048,0,0,1,1,0.0%,2h
41514,2,[ChlDDN]SrEvilz,2048,0,0,1,1,0.0%,2h
41514,2,Ironjoey,2048,0,0,1,1,0.0%,52m
41514,2,Oprime,2048,0,0,3,3,0.0%,2h
41514,2,cuervofatal,2048,0,0,5,5,0.0%,2h
41514,3,AngelVasquez,2048,0,0,5,5,0.0%,11m
41539,1,theo,2047,1002,97,103,200,48.5%,40m
41539,1,andresrnv,2047,600,21,26,47,44.7%,2h
41539,2,Alejandro,2047,514,20,17,37,54.1%,9m
41539,3,HakkMaster,2047,222,7,14,21,33.3%,2h
41539,1,Vaul,2047,238,6,9,15,40.0%,2h
41539,1,CpyKittykat,2047,207,5,10,15,33.3%,2h
41539,2,JBAC,2047,0,3,2,5,60.0%,25m
41539,2,RandomPerson,2047,30,3,5,8,37.5%,46m
41539,2,[ELIDS]Krakker,2047,138,3,9,12,25.0%,22m
41539,1,ODBrent,2047,48,1,1,2,50.0%,29m
41539,1,Charcoal,2047,0,1,2,3,33.3%,2h
41539,3,OSI,2047,0,1,4,5,20.0%,5m
41551,2,armandochesh,2046,1596,122,122,244,50.0%,2h
41551,2,Grifor,2046,1262,53,56,109,48.6%,3h
41551,2,LoreHorse,2046,740,28,26,54,51.9%,2h
41551,2,Moshé,2046,395,19,22,41,46.3%,2h
41551,1,comandoepapu,2046,503,18,27,45,40.0%,2h
41551,2,jessto,2046,367,13,13,26,50.0%,2h
41551,2,ElementrX,2046,250,8,11,19,42.1%,38m
41551,1,vipper,2046,236,7,14,21,33.3%,2h
41551,2,Nordhem,2046,116,6,2,8,75.0%,46m
41551,1,CHAVODELOCHO,2046,236,6,13,19,31.6%,2h
41551,2,CTRDoesStuff,2046,132,5,6,11,45.5%,2h
41551,3,SpicyGochu,2046,127,5,14,19,26.3%,11m
41551,3,OzzedOut,2046,126,4,22,26,15.4%,3m
41551,2,Zukesu,2046,114,3,12,15,20.0%,2h
41551,2,Adrian,2046,46,2,6,8,25.0%,2h
41551,2,Mythty,2046,88,1,1,2,50.0%,14m
41551,1,TaricGems,2046,0,1,7,8,12.5%,7m
41551,2,Tatalap,2046,0,0,1,1,0.0%,6m
41551,2,taylortots,2046,0,0,5,5,0.0%,2h
41570,2,GhostDog,2045,1132,78,83,161,48.4%,2h
41570,2,spoOkywagns,2045,1202,46,48,94,48.9%,6m
41570,2,Izzijeub,2045,1097,44,38,82,53.7%,2h
41570,2,[SWOU]Rookspwnshop,2045,944,39,35,74,52.7%,2h
41570,1,CAST,2045,922,32,41,73,43.8%,41m
41570,2,Bellum,2045,558,20,25,45,44.4%,2h
41570,1,Dangles,2045,586,17,29,46,37.0%,2h
41570,2,[INVLV1]nAc,2045,137,7,2,9,77.8%,34m
41570,2,[CUMMYs]CallMeJae,2045,144,5,9,14,35.7%,2h
41570,2,SilverHawk,2045,122,4,9,13,30.8%,2h
41570,1,Toshii,2045,153,3,10,13,23.1%,38m
41570,2,karhunvatuka,2045,0,1,0,1,100.0%,2h
41570,2,[ExcIgN]rokoloc,2045,0,1,1,2,50.0%,14m
41570,2,[InLeB]Vinzant,2045,73,1,1,2,50.0%,25m
41570,2,jmace,2045,48,1,7,8,12.5%,2h
41570,2,nick,2045,0,0,5,5,0.0%,42m
41570,3,helper,2045,0,0,5,5,0.0%,2h
41587,1,LOTAR,2044,1637,173,169,342,50.6%,17m
41587,1,BlueBerryX,2044,1041,59,73,132,44.7%,46m
41587,1,[DETER]JackOfSpades,2044,1354,50,54,104,48.1%,2h
41587,2,Red,2044,595,21,23,44,47.7%,2h
41587,1,AnotherGonzo,2044,536,15,28,43,34.9%,3m
41587,2,Gameknight,2044,358,13,10,23,56.5%,2h
41587,2,Koroshi,2044,266,8,11,19,42.1%,3m
41587,2,Oathkeeper,2044,30,5,3,8,62.5%,40m
41587,1,Bagerk,2044,162,4,10,14,28.6%,42m
41587,1,Donnie,2044,145,3,3,6,50.0%,29m
41587,2,[NXLsc]ptoelqlolea,2044,58,2,5,7,28.6%,6m
41587,2,[THNT]Tarniac,2044,46,2,6,8,25.0%,2h
41587,1,[forces]RAINONFEET,2044,30,2,8,10,20.0%,17m
41587,1,ESTEBAN,2044,48,2,10,12,16.7%,2h
41587,2,Story,2044,0,1,4,5,20.0%,2h
41587,2,Jackstraw,2044,0,1,4,5,20.0%,2h
41587,1,Keet,2044,48,1,5,6,16.7%,36m
41587,2,kitcat,2044,0,0,1,1,0.0%,2h
41587,2,WDNMD,2044,0,0,1,1,0.0%,46m
41587,3,Emperator,2044,0,0,4,4,0.0%,41m
41607,2,[Silly1]SpaceMarmot,2043,1642,113,122,235,48.1%,2h
41607,2,WoundedOgre,2043,351,28,32,60,46.7%,38m
41607,1,unkind,2043,728,22,34,56,39.3%,47m
41607,1,mirariel,2043,552,19,30,49,38.8%,2h
41607,2,John,2043,446,15,20,35,42.9%,2h
41607,2,CRAVET,2043,394,14,11,25,56.0%,3h
41607,2,Kross,2043,361,12,13,25,48.0%,2h
41607,2,[EpicG]KIOBO,2043,199,6,6,12,50.0%,2h
41607,1,blubberblat,2043,224,5,11,16,31.2%,43m
41607,2,SWAGMONEY,2043,140,3,3,6,50.0%,2h
41607,1,Mark,2043,80,3,10,13,23.1%,2h
41607,1,Gedeon,2043,0,2,7,9,22.2%,47m
41607,1,MackAttack,2043,40,2,8,10,20.0%,2h
41607,2,Killthealias,2043,0,0,1,1,0.0%,46m
41607,2,[Mallow]Tink,2043,0,0,1,1,0.0%,3m
41607,2,TheDoctor,2043,0,0,6,6,0.0%,2h
41623,2,TSST,2042,1553,194,207,401,48.4%,48m
41623,1,Asterisk,2042,1046,34,43,77,44.2%,2h
41623,2,josue,2042,319,12,20,32,37.5%,2h
41623,2,[G79]Lonewolfe,2042,306,10,10,20,50.0%,2h
41623,2,PanTH,2042,226,8,10,18,44.4%,2h
41623,1,quoofadilla,2042,193,7,8,15,46.7%,3h
41623,2,[DWKS]NinjaYun,2042,169,5,6,11,45.5%,39m
41623,3,MrSuck,2042,199,5,14,19,26.3%,22m
41623,1,Scarface,2042,125,4,9,13,30.8%,2h
41623,2,TomysCiborg,2042,86,3,8,11,27.3%,25m
41623,1,AlAegys,2042,30,3,12,15,20.0%,2h
41623,2,MordinSolus,2042,0,1,0,1,100.0%,50m
41623,2,DeltaX,2042,0,1,4,5,20.0%,2h
41623,2,BeatinU,2042,92,1,6,7,14.3%,36m
41623,1,[ExcIgN]LUISANGEL,2042,0,1,7,8,12.5%,38m
41623,2,[NU11]PsychoFlyer,2042,0,0,2,2,0.0%,2h
41623,2,Ian,2042,0,0,5,5,0.0%,2h
41640,2,Jex,2041,1574,118,128,246,48.0%,25m
41640,2,Myseeleeum,2041,988,36,37,73,49.3%,27m
41640,2,kevclang,2041,460,35,33,68,51.5%,2h
41640,2,rampage,2041,470,17,17,34,50.0%,2h
41640,2,Duke,2041,416,14,17,31,45.2%,36m
41640,1,Monsieur,2041,364,12,10,22,54.5%,2h
41640,2,SANiiTY,2041,285,12,19,31,38.7%,41m
41640,2,Acronix,2041,200,11,7,18,61.1%,2h
41640,2,Thael,2041,149,11,11,22,50.0%,2h
41640,2,CharlieBrown,2041,199,9,12,21,42.9%,2h
41640,1,XoM,2041,290,9,24,33,27.3%,30m
41640,2,[MofG]CapwN,2041,88,2,9,11,18.2%,38m
41640,2,Bayaz,2041,34,1,4,5,20.0%,3h
41640,1,MickAngel,2041,0,1,8,9,11.1%,2h
41640,3,Ardum,2041,0,0,1,1,0.0%,11m
41640,3,Dylon,2041,0,0,5,5,0.0%,2h
41656,1,Stevo,2040,1661,264,280,544,48.5%,46m
41656,2,RAM,2040,1600,167,182,349,47.9%,6m
41656,1,APOCALIPSIS,2040,1115,58,64,122,47.5%,37m
41656,2,LemonEric,2040,1378,53,58,111,47.7%,3m
41656,2,QuoVadis,2040,1028,42,40,82,51.2%,2h
41656,2,Megadan,2040,428,31,25,56,55.4%,2h
41656,2,SolidityCane,2040,922,31,34,65,47.7%,6m
41656,1,Kraynus,2040,727,30,29,59,50.8%,2h
41656,2,Gilakasla,2040,506,18,23,41,43.9%,2h
41656,2,JackOLantern,2040,309,18,25,43,41.9%,2h
41656,2,[FAQWAY]Faquarl,2040,389,17,14,31,54.8%,14m
41656,2,alvee,2040,405,16,11,27,59.3%,2h
41656,2,PatriotValor,2040,384,15,20,35,42.9%,2h
41656,2,NetherendsSC,2040,301,9,14,23,39.1%,2h
41656,2,qorsps,2040,289,9,16,25,36.0%,21m
41656,3,Diagram,2040,247,8,13,21,38.1%,2h
41656,2,Alamuerte,2040,114,7,8,15,46.7%,2h
41656,2,Ragnaroth,2040,156,5,2,7,71.4%,2h
41656,2,AoAo,2040,187,5,9,14,35.7%,2h
41656,2,NyanCatita,2040,108,2,2,4,50.0%,46m
41656,2,pepa,2040,30,2,4,6,33.3%,2h
41656,1,Mattnix,2040,46,2,6,8,25.0%,2h
41656,2,[DDOINK]Ralnor,2040,0,1,0,1,100.0%,49m
41656,3,raccoon,2040,0,1,8,9,11.1%,2h
41680,1,Aristotle,2039,1669,183,190,373,49.1%,2h
41680,1,[SC2LA]FeNoM,2039,1234,44,50,94,46.8%,30m
41680,2,drybonez,2039,888,43,44,87,49.4%,2h
41680,2,memo,2039,500,18,20,38,47.4%,2h
41680,2,Rolo,2039,568,18,25,43,41.9%,2h
41680,2,joseeduardo,2039,428,16,16,32,50.0%,50m
41680,2,BaneHammer,2039,466,14,23,37,37.8%,2h
41680,2,Prabbi,2039,378,12,21,33,36.4%,14m
41680,2,GROZLEX,2039,268,11,13,24,45.8%,14m
41680,2,Starboy,2039,231,6,7,13,46.2%,50m
41680,3,hiddenpylon,2039,171,5,13,18,27.8%,2h
41680,2,Chasers,2039,170,4,6,10,40.0%,53m
41680,2,DESCORT,2039,183,4,7,11,36.4%,2h
41680,1,FalseFather,2039,121,4,7,11,36.4%,12m
41680,2,dancer,2039,82,3,3,6,50.0%,44m
41680,2,Sõrin,2039,72,2,8,10,20.0%,2h
41680,1,[TRVMPD]Stephen,2039,48,2,9,11,18.2%,2h
41680,2,Taxor,2039,30,1,3,4,25.0%,2h
41680,1,Omar,2039,0,1,6,7,14.3%,2h
41680,1,kinosouls,2039,0,1,7,8,12.5%,2h
41680,1,ScaryToaster,2039,0,1,8,9,11.1%,2h
41680,1,louflee,2039,0,1,8,9,11.1%,2h
41680,2,adrian,2039,0,0,1,1,0.0%,2h
41680,3,NightKnight,2039,0,0,1,1,0.0%,5m
41704,1,captainbob,2038,1672,150,159,309,48.5%,8m
41704,2,JizzardofOz,2038,603,22,20,42,52.4%,2h
41704,2,[RSGXXX]SpaceEmperor,2038,487,21,19,40,52.5%,2h
41704,2,HyeuN,2038,370,13,11,24,54.2%,2h
41704,2,Triplec,2038,324,11,13,24,45.8%,6m
41704,2,badbillygoat,2038,218,8,13,21,38.1%,2h
41704,2,Raveryn,2038,248,8,13,21,38.1%,2h
41704,1,MiMamáMeMima,2038,201,7,5,12,58.3%,12m
41704,1,Roblin,2038,345,7,12,19,36.8%,2h
41704,2,[nieBla]Kukulza,2038,88,3,2,5,60.0%,2h
41704,2,ICEKORE,2038,90,3,5,8,37.5%,47m
41704,1,Kidmoney,2038,153,3,9,12,25.0%,2h
41704,1,stan,2038,30,3,12,15,20.0%,40m
41704,2,[P07470]KingSalmon,2038,46,2,1,3,66.7%,2h
41704,2,Sunny,2038,30,2,3,5,40.0%,2h
41704,2,[ASC1]FireFalcon,2038,0,1,0,1,100.0%,47m
41704,2,Bituca,2038,30,1,7,8,12.5%,25m
41704,2,ABadMeme,2038,0,0,2,2,0.0%,37m
41704,2,SPECTRUM,2038,73,0,2,2,0.0%,2h
41704,2,kevinm,2038,0,0,2,2,0.0%,47m
41724,1,THORAX,2037,1457,169,176,345,49.0%,2h
41724,2,BalderJiri,2037,926,38,40,78,48.7%,2h
41724,2,[Girlll]prettythanU,2037,842,29,33,62,46.8%,2h
41724,2,Markdat,2037,679,25,34,59,42.4%,2h
41724,2,TheExorcist,2037,411,20,23,43,46.5%,32m
41724,2,Clinton,2037,466,16,19,35,45.7%,24m
41724,2,winner,2037,424,14,22,36,38.9%,37m
41724,2,claudiokbça,2037,315,11,15,26,42.3%,2h
41724,2,[NLTN]MRsheyck,2037,212,7,10,17,41.2%,54m
41724,2,Maleore,2037,165,5,6,11,45.5%,2h
41724,3,kevlevel,2037,170,5,8,13,38.5%,2h
41724,1,[CRBK]Vriel,2037,148,5,11,16,31.2%,2h
41724,3,IwilDestroyU,2037,90,5,14,19,26.3%,13m
41724,3,Shadowmage,2037,30,4,2,6,66.7%,41m
41724,2,Jeruviel,2037,60,3,4,7,42.9%,47m
41724,2,[hekya]CaptainBill,2037,88,2,7,9,22.2%,2h
41724,1,Terramiso,2037,48,2,9,11,18.2%,2h
41724,2,[CR2020]NachoCR,2037,0,1,1,2,50.0%,2h
41724,2,ironbum,2037,30,1,3,4,25.0%,46m
41724,1,Frency,2037,97,1,8,9,11.1%,50m
41724,2,AngryBadger,2037,0,0,2,2,0.0%,2h
41724,3,[EchoIV]Byahh,2037,0,0,5,5,0.0%,54m
41724,2,iohan,2037,0,0,5,5,0.0%,2h
41747,2,Revol,2036,1561,62,66,128,48.4%,2h
41747,2,crixusmiguel,2036,530,46,36,82,56.1%,54m
41747,2,[RUSHya]Baldur,2036,809,30,35,65,46.2%,15m
41747,2,Mangoman,2036,705,26,22,48,54.2%,2h
41747,2,KeelinReid,2036,317,21,29,50,42.0%,2h
41747,2,Alicera,2036,407,16,12,28,57.1%,2h
41747,1,Deathtowel,2036,472,14,20,34,41.2%,2h
41747,2,TGX,2036,229,13,10,23,56.5%,6m
41747,2,Gonza,2036,181,5,5,10,50.0%,36m
41747,2,Xavity,2036,120,4,7,11,36.4%,2h
41747,3,Preo,2036,58,4,10,14,28.6%,14m
41747,1,Monseki,2036,0,1,6,7,14.3%,7m
41747,1,Doombot,2036,0,1,6,7,14.3%,24m
41747,2,potdark,2036,0,0,3,3,0.0%,33m
41747,1,Ardee,2036,0,0,4,4,0.0%,3h
41747,2,AxN,2036,0,0,6,6,0.0%,2h
41763,2,Raiden,2035,1579,99,98,197,50.3%,2h
41763,1,KERMIT,2035,918,49,55,104,47.1%,2h
41763,2,hamcrank,2035,945,41,39,80,51.2%,2h
41763,1,DatBoiCbob,2035,765,27,36,63,42.9%,2h
41763,2,DaHindu,2035,620,24,29,53,45.3%,3m
41763,1,SyphonElite,2035,556,20,24,44,45.5%,17m
41763,2,leoDark,2035,312,11,18,29,37.9%,2h
41763,1,iiiiiiiiiiii,2035,280,7,11,18,38.9%,51m
41763,2,ZayNar,2035,142,4,3,7,57.1%,2h
41763,2,brianseog,2035,118,4,10,14,28.6%,2h
41763,2,Chacha,2035,112,3,1,4,75.0%,2h
41763,2,cartonet,2035,124,3,8,11,27.3%,2h
41763,1,Xanthicus,2035,122,2,9,11,18.2%,42m
41763,2,lwidner,2035,30,1,2,3,33.3%,2h
41763,2,LinkCO,2035,46,1,4,5,20.0%,2h
41763,1,WolvenFire,2035,0,1,7,8,12.5%,13m
41763,3,ColdEnd,2035,0,1,8,9,11.1%,2h
41763,2,[GLHF1]FASD,2035,0,0,3,3,0.0%,55m
41763,3,CRIMSON,2035,0,0,5,5,0.0%,2h
41782,1,[NLTN]laguz,2034,1624,133,137,270,49.3%,2h
41782,1,LazyTitan,2034,616,84,85,169,49.7%,2h
41782,2,YamotoMusash,2034,1169,42,51,93,45.2%,47m
41782,2,ALIEN,2034,659,39,37,76,51.3%,2h
41782,2,Slaperr,2034,348,23,22,45,51.1%,2h
41782,2,[MMSTAR]VirusMoDe,2034,511,19,26,45,42.2%,2h
41782,2,Caelus,2034,166,5,4,9,55.6%,38m
41782,1,FXx,2034,124,5,9,14,35.7%,3h
41782,2,Firewall,2034,112,3,1,4,75.0%,2h
41782,2,autompne,2034,77,3,2,5,60.0%,52m
41782,1,Millicent,2034,97,2,8,10,20.0%,2h
41782,1,[773H]doomTRON,2034,48,2,9,11,18.2%,2h
41782,1,[KCCO99]scruffynerd,2034,96,1,1,2,50.0%,47m
41782,2,RebelSzn,2034,0,1,1,2,50.0%,2h
41782,2,[ITUSKI]Hirtis,2034,0,1,4,5,20.0%,23m
41782,2,Splime,2034,0,0,4,4,0.0%,2h
41798,2,yamalama,2033,1146,110,110,220,50.0%,2h
41798,2,DeepBlue,2033,198,10,10,20,50.0%,2h
41798,2,KekoSG,2033,195,6,9,15,40.0%,2h
41798,2,zellencrak,2033,182,6,15,21,28.6%,2h
41798,1,Fish,2033,187,4,10,14,28.6%,2h
41798,2,logo,2033,126,3,3,6,50.0%,14m
41798,2,zeropalmas,2033,100,3,5,8,37.5%,2h
41798,2,ARGENTO,2033,171,3,9,12,25.0%,2h
41798,1,Corpzey,2033,96,2,2,4,50.0%,2h
41798,2,mori,2033,30,2,3,5,40.0%,2h
41798,2,SilverFox,2033,60,2,5,7,28.6%,2h
41798,2,ColonelT,2033,95,1,2,3,33.3%,2h
41798,1,Mecs,2033,0,1,3,4,25.0%,10m
41798,2,AshbySan,2033,46,1,3,4,25.0%,39m
41798,1,Moiscrack,2033,0,1,7,8,12.5%,2h
41798,3,USTANG,2033,0,0,5,5,0.0%,12m
41814,2,brandon,2032,508,19,15,34,55.9%,21m
41814,2,stinkNtink,2032,311,9,11,20,45.0%,3m
41814,2,IIIIIIIIIIII,2032,253,9,14,23,39.1%,46m
41814,2,chriso,2032,256,8,9,17,47.1%,2h
41814,2,terran,2032,213,7,13,20,35.0%,46m
41814,2,Miracle,2032,128,4,1,5,80.0%,54m
41814,1,Blakcfoxx,2032,48,4,7,11,36.4%,6m
41814,2,acdcnut,2032,58,3,3,6,50.0%,2h
41814,1,deadlyflames,2032,0,3,4,7,42.9%,2h
41814,2,[RAWRRw]GrumpyKitten,2032,62,2,4,6,33.3%,46m
41814,2,ilpumaxd,2032,0,1,4,5,20.0%,42m
41814,2,Gonza,2032,30,1,4,5,20.0%,2h
41814,2,ignerant,2032,96,1,4,5,20.0%,2h
41814,2,CHUCKNORRIS,2032,0,1,5,6,16.7%,27m
41814,1,LegadOrtiz,2032,0,1,7,8,12.5%,2h
41814,2,[LY0]ALEX,2032,0,0,1,1,0.0%,15m
41814,2,Lich,2032,0,0,2,2,0.0%,2h
41814,2,Zeaks,2032,0,0,6,6,0.0%,6m
41832,2,roxuko,2031,1261,162,201,363,44.6%,38m
41832,2,Presiwhite,2031,1637,60,68,128,46.9%,25m
41832,1,Karmillion,2031,829,47,49,96,49.0%,2h
41832,2,Guts,2031,1034,42,39,81,51.9%,2h
41832,2,Supreme,2031,701,28,22,50,56.0%,55m
41832,2,Plokyprotos,2031,660,25,30,55,45.5%,2h
41832,1,OOA,2031,642,20,28,48,41.7%,41m
41832,2,[ExcIgN]lerrais,2031,411,16,15,31,51.6%,54m
41832,2,electrokoto,2031,407,16,16,32,50.0%,46m
41832,2,ItachiUchiha,2031,461,16,21,37,43.2%,3m
41832,2,VolcanoMaN,2031,482,16,23,39,41.0%,42m
41832,1,[RSBOYS]SPreezy,2031,239,10,12,22,45.5%,55m
41832,2,GeeGee,2031,205,8,7,15,53.3%,2h
41832,2,Bendonover,2031,265,8,17,25,32.0%,2h
41832,1,PlackTUM,2031,317,8,19,27,29.6%,2h
41832,2,Teladi,2031,243,7,13,20,35.0%,38m
41832,2,[ACCR]belOwZerO,2031,194,5,3,8,62.5%,2h
41832,3,BrokenDream,2031,121,2,2,4,50.0%,2h
41832,3,[Ir0n]zach,2031,0,2,8,10,20.0%,2h
41832,1,Sygone,2031,38,2,8,10,20.0%,55m
41832,3,tjitji,2031,0,1,4,5,20.0%,2h
41832,2,[WolfGT]abnerPF,2031,0,0,3,3,0.0%,2h
41832,2,VoidWraith,2031,0,0,6,6,0.0%,2h
41855,2,BolsonaroRJ,2030,1530,86,99,185,46.5%,47m
41855,2,Valar,2030,892,49,49,98,50.0%,2h
41855,2,[TheCul]rÄwr,2030,724,45,21,66,68.2%,36m
41855,1,[464]Maritacas,2030,592,19,31,50,38.0%,2h
41855,1,poo,2030,350,10,19,29,34.5%,2h
41855,2,ryany,2030,283,9,12,21,42.9%,6m
41855,3,Hormigón,2030,235,9,12,21,42.9%,47m
41855,2,[LSTR4]JTG,2030,253,7,10,17,41.2%,2h
41855,2,[FL4]javr,2030,182,6,10,16,37.5%,21m
41855,3,MrLonely,2030,149,4,12,16,25.0%,35m
41855,2,[MADBUF]madtatanka,2030,128,3,9,12,25.0%,2h
41855,2,[Hulu]TheTrain,2030,30,2,1,3,66.7%,36m
41855,2,ThanosTheMan,2030,38,2,2,4,50.0%,33m
41855,2,JaysonRDC,2030,0,0,2,2,0.0%,33m
41855,2,SlopySeconds,2030,0,0,5,5,0.0%,2h
41855,2,BENJAMIN,2030,0,0,6,6,0.0%,2h
41871,2,GLHaveFun,2029,1025,258,284,542,47.6%,52m
41871,3,[No0Bs]Grunter,2029,1516,174,200,374,46.5%,8m
41871,2,RowdyRow,2029,1409,76,78,154,49.4%,2h
41871,2,[ERFT]Sargento,2029,1476,57,60,117,48.7%,37m
41871,2,SWOLYxCAT,2029,1059,40,43,83,48.2%,2h
41871,2,[HLKT]PraporWorker,2029,592,21,23,44,47.7%,2h
41871,2,Lout,2029,491,20,16,36,55.6%,49m
41871,2,Doney,2029,495,18,25,43,41.9%,2h
41871,2,Floodslayer,2029,314,10,10,20,50.0%,2h
41871,2,gunquistador,2029,258,8,10,18,44.4%,2h
41871,2,RotCybert,2029,242,8,12,20,40.0%,22m
41871,2,Arcanior,2029,180,5,5,10,50.0%,36m
41871,2,DiscountJoke,2029,140,3,3,6,50.0%,3h
41871,2,callmedaddy,2029,94,2,1,3,66.7%,42m
41871,2,[Gogui]Jeosung,2029,60,2,8,10,20.0%,2h
41871,2,[Apink1]Apink,2029,0,1,0,1,100.0%,32m
41871,2,Ozymandias,2029,46,1,3,4,25.0%,2h
41871,1,Gabonator,2029,0,1,8,9,11.1%,22m
41871,2,PeelerJr,2029,0,0,1,1,0.0%,2h
41871,1,[VIPpro]zeratul,2029,0,0,1,1,0.0%,2h
41871,2,[ZUCCED]Tree,2029,0,0,3,3,0.0%,2h
41871,2,Onslaught,2029,0,0,6,6,0.0%,36m
41871,2,Cam,2029,0,0,6,6,0.0%,32m
41871,2,Scar,2029,0,0,6,6,0.0%,6m
41895,2,kunguen,2028,873,36,33,69,52.2%,6m
41895,2,Zeashan,2028,444,16,22,38,42.1%,3m
41895,1,Queiroga,2028,482,16,22,38,42.1%,48m
41895,2,LOCURAAAAAAA,2028,329,14,11,25,56.0%,21m
41895,2,LNewlands,2028,391,14,17,31,45.2%,2h
41895,2,farizbjxrn,2028,346,11,20,31,35.5%,41m
41895,1,DDS,2028,270,8,14,22,36.4%,2h
41895,2,imposing,2028,266,7,8,15,46.7%,2h
41895,2,Max,2028,106,3,10,13,23.1%,38m
41895,2,[WoFire]Ttwin,2028,32,2,5,7,28.6%,9m
41895,2,filpninja,2028,30,2,6,8,25.0%,6m
41895,1,llllllllllll,2028,40,2,7,9,22.2%,2h
41895,2,[KEMI]Siska,2028,30,1,6,7,14.3%,2h
41895,2,JoYkiLLaH,2028,0,1,6,7,14.3%,53m
41895,1,youngbouzin,2028,0,1,8,9,11.1%,49m
41895,1,Killman,2028,0,0,5,5,0.0%,2h
41911,3,Cahava,2027,1510,148,154,302,49.0%,2h
41911,2,Shredder,2027,1581,115,119,234,49.1%,49m
41911,1,jose,2027,1457,63,80,143,44.1%,2h
41911,2,TheChuck,2027,916,40,37,77,51.9%,2h
41911,2,gothboy,2027,853,31,42,73,42.5%,2h
41911,2,cboogie,2027,531,24,18,42,57.1%,2h
41911,2,CiRiS,2027,504,21,16,37,56.8%,2h
41911,2,EGDumB,2027,70,10,16,26,38.5%,2h
41911,2,Datralo,2027,218,8,4,12,66.7%,2h
41911,2,kramc,2027,160,6,10,16,37.5%,2h
41911,1,Shiznips,2027,228,6,15,21,28.6%,2h
41911,2,Pikuy,2027,177,5,9,14,35.7%,40m
41911,2,[TERRlS]Pdubbsss,2027,141,4,2,6,66.7%,25m
41911,2,[3xCHAP]Chappy,2027,92,3,9,12,25.0%,2h
41911,2,GuideonCrow,2027,30,2,3,5,40.0%,46m
41911,3,[KCDah]zergpimp,2027,0,2,3,5,40.0%,2h
41911,2,Redrix,2027,66,2,8,10,20.0%,2h
41911,2,JarJarBlinks,2027,0,1,0,1,100.0%,2h
41911,1,batatatxt,2027,36,1,6,7,14.3%,13m
41911,2,DrZ,2027,0,0,2,2,0.0%,23m
41911,2,CreepyTree,2027,0,0,3,3,0.0%,2h
41911,2,dolphin,2027,0,0,3,3,0.0%,2h
41911,3,Chilakiller,2027,0,0,7,7,0.0%,2h
41934,2,JeanC,2026,1115,86,90,176,48.9%,6m
41934,2,[OL3C]Odura,2026,1104,84,90,174,48.3%,2h
41934,2,Yasar,2026,1362,77,84,161,47.8%,6m
41934,2,Gustavex,2026,550,18,23,41,43.9%,2h
41934,3,RazerBeast,2026,294,12,12,24,50.0%,2h
41934,2,[CULTUR]ZeroGravitas,2026,305,10,12,22,45.5%,2h
41934,2,Andrew,2026,347,10,13,23,43.5%,2h
41934,2,laotemujen,2026,212,8,14,22,36.4%,2h
41934,2,Jackson,2026,105,7,10,17,41.2%,2h
41934,1,rego,2026,168,6,14,20,30.0%,2h
41934,1,sayten,2026,163,5,4,9,55.6%,3h
41934,2,lazyturtle,2026,90,4,3,7,57.1%,46m
41934,2,muganynnos,2026,88,4,3,7,57.1%,2h
41934,2,RollForward,2026,46,3,6,9,33.3%,27m
41934,3,[GRNSKN]LETHALxDRONE,2026,58,2,1,3,66.7%,2h
41934,2,[RTY]XxrtyxX,2026,88,2,1,3,66.7%,2h
41934,3,scarypig,2026,0,1,0,1,100.0%,2h
41934,2,Valiant,2026,88,1,2,3,33.3%,2h
41934,2,sebas,2026,97,1,2,3,33.3%,2h
41934,2,nHale,2026,30,1,3,4,25.0%,47m
41934,1,sic,2026,48,1,6,7,14.3%,50m
41934,2,[Susss]CyanMoss,2026,0,0,3,3,0.0%,2h
41934,3,Kommandant,2026,0,0,4,4,0.0%,2h
41957,1,juantbps,2025,1394,77,84,161,47.8%,37m
41957,2,JFLC,2025,675,36,39,75,48.0%,3h
41957,2,Zetho,2025,621,26,18,44,59.1%,2h
41957,2,[LBanda]luxo,2025,630,26,26,52,50.0%,2h
41957,2,Tekuani,2025,572,21,23,44,47.7%,40m
41957,2,PhyscoZealot,2025,221,10,10,20,50.0%,2h
41957,2,gsrighi,2025,129,4,7,11,36.4%,2h
41957,2,YOSVAN,2025,126,4,9,13,30.8%,24m
41957,3,Maybe,2025,62,4,10,14,28.6%,35m
41957,2,duke,2025,86,3,8,11,27.3%,2h
41957,3,SowFar,2025,0,1,4,5,20.0%,2h
41957,1,shynspru,2025,0,0,3,3,0.0%,18m
41957,2,OnEKinG,2025,0,0,5,5,0.0%,37m
41970,2,LIMAPASIV,2024,1331,112,121,233,48.1%,25m
41970,2,luismencov,2024,1358,63,66,129,48.8%,49m
41970,2,VanQ,2024,1551,60,57,117,51.3%,2h
41970,3,Justinian,2024,1563,60,61,121,49.6%,2h
41970,2,Qaphsiel,2024,1452,55,63,118,46.6%,3m
41970,2,KamikazeSE,2024,934,49,61,110,44.5%,2h
41970,2,AlfredPollo,2024,1137,43,45,88,48.9%,37m
41970,3,GoochGoblin,2024,792,30,34,64,46.9%,2h
41970,2,nabdos,2024,685,27,22,49,55.1%,2h
41970,2,goodguy,2024,448,18,13,31,58.1%,2h
41970,2,[ESTF]Beto,2024,174,6,10,16,37.5%,2h
41970,3,FernasRPG,2024,0,3,2,5,60.0%,1h
41970,2,sasquatch,2024,30,2,1,3,66.7%,2h
41970,3,[SWlNE]JTheSeagull,2024,30,1,1,2,50.0%,2h
41970,3,crislarrix,2024,0,0,1,1,0.0%,45m
41970,1,Soulantrax,2024,0,0,4,4,0.0%,3h
41986,2,SFBobN,2023,1538,194,204,398,48.7%,2h
41986,2,[RusHCr]Henegg,2023,1211,149,153,302,49.3%,3h
41986,2,IIIIIIIIIIII,2023,1263,91,82,173,52.6%,2h
41986,2,SuperJGo,2023,726,30,34,64,46.9%,2h
41986,3,Arie,2023,318,13,18,31,41.9%,3h
41986,2,Erick,2023,304,10,10,20,50.0%,48m
41986,1,Bastiann,2023,302,8,24,32,25.0%,38m
41986,2,IMkoreanNoob,2023,176,6,9,15,40.0%,2h
41986,3,MattBarry,2023,86,5,4,9,55.6%,2h
41986,2,Odin,2023,102,2,2,4,50.0%,14m
41986,2,Stugots,2023,102,2,2,4,50.0%,25m
41986,1,kai,2023,0,1,0,1,100.0%,2h
41986,3,Steven,2023,0,1,0,1,100.0%,2h
41986,3,Little,2023,30,1,2,3,33.3%,2h
41986,1,MannerlyDeer,2023,0,0,3,3,0.0%,2h
41986,2,FaceBones,2023,0,0,4,4,0.0%,14m
41986,2,awesome,2023,0,0,4,4,0.0%,2h
42003,1,mrdestiny,2022,965,34,49,83,41.0%,2h
42003,2,[Andraz]Moony,2022,629,33,33,66,50.0%,3m
42003,1,kirlanx,2022,680,23,34,57,40.4%,15m
42003,2,TokinTurtle,2022,526,17,27,44,38.6%,2h
42003,2,[UNFK]Kenesky,2022,322,13,16,29,44.8%,2h
42003,2,LorBenja,2022,372,13,22,35,37.1%,2h
42003,1,[3x0diA]cLMarines,2022,286,12,12,24,50.0%,7m
42003,1,TEHb,2022,295,10,19,29,34.5%,2h
42003,2,borromeo,2022,122,4,6,10,40.0%,2h
42003,1,dillon,2022,48,2,2,4,50.0%,2h
42003,3,SamyG,2022,0,2,2,4,50.0%,42m
42003,2,Sean,2022,62,2,7,9,22.2%,2h
42003,3,Cremedawg,2022,30,1,1,2,50.0%,2h
42003,1,vinaykhz,2022,48,1,4,5,20.0%,2h
42003,3,Sekiryuutei,2022,0,0,1,1,0.0%,2h
42003,3,Kalizzo,2022,0,0,1,1,0.0%,29m
42003,2,Jabbernaut,2022,0,0,1,1,0.0%,2h
42003,2,DURDEN,2022,0,0,2,2,0.0%,40m
42003,1,GARCILASO,2022,0,0,2,2,0.0%,2h
42003,3,simonL,2022,0,0,5,5,0.0%,2h
42003,2,[SCVM]jeidjj,2022,0,0,6,6,0.0%,50m
42024,1,Purp,2021,1514,53,71,124,42.7%,38m
42024,2,PapaBear,2021,815,40,22,62,64.5%,2h
42024,2,oof,2021,839,31,38,69,44.9%,25m
42024,2,SlimChicken,2021,666,29,27,56,51.8%,37m
42024,2,[DhZAc1]Morg,2021,469,21,18,39,53.8%,55m
42024,1,larr,2021,298,9,11,20,45.0%,2h
42024,2,[USAF20]DarthKarax,2021,297,9,12,21,42.9%,2h
42024,2,cucu,2021,120,8,10,18,44.4%,2h
42024,3,GreassyGamer,2021,194,7,5,12,58.3%,42m
42024,2,Punisher,2021,150,6,8,14,42.9%,2h
42024,2,Nukeinyrarea,2021,177,5,5,10,50.0%,2h
42024,2,[Shoto]KittenFlavor,2021,160,5,10,15,33.3%,2h
42024,1,Quantum,2021,144,5,12,17,29.4%,2h
42024,2,Tastynoodles,2021,120,4,7,11,36.4%,2h
42024,2,Frozz,2021,46,4,8,12,33.3%,2h
42024,2,BIOS,2021,30,3,12,15,20.0%,22m
42024,3,shadowmaster,2021,30,2,0,2,100.0%,11m
42024,1,NAbronzeACC,2021,113,2,2,4,50.0%,12m
42024,2,FFKitty,2021,122,2,4,6,33.3%,2h
42024,2,Vitmore,2021,0,1,2,3,33.3%,2h
42024,1,Erickbloody,2021,0,1,7,8,12.5%,49m
42024,3,Caric,2021,0,0,5,5,0.0%,1h
42046,2,gustin,2020,1380,59,54,113,52.2%,3h
42046,1,ALUCARD,2020,849,47,56,103,45.6%,2h
42046,2,BringRuckus,2020,1032,45,34,79,57.0%,2h
42046,1,Archangel,2020,342,12,18,30,40.0%,3h
42046,2,publicò,2020,142,4,3,7,57.1%,2h
42046,3,Proooceedin,2020,150,4,12,16,25.0%,44m
42046,3,KingJocko,2020,30,2,1,3,66.7%,19m
42046,2,chabelin,2020,30,2,2,4,50.0%,2h
42046,2,Colossus,2020,30,1,3,4,25.0%,2h
42046,2,SKOLLFANG,2020,30,1,5,6,16.7%,14m
42056,2,ShadyNasty,2019,1056,40,40,80,50.0%,2h
42056,2,Chopin,2019,512,20,22,42,47.6%,2h
42056,1,cmillie,2019,314,11,16,27,40.7%,2h
42056,2,yabeer,2019,155,5,12,17,29.4%,2h
42056,1,[evrgrn]Zee,2019,44,4,6,10,40.0%,37m
42056,2,[BAP01]ElChapirete,2019,128,3,4,7,42.9%,2h
42056,3,[GFAQs]MindXplosion,2019,0,3,5,8,37.5%,2h
42056,2,GusBest,2019,30,2,2,4,50.0%,15m
42056,3,Menjunje,2019,97,2,10,12,16.7%,47m
42056,3,ssyang,2019,0,0,1,1,0.0%,30m
42056,2,[xDPx]Visceral,2019,0,0,3,3,0.0%,39m
42056,3,MrViperx,2019,0,0,5,5,0.0%,2h
42056,2,stanlortm,2019,0,0,6,6,0.0%,55m
42069,2,SgtFluffy,2018,1083,95,90,185,51.4%,2h
42069,2,TheKyinKyan,2018,1548,58,63,121,47.9%,2h
42069,1,MESC,2018,910,33,46,79,41.8%,42m
42069,2,franco,2018,504,19,17,36,52.8%,46m
42069,1,beemangy,2018,292,14,27,41,34.1%,45m
42069,3,miniNinja,2018,150,12,14,26,46.2%,35m
42069,2,camja,2018,279,11,8,19,57.9%,2h
42069,3,joey,2018,272,10,7,17,58.8%,29m
42069,2,void,2018,205,8,6,14,57.1%,33m
42069,2,CyBorge,2018,206,7,10,17,41.2%,2h
42069,2,[MADPAM]Franco,2018,148,6,9,15,40.0%,14m
42069,2,PenguinBeast,2018,159,5,9,14,35.7%,9m
42069,2,Tweezy,2018,94,3,2,5,60.0%,2h
42069,2,KaKaYIV,2018,30,3,9,12,25.0%,37m
42069,3,samuel,2018,30,3,11,14,21.4%,19m
42069,2,DarkHelmet,2018,0,0,2,2,0.0%,2h
42069,2,Antonio,2018,0,0,2,2,0.0%,39m
42069,2,BetaStar,2018,0,0,4,4,0.0%,39m
42087,2,ackattack,2017,1311,96,103,199,48.2%,54m
42087,2,WillxDiesel,2017,1357,80,69,149,53.7%,46m
42087,3,Arthur,2017,1588,64,71,135,47.4%,42m
42087,2,[TERRlS]Lrrr,2017,884,35,38,73,47.9%,46m
42087,2,Mrezende,2017,286,19,20,39,48.7%,2h
42087,1,Koda,2017,468,16,23,39,41.0%,2h
42087,2,Zeus,2017,394,14,26,40,35.0%,19m
42087,2,BroMouzone,2017,95,9,19,28,32.1%,2h
42087,1,MMMMMHOTDOGS,2017,212,7,4,11,63.6%,6m
42087,2,RubberFangz,2017,178,7,7,14,50.0%,2h
42087,2,penisduro,2017,130,6,10,16,37.5%,47m
42087,2,Snorlax,2017,165,5,6,11,45.5%,2h
42087,2,LookingFresh,2017,93,2,5,7,28.6%,27m
42087,2,GamingShane,2017,0,2,6,8,25.0%,2h
42087,2,Seriu,2017,73,2,10,12,16.7%,2h
42087,2,MARINESxONLY,2017,0,1,0,1,100.0%,33m
42087,2,fatcat,2017,0,1,1,2,50.0%,2h
42087,2,Beerlighter,2017,93,1,6,7,14.3%,2h
42087,1,Protoss,2017,48,1,7,8,12.5%,31m
42087,3,[FUMON]Carlos,2017,0,0,1,1,0.0%,16m
42087,2,Saintcloud,2017,0,0,2,2,0.0%,2h
42108,2,HippieCom,2016,1548,135,147,282,47.9%,2h
42108,1,Sinisterjedi,2016,763,26,34,60,43.3%,7m
42108,2,[ORUS]ancesur,2016,604,23,30,53,43.4%,2h
42108,2,[ORTE]darcklord,2016,538,22,16,38,57.9%,6m
42108,2,Wolfrick,2016,375,14,21,35,40.0%,2h
42108,1,hopzz,2016,144,4,11,15,26.7%,22m
42108,3,blackparade,2016,60,4,13,17,23.5%,22m
42108,2,MidniteYeti,2016,112,3,10,13,23.1%,2h
42108,2,Gust,2016,30,2,4,6,33.3%,2h
42108,1,Klenchan,2016,0,1,6,7,14.3%,2h
42108,3,[Wat3rs]cisco,2016,0,0,1,1,0.0%,47m
42108,2,SpaceSpandex,2016,0,0,1,1,0.0%,2h
42108,2,BeastBoy,2016,0,0,1,1,0.0%,47m
42108,2,[suka]MotorMouf,2016,0,0,2,2,0.0%,47m
42108,2,impone,2016,0,0,3,3,0.0%,2h
42108,2,IDLEcrack,2016,0,0,3,3,0.0%,2h
42108,2,Psilocybe,2016,0,0,3,3,0.0%,42m
42108,3,yoo,2016,0,0,5,5,0.0%,23m
42126,2,mahshie,2015,1321,84,83,167,50.3%,2h
42126,2,Mingleberry,2015,1592,83,92,175,47.4%,2h
42126,2,dimotay,2015,182,18,25,43,41.9%,2h
42126,2,Darkmarine,2015,322,11,15,26,42.3%,2h
42126,2,Rarrar,2015,244,9,7,16,56.2%,37m
42126,1,Bluebaron,2015,130,5,11,16,31.2%,2h
42126,2,xiaobai,2015,30,3,7,10,30.0%,42m
42126,3,AidanMcCOOL,2015,30,2,0,2,100.0%,2h
42126,3,Clanc,2015,30,2,0,2,100.0%,35m
42126,2,[HN504]noobleak,2015,34,2,5,7,28.6%,2h
42126,1,[AbcCo]Lionx,2015,30,2,7,9,22.2%,33m
42126,3,Harpo,2015,0,0,1,1,0.0%,32m
42138,2,Conner,2014,1113,40,51,91,44.0%,21m
42138,2,Mano,2014,752,25,34,59,42.4%,51m
42138,2,Stza,2014,477,22,21,43,51.2%,2h
42138,2,FangYuanNan,2014,404,14,13,27,51.9%,14m
42138,2,viral,2014,337,12,14,26,46.2%,2h
42138,2,YogurtVini,2014,372,12,18,30,40.0%,2h
42138,2,[XDL]XaTuKo,2014,326,10,19,29,34.5%,42m
42138,1,Ghost,2014,189,5,8,13,38.5%,2h
42138,2,[xNetx]kevin,2014,178,4,3,7,57.1%,44m
42138,3,ElHr,2014,30,2,0,2,100.0%,2h
42138,2,TJStar,2014,88,2,1,3,66.7%,2h
42138,3,Papa,2014,0,1,0,1,100.0%,2h
42138,2,Iro,2014,30,1,3,4,25.0%,2h
42138,2,[EPCK]LightNinjaSC,2014,30,1,4,5,20.0%,2h
42138,3,coronavirus,2014,0,0,1,1,0.0%,2h
42138,2,[GGWolf]Ghost,2014,0,0,2,2,0.0%,55m
42138,2,Mynos,2014,0,0,3,3,0.0%,53m
42138,1,[BeerLH]Zohdin,2014,0,0,5,5,0.0%,2h
42138,3,luis,2014,0,0,5,5,0.0%,2h
42157,2,joemer,2013,705,27,40,67,40.3%,37m
42157,2,Broshi,2013,756,26,35,61,42.6%,25m
42157,2,Raven,2013,506,18,25,43,41.9%,2h
42157,2,thor,2013,492,17,17,34,50.0%,2h
42157,2,Zornhau,2013,343,9,12,21,42.9%,49m
42157,2,[CTHEGG]Cauthon,2013,152,8,5,13,61.5%,6m
42157,1,DEADSHOT,2013,206,6,11,17,35.3%,50m
42157,1,[VINGAD]Polegar,2013,36,5,5,10,50.0%,2h
42157,2,Pantz,2013,176,5,6,11,45.5%,49m
42157,3,[WHEELZ]Budokill,2013,171,5,13,18,27.8%,44m
42157,2,paraFox,2013,118,4,11,15,26.7%,2h
42157,2,Wildchild,2013,134,4,11,15,26.7%,24m
42157,1,BurritoWin,2013,0,3,5,8,37.5%,2h
42157,1,shamam,2013,120,3,10,13,23.1%,2h
42157,2,Naaarf,2013,0,2,4,6,33.3%,2h
42157,2,SlenderQuin,2013,0,1,1,2,50.0%,2h
42157,2,RiggaMoreau,2013,88,1,2,3,33.3%,2h
42157,2,jaemsy,2013,48,1,3,4,25.0%,6m
42157,2,micah,2013,0,1,3,4,25.0%,15m
42157,2,Humor,2013,44,1,7,8,12.5%,2h
42157,3,CleanPot,2013,0,0,1,1,0.0%,2h
42157,3,Scarface,2013,0,0,1,1,0.0%,2h
42157,3,TheCoachLIVE,2013,0,0,2,2,0.0%,2h
42157,2,Odiseo,2013,0,0,2,2,0.0%,2h
42157,3,xdelpro,2013,0,0,5,5,0.0%,34m
42182,1,Bassics,2012,1550,55,70,125,44.0%,2h
42182,2,Voyager,2012,538,40,36,76,52.6%,2h
42182,2,triksta,2012,233,12,13,25,48.0%,2h
42182,1,pbecotte,2012,190,5,12,17,29.4%,49m
42182,1,zinicstorm,2012,97,3,8,11,27.3%,51m
42182,2,[TheRs]LinedOut,2012,0,1,1,2,50.0%,2h
42182,3,Jetvar,2012,30,1,2,3,33.3%,36m
42182,2,Lerellion,2012,0,1,2,3,33.3%,2h
42182,2,[ZTempz]RokMan,2012,97,1,3,4,25.0%,46m
42182,3,Hexor,2012,0,1,3,4,25.0%,41m
42182,3,Hisoka,2012,0,0,5,5,0.0%,2h
42193,1,ivan,2011,1491,101,106,207,48.8%,2h
42193,2,mattman,2011,248,14,14,28,50.0%,2h
42193,2,oleg,2011,314,14,19,33,42.4%,46m
42193,2,Tempestß,2011,307,11,14,25,44.0%,2h
42193,3,Nicoli,2011,283,10,9,19,52.6%,55m
42193,1,Brandon,2011,220,9,21,30,30.0%,53m
42193,2,aimer,2011,217,8,9,17,47.1%,2h
42193,3,[CTVS]Ezkalante,2011,86,4,1,5,80.0%,56m
42193,2,Tricky,2011,151,4,5,9,44.4%,2h
42193,2,[TPGGXD]AliensXD,2011,203,4,9,13,30.8%,2h
42193,2,PyroGlyph,2011,142,2,7,9,22.2%,6m
42193,3,guido,2011,0,1,0,1,100.0%,25m
42193,2,QZG,2011,0,1,2,3,33.3%,51m
42193,3,mimo,2011,0,1,4,5,20.0%,5m
42193,3,Cheddar,2011,0,1,4,5,20.0%,11m
42193,3,[USWAG]CAMILALIAGAV,2011,0,0,1,1,0.0%,55m
42209,2,Danscott,2010,1090,40,47,87,46.0%,2h
42209,3,Trogdor,2010,757,33,24,57,57.9%,2h
42209,1,[IdArmy]CABLE,2010,479,23,31,54,42.6%,29m
42209,3,FABIOGF,2010,244,10,12,22,45.5%,44m
42209,2,BigBlueFox,2010,150,5,11,16,31.2%,53m
42209,2,Jahosifat,2010,126,4,3,7,57.1%,2h
42209,2,CHIBOLIN,2010,30,3,13,16,18.8%,2h
42209,2,cubanpapi,2010,92,2,9,11,18.2%,23m
42209,2,HOLYJR,2010,0,1,7,8,12.5%,2h
42209,1,nikecrack,2010,0,1,7,8,12.5%,2h
42219,2,Duckif,2009,1487,137,137,274,50.0%,50m
42219,2,Vanir,2009,663,57,50,107,53.3%,33m
42219,2,kingofblades,2009,1110,49,35,84,58.3%,2h
42219,2,Ajax,2009,452,15,19,34,44.1%,2h
42219,1,Yauhushua,2009,222,7,8,15,46.7%,2h
42219,2,CrisScience,2009,200,6,12,18,33.3%,25m
42219,1,lol,2009,186,5,11,16,31.2%,22m
42219,2,fenix,2009,149,4,13,17,23.5%,2h
42219,2,Mikasaaaaaaa,2009,168,3,4,7,42.9%,6m
42219,2,oneandonly,2009,0,3,4,7,42.9%,2h
42219,2,Joradrivia,2009,30,2,2,4,50.0%,2h
42219,2,thekoopazerg,2009,48,1,3,4,25.0%,35m
42219,2,McCloud,2009,0,1,7,8,12.5%,31m
42219,1,Haxor,2009,0,1,7,8,12.5%,6m
42219,3,Sidney,2009,0,0,5,5,0.0%,2h
42219,3,Zaccboy,2009,0,0,5,5,0.0%,2h
42235,3,DrackonHntr,2008,921,34,35,69,49.3%,2h
42235,2,dylan,2008,502,27,31,58,46.6%,51m
42235,2,[HOT69]UmessUdead,2008,583,23,24,47,48.9%,2h
42235,2,Danz,2008,438,20,15,35,57.1%,2h
42235,2,Gamv,2008,520,18,22,40,45.0%,3m
42235,1,[SPQ]CrisstobalZX,2008,166,8,22,30,26.7%,43m
42235,3,Ikaika,2008,179,5,3,8,62.5%,2h
42235,1,GingAD,2008,60,5,6,11,45.5%,41m
42235,1,BDUQUE,2008,157,3,6,9,33.3%,45m
42235,1,Huff,2008,110,2,9,11,18.2%,38m
42235,3,MNCAD,2008,0,1,0,1,100.0%,12m
42235,3,[WuTang]METHODman,2008,0,1,4,5,20.0%,2h
42235,3,TriAngles,2008,30,1,5,6,16.7%,1h
42235,3,GalaxyTh,2008,0,0,1,1,0.0%,3m
42235,3,DOGGYSLEAZE,2008,0,0,2,2,0.0%,55m
42235,2,SeehoWeasy,2008,0,0,6,6,0.0%,48m
42235,2,Doggo,2008,0,0,6,6,0.0%,2h
42252,2,camelo,2007,1577,101,111,212,47.6%,28m
42252,2,Urameshi,2007,721,96,101,197,48.7%,3h
42252,2,Iki,2007,1156,52,64,116,44.8%,4m
42252,2,ShadowZack,2007,580,20,27,47,42.6%,2h
42252,1,[LifeF]Stealer,2007,636,20,33,53,37.7%,2h
42252,2,MaddHatter,2007,331,15,14,29,51.7%,2h
42252,1,HeYa,2007,490,15,26,41,36.6%,2h
42252,2,Xapo,2007,436,14,24,38,36.8%,46m
42252,2,Akess,2007,381,12,25,37,32.4%,2h
42252,2,sworder,2007,182,7,10,17,41.2%,2h
42252,2,[SobH]iBugs,2007,30,5,4,9,55.6%,2h
42252,2,GiRodeo,2007,132,5,6,11,45.5%,2h
42252,2,vinz,2007,150,5,12,17,29.4%,2h
42252,1,Macarrom,2007,246,5,14,19,26.3%,8m
42252,2,JBKJ,2007,94,3,5,8,37.5%,2h
42252,3,krioztasis,2007,0,2,9,11,18.2%,2h
42252,2,Leonard,2007,0,1,6,7,14.3%,4m
42252,2,PsyfeR,2007,36,1,7,8,12.5%,2h
42252,3,gundoorofwar,2007,0,0,1,1,0.0%,2h
42252,2,AloneStilo,2007,0,0,2,2,0.0%,6m
42252,1,GhostTemplar,2007,0,0,8,8,0.0%,27m
42273,2,LegatusBobo,2006,463,36,42,78,46.2%,6m
42273,1,Witkit,2006,966,36,43,79,45.6%,2h
42273,2,wenshengege,2006,477,19,19,38,50.0%,33m
42273,2,iselldank,2006,474,19,19,38,50.0%,2h
42273,2,ODION,2006,211,8,8,16,50.0%,2h
42273,1,encpirate,2006,264,8,17,25,32.0%,2h
42273,2,[LKA]Abadon,2006,170,5,5,10,50.0%,50m
42273,1,John,2006,168,4,3,7,57.1%,49m
42273,3,Conda,2006,123,2,4,6,33.3%,2h
42273,2,Zarazua,2006,32,2,5,7,28.6%,2h
42273,2,JonSnow,2006,0,1,0,1,100.0%,2h
42273,2,[PobSC]litrox,2006,0,1,2,3,33.3%,2h
42273,3,player,2006,0,0,1,1,0.0%,1h
42286,2,[LETAL]javito,2005,1571,158,178,336,47.0%,2h
42286,2,Áine,2005,1005,34,48,82,41.5%,2h
42286,2,RJPAR,2005,773,31,29,60,51.7%,2h
42286,2,[ph0t0n]Fayeride,2005,714,29,34,63,46.0%,49m
42286,2,SaabBoy,2005,880,28,41,69,40.6%,6m
42286,3,Planur,2005,595,25,27,52,48.1%,5m
42286,3,wildershiño,2005,168,7,2,9,77.8%,2h
42286,3,edchot,2005,144,5,6,11,45.5%,29m
42286,1,theCid,2005,144,5,12,17,29.4%,28m
42286,3,KungFlu,2005,86,4,0,4,100.0%,2h
42286,1,CHERVU,2005,120,4,6,10,40.0%,2h
42286,2,Awi,2005,118,4,8,12,33.3%,36m
42286,1,Alistair,2005,94,2,2,4,50.0%,52m
42286,3,[Erik]Lanexoss,2005,58,2,7,9,22.2%,55m
42286,2,ZanyDruid,2005,84,2,7,9,22.2%,35m
42286,2,IlPablolI,2005,0,1,6,7,14.3%,42m
42286,1,ALFREDOMAC,2005,0,1,7,8,12.5%,56m
42286,3,Catman,2005,0,0,1,1,0.0%,2h
42286,2,whitegumby,2005,0,0,2,2,0.0%,33m
42286,3,SuperNova,2005,0,0,5,5,0.0%,2h
42306,1,Chillinator,2004,638,22,35,57,38.6%,18m
42306,2,EagleHeart,2004,406,14,16,30,46.7%,46m
42306,3,[DRAGA]ABELGARCIA,2004,416,13,23,36,36.1%,23m
42306,1,siresombre,2004,369,11,18,29,37.9%,2h
42306,2,bellotalco,2004,293,10,9,19,52.6%,2h
42306,2,Jamz,2004,308,10,10,20,50.0%,2h
42306,2,[ChiFan]Vivi,2004,251,8,11,19,42.1%,4m
42306,1,dapeaz,2004,205,5,1,6,83.3%,47m
42306,1,Jaeuszee,2004,96,5,8,13,38.5%,2h
42306,1,catmonkey,2004,191,5,9,14,35.7%,2h
42306,2,[534698]GENOSAUREN,2004,48,2,1,3,66.7%,6m
42306,3,Poh,2004,30,2,1,3,66.7%,2h
42306,3,Mac,2004,30,2,2,4,50.0%,2h
42306,2,Kasstghost,2004,44,2,7,9,22.2%,2h
42306,2,[RSHB]JenkinsIPM,2004,30,1,7,8,12.5%,2h
42306,2,[j0B5t0]MadHatter,2004,30,1,8,9,11.1%,2h
42306,3,kanbara,2004,0,0,5,5,0.0%,2h
42323,2,frame,2003,672,40,30,70,57.1%,2h
42323,2,[SCRlM]Bonzalez,2003,877,38,44,82,46.3%,22m
42323,1,CombatJester,2003,518,19,26,45,42.2%,10m
42323,2,KingCharles,2003,327,16,17,33,48.5%,2h
42323,2,Hibuddy,2003,162,7,6,13,53.8%,47m
42323,3,DOZAL,2003,183,7,12,19,36.8%,2h
42323,2,Dalelicious,2003,177,5,4,9,55.6%,44m
42323,3,Cooper,2003,58,3,0,3,100.0%,23m
42323,2,Anaya,2003,0,3,3,6,50.0%,55m
42323,1,[DeadNA]DeadmanEM,2003,0,3,4,7,42.9%,9m
42323,1,Hsamp,2003,0,1,1,2,50.0%,2h
42323,2,vlast,2003,0,1,1,2,50.0%,2h
42323,3,[AbcCo]Zgiro,2003,95,1,2,3,33.3%,2h
42323,2,jahl,2003,0,1,6,7,14.3%,36m
42323,1,SkJester,2003,0,1,8,9,11.1%,2h
42323,1,Entrimo,2003,0,0,1,1,0.0%,2h
42323,2,Anju,2003,0,0,2,2,0.0%,2h
42323,2,[KhanTv]False,2003,0,0,2,2,0.0%,2h
42323,2,susyatsy,2003,0,0,6,6,0.0%,2h
42323,2,Drexelfiend,2003,0,0,6,6,0.0%,2h
42343,2,Phulu,2002,891,69,70,139,49.6%,9m
42343,1,RonBurgundy,2002,995,55,55,110,50.0%,2h
42343,1,jase,2002,544,37,45,82,45.1%,48m
42343,2,JBart,2002,397,13,19,32,40.6%,2h
42343,2,[AIURxT]Luisekas,2002,210,7,11,18,38.9%,42m
42343,2,Maurice,2002,126,4,10,14,28.6%,25m
42343,3,[BrVoS]GuZzOd,2002,58,3,1,4,75.0%,2h
42343,2,NaClGlaive,2002,0,3,4,7,42.9%,3h
42343,1,Welp,2002,94,3,11,14,21.4%,2h
42343,3,[xDYEx]Steve,2002,0,1,0,1,100.0%,38m
42353,3,Pufly,2001,615,43,42,85,50.6%,36m
42353,2,biscochito,2001,534,26,32,58,44.8%,51m
42353,2,Hapaboy,2001,594,20,25,45,44.4%,42m
42353,2,Andrei,2001,472,16,25,41,39.0%,46m
42353,2,McCucky,2001,294,13,10,23,56.5%,2h
42353,3,RKPalmerJr,2001,287,9,13,22,40.9%,2h
42353,2,Raedennis,2001,118,4,11,15,26.7%,47m
42353,2,Holystar,2001,30,1,5,6,16.7%,2h
42353,2,agentj,2001,0,1,7,8,12.5%,2h
42353,3,[AiMY0N]JoSeonHurJun,2001,0,0,1,1,0.0%,42m
42353,2,BLINK,2001,0,0,1,1,0.0%,50m
42353,2,[Fever]gebug,2001,0,0,3,3,0.0%,2h
42353,3,colossus,2001,0,0,5,5,0.0%,2h
42353,2,Gaia,2001,0,0,5,5,0.0%,36m
42367,1,HAMMER,2000,1619,149,154,303,49.2%,43m
42367,2,Matanza,2000,1382,52,63,115,45.2%,2h
42367,2,Stars,2000,1338,50,65,115,43.5%,2h
42367,1,benben,2000,962,35,49,84,41.7%,2h
42367,3,MobMeister,2000,410,19,10,29,65.5%,2h
42367,2,Linfocito,2000,214,7,3,10,70.0%,53m
42367,3,EscobarTCD,2000,202,7,6,13,53.8%,2h
42367,1,EDmkhildegla,2000,192,7,10,17,41.2%,45m
42367,3,VivianN,2000,88,7,10,17,41.2%,2h
42367,3,jents,2000,86,6,6,12,50.0%,29m
42367,3,[TheRs]ArchAngelM,2000,46,6,13,19,31.6%,2h
42367,2,fish,2000,116,5,5,10,50.0%,2h
42367,1,[BR3]SgtDulsyBob,2000,163,5,11,16,31.2%,2h
42367,2,Kalevanji,2000,94,4,8,12,33.3%,2h
42367,2,Zorthox,2000,90,3,10,13,23.1%,2h
42367,3,Savvwah,2000,0,2,3,5,40.0%,39m
42367,3,joseticona,2000,89,2,7,9,22.2%,1h
42367,1,Rfeather,2000,48,2,9,11,18.2%,2h
42367,2,Rogarces,2000,154,2,11,13,15.4%,2h
42367,3,Luleouch,2000,97,1,2,3,33.3%,2h
42367,3,[Curry]DFCooks,2000,0,0,2,2,0.0%,2h
42367,2,[ALTF04]BrendaJ,2000,0,0,3,3,0.0%,42m
42367,1,[877142]Freefrag,2000,0,0,4,4,0.0%,2h
42367,2,SPARKIIE,2000,0,0,6,6,0.0%,2h
42391,2,SpongyFishin,1999,1306,48,65,113,42.5%,2h
42391,2,MAD,1999,1149,43,49,92,46.7%,48m
42391,3,Sergio,1999,1051,42,37,79,53.2%,38m
42391,2,Monch,1999,832,33,36,69,47.8%,2h
42391,2,Haz,1999,731,28,39,67,41.8%,2h
42391,3,Jeremy,1999,88,4,1,5,80.0%,36m
42391,2,PENTAGRAMA,1999,166,4,7,11,36.4%,2h
42391,1,[F0Xx]Elrobas,1999,142,4,13,17,23.5%,12m
42391,2,Cummi,1999,104,3,11,14,21.4%,2h
42391,1,ObaPrime,1999,140,2,2,4,50.0%,11m
42391,2,RsiKshatriya,1999,30,1,7,8,12.5%,2h
42391,3,GoUtesTommie,1999,0,0,1,1,0.0%,2h
42391,1,[L0L1]Lolisalpoder,1999,0,0,1,1,0.0%,2h
42391,3,corral,1999,0,0,5,5,0.0%,2h
42405,2,king,1998,1554,180,203,383,47.0%,14m
42405,1,Devenwalsh,1998,647,93,100,193,48.2%,12m
42405,2,IronClaw,1998,1613,71,80,151,47.0%,6m
42405,1,DrHemlock,1998,1085,70,84,154,45.5%,47m
42405,2,Hobbes,1998,840,34,34,68,50.0%,2h
42405,2,beanpole,1998,586,24,26,50,48.0%,2h
42405,1,Gisastoj,1998,201,21,35,56,37.5%,22m
42405,2,rams,1998,500,19,20,39,48.7%,42m
42405,2,PowrslavE,1998,408,15,18,33,45.5%,2h
42405,2,BIGDIESEL,1998,178,6,5,11,54.5%,2h
42405,2,[ZTemps]Dominator,1998,170,5,4,9,55.6%,55m
42405,2,cesteves,1998,157,5,6,11,45.5%,33m
42405,3,Obito,1998,0,3,2,5,60.0%,2h
42405,2,ImmaFlexHo,1998,78,3,8,11,27.3%,3m
42405,1,TheA,1998,48,2,10,12,16.7%,2h
42405,3,StoneyScien,1998,0,0,1,1,0.0%,2h
42405,2,Mrdope,1998,0,0,6,6,0.0%,42m
42405,2,Strike,1998,0,0,7,7,0.0%,2h
42423,2,ZeCarrot,1997,1000,58,77,135,43.0%,2h
42423,2,depredador,1997,1225,51,56,107,47.7%,2h
42423,2,PEREJIL,1997,1156,46,43,89,51.7%,2h
42423,2,Nebulus,1997,355,17,23,40,42.5%,37m
42423,3,[MXICAN]Everardo,1997,309,10,17,27,37.0%,36m
42423,1,[N3GL]TheKrisp,1997,222,9,15,24,37.5%,2h
42423,3,[TonyLz]AsapTriggaLz,1997,194,7,5,12,58.3%,2h
42423,1,awvvv,1997,251,7,14,21,33.3%,18m
42423,2,FRANCOCALA,1997,248,6,13,19,31.6%,40m
42423,3,zartanis,1997,114,4,5,9,44.4%,42m
42423,3,Xivi,1997,88,3,4,7,42.9%,8m
42423,2,legross,1997,108,3,7,10,30.0%,2h
42423,3,rasdel,1997,30,2,1,3,66.7%,2h
42423,3,Slickhick,1997,30,2,1,3,66.7%,2h
42423,3,Exostryker,1997,97,2,2,4,50.0%,2h
42423,3,lightorais,1997,0,1,0,1,100.0%,23m
42423,3,[USA100]NinjaMaster,1997,0,0,1,1,0.0%,2h
42423,2,THEDARKKING,1997,0,0,2,2,0.0%,44m
42423,2,thorek,1997,0,0,3,3,0.0%,2h
42442,2,Misoramen,1996,646,93,104,197,47.2%,2h
42442,2,lualcaro,1996,1363,84,96,180,46.7%,6m
42442,2,Roland,1996,1479,57,61,118,48.3%,2h
42442,3,wifeofgob,1996,1142,41,45,86,47.7%,26m
42442,2,dreamdybala,1996,653,27,28,55,49.1%,2h
42442,2,logaming,1996,635,21,29,50,42.0%,50m
42442,2,marquis,1996,524,20,21,41,48.8%,28m
42442,1,JPCAPO,1996,129,4,7,11,36.4%,42m
42442,3,Shadrach,1996,58,2,2,4,50.0%,44m
42442,3,Agustin,1996,0,1,1,2,50.0%,12m
42442,2,Cerberus,1996,30,1,9,10,10.0%,2h
42442,2,Tevans,1996,48,1,9,10,10.0%,2h
42442,3,tlays,1996,0,0,1,1,0.0%,2h
42442,3,Battleooze,1996,0,0,1,1,0.0%,2h
42442,2,aLazyPenguin,1996,0,0,2,2,0.0%,32m
42442,2,Pharmacyst,1996,0,0,3,3,0.0%,2h
42458,2,SamuraiJack,1995,1568,244,252,496,49.2%,2h
42458,2,OhadiNacnud,1995,1592,156,190,346,45.1%,15m
42458,1,[DOSC2]BrownRecluse,1995,1187,57,73,130,43.8%,2h
42458,1,dDd,1995,911,31,39,70,44.3%,20m
42458,2,Terrorblade,1995,756,26,34,60,43.3%,32m
42458,2,BooM,1995,612,25,22,47,53.2%,2h
42458,2,[NUTZZZ]Boilermaker,1995,452,21,26,47,44.7%,33m
42458,3,MediaBuyer,1995,528,18,25,43,41.9%,2h
42458,2,GBX,1995,308,12,13,25,48.0%,2h
42458,2,meko,1995,286,9,11,20,45.0%,2h
42458,1,zeroninja,1995,341,9,19,28,32.1%,3h
42458,2,FasS,1995,131,8,4,12,66.7%,2h
42458,2,marshalwaar,1995,196,6,13,19,31.6%,25m
42458,3,Glitersverse,1995,86,4,4,8,50.0%,38m
42458,1,Awper,1995,46,2,4,6,33.3%,2h
42458,3,Ivan,1995,36,2,5,7,28.6%,41m
42458,2,SpaceKowboy,1995,0,1,3,4,25.0%,40m
42458,2,[ScSwrm]Prxmetheus,1995,30,1,9,10,10.0%,2h
42458,3,Andy,1995,0,0,5,5,0.0%,56m
42477,2,tobz,1994,516,21,18,39,53.8%,2h
42477,3,Icebergg,1994,552,19,22,41,46.3%,2h
42477,3,loker,1994,298,10,16,26,38.5%,2h
42477,3,[TxC1]Daren,1994,170,7,16,23,30.4%,40m
42477,1,[4fun4]Venemouse,1994,142,5,9,14,35.7%,6m
42477,3,kailo,1994,30,2,1,3,66.7%,2h
42477,2,Carlotti,1994,85,2,2,4,50.0%,2h
42477,1,ScareKrow,1994,48,2,2,4,50.0%,2h
42477,2,Atty,1994,30,2,2,4,50.0%,22m
42477,3,daddytrackp,1994,66,2,4,6,33.3%,2h
42477,3,Coose,1994,0,1,0,1,100.0%,56m
42477,1,SHAZAM,1994,0,1,1,2,50.0%,2h
42477,2,[JAHB]weedtimes,1994,0,1,1,2,50.0%,2h
42477,1,charlywar,1994,0,1,7,8,12.5%,2h
42477,3,[TCOIH]ShadowCaster,1994,0,0,1,1,0.0%,2h
42477,2,DREEP,1994,0,0,1,1,0.0%,2h
42493,3,Brentus,1993,1175,93,125,218,42.7%,2h
42493,2,[bsDg]MadDawg,1993,1150,47,54,101,46.5%,40m
42493,2,ThunderWolf,1993,243,11,19,30,36.7%,2h
42493,2,SOUPHERBAE,1993,245,8,14,22,36.4%,28m
42493,2,LunarEclipse,1993,184,6,5,11,54.5%,2h
42493,3,RYYAN,1993,195,5,5,10,50.0%,2h
42493,3,ROBERT,1993,58,3,0,3,100.0%,56m
42493,2,SHD,1993,86,3,5,8,37.5%,2h
42493,3,[WWP2]Superte,1993,0,2,8,10,20.0%,2h
42493,1,Jota,1993,0,1,0,1,100.0%,2h
42493,3,athena,1993,0,1,2,3,33.3%,36m
42493,1,MrDaisy,1993,0,1,5,6,16.7%,41m
42493,2,MADAFAKER,1993,30,1,7,8,12.5%,2h
42493,3,PermaNoob,1993,0,0,1,1,0.0%,2h
42493,2,Avenger,1993,0,0,1,1,0.0%,2h
42493,2,ELDY,1993,0,0,2,2,0.0%,51m
42493,2,wyldechild,1993,0,0,6,6,0.0%,6m
42493,2,Starkiller,1993,0,0,7,7,0.0%,2h
42511,2,ProtoLicity,1992,1599,416,463,879,47.3%,2h
42511,1,rddeathlord,1992,1635,222,236,458,48.5%,29m
42511,3,Maximillian,1992,1593,99,116,215,46.0%,45m
42511,1,Wohooo,1992,280,33,49,82,40.2%,2h
42511,2,RichardGasqu,1992,628,24,25,49,49.0%,2h
42511,2,[425]DrX,1992,531,22,17,39,56.4%,2h
42511,2,couchman,1992,548,19,23,42,45.2%,2h
42511,2,Ladybud,1992,514,18,23,41,43.9%,2h
42511,2,Lulibin,1992,308,16,16,32,50.0%,38m
42511,3,abandonhope,1992,198,6,12,18,33.3%,42m
42511,2,WALLYGATOR,1992,75,5,7,12,41.7%,2h
42511,1,BadaBadaBoom,1992,162,5,9,14,35.7%,18m
42511,3,Kenneth,1992,88,4,5,9,44.4%,2h
42511,2,Killer,1992,62,2,5,7,28.6%,2h
42511,3,HuMaNiTy,1992,56,2,12,14,14.3%,2h
42511,3,[SC2DG]YouTubeEyes,1992,0,1,0,1,100.0%,2h
42511,2,lucidnugget,1992,30,1,4,5,20.0%,2h
42511,2,Red,1992,46,1,8,9,11.1%,2h
42511,3,DonMafa,1992,0,0,1,1,0.0%,2h
42511,3,Krysner,1992,0,0,1,1,0.0%,2h
42511,3,goofy,1992,0,0,1,1,0.0%,1h
42532,2,[DMONlC]jhjhggj,1991,1281,297,376,673,44.1%,49m
42532,2,UPDRIFT,1991,1205,107,105,212,50.5%,48m
42532,3,icygameova,1991,704,58,56,114,50.9%,2h
42532,2,McChronalds,1991,371,53,63,116,45.7%,37m
42532,2,Karuel,1991,1008,34,55,89,38.2%,2h
42532,3,Vitamin,1991,658,31,28,59,52.5%,2h
42532,2,daemonium,1991,654,24,27,51,47.1%,2h
42532,3,RazerCyclon,1991,432,14,19,33,42.4%,2h
42532,2,Mars,1991,401,13,23,36,36.1%,22m
42532,2,WIWI,1991,305,10,17,27,37.0%,2h
42532,2,Corum,1991,220,8,9,17,47.1%,2h
42532,3,Zethar,1991,86,4,1,5,80.0%,2h
42532,3,Alloy,1991,90,4,3,7,57.1%,2h
42532,2,Exorro,1991,44,1,1,2,50.0%,2h
42532,3,Reedinator,1991,95,1,3,4,25.0%,2h
42532,3,AGORILA,1991,0,0,1,1,0.0%,32m
42548,2,[gayRus]Smoothie,1990,804,186,205,391,47.6%,2h
42548,1,kfurmkos,1990,1450,80,90,170,47.1%,2h
42548,3,[IIDX]Sargentlewis,1990,471,17,19,36,47.2%,2h
42548,2,Pull,1990,250,10,12,22,45.5%,2h
42548,2,EvilKenshin,1990,240,7,9,16,43.8%,2h
42548,1,DreamState,1990,90,4,11,15,26.7%,30m
42548,2,kevbot,1990,107,4,11,15,26.7%,2h
42548,3,LruleroL,1990,46,3,3,6,50.0%,2h
42548,2,Tsula,1990,97,3,12,15,20.0%,2h
42548,2,[KnKHxx]Haust,1990,32,1,4,5,20.0%,2h
42548,3,PlayerNine,1990,0,1,4,5,20.0%,42m
42548,1,GoingPRObe,1990,0,0,5,5,0.0%,11m
42548,2,Conordon,1990,0,0,5,5,0.0%,2h
42561,2,MrVesuvious,1989,980,35,39,74,47.3%,39m
42561,3,[ConFed]ManSin,1989,726,34,32,66,51.5%,2h
42561,3,Krosvaldo,1989,384,13,23,36,36.1%,2h
42561,2,Yuriz,1989,105,9,8,17,52.9%,2h
42561,1,LeftArrow,1989,276,9,17,26,34.6%,2h
42561,3,[FNES1]OHWTV,1989,190,8,5,13,61.5%,2h
42561,2,Slayergabo,1989,30,1,4,5,20.0%,21m
42561,1,TenInchMitch,1989,48,1,5,6,16.7%,2h
42561,1,Briser,1989,0,1,9,10,10.0%,43m
42561,3,paradox,1989,0,0,1,1,0.0%,2h
42561,3,Maker,1989,0,0,2,2,0.0%,2h
42561,2,Braulini,1989,0,0,2,2,0.0%,2h
42573,2,Nehtur,1988,1577,138,138,276,50.0%,2h
42573,2,[BWgx]hogg,1988,1124,56,58,114,49.1%,2h
42573,2,Frannnn,1988,274,11,14,25,44.0%,2h
42573,3,III,1988,318,10,14,24,41.7%,2h
42573,2,LUKECRAFT,1988,278,9,11,20,45.0%,22m
42573,3,Dragon,1988,176,7,4,11,63.6%,29m
42573,3,Fermion,1988,58,4,9,13,30.8%,2h
42573,3,DarkDEX,1988,72,3,2,5,60.0%,2h
42573,3,nemesisberry,1988,0,3,3,6,50.0%,43m
42573,2,dcmallo,1988,58,2,4,6,33.3%,47m
42573,1,KodokunaUwU,1988,97,2,8,10,20.0%,2h
42573,3,ROY,1988,0,1,1,2,50.0%,31m
42573,3,HunabKuZamna,1988,0,1,1,2,50.0%,31m
42573,3,Duran,1988,0,0,2,2,0.0%,2h
42573,2,[TUSS]RacerC,1988,0,0,3,3,0.0%,2h
42573,2,dilicate,1988,0,0,3,3,0.0%,2h
42573,2,[Asnd]ChrisBVH,1988,0,0,5,5,0.0%,2h
42573,3,Philip,1988,0,0,5,5,0.0%,2h
42573,2,Ejecutor,1988,0,0,7,7,0.0%,52m
42592,2,[QUEENz]LanceSkyBud,1987,1583,359,382,741,48.4%,49m
42592,1,LdiabloMgMan,1987,873,101,96,197,51.3%,2h
42592,3,TRESDETRES,1987,502,90,98,188,47.9%,2h
42592,3,stoggs,1987,1307,55,58,113,48.7%,36m
42592,2,[nwBEAR]DARTHbane,1987,630,21,32,53,39.6%,2h
42592,3,spaltan,1987,196,7,7,14,50.0%,2h
42592,2,Jeffreysz,1987,186,6,13,19,31.6%,15m
42592,1,[CHAKA]jamboy,1987,203,6,13,19,31.6%,5m
42592,1,ROSHAK,1987,192,5,12,17,29.4%,2h
42592,2,DasCookies,1987,0,3,3,6,50.0%,2h
42592,3,sudoer,1987,92,3,4,7,42.9%,2h
42592,2,VosiBop,1987,62,3,8,11,27.3%,2h
42592,3,HCTRESMSCSAH,1987,0,2,10,12,16.7%,16m
42592,2,CiieJiie,1987,88,1,3,4,25.0%,2h
42592,2,Greengato,1987,0,0,2,2,0.0%,15m
42607,1,BooKNor,1986,1462,190,230,420,45.2%,47m
42607,1,frankieswing,1986,1531,79,102,181,43.6%,2h
42607,3,Blackvenom,1986,723,28,27,55,50.9%,45m
42607,2,Grayon,1986,353,13,13,26,50.0%,37m
42607,2,jmichel,1986,382,12,22,34,35.3%,2h
42607,1,SLATI,1986,304,10,9,19,52.6%,2h
42607,2,Adingdow,1986,227,7,7,14,50.0%,2h
42607,2,JorgeSV,1986,158,6,13,19,31.6%,2h
42607,2,Ainz,1986,154,5,14,19,26.3%,2h
42607,2,themongo,1986,194,5,14,19,26.3%,2h
42607,3,ELSHADAI,1986,86,4,2,6,66.7%,41m
42607,2,Crow,1986,168,3,6,9,33.3%,44m
42607,2,[BMash]DirtyClaw,1986,46,2,7,9,22.2%,32m
42607,2,CptKills,1986,0,0,2,2,0.0%,2h
42621,2,James,1985,1023,65,76,141,46.1%,22m
42621,2,Diego,1985,1006,52,53,105,49.5%,15m
42621,2,alexxxxxx,1985,1159,49,54,103,47.6%,2h
42621,3,Samujo,1985,594,42,43,85,49.4%,5m
42621,2,[DDPPSS]Eduardo,1985,618,24,31,55,43.6%,22m
42621,1,Burty,1985,574,18,34,52,34.6%,3h
42621,2,CorruptUSGOV,1985,350,13,23,36,36.1%,6m
42621,2,KIsixPSP,1985,335,12,12,24,50.0%,2h
42621,2,tomasheimer,1985,252,12,12,24,50.0%,2h
42621,2,deathstalker,1985,217,5,3,8,62.5%,35m
42621,2,[LCE]SantiKiller,1985,175,4,5,9,44.4%,2h
42621,3,CrAzYwAsP,1985,144,4,6,10,40.0%,2h
42621,3,llIIIIllllI,1985,0,1,4,5,20.0%,2h
42621,2,CHEMO,1985,0,1,6,7,14.3%,6m
42621,3,Destroyer,1985,0,0,1,1,0.0%,29m
42621,1,CrankyPants,1985,0,0,1,1,0.0%,2h
42621,2,NateDaNub,1985,0,0,1,1,0.0%,36m
42621,3,CEREBRUM,1985,0,0,1,1,0.0%,36m
42621,3,MpBurn,1985,0,0,1,1,0.0%,2h
42621,2,[JUGOS]alexis,1985,0,0,2,2,0.0%,2h
42621,2,akutsuki,1985,0,0,2,2,0.0%,3h
42621,3,Aster,1985,0,0,5,5,0.0%,2h
42643,1,Suito,1984,1620,68,80,148,45.9%,46m
42643,2,SilverLines,1984,888,36,39,75,48.0%,53m
42643,1,gator,1984,740,28,33,61,45.9%,2h
42643,3,[ZRN]KungFuUnicrn,1984,546,21,17,38,55.3%,41m
42643,3,Emialis,1984,458,16,11,27,59.3%,2h
42643,2,Fog,1984,404,14,22,36,38.9%,2h
42643,2,donerman,1984,229,7,8,15,46.7%,2h
42643,3,AsuraRage,1984,88,5,13,18,27.8%,2h
42643,2,Rypc,1984,86,4,9,13,30.8%,2h
42643,2,[HRDep]giantbighuge,1984,88,2,1,3,66.7%,33m
42643,3,Jaco,1984,60,2,3,5,40.0%,2h
42643,2,Lova,1984,44,1,8,9,11.1%,23m
42643,3,OrganDonor,1984,0,0,3,3,0.0%,2h
42643,1,Fefulito,1984,0,0,3,3,0.0%,2h
42643,2,zkht,1984,0,0,6,6,0.0%,2h
42643,2,bardem,1984,0,0,6,6,0.0%,51m
42643,2,Anton,1984,0,0,6,6,0.0%,6m
42660,2,Edgar,1983,1580,223,243,466,47.9%,50m
42660,1,Raynor,1983,1463,140,139,279,50.2%,10m
42660,2,David,1983,1577,68,66,134,50.7%,2h
42660,2,Daven,1983,1317,51,66,117,43.6%,4m
42660,2,Embolizer,1983,932,37,40,77,48.1%,2h
42660,3,bazooka,1983,750,27,26,53,50.9%,40m
42660,3,EqusVoidRici,1983,576,25,8,33,75.8%,2h
42660,2,Tiny,1983,158,17,7,24,70.8%,2h
42660,2,Santapaws,1983,290,13,19,32,40.6%,2h
42660,3,[mterds]TheFlush,1983,318,12,9,21,57.1%,2h
42660,3,XXSAMYHRXX,1983,320,11,15,26,42.3%,2h
42660,3,Petamai,1983,274,10,8,18,55.6%,2h
42660,1,cheeto,1983,176,8,12,20,40.0%,48m
42660,2,JiPabloskyNa,1983,276,7,14,21,33.3%,2h
42660,1,SLIETSWORD,1983,168,6,13,19,31.6%,2h
42660,2,[Pibo3]SwarmINC,1983,130,4,5,9,44.4%,3h
42660,1,DontCheeseMe,1983,213,4,11,15,26.7%,47m
42660,2,[TB0C]Rufio,1983,60,3,5,8,37.5%,38m
42660,1,Jean,1983,48,2,11,13,15.4%,53m
42679,2,HolyKnight,1982,990,41,48,89,46.1%,2h
42679,3,Lizzard,1982,369,12,9,21,57.1%,2h
42679,3,ELWAYDI,1982,0,2,2,4,50.0%,10m
42679,1,Babbus,1982,48,2,2,4,50.0%,56m
42679,2,scarecrowuzi,1982,88,2,3,5,40.0%,2h
42679,3,ReB,1982,0,1,0,1,100.0%,2h
42679,2,Tagar,1982,0,1,0,1,100.0%,27m
42679,3,curita,1982,0,1,0,1,100.0%,36m
42679,2,SCARFACE,1982,0,1,2,3,33.3%,50m
42679,3,MORENAZO,1982,30,1,4,5,20.0%,2h
42679,1,BigDaddy,1982,0,1,8,9,11.1%,2h
42690,2,Protoss,1981,1550,283,333,616,45.9%,2h
42690,2,joelricardo,1981,1551,127,146,273,46.5%,2h
42690,1,MESSALA,1981,1596,120,131,251,47.8%,3h
42690,1,GRCHOMARX,1981,1538,85,96,181,47.0%,18m
42690,2,Iceman,1981,799,84,77,161,52.2%,32m
42690,2,Macdaddy,1981,688,33,40,73,45.2%,2h
42690,3,ZERD,1981,666,30,17,47,63.8%,10m
42690,3,ZEnglishOwO,1981,683,30,19,49,61.2%,2h
42690,2,DeRamz,1981,370,12,17,29,41.4%,37m
42690,3,MurKy,1981,273,10,0,10,100.0%,5m
42690,3,LeGovernor,1981,62,3,3,6,50.0%,2h
42690,3,AlfonsoV,1981,60,2,3,5,40.0%,2h
42690,1,Dartagnan,1981,0,1,7,8,12.5%,2h
42690,2,[Sn0w]Munktor,1981,96,1,8,9,11.1%,51m
42690,3,Bigbirdalex,1981,0,0,1,1,0.0%,2h
42690,3,[nieBla]JManuelG,1981,0,0,5,5,0.0%,2h
42706,2,EvaUnit,1980,1476,88,92,180,48.9%,2h
42706,2,Fanstasma,1980,858,35,35,70,50.0%,2h
42706,2,[jPmC]JPSoCal,1980,597,23,35,58,39.7%,2h
42706,2,tunasandwich,1980,448,16,19,35,45.7%,49m
42706,2,Macrolooney,1980,278,9,15,24,37.5%,2h
42706,2,DominusRex,1980,196,5,9,14,35.7%,2h
42706,1,red,1980,143,2,3,5,40.0%,2h
42706,2,Rem,1980,131,2,8,10,20.0%,2h
42706,2,[AbcCo]kloctk,1980,0,1,2,3,33.3%,51m
42706,1,[chair]Bowl,1980,0,0,1,1,0.0%,2h
42706,3,josuh,1980,0,0,1,1,0.0%,2h
42706,2,Noragami,1980,0,0,3,3,0.0%,2h
42718,2,mamado,1979,622,23,30,53,43.4%,2h
42718,2,ElodinArlide,1979,414,17,14,31,54.8%,55m
42718,2,Gaskike,1979,492,17,27,44,38.6%,2h
42718,3,limberg,1979,364,11,9,20,55.0%,2h
42718,2,Shovon,1979,202,6,8,14,42.9%,40m
42718,3,ApexPredator,1979,88,3,4,7,42.9%,2h
42718,3,IROD,1979,30,2,1,3,66.7%,45m
42718,3,[ZTempz]NeoPeterPan,1979,30,2,1,3,66.7%,39m
42718,2,BeachGoth,1979,86,2,9,11,18.2%,32m
42718,3,Nether,1979,0,1,0,1,100.0%,2h
42718,2,SmokeyDaBehr,1979,0,1,1,2,50.0%,2h
42718,3,dizzy,1979,0,1,1,2,50.0%,2h
42718,2,[TEMK]Astaroth,1979,0,1,4,5,20.0%,2h
42718,3,subaru,1979,0,0,2,2,0.0%,5m
42718,2,pilotcrow,1979,0,0,6,6,0.0%,2h
42733,2,Yankaro,1978,1363,73,77,150,48.7%,24m
42733,2,Skeeta,1978,358,13,13,26,50.0%,2h
42733,2,JoãoMatador,1978,274,10,9,19,52.6%,47m
42733,2,Izer,1978,248,9,15,24,37.5%,50m
42733,2,ZKillaT,1978,244,8,9,17,47.1%,6m
42733,3,Charybdis,1978,163,4,10,14,28.6%,2h
42733,1,tadeogamer,1978,145,3,1,4,75.0%,3h
42733,2,[Tsurai]AraiTakahiro,1978,36,3,5,8,37.5%,2h
42733,1,xcalibur,1978,92,3,11,14,21.4%,50m
42733,3,sebastianP,1978,30,2,0,2,100.0%,48m
42733,2,[CCoWW]Willindorn,1978,95,2,5,7,28.6%,51m
42733,2,Eduardsaga,1978,76,2,8,10,20.0%,31m
42733,3,Winchester,1978,0,1,4,5,20.0%,55m
42733,2,XDLORDLUFFY,1978,30,1,6,7,14.3%,2h
42733,3,corza,1978,0,0,2,2,0.0%,2h
42733,3,Zorgatron,1978,0,0,3,3,0.0%,42m
42733,1,[Lasur]Ovryk,1978,0,0,4,4,0.0%,3h
42750,2,ShockanAwe,1977,1528,139,150,289,48.1%,2h
42750,1,Asatong,1977,1635,77,97,174,44.3%,3h
42750,3,Gessa,1977,961,66,65,131,50.4%,2h
42750,2,Grapes,1977,947,33,39,72,45.8%,36m
42750,2,[STRR]javiernaxe,1977,733,24,39,63,38.1%,2h
42750,2,disregard,1977,127,14,18,32,43.8%,7m
42750,2,Geterix,1977,402,13,23,36,36.1%,56m
42750,2,BoeJangles,1977,316,12,16,28,42.9%,2h
42750,2,[LPG2]santiago,1977,266,10,13,23,43.5%,2h
42750,3,[F4MILY]cesar,1977,120,5,15,20,25.0%,2h
42750,3,TheFck,1977,154,4,4,8,50.0%,2h
42750,3,Krillixa,1977,60,3,2,5,60.0%,45m
42750,2,Cloud,1977,46,3,6,9,33.3%,2h
42750,3,[LMI42]huenex,1977,58,2,5,7,28.6%,16m
42750,2,TRIPPYDUCE,1977,58,2,6,8,25.0%,49m
42750,2,Robo,1977,91,2,9,11,18.2%,2h
42750,3,slaughterer,1977,0,1,0,1,100.0%,2h
42750,2,Yone,1977,0,1,0,1,100.0%,34m
42750,3,[ASPIE]BananaKing,1977,30,1,1,2,50.0%,29m
42750,3,[110213]Corvin,1977,0,0,1,1,0.0%,41m
42750,2,[Bullys]Laffnman,1977,0,0,1,1,0.0%,27m
42750,3,[QOSQO]DIEWARTURO,1977,0,0,2,2,0.0%,31m
42750,2,HAtlanticor,1977,0,0,2,2,0.0%,2h
42750,3,Killermanic,1977,0,0,3,3,0.0%,2h
42774,2,Asterix,1976,778,142,175,317,44.8%,21m
42774,1,Demo,1976,1089,65,73,138,47.1%,15m
42774,2,Freeshotz,1976,516,49,49,98,50.0%,2h
42774,1,raudelio,1976,494,17,24,41,41.5%,2h
42774,3,Misc,1976,222,8,10,18,44.4%,2h
42774,2,[LTKPRS]Giertick,1976,195,5,12,17,29.4%,2h
42774,2,geerson,1976,128,4,7,11,36.4%,47m
42774,2,RACKOF,1976,167,4,12,16,25.0%,15m
42774,1,Javert,1976,48,3,9,12,25.0%,2h
42774,2,Canis,1976,90,3,11,14,21.4%,2h
42774,1,George,1976,0,0,1,1,0.0%,2h
42774,2,DarthRonin,1976,0,0,1,1,0.0%,2h
42774,2,Tezetos,1976,0,0,1,1,0.0%,2h
42774,3,PGLelluch,1976,0,0,2,2,0.0%,2h
42788,2,SpaceLlama,1975,1139,88,85,173,50.9%,40m
42788,2,WarLeiff,1975,1510,60,58,118,50.8%,2h
42788,2,KingJames,1975,974,38,36,74,51.4%,2h
42788,3,Andrew,1975,739,28,32,60,46.7%,2h
42788,1,MCOOL,1975,426,14,22,36,38.9%,2h
42788,2,Chance,1975,386,13,24,37,35.1%,7m
42788,3,JayParadox,1975,118,5,5,10,50.0%,38m
42788,2,Mel,1975,196,5,6,11,45.5%,2h
42788,3,ThaiNaVy,1975,94,4,2,6,66.7%,31m
42788,1,Daarin,1975,112,4,12,16,25.0%,2h
42788,3,Ramsosig,1975,58,2,2,4,50.0%,2h
42788,3,[Zyzz]Shadowphase,1975,0,2,3,5,40.0%,56m
42788,2,DennisC,1975,0,2,5,7,28.6%,2h
42788,1,Muztang,1975,0,1,0,1,100.0%,2h
42788,2,ricky,1975,0,1,6,7,14.3%,2h
42788,2,CoronaCorona,1975,0,0,2,2,0.0%,2h
42788,2,dragon,1975,0,0,6,6,0.0%,2h
42788,2,lor,1975,0,0,6,6,0.0%,2h
42788,2,[BALANG]BRzonoitildo,1975,0,0,8,8,0.0%,2h
42807,3,EberHd,1974,1329,134,150,284,47.2%,2h
42807,2,MONEYMANEx,1974,1081,46,54,100,46.0%,2h
42807,2,[LifeF]BJR,1974,616,23,27,50,46.0%,2h
42807,2,augzto,1974,294,14,15,29,48.3%,2h
42807,2,HULKASDF,1974,247,7,14,21,33.3%,2h
42807,2,Kanorbit,1974,200,6,11,17,35.3%,42m
42807,3,[LOHd]magnetron,1974,116,4,2,6,66.7%,48m
42807,1,SeventySeven,1974,193,3,11,14,21.4%,31m
42807,3,[shamas]ElJoamy,1974,60,2,6,8,25.0%,29m
42807,1,Mercenary,1974,88,1,8,9,11.1%,25m
42807,3,MrMeeseeks,1974,0,0,1,1,0.0%,2h
42807,3,Juan,1974,0,0,4,4,0.0%,2h
42807,3,brasswalker,1974,0,0,5,5,0.0%,2h
42820,2,RedStripe,1973,1549,137,148,285,48.1%,2h
42820,2,KingOT,1973,1230,108,119,227,47.6%,37m
42820,1,shaqers,1973,1102,40,50,90,44.4%,2h
42820,2,TERRACOTA,1973,293,11,14,25,44.0%,2h
42820,3,Dynamo,1973,235,8,1,9,88.9%,2h
42820,2,[RULES]Puppetmaster,1973,172,5,17,22,22.7%,2h
42820,3,purginspaget,1973,88,3,2,5,60.0%,2h
42820,3,papamessi,1973,88,3,5,8,37.5%,40m
42820,3,spiderman,1973,30,2,3,5,40.0%,48m
42820,1,[MPPA]Indcrist,1973,0,1,0,1,100.0%,2h
42820,2,[PODS]LuisSergio,1973,0,0,1,1,0.0%,6m
42820,3,Nick,1973,0,0,1,1,0.0%,44m
42820,3,Taiki,1973,0,0,1,1,0.0%,2h
42820,3,FABRICRAK,1973,0,0,5,5,0.0%,55m
42834,2,Mikoto,1972,1349,131,151,282,46.5%,2h
42834,1,Arboyo,1972,1611,84,99,183,45.9%,27m
42834,2,kastorbaires,1972,1436,82,99,181,45.3%,2h
42834,2,Sera,1972,674,25,30,55,45.5%,32m
42834,3,venomousyash,1972,360,13,16,29,44.8%,56m
42834,3,Soirez,1972,294,10,17,27,37.0%,2h
42834,1,SavageSensei,1972,372,10,23,33,30.3%,2h
42834,2,Ldbor,1972,234,9,7,16,56.2%,21m
42834,2,Chuwii,1972,160,3,9,12,25.0%,36m
42834,3,WARGODZILLA,1972,30,2,0,2,100.0%,23m
42834,3,Yabruf,1972,0,1,0,1,100.0%,2h
42845,2,BlackMagic,1971,589,26,23,49,53.1%,2h
42845,2,Chadbaby,1971,663,26,28,54,48.1%,56m
42845,2,viceps,1971,439,18,25,43,41.9%,4m
42845,3,Whasagoo,1971,394,14,13,27,51.9%,45m
42845,3,JOHNSNOWED,1971,144,6,4,10,60.0%,2h
42845,1,AbellaDanger,1971,238,5,3,8,62.5%,2h
42845,2,JRodriZ,1971,179,5,7,12,41.7%,2h
42845,3,Guppy,1971,86,3,2,5,60.0%,48m
42845,2,Qcity,1971,179,3,8,11,27.3%,2h
42845,3,Dogzen,1971,60,2,3,5,40.0%,2h
42845,3,Yoda,1971,30,1,3,4,25.0%,8m
42845,2,tett,1971,48,1,3,4,25.0%,2h
42845,2,Echo,1971,0,0,1,1,0.0%,2h
42858,2,StonedStoner,1970,1581,107,119,226,47.3%,2h
42858,2,RGKolirio,1970,662,38,41,79,48.1%,25m
42858,2,CraftzUwU,1970,701,28,28,56,50.0%,2h
42858,2,sneakyturtle,1970,343,26,39,65,40.0%,2h
42858,2,Shadowmaster,1970,603,23,27,50,46.0%,2h
42858,2,Arturus,1970,506,23,29,52,44.2%,37m
42858,2,bebruda,1970,444,15,24,39,38.5%,36m
42858,3,Shlongo,1970,330,11,15,26,42.3%,2h
42858,3,SwedishMech,1970,92,6,4,10,60.0%,2h
42858,3,Uzi,1970,172,4,7,11,36.4%,2h
42858,2,drperron,1970,172,4,10,14,28.6%,53m
42858,3,psionicninja,1970,42,2,0,2,100.0%,36m
42858,2,Constance,1970,60,2,7,9,22.2%,38m
42858,3,emurphy,1970,30,1,3,4,25.0%,2h
42858,1,ghostllama,1970,0,0,2,2,0.0%,2h
42873,2,Jon,1969,1557,101,101,202,50.0%,55m
42873,2,Jibit,1969,1413,65,68,133,48.9%,22m
42873,2,PureDragon,1969,1180,45,44,89,50.6%,2h
42873,1,Alejandro,1969,718,25,39,64,39.1%,2h
42873,1,wusspie,1969,508,17,30,47,36.2%,2h
42873,3,TheFox,1969,381,13,13,26,50.0%,2h
42873,3,Yoda,1969,343,11,8,19,57.9%,36m
42873,3,Josho,1969,114,8,2,10,80.0%,41m
42873,2,SofaKing,1969,140,4,6,10,40.0%,44m
42873,1,Skywalker,1969,152,3,5,8,37.5%,2h
42873,1,Boxiii,1969,0,1,7,8,12.5%,18m
42873,2,NakeDwarfGuy,1969,0,1,7,8,12.5%,2h
42873,3,Cazador,1969,0,0,2,2,0.0%,2h
42873,2,ToothDude,1969,0,0,6,6,0.0%,2h
42887,2,ThorHanson,1968,1241,56,61,117,47.9%,2h
42887,2,kri,1968,557,18,23,41,43.9%,48m
42887,2,beandipking,1968,364,12,18,30,40.0%,37m
42887,3,Fenix,1968,212,7,9,16,43.8%,56m
42887,3,highsaac,1968,86,4,2,6,66.7%,36m
42887,2,RATmcbilly,1968,90,4,9,13,30.8%,6m
42887,3,Nimrod,1968,64,4,16,20,20.0%,41m
42887,3,blacklacreek,1968,30,2,2,4,50.0%,2h
42887,3,Supreme,1968,0,1,0,1,100.0%,48m
42887,2,Zeth,1968,0,1,1,2,50.0%,15m
42887,3,jarg,1968,0,1,2,3,33.3%,2h
42887,3,FlameMaster,1968,30,1,3,4,25.0%,2h
42887,2,Hero,1968,42,1,5,6,16.7%,56m
42887,2,TuffCriminal,1968,42,1,7,8,12.5%,2h
42887,3,PhilsGoodMan,1968,0,0,5,5,0.0%,44m
42902,2,JOACHIMMURAT,1967,1372,86,105,191,45.0%,2h
42902,3,SPARTA,1967,957,41,47,88,46.6%,29m
42902,3,[AbcCo]lee,1967,357,13,19,32,40.6%,32m
42902,3,Catalou,1967,226,9,7,16,56.2%,2h
42902,1,Lamp,1967,148,6,12,18,33.3%,56m
42902,1,Entheogen,1967,108,4,11,15,26.7%,2h
42902,2,[GELIUM]fenix,1967,30,4,15,19,21.1%,2h
42902,2,Toyota,1967,44,2,7,9,22.2%,36m
42902,3,Chutzpan,1967,0,1,0,1,100.0%,2h
42902,3,Alienator,1967,0,0,1,1,0.0%,2h
42902,3,lexost,1967,0,0,1,1,0.0%,12m
42902,1,TiênÔng,1967,0,0,1,1,0.0%,2h
42902,3,KiritoKun,1967,0,0,2,2,0.0%,44m
42902,3,[CHZWIZ]RicketyDoor,1967,0,0,3,3,0.0%,2h
42902,3,Valius,1967,0,0,4,4,0.0%,41m
42917,2,theEddy,1966,1543,83,84,167,49.7%,2h
42917,3,Waly,1966,1270,46,49,95,48.4%,31m
42917,2,[Chubak]Zorro,1966,1049,41,35,76,53.9%,25m
42917,3,[PUNDR]BetoWolf,1966,204,8,5,13,61.5%,48m
42917,1,Benificent,1966,30,4,6,10,40.0%,25m
42917,1,Vitriol,1966,0,3,4,7,42.9%,2h
42917,3,Skato,1966,120,3,11,14,21.4%,40m
42917,3,NuttyNuts,1966,0,1,1,2,50.0%,10m
42917,3,martineltin,1966,0,0,1,1,0.0%,55m
42917,3,Ciciri,1966,0,0,1,1,0.0%,2h
42917,3,kevin,1966,0,0,5,5,0.0%,2h
42928,3,kenshin,1965,724,99,109,208,47.6%,40m
42928,1,SiMeoN,1965,1388,57,78,135,42.2%,2h
42928,3,THEPRO,1965,603,23,24,47,48.9%,42m
42928,3,Stromboli,1965,400,15,13,28,53.6%,31m
42928,2,Cyondor,1965,301,12,22,34,35.3%,49m
42928,2,Cobalt,1965,279,10,13,23,43.5%,36m
42928,3,WingWing,1965,148,7,16,23,30.4%,32m
42928,3,KAKITAS,1965,86,4,3,7,57.1%,29m
42928,3,[Trlp0d]Evindris,1965,114,4,12,16,25.0%,2h
42928,3,ASOC,1965,86,3,4,7,42.9%,2h
42928,3,[RckPpr]Scissors,1965,90,3,8,11,27.3%,2h
42928,3,[XpKAc]Acelereitor,1965,66,2,2,4,50.0%,2h
42928,2,JuanLo,1965,59,2,4,6,33.3%,2h
42928,2,Given,1965,97,2,7,9,22.2%,2h
42928,3,[USplan]DragonDTew,1965,30,1,2,3,33.3%,2h
42928,2,Davo,1965,46,1,4,5,20.0%,23m
42928,2,Brandmuffin,1965,4,1,4,5,20.0%,47m
42928,3,Adam,1965,0,0,1,1,0.0%,48m
42928,3,Teddy,1965,0,0,1,1,0.0%,34m
42928,2,celet,1965,0,0,6,6,0.0%,31m
42948,2,xaxu,1964,788,44,45,89,49.4%,7m
42948,2,RomeoKA,1964,512,27,37,64,42.2%,2h
42948,1,RequiEm,1964,143,3,10,13,23.1%,2h
42948,3,demacy,1964,0,1,1,2,50.0%,56m
42948,2,kroazn,1964,88,1,7,8,12.5%,2h
42948,2,Superman,1964,117,1,13,14,7.1%,2h
42948,2,TomG,1964,0,0,1,1,0.0%,6m
42948,3,BabyGirl,1964,0,0,2,2,0.0%,2h
42948,3,Shadez,1964,0,0,6,6,0.0%,2h
42948,2,mushroom,1964,0,0,7,7,0.0%,2h
42958,3,Loi,1963,563,20,31,51,39.2%,2h
42958,2,Zerg,1963,394,14,17,31,45.2%,2h
42958,2,SamtheBold,1963,377,10,21,31,32.3%,2h
42958,2,Grandee,1963,212,8,10,18,44.4%,2h
42958,3,[Core]Blissfulfeed,1963,120,5,5,10,50.0%,2h
42958,3,ragnarok,1963,68,3,0,3,100.0%,2h
42958,3,Leoplurodon,1963,30,2,1,3,66.7%,31m
42958,3,Shamus,1963,60,2,7,9,22.2%,2h
42958,3,[simp34]Mashall,1963,0,0,1,1,0.0%,2h
42958,3,deadlykitten,1963,0,0,1,1,0.0%,56m
42958,2,Windoori,1963,0,0,4,4,0.0%,2h
42958,3,GhettoNun,1963,0,0,6,6,0.0%,3h
42958,1,joão,1963,0,0,8,8,0.0%,2h
42971,2,[HE7I]Maverick,1962,1123,44,47,91,48.4%,2h
42971,3,Macki,1962,630,25,19,44,56.8%,12m
42971,1,chessy,1962,528,20,20,40,50.0%,3h
42971,2,LEONRAGNAR,1962,364,12,17,29,41.4%,2h
42971,3,theHatch,1962,187,7,6,13,53.8%,31m
42971,2,Gui,1962,130,7,7,14,50.0%,6m
42971,2,DarthMorice,1962,64,5,8,13,38.5%,2h
42971,2,SADUS,1962,141,4,4,8,50.0%,15m
42971,2,vIzZ,1962,140,4,7,11,36.4%,9m
42971,2,kvu,1962,125,3,4,7,42.9%,49m
42971,2,johnyack,1962,0,1,3,4,25.0%,42m
42971,2,turray,1962,0,1,3,4,25.0%,2h
42971,3,Skeight,1962,0,0,1,1,0.0%,2h
42971,3,GhostViz,1962,0,0,5,5,0.0%,42m
42971,3,Alice,1962,0,0,5,5,0.0%,2h
42986,2,DemStroyer,1961,1562,192,205,397,48.4%,51m
42986,3,Osiris,1961,853,35,30,65,53.8%,2h
42986,2,ALGRIM,1961,716,30,37,67,44.8%,22m
42986,2,andree,1961,806,27,40,67,40.3%,2h
42986,3,StealthMan,1961,351,17,9,26,65.4%,56m
42986,3,BRANDON,1961,240,10,7,17,58.8%,2h
42986,1,DoOdLoRd,1961,122,3,9,12,25.0%,2h
42986,2,[KEKKK]Inquits,1961,119,3,9,12,25.0%,38m
42986,2,pipipupu,1961,104,3,16,19,15.8%,22m
42986,3,WOOJOO,1961,0,2,1,3,66.7%,36m
42986,2,Jelise,1961,46,2,2,4,50.0%,2h
42986,2,MishiMiauu,1961,88,2,4,6,33.3%,25m
42986,2,IVANCITO,1961,60,2,8,10,20.0%,2h
42986,3,[CooL10]lemonsfly,1961,30,1,3,4,25.0%,32m
42986,2,[Colrs]TyphnFusion,1961,0,1,3,4,25.0%,34m
42986,2,[DeCan]DeRedTigeris,1961,30,1,7,8,12.5%,2h
42986,2,prosor,1961,48,1,8,9,11.1%,2h
42986,3,Nelson,1961,0,0,1,1,0.0%,2h
42986,1,TrumpYeezy,1961,0,0,1,1,0.0%,30m
42986,3,poluloqq,1961,0,0,6,6,0.0%,2h
43006,2,Phuhque,1960,888,64,66,130,49.2%,22m
43006,2,Zykrus,1960,1090,52,55,107,48.6%,49m
43006,1,kini,1960,1482,50,70,120,41.7%,44m
43006,2,skralin,1960,368,14,23,37,37.8%,3h
43006,2,nathyboy,1960,200,9,8,17,52.9%,2h
43006,3,Twolings,1960,226,7,7,14,50.0%,10m
43006,3,[uchi]RushThanos,1960,148,4,6,10,40.0%,16m
43006,3,JinX,1960,143,4,10,14,28.6%,2h
43006,3,CactusJuice,1960,86,3,2,5,60.0%,2h
43006,1,LAALAKL,1960,150,3,11,14,21.4%,4m
43006,3,eXeGeTe,1960,0,2,3,5,40.0%,2h
43006,1,Cindri,1960,48,2,9,11,18.2%,53m
43006,3,[ItsOkI]Storm,1960,0,2,11,13,15.4%,16m
43006,2,[jerga]shadown,1960,0,1,0,1,100.0%,2h
43006,3,ElMismisimo,1960,0,1,1,2,50.0%,2h
43006,3,jaloO,1960,0,0,4,4,0.0%,29m
43006,2,MSTY,1960,0,0,6,6,0.0%,36m
43006,2,GeorgeDragon,1960,0,0,6,6,0.0%,2h
43024,2,Juddthejuice,1959,1537,148,152,300,49.3%,2h
43024,1,Tbonedrum,1959,1612,121,137,258,46.9%,10m
43024,2,Foxlain,1959,1229,51,59,110,46.4%,2h
43024,2,JimBean,1959,474,40,42,82,48.8%,48m
43024,3,koomkookie,1959,267,14,9,23,60.9%,45m
43024,3,Meme,1959,407,12,23,35,34.3%,41m
43024,3,VuDu,1959,234,9,10,19,47.4%,2h
43024,2,itzbrant,1959,309,9,12,21,42.9%,4m
43024,2,ProblemChild,1959,228,7,7,14,50.0%,3h
43024,2,Destroyer,1959,182,4,5,9,44.4%,34m
43024,3,dodgingwords,1959,151,3,9,12,25.0%,2h
43024,2,diegoelcrack,1959,112,2,6,8,25.0%,2h
43024,2,StarSentinel,1959,62,2,10,12,16.7%,14m
43024,2,GVII,1959,90,1,1,2,50.0%,42m
43024,3,Jake,1959,0,0,1,1,0.0%,45m
43024,3,robomega,1959,0,0,3,3,0.0%,26m
43024,2,zorro,1959,0,0,6,6,0.0%,39m
43024,2,butterman,1959,0,0,7,7,0.0%,51m
43042,2,AshleyPaige,1958,1294,50,52,102,49.0%,2h
43042,2,Ito,1958,716,45,57,102,44.1%,2h
43042,2,Marcelo,1958,704,25,29,54,46.3%,2h
43042,3,JERMS,1958,530,21,17,38,55.3%,36m
43042,3,sander,1958,380,15,26,41,36.6%,8m
43042,3,notibob,1958,232,9,8,17,52.9%,2h
43042,2,Flik,1958,319,9,20,29,31.0%,2h
43042,1,Alchi,1958,160,5,11,16,31.2%,2h
43042,2,ROROROX,1958,88,4,11,15,26.7%,24m
43042,1,destroyzerks,1958,120,2,2,4,50.0%,2h
43042,3,Pereira,1958,0,2,3,5,40.0%,1h
43042,3,[5t0rng]HYDRO,1958,0,1,0,1,100.0%,1h
43042,1,Jennifer,1958,0,1,1,2,50.0%,2h
43042,3,[ZRGFRT]DaRogue,1958,30,1,2,3,33.3%,36m
43042,3,elmape,1958,0,1,2,3,33.3%,2h
43042,3,JoBeast,1958,30,1,2,3,33.3%,40m
43042,1,Tassadar,1958,96,1,2,3,33.3%,2h
43042,2,TukimEn,1958,0,0,1,1,0.0%,2h
43042,3,BJORN,1958,0,0,1,1,0.0%,42m
43042,2,Niquito,1958,0,0,6,6,0.0%,2h
43062,2,letsfucccccc,1957,1398,127,147,274,46.4%,2h
43062,2,ErickVR,1957,1330,84,79,163,51.5%,2h
43062,3,ELKANEL,1957,465,19,24,43,44.2%,47m
43062,2,Shmoofy,1957,384,14,22,36,38.9%,2h
43062,2,FortunerGS,1957,422,14,22,36,38.9%,7m
43062,2,victorXD,1957,182,8,13,21,38.1%,2h
43062,2,mxrtin,1957,247,7,8,15,46.7%,2h
43062,1,Vright,1957,0,3,4,7,42.9%,12m
43062,3,paulocu,1957,30,3,10,13,23.1%,2h
43062,3,[DOGT]Terranitup,1957,0,0,1,1,0.0%,2h
43062,3,Ghosts,1957,0,0,2,2,0.0%,29m
43073,2,[xDYEx]Cetme,1956,1561,72,85,157,45.9%,7m
43073,2,Tosilda,1956,1322,58,55,113,51.3%,28m
43073,1,Lol,1956,1190,41,63,104,39.4%,18m
43073,2,adam,1956,845,35,36,71,49.3%,2h
43073,2,SmokeHouse,1956,919,34,45,79,43.0%,53m
43073,1,PapaMidnight,1956,800,27,40,67,40.3%,3h
43073,2,[NIGT]Kofal,1956,309,12,21,33,36.4%,2h
43073,3,SofaKing,1956,338,11,24,35,31.4%,3h
43073,2,[dodgy]KOLOBOK,1956,131,4,9,13,30.8%,42m
43073,3,Frediel,1956,58,2,2,4,50.0%,2h
43073,2,Rina,1956,18,2,4,6,33.3%,2h
43073,3,SCROM,1956,0,1,0,1,100.0%,2h
43073,2,wwkkkççççççç,1956,48,1,4,5,20.0%,2h
43073,3,Seize,1956,0,0,2,2,0.0%,5m
43073,2,LazersToStun,1956,0,0,2,2,0.0%,27m
43073,1,KnightRider,1956,0,0,3,3,0.0%,31m
43073,3,Hitman,1956,0,0,3,3,0.0%,2h
43073,3,Paul,1956,0,0,5,5,0.0%,34m
43091,2,Trickster,1955,1534,187,215,402,46.5%,2h
43091,2,Vulture,1955,527,73,78,151,48.3%,2h
43091,2,GranAres,1955,705,25,41,66,37.9%,2h
43091,1,[iTard]OverlordSpce,1955,661,22,34,56,39.3%,2h
43091,1,YouSAYWHAT,1955,672,20,36,56,35.7%,2h
43091,3,GrandxMaster,1955,376,13,24,37,35.1%,41m
43091,3,Ebenezer,1955,305,9,7,16,56.2%,2h
43091,3,AdmNaismith,1955,0,3,2,5,60.0%,2h
43091,1,rafaMASTER,1955,48,2,3,5,40.0%,2h
43091,3,YogSothoth,1955,38,2,5,7,28.6%,2h
43091,2,YodaElToro,1955,93,2,6,8,25.0%,2h
43091,3,Asmita,1955,30,1,1,2,50.0%,2h
43091,3,Brandon,1955,0,0,1,1,0.0%,29m
43091,3,KMGaming,1955,0,0,2,2,0.0%,48m
43091,2,Lowdog,1955,0,0,7,7,0.0%,4m
43091,1,SneakyZeeky,1955,0,0,10,10,0.0%,3h
43107,2,Computer,1954,1556,202,247,449,45.0%,2h
43107,3,[CR1]IRONMONKEY,1954,538,19,17,36,52.8%,29m
43107,3,Fiki,1954,434,16,12,28,57.1%,2h
43107,2,StarMaster,1954,406,14,19,33,42.4%,2h
43107,2,Vexxtor,1954,366,13,18,31,41.9%,42m
43107,2,JahCasT,1954,280,10,18,28,35.7%,38m
43107,3,Zurikon,1954,260,8,13,21,38.1%,56m
43107,1,Trionix,1954,273,7,13,20,35.0%,2h
43107,2,BRYANT,1954,189,5,8,13,38.5%,2h
43107,3,[3jk2j3]BadGuts,1954,165,5,8,13,38.5%,47m
43107,2,swaflelord,1954,124,4,11,15,26.7%,47m
43107,1,[Grim3]DungeonTiger,1954,0,3,6,9,33.3%,2h
43107,1,Outworlder,1954,48,2,4,6,33.3%,53m
43107,1,Ulfrid,1954,44,2,9,11,18.2%,7m
43107,2,Taildragger,1954,0,1,5,6,16.7%,48m
43107,2,PancakesRock,1954,30,1,7,8,12.5%,2h
43107,3,[C2N]Zetsozen,1954,0,0,1,1,0.0%,36m
43107,3,Jon,1954,0,0,2,2,0.0%,36m
43107,3,sam,1954,0,0,2,2,0.0%,2h
43107,1,Pfcch,1954,0,0,5,5,0.0%,16m
43127,2,TrUkO,1953,1588,124,146,270,45.9%,38m
43127,2,Sulaco,1953,728,32,28,60,53.3%,2h
43127,2,Vault,1953,593,25,34,59,42.4%,51m
43127,3,Adama,1953,620,24,28,52,46.2%,2h
43127,1,cambiaformas,1953,319,13,16,29,44.8%,29m
43127,3,Giantsbro,1953,220,9,5,14,64.3%,29m
43127,3,Open,1953,277,9,20,29,31.0%,26m
43127,3,[RRude]Buttonhatch,1953,174,7,8,15,46.7%,2h
43127,2,[1for2]javixF,1953,110,7,14,21,33.3%,50m
43127,3,[SP1622]OLIVEBAY,1953,168,6,4,10,60.0%,41m
43127,2,embertap,1953,164,5,7,12,41.7%,27m
43127,3,cnavas,1953,86,4,3,7,57.1%,32m
43127,2,Billfckinmur,1953,30,3,11,14,21.4%,31m
43127,1,Angek,1953,94,3,11,14,21.4%,3h
43127,3,Javichy,1953,30,2,3,5,40.0%,2h
43127,3,[416GO]Forat,1953,117,2,9,11,18.2%,2h
43127,2,Traptech,1953,0,0,1,1,0.0%,2h
43127,3,SunzofMan,1953,0,0,3,3,0.0%,1h
43127,2,Deathgingr,1953,0,0,7,7,0.0%,2h
43146,1,Enderwigginz,1952,665,28,40,68,41.2%,2h
43146,1,JakeTaylor,1952,422,18,21,39,46.2%,2h
43146,2,Enurta,1952,418,15,16,31,48.4%,2h
43146,2,[The304]atran,1952,342,10,14,24,41.7%,2h
43146,3,Rafonius,1952,265,9,9,18,50.0%,2h
43146,3,SunTzu,1952,144,6,2,8,75.0%,2h
43146,3,miguel,1952,198,6,9,15,40.0%,1h
43146,1,OtherWay,1952,284,6,10,16,37.5%,52m
43146,3,Poodlepuff,1952,146,4,4,8,50.0%,56m
43146,3,DaSTRAYxDEGT,1952,90,3,8,11,27.3%,2h
43146,3,gadgetgaming,1952,0,1,0,1,100.0%,43m
43146,1,Zypher,1952,48,1,4,5,20.0%,2h
43146,3,ancestors,1952,0,0,6,6,0.0%,13m
43159,2,[LOSCTM]Alejo,1951,1535,115,133,248,46.4%,2h
43159,3,[UZD4S]Duke,1951,671,27,35,62,43.5%,40m
43159,3,mixterio,1951,503,24,10,34,70.6%,2h
43159,2,MRTURNUP,1951,392,13,23,36,36.1%,2h
43159,3,Just,1951,334,12,13,25,48.0%,2h
43159,2,Curtisfly,1951,212,7,11,18,38.9%,2h
43159,2,Zzang,1951,48,4,6,10,40.0%,2h
43159,3,BuhoFuerte,1951,58,3,2,5,60.0%,31m
43159,3,SAGITARIO,1951,0,3,2,5,60.0%,2h
43159,3,PepeSilvia,1951,58,3,3,6,50.0%,11m
43159,2,[4L0k0]NightCrawler,1951,92,3,10,13,23.1%,3h
43159,3,fhingin,1951,30,1,2,3,33.3%,2h
43159,3,Ecron,1951,0,0,1,1,0.0%,2h
43172,2,CanonRush,1950,339,13,33,46,28.3%,2h
43172,2,Zetiiitah,1950,262,9,15,24,37.5%,2h
43172,1,LeodA,1950,249,7,12,19,36.8%,2h
43172,3,ChacoBear,1950,0,1,0,1,100.0%,13m
43172,1,guy,1950,0,1,2,3,33.3%,2h
43172,3,SuperTroy,1950,0,0,2,2,0.0%,42m
43172,2,[TSith]Exterminador,1950,0,0,6,6,0.0%,4m
43179,1,lariats,1949,1563,125,133,258,48.4%,2h
43179,2,TheChosenOne,1949,1158,84,85,169,49.7%,46m
43179,3,PulpoCulto,1949,288,13,10,23,56.5%,2h
43179,3,DrCheeks,1949,391,13,15,28,46.4%,2h
43179,2,Lucas,1949,203,9,20,29,31.0%,2h
43179,3,Pipe,1949,218,8,7,15,53.3%,43m
43179,3,Arather,1949,136,7,13,20,35.0%,2h
43179,2,Shin,1949,120,6,14,20,30.0%,5m
43179,3,DrZook,1949,105,5,3,8,62.5%,8m
43179,2,[MGKYOU]Susanoo,1949,205,4,6,10,40.0%,6m
43179,2,FallenStar,1949,0,3,4,7,42.9%,2h
43179,3,ronnie,1949,30,3,5,8,37.5%,36m
43179,3,EmeraldLord,1949,0,2,4,6,33.3%,2h
43179,1,[Lp]Bato,1949,136,2,5,7,28.6%,53m
43179,2,Yugi,1949,72,2,10,12,16.7%,36m
43179,3,Potatoehunt,1949,0,1,2,3,33.3%,2h
43179,3,Luxemburgo,1949,30,1,3,4,25.0%,2h
43179,2,AvanzinKK,1949,44,1,3,4,25.0%,48m
43179,3,Kalstormblsd,1949,0,1,4,5,20.0%,2h
43179,2,SilverFox,1949,94,1,7,8,12.5%,2h
43179,3,SirVicho,1949,0,0,1,1,0.0%,41m
43179,3,Medicmx,1949,0,0,4,4,0.0%,31m
43179,2,[KANELO]angelcaido,1949,0,0,4,4,0.0%,2h
43202,2,gamergirl,1948,1173,44,53,97,45.4%,2h
43202,2,Spencer,1948,702,37,41,78,47.4%,26m
43202,2,Free,1948,540,27,45,72,37.5%,39m
43202,3,Arshion,1948,678,24,25,49,49.0%,2h
43202,2,ZeratuL,1948,358,13,16,29,44.8%,2h
43202,2,torres,1948,380,13,19,32,40.6%,2h
43202,3,Pavel,1948,278,10,10,20,50.0%,12m
43202,2,SSIwigger,1948,75,5,12,17,29.4%,47m
43202,3,EmTown,1948,58,4,6,10,40.0%,4m
43202,3,GabieBaby,1948,0,1,0,1,100.0%,48m
43202,3,SpaceBlock,1948,0,1,0,1,100.0%,16m
43202,3,[ESRA]SHANKINATOR,1948,96,1,2,3,33.3%,29m
43202,1,leben,1948,0,0,1,1,0.0%,2h
43215,2,MikeNY,1947,1547,172,183,355,48.5%,38m
43215,1,GANDER,1947,1553,152,153,305,49.8%,2h
43215,2,JÁJÁ,1947,1504,101,127,228,44.3%,2h
43215,2,Javier,1947,1112,53,55,108,49.1%,2h
43215,3,EriktheRed,1947,959,40,37,77,51.9%,2h
43215,3,RoninWorkout,1947,984,40,45,85,47.1%,2h
43215,2,Harvester,1947,348,32,34,66,48.5%,47m
43215,2,Wisnaiter,1947,495,22,17,39,56.4%,2h
43215,2,Brawndo,1947,210,7,13,20,35.0%,33m
43215,3,[L82Die]KingSSM,1947,120,5,5,10,50.0%,2h
43215,3,marq,1947,86,4,1,5,80.0%,31m
43215,3,FatalFuze,1947,60,3,1,4,75.0%,2h
43215,2,boon,1947,0,1,0,1,100.0%,2h
43215,1,nirupdse,1947,0,1,7,8,12.5%,34m
43215,2,Shahkanarnar,1947,0,0,4,4,0.0%,36m
43230,2,Vorclex,1946,904,117,121,238,49.2%,2h
43230,2,Curotto,1946,1217,46,59,105,43.8%,2h
43230,2,FRFLPPSmurf,1946,1067,39,52,91,42.9%,2h
43230,3,LEINAD,1946,694,28,28,56,50.0%,43m
43230,3,seanpiadoso,1946,457,25,23,48,52.1%,20m
43230,3,FoxDARK,1946,483,17,17,34,50.0%,12m
43230,2,Shield,1946,421,14,21,35,40.0%,2h
43230,2,BUCKNAKED,1946,226,8,11,19,42.1%,2h
43230,2,[BadBoi]General,1946,230,7,18,25,28.0%,49m
43230,1,LeroyJenkins,1946,197,5,15,20,25.0%,12m
43230,2,JoeBud,1946,122,4,14,18,22.2%,2h
43230,3,TimeForCrab,1946,0,2,3,5,40.0%,2h
43230,2,GpainSwag,1946,102,2,5,7,28.6%,2h
43230,3,WhydUdoTHAT,1946,42,2,5,7,28.6%,2h
43230,3,iSpiGaO,1946,0,0,1,1,0.0%,2h
43245,2,[C31081]zetabosiomx,1945,1573,159,181,340,46.8%,14m
43245,3,DEADLIFT,1945,1012,51,44,95,53.7%,2h
43245,2,[THDT]Pedro,1945,1186,49,48,97,50.5%,24m
43245,1,[GFUEL]HandiiMan,1945,458,45,56,101,44.6%,2h
43245,3,PantherX,1945,431,16,9,25,64.0%,2h
43245,2,rglemann,1945,333,12,13,25,48.0%,38m
43245,3,Cheveley,1945,306,11,12,23,47.8%,8m
43245,3,VLADE,1945,252,9,7,16,56.2%,2h
43245,3,CORVETTE,1945,228,7,0,7,100.0%,41m
43245,3,[72o]claytonimore,1945,112,4,4,8,50.0%,2h
43245,3,MURDEREK,1945,90,4,5,9,44.4%,2h
43245,3,claudius,1945,58,3,3,6,50.0%,2h
43245,1,Brock,1945,112,3,10,13,23.1%,2h
43245,1,JOHN,1945,97,2,4,6,33.3%,31m
43245,2,spade,1945,46,2,8,10,20.0%,2h
43245,3,Nose,1945,0,1,2,3,33.3%,2h
43245,1,Idhuntress,1945,48,1,2,3,33.3%,2h
43245,3,BigSwede,1945,0,1,4,5,20.0%,55m
43245,3,[COIL]Ogre,1945,38,1,6,7,14.3%,28m
43264,3,ealumass,1944,913,41,28,69,59.4%,2h
43264,3,Analog,1944,964,36,42,78,46.2%,1h
43264,3,TempleWolf,1944,500,17,9,26,65.4%,56m
43264,3,RonBuan,1944,359,14,15,29,48.3%,2h
43264,2,Phatluv,1944,278,9,11,20,45.0%,2h
43264,2,heymanGG,1944,270,8,8,16,50.0%,3h
43264,2,hotjoetato,1944,204,7,6,13,53.8%,27m
43264,2,bighead,1944,140,5,11,16,31.2%,2h
43264,2,direraven,1944,112,5,19,24,20.8%,2h
43264,1,redman,1944,163,4,1,5,80.0%,12m
43264,3,COMANDERKANE,1944,52,4,14,18,22.2%,2h
43264,3,smashen,1944,0,3,3,6,50.0%,16m
43264,3,MonkeyDLuffy,1944,30,3,4,7,42.9%,43m
43264,2,[3AM]StevenHaun,1944,62,3,6,9,33.3%,44m
43264,3,AlexGrady,1944,122,2,6,8,25.0%,2h
43264,3,[NEDLOG]RobOkhaN,1944,0,0,3,3,0.0%,2h
43264,3,Zeah,1944,0,0,5,5,0.0%,2h
43281,2,Zerg,1943,202,32,57,89,36.0%,23m
43281,3,DucatiDark,1943,664,26,21,47,55.3%,2h
43281,2,BaronVonEvil,1943,251,11,9,20,55.0%,2h
43281,2,SnakeEyes,1943,232,9,9,18,50.0%,48m
43281,2,SuperNinja,1943,100,6,7,13,46.2%,40m
43281,1,[FAPFAP]JJBarea,1943,235,6,11,17,35.3%,2h
43281,2,Aradriel,1943,128,6,14,20,30.0%,7m
43281,1,Chaim,1943,238,6,15,21,28.6%,2h
43281,2,[TPVZ]Braxis,1943,0,1,0,1,100.0%,2h
43281,2,BlazingFury,1943,0,1,0,1,100.0%,7m
43281,1,[HOT69]souldev,1943,48,1,5,6,16.7%,29m
43281,2,Rgsd,1943,0,1,8,9,11.1%,2h
43281,3,[TGCF]Amadeus,1943,0,0,1,1,0.0%,31m
43294,3,Pililus,1942,968,97,112,209,46.4%,31m
43294,2,CobraCoombs,1942,368,35,37,72,48.6%,38m
43294,1,YellowApproa,1942,549,26,45,71,36.6%,48m
43294,2,carlojbh,1942,532,22,33,55,40.0%,2h
43294,2,ambient,1942,622,21,31,52,40.4%,2h
43294,2,Yan,1942,283,8,17,25,32.0%,2h
43294,2,DarkYeshua,1942,212,5,12,17,29.4%,2h
43294,3,TheSickllama,1942,74,4,4,8,50.0%,2h
43294,3,Omega,1942,170,4,10,14,28.6%,2h
43294,3,UncleT,1942,167,4,10,14,28.6%,48m
43294,3,Logio,1942,120,3,1,4,75.0%,32m
43294,3,DeeperCookie,1942,104,3,7,10,30.0%,40m
43294,3,djcardhard,1942,30,2,0,2,100.0%,2h
43294,2,[DC2]MmRisorio,1942,34,2,7,9,22.2%,2h
43294,2,mfernandinom,1942,62,2,10,12,16.7%,40m
43294,3,Zelot,1942,0,1,0,1,100.0%,2h
43294,3,Pentor,1942,0,1,1,2,50.0%,56m
43294,3,[TOUHMI]bbenzo,1942,30,1,1,2,50.0%,44m
43294,3,BloodBrother,1942,0,1,2,3,33.3%,2h
43294,3,niko,1942,0,0,3,3,0.0%,2h
43294,2,bennydeuce,1942,0,0,6,6,0.0%,4m
43315,1,LtLfoot,1941,908,31,45,76,40.8%,2h
43315,2,Akira,1941,699,28,28,56,50.0%,15m
43315,3,Apollo,1941,484,18,16,34,52.9%,2h
43315,3,Tantrika,1941,261,14,12,26,53.8%,47m
43315,1,Jigsaw,1941,165,6,8,14,42.9%,56m
43315,1,simon,1941,236,6,15,21,28.6%,2h
43315,2,Ragnar,1941,188,5,9,14,35.7%,47m
43315,3,Natoh,1941,74,4,0,4,100.0%,48m
43315,3,Chechini,1941,114,4,5,9,44.4%,11m
43315,2,[TurkSu]Kaiser,1941,182,3,5,8,37.5%,48m
43315,2,Nyrk,1941,151,3,10,13,23.1%,40m
43315,2,Alvis,1941,30,1,7,8,12.5%,56m
43315,2,Wanheda,1941,30,1,8,9,11.1%,9m
43315,3,Mugen,1941,0,0,1,1,0.0%,2h
43315,3,SpeyederFang,1941,0,0,2,2,0.0%,2h
43315,1,SuperNinja,1941,0,0,5,5,0.0%,29m
43331,2,EVE,1940,1544,297,406,703,42.2%,2h
43331,2,[SCOG]Zyprexa,1940,1520,153,157,310,49.4%,2h
43331,1,jamesmin,1940,1533,93,110,203,45.8%,23m
43331,2,Neox,1940,996,43,49,92,46.7%,4m
43331,3,lubrasi,1940,862,31,33,64,48.4%,11m
43331,2,elbermix,1940,700,25,30,55,45.5%,2h
43331,1,Cosmos,1940,620,23,29,52,44.2%,28m
43331,1,Flicker,1940,540,20,36,56,35.7%,2h
43331,3,keanarritos,1940,522,18,23,41,43.9%,2h
43331,2,[xKATx]Ragnar,1940,214,7,17,24,29.2%,15m
43331,3,arkantos,1940,217,6,5,11,54.5%,43m
43331,2,SharpKnife,1940,192,6,8,14,42.9%,6m
43331,2,Goldenblade,1940,155,5,4,9,55.6%,2h
43331,1,Skeksis,1940,96,3,11,14,21.4%,2h
43331,2,Mayday,1940,64,2,7,9,22.2%,7m
43331,3,Shamasta,1940,0,1,0,1,100.0%,11m
43331,2,Mezzolien,1940,0,1,3,4,25.0%,15m
43331,3,EmperorOfMan,1940,0,0,1,1,0.0%,2h
43331,3,[BScard]sinjin,1940,0,0,1,1,0.0%,56m
43331,2,rodrigosonco,1940,0,0,4,4,0.0%,42m
43351,2,Aspire,1939,1511,85,87,172,49.4%,2h
43351,2,Sneakpeek,1939,1228,47,56,103,45.6%,3h
43351,3,aleden,1939,654,39,44,83,47.0%,2h
43351,2,MAURI,1939,926,34,42,76,44.7%,2h
43351,3,sunnyD,1939,396,19,4,23,82.6%,40m
43351,2,hidepp,1939,30,4,5,9,44.4%,2h
43351,3,JRMEDINA,1939,104,3,5,8,37.5%,2h
43351,1,emcl,1939,40,3,9,12,25.0%,48m
43351,1,Pneumo,1939,46,2,9,11,18.2%,46m
43351,1,FryDaddy,1939,40,2,10,12,16.7%,41m
43351,3,lostsoul,1939,0,1,0,1,100.0%,2h
43351,1,LieutenantKe,1939,0,1,8,9,11.1%,14m
43351,2,ANUX,1939,0,0,1,1,0.0%,2h
43351,3,Rediscool,1939,0,0,6,6,0.0%,42m
43365,2,sucram,1938,641,23,30,53,43.4%,2h
43365,2,COATL,1938,383,15,22,37,40.5%,2h
43365,2,GustavoHND,1938,164,5,9,14,35.7%,27m
43365,3,Afire,1938,30,2,2,4,50.0%,16m
43365,3,Soyoufoundme,1938,0,1,0,1,100.0%,2h
43365,3,aTomatoFocus,1938,0,0,1,1,0.0%,2h
43365,3,Flintson,1938,0,0,6,6,0.0%,2h
43365,2,Torrey,1938,0,0,6,6,0.0%,47m
43365,2,Ethan,1938,0,0,6,6,0.0%,2h
43365,2,Broma,1938,0,0,9,9,0.0%,2h
43375,2,[1944]JazzMan,1937,1588,198,215,413,47.9%,2h
43375,2,joefish,1937,1242,93,104,197,47.2%,2h
43375,1,turdhurdler,1937,1525,57,59,116,49.1%,56m
43375,2,[LOHd]fulmetaljkt,1937,876,29,43,72,40.3%,2h
43375,3,BigSpree,1937,576,24,19,43,55.8%,44m
43375,2,BigTittyGF,1937,570,23,25,48,47.9%,2h
43375,2,zachary,1937,522,18,24,42,42.9%,9m
43375,1,Justice,1937,268,9,15,24,37.5%,13m
43375,3,WhiteAngelNs,1937,214,8,5,13,61.5%,11m
43375,3,[mentir]metrallan,1937,240,8,6,14,57.1%,32m
43375,2,[PTHero]TheNanoMachi,1937,246,7,11,18,38.9%,2h
43375,1,BigC,1937,215,6,11,17,35.3%,2h
43375,2,felipepsi,1937,76,4,9,13,30.8%,2h
43375,3,SirManolo,1937,0,1,0,1,100.0%,2h
43375,2,ever,1937,30,1,4,5,20.0%,2h
43375,1,Shaman,1937,0,1,4,5,20.0%,29m
43375,2,Shinoa,1937,0,0,1,1,0.0%,2h
43375,2,MMuskrat,1937,0,0,3,3,0.0%,44m
43393,2,PapiMario,1936,1242,104,105,209,49.8%,51m
43393,2,[PNV]TastyCorn,1936,1234,50,56,106,47.2%,2h
43393,3,Boyesette,1936,554,20,22,42,47.6%,2h
43393,2,[GLHFG]Domenic,1936,440,16,21,37,43.2%,2h
43393,3,Anthony,1936,368,15,13,28,53.6%,46m
43393,2,Lucas,1936,189,6,8,14,42.9%,2h
43393,3,[WEWO]WarGhost,1936,114,4,3,7,57.1%,36m
43393,3,UwUxxFaixX,1936,60,3,1,4,75.0%,16m
43393,3,ZodiakSC,1936,88,3,6,9,33.3%,26m
43393,3,[JSTM]Switters,1936,60,2,1,3,66.7%,2h
43393,3,[MORGUE]Ajindo,1936,0,1,0,1,100.0%,47m
43393,3,Gzfellings,1936,0,1,1,2,50.0%,2h
43393,3,wetfox,1936,0,1,1,2,50.0%,2h
43393,3,agentmothman,1936,0,1,3,4,25.0%,2h
43393,1,Impact,1936,0,1,5,6,16.7%,2h
43393,2,Xeres,1936,0,0,7,7,0.0%,40m
43409,2,HornsBobby,1935,849,46,42,88,52.3%,2h
43409,3,DiegoFuzatto,1935,652,24,26,50,48.0%,2h
43409,3,TexasFighter,1935,482,21,20,41,51.2%,44m
43409,3,UShouldQuit,1935,508,20,16,36,55.6%,56m
43409,3,NoobForLife,1935,288,11,22,33,33.3%,2h
43409,3,Shiftydevil,1935,308,10,10,20,50.0%,2h
43409,2,WolfCrimson,1935,264,10,14,24,41.7%,2h
43409,3,Manuel,1935,232,8,1,9,88.9%,2h
43409,3,Dannydorito,1935,262,7,14,21,33.3%,41m
43409,1,RangerRaen,1935,158,6,13,19,31.6%,31m
43409,2,Arcangel,1935,173,4,7,11,36.4%,2h
43409,2,DrWatson,1935,94,4,9,13,30.8%,2h
43409,3,Max,1935,88,4,11,15,26.7%,2h
43409,2,antunXDpoder,1935,134,3,8,11,27.3%,2h
43409,3,[BzDp]Spydattack,1935,30,2,1,3,66.7%,2h
43409,3,[6801]CivicR,1935,0,1,4,5,20.0%,2h
43409,3,atrydes,1935,96,1,5,6,16.7%,2h
43409,2,ZENOMARC,1935,30,1,8,9,11.1%,40m
43409,3,[YEET42]Wrathor,1935,0,0,1,1,0.0%,2h
43409,2,gusta,1935,0,0,1,1,0.0%,2h
43409,3,Chinter,1935,0,0,2,2,0.0%,6m
43409,2,NumberOne,1935,0,0,2,2,0.0%,35m
43409,2,Lobotomight,1935,0,0,2,2,0.0%,2h
43409,3,Beowulf,1935,0,0,3,3,0.0%,2h
43433,2,InfinitY,1934,1482,119,122,241,49.4%,55m
43433,2,zorglud,1934,1497,70,78,148,47.3%,2h
43433,2,CHIHUAYO,1934,884,56,57,113,49.6%,2h
43433,3,SxTxYxLxExS,1934,62,3,3,6,50.0%,48m
43433,3,mko,1934,141,3,5,8,37.5%,11m
43433,2,WolfClawed,1934,130,3,7,10,30.0%,53m
43433,2,juanxs,1934,110,3,10,13,23.1%,2h
43433,2,Alkor,1934,0,1,7,8,12.5%,2h
43433,2,AyaseXKirino,1934,46,1,8,9,11.1%,2h
43433,3,[SLUMMS]Ethan,1934,0,0,2,2,0.0%,12m
43443,2,[Vrcz]KhoKhuayMan,1933,1230,83,99,182,45.6%,2h
43443,3,larvmatter,1933,1297,66,87,153,43.1%,4m
43443,2,Goldenpearl,1933,400,14,16,30,46.7%,36m
43443,3,Crypted,1933,70,7,9,16,43.8%,36m
43443,3,sempie,1933,190,6,6,12,50.0%,2h
43443,3,RenthWarlock,1933,146,6,7,13,46.2%,2h
43443,3,[Zambo]OdiseoDItaca,1933,125,3,11,14,21.4%,2h
43443,1,ryyan,1933,48,2,10,12,16.7%,23m
43443,3,jhojato,1933,30,1,2,3,33.3%,2h
43443,3,Epyon,1933,0,0,1,1,0.0%,55m
43443,3,[BosDon]BossDonRico,1933,0,0,2,2,0.0%,2h
43454,3,whally,1932,1008,73,86,159,45.9%,2h
43454,2,jambo,1932,706,29,27,56,51.8%,2h
43454,3,RedMonster,1932,285,10,17,27,37.0%,2h
43454,3,Jethreetwo,1932,266,9,10,19,47.4%,2h
43454,2,jaja,1932,217,8,10,18,44.4%,2h
43454,3,roger,1932,116,5,6,11,45.5%,31m
43454,3,Taeradun,1932,120,5,6,11,45.5%,2h
43454,1,HAZMAT,1932,192,5,16,21,23.8%,3h
43454,3,Benjy,1932,179,4,8,12,33.3%,20m
43454,3,ACIDImhiv,1932,88,3,5,8,37.5%,48m
43454,2,Kelsier,1932,42,1,8,9,11.1%,2h
43454,1,SneekySquid,1932,0,1,10,11,9.1%,31m
43454,3,[BLAQC]BLACK,1932,0,0,8,8,0.0%,2h
43467,2,BOA,1931,1057,43,40,83,51.8%,44m
43467,3,vikinglore,1931,1056,42,47,89,47.2%,16m
43467,3,Snaatch,1931,830,32,31,63,50.8%,31m
43467,2,TobyHumphrey,1931,762,25,38,63,39.7%,26m
43467,2,JBOMB,1931,446,15,24,39,38.5%,2h
43467,3,Dragon,1931,382,14,20,34,41.2%,36m
43467,2,CptnSwizzelz,1931,172,5,12,17,29.4%,2h
43467,1,SDMeridian,1931,64,4,16,20,20.0%,4m
43467,3,[Wonger]Adam,1931,0,1,1,2,50.0%,2h
43467,2,assasinpanda,1931,39,1,3,4,25.0%,35m
43467,3,Sam,1931,0,0,2,2,0.0%,56m
43467,2,Luiis,1931,0,0,6,6,0.0%,36m
43479,2,DirtyB,1930,1639,108,129,237,45.6%,2h
43479,2,Zealots,1930,1103,52,83,135,38.5%,51m
43479,3,aleph,1930,1300,46,55,101,45.5%,31m
43479,3,KillerJiang,1930,992,41,37,78,52.6%,41m
43479,3,VALCAS,1930,1014,37,39,76,48.7%,29m
43479,3,RedLantern,1930,298,29,19,48,60.4%,2h
43479,3,brayanEFN,1930,653,25,28,53,47.2%,2h
43479,3,VoidFlames,1930,550,22,18,40,55.0%,2h
43479,2,VoicedNose,1930,429,16,19,35,45.7%,2h
43479,3,SAGA,1930,435,14,18,32,43.8%,2h
43479,3,WizerKilhelm,1930,250,8,17,25,32.0%,2h
43479,1,BouncyBear,1930,139,3,0,3,100.0%,2h
43479,3,Ethan,1930,97,2,12,14,14.3%,32m
43479,3,FLYINGLOTUS,1930,30,1,1,2,50.0%,6m
43479,3,BLUEIIIIBEAM,1930,42,1,1,2,50.0%,41m
43479,3,[2015DR]ayax,1930,30,1,2,3,33.3%,8m
43479,3,Balthazar,1930,0,0,1,1,0.0%,31m
43479,3,[2RAW]Samsterix,1930,0,0,1,1,0.0%,20m
43479,2,[NYOOOM]Direlict,1930,0,0,5,5,0.0%,2h
43479,2,CHUGGY,1930,0,0,6,6,0.0%,47m
43479,3,Azreal,1930,0,0,7,7,0.0%,2h
43479,2,BIizzard,1930,0,0,7,7,0.0%,2h
43479,2,Frozen,1930,0,0,7,7,0.0%,53m
43502,2,ShotCaller,1929,399,16,15,31,51.6%,2h
43502,3,justmie,1929,287,9,8,17,52.9%,20m
43502,3,lostboy,1929,66,5,17,22,22.7%,38m
43502,1,wendy,1929,0,3,5,8,37.5%,9m
43502,1,Prettyyuja,1929,30,2,11,13,15.4%,2h
43502,3,merlin,1929,0,0,1,1,0.0%,2h
43502,3,uarfor,1929,0,0,1,1,0.0%,2h
43502,3,manuel,1929,0,0,2,2,0.0%,41m
43510,3,Carl,1928,950,51,68,119,42.9%,2h
43510,2,[WuTang]MasterWU,1928,748,29,30,59,49.2%,51m
43510,2,[BBDuB]GuCCiManEBuR,1928,391,17,26,43,39.5%,2h
43510,3,[askani]Askanison,1928,177,12,6,18,66.7%,36m
43510,1,HiTmAnHiTz,1928,226,8,12,20,40.0%,23m
43510,2,BenjaminJk,1928,46,4,5,9,44.4%,2h
43510,3,Xander,1928,102,3,6,9,33.3%,3h
43510,1,xXLEXDROGOXx,1928,112,3,9,12,25.0%,2h
43510,3,Kevdoscinco,1928,0,2,11,13,15.4%,2h
43510,3,skeletor,1928,0,1,1,2,50.0%,2h
43520,2,CumGroyper,1927,1098,46,47,93,49.5%,2h
43520,2,[CCoWW]Rob,1927,1206,46,58,104,44.2%,2h
43520,2,Easyduzzit,1927,389,29,35,64,45.3%,49m
43520,3,[SyLx]MAXBRASIL,1927,663,23,22,45,51.1%,2h
43520,3,MasterEng,1927,576,22,23,45,48.9%,31m
43520,3,elroble,1927,462,17,15,32,53.1%,2h
43520,3,Leviathann,1927,342,12,14,26,46.2%,2h
43520,3,Eclisto,1927,326,11,20,31,35.5%,16m
43520,2,eli,1927,194,4,9,13,30.8%,31m
43520,3,MrPikles,1927,145,3,6,9,33.3%,2h
43520,2,KalEl,1927,62,2,12,14,14.3%,2h
43520,3,pipe,1927,30,1,1,2,50.0%,2h
43520,1,rbg,1927,0,1,10,11,9.1%,37m
43520,2,Paladin,1927,0,0,2,2,0.0%,31m
43520,2,Bastion,1927,0,0,7,7,0.0%,2h
43535,3,EddieKing,1926,1283,48,52,100,48.0%,12m
43535,2,Hazzdogg,1926,242,8,10,18,44.4%,2h
43535,2,RobsonVESS,1926,136,6,6,12,50.0%,36m
43535,3,[ZTempz]cauze,1926,218,6,8,14,42.9%,1h
43535,1,Zuri,1926,48,2,0,2,100.0%,19m
43535,3,MoopMoop,1926,21,2,2,4,50.0%,2h
43535,3,Sanx,1926,0,0,1,1,0.0%,20m
43535,3,AdanHaz,1926,0,0,1,1,0.0%,42m
43543,2,Doomed,1925,1498,225,282,507,44.4%,2h
43543,2,Shazamseba,1925,1581,198,216,414,47.8%,2h
43543,2,CykoKiller,1925,1212,48,54,102,47.1%,38m
43543,3,Maverick,1925,458,31,30,61,50.8%,2h
43543,2,Twitchrider,1925,594,22,24,46,47.8%,6m
43543,2,Slav,1925,331,16,24,40,40.0%,47m
43543,3,sabotage,1925,338,12,21,33,36.4%,2h
43543,2,marvin,1925,234,11,15,26,42.3%,47m
43543,1,Amilius,1925,195,7,12,19,36.8%,46m
43543,3,SrKesoArdiya,1925,58,2,2,4,50.0%,43m
43543,3,[FUU]Durantien,1925,0,2,3,5,40.0%,2h
43543,3,[SYNDCT]Wyatt,1925,0,1,0,1,100.0%,36m
43543,3,GreenCat,1925,30,1,3,4,25.0%,46m
43543,3,LuisG,1925,0,0,1,1,0.0%,48m
43543,2,JohnPG,1925,0,0,3,3,0.0%,2h
43543,2,Demonwings,1925,0,0,8,8,0.0%,6m
43543,2,Thomas,1925,0,0,8,8,0.0%,35m
43560,2,[TXV]razerpin,1924,1188,43,68,111,38.7%,2h
43560,3,carlose,1924,532,18,16,34,52.9%,16m
43560,3,esteban,1924,489,17,19,36,47.2%,2h
43560,3,Rosharchk,1924,300,14,12,26,53.8%,48m
43560,3,Dachosenrat,1924,302,11,15,26,42.3%,2h
43560,3,Visionaryceo,1924,265,8,6,14,57.1%,2h
43560,1,RareQwilfish,1924,172,4,12,16,25.0%,52m
43560,3,Drakharis,1924,58,3,1,4,75.0%,2h
43560,3,Krlam,1924,86,3,3,6,50.0%,36m
43560,1,lalogbc,1924,95,2,1,3,66.7%,11m
43560,2,OneHungLow,1924,46,2,2,4,50.0%,35m
43560,1,Wildman,1924,48,2,10,12,16.7%,2h
43560,3,TicketyBoo,1924,0,1,0,1,100.0%,46m
43560,1,Oli,1924,0,1,1,2,50.0%,3h
43560,3,MyHalfToast,1924,0,1,1,2,50.0%,12m
43560,3,CatGhost,1924,30,1,7,8,12.5%,2h
43560,2,RedSorrow,1924,0,0,1,1,0.0%,36m
43560,3,KanyeRest,1924,0,0,1,1,0.0%,48m
43560,3,[xMGEx]xTemplarix,1924,0,0,1,1,0.0%,2h
43579,2,MayDay,1923,1352,121,161,282,42.9%,22m
43579,2,Choaslord,1923,1506,63,72,135,46.7%,42m
43579,3,zuluboy,1923,1205,61,66,127,48.0%,8m
43579,2,[PREVI]Marcio,1923,800,59,63,122,48.4%,2h
43579,3,OLDFattyPC,1923,1045,42,40,82,51.2%,38m
43579,3,TossBoss,1923,1040,42,44,86,48.8%,44m
43579,2,NattyRed,1923,977,36,39,75,48.0%,2h
43579,3,MrAnderson,1923,391,13,15,28,46.4%,2h
43579,3,jade,1923,204,8,3,11,72.7%,2h
43579,3,Nero,1923,30,2,1,3,66.7%,26m
43579,3,[AIURxT]elmenas,1923,0,1,0,1,100.0%,13m
43579,3,Arinze,1923,40,1,1,2,50.0%,47m
43579,3,SmonJith,1923,30,1,1,2,50.0%,12m
43579,2,dunnbeetle,1923,46,1,6,7,14.3%,2h
43579,1,KAT,1923,46,1,10,11,9.1%,2h
43579,3,Unagi,1923,0,0,5,5,0.0%,2h
43595,2,elinfiltrado,1922,205,14,17,31,45.2%,2h
43595,2,[9thAve]cheese,1922,276,11,14,25,44.0%,2h
43595,2,camipolo,1922,251,6,6,12,50.0%,2h
43595,3,Snow,1922,30,5,1,6,83.3%,46m
43595,3,soybiscuits,1922,62,3,6,9,33.3%,2h
43595,1,CarrotCake,1922,0,1,3,4,25.0%,2h
43595,3,ryanthelion,1922,0,0,1,1,0.0%,6m
43595,3,Revan,1922,0,0,5,5,0.0%,2h
43595,3,HowBigIsUrs,1922,0,0,6,6,0.0%,55m
43604,2,Diego,1921,1455,282,307,589,47.9%,2h
43604,1,SWED,1921,1506,158,152,310,51.0%,2h
43604,2,Rummblefish,1921,737,36,42,78,46.2%,2h
43604,2,[FyHr]leonidas,1921,820,34,33,67,50.7%,2h
43604,3,mongo,1921,367,23,18,41,56.1%,2h
43604,2,Tecra,1921,458,17,30,47,36.2%,2h
43604,3,pheasant,1921,242,8,5,13,61.5%,32m
43604,2,ZisupaS,1921,116,4,4,8,50.0%,46m
43604,3,WildSource,1921,112,4,7,11,36.4%,8m
43604,3,DominiKiD,1921,30,2,1,3,66.7%,2h
43604,3,MiniNinja,1921,60,2,4,6,33.3%,2h
43604,2,CashuaDWK,1921,64,2,7,9,22.2%,2h
43604,2,Draco,1921,97,2,10,12,16.7%,6m
43604,1,MISTERKRABBS,1921,34,2,10,12,16.7%,48m
43604,2,JUSTICE,1921,0,0,1,1,0.0%,2h
43604,3,Wilhem,1921,0,0,2,2,0.0%,2h
43604,2,WILLZ,1921,0,0,6,6,0.0%,26m
43621,2,Mox,1920,1117,42,49,91,46.2%,15m
43621,2,cristianproX,1920,436,15,18,33,45.5%,2h
43621,3,LastNavySeal,1920,197,10,7,17,58.8%,36m
43621,2,PeePoo,1920,272,10,9,19,52.6%,41m
43621,3,Chris,1920,30,4,5,9,44.4%,2h
43621,3,Mancaso,1920,30,2,0,2,100.0%,12m
43621,2,HUHU,1920,0,1,0,1,100.0%,2h
43621,3,adri,1920,0,1,0,1,100.0%,2h
43621,3,toumba,1920,0,1,1,2,50.0%,36m
43621,3,[Enuma]Visiuz,1920,0,0,2,2,0.0%,2h
43621,1,[RLFA]DuePlayer,1920,73,0,8,8,0.0%,10m
43632,3,repex,1919,193,9,11,20,45.0%,46m
43632,1,Lelolink,1919,246,8,19,27,29.6%,2h
43632,3,PhenixGo,1919,212,7,10,17,41.2%,12m
43632,3,jhon,1919,223,6,12,18,33.3%,2h
43632,2,Choccy,1919,74,2,9,11,18.2%,2h
43632,3,birdman,1919,0,1,4,5,20.0%,2h
43632,1,Declan,1919,93,1,7,8,12.5%,16m
43639,2,josh,1918,1564,191,228,419,45.6%,26m
43639,3,MrTulagran,1918,147,3,7,10,30.0%,2h
43639,1,Wadd,1918,96,3,12,15,20.0%,2h
43639,3,TylerDurden,1918,30,1,4,5,20.0%,2h
43639,1,LotSwordArt,1918,97,1,8,9,11.1%,2h
43639,2,AngelofDeath,1918,34,1,8,9,11.1%,2h
43639,3,HasluKa,1918,0,0,1,1,0.0%,38m
43639,3,Crazzyleggs,1918,0,0,2,2,0.0%,44m
43647,2,MarGael,1917,398,35,44,79,44.3%,2h
43647,2,spacefrog,1917,396,15,23,38,39.5%,2h
43647,1,[DSTN]entropy,1917,324,12,12,24,50.0%,52m
43647,3,HaitianNinja,1917,162,7,4,11,63.6%,2h
43647,3,Nsanity,1917,60,2,12,14,14.3%,43m
43647,3,LegendaryFox,1917,0,1,9,10,10.0%,30m
43647,3,Karmasamsara,1917,0,0,1,1,0.0%,31m
43647,2,ninjanoir,1917,0,0,1,1,0.0%,42m
43647,3,Filipano,1917,0,0,6,6,0.0%,2h
43656,2,FireDune,1916,1550,121,144,265,45.7%,2h
43656,2,AngelOfMercy,1916,1557,104,110,214,48.6%,46m
43656,2,VortecPinga,1916,1163,102,97,199,51.3%,2h
43656,1,autumn,1916,1124,81,94,175,46.3%,2h
43656,3,Omar,1916,1454,59,61,120,49.2%,2h
43656,1,PowerPlay,1916,292,11,19,30,36.7%,2h
43656,2,JarKhan,1916,358,10,18,28,35.7%,2h
43656,2,[D3xd]spectre,1916,166,6,5,11,54.5%,2h
43656,3,Hyperwaffles,1916,114,5,6,11,45.5%,44m
43656,3,Typhlosis,1916,88,4,1,5,80.0%,29m
43656,1,deathmage,1916,0,1,2,3,33.3%,2h
43656,3,lazygamer,1916,0,0,1,1,0.0%,2h
43656,2,fearme,1916,0,0,7,7,0.0%,2h
43669,2,silent,1915,1562,189,203,392,48.2%,15m
43669,1,CAZADOR,1915,735,59,67,126,46.8%,56m
43669,2,TurboCarmi,1915,584,22,29,51,43.1%,2h
43669,2,DEADCRAZY,1915,492,17,25,42,40.5%,6m
43669,3,[HOT69]TedMan,1915,357,15,16,31,48.4%,31m
43669,2,Krougar,1915,356,14,22,36,38.9%,3h
43669,3,Zergbriel,1915,325,13,14,27,48.1%,36m
43669,1,Café,1915,228,6,13,19,31.6%,2h
43669,3,DepreRexxor,1915,118,4,4,8,50.0%,2h
43669,3,mikecold,1915,119,3,9,12,25.0%,2h
43669,3,third,1915,30,2,1,3,66.7%,2h
43669,3,[cl0udM]XDkellan,1915,58,2,2,4,50.0%,40m
43669,3,woaiplatinum,1915,0,0,1,1,0.0%,2h
43669,3,Insaniac,1915,0,0,2,2,0.0%,34m
43669,2,[LoShay]NeMesSiLd,1915,0,0,7,7,0.0%,16m
43684,3,modigadi,1914,1595,370,442,812,45.6%,23m
43684,2,juancalito,1914,1366,68,77,145,46.9%,3h
43684,3,LazerDILLIGA,1914,984,39,39,78,50.0%,2h
43684,2,CapRazo,1914,217,25,32,57,43.9%,41m
43684,2,Emperorbauz,1914,619,25,32,57,43.9%,2h
43684,2,Herve,1914,635,24,30,54,44.4%,2h
43684,3,BULGORITE,1914,404,14,17,31,45.2%,4m
43684,2,Sithspawn,1914,316,11,19,30,36.7%,2h
43684,3,Smaenblack,1914,282,10,12,22,45.5%,42m
43684,1,Deathscythe,1914,290,9,19,28,32.1%,26m
43684,3,Grossnack,1914,163,6,4,10,60.0%,2h
43684,2,Teranasaurus,1914,140,5,12,17,29.4%,40m
43684,3,amFINtamin,1914,171,4,3,7,57.1%,2h
43684,3,RONALD,1914,94,3,10,13,23.1%,31m
43684,2,Mike,1914,30,1,5,6,16.7%,2h
43684,2,FluffyWolf,1914,48,1,8,9,11.1%,2h
43700,2,IBLACKIHEART,1913,689,24,31,55,43.6%,2h
43700,3,[RAR3]Jaccob,1913,533,19,14,33,57.6%,2h
43700,1,Mithrandir,1913,351,9,23,32,28.1%,2h
43700,3,fadedlotus,1913,235,8,4,12,66.7%,3m
43700,1,Eziow,1913,146,7,12,19,36.8%,26m
43700,2,Sequoia,1913,229,7,20,27,25.9%,22m
43700,2,THEDESTROYER,1913,216,5,3,8,62.5%,2h
43700,1,properruno,1913,196,4,6,10,40.0%,48m
43700,2,[GINW]CluckDaddy,1913,42,2,7,9,22.2%,2h
43700,3,Nautilus,1913,30,1,4,5,20.0%,2h
43700,2,Diavolo,1913,0,1,6,7,14.3%,28m
43700,1,[SWOU]Vanish,1913,0,1,8,9,11.1%,49m
43712,2,Alvalanker,1912,1523,213,234,447,47.7%,2h
43712,2,ShuaSlays,1912,678,26,35,61,42.6%,47m
43712,2,Bugha,1912,356,14,16,30,46.7%,2h
43712,3,proxstar,1912,122,5,8,13,38.5%,46m
43712,2,JorgeUnreal,1912,172,5,19,24,20.8%,4m
43712,2,ZappySnake,1912,90,2,9,11,18.2%,2h
43712,3,truth,1912,95,1,1,2,50.0%,43m
43712,1,fernando,1912,0,1,8,9,11.1%,2h
43720,2,Wramm,1911,558,23,26,49,46.9%,2h
43720,3,dmitry,1911,96,4,5,9,44.4%,40m
43720,3,Tamashi,1911,0,1,1,2,50.0%,41m
43720,3,TechTophia,1911,30,1,2,3,33.3%,8m
43720,1,[xXGDXx]azcat,1911,96,1,4,5,20.0%,2h
43720,3,HoesMad,1911,0,0,1,1,0.0%,2h
43720,3,Fluffis,1911,0,0,1,1,0.0%,17m
43720,3,RERERE,1911,0,0,5,5,0.0%,34m
43728,2,enjoythegame,1910,1197,99,114,213,46.5%,2h
43728,2,Mogly,1910,843,30,48,78,38.5%,47m
43728,3,Light,1910,581,22,20,42,52.4%,2m
43728,3,[ShuShu]Tyree,1910,554,19,19,38,50.0%,2h
43728,2,GIZZLER,1910,422,15,20,35,42.9%,15m
43728,2,XxinfiernoxX,1910,396,12,18,30,40.0%,42m
43728,2,Eorgorrt,1910,288,10,15,25,40.0%,2h
43728,1,Wendar,1910,146,4,7,11,36.4%,41m
43728,3,JIM,1910,145,3,2,5,60.0%,2h
43728,2,[ALL3N]Jimmyjammzz,1910,123,3,8,11,27.3%,25m
43728,3,Bous,1910,30,3,17,20,15.0%,40m
43728,3,hspanicpanic,1910,32,2,5,7,28.6%,42m
43728,2,ThHendricks,1910,58,2,9,11,18.2%,2h
43728,3,Allen,1910,30,1,2,3,33.3%,2h
43728,3,tmev,1910,30,1,4,5,20.0%,43m
43728,3,Joker,1910,0,0,6,6,0.0%,13m
43744,2,[NNKZ]False,1909,814,30,36,66,45.5%,2h
43744,2,panchatantra,1909,619,28,37,65,43.1%,2h
43744,3,igncar,1909,730,24,38,62,38.7%,2h
43744,3,Evan,1909,245,7,5,12,58.3%,2h
43744,2,Sweetie,1909,174,6,16,22,27.3%,9m
43744,3,IceCraft,1909,48,3,4,7,42.9%,2h
43744,3,MuddZeroFour,1909,117,2,8,10,20.0%,2h
43744,3,BlackDog,1909,0,1,0,1,100.0%,30m
43744,2,RoneDogg,1909,0,1,1,2,50.0%,2h
43753,1,Jabrevski,1908,828,30,39,69,43.5%,5m
43753,3,Phoenix,1908,505,19,15,34,55.9%,39m
43753,3,[ISMDI]SaberTooth,1908,494,14,26,40,35.0%,2h
43753,2,OneShot,1908,266,8,15,23,34.8%,2h
43753,3,[CPL7]Andreyiti,1908,172,6,7,13,46.2%,11m
43753,1,LiveActionJ,1908,96,4,12,16,25.0%,16m
43753,3,Jericho,1908,68,3,5,8,37.5%,2h
43753,3,LIWEILICAO,1908,58,2,2,4,50.0%,48m
43753,3,TulioJcc,1908,119,2,2,4,50.0%,26m
43753,2,Taz,1908,42,2,6,8,25.0%,2h
43753,3,Ivo,1908,30,1,2,3,33.3%,2h
43753,2,Blkbeard,1908,0,1,5,6,16.7%,2h
43753,3,Artix,1908,0,0,6,6,0.0%,2h
43766,2,JEAN,1907,645,20,30,50,40.0%,39m
43766,3,Loz,1907,408,15,20,35,42.9%,44m
43766,3,OhRob,1907,416,14,18,32,43.8%,46m
43766,3,Tek,1907,144,6,7,13,46.2%,3m
43766,1,nrhythmic,1907,185,5,8,13,38.5%,30m
43766,3,onion,1907,58,3,4,7,42.9%,2h
43766,1,Jack,1907,96,3,12,15,20.0%,2h
43766,3,scaboo,1907,0,1,2,3,33.3%,17m
43766,1,spiritx,1907,0,1,5,6,16.7%,30m
43766,3,KakarotoX,1907,0,0,1,1,0.0%,1m
43766,3,brinerj,1907,0,0,6,6,0.0%,2m
43777,3,Naofumi,1906,1479,71,65,136,52.2%,2h
43777,3,Peter,1906,721,41,53,94,43.6%,2h
43777,2,TinyHands,1906,639,27,33,60,45.0%,2h
43777,3,onlyralphie,1906,423,25,36,61,41.0%,2h
43777,2,Footz,1906,498,18,19,37,48.6%,2h
43777,3,Artanis,1906,422,14,19,33,42.4%,2h
43777,3,Vash,1906,260,9,5,14,64.3%,2m
43777,3,[VIRGII]Theone,1906,194,7,9,16,43.8%,2h
43777,3,ihateorcs,1906,196,7,13,20,35.0%,2h
43777,3,AtotheK,1906,170,5,11,16,31.2%,2h
43777,1,lucho,1906,140,4,6,10,40.0%,19m
43777,2,Chinowin,1906,90,4,7,11,36.4%,7m
43777,2,MUMBLES,1906,90,4,9,13,30.8%,53m
43777,3,lilsaint,1906,124,4,9,13,30.8%,2h
43777,2,leo,1906,123,3,12,15,20.0%,2h
43777,3,Blackman,1906,58,2,1,3,66.7%,32m
43777,3,[AbcCo]Predator,1906,30,2,1,3,66.7%,2h
43777,2,mahon,1906,112,2,4,6,33.3%,2h
43777,2,Armanai,1906,48,2,7,9,22.2%,2h
43777,1,[ZrtlDT]Pumboso,1906,0,1,0,1,100.0%,2h
43777,3,GoldRoyerD,1906,0,0,1,1,0.0%,32m
43777,2,Polaris,1906,0,0,1,1,0.0%,2h
43777,3,sirfabio,1906,0,0,6,6,0.0%,2h
43777,2,egk,1906,0,0,15,15,0.0%,42m
43801,3,[KOSC]KnightHawk,1905,855,30,40,70,42.9%,2h
43801,2,Fenix,1905,240,11,21,32,34.4%,50m
43801,2,malikor,1905,163,7,4,11,63.6%,2h
43801,3,GripNRip,1905,241,7,8,15,46.7%,2h
43801,1,TheChadGuy,1905,96,5,12,17,29.4%,2h
43801,2,orii,1905,114,3,8,11,27.3%,2m
43801,1,BattlePants,1905,38,2,5,7,28.6%,3h
43801,3,LoliLikha,1905,122,2,9,11,18.2%,2h
43801,2,[Bommmm]efra,1905,0,1,0,1,100.0%,2h
43801,3,KillerTune,1905,30,1,8,9,11.1%,2h
43801,3,[LFUT]josue,1905,0,0,1,1,0.0%,36m
43812,2,Grimm,1904,320,27,36,63,42.9%,2h
43812,3,Timothy,1904,392,15,18,33,45.5%,36m
43812,2,Fxrede,1904,145,5,7,12,41.7%,2h
43812,3,[SwaPGC]jNr,1904,0,1,5,6,16.7%,2h
43812,3,[OvrDsd]NoobMaster,1904,36,1,6,7,14.3%,2h
43812,3,valentina,1904,0,0,1,1,0.0%,2h
43818,2,redoxalis,1903,1292,206,217,423,48.7%,2h
43818,3,POIROT,1903,225,31,17,48,64.6%,44m
43818,3,TheGreatest,1903,666,27,37,64,42.2%,2h
43818,2,gonzalom,1903,640,26,32,58,44.8%,2h
43818,3,aha,1903,664,23,30,53,43.4%,2h
43818,3,predalien,1903,482,16,19,35,45.7%,2h
43818,3,FeelBarney,1903,307,11,18,29,37.9%,2h
43818,3,[XSMen]Gambit,1903,142,6,4,10,60.0%,2h
43818,1,Serious,1903,140,2,1,3,66.7%,2h
43818,2,Jesster,1903,94,2,7,9,22.2%,33m
43818,3,PUG,1903,60,2,7,9,22.2%,2h
43818,3,Eduardo,1903,0,1,0,1,100.0%,2h
43818,3,frogger,1903,0,1,0,1,100.0%,36m
43818,3,[Doko]DarkAlejo,1903,0,1,1,2,50.0%,2h
43818,3,gurst,1903,30,1,2,3,33.3%,2h
43818,3,JERRIK,1903,0,0,1,1,0.0%,17m
43818,3,[LTK]ANNIE,1903,0,0,6,6,0.0%,2h
43835,3,CosBee,1902,778,46,48,94,48.9%,36m
43835,3,JorgeMS,1902,618,22,33,55,40.0%,3m
43835,2,[GrnBrd]Neotholic,1902,168,7,7,14,50.0%,2h
43835,2,SpaceLemming,1902,160,6,6,12,50.0%,2h
43835,3,Eric,1902,124,3,11,14,21.4%,50m
43835,3,RayProto,1902,30,1,3,4,25.0%,2h
43835,3,DCXSparks,1902,0,0,3,3,0.0%,2h
43842,3,ACEBOOKER,1901,1275,77,95,172,44.8%,2h
43842,1,QNSTevilGabe,1901,1414,57,90,147,38.8%,9m
43842,2,Alex,1901,717,26,33,59,44.1%,2h
43842,3,elmon,1901,235,7,4,11,63.6%,2h
43842,3,GOLIATH,1901,240,7,16,23,30.4%,56m
43842,3,[KhanZ]terran,1901,169,4,5,9,44.4%,2m
43842,2,[AdaptG]Fireuzou,1901,98,3,7,10,30.0%,39m
43842,2,JACKATTACK,1901,126,3,9,12,25.0%,2h
43842,3,[JamRoc]Eraser,1901,30,1,1,2,50.0%,12m
43842,3,MiniNinja,1901,0,1,1,2,50.0%,2h
43842,2,stallion,1901,0,1,3,4,25.0%,53m
43842,2,skoomadealer,1901,0,1,5,6,16.7%,28m
43842,2,fenix,1901,0,0,1,1,0.0%,35m
43842,2,LaGranMaxa,1901,0,0,7,7,0.0%,43m
43856,3,Crazycat,1900,1577,100,108,208,48.1%,3m
43856,2,Rowkonn,1900,1314,78,80,158,49.4%,15m
43856,3,kor,1900,354,13,24,37,35.1%,2h
43856,3,GaeL,1900,180,6,4,10,60.0%,47m
43856,3,Canaduh,1900,86,3,5,8,37.5%,3m
43856,3,Gaberz,1900,62,3,7,10,30.0%,31m
43856,1,Arteros,1900,46,2,10,12,16.7%,8m
43856,3,Trewya,1900,30,1,5,6,16.7%,2m
43856,3,PhoenixJGrey,1900,0,0,2,2,0.0%,2h
43856,2,simulation,1900,0,0,3,3,0.0%,2h
43866,3,HotdogFarmer,1899,322,12,17,29,41.4%,2h
43866,2,[cluez]Bubbles,1899,383,12,21,33,36.4%,2h
43866,2,ScrewDriver,1899,306,10,16,26,38.5%,15m
43866,2,Cosmiclotus,1899,158,7,9,16,43.8%,2h
43866,2,Sunsphinx,1899,122,5,10,15,33.3%,50m
43866,3,[HooX]Hooks,1899,60,2,4,6,33.3%,31m
43866,3,Richard,1899,68,2,4,6,33.3%,2h
43866,2,FlamingLava,1899,0,0,2,2,0.0%,31m
43866,3,detroider,1899,0,0,3,3,0.0%,2h
43866,3,fishy,1899,0,0,5,5,0.0%,46m
43876,3,Harmony,1898,1619,77,96,173,44.5%,2h
43876,2,AUDIOMACHINE,1898,871,61,83,144,42.4%,2h
43876,3,YippeeKiYay,1898,698,49,23,72,68.1%,2h
43876,2,Tabernario,1898,1090,43,45,88,48.9%,2h
43876,3,[FCTR]Dokkisse,1898,515,18,20,38,47.4%,8m
43876,3,MisterZed,1898,378,15,12,27,55.6%,47m
43876,2,[FyHr]MrGlycrM,1898,163,4,8,12,33.3%,33m
43876,3,Maverick,1898,88,3,5,8,37.5%,2h
43876,3,darkgus,1898,30,1,2,3,33.3%,2h
43876,1,Fili,1898,0,1,9,10,10.0%,2h
43876,2,THEKILLER,1898,0,0,2,2,0.0%,2m
43876,3,[OMNV]Sensai,1898,0,0,6,6,0.0%,2h
43876,2,veggeta,1898,0,0,7,7,0.0%,47m
43889,2,Veritas,1897,836,30,42,72,41.7%,3h
43889,2,[TY4GG]Neptuno,1897,317,20,33,53,37.7%,38m
43889,3,[BLMFTP]Thugger,1897,376,14,17,31,45.2%,2h
43889,1,danger,1897,204,6,12,18,33.3%,39m
43889,3,bargul,1897,180,5,10,15,33.3%,56m
43889,3,spinachdip,1897,0,3,3,6,50.0%,26m
43889,2,betew,1897,0,3,7,10,30.0%,2h
43889,3,AMENA,1897,0,1,3,4,25.0%,31m
43889,1,TinyTuna,1897,0,1,8,9,11.1%,56m
43889,3,CaptEli,1897,0,0,2,2,0.0%,2h
43899,3,OBIONE,1896,1560,183,181,364,50.3%,11m
43899,2,[diaman]ElMoyo,1896,1128,82,91,173,47.4%,2h
43899,1,Quadena,1896,432,15,37,52,28.8%,33m
43899,3,molty,1896,365,13,25,38,34.2%,56m
43899,3,Dadivus,1896,273,9,18,27,33.3%,2h
43899,1,blizzmang,1896,249,8,15,23,34.8%,14m
43899,2,Zarazul,1896,247,7,15,22,31.8%,2h
43899,3,Pit,1896,58,3,7,10,30.0%,40m
43899,3,SomeHobo,1896,0,1,0,1,100.0%,2h
43899,1,cafecomleite,1896,97,1,3,4,25.0%,48m
43899,3,XCORE,1896,0,1,4,5,20.0%,11m
43899,3,[NoPlan]boxerboynine,1896,0,1,5,6,16.7%,2h
43899,2,chang,1896,0,1,8,9,11.1%,2h
43899,3,DaddyOG,1896,0,0,1,1,0.0%,2h
43899,1,SuperQ,1896,0,0,5,5,0.0%,45m
43914,3,BomberMan,1895,284,10,12,22,45.5%,2h
43914,1,jijimuge,1895,94,5,11,16,31.2%,18m
43914,2,[INextI]Angel,1895,150,3,7,10,30.0%,50m
43914,3,saga,1895,60,2,4,6,33.3%,11m
43914,2,MythBuster,1895,44,1,1,2,50.0%,45m
43914,3,JKaido,1895,0,1,2,3,33.3%,3m
43914,3,NoVa,1895,0,0,1,1,0.0%,2h
43914,3,AToaster,1895,0,0,1,1,0.0%,2h
43914,2,zarzawild,1895,0,0,3,3,0.0%,16m
43923,2,SneakyTurtle,1894,1372,61,70,131,46.6%,2h
43923,2,soulsaul,1894,908,43,60,103,41.7%,22m
43923,2,CarlosC,1894,771,33,39,72,45.8%,2h
43923,2,Nano,1894,421,15,27,42,35.7%,15m
43923,3,[FE595]StarryYJ,1894,0,4,3,7,57.1%,1m
43923,3,Ryota,1894,60,3,3,6,50.0%,56m
43923,3,Aaron,1894,88,3,6,9,33.3%,3m
43923,3,BsquareD,1894,30,1,3,4,25.0%,2h
43923,3,Observer,1894,0,0,5,5,0.0%,2h
43923,2,Valentinex,1894,0,0,7,7,0.0%,51m
43923,2,Voykov,1894,0,0,8,8,0.0%,2h
43934,3,Khaled,1893,1065,45,43,88,51.1%,2h
43934,2,yehonatan,1893,732,24,34,58,41.4%,15m
43934,2,castiel,1893,440,19,26,45,42.2%,2h
43934,2,Harveynz,1893,501,17,33,50,34.0%,13m
43934,3,Yoshua,1893,410,16,38,54,29.6%,11m
43934,3,gardoperonos,1893,360,11,19,30,36.7%,2h
43934,3,Parsec,1893,114,8,5,13,61.5%,2h
43934,3,petrigoph,1893,118,4,4,8,50.0%,2h
43934,3,JulioCezar,1893,0,3,2,5,60.0%,30m
43934,3,AresVico,1893,88,3,6,9,33.3%,2m
43934,2,ShadeN,1893,0,1,6,7,14.3%,2h
43934,3,NASFORD,1893,95,1,8,9,11.1%,2h
43934,1,BrokenBonnie,1893,0,0,2,2,0.0%,2h
43934,3,palmisbiglig,1893,0,0,2,2,0.0%,56m
43934,3,yubario,1893,0,0,3,3,0.0%,37m
43934,2,Hezzz,1893,0,0,5,5,0.0%,2h
43934,3,ROX,1893,0,0,6,6,0.0%,2h
43951,3,Kage,1892,1545,59,73,132,44.7%,3m
43951,2,Cosmic,1892,351,32,48,80,40.0%,4m
43951,3,aoeunhtdaoeu,1892,256,12,13,25,48.0%,36m
43951,1,[tSC2LP]Vulcanus,1892,144,6,15,21,28.6%,56m
43951,3,MisticGame,1892,30,3,13,16,18.8%,36m
43951,3,Banana,1892,58,2,2,4,50.0%,30m
43951,3,Emerol,1892,72,2,12,14,14.3%,2h
43951,3,roquevp,1892,30,1,1,2,50.0%,2h
43951,1,GeneralNeral,1892,48,1,6,7,14.3%,2h
43951,3,Syrel,1892,0,0,1,1,0.0%,2h
43951,1,DEYKAN,1892,0,0,1,1,0.0%,52m
43951,3,Pchelovod,1892,0,0,2,2,0.0%,2h
43951,1,engelmann,1892,0,0,2,2,0.0%,2h
43951,3,genk,1892,0,0,3,3,0.0%,37m
43965,3,Exilus,1891,1351,75,68,143,52.4%,43m
43965,3,TLATUANI,1891,947,37,44,81,45.7%,2h
43965,3,Downtown,1891,284,15,15,30,50.0%,26m
43965,3,vinimagus,1891,252,7,13,20,35.0%,2h
43965,1,Luxun,1891,202,6,6,12,50.0%,11m
43965,3,Light,1891,227,6,14,20,30.0%,56m
43965,3,samir,1891,122,3,6,9,33.3%,48m
43965,3,[SC2IDN]Cerebrave,1891,0,1,4,5,20.0%,42m
43965,3,Edward,1891,40,1,7,8,12.5%,34m
43965,2,Melicious,1891,40,1,9,10,10.0%,50m
43965,2,Gwaffs,1891,32,1,9,10,10.0%,2h
43965,3,[HOT69]rawbeartoe,1891,0,0,1,1,0.0%,2h
43965,3,EZEQUIEL,1891,0,0,3,3,0.0%,2h
43965,1,yokutez,1891,0,0,4,4,0.0%,2h
43979,2,Robs,1890,814,30,37,67,44.8%,2h
43979,2,[LeMono]MegaMartin,1890,444,20,19,39,51.3%,22m
43979,1,unavailable,1890,374,12,10,22,54.5%,23m
43979,3,Alcey,1890,305,10,23,33,30.3%,44m
43979,3,Christmas,1890,282,9,7,16,56.2%,6m
43979,3,Tunechi,1890,140,6,3,9,66.7%,11m
43979,3,[lKEl]CptCrunch,1890,177,5,12,17,29.4%,41m
43979,3,Lex,1890,120,4,10,14,28.6%,2h
43979,2,Srar,1890,156,3,9,12,25.0%,2h
43979,3,stevennoph,1890,30,2,0,2,100.0%,12m
43979,3,paulomenega,1890,58,2,1,3,66.7%,37m
43979,3,MAGOOFOO,1890,58,2,2,4,50.0%,9m
43979,2,kuro,1890,58,2,9,11,18.2%,25m
43979,3,TunaGina,1890,0,1,1,2,50.0%,34m
43979,3,KCASI,1890,0,0,1,1,0.0%,2h
43979,3,Furious,1890,0,0,1,1,0.0%,37m
43995,3,alexgamer,1889,972,38,40,78,48.7%,43m
43995,1,TheMcPeanut,1889,308,12,13,25,48.0%,2h
43995,3,Blessaim,1889,238,12,15,27,44.4%,47m
43995,2,keki,1889,186,8,13,21,38.1%,2h
43995,3,PROVENMLG,1889,152,6,12,18,33.3%,6m
43995,3,Verds,1889,150,5,7,12,41.7%,3m
43995,2,Exterminator,1889,94,3,7,10,30.0%,15m
43995,3,EzGunZ,1889,0,0,1,1,0.0%,2h
43995,3,francescusco,1889,0,0,6,6,0.0%,3h
43995,2,[Sp3c2]MEANGREEN,1889,0,0,7,7,0.0%,51m
44005,2,SgtStiffy,1888,1481,108,131,239,45.2%,2h
44005,3,SummerPrince,1888,1334,53,49,102,52.0%,6m
44005,2,kanyma,1888,932,35,47,82,42.7%,2h
44005,1,HardyGV,1888,883,30,45,75,40.0%,5m
44005,3,MrEisme,1888,538,23,22,45,51.1%,2h
44005,3,Simp,1888,579,21,32,53,39.6%,16m
44005,1,[cluez]Maquinakill,1888,259,6,12,18,33.3%,2h
44005,2,[CRBK]sombracr,1888,218,6,14,20,30.0%,37m
44005,2,Nayrhaon,1888,60,4,9,13,30.8%,26m
44005,2,Titanclaw,1888,30,2,9,11,18.2%,2h
44005,3,bowes,1888,0,0,2,2,0.0%,2h
44005,3,Smegmazilla,1888,0,0,2,2,0.0%,2h
44017,2,SeekNDestroy,1887,1585,172,186,358,48.0%,50m
44017,3,KUMITA,1887,1179,46,51,97,47.4%,3m
44017,1,Birdman,1887,280,11,26,37,29.7%,53m
44017,2,SHAGUI,1887,160,6,18,24,25.0%,2h
44017,3,ketch,1887,0,0,1,1,0.0%,9m
44017,3,Shoggoth,1887,0,0,7,7,0.0%,34m
44017,2,Lyth,1887,0,0,7,7,0.0%,15m
44024,3,evertdan,1886,1539,56,70,126,44.4%,2h
44024,2,QUACK,1886,1372,50,64,114,43.9%,2h
44024,3,Audiochild,1886,340,12,7,19,63.2%,56m
44024,3,Hecatonquiro,1886,143,11,14,25,44.0%,37m
44024,3,assmunch,1886,322,11,16,27,40.7%,2h
44024,1,RahSizzle,1886,385,10,23,33,30.3%,2h
44024,3,[CmrK]Sigfrido,1886,228,9,8,17,52.9%,2h
44024,2,CallMeLez,1886,304,9,17,26,34.6%,2h
44024,3,Zyron,1886,246,7,8,15,46.7%,41m
44024,3,[SORSC]leon,1886,149,4,6,10,40.0%,2h
44024,2,Pogz,1886,119,4,7,11,36.4%,2h
44024,2,Mirt,1886,166,4,11,15,26.7%,31m
44024,1,HazeOne,1886,136,4,13,17,23.5%,2h
44024,3,Anarchy,1886,0,0,4,4,0.0%,12m
44038,1,Reever,1885,1593,190,218,408,46.6%,3h
44038,3,salladboy,1885,406,14,23,37,37.8%,2h
44038,1,JimReinor,1885,140,6,9,15,40.0%,2h
44038,2,tadenaikwo,1885,143,5,9,14,35.7%,2h
44038,1,taignacio,1885,58,3,11,14,21.4%,2h
44038,3,jeffybobhead,1885,0,0,1,1,0.0%,2h
44038,2,THERUSSIAN,1885,0,0,2,2,0.0%,2h
44038,2,[Wehavu]VJFlow,1885,0,0,7,7,0.0%,49m
44046,2,[Cannel]KelayrChanel,1884,598,22,32,54,40.7%,3h
44046,3,RoCky,1884,596,20,34,54,37.0%,31m
44046,3,Fury,1884,280,18,19,37,48.6%,6m
44046,2,NahueKiller,1884,369,13,23,36,36.1%,28m
44046,3,ricP,1884,234,8,12,20,40.0%,43m
44046,3,archagels,1884,162,6,11,17,35.3%,2h
44046,1,KurtMcGirt,1884,96,3,10,13,23.1%,50m
44046,3,SpoknDstrctn,1884,58,2,3,5,40.0%,2h
44046,1,Dalloriam,1884,48,2,10,12,16.7%,2h
44046,3,CargoPaladin,1884,0,1,2,3,33.3%,2h
44046,2,jthedestroyr,1884,30,1,8,9,11.1%,7m
44046,3,nixonbowling,1884,0,0,3,3,0.0%,42m
44046,3,DIEGOVILLCA,1884,0,0,4,4,0.0%,2h
44046,1,HIKARU,1884,0,0,6,6,0.0%,3h
44060,3,Gini,1883,1584,105,117,222,47.3%,2h
44060,3,Fastball,1883,305,9,17,26,34.6%,2h
44060,1,[CrLine]benja,1883,156,7,25,32,21.9%,2m
44060,3,[SC2IDN]JackSparroww,1883,188,6,11,17,35.3%,2h
44060,3,Ton,1883,60,3,7,10,30.0%,48m
44060,1,Borko,1883,97,2,9,11,18.2%,26m
44060,2,SneakyTurtle,1883,30,1,7,8,12.5%,2h
44060,2,CoderNate,1883,30,1,8,9,11.1%,43m
44060,1,LayGr,1883,0,1,9,10,10.0%,32m
44069,3,Oscar,1882,1078,43,52,95,45.3%,2m
44069,3,syncmasterr,1882,880,29,38,67,43.3%,2h
44069,2,Paul,1882,86,10,20,30,33.3%,2h
44069,3,Ndrsxd,1882,142,5,4,9,55.6%,2h
44069,3,[GayAF]TyFighterGuy,1882,30,1,1,2,50.0%,30m
44074,2,AngusChen,1881,1488,62,86,148,41.9%,2h
44074,2,AltFfour,1881,619,22,33,55,40.0%,2h
44074,1,AlphaDavis,1881,195,7,17,24,29.2%,29m
44074,3,[WWWOLV]ALVARO,1881,60,3,3,6,50.0%,43m
44074,3,[VETS]Venom,1881,98,3,4,7,42.9%,2h
44074,3,ZARATRAS,1881,0,1,0,1,100.0%,2h
44074,3,[FireNB]DarkEvil,1881,0,1,0,1,100.0%,23m
44074,3,[EvnKrg]Aigis,1881,0,1,1,2,50.0%,3m
44074,1,jimi,1881,97,1,2,3,33.3%,2h
44074,3,maykel,1881,96,1,2,3,33.3%,2h
44074,3,RaysDtoy,1881,0,1,5,6,16.7%,55m
44074,2,JavierLOGO,1881,95,1,9,10,10.0%,35m
44074,3,GammaStar,1881,0,0,1,1,0.0%,2h
44074,3,DarkAngel,1881,0,0,4,4,0.0%,3m
44074,2,Salbhen,1881,0,0,4,4,0.0%,2h
44074,3,RhA,1881,0,0,5,5,0.0%,2h
44074,2,PeluchinSR,1881,0,0,8,8,0.0%,34m
44091,3,xZx,1880,1543,173,187,360,48.1%,2h
44091,3,Bonnox,1880,1522,167,249,416,40.1%,30m
44091,3,[SC13]AKRHO,1880,1136,40,52,92,43.5%,37m
44091,2,Flow,1880,794,31,46,77,40.3%,2h
44091,2,BluePheasant,1880,401,28,27,55,50.9%,2h
44091,2,PretorIvan,1880,730,26,40,66,39.4%,2h
44091,1,Agustin,1880,178,6,14,20,30.0%,3m
44091,3,ZerGUseR,1880,130,5,4,9,55.6%,44m
44091,2,SonofJa,1880,147,5,7,12,41.7%,48m
44091,3,Fluid,1880,58,4,6,10,40.0%,3m
44091,1,IIIlllIII,1880,142,4,14,18,22.2%,29m
44091,3,AMragley,1880,90,3,5,8,37.5%,44m
44091,2,KCRanger,1880,25,2,9,11,18.2%,40m
44091,3,Christopher,1880,0,1,1,2,50.0%,3m
44091,3,SUCIODAN,1880,0,0,1,1,0.0%,2h
44091,3,[Collos]karax,1880,0,0,1,1,0.0%,2h
44107,2,protossdiva,1879,1486,82,91,173,47.4%,2h
44107,3,Letholdus,1879,1310,66,72,138,47.8%,3m
44107,2,GianVJ,1879,1257,42,58,100,42.0%,53m
44107,2,jusn,1879,438,14,26,40,35.0%,25m
44107,3,Martantovic,1879,89,4,9,13,30.8%,3m
44107,3,ahorn,1879,121,3,0,3,100.0%,11m
44107,3,MaineCentral,1879,30,3,3,6,50.0%,1h
44107,3,galneryus,1879,30,1,3,4,25.0%,2h
44107,2,Heathcliff,1879,92,1,3,4,25.0%,37m
44107,3,LilyPrism,1879,0,1,5,6,16.7%,1m
44107,1,mewtho,1879,0,1,8,9,11.1%,2h
44107,2,Antilochus,1879,0,0,3,3,0.0%,48m
44107,3,cronos,1879,0,0,6,6,0.0%,2h
44107,3,Skipperf,1879,0,0,6,6,0.0%,3m
44121,3,Nightshade,1878,1540,388,441,829,46.8%,2h
44121,2,Mmadmax,1878,592,26,32,58,44.8%,22m
44121,2,charlie,1878,329,12,18,30,40.0%,22m
44121,2,Embalmer,1878,238,10,23,33,30.3%,2h
44121,3,TheBiasPious,1878,220,9,8,17,52.9%,2h
44121,3,Patrick,1878,124,3,1,4,75.0%,2h
44121,3,[BeTaPi]Frosty,1878,86,3,4,7,42.9%,3m
44121,2,Walkinz,1878,42,3,15,18,16.7%,34m
44121,1,Chas,1878,118,2,4,6,33.3%,54m
44121,1,CaptainLuke,1878,92,2,6,8,25.0%,2h
44121,3,PONYO,1878,0,1,2,3,33.3%,2h
44121,3,Brainfeeder,1878,0,0,1,1,0.0%,3h
44121,3,Wolf,1878,0,0,2,2,0.0%,47m
44134,2,BigBasement,1877,1365,55,67,122,45.1%,2h
44134,2,[PNF4L]DosDuMuni,1877,172,22,28,50,44.0%,38m
44134,3,RazAlGhul,1877,397,16,7,23,69.6%,31m
44134,3,DEATHºKNIGHT,1877,0,3,5,8,37.5%,2h
44134,3,[NEW]RUAZIO,1877,60,2,9,11,18.2%,2h
44134,3,skizzll,1877,0,1,3,4,25.0%,45m
44134,3,DJones,1877,0,0,1,1,0.0%,3h
44141,3,INGRICHARD,1876,556,19,21,40,47.5%,12m
44141,2,fishwrangler,1876,446,16,23,39,41.0%,42m
44141,3,KRAMPHUS,1876,359,11,20,31,35.5%,3m
44141,3,carlos,1876,289,10,8,18,55.6%,4m
44141,3,hokagesiete,1876,254,9,14,23,39.1%,41m
44141,3,MinuteMan,1876,111,5,8,13,38.5%,2h
44141,3,AnthoGmaerOP,1876,118,4,5,9,44.4%,2h
44141,2,Domador,1876,0,3,5,8,37.5%,25m
44141,2,QuekQuek,1876,60,3,8,11,27.3%,2h
44141,2,YANAHUMA,1876,0,2,7,9,22.2%,2h
44141,2,[KRY]Zazu,1876,138,2,8,10,20.0%,28m
44141,3,rodri,1876,0,0,1,1,0.0%,2h
44141,3,Temmie,1876,0,0,1,1,0.0%,56m
44141,3,danielkcool,1876,0,0,5,5,0.0%,2h
44155,1,hilltopbumer,1875,269,45,58,103,43.7%,48m
44155,3,jume,1875,910,33,40,73,45.2%,3m
44155,3,Atelk,1875,862,30,41,71,42.3%,2h
44155,3,Extreme,1875,314,10,12,22,45.5%,42m
44155,3,SonicWb,1875,144,9,2,11,81.8%,55m
44155,3,DAVICKO,1875,58,3,6,9,33.3%,43m
44155,3,[Elys]Speedfoot,1875,30,2,2,4,50.0%,2h
44155,3,supernaught,1875,118,2,10,12,16.7%,41m
44155,3,naspali,1875,0,0,1,1,0.0%,36m
44155,2,SavageDraco,1875,0,0,6,6,0.0%,2h
44165,3,[GTHS]eddy,1874,1443,57,53,110,51.8%,2h
44165,3,[RTY]CrookeD,1874,240,8,5,13,61.5%,2h
44165,3,SOXENATOR,1874,154,5,8,13,38.5%,6m
44165,3,ItZwar,1874,175,4,3,7,57.1%,2h
44165,3,drake,1874,173,4,4,8,50.0%,36m
44165,1,Glaurung,1874,122,4,13,17,23.5%,26m
44165,2,Paul,1874,0,1,0,1,100.0%,2h
44165,3,Zerocool,1874,0,0,2,2,0.0%,2h
44165,3,PastorM,1874,0,0,4,4,0.0%,2h
44174,3,MarcSanty,1873,764,29,31,60,48.3%,2h
44174,3,TravBrack,1873,93,5,3,8,62.5%,2h
44174,3,Protoss,1873,198,5,13,18,27.8%,2h
44174,3,TheSandMan,1873,148,4,5,9,44.4%,36m
44174,3,BloodyHands,1873,90,3,9,12,25.0%,2h
44174,2,Allenon,1873,46,2,1,3,66.7%,34m
44174,3,RandomGaming,1873,62,2,4,6,33.3%,2h
44174,1,[FltBat]JOEY,1873,46,1,6,7,14.3%,2h
44174,3,Shelson,1873,0,0,1,1,0.0%,1m
44174,3,renzio,1873,0,0,2,2,0.0%,2h
44174,3,jaeson,1873,0,0,2,2,0.0%,2h
44185,2,Ittog,1872,1519,91,99,190,47.9%,2h
44185,2,ccta,1872,1539,90,120,210,42.9%,2h
44185,3,Andrew,1872,1330,88,103,191,46.1%,36m
44185,3,Mdbcash,1872,1400,55,72,127,43.3%,40m
44185,3,TeDeScO,1872,1276,50,61,111,45.0%,2h
44185,3,[BDEA]frdsfrds,1872,1069,39,40,79,49.4%,3m
44185,3,Ninstromos,1872,283,19,15,34,55.9%,48m
44185,1,devank,1872,398,13,25,38,34.2%,2h
44185,3,Krathos,1872,258,9,6,15,60.0%,26m
44185,3,Fabrizio,1872,143,8,1,9,88.9%,2h
44185,3,HardyBrown,1872,149,8,11,19,42.1%,11m
44185,2,Ploxxjoob,1872,44,1,1,2,50.0%,35m
44185,2,mark,1872,30,1,9,10,10.0%,2h
44185,3,VitoSpade,1872,0,0,1,1,0.0%,2h
44199,3,Ordebryt,1871,1513,110,110,220,50.0%,2h
44199,3,diark,1871,1531,69,84,153,45.1%,2h
44199,2,Peter,1871,1106,45,51,96,46.9%,2h
44199,3,YaMi,1871,903,37,46,83,44.6%,2h
44199,1,infoattack,1871,115,3,2,5,60.0%,2h
44199,3,MrPeace,1871,38,3,2,5,60.0%,37m
44199,2,HARVEY,1871,44,2,1,3,66.7%,32m
44199,3,FireStrork,1871,58,2,5,7,28.6%,43m
44199,2,krampus,1871,46,2,7,9,22.2%,2h
44199,3,Noe,1871,0,1,2,3,33.3%,2h
44199,3,Yukone,1871,0,0,1,1,0.0%,13m
44199,2,SnoopWason,1871,0,0,5,5,0.0%,43m
44199,3,[Grim3]Sychronolai,1871,0,0,6,6,0.0%,3m
44212,2,RAMDYA,1870,1303,179,218,397,45.1%,2h
44212,3,nikolas,1870,1371,49,69,118,41.5%,36m
44212,1,Pedorrizila,1870,300,11,19,30,36.7%,2h
44212,3,Beto,1870,178,8,10,18,44.4%,17m
44212,1,ShadowDragon,1870,213,6,14,20,30.0%,13m
44212,3,[Zil]blanket,1870,58,3,4,7,42.9%,2h
44212,1,DrDelete,1870,96,1,1,2,50.0%,2h
44212,3,satansss,1870,30,1,2,3,33.3%,2h
44212,3,Jhamir,1870,0,1,5,6,16.7%,2h
44212,3,ZeRo,1870,0,0,2,2,0.0%,2h
44222,3,Kojimatsu,1869,601,23,25,48,47.9%,3m
44222,3,Hako,1869,201,8,7,15,53.3%,2h
44222,3,Bigboogy,1869,60,4,10,14,28.6%,23m
44222,1,SAMYQC,1869,48,2,2,4,50.0%,53m
44222,3,Booobooobear,1869,0,0,1,1,0.0%,2h
44222,3,RawStick,1869,0,0,2,2,0.0%,13m
44222,3,[CoVid]kfred,1869,0,0,2,2,0.0%,2h
44222,2,darkside,1869,0,0,3,3,0.0%,7m
44230,1,andy,1868,529,39,56,95,41.1%,54m
44230,3,RedneckGamer,1868,675,24,25,49,49.0%,42m
44230,3,spartan,1868,504,20,21,41,48.8%,39m
44230,3,[FyBs]koryluke,1868,378,14,15,29,48.3%,31m
44230,2,cristian,1868,198,7,14,21,33.3%,47m
44230,3,JEANDY,1868,141,4,5,9,44.4%,2h
44230,2,Banishalol,1868,92,4,10,14,28.6%,2h
44230,2,sam,1868,126,3,11,14,21.4%,16m
44230,3,Aldoapache,1868,122,2,2,4,50.0%,36m
44230,2,rip,1868,88,2,6,8,25.0%,2h
44230,3,[PAICHE]Deathmask,1868,97,1,2,3,33.3%,1h
44230,3,[TSCS]DrachirMist,1868,0,0,1,1,0.0%,2h
44242,2,Dark,1867,1439,112,143,255,43.9%,2h
44242,3,CosmicPanda,1867,1054,39,50,89,43.8%,42m
44242,3,SmerdyDoee,1867,596,39,51,90,43.3%,24m
44242,3,DeathStar,1867,314,12,18,30,40.0%,3m
44242,3,yoona,1867,193,5,2,7,71.4%,2h
44242,3,eagleselfs,1867,163,4,5,9,44.4%,2h
44242,1,[KGH3]HoneyBadger,1867,97,4,8,12,33.3%,2h
44242,2,CCMaster,1867,62,2,1,3,66.7%,36m
44242,3,[CR1]TikoKiller,1867,30,2,3,5,40.0%,39m
44242,3,JDiaz,1867,129,2,6,8,25.0%,3m
44252,1,Kpi,1866,1044,33,53,86,38.4%,17m
44252,3,Falcon,1866,97,1,2,3,33.3%,3m
44252,3,NIN,1866,0,1,4,5,20.0%,1m
44252,2,BUCACCE,1866,0,0,1,1,0.0%,2h
44252,3,sqerela,1866,0,0,1,1,0.0%,3h
44252,2,Jim,1866,0,0,7,7,0.0%,2h
44258,3,Schward,1865,213,17,14,31,54.8%,43m
44258,3,Kriztian,1865,435,15,23,38,39.5%,1h
44258,2,JWMURILLO,1865,314,11,22,33,33.3%,10m
44258,3,Loadedfist,1865,210,6,5,11,54.5%,45m
44258,1,Ethan,1865,239,4,16,20,20.0%,52m
44258,2,STUKOV,1865,136,3,7,10,30.0%,33m
44258,1,phaedrus,1865,0,2,14,16,12.5%,54m
44258,3,Ariki,1865,30,1,4,5,20.0%,47m
44258,2,valerii,1865,88,1,6,7,14.3%,2h
44258,2,Shadow,1865,0,0,2,2,0.0%,43m
44258,3,Kleatroz,1865,0,0,2,2,0.0%,56m
44258,3,iboostyou,1865,0,0,5,5,0.0%,1m
44270,2,YashoLMAo,1864,236,11,14,25,44.0%,2h
44270,3,Medinaosp,1864,322,11,20,31,35.5%,40m
44270,2,KennyLR,1864,264,9,16,25,36.0%,7m
44270,3,Nappy,1864,160,5,13,18,27.8%,9m
44270,2,UseLesS,1864,185,3,7,10,30.0%,3h
44270,1,Renegade,1864,46,2,8,10,20.0%,52m
44270,2,USchana,1864,0,1,1,2,50.0%,24m
44270,3,killerboynow,1864,30,1,6,7,14.3%,2h
44270,3,TopWop,1864,0,0,5,5,0.0%,2h
44279,2,Juice,1863,1345,53,56,109,48.6%,2h
44279,3,boredtodeath,1863,391,15,15,30,50.0%,56m
44279,3,Alphareaver,1863,356,13,12,25,52.0%,2m
44279,3,Samoht,1863,195,5,6,11,45.5%,17m
44279,3,salizar,1863,30,1,1,2,50.0%,2h
44279,3,joshiboi,1863,0,1,4,5,20.0%,46m
44279,3,juanedu,1863,0,0,1,1,0.0%,2h
44279,3,AnarchistOwl,1863,0,0,6,6,0.0%,47m
44287,3,ckcapt,1862,1128,41,67,108,38.0%,48m
44287,3,KimJongIl,1862,88,4,7,11,36.4%,47m
44287,3,TheClone,1862,123,2,5,7,28.6%,2h
44287,2,mirid,1862,0,2,8,10,20.0%,2h
44287,1,FernandoMan,1862,0,2,11,13,15.4%,2h
44287,3,Vystyk,1862,0,1,5,6,16.7%,1h
44287,2,Foodle,1862,0,1,9,10,10.0%,7m
44287,3,hardyye,1862,0,0,1,1,0.0%,37m
44287,3,Samboelpatro,1862,0,0,2,2,0.0%,2h
44287,1,Koj,1862,0,0,3,3,0.0%,2h
44297,2,Zhef,1861,209,319,425,744,42.9%,11m
44297,3,ricARD,1861,1070,36,53,89,40.4%,2h
44297,1,SEAN,1861,604,20,33,53,37.7%,2h
44297,3,[Chihui]kuto,1861,576,20,33,53,37.7%,40m
44297,3,Noobie,1861,226,6,4,10,60.0%,2h
44297,3,fenixalfa,1861,119,4,4,8,50.0%,56m
44297,3,Squishy,1861,116,4,5,9,44.4%,2h
44297,3,Ddysbbygirl,1861,32,3,8,11,27.3%,2h
44297,2,zabu,1861,88,3,10,13,23.1%,55m
44297,3,SUNMI,1861,30,2,0,2,100.0%,2h
44297,1,McFly,1861,0,1,5,6,16.7%,19m
44297,1,Cthulhu,1861,0,0,1,1,0.0%,2h
44309,3,joe,1860,1284,68,84,152,44.7%,2h
44309,3,Kevin,1860,1397,63,71,134,47.0%,2h
44309,3,DOOMZDAY,1860,686,26,27,53,49.1%,36m
44309,2,Cfster,1860,645,21,34,55,38.2%,2h
44309,3,TUTERROR,1860,289,14,7,21,66.7%,2h
44309,3,Sleigher,1860,271,9,16,25,36.0%,3m
44309,2,LeonCatsky,1860,160,7,7,14,50.0%,2h
44309,3,Alukard,1860,202,7,8,15,46.7%,17m
44309,3,Jdenim,1860,90,6,5,11,54.5%,2h
44309,3,Zapletal,1860,0,3,2,5,60.0%,2h
44309,3,panchuline,1860,48,2,4,6,33.3%,37m
44309,3,Harkli,1860,0,0,2,2,0.0%,2h
44309,3,Elius,1860,0,0,3,3,0.0%,2h
44309,1,BeBrave,1860,0,0,3,3,0.0%,53m
44309,2,[MUSC]timkshotme,1860,0,0,4,4,0.0%,2h
44324,3,kirek,1859,1585,65,80,145,44.8%,2h
44324,3,Fratini,1859,748,26,26,52,50.0%,2h
44324,3,CaptainXero,1859,324,12,11,23,52.2%,2h
44324,1,excorpion,1859,94,5,12,17,29.4%,14m
44324,3,Colbkilla,1859,119,3,0,3,100.0%,2h
44324,3,Bromantana,1859,88,3,5,8,37.5%,2h
44324,3,Lotso,1859,0,1,0,1,100.0%,20m
44324,3,Neutron,1859,0,1,4,5,20.0%,42m
44324,3,[KGIA]Tassillio,1859,0,1,6,7,14.3%,2h
44324,2,Moronicoscar,1859,0,1,7,8,12.5%,48m
44324,2,aito,1859,30,1,8,9,11.1%,7m
44324,3,daspinsta,1859,0,0,3,3,0.0%,45m
44324,2,Rick,1859,0,0,4,4,0.0%,2h
44337,3,Pure,1858,167,5,7,12,41.7%,17m
44337,3,bigbear,1858,143,4,3,7,57.1%,2h
44337,3,Mark,1858,60,2,5,7,28.6%,30m
44337,2,palturry,1858,44,1,5,6,16.7%,36m
44337,2,Nightstalker,1858,0,0,1,1,0.0%,51m
44342,3,Metformin,1857,564,20,26,46,43.5%,2h
44342,3,jonatasssj,1857,292,11,13,24,45.8%,2h
44342,3,[madas]MaraMay,1857,195,5,7,12,41.7%,43m
44342,3,dno,1857,150,5,8,13,38.5%,17m
44342,2,Josgar,1857,178,3,7,10,30.0%,33m
44342,3,iónmora,1857,30,2,2,4,50.0%,26m
44342,2,sandskee,1857,93,1,6,7,14.3%,2h
44342,1,Boxes,1857,0,0,13,13,0.0%,38m
44350,3,jambo,1856,1488,70,77,147,47.6%,2h
44350,3,rysybel,1856,852,37,38,75,49.3%,2h
44350,3,direrraven,1856,325,13,11,24,54.2%,1h
44350,3,[sweett]SweetTech,1856,250,9,17,26,34.6%,2h
44350,3,REDoSCOUT,1856,188,5,14,19,26.3%,56m
44350,3,Rick,1856,58,4,6,10,40.0%,56m
44350,1,Caleb,1856,30,3,15,18,16.7%,3h
44350,2,MoMo,1856,92,2,2,4,50.0%,35m
44350,3,MSGArmyEd,1856,60,2,4,6,33.3%,2h
44350,3,Ross,1856,0,0,1,1,0.0%,2h
44360,3,Elxim,1855,721,26,30,56,46.4%,56m
44360,3,[FCKAHO]Orin,1855,376,14,13,27,51.9%,2h
44360,3,lightcloud,1855,100,3,1,4,75.0%,2h
44360,2,[EFBI]SecretKing,1855,110,3,3,6,50.0%,2h
44360,2,jibba,1855,175,3,9,12,25.0%,51m
44360,3,JonnyBear,1855,96,2,1,3,66.7%,11m
44366,3,ProYatx,1854,1096,65,68,133,48.9%,11m
44366,3,fatfucck,1854,162,5,5,10,50.0%,44m
44366,3,OfficerBill,1854,94,4,2,6,66.7%,56m
44366,2,tatsumi,1854,143,4,9,13,30.8%,31m
44366,3,dingomama,1854,0,3,3,6,50.0%,2h
44366,2,KaKaShiGo,1854,94,3,11,14,21.4%,2h
44366,3,koroinu,1854,30,2,2,4,50.0%,2h
44366,3,enriched,1854,30,2,3,5,40.0%,2h
44366,3,LeiyeR,1854,0,1,0,1,100.0%,2h
44375,2,GhostDragon,1853,293,20,29,49,40.8%,40m
44375,3,BuseMorose,1853,536,18,24,42,42.9%,1h
44375,2,wongaboo,1853,448,15,23,38,39.5%,2h
44375,2,DossDoss,1853,297,11,22,33,33.3%,2h
44375,3,Skoll,1853,252,8,18,26,30.8%,2h
44375,2,Ykahala,1853,0,3,4,7,42.9%,2h
44375,3,anonimogamer,1853,0,1,0,1,100.0%,39m
44375,3,Motavenger,1853,34,1,7,8,12.5%,6m
44375,3,Scoe,1853,0,0,4,4,0.0%,39m
44384,3,ugottthat,1852,577,30,24,54,55.6%,3m
44384,2,Nightmare,1852,538,16,28,44,36.4%,37m
44384,2,coldamn,1852,386,14,31,45,31.1%,50m
44384,3,Stealthpaw,1852,216,9,11,20,45.0%,2h
44384,3,Richard,1852,88,3,9,12,25.0%,39m
44384,3,IronTalus,1852,58,2,3,5,40.0%,2h
44384,3,RAULSANDOVAL,1852,30,1,4,5,20.0%,26m
44384,1,[XIXVI]VOID,1852,0,1,11,12,8.3%,2h
44384,2,[xSiShx]NASHUA,1852,0,0,5,5,0.0%,2m
44384,3,GoBirdKR,1852,0,0,6,6,0.0%,2h
44394,2,TriAnGle,1851,1562,228,265,493,46.2%,2h
44394,2,DITO,1851,808,47,62,109,43.1%,53m
44394,3,mick,1851,1021,43,55,98,43.9%,11m
44394,2,fisty,1851,626,21,34,55,38.2%,3h
44394,3,GhostPants,1851,412,17,20,37,45.9%,48m
44394,3,Shadow,1851,341,12,16,28,42.9%,2h
44394,3,MarcelitoYT,1851,357,11,14,25,44.0%,2h
44394,3,jerassickpun,1851,0,2,3,5,40.0%,3m
44394,3,Nashira,1851,96,2,7,9,22.2%,2h
44394,2,Kadmus,1851,0,0,1,1,0.0%,43m
44394,2,lDIABLOl,1851,0,0,8,8,0.0%,2h
44405,2,MauiNui,1850,1255,66,73,139,47.5%,2h
44405,3,SonMatheus,1850,942,36,42,78,46.2%,33m
44405,3,RUGAL,1850,904,34,37,71,47.9%,2h
44405,3,SaltyVortex,1850,361,15,17,32,46.9%,2h
44405,3,SCAFER,1850,346,12,16,28,42.9%,2h
44405,2,Fasco,1850,290,11,20,31,35.5%,2h
44405,3,[1Wp]IlIlIlI,1850,58,3,8,11,27.3%,2h
44405,3,Rakem,1850,30,2,5,7,28.6%,2h
44405,1,Djmartinez,1850,0,1,11,12,8.3%,2h
44405,3,[HFD420]GhettoBlues,1850,0,0,2,2,0.0%,2h
44405,3,FraudBiden,1850,0,0,3,3,0.0%,31m
44416,3,Random,1849,641,25,28,53,47.2%,2h
44416,3,VicenteA,1849,382,17,23,40,42.5%,46m
44416,2,Xmas,1849,228,7,28,35,20.0%,2h
44416,3,StAkeouT,1849,94,5,15,20,25.0%,10m
44416,3,LaChinche,1849,146,4,15,19,21.1%,9m
44416,3,[HART]Bhentorck,1849,143,3,3,6,50.0%,2h
44416,2,cat,1849,44,2,3,5,40.0%,43m
44416,3,[Sathus]Sathus,1849,30,1,3,4,25.0%,4m
44416,3,elpaja,1849,0,0,1,1,0.0%,2m
44425,2,Excalibro,1848,514,17,37,54,31.5%,2h
44425,2,SaintCharlie,1848,258,8,20,28,28.6%,2h
44425,3,Joe,1848,90,4,10,14,28.6%,3m
44425,3,RyLo,1848,115,3,0,3,100.0%,2h
44425,3,[HD7K]KNicolas,1848,112,3,5,8,37.5%,17m
44425,2,MrRobot,1848,88,3,7,10,30.0%,56m
44425,3,Kirvo,1848,60,3,7,10,30.0%,2h
44425,3,onaro,1848,58,2,4,6,33.3%,2h
44425,3,Ackbar,1848,30,1,5,6,16.7%,26m
44425,3,[UxL]KingTJ,1848,0,0,2,2,0.0%,31m
44435,3,BradyBones,1847,1558,57,68,125,45.6%,2h
44435,3,Srslol,1847,484,21,18,39,53.8%,2h
44435,3,Axe,1847,331,13,2,15,86.7%,3m
44435,3,Brody,1847,333,13,11,24,54.2%,2h
44435,3,jarmar,1847,310,13,13,26,50.0%,2h
44435,3,noles,1847,344,12,19,31,38.7%,44m
44435,2,Starscream,1847,180,6,12,18,33.3%,37m
44435,2,JoulkerGI,1847,144,3,4,7,42.9%,7m
44435,2,Harry,1847,0,1,1,2,50.0%,34m
44435,3,backfighter,1847,0,0,2,2,0.0%,32m
44435,2,Thralljunior,1847,0,0,7,7,0.0%,2h
44446,2,DoubleJ,1846,1462,92,113,205,44.9%,2h
44446,3,PaddyQ,1846,1604,65,77,142,45.8%,2h
44446,3,Joey,1846,1366,62,83,145,42.8%,40m
44446,1,Daxlager,1846,1154,40,54,94,42.6%,42m
44446,3,Ares,1846,696,24,32,56,42.9%,2h
44446,3,GardianBravo,1846,561,22,20,42,52.4%,41m
44446,3,JJRALLY,1846,304,11,19,30,36.7%,26m
44446,3,warhead,1846,201,9,2,11,81.8%,2h
44446,3,modpra,1846,163,7,3,10,70.0%,30m
44446,3,cristian,1846,167,7,8,15,46.7%,2h
44446,1,TacticZ,1846,150,3,13,16,18.8%,17m
44446,3,Robespierre,1846,30,2,2,4,50.0%,2h
44446,3,mAiNsTreAm,1846,97,1,1,2,50.0%,3m
44446,3,Lickpipps,1846,0,0,1,1,0.0%,2h
44460,3,[foxsay]Fantasy,1845,1029,45,39,84,53.6%,31m
44460,2,TreeSteamer,1845,867,40,40,80,50.0%,53m
44460,3,perez,1845,435,21,19,40,52.5%,2h
44460,3,BigShiny,1845,238,8,12,20,40.0%,24m
44460,1,doonder,1845,307,8,19,27,29.6%,2h
44460,3,Zergking,1845,123,4,4,8,50.0%,2h
44460,3,Learning,1845,133,2,2,4,50.0%,2h
44460,3,Candyman,1845,30,2,7,9,22.2%,2h
44460,3,Ephixa,1845,44,1,1,2,50.0%,3h
44460,3,[HNPro]alexkiller,1845,96,1,3,4,25.0%,9m
44460,2,macabro,1845,0,0,1,1,0.0%,34m
44460,3,vLORDv,1845,0,0,2,2,0.0%,48m
44472,3,Lucifer,1844,1048,52,55,107,48.6%,24m
44472,2,Norman,1844,338,10,17,27,37.0%,38m
44472,3,Bearclaw,1844,294,10,19,29,34.5%,31m
44472,3,EliasJunior,1844,219,7,4,11,63.6%,2h
44472,3,Rizoma,1844,220,6,6,12,50.0%,2h
44472,3,RimmJob,1844,154,4,5,9,44.4%,2h
44472,3,Crackback,1844,30,2,1,3,66.7%,2h
44472,3,ChronoTGK,1844,36,2,8,10,20.0%,12m
44472,2,Valyx,1844,0,1,0,1,100.0%,2h
44472,2,Ares,1844,97,1,4,5,20.0%,2h
44472,3,WhiteSnake,1844,30,1,6,7,14.3%,43m
44472,3,[SL0PPY]SecondsYummy,1844,0,0,1,1,0.0%,2h
44484,3,[cluez]jair,1843,1484,53,62,115,46.1%,17m
44484,3,Fabius,1843,508,40,49,89,44.9%,32m
44484,3,bangzyomama,1843,484,19,20,39,48.7%,2h
44484,3,JESU,1843,289,11,11,22,50.0%,3m
44484,2,SABYSALAS,1843,322,10,21,31,32.3%,4m
44484,3,FXC,1843,239,7,11,18,38.9%,2h
44484,3,INFERNOPRO,1843,0,0,1,1,0.0%,26m
44484,3,bubuwink,1843,0,0,5,5,0.0%,44m
44492,3,[diaman]davA,1842,1004,38,48,86,44.2%,46m
44492,1,loladmin,1842,912,35,50,85,41.2%,2h
44492,3,Samael,1842,618,23,24,47,48.9%,56m
44492,2,Badger,1842,617,21,29,50,42.0%,3m
44492,2,DeCon,1842,320,20,36,56,35.7%,47m
44492,3,DOBERMAN,1842,199,9,11,20,45.0%,2h
44492,3,Stickemup,1842,120,4,8,12,33.3%,48m
44492,3,Alimaña,1842,48,3,6,9,33.3%,42m
44492,3,JuackoWarner,1842,97,1,1,2,50.0%,2h
44501,3,Rupert,1841,1053,38,47,85,44.7%,2h
44501,1,Lilgyboi,1841,615,21,36,57,36.8%,47m
44501,3,MikeRoss,1841,444,19,19,38,50.0%,40m
44501,3,loc,1841,282,11,13,24,45.8%,37m
44501,3,hanok,1841,266,9,15,24,37.5%,43m
44501,3,yerin,1841,223,7,6,13,53.8%,41m
44501,3,rokumimefu,1841,220,7,11,18,38.9%,56m
44501,2,[CaliAi]skywalkerel,1841,137,4,7,11,36.4%,34m
44501,3,[cusco]daniel,1841,0,2,0,2,100.0%,1h
44501,3,carlos,1841,62,2,6,8,25.0%,2h
44501,2,khal,1841,90,1,2,3,33.3%,48m
44501,3,[ThGG]ninjamaximo,1841,0,1,3,4,25.0%,2h
44501,3,Sebastian,1841,0,0,1,1,0.0%,6m
44501,3,NuttyNinja,1841,0,0,1,1,0.0%,2h
44501,3,Paig,1841,0,0,3,3,0.0%,43m
44516,2,bigazer,1840,1412,50,58,108,46.3%,2h
44516,3,Cassius,1840,958,37,48,85,43.5%,41m
44516,2,Stukov,1840,426,34,40,74,45.9%,2h
44516,3,mad,1840,441,19,19,38,50.0%,2h
44516,3,THZRodCoco,1840,380,14,12,26,53.8%,2h
44516,2,Angel,1840,274,9,18,27,33.3%,2h
44516,3,hectorin,1840,176,6,7,13,46.2%,2h
44516,1,alvaro,1840,230,5,16,21,23.8%,2h
44516,3,Leonid,1840,74,4,3,7,57.1%,2h
44516,2,Troegenator,1840,164,4,5,9,44.4%,48m
44516,3,Zavin,1840,0,0,2,2,0.0%,39m
44527,3,feisal,1839,575,85,109,194,43.8%,30m
44527,1,KeeKee,1839,448,11,22,33,33.3%,2h
44527,3,Biscoito,1839,243,9,15,24,37.5%,26m
44527,3,[AFWT]KYLECORBETT,1839,218,8,8,16,50.0%,3m
44527,2,Forza,1839,114,5,11,16,31.2%,53m
44527,3,FarizAja,1839,104,5,21,26,19.2%,30m
44527,3,Jaybles,1839,0,1,4,5,20.0%,2h
44527,1,rodrix,1839,0,1,4,5,20.0%,50m
44527,1,screedle,1839,0,1,8,9,11.1%,49m
44527,2,angelsuper,1839,30,1,9,10,10.0%,2h
44527,1,[RRR]HarambA,1839,0,0,1,1,0.0%,2h
44527,2,baaluu,1839,0,0,1,1,0.0%,2h
44527,3,Aleliv,1839,0,0,1,1,0.0%,2h
44527,1,functionaltk,1839,0,0,1,1,0.0%,2h
44541,1,LUKAS,1838,622,21,43,64,32.8%,25m
44541,3,TheBranman,1838,400,12,24,36,33.3%,2h
44541,3,exilid,1838,304,11,16,27,40.7%,37m
44541,2,LangleyMan,1838,353,11,20,31,35.5%,26m
44541,2,Gameneededme,1838,133,4,17,21,19.0%,2h
44546,1,Daniel,1837,194,6,11,17,35.3%,28m
44546,3,afjanistan,1837,128,3,11,14,21.4%,31m
44546,3,Nave,1837,30,2,3,5,40.0%,4m
44546,3,capalot,1837,0,0,2,2,0.0%,2h
44546,3,Darkrai,1837,0,0,3,3,0.0%,2h
44546,2,[TRUMPP]Farrox,1837,0,0,8,8,0.0%,2h
44552,1,ARTEAGA,1836,1574,49,60,109,45.0%,2h
44552,3,[HYGame]Harster,1836,435,15,21,36,41.7%,44m
44552,3,Guimelo,1836,148,4,12,16,25.0%,41m
44552,1,[cluez]wildran,1836,0,1,0,1,100.0%,9m
44552,3,Zizuar,1836,0,1,1,2,50.0%,9m
44552,3,[YUCK]Bogey,1836,30,1,6,7,14.3%,43m
44552,1,jones,1836,30,1,6,7,14.3%,3h
44552,2,DaWob,1836,0,1,9,10,10.0%,24m
44552,3,Juanjo,1836,0,0,7,7,0.0%,3h
44561,1,NoMercy,1835,1276,136,147,283,48.1%,2h
44561,2,kraken,1835,691,116,128,244,47.5%,2h
44561,3,LoudGasPassr,1835,1541,66,84,150,44.0%,4m
44561,2,Jokio,1835,1315,48,78,126,38.1%,2h
44561,3,Chris,1835,485,20,18,38,52.6%,2h
44561,3,ChineseFox,1835,258,8,13,21,38.1%,2h
44561,2,sauron,1835,154,5,17,22,22.7%,2h
44561,3,KimJongTrill,1835,94,3,15,18,16.7%,33m
44561,3,AceNight,1835,0,1,1,2,50.0%,2h
44561,1,[ANFA]Sierra,1835,48,1,2,3,33.3%,2h
44561,3,lloydxmas,1835,0,0,1,1,0.0%,6m
44572,3,STARLORD,1834,1107,43,45,88,48.9%,2h
44572,3,MikeO,1834,575,29,39,68,42.6%,3m
44572,3,Urgo,1834,670,27,26,53,50.9%,56m
44572,1,Bleasus,1834,724,21,46,67,31.3%,8m
44572,1,MajorPayne,1834,174,5,1,6,83.3%,2h
44572,3,NEYSERG,1834,0,1,1,2,50.0%,57m
44572,3,KPNO,1834,96,1,2,3,33.3%,17m
44572,2,Lilswampton,1834,96,1,9,10,10.0%,2h
44572,3,[FeM2]javico,1834,0,0,1,1,0.0%,2h
44581,3,WarLord,1833,1287,49,53,102,48.0%,2h
44581,3,jansasu,1833,359,13,13,26,50.0%,2h
44581,3,[DriveC]Ster,1833,268,10,12,22,45.5%,26m
44581,3,nero,1833,258,8,17,25,32.0%,48m
44581,3,MarkMactEat,1833,0,0,2,2,0.0%,2h
44586,3,pickpick,1832,1026,89,105,194,45.9%,47m
44586,1,SAMOT,1832,956,30,39,69,43.5%,2h
44586,3,DevAstor,1832,749,28,32,60,46.7%,2m
44586,3,cloudstrife,1832,278,8,10,18,44.4%,2h
44586,3,Xcott,1832,259,7,9,16,43.8%,1h
44586,3,fazesoccerhp,1832,220,6,9,15,40.0%,2h
44586,2,LEVIATHAN,1832,244,6,18,24,25.0%,3m
44586,3,Aiden,1832,30,1,1,2,50.0%,2h
44586,1,EMRE,1832,44,1,4,5,20.0%,2h
44586,1,Spock,1832,73,0,6,6,0.0%,2h
44596,2,[MaxWin]FrozenG,1831,702,39,47,86,45.3%,38m
44596,1,[TILtd]Vaelki,1831,358,10,17,27,37.0%,32m
44596,3,Dalqrod,1831,94,4,5,9,44.4%,40m
44596,2,BYN,1831,46,1,6,7,14.3%,37m
44596,2,Logoto,1831,42,1,9,10,10.0%,2h
44601,3,[HIBOYZ]Pueo,1830,1536,98,120,218,45.0%,44m
44601,3,Tegus,1830,1324,56,59,115,48.7%,11m
44601,1,Wraydar,1830,859,23,25,48,47.9%,2h
44601,1,OspreyPanzer,1830,650,17,9,26,65.4%,3m
44601,3,winterisbs,1830,363,12,11,23,52.2%,47m
44601,2,Umm,1830,286,10,20,30,33.3%,2h
44601,1,SorAnaIsBack,1830,282,9,26,35,25.7%,3h
44601,2,draxerel,1830,129,3,2,5,60.0%,43m
44609,3,SilverGoose,1829,1551,77,78,155,49.7%,2h
44609,3,[Rakau]Rypless,1829,1212,39,62,101,38.6%,9m
44609,3,Eldar,1829,870,36,30,66,54.5%,2h
44609,3,elmatatan,1829,354,14,18,32,43.8%,2h
44609,3,MagnusV,1829,182,6,7,13,46.2%,2h
44609,3,LOBOSALVAJE,1829,196,6,14,20,30.0%,2h
44609,3,MurderChapel,1829,148,3,5,8,37.5%,2h
44609,3,Andy,1829,122,2,3,5,40.0%,2h
44609,1,Evcast,1829,48,2,12,14,14.3%,2h
44609,1,turdmuscular,1829,0,0,1,1,0.0%,54m
44609,1,Sergio,1829,0,0,7,7,0.0%,2h
44609,2,[MMSTAR]Legend,1829,0,0,8,8,0.0%,36m
44621,1,[Pyroz]DARKMATTER,1828,1149,322,338,660,48.8%,2h
44621,2,kain,1828,1518,89,106,195,45.6%,26m
44621,1,BET,1828,251,6,5,11,54.5%,2h
44621,1,anthony,1828,271,5,8,13,38.5%,2h
44621,3,progressor,1828,98,4,7,11,36.4%,2h
44621,3,DopaminE,1828,176,4,14,18,22.2%,32m
44621,3,XMuts,1828,120,3,3,6,50.0%,1h
44621,2,alvaromalca,1828,136,3,6,9,33.3%,7m
44621,2,dimondsoul,1828,36,2,2,4,50.0%,51m
44621,3,Gusttavoo,1828,60,2,6,8,25.0%,2h
44621,1,[Pirobo]Maverick,1828,0,0,1,1,0.0%,53m
44632,2,TotoyTulo,1827,782,79,128,207,38.2%,49m
44632,3,Shadowthrone,1827,862,29,32,61,47.5%,43m
44632,3,[666ale]alejandro,1827,206,7,12,19,36.8%,2h
44632,2,[GrnBrd]DarthBrookes,1827,168,7,18,25,28.0%,34m
44632,2,SolGood,1827,158,5,5,10,50.0%,51m
44632,3,HugoElias,1827,116,4,9,13,30.8%,2h
44632,2,LokDragon,1827,162,3,14,17,17.6%,2h
44632,3,zar,1827,58,2,5,7,28.6%,2h
44632,2,TheChildMan,1827,36,2,9,11,18.2%,51m
44632,2,Snuffels,1827,0,1,9,10,10.0%,2h
44632,3,PaCOson,1827,0,0,2,2,0.0%,2h
44643,3,GoldPlayer,1826,839,32,32,64,50.0%,42m
44643,3,[Relent]THeDestroyer,1826,499,17,28,45,37.8%,4m
44643,3,Tempest,1826,30,2,3,5,40.0%,2h
44643,3,skimbo,1826,0,0,4,4,0.0%,43m
44643,3,Alyap,1826,0,0,5,5,0.0%,17m
44648,2,Sraw,1825,1110,96,117,213,45.1%,40m
44648,3,[Bommmm]Benjamin,1825,883,36,32,68,52.9%,1h
44648,1,CARLO,1825,983,28,31,59,47.5%,2h
44648,3,Viruta,1825,415,19,14,33,57.6%,2h
44648,2,samlar,1825,266,12,21,33,36.4%,2h
44648,3,AromaticOoze,1825,119,2,10,12,16.7%,2h
44648,2,mdilly,1825,30,1,8,9,11.1%,2h
44648,2,DarkProbe,1825,30,1,11,12,8.3%,2h
44648,3,Khan,1825,0,0,2,2,0.0%,28m
44657,3,SniperStadt,1824,1534,99,131,230,43.0%,3m
44657,3,CALIMBO,1824,106,6,6,12,50.0%,6m
44657,3,Rogue,1824,161,6,11,17,35.3%,2h
44657,1,ANoobXD,1824,96,3,2,5,60.0%,29m
44657,2,Makaveli,1824,0,0,8,8,0.0%,2m
44662,2,KingWasabii,1823,1304,47,61,108,43.5%,4m
44662,3,Slayer,1823,650,32,39,71,45.1%,36m
44662,3,JmoBR,1823,648,26,41,67,38.8%,2h
44662,2,Alpha,1823,342,10,19,29,34.5%,2h
44662,3,Areusal,1823,284,9,19,28,32.1%,2h
44662,2,Huplash,1823,124,3,13,16,18.8%,26m
44662,3,[LongD]Chahine,1823,0,0,3,3,0.0%,2h
44662,3,jsrassbai,1823,0,0,3,3,0.0%,56m
44670,3,DudeComeOn,1822,1606,89,124,213,41.8%,24m
44670,3,ParadaGamer,1822,881,30,48,78,38.5%,30m
44670,2,HulaHoop,1822,442,18,19,37,48.6%,53m
44670,3,Keats,1822,332,13,15,28,46.4%,2h
44670,2,ProjectGaia,1822,30,2,8,10,20.0%,34m
44670,1,IlIlIlIlIlIl,1822,0,0,1,1,0.0%,51m
44670,3,[Onward]KingD,1822,0,0,2,2,0.0%,2h
44670,2,Zequel,1822,0,0,5,5,0.0%,24m
44670,1,BlueDream,1822,73,0,7,7,0.0%,46m
44679,2,CMAE,1821,1277,83,93,176,47.2%,16m
44679,1,YandereZero,1821,966,32,45,77,41.6%,2h
44679,3,wes,1821,62,3,5,8,37.5%,37m
44679,3,Cristiano,1821,60,2,13,15,13.3%,48m
44679,1,xxxlinkxxx,1821,0,1,8,9,11.1%,52m
44684,3,IIIIIIIIIII,1820,1382,102,116,218,46.8%,3m
44684,3,aphelion,1820,337,14,17,31,45.2%,41m
44684,3,vampire,1820,248,7,17,24,29.2%,10m
44684,1,Bibsomdi,1820,174,5,1,6,83.3%,2h
44684,1,REKA,1820,48,2,14,16,12.5%,2h
44684,3,Ajax,1820,0,1,4,5,20.0%,2h
44684,3,[1305]Alexander,1820,0,0,2,2,0.0%,56m
44684,3,treyrex,1820,0,0,5,5,0.0%,42m
44692,3,goldeeni,1819,734,31,39,70,44.3%,2h
44692,3,hjakaria,1819,201,6,19,25,24.0%,42m
44692,2,BOKI,1819,96,2,9,11,18.2%,2h
44692,3,LyrialVision,1819,0,1,1,2,50.0%,12m
44692,2,elquesicome,1819,0,0,1,1,0.0%,24m
44697,1,Toto,1818,249,6,17,23,26.1%,2h
44697,3,ironfist,1818,156,6,17,23,26.1%,10m
44697,3,caligreen,1818,179,5,5,10,50.0%,2h
44697,2,Clef,1818,158,4,10,14,28.6%,2h
44697,2,HAVOC,1818,141,3,11,14,21.4%,2h
44697,1,BruceWarn,1818,97,2,11,13,15.4%,2h
44697,3,zin,1818,0,0,4,4,0.0%,1h
44697,2,Midnightiger,1818,0,0,6,6,0.0%,51m
44705,3,gladiator,1817,1128,54,62,116,46.6%,48m
44705,3,hondureño,1817,362,12,21,33,36.4%,46m
44705,2,Kail,1817,290,10,20,30,33.3%,2h
44705,3,Dante,1817,265,9,11,20,45.0%,2h
44705,1,[RomPK3]Jhonny,1817,84,3,4,7,42.9%,2h
44705,1,saramik,1817,0,2,3,5,40.0%,2h
44705,1,BubbaMonk,1817,0,1,1,2,50.0%,44m
44712,3,Fortexodus,1816,496,16,24,40,40.0%,2h
44712,3,mjday,1816,270,9,23,32,28.1%,42m
44712,1,Tarik,1816,178,5,4,9,55.6%,2h
44712,3,debonaiyr,1816,88,5,7,12,41.7%,2h
44712,3,Berserker,1816,122,4,10,14,28.6%,32m
44712,1,SuperSnacc,1816,120,3,7,10,30.0%,2h
44712,1,JeanThiago,1816,0,0,1,1,0.0%,2h
44712,3,Novato,1816,0,0,1,1,0.0%,42m
44712,1,OncomingStrm,1816,0,0,3,3,0.0%,2h
44721,3,Sugar,1815,1138,53,67,120,44.2%,30m
44721,1,ENIGMA,1815,304,10,22,32,31.2%,14m
44721,3,sharkslayer,1815,305,9,22,31,29.0%,3m
44721,3,javier,1815,0,2,5,7,28.6%,2h
44725,1,Emanurl,1814,1952,78,103,181,43.1%,2h
44725,3,CoronaSucks,1814,364,13,24,37,35.1%,39m
44725,1,pirataflow,1814,163,6,9,15,40.0%,2h
44725,3,skullbad,1814,112,5,7,12,41.7%,2h
44725,1,[FTLT]Alfremusic,1814,46,1,2,3,33.3%,2h
44725,1,[mumy]epic,1814,0,0,1,1,0.0%,2h
44725,3,sparkie,1814,0,0,2,2,0.0%,2h
44732,1,Grenadier,1813,1085,31,43,74,41.9%,2h
44732,3,Scubatropin,1813,340,10,12,22,45.5%,2h
44732,3,Stankalank,1813,289,10,19,29,34.5%,2h
44732,2,Vhinzdprinz,1813,218,7,5,12,58.3%,7m
44732,3,[DEVXGG]Ðevx,1813,0,3,5,8,37.5%,41m
44732,1,Sacred,1813,0,0,2,2,0.0%,44m
44732,3,WintorEkbalo,1813,0,0,2,2,0.0%,2h
44739,3,DEGOEL,1812,1585,83,93,176,47.2%,33m
44739,3,Dabcentric,1812,668,22,35,57,38.6%,2h
44739,3,Ender,1812,274,10,19,29,34.5%,2h
44739,2,Lebowski,1812,88,3,11,14,21.4%,37m
44739,3,BHOLTAR,1812,0,0,1,1,0.0%,2h
44739,2,Jarsoft,1812,0,0,6,6,0.0%,24m
44739,3,Slippy,1812,0,0,8,8,0.0%,42m
44746,2,concon,1811,777,265,325,590,44.9%,2h
44746,3,STARKILLER,1811,966,39,40,79,49.4%,2h
44746,3,momo,1811,401,14,26,40,35.0%,3m
44746,3,Dell,1811,256,9,12,21,42.9%,2h
44746,3,sariel,1811,151,7,4,11,63.6%,2h
44746,3,asendedkerri,1811,176,7,13,20,35.0%,6m
44746,3,CucaraChaCha,1811,120,5,8,13,38.5%,2h
44746,2,RiverRift,1811,152,3,13,16,18.8%,10m
44746,2,kered,1811,0,0,5,5,0.0%,2h
44755,2,Riptorz,1810,622,21,33,54,38.9%,2h
44755,1,ArGonX,1810,264,8,6,14,57.1%,51m
44755,2,LocusQS,1810,196,5,10,15,33.3%,17m
44755,3,[1Fenix]lateraluss,1810,122,4,6,10,40.0%,2h
44755,3,Aofermomo,1810,0,0,3,3,0.0%,2h
44760,3,[Over1]nikolo,1809,502,20,21,41,48.8%,37m
44760,1,zarcraft,1809,168,6,15,21,28.6%,28m
44760,3,MHATIUS,1809,149,4,4,8,50.0%,26m
44760,1,GaretJax,1809,136,3,4,7,42.9%,3h
44760,3,[BrassM]SmallChild,1809,0,1,1,2,50.0%,2h
44760,1,Samuraiblue,1809,46,1,3,4,25.0%,54m
44760,1,XxXLuisXxX,1809,0,1,4,5,20.0%,2h
44760,2,SUPERFLAMER,1809,38,1,7,8,12.5%,2h
44760,1,thedark,1809,0,0,1,1,0.0%,2h
44760,2,ccc,1809,0,0,3,3,0.0%,33m
44760,3,wesso,1809,0,0,6,6,0.0%,42m
44771,3,battlepants,1808,1288,99,132,231,42.9%,2h
44771,2,House,1808,420,21,30,51,41.2%,49m
44771,1,SissyFuss,1808,136,3,2,5,60.0%,26m
44771,3,tmwctw,1808,119,2,3,5,40.0%,6m
44771,1,RicoTwinbane,1808,0,1,10,11,9.1%,2h
44771,3,Gengiskant,1808,0,0,7,7,0.0%,48m
44777,3,DeadddHanUwU,1807,422,14,18,32,43.8%,37m
44777,3,monique,1807,359,11,15,26,42.3%,2h
44777,2,HolyDiver,1807,88,2,4,6,33.3%,54m
44777,2,barista,1807,74,2,11,13,15.4%,33m
44777,2,BloodHands,1807,0,1,4,5,20.0%,53m
44777,1,KBELOBR,1807,0,1,6,7,14.3%,2h
44783,3,thefrobo,1806,176,7,8,15,46.7%,2h
44783,1,CodeBar,1806,238,5,6,11,45.5%,44m
44783,1,Jongl,1806,0,1,0,1,100.0%,12m
44783,3,tdbronco,1806,34,1,6,7,14.3%,42m
44783,2,ENDERPRAIS,1806,0,0,1,1,0.0%,7m
44788,2,Tensai,1805,1001,51,77,128,39.8%,50m
44788,3,Zook,1805,653,24,29,53,45.3%,47m
44788,3,Ooggee,1805,313,19,26,45,42.2%,37m
44788,1,RoboPooper,1805,544,13,6,19,68.4%,44m
44788,3,LUKENBACHER,1805,90,13,17,30,43.3%,2h
44788,1,PanaMiguel,1805,242,10,4,14,71.4%,3m
44788,3,ajmal,1805,340,10,29,39,25.6%,17m
44788,3,xxDraGonZxx,1805,105,7,11,18,38.9%,13m
44788,3,zorroxf,1805,60,2,5,7,28.6%,2h
44788,3,VictorJara,1805,0,0,4,4,0.0%,2h
44798,3,AcedRaven,1804,993,34,47,81,42.0%,2h
44798,3,TheCtrl,1804,781,28,38,66,42.4%,2h
44798,1,Blazen,1804,0,4,1,5,80.0%,57m
44798,2,Jcoop,1804,134,3,13,16,18.8%,2h
44798,1,Stephanus,1804,0,1,0,1,100.0%,2h
44798,1,[sENOj]TitanicLuc,1804,0,1,0,1,100.0%,3m
44798,1,enperador,1804,48,1,2,3,33.3%,2h
44798,3,[Klukun]iSandur,1804,0,1,6,7,14.3%,2h
44806,1,Mecanicox,1803,930,25,30,55,45.5%,2h
44806,3,sagitario,1803,367,13,12,25,52.0%,2h
44806,1,FaGEight,1803,297,9,19,28,32.1%,2h
44806,2,DrlSgtSykes,1803,254,8,19,27,29.6%,49m
44806,3,MEMEQBGT,1803,88,3,6,9,33.3%,1h
44806,1,[Colrs]Leafking,1803,48,1,3,4,25.0%,2h
44806,1,smouk,1803,73,0,8,8,0.0%,2h
44813,2,EastTexas,1802,1437,208,244,452,46.0%,50m
44813,3,YANKO,1802,682,24,30,54,44.4%,13m
44813,3,Rasec,1802,497,16,23,39,41.0%,24m
44813,3,qwert,1802,170,5,5,10,50.0%,2h
44813,3,SuperJoker,1802,142,4,4,8,50.0%,3m
44813,3,xenoryt,1802,0,3,3,6,50.0%,2h
44813,3,seanthesheep,1802,0,1,0,1,100.0%,56m
44813,3,Acero,1802,0,0,1,1,0.0%,12m
44813,1,JersonPQ,1802,0,0,1,1,0.0%,2h
44813,3,fredy,1802,0,0,2,2,0.0%,2h
44813,3,Wintermute,1802,0,0,7,7,0.0%,2h
44824,2,Crimental,1801,1369,100,121,221,45.2%,2h
44824,3,[GriZe]TheUnknown,1801,705,41,52,93,44.1%,40m
44824,1,direrraven,1801,952,28,37,65,43.1%,2h
44824,1,raynor,1801,104,5,22,27,18.5%,2h
44824,1,bluntmaster,1801,92,3,3,6,50.0%,2h
44824,3,brax,1801,123,2,8,10,20.0%,1h
44824,1,SueñoPeruano,1801,0,1,11,12,8.3%,2h
44831,3,MauMaloso,1800,1175,54,69,123,43.9%,2h
44831,2,Zeb,1800,1124,43,53,96,44.8%,2h
44831,3,Cybersick,1800,1068,36,50,86,41.9%,39m
44831,3,Guipão,1800,190,7,7,14,50.0%,4m
44831,3,TylerDurden,1800,51,2,11,13,15.4%,2h
44831,1,linguiniboyo,1800,0,1,0,1,100.0%,2h
44831,3,[WOTDL]Raven,1800,0,0,6,6,0.0%,24m
44838,1,Eduardo,1799,741,19,26,45,42.2%,2h
44838,2,Darkstar,1799,476,15,24,39,38.5%,50m
44838,1,KALDANIS,1799,349,10,12,22,45.5%,48m
44838,1,Mimoso,1799,220,5,2,7,71.4%,3m
44838,3,SSSS,1799,112,4,8,12,33.3%,32m
44838,1,DIOGENES,1799,46,2,2,4,50.0%,7m
44838,1,MeBadNoMad,1799,0,1,4,5,20.0%,2h
44845,3,downtiowntra,1798,649,29,38,67,43.3%,30m
44845,3,ALUKAR,1798,384,15,20,35,42.9%,32m
44845,3,GingerSlime,1798,168,4,6,10,40.0%,1h
44845,1,samuelsam,1798,0,3,2,5,60.0%,3h
44845,1,[sanwch]Spud,1798,94,3,15,18,16.7%,57m
44845,1,Lucifer,1798,0,1,0,1,100.0%,51m
44851,1,[EvilGC]DarthSammael,1797,438,10,9,19,52.6%,46m
44851,2,donkaments,1797,218,9,23,32,28.1%,2h
44851,1,atilla,1797,268,6,9,15,40.0%,2h
44851,3,[40Chip]Alec,1797,118,6,9,15,40.0%,41m
44851,2,roastmytoast,1797,156,4,3,7,57.1%,32m
44851,1,KimTaeHyun,1797,46,1,2,3,33.3%,7m
44857,1,Orange,1796,1367,47,56,103,45.6%,27m
44857,3,[Kymer]Thorn,1796,302,10,12,22,45.5%,4m
44857,3,MESTEX,1796,43,2,5,7,28.6%,2h
44857,3,GiantSquid,1796,32,2,5,7,28.6%,3h
44857,2,DarkBios,1796,0,0,1,1,0.0%,7m
44862,3,rEAPER,1795,228,6,7,13,46.2%,2h
44862,1,heroshadow,1795,253,6,12,18,33.3%,50m
44862,3,BRYANT,1795,180,6,20,26,23.1%,2h
44862,3,Ariseph,1795,32,1,1,2,50.0%,42m
44862,1,LuizC,1795,0,0,1,1,0.0%,2h
44862,1,deon,1795,0,0,1,1,0.0%,2h
44862,3,dagger,1795,0,0,1,1,0.0%,2h
44869,2,WAP,1794,540,71,70,141,50.4%,34m
44869,3,[69boyz]billybobBJ,1794,1100,41,48,89,46.1%,2h
44869,3,darrell,1794,981,33,41,74,44.6%,47m
44869,1,HennydaHouse,1794,147,3,3,6,50.0%,2h
44869,3,KBrownie,1794,30,2,4,6,33.3%,56m
44869,1,[CLTrox]Diaboli,1794,0,1,2,3,33.3%,2h
44869,3,MarblesBluff,1794,48,1,2,3,33.3%,42m
44869,2,RayPugh,1794,0,1,4,5,20.0%,43m
44869,1,wizziie,1794,0,0,1,1,0.0%,54m
44878,3,mikahado,1793,963,41,51,92,44.6%,2h
44878,1,TomCat,1793,644,16,11,27,59.3%,38m
44878,2,Manwe,1793,232,9,11,20,45.0%,2h
44878,3,BrightDyed,1793,0,2,4,6,33.3%,6m
44878,3,TheGreekGuy,1793,30,2,9,11,18.2%,2h
44878,1,jsanthony,1793,0,1,1,2,50.0%,52m
44878,1,benbomber,1793,0,1,1,2,50.0%,2h
44878,2,Axse,1793,30,1,10,11,9.1%,22m
44878,3,LittleWolf,1793,0,0,1,1,0.0%,13m
44878,3,ZazBlack,1793,0,0,6,6,0.0%,2h
44878,2,Mattias,1793,0,0,6,6,0.0%,2h
44889,3,YOURMOM,1792,235,15,22,37,40.5%,20m
44889,2,TheiLLtype,1792,210,9,9,18,50.0%,2h
44889,1,Joasab,1792,264,8,10,18,44.4%,2h
44889,1,jackvier,1792,341,7,4,11,63.6%,2h
44889,1,begil,1792,138,7,5,12,58.3%,2h
44889,3,[HGLX]MasterShake,1792,0,2,4,6,33.3%,1m
44889,1,xel,1792,0,0,1,1,0.0%,51m
44896,3,ElGreñas,1791,1207,48,64,112,42.9%,9m
44896,3,TheConcept,1791,296,10,19,29,34.5%,2h
44896,3,dethpunk,1791,241,7,16,23,30.4%,17m
44896,3,Alex,1791,40,1,1,2,50.0%,2h
44900,3,fastfret,1790,615,30,30,60,50.0%,17m
44900,3,BlueAngel,1790,312,13,14,27,48.1%,42m
44900,1,[P00R]Leg,1790,48,1,4,5,20.0%,44m
44900,1,Thebest,1790,0,0,1,1,0.0%,2h
44904,3,Anthromorph,1789,1392,76,88,164,46.3%,45m
44904,3,Shepard,1789,806,39,53,92,42.4%,46m
44904,3,jadiel,1789,392,13,30,43,30.2%,55m
44904,3,BigBadAzza,1789,384,10,24,34,29.4%,32m
44904,2,Karnage,1789,284,7,16,23,30.4%,32m
44904,1,Endlessly,1789,63,2,1,3,66.7%,2h
44904,3,DankMeme,1789,0,2,4,6,33.3%,2h
44904,2,Bob,1789,0,1,8,9,11.1%,2h
44912,3,Franco,1788,1550,104,112,216,48.1%,30m
44912,2,Billymadison,1788,486,87,105,192,45.3%,29m
44912,1,GATO,1788,174,5,2,7,71.4%,23m
44912,3,[franci]francis,1788,0,2,3,5,40.0%,2h
44912,3,Tonkxin,1788,70,2,5,7,28.6%,2h
44912,1,xyruo,1788,46,1,1,2,50.0%,2h
44912,3,[gente]piertrak,1788,48,1,9,10,10.0%,2h
44912,1,Alistrine,1788,0,0,1,1,0.0%,2h
44912,2,bobert,1788,0,0,1,1,0.0%,2h
44912,3,zeke,1788,0,0,4,4,0.0%,2h
44922,1,Dreyksauron,1787,308,8,20,28,28.6%,30m
44922,1,MarineKing,1787,88,2,5,7,28.6%,2h
44924,3,DANLLEL,1786,460,30,42,72,41.7%,9m
44924,2,Aquiles,1786,570,22,36,58,37.9%,49m
44924,2,BabyCakes,1786,384,18,21,39,46.2%,2h
44924,2,Spaceman,1786,283,9,7,16,56.2%,7m
44924,1,[DXPCA]artanis,1786,359,9,14,23,39.1%,38m
44924,1,IIDarkProII,1786,279,7,2,9,77.8%,19m
44924,1,daddydom,1786,296,7,11,18,38.9%,2h
44924,2,Dantor,1786,55,3,3,6,50.0%,2h
44924,3,TheDaniex,1786,30,1,5,6,16.7%,24m
44933,2,Sabroson,1785,361,16,29,45,35.6%,39m
44933,3,bombbomb,1785,272,10,16,26,38.5%,47m
44933,1,siquirunturs,1785,308,8,6,14,57.1%,2h
44933,1,MMarshmallow,1785,228,6,3,9,66.7%,2h
44933,1,GGman,1785,184,5,1,6,83.3%,3h
44933,3,lildrizzle,1785,128,4,13,17,23.5%,57m
44933,2,timhuang,1785,30,1,9,10,10.0%,43m
44933,1,Skuished,1785,0,0,1,1,0.0%,2h
44941,2,Rebel,1784,1005,32,56,88,36.4%,55m
44941,3,master,1784,472,20,28,48,41.7%,2h
44941,1,Carter,1784,412,13,20,33,39.4%,2h
44941,1,TrippIV,1784,0,1,10,11,9.1%,7m
44945,3,imtired,1783,570,45,54,99,45.5%,3m
44945,1,[3pro5u]Andresaurio,1783,624,16,20,36,44.4%,57m
44945,1,Aleksanta,1783,550,14,21,35,40.0%,9m
44945,1,WaterAtTwoAM,1783,363,12,17,29,41.4%,2h
44945,1,Vanic,1783,274,7,7,14,50.0%,31m
44945,1,Pelao,1783,182,5,2,7,71.4%,2h
44945,3,Ibrahim,1783,116,5,7,12,41.7%,2h
44945,3,[Cholm]Warmachine,1783,97,2,4,6,33.3%,2h
44945,3,kenneth,1783,30,1,7,8,12.5%,2h
44945,2,Tarttalo,1783,0,0,9,9,0.0%,28m
44955,3,PlowingUrMOM,1782,1484,73,79,152,48.0%,37m
44955,2,[OD]Xeros,1782,1560,59,84,143,41.3%,37m
44955,3,KYonil,1782,1038,41,47,88,46.6%,2h
44955,2,[NM8]TOXIC,1782,314,9,21,30,30.0%,2h
44955,1,TIM,1782,130,5,4,9,55.6%,38m
44955,1,santi,1782,128,4,10,14,28.6%,3h
44955,1,[ThEnd]Alexander,1782,40,1,2,3,33.3%,46m
44962,1,NickMiller,1781,290,7,11,18,38.9%,3h
44962,1,[AbcCo]ZergDroid,1781,94,3,4,7,42.9%,7m
44962,2,Reaper,1781,86,3,12,15,20.0%,7m
44962,3,NickPar,1781,30,1,6,7,14.3%,2h
44962,3,TheBourgeois,1781,0,0,8,8,0.0%,37m
44967,3,Sierra,1780,1054,46,66,112,41.1%,46m
44967,2,blubberycone,1780,499,24,36,60,40.0%,2h
44967,1,Scapien,1780,393,17,4,21,81.0%,29m
44967,2,zzz,1780,332,10,17,27,37.0%,40m
44967,1,Modster,1780,179,5,4,9,55.6%,2h
44967,1,shadynasty,1780,138,3,4,7,42.9%,32m
44967,1,baltex,1780,92,2,6,8,25.0%,2h
44967,1,Marr,1780,0,1,0,1,100.0%,26m
44967,2,formulated,1780,0,1,1,2,50.0%,52m
44967,1,[RDTN]Robson,1780,0,0,1,1,0.0%,26m
44967,1,theone,1780,0,0,2,2,0.0%,2h
44978,1,MisterX,1779,1626,52,67,119,43.7%,31m
44978,3,FENIXPLAY,1779,254,9,17,26,34.6%,2h
44978,2,martruta,1779,272,8,15,23,34.8%,17m
44978,1,Morkim,1779,152,5,14,19,26.3%,26m
44978,2,ZhT,1779,120,4,12,16,25.0%,43m
44983,3,thebeast,1778,901,62,69,131,47.3%,2h
44983,1,TsaeBLerraF,1778,426,12,14,26,46.2%,2h
44983,3,DarthRaider,1778,215,5,12,17,29.4%,2h
44983,3,reddark,1778,140,4,4,8,50.0%,2h
44983,1,[TMKOs]Jean,1778,130,3,11,14,21.4%,51m
44983,3,[PAROLE]NotGreg,1778,30,1,1,2,50.0%,35m
44989,1,Monking,1777,928,54,80,134,40.3%,2h
44989,3,JAYONE,1777,1070,36,61,97,37.1%,42m
44989,1,Trophycletor,1777,682,18,23,41,43.9%,2h
44989,2,SwampLord,1777,368,12,29,41,29.3%,2h
44989,3,Nawook,1777,239,7,9,16,43.8%,13m
44989,1,jamesfurlano,1777,94,3,3,6,50.0%,2h
44989,3,TAO,1777,0,1,0,1,100.0%,13m
44989,1,Leoparfist,1777,0,0,4,4,0.0%,46m
44997,2,iiiiiiiceman,1776,1517,97,130,227,42.7%,2h
44997,3,[DRKSOU]BusterBrown,1776,1524,79,94,173,45.7%,3m
44997,2,iash,1776,958,33,46,79,41.8%,2h
44997,3,TAOOONE,1776,727,27,30,57,47.4%,3m
44997,2,VGMDETAILR,1776,500,17,33,50,34.0%,2h
44997,3,mutabeast,1776,480,15,31,46,32.6%,2h
44997,1,narra,1776,265,11,9,20,55.0%,2h
44997,3,Darkmatter,1776,289,9,13,22,40.9%,2h
44997,3,SEREDA,1776,58,3,7,10,30.0%,2h
44997,3,Byrne,1776,0,1,1,2,50.0%,2h
44997,3,Boulderdash,1776,38,1,5,6,16.7%,44m
44997,1,gerardouche,1776,0,0,4,4,0.0%,2h
45009,1,MrMojoRisin,1775,295,10,16,26,38.5%,2h
45009,1,bob,1775,0,1,1,2,50.0%,2h
45009,2,TheOne,1775,36,1,4,5,20.0%,52m
45009,2,Meli,1775,0,1,8,9,11.1%,56m
45013,1,Vulpecula,1774,540,14,13,27,51.9%,3m
45013,2,Smoothjazz,1774,217,4,12,16,25.0%,2h
45013,3,KRISG,1774,0,1,5,6,16.7%,44m
45013,1,morgano,1774,73,0,6,6,0.0%,2h
45017,1,swederik,1773,502,12,12,24,50.0%,53m
45017,1,starkid,1773,258,6,5,11,54.5%,30m
45017,3,Woolf,1773,214,6,11,17,35.3%,2h
45017,2,hewel,1773,186,5,16,21,23.8%,2h
45017,3,Metaphorist,1773,44,2,4,6,33.3%,2h
45017,1,DuckySummer,1773,0,0,2,2,0.0%,2h
45023,3,love,1772,1556,59,77,136,43.4%,2h
45023,1,CarlitosFlow,1772,902,24,32,56,42.9%,2h
45023,3,zurdo,1772,214,7,10,17,41.2%,2h
45023,3,Reis,1772,231,6,10,16,37.5%,2h
45023,3,Warlax,1772,122,4,12,16,25.0%,2h
45023,3,TwizzyWizzy,1772,0,0,1,1,0.0%,37m
45023,3,ZugZug,1772,0,0,7,7,0.0%,3m
45030,3,danteTHEfox,1771,629,78,80,158,49.4%,2h
45030,3,CanisLupus,1771,212,6,10,16,37.5%,11m
45032,3,[Emi12]Emiros,1770,184,8,14,22,36.4%,2h
45032,3,Scarlett,1770,0,1,1,2,50.0%,2h
45034,1,Killercat,1769,1079,31,29,60,51.7%,2h
45034,3,[TRPSC]Crid,1769,352,11,19,30,36.7%,3m
45034,2,Moophassa,1769,174,6,16,22,27.3%,10m
45034,3,Showrider,1769,0,0,6,6,0.0%,2h
45038,3,Hoegaarden,1768,1370,70,91,161,43.5%,32m
45038,1,Joshicus,1768,754,22,28,50,44.0%,57m
45038,2,cide,1768,542,22,30,52,42.3%,2h
45038,1,papichulo,1768,716,17,22,39,43.6%,30m
45038,1,NullError,1768,234,8,16,24,33.3%,2h
45038,1,Jekko,1768,284,6,16,22,27.3%,13m
45038,3,shadowsnaxx,1768,70,5,13,18,27.8%,48m
45038,3,EREUSSS,1768,119,4,5,9,44.4%,57m
45038,3,GHOST,1768,58,3,7,10,30.0%,17m
45038,2,JASTAN,1768,102,2,9,11,18.2%,25m
45038,3,Anderson,1768,0,0,1,1,0.0%,13m
45038,2,ASCII,1768,0,0,1,1,0.0%,52m
45050,3,Freya,1767,1123,60,71,131,45.8%,2h
45050,3,stotle,1767,596,24,29,53,45.3%,2h
45050,1,michiberri,1767,376,11,12,23,47.8%,44m
45050,3,madasaim,1767,120,11,22,33,33.3%,2h
45050,1,LFSIUCE,1767,44,2,1,3,66.7%,2h
45055,2,Zaro,1766,254,12,24,36,33.3%,2h
45055,1,AdeSan,1766,312,6,16,22,27.3%,31m
45055,1,AlienSAP,1766,132,4,15,19,21.1%,2h
45055,3,bobalva,1766,0,3,2,5,60.0%,2h
45055,2,SiegfriedKO,1766,0,1,0,1,100.0%,33m
45055,3,ZeratulY,1766,0,0,2,2,0.0%,2h
45055,2,ADUKAN,1766,0,0,9,9,0.0%,32m
45062,3,BigSpoon,1765,1470,142,168,310,45.8%,2h
45062,3,Fergersen,1765,1524,59,63,122,48.4%,31m
45062,3,cocox,1765,224,7,13,20,35.0%,2h
45062,1,[P4RK]BallN,1765,0,0,3,3,0.0%,2h
45062,2,AGgTiger,1765,0,0,7,7,0.0%,34m
45067,3,[NM8]Askywarrior,1764,1030,41,44,85,48.2%,57m
45067,1,Scorpion,1764,1403,40,49,89,44.9%,54m
45067,3,ESTEBAN,1764,763,26,45,71,36.6%,2h
45067,3,Amrak,1764,277,8,14,22,36.4%,2h
45067,3,[IRWT]lowdown,1764,90,5,10,15,33.3%,2h
45067,1,CHERRA,1764,139,3,12,15,20.0%,51m
45067,2,MoreOrLess,1764,95,1,10,11,9.1%,36m
45074,2,Torrescano,1763,1428,121,150,271,44.6%,2h
45074,3,nay,1763,790,25,41,66,37.9%,21m
45076,1,Smokey,1762,1227,38,39,77,49.4%,2h
45076,1,yoaho,1762,427,9,19,28,32.1%,2h
45076,1,JonC,1762,180,7,16,23,30.4%,26m
45076,3,Brnl,1762,136,4,6,10,40.0%,41m
45076,1,Franco,1762,0,1,0,1,100.0%,2h
45076,2,kurono,1762,34,1,12,13,7.7%,2h
45082,3,MoriPai,1761,1470,53,69,122,43.4%,2h
45082,1,[Lp]LpxZLoboZx,1761,384,12,5,17,70.6%,2h
45082,1,Foto,1761,374,11,8,19,57.9%,3m
45082,1,vadoosk,1761,174,5,3,8,62.5%,7m
45082,1,[MaNtaX]diamondred,1761,217,4,8,12,33.3%,52m
45082,1,Grandpaplays,1761,44,2,0,2,100.0%,30m
45082,3,[DNO13]Covfefe,1761,60,2,3,5,40.0%,2h
45082,1,Reality,1761,0,0,1,1,0.0%,29m
45090,2,MEGAEZTRAL,1760,217,5,9,14,35.7%,2m
45090,3,FallenAngel,1760,132,4,12,16,25.0%,40m
45090,2,JONDAL,1760,118,4,15,19,21.1%,48m
45090,1,overlord,1760,44,2,1,3,66.7%,2h
45090,1,FABIOBR,1760,30,2,8,10,20.0%,57m
45090,1,Hyperbolic,1760,0,1,1,2,50.0%,2h
45090,2,Darklord,1760,0,0,1,1,0.0%,2h
45097,1,Shooter,1759,183,9,4,13,69.2%,7m
45097,1,BigDirt,1759,335,9,19,28,32.1%,54m
45097,3,TYCHUS,1759,204,7,13,20,35.0%,3m
45097,3,[DGotO]DalekKahn,1759,70,2,3,5,40.0%,35m
45097,1,pedrolord,1759,48,1,2,3,33.3%,2h
45097,1,SamuraiJack,1759,0,1,4,5,20.0%,30m
45103,1,Knightmare,1758,1230,48,62,110,43.6%,2h
45103,1,SCforLOLZ,1758,1144,37,66,103,35.9%,2h
45103,1,[JTCA]Patina,1758,558,16,11,27,59.3%,2h
45103,3,DIDAK,1758,198,13,13,26,50.0%,2h
45103,1,Charliez,1758,423,12,13,25,48.0%,48m
45103,1,MYLORDMARINE,1758,356,9,7,16,56.2%,2h
45103,1,[CRAKS]zerathul,1758,316,7,7,14,50.0%,2h
45103,2,[84]BrianProtoss,1758,0,0,1,1,0.0%,52m
45103,1,Mediocrity,1758,0,0,1,1,0.0%,26m
45112,3,Stormtrooper,1757,1500,97,148,245,39.6%,2h
45112,3,gab,1757,682,24,39,63,38.1%,4m
45112,3,DrIGN,1757,528,20,28,48,41.7%,2h
45112,3,Mauruxu,1757,539,19,21,40,47.5%,2h
45112,1,killerwaffle,1757,327,17,21,38,44.7%,19m
45112,3,wardog,1757,437,15,33,48,31.2%,2h
45112,2,RoadRunner,1757,70,2,12,14,14.3%,10m
45112,3,MataDioses,1757,0,1,1,2,50.0%,2h
45120,2,[DraG0n]carnage,1756,226,9,19,28,32.1%,2h
45120,2,sandman,1756,32,1,10,11,9.1%,2h
45122,3,Raul,1755,1265,61,84,145,42.1%,2h
45122,1,ZOT,1755,1162,34,39,73,46.6%,7m
45122,3,AhTrini,1755,228,17,33,50,34.0%,37m
45122,2,Tabarnakers,1755,460,15,30,45,33.3%,2h
45122,2,FamilyTime,1755,113,4,7,11,36.4%,45m
45127,3,Dinamicy,1754,1327,97,132,229,42.4%,46m
45127,2,Slyfer,1754,268,9,20,29,31.0%,2h
45127,3,GLAZ,1754,199,8,6,14,57.1%,2h
45127,1,GKMRayden,1754,272,6,8,14,42.9%,28m
45127,1,LESTERMAN,1754,94,2,3,5,40.0%,2h
45132,1,hiroshikun,1753,255,12,16,28,42.9%,2h
45132,1,Bengence,1753,362,9,17,26,34.6%,7m
45132,2,lucascraft,1753,169,4,8,12,33.3%,28m
45132,1,Feenix,1753,86,3,2,5,60.0%,2h
45132,1,Destructor,1753,90,2,4,6,33.3%,2h
45132,2,MONSTARFGLS,1753,60,2,10,12,16.7%,2h
45132,1,JonnManAlfa,1753,0,1,0,1,100.0%,2h
45132,2,CroDoc,1753,36,1,10,11,9.1%,2h
45132,1,Blackape,1753,0,0,1,1,0.0%,2h
45132,3,Tower,1753,0,0,2,2,0.0%,2h
45142,3,UltravisioN,1752,839,87,97,184,47.3%,21m
45142,1,[ttcr]King,1752,126,5,6,11,45.5%,26m
45142,1,LittleJedi,1752,82,2,15,17,11.8%,2h
45142,3,Haltzman,1752,0,1,0,1,100.0%,42m
45142,2,ShadowStorm,1752,30,1,9,10,10.0%,51m
45142,2,Alucardcr,1752,48,1,10,11,9.1%,28m
45142,3,leandro,1752,0,0,2,2,0.0%,2h
45149,2,Titan,1751,108,3,5,8,37.5%,49m
45149,2,Ion,1751,148,3,12,15,20.0%,28m
45149,1,fourdseven,1751,158,3,15,18,16.7%,2h
45149,1,PLOKET,1751,73,1,4,5,20.0%,2h
45149,1,cronoz,1751,0,0,1,1,0.0%,9m
45154,1,alxndr,1750,0,0,6,6,0.0%,2h
45154,1,[ReB3L]nerdaton,1750,73,0,7,7,0.0%,2h
45156,1,GhostDogreal,1749,1946,65,78,143,45.5%,54m
45156,1,HeavyD,1749,180,5,6,11,45.5%,54m
45156,1,vodcat,1749,0,0,2,2,0.0%,2h
45159,2,KARYNA,1748,340,28,45,73,38.4%,2h
45159,2,SourSkittlez,1748,124,7,12,19,36.8%,50m
45159,1,Eldritch,1748,237,7,17,24,29.2%,23m
45159,3,[GDKND]ANGEL,1748,122,6,21,27,22.2%,3m
45159,2,DeanLofi,1748,76,3,11,14,21.4%,2h
45159,1,Gaston,1748,0,0,2,2,0.0%,2h
45165,3,EricFX,1747,798,97,105,202,48.0%,2h
45165,3,Bloodshot,1747,1186,45,54,99,45.5%,2h
45165,1,Masacre,1747,1104,31,33,64,48.4%,2h
45165,3,JoeyLort,1747,419,14,18,32,43.8%,24m
45165,1,neron,1747,46,2,0,2,100.0%,48m
45170,3,Racer,1746,255,25,32,57,43.9%,2h
45170,3,sableye,1746,657,25,36,61,41.0%,49m
45170,3,Victor,1746,319,12,16,28,42.9%,37m
45170,1,boomer,1746,306,10,11,21,47.6%,46m
45170,3,cubo,1746,324,10,13,23,43.5%,17m
45170,3,SANIQUILADOR,1746,100,5,5,10,50.0%,2h
45170,1,Craalb,1746,174,4,10,14,28.6%,2h
45170,3,StarBright,1746,0,3,4,7,42.9%,2h
45170,3,Therion,1746,0,2,6,8,25.0%,57m
45170,1,Buffinator,1746,125,2,9,11,18.2%,2h
45170,1,SebastianYT,1746,0,0,2,2,0.0%,57m
45170,1,[forma]jumpingjacks,1746,73,0,3,3,0.0%,2h
45170,3,shoemaker,1746,0,0,8,8,0.0%,12m
45183,1,Zeno,1745,330,8,9,17,47.1%,12m
45183,3,llllllllllll,1745,0,2,5,7,28.6%,2h
45183,3,TrevorP,1745,36,1,8,9,11.1%,2h
45183,3,JPARK,1745,0,0,1,1,0.0%,2h
45183,1,Powerbenja,1745,0,0,1,1,0.0%,2h
45183,2,[AXIOS]ANANASHAKIM,1745,0,0,10,10,0.0%,2h
45189,1,BuckNekkid,1744,216,6,17,23,26.1%,2h
45189,1,Mikkonnen,1744,96,2,2,4,50.0%,57m
45189,2,CaiquegoesI,1744,0,2,6,8,25.0%,2h
45189,3,jnpascua,1744,36,1,6,7,14.3%,2h
45193,3,xhareman,1743,454,17,23,40,42.5%,2h
45193,3,kilo,1743,126,4,11,15,26.7%,2h
45193,3,[Very]Skyptical,1743,0,1,6,7,14.3%,41m
45196,3,ANUNNAKI,1742,1507,112,116,228,49.1%,41m
45196,1,HyeuN,1742,549,18,26,44,40.9%,23m
45196,3,ninja,1742,290,11,27,38,28.9%,2h
45196,1,angel,1742,48,4,8,12,33.3%,2h
45196,3,Zaine,1742,118,4,12,16,25.0%,2h
45196,2,yungtrace,1742,161,3,13,16,18.8%,7m
45196,3,BPGLON,1742,30,1,1,2,50.0%,1m
45196,1,Korbin,1742,73,1,7,8,12.5%,2h
45204,1,[DeeCeS]Tywolf,1741,854,23,37,60,38.3%,2h
45204,3,MickD,1741,497,18,42,60,30.0%,11m
45204,3,Wheezie,1741,0,3,4,7,42.9%,3h
45204,1,likeastorm,1741,134,3,5,8,37.5%,44m
45204,2,ROINUY,1741,0,1,1,2,50.0%,2h
45209,3,[C10097]Nico,1740,994,33,55,88,37.5%,45m
45209,3,Rudy,1740,86,3,11,14,21.4%,2h
45209,3,marshmellow,1740,72,2,4,6,33.3%,42m
45209,1,SLIPPERUP,1740,0,0,1,1,0.0%,2h
45213,1,Xaqar,1739,1678,56,61,117,47.9%,4m
45213,1,[USWAG]onti,1739,1276,45,75,120,37.5%,3h
45213,1,WickyWoo,1739,1113,35,39,74,47.3%,2h
45213,1,oldtown,1739,946,26,34,60,43.3%,32m
45213,1,[Bommmm]Freddykawai,1739,373,12,18,30,40.0%,2h
45213,3,Riko,1739,221,7,11,18,38.9%,2h
45213,3,asdaichunli,1739,142,7,23,30,23.3%,2h
45213,3,cfrey,1739,154,6,17,23,26.1%,2h
45213,1,Yulian,1739,46,2,13,15,13.3%,2h
45213,1,Bibers,1739,0,0,2,2,0.0%,50m
45223,1,Sefa,1738,83,35,88,123,28.5%,26m
45223,3,OGmnm,1738,533,17,32,49,34.7%,2h
45225,1,Ripster,1737,797,23,27,50,46.0%,29m
45225,1,RanjiroYT,1737,722,18,22,40,45.0%,32m
45225,1,[QCDL]NOX,1737,564,14,22,36,38.9%,2h
45225,1,leounlikeyou,1737,268,7,6,13,53.8%,2h
45225,1,Cienciano,1737,239,6,17,23,26.1%,51m
45225,1,AshPow,1737,74,3,14,17,17.6%,2h
45225,3,detpackz,1737,0,0,1,1,0.0%,13m
45232,2,GGamrrage,1736,458,19,28,47,40.4%,2h
45232,1,fretzcastano,1736,0,3,4,7,42.9%,2h
45232,3,paws,1736,0,2,3,5,40.0%,2h
45232,1,JAIME,1736,42,1,2,3,33.3%,2h
45232,1,Iguana,1736,73,0,7,7,0.0%,2h
45232,3,Jim,1736,0,0,9,9,0.0%,3h
45238,3,alejandro,1735,507,18,28,46,39.1%,32m
45238,1,acegroup,1735,72,3,4,7,42.9%,2h
45238,2,CALAVERA,1735,38,1,2,3,33.3%,2h
45238,3,hypertack,1735,0,0,1,1,0.0%,2h
45238,1,[464]Josper,1735,0,0,2,2,0.0%,31m
45238,2,ManoloPvP,1735,0,0,8,8,0.0%,2h
45244,1,Xnova,1734,207,4,7,11,36.4%,2h
45245,3,YOUNG,1733,1519,74,102,176,42.0%,2h
45245,1,seth,1733,1298,39,40,79,49.4%,2h
45245,1,supremo,1733,779,20,27,47,42.6%,51m
45245,1,Bacoking,1733,222,5,8,13,38.5%,2h
45245,3,lobatos,1733,148,3,13,16,18.8%,2h
45245,1,MSAM,1733,40,1,3,4,25.0%,2h
45245,3,IlIIIlIIIIIl,1733,30,1,6,7,14.3%,21m
45245,3,mateo,1733,0,0,1,1,0.0%,13m
45253,1,NytVulf,1732,1153,40,56,96,41.7%,2h
45253,3,jim,1732,392,25,29,54,46.3%,2h
45253,3,JoshuaChoi,1732,539,21,32,53,39.6%,17m
45253,1,Spock,1732,48,6,1,7,85.7%,2h
45253,3,ZarRocWilOno,1732,120,2,8,10,20.0%,1h
45258,3,ACE,1731,472,15,24,39,38.5%,57m
45258,3,DerekZoger,1731,252,10,27,37,27.0%,2h
45258,1,HARD,1731,48,5,3,8,62.5%,2h
45258,1,[DSGoku]Scream,1731,0,0,1,1,0.0%,57m
45262,2,Squanto,1730,1428,132,152,284,46.5%,39m
45262,3,ZeratuL,1730,1218,77,115,192,40.1%,2h
45262,1,[DarkPG]Ignaciocapo,1730,1535,67,98,165,40.6%,4m
45262,1,[GOPERÚ]TheBest,1730,409,10,23,33,30.3%,2h
45262,1,DaneGRClose,1730,0,2,4,6,33.3%,54m
45267,1,Ostentatious,1729,136,3,7,10,30.0%,2h
45267,2,McCarthy,1729,70,2,13,15,13.3%,2h
45267,1,pexico,1729,0,0,1,1,0.0%,50m
45270,3,AnOldGuy,1728,1522,56,71,127,44.1%,30m
45270,3,Aetroe,1728,120,5,3,8,62.5%,13m
45270,3,Duke,1728,206,5,12,17,29.4%,57m
45270,1,Lorek,1728,0,1,0,1,100.0%,2h
45270,3,ValminX,1728,0,1,1,2,50.0%,13m
45275,3,itachiuchiha,1727,1019,52,71,123,42.3%,39m
45275,1,Fleachi,1727,114,4,14,18,22.2%,51m
45275,1,SonOfGary,1727,142,3,5,8,37.5%,2h
45275,1,xavi,1727,0,1,0,1,100.0%,12m
45275,1,Desertdawg,1727,0,0,1,1,0.0%,44m
45275,1,BeckemKong,1727,0,0,1,1,0.0%,2h
45275,1,[KohShe]Prom,1727,0,0,2,2,0.0%,2h
45282,3,John,1726,200,24,36,60,40.0%,30m
45282,3,Sciolist,1726,402,16,39,55,29.1%,35m
45282,1,injaneer,1726,359,10,12,22,45.5%,2h
45282,3,OfficerUther,1726,96,7,6,13,53.8%,2h
45282,1,captainbigma,1726,0,0,1,1,0.0%,13m
45282,1,jose,1726,0,0,1,1,0.0%,46m
45282,2,Omega,1726,0,0,8,8,0.0%,2h
45289,2,davisa,1725,242,8,17,25,32.0%,2h
45289,1,juanito,1725,178,5,20,25,20.0%,50m
45289,3,SKorn,1725,92,4,9,13,30.8%,1h
45292,2,Verado,1724,482,16,37,53,30.2%,40m
45292,1,SirAnthony,1724,176,4,4,8,50.0%,2h
45292,1,Maagic,1724,117,2,4,6,33.3%,2h
45292,1,SergioXd,1724,0,0,4,4,0.0%,4m
45292,3,SiMutada,1724,0,0,5,5,0.0%,6m
45297,3,strider,1723,1360,82,104,186,44.1%,2h
45297,3,niko,1723,645,24,30,54,44.4%,1h
45297,1,Pred,1723,296,9,16,25,36.0%,12m
45297,3,JKryptic,1723,264,8,22,30,26.7%,40m
45297,1,Radiance,1723,130,5,5,10,50.0%,2h
45297,3,PEDRO,1723,0,0,8,8,0.0%,2h
45303,3,Smoon,1722,32,1,2,3,33.3%,2h
45304,3,BurntorangeX,1721,1515,121,136,257,47.1%,2h
45304,3,jahwarrior,1721,1300,47,64,111,42.3%,2h
45304,3,TITAN,1721,341,17,29,46,37.0%,2h
45304,1,ThFrshDahlia,1721,513,14,18,32,43.8%,2h
45304,3,[RSC2]Zerathul,1721,122,5,12,17,29.4%,2h
45304,3,martino,1721,173,4,10,14,28.6%,2h
45304,2,Tristen,1721,48,1,9,10,10.0%,54m
45311,2,poultry,1720,964,34,48,82,41.5%,2h
45311,3,[PLUNG]commanderdat,1720,212,7,12,19,36.8%,2h
45311,3,JMCKILA,1720,86,4,10,14,28.6%,39m
45311,1,[BoBSti]ElPrincident,1720,163,3,6,9,33.3%,2h
45311,3,Alex,1720,95,2,5,7,28.6%,2h
45316,3,Oswen,1719,70,2,7,9,22.2%,7m
45316,1,jonathan,1719,0,1,2,3,33.3%,2h
45318,3,weichafe,1718,144,4,9,13,30.8%,2h
45318,1,ComingBack,1718,0,0,4,4,0.0%,2h
45320,3,Frank,1717,256,9,19,28,32.1%,1h
45320,3,andric,1717,309,9,23,32,28.1%,33m
45320,1,BERZERKER,1717,0,1,0,1,100.0%,2h
45320,1,MarsUltorian,1717,38,1,2,3,33.3%,2h
45320,3,ALcO,1717,0,0,8,8,0.0%,45m
45320,2,Tyler,1717,0,0,8,8,0.0%,2h
45326,3,EDUARDO,1716,1472,60,81,141,42.6%,2h
45326,3,CARB,1716,1426,57,65,122,46.7%,30m
45326,1,OscarAmin,1716,801,22,20,42,52.4%,2h
45326,3,MIRANDA,1716,387,21,31,52,40.4%,21m
45326,3,ZandsT,1716,285,13,28,41,31.7%,2h
45326,1,rockrio,1716,427,11,13,24,45.8%,53m
45326,2,Anas,1716,251,8,24,32,25.0%,22m
45326,3,tai,1716,30,2,14,16,12.5%,41m
45326,1,MorceGuuu,1716,44,1,3,4,25.0%,53m
45326,2,Teamdbz,1716,30,1,12,13,7.7%,2h
45326,1,RobDinThreeD,1716,0,0,1,1,0.0%,38m
45337,1,[EZDUNK]IIIIIIIIIIII,1715,1555,226,244,470,48.1%,2h
45337,3,REALIZOR,1715,30,2,6,8,25.0%,6m
45339,3,Ludwig,1714,1475,173,256,429,40.3%,2h
45339,3,ColdSweat,1714,836,30,40,70,42.9%,49m
45339,1,Javii,1714,696,19,22,41,46.3%,2h
45339,1,ARLO,1714,476,12,11,23,52.2%,53m
45339,3,GLHM,1714,263,10,16,26,38.5%,2h
45339,1,SpartanVela,1714,294,8,20,28,28.6%,53m
45339,1,Redx,1714,209,6,15,21,28.6%,2h
45339,3,jacky,1714,160,5,20,25,20.0%,57m
45339,2,marduk,1714,106,3,14,17,17.6%,24m
45339,3,[OPKZ]conceptmatt,1714,0,0,1,1,0.0%,13m
45339,3,JIMC,1714,0,0,2,2,0.0%,7m
45350,3,spacetrash,1713,1466,75,86,161,46.6%,2h
45350,3,Edward,1713,579,37,55,92,40.2%,2h
45350,1,saint,1713,1134,33,41,74,44.6%,38m
45350,2,[ERFT]Mayor,1713,644,31,53,84,36.9%,2h
45350,1,Mvdreno,1713,1062,30,36,66,45.5%,54m
45350,1,NOOBpwnr,1713,298,8,20,28,28.6%,2h
45350,1,dfg,1713,178,5,1,6,83.3%,32m
45350,1,CaptainX,1713,128,5,5,10,50.0%,2h
45350,2,ACE,1713,34,1,6,7,14.3%,2h
45350,3,[BrRv]Antonito,1713,0,0,1,1,0.0%,13m
45360,3,ironhorse,1712,1559,133,174,307,43.3%,21m
45360,1,borise,1712,1206,55,76,131,42.0%,30m
45360,3,JJay,1712,844,30,46,76,39.5%,45m
45360,1,Artimus,1712,282,7,15,22,31.8%,2h
45360,1,BrokenPrime,1712,212,5,5,10,50.0%,54m
45360,3,esteban,1712,72,2,9,11,18.2%,45m
45360,1,IceCube,1712,90,2,9,11,18.2%,27m
45360,3,David,1712,0,1,4,5,20.0%,2h
45360,3,Atex,1712,97,1,8,9,11.1%,2h
45360,3,NightKnight,1712,0,0,6,6,0.0%,7m
45370,1,Vince,1711,802,24,31,55,43.6%,2h
45370,1,Charlie,1711,697,23,24,47,48.9%,53m
45370,3,toreto,1711,302,14,25,39,35.9%,4m
45370,1,[WDGAF]NotSoFastSir,1711,268,7,12,19,36.8%,2h
45370,2,KingOfTheDam,1711,58,2,12,14,14.3%,2h
45375,1,shadow,1710,366,9,16,25,36.0%,3h
45375,1,Vinny,1710,90,2,5,7,28.6%,2h
45375,1,brute,1710,0,0,2,2,0.0%,2h
45378,1,Jugger,1709,408,11,22,33,33.3%,28m
45378,1,Guilherme,1709,468,11,23,34,32.4%,28m
45378,2,venom,1709,169,4,12,16,25.0%,2h
45381,3,Imtotscury,1708,322,10,26,36,27.8%,2h
45381,3,CommandNunu,1708,215,6,22,28,21.4%,2h
45381,1,PEGADOR,1708,136,5,14,19,26.3%,2h
45381,3,Craftdory,1708,147,4,10,14,28.6%,39m
45381,3,Pickle,1708,135,2,16,18,11.1%,57m
45381,3,SombrA,1708,0,0,1,1,0.0%,2h
45381,1,Dethstroke,1708,0,0,2,2,0.0%,3h
45381,3,eldermagic,1708,0,0,2,2,0.0%,2h
45381,3,Uppaclassmun,1708,0,0,4,4,0.0%,35m
45381,3,DaGrizzman,1708,0,0,14,14,0.0%,2h
45391,1,omgPROHASKA,1707,164,6,7,13,46.2%,29m
45391,1,CcloudsS,1707,0,0,1,1,0.0%,2h
45391,1,Axe,1707,0,0,2,2,0.0%,54m
45394,1,Saherron,1706,304,8,11,19,42.1%,23m
45394,1,Casper,1706,254,6,10,16,37.5%,2h
45394,3,Huesote,1706,160,5,15,20,25.0%,21m
45394,2,MKZIONFARK,1706,248,5,16,21,23.8%,28m
45394,3,erikxito,1706,60,2,11,13,15.4%,7m
45399,1,[Arions]Destroyer,1705,176,5,10,15,33.3%,3h
45400,1,Destroyer,1704,972,32,54,86,37.2%,2h
45400,1,[S2D]ProtossMain,1704,191,8,19,27,29.6%,29m
45400,3,JonasDeLuna,1704,90,3,13,16,18.8%,41m
45400,3,[TTII]Elgio,1704,30,2,8,10,20.0%,2h
45404,3,Zealot,1703,1484,117,173,290,40.3%,49m
45404,3,Jurg,1703,780,55,65,120,45.8%,5m
45404,1,[C96741]Burgernose,1703,822,24,25,49,49.0%,2h
45404,3,Garrett,1703,533,16,34,50,32.0%,42m
45404,1,lmnopqrstuv,1703,174,7,5,12,58.3%,57m
45404,3,Fujin,1703,70,2,12,14,14.3%,43m
45410,1,bleep,1702,36,1,2,3,33.3%,51m
45410,1,[AxL]SeaFoam,1702,104,1,11,12,8.3%,2h
45410,1,oscar,1702,0,0,2,2,0.0%,2h
45413,3,Craftmaster,1701,771,51,53,104,49.0%,2h
45413,1,BRIX,1701,138,6,7,13,46.2%,2h
45413,3,SabreTman,1701,30,2,7,9,22.2%,2h
45413,1,Coconuthead,1701,48,1,5,6,16.7%,3h
45413,2,Krayziemex,1701,0,0,1,1,0.0%,16m
45418,1,Nakon,1700,726,24,26,50,48.0%,9m
45419,1,Blankey,1699,1206,37,42,79,46.8%,2h
45419,2,Jatman,1699,142,4,15,19,21.1%,2h
45419,2,Bobcat,1699,124,3,14,17,17.6%,52m
45419,1,[HTSS]Lucifer,1699,46,1,2,3,33.3%,28m
45419,3,HonorGuideMe,1699,30,1,6,7,14.3%,2h
45419,1,TvFuzz,1699,0,0,1,1,0.0%,3h
45419,1,Souseiki,1699,0,0,2,2,0.0%,2h
45426,3,tothemax,1698,30,3,3,6,50.0%,2h
45426,2,jamchop,1698,0,0,1,1,0.0%,53m
45426,1,Destructor,1698,0,0,4,4,0.0%,2h
45429,2,SaltyDog,1697,906,31,48,79,39.2%,2h
45429,3,Sebastian,1697,477,16,36,52,30.8%,30m
45429,1,AleUwU,1697,88,3,0,3,100.0%,2h
45429,1,[LY]rosamel,1697,44,2,3,5,40.0%,19m
45429,3,Scooby,1697,0,0,3,3,0.0%,30m
45434,1,yonatan,1696,1260,36,51,87,41.4%,53m
45434,1,leo,1696,1090,31,38,69,44.9%,49m
45434,3,Rabbit,1696,289,8,15,23,34.8%,2h
45434,1,Lukem,1696,160,3,4,7,42.9%,2h
45438,1,RAGNAROK,1695,527,16,20,36,44.4%,2h
45438,1,WanderSage,1695,166,7,2,9,77.8%,2h
45438,1,Shadow,1695,94,2,4,6,33.3%,2h
45438,1,fkill,1695,0,0,3,3,0.0%,31m
45438,1,Tydrolor,1695,0,0,6,6,0.0%,2h
45443,3,[ZTemps]Aegis,1693,456,59,73,132,44.7%,39m
45443,1,mhneri,1693,88,2,4,6,33.3%,19m
45445,1,PasFromage,1692,672,36,41,77,46.8%,53m
45445,1,[HeLiuM]RedRadiation,1692,323,8,21,29,27.6%,23m
45445,1,GoldenGoose,1692,206,6,3,9,66.7%,19m
45445,3,SCStar,1692,88,4,17,21,19.0%,2h
45445,1,condor,1692,108,3,6,9,33.3%,53m
45445,1,tino,1692,0,2,3,5,40.0%,2h
45445,3,DarkNetDrago,1692,62,2,17,19,10.5%,24m
45445,1,ZipMaiFlai,1692,44,1,2,3,33.3%,3h
45453,1,Snurffe,1691,180,7,7,14,50.0%,2h
45453,3,[JUGOS2]RedVan,1691,218,7,20,27,25.9%,2h
45453,3,DjNiceFlow,1691,72,3,14,17,17.6%,2h
45453,1,HORUS,1691,48,2,14,16,12.5%,2h
45453,1,RAUL,1691,0,1,1,2,50.0%,28m
45453,1,[aIien]Kit,1691,46,1,2,3,33.3%,2h
45453,1,stomptheface,1691,48,1,4,5,20.0%,50m
45453,3,TinyDragon,1691,0,0,1,1,0.0%,13m
45453,3,JuanGabriel,1691,0,0,7,7,0.0%,13m
45453,2,MILAGROS,1691,0,0,11,11,0.0%,2h
45463,1,bunnycutie,1690,284,7,11,18,38.9%,53m
45463,3,StarFire,1690,178,7,14,21,33.3%,57m
45463,2,SirMixalot,1690,164,5,15,20,25.0%,37m
45463,3,XYON,1690,78,4,3,7,57.1%,2h
45463,2,[TLoA]OreMiner,1690,122,4,12,16,25.0%,2h
45463,1,gerarfa,1690,48,1,2,3,33.3%,3h
45463,1,bori,1690,46,1,2,3,33.3%,31m
45463,2,Legbone,1690,0,0,1,1,0.0%,36m
45463,3,Prowler,1690,0,0,1,1,0.0%,13m
45463,2,Oneeye,1690,0,0,9,9,0.0%,25m
45473,2,[ATLsOs]bossmode,1689,30,1,10,11,9.1%,2h
45474,1,[KngZ]Pipetoss,1688,830,28,55,83,33.7%,3h
45474,1,rcondoric,1688,524,14,15,29,48.3%,2h
45474,3,Denilson,1688,290,9,28,37,24.3%,2h
45474,2,pastorjona,1688,92,3,14,17,17.6%,39m
45478,1,jakethesnake,1687,299,10,16,26,38.5%,54m
45478,3,[ZTempz]Liberty,1687,233,7,13,20,35.0%,2h
45478,1,yaratilin,1687,0,1,0,1,100.0%,54m
45478,1,whitewolf,1687,0,0,2,2,0.0%,2h
45478,1,renan,1687,73,0,8,8,0.0%,2h
45483,1,[mMEGA]HERSU,1686,1561,65,83,148,43.9%,2h
45483,2,Coxolato,1686,958,31,59,90,34.4%,2h
45483,1,BlacXPhantum,1686,386,11,15,26,42.3%,46m
45483,2,[TMCP]Xavy,1686,46,2,11,13,15.4%,45m
45483,1,Nova,1686,0,1,2,3,33.3%,2h
45488,1,gapsk,1685,613,23,28,51,45.1%,2h
45488,3,OCamden,1685,0,0,1,1,0.0%,3h
45488,1,Starmak,1685,0,0,4,4,0.0%,2h
45491,3,[DRKESP]Nitro,1684,967,32,48,80,40.0%,2h
45491,1,crepygamer,1684,248,7,9,16,43.8%,30m
45491,1,MedicatedOne,1684,196,5,4,9,55.6%,8m
45494,1,SpaceStretMe,1683,97,2,1,3,66.7%,23m
45494,1,WraithRevolt,1683,94,2,12,14,14.3%,3h
45494,1,soma,1683,0,0,2,2,0.0%,2h
45497,1,gabriel,1682,295,9,20,29,31.0%,2h
45498,1,Franklin,1681,711,21,24,45,46.7%,2h
45498,1,MonGrRrolL,1681,88,2,4,6,33.3%,2h
45498,3,[LPrusa]Xforcex,1681,0,1,4,5,20.0%,13m
45498,3,MrKomori,1681,0,0,1,1,0.0%,2h
45502,1,TGH,1680,1368,94,118,212,44.3%,46m
45502,1,warchief,1680,563,14,23,37,37.8%,46m
45502,3,FlashCry,1680,30,3,4,7,42.9%,7m
45502,2,Darandomness,1680,116,2,12,14,14.3%,43m
45506,3,IMissYouGrMa,1679,1487,207,266,473,43.8%,2h
45506,3,wazzzzup,1679,40,1,2,3,33.3%,2h
45508,3,MetroKnome,1678,1357,46,63,109,42.2%,2h
45508,1,Xayid,1678,48,2,3,5,40.0%,46m
45508,1,Spytalons,1678,73,1,2,3,33.3%,2h
45508,3,TheBestAtSC,1678,0,0,9,9,0.0%,45m
45512,1,budioke,1677,94,3,19,22,13.6%,2h
45512,2,rokato,1677,58,2,13,15,13.3%,2h
45512,1,Neopactech,1677,0,0,2,2,0.0%,53m
45515,1,JohnStevens,1676,626,16,23,39,41.0%,3h
45515,1,ZALADIN,1676,556,15,15,30,50.0%,2h
45515,1,Fuburutunaka,1676,134,3,2,5,60.0%,2h
45515,3,Ping,1676,0,0,1,1,0.0%,7m
45519,1,bobyfarts,1675,176,3,5,8,37.5%,9m
45520,3,[LTlord]KippaSaurio,1674,324,9,22,31,29.0%,2h
45520,1,Adelais,1674,209,5,2,7,71.4%,49m
45520,2,LuCheCoCo,1674,30,1,10,11,9.1%,2h
45523,1,Clagolas,1673,412,14,18,32,43.8%,2h
45523,1,ZackAttack,1673,372,14,26,40,35.0%,3h
45523,1,sKyLeR,1673,404,12,15,27,44.4%,2h
45523,1,[pokk]Checkov,1673,314,9,12,21,42.9%,46m
45523,2,ViZZER,1673,106,3,14,17,17.6%,28m
45523,1,PlatinumOne,1673,135,2,13,15,13.3%,2h
45529,1,Odysseus,1672,974,28,47,75,37.3%,2h
45529,1,WillyWonka,1672,552,19,27,46,41.3%,46m
45529,1,GoblinGhost,1672,0,0,1,1,0.0%,53m
45532,1,pex,1671,235,12,13,25,48.0%,2h
45532,2,ken,1671,0,0,4,4,0.0%,2h
45534,2,MRdoinkster,1670,202,6,17,23,26.1%,28m
45534,1,Marty,1670,0,1,4,5,20.0%,30m
45534,1,[INKA5]Sturm,1670,0,0,2,2,0.0%,3h
45534,1,JJAJ,1670,0,0,5,5,0.0%,2h
45538,3,tiño,1669,202,6,11,17,35.3%,2h
45538,1,GLHF,1669,155,2,5,7,28.6%,2h
45538,1,SkyAngel,1669,48,1,4,5,20.0%,53m
45541,3,[KhanZ]Omarstar,1668,860,30,39,69,43.5%,41m
45541,1,[Mota12]oliverius,1668,294,8,15,23,34.8%,30m
45541,1,Ridgefield,1668,283,6,20,26,23.1%,2h
45541,2,[Eagle1]WhiteEagle,1668,0,0,7,7,0.0%,2h
45541,2,[SyLx]Slayer,1668,0,0,9,9,0.0%,2h
45541,2,afrAy,1668,0,0,9,9,0.0%,2h
45541,1,ancelantu,1668,0,0,10,10,0.0%,19m
45548,3,Bigbird,1667,827,39,52,91,42.9%,57m
45548,1,Zexonith,1667,246,6,9,15,40.0%,2h
45550,1,Stencovich,1666,504,11,21,32,34.4%,2h
45551,3,SnakEyes,1665,1337,62,88,150,41.3%,2h
45551,1,JJABRAMS,1665,1049,30,44,74,40.5%,2h
45551,1,CrowJoe,1665,665,18,27,45,40.0%,31m
45551,1,Fransis,1665,654,16,24,40,40.0%,31m
45551,1,EpicEric,1665,74,3,2,5,60.0%,2h
45551,2,[ORTE]Erickgamer,1665,159,3,8,11,27.3%,2h
45551,3,GabrielusYG,1665,0,2,5,7,28.6%,30m
45551,2,Spicles,1665,48,1,1,2,50.0%,17m
45551,1,killerman,1665,0,1,3,4,25.0%,46m
45551,3,Cake,1665,0,0,1,1,0.0%,2h
45551,1,Stonecrusher,1665,0,0,2,2,0.0%,2h
45551,2,Jtbk,1665,73,0,3,3,0.0%,45m
45563,1,still,1664,246,7,11,18,38.9%,20m
45563,3,Dyakrox,1664,90,3,6,9,33.3%,13m
45563,1,kirito,1664,30,2,5,7,28.6%,2h
45563,3,[Bommmm]FollamePuto,1664,0,2,6,8,25.0%,56m
45563,2,[DhZAc1]iGunnyn,1664,32,2,10,12,16.7%,3h
45568,1,Khayla,1663,334,8,15,23,34.8%,3h
45568,3,Zardie,1663,218,7,21,28,25.0%,43m
45568,1,martin,1663,222,6,20,26,23.1%,3h
45568,2,JhonTitor,1663,74,2,9,11,18.2%,2m
45572,3,Bitkruked,1662,1032,99,135,234,42.3%,37m
45572,3,ELCHAMAN,1662,853,36,48,84,42.9%,37m
45572,1,BryamKessler,1662,380,11,16,27,40.7%,2h
45572,2,shadow,1662,193,5,7,12,41.7%,52m
45572,1,[YEETRZ]yeetman,1662,131,3,14,17,17.6%,8m
45572,1,Beowolf,1662,0,0,1,1,0.0%,2h
45578,1,necronomicon,1661,322,8,17,25,32.0%,2h
45579,1,Werdwolf,1660,1863,74,109,183,40.4%,28m
45579,2,sami,1660,350,12,21,33,36.4%,2h
45579,1,[RnRFTP]ThePunisher,1660,172,4,8,12,33.3%,28m
45582,1,fluffybanana,1659,557,15,19,34,44.1%,4m
45582,3,Necropool,1659,30,2,5,7,28.6%,2h
45582,1,Riake,1659,0,0,3,3,0.0%,28m
45585,1,GatJoseRizal,1658,737,20,40,60,33.3%,2h
45585,1,Jayjay,1658,0,0,2,2,0.0%,2h
45587,1,holacomoewsk,1657,1180,34,41,75,45.3%,2h
45587,1,davikRoo,1657,104,4,16,20,20.0%,55m
45587,3,OscarOrtiz,1657,30,1,7,8,12.5%,2h
45587,1,Bryan,1657,0,0,8,8,0.0%,2h
45591,1,TazZadaR,1656,960,28,74,102,27.5%,42m
45591,1,CaptainJP,1656,152,7,30,37,18.9%,5m
45591,1,finao,1656,82,2,8,10,20.0%,2h
45591,1,VenomTerror,1656,0,1,0,1,100.0%,9m
45591,3,[DomFor]BMWMFLY,1656,0,0,5,5,0.0%,56m
45596,1,CooCooClock,1655,757,22,34,56,39.3%,2h
45596,3,Necronicon,1655,363,11,18,29,37.9%,2h
45596,2,SwampLord,1655,233,8,15,23,34.8%,2h
45596,2,Sputnik,1655,140,4,14,18,22.2%,16m
45596,1,Dangergirl,1655,144,3,14,17,17.6%,2h
45601,1,TRIPPINJIM,1654,279,8,6,14,57.1%,4m
45601,3,rdog,1654,152,8,13,21,38.1%,30m
45603,3,MULE,1653,205,8,12,20,40.0%,2h
45603,1,NeoGaliga,1653,0,1,0,1,100.0%,30m
45603,1,[Biag]king,1653,0,1,1,2,50.0%,53m
45606,2,becm,1652,1310,63,104,167,37.7%,48m
45606,1,DiBlasio,1652,478,18,8,26,69.2%,44m
45606,1,fabian,1652,515,15,23,38,39.5%,2h
45606,3,sunshine,1652,0,0,3,3,0.0%,2h
45610,1,[Bk3aa]RAM,1650,40,2,1,3,66.7%,2h
45611,3,haydean,1649,801,75,99,174,43.1%,46m
45611,1,daymiel,1649,0,0,4,4,0.0%,13m
45613,1,SHAKU,1647,1350,36,66,102,35.3%,49m
45613,1,ALEXANDER,1647,655,20,30,50,40.0%,20m
45613,1,Set,1647,174,6,9,15,40.0%,12m
45613,2,DreddSavage,1647,142,3,14,17,17.6%,43m
45613,3,Deaspora,1647,0,2,3,5,40.0%,2h
45613,1,Matias,1647,38,1,2,3,33.3%,31m
45613,3,DoNaN,1647,0,0,1,1,0.0%,7m
45620,1,baron,1646,358,10,10,20,50.0%,2h
45620,1,dfdffdfd,1646,0,0,1,1,0.0%,2h
45620,1,Cgal,1646,0,0,2,2,0.0%,49m
45623,3,BullitSpeed,1645,122,8,12,20,40.0%,2h
45623,3,[kOOp]hax,1645,58,3,1,4,75.0%,56m
45623,1,MaximusDM,1645,78,2,11,13,15.4%,2h
45623,1,Casino,1645,0,0,1,1,0.0%,4m
45627,1,Lafoe,1644,1044,33,46,79,41.8%,2h
45627,1,Redd,1644,412,11,16,27,40.7%,31m
45629,3,[Leengz]HarryNipps,1643,30,2,0,2,100.0%,45m
45629,2,war,1643,91,1,7,8,12.5%,2m
45629,1,DemonicBLT,1643,40,1,9,10,10.0%,2h
45632,1,tecomatador,1642,880,29,33,62,46.8%,2h
45632,1,Savage,1642,44,1,2,3,33.3%,27m
45632,1,CASHDRAGON,1642,0,0,6,6,0.0%,3h
45635,1,Bomro,1641,176,6,10,16,37.5%,50m
45635,3,[KSRP]HarryLeTaint,1641,120,5,8,13,38.5%,1h
45635,3,[Sdo]Wabux,1641,0,0,1,1,0.0%,42m
45638,3,Hokirob,1640,0,0,1,1,0.0%,2h
45639,1,DiscoStew,1639,397,18,21,39,46.2%,3h
45639,3,leee,1639,124,8,12,20,40.0%,11m
45639,3,TheDog,1639,204,7,22,29,24.1%,39m
45639,1,Alex,1639,0,1,3,4,25.0%,53m
45639,1,MaJesTiiC,1639,0,0,4,4,0.0%,27m
45639,3,Detpack,1639,0,0,5,5,0.0%,7m
45645,1,[ACTKK2]RhynoJunior,1638,238,7,22,29,24.1%,9m
45645,1,[Antss]tURD,1638,196,6,8,14,42.9%,2h
45645,1,DRXZblue,1638,263,6,11,17,35.3%,2h
45645,1,razer,1638,0,2,4,6,33.3%,30m
45649,1,Zex,1637,448,13,19,32,40.6%,44m
45650,3,[Tvirus]chikota,1636,0,0,2,2,0.0%,42m
45651,1,Sneakysquid,1635,1558,49,59,108,45.4%,44m
45651,1,MichaelMeyer,1635,392,13,16,29,44.8%,2h
45653,2,ZckkAttck,1634,0,1,0,1,100.0%,53m
45654,3,AllSystemsGo,1633,0,32,74,106,30.2%,25m
45654,1,[IMORTL]PRose,1633,583,15,21,36,41.7%,2h
45654,3,DubRhaNesh,1633,0,1,6,7,14.3%,56m
45657,1,[TeamCT]Luffy,1632,777,18,30,48,37.5%,3h
45658,1,Kaul,1631,811,22,33,55,40.0%,30m
45658,1,alexx,1631,93,1,5,6,16.7%,2h
45658,3,Enay,1631,0,0,1,1,0.0%,2h
45661,1,[VACAXD]Valtiel,1630,73,1,3,4,25.0%,12m
45662,1,Agamemnon,1629,209,6,6,12,50.0%,2h
45662,2,Dragonlord,1629,0,1,5,6,16.7%,52m
45664,1,Torch,1628,1524,42,68,110,38.2%,2h
45664,1,TurkeyCheese,1628,1187,37,51,88,42.0%,2h
45664,1,[PKSC]Ziery,1628,223,9,19,28,32.1%,8m
45664,1,zele,1628,326,8,32,40,20.0%,23m
45664,3,Noctic,1628,0,1,1,2,50.0%,14m
45669,1,IgnacioJS,1627,208,7,7,14,50.0%,2h
45669,1,Ronin,1627,230,7,8,15,46.7%,13m
45669,1,EsqueletoXd,1627,0,1,0,1,100.0%,9m
45669,1,[space3]Fantasma,1627,0,0,7,7,0.0%,54m
45673,3,Leandrus,1626,619,67,103,170,39.4%,2h
45673,1,wannabe,1626,128,3,5,8,37.5%,2h
45673,1,CeNo,1626,90,3,6,9,33.3%,2h
45673,1,[spKEY]HeliStructur,1626,38,1,2,3,33.3%,44m
45673,1,Gwad,1626,40,1,3,4,25.0%,32m
45678,3,[KABOOM]DALMATiaN,1625,30,1,5,6,16.7%,43m
45679,1,Metalator,1624,44,3,6,9,33.3%,20m
45679,1,[NGFR]Totoro,1624,86,3,6,9,33.3%,4m
45679,2,Connortje,1624,44,1,9,10,10.0%,2m
45682,1,terror,1623,208,6,6,12,50.0%,28m
45682,3,THenley,1623,30,1,11,12,8.3%,2h
45682,3,fredoren,1623,0,0,2,2,0.0%,43m
45685,1,paposky,1622,1826,134,167,301,44.5%,2h
45685,1,carlosgrosas,1622,1400,47,67,114,41.2%,2h
45685,3,elieio,1622,0,3,4,7,42.9%,2h
45688,1,[RnRFTP]FENDER,1621,416,13,14,27,48.1%,2h
45688,1,Tsobu,1621,141,6,8,14,42.9%,28m
45688,3,Pacu,1621,78,5,4,9,55.6%,2h
45688,1,Shinobi,1621,174,5,8,13,38.5%,2h
45688,1,Garenflow,1621,48,4,4,8,50.0%,2h
45688,3,moon,1621,0,1,0,1,100.0%,14m
45688,1,GoldenPants,1621,0,1,1,2,50.0%,2h
45695,3,darkzirux,1620,664,20,44,64,31.2%,46m
45696,3,CoachCraft,1619,238,9,22,31,29.0%,17m
45696,2,mct,1619,144,4,21,25,16.0%,2h
45696,1,Antonio,1619,0,0,6,6,0.0%,30m
45699,1,Darklordkaan,1618,68,5,6,11,45.5%,2h
45699,3,Aenima,1618,0,0,4,4,0.0%,7m
45701,3,kratoss,1617,756,26,44,70,37.1%,17m
45702,3,Murdock,1616,0,0,1,1,0.0%,56m
45703,1,Keyjo,1615,1871,278,419,697,39.9%,2h
45703,1,Tom,1615,864,34,45,79,43.0%,2h
45703,3,[Mony]Kimjiye,1615,977,34,46,80,42.5%,42m
45703,1,Lena,1615,133,4,5,9,44.4%,2h
45707,1,SybilRayne,1614,0,3,8,11,27.3%,2h
45707,1,JÔNATAS,1614,134,2,10,12,16.7%,2h
45709,3,EVILSKY,1613,428,14,31,45,31.1%,57m
45709,3,TheFenix,1613,0,0,5,5,0.0%,45m
45709,1,lllllllllll,1613,0,0,5,5,0.0%,2h
45712,1,Dizzlers,1612,0,0,2,2,0.0%,2h
45712,1,raft,1612,0,0,4,4,0.0%,2h
45712,3,Juggernorris,1612,0,0,6,6,0.0%,2h
45715,1,VeryToss,1611,342,15,7,22,68.2%,44m
45715,3,hellturtle,1611,138,5,13,18,27.8%,43m
45715,1,sly,1611,214,4,17,21,19.0%,24m
45715,1,Manolito,1611,30,2,15,17,11.8%,2h
45715,1,[MrBu]Kate,1611,0,1,0,1,100.0%,3h
45715,1,campeonce,1611,94,1,2,3,33.3%,2h
45715,2,VictorHs,1611,88,1,2,3,33.3%,3m
45715,1,Neno,1611,73,1,3,4,25.0%,2h
45723,3,RocKs,1610,482,22,38,60,36.7%,30m
45723,1,luchofons,1610,128,3,7,10,30.0%,2h
45723,1,BraverBadger,1610,0,0,1,1,0.0%,2h
45726,1,hahahay,1609,130,4,4,8,50.0%,27m
45727,2,Lucaas,1607,30,1,13,14,7.1%,47m
45727,1,PINOCHET,1607,0,0,7,7,0.0%,2h
45729,2,LILBITS,1606,138,4,17,21,19.0%,25m
45729,3,Wicked,1606,30,3,5,8,37.5%,13m
45729,3,Mastinator,1606,0,0,4,4,0.0%,37m
45732,1,ELISEO,1604,258,7,9,16,43.8%,2h
45732,2,ReiDaviTV,1604,0,3,2,5,60.0%,29m
45732,1,NiceShotTrev,1604,0,2,4,6,33.3%,2h
45735,2,AXELPRO,1603,384,12,33,45,26.7%,2h
45735,1,[C10097]sengnaga,1603,140,3,12,15,20.0%,52m
45735,2,Swatter,1603,90,2,18,20,10.0%,7m
45735,1,Turney,1603,0,1,2,3,33.3%,2h
45735,3,SaintReagan,1603,0,0,1,1,0.0%,37m
45740,3,TALIBAN,1602,296,10,19,29,34.5%,49m
45740,2,SleyeR,1602,168,3,11,14,21.4%,2h
45742,2,MisterPeeps,1601,210,6,9,15,40.0%,2h
45742,2,[teamGG]FCStrapdUp,1601,64,2,7,9,22.2%,2h
45744,1,sic,1600,837,23,34,57,40.4%,2h
45744,3,AlexiMichael,1600,417,12,33,45,26.7%,2h
45744,1,JrlLive,1600,99,2,6,8,25.0%,54m
45744,1,BlacPower,1600,30,2,7,9,22.2%,2h
45744,1,Chaichon,1600,78,2,9,11,18.2%,2h
45749,1,STARRJUNN,1598,1185,40,66,106,37.7%,2h
45749,2,Destroyer,1598,0,0,9,9,0.0%,2h
45751,1,WoShi,1597,1847,76,109,185,41.1%,38m
45751,3,Kirt,1597,400,31,54,85,36.5%,49m
45751,2,Reeper,1597,416,14,31,45,31.1%,10m
45751,2,fatsdabs,1597,86,3,5,8,37.5%,2h
45751,1,paosroach,1597,88,2,3,5,40.0%,2h
45756,2,same,1596,106,3,0,3,100.0%,37m
45757,1,BMG,1595,438,14,18,32,43.8%,2h
45757,2,sonic,1595,207,6,4,10,60.0%,37m
45757,1,Cerberus,1595,160,5,9,14,35.7%,2h
45757,3,KnickerNoob,1595,0,0,4,4,0.0%,7m
45757,3,JediLink,1595,0,0,4,4,0.0%,3h
45757,3,kiory,1595,0,0,6,6,0.0%,2h
45763,1,Coldf,1594,1020,37,61,98,37.8%,57m
45763,1,direrraven,1594,722,24,29,53,45.3%,49m
45763,1,FazoC,1594,366,10,12,22,45.5%,2h
45763,3,LazyMarine,1594,0,2,3,5,40.0%,43m
45763,2,[lolies]OniiChanWant,1594,73,0,3,3,0.0%,29m
45768,3,Naurto,1593,0,0,5,5,0.0%,56m
45769,3,Alumniel,1592,30,1,4,5,20.0%,7m
45770,1,dajut,1591,208,6,11,17,35.3%,2h
45770,2,Nusenthea,1591,48,2,8,10,20.0%,33m
45772,1,TWatson,1589,188,4,6,10,40.0%,2h
45772,1,SunTzu,1589,0,0,2,2,0.0%,46m
45774,2,weiaruyafew,1588,1169,250,353,603,41.5%,16m
45774,3,SantiagoG,1588,92,4,4,8,50.0%,2h
45776,2,Justin,1587,228,8,17,25,32.0%,32m
45776,3,LEXXIS,1587,0,1,0,1,100.0%,42m
45778,2,NOCHo,1586,168,5,6,11,45.5%,36m
45778,1,Adrian,1586,167,3,9,12,25.0%,2h
45780,1,Patricksm,1585,336,10,23,33,30.3%,8m
45780,2,Obliterator,1585,128,3,4,7,42.9%,29m
45780,2,JUKEIIEY,1585,74,2,1,3,66.7%,54m
45780,2,Richard,1585,0,0,1,1,0.0%,2h
45784,1,[BLBR]Iridium,1583,791,21,37,58,36.2%,2h
45784,1,ssotorp,1583,358,15,30,45,33.3%,4m
45784,1,Zebediah,1583,149,6,10,16,37.5%,28m
45784,2,[TCJN]SneezyDwarf,1583,0,0,2,2,0.0%,36m
45784,1,[QTCO]Fabiovsky,1583,0,0,2,2,0.0%,2h
45789,1,Nion,1582,1282,43,83,126,34.1%,2h
45789,1,Shark,1582,118,5,10,15,33.3%,2h
45789,1,DrPoya,1582,106,2,6,8,25.0%,30m
45792,3,zohan,1581,34,2,2,4,50.0%,42m
45793,2,[RSHB]Sammypty,1580,1253,62,81,143,43.4%,46m
45793,1,Velius,1580,86,3,16,19,15.8%,2h
45793,2,[028]daviobg,1580,0,0,1,1,0.0%,2h
45796,2,Pesky,1579,478,17,16,33,51.5%,2h
45796,1,Coronohoax,1579,192,5,10,15,33.3%,2h
45796,3,luap,1579,0,0,1,1,0.0%,56m
45799,1,Manny,1578,74,3,3,6,50.0%,2h
45799,2,crash,1578,36,2,2,4,50.0%,24m
45799,2,felix,1578,0,0,1,1,0.0%,3m
45802,1,MAS,1577,1799,122,197,319,38.2%,2h
45802,1,TuPinchePapá,1577,1601,54,99,153,35.3%,2h
45802,2,JRAMIREZ,1577,465,12,24,36,33.3%,3h
45805,1,JULIA,1576,1267,261,373,634,41.2%,2h
45806,2,ObieTrice,1575,66,4,6,10,40.0%,2h
45806,3,admjr,1575,0,1,1,2,50.0%,2h
45806,2,ProTer,1575,0,0,1,1,0.0%,49m
45809,3,ENRIQUEPB,1574,1503,102,140,242,42.1%,2h
45809,2,coolcool,1574,42,1,2,3,33.3%,33m
45809,2,Ankha,1574,0,0,1,1,0.0%,52m
45812,2,XHILELEO,1573,102,2,2,4,50.0%,2h
45813,3,nicchema,1572,0,0,4,4,0.0%,2h
45814,2,xmen,1571,220,8,19,27,29.6%,27m
45815,1,[ConFed]Danteexe,1570,40,1,13,14,7.1%,13m
45816,1,JuanGumitron,1569,44,2,4,6,33.3%,44m
45816,2,netcat,1569,0,0,5,5,0.0%,2h
45818,1,TurboPenguin,1568,393,10,18,28,35.7%,24m
45818,2,Rakzer,1568,202,8,12,20,40.0%,3h
45818,1,groglog,1568,80,2,9,11,18.2%,2h
45818,2,KarlMagnus,1568,97,1,4,5,20.0%,37m
45822,1,opus,1566,590,17,32,49,34.7%,2h
45823,1,[BeDilf]ComeInHerEye,1565,932,29,58,87,33.3%,2h
45823,3,BuzzCauldrin,1565,30,4,9,13,30.8%,48m
45825,1,EvenFudge,1564,565,14,17,31,45.2%,2h
45825,2,urbad,1564,272,7,7,14,50.0%,2h
45827,1,darkcy,1563,1844,343,467,810,42.3%,53m
45827,3,SusejTsirhc,1563,58,4,22,26,15.4%,41m
45829,3,Kinoshi,1562,700,42,68,110,38.2%,2h
45829,3,[LifeC]Lifecast,1562,0,1,1,2,50.0%,2h
45829,1,FENIXWARS,1562,0,1,17,18,5.6%,57m
45832,2,XerXesX,1561,78,2,4,6,33.3%,2h
45832,3,Ritual,1561,0,0,2,2,0.0%,3h
45832,3,Cayto,1561,0,0,3,3,0.0%,2h
45835,3,freddyman,1560,0,2,3,5,40.0%,2h
45835,2,breakass,1560,132,2,15,17,11.8%,2h
45835,1,MagicTurtle,1560,0,1,5,6,16.7%,2h
45835,3,ureta,1560,0,0,4,4,0.0%,42m
45839,1,wolfnica,1559,1024,39,58,97,40.2%,2h
45839,1,kuumathekid,1559,380,10,30,40,25.0%,2h
45839,1,chez,1559,42,1,7,8,12.5%,2h
45839,3,Tetratriton,1559,0,0,2,2,0.0%,2h
45843,2,ERIK,1557,178,4,1,5,80.0%,54m
45843,1,ShadowStorm,1557,163,3,8,11,27.3%,30m
45843,3,shadowwind,1557,0,0,1,1,0.0%,42m
45846,2,dwade,1556,70,5,4,9,55.6%,29m
45846,2,Maynard,1556,94,3,7,10,30.0%,16m
45848,1,[slow01]snail,1555,187,6,11,17,35.3%,52m
45848,2,Josiah,1555,147,4,11,15,26.7%,29m
45848,1,DippedinGold,1555,116,4,11,15,26.7%,57m
45851,1,Tom,1554,30,5,3,8,62.5%,8m
45852,3,Jibbals,1552,0,0,2,2,0.0%,56m
45853,3,hdhierro,1551,0,0,5,5,0.0%,2h
45854,3,[XchiX]ReiDeLaMort,1550,158,8,16,24,33.3%,57m
45854,3,anndyyomar,1550,0,0,7,7,0.0%,2h
45856,1,BOoM,1549,896,26,48,74,35.1%,2h
45856,1,Mark,1549,258,6,19,25,24.0%,13m
45856,3,killerbrain,1549,124,4,13,17,23.5%,35m
45856,1,TeddyBear,1549,44,2,8,10,20.0%,46m
45856,2,attesero,1549,0,1,4,5,20.0%,16m
45861,1,Valerio,1548,521,14,28,42,33.3%,2h
45861,2,Joneff,1548,112,3,2,5,60.0%,29m
45863,2,batlecruiser,1547,0,0,1,1,0.0%,2h
45864,2,HuuhKante,1546,968,30,73,103,29.1%,39m
45864,1,gralTIZIANO,1546,218,6,16,22,27.3%,2h
45866,1,warmech,1545,139,3,7,10,30.0%,30m
45866,2,Fendaren,1545,0,0,11,11,0.0%,2h
45868,2,Eison,1544,805,26,34,60,43.3%,36m
45868,1,davidtroll,1544,244,7,13,20,35.0%,2h
45870,1,Panchulo,1543,1027,31,54,85,36.5%,27m
45870,2,SilentStorm,1543,0,0,1,1,0.0%,2h
45872,1,boscarwin,1542,186,5,8,13,38.5%,2h
45873,2,DigitalCrazy,1541,0,2,4,6,33.3%,29m
45873,3,[VFam2]SneakyPanda,1541,0,0,1,1,0.0%,13m
45875,1,trrishyyy,1539,0,4,3,7,57.1%,2h
45876,2,[nieBla]NnnnN,1536,73,3,4,7,42.9%,2h
45877,2,MrRobot,1535,30,3,5,8,37.5%,2h
45878,2,Drekion,1534,0,0,4,4,0.0%,37m
45879,3,GuuiLlE,1533,112,3,17,20,15.0%,56m
45879,2,ToxicWaste,1533,40,1,3,4,25.0%,2h
45881,1,Sam,1532,678,18,29,47,38.3%,28m
45881,2,ShadowXlayer,1532,30,3,9,12,25.0%,2h
45881,1,Egoneronomo,1532,0,0,8,8,0.0%,2h
45884,3,TheLoneWolfe,1531,74,2,5,7,28.6%,35m
45885,2,Tweezy,1530,317,11,17,28,39.3%,49m
45885,2,BERSEKERPY,1530,170,5,8,13,38.5%,36m
45885,2,SwarmN,1530,0,1,1,2,50.0%,36m
45885,3,battleborn,1530,0,0,1,1,0.0%,3h
45889,2,ianarv,1528,354,11,13,24,45.8%,35m
45890,2,mateusresue,1527,38,2,14,16,12.5%,2h
45891,2,itzmie,1526,110,4,6,10,40.0%,7m
45892,1,Juanma,1524,966,27,57,84,32.1%,2h
45893,1,Nobody,1523,536,14,25,39,35.9%,2h
45893,3,JCrack,1523,380,13,28,41,31.7%,2h
45893,2,ImSoBad,1523,0,0,5,5,0.0%,16m
45896,2,Blodepker,1522,64,2,8,10,20.0%,52m
45897,3,SAB,1520,346,11,36,47,23.4%,2h
45897,1,GATO,1520,328,8,13,21,38.1%,2h
45899,2,LULU,1519,238,8,8,16,50.0%,2h
45900,2,harryhardout,1518,0,0,2,2,0.0%,2h
45900,2,Vertighost,1518,0,0,6,6,0.0%,2h
45902,3,Dohja,1514,203,6,16,22,27.3%,3m
45902,2,polin,1514,136,5,4,9,55.6%,2h
45904,1,Echo,1513,569,14,22,36,38.9%,2h
45904,2,[Mengsk]Arcturus,1513,202,6,12,18,33.3%,36m
45904,2,Melanie,1513,58,2,2,4,50.0%,7m
45904,2,Zunari,1513,0,0,1,1,0.0%,2h
45908,2,[Z1a]Ziamonkey,1511,346,11,10,21,52.4%,2h
45908,3,[0PG]Alveolate,1511,241,6,15,21,28.6%,32m
45908,2,jandar,1511,88,1,9,10,10.0%,32m
45908,2,HotZealotB,1511,0,1,12,13,7.7%,2h
45912,3,Heathcliff,1510,58,5,8,13,38.5%,56m
45912,2,taboo,1510,94,3,18,21,14.3%,47m
45914,1,Taygrit,1509,170,4,18,22,18.2%,4m
45914,3,SnowSurfer,1509,30,2,2,4,50.0%,35m
45914,2,Darvos,1509,131,2,5,7,28.6%,2h
45917,1,gelato,1506,914,42,105,147,28.6%,47m
45917,2,sgtmalone,1506,214,10,14,24,41.7%,2h
45917,2,qwd,1506,75,6,3,9,66.7%,33m
45920,2,Fenix,1505,70,2,3,5,40.0%,8m
45920,2,Charmande,1505,48,1,4,5,20.0%,36m
45922,1,ZethAndJames,1504,394,14,45,59,23.7%,2h
45922,1,OOOF,1504,0,1,7,8,12.5%,2h
45922,1,BjornTurock,1504,40,1,9,10,10.0%,3h
45925,1,LeetPuff,1503,1095,49,49,98,50.0%,30m
45926,2,lee,1502,874,29,47,76,38.2%,2h
45926,2,Imroth,1502,199,6,13,19,31.6%,33m
45926,2,MACHAO,1502,124,6,16,22,27.3%,2h
45926,2,ImperialWGmr,1502,0,0,9,9,0.0%,52m
45930,2,[KGB]ShredThug,1498,0,1,0,1,100.0%,54m
45931,3,VargoNX,1492,178,4,19,23,17.4%,2h
45931,1,zLuxxyz,1492,46,1,10,11,9.1%,2h
45933,3,Bancocoman,1490,114,6,10,16,37.5%,56m
45934,1,ALLENCHILE,1489,94,2,17,19,10.5%,2h
45934,3,[DOV]BronzeWyrm,1489,0,0,7,7,0.0%,3h
45936,3,kst,1488,30,1,11,12,8.3%,2h
45937,2,ruler,1487,0,0,1,1,0.0%,2h
45938,1,sloppypants,1486,44,2,6,8,25.0%,2h
45939,3,[FROMOZ]StarStruck,1484,0,0,5,5,0.0%,2h
45940,2,HundreDemons,1482,73,0,6,6,0.0%,2h
45941,2,TVXGamer,1481,118,4,19,23,17.4%,2h
45942,3,Ryan,1480,62,2,11,13,15.4%,7m
45942,2,FIH,1480,36,1,10,11,9.1%,37m
45944,2,SecretSpy,1479,108,4,8,12,33.3%,3m
45945,2,Robertcarlqq,1477,483,13,34,47,27.7%,52m
45946,3,Ccth,1475,0,0,8,8,0.0%,2h
45947,1,luizgoro,1472,617,26,28,54,48.1%,2h
45948,2,Miunick,1471,0,1,1,2,50.0%,29m
45949,3,Chronoss,1470,116,5,1,6,83.3%,2h
45950,2,rsk,1469,883,41,67,108,38.0%,52m
45950,3,stevenz,1469,0,1,0,1,100.0%,3h
45950,2,uWilwin,1469,0,1,8,9,11.1%,49m
45953,3,nandcivic,1468,30,5,10,15,33.3%,4m
45954,2,PANDA,1467,371,12,16,28,42.9%,52m
45955,2,GhostDog,1466,586,26,50,76,34.2%,34m
45956,2,TiTuCusi,1465,108,2,6,8,25.0%,2h
45957,2,Davi,1464,0,0,1,1,0.0%,2h
45958,1,Pelis,1461,916,31,60,91,34.1%,2h
45958,2,juanyolo,1461,94,3,15,18,16.7%,2h
45958,2,JoaoLuiz,1461,0,0,7,7,0.0%,35m
45961,2,TrishaSwisha,1457,48,4,9,13,30.8%,29m
45962,2,arqsebastian,1456,0,1,0,1,100.0%,54m
45963,3,CranPuzzle,1453,0,0,5,5,0.0%,2h
45964,1,quebeckerca,1450,883,28,46,74,37.8%,2h
45964,2,Spanky,1450,0,0,5,5,0.0%,2h
45966,2,ChevalDeg,1447,613,24,44,68,35.3%,52m
45966,2,NorthNomad,1447,154,4,7,11,36.4%,32m
45966,1,Edgar,1447,90,1,6,7,14.3%,2h
45969,3,Walkinzxz,1443,0,1,8,9,11.1%,37m
45970,3,ficcio,1442,1318,43,94,137,31.4%,2h
45971,2,Pook,1440,0,0,12,12,0.0%,7m
45972,1,HJODQWEHGEDW,1438,134,4,21,25,16.0%,3h
45972,3,Raph,1438,0,0,2,2,0.0%,7m
45974,1,Maiden,1437,663,20,41,61,32.8%,46m
45974,3,SnakeEaterD,1437,0,0,1,1,0.0%,2h
45976,2,DaWest,1434,132,3,10,13,23.1%,2h
45976,3,goofy,1434,0,0,5,5,0.0%,37m
45978,2,[EAbad]sfhvuivhiovh,1432,388,14,15,29,48.3%,29m
45978,2,xelnaga,1432,212,7,10,17,41.2%,2h
45980,1,ElPepo,1430,92,4,14,18,22.2%,2h
45981,2,StealthDank,1427,44,1,17,18,5.6%,2h
45982,1,[LSDEX6]Naughty,1425,182,6,18,24,25.0%,53m
45983,2,ARCANJO,1419,1594,96,194,290,33.1%,2h
45984,2,EDFPE,1416,672,20,47,67,29.9%,36m
45985,3,meDaBoss,1414,0,1,1,2,50.0%,2h
45986,2,FOBUS,1413,206,8,24,32,25.0%,2h
45987,1,Red,1407,172,6,29,35,17.1%,2h
45988,2,SeanW,1406,916,29,68,97,29.9%,2h
45989,2,weed,1403,179,3,15,18,16.7%,29m
45990,3,FreeBelarus,1401,0,0,1,1,0.0%,56m
45991,1,Soar,1397,296,9,61,70,12.9%,10m
45992,2,DFSketch,1395,0,0,3,3,0.0%,32m
45993,2,hyperia,1390,248,5,12,17,29.4%,2h
45994,1,LaRepublica,1389,208,4,23,27,14.8%,53m
45995,3,GLKtojlo,1387,32,1,5,6,16.7%,2h
45996,3,[Msia]kek,1382,0,0,1,1,0.0%,2h
45997,1,LuzuanoDQ,1381,188,5,27,32,15.6%,53m
45997,3,benjt,1381,0,1,4,5,20.0%,2h
45999,2,Oghma,1380,139,5,0,5,100.0%,2h
46000,2,MildAutism,1379,194,7,8,15,46.7%,2h
46000,3,DarkMagic,1379,34,2,12,14,14.3%,2h
46000,3,Daneye,1379,0,1,0,1,100.0%,2h
46003,2,yuckeymoney,1377,88,1,2,3,33.3%,37m
46004,2,jefemaestro,1374,30,1,6,7,14.3%,2h
46005,3,sectionist,1367,142,5,7,12,41.7%,42m
46006,1,Lyghtning,1358,310,10,22,32,31.2%,2h
46007,1,EdLions,1356,90,3,24,27,11.1%,2h
46008,1,MISTERJORDAN,1353,0,0,12,12,0.0%,2h
46009,3,DeadlyKitten,1352,30,1,17,18,5.6%,2h
46010,2,Forlan,1350,274,9,31,40,22.5%,45m
46010,3,kennedyfried,1350,30,1,10,11,9.1%,2h
46012,2,FrostBite,1348,118,2,6,8,25.0%,3m
46013,3,llllllllllll,1347,30,1,1,2,50.0%,2h
46013,3,Lucia,1347,0,1,4,5,20.0%,2m
46015,2,Luckysam,1346,616,18,33,51,35.3%,2h
46016,1,Shweddynuts,1343,64,3,31,34,8.8%,16m
46016,3,[Pro999]francinobac,1343,30,1,2,3,33.3%,2h
46018,3,Smarties,1342,0,0,5,5,0.0%,29m
46019,3,POMBEROpy,1341,0,0,2,2,0.0%,14m
46020,1,walteparaiso,1340,781,27,63,90,30.0%,27m
46020,3,Gimya,1340,0,0,2,2,0.0%,37m
46022,2,Rico,1339,0,0,2,2,0.0%,32m
46023,3,spike,1337,30,1,6,7,14.3%,14m
46024,2,Noctis,1335,276,18,27,45,40.0%,2h
46025,2,[THC419]Blazemore,1334,562,15,50,65,23.1%,8m
46025,2,solidsnake,1334,0,0,2,2,0.0%,2h
46027,1,dogman,1329,128,4,29,33,12.1%,2h
46028,3,Canobbio,1327,0,0,2,2,0.0%,29m
46029,1,dlee,1324,1212,47,90,137,34.3%,2h
46030,2,TUBESTEAK,1323,140,4,7,11,36.4%,7m
46031,2,Mighty,1314,0,0,19,19,0.0%,2h
46032,2,MMHM,1312,456,14,29,43,32.6%,29m
46032,3,carl,1312,94,4,14,18,22.2%,35m
46032,3,[DOOM10]masterchief,1312,0,0,1,1,0.0%,29m
46035,1,Camelfarmer,1311,584,32,86,118,27.1%,20m
46036,1,agjil,1306,1037,501,946,1447,34.6%,2h
46037,2,runner,1303,344,12,17,29,41.4%,17m
46038,2,sOs,1302,306,12,65,77,15.6%,16m
46038,3,[CataSC]Player,1302,0,0,3,3,0.0%,37m
46040,2,BOII,1297,436,12,40,52,23.1%,29m
46041,3,erikthered,1296,0,1,4,5,20.0%,29m
46042,3,ugarmig,1292,242,9,35,44,20.5%,13m
46042,3,[TheB4d]TrueLaura,1292,0,1,1,2,50.0%,29m
46044,3,Jyveks,1289,131,6,3,9,66.7%,2h
46045,3,starshed,1288,60,2,19,21,9.5%,2h
46046,3,shaneakira,1287,1105,40,74,114,35.1%,2h
46047,3,karla,1282,124,4,12,16,25.0%,42m
46048,2,IIIIIIIIIII,1280,1662,92,135,227,40.5%,29m
46048,3,overmind,1280,0,0,2,2,0.0%,35m
46050,3,Chaoz,1279,30,2,5,7,28.6%,2m
46051,3,HepatitisLee,1275,0,0,4,4,0.0%,29m
46052,2,juiceling,1269,202,5,28,33,15.2%,16m
46053,3,TemplarDT,1263,58,2,20,22,9.1%,2h
46054,3,SugarBoi,1259,198,6,11,17,35.3%,37m
46055,3,ruben,1256,435,17,29,46,37.0%,2h
46056,3,Michael,1247,0,0,1,1,0.0%,2m
46057,3,JumpinJames,1246,30,1,11,12,8.3%,2h
46058,3,[ALTF04]ARGHunter,1242,30,1,5,6,16.7%,37m
46059,3,PrisonLips,1235,0,0,5,5,0.0%,13m
46060,2,datsitt,1232,90,3,21,24,12.5%,2h
46061,3,pity,1229,190,6,14,20,30.0%,14m
46061,2,[DRKRYL]Goo,1229,0,0,9,9,0.0%,2h
46063,3,[DROM]Espectro,1228,0,0,1,1,0.0%,29m
46064,3,Darthblaze,1223,58,2,4,6,33.3%,7m
46065,3,[boei]pickleman,1221,60,2,9,11,18.2%,2h
46065,3,behemoth,1221,0,1,5,6,16.7%,2h
46067,3,Viarz,1188,130,4,5,9,44.4%,29m
46068,2,hazemaker,1186,376,11,51,62,17.7%,2h
46069,3,Shup,1176,90,3,16,19,15.8%,2h
46070,3,abe,1173,136,5,31,36,13.9%,2h
46071,3,danyphanton,1172,30,1,3,4,25.0%,13m
46072,3,ROGER,1163,70,2,11,13,15.4%,29m
46073,3,tronado,1162,30,1,1,2,50.0%,29m
46074,1,Plecto,1140,1570,595,339,934,63.7%,22m
46075,2,DreamsNvEnd,1119,40,2,15,17,11.8%,2h
46076,3,NeverBiden,1114,30,1,23,24,4.2%,29m
46077,2,silver,1108,265,40,56,96,41.7%,2h
46078,2,Protosspro,1092,254,7,40,47,14.9%,16m
46079,3,JamminJohn,1070,30,1,8,9,11.1%,2h
46080,3,miguelh,1030,86,3,20,23,13.0%,42m
46081,3,[GaOn]Crankit,1010,60,2,12,14,14.3%,29m
46082,3,green,998,60,2,8,10,20.0%,29m
46083,2,Zerg,981,0,0,31,31,0.0%,24m
46084,2,darthCopy,870,1554,695,768,1463,47.5%,2h
46085,3,[coI]AboveTheLaw,817,1092,251,327,578,43.4%,2h
46086,1,Cusigma,682,1200,142,366,508,28.0%,51m
46087,3,WorstplyrNA,634,0,0,2,2,0.0%,2h
46088,3,glhf,598,0,1,4,5,20.0%,29m
46089,3,llllllllllll,591,0,0,1,1,0.0%,2h
