rank,tier,name,mmr,points,wins,losses,played,winrate,age
1,1,[xGenGx]PiLiPiLi,6054,0,1,1,2,50.0%,28m
2,1,[MFSC2]pezzaperry,5911,48,2,1,3,66.7%,7m
3,1,[Ex0n]Burninator,5670,0,1,0,1,100.0%,38m
4,1,[LRKT]Guitarcheese,5636,0,1,0,1,100.0%,46m
5,1,[R1seUP]TheBlazer,5554,48,1,2,3,33.3%,38m
6,1,[PiGPan]PiG,5547,2252,90,86,176,51.1%,3m
7,1,IIIIIIIIIIII,5540,274,9,4,13,69.2%,25m
8,1,[Lolili]Winter,5489,1511,94,69,163,57.7%,3m
9,1,Starlord,5488,0,1,1,2,50.0%,4m
10,2,[RnGpro]Puppypaws,5471,0,1,2,3,33.3%,47m
11,1,[CumNow]Kamker,5435,588,13,14,27,48.1%,38m
12,1,McGregor,5412,569,24,17,41,58.5%,28m
13,1,[Tvitch]PoKoMoM,5356,2868,302,221,523,57.7%,3m
14,2,IrishLad,5355,0,1,0,1,100.0%,38m
15,1,IIIIIIIIIIII,5339,0,1,0,1,100.0%,7m
16,1,[αXLa]GutyECUADOR,5325,1018,26,18,44,59.1%,3m
17,1,[xRtG]Haffey,5309,144,4,1,5,80.0%,35m
18,1,[Groovy]Judgement,5289,228,5,3,8,62.5%,7m
19,1,YessumZero,5268,232,6,2,8,75.0%,33m
20,3,Oreo,5240,0,3,2,5,60.0%,32m
21,1,[EvilGC]SkrOs,5209,0,0,1,1,0.0%,27m
22,1,NightLight,5190,94,3,2,5,60.0%,28m
23,1,[aviNA]aviloSoAmaze,5161,504,14,17,31,45.2%,47m
24,1,[Bee]BerryRAWR,5145,86,2,2,4,50.0%,25m
25,1,saggybooty,5144,1312,89,14,103,86.4%,45m
26,1,[ROOT]ViBE,5141,184,5,2,7,71.4%,51m
27,1,[Ris3n]SacDeFromage,5138,2705,196,162,358,54.7%,3m
28,1,[Cryptc]ElNiño,5134,748,79,51,130,60.8%,38m
28,1,[prxynb]SalbeoL,5134,0,2,0,2,100.0%,34m
30,1,Groovyman,5130,1313,72,40,112,64.3%,38m
31,3,MikeRoss,5115,0,3,2,5,60.0%,47m
32,1,[dastan]selacome,5089,0,1,0,1,100.0%,28m
33,1,[GnR]Naattt,5062,0,1,1,2,50.0%,38m
34,1,BamgOOraY,5050,1466,176,153,329,53.5%,33m
35,1,IIIIIIIIIIII,5048,240,5,16,21,23.8%,34m
36,1,[FabIed]Integral,5024,2436,137,110,247,55.5%,35m
36,1,[Black0]Galeno,5024,0,0,1,1,0.0%,4m
38,1,llllllllllll,5020,304,9,9,18,50.0%,38m
39,1,[ACSS]HeavyFresh,5018,1841,123,93,216,56.9%,7m
40,1,[NOPVP]pHSPUq,5017,0,1,3,4,25.0%,51m
41,1,llllllllllll,5009,0,3,2,5,60.0%,28m
42,1,MilkTerran,4992,0,1,0,1,100.0%,38m
43,1,[ChiFan]ChillerView,4986,0,1,0,1,100.0%,28m
44,1,LaVerdaddy,4983,0,2,2,4,50.0%,25m
45,1,[αX]starkiller,4982,2795,205,167,372,55.1%,3m
46,1,[0ooooo]RedViper,4970,84,5,6,11,45.5%,25m
47,1,BigBird,4961,0,0,2,2,0.0%,7m
48,1,llllllllllll,4957,302,7,8,15,46.7%,37m
48,3,IllIIllllIIl,4957,145,4,0,4,100.0%,32m
50,1,cheeser,4951,911,40,16,56,71.4%,33m
51,1,IIlllIlllIll,4950,0,1,1,2,50.0%,8m
52,1,[ELIDS]QuaNTeL,4948,208,6,2,8,75.0%,34m
53,2,atom,4936,312,17,1,18,94.4%,8m
54,1,IIIIIIIIII,4935,122,4,0,4,100.0%,47m
55,1,[RnGpro]Goomba,4934,230,7,4,11,63.6%,35m
55,1,IIIIIIIIIIII,4934,0,2,3,5,40.0%,25m
57,3,[DTokes]TerranTears,4932,121,3,0,3,100.0%,47m
58,1,[LGCANZ]MeomaikaFan,4931,670,19,26,45,42.2%,7m
59,1,IIIIIIllllll,4929,0,2,1,3,66.7%,5m
60,1,newtoRTS,4917,1322,71,36,107,66.4%,30m
61,1,CCalms,4915,48,4,1,5,80.0%,46m
62,1,[cl0udM]Eurystheus,4911,0,1,9,10,10.0%,38m
63,1,llllllllllll,4910,315,12,7,19,63.2%,33m
64,1,FeelsBadMan,4906,86,6,2,8,75.0%,25m
65,1,Rascalllllll,4904,0,0,1,1,0.0%,44m
66,1,llllllllllll,4903,0,4,1,5,80.0%,33m
67,1,Yoyo,4900,625,29,11,40,72.5%,7m
67,1,RuFF,4900,554,19,11,30,63.3%,25m
67,1,WigglyWeenie,4900,116,5,3,8,62.5%,51m
70,1,[BYU]DelisDaily,4882,238,6,1,7,85.7%,27m
71,1,[Dundy]Dundy,4872,0,0,1,1,0.0%,3m
72,1,[Macac0]JimRising,4870,1298,49,62,111,44.1%,38m
73,1,[RBTH]ShotnVelt,4861,0,3,2,5,60.0%,38m
74,1,DUKnowKimchi,4854,126,6,3,9,66.7%,45m
75,1,[GetThe]LambSauce,4842,338,11,7,18,61.1%,33m
76,1,[αXLa]eGGz,4840,334,13,19,32,40.6%,28m
77,1,[Micr0]ImpKing,4838,0,1,0,1,100.0%,28m
78,1,[FRMAGE]ColWombaT,4837,2972,477,452,929,51.3%,45m
78,1,Koala,4837,199,15,2,17,88.2%,38m
78,1,[SNlPED]EZcheezy,4837,0,0,1,1,0.0%,51m
81,1,[WNTR]WinterSC,4829,680,23,20,43,53.5%,47m
82,2,[ROOT]RanDOOM,4828,34,2,4,6,33.3%,41m
83,1,[GnR]Asturias,4820,221,8,10,18,44.4%,51m
84,1,[PPayne]FenrisWolf,4817,0,0,1,1,0.0%,38m
85,1,XIV,4810,530,28,13,41,68.3%,28m
86,1,Isaiah,4809,0,1,0,1,100.0%,3m
87,1,[xRtG]NamhciR,4808,1691,66,66,132,50.0%,28m
88,1,[Th3Bad]nLghosT,4804,0,0,1,1,0.0%,34m
89,1,Meclizine,4802,506,35,7,42,83.3%,51m
90,1,Golden,4801,44,2,1,3,66.7%,7m
91,1,[AvsA]PsYche,4800,64,3,3,6,50.0%,4m
92,1,[ShoaL]EeVee,4799,0,1,0,1,100.0%,33m
93,3,[PSC]Mokomi,4798,247,10,11,21,47.6%,43m
94,1,Cloudy,4795,401,12,9,21,57.1%,3m
95,1,Boomer,4790,0,3,4,7,42.9%,48m
96,1,[DhZCom]DakkoN,4788,616,30,23,53,56.6%,35m
97,1,QQtower,4784,150,6,6,12,50.0%,7m
98,1,[AlIin]Yoyo,4782,520,15,16,31,48.4%,45m
99,2,[ObiWan]Kenobi,4781,16,2,0,2,100.0%,37m
100,1,[Ris3n]PBOY,4773,112,3,5,8,37.5%,3m
101,1,Apple,4770,104,4,7,11,36.4%,8m
102,3,chilax,4769,0,1,0,1,100.0%,40m
103,1,XIX,4766,0,1,3,4,25.0%,30m
104,1,IlllIIllIlIl,4763,0,1,2,3,33.3%,3m
104,2,[ValidG]Thor,4763,0,0,1,1,0.0%,11m
106,1,IIIIIIIIIIII,4761,289,12,4,16,75.0%,25m
107,1,goya,4758,2881,197,149,346,56.9%,3m
108,1,[CaptA]Sentinel,4754,2220,119,76,195,61.0%,38m
109,1,[G0G0G0]Austin,4745,0,0,1,1,0.0%,44m
110,2,IrishLad,4740,0,1,1,2,50.0%,41m
111,2,nochat,4734,434,27,5,32,84.4%,34m
112,1,dumpster,4727,1115,148,128,276,53.6%,38m
113,1,Crush,4723,104,3,7,10,30.0%,47m
114,2,llllllllllll,4722,437,24,11,35,68.6%,41m
115,1,Nepal,4720,48,4,2,6,66.7%,36m
116,2,[GR33D]RogueZZ,4719,841,35,30,65,53.8%,40m
116,1,PeaKnuckles,4719,326,11,14,25,44.0%,38m
118,2,[WNTRCO]Brenda,4718,366,15,6,21,71.4%,38m
119,2,[N0FKz]iDrone,4717,0,1,1,2,50.0%,14m
120,2,[PCAKE]SiF,4713,26,1,2,3,33.3%,14m
121,1,IIIIIIIIIII,4712,446,17,20,37,45.9%,33m
122,2,[afterM]Albino,4710,0,0,1,1,0.0%,11m
123,2,Shades,4707,330,13,6,19,68.4%,29m
123,1,[MadK]Shellbee,4707,0,2,6,8,25.0%,30m
125,3,Dragon,4700,169,7,7,14,50.0%,3m
125,1,[CIoud9]IlllllI,4700,48,5,2,7,71.4%,30m
127,2,Marko,4698,0,0,1,1,0.0%,38m
128,1,[UFL]Flench,4693,0,0,1,1,0.0%,41m
129,1,[FRNAVY]Beltalowda,4687,192,5,14,19,26.3%,8m
130,2,PERVERTtoss,4683,0,0,1,1,0.0%,31m
131,1,[Lp]BrEnDaN,4678,1504,56,59,115,48.7%,27m
132,2,[αX]ViruS,4671,0,1,0,1,100.0%,8m
133,2,[TYRNT]Yharim,4667,595,35,12,47,74.5%,33m
134,2,Random,4666,379,21,2,23,91.3%,11m
135,2,SrryGtg,4664,0,1,0,1,100.0%,42m
136,2,WhineFarmer,4662,570,36,17,53,67.9%,11m
137,1,CroOK,4657,0,1,1,2,50.0%,28m
138,2,[Scyth]WaEsOpH,4654,0,1,0,1,100.0%,47m
139,2,[SsaYnS]Caloreen,4652,2059,120,110,230,52.2%,8m
139,2,root,4652,548,30,19,49,61.2%,13m
139,2,[FZ]Cobalt,4652,0,0,1,1,0.0%,42m
142,2,[BIacer]MogarFNSMASH,4648,58,4,1,5,80.0%,8m
143,2,[BRSKR]Washikie,4646,2493,408,444,852,47.9%,33m
144,2,Berzerker,4644,70,4,4,8,50.0%,14m
145,2,TerranUApart,4641,645,32,17,49,65.3%,11m
145,1,[KingSC]FanTYTY,4641,74,4,9,13,30.8%,8m
145,2,Solzhenitsyn,4641,0,2,3,5,40.0%,51m
148,3,[xRtG]SorroW,4640,8,2,1,3,66.7%,46m
149,2,[HRBNGR]SeOuLStEaL,4639,14,1,5,6,16.7%,51m
150,2,[xRtG]Ambition,4637,2072,89,81,170,52.4%,11m
150,2,XLIMIT,4637,291,10,6,16,62.5%,40m
150,1,[dLife]Ascarecroww,4637,0,1,1,2,50.0%,43m
153,2,IIIIIIIIIIII,4635,1231,64,22,86,74.4%,11m
154,2,MasterKenobi,4630,89,5,3,8,62.5%,13m
155,2,llllllllll,4629,40,2,0,2,100.0%,13m
156,2,Vister,4628,38,2,1,3,66.7%,37m
157,2,ZaramayBaby,4626,123,4,5,9,44.4%,8m
158,2,[RiGO]PrayeR,4625,80,4,5,9,44.4%,42m
158,2,IIIIIIIIIIII,4625,0,1,0,1,100.0%,51m
160,2,MooNLighT,4624,638,33,35,68,48.5%,31m
160,2,KelaFan,4624,181,4,3,7,57.1%,38m
160,1,IIIIIIIIIIII,4624,62,2,17,19,10.5%,30m
160,2,InsoydGaymin,4624,0,0,1,1,0.0%,11m
164,1,TulaGRANDE,4623,0,3,6,9,33.3%,33m
164,2,PewpSokk,4623,0,0,2,2,0.0%,42m
166,1,[NeAs]MaelG,4616,144,3,5,8,37.5%,49m
167,2,[F0cus]dozer,4613,0,1,0,1,100.0%,29m
168,2,Dreamer,4611,0,0,2,2,0.0%,34m
169,2,Mejkstar,4609,378,17,8,25,68.0%,31m
169,2,KiwiTaco,4609,0,0,1,1,0.0%,31m
169,2,[WNTRCH]CheesyRandom,4609,0,0,1,1,0.0%,41m
172,2,[GTBIG]Rayden,4608,0,1,0,1,100.0%,47m
173,2,[eX]ReMy,4605,28,2,3,5,40.0%,51m
174,2,[iMkS]SoldieR,4603,0,1,2,3,33.3%,38m
175,2,IIIIIIIIIIII,4602,76,1,4,5,20.0%,38m
176,2,[RnGpro]Prototype,4598,375,27,13,40,67.5%,37m
177,2,[GTs]Lunchador,4593,625,62,63,125,49.6%,38m
178,2,SlipperyFart,4592,199,11,6,17,64.7%,14m
179,2,TwitchMaster,4589,0,3,3,6,50.0%,29m
179,2,[AlIin]WyScion,4589,0,2,3,5,40.0%,11m
179,2,RandomName,4589,0,0,2,2,0.0%,37m
182,2,NaCl,4588,0,1,0,1,100.0%,42m
183,2,[KiMBR]FeraMansa,4584,186,8,6,14,57.1%,13m
184,2,[NovaX]Imagine,4577,1615,139,107,246,56.5%,41m
185,2,Zenith,4575,249,10,4,14,71.4%,47m
186,2,Sorrygtg,4574,332,17,3,20,85.0%,38m
187,1,[αX]Psych,4571,1991,76,83,159,47.8%,34m
187,2,IIIIIIIIIIII,4571,0,1,0,1,100.0%,51m
189,2,PracticeY,4567,0,0,1,1,0.0%,29m
190,2,[Ris3n]Richard,4563,74,4,4,8,50.0%,34m
191,2,FMage,4558,1865,82,65,147,55.8%,11m
191,1,[FANXY]Paul,4558,0,0,1,1,0.0%,43m
191,2,Kingslayer,4558,0,0,2,2,0.0%,51m
194,2,[M0DE]BLISSMODE,4557,1909,111,105,216,51.4%,37m
195,2,[SABO]Saboteur,4554,88,4,5,9,44.4%,47m
196,1,Random,4553,344,14,3,17,82.4%,13m
196,2,[L4CRA]Futoshiki,4553,231,9,16,25,36.0%,34m
196,1,[αXLa]TheVirusLove,4553,241,4,6,10,40.0%,10m
196,2,[Coach]Dink,4553,0,0,2,2,0.0%,14m
200,3,[NPhase]AeTherKuRyku,4550,38,3,1,4,75.0%,47m
201,1,llllllllllll,4547,375,18,0,18,100.0%,41m
202,2,Brom,4546,97,1,3,4,25.0%,14m
203,3,[L4CRA]LaMamaDelron,4545,163,8,10,18,44.4%,31m
204,3,[xLgNx]GranTurismo,4544,0,0,1,1,0.0%,6m
205,3,MinBikCok,4543,0,1,0,1,100.0%,7m
206,3,[eX]Dorminhoco,4541,0,0,1,1,0.0%,45m
206,2,Realstreetg,4541,0,0,2,2,0.0%,34m
208,3,MorganWallen,4540,0,0,1,1,0.0%,50m
209,3,[ArGNA]picur,4535,0,1,0,1,100.0%,45m
209,3,[YUNHAO]Flume,4535,0,1,0,1,100.0%,32m
211,3,DrDronage,4533,0,1,0,1,100.0%,45m
212,2,Terminus,4529,1937,123,111,234,52.6%,29m
213,3,PeterHartz,4528,0,1,0,1,100.0%,11m
213,3,[PwT]Christ,4528,0,1,1,2,50.0%,26m
215,1,BTGMGroovy,4526,0,0,9,9,0.0%,47m
216,2,llllllllllll,4525,0,0,5,5,0.0%,29m
217,2,ssapchobo,4524,74,2,1,3,66.7%,51m
218,2,JoniMitchell,4518,96,3,3,6,50.0%,34m
218,3,RobBedstain,4518,0,1,0,1,100.0%,4m
220,3,NandoWORD,4514,0,0,1,1,0.0%,52m
221,3,[αXLa]Deklan,4511,0,0,1,1,0.0%,50m
222,2,[lNI]Eldrid,4508,22,2,6,8,25.0%,29m
222,3,[Atira]Akoo,4508,0,1,0,1,100.0%,43m
224,3,[Ris3n]CollegeWings,4507,0,1,0,1,100.0%,26m
225,3,Suki,4506,22,4,4,8,50.0%,47m
226,3,[4RUM]DerMeister,4504,40,4,6,10,40.0%,11m
227,3,FreeCoaching,4503,0,5,0,5,100.0%,50m
228,2,[PSISTM]EndOfLine,4502,1010,44,46,90,48.9%,29m
229,2,[DhZPro]TAG,4500,0,3,2,5,60.0%,48m
230,3,[SsaYnS]Tachypsychia,4499,0,0,2,2,0.0%,4m
231,3,[EzW]LonelyZealot,4497,22,1,2,3,33.3%,3m
232,2,llIlIIIllIlI,4496,258,11,17,28,39.3%,29m
233,3,[TGosuD]Lightborn,4495,222,15,16,31,48.4%,11m
234,2,[RBTH]MakroMaraude,4492,2115,141,131,272,51.8%,31m
234,3,ColiNerTiA,4492,0,1,0,1,100.0%,9m
236,3,KillazZ,4489,0,1,0,1,100.0%,32m
237,3,Zen,4487,0,0,2,2,0.0%,47m
238,3,[GumZ]NatroNix,4484,334,11,8,19,57.9%,4m
239,2,EzGameEzLife,4481,80,3,10,13,23.1%,38m
240,1,ProtossOP,4476,437,14,10,24,58.3%,44m
240,3,everNExt,4476,2,1,1,2,50.0%,45m
240,3,[NEFN]ignorant,4476,0,0,1,1,0.0%,7m
243,3,[SsaYnS]Demiurge,4472,40,5,5,10,50.0%,37m
244,3,GETOUT,4469,26,5,6,11,45.5%,37m
245,3,KappaRoss,4468,44,6,4,10,60.0%,3m
246,2,[Ris3n]Koda,4462,727,34,26,60,56.7%,37m
247,3,[ArGNA]YaNaRion,4461,812,55,39,94,58.5%,7m
247,3,[CaptA]CrimsonChaos,4461,0,1,0,1,100.0%,11m
249,3,Inkarnate,4459,376,27,25,52,51.9%,4m
250,1,[BLM4Ev]RIPGeorgeF,4458,0,1,0,1,100.0%,4m
250,1,llllllllllll,4458,0,0,2,2,0.0%,50m
252,3,Ratimus,4457,28,3,2,5,60.0%,31m
253,1,[BoSe69]Thortralisk,4454,2664,148,144,292,50.7%,38m
254,3,[xNtG]Tasty,4449,0,1,1,2,50.0%,41m
255,2,[DarkAG]tunechi,4448,788,38,31,69,55.1%,31m
256,2,jaMz,4446,115,8,8,16,50.0%,41m
256,3,iStimUwin,4446,0,1,1,2,50.0%,3m
256,3,[CnfOD]CharAznable,4446,0,0,3,3,0.0%,47m
259,1,AlphaStar,4443,0,0,1,1,0.0%,44m
260,2,Punisher,4441,2286,226,234,460,49.1%,29m
260,3,Ajax,4441,80,9,5,14,64.3%,31m
262,2,[FvR]Flamyblade,4440,258,13,16,29,44.8%,38m
263,2,[RBTH]Zura,4439,516,22,30,52,42.3%,41m
264,3,SunRise,4438,519,32,31,63,50.8%,4m
264,3,[DhZPro]Terranosaur,4438,4,2,3,5,40.0%,40m
264,3,[M4nLUV]TitusZell,4438,0,0,1,1,0.0%,32m
267,2,[Ex0n]NetBio,4435,48,3,4,7,42.9%,3m
267,2,Sunlight,4435,0,0,2,2,0.0%,43m
269,3,IlIlIlIlIlIl,4433,14,2,0,2,100.0%,4m
269,3,Cadenza,4433,0,1,4,5,20.0%,52m
271,2,Nepho,4431,0,4,1,5,80.0%,4m
272,3,[SsaYnS]BigMac,4430,0,1,1,2,50.0%,43m
273,3,Artifice,4429,4,1,1,2,50.0%,4m
274,3,[ShoaL]Rain,4424,0,0,1,1,0.0%,6m
274,3,IlIlllIIll,4424,0,0,1,1,0.0%,28m
276,3,VibrantBlue,4420,1865,117,112,229,51.1%,13m
276,3,lllllllllX,4420,0,1,0,1,100.0%,50m
278,3,[hTx]Shrimp,4416,86,8,9,17,47.1%,13m
279,3,Antoine,4415,0,0,5,5,0.0%,13m
280,3,Ascendead,4414,8,1,1,2,50.0%,9m
281,3,[1E100]whoyou,4413,0,5,0,5,100.0%,46m
282,3,[NwAs]Draconix,4410,216,19,27,46,41.3%,40m
282,3,[DNKCFT]iveseensmolr,4410,56,14,14,28,50.0%,11m
284,3,[RØR]RoMSHoT,4409,6,1,1,2,50.0%,3m
285,3,[JaMiT]Flexxi,4408,0,0,5,5,0.0%,13m
286,3,Greedylee,4407,309,51,33,84,60.7%,11m
286,3,Wontstop,4407,0,0,4,4,0.0%,31m
288,3,Fingerer,4406,4,2,1,3,66.7%,50m
289,3,[FxB]Trumpet,4403,334,16,21,37,43.2%,32m
290,1,[KORKOR]Kimchi,4402,0,0,1,1,0.0%,50m
291,3,[Kaii]BabyDriver,4401,0,0,1,1,0.0%,25m
292,3,[NPhase]MeronG,4398,8,2,4,6,33.3%,13m
293,2,Cooperation,4395,717,34,47,81,42.0%,13m
294,3,[RUMB]JAKETHESNAKE,4394,0,1,1,2,50.0%,43m
295,2,Wislakrakow,4390,94,4,5,9,44.4%,5m
296,3,[M4nLUV]SacSurgeon,4389,379,16,13,29,55.2%,46m
297,3,[tdrs]Lee,4388,0,0,1,1,0.0%,13m
298,3,[Lp]TheDarkOne,4385,0,1,0,1,100.0%,26m
299,3,IIIIIIIIIIII,4384,292,16,0,16,100.0%,26m
299,3,[MAYN]Frequency,4384,0,0,1,1,0.0%,40m
301,3,Jack,4383,207,17,21,38,44.7%,32m
302,3,[PSlSTC]Misery,4377,30,4,4,8,50.0%,40m
303,2,Egwene,4376,934,49,60,109,45.0%,51m
303,3,Azula,4376,176,7,3,10,70.0%,46m
305,3,Mint,4374,44,5,5,10,50.0%,40m
306,3,Smash,4373,823,47,44,91,51.6%,50m
307,3,[LTK]bakla,4370,0,4,1,5,80.0%,45m
307,1,[UpeV]Arrow,4370,0,1,0,1,100.0%,13m
309,3,Imagine,4368,787,132,141,273,48.4%,31m
309,3,Ralphie,4368,10,3,2,5,60.0%,28m
311,3,[aivNA]fig,4365,817,35,25,60,58.3%,50m
311,3,Flitzer,4365,0,0,1,1,0.0%,3m
313,3,Vengeance,4364,101,2,2,4,50.0%,43m
314,3,ComeAtMeBrah,4362,569,36,13,49,73.5%,47m
315,3,Pancake,4361,127,4,0,4,100.0%,3m
315,3,[RBTH]CristianoX,4361,8,1,2,3,33.3%,26m
315,2,PkBLUE,4361,0,1,3,4,25.0%,41m
315,3,Shiisi,4361,0,0,6,6,0.0%,52m
319,3,[HRBNGR]Hupsaiya,4360,10,2,4,6,33.3%,4m
320,2,[TGCF]GOTRUMPGO,4359,92,7,2,9,77.8%,35m
321,3,[puCked]Black,4358,2139,263,265,528,49.8%,3m
321,3,SnakeMarine,4358,507,33,19,52,63.5%,3m
321,3,[TMMM]Achilles,4358,0,1,0,1,100.0%,13m
324,2,bayagster,4357,876,53,69,122,43.4%,42m
325,3,Megatron,4356,20,2,6,8,25.0%,4m
326,3,[BtnBot]tyzor,4355,0,1,0,1,100.0%,31m
327,3,ReDPanDa,4354,40,5,5,10,50.0%,11m
327,3,ENaSSaJJaGa,4354,138,4,2,6,66.7%,3m
329,2,Shrike,4352,42,1,3,4,25.0%,30m
329,1,Ajaxz,4352,0,0,1,1,0.0%,47m
331,3,[Impact]SushiSamurai,4351,215,9,3,12,75.0%,32m
331,3,[MTMRK]HunterKiller,4351,101,2,1,3,66.7%,11m
333,3,FLawLesS,4349,601,85,77,162,52.5%,43m
333,3,GamIsSecHome,4349,114,13,13,26,50.0%,32m
333,3,Brom,4349,105,3,0,3,100.0%,28m
333,3,[cfaftw]Pheo,4349,0,1,4,5,20.0%,46m
333,3,[RUTG]Kortflog,4349,8,1,5,6,16.7%,32m
338,3,Toyhouze,4348,54,6,9,15,40.0%,13m
339,3,[DETER]SOL,4347,215,56,27,83,67.5%,3m
340,3,SorryGTG,4346,284,16,2,18,88.9%,31m
341,3,ByeonGgEo,4345,2245,323,318,641,50.4%,7m
341,3,Ghostie,4345,0,0,2,2,0.0%,6m
343,3,HesiHeyyyy,4344,1111,125,88,213,58.7%,3m
344,3,[FTII]Xymakari,4343,121,3,5,8,37.5%,46m
345,3,llllllllllll,4342,885,45,19,64,70.3%,7m
345,3,Moderate,4342,764,42,21,63,66.7%,42m
345,3,[KingSC]IMDaggoth,4342,153,15,10,25,60.0%,40m
348,3,HappySunday,4341,620,113,70,183,61.7%,32m
349,3,Phive,4340,193,5,2,7,71.4%,13m
349,3,[REPORT]captainboys,4340,14,3,2,5,60.0%,43m
351,3,Archile,4339,96,13,15,28,46.4%,7m
351,3,EnvY,4339,218,6,2,8,75.0%,37m
353,3,index,4338,347,13,8,21,61.9%,45m
354,3,[FANXY]llllllllllll,4337,476,20,11,31,64.5%,13m
354,3,[LowIQ]Cosmocraft,4337,124,12,16,28,42.9%,13m
354,3,[500mms]Paul,4337,0,1,4,5,20.0%,25m
357,3,zettick,4336,1141,55,30,85,64.7%,42m
357,3,[BoRnGo]Steffan,4336,277,9,13,22,40.9%,6m
357,2,[αXLa]Supremo,4336,0,3,2,5,60.0%,26m
360,3,PkDriloon,4335,274,16,0,16,100.0%,47m
361,3,protein,4334,343,13,3,16,81.2%,45m
361,3,[M4A1]ISOMER,4334,16,4,5,9,44.4%,50m
363,3,IIIIIII,4333,97,1,1,2,50.0%,26m
364,3,BanelingKing,4332,134,183,197,380,48.2%,13m
364,2,SIDINHO,4332,44,3,3,6,50.0%,37m
366,3,[neuroS]ALLMIGHT,4330,68,9,14,23,39.1%,31m
367,3,barcode,4329,446,34,34,68,50.0%,32m
367,2,[SCTP]llllllllllll,4329,0,2,1,3,66.7%,41m
367,3,BlitzZz,4329,0,1,0,1,100.0%,52m
367,3,[RevAng]SHAORAN,4329,97,1,1,2,50.0%,45m
371,3,llllllllllll,4328,154,14,17,31,45.2%,13m
371,3,PSY,4328,30,6,10,16,37.5%,32m
373,3,JustinBieber,4327,146,6,3,9,66.7%,7m
374,3,Powerhouse,4326,491,41,49,90,45.6%,11m
374,3,South,4326,205,12,5,17,70.6%,3m
374,3,nikwelik,4326,6,3,3,6,50.0%,7m
374,3,CHL,4326,20,2,5,7,28.6%,40m
378,3,[KingSC]LSPisBack,4325,0,0,1,1,0.0%,3m
379,3,LUNATIC,4324,437,64,61,125,51.2%,32m
380,3,Modena,4323,193,5,1,6,83.3%,26m
380,3,ProtossOP,4323,121,2,2,4,50.0%,47m
382,3,EECSFOREVER,4322,1668,314,282,596,52.7%,26m
382,3,GamerMD,4322,530,25,13,38,65.8%,45m
384,3,lVlagic,4321,14,3,5,8,37.5%,7m
385,3,LimeHero,4320,1300,69,75,144,47.9%,32m
385,2,Bananastar,4320,258,7,3,10,70.0%,6m
385,3,PAOLO,4320,108,2,1,3,66.7%,52m
388,1,Bango,4319,48,1,1,2,50.0%,39m
389,2,[Cryptc]SirDidymus,4318,0,0,2,2,0.0%,38m
390,2,Kratom,4315,266,8,0,8,100.0%,35m
391,3,[TxC1]TakeMyHand,4312,955,153,154,307,49.8%,50m
392,3,AIphaStar,4308,439,27,26,53,50.9%,3m
392,3,Eulogy,4308,272,9,8,17,52.9%,45m
394,1,OIOQ,4305,0,1,0,1,100.0%,36m
395,2,PirulitO,4302,96,3,3,6,50.0%,26m
396,2,[cl0udM]Nagaeiku,4301,533,29,42,71,40.8%,29m
397,3,[GØSU]bobabomber,4300,156,6,4,10,60.0%,40m
398,3,ALBANINJA,4297,684,35,20,55,63.6%,42m
399,3,[SPACEX]Quantum,4294,79,41,35,76,53.9%,40m
400,1,SkyFlake,4293,0,4,1,5,80.0%,32m
401,3,Neo,4291,0,3,3,6,50.0%,42m
401,1,IIIIllllIII,4291,0,0,1,1,0.0%,43m
403,3,llllllllllll,4289,404,32,27,59,54.2%,32m
403,2,HakunaMatata,4289,92,4,3,7,57.1%,8m
403,1,[xTQc]InZo,4289,0,0,1,1,0.0%,25m
406,3,[αXi]ThiasHP,4286,554,62,57,119,52.1%,4m
407,3,[INextI]Bogue,4284,109,4,5,9,44.4%,47m
408,1,[425]dugo,4281,48,1,3,4,25.0%,36m
409,1,KimchiFuxker,4280,500,16,8,24,66.7%,41m
409,1,Oniichan,4280,0,0,5,5,0.0%,41m
411,1,SatireMan,4279,0,1,4,5,20.0%,3m
412,2,[KiMBR]Pikeno,4277,0,0,2,2,0.0%,53m
413,1,[NwAs]Gonzalo,4273,0,0,1,1,0.0%,32m
413,1,[SABO]Colourizing,4273,0,0,3,3,0.0%,13m
415,3,[BxLxM]MarkHenry,4270,707,129,115,244,52.9%,6m
416,2,Ykrang,4267,0,0,1,1,0.0%,6m
417,3,[NovaX]octomologyst,4265,454,23,26,49,46.9%,42m
417,2,[C96]LeeMongChuPa,4265,0,1,0,1,100.0%,38m
419,1,OFRparis,4263,0,1,1,2,50.0%,9m
420,3,maniachillo,4262,405,20,11,31,64.5%,3m
420,2,Bonaparte,4262,275,14,0,14,100.0%,29m
420,1,[Lp]JerrodSwag,4262,268,7,9,16,43.8%,39m
420,2,[TSØP]RenesoundGB,4262,0,0,1,1,0.0%,48m
424,1,[IMDSI]EtherNal,4260,192,4,6,10,40.0%,36m
425,2,[CSGO]Nostalgia,4257,0,1,0,1,100.0%,41m
425,1,Nobody,4257,0,1,0,1,100.0%,44m
427,3,ElmerFudd,4256,1195,82,82,164,50.0%,32m
427,2,Kuyzz,4256,0,0,1,1,0.0%,29m
429,2,FreeHongKong,4253,0,1,0,1,100.0%,39m
430,3,rickybobby,4252,318,30,19,49,61.2%,25m
431,3,[Kingx]Romeo,4251,1118,77,77,154,50.0%,9m
431,1,[PLA2N]JashaStar,4251,0,0,1,1,0.0%,47m
433,2,lIllllIIIIlI,4249,44,1,2,3,33.3%,44m
434,1,[PSISTM]Freeedom,4248,192,5,1,6,83.3%,5m
435,2,Makero,4247,186,5,2,7,71.4%,49m
435,2,Hank,4247,0,1,1,2,50.0%,9m
437,1,TRuDUK,4246,303,17,2,19,89.5%,46m
437,1,SnækPlatypus,4246,0,0,1,1,0.0%,39m
439,2,Eyjafjallajo,4245,88,4,2,6,66.7%,28m
440,1,Kratom,4244,249,13,0,13,100.0%,39m
441,3,[DarkAG]PKV,4241,148,14,23,37,37.8%,13m
441,1,llllllllllll,4241,0,1,1,2,50.0%,44m
443,1,ShowKhan,4237,240,6,4,10,60.0%,53m
444,1,[LimaSC]vergas,4236,1078,27,15,42,64.3%,33m
445,3,[Cryptc]Astra,4235,951,80,88,168,47.6%,7m
445,1,EmailAddress,4235,1135,38,23,61,62.3%,36m
445,3,[NeAs]Anxiety,4235,121,3,6,9,33.3%,38m
445,1,[VetZCo]POODLEHAT,4235,48,1,2,3,33.3%,46m
449,1,[TKCT]NecrO,4231,0,2,3,5,40.0%,8m
450,3,Victor,4229,121,8,9,17,47.1%,47m
451,1,[NPhase]VelvetThunda,4223,536,13,7,20,65.0%,48m
452,3,[LTK]Redeye,4222,108,15,19,34,44.1%,3m
452,1,[Bloody]NotASword,4222,48,2,9,11,18.2%,5m
452,2,[SNSD]Zemagdnim,4222,0,1,1,2,50.0%,38m
455,1,moki,4220,612,14,9,23,60.9%,49m
456,1,[lCY]SieGe,4218,0,1,2,3,33.3%,47m
456,1,[SydTT]IIIIIIIIIIII,4218,0,0,4,4,0.0%,48m
458,1,Zothiel,4216,391,16,2,18,88.9%,9m
459,3,Vindicarian,4214,154,15,26,41,36.6%,43m
459,2,llllllllll,4214,118,2,5,7,28.6%,38m
461,1,JKap,4213,789,42,21,63,66.7%,3m
462,1,[Ris3n]butterfly,4212,192,5,7,12,41.7%,45m
463,1,[UoM]HailStorm,4211,384,9,6,15,60.0%,27m
463,1,[AthSun]Aysymer,4211,0,1,0,1,100.0%,33m
465,1,[GGu2EZ]HeReTiC,4210,208,6,3,9,66.7%,48m
466,1,Triste,4209,0,1,1,2,50.0%,4m
467,1,[PCAKE]Pancake,4208,1463,42,49,91,46.2%,49m
467,1,PillowFight,4208,578,14,10,24,58.3%,41m
469,3,Pegasides,4207,64,16,24,40,40.0%,47m
470,1,Hammer,4206,0,0,3,3,0.0%,34m
471,1,dropout,4205,1028,76,40,116,65.5%,47m
471,1,LhornyTorynK,4205,1798,68,34,102,66.7%,43m
471,3,[JGalt]silentcoup,4205,38,10,17,27,37.0%,13m
471,1,Seki,4205,0,3,0,3,100.0%,38m
471,2,MaCroN,4205,0,0,1,1,0.0%,37m
476,1,[MONO]NrGHumble,4204,1519,46,27,73,63.0%,53m
477,1,LizrdChuckle,4203,48,1,1,2,50.0%,49m
478,1,Daddy,4202,1689,63,45,108,58.3%,50m
478,1,NaviDR,4202,1311,31,24,55,56.4%,32m
478,2,IronmanDies,4202,0,1,0,1,100.0%,10m
481,1,[DthW]Astinio,4199,0,1,0,1,100.0%,38m
481,1,mint,4199,0,0,1,1,0.0%,32m
483,2,huh,4198,283,14,1,15,93.3%,45m
484,1,llll,4197,0,0,2,2,0.0%,6m
485,3,Android,4196,306,20,33,53,37.7%,40m
486,1,llllllllllll,4194,206,8,5,13,61.5%,13m
487,1,elias,4191,48,2,0,2,100.0%,47m
487,1,[JOSUN]Sylla,4191,0,0,1,1,0.0%,36m
489,1,[GLAD]AoNe,4187,0,0,2,2,0.0%,47m
490,1,[UpeV]SMSakurazawa,4186,240,6,3,9,66.7%,14m
491,1,ImFromWuhan,4185,0,1,0,1,100.0%,4m
492,3,Name,4183,2108,394,366,760,51.8%,13m
493,1,[PTHero]esReveR,4181,1964,208,203,411,50.6%,25m
493,1,[AngelA]Angelus,4181,0,1,0,1,100.0%,52m
495,1,[gohchu]yubang,4178,964,27,30,57,47.4%,4m
495,1,[DikBoy]Light,4178,822,20,20,40,50.0%,28m
497,1,Memeling,4176,929,30,18,48,62.5%,33m
497,3,[CSGO]HellSing,4176,166,14,32,46,30.4%,40m
497,1,[Cryptc]CyStorm,4176,0,1,1,2,50.0%,53m
497,3,[LAAR]Spawn,4176,0,0,1,1,0.0%,43m
501,1,PrincessChaz,4174,628,14,16,30,46.7%,39m
502,2,[H0PES]HopeTurtle,4173,0,3,5,8,37.5%,38m
503,1,Apoptosis,4172,0,0,2,2,0.0%,49m
504,1,[LowIQ]Elryia,4169,0,0,1,1,0.0%,3m
504,1,[lLiTl]Broketail,4169,0,0,3,3,0.0%,14m
506,1,Potatoking,4168,538,13,5,18,72.2%,44m
506,1,[JaMiT]BigBoyLing,4168,96,3,2,5,60.0%,6m
508,1,FIGJAM,4167,48,2,0,2,100.0%,49m
508,1,TylerOkurbak,4167,0,0,1,1,0.0%,52m
510,1,[TGCrew]KCal,4166,951,27,11,38,71.1%,36m
511,1,[G0G0G0]IIIIIIIIIIII,4165,238,5,4,9,55.6%,13m
512,3,BenImmortal,4164,2027,292,124,416,70.2%,31m
512,1,gag,4164,509,16,16,32,50.0%,4m
512,2,ReallyNoob,4164,0,1,0,1,100.0%,50m
515,1,[TXOP]ChevChelios,4161,48,3,6,9,33.3%,4m
516,1,Present,4160,420,9,5,14,64.3%,47m
516,3,damo,4160,115,5,10,15,33.3%,38m
516,1,[GØSU]zyclon,4160,142,4,1,5,80.0%,44m
519,1,[ToRQ]Wade,4159,644,19,13,32,59.4%,31m
520,1,[NovaX]TwoMeows,4156,1012,22,26,48,45.8%,49m
520,3,zachxxx,4156,0,1,4,5,20.0%,13m
522,1,[SL7R]Voodoo,4154,144,3,6,9,33.3%,49m
522,1,[AdaptG]JoySynthetic,4154,0,1,0,1,100.0%,9m
522,1,[RUMB]SCwizard,4154,0,0,1,1,0.0%,46m
525,3,[DarkAG]Dro,4153,2092,224,165,389,57.6%,28m
526,3,Haven,4152,0,3,3,6,50.0%,7m
527,3,Vanish,4151,0,0,1,1,0.0%,28m
528,1,[S4V4G3]zãÿØ,4149,382,8,17,25,32.0%,6m
528,1,[Bizarr]aRtH,4149,0,0,1,1,0.0%,4m
530,3,llllllllllll,4148,799,105,97,202,52.0%,4m
530,1,SiTuaTioN,4148,540,18,14,32,56.2%,10m
530,1,[αB]AZAZEL,4148,96,2,3,5,40.0%,51m
533,1,[SsaYnS]MiolO,4147,1870,60,42,102,58.8%,43m
534,1,[lNI]QueensGambit,4146,142,7,2,9,77.8%,44m
534,1,Aithic,4146,115,4,6,10,40.0%,5m
536,1,Architorture,4145,1255,64,40,104,61.5%,6m
536,1,WiLLiAMS,4145,96,3,4,7,42.9%,36m
538,1,[llCFll]DropDrip,4144,1974,92,63,155,59.4%,9m
539,3,[FvR]ShOckWavE,4143,379,26,35,61,42.6%,32m
539,2,[ACSS]SnickleFritz,4143,0,1,3,4,25.0%,13m
541,2,Yeet,4142,46,2,0,2,100.0%,54m
542,1,LeSorHaiChap,4141,0,3,2,5,60.0%,32m
543,1,chelseafan,4140,1971,57,60,117,48.7%,38m
544,1,[UAP]TheJedi,4139,996,46,46,92,50.0%,38m
545,3,Primal,4138,16,7,17,24,29.2%,3m
546,1,DeepsYug,4137,0,0,2,2,0.0%,48m
547,3,[NovaX]Soda,4136,1994,272,286,558,48.7%,25m
548,1,IllIllIllIll,4134,0,1,1,2,50.0%,46m
549,1,Roots,4133,382,9,8,17,52.9%,31m
550,1,[DETER]WESTWOOD,4132,869,22,20,42,52.4%,32m
550,1,[TOoOT]MonkeyOoO,4132,0,0,1,1,0.0%,4m
552,1,PinkBunny,4131,48,3,6,9,33.3%,13m
553,1,[cfL]Zantesuke,4130,1971,163,149,312,52.2%,3m
553,1,macko,4130,0,0,2,2,0.0%,45m
555,3,[LXG]twistedsteel,4127,1824,189,185,374,50.5%,45m
555,3,[GØSU]SkyWalkeR,4127,1955,152,156,308,49.4%,31m
555,1,[NZER0]Draddition,4127,142,3,4,7,42.9%,51m
558,3,PussiBarcode,4126,0,2,2,4,50.0%,44m
558,1,[TAW]TeRrAnBrOkEn,4126,0,0,3,3,0.0%,39m
560,1,Bucket,4124,363,15,5,20,75.0%,44m
560,1,aaa,4124,169,9,6,15,60.0%,33m
560,2,[DixOut]Applia,4124,0,3,4,7,42.9%,48m
563,1,[xLgNx]TwoFiveBoy,4123,232,5,2,7,71.4%,3m
563,1,microking,4123,144,4,6,10,40.0%,28m
565,1,Slaget,4121,0,0,3,3,0.0%,13m
566,1,TheReapist,4120,48,2,1,3,66.7%,28m
567,3,[RoB]Grufzar,4118,1415,139,163,302,46.0%,31m
567,1,[iMkS]AdreNa,4118,585,15,14,29,51.7%,34m
567,1,[HAV0C]cutegrrl,4118,48,2,1,3,66.7%,32m
570,1,[GirlGo]Rosie,4116,0,0,1,1,0.0%,12m
571,1,[TGosuA]Pyra,4114,48,1,1,2,50.0%,31m
572,1,Computer,4113,94,6,3,9,66.7%,34m
572,3,[MTSux]AntMantis,4113,6,5,8,13,38.5%,43m
572,1,[Asmbly]Kanny,4113,0,0,1,1,0.0%,48m
575,1,Detour,4112,466,11,5,16,68.8%,47m
576,1,VeNGeaNcE,4111,308,17,6,23,73.9%,33m
576,1,[eSun]Toshiro,4111,426,10,11,21,47.6%,44m
576,2,[AMSeAL]IamBack,4111,268,7,9,16,43.8%,3m
579,1,stardust,4110,1520,41,38,79,51.9%,49m
579,1,Spoon,4110,0,1,0,1,100.0%,36m
581,2,[DikBoy]Ryan,4109,951,41,66,107,38.3%,42m
581,1,[cl0udM]SarsSan,4109,48,1,3,4,25.0%,52m
581,1,Equinox,4109,0,0,1,1,0.0%,48m
584,1,FilthyCasual,4108,642,29,12,41,70.7%,6m
585,1,MagicTurtle,4107,826,27,23,50,54.0%,33m
585,1,[CtSE]lllXXlll,4107,333,17,7,24,70.8%,36m
585,1,[Zprime]Crenty,4107,0,1,6,7,14.3%,6m
588,1,[CodeB]Tism,4105,48,2,0,2,100.0%,53m
588,2,[Heen]BanelingKing,4105,70,2,2,4,50.0%,40m
590,2,Fury,4104,0,0,1,1,0.0%,38m
591,1,[MLC]JelQQing,4102,1633,50,38,88,56.8%,13m
591,1,[GdAT]iamorni,4102,48,2,4,6,33.3%,44m
591,1,[PSlSTC]MyLifeFrAiur,4102,0,0,1,1,0.0%,46m
594,1,FreeHongKong,4101,1148,26,28,54,48.1%,10m
594,1,[xRtG]xobythesword,4101,0,1,0,1,100.0%,32m
594,1,Smurf,4101,0,1,0,1,100.0%,46m
597,1,YOLOSWAGGINS,4100,48,4,2,6,66.7%,46m
598,1,[DhZPro]Zodte,4099,1647,98,108,206,47.6%,9m
598,1,QYQY,4099,412,10,2,12,83.3%,50m
598,1,hurrrr,4099,48,2,0,2,100.0%,13m
601,1,LighterSkies,4097,675,23,13,36,63.9%,32m
601,1,[LHRS]Charlie,4097,192,4,7,11,36.4%,10m
601,1,Logarithm,4097,46,1,3,4,25.0%,38m
604,3,mArioNetTe,4096,2024,98,105,203,48.3%,46m
604,1,MorningLappy,4096,0,1,4,5,20.0%,32m
606,1,YeeHaw,4095,94,2,3,5,40.0%,3m
606,1,[HankH]bobbyShmurda,4095,0,0,2,2,0.0%,36m
608,1,[ZTemps]phiL,4093,322,12,7,19,63.2%,47m
609,1,[5555]Zoundz,4092,1913,61,56,117,52.1%,49m
609,1,Alpha,4092,249,18,7,25,72.0%,5m
609,1,[RUMB]ÖrjanVilma,4092,238,5,12,17,29.4%,36m
609,1,[Fir3s]BUDDITH,4092,0,0,1,1,0.0%,44m
613,2,SORRYGTG,4090,84,3,4,7,42.9%,49m
614,1,[BRSKR]Erujan,4089,0,2,3,5,40.0%,32m
615,1,Jackson,4088,1540,142,154,296,48.0%,52m
616,1,[FINDEX]StoicWilly,4087,0,0,1,1,0.0%,36m
616,3,JuLoSoLo,4087,0,0,1,1,0.0%,31m
618,1,[SsaYnS]rock,4085,1797,106,106,212,50.0%,3m
618,1,Freeze,4085,1451,104,103,207,50.2%,53m
618,1,[NwAs]pollomex,4085,608,13,16,29,44.8%,34m
621,1,IIIIIllllIII,4083,96,3,6,9,33.3%,46m
622,1,Quarantino,4082,140,4,3,7,57.1%,36m
622,1,pink,4082,48,2,4,6,33.3%,9m
624,1,Cerulean,4080,0,1,0,1,100.0%,25m
624,1,BiGBoy,4080,0,0,1,1,0.0%,44m
626,1,Practice,4078,458,12,22,34,35.3%,26m
626,1,[PCAKE]Simbot,4078,0,0,2,2,0.0%,33m
628,1,barcode,4077,1354,41,31,72,56.9%,53m
628,1,Celebrimbor,4077,0,3,2,5,60.0%,32m
630,1,MMMicro,4076,318,8,9,17,47.1%,44m
630,1,NiTGriT,4076,190,4,2,6,66.7%,47m
632,1,[GOPERÚ]SrSARCASMO,4075,570,15,6,21,71.4%,32m
632,1,Sydney,4075,0,0,1,1,0.0%,25m
632,1,soonsiri,4075,0,0,1,1,0.0%,14m
635,1,[ArGNA]universe,4074,48,2,1,3,66.7%,32m
636,1,Vanish,4073,730,19,18,37,51.4%,12m
636,2,Nuffy,4073,0,1,0,1,100.0%,3m
638,2,Blitzkrieg,4072,172,5,4,9,55.6%,32m
638,1,iiiiiiiiiiii,4072,0,0,1,1,0.0%,53m
638,2,ReallyManny,4072,0,0,4,4,0.0%,3m
641,1,kali,4069,0,1,0,1,100.0%,51m
642,1,Termination,4068,1310,33,35,68,48.5%,36m
643,1,[8o8s]Bluey,4066,2144,586,591,1177,49.8%,31m
643,3,[Bee]Athena,4066,1125,105,127,232,45.3%,50m
645,1,Soeki,4065,2110,116,117,233,49.8%,12m
645,1,Scoundrel,4065,772,18,10,28,64.3%,47m
645,1,TheFTS,4065,188,5,5,10,50.0%,51m
648,1,[Bee]LiviRAWR,4064,48,1,1,2,50.0%,44m
649,2,Moon,4063,0,1,3,4,25.0%,6m
650,1,iililililili,4062,202,4,1,5,80.0%,38m
650,1,[FateTw]Chance,4062,0,0,1,1,0.0%,36m
650,1,LionKing,4062,0,0,1,1,0.0%,9m
653,1,Loki,4061,371,13,16,29,44.8%,10m
653,1,Taimyr,4061,142,4,6,10,40.0%,38m
653,1,ForbZ,4061,96,3,4,7,42.9%,14m
653,1,[InGt]AtomicFather,4061,46,1,2,3,33.3%,53m
657,1,Ghost,4060,319,8,5,13,61.5%,41m
657,1,[NwAs]fluxKoas,4060,144,3,8,11,27.3%,26m
659,1,BlackRoofGC,4059,466,11,9,20,55.0%,44m
659,1,[VERUM]Enigma,4059,48,1,1,2,50.0%,49m
659,1,[Lesbos]Sappho,4059,0,1,5,6,16.7%,27m
662,1,Shallow,4058,320,7,2,9,77.8%,31m
662,1,[1SN1]norton,4058,0,0,1,1,0.0%,40m
664,1,[eSun]Ciel,4056,284,7,8,15,46.7%,40m
665,1,[NLTTJ]Yue,4055,1672,96,84,180,53.3%,46m
666,1,[Lapis]Ignia,4052,1632,53,46,99,53.5%,46m
666,1,[FiFo]sOmesinG,4052,376,8,9,17,47.1%,6m
666,1,Ascendead,4052,282,7,7,14,50.0%,46m
669,1,GuZrCn,4050,535,14,11,25,56.0%,13m
669,1,[s7z]CoRviX,4050,234,5,10,15,33.3%,49m
671,1,[QTclub]niknovichkov,4049,1930,82,77,159,51.6%,53m
671,3,gimmesumloot,4049,0,5,0,5,100.0%,6m
671,1,TaNk,4049,0,1,0,1,100.0%,49m
674,1,Ozymandias,4048,1381,49,55,104,47.1%,34m
674,1,PotatoDerp,4048,0,3,2,5,60.0%,50m
676,1,[IPZerg]Hail,4047,144,4,4,8,50.0%,38m
677,1,cloud,4045,376,8,16,24,33.3%,44m
677,2,lIllIIllII,4045,141,4,2,6,66.7%,38m
679,1,[cl0udM]Thimius,4043,1179,38,24,62,61.3%,47m
679,1,[HYXJM]MGJTerran,4043,0,1,1,2,50.0%,46m
681,1,[Cl3f]SMB,4042,742,18,18,36,50.0%,41m
681,1,PARKJIMIN,4042,193,9,3,12,75.0%,12m
683,2,JamesWade,4041,0,1,0,1,100.0%,6m
684,1,[xTQc]Freak,4039,324,7,6,13,53.8%,3m
684,1,PRoSu,4039,48,1,3,4,25.0%,6m
686,1,Ranko,4037,941,25,28,53,47.2%,6m
687,1,moki,4035,464,10,13,23,43.5%,28m
688,1,HesiJimbo,4033,1008,70,52,122,57.4%,46m
688,1,Salina,4033,366,22,1,23,95.7%,33m
688,1,monsterkillz,4033,376,8,10,18,44.4%,36m
688,1,TuckFrance,4033,192,4,8,12,33.3%,43m
688,3,PacFROST,4033,30,3,3,6,50.0%,13m
693,3,[J3wIQ]JudaicChad,4032,146,20,37,57,35.1%,13m
693,1,[UpeV]arack,4032,0,1,0,1,100.0%,13m
695,1,Xenoboss,4031,328,10,9,19,52.6%,44m
696,3,[CWKz]Maker,4030,0,1,0,1,100.0%,11m
697,1,Rose,4029,0,1,1,2,50.0%,6m
698,1,[chEdd]Stallions,4028,1316,39,32,71,54.9%,25m
699,1,Poleman,4027,142,6,5,11,54.5%,25m
699,1,[NubTos]MystP,4027,0,3,2,5,60.0%,40m
699,3,[FyHr]Andy,4027,0,2,3,5,40.0%,9m
702,1,Key,4026,366,8,3,11,72.7%,43m
702,1,Ronny,4026,0,1,0,1,100.0%,27m
704,1,Devil,4024,0,1,0,1,100.0%,32m
705,3,DatGuyGaming,4023,0,0,1,1,0.0%,43m
705,1,SandyRavage,4023,0,0,1,1,0.0%,33m
705,1,Corazon,4023,0,0,4,4,0.0%,26m
708,1,[cl0udM]KilgoreTrout,4022,1456,46,41,87,52.9%,28m
708,1,[hdhvst]ESKiLL,4022,0,0,5,5,0.0%,3m
710,1,[sc2rep]Bowzer,4021,1817,87,85,172,50.6%,34m
710,1,WatMatson,4021,476,13,9,22,59.1%,52m
712,1,[lLiTl]ieLLiMo,4020,190,4,9,13,30.8%,32m
712,3,[αB]Azure,4020,50,2,2,4,50.0%,11m
714,1,Monster,4019,938,35,25,60,58.3%,13m
715,1,[WNTRLH]barcode,4018,1398,36,34,70,51.4%,44m
716,3,Light,4017,58,5,2,7,71.4%,44m
716,1,llllllllllll,4017,0,1,5,6,16.7%,32m
718,1,[pwrIX]DOOMHURT,4016,2074,201,174,375,53.6%,48m
718,1,[Nu]AgentStang,4016,1987,184,169,353,52.1%,46m
718,1,[PPleb]Blodzil,4016,1869,83,63,146,56.8%,49m
718,1,[CMU]Qoo,4016,0,5,0,5,100.0%,31m
718,1,[KYARU]karyl,4016,157,4,1,5,80.0%,38m
723,1,[NwAs]Ordin,4015,1985,126,117,243,51.9%,38m
723,1,[ValidG]kali,4015,1276,42,37,79,53.2%,4m
723,2,Cxteam,4015,260,6,8,14,42.9%,10m
726,3,[ZTemps]OneMoreTime,4014,1944,369,368,737,50.1%,3m
726,1,redturtle,4014,92,2,2,4,50.0%,32m
728,1,[notCo]Grogu,4012,274,7,3,10,70.0%,46m
728,1,[nSis]kwonsso,4012,0,1,0,1,100.0%,9m
730,1,Present,4011,631,18,7,25,72.0%,50m
731,1,[JlGLY]Zonda,4010,93,2,0,2,100.0%,50m
732,1,TGNPS,4009,138,3,2,5,60.0%,44m
733,1,Cure,4008,735,29,13,42,69.0%,48m
734,1,trollbert,4007,2053,308,297,605,50.9%,38m
735,1,RedGoal,4006,1939,91,99,190,47.9%,52m
735,1,SpamPants,4006,1751,59,41,100,59.0%,40m
735,1,[NPhase]SlugLife,4006,48,2,0,2,100.0%,44m
738,3,[SCNS]MyNameAlice,4004,1758,290,327,617,47.0%,6m
738,3,[RlSKE]Sniper,4004,0,0,1,1,0.0%,34m
740,2,Reaper,4003,128,2,5,7,28.6%,38m
741,1,[dLife]BrokenLatex,4002,328,8,13,21,38.1%,26m
741,1,Bogue,4002,0,1,0,1,100.0%,46m
743,1,AlphaOne,4001,1830,161,169,330,48.8%,36m
743,2,Wirt,4001,221,12,3,15,80.0%,8m
743,1,MartinOne,4001,48,2,2,4,50.0%,32m
746,1,SeeungWho,4000,737,27,17,44,61.4%,33m
747,1,Tasty,3999,917,24,24,48,50.0%,49m
747,1,[PTHero]FireBird,3999,848,20,24,44,45.5%,49m
747,1,[UpeV]Saggy,3999,421,14,8,22,63.6%,47m
750,1,abcdefghijkl,3998,1077,40,31,71,56.3%,46m
750,1,Lyuganok,3998,165,5,0,5,100.0%,9m
752,1,[ROCKSC]BAEM,3996,628,14,22,36,38.9%,51m
752,1,[MiG]Covalent,3996,0,3,3,6,50.0%,36m
752,1,Neutrino,3996,94,2,1,3,66.7%,6m
752,3,Malaks,3996,0,1,4,5,20.0%,28m
752,1,GoA,3996,0,0,1,1,0.0%,38m
757,1,[AgK]BAEM,3995,506,12,13,25,48.0%,5m
758,1,[ShoaL]Smile,3994,836,30,17,47,63.8%,44m
758,1,Sulluukun,3994,109,5,2,7,71.4%,25m
760,3,yokai,3993,215,11,1,12,91.7%,40m
760,3,Phantoman,3993,0,1,2,3,33.3%,44m
762,1,CherryPopper,3992,1762,157,171,328,47.9%,4m
762,1,[TGosuB]JonasMcRaven,3992,0,1,0,1,100.0%,36m
764,1,[Lp]gatoloco,3990,0,1,0,1,100.0%,43m
765,1,[SPCBR]Barcode,3989,0,1,0,1,100.0%,47m
766,1,llllllllllll,3988,432,56,8,64,87.5%,31m
766,1,DeDeDeDerp,3988,133,9,0,9,100.0%,9m
766,1,grimZ,3988,108,5,3,8,62.5%,13m
769,1,thedude,3986,1680,117,125,242,48.3%,34m
769,1,hahaha,3986,439,11,12,23,47.8%,46m
769,3,SynthetiC,3986,0,1,0,1,100.0%,49m
772,1,[BStL]Jawhorse,3985,145,4,2,6,66.7%,32m
773,2,MacroMozart,3984,88,1,3,4,25.0%,6m
774,1,WhiteMonster,3983,0,5,0,5,100.0%,5m
775,1,Cris,3982,448,11,13,24,45.8%,47m
775,3,lIlIllIIllIl,3982,30,2,0,2,100.0%,5m
775,1,[ARLA]FGThjklzEX,3982,0,1,0,1,100.0%,26m
778,1,[cl0udM]CowboyDan,3980,711,23,14,37,62.2%,53m
778,3,Arteriuz,3980,0,1,0,1,100.0%,42m
778,2,VenaHausVien,3980,0,1,0,1,100.0%,41m
778,3,[CrtCrw]CrazyCritter,3980,0,1,0,1,100.0%,13m
782,1,Tread,3978,1077,61,60,121,50.4%,47m
782,1,[BearMe]Siegfried,3978,234,5,13,18,27.8%,50m
782,1,SiDeEfFeCtZ,3978,96,2,4,6,33.3%,25m
785,1,Terminator,3977,190,7,3,10,70.0%,38m
785,1,Trakia,3977,48,1,1,2,50.0%,14m
785,3,Vladizor,3977,0,0,1,1,0.0%,32m
788,1,[FxB]caiobex,3976,554,15,21,36,41.7%,38m
789,1,[HWN]babybird,3975,48,1,5,6,16.7%,43m
790,1,[uWu69]CollinCobra,3973,910,38,28,66,57.6%,44m
791,1,Lazuli,3972,0,1,0,1,100.0%,44m
792,1,SamsChoice,3971,1516,76,65,141,53.9%,38m
792,1,Zakalwe,3971,1162,45,21,66,68.2%,41m
792,1,Nimar,3971,358,9,7,16,56.2%,53m
792,3,IlllIlIlIIIl,3971,0,1,3,4,25.0%,44m
796,3,CptWilly,3969,0,1,1,2,50.0%,3m
797,1,KelviN,3968,828,58,40,98,59.2%,4m
798,1,Vardek,3967,501,23,8,31,74.2%,13m
798,1,Radax,3967,92,2,2,4,50.0%,46m
800,1,Tandruil,3963,187,12,2,14,85.7%,5m
801,1,[EZDUNK]TheEvilOne,3962,1875,333,336,669,49.8%,53m
802,2,[UpeV]Everness,3961,0,1,3,4,25.0%,26m
803,1,[dLife]NewMetaNoob,3959,312,8,10,18,44.4%,50m
803,1,ransom,3959,129,5,4,9,55.6%,48m
803,1,IIIIIIIIIIII,3959,0,0,3,3,0.0%,6m
806,1,Diogonies,3958,46,2,2,4,50.0%,51m
806,1,[Hauk]LightCartman,3958,0,0,1,1,0.0%,12m
808,2,HellraiserX,3956,179,9,6,15,60.0%,11m
809,1,TurkeyHawk,3955,471,22,6,28,78.6%,13m
810,1,Improving,3954,48,3,8,11,27.3%,32m
811,1,yusef,3952,2050,204,187,391,52.2%,6m
811,1,Caesar,3952,1971,63,70,133,47.4%,36m
813,1,[SsaYnS]Boundless,3951,782,44,41,85,51.8%,46m
813,1,CookieWizard,3951,0,0,1,1,0.0%,45m
815,1,goldhat,3950,307,13,6,19,68.4%,32m
815,1,[PZB9]SnoufyDuke,3950,0,0,1,1,0.0%,47m
817,1,[GOPERÚ]AyaxFenix,3949,1405,119,93,212,56.1%,36m
817,1,wenks,3949,0,3,2,5,60.0%,38m
819,1,llllllllllll,3948,497,19,16,35,54.3%,41m
819,3,LOOTBOX,3948,145,8,0,8,100.0%,28m
819,3,OKGo,3948,0,1,0,1,100.0%,5m
822,1,[FxB]Delicious,3947,640,23,14,37,62.2%,39m
822,1,[ScSwrm]IronLung,3947,48,2,3,5,40.0%,28m
822,1,BudgetSteak,3947,46,1,2,3,33.3%,44m
825,1,[Amb3rs]UGamer,3946,1173,38,40,78,48.7%,28m
825,2,lllllll,3946,188,12,2,14,85.7%,31m
827,1,[TGosuC]Dogfobmal,3945,212,8,6,14,57.1%,5m
827,3,[PK]Montero,3945,0,1,4,5,20.0%,43m
829,1,[ScSwrm]Edennil,3943,856,72,55,127,56.7%,47m
830,3,MrMidnight,3942,30,1,2,3,33.3%,29m
831,1,[TBALL]Toto,3941,1263,51,45,96,53.1%,32m
831,1,wolfhead,3941,706,31,19,50,62.0%,13m
831,1,Wilk,3941,312,7,6,13,53.8%,49m
831,2,[N8D]PandaExpress,3941,201,5,7,12,41.7%,42m
835,1,Burger,3940,313,84,79,163,51.5%,46m
835,1,llllllllllll,3940,550,30,32,62,48.4%,44m
835,1,[SsaYnS]xxxxxxxxxxxx,3940,165,4,11,15,26.7%,41m
835,1,IIIIIIIIIIII,3940,46,2,1,3,66.7%,50m
835,1,[Cind3r]FightDiaper,3940,138,2,2,4,50.0%,47m
835,1,[xRtG]TheSizzler,3940,0,1,0,1,100.0%,28m
835,1,Sponge,3940,91,1,1,2,50.0%,47m
842,1,[SftVgn]DoTcom,3939,315,13,7,20,65.0%,53m
843,1,vult,3938,1229,52,37,89,58.4%,53m
843,1,[BRAP]Spyder,3938,685,26,14,40,65.0%,38m
843,1,[CTOP]Echo,3938,92,1,2,3,33.3%,13m
846,1,llllllllllll,3937,1726,51,48,99,51.5%,6m
846,1,CroNoS,3937,840,39,27,66,59.1%,39m
846,1,Cold,3937,185,4,3,7,57.1%,49m
846,1,[KiMBR]WiN,3937,0,0,1,1,0.0%,28m
850,1,[DontRN]Anunnaki,3936,347,50,40,90,55.6%,47m
850,1,[B1GNut]LoadeD,3936,133,2,2,4,50.0%,49m
850,1,[DRFS]ElfandOak,3936,73,1,1,2,50.0%,13m
853,1,theNuclide,3935,626,29,11,40,72.5%,50m
854,1,XYFans,3934,625,21,12,33,63.6%,27m
855,1,Garky,3932,1592,156,140,296,52.7%,48m
855,1,[QS]NothRemember,3932,819,73,63,136,53.7%,4m
855,1,Slylandro,3932,1359,35,33,68,51.5%,48m
855,1,[NPhase]Wittgenstein,3932,140,4,6,10,40.0%,4m
855,3,DFTBA,3932,0,0,1,1,0.0%,53m
860,2,FalseHope,3931,42,2,1,3,66.7%,6m
861,1,HopHopHop,3930,283,62,41,103,60.2%,32m
862,3,StaleBread,3928,216,10,1,11,90.9%,33m
862,2,[TushAn]SooVation,3928,38,1,2,3,33.3%,53m
864,1,[NPhase]MeltedCheese,3927,1720,84,84,168,50.0%,47m
864,2,JoshGordon,3927,234,7,5,12,58.3%,39m
866,1,[Frog]TAPOR,3926,0,2,5,7,28.6%,44m
867,1,Leninade,3925,48,2,3,5,40.0%,50m
867,1,tskarz,3925,48,1,8,9,11.1%,51m
867,1,[WeLike]Angels,3925,0,0,2,2,0.0%,41m
870,1,[NerfMe]SouljaBoy,3924,1024,46,32,78,59.0%,53m
870,1,[BELDA]Geno,3924,410,13,8,21,61.9%,36m
870,2,[NotEQ]InEquality,3924,0,1,0,1,100.0%,53m
873,2,PartyWater,3923,908,50,22,72,69.4%,41m
873,2,[GHESSG]SHeYyYTaAaN,3923,299,15,5,20,75.0%,54m
873,1,Petrox,3923,142,7,14,21,33.3%,5m
873,2,Shanx,3923,38,2,0,2,100.0%,32m
873,2,TheYeti,3923,0,0,1,1,0.0%,41m
878,1,BrokenLatex,3922,381,18,4,22,81.8%,13m
879,1,Khucumber,3920,0,2,3,5,40.0%,38m
879,2,OFE,3920,0,1,0,1,100.0%,54m
881,1,JustTheTip,3919,93,2,1,3,66.7%,28m
882,1,[hTx]vTriple,3918,92,3,3,6,50.0%,47m
882,2,CDNLandmine,3918,0,1,0,1,100.0%,50m
884,1,[FiFo]CrackFurtado,3917,1298,53,48,101,52.5%,5m
885,1,crazyman,3916,356,13,14,27,48.1%,43m
886,1,[qOjOp]eurotrash,3914,390,14,9,23,60.9%,46m
886,1,Mutwinkle,3914,371,7,11,18,38.9%,26m
886,1,[SWD325]PrOsperity,3914,46,1,5,6,16.7%,33m
889,2,[MilkIt]Odin,3913,0,1,0,1,100.0%,7m
890,1,IlIlllllIIll,3912,1498,230,200,430,53.5%,32m
890,1,exXxecutor,3912,1751,178,184,362,49.2%,28m
890,3,LingBling,3912,1112,58,65,123,47.2%,28m
890,2,FogofWar,3912,1070,39,39,78,50.0%,27m
894,1,sOs,3911,969,39,35,74,52.7%,36m
894,1,Pokemon,3911,648,15,17,32,46.9%,51m
894,2,Eyetalian,3911,216,8,3,11,72.7%,45m
897,2,[NPhasA]TheHamman,3910,102,3,2,5,60.0%,11m
897,2,zzgodmodezz,3910,0,1,0,1,100.0%,3m
897,1,Duke,3910,48,1,10,11,9.1%,32m
900,2,Halogen,3909,536,19,14,33,57.6%,46m
900,1,Pogue,3909,142,3,15,18,16.7%,36m
900,2,Kitfox,3909,0,0,1,1,0.0%,52m
903,1,Chucko,3907,1980,106,107,213,49.8%,46m
903,1,glaxor,3907,1230,44,34,78,56.4%,27m
903,2,AuTisToss,3907,444,16,6,22,72.7%,41m
906,1,[cloudM]Yarters,3905,671,26,24,50,52.0%,33m
906,2,Motion,3905,0,1,0,1,100.0%,8m
908,1,RipGeoff,3904,0,0,4,4,0.0%,3m
909,1,Protossop,3903,560,27,12,39,69.2%,43m
909,2,IlIlllIlIlll,3903,345,17,4,21,81.0%,7m
909,1,Houdini,3903,95,4,3,7,57.1%,5m
909,1,[werf]Volaurt,3903,102,3,3,6,50.0%,25m
913,2,[MBQ]BoukarDiouf,3902,1066,39,36,75,52.0%,43m
913,3,[MSUsc2]SpiKeYMaN,3902,0,0,2,2,0.0%,33m
915,2,[EZDUNK]BalancWiener,3901,68,3,1,4,75.0%,3m
916,1,ImABarchode,3900,0,2,5,7,28.6%,27m
916,2,Darknight,3900,0,0,1,1,0.0%,49m
918,1,[oJKo]MolyPercocet,3899,1308,64,38,102,62.7%,40m
918,2,[GWYNNE]IceBerg,3899,0,0,1,1,0.0%,53m
920,1,BugsLife,3898,1550,96,98,194,49.5%,51m
921,2,[RBTH]CedriK,3897,812,30,29,59,50.8%,52m
921,1,[DarkAG]Ace,3897,330,7,8,15,46.7%,10m
921,2,[BlTEL]DranzerJJ,3897,0,0,1,1,0.0%,42m
924,2,ZukhMaïDykh,3896,486,15,13,28,53.6%,26m
924,2,Gabagool,3896,0,0,1,1,0.0%,45m
926,2,burp,3895,186,10,1,11,90.9%,54m
926,1,Einstein,3895,88,1,2,3,33.3%,53m
928,1,Wolfhead,3894,1599,89,66,155,57.4%,27m
928,3,[NAGARA]Nyaong,3894,88,4,1,5,80.0%,34m
928,2,[CRAKS]FarmerPoopy,3894,0,0,3,3,0.0%,28m
931,2,[hLu]Popy,3893,36,1,5,6,16.7%,38m
931,2,[AdaptG]Ecchi,3893,0,0,1,1,0.0%,26m
933,1,[JustFF]Nibiru,3891,164,7,1,8,87.5%,5m
934,1,Ledrash,3890,1895,68,66,134,50.7%,10m
935,2,FlyingWhale,3889,728,28,15,43,65.1%,6m
936,2,IIIIIIIIIIII,3888,62,3,0,3,100.0%,37m
936,2,[iPG]Chodder,3888,0,1,0,1,100.0%,51m
938,1,JoeKingMan,3887,1586,147,140,287,51.2%,46m
938,2,Dashedhopes,3887,126,5,4,9,55.6%,6m
938,2,[ClanZN]Reusk,3887,0,1,0,1,100.0%,37m
941,1,THEBLOB,3886,1876,293,282,575,51.0%,43m
941,2,Murtagh,3886,90,8,0,8,100.0%,9m
943,2,Rocktopus,3885,626,22,18,40,55.0%,49m
943,1,[xNtG]FlawlessPim,3885,263,7,6,13,53.8%,32m
943,2,[MRCYLS]Human,3885,168,5,3,8,62.5%,52m
946,1,DangaZone,3884,1994,135,149,284,47.5%,48m
946,2,StrongBad,3884,418,30,32,62,48.4%,13m
946,3,JayTeee,3884,0,0,1,1,0.0%,37m
949,1,BmJake,3883,94,2,10,12,16.7%,36m
949,2,IsThisMemes,3883,0,1,0,1,100.0%,9m
951,1,[sdfgh]Voidreaver,3882,1538,41,58,99,41.4%,49m
952,2,TheLaw,3881,290,16,5,21,76.2%,11m
952,2,[LGNxx]GHOST,3881,164,5,2,7,71.4%,8m
952,3,Klimrod,3881,88,4,2,6,66.7%,47m
952,1,GoRush,3881,108,2,7,9,22.2%,13m
956,1,ChIkIruLz,3880,1547,52,49,101,51.5%,27m
956,2,[RealDT]MelaniaTrump,3880,34,2,0,2,100.0%,51m
956,3,[noAPEX]BATTLECRUISR,3880,0,0,1,1,0.0%,49m
956,2,Aphrodite,3880,0,0,1,1,0.0%,37m
960,1,scheiblebier,3879,892,22,35,57,38.6%,33m
960,2,[UFL]Jushyfruit,3879,40,1,1,2,50.0%,28m
962,1,[TzToss]KeylowBravo,3878,94,2,7,9,22.2%,53m
963,3,[αX]MaidenSlayer,3877,1824,173,188,361,47.9%,43m
963,2,[Ris3n]MogSkynet,3877,104,3,4,7,42.9%,40m
963,3,[KiMBR]Brucutu,3877,0,0,1,1,0.0%,39m
966,1,UncleFudge,3875,1926,132,133,265,49.8%,49m
967,2,Ahihi,3874,204,7,1,8,87.5%,26m
967,2,TwoOutOfTen,3874,156,5,6,11,45.5%,46m
969,2,Gazedo,3873,0,1,1,2,50.0%,6m
970,1,[ValidG]IzzyMeanWeeb,3872,231,7,9,16,43.8%,12m
970,2,DISTURB,3872,42,1,4,5,20.0%,6m
972,3,SoWhat,3870,46,3,4,7,42.9%,40m
973,2,KarlosAris,3868,0,1,0,1,100.0%,41m
974,2,Xenon,3866,132,5,3,8,62.5%,45m
974,2,Jamoz,3866,38,1,1,2,50.0%,43m
976,2,VoidyPoo,3865,1598,155,143,298,52.0%,38m
976,2,[TGosuC]gonjareya,3865,311,15,13,28,53.6%,31m
978,2,llprnc,3864,657,49,37,86,57.0%,11m
978,1,[PSU]OGBerM,3864,583,28,23,51,54.9%,13m
978,2,DarkWingDuck,3864,632,27,9,36,75.0%,26m
978,2,[Scoop]FunkyMonke,3864,112,4,3,7,57.1%,51m
982,2,ItzMeMarco,3863,0,1,0,1,100.0%,35m
982,2,MindfulMan,3863,0,0,1,1,0.0%,50m
984,1,MockNee,3862,1337,208,219,427,48.7%,38m
984,2,Verdugo,3862,234,8,7,15,53.3%,6m
984,3,PKT,3862,30,1,3,4,25.0%,26m
984,3,Huskys,3862,30,1,4,5,20.0%,37m
988,2,[INextI]JUKUMARU,3861,1368,54,46,100,54.0%,49m
988,2,[RAMEN]mladicO,3861,72,3,2,5,60.0%,9m
988,2,[BACK2R]IamNotByun,3861,0,0,1,1,0.0%,39m
991,2,Terran,3860,0,0,1,1,0.0%,37m
992,2,Springfield,3859,1630,70,51,121,57.9%,52m
992,1,Zerocool,3859,1508,46,51,97,47.4%,49m
994,2,[AFM]cookie,3858,723,33,26,59,55.9%,40m
995,2,SymphoniC,3857,64,2,3,5,40.0%,43m
995,2,JAPESofWRATH,3857,32,1,2,3,33.3%,43m
997,2,BREÀSTMODE,3856,142,8,0,8,100.0%,42m
997,2,Kwehhh,3856,40,2,0,2,100.0%,8m
997,2,IIIIIIIIIIII,3856,32,2,2,4,50.0%,8m
997,2,PocketSand,3856,0,0,1,1,0.0%,29m
1001,1,ParkBoGeom,3855,134,4,6,10,40.0%,46m
1001,2,deuce,3855,110,3,4,7,42.9%,43m
1001,2,SharpShooter,3855,0,0,1,1,0.0%,14m
1004,1,[DRKFOX]Apothenes,3854,1877,139,137,276,50.4%,47m
1004,2,TheWall,3854,66,3,2,5,60.0%,52m
1006,1,[TheRs]LiberTea,3853,536,15,20,35,42.9%,33m
1006,2,[BA0]getshum,3853,92,4,5,9,44.4%,43m
1008,2,BeanBurrito,3852,58,3,0,3,100.0%,46m
1009,2,[YE71]aYawningLion,3851,234,7,7,14,50.0%,40m
1009,2,Raistlin,3851,0,2,3,5,40.0%,35m
1011,2,llllllllllll,3850,720,32,18,50,64.0%,41m
1011,2,[UpeV]SrPipeneisho,3850,99,2,3,5,40.0%,41m
1013,1,Microblitz,3848,1733,82,66,148,55.4%,5m
1013,1,sjShark,3848,570,13,21,34,38.2%,12m
1013,2,Trumpanzee,3848,202,10,9,19,52.6%,51m
1013,2,IntotheBotto,3848,280,8,12,20,40.0%,51m
1017,3,SneakyTurtle,3847,97,5,1,6,83.3%,54m
1017,1,[TAsc]Yip,3847,182,4,6,10,40.0%,5m
1017,2,[VAPE7]LuNaTiC,3847,136,4,7,11,36.4%,31m
1020,2,Somnolent,3846,368,13,7,20,65.0%,11m
1020,2,Draconus,3846,36,2,3,5,40.0%,49m
1020,2,HankHill,3846,32,2,3,5,40.0%,50m
1023,2,xilocamp,3845,202,8,3,11,72.7%,30m
1024,2,Tetris,3844,208,8,9,17,47.1%,46m
1024,3,nooblet,3844,60,3,1,4,75.0%,12m
1026,2,Yip,3843,392,14,11,25,56.0%,39m
1026,2,HalfMoon,3843,137,6,6,12,50.0%,46m
1026,2,Erberack,3843,112,4,7,11,36.4%,45m
1029,1,Solace,3842,1257,116,108,224,51.8%,13m
1029,2,[Odins]Bliss,3842,568,21,19,40,52.5%,46m
1031,2,Madvillain,3841,366,14,4,18,77.8%,45m
1031,2,historian,3841,0,3,2,5,60.0%,11m
1031,2,Yooshiii,3841,60,2,5,7,28.6%,53m
1031,2,[Wiggin]GreatArchon,3841,0,0,1,1,0.0%,50m
1035,1,killerp,3840,761,46,39,85,54.1%,46m
1036,2,MrBrightside,3839,76,2,5,7,28.6%,4m
1037,2,VoidRayOP,3837,986,42,24,66,63.6%,9m
1037,1,[ZGRB]JESTJERVYN,3837,276,6,15,21,28.6%,44m
1039,1,[cl0udM]Waterdrip,3836,1973,317,323,640,49.5%,28m
1039,2,jakos,3836,40,2,1,3,66.7%,29m
1041,2,[RUMB]PieForever,3835,0,0,1,1,0.0%,6m
1042,1,[LilHo]tehdoctor,3832,717,31,38,69,44.9%,38m
1042,2,Ryanwj,3832,0,1,0,1,100.0%,48m
1044,2,[iMkS]Stalife,3831,1242,49,39,88,55.7%,37m
1045,2,[Xpk]LimeLight,3829,436,16,8,24,66.7%,27m
1045,2,TheMacroKing,3829,88,4,2,6,66.7%,14m
1045,2,GETABETTERIQ,3829,0,1,2,3,33.3%,54m
1048,1,[SHMALO]Python,3828,1955,169,164,333,50.8%,13m
1048,2,ohnogg,3828,131,5,8,13,38.5%,49m
1048,3,[LowIQ]EvolFighter,3828,115,4,4,8,50.0%,13m
1048,1,[ProMex]Fénix,3828,0,0,7,7,0.0%,31m
1052,1,Rowan,3827,44,2,8,10,20.0%,49m
1053,2,FeelsBadMan,3826,0,0,1,1,0.0%,6m
1054,2,[NPhasA]BalletDump,3825,188,10,1,11,90.9%,14m
1054,2,llllllllll,3825,0,3,5,8,37.5%,6m
1054,2,MrBrightside,3825,0,1,0,1,100.0%,11m
1057,2,CCCPPutin,3824,752,40,28,68,58.8%,37m
1057,2,CrazyFingers,3824,246,8,10,18,44.4%,43m
1057,2,SleepyJoe,3824,58,4,3,7,57.1%,46m
1060,1,CoreaTeam,3823,0,1,8,9,11.1%,49m
1061,2,[Nua]pattaya,3822,765,32,21,53,60.4%,37m
1061,2,DripDrop,3822,363,18,19,37,48.6%,36m
1061,2,[Namzug]JRMeister,3822,34,2,6,8,25.0%,32m
1064,2,[uGG]xEnvy,3821,1076,40,37,77,51.9%,51m
1064,2,[TGosuD]Dingo,3821,482,19,8,27,70.4%,54m
1064,2,[BFOL]LingLing,3821,0,0,1,1,0.0%,53m
1067,2,[NwAs]Blutt,3820,650,26,18,44,59.1%,38m
1067,2,Mykal,3820,0,1,0,1,100.0%,39m
1069,2,Goldenass,3819,30,1,1,2,50.0%,39m
1070,1,NOGG,3818,1480,285,303,588,48.5%,52m
1071,2,Random,3817,70,2,5,7,28.6%,10m
1072,2,Schism,3816,942,36,30,66,54.5%,11m
1072,2,[TGosuB]Kyle,3816,0,1,0,1,100.0%,29m
1074,1,[LOTV7]Captain,3815,778,55,37,92,59.8%,34m
1074,2,Papai,3815,1161,54,37,91,59.3%,40m
1074,1,Jocker,3815,0,2,5,7,28.6%,4m
1074,2,[Macac0]liszt,3815,30,1,5,6,16.7%,29m
1078,2,[BRSKR]Siumo,3814,73,0,2,2,0.0%,30m
1079,3,snAck,3813,144,3,1,4,75.0%,39m
1080,1,HappyEden,3812,955,45,31,76,59.2%,32m
1080,3,RexOf,3812,160,9,2,11,81.8%,14m
1082,2,[Crew]RallosZek,3811,36,1,2,3,33.3%,31m
1083,2,MyDadLeft,3810,238,7,9,16,43.8%,7m
1084,2,Icebear,3809,450,16,13,29,55.2%,6m
1084,1,Doom,3809,0,0,3,3,0.0%,35m
1086,1,[neuroS]Ultrahugs,3807,916,23,35,58,39.7%,31m
1086,2,hubs,3807,396,14,13,27,51.9%,52m
1086,1,aLW,3807,278,8,11,19,42.1%,44m
1089,2,jimmypoi,3806,896,36,29,65,55.4%,4m
1089,2,Zerg,3806,695,29,15,44,65.9%,34m
1091,2,ArriSTv,3805,548,22,13,35,62.9%,27m
1091,2,RandomEUplay,3805,452,17,14,31,54.8%,53m
1091,2,Koooooozaan,3805,0,4,1,5,80.0%,53m
1094,2,[WEWINn]Unstopable,3804,214,8,5,13,61.5%,9m
1094,3,[TeamUR]Parka,3804,121,2,1,3,66.7%,39m
1094,2,[ANIMOO]hurdler,3804,38,1,2,3,33.3%,50m
1097,2,Loopy,3803,1475,78,72,150,52.0%,33m
1097,3,Flash,3803,304,15,5,20,75.0%,10m
1097,2,[VSOU]Crass,3803,0,0,3,3,0.0%,39m
1100,2,BLADE,3802,248,11,11,22,50.0%,39m
1101,2,[WiGGz]SoulPosessed,3801,1647,178,169,347,51.3%,41m
1101,1,[Khawah]Mutzigoon,3801,1918,152,152,304,50.0%,41m
1101,1,[T1T5]MarineQueen,3801,1371,59,68,127,46.5%,49m
1104,2,vain,3800,1439,375,343,718,52.2%,9m
1104,2,tman,3800,1599,139,126,265,52.5%,42m
1104,1,Payne,3800,1409,65,56,121,53.7%,6m
1104,2,SkOOg,3800,143,14,11,25,56.0%,52m
1104,2,ZHZ,3800,128,5,4,9,55.6%,7m
1104,2,[NSKL]Laik,3800,38,2,5,7,28.6%,41m
1104,2,SluttyMagoo,3800,0,0,1,1,0.0%,45m
1111,1,[Ssok]ian,3799,1670,59,59,118,50.0%,26m
1111,2,HiboFlavin,3799,0,0,1,1,0.0%,45m
1111,2,Random,3799,0,0,1,1,0.0%,4m
1114,2,nightknight,3798,0,1,0,1,100.0%,32m
1115,2,pookie,3797,388,14,12,26,53.8%,9m
1115,2,yousuck,3797,388,13,14,27,48.1%,3m
1115,2,Annanias,3797,0,0,1,1,0.0%,30m
1118,2,AnimeLove,3796,0,5,0,5,100.0%,10m
1119,2,Retsof,3795,913,59,54,113,52.2%,43m
1119,2,[AciNoN]TwilightZeRR,3795,286,16,2,18,88.9%,4m
1119,2,theripperr,3795,193,5,5,10,50.0%,11m
1119,2,GEANTOR,3795,0,0,1,1,0.0%,52m
1123,2,Calipoo,3794,1401,58,51,109,53.2%,41m
1123,3,[tTZz]InitialLiMiT,3794,30,1,1,2,50.0%,29m
1125,2,[fagz]HybridGnome,3793,0,0,1,1,0.0%,39m
1126,2,Frost,3792,980,49,40,89,55.1%,11m
1126,3,JuicyJesuz,3792,242,12,4,16,75.0%,37m
1128,2,MacroMantis,3791,310,13,12,25,52.0%,45m
1128,1,IIIIIIIIIIII,3791,388,9,18,27,33.3%,53m
1128,1,[daTbud]Nisko,3791,274,6,20,26,23.1%,13m
1128,2,Civil,3791,86,3,1,4,75.0%,3m
1128,2,Protoss,3791,0,0,3,3,0.0%,50m
1133,2,MarineEleven,3789,774,29,23,52,55.8%,11m
1133,1,FATTYMA,3789,1069,28,29,57,49.1%,41m
1133,1,hermytheworm,3789,88,5,3,8,62.5%,49m
1136,1,Dreamer,3788,895,77,65,142,54.2%,49m
1136,1,[Random]Dave,3788,390,10,14,24,41.7%,53m
1136,2,[MacrOP]Infidel,3788,0,0,1,1,0.0%,28m
1139,1,[GIBE]Zerg,3787,1920,479,484,963,49.7%,6m
1139,2,kakaru,3787,799,39,12,51,76.5%,26m
1139,2,[PMT]spinnercat,3787,88,2,0,2,100.0%,30m
1139,2,CTVStarFox,3787,30,1,1,2,50.0%,30m
1143,2,[lNI]GeNiuS,3785,192,7,8,15,46.7%,49m
1143,2,[KGH2]Typhon,3785,114,6,4,10,60.0%,52m
1143,2,EnTaroDHo,3785,32,1,2,3,33.3%,54m
1146,2,[lASUl]Cavalieri,3783,1548,103,101,204,50.5%,5m
1146,1,Cools,3783,928,57,48,105,54.3%,37m
1146,3,[2V2G0d]iHasTHIGHS,3783,203,14,6,20,70.0%,11m
1146,2,[Wyo]Kickosh,3783,58,3,0,3,100.0%,37m
1150,2,Leafers,3782,1057,44,32,76,57.9%,54m
1150,2,[ANFA]Fade,3782,422,16,10,26,61.5%,38m
1150,2,[BGOK]Chickenman,3782,370,15,7,22,68.2%,3m
1150,1,Navi,3782,450,12,17,29,41.4%,28m
1154,2,[M12]GasLight,3780,324,18,5,23,78.3%,49m
1154,2,DJTJ,3780,0,1,0,1,100.0%,32m
1156,2,vanilla,3779,0,1,0,1,100.0%,43m
1156,2,DeadGame,3779,0,1,0,1,100.0%,38m
1158,2,Silvanas,3778,488,18,14,32,56.2%,11m
1158,3,[LDPro]TikiRoss,3778,0,0,2,2,0.0%,28m
1160,1,MrGigglez,3777,0,0,1,1,0.0%,50m
1161,3,Omer,3775,144,6,3,9,66.7%,5m
1161,2,Protoss,3775,154,5,6,11,45.5%,30m
1161,2,meva,3775,0,3,2,5,60.0%,37m
1164,2,[TJET]Bonein,3774,356,12,16,28,42.9%,37m
1164,2,Polaris,3774,200,6,14,20,30.0%,36m
1164,2,Oreo,3774,30,2,5,7,28.6%,9m
1164,2,Thor,3774,0,1,0,1,100.0%,39m
1164,2,DrJAB,3774,0,1,1,2,50.0%,49m
1164,2,[WEEEEE]jam,3774,0,0,4,4,0.0%,54m
1170,2,[BioTek]JALNARE,3773,1006,48,40,88,54.5%,31m
1170,2,[DarkAG]BreaKer,3773,404,13,16,29,44.8%,49m
1170,2,Levity,3773,236,9,10,19,47.4%,38m
1173,2,DontBeSad,3772,166,6,3,9,66.7%,30m
1173,2,[Lp]NeoShaGgy,3772,0,1,1,2,50.0%,3m
1173,2,[NZER0]Ghoul,3772,0,0,1,1,0.0%,27m
1176,1,Swoop,3771,1889,166,162,328,50.6%,27m
1176,2,[Cryptc]EviLs,3771,388,13,16,29,44.8%,8m
1176,2,ARCH,3771,0,1,1,2,50.0%,46m
1179,2,[ZTemp]karen,3770,951,63,42,105,60.0%,48m
1179,2,NinjaOng,3770,210,7,6,13,53.8%,3m
1179,2,[RBTH]CALLO,3770,90,4,0,4,100.0%,50m
1182,1,NEWPLAYER,3769,97,6,0,6,100.0%,10m
1183,1,BFG,3768,1857,174,168,342,50.9%,47m
1183,2,YinYang,3768,242,13,3,16,81.2%,43m
1183,2,Bean,3768,0,0,2,2,0.0%,42m
1186,1,Malfy,3767,1882,181,186,367,49.3%,44m
1186,3,[BROFLX]VADER,3767,0,0,1,1,0.0%,3m
1188,2,[Cakius]Tavo,3766,66,2,6,8,25.0%,53m
1188,2,zion,3766,0,0,2,2,0.0%,9m
1190,1,Vales,3765,608,22,20,42,52.4%,49m
1190,2,[NIntN]Rhodesian,3765,314,11,11,22,50.0%,53m
1190,2,Matt,3765,298,11,15,26,42.3%,53m
1190,3,Serenity,3765,0,0,1,1,0.0%,47m
1194,3,Fasho,3764,169,4,1,5,80.0%,10m
1194,2,Littlenoob,3764,30,2,0,2,100.0%,29m
1194,2,schmuttt,3764,30,1,2,3,33.3%,32m
1194,2,[ValidG]Kwas,3764,0,0,1,1,0.0%,26m
1198,1,Yagi,3763,1847,216,229,445,48.5%,28m
1198,2,oxycodone,3763,0,5,0,5,100.0%,11m
1198,2,Paranormal,3763,30,5,3,8,62.5%,43m
1201,1,Data,3762,1740,113,123,236,47.9%,9m
1202,2,BenchPress,3761,840,31,32,63,49.2%,3m
1202,2,NEW,3761,0,1,0,1,100.0%,38m
1202,2,Thisisfun,3761,30,1,3,4,25.0%,11m
1202,3,[MikAlx]SetoKaiba,3761,0,0,1,1,0.0%,36m
1206,1,[LeHigh]Family,3760,1216,34,42,76,44.7%,53m
1206,2,[xGenGx]MadneticsYT,3760,149,5,5,10,50.0%,8m
1206,2,dirtyplayer,3760,30,3,4,7,42.9%,30m
1206,2,[KingSC]Maydaz,3760,30,2,2,4,50.0%,45m
1206,2,Prismatix,3760,0,1,0,1,100.0%,52m
1211,2,[GDJ]DrunkMaster,3759,804,53,52,105,50.5%,37m
1211,2,[Macac0]MuTaco,3759,242,10,2,12,83.3%,31m
1213,2,Petrucci,3758,0,1,0,1,100.0%,42m
1214,2,Critter,3756,799,36,24,60,60.0%,36m
1214,2,[hTx]JackStark,3756,300,10,10,20,50.0%,31m
1214,3,Fourth,3756,168,5,6,11,45.5%,14m
1217,1,Tides,3755,1793,121,123,244,49.6%,49m
1217,2,[CUMBAT]koi,3755,397,22,14,36,61.1%,43m
1217,3,Mumba,3755,99,9,0,9,100.0%,46m
1220,2,[TGCrew]CholmesInk,3754,1358,69,66,135,51.1%,50m
1220,2,[TVGL]Merchant,3754,206,10,12,22,45.5%,43m
1222,2,icup,3753,1590,67,74,141,47.5%,42m
1222,1,Photon,3753,1752,57,74,131,43.5%,9m
1224,2,Okonkwo,3752,0,1,0,1,100.0%,37m
1224,2,[TeriS]rollinondubs,3752,0,1,4,5,20.0%,50m
1226,3,RollTheDice,3751,30,1,5,6,16.7%,12m
1227,2,[Macac0]kpa,3750,1626,70,63,133,52.6%,49m
1227,2,NotinMKSens,3750,152,6,5,11,54.5%,31m
1229,3,Jenny,3749,265,8,11,19,42.1%,5m
1229,2,town,3749,164,6,7,13,46.2%,42m
1229,2,Otter,3749,30,2,2,4,50.0%,13m
1229,2,llllllllllll,3749,30,2,5,7,28.6%,45m
1229,2,[TRTR]Deas,3749,32,1,4,5,20.0%,37m
1234,2,[WisOP]Cephalopod,3748,664,28,15,43,65.1%,48m
1234,2,FanofCloud,3748,401,17,4,21,81.0%,38m
1234,2,terranstyle,3748,244,9,10,19,47.4%,9m
1234,2,llllllllllll,3748,94,4,3,7,57.1%,41m
1234,2,Baysen,3748,0,1,1,2,50.0%,35m
1239,2,LowApm,3746,334,23,15,38,60.5%,31m
1239,2,BlueRa,3746,68,3,6,9,33.3%,49m
1241,1,[ØØ]NerfHerder,3745,1890,356,364,720,49.4%,9m
1241,2,ctwo,3745,0,0,1,1,0.0%,40m
1243,2,Roma,3744,0,0,1,1,0.0%,48m
1244,2,[WNTR]Ordin,3743,1050,54,51,105,51.4%,51m
1245,2,DTox,3741,232,6,8,14,42.9%,12m
1245,2,psychoz,3741,0,0,7,7,0.0%,6m
1247,2,Mentanje,3740,706,117,115,232,50.4%,52m
1247,2,allmotor,3740,524,62,56,118,52.5%,38m
1247,2,disruptorOp,3740,583,23,19,42,54.8%,50m
1250,2,Reign,3738,909,66,44,110,60.0%,40m
1250,2,Supermahon,3738,205,43,49,92,46.7%,38m
1252,2,DemonSlayer,3737,610,24,15,39,61.5%,11m
1252,2,Kankedort,3737,436,20,13,33,60.6%,40m
1252,2,badassburito,3737,450,17,13,30,56.7%,39m
1252,2,[ValidG]Lemonio,3737,120,5,2,7,71.4%,46m
1256,3,Rin,3735,153,12,3,15,80.0%,26m
1257,2,Justonemore,3734,162,6,1,7,85.7%,3m
1257,2,[TGosuB]NOMAD,3734,120,4,9,13,30.8%,53m
1257,2,Zerko,3734,0,0,1,1,0.0%,53m
1260,2,[RlSKE]assassinXY,3733,66,3,4,7,42.9%,30m
1260,2,Alandalf,3733,0,1,0,1,100.0%,50m
1262,2,[DikBoy]Blodge,3732,926,34,40,74,45.9%,11m
1262,2,POTATO,3732,464,22,12,34,64.7%,46m
1262,2,SVETA,3732,0,0,1,1,0.0%,41m
1265,2,[adY]awS,3731,451,35,28,63,55.6%,41m
1265,2,[TPGGXD]Miguelitoohh,3731,378,19,1,20,95.0%,8m
1265,2,[pq]SaTivAs,3731,300,11,9,20,55.0%,42m
1265,2,bobby,3731,0,1,0,1,100.0%,42m
1265,2,Snagon,3731,0,0,1,1,0.0%,41m
1270,2,[UpeV]NewEra,3730,30,2,1,3,66.7%,31m
1270,2,[PPGER]Amikiller,3730,0,1,0,1,100.0%,38m
1270,2,QuEWeZz,3730,99,1,4,5,20.0%,42m
1273,2,XVIII,3729,482,36,36,72,50.0%,31m
1273,1,xLINKx,3729,712,18,30,48,37.5%,49m
1273,2,MadBadSad,3729,325,12,5,17,70.6%,36m
1273,2,[sa1t]BigFungus,3729,253,10,6,16,62.5%,6m
1277,2,barcode,3728,871,121,113,234,51.7%,28m
1277,2,[tired]Winter,3728,1603,70,53,123,56.9%,48m
1277,2,Evolution,3728,420,16,14,30,53.3%,30m
1280,2,Xiaomo,3727,0,1,0,1,100.0%,30m
1280,3,[UTSW]LightCloud,3727,0,1,1,2,50.0%,10m
1282,1,MrMAGII,3726,1594,152,162,314,48.4%,14m
1282,2,[GanGan]Rykuu,3726,226,12,7,19,63.2%,31m
1282,2,[13und]Pwnyo,3726,92,4,5,9,44.4%,7m
1282,2,Failer,3726,58,3,0,3,100.0%,8m
1282,2,[NwAs]PinkFloyd,3726,0,1,0,1,100.0%,28m
1282,2,[TCCrew]SneakyCuack,3726,0,0,3,3,0.0%,49m
1288,1,Gengar,3725,1680,124,143,267,46.4%,5m
1288,1,[xTQc]NotinMkSens,3725,944,42,50,92,45.7%,49m
1288,2,Lilù,3725,390,19,10,29,65.5%,46m
1288,2,Duffman,3725,0,0,1,1,0.0%,36m
1288,2,HKYoo,3725,0,0,1,1,0.0%,8m
1293,2,[TgAg]QuiOui,3723,326,16,7,23,69.6%,3m
1293,2,[TLibre]BuRgUeTe,3723,152,6,7,13,46.2%,52m
1295,2,GPLague,3722,280,10,11,21,47.6%,6m
1296,2,[CadeGs]Ultimifier,3721,646,23,27,50,46.0%,36m
1296,2,murK,3721,78,3,7,10,30.0%,46m
1298,1,[NPhase]aWildBoar,3720,1850,213,205,418,51.0%,40m
1299,3,[Pender]Conspiracy,3719,308,14,4,18,77.8%,30m
1299,2,Profisee,3719,212,7,7,14,50.0%,9m
1299,2,KozukiYamato,3719,88,4,3,7,57.1%,43m
1299,2,Bito,3719,0,0,5,5,0.0%,6m
1303,1,teefol,3718,1808,286,286,572,50.0%,33m
1303,2,qnzp,3718,114,7,0,7,100.0%,14m
1303,2,AgentSquall,3718,0,0,1,1,0.0%,38m
1306,2,pboyle,3716,1553,99,99,198,50.0%,43m
1306,1,Midge,3716,0,3,2,5,60.0%,33m
1306,2,twoSTEP,3716,0,0,1,1,0.0%,31m
1306,2,[NXLsc]memex,3716,0,0,1,1,0.0%,11m
1306,2,[CDS12]dayco,3716,0,0,3,3,0.0%,9m
1306,2,[TeamUR]Ghyslyn,3716,0,0,4,4,0.0%,49m
1312,2,cayaty,3715,472,18,19,37,48.6%,41m
1312,2,adamsun,3715,430,16,17,33,48.5%,51m
1312,2,TrashGame,3715,0,0,1,1,0.0%,49m
1312,2,RobotWizard,3715,0,0,2,2,0.0%,42m
1316,2,SirWhite,3714,316,13,12,25,52.0%,5m
1316,2,maybeiloveU,3714,90,3,3,6,50.0%,28m
1318,2,WaRzOnE,3713,472,55,9,64,85.9%,4m
1319,2,[Tl2ON]TRON,3712,62,2,5,7,28.6%,41m
1320,2,[QTp2T]Kobe,3711,184,14,8,22,63.6%,12m
1320,2,GeneralZ,3711,0,3,0,3,100.0%,44m
1322,1,AciD,3710,1855,214,221,435,49.2%,38m
1322,3,trumpinvinci,3710,109,11,2,13,84.6%,11m
1322,2,IIIIIIII,3710,60,2,3,5,40.0%,12m
1322,2,NUKLS,3710,0,0,1,1,0.0%,50m
1326,2,Whackatoe,3709,1164,45,39,84,53.6%,30m
1326,2,[BaCo]Lazerus,3709,785,30,22,52,57.7%,53m
1326,2,[NPhasA]CaptCuddles,3709,0,1,0,1,100.0%,6m
1326,2,Anthorn,3709,0,0,1,1,0.0%,12m
1330,2,Mapusan,3708,342,13,6,19,68.4%,45m
1330,3,Penumbra,3708,192,8,4,12,66.7%,38m
1330,2,[DRKESP]DrunkSCV,3708,109,1,3,4,25.0%,36m
1330,2,Raijingeki,3708,0,0,3,3,0.0%,52m
1334,2,[ExcIgN]TOUCH,3706,866,106,103,209,50.7%,40m
1334,1,SerBronn,3706,1606,101,114,215,47.0%,53m
1334,2,oddyseY,3706,620,28,16,44,63.6%,8m
1334,2,GlacierHades,3706,146,6,7,13,46.2%,46m
1334,2,[Fatty]HateLoad,3706,62,4,6,10,40.0%,30m
1339,2,david,3705,185,9,1,10,90.0%,52m
1339,2,Murtagh,3705,30,6,0,6,100.0%,37m
1339,2,MeemoSaan,3705,30,2,0,2,100.0%,42m
1342,2,[NKT1]YuiHatano,3704,302,11,7,18,61.1%,42m
1342,2,[MeyMey]Coxaflopin,3704,132,4,4,8,50.0%,41m
1342,2,[SsaYnS]KanyeEast,3704,30,2,0,2,100.0%,52m
1342,2,[TiChum]RaijiN,3704,0,1,0,1,100.0%,54m
1346,2,[FALURS]Marvel,3703,0,3,1,4,75.0%,37m
1346,2,[nPnSX]Hippyjet,3703,60,3,2,5,60.0%,46m
1348,1,[TGCrew]Westopoli,3702,948,27,39,66,40.9%,51m
1348,3,[GGxC]thegreybush,3702,121,4,5,9,44.4%,34m
1348,2,[Yuhang]Launcelot,3702,62,2,7,9,22.2%,52m
1351,3,[cl0udM]shiptor,3701,463,19,2,21,90.5%,8m
1351,2,YeosuBambada,3701,352,13,8,21,61.9%,6m
1351,3,Hoody,3701,209,8,2,10,80.0%,42m
1351,2,ALDASAM,3701,0,2,3,5,40.0%,37m
1351,2,Knify,3701,0,1,0,1,100.0%,41m
1351,2,Dark,3701,0,1,0,1,100.0%,4m
1351,2,Baysen,3701,0,1,1,2,50.0%,5m
1358,2,Cocamaster,3700,60,4,4,8,50.0%,40m
1358,2,Marine,3700,0,0,1,1,0.0%,50m
1358,2,[KiMBR]WizardShades,3700,0,0,2,2,0.0%,27m
1361,2,[F4R7Z]IIIIIIIIIIII,3699,557,90,98,188,47.9%,9m
1362,2,MaestroRF,3698,1104,47,34,81,58.0%,45m
1362,2,[3g0]KuVuTuNe,3698,0,0,1,1,0.0%,9m
1362,2,[CSGO]Panilanpa,3698,0,0,1,1,0.0%,3m
1365,1,yeunk,3697,1315,153,157,310,49.4%,37m
1365,3,[danuts]MNYODA,3697,191,5,1,6,83.3%,6m
1365,2,[ZTempz]PaRaGoNPasT,3697,0,0,3,3,0.0%,6m
1368,2,Bjl,3696,0,0,1,1,0.0%,5m
1368,2,[SBlock]KerryKaverga,3696,0,0,2,2,0.0%,11m
1370,2,Smob,3695,62,3,2,5,60.0%,9m
1371,2,[PaPP]TheSpacePope,3694,966,111,110,221,50.2%,52m
1371,2,FachoPobre,3694,288,11,8,19,57.9%,53m
1371,2,SilentKnight,3694,246,11,10,21,52.4%,5m
1371,3,MicroMarine,3694,58,3,1,4,75.0%,33m
1375,2,OsIrIs,3693,154,9,4,13,69.2%,6m
1375,2,DaTomminator,3693,196,7,7,14,50.0%,8m
1375,2,KUANG,3693,30,4,3,7,57.1%,9m
1375,2,DonMClean,3693,58,2,2,4,50.0%,26m
1375,3,Bighentai,3693,30,2,3,5,40.0%,10m
1375,2,Apophis,3693,0,1,3,4,25.0%,29m
1381,2,[SMB]Rainstorm,3692,157,3,3,6,50.0%,11m
1381,2,DonoWall,3692,30,2,0,2,100.0%,6m
1383,2,[xLgNx]terran,3691,903,101,107,208,48.6%,43m
1383,2,[NwAs]Draconix,3691,245,15,5,20,75.0%,9m
1385,2,[FraGx]TNTEarth,3690,1418,92,87,179,51.4%,53m
1385,2,XenoMorphKai,3690,601,27,19,46,58.7%,37m
1385,2,[420whg]Avaek,3690,303,14,6,20,70.0%,50m
1385,2,CalaVera,3690,384,13,13,26,50.0%,32m
1385,2,[RUMB]Resilient,3690,0,2,3,5,40.0%,46m
1385,2,GoOn,3690,62,2,9,11,18.2%,41m
1385,2,StormGudUnit,3690,0,1,0,1,100.0%,33m
1385,2,[SIClan]kiumars,3690,0,0,1,1,0.0%,44m
1385,2,feisto,3690,0,0,4,4,0.0%,11m
1394,1,Tomus,3689,48,1,2,3,33.3%,49m
1395,2,Dijkkie,3688,470,16,19,35,45.7%,4m
1395,2,[GEEKED]Amorfo,3688,200,11,7,18,61.1%,9m
1397,2,SlayrOfSmoke,3687,1231,59,58,117,50.4%,35m
1397,2,Canuck,3687,360,13,18,31,41.9%,12m
1397,1,[IBIMS]BoBaq,3687,143,8,1,9,88.9%,51m
1397,2,[xLgNx]Dive,3687,0,0,1,1,0.0%,6m
1401,2,XLordZayidX,3686,1128,141,137,278,50.7%,36m
1401,2,[DRKDMN]warrior,3686,1041,37,43,80,46.2%,26m
1401,2,[TB0C]ThousandSons,3686,170,7,8,15,46.7%,7m
1404,2,Jenny,3685,0,0,1,1,0.0%,11m
1405,2,GDawg,3684,0,0,1,1,0.0%,5m
1406,2,Castplay,3683,381,15,7,22,68.2%,14m
1406,2,crazy,3683,0,0,1,1,0.0%,29m
1408,2,bleeding,3682,1504,127,129,256,49.6%,35m
1408,2,IIIIIIIIIIII,3682,1029,59,37,96,61.5%,41m
1408,2,[Th3Bad]matheusT,3682,58,2,2,4,50.0%,46m
1408,2,Stringbean,3682,0,1,1,2,50.0%,33m
1408,2,[RPLLE]RPWaniboko,3682,0,0,1,1,0.0%,7m
1413,2,enchantment,3681,293,15,5,20,75.0%,44m
1414,2,[M32]HOFF,3679,834,63,58,121,52.1%,11m
1414,2,FunGame,3679,301,16,5,21,76.2%,49m
1414,2,[FLSHB8]BantTwinfist,3679,330,12,7,19,63.2%,49m
1414,2,[GOURDS]APD,3679,116,7,5,12,58.3%,54m
1414,3,qqq,3679,175,7,8,15,46.7%,41m
1414,2,mayorill,3679,60,2,7,9,22.2%,32m
1414,2,[v1rgin]Zelevin,3679,30,1,3,4,25.0%,44m
1421,2,Skewmer,3678,1223,98,81,179,54.7%,11m
1421,2,JYL,3678,322,11,18,29,37.9%,45m
1423,2,GameImba,3677,0,2,3,5,40.0%,6m
1424,2,[BRSKR]MUDABANG,3676,1515,97,79,176,55.1%,31m
1424,2,Shaurma,3676,428,78,76,154,50.6%,30m
1424,2,[GR33D]SilentFight,3676,30,2,1,3,66.7%,33m
1424,2,[CBO]Vromrig,3676,0,1,1,2,50.0%,9m
1428,2,[xRtG]Vegeta,3675,622,23,26,49,46.9%,27m
1428,2,[FkJeff]INnoVation,3675,58,3,1,4,75.0%,9m
1430,2,gamer,3674,172,7,9,16,43.8%,49m
1431,2,thewitherest,3673,1600,178,152,330,53.9%,50m
1431,1,[DIKOUT]cowSPHERE,3673,218,7,13,20,35.0%,37m
1431,2,Cruiser,3673,30,1,3,4,25.0%,37m
1431,2,Atlas,3673,0,0,2,2,0.0%,41m
1435,2,IamDerp,3672,316,15,8,23,65.2%,4m
1435,2,[236]Desty,3672,340,14,13,27,51.9%,5m
1435,2,DragonLily,3672,244,9,5,14,64.3%,12m
1438,2,asdasdasd,3671,248,8,15,23,34.8%,37m
1438,2,stärcraft,3671,120,4,1,5,80.0%,52m
1440,2,BitzPleaze,3670,291,13,12,25,52.0%,37m
1441,2,NoobKiller,3669,58,6,3,9,66.7%,37m
1441,2,[THROWS]Cantro,3669,172,6,7,13,46.2%,11m
1441,2,[HaMz]Parm,3669,0,1,0,1,100.0%,45m
1441,2,[Bxop]ian,3669,0,0,1,1,0.0%,54m
1445,2,[EoMX]artanis,3668,1539,339,328,667,50.8%,6m
1445,2,dgunzoid,3668,347,56,42,98,57.1%,38m
1445,2,[GRNSKN]monkaSniper,3668,0,1,1,2,50.0%,3m
1445,2,Spinozah,3668,0,0,1,1,0.0%,37m
1445,1,XXXXXXXXXXXX,3668,0,0,30,30,0.0%,48m
1450,2,[CBRA]medanat,3667,1146,115,110,225,51.1%,46m
1450,2,lavenderlich,3667,462,17,16,33,51.5%,32m
1452,2,[MDCo]siskel,3666,0,2,2,4,50.0%,41m
1452,2,WhatsThePLAN,3666,0,1,0,1,100.0%,41m
1454,1,Ghostmakerx,3665,1781,107,94,201,53.2%,27m
1454,2,[GØSU]TomboKai,3665,60,3,1,4,75.0%,26m
1454,2,[thebox]JuKes,3665,30,1,1,2,50.0%,44m
1457,1,TerraTron,3664,191,7,3,10,70.0%,6m
1458,2,[TheReg]Frost,3662,952,36,33,69,52.2%,49m
1458,3,Coffee,3662,169,4,2,6,66.7%,45m
1458,2,[Ikar0s]ExecutorFil,3662,0,1,0,1,100.0%,11m
1458,2,[TgAg]Doom,3662,0,0,1,1,0.0%,49m
1462,2,[cl0udM]Boreal,3661,258,10,8,18,55.6%,31m
1462,2,LeCannibale,3661,58,2,5,7,28.6%,9m
1464,2,[Pibo3]strahlor,3660,590,26,14,40,65.0%,35m
1464,2,[xLgNx]ColiNfsTrann,3660,0,1,1,2,50.0%,32m
1466,2,stirfry,3659,1620,283,279,562,50.4%,36m
1466,2,Torque,3659,166,8,2,10,80.0%,37m
1466,2,Crossan,3659,0,0,1,1,0.0%,42m
1469,3,biteme,3658,0,0,1,1,0.0%,33m
1469,2,[AtL450]RealoG,3658,0,0,1,1,0.0%,49m
1469,2,oGGoku,3658,0,0,1,1,0.0%,36m
1472,2,DayNine,3657,389,15,13,28,53.6%,31m
1472,2,Ridiculous,3657,0,0,1,1,0.0%,6m
1474,2,IIIIIIIIIIII,3656,0,5,0,5,100.0%,45m
1474,2,Ornstein,3656,0,0,1,1,0.0%,3m
1474,2,Tsun,3656,0,0,1,1,0.0%,46m
1477,2,[APM]Genuine,3655,834,62,51,113,54.9%,48m
1478,2,Sondaljan,3654,693,32,31,63,50.8%,37m
1478,1,[CN123]LSAIsLoser,3654,120,5,4,9,55.6%,11m
1478,2,[iTHC]MixxMastaJrT,3654,0,1,0,1,100.0%,54m
1478,2,[4RLZs]Asteroc,3654,0,0,4,4,0.0%,37m
1482,2,IIIIIIIIIIII,3652,58,3,2,5,60.0%,45m
1483,1,Igaeme,3651,1763,496,532,1028,48.2%,54m
1483,2,HUASCAR,3651,1280,102,92,194,52.6%,9m
1483,2,mizU,3651,30,1,2,3,33.3%,29m
1483,2,CTRL,3651,0,1,2,3,33.3%,40m
1487,2,[UnitQC]NaYa,3650,620,39,31,70,55.7%,39m
1487,2,hzheng,3650,406,17,18,35,48.6%,8m
1489,1,Lock,3649,1203,81,89,170,47.6%,45m
1489,2,blackjack,3649,949,44,24,68,64.7%,11m
1489,1,[SsaYnS]Clairvoyance,3649,84,4,10,14,28.6%,5m
1489,2,[GGBr0]IIIIII,3649,59,3,5,8,37.5%,50m
1489,2,Day,3649,90,3,5,8,37.5%,35m
1489,3,[FFJUST]Pookie,3649,0,1,0,1,100.0%,53m
1495,2,Zildy,3648,1558,132,134,266,49.6%,45m
1495,2,[αB]Geeth,3648,88,4,2,6,66.7%,5m
1495,2,[EvilGC]ChesitoPato,3648,90,4,5,9,44.4%,34m
1495,2,Garfield,3648,0,0,2,2,0.0%,7m
1499,2,samaitch,3647,1586,88,90,178,49.4%,49m
1499,2,MagicTerran,3647,347,18,8,26,69.2%,26m
1499,2,Zerker,3647,106,8,5,13,61.5%,27m
1499,2,[DNKCFT]DANKCRAFT,3647,174,7,4,11,63.6%,7m
1503,2,FriendComp,3646,142,8,6,14,57.1%,3m
1503,2,GenBan,3646,58,7,1,8,87.5%,49m
1503,2,[FANXY]Elfantome,3646,205,6,19,25,24.0%,27m
1503,1,Destrucity,3646,0,0,1,1,0.0%,46m
1507,2,slegehammer,3645,0,1,1,2,50.0%,28m
1507,2,[4eG]TheRedArmy,3645,30,1,2,3,33.3%,54m
1509,2,Harlequin,3644,368,35,31,66,53.0%,40m
1509,1,[12WERT]OGFindMuck,3644,390,11,17,28,39.3%,54m
1509,2,[Newbii]Zell,3644,0,4,1,5,80.0%,14m
1509,2,[trolz]Hakase,3644,0,2,3,5,40.0%,37m
1513,2,RobotWizard,3643,1603,133,106,239,55.6%,30m
1513,2,iadoH,3643,1581,123,128,251,49.0%,49m
1515,2,[mvcs]biaji,3642,561,24,15,39,61.5%,30m
1516,2,Tossim,3641,1586,127,105,232,54.7%,38m
1516,2,[DGP]Osukaru,3641,118,5,6,11,45.5%,51m
1516,2,[lNI]AlwaysHigh,3641,96,3,13,16,18.8%,3m
1516,2,Caleb,3641,0,0,1,1,0.0%,7m
1520,2,[VFam2]VanOoijen,3640,0,0,1,1,0.0%,39m
1521,2,Heartbreak,3639,756,30,40,70,42.9%,31m
1521,3,MisterPotato,3639,147,8,6,14,57.1%,49m
1521,1,MARU,3639,97,2,0,2,100.0%,42m
1521,2,seVen,3639,0,1,0,1,100.0%,7m
1525,2,[NutLow]TheMadBomber,3638,1055,61,53,114,53.5%,45m
1525,2,Oddsbodikins,3638,0,3,5,8,37.5%,12m
1525,2,sOs,3638,0,1,0,1,100.0%,12m
1525,2,Itsokman,3638,0,0,1,1,0.0%,53m
1529,2,Zoe,3637,316,21,22,43,48.8%,27m
1530,2,lIlllIIllIII,3636,250,8,9,17,47.1%,44m
1530,2,[Z0HR]Anarchy,3636,60,3,1,4,75.0%,32m
1530,2,[Xtsy]bluenoodle,3636,30,1,2,3,33.3%,13m
1533,2,[868]TriniCron,3635,1565,421,411,832,50.6%,6m
1533,2,Wenson,3635,424,14,22,36,38.9%,46m
1533,2,[9g9g]WaRnER,3635,0,0,1,1,0.0%,9m
1536,2,PKHALF,3634,412,22,7,29,75.9%,11m
1536,2,dcmsQuaLL,3634,58,4,1,5,80.0%,54m
1538,2,[TGCrew]FedSmoker,3633,30,1,1,2,50.0%,42m
1538,2,BluShifT,3633,0,0,1,1,0.0%,43m
1540,2,Synergy,3631,1252,287,284,571,50.3%,43m
1540,2,[xLgNx]RenaisSance,3631,348,16,17,33,48.5%,46m
1540,2,ibetuwill,3631,58,3,3,6,50.0%,11m
1540,2,Enceladus,3631,30,2,3,5,40.0%,49m
1544,2,[LEGROS]BIG,3630,30,1,1,2,50.0%,6m
1545,2,Liger,3629,892,74,75,149,49.7%,9m
1546,2,CptProtoss,3628,661,40,18,58,69.0%,7m
1546,2,[hTx]IMSpookeh,3628,150,5,7,12,41.7%,38m
1548,1,LARO,3627,1781,136,123,259,52.5%,5m
1548,2,[MadK]Marte,3627,1278,58,68,126,46.0%,14m
1548,2,idrinkwater,3627,309,13,5,18,72.2%,33m
1548,2,Obnehz,3627,88,4,1,5,80.0%,37m
1548,2,BlueRare,3627,0,0,1,1,0.0%,36m
1548,1,PickAndMix,3627,0,0,1,1,0.0%,38m
1554,2,Voracity,3626,1370,61,44,105,58.1%,44m
1554,2,Snikerdoodle,3626,642,55,63,118,46.6%,40m
1554,2,htty,3626,351,13,18,31,41.9%,49m
1554,2,[touchy]Robtimus,3626,30,2,0,2,100.0%,9m
1554,3,thecrazyone,3626,0,1,0,1,100.0%,44m
1554,2,Dresden,3626,0,0,1,1,0.0%,33m
1560,2,AndyPandy,3625,1599,231,227,458,50.4%,36m
1560,2,[LgnTDS]Zerg,3625,926,39,30,69,56.5%,38m
1560,1,delvur,3625,0,1,1,2,50.0%,40m
1560,3,SCAChoi,3625,30,1,4,5,20.0%,45m
1560,3,BuDz,3625,30,1,5,6,16.7%,25m
1565,2,phil,3624,458,20,19,39,51.3%,41m
1566,1,[LgnTDS]NotAgain,3623,1391,40,55,95,42.1%,43m
1566,2,oban,3623,60,2,2,4,50.0%,44m
1566,2,AIphaStar,3623,0,0,1,1,0.0%,31m
1569,2,llllllllllll,3622,929,47,41,88,53.4%,41m
1569,2,Meyr,3622,332,16,8,24,66.7%,45m
1569,2,[Whet]CallDown,3622,30,1,3,4,25.0%,41m
1572,2,[PwT]ßØÐE,3621,0,0,1,1,0.0%,26m
1573,2,rUready,3620,355,13,11,24,54.2%,46m
1574,2,PROXY,3619,857,99,92,191,51.8%,43m
1574,3,orotoss,3619,331,14,5,19,73.7%,7m
1574,2,Kerrigan,3619,0,4,1,5,80.0%,49m
1577,2,[WIDOWZ]Mendokusee,3618,584,21,22,43,48.8%,6m
1577,2,[SVY]GHOSTMARINE,3618,490,18,12,30,60.0%,49m
1577,3,[KyIe]Gravitas,3618,161,12,6,18,66.7%,11m
1577,2,[sMi]sMiLucky,3618,30,3,5,8,37.5%,30m
1577,2,TerranPatch,3618,58,2,4,6,33.3%,50m
1577,2,[PSISTM]Freeden,3618,30,1,1,2,50.0%,52m
1583,2,Syocto,3617,338,12,10,22,54.5%,4m
1583,2,Trout,3617,114,5,1,6,83.3%,50m
1583,2,Trinity,3617,104,3,4,7,42.9%,5m
1583,2,SpaceJustice,3617,0,2,0,2,100.0%,30m
1583,2,Player,3617,30,2,0,2,100.0%,26m
1583,2,[FyHr]ToyecaX,3617,0,1,2,3,33.3%,53m
1589,2,Retsof,3616,390,15,9,24,62.5%,50m
1589,2,Microwave,3616,212,12,5,17,70.6%,42m
1589,2,ManAtSea,3616,163,4,4,8,50.0%,42m
1589,2,KurtBlock,3616,0,0,1,1,0.0%,28m
1593,2,[TGosuB]SimplePickUp,3615,434,16,14,30,53.3%,30m
1593,1,BOONGBOONG,3615,207,10,2,12,83.3%,50m
1593,2,DOdoubleG,3615,258,8,7,15,53.3%,6m
1593,2,Ayo,3615,94,4,8,12,33.3%,11m
1597,2,[CHEZ]Nullify,3613,30,1,3,4,25.0%,27m
1598,1,ORGRIM,3612,238,6,3,9,66.7%,41m
1598,2,toast,3612,60,3,6,9,33.3%,7m
1598,2,momasbiscuit,3612,0,0,1,1,0.0%,50m
1601,2,[TXOP]Artekario,3611,86,3,2,5,60.0%,37m
1601,2,foREVer,3611,0,3,2,5,60.0%,11m
1601,2,PtiCreolMauv,3611,58,3,13,16,18.8%,34m
1601,2,Tiger,3611,0,0,3,3,0.0%,4m
1605,2,llllllllllll,3610,1469,92,91,183,50.3%,50m
1605,3,iathsdeia,3610,144,4,0,4,100.0%,44m
1605,2,HotKeyPlayer,3610,0,0,4,4,0.0%,11m
1608,2,[cl0udM]DeathByToss,3609,268,10,11,21,47.6%,28m
1608,2,NobleGenesis,3609,0,5,0,5,100.0%,5m
1608,3,[EWM]Itzwil,3609,30,3,9,12,25.0%,8m
1608,2,[SGsc18]TROVAS,3609,0,1,0,1,100.0%,44m
1612,2,[KingSC]Eddy,3607,150,7,11,18,38.9%,51m
1612,2,[RUMB]TyDo,3607,0,1,0,1,100.0%,38m
1612,2,[UpeV]blackdead,3607,0,0,1,1,0.0%,9m
1615,2,Meow,3606,830,29,37,66,43.9%,34m
1615,2,AirGoodman,3606,138,3,2,5,60.0%,4m
1615,3,[xFaDe]HealZ,3606,0,1,0,1,100.0%,12m
1618,2,[PobSC]Folka,3605,986,38,32,70,54.3%,43m
1618,2,[SSEAS]Ceicel,3605,58,3,3,6,50.0%,36m
1618,2,[cl0udM]Kakarott,3605,30,1,3,4,25.0%,40m
1618,2,Dude,3605,0,0,1,1,0.0%,12m
1622,2,hootis,3604,706,25,24,49,51.0%,49m
1622,2,Bluntbread,3604,116,4,13,17,23.5%,11m
1624,2,Cricket,3603,30,1,2,3,33.3%,6m
1625,2,[FReNs]LEGENDARY,3602,143,4,3,7,57.1%,36m
1626,2,[WO0K]WhiteClaw,3601,58,3,0,3,100.0%,54m
1626,2,[xCZx]NinjaDuckBob,3601,0,1,0,1,100.0%,49m
1628,2,EasyG,3600,1602,215,204,419,51.3%,37m
1628,2,TrueNorth,3600,938,40,31,71,56.3%,37m
1628,1,Megatron,3600,972,32,57,89,36.0%,31m
1628,2,Fringe,3600,234,9,3,12,75.0%,43m
1628,2,Banger,3600,86,4,3,7,57.1%,33m
1628,2,WerzMyBackup,3600,60,3,2,5,60.0%,49m
1628,2,[PiGPan]MaruAmoriani,3600,88,3,3,6,50.0%,28m
1635,2,MrBigshot,3599,924,39,31,70,55.7%,5m
1635,2,FroggyStylez,3599,956,34,44,78,43.6%,30m
1635,2,[cl0udM]aButtPirate,3599,278,10,5,15,66.7%,26m
1635,2,kadoeo,3599,0,1,0,1,100.0%,48m
1635,2,[FnS]DiZ,3599,0,1,1,2,50.0%,30m
1640,2,ArieS,3598,818,35,29,64,54.7%,46m
1640,2,BarrackOhana,3598,495,24,26,50,48.0%,36m
1640,2,[FataI]ReBeL,3598,324,14,6,20,70.0%,53m
1640,3,[TATR]Toasty,3598,280,13,6,19,68.4%,51m
1640,2,Vamos,3598,60,3,2,5,60.0%,42m
1645,2,[IWCP]snackerS,3597,1050,47,31,78,60.3%,30m
1645,2,[UrMove]MangoSpice,3597,118,4,6,10,40.0%,49m
1645,2,[lLiTl]HektorOfTroy,3597,30,2,1,3,66.7%,50m
1645,2,TiagoooJeDi,3597,0,0,1,1,0.0%,5m
1645,2,[ConFed]BigPapaPump,3597,0,0,5,5,0.0%,9m
1650,2,[ixM]tetec,3596,942,53,45,98,54.1%,37m
1650,2,[zeez]Synastren,3596,724,27,32,59,45.8%,38m
1650,2,[EtrOy]lightwolf,3596,416,17,10,27,63.0%,36m
1650,2,[cl0udM]gRiT,3596,400,16,9,25,64.0%,31m
1650,2,Orestes,3596,58,3,3,6,50.0%,33m
1650,2,FartinG,3596,0,0,8,8,0.0%,41m
1656,2,IIIIIIIIIII,3595,832,38,23,61,62.3%,14m
1656,2,IIIIIIIIIIII,3595,193,11,3,14,78.6%,5m
1656,2,Jaguar,3595,102,7,0,7,100.0%,14m
1656,2,oGizMo,3595,0,0,4,4,0.0%,7m
1660,2,[NerfZg]Aguero,3594,162,5,3,8,62.5%,46m
1660,3,PROTOSSLORD,3594,147,3,4,7,42.9%,34m
1660,2,[BYU]BYU,3594,102,2,1,3,66.7%,3m
1663,2,ChairMao,3593,1571,275,267,542,50.7%,27m
1663,2,[TSS]Underoath,3593,1096,44,44,88,50.0%,41m
1663,2,superdemon,3593,239,13,5,18,72.2%,37m
1663,2,TerdFerguson,3593,262,11,4,15,73.3%,31m
1663,2,Cerulean,3593,97,2,5,7,28.6%,29m
1668,2,[51JTM]tassadar,3592,470,24,18,42,57.1%,33m
1668,2,[SsaYnS]kanstar,3592,230,10,14,24,41.7%,41m
1668,1,[αB]AlCaPwneD,3592,48,2,3,5,40.0%,41m
1668,2,[xLgNx]IcyGoblin,3592,0,0,1,1,0.0%,43m
1672,2,InsungMungae,3591,357,14,8,22,63.6%,33m
1672,2,[YD2K]GBFK,3591,90,4,5,9,44.4%,37m
1672,2,Dstar,3591,58,3,1,4,75.0%,40m
1672,1,BigPP,3591,96,1,1,2,50.0%,9m
1672,2,Charlotte,3591,0,0,1,1,0.0%,33m
1677,2,OBCD,3590,427,21,18,39,53.8%,49m
1677,2,Fear,3590,200,7,8,15,46.7%,46m
1677,3,Beyondexx,3590,171,4,5,9,44.4%,38m
1677,2,SOAPY,3590,58,3,3,6,50.0%,9m
1677,2,PrinzEugen,3590,30,2,4,6,33.3%,11m
1677,2,HyperDragoon,3590,30,1,1,2,50.0%,3m
1677,2,supermech,3590,0,0,1,1,0.0%,8m
1684,2,Iconoclast,3589,147,3,5,8,37.5%,42m
1684,2,WIN,3589,0,2,3,5,40.0%,5m
1684,2,winning,3589,30,2,4,6,33.3%,12m
1684,2,Coyrn,3589,0,1,0,1,100.0%,26m
1684,2,LEGACYofVOID,3589,0,1,2,3,33.3%,36m
1689,2,Piry,3588,88,1,1,2,50.0%,5m
1690,2,PlzTrump,3587,344,12,9,21,57.1%,38m
1690,2,NoMicroWin,3587,120,4,6,10,40.0%,12m
1690,2,[LCE]GaToo,3587,0,1,0,1,100.0%,37m
1690,2,Myelin,3587,0,1,0,1,100.0%,13m
1690,2,xjohtox,3587,30,1,1,2,50.0%,41m
1690,2,nDubs,3587,0,0,1,1,0.0%,38m
1696,2,JCTC,3586,1480,73,55,128,57.0%,54m
1696,2,[LCE]JuanManuel,3586,1018,41,37,78,52.6%,49m
1696,2,MasterFree,3586,0,2,3,5,40.0%,7m
1696,2,magbar,3586,30,1,3,4,25.0%,28m
1696,2,[FyHr]Raúl,3586,0,0,1,1,0.0%,42m
1701,2,BROTATO,3585,1012,45,33,78,57.7%,36m
1701,2,Anthony,3585,1018,36,45,81,44.4%,6m
1701,1,mACROpLAYER,3585,121,4,5,9,44.4%,48m
1701,2,Tervaperse,3585,0,1,3,4,25.0%,40m
1705,2,EdithB,3584,233,9,5,14,64.3%,27m
1705,2,Irv,3584,124,4,14,18,22.2%,27m
1705,2,[8iSh]Heeebster,3584,112,3,0,3,100.0%,46m
1708,1,EuroBeats,3583,211,7,3,10,70.0%,41m
1708,2,DABO,3583,88,5,1,6,83.3%,30m
1708,2,[ssexxy]Corvus,3583,0,0,1,1,0.0%,9m
1711,2,[VFam]Zaechus,3582,516,22,13,35,62.9%,34m
1711,2,[BUTFUQ]ace,3582,166,8,11,19,42.1%,40m
1711,2,[sAFT]JellyMaster,3582,192,6,3,9,66.7%,41m
1711,3,IIIIIIIIII,3582,0,5,0,5,100.0%,4m
1711,2,[KGH]smoOthster,3582,30,1,2,3,33.3%,51m
1716,2,SoLo,3581,1435,78,85,163,47.9%,45m
1716,2,Oneofthree,3581,173,10,4,14,71.4%,12m
1716,2,[NPhasA]DanieLBee,3581,164,6,1,7,85.7%,42m
1716,2,Jenny,3581,88,4,2,6,66.7%,54m
1716,2,ZoF,3581,30,1,5,6,16.7%,31m
1716,2,[YD2K]AoNxWookie,3581,0,0,3,3,0.0%,49m
1722,2,Yeet,3580,166,9,3,12,75.0%,37m
1722,2,[LgnTDS]MachoMantis,3580,0,1,0,1,100.0%,52m
1722,2,[WTR]Kilroy,3580,0,0,1,1,0.0%,52m
1725,2,[AlIin]NineK,3579,204,10,0,10,100.0%,41m
1725,2,DasWagen,3579,95,2,0,2,100.0%,28m
1727,2,Perfect,3578,432,18,14,32,56.2%,3m
1727,2,AzazeL,3578,154,7,4,11,63.6%,27m
1727,2,[ZTempz]Zara,3578,146,6,4,10,60.0%,6m
1727,2,[CHAPU]DARK,3578,189,5,2,7,71.4%,30m
1727,2,CREAMPIELORD,3578,0,2,3,5,40.0%,11m
1727,3,[TGosuA]ESCypher,3578,0,1,0,1,100.0%,41m
1733,2,MedXJunkie,3577,833,35,29,64,54.7%,30m
1734,2,lilyachty,3576,1568,108,106,214,50.5%,9m
1734,1,[AnUB]MEGATRON,3576,1727,92,94,186,49.5%,47m
1734,2,[Astute]ThaoTheSofa,3576,1479,74,71,145,51.0%,11m
1734,2,Mad,3576,849,47,15,62,75.8%,52m
1734,2,LDraGo,3576,639,25,24,49,51.0%,49m
1734,2,bluestar,3576,0,1,0,1,100.0%,12m
1740,2,[Shardz]ThatOneDude,3574,1207,69,64,133,51.9%,29m
1740,2,Lightforger,3574,704,51,49,100,51.0%,40m
1740,2,Midas,3574,691,30,20,50,60.0%,4m
1740,2,CaoCao,3574,163,8,1,9,88.9%,28m
1740,2,LLegacies,3574,114,4,5,9,44.4%,28m
1745,2,[UoM]Tortle,3573,152,5,2,7,71.4%,7m
1745,3,dawn,3573,58,2,5,7,28.6%,48m
1745,2,[765]Bakon,3573,0,1,0,1,100.0%,28m
1748,2,Solitude,3572,1570,363,351,714,50.8%,36m
1748,2,Avenger,3572,1560,157,158,315,49.8%,46m
1748,2,Computer,3572,487,19,22,41,46.3%,52m
1748,2,Inertia,3572,358,13,16,29,44.8%,49m
1748,2,Kraulenth,3572,279,10,6,16,62.5%,31m
1748,2,[BRSKR]Paloma,3572,88,6,4,10,60.0%,44m
1754,2,[DETER]DirtyToilet,3571,782,73,61,134,54.5%,46m
1754,2,TrueSouth,3571,278,9,17,26,34.6%,37m
1754,1,Mercy,3571,48,2,3,5,40.0%,54m
1754,2,Thron,3571,30,1,4,5,20.0%,38m
1758,2,[BoRnGo]MooCowThon,3570,1057,45,38,83,54.2%,30m
1758,2,Anomaly,3570,280,11,5,16,68.8%,9m
1758,1,[HazIPA]Zen,3570,121,6,3,9,66.7%,12m
1758,2,jason,3570,0,4,1,5,80.0%,30m
1758,3,itsanap,3570,0,3,2,5,60.0%,42m
1758,2,Bartomeu,3570,0,0,1,1,0.0%,11m
1764,2,[ZTempz]SoggyInferno,3569,901,34,41,75,45.3%,53m
1764,1,IIIIIIIIIIII,3569,168,5,3,8,62.5%,44m
1764,2,[JGalt]theo,3569,58,3,5,8,37.5%,5m
1764,3,Turtoise,3569,0,1,1,2,50.0%,39m
1764,2,[Jalanp]Sprite,3569,0,0,1,1,0.0%,50m
1769,3,[Cow5]Lustmord,3568,304,13,5,18,72.2%,12m
1769,2,Allegseuh,3568,122,7,6,13,53.8%,37m
1769,2,[SiG7]Chiffins,3568,0,4,1,5,80.0%,53m
1769,2,[MWM]miomamo,3568,88,3,3,6,50.0%,4m
1769,2,[SuperZ]NorthAnor,3568,0,0,1,1,0.0%,11m
1769,2,JDP,3568,0,0,2,2,0.0%,50m
1775,2,BYBY,3567,1419,99,69,168,58.9%,30m
1775,2,TheGreat,3567,918,50,18,68,73.5%,14m
1775,2,[NovaX]HJM,3567,959,50,61,111,45.0%,26m
1775,2,unabated,3567,635,32,45,77,41.6%,5m
1775,2,Tempest,3567,60,2,5,7,28.6%,37m
1775,2,grrrrrrrrrrr,3567,60,2,8,10,20.0%,42m
1775,2,IamNaeroK,3567,0,1,0,1,100.0%,8m
1782,1,[2faded]Random,3566,697,19,32,51,37.3%,6m
1782,2,[FxB]MaeFire,3566,150,6,7,13,46.2%,43m
1782,2,[CBAS2]GiantReaver,3566,0,2,8,10,20.0%,8m
1782,2,[Dal3]Ares,3566,0,1,0,1,100.0%,33m
1786,2,SEMINENCE,3565,1121,96,79,175,54.9%,49m
1786,2,KAYPAK,3565,204,7,8,15,46.7%,7m
1786,2,[FYous]Zzzz,3565,114,2,2,4,50.0%,33m
1789,2,Protonin,3564,1473,82,92,174,47.1%,37m
1789,2,Saltlord,3564,348,73,52,125,58.4%,54m
1789,2,[Exehn]Topspin,3564,102,3,1,4,75.0%,36m
1789,2,[StS]Tritor,3564,88,2,0,2,100.0%,50m
1793,2,[SsaYnS]HappyHippo,3563,548,22,21,43,51.2%,38m
1793,2,llllllllllll,3563,156,7,0,7,100.0%,44m
1793,2,Pants,3563,116,3,1,4,75.0%,41m
1796,2,LENOX,3562,805,43,16,59,72.9%,52m
1796,2,valkryie,3562,386,17,10,27,63.0%,49m
1796,2,CaptPlanet,3562,274,11,11,22,50.0%,40m
1796,2,[Kappa8]TricoCV,3562,168,6,4,10,60.0%,11m
1796,2,milkTEA,3562,86,4,3,7,57.1%,8m
1796,2,SinaSC,3562,0,3,3,6,50.0%,11m
1796,2,SuperiaHands,3562,0,0,1,1,0.0%,42m
1796,2,[m8z]ladygaga,3562,0,0,1,1,0.0%,49m
1804,2,[xSYNx]Impaler,3561,824,37,25,62,59.7%,12m
1804,3,[NPhasA]Ãdolf,3561,30,1,1,2,50.0%,10m
1804,2,[SPARK]Wulfe,3561,0,0,1,1,0.0%,14m
1804,2,[Curds]Fushickut,3561,0,0,1,1,0.0%,42m
1808,2,[xLgNx]Calm,3560,352,18,5,23,78.3%,33m
1808,3,[EzyPzY]TopRahman,3560,0,4,1,5,80.0%,51m
1808,2,[DRONGO]Indominable,3560,0,0,2,2,0.0%,6m
1808,2,Microman,3560,0,0,3,3,0.0%,26m
1812,2,Pacific,3559,1244,75,59,134,56.0%,29m
1812,2,[ØÛ]Vendettavic,3559,369,20,7,27,74.1%,40m
1812,2,Soptich,3559,0,5,0,5,100.0%,44m
1812,2,Cannatonic,3559,110,4,13,17,23.5%,11m
1812,2,PhagoCytE,3559,102,2,1,3,66.7%,9m
1812,2,random,3559,0,0,1,1,0.0%,49m
1818,2,JinC,3558,692,112,114,226,49.6%,41m
1818,2,Lennek,3558,504,20,15,35,57.1%,8m
1818,2,SneakySnake,3558,142,5,8,13,38.5%,5m
1818,2,VanillaLove,3558,0,1,1,2,50.0%,46m
1822,2,CiscoCert,3557,972,41,42,83,49.4%,49m
1822,2,oUróboRoS,3557,140,8,2,10,80.0%,37m
1822,2,FalcoN,3557,0,5,0,5,100.0%,52m
1822,3,[xTQc]Maz,3557,108,3,0,3,100.0%,8m
1822,2,person,3557,0,1,1,2,50.0%,48m
1822,2,[BJWD]llllllllllll,3557,0,0,1,1,0.0%,8m
1828,2,[LOOPY]drmdrm,3556,179,6,4,10,60.0%,49m
1828,2,[Toiley]Klog,3556,112,3,1,4,75.0%,42m
1830,2,MrWhiskers,3555,617,26,37,63,41.3%,39m
1830,2,[TG3]learytheory,3555,424,15,18,33,45.5%,6m
1830,2,[DarkAG]Sleepy,3555,154,5,3,8,62.5%,31m
1830,2,Rezian,3555,116,3,1,4,75.0%,36m
1830,2,Zugg,3555,0,1,0,1,100.0%,37m
1830,2,Zakarumae,3555,0,0,1,1,0.0%,41m
1836,2,[EtrOy]AnloreRH,3554,482,66,61,127,52.0%,53m
1836,2,srsqtee,3554,374,14,12,26,53.8%,5m
1836,1,SoulCalibur,3554,207,10,2,12,83.3%,7m
1836,2,ZynKa,3554,88,1,1,2,50.0%,11m
1836,2,Xecuter,3554,0,0,1,1,0.0%,53m
1841,2,[HØST]DarkVorazun,3553,236,13,14,27,48.1%,9m
1841,2,GOOBA,3553,88,1,1,2,50.0%,54m
1843,2,Random,3552,784,37,29,66,56.1%,55m
1843,2,[HØST]RuiterD,3552,102,3,1,4,75.0%,11m
1845,1,[KoopaZ]Maleficent,3551,1739,97,114,211,46.0%,49m
1845,2,[LlQUlD]Jinro,3551,332,11,11,22,50.0%,38m
1845,2,[HOV]RAV,3551,0,2,3,5,40.0%,37m
1845,2,[DETER]Mirko,3551,0,1,0,1,100.0%,9m
1849,1,Rolly,3550,142,2,4,6,33.3%,55m
1850,2,DamageINC,3549,454,94,97,191,49.2%,51m
1850,2,Esco,3549,659,26,23,49,53.1%,26m
1850,2,Samaitch,3549,566,20,20,40,50.0%,52m
1850,2,Disciple,3549,60,2,4,6,33.3%,33m
1850,2,[Lp]Larso,3549,0,1,0,1,100.0%,51m
1855,2,[NLTTJ]sohot,3548,645,42,30,72,58.3%,49m
1855,2,gooseduck,3548,535,20,18,38,52.6%,50m
1855,2,Deylinia,3548,118,5,10,15,33.3%,39m
1855,2,[αX]Nemesis,3548,116,3,3,6,50.0%,46m
1855,2,[BOkaos]Balmung,3548,0,0,1,1,0.0%,46m
1860,2,Fifth,3547,551,27,13,40,67.5%,33m
1860,2,StevenSeagal,3547,88,4,3,7,57.1%,6m
1860,2,[TGosuC]Maliss,3547,0,1,4,5,20.0%,4m
1860,1,[CodeB]DirTyTactics,3547,0,0,2,2,0.0%,53m
1860,2,Barcode,3547,0,0,2,2,0.0%,47m
1860,2,[DuCKen]Gastritis,3547,0,0,2,2,0.0%,52m
1860,2,[Vitami]Vitamins,3547,0,0,5,5,0.0%,30m
1867,2,[PTHero]CharactR,3546,476,23,22,45,51.1%,33m
1867,2,[VoHox]beastti,3546,316,11,12,23,47.8%,49m
1867,2,xellowgetfuk,3546,96,6,1,7,85.7%,5m
1867,3,[JTRUMP]MilesCru,3546,0,2,3,5,40.0%,41m
1867,3,SinGiRu,3546,0,1,0,1,100.0%,47m
1867,3,xiaochun,3546,0,1,0,1,100.0%,36m
1867,3,Beastin,3546,0,0,1,1,0.0%,49m
1874,1,undefined,3545,1070,83,105,188,44.1%,4m
1874,2,[eZzZzZ]VictuM,3545,1174,46,43,89,51.7%,31m
1874,2,LuckyX,3545,142,7,1,8,87.5%,48m
1874,2,dcpwilliam,3545,0,0,2,2,0.0%,5m
1878,2,[LQV]MasterYoda,3544,859,145,129,274,52.9%,26m
1878,2,Fluoxetine,3544,633,51,36,87,58.6%,41m
1878,2,bigBUTts,3544,548,22,23,45,48.9%,4m
1878,3,llllllllllll,3544,331,12,7,19,63.2%,6m
1878,2,FooFoo,3544,136,4,2,6,66.7%,8m
1883,2,Zombiesaurus,3543,549,22,17,39,56.4%,9m
1884,2,iRLFayTz,3542,509,19,17,36,52.8%,37m
1884,3,Falco,3542,241,10,6,16,62.5%,41m
1884,3,iNFiNiTY,3542,0,1,0,1,100.0%,45m
1884,3,[LAGCR]KiPToR,3542,0,0,1,1,0.0%,14m
1888,2,Fourby,3541,905,38,29,67,56.7%,6m
1888,2,[AD3C]CuBaNo,3541,498,18,20,38,47.4%,41m
1888,2,[SBlock]Alan,3541,139,3,1,4,75.0%,8m
1888,3,[BLNT]TehBorg,3541,0,0,1,1,0.0%,31m
1892,2,OddiE,3540,1413,85,83,168,50.6%,53m
1892,3,Lazy,3540,274,10,4,14,71.4%,13m
1892,2,PNess,3540,272,9,14,23,39.1%,51m
1892,3,Trogdor,3540,0,0,1,1,0.0%,49m
1896,2,asdf,3539,508,19,24,43,44.2%,54m
1896,2,HateGGONG,3539,162,6,4,10,60.0%,8m
1898,2,[LQQMPP]Qkumber,3538,745,33,33,66,50.0%,35m
1898,3,[wtfbbq]Symbolic,3538,146,6,2,8,75.0%,28m
1898,2,[ANIMOO]Dannie,3538,112,3,3,6,50.0%,46m
1898,1,satiety,3538,48,2,0,2,100.0%,31m
1898,3,[gecko]Covariance,3538,0,2,3,5,40.0%,30m
1903,2,[GnR]StuBob,3537,390,14,24,38,36.8%,54m
1903,2,[EGx]Jäger,3537,0,1,3,4,25.0%,42m
1905,2,TTY,3536,1482,101,107,208,48.6%,7m
1906,2,MyThOs,3535,1440,279,206,485,57.5%,42m
1906,2,Aphex,3535,718,111,116,227,48.9%,53m
1906,2,Mimir,3535,324,14,9,23,60.9%,37m
1906,2,[Kingx]Cye,3535,144,6,6,12,50.0%,49m
1906,1,[OVER9K]aneruok,3535,225,6,8,14,42.9%,27m
1906,1,IBGreedy,3535,96,4,8,12,33.3%,48m
1906,3,GuitarGuy,3535,0,0,1,1,0.0%,5m
1906,3,Diogo,3535,0,0,1,1,0.0%,37m
1914,3,GLizZyGoBBLe,3534,330,13,12,25,52.0%,31m
1914,2,llllllllllll,3534,202,11,4,15,73.3%,5m
1914,2,[Astute]Innovatable,3534,191,6,5,11,54.5%,31m
1914,2,Deometris,3534,176,6,10,16,37.5%,30m
1914,3,llllllllllll,3534,0,1,0,1,100.0%,37m
1919,2,Werner,3533,368,12,13,25,48.0%,9m
1919,1,Derz,3533,253,11,4,15,73.3%,6m
1919,2,Cheno,3533,217,9,4,13,69.2%,55m
1919,2,kadesh,3533,262,8,11,19,42.1%,38m
1919,2,kasilisco,3533,0,0,2,2,0.0%,4m
1924,3,ChadBroChill,3532,730,38,16,54,70.4%,28m
1924,2,BustOnYou,3532,0,1,0,1,100.0%,33m
1924,3,Payphone,3532,30,1,1,2,50.0%,26m
1927,2,Hiramekarei,3531,402,15,20,35,42.9%,51m
1927,3,Decadence,3531,174,4,6,10,40.0%,47m
1929,3,[VKNG5]RedHorse,3530,30,1,2,3,33.3%,26m
1929,3,[NwAs]Odinsc,3530,0,0,1,1,0.0%,38m
1931,2,[KrV]KrVBurgrKing,3529,350,11,20,31,35.5%,37m
1931,3,Tapu,3529,114,4,1,5,80.0%,36m
1931,2,[FxB]Duttles,3529,0,0,2,2,0.0%,43m
1934,2,[SANGRE]ibetuwill,3528,1128,47,40,87,54.0%,52m
1934,2,Emu,3528,130,5,2,7,71.4%,53m
1934,3,wipeOut,3528,30,1,8,9,11.1%,38m
1937,2,Mays,3527,1123,94,96,190,49.5%,12m
1937,2,[PSISTM]KenjiMuyo,3527,702,50,57,107,46.7%,26m
1937,2,[Kyps]SorryImHigh,3527,796,43,30,73,58.9%,26m
1937,3,[PNS]Parafina,3527,141,4,1,5,80.0%,28m
1937,2,[YSP]WhaleHunter,3527,102,4,6,10,40.0%,26m
1937,2,[αXLa]Mabels,3527,0,2,4,6,33.3%,49m
1943,2,MooStar,3526,490,23,13,36,63.9%,11m
1943,2,[SDAASD]Ming,3526,622,21,30,51,41.2%,26m
1945,3,[BLKISH]BlackishWolf,3525,86,4,6,10,40.0%,29m
1946,2,SoftStorm,3524,1448,258,258,516,50.0%,39m
1946,2,Nord,3524,805,33,31,64,51.6%,52m
1946,3,[unm2]shino,3524,167,5,4,9,55.6%,12m
1946,3,Pancakes,3524,0,2,3,5,40.0%,33m
1946,3,Seven,3524,0,0,1,1,0.0%,29m
1951,2,BboySmilez,3523,1342,159,149,308,51.6%,38m
1951,3,GreySquid,3523,0,5,0,5,100.0%,10m
1951,3,vixolin,3523,0,1,0,1,100.0%,12m
1954,3,Ikepono,3522,1651,336,328,664,50.6%,11m
1954,2,Waterbottle,3522,331,12,9,21,57.1%,36m
1954,2,YuriOrlov,3522,146,6,11,17,35.3%,30m
1954,2,[TDDS]dahiJa,3522,142,3,5,8,37.5%,52m
1954,3,GalopinGhost,3522,58,2,1,3,66.7%,28m
1954,3,Zypher,3522,30,2,1,3,66.7%,45m
1960,2,UnderBob,3521,1549,562,553,1115,50.4%,13m
1960,2,noggin,3521,111,6,8,14,42.9%,7m
1960,3,LiquidPaper,3521,58,4,3,7,57.1%,26m
1960,2,[TUED]Arourou,3521,0,0,1,1,0.0%,45m
1964,3,Sauceee,3520,231,11,6,17,64.7%,34m
1964,3,Oenari,3520,30,3,3,6,50.0%,30m
1966,2,sWiTcH,3519,1419,111,104,215,51.6%,36m
1966,2,Serenity,3519,494,18,27,45,40.0%,41m
1966,3,[xTQc]FiNiTioN,3519,0,2,3,5,40.0%,48m
1966,3,[cl0udM]Stroke,3519,0,1,0,1,100.0%,49m
1970,2,MrPotatoHead,3518,452,57,51,108,52.8%,6m
1970,3,MASSUKA,3518,0,1,0,1,100.0%,9m
1970,3,[TSØP]Darkill,3518,0,1,2,3,33.3%,49m
1970,3,[q420p]DaddyTrump,3518,0,0,1,1,0.0%,13m
1974,3,RiP,3517,0,4,1,5,80.0%,31m
1974,3,BLEST,3517,0,4,1,5,80.0%,30m
1974,3,Klubbhead,3517,0,0,1,1,0.0%,42m
1974,2,[TGCrew]Darkblade,3517,0,0,3,3,0.0%,44m
1978,3,Biggestbro,3515,0,1,0,1,100.0%,38m
1978,2,Mustacracken,3515,0,0,3,3,0.0%,43m
1980,2,Tyve,3514,1138,97,81,178,54.5%,49m
1980,3,[33rd]Mozzi,3514,0,0,2,2,0.0%,52m
1980,2,Legacy,3514,0,0,3,3,0.0%,13m
1983,2,Patches,3512,1445,116,115,231,50.2%,53m
1983,2,Cyclops,3512,967,87,88,175,49.7%,37m
1983,3,[gromp]Ragnarokette,3512,97,1,3,4,25.0%,34m
1986,2,GambleGambel,3511,599,86,86,172,50.0%,44m
1986,2,Stacy,3511,364,18,7,25,72.0%,30m
1986,1,Ray,3511,213,4,6,10,40.0%,39m
1986,1,[INextI]Judicator,3511,0,0,1,1,0.0%,6m
1990,2,Vultreus,3509,36,7,10,17,41.2%,52m
1990,1,ChairmanMao,3509,94,5,8,13,38.5%,12m
1990,3,KurtBlock,3509,0,1,0,1,100.0%,34m
1990,3,[3g0]ChlnO,3509,0,1,1,2,50.0%,49m
1990,3,[QuackD]Hulio,3509,0,0,1,1,0.0%,5m
1995,2,[Cow5]Pancakeo,3508,252,10,2,12,83.3%,39m
1995,2,SOCCIA,3508,115,2,3,5,40.0%,9m
1995,3,Alyeva,3508,0,0,1,1,0.0%,37m
1998,2,FreshJuice,3507,1379,206,210,416,49.5%,52m
1998,2,argonkingdom,3507,479,19,16,35,54.3%,35m
1998,3,Desty,3507,88,6,4,10,60.0%,45m
1998,2,TheBestfOu,3507,94,4,9,13,30.8%,26m
1998,3,[GUCCl]fruitseller,3507,86,3,2,5,60.0%,5m
1998,3,elegance,3507,0,1,0,1,100.0%,52m
1998,3,[LTlord]ZON,3507,30,1,2,3,33.3%,44m
1998,3,[SnW]PeoNSaGe,3507,30,1,2,3,33.3%,14m
2006,2,Ease,3506,360,17,10,27,63.0%,31m
2006,2,Jimson,3506,30,2,5,7,28.6%,46m
2006,2,cheeseman,3506,0,1,3,4,25.0%,42m
2009,2,[Chizu]Innovaciones,3505,1481,97,95,192,50.5%,26m
2009,3,NoooB,3505,396,19,12,31,61.3%,10m
2009,3,xuisp,3505,166,8,6,14,57.1%,26m
2009,3,[F0cus]ISaeGo,3505,92,3,3,6,50.0%,29m
2009,2,crunchatized,3505,64,3,8,11,27.3%,30m
2014,2,ShrimpMoney,3504,1037,152,159,311,48.9%,26m
2014,2,UwUPimpollo,3504,1154,83,81,164,50.6%,51m
2014,2,llllllllllll,3504,512,23,20,43,53.5%,4m
2014,3,PanTo,3504,349,12,6,18,66.7%,37m
2014,3,Morpheus,3504,0,4,1,5,80.0%,41m
2014,3,[WMA]Chambersiziz,3504,30,2,2,4,50.0%,5m
2020,1,Wolvrine,3503,1135,42,61,103,40.8%,5m
2020,2,Megaman,3503,676,23,29,52,44.2%,38m
2020,3,chIP,3503,0,0,3,3,0.0%,34m
2023,2,Ancient,3502,1466,75,70,145,51.7%,41m
2023,3,[ML]PSF,3502,60,7,1,8,87.5%,7m
2023,2,[SC2AU]vEnergyDrink,3502,144,6,12,18,33.3%,11m
2023,3,LanKa,3502,0,4,1,5,80.0%,40m
2023,2,[TOOHI]JeXeD,3502,108,3,5,8,37.5%,4m
2023,3,Hizzay,3502,0,1,1,2,50.0%,14m
2029,3,BlackDragon,3501,627,24,20,44,54.5%,26m
2029,3,FlukeShow,3501,264,11,10,21,52.4%,48m
2029,3,[Illini]Neverland,3501,0,5,0,5,100.0%,52m
2029,3,pog,3501,0,3,2,5,60.0%,51m
2029,3,[LoF]Time,3501,0,1,0,1,100.0%,44m
2029,2,moke,3501,0,1,0,1,100.0%,26m
2029,3,[D4KSDE]Mauri,3501,30,1,1,2,50.0%,41m
2036,2,Eddy,3500,282,15,8,23,65.2%,30m
2036,3,Jatlantis,3500,86,7,1,8,87.5%,51m
2036,2,[x3D]DROPSECT,3500,62,3,6,9,33.3%,51m
2036,2,HYVAA,3500,88,2,2,4,50.0%,50m
2036,2,Excon,3500,0,0,2,2,0.0%,8m
2041,1,diamondDRG,3499,1704,381,383,764,49.9%,31m
2041,2,[GoBrrr]Shockwave,3499,792,35,27,62,56.5%,6m
2043,2,Jestin,3498,1280,186,178,364,51.1%,35m
2043,3,[xGs]yetzul,3498,114,5,3,8,62.5%,53m
2043,3,NubeVoladora,3498,181,5,4,9,55.6%,10m
2043,3,IordOfFlies,3498,60,3,4,7,42.9%,37m
2047,2,[PTHero]Neutralis,3497,597,25,21,46,54.3%,12m
2047,1,Fortitudo,3497,190,6,6,12,50.0%,48m
2047,3,IIIIIIIIIIII,3497,0,5,0,5,100.0%,31m
2047,3,[Maegis]Red,3497,86,4,1,5,80.0%,42m
2047,3,[UCSD]Artistic,3497,0,1,0,1,100.0%,46m
2047,3,JubilantCows,3497,0,0,2,2,0.0%,30m
2053,1,SodaGrackers,3496,0,1,0,1,100.0%,48m
2053,3,[HQ]Hyerquality,3496,30,1,2,3,33.3%,42m
2053,2,[urdone]Chiefpokeaho,3496,30,1,5,6,16.7%,5m
2056,2,ZvZzzzz,3495,1446,197,201,398,49.5%,51m
2056,2,thePimpoyo,3495,1054,37,41,78,47.4%,27m
2056,2,iiliiliiliil,3495,88,6,1,7,85.7%,11m
2056,3,Hammypan,3495,120,3,2,5,60.0%,7m
2060,2,Nitramzero,3494,764,40,19,59,67.8%,44m
2060,1,LazyTurtle,3494,167,10,4,14,71.4%,33m
2060,2,SgtRatlaGOD,3494,221,8,8,16,50.0%,51m
2060,3,[Toxity]liberty,3494,0,1,4,5,20.0%,26m
2064,3,[KingSC]roma,3493,142,6,2,8,75.0%,26m
2064,3,Darklo,3493,0,0,1,1,0.0%,38m
2066,2,Jun,3492,1117,69,54,123,56.1%,30m
2066,3,[Frzen]Lanaya,3492,368,13,16,29,44.8%,7m
2066,3,Jmpzisbad,3492,0,1,0,1,100.0%,31m
2069,2,Landrew,3491,1383,103,90,193,53.4%,8m
2069,3,[ZTemps]Fibonacci,3491,1373,53,49,102,52.0%,13m
2069,2,lIIIllllIlIl,3491,895,43,31,74,58.1%,43m
2069,2,Redbaron,3491,641,28,21,49,57.1%,11m
2069,3,gottleich,3491,0,5,0,5,100.0%,26m
2069,2,[EZDUNK]Mindgames,3491,0,1,0,1,100.0%,9m
2069,1,Summon,3491,0,0,2,2,0.0%,32m
2069,3,[NODANE]boofberry,3491,0,0,2,2,0.0%,44m
2077,2,[JRB]ZCBP,3490,62,3,5,8,37.5%,37m
2077,3,[DTXt]Deluxe,3490,0,0,2,2,0.0%,37m
2079,1,SyriuSBack,3489,209,10,4,14,71.4%,47m
2079,3,[PTHero]Vampire,3489,196,6,6,12,50.0%,38m
2079,3,DroNE,3489,97,2,2,4,50.0%,14m
2079,3,[CHEWIN]Jumper,3489,0,0,1,1,0.0%,36m
2083,2,[iTLiT]Hustlen,3488,1551,132,134,266,49.6%,47m
2083,2,[Cryptc]Legendary,3488,1080,37,48,85,43.5%,9m
2083,3,NightMare,3488,188,7,3,10,70.0%,38m
2083,2,[421]Tyho,3488,116,7,12,19,36.8%,33m
2087,2,[MAGA21]ScoTT,3487,726,29,29,58,50.0%,3m
2087,2,eeedddccc,3487,520,18,19,37,48.6%,30m
2087,2,YuSmoLpeen,3487,321,12,9,21,57.1%,29m
2087,2,[JHU]pAndorA,3487,246,8,25,33,24.2%,5m
2091,3,YELKAO,3486,340,15,14,29,51.7%,12m
2091,2,[lCeMan]iCeMan,3486,266,9,15,24,37.5%,41m
2091,2,[MOBO]Micotarie,3486,130,4,4,8,50.0%,12m
2091,2,[3XR]WardOTR,3486,102,3,4,7,42.9%,35m
2091,3,[INRI]Darvan,3486,0,0,1,1,0.0%,37m
2096,2,Bob,3485,120,8,9,17,47.1%,3m
2096,1,Jpat,3485,49,4,14,18,22.2%,5m
2098,3,ZoniekilleR,3484,30,1,3,4,25.0%,30m
2099,2,[cl0udM]AniketosMav,3483,738,37,25,62,59.7%,9m
2099,3,NoScared,3483,522,23,2,25,92.0%,54m
2099,2,redbone,3483,243,13,7,20,65.0%,8m
2102,2,doud,3482,268,15,8,23,65.2%,51m
2102,3,[NaDa]Chobo,3482,86,4,1,5,80.0%,6m
2102,3,wonder,3482,0,3,2,5,60.0%,47m
2102,2,DrNoob,3482,46,2,2,4,50.0%,27m
2102,3,Emily,3482,0,0,1,1,0.0%,41m
2107,2,Kilson,3481,408,13,15,28,46.4%,7m
2108,3,kilvan,3480,858,36,24,60,60.0%,9m
2108,2,[RnM4EV]MortestMorty,3480,265,26,16,42,61.9%,44m
2108,3,TANIOS,3480,96,2,2,4,50.0%,30m
2108,3,[Risque]LDOGPANKAKE,3480,0,0,1,1,0.0%,37m
2112,3,[LgnTDS]Fact,3479,314,16,9,25,64.0%,38m
2112,3,[TROS]Poser,3479,0,0,1,1,0.0%,30m
2112,3,Rudy,3479,0,0,2,2,0.0%,34m
2115,3,[BMBMBM]KFCZinger,3478,471,20,12,32,62.5%,25m
2115,3,Ninx,3478,334,13,3,16,81.2%,37m
2115,3,XSAGITTARUSX,3478,0,1,0,1,100.0%,45m
2118,3,ArthurS,3477,90,8,3,11,72.7%,8m
2118,3,Auslender,3477,0,5,0,5,100.0%,11m
2118,3,splay,3477,0,0,1,1,0.0%,6m
2121,2,[iDrunk]Loocsinatas,3476,444,19,18,37,51.4%,8m
2121,3,fred,3476,0,3,2,5,60.0%,42m
2121,3,[ValidG]Sujen,3476,60,2,3,5,40.0%,41m
2124,3,[ShoaL]Red,3475,0,0,1,1,0.0%,33m
2125,2,[PGTLGL]Pochi,3474,1534,112,122,234,47.9%,45m
2125,1,StupidProbe,3474,166,8,4,12,66.7%,51m
2125,3,Webster,3474,0,4,0,4,100.0%,45m
2125,3,Mackky,3474,58,3,3,6,50.0%,41m
2125,2,Oski,3474,0,1,0,1,100.0%,42m
2125,2,[5150BB]JJMax,3474,0,0,2,2,0.0%,4m
2131,2,gTimes,3473,736,104,81,185,56.2%,47m
2131,2,Hysteric,3473,666,28,25,53,52.8%,3m
2131,2,[GKat]VmC,3473,762,27,32,59,45.8%,55m
2131,3,ThorIsHere,3473,365,17,16,33,51.5%,44m
2131,3,gasbreakdip,3473,318,12,7,19,63.2%,51m
2131,3,Meemoo,3473,144,6,4,10,60.0%,47m
2131,3,[flyrev]flyrev,3473,0,2,3,5,40.0%,27m
2138,3,[idscom]bata,3472,116,9,1,10,90.0%,41m
2138,3,TheDoctor,3472,99,8,6,14,57.1%,44m
2138,3,Daniel,3472,167,8,8,16,50.0%,3m
2138,3,PatchRandom,3472,0,1,0,1,100.0%,6m
2142,3,HipHopotamus,3471,1031,109,102,211,51.7%,52m
2143,3,Sarandia,3470,661,28,20,48,58.3%,8m
2143,3,[LFC]MamMoTH,3470,250,12,3,15,80.0%,26m
2143,2,RandomGuy,3470,227,10,3,13,76.9%,8m
2146,2,[XpKb]Ramzzez,3469,1303,53,45,98,54.1%,43m
2146,2,[Align]RIZZTOWN,3469,476,20,26,46,43.5%,27m
2146,3,Shogun,3469,346,13,5,18,72.2%,30m
2146,1,JasperNoone,3469,242,11,5,16,68.8%,49m
2146,1,StinkyBrain,3469,209,6,5,11,54.5%,41m
2146,1,WkDx,3469,213,5,29,34,14.7%,33m
2146,1,[Hm00ng]IceCream,3469,144,4,3,7,57.1%,31m
2153,2,ehdeelee,3468,1369,174,173,347,50.1%,36m
2153,2,[OhSnap]ItSOnRaNDoM,3468,1090,58,51,109,53.2%,36m
2153,2,[Virgo]ZDragon,3468,384,15,30,45,33.3%,45m
2153,2,Elbandido,3468,298,10,12,22,45.5%,5m
2153,2,Antoinette,3468,131,8,4,12,66.7%,5m
2153,2,[YD2K]TheMIHM,3468,124,8,10,18,44.4%,49m
2153,3,[AMBP]HotAmbush,3468,93,1,2,3,33.3%,41m
2160,2,dinnertime,3467,806,98,98,196,50.0%,13m
2160,3,[bsaur]Fylypek,3467,344,13,10,23,56.5%,10m
2160,3,[RLB666]TlTsParty,3467,30,2,1,3,66.7%,51m
2160,3,BaneRain,3467,30,2,4,6,33.3%,36m
2160,3,[DRONGO]bega,3467,30,1,1,2,50.0%,26m
2165,3,Contoss,3466,118,4,7,11,36.4%,8m
2165,3,SuperDog,3466,0,2,3,5,40.0%,10m
2165,1,[bM4e]ArtTherapist,3466,0,1,0,1,100.0%,48m
2168,3,Taydon,3465,438,17,12,29,58.6%,9m
2168,3,[ZDE20]ShaneLiang,3465,0,2,3,5,40.0%,26m
2168,3,[KingSC]NATALI,3465,0,1,1,2,50.0%,45m
2171,2,[PTHero]shWall,3464,750,31,36,67,46.3%,34m
2171,2,[TryA]VicentiN,3464,170,6,6,12,50.0%,30m
2171,2,Heart,3464,178,5,8,13,38.5%,40m
2171,2,ScubaLakes,3464,88,3,8,11,27.3%,8m
2171,3,YourFace,3464,0,1,0,1,100.0%,36m
2176,3,Bjader,3463,238,8,9,17,47.1%,8m
2176,3,UnknownNOone,3463,140,6,5,11,54.5%,37m
2176,3,NoScared,3463,0,5,0,5,100.0%,45m
2176,3,Riesenlurch,3463,42,3,4,7,42.9%,51m
2180,2,[SsaYnS]fiveQ,3462,1543,292,293,585,49.9%,54m
2180,3,[NwAs]LEINAD,3462,724,28,21,49,57.1%,8m
2180,3,[Flam3s]Dias,3462,58,3,6,9,33.3%,15m
2180,3,OpWaNaGeThY,3462,0,1,0,1,100.0%,37m
2184,2,[YD2K]cptrock,3461,603,93,81,174,53.4%,38m
2184,3,PooCreator,3461,1349,68,51,119,57.1%,6m
2184,2,[Lp]DaRkneSS,3461,1112,44,47,91,48.4%,46m
2184,3,NorthPower,3461,385,25,18,43,58.1%,51m
2184,2,wafs,3461,370,17,29,46,37.0%,40m
2189,3,Sloth,3460,136,5,7,12,41.7%,14m
2189,3,Dmutri,3460,30,1,2,3,33.3%,28m
2191,3,Nightmare,3459,1228,70,53,123,56.9%,6m
2191,3,Jeedy,3459,354,15,17,32,46.9%,43m
2191,3,BeSt,3459,121,6,1,7,85.7%,51m
2191,3,[UpeV]Garule,3459,0,5,0,5,100.0%,36m
2191,2,Jehee,3459,62,3,6,9,33.3%,11m
2191,3,wizardc,3459,0,0,3,3,0.0%,45m
2197,3,[D3A]Kaelen,3458,898,35,27,62,56.5%,8m
2197,3,MonstR,3458,121,6,1,7,85.7%,54m
2197,3,[αXLa]AcmeHero,3458,60,2,4,6,33.3%,42m
2200,2,tRex,3457,1240,154,139,293,52.6%,49m
2200,3,[EhTeam]Duke,3457,1578,81,65,146,55.5%,29m
2200,2,[KSTONE]Meven,3457,1401,60,69,129,46.5%,13m
2200,2,[Kleets]Kolado,3457,459,22,27,49,44.9%,27m
2200,3,[cl0udM]Divi,3457,532,20,14,34,58.8%,30m
2200,2,[ICL]Karthdaddy,3457,345,12,18,30,40.0%,54m
2200,3,[Gouda]Bunsen,3457,168,7,9,16,43.8%,8m
2200,2,snowflake,3457,143,6,7,13,46.2%,52m
2200,3,[500CC]Natum,3457,30,4,2,6,66.7%,49m
2200,3,[cl0udM]OldFashion,3457,0,1,0,1,100.0%,40m
2200,3,[icon]Lildaver,3457,0,0,1,1,0.0%,7m
2200,1,Shootz,3457,0,0,1,1,0.0%,45m
2212,3,Fartosis,3456,30,1,1,2,50.0%,13m
2213,1,ipxC,3455,118,3,3,6,50.0%,29m
2213,2,ReaPerTeRRaN,3455,88,2,6,8,25.0%,4m
2213,3,[unm2]Tachatte,3455,0,1,0,1,100.0%,48m
2213,3,HEIHEI,3455,0,0,1,1,0.0%,10m
2217,2,miamilow,3454,940,43,35,78,55.1%,47m
2217,3,[theBSL]Svetz,3454,365,13,11,24,54.2%,36m
2217,3,[805]Rambler,3454,140,6,1,7,85.7%,44m
2217,2,MMeRchant,3454,163,5,8,13,38.5%,28m
2217,3,babyduckfart,3454,30,1,1,2,50.0%,32m
2222,3,[xTQc]WishDeath,3453,916,34,32,66,51.5%,53m
2222,2,DarkFox,3453,0,2,5,7,28.6%,26m
2222,2,[DrgnEg]Nûby,3453,137,2,12,14,14.3%,11m
2222,2,Dawserg,3453,96,1,2,3,33.3%,30m
2222,2,Riflescout,3453,0,1,2,3,33.3%,39m
2227,3,[ØÛ]StartinHP,3452,348,14,8,22,63.6%,49m
2227,3,Wicle,3452,86,3,1,4,75.0%,29m
2227,3,Dcru,3452,0,3,2,5,60.0%,42m
2227,2,Chraser,3452,0,1,0,1,100.0%,44m
2227,2,[GGDA]invictor,3452,0,1,2,3,33.3%,44m
2232,2,[PNS]Tek,3451,640,45,39,84,53.6%,37m
2232,3,[YEM]DogLog,3451,399,37,16,53,69.8%,11m
2232,3,[Sw0le]Bodybuilding,3451,58,2,1,3,66.7%,37m
2235,2,Goguryeo,3450,484,35,35,70,50.0%,35m
2235,3,[PRB4SL]MrBooze,3450,86,4,5,9,44.4%,37m
2235,3,KitcoMeSCBr,3450,0,1,0,1,100.0%,44m
2235,1,FruitsCode,3450,0,1,2,3,33.3%,1h
2235,3,[1vsM]flachwichser,3450,0,0,1,1,0.0%,4m
2240,3,Ivanzord,3449,1601,206,196,402,51.2%,41m
2240,3,[TeamUR]Andacht,3449,666,25,25,50,50.0%,11m
2240,2,Riski,3449,185,6,4,10,60.0%,3m
2240,3,NuggetBucker,3449,97,5,1,6,83.3%,51m
2240,1,ArgonKing,3449,73,1,1,2,50.0%,54m
2245,2,vSixty,3448,187,27,27,54,50.0%,35m
2245,3,Miller,3448,266,10,6,16,62.5%,31m
2245,3,[YAKUTZ]YamonBamon,3448,144,8,1,9,88.9%,25m
2245,3,[UFC]KrazyDago,3448,236,8,10,18,44.4%,8m
2245,3,Green,3448,97,2,2,4,50.0%,37m
2245,3,[ValidG]Ins,3448,30,1,2,3,33.3%,14m
2251,2,[DarkAG]auto,3447,1583,101,112,213,47.4%,45m
2251,3,TouchMe,3447,594,23,17,40,57.5%,31m
2251,3,BsKCoto,3447,86,4,1,5,80.0%,54m
2251,3,[InGt]thurston,3447,142,3,3,6,50.0%,39m
2251,3,life,3447,97,2,4,6,33.3%,12m
2256,3,huhu,3446,1537,149,134,283,52.7%,44m
2256,2,[DC420]DanCLan,3446,1285,111,105,216,51.4%,41m
2256,3,[RGNK]Sursurrus,3446,348,14,14,28,50.0%,45m
2256,3,Dwkoh,3446,172,6,5,11,54.5%,28m
2256,3,rurru,3446,86,4,0,4,100.0%,44m
2256,3,NomaD,3446,114,4,3,7,57.1%,29m
2256,3,Toto,3446,62,4,12,16,25.0%,27m
2256,3,[MdF]Domsaleo,3446,30,2,1,3,66.7%,38m
2256,3,BuFFSaGe,3446,30,2,3,5,40.0%,52m
2256,3,Snuffles,3446,0,1,5,6,16.7%,12m
2256,3,Weebles,3446,0,0,1,1,0.0%,52m
2267,2,[7B]BestOfSeven,3445,574,27,22,49,55.1%,35m
2267,3,[Pig2]krioni,3445,369,17,19,36,47.2%,28m
2267,3,Soul,3445,0,3,2,5,60.0%,42m
2267,3,llMachiNell,3445,88,3,3,6,50.0%,28m
2267,2,[Uprise]LionEnCage,3445,122,2,7,9,22.2%,46m
2272,2,llllllllllll,3444,889,70,71,141,49.6%,47m
2272,3,Frost,3444,478,41,30,71,57.7%,49m
2272,3,streeD,3444,285,11,9,20,55.0%,37m
2272,3,Wizzy,3444,0,4,2,6,66.7%,48m
2272,3,DaBunkaKid,3444,30,1,7,8,12.5%,8m
2277,2,[Nut69]Ike,3443,1460,138,123,261,52.9%,52m
2277,3,mcVV,3443,1592,132,136,268,49.3%,10m
2277,3,Stinkfist,3443,809,70,68,138,50.7%,37m
2277,3,Inspirit,3443,166,7,6,13,53.8%,12m
2277,3,CnDMaster,3443,86,3,3,6,50.0%,41m
2277,3,Pdizzle,3443,0,0,1,1,0.0%,30m
2277,3,[xLgNx]GunnerBlade,3443,0,0,1,1,0.0%,34m
2284,3,showmax,3442,383,17,8,25,68.0%,34m
2284,1,Cyrus,3442,97,6,3,9,66.7%,52m
2284,2,Frag,3442,156,5,9,14,35.7%,44m
2284,1,Pwnography,3442,118,3,5,8,37.5%,26m
2284,3,SKTIBANKY,3442,0,1,0,1,100.0%,5m
2284,3,Niki,3442,0,0,1,1,0.0%,48m
2290,3,YorkHawk,3441,532,38,23,61,62.3%,9m
2290,3,[BSSG]LaCucaracha,3441,778,29,26,55,52.7%,32m
2290,3,xpope,3441,200,8,4,12,66.7%,51m
2290,1,PeonYou,3441,0,1,4,5,20.0%,26m
2290,1,IIIIIIIIIIII,3441,0,1,4,5,20.0%,1h
2295,3,[Prison]REV,3440,1325,70,68,138,50.7%,6m
2295,3,[tbagTM]woppers,3440,30,1,1,2,50.0%,41m
2295,3,Strybosch,3440,0,0,1,1,0.0%,53m
2298,3,Pina,3439,1558,132,124,256,51.6%,9m
2298,2,[Flying]Willie,3439,1257,89,94,183,48.6%,39m
2298,2,[INextI]Gergy,3439,612,22,25,47,46.8%,49m
2298,2,mrfun,3439,222,12,16,28,42.9%,41m
2298,3,IIIIIIIIIIII,3439,30,4,3,7,57.1%,5m
2298,3,kishan,3439,30,2,1,3,66.7%,30m
2298,3,PuFF,3439,0,1,0,1,100.0%,7m
2298,3,NNNostaliii,3439,0,1,0,1,100.0%,26m
2298,1,NeronX,3439,0,0,2,2,0.0%,3h
2307,3,[WTZ]ZugZagZug,3438,336,13,10,23,56.5%,6m
2307,3,[INextI]Ozzy,3438,0,1,0,1,100.0%,26m
2307,3,VincenteIL,3438,0,1,0,1,100.0%,33m
2310,3,Gatsby,3437,287,22,18,40,55.0%,55m
2310,3,[WNSG]Anktious,3437,141,3,5,8,37.5%,32m
2310,3,[PiGPan]Piccolo,3437,30,2,1,3,66.7%,40m
2310,3,[JBRONI]TerranDan,3437,0,1,0,1,100.0%,29m
2310,3,Fishbed,3437,0,0,1,1,0.0%,26m
2315,3,ToddMargaret,3436,518,21,18,39,53.8%,38m
2315,3,Militia,3436,60,2,6,8,25.0%,45m
2315,1,Aspros,3436,0,1,0,1,100.0%,3h
2318,3,kingnerd,3435,1260,267,253,520,51.3%,36m
2318,3,Ashlyn,3435,430,29,12,41,70.7%,13m
2318,3,[KGH4]Wanted,3435,376,15,6,21,71.4%,51m
2318,3,SpineshanK,3435,466,15,19,34,44.1%,32m
2318,3,[MSotU]Mustang,3435,0,1,0,1,100.0%,40m
2318,3,TheBBC,3435,0,0,1,1,0.0%,47m
2318,3,Tropiczz,3435,0,0,1,1,0.0%,6m
2325,2,Husyelt,3434,1423,141,153,294,48.0%,9m
2325,3,[NFLDs]Imperator,3434,1300,87,84,171,50.9%,4m
2325,3,[NrFms]LingLeadeR,3434,252,9,11,20,45.0%,31m
2325,3,[MoSun]YellowLarva,3434,145,8,7,15,53.3%,48m
2325,3,QuanticPsych,3434,58,3,0,3,100.0%,6m
2325,3,[EoT]Lorekt,3434,0,0,1,1,0.0%,10m
2325,3,Praetor,3434,0,0,1,1,0.0%,27m
2332,3,[813ice]AntxTen,3433,929,41,24,65,63.1%,49m
2332,3,[SFUSC]MingA,3433,557,23,14,37,62.2%,31m
2332,3,hatethisgame,3433,150,6,6,12,50.0%,37m
2332,3,Shadorunner,3433,182,6,8,14,42.9%,43m
2336,2,[FxB]zil,3432,1380,77,74,151,51.0%,37m
2336,3,Cyque,3432,618,26,25,51,51.0%,44m
2336,3,Herakles,3432,0,1,5,6,16.7%,40m
2339,3,FatalglorY,3431,500,19,20,39,48.7%,37m
2339,3,batty,3431,180,9,15,24,37.5%,45m
2339,3,Boom,3431,204,8,2,10,80.0%,33m
2339,3,[UpeV]BarCode,3431,122,3,1,4,75.0%,31m
2339,3,[OGbros]GypsyQueen,3431,28,2,2,4,50.0%,11m
2339,3,IIIIIIIIIIII,3431,0,1,0,1,100.0%,29m
2339,3,Jabaja,3431,0,1,2,3,33.3%,36m
2339,1,IIIIIIIIIIII,3431,0,1,4,5,20.0%,1h
2347,3,JaBc,3430,274,10,12,22,45.5%,28m
2347,3,LuckyPants,3430,144,3,3,6,50.0%,6m
2347,1,[grity]MrKeatz,3430,0,0,5,5,0.0%,40m
2350,3,[BZ]Katarsis,3429,1054,41,37,78,52.6%,27m
2350,3,DaOmega,3429,914,33,36,69,47.8%,12m
2350,3,[VENSC2]draga,3429,146,19,13,32,59.4%,53m
2350,2,[OCSD]duckRawr,3429,250,8,15,23,34.8%,43m
2350,3,[LGNxx]ivTheMazoku,3429,86,4,2,6,66.7%,47m
2350,1,KARAKURT,3429,0,3,2,5,60.0%,1h
2350,3,[AngryB]Cheesy,3429,0,1,0,1,100.0%,8m
2350,3,Talemar,3429,30,1,3,4,25.0%,48m
2358,2,[PCAKE]Involution,3428,1055,145,138,283,51.2%,42m
2358,3,AllStimmedUp,3428,1652,94,86,180,52.2%,7m
2358,3,[VFam]Andrew,3428,58,2,1,3,66.7%,36m
2358,3,[Ohyo]Gupps,3428,0,1,0,1,100.0%,41m
2362,3,[StepUp]DirtyFlamer,3427,193,6,8,14,42.9%,26m
2362,2,[LOOPY]ClockwiseLGI,3427,0,1,0,1,100.0%,13m
2362,3,[182]DAVID,3427,0,0,1,1,0.0%,50m
2362,3,[αB]SnowFlower,3427,0,0,1,1,0.0%,37m
2362,3,Antibiotics,3427,0,0,1,1,0.0%,30m
2367,3,[ScSwrm]hunter,3426,266,11,2,13,84.6%,38m
2367,3,Papprittar,3426,238,7,7,14,50.0%,9m
2367,2,[LGNxx]macdwest,3426,0,5,3,8,62.5%,45m
2367,3,[KGH]Dakota,3426,0,1,0,1,100.0%,54m
2367,3,[NGFR]JarJarDinks,3426,0,0,1,1,0.0%,43m
2372,3,Eleven,3425,508,19,16,35,54.3%,53m
2372,3,Computer,3425,0,1,3,4,25.0%,8m
2374,3,plop,3424,1558,99,95,194,51.0%,29m
2374,3,[F0D]Spizella,3424,432,16,14,30,53.3%,11m
2374,2,DaveyGunface,3424,340,11,16,27,40.7%,14m
2374,3,LOSTzTALE,3424,232,8,10,18,44.4%,47m
2374,2,lllllllllll,3424,142,6,4,10,60.0%,37m
2374,3,[blacLM]CheesePizza,3424,60,3,2,5,60.0%,38m
2380,2,masterGIL,3423,1621,115,113,228,50.4%,48m
2380,2,hellviper,3423,1466,111,121,232,47.8%,7m
2380,3,PasFromage,3423,1361,73,17,90,81.1%,7m
2380,3,sparkster,3423,271,10,7,17,58.8%,30m
2380,3,[Remy]SoulRain,3423,0,1,1,2,50.0%,37m
2380,3,strelitzia,3423,0,1,1,2,50.0%,28m
2380,2,CptHindsight,3423,0,1,7,8,12.5%,41m
2380,1,[UpeV]Radstok,3423,0,0,1,1,0.0%,6m
2388,3,PhattyNutz,3422,329,55,45,100,55.0%,11m
2388,2,[BLSTIX]GuMiho,3422,885,45,47,92,48.9%,42m
2388,3,[KGH]spargo,3422,734,29,22,51,56.9%,34m
2388,3,holaqhace,3422,58,3,3,6,50.0%,14m
2388,3,[xRFR]COURAGEWOLF,3422,58,2,4,6,33.3%,40m
2393,3,Hyajms,3421,178,8,2,10,80.0%,37m
2393,3,NAlowIQsoEZ,3421,0,3,1,4,75.0%,33m
2393,3,FluvsKornor,3421,30,2,1,3,66.7%,6m
2393,3,NaOH,3421,0,1,0,1,100.0%,27m
2397,2,Chris,3420,600,22,26,48,45.8%,7m
2397,3,[HGG]Oxygen,3420,398,16,11,27,59.3%,11m
2399,3,[AiMB]fiziokrat,3419,1659,154,128,282,54.6%,28m
2399,3,keit,3419,945,43,25,68,63.2%,32m
2399,2,Raider,3419,396,13,18,31,41.9%,42m
2399,3,[2AnimE]MihoLN,3419,276,11,12,23,47.8%,51m
2399,3,[HORSE]Pariah,3419,216,7,10,17,41.2%,48m
2399,3,GameBoy,3419,0,4,1,5,80.0%,5m
2399,3,[Kaii]CyBorg,3419,165,3,3,6,50.0%,30m
2399,3,[2AhB]Omedon,3419,0,1,0,1,100.0%,4m
2399,3,DeViLHaZe,3419,0,1,0,1,100.0%,28m
2399,3,[UpeV]DayZ,3419,30,1,1,2,50.0%,12m
2409,3,AsherBro,3418,1112,45,34,79,57.0%,34m
2409,3,[RusWin]Alcoworld,3418,193,14,16,30,46.7%,41m
2409,3,Stinkfist,3418,88,5,3,8,62.5%,37m
2409,3,maddestlad,3418,148,5,10,15,33.3%,31m
2413,2,[VENSC2]SCHOMBERG,3417,1052,106,111,217,48.8%,27m
2413,2,[1E100]Tapirus,3417,989,36,38,74,48.6%,31m
2413,1,CanCel,3417,0,4,1,5,80.0%,1h
2413,3,Life,3417,0,0,2,2,0.0%,7m
2417,3,Schnitzel,3416,757,61,36,97,62.9%,32m
2417,1,gof,3416,278,12,6,18,66.7%,40m
2417,3,[Q5]Holmy,3416,30,1,1,2,50.0%,37m
2417,3,Kyezer,3416,0,0,1,1,0.0%,47m
2421,3,[Krizby]Player,3415,1640,71,59,130,54.6%,42m
2421,3,Fermi,3415,880,47,35,82,57.3%,48m
2421,3,[GRU]Heelion,3415,566,22,18,40,55.0%,30m
2421,2,BoomBabyBoom,3415,131,3,2,5,60.0%,38m
2425,2,bwag,3414,1444,296,279,575,51.5%,11m
2425,2,sheep,3414,1561,183,189,372,49.2%,10m
2425,3,[void44]epicvoid,3414,965,44,21,65,67.7%,6m
2425,3,[InGt]Yukon,3414,332,12,13,25,48.0%,14m
2425,3,[ClanZN]YumKimil,3414,316,11,11,22,50.0%,6m
2425,3,[grity]hoebag,3414,58,2,3,5,40.0%,34m
2425,3,Naimad,3414,0,2,3,5,40.0%,11m
2425,3,[QcScT]wanted,3414,30,2,6,8,25.0%,9m
2425,3,MacroKing,3414,0,1,2,3,33.3%,37m
2425,3,Blacksteel,3414,97,1,2,3,33.3%,36m
2425,3,NeoBlade,3414,0,0,1,1,0.0%,49m
2425,3,FUNKYFUNTIME,3414,0,0,1,1,0.0%,8m
2437,2,[004572]Noah,3413,1452,256,251,507,50.5%,11m
2437,2,Clairvoyant,3413,837,126,116,242,52.1%,33m
2437,3,aigochamaloh,3413,114,5,1,6,83.3%,28m
2437,3,DeepThought,3413,118,4,9,13,30.8%,28m
2437,3,[Note]vamp,3413,60,2,6,8,25.0%,32m
2437,3,kGAULT,3413,0,0,1,1,0.0%,47m
2437,3,[Lp]SaCrOs,3413,0,0,1,1,0.0%,37m
2444,3,Detiner,3412,88,3,7,10,30.0%,14m
2444,3,Kubrickr,3412,60,2,3,5,40.0%,48m
2444,3,[9000]gthx,3412,60,2,5,7,28.6%,52m
2444,3,[NASRIN]Stopher,3412,0,1,0,1,100.0%,9m
2448,3,[RndNgr]WhimsOfFate,3411,1239,60,24,84,71.4%,7m
2448,3,Xorox,3411,30,2,2,4,50.0%,29m
2448,3,SMOOTHBRAIN,3411,0,1,0,1,100.0%,34m
2451,2,[eFight]dudebro,3410,1573,199,207,406,49.0%,36m
2451,3,IJERKEVRYDAY,3410,296,16,5,21,76.2%,9m
2451,2,Lucian,3410,153,3,2,5,60.0%,38m
2451,3,MicroMarine,3410,30,2,2,4,50.0%,34m
2451,3,[SHle]molecular,3410,0,1,1,2,50.0%,31m
2451,3,Therightside,3410,30,1,2,3,33.3%,28m
2451,2,[AXAT]MARINEKING,3410,94,1,2,3,33.3%,8m
2458,3,ThisGuy,3409,754,32,24,56,57.1%,34m
2458,2,Fluffy,3409,680,23,33,56,41.1%,42m
2458,3,Watertop,3409,482,18,14,32,56.2%,14m
2458,2,[Lp]MiniDaRkneSS,3409,398,12,19,31,38.7%,39m
2458,2,maxQ,3409,240,9,15,24,37.5%,35m
2458,3,[Ostie]mOnOpInK,3409,146,6,5,11,54.5%,38m
2458,2,Nuclear,3409,88,4,4,8,50.0%,29m
2458,1,[DATTE]KpAp,3409,0,3,2,5,60.0%,3h
2458,1,[REPORT]ERAU,3409,0,1,0,1,100.0%,53m
2467,3,[EtrOy]dougt,3408,60,2,3,5,40.0%,28m
2467,3,[CDEC]Loonie,3408,0,1,1,2,50.0%,45m
2467,3,Bega,3408,30,1,1,2,50.0%,41m
2467,2,[Bonoo]JonSnow,3408,0,0,1,1,0.0%,46m
2471,2,Zero,3407,1239,52,48,100,52.0%,46m
2471,3,[UCF]SbaerO,3407,388,14,12,26,53.8%,11m
2471,3,elcom,3407,196,7,6,13,53.8%,12m
2471,3,ignap,3407,30,2,0,2,100.0%,34m
2475,2,[425]TRxArce,3406,1523,69,95,164,42.1%,42m
2475,3,[MexSex]Karias,3406,462,20,15,35,57.1%,38m
2475,3,Kolin,3406,0,5,1,6,83.3%,15m
2475,1,MochiGucci,3406,97,5,1,6,83.3%,1h
2479,3,[zzzzz]Zur,3405,1625,186,172,358,52.0%,44m
2479,2,[SmokeH]mangoeater,3405,1459,176,189,365,48.2%,51m
2479,3,Friend,3405,144,7,1,8,87.5%,42m
2479,3,Kippi,3405,94,2,7,9,22.2%,30m
2479,3,[DASUL]Mach,3405,0,1,0,1,100.0%,7m
2484,3,Zerg,3404,0,4,1,5,80.0%,43m
2484,3,kurby,3404,30,2,0,2,100.0%,45m
2486,2,RoachReggae,3403,335,10,18,28,35.7%,4m
2486,3,[DsRupT]BUILDPROBE,3403,16,3,6,9,33.3%,11m
2486,3,[Aquad]ArthapOO,3403,60,2,3,5,40.0%,32m
2486,3,Turley,3403,0,0,1,1,0.0%,26m
2486,3,DoneDoKnow,3403,0,0,1,1,0.0%,8m
2491,3,[NairX]MeDiX,3402,781,44,36,80,55.0%,36m
2491,2,[PES]Silver,3402,679,26,27,53,49.1%,5m
2491,3,[REXH]Travis,3402,214,8,10,18,44.4%,9m
2491,3,[OpT1cZ]Potato,3402,0,1,0,1,100.0%,40m
2491,3,PeterPiper,3402,30,1,2,3,33.3%,31m
2491,3,NETCore,3402,0,0,1,1,0.0%,44m
2497,3,nEwbRoOd,3401,1165,65,65,130,50.0%,43m
2497,2,Totalwar,3401,270,10,17,27,37.0%,29m
2497,2,SoulShine,3401,217,8,6,14,57.1%,4m
2500,3,[PsyNRG]whynogethigh,3400,1279,91,87,178,51.1%,6m
2500,3,FadeToBlack,3400,246,16,6,22,72.7%,44m
2500,3,Shuku,3400,88,4,5,9,44.4%,52m
2500,1,Stanky,3400,0,1,0,1,100.0%,26m
2504,3,StonedGnome,3399,402,15,15,30,50.0%,46m
2505,3,HaSingPlay,3398,1636,313,299,612,51.1%,32m
2505,2,BizzaroBird,3398,840,127,129,256,49.6%,41m
2505,3,[DASUL]LaloAssassin,3398,336,13,7,20,65.0%,12m
2505,3,[YAS]Knowledge,3398,354,13,12,25,52.0%,4m
2505,3,[Taller]TMOE,3398,86,3,4,7,42.9%,6m
2505,3,YemaThar,3398,30,2,1,3,66.7%,12m
2505,2,Omnivore,3398,0,1,2,3,33.3%,38m
2512,2,Tuna,3397,670,60,56,116,51.7%,38m
2512,3,TheRight,3397,114,4,1,5,80.0%,45m
2512,1,Jermz,3397,46,2,2,4,50.0%,7m
2515,3,[YD2K]You,3396,1303,62,36,98,63.3%,5m
2515,3,[TwitcX]AminoX,3396,666,35,2,37,94.6%,12m
2515,3,[KingSC]Gonsu,3396,470,18,16,34,52.9%,11m
2515,3,TheDrone,3396,0,4,1,5,80.0%,26m
2515,2,NEVERGIVEUP,3396,120,4,19,23,17.4%,4m
2515,3,GeilHoertje,3396,60,2,2,4,50.0%,30m
2515,3,[IAku]Squiggly,3396,0,1,3,4,25.0%,30m
2515,3,RippedJoint,3396,0,0,1,1,0.0%,51m
2523,3,Anewb,3395,796,28,28,56,50.0%,11m
2523,2,[SMB]maxpower,3395,548,23,30,53,43.4%,49m
2523,2,SpRaYFartt,3395,242,9,17,26,34.6%,29m
2523,3,[TACTEC]awfulplayer,3395,142,7,0,7,100.0%,40m
2523,3,saraevans,3395,58,3,0,3,100.0%,9m
2523,3,[ELRIS]SunYoung,3395,0,1,0,1,100.0%,26m
2529,3,Alphabet,3394,1349,127,106,233,54.5%,34m
2529,3,Guileful,3394,300,16,7,23,69.6%,8m
2529,1,Loki,3394,253,11,6,17,64.7%,34m
2529,3,TerranTears,3394,118,5,3,8,62.5%,28m
2529,3,DarkTemplar,3394,0,1,0,1,100.0%,32m
2529,3,IIIIIIII,3394,0,0,1,1,0.0%,45m
2535,3,MelGibson,3393,815,118,89,207,57.0%,47m
2535,3,xRdyx,3393,748,48,52,100,48.0%,14m
2535,3,Dorime,3393,245,8,4,12,66.7%,11m
2535,3,bekdouche,3393,86,4,2,6,66.7%,12m
2535,3,karatekid,3393,30,2,2,4,50.0%,6m
2535,3,Frosty,3393,0,2,5,7,28.6%,27m
2535,3,Quarantine,3393,0,1,0,1,100.0%,41m
2535,2,VeganDeity,3393,94,1,1,2,50.0%,45m
2535,1,Bragoon,3393,0,1,2,3,33.3%,51m
2535,3,[ROKEA]WhiteAther,3393,0,0,5,5,0.0%,7m
2545,3,[Pig2]MaelStorm,3392,664,26,18,44,59.1%,49m
2545,3,[P51]Rakhnam,3392,343,15,9,24,62.5%,42m
2545,3,ReDiBuLouS,3392,0,1,2,3,33.3%,38m
2545,3,[UpeV]BlackPhillip,3392,0,1,2,3,33.3%,14m
2549,3,Orlandini,3391,30,2,3,5,40.0%,38m
2549,3,OpJeof,3391,0,0,1,1,0.0%,36m
2551,3,[TAW]DigitZ,3390,207,8,8,16,50.0%,12m
2551,3,AKA,3390,30,2,0,2,100.0%,8m
2551,3,IIIIIIIIIIII,3390,0,0,1,1,0.0%,40m
2554,2,[0dins]Paulverizer,3389,1577,91,97,188,48.4%,8m
2554,2,EdvanSchleck,3389,186,5,4,9,55.6%,47m
2554,1,Destovel,3389,97,2,1,3,66.7%,8m
2554,3,ATOY,3389,60,2,7,9,22.2%,6m
2554,3,Cheeryohs,3389,0,1,0,1,100.0%,26m
2554,3,zero,3389,30,1,3,4,25.0%,51m
2560,3,Rowdydevil,3388,508,19,15,34,55.9%,6m
2560,3,[GlrLs]SunYoung,3388,0,1,0,1,100.0%,31m
2560,3,SmollPP,3388,0,1,0,1,100.0%,53m
2563,3,[GvSQD]GoveaKun,3387,676,25,26,51,49.0%,7m
2563,3,Dokdo,3387,0,1,4,5,20.0%,30m
2565,3,JacksMedula,3386,1633,186,158,344,54.1%,4m
2565,3,[MadK]Kevin,3386,1381,59,38,97,60.8%,32m
2565,3,CeberousMan,3386,600,24,15,39,61.5%,43m
2565,3,iAmVegan,3386,272,9,17,26,34.6%,31m
2565,3,[NGS616]Towel,3386,174,7,6,13,53.8%,32m
2565,3,[SsaYnS]Zealot,3386,0,5,0,5,100.0%,31m
2565,3,Citizenkangg,3386,97,3,4,7,42.9%,48m
2565,3,LloydAurion,3386,0,1,0,1,100.0%,51m
2573,3,Gronkmen,3385,1617,237,206,443,53.5%,42m
2573,3,muriden,3385,665,29,28,57,50.9%,29m
2573,3,MushroomMan,3385,0,4,1,5,80.0%,43m
2573,2,Zaur,3385,0,4,4,8,50.0%,4m
2573,3,MOJ,3385,0,2,3,5,40.0%,5m
2573,3,Crusader,3385,58,2,4,6,33.3%,50m
2579,3,[X17]Kyhol,3384,990,36,39,75,48.0%,11m
2579,3,Rataerix,3384,116,4,7,11,36.4%,39m
2579,3,ZombieHobbit,3384,60,2,5,7,28.6%,37m
2579,3,Rocker,3384,0,1,0,1,100.0%,31m
2583,3,[8kPLUS]RitualMurder,3383,140,5,3,8,62.5%,34m
2583,3,Talen,3383,0,1,0,1,100.0%,28m
2585,3,MajiN,3382,548,40,28,68,58.8%,31m
2585,3,Degnoob,3382,405,20,25,45,44.4%,43m
2585,3,[178]AThenaPrime,3382,0,1,0,1,100.0%,53m
2588,3,Jim,3381,1454,183,179,362,50.6%,42m
2588,3,MLP,3381,228,17,16,33,51.5%,28m
2588,2,Broccoli,3381,254,11,17,28,39.3%,51m
2588,3,[DTokes]Chickenhawk,3381,220,8,6,14,57.1%,44m
2588,3,SaGa,3381,0,1,0,1,100.0%,12m
2588,3,[Cryptc]Tonstor,3381,30,1,4,5,20.0%,41m
2588,3,[TM]NMxTien,3381,30,1,10,11,9.1%,47m
2588,3,brandon,3381,0,0,3,3,0.0%,42m
2588,3,LedOverLord,3381,0,0,3,3,0.0%,11m
2597,2,Ubersoldatte,3380,1484,809,803,1612,50.2%,14m
2597,3,TheKeystone,3380,440,16,12,28,57.1%,34m
2597,2,[Deathn]DestinyKid,3380,296,10,21,31,32.3%,30m
2597,3,Momo,3380,0,3,2,5,60.0%,13m
2597,3,[TPGGXD]Kilpinga,3380,0,0,1,1,0.0%,27m
2602,3,COVIDSUXX,3379,328,14,9,23,60.9%,38m
2602,3,[SC2MF]Justice,3379,242,9,12,21,42.9%,12m
2602,3,Jabalsal,3379,94,4,9,13,30.8%,41m
2602,3,[C59]chav,3379,0,2,1,3,66.7%,30m
2602,3,[NYAAAA]PandaPrime,3379,30,1,4,5,20.0%,28m
2607,3,[Random]Funk,3378,1542,154,149,303,50.8%,12m
2607,3,LeftStroke,3378,534,23,19,42,54.8%,31m
2607,3,RICKY,3378,425,22,6,28,78.6%,30m
2607,3,llllllllllll,3378,541,21,13,34,61.8%,41m
2607,3,shromsdaburd,3378,121,3,0,3,100.0%,7m
2607,3,[FateTw]VOIDRAYS,3378,0,1,0,1,100.0%,37m
2607,3,[IMAC]IIIIIIIIIIII,3378,0,1,4,5,20.0%,39m
2607,2,Mateocos,3378,0,0,1,1,0.0%,8m
2615,3,Geezer,3377,682,170,161,331,51.4%,7m
2615,3,[TØXIC]Horror,3377,58,3,3,6,50.0%,33m
2615,3,[Len1n]Wagz,3377,60,2,6,8,25.0%,32m
2615,3,[SHDWBT]Mezlite,3377,0,1,0,1,100.0%,49m
2615,3,oiL,3377,30,1,3,4,25.0%,32m
2615,3,[dioses]Hiunkel,3377,0,1,4,5,20.0%,14m
2615,3,Walruslisk,3377,0,0,5,5,0.0%,41m
2622,3,BIDENBOI,3376,349,67,67,134,50.0%,14m
2622,3,nokuy,3376,363,16,7,23,69.6%,41m
2622,3,[KingSC]Luigi,3376,318,13,11,24,54.2%,48m
2622,3,JanMVincent,3376,122,5,5,10,50.0%,52m
2622,3,llllllllllll,3376,58,3,3,6,50.0%,54m
2622,3,[kØ]Nicoo,3376,0,1,0,1,100.0%,33m
2622,3,iAmZero,3376,0,0,1,1,0.0%,38m
2629,3,Red,3375,515,35,33,68,51.5%,29m
2629,3,StuDiddy,3375,683,28,26,54,51.9%,52m
2629,3,[DE]Ashlyn,3375,400,17,10,27,63.0%,47m
2629,3,[RUMB]Mager,3375,266,11,5,16,68.8%,31m
2629,3,[MoWiz]ForestGump,3375,30,3,12,15,20.0%,41m
2629,3,[Viola]prettaes,3375,52,2,2,4,50.0%,49m
2629,3,[xULTRA]kOr,3375,0,0,1,1,0.0%,36m
2629,3,Treinn,3375,0,0,1,1,0.0%,36m
2637,3,troy,3374,140,6,2,8,75.0%,39m
2637,3,TFKer,3374,30,4,2,6,66.7%,37m
2637,3,[ZOOMOB]DirtyHobo,3374,30,1,1,2,50.0%,48m
2637,3,Dude,3374,0,0,5,5,0.0%,15m
2641,3,Chocolate,3373,1639,125,88,213,58.7%,32m
2641,3,WhitestWhite,3373,550,45,23,68,66.2%,52m
2641,2,[SSJ4]GameOfDrones,3373,425,33,39,72,45.8%,51m
2641,3,MOUNTAINDEW,3373,589,24,19,43,55.8%,7m
2641,3,[Riichi]NotoriousBOB,3373,0,1,3,4,25.0%,48m
2641,3,liquidsnake,3373,0,0,3,3,0.0%,28m
2647,2,[ExceI]Modranidrem,3372,807,33,32,65,50.8%,49m
2647,3,[JPPR]Jduncan,3372,97,2,5,7,28.6%,43m
2647,3,Titan,3372,30,1,2,3,33.3%,26m
2650,3,llllllllllll,3371,959,78,66,144,54.2%,11m
2650,3,marbles,3371,0,0,2,2,0.0%,4m
2652,3,PoCkEtS,3370,216,9,3,12,75.0%,12m
2652,3,Yokonisos,3370,218,8,4,12,66.7%,52m
2652,3,Lucky,3370,0,0,1,1,0.0%,11m
2655,3,MKMK,3369,141,6,2,8,75.0%,37m
2655,3,[tdrs]MyNeighbor,3369,86,4,2,6,66.7%,29m
2655,3,[GGBr0]starzzang,3369,30,3,4,7,42.9%,52m
2655,1,[MinzS]SwordWielder,3369,0,0,1,1,0.0%,9m
2659,3,pride,3368,270,11,9,20,55.0%,34m
2659,3,TanK,3368,30,1,4,5,20.0%,28m
2659,3,[FateTw]Soapyjeans,3368,0,0,1,1,0.0%,46m
2659,3,BeepBeepJeep,3368,0,0,2,2,0.0%,53m
2659,3,[KiTeam]KiTScarleTT,3368,0,0,2,2,0.0%,38m
2664,2,[SnDICE]IOIOII,3367,757,29,34,63,46.0%,33m
2664,2,[YD2K]Stef,3367,526,19,22,41,46.3%,47m
2664,3,HIGHLANDER,3367,245,11,2,13,84.6%,12m
2664,3,ProbeiusCorp,3367,140,6,0,6,100.0%,47m
2664,3,ivSeenBigger,3367,0,3,2,5,60.0%,30m
2664,3,Fallout,3367,95,1,1,2,50.0%,8m
2670,3,MrSmiley,3366,871,41,38,79,51.9%,33m
2670,2,[INCARD]BigRat,3366,319,10,14,24,41.7%,44m
2670,3,Nosferatu,3366,0,0,3,3,0.0%,11m
2673,3,[SIClan]INnoVation,3365,0,1,0,1,100.0%,30m
2674,3,Juay,3364,1562,183,141,324,56.5%,52m
2674,2,[PMN]LibYourLife,3364,1524,137,142,279,49.1%,42m
2674,3,eyemhy,3364,1201,73,62,135,54.1%,12m
2674,3,[LTlord]GokuLeGana,3364,593,21,19,40,52.5%,48m
2674,3,Kurare,3364,118,11,7,18,61.1%,12m
2674,3,valkyreaver,3364,86,7,2,9,77.8%,28m
2674,3,[ScSwrm]LAMBDA,3364,0,0,3,3,0.0%,7m
2681,3,dholma,3363,172,27,16,43,62.8%,47m
2681,3,Pexavi,3363,466,18,11,29,62.1%,5m
2681,3,Solanin,3363,222,10,10,20,50.0%,43m
2681,3,TheOx,3363,170,7,2,9,77.8%,11m
2681,2,NoName,3363,186,6,3,9,66.7%,30m
2681,3,FOUND,3363,0,0,1,1,0.0%,52m
2687,3,[BrHero]jumplnjac,3362,867,75,65,140,53.6%,12m
2687,3,LuisVargas,3362,537,46,44,90,51.1%,55m
2687,3,igoairok,3362,868,36,25,61,59.0%,54m
2687,3,Kael,3362,454,20,12,32,62.5%,11m
2687,3,[FxB]Remain,3362,428,17,14,31,54.8%,4m
2687,3,MicroMarine,3362,466,17,15,32,53.1%,29m
2687,3,FatherDrift,3362,60,3,1,4,75.0%,39m
2687,3,[TRETER]Wavic,3362,58,3,5,8,37.5%,32m
2687,3,BearLeG,3362,0,1,0,1,100.0%,37m
2696,3,[VFam2]EZDeschanel,3361,1123,80,63,143,55.9%,34m
2696,2,[TSØP]RoBoT,3361,935,38,43,81,46.9%,40m
2696,2,[ggzvz]llllllllllll,3361,326,14,22,36,38.9%,52m
2696,3,[ZTemps]ZeN,3361,332,13,13,26,50.0%,28m
2696,3,[nieBla]Woltstrider,3361,0,5,0,5,100.0%,26m
2696,3,orangepeel,3361,123,3,3,6,50.0%,48m
2696,3,DontHaselHof,3361,0,1,2,3,33.3%,32m
2703,2,Galivan,3360,1487,313,301,614,51.0%,35m
2703,3,Glunch,3360,530,84,83,167,50.3%,44m
2703,3,shino,3360,334,11,7,18,61.1%,50m
2703,2,Peen,3360,203,7,10,17,41.2%,42m
2703,1,MEGAMAN,3360,97,5,1,6,83.3%,3h
2703,3,[DNKCFT]OhStephy,3360,58,2,7,9,22.2%,54m
2703,3,[Flam3s]Mancub,3360,30,1,1,2,50.0%,45m
2710,2,SMOKEN,3359,1568,269,259,528,50.9%,54m
2710,3,Specter,3359,628,28,17,45,62.2%,14m
2710,3,MASSUKKAMURA,3359,398,18,8,26,69.2%,26m
2710,3,Jeral,3359,228,9,4,13,69.2%,44m
2710,3,toshy,3359,0,1,0,1,100.0%,28m
2710,3,onsSCCN,3359,97,1,1,2,50.0%,14m
2716,3,[NwAs]ESAAS,3358,525,24,14,38,63.2%,40m
2716,3,Dankomatic,3358,230,9,8,17,52.9%,52m
2716,3,Samuel,3358,118,5,3,8,62.5%,49m
2716,1,Ewanda,3358,97,3,1,4,75.0%,42m
2716,3,squi,3358,30,1,1,2,50.0%,36m
2721,3,[kØ]Huasozerlin,3357,545,20,18,38,52.6%,42m
2721,3,Bowchicabow,3357,86,7,2,9,77.8%,34m
2721,3,[Pharoh]Rainyforest,3357,86,3,2,5,60.0%,54m
2721,3,Marcel,3357,157,3,2,5,60.0%,34m
2725,3,Gramps,3356,358,52,19,71,73.2%,14m
2725,2,Cantina,3356,631,28,24,52,53.8%,8m
2725,3,Ioplop,3356,454,16,19,35,45.7%,4m
2725,3,Mycatsinheat,3356,228,12,9,21,57.1%,12m
2725,3,Ben,3356,88,8,4,12,66.7%,7m
2725,3,[AWOOO]LunarTear,3356,60,2,8,10,20.0%,12m
2725,3,Infernaldawn,3356,0,0,1,1,0.0%,4m
2725,3,Sprite,3356,0,0,3,3,0.0%,15m
2733,2,Marijuander,3355,334,11,19,30,36.7%,39m
2733,3,Hiyori,3355,212,7,4,11,63.6%,42m
2733,3,[eXtra1]TheFerretKin,3355,30,2,2,4,50.0%,4m
2733,3,PerronenDrgo,3355,0,1,0,1,100.0%,5m
2733,3,Noodle,3355,0,1,0,1,100.0%,54m
2738,3,SMILEYCYRUS,3354,1485,211,218,429,49.2%,52m
2738,3,Shnark,3354,1268,49,47,96,51.0%,29m
2738,3,DueSs,3354,314,12,9,21,57.1%,30m
2738,3,soccersaver,3354,146,5,5,10,50.0%,36m
2738,3,ImALooooser,3354,0,2,3,5,40.0%,51m
2738,3,StixZadinia,3354,0,1,0,1,100.0%,43m
2738,3,Youiur,3354,30,1,4,5,20.0%,33m
2745,3,KiRiTo,3353,998,55,38,93,59.1%,14m
2745,3,PolskaPro,3353,436,26,22,48,54.2%,28m
2745,3,Rokodalin,3353,370,23,13,36,63.9%,30m
2745,3,nissin,3353,382,13,11,24,54.2%,28m
2745,1,PoultryFeed,3353,96,5,1,6,83.3%,50m
2745,3,[InGt]Fig,3353,30,1,6,7,14.3%,34m
2751,2,Opticon,3352,1428,92,95,187,49.2%,6m
2751,3,[LASER]Skellis,3352,204,7,7,14,50.0%,39m
2751,3,MicrO,3352,58,5,3,8,62.5%,46m
2751,3,Alco,3352,88,3,7,10,30.0%,12m
2751,3,OpticParadox,3352,30,1,3,4,25.0%,29m
2756,3,Deathkillerz,3351,376,12,22,34,35.3%,28m
2756,1,TVLO,3351,0,5,0,5,100.0%,47m
2756,3,sharp,3351,30,4,2,6,66.7%,42m
2756,3,zergina,3351,58,3,4,7,42.9%,49m
2756,3,UNKO,3351,0,0,3,3,0.0%,34m
2761,2,[HUSHrx]Celestiall,3350,1240,44,55,99,44.4%,13m
2761,1,hmmmm,3350,118,6,1,7,85.7%,1h
2761,3,cccccccccccc,3350,141,3,1,4,75.0%,10m
2764,2,[TGosuA]AtomicLime,3349,1547,483,489,972,49.7%,38m
2764,2,PrexcitedAF,3349,1566,224,229,453,49.4%,50m
2764,2,[REPORT]ByaKko,3349,1578,170,168,338,50.3%,30m
2764,2,[Digged]ChEDo,3349,209,10,5,15,66.7%,29m
2764,3,WellDone,3349,118,8,6,14,57.1%,47m
2764,3,[8kPLUS]Moradagh,3349,0,1,2,3,33.3%,41m
2764,3,Skoda,3349,30,1,5,6,16.7%,43m
2764,3,KillyMagee,3349,0,0,1,1,0.0%,36m
2764,3,YouSoMadBro,3349,0,0,1,1,0.0%,4m
2773,3,[YD2K]winning,3348,318,10,13,23,43.5%,8m
2773,3,SpiderShlong,3348,220,9,5,14,64.3%,36m
2773,3,Fubar,3348,166,6,5,11,54.5%,30m
2773,3,[FMX]Jackblaster,3348,96,1,1,2,50.0%,48m
2773,3,[dLife]Monkey,3348,0,0,1,1,0.0%,33m
2773,3,Snøw,3348,0,0,1,1,0.0%,13m
2773,3,[FenGCN]MrMeepO,3348,0,0,1,1,0.0%,9m
2780,3,[Pton]MrSquirrley,3347,1134,206,194,400,51.5%,37m
2780,3,Jeed,3347,602,28,14,42,66.7%,29m
2780,3,Barkcode,3347,198,27,7,34,79.4%,49m
2780,3,[AiMB]CeeDee,3347,286,11,8,19,57.9%,44m
2780,3,[22IQ]Blitzer,3347,0,0,1,1,0.0%,7m
2780,3,QuackDonal,3347,0,0,1,1,0.0%,7m
2780,3,[TPGGXD]ULIGJ,3347,0,0,2,2,0.0%,38m
2787,3,IIIIIIIII,3346,1593,105,108,213,49.3%,29m
2787,3,bowyer,3346,97,1,1,2,50.0%,49m
2787,3,[Cryptc]TurretOne,3346,0,0,4,4,0.0%,42m
2790,3,[CnfOD]iacta,3345,1176,48,36,84,57.1%,4m
2790,3,[500CC]CoreDefender,3345,355,13,12,25,52.0%,12m
2790,3,[H3xPr0]DrPlato,3345,154,5,9,14,35.7%,48m
2790,3,Daggoth,3345,124,5,10,15,33.3%,9m
2790,3,[GTMDSB]Rheinpw,3345,78,4,1,5,80.0%,39m
2790,3,box,3345,30,4,2,6,66.7%,14m
2790,3,[RatEZ]Totony,3345,0,0,1,1,0.0%,43m
2797,3,llllllllllll,3344,1569,123,88,211,58.3%,31m
2797,3,kush,3344,623,28,21,49,57.1%,11m
2797,3,[SsaYnS]Sleeky,3344,464,18,12,30,60.0%,43m
2797,3,KingKev,3344,262,10,8,18,55.6%,31m
2797,3,HavocWreaker,3344,90,6,5,11,54.5%,28m
2797,3,ImOnlyEight,3344,0,4,1,5,80.0%,7m
2797,3,Capiroto,3344,121,2,6,8,25.0%,51m
2804,3,IMissYouGrMa,3343,1205,137,91,228,60.1%,31m
2804,3,Chris,3343,1432,91,83,174,52.3%,30m
2804,3,IamMrV,3343,116,5,7,12,41.7%,15m
2804,3,[VlPeRz]SkullStew,3343,0,1,0,1,100.0%,26m
2804,3,BloodSport,3343,0,1,0,1,100.0%,44m
2809,3,BroastGarlic,3342,58,2,2,4,50.0%,6m
2809,3,[MEP]AkicitaWaste,3342,0,1,0,1,100.0%,8m
2809,3,Finrod,3342,30,1,6,7,14.3%,42m
2812,2,[SsaYnS]SHY,3341,1543,412,406,818,50.4%,8m
2812,2,bearUSC,3341,1177,46,50,96,47.9%,47m
2812,2,SCHardNips,3341,878,28,41,69,40.6%,49m
2812,3,SirNayz,3341,0,4,2,6,66.7%,27m
2812,3,[TechN]Undead,3341,0,0,1,1,0.0%,12m
2812,1,Shadowbee,3341,0,0,1,1,0.0%,54m
2812,3,Cystemic,3341,0,0,2,2,0.0%,46m
2819,2,[NePzdi]zergerburger,3340,1556,142,146,288,49.3%,11m
2819,3,[MluvK]MyBFMadeMe,3340,1485,133,90,223,59.6%,44m
2819,3,Buttface,3340,1549,76,69,145,52.4%,14m
2819,3,[BRUTAL]FeedtheFeet,3340,482,18,14,32,56.2%,7m
2819,3,Lionel,3340,317,15,5,20,75.0%,32m
2819,3,[ANGST]SideShow,3340,185,6,2,8,75.0%,7m
2825,2,[FyHr]RakeIsSerral,3339,863,33,47,80,41.2%,54m
2825,3,MaryaReisy,3339,192,8,6,14,57.1%,37m
2825,1,BLEE,3339,145,3,3,6,50.0%,1h
2825,3,Markle,3339,60,3,5,8,37.5%,47m
2825,3,ArthurDent,3339,0,0,1,1,0.0%,43m
2830,2,idiZa,3338,1419,144,149,293,49.1%,44m
2830,3,[STILL]TheAlchemist,3338,1240,48,42,90,53.3%,34m
2830,2,Bearface,3338,412,15,36,51,29.4%,40m
2830,3,GigaPuddi,3338,0,1,0,1,100.0%,35m
2830,3,[PzC]SiNk,3338,30,1,3,4,25.0%,28m
2830,3,[Dvier]AOEBetter,3338,0,0,1,1,0.0%,26m
2830,3,AnT,3338,0,0,2,2,0.0%,45m
2837,2,[DarkAG]WHOSFIRST,3337,786,35,44,79,44.3%,52m
2837,1,Grandma,3337,324,14,7,21,66.7%,53m
2837,3,[Xpk]Allegseu,3337,60,2,2,4,50.0%,34m
2840,3,FearNot,3336,725,108,96,204,52.9%,6m
2840,3,DoGG,3336,1490,68,69,137,49.6%,15m
2840,3,MrWin,3336,909,34,34,68,50.0%,32m
2840,3,Cayeuf,3336,646,26,20,46,56.5%,30m
2840,2,swarmCore,3336,305,12,5,17,70.6%,35m
2840,3,Kapai,3336,162,6,7,13,46.2%,45m
2840,3,[RtKa]Enn,3336,30,5,1,6,83.3%,31m
2840,1,Jnuker,3336,0,4,1,5,80.0%,1h
2840,3,[lLiTl]Acey,3336,62,3,6,9,33.3%,42m
2849,2,CanBacon,3335,1360,221,225,446,49.6%,46m
2849,3,[TAWP69]GaryJohnston,3335,326,14,9,23,60.9%,50m
2849,3,Mrcursed,3335,260,8,5,13,61.5%,31m
2849,3,RELOAD,3335,120,5,10,15,33.3%,7m
2849,3,SirBonjwa,3335,30,3,3,6,50.0%,11m
2854,3,fridor,3334,1070,80,70,150,53.3%,40m
2854,3,DuckStation,3334,184,6,9,15,40.0%,43m
2854,3,[Dchk]Kestal,3334,30,1,4,5,20.0%,8m
2857,3,[Cometh]Nightman,3333,1661,189,178,367,51.5%,45m
2857,3,Algerin,3333,1557,99,106,205,48.3%,11m
2857,3,[DaeNA]will,3333,120,6,7,13,46.2%,48m
2860,3,ioiio,3332,1568,170,167,337,50.4%,30m
2860,3,bobbywhisky,3332,1599,73,66,139,52.5%,34m
2860,3,[NPhase]Swiftdaddy,3332,994,38,35,73,52.1%,47m
2860,2,Pyromancer,3332,519,21,20,41,51.2%,38m
2860,2,[S2sex]ILOVESEX,3332,500,17,33,50,34.0%,46m
2860,3,JimBoogie,3332,239,9,1,10,90.0%,52m
2860,3,Dingles,3332,60,3,1,4,75.0%,14m
2860,3,Hero,3332,30,2,1,3,66.7%,36m
2860,1,[Deb]gazooks,3332,0,1,0,1,100.0%,1h
2860,3,[CS0]Samwise,3332,0,1,0,1,100.0%,14m
2860,3,[MacMic]AngelOfGod,3332,0,1,0,1,100.0%,8m
2860,3,KeanuReeves,3332,0,0,1,1,0.0%,32m
2872,3,[TGosuC]Lucid,3331,422,17,5,22,77.3%,28m
2872,3,Colgate,3331,30,2,4,6,33.3%,14m
2872,3,feebdaed,3331,96,1,2,3,33.3%,14m
2875,3,UED,3330,394,14,18,32,43.8%,36m
2875,3,fuquer,3330,187,9,4,13,69.2%,7m
2875,3,LiarGirl,3330,46,2,4,6,33.3%,30m
2875,3,tombo,3330,0,0,1,1,0.0%,26m
2879,1,snickers,3329,97,2,0,2,100.0%,40m
2879,3,[C2N]DeathBringer,3329,30,1,3,4,25.0%,14m
2881,3,Grrrr,3328,1302,51,52,103,49.5%,26m
2881,3,Dreemurr,3328,62,2,6,8,25.0%,34m
2881,3,TrueNorth,3328,0,1,0,1,100.0%,28m
2881,3,PLPLlama,3328,0,0,1,1,0.0%,6m
2881,3,[ØÛ]gorilarosado,3328,0,0,1,1,0.0%,4m
2886,3,GeardFord,3327,494,17,16,33,51.5%,52m
2886,2,WulfBane,3327,156,4,2,6,66.7%,43m
2886,1,junstin,3327,96,4,2,6,66.7%,23m
2886,3,Infinity,3327,115,3,2,5,60.0%,39m
2886,1,McCrazy,3327,0,1,0,1,100.0%,42m
2891,3,Darling,3326,1278,47,46,93,50.5%,14m
2891,3,panda,3326,238,8,6,14,57.1%,52m
2891,2,Sirbomber,3326,62,4,11,15,26.7%,8m
2891,1,[Helsm]RandomSprect,3326,97,3,0,3,100.0%,1h
2891,3,[DarkAG]LUDEMEISTER,3326,30,2,0,2,100.0%,14m
2891,3,PhaseLethal,3326,0,0,1,1,0.0%,36m
2897,3,WolfieRa,3325,194,8,8,16,50.0%,8m
2897,2,IIIIIIIIIIII,3325,0,1,0,1,100.0%,10m
2897,3,[αB]Mythikdawn,3325,30,1,3,4,25.0%,41m
2900,3,ToE,3324,495,134,127,261,51.3%,33m
2900,3,[TX]ChuckWagon,3324,30,2,0,2,100.0%,52m
2900,3,Resolution,3324,0,0,1,1,0.0%,11m
2903,3,RaynorsRaid,3323,1517,219,211,430,50.9%,49m
2903,3,[TGosuC]FuriousDroid,3323,292,13,8,21,61.9%,12m
2903,2,sonnenkind,3323,211,9,4,13,69.2%,33m
2903,3,[SaintJ]Anakin,3323,168,7,2,9,77.8%,34m
2903,2,[nGunGu]Wingless,3323,132,2,2,4,50.0%,7m
2903,3,[Carat]Hanzos,3323,0,0,1,1,0.0%,40m
2909,2,[eeieei]rafiki,3322,515,33,30,63,52.4%,35m
2909,3,[Zulu]ReiGn,3322,228,9,6,15,60.0%,28m
2909,3,[GOPERÚ]ELGRANn,3322,30,2,5,7,28.6%,15m
2909,2,[OCSD]BlackStar,3322,0,1,0,1,100.0%,1h
2909,3,MSTY,3322,0,1,0,1,100.0%,12m
2909,3,[UpeV]TyrJose,3322,0,1,0,1,100.0%,6m
2915,2,MunchyMan,3321,1244,57,68,125,45.6%,28m
2915,3,KinguvcheeZL,3321,30,1,2,3,33.3%,4m
2917,3,UristMcKoga,3320,1613,244,229,473,51.6%,12m
2917,3,porkythepig,3320,1180,67,62,129,51.9%,13m
2917,3,Samus,3320,920,35,40,75,46.7%,49m
2917,3,Zupper,3320,147,5,5,10,50.0%,34m
2917,3,hiyo,3320,133,3,2,5,60.0%,51m
2917,3,YeePs,3320,88,3,5,8,37.5%,12m
2923,3,Overside,3319,224,70,72,142,49.3%,30m
2923,2,[SsaYnS]ArsisThesis,3319,1309,67,74,141,47.5%,40m
2923,3,[LatAm]Csr,3319,1425,57,62,119,47.9%,45m
2923,2,Algeroth,3319,152,49,52,101,48.5%,9m
2923,3,RyuuShiBaRi,3319,456,30,33,63,47.6%,32m
2923,3,[HaCoLa]Krabator,3319,608,23,21,44,52.3%,31m
2923,1,[WoLFR]JetkyWolf,3319,97,6,1,7,85.7%,1h
2923,3,[NwAs]Kche,3319,0,1,0,1,100.0%,51m
2923,3,[LOCO]Teim,3319,0,0,1,1,0.0%,39m
2932,2,DMoN,3318,1579,143,151,294,48.6%,54m
2932,3,[TheRs]DeHaKa,3318,448,16,23,39,41.0%,8m
2932,3,alphonzo,3318,237,9,6,15,60.0%,7m
2932,3,Bot,3318,214,8,2,10,80.0%,33m
2932,3,Conics,3318,159,3,9,12,25.0%,31m
2932,1,Theswan,3318,0,1,0,1,100.0%,7m
2938,3,[ConFed]iseeisaid,3317,442,28,22,50,56.0%,6m
2938,3,Kippa,3317,165,8,3,11,72.7%,43m
2940,3,Munchies,3316,1060,144,141,285,50.5%,12m
2940,3,CoachZ,3316,316,12,11,23,52.2%,37m
2940,3,BokinSmowls,3316,256,9,12,21,42.9%,29m
2943,3,[Weac]bananaman,3315,1252,53,37,90,58.9%,31m
2943,3,MaximusBlock,3315,1130,44,40,84,52.4%,8m
2943,3,[Over1]Manuel,3315,454,16,14,30,53.3%,48m
2943,3,Crimson,3315,58,4,5,9,44.4%,31m
2943,1,Gouda,3315,97,3,3,6,50.0%,15m
2943,3,DrewShow,3315,92,3,4,7,42.9%,6m
2949,3,DoBrO,3314,228,12,8,20,60.0%,29m
2949,3,Pinoguy,3314,204,7,6,13,53.8%,41m
2949,3,[KingSC]InFected,3314,156,6,10,16,37.5%,27m
2949,3,Babuined,3314,0,1,1,2,50.0%,34m
2953,3,Boudichon,3313,566,23,20,43,53.5%,29m
2953,3,Bushwack,3313,0,1,0,1,100.0%,31m
2953,3,Sauer,3313,0,1,5,6,16.7%,36m
2953,1,[Hilas2]RJVP,3313,0,0,1,1,0.0%,3h
2957,2,wbckulty,3312,1009,39,42,81,48.1%,11m
2957,3,Dethstick,3312,703,37,29,66,56.1%,7m
2957,3,MechnCheese,3312,374,14,13,27,51.9%,6m
2957,3,LeX,3312,146,5,9,14,35.7%,35m
2961,3,Integrity,3311,1598,222,210,432,51.4%,4m
2961,3,SleepyBear,3311,166,7,6,13,53.8%,43m
2961,3,[TheDOH]ListerFiend,3311,156,5,10,15,33.3%,50m
2961,2,JayWag,3311,176,4,1,5,80.0%,29m
2961,2,marmelloh,3311,114,4,19,23,17.4%,38m
2961,1,Eskae,3311,138,3,1,4,75.0%,60m
2961,3,[DRONGO]FirSTBloOD,3311,0,0,1,1,0.0%,54m
2968,3,MAGNETO,3310,1584,96,90,186,51.6%,12m
2968,3,KannOx,3310,534,21,15,36,58.3%,50m
2968,3,[ZTemp]GameofDrones,3310,402,14,20,34,41.2%,12m
2968,3,aiforvictory,3310,254,9,9,18,50.0%,43m
2968,3,[AD3C]Asth,3310,191,6,6,12,50.0%,32m
2968,3,IIIIIIIIIIII,3310,88,4,6,10,40.0%,6m
2968,3,[ProSC]queuez,3310,0,0,1,1,0.0%,33m
2975,2,BLitSon,3309,1559,187,190,377,49.6%,4m
2975,2,Alexandros,3309,1399,69,48,117,59.0%,41m
2975,3,Future,3309,1327,59,56,115,51.3%,12m
2975,3,HIkingBoots,3309,134,10,12,22,45.5%,12m
2975,3,RobotNinja,3309,195,8,6,14,57.1%,27m
2975,3,WaynaTakiri,3309,116,5,3,8,62.5%,11m
2975,3,[BoAVN]Ice,3309,121,4,4,8,50.0%,5m
2975,3,DebugCode,3309,0,3,2,5,60.0%,26m
2983,3,[TGosuA]Kyroh,3308,489,34,32,66,51.5%,29m
2983,3,Verrix,3308,394,14,17,31,45.2%,6m
2983,3,[SRT4]Starfire,3308,298,11,8,19,57.9%,6m
2983,3,sevenOfour,3308,0,3,3,6,50.0%,36m
2987,3,[DNLF]DikWikky,3307,614,25,19,44,56.8%,50m
2987,3,Cotab,3307,357,14,3,17,82.4%,32m
2987,2,Pearcey,3307,0,5,0,5,100.0%,3h
2987,3,[FalPal]FattyESQ,3307,58,3,1,4,75.0%,44m
2987,3,Akuro,3307,0,1,0,1,100.0%,4m
2992,3,[iDrunk]LulisBay,3306,612,25,19,44,56.8%,7m
2992,1,EGJD,3306,252,13,7,20,65.0%,32m
2992,2,[3ms]JACOBIS,3306,246,12,13,25,48.0%,43m
2992,3,[LgnTDS]shivi,3306,206,8,10,18,44.4%,8m
2992,3,Breaker,3306,130,6,3,9,66.7%,35m
2992,3,[GØSU]Coek,3306,92,3,8,11,27.3%,7m
2992,3,Aclickmarine,3306,0,1,4,5,20.0%,39m
2999,3,Armamani,3305,1203,94,73,167,56.3%,4m
2999,3,[LCE]PartinG,3305,470,19,9,28,67.9%,27m
2999,3,XXXXXXXXXX,3305,0,0,1,1,0.0%,29m
3002,3,Dreading,3304,1251,53,56,109,48.6%,38m
3002,3,[TPGGXD]adrian,3304,1260,50,41,91,54.9%,34m
3002,3,QcPac,3304,1037,42,34,76,55.3%,4m
3002,3,Oberyn,3304,168,6,4,10,60.0%,6m
3002,3,[LOHs]BrOkEn,3304,90,5,11,16,31.2%,33m
3002,3,[KiTeam]KitZoa,3304,0,1,3,4,25.0%,36m
3008,3,[ZCCCFE]kaboom,3303,1020,41,33,74,55.4%,14m
3008,3,[xLgNx]Kalo,3303,218,20,5,25,80.0%,29m
3008,3,Anthony,3303,171,8,4,12,66.7%,6m
3008,3,Hemloch,3303,146,4,2,6,66.7%,3m
3012,2,Getafix,3302,1578,158,158,316,50.0%,42m
3012,3,MechncSpecal,3302,940,91,96,187,48.7%,34m
3012,3,Dextrocity,3302,605,78,64,142,54.9%,12m
3012,3,ShriekinGeek,3302,62,2,6,8,25.0%,1m
3012,3,[DuJour]CelebiPZ,3302,0,1,0,1,100.0%,29m
3012,1,[mocat]TBONE,3302,0,0,1,1,0.0%,10m
3018,3,AlmondMilk,3301,932,43,30,73,58.9%,43m
3018,3,[FMX]KAKAROTO,3301,955,42,28,70,60.0%,7m
3018,3,speaknow,3301,88,4,4,8,50.0%,12m
3018,1,[TgAg]ExoYimmY,3301,85,2,0,2,100.0%,36m
3018,3,JChul,3301,94,2,0,2,100.0%,29m
3023,3,iDontTalk,3300,849,141,129,270,52.2%,11m
3023,3,[ACEI]ANGIOEDEMA,3300,874,74,67,141,52.5%,6m
3023,3,[Awo0o]DaCoyoteMan,3300,236,8,14,22,36.4%,7m
3023,3,Okami,3300,30,3,3,6,50.0%,33m
3023,2,HuskyS,3300,120,3,9,12,25.0%,9m
3023,3,VoidZero,3300,30,2,3,5,40.0%,29m
3029,3,Captnsug,3299,727,293,291,584,50.2%,12m
3029,3,YiSuS,3299,572,33,36,69,47.8%,7m
3029,3,lIlIlIlIlI,3299,559,26,27,53,49.1%,48m
3029,3,SandBoXx,3299,584,23,22,45,51.1%,6m
3029,2,Resonance,3299,606,21,27,48,43.8%,30m
3029,3,MugrosoCarl,3299,403,16,12,28,57.1%,2m
3029,3,[Pikmin]Metrick,3299,358,13,15,28,46.4%,43m
3029,3,[NPhasA]TTTGGG,3299,30,3,3,6,50.0%,29m
3029,3,[Fever]Decay,3299,146,3,4,7,42.9%,12m
3029,2,NAZGUL,3299,0,1,0,1,100.0%,8m
3029,3,MolarBear,3299,0,0,2,2,0.0%,3m
3040,3,zoO,3298,58,3,2,5,60.0%,34m
3040,3,Insatiable,3298,0,1,0,1,100.0%,12m
3040,3,Wildcide,3298,0,0,1,1,0.0%,7m
3043,3,EZZ,3297,1585,143,139,282,50.7%,6m
3043,3,Starscream,3297,1360,132,123,255,51.8%,6m
3043,3,Marineford,3297,578,23,21,44,52.3%,14m
3043,3,QLmindless,3297,140,6,1,7,85.7%,30m
3043,3,[iS1MP]Feather,3297,0,3,5,8,37.5%,51m
3043,1,[TPLUSS]Tinichu,3297,48,2,1,3,66.7%,9m
3043,3,Eversmot,3297,0,1,4,5,20.0%,43m
3043,3,CruSha,3297,0,0,1,1,0.0%,34m
3051,3,[UniVV]NorthStar,3296,328,17,22,39,43.6%,8m
3051,2,HanNiBal,3296,246,11,6,17,64.7%,43m
3051,3,TaX,3296,90,4,11,15,26.7%,37m
3051,3,ramanujan,3296,90,3,6,9,33.3%,11m
3051,3,Hasted,3296,0,1,0,1,100.0%,7m
3051,3,[PRTLD]MrAnderson,3296,0,0,1,1,0.0%,15m
3057,3,[SsaYnS]Kiar,3295,254,72,65,137,52.6%,4m
3057,3,[GDTAzT]LSxNarGusx,3295,635,43,48,91,47.3%,32m
3057,3,Donut,3295,30,1,1,2,50.0%,32m
3057,3,Exoticfritos,3295,0,0,1,1,0.0%,40m
3061,3,Sigmakiavel,3294,549,87,75,162,53.7%,12m
3061,3,Exiedot,3294,314,14,13,27,51.9%,44m
3061,3,[TgAg]FearCat,3294,354,13,8,21,61.9%,29m
3061,3,MMRDonation,3294,30,2,5,7,28.6%,14m
3065,3,smallman,3293,1318,50,52,102,49.0%,3m
3065,3,[GnR]TitsMcgee,3293,1029,49,47,96,51.0%,45m
3065,3,CthulhUwU,3293,337,34,32,66,51.5%,49m
3065,3,[ArGNA]kilokilo,3293,140,6,5,11,54.5%,10m
3065,3,[CH3ES3]ColonelHamm,3293,119,2,1,3,66.7%,40m
3065,3,Preeminent,3293,0,2,4,6,33.3%,14m
3065,3,[Zzone]Arth,3293,0,0,1,1,0.0%,44m
3072,3,[lNI]PrismMike,3292,785,46,50,96,47.9%,31m
3072,3,[FFAA]Tlaloc,3292,254,9,0,9,100.0%,14m
3072,3,[SkAL]Skalinas,3292,94,3,9,12,25.0%,43m
3072,3,Luonidas,3292,30,1,2,3,33.3%,1m
3072,2,[Cryptc]hotdogSherif,3292,0,0,2,2,0.0%,60m
3077,3,NoEffort,3291,418,19,12,31,61.3%,38m
3077,3,Zevi,3291,0,4,1,5,80.0%,42m
3077,3,Lucky,3291,30,4,5,9,44.4%,38m
3080,3,[ValidG]Blitz,3290,1576,99,80,179,55.3%,12m
3080,3,melville,3290,118,2,2,4,50.0%,47m
3080,3,[NwAs]ILifeI,3290,0,1,0,1,100.0%,54m
3080,3,johngalt,3290,0,0,1,1,0.0%,2m
3084,3,[NPhase]PrbeLfeMatta,3289,875,126,107,233,54.1%,53m
3084,3,Brobz,3289,114,4,4,8,50.0%,4m
3084,3,Gamma,3289,30,2,4,6,33.3%,51m
3084,3,Gendarme,3289,0,1,0,1,100.0%,51m
3084,3,[doodz]ETgoBoom,3289,30,1,1,2,50.0%,6m
3089,3,[iIoveU]Aphroditeve,3288,1580,523,512,1035,50.5%,54m
3089,3,[LTK]CaDanGr,3288,1536,63,52,115,54.8%,14m
3089,3,Dayman,3288,349,39,26,65,60.0%,39m
3089,3,[funand]Serral,3288,1002,38,38,76,50.0%,12m
3089,3,Grimkz,3288,0,3,2,5,60.0%,6m
3089,3,[UCI]Shockling,3288,92,3,5,8,37.5%,12m
3089,1,Ret,3288,119,2,2,4,50.0%,54m
3089,3,UncLeToBy,3288,97,1,1,2,50.0%,6m
3097,2,Doucher,3287,857,109,115,224,48.7%,42m
3097,3,AlphaDrake,3287,1286,97,93,190,51.1%,53m
3097,3,NoMad,3287,383,20,28,48,41.7%,12m
3097,3,Xenomorph,3287,135,15,13,28,53.6%,33m
3097,3,[THYGAP]KimJongSkill,3287,351,10,19,29,34.5%,37m
3097,2,Moushi,3287,0,4,1,5,80.0%,39m
3097,3,[PlsB0s]Ocelot,3287,0,0,4,4,0.0%,46m
3104,3,KillerOB,3286,992,37,32,69,53.6%,36m
3104,3,Estrong,3286,743,29,33,62,46.8%,54m
3104,3,stranger,3286,388,20,15,35,57.1%,14m
3104,2,NoxyBo,3286,423,15,23,38,39.5%,50m
3104,2,Alackatro,3286,202,6,5,11,54.5%,50m
3104,3,Entertainer,3286,0,1,0,1,100.0%,53m
3104,3,[TNBII]Remones,3286,0,0,1,1,0.0%,29m
3104,3,qqqqqq,3286,0,0,1,1,0.0%,14m
3104,3,Barkode,3286,0,0,2,2,0.0%,14m
3113,3,[Hayze]ARedTornadO,3285,689,55,53,108,50.9%,45m
3113,3,[0sC]Ram,3285,457,24,18,42,57.1%,33m
3113,3,avilo,3285,300,11,15,26,42.3%,54m
3113,3,[PVZ50]DasNoob,3285,131,3,0,3,100.0%,33m
3113,3,SpAzTiC,3285,146,3,4,7,42.9%,2m
3113,3,computer,3285,0,0,1,1,0.0%,45m
3113,3,Shivyk,3285,0,0,1,1,0.0%,12m
3120,3,Ryz,3284,1626,608,583,1191,51.0%,49m
3120,3,Jude,3284,1381,92,83,175,52.6%,37m
3120,3,Hiholic,3284,662,27,22,49,55.1%,42m
3120,3,Chamillitary,3284,192,8,5,13,61.5%,45m
3120,3,Titanflash,3284,208,7,12,19,36.8%,45m
3120,3,UrineTrouble,3284,196,7,12,19,36.8%,11m
3120,1,PoultryFeed,3284,144,6,3,9,66.7%,3h
3120,3,[NPhasA]TheNewGuy,3284,122,4,9,13,30.8%,8m
3120,3,Admiral,3284,0,3,2,5,60.0%,37m
3120,3,[DhZAc1]SkyDrago,3284,60,2,6,8,25.0%,32m
3120,3,[Sune]Pilaf,3284,0,0,1,1,0.0%,40m
3120,3,Krycek,3284,0,0,2,2,0.0%,49m
3132,3,Raisins,3283,1594,112,109,221,50.7%,43m
3132,3,[HJBE]Hullo,3283,470,16,22,38,42.1%,32m
3132,2,[Moneey]Gryzm,3283,183,9,7,16,56.2%,33m
3132,3,GLYDE,3283,230,8,12,20,40.0%,45m
3132,1,[YTOWN]LanoBolt,3283,46,1,4,5,20.0%,10m
3137,3,[GnR]GoodBoy,3282,283,13,22,35,37.1%,30m
3137,3,[Big117]theprobelem,3282,232,9,12,21,42.9%,6m
3137,3,Brenno,3282,0,1,0,1,100.0%,30m
3137,3,Strange,3282,0,1,0,1,100.0%,29m
3137,3,MrCakeZ,3282,0,0,2,2,0.0%,54m
3137,3,Enderdejoran,3282,0,0,5,5,0.0%,31m
3143,3,[WNTRLY]Leethor,3281,1003,41,33,74,55.4%,37m
3143,3,Orr,3281,30,2,9,11,18.2%,38m
3143,3,[LUE]OctopusBlues,3281,0,1,0,1,100.0%,7m
3143,3,Hoobawapa,3281,91,1,2,3,33.3%,43m
3147,3,[NOllll]IIIIIIIIIIII,3280,428,34,30,64,53.1%,48m
3147,3,Tyler,3280,0,4,1,5,80.0%,43m
3147,3,TenNeon,3280,94,3,7,10,30.0%,12m
3147,3,Tazel,3280,0,1,4,5,20.0%,34m
3147,3,Matt,3280,0,0,1,1,0.0%,53m
3152,3,AxeForge,3279,1427,240,226,466,51.5%,2m
3152,3,KainPrime,3279,371,13,5,18,72.2%,8m
3152,3,HotSoupForJD,3279,30,4,2,6,66.7%,4m
3152,3,DramerFarma,3279,0,1,0,1,100.0%,47m
3152,3,cam,3279,30,1,1,2,50.0%,11m
3152,2,[SALTDY]inEVItabLe,3279,0,0,1,1,0.0%,1h
3158,3,SwarmStorm,3278,818,71,55,126,56.3%,2m
3158,2,Klocks,3278,1025,41,55,96,42.7%,5m
3158,3,ONEEEPUNCHHH,3278,399,17,9,26,65.4%,43m
3158,3,asereje,3278,235,11,2,13,84.6%,15m
3158,2,victor,3278,288,9,22,31,29.0%,51m
3158,3,[KiMBR]FeniX,3278,86,3,1,4,75.0%,3m
3158,3,MarcosR,3278,90,3,10,13,23.1%,12m
3158,3,[FateTw]Neroc,3278,34,1,1,2,50.0%,14m
3166,2,XFilez,3277,1236,330,326,656,50.3%,5m
3166,3,[CHATO]PedroHBD,3277,1534,137,117,254,53.9%,29m
3166,3,SoapNShampoo,3277,202,7,8,15,46.7%,32m
3166,3,FinnTheHuman,3277,144,5,3,8,62.5%,15m
3166,3,[MMBCA]VISION,3277,30,1,2,3,33.3%,44m
3166,3,Ronnie,3277,0,0,1,1,0.0%,31m
3172,3,[IPOI3]ImDewey,3276,612,22,25,47,46.8%,41m
3172,3,SYLAR,3276,328,12,13,25,48.0%,43m
3172,3,TheOtherOne,3276,268,11,7,18,61.1%,52m
3172,2,GoodGameNoob,3276,198,4,10,14,28.6%,46m
3176,3,JoJo,3275,611,80,78,158,50.6%,37m
3176,2,[iDrunk]Zach,3275,278,11,18,29,37.9%,33m
3176,3,lllllll,3275,114,5,7,12,41.7%,37m
3176,3,[Vales]Kalthazard,3275,0,3,2,5,60.0%,54m
3180,3,vonster,3274,1203,155,135,290,53.4%,1m
3180,3,[αB]Duckpool,3274,196,7,7,14,50.0%,15m
3180,3,IIIIIIIIIIII,3274,200,7,9,16,43.8%,31m
3180,3,[SHLA]PartinG,3274,30,5,2,7,71.4%,6m
3180,3,RuDE,3274,30,1,1,2,50.0%,47m
3180,3,[Ghost2]Oberyn,3274,0,0,1,1,0.0%,4m
3186,3,[Simen]Bupie,3273,735,34,21,55,61.8%,1m
3186,3,[DSGang]DonnyT,3273,523,22,10,32,68.8%,40m
3186,3,romantasy,3273,445,17,8,25,68.0%,46m
3186,3,covid,3273,342,13,9,22,59.1%,11m
3186,3,CManForever,3273,0,4,1,5,80.0%,2m
3186,3,shoegaze,3273,90,4,3,7,57.1%,6m
3186,3,casualplayer,3273,0,1,0,1,100.0%,12m
3193,3,Justitia,3272,1390,166,156,322,51.6%,37m
3193,2,thotleader,3272,154,5,3,8,62.5%,4m
3193,3,[ØFoxF2]Moxterr,3272,86,4,3,7,57.1%,44m
3193,3,MarineKing,3272,30,2,1,3,66.7%,39m
3193,3,[AUNI]foREVer,3272,0,2,3,5,40.0%,11m
3198,3,[Fluxy]gdolphin,3271,401,94,85,179,52.5%,7m
3198,1,SoulCancer,3271,145,4,2,6,66.7%,39m
3198,3,Atopos,3271,0,0,1,1,0.0%,7m
3198,3,LeoMinelli,3271,0,0,3,3,0.0%,29m
3202,3,[BRAP]Xterminator,3270,499,42,33,75,56.0%,32m
3202,3,Serenity,3270,546,27,20,47,57.4%,36m
3202,3,[CrnKy]MeoMaikasCat,3270,294,11,14,25,44.0%,55m
3202,3,yumyumhungry,3270,114,4,2,6,66.7%,1m
3202,1,IIIIIIIIIIII,3270,97,2,0,2,100.0%,41m
3202,3,Bottle,3270,0,1,0,1,100.0%,46m
3202,3,SicVitaEst,3270,30,1,1,2,50.0%,6m
3202,3,DYLue,3270,30,1,2,3,33.3%,3m
3202,3,[JDG]Emperatore,3270,0,0,1,1,0.0%,34m
3202,3,ClootClam,3270,0,0,1,1,0.0%,48m
3202,3,Trixta,3270,0,0,1,1,0.0%,52m
3213,3,[NPhase]Slardak,3269,1397,59,58,117,50.4%,29m
3213,3,Plas,3269,882,35,28,63,55.6%,47m
3213,3,Bob,3269,348,13,6,19,68.4%,47m
3213,3,[TPGGXD]Smile,3269,155,6,2,8,75.0%,54m
3213,3,Mark,3269,174,6,5,11,54.5%,29m
3213,3,Keyboard,3269,140,4,0,4,100.0%,43m
3213,3,IllIIIllllII,3269,0,0,3,3,0.0%,1m
3220,2,Bankai,3268,0,3,2,5,60.0%,1h
3220,3,WorkWork,3268,0,1,0,1,100.0%,29m
3220,3,SixGuns,3268,0,0,1,1,0.0%,34m
3220,3,Babu,3268,0,0,2,2,0.0%,2m
3224,3,YoYoMan,3267,217,6,4,10,60.0%,43m
3224,2,RandomName,3267,95,5,1,6,83.3%,1h
3224,2,IIIIIIIIIIII,3267,46,5,2,7,71.4%,43m
3224,3,[Macac0]pungthewolf,3267,86,4,1,5,80.0%,9m
3224,3,ZeroControl,3267,58,3,1,4,75.0%,50m
3224,3,strangestrat,3267,30,2,0,2,100.0%,53m
3224,3,[Ris3n]PhoenixKing,3267,95,1,4,5,20.0%,11m
3224,3,xxxxxxxxxx,3267,0,0,1,1,0.0%,29m
3232,3,Jmbwoody,3266,717,153,141,294,52.0%,8m
3232,3,AVO,3266,612,27,25,52,51.9%,37m
3232,3,Dave,3266,197,9,5,14,64.3%,45m
3232,3,llllllllllll,3266,166,6,6,12,50.0%,48m
3232,3,surreal,3266,60,2,7,9,22.2%,10m
3232,1,Stcalde,3266,44,1,1,2,50.0%,11m
3232,3,TrippelM,3266,0,0,1,1,0.0%,33m
3232,3,[SyLx]mishima,3266,0,0,1,1,0.0%,50m
3240,3,Solilonarova,3265,1542,109,89,198,55.1%,3m
3240,3,JeanJean,3265,465,20,11,31,64.5%,12m
3240,3,[SC2IDN]Jangbingo,3265,308,12,5,17,70.6%,6m
3240,3,FBHKreator,3265,210,7,6,13,53.8%,50m
3240,3,[SLAPD]AscenT,3265,58,2,3,5,40.0%,12m
3240,3,[fagz]TheBigGay,3265,30,1,2,3,33.3%,34m
3246,3,drop,3264,1305,81,61,142,57.0%,31m
3246,3,IAMCANADIAN,3264,1126,44,44,88,50.0%,34m
3246,3,HelsHounds,3264,471,25,31,56,44.6%,3m
3246,3,[FVCES]lolmattlol,3264,142,6,3,9,66.7%,39m
3246,3,razE,3264,0,3,2,5,60.0%,13m
3246,3,LexRex,3264,58,2,1,3,66.7%,35m
3246,3,[PD2D]Killakure,3264,0,0,1,1,0.0%,37m
3253,3,[αXLa]Eintrag,3263,1484,100,101,201,49.8%,9m
3253,3,[TUTTER]Cubra,3263,572,19,28,47,40.4%,12m
3253,3,IIIIIIIIIIII,3263,116,5,2,7,71.4%,35m
3253,3,[XpKb]GansitoUwU,3263,86,3,1,4,75.0%,34m
3253,3,[ACSS]CoBro,3263,60,2,7,9,22.2%,14m
3258,3,hunter,3262,896,40,27,67,59.7%,50m
3258,3,[zeez]zeezPanzer,3262,348,13,8,21,61.9%,2m
3258,3,[Komica]MisterHYC,3262,0,4,1,5,80.0%,39m
3261,2,Weenersaurus,3261,1398,101,117,218,46.3%,40m
3261,3,JohnnySinz,3261,1116,42,48,90,46.7%,10m
3261,3,[xLgNx]flapjack,3261,766,39,29,68,57.4%,52m
3261,3,Pandadeath,3261,744,29,26,55,52.7%,1m
3261,3,[LynnU]PaulAtreides,3261,62,3,3,6,50.0%,43m
3261,3,Dvine,3261,0,1,0,1,100.0%,39m
3261,2,KillerApe,3261,0,1,0,1,100.0%,1h
3261,3,[NOZO]Vegeta,3261,0,1,1,2,50.0%,39m
3269,3,drizzle,3260,204,7,9,16,43.8%,31m
3269,1,NarutoUzumak,3260,121,6,2,8,75.0%,10m
3269,3,uuuuuuuuuuuu,3260,212,6,6,12,50.0%,50m
3269,3,Sherpad,3260,114,5,4,9,55.6%,5m
3269,3,[RustLg]XxkilljoyxX,3260,0,3,2,5,60.0%,34m
3269,3,[NrFms]MaD,3260,30,2,2,4,50.0%,37m
3269,3,BETRÜGER,3260,0,1,2,3,33.3%,54m
3269,3,XXXXXXXXXX,3260,0,0,1,1,0.0%,29m
3277,3,Space,3259,839,154,133,287,53.7%,7m
3277,3,MrTerribad,3259,1060,41,40,81,50.6%,29m
3277,3,Phoenix,3259,574,23,20,43,53.5%,54m
3277,3,Gargamash,3259,525,20,13,33,60.6%,31m
3277,3,StarRider,3259,356,13,9,22,59.1%,40m
3277,2,MicroManage,3259,96,6,0,6,100.0%,1h
3277,3,Blead,3259,146,6,7,13,46.2%,32m
3277,3,HitmanLife,3259,188,6,13,19,31.6%,11m
3277,3,SirWhite,3259,0,5,0,5,100.0%,39m
3277,3,HiO,3259,0,4,1,5,80.0%,11m
3287,3,CANCEL,3258,251,25,22,47,53.2%,13m
3287,3,Jaguar,3258,361,15,11,26,57.7%,48m
3287,3,[GdAT]ScarlettUK,3258,234,15,14,29,51.7%,33m
3287,2,[UoM]PandaKing,3258,62,4,10,14,28.6%,50m
3287,3,Silence,3258,30,1,4,5,20.0%,30m
3292,3,KeyBlader,3257,512,18,22,40,45.0%,46m
3292,3,Faith,3257,168,7,5,12,58.3%,33m
3292,3,[LQV]Raccoon,3257,60,3,4,7,42.9%,29m
3292,3,FlickFiebeR,3257,30,2,0,2,100.0%,7m
3292,3,[xRtGac]arcHoniC,3257,0,1,0,1,100.0%,48m
3297,3,[syrup]rev,3256,304,11,11,22,50.0%,32m
3297,3,[SUNBRA]Solaire,3256,192,8,5,13,61.5%,32m
3297,3,Baxtor,3256,114,4,1,5,80.0%,37m
3297,3,JcR,3256,185,4,5,9,44.4%,33m
3297,2,[MIT]radon,3256,0,2,3,5,40.0%,34m
3297,3,Vaala,3256,30,1,1,2,50.0%,40m
3303,3,Eggiman,3255,427,30,35,65,46.2%,12m
3303,3,fraffmantis,3255,0,1,0,1,100.0%,45m
3303,3,[PSC]RockLobster,3255,34,1,2,3,33.3%,47m
3303,3,TrOyHaRd,3255,0,0,1,1,0.0%,37m
3303,1,modcrac,3255,0,0,1,1,0.0%,14m
3308,3,Rahwinia,3254,1296,313,299,612,51.1%,41m
3308,3,Anti,3254,482,20,12,32,62.5%,42m
3308,3,higl,3254,142,7,3,10,70.0%,33m
3308,3,BadManner,3254,0,1,0,1,100.0%,11m
3308,3,Tandris,3254,30,1,2,3,33.3%,12m
3313,3,MrGirardT,3253,1406,131,118,249,52.6%,7m
3313,3,[XBBQ]DeltaRomeo,3253,860,47,40,87,54.0%,46m
3313,3,ATC,3253,122,3,4,7,42.9%,54m
3313,3,qqq,3253,58,3,5,8,37.5%,6m
3313,3,[GSF91]bonxiakalaka,3253,0,1,0,1,100.0%,48m
3318,3,TripleXXX,3252,768,30,22,52,57.7%,4m
3318,3,xxardacoxx,3252,198,9,12,21,42.9%,46m
3318,3,[2Pac96]Nosslar,3252,30,5,1,6,83.3%,3m
3318,2,[LXG]Sylvar,3252,0,1,4,5,20.0%,52m
3318,3,dcfm,3252,0,0,3,3,0.0%,14m
3323,3,[plannB]Ryansdad,3251,237,21,17,38,55.3%,12m
3323,3,DonaldPump,3251,347,15,10,25,60.0%,11m
3323,3,LargePeniz,3251,398,15,12,27,55.6%,42m
3323,3,[RatZx]RatzBarcode,3251,353,12,8,20,60.0%,11m
3323,3,[αB]SniperSC,3251,146,6,5,11,54.5%,4m
3323,3,[DFWU]HateGames,3251,0,4,1,5,80.0%,49m
3323,3,deadish,3251,30,2,1,3,66.7%,32m
3323,3,BrightViSion,3251,0,1,0,1,100.0%,51m
3331,2,[SolOGS]assassin,3250,301,10,24,34,29.4%,37m
3331,3,[pzv]superpants,3250,248,9,7,16,56.2%,32m
3331,1,HowSad,3250,97,6,1,7,85.7%,3h
3331,3,[EZTAXI]GreatGoomba,3250,172,6,5,11,54.5%,8m
3331,2,[RawDog]DrPoopyHands,3250,0,4,1,5,80.0%,1h
3336,2,HopperLindy,3249,1493,164,182,346,47.4%,52m
3336,3,[xnSx]SpkrFrDead,3249,688,27,38,65,41.5%,29m
3336,3,boombledoor,3249,472,20,17,37,54.1%,29m
3336,3,boubou,3249,427,15,10,25,60.0%,29m
3336,3,BurgerBoy,3249,280,11,7,18,61.1%,30m
3336,3,Realphil,3249,86,4,1,5,80.0%,37m
3336,3,PNUTBTRFLCN,3249,30,2,1,3,66.7%,1m
3336,3,[UCSD]nobodywonder,3249,0,1,0,1,100.0%,32m
3336,3,Drcesar,3249,18,1,13,14,7.1%,38m
3345,3,Wutsherface,3248,1609,80,45,125,64.0%,47m
3345,3,rednelB,3248,1068,48,27,75,64.0%,52m
3345,3,[EZDUNK]GuyInTheChat,3248,634,31,37,68,45.6%,45m
3345,3,MATHEMATIK,3248,837,30,37,67,44.8%,11m
3345,3,Gray,3248,383,27,26,53,50.9%,52m
3345,3,littlemozart,3248,60,2,3,5,40.0%,34m
3345,2,LsSc,3248,0,1,0,1,100.0%,32m
3345,3,Davastator,3248,0,1,0,1,100.0%,32m
3345,3,Yuugure,3248,0,1,0,1,100.0%,40m
3345,2,hyulch,3248,48,1,1,2,50.0%,1h
3345,3,OhMyZeRo,3248,30,1,2,3,33.3%,45m
3356,3,Cheche,3247,795,48,33,81,59.3%,39m
3356,3,DarkWolfdog,3247,410,17,15,32,53.1%,7m
3356,3,[TCook]Beercules,3247,426,15,17,32,46.9%,29m
3356,3,[BRUVV]Telephone,3247,118,5,5,10,50.0%,6m
3356,3,Raynor,3247,30,2,0,2,100.0%,49m
3356,3,[DarkAG]Zergasm,3247,30,1,1,2,50.0%,11m
3356,3,[QTclub]Dust,3247,30,1,1,2,50.0%,32m
3356,3,eZZeCuTeR,3247,30,1,4,5,20.0%,45m
3364,3,Future,3246,427,15,17,32,46.9%,14m
3364,3,[wOaS]horseypistac,3246,140,6,2,8,75.0%,42m
3364,3,[TGosuA]Burrell,3246,60,3,2,5,60.0%,32m
3364,1,Rdzm,3246,97,1,2,3,33.3%,1h
3368,3,[HBNC]hbdisfoo,3245,1565,165,161,326,50.6%,29m
3368,3,[PNS]Ziguela,3245,761,35,24,59,59.3%,32m
3368,3,HooLiganI,3245,249,8,8,16,50.0%,37m
3368,3,liang,3245,0,5,1,6,83.3%,43m
3368,3,[MLGB]AOldDustShoe,3245,0,1,1,2,50.0%,32m
3373,3,Shrimp,3244,831,178,156,334,53.3%,48m
3373,3,deal,3244,425,26,19,45,57.8%,12m
3373,2,[asdfsd]Kobra,3244,610,21,39,60,35.0%,32m
3373,3,Grimreaper,3244,120,6,7,13,46.2%,7m
3373,3,eninyaD,3244,180,6,11,17,35.3%,40m
3373,3,[ZTempz]llThunDeRll,3244,118,5,4,9,55.6%,39m
3373,3,[oTc]BakeR,3244,150,5,8,13,38.5%,11m
3373,2,OldGeroTook,3244,0,4,1,5,80.0%,33m
3373,3,BeltaLowda,3244,0,0,2,2,0.0%,40m
3382,3,Saskuk,3243,1126,41,45,86,47.7%,15m
3382,3,[F1ght]Moony,3243,643,27,25,52,51.9%,38m
3382,3,wewe,3243,138,8,1,9,88.9%,43m
3382,3,Xyu,3243,224,7,16,23,30.4%,55m
3382,3,Ekchuah,3243,118,4,3,7,57.1%,41m
3382,3,[iMx]Hero,3243,30,2,2,4,50.0%,40m
3382,3,[KGC]slyp,3243,30,1,7,8,12.5%,39m
3382,3,[d1ldo]Tonkatwuck,3243,0,0,2,2,0.0%,30m
3390,3,Effervescent,3242,1054,44,33,77,57.1%,7m
3390,3,[Italis]ttime,3242,706,29,22,51,56.9%,15m
3390,3,Saitama,3242,148,6,7,13,46.2%,42m
3390,3,[P00S1E]blubr,3242,179,5,8,13,38.5%,15m
3390,3,PapayaNuts,3242,58,3,0,3,100.0%,31m
3390,3,NewEnd,3242,0,3,3,6,50.0%,36m
3390,3,[JSLs]AirKing,3242,0,1,0,1,100.0%,7m
3390,2,deadinside,3242,0,0,1,1,0.0%,50m
3398,3,Starblazed,3241,315,15,8,23,65.2%,7m
3398,3,Moo,3241,223,8,0,8,100.0%,8m
3398,3,idaniel,3241,202,7,10,17,41.2%,32m
3398,3,StickyWicket,3241,0,1,0,1,100.0%,31m
3402,2,lilac,3240,90,1,1,2,50.0%,32m
3402,3,tpk,3240,30,1,2,3,33.3%,43m
3402,3,[AZK]VoodooJester,3240,0,0,1,1,0.0%,29m
3405,3,fleshblade,3239,1586,221,218,439,50.3%,33m
3405,3,AboveThee,3239,1126,55,47,102,53.9%,4m
3405,3,Ouroboros,3239,163,7,3,10,70.0%,12m
3405,3,[Igbt]FlyinHurtBus,3239,0,2,3,5,40.0%,45m
3409,3,[ShNK]DeathGun,3238,893,42,22,64,65.6%,42m
3409,3,[AiMB]MissMicro,3238,797,33,33,66,50.0%,15m
3409,3,Jambi,3238,30,5,2,7,71.4%,43m
3409,3,ShadyDealer,3238,58,3,1,4,75.0%,11m
3409,3,Groo,3238,86,3,2,5,60.0%,32m
3409,3,[LCE]Wizard,3238,0,1,0,1,100.0%,29m
3415,3,Ace,3237,623,32,22,54,59.3%,35m
3415,1,Scaevola,3237,189,7,4,11,63.6%,3h
3415,3,[DoRQ]Zimphar,3237,156,5,11,16,31.2%,46m
3415,3,LeeSeDol,3237,116,4,9,13,30.8%,36m
3415,3,Wretched,3237,0,3,1,4,75.0%,14m
3415,3,OnlyLoveYou,3237,58,3,9,12,25.0%,11m
3421,2,Deluzio,3236,321,11,8,19,57.9%,9m
3421,3,Helloladys,3236,0,1,0,1,100.0%,49m
3421,3,DarkReaper,3236,30,1,2,3,33.3%,7m
3424,3,TangoRocker,3235,368,57,34,91,62.6%,32m
3424,3,[GOPERÚ]Angeluz,3235,697,42,38,80,52.5%,15m
3424,3,darxon,3235,190,5,2,7,71.4%,34m
3424,3,Prode,3235,0,5,3,8,62.5%,36m
3424,2,Silver,3235,96,3,3,6,50.0%,1h
3424,3,min,3235,97,2,2,4,50.0%,46m
3424,3,[LGNxx]Shaman,3235,0,1,0,1,100.0%,39m
3431,3,Mechulus,3234,1615,106,95,201,52.7%,39m
3431,3,IIIIIIIIIIII,3234,1252,52,42,94,55.3%,10m
3431,3,saken,3234,700,25,31,56,44.6%,14m
3431,3,Forkstealer,3234,62,5,6,11,45.5%,12m
3431,2,TYTY,3234,0,4,1,5,80.0%,10m
3431,3,BlackSoul,3234,117,3,0,3,100.0%,54m
3431,3,ºsnorlaxº,3234,93,3,1,4,75.0%,34m
3431,3,CommandCentr,3234,38,2,0,2,100.0%,37m
3439,3,[PHAG5]Jellyfish,3233,1247,54,46,100,54.0%,31m
3439,3,CORVIDSUX,3233,335,14,7,21,66.7%,32m
3439,1,RedSteel,3233,165,7,2,9,77.8%,1h
3439,3,[4Karl]Nebula,3233,189,7,6,13,53.8%,39m
3439,3,BigUzii,3233,0,0,1,1,0.0%,50m
3444,3,Dotty,3232,364,15,14,29,51.7%,29m
3444,3,jusszy,3232,144,6,7,13,46.2%,14m
3444,3,alberttt,3232,88,4,1,5,80.0%,38m
3444,3,[ROS8th]Temperplex,3232,30,2,1,3,66.7%,12m
3444,3,[TGosuA]KimJongBoom,3232,42,1,5,6,16.7%,14m
3444,3,SoulHunter,3232,0,0,1,1,0.0%,37m
3450,3,KombatWombat,3231,176,7,9,16,43.8%,43m
3450,3,FroMan,3231,30,6,2,8,75.0%,7m
3450,3,Abduzcan,3231,0,5,0,5,100.0%,32m
3450,1,Tailon,3231,120,2,2,4,50.0%,50m
3450,2,Tydro,3231,0,1,0,1,100.0%,3m
3450,3,[DarkAG]EEZ,3231,0,1,2,3,33.3%,3m
3450,3,[420kil]CoronaVirus,3231,0,0,1,1,0.0%,4m
3450,3,[SAUNA]Dimmy,3231,0,0,1,1,0.0%,45m
3450,3,Aborym,3231,0,0,1,1,0.0%,41m
3459,3,BadManner,3230,1147,173,175,348,49.7%,52m
3459,3,[SIClan]morulis,3230,1016,122,127,249,49.0%,29m
3459,3,iseebugs,3230,1487,108,90,198,54.5%,1m
3459,3,pyle,3230,772,26,38,64,40.6%,5m
3459,3,gongor,3230,30,5,2,7,71.4%,40m
3459,3,dogjlao,3230,95,3,3,6,50.0%,53m
3459,3,[LDPro]ZerX,3230,0,0,1,1,0.0%,49m
3466,3,Lua,3229,1539,94,99,193,48.7%,42m
3466,3,Sheep,3229,1122,42,45,87,48.3%,39m
3466,3,ReFuGee,3229,325,24,19,43,55.8%,11m
3466,3,ProToZ,3229,316,12,10,22,54.5%,37m
3466,3,PigFan,3229,0,4,1,5,80.0%,52m
3466,3,[MLPog]Astealthyko,3229,58,2,1,3,66.7%,7m
3466,3,[Tacos]andycap,3229,0,1,5,6,16.7%,42m
3466,3,[Keenky]Timtation,3229,0,0,3,3,0.0%,37m
3474,3,ThePunisher,3228,1632,124,104,228,54.4%,35m
3474,3,Rzer,3228,544,21,18,39,53.8%,38m
3474,3,[PTHero]Ganondorf,3228,528,19,15,34,55.9%,37m
3474,3,[AbcCo]Eivici,3228,280,9,11,20,45.0%,2m
3474,3,SleepyJoe,3228,0,4,1,5,80.0%,2m
3474,3,RebornAngel,3228,0,0,1,1,0.0%,50m
3474,3,[LCE]Gabriel,3228,0,0,1,1,0.0%,42m
3481,3,GrimLock,3227,347,13,9,22,59.1%,52m
3481,3,[l3l3]Melonheadjr,3227,148,7,4,11,63.6%,13m
3481,3,SarahZhang,3227,219,7,11,18,38.9%,45m
3481,3,nex,3227,190,6,3,9,66.7%,8m
3481,3,[umoron]llllllllllll,3227,188,5,5,10,50.0%,42m
3481,3,MabuL,3227,137,4,1,5,80.0%,2m
3481,2,[QTp2T]Felicity,3227,0,1,0,1,100.0%,60m
3481,3,[IiUiI]demon,3227,0,0,1,1,0.0%,41m
3489,3,[REPORT]CheLoSenSei,3226,1139,48,35,83,57.8%,54m
3489,2,AlexJones,3226,207,9,5,14,64.3%,9m
3489,1,GopOfVade,3226,141,6,3,9,66.7%,1h
3489,3,[IpTime]DestinyCake,3226,0,4,1,5,80.0%,13m
3489,3,WHTVRTTKS,3226,90,3,10,13,23.1%,29m
3489,3,[ICE8]MCC,3226,30,2,1,3,66.7%,51m
3489,3,MyDudes,3226,0,0,1,1,0.0%,37m
3496,3,[Ash3s]Eleven,3225,1547,299,304,603,49.6%,54m
3496,3,[PMN]WhoGotDaMumf,3225,754,32,23,55,58.2%,13m
3496,2,Neato,3225,0,3,3,6,50.0%,52m
3496,3,[NEO]Divine,3225,0,0,1,1,0.0%,35m
3500,3,XXXXXXXXXX,3224,1253,98,96,194,50.5%,52m
3500,3,LORD,3224,0,1,0,1,100.0%,14m
3500,3,AAAAAAAAA,3224,0,1,0,1,100.0%,6m
3500,3,[SCTR]CapMurica,3224,0,0,1,1,0.0%,50m
3504,3,[iDeX]ForaBolsonar,3223,1542,123,120,243,50.6%,11m
3504,3,PBnJ,3223,1145,49,34,83,59.0%,38m
3504,3,DSTittyBang,3223,434,20,11,31,64.5%,10m
3504,3,TheBOMB,3223,286,9,8,17,52.9%,15m
3504,3,ZEROSTAR,3223,0,1,0,1,100.0%,8m
3504,3,[RwtM]Dman,3223,0,0,1,1,0.0%,54m
3510,3,[Peeepz]rocky,3222,228,9,7,16,56.2%,37m
3510,3,brinky,3222,95,4,2,6,66.7%,4m
3510,2,Desenchufado,3222,0,0,3,3,0.0%,3m
3513,3,Blank,3221,0,4,1,5,80.0%,40m
3513,3,[GOPERÚ]deathwork,3221,0,2,3,5,40.0%,31m
3515,3,[PLOWU]DayMan,3220,486,19,12,31,61.3%,31m
3515,3,[SMRT]OoObernOOb,3220,292,12,9,21,57.1%,32m
3515,3,noobbz,3220,122,7,8,15,46.7%,37m
3515,3,StoryTeller,3220,119,2,1,3,66.7%,34m
3515,3,NotSure,3220,0,2,3,5,40.0%,15m
3515,3,ASlowLoris,3220,0,1,0,1,100.0%,35m
3521,3,BouncyKnight,3219,1521,211,201,412,51.2%,6m
3521,3,llllllllllll,3219,174,7,6,13,53.8%,10m
3521,2,Brachydios,3219,0,3,2,5,60.0%,1h
3521,1,[QRTINE]XXIIVIII,3219,96,3,6,9,33.3%,34m
3525,3,Peter,3218,411,18,13,31,58.1%,3m
3525,3,[TGULS]miko,3218,410,14,20,34,41.2%,4m
3525,1,SKTerran,3218,333,13,10,23,56.5%,3m
3525,3,[CUMING]maxwelljones,3218,380,13,22,35,37.1%,29m
3525,3,[iDrunk]Azbro,3218,279,11,5,16,68.8%,40m
3525,3,Mopup,3218,347,11,13,24,45.8%,5m
3525,3,[Macac0]JonSnow,3218,240,8,15,23,34.8%,36m
3525,3,[inHell]TheSirFM,3218,192,5,3,8,62.5%,4m
3525,3,[TeamUR]LostFafa,3218,26,3,9,12,25.0%,37m
3525,3,LGBTandBLM,3218,0,2,0,2,100.0%,32m
3525,3,[TCRC]duncgardner,3218,60,2,2,4,50.0%,29m
3525,2,[IMDSI]SMURFIN,3218,0,1,0,1,100.0%,1h
3525,2,Czubi,3218,0,1,0,1,100.0%,56m
3525,1,[Exper]Earendil,3218,96,1,1,2,50.0%,39m
3525,2,tgop,3218,0,0,1,1,0.0%,1h
3525,3,[CCUO]BirchTree,3218,0,0,1,1,0.0%,39m
3541,3,[DNKCFT]Aerialace,3217,494,20,13,33,60.6%,11m
3541,3,[UpeV]Deadpool,3217,322,12,17,29,41.4%,32m
3541,3,[fagz]HarstemPupil,3217,278,11,3,14,78.6%,35m
3541,3,RedPepper,3217,143,5,4,9,55.6%,3m
3541,2,[Sune]StarGhost,3217,46,2,1,3,66.7%,1h
3541,2,FrOst,3217,0,1,0,1,100.0%,1h
3541,3,Sentwist,3217,0,0,1,1,0.0%,29m
3548,3,Vezza,3216,228,9,14,23,39.1%,37m
3548,3,[oLCi]GoodbyeKitty,3216,220,8,7,15,53.3%,50m
3548,3,PopCorn,3216,0,2,4,6,33.3%,31m
3548,3,[THEV]Swider,3216,0,1,0,1,100.0%,7m
3552,3,Hindenburg,3215,983,38,31,69,55.1%,52m
3552,3,[Mammy]FaDeMuss,3215,256,10,6,16,62.5%,10m
3552,3,Bourne,3215,265,10,7,17,58.8%,30m
3552,2,[FnATlC]OPprotoszerg,3215,137,9,12,21,42.9%,34m
3552,3,Greengimp,3215,196,6,8,14,42.9%,13m
3552,3,KingOfGods,3215,161,6,9,15,40.0%,37m
3552,3,Bob,3215,30,1,2,3,33.3%,3m
3552,3,BAYACETO,3215,0,1,2,3,33.3%,54m
3552,3,[CHlNK]InBeijing,3215,30,1,10,11,9.1%,10m
3552,3,[DRKNS]RawStar,3215,0,0,1,1,0.0%,30m
3552,3,KMAGyoyo,3215,0,0,3,3,0.0%,40m
3563,3,HeroicCookie,3214,365,16,1,17,94.1%,7m
3563,3,Uratsakidogi,3214,192,8,5,13,61.5%,48m
3563,3,Entropian,3214,178,8,10,18,44.4%,29m
3563,3,ColONeill,3214,189,6,4,10,60.0%,35m
3563,3,[scMAUI]Razer,3214,30,2,4,6,33.3%,7m
3563,3,[WpoA]RedXios,3214,30,1,2,3,33.3%,15m
3563,3,[SGSPP]Sushiagogo,3214,0,0,1,1,0.0%,39m
3563,3,OxdeadcOde,3214,0,0,2,2,0.0%,10m
3571,3,[BOOT]Goldo,3213,1277,136,119,255,53.3%,13m
3571,3,Sirkappuccio,3213,1264,48,48,96,50.0%,52m
3571,3,annbenji,3213,392,15,8,23,65.2%,32m
3571,3,[SANGRE]JaYiSiS,3213,345,12,7,19,63.2%,11m
3571,1,aNdoRi,3213,122,6,3,9,66.7%,37m
3571,3,[ROYALz]mrjakk,3213,0,1,0,1,100.0%,37m
3571,3,MrVine,3213,0,1,0,1,100.0%,8m
3571,3,[EzWinn]NoobSAUCE,3213,0,1,1,2,50.0%,35m
3579,3,HongSheng,3212,1587,94,87,181,51.9%,44m
3579,3,Leaky,3212,358,13,18,31,41.9%,34m
3579,3,[NeOx1]resOrt,3212,220,10,14,24,41.7%,48m
3579,3,joelsleftbal,3212,196,7,7,14,50.0%,30m
3579,2,qwe,3212,0,4,1,5,80.0%,1h
3579,2,avoca,3212,0,1,4,5,20.0%,5m
3579,3,TNTTheEliTe,3212,0,0,1,1,0.0%,42m
3579,3,SerralJR,3212,0,0,1,1,0.0%,42m
3579,3,[iCz]TrollYou,3212,0,0,1,1,0.0%,48m
3588,3,Ankoromochi,3211,1170,53,57,110,48.2%,53m
3588,3,Nautilus,3211,420,52,50,102,51.0%,44m
3588,3,[AMFT]BluePenguin,3211,0,4,1,5,80.0%,45m
3588,3,Mazel,3211,88,4,2,6,66.7%,49m
3588,3,Cray,3211,30,2,5,7,28.6%,32m
3588,3,[MiLt]Kitten,3211,0,0,3,3,0.0%,53m
3594,2,ARASTAFASTA,3210,239,8,6,14,57.1%,11m
3594,3,yabuyabu,3210,94,4,2,6,66.7%,54m
3594,3,Eternal,3210,0,2,3,5,40.0%,42m
3594,3,MojoJoGio,3210,60,2,3,5,40.0%,10m
3594,1,Zenxus,3210,96,1,1,2,50.0%,2m
3594,3,Farhao,3210,0,1,2,3,33.3%,32m
3600,3,[3nTar0]Zeratul,3209,1549,72,56,128,56.2%,55m
3600,3,Ryan,3209,964,38,39,77,49.4%,31m
3600,3,[ZTemp]MrMaryJane,3209,496,16,26,42,38.1%,11m
3600,3,Keepo,3209,311,13,13,26,50.0%,7m
3600,3,Gongmyung,3209,140,11,17,28,39.3%,49m
3600,3,WindWIn,3209,0,4,1,5,80.0%,1h
3600,3,thisisnickc,3209,30,2,0,2,100.0%,8m
3600,3,David,3209,0,1,0,1,100.0%,33m
3608,3,Gotti,3208,1519,275,285,560,49.1%,54m
3608,3,SpinW,3208,671,28,25,53,52.8%,50m
3608,3,Hercules,3208,449,15,15,30,50.0%,37m
3608,3,juancho,3208,277,13,15,28,46.4%,3m
3608,3,[RNDM]PpankNoraa,3208,346,11,24,35,31.4%,12m
3608,3,Dark,3208,30,2,6,8,25.0%,29m
3608,3,[eLemon]crazykilller,3208,0,1,0,1,100.0%,31m
3615,3,[sk3tch]Music,3207,1595,221,208,429,51.5%,46m
3615,3,cindysue,3207,336,66,59,125,52.8%,32m
3615,3,[HOOKEM]Dracarys,3207,192,8,6,14,57.1%,7m
3615,3,TheD,3207,192,7,7,14,50.0%,30m
3615,3,SteEZySteve,3207,0,0,1,1,0.0%,49m
3615,2,sanZeNeX,3207,0,0,1,1,0.0%,7m
3621,3,[HGDO]ColdHands,3206,1289,123,117,240,51.2%,7m
3621,3,SickFlick,3206,1503,83,73,156,53.2%,46m
3621,3,KTFlaSh,3206,419,16,16,32,50.0%,50m
3621,2,tyler,3206,46,5,2,7,71.4%,39m
3621,2,ShortsMan,3206,184,5,5,10,50.0%,49m
3621,3,EarthBender,3206,86,3,6,9,33.3%,29m
3621,3,Bondkron,3206,58,2,2,4,50.0%,6m
3621,3,KuDoS,3206,0,1,0,1,100.0%,39m
3621,3,Draven,3206,0,0,1,1,0.0%,13m
3621,3,Alvaparra,3206,0,0,1,1,0.0%,14m
3631,3,[SsaYnS]ofthextype,3205,1431,212,213,425,49.9%,12m
3631,3,goqsane,3205,720,95,79,174,54.6%,50m
3631,3,Masares,3205,1174,59,52,111,53.2%,50m
3631,3,Thischo,3205,384,13,13,26,50.0%,35m
3631,3,[LTlord]daryl,3205,221,10,8,18,55.6%,37m
3631,3,[EpicG]LavienRose,3205,30,1,2,3,33.3%,47m
3631,3,[hTx]DroneCapone,3205,0,0,2,2,0.0%,48m
3638,3,[cbox]dhn,3204,813,38,24,62,61.3%,33m
3638,2,[CuBTaK]llllllllllll,3204,239,8,4,12,66.7%,29m
3638,3,thePRINCE,3204,176,7,6,13,53.8%,48m
3638,3,Stevano,3204,112,5,3,8,62.5%,45m
3638,3,ShadowDragon,3204,144,5,9,14,35.7%,2m
3638,3,HowardMarks,3204,0,4,1,5,80.0%,1h
3638,3,sdf,3204,92,4,7,11,36.4%,52m
3638,3,TheBozozo,3204,120,2,2,4,50.0%,14m
3646,3,[LGNxx]Kyusa,3203,701,32,21,53,60.4%,4m
3646,3,DreamJob,3203,658,26,20,46,56.5%,46m
3646,3,[DarkAG]cbearfresh,3203,565,26,20,46,56.5%,43m
3646,3,MrPenguin,3203,150,6,10,16,37.5%,12m
3646,3,Spenouh,3203,137,5,4,9,55.6%,43m
3646,3,Specialist,3203,0,1,4,5,20.0%,50m
3652,3,[TEAMwC]GoatHerder,3202,1235,292,270,562,52.0%,37m
3652,3,soljax,3202,1458,90,81,171,52.6%,49m
3652,3,yoyo,3202,451,54,52,106,50.9%,29m
3652,3,IIIIIIIIIIII,3202,616,39,41,80,48.8%,11m
3652,3,Hanzos,3202,198,7,6,13,53.8%,45m
3652,3,[NLK]Wormsign,3202,118,5,9,14,35.7%,32m
3652,3,ChozoToss,3202,30,2,1,3,66.7%,15m
3652,3,lmc,3202,0,1,0,1,100.0%,8m
3660,3,shyguy,3201,868,35,39,74,47.3%,37m
3660,3,OveThRainbow,3201,494,18,17,35,51.4%,43m
3660,3,[3D]Melkor,3201,306,11,13,24,45.8%,31m
3660,3,ZeroHedge,3201,120,5,6,11,45.5%,12m
3660,2,[TGosuB]Aroux,3201,117,3,1,4,75.0%,16m
3660,3,[GOPERÚ]sirdrakar,3201,10,2,4,6,33.3%,49m
3660,2,[KxH]Oathkeeper,3201,95,2,5,7,28.6%,10m
3660,3,Angel,3201,0,1,0,1,100.0%,9m
3660,3,[SISR]Phasing,3201,0,1,0,1,100.0%,6m
3660,3,[MEP]sao,3201,30,1,1,2,50.0%,38m
3660,3,selym,3201,0,1,1,2,50.0%,7m
3671,3,[ScrBnG]SCArium,3200,280,10,18,28,35.7%,4m
3671,3,Schuman,3200,198,8,8,16,50.0%,12m
3671,3,[KhanTv]konodioda,3200,151,5,1,6,83.3%,13m
3671,3,[INextI]Sara,3200,90,4,4,8,50.0%,39m
3671,3,[Ahern]AnGrMaNaGmnt,3200,30,1,3,4,25.0%,38m
3671,2,[Fir3s]StporA,3200,0,0,2,2,0.0%,5m
3677,3,[lKoDl]Choreza,3199,553,27,24,51,52.9%,38m
3677,3,Lobão,3199,415,18,8,26,69.2%,7m
3677,1,killerReong,3199,242,15,10,25,60.0%,42m
3677,1,Error,3199,204,8,8,16,50.0%,40m
3677,3,NightKnight,3199,60,3,3,6,50.0%,11m
3677,3,[DNKCFT]Hobbmaster,3199,58,2,2,4,50.0%,13m
3677,3,Flashstorm,3199,0,0,1,1,0.0%,38m
3684,3,UPGRAYEDD,3198,1166,150,145,295,50.8%,42m
3684,3,Nietzsche,3198,1554,76,70,146,52.1%,3m
3684,3,blinkSCV,3198,179,6,6,12,50.0%,43m
3684,3,xelex,3198,0,1,1,2,50.0%,6m
3688,3,[TwiLit]BlueJay,3197,712,26,25,51,51.0%,48m
3688,3,dracoKnights,3197,167,12,6,18,66.7%,37m
3688,3,[NLTN]Tarkor,3197,254,10,9,19,52.6%,2m
3688,3,[NSKL]SlashZero,3197,0,0,1,1,0.0%,2m
3692,3,[CHEE53]BitsPlease,3196,538,19,27,46,41.3%,48m
3692,3,iloveketamin,3196,232,7,5,12,58.3%,53m
3692,3,Draztik,3196,151,3,2,5,60.0%,43m
3692,3,[xVALx]LightbornSC,3196,0,1,0,1,100.0%,29m
3692,3,LONGBOW,3196,0,1,1,2,50.0%,13m
3692,2,[Pharoh]Alexander,3196,0,1,2,3,33.3%,54m
3698,3,Piglet,3195,854,41,42,83,49.4%,12m
3698,3,[hTx]microjackson,3195,902,34,32,66,51.5%,55m
3698,3,[ACSS]soymilk,3195,680,25,27,52,48.1%,43m
3698,3,[FkHost]Altectech,3195,559,21,21,42,50.0%,43m
3698,3,[123Shh]DougSluggins,3195,370,14,15,29,48.3%,42m
3698,3,Fiyero,3195,353,12,11,23,52.2%,38m
3698,3,[nubPWR]SlubberScrub,3195,168,8,5,13,61.5%,31m
3698,3,MoSaiC,3195,109,5,2,7,71.4%,42m
3698,3,[1234SC]BoopieBlast,3195,117,2,1,3,66.7%,13m
3698,2,BATTLEKING,3195,0,1,0,1,100.0%,33m
3698,3,Pekorekt,3195,0,0,2,2,0.0%,39m
3709,3,stupidanimal,3194,1625,164,140,304,53.9%,42m
3709,3,MoreLife,3194,1500,57,57,114,50.0%,33m
3709,3,[DRKESP]Bas,3194,118,4,5,9,44.4%,50m
3709,3,[WHSc]navenitram,3194,0,1,3,4,25.0%,32m
3709,3,[SBlock]SEBASTIAN,3194,0,0,1,1,0.0%,47m
3709,3,ForAiur,3194,0,0,2,2,0.0%,12m
3715,3,TheEnd,3193,612,21,36,57,36.8%,43m
3715,3,HelloWorld,3193,404,18,11,29,62.1%,53m
3715,3,KernelPanic,3193,341,12,8,20,60.0%,37m
3715,3,SCIIPlayer,3193,0,1,0,1,100.0%,29m
3719,3,[1LPD]Darkmerlinn,3192,990,39,38,77,50.6%,15m
3719,3,Csuth,3192,617,28,20,48,58.3%,4m
3719,3,KEN,3192,324,12,11,23,52.2%,44m
3719,3,inoscopedJFK,3192,186,6,20,26,23.1%,14m
3719,3,idkwhattoput,3192,30,1,1,2,50.0%,50m
3719,3,[Xpk]Jedi,3192,0,1,2,3,33.3%,33m
3719,1,[1Cat1]StingrayVoid,3192,0,0,1,1,0.0%,34m
3726,3,Weep,3191,1115,109,110,219,49.8%,36m
3726,3,UHC,3191,1608,97,97,194,50.0%,11m
3726,3,[NLTN]Innerself,3191,1338,83,84,167,49.7%,53m
3726,3,brenizer,3191,448,15,14,29,51.7%,40m
3726,3,[TØw]MrPig,3191,183,6,1,7,85.7%,29m
3726,1,Crillin,3191,0,3,5,8,37.5%,1h
3726,3,commanderh,3191,0,1,0,1,100.0%,11m
3733,3,TakTix,3190,807,89,77,166,53.6%,6m
3733,3,bobi,3190,0,3,2,5,60.0%,25m
3733,3,[69rs]Infintium,3190,94,3,3,6,50.0%,29m
3733,1,KingBonobo,3190,97,2,1,3,66.7%,1h
3733,3,[BoosS]OGTXIIIxBoSs,3190,26,2,3,5,40.0%,53m
3733,3,CHOEzilla,3190,30,2,3,5,40.0%,9m
3733,3,super,3190,93,2,4,6,33.3%,49m
3733,3,[Emb3rs]hellosugaree,3190,0,1,0,1,100.0%,12m
3733,3,WildCrane,3190,0,0,8,8,0.0%,9m
3742,3,pawel,3189,644,73,74,147,49.7%,12m
3742,3,Vernors,3189,550,20,21,41,48.8%,54m
3742,3,[mocat]Summer,3189,172,7,1,8,87.5%,41m
3742,3,malahaas,3189,214,7,12,19,36.8%,49m
3742,3,[CqAce]AceAceAce,3189,92,6,6,12,50.0%,10m
3742,3,[hX]Ano,3189,161,5,1,6,83.3%,42m
3742,3,[ETTyeh]ETT,3189,177,5,2,7,71.4%,45m
3742,3,TitaN,3189,147,5,7,12,41.7%,41m
3742,3,delay,3189,192,5,11,16,31.2%,53m
3742,3,dareOfficer,3189,0,2,2,4,50.0%,32m
3742,1,[xLgNx]MajinUub,3189,0,1,2,3,33.3%,12m
3753,3,Ryuichi,3188,821,50,5,55,90.9%,50m
3753,3,Quarantined,3188,792,41,36,77,53.2%,6m
3753,3,RustDemon,3188,815,34,25,59,57.6%,39m
3753,3,therialumon,3188,120,8,5,13,61.5%,48m
3753,3,ToastProxy,3188,148,5,6,11,45.5%,52m
3758,3,HaveFun,3187,1125,87,71,158,55.1%,47m
3758,3,natedog,3187,609,24,19,43,55.8%,48m
3758,3,bobby,3187,121,5,3,8,62.5%,48m
3758,3,CaQcMtlVSL,3187,120,4,5,9,44.4%,31m
3758,3,[SsaYnS]DarkPrelate,3187,90,3,6,9,33.3%,4m
3758,3,[lLiTl]Shadow,3187,0,1,0,1,100.0%,38m
3758,3,Bourne,3187,0,0,1,1,0.0%,29m
3758,3,[lLiTl]Abyssional,3187,0,0,1,1,0.0%,13m
3758,3,[CSUF]ImGMbtw,3187,0,0,1,1,0.0%,3m
3767,3,Story,3186,1611,99,103,202,49.0%,37m
3767,3,[xLgNx]SpaceMusic,3186,1463,61,58,119,51.3%,3m
3767,3,[CH3ES3]FluffyKitten,3186,1063,40,37,77,51.9%,42m
3767,3,Moist,3186,386,14,16,30,46.7%,36m
3767,3,IIIIIIIIIIII,3186,236,11,4,15,73.3%,6m
3767,3,DeusRekt,3186,238,10,8,18,55.6%,34m
3767,3,Wantoch,3186,208,8,8,16,50.0%,52m
3767,3,Fridge,3186,0,4,1,5,80.0%,39m
3767,3,AsH,3186,94,3,3,6,50.0%,49m
3767,3,[Dre4mT]trisomique,3186,0,1,1,2,50.0%,36m
3767,3,[LCE]Draco,3186,30,1,5,6,16.7%,3m
3778,3,Zee,3185,656,32,18,50,64.0%,55m
3778,2,PewPewBerry,3185,96,5,2,7,71.4%,52m
3778,2,Aphorism,3185,0,0,1,1,0.0%,1h
3778,3,Oldtimer,3185,0,0,1,1,0.0%,53m
3782,3,Abernasty,3184,998,272,270,542,50.2%,45m
3782,3,moist,3184,1659,165,147,312,52.9%,7m
3782,3,nightknight,3184,467,35,40,75,46.7%,44m
3782,2,[TGCrew]Sesso,3184,166,5,5,10,50.0%,43m
3782,3,[Nuken]Furiouskill,3184,121,2,2,4,50.0%,38m
3782,3,[tets]VichipomS,3184,0,1,0,1,100.0%,42m
3788,3,[Fir3s]HomeTownCrib,3183,342,13,6,19,68.4%,14m
3788,3,NKGabrielBR,3183,219,8,7,15,53.3%,43m
3788,3,Dopen,3183,217,7,2,9,77.8%,36m
3788,3,[RushA]SuperKingdom,3183,132,6,4,10,60.0%,48m
3788,3,[Lpaz]XaviiH,3183,0,3,2,5,60.0%,41m
3788,3,RayShades,3183,58,3,6,9,33.3%,8m
3788,3,[TGosuA]OtterFamily,3183,60,2,2,4,50.0%,6m
3788,3,Reapergv,3183,0,0,1,1,0.0%,2m
3788,3,[GR33D]ShoTwiRe,3183,0,0,2,2,0.0%,48m
3788,3,[RdLzrd]LindyHopper,3183,0,0,3,3,0.0%,3h
3798,3,[TgJc]GoldenPants,3182,1558,136,126,262,51.9%,42m
3798,3,[GOPERÚ]Edward,3182,1324,82,75,157,52.2%,52m
3798,3,[GGK]Pillowpants,3182,841,63,68,131,48.1%,48m
3798,3,Tettarus,3182,490,21,13,34,61.8%,2m
3798,3,[NLTN]Defeater,3182,534,20,17,37,54.1%,38m
3798,3,StarBaby,3182,350,13,12,25,52.0%,3m
3798,3,NAB,3182,208,11,8,19,57.9%,31m
3798,2,[αXLa]ZerGAcTiOn,3182,120,3,5,8,37.5%,1h
3798,3,Hendel,3182,0,0,1,1,0.0%,34m
3807,3,SilverFenyx,3181,1400,199,179,378,52.6%,9m
3807,3,Survival,3181,552,57,39,96,59.4%,46m
3807,3,Cast,3181,382,16,13,29,55.2%,39m
3807,3,[GRNSKN]SlubberBub,3181,308,11,8,19,57.9%,7m
3807,3,[OdC]Poseidón,3181,114,4,4,8,50.0%,42m
3807,3,[mAg]Orchestrate,3181,90,4,8,12,33.3%,50m
3807,1,AceKenneth,3181,96,2,1,3,66.7%,8m
3807,3,Brotoss,3181,0,1,0,1,100.0%,6m
3807,3,[BasicB]Grimsley,3181,94,1,1,2,50.0%,15m
3807,3,xXTryoNXx,3181,30,1,5,6,16.7%,34m
3817,3,Pinkerton,3180,1072,111,93,204,54.4%,29m
3817,3,Conotor,3180,374,14,16,30,46.7%,29m
3817,3,YeoSK,3180,303,13,4,17,76.5%,14m
3817,3,ProCreator,3180,142,6,7,13,46.2%,38m
3817,3,Lemoncup,3180,90,3,10,13,23.1%,32m
3817,1,[Scuba]Carouse,3180,0,0,2,2,0.0%,27m
3823,3,[αB]sctime,3179,716,26,30,56,46.4%,41m
3823,3,ZeroKProof,3179,210,6,4,10,60.0%,42m
3823,3,[GGBGll]SColddriver,3179,116,5,4,9,55.6%,49m
3823,3,SmoothSounds,3179,132,4,0,4,100.0%,11m
3823,3,Ozy,3179,32,2,0,2,100.0%,9m
3823,3,[DRKDNA]HeavenScream,3179,120,2,2,4,50.0%,15m
3823,2,[xXBGXx]Cairm,3179,0,1,0,1,100.0%,32m
3823,3,Corea,3179,0,1,0,1,100.0%,13m
3823,2,[1EOM]Nikolias,3179,0,0,1,1,0.0%,23m
3832,3,[xENTx]InfinitePest,3178,793,61,49,110,55.5%,53m
3832,3,[LGNxx]klanosk,3178,982,41,32,73,56.2%,37m
3832,3,[BIGSTD]Syphilis,3178,683,29,26,55,52.7%,32m
3832,3,CSantder,3178,366,18,6,24,75.0%,6m
3832,3,[ScSwrm]Robertoson,3178,464,17,19,36,47.2%,46m
3832,3,sprint,3178,334,15,12,27,55.6%,44m
3832,3,IIIIIIIIIIII,3178,177,6,2,8,75.0%,35m
3832,3,[GR33D]Ritho,3178,137,4,1,5,80.0%,48m
3832,3,Cowboy,3178,0,3,2,5,60.0%,1h
3832,3,Guile,3178,0,1,0,1,100.0%,38m
3832,2,[NTrio]Zandel,3178,0,1,0,1,100.0%,53m
3843,3,[EWAN]Source,3177,1090,52,30,82,63.4%,38m
3843,3,MrPink,3177,292,12,11,23,52.2%,53m
3843,3,tsing,3177,0,2,3,5,40.0%,1h
3843,2,ChugCafeBro,3177,0,1,0,1,100.0%,3h
3843,3,TWillG,3177,0,0,1,1,0.0%,6m
3843,2,TechGuyZach,3177,0,0,3,3,0.0%,34m
3849,3,[Tama]SCBattle,3176,405,19,13,32,59.4%,7m
3849,3,Moose,3176,350,13,12,25,52.0%,2m
3849,3,Octopus,3176,188,9,11,20,45.0%,44m
3849,3,MacroPhage,3176,118,5,3,8,62.5%,46m
3849,1,uhoh,3176,142,3,0,3,100.0%,1h
3849,3,[B2TF]Lox,3176,136,3,2,5,60.0%,2m
3849,3,haoxianghe,3176,30,1,3,4,25.0%,13m
3849,3,mikuccc,3176,0,0,1,1,0.0%,38m
3849,2,Pogo,3176,0,0,2,2,0.0%,3h
3858,3,CerealKiller,3175,1453,366,315,681,53.7%,35m
3858,3,IIIIIIIIIII,3175,802,39,21,60,65.0%,4m
3858,3,[BNKRZ]Jeffy,3175,863,36,30,66,54.5%,32m
3858,3,[MOAV]thec,3175,441,35,18,53,66.0%,46m
3858,3,Ogre,3175,865,35,30,65,53.8%,48m
3858,3,GrumpyPants,3175,352,16,9,25,64.0%,41m
3858,3,[nieBla]QQuisoteSan,3175,265,9,7,16,56.2%,42m
3858,3,Puddlez,3175,182,7,9,16,43.8%,1m
3858,3,[iMkS]Dnzo,3175,169,4,2,6,66.7%,6m
3858,3,EPICFPV,3175,58,3,5,8,37.5%,6m
3858,3,DUCKVILLELOL,3175,32,2,3,5,40.0%,3m
3858,3,[aaiBBQ]MrFluffles,3175,0,1,0,1,100.0%,34m
3858,3,Exsedol,3175,0,1,1,2,50.0%,32m
3871,3,SenShiNoYami,3174,1143,50,53,103,48.5%,9m
3871,3,Stardust,3174,392,18,9,27,66.7%,4m
3871,3,[Macac0]Mayhem,3174,461,16,18,34,47.1%,37m
3871,3,[No0Bs]FluffyZling,3174,314,16,19,35,45.7%,38m
3871,3,aners,3174,325,13,5,18,72.2%,14m
3871,3,Floopy,3174,94,2,0,2,100.0%,52m
3871,3,[cl0udM]AIphaStar,3174,90,2,0,2,100.0%,29m
3871,3,iLikeTurtles,3174,0,2,1,3,66.7%,7m
3871,3,[SlPt]Proston,3174,0,1,0,1,100.0%,35m
3880,3,Thanatos,3173,884,235,216,451,52.1%,32m
3880,3,TMoney,3173,1541,225,211,436,51.6%,13m
3880,3,DasNoob,3173,708,74,16,90,82.2%,53m
3880,3,[SCRAM]Fenjamin,3173,1160,50,44,94,53.2%,14m
3880,3,Envy,3173,950,40,35,75,53.3%,42m
3880,3,[LowIQ]Fergus,3173,906,31,42,73,42.5%,45m
3880,3,Chumbawamba,3173,664,23,29,52,44.2%,14m
3880,3,[ZrO2]Ryz,3173,374,14,14,28,50.0%,42m
3880,3,[HPing]Armadesdons,3173,237,11,6,17,64.7%,47m
3880,3,NumberSix,3173,116,5,4,9,55.6%,49m
3880,3,[VFC]Wicket,3173,95,1,1,2,50.0%,52m
3880,3,BadBoiKilla,3173,95,1,4,5,20.0%,54m
3892,3,[CCCT]RadarPrince,3172,617,23,23,46,50.0%,36m
3892,3,SadKingBilly,3172,191,9,6,15,60.0%,32m
3892,3,ggg,3172,150,8,2,10,80.0%,43m
3892,2,[Toast]Flightless,3172,141,5,4,9,55.6%,1h
3892,1,Ralicious,3172,119,3,0,3,100.0%,50m
3892,3,[FUUD]nonissue,3172,0,1,0,1,100.0%,2m
3892,3,IIInnovation,3172,0,1,3,4,25.0%,46m
3892,3,[UoM]SparkleHands,3172,0,0,1,1,0.0%,44m
3892,3,XXXXXXXXXX,3172,0,0,1,1,0.0%,29m
3892,3,iWind,3172,0,0,1,1,0.0%,49m
3892,3,[A5]JunLong,3172,0,0,2,2,0.0%,7m
3903,3,Titanium,3171,1307,52,49,101,51.5%,2m
3903,3,JeanPons,3171,719,34,20,54,63.0%,33m
3903,3,[TGosuB]BisDaQ,3171,583,23,16,39,59.0%,40m
3903,2,JoeyHands,3171,618,21,36,57,36.8%,45m
3903,3,OoO,3171,246,13,4,17,76.5%,2m
3903,3,MapleMan,3171,266,10,10,20,50.0%,53m
3903,3,Kipo,3171,172,6,11,17,35.3%,13m
3903,1,IIIIIIII,3171,46,4,5,9,44.4%,4m
3903,3,Lumon,3171,116,3,0,3,100.0%,11m
3903,3,eastcommon,3171,0,2,3,5,40.0%,29m
3903,1,Wildmilf,3171,0,1,2,3,33.3%,1h
3903,2,StevieJay,3171,46,1,3,4,25.0%,49m
3903,3,BattleCruser,3171,0,0,3,3,0.0%,50m
3916,3,TheFoils,3170,1558,268,266,534,50.2%,46m
3916,3,Angelmaker,3170,539,20,16,36,55.6%,52m
3916,3,Mike,3170,530,19,18,37,51.4%,3m
3916,3,[THYGAP]ClapinCheeks,3170,349,15,6,21,71.4%,30m
3916,3,Kinpatsu,3170,120,5,6,11,45.5%,6m
3916,3,IIIIIIIIIIII,3170,58,3,2,5,60.0%,32m
3916,3,[KAGUSA]WifePWNer,3170,94,1,1,2,50.0%,29m
3916,3,frosecold,3170,0,0,1,1,0.0%,39m
3916,3,Monkey,3170,0,0,1,1,0.0%,30m
3925,3,Panman,3169,571,34,22,56,60.7%,14m
3925,3,ButWait,3169,536,21,16,37,56.8%,7m
3925,3,SSJBVEGETA,3169,468,19,29,48,39.6%,47m
3925,3,BuffettGamer,3169,384,17,11,28,60.7%,6m
3925,2,llllllllllll,3169,158,6,12,18,33.3%,38m
3925,3,BGBOY,3169,0,1,0,1,100.0%,37m
3925,3,[SsaYnS]KoalaSoup,3169,0,0,6,6,0.0%,48m
3932,3,beh,3168,1064,120,121,241,49.8%,4m
3932,3,SCatological,3168,1398,114,111,225,50.7%,42m
3932,3,[SLAMT]ElecTrAsY,3168,914,37,29,66,56.1%,38m
3932,3,[PooCru]MrGusta,3168,684,30,20,50,60.0%,44m
3932,3,[INextI]MechaMarine,3168,462,24,6,30,80.0%,12m
3932,3,Tazerface,3168,544,24,14,38,63.2%,31m
3932,3,VoteByMail,3168,541,22,12,34,64.7%,11m
3932,2,BioHazardist,3168,287,12,8,20,60.0%,32m
3932,3,WiseKoala,3168,93,3,3,6,50.0%,15m
3932,1,Narkobear,3168,0,2,6,8,25.0%,35m
3932,3,[cl0udM]Scout,3168,0,1,3,4,25.0%,7m
3932,3,Maxaroni,3168,0,0,2,2,0.0%,13m
3944,3,PoKwan,3167,843,86,75,161,53.4%,51m
3944,3,Rolendubs,3167,1137,71,59,130,54.6%,37m
3944,3,Greed,3167,586,54,44,98,55.1%,42m
3944,3,[Jokn]Pippin,3167,229,8,3,11,72.7%,31m
3944,3,SlayersMMA,3167,133,7,2,9,77.8%,6m
3944,3,Yuzu,3167,93,2,0,2,100.0%,44m
3944,3,wellness,3167,0,1,2,3,33.3%,2m
3944,2,NotAGlassCan,3167,0,0,1,1,0.0%,39m
3952,3,GVIA,3166,1326,270,259,529,51.0%,35m
3952,3,[OnLIOn]Specter,3166,1578,59,57,116,50.9%,37m
3952,3,DankSaVaGe,3166,753,38,26,64,59.4%,40m
3952,3,[LimaSC]TBDayMasacre,3166,554,25,13,38,65.8%,12m
3952,3,DreWRanger,3166,460,19,17,36,52.8%,32m
3952,3,bluenoodle,3166,206,9,7,16,56.2%,13m
3952,3,HappyTenthSC,3166,207,7,3,10,70.0%,53m
3952,3,CWCHW,3166,200,6,5,11,54.5%,38m
3952,3,xOff,3166,93,4,2,6,66.7%,6m
3952,3,[LGNxx]Bellephron,3166,153,4,2,6,66.7%,9m
3952,3,sKout,3166,160,4,4,8,50.0%,31m
3952,3,Shroud,3166,118,3,1,4,75.0%,30m
3952,2,[DXPCA]Pogi,3166,117,3,5,8,37.5%,1h
3952,1,Doughboy,3166,96,2,4,6,33.3%,32m
3952,3,Pokketz,3166,30,1,3,4,25.0%,42m
3952,3,GRIMLOCK,3166,0,0,1,1,0.0%,44m
3968,3,[YD2K]MaSCoTZON,3165,1614,161,162,323,49.8%,5m
3968,3,ididntknow,3165,1096,73,66,139,52.5%,7m
3968,3,[BoAVN]tumulu,3165,392,14,15,29,48.3%,29m
3968,3,Groove,3165,212,6,4,10,60.0%,1m
3968,3,[ExcIgN]JoSS,3165,116,2,1,3,66.7%,42m
3968,2,Hurdsaucey,3165,0,0,1,1,0.0%,1h
3974,3,TinMan,3164,1085,146,128,274,53.3%,31m
3974,3,Curupira,3164,1551,120,94,214,56.1%,2m
3974,3,ljamericanpa,3164,939,52,17,69,75.4%,35m
3974,3,Slawsh,3164,496,44,33,77,57.1%,1m
3974,3,Bloodwolf,3164,1088,41,45,86,47.7%,37m
3974,3,[NPhasA]RoughNecks,3164,835,37,37,74,50.0%,42m
3974,3,[Cind3r]Amotokai,3164,459,18,11,29,62.1%,31m
3974,2,[RAXXED]mubeen,3164,251,10,6,16,62.5%,4m
3974,3,Goobster,3164,230,7,11,18,38.9%,9m
3974,3,Verjo,3164,138,4,1,5,80.0%,32m
3974,3,[Nuggin]PaZuzUu,3164,95,3,4,7,42.9%,47m
3974,3,bLiNd,3164,95,2,1,3,66.7%,15m
3974,3,tutter,3164,97,2,4,6,33.3%,1h
3974,3,VaeVictisSC,3164,0,1,0,1,100.0%,31m
3974,3,Narize,3164,94,1,1,2,50.0%,5m
3974,2,IIlIlIlIlIlI,3164,0,0,1,1,0.0%,3m
3974,3,Renegade,3164,0,0,4,4,0.0%,43m
3991,3,Popols,3163,719,43,28,71,60.6%,35m
3991,3,[D0J0]Trijiro,3163,629,29,14,43,67.4%,2m
3991,3,JackDaniel,3163,496,21,21,42,50.0%,39m
3991,3,CheeseComing,3163,217,21,25,46,45.7%,3m
3991,3,happystick,3163,346,15,5,20,75.0%,2m
3991,3,sUPerSMuRf,3163,265,10,4,14,71.4%,51m
3991,3,ObamaOnCRACK,3163,245,8,5,13,61.5%,34m
3991,3,[SABO]ChewChilla,3163,160,5,1,6,83.3%,32m
3991,3,xJugGernautx,3163,0,1,0,1,100.0%,12m
3991,3,[DMONlC]SonofMan,3163,0,1,0,1,100.0%,31m
3991,3,meca,3163,30,1,2,3,33.3%,39m
3991,1,Gilead,3163,97,1,2,3,33.3%,1h
3991,3,[Macac0]Armisael,3163,0,0,1,1,0.0%,45m
4004,3,Rayner,3162,1599,195,189,384,50.8%,1m
4004,3,PooHerder,3162,705,36,17,53,67.9%,35m
4004,3,Andys,3162,238,26,22,48,54.2%,30m
4004,3,philosophe,3162,348,13,22,35,37.1%,31m
4004,3,[YLG]NuTz,3162,283,11,4,15,73.3%,54m
4004,3,biiiiiiird,3162,318,11,12,23,47.8%,9m
4004,3,ZAW,3162,195,5,6,11,45.5%,44m
4004,3,GLiTCH,3162,0,1,0,1,100.0%,10m
4004,3,[DarkAG]AeroSoap,3162,92,1,1,2,50.0%,4m
4013,3,MungTheKing,3161,897,133,98,231,57.6%,11m
4013,3,chrisugru,3161,172,50,36,86,58.1%,29m
4013,3,[PTHero]Cybertron,3161,1046,45,33,78,57.7%,40m
4013,3,[DSGoku]ArgentSouL,3161,814,33,39,72,45.8%,8m
4013,3,Preeminent,3161,508,23,16,39,59.0%,43m
4013,2,[ESBU]Chaos,3161,121,6,2,8,75.0%,34m
4013,3,[DarkAG]HARAZZER,3161,144,5,9,14,35.7%,10m
4013,3,protoTYP,3161,115,3,0,3,100.0%,4m
4013,2,[xLgNx]walker,3161,44,2,1,3,66.7%,1h
4013,3,Dom,3161,0,1,0,1,100.0%,1h
4013,3,Sweet,3161,97,1,1,2,50.0%,39m
4024,3,[LNNS]adap,3160,852,61,45,106,57.5%,38m
4024,3,[ASC1]USSR,3160,770,29,31,60,48.3%,48m
4024,3,briznokovic,3160,648,23,28,51,45.1%,49m
4024,3,yleM,3160,431,21,11,32,65.6%,38m
4024,3,[LGRW]Stuke,3160,264,9,11,20,45.0%,46m
4024,3,darium,3160,132,4,1,5,80.0%,42m
4024,1,Tassadar,3160,0,4,1,5,80.0%,10m
4024,3,[VENSC2]Husky,3160,90,3,5,8,37.5%,35m
4024,1,KTP,3160,74,2,1,3,66.7%,52m
4024,3,[TYBROS]Yalmic,3160,0,1,0,1,100.0%,2m
4034,1,SwankyPants,3159,557,20,14,34,58.8%,53m
4034,3,tInyHMAN,3159,167,11,11,22,50.0%,9m
4034,3,Sonoso,3159,207,7,4,11,63.6%,41m
4034,1,Superman,3159,0,4,0,4,100.0%,2m
4034,1,Minarets,3159,0,0,1,1,0.0%,53m
4034,3,Ratar,3159,0,0,3,3,0.0%,35m
4034,3,[SoGo]ESKiMoJoE,3159,0,0,5,5,0.0%,10m
4041,3,Sklar,3158,1506,177,176,353,50.1%,29m
4041,3,HiggsBoson,3158,1439,168,169,337,49.9%,49m
4041,1,ZoNo,3158,1652,108,102,210,51.4%,13m
4041,3,[VH]TheLibrarian,3158,1227,65,54,119,54.6%,11m
4041,3,[B0NER]UltraDeath,3158,606,26,23,49,53.1%,11m
4041,2,JKNY,3158,245,13,9,22,59.1%,32m
4041,1,[GOPERÚ]Force,3158,86,3,0,3,100.0%,7m
4041,1,NowPlaySmurf,3158,42,3,2,5,60.0%,44m
4041,3,[XTGZ]XtremeNubi,3158,62,3,9,12,25.0%,9m
4041,1,[ØFoxF2]DohKo,3158,44,2,0,2,100.0%,45m
4041,3,[Alphaa]DBOSS,3158,0,2,1,3,66.7%,30m
4041,3,CatrionaGray,3158,0,1,0,1,100.0%,37m
4041,1,IIIIIIIIIIII,3158,0,1,1,2,50.0%,1h
4041,3,teioh,3158,30,1,3,4,25.0%,6m
4041,3,[lendas]octavio,3158,0,1,3,4,25.0%,8m
4041,1,Darknight,3158,0,0,1,1,0.0%,52m
4057,3,HornySCV,3157,1573,167,167,334,50.0%,54m
4057,3,[GOPERÚ]iProblem,3157,422,15,13,28,53.6%,11m
4057,3,[B1GDic]MajorLazer,3157,60,3,5,8,37.5%,36m
4057,3,largeDog,3157,120,3,6,9,33.3%,31m
4057,3,dio,3157,0,1,1,2,50.0%,10m
4057,1,Bulma,3157,0,1,5,6,16.7%,40m
4057,3,TightGarbage,3157,0,0,2,2,0.0%,35m
4064,3,SmurfDaddy,3156,428,54,44,98,55.1%,6m
4064,3,NoRelax,3156,762,30,26,56,53.6%,7m
4064,3,Malison,3156,262,10,7,17,58.8%,31m
4064,1,TrixRivKidZ,3156,44,1,2,3,33.3%,51m
4068,3,[DNKCFT]HoRNET,3155,475,107,102,209,51.2%,46m
4068,3,Tbag,3155,1304,94,49,143,65.7%,32m
4068,1,[DarkAG]MinajestY,3155,539,21,8,29,72.4%,3m
4068,3,[N0FKz]GhostOp,3155,126,6,3,9,66.7%,44m
4068,3,ttime,3155,30,5,3,8,62.5%,42m
4068,3,Elfleischo,3155,0,3,0,3,100.0%,1h
4068,1,CrabPulsar,3155,0,2,3,5,40.0%,49m
4068,1,[SuperZ]JoHidding,3155,42,1,1,2,50.0%,52m
4076,3,[Ash3s]OMNIPOTENT,3154,1560,194,165,359,54.0%,6m
4076,3,Erowid,3154,907,39,28,67,58.2%,2m
4076,3,Umnums,3154,520,19,19,38,50.0%,38m
4076,3,ethos,3154,170,18,15,33,54.5%,29m
4076,3,SHlTSHOW,3154,192,6,5,11,54.5%,32m
4076,3,omgPVO,3154,0,4,1,5,80.0%,1h
4076,1,CjsArcher,3154,0,2,0,2,100.0%,6m
4076,3,Kaboel,3154,58,2,4,6,33.3%,42m
4076,3,[REPORT]ProTerZer,3154,44,1,2,3,33.3%,1h
4076,3,[YSHI]Aibi,3154,0,0,4,4,0.0%,35m
4086,3,NotVaush,3153,511,22,16,38,57.9%,2m
4086,3,[QTp2T]ARc,3153,335,14,7,21,66.7%,2m
4086,3,[Random]helianorus,3153,121,5,2,7,71.4%,1h
4086,3,LiNuXxX,3153,122,4,8,12,33.3%,6m
4086,3,Fonjeezy,3153,120,2,3,5,40.0%,3m
4086,2,[αB]CaptainClub,3153,0,1,0,1,100.0%,49m
4086,3,Durotar,3153,0,0,2,2,0.0%,38m
4093,2,[TWAS]ChopSuey,3152,142,4,0,4,100.0%,34m
4093,3,[iB1]JavierMontes,3152,0,2,4,6,33.3%,31m
4095,3,whisky,3151,1654,403,397,800,50.4%,29m
4095,3,PonySoprano,3151,1220,52,57,109,47.7%,12m
4095,1,llllllllllll,3151,842,49,78,127,38.6%,54m
4095,1,DarthMono,3151,120,3,4,7,42.9%,7m
4095,1,QuiDx,3151,151,3,5,8,37.5%,14m
4095,1,[ExcIgN]Lerius,3151,0,1,0,1,100.0%,8m
4095,3,Probiotic,3151,0,1,1,2,50.0%,4m
4095,3,[BfLaD]DensitY,3151,0,0,1,1,0.0%,4m
4095,1,Choukaki,3151,0,0,1,1,0.0%,2m
4095,1,Jebediah,3151,0,0,1,1,0.0%,13m
4105,3,Wehrmacht,3150,432,18,16,34,52.9%,11m
4105,3,[2Hott]Daddy,3150,133,5,5,10,50.0%,8m
4105,3,Nathan,3150,92,4,7,11,36.4%,46m
4105,1,SLOSHED,3150,0,3,2,5,60.0%,42m
4105,3,TMcorvo,3150,58,3,6,9,33.3%,39m
4105,1,[LMBD]Lambda,3150,34,2,0,2,100.0%,48m
4111,3,bashusr,3149,1356,66,76,142,46.5%,15m
4111,2,[Exist]DroneRush,3149,142,6,3,9,66.7%,1h
4111,3,Benzo,3149,207,6,4,10,60.0%,31m
4111,3,IcomefromEU,3149,138,5,5,10,50.0%,11m
4111,1,[QTp2T]GGAllin,3149,82,3,0,3,100.0%,40m
4116,3,Snoopy,3148,1577,200,197,397,50.4%,52m
4116,3,ABIMAEL,3148,131,4,2,6,66.7%,32m
4116,3,[waRp1]LacraMSI,3148,116,4,9,13,30.8%,31m
4116,3,[lHMNGl]SCmenace,3148,94,2,1,3,66.7%,46m
4120,3,[11001]Yggdrasil,3147,830,54,50,104,51.9%,47m
4120,3,Zeratul,3147,357,14,10,24,58.3%,11m
4120,3,Sillyfoxy,3147,305,11,14,25,44.0%,13m
4120,1,Nagibator,3147,114,5,2,7,71.4%,42m
4120,1,Luru,3147,80,3,0,3,100.0%,7m
4120,3,WaquaPictdom,3147,114,3,1,4,75.0%,42m
4120,1,AuroRa,3147,40,1,2,3,33.3%,31m
4120,3,[BUTIFL]Daoh,3147,0,0,2,2,0.0%,53m
4128,3,TBZ,3146,898,48,41,89,53.9%,10m
4128,3,[FTBALL]PapaBigBelly,3146,374,14,17,31,45.2%,7m
4128,1,[urEZaF]Nerd,3146,208,8,4,12,66.7%,1h
4128,3,Irootoko,3146,230,8,10,18,44.4%,5m
4128,3,steakncheese,3146,30,4,4,8,50.0%,5m
4128,3,[MooLA]MaGic,3146,90,3,10,13,23.1%,11m
4128,3,anger,3146,98,3,13,16,18.8%,35m
4135,1,[AbcCo]FleshMan,3145,1533,69,56,125,55.2%,12m
4135,3,[HotCop]Paralysis,3145,120,5,8,13,38.5%,43m
4135,1,Scv,3145,0,4,1,5,80.0%,38m
4135,3,Jass,3145,92,3,7,10,30.0%,48m
4135,1,[AXSSY]Wayward,3145,0,1,0,1,100.0%,41m
4135,1,[RUSHya]Ares,3145,0,1,0,1,100.0%,5m
4135,2,JeanMic,3145,40,1,2,3,33.3%,9m
4142,3,Seveso,3144,585,25,26,51,49.0%,30m
4142,1,bbcparty,3144,210,8,5,13,61.5%,55m
4142,1,Keir,3144,38,4,2,6,66.7%,40m
4142,1,Brr,3144,40,2,0,2,100.0%,35m
4142,3,GameStrength,3144,0,0,3,3,0.0%,13m
4147,3,Lively,3143,778,38,25,63,60.3%,48m
4147,3,SodiumBarcod,3143,272,10,13,23,43.5%,31m
4147,3,XXXBlumpkin,3143,178,6,8,14,42.9%,2m
4147,3,[2qt]caRefulSCV,3143,0,4,3,7,57.1%,4m
4147,1,Madhin,3143,142,3,0,3,100.0%,41m
4152,1,[Hilas2]manoyyy,3142,816,27,22,49,55.1%,50m
4152,1,[DETER]Ohbey,3142,502,23,0,23,100.0%,36m
4152,3,Vex,3142,276,18,28,46,39.1%,54m
4152,3,[ValidG]oldparr,3142,444,17,13,30,56.7%,35m
4152,3,Offer,3142,262,11,8,19,57.9%,9m
4152,3,[NSTYBO]TurdCutter,3142,121,6,1,7,85.7%,42m
4152,1,[QTclub]NightCaller,3142,176,6,2,8,75.0%,5m
4152,3,IxooxI,3142,110,5,4,9,55.6%,3m
4152,3,[KiMBR]Pedras,3142,143,3,4,7,42.9%,38m
4152,1,[VH]Rollo,3142,48,2,8,10,20.0%,22m
4152,2,[LGNxxx]rendevie,3142,0,0,1,1,0.0%,15m
4163,3,Klied,3141,896,136,125,261,52.1%,7m
4163,3,minimin,3141,1403,65,64,129,50.4%,30m
4163,3,Bingbing,3141,103,9,16,25,36.0%,53m
4163,3,[GangR]MattMac,3141,270,8,9,17,47.1%,9m
4163,3,WizarD,3141,122,6,10,16,37.5%,14m
4163,1,jcrellik,3141,0,1,0,1,100.0%,50m
4169,3,[DEFUP]Aummadour,3140,1549,70,67,137,51.1%,7m
4169,3,americandrea,3140,318,63,61,124,50.8%,13m
4169,3,Ludo,3140,170,6,10,16,37.5%,46m
4169,3,[TimTom]Zzoram,3140,60,2,4,6,33.3%,11m
4169,3,bigbertha,3140,47,2,5,7,28.6%,50m
4169,3,[LGNxx]Outlawz,3140,118,2,11,13,15.4%,38m
4169,2,TitoPayToo,3140,0,0,1,1,0.0%,9m
4169,3,Garett,3140,0,0,8,8,0.0%,32m
4177,3,LEET,3139,1250,176,177,353,49.9%,4m
4177,3,Supi,3139,1626,90,89,179,50.3%,35m
4177,3,HughMungus,3139,719,28,28,56,50.0%,3m
4177,3,Rokman,3139,428,16,11,27,59.3%,48m
4177,3,mingedog,3139,30,5,3,8,62.5%,32m
4177,1,JeffB,3139,0,4,1,5,80.0%,10m
4177,2,[FxA]PasQ,3139,0,0,1,1,0.0%,1h
4177,3,ArchSeth,3139,0,0,3,3,0.0%,32m
4185,3,LIlIIiil,3138,1556,78,67,145,53.8%,47m
4185,3,[ZTempz]Taucer,3138,794,31,26,57,54.4%,30m
4185,3,Santana,3138,478,21,8,29,72.4%,13m
4185,3,[13Pool]shogi,3138,508,17,29,46,37.0%,51m
4185,3,Dancore,3138,0,3,2,5,60.0%,46m
4190,1,[MATTO]Milquetoast,3137,620,18,13,31,58.1%,13m
4190,3,Phantera,3137,356,13,11,24,54.2%,8m
4190,3,DeToNaToR,3137,198,10,5,15,66.7%,13m
4190,3,[ZGZGZG]ultralisc,3137,194,6,5,11,54.5%,7m
4190,1,ricos,3137,0,0,1,1,0.0%,55m
4190,1,Orgetorix,3137,0,0,2,2,0.0%,52m
4190,3,MGUH,3137,0,0,2,2,0.0%,15m
4197,3,[JAPON]Heisenzerg,3136,1068,62,54,116,53.4%,35m
4197,3,Kronk,3136,440,38,41,79,48.1%,12m
4197,1,freya,3136,74,3,0,3,100.0%,2m
4200,1,[WiDoZ]DutMoney,3135,1244,47,45,92,51.1%,55m
4200,3,[GiLLs]FDSBosox,3135,490,20,19,39,51.3%,12m
4200,3,bamboosheet,3135,174,7,8,15,46.7%,7m
4200,3,Screwface,3135,226,6,7,13,46.2%,46m
4200,2,EzMelon,3135,0,4,2,6,66.7%,1h
4200,1,Blackheart,3135,84,3,1,4,75.0%,32m
4200,1,[Fever]Carpe,3135,0,0,1,1,0.0%,42m
4200,1,BeeBuggin,3135,0,0,2,2,0.0%,55m
4208,3,[Ntshls]Kramer,3134,1191,137,123,260,52.7%,43m
4208,1,[BoAVN]ProPK,3134,685,35,23,58,60.3%,14m
4208,3,scumbag,3134,640,24,22,46,52.2%,42m
4208,1,Metrobius,3134,350,18,12,30,60.0%,12m
4208,1,Chimera,3134,116,6,2,8,75.0%,2m
4208,3,deVas,3134,94,3,10,13,23.1%,35m
4208,1,[TAW]Nightowl,3134,0,1,0,1,100.0%,51m
4208,2,[DUNGR]FTL,3134,46,1,8,9,11.1%,37m
4216,3,Bertxi,3133,1460,186,188,374,49.7%,15m
4216,3,[LgnTDS]Locke,3133,1544,150,147,297,50.5%,37m
4216,3,DrRad,3133,471,19,19,38,50.0%,29m
4216,3,[Shota]Lakshmi,3133,144,6,6,12,50.0%,12m
4216,3,[MRCPLX]DeXTer,3133,30,2,2,4,50.0%,30m
4221,3,KarmaPolice,3132,977,54,59,113,47.8%,34m
4221,1,Janice,3132,942,38,30,68,55.9%,50m
4221,1,Fox,3132,534,17,9,26,65.4%,56m
4221,3,Metradime,3132,331,14,13,27,51.9%,32m
4221,1,DrippingSkin,3132,314,9,6,15,60.0%,7m
4221,1,[Mitsu]TheMule,3132,0,3,2,5,60.0%,48m
4221,1,[VFam2]Kaladin,3132,0,0,2,2,0.0%,32m
4221,3,[BSOs]Rchin,3132,0,0,4,4,0.0%,3h
4229,3,AntiCamper,3131,1346,63,54,117,53.8%,6m
4229,1,Spriz,3131,801,29,21,50,58.0%,43m
4229,1,[DASUL]Durden,3131,486,15,9,24,62.5%,10m
4229,1,[Moo0]Smuckers,3131,296,9,5,14,64.3%,55m
4229,3,Candalistic,3131,166,7,1,8,87.5%,8m
4229,3,sUnPoWeR,3131,109,7,2,9,77.8%,39m
4229,3,Thrako,3131,0,4,1,5,80.0%,21m
4229,1,Slid,3131,0,1,3,4,25.0%,7m
4229,3,[VENSC2]Pyro,3131,30,1,4,5,20.0%,42m
4238,1,ButtSlayer,3130,701,21,17,38,55.3%,42m
4238,3,YUCK,3130,245,10,9,19,52.6%,48m
4238,3,Stein,3130,120,5,6,11,45.5%,5m
4238,1,tkmad,3130,0,1,0,1,100.0%,44m
4238,3,Kowy,3130,0,1,2,3,33.3%,42m
4243,1,[TWNNO1]Master,3129,1684,60,59,119,50.4%,52m
4243,3,FUTECH,3129,309,10,10,20,50.0%,13m
4243,2,Heliogabal,3129,144,6,3,9,66.7%,14m
4243,3,PnP,3129,177,5,7,12,41.7%,13m
4243,1,dapatywagon,3129,0,4,1,5,80.0%,56m
4243,1,[JB]modelo,3129,113,2,6,8,25.0%,38m
4243,1,[DDragB]Ceeeeeeee,3129,0,0,1,1,0.0%,50m
4250,1,MintyFresh,3128,523,19,9,28,67.9%,14m
4250,2,Gaijin,3128,96,4,3,7,57.1%,3h
4250,3,showmax,3128,0,2,1,3,66.7%,3h
4250,1,WikiWorm,3128,42,2,5,7,28.6%,30m
4250,1,[hTx]EyesRSquared,3128,0,0,2,2,0.0%,54m
4255,3,[GAN]hellomyson,3127,346,13,10,23,56.5%,3m
4255,3,[REPORT]Arto,3127,114,5,6,11,45.5%,53m
4255,3,OKOKOK,3127,58,3,8,11,27.3%,45m
4255,1,RailBunnysMA,3127,40,2,0,2,100.0%,54m
4255,2,Waffles,3127,0,0,1,1,0.0%,1h
4260,3,GeorgeSoros,3126,1021,48,43,91,52.7%,47m
4260,1,add,3126,1052,42,38,80,52.5%,49m
4260,3,Montana,3126,646,21,33,54,38.9%,42m
4260,1,Goodie,3126,340,11,8,19,57.9%,9m
4260,3,[iMpB]Armarus,3126,190,9,5,14,64.3%,50m
4260,3,Rave,3126,146,6,11,17,35.3%,46m
4260,1,EsoOmni,3126,162,5,3,8,62.5%,41m
4260,1,XburriitoX,3126,132,5,3,8,62.5%,10m
4260,1,MethodMan,3126,122,2,2,4,50.0%,49m
4260,1,FromParis,3126,0,0,2,2,0.0%,1h
4270,1,GimmeSumMore,3125,410,12,7,19,63.2%,44m
4270,2,[BCIub]Vision,3125,282,10,13,23,43.5%,43m
4270,3,[Xpk]Corsario,3125,154,6,7,13,46.2%,3m
4270,1,[syrup]xantan,3125,192,5,3,8,62.5%,49m
4270,3,Flurry,3125,0,3,2,5,60.0%,19m
4270,1,ClpHewitt,3125,0,0,1,1,0.0%,7m
4276,1,[IRL]Cooler,3124,503,16,14,30,53.3%,30m
4276,1,SadCream,3124,508,15,11,26,57.7%,45m
4276,3,[Bobjr]bobjr,3124,288,13,9,22,59.1%,50m
4276,1,Typhooey,3124,154,7,5,12,58.3%,53m
4276,3,[ScSwrm]Aldric,3124,182,5,7,12,41.7%,32m
4276,1,[GT3]Sonto,3124,42,2,0,2,100.0%,51m
4276,2,ytrewq,3124,88,2,4,6,33.3%,30m
4276,2,[GGMESP]AberamaGold,3124,0,1,5,6,16.7%,1h
4276,1,[SIClan]bushido,3124,73,0,2,2,0.0%,2m
4285,3,Final,3123,229,43,33,76,56.6%,49m
4285,3,Barett,3123,472,15,25,40,37.5%,46m
4285,1,MoSalah,3123,205,8,5,13,61.5%,60m
4285,1,SilentSword,3123,292,8,11,19,42.1%,38m
4285,1,NoeL,3123,276,7,2,9,77.8%,52m
4285,3,[GEEKED]MicroPhelps,3123,155,5,3,8,62.5%,1h
4285,3,[LWBB]ilDuce,3123,0,4,1,5,80.0%,1h
4285,3,[RH]DrG,3123,60,3,10,13,23.1%,11m
4285,3,ElemenT,3123,0,2,4,6,33.3%,39m
4294,3,Uberpsycho,3122,679,43,49,92,46.7%,50m
4294,3,[TACOST]ZERO,3122,499,18,18,36,50.0%,7m
4294,1,[BNITOS]Adrianks,3122,411,11,14,25,44.0%,55m
4294,2,Beluga,3122,266,9,7,16,56.2%,15m
4294,2,TylerDurden,3122,139,6,3,9,66.7%,21m
4294,1,GetRektNip,3122,116,3,3,6,50.0%,51m
4300,3,[xLgNx]IamGroot,3121,233,48,57,105,45.7%,12m
4300,3,BloodyRabbit,3121,232,13,9,22,59.1%,42m
4300,3,[AOTB]XxEliTeCLoWn,3121,340,13,14,27,48.1%,13m
4300,3,AquaBadger,3121,146,10,7,17,58.8%,38m
4300,1,ZoO,3121,115,6,2,8,75.0%,2m
4300,3,[AUSC]Darkboi,3121,195,5,8,13,38.5%,7m
4300,3,LiquidFire,3121,145,4,4,8,50.0%,13m
4300,3,Peugeot,3121,0,1,0,1,100.0%,39m
4308,3,Ekanr,3120,1010,191,186,377,50.7%,13m
4308,3,DefundCops,3120,1507,69,48,117,59.0%,35m
4308,3,[Hesa]flanaganapus,3120,822,31,30,61,50.8%,50m
4308,3,[Valid]Invalid,3120,402,17,9,26,65.4%,3m
4308,2,HolyOrder,3120,0,5,1,6,83.3%,16m
4308,2,[UpeV]Mugiwara,3120,0,1,1,2,50.0%,1h
4308,2,Frankenstein,3120,0,0,1,1,0.0%,5m
4315,3,JotaDe,3119,282,9,11,20,45.0%,41m
4315,2,GhTakahashi,3119,227,8,13,21,38.1%,47m
4315,1,Wildwolf,3119,188,6,4,10,60.0%,4m
4315,3,[Broxit]SeansFriend,3119,38,3,2,5,60.0%,29m
4315,1,Cheesehelmet,3119,0,1,3,4,25.0%,28m
4315,1,letztewelt,3119,0,0,1,1,0.0%,49m
4315,1,polololo,3119,0,0,1,1,0.0%,56m
4322,3,[DRGC]RedPaulf,3118,1167,132,124,256,51.6%,35m
4322,3,Tyrano,3118,1102,50,54,104,48.1%,13m
4322,1,BADD,3118,914,35,22,57,61.4%,14m
4322,3,ShardZ,3118,616,23,26,49,46.9%,35m
4322,3,[KJDW]tron,3118,234,8,6,14,57.1%,49m
4322,1,[rageD]Deadpotato,3118,170,7,4,11,63.6%,42m
4322,3,[iDrunk]Artanis,3118,204,7,8,15,46.7%,38m
4322,1,lenor,3118,104,6,1,7,85.7%,32m
4322,1,speedghOst,3118,143,5,7,12,41.7%,1h
4322,3,David,3118,0,4,2,6,66.7%,45m
4322,1,BluRay,3118,0,3,2,5,60.0%,40m
4322,1,Random,3118,0,0,1,1,0.0%,2m
4322,3,[MCRmy]CutMESilly,3118,0,0,4,4,0.0%,32m
4335,3,Mousline,3117,1565,140,140,280,50.0%,49m
4335,3,ETAWhenever,3117,1213,127,136,263,48.3%,49m
4335,3,ICEMAN,3117,893,103,106,209,49.3%,46m
4335,3,Supermarmota,3117,1402,69,75,144,47.9%,43m
4335,1,CrediNation,3117,1094,43,36,79,54.4%,4m
4335,3,VengefulLima,3117,295,32,20,52,61.5%,42m
4335,3,HydraPwniK,3117,542,24,21,45,53.3%,53m
4335,1,iWon,3117,76,4,4,8,50.0%,49m
4335,3,[ZTemp]DujekOnearm,3117,0,1,1,2,50.0%,20m
4344,3,[CTLV]Campy,3116,1573,531,515,1046,50.8%,32m
4344,1,sanguine,3116,482,13,14,27,48.1%,47m
4344,1,[juggr]PinkFloyd,3116,84,2,3,5,40.0%,30m
4347,3,[SurfC]Kaizerg,3115,640,23,26,49,46.9%,42m
4347,3,SKT,3115,184,11,12,23,47.8%,44m
4347,3,Plott,3115,265,9,11,20,45.0%,33m
4347,3,predoqldke,3115,121,5,2,7,71.4%,1h
4347,1,SkynetIII,3115,80,4,5,9,44.4%,40m
4347,3,[8iSh]TheKazootie,3115,122,2,3,5,40.0%,13m
4347,3,BENTANCUR,3115,121,2,3,5,40.0%,1h
4347,1,Mapaf,3115,0,2,3,5,40.0%,2m
4347,1,nuttysquirel,3115,0,0,2,2,0.0%,6m
4356,3,[Random]DumbMother,3114,618,79,95,174,45.4%,54m
4356,1,[OndaVT]Jorm,3114,226,9,7,16,56.2%,16m
4356,1,[kisay]Relover,3114,259,6,7,13,46.2%,32m
4356,3,Timo,3114,135,5,3,8,62.5%,29m
4356,3,iiiiiiiiiiii,3114,60,4,7,11,36.4%,31m
4356,1,jerry,3114,40,1,2,3,33.3%,8m
4362,3,[HCAZ]HCAZ,3113,1386,113,114,227,49.8%,49m
4362,1,Mindtaker,3113,794,54,43,97,55.7%,42m
4362,3,Vazilard,3113,286,16,15,31,51.6%,54m
4362,1,Castalot,3113,167,4,3,7,57.1%,54m
4362,3,Legion,3113,127,3,4,7,42.9%,41m
4367,3,Labyrinth,3112,1236,49,51,100,49.0%,48m
4367,1,[SsaYnS]Kujuddify,3112,577,37,31,68,54.4%,46m
4367,3,[Kusshh]Chiu,3112,307,29,27,56,51.8%,34m
4367,3,MotleyCow,3112,558,23,15,38,60.5%,31m
4367,3,Rush,3112,62,6,5,11,54.5%,48m
4367,1,mrapple,3112,60,3,0,3,100.0%,45m
4367,1,Hector,3112,44,1,1,2,50.0%,5m
4374,3,Deasy,3111,1548,94,78,172,54.7%,33m
4374,3,matcha,3111,476,39,34,73,53.4%,13m
4374,3,NeutrinO,3111,582,27,17,44,61.4%,8m
4374,3,[ZTemp]ShadowZero,3111,258,9,7,16,56.2%,2m
4374,1,IIIIIIIIIIII,3111,0,1,0,1,100.0%,2m
4379,3,Arno,3110,188,9,6,15,60.0%,10m
4379,2,WiDoWMaKeR,3110,46,5,2,7,71.4%,1h
4379,1,Willy,3110,89,4,2,6,66.7%,50m
4379,2,janosabeee,3110,0,0,1,1,0.0%,1h
4383,3,Squiggz,3109,1604,313,314,627,49.9%,31m
4383,3,Stardu,3109,800,98,71,169,58.0%,31m
4383,3,Stu,3109,1483,88,87,175,50.3%,30m
4383,3,Goliath,3109,660,22,38,60,36.7%,7m
4383,1,WildApache,3109,258,15,3,18,83.3%,38m
4383,3,Pacman,3109,207,9,10,19,47.4%,29m
4383,3,SatanClaws,3109,0,5,0,5,100.0%,56m
4383,3,GoFMidoNA,3109,0,3,2,5,60.0%,1h
4383,1,[CGIW]xXDaganonXx,3109,0,2,3,5,40.0%,53m
4383,3,undertone,3109,0,2,4,6,33.3%,48m
4383,2,Spirithound,3109,0,0,1,1,0.0%,35m
4383,1,[ISDP]Taco,3109,0,0,2,2,0.0%,6m
4395,3,[LARM]Beregonds,3108,652,76,57,133,57.1%,54m
4395,1,KTrooper,3108,1170,48,31,79,60.8%,33m
4395,1,[Gomz]Zero,3108,656,24,19,43,55.8%,31m
4395,1,CoinFlip,3108,105,5,2,7,71.4%,38m
4395,1,Adjudicator,3108,35,1,2,3,33.3%,43m
4395,1,FredB,3108,0,0,1,1,0.0%,55m
4401,3,sundaybrunch,3107,1378,50,55,105,47.6%,4m
4401,3,DAW,3107,834,47,54,101,46.5%,32m
4401,1,QuietMind,3107,120,5,3,8,62.5%,56m
4401,3,Thorogmar,3107,97,4,2,6,66.7%,13m
4401,3,BanglaDezu,3107,0,1,0,1,100.0%,56m
4406,3,Swayze,3106,1143,53,44,97,54.6%,51m
4406,1,SwissCheese,3106,984,31,30,61,50.8%,46m
4406,1,MaruTheBest,3106,0,1,0,1,100.0%,42m
4406,1,Raaaawr,3106,0,0,1,1,0.0%,2m
4406,2,Kat,3106,0,0,1,1,0.0%,3m
4406,3,[VPB]FalconX,3106,0,0,2,2,0.0%,12m
4412,3,Samaranth,3105,1565,104,94,198,52.5%,48m
4412,3,Italian,3105,1569,102,88,190,53.7%,38m
4412,1,KirihaKaisei,3105,400,13,9,22,59.1%,34m
4412,1,[NPhase]RektTrashEZ,3105,84,2,1,3,66.7%,53m
4412,1,[SigmaV]johnnyvowels,3105,0,1,1,2,50.0%,10m
4412,1,[SRVTS]Claudinhodf,3105,0,0,1,1,0.0%,48m
4412,2,Dadzarg,3105,0,0,1,1,0.0%,3h
4412,1,[MSCE]MADCERBERO,3105,0,0,1,1,0.0%,8m
4420,3,[TgAg]Dynamic,3104,1023,46,41,87,52.9%,37m
4420,1,Salas,3104,254,11,11,22,50.0%,2m
4420,3,Gpremier,3104,202,8,11,19,42.1%,30m
4420,1,ScIIMobile,3104,42,2,0,2,100.0%,42m
4420,3,Gimmicking,3104,121,2,1,3,66.7%,48m
4420,3,[dMdC]SuperHella,3104,0,0,5,5,0.0%,5m
4426,3,Marinator,3103,878,37,34,71,52.1%,4m
4426,1,[cluez]AbGolfing,3103,941,36,24,60,60.0%,31m
4426,2,DreamState,3103,0,0,1,1,0.0%,52m
4426,1,MaterLord,3103,0,0,2,2,0.0%,50m
4426,3,NibbleZits,3103,0,0,5,5,0.0%,8m
4431,3,Qikaiyao,3102,925,65,80,145,44.8%,31m
4431,3,[Lp]CallaoLacra,3102,244,15,14,29,51.7%,15m
4431,1,Eddie,3102,361,11,4,15,73.3%,53m
4431,3,Bjornbrandr,3102,224,10,8,18,55.6%,14m
4431,1,[Rustla]iDrone,3102,228,7,4,11,63.6%,10m
4431,3,[GGBr0]kuce,3102,158,6,14,20,30.0%,35m
4431,1,speedyss,3102,156,5,3,8,62.5%,52m
4431,2,CatSmokesPot,3102,94,5,3,8,62.5%,1h
4439,3,swish,3101,1395,112,103,215,52.1%,4m
4439,1,Nikky,3101,283,11,0,11,100.0%,51m
4439,3,alberttttttt,3101,151,4,4,8,50.0%,32m
4439,1,TBoner,3101,0,1,1,2,50.0%,4m
4439,3,KHALTHEBOLD,3101,0,1,5,6,16.7%,1h
4439,1,[MeowZe]Kyzzer,3101,0,0,1,1,0.0%,8m
4439,1,Imperium,3101,0,0,2,2,0.0%,42m
4446,3,[LPZR]DangerDog,3100,1316,90,92,182,49.5%,7m
4446,3,Aiden,3100,897,36,34,70,51.4%,34m
4446,1,ShipWreack,3100,754,28,19,47,59.6%,34m
4446,3,Lego,3100,274,13,13,26,50.0%,42m
4446,1,Skywalker,3100,124,3,1,4,75.0%,44m
4446,1,Roakin,3100,0,3,2,5,60.0%,43m
4446,3,BlackStar,3100,30,3,5,8,37.5%,48m
4453,3,Inneluki,3099,762,55,47,102,53.9%,39m
4453,3,xlx,3099,594,21,27,48,43.8%,49m
4453,2,mubeen,3099,339,13,10,23,56.5%,46m
4453,3,[HDL]Raklann,3099,300,12,2,14,85.7%,38m
4453,3,pixel,3099,118,3,6,9,33.3%,45m
4458,3,Iseefor,3098,1086,64,53,117,54.7%,31m
4458,3,[GT2020]Estiven,3098,603,47,41,88,53.4%,7m
4458,3,Cong,3098,348,13,14,27,48.1%,36m
4458,3,iGGnacious,3098,180,6,2,8,75.0%,15m
4458,3,Virtue,3098,60,3,6,9,33.3%,30m
4458,1,[UrBX]Callnoway,3098,0,1,0,1,100.0%,41m
4458,3,[PTHero]Heen,3098,0,0,6,6,0.0%,39m
4465,3,SnizSnatcher,3097,1500,73,79,152,48.0%,14m
4465,3,LightninFish,3097,208,6,6,12,50.0%,31m
4465,1,FrOzeN,3097,138,4,4,8,50.0%,51m
4465,3,[EGiD]Braxton,3097,97,2,4,6,33.3%,23m
4469,1,Stouticuss,3096,1733,109,91,200,54.5%,41m
4469,1,AmA,3096,843,85,0,85,100.0%,2m
4469,3,[Viola]lllDFGlll,3096,1003,60,74,134,44.8%,9m
4469,1,Simplified,3096,974,34,30,64,53.1%,34m
4469,3,Ato,3096,699,33,35,68,48.5%,42m
4469,3,Gregor,3096,235,8,5,13,61.5%,10m
4469,2,JackHindell,3096,96,5,3,8,62.5%,1h
4469,1,susurrador,3096,40,2,1,3,66.7%,8m
4469,1,davidm,3096,74,2,3,5,40.0%,42m
4478,3,[CHOOM]ketones,3095,1638,671,671,1342,50.0%,45m
4478,3,eschelon,3095,828,127,122,249,51.0%,55m
4478,3,TomTomTommy,3095,1433,84,83,167,50.3%,29m
4478,1,ButtRipper,3095,632,21,19,40,52.5%,6m
4478,1,TheSense,3095,145,6,5,11,54.5%,8m
4478,1,Hellscythe,3095,0,1,0,1,100.0%,46m
4478,1,[TPGGXD]YellowRay,3095,42,1,3,4,25.0%,52m
4478,1,localhoney,3095,0,0,2,2,0.0%,30m
4486,3,IMaximus,3094,549,23,15,38,60.5%,2m
4486,1,Jimmy,3094,579,20,11,31,64.5%,34m
4486,1,[CAM]Khaydarin,3094,152,4,3,7,57.1%,54m
4486,3,BzKTab,3094,0,3,2,5,60.0%,1h
4486,3,Skateboard,3094,0,3,3,6,50.0%,45m
4486,3,Coffee,3094,142,3,6,9,33.3%,47m
4486,3,[GOPERÚ]ShadowBoy,3094,0,1,0,1,100.0%,1h
4486,1,CarolBaskin,3094,0,1,1,2,50.0%,10m
4486,3,ClaudeSpeed,3094,30,1,5,6,16.7%,39m
4495,3,[HØST]hugobw,3093,470,19,22,41,46.3%,7m
4495,2,Wackysplash,3093,115,3,2,5,60.0%,6m
4495,1,LegionOfDoom,3093,44,1,4,5,20.0%,56m
4495,1,[imN0ob]LgdOscurO,3093,0,0,1,1,0.0%,40m
4499,3,ForCadia,3092,1081,151,152,303,49.8%,33m
4499,3,[peepoC]Cascade,3092,773,49,48,97,50.5%,15m
4499,1,ScotchWhisky,3092,350,26,17,43,60.5%,8m
4499,1,Renzokuken,3092,292,18,15,33,54.5%,50m
4499,1,anprimwaifu,3092,344,12,5,17,70.6%,54m
4499,1,Mev,3092,287,11,7,18,61.1%,9m
4499,1,Zero,3092,316,9,11,20,45.0%,52m
4499,2,[MAYN]twitchChat,3092,186,5,1,6,83.3%,1h
4499,1,PrinceArthas,3092,184,5,5,10,50.0%,34m
4499,1,[Angell]Lokarth,3092,117,3,4,7,42.9%,53m
4499,1,DEAFXROBOT,3092,78,2,3,5,40.0%,8m
4499,3,sliver,3092,60,2,7,9,22.2%,55m
4499,1,Nematic,3092,0,1,0,1,100.0%,8m
4512,3,Phantom,3091,1573,166,170,336,49.4%,37m
4512,3,Gabriel,3091,525,18,30,48,37.5%,38m
4512,1,[TgAg]ItsRichieBTW,3091,80,3,4,7,42.9%,54m
4512,1,Geoff,3091,0,1,0,1,100.0%,52m
4512,1,MiKa,3091,42,1,2,3,33.3%,52m
4512,1,maikojodan,3091,42,1,4,5,20.0%,52m
4512,1,Manabu,3091,0,0,1,1,0.0%,35m
4519,1,Dakalo,3090,328,12,11,23,52.2%,54m
4519,3,Elkahest,3090,178,7,11,18,38.9%,15m
4519,1,Kosui,3090,118,3,5,8,37.5%,42m
4519,1,Netfreakk,3090,0,2,3,5,40.0%,1h
4519,1,[DNKCFT]FappyToad,3090,0,1,4,5,20.0%,40m
4524,3,[WaIl]Caesar,3089,1651,352,337,689,51.1%,32m
4524,1,Gibkram,3089,1047,51,40,91,56.0%,43m
4524,1,[RtKa]Enn,3089,426,12,15,27,44.4%,46m
4524,1,[nSGI]alwaysTrigrd,3089,234,11,5,16,68.8%,29m
4524,1,ENGEL,3089,0,4,1,5,80.0%,54m
4524,1,Neo,3089,80,2,1,3,66.7%,44m
4530,3,LiquidSoap,3088,722,155,105,260,59.6%,48m
4530,1,Indigos,3088,569,20,18,38,52.6%,8m
4530,1,ZPM,3088,187,5,4,9,55.6%,1h
4530,3,Zizzle,3088,120,5,9,14,35.7%,31m
4530,1,[GOPERÚ]pandafloo,3088,170,4,4,8,50.0%,56m
4530,3,GenKenobi,3088,0,1,0,1,100.0%,48m
4530,2,Heisenzerg,3088,0,0,2,2,0.0%,1h
4537,1,[HØST]Gyako,3087,265,9,4,13,69.2%,49m
4537,1,GuzzleMe,3087,140,7,7,14,50.0%,1h
4537,1,[cl0udM]IIIIIIIIIIII,3087,0,5,1,6,83.3%,41m
4537,3,TakaJoebacca,3087,58,4,9,13,30.8%,2m
4537,1,MPL,3087,72,3,0,3,100.0%,4m
4537,1,QStorm,3087,40,1,4,5,20.0%,4m
4537,1,[pumper]bagpipesonme,3087,0,0,1,1,0.0%,40m
4537,1,[3D]TrencH,3087,0,0,1,1,0.0%,4m
4545,1,Mindtaker,3086,318,14,10,24,58.3%,43m
4545,3,DaSwarm,3086,338,13,6,19,68.4%,33m
4545,3,[SADBOI]Ooze,3086,207,13,25,38,34.2%,37m
4545,3,[DFace]MachoTaco,3086,248,8,19,27,29.6%,47m
4545,1,Bodmon,3086,42,2,1,3,66.7%,41m
4545,1,gastrobot,3086,38,1,1,2,50.0%,40m
4551,3,Slagsdale,3085,1586,122,120,242,50.4%,55m
4551,3,[LINY]DeltaSquad,3085,1119,51,64,115,44.3%,9m
4551,1,[GnR]Poaq,3085,639,29,13,42,69.0%,31m
4551,1,[SurfC]Maths,3085,712,28,18,46,60.9%,51m
4551,3,SirScrotus,3085,132,7,5,12,58.3%,35m
4551,1,Decreed,3085,0,3,3,6,50.0%,2m
4551,1,Kolb,3085,38,2,0,2,100.0%,8m
4558,1,[AGHS]heby,3084,737,48,46,94,51.1%,52m
4558,1,janwawa,3084,142,8,4,12,66.7%,56m
4558,1,RandomTraini,3084,0,1,0,1,100.0%,40m
4558,1,[CUUMX]Masterblade,3084,0,1,1,2,50.0%,56m
4558,1,Joey,3084,0,0,1,1,0.0%,52m
4563,1,Ganggbang,3083,961,40,29,69,58.0%,50m
4563,1,iSeeYou,3083,304,11,8,19,57.9%,55m
4563,3,[UED666]UEDCommand,3083,93,5,2,7,71.4%,35m
4563,2,Hipperman,3083,204,4,9,13,30.8%,1h
4563,1,[TGosuB]XLBeastmode,3083,0,1,2,3,33.3%,13m
4563,1,Enzo,3083,0,0,1,1,0.0%,41m
4569,3,Jimmi,3082,453,21,15,36,58.3%,44m
4569,1,Sareth,3082,443,17,13,30,56.7%,34m
4569,3,[CoCoWa]TrashPanda,3082,359,11,25,36,30.6%,48m
4569,2,killereong,3082,156,7,4,11,63.6%,50m
4569,1,Thebucko,3082,169,7,6,13,53.8%,41m
4569,3,[SIKAPM]Cyrus,3082,180,6,5,11,54.5%,13m
4569,1,[XxWoot]holyknight,3082,112,3,3,6,50.0%,51m
4569,2,rithosDOOM,3082,92,2,0,2,100.0%,55m
4569,1,thebigzit,3082,44,2,1,3,66.7%,10m
4569,3,Mophideus,3082,0,1,1,2,50.0%,51m
4579,1,specialed,3081,1760,504,495,999,50.5%,47m
4579,3,HighPeaks,3081,808,30,32,62,48.4%,38m
4579,1,Abraxas,3081,634,23,12,35,65.7%,56m
4579,3,MindGrape,3081,379,13,13,26,50.0%,41m
4579,2,loosecannon,3081,119,10,8,18,55.6%,5m
4579,3,[CatRG]Harambe,3081,0,1,0,1,100.0%,25m
4579,1,Xerolag,3081,0,1,0,1,100.0%,50m
4579,1,[αXLa]Nocturnal,3081,0,1,1,2,50.0%,14m
4579,1,EnZy,3081,0,1,1,2,50.0%,54m
4588,1,[TGosuA]belly,3080,1718,152,142,294,51.7%,46m
4588,1,murkleston,3080,1526,53,56,109,48.6%,2m
4588,1,Nanami,3080,1152,43,31,74,58.1%,54m
4588,3,noflo,3080,554,25,23,48,52.1%,9m
4588,3,Terran,3080,244,8,9,17,47.1%,38m
4588,1,Squider,3080,0,0,1,1,0.0%,41m
4594,1,bebopasaurus,3079,1228,42,41,83,50.6%,42m
4594,3,[xSNSDx]Taeny,3079,151,10,16,26,38.5%,9m
4594,1,Cadrigar,3079,218,6,6,12,50.0%,47m
4594,1,[FMX]KmpaOne,3079,150,4,7,11,36.4%,4m
4594,3,[WLL]Stallion,3079,0,1,0,1,100.0%,58m
4594,1,Thechef,3079,40,1,1,2,50.0%,52m
4594,1,hydrokilla,3079,0,0,1,1,0.0%,43m
4594,3,[Meute]iRushAlways,3079,0,0,5,5,0.0%,50m
4602,1,Snuggle,3078,477,16,14,30,53.3%,10m
4602,1,Skav,3078,273,14,17,31,45.2%,2m
4602,1,MarCraft,3078,34,2,1,3,66.7%,41m
4602,1,McSweetness,3078,0,1,0,1,100.0%,53m
4602,1,[nfr]Santander,3078,0,1,0,1,100.0%,52m
4607,3,Chupacabra,3077,1090,308,300,608,50.7%,35m
4607,1,FXmarc,3077,483,37,28,65,56.9%,33m
4607,1,[KGH]SKP,3077,225,6,4,10,60.0%,40m
4607,3,DaddyChamp,3077,60,6,5,11,54.5%,46m
4607,1,Dye,3077,0,3,2,5,60.0%,47m
4607,1,[CoOpy]SavageDragon,3077,40,1,2,3,33.3%,13m
4613,1,vnmZor,3076,471,16,14,30,53.3%,51m
4613,1,[DNEdge]Nagasaki,3076,368,15,12,27,55.6%,33m
4613,1,[HODE]xploD,3076,235,9,11,20,45.0%,33m
4613,1,[NMPro]Megatron,3076,40,1,1,2,50.0%,50m
4613,1,Hungsolo,3076,0,0,1,1,0.0%,32m
4613,3,VladImpaler,3076,0,0,1,1,0.0%,43m
4619,1,YocuCA,3075,904,33,30,63,52.4%,4m
4619,3,[Lp]rayo,3075,447,30,38,68,44.1%,49m
4619,3,[V1RGN]Geoff,3075,319,15,12,27,55.6%,33m
4619,1,Nautilus,3075,0,3,2,5,60.0%,42m
4619,1,[eSx]Broshimitsu,3075,82,2,3,5,40.0%,4m
4619,1,[60Pho]Trainzor,3075,94,1,3,4,25.0%,40m
4619,3,[SCTRRA]cerebrate,3075,0,1,3,4,25.0%,3m
4626,3,[REIKI]NonMeltIce,3074,1528,195,196,391,49.9%,15m
4626,3,tarita,3074,368,23,20,43,53.5%,12m
4626,1,Fortune,3074,623,18,19,37,48.6%,44m
4626,3,[MarinC]lIIlIIIIIIlI,3074,0,4,2,6,66.7%,8m
4626,1,Yinzknow,3074,80,3,0,3,100.0%,12m
4626,1,TheJuice,3074,42,2,2,4,50.0%,52m
4626,1,[TaKGaM]taKMashido,3074,0,0,2,2,0.0%,31m
4626,1,Dexter,3074,0,0,3,3,0.0%,41m
4634,3,KissKiss,3073,367,120,121,241,49.8%,34m
4634,1,Aphex,3073,1229,50,45,95,52.6%,8m
4634,1,Rooster,3073,634,23,18,41,56.1%,37m
4634,1,Santonria,3073,167,9,5,14,64.3%,12m
4634,3,[ThCORE]DaveyGO,3073,234,8,20,28,28.6%,15m
4634,1,asd,3073,104,6,5,11,54.5%,4m
4634,1,Ndras,3073,40,2,0,2,100.0%,44m
4641,1,[WlLLYS]FirstToDie,3072,583,20,22,42,47.6%,12m
4641,3,CerealKilla,3072,430,19,14,33,57.6%,38m
4641,1,drip,3072,161,3,3,6,50.0%,49m
4641,1,[DarkLS]SLimE,3072,0,1,0,1,100.0%,5m
4641,1,sSnowblind,3072,0,0,2,2,0.0%,12m
4646,3,FilthyCasual,3071,874,86,71,157,54.8%,7m
4646,3,[SkAL]FrostyFenix,3071,1516,81,74,155,52.3%,42m
4646,1,imawinner,3071,789,26,22,48,54.2%,56m
4646,1,Name,3071,710,20,25,45,44.4%,46m
4646,1,Insaneoman,3071,369,15,7,22,68.2%,32m
4646,2,DasCeasar,3071,234,8,5,13,61.5%,35m
4646,1,LeTrollSam,3071,240,6,8,14,42.9%,44m
4646,1,FUNK,3071,0,0,1,1,0.0%,40m
4654,3,[xENTx]Simo,3070,835,94,98,192,49.0%,37m
4654,1,ScvLivesMttr,3070,350,11,11,22,50.0%,44m
4654,1,[EUMEX]UNDERTACOS,3070,78,3,2,5,60.0%,34m
4654,1,WAP,3070,0,1,0,1,100.0%,32m
4658,3,Peacemaker,3069,365,15,19,34,44.1%,15m
4658,1,Cartz,3069,182,8,5,13,61.5%,43m
4658,1,Fulcro,3069,238,6,4,10,60.0%,52m
4658,1,StreetFIend,3069,146,5,3,8,62.5%,56m
4658,3,[LgnTDS]IIIITesta,3069,58,2,8,10,20.0%,5m
4658,1,IamBeefo,3069,44,1,4,5,20.0%,12m
4658,1,[P3ru96]LunaLee,3069,0,0,1,1,0.0%,44m
4658,1,Brotoss,3069,0,0,1,1,0.0%,56m
4666,3,mrdoppler,3068,1683,133,133,266,50.0%,38m
4666,1,TJosh,3068,646,23,19,42,54.8%,49m
4666,2,CanCauser,3068,184,5,1,6,83.3%,1h
4666,1,Auron,3068,40,2,1,3,66.7%,10m
4666,1,SixPooL,3068,0,0,1,1,0.0%,30m
4671,3,llllllllllll,3067,1603,1107,1107,2214,50.0%,50m
4671,3,WarLord,3067,1600,245,227,472,51.9%,53m
4671,3,[KingSC]SIck,3067,1450,95,102,197,48.2%,8m
4671,1,iloveoov,3067,1279,94,49,143,65.7%,33m
4671,1,GlowDrop,3067,464,56,44,100,56.0%,4m
4671,1,[SEQ]ChromaTiN,3067,1008,48,31,79,60.8%,41m
4671,1,[THC420]Drone,3067,573,19,19,38,50.0%,48m
4671,2,cosmoton,3067,250,9,5,14,64.3%,18m
4671,1,[SLAMT]Syn,3067,270,8,9,17,47.1%,35m
4671,1,CiRCliNG,3067,212,6,10,16,37.5%,14m
4671,3,[KurWa]NefariouS,3067,94,4,4,8,50.0%,9m
4671,1,AzaSMtt,3067,32,2,0,2,100.0%,14m
4671,1,[HUSTLA]minkus,3067,0,0,1,1,0.0%,33m
4684,3,Taylorsai,3066,1039,103,104,207,49.8%,48m
4684,1,hornet,3066,1735,101,86,187,54.0%,52m
4684,3,[TLAN]thwOmp,3066,1087,80,74,154,51.9%,6m
4684,1,CakePie,3066,366,14,9,23,60.9%,14m
4684,1,[nieBla]daniov,3066,434,12,13,25,48.0%,42m
4684,1,Nergal,3066,190,6,6,12,50.0%,56m
4684,1,ggwp,3066,40,1,4,5,20.0%,4m
4691,3,[WRuniv]STRENTWILL,3065,1518,79,89,168,47.0%,53m
4691,1,rusty,3065,36,1,1,2,50.0%,43m
4691,2,SlyBoots,3065,0,1,1,2,50.0%,1h
4691,1,CornStar,3065,0,0,1,1,0.0%,41m
4695,1,[n3wk1d]Django,3064,307,20,11,31,64.5%,34m
4695,3,KoomBoom,3064,190,19,25,44,43.2%,5m
4695,3,Blake,3064,338,12,15,27,44.4%,15m
4698,1,[IFC]Knoll,3063,771,28,23,51,54.9%,6m
4698,1,Jackal,3063,372,16,12,28,57.1%,14m
4698,1,[Tensor]sLing,3063,425,14,13,27,51.9%,14m
4698,3,SeguinINC,3063,97,6,1,7,85.7%,3h
4698,1,[TuBE]Woltube,3063,103,4,3,7,57.1%,42m
4698,1,UnaPapusa,3063,152,3,7,10,30.0%,13m
4698,1,[TPGGXD]ELRICK,3063,88,2,0,2,100.0%,33m
4698,1,Dollynho,3063,30,2,1,3,66.7%,8m
4706,1,[KiTeam]DjRew,3062,1607,70,54,124,56.5%,32m
4706,1,MrBolander,3062,684,56,39,95,58.9%,50m
4706,1,chakattakk,3062,256,7,5,12,58.3%,31m
4706,1,[SCxRH]TylerJohnson,3062,118,4,1,5,80.0%,52m
4706,1,crysys,3062,0,4,1,5,80.0%,53m
4706,3,Faust,3062,41,3,10,13,23.1%,32m
4706,1,FLYSON,3062,0,0,1,1,0.0%,46m
4713,3,koo,3061,246,44,38,82,53.7%,45m
4713,3,Tabris,3061,820,30,38,68,44.1%,39m
4713,3,EDDY,3061,117,6,3,9,66.7%,44m
4713,1,moose,3061,0,0,1,1,0.0%,1h
4713,3,TaeKwonDOH,3061,0,0,2,2,0.0%,1h
4718,1,[RwtM]TheReaper,3060,596,20,18,38,52.6%,30m
4718,1,SiNE,3060,518,15,15,30,50.0%,46m
4718,1,gnostic,3060,0,4,1,5,80.0%,10m
4718,3,PyDev,3060,0,4,2,6,66.7%,44m
4718,1,CharlyKing,3060,68,3,1,4,75.0%,42m
4718,3,SUYASUYA,3060,97,1,6,7,14.3%,20m
4718,1,[LPACL]TheMAuRo,3060,0,0,1,1,0.0%,38m
4725,1,plateau,3059,384,32,18,50,64.0%,44m
4725,1,improvise,3059,427,15,11,26,57.7%,10m
4725,1,[LVARW]Oomi,3059,78,2,3,5,40.0%,54m
4728,3,[SBlock]Omar,3058,1097,45,59,104,43.3%,50m
4728,1,proxyimba,3058,616,31,5,36,86.1%,40m
4728,2,Aldwin,3058,142,7,2,9,77.8%,1h
4728,1,jadO,3058,124,3,8,11,27.3%,30m
4728,1,[FxB]Coast,3058,40,1,3,4,25.0%,30m
4728,1,WAKE,3058,40,1,4,5,20.0%,44m
4728,2,LongJohnson,3058,0,1,4,5,20.0%,1h
4735,3,[OddV]KAKAROTO,3057,1354,214,208,422,50.7%,2m
4735,3,Walty,3057,367,32,36,68,47.1%,12m
4735,1,[Chizu]SixtyNeinAPM,3057,257,11,7,18,61.1%,5m
4735,1,KamalaHaRriS,3057,268,11,10,21,52.4%,10m
4735,1,Wrecker,3057,346,9,11,20,45.0%,40m
4735,1,[GaTech]Merakai,3057,193,7,5,12,58.3%,12m
4735,1,Eastmeteor,3057,117,6,4,10,60.0%,13m
4735,1,[EZDUNK]Apple,3057,0,1,0,1,100.0%,56m
4735,1,[LGNxx]Shadow,3057,0,1,3,4,25.0%,46m
4735,1,[DIYE]Oliokath,3057,0,0,1,1,0.0%,34m
4745,3,Luu,3056,1485,121,123,244,49.6%,30m
4745,3,MagicTurtle,3056,607,58,57,115,50.4%,7m
4745,1,[LgnTDS]Rhasta,3056,770,33,25,58,56.9%,31m
4745,1,[SNSD]DocJonson,3056,304,10,8,18,55.6%,56m
4745,1,coorsllte,3056,142,5,5,10,50.0%,30m
4745,1,DharmaKiller,3056,82,3,3,6,50.0%,5m
4751,1,EzeQuieL,3055,0,1,0,1,100.0%,56m
4751,1,[NeAs]LiquidADS,3055,0,1,0,1,100.0%,4m
4751,1,Imply,3055,0,1,1,2,50.0%,30m
4751,1,sunshine,3055,94,1,2,3,33.3%,37m
4751,1,[BlTEL]HidenTiger,3055,0,1,4,5,20.0%,30m
4756,3,Mokkan,3054,1533,94,92,186,50.5%,35m
4756,3,[PXZ]VerixVerck,3054,252,14,12,26,53.8%,38m
4756,1,[LTCent]BeenBallin,3054,215,9,5,14,64.3%,40m
4756,1,Asura,3054,218,7,6,13,53.8%,30m
4756,3,McanningsSon,3054,145,6,2,8,75.0%,15m
4756,1,[Macac0]EsKiaf,3054,36,1,1,2,50.0%,55m
4756,1,RxDealer,3054,38,1,2,3,33.3%,56m
4763,3,[M1A5]Apocalypse,3053,935,64,77,141,45.4%,10m
4763,1,SeaUrchin,3053,411,17,15,32,53.1%,12m
4763,1,[st0bs]CupCokeYum,3053,437,17,17,34,50.0%,13m
4763,2,[ZTemps]PSYCH,3053,161,4,1,5,80.0%,1h
4763,1,[Ar4]Miyeon,3053,110,4,6,10,40.0%,37m
4763,1,lIlllIIIll,3053,114,3,3,6,50.0%,52m
4763,1,[CrnKy]Yakuzaku,3053,84,2,4,6,33.3%,52m
4763,1,[tay]MooGoo,3053,0,1,0,1,100.0%,42m
4763,3,pXgMindcrime,3053,44,1,2,3,33.3%,41m
4763,1,ziache,3053,34,1,2,3,33.3%,55m
4763,1,[NZER0]Trogdar,3053,0,1,2,3,33.3%,2m
4774,1,max,3052,566,43,36,79,54.4%,44m
4774,1,ProudPaw,3052,980,33,28,61,54.1%,41m
4774,1,Stig,3052,561,29,22,51,56.9%,52m
4774,1,Truco,3052,313,13,15,28,46.4%,52m
4774,1,[23cm]KidBengala,3052,169,10,10,20,50.0%,42m
4774,1,[HGL]IMMvp,3052,171,6,2,8,75.0%,50m
4774,1,Grantae,3052,0,3,2,5,60.0%,38m
4781,3,[Ferrum]RuCoMa,3051,1661,127,122,249,51.0%,5m
4781,3,[Rastah]DarthRoam,3051,511,103,110,213,48.4%,34m
4781,1,IIIIIIIII,3051,135,3,2,5,60.0%,26m
4781,1,IMGSaibh,3051,0,3,2,5,60.0%,42m
4785,1,Dontbedouche,3050,998,53,46,99,53.5%,33m
4785,1,[RCSM]dapperboxer,3050,1062,47,34,81,58.0%,7m
4785,1,[lCHRGl]kool,3050,1154,45,34,79,57.0%,54m
4785,3,LeDuc,3050,1030,37,42,79,46.8%,32m
4785,1,llllllllllll,3050,260,9,9,18,50.0%,33m
4785,2,PapaSchlumpf,3050,181,8,4,12,66.7%,32m
4785,1,NAisaJOKE,3050,72,7,2,9,77.8%,56m
4785,2,NoelGeezy,3050,0,4,3,7,57.1%,1h
4785,1,[killpp]Bloodinface,3050,0,1,0,1,100.0%,43m
4785,1,[5Svrt]Nyctor,3050,0,1,0,1,100.0%,55m
4785,1,[NovaX]DerFührer,3050,0,1,0,1,100.0%,54m
4785,1,Arson,3050,40,1,1,2,50.0%,37m
4797,1,FamilyValues,3049,138,4,11,15,26.7%,1h
4797,1,[iDrunk]DankTemplar,3049,0,1,1,2,50.0%,52m
4797,1,TheSnake,3049,0,1,3,4,25.0%,11m
4797,3,[spa3c]stonecoat,3049,30,1,14,15,6.7%,42m
4801,1,Drax,3048,971,45,31,76,59.2%,49m
4801,1,llllllllllll,3048,229,8,7,15,53.3%,42m
4801,1,RyderB,3048,196,7,2,9,77.8%,30m
4801,1,[UpeV]LuisSanHer,3048,144,4,5,9,44.4%,56m
4801,1,Naruhito,3048,0,3,2,5,60.0%,34m
4801,1,TrevorSeeth,3048,42,1,2,3,33.3%,43m
4807,3,[MTAs]Ampersand,3047,1558,325,326,651,49.9%,30m
4807,2,[Random]Lush,3047,1546,144,173,317,45.4%,10m
4807,1,pepo,3047,1680,120,113,233,51.5%,51m
4807,3,[Jerkz]freshkeeper,3047,1330,81,72,153,52.9%,32m
4807,1,[RH]Rave,3047,379,46,34,80,57.5%,37m
4807,1,Kaiser,3047,390,19,10,29,65.5%,14m
4807,1,GoldenArmada,3047,323,11,15,26,42.3%,15m
4807,1,Titin,3047,0,4,1,5,80.0%,52m
4807,3,Newbtacular,3047,0,3,4,7,42.9%,15m
4807,1,[FU2]BlackSlice,3047,114,3,5,8,37.5%,31m
4807,2,[BRAP]Overdriven,3047,90,2,5,7,28.6%,34m
4807,1,PowerYoda,3047,0,1,0,1,100.0%,4m
4807,2,Mercer,3047,0,1,1,2,50.0%,52m
4807,1,[nek0]Emi,3047,0,0,1,1,0.0%,3h
4821,3,fumom,3046,811,30,41,71,42.3%,8m
4821,1,DuMa,3046,388,19,9,28,67.9%,34m
4821,3,[TGosuA]Rolch,3046,325,10,17,27,37.0%,54m
4821,1,OfrParis,3046,157,7,0,7,100.0%,33m
4821,1,[TheB4d]LazyMetroid,3046,218,7,5,12,58.3%,40m
4821,1,CloudBoi,3046,210,6,7,13,46.2%,31m
4821,1,[GaMTaK]TaKMashido,3046,0,1,0,1,100.0%,30m
4828,1,[HACKER]CrashOveride,3045,1275,47,41,88,53.4%,8m
4828,3,[SCL]RedNoVeno,3045,306,30,35,65,46.2%,55m
4828,1,[A3XTR]Proxy,3045,530,16,14,30,53.3%,52m
4828,2,DANGER,3045,167,7,5,12,58.3%,1h
4828,1,powercoockie,3045,128,6,3,9,66.7%,33m
4828,1,prttygrlrock,3045,106,3,3,6,50.0%,52m
4828,1,mesh,3045,36,2,1,3,66.7%,33m
4828,2,Kakisho,3045,96,1,2,3,33.3%,50m
4836,3,PrbeLfeMafia,3044,815,115,105,220,52.3%,49m
4836,1,[Th3Bad]ToadPoa,3044,1589,73,61,134,54.5%,12m
4836,1,Null,3044,1080,39,31,70,55.7%,54m
4836,1,Dasbooty,3044,676,32,19,51,62.7%,36m
4836,1,Arostegui,3044,268,12,6,18,66.7%,13m
4836,1,Totaro,3044,154,8,4,12,66.7%,3m
4836,1,MauRuS,3044,0,1,1,2,50.0%,2m
4836,1,Dread,3044,38,1,4,5,20.0%,50m
4836,1,Mika,3044,0,1,4,5,20.0%,37m
4836,1,Spazzifier,3044,0,0,3,3,0.0%,41m
4846,1,Electro,3043,1702,163,155,318,51.3%,41m
4846,1,Jonerys,3043,1267,74,62,136,54.4%,43m
4846,1,Kioelf,3043,1293,48,41,89,53.9%,41m
4846,3,SoEasy,3043,503,36,34,70,51.4%,32m
4846,1,RaithSensei,3043,636,35,22,57,61.4%,34m
4846,1,DaddyDolla,3043,837,35,27,62,56.5%,5m
4846,1,Troy,3043,669,24,18,42,57.1%,41m
4846,1,Darkness,3043,276,17,10,27,63.0%,30m
4846,3,Revolt,3043,0,0,1,1,0.0%,15m
4855,3,WolfJohnson,3042,1210,47,51,98,48.0%,43m
4855,3,JukeLuke,3042,602,21,28,49,42.9%,4m
4855,1,Mortalitor,3042,271,8,10,18,44.4%,1h
4855,1,[Addict]Nevermore,3042,40,1,4,5,20.0%,37m
4855,1,darthCopy,3042,0,0,1,1,0.0%,12m
4860,1,TROLLMAN,3041,398,18,14,32,56.2%,43m
4860,1,[XpKb]CrisderKill,3041,0,3,2,5,60.0%,10m
4860,3,dabomb,3041,0,1,0,1,100.0%,3h
4860,1,wherevugo,3041,0,0,1,1,0.0%,52m
4864,1,[DRKPMT]Neid,3040,1544,63,56,119,52.9%,40m
4864,1,Echomancer,3040,860,28,29,57,49.1%,54m
4864,3,[FBK]Tiran,3040,421,19,24,43,44.2%,15m
4864,1,[KGH]Overnuke,3040,382,10,9,19,52.6%,56m
4864,3,[VEEJAY]Railgun,3040,97,2,0,2,100.0%,1h
4864,3,Emily,3040,97,1,1,2,50.0%,1h
4864,1,guttedbro,3040,32,1,3,4,25.0%,44m
4871,3,[C0RN]brikkity,3039,911,126,126,252,50.0%,35m
4871,3,[GIBE]AlfieStar,3039,771,55,52,107,51.4%,35m
4871,1,Krat,3039,802,32,26,58,55.2%,43m
4871,3,Hank,3039,642,28,38,66,42.4%,53m
4871,1,Captainsalt,3039,504,15,16,31,48.4%,13m
4871,1,Matt,3039,253,12,7,19,63.2%,56m
4871,1,[UFC]Social,3039,143,6,6,12,50.0%,37m
4871,2,Cheesecake,3039,112,3,3,6,50.0%,40m
4871,1,XXTASY,3039,102,3,3,6,50.0%,52m
4871,1,AlienWiz,3039,0,1,1,2,50.0%,50m
4871,1,[CDAL]Tucano,3039,97,1,7,8,12.5%,49m
4882,3,[EZTZPZ]Blank,3038,1241,73,84,157,46.5%,4m
4882,3,piliaborza,3038,740,26,35,61,42.6%,13m
4882,1,Varentou,3038,234,6,9,15,40.0%,41m
4882,1,STVCR,3038,0,5,0,5,100.0%,4m
4882,3,lumps,3038,93,4,1,5,80.0%,5m
4882,1,DVE,3038,76,2,3,5,40.0%,56m
4888,3,CaptBigBoss,3037,1163,57,76,133,42.9%,12m
4888,3,[NrFms]llllllllllll,3037,456,20,17,37,54.1%,34m
4888,1,[Macac0]Oturanx,3037,219,7,3,10,70.0%,13m
4888,1,[TheDOH]Andy,3037,164,6,2,8,75.0%,5m
4888,1,[TGOTA]Osaka,3037,122,2,5,7,28.6%,14m
4888,1,[SCIIS]Tubesock,3037,0,1,3,4,25.0%,9m
4894,3,ATLien,3036,1453,161,165,326,49.4%,7m
4894,1,llllllllllll,3036,453,24,27,51,47.1%,51m
4894,3,Wicholmaster,3036,545,19,22,41,46.3%,5m
4894,1,GarbalageMan,3036,366,13,12,25,52.0%,36m
4894,1,quetzal,3036,222,7,1,8,87.5%,1h
4894,3,[GGMESP]RICKY,3036,133,5,4,9,55.6%,1h
4894,1,[HR666]Nighthawk,3036,112,3,5,8,37.5%,46m
4894,1,Androide,3036,107,3,7,10,30.0%,36m
4894,1,frog,3036,42,2,3,5,40.0%,54m
4894,1,FrozenCloud,3036,58,2,3,5,40.0%,36m
4894,1,Louisvillian,3036,0,1,0,1,100.0%,43m
4905,1,[PooNys]Chuncocoo,3035,1000,46,37,83,55.4%,5m
4905,1,[UpeV]Aioria,3035,595,23,14,37,62.2%,40m
4905,1,lennytheboi,3035,173,8,2,10,80.0%,53m
4905,1,entrØpy,3035,102,3,0,3,100.0%,8m
4905,1,[monin]Yaxhiro,3035,108,2,1,3,66.7%,13m
4905,1,[Oystar]Pituiberries,3035,105,2,1,3,66.7%,8m
4905,3,[Ash3s]StarsFallDim,3035,0,1,7,8,12.5%,13m
4905,1,kobetj,3035,0,0,1,1,0.0%,52m
4905,3,SonHeungMin,3035,0,0,1,1,0.0%,23m
4914,3,Condo,3034,1611,204,197,401,50.9%,34m
4914,1,[220ms]Mightily,3034,1495,59,51,110,53.6%,42m
4914,1,Boondoggle,3034,678,55,45,100,55.0%,50m
4914,3,StackingKing,3034,990,32,52,84,38.1%,15m
4914,1,NavySil,3034,463,21,26,47,44.7%,47m
4914,3,[Exper]Tanus,3034,248,10,11,21,47.6%,35m
4914,3,Sluipen,3034,156,8,5,13,61.5%,8m
4914,1,cakewalk,3034,72,7,2,9,77.8%,3m
4914,3,xNoobMasterx,3034,146,6,3,9,66.7%,1h
4914,1,Sir,3034,189,4,4,8,50.0%,50m
4914,2,[TSHUB]JonathanYork,3034,0,1,1,2,50.0%,1h
4925,3,[xO]MAXPOWER,3033,1595,263,261,524,50.2%,7m
4925,1,[AiMY0N]JoSeonHurJun,3033,1636,63,51,114,55.3%,2m
4925,3,Lasagna,3033,172,8,6,14,57.1%,30m
4925,1,[YPR]YPR,3033,143,3,2,5,60.0%,34m
4925,1,Twine,3033,0,3,2,5,60.0%,39m
4925,1,Momanon,3033,40,2,2,4,50.0%,14m
4925,1,[WFV]freya,3033,89,1,1,2,50.0%,14m
4925,3,onestratterr,3033,0,0,1,1,0.0%,30m
4933,1,Chae,3032,881,36,31,67,53.7%,13m
4933,3,[PoHo]Phoenix,3032,627,31,27,58,53.4%,8m
4933,1,RichManJoe,3032,289,14,9,23,60.9%,38m
4933,1,GUMIHOO,3032,377,13,9,22,59.1%,14m
4933,1,KaiGreene,3032,244,10,5,15,66.7%,11m
4933,1,BadApple,3032,257,9,5,14,64.3%,26m
4933,3,[DRKDNA]Shilowind,3032,121,5,6,11,45.5%,49m
4933,1,[Cryptc]SevenLions,3032,116,4,1,5,80.0%,40m
4933,1,Rhaam,3032,48,4,2,6,66.7%,14m
4933,1,zzzzmodule,3032,0,1,0,1,100.0%,9m
4933,1,Pharowizard,3032,0,1,2,3,33.3%,8m
4933,1,DeRcHoBo,3032,0,0,1,1,0.0%,34m
4933,3,Gerard,3032,0,0,4,4,0.0%,30m
4946,1,defn,3031,1668,135,130,265,50.9%,37m
4946,1,[samnx]samurayx,3031,1725,120,111,231,51.9%,56m
4946,3,Sheldon,3031,1573,66,71,137,48.2%,15m
4946,1,Broach,3031,733,26,24,50,52.0%,13m
4946,1,WhiteWolf,3031,240,7,7,14,50.0%,4m
4946,2,[POPJAW]JawPoper,3031,131,5,3,8,62.5%,1h
4946,1,Valhalla,3031,38,1,3,4,25.0%,55m
4953,3,tulon,3030,236,12,10,22,54.5%,32m
4953,1,EnTaroDEHAKA,3030,276,9,7,16,56.2%,2m
4953,1,[HØST]VicBansemer,3030,137,5,3,8,62.5%,29m
4953,1,zINGO,3030,223,5,5,10,50.0%,37m
4953,1,YenYeri,3030,0,1,3,4,25.0%,30m
4953,1,Zorro,3030,0,0,1,1,0.0%,14m
4959,1,[D3M0NS]bkjlake,3029,1430,49,50,99,49.5%,13m
4959,1,[EtrOy]hairyewok,3029,668,20,22,42,47.6%,30m
4959,1,twicetherice,3029,476,15,11,26,57.7%,5m
4959,1,Winchest,3029,174,8,5,13,61.5%,10m
4959,1,Stealth,3029,0,3,2,5,60.0%,33m
4959,3,SkyyCaptain,3029,107,3,6,9,33.3%,30m
4959,3,[DIS]Hoobajoob,3029,42,2,7,9,22.2%,3h
4959,1,CptRandom,3029,0,1,1,2,50.0%,13m
4959,1,Ryan,3029,44,1,5,6,16.7%,46m
4959,1,[TPGGXD]DarKar,3029,0,0,1,1,0.0%,48m
4969,1,[ValidG]SafteScizors,3028,1366,76,77,153,49.7%,55m
4969,3,[runnn]GenBuboniC,3028,778,27,40,67,40.3%,55m
4969,1,UnusualPlay,3028,100,5,2,7,71.4%,41m
4969,1,RedHorse,3028,120,2,3,5,40.0%,2m
4969,1,Devil,3028,0,0,1,1,0.0%,2m
4974,1,Bane,3027,522,24,19,43,55.8%,13m
4974,1,[TechN]Parasite,3027,495,23,12,35,65.7%,33m
4974,1,[SRiC]Obsidian,3027,698,20,25,45,44.4%,5m
4974,1,AmonsForces,3027,304,11,11,22,50.0%,12m
4974,1,dingymick,3027,200,8,3,11,72.7%,13m
4974,3,Kiwi,3027,185,7,3,10,70.0%,1h
4974,1,[xNGx]WokeAssClown,3027,88,3,1,4,75.0%,8m
4974,1,watermelon,3027,0,3,3,6,50.0%,50m
4974,1,Jm,3027,145,2,2,4,50.0%,44m
4974,1,Raize,3027,88,1,1,2,50.0%,47m
4974,1,perro,3027,42,1,7,8,12.5%,43m
4974,2,LeBronzeAims,3027,0,0,2,2,0.0%,1h
4986,3,[ZaPiT]PawnForTobi,3026,1481,87,92,179,48.6%,39m
4986,3,[HARLET]SENJUxMIGUEL,3026,1541,81,83,164,49.4%,48m
4986,1,[Mc]Fenrir,3026,1040,46,39,85,54.1%,37m
4986,1,Volla,3026,266,8,6,14,57.1%,40m
4986,1,Wetty,3026,257,7,9,16,43.8%,1h
4986,2,Marus,3026,0,1,0,1,100.0%,1h
4986,2,JoNes,3026,30,1,1,2,50.0%,41m
4986,2,Hades,3026,0,0,1,1,0.0%,6m
4994,3,PDXPanda,3025,599,28,22,50,56.0%,8m
4994,1,Resolution,3025,743,26,24,50,52.0%,7m
4994,1,ahahahhahaha,3025,466,17,12,29,58.6%,37m
4994,1,[JlNAIR]IIIIIIIIIIII,3025,277,12,7,19,63.2%,1h
4994,1,[KrV]KrVwoodchuck,3025,354,11,10,21,52.4%,35m
4994,1,EluSivE,3025,324,9,13,22,40.9%,2m
4994,1,BaliHai,3025,34,2,1,3,66.7%,37m
5001,3,[BUTIFL]Zeebz,3024,196,8,12,20,40.0%,33m
5001,3,GoudaNuff,3024,94,6,11,17,35.3%,44m
5001,1,[HEZUS]DietProtoss,3024,42,4,4,8,50.0%,2m
5001,1,Mad,3024,126,2,3,5,40.0%,46m
5001,3,MiniGhost,3024,0,1,0,1,100.0%,46m
5001,1,[Truies]Pretzel,3024,0,1,1,2,50.0%,40m
5001,1,Paradox,3024,0,0,2,2,0.0%,12m
5008,1,Rozoke,3023,1349,58,58,116,50.0%,12m
5008,3,Damon,3023,568,35,34,69,50.7%,44m
5008,3,[KGC]LvLOneNinja,3023,727,26,31,57,45.6%,42m
5008,3,Chiral,3023,469,21,18,39,53.8%,13m
5008,1,[731]ZeRo,3023,239,11,4,15,73.3%,4m
5008,2,[GoF]Bolt,3023,0,4,1,5,80.0%,33m
5008,2,RyanZhang,3023,0,1,0,1,100.0%,31m
5008,1,NicoResko,3023,0,0,4,4,0.0%,3m
5016,2,GuestAGuy,3022,1423,81,71,152,53.3%,33m
5016,1,[lllIIl]llllllllllll,3022,1264,55,47,102,53.9%,47m
5016,2,Qwerty,3022,945,38,31,69,55.1%,14m
5016,1,[Crab]Carbon,3022,264,9,6,15,60.0%,14m
5016,2,Busty,3022,112,4,3,7,57.1%,33m
5016,3,[SURUPA]VaLeskA,3022,122,4,3,7,57.1%,58m
5016,1,Gaia,3022,96,2,3,5,40.0%,1h
5016,1,[OPGame]Vistatus,3022,0,1,2,3,33.3%,1h
5016,1,BlessMyOPX,3022,0,0,10,10,0.0%,43m
5025,1,JsMemoRy,3021,1244,50,47,97,51.5%,30m
5025,3,[DarkAG]Jaicir,3021,762,27,35,62,43.5%,43m
5025,2,[xJFJx]DoggyDawgg,3021,190,8,5,13,61.5%,3m
5025,1,[SWORD7]Bill,3021,234,7,11,18,38.9%,13m
5025,1,Matches,3021,97,5,5,10,50.0%,2m
5025,1,MicroJFox,3021,99,4,4,8,50.0%,36m
5025,1,[Quetza]Warsong,3021,76,3,5,8,37.5%,4m
5025,1,Eko,3021,118,3,7,10,30.0%,53m
5025,1,[RLSM]jdc,3021,0,1,1,2,50.0%,56m
5034,1,[xNPGx]Jhandro,3020,734,37,30,67,55.2%,10m
5034,1,[TC2]GenBen,3020,332,11,9,20,55.0%,30m
5034,3,[DarkAG]ChristLvsYou,3020,187,5,10,15,33.3%,8m
5034,1,LaxAxeman,3020,158,3,4,7,42.9%,9m
5034,2,Morgeno,3020,0,2,3,5,40.0%,3m
5039,3,[NFLD]Zaralus,3019,1563,168,171,339,49.6%,46m
5039,1,[LGL]Siul,3019,1397,53,46,99,53.5%,37m
5039,1,Ark,3019,294,17,16,33,51.5%,5m
5039,1,Throwback,3019,168,7,8,15,46.7%,41m
5039,3,Lantis,3019,220,6,11,17,35.3%,33m
5039,1,Hello,3019,137,4,2,6,66.7%,54m
5045,1,[XHB]SSB,3018,638,26,24,50,52.0%,37m
5045,1,[AKLsc]ForStaR,3018,693,24,23,47,51.1%,55m
5045,3,OldPork,3018,218,8,14,22,36.4%,44m
5045,3,MightyO,3018,161,7,24,31,22.6%,39m
5045,2,HrdInDaCreep,3018,30,2,0,2,100.0%,6m
5045,1,[DTP15]ICHIGO,3018,0,0,4,4,0.0%,43m
5051,1,kaboosH,3017,809,48,42,90,53.3%,8m
5051,2,FRxENCHnoob,3017,746,35,13,48,72.9%,5m
5051,1,[BUMFUK]kneeinthesac,3017,767,24,25,49,49.0%,52m
5051,1,Bland,3017,329,13,17,30,43.3%,14m
5051,1,hyrican,3017,422,13,20,33,39.4%,52m
5051,3,SHOOTERJ,3017,149,7,6,13,53.8%,31m
5051,3,joker,3017,60,4,9,13,30.8%,16m
5051,1,dre,3017,82,3,3,6,50.0%,44m
5051,1,NotSteve,3017,118,3,8,11,27.3%,43m
5051,2,SCghost,3017,0,0,1,1,0.0%,54m
5061,2,Xanxus,3016,1152,48,33,81,59.3%,40m
5061,3,Nightmare,3016,710,24,38,62,38.7%,31m
5061,2,DemonSorrow,3016,378,17,9,26,65.4%,7m
5061,3,[SVEJST]ililliilllii,3016,208,8,4,12,66.7%,3h
5061,2,KickHimPedro,3016,154,6,4,10,60.0%,51m
5061,3,[αB]ZAWGURN,3016,204,6,7,13,46.2%,8m
5061,1,[nicech]KumaNeko,3016,30,5,3,8,62.5%,4m
5061,1,Solo,3016,0,3,2,5,60.0%,35m
5061,1,Adam,3016,0,3,2,5,60.0%,14m
5061,2,mikmonk,3016,0,2,3,5,40.0%,54m
5061,1,[catcat]mIndwarp,3016,0,1,2,3,33.3%,33m
5072,1,Piero,3015,839,106,100,206,51.5%,31m
5072,1,IronMario,3015,614,24,19,43,55.8%,37m
5072,1,[TGCF]Yuki,3015,314,21,14,35,60.0%,48m
5072,2,KnightMares,3015,360,13,9,22,59.1%,11m
5072,3,Krazzus,3015,285,12,12,24,50.0%,11m
5072,1,TheRuthless,3015,197,5,11,16,31.2%,40m
5072,2,[QTp2T]Voden,3015,62,2,3,5,40.0%,44m
5072,2,Mars,3015,0,1,0,1,100.0%,10m
5080,1,[NAUG3]CrazyJezuz,3014,1411,72,54,126,57.1%,31m
5080,3,GINTOKI,3014,960,66,70,136,48.5%,13m
5080,1,Havoc,3014,912,31,31,62,50.0%,40m
5080,1,RodAR,3014,642,23,18,41,56.1%,4m
5080,3,EyeHoles,3014,123,4,7,11,36.4%,15m
5080,1,[Mans]Osman,3014,80,2,8,10,20.0%,49m
5080,2,[DiaOrg]Stormer,3014,0,1,0,1,100.0%,31m
5080,1,[BtoB]Fluffybunny,3014,30,1,2,3,33.3%,3m
5080,1,[zeez]VoidPhallus,3014,36,1,6,7,14.3%,2m
5080,1,[a99]Bloodbyte,3014,0,0,2,2,0.0%,38m
5080,1,DarkMaster,3014,0,0,2,2,0.0%,56m
5080,1,kaykay,3014,0,0,3,3,0.0%,42m
5092,3,EraMemory,3013,1556,69,77,146,47.3%,49m
5092,2,Zeropoint,3013,580,25,15,40,62.5%,16m
5092,2,lWorstGodl,3013,248,9,2,11,81.8%,44m
5092,1,DrDoom,3013,183,6,4,10,60.0%,47m
5092,1,Trista,3013,48,4,2,6,66.7%,1h
5092,1,Jaybird,3013,76,2,6,8,25.0%,12m
5092,3,MaoShiSi,3013,0,1,0,1,100.0%,1h
5099,3,[HBNC]puddlez,3012,1621,195,192,387,50.4%,8m
5099,3,InnisAndGunn,3012,1364,110,116,226,48.7%,4m
5099,1,lilsnow,3012,1442,75,70,145,51.7%,44m
5099,2,HandiQuacked,3012,719,36,9,45,80.0%,4m
5099,3,LostSoulz,3012,330,15,13,28,53.6%,13m
5099,1,superkiddo,3012,0,3,2,5,60.0%,1h
5099,2,superkiller,3012,0,2,3,5,40.0%,41m
5099,2,[UnPhuk]TheFlamingo,3012,0,1,0,1,100.0%,55m
5099,2,[Ne0x1]AARON,3012,0,1,0,1,100.0%,30m
5099,2,[Kaii]Yaguar,3012,32,1,1,2,50.0%,36m
5099,1,[SSQc]ArtStyle,3012,89,1,2,3,33.3%,8m
5099,2,LeMonLinK,3012,0,0,1,1,0.0%,11m
5111,1,[TPGGXD]alecsander,3011,444,19,13,32,59.4%,13m
5111,2,Nighthawk,3011,314,12,7,19,63.2%,15m
5111,1,Nouki,3011,228,6,10,16,37.5%,8m
5111,3,[SCGA]AGMiaoB,3011,86,5,9,14,35.7%,15m
5111,1,Tempest,3011,0,4,2,6,66.7%,41m
5111,2,MagicProtoss,3011,96,4,2,6,66.7%,36m
5111,3,[glgghf]Illidan,3011,120,3,1,4,75.0%,44m
5111,2,[KREAP]FlamingPie,3011,0,3,2,5,60.0%,53m
5111,2,Casorus,3011,0,1,0,1,100.0%,7m
5111,2,Joannaho,3011,0,1,0,1,100.0%,9m
5111,2,Swiskey,3011,0,1,0,1,100.0%,11m
5111,2,[PTHero]JTgalactica,3011,0,0,1,1,0.0%,47m
5123,1,[MPC]IIIIIIIIIIII,3010,1148,92,93,185,49.7%,4m
5123,1,Jehudda,3010,1396,71,67,138,51.4%,54m
5123,3,Azreal,3010,42,5,4,9,55.6%,8m
5123,1,iftarii,3010,152,5,9,14,35.7%,48m
5123,2,speedoguy,3010,30,4,2,6,66.7%,10m
5123,2,[BMGT]Modsoul,3010,123,2,4,6,33.3%,16m
5123,1,[Cavalo]Lee,3010,38,1,3,4,25.0%,33m
5123,1,[Dicboy]Mannheim,3010,0,0,3,3,0.0%,52m
5131,2,JAVI,3009,591,23,16,39,59.0%,55m
5131,1,Cállate,3009,264,8,10,18,44.4%,37m
5131,1,Beetlejuice,3009,74,3,9,12,25.0%,11m
5131,2,Zwiback,3009,58,2,2,4,50.0%,39m
5131,1,[TPGGXD]Machaca,3009,0,1,3,4,25.0%,41m
5131,2,WizardSmooth,3009,0,0,1,1,0.0%,11m
5137,1,[boeuf]Gateaux,3008,1685,164,143,307,53.4%,53m
5137,3,[SDC12]Wequisley,3008,1583,68,74,142,47.9%,16m
5137,3,[GGMESP]RoseewalQloO,3008,302,11,5,16,68.8%,13m
5137,1,Maverick,3008,160,4,9,13,30.8%,53m
5137,2,SoloXman,3008,0,1,0,1,100.0%,9m
5137,1,Profit,3008,0,1,4,5,20.0%,1h
5137,2,[AD3C]NalCRAFT,3008,0,0,1,1,0.0%,35m
5144,1,inkybinky,3007,1349,80,73,153,52.3%,33m
5144,3,[UpxV]HarDan,3007,642,58,64,122,47.5%,41m
5144,3,Jeremylin,3007,630,23,26,49,46.9%,31m
5144,2,VxAnime,3007,442,21,15,36,58.3%,4m
5144,3,Smykea,3007,386,17,17,34,50.0%,36m
5144,1,MacGruber,3007,193,5,5,10,50.0%,44m
5144,1,PersonEight,3007,172,5,13,18,27.8%,52m
5151,1,[ZTemp]burn,3006,811,35,36,71,49.3%,30m
5151,3,[57717]SolemnWookie,3006,139,3,6,9,33.3%,1h
5151,1,McHootsman,3006,38,1,3,4,25.0%,40m
5151,2,[PTHero]Jenger,3006,44,1,4,5,20.0%,51m
5151,2,[QuAzar]pinguchingu,3006,0,0,2,2,0.0%,8m
5151,1,Zebwak,3006,0,0,3,3,0.0%,4m
5157,1,[CTCiav]MKiller,3005,917,34,30,64,53.1%,52m
5157,3,PANDARINMAN,3005,446,15,22,37,40.5%,43m
5157,2,idkhowtoplay,3005,88,3,3,6,50.0%,15m
5157,2,snotrag,3005,0,1,0,1,100.0%,13m
5161,1,SkullCapVR,3004,323,11,12,23,47.8%,55m
5161,2,Oreki,3004,140,6,5,11,54.5%,8m
5161,1,SirBlahDBlah,3004,93,2,2,4,50.0%,40m
5161,2,GreenJobCzar,3004,0,0,1,1,0.0%,14m
5161,1,[WHITEz]babbycakes,3004,0,0,3,3,0.0%,56m
5166,3,Craxz,3003,82,3,5,8,37.5%,1h
5166,2,[NoSex4]Chocobo,3003,0,1,1,2,50.0%,10m
5168,1,PlanB,3002,1254,42,44,86,48.8%,43m
5168,1,NoWar,3002,219,7,6,13,53.8%,4m
5168,2,[nieBla]Heinsenberg,3002,277,7,8,15,46.7%,47m
5168,3,DoitiEtok,3002,137,5,4,9,55.6%,1h
5168,1,usucha,3002,0,3,2,5,60.0%,21m
5168,1,[Tdog4e]Lore,3002,48,3,4,7,42.9%,3h
5168,2,llllllllllll,3002,0,2,3,5,40.0%,52m
5168,1,[9thAve]ShoeBaD,3002,36,2,6,8,25.0%,37m
5168,1,Diaw,3002,0,1,1,2,50.0%,34m
5177,1,VeinDrainage,3001,1645,112,107,219,51.1%,5m
5177,1,Maorijosh,3001,1396,66,51,117,56.4%,56m
5177,1,[ATL]JimLahey,3001,1331,62,66,128,48.4%,8m
5177,1,[gaPe]Siv,3001,1178,45,40,85,52.9%,56m
5177,1,nGsDangerous,3001,300,13,8,21,61.9%,52m
5177,1,[JIGLY]RainMaker,3001,0,4,1,5,80.0%,1h
5177,2,Crybaby,3001,0,3,2,5,60.0%,3m
5177,2,Deeeeeeeeerp,3001,0,3,2,5,60.0%,7m
5177,1,Afourteen,3001,0,3,3,6,50.0%,13m
5177,1,Daigle,3001,138,3,4,7,42.9%,8m
5177,1,TroudBâl,3001,0,2,3,5,40.0%,57m
5177,2,Curio,3001,0,1,0,1,100.0%,34m
5177,2,[ALQ]Gorilla,3001,0,1,1,2,50.0%,34m
5177,2,HotDryNoodle,3001,34,1,1,2,50.0%,11m
5191,1,rickynewt,3000,433,22,18,40,55.0%,52m
5191,1,freshsashimi,3000,604,22,18,40,55.0%,56m
5191,2,[ExcIgN]sebastis,3000,544,20,13,33,60.6%,8m
5191,1,AntM,3000,196,10,10,20,50.0%,55m
5191,2,Martin,3000,94,4,1,5,80.0%,15m
5191,2,SillyPufPuf,3000,30,2,1,3,66.7%,31m
5191,2,dEstrydwApoN,3000,58,2,2,4,50.0%,5m
5191,2,TaCoMunCher,3000,139,2,4,6,33.3%,1h
5191,2,[JaMiT]Greenknight,3000,34,1,2,3,33.3%,6m
5191,2,[SsaYnS]SiLVeRLeAF,3000,0,0,3,3,0.0%,11m
5201,1,Peej,2999,1626,72,80,152,47.4%,31m
5201,1,AlanarKo,2999,832,44,36,80,55.0%,40m
5201,1,[AnimaS]StarkeRath,2999,439,18,9,27,66.7%,35m
5201,3,[WkdWlf]john,2999,436,16,23,39,41.0%,54m
5201,1,nofratos,2999,210,8,4,12,66.7%,3m
5201,2,Pita,2999,193,8,6,14,57.1%,42m
5201,1,[NovaX]Realone,2999,156,6,2,8,75.0%,12m
5201,2,[TlClS]SnaIdeN,2999,30,1,1,2,50.0%,51m
5201,2,TrashPanda,2999,34,1,3,4,25.0%,55m
5210,2,lowtone,2998,1511,214,202,416,51.4%,5m
5210,1,Arob,2998,1709,133,133,266,50.0%,47m
5210,1,Heisenberg,2998,1540,56,53,109,51.4%,47m
5210,2,Mauve,2998,664,28,18,46,60.9%,48m
5210,2,[TGosuB]Yeezus,2998,621,23,16,39,59.0%,4m
5210,2,superkyler,2998,213,14,10,24,58.3%,34m
5210,1,[GnR]Kingbenjamin,2998,384,12,17,29,41.4%,42m
5210,2,[Cambas]Edwinosky,2998,294,11,9,20,55.0%,55m
5210,1,Pokiki,2998,62,3,6,9,33.3%,5m
5210,2,biggelwelp,2998,0,2,4,6,33.3%,59m
5220,3,Borg,2997,858,33,32,65,50.8%,44m
5220,3,[xLgNx]MrsAhrim,2997,802,28,42,70,40.0%,10m
5220,1,Kufa,2997,775,26,25,51,51.0%,43m
5220,2,Flocka,2997,310,13,9,22,59.1%,55m
5220,2,Rayko,2997,171,6,1,7,85.7%,53m
5220,2,itekken,2997,150,5,6,11,45.5%,9m
5220,3,notmaster,2997,146,3,3,6,50.0%,25m
5220,3,StimToWin,2997,0,1,1,2,50.0%,1h
5220,1,Noodles,2997,0,1,2,3,33.3%,53m
5229,1,OuatDePhoque,2996,1697,240,217,457,52.5%,12m
5229,3,TumerzuKING,2996,1250,48,46,94,51.1%,54m
5229,1,Jackintosh,2996,489,32,25,57,56.1%,43m
5229,1,Vaporflare,2996,816,29,29,58,50.0%,5m
5229,2,Hambone,2996,564,19,21,40,47.5%,3m
5229,1,[Random]Couts,2996,580,16,25,41,39.0%,14m
5229,1,[NAisOK]WEEBRATOR,2996,338,13,11,24,54.2%,49m
5229,1,EMP,2996,350,12,11,23,52.2%,37m
5229,3,Harbinger,2996,160,4,3,7,57.1%,3h
5229,1,BrianWobbles,2996,66,2,5,7,28.6%,14m
5229,3,Stellar,2996,30,1,13,14,7.1%,11m
5229,1,TestBot,2996,0,0,1,1,0.0%,48m
5229,2,FilthyBeaver,2996,0,0,2,2,0.0%,34m
5229,1,JUICE,2996,0,0,5,5,0.0%,35m
5243,2,AgentVenom,2995,1634,271,233,504,53.8%,12m
5243,3,[RUMB]Daddy,2995,1476,54,71,125,43.2%,12m
5243,1,bustercat,2995,546,15,19,34,44.1%,12m
5243,2,[neuroS]Wizard,2995,126,6,3,9,66.7%,54m
5243,1,[HMTeam]KoyaTeckKpv,2995,148,6,3,9,66.7%,37m
5243,1,Joshua,2995,0,4,1,5,80.0%,39m
5243,1,SuPeRiOrNi,2995,0,3,2,5,60.0%,1h
5243,2,JazZz,2995,0,2,3,5,40.0%,53m
5243,2,[VRGA]radiohead,2995,23,1,2,3,33.3%,37m
5252,3,Kirby,2994,1338,202,200,402,50.2%,15m
5252,3,jeanlefou,2994,1160,69,67,136,50.7%,41m
5252,2,XenoKai,2994,897,44,27,71,62.0%,46m
5252,1,[WiGGz]Lobodomy,2994,711,24,25,49,49.0%,33m
5252,1,[MOBOZ]Dubstep,2994,152,4,12,16,25.0%,40m
5252,3,SCVready,2994,0,1,1,2,50.0%,3h
5252,2,watercolour,2994,0,0,2,2,0.0%,39m
5259,1,[ZC]KillCredit,2993,1435,109,107,216,50.5%,49m
5259,3,brotato,2993,1388,100,94,194,51.5%,48m
5259,1,[DarkAG]Duffy,2993,556,17,23,40,42.5%,42m
5259,1,darkyun,2993,296,14,17,31,45.2%,8m
5259,2,[ZTemp]Observer,2993,300,12,4,16,75.0%,10m
5259,2,[FEST]Darwin,2993,0,0,1,1,0.0%,10m
5265,1,HappyTwoBe,2992,1243,45,44,89,50.6%,4m
5265,2,dollar,2992,718,29,21,50,58.0%,55m
5265,2,[K3oudy]Koudy,2992,668,26,22,48,54.2%,33m
5265,1,Erdbeerblau,2992,555,24,14,38,63.2%,42m
5265,1,[SLAMT]Enclave,2992,345,16,10,26,61.5%,32m
5265,1,Rayn,2992,450,16,17,33,48.5%,44m
5265,1,[DmEs]DelaroAlexDA,2992,88,2,1,3,66.7%,30m
5265,2,MIGHTYKING,2992,0,1,1,2,50.0%,10m
5265,2,yOOK,2992,0,0,1,1,0.0%,53m
5265,2,[BeSuzy]ARAGONK,2992,0,0,1,1,0.0%,34m
5265,3,IIIIIIIIIIII,2992,0,0,1,1,0.0%,20m
5265,1,merza,2992,0,0,5,5,0.0%,53m
5277,1,[FxB]dere,2991,719,27,27,54,50.0%,43m
5277,1,Nystagmus,2991,551,24,16,40,60.0%,56m
5277,1,tolss,2991,422,15,11,26,57.7%,46m
5277,2,Topher,2991,344,11,15,26,42.3%,6m
5277,1,[iDrunk]SlurpSack,2991,324,9,13,22,40.9%,40m
5277,3,albatoss,2991,191,7,4,11,63.6%,1h
5277,2,Waimea,2991,168,5,3,8,62.5%,16m
5277,2,KalVentis,2991,92,5,8,13,38.5%,33m
5277,2,QuantCheesin,2991,32,2,1,3,66.7%,37m
5277,2,[xRtGac]Zippy,2991,0,1,0,1,100.0%,35m
5277,2,[SOLNEM]SolNemesis,2991,0,0,1,1,0.0%,3h
5277,2,bbb,2991,0,0,1,1,0.0%,4m
5289,1,RockEnRolla,2990,1290,252,226,478,52.7%,14m
5289,3,BrainMachine,2990,1494,184,184,368,50.0%,8m
5289,1,Slar,2990,1581,137,133,270,50.7%,56m
5289,2,Milotook,2990,1636,83,59,142,58.5%,6m
5289,1,Vysedomo,2990,1043,63,55,118,53.4%,50m
5289,2,supertulon,2990,669,45,13,58,77.6%,40m
5289,1,[Ralphy]shablaman,2990,562,16,23,39,41.0%,56m
5289,1,yderf,2990,230,7,6,13,53.8%,8m
5289,2,[SC2DD]MadSon,2990,242,7,7,14,50.0%,55m
5289,1,IronChef,2990,0,4,2,6,66.7%,3m
5289,2,BobLouange,2990,0,2,3,5,40.0%,53m
5289,1,PussiDstryer,2990,36,1,4,5,20.0%,32m
5289,2,groverian,2990,0,0,1,1,0.0%,9m
5289,2,[GINGY]Fluffy,2990,0,0,1,1,0.0%,50m
5289,2,changhavv,2990,0,0,1,1,0.0%,44m
5304,1,klink,2989,696,21,28,49,42.9%,33m
5304,1,PenusChamp,2989,284,11,13,24,45.8%,13m
5304,2,JOCKBOY,2989,164,4,4,8,50.0%,41m
5304,2,TheLegiOn,2989,0,3,2,5,60.0%,50m
5304,2,[MIT]vEnhance,2989,0,1,0,1,100.0%,55m
5304,2,DrPotato,2989,0,1,1,2,50.0%,3m
5304,2,[BVR]cuts,2989,88,1,2,3,33.3%,41m
5304,3,CookieTime,2989,42,1,3,4,25.0%,21m
5312,1,Petrichor,2988,814,55,63,118,46.6%,31m
5312,3,[BigBrd]hazelnut,2988,830,33,33,66,50.0%,43m
5312,3,Habile,2988,450,16,21,37,43.2%,15m
5312,1,SelFelatio,2988,296,13,11,24,54.2%,37m
5312,1,[BL]Kevingalls,2988,368,10,12,22,45.5%,50m
5312,2,PEDROLANE,2988,254,9,8,17,52.9%,44m
5312,2,Eyeoh,2988,230,8,9,17,47.1%,48m
5312,1,[XpKb]Rterrakion,2988,160,6,3,9,66.7%,52m
5312,3,Zeolite,2988,90,2,5,7,28.6%,44m
5312,2,[COAI]GGXO,2988,0,1,0,1,100.0%,53m
5312,2,BlackSundown,2988,0,0,1,1,0.0%,53m
5323,2,[Pig2]Utlagi,2987,973,145,136,281,51.6%,6m
5323,1,EliteGhost,2987,1515,132,124,256,51.6%,43m
5323,1,Noodlelisk,2987,1419,51,52,103,49.5%,13m
5323,3,Nightshade,2987,429,50,47,97,51.5%,36m
5323,1,DigitalBath,2987,1028,36,36,72,50.0%,30m
5323,2,GetBONKED,2987,264,10,9,19,52.6%,47m
5323,1,[KCDah]qazwec,2987,224,7,10,17,41.2%,11m
5323,1,iQue,2987,152,4,9,13,30.8%,51m
5323,2,Dan,2987,60,3,1,4,75.0%,47m
5332,1,urgan,2986,836,104,82,186,55.9%,11m
5332,1,[Nfreak]Kerplunk,2986,945,84,87,171,49.1%,14m
5332,3,cassius,2986,890,49,42,91,53.8%,40m
5332,1,[xRtGac]Medivac,2986,1273,47,44,91,51.6%,44m
5332,1,[Zyn]Zynastor,2986,880,39,28,67,58.2%,53m
5332,2,Roke,2986,223,8,1,9,88.9%,1h
5332,3,Clarity,2986,143,3,1,4,75.0%,26m
5332,2,hihihi,2986,58,2,2,4,50.0%,13m
5332,1,[QOSQO]HarrYTM,2986,0,1,4,5,20.0%,3m
5341,1,Venom,2985,124,2,5,7,28.6%,50m
5341,2,[scMAUI]kanji,2985,0,1,0,1,100.0%,31m
5341,2,Linkkun,2985,0,1,0,1,100.0%,10m
5341,2,[HØST]Snakespe,2985,30,1,1,2,50.0%,11m
5341,1,crankx,2985,38,1,10,11,9.1%,37m
5346,1,[JMX]PARRA,2984,1520,219,211,430,50.9%,56m
5346,1,FXmarc,2984,330,34,15,49,69.4%,46m
5346,1,[Manus]Draft,2984,810,28,29,57,49.1%,55m
5346,1,[xLgNx]DANTE,2984,250,8,12,20,40.0%,4m
5346,2,[juggr]Gandalf,2984,88,3,5,8,37.5%,7m
5346,2,[SHART]SHARTYPANTS,2984,32,2,1,3,66.7%,33m
5346,1,Smegmma,2984,89,2,2,4,50.0%,56m
5346,2,Barcode,2984,0,2,3,5,40.0%,41m
5354,1,[QCHFLT]LosTankesFCO,2983,1501,75,71,146,51.4%,5m
5354,3,LikeAToss,2983,858,41,35,76,53.9%,8m
5354,1,[GYEA]ELcapitan,2983,951,36,31,67,53.7%,9m
5354,1,Cheebs,2983,489,20,17,37,54.1%,41m
5354,2,DJDespawn,2983,382,15,10,25,60.0%,45m
5354,1,Dactylus,2983,378,14,13,27,51.9%,31m
5354,1,AceAceAceAce,2983,213,8,7,15,53.3%,26m
5354,2,Kaann,2983,0,1,0,1,100.0%,47m
5362,2,CoralBeans,2982,403,33,11,44,75.0%,9m
5362,2,[MSet]tomzZor,2982,418,16,10,26,61.5%,47m
5362,2,Predator,2982,176,9,7,16,56.2%,34m
5362,1,[GTFOx2]isaac,2982,191,8,5,13,61.5%,50m
5362,1,[Sobro]Raynor,2982,279,8,8,16,50.0%,15m
5362,1,Guduranis,2982,0,4,1,5,80.0%,1h
5362,1,Fergy,2982,48,2,0,2,100.0%,1h
5362,2,[Whaaaa]Mathurin,2982,0,1,2,3,33.3%,15m
5362,2,Goatse,2982,0,0,1,1,0.0%,51m
5371,1,[illers]Westend,2981,884,194,177,371,52.3%,56m
5371,1,MittRomney,2981,1530,155,137,292,53.1%,4m
5371,3,[DXPCA]FJgg,2981,899,93,89,182,51.1%,11m
5371,3,Bowen,2981,1381,71,78,149,47.7%,16m
5371,1,Protagonist,2981,346,11,11,22,50.0%,49m
5371,1,[EThugz]WiZecraX,2981,272,10,10,20,50.0%,56m
5371,2,RedLabelL,2981,88,5,1,6,83.3%,50m
5378,2,PlayerTwo,2980,1461,145,110,255,56.9%,50m
5378,1,AGUINASIO,2980,1545,61,56,117,52.1%,56m
5378,1,zealot,2980,1449,54,51,105,51.4%,5m
5378,2,cmyr,2980,1106,47,36,83,56.6%,33m
5378,1,ClayWaifu,2980,784,30,28,58,51.7%,4m
5378,3,Anakin,2980,716,27,37,64,42.2%,7m
5378,1,Siecje,2980,282,11,9,20,55.0%,50m
5378,2,Veznite,2980,195,9,9,18,50.0%,37m
5378,2,[CHGGS]WillyThePimp,2980,0,3,2,5,60.0%,55m
5378,2,[CHZSCT]MorphingTime,2980,0,1,0,1,100.0%,46m
5388,2,[Notchd]luee,2979,1177,66,64,130,50.8%,37m
5388,2,[eX]Koébro,2979,313,13,12,25,52.0%,45m
5388,3,SgtSeastand,2979,297,10,14,24,41.7%,30m
5388,2,GooseWillis,2979,211,9,5,14,64.3%,47m
5388,3,Probability,2979,170,7,4,11,63.6%,4m
5388,1,[JCN]ACDCLIVE,2979,0,3,2,5,60.0%,3h
5388,2,Namae,2979,0,3,2,5,60.0%,45m
5388,2,Gandalf,2979,30,1,1,2,50.0%,11m
5396,3,[SUNBRA]thatsjustice,2978,1025,42,39,81,51.9%,53m
5396,1,Karma,2978,815,39,35,74,52.7%,46m
5396,1,Haste,2978,1011,36,43,79,45.6%,8m
5396,1,[HAWD]hulksmash,2978,452,15,17,32,46.9%,42m
5396,1,Mayucchi,2978,80,3,8,11,27.3%,46m
5396,2,DRSTRANGE,2978,0,1,0,1,100.0%,36m
5396,2,Prince,2978,0,0,1,1,0.0%,52m
5396,2,KYYYYYYY,2978,0,0,1,1,0.0%,1h
5396,1,[DSKapa]MIke,2978,0,0,6,6,0.0%,47m
5405,3,Cixelsyd,2977,1446,132,140,272,48.5%,34m
5405,2,Dare,2977,1591,73,56,129,56.6%,47m
5405,3,jed,2977,746,31,31,62,50.0%,11m
5405,2,HideousWizrd,2977,0,3,2,5,60.0%,47m
5405,2,WaaX,2977,0,3,2,5,60.0%,49m
5405,1,Superman,2977,0,1,3,4,25.0%,35m
5405,2,[old50s]Flyers,2977,0,1,4,5,20.0%,45m
5405,1,Hardlinemonk,2977,30,1,5,6,16.7%,44m
5413,1,Desciple,2976,431,23,19,42,54.8%,43m
5413,3,DoDawn,2976,116,2,4,6,33.3%,42m
5413,1,Winger,2976,36,1,4,5,20.0%,43m
5416,1,sunjay,2975,1585,59,53,112,52.7%,3m
5416,2,[HaMz]ebilice,2975,489,17,13,30,56.7%,32m
5416,2,Terranasaur,2975,321,14,10,24,58.3%,10m
5416,2,Baitall,2975,0,4,1,5,80.0%,33m
5420,1,HULKAMANIA,2974,1695,125,122,247,50.6%,37m
5420,1,glwwlg,2974,1385,53,49,102,52.0%,3m
5420,2,GreGo,2974,722,28,22,50,56.0%,4m
5420,2,Zepp,2974,493,19,17,36,52.8%,55m
5420,1,Esaliine,2974,405,16,16,32,50.0%,11m
5420,2,KopiOAis,2974,173,9,6,15,60.0%,10m
5420,1,crsy,2974,155,8,10,18,44.4%,46m
5420,2,Osiris,2974,0,1,0,1,100.0%,11m
5428,3,[SCTF]kaBz,2973,608,23,34,57,40.4%,53m
5428,3,DTCBoB,2973,351,15,13,28,53.6%,4m
5428,2,[INextI]Skyder,2973,336,11,14,25,44.0%,3m
5428,2,[STG]ElTrujas,2973,172,7,3,10,70.0%,47m
5428,2,[Boooiz]SourDough,2973,0,2,3,5,40.0%,13m
5428,3,[STAAAN]asVa,2973,0,1,1,2,50.0%,1h
5428,1,KupKaKe,2973,0,1,2,3,33.3%,51m
5428,2,[LATERs]HokkaiShime,2973,0,1,4,5,20.0%,12m
5428,2,[DarkLS]Arphoenyx,2973,0,0,1,1,0.0%,39m
5437,3,[GENNY]Metformin,2972,1595,192,189,381,50.4%,50m
5437,2,DingusOP,2972,920,68,56,124,54.8%,33m
5437,2,LuckyLarry,2972,503,22,10,32,68.8%,50m
5437,2,SquidSquad,2972,272,10,10,20,50.0%,10m
5437,2,Harry,2972,154,4,4,8,50.0%,8m
5437,2,[LBGF]anslod,2972,0,3,2,5,60.0%,6m
5437,1,AgentSmith,2972,0,3,2,5,60.0%,1h
5437,2,[TxT]Sopes,2972,115,3,3,6,50.0%,33m
5437,2,Relic,2972,0,1,0,1,100.0%,40m
5446,3,Spectactix,2971,1377,52,57,109,47.7%,32m
5446,1,[ExecUt]Alienshark,2971,899,35,32,67,52.2%,35m
5446,1,[ÐxStar]Gawain,2971,514,22,19,41,53.7%,52m
5446,2,[PiGPan]Draknas,2971,380,18,11,29,62.1%,55m
5446,2,[GOPERÚ]Caotic,2971,315,11,6,17,64.7%,6m
5446,1,ReZ,2971,348,11,15,26,42.3%,56m
5446,1,maurice,2971,328,11,17,28,39.3%,7m
5446,1,Forky,2971,284,8,6,14,57.1%,38m
5446,1,IIIIRiMIIII,2971,212,7,12,19,36.8%,32m
5446,2,Sar,2971,0,4,1,5,80.0%,33m
5446,2,Stormy,2971,132,3,1,4,75.0%,6m
5446,1,[n00b5]Logash,2971,0,3,2,5,60.0%,3h
5446,3,Alzales,2971,119,3,2,5,60.0%,37m
5446,1,[iDrunk]MaggieDad,2971,109,3,3,6,50.0%,46m
5446,2,llllllllllll,2971,112,2,1,3,66.7%,31m
5446,2,[IH8TOS]waltiostias,2971,0,2,3,5,40.0%,33m
5446,2,ImbaSimba,2971,0,0,1,1,0.0%,4m
5463,1,Serpentine,2970,1085,42,40,82,51.2%,41m
5463,2,Chaos,2970,576,26,20,46,56.5%,33m
5463,1,Whomp,2970,590,18,24,42,42.9%,48m
5463,1,STeven,2970,399,17,16,33,51.5%,47m
5463,2,MagnusXtian,2970,90,2,2,4,50.0%,1h
5463,2,DarkVhyll,2970,60,2,4,6,33.3%,10m
5463,2,yourleftball,2970,30,1,1,2,50.0%,5m
5463,1,PurpleInvazn,2970,0,0,1,1,0.0%,11m
5463,2,tekron,2970,0,0,2,2,0.0%,36m
5472,3,[MCPWN]Vindicator,2969,1507,195,190,385,50.6%,12m
5472,1,[DarkPG]ELMANCO,2969,529,31,23,54,57.4%,43m
5472,2,undeadfotr,2969,637,25,23,48,52.1%,45m
5472,1,[HENT4l]GoingPostal,2969,416,16,12,28,57.1%,5m
5472,2,[Yahoo]JayKay,2969,233,6,17,23,26.1%,14m
5472,2,theDreamKing,2969,141,5,3,8,62.5%,42m
5472,1,ToastDragon,2969,94,2,1,3,66.7%,1h
5472,2,[DarkAG]LvlTwoNinja,2969,64,2,3,5,40.0%,46m
5472,2,Savel,2969,0,1,0,1,100.0%,10m
5472,2,[GLit]LiquidNature,2969,0,1,1,2,50.0%,10m
5472,1,Snowcow,2969,42,1,1,2,50.0%,1h
5483,1,Strider,2968,665,40,36,76,52.6%,51m
5483,3,[WWP2]shaGz,2968,189,5,4,9,55.6%,34m
5483,2,Machete,2968,88,3,2,5,60.0%,52m
5483,2,Manguera,2968,0,0,1,1,0.0%,16m
5483,2,CREST,2968,0,0,1,1,0.0%,16m
5488,2,[missA]jman,2967,1241,446,415,861,51.8%,56m
5488,1,danny,2967,1306,47,46,93,50.5%,51m
5488,3,Valkyrie,2967,320,14,9,23,60.9%,15m
5488,1,jhomathy,2967,296,12,8,20,60.0%,27m
5488,2,[IMDSI]Murillox,2967,263,8,8,16,50.0%,55m
5488,3,[Wafflz]Waffelz,2967,180,7,3,10,70.0%,3h
5488,1,RonaldoJr,2967,184,5,5,10,50.0%,48m
5495,3,wepoopnloopn,2966,1623,203,206,409,49.6%,16m
5495,2,lllllIIIllll,2966,1477,119,99,218,54.6%,44m
5495,1,notKingVoulo,2966,1008,31,40,71,43.7%,3m
5495,2,[SCVM]FlySlendyGG,2966,438,17,10,27,63.0%,55m
5495,1,[dSLAP]DaBeans,2966,283,8,9,17,47.1%,42m
5495,1,[OSCC]SnakeCage,2966,0,3,2,5,60.0%,31m
5495,2,[gecko]tuxwhisperer,2966,0,0,1,1,0.0%,10m
5502,2,TuPapi,2965,1403,59,50,109,54.1%,31m
5502,3,ZackDaFuture,2965,1270,45,50,95,47.4%,49m
5502,2,[AiMB]Rudolpho,2965,269,9,5,14,64.3%,8m
5502,2,Superkewl,2965,30,5,3,8,62.5%,11m
5502,1,Thor,2965,0,4,1,5,80.0%,3h
5502,2,Xerxes,2965,98,4,4,8,50.0%,10m
5502,1,HelloWorld,2965,0,3,2,5,60.0%,14m
5502,2,[SLan]BlueSteel,2965,23,2,1,3,66.7%,40m
5502,2,Sciolist,2965,0,2,3,5,40.0%,51m
5502,2,SteamBOT,2965,30,1,4,5,20.0%,47m
5512,2,[AIN]jaimenak,2964,1493,65,54,119,54.6%,32m
5512,2,[OPbois]PassiveFist,2964,1543,61,57,118,51.7%,12m
5512,2,bOA,2964,1270,52,49,101,51.5%,42m
5512,1,[GnKSQd]CookieEater,2964,0,4,2,6,66.7%,50m
5512,3,blackice,2964,144,3,1,4,75.0%,24m
5512,2,[420CC]UncleDrew,2964,86,3,2,5,60.0%,46m
5512,2,Periodic,2964,30,2,0,2,100.0%,14m
5512,2,[ValidG]PoisonTrail,2964,30,2,0,2,100.0%,39m
5520,1,PetitFromage,2963,1518,333,309,642,51.9%,47m
5520,1,[TvagP]Dender,2963,1574,131,108,239,54.8%,8m
5520,1,BlueSol,2963,952,70,75,145,48.3%,5m
5520,3,Leafstep,2963,606,61,69,130,46.9%,7m
5520,2,Legion,2963,352,15,11,26,57.7%,41m
5520,1,Fuino,2963,232,10,8,18,55.6%,43m
5520,1,[ValidG]StepSister,2963,132,6,5,11,54.5%,40m
5520,1,[UAClan]grayfox,2963,150,5,8,13,38.5%,12m
5520,2,TossCraftSux,2963,58,3,0,3,100.0%,8m
5520,2,thomaskno,2963,0,3,2,5,60.0%,6m
5520,2,Zortor,2963,32,2,2,4,50.0%,6m
5520,2,[boatz]MightyWut,2963,0,0,1,1,0.0%,47m
5532,2,[TGosuB]ShinyDialga,2962,228,9,6,15,60.0%,10m
5532,2,DIALUP,2962,86,4,3,7,57.1%,33m
5532,1,Dethan,2962,116,4,11,15,26.7%,42m
5532,2,Crepuscular,2962,30,1,1,2,50.0%,33m
5532,1,[FFAA]KINGWAR,2962,34,1,7,8,12.5%,12m
5537,1,amipooping,2961,1548,118,104,222,53.2%,33m
5537,1,All,2961,294,11,13,24,45.8%,3m
5537,2,Pariseau,2961,218,10,8,18,55.6%,54m
5537,2,sykeasaurus,2961,270,10,9,19,52.6%,5m
5537,2,[SWOF]Inertiatic,2961,157,8,5,13,61.5%,10m
5537,1,Charon,2961,280,8,14,22,36.4%,30m
5537,3,happymunkee,2961,0,5,2,7,71.4%,43m
5537,3,HomerovCv,2961,121,4,5,9,44.4%,3h
5537,2,[N3RDST]BigJoeLogs,2961,0,1,0,1,100.0%,49m
5537,2,Tyrael,2961,0,1,0,1,100.0%,33m
5537,2,[NiERDS]bohdan,2961,0,1,0,1,100.0%,10m
5537,3,CateDraL,2961,0,0,1,1,0.0%,4m
5537,1,[CBTW]MyLocalNinja,2961,0,0,7,7,0.0%,45m
5550,2,Edge,2960,508,22,17,39,56.4%,44m
5550,1,EazyE,2960,441,14,16,30,46.7%,42m
5550,1,iZergYou,2960,332,11,17,28,39.3%,52m
5550,2,[HoFoCo]spoonodoom,2960,290,9,12,21,42.9%,50m
5550,2,TecFenix,2960,202,8,6,14,57.1%,33m
5550,1,AurA,2960,146,3,2,5,60.0%,1h
5550,2,EfourMAFIA,2960,0,1,0,1,100.0%,46m
5550,1,[T1G]ThatOneGuy,2960,0,1,2,3,33.3%,34m
5550,2,XxGamearayxX,2960,0,0,3,3,0.0%,52m
5550,2,PaxTor,2960,0,0,3,3,0.0%,46m
5560,2,MochiKat,2959,366,35,25,60,58.3%,4m
5560,1,[rshDIE]Baconidas,2959,575,29,19,48,60.4%,56m
5560,3,LuizPaulo,2959,482,17,25,42,40.5%,7m
5560,3,Jaydawg,2959,164,10,8,18,55.6%,54m
5560,2,RastaPigg,2959,120,5,3,8,62.5%,3m
5560,2,RecycleBin,2959,120,3,4,7,42.9%,4m
5566,1,esotericg,2958,1637,139,124,263,52.9%,56m
5566,1,Therapist,2958,1693,94,99,193,48.7%,45m
5566,2,Lastresort,2958,696,34,25,59,57.6%,51m
5566,3,LimYoHwan,2958,202,20,29,49,40.8%,14m
5566,1,[WWP2]scottdang,2958,354,18,13,31,58.1%,8m
5566,2,HamChoi,2958,381,12,12,24,50.0%,45m
5566,1,LeBas,2958,0,3,2,5,60.0%,1h
5566,1,FalconBeetle,2958,0,1,0,1,100.0%,60m
5566,1,Elliephant,2958,0,1,1,2,50.0%,30m
5575,1,[ZTemps]Sonder,2957,1330,60,60,120,50.0%,42m
5575,3,RickeyBobby,2957,796,34,41,75,45.3%,44m
5575,2,Daijoubu,2957,375,14,9,23,60.9%,36m
5575,2,[SPQ]RMJ,2957,346,11,8,19,57.9%,47m
5575,2,[MEye]Illuminatus,2957,63,10,8,18,55.6%,48m
5575,2,lllllllll,2957,122,5,3,8,62.5%,40m
5575,2,[WNTRLY]Athol,2957,94,2,3,5,40.0%,1h
5575,2,TrashCan,2957,0,1,0,1,100.0%,46m
5575,1,FirstToFire,2957,0,1,0,1,100.0%,1h
5575,1,Vegas,2957,0,1,1,2,50.0%,3h
5585,2,AnanZero,2956,0,3,2,5,60.0%,8m
5585,1,EpK,2956,0,3,2,5,60.0%,1h
5585,1,xboxsignout,2956,112,3,8,11,27.3%,43m
5585,1,eazyono,2956,43,3,8,11,27.3%,30m
5585,2,Bealzabub,2956,62,2,3,5,40.0%,14m
5585,2,[FMX]luchoxp,2956,0,1,1,2,50.0%,47m
5585,1,[Blacer]Darkmatter,2956,0,1,6,7,14.3%,3m
5585,2,JoeGreene,2956,0,0,1,1,0.0%,7m
5593,1,Chainmail,2955,285,11,11,22,50.0%,43m
5593,1,MagicPants,2955,172,6,9,15,40.0%,38m
5593,2,Plugger,2955,30,2,0,2,100.0%,10m
5593,2,sausey,2955,0,0,1,1,0.0%,50m
5597,2,Sensii,2954,1056,47,35,82,57.3%,39m
5597,3,KXMoon,2954,297,14,9,23,60.9%,34m
5597,2,[ScCLC]traceur,2954,292,13,8,21,61.9%,56m
5597,3,Blacknight,2954,121,4,6,10,40.0%,58m
5597,1,Bee,2954,0,3,2,5,60.0%,1h
5597,1,Fuzzydeath,2954,0,1,1,2,50.0%,3h
5597,2,Twilight,2954,30,1,2,3,33.3%,48m
5597,2,XxSPAZxX,2954,0,1,4,5,20.0%,53m
5597,2,BlackOp,2954,0,0,1,1,0.0%,56m
5606,1,[PDX503]orthodoxosis,2953,1687,173,178,351,49.3%,33m
5606,3,beto,2953,1467,98,100,198,49.5%,43m
5606,2,[MtnDwd]MuchosPylons,2953,386,23,19,42,54.8%,10m
5606,2,Bob,2953,186,6,2,8,75.0%,4m
5606,2,[Ppode]Tripode,2953,168,5,1,6,83.3%,5m
5606,1,Mitch,2953,0,3,2,5,60.0%,12m
5606,2,Quetzalcoatl,2953,86,3,4,7,42.9%,38m
5606,2,[CeNori]AzureGod,2953,58,2,2,4,50.0%,6m
5606,2,[Ninjas]EviLSuperman,2953,0,1,1,2,50.0%,41m
5606,2,[SnDICE]Random,2953,0,1,2,3,33.3%,51m
5616,1,YOROSHIKU,2952,812,116,91,207,56.0%,14m
5616,1,[Dmonik]Belial,2952,422,14,16,30,46.7%,12m
5616,1,Koro,2952,0,1,4,5,20.0%,1h
5616,2,IlIlllIlIIIl,2952,0,0,1,1,0.0%,1h
5616,2,[MvL]Coyote,2952,0,0,9,9,0.0%,1h
5621,1,fatboiee,2951,1032,36,42,78,46.2%,56m
5621,3,Nimzo,2951,318,14,15,29,48.3%,49m
5621,1,[Lost22]FrankLapidus,2951,350,13,10,23,56.5%,17m
5621,2,[NM8]JAIMELEPROX,2951,88,4,2,6,66.7%,55m
5621,2,beervirus,2951,120,3,0,3,100.0%,44m
5621,2,Jeff,2951,88,3,3,6,50.0%,10m
5621,2,Dstrange,2951,0,2,3,5,40.0%,12m
5621,2,[LNRZ]StarBuck,2951,0,1,0,1,100.0%,39m
5621,2,Ragnarok,2951,0,0,1,1,0.0%,10m
5630,2,Missingno,2950,1174,71,54,125,56.8%,15m
5630,1,[Slops]Mongo,2950,571,21,18,39,53.8%,6m
5630,2,Dart,2950,401,13,19,32,40.6%,50m
5630,1,[HØST]Pletz,2950,241,7,7,14,50.0%,41m
5630,2,Edminster,2950,118,5,3,8,62.5%,9m
5630,2,OtakuSlave,2950,0,1,0,1,100.0%,9m
5630,2,speedy,2950,30,1,2,3,33.3%,14m
5630,2,Vato,2950,30,1,4,5,20.0%,39m
5630,2,Majitsu,2950,0,0,1,1,0.0%,42m
5630,3,[3COX]HighCommand,2950,0,0,1,1,0.0%,56m
5640,2,NRF,2949,1602,142,129,271,52.4%,56m
5640,1,[OhSoEz]Jamm,2949,670,86,87,173,49.7%,53m
5640,2,baduserna,2949,1446,60,46,106,56.6%,53m
5640,1,[PRT]Tavo,2949,1202,42,46,88,47.7%,46m
5640,1,IgotoHarvard,2949,720,29,24,53,54.7%,3m
5640,2,[NSLB]Chuff,2949,223,6,9,15,40.0%,2m
5640,1,Static,2949,106,3,6,9,33.3%,41m
5640,2,bengbeng,2949,30,2,2,4,50.0%,11m
5640,2,Hirotto,2949,0,1,0,1,100.0%,3m
5640,1,scnightfire,2949,0,0,1,1,0.0%,3h
5650,1,[ÐxStar]JORGEX,2948,1680,207,204,411,50.4%,31m
5650,1,Kjubaran,2948,1240,48,48,96,50.0%,41m
5650,2,DeviousDonut,2948,727,29,27,56,51.8%,45m
5650,2,Nerdking,2948,410,16,9,25,64.0%,33m
5650,2,[WNTR]Liko,2948,165,9,3,12,75.0%,45m
5650,2,IIIIIIIIIIII,2948,179,9,5,14,64.3%,54m
5650,2,Fantasy,2948,182,5,9,14,35.7%,52m
5650,2,[TILL]HeadBanga,2948,0,2,1,3,66.7%,34m
5650,2,Jasper,2948,0,1,1,2,50.0%,48m
5650,1,[TERRlS]SupSon,2948,48,1,2,3,33.3%,3m
5650,2,[Xpk]mxpandrax,2948,0,0,1,1,0.0%,10m
5650,3,Shredling,2948,0,0,1,1,0.0%,3h
5650,2,Flash,2948,0,0,2,2,0.0%,6m
5663,2,NoLogic,2947,319,21,13,34,61.8%,31m
5663,2,Whatever,2947,420,15,14,29,51.7%,4m
5663,1,NullVoid,2947,300,9,16,25,36.0%,54m
5663,2,Race,2947,239,8,4,12,66.7%,32m
5663,2,oDiNe,2947,202,8,9,17,47.1%,36m
5663,1,Lila,2947,0,4,1,5,80.0%,44m
5663,1,hani,2947,0,1,5,6,16.7%,1h
5663,3,Eliza,2947,0,0,3,3,0.0%,1h
5671,2,Jeeewlyfe,2946,259,57,49,106,53.8%,33m
5671,1,JokerPW,2946,628,21,24,45,46.7%,8m
5671,2,NOUB,2946,274,9,9,18,50.0%,5m
5671,1,Venoma,2946,144,5,3,8,62.5%,1h
5671,1,[Ballz]Kaisad,2946,156,4,4,8,50.0%,33m
5671,1,[L3]chiubaka,2946,114,3,5,8,37.5%,8m
5671,1,ViciousV,2946,0,1,0,1,100.0%,3h
5671,1,[McRo]MiCrOsKiLLs,2946,30,1,4,5,20.0%,3m
5671,1,[Sune]ArcangelCR,2946,0,0,6,6,0.0%,43m
5680,3,ChiveX,2945,1422,86,91,177,48.6%,39m
5680,2,[MNGOMN]JAS,2945,960,55,52,107,51.4%,55m
5680,2,VISION,2945,370,16,10,26,61.5%,7m
5680,1,Ddpskizzle,2945,183,9,8,17,52.9%,31m
5680,2,ChillPenguin,2945,216,8,2,10,80.0%,6m
5680,3,AdrenalGHOST,2945,0,5,2,7,71.4%,1h
5680,2,[TGosuB]PROMETHIUM,2945,62,3,5,8,37.5%,9m
5680,2,[HvnDvl]Ekho,2945,0,1,0,1,100.0%,41m
5680,2,[3eve]jslocum,2945,0,1,0,1,100.0%,36m
5680,2,outer,2945,0,0,1,1,0.0%,32m
5680,2,SirSoDerp,2945,0,0,2,2,0.0%,14m
5680,1,[IDDS]InNoVaTiOn,2945,0,0,3,3,0.0%,3m
5692,2,Liumonster,2944,1580,194,190,384,50.5%,36m
5692,1,Amethyst,2944,931,39,34,73,53.4%,3m
5692,1,[S980K]juanitoOo,2944,771,26,35,61,42.6%,47m
5692,2,[0PGC0]Marat,2944,490,24,6,30,80.0%,3m
5692,1,Starius,2944,529,17,21,38,44.7%,4m
5692,2,NeuralParity,2944,192,7,6,13,53.8%,32m
5692,3,Deduks,2944,121,2,3,5,40.0%,1h
5692,1,[ACRE]Keniow,2944,0,0,1,1,0.0%,1h
5692,1,[f331]Grimlock,2944,0,0,1,1,0.0%,8m
5692,1,wiblyspceman,2944,0,0,2,2,0.0%,12m
5702,2,NGSerenity,2943,1568,146,123,269,54.3%,41m
5702,1,JustFlossed,2943,1505,57,59,116,49.1%,37m
5702,2,Archimedes,2943,186,23,13,36,63.9%,11m
5702,3,[SOOH]OneMustFall,2943,40,6,3,9,66.7%,1h
5702,2,[35of35]CRezent,2943,0,0,1,1,0.0%,1h
5707,1,funney,2942,1207,44,45,89,49.4%,41m
5707,1,[GreeDy]JteCreme,2942,657,28,25,53,52.8%,46m
5707,2,panda,2942,0,1,0,1,100.0%,46m
5710,2,SCV,2941,1603,267,242,509,52.5%,49m
5710,2,[DugNut]PrisonMike,2941,615,30,16,46,65.2%,50m
5710,1,EmperorPat,2941,337,26,36,62,41.9%,42m
5710,2,bigsmoke,2941,655,24,23,47,51.1%,51m
5710,2,Raka,2941,340,15,12,27,55.6%,32m
5710,1,Galerunner,2941,32,4,4,8,50.0%,3m
5710,1,[LCE]PULPIN,2941,110,4,6,10,40.0%,35m
5710,2,HairyProbe,2941,76,3,5,8,37.5%,10m
5710,1,[XZEROX]VoidWolf,2941,157,3,7,10,30.0%,48m
5710,2,OrLaWaDaaA,2941,102,2,1,3,66.7%,53m
5710,2,BizLeZ,2941,0,1,0,1,100.0%,49m
5710,2,PyLah,2941,0,1,0,1,100.0%,33m
5710,2,Bratkuchen,2941,42,1,2,3,33.3%,1h
5723,1,[GTWITM]xzjxxbtx,2940,1678,72,83,155,46.5%,56m
5723,2,PotatoPc,2940,557,23,20,43,53.5%,9m
5723,1,sudo,2940,334,12,12,24,50.0%,43m
5723,2,Tevish,2940,184,5,3,8,62.5%,2m
5723,1,UrineTrouble,2940,120,4,3,7,57.1%,32m
5723,2,nutso,2940,0,1,0,1,100.0%,56m
5729,1,Kenfucious,2939,967,40,36,76,52.6%,55m
5729,2,hagar,2939,369,36,37,73,49.3%,38m
5729,2,Mars,2939,517,22,12,34,64.7%,5m
5729,2,StormzBG,2939,506,22,15,37,59.5%,47m
5729,2,ironblade,2939,544,21,22,43,48.8%,42m
5729,1,GrandCaravan,2939,587,21,22,43,48.8%,55m
5729,3,[LPDeTV]DieGGoth,2939,351,15,14,29,51.7%,4m
5729,1,ztek,2939,174,4,8,12,33.3%,46m
5729,1,TerribleSS,2939,133,3,5,8,37.5%,19m
5729,2,PapaSmurf,2939,0,2,2,4,50.0%,10m
5729,2,MrBananas,2939,116,2,5,7,28.6%,46m
5729,2,Joker,2939,0,1,4,5,20.0%,46m
5729,2,[SHle]Sergio,2939,0,0,1,1,0.0%,8m
5742,1,SirCharles,2938,1657,449,431,880,51.0%,43m
5742,2,Zaklee,2938,288,10,7,17,58.8%,14m
5742,1,[Pro2os]FireFistAce,2938,175,8,12,20,40.0%,35m
5742,2,NappingTiger,2938,184,4,3,7,57.1%,51m
5742,2,Joshytime,2938,30,1,1,2,50.0%,53m
5742,2,[WLFSPK]WolfsButcher,2938,0,0,1,1,0.0%,35m
5742,2,[PacK]Goodmourning,2938,0,0,1,1,0.0%,8m
5742,3,[LATINX]TyraelDie,2938,0,0,1,1,0.0%,43m
5742,2,[KhanZ]Buttzilla,2938,0,0,2,2,0.0%,45m
5742,1,aeggin,2938,0,0,3,3,0.0%,3h
5742,2,[ZsDrag]DragonZeus,2938,0,0,3,3,0.0%,5m
5753,1,ZafnatPaneaj,2937,1664,413,395,808,51.1%,34m
5753,1,[GRNSKN]MasterJames,2937,1661,170,143,313,54.3%,49m
5753,2,suripat,2937,376,13,11,24,54.2%,8m
5753,2,[Pharoh]snowdrop,2937,269,9,4,13,69.2%,50m
5757,1,[tCo9]Syl,2936,898,73,60,133,54.9%,50m
5757,1,[Fir3s]RisingSun,2936,0,1,0,1,100.0%,3h
5757,1,hollabrrack,2936,48,1,2,3,33.3%,12m
5757,3,MasonisHiga,2936,0,0,2,2,0.0%,1h
5757,2,TheHOG,2936,0,0,4,4,0.0%,4m
5762,2,Uverga,2935,395,85,73,158,53.8%,3m
5762,2,FXmarc,2935,412,18,14,32,56.2%,11m
5762,1,[iTrolI]Badgerfc,2935,432,13,16,29,44.8%,12m
5762,2,StreetFightR,2935,224,4,9,13,30.8%,6m
5762,2,[BaIIz]almightyalf,2935,58,3,6,9,33.3%,47m
5762,2,Nightmare,2935,115,2,3,5,40.0%,35m
5762,2,poltergeist,2935,60,2,4,6,33.3%,10m
5762,3,Krucyble,2935,0,1,0,1,100.0%,30m
5762,2,Coldfire,2935,0,1,0,1,100.0%,40m
5771,2,VRman,2934,1597,117,74,191,61.3%,52m
5771,2,guevarodrigo,2934,977,44,33,77,57.1%,10m
5771,2,verjox,2934,323,11,9,20,55.0%,33m
5771,2,James,2934,188,10,9,19,52.6%,39m
5771,1,[TurNT]Coletrain,2934,116,3,4,7,42.9%,42m
5771,2,Zealot,2934,0,1,0,1,100.0%,46m
5771,2,[GLov]BLorD,2934,0,1,0,1,100.0%,6m
5771,2,beniceplease,2934,0,0,1,1,0.0%,42m
5771,2,Daniel,2934,0,0,1,1,0.0%,42m
5780,3,Yamanouchi,2933,1454,116,103,219,53.0%,3m
5780,2,Bryson,2933,671,32,12,44,72.7%,36m
5780,2,[TCD]Neferio,2933,565,23,15,38,60.5%,14m
5780,2,MediOgre,2933,322,11,9,20,55.0%,7m
5780,1,Duffman,2933,324,9,12,21,42.9%,12m
5780,2,[Paklys]Tyflikw,2933,212,7,8,15,46.7%,9m
5780,2,[xAlURx]Tanua,2933,130,4,6,10,40.0%,46m
5780,2,Yalos,2933,0,3,2,5,60.0%,6m
5780,2,Hummus,2933,90,3,3,6,50.0%,10m
5780,2,[RiskCo]BlackAttack,2933,58,2,3,5,40.0%,36m
5780,1,[1025]HyperVirus,2933,0,1,2,3,33.3%,35m
5780,2,helmaroc,2933,0,0,1,1,0.0%,46m
5792,2,RANDOM,2932,1670,130,123,253,51.4%,11m
5792,1,[INCARD]Brownard,2932,1611,85,73,158,53.8%,56m
5792,1,AsIWasSaying,2932,973,79,80,159,49.7%,38m
5792,2,ledevourer,2932,316,12,10,22,54.5%,36m
5792,2,Icarus,2932,102,4,3,7,57.1%,56m
5792,2,WingZero,2932,58,3,1,4,75.0%,39m
5792,1,Zero,2932,90,2,6,8,25.0%,51m
5792,2,[GRNSKN]Ebondawn,2932,30,1,1,2,50.0%,34m
5792,3,FrenzyMaster,2932,0,0,1,1,0.0%,1h
5801,3,KachunK,2931,1028,216,221,437,49.4%,13m
5801,1,maximus,2931,1297,87,79,166,52.4%,54m
5801,1,[The248]LTon,2931,1033,53,57,110,48.2%,5m
5801,2,OrganEyes,2931,60,3,5,8,37.5%,46m
5801,1,Yummmens,2931,0,2,10,12,16.7%,13m
5801,2,[ng123]FENIXSOMBRA,2931,0,0,1,1,0.0%,52m
5807,3,Radius,2930,1530,248,248,496,50.0%,14m
5807,3,[EvilGC]MaxFire,2930,1596,227,225,452,50.2%,16m
5807,2,[SWMX]Poethi,2930,331,12,8,20,60.0%,4m
5807,2,Blade,2930,323,12,17,29,41.4%,36m
5807,1,[FORCE9]Rhazz,2930,188,7,10,17,41.2%,37m
5807,3,[PRDX]opme,2930,146,4,3,7,57.1%,3h
5807,2,Cloudy,2930,160,4,3,7,57.1%,8m
5807,2,Geezer,2930,88,3,3,6,50.0%,36m
5807,2,pewp,2930,0,1,4,5,20.0%,47m
5816,3,Chronic,2929,724,77,76,153,50.3%,31m
5816,2,Golddagger,2929,1042,46,30,76,60.5%,6m
5816,2,Noobforreal,2929,0,4,1,5,80.0%,36m
5816,1,TRYHARDVIRGN,2929,121,4,3,7,57.1%,16m
5816,1,ToiletDive,2929,30,2,2,4,50.0%,11m
5816,2,[N1C3]Liberspartan,2929,0,1,0,1,100.0%,10m
5816,2,[TGosuA]Ramshack,2929,0,0,2,2,0.0%,36m
5823,1,bisleksik,2928,529,19,22,41,46.3%,47m
5823,2,Emperor,2928,338,14,7,21,66.7%,54m
5823,2,Sirius,2928,267,10,7,17,58.8%,18m
5823,1,[PANN]Stryder,2928,317,10,15,25,40.0%,41m
5823,3,Milhouse,2928,181,5,8,13,38.5%,42m
5823,2,pingasolina,2928,30,4,3,7,57.1%,51m
5823,2,Squirtle,2928,36,1,2,3,33.3%,10m
5823,2,Rapture,2928,0,0,1,1,0.0%,2m
5831,1,[BlHawk]Quantum,2927,1127,72,68,140,51.4%,11m
5831,2,Fonlon,2927,1160,56,51,107,52.3%,5m
5831,2,SelendisOWO,2927,431,19,9,28,67.9%,16m
5831,2,Harkonnen,2927,120,5,5,10,50.0%,3m
5831,1,meme,2927,48,2,0,2,100.0%,1h
5831,2,Blank,2927,88,2,4,6,33.3%,6m
5831,2,fartburn,2927,58,2,5,7,28.6%,56m
5831,2,Ganjalf,2927,0,1,0,1,100.0%,46m
5831,2,jpppppp,2927,0,1,3,4,25.0%,2m
5831,2,EpicNoob,2927,0,0,1,1,0.0%,5m
5831,2,[DNDY]AqueeriusX,2927,0,0,2,2,0.0%,4m
5842,2,DoctorGentle,2926,406,17,16,33,51.5%,5m
5842,2,Alkazarl,2926,299,13,12,25,52.0%,15m
5842,2,eCakes,2926,202,7,7,14,50.0%,38m
5842,2,cardab,2926,167,6,3,9,66.7%,13m
5842,2,RideSix,2926,90,4,5,9,44.4%,42m
5842,2,Ouro,2926,114,3,1,4,75.0%,33m
5842,2,Panthre,2926,30,3,4,7,42.9%,49m
5842,2,kekkers,2926,62,2,6,8,25.0%,15m
5850,2,llllllllllll,2925,707,26,25,51,51.0%,3m
5850,2,[Grayon]CPCHOWDER,2925,465,19,13,32,59.4%,41m
5850,1,BonerGuideMe,2925,256,10,10,20,50.0%,13m
5850,1,AluPIgus,2925,214,6,15,21,28.6%,8m
5850,1,commetamere,2925,48,5,3,8,62.5%,1h
5850,1,Clutch,2925,121,5,10,15,33.3%,27m
5850,2,Visceroid,2925,116,4,4,8,50.0%,48m
5850,2,JoeyK,2925,0,0,1,1,0.0%,46m
5850,2,iDrone,2925,0,0,3,3,0.0%,49m
5859,1,GreatGatsby,2924,1546,349,329,678,51.5%,7m
5859,3,[Khalta]ARCANGEL,2924,398,210,217,427,49.2%,55m
5859,3,mmmmmcookies,2924,1509,151,150,301,50.2%,13m
5859,1,StoneyBalony,2924,808,25,31,56,44.6%,36m
5859,2,Crazed,2924,490,19,16,35,54.3%,44m
5859,2,campbel,2924,559,18,26,44,40.9%,50m
5859,2,[WTSH]Luffman,2924,314,11,11,22,50.0%,50m
5859,3,[PwnCat]MrBojangles,2924,195,10,2,12,83.3%,1h
5859,2,[No0Bs]Guff,2924,132,3,3,6,50.0%,11m
5859,1,Ambrella,2924,97,2,4,6,33.3%,1h
5859,2,[INextI]sirlorddavid,2924,30,1,3,4,25.0%,36m
5859,2,[GØSU]Virtual,2924,0,1,4,5,20.0%,13m
5871,3,Dilly,2923,1012,91,93,184,49.5%,14m
5871,2,TAZ,2923,313,12,6,18,66.7%,45m
5871,1,MortTheBort,2923,48,5,3,8,62.5%,3h
5871,2,Young,2923,116,5,5,10,50.0%,15m
5871,2,xDiShPiGx,2923,120,5,5,10,50.0%,35m
5871,2,Haybale,2923,166,4,7,11,36.4%,18m
5871,2,Pyro,2923,82,2,4,6,33.3%,36m
5871,1,[PNKN]Peadan,2923,0,1,0,1,100.0%,36m
5871,1,[PPAP]SmartSputnik,2923,0,1,4,5,20.0%,6m
5871,2,[RealMK]PackLips,2923,0,0,1,1,0.0%,3h
5871,1,Euphoric,2923,0,0,1,1,0.0%,3h
5882,3,[VENSC2]Wasabi,2922,1416,92,97,189,48.7%,3m
5882,2,[VFam2]Sirgamermore,2922,374,16,9,25,64.0%,46m
5882,2,RIGOTICO,2922,340,13,8,21,61.9%,33m
5882,1,[PSlSTC]reaper,2922,334,12,12,24,50.0%,31m
5882,2,Shadow,2922,201,7,3,10,70.0%,52m
5882,2,Nutella,2922,228,7,5,12,58.3%,40m
5882,2,[IDKH]Barbro,2922,30,2,1,3,66.7%,54m
5882,2,Cartman,2922,0,2,3,5,40.0%,56m
5882,2,[LFUT]Alexis,2922,30,1,1,2,50.0%,6m
5882,2,Hybrid,2922,0,0,2,2,0.0%,50m
5892,1,[SCMK]Abuelo,2921,1338,85,77,162,52.5%,54m
5892,1,SniperRaynor,2921,444,18,18,36,50.0%,57m
5892,1,Kahoyt,2921,204,8,8,16,50.0%,38m
5892,2,SylvanNight,2921,190,6,3,9,66.7%,10m
5892,2,Wubb,2921,30,1,1,2,50.0%,4m
5892,1,[RwtM]Machaube,2921,97,1,1,2,50.0%,3h
5892,2,Galaxy,2921,0,0,1,1,0.0%,54m
5892,2,Avefenix,2921,0,0,1,1,0.0%,52m
5900,2,[YD2K]BlaqSasQuach,2920,1583,132,114,246,53.7%,15m
5900,2,[sk3tch]Lowko,2920,1610,112,105,217,51.6%,15m
5900,2,Pandemic,2920,130,5,0,5,100.0%,10m
5900,1,MrSpecial,2920,92,2,0,2,100.0%,1h
5900,1,Jonakill,2920,48,1,8,9,11.1%,17m
5900,2,lobonator,2920,0,0,1,1,0.0%,48m
5906,3,SpeedySloth,2919,247,9,8,17,52.9%,5m
5906,2,Striker,2919,202,6,5,11,54.5%,53m
5906,2,Bloodfuser,2919,60,2,8,10,20.0%,3m
5909,1,Gin,2918,1588,109,112,221,49.3%,55m
5909,2,forgetone,2918,685,28,22,50,56.0%,46m
5909,2,SEQUEL,2918,429,26,20,46,56.5%,32m
5909,2,[TERRI]Jahovarasta,2918,600,24,24,48,50.0%,3m
5909,2,SandKing,2918,418,18,12,30,60.0%,52m
5909,2,grannit,2918,254,14,11,25,56.0%,45m
5909,1,Maxpie,2918,228,10,9,19,52.6%,28m
5909,1,fork,2918,157,7,6,13,53.8%,41m
5909,2,HANS,2918,0,3,2,5,60.0%,56m
5909,1,Morgan,2918,0,0,1,1,0.0%,29m
5919,2,[F0cus]Devonian,2917,581,23,21,44,52.3%,47m
5919,2,[UGDC]convictioN,2917,420,18,14,32,56.2%,4m
5919,2,darkdiamond,2917,208,7,8,15,46.7%,36m
5919,1,OUOU,2917,97,4,3,7,57.1%,1h
5919,2,cemt,2917,88,3,3,6,50.0%,47m
5919,2,dreambeing,2917,118,3,7,10,30.0%,15m
5919,2,Andy,2917,0,1,0,1,100.0%,41m
5926,1,AssyMcgee,2916,951,60,53,113,53.1%,44m
5926,2,Radical,2916,638,27,21,48,56.2%,54m
5926,3,[URQ]McPupu,2916,40,5,3,8,62.5%,1h
5926,2,[kØ]Agronor,2916,146,5,5,10,50.0%,56m
5926,2,[LOLITO]Lumpitaz,2916,0,1,0,1,100.0%,33m
5926,1,XBlackDracoX,2916,0,1,0,1,100.0%,3h
5926,3,OneUp,2916,0,1,1,2,50.0%,43m
5926,2,qGhee,2916,0,1,4,5,20.0%,52m
5934,2,bobnelson,2915,1147,47,41,88,53.4%,15m
5934,2,StorminNorm,2915,1140,41,46,87,47.1%,47m
5934,2,LSDx,2915,376,18,15,33,54.5%,7m
5934,2,BabyEater,2915,369,16,10,26,61.5%,15m
5934,2,[BHOG]Malkintosh,2915,0,2,4,6,33.3%,44m
5934,2,DarKSooN,2915,0,0,1,1,0.0%,33m
5940,1,Scurrilous,2914,1016,50,48,98,51.0%,33m
5940,1,Konig,2914,1091,45,45,90,50.0%,5m
5940,2,pidgey,2914,553,22,23,45,48.9%,44m
5940,2,intrepidmonk,2914,488,21,16,37,56.8%,31m
5940,3,[KGH]XtremeJPR,2914,328,11,22,33,33.3%,40m
5940,2,Arganova,2914,203,8,8,16,50.0%,1h
5940,2,frontbutfevr,2914,130,4,1,5,80.0%,31m
5940,3,[DCGA]TheSpot,2914,139,3,8,11,27.3%,33m
5940,1,Search,2914,0,1,0,1,100.0%,43m
5940,2,[RinNya]Alice,2914,0,0,1,1,0.0%,8m
5950,1,Jauvil,2913,1654,332,319,651,51.0%,8m
5950,3,TheBoxeR,2913,1572,113,118,231,48.9%,47m
5950,2,bakihanma,2913,648,46,40,86,53.5%,46m
5950,2,Jdogg,2913,295,12,5,17,70.6%,32m
5950,2,Drip,2913,224,11,6,17,64.7%,3m
5950,2,DaftTank,2913,286,11,10,21,52.4%,49m
5950,2,Laughingman,2913,200,8,7,15,53.3%,8m
5950,3,HARMICHAEL,2913,201,7,3,10,70.0%,56m
5950,1,[forces]DeathRaven,2913,173,5,3,8,62.5%,1h
5950,2,GalaxyBrain,2913,88,4,2,6,66.7%,6m
5950,2,[oxen]WarrPig,2913,0,2,4,6,33.3%,8m
5950,2,Croaker,2913,30,1,3,4,25.0%,45m
5950,1,Zurat,2913,0,1,4,5,20.0%,39m
5950,2,Caid,2913,0,0,1,1,0.0%,41m
5964,1,[sk3tch]MRGoldenPaws,2912,363,12,16,28,42.9%,51m
5964,2,Probelims,2912,258,11,4,15,73.3%,42m
5964,2,[XpKb]WhiteVoid,2912,187,11,10,21,52.4%,38m
5964,2,[EXTC]Arthur,2912,300,11,10,21,52.4%,39m
5964,1,Disboard,2912,221,6,7,13,46.2%,1h
5964,1,[PHNTMS]Dabthulhu,2912,0,3,3,6,50.0%,30m
5970,1,Luca,2911,837,30,32,62,48.4%,55m
5970,2,dangree,2911,543,19,24,43,44.2%,4m
5970,2,all,2911,90,4,5,9,44.4%,49m
5970,2,[SCX2]CRIAGarm,2911,124,4,7,11,36.4%,50m
5970,2,Tito,2911,0,3,2,5,60.0%,41m
5970,3,[3kIQ]Scurvy,2911,0,1,0,1,100.0%,15m
5970,2,wildflower,2911,0,0,2,2,0.0%,7m
5977,2,[Zion]CaskStrength,2910,860,122,107,229,53.3%,56m
5977,2,anaujiraM,2910,1259,62,65,127,48.8%,10m
5977,1,Efadrael,2910,1224,43,50,93,46.2%,46m
5977,2,ImpAsauruS,2910,423,17,15,32,53.1%,6m
5977,1,[MiaoM]Tonytan,2910,530,17,27,44,38.6%,49m
5977,2,Jrod,2910,274,10,11,21,47.6%,50m
5977,2,[Pinoys]HaniSalam,2910,208,6,5,11,54.5%,56m
5977,2,Mercy,2910,112,4,4,8,50.0%,46m
5977,2,DrSeuss,2910,0,3,2,5,60.0%,54m
5977,2,VeridisQuo,2910,62,2,5,7,28.6%,6m
5977,1,[SnCity]TMan,2910,84,2,13,15,13.3%,42m
5977,2,AtoTheK,2910,0,1,1,2,50.0%,33m
5977,2,[pntoCL]jjXploittCL,2910,0,0,1,1,0.0%,10m
5990,1,[TGosuA]bunK,2909,680,22,28,50,44.0%,43m
5990,2,IIIIIIIIIIII,2909,243,11,5,16,68.8%,46m
5990,2,[Rela]JamirL,2909,279,10,7,17,58.8%,49m
5990,2,IIIIIIIIIIII,2909,260,9,7,16,56.2%,46m
5990,2,WashNMachine,2909,221,8,5,13,61.5%,41m
5990,2,Maverik,2909,120,5,6,11,45.5%,33m
5990,2,Raziel,2909,0,3,2,5,60.0%,52m
5990,1,ramunemarble,2909,122,3,7,10,30.0%,53m
5990,1,Kaisher,2909,48,2,0,2,100.0%,42m
5990,2,aldeon,2909,114,2,2,4,50.0%,36m
5990,2,Merlin,2909,0,1,0,1,100.0%,46m
6001,1,NooK,2908,969,39,34,73,53.4%,45m
6001,2,[KnG]Endless,2908,184,6,8,14,42.9%,53m
6001,1,Blardin,2908,142,5,3,8,62.5%,3h
6001,1,Emressynn,2908,0,4,1,5,80.0%,50m
6001,1,Madeline,2908,48,4,3,7,57.1%,50m
6001,2,[HvnDvl]DROOF,2908,78,3,7,10,30.0%,4m
6001,2,[ExcIgN]InsertText,2908,0,1,1,2,50.0%,31m
6008,2,omgECYOR,2907,305,12,8,20,60.0%,41m
6008,1,PetePeterson,2907,204,8,8,16,50.0%,33m
6008,2,Slicy,2907,112,2,2,4,50.0%,41m
6008,3,KingTrump,2907,97,1,1,2,50.0%,43m
6008,2,[OceanT]MulatoPampu,2907,0,0,1,1,0.0%,46m
6008,1,Bubba,2907,0,0,1,1,0.0%,58m
6008,2,Barbaro,2907,0,0,2,2,0.0%,39m
6015,2,[Dogee]biznatch,2906,1010,37,35,72,51.4%,8m
6015,2,Dontbemad,2906,331,14,14,28,50.0%,46m
6015,2,Fourlan,2906,219,8,4,12,66.7%,45m
6015,2,DormantGamer,2906,138,4,2,6,66.7%,11m
6015,2,Herpderk,2906,86,4,4,8,50.0%,15m
6015,1,RenieHouR,2906,0,3,3,6,50.0%,1h
6015,2,Nilbog,2906,58,3,3,6,50.0%,2m
6015,2,[sk3tch]Calm,2906,94,3,4,7,42.9%,3m
6015,1,[BroBlo]Axumi,2906,96,2,3,5,40.0%,6m
6015,2,[TEAMiE]IEJimRaynor,2906,0,2,3,5,40.0%,52m
6015,2,Foozbond,2906,0,0,1,1,0.0%,40m
6026,2,[psych]nurse,2905,1273,142,138,280,50.7%,46m
6026,1,Theleech,2905,1588,103,81,184,56.0%,50m
6026,1,Thal,2905,1509,60,63,123,48.8%,55m
6026,2,Exarch,2905,683,26,23,49,53.1%,16m
6026,3,TaZ,2905,554,21,31,52,40.4%,4m
6026,2,[BoRnGo]DarthJulius,2905,239,9,7,16,56.2%,53m
6026,2,FecalTxn,2905,212,9,7,16,56.2%,7m
6026,2,RegularName,2905,198,8,8,16,50.0%,5m
6026,2,[FloFam]Derpy,2905,116,3,1,4,75.0%,52m
6026,2,xiboloxd,2905,0,2,3,5,40.0%,8m
6026,2,megadeth,2905,30,1,2,3,33.3%,32m
6026,2,[WaUN]Labraid,2905,0,0,1,1,0.0%,35m
6026,2,chuushi,2905,0,0,1,1,0.0%,42m
6026,2,[IRnewb]VladditZ,2905,0,0,2,2,0.0%,7m
6040,1,nihaoma,2904,1623,481,465,946,50.8%,9m
6040,2,Strife,2904,1138,54,39,93,58.1%,8m
6040,2,Greedy,2904,835,38,24,62,61.3%,56m
6040,2,[RLSM]crankx,2904,572,22,18,40,55.0%,4m
6040,2,Altecman,2904,247,15,5,20,75.0%,4m
6040,2,LLLLLLLLLLl,2904,403,15,12,27,55.6%,46m
6040,2,[FyHr]CharlyCox,2904,118,5,4,9,55.6%,6m
6040,2,TurtleSageWS,2904,130,4,1,5,80.0%,3m
6040,2,Bonta,2904,0,3,2,5,60.0%,42m
6040,2,Stevo,2904,0,1,0,1,100.0%,50m
6040,2,Mark,2904,0,1,1,2,50.0%,41m
6051,2,Opponent,2903,1575,130,111,241,53.9%,5m
6051,2,theunknown,2903,1455,92,16,108,85.2%,39m
6051,1,aeoniq,2903,1030,33,38,71,46.5%,54m
6051,2,TReXXX,2903,750,26,31,57,45.6%,38m
6051,2,[FL4]PoCoYo,2903,410,14,12,26,53.8%,31m
6051,3,JohnRiley,2903,172,7,5,12,58.3%,19m
6051,2,[hTx]DiOrcus,2903,120,5,8,13,38.5%,46m
6051,2,toyorom,2903,0,1,0,1,100.0%,35m
6051,2,DaDrunkTinMa,2903,0,1,4,5,20.0%,3h
6060,2,Dassand,2902,1530,231,205,436,53.0%,47m
6060,2,Gulain,2902,1178,149,153,302,49.3%,10m
6060,1,HUGE,2902,1133,44,43,87,50.6%,43m
6060,2,Xanthus,2902,839,35,30,65,53.8%,3m
6060,1,sincerebnana,2902,838,27,32,59,45.8%,51m
6060,2,[Astute]Earlyreraise,2902,568,25,15,40,62.5%,39m
6060,1,PrpaneDreams,2902,406,17,15,32,53.1%,50m
6060,2,Ultralisk,2902,296,11,14,25,44.0%,6m
6060,1,SomeJobber,2902,151,4,8,12,33.3%,39m
6060,2,CHOOCH,2902,0,3,2,5,60.0%,3h
6060,2,[FFAA]Akopian,2902,0,2,3,5,40.0%,3h
6060,2,Faygala,2902,0,1,0,1,100.0%,35m
6060,2,[X17]WryWonder,2902,0,1,0,1,100.0%,32m
6060,2,Mosckvin,2902,0,0,1,1,0.0%,15m
6060,2,cuchi,2902,0,0,2,2,0.0%,7m
6075,2,Oblique,2901,804,49,43,92,53.3%,2m
6075,1,CoreyJJ,2901,823,27,33,60,45.0%,49m
6075,2,ONEOKROCK,2901,178,6,4,10,60.0%,6m
6075,2,dfd,2901,180,6,8,14,42.9%,31m
6075,3,Humongous,2901,148,5,6,11,45.5%,44m
6075,2,pooder,2901,0,4,1,5,80.0%,41m
6075,2,IEsouL,2901,0,2,3,5,40.0%,6m
6075,1,[SWCG]Ultralisk,2901,44,1,1,2,50.0%,45m
6075,2,oscarluq,2901,88,1,1,2,50.0%,35m
6075,2,Noodle,2901,0,0,1,1,0.0%,49m
6085,1,DeGen,2900,1341,79,76,155,51.0%,36m
6085,3,BladeRunner,2900,1503,60,66,126,47.6%,36m
6085,2,[YelJaK]BlazinBlind,2900,898,34,35,69,49.3%,46m
6085,1,JoeBiden,2900,824,30,33,63,47.6%,37m
6085,2,[SyLx]NightMoose,2900,486,18,18,36,50.0%,44m
6085,1,BaZinga,2900,432,15,20,35,42.9%,36m
6091,2,[KanZan]KanSanZio,2899,1268,255,247,502,50.8%,38m
6091,1,[DarkPG]DabMax,2899,1629,171,167,338,50.6%,13m
6091,2,Dangelo,2899,1503,168,153,321,52.3%,50m
6091,2,PondEnjoyer,2899,252,28,24,52,53.8%,15m
6091,2,AyaseXKirino,2899,441,18,11,29,62.1%,31m
6091,1,Tekrebel,2899,381,14,16,30,46.7%,4m
6091,1,[Idkfu]DrinkWater,2899,284,13,9,22,59.1%,36m
6091,2,[hz21]hectorcito,2899,175,8,5,13,61.5%,32m
6091,1,James,2899,93,5,1,6,83.3%,3m
6091,2,[UpeV]RikrdoDj,2899,171,4,7,11,36.4%,41m
6091,2,BEEEEJ,2899,168,4,11,15,26.7%,45m
6091,2,POPka,2899,30,3,2,5,60.0%,33m
6091,2,JasonMraz,2899,0,0,1,1,0.0%,48m
6104,1,Trichomonas,2898,1644,360,339,699,51.5%,7m
6104,2,SuperLeroy,2898,226,9,9,18,50.0%,5m
6104,2,MorningWood,2898,216,7,5,12,58.3%,44m
6104,1,Already,2898,223,7,11,18,38.9%,33m
6104,2,Maverick,2898,90,4,3,7,57.1%,39m
6104,1,Pogo,2898,159,4,5,9,44.4%,3h
6104,1,pat,2898,192,4,11,15,26.7%,13m
6104,2,[TruckU]Syrus,2898,0,3,2,5,60.0%,6m
6104,1,bdfg,2898,97,2,0,2,100.0%,1h
6104,2,[burg3r]Astrydax,2898,30,1,2,3,33.3%,54m
6104,2,Lunick,2898,30,1,3,4,25.0%,46m
6104,2,Eclipse,2898,0,1,3,4,25.0%,31m
6104,2,markul,2898,0,0,1,1,0.0%,32m
6117,2,[Macac0]DANTEx,2897,1557,144,132,276,52.2%,16m
6117,3,VSEPR,2897,1446,61,72,133,45.9%,36m
6117,1,zim,2897,695,29,35,64,45.3%,44m
6117,2,DennyDeniro,2897,282,11,7,18,61.1%,38m
6117,2,Clyde,2897,306,11,13,24,45.8%,4m
6117,2,BabaLuga,2897,60,7,2,9,77.8%,42m
6117,2,Laser,2897,198,6,11,17,35.3%,15m
6117,2,Janke,2897,30,4,3,7,57.1%,6m
6117,3,Hamu,2897,148,3,4,7,42.9%,1h
6117,1,FookMi,2897,48,1,2,3,33.3%,33m
6117,1,Avenger,2897,0,1,6,7,14.3%,39m
6117,2,kiniath,2897,0,0,3,3,0.0%,32m
6129,2,[KiMBR]UhPapaiChego,2896,316,58,14,72,80.6%,36m
6129,1,bdawgsterr,2896,565,25,22,47,53.2%,55m
6129,2,ArqLeO,2896,268,10,7,17,58.8%,33m
6129,1,[LitllR]LitlleRabbit,2896,208,7,3,10,70.0%,3h
6129,2,IronCurtain,2896,196,6,9,15,40.0%,42m
6129,2,NeoSecond,2896,0,1,0,1,100.0%,46m
6129,2,[Nutr]Wolfstep,2896,0,1,1,2,50.0%,56m
6136,2,[NZER0]Ghost,2895,1529,119,120,239,49.8%,9m
6136,1,nobuild,2895,334,12,12,24,50.0%,3m
6136,2,[Cullen]Alcatranz,2895,262,10,10,20,50.0%,56m
6136,3,Justforfun,2895,170,7,4,11,63.6%,57m
6136,3,[GudC]Lightworker,2895,170,4,4,8,50.0%,1h
6136,2,Cherry,2895,0,3,2,5,60.0%,3h
6136,2,ChuckNorris,2895,88,3,3,6,50.0%,16m
6136,3,[Random]Nofatchicks,2895,66,2,20,22,9.1%,36m
6136,2,AFK,2895,92,1,3,4,25.0%,36m
6136,2,DontSquirt,2895,0,0,1,1,0.0%,36m
6146,1,Heck,2894,579,25,26,51,49.0%,50m
6146,2,ArthurTei,2894,502,23,12,35,65.7%,36m
6146,2,zandR,2894,384,18,15,33,54.5%,35m
6146,1,FLOPPA,2894,344,14,13,27,51.9%,15m
6146,1,FunkyMonk,2894,105,9,17,26,34.6%,8m
6146,2,[CLoob]ptslammer,2894,229,7,7,14,50.0%,54m
6146,1,Phaedrus,2894,136,6,6,12,50.0%,3m
6146,1,[DmnTz]Samura,2894,96,3,2,5,60.0%,1h
6146,2,AutonomyLost,2894,0,3,2,5,60.0%,8m
6146,2,axel,2894,102,2,1,3,66.7%,42m
6146,2,Hitchslap,2894,30,2,3,5,40.0%,15m
6157,3,SandyCheeks,2893,355,13,5,18,72.2%,4m
6157,3,[NPhasA]ATlien,2893,308,12,1,13,92.3%,39m
6157,1,Bean,2893,363,12,16,28,42.9%,51m
6157,2,Sarzorus,2893,300,10,13,23,43.5%,10m
6157,2,Kinesin,2893,91,1,1,2,50.0%,2m
6157,1,chewiestbear,2893,0,1,1,2,50.0%,48m
6157,2,[RLRC]grayfox,2893,0,1,2,3,33.3%,54m
6157,2,MDR,2893,0,1,3,4,25.0%,36m
6157,3,[Gr33zy]CatGuy,2893,0,0,1,1,0.0%,40m
6157,1,MikekiM,2893,0,0,1,1,0.0%,59m
6157,3,Grogu,2893,0,0,1,1,0.0%,2m
6168,1,Grandpa,2892,1635,85,86,171,49.7%,14m
6168,2,ricolocotito,2892,566,22,24,46,47.8%,31m
6168,3,Firefrizzle,2892,235,10,4,14,71.4%,1h
6168,2,Twohey,2892,210,7,5,12,58.3%,6m
6168,2,Donk,2892,0,5,1,6,83.3%,13m
6168,2,LovAge,2892,126,4,7,11,36.4%,4m
6168,1,CremeFraiche,2892,0,3,3,6,50.0%,6m
6175,3,[KOYOMI]PROBER,2891,902,98,101,199,49.2%,16m
6175,2,ppp,2891,132,6,3,9,66.7%,39m
6175,2,Tony,2891,0,3,3,6,50.0%,47m
6175,3,Ninsoma,2891,58,2,1,3,66.7%,45m
6175,1,BauerDSN,2891,0,1,6,7,14.3%,34m
6180,1,evolsteve,2890,1517,96,95,191,50.3%,34m
6180,2,[UpxV]TYTY,2890,698,26,22,48,54.2%,10m
6180,2,Volley,2890,567,23,18,41,56.1%,16m
6180,2,funnyZEALOT,2890,494,22,22,44,50.0%,45m
6180,1,[DMT1]bigcHENDO,2890,542,17,25,42,40.5%,8m
6180,1,[ProSC]ObaMarauder,2890,410,13,20,33,39.4%,42m
6180,3,Tupac,2890,281,11,6,17,64.7%,54m
6180,2,[ZTempz]SilentReaver,2890,154,4,4,8,50.0%,49m
6180,3,DaveBarry,2890,0,1,0,1,100.0%,5m
6180,2,jurgenrp,2890,0,0,2,2,0.0%,35m
6180,2,zealofwar,2890,0,0,2,2,0.0%,1h
6191,2,MrMotes,2889,1053,54,52,106,50.9%,32m
6191,2,Bread,2889,437,41,40,81,50.6%,11m
6191,1,[Exper]ERICK,2889,526,18,23,41,43.9%,11m
6191,3,Cora,2889,221,9,6,15,60.0%,42m
6191,3,Kioelf,2889,224,8,5,13,61.5%,42m
6191,3,Asnofyx,2889,0,1,0,1,100.0%,35m
6197,2,DoSomething,2888,925,49,47,96,51.0%,12m
6197,3,IIIIIIIIIIII,2888,141,7,3,10,70.0%,39m
6197,2,Azepro,2888,174,7,10,17,41.2%,7m
6197,2,[EpicG]ElPatrick,2888,166,5,4,9,55.6%,52m
6197,2,ChuttMcBugg,2888,138,5,5,10,50.0%,5m
6197,3,[αXLa]Faesbuca,2888,86,4,0,4,100.0%,46m
6197,2,[Black0]CHELOMANO,2888,116,4,1,5,80.0%,56m
6197,2,[3C]Sinisa,2888,166,4,5,9,44.4%,3m
6197,3,YdOOm,2888,97,2,2,4,50.0%,1h
6197,2,Rankfield,2888,0,2,3,5,40.0%,3h
6197,2,SilentSwordX,2888,0,1,1,2,50.0%,4m
6197,2,Paradox,2888,0,1,4,5,20.0%,3h
6197,2,[oPLo]BustardO,2888,0,0,1,1,0.0%,1h
6197,3,[SIMCTY]ChrismusTime,2888,0,0,1,1,0.0%,37m
6211,2,Droopy,2887,1091,119,99,218,54.6%,6m
6211,2,[DubDom]LithicLeafy,2887,860,44,38,82,53.7%,7m
6211,2,Spoon,2887,189,14,12,26,53.8%,6m
6211,1,Battlemaster,2887,281,10,14,24,41.7%,43m
6211,2,[RLRC]BreaktheSky,2887,289,9,9,18,50.0%,3m
6211,2,ArAgOoX,2887,170,7,9,16,43.8%,6m
6211,3,TheAbhorsen,2887,146,5,3,8,62.5%,37m
6211,1,BrightLance,2887,48,5,3,8,62.5%,42m
6211,1,[daBBC]FreshPrince,2887,142,4,12,16,25.0%,42m
6211,3,AnubiS,2887,0,3,2,5,60.0%,4m
6211,2,[CASUL]carlitos,2887,0,3,2,5,60.0%,1h
6211,2,[AntNob]destroyer,2887,0,1,0,1,100.0%,3h
6223,3,rage,2886,1595,147,129,276,53.3%,38m
6223,1,YoloSwagtron,2886,1496,125,110,235,53.2%,7m
6223,2,FireRedJP,2886,346,14,12,26,53.8%,50m
6223,2,BlackBloc,2886,410,14,15,29,48.3%,48m
6223,2,ChiLeNo,2886,284,14,18,32,43.8%,12m
6223,1,jRHEE,2886,460,14,21,35,40.0%,11m
6223,2,[HAV0C]Jimmyfalcon,2886,291,13,4,17,76.5%,45m
6223,2,Barcode,2886,166,6,6,12,50.0%,39m
6223,2,YogenFruz,2886,102,3,1,4,75.0%,9m
6223,3,bitwise,2886,30,2,0,2,100.0%,35m
6223,2,Jonny,2886,0,1,1,2,50.0%,4m
6223,3,RANDOM,2886,0,0,1,1,0.0%,35m
6235,1,PopPop,2885,972,34,37,71,47.9%,3m
6235,1,ChiefRocka,2885,309,19,28,47,40.4%,53m
6235,1,chechme,2885,426,16,16,32,50.0%,3m
6235,1,HiddenAgenda,2885,437,13,19,32,40.6%,32m
6235,2,shadowmonk,2885,154,5,9,14,35.7%,52m
6235,2,TrustChrist,2885,142,3,4,7,42.9%,41m
6235,3,Dustin,2885,0,3,5,8,37.5%,3h
6235,3,DarkLucho,2885,30,2,1,3,66.7%,53m
6235,2,Feddas,2885,0,0,1,1,0.0%,40m
6235,3,America,2885,0,0,1,1,0.0%,42m
6235,2,BustardoS,2885,0,0,1,1,0.0%,1h
6246,3,[DRKRIS]woshinidaye,2884,1467,94,103,197,47.7%,14m
6246,2,kyto,2884,386,17,14,31,54.8%,56m
6246,1,JohnnyCash,2884,234,6,7,13,46.2%,27m
6246,1,Fenix,2884,0,3,4,7,42.9%,3h
6246,3,battlesquid,2884,0,2,3,5,40.0%,32m
6246,3,[FTLTX]DemonCanival,2884,0,1,0,1,100.0%,14m
6246,3,NANDOX,2884,0,1,0,1,100.0%,35m
6246,2,IIIIIIIIIIII,2884,30,1,3,4,25.0%,15m
6246,3,Archangel,2884,0,0,1,1,0.0%,44m
6246,1,[8read]Bhutthead,2884,0,0,3,3,0.0%,1h
6246,2,[FSid3]Finch,2884,0,0,5,5,0.0%,4m
6257,2,[1E100]IGotPlanz,2883,815,100,98,198,50.5%,35m
6257,1,[StheC]DoABarrelRol,2883,1095,63,62,125,50.4%,49m
6257,3,[CBLS]CyberNinja,2883,653,25,35,60,41.7%,56m
6257,2,LetzHevFun,2883,358,17,10,27,63.0%,9m
6257,2,CapnCook,2883,442,17,18,35,48.6%,2m
6257,2,Facemereal,2883,341,17,20,37,45.9%,11m
6257,2,ShambleTron,2883,402,16,13,29,55.2%,12m
6257,2,DoUNOKimchi,2883,163,10,9,19,52.6%,32m
6257,3,RonzeB,2883,97,2,0,2,100.0%,22m
6257,2,Azgalor,2883,129,2,1,3,66.7%,1h
6257,3,LargePelican,2883,0,0,1,1,0.0%,42m
6268,3,Choco,2882,510,20,25,45,44.4%,42m
6268,2,CheeseImmune,2882,440,16,20,36,44.4%,46m
6268,2,DeividCraft,2882,0,4,2,6,66.7%,46m
6268,2,Pinky,2882,108,4,4,8,50.0%,50m
6268,1,UrdnotMark,2882,0,1,0,1,100.0%,1h
6268,1,jonn,2882,0,1,0,1,100.0%,1h
6268,2,[097]XXXanin,2882,30,1,3,4,25.0%,6m
6268,2,[GnR]happybythree,2882,0,1,4,5,20.0%,3h
6276,3,InDIGo,2881,936,70,73,143,49.0%,47m
6276,2,Jasian,2881,485,18,17,35,51.4%,46m
6276,2,SoXXoS,2881,408,16,16,32,50.0%,46m
6276,2,Pumpkinpod,2881,210,10,9,19,52.6%,46m
6276,3,TwistedTea,2881,218,9,7,16,56.2%,1h
6276,2,[EndPro]YeIBoRG,2881,182,9,10,19,47.4%,10m
6276,1,Threegnomes,2881,231,7,5,12,58.3%,7m
6276,2,NNSalve,2881,114,4,4,8,50.0%,33m
6276,2,[Mc]Psylocibe,2881,138,3,4,7,42.9%,47m
6276,3,AerLingus,2881,0,2,3,5,40.0%,45m
6276,3,DKR,2881,113,2,3,5,40.0%,36m
6276,2,RebelChara,2881,30,2,6,8,25.0%,53m
6276,1,[ctrlF]BalphEubank,2881,0,1,0,1,100.0%,3m
6276,1,[Jamin]SbCarrisai,2881,0,1,0,1,100.0%,21m
6276,2,MedicsUp,2881,0,0,1,1,0.0%,1h
6291,1,BeauxNoir,2880,1662,583,578,1161,50.2%,53m
6291,2,[wNt]Dennhis,2880,1604,293,263,556,52.7%,56m
6291,3,Nab,2880,1048,187,185,372,50.3%,38m
6291,1,PelicanWhomp,2880,1374,112,127,239,46.9%,46m
6291,2,Zobel,2880,463,20,14,34,58.8%,39m
6291,2,Addamere,2880,345,12,11,23,52.2%,10m
6291,2,BabiHutan,2880,243,11,9,20,55.0%,52m
6291,2,SaltLakers,2880,93,5,5,10,50.0%,1h
6291,1,Altros,2880,126,4,1,5,80.0%,39m
6291,3,Anandamide,2880,58,3,1,4,75.0%,3m
6291,1,shadowsniper,2880,97,2,0,2,100.0%,35m
6302,3,GolDaniels,2879,180,5,3,8,62.5%,51m
6302,2,SirStichUp,2879,112,2,3,5,40.0%,42m
6302,1,RoadDoc,2879,70,2,10,12,16.7%,15m
6302,3,[FJLAK]ddmpc,2879,0,0,1,1,0.0%,1h
6306,2,Doberman,2878,648,236,217,453,52.1%,6m
6306,1,Carlton,2878,1631,134,134,268,50.0%,56m
6306,1,jeanuxi,2878,1512,72,67,139,51.8%,41m
6306,2,Emselar,2878,621,25,24,49,51.0%,31m
6306,3,Moridin,2878,547,24,6,30,80.0%,38m
6306,1,[DMONlC]DEMONIC,2878,629,22,19,41,53.7%,50m
6306,3,garro,2878,221,6,8,14,42.9%,35m
6306,3,PandaExpress,2878,60,5,8,13,38.5%,6m
6306,2,Glass,2878,88,3,4,7,42.9%,41m
6306,2,KingsnO,2878,72,2,6,8,25.0%,33m
6306,1,Blockage,2878,0,1,0,1,100.0%,3h
6306,1,JIMBO,2878,0,1,0,1,100.0%,1h
6306,3,[T0PK3K]fuzzyBUNNY,2878,30,1,2,3,33.3%,15m
6306,2,GangstaRap,2878,0,1,3,4,25.0%,7m
6306,3,IIIIIIIIIII,2878,0,0,1,1,0.0%,1h
6321,1,Brasileiro,2877,1653,360,331,691,52.1%,35m
6321,2,[XATUBA]Gozawr,2877,1483,97,86,183,53.0%,50m
6321,2,[BuGang]FullySick,2877,962,38,41,79,48.1%,35m
6321,3,chem,2877,898,35,27,62,56.5%,43m
6321,2,[UAK]Dextrus,2877,432,19,16,35,54.3%,41m
6321,2,Dunsidian,2877,486,18,16,34,52.9%,16m
6321,3,baikun,2877,215,7,4,11,63.6%,38m
6321,2,[DarkAG]Meta,2877,208,7,13,20,35.0%,42m
6321,3,Zerg,2877,114,3,0,3,100.0%,36m
6321,3,GrosMalin,2877,0,3,2,5,60.0%,38m
6321,2,omzoc,2877,60,3,3,6,50.0%,48m
6321,2,[s1s]Khadgar,2877,0,2,3,5,40.0%,14m
6321,2,BubbleMagic,2877,0,1,5,6,16.7%,32m
6334,2,[343FTW]Azureangel,2876,370,24,13,37,64.9%,46m
6334,1,[hikari]lilystar,2876,457,16,18,34,47.1%,44m
6334,2,[GTWITM]MrKwan,2876,374,15,14,29,51.7%,11m
6334,3,Garbage,2876,172,9,3,12,75.0%,37m
6334,3,GRAMBO,2876,187,8,4,12,66.7%,1h
6334,3,Niteshade,2876,120,5,3,8,62.5%,10m
6334,2,Ulysses,2876,104,4,7,11,36.4%,3m
6334,3,starjunkie,2876,0,3,2,5,60.0%,54m
6334,2,Squirrel,2876,96,2,2,4,50.0%,32m
6334,3,[EnTrpY]Jack,2876,0,0,1,1,0.0%,42m
6334,3,[USOMAD]NameHere,2876,0,0,1,1,0.0%,42m
6334,2,[C0V]ATHEOTES,2876,0,0,2,2,0.0%,10m
6346,3,Faiya,2875,525,21,10,31,67.7%,14m
6346,2,shibe,2875,294,14,16,30,46.7%,6m
6346,1,[NoBads]NiceBlood,2875,97,5,2,7,71.4%,3m
6346,2,Hotzenplotz,2875,106,5,3,8,62.5%,52m
6346,1,ArtieShaw,2875,36,5,9,14,35.7%,3h
6346,3,[WafTV]Wafer,2875,180,5,10,15,33.3%,42m
6346,3,CJMtilla,2875,0,4,1,5,80.0%,12m
6346,2,Chosen,2875,138,4,3,7,57.1%,3h
6346,3,[DHZAcD]UpSideDown,2875,121,2,1,3,66.7%,20m
6346,1,[cbox]Aronator,2875,0,1,0,1,100.0%,59m
6346,3,skysthelimit,2875,30,1,1,2,50.0%,3m
6346,1,DontSneezeMe,2875,48,1,3,4,25.0%,31m
6346,3,SteveA,2875,0,0,1,1,0.0%,34m
6346,3,[BlGD]ghost,2875,0,0,1,1,0.0%,42m
6360,1,amumu,2874,586,38,37,75,50.7%,50m
6360,3,[REPORT]RaNdOmIzE,2874,471,19,8,27,70.4%,14m
6360,2,LuisGBR,2874,513,19,23,42,45.2%,56m
6360,2,[D3m0N]Shadow,2874,384,18,16,34,52.9%,52m
6360,2,Døyhar,2874,290,13,6,19,68.4%,7m
6360,3,Win,2874,97,4,6,10,40.0%,20m
6360,3,[SQA]Maxodeno,2874,0,3,2,5,60.0%,10m
6360,3,Gold,2874,0,2,3,5,40.0%,12m
6360,3,[xDBZx]AlfredoCruz,2874,58,2,3,5,40.0%,16m
6360,3,[FFAA]EFRAIN,2874,0,1,0,1,100.0%,9m
6360,3,Legnacra,2874,0,1,4,5,20.0%,10m
6360,2,Vault,2874,30,1,7,8,12.5%,4m
6360,3,Shenster,2874,0,0,1,1,0.0%,50m
6373,2,[GOPERÚ]lllllllllll,2873,788,39,18,57,68.4%,10m
6373,2,[Ntshls]Schwaz,2873,385,16,15,31,51.6%,56m
6373,2,[Shardz]nhduia,2873,250,8,5,13,61.5%,1h
6373,2,[KTBOSS]xShadowx,2873,217,8,6,14,57.1%,50m
6373,3,Spartann,2873,86,4,2,6,66.7%,3m
6373,1,Euco,2873,96,2,0,2,100.0%,3h
6373,3,MiNiJam,2873,58,2,1,3,66.7%,35m
6373,2,[pd]mearei,2873,30,2,3,5,40.0%,46m
6373,3,[LED]Jayski,2873,0,1,0,1,100.0%,15m
6373,2,Karmaeleon,2873,48,1,1,2,50.0%,1h
6373,1,ArkKnight,2873,0,0,1,1,0.0%,3m
6373,3,Locoster,2873,0,0,1,1,0.0%,6m
6385,2,NUGGETHEAD,2872,1049,51,46,97,52.6%,4m
6385,2,[42x]Lights,2872,364,47,39,86,54.7%,46m
6385,2,bluewhale,2872,302,12,10,22,54.5%,10m
6385,3,Nemesis,2872,192,7,6,13,53.8%,4m
6385,2,YUM,2872,122,5,6,11,45.5%,47m
6385,2,[SABO]Zig,2872,150,5,11,16,31.2%,39m
6385,3,jobjams,2872,116,4,3,7,57.1%,54m
6385,2,jdub,2872,0,3,2,5,60.0%,3h
6385,3,Dalria,2872,0,3,2,5,60.0%,47m
6394,1,Pudgyducky,2871,935,111,106,217,51.2%,43m
6394,2,[TLAN]Timbits,2871,958,36,37,73,49.3%,6m
6394,2,IXIXIXI,2871,792,29,29,58,50.0%,5m
6394,2,TANKnelson,2871,467,18,16,34,52.9%,32m
6394,2,iamcomma,2871,414,15,17,32,46.9%,7m
6394,2,Irae,2871,290,9,9,18,50.0%,35m
6394,3,[Pig2]ACGeneral,2871,232,8,6,14,57.1%,1h
6394,2,[CFZL]coldfuzion,2871,212,8,7,15,53.3%,54m
6394,2,[UpxV]PAINKILLER,2871,178,6,6,12,50.0%,47m
6394,2,Dawn,2871,142,5,7,12,41.7%,43m
6394,3,[Chizu]Serralberto,2871,58,3,1,4,75.0%,50m
6394,2,Wolverine,2871,62,3,5,8,37.5%,4m
6394,2,OneAndOnlyDS,2871,30,2,5,7,28.6%,42m
6394,2,jiminlee,2871,58,2,6,8,25.0%,46m
6394,3,[JAYJAY]ddlfighter,2871,0,1,0,1,100.0%,12m
6394,3,Hsiaoboy,2871,0,1,0,1,100.0%,39m
6394,3,Jamin,2871,30,1,1,2,50.0%,31m
6411,2,[DbChan]Kerthus,2870,1588,88,70,158,55.7%,2m
6411,2,[TFGID]Dreknal,2870,1170,46,47,93,49.5%,56m
6411,3,Belzedar,2870,425,15,17,32,46.9%,56m
6411,2,[813ice]Ninjer,2870,148,8,8,16,50.0%,50m
6411,1,Palpatine,2870,118,4,3,7,57.1%,3h
6416,3,[KGH3]BlackHydra,2869,1407,121,135,256,47.3%,16m
6416,3,zoidburrrrrg,2869,251,21,18,39,53.8%,5m
6416,1,ChampOrChump,2869,96,5,6,11,45.5%,7m
6416,1,Dynasty,2869,97,4,3,7,57.1%,1h
6416,3,StayHydrated,2869,0,0,1,1,0.0%,37m
6421,1,[Wc3GGL]NatureBoy,2868,1522,132,129,261,50.6%,9m
6421,2,GKL,2868,1616,126,111,237,53.2%,10m
6421,2,Rodrihunter,2868,1607,87,79,166,52.4%,54m
6421,2,[UKNOME]QuiRepublic,2868,820,78,61,139,56.1%,41m
6421,2,[Shang]Killa,2868,852,32,28,60,53.3%,42m
6421,2,Savage,2868,677,26,25,51,51.0%,37m
6421,2,IILUMINOTHII,2868,531,22,21,43,51.2%,46m
6421,2,Sebbie,2868,332,15,8,23,65.2%,6m
6421,3,Brennen,2868,232,8,4,12,66.7%,45m
6421,2,Eurotrix,2868,172,8,6,14,57.1%,53m
6421,2,OldManWillow,2868,176,8,8,16,50.0%,31m
6421,3,[4LOBOS]xXTheLionXx,2868,0,3,2,5,60.0%,39m
6421,2,FreNuLuM,2868,116,3,4,7,42.9%,42m
6421,2,[MacJu]Beginner,2868,0,1,4,5,20.0%,3h
6421,2,[TYNXT]DoubleCat,2868,0,0,2,2,0.0%,6m
6436,2,Aldaris,2867,1512,81,73,154,52.6%,52m
6436,2,[Macac0]sakura,2867,1145,44,43,87,50.6%,42m
6436,3,Rheese,2867,114,7,4,11,63.6%,40m
6436,1,Assassin,2867,145,4,4,8,50.0%,18m
6436,3,neweywest,2867,30,1,2,3,33.3%,8m
6436,2,[ExcIgN]ShadowDragon,2867,0,1,2,3,33.3%,3h
6436,3,CaptinMitt,2867,0,0,1,1,0.0%,42m
6443,2,[TSØP]GosuGhost,2866,1407,86,69,155,55.5%,56m
6443,1,utenation,2866,1404,53,54,107,49.5%,14m
6443,1,[RvO]StarLord,2866,0,3,3,6,50.0%,39m
6443,3,Juhyeon,2866,30,2,0,2,100.0%,16m
6443,3,SoiBoi,2866,30,2,0,2,100.0%,7m
6443,1,Slapfunk,2866,0,1,0,1,100.0%,28m
6443,3,Binary,2866,0,1,0,1,100.0%,52m
6443,3,Camo,2866,0,1,0,1,100.0%,38m
6443,2,Flow,2866,42,1,1,2,50.0%,2m
6443,3,[GOPERÚ]Ashiran,2866,30,1,2,3,33.3%,43m
6443,3,Lance,2866,0,0,1,1,0.0%,47m
6443,2,ENDER,2866,0,0,3,3,0.0%,3m
6455,3,[ConFed]gerdel,2865,1485,168,162,330,50.9%,16m
6455,1,[scMAUI]SpaceRonin,2865,1532,136,138,274,49.6%,8m
6455,3,[ChiFan]MindSpiritG,2865,86,4,1,5,80.0%,52m
6455,2,[Cind3r]Hayes,2865,81,4,5,9,44.4%,3m
6455,3,AlexBaez,2865,30,2,0,2,100.0%,42m
6460,3,[HSTLE]MightyMicah,2864,1276,208,217,425,48.9%,36m
6460,2,Magistrate,2864,1406,106,99,205,51.7%,53m
6460,1,[OTOGS]Arktanis,2864,1597,103,99,202,51.0%,56m
6460,3,grannit,2864,698,100,81,181,55.2%,38m
6460,3,illy,2864,790,31,29,60,51.7%,14m
6460,3,RubberDucky,2864,385,16,10,26,61.5%,34m
6460,3,Spacemonkey,2864,339,15,10,25,60.0%,54m
6460,2,huntdog,2864,290,11,13,24,45.8%,42m
6460,1,[ZOOMOB]Clarity,2864,252,9,2,11,81.8%,12m
6460,1,qqn,2864,154,9,7,16,56.2%,49m
6460,3,[selly]selly,2864,114,4,1,5,80.0%,36m
6460,3,[SHKNG]JASOX,2864,58,3,2,5,60.0%,15m
6460,3,[MOBOZ]Waffle,2864,30,2,2,4,50.0%,3m
6460,3,nirvash,2864,0,2,3,5,40.0%,56m
6460,3,CAREPERRO,2864,0,0,2,2,0.0%,51m
6460,3,[ZDX]AylianQc,2864,0,0,3,3,0.0%,1h
6476,3,NYCnosukja,2863,1506,105,116,221,47.5%,36m
6476,3,Clossius,2863,477,27,10,37,73.0%,45m
6476,2,Uristmcary,2863,477,26,27,53,49.1%,3m
6476,3,Thedutang,2863,532,23,8,31,74.2%,54m
6476,2,ispirit,2863,479,19,20,39,48.7%,2m
6476,1,kalli,2863,506,18,26,44,40.9%,5m
6476,3,Infernio,2863,402,16,10,26,61.5%,6m
6476,3,IllIIIllllll,2863,304,12,7,19,63.2%,54m
6476,3,Taybuck,2863,234,9,6,15,60.0%,1h
6476,3,CoochieMan,2863,226,8,10,18,44.4%,12m
6476,3,Taroro,2863,0,2,3,5,40.0%,42m
6476,2,[GRNSKN]Skynet,2863,124,2,4,6,33.3%,46m
6488,3,Odontoma,2862,1525,256,259,515,49.7%,2m
6488,1,[MPC]GorosPrime,2862,1611,155,153,308,50.3%,51m
6488,1,primussux,2862,1580,98,102,200,49.0%,4m
6488,3,[juggr]NapTime,2862,1266,49,62,111,44.1%,34m
6488,1,NiNJa,2862,185,8,7,15,53.3%,15m
6488,1,LiuBei,2862,213,6,5,11,54.5%,3h
6488,2,ColonelW,2862,118,4,7,11,36.4%,56m
6488,3,[PHUK]URGOVRNMNT,2862,90,3,4,7,42.9%,42m
6488,2,[Games2]gianipo,2862,128,3,4,7,42.9%,47m
6488,3,Kaz,2862,0,0,1,1,0.0%,6m
6488,2,overpowerd,2862,0,0,5,5,0.0%,7m
6499,2,Cuong,2861,1324,89,73,162,54.9%,45m
6499,2,Mongose,2861,1292,48,52,100,48.0%,11m
6499,2,[FyHr]RyukOmg,2861,797,34,28,62,54.8%,5m
6499,2,RenaldoMoon,2861,316,12,14,26,46.2%,6m
6499,3,KingDragon,2861,162,9,4,13,69.2%,50m
6499,1,[FeedUs]Finally,2861,96,6,5,11,54.5%,1h
6499,2,RedruM,2861,44,3,3,6,50.0%,3h
6499,1,BorneyG,2861,95,2,0,2,100.0%,1h
6499,3,[StmBrk]GeckO,2861,30,2,2,4,50.0%,46m
6499,3,Gary,2861,30,1,5,6,16.7%,34m
6499,2,sambolio,2861,0,0,5,5,0.0%,1h
6510,2,StEeZe,2860,172,5,5,10,50.0%,6m
6510,2,LawlsCraft,2860,0,1,0,1,100.0%,9m
6510,3,[XpKAc]bleephk,2860,0,1,0,1,100.0%,50m
6510,2,[Area88]Feels,2860,0,0,1,1,0.0%,12m
6510,3,code,2860,0,0,2,2,0.0%,39m
6510,3,Niggun,2860,0,0,2,2,0.0%,16m
6510,3,Flex,2860,0,0,2,2,0.0%,4h
6517,2,cholo,2859,1609,78,67,145,53.8%,56m
6517,3,Kaelith,2859,876,68,62,130,52.3%,34m
6517,1,RebelSOUL,2859,636,36,39,75,48.0%,13m
6517,2,Peco,2859,426,16,15,31,51.6%,46m
6517,2,Wildfire,2859,369,16,16,32,50.0%,12m
6517,2,[4One]ShaKa,2859,261,15,14,29,51.7%,15m
6517,1,Ichigo,2859,154,4,17,21,19.0%,13m
6517,1,JuhwanJeong,2859,114,2,6,8,25.0%,50m
6517,1,[UpeV]viperKingHG,2859,0,1,0,1,100.0%,32m
6517,3,[Squidy]RavinBailiff,2859,0,1,0,1,100.0%,32m
6517,3,HOR,2859,0,0,1,1,0.0%,36m
6517,1,TheKingMelon,2859,0,0,2,2,0.0%,50m
6529,3,[sm0oth]brainedPony,2858,1067,68,73,141,48.2%,46m
6529,3,Youfi,2858,1155,55,45,100,55.0%,38m
6529,1,NoobBot,2858,257,10,11,21,47.6%,1h
6529,3,JPX,2858,204,8,8,16,50.0%,1h
6529,2,[Lp]Iniwalker,2858,165,5,5,10,50.0%,56m
6529,2,[SirDon]DonDui,2858,146,4,9,13,30.8%,3h
6529,1,Andromedus,2858,122,3,7,10,30.0%,44m
6536,3,[ValidG]Creature,2857,450,25,16,41,61.0%,37m
6536,3,SuperNinja,2857,400,16,21,37,43.2%,54m
6536,3,Cosmicraider,2857,253,11,5,16,68.8%,17m
6536,2,Newby,2857,232,11,8,19,57.9%,10m
6536,1,[KiMBR]NabucAo,2857,191,5,5,10,50.0%,3h
6536,2,lokito,2857,0,3,2,5,60.0%,8m
6536,3,ThorKen,2857,30,2,0,2,100.0%,56m
6536,2,[cl0udM]Hellfire,2857,0,1,0,1,100.0%,38m
6536,2,DarckMaster,2857,96,1,2,3,33.3%,33m
6536,3,[pTFBq]Brennan,2857,0,0,1,1,0.0%,16m
6536,3,[Straub]hotwings,2857,0,0,1,1,0.0%,13m
6536,2,Eodor,2857,0,0,4,4,0.0%,35m
6548,3,[BeefyU]Szanto,2856,1578,150,142,292,51.4%,48m
6548,2,GQD,2856,1352,75,72,147,51.0%,11m
6548,2,Zippri,2856,469,18,18,36,50.0%,46m
6548,2,[xTLAx]IMPaSSiVE,2856,92,4,5,9,44.4%,3m
6548,3,MacroNutrien,2856,30,2,1,3,66.7%,3m
6548,3,Killstatic,2856,0,0,1,1,0.0%,1h
6548,1,Roke,2856,0,0,2,2,0.0%,1h
6555,2,ComradeY,2855,882,63,69,132,47.7%,10m
6555,3,terminator,2855,250,9,2,11,81.8%,15m
6555,2,[ggUNlT]BlackMesaINC,2855,115,7,5,12,58.3%,45m
6555,2,[J33SH]NiocePlay,2855,68,5,9,14,35.7%,10m
6555,3,SombraLetal,2855,30,4,2,6,66.7%,15m
6555,2,JilkerWow,2855,0,3,2,5,60.0%,1h
6555,3,IIIIIIIIIIII,2855,129,2,2,4,50.0%,29m
6555,1,Muffzilla,2855,0,1,0,1,100.0%,59m
6555,2,levenpeven,2855,0,1,0,1,100.0%,39m
6555,1,NotToGood,2855,0,0,1,1,0.0%,1h
6565,2,Bert,2854,1542,294,267,561,52.4%,15m
6565,2,[Meseek]Joker,2854,997,42,43,85,49.4%,16m
6565,3,[uRTeam]Tassadar,2854,246,9,6,15,60.0%,12m
6565,3,Venom,2854,80,3,9,12,25.0%,1h
6565,2,Swarm,2854,0,1,0,1,100.0%,3h
6565,1,[XxPwnX]LLShadowsX,2854,0,1,1,2,50.0%,3h
6571,1,[GOPERÚ]Rohan,2853,1351,101,97,198,51.0%,57m
6571,2,beatboxbear,2853,1333,69,64,133,51.9%,3m
6571,2,DarkstonEr,2853,745,38,38,76,50.0%,32m
6571,1,EARFQUAKE,2853,786,32,30,62,51.6%,55m
6571,3,redsmurf,2853,532,19,20,39,48.7%,3m
6571,1,[YetiFC]wPsGameover,2853,343,12,9,21,57.1%,42m
6571,3,Lycosa,2853,160,7,15,22,31.8%,39m
6571,1,[nGUN5]Phillup,2853,0,1,0,1,100.0%,1h
6571,3,[TPGGXD]elTipo,2853,30,1,1,2,50.0%,13m
6571,2,MarineChien,2853,30,1,5,6,16.7%,46m
6581,2,[XxITxX]Joker,2852,1614,266,257,523,50.9%,33m
6581,1,HappyPanda,2852,900,60,52,112,53.6%,57m
6581,2,Zeratul,2852,580,20,26,46,43.5%,56m
6581,2,Silky,2852,411,19,13,32,59.4%,38m
6581,2,Mindfreak,2852,322,14,16,30,46.7%,50m
6581,1,Seba,2852,341,13,10,23,56.5%,42m
6581,2,ZooZooBubble,2852,227,11,5,16,68.8%,35m
6581,3,llllllllllll,2852,230,7,7,14,50.0%,42m
6581,2,Omnipotent,2852,178,7,10,17,41.2%,46m
6581,2,Adapt,2852,60,4,5,9,44.4%,37m
6581,3,kenzington,2852,58,3,2,5,60.0%,55m
6581,3,NordicMoose,2852,141,3,2,5,60.0%,55m
6581,3,coffee,2852,0,3,2,5,60.0%,10m
6581,2,NoBushido,2852,94,2,5,7,28.6%,1h
6581,3,hnrcbx,2852,30,1,3,4,25.0%,8m
6581,2,[RiseWC]Fistocuffs,2852,0,1,6,7,14.3%,13m
6581,3,Einarin,2852,0,0,1,1,0.0%,45m
6581,3,[NLTN]Icebrand,2852,0,0,1,1,0.0%,55m
6599,3,[DNYO]Sorry,2851,1546,112,112,224,50.0%,38m
6599,1,[LDPro]Numberthree,2851,30,3,7,10,30.0%,42m
6599,3,JaHa,2851,0,0,2,2,0.0%,4m
6599,3,Gavin,2851,0,0,5,5,0.0%,45m
6603,3,[SYNDCT]Jongsongs,2850,334,20,12,32,62.5%,35m
6603,3,Johan,2850,458,17,12,29,58.6%,47m
6603,1,LeTurkeh,2850,334,17,13,30,56.7%,13m
6603,1,Calidine,2850,312,12,17,29,41.4%,3m
6603,1,mrkisawsome,2850,122,5,4,9,55.6%,1h
6603,2,Deathwing,2850,133,2,8,10,20.0%,46m
6603,2,[GBTC]GetTheBTCLLC,2850,0,1,0,1,100.0%,48m
6603,3,[RuS98]UberNOobster,2850,0,1,1,2,50.0%,38m
6603,3,HighDied,2850,0,0,1,1,0.0%,35m
6612,2,Eclipse,2849,714,30,29,59,50.8%,47m
6612,2,Kanky,2849,403,28,24,52,53.8%,42m
6612,3,hatchet,2849,220,8,6,14,57.1%,1h
6612,3,VIPsedan,2849,86,4,1,5,80.0%,35m
6612,1,XXOO,2849,0,3,2,5,60.0%,18m
6612,1,[Zambo]RicaLaPiña,2849,48,2,0,2,100.0%,10m
6612,3,[sk3tch]BillDipperly,2849,58,2,1,3,66.7%,15m
6612,3,UDeadYeah,2849,0,1,0,1,100.0%,51m
6612,3,Venduss,2849,30,1,3,4,25.0%,38m
6621,2,[LOHc]www,2848,1292,75,70,145,51.7%,32m
6621,3,irishexpress,2848,1253,64,59,123,52.0%,36m
6621,2,killonater,2848,427,22,21,43,51.2%,7m
6621,3,[TYA]FazZ,2848,508,19,17,36,52.8%,43m
6621,2,CptRandom,2848,214,7,9,16,43.8%,33m
6621,2,herOS,2848,0,5,5,10,50.0%,1h
6621,1,Rabscuttle,2848,0,4,2,6,66.7%,56m
6621,3,Lastexit,2848,0,2,1,3,66.7%,42m
6621,3,[froz3n]silverkaze,2848,0,0,1,1,0.0%,50m
6630,3,Víctor,2847,1599,99,75,174,56.9%,32m
6630,2,MrShnoodleMD,2847,491,22,20,42,52.4%,33m
6630,3,mastertiger,2847,176,6,4,10,60.0%,35m
6630,2,[QcScT]WestSpirit,2847,128,3,5,8,37.5%,42m
6634,1,Dudeman,2846,1358,60,59,119,50.4%,43m
6634,1,Tiozin,2846,90,5,4,9,55.6%,10m
6634,3,Bae,2846,30,1,2,3,33.3%,12m
6634,3,[GOPERÚ]RonalFlores,2846,30,1,3,4,25.0%,43m
6634,3,[TGosuA]Patata,2846,0,0,1,1,0.0%,3h
6639,3,[xARESx]GratSpike,2845,1465,94,67,161,58.4%,4m
6639,3,Decay,2845,1043,80,65,145,55.2%,38m
6639,2,Bargosk,2845,738,28,29,57,49.1%,6m
6639,2,TheOneking,2845,379,13,14,27,48.1%,33m
6639,2,mark,2845,229,11,7,18,61.1%,41m
6639,2,[RAND0M]Juxtapolemic,2845,178,6,10,16,37.5%,49m
6639,3,Furby,2845,157,4,6,10,40.0%,15m
6639,3,Kairos,2845,86,3,2,5,60.0%,49m
6639,3,IronGear,2845,88,3,2,5,60.0%,55m
6639,3,[AbcCo]CaritaFeliz,2845,139,3,3,6,50.0%,14m
6639,2,Necrodancer,2845,30,2,4,6,33.3%,10m
6639,3,Lampioã,2845,0,1,1,2,50.0%,35m
6639,3,[TLibre]patal,2845,0,0,1,1,0.0%,1h
6639,3,Heart,2845,0,0,1,1,0.0%,34m
6653,3,Keolasin,2844,1252,51,41,92,55.4%,38m
6653,2,Arrhythmia,2844,1066,41,44,85,48.2%,48m
6653,3,celendis,2844,734,32,20,52,61.5%,2m
6653,2,Presto,2844,436,15,17,32,46.9%,15m
6653,3,mmun,2844,382,15,27,42,35.7%,45m
6653,3,Stinger,2844,328,11,6,17,64.7%,32m
6653,2,KombatKarl,2844,256,7,12,19,36.8%,3m
6653,2,kangpunge,2844,102,3,3,6,50.0%,46m
6653,3,Hellknight,2844,95,3,3,6,50.0%,10m
6653,2,[OvrDsd]MikeU,2844,60,3,5,8,37.5%,32m
6653,3,You,2844,30,2,2,4,50.0%,10m
6653,2,[dLife]DarkTRUMPlar,2844,88,1,4,5,20.0%,37m
6653,3,Juul,2844,0,0,1,1,0.0%,46m
6653,3,[jacasb]VELKAN,2844,0,0,1,1,0.0%,44m
6653,1,Korcholata,2844,0,0,1,1,0.0%,3h
6653,2,IceD,2844,0,0,1,1,0.0%,1h
6669,3,xxMYMANxX,2843,119,5,8,13,38.5%,38m
6669,3,AngeluS,2843,107,4,3,7,57.1%,42m
6669,1,[5oh1st]ItsRhett,2843,97,2,1,3,66.7%,1h
6669,2,[2Z1MTV]Tempesta,2843,62,2,7,9,22.2%,54m
6669,3,ricjamesbtch,2843,0,1,1,2,50.0%,54m
6674,3,seVeN,2842,1474,186,190,376,49.5%,36m
6674,3,LeahGotti,2842,339,13,13,26,50.0%,39m
6674,3,FaDe,2842,304,12,7,19,63.2%,36m
6674,3,LDYZnGENTLMN,2842,252,8,4,12,66.7%,14m
6674,3,lili,2842,232,8,4,12,66.7%,38m
6674,3,Fragile,2842,95,4,2,6,66.7%,42m
6674,3,[SCTR]OpaGandalf,2842,97,2,0,2,100.0%,4h
6674,3,Zimap,2842,34,2,2,4,50.0%,44m
6682,2,iamcherry,2841,901,112,94,206,54.4%,44m
6682,2,catukun,2841,552,19,28,47,40.4%,35m
6682,2,[6PR]EvoLuTion,2841,363,15,19,34,44.1%,15m
6682,1,Kanco,2841,315,13,11,24,54.2%,39m
6682,3,[scUN]DeadlyKitten,2841,136,6,2,8,75.0%,6m
6682,3,Nando,2841,146,6,4,10,60.0%,42m
6682,1,thebigone,2841,48,4,5,9,44.4%,46m
6682,3,Virtue,2841,162,4,9,13,30.8%,41m
6682,3,[NPhasA]HASPEL,2841,30,2,2,4,50.0%,15m
6682,2,[oJKo]TheGodEater,2841,0,1,1,2,50.0%,17m
6692,2,Writhe,2840,1508,90,84,174,51.7%,45m
6692,3,Hamsung,2840,440,16,11,27,59.3%,32m
6692,3,[Random]JiveTurkey,2840,226,12,13,25,48.0%,5m
6692,2,[H0D0R]chris,2840,142,5,8,13,38.5%,33m
6692,3,NohVarr,2840,117,4,5,9,44.4%,14m
6692,1,rumple,2840,0,3,3,6,50.0%,13m
6692,2,StokesANTH,2840,127,3,4,7,42.9%,32m
6692,2,HomeDepot,2840,0,2,2,4,50.0%,3h
6692,3,[LAW]Drewbie,2840,0,1,0,1,100.0%,38m
6701,2,Romanrat,2839,1482,222,223,445,49.9%,49m
6701,3,Elbuen,2839,1586,69,60,129,53.5%,40m
6701,2,shadowwull,2839,684,33,33,66,50.0%,46m
6701,3,RoorinRyan,2839,215,8,8,16,50.0%,1h
6701,2,RobTenken,2839,232,7,8,15,46.7%,51m
6701,1,Augustus,2839,122,6,5,11,54.5%,57m
6701,3,HumanFly,2839,0,2,3,5,40.0%,39m
6701,1,[CBAS]DaGuill,2839,0,1,0,1,100.0%,1h
6701,2,BliNkeR,2839,0,1,0,1,100.0%,9m
6701,2,Saito,2839,0,1,6,7,14.3%,56m
6701,3,AIphaStar,2839,0,0,2,2,0.0%,14m
6712,3,Milkiss,2838,403,17,15,32,53.1%,31m
6712,1,Gimli,2838,189,5,4,9,55.6%,22m
6712,3,[Macac0]Selxtop,2838,0,1,3,4,25.0%,56m
6715,2,TheBlueFenix,2837,879,83,74,157,52.9%,46m
6715,3,[Emb3rs]thisisfine,2837,278,10,18,28,35.7%,5m
6715,2,[IMIRS]BrThome,2837,225,9,8,17,52.9%,3h
6715,2,[2City]CYLON,2837,146,6,11,17,35.3%,4m
6715,3,Hades,2837,30,2,0,2,100.0%,12m
6715,1,IronZywiec,2837,0,0,2,2,0.0%,1h
6715,3,[JandH]Turgon,2837,0,0,2,2,0.0%,42m
6715,3,Bors,2837,0,0,2,2,0.0%,52m
6723,1,[NBSvet]CommisarKate,2836,1614,368,346,714,51.5%,45m
6723,3,LaquabAkhahb,2836,1268,85,46,131,64.9%,15m
6723,3,Guru,2836,430,35,30,65,53.8%,56m
6723,1,Dodgson,2836,690,25,28,53,47.2%,43m
6723,3,tbonehmb,2836,387,13,9,22,59.1%,35m
6723,1,[N3RD5]Lawlzer,2836,270,10,12,22,45.5%,38m
6723,3,[llIII]Probius,2836,118,4,7,11,36.4%,3m
6723,3,[d0ngZi]chaosjon,2836,0,3,2,5,60.0%,42m
6723,3,Finality,2836,119,2,6,8,25.0%,3m
6723,3,Cuspio,2836,0,1,1,2,50.0%,45m
6733,1,Chaos,2835,1611,68,78,146,46.6%,36m
6733,2,Sandtrap,2835,1076,46,42,88,52.3%,56m
6733,2,Conspiration,2835,142,5,4,9,55.6%,11m
6733,1,YYLegend,2835,0,3,3,6,50.0%,1h
6733,2,elsebo,2835,0,2,1,3,66.7%,3h
6733,3,VpRainbow,2835,58,2,2,4,50.0%,51m
6733,3,[TGosuB]Dream,2835,124,2,4,6,33.3%,35m
6733,3,anan,2835,30,1,1,2,50.0%,15m
6741,2,xSKYWALKERx,2834,1542,65,72,137,47.4%,37m
6741,2,[xGenGx]bAthAlA,2834,423,17,11,28,60.7%,11m
6741,3,JUBEI,2834,382,16,22,38,42.1%,55m
6741,2,huesos,2834,347,14,12,26,53.8%,52m
6741,3,xtremeplayer,2834,298,10,12,22,45.5%,16m
6741,1,Grogam,2834,144,6,6,12,50.0%,1h
6741,3,likeaboss,2834,0,4,1,5,80.0%,14m
6741,2,zuse,2834,128,4,5,9,44.4%,10m
6741,3,Mercules,2834,144,3,2,5,60.0%,60m
6741,3,Phobophobia,2834,58,2,1,3,66.7%,51m
6741,2,Jorz,2834,0,1,2,3,33.3%,37m
6741,3,[1for2]Rocketmaser,2834,0,0,1,1,0.0%,47m
6741,3,[QTp2T]Ivy,2834,0,0,1,1,0.0%,52m
6741,3,HeyDoc,2834,0,0,1,1,0.0%,54m
6755,2,NIGHTMARE,2833,1542,213,198,411,51.8%,3m
6755,2,[VPB]Faucatrua,2833,401,18,17,35,51.4%,32m
6755,3,[TheVD]Spish,2833,343,12,8,20,60.0%,38m
6755,1,JakeTheGreat,2833,257,8,6,14,57.1%,3h
6755,1,MakkO,2833,184,6,2,8,75.0%,50m
6755,3,BapBap,2833,173,4,4,8,50.0%,48m
6755,1,SgtMac,2833,0,4,4,8,50.0%,35m
6755,3,Sleepy,2833,92,4,5,9,44.4%,9m
6755,2,Dune,2833,0,3,2,5,60.0%,45m
6764,3,defaspect,2832,1406,53,89,142,37.3%,38m
6764,2,[PISCO]CAPITAN,2832,890,40,40,80,50.0%,6m
6764,1,Bloodpack,2832,326,15,16,31,48.4%,50m
6764,3,zaes,2832,400,14,12,26,53.8%,35m
6764,2,BRZhadouken,2832,210,11,8,19,57.9%,10m
6764,3,JuanBobo,2832,249,9,1,10,90.0%,5m
6764,1,DoUdOu,2832,140,5,16,21,23.8%,5m
6764,3,Subaru,2832,35,2,2,4,50.0%,34m
6764,3,Berticus,2832,0,0,1,1,0.0%,48m
6764,3,DeepThot,2832,0,0,1,1,0.0%,32m
6774,1,Eusung,2831,608,24,26,50,48.0%,57m
6774,2,Goolash,2831,130,6,4,10,60.0%,50m
6774,1,[LOHs]popin,2831,168,4,6,10,40.0%,8m
6774,3,PIMBA,2831,0,3,2,5,60.0%,35m
6774,3,zxuGx,2831,30,2,4,6,33.3%,1h
6774,3,[VFam]Epidermus,2831,0,1,0,1,100.0%,52m
6780,3,CMGtml,2830,1477,75,87,162,46.3%,47m
6780,3,BabyZergling,2830,645,28,20,48,58.3%,31m
6780,3,Bobblehead,2830,344,13,6,19,68.4%,15m
6780,3,plus,2830,200,8,5,13,61.5%,9m
6780,1,CaSiS,2830,125,2,3,5,40.0%,1h
6780,1,paragon,2830,0,1,0,1,100.0%,1h
6780,3,LeNinja,2830,30,1,4,5,20.0%,12m
6787,3,[PINGP]Richardzerat,2829,1562,65,55,120,54.2%,16m
6787,3,KushUps,2829,710,32,16,48,66.7%,42m
6787,3,geozdiegoXD,2829,278,10,9,19,52.6%,50m
6787,3,Troll,2829,204,8,7,15,53.3%,42m
6787,2,Bemo,2829,130,4,4,8,50.0%,38m
6787,3,Owenator,2829,0,1,4,5,20.0%,53m
6787,3,[UpeV]LegendHero,2829,0,0,1,1,0.0%,48m
6794,3,Monty,2828,1338,77,62,139,55.4%,50m
6794,3,[dtwist]DarkVoice,2828,891,49,18,67,73.1%,16m
6794,3,CORN,2828,541,21,20,41,51.2%,32m
6794,3,[ValidG]hdmark,2828,335,12,7,19,63.2%,13m
6794,2,[Flar3s]MaximuS,2828,307,11,14,25,44.0%,50m
6794,2,xray,2828,42,2,0,2,100.0%,1h
6794,3,[BA5B]CAMERON,2828,0,0,1,1,0.0%,54m
6794,3,[PasT1]Bigshots,2828,0,0,2,2,0.0%,10m
6794,2,Zodiac,2828,0,0,3,3,0.0%,24m
6803,3,Jadch,2827,1364,69,70,139,49.6%,56m
6803,3,[BrNzUP]Tiny,2827,1069,64,13,77,83.1%,10m
6803,3,[GuN]Pogi,2827,264,8,5,13,61.5%,17m
6803,2,[Seinfd]George,2827,186,6,13,19,31.6%,56m
6803,3,[GRNSKN]Neroxas,2827,0,4,1,5,80.0%,50m
6803,2,Rize,2827,173,3,7,10,30.0%,12m
6803,2,[PtheG]Pendragon,2827,48,2,5,7,28.6%,1h
6803,3,[Peww]icecoldjuice,2827,30,1,1,2,50.0%,42m
6803,2,TarMinyatur,2827,67,1,7,8,12.5%,49m
6812,2,RandomIsImba,2826,987,62,56,118,52.5%,16m
6812,2,[63slas]Sivart,2826,591,25,22,47,53.2%,6m
6812,3,[MCY]JpBlacker,2826,426,17,8,25,68.0%,12m
6812,3,nitechaos,2826,224,13,13,26,50.0%,56m
6812,3,THEKING,2826,338,11,8,19,57.9%,12m
6812,3,LTSmash,2826,280,11,10,21,52.4%,47m
6812,1,[DNKCFT]ePHeCt,2826,209,7,2,9,77.8%,42m
6812,1,[HØST]Salgarello,2826,142,4,5,9,44.4%,1h
6812,3,[Smutty]Shamu,2826,0,1,0,1,100.0%,40m
6812,2,Killosopher,2826,0,1,1,2,50.0%,19m
6822,2,KeviNhO,2825,1399,86,73,159,54.1%,48m
6822,2,Cox,2825,202,55,40,95,57.9%,5m
6822,2,grasewicz,2825,1173,49,45,94,52.1%,16m
6822,2,[Xgamer]gnlbenkenobi,2825,854,32,32,64,50.0%,4m
6822,3,[6ixS]Carbon,2825,710,28,21,49,57.1%,38m
6822,3,BMcFatty,2825,390,14,11,25,56.0%,15m
6822,3,[142]Kurenzar,2825,194,5,9,14,35.7%,1h
6822,3,TyCoAvenger,2825,0,2,3,5,40.0%,38m
6822,3,BeSt,2825,30,1,1,2,50.0%,38m
6822,3,Beezkneez,2825,0,1,1,2,50.0%,35m
6822,2,TrumpFTW,2825,0,1,1,2,50.0%,1h
6822,3,[KSC2]ISSProxima,2825,0,0,1,1,0.0%,39m
6834,3,ImbaCyL,2824,735,68,54,122,55.7%,55m
6834,3,[GRNSKN]DLCForcesTTV,2824,543,28,16,44,63.6%,40m
6834,2,SewerWizard,2824,377,27,26,53,50.9%,11m
6834,3,Snij,2824,585,21,16,37,56.8%,4m
6834,1,ZerGUseR,2824,189,6,3,9,66.7%,54m
6834,3,[ARCsc2]Wrynn,2824,120,4,4,8,50.0%,4m
6834,1,Deado,2824,121,3,1,4,75.0%,6m
6834,3,llllllllllll,2824,0,3,2,5,60.0%,38m
6834,3,[SLAMT]LeGiTSkArK,2824,95,3,3,6,50.0%,15m
6834,3,Equalizer,2824,0,1,1,2,50.0%,47m
6834,3,Tdevil,2824,34,1,3,4,25.0%,1h
6834,3,[LQV]starwarex,2824,0,0,1,1,0.0%,16m
6834,3,Woz,2824,0,0,2,2,0.0%,39m
6847,3,[SWOLJ]NinjafOx,2823,1371,204,225,429,47.6%,9m
6847,2,Dodger,2823,1350,52,55,107,48.6%,56m
6847,2,Hateme,2823,522,22,24,46,47.8%,42m
6847,3,dvdseller,2823,195,11,9,20,55.0%,36m
6847,3,Matt,2823,187,8,7,15,53.3%,1h
6847,3,Rmao,2823,182,5,1,6,83.3%,47m
6847,3,JSMaster,2823,60,4,4,8,50.0%,50m
6847,3,Templar,2823,30,2,1,3,66.7%,14m
6847,1,[NLTTJ]Crawfish,2823,48,1,2,3,33.3%,49m
6847,3,wizardsleeve,2823,0,1,2,3,33.3%,15m
6847,3,[519mob]xAmImacroOox,2823,0,1,3,4,25.0%,38m
6847,3,KimJongLi,2823,0,0,1,1,0.0%,1h
6847,2,[Apug]Rockassist,2823,0,0,3,3,0.0%,1h
6847,2,Hendel,2823,0,0,3,3,0.0%,49m
6861,3,[DugNut]Tinkle,2822,873,45,12,57,78.9%,54m
6861,3,DPOD,2822,567,23,16,39,59.0%,45m
6861,3,RavenGloodus,2822,363,20,12,32,62.5%,38m
6861,3,[G501st]IIIIIIIIIIII,2822,444,16,17,33,48.5%,36m
6861,1,[DaiCa]MiAnLien,2822,493,15,27,42,35.7%,57m
6861,1,[WeGoon]hiig,2822,212,8,4,12,66.7%,1h
6861,2,jsviau,2822,188,5,5,10,50.0%,6m
6861,3,KiRA,2822,0,3,2,5,60.0%,50m
6861,2,Desamunt,2822,90,3,10,13,23.1%,4m
6861,3,cacharpo,2822,58,2,2,4,50.0%,14m
6861,3,Fredis,2822,0,2,3,5,40.0%,39m
6861,2,ynotloze,2822,0,1,0,1,100.0%,29m
6861,2,PMmeForDrugs,2822,0,1,1,2,50.0%,39m
6861,3,[Yaint]Marricx,2822,0,0,1,1,0.0%,17m
6875,3,NoobGaming,2821,893,53,23,76,69.7%,42m
6875,3,Dmitry,2821,478,18,17,35,51.4%,10m
6875,3,DoubleD,2821,404,15,9,24,62.5%,50m
6875,3,Xochimilco,2821,402,15,10,25,60.0%,16m
6875,3,pijaman,2821,114,5,3,8,62.5%,13m
6875,2,Idioteque,2821,30,4,5,9,44.4%,16m
6875,3,GERT,2821,0,3,2,5,60.0%,4m
6875,1,Pejelargarto,2821,122,2,4,6,33.3%,28m
6875,2,Serials,2821,0,1,0,1,100.0%,19m
6875,2,[H1M1D]Jonny,2821,0,0,3,3,0.0%,1h
6875,3,Cheerios,2821,0,0,3,3,0.0%,16m
6886,1,Fitzroy,2820,1586,99,107,206,48.1%,47m
6886,3,[SRCHA]KrisKon,2820,797,67,59,126,53.2%,31m
6886,3,Lit,2820,1297,54,53,107,50.5%,6m
6886,2,flypeach,2820,1114,46,44,90,51.1%,6m
6886,3,gsonerdxoxo,2820,158,12,11,23,52.2%,50m
6886,2,[TGosuB]PureVoltage,2820,0,0,3,3,0.0%,3h
6892,2,Jones,2819,546,20,22,42,47.6%,40m
6892,3,WTFunk,2819,224,9,7,16,56.2%,51m
6892,3,[AKDL]Cech,2819,233,8,4,12,66.7%,7m
6892,2,YasserKim,2819,244,7,11,18,38.9%,6m
6892,1,zerg,2819,171,5,3,8,62.5%,9m
6892,3,Asesinonino,2819,58,2,4,6,33.3%,34m
6892,1,SpaceInvader,2819,0,1,4,5,20.0%,16m
6899,3,TheBlackOne,2818,1625,370,341,711,52.0%,36m
6899,3,VITMDL,2818,1555,78,74,152,51.3%,37m
6899,3,OldDriver,2818,576,22,27,49,44.9%,47m
6899,3,TheLostSoul,2818,183,7,5,12,58.3%,54m
6899,3,[UncrNa]Pegge,2818,141,4,3,7,57.1%,36m
6899,2,teaz,2818,86,4,8,12,33.3%,43m
6899,1,Nightmare,2818,96,3,8,11,27.3%,1h
6899,3,super,2818,97,2,0,2,100.0%,16m
6899,3,JohnHogan,2818,58,2,1,3,66.7%,16m
6899,2,[AKAY47]TigOlBitties,2818,44,2,3,5,40.0%,4m
6899,1,ThisIzAtraP,2818,48,1,1,2,50.0%,4h
6899,3,GLaDOS,2818,30,1,2,3,33.3%,3m
6899,3,TinyGabe,2818,0,0,1,1,0.0%,39m
6912,1,SuedePritch,2817,1511,291,288,579,50.3%,3m
6912,2,Nate,2817,568,30,22,52,57.7%,4m
6912,2,sass,2817,0,4,1,5,80.0%,1h
6912,1,FreeAccount,2817,48,4,4,8,50.0%,3h
6912,3,banguela,2817,0,0,1,1,0.0%,10m
6912,3,[2up]JDogg,2817,0,0,1,1,0.0%,13m
6912,3,NeurotiCSagA,2817,0,0,1,1,0.0%,42m
6912,3,LANDA,2817,0,0,10,10,0.0%,35m
6920,2,Bighorn,2816,668,25,25,50,50.0%,8m
6920,1,Cyprezs,2816,335,10,15,25,40.0%,1h
6920,3,[INCAS]QUAGMIRE,2816,144,5,9,14,35.7%,12m
6920,3,BattleFreak,2816,94,4,2,6,66.7%,39m
6920,3,Dweloren,2816,60,3,2,5,60.0%,38m
6920,3,Murphy,2816,0,1,0,1,100.0%,51m
6920,3,Ender,2816,0,0,1,1,0.0%,14m
6920,3,Misha,2816,0,0,1,1,0.0%,5m
6928,3,Zannall,2815,1604,142,101,243,58.4%,49m
6928,2,[Batmn]kratoz,2815,1565,84,68,152,55.3%,53m
6928,3,[DubDom]LeafyAcorn,2815,1359,78,67,145,53.8%,14m
6928,3,jizzzstain,2815,532,26,18,44,59.1%,7m
6928,3,[KiMBR]Leonardo,2815,150,6,7,13,46.2%,15m
6928,1,daddyzeb,2815,0,5,2,7,71.4%,3h
6928,2,Bibulus,2815,122,5,11,16,31.2%,46m
6928,3,Zacknetic,2815,30,4,3,7,57.1%,16m
6928,3,[NM8]Matt,2815,58,2,1,3,66.7%,50m
6928,1,Shadows,2815,0,0,2,2,0.0%,6m
6938,3,[xARESx]Nerdles,2814,1430,73,49,122,59.8%,50m
6938,2,[NPhase]Kmerengetsum,2814,677,25,27,52,48.1%,6m
6938,1,Timmy,2814,295,10,15,25,40.0%,55m
6938,1,Kida,2814,0,4,3,7,57.1%,58m
6938,1,Ivellios,2814,192,4,4,8,50.0%,3h
6938,3,Workerrush,2814,30,2,3,5,40.0%,11m
6938,3,[DHZ0ne]Pedra,2814,0,1,1,2,50.0%,56m
6938,3,RedBeard,2814,0,0,1,1,0.0%,4m
6938,3,Gabriel,2814,0,0,1,1,0.0%,38m
6947,1,[HILLS]Spartacus,2813,1545,111,117,228,48.7%,38m
6947,3,Tisartktw,2813,1127,99,90,189,52.4%,15m
6947,2,sandwich,2813,1602,93,92,185,50.3%,16m
6947,3,Skyguy,2813,1248,74,69,143,51.7%,55m
6947,3,[SDC12]JABA,2813,1024,47,38,85,55.3%,48m
6947,2,Anasazi,2813,574,41,40,81,50.6%,54m
6947,3,DjJazzyGeoff,2813,818,31,32,63,49.2%,45m
6947,3,TaTKoSmurf,2813,308,10,6,16,62.5%,3h
6947,3,mcxlee,2813,86,3,2,5,60.0%,39m
6947,3,MrCrescent,2813,97,1,2,3,33.3%,1h
6947,3,Vincini,2813,0,0,2,2,0.0%,12m
6947,3,Pinche,2813,0,0,5,5,0.0%,7m
6959,3,LBD,2812,1522,150,159,309,48.5%,13m
6959,2,[0sC]hAZUdrONe,2812,1556,93,90,183,50.8%,10m
6959,3,homosexaul,2812,1189,54,32,86,62.8%,47m
6959,3,[nwBEAR]bear,2812,765,33,22,55,60.0%,32m
6959,3,[Iewd]StarTaleSuzy,2812,324,11,9,20,55.0%,34m
6959,2,vvvscs,2812,250,10,10,20,50.0%,53m
6959,2,[LQV]IJGI,2812,222,7,10,17,41.2%,4m
6959,3,Pamir,2812,58,5,4,9,55.6%,56m
6959,3,Brobocop,2812,0,3,2,5,60.0%,48m
6959,3,Aerodactyl,2812,0,3,3,6,50.0%,44m
6959,3,Cristian,2812,0,2,2,4,50.0%,38m
6959,3,SuperGrim,2812,30,2,3,5,40.0%,56m
6959,2,[tCo9]RnchroCsmico,2812,0,2,5,7,28.6%,13m
6959,3,[WINDD]slyTiger,2812,66,2,8,10,20.0%,1h
6959,3,jdb,2812,0,1,0,1,100.0%,38m
6959,3,Stymee,2812,0,0,3,3,0.0%,15m
6975,3,Challenger,2811,1501,100,90,190,52.6%,15m
6975,3,Wodan,2811,543,47,49,96,49.0%,42m
6975,2,[xf3]nApAlm,2811,388,16,11,27,59.3%,6m
6975,1,cpt,2811,168,5,5,10,50.0%,18m
6975,3,ExpressImba,2811,58,2,3,5,40.0%,2m
6980,3,Brid,2810,552,141,131,272,51.8%,14m
6980,3,ZergXR,2810,258,9,3,12,75.0%,11m
6980,2,Pinoldão,2810,252,9,14,23,39.1%,31m
6980,2,[RD2K17]Midgio,2810,102,4,4,8,50.0%,7m
6980,3,mOt,2810,30,2,5,7,28.6%,2m
6985,3,[Elder]pieguy,2809,1058,54,56,110,49.1%,42m
6985,3,SlikNdSneaky,2809,1100,45,38,83,54.2%,12m
6985,2,[NoBads]starfighter,2809,491,20,17,37,54.1%,32m
6985,3,MaJaeYoon,2809,382,14,10,24,58.3%,44m
6985,3,[PuStLe]Skalethon,2809,308,11,11,22,50.0%,38m
6985,3,CEROCUATRO,2809,115,3,1,4,75.0%,1h
6985,2,[BigOlD]TooTLooPs,2809,0,3,2,5,60.0%,33m
6985,1,marman,2809,165,3,3,6,50.0%,36m
6985,3,[TKS]KsFryray,2809,95,2,0,2,100.0%,10m
6985,3,[3DTRIG]PistolPete,2809,58,2,3,5,40.0%,15m
6985,1,[FAECES]Uriel,2809,0,0,2,2,0.0%,1h
6985,3,IAN,2809,0,0,2,2,0.0%,41m
6997,2,TheReaper,2808,991,43,37,80,53.8%,31m
6997,3,SCL,2808,485,30,17,47,63.8%,50m
6997,3,[DarkPG]DarkKnight,2808,335,21,11,32,65.6%,15m
6997,3,aris,2808,508,17,19,36,47.2%,41m
6997,3,Hunter,2808,234,8,10,18,44.4%,32m
6997,1,BobTheLob,2808,215,6,6,12,50.0%,4m
6997,2,[SC2MOO]Mishrac,2808,38,4,3,7,57.1%,48m
6997,3,[E2E]PABON,2808,95,3,3,6,50.0%,35m
6997,3,Ira,2808,60,3,5,8,37.5%,56m
6997,3,[Tyber]Jettn,2808,30,2,1,3,66.7%,52m
6997,3,[xRtGac]ArmyHavoc,2808,30,2,2,4,50.0%,53m
6997,3,Matt,2808,60,2,3,5,40.0%,13m
6997,3,[Berryz]slyknight,2808,60,2,4,6,33.3%,16m
6997,3,[scMAUI]Endymion,2808,0,1,2,3,33.3%,38m
6997,3,DarkSoul,2808,0,0,1,1,0.0%,14m
7012,1,SHIBBY,2807,1273,50,53,103,48.5%,52m
7012,3,Sodacan,2807,475,23,18,41,56.1%,9m
7012,2,[Zulu]King,2807,320,11,13,24,45.8%,54m
7012,3,Dan,2807,213,9,6,15,60.0%,39m
7012,3,GHOST,2807,173,6,1,7,85.7%,32m
7012,2,BenBen,2807,128,4,3,7,57.1%,38m
7012,3,Epoch,2807,86,3,4,7,42.9%,50m
7012,3,Energie,2807,0,2,3,5,40.0%,42m
7012,3,[6969]mikjagger,2807,0,2,3,5,40.0%,15m
7012,1,ROdamedium,2807,0,1,0,1,100.0%,3h
7012,3,fifou,2807,30,1,1,2,50.0%,10m
7012,3,[BCVets]MrSmithers,2807,0,1,2,3,33.3%,50m
7012,1,wildwolf,2807,0,0,1,1,0.0%,3h
7012,3,[XCoast]Cornelius,2807,0,0,4,4,0.0%,39m
7026,2,DudeMan,2806,1617,288,272,560,51.4%,7m
7026,3,MasterP,2806,1547,228,248,476,47.9%,54m
7026,3,[haut]grep,2806,1442,58,52,110,52.7%,39m
7026,2,Jonny,2806,0,1,0,1,100.0%,3h
7026,3,[Lac10]brujochilote,2806,0,1,0,1,100.0%,35m
7026,3,Stanley,2806,0,1,3,4,25.0%,7m
7026,3,Meals,2806,0,1,4,5,20.0%,35m
7026,3,[GOPERÚ]Jamj,2806,0,0,2,2,0.0%,19m
7026,3,Capitalist,2806,0,0,3,3,0.0%,16m
7035,2,[toOVEN]GLaDOS,2805,645,26,26,52,50.0%,46m
7035,2,ShrekBaggins,2805,566,22,24,46,47.8%,6m
7035,3,[ashjg]terranasoras,2805,454,16,49,65,24.6%,33m
7035,1,BattlePants,2805,331,12,16,28,42.9%,32m
7035,1,SkepticSloth,2805,202,8,4,12,66.7%,59m
7035,3,[SWOU]XxXFlashXxX,2805,222,7,2,9,77.8%,10m
7035,2,theplen,2805,207,7,10,17,41.2%,12m
7035,3,Pagnotta,2805,142,6,2,8,75.0%,4m
7035,2,balantay,2805,0,3,2,5,60.0%,1h
7035,3,Endless,2805,0,1,1,2,50.0%,9m
7035,2,bmackillaz,2805,0,1,3,4,25.0%,11m
7046,2,[CKG]Tirapiedraz,2804,1151,77,75,152,50.7%,4m
7046,2,Yes,2804,769,73,70,143,51.0%,4m
7046,2,WuttaRichard,2804,214,21,19,40,52.5%,35m
7046,3,MajorSparkle,2804,261,9,6,15,60.0%,39m
7046,1,Raven,2804,155,5,4,9,55.6%,1h
7046,3,angel,2804,0,4,1,5,80.0%,48m
7046,3,[AbcCo]HojuelaDMaiz,2804,118,4,2,6,66.7%,8m
7046,3,[UQQ2ME]BIG,2804,86,3,5,8,37.5%,44m
7046,3,[ZTemps]sietepalos,2804,30,2,1,3,66.7%,36m
7046,3,unholypanda,2804,0,1,0,1,100.0%,49m
7046,3,Farsgull,2804,0,1,0,1,100.0%,44m
7046,3,wickedftw,2804,0,1,0,1,100.0%,15m
7046,3,JamesBreznev,2804,30,1,2,3,33.3%,15m
7046,3,Gladys,2804,30,1,4,5,20.0%,56m
7046,3,[YS420]Shaffty,2804,30,1,4,5,20.0%,16m
7046,3,harryman,2804,0,0,3,3,0.0%,19m
7062,3,CoR,2803,442,15,14,29,51.7%,38m
7062,2,SmurfsDie,2803,349,15,19,34,44.1%,12m
7062,3,SiCKO,2803,343,13,14,27,48.1%,13m
7062,3,Alatriste,2803,180,6,8,14,42.9%,14m
7062,1,[sk3tch]TokesMcGanja,2803,207,5,3,8,62.5%,1h
7062,1,Verus,2803,118,5,4,9,55.6%,1h
7062,2,honey,2803,88,4,3,7,57.1%,46m
7062,3,NombreBacán,2803,58,3,6,9,33.3%,12m
7062,3,Thiccbagel,2803,0,2,3,5,40.0%,16m
7062,3,[EvilCC]EDUARS,2803,0,1,0,1,100.0%,56m
7062,3,NPCmajor,2803,0,0,1,1,0.0%,36m
7062,3,Saldanha,2803,0,0,1,1,0.0%,30m
7074,2,lacreatura,2802,1336,116,113,229,50.7%,6m
7074,1,HarryPothead,2802,200,10,7,17,58.8%,43m
7074,3,[ESF]IMsIMBA,2802,170,7,6,13,53.8%,14m
7074,3,Stryfe,2802,114,4,5,9,44.4%,12m
7074,3,Tenko,2802,58,3,2,5,60.0%,50m
7074,3,DanielR,2802,91,3,3,6,50.0%,35m
7074,3,[DGCIM]torto,2802,58,3,4,7,42.9%,12m
7074,3,grrr,2802,0,2,3,5,40.0%,40m
7074,3,GoatThroat,2802,0,1,0,1,100.0%,37m
7074,3,Jerian,2802,0,1,0,1,100.0%,54m
7074,3,SiegfrieD,2802,0,1,0,1,100.0%,13m
7074,3,[Jok3r]Banksy,2802,30,1,3,4,25.0%,38m
7074,3,prometheus,2802,30,1,4,5,20.0%,55m
7074,3,Sulfur,2802,0,0,1,1,0.0%,42m
7074,3,Tatoks,2802,0,0,2,2,0.0%,12m
7089,1,Bigchunk,2801,1308,61,68,129,47.3%,31m
7089,2,BIANG,2801,1329,53,45,98,54.1%,6m
7089,2,[3Gs]MTEEGZ,2801,745,31,31,62,50.0%,37m
7089,1,Nachdenklich,2801,191,7,6,13,53.8%,9m
7089,3,josue,2801,0,4,2,6,66.7%,14m
7089,2,[nbgPH]Napster,2801,0,3,2,5,60.0%,1h
7089,2,itsgotime,2801,48,2,6,8,25.0%,28m
7089,3,FSUTom,2801,30,1,1,2,50.0%,34m
7097,1,[ALQ]ReAdosS,2800,1585,259,253,512,50.6%,14m
7097,2,[xFsNxx]sPeCtRuM,2800,1314,112,101,213,52.6%,46m
7097,3,McBlanc,2800,1121,46,41,87,52.9%,42m
7097,2,Fritzmeister,2800,899,35,41,76,46.1%,33m
7097,3,bananamon,2800,751,31,21,52,59.6%,7m
7097,3,Torbjörn,2800,441,24,15,39,61.5%,52m
7097,3,Flank,2800,192,7,8,15,46.7%,38m
7097,3,[RIT]Icarus,2800,170,6,6,12,50.0%,1h
7097,1,MrBones,2800,144,5,4,9,55.6%,1h
7097,1,Veracity,2800,0,1,0,1,100.0%,1h
7097,2,[0PGC0]Betho,2800,0,0,1,1,0.0%,1h
7108,3,Ktunk,2799,1575,439,425,864,50.8%,17m
7108,2,Forestaurora,2799,1070,39,43,82,47.6%,34m
7108,3,Immortal,2799,146,6,5,11,54.5%,36m
7108,3,[αXLa]CEMAFATHI,2799,157,5,2,7,71.4%,15m
7108,2,[CGY]fumbucker,2799,106,4,4,8,50.0%,33m
7108,3,[LCE]FranciscoG,2799,0,2,3,5,40.0%,55m
7108,3,HoneyBadger,2799,0,1,0,1,100.0%,54m
7108,2,Xavier,2799,0,0,1,1,0.0%,22m
7116,1,[Bee]Lankonos,2798,1083,337,340,677,49.8%,3m
7116,2,mimori,2798,1259,284,300,584,48.6%,56m
7116,3,REM,2798,1596,103,91,194,53.1%,49m
7116,3,RottingTomb,2798,942,36,29,65,55.4%,42m
7116,3,IcyFather,2798,383,28,8,36,77.8%,33m
7116,3,BigJohnson,2798,70,5,9,14,35.7%,1h
7116,2,ANDREWYANG,2798,0,4,2,6,66.7%,52m
7116,3,[RPL]cLinto,2798,166,4,5,9,44.4%,15m
7116,2,KillahHunt,2798,0,3,2,5,60.0%,1h
7116,1,[CHAN4]RonBurgundy,2798,97,1,4,5,20.0%,3h
7116,2,Steve,2798,42,1,6,7,14.3%,56m
7116,3,[Severe]StormCluster,2798,0,0,1,1,0.0%,6m
7128,3,PLAYMAKER,2797,467,20,16,36,55.6%,43m
7128,2,TheJudge,2797,381,16,16,32,50.0%,37m
7128,3,[Albino]ItsHappening,2797,153,7,1,8,87.5%,9m
7128,2,OmniKai,2797,181,6,7,13,46.2%,42m
7128,1,HADES,2797,150,6,9,15,40.0%,33m
7128,2,CPMou,2797,0,4,2,6,66.7%,48m
7128,2,opprotoss,2797,155,4,3,7,57.1%,15m
7128,1,Zeddricon,2797,92,3,3,6,50.0%,3h
7128,3,MESC,2797,0,2,3,5,40.0%,39m
7128,3,jjj,2797,30,1,1,2,50.0%,56m
7128,2,StyliAnT,2797,0,0,1,1,0.0%,3h
7128,3,dhyung,2797,0,0,1,1,0.0%,39m
7140,3,Vegita,2796,936,46,26,72,63.9%,10m
7140,3,Simonsaysz,2796,218,8,4,12,66.7%,38m
7140,3,Sterben,2796,114,4,4,8,50.0%,55m
7140,1,[xTQc]Katamundi,2796,48,4,5,9,44.4%,1h
7140,3,doofus,2796,60,3,4,7,42.9%,10m
7140,3,Rampage,2796,0,2,3,5,40.0%,38m
7140,3,[DSGs]Tsubasa,2796,0,2,4,6,33.3%,49m
7140,1,[Bunge]Roadkill,2796,0,0,1,1,0.0%,1h
7148,2,Ecuatoss,2795,732,157,149,306,51.3%,16m
7148,3,OutKast,2795,1552,139,128,267,52.1%,43m
7148,3,RKN,2795,612,34,23,57,59.6%,15m
7148,3,Timousse,2795,170,18,19,37,48.6%,42m
7148,1,Aither,2795,206,7,5,12,58.3%,58m
7148,1,Sangreshed,2795,188,5,1,6,83.3%,6m
7148,2,kocko,2795,0,4,1,5,80.0%,3h
7148,3,GolDaniels,2795,95,1,1,2,50.0%,42m
7148,3,Phaze,2795,0,0,1,1,0.0%,13m
7148,3,HelixOxford,2795,0,0,1,1,0.0%,44m
7158,2,Tsugaru,2794,1367,186,167,353,52.7%,51m
7158,2,Schweder,2794,1480,87,86,173,50.3%,35m
7158,3,DumDum,2794,889,42,20,62,67.7%,42m
7158,2,KingRomstar,2794,312,13,9,22,59.1%,3h
7158,3,WGFURY,2794,297,11,7,18,61.1%,14m
7158,2,kota,2794,0,3,1,4,75.0%,1h
7158,3,Firebat,2794,121,3,2,5,60.0%,57m
7165,3,dartelaryon,2793,1191,78,64,142,54.9%,41m
7165,3,Squanchy,2793,658,40,25,65,61.5%,33m
7165,3,FatherZeus,2793,198,8,8,16,50.0%,56m
7165,1,scraul,2793,144,6,4,10,60.0%,1h
7165,1,Czechowicz,2793,191,6,6,12,50.0%,3h
7165,3,Jangus,2793,88,4,5,9,44.4%,42m
7165,3,AgentOfChaos,2793,60,2,6,8,25.0%,34m
7165,3,Warped,2793,0,0,2,2,0.0%,56m
7173,3,Shippy,2792,1481,103,96,199,51.8%,39m
7173,2,Borzinator,2792,1295,51,56,107,47.7%,35m
7173,3,Elson,2792,533,20,21,41,48.8%,8m
7173,3,Sundown,2792,424,15,18,33,45.5%,52m
7173,3,[Chummp]DALEG,2792,142,5,5,10,50.0%,16m
7173,3,SpaceCaptain,2792,30,1,1,2,50.0%,43m
7173,3,[B055]ShadowTiger,2792,30,1,1,2,50.0%,56m
7180,1,Achilles,2791,778,187,184,371,50.4%,7m
7180,2,Raggamuffin,2791,1126,148,143,291,50.9%,12m
7180,2,[BrisK]RaGe,2791,424,16,15,31,51.6%,31m
7180,3,pessoe,2791,178,7,6,13,53.8%,12m
7180,1,yfgkytl,2791,190,6,6,12,50.0%,45m
7180,3,beardontcare,2791,155,4,8,12,33.3%,49m
7180,2,[TxT]Cynich,2791,84,3,5,8,37.5%,37m
7180,1,[UpxV]CondorAlfa,2791,0,1,7,8,12.5%,1h
7180,3,SirBeefySwag,2791,0,0,1,1,0.0%,49m
7180,3,Ícaro,2791,0,0,1,1,0.0%,27m
7180,2,NemO,2791,0,0,1,1,0.0%,3h
7180,3,StevenCurry,2791,0,0,2,2,0.0%,14m
7192,3,Steel,2790,1059,61,60,121,50.4%,5m
7192,3,[TGosuB]Nukemaster,2790,926,44,22,66,66.7%,43m
7192,2,ThaNaTo,2790,693,31,32,63,49.2%,7m
7192,1,[nomame]minifig,2790,169,6,6,12,50.0%,3h
7192,1,[SEK420]kuPsen,2790,139,3,2,5,60.0%,39m
7192,2,Snide,2790,0,3,2,5,60.0%,55m
7192,1,[TGosuA]TheRomanian,2790,97,3,4,7,42.9%,48m
7192,3,Gatt,2790,0,1,0,1,100.0%,51m
7192,3,[4Pics]Bladefight,2790,30,1,2,3,33.3%,42m
7192,3,MundoPc,2790,0,0,1,1,0.0%,16m
7202,3,RoidVoid,2789,1363,54,52,106,50.9%,53m
7202,3,sxtycat,2789,388,14,15,29,48.3%,52m
7202,2,WildRage,2789,258,11,11,22,50.0%,1h
7202,3,Brutus,2789,288,10,7,17,58.8%,38m
7202,2,Thrascall,2789,242,8,9,17,47.1%,51m
7202,2,[tehbut]Voketo,2789,242,7,12,19,36.8%,36m
7202,3,warboy,2789,150,3,11,14,21.4%,10m
7202,3,Vaeleran,2789,96,2,4,6,33.3%,48m
7210,2,[cluez]halfE,2788,1042,70,72,142,49.3%,33m
7210,3,Swankypants,2788,510,23,15,38,60.5%,10m
7210,3,squeech,2788,273,12,8,20,60.0%,24m
7210,3,Indianadrone,2788,127,4,2,6,66.7%,55m
7210,3,Rocksteady,2788,124,4,6,10,40.0%,35m
7210,3,SewerSquirel,2788,109,3,5,8,37.5%,38m
7210,3,superpraw,2788,60,3,6,9,33.3%,13m
7210,3,[DNKCET]KloacaHarris,2788,0,1,2,3,33.3%,42m
7210,3,[FFDP]GSeebs,2788,0,0,1,1,0.0%,16m
7210,3,Sparky,2788,0,0,1,1,0.0%,49m
7220,1,Paladin,2787,1526,151,141,292,51.7%,32m
7220,1,SnobbyOcto,2787,1150,67,70,137,48.9%,14m
7220,3,SleepyBear,2787,1308,55,52,107,51.4%,38m
7220,3,[DXPCA]Sebastian,2787,270,14,9,23,60.9%,17m
7220,2,Manplank,2787,95,2,1,3,66.7%,3h
7225,2,cloud,2786,300,14,19,33,42.4%,42m
7225,3,Prometheus,2786,276,11,12,23,47.8%,33m
7225,3,Jamie,2786,168,6,6,12,50.0%,40m
7225,2,Whitepolar,2786,0,4,1,5,80.0%,3h
7225,3,[Gooons]lumberjack,2786,120,4,6,10,40.0%,10m
7225,3,[NEW]MORTE,2786,0,3,2,5,60.0%,47m
7225,3,Mixalot,2786,30,3,3,6,50.0%,40m
7225,3,SlowMan,2786,75,2,5,7,28.6%,1h
7225,2,sangi,2786,0,1,0,1,100.0%,1h
7225,3,[tdrs]eyecomehonor,2786,0,0,1,1,0.0%,15m
7225,3,[GoPctm]Bari,2786,0,0,2,2,0.0%,51m
7225,3,Pwnage,2786,0,0,2,2,0.0%,15m
7237,2,hkxsuperhero,2785,994,61,62,123,49.6%,42m
7237,3,DawgyDawg,2785,624,27,22,49,55.1%,38m
7237,2,JDR,2785,294,13,14,27,48.1%,16m
7237,1,Rob,2785,48,2,2,4,50.0%,1h
7241,3,THCodb,2784,362,14,14,28,50.0%,52m
7241,2,zero,2784,316,13,18,31,41.9%,41m
7241,3,[S0O]FIREGROUND,2784,233,8,4,12,66.7%,7m
7241,3,vulak,2784,0,1,2,3,33.3%,9m
7241,3,[Z4TS]Evanator,2784,0,0,1,1,0.0%,35m
7246,3,[SKSR]zephyr,2783,664,85,86,171,49.7%,11m
7246,1,KoopaTroopa,2783,924,82,90,172,47.7%,45m
7246,3,novo,2783,611,22,19,41,53.7%,3m
7246,2,VeinStain,2783,380,12,24,36,33.3%,54m
7246,3,[FuNg]Mushroom,2783,170,6,11,17,35.3%,38m
7246,3,[lwhy]RealLeader,2783,60,3,2,5,60.0%,40m
7246,3,mjm,2783,0,1,0,1,100.0%,42m
7246,3,[TeamUR]DrEuclidean,2783,30,1,1,2,50.0%,38m
7254,2,IncaPaisa,2782,1540,288,288,576,50.0%,13m
7254,2,[CORON4]vIrUS,2782,1589,173,189,362,47.8%,40m
7254,2,Orkin,2782,900,31,40,71,43.7%,10m
7254,3,asfd,2782,463,16,17,33,48.5%,39m
7254,3,[ssexxy]Covaena,2782,116,3,0,3,100.0%,32m
7254,3,[NMX]Toluxero,2782,0,3,2,5,60.0%,38m
7254,2,BlackBurn,2782,0,3,3,6,50.0%,1h
7254,3,[N0FKz]hershy,2782,62,3,5,8,37.5%,12m
7254,2,[RogueW]DarkTemplar,2782,0,2,1,3,66.7%,3h
7254,3,Reynor,2782,0,0,1,1,0.0%,16m
7254,1,DRUNKALISK,2782,0,0,1,1,0.0%,22m
7254,3,[MaLiZ]Tangobsesion,2782,0,0,3,3,0.0%,52m
7266,3,HmLee,2781,1316,230,224,454,50.7%,47m
7266,3,TheJangler,2781,1270,76,56,132,57.6%,38m
7266,2,[HPSLM]SenorShim,2781,1300,64,64,128,50.0%,56m
7266,3,EveryLevel,2781,577,25,15,40,62.5%,55m
7266,3,[R0DANT]Cranium,2781,172,6,6,12,50.0%,44m
7266,3,soN,2781,191,5,5,10,50.0%,15m
7266,3,SayNoToStim,2781,0,0,1,1,0.0%,4m
7266,2,Kenshi,2781,0,0,5,5,0.0%,14m
7274,2,Partywave,2780,1501,117,122,239,49.0%,12m
7274,3,Alucard,2780,330,112,103,215,52.1%,52m
7274,3,legacy,2780,628,22,25,47,46.8%,36m
7274,3,IIIIIIIIIIII,2780,333,14,9,23,60.9%,10m
7274,3,glhf,2780,305,12,8,20,60.0%,33m
7274,3,[ZT0]zukov,2780,322,11,11,22,50.0%,49m
7274,2,bobcat,2780,214,9,8,17,52.9%,1h
7274,3,[OD2019]Raise,2780,86,4,2,6,66.7%,45m
7274,3,[P3AC3]Reflection,2780,60,2,4,6,33.3%,15m
7274,3,[W3Mod]FistechFiend,2780,58,2,4,6,33.3%,12m
7274,3,HorseButHole,2780,60,2,6,8,25.0%,12m
7274,2,Killmachine,2780,0,1,0,1,100.0%,1h
7274,3,SnAfU,2780,0,0,1,1,0.0%,4m
7274,3,HunterElite,2780,0,0,1,1,0.0%,34m
7288,3,Aalleyway,2779,867,35,30,65,53.8%,2m
7288,3,Wick,2779,584,27,21,48,56.2%,12m
7288,3,[NCEs]Raycu,2779,435,20,9,29,69.0%,12m
7288,3,AmUnknown,2779,249,11,3,14,78.6%,54m
7288,3,HerrKamerad,2779,217,8,7,15,53.3%,15m
7288,3,Beto,2779,217,7,6,13,53.8%,15m
7288,3,DarkMatters,2779,95,1,1,2,50.0%,3m
7288,2,[Incred]Shreazla,2779,0,1,2,3,33.3%,1h
7296,2,KimJongSkill,2778,869,41,34,75,54.7%,41m
7296,3,BadOmen,2778,935,38,33,71,53.5%,15m
7296,3,[KTWN]NewWonjo,2778,485,22,13,35,62.9%,13m
7296,3,Mush,2778,270,8,12,20,40.0%,42m
7296,2,SuperQ,2778,118,7,8,15,46.7%,36m
7296,3,South,2778,182,6,10,16,37.5%,39m
7296,3,Darkness,2778,97,4,6,10,40.0%,16m
7296,2,Trapnasty,2778,181,4,8,12,33.3%,1h
7296,2,SamEvans,2778,0,3,3,6,50.0%,3h
7296,3,lime,2778,30,3,5,8,37.5%,42m
7296,3,supraspeed,2778,0,1,0,1,100.0%,32m
7296,3,[OPTZ]ikyoba,2778,0,0,2,2,0.0%,38m
7308,1,Quackpork,2777,1141,147,137,284,51.8%,8m
7308,2,[RUMB]Zoid,2777,1539,140,145,285,49.1%,12m
7308,3,[Z420]RamRod,2777,1537,125,114,239,52.3%,8m
7308,3,KILLERZERG,2777,1523,111,104,215,51.6%,50m
7308,3,Jro,2777,1394,109,93,202,54.0%,40m
7308,3,Sildenafil,2777,824,39,28,67,58.2%,40m
7308,3,[KiDo]agodeli,2777,424,22,8,30,73.3%,40m
7308,2,[ZealF]jrozzi,2777,247,11,9,20,55.0%,53m
7308,3,Holz,2777,256,10,3,13,76.9%,42m
7308,1,TheGambler,2777,154,8,9,17,47.1%,55m
7308,3,QuBuS,2777,166,6,5,11,54.5%,34m
7308,3,xDiShPiGx,2777,165,5,2,7,71.4%,50m
7308,2,ShakiestGun,2777,0,4,2,6,66.7%,1h
7308,3,Aresmar,2777,137,3,3,6,50.0%,41m
7308,3,TheGodFather,2777,60,2,7,9,22.2%,45m
7323,2,[REXB]Submunition,2776,1319,50,49,99,50.5%,11m
7323,2,InfestdFurby,2776,842,33,40,73,45.2%,40m
7323,3,[kØ]NAIRTENS,2776,198,9,9,18,50.0%,50m
7323,3,Julius,2776,173,7,3,10,70.0%,39m
7323,3,Nephira,2776,245,7,5,12,58.3%,10m
7323,3,WildCat,2776,156,5,1,6,83.3%,53m
7323,2,Envy,2776,158,3,4,7,42.9%,15m
7323,3,AppleJax,2776,0,0,1,1,0.0%,51m
7323,3,InfernEx,2776,0,0,1,1,0.0%,14m
7332,1,Atrocitus,2775,854,95,93,188,50.5%,6m
7332,3,Ezeon,2775,380,16,15,31,51.6%,3m
7332,3,snail,2775,148,8,2,10,80.0%,48m
7332,3,StuKov,2775,166,5,1,6,83.3%,39m
7332,3,Lorinis,2775,112,4,4,8,50.0%,5m
7332,2,Moyses,2775,0,2,1,3,66.7%,3h
7332,3,[BT44]Mako,2775,0,0,1,1,0.0%,55m
7339,2,tex,2774,802,32,36,68,47.1%,33m
7339,2,calypso,2774,714,26,27,53,49.1%,3m
7339,3,BrookzDERP,2774,300,11,7,18,61.1%,44m
7339,3,[FIow]madSCIeNTiSt,2774,198,9,11,20,45.0%,49m
7339,1,WuTang,2774,96,6,5,11,54.5%,15m
7339,1,[OOCG]sycoticjason,2774,213,6,6,12,50.0%,1h
7339,1,Railen,2774,139,3,9,12,25.0%,43m
7339,3,Ruso,2774,0,2,3,5,40.0%,31m
7339,3,Nyaruko,2774,0,2,3,5,40.0%,43m
7339,1,[DRKFOX]sunkae,2774,0,1,0,1,100.0%,58m
7349,3,Chatiko,2773,1527,192,163,355,54.1%,12m
7349,3,Spinoza,2773,852,36,36,72,50.0%,38m
7349,3,Ormuz,2773,554,29,20,49,59.2%,56m
7349,2,[SWOU]Cuper,2773,588,23,23,46,50.0%,46m
7349,2,[GOPERÚ]irvin,2773,380,21,25,46,45.7%,12m
7349,3,[TFT]SushiCat,2773,468,16,16,32,50.0%,45m
7349,3,Moridin,2773,298,15,5,20,75.0%,54m
7349,1,xxoxx,2773,164,7,6,13,53.8%,11m
7349,1,Sironimo,2773,216,6,7,13,46.2%,50m
7349,3,CFaddaEsport,2773,177,6,9,15,40.0%,4h
7349,3,Cajual,2773,167,5,3,8,62.5%,55m
7349,3,Frostytatas,2773,0,3,3,6,50.0%,40m
7349,2,daveruski,2773,0,2,3,5,40.0%,3h
7349,3,Huitza,2773,30,2,6,8,25.0%,2m
7349,3,Goku,2773,0,0,1,1,0.0%,5m
7349,3,xXRICHARDXx,2773,0,0,2,2,0.0%,44m
7349,3,namaste,2773,0,0,2,2,0.0%,56m
7349,3,Anthony,2773,0,0,5,5,0.0%,52m
7367,2,Gambeulin,2772,1332,201,203,404,49.8%,42m
7367,2,gambitmonk,2772,1597,156,155,311,50.2%,38m
7367,3,pumba,2772,966,94,76,170,55.3%,42m
7367,3,Razul,2772,738,34,18,52,65.4%,56m
7367,2,BigBoss,2772,582,20,30,50,40.0%,5m
7367,2,ninecorpses,2772,413,17,14,31,54.8%,51m
7367,3,Tao,2772,88,6,5,11,54.5%,10m
7367,1,MindWalkerX,2772,0,1,1,2,50.0%,1h
7367,2,Mikuo,2772,0,0,1,1,0.0%,5m
7367,3,Nooby,2772,0,0,1,1,0.0%,37m
7377,3,MarineKing,2771,1252,50,40,90,55.6%,8m
7377,2,Foxboy,2771,688,27,25,52,51.9%,3m
7377,3,OGKUSH,2771,434,25,20,45,55.6%,16m
7377,3,[FATwS]FatIsaac,2771,285,12,10,22,54.5%,16m
7377,3,SmurfysLaw,2771,292,10,8,18,55.6%,1h
7377,3,[Feudal]HAMMERxDOWN,2771,193,6,7,13,46.2%,45m
7377,3,JoTa,2771,150,5,13,18,27.8%,51m
7377,3,GameTheorist,2771,0,2,3,5,40.0%,32m
7377,1,[YE3T]ForrestGump,2771,94,2,5,7,28.6%,1h
7377,2,Singularity,2771,0,1,0,1,100.0%,1h
7387,3,Malziekam,2770,1236,47,47,94,50.0%,48m
7387,3,trpvOne,2770,850,37,27,64,57.8%,45m
7387,2,Spacemonster,2770,545,24,21,45,53.3%,31m
7387,3,Barn,2770,534,22,21,43,51.2%,48m
7387,2,[CBF]NinjaBird,2770,542,21,24,45,46.7%,4m
7387,3,TSandwich,2770,370,14,14,28,50.0%,15m
7387,3,CoronaVirus,2770,229,10,5,15,66.7%,35m
7387,3,Pincho,2770,220,9,7,16,56.2%,38m
7387,2,Castlevania,2770,134,6,5,11,54.5%,48m
7387,3,Trippin,2770,90,6,6,12,50.0%,44m
7387,3,Fishy,2770,110,3,0,3,100.0%,15m
7387,3,[PWNDya]Pinkiemind,2770,86,3,5,8,37.5%,47m
7387,3,[NSTYBZ]matus,2770,30,2,2,4,50.0%,50m
7387,3,RichardNixon,2770,137,2,9,11,18.2%,1h
7387,3,CondThanatus,2770,0,0,1,1,0.0%,37m
7387,3,scotteh,2770,0,0,2,2,0.0%,50m
7403,3,Shinji,2769,1241,76,66,142,53.5%,38m
7403,3,Biccboii,2769,503,20,22,42,47.6%,16m
7403,3,[GOPERÚ]Danatextraño,2769,320,13,5,18,72.2%,37m
7403,3,[GDTS]Plasmius,2769,236,8,12,20,40.0%,6m
7403,1,AlanEspinoza,2769,184,6,3,9,66.7%,1h
7403,3,Shikamaru,2769,153,6,4,10,60.0%,12m
7403,3,leetanderson,2769,212,6,7,13,46.2%,56m
7403,3,DonuttTrump,2769,105,4,3,7,57.1%,15m
7403,3,[DTML]Polyknikes,2769,0,2,4,6,33.3%,32m
7403,3,Peter,2769,109,2,5,7,28.6%,38m
7403,3,Cheese,2769,0,1,0,1,100.0%,14m
7403,3,[WNTRCO]Kiljaden,2769,0,0,3,3,0.0%,1h
7415,3,[ZTemps]dayodave,2768,1088,80,56,136,58.8%,4m
7415,2,Xero,2768,348,13,15,28,46.4%,36m
7415,2,[LACRAS]RATAMASTA,2768,221,7,13,20,35.0%,49m
7415,3,[FGHER]Ben,2768,154,6,6,12,50.0%,14m
7415,3,ToastWhisper,2768,30,2,3,5,40.0%,38m
7415,2,TPlink,2768,0,2,3,5,40.0%,44m
7415,2,SkeViHuE,2768,0,1,6,7,14.3%,7m
7422,1,Pygy,2767,1379,123,120,243,50.6%,41m
7422,2,Arthas,2767,491,20,19,39,51.3%,8m
7422,2,Infidel,2767,327,15,12,27,55.6%,3m
7422,3,BlackSwarm,2767,361,14,13,27,51.9%,43m
7422,2,Fortesque,2767,324,12,10,22,54.5%,3h
7422,3,NoMads,2767,216,7,4,11,63.6%,50m
7422,3,large,2767,234,7,5,12,58.3%,35m
7422,2,Deathcall,2767,192,7,10,17,41.2%,11m
7422,3,PABLOKX,2767,193,6,2,8,75.0%,40m
7422,2,LolSucks,2767,185,5,4,9,55.6%,1h
7422,1,chungus,2767,145,5,5,10,50.0%,1h
7422,3,Yamato,2767,86,5,6,11,45.5%,12m
7422,1,Megachrist,2767,144,3,4,7,42.9%,10m
7422,2,[ripps]Armaggedon,2767,30,2,8,10,20.0%,7m
7422,3,astigflip,2767,93,1,1,2,50.0%,37m
7422,3,Cosmoz,2767,0,0,1,1,0.0%,16m
7422,3,[sk3tch]RIMKICA,2767,0,0,2,2,0.0%,15m
7439,3,[Pig2]GGCowabunga,2766,1170,87,81,168,51.8%,41m
7439,3,[danuts]tonsofdamage,2766,965,80,76,156,51.3%,45m
7439,2,ACES,2766,1011,64,60,124,51.6%,46m
7439,3,[EXL2]SombrA,2766,1208,47,44,91,51.6%,39m
7439,3,DeadlyKitten,2766,616,25,14,39,64.1%,12m
7439,3,[MARV3L]BtotheMoon,2766,203,10,6,16,62.5%,35m
7439,2,SuperiorX,2766,242,9,13,22,40.9%,16m
7439,3,MasterDiablo,2766,114,3,1,4,75.0%,3m
7439,3,[BADMFS]Technodynamc,2766,131,3,4,7,42.9%,38m
7439,2,TinLeague,2766,60,3,8,11,27.3%,6m
7439,2,Vezon,2766,88,2,0,2,100.0%,1h
7439,3,Shoneroc,2766,30,2,1,3,66.7%,42m
7439,2,[POL]WildRage,2766,88,2,2,4,50.0%,1h
7439,3,[G3tgud]Boxer,2766,0,0,1,1,0.0%,49m
7439,2,[1Ec0n1]gunner,2766,0,0,1,1,0.0%,41m
7454,1,[HS]Dealer,2765,1608,565,547,1112,50.8%,4m
7454,2,[Sh33r]SeamyComic,2765,1582,264,279,543,48.6%,7m
7454,2,LooneyToon,2765,891,36,36,72,50.0%,33m
7454,3,[MxSC]Shadow,2765,738,30,30,60,50.0%,36m
7454,1,HelloThere,2765,470,19,23,42,45.2%,34m
7454,3,TurboBeast,2765,406,17,14,31,54.8%,32m
7454,3,[SABO]ORAGNA,2765,346,14,6,20,70.0%,8m
7454,3,whatever,2765,328,12,11,23,52.2%,32m
7454,3,KrakenSlayer,2765,123,9,3,12,75.0%,16m
7454,3,[YomYom]ButterNugget,2765,161,7,5,12,58.3%,35m
7454,1,Wolverine,2765,163,4,1,5,80.0%,3h
7454,3,KMAxStretch,2765,0,3,3,6,50.0%,12m
7454,3,vamak,2765,118,2,2,4,50.0%,10m
7454,3,GringoStar,2765,0,2,3,5,40.0%,47m
7454,1,MustardTiger,2765,0,1,1,2,50.0%,23m
7454,3,Eon,2765,30,1,2,3,33.3%,49m
7454,3,Adrenaline,2765,0,0,1,1,0.0%,3m
7454,3,Chiddybang,2765,0,0,1,1,0.0%,44m
7454,3,DeX,2765,0,0,1,1,0.0%,31m
7454,3,Studlius,2765,0,0,2,2,0.0%,47m
7474,3,[DRGNS]PeruvnSwarm,2764,412,16,17,33,48.5%,42m
7474,3,[IiUiI]KoshNaranek,2764,264,8,14,22,36.4%,55m
7474,1,[KrAce]cris,2764,168,7,6,13,53.8%,3h
7474,3,Link,2764,148,6,6,12,50.0%,34m
7474,3,MurderMage,2764,132,5,4,9,55.6%,10m
7474,3,EasyAI,2764,141,4,4,8,50.0%,36m
7474,3,[R4NK3D]Mau,2764,58,3,5,8,37.5%,56m
7474,3,[LHdH]EdEvans,2764,113,2,1,3,66.7%,38m
7482,3,ThaKid,2763,614,48,35,83,57.8%,33m
7482,3,MadeofStars,2763,445,30,20,50,60.0%,44m
7482,3,[Efflux]MuFFinMaN,2763,451,23,22,45,51.1%,12m
7482,3,grannit,2763,278,12,6,18,66.7%,43m
7482,3,MpK,2763,144,5,6,11,45.5%,38m
7482,1,Defadog,2763,158,4,4,8,50.0%,4h
7482,3,Austerity,2763,0,3,2,5,60.0%,5m
7482,3,lIlIIlIlIIll,2763,0,2,3,5,40.0%,40m
7482,1,Wedge,2763,97,1,1,2,50.0%,3h
7482,1,[catcat]minds,2763,0,0,1,1,0.0%,1h
7492,1,[WuTang]Tofu,2762,1563,112,120,232,48.3%,53m
7492,3,[G79]imzesok,2762,1375,67,59,126,53.2%,15m
7492,3,[Brohan]Kezsorg,2762,977,37,34,71,52.1%,43m
7492,3,somethingsho,2762,439,19,14,33,57.6%,49m
7492,3,PooopDollar,2762,352,14,6,20,70.0%,38m
7492,2,WaywardMage,2762,0,4,1,5,80.0%,1h
7492,3,Yoda,2762,60,2,5,7,28.6%,17m
7492,3,carrydacarro,2762,0,0,1,1,0.0%,35m
7492,3,JungleBridge,2762,0,0,3,3,0.0%,10m
7501,1,Pessen,2761,96,6,5,11,54.5%,12m
7501,2,Zack,2761,145,6,6,12,50.0%,46m
7501,2,Preach,2761,124,5,16,21,23.8%,5m
7501,2,SKinGX,2761,120,4,14,18,22.2%,46m
7501,3,[TGosuD]Warchief,2761,138,3,3,6,50.0%,38m
7501,1,[TKON]LilAl,2761,96,2,3,5,40.0%,3h
7501,2,Rizla,2761,116,2,6,8,25.0%,43m
7501,3,[Build]Crabalanche,2761,0,1,0,1,100.0%,16m
7509,3,Zakiir,2760,735,169,168,337,50.1%,9m
7509,3,GenPurge,2760,1116,108,100,208,51.9%,35m
7509,2,Zero,2760,431,18,13,31,58.1%,42m
7509,2,Tululu,2760,145,9,10,19,47.4%,1h
7509,2,brseiye,2760,171,7,8,15,46.7%,55m
7509,3,xNataS,2760,0,0,1,1,0.0%,15m
7509,2,Achex,2760,0,0,2,2,0.0%,5m
7509,3,BoganArmy,2760,0,0,3,3,0.0%,15m
7517,3,muninn,2759,1318,53,50,103,51.5%,38m
7517,2,[HØST]LeoWalker,2759,180,19,19,38,50.0%,12m
7517,2,[jobjap]Japsap,2759,94,4,2,6,66.7%,1h
7517,2,Chrizzo,2759,48,4,3,7,57.1%,1h
7517,3,chiuxjai,2759,115,2,3,5,40.0%,56m
7517,3,[MOLES]JahRule,2759,58,2,5,7,28.6%,15m
7517,1,Residue,2759,0,1,0,1,100.0%,1h
7517,2,BBgamer,2759,0,1,0,1,100.0%,30m
7525,3,[Pizzy]Vainoteu,2758,1212,110,96,206,53.4%,15m
7525,2,Iraw,2758,1074,39,47,86,45.3%,46m
7525,3,[Light1]ToastyGaming,2758,380,14,15,29,48.3%,49m
7525,3,Guyles,2758,262,10,12,22,45.5%,2m
7525,3,Sword,2758,58,5,5,10,50.0%,13m
7525,3,[Fr0nt]Midnitegyro,2758,120,5,6,11,45.5%,13m
7525,3,[EZYtgt]Torn,2758,60,3,2,5,60.0%,35m
7525,1,VVingless,2758,40,3,3,6,50.0%,56m
7525,1,WeaselKing,2758,0,1,1,2,50.0%,1h
7525,2,SuperNinja,2758,48,1,1,2,50.0%,9m
7525,3,WONDERBOY,2758,0,1,3,4,25.0%,9m
7525,1,WarpigxxxL,2758,113,1,3,4,25.0%,1h
7525,3,SuperPants,2758,30,1,5,6,16.7%,56m
7538,3,LSBJ,2757,60,5,4,9,55.6%,54m
7538,1,[SQUEE]Castaway,2757,215,5,10,15,33.3%,36m
7538,2,seunghwan,2757,88,4,4,8,50.0%,17m
7538,3,[NeAs]Zippo,2757,0,3,3,6,50.0%,17m
7538,3,[MLscGs]paintballman,2757,58,3,6,9,33.3%,53m
7538,1,oze,2757,0,0,3,3,0.0%,46m
7544,2,[Mc]CaMaX,2756,1245,55,52,107,51.4%,42m
7544,3,KillerAZ,2756,1159,53,37,90,58.9%,38m
7544,3,IconicKnight,2756,311,12,14,26,46.2%,51m
7544,1,[ramrad]russo,2756,232,8,8,16,50.0%,39m
7544,2,TooMuchLeaf,2756,226,5,12,17,29.4%,54m
7544,2,Amarant,2756,96,4,2,6,66.7%,8m
7544,3,RageForger,2756,90,4,6,10,40.0%,5m
7544,1,[RdRC]TcoR,2756,131,2,5,7,28.6%,28m
7544,1,Artifact,2756,0,1,0,1,100.0%,3h
7544,2,LittleOlive,2756,95,1,1,2,50.0%,3h
7544,3,[TIJ]sZshock,2756,93,1,5,6,16.7%,4m
7544,1,glOpP,2756,0,0,1,1,0.0%,56m
7544,3,[ethicc]Yackob,2756,0,0,2,2,0.0%,38m
7557,2,MeIGibson,2755,762,35,33,68,51.5%,41m
7557,3,[HØST]EliasParrini,2755,685,33,20,53,62.3%,15m
7557,3,[ESW]Mecoboy,2755,685,27,24,51,52.9%,56m
7557,2,Smores,2755,540,20,22,42,47.6%,16m
7557,3,Phlegethon,2755,395,17,14,31,54.8%,42m
7557,3,scarabones,2755,237,11,7,18,61.1%,1h
7557,1,[xxxbow]Glub,2755,125,4,5,9,44.4%,1h
7557,2,TheUndead,2755,0,2,3,5,40.0%,20m
7557,2,JoJo,2755,0,1,4,5,20.0%,3h
7557,2,kyrie,2755,0,0,2,2,0.0%,1h
7567,2,NeoSecondSEA,2754,622,32,30,62,51.6%,48m
7567,3,Solindar,2754,482,17,20,37,45.9%,38m
7567,3,[YEOBO]yeobo,2754,198,5,6,11,45.5%,15m
7567,2,JonathanD,2754,0,2,1,3,66.7%,50m
7567,1,Renrag,2754,42,1,1,2,50.0%,28m
7572,3,Dre,2753,1423,114,102,216,52.8%,3m
7572,3,Naturgummier,2753,322,72,54,126,57.1%,7m
7572,3,[JRT]Hikikomori,2753,930,61,53,114,53.5%,43m
7572,1,Craving,2753,874,53,68,121,43.8%,51m
7572,3,[LQV]BOTOvermind,2753,172,6,10,16,37.5%,16m
7572,1,ImCharliHz,2753,0,3,4,7,42.9%,13m
7572,1,MoldyCracks,2753,38,2,0,2,100.0%,1h
7572,1,Divinity,2753,0,1,0,1,100.0%,29m
7572,3,Maeata,2753,0,1,1,2,50.0%,52m
7581,2,Kroeker,2752,536,21,22,43,48.8%,43m
7581,2,marv,2752,119,7,10,17,41.2%,3h
7581,2,WoundedNun,2752,0,3,3,6,50.0%,11m
7581,2,Hibuddy,2752,0,3,4,7,42.9%,7m
7581,1,encguitarist,2752,0,1,0,1,100.0%,11m
7581,1,[KVR]SINA,2752,0,0,1,1,0.0%,24m
7587,2,[I3ro]Donjuancho,2751,896,63,73,136,46.3%,42m
7587,2,MarineThots,2751,284,13,15,28,46.4%,51m
7587,3,Mist,2751,155,5,3,8,62.5%,16m
7587,3,[PVZ50]theoboyAUSD,2751,183,5,9,14,35.7%,14m
7587,2,[DIKOUT]Enigma,2751,106,4,5,9,44.4%,36m
7587,3,Nahnix,2751,30,2,5,7,28.6%,38m
7587,1,[DhZAc1]OlavinhoXD,2751,0,1,0,1,100.0%,11m
7587,3,LegoMan,2751,0,1,1,2,50.0%,40m
7587,1,Zergalicious,2751,0,0,1,1,0.0%,1h
7596,1,ººº,2750,1524,72,32,104,69.2%,1h
7596,3,Winbar,2750,125,5,2,7,71.4%,47m
7596,3,SpongeBoB,2750,30,2,2,4,50.0%,10m
7596,1,Profet,2750,0,2,7,9,22.2%,1h
7596,1,MinerOnly,2750,40,1,1,2,50.0%,1h
7596,2,moenkhaus,2750,0,0,1,1,0.0%,20m
7602,3,LeatherySock,2749,1026,45,31,76,59.2%,32m
7602,1,Metric,2749,348,11,7,18,61.1%,1h
7602,3,SaltyClam,2749,258,10,11,21,47.6%,50m
7602,1,Jimi,2749,153,9,1,10,90.0%,49m
7602,1,Obstruction,2749,116,3,1,4,75.0%,48m
7602,3,[SCCoop]CôEmMaCàRông,2749,86,3,4,7,42.9%,16m
7602,3,Lightingwar,2749,94,2,1,3,66.7%,38m
7602,1,XxPerverzoxX,2749,0,1,0,1,100.0%,40m
7602,1,[LTWAR]Daster,2749,42,1,2,3,33.3%,50m
7611,2,SCC,2748,1235,138,140,278,49.6%,15m
7611,3,[PTHero]HyperTurtle,2748,738,31,24,55,56.4%,3m
7611,3,[MFE]ISuckS,2748,636,25,23,48,52.1%,35m
7611,3,raigomaru,2748,95,2,1,3,66.7%,42m
7611,1,[IvD]GosuAppa,2748,0,1,0,1,100.0%,26m
7611,3,TonyStark,2748,0,1,2,3,33.3%,52m
7617,1,PrimalOoze,2747,138,5,5,10,50.0%,40m
7617,1,Redcrosse,2747,162,3,1,4,75.0%,1h
7617,1,[STOON]LEGendary,2747,97,3,4,7,42.9%,11m
7617,3,Rho,2747,32,1,3,4,25.0%,1h
7617,1,BakeEyes,2747,0,0,1,1,0.0%,20m
7617,1,BoKoR,2747,0,0,3,3,0.0%,3h
7623,3,MacDaddy,2746,1001,47,26,73,64.4%,42m
7623,3,[ExcIgN]Psychology,2746,896,39,35,74,52.7%,10m
7623,3,Sonic,2746,509,23,26,49,46.9%,38m
7623,1,Toby,2746,216,9,12,21,42.9%,15m
7623,3,ThinkTwice,2746,95,2,1,3,66.7%,38m
7623,1,LegiT,2746,48,1,2,3,33.3%,12m
7623,3,Dargon,2746,0,0,2,2,0.0%,12m
7630,3,EvolutionZ,2745,1579,100,91,191,52.4%,35m
7630,2,Kent,2745,1566,93,86,179,52.0%,3m
7630,3,jjjjjjjjj,2745,497,22,12,34,64.7%,6m
7630,1,Display,2745,536,18,17,35,51.4%,11m
7630,2,rodo,2745,253,8,6,14,57.1%,1h
7630,3,Sillonson,2745,180,8,7,15,53.3%,40m
7630,1,[Rk63]artwo,2745,34,2,0,2,100.0%,1h
7630,3,[sk3tch]Jensen,2745,117,2,3,5,40.0%,34m
7630,1,[SJO]yoonloop,2745,0,2,3,5,40.0%,1h
7630,2,[FKYA]ShTouR,2745,30,2,6,8,25.0%,46m
7630,1,Vague,2745,0,1,0,1,100.0%,16m
7630,1,[BWLL]Marusvineyrd,2745,40,1,2,3,33.3%,42m
7630,1,commandercj,2745,0,0,1,1,0.0%,1h
7643,3,vicccccccccc,2744,905,103,87,190,54.2%,2m
7643,2,[ScSwrm]Panda,2744,1539,98,94,192,51.0%,42m
7643,3,DarkSlug,2744,1133,45,43,88,51.1%,4m
7643,3,[BBOX]Firelion,2744,906,40,30,70,57.1%,4m
7643,3,bbade,2744,599,24,28,52,46.2%,56m
7643,2,Fadatats,2744,538,19,27,46,41.3%,41m
7643,1,Abridenal,2744,296,11,8,19,57.9%,1h
7643,3,[Mammy]Tomhumfree,2744,271,10,10,20,50.0%,56m
7651,1,[NLTN]Domi,2743,1502,190,195,385,49.4%,32m
7651,3,Ventricosa,2743,410,16,18,34,47.1%,40m
7651,1,Twiddlestorm,2743,78,3,0,3,100.0%,16m
7651,2,[disabl]ImRetarded,2743,96,2,4,6,33.3%,22m
7651,2,JhuN,2743,0,2,10,12,16.7%,34m
7651,1,Celesarn,2743,0,1,0,1,100.0%,14m
7651,1,[eX]FnX,2743,0,0,1,1,0.0%,1h
7651,3,Ranoik,2743,0,0,3,3,0.0%,15m
7659,2,KingOfPop,2742,811,29,28,57,50.9%,45m
7659,3,Niplheim,2742,198,9,6,15,60.0%,12m
7659,3,TheOne,2742,174,6,9,15,40.0%,44m
7659,2,theRuoi,2742,94,3,1,4,75.0%,41m
7659,1,[CACTS]MaxVeers,2742,0,0,1,1,0.0%,48m
7664,3,seansc,2741,894,49,35,84,58.3%,10m
7664,2,clf,2741,417,16,22,38,42.1%,36m
7664,2,dæmon,2741,60,5,6,11,45.5%,47m
7664,1,[8IIlID]SSJemmett,2741,96,1,2,3,33.3%,3h
7664,3,WhiteKey,2741,0,1,3,4,25.0%,49m
7664,3,[1snD]Xylithol,2741,30,1,5,6,16.7%,35m
7670,2,[CSH]SpartanAlumn,2740,362,41,42,83,49.4%,4m
7670,3,[RVSV]Viceroy,2740,778,32,25,57,56.1%,37m
7670,3,[DLe]chatoworld,2740,815,31,28,59,52.5%,38m
7670,1,[FaO]TheBeesKnees,2740,443,14,9,23,60.9%,1h
7670,3,[FauLTy]ReDD,2740,396,13,18,31,41.9%,40m
7675,2,KillerRa,2739,1398,186,165,351,53.0%,43m
7675,3,Phil,2739,1264,57,46,103,55.3%,48m
7675,3,Psuedo,2739,749,28,26,54,51.9%,15m
7675,1,Flower,2739,658,26,16,42,61.9%,36m
7675,3,FattPenguin,2739,538,22,21,43,51.2%,53m
7675,3,[Swilly]SuperSaiyan,2739,535,20,16,36,55.6%,39m
7675,1,endl,2739,0,3,2,5,60.0%,1h
7675,3,[PASTY]rootbeer,2739,136,3,4,7,42.9%,12m
7675,1,CausticVom,2739,0,3,5,8,37.5%,3h
7675,1,GagamelsRage,2739,0,1,4,5,20.0%,1h
7685,3,Benaiah,2738,415,25,22,47,53.2%,7m
7685,1,PanZerG,2738,266,8,5,13,61.5%,1h
7685,3,[SkAL]Ozlord,2738,112,4,4,8,50.0%,54m
7685,1,alucard,2738,0,1,0,1,100.0%,45m
7685,1,Earlsling,2738,0,1,0,1,100.0%,36m
7690,1,Crucio,2737,1179,100,95,195,51.3%,1h
7690,3,[Lp]Blessmen,2737,848,96,79,175,54.9%,48m
7690,3,crazyelf,2737,1441,68,61,129,52.7%,36m
7690,3,Topotamdr,2737,854,32,33,65,49.2%,43m
7690,3,Snb,2737,444,21,8,29,72.4%,16m
7690,3,zealis,2737,376,14,15,29,48.3%,32m
7690,2,SacredSelf,2737,390,14,19,33,42.4%,17m
7690,3,UHURU,2737,150,5,8,13,38.5%,7m
7690,2,FireBat,2737,0,4,1,5,80.0%,27m
7690,1,battlechode,2737,120,4,3,7,57.1%,1h
7690,2,Silentstash,2737,0,2,3,5,40.0%,3m
7701,1,Zinmasta,2736,514,57,46,103,55.3%,1h
7701,1,jseashell,2736,1199,43,40,83,51.8%,1h
7701,1,Sorrow,2736,574,22,18,40,55.0%,42m
7701,3,[ARGENT]Tutsinator,2736,421,17,12,29,58.6%,42m
7701,3,[YEOBO]nahcaD,2736,436,15,15,30,50.0%,35m
7701,1,pieroomarco,2736,302,10,9,19,52.6%,1h
7701,1,fvelmntnja,2736,245,7,7,14,50.0%,1h
7701,1,[imN0ob]axelspider,2736,78,5,3,8,62.5%,1h
7701,1,Tom,2736,110,3,1,4,75.0%,3h
7701,1,[VECT]seanzor,2736,0,0,1,1,0.0%,1h
7711,3,ZroXD,2735,243,9,8,17,52.9%,56m
7711,2,EnigmaTome,2735,182,6,2,8,75.0%,36m
7711,2,Mudge,2735,0,3,2,5,60.0%,3h
7711,3,bossdawg,2735,0,1,1,2,50.0%,1h
7711,3,Hagian,2735,92,1,3,4,25.0%,38m
7711,1,love,2735,48,1,6,7,14.3%,12m
7711,1,Zergi,2735,0,0,1,1,0.0%,12m
7718,3,[PiGPan]MrWilson,2734,1480,57,54,111,51.4%,15m
7718,3,ToRndOfSoulZ,2734,1028,37,40,77,48.1%,3m
7718,2,Shogeki,2734,335,14,14,28,50.0%,34m
7718,1,Krawstaw,2734,208,9,11,20,45.0%,15m
7718,1,[LIEF]Panquesito,2734,0,1,0,1,100.0%,1h
7723,3,Brunost,2733,1560,247,242,489,50.5%,41m
7723,3,[PREGG]SpartanG,2733,452,28,24,52,53.8%,51m
7723,3,Jlance,2733,483,22,13,35,62.9%,12m
7723,3,icemanida,2733,434,15,12,27,55.6%,12m
7723,2,Colossus,2733,302,11,18,29,37.9%,4m
7723,2,Mattyto,2733,119,8,3,11,72.7%,56m
7723,1,Broski,2733,42,2,0,2,100.0%,27m
7723,1,Lambo,2733,0,1,1,2,50.0%,42m
7723,3,OpticalPunch,2733,30,1,9,10,10.0%,52m
7723,3,[gamerb]CrySoHard,2733,0,0,4,4,0.0%,56m
7723,2,[GRO]Ailati,2733,0,0,5,5,0.0%,3h
7734,2,YogurtEater,2732,1240,83,83,166,50.0%,37m
7734,3,Crabapple,2732,342,49,35,84,58.3%,43m
7734,3,[WHYYYY]WEEBRIOSIS,2732,567,21,17,38,55.3%,39m
7734,2,SSRSnake,2732,93,1,3,4,25.0%,45m
7738,3,Singularity,2731,1139,54,56,110,49.1%,16m
7738,3,hjgh,2731,1194,47,46,93,50.5%,14m
7738,1,DPHO,2731,180,9,8,17,52.9%,4m
7738,3,Mijob,2731,30,5,3,8,62.5%,38m
7738,1,JaymesReady,2731,168,4,3,7,57.1%,3h
7738,1,VODKANCRAN,2731,0,1,0,1,100.0%,1h
7738,3,Gauren,2731,0,0,5,5,0.0%,48m
7745,2,[KGH]Pocaris,2730,1547,90,92,182,49.5%,7m
7745,1,sunfaija,2730,387,16,3,19,84.2%,3h
7745,3,lryS,2730,301,16,17,33,48.5%,56m
7745,1,Sakthepro,2730,176,5,2,7,71.4%,1h
7745,2,Gregh,2730,44,4,3,7,57.1%,3h
7745,3,[PeePz]MadeInChina,2730,120,3,4,7,42.9%,49m
7745,1,Leonic,2730,44,1,3,4,25.0%,1h
7745,1,[icCCce]InfernoForce,2730,0,0,1,1,0.0%,30m
7745,1,screenslaver,2730,0,0,1,1,0.0%,1h
7754,2,[IiUiI]Antisaint,2729,1094,78,76,154,50.6%,39m
7754,3,[RoadL]essTraversed,2729,865,33,36,69,47.8%,5m
7754,2,Rusher,2729,91,4,2,6,66.7%,3h
7754,2,Bowman,2729,94,4,5,9,44.4%,5m
7754,2,[Deeeez]Swiss,2729,97,3,3,6,50.0%,3h
7754,2,epicwamm,2729,0,3,3,6,50.0%,45m
7754,1,[Nuutzz]ToxicJackal,2729,0,1,0,1,100.0%,1h
7754,2,Ochre,2729,0,1,4,5,20.0%,29m
7754,1,PotatoFields,2729,0,0,2,2,0.0%,12m
7763,3,[DRKPMT]Gamble,2728,1409,252,237,489,51.5%,14m
7763,2,XDCesarDX,2728,1266,139,118,257,54.1%,32m
7763,2,[50cal]SilentSpell,2728,1508,81,80,161,50.3%,46m
7763,2,MaiPai,2728,1134,52,51,103,50.5%,46m
7763,3,NMsinse,2728,895,40,38,78,51.3%,12m
7763,1,MelIris,2728,425,16,17,33,48.5%,41m
7763,1,[8kPLUS]CombatKingg,2728,0,1,0,1,100.0%,1h
7770,2,Balazs,2727,695,28,28,56,50.0%,4m
7770,3,JokingForYou,2727,498,18,22,40,45.0%,42m
7770,3,DrgnSlayer,2727,318,11,14,25,44.0%,42m
7770,1,KindSir,2727,0,1,1,2,50.0%,45m
7770,1,Deezeegee,2727,0,0,1,1,0.0%,59m
7775,2,toofattotype,2726,1391,62,54,116,53.4%,55m
7775,1,Witty,2726,322,13,14,27,48.1%,1h
7775,1,Darksun,2726,288,9,7,16,56.2%,59m
7775,3,nougats,2726,188,7,8,15,46.7%,4m
7775,3,dragonfly,2726,192,5,6,11,45.5%,1h
7775,1,joakc,2726,0,0,1,1,0.0%,3h
7775,1,IIIIIIIIIIII,2726,0,0,2,2,0.0%,12m
7775,1,[SYNDCT]AngelofSc,2726,0,0,3,3,0.0%,4h
7775,2,TheKingMoose,2726,0,0,9,9,0.0%,4m
7784,2,InspireAloha,2725,467,47,41,88,53.4%,5m
7784,3,CiroGames,2725,632,29,21,50,58.0%,42m
7784,3,Biorex,2725,348,16,14,30,53.3%,43m
7784,1,SCVrush,2725,389,13,7,20,65.0%,48m
7784,3,michealaa,2725,280,13,9,22,59.1%,12m
7784,1,Whatever,2725,86,5,2,7,71.4%,24m
7784,3,[Hamish]Hamish,2725,121,3,3,6,50.0%,1h
7784,2,stokes,2725,30,3,6,9,33.3%,32m
7784,2,[HTP450]angel,2725,0,1,1,2,50.0%,3h
7784,3,betheball,2725,0,1,3,4,25.0%,7m
7784,3,[SBoys]Elterranazul,2725,0,1,4,5,20.0%,38m
7784,1,[FALURS]Squeeky,2725,0,0,1,1,0.0%,49m
7784,1,StarNynfa,2725,0,0,1,1,0.0%,9m
7797,3,Monkey,2724,595,24,17,41,58.5%,36m
7797,3,ZoidbergsMum,2724,338,13,14,27,48.1%,7m
7797,3,MrCraftia,2724,239,8,6,14,57.1%,1h
7797,3,GeneralMazz,2724,216,8,14,22,36.4%,12m
7797,3,NSTARDUST,2724,60,3,6,9,33.3%,5m
7797,2,lala,2724,0,1,1,2,50.0%,54m
7797,1,oOGoSuOo,2724,0,0,1,1,0.0%,3h
7797,3,robdog,2724,0,0,4,4,0.0%,52m
7805,1,Will,2723,1341,55,37,92,59.8%,1h
7805,3,RaidersRoll,2723,527,53,48,101,52.5%,52m
7805,3,BladeSlash,2723,490,32,28,60,53.3%,47m
7805,3,[Atone]fukthisgame,2723,513,24,18,42,57.1%,40m
7805,1,LutschMRN,2723,391,16,11,27,59.3%,21m
7805,3,CLaUs,2723,422,16,18,34,47.1%,16m
7805,1,GICR,2723,364,11,7,18,61.1%,1h
7805,3,Trips,2723,239,10,5,15,66.7%,49m
7805,3,[D0M0]xXXLustXxx,2723,219,7,6,13,53.8%,36m
7805,2,Kyoumadess,2723,139,5,3,8,62.5%,1h
7805,1,Sam,2723,143,5,6,11,45.5%,1h
7805,3,Zouski,2723,100,4,4,8,50.0%,36m
7805,3,[Drug]ColdChi,2723,0,1,1,2,50.0%,39m
7818,3,PainTrain,2722,1379,64,58,122,52.5%,44m
7818,1,[TY4GG]EasyComputer,2722,1105,45,31,76,59.2%,1h
7818,1,Deathgear,2722,1064,37,29,66,56.1%,24m
7818,2,[UFC]aktuner,2722,880,30,38,68,44.1%,4m
7818,3,Orbitalperid,2722,584,28,25,53,52.8%,12m
7818,3,JanKz,2722,443,18,16,34,52.9%,55m
7818,1,[iljili]HungLikeOrc,2722,227,9,4,13,69.2%,1h
7818,3,llllllllllll,2722,220,9,11,20,45.0%,1h
7818,2,HackErIsTop,2722,0,2,3,5,40.0%,56m
7818,1,[SP1622]SuperPenguin,2722,82,2,4,6,33.3%,3h
7818,2,BlindOtter,2722,30,2,7,9,22.2%,7m
7818,1,[GRYRE]BilboBaggins,2722,0,1,0,1,100.0%,3h
7830,3,[mtcL]zerg,2721,492,17,18,35,48.6%,32m
7830,2,beastlyguy,2721,0,2,3,5,40.0%,1h
7830,2,abc,2721,0,1,0,1,100.0%,3h
7830,2,[HZxZ]Warwind,2721,0,0,2,2,0.0%,9m
7834,3,Phalynx,2720,1278,75,55,130,57.7%,53m
7834,3,HOUSE,2720,867,35,32,67,52.2%,34m
7834,2,[MBQ]Mattymat,2720,697,24,33,57,42.1%,46m
7834,1,TrafcoRaviol,2720,321,19,18,37,51.4%,26m
7834,3,Orlandu,2720,245,9,12,21,42.9%,1h
7834,1,Rex,2720,267,8,6,14,57.1%,48m
7834,3,ZEN,2720,30,4,5,9,44.4%,16m
7834,1,GilbertSicot,2720,236,4,6,10,40.0%,1h
7834,1,Ohmsoutlaw,2720,0,1,2,3,33.3%,1h
7834,2,PartinGG,2720,88,1,2,3,33.3%,35m
7834,1,SgtSlaughter,2720,0,1,4,5,20.0%,3h
7834,3,[Oddjob]ButtHexor,2720,0,0,2,2,0.0%,41m
7834,1,[IPCSI]Carmesino,2720,0,0,2,2,0.0%,1h
7847,3,Dreadnaught,2719,1539,336,328,664,50.6%,15m
7847,3,Arctaeus,2719,1428,55,57,112,49.1%,44m
7847,3,destroyer,2719,359,25,22,47,53.2%,36m
7847,3,SoccerMom,2719,94,5,6,11,45.5%,36m
7847,3,Sebs,2719,94,4,6,10,40.0%,36m
7847,1,SuperPlayer,2719,36,1,1,2,50.0%,43m
7853,2,[scvpog]Pann,2718,790,32,35,67,47.8%,54m
7853,3,llllllllllll,2718,426,18,15,33,54.5%,55m
7853,3,[Fever]llllllllllll,2718,30,2,3,5,40.0%,47m
7853,1,Guywithgun,2718,0,0,1,1,0.0%,3h
7857,3,CommandoBdog,2717,1543,122,120,242,50.4%,9m
7857,2,kronos,2717,396,14,20,34,41.2%,5m
7857,3,BigHead,2717,198,7,11,18,38.9%,42m
7857,2,Chille,2717,90,6,8,14,42.9%,16m
7857,1,causeway,2717,0,4,1,5,80.0%,1h
7857,2,[oBRO]Meowmix,2717,0,4,2,6,66.7%,45m
7857,3,[CatDad]FancyFetus,2717,0,1,3,4,25.0%,46m
7857,3,[FNKY]MicroBe,2717,30,1,4,5,20.0%,41m
7865,2,XXLVXX,2716,1128,104,100,204,51.0%,47m
7865,1,Jesibet,2716,1506,101,112,213,47.4%,44m
7865,3,OolongTea,2716,1471,58,61,119,48.7%,11m
7865,3,LLamaKing,2716,514,21,24,45,46.7%,42m
7865,3,[Saltye]DragL,2716,305,11,10,21,52.4%,10m
7865,2,zelothero,2716,30,6,5,11,54.5%,56m
7865,1,DrBowMan,2716,120,4,1,5,80.0%,3h
7865,2,[ooPLoo]QuBuS,2716,121,3,1,4,75.0%,1h
7865,1,Glaedr,2716,114,3,2,5,60.0%,1h
7865,1,Straw,2716,0,3,2,5,60.0%,1h
7865,1,NotSaitama,2716,40,2,2,4,50.0%,4h
7865,3,[Nu]kilcupcake,2716,0,2,3,5,40.0%,15m
7865,3,DinJoo,2716,30,2,4,6,33.3%,32m
7865,2,LOVEBYUN,2716,0,0,8,8,0.0%,35m
7879,2,PJLO,2715,432,52,47,99,52.5%,10m
7879,3,Kiang,2715,1059,46,37,83,55.4%,42m
7879,3,[Sune]yukimura,2715,863,40,39,79,50.6%,57m
7879,3,Eccentrix,2715,617,25,20,45,55.6%,3m
7879,3,Fenser,2715,426,18,14,32,56.2%,35m
7879,1,[MLKSHK]Jin,2715,495,15,15,30,50.0%,29m
7879,3,SkynetII,2715,146,6,11,17,35.3%,10m
7879,3,[TheNME]draker,2715,146,5,12,17,29.4%,16m
7879,1,VitorHugo,2715,120,4,5,9,44.4%,1h
7879,1,DaBi,2715,0,3,2,5,60.0%,1h
7879,2,OOXIXOO,2715,0,3,3,6,50.0%,3h
7879,1,[ELTEMW]Nyquist,2715,40,2,0,2,100.0%,1h
7879,1,Cranberry,2715,0,2,3,5,40.0%,1h
7892,2,Magnum,2714,1573,166,157,323,51.4%,48m
7892,3,Greedo,2714,495,35,30,65,53.8%,3m
7892,3,Natesurf,2714,619,24,26,50,48.0%,16m
7892,3,DustyDusters,2714,292,11,9,20,55.0%,27m
7892,1,Mjalfication,2714,297,10,7,17,58.8%,1h
7892,2,Luc,2714,206,7,4,11,63.6%,30m
7892,1,[UpxV]Hybrid,2714,198,5,8,13,38.5%,26m
7892,1,TripleAught,2714,112,3,5,8,37.5%,24m
7900,3,ShadowStorm,2713,1123,42,42,84,50.0%,54m
7900,3,Hypegiaphobe,2713,486,30,37,67,44.8%,39m
7900,3,Maitoparta,2713,576,21,26,47,44.7%,3m
7900,3,Style,2713,312,11,13,24,45.8%,50m
7900,1,[IDoom]Harbinger,2713,123,2,3,5,40.0%,41m
7900,1,[PiGPan]Malinka,2713,0,0,1,1,0.0%,6m
7900,1,SUPETEN,2713,73,0,2,2,0.0%,52m
7907,3,abe,2712,950,38,33,71,53.5%,41m
7907,1,PaltryNewt,2712,400,13,6,19,68.4%,1h
7907,1,nooboldmen,2712,202,7,5,12,58.3%,1h
7907,3,[Ba1t]ranger,2712,184,7,10,17,41.2%,17m
7907,1,[MIT]scsteve,2712,116,4,2,6,66.7%,1h
7907,2,zerg,2712,0,4,2,6,66.7%,45m
7907,2,[mustaf]protosusalad,2712,96,4,3,7,57.1%,3h
7907,3,ZeroVirus,2712,86,4,5,9,44.4%,52m
7907,3,phaiT,2712,127,3,0,3,100.0%,26m
7907,3,AureliusRex,2712,90,3,9,12,25.0%,14m
7907,1,[RwtM]Blaze,2712,76,2,1,3,66.7%,40m
7907,1,[xGPLx]IndigoStorm,2712,78,2,4,6,33.3%,1h
7907,2,[Wesye]Wesye,2712,46,1,2,3,33.3%,1h
7907,1,valentino,2712,0,0,1,1,0.0%,3h
7921,3,[ACSS]Dadams,2711,1177,109,107,216,50.5%,39m
7921,3,[LPrD]Tri,2711,613,87,67,154,56.5%,52m
7921,1,LoseImprove,2711,296,10,10,20,50.0%,1h
7921,2,[BLOML]CygnusXone,2711,216,6,11,17,35.3%,33m
7921,2,Jaguar,2711,114,3,3,6,50.0%,56m
7921,2,QuBuS,2711,181,3,3,6,50.0%,3h
7921,1,[XpKAc]alberto,2711,0,1,0,1,100.0%,56m
7921,3,DrDrew,2711,30,1,5,6,16.7%,2m
7929,2,CaptLadybug,2710,1560,225,263,488,46.1%,32m
7929,3,Warren,2710,1325,55,50,105,52.4%,47m
7929,1,Loki,2710,759,30,22,52,57.7%,3m
7929,1,Jealousbean,2710,327,12,8,20,60.0%,1h
7929,1,Elmugroso,2710,364,11,8,19,57.9%,36m
7929,1,OneTrueNoob,2710,238,8,7,15,53.3%,3h
7929,1,llllllllllll,2710,262,7,6,13,53.8%,29m
7929,3,WalrusCow,2710,148,4,5,9,44.4%,35m
7929,3,Seskem,2710,0,2,3,5,40.0%,1h
7929,2,automation,2710,0,1,1,2,50.0%,3m
7929,1,WingZeroType,2710,48,1,4,5,20.0%,51m
7929,1,[XWIS]FOodLiOn,2710,0,1,4,5,20.0%,30m
7941,2,Metronome,2709,819,33,33,66,50.0%,4m
7941,2,Curry,2709,48,2,1,3,66.7%,1h
7941,1,Alejosaurio,2709,0,1,0,1,100.0%,37m
7941,1,barbaerotica,2709,0,1,1,2,50.0%,50m
7941,2,DönerKing,2709,88,1,1,2,50.0%,60m
7946,1,Runandhide,2708,1333,113,120,233,48.5%,13m
7946,1,[CFFL]Spirit,2708,1518,55,50,105,52.4%,43m
7946,1,Matches,2708,578,23,17,40,57.5%,3h
7946,3,Nascar,2708,365,21,18,39,53.8%,37m
7946,3,Sky,2708,345,13,12,25,52.0%,50m
7946,1,[KuroS]KuroSenshi,2708,182,6,4,10,60.0%,11m
7946,1,stepie,2708,198,5,3,8,62.5%,3h
7946,1,[P4NDAS]Hammerhead,2708,216,4,6,10,40.0%,15m
7946,1,[SCIIpy]Vash,2708,0,3,2,5,60.0%,1h
7946,1,Frestón,2708,38,2,0,2,100.0%,45m
7946,1,[TlClS]Virus,2708,0,1,0,1,100.0%,3h
7946,1,Hindrance,2708,0,1,1,2,50.0%,1h
7958,2,[CCBB]TrainXII,2707,751,31,29,60,51.7%,46m
7958,2,aaaaaa,2707,750,28,34,62,45.2%,48m
7958,2,Stammit,2707,0,4,3,7,57.1%,53m
7958,1,LambKebab,2707,120,2,5,7,28.6%,1h
7958,1,zakguo,2707,0,1,8,9,11.1%,1h
7963,3,Publius,2706,1545,79,79,158,50.0%,32m
7963,3,[PiN0YS]Parusa,2706,990,41,38,79,51.9%,38m
7963,1,[FMX]Dante,2706,790,31,19,50,62.0%,21m
7963,1,Zerocross,2706,572,20,14,34,58.8%,1h
7963,3,BigJay,2706,226,9,9,18,50.0%,36m
7963,3,[OTEL]ROOMMAA,2706,156,6,13,19,31.6%,57m
7963,1,[EGx]KevineytorXD,2706,183,5,6,11,45.5%,1h
7963,3,[CORNET]Player,2706,176,5,7,12,41.7%,36m
7963,3,Theenel,2706,0,2,3,5,40.0%,31m
7963,1,[RUnoob]MrBuckLee,2706,40,1,1,2,50.0%,1h
7963,1,Ray,2706,40,1,2,3,33.3%,1h
7963,1,Chad,2706,0,0,3,3,0.0%,49m
7975,3,AyyyyCorona,2705,703,180,175,355,50.7%,46m
7975,1,[SHOOTU]foogoo,2705,350,13,5,18,72.2%,3h
7975,3,Prot,2705,278,9,12,21,42.9%,46m
7975,1,remainDERKng,2705,140,6,6,12,50.0%,1h
7975,3,Tylenita,2705,30,5,3,8,62.5%,15m
7975,1,coolio,2705,32,2,1,3,66.7%,1h
7975,1,NinjaZerg,2705,0,2,3,5,40.0%,1h
7975,3,Albert,2705,0,1,1,2,50.0%,31m
7975,1,DirectTester,2705,30,1,1,2,50.0%,8m
7975,3,[Noon]kerntastic,2705,30,1,5,6,16.7%,40m
7975,1,cooking,2705,0,0,1,1,0.0%,1h
7975,1,SaltySandJr,2705,0,0,1,1,0.0%,1h
7987,2,DìazdeVivar,2704,1514,96,103,199,48.2%,7m
7987,1,[5252]Starstriker,2704,432,19,5,24,79.2%,49m
7987,3,Nathanator,2704,279,10,8,18,55.6%,5m
7987,3,TheLordNukem,2704,202,6,5,11,54.5%,39m
7987,2,SlayersReign,2704,0,3,3,6,50.0%,44m
7987,2,Poozy,2704,0,3,4,7,42.9%,41m
7987,1,[PobSC]Spaceman,2704,0,1,0,1,100.0%,1h
7987,1,quest,2704,0,0,1,1,0.0%,36m
7995,3,Skepticism,2703,1284,105,100,205,51.2%,42m
7995,1,HeadDesk,2703,1124,40,37,77,51.9%,1h
7995,3,OGnerdballer,2703,468,16,20,36,44.4%,43m
7995,3,RageOfGoku,2703,188,8,3,11,72.7%,5m
7995,3,Guivaalachas,2703,200,8,12,20,40.0%,10m
7995,1,Shark,2703,144,6,8,14,42.9%,3h
7995,1,[xRtG]Freedomflyer,2703,158,5,6,11,45.5%,3h
7995,1,[gtouli]GreezyG,2703,38,2,0,2,100.0%,29m
7995,1,BoHateTerran,2703,0,2,3,5,40.0%,1h
7995,2,spacecowboy,2703,89,1,1,2,50.0%,3h
7995,3,nuYOmaYO,2703,0,0,1,1,0.0%,3h
8006,3,maosan,2702,1459,120,115,235,51.1%,14m
8006,3,blandboss,2702,699,36,40,76,47.4%,47m
8006,1,NerdyGammer,2702,241,8,2,10,80.0%,1h
8006,1,fenix,2702,0,3,2,5,60.0%,1h
8006,3,[WISH]baLLerWISH,2702,0,2,3,5,40.0%,1h
8006,1,[BRSKR]ToxicChicken,2702,92,2,4,6,33.3%,6m
8006,2,[KerriS]NeroKaijin,2702,0,1,0,1,100.0%,3h
8006,1,Madhatter,2702,89,1,2,3,33.3%,10m
8014,2,[CopiaX]TheParra,2701,1069,104,105,209,49.8%,56m
8014,3,Profesitor,2701,1205,49,46,95,51.6%,32m
8014,3,[xNPGx]PaPu,2701,1156,47,45,92,51.1%,40m
8014,1,Justice,2701,526,16,14,30,53.3%,36m
8014,3,TJCIII,2701,212,8,9,17,47.1%,1h
8014,1,[Scanes]Gottagobad,2701,96,7,10,17,41.2%,54m
8014,1,BokalLotku,2701,178,4,1,5,80.0%,3h
8014,3,RickyRicardo,2701,62,3,10,13,23.1%,12m
8014,3,yoitsmedung,2701,0,2,3,5,40.0%,30m
8014,1,[STE]TechMarine,2701,0,1,0,1,100.0%,27m
8014,3,Sloppykit,2701,27,1,11,12,8.3%,53m
8014,1,RKB,2701,0,0,1,1,0.0%,29m
8026,1,Random,2700,1336,85,20,105,81.0%,1h
8026,3,ATMACS,2700,680,26,23,49,53.1%,16m
8026,3,Evershade,2700,244,8,13,21,38.1%,52m
8026,1,eternalnoobj,2700,239,6,4,10,60.0%,8m
8026,1,[Aprica]LynN,2700,166,5,6,11,45.5%,31m
8026,3,[PY]shpshp,2700,0,4,2,6,66.7%,41m
8026,1,[FENC]DrgonCN,2700,171,4,3,7,57.1%,36m
8026,3,[VOLKDS]ElOriginal,2700,130,3,4,7,42.9%,2m
8026,1,mAdcOw,2700,0,2,3,5,40.0%,30m
8026,1,ReRuns,2700,0,0,1,1,0.0%,1h
8036,1,Bulbasaur,2699,441,28,26,54,51.9%,3h
8036,1,MioFx,2699,304,22,14,36,61.1%,30m
8036,1,[ph0t0n]MinuteHand,2699,290,11,8,19,57.9%,30m
8036,1,LENINADE,2699,76,2,2,4,50.0%,3h
8036,3,Megabuster,2699,0,2,3,5,40.0%,12m
8036,1,MeiLaut,2699,0,2,3,5,40.0%,45m
8036,1,Hurdle,2699,0,1,0,1,100.0%,1h
8036,1,[PTHero]NOObius,2699,0,1,4,5,20.0%,40m
8036,3,untold,2699,0,0,5,5,0.0%,12m
8045,2,Cahuide,2698,1160,44,45,89,49.4%,42m
8045,3,Alexis,2698,684,28,27,55,50.9%,15m
8045,2,Theory,2698,639,23,33,56,41.1%,4m
8045,1,Heisenberg,2698,508,15,14,29,51.7%,3h
8045,1,mrwatt,2698,94,2,3,5,40.0%,1h
8045,1,Leekorean,2698,0,1,0,1,100.0%,3h
8045,3,bigsauceguy,2698,91,1,4,5,20.0%,10m
8045,1,squirrel,2698,0,0,1,1,0.0%,1h
8053,3,FrankPZT,2697,1559,134,151,285,47.0%,9m
8053,1,[Scro]ValleyForge,2697,1343,77,73,150,51.3%,1h
8053,3,lanyy,2697,1166,49,46,95,51.6%,15m
8053,1,[LNTM]SpartanTy,2697,764,25,22,47,53.2%,52m
8053,3,Math,2697,536,20,22,42,47.6%,45m
8053,3,[The248]IamUgly,2697,360,13,15,28,46.4%,15m
8053,1,MikeMoon,2697,411,11,9,20,55.0%,52m
8053,3,DarkErkon,2697,285,11,10,21,52.4%,1h
8053,1,robotikov,2697,158,6,2,8,75.0%,1h
8053,2,Khazad,2697,48,2,1,3,66.7%,1h
8053,1,[Bommmm]Pepitochan,2697,0,1,0,1,100.0%,3h
8053,1,orz,2697,0,1,1,2,50.0%,3h
8053,3,[AbcCo]PecesitoUwU,2697,0,0,1,1,0.0%,1h
8053,3,XxWarheadxX,2697,0,0,2,2,0.0%,1h
8053,1,[Endure]Shadow,2697,0,0,3,3,0.0%,1h
8053,1,[GRU]Crabcake,2697,0,0,3,3,0.0%,11m
8069,3,[ArmyUp]lycan,2696,1543,80,79,159,50.3%,33m
8069,3,Wonder,2696,663,26,25,51,51.0%,46m
8069,3,Insulate,2696,167,5,3,8,62.5%,43m
8069,2,SNAPPY,2696,0,4,2,6,66.7%,3h
8069,1,Lulala,2696,66,2,2,4,50.0%,1h
8069,3,[SSIX]BrandonD,2696,0,2,3,5,40.0%,43m
8069,1,[ARCHIE]AleeSxander,2696,0,1,1,2,50.0%,30m
8069,1,ProBronzPlay,2696,0,0,1,1,0.0%,1h
8077,1,OrkoPolo,2695,1746,290,294,584,49.7%,16m
8077,3,OBPagan,2695,496,20,14,34,58.8%,44m
8077,1,Apparition,2695,501,19,16,35,54.3%,36m
8077,1,CropDrop,2695,508,14,16,30,46.7%,1h
8077,1,[DaHo]NEMROD,2695,254,13,14,27,48.1%,4m
8077,1,[8iSh]Midivh,2695,200,5,9,14,35.7%,1h
8077,1,Borg,2695,167,4,1,5,80.0%,1h
8077,2,PattyMcFatty,2695,95,3,2,5,60.0%,3m
8085,1,[TSFD]JollyJohn,2694,933,40,54,94,42.6%,56m
8085,3,Commander,2694,392,15,11,26,57.7%,9m
8085,3,OlI,2694,341,13,21,34,38.2%,35m
8085,1,YoYoY,2694,0,3,2,5,60.0%,24m
8085,1,[STDMAF]Forseti,2694,104,3,4,7,42.9%,1h
8085,1,ComDAC,2694,78,2,2,4,50.0%,24m
8085,3,Jayden,2694,0,2,3,5,40.0%,4m
8085,1,thelostcoast,2694,118,2,3,5,40.0%,59m
8085,3,Cropdustah,2694,0,1,0,1,100.0%,5m
8085,3,[RogAir]MoistTowelet,2694,0,0,1,1,0.0%,1h
8085,2,PyschoShark,2694,0,0,1,1,0.0%,1h
8096,1,SpaceDude,2693,129,2,4,6,33.3%,1h
8096,1,goatsonaboat,2693,0,0,1,1,0.0%,39m
8096,1,Rawksarz,2693,0,0,2,2,0.0%,1h
8099,1,Ateus,2692,352,12,12,24,50.0%,3h
8099,3,Creative,2692,167,10,16,26,38.5%,6m
8099,2,ergo,2692,88,6,9,15,40.0%,9m
8099,1,Vysel,2692,191,4,3,7,57.1%,3h
8099,2,Tassillio,2692,140,4,5,9,44.4%,3h
8099,2,WiseAsian,2692,161,3,3,6,50.0%,1h
8099,1,crash,2692,93,2,4,6,33.3%,54m
8099,1,[Zohner]SWISSPIKE,2692,0,2,7,9,22.2%,3h
8099,1,[Pig2]Snelly,2692,48,1,1,2,50.0%,59m
8099,1,[SigmaV]GegMopak,2692,0,0,1,1,0.0%,1h
8109,1,[Snack]CRS,2691,1341,116,119,235,49.4%,16m
8109,1,llllllllllll,2691,470,21,12,33,63.6%,3h
8109,2,Moridin,2691,231,18,6,24,75.0%,1h
8109,1,Solorn,2691,557,18,14,32,56.2%,12m
8109,3,[TGosuB]JohanBastion,2691,124,4,9,13,30.8%,38m
8109,3,macros,2691,90,4,10,14,28.6%,42m
8109,3,Ragnar,2691,30,1,3,4,25.0%,1h
8116,2,Wreckursive,2690,1551,420,397,817,51.4%,46m
8116,1,Nerchio,2690,1007,94,83,177,53.1%,3m
8116,1,StoneSoldier,2690,1431,60,42,102,58.8%,1h
8116,3,ComBilLi,2690,644,23,28,51,45.1%,41m
8116,1,[TPGGXD]sebmati,2690,396,17,6,23,73.9%,3h
8116,1,KernoInferno,2690,104,3,0,3,100.0%,1h
8116,1,mGaHypocrite,2690,104,3,5,8,37.5%,1h
8116,3,Karandras,2690,0,2,3,5,40.0%,1h
8116,1,IvBolan,2690,0,2,3,5,40.0%,1h
8116,3,[ACSS]Methyle,2690,0,0,2,2,0.0%,56m
8126,3,llllllllllll,2689,1142,182,173,355,51.3%,36m
8126,2,FartBox,2689,1094,55,58,113,48.7%,33m
8126,3,codered,2689,222,8,14,22,36.4%,49m
8126,1,areesu,2689,42,1,2,3,33.3%,1h
8130,1,Artanis,2688,424,12,12,24,50.0%,1h
8130,3,[MexPro]MarioalMX,2688,116,4,10,14,28.6%,45m
8130,1,DarthCarrot,2688,158,3,1,4,75.0%,29m
8130,3,SuNSeT,2688,0,3,2,5,60.0%,36m
8130,3,Piero,2688,0,1,6,7,14.3%,32m
8130,1,TimTan,2688,0,0,1,1,0.0%,1h
8130,1,ChookUS,2688,0,0,1,1,0.0%,4m
8137,1,Pistol,2687,807,42,25,67,62.7%,1h
8137,3,Barrikade,2687,392,39,43,82,47.6%,15m
8137,1,DIEGO,2687,665,22,31,53,41.5%,42m
8137,1,Moridin,2687,473,20,6,26,76.9%,11m
8137,2,skanks,2687,472,19,21,40,47.5%,45m
8137,1,[AiMB]kagongorr,2687,324,9,9,18,50.0%,20m
8137,1,bilboswagins,2687,184,6,7,13,46.2%,29m
8137,1,mayaAngelou,2687,97,2,3,5,40.0%,24m
8137,1,Yoldo,2687,0,1,0,1,100.0%,3h
8137,3,BEHEMOTH,2687,30,1,6,7,14.3%,52m
8147,1,eCakes,2686,1453,133,125,258,51.6%,3h
8147,3,Ragna,2686,664,25,24,49,51.0%,4m
8147,3,[KhanZ]Kaleb,2686,284,12,10,22,54.5%,43m
8147,1,BigPapaPimp,2686,300,8,7,15,53.3%,1h
8147,1,[Kray]FleX,2686,246,7,10,17,41.2%,1h
8147,1,IlIlIlIlIlII,2686,214,6,5,11,54.5%,1h
8147,1,Barcode,2686,36,6,6,12,50.0%,57m
8147,1,[WG1WGA]RaVeN,2686,0,1,0,1,100.0%,1h
8147,1,BoeJangles,2686,0,1,2,3,33.3%,3h
8156,3,[LOHd]ITFANS,2685,1581,174,168,342,50.9%,16m
8156,1,Tiger,2685,964,36,33,69,52.2%,1h
8156,1,iamni,2685,914,30,31,61,49.2%,3h
8156,3,FancyBear,2685,671,27,25,52,51.9%,12m
8156,3,Sejaay,2685,432,20,22,42,47.6%,48m
8156,1,TrumpLost,2685,426,13,20,33,39.4%,17m
8156,1,OKBoomer,2685,303,12,6,18,66.7%,1h
8156,1,[Loli4u]MoneyChanger,2685,366,11,7,18,61.1%,39m
8156,3,barcode,2685,161,9,10,19,47.4%,3h
8156,1,Corrision,2685,0,3,2,5,60.0%,54m
8156,2,HighTemplar,2685,94,3,4,7,42.9%,1h
8167,3,ChuckNorrisX,2684,1115,112,95,207,54.1%,2m
8167,1,Ztaz,2684,662,27,23,50,54.0%,1h
8167,1,mcgravey,2684,78,3,1,4,75.0%,37m
8167,1,OKY,2684,0,3,2,5,60.0%,37m
8167,1,GeezBlecheez,2684,0,1,0,1,100.0%,1h
8167,3,captainG,2684,0,1,1,2,50.0%,44m
8167,1,LaughingPug,2684,42,1,2,3,33.3%,3h
8167,3,fabian,2684,0,1,4,5,20.0%,5m
8167,3,Joxikor,2684,0,1,4,5,20.0%,10m
8176,3,Snapdragon,2683,1255,100,90,190,52.6%,55m
8176,1,[eroko]Duke,2683,211,9,7,16,56.2%,1h
8176,1,alhazerad,2683,160,6,7,13,46.2%,10m
8176,1,Cayito,2683,114,4,3,7,57.1%,43m
8176,1,zdexor,2683,0,3,2,5,60.0%,54m
8176,2,Duke,2683,95,3,4,7,42.9%,51m
8176,1,RickyHatton,2683,76,2,4,6,33.3%,1h
8176,1,[SocDis]IlIlllIlllII,2683,0,1,0,1,100.0%,45m
8176,1,[neuroS]Zeedog,2683,0,0,1,1,0.0%,1h
8176,1,DaiSy,2683,0,0,1,1,0.0%,1h
8186,3,Phi,2682,1594,135,132,267,50.6%,43m
8186,3,vug,2682,856,74,67,141,52.5%,55m
8186,1,DIegoS,2682,1327,52,44,96,54.2%,3h
8186,1,SkyMouse,2682,1218,42,43,85,49.4%,14m
8186,1,Plauge,2682,1200,40,43,83,48.2%,1h
8186,1,Serral,2682,562,29,3,32,90.6%,3h
8186,3,FezWhatley,2682,670,29,27,56,51.8%,57m
8186,1,[IMDSI]Hiroshima,2682,264,9,6,15,60.0%,54m
8186,1,azapheus,2682,186,7,2,9,77.8%,1h
8186,1,[KKYS]darkwings,2682,213,6,6,12,50.0%,4h
8186,3,Commando,2682,192,6,7,13,46.2%,12m
8186,2,[D5FTWA]xXDaBossXx,2682,0,4,3,7,57.1%,1h
8186,1,Findlay,2682,156,4,6,10,40.0%,3h
8186,1,[BURNIN]NaturalFlux,2682,36,1,1,2,50.0%,1h
8186,3,bondchu,2682,30,1,4,5,20.0%,16m
8201,3,AVA,2681,409,15,16,31,48.4%,48m
8201,1,ZehWallace,2681,154,5,5,10,50.0%,1h
8201,1,Killerqueen,2681,0,4,1,5,80.0%,43m
8201,1,Tethgret,2681,62,3,1,4,75.0%,37m
8201,1,Invid,2681,42,2,1,3,66.7%,14m
8201,3,mossijo,2681,0,2,3,5,40.0%,5m
8201,3,Whitess,2681,0,2,3,5,40.0%,44m
8201,1,SeeAdler,2681,105,2,6,8,25.0%,49m
8201,2,Yuengling,2681,0,1,0,1,100.0%,1h
8201,1,Rey,2681,0,1,8,9,11.1%,4m
8201,2,PatBateman,2681,0,0,1,1,0.0%,1h
8201,1,JHound,2681,0,0,1,1,0.0%,1h
8201,2,Silverleysh,2681,0,0,2,2,0.0%,1h
8201,1,KÿrÖôRapTor,2681,0,0,3,3,0.0%,30m
8215,2,HamesJarden,2680,1586,97,103,200,48.5%,4m
8215,3,Robertronix,2680,1324,89,88,177,50.3%,16m
8215,2,Wes,2680,616,24,27,51,47.1%,42m
8215,1,PhilOsophy,2680,730,22,23,45,48.9%,1h
8215,1,CallaBestia,2680,108,3,2,5,60.0%,1h
8215,3,CarroTLover,2680,0,2,3,5,40.0%,15m
8215,2,[KingSC]LRT,2680,0,1,0,1,100.0%,3h
8215,1,[MCSC]Blade,2680,0,0,1,1,0.0%,6m
8223,3,[SWOU]AMADEUS,2679,1481,114,110,224,50.9%,55m
8223,2,BadPro,2679,910,31,42,73,42.5%,33m
8223,1,Fckboy,2679,829,30,23,53,56.6%,1h
8223,1,Skrige,2679,460,16,16,32,50.0%,40m
8223,3,oJeDo,2679,247,11,9,20,55.0%,1h
8223,1,jofrito,2679,42,2,2,4,50.0%,1h
8223,1,SteroiD,2679,72,2,2,4,50.0%,54m
8223,1,Frostbyrne,2679,0,0,1,1,0.0%,11m
8231,3,WolfOfMibu,2678,838,33,29,62,53.2%,41m
8231,2,[Pizzy]smooveAlv,2678,268,11,11,22,50.0%,1h
8231,1,Xenoknight,2678,0,4,1,5,80.0%,51m
8231,1,[1GP]IronShadow,2678,30,4,9,13,30.8%,5m
8231,1,[rdgma]immortals,2678,0,1,0,1,100.0%,1h
8231,1,Ragnar,2678,0,1,1,2,50.0%,18m
8237,3,Panda,2677,778,60,50,110,54.5%,35m
8237,3,polar,2677,253,34,25,59,57.6%,7m
8237,3,Ezzy,2677,488,34,25,59,57.6%,17m
8237,3,SKING,2677,174,5,7,12,41.7%,50m
8237,1,Saazer,2677,126,3,0,3,100.0%,11m
8237,2,Cptnunderpnz,2677,95,3,4,7,42.9%,3h
8237,3,EffeCt,2677,0,0,2,2,0.0%,2m
8244,3,South,2676,1555,170,174,344,49.4%,32m
8244,2,Anon,2676,1514,150,158,308,48.7%,11m
8244,2,DaneelOlivaw,2676,1485,62,70,132,47.0%,41m
8244,1,[NSMR]acdcrulz,2676,574,20,21,41,48.8%,30m
8244,1,YoungTiger,2676,160,5,6,11,45.5%,3h
8244,2,Skynet,2676,88,3,2,5,60.0%,3m
8244,2,DreadGazebo,2676,95,3,4,7,42.9%,1h
8244,1,Alo,2676,93,2,4,6,33.3%,36m
8244,1,[FatMom]Player,2676,0,1,1,2,50.0%,1h
8244,1,[Tyber]Badgingworth,2676,36,1,1,2,50.0%,3h
8244,1,Petrie,2676,88,1,2,3,33.3%,1h
8244,3,[MLP0NY]aahhii,2676,30,1,9,10,10.0%,55m
8244,3,[GSP0T]Gaben,2676,0,0,1,1,0.0%,1h
8244,1,[PiN0YS]TantanPH,2676,0,0,5,5,0.0%,3h
8258,2,[DRKACE]Hayden,2675,553,139,146,285,48.8%,37m
8258,3,FilthyBeaver,2675,394,69,101,170,40.6%,50m
8258,1,aldezerg,2675,1067,37,35,72,51.4%,1h
8258,3,RuschDie,2675,702,27,30,57,47.4%,15m
8258,2,Ohanamontana,2675,30,4,7,11,36.4%,12m
8258,3,FireFly,2675,121,3,4,7,42.9%,34m
8258,1,[Meower]Bootycat,2675,84,2,5,7,28.6%,1h
8258,2,LFxDyablo,2675,0,1,0,1,100.0%,3h
8258,1,Rampage,2675,0,0,1,1,0.0%,46m
8267,3,cyberghost,2674,1575,160,151,311,51.4%,48m
8267,2,DrummerCL,2674,1535,159,153,312,51.0%,6m
8267,1,bsdsbgmm,2674,967,44,21,65,67.7%,16m
8267,1,[Erik]ZtingeR,2674,562,30,4,34,88.2%,1h
8267,3,breadfit,2674,184,22,25,47,46.8%,42m
8267,1,DKingLinch,2674,178,5,9,14,35.7%,20m
8267,1,Eliteknives,2674,0,2,3,5,40.0%,46m
8267,1,BukuMan,2674,0,1,0,1,100.0%,20m
8267,1,[FaTlAd]Terranhero,2674,0,0,1,1,0.0%,3h
8276,3,EliteTris,2673,1576,638,674,1312,48.6%,43m
8276,1,McSpankyyy,2673,648,20,23,43,46.5%,3h
8276,2,[DXPCA]PAULOMF,2673,146,6,14,20,30.0%,13m
8276,1,[UxL]Flash,2673,142,4,1,5,80.0%,10m
8276,2,Obelisk,2673,46,1,1,2,50.0%,1h
8276,2,AirForceOnes,2673,48,1,3,4,25.0%,1h
8276,3,[TaRus]Shinigami,2673,0,0,1,1,0.0%,5m
8283,1,Hadrian,2672,532,17,16,33,51.5%,3h
8283,1,[4SKULL]dude,2672,216,7,8,15,46.7%,8m
8283,2,OmegaBlac,2672,44,5,3,8,62.5%,37m
8283,1,[ExcIgN]Yanzo,2672,178,4,4,8,50.0%,1h
8283,1,[DISC]hfd,2672,36,3,5,8,37.5%,1h
8288,1,[zeita1]SOYTUCACHERO,2671,1040,79,62,141,56.0%,30m
8288,3,[90RN]Hess,2671,910,36,33,69,52.2%,16m
8288,3,[420SC2]DeathIgniter,2671,742,26,32,58,44.8%,37m
8288,1,[Atone]Dadbod,2671,399,16,15,31,51.6%,1h
8288,1,[GeekA]DarthJulius,2671,368,11,8,19,57.9%,1h
8288,1,saplingg,2671,234,5,5,10,50.0%,30m
8288,1,Killerfridge,2671,174,5,6,11,45.5%,1h
8288,1,thotPATROL,2671,96,5,7,12,41.7%,45m
8288,1,NovaStrider,2671,0,0,1,1,0.0%,1h
8288,1,FrozenSabre,2671,0,0,1,1,0.0%,1h
8298,2,[BS]DigGo,2670,1503,123,115,238,51.7%,6m
8298,1,MincheRrat,2670,303,26,17,43,60.5%,1h
8298,2,[PDBR]xck,2670,646,25,31,56,44.6%,43m
8298,2,Asherbanipal,2670,628,21,33,54,38.9%,40m
8298,1,[DhZone]Guima,2670,360,10,10,20,50.0%,56m
8298,1,[oXoXo]JEAxXI,2670,194,6,5,11,54.5%,30m
8298,2,SCVready,2670,0,3,3,6,50.0%,3h
8298,1,[Sune]HavelTheRock,2670,95,1,2,3,33.3%,11m
8298,2,Shindok,2670,0,0,2,2,0.0%,3h
8307,2,[BrisK]ToxicRust,2669,1401,91,99,190,47.9%,32m
8307,3,ReNaYUl,2669,1323,69,65,134,51.5%,52m
8307,2,[LOTV7]CaptainRed,2669,249,31,34,65,47.7%,42m
8307,1,ProteusKel,2669,686,25,23,48,52.1%,24m
8307,3,lodgoro,2669,259,8,13,21,38.1%,10m
8307,1,Bekmonster,2669,188,7,7,14,50.0%,1h
8307,1,aznovo,2669,220,6,4,10,60.0%,29m
8307,1,[Mu5ic]DrumSetMan,2669,190,5,5,10,50.0%,3h
8307,3,Lalord,2669,124,4,11,15,26.7%,41m
8307,3,[ktkzs]XycoDelics,2669,104,4,12,16,25.0%,48m
8307,1,TheDude,2669,104,3,4,7,42.9%,1h
8307,2,Tiffin,2669,96,3,7,10,30.0%,3m
8307,1,KaitlynsBF,2669,105,2,2,4,50.0%,3h
8307,3,Avo,2669,0,2,3,5,40.0%,32m
8321,1,Isu,2668,1535,311,317,628,49.5%,4m
8321,1,Earth,2668,352,15,11,26,57.7%,1h
8321,2,ReaPer,2668,173,7,3,10,70.0%,52m
8321,1,SwarthyMcTit,2668,172,6,2,8,75.0%,6m
8321,1,[Bee]SpaceDucK,2668,0,3,2,5,60.0%,8m
8321,3,Escendo,2668,0,1,2,3,33.3%,40m
8327,1,LazyTitan,2667,1034,84,67,151,55.6%,3h
8327,2,Nide,2667,937,84,68,152,55.3%,39m
8327,3,[12YD]Skrumpf,2667,137,7,4,11,63.6%,15m
8327,3,[Random]Taz,2667,116,4,10,14,28.6%,11m
8327,1,Xeo,2667,80,3,5,8,37.5%,6m
8332,1,[SKSR]FukdUpBack,2666,1293,48,47,95,50.5%,3h
8332,3,Lombardo,2666,537,37,33,70,52.9%,16m
8332,3,Miguel,2666,491,19,21,40,47.5%,42m
8332,3,Grateful,2666,377,14,16,30,46.7%,16m
8332,1,xZTzl,2666,173,6,8,14,42.9%,3h
8332,1,Thermo,2666,0,3,2,5,60.0%,49m
8332,1,Ares,2666,66,2,2,4,50.0%,1h
8332,1,[DBOIs]JasonCass,2666,0,0,1,1,0.0%,11m
8340,1,Strypert,2665,938,32,32,64,50.0%,26m
8340,1,NightKnight,2665,120,3,2,5,60.0%,24m
8340,1,CommanderLLM,2665,0,3,5,8,37.5%,45m
8340,3,Solimar,2665,0,2,3,5,40.0%,1h
8340,1,JollyGren,2665,0,1,1,2,50.0%,1h
8340,1,jmartin,2665,0,1,2,3,33.3%,1h
8340,1,[HBNC]QuipsQuaff,2665,107,1,4,5,20.0%,3h
8340,1,[LCE]Roots,2665,0,0,1,1,0.0%,3h
8348,2,Cheesey,2664,1540,130,132,262,49.6%,40m
8348,1,DarthWeiner,2664,622,21,20,41,51.2%,14m
8348,1,BearCavalry,2664,500,15,16,31,48.4%,36m
8348,3,CPTSmAcKaHo,2664,331,13,11,24,54.2%,53m
8348,2,Peacemaker,2664,0,3,3,6,50.0%,5m
8348,2,Vivaldi,2664,0,3,4,7,42.9%,3m
8348,3,Artanis,2664,0,0,3,3,0.0%,38m
8355,3,[ØÛ]matiBTC,2663,658,33,18,51,64.7%,44m
8355,3,Stairs,2663,249,19,23,42,45.2%,13m
8355,1,Spycrab,2663,446,14,13,27,51.9%,37m
8355,1,Bryan,2663,355,10,10,20,50.0%,41m
8355,1,Jeff,2663,78,2,3,5,40.0%,3h
8355,1,[PSF]Matik,2663,0,0,4,4,0.0%,4m
8361,1,OneAndOnlyAB,2662,943,44,30,74,59.5%,12m
8361,3,[Zeiv]katsuo,2662,914,38,42,80,47.5%,8m
8361,1,[RVSV]Rocha,2662,626,31,19,50,62.0%,14m
8361,1,gege,2662,378,12,13,25,48.0%,3h
8361,1,[NA7]beXcellent,2662,212,8,2,10,80.0%,1h
8361,1,brahamnp,2662,0,3,2,5,60.0%,3h
8361,1,TerrorEmu,2662,76,3,2,5,60.0%,27m
8361,3,Souyiro,2662,0,2,3,5,40.0%,33m
8369,1,OneHarmony,2661,832,42,50,92,45.7%,12m
8369,3,Zerovelocity,2661,336,40,30,70,57.1%,56m
8369,1,[PacheK]thedickdans,2661,401,10,17,27,37.0%,1h
8369,1,[HDOG]Ephaestus,2661,264,7,8,15,46.7%,1h
8369,1,[FFAWAR]FaceAttack,2661,158,4,4,8,50.0%,43m
8369,3,PenguinNuggs,2661,30,1,8,9,11.1%,45m
8369,1,SrZombie,2661,0,0,1,1,0.0%,1h
8376,1,Mise,2660,1356,68,49,117,58.1%,3h
8376,1,Reesepup,2660,448,14,15,29,48.3%,24m
8376,2,robcole,2660,0,4,2,6,66.7%,3h
8376,1,[ZTempz]GeneralGreat,2660,150,3,3,6,50.0%,8m
8376,3,Denamon,2660,0,2,3,5,40.0%,3h
8376,3,jader,2660,0,1,0,1,100.0%,53m
8376,2,[JDG]IngArmando,2660,0,0,1,1,0.0%,1h
8376,2,Kae,2660,0,0,3,3,0.0%,3h
8376,1,DragonRiderz,2660,0,0,5,5,0.0%,3h
8385,3,Resipsa,2659,1210,53,48,101,52.5%,16m
8385,3,blink,2659,775,31,31,62,50.0%,33m
8385,1,Mandrew,2659,382,21,7,28,75.0%,1h
8385,1,Yoshiyahoo,2659,97,5,5,10,50.0%,1h
8385,1,[AbcCo]Megab,2659,166,5,5,10,50.0%,4h
8385,1,Finger,2659,42,2,2,4,50.0%,3h
8385,1,DonaldTrump,2659,0,0,1,1,0.0%,46m
8392,1,deeznutz,2658,1269,49,43,92,53.3%,56m
8392,1,[Kixeye]Seek,2658,718,37,30,67,55.2%,1h
8392,3,Babyteeth,2658,804,37,46,83,44.6%,10m
8392,2,bobtubba,2658,802,27,39,66,40.9%,5m
8392,1,PeterPan,2658,436,17,9,26,65.4%,14m
8392,3,[RknStn]robotommy,2658,196,5,7,12,41.7%,37m
8392,1,Gloves,2658,104,3,0,3,100.0%,1h
8392,1,MaxPornfest,2658,40,1,2,3,33.3%,1h
8392,1,frogician,2658,0,0,4,4,0.0%,50m
8401,1,[ZEXT]Jorath,2657,0,3,3,6,50.0%,29m
8401,1,Tangiblebat,2657,74,3,3,6,50.0%,6m
8401,1,[INextI]OnefOXPrime,2657,89,3,15,18,16.7%,16m
8401,3,LeroyJenkins,2657,0,2,3,5,40.0%,34m
8401,2,[TECPLA]wilder,2657,0,0,2,2,0.0%,8m
8406,3,MrBangoJango,2656,1438,322,327,649,49.6%,37m
8406,2,Klink,2656,1510,163,171,334,48.8%,11m
8406,3,zad,2656,1387,74,75,149,49.7%,48m
8406,3,proxicon,2656,1059,56,59,115,48.7%,48m
8406,3,Change,2656,306,13,11,24,54.2%,31m
8406,3,xacem,2656,0,4,1,5,80.0%,32m
8406,3,[UCF]TitanWarrior,2656,62,3,7,10,30.0%,33m
8406,1,[2fTz]fixerjj,2656,68,2,2,4,50.0%,46m
8406,1,RumNCoke,2656,40,1,3,4,25.0%,50m
8415,2,Anubis,2655,1309,136,122,258,52.7%,6m
8415,1,MinersCorp,2655,1269,101,74,175,57.7%,1h
8415,1,SkyTyman,2655,255,11,6,17,64.7%,16m
8415,1,[Manics]AAABattery,2655,238,9,8,17,52.9%,1h
8415,3,Pharaoh,2655,183,8,10,18,44.4%,40m
8415,1,ZCE,2655,142,5,1,6,83.3%,1h
8415,2,HENRRY,2655,0,4,2,6,66.7%,3h
8415,1,[DETER]Alsadair,2655,102,3,4,7,42.9%,3h
8415,1,[FoxBR]Charlinnn,2655,0,2,3,5,40.0%,1h
8415,1,Omgmuffins,2655,0,0,2,2,0.0%,21m
8415,1,[sm0oth]BrainedCanid,2655,0,0,5,5,0.0%,1h
8426,2,Creep,2654,1277,79,85,164,48.2%,40m
8426,1,JiayouCH,2654,308,14,7,21,66.7%,1h
8426,1,Deville,2654,89,1,1,2,50.0%,3h
8426,1,ELFoLo,2654,40,1,2,3,33.3%,1h
8426,1,baker,2654,40,1,2,3,33.3%,1h
8426,3,[pinoy]EightySixJun,2654,0,0,1,1,0.0%,1h
8426,3,[nieBla]Axwel,2654,0,0,4,4,0.0%,1h
8433,1,PROMETEEROS,2653,1705,95,95,190,50.0%,12m
8433,1,zander,2653,1628,77,71,148,52.0%,3h
8433,1,PearlMilkTea,2653,1590,58,53,111,52.3%,29m
8433,1,madek,2653,790,29,25,54,53.7%,1h
8433,3,[10JQKA]Baller,2653,224,9,9,18,50.0%,16m
8433,3,Heileos,2653,160,6,8,14,42.9%,48m
8433,1,Wildcat,2653,154,5,8,13,38.5%,1h
8440,3,[TOWL]Funkytown,2652,619,40,45,85,47.1%,57m
8440,3,Blinded,2652,685,29,32,61,47.5%,53m
8440,2,[DTL]KillaChri,2652,463,25,33,58,43.1%,10m
8440,1,gohanngasusu,2652,669,21,19,40,52.5%,17m
8440,1,[PiN0YS]youngone,2652,430,15,14,29,51.7%,24m
8440,1,Tacocorp,2652,313,10,15,25,40.0%,54m
8440,1,[SINSTR]roberhpp,2652,257,7,5,12,58.3%,56m
8440,1,iron,2652,228,7,6,13,53.8%,1h
8440,3,Shweddynuts,2652,30,2,3,5,40.0%,43m
8440,3,Rajj,2652,0,2,3,5,40.0%,28m
8440,1,Lalolink,2652,0,2,3,5,40.0%,3h
8440,1,Deku,2652,0,2,3,5,40.0%,1h
8440,1,[II4WI]mcdoogs,2652,0,2,3,5,40.0%,1h
8440,1,SniperElGato,2652,38,1,2,3,33.3%,1h
8440,1,bingus,2652,0,0,3,3,0.0%,3h
8455,3,nono,2651,1341,91,90,181,50.3%,52m
8455,1,[SOAF]ZobelPrize,2651,1578,60,59,119,50.4%,1h
8455,1,[CWF]JeangamerXD,2651,383,18,9,27,66.7%,1h
8455,1,[Chrev]Chriskler,2651,423,17,17,34,50.0%,3h
8455,3,HEXLET,2651,224,8,11,19,42.1%,37m
8455,1,[TrK]Corruptor,2651,134,5,5,10,50.0%,28m
8455,2,GSilverstein,2651,136,4,6,10,40.0%,29m
8455,1,garde,2651,88,2,0,2,100.0%,18m
8455,1,Bonefish,2651,0,2,3,5,40.0%,1h
8455,1,[TxT]Bearhat,2651,76,2,5,7,28.6%,3h
8455,1,[LapisL]Elaina,2651,88,1,1,2,50.0%,1h
8455,3,Jackjack,2651,0,0,1,1,0.0%,1h
8455,1,Wittelman,2651,0,0,1,1,0.0%,4h
8468,3,pungkow,2650,197,11,2,13,84.6%,57m
8468,1,[TFFO]Meh,2650,130,4,3,7,57.1%,1h
8468,1,Torrison,2650,0,2,3,5,40.0%,1h
8468,1,[SCR0TE]WrathOfBong,2650,0,1,0,1,100.0%,52m
8468,1,[2up]IGStocky,2650,0,0,1,1,0.0%,3h
8468,2,LaidToRest,2650,0,0,6,6,0.0%,1h
8474,1,[Sqwirl]Lawiez,2649,769,32,27,59,54.2%,1h
8474,3,mooman,2649,571,24,19,43,55.8%,56m
8474,1,[ProW]AtomicWaffle,2649,370,22,16,38,57.9%,52m
8474,2,Toker,2649,546,21,22,43,48.8%,8m
8474,1,Mack,2649,337,13,16,29,44.8%,1h
8474,1,Clemens,2649,218,8,9,17,47.1%,24m
8474,2,Firechrome,2649,46,5,3,8,62.5%,1h
8474,1,[Wat3rs]DevilDuck,2649,174,5,5,10,50.0%,1h
8474,1,Kikkelitikku,2649,150,3,3,6,50.0%,51m
8483,3,Yoryo,2648,1557,129,128,257,50.2%,41m
8483,3,[NEST4]Eagle,2648,1565,115,111,226,50.9%,16m
8483,3,Cernoborg,2648,444,18,15,33,54.5%,50m
8483,3,yehosua,2648,422,14,27,41,34.1%,34m
8483,1,BookII,2648,200,7,5,12,58.3%,57m
8483,1,Tyrone,2648,148,5,6,11,45.5%,1h
8483,3,Dieguito,2648,42,3,2,5,60.0%,1h
8483,1,[LMI42]DookieToe,2648,0,1,0,1,100.0%,4m
8483,1,[12stps]KhazadDum,2648,88,1,1,2,50.0%,12m
8483,3,Jamthenam,2648,0,1,2,3,33.3%,1h
8493,1,eigenvec,2647,1323,63,46,109,57.8%,9m
8493,3,Ross,2647,755,31,34,65,47.7%,48m
8493,1,Marklongwide,2647,349,17,16,33,51.5%,1h
8493,3,FoxyAvida,2647,294,12,12,24,50.0%,12m
8493,1,DeadlyKitten,2647,168,7,9,16,43.8%,1h
8493,1,Joputa,2647,222,6,7,13,46.2%,28m
8493,1,Costilla,2647,127,5,5,10,50.0%,54m
8493,2,[RIPXXX]drEGGonshirt,2647,137,4,4,8,50.0%,15m
8493,2,Mahambah,2647,46,2,0,2,100.0%,1h
8493,1,miniSHAKA,2647,36,1,2,3,33.3%,1h
8493,1,Softcore,2647,0,0,1,1,0.0%,11m
8504,1,[AZK2]Metaldesidia,2646,1703,106,93,199,53.3%,30m
8504,1,MrBushido,2646,387,17,14,31,54.8%,50m
8504,1,ALMANEGRA,2646,445,14,12,26,53.8%,1h
8504,1,toditron,2646,464,14,15,29,48.3%,30m
8504,2,ThVium,2646,226,8,11,19,42.1%,42m
8504,2,kurtesimo,2646,94,4,3,7,57.1%,29m
8504,2,NoName,2646,90,4,6,10,40.0%,48m
8511,1,[xMSx]GENERALZON,2645,1354,231,225,456,50.7%,3h
8511,3,iAmKorean,2645,125,31,39,70,44.3%,40m
8511,1,Tea,2645,407,15,12,27,55.6%,39m
8511,1,RDawg,2645,186,7,2,9,77.8%,24m
8511,1,DevilD,2645,223,7,8,15,46.7%,1h
8511,3,Jozzemma,2645,252,7,21,28,25.0%,43m
8511,1,Karachtor,2645,180,6,3,9,66.7%,52m
8511,1,dinoDNA,2645,90,3,4,7,42.9%,1h
8519,2,HellSorC,2644,1487,65,69,134,48.5%,16m
8519,3,Hyperbole,2644,391,29,32,61,47.5%,17m
8519,3,Kharnage,2644,570,20,27,47,42.6%,16m
8519,1,FionaTheHipO,2644,447,14,12,26,53.8%,37m
8519,1,ELCAZADORZ,2644,144,4,5,9,44.4%,3h
8519,1,simenga,2644,0,2,3,5,40.0%,1h
8519,2,[JST]Furinax,2644,0,1,0,1,100.0%,56m
8526,2,[SwOoNz]Goatboy,2643,1046,427,415,842,50.7%,35m
8526,2,Aaron,2643,1460,167,145,312,53.5%,53m
8526,1,egyware,2643,486,15,12,27,55.6%,1h
8526,2,[5252]Jokertrue,2643,156,5,2,7,71.4%,3h
8526,3,blackbriar,2643,111,4,6,10,40.0%,4m
8526,1,Chris,2643,0,2,3,5,40.0%,1h
8526,1,LineTwist,2643,0,1,4,5,20.0%,1h
8533,3,SamuraiMatt,2642,1275,90,93,183,49.2%,51m
8533,1,DeathDealer,2642,421,16,15,31,51.6%,1h
8533,2,Star,2642,238,10,17,27,37.0%,5m
8533,3,emayrolol,2642,30,4,6,10,40.0%,11m
8533,1,Pebbo,2642,0,3,2,5,60.0%,18m
8533,1,sGs,2642,78,3,6,9,33.3%,3h
8533,1,Chauzuvoy,2642,0,2,4,6,33.3%,4h
8533,1,[YGD]Sephiroth,2642,0,1,2,3,33.3%,1h
8541,2,mmmongo,2641,1328,46,59,105,43.8%,37m
8541,3,[kdUb]INcrypted,2641,1130,42,50,92,45.7%,52m
8541,1,NoCheesePlz,2641,823,34,26,60,56.7%,25m
8541,1,Battlestooge,2641,323,13,13,26,50.0%,3h
8541,1,[Litez]Shadowslayer,2641,330,10,12,22,45.5%,43m
8541,1,BringTheFunk,2641,158,5,6,11,45.5%,1h
8541,2,[Kodos]OttO,2641,136,4,0,4,100.0%,51m
8541,1,texasmade,2641,0,4,1,5,80.0%,49m
8541,1,[RSGP]Aristoteles,2641,90,2,0,2,100.0%,7m
8550,1,GrassTree,2640,313,85,76,161,52.8%,39m
8550,3,TMoney,2640,339,12,14,26,46.2%,8m
8550,1,STARSHINE,2640,263,9,6,15,60.0%,50m
8550,1,[EZYtgt]PhotoOp,2640,240,9,8,17,52.9%,52m
8550,1,CEVICHITO,2640,191,6,4,10,60.0%,3h
8550,1,ZZARCH,2640,78,5,5,10,50.0%,29m
8550,3,VonBergen,2640,92,5,8,13,38.5%,47m
8550,1,lebbra,2640,138,5,11,16,31.2%,38m
8550,2,BabyGun,2640,88,4,1,5,80.0%,10m
8550,1,gatocasual,2640,76,3,7,10,30.0%,29m
8550,3,Waffle,2640,0,2,3,5,40.0%,1h
8550,2,Straightrust,2640,0,0,1,1,0.0%,36m
8562,3,Junglist,2639,921,129,132,261,49.4%,34m
8562,1,tehepicwin,2639,552,22,15,37,59.5%,1h
8562,2,LasagneWest,2639,200,11,6,17,64.7%,3m
8562,2,[CAE]Engelord,2639,262,10,5,15,66.7%,3h
8562,3,MichConner,2639,168,4,3,7,57.1%,44m
8562,1,[SCMK]Viaos,2639,72,2,3,5,40.0%,1h
8562,1,Aece,2639,78,2,6,8,25.0%,43m
8569,2,CapsJr,2638,1542,129,135,264,48.9%,3m
8569,1,TNT,2638,718,25,21,46,54.3%,40m
8569,3,Sunnyhundred,2638,607,23,25,48,47.9%,55m
8569,1,Requiem,2638,468,14,14,28,50.0%,39m
8569,1,TParr,2638,266,10,7,17,58.8%,39m
8569,1,[GOPERÚ]MACHERFL,2638,162,7,2,9,77.8%,28m
8569,1,[TgAg]BlackNova,2638,212,6,8,14,42.9%,3h
8569,1,[JkSKS]Arcaik,2638,78,3,4,7,42.9%,1h
8569,1,Caleb,2638,40,2,3,5,40.0%,42m
8569,2,Athelos,2638,0,1,0,1,100.0%,54m
8569,2,[LMI42]Mrchichico,2638,0,0,1,1,0.0%,45m
8580,2,BlizzReally,2637,702,25,35,60,41.7%,17m
8580,3,[Swap]nanu,2637,398,13,25,38,34.2%,4m
8580,2,DRoyalArmy,2637,133,6,2,8,75.0%,29m
8580,2,Dafei,2637,142,4,0,4,100.0%,29m
8580,2,EzMelo,2637,0,2,3,5,40.0%,1h
8580,2,Leined,2637,0,1,0,1,100.0%,41m
8580,2,Zerodyme,2637,0,0,1,1,0.0%,1h
8587,2,cartman,2636,978,52,42,94,55.3%,1h
8587,1,kaishakunin,2636,830,40,37,77,51.9%,1h
8587,3,armagedon,2636,724,30,30,60,50.0%,16m
8587,1,straalen,2636,265,11,8,19,57.9%,24m
8587,1,lolzebra,2636,141,6,6,12,50.0%,4m
8587,3,InvictusEr,2636,135,3,4,7,42.9%,52m
8587,2,RavenLord,2636,0,1,1,2,50.0%,51m
8587,2,Chungusisyum,2636,32,1,2,3,33.3%,3h
8595,3,TheSituation,2635,1545,182,171,353,51.6%,15m
8595,3,JepHri,2635,1541,149,149,298,50.0%,41m
8595,1,[nCrphL]TigerSpider,2635,1182,61,62,123,49.6%,18m
8595,2,AsaZiN,2635,590,26,20,46,56.5%,5m
8599,1,PerroKeHabla,2634,1506,70,64,134,52.2%,3h
8599,1,Jundie,2634,633,20,18,38,52.6%,18m
8599,3,TWB,2634,329,15,19,34,44.1%,34m
8599,3,Fax,2634,395,14,16,30,46.7%,44m
8599,2,Gaskike,2634,0,4,1,5,80.0%,3h
8599,1,WayGroovy,2634,82,2,7,9,22.2%,50m
8599,2,Dofoos,2634,0,1,0,1,100.0%,41m
8599,2,SuperMan,2634,0,0,1,1,0.0%,3h
8599,1,Isaac,2634,0,0,1,1,0.0%,40m
8599,1,Vison,2634,0,0,1,1,0.0%,11m
8599,2,gnome,2634,0,0,5,5,0.0%,3h
8610,3,DmdWt,2633,698,42,44,86,48.8%,5m
8610,1,JohnyUtah,2633,568,18,21,39,46.2%,1h
8610,3,[neuroW]jompy,2633,462,17,21,38,44.7%,33m
8610,1,Ninjamonkey,2633,364,12,14,26,46.2%,14m
8610,2,[GoldPo]TheCold,2633,172,6,5,11,54.5%,1h
8610,1,[GGK]Paumer,2633,110,4,5,9,44.4%,44m
8610,2,humbug,2633,0,0,1,1,0.0%,3h
8617,3,LilJon,2632,863,51,43,94,54.3%,39m
8617,1,Converge,2632,707,26,26,52,50.0%,37m
8617,1,BigÐickRick,2632,548,21,20,41,51.2%,1h
8617,2,Aummadour,2632,142,3,2,5,60.0%,1h
8617,1,WiddlePengu,2632,0,2,4,6,33.3%,1h
8617,1,Smiley,2632,0,0,2,2,0.0%,4m
8617,3,Gawayn,2632,0,0,2,2,0.0%,1h
8624,1,SkelNine,2631,1089,155,154,309,50.2%,20m
8624,1,POLLUXcastor,2631,1230,46,43,89,51.7%,30m
8624,1,Kedgann,2631,213,7,4,11,63.6%,1h
8624,1,[WuTang]uponus,2631,174,6,7,13,46.2%,37m
8624,2,[Pharoh]bksc,2631,62,2,3,5,40.0%,52m
8624,2,Chimaera,2631,0,1,0,1,100.0%,51m
8624,1,[BugZ]cyclonic,2631,89,1,2,3,33.3%,49m
8624,1,JohnEnglish,2631,38,1,3,4,25.0%,29m
8624,1,RafalexF,2631,0,0,3,3,0.0%,3h
8633,1,Touklakos,2630,639,30,11,41,73.2%,54m
8633,2,Probetoss,2630,476,17,15,32,53.1%,1h
8633,1,BlackObama,2630,441,15,15,30,50.0%,26m
8633,3,kaka,2630,347,12,10,22,54.5%,3h
8633,1,[ValidG]daveyboy,2630,247,10,10,20,50.0%,1h
8633,2,Newool,2630,200,5,6,11,45.5%,3m
8633,2,Flickshot,2630,62,3,1,4,75.0%,10m
8633,1,paRaDe,2630,40,2,2,4,50.0%,1h
8633,2,[MinzS]Andrene,2630,0,1,0,1,100.0%,1h
8633,2,Golden,2630,0,1,0,1,100.0%,50m
8633,2,antonioFK,2630,0,0,1,1,0.0%,1h
8644,3,SearchEcosia,2629,451,44,47,91,48.4%,56m
8644,1,Badger,2629,349,23,14,37,62.2%,3h
8644,1,[MOF0]Dstad,2629,432,12,14,26,46.2%,3h
8644,1,Jameson,2629,237,8,5,13,61.5%,1h
8644,1,[XaViEr]Underdog,2629,187,7,8,15,46.7%,54m
8644,1,soulbinder,2629,235,4,7,11,36.4%,57m
8644,2,Ottogi,2629,0,3,2,5,60.0%,58m
8644,2,Stoivanich,2629,94,3,4,7,42.9%,3h
8644,2,FUCYOURMOM,2629,0,1,0,1,100.0%,3h
8644,2,BlueIce,2629,0,1,0,1,100.0%,21m
8654,3,Spyder,2628,1481,125,123,248,50.4%,33m
8654,1,Alphabet,2628,1050,40,40,80,50.0%,44m
8654,1,KetamineYoda,2628,698,28,20,48,58.3%,3h
8654,2,MikeChicken,2628,346,13,12,25,52.0%,34m
8654,3,Microangelo,2628,329,13,13,26,50.0%,39m
8654,1,[Blacer]alleycat,2628,414,12,15,27,44.4%,1h
8654,1,slackTOSS,2628,220,6,5,11,54.5%,9m
8654,2,ELTORITO,2628,92,3,1,4,75.0%,19m
8654,2,Yamawalkie,2628,0,1,0,1,100.0%,37m
8654,1,Jinkozouo,2628,0,1,1,2,50.0%,1h
8664,2,BlackSoul,2627,205,8,3,11,72.7%,41m
8664,1,JazZzoN,2627,244,8,9,17,47.1%,1h
8664,2,Pachamam,2627,176,6,3,9,66.7%,1h
8664,3,gabavelpo,2627,167,6,9,15,40.0%,4m
8664,2,YrecoiLeTas,2627,0,3,4,7,42.9%,1h
8664,1,[EoC]Luxsong,2627,116,3,7,10,30.0%,1h
8664,2,Socrates,2627,0,2,3,5,40.0%,47m
8664,2,Ruckus,2627,46,1,2,3,33.3%,3h
8664,1,Rascalin,2627,0,0,4,4,0.0%,1h
8673,2,HeatoN,2626,1393,100,115,215,46.5%,5m
8673,1,[LGNxx]AiDz,2626,286,8,8,16,50.0%,3h
8673,2,Ainzooalgown,2626,0,4,2,6,66.7%,1h
8673,2,[GTN1]Victumin,2626,0,3,2,5,60.0%,1h
8673,1,[K4Y0TK]BlackStone,2626,76,3,7,10,30.0%,16m
8673,3,Lemon,2626,0,2,3,5,40.0%,1h
8673,3,Aku,2626,0,1,3,4,25.0%,3h
8673,1,Bigazzfries,2626,0,0,3,3,0.0%,1h
8681,2,StarCrossedC,2625,1545,461,445,906,50.9%,16m
8681,1,[zoolog]GaggleOGeese,2625,1525,84,81,165,50.9%,56m
8681,3,Nerdrrage,2625,829,70,93,163,42.9%,56m
8681,1,JuniorBacon,2625,1324,63,30,93,67.7%,1h
8681,3,ParanoidMarv,2625,907,51,57,108,47.2%,7m
8681,1,TomCruiser,2625,586,18,19,37,48.6%,24m
8681,3,ChiefRocka,2625,40,5,9,14,35.7%,30m
8681,2,Irie,2625,70,2,2,4,50.0%,57m
8681,2,[Uber]ProtossSalad,2625,62,2,3,5,40.0%,1h
8681,2,IMPERATOR,2625,0,2,3,5,40.0%,1h
8681,2,MaStAh,2625,0,0,1,1,0.0%,1h
8692,2,bladex,2624,330,11,12,23,47.8%,40m
8692,1,FionaHippo,2624,107,4,3,7,57.1%,3h
8692,2,Coyote,2624,0,2,3,5,40.0%,3h
8692,2,PlayfuLobstr,2624,0,1,0,1,100.0%,40m
8692,2,Daios,2624,0,1,0,1,100.0%,1h
8692,2,xBiznitch,2624,94,1,1,2,50.0%,48m
8698,2,Element,2623,776,38,22,60,63.3%,19m
8698,2,Shadyxxxx,2623,928,37,34,71,52.1%,50m
8698,1,[FIFON]Filou,2623,660,22,27,49,44.9%,37m
8698,1,Dinobot,2623,337,14,15,29,48.3%,3h
8698,3,[HRLOCA]DeiAurea,2623,380,13,20,33,39.4%,37m
8698,1,seaworm,2623,192,8,9,17,47.1%,1h
8698,3,TwoFtNYoChst,2623,0,2,3,5,40.0%,1h
8698,1,[TOYOTA]CelicaPower,2623,66,2,4,6,33.3%,3h
8698,2,Supaplex,2623,0,1,0,1,100.0%,1h
8698,2,Cristianlizc,2623,0,0,1,1,0.0%,3h
8708,1,[SBCG]Judson,2622,930,33,33,66,50.0%,43m
8708,2,Dishonored,2622,538,19,17,36,52.8%,1h
8708,3,Vorazun,2622,442,16,21,37,43.2%,12m
8708,1,Stash,2622,284,9,9,18,50.0%,30m
8708,1,CheesyCURDS,2622,149,7,5,12,58.3%,3h
8708,1,[VFam]Apollyon,2622,233,6,20,26,23.1%,1h
8708,2,[VRGA]RamonShatter,2622,114,5,0,5,100.0%,29m
8708,1,ScarletYNEZ,2622,92,2,6,8,25.0%,1h
8708,3,suprRageling,2622,0,1,4,5,20.0%,50m
8708,1,[FDV]Squirtlizer,2622,0,1,5,6,16.7%,1h
8708,2,FuNdaMentaL,2622,0,1,7,8,12.5%,3h
8719,1,MechaCow,2621,704,26,20,46,56.5%,50m
8719,2,[THBF]Kawaii,2621,283,11,2,13,84.6%,3h
8719,1,[RAINBO]Touchoflove,2621,398,11,13,24,45.8%,1h
8719,3,[xLCx]Shuru,2621,220,9,9,18,50.0%,9m
8719,1,[Xels]JulianoSledz,2621,146,5,4,9,55.6%,12m
8719,1,Lemons,2621,94,2,1,3,66.7%,1h
8719,3,[A3Flex]Frank,2621,122,2,2,4,50.0%,1h
8719,2,OceanMan,2621,58,2,2,4,50.0%,50m
8719,3,MaeRa,2621,0,2,3,5,40.0%,34m
8719,1,DpakoN,2621,80,2,6,8,25.0%,3h
8719,2,[DarkC]BigCharles,2621,0,1,0,1,100.0%,3h
8719,2,NoobZerg,2621,0,1,1,2,50.0%,1h
8731,1,Psignosys,2620,1384,380,473,853,44.5%,1h
8731,2,Kevin,2620,1556,142,154,296,48.0%,51m
8731,3,FalseFlag,2620,1565,78,84,162,48.1%,56m
8731,2,[Dicboy]INeedHelp,2620,463,18,14,32,56.2%,3h
8731,1,[KFA]Muskrat,2620,338,14,13,27,51.9%,56m
8731,1,Vorbeck,2620,358,10,10,20,50.0%,30m
8731,1,KingDaso,2620,169,6,3,9,66.7%,49m
8731,2,[Mgumin]IventHalcon,2620,48,1,1,2,50.0%,42m
8731,2,Conker,2620,30,1,2,3,33.3%,1h
8731,2,egyware,2620,30,1,2,3,33.3%,3h
8731,1,Freks,2620,40,1,3,4,25.0%,14m
8742,2,[Sc9Maf]PeeFace,2619,138,3,2,5,60.0%,1h
8742,2,[neverb]SoloOp,2619,0,0,1,1,0.0%,41m
8742,2,Sopro,2619,0,0,1,1,0.0%,1h
8742,2,[anti5z]Osoman,2619,0,0,1,1,0.0%,1h
8746,3,Blooha,2618,129,3,4,7,42.9%,15m
8746,2,Hydra,2618,30,2,0,2,100.0%,57m
8746,2,[SANGRE]Orue,2618,0,1,0,1,100.0%,3h
8746,1,Theriph,2618,95,1,1,2,50.0%,1h
8746,2,vinniecent,2618,0,1,4,5,20.0%,3h
8746,2,GranBajoPode,2618,0,0,1,1,0.0%,45m
8752,1,FellMyPower,2617,1007,46,25,71,64.8%,7m
8752,1,[WNTRLY]leadtech,2617,394,12,12,24,50.0%,24m
8752,2,MAYROMuwu,2617,0,0,1,1,0.0%,1h
8755,2,Parity,2616,507,94,98,192,49.0%,54m
8755,1,Spartz,2616,976,38,32,70,54.3%,1h
8755,1,PrimeAqasix,2616,498,18,21,39,46.2%,13m
8755,1,MiVidaxAiur,2616,303,9,11,20,45.0%,15m
8755,1,[Gaaaas]YEAHPHAT,2616,190,8,9,17,47.1%,1h
8755,3,Caffeine,2616,0,3,2,5,60.0%,15m
8755,1,[MexTab]Chelozskyy,2616,36,3,4,7,42.9%,1h
8755,1,[PTHero]Drizzt,2616,118,3,7,10,30.0%,3h
8755,2,Hakujin,2616,0,2,3,5,40.0%,1h
8755,1,ToganX,2616,122,2,3,5,40.0%,1h
8755,2,Hooptie,2616,0,1,0,1,100.0%,1h
8755,2,FoBoS,2616,0,0,1,1,0.0%,8m
8755,2,[4L0k0]NightCrawler,2616,0,0,5,5,0.0%,3h
8768,1,Leaf,2615,1528,176,198,374,47.1%,57m
8768,1,GUEVARA,2615,1167,146,142,288,50.7%,27m
8768,3,Prawnstar,2615,1526,89,77,166,53.6%,45m
8768,1,PiterFuentes,2615,1643,64,62,126,50.8%,1h
8768,1,InManEx,2615,186,6,8,14,42.9%,3h
8768,2,sandstorm,2615,134,4,0,4,100.0%,40m
8768,2,DragonSlayer,2615,64,3,3,6,50.0%,1h
8768,2,[Recall]Vonix,2615,0,1,0,1,100.0%,3h
8768,3,JJGargantuan,2615,0,1,4,5,20.0%,1h
8768,1,[ARIER]HairBert,2615,32,1,7,8,12.5%,1h
8768,2,MonkeyButt,2615,0,0,1,1,0.0%,1h
8768,1,depthy,2615,0,0,2,2,0.0%,1h
8780,2,Killdotgif,2614,1215,81,86,167,48.5%,5m
8780,2,GetSome,2614,728,78,91,169,46.2%,16m
8780,1,Sheeb,2614,1535,71,59,130,54.6%,1h
8780,3,Zile,2614,150,6,7,13,46.2%,55m
8780,2,ProbingTime,2614,0,1,0,1,100.0%,12m
8780,1,Yman,2614,0,1,1,2,50.0%,3h
8780,2,FierceBADGER,2614,0,0,2,2,0.0%,1h
8787,3,stupify,2613,986,57,63,120,47.5%,17m
8787,1,cal,2613,727,29,25,54,53.7%,24m
8787,1,GuruSnot,2613,519,17,20,37,45.9%,11m
8787,3,[WeGoon]bobjoe,2613,242,9,12,21,42.9%,6m
8787,2,Skapari,2613,177,6,5,11,54.5%,3h
8787,1,JackSparrow,2613,72,4,6,10,40.0%,30m
8787,1,Arkham,2613,114,3,6,9,33.3%,3h
8787,3,[TYDR]Tydrous,2613,0,2,3,5,40.0%,6m
8787,3,Chad,2613,0,0,1,1,0.0%,1h
8796,3,RareLNO,2612,440,17,20,37,45.9%,53m
8796,1,BloodReaver,2612,483,17,21,38,44.7%,40m
8796,3,WoodenFloors,2612,293,12,10,22,54.5%,39m
8796,1,thebigbanana,2612,144,7,8,15,46.7%,49m
8796,1,BLANDIN,2612,229,6,7,13,46.2%,51m
8796,1,Joker,2612,176,5,8,13,38.5%,13m
8796,2,Achilles,2612,146,5,10,15,33.3%,10m
8796,2,BUFFBIGSTUFF,2612,0,2,3,5,40.0%,1h
8804,3,Chrono,2611,498,42,45,87,48.3%,10m
8804,3,[BANZ]Kinufix,2611,706,35,36,71,49.3%,37m
8804,1,SyNaps,2611,327,16,13,29,55.2%,1h
8804,1,NNR,2611,305,11,8,19,57.9%,1h
8804,2,TossOP,2611,114,7,0,7,100.0%,18m
8804,1,NiceGuy,2611,214,7,9,16,43.8%,1h
8804,2,KnightOfHell,2611,0,1,0,1,100.0%,17m
8804,2,[Y3333T]CannonRusher,2611,30,1,2,3,33.3%,17m
8804,2,TheSwiss,2611,0,0,1,1,0.0%,34m
8804,2,[Nihity]Danithewolf,2611,0,0,2,2,0.0%,1h
8814,3,Daedalus,2610,1311,222,237,459,48.4%,17m
8814,1,JIMBO,2610,1029,40,36,76,52.6%,56m
8814,1,[ZHK]wayo,2610,666,25,18,43,58.1%,43m
8814,2,[WRFs87]Soriano,2610,490,20,15,35,57.1%,3h
8814,1,yourwifesson,2610,376,12,25,37,32.4%,51m
8814,2,xbastianx,2610,296,10,10,20,50.0%,1h
8814,2,Khas,2610,249,9,3,12,75.0%,42m
8814,1,[MOSKO]DoOrDie,2610,112,4,1,5,80.0%,11m
8814,2,Sonagi,2610,90,3,1,4,75.0%,58m
8814,2,Alazay,2610,46,3,5,8,37.5%,1h
8814,1,Tumbao,2610,106,3,7,10,30.0%,1h
8814,3,Pewpew,2610,0,2,3,5,40.0%,58m
8814,2,[micro]SUNG,2610,0,0,1,1,0.0%,4h
8814,1,Bargosk,2610,0,0,4,4,0.0%,1h
8828,3,lIIIlIIIlIII,2609,1089,84,81,165,50.9%,11m
8828,2,Wooli,2609,623,61,41,102,59.8%,3h
8828,2,Sundawgsmexy,2609,389,20,31,51,39.2%,16m
8828,3,LeoMelbourne,2609,483,14,23,37,37.8%,39m
8828,2,Mike,2609,348,12,11,23,52.2%,51m
8828,1,[krz]vanjo,2609,365,12,14,26,46.2%,1h
8828,1,bkuze,2609,135,5,6,11,45.5%,36m
8828,2,GadgetDad,2609,60,3,0,3,100.0%,23m
8828,2,[SCTF]Anthony,2609,30,2,2,4,50.0%,1h
8828,1,[FTK]tegra,2609,40,2,3,5,40.0%,30m
8828,2,mtraceur,2609,0,1,0,1,100.0%,1h
8828,1,Williaz,2609,0,1,2,3,33.3%,45m
8828,1,JackChin,2609,42,1,3,4,25.0%,1h
8841,3,[BoAVN]MrVietcong,2608,367,74,63,137,54.0%,44m
8841,2,SmRTneZ,2608,1533,70,63,133,52.6%,45m
8841,3,Canopus,2608,486,15,27,42,35.7%,16m
8841,1,Shadowdog,2608,351,13,9,22,59.1%,18m
8841,2,[SANGRE]hijodeodin,2608,394,13,15,28,46.4%,1h
8841,2,[TPGGXD]DARONSUE,2608,168,6,0,6,100.0%,4h
8841,1,GeTrEkT,2608,108,5,7,12,41.7%,4m
8841,2,[FkRFgt]DarkPanda,2608,0,4,1,5,80.0%,3h
8841,3,itchyrear,2608,40,4,3,7,57.1%,1h
8841,2,MachineOsaur,2608,120,4,5,9,44.4%,48m
8841,1,Kaej,2608,0,1,0,1,100.0%,55m
8852,1,[PiN0YS]NoisyBoy,2607,1438,82,74,156,52.6%,1h
8852,3,AMANGBS,2607,593,50,48,98,51.0%,37m
8852,1,Kenny,2607,1014,41,36,77,53.2%,1h
8852,2,Andy,2607,634,23,17,40,57.5%,1h
8852,1,BIANCHIROCK,2607,527,17,18,35,48.6%,1h
8852,1,TaylorGang,2607,195,8,7,15,53.3%,3h
8852,1,boulevardier,2607,81,5,8,13,38.5%,3h
8852,1,Sean,2607,72,3,4,7,42.9%,3h
8852,1,ViRuS,2607,0,1,2,3,33.3%,7m
8852,1,Rhaely,2607,0,0,2,2,0.0%,50m
8852,2,benens,2607,0,0,2,2,0.0%,9m
8863,3,TheBoxeR,2606,1424,175,189,364,48.1%,37m
8863,2,Boboski,2606,671,27,23,50,54.0%,46m
8863,1,CompasionTdT,2606,225,7,2,9,77.8%,3h
8863,2,Huntfalow,2606,128,4,3,7,57.1%,37m
8863,1,BagOfLettuce,2606,0,3,3,6,50.0%,51m
8863,2,[HLB]silverjce,2606,92,3,4,7,42.9%,25m
8863,2,[DRKDNA]Lythander,2606,0,2,3,5,40.0%,18m
8863,1,Spunions,2606,53,2,5,7,28.6%,12m
8863,2,SpartanKevin,2606,30,1,3,4,25.0%,52m
8872,3,[JIGSAW]demoleo,2605,684,57,64,121,47.1%,37m
8872,2,Deadlock,2605,682,41,37,78,52.6%,37m
8872,1,[Wienie]MrLoaf,2605,520,20,19,39,51.3%,49m
8872,2,[E10G]Bannanfage,2605,464,18,14,32,56.2%,3m
8872,3,Haymitch,2605,318,13,21,34,38.2%,38m
8872,2,NihonTarheel,2605,292,10,5,15,66.7%,5m
8872,1,Deller,2605,203,5,8,13,38.5%,3h
8872,2,WarriorZero,2605,88,4,1,5,80.0%,3h
8872,2,dotablaze,2605,0,3,2,5,60.0%,17m
8872,1,[HardCo]Wompas,2605,58,3,6,9,33.3%,51m
8872,2,[oPu]lCharizardl,2605,36,1,2,3,33.3%,3h
8883,1,ThePainTrain,2604,1638,587,570,1157,50.7%,30m
8883,3,Webtek,2604,1536,73,71,144,50.7%,55m
8883,2,Flomotion,2604,150,4,2,6,66.7%,1h
8883,2,Natural,2604,58,4,4,8,50.0%,1h
8883,1,[DeBoyz]Sniper,2604,154,4,10,14,28.6%,20m
8883,2,Dago,2604,0,3,2,5,60.0%,32m
8883,2,Senkyo,2604,32,1,3,4,25.0%,13m
8883,2,Sidress,2604,0,0,1,1,0.0%,19m
8883,3,navijojo,2604,0,0,2,2,0.0%,44m
8883,1,Barrier,2604,0,0,3,3,0.0%,1h
8893,3,Gery,2603,1384,189,184,373,50.7%,4m
8893,3,redbaron,2603,1470,112,101,213,52.6%,36m
8893,1,RawbDoggy,2603,1432,89,83,172,51.7%,1h
8893,1,pwrovrwelmin,2603,282,17,14,31,54.8%,1h
8893,1,cOs,2603,274,15,7,22,68.2%,3h
8893,1,Cynkar,2603,419,15,17,32,46.9%,1h
8893,2,[F2AAA]yikedami,2603,294,10,8,18,55.6%,3h
8893,1,lilililliili,2603,0,3,3,6,50.0%,4m
8893,1,Kessel,2603,121,3,6,9,33.3%,3h
8893,2,Monk,2603,138,2,1,3,66.7%,7m
8893,3,Jakamungo,2603,0,2,3,5,40.0%,3h
8893,1,Sevi,2603,40,2,5,7,28.6%,1h
8893,2,Derpo,2603,0,1,0,1,100.0%,1h
8893,2,simulation,2603,0,1,1,2,50.0%,51m
8893,1,[MEEGS]Pathogen,2603,40,1,5,6,16.7%,4m
8893,2,JoelFromIowa,2603,0,0,1,1,0.0%,48m
8909,1,PRod,2602,1414,60,50,110,54.5%,3h
8909,2,MrOvo,2602,244,10,11,21,47.6%,47m
8909,3,Champ,2602,230,7,18,25,28.0%,40m
8909,1,RShackleford,2602,146,5,7,12,41.7%,1h
8909,3,Fonduez,2602,0,2,3,5,40.0%,3m
8914,1,RainbowFruit,2601,1661,76,76,152,50.0%,1h
8914,1,[Lp]DarkShadooW,2601,634,20,25,45,44.4%,18m
8914,1,LuCkSs,2601,97,3,7,10,30.0%,1h
8917,1,Spinz,2600,1433,83,80,163,50.9%,17m
8917,2,[AIlin]Solus,2600,571,21,22,43,48.8%,3h
8917,1,JUNDK,2600,578,18,22,40,45.0%,1h
8917,1,Blind,2600,410,13,20,33,39.4%,30m
8917,1,DaBuDing,2600,234,8,6,14,57.1%,24m
8917,2,[CPRG]Xebdaz,2600,142,4,6,10,40.0%,3h
8917,3,codehead,2600,86,4,10,14,28.6%,51m
8917,2,kanada,2600,0,3,5,8,37.5%,32m
8917,1,Yamanashi,2600,116,2,3,5,40.0%,46m
8917,1,Hirron,2600,40,2,6,8,25.0%,3h
8917,1,ZebraHoedown,2600,30,1,3,4,25.0%,4m
8917,1,[CRABBR]MthaFkaJones,2600,88,1,5,6,16.7%,40m
8929,1,DrLoveCluck,2599,306,10,15,25,40.0%,1h
8929,2,[RINGTA]CrimeLemur,2599,60,3,1,4,75.0%,1h
8929,2,TinkaCat,2599,0,2,3,5,40.0%,3h
8929,2,Coffeecoast,2599,73,1,2,3,33.3%,3h
8933,2,Murphyslaw,2598,1084,60,37,97,61.9%,1h
8933,2,geku,2598,1085,54,43,97,55.7%,3h
8933,3,[DRKDMN]Noahala,2598,820,30,38,68,44.1%,6m
8933,2,DrTegridy,2598,452,17,11,28,60.7%,41m
8933,3,Weasel,2598,236,10,13,23,43.5%,21m
8933,2,Sausage,2598,178,9,13,22,40.9%,3m
8933,2,BabyOnBoard,2598,163,8,2,10,80.0%,1h
8933,3,[FETT]LuBu,2598,148,6,8,14,42.9%,41m
8933,2,Zabza,2598,0,4,5,9,44.4%,1h
8933,2,[NextDC]BlindSword,2598,84,4,8,12,33.3%,1h
8933,3,[DayJ]FentonLFC,2598,0,2,3,5,40.0%,3h
8933,2,Plumage,2598,0,2,3,5,40.0%,54m
8933,3,[ZTemps]Tengu,2598,40,1,1,2,50.0%,1h
8933,2,Fade,2598,0,0,1,1,0.0%,47m
8947,2,oibr,2597,1579,88,89,177,49.7%,11m
8947,2,thedestroyer,2597,222,6,7,13,46.2%,9m
8947,1,[ChiFan]Quetzal,2597,176,5,10,15,33.3%,7m
8947,1,Polderong,2597,191,4,6,10,40.0%,36m
8947,2,Hideo,2597,108,2,2,4,50.0%,49m
8947,2,FoRAiuR,2597,0,2,3,5,40.0%,1h
8947,2,[US]theFuzzyNeck,2597,0,0,1,1,0.0%,57m
8947,2,Lukicies,2597,0,0,1,1,0.0%,1h
8955,2,HelloKitty,2596,735,29,18,47,61.7%,3h
8955,2,poy,2596,318,10,11,21,47.6%,1h
8955,2,ForTheSwarM,2596,284,9,10,19,47.4%,1h
8955,2,[relord]MemeLord,2596,36,2,1,3,66.7%,51m
8955,2,Tiberius,2596,32,1,2,3,33.3%,5m
8960,1,ConnorDotCom,2595,853,92,79,171,53.8%,4m
8960,2,[LCE]InnoVation,2595,469,20,6,26,76.9%,48m
8960,1,zerglingsoup,2595,342,11,12,23,47.8%,30m
8960,2,haiLIFE,2595,92,3,4,7,42.9%,4h
8960,2,[PLT]Sars,2595,60,2,2,4,50.0%,1h
8960,2,Victor,2595,0,2,3,5,40.0%,4h
8960,1,Padraic,2595,0,1,3,4,25.0%,3h
8960,3,WaffleFry,2595,38,1,4,5,20.0%,1h
8960,2,TheRealShaDy,2595,0,0,1,1,0.0%,29m
8969,3,BigBoy,2594,1505,229,235,464,49.4%,52m
8969,3,jaiprime,2594,1021,70,72,142,49.3%,4m
8969,3,[REKTD]MegaHurtz,2594,1072,40,49,89,44.9%,36m
8969,1,Greygoo,2594,142,7,10,17,41.2%,59m
8969,3,Mystery,2594,0,2,3,5,40.0%,44m
8969,2,KingXvPvX,2594,0,0,2,2,0.0%,37m
8975,1,Stza,2593,619,62,39,101,61.4%,1h
8975,1,EveOnline,2593,742,26,26,52,50.0%,1h
8975,3,foxwoods,2593,298,12,15,27,44.4%,44m
8975,2,[UpxV]MrLimn,2593,162,5,4,9,55.6%,1h
8975,3,lowkey,2593,36,5,9,14,35.7%,39m
8975,2,[U55R]CobaltZephyr,2593,30,4,2,6,66.7%,1h
8975,3,Alexisherre,2593,40,4,4,8,50.0%,11m
8975,3,random,2593,0,3,4,7,42.9%,37m
8975,2,TheHunter,2593,0,2,3,5,40.0%,1h
8975,2,[Moka]frappuchino,2593,0,1,1,2,50.0%,25m
8975,1,RAYMANKAPEEN,2593,0,1,5,6,16.7%,3h
8975,1,salchi,2593,0,0,3,3,0.0%,3h
8987,1,MauKC,2592,860,34,28,62,54.8%,1h
8987,3,aje,2592,455,22,33,55,40.0%,56m
8987,3,Resol,2592,138,7,20,27,25.9%,32m
8987,1,NicaGizmody,2592,96,5,9,14,35.7%,1h
8987,2,[TT]Typhoon,2592,0,2,3,5,40.0%,1h
8987,2,GOLDENEAGLE,2592,0,0,1,1,0.0%,1h
8987,2,[NoBads]NepeGigante,2592,0,0,1,1,0.0%,3m
8987,2,[sffssf]Skerelechuga,2592,0,0,1,1,0.0%,1h
8995,3,[FyHr]MacKayA,2591,1548,267,255,522,51.1%,45m
8995,1,Bullshooter,2591,1670,145,146,291,49.8%,52m
8995,2,GreenRainbow,2591,1644,108,110,218,49.5%,5m
8995,3,Antinomy,2591,614,60,83,143,42.0%,10m
8995,1,Demora,2591,225,8,5,13,61.5%,20m
8995,2,Woplick,2591,194,7,8,15,46.7%,3h
8995,2,[Macac0]xLoro,2591,96,3,5,8,37.5%,1h
8995,3,OutOfOrder,2591,30,2,6,8,25.0%,58m
8995,1,Educado,2591,48,1,1,2,50.0%,49m
9004,1,Barcode,2590,1613,102,103,205,49.8%,11m
9004,1,[T5R]celiokan,2590,1517,82,75,157,52.2%,30m
9004,3,dimidrol,2590,543,26,31,57,45.6%,49m
9004,1,Havoc,2590,493,25,20,45,55.6%,43m
9004,1,AsthmaticLoc,2590,796,25,33,58,43.1%,1h
9004,1,Violentllama,2590,426,21,20,41,51.2%,4m
9004,2,[Grayon]Alak,2590,475,19,11,30,63.3%,1h
9004,3,Vudoo,2590,308,19,28,47,40.4%,14m
9004,2,ByunsUncle,2590,326,11,15,26,42.3%,23m
9004,1,Apothecera,2590,322,9,10,19,47.4%,1h
9004,2,shagy,2590,88,4,1,5,80.0%,23m
9004,1,Gino,2590,0,4,2,6,66.7%,3h
9004,2,Walrai,2590,90,3,4,7,42.9%,1h
9004,1,Crocop,2590,100,3,5,8,37.5%,50m
9004,2,[SEEXEE]Aisthesis,2590,30,2,2,4,50.0%,1h
9004,3,Teague,2590,0,1,1,2,50.0%,1h
9004,3,plato,2590,0,1,7,8,12.5%,58m
9021,1,agamenon,2589,591,21,21,42,50.0%,1h
9021,2,atom,2589,184,5,5,10,50.0%,3h
9021,2,Kiom,2589,96,4,4,8,50.0%,52m
9021,2,Jab,2589,0,2,3,5,40.0%,3h
9025,2,Alvaro,2588,1529,185,168,353,52.4%,1h
9025,3,[HRZCOK]sPiKe,2588,1567,115,115,230,50.0%,52m
9025,1,Lobo,2588,879,30,35,65,46.2%,3h
9025,1,[UAK]CrzySOMEBODY,2588,518,15,20,35,42.9%,4m
9025,1,joselewis,2588,278,9,14,23,39.1%,17m
9025,2,Megalectium,2588,187,5,3,8,62.5%,51m
9025,2,Feelsbad,2588,0,3,5,8,37.5%,14m
9025,1,dead,2588,0,1,8,9,11.1%,1h
9033,1,[xARGx]FallpaESP,2587,989,73,65,138,52.9%,3h
9033,2,[ARSON]sTix,2587,464,20,15,35,57.1%,1h
9033,1,dreicol,2587,335,12,12,24,50.0%,10m
9033,1,[C15]BLUMPKIN,2587,207,8,13,21,38.1%,17m
9033,3,JLR,2587,278,7,16,23,30.4%,4m
9033,2,Bio,2587,30,4,3,7,57.1%,4h
9033,2,[alphox]yolo,2587,30,2,0,2,100.0%,10m
9033,2,owldamage,2587,120,2,2,4,50.0%,32m
9033,2,iamnotahorse,2587,32,1,3,4,25.0%,3h
9033,2,Kimchiman,2587,0,0,1,1,0.0%,5m
9043,1,BigBoss,2586,1648,70,69,139,50.4%,7m
9043,2,EasySkankin,2586,514,21,15,36,58.3%,1h
9043,1,[WARN]watdafuk,2586,456,21,27,48,43.8%,3h
9043,1,Touchme,2586,355,14,13,27,51.9%,42m
9043,1,tootloops,2586,265,11,9,20,55.0%,12m
9043,2,Birthday,2586,86,4,2,6,66.7%,4h
9043,2,Quimet,2586,58,2,2,4,50.0%,58m
9043,3,GANZI,2586,0,2,3,5,40.0%,9m
9043,1,wolajacy,2586,0,2,4,6,33.3%,51m
9043,2,Madmartigan,2586,0,0,1,1,0.0%,37m
9043,2,GamenDeaD,2586,0,0,1,1,0.0%,3h
9043,2,malta,2586,0,0,1,1,0.0%,3h
9043,2,Suljo,2586,0,0,3,3,0.0%,45m
9056,2,imhigh,2585,1088,64,40,104,61.5%,1h
9056,3,JoJotaro,2585,802,34,32,66,51.5%,16m
9056,1,FairlyLost,2585,831,30,28,58,51.7%,24m
9056,3,Claes,2585,261,10,8,18,55.6%,15m
9056,3,CazzRenard,2585,90,5,8,13,38.5%,40m
9056,2,LortEctro,2585,240,5,9,14,35.7%,1h
9056,2,danielo,2585,156,4,6,10,40.0%,1h
9056,2,ShameBoy,2585,137,4,6,10,40.0%,3h
9056,2,BIOS,2585,108,3,4,7,42.9%,47m
9056,3,artnquest,2585,0,1,0,1,100.0%,1h
9056,2,[K3oudy]Fusion,2585,0,1,1,2,50.0%,3h
9056,1,[BNG]Twixxo,2585,0,1,2,3,33.3%,1h
9056,3,Zooko,2585,0,0,1,1,0.0%,3m
9069,1,Gloat,2584,1455,200,190,390,51.3%,11m
9069,2,Luisito,2584,879,40,26,66,60.6%,1h
9069,2,TrippUW,2584,608,21,34,55,38.2%,34m
9069,2,Dust,2584,462,20,8,28,71.4%,3h
9069,1,qrtpasdca,2584,409,12,17,29,41.4%,54m
9069,2,[EZDUNK]holleeze,2584,224,7,9,16,43.8%,1h
9069,2,[KSRP]LizardPity,2584,142,4,2,6,66.7%,3h
9069,2,[KUNUKU]FranzXaver,2584,0,2,3,5,40.0%,23m
9069,3,HotCoco,2584,0,2,4,6,33.3%,35m
9069,3,Starlord,2584,0,1,0,1,100.0%,1h
9069,2,[LastKT]Ridley,2584,95,1,3,4,25.0%,3h
9080,1,MEDIC,2583,834,30,32,62,48.4%,14m
9080,2,ZestisBest,2583,120,4,3,7,57.1%,1h
9080,3,[LETAL]Amón,2583,0,3,1,4,75.0%,11m
9080,1,Davidbp,2583,48,1,3,4,25.0%,3h
9084,1,killu,2582,945,41,37,78,52.6%,4h
9084,1,Leeshinobi,2582,522,23,19,42,54.8%,1h
9084,1,blacktrance,2582,588,22,24,46,47.8%,1h
9084,1,[PvZMa]xsaberdragon,2582,607,20,21,41,48.8%,49m
9084,1,[ILikeU]YOUNgLUCKy,2582,505,18,16,34,52.9%,1h
9084,2,Stinger,2582,258,8,5,13,61.5%,1h
9084,1,[TY4GG]Dominator,2582,208,6,12,18,33.3%,3h
9084,1,[NorK]TheInnKeeper,2582,117,4,4,8,50.0%,3h
9084,1,[AbcCo]NITRAM,2582,143,3,1,4,75.0%,1h
9084,1,Bishop,2582,40,2,5,7,28.6%,20m
9084,1,flamingo,2582,44,2,8,10,20.0%,12m
9084,2,Lambshaker,2582,0,1,0,1,100.0%,1h
9084,2,Tessaderes,2582,0,1,0,1,100.0%,1h
9084,2,Corripio,2582,0,0,1,1,0.0%,52m
9084,1,[HnTr]BlackBlade,2582,0,0,3,3,0.0%,14m
9084,3,BigDaddy,2582,0,0,5,5,0.0%,48m
9100,1,Holyshieldz,2581,1661,291,287,578,50.3%,37m
9100,3,tabs,2581,1246,88,88,176,50.0%,44m
9100,2,Elsolapa,2581,428,19,6,25,76.0%,1h
9100,2,chacon,2581,236,15,11,26,57.7%,1h
9100,3,ChesterNoob,2581,430,14,23,37,37.8%,43m
9100,2,Madness,2581,131,5,4,9,55.6%,1h
9100,1,[FalPal]computer,2581,130,5,7,12,41.7%,1h
9100,2,XENOACOLYTE,2581,0,1,1,2,50.0%,45m
9100,2,Reaver,2581,0,0,1,1,0.0%,3h
9100,2,[TCCore]Raiden,2581,0,0,3,3,0.0%,38m
9110,2,Goose,2580,886,41,35,76,53.9%,19m
9110,2,REDSILENCEX,2580,767,30,38,68,44.1%,46m
9110,3,Hardstem,2580,336,10,17,27,37.0%,32m
9110,2,Shwing,2580,0,1,0,1,100.0%,3h
9110,2,Edorn,2580,30,1,2,3,33.3%,4h
9110,1,honeynut,2580,90,1,4,5,20.0%,52m
9116,2,khuaikhema,2579,1509,179,177,356,50.3%,40m
9116,1,Sancheez,2579,255,15,10,25,60.0%,1h
9116,1,Ambition,2579,378,15,15,30,50.0%,1h
9116,2,SpetsnazHero,2579,161,5,3,8,62.5%,1h
9116,2,cimplex,2579,166,5,4,9,55.6%,25m
9116,1,[Over1]SUPAPI,2579,102,4,6,10,40.0%,1h
9116,2,Randy,2579,128,3,2,5,60.0%,18m
9116,3,wester,2579,0,2,2,4,50.0%,1h
9124,3,Setz,2578,997,56,68,124,45.2%,37m
9124,1,BeliMaMa,2578,1043,42,35,77,54.5%,1h
9124,2,RainyDay,2578,448,16,12,28,57.1%,1h
9124,2,DaggothZilla,2578,258,8,10,18,44.4%,51m
9124,2,TopShotta,2578,0,0,2,2,0.0%,1h
9124,2,[5Under]BazookaFist,2578,0,0,2,2,0.0%,1h
9130,1,[40T]Essence,2577,1186,285,285,570,50.0%,10m
9130,3,antagomiR,2577,600,86,80,166,51.8%,54m
9130,1,Gus,2577,688,27,34,61,44.3%,4m
9130,2,Gerg,2577,534,21,15,36,58.3%,1h
9130,1,Fantasma,2577,426,13,20,33,39.4%,1h
9130,1,PorkJaw,2577,250,8,11,19,42.1%,1h
9130,2,BadLadurette,2577,160,6,5,11,54.5%,48m
9130,2,Daxter,2577,60,3,4,7,42.9%,57m
9130,1,ShadowHunter,2577,136,3,5,8,37.5%,1h
9130,2,[VTMed]Magdern,2577,30,2,0,2,100.0%,1h
9140,2,Juice,2576,585,24,16,40,60.0%,34m
9140,2,SoulBlack,2576,555,21,18,39,53.8%,27m
9140,1,Isaku,2576,399,16,17,33,48.5%,9m
9140,2,[MPC]JaySmiles,2576,234,9,10,19,47.4%,29m
9140,1,[OvG]Corgoth,2576,184,6,9,15,40.0%,19m
9140,1,FilthyDish,2576,96,3,11,14,21.4%,4h
9140,1,IlIlIlIlIlIl,2576,0,2,3,5,40.0%,30m
9140,2,Toxicity,2576,0,2,3,5,40.0%,9m
9140,3,Darwin,2576,0,2,3,5,40.0%,34m
9149,1,Sooperdork,2575,962,40,40,80,50.0%,3h
9149,3,SunTzu,2575,500,18,26,44,40.9%,32m
9149,1,GlHfGg,2575,350,13,15,28,46.4%,1h
9149,2,SnakeholeRON,2575,296,11,12,23,47.8%,39m
9149,2,lemonade,2575,204,7,3,10,70.0%,4h
9149,3,[Rawwr]Michael,2575,0,3,2,5,60.0%,58m
9149,2,Zalbaag,2575,0,3,2,5,60.0%,3h
9149,2,CrackSpider,2575,86,3,5,8,37.5%,54m
9149,3,senjo,2575,97,2,0,2,100.0%,18m
9149,2,[GØSU]Dread,2575,0,1,0,1,100.0%,23m
9149,2,Tsuvani,2575,88,1,5,6,16.7%,1h
9149,2,[OtakMs]RicardoMS,2575,0,0,2,2,0.0%,15m
9161,3,GrenSuin,2574,706,28,37,65,43.1%,51m
9161,1,Falgoo,2574,512,22,23,45,48.9%,4m
9161,2,Archina,2574,424,14,16,30,46.7%,3h
9161,2,BULAZ,2574,234,8,3,11,72.7%,52m
9161,2,DeRcHoBo,2574,246,8,8,16,50.0%,1h
9161,2,EricLuve,2574,176,5,3,8,62.5%,1h
9161,1,Dajooka,2574,0,2,4,6,33.3%,1h
9168,2,[DNKCFT]PrEaTure,2573,313,25,23,48,52.1%,1h
9168,2,Hybrid,2573,505,24,25,49,49.0%,5m
9168,2,MrMayhem,2573,296,12,4,16,75.0%,1h
9171,1,[CRABBR]DVDA,2572,968,49,50,99,49.5%,20m
9171,2,[ShTiLe]sludgeminer,2572,689,24,23,47,51.1%,3h
9171,1,Dngercarrot,2572,338,10,11,21,47.6%,1h
9171,2,[GOPERÚ]LORKAOS,2572,158,5,4,9,55.6%,48m
9171,1,JUAN,2572,121,5,7,12,41.7%,4m
9171,2,billyfraser,2572,36,1,2,3,33.3%,1h
9171,2,SsAaDdIiCc,2572,40,1,2,3,33.3%,16m
9171,1,[INGAMZ]Iscariote,2572,0,1,5,6,16.7%,1h
9171,2,KorbenDallas,2572,0,0,1,1,0.0%,1h
9180,3,IsTheShadow,2571,1575,260,276,536,48.5%,47m
9180,3,[X1eHu1]AndyGai,2571,1281,114,83,197,57.9%,36m
9180,3,Piwo,2571,614,58,60,118,49.2%,43m
9180,2,Energie,2571,506,22,10,32,68.8%,27m
9180,1,bassface,2571,621,21,30,51,41.2%,17m
9180,2,Truquero,2571,474,20,17,37,54.1%,17m
9180,1,Zyun,2571,128,16,18,34,47.1%,3h
9180,1,JagoShadow,2571,409,13,13,26,50.0%,1h
9180,3,Vailer,2571,402,13,24,37,35.1%,33m
9180,1,NuclearGoo,2571,271,8,10,18,44.4%,12m
9180,2,ZiiiDrate,2571,167,5,3,8,62.5%,3h
9180,2,Timbalistea,2571,60,4,5,9,44.4%,3h
9192,2,HappyFeet,2570,204,7,7,14,50.0%,41m
9192,2,BlindWolf,2570,90,4,5,9,44.4%,1h
9192,2,PBee,2570,30,3,4,7,42.9%,18m
9192,1,Mavy,2570,142,3,6,9,33.3%,60m
9196,2,annuler,2569,1604,79,65,144,54.9%,3h
9196,2,AnarchicMaN,2569,469,18,18,36,50.0%,1h
9196,2,RickSanchez,2569,291,11,10,21,52.4%,36m
9196,2,TzpheonixD,2569,262,10,9,19,52.6%,1h
9196,2,[kØ]MurDeR,2569,217,9,1,10,90.0%,27m
9196,2,Embolia,2569,246,9,12,21,42.9%,1h
9196,2,tinman,2569,182,7,5,12,58.3%,1h
9196,1,Gaba,2569,180,6,13,19,31.6%,1h
9196,2,runinmonkey,2569,94,5,9,14,35.7%,10m
9196,2,ThiefOfEden,2569,126,4,3,7,57.1%,41m
9196,2,AlexShu,2569,0,2,3,5,40.0%,52m
9196,3,WebCorno,2569,0,1,3,4,25.0%,1h
9208,3,Tony,2568,1450,150,145,295,50.8%,39m
9208,2,TonyStark,2568,874,31,31,62,50.0%,25m
9208,3,onegu,2568,806,27,35,62,43.5%,11m
9208,1,Alejandro,2568,516,16,25,41,39.0%,1h
9208,3,Random,2568,260,11,11,22,50.0%,39m
9208,3,Zambowskie,2568,275,10,6,16,62.5%,1h
9208,2,[TFAM]railofone,2568,161,5,6,11,45.5%,1h
9208,3,Sateriok,2568,168,4,5,9,44.4%,34m
9208,2,lIlIIIlI,2568,90,3,6,9,33.3%,1h
9208,2,Dillwinn,2568,0,2,3,5,40.0%,37m
9208,2,clifor,2568,38,1,3,4,25.0%,1h
9219,3,Hok,2567,1555,259,261,520,49.8%,56m
9219,2,[M2A5]joepetey,2567,636,80,136,216,37.0%,41m
9219,3,Martlebetuna,2567,1403,60,63,123,48.8%,16m
9219,2,Raiden,2567,371,15,8,23,65.2%,3h
9219,2,Boom,2567,155,4,1,5,80.0%,1h
9219,2,Stonewall,2567,97,2,4,6,33.3%,1h
9225,2,piggy,2566,363,15,12,27,55.6%,4h
9225,1,giantwalker,2566,452,14,18,32,43.8%,1h
9225,3,[KYLE]rabbitez,2566,278,9,22,31,29.0%,15m
9225,1,[icon]Jason,2566,214,8,12,20,40.0%,36m
9225,2,Varimatas,2566,234,7,5,12,58.3%,1h
9225,1,HOUSE,2566,178,6,8,14,42.9%,1h
9225,1,serenitynow,2566,134,4,8,12,33.3%,4m
9225,2,RiceNinja,2566,115,3,5,8,37.5%,3h
9225,2,PandaBear,2566,99,2,3,5,40.0%,42m
9225,2,[Shang]Penamat,2566,0,2,3,5,40.0%,4h
9225,1,Scootydooter,2566,38,2,4,6,33.3%,1h
9225,2,IronChef,2566,0,1,1,2,50.0%,3h
9225,2,[Girlll]prettythanU,2566,0,0,2,2,0.0%,1h
9225,2,quaiurntined,2566,0,0,3,3,0.0%,25m
9225,2,[MCOS]Frutilloso,2566,0,0,8,8,0.0%,9m
9240,3,[PRATAZ]Dengue,2565,1137,42,43,85,49.4%,47m
9240,2,[TF11]Raider,2565,963,39,56,95,41.1%,50m
9240,2,rArA,2565,193,7,6,13,53.8%,52m
9240,3,Texugo,2565,129,5,3,8,62.5%,6m
9240,1,Boyd,2565,145,5,8,13,38.5%,7m
9240,2,PolitiKill,2565,96,4,2,6,66.7%,3h
9240,3,JuggyRule,2565,0,2,4,6,33.3%,1h
9240,2,[TACOMD]Rockstaar,2565,0,1,0,1,100.0%,1h
9240,3,JAK,2565,0,1,0,1,100.0%,1h
9240,2,Faith,2565,0,1,4,5,20.0%,29m
9250,2,Run,2564,734,34,16,50,68.0%,1h
9250,3,MineShaft,2564,681,30,39,69,43.5%,53m
9250,2,[Kodos]Nicofersar,2564,243,9,8,17,52.9%,32m
9250,1,SAINT,2564,97,4,2,6,66.7%,1h
9250,2,VoidStalker,2564,0,1,0,1,100.0%,1h
9255,3,Lilzerglin,2563,453,20,21,41,48.8%,15m
9255,1,[Chizu]ReyKnorr,2563,116,8,10,18,44.4%,56m
9255,1,namsoft,2563,0,2,4,6,33.3%,3h
9255,2,[αXLa]Fox,2563,0,1,0,1,100.0%,42m
9259,2,SpiritFriend,2562,435,28,25,53,52.8%,1h
9259,3,[Mamers]Terminator,2562,756,27,35,62,43.5%,36m
9259,1,kaygee,2562,358,12,12,24,50.0%,1h
9259,1,Darkfuzion,2562,366,11,16,27,40.7%,1h
9259,2,Poins,2562,0,1,4,5,20.0%,36m
9259,3,JDlove,2562,0,0,1,1,0.0%,1h
9259,1,[NGFR]MrKrabs,2562,0,0,2,2,0.0%,55m
9266,2,[ISDI]NeoAer,2561,317,14,1,15,93.3%,1h
9266,2,Bigdickbison,2561,328,13,10,23,56.5%,1h
9266,3,DaBlAcKmAmBa,2561,0,4,2,6,66.7%,11m
9266,2,NexusKing,2561,30,2,5,7,28.6%,1h
9270,2,TheWitch,2560,454,17,11,28,60.7%,3h
9270,2,Overlord,2560,114,5,7,12,41.7%,1h
9270,2,Japtin,2560,58,3,4,7,42.9%,1h
9270,2,XIAOHU,2560,60,2,3,5,40.0%,1h
9270,2,[Axius]StarkNara,2560,0,0,1,1,0.0%,4h
9270,3,[Po0pY]Nostrils,2560,0,0,1,1,0.0%,53m
9270,2,[AbcCo]Amir,2560,0,0,5,5,0.0%,32m
9277,3,Ramblingfool,2559,1428,101,106,207,48.8%,55m
9277,2,Maru,2559,1128,48,34,82,58.5%,3h
9277,2,[TILtd]Aibohpotorue,2559,750,31,22,53,58.5%,34m
9277,2,Spudnuts,2559,30,1,1,2,50.0%,4h
9277,2,TheCrounge,2559,0,0,1,1,0.0%,1h
9282,1,[BMNC]Jahan,2558,1237,52,54,106,49.1%,3h
9282,2,lIlIlIlIlIlI,2558,918,32,36,68,47.1%,1h
9282,3,Polytonalism,2558,538,19,22,41,46.3%,48m
9282,2,ElPenuino,2558,107,3,4,7,42.9%,46m
9282,1,skchimera,2558,0,2,4,6,33.3%,4m
9287,2,Warhawk,2557,1589,201,186,387,51.9%,1h
9287,1,Bicboooi,2557,694,27,28,55,49.1%,5m
9287,2,[ZTemps]MystixW,2557,395,15,11,26,57.7%,1h
9287,2,BoomerTown,2557,88,3,4,7,42.9%,1h
9287,1,Olivier,2557,125,3,5,8,37.5%,45m
9287,2,[AbcCo]AlexG,2557,0,1,0,1,100.0%,47m
9287,2,[xEx]monash,2557,30,1,1,2,50.0%,1h
9287,1,CMTCaptain,2557,42,1,1,2,50.0%,4m
9287,3,PostalElf,2557,0,0,2,2,0.0%,1h
9296,1,[SDAASD]cdtBehemoth,2556,1208,70,69,139,50.4%,20m
9296,2,AldoRguez,2556,988,36,36,72,50.0%,16m
9296,1,waterbottle,2556,214,7,11,18,38.9%,13m
9296,2,[JOSOWE]HeroZealot,2556,0,4,0,4,100.0%,1h
9296,2,Effortless,2556,112,3,0,3,100.0%,47m
9296,3,DrAbusive,2556,32,3,4,7,42.9%,53m
9296,2,Zelph,2556,132,3,5,8,37.5%,3h
9296,2,[Box2]YERICOS,2556,126,3,6,9,33.3%,25m
9296,2,Albatraoz,2556,60,2,4,6,33.3%,52m
9305,3,LorgePanda,2555,1527,343,344,687,49.9%,5m
9305,2,[GLhf12]BRUTALMATT,2555,499,37,18,55,67.3%,13m
9305,1,HMSBeagle,2555,658,23,30,53,43.4%,56m
9305,2,GershonJonez,2555,436,17,11,28,60.7%,27m
9309,2,Garnet,2554,664,42,30,72,58.3%,23m
9309,2,Zephrene,2554,226,9,7,16,56.2%,10m
9309,1,MouthFeel,2554,182,7,11,18,38.9%,1h
9309,2,Paul,2554,191,6,3,9,66.7%,4h
9309,1,[T3RA]BooneGoon,2554,216,6,12,18,33.3%,46m
9309,1,Olmeca,2554,238,6,23,29,20.7%,1h
9309,1,JawnDeep,2554,144,5,8,13,38.5%,11m
9309,2,[Drowi]Makto,2554,128,4,6,10,40.0%,1h
9309,2,holdmyD,2554,88,4,6,10,40.0%,57m
9309,1,Computer,2554,0,2,4,6,33.3%,1h
9309,2,Berj,2554,0,0,1,1,0.0%,17m
9320,1,Danyk,2553,482,26,20,46,56.5%,14m
9320,1,jarrett,2553,30,3,5,8,37.5%,1h
9320,2,[NOOT]BootyDaddy,2553,30,2,0,2,100.0%,27m
9320,2,PRQ,2553,64,2,3,5,40.0%,1h
9320,1,zergkiller,2553,70,2,10,12,16.7%,3h
9320,2,HaPeniss,2553,0,0,1,1,0.0%,1h
9326,1,[ExcIgN]Charlie,2552,1494,188,175,363,51.8%,54m
9326,2,[tCo9]Ace,2552,1031,53,47,100,53.0%,51m
9326,1,[EOKA]Spartacus,2552,1253,47,47,94,50.0%,1h
9326,1,Fiercemind,2552,559,23,25,48,47.9%,3h
9326,3,[XCLSV]panamakido,2552,11,4,18,22,18.2%,56m
9326,3,[PCAKE]Benok,2552,121,3,4,7,42.9%,46m
9326,2,SkeeZeL,2552,30,3,5,8,37.5%,47m
9326,3,[LDCO]darkjulio,2552,0,1,1,2,50.0%,1h
9334,2,vash,2551,1018,48,39,87,55.2%,1h
9334,2,devastator,2551,115,2,3,5,40.0%,1h
9334,3,Xiao,2551,0,2,3,5,40.0%,5m
9334,2,DunkaDanku,2551,0,1,4,5,20.0%,3h
9334,2,[SyLx]Hercules,2551,0,0,2,2,0.0%,3h
9339,2,SaltyDave,2550,1065,43,38,81,53.1%,3h
9339,1,Daniel,2550,786,30,29,59,50.8%,1h
9339,2,Trumptard,2550,309,12,13,25,48.0%,52m
9339,1,[mewth]Catman,2550,219,8,15,23,34.8%,1h
9339,1,TwoFaces,2550,193,6,8,14,42.9%,46m
9339,1,Enzion,2550,223,6,10,16,37.5%,50m
9339,2,[lRl]oldcrazyeyes,2550,116,5,5,10,50.0%,1h
9339,1,Easty,2550,194,4,8,12,33.3%,1h
9339,2,karckrac,2550,108,3,5,8,37.5%,17m
9339,3,Hockmah,2550,0,0,1,1,0.0%,39m
9349,1,[KTWN]Woorijip,2549,664,22,23,45,48.9%,7m
9349,1,VDMD,2549,252,8,13,21,38.1%,9m
9349,2,DaRealNiglet,2549,0,1,2,3,33.3%,58m
9352,2,Paul,2548,1005,47,35,82,57.3%,36m
9352,3,Conan,2548,854,33,35,68,48.5%,5m
9352,2,[Atone]Base,2548,482,18,33,51,35.3%,18m
9352,2,[MlgRek]Wolf,2548,252,5,7,12,41.7%,33m
9352,2,[BAAF]wargazmz,2548,133,4,2,6,66.7%,1h
9352,2,Dewey,2548,133,3,2,5,60.0%,3h
9352,3,JungBeest,2548,97,2,0,2,100.0%,53m
9359,1,DangerZone,2547,1628,149,147,296,50.3%,18m
9359,1,darksession,2547,1475,104,110,214,48.6%,3h
9359,2,[FQRBDY]NATAS,2547,1007,63,81,144,43.8%,36m
9359,2,happykid,2547,1205,51,45,96,53.1%,1h
9359,2,Kaydence,2547,734,27,28,55,49.1%,3h
9359,2,BiohazrD,2547,191,4,7,11,36.4%,3h
9359,2,Chemyst,2547,44,2,0,2,100.0%,38m
9359,2,FunkyCold,2547,38,2,3,5,40.0%,20m
9359,2,doubledown,2547,0,1,0,1,100.0%,4h
9359,1,nub,2547,0,1,6,7,14.3%,1h
9369,1,Tobi,2546,627,25,23,48,52.1%,43m
9369,3,Tweak,2546,270,25,23,48,52.1%,39m
9369,3,Azuna,2546,494,21,25,46,45.7%,16m
9369,1,[zxczx]Remdeex,2546,264,7,11,18,38.9%,46m
9369,2,atomas,2546,185,6,5,11,54.5%,1h
9369,2,[NSushi]nighthawk,2546,120,5,4,9,55.6%,1h
9369,3,Dreadnaught,2546,0,3,2,5,60.0%,1h
9369,1,quicklyspent,2546,38,3,6,9,33.3%,25m
9369,2,[LBxX]Imortalyon,2546,88,2,0,2,100.0%,3h
9369,3,GIChoe,2546,0,2,3,5,40.0%,3h
9369,2,[DSAL]GOLIAT,2546,0,1,0,1,100.0%,23m
9380,1,Furbi,2545,1628,153,143,296,51.7%,3h
9380,3,LocdOut,2545,858,32,37,69,46.4%,32m
9380,2,Player,2545,258,10,9,19,52.6%,1h
9380,1,Balto,2545,283,8,12,20,40.0%,32m
9380,2,[SMH]Raptor,2545,126,4,1,5,80.0%,1h
9380,3,AcidFalls,2545,0,2,5,7,28.6%,47m
9380,2,BabyMeat,2545,0,1,1,2,50.0%,3h
9380,2,Chomosuke,2545,42,1,3,4,25.0%,3h
9380,2,[DHE]Lithos,2545,0,1,4,5,20.0%,48m
9389,1,SweatStain,2544,1617,154,157,311,49.5%,1h
9389,3,dasdsaf,2544,745,27,30,57,47.4%,40m
9389,2,DumbInACan,2544,325,12,16,28,42.9%,1h
9389,1,MedmanX,2544,317,9,10,19,47.4%,11m
9389,2,MONKEYSTYLE,2544,0,2,3,5,40.0%,1h
9389,2,Maicke,2544,34,2,3,5,40.0%,1h
9389,3,Fliegen,2544,0,2,3,5,40.0%,4m
9389,2,MrShackly,2544,0,1,0,1,100.0%,1h
9389,2,yobuggzy,2544,30,1,2,3,33.3%,3h
9398,2,calculon,2543,394,14,16,30,46.7%,52m
9398,2,Deku,2543,234,8,8,16,50.0%,3h
9398,2,BlastySpice,2543,148,7,6,13,53.8%,1h
9398,2,dunny,2543,154,5,1,6,83.3%,1h
9398,2,Pulz,2543,0,3,2,5,60.0%,3h
9398,2,[UNITEM]GAMBIT,2543,30,2,1,3,66.7%,1h
9398,3,Vitojuice,2543,0,2,4,6,33.3%,39m
9405,2,Vindictus,2542,1551,368,374,742,49.6%,49m
9405,2,Arngrim,2542,1596,89,84,173,51.4%,1h
9405,2,xxKAZUNARIxx,2542,359,14,7,21,66.7%,3h
9405,2,[GRU]Trippleblack,2542,112,3,0,3,100.0%,3m
9405,2,[ADDU]VanHoenheim,2542,123,3,3,6,50.0%,1h
9410,2,opie,2541,183,19,19,38,50.0%,36m
9410,1,veracitas,2541,422,13,19,32,40.6%,28m
9410,2,[MURI0C]dragon,2541,140,5,3,8,62.5%,1h
9410,2,Kome,2541,0,1,2,3,33.3%,30m
9410,2,[Awo0o]Gnarbone,2541,0,0,1,1,0.0%,20m
9410,2,ConsciousG,2541,0,0,1,1,0.0%,1h
9410,3,Totalnublet,2541,0,0,2,2,0.0%,21m
9417,2,BuruBRA,2540,1402,72,66,138,52.2%,3h
9417,1,Next,2540,765,60,58,118,50.8%,1h
9417,2,BouncyBear,2540,561,52,35,87,59.8%,1h
9417,2,[PMN]aKaGCurse,2540,551,23,24,47,48.9%,3h
9417,1,[Zelern]ezbake,2540,458,14,21,35,40.0%,4h
9417,2,Derpalisk,2540,264,10,12,22,45.5%,1h
9417,1,[Mayku]Atreyu,2540,321,8,8,16,50.0%,32m
9417,1,Vandarcae,2540,336,8,9,17,47.1%,3h
9417,2,Avocadeado,2540,127,5,8,13,38.5%,1h
9417,3,[BeerLH]Zohdin,2540,0,1,4,5,20.0%,15m
9427,1,[HdV22]nemesis,2539,252,8,14,22,36.4%,1h
9427,1,DallFace,2539,152,3,8,11,27.3%,1h
9427,2,Wadilight,2539,88,1,1,2,50.0%,1h
9427,2,[Snoopy]Arkling,2539,0,0,1,1,0.0%,3h
9431,3,IIIIIIIIIIII,2538,1464,89,91,180,49.4%,16m
9431,2,Fame,2538,1349,60,39,99,60.6%,1h
9431,2,HatedJoker,2538,583,25,16,41,61.0%,58m
9431,3,Zerg,2538,97,4,3,7,57.1%,33m
9431,2,Ripley,2538,0,1,0,1,100.0%,18m
9431,1,[churrr]ohomairangi,2538,0,1,2,3,33.3%,5m
9437,1,Champs,2537,725,30,28,58,51.7%,3h
9437,2,Makta,2537,680,26,27,53,49.1%,3h
9437,1,Salo,2537,100,6,6,12,50.0%,1h
9437,1,MeatGazer,2537,30,2,7,9,22.2%,46m
9437,2,[pigs]GetGot,2537,0,1,0,1,100.0%,1h
9437,2,DALTRON,2537,0,0,1,1,0.0%,52m
9437,3,[DANKEM]Cæsarius,2537,0,0,1,1,0.0%,1h
9444,1,ComputerEasy,2536,1394,65,78,143,45.5%,1h
9444,2,EpicSchiPhy,2536,1183,51,45,96,53.1%,1h
9444,2,mrsandia,2536,640,24,28,52,46.2%,1h
9444,2,ChimTheGrim,2536,505,18,19,37,48.6%,37m
9444,2,RubberJacky,2536,494,18,20,38,47.4%,1h
9444,2,Ashka,2536,176,6,6,12,50.0%,54m
9444,2,OSarinha,2536,88,5,7,12,41.7%,51m
9444,2,Nubcakes,2536,41,3,3,6,50.0%,1h
9444,3,[Emb3rs]Tell,2536,0,0,5,5,0.0%,58m
9453,3,[EGGboi]MaxMagus,2535,1028,59,63,122,48.4%,43m
9453,1,[iMOAN]Necroxion,2535,208,5,7,12,41.7%,50m
9453,2,[Mldr]Reminex,2535,116,4,0,4,100.0%,1h
9453,2,[GC2042]Axolotl,2535,126,3,3,6,50.0%,1h
9453,2,Haindall,2535,0,2,3,5,40.0%,3h
9453,3,[PobSC]latineltunas,2535,0,1,3,4,25.0%,1h
9453,2,QuBuS,2535,88,1,5,6,16.7%,3h
9453,2,Buurgen,2535,0,0,1,1,0.0%,1h
9461,1,quark,2534,1625,194,183,377,51.5%,50m
9461,2,Iboga,2534,1588,151,146,297,50.8%,1h
9461,1,Stilgar,2534,730,44,45,89,49.4%,1h
9461,1,Yoochun,2534,182,6,8,14,42.9%,35m
9461,1,smellykid,2534,70,4,5,9,44.4%,1h
9461,3,tipsywipsy,2534,0,2,3,5,40.0%,11m
9461,3,maghea,2534,0,0,2,2,0.0%,33m
9468,2,Sprinter,2533,786,39,33,72,54.2%,3h
9468,1,Jiska,2533,714,25,30,55,45.5%,19m
9468,2,SirBeaker,2533,564,20,31,51,39.2%,36m
9468,2,Noelgeezy,2533,401,14,17,31,45.2%,1h
9468,2,Dann,2533,258,10,10,20,50.0%,1h
9468,2,BananaKush,2533,58,4,6,10,40.0%,46m
9468,2,[BICDIX]Amnesia,2533,88,2,0,2,100.0%,3h
9468,2,[PIN]Davo,2533,50,2,3,5,40.0%,1h
9468,2,SALT,2533,0,1,0,1,100.0%,1h
9468,3,ZergYunior,2533,0,1,4,5,20.0%,34m
9468,2,[OCBO]Kemosabe,2533,0,0,1,1,0.0%,5m
9479,2,arfiss,2532,417,19,21,40,47.5%,3h
9479,2,nzAbyssal,2532,117,3,1,4,75.0%,1h
9481,1,Kal,2531,558,19,23,42,45.2%,1h
9481,1,husty,2531,484,15,19,34,44.1%,46m
9481,2,[ScScUr]DDD,2531,378,13,13,26,50.0%,51m
9481,1,bruhmoment,2531,0,2,3,5,40.0%,13m
9481,3,Bigmichael,2531,0,0,2,2,0.0%,44m
9486,2,burntoast,2530,1398,58,44,102,56.9%,1h
9486,2,DrHyde,2530,933,45,41,86,52.3%,1h
9486,2,Gansk,2530,997,42,46,88,47.7%,1h
9486,1,BigDreams,2530,379,13,13,26,50.0%,3h
9486,1,Cacciatore,2530,195,8,9,17,47.1%,1h
9486,1,Manus,2530,190,6,11,17,35.3%,1h
9486,2,LadyBug,2530,187,5,7,12,41.7%,1h
9486,1,pikachu,2530,0,4,2,6,66.7%,3h
9486,2,Fiddlefiend,2530,64,2,5,7,28.6%,3h
9486,3,LFNIGHTMARE,2530,97,2,5,7,28.6%,5m
9486,2,llBalanaRll,2530,0,1,1,2,50.0%,3h
9497,1,[D0NGL]skyoctopi,2529,1651,251,242,493,50.9%,19m
9497,2,edgatgNM,2529,516,21,22,43,48.8%,37m
9497,2,Connor,2529,392,18,11,29,62.1%,17m
9497,2,[gksrnr]Class,2529,332,13,6,19,68.4%,30m
9497,2,[cl0udM]Cryogenes,2529,156,7,2,9,77.8%,1h
9497,1,UtilityFan,2529,206,6,13,19,31.6%,14m
9497,2,Adimus,2529,94,2,1,3,66.7%,3h
9504,2,NebulaDesign,2528,1342,66,65,131,50.4%,3h
9504,2,[STDnbs]Cooleo,2528,805,35,31,66,53.0%,3h
9504,2,[aqocea]Shadow,2528,550,20,24,44,45.5%,36m
9504,1,[TTKOPF]Blitztod,2528,124,5,11,16,31.2%,1h
9504,2,NEuRoM,2528,58,3,2,5,60.0%,1h
9504,1,Elements,2528,70,2,10,12,16.7%,1h
9504,1,[CLOWNF]FreeArtsakh,2528,0,1,3,4,25.0%,1h
9511,1,[LMI42]ham,2527,1544,104,110,214,48.6%,17m
9511,2,[DVHSC]RATMATAZZ,2527,1133,64,56,120,53.3%,52m
9511,2,manh,2527,465,20,14,34,58.8%,1h
9511,2,Tactician,2527,343,14,10,24,58.3%,1h
9511,2,Petee,2527,246,8,36,44,18.2%,34m
9511,2,AydahBR,2527,186,6,7,13,46.2%,1h
9511,2,Korfuffle,2527,180,5,11,16,31.2%,40m
9511,3,[GOPERÚ]Alan,2527,0,1,0,1,100.0%,42m
9519,2,Tyrissa,2526,1064,38,48,86,44.2%,54m
9519,2,grannit,2526,806,37,25,62,59.7%,1h
9519,1,[INKED]Arka,2526,1076,37,43,80,46.2%,29m
9519,2,lima,2526,553,24,21,45,53.3%,36m
9519,2,[40T]Synergy,2526,362,13,10,23,56.5%,1h
9519,1,[buttts]DJStinkyButt,2526,198,6,10,16,37.5%,9m
9519,1,Dorgis,2526,108,5,8,13,38.5%,3h
9519,2,CaptainSiek,2526,111,4,7,11,36.4%,1h
9519,3,Spartacus,2526,62,2,8,10,20.0%,42m
9519,2,RAWR,2526,0,1,0,1,100.0%,1h
9519,2,DMT,2526,0,0,2,2,0.0%,53m
9530,2,SteveS,2525,1518,189,173,362,52.2%,3h
9530,2,sNaiL,2525,721,30,29,59,50.8%,32m
9530,2,Alex,2525,576,28,10,38,73.7%,16m
9530,2,[MUGI]TimERTy,2525,500,18,19,37,48.6%,36m
9530,2,sakatoma,2525,397,16,10,26,61.5%,1h
9530,1,Higuma,2525,416,12,24,36,33.3%,1h
9530,2,TheEpicOne,2525,326,11,10,21,52.4%,37m
9530,1,[iTE]DaWarrior,2525,202,7,9,16,43.8%,18m
9530,3,MinscBoo,2525,120,6,10,16,37.5%,32m
9530,2,WuhanPeople,2525,170,5,8,13,38.5%,1h
9530,2,[ZTemp]Chesshire,2525,140,3,3,6,50.0%,36m
9530,1,Danaku,2525,0,2,3,5,40.0%,1h
9530,2,WErDNA,2525,64,2,4,6,33.3%,19m
9530,1,Deguel,2525,40,2,10,12,16.7%,1h
9530,1,Krush,2525,0,1,4,5,20.0%,3h
9530,2,PoSsYdOg,2525,0,0,1,1,0.0%,1h
9530,2,[p0w]FieryFractal,2525,0,0,4,4,0.0%,3h
9547,3,ParkinG,2524,1513,121,121,242,50.0%,16m
9547,1,DankCrank,2524,972,40,39,79,50.6%,12m
9547,1,PROTOSAURUS,2524,739,29,31,60,48.3%,1h
9547,2,Chey,2524,523,21,15,36,58.3%,4h
9547,2,[ROTFst]codenamez,2524,348,13,14,27,48.1%,34m
9547,2,banana,2524,206,7,6,13,53.8%,1h
9547,3,Pyruvat,2524,268,7,24,31,22.6%,41m
9547,2,[TSM88]JOHNANDBUDDY,2524,144,5,6,11,45.5%,52m
9547,2,SpaceTurd,2524,148,4,5,9,44.4%,3h
9547,1,Fragment,2524,95,2,0,2,100.0%,4h
9547,2,[HLP]LadyKnight,2524,0,1,0,1,100.0%,3h
9547,1,crash,2524,48,1,6,7,14.3%,3h
9559,3,BluExBoI,2523,892,70,70,140,50.0%,35m
9559,1,Darboux,2523,462,17,25,42,40.5%,1h
9559,2,[WNTRLY]aRsony,2523,154,8,3,11,72.7%,3h
9559,2,Shifter,2523,62,2,4,6,33.3%,18m
9559,2,VaJoNGas,2523,0,1,0,1,100.0%,1h
9564,2,[VGOsc2]Vertigo,2522,1176,97,92,189,51.3%,40m
9564,2,Erendira,2522,219,6,9,15,40.0%,1h
9564,1,biscuit,2522,190,6,9,15,40.0%,1h
9564,1,Losphoenix,2522,208,5,7,12,41.7%,52m
9564,2,Herbmann,2522,0,4,3,7,57.1%,1h
9564,2,SMOG,2522,30,3,5,8,37.5%,47m
9564,1,[MCLRSN]MichaelRosen,2522,0,2,3,5,40.0%,8m
9564,3,RadioBreath,2522,0,2,4,6,33.3%,45m
9564,2,NoInnovation,2522,32,1,3,4,25.0%,3m
9564,2,RamseySkyFly,2522,0,0,3,3,0.0%,4h
9564,2,[NXLsc]CrimsonAA,2522,0,0,4,4,0.0%,1h
9575,3,vivi,2521,1541,412,407,819,50.3%,10m
9575,2,lugia,2521,288,11,5,16,68.8%,3h
9575,2,[InstaF]AtNano,2521,193,8,8,16,50.0%,1h
9575,2,MagicTerran,2521,191,6,9,15,40.0%,3h
9575,3,bingu,2521,58,4,8,12,33.3%,11m
9575,2,MajorlyGamin,2521,92,3,8,11,27.3%,49m
9575,2,DarkLyord,2521,0,1,1,2,50.0%,7m
9575,1,BTPaladin,2521,0,0,1,1,0.0%,1h
9583,3,Machine,2520,1117,46,38,84,54.8%,45m
9583,2,[VFam]ChateeZy,2520,473,14,41,55,25.5%,39m
9583,2,wuhanjiayou,2520,373,13,12,25,52.0%,1h
9583,1,XvaT,2520,253,9,11,20,45.0%,1h
9583,3,QiaoMaMa,2520,182,5,1,6,83.3%,33m
9583,2,[HSiYA]Royis,2520,44,1,2,3,33.3%,3h
9583,3,Sceth,2520,0,0,1,1,0.0%,1h
9590,2,[TgAg]Flash,2519,600,35,5,40,87.5%,53m
9590,2,mna,2519,481,17,18,35,48.6%,1h
9590,2,ZzZ,2519,128,10,4,14,71.4%,28m
9590,1,TheDevouring,2519,192,8,9,17,47.1%,30m
9590,1,FireLord,2519,160,4,15,19,21.1%,11m
9590,3,SentaoDePana,2519,0,0,1,1,0.0%,1h
9590,2,SpacePirate,2519,0,0,2,2,0.0%,1h
9597,3,nachin,2518,1378,162,162,324,50.0%,46m
9597,2,willjog,2518,1262,145,160,305,47.5%,18m
9597,3,zero,2518,1080,54,65,119,45.4%,39m
9597,2,SpintheKotl,2518,413,19,8,27,70.4%,3m
9597,2,[Etfine]Drixenol,2518,213,7,2,9,77.8%,4m
9597,3,brunocpbrito,2518,119,2,7,9,22.2%,55m
9603,2,RatSlayer,2517,639,71,71,142,50.0%,1h
9603,1,BoogieMan,2517,722,22,32,54,40.7%,1h
9603,1,sketBURD,2517,128,5,8,13,38.5%,45m
9603,2,Halloween,2517,58,3,3,6,50.0%,1h
9603,3,shadow,2517,97,2,4,6,33.3%,1h
9603,1,Andy,2517,0,0,3,3,0.0%,7m
9609,1,GQBlue,2516,1608,212,208,420,50.5%,12m
9609,1,[KGH4]SirJohny,2516,805,31,30,61,50.8%,1h
9609,2,Lane,2516,707,28,24,52,53.8%,3h
9609,3,Rodolfinho,2516,576,23,19,42,54.8%,54m
9609,3,Kapis,2516,417,16,19,35,45.7%,1h
9609,3,AshyLarry,2516,302,10,6,16,62.5%,51m
9609,2,GrimDuke,2516,299,10,8,18,55.6%,17m
9609,1,zach,2516,97,5,6,11,45.5%,3h
9609,3,KIRITO,2516,90,3,3,6,50.0%,3h
9609,2,ZoidMeow,2516,60,2,4,6,33.3%,42m
9609,3,Gygy,2516,0,1,0,1,100.0%,54m
9609,3,ProtossFS,2516,0,1,0,1,100.0%,5m
9609,2,[BERTA]Burster,2516,30,1,21,22,4.5%,37m
9609,3,Axe,2516,0,0,1,1,0.0%,42m
9609,2,[Rushms]orangeroll,2516,0,0,2,2,0.0%,3h
9624,2,[zxczx]Eclipse,2515,1260,90,78,168,53.6%,1h
9624,2,[SCGals]Karen,2515,492,65,53,118,55.1%,3h
9624,1,Jester,2515,669,43,49,92,46.7%,14m
9624,1,Cassa,2515,568,25,15,40,62.5%,22m
9624,3,CrowOfLight,2515,608,23,16,39,59.0%,10m
9624,2,KingKenny,2515,214,6,6,12,50.0%,1h
9624,3,Fareoh,2515,58,3,5,8,37.5%,28m
9624,2,[DNKCFT]KneckandNeck,2515,88,2,1,3,66.7%,1h
9624,3,[DaFew]arcangel,2515,0,1,0,1,100.0%,18m
9624,3,dbhamster,2515,0,0,2,2,0.0%,24m
9624,2,Maximus,2515,0,0,3,3,0.0%,1h
9635,1,[DOVA]Wolf,2514,1594,138,140,278,49.6%,1h
9635,1,Pavel,2514,194,7,8,15,46.7%,43m
9635,2,[FCTR]Dokkisse,2514,0,3,5,8,37.5%,51m
9635,2,gabriel,2514,60,2,8,10,20.0%,13m
9635,3,darkdan,2514,0,1,0,1,100.0%,36m
9635,1,wacko,2514,0,0,5,5,0.0%,49m
9635,2,Thrawn,2514,0,0,5,5,0.0%,1h
9642,1,LoTengoChico,2513,593,19,24,43,44.2%,39m
9642,3,[HCFSC]Tignok,2513,145,4,2,6,66.7%,16m
9642,3,maicra,2513,48,3,2,5,60.0%,1h
9642,2,HARDWAR,2513,46,3,6,9,33.3%,6m
9642,3,Terrance,2513,60,2,2,4,50.0%,57m
9642,2,[nochee]Wolfe,2513,30,2,4,6,33.3%,5m
9642,2,[EZA]Minirobot,2513,62,2,7,9,22.2%,1h
9642,3,[iMECH]KolosS,2513,0,1,0,1,100.0%,25m
9642,2,[PVZ50]VodkaApple,2513,0,0,1,1,0.0%,39m
9642,3,[COAI]veryeasyAI,2513,0,0,2,2,0.0%,1h
9652,1,SATURNOvO,2512,959,44,42,86,51.2%,57m
9652,2,VaGmastRson,2512,126,3,3,6,50.0%,54m
9652,3,[SWMP]gavilan,2512,30,1,2,3,33.3%,1h
9652,3,CaptainPabst,2512,0,0,1,1,0.0%,1h
9652,3,torro,2512,0,0,1,1,0.0%,10m
9657,3,itros,2511,1537,77,69,146,52.7%,3h
9657,2,Wolf,2511,1243,74,80,154,48.1%,1h
9657,2,Ion,2511,191,6,6,12,50.0%,1h
9657,3,Yeldar,2511,121,3,5,8,37.5%,42m
9657,3,gudynator,2511,0,0,3,3,0.0%,3h
9662,1,Shamoa,2510,1639,139,123,262,53.1%,1h
9662,1,Abaddon,2510,1505,93,81,174,53.4%,3h
9662,2,BluExMamba,2510,1530,84,106,190,44.2%,33m
9662,1,exzplosive,2510,1480,59,61,120,49.2%,1h
9662,2,fluff,2510,557,22,18,40,55.0%,1h
9662,1,Herglotz,2510,154,7,6,13,53.8%,51m
9662,2,[L4Life]Threeppholes,2510,143,5,2,7,71.4%,3h
9662,2,lIlIIllIIIIl,2510,30,3,5,8,37.5%,18m
9662,3,matareynor,2510,0,1,0,1,100.0%,1h
9662,3,mommymilkers,2510,0,0,1,1,0.0%,6m
9662,3,[AbcCo]xXMelvinGVXx,2510,0,0,1,1,0.0%,1h
9673,1,Jake,2509,1491,58,59,117,49.6%,1h
9673,2,djt,2509,809,44,38,82,53.7%,19m
9673,2,Kyle,2509,708,28,27,55,50.9%,1h
9673,3,Darvein,2509,148,5,4,9,55.6%,1h
9673,2,[GaaaSQ]marcelocheXD,2509,149,3,3,6,50.0%,3h
9673,2,EoS,2509,30,3,10,13,23.1%,32m
9673,2,Duni,2509,62,2,5,7,28.6%,3h
9673,2,[notBAD]TheDesertFox,2509,0,0,2,2,0.0%,3h
9681,2,Bulletproof,2508,1606,284,281,565,50.3%,39m
9681,1,joe,2508,1396,154,158,312,49.4%,1h
9681,1,[FLUFFS]KCHU,2508,1493,106,110,216,49.1%,14m
9681,1,VisibleIvan,2508,1190,55,61,116,47.4%,31m
9681,2,BlessedG,2508,428,15,18,33,45.5%,18m
9681,1,Fading,2508,322,14,14,28,50.0%,1h
9681,2,[BCBZ]Newton,2508,268,10,8,18,55.6%,46m
9681,2,[missA]FuhCough,2508,0,4,4,8,50.0%,1h
9681,3,Micfetzer,2508,0,0,1,1,0.0%,29m
9690,2,Himsky,2507,1621,192,173,365,52.6%,3h
9690,3,[DoRQ]Ripley,2507,914,34,38,72,47.2%,39m
9690,2,[GSP0T]FREON,2507,112,7,7,14,50.0%,1h
9690,1,lee,2507,230,6,9,15,40.0%,1h
9690,1,[Sooner]Chanh,2507,177,6,10,16,37.5%,40m
9690,3,CommunistAK,2507,183,5,1,6,83.3%,4m
9690,2,Bob,2507,86,4,4,8,50.0%,1h
9697,1,MENGSK,2506,1554,87,82,169,51.5%,1h
9697,2,Tslack,2506,283,11,7,18,61.1%,3h
9697,2,[TY4GG]Crisps,2506,266,9,8,17,52.9%,1h
9697,2,BdubzThaG,2506,231,5,6,11,45.5%,1h
9697,2,Poncho,2506,58,3,3,6,50.0%,3h
9697,3,dethBySnuSnu,2506,30,2,0,2,100.0%,5m
9697,3,[IGeaL]repanpan,2506,123,2,2,4,50.0%,51m
9697,3,GamerGamer,2506,97,1,1,2,50.0%,45m
9705,3,[Pharoh]MadeInCanada,2505,1541,474,468,942,50.3%,36m
9705,1,Bambi,2505,121,14,18,32,43.8%,40m
9705,3,[C43]spacewalker,2505,162,6,5,11,54.5%,3m
9705,2,naive,2505,184,6,11,17,35.3%,40m
9705,3,[Exper]JuanPlatanit,2505,30,2,0,2,100.0%,1h
9705,3,[UltraX]CombatWombat,2505,0,1,0,1,100.0%,4h
9705,1,ODS,2505,0,1,7,8,12.5%,1h
9712,1,mandalf,2504,1317,75,79,154,48.7%,46m
9712,3,akaRip,2504,301,15,12,27,55.6%,1h
9712,1,slippycat,2504,422,14,19,33,42.4%,1h
9712,1,Hauntedmist,2504,260,7,8,15,46.7%,35m
9712,3,Botswaa,2504,120,3,10,13,23.1%,49m
9712,1,Dannydorito,2504,0,2,3,5,40.0%,4h
9712,2,[G4M3R5]Jaydogs,2504,0,0,2,2,0.0%,3h
9719,2,[dtwist]SwampyTaint,2503,912,56,41,97,57.7%,3h
9719,1,alexspach,2503,777,27,32,59,45.8%,1h
9719,1,Chloe,2503,287,12,15,27,44.4%,1h
9719,3,[Pharoh]oof,2503,88,4,1,5,80.0%,1h
9719,2,themightysac,2503,112,4,6,10,40.0%,46m
9719,1,CEleven,2503,74,4,7,11,36.4%,1h
9719,3,WIZVENGEANCE,2503,153,3,1,4,75.0%,44m
9726,1,Adonis,2502,784,42,45,87,48.3%,37m
9726,3,Guuuusfraba,2502,759,38,51,89,42.7%,50m
9726,1,[Z4RA]YoucefM,2502,491,17,16,33,51.5%,3h
9726,2,FerHIM,2502,243,10,15,25,40.0%,1h
9726,1,WarlordX,2502,195,7,9,16,43.8%,4h
9726,2,debellum,2502,117,4,6,10,40.0%,1h
9726,2,[FFAA]EthanR,2502,102,3,1,4,75.0%,42m
9726,2,Vampyreq,2502,68,2,25,27,7.4%,34m
9726,2,[ZOOMOB]KingZoot,2502,0,1,0,1,100.0%,3h
9726,3,[KDST]Grappler,2502,0,0,1,1,0.0%,4h
9736,2,lluckyday,2501,1454,85,87,172,49.4%,1h
9736,2,Chiron,2501,294,12,13,25,48.0%,1h
9736,2,BlackKnight,2501,189,6,4,10,60.0%,3h
9736,1,SneakyPete,2501,141,5,7,12,41.7%,1h
9736,1,NivixParadox,2501,112,4,12,16,25.0%,46m
9736,3,Geir,2501,30,2,2,4,50.0%,1h
9742,3,GideonKing,2500,445,18,20,38,47.4%,43m
9742,2,Zerallamvuut,2500,88,15,13,28,53.6%,1h
9742,3,[tsmph]Spencer,2500,202,7,8,15,46.7%,1h
9742,3,[FEEKAL]BanjoMan,2500,116,5,1,6,83.3%,16m
9742,2,Krondizlkork,2500,130,2,5,7,28.6%,46m
9742,3,CbEk,2500,0,1,0,1,100.0%,58m
9742,3,Suyeon,2500,0,0,3,3,0.0%,1h
9749,2,ColonelW,2499,1316,69,19,88,78.4%,20m
9749,2,dango,2499,455,19,18,37,51.4%,42m
9749,2,Kevin,2499,300,14,14,28,50.0%,1h
9749,2,Batu,2499,44,5,5,10,50.0%,1h
9749,2,NEWT,2499,164,4,5,9,44.4%,1h
9749,3,youGotREKT,2499,0,2,3,5,40.0%,1h
9749,2,TupaC,2499,0,1,0,1,100.0%,1h
9749,3,[DXPCA]Grraywarrior,2499,0,1,0,1,100.0%,36m
9749,2,[DSKLRS]PartEMan,2499,0,1,1,2,50.0%,47m
9749,3,Pwnalicious,2499,0,0,1,1,0.0%,1h
9759,2,BarnDog,2498,744,83,75,158,52.5%,1h
9759,1,hepeto,2498,1396,48,61,109,44.0%,31m
9759,2,[Mataco]Yorick,2498,990,37,39,76,48.7%,1h
9759,1,Nutpot,2498,551,20,23,43,46.5%,1h
9759,2,Rebel,2498,530,19,14,33,57.6%,1h
9759,2,[FatMom]Jason,2498,388,15,11,26,57.7%,13m
9759,2,Pnuemonia,2498,342,14,21,35,40.0%,5m
9759,1,cosadebene,2498,438,14,23,37,37.8%,1h
9759,2,cyh,2498,266,9,14,23,39.1%,1h
9759,2,[GGMESP]SilverHawk,2498,184,6,8,14,42.9%,3h
9759,2,pernalonga,2498,216,6,9,15,40.0%,3h
9759,3,Biggy,2498,208,6,10,16,37.5%,59m
9759,3,Lolis,2498,0,4,3,7,57.1%,53m
9759,3,[Mlol]Nane,2498,86,3,4,7,42.9%,1h
9759,3,Roughriders,2498,119,3,4,7,42.9%,1h
9759,1,[SWOU]SnoopyCat,2498,0,1,10,11,9.1%,1h
9775,3,Grrrr,2497,815,32,20,52,61.5%,1h
9775,1,TuToyerLCiel,2497,48,4,2,6,66.7%,1h
9775,2,MILFHunter,2497,30,3,5,8,37.5%,40m
9775,3,ZmanZimms,2497,30,1,2,3,33.3%,58m
9775,3,Alec,2497,0,0,1,1,0.0%,1h
9775,1,misterpipol,2497,0,0,5,5,0.0%,15m
9781,1,[DoVOID]madkorean,2496,1378,138,120,258,53.5%,12m
9781,2,BARCODE,2496,445,21,35,56,37.5%,36m
9781,2,momofuku,2496,145,6,7,13,46.2%,1h
9781,1,TreaSurE,2496,0,2,3,5,40.0%,3h
9781,3,DAMOCLES,2496,0,1,0,1,100.0%,1h
9781,3,[AkNi]NicKracken,2496,0,1,0,1,100.0%,38m
9781,3,BubbaFet,2496,30,1,1,2,50.0%,51m
9781,3,Aiolia,2496,0,0,1,1,0.0%,3h
9781,2,Maximus,2496,0,0,2,2,0.0%,1h
9790,1,spaceman,2495,709,28,20,48,58.3%,54m
9790,2,KINGDANK,2495,207,8,3,11,72.7%,1h
9790,2,Selrahc,2495,178,4,11,15,26.7%,3h
9793,1,Dave,2494,1636,142,139,281,50.5%,13m
9793,3,[Spain]frankk,2494,1304,45,56,101,44.6%,17m
9793,2,JackDupp,2494,553,22,24,46,47.8%,57m
9793,2,Saitama,2494,300,13,12,25,52.0%,42m
9793,1,Nate,2494,337,11,22,33,33.3%,13m
9793,3,[xTWx]Attilles,2494,233,7,2,9,77.8%,21m
9793,2,Eliiitz,2494,166,6,11,17,35.3%,1h
9793,2,Jackson,2494,122,6,12,18,33.3%,1h
9793,2,Penguin,2494,102,3,5,8,37.5%,53m
9793,3,drenoir,2494,106,2,1,3,66.7%,1h
9793,1,Etheros,2494,0,0,3,3,0.0%,3h
9804,2,Evilworld,2493,610,31,30,61,50.8%,5m
9804,1,Falaciosone,2493,320,10,20,30,33.3%,1h
9804,1,Emprorpinapl,2493,235,9,11,20,45.0%,40m
9804,3,Gonja,2493,198,8,5,13,61.5%,27m
9804,1,CompuJoby,2493,250,6,11,17,35.3%,1h
9804,2,[GRUMEC]edgeabc,2493,258,6,14,20,30.0%,1h
9804,3,lebaron,2493,114,4,2,6,66.7%,1h
9804,3,Neederlander,2493,88,3,2,5,60.0%,1h
9804,3,[0AAA1]Dragunov,2493,60,2,3,5,40.0%,1h
9804,3,[LgnTDS]yumRiCExP,2493,0,1,0,1,100.0%,1h
9804,1,WhistlerMTB,2493,0,0,1,1,0.0%,1h
9815,2,[DhZAc1]Seven,2492,987,37,36,73,50.7%,3h
9815,2,CptFalcon,2492,708,24,27,51,47.1%,6m
9815,2,CHIMICHURRI,2492,544,19,34,53,35.8%,50m
9815,2,[DkVb]DTCory,2492,30,4,4,8,50.0%,17m
9815,1,Predator,2492,120,2,5,7,28.6%,3h
9815,3,NidhogGG,2492,30,1,5,6,16.7%,4h
9815,3,RichardButte,2492,0,0,1,1,0.0%,3h
9815,3,BreakinEDCs,2492,0,0,2,2,0.0%,1h
9823,3,cold,2491,256,9,7,16,56.2%,32m
9823,3,TTVMathew,2491,86,4,3,7,57.1%,22m
9823,3,wilber,2491,121,3,2,5,60.0%,1h
9823,3,RJrulesSF,2491,0,2,3,5,40.0%,1h
9823,2,perustyle,2491,0,2,4,6,33.3%,3h
9823,2,LikeABox,2491,88,1,3,4,25.0%,4h
9823,2,[ccbi]Miklul,2491,0,0,2,2,0.0%,3h
9823,1,Ashijo,2491,0,0,5,5,0.0%,33m
9831,2,kaid,2490,216,10,9,19,52.6%,1h
9831,2,JamaisVu,2490,128,5,6,11,45.5%,1h
9831,2,Ghost,2490,126,4,9,13,30.8%,3m
9831,2,Noobler,2490,0,2,4,6,33.3%,1h
9831,3,[m0ld]ADHD,2490,97,1,2,3,33.3%,59m
9831,2,Kinves,2490,0,0,1,1,0.0%,23m
9831,3,ArchonSmash,2490,0,0,1,1,0.0%,39m
9831,2,JaggerJack,2490,0,0,2,2,0.0%,6m
9831,3,JohnyDaMylla,2490,0,0,3,3,0.0%,30m
9840,2,Buck,2489,249,11,14,25,44.0%,5m
9840,1,[SkAL]Manafiend,2489,278,8,8,16,50.0%,1h
9840,2,kaveziya,2489,180,6,10,16,37.5%,1h
9840,2,[KhanZ]JoshuaOliver,2489,120,4,7,11,36.4%,3h
9840,3,Heresy,2489,124,3,6,9,33.3%,1h
9840,2,REDvBLUE,2489,30,1,4,5,20.0%,1h
9846,1,Hiroshneeb,2488,1435,220,220,440,50.0%,46m
9846,1,VoxelKeely,2488,1206,68,79,147,46.3%,25m
9846,2,[AlIin]Kartoffel,2488,609,37,33,70,52.9%,1h
9846,3,Balalaika,2488,711,34,13,47,72.3%,1h
9846,1,[Boboyz]spacerandy,2488,882,32,35,67,47.8%,1h
9846,1,TheBoomer,2488,404,17,6,23,73.9%,3h
9846,1,MWFriesen,2488,286,11,12,23,47.8%,1h
9846,1,[guest]Megatsunami,2488,360,11,20,31,35.5%,57m
9846,2,PolyPslinger,2488,160,6,12,18,33.3%,3h
9846,3,RAMmyTB,2488,86,4,5,9,44.4%,1h
9846,1,Goldsound,2488,114,4,7,11,36.4%,1h
9846,3,[NM8]Maximilian,2488,0,2,3,5,40.0%,20m
9846,1,[TZOOB]Duckyson,2488,140,2,3,5,40.0%,1h
9846,1,[TNTW]Xevicon,2488,48,2,4,6,33.3%,1h
9846,2,BIGvince,2488,0,2,4,6,33.3%,13m
9846,3,[UpxV]angel,2488,123,2,5,7,28.6%,6m
9846,3,JimDogMeyer,2488,30,1,2,3,33.3%,3h
9846,3,PznSensation,2488,0,1,4,5,20.0%,1h
9846,3,CptComeback,2488,0,0,1,1,0.0%,1h
9865,3,INVESTEDT,2487,951,44,26,70,62.9%,12m
9865,1,IIIIIIIIIIII,2487,230,20,24,44,45.5%,3h
9865,3,ericdraven,2487,121,3,5,8,37.5%,1h
9865,3,GLHF,2487,0,0,1,1,0.0%,21m
9865,3,Barin,2487,0,0,2,2,0.0%,8m
9865,2,Songoo,2487,0,0,3,3,0.0%,39m
9865,2,[FCBM]xPOSEIDONx,2487,0,0,5,5,0.0%,1h
9872,2,Gomer,2486,905,45,38,83,54.2%,3h
9872,1,Dominator,2486,632,21,31,52,40.4%,1h
9872,2,Woundem,2486,335,14,12,26,53.8%,17m
9872,2,[JGG]ishatmypants,2486,206,7,9,16,43.8%,1h
9872,3,IlIlIlIlIlIl,2486,247,7,17,24,29.2%,45m
9872,2,theburrito,2486,0,1,1,2,50.0%,17m
9872,3,[PTHero]Strygwyr,2486,30,1,3,4,25.0%,1h
9879,3,Lem,2485,657,24,23,47,51.1%,1h
9879,1,MutantCookie,2485,588,23,24,47,48.9%,31m
9879,2,[SlPo]AlexJ,2485,412,14,19,33,42.4%,6m
9879,2,RubberDucky,2485,276,9,12,21,42.9%,1h
9879,3,[GnR]Hawkmoon,2485,30,2,0,2,100.0%,44m
9884,2,lolenricoxd,2484,365,17,15,32,53.1%,32m
9884,1,neonfighter,2484,271,9,10,19,47.4%,1h
9884,3,ActualDeath,2484,58,2,2,4,50.0%,1h
9884,3,Dahn,2484,0,1,0,1,100.0%,20m
9884,3,ESLAyed,2484,0,1,0,1,100.0%,33m
9884,3,[Linked]Jiyon,2484,0,0,1,1,0.0%,32m
9884,3,GrovePark,2484,0,0,2,2,0.0%,1h
9891,3,luisenano,2483,530,20,15,35,57.1%,1h
9891,1,OneBadZerg,2483,322,12,15,27,44.4%,31m
9891,1,[G0R3]lala,2483,284,9,4,13,69.2%,40m
9891,3,[MP1]Gupu,2483,114,4,5,9,44.4%,1h
9891,3,flanyer,2483,40,3,6,9,33.3%,24m
9891,3,kswebster,2483,60,2,4,6,33.3%,40m
9891,3,welol,2483,0,2,4,6,33.3%,3h
9891,1,CodyiakBear,2483,0,1,0,1,100.0%,1h
9891,1,RPepez,2483,46,1,2,3,33.3%,3h
9891,2,Given,2483,0,1,2,3,33.3%,1h
9891,2,Planchet,2483,0,1,5,6,16.7%,1h
9891,3,zedd,2483,0,0,1,1,0.0%,1h
9903,3,smEga,2482,973,36,44,80,45.0%,17m
9903,3,maxsp,2482,330,13,16,29,44.8%,20m
9903,1,DukeNukem,2482,184,7,10,17,41.2%,1h
9903,3,adfshsjhds,2482,86,4,2,6,66.7%,1h
9903,3,[FyHr]Takaro,2482,30,2,1,3,66.7%,1h
9903,3,[IMl]Cruise,2482,0,2,3,5,40.0%,1h
9903,3,Blackknightt,2482,0,2,4,6,33.3%,58m
9903,2,Salem,2482,0,1,0,1,100.0%,3h
9903,3,Tkong,2482,0,0,1,1,0.0%,28m
9912,3,[VFam]Fury,2481,999,37,35,72,51.4%,1h
9912,1,tim,2481,646,21,28,49,42.9%,1h
9912,2,Duke,2481,405,18,8,26,69.2%,1h
9912,2,Casino,2481,470,17,23,40,42.5%,1h
9912,2,Papucho,2481,210,9,8,17,52.9%,1h
9912,3,[uDuh]XpermentorX,2481,218,6,3,9,66.7%,11m
9912,2,[Chotus]Hope,2481,118,5,8,13,38.5%,52m
9912,3,Bromosapien,2481,58,3,1,4,75.0%,27m
9912,2,zerg,2481,137,3,7,10,30.0%,3h
9912,2,Wakata,2481,30,2,4,6,33.3%,3h
9912,3,SirMarc,2481,0,1,0,1,100.0%,1h
9912,2,Lacey,2481,94,1,3,4,25.0%,1h
9912,3,Varum,2481,0,0,1,1,0.0%,1h
9912,3,Deaffin,2481,0,0,1,1,0.0%,15m
9912,3,ninjarobot,2481,0,0,2,2,0.0%,1h
9927,3,ChilenoSinga,2480,1271,50,52,102,49.0%,3m
9927,1,WOLLKATZE,2480,427,17,21,38,44.7%,1h
9927,3,PoKa,2480,376,15,11,26,57.7%,60m
9927,3,[Atira]Atira,2480,263,8,5,13,61.5%,29m
9927,3,[LAGGT]Minimi,2480,58,3,0,3,100.0%,60m
9927,1,[TaPX]EqUiLlIbRiUm,2480,30,3,6,9,33.3%,49m
9927,2,Grabthroat,2480,112,2,4,6,33.3%,1h
9927,3,iyc,2480,0,1,4,5,20.0%,28m
9927,1,Bamos,2480,46,1,7,8,12.5%,16m
9927,3,iffysolution,2480,0,0,1,1,0.0%,1h
9927,3,Madjack,2480,0,0,1,1,0.0%,10m
9938,3,[Sc2F]ToaFolks,2479,961,38,31,69,55.1%,20m
9938,1,Triggered,2479,276,9,12,21,42.9%,1h
9938,3,lmMike,2479,58,6,8,14,42.9%,50m
9938,2,whatupchuck,2479,8,6,9,15,40.0%,3h
9938,2,InstincT,2479,94,4,9,13,30.8%,18m
9938,3,Psinstein,2479,86,3,2,5,60.0%,1h
9938,3,[weedz]DrThong,2479,96,2,3,5,40.0%,54m
9938,1,Greg,2479,36,2,4,6,33.3%,4h
9938,3,GeneralJJ,2479,0,1,0,1,100.0%,1h
9938,3,[Cind3r]smirnoft,2479,0,1,0,1,100.0%,44m
9938,2,KillerClown,2479,30,1,5,6,16.7%,3h
9949,3,TheSpiritFox,2478,1611,449,441,890,50.4%,1h
9949,3,PhamNuwen,2478,478,79,74,153,51.6%,21m
9949,1,Frontalier,2478,568,26,26,52,50.0%,1h
9949,3,juuse,2478,195,7,11,18,38.9%,43m
9949,3,Sunkist,2478,121,2,2,4,50.0%,59m
9949,3,Donut,2478,0,2,3,5,40.0%,6m
9949,3,NoahTerve,2478,0,2,5,7,28.6%,1h
9949,3,Chadow,2478,0,0,1,1,0.0%,3h
9957,3,ClownFiesta,2477,926,38,42,80,47.5%,17m
9957,2,XaviSavi,2477,301,11,13,24,45.8%,1h
9957,2,NoMirrorGame,2477,220,8,12,20,40.0%,1h
9957,2,[Ikeb]turbo,2477,118,5,6,11,45.5%,1h
9957,2,[QA]Shenpa,2477,120,4,8,12,33.3%,1h
9957,2,Keamon,2477,132,3,2,5,60.0%,10m
9957,2,Hammer,2477,30,3,4,7,42.9%,30m
9957,3,[DvaRKA]Zerral,2477,34,2,0,2,100.0%,31m
9957,3,LemonMule,2477,0,2,3,5,40.0%,10m
9957,2,isythebeast,2477,44,2,4,6,33.3%,13m
9967,2,poupousensei,2476,1585,246,237,483,50.9%,1h
9967,1,[HILLS]Vauban,2476,1617,156,158,314,49.7%,19m
9967,3,rammingspeed,2476,1346,54,64,118,45.8%,36m
9967,2,kbcitas,2476,514,17,22,39,43.6%,1h
9967,2,OldSock,2476,360,15,13,28,53.6%,1h
9967,3,iambrocolli,2476,168,5,1,6,83.3%,3h
9973,2,AvtarChupito,2475,163,14,35,49,28.6%,12m
9973,2,[ffaaak]POKEMONMEN,2475,182,7,9,16,43.8%,27m
9973,3,Ivanhoe,2475,94,6,5,11,54.5%,47m
9973,3,BooMSelectA,2475,121,5,3,8,62.5%,1h
9973,3,juanxs,2475,118,2,3,5,40.0%,31m
9973,3,[AP3X]SevenFold,2475,0,1,1,2,50.0%,1h
9973,3,Nanology,2475,0,0,5,5,0.0%,33m
9980,3,TheBestfOu,2474,1396,60,50,110,54.5%,33m
9980,2,beeeeeeto,2474,1040,56,50,106,52.8%,52m
9980,3,AlphaRosa,2474,735,28,22,50,56.0%,1h
9980,2,Alfred,2474,308,10,18,28,35.7%,3h
9980,3,Devastador,2474,248,8,7,15,53.3%,29m
9980,3,CartelQc,2474,36,4,4,8,50.0%,3m
9980,3,RodolfoGuti,2474,58,3,3,6,50.0%,1h
9980,3,[Ash3s]Astroidflame,2474,80,2,4,6,33.3%,3m
9980,3,CaptainMarkk,2474,0,1,0,1,100.0%,42m
9989,1,[ZTemp]Chesshire,2473,350,11,20,31,35.5%,40m
9989,2,[Stigma]Akira,2473,80,3,7,10,30.0%,1h
9989,3,Avefenix,2473,95,2,1,3,66.7%,20m
9989,3,Fadilla,2473,0,1,2,3,33.3%,53m
9989,2,[bigFan]FruitDealer,2473,30,1,9,10,10.0%,3h
9989,1,DROWNALD,2473,0,0,1,1,0.0%,24m
9989,3,Skeletor,2473,0,0,5,5,0.0%,18m
9996,2,TaeKa,2472,1540,104,100,204,51.0%,1h
9996,2,joepunk,2472,294,101,103,204,49.5%,1h
9996,2,[a2M]BookWyrm,2472,1317,48,72,120,40.0%,6m
9996,3,ZZZ,2472,324,16,6,22,72.7%,30m
9996,2,Benji,2472,276,9,17,26,34.6%,1h
9996,1,Hawk,2472,236,8,14,22,36.4%,4h
9996,3,Troddler,2472,133,3,11,14,21.4%,53m
9996,1,[EffM]Tavis,2472,0,2,3,5,40.0%,1h
9996,3,DEMOLIDOR,2472,0,1,3,4,25.0%,48m
9996,3,Tarask,2472,0,1,5,6,16.7%,35m
9996,3,[PotE]Camzz,2472,0,0,1,1,0.0%,58m
9996,2,CompLEET,2472,0,0,2,2,0.0%,30m
10008,3,milkaholic,2471,1509,270,266,536,50.4%,48m
10008,1,Larip,2471,950,53,51,104,51.0%,10m
10008,2,Grandmaster,2471,390,15,12,27,55.6%,1h
10008,3,Vinyl,2471,372,13,13,26,50.0%,3h
10008,3,VictoriuzPRD,2471,0,3,3,6,50.0%,1h
10008,3,Crocop,2471,0,0,1,1,0.0%,28m
10014,2,BrickWiggles,2470,455,32,29,61,52.5%,4h
10014,2,Spud,2470,355,15,13,28,53.6%,17m
10014,3,[TY4GG]orientalboy,2470,182,5,6,11,45.5%,42m
10014,3,starliberty,2470,0,1,0,1,100.0%,50m
10014,3,[PTHero]LUCADEBOSS,2470,0,1,0,1,100.0%,32m
10014,3,Kosmic,2470,0,1,0,1,100.0%,3h
10014,3,Tigger,2470,0,1,4,5,20.0%,1h
10021,1,[QMM]CHICOBIZARRO,2469,1491,98,101,199,49.2%,57m
10021,3,viruz,2469,325,11,4,15,73.3%,38m
10021,1,KaptinBadruk,2469,255,10,12,22,45.5%,1h
10021,2,Yamser,2469,0,1,4,5,20.0%,1h
10025,2,MLGShreckDen,2468,700,208,198,406,51.2%,19m
10025,3,[MncsGG]Dinkelberg,2468,558,21,13,34,61.8%,1h
10025,3,Jaihen,2468,327,13,11,24,54.2%,30m
10025,1,Jonyshin,2468,298,11,19,30,36.7%,1h
10025,3,HardOffender,2468,205,5,5,10,50.0%,44m
10025,3,charmquark,2468,131,3,1,4,75.0%,1h
10025,3,Arrrrr,2468,121,3,5,8,37.5%,24m
10025,3,poobutt,2468,123,3,6,9,33.3%,11m
10025,3,[TGCrew]koszonom,2468,30,2,0,2,100.0%,44m
10025,3,[LSMR]Oberon,2468,0,1,0,1,100.0%,38m
10025,3,COFRAN,2468,0,1,0,1,100.0%,1h
10025,3,SergeantVang,2468,38,1,2,3,33.3%,27m
10025,3,UncleMagic,2468,0,1,2,3,33.3%,45m
10025,3,[FT5]BobbaGanuesh,2468,0,1,2,3,33.3%,3m
10025,2,TheLivingEnd,2468,30,1,7,8,12.5%,53m
10025,3,ElWeirdo,2468,0,0,1,1,0.0%,22m
10025,2,camu,2468,0,0,3,3,0.0%,39m
10025,1,Bazum,2468,0,0,4,4,0.0%,49m
10043,2,DirtyTWillis,2467,1236,45,45,90,50.0%,1h
10043,1,King,2467,460,19,16,35,54.3%,28m
10043,2,Rags,2467,167,5,5,10,50.0%,25m
10043,3,[PyTi]Kyzester,2467,0,2,3,5,40.0%,20m
10043,3,Destroyer,2467,30,1,3,4,25.0%,5m
10043,3,SemeR,2467,0,0,1,1,0.0%,3h
10049,3,FinnLockwood,2466,76,3,6,9,33.3%,1h
10049,1,Survival,2466,0,1,0,1,100.0%,1h
10049,2,IGD,2466,0,1,3,4,25.0%,3h
10052,3,Crazyhobo,2465,1371,58,49,107,54.2%,4h
10052,3,[TRR]ventfan,2465,1038,36,51,87,41.4%,39m
10052,3,CuteHusky,2465,654,24,33,57,42.1%,16m
10052,1,Yerkie,2465,353,15,24,39,38.5%,53m
10052,3,[Khalta]jose,2465,162,6,7,13,46.2%,58m
10052,2,CoffeeZone,2465,125,4,3,7,57.1%,3h
10052,3,deathtocraig,2465,120,2,4,6,33.3%,1h
10052,3,BreathUnseen,2465,0,0,1,1,0.0%,1h
10060,2,[4GH]thepatchman,2464,1255,43,59,102,42.2%,53m
10060,2,AtomBomb,2464,856,41,47,88,46.6%,37m
10060,3,[LY0]TheCareCuy,2464,272,10,3,13,76.9%,45m
10060,1,EatMyShorts,2464,48,4,3,7,57.1%,1h
10060,2,[SQWD]Earthbend,2464,80,4,8,12,33.3%,1h
10060,3,snaileye,2464,146,3,2,5,60.0%,1h
10060,1,Casstiel,2464,0,1,4,5,20.0%,3h
10067,1,Bonitao,2463,1224,143,136,279,51.3%,54m
10067,1,Faerie,2463,240,23,29,52,44.2%,3h
10067,2,Braynztorm,2463,504,18,18,36,50.0%,55m
10067,3,Comet,2463,118,4,3,7,57.1%,33m
10067,2,TheDrizzle,2463,112,4,5,9,44.4%,1h
10067,3,[Viola]Zyreath,2463,0,1,0,1,100.0%,44m
10067,3,Krugessin,2463,0,1,4,5,20.0%,1h
10067,3,[NM8]XcrixosX,2463,0,0,1,1,0.0%,10m
10075,2,Joe,2462,882,83,70,153,54.2%,3m
10075,3,[PiN0YS]Mithraic,2462,804,43,55,98,43.9%,38m
10075,1,Silverity,2462,847,31,40,71,43.7%,1h
10075,3,BITUCHO,2462,34,3,5,8,37.5%,44m
10075,3,clampKK,2462,30,2,0,2,100.0%,1h
10080,2,Stevius,2461,1569,62,68,130,47.7%,1h
10080,2,[6PR]Verantic,2461,572,23,20,43,53.5%,1h
10080,2,Zeratul,2461,252,12,6,18,66.7%,3h
10080,3,MostPeople,2461,0,2,5,7,28.6%,1h
10080,3,CNAF,2461,0,1,0,1,100.0%,30m
10080,3,AurA,2461,0,1,4,5,20.0%,1h
10086,2,rush,2460,1527,128,128,256,50.0%,1h
10086,1,jaf,2460,1140,58,62,120,48.3%,37m
10086,3,Ceed,2460,6,1,2,3,33.3%,1h
10086,3,mehmehmeh,2460,95,1,2,3,33.3%,16m
10086,3,BigDaddy,2460,0,0,1,1,0.0%,45m
10086,2,[ELNENE]Furan,2460,0,0,3,3,0.0%,33m
10092,2,enzo,2459,1568,92,90,182,50.5%,18m
10092,3,rui,2459,810,36,23,59,61.0%,60m
10092,3,XeroKuhl,2459,286,9,24,33,27.3%,39m
10092,3,russox,2459,0,1,0,1,100.0%,3h
10092,3,Borealis,2459,0,1,1,2,50.0%,1h
10092,3,MODOM,2459,0,1,1,2,50.0%,1h
10092,1,Sejun,2459,97,1,1,2,50.0%,8m
10092,2,stump,2459,30,1,5,6,16.7%,3h
10092,2,[WNSG]Araduun,2459,0,1,5,6,16.7%,3h
10092,3,SDMX,2459,0,0,1,1,0.0%,20m
10092,3,Scion,2459,0,0,1,1,0.0%,4h
10103,2,[PiGPan]HubbleWho,2458,436,15,23,38,39.5%,57m
10103,2,Psycho,2458,194,6,8,14,42.9%,3h
10103,2,AiON,2458,166,4,9,13,30.8%,3h
10103,1,billsybob,2458,165,3,8,11,27.3%,60m
10103,3,QESOconPAPA,2458,58,2,2,4,50.0%,1h
10103,3,Bobby,2458,0,1,1,2,50.0%,51m
10109,1,Paratrooper,2457,1415,90,93,183,49.2%,31m
10109,2,Gucci,2457,224,24,25,49,49.0%,52m
10109,2,Angel,2457,376,15,18,33,45.5%,55m
10109,2,Apostle,2457,113,8,14,22,36.4%,1h
10109,2,Westopoli,2457,208,7,8,15,46.7%,1h
10109,1,Orion,2457,0,3,2,5,60.0%,8m
10109,3,[Ak47s]Cheesenberg,2457,0,0,1,1,0.0%,1h
10109,2,[Sly]willzor,2457,0,0,3,3,0.0%,13m
10117,2,[suprtG]redvision,2456,1112,135,135,270,50.0%,19m
10117,2,CoolGameBro,2456,1447,57,61,118,48.3%,1h
10117,2,[PAWPAT]Bacteria,2456,1016,45,39,84,53.6%,3m
10117,3,CosmicTurtle,2456,394,14,16,30,46.7%,41m
10117,2,[latrom]Exothermic,2456,122,4,9,13,30.8%,13m
10117,2,DeceiT,2456,0,2,4,6,33.3%,3h
10117,3,KahlForPrez,2456,0,1,0,1,100.0%,1h
10117,1,Roach,2456,0,0,3,3,0.0%,58m
10125,3,JATAMA,2455,1165,73,67,140,52.1%,1h
10125,2,[ACSS]Petrocules,2455,884,40,49,89,44.9%,3h
10125,3,[DaPlug]leopshef,2455,341,27,21,48,56.2%,1h
10125,2,TRUMPWIN,2455,465,17,19,36,47.2%,3h
10125,2,[B1teMe]Harpa,2455,187,7,6,13,53.8%,3h
10125,2,[SkAL]holydiver,2455,200,7,6,13,53.8%,42m
10125,3,Hellig,2455,147,5,4,9,55.6%,11m
10125,3,jeanfes,2455,86,4,3,7,57.1%,22m
10125,3,Aviato,2455,0,2,5,7,28.6%,1h
10125,3,Sparticus,2455,0,1,0,1,100.0%,37m
10125,3,[REPORT]multiplyAU,2455,0,0,1,1,0.0%,1h
10125,2,[LOHs]ArMada,2455,0,0,4,4,0.0%,46m
10137,1,Gorrigan,2454,1256,111,100,211,52.6%,3h
10137,2,BigDaddy,2454,1588,79,81,160,49.4%,59m
10137,2,Law,2454,372,13,15,28,46.4%,1h
10137,3,daisy,2454,316,11,4,15,73.3%,1h
10137,2,LeeHarvey,2454,102,6,8,14,42.9%,52m
10137,3,KillerJoe,2454,30,5,5,10,50.0%,41m
10137,2,SCLSymbian,2454,186,5,7,12,41.7%,1h
10137,3,KungMarco,2454,130,3,5,8,37.5%,1h
10137,2,PRES,2454,58,2,6,8,25.0%,42m
10137,3,karankoron,2454,0,1,1,2,50.0%,30m
10137,3,[MRDPOT]DeathOmen,2454,0,1,1,2,50.0%,11m
10137,3,Madenlee,2454,0,1,1,2,50.0%,1h
10137,3,DDan,2454,0,1,4,5,20.0%,6m
10150,3,[cl0udM]KindOf,2453,181,5,1,6,83.3%,1h
10150,2,Dantor,2453,32,1,6,7,14.3%,18m
10150,3,BooM,2453,0,0,1,1,0.0%,31m
10150,2,phoenix,2453,0,0,1,1,0.0%,9m
10150,3,Kaelthalaz,2453,0,0,1,1,0.0%,1h
10155,1,Kiser,2452,1585,148,147,295,50.2%,31m
10155,2,NomadRusso,2452,552,114,125,239,47.7%,4h
10155,2,froztycat,2452,444,53,48,101,52.5%,1h
10155,2,Whipface,2452,456,18,18,36,50.0%,10m
10155,3,[85F]rainy,2452,347,16,16,32,50.0%,44m
10155,3,Lawlderp,2452,116,2,1,3,66.7%,8m
10155,2,Alex,2452,0,2,4,6,33.3%,47m
10155,3,[TR0L]Virus,2452,0,1,1,2,50.0%,3h
10163,3,SanVyrish,2451,217,10,4,14,71.4%,25m
10163,1,[OSCC]CaptGiantDik,2451,0,2,3,5,40.0%,3h
10163,2,MEGaboss,2451,0,2,4,6,33.3%,6m
10163,1,methodL,2451,58,2,5,7,28.6%,1h
10163,3,LukeSkywalkr,2451,0,1,0,1,100.0%,1h
10163,3,trompo,2451,0,1,0,1,100.0%,51m
10163,3,Brendaaan,2451,0,0,1,1,0.0%,1h
10170,1,UNOCHEESE,2450,765,43,38,81,53.1%,3h
10170,2,NotSoCrafty,2450,334,14,18,32,43.8%,1h
10170,2,Mohicha,2450,168,5,7,12,41.7%,3h
10170,3,[MZHS]AviloHAHAHA,2450,114,4,4,8,50.0%,60m
10170,3,[CHOG]CaptainRex,2450,0,3,2,5,60.0%,33m
10170,1,boredom,2450,109,3,6,9,33.3%,37m
10170,3,ryankrk,2450,30,2,0,2,100.0%,25m
10170,3,RLH,2450,58,2,3,5,40.0%,16m
10170,3,nako,2450,0,2,3,5,40.0%,57m
10170,3,Eon,2450,0,0,1,1,0.0%,3h
10180,3,alex,2449,666,55,48,103,53.4%,23m
10180,2,giansa,2449,1122,45,47,92,48.9%,1h
10180,2,ECLIPSAUN,2449,152,4,6,10,40.0%,19m
10180,1,toO,2449,104,4,12,16,25.0%,5m
10180,3,Skeixrya,2449,30,1,2,3,33.3%,3h
10185,2,Flophead,2448,345,13,19,32,40.6%,19m
10185,2,Nuke,2448,136,5,9,14,35.7%,4m
10185,2,Exodor,2448,198,5,10,15,33.3%,3h
10185,3,[M4SS1V]ITURTLEI,2448,0,0,1,1,0.0%,8m
10189,2,[0825]cptsparrow,2447,305,37,34,71,52.1%,13m
10189,3,Jose,2447,689,28,29,57,49.1%,8m
10189,2,[2ES]JayD,2447,658,25,28,53,47.2%,1h
10189,3,Rocky,2447,583,22,15,37,59.5%,8m
10189,3,chqis,2447,0,3,4,7,42.9%,3h
10189,2,salk,2447,132,2,4,6,33.3%,1h
10189,3,Nnine,2447,30,1,2,3,33.3%,38m
10189,3,ELGGNOMAS,2447,0,1,4,5,20.0%,3m
10189,3,GaJyT,2447,0,0,3,3,0.0%,1h
10189,3,[Ta130O]MindReaper,2447,0,0,3,3,0.0%,1h
10199,2,Andre,2446,1257,146,129,275,53.1%,1h
10199,3,[Export]Yulha,2446,663,43,36,79,54.4%,1h
10199,3,[JeZ]russelkiller,2446,116,5,7,12,41.7%,1h
10199,3,KIng,2446,92,4,3,7,57.1%,1h
10199,1,Marco,2446,36,4,6,10,40.0%,3h
10199,2,PollSed,2446,30,3,5,8,37.5%,30m
10205,2,LuckyPig,2445,502,75,64,139,54.0%,3h
10205,3,creyesk,2445,1058,41,37,78,52.6%,1h
10205,3,[GOPERÚ]JorgeMA,2445,481,24,20,44,54.5%,1h
10205,2,landsponge,2445,544,18,25,43,41.9%,1h
10205,3,nedsdead,2445,137,10,14,24,41.7%,22m
10205,3,hewmiri,2445,120,3,0,3,100.0%,1h
10205,3,ITzExort,2445,90,3,3,6,50.0%,32m
10205,3,[0LD3R]blitx,2445,60,3,3,6,50.0%,1h
10205,1,[IBIB]juggernaut,2445,0,2,4,6,33.3%,1h
10205,1,Heist,2445,0,1,0,1,100.0%,1h
10205,2,TheRaloMan,2445,0,0,1,1,0.0%,3h
10205,3,[StRaP]DeltronDon,2445,0,0,1,1,0.0%,1h
10217,3,[PO342]Toxic,2444,315,10,5,15,66.7%,1h
10217,2,Passionfruit,2444,301,10,10,20,50.0%,4m
10217,3,dhuangal,2444,0,4,1,5,80.0%,44m
10217,3,FiatLux,2444,86,4,3,7,57.1%,42m
10217,3,Hootenanny,2444,0,3,2,5,60.0%,3h
10217,3,diazz,2444,32,3,4,7,42.9%,21m
10217,2,CDIO,2444,0,2,9,11,18.2%,41m
10217,3,[diaman]takuH,2444,0,1,0,1,100.0%,42m
10225,3,TheWizard,2443,641,24,22,46,52.2%,25m
10225,3,Reedyseth,2443,114,8,11,19,42.1%,15m
10225,1,Anxienty,2443,157,6,10,16,37.5%,1h
10225,3,Jacky,2443,121,3,0,3,100.0%,58m
10225,3,[xDYEx]Spectre,2443,95,2,0,2,100.0%,1h
10225,1,VictorTM,2443,121,2,2,4,50.0%,25m
10225,3,[G79]Crayton,2443,0,1,1,2,50.0%,1h
10225,2,Talman,2443,0,1,2,3,33.3%,1h
10233,1,Solidsnake,2442,1537,123,136,259,47.5%,1h
10233,3,BronzeLegend,2442,219,8,6,14,57.1%,51m
10233,2,Broly,2442,193,8,10,18,44.4%,1h
10233,3,Loli,2442,161,3,3,6,50.0%,3h
10233,1,[NziS]ActualLenin,2442,0,2,3,5,40.0%,1h
10233,3,[IBB]nashface,2442,60,2,4,6,33.3%,1h
10233,3,Khuno,2442,0,1,2,3,33.3%,40m
10233,3,Ferg,2442,0,0,1,1,0.0%,3h
10241,3,poLycromatic,2441,763,88,79,167,52.7%,1h
10241,3,EdTheWin,2441,460,16,12,28,57.1%,1h
10241,3,Player,2441,358,13,16,29,44.8%,1h
10241,3,sherminatorr,2441,145,3,1,4,75.0%,60m
10241,3,Mavekashi,2441,58,3,2,5,60.0%,20m
10241,1,allolefort,2441,117,3,5,8,37.5%,51m
10241,3,QWERTY,2441,0,1,1,2,50.0%,3h
10241,3,SonzaX,2441,0,1,2,3,33.3%,17m
10241,3,Champion,2441,0,1,4,5,20.0%,12m
10250,1,herO,2440,874,266,351,617,43.1%,3h
10250,3,SuperShark,2440,1437,58,52,110,52.7%,11m
10250,3,[SCVM]NightKnight,2440,210,8,11,19,42.1%,23m
10250,1,tudios,2440,110,7,7,14,50.0%,4m
10250,2,AlcoEnforcer,2440,167,5,7,12,41.7%,37m
10250,3,[BucBim]Qwerty,2440,30,2,0,2,100.0%,51m
10250,3,Prax,2440,58,2,2,4,50.0%,1h
10250,1,MartR,2440,0,1,0,1,100.0%,23m
10250,3,Voltheart,2440,30,1,1,2,50.0%,1h
10250,3,Mexell,2440,0,0,2,2,0.0%,31m
10260,2,Bulloch,2439,1568,161,172,333,48.3%,10m
10260,2,BuyCrypto,2439,920,111,136,247,44.9%,46m
10260,3,[CFHfh]mvanucci,2439,424,17,11,28,60.7%,1h
10260,3,Demosthenes,2439,391,14,18,32,43.8%,59m
10260,3,Adventurer,2439,305,13,8,21,61.9%,36m
10260,2,HBSRETWBVER,2439,330,12,16,28,42.9%,1h
10260,2,Briareos,2439,244,10,13,23,43.5%,1h
10260,3,Lippy,2439,218,6,6,12,50.0%,1h
10260,1,Sleepingrock,2439,96,3,5,8,37.5%,15m
10260,3,TheGoldenKey,2439,0,1,0,1,100.0%,37m
10260,2,LocGnar,2439,88,1,5,6,16.7%,3h
10271,1,coaliz,2438,1576,144,148,292,49.3%,42m
10271,3,barcOde,2438,267,9,2,11,81.8%,1h
10271,2,epidemiK,2438,286,9,11,20,45.0%,1h
10271,1,Macua,2438,0,2,3,5,40.0%,1h
10271,3,Adgor,2438,0,1,4,5,20.0%,55m
10276,3,Beardo,2437,326,12,12,24,50.0%,1h
10276,3,RockMachine,2437,191,7,12,19,36.8%,41m
10276,3,XpertUltra,2437,211,6,10,16,37.5%,11m
10276,3,Scoobydoo,2437,97,3,4,7,42.9%,45m
10276,3,twentyone,2437,74,3,7,10,30.0%,16m
10276,1,Tycho,2437,48,2,4,6,33.3%,4h
10276,3,ALSC,2437,30,1,4,5,20.0%,10m
10283,3,[GRNDMA]Spaghett,2436,776,31,29,60,51.7%,59m
10283,3,Bonesetter,2436,408,14,13,27,51.9%,8m
10283,1,KRTizzle,2436,191,8,10,18,44.4%,3h
10283,3,Dave,2436,30,3,4,7,42.9%,1h
10283,3,SkoloVakarus,2436,60,2,4,6,33.3%,38m
10283,3,RandyBobandy,2436,117,2,4,6,33.3%,51m
10283,3,[x98]SevenOfNine,2436,30,1,3,4,25.0%,1h
10290,2,[TheVD]ZealousShad,2435,1048,90,95,185,48.6%,53m
10290,2,Dirtstick,2435,483,19,17,36,52.8%,1h
10290,3,[PL347]QuBuS,2435,342,15,8,23,65.2%,16m
10290,2,Xugo,2435,224,8,9,17,47.1%,1h
10290,2,[DGOW]TheSwitchoff,2435,0,4,4,8,50.0%,1h
10290,3,ixhatexjello,2435,122,4,6,10,40.0%,22m
10290,3,Elax,2435,32,2,1,3,66.7%,1h
10290,3,Zapwai,2435,0,1,1,2,50.0%,1h
10290,3,Rimctto,2435,30,1,3,4,25.0%,1h
10290,3,[NvM]Nexobituous,2435,30,1,4,5,20.0%,1h
10290,2,ScreenLooker,2435,0,0,1,1,0.0%,1h
10301,2,Angel,2434,259,18,19,37,48.6%,1h
10301,3,Geosensation,2434,309,12,14,26,46.2%,1h
10301,2,RaZeD,2434,271,8,16,24,33.3%,3h
10301,3,[ADDU]ZEuS,2434,60,3,3,6,50.0%,1h
10301,2,MOONSTONE,2434,0,2,5,7,28.6%,1h
10301,3,Kitt,2434,0,1,0,1,100.0%,3h
10301,2,Substance,2434,46,1,5,6,16.7%,57m
10308,2,ROst,2433,931,194,183,377,51.5%,3h
10308,1,ThickTurd,2433,1197,93,96,189,49.2%,3h
10308,3,Snyder,2433,717,28,21,49,57.1%,33m
10308,3,BenJAMMIN,2433,274,12,10,22,54.5%,45m
10308,3,ForevrADrone,2433,154,6,6,12,50.0%,60m
10308,3,Webear,2433,136,5,7,12,41.7%,55m
10308,3,Mydogsmia,2433,150,5,7,12,41.7%,1h
10308,3,[3Drs]rObOdOg,2433,157,4,6,10,40.0%,1h
10308,3,[spici]MassiveMike,2433,0,3,3,6,50.0%,1h
10308,3,xluisitox,2433,0,2,3,5,40.0%,1h
10318,2,[Zno]livenaut,2432,1260,95,101,196,48.5%,1h
10318,3,[ROUS]Jobba,2432,1083,49,55,104,47.1%,5m
10318,1,TheTool,2432,608,23,30,53,43.4%,1h
10318,2,NewSwiss,2432,214,8,12,20,40.0%,24m
10318,3,carlos,2432,94,3,5,8,37.5%,1h
10318,2,erosleda,2432,30,2,6,8,25.0%,1h
10318,3,redpill,2432,32,1,4,5,20.0%,1h
10318,1,Weezer,2432,0,0,3,3,0.0%,23m
10326,1,[SOG4E]SkinFlap,2431,1480,177,190,367,48.2%,1h
10326,3,AsKicker,2431,121,3,5,8,37.5%,1h
10326,1,[GUARA1]Leaffarr,2431,0,2,3,5,40.0%,4h
10329,3,[HNPro]Wolfy,2430,205,7,4,11,63.6%,1h
10329,2,zerling,2430,208,6,8,14,42.9%,1h
10329,3,brian,2430,150,5,6,11,45.5%,1h
10329,3,Itokawa,2430,36,2,1,3,66.7%,1h
10329,2,Firzen,2430,88,2,2,4,50.0%,51m
10329,3,[0dins]Dugrok,2430,30,1,3,4,25.0%,1h
10335,3,[SNICKL]WATERmouth,2429,704,30,22,52,57.7%,11m
10335,1,EiZoukhaso,2429,200,10,11,21,47.6%,4m
10335,2,audibledevil,2429,246,8,15,23,34.8%,1h
10335,2,Gammawatt,2429,193,5,5,10,50.0%,1h
10335,3,Newbatron,2429,92,3,8,11,27.3%,1h
10335,3,ZERGslayer,2429,30,3,8,11,27.3%,4m
10335,3,Honhe,2429,0,2,3,5,40.0%,28m
10335,3,ToucanStan,2429,0,1,0,1,100.0%,6m
10335,1,Welly,2429,0,0,4,4,0.0%,1h
10344,3,Highdra,2428,339,11,9,20,55.0%,1h
10344,3,[ecdn]Shaynk,2428,228,8,8,16,50.0%,1h
10344,2,Player,2428,204,8,9,17,47.1%,20m
10344,3,Atreides,2428,205,7,6,13,53.8%,45m
10344,2,Haxula,2428,0,2,4,6,33.3%,1h
10344,3,llllllllllll,2428,0,1,1,2,50.0%,57m
10344,3,Starchild,2428,30,1,2,3,33.3%,1h
10344,3,Souvenyr,2428,0,0,2,2,0.0%,1h
10352,2,[MOLES]JimRayger,2427,1081,147,146,293,50.2%,3m
10352,1,DarkDragon,2427,1081,99,99,198,50.0%,3h
10352,2,TimmyJ,2427,949,34,42,76,44.7%,39m
10352,2,StyleBender,2427,571,23,27,50,46.0%,1h
10352,2,SilkyJohnson,2427,367,22,14,36,61.1%,57m
10352,3,STEVE,2427,0,4,1,5,80.0%,25m
10352,1,OriOnO,2427,107,3,4,7,42.9%,1h
10352,2,[Enable]BoOYaz,2427,60,3,7,10,30.0%,1h
10352,3,berries,2427,30,2,3,5,40.0%,1h
10352,3,[Umizoo]BloodSparrow,2427,0,1,0,1,100.0%,1h
10352,3,[PDPGS]swordfish,2427,95,1,1,2,50.0%,33m
10363,2,[JUGOS]XELO,2426,1412,97,97,194,50.0%,17m
10363,3,[Wizerd]Jafar,2426,345,11,15,26,42.3%,1h
10363,3,[WP]bewhyou,2426,178,5,3,8,62.5%,1h
10363,3,cannabinoid,2426,97,1,1,2,50.0%,3h
10363,3,FoxADIO,2426,0,0,1,1,0.0%,1h
10368,3,GigaHertz,2425,1621,135,135,270,50.0%,1h
10368,2,RaithWrath,2425,715,64,51,115,55.7%,1h
10368,3,[LOHs]VashTzP,2425,329,12,11,23,52.2%,25m
10368,3,CAPA,2425,175,6,6,12,50.0%,1h
10368,3,[HOBOS]IIIIIIIIIIII,2425,120,4,7,11,36.4%,20m
10368,3,Church,2425,0,3,3,6,50.0%,1h
10368,3,AztecWarrior,2425,0,3,3,6,50.0%,11m
10368,1,Marles,2425,119,3,3,6,50.0%,1h
10376,1,[MDeS]CmPltLyShT,2424,425,54,60,114,47.4%,19m
10376,3,Priest,2424,121,3,1,4,75.0%,35m
10376,3,Satin,2424,30,2,3,5,40.0%,1h
10376,3,Purity,2424,0,1,0,1,100.0%,1h
10376,2,Merthos,2424,0,0,2,2,0.0%,31m
10376,3,Jimmaye,2424,0,0,3,3,0.0%,28m
10382,2,[Alzh]Flash,2423,598,25,27,52,48.1%,3h
10382,3,nicskywalker,2423,325,23,18,41,56.1%,20m
10382,3,[CPU1]SubSonic,2423,205,6,2,8,75.0%,3m
10382,2,Laxdragon,2423,137,5,5,10,50.0%,39m
10382,2,Invio,2423,162,5,8,13,38.5%,3h
10382,3,[EZkill]SpaceJanitor,2423,60,2,2,4,50.0%,45m
10382,1,luriel,2423,0,2,3,5,40.0%,1h
10389,2,Scruffy,2422,1566,251,243,494,50.8%,1h
10389,2,elextermina,2422,1465,142,141,283,50.2%,1h
10389,3,YOLOSWAGTRON,2422,593,24,20,44,54.5%,1h
10389,2,[Caza]Seven,2422,518,20,19,39,51.3%,1h
10389,2,PapaMidnight,2422,277,10,9,19,52.6%,1h
10389,3,Xuron,2422,218,10,15,25,40.0%,51m
10389,3,Vackio,2422,206,7,3,10,70.0%,5m
10389,3,[NM8]ACE,2422,60,3,3,6,50.0%,1h
10389,3,Coburn,2422,0,2,6,8,25.0%,32m
10398,2,[LoShay]Draiquin,2421,697,25,30,55,45.5%,39m
10398,3,mazoozoo,2421,345,13,13,26,50.0%,1h
10398,2,Sanitizer,2421,260,12,14,26,46.2%,1h
10398,3,JeezisShiva,2421,261,9,11,20,45.0%,1h
10398,1,Michael,2421,0,1,0,1,100.0%,1h
10398,3,[255]BitcoinIsBCH,2421,96,1,1,2,50.0%,1h
10398,3,Foxlain,2421,0,1,4,5,20.0%,1h
10398,3,Divinity,2421,0,0,2,2,0.0%,1h
10406,1,Idontknow,2420,378,13,21,34,38.2%,54m
10406,2,[VGss]knacXhibit,2420,0,3,3,6,50.0%,1h
10406,3,[GOPERÚ]DarkOtaku,2420,96,2,2,4,50.0%,36m
10406,3,Eagle,2420,30,2,3,5,40.0%,1h
10406,3,[KENT]TMoney,2420,0,0,1,1,0.0%,10m
10406,2,GuineaPiglet,2420,0,0,7,7,0.0%,1h
10412,3,[coI]AboveTheLaw,2419,501,1207,1727,2934,41.1%,38m
10412,2,bleep,2419,1367,117,113,230,50.9%,40m
10412,3,govnr,2419,938,114,89,203,56.2%,1h
10412,3,Ticheesy,2419,1152,43,45,88,48.9%,31m
10412,3,Underscore,2419,757,31,23,54,57.4%,32m
10412,2,ahsten,2419,563,30,19,49,61.2%,1h
10412,3,IkarosRT,2419,616,27,17,44,61.4%,1h
10412,3,TimSpin,2419,224,8,10,18,44.4%,60m
10412,3,[REPORT]Starzergian,2419,190,6,4,10,60.0%,1h
10412,3,Fuzzy,2419,133,6,5,11,54.5%,20m
10412,1,stotle,2419,204,6,11,17,35.3%,49m
10412,1,[Gaaaas]covidninteen,2419,96,5,4,9,55.6%,53m
10412,3,TiOTwo,2419,96,2,0,2,100.0%,1h
10412,3,InfstrGadget,2419,0,2,5,7,28.6%,5m
10412,3,LaBala,2419,0,1,0,1,100.0%,1h
10412,3,Foladan,2419,0,0,1,1,0.0%,10m
10412,3,RabbidLesbo,2419,0,0,1,1,0.0%,1h
10412,3,Imperator,2419,0,0,3,3,0.0%,38m
10430,2,jxb,2418,1570,209,214,423,49.4%,3h
10430,3,GnarFury,2418,1607,109,104,213,51.2%,29m
10430,3,roboticFunk,2418,272,18,18,36,50.0%,3h
10430,1,Freeman,2418,198,8,10,18,44.4%,1h
10430,3,[BNITOS]MilfHunter,2418,120,5,5,10,50.0%,1h
10430,3,Verth,2418,96,4,2,6,66.7%,11m
10430,3,[M0lST]MeatyFlaps,2418,118,2,1,3,66.7%,51m
10430,2,eldarion,2418,41,1,1,2,50.0%,23m
10438,2,neinthousand,2417,1605,227,225,452,50.2%,3h
10438,3,skytobal,2417,1569,118,101,219,53.9%,10m
10438,3,KingKush,2417,786,37,19,56,66.1%,1h
10438,3,retype,2417,978,36,40,76,47.4%,1h
10438,3,[MickyD]MacForBLT,2417,202,8,9,17,47.1%,1h
10438,3,illahfiend,2417,171,5,6,11,45.5%,5m
10438,1,LGMMaverik,2417,96,2,2,4,50.0%,39m
10438,1,francescusco,2417,0,1,0,1,100.0%,1h
10446,2,RequiemRust,2416,1270,123,127,250,49.2%,24m
10446,2,ARTANIS,2416,321,14,9,23,60.9%,1h
10446,3,[ShiPal]DrNexium,2416,246,9,11,20,45.0%,57m
10446,3,Eurik,2416,120,5,4,9,55.6%,3h
10446,3,[blub0i]Kirazoya,2416,134,4,2,6,66.7%,1h
10446,3,axel,2416,0,3,5,8,37.5%,16m
10446,3,Devastador,2416,0,1,0,1,100.0%,51m
10446,1,Homunculus,2416,0,1,4,5,20.0%,1h
10446,1,Bones,2416,0,1,4,5,20.0%,53m
10446,3,darkmerc,2416,0,0,1,1,0.0%,4h
10456,1,SGoodman,2415,1297,82,86,168,48.8%,13m
10456,3,Arjet,2415,811,44,38,82,53.7%,44m
10456,3,FiftyCal,2415,1098,42,41,83,50.6%,1h
10456,3,JackDanger,2415,850,33,69,102,32.4%,38m
10456,3,Noctrnal,2415,502,29,20,49,59.2%,3h
10456,3,Arvizo,2415,270,14,15,29,48.3%,1h
10456,3,Doophie,2415,203,5,7,12,41.7%,32m
10456,3,[Mlnz]Panander,2415,197,5,10,15,33.3%,60m
10456,3,[1MH1]schanks,2415,116,2,1,3,66.7%,1h
10456,2,[TVtwit]CheeseTroll,2415,94,2,3,5,40.0%,6m
10456,3,[XpKAc]marinexd,2415,42,2,4,6,33.3%,1h
10456,1,[TIC]aboutblank,2415,0,1,4,5,20.0%,40m
10456,3,stu,2415,0,0,2,2,0.0%,3h
10456,3,mojorito,2415,0,0,2,2,0.0%,1h
10456,1,[M00SE]moose,2415,0,0,3,3,0.0%,1h
10456,3,workwork,2415,0,0,5,5,0.0%,25m
10472,2,[OAFAF]ViChO,2414,1193,46,47,93,49.5%,3h
10472,2,HoHoWizard,2414,116,8,9,17,47.1%,3h
10472,1,jimmydo,2414,96,3,2,5,60.0%,1h
10472,3,EchoDriver,2414,0,3,4,7,42.9%,1h
10472,3,Vrixen,2414,0,0,1,1,0.0%,1h
10472,3,thewolf,2414,0,0,1,1,0.0%,3m
10478,2,[MªnCºs]HHMM,2413,1544,164,165,329,49.8%,1h
10478,3,vooz,2413,1082,59,56,115,51.3%,40m
10478,3,Simponator,2413,912,48,40,88,54.5%,36m
10478,3,reteP,2413,830,31,29,60,51.7%,22m
10478,3,teem,2413,225,7,6,13,53.8%,44m
10478,3,[oRuRo]elboliviano,2413,0,2,3,5,40.0%,41m
10478,1,[PETE]DarthNater,2413,0,1,0,1,100.0%,17m
10478,3,GoombaStompa,2413,0,0,1,1,0.0%,45m
10486,3,Weak,2412,1570,167,156,323,51.7%,16m
10486,2,HPoe,2412,349,122,126,248,49.2%,1h
10486,3,[XpKAc]LOKTHAR,2412,940,79,71,150,52.7%,1h
10486,3,ohmeingott,2412,447,18,11,29,62.1%,1h
10486,3,Pricursor,2412,119,4,4,8,50.0%,55m
10486,3,Rations,2412,0,0,1,1,0.0%,41m
10486,3,Dayum,2412,0,0,4,4,0.0%,1h
10493,3,[SSC]DeepWade,2411,1579,182,188,370,49.2%,1h
10493,3,urimerhav,2411,1555,156,152,308,50.6%,1h
10493,2,Teddy,2411,630,26,30,56,46.4%,4h
10493,2,Diego,2411,234,11,13,24,45.8%,26m
10493,3,[LMI42]DaBoss,2411,328,10,16,26,38.5%,60m
10493,1,Ross,2411,145,5,2,7,71.4%,36m
10493,1,Yuudachi,2411,0,2,6,8,25.0%,42m
10493,3,HappyHydra,2411,36,2,7,9,22.2%,37m
10493,3,BillyBob,2411,0,1,0,1,100.0%,58m
10493,3,IIIIIIIIIIII,2411,30,1,2,3,33.3%,10m
10493,3,[HILLS]Recneps,2411,0,0,1,1,0.0%,1h
10493,3,xigency,2411,0,0,4,4,0.0%,17m
10505,2,veqgooff,2410,1522,67,64,131,51.1%,1h
10505,3,ogSaber,2410,1034,37,40,77,48.1%,31m
10505,2,jTrus,2410,772,30,29,59,50.8%,1h
10505,3,MinecraftPro,2410,742,30,30,60,50.0%,1h
10505,2,Zygonn,2410,116,3,7,10,30.0%,1h
10505,2,DegaLeo,2410,0,1,4,5,20.0%,1h
10505,3,black,2410,0,1,4,5,20.0%,58m
10512,2,WildBurns,2409,1068,52,48,100,52.0%,3h
10512,3,Zephyr,2409,683,46,41,87,52.9%,1h
10512,1,dwilla,2409,609,24,26,50,48.0%,4m
10512,2,[MSTEIN]Eeyore,2409,286,10,15,25,40.0%,46m
10512,3,[FeCl]Yar,2409,209,7,6,13,53.8%,3h
10512,3,[blubr]Phlothsenes,2409,113,6,3,9,66.7%,1h
10512,2,Morpheus,2409,114,3,3,6,50.0%,59m
10512,3,BARCODE,2409,30,2,1,3,66.7%,17m
10512,3,Skeletorre,2409,30,2,1,3,66.7%,1h
10512,1,DKV,2409,0,1,4,5,20.0%,15m
10512,3,Lazypanda,2409,0,1,6,7,14.3%,39m
10523,2,RAMX,2408,1563,804,817,1621,49.6%,1h
10523,3,Sethracido,2408,1570,180,180,360,50.0%,3h
10523,3,SanteClaws,2408,278,17,15,32,53.1%,10m
10523,3,Liam,2408,361,13,10,23,56.5%,50m
10523,2,[LOHd]Cartore,2408,312,10,19,29,34.5%,1h
10523,3,cirok,2408,165,8,8,16,50.0%,45m
10523,3,[Mc]Jupiter,2408,212,8,8,16,50.0%,41m
10523,3,RobinHood,2408,0,2,4,6,33.3%,1h
10523,3,WhiteShadow,2408,0,0,1,1,0.0%,4h
10532,2,MercilesTrol,2407,1138,47,42,89,52.8%,1h
10532,2,GrimReaper,2407,1244,46,54,100,46.0%,1h
10532,3,Demexo,2407,478,18,17,35,51.4%,1h
10532,3,OptimusPrime,2407,382,14,17,31,45.2%,44m
10532,3,SkullKrusher,2407,372,13,8,21,61.9%,3h
10532,2,TheEndDragon,2407,194,6,12,18,33.3%,52m
10532,1,Apollodorus,2407,0,3,2,5,60.0%,1h
10532,1,REEactive,2407,0,1,4,5,20.0%,15m
10532,3,tsjjm,2407,0,1,4,5,20.0%,1h
10541,3,[CodeA]Beatme,2406,1537,156,183,339,46.0%,17m
10541,3,[M4ND4]malaspulgas,2406,547,20,16,36,55.6%,8m
10541,3,BigCheese,2406,492,18,23,41,43.9%,1h
10541,3,TORN,2406,346,12,15,27,44.4%,44m
10541,3,WatWatInDaBu,2406,94,2,4,6,33.3%,51m
10541,3,NotsoImba,2406,0,1,0,1,100.0%,53m
10541,3,[OuchA]Frisby,2406,95,1,2,3,33.3%,1h
10541,3,ZTARCRAFT,2406,30,1,5,6,16.7%,30m
10549,2,terranmaster,2405,1519,112,117,229,48.9%,1h
10549,2,Lelk,2405,1160,44,45,89,49.4%,3h
10549,3,[PTHero]oSeabass,2405,484,20,15,35,57.1%,1h
10549,3,Dynamo,2405,397,15,6,21,71.4%,38m
10549,3,KaiDe,2405,405,15,13,28,53.6%,1h
10549,3,freebuttouch,2405,178,7,5,12,58.3%,12m
10549,3,brainbug,2405,210,6,4,10,60.0%,38m
10549,3,[WW2LA]NinjaRobot,2405,121,5,1,6,83.3%,48m
10549,3,[MLNP]HungrySumo,2405,58,2,3,5,40.0%,1h
10549,2,Snufflupagus,2405,114,2,4,6,33.3%,3m
10549,3,[KRAFTT]Chamelio,2405,30,1,3,4,25.0%,1h
10549,3,Phoenix,2405,0,1,4,5,20.0%,1h
10549,3,Keylogram,2405,0,1,4,5,20.0%,1h
10562,3,Stormwolf,2404,519,32,34,66,48.5%,1h
10562,3,Blackhole,2404,653,24,24,48,50.0%,59m
10562,3,OmgItsVlad,2404,477,19,12,31,61.3%,1h
10562,3,Toxic,2404,72,2,9,11,18.2%,44m
10562,1,Nothxu,2404,48,1,1,2,50.0%,1h
10562,3,sauce,2404,0,1,4,5,20.0%,30m
10562,3,[THICKA]ENRICO,2404,0,0,1,1,0.0%,1h
10562,3,Sclavus,2404,0,0,3,3,0.0%,1h
10570,3,River,2403,469,45,40,85,52.9%,23m
10570,1,brendenator,2403,186,8,10,18,44.4%,51m
10570,3,FriedChicken,2403,146,6,7,13,46.2%,38m
10570,3,SgtButtPatch,2403,163,5,1,6,83.3%,44m
10570,3,SpecialK,2403,149,4,7,11,36.4%,1h
10570,3,Mineral,2403,124,4,7,11,36.4%,3h
10570,3,iamzeusass,2403,159,4,8,12,33.3%,11m
10570,3,ZACARABA,2403,0,2,6,8,25.0%,1h
10570,2,Sharky,2403,30,2,7,9,22.2%,3h
10570,1,Legend,2403,92,2,8,10,20.0%,3h
10580,3,JackPatata,2402,245,7,7,14,50.0%,1h
10580,2,[DACKS]silkyjohnson,2402,130,4,10,14,28.6%,46m
10580,1,[GayFsh]Johnson,2402,48,2,4,6,33.3%,1h
10580,3,Jie,2402,58,2,5,7,28.6%,1h
10584,1,loafa,2401,1343,77,84,161,47.8%,40m
10584,1,Breeze,2401,975,58,69,127,45.7%,37m
10584,3,NoobyKorean,2401,867,37,36,73,50.7%,41m
10584,3,HilaryHNC,2401,220,7,11,18,38.9%,1h
10584,3,[GO0NS]REVELATIONS,2401,188,5,5,10,50.0%,38m
10584,3,Balldanor,2401,164,5,7,12,41.7%,60m
10584,3,Help,2401,0,3,2,5,60.0%,33m
10584,3,wolf,2401,116,2,2,4,50.0%,31m
10584,3,DrLuis,2401,0,1,2,3,33.3%,38m
10584,3,Innerlight,2401,30,1,5,6,16.7%,31m
10584,2,Dochi,2401,0,0,1,1,0.0%,1h
10584,1,xelnaga,2401,0,0,1,1,0.0%,3h
10596,2,macroKing,2400,1522,115,106,221,52.0%,59m
10596,2,FancyHippo,2400,1344,47,71,118,39.8%,8m
10596,1,JSAA,2400,120,8,9,17,47.1%,44m
10596,2,JordyJoesta,2400,152,8,11,19,42.1%,8m
10596,2,CollinsAx,2400,239,8,15,23,34.8%,1h
10596,3,FlokY,2400,167,6,12,18,33.3%,28m
10596,3,JHAZZO,2400,92,3,7,10,30.0%,1h
10596,2,[PhaZe]Sasquatch,2400,130,2,5,7,28.6%,1h
10596,1,Claudio,2400,0,1,4,5,20.0%,13m
10605,1,Guan,2399,1576,59,75,134,44.0%,25m
10605,3,Pjohson,2399,143,13,16,29,44.8%,44m
10605,3,WilFromEarth,2399,196,8,8,16,50.0%,1h
10605,1,DirtyJuice,2399,139,7,7,14,50.0%,3h
10605,3,Pennywise,2399,144,3,3,6,50.0%,4m
10605,3,TheOne,2399,117,3,5,8,37.5%,3h
10611,2,Reflex,2398,1517,281,278,559,50.3%,1h
10611,1,Lothar,2398,1900,142,142,284,50.0%,1h
10611,1,Fear,2398,1055,42,41,83,50.6%,1h
10611,3,SkyLounge,2398,241,7,6,13,53.8%,1h
10611,1,CAZPER,2398,239,6,11,17,35.3%,1h
10611,1,lennon,2398,177,5,8,13,38.5%,24m
10611,3,SnickersII,2398,97,4,4,8,50.0%,31m
10611,3,Stabathor,2398,117,3,3,6,50.0%,24m
10611,2,[LTlord]Sombra,2398,128,3,4,7,42.9%,1h
10611,1,eframm,2398,88,3,5,8,37.5%,1h
10611,1,[DKMC]Mercy,2398,0,1,0,1,100.0%,33m
10611,1,LeaningTree,2398,0,1,3,4,25.0%,53m
10611,3,CamoKat,2398,0,0,2,2,0.0%,50m
10624,1,hardwork,2397,1089,137,152,289,47.4%,10m
10624,3,KillaKat,2397,659,30,19,49,61.2%,20m
10624,2,StarCruiser,2397,352,12,16,28,42.9%,37m
10624,3,Dewbie,2397,238,9,9,18,50.0%,44m
10624,3,Ender,2397,58,4,6,10,40.0%,29m
10629,3,LiquidFusion,2396,1457,71,53,124,57.3%,30m
10629,2,CNDallas,2396,405,18,26,44,40.9%,20m
10629,3,[MPC]ThexArtistx,2396,387,15,23,38,39.5%,45m
10629,3,Gamble,2396,134,3,6,9,33.3%,10m
10633,3,parka,2395,208,55,44,99,55.6%,1h
10633,3,Mystic,2395,297,11,6,17,64.7%,1h
10633,3,NachoZ,2395,146,4,6,10,40.0%,10m
10633,2,CaptCoolness,2395,116,4,8,12,33.3%,45m
10633,1,StarSim,2395,97,1,10,11,9.1%,3h
10638,2,[SCMW]JCDJ,2394,992,35,41,76,46.1%,1h
10638,3,Murakami,2394,449,27,27,54,50.0%,45m
10638,3,Fifi,2394,368,14,16,30,46.7%,40m
10638,1,AapixX,2394,0,2,3,5,40.0%,26m
10638,3,[4xDRG]Jelleton,2394,60,2,5,7,28.6%,1h
10638,1,caesura,2394,0,1,4,5,20.0%,4h
10638,1,[ScSwrm]Proboarder,2394,0,0,1,1,0.0%,16m
10645,3,Clayto,2393,296,14,16,30,46.7%,1h
10645,2,[PTHero]Gaddict,2393,443,14,19,33,42.4%,1h
10645,2,[pops]papel,2393,374,13,20,33,39.4%,30m
10645,2,NoMurrcy,2393,224,7,16,23,30.4%,18m
10645,3,NoobStench,2393,136,6,10,16,37.5%,16m
10645,2,TheBigWeed,2393,226,6,11,17,35.3%,1h
10645,2,MPA,2393,179,4,3,7,57.1%,3h
10645,1,khanon,2393,114,3,1,4,75.0%,37m
10645,1,killyan,2393,0,2,4,6,33.3%,20m
10645,1,bossdrizzt,2393,48,2,5,7,28.6%,3h
10645,3,Wever,2393,0,1,2,3,33.3%,3h
10645,1,[420SC2]barbarian,2393,0,0,1,1,0.0%,60m
10657,2,onemore,2392,1536,115,127,242,47.5%,42m
10657,3,primehat,2392,1616,96,99,195,49.2%,41m
10657,2,Galveston,2392,988,37,41,78,47.4%,52m
10657,2,MAYCOL,2392,346,30,27,57,52.6%,37m
10657,2,Shakyamuni,2392,710,26,30,56,46.4%,3h
10657,3,ArtiC,2392,302,13,17,30,43.3%,3h
10657,3,Bryan,2392,385,12,21,33,36.4%,1h
10657,1,Jos,2392,232,9,13,22,40.9%,46m
10665,2,krimpi,2391,1424,121,123,244,49.6%,1h
10665,1,ygg,2391,1566,82,87,169,48.5%,1h
10665,2,LonePorpoise,2391,228,38,34,72,52.8%,1h
10665,2,Dilator,2391,406,14,22,36,38.9%,27m
10665,1,Numbers,2391,253,7,10,17,41.2%,24m
10665,1,Slug,2391,162,5,5,10,50.0%,53m
10665,2,DarkOne,2391,153,5,8,13,38.5%,53m
10665,1,[TWL20]hoaZg,2391,48,3,4,7,42.9%,1h
10665,1,SteveHarvey,2391,48,2,5,7,28.6%,1h
10665,1,Bear,2391,48,2,6,8,25.0%,30m
10675,3,Trinity,2390,1590,81,66,147,55.1%,1h
10675,3,Gaberuth,2390,67,3,5,8,37.5%,51m
10675,3,[CatImp]Iconicion,2390,0,1,3,4,25.0%,1h
10675,3,crackervirus,2390,30,1,8,9,11.1%,23m
10679,1,saulgudman,2389,0,3,2,5,60.0%,53m
10679,3,PlanckTime,2389,62,3,4,7,42.9%,58m
10679,3,TheSS,2389,30,2,5,7,28.6%,55m
10679,1,[IOU]shockwave,2389,0,1,4,5,20.0%,24m
10683,1,Horzingtonz,2388,804,25,19,44,56.8%,1h
10683,3,FreePizza,2388,580,21,23,44,47.7%,20m
10683,3,[6661]ELFURROTAKU,2388,467,19,10,29,65.5%,42m
10683,1,[8kPLUS]BroodWeed,2388,218,6,2,8,75.0%,47m
10683,2,[strtgy]tofubaget,2388,231,6,16,22,27.3%,53m
10683,3,Brotoss,2388,189,5,6,11,45.5%,1h
10683,1,Iceman,2388,46,2,0,2,100.0%,1h
10683,1,[newati]Kakarot,2388,0,0,1,1,0.0%,3h
10691,3,Ferris,2387,334,24,28,52,46.2%,1h
10691,2,Sagara,2387,146,5,13,18,27.8%,1h
10691,1,esteban,2387,0,4,1,5,80.0%,3h
10691,1,Roger,2387,0,3,2,5,60.0%,4h
10691,3,[TCCore]TheDecider,2387,32,3,3,6,50.0%,1h
10691,3,Zeracile,2387,0,1,4,5,20.0%,1h
10691,1,GymmyClassic,2387,0,0,1,1,0.0%,5m
10691,3,XoM,2387,0,0,7,7,0.0%,1h
10699,2,magaCannon,2386,1220,86,90,176,48.9%,37m
10699,3,MilkAndMoney,2386,432,18,21,39,46.2%,1h
10699,2,Quekchose,2386,244,10,19,29,34.5%,1h
10699,3,[llII]kaysik,2386,176,9,8,17,52.9%,3h
10699,3,yourface,2386,243,8,9,17,47.1%,29m
10699,1,cardtoon,2386,128,3,2,5,60.0%,3h
10699,1,jhon,2386,0,0,5,5,0.0%,49m
10706,2,ChaeHoGyun,2385,682,87,87,174,50.0%,1h
10706,2,Russty,2385,811,60,56,116,51.7%,59m
10706,1,DashForceOne,2385,594,20,29,49,40.8%,57m
10706,3,nadonia,2385,234,10,12,22,45.5%,1h
10706,2,Heatseeker,2385,211,8,13,21,38.1%,42m
10706,1,Open,2385,110,3,7,10,30.0%,3h
10706,2,Wolvereness,2385,112,3,7,10,30.0%,1h
10706,3,Swervice,2385,120,2,2,4,50.0%,41m
10706,1,sloppyjoe,2385,0,1,0,1,100.0%,1h
10706,1,Marshadrin,2385,0,1,0,1,100.0%,1h
10706,3,[goodho]ajam,2385,0,1,1,2,50.0%,45m
10706,3,Coágulo,2385,95,1,2,3,33.3%,20m
10706,1,[GEEKED]Oglop,2385,0,0,1,1,0.0%,9m
10706,1,FigNewton,2385,0,0,1,1,0.0%,1h
10706,2,Deathdealer,2385,0,0,4,4,0.0%,3h
10721,3,LoTuSsSs,2384,1384,51,55,106,48.1%,1h
10721,3,Riverside,2384,177,7,4,11,63.6%,1h
10721,1,Versatile,2384,178,6,11,17,35.3%,47m
10721,2,Johann,2384,145,5,8,13,38.5%,31m
10721,3,Demonchlld,2384,30,4,8,12,33.3%,12m
10721,3,[UWUW]Orangebudda,2384,88,3,6,9,33.3%,26m
10721,2,[zernex]STETMANN,2384,38,1,4,5,20.0%,49m
10728,2,[CGwon]LiveWraith,2383,1607,363,369,732,49.6%,3m
10728,1,[kaptor]Legoshi,2383,492,19,16,35,54.3%,3h
10728,1,Boulderdash,2383,440,15,12,27,55.6%,10m
10728,3,[pepis]ClownGamer,2383,188,8,4,12,66.7%,17m
10728,3,[MBurns]killazerg,2383,64,2,41,43,4.7%,42m
10728,3,HeLMEt,2383,0,1,1,2,50.0%,11m
10728,3,Constantine,2383,0,1,6,7,14.3%,29m
10735,1,[KissRa]GRANT,2382,1152,42,36,78,53.8%,4h
10735,3,[OGB]YungSwagLord,2382,169,8,10,18,44.4%,3h
10735,3,[Quebec]Spatule,2382,183,5,7,12,41.7%,58m
10735,2,Bork,2382,40,2,3,5,40.0%,33m
10739,2,Eberk,2381,1486,78,84,162,48.1%,42m
10739,3,quien,2381,1311,58,49,107,54.2%,36m
10739,3,eels,2381,312,26,29,55,47.3%,1h
10739,3,[scMAUI]Jayden,2381,372,12,13,25,48.0%,4h
10739,3,[DRKL0R]Viper,2381,285,9,8,17,52.9%,8m
10739,2,[DMSO]MattD,2381,184,9,15,24,37.5%,10m
10739,3,jwbrain,2381,236,8,5,13,61.5%,7m
10739,3,destroyah,2381,97,4,4,8,50.0%,19m
10739,3,dudeitsdan,2381,122,4,8,12,33.3%,1h
10739,3,[8iSh]Protossible,2381,60,3,4,7,42.9%,23m
10739,3,Sawcebauwce,2381,36,2,2,4,50.0%,10m
10739,3,donkey,2381,121,2,3,5,40.0%,1h
10739,3,MrGose,2381,96,2,5,7,28.6%,45m
10739,1,[00fs]Boston,2381,0,1,0,1,100.0%,4h
10739,3,DesertRider,2381,30,1,4,5,20.0%,12m
10739,1,[CRBK]Vriel,2381,0,1,4,5,20.0%,3h
10739,3,SomEonEsbuTT,2381,0,0,3,3,0.0%,1h
10756,1,elElegido,2380,673,22,15,37,59.5%,6m
10756,3,SCVRUSH,2380,482,17,13,30,56.7%,1h
10756,3,TonyTone,2380,234,7,8,15,46.7%,60m
10756,3,[NSNTP]AngelWolf,2380,30,1,4,5,20.0%,10m
10756,1,SerralsPinky,2380,0,0,1,1,0.0%,1h
10761,2,Slugster,2379,1012,116,116,232,50.0%,51m
10761,3,[TITODO]MrCoyote,2379,1525,92,83,175,52.6%,1h
10761,3,SOLNEGRO,2379,846,46,40,86,53.5%,1h
10761,1,[MITO22]Stepbrother,2379,443,17,23,40,42.5%,29m
10765,3,Astroboy,2378,565,21,22,43,48.8%,25m
10765,3,Nathan,2378,542,19,23,42,45.2%,45m
10765,3,Snorkel,2378,370,13,13,26,50.0%,1h
10765,1,AdmusSaint,2378,134,3,4,7,42.9%,51m
10765,1,[TJFK]kingsblood,2378,0,2,3,5,40.0%,47m
10765,3,Hix,2378,58,2,4,6,33.3%,11m
10771,3,KingRaynor,2377,809,31,32,63,49.2%,1h
10771,3,Apolum,2377,193,6,4,10,60.0%,27m
10771,2,Potts,2377,62,3,10,13,23.1%,42m
10771,1,Cuddles,2377,44,1,2,3,33.3%,1h
10771,1,envokezYT,2377,0,1,4,5,20.0%,4m
10776,3,[nieBla]ALAMUERTE,2376,341,12,15,27,44.4%,45m
10776,1,proggleyes,2376,206,5,3,8,62.5%,9m
10776,1,sealius,2376,168,5,9,14,35.7%,56m
10779,3,Shinwelwensa,2375,1130,49,45,94,52.1%,6m
10779,3,Nykidemus,2375,702,29,28,57,50.9%,20m
10779,3,Alex,2375,286,9,15,24,37.5%,1h
10779,1,casualT,2375,178,4,3,7,57.1%,3h
10779,1,CamoKeeper,2375,42,3,3,6,50.0%,1h
10779,3,Selbor,2375,151,3,5,8,37.5%,1h
10779,1,EndersisxEW,2375,48,2,1,3,66.7%,3h
10779,3,Dockavok,2375,0,1,3,4,25.0%,3h
10779,3,PlagatH,2375,0,1,3,4,25.0%,38m
10779,3,Darwin,2375,0,0,2,2,0.0%,30m
10789,3,Religare,2374,901,44,40,84,52.4%,1h
10789,2,[KSRP]JackiePwnAss,2374,731,26,32,58,44.8%,1h
10789,3,ZIS,2374,368,13,15,28,46.4%,32m
10789,1,[GRNSKN]Shepherd,2374,180,5,5,10,50.0%,1h
10789,3,[BPunch]plusmental,2374,94,5,13,18,27.8%,46m
10789,1,Nonimba,2374,90,2,4,6,33.3%,17m
10789,1,eeboxer,2374,0,0,5,5,0.0%,4h
10796,3,SoytheLB,2373,601,24,22,46,52.2%,1h
10796,1,LilNig,2373,162,4,7,11,36.4%,1h
10798,1,[RNSF]Ricen,2372,293,10,15,25,40.0%,14m
10798,1,DonMoses,2372,256,6,4,10,60.0%,1h
10798,3,EvanSlyter,2372,97,4,4,8,50.0%,19m
10798,3,Barra,2372,58,2,8,10,20.0%,58m
10798,1,SamelCamel,2372,48,1,3,4,25.0%,9m
10803,2,[Atone]Clothes,2371,1525,120,121,241,49.8%,53m
10803,2,AVA,2371,400,14,16,30,46.7%,10m
10803,1,Kirk,2371,290,8,6,14,57.1%,31m
10803,1,DonPajerin,2371,166,4,2,6,66.7%,1h
10803,3,[ALTF04]Alastor,2371,78,3,8,11,27.3%,9m
10803,1,xBLaZnAzNx,2371,0,2,6,8,25.0%,25m
10803,1,avtec,2371,0,1,1,2,50.0%,1h
10810,3,GgamNol,2370,415,15,12,27,55.6%,45m
10810,3,Killdrjavier,2370,201,6,6,12,50.0%,1h
10810,3,IlIlIlIlIlIl,2370,42,4,5,9,44.4%,43m
10810,3,Kendor,2370,110,2,3,5,40.0%,1h
10810,1,MaeGovannen,2370,0,2,3,5,40.0%,1h
10810,1,zartanis,2370,0,1,4,5,20.0%,6m
10810,1,Lukem,2370,0,1,5,6,16.7%,1h
10810,3,sss,2370,0,0,2,2,0.0%,3h
10818,2,Pablito,2369,1567,130,135,265,49.1%,3h
10818,3,Viper,2369,654,26,24,50,52.0%,1h
10818,2,dixy,2369,186,8,9,17,47.1%,1h
10818,2,Tushinux,2369,196,8,15,23,34.8%,52m
10818,3,Velken,2369,48,2,3,5,40.0%,1h
10818,1,Mikezknight,2369,42,2,4,6,33.3%,1h
10818,3,OccamaRazor,2369,123,2,7,9,22.2%,1h
10818,1,[Crip1]milodon,2369,0,1,2,3,33.3%,3h
10818,2,[VVPPGG]Fanatic,2369,0,1,3,4,25.0%,1h
10818,1,[LMI42]Hoehammer,2369,73,0,2,2,0.0%,36m
10828,2,ABabyKoala,2368,396,15,21,36,41.7%,4h
10828,3,nomada,2368,176,6,8,14,42.9%,10m
10828,3,Idiot,2368,120,5,4,9,55.6%,58m
10828,1,Zeph,2368,0,1,4,5,20.0%,13m
10832,1,BetaStar,2367,1577,212,224,436,48.6%,7m
10832,2,HeavyMetal,2367,1398,78,88,166,47.0%,1h
10832,2,SEAN,2367,719,36,30,66,54.5%,51m
10832,3,[DXPCA]KaZiel,2367,662,24,21,45,53.3%,1h
10832,3,Axiz,2367,579,20,21,41,48.8%,41m
10832,3,Notsee,2367,72,4,5,9,44.4%,1h
10832,3,[BOLVIA]VICTUM,2367,122,3,3,6,50.0%,1h
10832,1,AboutToBoke,2367,88,2,3,5,40.0%,3h
10832,1,WhiteRose,2367,0,0,1,1,0.0%,45m
10841,3,Nerakor,2366,1157,156,155,311,50.2%,1h
10841,3,FromJapan,2366,992,107,108,215,49.8%,11m
10841,3,Abdunm,2366,1378,89,81,170,52.4%,1h
10841,2,IrishJohn,2366,1127,49,54,103,47.6%,1h
10841,1,RoastSalmon,2366,798,31,24,55,56.4%,4h
10841,1,[Huffs]Imposter,2366,483,12,11,23,52.2%,3h
10841,3,Charliebug,2366,202,5,4,9,55.6%,53m
10841,1,Fryevia,2366,94,3,1,4,75.0%,51m
10841,1,[f10]DronesToMen,2366,0,3,2,5,60.0%,3h
10841,1,ericknirvana,2366,44,2,5,7,28.6%,1h
10841,1,[CoVid]IIIIIIIIIIII,2366,0,0,1,1,0.0%,1h
10841,1,[Moulb]xialdeath,2366,0,0,1,1,0.0%,55m
10853,3,Notlim,2365,1140,47,52,99,47.5%,22m
10853,1,[STALK]reivaxebud,2365,947,30,20,50,60.0%,36m
10853,1,MadMedic,2365,391,9,10,19,47.4%,1h
10853,1,Splash,2365,162,3,2,5,60.0%,26m
10853,1,Jarclock,2365,42,1,1,2,50.0%,8m
10853,1,[XxWoot]Duck,2365,0,0,1,1,0.0%,1h
10853,1,[CDiez9]BruJo,2365,0,0,1,1,0.0%,26m
10853,1,[Squidy]NotThisTime,2365,0,0,4,4,0.0%,1h
10861,2,[WSCON]Styles,2364,747,28,32,60,46.7%,13m
10861,1,[Nose02]Djokovic,2364,122,4,1,5,80.0%,1h
10861,1,zzyy,2364,44,2,1,3,66.7%,47m
10861,3,[Wizerd]KingStupid,2364,0,2,5,7,28.6%,59m
10861,3,Demi,2364,30,2,8,10,20.0%,17m
10861,1,Hoosierboi,2364,0,1,1,2,50.0%,12m
10861,3,[Euph]RMP,2364,0,1,2,3,33.3%,1h
10868,1,Keriggan,2363,1552,107,120,227,47.1%,19m
10868,1,[Epokhé]gallitodeoro,2363,522,21,27,48,43.8%,1h
10868,3,JACOBY,2363,512,20,20,40,50.0%,16m
10868,3,cuphands,2363,548,19,19,38,50.0%,1h
10868,3,texugão,2363,403,15,15,30,50.0%,1h
10868,3,turazza,2363,0,2,5,7,28.6%,20m
10868,1,japshornyasf,2363,46,1,2,3,33.3%,1h
10868,1,trixiee,2363,0,1,4,5,20.0%,6m
10876,3,Sandwichpak,2362,907,43,63,106,40.6%,45m
10876,3,[UWISH]GrewalB,2362,92,4,6,10,40.0%,1h
10876,3,Qoo,2362,38,2,1,3,66.7%,24m
10876,1,kimboslice,2362,0,0,1,1,0.0%,3h
10880,3,Meat,2361,1363,105,100,205,51.2%,12m
10880,3,[scMAUI]MaxStout,2361,1021,37,33,70,52.9%,44m
10880,3,RETROPRO,2361,401,13,17,30,43.3%,42m
10880,1,Septtem,2361,349,11,17,28,39.3%,47m
10880,1,Jellyman,2361,48,2,0,2,100.0%,1h
10880,1,Rudeboy,2361,0,0,1,1,0.0%,1h
10880,1,[GGBr0]Nuke,2361,0,0,2,2,0.0%,1h
10887,3,LilEgg,2360,835,50,37,87,57.5%,1h
10887,3,[ASPIE]BananaKing,2360,489,30,23,53,56.6%,1h
10887,1,tbirdxi,2360,660,19,12,31,61.3%,1h
10887,2,Danny,2360,403,18,15,33,54.5%,1h
10887,2,Blacksheep,2360,394,13,20,33,39.4%,41m
10887,2,BlackIce,2360,330,12,16,28,42.9%,53m
10887,3,CIKOS,2360,268,11,14,25,44.0%,1h
10887,3,akirakato,2360,174,10,14,24,41.7%,49m
10887,3,paul,2360,167,6,9,15,40.0%,17m
10896,3,BustaGusta,2359,1551,248,262,510,48.6%,50m
10896,3,[iMkS]Dahlmann,2359,160,7,5,12,58.3%,1h
10896,1,Dekoba,2359,170,5,1,6,83.3%,50m
10896,3,[PTHero]Dex,2359,100,3,8,11,27.3%,16m
10896,3,HentaiSenpai,2359,121,2,4,6,33.3%,1h
10901,1,[LMI42]Sadik,2358,646,82,89,171,48.0%,1h
10901,2,Beastmode,2358,1292,81,93,174,46.6%,53m
10901,1,gae,2358,1381,78,81,159,49.1%,8m
10901,3,llllllllllll,2358,526,18,21,39,46.2%,33m
10901,3,Seismic,2358,316,11,8,19,57.9%,41m
10901,2,lilbaby,2358,284,10,16,26,38.5%,3h
10901,1,KillerChickn,2358,44,1,2,3,33.3%,14m
10901,1,CupCake,2358,0,0,2,2,0.0%,8m
10909,3,memerweiner,2357,1250,45,49,94,47.9%,1h
10909,2,Frigate,2357,654,25,34,59,42.4%,3h
10909,2,jaxDammOn,2357,314,12,18,30,40.0%,3h
10909,3,[RON1N]Prometheus,2357,271,8,10,18,44.4%,59m
10909,1,zergxsiempre,2357,0,1,4,5,20.0%,32m
10909,1,ThunderKai,2357,0,1,4,5,20.0%,27m
10915,2,FireServant,2356,902,31,41,72,43.1%,1h
10915,1,[beserk]DiosEsAmor,2356,97,2,0,2,100.0%,16m
10915,1,Pouding,2356,86,2,2,4,50.0%,1h
10915,1,slash,2356,0,0,1,1,0.0%,1h
10919,3,FluffyPuppy,2355,296,11,13,24,45.8%,1h
10919,1,[ThCz]Wraith,2355,48,4,3,7,57.1%,1h
10919,1,KKangs,2355,0,0,1,1,0.0%,3h
10922,3,xxxKIRAxxx,2354,484,24,22,46,52.2%,38m
10922,2,Sandéconné,2354,490,20,20,40,50.0%,4m
10922,2,Shazmo,2354,195,7,9,16,43.8%,3h
10922,3,critHASTY,2354,203,6,9,15,40.0%,52m
10922,1,Beausoleil,2354,126,3,3,6,50.0%,3h
10922,3,AngelofDeath,2354,115,3,6,9,33.3%,1h
10922,1,excusemebut,2354,42,2,0,2,100.0%,1h
10922,3,Turbo,2354,0,0,4,4,0.0%,1h
10930,1,TheGrinch,2353,1384,95,99,194,49.0%,1h
10930,3,Venom,2353,168,9,10,19,47.4%,1h
10930,2,ACBLACK,2353,140,4,8,12,33.3%,3h
10930,1,ButAidsNoPlz,2353,0,2,3,5,40.0%,1h
10930,1,Samiam,2353,0,1,0,1,100.0%,4h
10930,1,DISTROYER,2353,0,1,0,1,100.0%,26m
10930,1,Kozuka,2353,0,1,2,3,33.3%,31m
10930,3,[MARIO6]magolunatico,2353,32,1,4,5,20.0%,44m
10938,3,[4Vic]AllAmKorean,2352,687,69,69,138,50.0%,16m
10938,3,IIURANOSII,2352,115,2,4,6,33.3%,45m
10938,1,[SCTF]Zen,2352,0,1,0,1,100.0%,1h
10938,1,Iamaman,2352,0,1,4,5,20.0%,47m
10938,3,DanielR,2352,0,1,7,8,12.5%,3h
10938,1,WarPanther,2352,0,0,1,1,0.0%,60m
10944,3,Fasto,2351,821,48,48,96,50.0%,1h
10944,1,[LcH]DeePShadow,2351,42,6,0,6,100.0%,9m
10944,1,Tyranid,2351,195,6,12,18,33.3%,44m
10944,1,ApmTen,2351,0,1,4,5,20.0%,58m
10948,3,Bryan,2350,273,39,31,70,55.7%,3h
10948,1,[VRSSYN]ieatglue,2350,690,18,15,33,54.5%,3h
10948,1,BIGCITY,2350,545,15,17,32,46.9%,53m
10948,2,Nomad,2350,221,8,13,21,38.1%,6m
10948,1,Ajax,2350,0,3,2,5,60.0%,56m
10948,1,Razor,2350,0,3,2,5,60.0%,58m
10948,1,Miyuki,2350,0,2,3,5,40.0%,4h
10955,1,GOLDENBOY,2349,610,21,16,37,56.8%,27m
10955,3,[ValidG]SeVeN,2349,392,14,14,28,50.0%,1h
10955,1,cptmorgan,2349,229,6,6,12,50.0%,9m
10955,2,FelipeII,2349,161,6,8,14,42.9%,1h
10955,1,Freeza,2349,168,5,4,9,55.6%,3h
10955,1,xGodfatherLM,2349,114,3,5,8,37.5%,37m
10961,1,ChowderSnake,2348,1856,96,99,195,49.2%,51m
10961,3,[FOXY]IxLOVExSOCKS,2348,219,9,11,20,45.0%,1h
10961,3,[ZCMD]MiniPike,2348,166,7,8,15,46.7%,43m
10961,3,[LGDI]Arenium,2348,137,3,6,9,33.3%,1h
10961,1,[TeamUR]SirVilder,2348,46,2,2,4,50.0%,1h
10961,3,HighestDrumr,2348,0,1,0,1,100.0%,1h
10961,1,King,2348,0,1,1,2,50.0%,1h
10961,1,SASSIE,2348,0,0,1,1,0.0%,1h
10961,3,[TGosuA]DookieButter,2348,0,0,3,3,0.0%,58m
10970,1,Todd,2347,1564,209,216,425,49.2%,25m
10970,3,[WEQUE]ahmad,2347,1040,66,68,134,49.3%,1h
10970,3,Mino,2347,482,54,47,101,53.5%,1h
10970,3,ZzZz,2347,644,26,26,52,50.0%,59m
10970,1,SoulStorm,2347,264,9,0,9,100.0%,58m
10970,1,CptObvious,2347,196,4,4,8,50.0%,3h
10970,2,DiabloSUCKIT,2347,30,3,7,10,30.0%,1h
10970,1,WaldoTheBird,2347,0,2,3,5,40.0%,3h
10970,1,[n3wk1d]clashvalian,2347,92,2,7,9,22.2%,41m
10970,1,DaPopeM,2347,44,1,1,2,50.0%,3h
10970,3,[Silica]Hadez,2347,0,1,2,3,33.3%,3h
10970,1,Kyerion,2347,0,0,1,1,0.0%,23m
10982,3,AKILAE,2346,1276,227,233,460,49.3%,1h
10982,1,RedBullQC,2346,1798,106,106,212,50.0%,3h
10982,1,Moly,2346,0,1,4,5,20.0%,26m
10982,1,[LOHe]Chirunco,2346,0,0,1,1,0.0%,1h
10986,3,Raclem,2345,1309,88,87,175,50.3%,1h
10986,2,JunYong,2345,918,61,68,129,47.3%,42m
10986,1,[LALALE]HuRRicane,2345,593,45,50,95,47.4%,1h
10986,3,Oblivion,2345,482,20,26,46,43.5%,15m
10986,3,lowkei,2345,562,19,22,41,46.3%,1h
10986,3,MauTruong,2345,262,13,13,26,50.0%,43m
10986,3,Kraken,2345,307,11,11,22,50.0%,1h
10986,3,fking,2345,276,10,12,22,45.5%,1h
10986,1,NickNack,2345,229,5,5,10,50.0%,1h
10986,3,txing,2345,30,4,8,12,33.3%,16m
10986,1,thorim,2345,134,3,5,8,37.5%,3h
10986,1,Killer,2345,42,2,4,6,33.3%,1h
10986,1,Imangry,2345,0,0,3,3,0.0%,1h
10999,2,[Haze4z]Bluedreamz,2344,628,22,29,51,43.1%,1h
10999,1,lIIIlIlIIIII,2344,492,12,15,27,44.4%,1h
10999,1,[ZTemp]Tamarind,2344,179,9,7,16,56.2%,1h
10999,3,[HOT69]KManG,2344,165,7,8,15,46.7%,1h
10999,3,[posta]edacx,2344,223,6,8,14,42.9%,35m
10999,1,ineke,2344,128,3,1,4,75.0%,3h
10999,1,Hendo,2344,192,3,2,5,60.0%,15m
10999,1,RanGOo,2344,48,2,0,2,100.0%,1h
10999,1,[KBORK]SamuelMadrid,2344,46,2,2,4,50.0%,1h
10999,1,mikey,2344,0,1,1,2,50.0%,1h
10999,1,TheShowSC,2344,0,0,1,1,0.0%,50m
11010,1,Azathoth,2343,652,21,13,34,61.8%,1h
11010,1,gotenks,2343,610,21,28,49,42.9%,1h
11010,3,lonecraft,2343,203,7,8,15,46.7%,10m
11010,2,Dreak,2343,88,3,5,8,37.5%,52m
11010,3,Taylor,2343,0,0,6,6,0.0%,1h
11015,1,SmoteurGoat,2342,418,15,15,30,50.0%,1h
11015,1,QUANTUM,2342,174,4,6,10,40.0%,23m
11015,3,StarWolf,2342,97,1,1,2,50.0%,1h
11015,1,daromon,2342,0,0,1,1,0.0%,1h
11019,1,Miltron,2340,1523,325,316,641,50.7%,13m
11019,1,[SMCE]CubixTale,2340,560,20,9,29,69.0%,50m
11019,1,Gnkku,2340,467,16,13,29,55.2%,3h
11019,1,Valkyrie,2340,273,9,16,25,36.0%,1h
11019,1,DaNuSkA,2340,191,3,2,5,60.0%,30m
11024,3,Rychmistrz,2339,1243,49,53,102,48.0%,1h
11024,1,[ConFed]Python,2339,48,3,4,7,42.9%,54m
11024,1,maxent,2339,0,1,3,4,25.0%,1h
11027,2,BOBOBOBOBOBO,2338,1534,256,260,516,49.6%,1h
11027,2,Yaharga,2338,761,53,63,116,45.7%,1h
11027,1,[NSB01]Caprisun,2338,296,9,7,16,56.2%,1h
11027,2,[DRKFOX]DeathByDope,2338,224,6,13,19,31.6%,1h
11027,1,[oRuRo]ERICKSON,2338,40,1,1,2,50.0%,1h
11027,1,Desquiciado,2338,0,1,1,2,50.0%,25m
11027,1,NKtealc,2338,0,1,1,2,50.0%,1h
11034,2,Mullethunt,2337,512,19,27,46,41.3%,1h
11034,3,[4aRaza]Koagulo,2337,330,11,12,23,47.8%,38m
11034,3,Amurderer,2337,0,0,3,3,0.0%,1h
11037,1,HarthBringer,2336,278,9,7,16,56.2%,1h
11037,3,FlanTheMan,2336,30,5,7,12,41.7%,40m
11037,1,Crillic,2336,60,5,7,12,41.7%,1h
11037,1,xDurillo,2336,161,4,6,10,40.0%,1h
11037,1,lagoon,2336,84,3,2,5,60.0%,8m
11037,3,ChrisDonDada,2336,30,2,5,7,28.6%,1h
11037,1,[xSoD]Danilo,2336,0,0,1,1,0.0%,41m
11044,3,[Cade]JimboSlice,2335,291,57,40,97,58.8%,1h
11044,1,AndrossTrue,2335,1190,37,39,76,48.7%,4h
11044,2,Arem,2335,418,15,25,40,37.5%,1h
11044,1,Hermes,2335,486,13,12,25,52.0%,1h
11044,1,FyrECatZ,2335,228,8,0,8,100.0%,1h
11044,3,spacefrog,2335,272,8,12,20,40.0%,1h
11044,2,HertzBr,2335,262,8,17,25,32.0%,1h
11044,2,cubanpapi,2335,94,3,8,11,27.3%,1h
11044,3,KenshinX,2335,30,2,1,3,66.7%,1h
11044,1,DeadlyParrot,2335,0,1,4,5,20.0%,47m
11044,1,Melcore,2335,0,0,1,1,0.0%,1h
11055,1,Biceps,2334,942,31,27,58,53.4%,8m
11055,1,Bernardomaxi,2334,513,17,7,24,70.8%,1h
11055,3,HASSERFUELLT,2334,481,17,17,34,50.0%,1h
11055,1,Cmon,2334,240,8,9,17,47.1%,3h
11055,3,[ANDINO]chuño,2334,0,1,0,1,100.0%,34m
11055,1,matadol,2334,0,1,5,6,16.7%,18m
11055,1,BoisLikeFood,2334,0,0,1,1,0.0%,1h
11062,1,[AbcCo]lee,2333,1737,119,116,235,50.6%,1h
11062,3,JoMo,2333,563,45,46,91,49.5%,31m
11062,3,RichMunroe,2333,359,13,10,23,56.5%,44m
11062,3,Sarge,2333,285,10,11,21,47.6%,1h
11062,1,ToasterBomb,2333,313,9,9,18,50.0%,1h
11062,3,DarKudo,2333,60,2,9,11,18.2%,20m
11062,1,acidflux,2333,0,0,1,1,0.0%,45m
11069,3,Taggert,2332,964,37,40,77,48.1%,1h
11069,3,[LOHd]FreyasGuard,2332,453,20,22,42,47.6%,1h
11069,1,[Moo0]Cowsmoke,2332,314,10,0,10,100.0%,4m
11069,1,AdnerwHpelre,2332,350,9,11,20,45.0%,50m
11069,1,Dnysc,2332,166,5,3,8,62.5%,16m
11069,1,[SCVM]DespritLoon,2332,0,1,0,1,100.0%,44m
11069,1,floortile,2332,111,1,4,5,20.0%,4h
11069,1,Mark,2332,0,0,1,1,0.0%,3h
11077,1,Holty,2331,366,9,6,15,60.0%,1h
11077,2,Drin,2331,192,6,16,22,27.3%,35m
11077,1,[sk3tch]Luffigus,2331,157,5,4,9,55.6%,3h
11077,3,Hypnos,2331,149,4,4,8,50.0%,1h
11077,3,LMDuc,2331,147,4,9,13,30.8%,46m
11077,1,Pride,2331,0,3,2,5,60.0%,14m
11077,1,Traus,2331,0,2,3,5,40.0%,1h
11077,1,NoseTypist,2331,88,2,4,6,33.3%,3h
11077,3,YaBokU,2331,40,2,9,11,18.2%,44m
11077,1,[M00SE]zero,2331,0,1,2,3,33.3%,23m
11077,1,MickisMan,2331,0,1,3,4,25.0%,36m
11088,3,BobbyTrick,2330,1511,82,88,170,48.2%,10m
11088,2,Sparkzey,2330,560,20,25,45,44.4%,1h
11088,1,Judged,2330,356,9,8,17,52.9%,3h
11088,1,[usbr]Broformist,2330,324,8,10,18,44.4%,32m
11088,1,[CRolls]THESHIZZLE,2330,157,5,10,15,33.3%,1h
11088,1,Che,2330,0,1,3,4,25.0%,1h
11088,3,DarkSteel,2330,30,1,5,6,16.7%,1h
11095,1,Tyrael,2328,1165,44,41,85,51.8%,1h
11095,2,[Ex0n]iveseenbiggr,2328,640,22,33,55,40.0%,3h
11095,3,Hypnoprobe,2328,442,16,16,32,50.0%,1h
11095,3,octotaco,2328,377,14,19,33,42.4%,1h
11095,3,[Eagle1]WhiteEagle,2328,242,8,13,21,38.1%,51m
11095,3,[iar]THEBUTLER,2328,215,6,8,14,42.9%,23m
11095,1,MaUkTaY,2328,48,2,5,7,28.6%,1h
11095,1,[Pirobo]Mayher,2328,46,1,1,2,50.0%,5m
11095,1,ABear,2328,0,1,4,5,20.0%,3h
11095,1,alxndr,2328,0,1,4,5,20.0%,6m
11105,3,MechDonalds,2327,197,6,2,8,75.0%,3h
11105,3,Oscar,2327,0,0,1,1,0.0%,1h
11107,2,AlexiStukov,2326,706,25,35,60,41.7%,1h
11107,1,Fusti,2326,145,3,5,8,37.5%,3h
11107,3,grundle,2326,94,2,5,7,28.6%,30m
11107,1,ScrtchnWarlk,2326,0,2,6,8,25.0%,13m
11107,3,Artanis,2326,0,1,5,6,16.7%,58m
11112,1,[LETAL]pap,2325,539,13,15,28,46.4%,1h
11112,1,ETOVE,2325,283,8,5,13,61.5%,3h
11112,3,Hexar,2325,221,6,5,11,54.5%,1h
11112,3,Sylar,2325,193,6,8,14,42.9%,1h
11112,1,Lance,2325,80,3,2,5,60.0%,1h
11112,1,Blackangel,2325,100,3,8,11,27.3%,1h
11118,1,hiroshijag,2324,224,5,10,15,33.3%,1h
11118,3,RandALthor,2324,93,2,3,5,40.0%,45m
11118,3,[SC2US]KodaGG,2324,30,2,5,7,28.6%,1h
11118,2,Jeur,2324,0,1,0,1,100.0%,45m
11122,3,Buurduurhuur,2323,1042,52,55,107,48.6%,26m
11122,1,ZeirosRak,2323,486,25,22,47,53.2%,1h
11122,1,[CobraC]Destro,2323,712,19,16,35,54.3%,60m
11122,1,[VGRiD]Heatwave,2323,168,5,4,9,55.6%,1h
11122,1,BBQmaxiXXL,2323,171,5,5,10,50.0%,56m
11122,1,Manntra,2323,70,2,2,4,50.0%,1h
11122,3,Barn,2323,30,2,6,8,25.0%,52m
11122,3,[Docs]RagTagMonstR,2323,120,2,7,9,22.2%,1h
11122,1,[Huevos]ChikaneXIV,2323,0,1,0,1,100.0%,54m
11122,3,DiddyDove,2323,0,1,0,1,100.0%,16m
11122,1,GothicCrisis,2323,0,0,2,2,0.0%,3h
11133,3,MuddyNutts,2322,1553,124,132,256,48.4%,1h
11133,1,Isaac,2322,1070,74,65,139,53.2%,46m
11133,1,Carnage,2322,1097,47,46,93,50.5%,23m
11133,1,Renegade,2322,294,7,11,18,38.9%,1h
11133,1,GANDER,2322,0,3,2,5,60.0%,6m
11133,1,[Khalta]RaynorHere,2322,0,2,2,4,50.0%,1h
11133,1,Dissin,2322,0,2,3,5,40.0%,4h
11133,3,Cory,2322,93,2,5,7,28.6%,1h
11141,1,Moadhib,2321,1513,346,345,691,50.1%,1h
11141,1,entusnalgas,2321,539,15,13,28,53.6%,1h
11141,3,[PLUNG]Mindwave,2321,310,12,18,30,40.0%,1h
11141,2,[TgJc]ThatGuyJorge,2321,216,7,3,10,70.0%,3h
11141,1,Dancraft,2321,208,5,9,14,35.7%,3h
11141,1,Ogre,2321,48,2,5,7,28.6%,36m
11141,3,IlIlIlIlIlIl,2321,120,2,6,8,25.0%,1h
11141,3,CASHFLOW,2321,60,2,8,10,20.0%,45m
11141,3,ChugaJS,2321,32,1,2,3,33.3%,1h
11141,1,Zamyk,2321,44,1,4,5,20.0%,60m
11151,3,GeorgeFill,2320,1091,49,46,95,51.6%,1h
11151,1,MeeMeeSiku,2320,810,23,20,43,53.5%,16m
11151,2,[IDKB]JacknCoke,2320,60,4,8,12,33.3%,3h
11151,1,[RogueW]PookieWon,2320,0,0,2,2,0.0%,1h
11155,2,[AssSZN]SpankMaster,2319,1566,136,147,283,48.1%,1h
11155,2,[G0BBLE]imtucker,2319,273,10,11,21,47.6%,1h
11155,2,Brando,2319,193,7,11,18,38.9%,1h
11155,1,halec,2319,223,6,9,15,40.0%,26m
11155,3,chifus,2319,34,3,7,10,30.0%,6m
11155,1,[RON1N]RevMatch,2319,0,1,4,5,20.0%,55m
11155,1,RaccoonV,2319,0,1,4,5,20.0%,3h
11155,1,FiftySixKay,2319,42,1,4,5,20.0%,1h
11155,1,ReznovsSon,2319,0,0,1,1,0.0%,1h
11164,2,Cachookey,2318,1261,75,76,151,49.7%,38m
11164,3,[cluez]zerotwo,2318,107,5,6,11,45.5%,53m
11164,3,Natcitlaneh,2318,0,1,4,5,20.0%,1h
11164,2,ASSAZIN,2318,0,0,1,1,0.0%,28m
11168,3,Ontologist,2317,1479,128,116,244,52.5%,9m
11168,1,AgentHippo,2317,202,4,2,6,66.7%,1h
11168,3,IVDenisovich,2317,86,3,7,10,30.0%,4m
11168,3,[pineC]StrataPeng,2317,0,0,1,1,0.0%,5m
11172,3,langostino,2316,1131,94,93,187,50.3%,1h
11172,3,[UAN]boom,2316,440,17,23,40,42.5%,3h
11172,1,TonyG,2316,388,13,12,25,52.0%,3h
11172,1,bdfg,2316,438,13,15,28,46.4%,5m
11172,3,Lallaar,2316,359,12,13,25,48.0%,3h
11172,1,Digits,2316,118,3,4,7,42.9%,15m
11178,3,wrandas,2315,529,94,88,182,51.6%,38m
11178,3,RoadToPlaty,2315,678,56,51,107,52.3%,32m
11178,3,LiquidSky,2315,306,20,20,40,50.0%,32m
11178,2,[Pibo3]SwarmINC,2315,102,3,4,7,42.9%,1h
11178,1,Exclusive,2315,0,0,1,1,0.0%,44m
11178,1,MortyHot,2315,0,0,1,1,0.0%,3h
11178,3,babyboy,2315,0,0,6,6,0.0%,1h
11185,3,Astro,2314,60,6,10,16,37.5%,12m
11185,1,Codicia,2314,97,1,3,4,25.0%,39m
11185,1,WorthlesCube,2314,0,1,4,5,20.0%,9m
11185,2,Favhos,2314,40,1,5,6,16.7%,3h
11189,3,PandaStorm,2313,1532,68,73,141,48.2%,45m
11189,1,Lockking,2313,861,49,40,89,55.1%,52m
11189,3,[GOOOSE]mooplet,2313,242,11,12,23,47.8%,36m
11189,1,[ScoMaf]empleh,2313,194,6,7,13,46.2%,1h
11189,2,ScvAssassin,2313,147,4,12,16,25.0%,6m
11189,2,Phoenix,2313,46,1,2,3,33.3%,58m
11195,2,TaxiDriver,2312,1506,127,136,263,48.3%,37m
11195,1,Corpse,2312,1576,115,126,241,47.7%,3h
11195,2,[KR20]WISDOM,2312,1193,53,64,117,45.3%,18m
11195,1,Matador,2312,44,3,4,7,42.9%,18m
11195,1,[SHCrew]Luxes,2312,0,2,3,5,40.0%,3h
11195,3,CaptainBald,2312,110,2,5,7,28.6%,10m
11195,1,Benjy,2312,0,1,0,1,100.0%,1h
11195,3,Furby,2312,0,0,2,2,0.0%,1h
11203,3,Anders,2311,1509,60,97,157,38.2%,5m
11203,1,SwampAss,2311,364,11,7,18,61.1%,1h
11203,1,OrdinaryNot,2311,128,6,5,11,54.5%,1h
11203,1,TheNevermind,2311,48,2,0,2,100.0%,16m
11203,3,Ourus,2311,0,1,2,3,33.3%,1h
11203,1,Adam,2311,0,0,1,1,0.0%,3h
11209,2,SleepyBoar,2310,856,190,191,381,49.9%,13m
11209,1,toro,2310,1190,108,108,216,50.0%,1h
11209,1,BuckWild,2310,705,21,17,38,55.3%,1h
11209,1,MysteryMan,2310,318,9,11,20,45.0%,1h
11209,1,MakoSOLDIER,2310,0,1,5,6,16.7%,1h
11209,1,Vick,2310,0,1,5,6,16.7%,16m
11215,1,Virgulino,2309,424,11,14,25,44.0%,1h
11215,1,Joseiza,2309,221,7,8,15,46.7%,34m
11215,1,TOSSNMYSALAD,2309,0,2,3,5,40.0%,49m
11215,1,Londier,2309,0,1,1,2,50.0%,60m
11215,1,Logan,2309,0,0,1,1,0.0%,4h
11220,2,Nerdface,2308,44,5,6,11,45.5%,1h
11220,1,PatrickJane,2308,170,4,5,9,44.4%,1h
11220,1,BLADE,2308,0,1,4,5,20.0%,1h
11220,1,Dome,2308,0,1,5,6,16.7%,54m
11220,1,Wortho,2308,0,1,5,6,16.7%,15m
11220,1,[CTsix]Danimal,2308,0,0,3,3,0.0%,1h
11226,1,Drawer,2307,635,54,47,101,53.5%,3h
11226,1,Duffman,2307,494,14,10,24,58.3%,16m
11226,1,BMTH,2307,96,1,5,6,16.7%,4h
11229,3,[MaxWin]SkyKai,2306,404,14,20,34,41.2%,36m
11229,1,Alt,2306,190,7,7,14,50.0%,37m
11229,3,[LCE]Dks,2306,172,6,13,19,31.6%,1h
11229,1,SeungguLee,2306,178,5,6,11,45.5%,35m
11229,3,Heisenberg,2306,120,5,11,16,31.2%,1h
11229,1,Slade,2306,86,3,4,7,42.9%,41m
11235,3,Panthera,2305,1555,463,475,938,49.4%,16m
11235,2,Cosadog,2305,1087,60,60,120,50.0%,55m
11235,1,kkmmt,2305,956,31,27,58,53.4%,1h
11235,1,TotalPenguin,2305,143,4,5,9,44.4%,1h
11235,1,[TSFK]JenningsRage,2305,46,2,5,7,28.6%,56m
11235,1,Faroth,2305,0,1,4,5,20.0%,3h
11235,1,amenodorime,2305,0,0,2,2,0.0%,25m
11242,3,Saga,2304,1284,54,57,111,48.6%,1h
11242,3,[Wat3rs]Assassino,2304,146,4,7,11,36.4%,51m
11242,1,Vamp,2304,147,4,10,14,28.6%,3h
11242,1,DaBlackMac,2304,42,2,5,7,28.6%,9m
11242,1,ROWNNIE,2304,0,0,2,2,0.0%,23m
11247,3,Sinaps,2303,1552,74,77,151,49.0%,1h
11247,3,WrathofScott,2303,1260,46,52,98,46.9%,17m
11247,2,BlackWolf,2303,547,18,35,53,34.0%,3h
11247,3,Scurred,2303,237,9,9,18,50.0%,1h
11247,1,CHALLENGER,2303,212,5,6,11,45.5%,60m
11247,1,[FalPal]FireEye,2303,121,4,5,9,44.4%,59m
11247,1,[LTlord]KippaSaurio,2303,0,3,2,5,60.0%,19m
11254,1,ArthurP,2302,1841,211,199,410,51.5%,1h
11254,1,[AOrder]SpiritEater,2302,1369,180,189,369,48.8%,3h
11254,3,[SCVM]NightTrain,2302,172,7,6,13,53.8%,32m
11254,2,buru,2302,188,7,21,28,25.0%,52m
11254,3,ForAnThrill,2302,176,5,9,14,35.7%,58m
11254,1,Afatcow,2302,92,4,6,10,40.0%,1h
11254,1,seratull,2302,88,3,7,10,30.0%,1h
11261,1,[WeRaD]opop,2301,40,2,6,8,25.0%,49m
11261,3,[Apink1]Apink,2301,0,0,1,1,0.0%,1h
11261,1,ScrotemPole,2301,0,0,1,1,0.0%,26m
11264,1,ASSASSINS,2300,0,0,1,1,0.0%,51m
11264,1,Mrgotohell,2300,0,0,2,2,0.0%,3h
11266,2,ToffyUK,2299,1468,197,205,402,49.0%,4m
11266,1,Ych,2299,1310,40,51,91,44.0%,1h
11266,3,Jwhit,2299,748,37,38,75,49.3%,1h
11266,3,Pablito,2299,780,28,35,63,44.4%,1h
11266,1,imabeast,2299,694,20,17,37,54.1%,1h
11266,1,Wizzleli,2299,641,19,14,33,57.6%,3h
11266,1,[RNDMX]DAMIANCA,2299,444,12,12,24,50.0%,1h
11266,3,Brent,2299,235,8,9,17,47.1%,26m
11266,1,MATO,2299,239,7,2,9,77.8%,23m
11266,1,NICODEMUS,2299,48,2,6,8,25.0%,9m
11266,1,ToXic,2299,0,1,4,5,20.0%,8m
11266,1,Stick,2299,0,0,2,2,0.0%,8m
11278,1,Slaughter,2298,1321,107,108,215,49.8%,1h
11278,3,Caltech,2298,544,31,34,65,47.7%,51m
11278,1,[KEILZ]Whitezero,2298,719,25,23,48,52.1%,60m
11278,3,atlbraves,2298,175,8,8,16,50.0%,1h
11278,1,killercow,2298,163,7,4,11,63.6%,56m
11278,2,Joatmon,2298,90,7,7,14,50.0%,3h
11278,1,Josh,2298,152,7,16,23,30.4%,55m
11278,1,SoMLic,2298,124,4,1,5,80.0%,1h
11278,1,Picus,2298,94,2,2,4,50.0%,33m
11278,3,TobStar,2298,58,2,8,10,20.0%,1h
11278,3,CnelSheppard,2298,123,2,9,11,18.2%,39m
11278,1,GViper,2298,0,1,0,1,100.0%,3h
11278,1,Teranasaurus,2298,0,1,4,5,20.0%,1h
11278,2,richyqtqt,2298,0,1,9,10,10.0%,1h
11278,1,DavidHR,2298,0,0,2,2,0.0%,25m
11293,3,contramundi,2297,1367,201,209,410,49.0%,17m
11293,2,Fokus,2297,1098,68,74,142,47.9%,3h
11293,3,[DSGs]Roquefort,2297,486,18,22,40,45.0%,42m
11293,1,ThinkBlue,2297,502,13,14,27,48.1%,1h
11293,3,[SIMPx]TottyX,2297,367,12,16,28,42.9%,1h
11293,3,[142]Magus,2297,169,5,1,6,83.3%,1h
11299,1,Prizior,2296,1796,73,74,147,49.7%,3h
11299,3,Waverr,2296,1241,53,73,126,42.1%,52m
11299,1,SilverSavior,2296,270,7,6,13,53.8%,3h
11299,1,[gam30n]BornLaughing,2296,281,6,16,22,27.3%,37m
11299,1,SlothJaw,2296,48,2,6,8,25.0%,1h
11299,1,HunterXD,2296,97,1,5,6,16.7%,39m
11305,2,DarthRez,2295,1144,40,56,96,41.7%,1h
11305,2,[SWOU]maxpoint,2295,581,39,46,85,45.9%,20m
11305,3,vvtrcc,2295,596,21,23,44,47.7%,1h
11305,3,Tachinii,2295,609,21,31,52,40.4%,31m
11305,1,Ozram,2295,454,15,14,29,51.7%,3h
11305,3,Ghosttotem,2295,229,9,22,31,29.0%,1h
11305,3,awstrat,2295,222,7,7,14,50.0%,59m
11305,1,[8kPLUS]Hemroid,2295,163,3,2,5,60.0%,1h
11305,2,[Nose02]MrPotato,2295,0,1,1,2,50.0%,16m
11305,1,Fridge,2295,0,1,4,5,20.0%,10m
11305,2,Kimochi,2295,0,1,4,5,20.0%,3m
11305,1,whiskeyjam,2295,0,0,1,1,0.0%,53m
11305,1,SouLReapeR,2295,0,0,3,3,0.0%,3h
11318,2,[xRI]Psylent,2294,1606,622,619,1241,50.1%,49m
11318,3,Eclipse,2294,1620,223,223,446,50.0%,1h
11318,2,MaysLanding,2294,652,40,44,84,47.6%,1h
11318,1,Pharmacyst,2294,42,2,0,2,100.0%,1h
11318,1,OnlyOneWrx,2294,82,2,5,7,28.6%,4h
11318,1,[SKGS]Elydan,2294,0,0,1,1,0.0%,32m
11324,1,knobby,2293,1005,31,32,63,49.2%,12m
11324,1,dcfobreezy,2293,530,14,14,28,50.0%,1h
11324,1,[KJ]LittleReaper,2293,0,1,0,1,100.0%,1h
11324,2,SORIA,2293,0,0,4,4,0.0%,3h
11328,2,Yoda,2292,1248,135,135,270,50.0%,1h
11328,1,Matadorkiler,2292,380,12,9,21,57.1%,41m
11328,1,Bready,2292,193,4,4,8,50.0%,41m
11328,3,zaiken,2292,142,3,6,9,33.3%,58m
11332,1,ElocinEvol,2291,1104,56,63,119,47.1%,47m
11332,1,NinaLapochka,2291,0,2,1,3,66.7%,49m
11332,1,Wizzour,2291,44,2,2,4,50.0%,1h
11335,1,[5up3r]Mario,2290,423,12,16,28,42.9%,55m
11335,2,CrypticTag,2290,227,11,23,34,32.4%,1h
11335,1,taeyun,2290,74,3,0,3,100.0%,4h
11335,1,TearBear,2290,0,3,5,8,37.5%,40m
11335,3,IIIIIIIIIIII,2290,44,3,8,11,27.3%,1h
11340,1,suarez,2289,552,37,34,71,52.1%,31m
11340,1,DaddyMusk,2289,732,23,19,42,54.8%,1h
11340,1,dornröschen,2289,84,2,3,5,40.0%,1h
11340,3,Lilon,2289,0,1,1,2,50.0%,1h
11344,1,[SITW]scout,2288,171,7,8,15,46.7%,51m
11344,1,iphoneBoxs,2288,0,1,4,5,20.0%,8m
11346,3,jclee,2287,442,26,27,53,49.1%,1h
11346,1,pwavvy,2287,238,6,2,8,75.0%,4h
11348,1,Bhageera,2286,1856,145,148,293,49.5%,1h
11348,3,CappinCrunch,2286,145,3,4,7,42.9%,1h
11348,1,TheRevenant,2286,88,2,2,4,50.0%,3h
11348,1,[Pyr3s]Studley,2286,0,1,0,1,100.0%,3h
11348,2,ShAdOw,2286,88,1,3,4,25.0%,1h
11348,3,Waddles,2286,30,1,4,5,20.0%,10m
11348,3,boodybandit,2286,0,1,6,7,14.3%,1h
11348,1,[FCTR]Sawa,2286,0,0,2,2,0.0%,1h
11356,3,Grinurlife,2285,1560,441,480,921,47.9%,44m
11356,2,FlatCircle,2285,1104,41,49,90,45.6%,1h
11356,3,MrBigBalls,2285,411,22,24,46,47.8%,44m
11356,1,[GCV]Maddness,2285,181,5,9,14,35.7%,3h
11356,1,ebv,2285,44,2,2,4,50.0%,8m
11356,1,[DeStRo]bingshady,2285,88,2,7,9,22.2%,12m
11356,1,[AFOTW]Farin,2285,0,1,1,2,50.0%,3h
11356,1,MasterMller,2285,0,1,1,2,50.0%,1h
11356,1,iqzz,2285,0,0,1,1,0.0%,1h
11365,1,[Reeb]CervezaRey,2284,1074,35,30,65,53.8%,1h
11365,1,CapMarmota,2284,590,27,15,42,64.3%,35m
11365,2,ElFipe,2284,559,22,34,56,39.3%,1h
11365,1,Eversmen,2284,315,11,12,23,47.8%,12m
11365,1,[JAAM]JAAM,2284,168,6,8,14,42.9%,56m
11365,1,Ptizizi,2284,160,4,6,10,40.0%,26m
11365,3,AIREO,2284,121,3,1,4,75.0%,22m
11365,1,SilentKilla,2284,0,3,4,7,42.9%,30m
11365,1,MrGarrison,2284,46,2,6,8,25.0%,8m
11365,2,[EPCK]anchante,2284,0,1,4,5,20.0%,44m
11365,3,llllllllllll,2284,0,0,2,2,0.0%,51m
11376,1,[SqBD]Kardaron,2283,1628,54,54,108,50.0%,44m
11376,2,xxKINGREKTxx,2283,913,34,43,77,44.2%,1h
11376,1,mcdizzle,2283,667,26,23,49,53.1%,1h
11376,1,Kurisuten,2283,488,13,10,23,56.5%,12m
11376,3,TolietSkunk,2283,122,3,4,7,42.9%,41m
11376,3,Ols,2283,90,3,10,13,23.1%,4m
11376,1,Delothim,2283,133,3,10,13,23.1%,4h
11376,1,TheWorstAtSc,2283,42,2,0,2,100.0%,1h
11376,2,DownSkyward,2283,0,0,7,7,0.0%,58m
11385,1,[n1zzle]Ethan,2282,544,23,17,40,57.5%,31m
11385,2,SkUnCh,2282,221,7,7,14,50.0%,3h
11385,1,angel,2282,48,2,6,8,25.0%,16m
11385,3,Valjean,2282,0,2,8,10,20.0%,59m
11385,3,[LOHd]racso,2282,0,0,1,1,0.0%,1h
11390,1,Galimatías,2281,568,19,11,30,63.3%,12m
11390,1,BTSJimin,2281,317,11,14,25,44.0%,3h
11390,1,Liondres,2281,386,10,7,17,58.8%,4h
11390,1,Drrouter,2281,269,7,11,18,38.9%,3h
11390,1,Jpol,2281,44,1,1,2,50.0%,60m
11390,1,StickFigure,2281,0,1,2,3,33.3%,23m
11396,2,MATAOS,2280,1555,379,381,760,49.9%,3h
11396,1,likmedik,2280,576,20,19,39,51.3%,46m
11396,3,[xCTx]Armyofone,2280,64,5,9,14,35.7%,1h
11396,1,RooWattsBalí,2280,0,1,1,2,50.0%,46m
11396,1,David,2280,0,1,6,7,14.3%,16m
11401,1,Impact,2279,762,27,19,46,58.7%,41m
11401,1,[DEREZZ]ACM,2279,691,27,20,47,57.4%,1h
11401,1,[SxyMxN]Sants,2279,334,11,17,28,39.3%,12m
11401,1,DRACULA,2279,215,5,9,14,35.7%,56m
11401,1,[cluez]Killer,2279,174,4,5,9,44.4%,5m
11401,1,VoidHunter,2279,48,2,2,4,50.0%,40m
11401,1,Viinders,2279,95,2,3,5,40.0%,51m
11401,3,ruBBer,2279,0,2,6,8,25.0%,10m
11401,2,Zulu,2279,0,0,1,1,0.0%,1h
11410,1,[KG73]AlexThor,2278,1578,94,94,188,50.0%,3h
11410,2,pocoyo,2278,0,3,2,5,60.0%,34m
11410,3,Realdizzle,2278,90,3,12,15,20.0%,59m
11410,1,RonaldRaygun,2278,0,0,3,3,0.0%,3h
11414,1,poodragon,2277,1482,84,75,159,52.8%,13m
11414,1,Helios,2277,276,9,19,28,32.1%,1h
11414,1,Kayzerg,2277,296,8,7,15,53.3%,4h
11414,3,ScubaSteve,2277,211,6,9,15,40.0%,29m
11414,1,Dragon,2277,176,5,11,16,31.2%,3h
11414,1,Wirry,2277,126,4,8,12,33.3%,53m
11414,1,[NoH2O]Tynamo,2277,0,0,2,2,0.0%,1h
11421,1,Einzlander,2276,918,39,32,71,54.9%,35m
11421,1,[MMSTAR]tommyrod,2276,737,26,21,47,55.3%,8m
11421,1,YazUro,2276,542,15,16,31,48.4%,27m
11421,2,[Ta130O]Dragah,2276,155,5,9,14,35.7%,47m
11421,1,longjabbin,2276,74,3,1,4,75.0%,3h
11421,1,Arie,2276,84,3,5,8,37.5%,4h
11421,1,[azer]azer,2276,145,3,6,9,33.3%,1h
11421,1,[HENT4l]Rambo,2276,0,1,0,1,100.0%,4h
11421,1,[LOHc]touchpadmous,2276,97,1,3,4,25.0%,1h
11430,3,LoneWolf,2275,217,8,7,15,53.3%,1h
11430,1,Aarodynamix,2275,238,7,4,11,63.6%,3h
11430,1,[HSTL]ChosEnFeWx,2275,145,3,5,8,37.5%,54m
11430,1,[StrkZ]Wraith,2275,96,3,5,8,37.5%,10m
11430,3,GlhfiloveYou,2275,30,1,4,5,20.0%,31m
11430,2,awdawd,2275,0,1,6,7,14.3%,3h
11430,1,slatewolf,2275,0,0,1,1,0.0%,3h
11430,1,Mitsurugi,2275,0,0,2,2,0.0%,35m
11438,2,IDarkBladezI,2274,962,32,45,77,41.6%,11m
11438,3,salsaverde,2274,254,27,19,46,58.7%,59m
11438,1,[D00M]DARKZZII,2274,312,10,15,25,40.0%,37m
11438,1,Jake,2274,84,3,6,9,33.3%,1h
11438,1,VolcanoMaN,2274,78,2,2,4,50.0%,32m
11438,1,IshikawaYui,2274,0,0,2,2,0.0%,15m
11444,3,ÐixieRëkt,2273,1049,71,85,156,45.5%,1h
11444,1,cndnsinger,2273,1465,49,49,98,50.0%,31m
11444,2,kanuk,2273,1330,46,58,104,44.2%,1h
11444,1,Xlaw,2273,1020,40,44,84,47.6%,60m
11444,1,SphYnoX,2273,42,2,2,4,50.0%,3h
11444,3,Abraxxes,2273,30,1,5,6,16.7%,4h
11450,2,[iRQ]Clark,2272,1290,51,59,110,46.4%,4m
11450,1,duckychan,2272,479,21,23,44,47.7%,52m
11450,1,[MutasT]Mac,2272,193,6,5,11,54.5%,10m
11450,1,[CHOG]Amplified,2272,173,6,12,18,33.3%,1h
11450,3,Cellulanus,2272,142,3,6,9,33.3%,45m
11450,1,empblah,2272,44,1,2,3,33.3%,47m
11450,1,[LIPESC]Monstuos,2272,0,0,1,1,0.0%,45m
11450,2,IlIlIlIlIl,2272,0,0,1,1,0.0%,1h
11458,3,[Wat3rs]TheEnforcer,2271,570,37,44,81,45.7%,1h
11458,3,KingPawn,2271,127,17,21,38,44.7%,45m
11458,1,Stark,2271,540,14,15,29,48.3%,3h
11458,1,Clam,2271,309,10,10,20,50.0%,3h
11458,2,RiNowIWINmix,2271,193,9,8,17,52.9%,17m
11458,2,[MIIllM]IlII,2271,0,1,2,3,33.3%,1h
11458,1,[NoBads]Halcyon,2271,0,1,2,3,33.3%,1h
11465,1,cjjknight,2270,260,7,3,10,70.0%,32m
11465,3,[WOW2EZ]Pug,2270,193,6,11,17,35.3%,59m
11465,3,daveeeed,2270,142,6,11,17,35.3%,7m
11465,1,[LGNxx]DarkBlood,2270,160,4,1,5,80.0%,3h
11465,3,QWASDERTY,2270,97,2,1,3,66.7%,20m
11465,3,byBre,2270,0,0,3,3,0.0%,1h
11471,3,TitsMcGee,2269,1189,66,66,132,50.0%,1h
11471,3,Random,2269,146,6,10,16,37.5%,41m
11471,1,[FFAA]KaleJarret,2269,99,4,2,6,66.7%,3h
11471,1,vybnji,2269,0,2,4,6,33.3%,1h
11471,1,Peace,2269,34,2,11,13,15.4%,3h
11471,2,TRIgEr,2269,0,1,4,5,20.0%,1h
11477,1,[VikE]IZZievil,2268,541,14,19,33,42.4%,1h
11477,2,Nonsense,2268,324,12,19,31,38.7%,3h
11477,1,DirtyDude,2268,274,8,8,16,50.0%,1h
11477,2,QueenSack,2268,154,7,12,19,36.8%,1h
11477,1,[UpxV]Reeaper,2268,44,1,1,2,50.0%,1h
11477,3,[Lamort]FabroManiac,2268,0,0,2,2,0.0%,34m
11483,3,Jitano,2267,949,112,97,209,53.6%,45m
11483,3,[FTLT]angelo,2267,624,21,32,53,39.6%,21m
11483,1,Baujahr,2267,114,3,5,8,37.5%,47m
11483,1,King,2267,0,0,1,1,0.0%,56m
11483,2,snaddladd,2267,0,0,1,1,0.0%,59m
11488,1,BlueBeast,2266,983,38,38,76,50.0%,1h
11488,1,[GOOOSE]tpafs,2266,0,2,2,4,50.0%,4h
11490,1,jessto,2265,329,9,10,19,47.4%,3h
11490,1,CerealKiller,2265,162,5,7,12,41.7%,8m
11490,3,killerman,2265,0,1,2,3,33.3%,3h
11490,1,locojuhi,2265,0,1,2,3,33.3%,3h
11490,1,Bustarhymes,2265,91,1,6,7,14.3%,1h
11495,3,DrunkSuprman,2264,562,20,28,48,41.7%,7m
11495,2,druidlad,2264,269,9,15,24,37.5%,4h
11495,1,[FAKUU]Molicopter,2264,0,1,0,1,100.0%,1h
11498,3,Xerdo,2263,1454,87,97,184,47.3%,1h
11498,1,UltimateNoob,2263,284,9,13,22,40.9%,13m
11498,1,Geobob,2263,88,2,3,5,40.0%,60m
11498,1,[Vulk]Jymix,2263,0,1,7,8,12.5%,3h
11498,1,adler,2263,0,0,1,1,0.0%,3h
11498,1,Kevincap,2263,0,0,2,2,0.0%,1h
11498,1,sjschlag,2263,0,0,3,3,0.0%,1h
11505,1,SpeedRacerX,2262,488,22,11,33,66.7%,3h
11505,3,BlackBeard,2262,275,8,9,17,47.1%,54m
11505,3,Executor,2262,136,8,10,18,44.4%,54m
11505,3,[FiFo]Verblazo,2262,34,3,8,11,27.3%,5m
11505,1,Skillson,2262,0,2,3,5,40.0%,37m
11505,2,[Mkx]Albatraoz,2262,0,1,4,5,20.0%,1h
11511,1,auNit,2261,84,3,2,5,60.0%,55m
11511,1,SeaHam,2261,0,3,2,5,60.0%,1h
11511,1,[SCUnal]Kathartes,2261,88,2,0,2,100.0%,47m
11511,2,[RSHB]Sammypty,2261,0,2,2,4,50.0%,7m
11511,1,Antoni,2261,0,2,2,4,50.0%,55m
11511,1,Ruffeo,2261,0,2,3,5,40.0%,9m
11511,1,Niceman,2261,0,0,2,2,0.0%,1h
11518,1,Eurozone,2260,371,68,58,126,54.0%,9m
11518,1,Tonno,2260,510,13,17,30,43.3%,12m
11518,1,shacklebolt,2260,413,12,17,29,41.4%,3h
11518,3,Switchy,2260,309,11,13,24,45.8%,45m
11518,1,[FYous]Dunkers,2260,168,5,7,12,41.7%,37m
11518,1,guiltyorphan,2260,86,3,5,8,37.5%,1h
11518,1,[iForce]Alpha,2260,0,1,5,6,16.7%,1h
11518,1,lililililili,2260,0,1,6,7,14.3%,1h
11526,1,Battleooze,2259,1278,64,59,123,52.0%,3h
11526,3,[jugoso]THENAME,2259,730,26,34,60,43.3%,21m
11526,1,[diaman]DjembZone,2259,30,1,6,7,14.3%,5m
11529,1,Migbon,2258,1253,41,43,84,48.8%,26m
11529,1,ElCanelas,2258,48,2,0,2,100.0%,1h
11529,1,jhojato,2258,0,1,0,1,100.0%,45m
11529,1,MasteroDeath,2258,0,0,1,1,0.0%,37m
11533,1,Scubatropin,2257,973,44,32,76,57.9%,3h
11533,1,[xABQx]Lukas,2257,702,36,18,54,66.7%,4h
11533,1,[LWWC]tugfaloca,2257,322,9,5,14,64.3%,1h
11533,1,Hero,2257,280,8,8,16,50.0%,3h
11533,1,[TStarD]MalleusMal,2257,184,4,3,7,57.1%,50m
11533,1,deef,2257,40,2,4,6,33.3%,53m
11539,2,Marius,2256,388,51,64,115,44.3%,6m
11539,3,ChikiPuki,2256,118,7,9,16,43.8%,34m
11539,1,[SECT4]EltioZeratul,2256,221,5,7,12,41.7%,1h
11539,3,MMRGiver,2256,122,3,6,9,33.3%,1h
11539,1,Thorby,2256,0,1,5,6,16.7%,1h
11544,2,[AllyPG]Smittyblack,2255,0,3,0,3,100.0%,1h
11544,1,[E8]Kelvinator,2255,92,3,3,6,50.0%,3h
11544,1,marceloco,2255,88,3,3,6,50.0%,16m
11544,1,Descendant,2255,0,2,7,9,22.2%,1h
11544,1,David,2255,0,1,0,1,100.0%,3h
11544,3,TUBESTEAK,2255,0,1,1,2,50.0%,36m
11544,1,AngryP,2255,0,1,5,6,16.7%,1h
11544,1,KamikazeDuck,2255,0,0,1,1,0.0%,25m
11552,1,[brenst]archsten,2254,0,2,7,9,22.2%,37m
11552,1,Gyro,2254,40,2,7,9,22.2%,3h
11552,2,spiritx,2254,0,1,2,3,33.3%,1h
11552,2,vicente,2254,0,1,4,5,20.0%,49m
11552,1,[KoT]Zava,2254,0,0,1,1,0.0%,1h
11552,1,gboy,2254,0,0,2,2,0.0%,40m
11558,1,SenArrow,2253,1423,87,102,189,46.0%,12m
11558,1,[cluez]kramos,2253,822,30,29,59,50.8%,58m
11558,1,jaipeso,2253,966,30,29,59,50.8%,1h
11558,2,Terere,2253,145,8,15,23,34.8%,46m
11558,1,PhilMcGlackn,2253,48,4,7,11,36.4%,15m
11558,1,[iTE]Jed,2253,42,2,0,2,100.0%,1h
11558,1,Thebigdragon,2253,38,1,2,3,33.3%,12m
11558,1,MANU,2253,85,1,2,3,33.3%,1h
11566,3,FXC,2252,1551,263,266,529,49.7%,3h
11566,3,ToneOSarcasm,2252,674,25,24,49,51.0%,32m
11566,3,SiNtEcLaDo,2252,505,24,30,54,44.4%,45m
11566,3,killgun,2252,249,8,12,20,40.0%,1h
11566,1,Dabby,2252,44,4,3,7,57.1%,1h
11566,1,cheekywanker,2252,0,2,4,6,33.3%,15m
11566,1,[EvnKrg]Aigis,2252,0,1,0,1,100.0%,16m
11566,1,gtfobish,2252,44,1,3,4,25.0%,3h
11574,2,Viper,2251,1475,143,147,290,49.3%,20m
11574,1,EchoShib,2251,813,27,24,51,52.9%,53m
11574,1,DingusKhan,2251,591,19,20,39,48.7%,3h
11574,3,dellano,2251,124,7,9,16,43.8%,1h
11574,1,[OlNA]Olimpos,2251,248,6,12,18,33.3%,1h
11574,1,[icekin]greghatch,2251,96,2,3,5,40.0%,51m
11574,2,bmt,2251,46,1,5,6,16.7%,19m
11581,1,[MIDMX]Ale,2250,1563,89,94,183,48.6%,25m
11581,1,CharlieBrown,2250,478,17,15,32,53.1%,59m
11581,1,[SOAF]TANDemonium,2250,242,6,4,10,60.0%,59m
11581,1,Metal,2250,90,2,4,6,33.3%,3h
11581,1,[P3T3S]Avicknash,2250,48,1,7,8,12.5%,29m
11586,1,encRoach,2249,751,43,11,54,79.6%,3h
11586,2,[xSOB]waterblades,2249,528,40,50,90,44.4%,1h
11586,1,[DayVay]Taytay,2249,261,29,6,35,82.9%,1h
11586,1,SkolViking,2249,498,12,17,29,41.4%,4h
11586,1,[USplan]bobgokou,2249,220,7,4,11,63.6%,33m
11586,1,[WebOS]Tlacoyito,2249,210,6,9,15,40.0%,24m
11586,1,CrispyGT,2249,145,4,2,6,66.7%,4h
11586,1,[ETTE]SkinAndBones,2249,0,3,3,6,50.0%,9m
11586,3,GlazMain,2249,0,1,0,1,100.0%,25m
11595,1,TheRedPepper,2248,732,30,29,59,50.8%,3h
11595,1,Nic,2248,48,2,6,8,25.0%,18m
11595,1,[AKWarr]TimmyVader,2248,91,1,1,2,50.0%,3h
11598,2,ReubenD,2247,1485,141,152,293,48.1%,3h
11598,1,MelonLord,2247,1111,41,39,80,51.2%,31m
11598,1,Jimmy,2247,208,11,15,26,42.3%,43m
11598,1,George,2247,288,9,5,14,64.3%,33m
11598,1,ANoobXD,2247,170,6,5,11,54.5%,1h
11603,1,POOFIAMAFROG,2246,893,42,38,80,52.5%,1h
11603,3,IrishZiggy,2246,60,5,6,11,45.5%,34m
11603,1,[FMX]DarthVader,2246,78,3,1,4,75.0%,27m
11603,2,Trinidad,2246,129,2,5,7,28.6%,44m
11603,1,[1KoN1]ImSoNooB,2246,0,1,0,1,100.0%,50m
11608,1,orko,2245,1596,62,59,121,51.2%,56m
11608,1,GoTime,2245,954,29,34,63,46.0%,25m
11608,1,HiDef,2245,156,6,4,10,60.0%,6m
11608,1,RolandStrife,2245,97,4,3,7,57.1%,1h
11608,2,AzComBaT,2245,0,2,7,9,22.2%,3h
11608,3,Lenion,2245,0,0,2,2,0.0%,53m
11614,1,[An1me1]YouAreClown,2244,259,11,2,13,84.6%,57m
11614,1,Mikman,2244,312,11,14,25,44.0%,1h
11614,1,TeaSnack,2244,171,5,7,12,41.7%,34m
11617,3,[MSUsc2]YuriMM,2243,256,30,33,63,47.6%,7m
11617,1,[SSquad]SubtleStone,2243,808,26,22,48,54.2%,3h
11617,1,Stza,2243,548,26,28,54,48.1%,1h
11617,2,[TpLn]CoachGriffin,2243,144,4,8,12,33.3%,1h
11617,1,Zero,2243,164,3,7,10,30.0%,1h
11617,3,[3pro5u]Andresaurio,2243,97,2,7,9,22.2%,35m
11617,1,LIKASOHMBODE,2243,0,0,1,1,0.0%,27m
11617,1,DTBshadow,2243,73,0,2,2,0.0%,3h
11625,1,JerryJones,2242,1026,46,43,89,51.7%,1h
11625,1,[LCE]LexJauregui,2242,1168,39,38,77,50.6%,18m
11625,1,[DRUNKN]ILuvZergling,2242,394,11,17,28,39.3%,1h
11625,2,[pobhla]ficcus,2242,0,1,0,1,100.0%,4m
11625,1,Fatal,2242,0,1,6,7,14.3%,56m
11625,1,[Apinks]Apink,2242,0,0,1,1,0.0%,1h
11631,1,EGDumB,2241,844,33,26,59,55.9%,4h
11631,1,Shunzilla,2241,797,28,20,48,58.3%,47m
11631,3,Hsueypooy,2241,176,7,11,18,38.9%,51m
11631,1,Shibanz,2241,135,4,1,5,80.0%,52m
11635,1,ETdeVarginha,2240,1212,40,42,82,48.8%,1h
11635,1,SpoonFedWins,2240,0,1,0,1,100.0%,16m
11635,1,SixFortyK,2240,0,0,1,1,0.0%,20m
11638,1,DeeperCookie,2239,204,6,3,9,66.7%,3h
11638,1,baminurhobo,2239,82,2,2,4,50.0%,15m
11640,3,GermDrunkAxt,2238,996,34,48,82,41.5%,1h
11640,1,FrenziedMonk,2238,515,19,25,44,43.2%,4h
11640,3,AromaticOoze,2238,434,15,21,36,41.7%,3h
11640,1,[SMV]NullPointer,2238,122,5,6,11,45.5%,1h
11640,2,uFFoZ,2238,0,2,1,3,66.7%,1h
11640,1,[catcat]Anubis,2238,38,1,6,7,14.3%,55m
11646,3,Indra,2237,244,9,14,23,39.1%,52m
11646,1,Crown,2237,128,5,7,12,41.7%,33m
11646,2,Phenom,2237,46,1,5,6,16.7%,49m
11646,1,[FLEXXX]Yoomee,2237,0,1,5,6,16.7%,1h
11650,3,Stock,2236,1519,166,172,338,49.1%,1h
11650,1,mikiemanna,2236,1804,156,158,314,49.7%,16m
11650,3,EllenRipley,2236,1031,68,71,139,48.9%,32m
11650,1,Lectus,2236,438,12,14,26,46.2%,3h
11650,3,SPIKE,2236,30,3,8,11,27.3%,4h
11650,1,ebuzz,2236,0,1,5,6,16.7%,4h
11650,2,fuzzylogic,2236,46,1,5,6,16.7%,34m
11650,1,uncleDumDum,2236,44,1,8,9,11.1%,58m
11650,1,Gonzerelli,2236,0,0,4,4,0.0%,1h
11659,3,llllllllllll,2235,1375,572,622,1194,47.9%,4h
11659,1,Scars,2235,396,15,17,32,46.9%,48m
11659,1,SmallDragon,2235,149,10,16,26,38.5%,58m
11659,1,Pfayze,2235,122,4,4,8,50.0%,20m
11659,3,Yolonda,2235,0,1,6,7,14.3%,12m
11659,3,GrandLarsony,2235,0,0,1,1,0.0%,1h
11665,1,Dimitri,2234,594,21,22,43,48.8%,25m
11665,1,RAMZABERL,2234,484,18,17,35,51.4%,1h
11665,1,riskybadger,2234,156,5,11,16,31.2%,1h
11665,1,Monteclinto,2234,0,3,2,5,60.0%,53m
11665,1,Adama,2234,139,2,1,3,66.7%,1h
11665,2,OSI,2234,0,2,1,3,66.7%,11m
11665,2,MrMisterMan,2234,115,2,4,6,33.3%,3h
11665,1,playergone,2234,40,1,5,6,16.7%,1h
11673,1,troy,2233,693,33,38,71,46.5%,8m
11673,2,[nbgPH]SumBer,2233,170,8,14,22,36.4%,1h
11673,1,Obanana,2233,108,3,6,9,33.3%,1h
11673,1,[KCCO99]scruffynerd,2233,86,2,5,7,28.6%,37m
11673,2,YouSAYWHAT,2233,0,2,7,9,22.2%,1h
11673,1,[LMI42]DyE,2233,0,1,0,1,100.0%,1h
11673,3,KruLL,2233,0,1,6,7,14.3%,43m
11680,1,Deathbringer,2232,696,27,23,50,54.0%,8m
11680,1,Thor,2232,427,25,6,31,80.6%,8m
11680,1,YouNeedLube,2232,209,8,5,13,61.5%,8m
11680,1,Baddie,2232,97,2,6,8,25.0%,3h
11680,1,AlphaWhiskey,2232,0,1,1,2,50.0%,1h
11680,2,youngbouzin,2232,0,1,4,5,20.0%,1h
11686,1,tijay,2231,1530,109,108,217,50.2%,3h
11686,1,[GRNSKN]StarFireX,2231,1182,51,50,101,50.5%,13m
11686,1,Thesboi,2231,326,34,22,56,60.7%,52m
11686,1,Happytaco,2231,692,20,22,42,47.6%,12m
11686,1,Caleb,2231,42,2,2,4,50.0%,8m
11691,1,NuttinFivin,2230,1794,124,117,241,51.5%,20m
11691,1,[MeanM]Alaren,2230,430,14,13,27,51.9%,34m
11691,3,StarLegions,2230,241,9,11,20,45.0%,1h
11691,1,Kristjan,2230,36,2,4,6,33.3%,60m
11691,1,MrThirtyAPM,2230,0,2,4,6,33.3%,54m
11691,3,[LoNG]slinkywinky,2230,30,1,1,2,50.0%,1h
11691,1,NikoN,2230,0,1,5,6,16.7%,49m
11691,1,[GDPx]oPkongasaur,2230,0,0,1,1,0.0%,41m
11691,3,HeavyBen,2230,0,0,1,1,0.0%,1h
11700,1,[Tenn]Dagus,2229,442,28,22,50,56.0%,4h
11700,1,ggyo,2229,713,23,16,39,59.0%,24m
11700,1,Valius,2229,248,9,10,19,47.4%,1h
11700,1,ChickVanCluk,2229,96,3,8,11,27.3%,1h
11704,1,BGERO,2228,0,2,3,5,40.0%,4h
11704,2,Epicloud,2228,0,2,6,8,25.0%,20m
11704,1,JohnDeformed,2228,0,0,5,5,0.0%,1h
11704,1,[xABQx]HerrDoktor,2228,0,0,6,6,0.0%,15m
11708,1,Wraydar,2227,987,102,99,201,50.7%,4h
11708,1,IIIIIIIIIIII,2227,768,21,25,46,45.7%,3h
11708,3,DHH,2227,197,5,7,12,41.7%,48m
11708,1,Pato,2227,36,2,3,5,40.0%,1h
11708,1,NoFo,2227,126,2,6,8,25.0%,3h
11708,1,[PobSC]VocaloidBot,2227,42,1,4,5,20.0%,1h
11708,1,TheWaycoKid,2227,0,0,4,4,0.0%,60m
11715,1,killa,2226,1774,104,106,210,49.5%,58m
11715,1,DDS,2226,517,20,17,37,54.1%,12m
11715,2,Justice,2226,319,13,31,44,29.5%,1h
11715,1,Nando,2226,230,9,5,14,64.3%,49m
11715,1,[KhanZ]Twist,2226,261,7,10,17,41.2%,33m
11715,1,jerzy,2226,144,3,3,6,50.0%,56m
11715,1,[WCH69]DMAX,2226,0,1,1,2,50.0%,8m
11715,1,[DNO13]Covfefe,2226,0,1,1,2,50.0%,25m
11715,1,Parthax,2226,0,0,1,1,0.0%,1h
11724,1,[Zno]CaptainTuna,2225,948,31,31,62,50.0%,37m
11724,1,Ilynn,2225,575,23,27,50,46.0%,12m
11724,1,[VETS]DonOmar,2225,0,0,1,1,0.0%,1h
11727,1,slunchy,2224,1421,71,68,139,51.1%,1h
11727,1,Sol,2224,1742,61,67,128,47.7%,50m
11727,1,DoggPiss,2224,1254,54,53,107,50.5%,54m
11727,1,BobLobLaw,2224,122,5,7,12,41.7%,1h
11727,1,LeMoucheur,2224,0,1,1,2,50.0%,1h
11727,1,DameWinPLIS,2224,0,0,5,5,0.0%,16m
11733,3,Moozoo,2223,1417,100,86,186,53.8%,28m
11733,3,HeroGhots,2223,621,96,95,191,50.3%,1h
11733,3,GorillaNUTZ,2223,1364,60,67,127,47.2%,52m
11733,1,Skullbasher,2223,1201,40,38,78,51.3%,1h
11733,1,Marvelous,2223,689,20,18,38,52.6%,33m
11733,1,monkeyM,2223,42,2,2,4,50.0%,37m
11733,1,manox,2223,0,1,6,7,14.3%,1h
11740,2,HeartOfHate,2222,898,97,111,208,46.6%,1h
11740,1,nadir,2222,1650,91,96,187,48.7%,1h
11740,1,princess,2222,1754,60,71,131,45.8%,54m
11740,3,Babyimreal,2222,1453,57,67,124,46.0%,12m
11740,1,liquidsnake,2222,86,2,2,4,50.0%,3h
11740,1,Bugachug,2222,0,2,3,5,40.0%,41m
11740,1,SixWizards,2222,0,2,6,8,25.0%,1h
11740,1,Arthael,2222,0,0,1,1,0.0%,12m
11740,2,Kraytin,2222,0,0,1,1,0.0%,3h
11749,1,Neo,2221,1388,50,53,103,48.5%,1h
11749,1,Purple,2221,385,12,9,21,57.1%,6m
11749,1,GoodKnight,2221,153,5,1,6,83.3%,12m
11749,1,buzz,2221,154,5,9,14,35.7%,1h
11749,1,Laggan,2221,106,3,6,9,33.3%,1h
11749,1,Maqquiez,2221,0,1,4,5,20.0%,3h
11755,1,lloydxmas,2220,1611,275,274,549,50.1%,3h
11755,1,[000s]arn,2220,1359,77,85,162,47.5%,12m
11755,1,MathFerret,2220,922,33,26,59,55.9%,1h
11755,2,Index,2220,218,9,13,22,40.9%,3h
11755,1,OldSchool,2220,124,4,4,8,50.0%,23m
11755,1,Loreene,2220,0,3,3,6,50.0%,1h
11755,1,Slaytanic,2220,0,1,0,1,100.0%,3h
11762,1,[LEZZ]Delta,2219,908,94,104,198,47.5%,1h
11762,1,Kerrigan,2219,284,10,10,20,50.0%,1h
11762,1,Kevincito,2219,124,4,4,8,50.0%,56m
11762,1,JoRdHiZiTo,2219,164,3,6,9,33.3%,1h
11762,1,Alex,2219,145,3,7,10,30.0%,45m
11762,1,juanyolo,2219,0,1,7,8,12.5%,1h
11768,1,TheColtrane,2218,264,14,12,26,53.8%,51m
11768,1,MikeHancho,2218,158,5,5,10,50.0%,3h
11768,1,quique,2218,116,4,4,8,50.0%,41m
11768,1,Rencee,2218,44,3,5,8,37.5%,1h
11768,1,Shinji,2218,0,0,1,1,0.0%,46m
11768,1,JOHNSPARTAN,2218,0,0,2,2,0.0%,4h
11774,1,Majic,2217,842,26,27,53,49.1%,3h
11774,2,[Khron]RavenwolF,2217,293,11,16,27,40.7%,47m
11774,1,[Ricers]PatrickB,2217,110,3,1,4,75.0%,15m
11774,1,[UFC]GokuChi,2217,0,1,1,2,50.0%,1h
11774,2,Banmanran,2217,46,1,5,6,16.7%,1h
11774,1,Albinosmurfs,2217,0,1,6,7,14.3%,1h
11780,1,RAG,2216,1734,196,187,383,51.2%,6m
11780,3,Sklea,2216,1468,77,80,157,49.0%,31m
11780,3,[lowAPM]Somuchtosay,2216,936,44,37,81,54.3%,1h
11780,3,Kamaaiana,2216,610,41,51,92,44.6%,31m
11780,1,Platano,2216,0,3,4,7,42.9%,49m
11780,2,Adama,2216,46,2,4,6,33.3%,1h
11786,3,Otocani,2215,941,41,50,91,45.1%,5m
11786,1,Arturus,2215,88,5,2,7,71.4%,3h
11786,2,Etrain,2215,0,2,0,2,100.0%,4m
11786,1,Serral,2215,128,2,2,4,50.0%,1h
11786,1,Alkaia,2215,0,1,0,1,100.0%,27m
11786,2,redzax,2215,46,1,5,6,16.7%,4h
11792,1,FBSUPER,2214,385,16,13,29,55.2%,8m
11792,1,BarneyRumble,2214,396,9,10,19,47.4%,1h
11792,1,MendoSlay,2214,0,1,0,1,100.0%,6m
11792,1,electric,2214,0,0,1,1,0.0%,1h
11792,1,Losche,2214,0,0,1,1,0.0%,1h
11797,1,TiananmenV,2213,610,19,23,42,45.2%,1h
11797,1,JosepheXDF,2213,402,13,16,29,44.8%,26m
11797,3,Palesticks,2213,282,11,20,31,35.5%,28m
11797,3,Edge,2213,277,8,12,20,40.0%,1h
11801,1,Funkapotamus,2212,866,28,30,58,48.3%,3h
11801,2,IVXX,2212,313,12,6,18,66.7%,1h
11801,1,Abominous,2212,148,7,8,15,46.7%,3h
11801,1,[BlakMa]ATAT,2212,44,2,6,8,25.0%,27m
11801,1,TwoStep,2212,80,2,7,9,22.2%,1h
11806,3,WhiteDwarf,2211,1468,68,65,133,51.1%,1h
11806,1,WOJTEK,2211,315,12,11,23,52.2%,4m
11806,1,Orconte,2211,144,4,9,13,30.8%,55m
11806,2,RAS,2211,0,1,4,5,20.0%,49m
11810,1,Bawkser,2210,1272,50,53,103,48.5%,1h
11810,1,[opWeed]Accelerator,2210,527,22,21,43,51.2%,41m
11810,1,Nooblet,2210,677,21,20,41,51.2%,15m
11810,3,voilierrouge,2210,151,4,9,13,30.8%,18m
11810,2,JuffBB,2210,121,2,1,3,66.7%,29m
11815,1,wwr,2209,1783,111,120,231,48.1%,3h
11815,1,MuTiLaToR,2209,1410,46,52,98,46.9%,15m
11815,1,Leofrancis,2209,876,26,36,62,41.9%,53m
11815,1,cumberland,2209,606,18,22,40,45.0%,59m
11815,2,JackalOprah,2209,406,13,14,27,48.1%,41m
11815,1,DoctorElkay,2209,162,7,11,18,38.9%,49m
11815,2,JOAO,2209,196,6,9,15,40.0%,19m
11815,1,[MCBP2]Master,2209,96,4,6,10,40.0%,1h
11815,1,JEDI,2209,0,1,0,1,100.0%,1h
11815,2,MadVolf,2209,0,0,1,1,0.0%,1h
11815,1,[NM8]Stanler,2209,0,0,2,2,0.0%,3h
11826,3,Battlesteak,2208,1369,90,94,184,48.9%,40m
11826,1,nexus,2208,519,20,11,31,64.5%,33m
11826,1,MyLittlePwny,2208,476,15,13,28,53.6%,3h
11826,1,Kingbrag,2208,168,5,12,17,29.4%,56m
11826,1,DarkHorse,2208,88,2,1,3,66.7%,8m
11831,1,Rieken,2207,1794,87,89,176,49.4%,1h
11831,1,[HENT4l]Cheech,2207,592,19,18,37,51.4%,1h
11831,1,Ittifi,2207,0,3,3,6,50.0%,3h
11831,3,Jul,2207,0,1,0,1,100.0%,20m
11835,1,SANTIJAZA,2206,577,26,14,40,65.0%,1h
11835,1,[Preran]guachimiri,2206,327,9,8,17,52.9%,1h
11835,2,Trystero,2206,180,6,3,9,66.7%,6m
11835,1,UncleMeat,2206,85,3,4,7,42.9%,1h
11835,1,Fireworks,2206,91,1,2,3,33.3%,1h
11840,3,Caedes,2205,1533,670,685,1355,49.4%,40m
11840,1,Kchorro,2205,337,9,10,19,47.4%,3h
11840,1,Rugbydude,2205,0,0,3,3,0.0%,1h
11843,3,Innatious,2204,316,13,21,34,38.2%,40m
11843,1,Bozo,2204,238,7,7,14,50.0%,41m
11843,3,NiceHat,2204,207,6,31,37,16.2%,48m
11843,2,ChuckChunder,2204,0,2,3,5,40.0%,19m
11843,2,[SJT]Billybob,2204,0,1,1,2,50.0%,52m
11848,1,Painwake,2203,602,15,18,33,45.5%,58m
11848,2,WarLard,2203,332,10,5,15,66.7%,1h
11848,1,[ThWhNi]KaitoKid,2203,186,5,9,14,35.7%,3h
11848,2,tino,2203,62,2,1,3,66.7%,1h
11852,1,[xDoGx]Ruben,2202,609,24,25,49,49.0%,3h
11852,1,Bronzor,2202,96,3,7,10,30.0%,1h
11852,1,thedestroyer,2202,0,1,1,2,50.0%,4h
11852,3,LostCause,2202,97,1,2,3,33.3%,1h
11852,1,[cFG]Six,2202,0,1,5,6,16.7%,51m
11857,2,Purgattory,2201,1515,116,117,233,49.8%,41m
11857,1,LUIZ,2201,199,7,3,10,70.0%,11m
11857,2,[M1A5]War,2201,145,6,13,19,31.6%,1h
11857,1,carlotto,2201,148,4,3,7,57.1%,8m
11857,1,[CRaPaN]IIIIIIIIIII,2201,177,3,4,7,42.9%,1h
11862,3,geckocamaro,2200,1354,250,251,501,49.9%,18m
11862,1,peluche,2200,678,20,23,43,46.5%,44m
11862,1,Synkin,2200,516,17,22,39,43.6%,23m
11862,1,foxfire,2200,234,7,13,20,35.0%,8m
11862,1,Veromi,2200,217,4,11,15,26.7%,51m
11862,2,matasanos,2200,0,0,1,1,0.0%,46m
11868,1,[GEZN]Renzel,2199,1802,122,128,250,48.8%,24m
11868,2,[HotRod]Silverscorp,2199,216,9,17,26,34.6%,3h
11868,2,[JUGOS]JGRIMALDI,2199,0,3,2,5,60.0%,6m
11868,3,GambitJr,2199,30,1,1,2,50.0%,6m
11868,1,UNREAL,2199,0,0,3,3,0.0%,3h
11873,1,Orgulthar,2198,1174,38,43,81,46.9%,52m
11873,1,[IBIU]Shadow,2198,848,28,29,57,49.1%,1h
11873,3,sbmc,2198,266,9,15,24,37.5%,1h
11873,1,estrellaporn,2198,164,6,2,8,75.0%,9m
11873,1,[maSC]Jopae,2198,38,1,5,6,16.7%,1h
11873,2,cheeseRus,2198,0,0,1,1,0.0%,1h
11873,1,[DMONlC]DEMONIC,2198,0,0,2,2,0.0%,24m
11880,3,RPG,2197,177,6,11,17,35.3%,16m
11880,1,Aristides,2197,42,2,8,10,20.0%,1h
11882,1,[kolkid]john,2196,622,17,19,36,47.2%,1h
11882,1,beelcraft,2196,346,13,16,29,44.8%,33m
11884,1,mogmaar,2195,1086,38,35,73,52.1%,50m
11884,2,Tehuti,2195,571,22,12,34,64.7%,46m
11884,2,Gilbert,2195,500,20,12,32,62.5%,3h
11884,3,Magnum,2195,608,20,31,51,39.2%,5m
11884,2,TARTA,2195,414,17,21,38,44.7%,1h
11884,2,Tesla,2195,0,3,2,5,60.0%,58m
11884,2,Rodrigo,2195,30,1,1,2,50.0%,19m
11891,3,[GiLLs]Dalton,2194,263,8,12,20,40.0%,10m
11891,1,Weesan,2194,270,7,9,16,43.8%,1h
11891,1,Neurotic,2194,204,5,8,13,38.5%,1h
11891,2,Smokey,2194,0,1,0,1,100.0%,9m
11895,2,[FyH]salomon,2193,64,3,1,4,75.0%,23m
11895,1,JTD,2193,0,3,3,6,50.0%,33m
11895,3,Zentenk,2193,97,1,1,2,50.0%,12m
11895,2,BigTwigy,2193,0,0,1,1,0.0%,38m
11895,1,[viwar]ElUrielOP,2193,0,0,3,3,0.0%,37m
11900,3,Dart,2192,1492,87,93,180,48.3%,30m
11900,1,Stoltis,2192,271,11,4,15,73.3%,57m
11900,2,DrVindaloo,2192,162,6,9,15,40.0%,3h
11900,1,McFlurry,2192,0,1,6,7,14.3%,16m
11900,2,JKGODYT,2192,0,0,1,1,0.0%,6m
11905,1,grass,2191,1131,120,125,245,49.0%,34m
11905,1,Nope,2191,880,28,32,60,46.7%,3h
11905,1,[4L0k0]chokusan,2191,245,6,6,12,50.0%,26m
11905,3,grndfthrprdx,2191,181,5,11,16,31.2%,36m
11905,2,AsuraRage,2191,0,3,2,5,60.0%,1h
11905,2,Elodin,2191,0,0,5,5,0.0%,1h
11911,1,ChaoticBacon,2190,1643,141,136,277,50.9%,33m
11911,1,[LY0]GameMaker,2190,230,7,7,14,50.0%,1h
11913,1,[DT19]LyingCat,2189,1171,39,40,79,49.4%,45m
11913,3,[FatMom]Xenocide,2189,870,30,36,66,45.5%,1h
11913,1,ThePrimeMime,2189,584,18,18,36,50.0%,1h
11913,3,trouvere,2189,381,15,27,42,35.7%,37m
11913,2,Loot,2189,0,0,2,2,0.0%,46m
11918,2,NaCljerky,2188,1392,51,50,101,50.5%,5m
11918,2,chickeneater,2188,1311,48,65,113,42.5%,53m
11918,1,Rives,2188,72,3,8,11,27.3%,60m
11918,3,MrButterBean,2188,0,2,8,10,20.0%,48m
11918,3,Tamashi,2188,95,1,4,5,20.0%,1h
11923,1,Ciciri,2187,1772,560,567,1127,49.7%,1h
11923,3,InsaneDemon,2187,589,36,41,77,46.8%,39m
11923,2,[ChoJAH]TEN,2187,618,27,27,54,50.0%,24m
11923,2,Barrelito,2187,90,7,2,9,77.8%,1h
11923,1,AcmeDystopia,2187,196,5,11,16,31.2%,54m
11923,1,[xeMgx]PepperMaromi,2187,120,4,8,12,33.3%,1h
11923,1,Viper,2187,128,4,9,13,30.8%,25m
11923,3,VENOM,2187,0,0,4,4,0.0%,3h
11931,1,[DhZAc1]Kim,2186,534,22,19,41,53.7%,3h
11931,2,Quixoticelix,2186,0,2,3,5,40.0%,15m
11931,1,Zuthanatos,2186,0,1,1,2,50.0%,3h
11931,3,MrMoon,2186,0,0,4,4,0.0%,46m
11935,1,kingpin,2185,1450,49,46,95,51.6%,3h
11935,1,HumbleTiger,2185,121,4,5,9,44.4%,3h
11935,1,GreenCoat,2185,0,1,1,2,50.0%,52m
11935,2,Murdura,2185,97,1,3,4,25.0%,1h
11935,2,[Fir3s]MechMeUp,2185,0,1,5,6,16.7%,1h
11940,3,Veda,2184,1628,60,81,141,42.6%,32m
11940,2,Youfi,2184,784,29,30,59,49.2%,1h
11940,2,Kanzakii,2184,90,3,2,5,60.0%,47m
11940,2,[AGANE]WhiteRook,2184,30,2,1,3,66.7%,4h
11940,1,swootton,2184,94,2,1,3,66.7%,56m
11940,1,[AbcCo]Roy,2184,105,2,4,6,33.3%,25m
11940,2,[Dimand]MenYmaN,2184,32,1,1,2,50.0%,7m
11940,2,Rawr,2184,0,0,1,1,0.0%,50m
11940,1,[SAVGZ]ratchetjaw,2184,0,0,4,4,0.0%,56m
11949,1,Razandul,2183,1161,41,42,83,49.4%,1h
11949,2,IUhead,2183,459,25,3,28,89.3%,3h
11949,1,[LatMex]TiburonRed,2183,590,19,27,46,41.3%,4h
11949,3,[Capvar]Gago,2183,258,11,16,27,40.7%,43m
11949,2,RubberDuckie,2183,199,9,12,21,42.9%,1h
11949,2,[LeMono]PillanTheWte,2183,0,0,1,1,0.0%,1h
11949,2,DMNlord,2183,0,0,2,2,0.0%,58m
11956,3,[CHD]LowLander,2182,979,64,82,146,43.8%,1h
11956,2,Cyro,2182,198,7,3,10,70.0%,8m
11956,1,[AbcCo]sopaxx,2182,174,4,12,16,25.0%,10m
11956,2,[GEKO]GusNar,2182,0,2,3,5,40.0%,25m
11956,1,supremo,2182,38,2,4,6,33.3%,3h
11961,2,LynW,2181,481,31,25,56,55.4%,3h
11961,3,[Ash3s]LiTuS,2181,0,1,3,4,25.0%,3h
11963,3,COWBOYS,2180,1527,88,91,179,49.2%,24m
11963,2,West,2180,518,18,20,38,47.4%,10m
11963,1,[UNCUT]Sausage,2180,506,16,14,30,53.3%,13m
11963,1,KHYRIOS,2180,378,11,17,28,39.3%,5m
11963,2,SpaceMarine,2180,34,1,2,3,33.3%,28m
11963,2,OmegaStorm,2180,0,0,1,1,0.0%,6m
11963,1,Tusky,2180,0,0,2,2,0.0%,14m
11963,2,KnifeWrench,2180,0,0,5,5,0.0%,1h
11971,1,Fivelidz,2179,166,7,6,13,53.8%,3h
11971,3,Zebgoraj,2179,215,7,12,19,36.8%,1h
11971,2,KingofCheese,2179,30,4,3,7,57.1%,14m
11971,1,agasm,2179,122,4,7,11,36.4%,50m
11971,2,Gladiator,2179,92,3,3,6,50.0%,43m
11971,2,[GoldPo]TRUEJUSTICE,2179,0,1,4,5,20.0%,42m
11971,2,itsme,2179,46,1,5,6,16.7%,1h
11978,3,Andromedus,2178,256,9,14,23,39.1%,27m
11978,3,llllllllllll,2178,195,6,2,8,75.0%,33m
11978,2,WildPants,2178,30,1,1,2,50.0%,6m
11981,2,Pure,2177,112,5,2,7,71.4%,1h
11981,1,[HOTDAM]Kira,2177,144,4,7,11,36.4%,1h
11981,1,lumpyoats,2177,48,1,3,4,25.0%,1h
11981,1,CHUGGY,2177,0,1,6,7,14.3%,1h
11981,2,leviathan,2177,0,0,1,1,0.0%,1h
11981,2,TAZADAR,2177,0,0,1,1,0.0%,52m
11987,1,FriendlyChem,2176,194,6,7,13,46.2%,33m
11987,3,AiViktor,2176,171,5,11,16,31.2%,20m
11987,1,Sleigher,2176,96,3,8,11,27.3%,15m
11987,1,BloodLeon,2176,88,1,4,5,20.0%,8m
11991,1,droppingload,2175,851,32,33,65,49.2%,3h
11991,3,RODRIG,2175,520,20,27,47,42.6%,31m
11991,2,[XpKAc]Nando,2175,444,15,10,25,60.0%,5m
11991,1,Cornbread,2175,417,14,18,32,43.8%,1h
11991,2,CaptainKyrk,2175,160,6,3,9,66.7%,3h
11991,2,elChule,2175,106,3,2,5,60.0%,43m
11991,1,Jihgfed,2175,42,2,3,5,40.0%,41m
11991,2,lariats,2175,0,1,4,5,20.0%,25m
11999,1,Legolas,2174,746,26,34,60,43.3%,37m
11999,2,FreeBelarus,2174,236,9,4,13,69.2%,1h
11999,2,[TPGGXD]ChristianB,2174,0,3,1,4,75.0%,1h
11999,2,DunksPls,2174,0,2,3,5,40.0%,49m
11999,2,[BAP01]ElChapirete,2174,0,1,3,4,25.0%,5m
11999,1,Trez,2174,0,0,6,6,0.0%,54m
12005,1,Rez,2173,604,61,65,126,48.4%,1h
12005,1,seerfax,2173,916,34,37,71,47.9%,1h
12005,1,[aisg]Temperau,2173,739,31,30,61,50.8%,56m
12005,2,[ZTempz]NeoPeterPan,2173,602,24,14,38,63.2%,1h
12005,1,AbyssTerd,2173,230,7,8,15,46.7%,12m
12005,2,[FTLT]elgranpapu,2173,0,1,0,1,100.0%,1h
12011,3,jevons,2172,826,24,65,89,27.0%,43m
12012,1,nescaltoddy,2171,694,25,23,48,52.1%,42m
12012,1,[URINE]RamMan,2171,183,7,3,10,70.0%,3h
12012,2,[20]George,2171,58,2,3,5,40.0%,1h
12012,2,CarlosObo,2171,0,1,4,5,20.0%,41m
12012,2,[ApmTen]Bronze,2171,0,0,1,1,0.0%,42m
12012,2,Bagel,2171,0,0,1,1,0.0%,15m
12018,2,BeeKing,2170,1585,130,135,265,49.1%,1h
12018,1,[Ace]Morza,2170,1578,78,82,160,48.8%,34m
12018,2,IgnoreTaName,2170,282,11,14,25,44.0%,1h
12021,2,Wedgedtail,2169,1030,42,45,87,48.3%,41m
12021,1,FlyFresno,2169,1173,39,42,81,48.1%,3h
12021,2,CHUCKNORRIS,2169,275,8,16,24,33.3%,1h
12021,3,Sinrob,2169,223,6,9,15,40.0%,16m
12021,3,lnckdave,2169,151,4,6,10,40.0%,1h
12021,3,Muzzinguava,2169,36,1,2,3,33.3%,3h
12027,1,IWILLWIN,2168,1180,37,51,88,42.0%,38m
12027,1,BLACKSMITH,2168,404,16,16,32,50.0%,3h
12027,2,Demento,2168,460,16,25,41,39.0%,1h
12027,1,[LegSC]pichichax,2168,386,10,11,21,47.6%,1h
12027,1,CombatJester,2168,0,1,5,6,16.7%,1h
12027,2,[UMTD]Loser,2168,0,0,5,5,0.0%,25m
12033,1,morgal,2167,414,12,14,26,46.2%,1h
12033,2,lionleaf,2167,164,9,7,16,56.2%,47m
12033,1,dexter,2167,120,4,5,9,44.4%,4h
12036,1,Napal,2166,1702,170,180,350,48.6%,12m
12036,1,PoloPAC,2166,1170,40,45,85,47.1%,4h
12036,1,[0425]NEMO,2166,741,24,28,52,46.2%,1h
12036,1,Octave,2166,423,14,12,26,53.8%,1h
12036,2,[CS0]UndeadPants,2166,330,11,4,15,73.3%,3h
12036,2,RentIsDue,2166,311,10,4,14,71.4%,1h
12036,2,[ROSC2]DIHmaster,2166,0,0,3,3,0.0%,1h
12043,1,Mmadmax,2165,1762,345,372,717,48.1%,56m
12043,1,Stryker,2165,950,65,57,122,53.3%,3h
12043,1,Sheogorath,2165,1336,52,46,98,53.1%,25m
12043,3,Anxthz,2165,128,6,11,17,35.3%,1h
12043,2,[waRp1]GhostBr,2165,0,2,3,5,40.0%,17m
12043,2,Jason,2165,30,1,1,2,50.0%,3h
12043,2,Asmith,2165,94,1,5,6,16.7%,1h
12043,2,Ghost,2165,0,0,1,1,0.0%,1h
12051,1,drcakeman,2164,1222,46,48,94,48.9%,37m
12051,1,mkb,2164,405,18,20,38,47.4%,60m
12051,1,apolo,2164,260,6,9,15,40.0%,3h
12051,3,NAs,2164,30,2,8,10,20.0%,1h
12051,2,Astro,2164,0,1,0,1,100.0%,4h
12051,1,JimRaynor,2164,0,0,2,2,0.0%,37m
12057,2,[GTO4]Infecto,2163,159,4,3,7,57.1%,17m
12057,2,Jayrome,2163,60,2,4,6,33.3%,3h
12057,2,Zues,2163,0,1,0,1,100.0%,46m
12060,1,sly,2162,199,8,19,27,29.6%,11m
12060,2,IMJD,2162,152,6,3,9,66.7%,29m
12060,1,Flicker,2162,78,4,6,10,40.0%,4h
12060,2,PhineasGage,2162,0,1,0,1,100.0%,17m
12060,1,iBurnBridges,2162,0,1,8,9,11.1%,1h
12065,2,Happynec,2161,969,178,178,356,50.0%,3h
12065,2,Archdevil,2161,1197,44,42,86,51.2%,16m
12065,3,MassColoxen,2161,97,2,8,10,20.0%,33m
12065,2,bjai,2161,0,1,0,1,100.0%,49m
12069,1,WilliamTell,2160,1764,172,187,359,47.9%,4h
12069,2,Axse,2160,444,16,21,37,43.2%,1h
12069,1,cRam,2160,218,5,7,12,41.7%,1h
12069,1,terasilfo,2160,150,4,9,13,30.8%,1h
12069,2,Amicus,2160,0,0,2,2,0.0%,1h
12074,2,damianhommie,2159,257,9,13,22,40.9%,10m
12074,2,ThatPZT,2159,171,7,4,11,63.6%,35m
12074,1,Avila,2159,167,5,4,9,55.6%,1h
12074,2,[HIBOYZ]Artanis,2159,140,4,3,7,57.1%,3h
12078,1,BattleBreakr,2158,322,10,14,24,41.7%,4h
12079,1,BigBearHBz,2157,1398,45,55,100,45.0%,1h
12079,1,Ozzten,2157,880,30,31,61,49.2%,1h
12079,1,Slyndovv,2157,259,10,9,19,52.6%,23m
12079,2,jamwheeler,2157,60,2,2,4,50.0%,41m
12083,2,aecoz,2156,296,13,20,33,39.4%,4m
12083,1,Jhoncyto,2156,0,1,1,2,50.0%,1h
12085,1,Chips,2155,1641,120,119,239,50.2%,50m
12085,3,KonSpiral,2155,1263,58,75,133,43.6%,3h
12085,1,Grpyhn,2155,1014,36,40,76,47.4%,4h
12085,2,Niki,2155,142,5,6,11,45.5%,1h
12085,2,JMFV,2155,0,1,1,2,50.0%,3h
12085,2,Joshie,2155,0,1,4,5,20.0%,1h
12085,2,[EPCK]joaquinad,2155,0,1,4,5,20.0%,1h
12085,1,AlmiusJuez,2155,0,1,5,6,16.7%,3h
12093,3,starkilla,2154,832,193,197,390,49.5%,37m
12093,2,DamageZero,2154,1649,133,143,276,48.2%,1h
12093,1,Kinged,2154,448,12,19,31,38.7%,1h
12093,2,[Daimyo]Draconis,2154,64,2,1,3,66.7%,1h
12093,2,Phuhque,2154,143,2,5,7,28.6%,31m
12098,1,[LAN]sirstabbins,2153,276,9,13,22,40.9%,58m
12098,2,HUEngineer,2153,46,2,2,4,50.0%,11m
12098,1,[Joon]TraweezyJoon,2153,42,2,9,11,18.2%,3h
12098,2,SuperNova,2153,0,0,5,5,0.0%,4m
12102,1,chixxdigit,2152,254,8,11,19,42.1%,1h
12102,2,RIVERA,2152,72,2,1,3,66.7%,1h
12102,2,[IMDSI]Ciceron,2152,30,1,1,2,50.0%,1h
12105,2,[Hulu]TheTrain,2151,1499,104,101,205,50.7%,1h
12105,1,DocGear,2151,448,19,30,49,38.8%,38m
12105,1,[Necron]TheDoomBlade,2151,274,10,11,21,47.6%,1h
12105,1,[LGNxx]IBDomnivore,2151,243,7,8,15,46.7%,1h
12105,3,piter,2151,192,6,11,17,35.3%,32m
12105,1,FOX,2151,190,5,5,10,50.0%,18m
12105,2,[PTHero]MvonLipwig,2151,0,2,1,3,66.7%,15m
12105,1,Francocala,2151,91,2,1,3,66.7%,47m
12105,2,Federcio,2151,0,2,4,6,33.3%,1h
12105,1,Ambrosia,2151,97,2,4,6,33.3%,4m
12115,1,[COPD]YOUNGJUN,2150,1282,44,48,92,47.8%,12m
12115,1,CountcHILD,2150,1100,39,47,86,45.3%,36m
12115,1,Atlas,2150,564,17,19,36,47.2%,1h
12115,2,Vampireking,2150,85,7,5,12,58.3%,24m
12115,2,Torx,2150,134,3,9,12,25.0%,48m
12115,1,Jake,2150,89,2,5,7,28.6%,56m
12115,2,YodaJedi,2150,0,0,1,1,0.0%,38m
12115,2,Thunderthigh,2150,0,0,1,1,0.0%,1h
12115,2,mutabeast,2150,0,0,3,3,0.0%,8m
12124,1,BrewedWar,2149,1558,105,106,211,49.8%,52m
12124,1,UNEVEN,2149,327,12,11,23,52.2%,1h
12124,2,vichomalo,2149,294,10,8,18,55.6%,3h
12124,2,oipers,2149,0,1,4,5,20.0%,1h
12124,1,buzzlow,2149,0,1,7,8,12.5%,9m
12129,1,Surgery,2148,876,26,32,58,44.8%,4h
12129,2,Lucia,2148,0,1,0,1,100.0%,1h
12129,2,Chandika,2148,30,1,1,2,50.0%,3h
12129,2,MonsterTaeny,2148,0,0,5,5,0.0%,1h
12133,1,Zaid,2147,949,28,33,61,45.9%,1h
12133,1,RideTheTiger,2147,350,10,18,28,35.7%,1h
12133,2,Ulgrim,2147,145,7,18,25,28.0%,9m
12133,1,Drovan,2147,128,5,8,13,38.5%,17m
12133,2,Tormenta,2147,62,2,4,6,33.3%,58m
12133,1,Crownlyi,2147,0,1,7,8,12.5%,3h
12133,2,OptimusPrime,2147,0,0,2,2,0.0%,3h
12133,1,rodemito,2147,0,0,4,4,0.0%,50m
12141,1,MaruJR,2146,777,27,26,53,50.9%,1h
12141,2,[ChiFan]Apophis,2146,265,11,10,21,52.4%,3h
12141,1,LaserTime,2146,254,7,20,27,25.9%,34m
12141,2,Fraaan,2146,152,6,4,10,60.0%,47m
12141,1,[TUSS]RacerC,2146,143,3,4,7,42.9%,3h
12141,1,[Wehavu]Qetzc,2146,48,1,3,4,25.0%,1h
12141,2,Starflyer,2146,0,0,2,2,0.0%,6m
12141,3,[SCMK]Negas,2146,0,0,5,5,0.0%,1h
12149,3,BestTaricNA,2145,32,3,8,11,27.3%,3h
12149,1,jmgzch,2145,0,0,1,1,0.0%,1h
12151,2,DiazSichbear,2144,1430,57,64,121,47.1%,5m
12151,1,lmcfirst,2144,874,30,25,55,54.5%,1h
12151,3,TriAngles,2144,516,22,26,48,45.8%,26m
12151,2,[Bahu]LionCubChubb,2144,46,3,4,7,42.9%,44m
12151,2,[Av0c]Pandasaurus,2144,0,1,4,5,20.0%,39m
12156,3,[JDG]kretoz,2143,716,27,42,69,39.1%,1h
12156,2,Brayden,2143,0,4,1,5,80.0%,1h
12156,2,[cluez]Drako,2143,0,3,2,5,60.0%,1h
12156,2,[UAK]Deries,2143,99,2,3,5,40.0%,3h
12156,1,UndeadChew,2143,0,2,4,6,33.3%,1h
12161,2,Elias,2142,551,28,22,50,56.0%,41m
12161,1,Cavewert,2142,358,13,23,36,36.1%,3h
12161,1,[TheRs]Prometheus,2142,304,9,18,27,33.3%,54m
12161,2,[nucrer]Lufe,2142,122,4,2,6,66.7%,3h
12161,2,Stonecitizen,2142,0,0,5,5,0.0%,44m
12166,2,[Dr55]DRACOBET,2141,761,38,39,77,49.4%,3h
12166,2,ElmoStinky,2141,496,20,19,39,51.3%,1h
12166,2,TheSenate,2141,450,17,12,29,58.6%,46m
12166,2,STRYKER,2141,0,0,6,6,0.0%,1h
12166,1,XMAN,2141,0,0,7,7,0.0%,1h
12171,1,CUBANS,2140,803,33,37,70,47.1%,1h
12171,2,TicketyBoo,2140,522,20,12,32,62.5%,1h
12171,3,Anubis,2140,467,18,23,41,43.9%,1h
12171,1,ShudUpBich,2140,390,11,20,31,35.5%,50m
12171,2,TyTheTemplar,2140,94,3,1,4,75.0%,47m
12171,2,Sin,2140,30,2,3,5,40.0%,3h
12171,2,RaGe,2140,0,2,3,5,40.0%,21m
12171,1,FreshDeli,2140,0,1,3,4,25.0%,1h
12171,2,Bleed,2140,92,1,5,6,16.7%,19m
12180,2,PregoArgtano,2139,369,13,12,25,52.0%,3h
12180,1,Matrek,2139,282,10,13,23,43.5%,10m
12182,1,legion,2138,1613,125,142,267,46.8%,57m
12182,1,RoughNeck,2138,1486,120,125,245,49.0%,1h
12182,3,Jsnkemp,2138,416,14,28,42,33.3%,51m
12182,1,Trek,2138,217,4,10,14,28.6%,1h
12182,1,VirtualDhruv,2138,0,1,0,1,100.0%,54m
12187,2,ArgentiSol,2137,1605,108,109,217,49.8%,3h
12187,1,McLOVIN,2137,1692,60,66,126,47.6%,24m
12187,1,TerranYouUp,2137,1154,38,47,85,44.7%,12m
12187,1,[AbcCo]alpaco,2137,409,13,23,36,36.1%,3h
12187,2,Kinuven,2137,125,4,7,11,36.4%,39m
12187,2,[EpicG]FraNChiLeNo,2137,0,3,2,5,60.0%,1h
12187,2,chemao,2137,0,1,5,6,16.7%,1h
12187,2,Evig,2137,0,1,5,6,16.7%,4m
12187,1,IcemanMat,2137,42,1,14,15,6.7%,37m
12196,1,[F4H]gatolzm,2136,1581,144,149,293,49.1%,1h
12196,1,Rurikari,2136,1181,43,43,86,50.0%,12m
12196,3,Chileno,2136,125,3,8,11,27.3%,1h
12196,2,Devenwalsh,2136,0,2,3,5,40.0%,30m
12196,1,DarkHunter,2136,36,2,6,8,25.0%,31m
12196,2,Santiago,2136,0,1,0,1,100.0%,5m
12202,2,TomasMalthus,2135,170,5,8,13,38.5%,1h
12202,1,Gil,2135,0,0,2,2,0.0%,4m
12204,1,Killpretty,2134,1510,195,208,403,48.4%,16m
12204,1,Yed,2134,601,39,38,77,50.6%,3h
12204,2,[DaPeep]DarkBullet,2134,266,9,14,23,39.1%,10m
12204,1,Catalou,2134,120,6,5,11,54.5%,1h
12204,2,NASA,2134,98,3,3,6,50.0%,11m
12209,1,LightWolf,2133,287,8,10,18,44.4%,3h
12209,2,Kegerator,2133,0,1,0,1,100.0%,1h
12211,3,[NSushi]APalestino,2132,798,28,35,63,44.4%,46m
12211,2,ROY,2132,358,13,13,26,50.0%,11m
12211,1,Obsolete,2132,267,9,10,19,47.4%,59m
12211,2,kurt,2132,0,0,5,5,0.0%,1h
12215,2,LibHongKong,2131,178,6,3,9,66.7%,1h
12215,2,EXTREMEGAME,2131,66,2,3,5,40.0%,6m
12215,2,[TGosuD]jakeadoo,2131,0,2,3,5,40.0%,35m
12215,2,Dosage,2131,0,0,1,1,0.0%,1h
12219,1,Scoe,2130,1644,153,154,307,49.8%,33m
12219,2,KingDavid,2130,666,26,19,45,57.8%,58m
12219,3,Pers,2130,0,0,3,3,0.0%,54m
12222,1,raynuxs,2129,252,6,5,11,54.5%,1h
12222,2,Alamuerte,2129,0,3,3,6,50.0%,1h
12222,2,PARKER,2129,121,3,4,7,42.9%,1h
12222,1,Sackbutter,2129,36,1,6,7,14.3%,27m
12222,3,neeatstere,2129,0,0,1,1,0.0%,1h
12227,2,Spiro,2128,586,21,18,39,53.8%,1h
12227,1,[DETER]JackOfSpades,2128,0,1,6,7,14.3%,6m
12227,2,Andreas,2128,0,0,5,5,0.0%,1h
12227,2,ZeroAPM,2128,0,0,5,5,0.0%,25m
12231,2,Slartibart,2127,438,17,13,30,56.7%,3h
12231,1,JJboo,2127,286,7,10,17,41.2%,3h
12231,2,THESALTLORD,2127,62,3,1,4,75.0%,3h
12231,2,Angel,2127,0,3,2,5,60.0%,25m
12231,2,tatchka,2127,0,2,3,5,40.0%,1h
12231,1,Tengy,2127,48,2,8,10,20.0%,16m
12231,2,IIIIIIIIIIII,2127,0,1,0,1,100.0%,3h
12231,2,[Sc2Maf]Helz,2127,0,0,1,1,0.0%,3h
12239,2,SHAGUI,2126,114,5,5,10,50.0%,1h
12239,2,Davestator,2126,0,0,5,5,0.0%,1h
12241,1,Gallatin,2125,410,14,30,44,31.8%,4h
12241,2,Ehecatl,2125,244,8,12,20,40.0%,31m
12241,2,SolArgenti,2125,196,5,1,6,83.3%,1h
12241,1,LAWZ,2125,145,3,7,10,30.0%,56m
12241,2,Sarpedon,2125,0,0,1,1,0.0%,1h
12241,2,darkside,2125,0,0,3,3,0.0%,1h
12247,1,Mordent,2124,798,28,31,59,47.5%,4h
12247,2,[x0i]EditiongTe,2124,481,18,19,37,48.6%,17m
12247,2,FSDRKSLDR,2124,202,6,7,13,46.2%,3h
12247,2,[Over1]nikolo,2124,0,1,0,1,100.0%,19m
12247,2,DarthKan,2124,0,1,4,5,20.0%,1h
12247,1,[GGdogs]Postre,2124,0,0,4,4,0.0%,1h
12253,2,xuniverseIVG,2123,88,5,15,20,25.0%,1h
12254,2,Rhodoknight,2122,430,12,27,39,30.8%,3h
12254,2,[zerg39]DXG,2122,32,2,0,2,100.0%,19m
12254,2,deakdollars,2122,0,2,3,5,40.0%,3h
12257,1,[FTLTX]Chaloman,2121,985,35,39,74,47.3%,48m
12257,2,Cokedajoke,2121,0,0,3,3,0.0%,1h
12259,2,Ankhor,2120,64,3,3,6,50.0%,46m
12260,1,ashenskye,2119,348,14,14,28,50.0%,11m
12260,3,gunquistador,2119,256,11,9,20,55.0%,19m
12260,2,MacroCephaly,2119,238,8,6,14,57.1%,1h
12260,1,VanWalker,2119,48,1,4,5,20.0%,3h
12260,1,MisterUwU,2119,32,1,7,8,12.5%,33m
12260,2,daimremREWES,2119,0,0,1,1,0.0%,46m
12260,2,ECSViper,2119,0,0,5,5,0.0%,1h
12267,1,[Bahu]Gelzyme,2118,1386,74,75,149,49.7%,41m
12267,3,ShadoFate,2118,0,0,1,1,0.0%,1h
12267,2,[xRtGac]Beardedragon,2118,0,0,1,1,0.0%,1h
12267,2,AdjutantCore,2118,0,0,2,2,0.0%,45m
12271,3,JohnKimYaY,2117,1480,185,200,385,48.1%,1h
12271,2,[spici]klitmajik,2117,320,11,12,23,47.8%,57m
12271,3,LyrialVision,2117,32,3,10,13,23.1%,1h
12274,2,[tCo9]boyschilling,2116,605,20,23,43,46.5%,3h
12274,1,Architeuthis,2116,130,4,12,16,25.0%,52m
12274,1,eagle,2116,88,3,5,8,37.5%,3h
12274,1,impuls,2116,0,1,7,8,12.5%,33m
12274,2,Damion,2116,0,0,7,7,0.0%,4m
12279,1,theSinned,2115,279,12,16,28,42.9%,1h
12279,1,Yoda,2115,96,2,0,2,100.0%,1h
12279,2,Swampton,2115,0,0,1,1,0.0%,46m
12279,2,SympuLse,2115,0,0,5,5,0.0%,50m
12283,1,Jaben,2114,180,5,7,12,41.7%,3h
12283,1,Swinestein,2114,66,3,5,8,37.5%,1h
12283,2,jackfoo,2114,48,2,6,8,25.0%,1h
12283,2,Whipee,2114,30,1,1,2,50.0%,1h
12283,2,ExtremeJoy,2114,0,0,5,5,0.0%,41m
12288,2,hidepp,2113,1290,52,46,98,53.1%,31m
12288,2,Erick,2113,490,16,20,36,44.4%,3h
12288,1,[C84]Slayer,2113,410,12,17,29,41.4%,1h
12288,1,Jinjer,2113,410,11,21,32,34.4%,1h
12288,1,DeathWeed,2113,276,7,16,23,30.4%,3h
12288,2,FRFLPPSmurf,2113,109,2,6,8,25.0%,25m
12288,2,Antwerp,2113,0,1,2,3,33.3%,3h
12288,2,Mackensen,2113,30,1,6,7,14.3%,49m
12296,1,Fabulouslife,2112,1349,71,76,147,48.3%,53m
12296,2,Ace,2112,566,21,20,41,51.2%,39m
12296,1,SourSquirrel,2112,284,6,9,15,40.0%,1h
12296,3,[MPPA]Indcrist,2112,145,4,2,6,66.7%,55m
12296,2,[Eagle1]WhiteEagle,2112,0,0,3,3,0.0%,34m
12296,2,iWild,2112,0,0,5,5,0.0%,1h
12302,3,Smurfy,2111,382,13,22,35,37.1%,1h
12302,1,[cluez]NolaSaints,2111,80,3,10,13,23.1%,1h
12302,2,MtyThor,2111,30,1,4,5,20.0%,4h
12302,2,Trunko,2111,0,1,5,6,16.7%,38m
12306,1,patron,2110,1656,322,336,658,48.9%,12m
12306,1,iATechnique,2110,455,22,20,42,52.4%,54m
12306,2,WindDemon,2110,418,14,14,28,50.0%,1h
12306,1,Nine,2110,142,7,9,16,43.8%,26m
12306,2,mana,2110,60,2,4,6,33.3%,1h
12306,2,info,2110,0,0,5,5,0.0%,42m
12312,1,ThePresident,2109,116,3,4,7,42.9%,11m
12312,2,Toxic,2109,30,1,1,2,50.0%,3h
12314,2,Chelo,2108,1089,44,39,83,53.0%,1h
12314,3,dreamliner,2108,584,26,39,65,40.0%,18m
12314,2,FLoveShady,2108,362,10,18,28,35.7%,3h
12314,1,Nazares,2108,66,2,6,8,25.0%,3h
12314,1,[RageQr]Vincent,2108,0,0,10,10,0.0%,1h
12319,1,[DFWU]Caveman,2107,1525,65,67,132,49.2%,3h
12319,1,Dandord,2107,741,25,34,59,42.4%,16m
12319,1,[HnTr]Osiris,2107,164,5,12,17,29.4%,41m
12319,1,GHOST,2107,148,4,11,15,26.7%,33m
12319,2,Seraphim,2107,0,0,1,1,0.0%,42m
12319,2,Raven,2107,0,0,3,3,0.0%,3h
12325,1,daddypalps,2106,374,12,17,29,41.4%,1h
12325,3,[R3K]ZhangFei,2106,292,9,24,33,27.3%,18m
12325,1,LagMan,2106,0,2,5,7,28.6%,3h
12325,1,[AbcCo]JorgeReyy,2106,89,2,6,8,25.0%,3h
12325,2,Tarkus,2106,0,1,3,4,25.0%,1h
12325,2,Tvirus,2106,0,0,5,5,0.0%,1h
12331,3,FriskyTango,2105,473,17,28,45,37.8%,1h
12332,2,Mick,2104,1536,83,86,169,49.1%,1h
12332,1,SoulTrigger,2104,126,4,6,10,40.0%,3h
12332,2,RagingPwner,2104,30,1,5,6,16.7%,1h
12335,1,EnemaBagJone,2103,1072,50,50,100,50.0%,1h
12335,1,[HOT69]Moosgoo,2103,654,19,26,45,42.2%,1h
12335,2,Announcers,2103,566,19,29,48,39.6%,1h
12335,2,CashMunie,2103,254,16,13,29,55.2%,46m
12335,1,LWD,2103,378,13,17,30,43.3%,1h
12335,2,GabrielGP,2103,312,9,9,18,50.0%,42m
12335,2,[ILTAI]christopher,2103,251,9,12,21,42.9%,3h
12335,2,elefanteHOT,2103,0,2,4,6,33.3%,35m
12335,2,Marcus,2103,46,1,8,9,11.1%,1h
12335,2,[GRTG]Salerno,2103,0,0,2,2,0.0%,17m
12335,2,GOATS,2103,0,0,2,2,0.0%,1h
12346,2,Minos,2102,184,6,11,17,35.3%,3h
12346,1,Xende,2102,30,1,15,16,6.2%,1h
12348,1,theapocalyps,2101,742,27,27,54,50.0%,4h
12348,2,Salvador,2101,510,20,13,33,60.6%,3h
12348,2,ADGN,2101,339,10,13,23,43.5%,11m
12348,2,king,2101,256,9,8,17,52.9%,1h
12348,2,zellencrak,2101,0,1,2,3,33.3%,11m
12348,2,Waber,2101,0,0,5,5,0.0%,19m
12354,1,MongolKhan,2100,1122,38,40,78,48.7%,3h
12354,2,cuNAHH,2100,136,4,6,10,40.0%,9m
12354,2,Diego,2100,30,1,1,2,50.0%,3h
12354,2,krambola,2100,0,1,1,2,50.0%,50m
12358,2,[TY4GG]FROSTY,2099,1344,284,298,582,48.8%,1h
12358,2,MPHamilton,2099,746,120,119,239,50.2%,50m
12358,1,[OSDHL]FALLEN,2099,601,21,20,41,51.2%,1h
12358,1,Pop,2099,0,0,3,3,0.0%,1h
12362,1,Gerald,2098,719,45,50,95,47.4%,8m
12362,3,llllllll,2098,658,22,33,55,40.0%,59m
12362,1,MidnightXxX,2098,40,4,5,9,44.4%,50m
12362,2,[NO0OBZ]Jbreezy,2098,0,1,0,1,100.0%,19m
12362,2,[Random]Aricartt,2098,0,1,4,5,20.0%,41m
12367,2,[AOTDF]arquintana,2097,670,26,24,50,52.0%,6m
12367,1,Ethan,2097,538,18,25,43,41.9%,3h
12367,1,SharpKnife,2097,178,6,11,17,35.3%,4h
12367,2,SuperNinja,2097,135,5,2,7,71.4%,11m
12367,2,ChaoticNooB,2097,0,1,4,5,20.0%,3h
12367,2,llllllllllll,2097,0,0,5,5,0.0%,1h
12373,3,[Watame]ReinerBraun,2096,1322,306,320,626,48.9%,1h
12373,2,JeffDahmer,2096,540,20,15,35,57.1%,1h
12373,1,Ryujiin,2096,48,2,7,9,22.2%,1h
12373,2,greenstill,2096,0,1,6,7,14.3%,8m
12373,2,GameR,2096,0,0,5,5,0.0%,1h
12378,1,MrGrumpFish,2095,1116,65,79,144,45.1%,33m
12378,2,McJoey,2095,1642,60,74,134,44.8%,1h
12378,1,hotawefulman,2095,577,20,25,45,44.4%,37m
12378,2,[TGosuD]Peacewind,2095,114,4,4,8,50.0%,50m
12378,1,BlueBerryX,2095,114,4,6,10,40.0%,4h
12378,2,ANonimus,2095,88,1,5,6,16.7%,1h
12378,1,WILLBLADE,2095,0,1,7,8,12.5%,53m
12385,2,SnakeEyes,2094,1616,139,140,279,49.8%,3h
12385,1,AndroniusMax,2094,1482,89,99,188,47.3%,1h
12385,1,Slay,2094,515,19,22,41,46.3%,52m
12385,2,MrSparkly,2094,138,5,6,11,45.5%,1h
12385,2,Bearrorist,2094,86,3,2,5,60.0%,1h
12385,2,Lichbich,2094,0,1,4,5,20.0%,1h
12391,1,DirtySavage,2093,96,2,4,6,33.3%,1h
12391,2,BRYANT,2093,96,2,7,9,22.2%,3h
12393,3,ZeroTheFool,2092,1470,197,217,414,47.6%,1h
12393,2,Tovarisch,2092,931,39,31,70,55.7%,24m
12393,2,[PUNDR]TritochHuntr,2092,582,21,24,45,46.7%,39m
12393,2,Pelantaru,2092,30,4,3,7,57.1%,49m
12397,2,MrBeefy,2091,905,73,70,143,51.0%,10m
12397,2,BKLYNWarLord,2091,1134,57,57,114,50.0%,1h
12397,2,Ratcano,2091,300,13,13,26,50.0%,1h
12397,2,Foxtrot,2091,314,11,13,24,45.8%,22m
12397,2,KalTar,2091,94,3,9,12,25.0%,47m
12397,2,Anasazi,2091,0,1,1,2,50.0%,17m
12403,2,[FyHr]leonidas,2090,1311,53,54,107,49.5%,52m
12403,1,cabomita,2090,1024,48,56,104,46.2%,1h
12403,2,GlueSniffer,2090,100,11,14,25,44.0%,7m
12406,3,DrPootytang,2089,1576,568,569,1137,50.0%,14m
12406,2,mrawseht,2089,1334,50,53,103,48.5%,1h
12406,2,nicolas,2089,724,31,27,58,53.4%,1h
12406,2,PapaSmurf,2089,152,7,8,15,46.7%,17m
12406,2,[IrmBRs]valoroso,2089,0,0,2,2,0.0%,31m
12411,2,Red,2088,1286,50,45,95,52.6%,1h
12411,1,[CULTPi]Darth,2088,580,20,24,44,45.5%,6m
12411,2,Zauberer,2088,277,12,16,28,42.9%,50m
12411,2,PandaJer,2088,58,3,6,9,33.3%,1h
12411,2,Ronin,2088,0,2,3,5,40.0%,46m
12411,2,SunTzu,2088,0,1,1,2,50.0%,1h
12411,2,Endoscope,2088,48,1,2,3,33.3%,58m
12418,2,RazAlGhul,2087,331,12,10,22,54.5%,5m
12418,2,synreaper,2087,0,1,3,4,25.0%,1h
12420,1,AKellen,2086,1334,113,116,229,49.3%,41m
12420,2,ritzs,2086,380,13,15,28,46.4%,1h
12420,2,[SBAii1]commshepard,2086,42,4,3,7,57.1%,1h
12420,1,Doomsiren,2086,114,3,7,10,30.0%,53m
12420,2,spiderpig,2086,64,2,5,7,28.6%,1h
12420,2,SuperSpoke,2086,30,1,3,4,25.0%,1h
12426,1,Callipygian,2085,1706,193,219,412,46.8%,45m
12426,2,BunkerWolf,2085,337,11,14,25,44.0%,3h
12426,1,[WB1]Wurst,2085,0,1,6,7,14.3%,7m
12426,1,Gufaza,2085,48,1,7,8,12.5%,20m
12430,1,shadynasty,2084,1045,40,45,85,47.1%,1h
12430,2,Nick,2084,491,20,20,40,50.0%,14m
12430,2,Lattam,2084,466,15,23,38,39.5%,47m
12430,2,MacroKing,2084,102,2,6,8,25.0%,3h
12430,2,kukuro,2084,44,1,4,5,20.0%,45m
12430,2,Dragonbasher,2084,44,1,6,7,14.3%,35m
12430,1,ZOCALEBZRG,2084,0,0,1,1,0.0%,29m
12430,2,KRAMPHUS,2084,0,0,5,5,0.0%,1h
12438,3,volitic,2083,1083,61,69,130,46.9%,4h
12438,2,Odiseo,2083,0,1,0,1,100.0%,7m
12438,2,Kanades,2083,0,1,4,5,20.0%,3h
12438,2,[YUGEPP]MarsellusW,2083,0,0,5,5,0.0%,42m
12442,1,sauce,2082,1536,52,58,110,47.3%,4h
12442,2,ALuCam,2082,322,17,15,32,53.1%,1h
12442,2,WhiteLight,2082,354,15,21,36,41.7%,40m
12442,2,JAML,2082,418,14,13,27,51.9%,11m
12442,2,[ARHO]Shadowbair,2082,239,9,10,19,47.4%,42m
12447,1,CAPTAINSEDM,2081,1385,63,74,137,46.0%,3h
12447,2,BlackWolf,2081,732,32,28,60,53.3%,1h
12447,2,[SSWsk]SSWsk,2081,0,1,2,3,33.3%,1h
12447,2,Jake,2081,0,0,5,5,0.0%,1h
12447,2,TOP,2081,0,0,5,5,0.0%,15m
12452,1,LebronJames,2080,1532,126,131,257,49.0%,1h
12452,2,entropy,2080,1628,79,82,161,49.1%,1h
12452,1,Zetho,2080,250,11,10,21,52.4%,36m
12452,2,RAZAR,2080,184,6,10,16,37.5%,29m
12456,2,Nephilim,2079,698,25,22,47,53.2%,50m
12456,2,ciberninja,2079,32,1,2,3,33.3%,32m
12458,2,BigFatGuy,2078,146,6,14,20,30.0%,53m
12458,1,[Buried]Neonlight,2078,97,1,3,4,25.0%,37m
12458,2,[tLOB]BlackDeath,2078,0,0,2,2,0.0%,35m
12461,1,SirJohnEh,2077,1370,54,50,104,51.9%,1h
12461,2,[FatMom]Unerwunscht,2077,100,4,8,12,33.3%,1h
12461,2,[frthLd]monticristo,2077,98,3,10,13,23.1%,3h
12461,2,NicBlithe,2077,94,1,6,7,14.3%,1h
12461,2,dalbertomtz,2077,0,0,5,5,0.0%,7m
12466,2,PwrOvrwelmng,2076,456,17,15,32,53.1%,50m
12466,2,DarkCrusader,2076,160,4,11,15,26.7%,1h
12468,2,Phyrestryke,2075,34,3,4,7,42.9%,1h
12468,2,Silentstorm,2075,30,2,3,5,40.0%,9m
12470,1,WillxWallace,2074,308,12,7,19,63.2%,1h
12470,1,BouncyBear,2074,236,5,8,13,38.5%,1h
12470,3,lllllll,2074,92,4,11,15,26.7%,1h
12470,2,Bagel,2074,30,1,6,7,14.3%,3h
12470,1,Alzander,2074,0,0,1,1,0.0%,3h
12475,2,RogerThat,2073,351,14,7,21,66.7%,1h
12475,2,DJD,2073,272,10,12,22,45.5%,10m
12475,2,[GEI]HackLord,2073,58,3,4,7,42.9%,1h
12475,3,BigBertho,2073,62,3,9,12,25.0%,35m
12475,2,zeratul,2073,0,2,3,5,40.0%,52m
12475,2,[BrknPp]DaCookie,2073,0,0,1,1,0.0%,1h
12481,2,OtherWay,2072,476,18,20,38,47.4%,1h
12481,1,[TaWa]Nowel,2072,500,16,21,37,43.2%,1h
12481,2,infoattack,2072,263,7,11,18,38.9%,3h
12481,3,[AbcCo]Washovietic,2072,147,4,4,8,50.0%,36m
12481,1,LtDan,2072,0,1,7,8,12.5%,51m
12486,2,Din,2071,872,38,35,73,52.1%,3h
12486,2,[Bahu]CheetahCub,2071,679,26,25,51,51.0%,3h
12486,1,DoctorQ,2071,441,17,32,49,34.7%,1h
12486,2,[TGOOD]Serral,2071,60,3,7,10,30.0%,1h
12486,2,[BlackW]TopNotch,2071,80,3,8,11,27.3%,1h
12486,2,skittleninja,2071,36,2,8,10,20.0%,1h
12486,2,Surge,2071,30,1,4,5,20.0%,3h
12493,2,Chaos,2070,1154,101,99,200,50.5%,1h
12493,2,tylerusmchi,2070,894,29,54,83,34.9%,1h
12493,2,TedSheckler,2070,264,8,11,19,42.1%,1h
12493,2,[OpnL]Cthulhu,2070,124,3,1,4,75.0%,3h
12497,1,NickNate,2069,970,41,43,84,48.8%,56m
12497,2,HDtr,2069,317,13,10,23,56.5%,1h
12497,1,Merodomax,2069,64,4,7,11,36.4%,1h
12497,1,DoomCashew,2069,0,1,7,8,12.5%,1h
12501,2,Dyzzle,2068,874,31,34,65,47.7%,1h
12501,3,[towor]egrot,2068,97,2,1,3,66.7%,1h
12501,3,NinjaGamerTV,2068,119,2,2,4,50.0%,1h
12501,2,[mork]LiquidPaper,2068,27,1,3,4,25.0%,1h
12505,1,[pSC20]ZERO,2067,921,32,36,68,47.1%,11m
12505,2,[Lowko]NinjaOng,2067,510,17,20,37,45.9%,1h
12505,2,[FTFC]NoGimmicks,2067,141,6,5,11,54.5%,1m
12505,2,NEO,2067,86,3,5,8,37.5%,11m
12505,2,Noble,2067,58,2,2,4,50.0%,11m
12505,2,DinoZerg,2067,94,2,5,7,28.6%,1h
12505,2,dunkine,2067,0,0,6,6,0.0%,1h
12512,2,Lunchbox,2066,1244,46,47,93,49.5%,1h
12512,2,[MotW]Happybuttons,2066,249,9,11,20,45.0%,1h
12512,2,PacoBear,2066,222,7,8,15,46.7%,3h
12512,2,Hitchslap,2066,82,5,10,15,33.3%,3h
12512,1,[F2AAA]randomwalk,2066,144,4,6,10,40.0%,16m
12512,2,Garrett,2066,0,2,3,5,40.0%,42m
12518,1,CoyoteTango,2065,164,5,12,17,29.4%,52m
12518,1,JOTARO,2065,72,3,9,12,25.0%,18m
12518,3,MeBadNoMad,2065,0,0,5,5,0.0%,1h
12521,2,forevasilver,2064,724,28,25,53,52.8%,41m
12521,2,RimmJob,2064,144,5,5,10,50.0%,3h
12521,2,Shlongo,2064,0,2,3,5,40.0%,40m
12521,2,[QQQ]doc,2064,88,2,4,6,33.3%,7m
12521,2,Duffenzag,2064,0,0,1,1,0.0%,1h
12521,2,Skatobetho,2064,0,0,5,5,0.0%,52m
12521,3,[noobs4]death,2064,0,0,5,5,0.0%,23m
12528,3,Allezo,2063,1397,363,379,742,48.9%,7m
12528,2,SWOLYxCAT,2063,1498,131,135,266,49.2%,1h
12528,1,Noodels,2063,1659,91,88,179,50.8%,45m
12528,2,DBorgesRS,2063,826,29,32,61,47.5%,9m
12528,2,kini,2063,388,14,12,26,53.8%,42m
12528,2,ThatGuy,2063,236,7,5,12,58.3%,32m
12534,1,Adrian,2062,1067,101,112,213,47.4%,58m
12534,1,CRC,2062,1116,95,99,194,49.0%,3h
12534,2,Ragna,2062,552,22,14,36,61.1%,3h
12534,2,MacZyy,2062,89,2,4,6,33.3%,19m
12534,2,llllllllllll,2062,30,2,5,7,28.6%,47m
12539,2,SoullesS,2061,166,6,1,7,85.7%,1h
12539,2,[NTINE]gabriel,2061,193,4,5,9,44.4%,58m
12539,2,WickyWoo,2061,0,0,2,2,0.0%,3h
12542,2,NotOrious,2060,0,1,0,1,100.0%,1h
12542,2,CARDO,2060,30,1,4,5,20.0%,42m
12542,2,[Metric]saY,2060,0,0,2,2,0.0%,3m
12545,2,plasticfuzz,2059,216,6,8,14,42.9%,1h
12545,1,bobsaget,2059,0,1,6,7,14.3%,53m
12545,1,Enderwigginz,2059,0,1,7,8,12.5%,3h
12548,2,Javo,2058,1619,73,84,157,46.5%,4h
12548,2,donerman,2058,577,40,42,82,48.8%,1h
12548,2,[MyHase]LauraKslng,2058,418,14,19,33,42.4%,8m
12548,2,BattlePants,2058,376,12,22,34,35.3%,47m
12548,3,felon,2058,292,9,15,24,37.5%,1h
12548,2,lui,2058,30,2,2,4,50.0%,2m
12548,2,elcachero,2058,0,1,0,1,100.0%,3h
12548,2,Azgul,2058,0,1,6,7,14.3%,1h
12548,2,SMILE,2058,0,0,1,1,0.0%,1h
12557,1,URUALFA,2057,675,29,28,57,50.9%,1h
12557,1,Colombo,2057,442,14,25,39,35.9%,52m
12557,2,atrydes,2057,196,6,2,8,75.0%,46m
12557,2,seaone,2057,30,2,5,7,28.6%,42m
12557,2,PEEpee,2057,30,1,3,4,25.0%,42m
12557,2,Indistrol,2057,48,1,7,8,12.5%,3m
12563,2,DITO,2056,1422,100,116,216,46.3%,21m
12563,2,Scotch,2056,339,12,13,25,48.0%,1h
12563,2,buddablitz,2056,218,8,8,16,50.0%,1h
12563,1,Yorzh,2056,241,7,10,17,41.2%,1h
12563,2,DrProfessor,2056,60,3,7,10,30.0%,1h
12563,2,Cluntang,2056,0,0,1,1,0.0%,1h
12569,2,WingPlayerSC,2055,501,16,24,40,40.0%,43m
12569,2,Clarence,2055,221,10,2,12,83.3%,2m
12569,2,UncleJeff,2055,180,3,8,11,27.3%,1h
12569,2,INSOLID,2055,0,1,0,1,100.0%,8m
12569,2,JaYeti,2055,0,0,1,1,0.0%,3m
12569,1,DragonFly,2055,0,0,3,3,0.0%,1h
12575,2,Bobby,2054,209,44,52,96,45.8%,3h
12575,2,[Autos]shaka,2054,804,26,35,61,42.6%,1h
12575,1,Midnight,2054,307,11,11,22,50.0%,26m
12575,1,[udcOKI]JimmyJimmy,2054,198,6,12,18,33.3%,51m
12575,1,Vogg,2054,171,6,18,24,25.0%,3h
12575,2,[D4Skin]Armageddon,2054,48,2,9,11,18.2%,1h
12575,2,capthaddock,2054,0,1,5,6,16.7%,4m
12575,2,[Epokhé]Mauro,2054,0,0,1,1,0.0%,1h
12575,2,[oziozi]COLL,2054,0,0,1,1,0.0%,11m
12584,1,ChairmanMeow,2053,525,19,26,45,42.2%,41m
12584,2,hivetyranid,2053,231,7,7,14,50.0%,1h
12584,2,IIIIIIIIIIII,2053,156,6,7,13,46.2%,1h
12584,2,hammerpie,2053,114,5,7,12,41.7%,1h
12584,2,dirtbird,2053,0,3,4,7,42.9%,3m
12584,2,ndclub,2053,30,1,7,8,12.5%,1h
12584,2,gianmarco,2053,0,0,1,1,0.0%,11m
12591,3,Broken,2052,990,33,52,85,38.8%,1h
12591,2,IcedOverSoul,2052,30,1,3,4,25.0%,11m
12593,1,Leo,2051,833,106,113,219,48.4%,6m
12593,3,Tegredy,2051,145,3,10,13,23.1%,51m
12593,2,Deathtowel,2051,42,1,1,2,50.0%,1h
12593,2,themaestro,2051,0,0,2,2,0.0%,1m
12597,1,fredastaire,2050,156,4,4,8,50.0%,18m
12597,2,Ian,2050,0,3,2,5,60.0%,1h
12597,1,Rexor,2050,0,0,1,1,0.0%,46m
12597,3,DJThumpsDawg,2050,0,0,3,3,0.0%,1h
12601,3,Ace,2049,1576,762,969,1731,44.0%,1h
12601,1,[PTT]bluehash,2049,1510,52,66,118,44.1%,1h
12601,2,[FBDPFF]DouglasCP,2049,60,4,4,8,50.0%,1h
12601,2,Cade,2049,48,2,6,8,25.0%,11m
12605,2,Mikey,2048,1321,58,67,125,46.4%,3h
12605,2,Jabrevski,2048,676,24,39,63,38.1%,3h
12607,1,SoSaltySoFU,2047,974,53,54,107,49.5%,1h
12607,1,Herve,2047,202,9,11,20,45.0%,8m
12607,2,Mishra,2047,88,3,9,12,25.0%,41m
12610,2,Matt,2046,320,13,12,25,52.0%,32m
12610,3,Villager,2046,97,1,1,2,50.0%,29m
12610,2,[Gh0sty]Hawk,2046,0,0,2,2,0.0%,1h
12613,1,EmeraldLord,2044,405,14,16,30,46.7%,18m
12613,3,JustSeth,2044,230,9,13,22,40.9%,5m
12613,2,gsrighi,2044,58,2,3,5,40.0%,50m
12616,2,Astor,2043,48,1,7,8,12.5%,49m
12616,2,Nightshade,2043,0,0,1,1,0.0%,28m
12618,2,EEE,2042,1487,79,84,163,48.5%,42m
12618,2,YaMi,2042,708,27,29,56,48.2%,2m
12618,1,Decreed,2042,654,19,37,56,33.9%,18m
12618,2,Accountll,2042,288,11,12,23,47.8%,3h
12618,2,jusn,2042,88,3,1,4,75.0%,1h
12618,2,Epyon,2042,32,2,1,3,66.7%,58m
12618,1,KoolAidLings,2042,144,2,4,6,33.3%,14m
12618,2,Ninja,2042,60,2,8,10,20.0%,32m
12618,2,MrQuintus,2042,0,1,4,5,20.0%,11m
12618,2,Cabruto,2042,0,0,1,1,0.0%,6m
12618,2,MAS,2042,0,0,1,1,0.0%,2m
12629,1,[FatMom]Damien,2041,353,10,16,26,38.5%,1h
12629,2,barto,2041,0,1,0,1,100.0%,1h
12631,1,TomaterBagel,2040,602,69,72,141,48.9%,1h
12631,2,illinem,2040,1268,67,56,123,54.5%,1h
12631,2,Gugnir,2040,1430,59,64,123,48.0%,47m
12631,2,[SBlock]Vergara,2040,1174,54,54,108,50.0%,2m
12631,1,Taskmaster,2040,271,8,16,24,33.3%,1h
12631,2,marquis,2040,121,4,1,5,80.0%,6m
12631,1,Jang,2040,168,4,11,15,26.7%,1h
12631,2,[CCTV]wheresmyktkt,2040,0,2,4,6,33.3%,1h
12631,2,kuro,2040,0,1,0,1,100.0%,25m
12631,2,netcat,2040,0,0,5,5,0.0%,6m
12641,2,Coneylake,2039,1458,97,92,189,51.3%,46m
12641,2,BetaStar,2039,1398,55,50,105,52.4%,38m
12641,2,[VINGAD]Polegar,2039,428,18,19,37,48.6%,1h
12641,2,Aynek,2039,377,17,5,22,77.3%,31m
12641,2,crumb,2039,200,8,8,16,50.0%,1h
12641,2,slunky,2039,172,5,3,8,62.5%,1h
12641,2,SgRedeemer,2039,114,3,1,4,75.0%,42m
12641,2,[Kappa8]Mmbrillo,2039,100,3,7,10,30.0%,3h
12649,2,BLoodspLL,2038,1536,62,64,126,49.2%,1h
12649,2,MrGarrisonx,2038,127,9,13,22,40.9%,3h
12649,2,[DRKDMN]mike,2038,181,7,2,9,77.8%,49m
12649,2,Shadownata,2038,170,5,4,9,55.6%,11m
12649,2,TLOislife,2038,134,5,11,16,31.2%,46m
12649,2,EakeR,2038,102,2,1,3,66.7%,42m
12655,2,kmaradarti,2037,1363,66,71,137,48.2%,41m
12655,2,[AIURxT]elmenas,2037,48,2,0,2,100.0%,1h
12655,3,NCTUmQP,2037,38,1,5,6,16.7%,29m
12658,2,TurdShip,2036,1270,185,206,391,47.3%,1h
12658,2,krung,2036,267,12,17,29,41.4%,29m
12658,2,NoWayOut,2036,202,7,17,24,29.2%,21m
12658,2,mija,2036,192,6,5,11,54.5%,58m
12658,2,Jose,2036,120,5,7,12,41.7%,3m
12658,2,Bob,2036,32,1,2,3,33.3%,3h
12664,1,AlfredPollo,2035,890,30,43,73,41.1%,3h
12664,2,bumberbelly,2035,787,28,38,66,42.4%,3h
12664,2,[Lecka]BonSchlonzoo,2035,437,14,18,32,43.8%,3h
12664,3,kobalt,2035,60,4,12,16,25.0%,36m
12664,1,Lidwarrior,2035,0,0,1,1,0.0%,1h
12664,3,Jackrocks,2035,0,0,5,5,0.0%,1h
12670,1,Exodia,2034,198,5,17,22,22.7%,1h
12670,2,ShowDao,2034,60,2,5,7,28.6%,1h
12670,2,folino,2034,0,1,5,6,16.7%,1h
12670,3,binho,2034,0,0,1,1,0.0%,1h
12670,2,McDidio,2034,0,0,6,6,0.0%,3h
12675,3,AnotherGonzo,2033,1006,41,53,94,43.6%,23m
12675,2,JayAreno,2033,1102,35,48,83,42.2%,46m
12675,2,[ZTemps]IIIIIIIIIIII,2033,746,25,30,55,45.5%,10m
12675,3,[VIRGII]Theone,2033,123,3,2,5,60.0%,6m
12675,1,neo,2033,0,0,7,7,0.0%,37m
12680,2,fizzyelf,2032,625,23,29,52,44.2%,3h
12680,2,Taquache,2032,173,7,2,9,77.8%,24m
12680,3,PREDADOR,2032,180,5,9,14,35.7%,1h
12680,1,DarkHadezs,2032,89,3,2,5,60.0%,1h
12680,2,Gameneededme,2032,120,2,3,5,40.0%,2m
12680,1,legends,2032,30,2,8,10,20.0%,3h
12686,2,ironbum,2031,1552,117,128,245,47.8%,32m
12686,2,PolskiBoi,2031,216,8,6,14,57.1%,1h
12686,2,Donkey,2031,86,3,5,8,37.5%,24m
12686,2,[swaus]katino,2031,0,1,0,1,100.0%,1m
12686,2,matadorx,2031,0,1,5,6,16.7%,25m
12686,2,Ray,2031,0,0,1,1,0.0%,2m
12692,2,StarCars,2030,1265,78,98,176,44.3%,1h
12692,2,Fenny,2030,210,8,9,17,47.1%,1h
12692,2,NickSwisk,2030,192,7,4,11,63.6%,1h
12692,1,TheArtist,2030,209,5,6,11,45.5%,54m
12696,2,[Boboyz]SteveCherry,2029,0,0,3,3,0.0%,1h
12696,2,MSTY,2029,0,0,5,5,0.0%,42m
12698,1,Mogly,2028,1664,87,103,190,45.8%,56m
12698,2,Oikawa,2028,1091,45,45,90,50.0%,1h
12698,2,Ardas,2028,396,16,17,33,48.5%,47m
12698,2,SparkleWater,2028,92,5,14,19,26.3%,1h
12698,2,Allenon,2028,0,1,0,1,100.0%,11m
12698,2,Josa,2028,0,1,1,2,50.0%,3h
12698,2,FriarShaggy,2028,0,0,1,1,0.0%,4m
12698,2,Navolist,2028,0,0,3,3,0.0%,1h
12706,2,Beushore,2027,1106,99,101,200,49.5%,1h
12706,2,Fearsum,2027,1431,61,62,123,49.6%,1h
12706,2,gunty,2027,90,4,4,8,50.0%,3h
12706,2,Jonathan,2027,0,0,7,7,0.0%,2m
12710,2,Bourkes,2026,266,32,36,68,47.1%,11m
12710,2,[Konir]CaptClaymore,2026,433,14,27,41,34.1%,3h
12710,2,[XZL]Mantequilla,2026,88,2,1,3,66.7%,1h
12713,2,Crank,2025,1273,50,53,103,48.5%,47m
12713,3,[Groovy]eryo,2025,116,4,4,8,50.0%,1h
12713,2,adnsaitama,2025,0,2,4,6,33.3%,3h
12713,2,Zacchary,2025,0,0,6,6,0.0%,1h
12717,2,Donkey,2024,213,20,24,44,45.5%,1h
12717,3,Dirk,2024,0,0,2,2,0.0%,21m
12719,1,asd,2023,1682,64,78,142,45.1%,1h
12719,2,GoToSleep,2023,1556,63,63,126,50.0%,7m
12719,3,kyleslizard,2023,180,5,12,17,29.4%,1h
12719,2,OneLazyHero,2023,126,4,9,13,30.8%,1h
12723,3,DrlSgtSykes,2022,634,22,23,45,48.9%,1h
12723,1,Ketheres,2022,134,4,11,15,26.7%,46m
12723,2,Javier,2022,122,3,10,13,23.1%,42m
12726,1,ClanCampbell,2021,1587,59,64,123,48.0%,4h
12726,2,Aramil,2021,408,14,18,32,43.8%,1h
12726,3,Mist,2021,359,13,3,16,81.2%,7m
12726,3,Bobby,2021,336,13,8,21,61.9%,3h
12726,3,WamBamTYCam,2021,88,3,3,6,50.0%,14m
12726,3,CarnZarooks,2021,46,2,1,3,66.7%,1h
12726,1,AlexGrady,2021,48,1,8,9,11.1%,29m
12726,3,JuanVicky,2021,0,0,1,1,0.0%,60m
12734,2,Aomy,2020,244,12,12,24,50.0%,1m
12734,3,[FireNB]DarkEvil,2020,114,6,4,10,60.0%,2h
12734,1,[GGMB]Fritigern,2020,108,5,10,15,33.3%,4h
12734,3,Areusal,2020,0,2,3,5,40.0%,1h
12738,2,[MESCAL]Lelouch,2019,1280,48,52,100,48.0%,3h
12738,1,Ravenbery,2019,451,16,22,38,42.1%,3h
12738,1,RiverWillows,2019,342,8,9,17,47.1%,1h
12738,2,nemesisberry,2019,30,1,3,4,25.0%,41m
12738,3,[TCD]LcrdSnccp,2019,0,0,1,1,0.0%,43m
12738,2,[1944]JazzMan,2019,0,0,2,2,0.0%,16m
12744,1,LEEFFJL,2018,775,30,37,67,44.8%,8m
12744,3,JHOELORD,2018,199,7,13,20,35.0%,59m
12744,3,Dogmar,2018,100,6,0,6,100.0%,3h
12747,1,RaysDtoy,2017,144,6,10,16,37.5%,51m
12747,2,McLegar,2017,0,1,1,2,50.0%,1h
12749,2,[M1D]Relevant,2016,894,32,38,70,45.7%,1h
12749,2,Liberator,2016,58,2,8,10,20.0%,1h
12749,3,LInk,2016,95,1,2,3,33.3%,1h
12749,3,Mako,2016,0,0,1,1,0.0%,3h
12749,2,Diao,2016,0,0,6,6,0.0%,3h
12754,3,[LSDEX6]Naughty,2015,295,24,6,30,80.0%,32m
12754,3,Oorgle,2015,0,1,0,1,100.0%,2h
12754,2,SEEKS,2015,90,1,7,8,12.5%,19m
12757,2,[GFUEL]HandiiMan,2014,297,13,14,27,48.1%,1h
12757,2,FckBTC,2014,112,5,4,9,55.6%,4h
12757,1,Brittle,2014,48,2,9,11,18.2%,9m
12757,3,Zman,2014,0,0,1,1,0.0%,1m
12761,2,jefe,2013,840,31,31,62,50.0%,3h
12761,2,barcode,2013,46,4,6,10,40.0%,3h
12761,2,iRemember,2013,120,4,8,12,33.3%,3h
12761,3,[TPride]FitzWing,2013,0,0,1,1,0.0%,3h
12761,2,XeroFelix,2013,0,0,2,2,0.0%,4h
12766,2,Snake,2012,246,7,12,19,36.8%,1h
12766,2,Minime,2012,114,3,6,9,33.3%,43m
12766,1,GUTSKI,2012,0,0,3,3,0.0%,1h
12769,2,larr,2011,1491,103,114,217,47.5%,11m
12769,2,tharizzla,2011,72,4,15,19,21.1%,1h
12771,1,swole,2010,1539,62,73,135,45.9%,57m
12771,3,MorceGuuu,2010,0,3,1,4,75.0%,59m
12773,2,HughJorgan,2009,1345,58,52,110,52.7%,17m
12773,2,Ray,2009,720,37,32,69,53.6%,1h
12773,2,ziggy,2009,269,9,10,19,47.4%,1h
12773,1,[KABOOM]DALMATiaN,2009,214,6,10,16,37.5%,51m
12773,2,[Yahweh]BaNe,2009,96,2,2,4,50.0%,17m
12773,3,JoeBud,2009,0,0,1,1,0.0%,35m
12779,2,GroMinet,2008,356,11,12,23,47.8%,3m
12779,2,NahueKiller,2008,153,3,8,11,27.3%,1h
12781,1,SARS,2007,193,4,11,15,26.7%,1h
12781,2,Chunko,2007,112,3,9,12,25.0%,1h
12781,3,BLaZeDReaVeR,2007,0,1,0,1,100.0%,6m
12781,2,maxout,2007,30,1,7,8,12.5%,11m
12785,1,SunEPhone,2006,1182,81,84,165,49.1%,4h
12785,1,BASBOIVIN,2006,721,25,31,56,44.6%,34m
12785,1,lllllllllll,2006,710,21,34,55,38.2%,36m
12785,2,Simp,2006,301,10,16,26,38.5%,1m
12785,1,Oscar,2006,239,4,10,14,28.6%,3h
12790,2,llllllllllll,2005,345,22,23,45,48.9%,1h
12791,2,Sulaco,2004,1513,340,373,713,47.7%,1h
12791,2,DontCheeseMe,2004,373,14,15,29,48.3%,1h
12791,3,Emily,2004,336,11,21,32,34.4%,1h
12791,2,degoplay,2004,150,7,10,17,41.2%,1m
12791,3,Woundedghost,2004,121,4,8,12,33.3%,59m
12791,2,vortex,2004,0,0,3,3,0.0%,1h
12797,2,tett,2003,1326,68,81,149,45.6%,3h
12797,2,nimrod,2003,588,22,18,40,55.0%,5m
12797,2,[OBE]SirCharles,2003,562,20,22,42,47.6%,42m
12797,3,lIlllIIIlllI,2003,58,3,0,3,100.0%,1h
12801,2,JulioCezar,2002,1107,45,40,85,52.9%,1h
12801,3,[THESG]IMoGsPrime,2002,269,11,4,15,73.3%,2h
12801,2,OrdoShivtiya,2002,121,6,8,14,42.9%,5m
12801,1,vendettaC,2002,46,2,8,10,20.0%,37m
12801,2,Grimmjow,2002,0,0,4,4,0.0%,1h
12806,2,Trekkie,2001,902,33,37,70,47.1%,29m
12806,3,Eduardo,2001,60,3,1,4,75.0%,36m
12806,3,Andy,2001,0,0,1,1,0.0%,54m
12809,2,[JERKER]Riveara,2000,343,14,13,27,51.9%,1h
12809,2,Cbastianb,2000,228,8,7,15,53.3%,31m
12809,2,SneakyTurtle,2000,202,7,9,16,43.8%,1h
12809,3,ChefCharles,2000,0,0,5,5,0.0%,56m
12813,3,[UtPowr]TopTap,1999,0,1,0,1,100.0%,19m
12813,3,Zut,1999,30,1,3,4,25.0%,32m
12815,1,[SC2Ecu]DeathX,1998,192,5,14,19,26.3%,3h
12816,2,tatsumi,1997,899,50,55,105,47.6%,30m
12816,1,flippinrocks,1997,286,9,14,23,39.1%,1h
12816,3,Bean,1997,168,5,6,11,45.5%,45m
12816,3,[HooX]Hooks,1997,72,2,3,5,40.0%,54m
12820,3,fascist,1996,1398,81,93,174,46.6%,4h
12820,2,DerkaDerka,1996,271,10,9,19,52.6%,19m
12820,2,Zeratul,1996,93,1,5,6,16.7%,1h
12823,2,Cjkmaa,1995,789,57,62,119,47.9%,1h
12823,3,asendedkerri,1995,0,0,1,1,0.0%,45m
12825,2,RodeoFiasco,1994,1078,74,80,154,48.1%,43m
12825,3,cesar,1994,811,31,28,59,52.5%,1h
12825,2,RLCF,1994,664,24,26,50,48.0%,32m
12825,2,patriot,1994,425,16,24,40,40.0%,1h
12825,2,Maxun,1994,60,2,7,9,22.2%,19m
12825,2,Juanes,1994,0,1,1,2,50.0%,2m
12825,2,darkangel,1994,0,0,2,2,0.0%,1h
12832,2,[00SB00]SpItFiRe,1992,457,23,24,47,48.9%,46m
12832,3,Milkman,1992,491,20,18,38,52.6%,1h
12832,1,LucidThought,1992,336,11,19,30,36.7%,4h
12832,1,[VFam2]GeneralTazz,1992,120,5,10,15,33.3%,59m
12832,3,Doc,1992,86,3,2,5,60.0%,3h
12832,3,yazico,1992,0,0,5,5,0.0%,3h
12838,2,krywaj,1991,697,26,28,54,48.1%,29m
12838,2,[OSpros]xclaudiox,1991,0,0,3,3,0.0%,1h
12840,3,[G3O]ShenaniGans,1990,86,3,1,4,75.0%,1h
12841,2,[HI3rd]Paimon,1989,30,5,3,8,62.5%,47m
12841,3,Tuckus,1989,0,0,1,1,0.0%,35m
12843,2,Rilakkuma,1988,884,33,35,68,48.5%,3h
12843,2,[C0NC1L]Woozard,1988,323,10,15,25,40.0%,1h
12843,2,DairyQueen,1988,0,1,6,7,14.3%,45m
12846,2,altazimuth,1987,1574,79,85,164,48.2%,3h
12846,2,Darkdragon,1987,998,70,72,142,49.3%,50m
12846,1,GameAthlete,1987,1464,51,64,115,44.3%,1h
12846,1,Pnkysin,1987,605,21,29,50,42.0%,4h
12846,3,BomberMan,1987,345,10,6,16,62.5%,23m
12846,3,[OPKZ]conceptmatt,1987,0,1,0,1,100.0%,56m
12846,2,[877142]Freefrag,1987,38,1,4,5,20.0%,1h
12846,3,Marranzo,1987,0,0,1,1,0.0%,1h
12854,2,Aegis,1986,1574,116,128,244,47.5%,46m
12854,1,GROZLEX,1986,867,59,66,125,47.2%,8m
12854,3,Keennuts,1986,409,25,1,26,96.2%,19m
12854,3,captainbob,1986,148,5,8,13,38.5%,1h
12854,1,Srslol,1986,142,5,16,21,23.8%,3h
12854,2,detroider,1986,179,4,8,12,33.3%,43m
12854,3,Arshavin,1986,0,0,1,1,0.0%,1h
12861,2,Jackson,1985,1573,121,127,248,48.8%,4h
12861,2,Rico,1985,683,26,29,55,47.3%,49m
12861,2,Stormtrooper,1985,385,17,18,35,48.6%,24m
12861,3,KillerK,1985,70,3,12,15,20.0%,14m
12861,1,VladCanada,1985,0,0,1,1,0.0%,40m
12866,2,IOnlyCheese,1984,1543,1030,1061,2091,49.3%,14m
12866,1,joefish,1984,692,27,31,58,46.6%,4h
12866,3,COLT,1984,314,11,8,19,57.9%,3h
12869,1,DarthUkrarr,1983,1657,338,373,711,47.5%,41m
12869,3,Minzy,1983,949,35,39,74,47.3%,40m
12869,1,ALEXANDR,1983,48,4,6,10,40.0%,1h
12869,3,SiMutada,1983,58,4,12,16,25.0%,1h
12869,2,KingJocko,1983,30,2,3,5,40.0%,24m
12869,3,Collectibles,1983,0,0,5,5,0.0%,49m
12875,3,[Dnwlkr]kmleon,1982,248,10,8,18,55.6%,1h
12875,1,igncar,1982,0,4,5,9,44.4%,1h
12875,3,[Vrcz]KhoKhuayMan,1982,58,2,3,5,40.0%,36m
12878,2,MasterCpu,1981,1187,130,138,268,48.5%,2m
12878,2,Rogue,1981,472,111,127,238,46.6%,29m
12880,2,BlazzinMonk,1980,263,9,15,24,37.5%,7m
12880,1,RokaCola,1980,187,4,6,10,40.0%,20m
12880,3,[Dusky]mexorcist,1980,30,2,19,21,9.5%,10m
12883,3,notebook,1979,706,25,37,62,40.3%,40m
12884,2,cavediver,1978,1581,272,322,594,45.8%,1h
12884,3,[MA50N]crispcheese,1978,124,12,15,27,44.4%,1h
12884,3,Princess,1978,337,11,16,27,40.7%,12m
12884,1,Giancito,1978,290,9,22,31,29.0%,3h
12884,3,Jeeppee,1978,90,3,5,8,37.5%,21m
12889,3,miguel,1977,58,3,5,8,37.5%,1h
12889,2,[FRlDGE]llllllllllll,1977,30,1,5,6,16.7%,43m
12889,3,[GDKND]zorg,1977,0,0,1,1,0.0%,29m
12889,3,InGame,1977,0,0,6,6,0.0%,1h
12893,2,MiltHinton,1976,170,9,13,22,40.9%,43m
12893,2,MGX,1976,0,1,7,8,12.5%,4h
12893,2,grayco,1976,0,0,4,4,0.0%,1h
12893,2,SourceWizard,1976,0,0,6,6,0.0%,1h
12897,2,mike,1975,1026,38,40,78,48.7%,58m
12897,2,INGRICHARD,1975,174,5,8,13,38.5%,25m
12897,3,Hogan,1975,0,0,1,1,0.0%,32m
12897,2,eva,1975,0,0,6,6,0.0%,1h
12901,2,AceInTheFace,1974,228,7,9,16,43.8%,17m
12901,3,Zod,1974,60,2,3,5,40.0%,1h
12901,1,MASTERED,1974,0,1,7,8,12.5%,15m
12901,2,Veterano,1974,0,0,1,1,0.0%,1h
12905,2,Andromeda,1973,1366,65,70,135,48.1%,1h
12905,3,HughMan,1973,1064,35,47,82,42.7%,52m
12905,1,ihateorcs,1973,568,22,23,45,48.9%,1h
12905,2,Lilgyboi,1973,188,20,25,45,44.4%,43m
12905,2,Raffi,1973,498,16,27,43,37.2%,11m
12905,2,GrayToar,1973,404,15,19,34,44.1%,53m
12905,2,pyro,1973,267,9,8,17,52.9%,32m
12905,3,Guns,1973,0,1,4,5,20.0%,23m
12913,1,[MadMON]MELEKAIJOE,1972,1626,150,150,300,50.0%,15m
12913,2,Dezp,1972,121,6,11,17,35.3%,1h
12913,3,naquos,1972,0,1,0,1,100.0%,25m
12916,2,PabloDelaQ,1971,1412,251,280,531,47.3%,3h
12916,2,[PQH]Danauck,1971,388,14,17,31,45.2%,11m
12916,3,enller,1971,172,4,4,8,50.0%,1h
12916,3,CptnBuckaroo,1971,86,3,2,5,60.0%,1h
12916,2,Harveynz,1971,0,3,4,7,42.9%,3m
12916,3,Curtlis,1971,125,2,7,9,22.2%,6m
12916,2,gladiator,1971,0,1,5,6,16.7%,4h
12916,1,HYDROXYZINE,1971,0,1,9,10,10.0%,1h
12924,2,McMoo,1970,86,39,46,85,45.9%,1h
12924,3,kane,1970,30,1,2,3,33.3%,36m
12926,2,Rayek,1969,1404,224,247,471,47.6%,3h
12926,2,Newgen,1969,1494,82,89,171,48.0%,2m
12926,2,[DenSC2]winterwolf,1969,166,5,7,12,41.7%,29m
12926,3,RAmzap,1969,173,4,6,10,40.0%,1h
12926,3,Sirius,1969,58,3,1,4,75.0%,1h
12926,3,Laertes,1969,88,3,3,6,50.0%,46m
12926,2,FlackStar,1969,0,1,6,7,14.3%,49m
12926,3,master,1969,0,0,1,1,0.0%,1h
12926,1,Gunslinger,1969,0,0,2,2,0.0%,16m
12935,2,SpacePirate,1968,971,53,57,110,48.2%,1h
12935,1,liderstarkil,1968,953,35,54,89,39.3%,3h
12935,2,RockFarofa,1968,190,6,16,22,27.3%,1h
12935,1,EverlastingD,1968,131,3,9,12,25.0%,4h
12935,2,GLNoobHF,1968,0,2,4,6,33.3%,1m
12940,2,danger,1967,1196,42,51,93,45.2%,1h
12940,2,Tathos,1967,0,2,5,7,28.6%,9m
12940,3,[ØÛ]greedxgraff,1967,0,1,0,1,100.0%,17m
12940,2,[JBSE]BIGCNL,1967,44,1,3,4,25.0%,21m
12944,3,Heffy,1966,458,17,17,34,50.0%,32m
12944,3,[GRSC]drmetalmaker,1966,88,4,5,9,44.4%,1h
12944,1,[RMU]Pluto,1966,169,3,6,9,33.3%,1h
12944,3,[LY]ARCANGEL,1966,30,2,2,4,50.0%,49m
12944,1,SANGETSU,1966,48,2,6,8,25.0%,54m
12944,3,Tempest,1966,0,0,2,2,0.0%,1h
12944,3,[BrVoS]GuZzOd,1966,0,0,3,3,0.0%,7m
12951,3,Vin,1965,696,25,28,53,47.2%,35m
12951,1,ARGET,1965,535,18,25,43,41.9%,59m
12951,2,Boss,1965,456,16,18,34,47.1%,1h
12951,2,[weedz]Jokeawild,1965,426,14,24,38,36.8%,8m
12951,3,Pumpkins,1965,164,12,11,23,52.2%,1h
12951,3,[Vss]LucaasPakXXX,1965,240,9,13,22,40.9%,17m
12951,2,[PMgaf]GoodUsopp,1965,0,1,0,1,100.0%,1h
12951,2,KingerJJ,1965,88,1,4,5,20.0%,3h
12951,2,CalmMonster,1965,0,0,5,5,0.0%,35m
12960,3,CiRiS,1964,240,9,5,14,64.3%,1h
12960,1,[IRWT]Hairyman,1964,145,5,8,13,38.5%,16m
12960,3,MonkeyDLuffy,1964,30,2,10,12,16.7%,3h
12960,2,[TGosuD]XIACOM,1964,0,0,4,4,0.0%,1m
12964,3,hookersauce,1963,328,14,18,32,43.8%,1h
12964,2,MrBig,1963,271,13,20,33,39.4%,14m
12964,2,Chompiras,1963,90,3,12,15,20.0%,1h
12964,2,Thegubester,1963,0,1,2,3,33.3%,38m
12964,3,Necreport,1963,0,0,5,5,0.0%,1h
12969,3,Philippe,1962,745,28,29,57,49.1%,38m
12969,2,[Gotti]TheBest,1962,0,0,2,2,0.0%,1h
12971,2,happy,1961,678,22,31,53,41.5%,3h
12971,3,juancamaney,1961,278,11,8,19,57.9%,32m
12971,3,[INKA5]Sturm,1961,314,11,13,24,45.8%,43m
12971,3,TheDarcy,1961,238,10,6,16,62.5%,14m
12971,2,WraithRevolt,1961,228,8,19,27,29.6%,30m
12971,2,Spock,1961,162,4,5,9,44.4%,2m
12971,3,TheRavager,1961,0,0,2,2,0.0%,47m
12978,3,MarineGirl,1960,612,28,25,53,52.8%,36m
12978,3,Whion,1960,58,2,6,8,25.0%,1h
12978,2,Grant,1960,0,0,6,6,0.0%,1h
12981,3,BLADEOFGRASS,1959,30,2,2,4,50.0%,49m
12981,2,[xELiTE]Marx,1959,0,0,2,2,0.0%,49m
12981,3,bjmccabe,1959,0,0,3,3,0.0%,6m
12984,3,SwampLord,1958,546,23,21,44,52.3%,59m
12985,2,aZaZel,1957,592,22,27,49,44.9%,34m
12985,2,[VTV]Kraepelin,1957,586,21,32,53,39.6%,41m
12985,2,principiante,1957,280,8,20,28,28.6%,1h
12985,3,[4vs4]RickyDou,1957,67,1,4,5,20.0%,35m
12985,3,BichoMalo,1957,0,0,2,2,0.0%,35m
12990,3,[TPGZ]JakTheRipper,1956,72,4,6,10,40.0%,2h
12991,3,Jarsoft,1955,846,105,107,212,49.5%,1h
12991,3,HoneyBadger,1955,0,0,1,1,0.0%,49m
12993,3,ODBrent,1954,286,10,12,22,45.5%,35m
12993,2,Pheeps,1954,135,4,8,12,33.3%,45m
12993,1,JodbaCarnage,1954,145,3,11,14,21.4%,31m
12996,2,are,1953,0,0,6,6,0.0%,1h
12997,3,MMMMMHOTDOGS,1952,108,5,1,6,83.3%,54m
12998,3,RAVEN,1951,900,32,48,80,40.0%,58m
12998,3,Feanor,1951,88,3,5,8,37.5%,1h
12998,2,Raperomaximo,1951,116,3,13,16,18.8%,1h
12998,3,RebelSzn,1951,0,2,3,5,40.0%,46m
12998,3,[TM69]Shadow,1951,0,0,1,1,0.0%,2h
13003,3,GerhardtJean,1950,60,3,7,10,30.0%,39m
13003,3,[SteppF]Acegamer,1950,30,1,4,5,20.0%,7m
13005,2,CapPicard,1949,220,6,14,20,30.0%,3h
13005,2,Saphron,1949,90,4,9,13,30.8%,5m
13005,3,eldelicioso,1949,0,0,2,2,0.0%,45m
13005,3,Aterrador,1949,0,0,3,3,0.0%,1h
13009,1,Cucowisc,1948,1135,41,60,101,40.6%,1h
13009,3,[Amoove]CptWasabi,1948,386,14,14,28,50.0%,1h
13009,3,wildwolf,1948,290,10,17,27,37.0%,1h
13009,2,AnCutDitMeow,1948,64,2,6,8,25.0%,1h
13009,2,[TYFTRS]Duch,1948,123,2,6,8,25.0%,19m
13009,3,darkangel,1948,30,1,6,7,14.3%,1h
13015,2,Craalb,1947,948,35,40,75,46.7%,17m
13015,1,Suneater,1947,684,24,37,61,39.3%,12m
13017,3,[jerga]shadown,1946,0,0,1,1,0.0%,4m
13018,2,Boarderdude,1945,1430,57,62,119,47.9%,3m
13018,3,TheFvck,1945,198,7,8,15,46.7%,46m
13018,3,[Whamo]Kujo,1945,0,0,1,1,0.0%,46m
13018,2,Maverick,1945,0,0,2,2,0.0%,1h
13022,1,Effectery,1944,1120,43,46,89,48.3%,56m
13022,3,[420SC2]Towel,1944,58,3,0,3,100.0%,60m
13024,3,SUCIODAN,1943,124,5,7,12,41.7%,1h
13024,3,Bloodnut,1943,0,1,0,1,100.0%,1h
13024,3,iLLsKiLLz,1943,0,0,1,1,0.0%,1h
13024,3,Tartinez,1943,0,0,3,3,0.0%,39m
13028,2,zakiro,1941,452,17,21,38,44.7%,1h
13028,3,BigDirt,1941,366,16,20,36,44.4%,1h
13028,2,sqerela,1941,0,0,1,1,0.0%,1h
13028,3,lucidnugget,1941,0,0,4,4,0.0%,1h
13032,2,rubenLm,1940,0,1,6,7,14.3%,1h
13033,3,MrSavage,1939,242,7,9,16,43.8%,2h
13034,3,griffinator,1938,30,1,2,3,33.3%,36m
13034,3,Specter,1938,0,1,4,5,20.0%,46m
13036,2,SeñorSandia,1937,221,5,7,12,41.7%,1h
13036,2,chemwi,1937,0,0,6,6,0.0%,1h
13036,2,superowl,1937,0,0,7,7,0.0%,1h
13039,1,spacebolas,1936,1506,67,86,153,43.8%,10m
13039,2,ArkhamKnight,1936,296,42,47,89,47.2%,1h
13039,3,Ajax,1936,150,5,3,8,62.5%,7m
13039,3,KluverBucy,1936,0,1,4,5,20.0%,1h
13039,3,Biz,1936,0,0,5,5,0.0%,6m
13044,3,Lotus,1935,414,54,58,112,48.2%,1h
13044,2,Errk,1935,302,11,17,28,39.3%,6m
13044,3,McNinjaPro,1935,0,0,1,1,0.0%,36m
13047,2,enzwarlord,1934,1188,42,52,94,44.7%,3h
13047,3,terran,1934,269,8,12,20,40.0%,17m
13047,3,Dirbles,1934,0,1,1,2,50.0%,1h
13047,3,Thunderpain,1934,0,0,1,1,0.0%,46m
13051,2,InnoVaTion,1933,292,11,16,27,40.7%,1h
13051,3,[Pirobo]Maverick,1933,62,2,4,6,33.3%,6m
13051,3,[A1312]entropia,1933,0,1,3,4,25.0%,1h
13051,2,[D4Skin]Warper,1933,0,1,8,9,11.1%,3h
13051,3,IIIIIIIIIIII,1933,0,0,1,1,0.0%,1h
13056,2,august,1932,0,1,0,1,100.0%,11m
13056,2,suparedman,1932,0,0,1,1,0.0%,1h
13058,3,FORECASTER,1931,791,30,28,58,51.7%,1h
13059,1,Avrose,1930,324,10,12,22,45.5%,1h
13059,2,NgaZ,1930,0,2,6,8,25.0%,1h
13059,3,odinthegreat,1930,0,1,8,9,11.1%,34m
13062,3,Azrael,1929,0,1,4,5,20.0%,56m
13062,2,GeneralNeral,1929,0,0,1,1,0.0%,50m
13064,2,RosiesDad,1928,90,4,8,12,33.3%,36m
13064,2,JohninSeitz,1928,46,1,4,5,20.0%,36m
13064,3,[JEDIS]JediWolfPack,1928,0,0,1,1,0.0%,4m
13067,2,KIRK,1927,1534,90,85,175,51.4%,3h
13067,2,totoro,1927,176,6,14,20,30.0%,8m
13067,1,Eziow,1927,186,6,17,23,26.1%,1h
13067,2,taylon,1927,0,0,4,4,0.0%,4h
13071,1,LiLFunNy,1926,1395,65,87,152,42.8%,3h
13071,3,Khal,1926,0,0,5,5,0.0%,3h
13073,3,IBLACKIHEART,1925,900,37,38,75,49.3%,35m
13073,2,badgebomb,1925,0,0,3,3,0.0%,36m
13075,3,SweetT,1924,0,0,1,1,0.0%,36m
13076,2,Ragnarok,1923,740,28,35,63,44.4%,25m
13076,3,pulse,1923,58,2,2,4,50.0%,1h
13076,2,Patrick,1923,93,1,3,4,25.0%,3h
13076,1,[CBAS3]THEDUDE,1923,48,1,7,8,12.5%,54m
13080,3,Kimo,1922,658,24,30,54,44.4%,44m
13081,3,dancer,1921,183,5,8,13,38.5%,54m
13082,2,HumanAnD,1920,1570,384,479,863,44.5%,3h
13082,1,Tainted,1920,1076,65,78,143,45.5%,17m
13082,3,Shakuras,1920,0,0,1,1,0.0%,11m
13082,3,baseballboy,1920,0,0,5,5,0.0%,39m
13086,3,qorsps,1919,86,3,8,11,27.3%,49m
13086,3,Bizling,1919,0,0,5,5,0.0%,59m
13088,3,YogSothoth,1918,280,10,17,27,37.0%,12m
13088,3,highsaac,1918,149,10,17,27,37.0%,52m
13088,2,Samuraiblue,1918,0,1,1,2,50.0%,50m
13091,3,chronic,1917,433,55,58,113,48.7%,1h
13091,3,xDTx,1917,154,5,10,15,33.3%,3h
13091,2,SoulMonster,1917,46,1,5,6,16.7%,3h
13091,3,[Sathus]Sathus,1917,0,0,1,1,0.0%,29m
13095,2,Petamai,1916,1445,84,92,176,47.7%,35m
13095,1,Masterchief,1916,376,12,18,30,40.0%,3h
13097,3,Jerd,1915,30,1,5,6,16.7%,1h
13097,3,Pizza,1915,0,0,1,1,0.0%,1h
13097,2,Guppy,1915,0,0,1,1,0.0%,1h
13097,2,Caustik,1915,0,0,7,7,0.0%,19m
13101,3,joelraynor,1914,932,45,54,99,45.5%,1h
13101,3,Arahgon,1914,48,2,7,9,22.2%,24m
13101,2,dangwheezy,1914,0,0,1,1,0.0%,50m
13104,2,Blaik,1913,340,11,18,29,37.9%,1h
13104,3,[DomFor]BMWMFLY,1913,249,8,8,16,50.0%,35m
13104,3,Teslon,1913,129,2,17,19,10.5%,1h
13104,2,Bheasty,1913,88,1,8,9,11.1%,1h
13104,3,LPMuseFan,1913,0,0,1,1,0.0%,1h
13104,3,[DIKOUT]VincentVega,1913,0,0,1,1,0.0%,39m
13110,1,CharlesXavi,1912,378,12,17,29,41.4%,1h
13111,2,[CRABBR]Soap,1911,181,9,16,25,36.0%,1h
13111,3,YOSVAN,1911,0,0,1,1,0.0%,46m
13113,3,Wilson,1910,0,0,2,2,0.0%,55m
13114,2,Colin,1908,838,43,50,93,46.2%,43m
13114,1,Jepsor,1908,206,7,15,22,31.8%,3h
13116,3,Elíptica,1906,788,29,33,62,46.8%,3h
13116,3,MrPinchley,1906,120,5,5,10,50.0%,52m
13116,2,mistu,1906,0,1,6,7,14.3%,3h
13116,3,Cerberus,1906,0,0,1,1,0.0%,36m
13120,3,sempie,1905,658,27,35,62,43.5%,36m
13120,1,Rauc,1905,301,8,16,24,33.3%,10m
13120,3,Keet,1905,96,1,5,6,16.7%,17m
13123,1,donkaments,1904,1610,87,95,182,47.8%,10m
13123,2,IIIIIIIIIII,1904,274,7,13,20,35.0%,46m
13123,3,dilanquijije,1904,60,3,7,10,30.0%,1h
13123,2,Demo,1904,46,2,1,3,66.7%,1h
13123,3,[7SDS]sevdeadsin,1904,0,0,6,6,0.0%,11m
13128,2,pirataflow,1903,0,0,7,7,0.0%,8m
13128,2,Drakiv,1903,0,0,8,8,0.0%,1h
13130,3,alequei,1902,449,14,20,34,41.2%,1m
13130,2,[Zyzz]Shadowphase,1902,241,7,18,25,28.0%,1h
13130,3,WoolaThark,1902,0,0,2,2,0.0%,1h
13130,2,AshbySan,1902,0,0,5,5,0.0%,11m
13134,2,Superbench,1901,1315,48,69,117,41.0%,58m
13134,2,HuangYaoshi,1901,818,28,40,68,41.2%,47m
13134,1,Spacelord,1901,140,6,15,21,28.6%,1h
13134,3,JackReaping,1901,30,2,4,6,33.3%,1h
13134,3,jimmyazc,1901,0,0,1,1,0.0%,43m
13139,3,MrSatan,1900,194,6,17,23,26.1%,19m
13139,1,TEZA,1900,30,3,9,12,25.0%,18m
13139,1,PomThomas,1900,48,2,7,9,22.2%,1h
13139,3,DEREKUDA,1900,70,2,9,11,18.2%,24m
13143,2,Tiketh,1899,95,1,8,9,11.1%,1h
13143,3,DuneRunner,1899,0,0,6,6,0.0%,1h
13145,3,KomodoDragon,1898,58,3,3,6,50.0%,21m
13146,3,Grifor,1897,983,36,39,75,48.0%,6m
13146,3,jhonn,1897,293,11,14,25,44.0%,35m
13146,1,Scott,1897,180,4,11,15,26.7%,14m
13146,3,Foxhound,1897,90,3,9,12,25.0%,3h
13150,2,Amrak,1896,153,5,9,14,35.7%,8m
13151,3,[UNCCH]BLACKSPACE,1895,451,17,8,25,68.0%,1h
13151,3,[MAUF]Glaxy,1895,30,2,2,4,50.0%,1h
13151,2,AlbyG,1895,0,0,4,4,0.0%,1h
13154,1,rise,1894,1396,82,89,171,48.0%,53m
13154,3,RoedorRM,1894,274,9,18,27,33.3%,14m
13156,1,[KotW]Jadyn,1893,230,5,8,13,38.5%,1h
13156,3,Masser,1893,58,3,2,5,60.0%,17m
13156,3,MAQUIAVEL,1893,60,2,3,5,40.0%,1h
13159,3,TangoFox,1892,1586,71,73,144,49.3%,1h
13159,3,imp,1892,1195,40,65,105,38.1%,17m
13159,1,Constantine,1892,778,24,36,60,40.0%,1h
13162,1,Svein,1891,160,4,12,16,25.0%,25m
13162,3,Draco,1891,119,3,4,7,42.9%,1m
13164,1,MSQUAD,1890,934,59,84,143,41.3%,3h
13164,2,Jamz,1890,514,32,41,73,43.8%,1h
13164,3,SpaceLemming,1890,151,6,9,15,40.0%,2h
13164,3,TANKSHOW,1890,0,0,5,5,0.0%,1h
13168,2,Fasco,1889,0,1,3,4,25.0%,25m
13168,3,[ACTKK2]Rhynozeronte,1889,48,1,6,7,14.3%,1h
13170,2,KingTofu,1888,905,97,99,196,49.5%,1h
13171,2,AaroC,1887,622,20,34,54,37.0%,50m
13171,1,SolidM,1887,216,7,27,34,20.6%,22m
13173,2,Fredwet,1886,1312,78,101,179,43.6%,53m
13173,2,[TY4GG]Grandma,1886,303,12,12,24,50.0%,47m
13173,2,Cakeboss,1886,225,7,9,16,43.8%,1h
13173,3,Sraw,1886,66,3,4,7,42.9%,21m
13173,2,BRANDOON,1886,0,0,1,1,0.0%,1h
13178,3,neverforget,1885,0,0,1,1,0.0%,1h
13179,2,BigParma,1884,352,12,20,32,37.5%,3h
13179,3,SleepyBear,1884,0,0,2,2,0.0%,43m
13181,2,[MaxWin]FrozenG,1883,993,54,61,115,47.0%,1h
13181,3,Zeus,1883,0,0,6,6,0.0%,44m
13181,2,[DSU]bullfrog,1883,0,0,8,8,0.0%,17m
13184,3,sTrAnGeBiRd,1882,142,4,5,9,44.4%,1h
13185,3,TUNALAG,1881,0,0,4,4,0.0%,46m
13186,3,AFO,1879,0,0,1,1,0.0%,1h
13187,3,LetrasLibres,1878,323,12,11,23,52.2%,60m
13187,2,Tru,1878,295,9,22,31,29.0%,10m
13187,3,ZeratuL,1878,184,5,6,11,45.5%,1h
13190,1,Hucrot,1877,292,10,16,26,38.5%,1h
13190,3,Irick,1877,257,8,20,28,28.6%,1h
13190,3,[TSBr2]ShangTsung,1877,118,5,6,11,45.5%,1h
13193,2,[Batmn]LeetroyJnkns,1875,408,13,27,40,32.5%,1h
13194,2,BolsonaroRJ,1874,1529,190,216,406,46.8%,1h
13194,2,Joshicus,1874,220,8,10,18,44.4%,2m
13194,3,Saotand,1874,172,5,4,9,55.6%,36m
13194,3,UShouldQuit,1874,0,0,2,2,0.0%,3h
13198,1,Phoenix,1873,88,3,10,13,23.1%,56m
13198,3,[VFam2]SneakyPanda,1873,0,0,1,1,0.0%,55m
13200,2,Branboom,1872,1021,59,69,128,46.1%,21m
13200,3,Naaarf,1872,0,1,5,6,16.7%,3h
13200,1,[Hellal]hellalhuya,1872,0,1,8,9,11.1%,1h
13203,3,Apollyon,1871,1508,275,318,593,46.4%,1h
13203,2,Floridian,1871,506,18,27,45,40.0%,3m
13203,3,Raflitz,1871,152,7,4,11,63.6%,34m
13203,2,Jakan,1871,88,3,10,13,23.1%,1h
13207,3,fredoren,1870,0,0,1,1,0.0%,28m
13208,2,KAPUA,1869,1494,66,78,144,45.8%,2m
13208,3,Zexonith,1869,170,5,2,7,71.4%,54m
13208,2,[NePe]Tatascan,1869,139,2,5,7,28.6%,3m
13208,3,[AntLYF]Memebro,1869,0,0,1,1,0.0%,20m
13212,1,dancat,1868,352,13,17,30,43.3%,1h
13212,3,zurdo,1868,0,3,2,5,60.0%,1h
13212,1,[DeeCeS]Tywolf,1868,121,3,11,14,21.4%,1h
13215,3,Prabbi,1866,30,1,4,5,20.0%,39m
13216,3,iash,1865,921,37,43,80,46.2%,1h
13217,3,Uppaclassmun,1864,527,23,25,48,47.9%,1h
13217,3,BOA,1864,222,9,11,20,45.0%,46m
13219,3,dita,1861,634,41,54,95,43.2%,33m
13219,3,NorthNomad,1861,220,9,7,16,56.2%,46m
13219,3,TheShrike,1861,30,1,5,6,16.7%,1h
13222,3,Markov,1860,0,1,0,1,100.0%,55m
13222,3,JKryptic,1860,0,0,1,1,0.0%,1h
13224,2,angel,1859,928,34,45,79,43.0%,35m
13224,3,JenasiaWolfe,1859,95,2,12,14,14.3%,45m
13226,3,scorpatpod,1858,129,3,8,11,27.3%,7m
13226,3,Miracle,1858,0,1,1,2,50.0%,3h
13226,3,Dale,1858,0,0,1,1,0.0%,21m
13229,2,kevclang,1857,755,77,92,169,45.6%,1h
13229,3,[ACTKK2]RhynoJunior,1857,121,3,11,14,21.4%,2m
13229,3,fredy,1857,30,2,3,5,40.0%,17m
13232,3,Jelise,1856,869,28,41,69,40.6%,33m
13232,1,Choppur,1856,239,5,14,19,26.3%,1h
13232,2,RKPalmerJr,1856,0,1,2,3,33.3%,1h
13232,3,RayLiotta,1856,0,0,5,5,0.0%,36m
13236,2,Leoneldoge,1855,64,3,8,11,27.3%,43m
13237,3,Fint,1854,292,14,1,15,93.3%,1h
13237,3,[xCGYx]HALYCONFIVE,1854,123,3,2,5,60.0%,54m
13239,3,panchatantra,1852,88,4,3,7,57.1%,45m
13239,2,paperman,1852,0,0,10,10,0.0%,1h
13241,3,wings,1851,215,6,12,18,33.3%,36m
13242,3,rddeathlord,1850,310,10,11,21,47.6%,3h
13242,3,SuperKamiG,1850,170,7,18,25,28.0%,1h
13242,3,ChaseInvader,1850,115,2,5,7,28.6%,1h
13245,3,Gilbert,1849,1584,190,214,404,47.0%,1h
13246,3,downtiowntra,1848,456,18,17,35,51.4%,1h
13246,3,BillyJean,1848,87,3,6,9,33.3%,1h
13246,2,Cupcake,1848,126,2,5,7,28.6%,1h
13246,3,viceps,1848,0,0,1,1,0.0%,49m
13250,3,[DisQd]DARPAChieff,1846,424,32,39,71,45.1%,35m
13250,2,dounut,1846,356,11,28,39,28.2%,14m
13250,3,triksta,1846,200,6,8,14,42.9%,36m
13253,3,Charlie,1845,1345,53,66,119,44.5%,4m
13253,3,David,1845,621,25,30,55,45.5%,35m
13253,2,AmonsForces,1845,678,22,34,56,39.3%,11m
13256,3,[RSC2]Zerathul,1844,229,7,7,14,50.0%,17m
13256,3,LegoMyFuego,1844,125,2,9,11,18.2%,41m
13258,3,Cesium,1843,0,0,5,5,0.0%,1h
13259,2,emer,1842,44,1,9,10,10.0%,59m
13259,3,MagicPants,1842,0,0,3,3,0.0%,1h
13259,2,Dartoy,1842,0,0,9,9,0.0%,1h
13262,2,Juice,1841,1335,70,88,158,44.3%,1h
13262,3,Danyoul,1841,383,14,22,36,38.9%,17m
13262,3,JrlLive,1841,0,1,4,5,20.0%,1h
13265,1,yellow,1840,1303,60,81,141,42.6%,1h
13265,2,[BEEDS]rmattingly,1840,772,28,31,59,47.5%,43m
13265,1,Darkstar,1840,30,3,11,14,21.4%,1h
13268,3,Kulzokid,1839,214,7,9,16,43.8%,12m
13269,3,Braulini,1837,0,0,3,3,0.0%,1h
13270,3,sup,1836,882,33,38,71,46.5%,1h
13270,3,cambiaformas,1836,356,11,23,34,32.4%,32m
13270,1,[AlamoC]Major,1836,167,5,6,11,45.5%,17m
13270,3,abc,1836,194,5,9,14,35.7%,2m
13270,3,[NANIMO]Sasha,1836,40,1,1,2,50.0%,1h
13270,3,Willlipe,1836,0,1,2,3,33.3%,2m
13276,1,starhue,1835,73,0,2,2,0.0%,1h
13277,3,Dante,1834,375,16,18,34,47.1%,2m
13277,2,URMySUNSHINE,1834,242,8,13,21,38.1%,10m
13279,1,tmex,1833,89,1,2,3,33.3%,56m
13280,3,SaintProsvet,1832,1329,52,66,118,44.1%,17m
13280,1,Manzilla,1832,0,1,0,1,100.0%,3h
13282,3,aSherGamer,1831,238,7,6,13,53.8%,30m
13283,2,[RusHCr]Henegg,1830,1533,94,108,202,46.5%,1h
13284,2,judgejudy,1829,1491,110,143,253,43.5%,47m
13285,3,[MEP]Zoomami,1828,1068,60,69,129,46.5%,25m
13285,3,Hero,1828,382,13,20,33,39.4%,46m
13285,2,MushroomCake,1828,216,6,12,18,33.3%,1h
13288,3,ROMARIO,1827,320,13,18,31,41.9%,32m
13288,3,DerekZoger,1827,186,6,13,19,31.6%,1h
13288,2,Kronix,1827,0,0,8,8,0.0%,50m
13291,3,drag,1826,316,15,15,30,50.0%,46m
13291,3,Andros,1826,416,13,21,34,38.2%,59m
13291,3,LOTAR,1826,95,1,2,3,33.3%,46m
13294,2,maniatico,1824,185,7,12,19,36.8%,23m
13294,3,kira,1824,184,6,6,12,50.0%,1h
13294,1,PandaKhan,1824,180,5,0,5,100.0%,42m
13297,3,Alphareaver,1823,1543,143,156,299,47.8%,1h
13298,3,Vorotato,1822,208,6,15,21,28.6%,1h
13298,3,DANIELDC,1822,119,4,4,8,50.0%,47m
13298,2,Yuriz,1822,167,3,7,10,30.0%,59m
13301,3,mirzakhani,1821,30,2,7,9,22.2%,39m
13302,3,MauiNui,1820,1555,148,176,324,45.7%,1h
13302,1,[00f]RanDumb,1820,0,0,1,1,0.0%,1h
13304,3,DieGoARA,1818,30,1,8,9,11.1%,17m
13305,3,magiatortuga,1817,301,11,17,28,39.3%,3h
13305,2,narito,1817,210,6,9,15,40.0%,59m
13305,3,koopatroopa,1817,38,3,6,9,33.3%,1h
13305,3,gLadE,1817,100,3,8,11,27.3%,3h
13309,1,Vulture,1816,246,10,12,22,45.5%,1h
13309,3,felix,1816,85,3,6,9,33.3%,1h
13309,2,harryhardout,1816,0,0,1,1,0.0%,1h
13312,3,[WuTang]MasterWU,1815,119,3,3,6,50.0%,46m
13313,3,Satirev,1814,0,0,4,4,0.0%,2h
13314,2,Jake,1812,1508,112,116,228,49.1%,3h
13314,3,James,1812,613,48,53,101,47.5%,1h
13314,3,iSpiGaO,1812,0,0,2,2,0.0%,3h
13317,3,Steven,1811,645,23,18,41,56.1%,1h
13317,1,vvv,1811,48,2,0,2,100.0%,51m
13317,3,Russell,1811,0,2,15,17,11.8%,17m
13317,3,ElEkTrObIeR,1811,38,1,2,3,33.3%,28m
13321,1,zelot,1810,143,12,26,38,31.6%,1h
13321,2,Maar,1810,86,2,3,5,40.0%,50m
13321,3,malikor,1810,97,1,3,4,25.0%,2m
13324,1,TheHighChamp,1809,134,4,15,19,21.1%,26m
13325,3,[XchiX]ReiDeLaMort,1808,1171,43,60,103,41.7%,1h
13325,1,AKARead,1808,46,1,1,2,50.0%,16m
13327,1,prax,1806,0,0,1,1,0.0%,1h
13328,3,[c511]Mdenny,1804,280,10,15,25,40.0%,1h
13329,1,Juno,1803,1518,75,93,168,44.6%,16m
13329,3,paulomenega,1803,391,13,20,33,39.4%,32m
13329,1,Jiye,1803,0,0,1,1,0.0%,17m
13332,1,bigdaddy,1802,1926,83,101,184,45.1%,1h
13332,1,[TgAg]Ghosted,1802,436,10,9,19,52.6%,1h
13334,3,DBrown,1801,1545,98,114,212,46.2%,52m
13334,3,Denzille,1801,554,19,40,59,32.2%,43m
13334,1,dreico,1801,134,3,12,15,20.0%,26m
13334,1,Plumbus,1801,0,1,4,5,20.0%,10m
13338,3,SergioXd,1800,66,5,4,9,55.6%,56m
13338,2,Zicario,1800,84,2,7,9,22.2%,1h
13338,3,Lunchpail,1800,0,1,4,5,20.0%,28m
13341,3,Anthony,1799,730,27,30,57,47.4%,1h
13341,3,GoldenGoose,1799,216,8,1,9,88.9%,1h
13341,1,[FDAP69]RetardTed,1799,138,3,3,6,50.0%,3h
13344,1,PINOYKA,1798,94,2,4,6,33.3%,1h
13345,3,freakazoid,1797,38,1,2,3,33.3%,1h
13346,2,[BRobli]Tdestroyer,1796,687,47,67,114,41.2%,1h
13346,3,InertiaBlade,1796,328,37,45,82,45.1%,55m
13346,2,Lystat,1796,485,18,25,43,41.9%,10m
13346,3,DoNaN,1796,0,0,1,1,0.0%,1h
13346,3,DCXSparks,1796,0,0,1,1,0.0%,36m
13346,3,SAIXONE,1796,0,0,7,7,0.0%,1h
13352,3,Vicky,1795,0,0,4,4,0.0%,32m
13353,1,CraftzUwU,1794,0,2,3,5,40.0%,29m
13353,2,PaulRodrigo,1794,70,2,11,13,15.4%,19m
13355,2,EpicEric,1793,282,10,10,20,50.0%,3m
13355,2,whitewolf,1793,0,0,1,1,0.0%,1h
13357,3,Gini,1792,118,7,10,17,41.2%,36m
13357,2,AvaDak,1792,72,2,5,7,28.6%,1h
13359,3,[LOSCTM]Alejo,1791,1080,38,53,91,41.8%,36m
13359,3,[MLI]StarCracker,1791,427,22,24,46,47.8%,32m
13361,2,[EvilCC]Dragonaid,1790,0,1,8,9,11.1%,24m
13362,1,ACEBOOKER,1788,1606,108,153,261,41.4%,27m
13363,1,vic,1786,1888,70,92,162,43.2%,10m
13363,1,Atlas,1786,73,0,8,8,0.0%,3h
13365,3,Candyman,1785,359,12,16,28,42.9%,49m
13365,3,lightcloud,1785,0,0,1,1,0.0%,35m
13365,1,skizzll,1785,0,0,1,1,0.0%,31m
13368,1,[KAGUSA]SparK,1784,86,2,2,4,50.0%,10m
13369,3,krahzeeNYC,1783,1011,38,46,84,45.2%,3h
13369,3,madmonte,1783,94,1,5,6,16.7%,54m
13371,3,Bloodshot,1782,1426,69,89,158,43.7%,55m
13371,3,Andykatz,1782,232,7,9,16,43.8%,35m
13371,3,juberoller,1782,0,1,3,4,25.0%,7m
13374,1,darthfreddie,1781,808,37,41,78,47.4%,40m
13374,1,HOPE,1781,142,5,20,25,20.0%,29m
13374,2,destiny,1781,100,3,14,17,17.6%,1h
13377,2,fatfucck,1778,172,6,5,11,54.5%,1h
13377,2,STRYKER,1778,92,3,11,14,21.4%,7m
13379,3,rams,1777,389,19,32,51,37.3%,6m
13379,1,maxwell,1777,96,2,3,5,40.0%,3h
13381,1,Sergio,1776,0,1,0,1,100.0%,40m
13381,1,BlueDream,1776,0,1,1,2,50.0%,9m
13381,3,SuperTroy,1776,0,1,5,6,16.7%,1h
13384,1,Mazinga,1775,208,7,4,11,63.6%,51m
13384,3,Dankhole,1775,176,7,11,18,38.9%,1h
13384,3,KungFlu,1775,30,1,5,6,16.7%,35m
13384,3,LeftFoot,1775,0,0,4,4,0.0%,49m
13388,2,[Pirobo]JaxMetal,1774,1516,116,134,250,46.4%,47m
13388,1,[FMX]KarmaSutra,1774,96,2,0,2,100.0%,1h
13388,1,Bitkruked,1774,44,2,4,6,33.3%,20m
13391,3,Syrel,1773,0,0,1,1,0.0%,29m
13392,3,Charybdis,1772,473,16,27,43,37.2%,36m
13392,3,Kiszu,1772,0,0,6,6,0.0%,1h
13394,1,soga,1771,0,0,2,2,0.0%,16m
13395,1,[cluez]royery,1770,0,1,0,1,100.0%,17m
13395,3,[LegSC]Baldur,1770,0,0,4,4,0.0%,43m
13397,2,jade,1769,1520,230,252,482,47.7%,3h
13397,3,[Rag1n]BiggestBoner,1769,0,0,2,2,0.0%,2m
13399,2,[EZDUNK]IIIIIIIIIIII,1768,255,19,27,46,41.3%,1h
13399,1,Yeyito,1768,46,1,3,4,25.0%,1h
13401,2,DannyK,1767,514,18,29,47,38.3%,43m
13401,1,[MOCITO]yaxianli,1767,0,1,1,2,50.0%,3h
13403,3,Victor,1766,1104,37,53,90,41.1%,60m
13403,2,Superhoe,1766,30,1,9,10,10.0%,11m
13405,2,ALBORYOIN,1765,1488,153,194,347,44.1%,1h
13405,3,[BL3]shawdonight,1765,871,38,36,74,51.4%,4m
13407,1,[XPARTA]SUPERBADBOY,1764,267,10,20,30,33.3%,52m
13408,3,Impact,1762,652,24,35,59,40.7%,1h
13408,3,adamdude,1762,560,21,30,51,41.2%,41m
13408,2,[uEZaF]Dream,1762,169,4,7,11,36.4%,38m
13408,1,JoakorVF,1762,46,2,4,6,33.3%,17m
13408,2,haka,1762,58,2,11,13,15.4%,43m
13413,3,DasCookies,1761,730,24,36,60,40.0%,1h
13414,3,Gérard,1760,1139,42,55,97,43.3%,1h
13415,1,Dinamicy,1759,400,9,13,22,40.9%,1h
13415,3,[RAR3]Nshaffer,1759,0,2,5,7,28.6%,36m
13417,1,[FU2]StimJunky,1758,446,16,7,23,69.6%,50m
13417,1,Thomas,1758,281,8,19,27,29.6%,3h
13417,1,MarineKing,1758,0,0,3,3,0.0%,10m
13417,2,Colour,1758,0,0,9,9,0.0%,1h
13421,1,[GGMESP]FabioSR,1757,226,5,1,6,83.3%,1h
13421,2,illlmanner,1757,30,1,10,11,9.1%,1h
13423,2,[Mony]Kimjiye,1755,993,40,61,101,39.6%,4h
13423,3,JoseCruz,1755,0,0,2,2,0.0%,3h
13425,1,IIIIIIIIII,1754,296,7,4,11,63.6%,10m
13425,2,dark,1754,30,1,10,11,9.1%,3h
13427,3,hoovooloo,1753,1068,38,48,86,44.2%,17m
13427,1,[wsat2]space,1753,86,2,4,6,33.3%,3h
13429,3,brayitan,1751,0,1,3,4,25.0%,38m
13430,3,Porky,1750,491,21,22,43,48.8%,3h
13430,1,Hero,1750,0,0,1,1,0.0%,1h
13432,3,[SalvA]geo,1749,173,29,38,67,43.3%,32m
13432,2,Sweetie,1749,30,1,9,10,10.0%,1h
13434,1,Grenadier,1747,0,2,3,5,40.0%,3h
13435,3,[diaman]davA,1746,278,10,10,20,50.0%,7m
13435,1,Igmopop,1746,318,7,14,21,33.3%,20m
13435,1,adam,1746,136,3,7,10,30.0%,1h
13438,1,TheBiasPious,1745,1127,33,46,79,41.8%,1h
13439,1,Dell,1744,506,12,13,25,48.0%,1h
13439,2,[KSRP]HarryLeTaint,1744,155,8,9,17,47.1%,59m
13439,2,[Pyroz]DARKMATTER,1744,46,2,7,9,22.2%,36m
13439,3,[mentir]metrallan,1744,0,0,1,1,0.0%,24m
13443,1,Skninja,1743,261,5,8,13,38.5%,16m
13444,2,AXELPRO,1742,292,10,21,31,32.3%,1h
13445,1,Ink,1741,48,1,1,2,50.0%,3h
13446,1,FoxDARK,1740,165,7,5,12,58.3%,19m
13446,3,AxlBundy,1740,144,5,18,23,21.7%,1h
13446,3,DIDAK,1740,0,1,1,2,50.0%,3h
13446,3,[Pr3cum]Danja,1740,32,1,3,4,25.0%,43m
13450,3,Fabius,1738,756,92,127,219,42.0%,1h
13450,1,JonasDeLuna,1738,1302,43,49,92,46.7%,3h
13450,2,snorkelpig,1738,948,33,53,86,38.4%,1h
13450,1,RayBomb,1738,46,2,3,5,40.0%,54m
13454,1,[KGIA]Tassillio,1737,84,3,13,16,18.8%,3h
13455,1,cesaralonso,1736,577,17,21,38,44.7%,17m
13455,1,Niveus,1736,0,1,0,1,100.0%,26m
13457,1,kratoss,1735,166,6,7,13,46.2%,1h
13457,3,REALIZOR,1735,0,3,6,9,33.3%,44m
13457,3,[Axius]XxLeoprimeXx,1735,0,0,2,2,0.0%,3h
13460,1,Dman,1734,94,3,0,3,100.0%,1h
13461,2,shockm,1732,222,7,5,12,58.3%,1h
13462,1,SirPerceval,1729,192,5,3,8,62.5%,1h
13462,2,gregk,1729,0,0,9,9,0.0%,1h
13464,3,[ORUS]ancesur,1728,1016,45,68,113,39.8%,54m
13464,1,[EMV]Dizzy,1728,1304,41,48,89,46.1%,46m
13464,1,[RGNMG]RAGNAROK,1728,73,1,2,3,33.3%,1h
13464,3,[PUNDR]BetoWolf,1728,0,0,2,2,0.0%,1h
13464,1,[ENDMAN]AgeofEmpires,1728,0,0,5,5,0.0%,3h
13469,1,LittleLlama,1727,0,1,5,6,16.7%,17m
13469,2,kennedyfried,1727,0,0,1,1,0.0%,1h
13471,2,FrankTheTank,1725,238,7,17,24,29.2%,10m
13471,3,[AiKS]Barcode,1725,0,0,1,1,0.0%,1h
13473,1,KingFriesV,1724,134,4,19,23,17.4%,56m
13474,2,Artanis,1723,0,0,1,1,0.0%,21m
13475,2,Luiz,1722,88,1,1,2,50.0%,4h
13475,1,ShadowZack,1722,0,0,2,2,0.0%,16m
13477,1,Coldf,1720,1666,59,68,127,46.5%,1h
13477,3,Kobra,1720,726,24,36,60,40.0%,1h
13479,3,Ariseph,1718,58,2,2,4,50.0%,1h
13479,2,xlevi,1718,0,0,9,9,0.0%,25m
13481,3,Yonstar,1717,54,5,8,13,38.5%,43m
13482,3,BeckemKong,1713,1023,34,58,92,37.0%,36m
13482,3,leandro,1713,556,28,38,66,42.4%,38m
13482,1,TheStorm,1713,461,23,33,56,41.1%,1h
13482,3,TerryDane,1713,204,8,14,22,36.4%,1h
13486,1,pauldestruct,1712,456,15,19,34,44.1%,21m
13486,1,satcomiv,1712,253,7,14,21,33.3%,17m
13488,2,Firewall,1711,1075,147,205,352,41.8%,3h
13488,1,monkemaster,1711,178,5,8,13,38.5%,16m
13488,1,SwarmN,1711,92,3,0,3,100.0%,1h
13491,3,Badger,1709,62,5,9,14,35.7%,1h
13491,1,Masacre,1709,113,3,5,8,37.5%,16m
13491,3,ZombieHunter,1709,30,2,4,6,33.3%,55m
13494,2,pickpick,1708,88,1,4,5,20.0%,50m
13495,1,BenjaminJk,1707,0,1,4,5,20.0%,1h
13495,1,player,1707,0,0,1,1,0.0%,1h
13497,3,MONSTARFGLS,1706,318,10,20,30,33.3%,17m
13498,3,shinjiuchiha,1705,489,18,28,46,39.1%,3h
13499,1,antunXDpoder,1703,90,3,3,6,50.0%,16m
13500,1,jhudihangel,1702,0,1,4,5,20.0%,55m
13501,1,meDaBoss,1701,46,1,3,4,25.0%,40m
13502,1,Nebulosa,1700,250,9,7,16,56.2%,1h
13503,3,Legbone,1699,1542,226,269,495,45.7%,2m
13503,3,[HiJ]NachoLibro,1699,493,23,30,53,43.4%,7m
13503,3,[ELITZ]Pawnt,1699,284,11,18,29,37.9%,35m
13503,3,smashen,1699,163,4,7,11,36.4%,45m
13507,1,[BruC]DaComissar,1695,1008,27,36,63,42.9%,3h
13508,1,IamLearning,1694,172,3,1,4,75.0%,1h
13509,1,RAFFAST,1691,121,2,11,13,15.4%,16m
13510,1,[BlGDlK]VincentVega,1689,0,0,1,1,0.0%,16m
13511,3,Computer,1688,1417,56,80,136,41.2%,60m
13511,3,Braukenman,1688,30,2,2,4,50.0%,43m
13513,3,[TMCP]Xavy,1687,180,6,11,17,35.3%,1h
13514,1,INegateIt,1686,304,6,5,11,54.5%,1h
13515,1,YASHA,1685,0,1,2,3,33.3%,1h
13516,1,Exilus,1684,1267,39,47,86,45.3%,1h
13516,3,[DSTN]entropy,1684,0,1,5,6,16.7%,49m
13518,1,Witchdoctor,1683,175,4,11,15,26.7%,41m
13519,3,POIROT,1680,472,56,105,161,34.8%,1h
13519,3,DCLXVI,1680,290,10,18,28,35.7%,49m
13521,1,poeta,1679,44,1,7,8,12.5%,3h
13522,3,walgrenz,1678,1474,84,102,186,45.2%,3h
13522,1,thedude,1678,344,16,17,33,48.5%,1h
13522,1,Domador,1678,0,1,4,5,20.0%,10m
13525,1,PaddyQ,1674,478,20,26,46,43.5%,1h
13526,1,[SSJ4]Kevgeta,1672,1206,33,59,92,35.9%,37m
13526,2,aito,1672,244,7,21,28,25.0%,50m
13526,1,[ZTemps]Aegis,1672,0,1,1,2,50.0%,1h
13526,1,Craftdory,1672,0,0,2,2,0.0%,1h
13530,1,Joemanagemen,1671,0,1,2,3,33.3%,1h
13531,1,Pete,1668,325,9,14,23,39.1%,1h
13532,1,scibri,1667,338,9,8,17,52.9%,31m
13533,1,darksoulboss,1666,0,0,2,2,0.0%,17m
13534,3,juancalito,1665,176,5,10,15,33.3%,1h
13535,1,kidzplaygame,1663,99,2,2,4,50.0%,3h
13536,1,alexlsaint,1662,73,0,3,3,0.0%,37m
13537,1,KiloSix,1661,1912,98,123,221,44.3%,46m
13538,1,Lux,1659,532,14,28,42,33.3%,1h
13539,1,Samael,1658,833,22,39,61,36.1%,1h
13540,2,SeGo,1657,91,1,1,2,50.0%,1h
13540,3,oscar,1657,0,0,1,1,0.0%,24m
13540,3,POLOVECANO,1657,0,0,1,1,0.0%,56m
13543,1,[kolkid]Fuzzy,1655,44,1,3,4,25.0%,31m
13544,1,Trisfae,1654,475,14,24,38,36.8%,1h
13545,3,[BzDp]Spydattack,1653,1070,66,85,151,43.7%,1h
13546,1,[AiKS]DrKobo,1652,134,3,10,13,23.1%,4h
13546,1,thatnoobisme,1652,0,0,1,1,0.0%,31m
13548,1,yametkudasai,1651,131,3,4,7,42.9%,1h
13549,2,JONDAL,1648,220,7,20,27,25.9%,38m
13549,3,bomba,1648,125,7,21,28,25.0%,35m
13551,3,NOCHo,1647,34,1,3,4,25.0%,55m
13552,1,SkyScream,1646,48,1,10,11,9.1%,18m
13552,1,DaWest,1646,0,0,1,1,0.0%,42m
13554,3,SimpleJack,1642,0,0,5,5,0.0%,28m
13555,1,evertdan,1641,907,28,40,68,41.2%,16m
13555,3,[PiGPan]conn,1641,0,1,0,1,100.0%,36m
13557,2,[lIIlll]lIllIlllIlll,1640,1344,244,316,560,43.6%,20m
13557,1,trumPutin,1640,1344,47,60,107,43.9%,55m
13559,1,MrNoisy,1638,0,1,0,1,100.0%,37m
13560,3,sherman,1637,0,1,4,5,20.0%,49m
13561,1,VWarrior,1636,1867,104,136,240,43.3%,55m
13562,1,SonMatheus,1634,44,3,7,10,30.0%,17m
13562,3,Marr,1634,0,0,1,1,0.0%,1h
13564,1,BetterThanU,1633,106,2,3,5,40.0%,1h
13564,1,jaykill,1633,44,1,6,7,14.3%,37m
13566,3,tarkoravman,1630,98,8,23,31,25.8%,1h
13567,2,Charly,1625,30,4,8,12,33.3%,1h
13568,1,Dada,1624,136,2,13,15,13.3%,3h
13569,2,EastTexas,1623,99,2,7,9,22.2%,1h
13569,3,SMCIanimegir,1623,0,0,1,1,0.0%,1h
13571,1,Basilone,1621,1422,48,76,124,38.7%,31m
13571,1,IIIIIIIIIIII,1621,123,4,1,5,80.0%,1h
13571,2,Alkimear,1621,30,1,13,14,7.1%,6m
13574,1,BubbaMonk,1620,830,50,72,122,41.0%,1h
13574,1,MetroKnome,1620,0,0,1,1,0.0%,1h
13576,1,PermaNoob,1618,0,0,1,1,0.0%,3h
13577,1,PapiMario,1616,316,15,16,31,48.4%,10m
13577,3,warmonger,1616,30,3,7,10,30.0%,28m
13579,1,chessy,1615,398,13,21,34,38.2%,1h
13580,1,Michael,1613,1109,34,38,72,47.2%,1h
13580,3,SeanFox,1613,532,18,35,53,34.0%,1h
13582,3,TrumpYeezy,1607,0,0,1,1,0.0%,1h
13583,2,Kyle,1605,709,119,156,275,43.3%,58m
13583,3,Creampie,1605,0,0,6,6,0.0%,3h
13585,2,llllll,1604,1378,433,539,972,44.5%,47m
13586,1,TheBranman,1602,474,18,26,44,40.9%,17m
13587,1,ARTIFICIUS,1601,470,11,21,32,34.4%,1h
13587,3,Tucker,1601,174,5,19,24,20.8%,41m
13589,1,Stephanus,1600,155,4,2,6,66.7%,1h
13589,3,BonHaus,1600,108,3,8,11,27.3%,24m
13591,3,HonorGuideMe,1597,0,0,5,5,0.0%,44m
13592,3,Haltzman,1596,663,47,64,111,42.3%,1h
13593,3,turdhurdler,1595,440,14,31,45,31.1%,34m
13594,2,Salva,1591,88,2,18,20,10.0%,1h
13595,2,Edward,1589,0,0,5,5,0.0%,16m
13596,1,llllllllllll,1587,421,10,19,29,34.5%,16m
13597,3,ssotorp,1586,0,1,6,7,14.3%,55m
13598,1,Scantron,1585,1525,554,685,1239,44.7%,4h
13598,3,espectra,1585,0,0,1,1,0.0%,56m
13600,1,ghostpants,1582,92,1,7,8,12.5%,21m
13600,3,QuickChick,1582,0,0,1,1,0.0%,1h
13602,2,Snurffe,1579,119,1,13,14,7.1%,1h
13602,2,Lebowski,1579,0,0,5,5,0.0%,11m
13604,2,Fenrir,1575,0,0,1,1,0.0%,1h
13605,3,Legend,1573,408,13,40,53,24.5%,22m
13605,1,Alex,1573,0,0,4,4,0.0%,26m
13607,2,TurkeyCheese,1572,73,1,9,10,10.0%,16m
13608,2,Tweezy,1569,90,2,16,18,11.1%,20m
13608,3,[RnRFTP]FENDER,1569,30,1,2,3,33.3%,36m
13610,1,[The3Bs]derek,1567,393,14,18,32,43.8%,1h
13611,2,[TONIC]susanoo,1566,142,5,2,7,71.4%,50m
13612,3,ALLENCHILE,1564,58,2,1,3,66.7%,1h
13613,1,cide,1562,182,4,9,13,30.8%,3h
13613,3,[TCJN]SneezyDwarf,1562,0,1,0,1,100.0%,56m
13615,2,[HOBOS]Pulse,1560,1045,108,149,257,42.0%,53m
13616,1,XaRdOz,1558,949,65,99,164,39.6%,1h
13616,3,Khayla,1558,0,1,4,5,20.0%,3h
13618,1,Jekko,1557,1136,50,67,117,42.7%,1h
13618,3,Littlebee,1557,170,6,5,11,54.5%,1h
13620,3,Lego,1553,0,0,4,4,0.0%,3h
13621,2,BattlePants,1552,0,0,3,3,0.0%,36m
13622,3,maykel,1551,0,2,5,7,28.6%,55m
13623,1,Tarik,1550,136,3,8,11,27.3%,1h
13624,3,miguelh,1544,0,1,1,2,50.0%,1h
13625,3,seanpiadoso,1542,0,1,4,5,20.0%,55m
13626,2,Threadripper,1541,0,0,5,5,0.0%,16m
13627,1,[DarkPG]Ignaciocapo,1539,1196,52,101,153,34.0%,1h
13627,2,unavailable,1539,44,2,5,7,28.6%,3m
13629,2,[YUCK]Bogey,1532,30,1,2,3,33.3%,8m
13630,3,jonnnhowss,1531,1478,195,276,471,41.4%,3h
13631,2,Sneakysquid,1529,88,2,1,3,66.7%,4h
13631,2,EricFX,1529,0,1,4,5,20.0%,1h
13633,3,DELEISER,1528,1423,64,101,165,38.8%,7m
13633,3,MaiLyf,1528,476,17,56,73,23.3%,11m
13635,2,TheJangler,1526,184,7,10,17,41.2%,16m
13636,3,Zoe,1520,1541,264,360,624,42.3%,17m
13637,2,Desertdawg,1519,48,1,4,5,20.0%,1h
13638,1,warmech,1517,132,4,8,12,33.3%,37m
13638,2,[LeMono]MegaMartin,1517,0,1,5,6,16.7%,1h
13640,3,tupacamaruII,1516,30,1,12,13,7.7%,21m
13641,3,[amvpro]natsu,1514,158,5,18,23,21.7%,20m
13642,3,Twistee,1508,0,0,12,12,0.0%,46m
13643,3,rytontym,1507,30,4,6,10,40.0%,1h
13644,2,MusicGame,1505,494,20,14,34,58.8%,21m
13644,2,Pook,1505,588,19,43,62,30.6%,50m
13646,3,SaintReagan,1504,0,0,1,1,0.0%,1h
13647,2,[MIN1]PATBATZU,1501,0,0,1,1,0.0%,36m
13648,2,link,1500,258,8,14,22,36.4%,1h
13649,2,tufelhunden,1496,30,1,4,5,20.0%,11m
13650,2,Gunery,1495,108,3,18,21,14.3%,8m
13650,2,LeetPuff,1495,73,1,9,10,10.0%,16m
13652,1,Franklin,1493,1752,60,95,155,38.7%,46m
13653,3,billy,1492,899,26,60,86,30.2%,41m
13654,3,[Proooo]SteamHaloMCC,1489,0,1,0,1,100.0%,1h
13655,1,NameChange,1487,0,0,17,17,0.0%,10m
13656,2,EVILSKY,1486,712,24,65,89,27.0%,17m
13657,2,Leod,1479,390,12,23,35,34.3%,1h
13658,2,[C96741]Burgernose,1477,514,16,27,43,37.2%,21m
13658,2,Maverick,1477,0,3,2,5,60.0%,1h
13660,2,Octosub,1475,0,0,5,5,0.0%,1h
13661,1,[spKEY]HeliStructur,1474,336,9,15,24,37.5%,1h
13662,2,abe,1473,170,6,12,18,33.3%,11m
13663,2,Satheaus,1472,30,1,14,15,6.7%,5m
13664,2,danyphanton,1468,90,3,9,12,25.0%,60m
13665,2,locusk,1467,38,1,2,3,33.3%,1h
13665,2,Fujin,1467,0,1,4,5,20.0%,16m
13667,3,Kallisthea,1464,46,1,14,15,6.7%,3h
13668,3,ccc,1463,72,3,6,9,33.3%,1h
13669,2,vonpolus,1459,1260,42,70,112,37.5%,1h
13670,1,Duke,1457,299,8,15,23,34.8%,50m
13671,1,Jetpackracer,1449,0,0,8,8,0.0%,16m
13672,2,[VENSC2]GhostDragon,1447,377,11,13,24,45.8%,1h
13672,2,oGt,1447,126,3,5,8,37.5%,16m
13674,3,[HYGame]Harster,1446,0,0,8,8,0.0%,29m
13675,1,Bobhoule,1438,48,2,20,22,9.1%,4h
13676,1,FallenAngel,1433,125,2,11,13,15.4%,41m
13677,3,Omegatherion,1425,30,1,7,8,12.5%,55m
13677,1,xdelpro,1425,0,1,18,19,5.3%,1h
13679,2,Bancocoman,1419,36,2,6,8,25.0%,16m
13680,2,DudeComeOn,1411,516,16,42,58,27.6%,1h
13681,2,agjil,1410,1611,54,88,142,38.0%,16m
13681,2,Baiter,1410,0,0,1,1,0.0%,16m
13683,2,BobVance,1398,158,11,0,11,100.0%,3h
13684,1,ureta,1396,342,13,36,49,26.5%,1h
13685,1,AnonymousJoe,1395,1326,36,71,107,33.6%,42m
13686,2,[DOOM10]masterchief,1391,0,0,7,7,0.0%,1h
13687,2,Arcangel,1390,576,18,35,53,34.0%,1h
13688,3,OZZY,1384,0,0,1,1,0.0%,3h
13689,2,Narcomax,1381,66,3,8,11,27.3%,1h
13690,2,Flowergirls,1375,1566,208,381,589,35.3%,1h
13691,3,[R4YN0R]Wackywookie,1370,184,7,0,7,100.0%,49m
13691,2,gralTIZIANO,1370,90,3,13,16,18.8%,1h
13693,2,[AHBR]Mestre,1365,0,0,4,4,0.0%,1h
13694,3,mdomofe,1361,0,1,4,5,20.0%,1h
13694,3,TheCowSays,1361,0,0,3,3,0.0%,49m
13696,2,lnchbx,1359,354,11,20,31,35.5%,16m
13697,3,HolyKnight,1358,0,1,7,8,12.5%,3h
13698,2,[TIKTOK]Jocelyn,1337,217,5,15,20,25.0%,1h
13699,3,BLOODxGANG,1335,278,9,16,25,36.0%,1h
13700,3,Andy,1322,86,3,4,7,42.9%,1h
13701,3,axel,1312,0,1,5,6,16.7%,1h
13701,3,TeddyBear,1312,0,0,1,1,0.0%,29m
13703,3,Jyveks,1306,154,7,1,8,87.5%,36m
13704,1,SkyAngel,1282,1161,127,195,322,39.4%,55m
13704,2,Shuhac,1282,416,15,30,45,33.3%,1h
13704,3,wheezy,1282,232,8,33,41,19.5%,1h
13707,3,DarthZeran,1280,72,3,0,3,100.0%,1h
13708,3,Fireburner,1279,0,1,4,5,20.0%,24m
13709,3,[ALTF04]ARGHunter,1278,120,4,13,17,23.5%,1h
13710,3,lhippie,1275,142,4,12,16,25.0%,10m
13711,3,TheBigCarl,1260,0,0,1,1,0.0%,10m
13712,3,Noctis,1257,0,0,2,2,0.0%,29m
13713,2,jack,1227,1134,35,87,122,28.7%,1h
13714,3,Envoidragorn,1225,0,0,18,18,0.0%,49m
13715,3,NessRez,1223,30,1,6,7,14.3%,3h
13716,3,macktrack,1212,0,0,5,5,0.0%,56m
13717,3,IHaveNoIdea,1209,65,3,2,5,60.0%,43m
13718,3,KUMITA,1206,0,0,6,6,0.0%,1h
13719,3,JamminJohn,1187,86,3,7,10,30.0%,56m
13720,2,[MeePwn]HaKu,1185,1464,239,596,835,28.6%,16m
13721,3,DFSketch,1178,30,3,7,10,30.0%,1h
13722,1,MAK,1153,253,6,45,51,11.8%,1h
13723,3,holacomoewsk,1142,30,1,2,3,33.3%,1h
13724,1,Plecto,1111,12,1320,757,2077,63.6%,8m
13725,3,neerking,1088,118,4,1,5,80.0%,49m
13726,3,JumpinJames,1072,30,1,10,11,9.1%,56m
13727,3,Zoferos,1063,0,0,1,1,0.0%,1h
13728,3,[TOYOTA]CamryPower,997,0,0,14,14,0.0%,1h
13729,3,[AntRuS]Raistlin,905,90,3,8,11,27.3%,1h
13730,2,Quadena,896,78,2,20,22,9.1%,1h
13731,3,CaraDCaquita,777,30,1,7,8,12.5%,43m
13732,3,WorstplyrNA,753,30,1,4,5,20.0%,1h
13733,2,[WuTang]BingGan,394,1065,3142,4631,7773,40.4%,1h
13734,3,llllllllllll,349,0,742,2992,3734,19.9%,58m
13735,3,[Gainss]Livibee,237,0,0,2,2,0.0%,43m
13736,3,ForAuir,160,1009,1062,1610,2672,39.7%,1h
