rank,tier,name,mmr,points,wins,losses,played,winrate,age
1,1,[Ex0n]SpeCial,6345,1883,72,29,101,71.3%,7m
2,1,Sonagi,6258,0,0,2,2,0.0%,31m
3,1,lllllllllIll,6232,1280,29,6,35,82.9%,26m
4,1,[αX]MaSa,6196,240,6,2,8,75.0%,7m
5,1,Spear,6186,0,0,1,1,0.0%,7m
6,1,freeyourself,6144,2421,299,100,399,74.9%,2m
7,1,Kylekatarn,6123,240,6,0,6,100.0%,4m
8,1,[MFSC2]Seither,6122,726,27,16,43,62.8%,40m
9,1,[UpeV]jOker,6083,616,24,6,30,80.0%,2m
10,1,MillForGG,6081,3710,1320,864,2184,60.4%,2m
11,1,Sottorks,6077,3432,601,177,778,77.2%,2m
11,1,[juggr]Jason,6077,3229,126,57,183,68.9%,2m
13,1,Homer,6069,384,8,5,13,61.5%,3m
14,1,[iMkS]YeraldSC,6064,376,13,4,17,76.5%,31m
15,1,[H0110W]ZoteTheMghty,6050,48,2,0,2,100.0%,13m
16,1,SuperNova,6043,1760,249,70,319,78.1%,39m
17,1,[αX]Vindicta,6037,1392,52,35,87,59.8%,13m
18,1,IIIIIIIIIIII,6031,0,1,1,2,50.0%,17m
19,1,jheffe,6027,288,6,3,9,66.7%,2m
20,1,[EZFLEX]mchoma,6005,772,57,12,69,82.6%,12m
21,1,HydraulixXD,5996,1564,58,28,86,67.4%,25m
22,1,[PSISTM]Epic,5963,3362,186,108,294,63.3%,2m
23,1,GamerRichy,5945,288,6,5,11,54.5%,14m
23,1,[YMTT]Drunkenboi,5945,96,3,0,3,100.0%,31m
25,1,KAPPAPRIDE,5937,1300,124,71,195,63.6%,26m
26,1,macmiller,5921,0,0,1,1,0.0%,17m
27,1,AGRESOR,5919,959,44,17,61,72.1%,39m
28,1,[αX]Future,5915,1854,45,25,70,64.3%,25m
29,1,Creed,5911,48,2,2,4,50.0%,40m
30,1,IIIIIIIIIIII,5910,3130,210,46,256,82.0%,2m
30,1,[cult]CrucialNug,5910,0,0,1,1,0.0%,17m
32,1,llllllllllll,5892,610,13,6,19,68.4%,39m
33,1,CloutCobain,5891,773,16,5,21,76.2%,2m
33,1,malloc,5891,0,1,0,1,100.0%,39m
35,1,[Perfec]Zero,5890,3522,325,229,554,58.7%,2m
36,1,kiwian,5886,0,1,0,1,100.0%,25m
37,1,[αX]Uzikoti,5848,0,1,0,1,100.0%,7m
38,1,[RnGpro]Goomba,5841,3445,595,430,1025,58.0%,2m
39,1,balrog,5834,188,5,1,6,83.3%,7m
40,1,[JIGLY]Mangos,5832,0,1,0,1,100.0%,39m
41,1,[Regstr]FlexOffender,5830,524,15,4,19,78.9%,25m
41,1,llllllllllll,5830,0,0,1,1,0.0%,17m
43,1,ItWasLuck,5825,336,7,1,8,87.5%,31m
44,1,McGregor,5824,96,3,1,4,75.0%,31m
45,1,[CumNow]Kamker,5817,613,115,57,172,66.9%,12m
46,1,mercy,5797,280,7,8,15,46.7%,17m
47,1,[LCE]ldrunk,5791,2104,71,44,115,61.7%,2m
48,1,piglet,5781,1424,59,49,108,54.6%,25m
49,1,StutterStep,5776,336,7,7,14,50.0%,17m
50,1,SayICanComeI,5774,504,88,58,146,60.3%,6m
51,1,BratOK,5748,48,1,2,3,33.3%,3m
52,1,TopGun,5736,0,1,0,1,100.0%,3m
53,1,[RolIin]Dolan,5725,3375,559,421,980,57.0%,2m
54,1,table,5723,710,15,14,29,51.7%,13m
55,1,rive,5719,0,0,1,1,0.0%,6m
56,1,[P51]TaeJa,5707,96,2,1,3,66.7%,31m
57,1,[VRKLAK]Wanderer,5706,48,1,5,6,16.7%,17m
58,1,Avenger,5704,732,221,182,403,54.8%,17m
59,1,coldhands,5703,464,10,4,14,71.4%,3m
60,1,[Ex0n]Skyler,5701,3266,439,312,751,58.5%,2m
61,1,[GIBE]Jason,5697,3414,299,187,486,61.5%,2m
62,1,[xRtG]Ambition,5696,1827,75,49,124,60.5%,2m
63,1,IIIIIIIIIIII,5690,554,21,10,31,67.7%,2m
64,1,maryshelly,5685,73,0,4,4,0.0%,7m
65,1,[YMTT]ChampgnePapi,5658,1786,60,49,109,55.0%,25m
66,1,[ROOT]DisK,5657,678,26,9,35,74.3%,40m
67,1,[JIGLY]Zonda,5654,364,15,15,30,50.0%,2m
68,1,IIIIIIIIIIII,5647,0,1,0,1,100.0%,12m
69,1,ºººººººººººº,5646,0,0,1,1,0.0%,25m
70,1,[omgBBC]GucciCoochie,5645,0,0,1,1,0.0%,7m
71,1,Lero,5638,924,22,11,33,66.7%,17m
72,1,llllllllllll,5636,0,0,1,1,0.0%,4m
73,1,llllllllllll,5626,1525,229,178,407,56.3%,25m
74,1,PracticeX,5625,654,15,7,22,68.2%,39m
75,1,[byunta]llllllllllll,5615,1296,112,75,187,59.9%,25m
76,1,IIIIIIIIIIII,5613,48,2,1,3,66.7%,12m
77,1,HearMyCall,5606,942,107,38,145,73.8%,12m
78,1,llllllllllll,5601,0,1,1,2,50.0%,17m
79,1,llllllllllll,5590,280,7,3,10,70.0%,17m
80,1,llllllllllll,5585,1213,52,29,81,64.2%,14m
81,1,JEROS,5582,786,17,8,25,68.0%,25m
82,1,[aivNA]Powerfoe,5574,0,1,0,1,100.0%,6m
83,1,[aivNA]aviloSoAmaze,5563,1929,218,141,359,60.7%,39m
84,1,NugPot,5554,3295,240,191,431,55.7%,2m
85,1,Calm,5548,3210,506,389,895,56.5%,2m
86,1,coLKoMA,5544,401,14,16,30,46.7%,13m
87,1,LaIncaKola,5535,2269,138,110,248,55.6%,31m
88,1,llllllllllll,5534,2847,424,341,765,55.4%,2m
89,1,TwitchSonagi,5532,936,44,16,60,73.3%,2m
90,1,[GdAT]RoRrO,5520,1518,56,25,81,69.1%,2m
91,1,[lCY]Kozan,5514,2815,124,93,217,57.1%,2m
91,1,CrnkyDiabetc,5514,48,1,6,7,14.3%,17m
93,1,[Yggr]TerribleOne,5513,1180,181,125,306,59.2%,26m
94,1,Destructicon,5510,0,1,0,1,100.0%,14m
95,1,TORMENT,5496,1877,95,63,158,60.1%,4m
96,1,IIIIIIIIIIII,5495,96,3,2,5,60.0%,3m
97,1,[HMTeam]Lobo,5491,0,0,1,1,0.0%,26m
98,1,[αX]Kunamatata,5482,1082,37,26,63,58.7%,31m
99,1,BethHarmon,5481,1336,42,29,71,59.2%,2m
99,1,[LGCANZ]Azure,5481,731,25,19,44,56.8%,12m
101,1,Dragon,5479,96,3,3,6,50.0%,17m
101,1,IIIIIIIIIII,5479,0,0,1,1,0.0%,17m
103,1,[PSISTM]Namshar,5478,0,2,5,7,28.6%,10m
104,1,[cl0udM]Symphony,5474,2211,254,188,442,57.5%,3m
105,1,[NwAs]EvilJhonny,5471,0,1,0,1,100.0%,17m
106,1,[DAVFAN]MeomaikaFan,5470,73,1,0,1,100.0%,17m
107,1,YanXII,5467,1480,96,34,130,73.8%,25m
108,1,Byun,5462,496,13,5,18,72.2%,6m
109,1,IlIlIllIIllI,5460,0,0,1,1,0.0%,31m
110,1,IIIIIIIIIIII,5454,381,38,26,64,59.4%,17m
111,1,[xGenGx]ForeverX,5449,3143,277,220,497,55.7%,2m
112,1,IIIIIIIIIIII,5448,1345,49,28,77,63.6%,2m
113,1,[KRizEZ]Gemini,5446,1224,30,19,49,61.2%,8m
113,1,TheBatman,5446,905,29,27,56,51.8%,2m
115,1,[PiGPan]PiG,5443,1876,76,69,145,52.4%,2m
116,1,[Thpj]MeOwEx,5441,186,5,2,7,71.4%,25m
117,1,[cl0udM]Eurystheus,5440,1936,308,252,560,55.0%,6m
118,1,holiday,5439,534,33,27,60,55.0%,17m
118,1,IMPERATOR,5439,96,3,0,3,100.0%,2m
120,1,[aviNA]aviloSoAmaze,5433,3242,217,185,402,54.0%,2m
120,1,[Padoru]imeurotrash,5433,1776,158,106,264,59.8%,31m
122,1,[KORKOR]Meister,5430,334,8,5,13,61.5%,17m
123,1,[BoRnGo]Greenert,5426,0,1,1,2,50.0%,4m
124,1,[xRtG]NamhciR,5424,1704,74,46,120,61.7%,2m
125,1,Aldia,5419,1384,57,34,91,62.6%,2m
125,1,[AoBDE]BossToss,5419,0,1,0,1,100.0%,31m
127,1,[FAHUR]SgtFahur,5416,92,3,2,5,60.0%,17m
128,1,TerranUser,5414,48,2,0,2,100.0%,17m
129,1,mistborn,5403,1125,37,35,72,51.4%,17m
130,1,[ChiFan]ChillerView,5397,140,3,2,5,60.0%,8m
131,1,Nesnow,5393,236,6,4,10,60.0%,10m
132,1,[Bee]BerryRAWR,5392,3108,387,314,701,55.2%,2m
132,1,CammyRed,5392,0,0,4,4,0.0%,26m
134,1,FoREVer,5391,96,2,1,3,66.7%,17m
135,1,suehtsyruE,5389,3087,355,294,649,54.7%,2m
136,1,[xRtG]Haffey,5386,2303,114,99,213,53.5%,2m
137,1,[SUOMI]Luolis,5383,224,6,2,8,75.0%,6m
138,1,Care,5381,0,0,1,1,0.0%,39m
139,1,uwuer,5380,175,4,6,10,40.0%,8m
140,1,Mogar,5379,136,3,1,4,75.0%,7m
141,1,RuFF,5376,1240,51,20,71,71.8%,2m
142,1,TimApple,5373,363,19,16,35,54.3%,6m
143,1,[xRtG]Wonder,5369,0,0,1,1,0.0%,13m
144,1,[Dipz]llllllllllll,5368,1689,59,53,112,52.7%,2m
145,1,BamgOOraY,5364,472,11,11,22,50.0%,39m
146,2,Messee,5358,0,1,0,1,100.0%,35m
147,1,[Specie]Ape,5353,777,71,57,128,55.5%,17m
147,1,Tezuka,5353,432,66,18,84,78.6%,31m
147,1,frankthetank,5353,192,4,3,7,57.1%,13m
150,1,FullOfFlaw,5351,804,20,8,28,71.4%,17m
150,1,[8Range]LaWeedaLoca,5351,0,0,2,2,0.0%,3m
152,1,TTD,5349,1278,33,24,57,57.9%,25m
153,1,Ulysses,5345,48,1,1,2,50.0%,17m
153,1,IIIIIIIIIIII,5345,0,0,1,1,0.0%,25m
155,1,Sequoia,5342,658,44,27,71,62.0%,17m
156,1,[realUW]Pfoe,5341,778,100,45,145,69.0%,17m
156,1,vini,5341,0,0,2,2,0.0%,40m
158,1,[DuSt]AmpliFy,5336,0,0,1,1,0.0%,25m
159,1,[TeamGP]LunaSea,5335,0,2,3,5,40.0%,39m
159,1,[NSE]Sentinel,5335,0,1,0,1,100.0%,39m
159,1,[AoBDE]jackson,5335,0,0,1,1,0.0%,8m
162,1,Soma,5331,0,1,0,1,100.0%,13m
163,1,[KingSC]FanTYTY,5329,73,1,0,1,100.0%,3m
164,1,[αX]taedaj,5328,96,3,5,8,37.5%,10m
165,1,[αB]Speakthen,5327,979,184,149,333,55.3%,10m
166,1,[RBTH]tavo,5326,1303,55,28,83,66.3%,2m
167,1,TacosDeTripa,5325,44,1,4,5,20.0%,31m
168,1,WolfWaffen,5321,424,9,8,17,52.9%,14m
169,1,FukMOUNTAIN,5317,48,2,0,2,100.0%,12m
170,1,SolidClem,5315,868,55,31,86,64.0%,3m
171,1,[prxynb]SalbeoL,5314,870,34,21,55,61.8%,2m
171,1,[lovavi]NaShimOon,5314,48,1,3,4,25.0%,2m
173,1,Goky,5313,0,0,2,2,0.0%,17m
174,1,TABLE,5312,144,3,9,12,25.0%,6m
174,1,[BUMPY]sapling,5312,0,0,2,2,0.0%,31m
176,1,[xRtG]Dice,5310,942,32,17,49,65.3%,2m
177,1,Dicehammer,5309,48,1,1,2,50.0%,31m
178,1,[0iq]NickDickBrwn,5308,1264,34,26,60,56.7%,8m
179,1,[RBTH]NeO,5307,1349,63,47,110,57.3%,40m
179,1,[NSE]Drusus,5307,48,2,2,4,50.0%,39m
181,1,[SttE]sean,5304,2696,140,118,258,54.3%,2m
181,1,stackinSATS,5304,1449,81,63,144,56.2%,2m
183,1,IIIIIIIIIIII,5300,1577,61,53,114,53.5%,2m
184,1,[RBTH]IIIIIIIIIII,5297,1284,44,30,74,59.5%,17m
185,1,[OOOOHH]EldenRIng,5295,349,13,6,19,68.4%,40m
186,1,Boulder,5294,447,18,12,30,60.0%,26m
186,1,IIIIIIIIIIIl,5294,289,6,2,8,75.0%,2m
188,1,SuperNova,5293,516,46,10,56,82.1%,7m
189,1,vmgNarra,5292,0,1,0,1,100.0%,2m
189,1,Rain,5292,46,1,2,3,33.3%,17m
191,1,[EZDUNK]Cyanine,5290,0,1,2,3,33.3%,31m
192,1,WhosSly,5286,2055,271,203,474,57.2%,25m
192,1,UpsetKimchi,5286,1217,45,27,72,62.5%,2m
194,1,Erik,5281,182,6,1,7,85.7%,12m
195,1,[KR2077]HonMonO,5279,636,17,14,31,54.8%,12m
195,1,CorpPor,5279,48,1,8,9,11.1%,31m
197,1,[SJK]SJK,5278,124,4,7,11,36.4%,2m
198,1,[3Z]CountWaffles,5274,0,0,1,1,0.0%,8m
199,1,[Pinocc]Epitomes,5270,423,16,14,30,53.3%,40m
200,1,IIIIIIIIIIII,5267,46,2,4,6,33.3%,17m
201,1,LastHerO,5259,0,1,1,2,50.0%,10m
202,1,[Black0]Galeno,5258,54,2,1,3,66.7%,8m
203,1,Five,5257,934,26,13,39,66.7%,8m
204,1,ShihYat,5249,1199,33,36,69,47.8%,39m
205,1,MAD,5248,744,43,4,47,91.5%,31m
205,1,[Ex0n]Sweetzy,5248,604,13,10,23,56.5%,7m
207,2,VergaDeDios,5247,42,1,1,2,50.0%,35m
208,1,TheDude,5246,260,6,7,13,46.2%,8m
208,1,[REPORT]llllllllllll,5246,0,0,1,1,0.0%,13m
210,1,EarthyGrey,5245,1443,105,73,178,59.0%,3m
210,1,Bunners,5245,674,15,26,41,36.6%,26m
212,1,Hiro,5242,0,0,1,1,0.0%,8m
213,1,[TPGGXD]Fabricio,5241,270,7,6,13,53.8%,26m
214,1,Voiceless,5239,48,1,2,3,33.3%,17m
215,1,[TWON]tGuaN,5238,1162,63,19,82,76.8%,39m
216,1,[Perfec]Frontstab,5235,0,1,0,1,100.0%,17m
217,1,[SttE]wam,5233,1983,131,102,233,56.2%,26m
218,1,SevenRax,5230,42,1,4,5,20.0%,13m
219,1,kkwon,5228,0,0,1,1,0.0%,13m
220,1,Goosejuice,5221,0,0,1,1,0.0%,3m
221,1,CreatorJEJA,5220,1162,41,19,60,68.3%,3m
222,1,Stark,5219,200,5,7,12,41.7%,7m
223,1,[eviNA]EVILOTOSS,5217,810,20,20,40,50.0%,17m
224,1,badgermuffin,5214,294,7,7,14,50.0%,39m
225,1,MadaMadaDane,5212,142,3,8,11,27.3%,10m
226,1,KelMorian,5211,1922,127,9,136,93.4%,2m
227,1,[Boomrs]Smile,5210,237,8,2,10,80.0%,2m
228,1,IIIIIIIIIIII,5207,144,4,7,11,36.4%,26m
229,1,Arnak,5206,638,17,5,22,77.3%,4m
230,1,llllllllllll,5205,369,25,31,56,44.6%,17m
230,1,IIIIIIIIIIII,5205,412,17,2,19,89.5%,14m
232,1,llllllllllll,5203,2456,120,112,232,51.7%,2m
233,1,[Costco]ChuckNorris,5202,0,0,1,1,0.0%,26m
234,1,[BJWD]MaBaoGuo,5201,363,13,3,16,81.2%,3m
234,1,[iMkS]SoldieR,5201,109,2,2,4,50.0%,2m
234,1,[JIGLY]Marea,5201,76,2,5,7,28.6%,39m
234,1,Goliath,5201,0,0,2,2,0.0%,17m
238,1,IrishLad,5198,356,41,31,72,56.9%,14m
239,1,Kanoa,5197,0,0,1,1,0.0%,31m
240,1,[PPayne]FenrisWolf,5194,980,40,43,83,48.2%,13m
241,1,[Cdojo]TheGazMan,5193,853,286,227,513,55.8%,3m
242,1,Joker,5191,458,13,10,23,56.5%,40m
243,1,[Th3Bad]YanXII,5187,1691,89,65,154,57.8%,2m
244,1,IIIIIIIIIIII,5186,0,0,1,1,0.0%,12m
245,1,[Cryptc]BnjourThomas,5184,490,28,11,39,71.8%,39m
246,1,newtoRTS,5182,2021,129,50,179,72.1%,2m
247,1,[Ohm2]WalmartWiFi,5181,1614,75,58,133,56.4%,2m
248,1,Starlord,5180,440,14,9,23,60.9%,2m
248,1,TheTargeT,5180,0,0,1,1,0.0%,31m
250,1,qwe,5179,1477,124,106,230,53.9%,4m
251,1,[icecId]iceinmyveins,5178,142,3,5,8,37.5%,6m
252,1,llllllllllll,5177,136,4,4,8,50.0%,17m
253,1,[ITTC]iNu,5175,362,26,16,42,61.9%,31m
254,1,IIIIIIIIIIII,5173,2137,116,102,218,53.2%,2m
254,1,llllllllllll,5173,1486,74,37,111,66.7%,13m
254,1,FUBUKI,5173,936,38,29,67,56.7%,2m
257,1,lIllllIIIIlI,5172,2662,304,261,565,53.8%,2m
257,1,TuÉCego,5172,88,2,6,8,25.0%,17m
259,1,[lmbaF]Bombilla,5171,48,1,1,2,50.0%,31m
260,1,[SsaYnS]ImTwelve,5169,2410,240,174,414,58.0%,2m
261,1,[Ex0n]EndOfDays,5167,0,0,1,1,0.0%,40m
262,1,[GnR]DarKVoiD,5165,1602,155,109,264,58.7%,17m
263,1,Blindone,5164,712,39,5,44,88.6%,2m
263,1,MisaCampo,5164,455,18,13,31,58.1%,6m
265,1,[MadK]Shellbee,5163,2651,402,335,737,54.5%,2m
265,1,[L4CRA]Futoshiki,5163,1305,65,43,108,60.2%,2m
265,1,Berserkforce,5163,48,1,3,4,25.0%,25m
268,1,Pummeler,5161,286,8,2,10,80.0%,25m
269,1,LosMojarras,5160,90,3,6,9,33.3%,17m
270,1,[ArGNA]EruptioN,5158,488,14,10,24,58.3%,3m
271,1,[LGCANZ]RunaMoK,5157,2846,250,199,449,55.7%,31m
272,1,[MSFT]SeibasAhoge,5156,40,1,2,3,33.3%,31m
273,1,Mikasa,5150,516,13,14,27,48.1%,7m
274,1,[EnVac]Emma,5147,0,0,2,2,0.0%,26m
275,1,mattpk,5146,1005,45,38,83,54.2%,25m
275,1,[JIGLY]Pointless,5146,397,15,17,32,46.9%,2m
277,1,IrishLad,5144,454,16,13,29,55.2%,31m
278,1,IIIIIIIIII,5137,1084,45,24,69,65.2%,3m
279,1,IIIIIIIIIIII,5136,46,1,1,2,50.0%,17m
279,1,[MaxWin]Grefoli,5136,0,0,1,1,0.0%,39m
281,1,[L4CRA]KappaCrown,5134,1320,59,52,111,53.2%,4m
282,1,[CUTEST]Livibee,5131,2241,320,289,609,52.5%,39m
282,1,[TeamUR]Acely,5131,802,23,10,33,69.7%,17m
282,1,Sherry,5131,96,3,0,3,100.0%,14m
282,1,Prøject,5131,92,2,3,5,40.0%,17m
286,1,HanNibaL,5129,0,1,0,1,100.0%,14m
287,1,Noumena,5128,2753,307,255,562,54.6%,26m
288,1,[GnR]JongleBolls,5123,0,0,1,1,0.0%,6m
289,1,llllllllllll,5122,1958,84,62,146,57.5%,7m
289,1,[WNTR]WinterSC,5122,0,1,0,1,100.0%,26m
291,1,LowBattery,5121,2085,106,80,186,57.0%,26m
292,1,Mustitorte,5118,80,2,1,3,66.7%,6m
293,1,llllllllllll,5117,2859,177,136,313,56.5%,39m
293,1,llllllllllll,5117,0,1,0,1,100.0%,17m
295,1,[CXIV]FirstTake,5115,912,61,38,99,61.6%,39m
296,1,Antonio,5113,0,1,0,1,100.0%,26m
297,1,Rareeeeee,5112,0,0,1,1,0.0%,17m
298,1,[LOUISV]DICEROLLER,5105,1645,75,68,143,52.4%,2m
299,1,[HwKlLr]Nicoract,5101,0,1,2,3,33.3%,14m
299,1,[HoSeeB]richardfeder,5101,0,0,2,2,0.0%,17m
301,3,[RnGpro]Puppypaws,5091,0,2,3,5,40.0%,8m
302,1,[PSISTM]RuFF,5090,520,14,3,17,82.4%,39m
303,1,frz,5089,389,10,7,17,58.8%,25m
304,1,[Ris3n]Faz,5088,3119,222,183,405,54.8%,17m
304,1,Dedushka,5088,2990,208,137,345,60.3%,17m
304,1,Groovyman,5088,892,29,32,61,47.5%,17m
304,1,goblin,5088,0,1,2,3,33.3%,39m
308,1,[NM8]LilRocketMan,5083,1405,58,57,115,50.4%,39m
309,1,Rain,5082,340,9,4,13,69.2%,14m
310,1,HumongusKimi,5079,1363,46,40,86,53.5%,31m
311,1,[αX]Psych,5078,128,3,6,9,33.3%,4m
312,2,[RÐ]RazerBlader,5077,107,3,0,3,100.0%,34m
313,1,Reap,5076,517,84,40,124,67.7%,17m
314,1,[VaLuE]PrimeHunterZ,5073,0,1,0,1,100.0%,25m
315,1,ahurry,5071,46,1,2,3,33.3%,39m
315,1,Smash,5071,0,0,1,1,0.0%,31m
317,1,llllllllIIIl,5070,88,2,4,6,33.3%,40m
318,1,forsenCD,5069,3091,459,353,812,56.5%,4m
318,1,[nG]WillyStrike,5069,0,0,1,1,0.0%,40m
320,1,[GitAdd]vLDemonizer,5068,1011,46,29,75,61.3%,3m
321,1,DJDJ,5065,656,36,4,40,90.0%,8m
321,1,Bonjwa,5065,0,3,2,5,60.0%,13m
323,1,ThorRush,5061,1212,97,75,172,56.4%,7m
324,1,llllllllllll,5058,0,0,1,1,0.0%,40m
325,1,MarineF,5053,1062,31,28,59,52.5%,3m
325,1,[αXLa]GutyECUADOR,5053,172,5,5,10,50.0%,14m
325,1,[JOSUN]dkfofjcndjs,5053,0,1,1,2,50.0%,17m
325,1,[Atira]DieselMP,5053,0,0,1,1,0.0%,2m
329,1,ZergPurée,5051,220,6,4,10,60.0%,26m
329,1,CHEEZE,5051,0,1,0,1,100.0%,4m
331,1,[RBTH]Crown,5050,1296,64,52,116,55.2%,39m
332,1,[dLife]Pursuit,5048,2509,195,157,352,55.4%,8m
333,1,[Tuurtl]NinjaTurtle,5045,979,48,6,54,88.9%,17m
334,1,[GR33D]RogueZZ,5044,3057,221,176,397,55.7%,39m
334,1,[nG]bouette,5044,0,0,1,1,0.0%,31m
336,1,[juggr]LunarSC,5041,3115,231,196,427,54.1%,10m
337,1,realist,5040,916,26,23,49,53.1%,39m
337,1,[GnR]Asturias,5040,322,9,6,15,60.0%,6m
339,1,[Weac]bEwiLdErEd,5039,2673,413,348,761,54.3%,14m
339,1,ThinkZero,5039,1777,72,32,104,69.2%,3m
341,1,NetMech,5037,2868,186,168,354,52.5%,25m
342,1,StepBro,5035,516,14,2,16,87.5%,17m
342,1,Seanybops,5035,26,2,5,7,28.6%,17m
344,1,[PSISTM]TAGurPRGNANT,5031,70,2,3,5,40.0%,3m
344,1,CarGO,5031,0,1,0,1,100.0%,17m
346,1,[iMmsV]sfoRzanDo,5030,0,1,0,1,100.0%,7m
346,1,Menkhu,5030,0,1,0,1,100.0%,17m
348,1,[RnGpro]Armageddon,5029,0,0,3,3,0.0%,26m
349,1,[Kakita]MerCeNario,5028,1033,42,18,60,70.0%,17m
350,1,[RVluv]TLQKFSUSEMF,5027,596,21,6,27,77.8%,3m
351,1,Skyblue,5025,432,14,11,25,56.0%,13m
352,1,[TGosuC]Lyra,5024,1560,60,47,107,56.1%,3m
352,1,[Ex0n]Zen,5024,0,1,0,1,100.0%,7m
354,1,[Ex0n]Ryan,5023,2950,255,209,464,55.0%,13m
354,1,IIIIIIIIIIII,5023,86,3,1,4,75.0%,7m
356,1,llllllllllll,5022,2295,117,99,216,54.2%,31m
356,1,carriermom,5022,1253,58,17,75,77.3%,17m
358,1,[JGalt]silentcoup,5021,48,1,1,2,50.0%,17m
359,1,[SJVV]Lily,5018,389,29,1,30,96.7%,2m
359,1,RamMeal,5018,345,12,9,21,57.1%,8m
361,1,llllllllllll,5015,1264,65,51,116,56.0%,3m
361,1,[ACSS]HeavyFresh,5015,0,1,0,1,100.0%,40m
363,1,[UpeV]Virtuoso,5012,2404,103,73,176,58.5%,17m
363,1,Plecto,5012,1685,82,70,152,53.9%,7m
363,1,[ROOT]Robbie,5012,426,13,7,20,65.0%,13m
366,1,llllllllllll,5010,0,0,1,1,0.0%,6m
367,1,Eilonwy,5008,246,7,3,10,70.0%,17m
367,1,IlIlIlIlIl,5008,250,7,9,16,43.8%,39m
367,1,Solaris,5008,134,3,8,11,27.3%,17m
370,3,[JIGLY]MèoMáiKà,5007,0,0,1,1,0.0%,3m
371,1,deth,5004,767,26,13,39,66.7%,31m
371,1,[CATFUK]Lambdadelta,5004,174,4,2,6,66.7%,17m
373,1,MarineKing,5003,514,13,13,26,50.0%,2m
373,1,[TSØP]HawaiinStyle,5003,48,1,2,3,33.3%,25m
375,1,lIlIlIlIlIlI,5001,2697,127,105,232,54.7%,17m
376,1,RifleCaster,5000,214,5,8,13,38.5%,26m
377,1,[SBoys]Jazzie,4996,603,21,6,27,77.8%,25m
377,1,[SHPony]lIlIlIlIlIlI,4996,507,19,23,42,45.2%,39m
379,1,Madness,4994,0,0,1,1,0.0%,8m
380,1,KingofMech,4991,1234,44,24,68,64.7%,2m
381,1,[Ris3n]sky,4990,2097,95,81,176,54.0%,4m
381,1,[MlGHTY]Chimporus,4990,390,10,11,21,47.6%,31m
383,1,Timothy,4989,2841,429,372,801,53.6%,17m
383,1,Dion,4989,202,6,16,22,27.3%,17m
383,1,[inCo]BabyNeffy,4989,0,1,2,3,33.3%,17m
386,1,JumboTron,4984,226,6,4,10,60.0%,25m
386,1,Legend,4984,0,1,0,1,100.0%,25m
388,1,Fujiwara,4983,758,22,10,32,68.8%,25m
389,1,GetMeOut,4981,181,9,8,17,52.9%,8m
389,1,[NwAs]Draconix,4981,0,0,1,1,0.0%,14m
391,1,MrShaibel,4980,1007,32,21,53,60.4%,40m
392,1,smoothbrain,4979,853,31,18,49,63.3%,4m
392,1,TestAcc,4979,0,0,1,1,0.0%,14m
394,1,MCannix,4978,1477,67,31,98,68.4%,31m
395,1,[WarLT]ThugNasty,4977,0,1,0,1,100.0%,3m
395,1,spectre,4977,0,1,2,3,33.3%,39m
397,1,[GØSU]Fatalmpulse,4975,0,0,1,1,0.0%,17m
398,1,[SydTT]NiceR,4974,1692,70,54,124,56.5%,26m
398,3,[BYU]DelisDaily,4974,0,0,2,2,0.0%,22m
400,1,QuizToWinMMR,4973,2226,110,93,203,54.2%,17m
400,1,Paparoni,4973,1121,57,20,77,74.0%,17m
400,1,[eSun]llllllllllll,4973,0,0,2,2,0.0%,17m
403,1,Larry,4971,254,7,13,20,35.0%,39m
404,1,llllllllllll,4968,1548,67,38,105,63.8%,31m
404,1,SidtheSloth,4968,92,2,2,4,50.0%,2m
406,1,[iMkS]Metallicruc,4966,552,16,8,24,66.7%,4m
407,1,OhHoney,4964,126,4,2,6,66.7%,17m
408,1,llllllllllll,4963,664,58,49,107,54.2%,10m
409,1,Micromancer,4962,2681,246,211,457,53.8%,2m
409,1,FoxSocks,4962,48,2,3,5,40.0%,8m
411,1,pepshi,4961,1217,41,44,85,48.2%,3m
412,1,Antonio,4960,164,5,5,10,50.0%,10m
412,1,Cóckcheck,4960,36,2,0,2,100.0%,40m
414,1,nangdealer,4959,586,34,18,52,65.4%,25m
414,1,[toXsiC]OgSlayer,4959,0,0,1,1,0.0%,8m
416,1,[αX]LastSurprise,4958,976,52,40,92,56.5%,8m
417,1,Slaya,4957,253,32,4,36,88.9%,8m
418,1,omgabanana,4956,1293,43,33,76,56.6%,8m
419,1,IIIIIIIIIIII,4954,1633,79,67,146,54.1%,14m
419,1,[X17]MystiC,4954,1457,70,59,129,54.3%,26m
419,1,Initiative,4954,0,0,1,1,0.0%,3m
422,1,llllllllllll,4951,154,4,4,8,50.0%,10m
423,1,llllllllllll,4950,0,1,0,1,100.0%,31m
424,1,Dad,4948,1139,62,26,88,70.5%,17m
425,1,LaDeZWoshRuM,4947,1551,108,69,177,61.0%,3m
425,1,[αX]Veritas,4947,1888,86,68,154,55.8%,17m
427,1,Dennery,4945,387,18,2,20,90.0%,13m
427,1,WINTER,4945,182,7,6,13,53.8%,13m
429,1,[xRtG]Ora,4939,2206,93,75,168,55.4%,13m
429,1,SwagSurgeon,4939,46,2,4,6,33.3%,18m
431,1,FoxFoxFoxFox,4936,2893,188,194,382,49.2%,25m
431,1,UpATree,4936,620,30,2,32,93.8%,40m
433,1,[CIoud9]IIIIIIIIIIII,4935,1468,73,52,125,58.4%,3m
434,1,[UCI]POlar,4933,2979,163,165,328,49.7%,17m
434,1,Drima,4933,22,2,1,3,66.7%,25m
436,1,[Ris3n]Kilimanjar0,4932,0,0,1,1,0.0%,31m
437,1,UpATree,4930,779,35,5,40,87.5%,40m
438,1,VoyageR,4926,2948,135,121,256,52.7%,17m
439,3,dicescLive,4924,158,7,5,12,58.3%,27m
439,1,SpicyNacho,4924,0,1,0,1,100.0%,6m
441,1,[Probuu]grub,4923,296,9,15,24,37.5%,17m
442,1,IIIIIIIIII,4922,108,3,2,5,60.0%,40m
442,1,[prim8s]KFC,4922,0,1,0,1,100.0%,6m
444,1,waidmannshei,4921,116,4,7,11,36.4%,40m
445,1,[αX]xKawaiian,4920,86,3,8,11,27.3%,26m
445,1,[AYSE]KRIPPFANGIRL,4920,0,1,0,1,100.0%,40m
447,1,Dyukusi,4919,0,0,2,2,0.0%,40m
448,1,llllllllllll,4918,1352,207,184,391,52.9%,17m
449,1,IIIIIIIIII,4916,2789,268,210,478,56.1%,40m
450,1,ProCyborg,4915,1019,35,30,65,53.8%,10m
451,1,nochat,4913,609,29,7,36,80.6%,17m
451,1,[NwAs]Fennix,4913,44,3,0,3,100.0%,31m
453,1,[SydTT]DeJaVu,4910,571,26,14,40,65.0%,25m
454,1,[DIGITL]EndlessGG,4908,80,3,0,3,100.0%,14m
455,1,[VietG]OuTLaW,4906,0,0,1,1,0.0%,40m
456,1,Bulugulu,4905,1045,37,35,72,51.4%,13m
457,1,[Groovy]Nico,4904,2987,165,155,320,51.6%,18m
457,1,[αXLa]Darkness,4904,162,5,4,9,55.6%,8m
459,1,Hellokitty,4903,1051,58,10,68,85.3%,39m
459,1,TingGoSkrrra,4903,387,12,14,26,46.2%,25m
461,1,[Lp]Maiev,4902,562,18,13,31,58.1%,6m
461,1,[SydTT]MeEpwN,4902,0,0,1,1,0.0%,8m
463,1,[GdAT]Mabadi,4901,879,40,30,70,57.1%,26m
463,1,Pudim,4901,188,5,1,6,83.3%,31m
465,1,MaidMelody,4900,447,14,9,23,60.9%,2m
465,1,DeadShadow,4900,0,0,1,1,0.0%,8m
467,1,[L4CRA]IIIIIIIIIII,4897,1359,59,42,101,58.4%,40m
467,1,llllllllll,4897,210,6,2,8,75.0%,8m
469,1,IlIlIlIlIlIl,4896,1039,44,34,78,56.4%,39m
469,1,[TSØP]CrKharloz,4896,0,0,1,1,0.0%,8m
471,1,Apple,4893,2080,80,71,151,53.0%,17m
471,1,[lMMl]Divinesia,4893,613,20,17,37,54.1%,14m
473,1,IIIIIIIIIII,4891,2432,141,108,249,56.6%,14m
474,1,Bash,4888,591,57,48,105,54.3%,8m
474,1,[zeez]Jimmeh,4888,122,3,3,6,50.0%,17m
474,1,Serch,4888,0,0,1,1,0.0%,3m
477,1,YABAI,4887,222,7,3,10,70.0%,8m
477,1,InsoydGaymin,4887,0,0,1,1,0.0%,13m
477,1,[FINDEX]StoicWilly,4887,0,0,2,2,0.0%,40m
480,1,TechBot,4885,1139,40,33,73,54.8%,18m
480,1,Glave,4885,510,14,15,29,48.3%,17m
482,1,atom,4884,32,5,1,6,83.3%,25m
483,1,Antigone,4883,456,13,16,29,44.8%,2m
484,1,DolanSimp,4882,0,0,2,2,0.0%,39m
485,1,[sryITS]Complicated,4881,1429,62,35,97,63.9%,40m
485,1,[DhZCom]Filho,4881,1346,48,40,88,54.5%,25m
487,1,FeelsBadMan,4880,80,7,0,7,100.0%,17m
487,1,[CTsix]northquab,4880,28,1,2,3,33.3%,31m
489,1,NoMercy,4879,816,28,19,47,59.6%,39m
489,1,[DNCE1]llllllllllll,4879,0,0,1,1,0.0%,6m
491,1,[RBTH]MakroMaraude,4878,2871,157,132,289,54.3%,6m
491,1,[AlIin]Pure,4878,0,0,5,5,0.0%,17m
493,1,[L0ne1y]PattyMac,4877,799,28,22,50,56.0%,17m
494,1,[CATFUK]NoEGirls,4876,1877,109,80,189,57.7%,17m
494,1,[xLs]TerrorTerraN,4876,1905,75,67,142,52.8%,13m
494,1,IlIlIlIlllII,4876,632,42,14,56,75.0%,17m
494,1,Pizzaguy,4876,46,2,2,4,50.0%,8m
498,1,UpATree,4875,805,41,10,51,80.4%,25m
498,1,ITisFinished,4875,122,5,1,6,83.3%,26m
498,1,[EZDUNK]deribou,4875,82,2,3,5,40.0%,10m
498,1,llllllllllll,4875,0,0,1,1,0.0%,31m
502,1,[WSCSC2]Juun,4874,0,0,1,1,0.0%,18m
503,1,SlimShady,4873,1767,94,64,158,59.5%,40m
503,3,lllIllIlIllI,4873,145,8,2,10,80.0%,2m
503,1,NaDajeja,4873,270,8,4,12,66.7%,13m
503,1,lfrENzyl,4873,84,3,0,3,100.0%,25m
507,1,Snor,4872,871,44,15,59,74.6%,31m
507,1,[UpeV]NewEra,4872,1071,44,28,72,61.1%,25m
509,1,IIIIIIIIIIII,4870,1447,212,164,376,56.4%,6m
510,1,UpATree,4869,625,31,3,34,91.2%,13m
510,1,[juggr]TeaJay,4869,488,15,10,25,60.0%,2m
510,1,[MisW]Misery,4869,302,9,14,23,39.1%,18m
513,1,Sephiroth,4868,118,4,3,7,57.1%,40m
514,1,IIIIIIIIIIII,4866,1302,55,50,105,52.4%,25m
515,1,MvpGG,4865,1069,45,18,63,71.4%,13m
515,1,[QAnon]Presence,4865,130,4,2,6,66.7%,3m
517,3,[Ato2]FatMan,4864,214,8,3,11,72.7%,41m
518,1,BloodOcean,4862,1157,53,23,76,69.7%,17m
518,1,[TGosuC]RavendarK,4862,1267,52,48,100,52.0%,25m
518,1,Nature,4862,155,6,1,7,85.7%,3m
518,1,chilax,4862,0,1,0,1,100.0%,17m
522,1,[xTQc]Pit,4861,0,1,0,1,100.0%,25m
523,1,EzGameEzLife,4860,485,15,9,24,62.5%,40m
524,1,[Ris3n]Koda,4859,1821,84,90,174,48.3%,14m
524,1,Chingu,4859,0,1,0,1,100.0%,3m
524,1,Classic,4859,0,0,10,10,0.0%,13m
527,1,Mintsc,4858,492,32,1,33,97.0%,17m
527,1,llllllllllll,4858,238,9,4,13,69.2%,25m
529,1,[LGNxx]MoWjAhEeD,4857,782,24,23,47,51.1%,8m
529,1,WinterComing,4857,44,2,0,2,100.0%,3m
531,1,dayum,4856,44,1,4,5,20.0%,18m
531,1,IIIIIIIIIIII,4856,0,0,1,1,0.0%,3m
533,1,[TGCF]deep,4855,2927,351,338,689,50.9%,10m
534,1,[lCY]TurkeyDano,4854,0,0,7,7,0.0%,18m
535,1,Dragon,4852,547,25,12,37,67.6%,8m
535,1,[HoSeeB]FeelsGoodMan,4852,38,1,7,8,12.5%,40m
537,1,[uWu69]MackDaddy,4851,0,0,1,1,0.0%,40m
538,1,lIlIlIlIlIlI,4848,964,31,30,61,50.8%,25m
538,1,[αX]choi,4848,268,7,10,17,41.2%,6m
540,1,[UDPC]NakedTom,4847,0,1,0,1,100.0%,13m
541,1,llllllllllll,4846,180,5,6,11,45.5%,40m
541,1,Roomba,4846,60,3,1,4,75.0%,3m
543,1,IAmTheSenate,4844,1462,67,41,108,62.0%,31m
543,1,SirCarlos,4844,998,39,27,66,59.1%,3m
543,1,[Bloody]NotASword,4844,0,1,0,1,100.0%,10m
543,1,[Ris3n]CollegeWings,4844,0,0,1,1,0.0%,3m
547,1,IIIIIIIIIIII,4843,334,10,6,16,62.5%,10m
548,1,Rainmaker,4842,498,27,2,29,93.1%,13m
549,1,llllllllllll,4839,1484,335,308,643,52.1%,13m
549,1,[UoM]HailStorm,4839,0,1,0,1,100.0%,3m
549,1,hungneezy,4839,44,1,3,4,25.0%,31m
552,1,[xRtG]Rebel,4837,1675,219,195,414,52.9%,40m
552,1,IlllIIllIlIl,4837,520,14,15,29,48.3%,3m
554,1,sAviTar,4836,116,3,6,9,33.3%,26m
554,1,Lemon,4836,90,2,4,6,33.3%,17m
556,1,cheeser,4835,464,25,8,33,75.8%,39m
557,1,XIX,4834,2105,88,85,173,50.9%,26m
557,1,[CS0]XPA,4834,878,32,28,60,53.3%,18m
557,1,[SIoth]aprilterran,4834,0,0,1,1,0.0%,18m
560,1,Bairdo,4832,1843,97,79,176,55.1%,17m
560,1,IIIIIIIIIIII,4832,46,2,0,2,100.0%,25m
560,1,ToastBurner,4832,32,2,3,5,40.0%,8m
563,1,ShXtStorm,4831,2552,107,96,203,52.7%,6m
564,1,Bathtub,4830,1825,81,49,130,62.3%,4m
564,1,[KORKOR]Dreamer,4830,323,12,11,23,52.2%,40m
564,1,Arsenal,4830,136,4,1,5,80.0%,39m
564,1,MacroTerran,4830,0,0,2,2,0.0%,40m
568,1,Prøject,4829,422,14,8,22,63.6%,6m
568,1,Fenix,4829,40,2,2,4,50.0%,10m
568,1,llllllllllll,4829,0,1,0,1,100.0%,3m
571,1,[TGosuD]DEVIN,4828,2965,586,597,1183,49.5%,40m
572,1,[Xelnic]MadoKa,4827,2779,359,360,719,49.9%,10m
572,1,Gelos,4827,2786,173,152,325,53.2%,40m
572,1,Smoke,4827,0,1,1,2,50.0%,10m
575,1,PenSC,4826,2786,230,196,426,54.0%,39m
575,1,SeoGuN,4826,746,40,1,41,97.6%,39m
575,1,Rocha,4826,156,6,7,13,46.2%,40m
575,1,Day,4826,130,3,5,8,37.5%,3m
575,1,[αB]Hyren,4826,0,0,1,1,0.0%,23m
580,1,LoveYouToo,4824,1246,155,163,318,48.7%,6m
580,1,lIllIlII,4824,0,0,1,1,0.0%,26m
582,1,[DTokes]riBCage,4822,0,1,0,1,100.0%,3m
583,1,[BRAAAP]GuruFan,4821,0,1,0,1,100.0%,40m
584,1,TrashGame,4820,361,9,9,18,50.0%,14m
585,1,[X1eHu1]AndyGai,4819,0,0,1,1,0.0%,2m
586,1,ripMFDOOM,4818,533,20,19,39,51.3%,31m
586,1,Byunchul,4818,0,0,3,3,0.0%,8m
588,1,[RBTH]Zura,4817,866,42,35,77,54.5%,10m
589,1,[TeamUR]brms,4816,2807,289,221,510,56.7%,31m
589,1,[αXLa]Dastan,4816,2152,95,93,188,50.5%,39m
589,1,[LoveHY]krJYS,4816,486,25,17,42,59.5%,6m
589,1,[Igbt]ihcakeep,4816,0,3,2,5,60.0%,25m
589,1,Scantid,4816,0,0,3,3,0.0%,4m
594,1,Boomer,4815,299,9,8,17,52.9%,2m
595,1,[αXLa]eGGz,4814,397,17,15,32,53.1%,10m
596,1,[gerG]Greg,4813,590,25,18,43,58.1%,25m
596,1,llllllllllll,4813,244,6,5,11,54.5%,17m
598,1,HotHands,4812,2115,364,317,681,53.5%,3m
598,1,DragonLily,4812,2241,98,84,182,53.8%,39m
600,1,[NeAs]MaelG,4811,260,10,6,16,62.5%,26m
601,1,Gumbi,4809,44,2,1,3,66.7%,17m
602,1,llllllllll,4807,110,3,0,3,100.0%,6m
602,1,IIIIIIIIIIII,4807,0,2,3,5,40.0%,38m
602,1,[EGRIL]CoronaTime,4807,0,0,1,1,0.0%,17m
605,1,llllllllllll,4806,365,19,13,32,59.4%,3m
606,1,Azrael,4805,1925,342,344,686,49.9%,25m
606,1,[xThex]VirginSlayer,4805,2927,142,87,229,62.0%,39m
606,1,Redemption,4805,744,38,12,50,76.0%,18m
606,1,[Kingx]Romeo,4805,0,1,0,1,100.0%,10m
610,1,[NwAs]Draconix,4804,1777,226,217,443,51.0%,3m
611,1,FoxeR,4802,531,28,2,30,93.3%,26m
611,1,dante,4802,353,24,1,25,96.0%,40m
611,1,TomGreen,4802,486,15,11,26,57.7%,6m
611,1,ZukaLaBite,4802,450,13,14,27,48.1%,40m
611,1,[LOVE33]Presence,4802,0,1,0,1,100.0%,8m
616,1,[DhZPro]TAG,4801,578,65,61,126,51.6%,31m
616,1,ByuN,4801,889,48,22,70,68.6%,13m
616,1,[αB]Ozmosis,4801,570,16,20,36,44.4%,25m
616,1,ppgBubbles,4801,230,9,11,20,45.0%,31m
616,1,[ValidG]Pikachoo,4801,228,7,7,14,50.0%,25m
616,1,Nyx,4801,0,0,1,1,0.0%,17m
622,1,[Cryptc]Gandawg,4800,1784,126,108,234,53.8%,26m
622,1,Brook,4800,797,27,21,48,56.2%,18m
622,1,[DuSt]Pride,4800,694,20,38,58,34.5%,14m
622,1,Cherry,4800,238,11,2,13,84.6%,10m
622,1,scvstackkk,4800,210,7,6,13,53.8%,26m
622,1,NohairContro,4800,125,2,2,4,50.0%,13m
622,1,MeFTW,4800,0,1,0,1,100.0%,14m
622,1,[GTs]Lunchador,4800,42,1,9,10,10.0%,3m
630,1,RUSH,4799,499,36,10,46,78.3%,14m
631,2,OpTiMiStC,4798,188,4,8,12,33.3%,9m
632,1,MechBiden,4796,2455,340,352,692,49.1%,31m
632,1,Sonic,4796,484,28,2,30,93.3%,39m
632,1,Milpool,4796,40,2,2,4,50.0%,3m
635,1,[xRtG]Sietesoles,4795,2859,253,218,471,53.7%,17m
636,1,llllllllllll,4794,961,41,33,74,55.4%,39m
636,1,CameronJS,4794,182,9,5,14,64.3%,13m
636,1,IIIIIIIIIIII,4794,84,3,1,4,75.0%,25m
639,1,IIIIIIIIIIII,4793,262,8,7,15,53.3%,18m
639,1,IIVIVIIVIVII,4793,36,2,1,3,66.7%,8m
641,1,BLUEWINGS,4792,2226,132,125,257,51.4%,40m
641,1,[thxsub]Twitchjinioh,4792,522,32,8,40,80.0%,31m
643,1,[eSun]Minnivation,4791,646,36,31,67,53.7%,2m
643,1,IIIIIIIIIIII,4791,471,23,16,39,59.0%,18m
643,1,[Strimm]Sword,4791,162,4,4,8,50.0%,3m
643,1,[Unify]Martin,4791,89,1,1,2,50.0%,6m
647,1,HackaXorean,4790,0,1,0,1,100.0%,26m
648,1,[DmEs]DelaroAlexDA,4789,581,36,10,46,78.3%,17m
648,1,Simplistic,4789,277,9,4,13,69.2%,40m
648,1,ABigCheeser,4789,87,1,1,2,50.0%,3m
648,1,[RevAng]SHAORAN,4789,0,0,1,1,0.0%,26m
652,1,PeekaChi,4788,486,25,17,42,59.5%,5m
652,1,[TPGGXD]ILYLes,4788,128,3,1,4,75.0%,8m
652,1,JSH,4788,0,0,1,1,0.0%,31m
655,1,Bonaparte,4787,1140,113,126,239,47.3%,3m
655,1,[EvilGC]atzin,4787,307,49,29,78,62.8%,2m
655,1,[Jyuzi]IIIIIIIIIIII,4787,502,22,18,40,55.0%,31m
655,1,[xNtG]Axiom,4787,87,1,1,2,50.0%,25m
659,1,[NeAs]LiquidADS,4786,502,31,15,46,67.4%,39m
659,1,MiScopMiHomm,4786,625,29,21,50,58.0%,5m
659,1,GUMGUMRuFFy,4786,884,27,33,60,45.0%,14m
662,1,[BluS]ArtyK,4785,808,110,98,208,52.9%,18m
662,1,[xRtG]HaHa,4785,282,8,6,14,57.1%,2m
662,1,JizzSlammer,4785,113,4,1,5,80.0%,18m
662,1,BADABUN,4785,72,2,3,5,40.0%,13m
662,1,[GTBIG]Rayden,4785,92,1,1,2,50.0%,10m
662,1,[ShoaL]SalmonII,4785,0,0,1,1,0.0%,31m
668,1,GuySensei,4784,2936,206,194,400,51.5%,14m
668,1,IIIIIIIIII,4784,112,3,1,4,75.0%,8m
668,1,[FFAA]Batash,4784,0,1,0,1,100.0%,5m
671,1,HalfMoon,4783,317,22,23,45,48.9%,8m
671,1,[OOWEEE]Jinro,4783,714,22,26,48,45.8%,39m
671,1,Cloudy,4783,0,1,0,1,100.0%,25m
671,1,[asaa]Naisha,4783,0,1,0,1,100.0%,6m
671,1,PsYcHiCmOn,4783,0,0,1,1,0.0%,8m
676,1,Inkarnate,4782,1025,119,129,248,48.0%,3m
676,1,dplyr,4782,112,8,0,8,100.0%,31m
676,1,AndyCohenFan,4782,107,4,0,4,100.0%,13m
676,1,[RøckeT]IIIIIIIIIIII,4782,152,4,20,24,16.7%,6m
680,1,[LoF]RandomNick,4781,1270,48,38,86,55.8%,40m
680,2,[LeoD]IIIIIIIIIIII,4781,410,26,1,27,96.3%,39m
680,1,KEKW,4781,476,15,17,32,46.9%,8m
680,1,Koala,4781,0,4,1,5,80.0%,5m
680,1,Artysta,4781,144,4,3,7,57.1%,18m
685,1,TulaGRANDE,4780,2523,135,109,244,55.3%,13m
685,1,Care,4780,1139,36,41,77,46.8%,31m
687,1,[Ris3n]PBOY,4779,1454,53,49,102,52.0%,17m
687,2,Montreal,4779,0,1,0,1,100.0%,39m
687,1,FlorencioFan,4779,26,1,9,10,10.0%,13m
690,2,DDDDD,4778,18,2,1,3,66.7%,11m
690,1,[iGx]Greg,4778,0,1,1,2,50.0%,6m
692,1,[Slayor]glow,4777,0,0,2,2,0.0%,17m
693,1,Retardbatery,4775,927,56,14,70,80.0%,5m
693,1,Intoxicated,4775,811,32,23,55,58.2%,18m
695,1,BadHorsey,4774,2808,276,265,541,51.0%,8m
695,1,llllllllllll,4774,911,44,36,80,55.0%,25m
697,1,NOTAKON,4772,386,13,27,40,32.5%,40m
698,1,izONE,4771,34,1,2,3,33.3%,26m
698,2,[FANXY]Paul,4771,0,0,1,1,0.0%,36m
700,1,SoK,4770,40,1,4,5,20.0%,13m
701,1,[ArGNA]universe,4769,896,31,27,58,53.4%,31m
701,2,Kampfgruppe,4769,42,1,1,2,50.0%,22m
703,1,[UpeV]Sepheron,4768,1332,136,106,242,56.2%,2m
703,1,[NwAs]Acerdaniel,4768,660,31,22,53,58.5%,25m
705,2,Killboy,4765,1198,62,30,92,67.4%,11m
705,2,[Mc]PrimusDeksia,4765,780,28,36,64,43.8%,20m
707,3,TibetOP,4764,90,4,6,10,40.0%,17m
708,2,llllllllllll,4763,0,1,0,1,100.0%,18m
709,1,fortuitous,4762,1436,57,48,105,54.3%,31m
709,2,llllllllllll,4762,0,1,0,1,100.0%,34m
711,1,BrightHammer,4761,1544,59,55,114,51.8%,2m
711,2,[aviG0D]aviloSoSimp,4761,258,11,4,15,73.3%,14m
713,2,[IMDSI]EtherNal,4760,254,10,5,15,66.7%,14m
713,1,[RØR]RoMSHoT,4760,46,2,4,6,33.3%,2m
715,1,[MFSC2]pezzaperry,4759,2487,235,177,412,57.0%,5m
715,1,[DhZPro]TuKa,4759,147,5,6,11,45.5%,17m
715,2,AvrilLavigne,4759,80,3,1,4,75.0%,39m
718,2,TwoDisInochi,4758,206,7,7,14,50.0%,20m
718,2,llllllllllll,4758,0,3,2,5,60.0%,9m
718,2,Jakttornet,4758,0,0,1,1,0.0%,21m
721,2,CheesyTerran,4757,541,23,15,38,60.5%,26m
721,2,Minatokaze,4757,30,1,1,2,50.0%,9m
723,1,SadMaguroMan,4756,497,33,18,51,64.7%,17m
723,3,demuQueen,4756,0,1,0,1,100.0%,34m
725,1,[FxB]Bojinkins,4753,2243,94,87,181,51.9%,40m
726,1,ezBoys,4752,1049,41,34,75,54.7%,8m
726,1,[αB]Phobia,4752,836,31,27,58,53.4%,3m
728,1,MusCLEMen,4749,2018,85,74,159,53.5%,3m
729,1,[αX]Pacomike,4748,668,21,20,41,51.2%,2m
729,1,llllllllllll,4748,108,3,3,6,50.0%,25m
731,1,SciEm,4747,958,34,35,69,49.3%,10m
732,2,salve,4745,957,52,20,72,72.2%,16m
733,1,[LNGang]LaughNgamez,4744,2250,91,84,175,52.0%,3m
733,1,AlwaysHangry,4744,859,36,27,63,57.1%,18m
733,2,ImaGine,4744,388,13,6,19,68.4%,13m
733,2,GamerMD,4744,8,2,5,7,28.6%,14m
737,1,[VetZCo]Ben,4743,2294,95,81,176,54.0%,17m
737,2,Killboy,4743,42,1,2,3,33.3%,9m
739,2,[FINDEX]StoicWilly,4742,416,20,13,33,60.6%,9m
739,2,Mafia,4742,228,12,1,13,92.3%,11m
741,1,[DikBoy]Narvik,4741,1455,64,48,112,57.1%,13m
742,1,[DhZCom]Kamikaze,4740,2884,535,507,1042,51.3%,17m
743,1,LoraX,4739,2703,145,117,262,55.3%,17m
743,1,[BearMe]Siegfried,4739,1927,103,93,196,52.6%,18m
743,2,Calm,4739,108,5,4,9,55.6%,11m
746,1,[eSun]Pen,4738,2906,478,457,935,51.1%,39m
746,1,[TSØP]NarO,4738,2842,183,179,362,50.6%,2m
746,2,IIIIIIIlllll,4738,224,13,5,18,72.2%,35m
746,2,SoK,4738,80,3,2,5,60.0%,11m
750,1,Hobbit,4737,2876,212,172,384,55.2%,10m
750,2,ssapchobo,4737,84,3,3,6,50.0%,31m
752,1,[SCxPH]PhyNix,4735,2901,225,215,440,51.1%,3m
752,2,YellowFlash,4735,0,1,1,2,50.0%,11m
754,2,[MSUsc2]TitsMcSwag,4734,0,1,0,1,100.0%,26m
755,1,[MutasT]WhiteIdra,4733,2781,581,635,1216,47.8%,8m
755,2,[DarkAG]tunechi,4733,2681,152,161,313,48.6%,18m
755,2,Ramjet,4733,594,29,24,53,54.7%,26m
758,2,[MFSC2]MeomaikaFan,4731,160,7,5,12,58.3%,35m
758,1,Honeybear,4731,0,0,2,2,0.0%,15m
760,2,[SABO]Saboteur,4728,0,0,3,3,0.0%,35m
761,1,Flubbywubby,4724,2683,240,265,505,47.5%,2m
761,1,IIIIIIIIIIII,4724,469,61,65,126,48.4%,14m
761,1,Azula,4724,1416,54,56,110,49.1%,3m
761,1,MimonBaraka,4724,46,2,3,5,40.0%,13m
765,1,GhostPain,4722,54,3,5,8,37.5%,26m
766,2,[NPhase]MeronG,4721,124,5,4,9,55.6%,21m
767,2,[Macac0]JimRising,4720,504,19,19,38,50.0%,26m
767,2,DROPTHEMINE,4720,0,0,1,1,0.0%,13m
769,2,[l5150l]kiddle,4719,467,27,2,29,93.1%,36m
769,2,[iGx]javascript,4719,0,0,1,1,0.0%,35m
771,1,[ValidG]Thor,4718,2885,292,311,603,48.4%,13m
771,1,[UpeV]BrazzerCs,4718,2249,134,120,254,52.8%,14m
771,2,[xGenGx]PiLiPiLi,4718,266,11,11,22,50.0%,26m
771,3,MudKip,4718,261,8,1,9,88.9%,30m
771,1,KingkOng,4718,0,1,4,5,20.0%,39m
776,2,[LGCANZ]MeomaikaFan,4717,293,24,20,44,54.5%,35m
776,2,[juggr]BigLebowski,4717,308,12,12,24,50.0%,22m
778,2,MinBikCok,4716,68,4,3,7,57.1%,39m
778,2,Matlo,4716,42,3,1,4,75.0%,39m
778,2,llllllllll,4716,0,1,0,1,100.0%,11m
778,2,[Scyth]WaEsOpH,4716,12,1,3,4,25.0%,39m
782,2,CrazyCharlie,4715,0,0,1,1,0.0%,9m
783,1,ftw,4714,364,25,5,30,83.3%,40m
784,2,IIIIIIIIIIII,4713,100,5,5,10,50.0%,36m
784,2,[Kapoo]tannOOb,4713,0,0,1,1,0.0%,14m
786,2,TerranUApart,4712,508,33,14,47,70.2%,34m
787,1,Vanish,4711,2796,344,313,657,52.4%,40m
787,1,GooseTheCat,4711,410,39,39,78,50.0%,8m
787,2,[FMX]Spartanking,4711,0,0,3,3,0.0%,16m
790,2,[apoca]Adeul,4710,2586,158,128,286,55.2%,34m
790,2,Rash,4710,492,21,22,43,48.8%,9m
790,2,Ten,4710,82,4,2,6,66.7%,36m
793,2,[NACHT]Virbanium,4709,747,76,31,107,71.0%,34m
794,2,dajiba,4708,20,2,0,2,100.0%,26m
794,2,[NwAs]ulTimeCia,4708,0,0,1,1,0.0%,34m
796,3,Tamago,4706,28,3,1,4,75.0%,30m
796,2,PandaKO,4706,0,1,0,1,100.0%,22m
796,2,[lTKl]Hongi,4706,0,0,1,1,0.0%,26m
799,1,[UofC]iloveoof,4705,2886,408,365,773,52.8%,31m
799,1,[eX]Rocha,4705,2462,266,277,543,49.0%,14m
799,2,[iGx]rust,4705,0,1,0,1,100.0%,35m
799,2,Viettel,4705,28,1,3,4,25.0%,39m
803,1,[FSid3]Elly,4704,469,23,17,40,57.5%,3m
803,2,[Shang]HuShang,4704,368,19,10,29,65.5%,22m
803,2,FlashMarine,4704,0,1,2,3,33.3%,20m
803,2,[BearMe]Waldo,4704,0,0,1,1,0.0%,13m
803,2,[HSGirl]Oono,4704,0,0,1,1,0.0%,18m
808,2,AegiS,4703,0,1,3,4,25.0%,39m
808,2,[RdLzrd]Blake,4703,0,0,1,1,0.0%,13m
810,2,Wall,4702,0,1,0,1,100.0%,22m
810,2,[HoSeeB]IIIIIIIIIIII,4702,0,0,1,1,0.0%,9m
812,1,BreakSouL,4701,2089,98,86,184,53.3%,25m
812,1,Pleb,4701,1936,96,73,169,56.8%,14m
812,2,GeneralTso,4701,633,51,19,70,72.9%,18m
812,2,[MofS]RoLo,4701,0,1,0,1,100.0%,18m
816,1,[xRtG]Typic,4700,1596,73,62,135,54.1%,8m
817,2,llllllllllll,4699,2215,107,83,190,56.3%,36m
818,2,Nepal,4698,28,3,0,3,100.0%,11m
818,2,[G0G0G0]JoaoPistori,4698,0,1,0,1,100.0%,20m
820,1,Ookami,4697,1148,51,60,111,45.9%,10m
820,1,[KiMBR]ReMy,4697,0,0,1,1,0.0%,22m
822,1,[Cryptc]ElNiño,4696,460,14,15,29,48.3%,18m
822,2,Prokofiev,4696,92,4,6,10,40.0%,26m
822,2,IllIIIllllII,4696,0,1,0,1,100.0%,34m
825,2,[INextI]Bogue,4695,106,5,5,10,50.0%,20m
826,1,[Ex0n]NetBio,4694,2883,542,553,1095,49.5%,2m
826,1,[EtrOy]synapse,4694,1634,70,72,142,49.3%,10m
828,2,llllllllllll,4693,66,3,3,6,50.0%,39m
829,1,SET,4692,2848,165,150,315,52.4%,13m
830,1,[PwT]PwTelivolts,4691,2829,621,613,1234,50.3%,3m
830,2,CheeseMeDadi,4691,42,2,4,6,33.3%,11m
832,1,[ArGNA]YaNaRion,4690,2744,124,121,245,50.6%,18m
832,2,[iMkS]Stalife,4690,94,4,3,7,57.1%,14m
832,2,marineIMBA,4690,0,0,1,1,0.0%,31m
835,2,DanteV,4689,829,36,29,65,55.4%,18m
836,1,IIIIIIIIIIII,4688,162,5,9,14,35.7%,39m
837,1,Victorium,4687,1254,46,61,107,43.0%,3m
837,2,[DarkAG]MichaelScott,4687,76,4,3,7,57.1%,9m
839,2,Chemikal,4686,42,1,4,5,20.0%,13m
840,2,ZaramayBaby,4685,882,36,36,72,50.0%,18m
840,2,IMMvp,4685,0,1,3,4,25.0%,20m
840,2,TISM,4685,0,0,1,1,0.0%,9m
843,2,proxyimba,4684,1030,66,7,73,90.4%,14m
844,2,BitterSweet,4682,609,70,60,130,53.8%,35m
844,1,llllllllllll,4682,1040,52,25,77,67.5%,17m
844,1,[Quasr]printf,4682,1308,44,56,100,44.0%,13m
844,2,zzhtw,4682,0,0,1,1,0.0%,34m
848,2,name,4681,62,3,1,4,75.0%,13m
849,2,LOGO,4680,274,12,7,19,63.2%,11m
850,1,Vanish,4679,2779,142,154,296,48.0%,13m
850,2,[αX]TriGGeR,4679,272,10,13,23,43.5%,35m
852,1,UncleClimax,4678,1321,152,181,333,45.6%,10m
852,2,Lomba,4678,570,29,11,40,72.5%,11m
854,2,Saturn,4677,362,17,13,30,56.7%,11m
855,2,IIIIIIIIIIII,4676,906,37,38,75,49.3%,35m
855,2,[Cryptc]GarageFloor,4676,0,0,5,5,0.0%,36m
857,1,llllllllllll,4675,1529,258,253,511,50.5%,25m
857,2,[LgnTDS]OmniSkeptic,4675,1520,63,61,124,50.8%,9m
857,2,ERRORNONAME,4675,467,16,11,27,59.3%,16m
857,2,Carrion,4675,34,2,1,3,66.7%,21m
861,2,crazyman,4674,151,4,2,6,66.7%,35m
861,2,MayanDrina,4674,38,2,2,4,50.0%,22m
863,1,MyWay,4673,564,31,22,53,58.5%,3m
863,2,[ELIDS]QuaNTeL,4673,259,16,17,33,48.5%,9m
865,1,sauza,4672,2767,254,261,515,49.3%,31m
865,2,[eX]GoodUnit,4672,60,2,6,8,25.0%,21m
865,2,[FANXY]thousandPing,4672,0,1,0,1,100.0%,34m
865,2,[IDFI]MeomaikaFan,4672,0,1,1,2,50.0%,21m
869,1,[NPhase]Dolus,4671,1732,81,71,152,53.3%,40m
869,1,[TSØP]Mooro,4671,558,17,25,42,40.5%,14m
869,2,LoveTraps,4671,10,4,2,6,66.7%,9m
869,2,laStDanCe,4671,98,4,7,11,36.4%,21m
869,1,IIIIIIIIIIII,4671,0,1,3,4,25.0%,42m
874,1,[cl0udM]Meep,4670,710,21,36,57,36.8%,8m
874,2,Goma,4670,76,4,1,5,80.0%,39m
874,2,[JIGLY]Arts,4670,0,1,0,1,100.0%,36m
874,2,[BoRnGo]HelmutCool,4670,0,0,1,1,0.0%,31m
878,2,[BbTea]HighWings,4669,0,1,0,1,100.0%,35m
878,2,[AdSC2]Adrrich,4669,0,0,1,1,0.0%,9m
880,2,SilentGhost,4668,0,0,1,1,0.0%,18m
881,2,[NalsEz]IIIIIIIIIIII,4667,307,15,5,20,75.0%,13m
882,2,Benny,4666,0,0,1,1,0.0%,20m
883,2,helloworld,4665,1519,83,62,145,57.2%,14m
883,2,FullRush,4665,0,0,1,1,0.0%,9m
885,1,llllllllllll,4664,1297,46,47,93,49.5%,40m
885,2,[NwAs]BeIieve,4664,272,11,8,19,57.9%,39m
885,2,Deadline,4664,14,1,1,2,50.0%,34m
888,2,HHH,4663,0,0,1,1,0.0%,13m
888,2,Byda,4663,0,0,2,2,0.0%,22m
890,1,[Ris3n]Rath,4662,2146,186,192,378,49.2%,3m
891,1,SpaceJam,4661,2780,187,208,395,47.3%,27m
892,2,llllllllll,4660,317,21,8,29,72.4%,21m
893,2,[FkJeff]Violet,4659,803,47,27,74,63.5%,34m
893,2,llllllllllll,4659,562,23,26,49,46.9%,20m
893,2,MemeBoi,4659,30,1,4,5,20.0%,20m
896,2,llllllllllll,4658,182,7,4,11,63.6%,13m
897,2,[ROOT]duckhunt,4657,2585,152,113,265,57.4%,14m
897,2,hirekui,4657,2018,121,122,243,49.8%,36m
899,1,[Lp]siNder,4656,2104,81,87,168,48.2%,8m
899,2,[LOV3]TakeDown,4656,0,0,1,1,0.0%,14m
899,2,Crypticzz,4656,0,0,2,2,0.0%,34m
902,2,[FkJeff]Mayuyu,4655,719,52,41,93,55.9%,22m
902,2,llllllllll,4655,80,5,5,10,50.0%,36m
904,2,KAI,4654,0,1,0,1,100.0%,36m
904,2,[NEFN]ignorant,4654,0,0,1,1,0.0%,26m
904,2,[LowIQ]Cosmocraft,4654,0,0,2,2,0.0%,31m
907,1,[CCC]ClsClassiC,4653,2808,438,459,897,48.8%,40m
907,1,Gosuhenke,4653,898,61,53,114,53.5%,27m
907,2,[XIICDO]ElPepe,4653,970,46,44,90,51.1%,20m
910,2,[TGCrew]SqrtofnegOne,4652,372,15,15,30,50.0%,34m
910,3,AndréMacher,4652,12,2,0,2,100.0%,26m
912,2,[αX]Aznflipfoo,4651,2433,136,113,249,54.6%,31m
912,2,llllllllllll,4651,247,24,2,26,92.3%,20m
914,2,cleekin,4650,2439,305,295,600,50.8%,11m
914,2,[αB]Puzzle,4650,1170,66,70,136,48.5%,35m
916,1,[DhZCom]PrintSC,4648,1594,64,61,125,51.2%,25m
916,2,USAUSAUSA,4648,264,13,2,15,86.7%,39m
918,2,[NAGARA]llllllllllll,4647,280,16,5,21,76.2%,11m
918,2,IrishLad,4647,304,12,14,26,46.2%,18m
920,2,[Align]DeathdealeR,4645,2270,108,93,201,53.7%,35m
920,2,[lNI]Anxiety,4645,0,0,1,1,0.0%,9m
922,1,[425]dugo,4644,1003,40,44,84,47.6%,27m
922,2,Eksperten,4644,412,23,2,25,92.0%,39m
922,2,llllllllllll,4644,0,0,1,1,0.0%,36m
925,1,Cadenza,4643,0,4,1,5,80.0%,3m
926,2,[STIEMD]SYSY,4642,463,26,6,32,81.2%,39m
927,2,Krylon,4641,2651,248,259,507,48.9%,21m
927,2,Pogi,4641,0,0,1,1,0.0%,39m
929,1,Saliroz,4640,1698,65,64,129,50.4%,10m
929,2,TwitchMaster,4640,358,19,14,33,57.6%,39m
929,2,lIlIlIlIlIlI,4640,312,13,1,14,92.9%,16m
932,2,Worrab,4639,828,31,37,68,45.6%,34m
932,2,IllIIllIIlI,4639,197,8,3,11,72.7%,16m
932,2,Permanence,4639,0,1,0,1,100.0%,13m
932,2,[xRtG]MacUseR,4639,0,1,6,7,14.3%,22m
936,2,[RnGpro]Prototype,4638,204,9,3,12,75.0%,18m
937,1,Infallible,4637,1905,83,79,162,51.2%,7m
937,2,MicrOJordaaN,4637,500,23,15,38,60.5%,21m
937,2,DarkSasuke,4637,228,8,4,12,66.7%,39m
940,2,[MINSAL]Barcode,4636,0,1,0,1,100.0%,9m
941,2,[AMZN]Slumdog,4635,901,43,43,86,50.0%,20m
941,2,HolY,4635,384,15,8,23,65.2%,34m
941,2,[lCY]CalebAracous,4635,280,11,9,20,55.0%,34m
941,2,[SuLcrU]Frogis,4635,0,1,0,1,100.0%,20m
945,2,[YaHaWa]Nerffy,4634,2473,146,99,245,59.6%,9m
945,2,[AnUB]RoboCop,4634,2073,134,109,243,55.1%,21m
945,2,[TeamUR]TEarDroP,4634,672,33,20,53,62.3%,36m
945,2,llllllllllll,4634,0,0,2,2,0.0%,39m
949,2,Pyre,4633,832,36,34,70,51.4%,20m
949,2,Practice,4633,128,6,8,14,42.9%,31m
951,2,[SCxPH]UnknOwNe,4632,0,0,1,1,0.0%,9m
952,1,[xRtG]CameronSharp,4631,259,11,15,26,42.3%,10m
953,1,IIIIIIIIIIII,4630,2424,108,94,202,53.5%,8m
953,2,CoronaChina,4630,319,18,14,32,56.2%,16m
953,2,[iGx]GoldenGød,4630,0,1,0,1,100.0%,35m
956,2,[CTsix]Vespasian,4628,394,17,15,32,53.1%,34m
956,1,[G0G0G0]Austin,4628,143,4,0,4,100.0%,24m
956,2,llllllllllll,4628,36,3,4,7,42.9%,18m
959,1,coronavirus,4627,1566,58,64,122,47.5%,17m
960,2,tucker,4626,2627,374,354,728,51.4%,14m
960,2,[NW5]AhOk,4626,221,11,4,15,73.3%,34m
962,2,[JUIN]Serp,4625,597,29,26,55,52.7%,20m
962,2,Sakura,4625,267,14,3,17,82.4%,13m
962,2,Galois,4625,0,1,0,1,100.0%,34m
965,2,glhf,4624,337,20,10,30,66.7%,16m
966,1,IIIIIIIIIIII,4623,2720,392,389,781,50.2%,31m
966,1,[ACCF]Shinhye,4623,2659,289,251,540,53.5%,8m
966,2,fotbalexpert,4623,2455,134,137,271,49.4%,11m
966,2,[TGosuB]Laziness,4623,156,7,6,13,53.8%,20m
966,2,llllllllllll,4623,0,1,0,1,100.0%,36m
966,2,EECSFOREVER,4623,0,0,1,1,0.0%,14m
972,1,[xRtG]Dire,4622,1937,90,80,170,52.9%,31m
972,2,Shades,4622,211,8,4,12,66.7%,9m
972,2,[HugGMC]ElNino,4622,0,0,1,1,0.0%,9m
972,1,IIIIIIIIIIII,4622,0,0,1,1,0.0%,25m
976,1,iconofsin,4621,2822,201,179,380,52.9%,13m
976,2,[TXOP]Poison,4621,914,37,41,78,47.4%,31m
976,1,Stephano,4621,591,30,28,58,51.7%,31m
976,2,iStimUwin,4621,259,15,10,25,60.0%,21m
980,1,SmokeCocaine,4620,2606,115,100,215,53.5%,13m
980,2,RiccyG,4620,230,29,34,63,46.0%,26m
980,2,VaToss,4620,0,0,3,3,0.0%,22m
983,1,[αB]TheDetweiler,4619,2767,435,492,927,46.9%,2m
984,2,Tianzi,4618,539,25,19,44,56.8%,13m
984,2,IIIlllIIIlll,4618,407,23,14,37,62.2%,36m
984,1,ElevatorGuy,4618,0,0,2,2,0.0%,27m
984,2,DrBojengles,4618,0,0,3,3,0.0%,26m
988,1,Greed,4617,714,27,27,54,50.0%,40m
988,2,TerranPride,4617,128,6,8,14,42.9%,22m
988,2,lllllllllll,4617,0,3,2,5,60.0%,36m
991,2,Pakost,4616,509,25,19,44,56.8%,22m
991,2,sprout,4616,202,8,11,19,42.1%,18m
991,2,Snakevsplane,4616,0,0,3,3,0.0%,35m
994,2,Thrive,4615,66,3,2,5,60.0%,20m
995,1,[PSlSTC]Misery,4614,2514,152,163,315,48.3%,31m
995,2,ProxyTwoRax,4614,336,37,15,52,71.2%,13m
995,2,computer,4614,277,14,7,21,66.7%,14m
995,2,wTinte,4614,0,0,1,1,0.0%,18m
999,1,[LXBoy]Papillon,4613,2681,202,178,380,53.2%,40m
999,2,llllllllllll,4613,134,7,5,12,58.3%,13m
999,2,[FTRUMP]Sinon,4613,50,2,3,5,40.0%,34m
999,2,[DDD3]TenCeNT,4613,0,0,1,1,0.0%,36m
1003,1,IlIllIlIIlI,4612,2632,124,117,241,51.5%,31m
1003,3,ZealotSteve,4612,381,20,1,21,95.2%,8m
1003,2,[aivNA]TonyTransit,4612,184,13,3,16,81.2%,34m
1003,2,[FkJeff]mgjTerran,4612,0,0,1,1,0.0%,39m
1007,2,XIV,4611,592,31,28,59,52.5%,13m
1007,2,[WeLike]patient,4611,0,1,0,1,100.0%,18m
1007,2,[LUE]Chaggi,4611,0,0,1,1,0.0%,18m
1010,2,VCERUSH,4610,1600,310,346,656,47.3%,35m
1010,1,ZOO,4610,2165,114,113,227,50.2%,8m
1010,2,Speaker,4610,492,26,16,42,61.9%,21m
1010,2,[eSun]Lagakht,4610,24,3,0,3,100.0%,9m
1010,2,[FkJeff]INnoVation,4610,0,1,0,1,100.0%,34m
1015,1,llllllllllll,4609,2798,310,327,637,48.7%,17m
1015,2,[DhZPro]mwaltr,4609,964,81,74,155,52.3%,35m
1015,2,[neuroS]Qolt,4609,522,31,19,50,62.0%,20m
1015,2,root,4609,389,20,14,34,58.8%,9m
1019,2,ExWife,4607,22,2,1,3,66.7%,36m
1020,2,FlappyVag,4606,62,3,1,4,75.0%,31m
1021,1,[DhZCom]Artcs,4605,1278,110,116,226,48.7%,27m
1021,2,llllllllllll,4605,949,48,51,99,48.5%,9m
1021,2,IIIIIIIIIII,4605,0,1,0,1,100.0%,11m
1024,2,LingKing,4603,248,12,6,18,66.7%,9m
1024,1,[X17]EarthBoyTroy,4603,0,0,2,2,0.0%,28m
1026,2,[NovaX]Action,4602,2604,236,227,463,51.0%,36m
1026,2,[ScSwrm]Alephnaut,4602,2293,155,162,317,48.9%,11m
1026,1,Law,4602,1476,67,71,138,48.6%,7m
1026,2,llllllllllll,4602,906,45,31,76,59.2%,11m
1026,2,[TW4T]SLUTBUCKET,4602,36,2,3,5,40.0%,34m
1031,2,Coordinated,4601,544,27,29,56,48.2%,14m
1032,2,Mandalore,4600,1852,111,110,221,50.2%,9m
1032,2,Lyndon,4600,0,1,0,1,100.0%,22m
1034,1,Thaniri,4599,2672,238,233,471,50.5%,7m
1034,1,[1tWoK]Dalinar,4599,703,23,34,57,40.4%,8m
1036,2,PikaChoO,4598,369,22,23,45,48.9%,20m
1036,2,luvkill,4598,0,0,1,1,0.0%,34m
1038,1,bryguy,4597,2707,223,207,430,51.9%,17m
1038,1,llllllllllll,4597,0,0,1,1,0.0%,26m
1038,2,Liberty,4597,0,0,2,2,0.0%,11m
1041,2,ZeroAPM,4596,222,14,1,15,93.3%,11m
1042,1,[PSISTM]UpATree,4595,2617,315,296,611,51.6%,25m
1042,2,[mbDeep]Ninjinho,4595,217,16,2,18,88.9%,34m
1042,2,IIIIIIIIIIII,4595,239,8,5,13,61.5%,39m
1042,2,Huh,4595,0,0,3,3,0.0%,21m
1046,1,[NwAs]leshrac,4594,2794,374,357,731,51.2%,39m
1046,2,CattlBruiser,4594,218,10,16,26,38.5%,21m
1046,2,ShiveR,4594,62,4,4,8,50.0%,31m
1049,2,Person,4593,769,32,28,60,53.3%,11m
1049,2,[Gainss]SuperSoldier,4593,348,22,20,42,52.4%,13m
1049,2,llllllllllll,4593,314,18,12,30,60.0%,34m
1049,1,llllllllllll,4593,293,13,13,26,50.0%,25m
1049,2,RaFiki,4593,120,4,7,11,36.4%,22m
1049,2,SpecialK,4593,0,1,0,1,100.0%,20m
1055,2,VibrantBlue,4592,2472,257,283,540,47.6%,11m
1055,2,Megalodon,4592,500,29,20,49,59.2%,14m
1055,2,[SCABS]OPA,4592,0,0,1,1,0.0%,21m
1058,2,lIlIlllIIIlI,4591,1388,68,36,104,65.4%,14m
1058,2,SatireMan,4591,444,32,21,53,60.4%,9m
1060,2,[TSØP]RaMs,4590,1073,66,66,132,50.0%,22m
1060,2,[IMST]WestopoliFAN,4590,10,2,0,2,100.0%,13m
1062,2,[HAV0C]cutegrrl,4589,974,49,23,72,68.1%,31m
1062,2,Radan,4589,652,28,38,66,42.4%,27m
1062,2,[JOSUN]Jindotgae,4589,0,0,1,1,0.0%,9m
1065,1,[xLgNx]ColiNfsTrann,4588,2788,106,131,237,44.7%,17m
1066,2,[CG]Bop,4587,148,7,13,20,35.0%,22m
1067,2,Arson,4586,258,20,6,26,76.9%,13m
1067,2,llllllllll,4586,259,9,3,12,75.0%,21m
1067,2,[ArGNA]Rhizer,4586,194,6,6,12,50.0%,21m
1070,2,WaterBird,4584,707,41,18,59,69.5%,14m
1070,2,Cinnabon,4584,366,13,20,33,39.4%,21m
1072,2,llllllllllll,4583,2100,93,90,183,50.8%,9m
1072,2,[Ris3n]Rycerj,4583,1016,44,42,86,51.2%,31m
1074,2,[PTHero]Leetz,4582,2564,304,312,616,49.4%,13m
1074,2,llllllllllll,4582,436,23,4,27,85.2%,21m
1074,2,[DRKPMT]Jayxp,4582,526,22,32,54,40.7%,34m
1074,2,[nG]ZaCRo,4582,34,2,4,6,33.3%,39m
1078,2,[MYi]gladius,4581,0,1,0,1,100.0%,35m
1079,2,[izumi]ZARD,4580,258,18,0,18,100.0%,22m
1079,2,NoLogik,4580,352,13,13,26,50.0%,11m
1079,2,llllllllllll,4580,0,1,0,1,100.0%,31m
1079,2,llllllllllll,4580,0,0,1,1,0.0%,27m
1079,2,[αXLa]TheVirusLove,4580,0,0,1,1,0.0%,31m
1084,2,[DhZCom]DakkoN,4579,2491,259,266,525,49.3%,13m
1084,2,[cl0udM]DHDH,4579,2248,149,135,284,52.5%,36m
1084,2,[ZTemp]RangeRojo,4579,1488,93,36,129,72.1%,14m
1087,2,[Lp]kevin,4578,606,32,30,62,51.6%,35m
1087,3,llllllllllll,4578,408,21,2,23,91.3%,8m
1089,2,[INextI]Ban,4577,0,1,0,1,100.0%,20m
1090,2,SymphoniC,4576,503,39,32,71,54.9%,20m
1090,1,Radiance,4576,641,23,31,54,42.6%,3m
1090,2,Sabana,4576,26,2,1,3,66.7%,34m
1090,2,[TSØP]Vader,4576,24,1,4,5,20.0%,27m
1090,2,[lNI]Spook,4576,0,0,1,1,0.0%,22m
1095,1,llllllllllll,4575,2523,169,187,356,47.5%,40m
1095,2,[CG]Homestar,4575,501,61,61,122,50.0%,22m
1095,2,[SDC12]dougsam,4575,311,22,17,39,56.4%,31m
1095,2,[PSlSTC]MyLifeFrAiur,4575,0,0,1,1,0.0%,35m
1099,2,[xRtG]xobythesword,4574,2577,176,155,331,53.2%,35m
1099,2,Vitamin,4574,0,0,1,1,0.0%,39m
1101,2,drfyy,4573,624,35,17,52,67.3%,22m
1101,2,himan,4573,0,0,1,1,0.0%,34m
1103,2,[UpeV]TheStreet,4572,206,13,8,21,61.9%,9m
1103,2,[TGosuD]Sheep,4572,0,1,0,1,100.0%,31m
1103,1,ice,4572,0,0,23,23,0.0%,18m
1106,2,Hoskyhosk,4571,1800,139,137,276,50.4%,31m
1106,2,GUCCI,4571,1008,52,30,82,63.4%,16m
1106,1,nerfmepls,4571,0,0,1,1,0.0%,27m
1109,1,[SABO]Coffee,4570,2210,233,177,410,56.8%,18m
1109,2,Artifice,4570,1912,82,95,177,46.3%,34m
1109,1,[PLA2N]JashaStar,4570,1305,59,47,106,55.7%,17m
1109,2,[FabIed]Integral,4570,1105,53,48,101,52.5%,39m
1109,2,techboy,4570,0,0,1,1,0.0%,14m
1109,3,Sherminator,4570,0,0,1,1,0.0%,3m
1115,2,Tiga,4569,243,13,7,20,65.0%,20m
1115,2,[AMZN]pult,4569,122,9,5,14,64.3%,35m
1115,1,[DAVFAN]David,4569,168,5,4,9,55.6%,10m
1115,2,Nova,4569,83,2,0,2,100.0%,31m
1119,2,[DmnTz]DCZ,4568,0,0,1,1,0.0%,11m
1119,2,[Chiz]Noel,4568,0,0,1,1,0.0%,20m
1121,1,Sympathy,4567,193,4,2,6,66.7%,42m
1121,2,BaBuShaSha,4567,0,1,0,1,100.0%,9m
1123,2,SoK,4566,2081,123,101,224,54.9%,31m
1123,2,HYRJYFYRPTYL,4566,483,25,11,36,69.4%,9m
1125,2,SashaGrey,4565,459,27,17,44,61.4%,16m
1125,2,[FMX]KarmaDealer,4565,0,0,1,1,0.0%,34m
1127,2,Schaeffer,4564,2325,198,194,392,50.5%,14m
1127,2,IlIllIIlIlII,4564,2411,136,132,268,50.7%,9m
1127,2,[DhZPro]MATADORSCII,4564,1437,133,109,242,55.0%,9m
1127,3,brodo,4564,181,11,1,12,91.7%,8m
1127,2,PikeMence,4564,0,1,0,1,100.0%,21m
1132,2,[HMTeam]AreZ,4563,2556,204,225,429,47.6%,9m
1132,2,llllllllllll,4563,526,32,11,43,74.4%,39m
1132,2,[RBTH]CedriK,4563,516,32,20,52,61.5%,21m
1132,2,hendralisk,4563,750,32,35,67,47.8%,13m
1132,2,[LimaSC]vergas,4563,244,20,6,26,76.9%,39m
1132,1,llllllllllll,4563,384,8,1,9,88.9%,12m
1132,1,dupdup,4563,122,3,5,8,37.5%,20m
1132,2,[SydTT]Mayuyu,4563,80,2,1,3,66.7%,35m
1132,2,SHU,4563,0,1,0,1,100.0%,11m
1132,2,OFRPARIS,4563,0,0,1,1,0.0%,35m
1132,2,JKM,4563,0,0,3,3,0.0%,34m
1143,2,[Raven1]Jacky,4562,86,3,2,5,60.0%,13m
1143,2,[HSGirl]OonoAkira,4562,0,0,1,1,0.0%,18m
1145,2,[SDTL]Aloera,4561,1815,200,223,423,47.3%,20m
1145,2,Zinger,4561,1123,46,51,97,47.4%,14m
1145,2,IIIIIIIIIIII,4561,169,11,3,14,78.6%,22m
1145,2,[αX]ViruS,4561,106,4,7,11,36.4%,14m
1149,1,[Ris3n]LazyTitan,4560,1221,59,66,125,47.2%,15m
1149,2,Shura,4560,0,0,1,1,0.0%,31m
1151,2,[Suisei]Hoshimachi,4559,427,23,3,26,88.5%,39m
1151,2,Wabble,4559,151,6,4,10,60.0%,9m
1151,2,GoblinGirl,4559,0,1,0,1,100.0%,35m
1154,2,dPuMa,4558,1728,78,75,153,51.0%,9m
1154,2,OutCastThor,4558,93,3,1,4,75.0%,35m
1154,2,DazH,4558,42,2,7,9,22.2%,22m
1154,2,Aeon,4558,0,1,0,1,100.0%,18m
1154,2,OwL,4558,0,0,1,1,0.0%,11m
1159,2,crBox,4557,789,36,33,69,52.2%,21m
1159,2,[LaSt]Rowrin,4557,166,7,6,13,53.8%,9m
1159,2,[GØSU]EmBánGiày,4557,36,1,2,3,33.3%,18m
1159,2,llllllllllll,4557,0,0,1,1,0.0%,36m
1163,2,[TeamUR]Blazejwa,4556,70,4,5,9,44.4%,21m
1163,2,llllllllllll,4556,75,2,1,3,66.7%,18m
1163,2,Drama,4556,0,1,0,1,100.0%,11m
1166,2,[ROOT]ViBE,4555,908,35,38,73,47.9%,27m
1166,2,GETOUT,4555,447,29,7,36,80.6%,22m
1168,2,[TeamNv]NvRossi,4554,1027,73,57,130,56.2%,34m
1169,2,Noodle,4553,919,40,37,77,51.9%,11m
1169,2,[AvsA]PsYche,4553,417,26,33,59,44.1%,31m
1169,1,[CJB]ian,4553,323,10,18,28,35.7%,40m
1169,2,Bundo,4553,0,1,0,1,100.0%,11m
1169,2,MonkeyMonkey,4553,0,0,2,2,0.0%,39m
1174,2,[Ex0n]Spy,4552,128,7,6,13,53.8%,34m
1175,2,[AlIin]Yoyo,4551,323,13,16,29,44.8%,9m
1176,2,Arlyne,4550,829,47,29,76,61.8%,9m
1177,2,kaybee,4549,1774,85,71,156,54.5%,39m
1177,1,Papaours,4549,48,1,1,2,50.0%,29m
1177,3,[SsaYnS]resolve,4549,0,0,1,1,0.0%,41m
1180,2,Omelette,4548,2555,216,207,423,51.1%,27m
1180,2,[NPhase]darklight,4548,1341,124,110,234,53.0%,11m
1180,2,[JOSUN]ChooNo,4548,557,47,32,79,59.5%,18m
1180,2,ppppvvvv,4548,176,5,5,10,50.0%,22m
1180,3,[HAV0C]KriXuS,4548,0,0,1,1,0.0%,4m
1185,2,LoveandHate,4547,1011,50,38,88,56.8%,9m
1185,2,Barcode,4547,173,9,5,14,64.3%,36m
1185,3,BamBam,4547,0,1,0,1,100.0%,6m
1188,2,TSyDoOT,4545,174,8,6,14,57.1%,18m
1188,2,[αX]Hjax,4545,32,2,5,7,28.6%,13m
1188,3,SacredCocos,4545,0,0,1,1,0.0%,5m
1191,3,Tommyrod,4544,1329,115,108,223,51.6%,20m
1192,2,FuManChu,4543,2563,305,319,624,48.9%,27m
1192,3,[cronk]CAVEMAN,4543,0,0,1,1,0.0%,11m
1194,2,[Rival]Redkeekee,4542,864,79,90,169,46.7%,9m
1194,2,[Lp]MarineBoss,4542,1652,78,80,158,49.4%,21m
1194,3,Prokiller,4542,8,1,2,3,33.3%,34m
1194,2,Chimp,4542,0,1,3,4,25.0%,25m
1194,3,[ArGNA]Warren,4542,0,0,1,1,0.0%,6m
1194,3,Alan,4542,0,0,1,1,0.0%,26m
1200,2,[PSC]Mokomi,4541,290,15,18,33,45.5%,35m
1201,3,Flos,4540,16,4,1,5,80.0%,17m
1201,2,[RBTH]CristianoX,4540,18,2,5,7,28.6%,36m
1201,2,[ByuJi]NanBong,4540,86,1,3,4,25.0%,31m
1204,3,llllIlIlIlIl,4539,302,19,13,32,59.4%,5m
1204,2,Bomber,4539,176,10,8,18,55.6%,27m
1204,3,[M2A5]darkwarrior,4539,0,0,1,1,0.0%,25m
1207,1,[xRtG]BBB,4538,2635,374,360,734,51.0%,25m
1207,2,[eX]Tricolor,4538,356,14,19,33,42.4%,14m
1207,3,[NPhase]Wabbit,4538,0,1,0,1,100.0%,30m
1210,2,CHL,4537,299,16,14,30,53.3%,18m
1211,2,Empower,4536,377,41,40,81,50.6%,13m
1211,3,llllllllllll,4536,0,0,1,1,0.0%,12m
1213,2,[WTZ]Silas,4535,66,4,5,9,44.4%,35m
1214,2,[xJGMx]EvolvE,4534,936,43,51,94,45.7%,11m
1215,3,Gandhi,4533,0,1,0,1,100.0%,23m
1215,2,llllllllllll,4533,0,1,3,4,25.0%,9m
1217,1,llllllllllll,4531,1671,146,133,279,52.3%,7m
1217,3,[oJKo]MolyPercocet,4531,44,6,2,8,75.0%,4m
1217,3,DuSt,4531,56,4,1,5,80.0%,6m
1217,2,[cloudM]InVerSe,4531,12,1,4,5,20.0%,35m
1221,2,[αX]Dust,4529,2283,224,233,457,49.0%,31m
1221,2,[NovaX]Ysorigin,4529,104,6,9,15,40.0%,9m
1221,3,[αB]Slayer,4529,12,2,1,3,66.7%,12m
1221,3,MalcolmXWing,4529,0,1,0,1,100.0%,12m
1225,2,AMLO,4528,798,38,37,75,50.7%,11m
1225,2,kumar,4528,142,8,6,14,57.1%,21m
1225,3,[SsaYnS]Hyuna,4528,0,0,1,1,0.0%,32m
1228,2,FrankTheTank,4527,418,14,25,39,35.9%,20m
1228,2,[GØSU]AlexTG,4527,164,6,14,20,30.0%,20m
1228,2,[HAV0C]Holey,4527,76,4,10,14,28.6%,22m
1231,2,Mathias,4526,1156,59,38,97,60.8%,36m
1232,1,HammonD,4523,48,2,1,3,66.7%,27m
1233,3,KTqurater,4522,383,18,3,21,85.7%,27m
1234,3,Booty,4521,0,1,0,1,100.0%,20m
1234,3,AkashSky,4521,0,1,2,3,33.3%,8m
1236,3,DoodyBop,4520,424,22,2,24,91.7%,27m
1237,3,Terxel,4519,0,0,2,2,0.0%,30m
1238,2,Matrix,4518,774,67,36,103,65.0%,13m
1238,2,ShadowThor,4518,895,41,39,80,51.2%,14m
1238,2,BBOY,4518,448,24,21,45,53.3%,9m
1238,3,[GUCCl]Julia,4518,32,2,3,5,40.0%,37m
1238,3,[HoSeeB]bEnAndrEw,4518,0,0,3,3,0.0%,6m
1243,2,Natum,4517,2499,244,261,505,48.3%,11m
1243,3,ACinfr,4517,0,1,0,1,100.0%,26m
1243,3,kane,4517,16,1,2,3,33.3%,34m
1243,3,[xNtG]FlawlessPim,4517,0,0,1,1,0.0%,21m
1243,2,Crysing,4517,0,0,10,10,0.0%,36m
1248,3,BarNaBaS,4516,384,20,3,23,87.0%,4m
1248,1,[WNTRCO]Brenda,4516,254,10,0,10,100.0%,10m
1250,2,[eSun]FurryUwU,4515,2311,129,107,236,54.7%,9m
1250,2,IIIIIIIIIIII,4515,818,39,42,81,48.1%,35m
1250,2,IIIIIIIIIIII,4515,0,2,2,4,50.0%,20m
1253,3,[NISHI]MARUCHAN,4514,2110,288,298,586,49.1%,6m
1253,3,[13und]Pwnyo,4514,429,33,21,54,61.1%,37m
1255,2,[500CC]zzzawoyzzz,4513,0,0,5,5,0.0%,20m
1256,3,Lamduy,4512,88,9,5,14,64.3%,11m
1256,3,[FxB]kccasey,4512,0,0,1,1,0.0%,23m
1258,2,[1E100]Gyalgatine,4511,139,7,7,14,50.0%,9m
1258,3,Cycy,4511,32,5,1,6,83.3%,4m
1260,2,Reaper,4510,84,3,3,6,50.0%,14m
1260,3,[TeamUR]UltimateHero,4510,0,0,1,1,0.0%,27m
1260,3,david,4510,0,0,1,1,0.0%,21m
1263,3,yaoyao,4508,1452,109,102,211,51.7%,12m
1263,2,Pickle,4508,291,20,10,30,66.7%,39m
1263,3,ElCacas,4508,22,2,1,3,66.7%,5m
1263,3,Jack,4508,0,1,0,1,100.0%,6m
1263,3,[AKLsc]ForStaR,4508,4,1,3,4,25.0%,41m
1263,3,[Hack69]ElTramposo,4508,0,0,2,2,0.0%,35m
1269,2,Mingo,4506,465,48,45,93,51.6%,20m
1269,2,jollywodfker,4506,546,27,29,56,48.2%,36m
1269,3,DESTINY,4506,14,2,1,3,66.7%,32m
1272,1,llllllllllll,4505,2744,453,432,885,51.2%,40m
1272,1,LOOTBOX,4505,383,17,3,20,85.0%,23m
1272,2,llllllllllll,4505,0,0,2,2,0.0%,38m
1275,2,[xRtG]Mukiwaa,4504,2090,117,129,246,47.6%,31m
1275,3,[Cind3r]Slained,4504,34,3,3,6,50.0%,5m
1275,2,poker,4504,24,2,7,9,22.2%,14m
1275,3,Next,4504,0,1,1,2,50.0%,20m
1279,1,[Ris3n]Bonachon,4503,2521,164,192,356,46.1%,8m
1279,2,QUEEK,4503,731,47,37,84,56.0%,11m
1279,3,IIIIIIIIIIII,4503,66,6,9,15,40.0%,35m
1282,2,[TGosuB]MewMewDewm,4502,770,40,34,74,54.1%,14m
1282,3,Villain,4502,0,1,4,5,20.0%,25m
1284,2,[5555]Mouse,4501,2504,266,286,552,48.2%,39m
1284,3,Computer,4501,177,9,1,10,90.0%,39m
1284,3,IIIIIIIIIIII,4501,26,4,5,9,44.4%,8m
1284,3,Enigma,4501,0,0,1,1,0.0%,3m
1288,2,Hellbat,4500,2536,270,267,537,50.3%,18m
1288,2,Defensive,4500,1878,147,147,294,50.0%,14m
1288,2,[LoF]TheGladiator,4500,1753,81,79,160,50.6%,14m
1288,3,BuTViK,4500,0,1,0,1,100.0%,27m
1288,3,BrunoEarth,4500,0,0,3,3,0.0%,32m
1293,2,mgjgshxd,4499,893,69,65,134,51.5%,21m
1293,3,Hidra,4499,0,0,2,2,0.0%,37m
1295,3,CryStun,4498,54,10,7,17,58.8%,39m
1295,3,OrbánViktor,4498,16,2,1,3,66.7%,26m
1295,3,[LimaSC]JuanKING,4498,0,1,0,1,100.0%,32m
1298,2,[1E100]Stealthbreed,4497,1048,97,97,194,50.0%,35m
1298,2,[DhZPro]Sif,4497,420,23,28,51,45.1%,9m
1298,2,MMRtoVeritas,4497,72,3,7,10,30.0%,27m
1301,2,Machine,4496,2054,94,107,201,46.8%,9m
1301,2,Nuc,4496,731,60,49,109,55.0%,13m
1301,3,TheSTC,4496,97,1,4,5,20.0%,34m
1301,3,sbsb,4496,0,0,1,1,0.0%,6m
1305,2,[TAW]SpaceMarine,4495,540,28,23,51,54.9%,9m
1305,3,rush,4495,379,27,8,35,77.1%,17m
1307,3,[Heen]BanelingKing,4494,921,57,44,101,56.4%,27m
1307,2,vestnik,4494,614,36,14,50,72.0%,11m
1307,2,[Ris3n]Stephen,4494,165,11,10,21,52.4%,13m
1310,1,xOc,4493,2454,106,129,235,45.1%,40m
1311,3,Bouldestress,4492,0,1,0,1,100.0%,6m
1312,3,[JURT]KarrA,4491,0,0,2,2,0.0%,4m
1313,2,[M2A5]RelaxAcc,4490,1443,74,70,144,51.4%,9m
1313,3,IIIIIIIIIIII,4490,186,5,9,14,35.7%,4m
1315,3,nihao,4489,0,0,1,1,0.0%,23m
1315,3,[HSPAS]Ebony,4489,0,0,3,3,0.0%,32m
1317,2,[NovaX]Soda,4488,952,47,44,91,51.6%,27m
1317,2,Wontstop,4488,0,0,5,5,0.0%,31m
1319,3,[NwAs]Nomad,4487,114,13,14,27,48.1%,39m
1319,3,[Parkto]Fantasia,4487,38,5,6,11,45.5%,11m
1319,2,RandomName,4487,112,5,12,17,29.4%,13m
1319,3,DTRAW,4487,12,2,2,4,50.0%,25m
1319,3,King,4487,0,1,0,1,100.0%,8m
1324,2,JoniMitchell,4486,130,7,11,18,38.9%,9m
1325,1,[UhOhJo]SquidGunZ,4484,2537,116,143,259,44.8%,10m
1325,3,[NPhase]Eclipse,4484,379,29,28,57,50.9%,34m
1327,1,[ROOT]RanDOOM,4483,2676,507,536,1043,48.6%,5m
1327,1,IlIlIlIlIlIl,4483,800,40,55,95,42.1%,8m
1327,3,Speaknow,4483,144,21,13,34,61.8%,23m
1327,1,ByunJovi,4483,168,8,0,8,100.0%,12m
1327,3,[iFox]Haeyoon,4483,0,0,1,1,0.0%,34m
1332,3,[ezBad]rncg,4482,396,27,31,58,46.6%,5m
1332,3,WarMonger,4482,415,22,5,27,81.5%,27m
1332,2,lIlIlIlIlIlI,4482,508,22,31,53,41.5%,35m
1335,2,Rel,4481,850,34,44,78,43.6%,27m
1335,2,[J3wIQ]JudaicChad,4481,258,14,15,29,48.3%,18m
1335,3,FireBat,4481,68,8,5,13,61.5%,30m
1335,3,Roca,4481,52,7,4,11,63.6%,34m
1335,3,[ExcIgN]SlayersBoxer,4481,66,6,5,11,54.5%,6m
1340,2,[Morky]TRAGIC,4480,2466,119,121,240,49.6%,36m
1340,2,imissIdrA,4480,804,57,57,114,50.0%,27m
1340,3,Atoms,4480,180,19,13,32,59.4%,11m
1340,3,Liberty,4480,0,1,0,1,100.0%,6m
1340,3,DarkTilRisen,4480,16,1,4,5,20.0%,25m
1340,2,[hOpp]Bathtub,4480,22,1,9,10,10.0%,9m
1346,3,[xRtG]eXqUiSiTe,4479,1042,90,93,183,49.2%,37m
1346,3,[GYDR]Farvestoffer,4479,0,1,0,1,100.0%,11m
1346,2,jcc,4479,6,1,8,9,11.1%,11m
1349,2,SKTFaker,4478,1286,157,66,223,70.4%,40m
1349,3,[LUSK]Skeetz,4478,8,2,2,4,50.0%,35m
1351,2,Mason,4477,371,17,21,38,44.7%,27m
1351,3,IIIIIIIIIII,4477,28,1,2,3,33.3%,17m
1353,2,[UofC]SuNmAN,4476,2496,232,219,451,51.4%,9m
1353,2,[NerfMe]SouljaBoy,4476,875,39,43,82,47.6%,22m
1353,3,lIllIlllIlIl,4476,82,12,5,17,70.6%,20m
1353,3,SadoTerran,4476,0,1,0,1,100.0%,21m
1357,3,SteveStifler,4475,0,1,0,1,100.0%,23m
1357,3,[lLiTl]Wugi,4475,0,1,1,2,50.0%,4m
1357,3,Bluesader,4475,0,0,1,1,0.0%,8m
1360,2,[DTokes]Cisplatin,4474,2188,89,126,215,41.4%,31m
1360,1,Guilty,4474,48,2,1,3,66.7%,25m
1362,2,Prosper,4473,2380,117,146,263,44.5%,9m
1362,3,BartSimpson,4473,0,1,0,1,100.0%,20m
1364,3,BJH,4472,1426,85,49,134,63.4%,8m
1364,1,llllllllllll,4472,0,1,0,1,100.0%,27m
1366,2,Yoyo,4471,440,27,15,42,64.3%,36m
1367,2,salopette,4470,2487,247,264,511,48.3%,20m
1367,3,Berzerker,4470,36,4,0,4,100.0%,39m
1367,3,[Sune]Kaluz,4470,6,1,1,2,50.0%,25m
1370,3,AlphaStar,4469,0,1,0,1,100.0%,3m
1371,3,MadBadSad,4468,1971,119,97,216,55.1%,39m
1371,3,luvkillwow,4468,386,28,26,54,51.9%,5m
1371,3,[AD3C]Dari,4468,0,0,1,1,0.0%,41m
1374,2,[NPhase]VelvetThunda,4467,181,13,10,23,56.5%,31m
1375,3,JiBenGong,4466,22,4,7,11,36.4%,4m
1375,3,iNN,4466,30,3,0,3,100.0%,35m
1377,2,Creation,4465,1099,55,75,130,42.3%,21m
1377,3,[4WG]ClickPrime,4465,34,4,7,11,36.4%,4m
1379,3,[NAis]ezpz,4464,445,31,16,47,66.0%,5m
1379,3,IIIIIIIIIIII,4464,334,28,9,37,75.7%,41m
1379,3,[SCTP]KOYO,4464,6,2,2,4,50.0%,4m
1379,3,[xRtG]Conman,4464,12,1,4,5,20.0%,23m
1383,2,[Msia]TwoTrickPony,4463,2266,169,158,327,51.7%,14m
1383,2,[Cryptc]Astra,4463,1453,80,70,150,53.3%,21m
1383,3,[UpeV]Ferxt,4463,909,78,69,147,53.1%,17m
1383,3,DAMONHA,4463,136,12,10,22,54.5%,25m
1387,3,[SuperZ]TheRedDeath,4462,2329,295,294,589,50.1%,34m
1387,2,[PatchT]BasedGob,4462,664,63,72,135,46.7%,22m
1387,3,IKizzy,4462,10,2,3,5,40.0%,6m
1387,2,fAzNi,4462,0,1,0,1,100.0%,33m
1391,3,[rgZ]Yui,4461,360,44,44,88,50.0%,6m
1392,3,[iMkS]TSyBoOT,4460,44,5,4,9,55.6%,32m
1392,3,Present,4460,28,2,1,3,66.7%,39m
1392,3,Flashuism,4460,0,0,1,1,0.0%,4m
1395,3,MrJonesLp,4459,310,26,10,36,72.2%,42m
1395,3,llllllllllll,4459,210,15,15,30,50.0%,17m
1395,3,[VLHLMH]Lamduy,4459,56,10,3,13,76.9%,5m
1395,3,YBYB,4459,4,2,0,2,100.0%,17m
1395,3,[GUCCl]moma,4459,0,0,1,1,0.0%,23m
1400,3,[Ris3n]Darkson,4458,10,1,7,8,12.5%,4m
1401,2,SummiT,4457,1171,60,49,109,55.0%,14m
1401,3,llIlIIIllIlI,4457,50,8,7,15,53.3%,41m
1401,3,Crazy,4457,3,5,6,11,45.5%,41m
1401,3,CheekClapper,4457,28,5,7,12,41.7%,35m
1401,3,llllllllllll,4457,4,1,1,2,50.0%,42m
1401,3,[TSFs]Quakeroats,4457,0,0,1,1,0.0%,3m
1401,3,Bohne,4457,0,0,1,1,0.0%,30m
1408,2,[TSØP]EpSiLoN,4456,1585,80,68,148,54.1%,27m
1408,3,shimizu,4456,498,49,37,86,57.0%,17m
1408,3,RoceirO,4456,0,0,1,1,0.0%,4m
1411,3,SynQ,4455,0,1,0,1,100.0%,12m
1411,3,[inCo]iHaxGGnoRE,4455,0,1,0,1,100.0%,35m
1411,3,PuppyKing,4455,8,1,2,3,33.3%,39m
1411,3,[Nerdz]ToxicPotato,4455,0,0,1,1,0.0%,32m
1411,3,[VAPEem]Psy,4455,0,0,1,1,0.0%,17m
1416,2,[hTx]Shrimp,4454,639,37,31,68,54.4%,36m
1416,2,[TPL]Panda,4454,66,4,7,11,36.4%,13m
1416,3,[MBTW]Rowey,4454,0,1,0,1,100.0%,4m
1416,3,[A1M]Eric,4454,0,0,1,1,0.0%,39m
1420,3,llllllllllll,4453,134,13,9,22,59.1%,42m
1420,3,[MadK]Rescue,4453,56,4,2,6,66.7%,4m
1420,3,[Swisss]BabySwiss,4453,0,0,1,1,0.0%,4m
1420,3,Fiblo,4453,0,0,1,1,0.0%,23m
1424,1,[PSISTM]morn,4452,350,11,24,35,31.4%,18m
1424,1,NoobCake,4452,0,2,5,7,28.6%,23m
1424,3,[Fir3s]Brad,4452,0,1,1,2,50.0%,4m
1424,3,intoTheTrees,4452,0,0,1,1,0.0%,12m
1428,3,[PTHero]FireBird,4451,1721,88,95,183,48.1%,6m
1428,3,[D4NGER]stranger,4451,8,2,5,7,28.6%,37m
1430,2,[xRtG]cHuT,4450,2538,239,255,494,48.4%,9m
1430,3,llllllllllll,4450,94,10,8,18,55.6%,39m
1432,3,[xRtG]Void,4449,0,0,1,1,0.0%,6m
1433,3,[SQB]Buttons,4447,562,42,43,85,49.4%,34m
1433,3,aSaHerBa,4447,232,9,3,12,75.0%,8m
1433,3,Joe,4447,0,2,3,5,40.0%,27m
1433,3,[InGt]Fig,4447,0,1,0,1,100.0%,35m
1437,3,Holic,4446,401,24,16,40,60.0%,30m
1437,3,[TSØP]LeonªsMercs,4446,0,1,0,1,100.0%,32m
1437,3,IIIIIIIIIIII,4446,0,0,1,1,0.0%,41m
1440,1,Fear,4445,2694,331,378,709,46.7%,10m
1440,3,[TAW]TeRrAnBrOkEn,4445,386,22,14,36,61.1%,25m
1442,3,MiNiRodZ,4444,2253,249,258,507,49.1%,11m
1442,3,[L4CRA]LaMamaDelron,4444,214,25,26,51,49.0%,12m
1442,3,[UpeV]Radstok,4444,150,15,11,26,57.7%,11m
1445,3,[IMGOSU]Never,4443,1383,150,132,282,53.2%,26m
1445,2,Jade,4443,232,39,16,55,70.9%,40m
1445,3,[LgnTDS]ToZu,4443,104,9,11,20,45.0%,41m
1445,3,Neighbor,4443,32,4,3,7,57.1%,6m
1445,3,Ascendead,4443,16,2,2,4,50.0%,12m
1445,3,Petrox,4443,0,0,1,1,0.0%,5m
1451,2,MeepMeep,4442,163,12,13,25,48.0%,22m
1451,3,Twilight,4442,0,0,6,6,0.0%,3m
1453,3,[Ser]Zatch,4441,0,1,0,1,100.0%,42m
1453,3,[lLiTl]IlIIIlllIIIl,4441,0,0,1,1,0.0%,20m
1455,3,llllllllllll,4440,10,2,2,4,50.0%,26m
1456,3,[K1]Salvador,4439,31,7,10,17,41.2%,34m
1456,3,Zeit,4439,0,1,0,1,100.0%,3m
1456,2,ClutchCat,4439,0,1,6,7,14.3%,31m
1456,3,[SsaYnS]Demiurge,4439,0,0,1,1,0.0%,42m
1460,3,[KiMBR]FeraMansa,4438,385,28,24,52,53.8%,6m
1460,3,BLACK,4438,0,1,1,2,50.0%,17m
1462,2,[xRtG]DrRektinator,4437,2477,196,195,391,50.1%,9m
1462,3,[sc3x]scplayer,4437,988,50,53,103,48.5%,37m
1462,3,TravelSicK,4437,0,1,0,1,100.0%,27m
1462,3,[ScSwrm]tso,4437,6,1,3,4,25.0%,4m
1462,3,[scRPI]tfang,4437,0,0,1,1,0.0%,27m
1467,2,Willy,4436,2218,133,120,253,52.6%,22m
1467,2,[Kaii]Alpha,4436,435,59,62,121,48.8%,31m
1467,3,Virgil,4436,472,24,1,25,96.0%,25m
1467,3,[JOSUN]Zephyr,4436,4,1,3,4,25.0%,25m
1467,1,CranK,4436,0,0,1,1,0.0%,26m
1472,3,ExtraWetFart,4435,976,84,82,166,50.6%,11m
1472,1,IMMVP,4435,48,2,0,2,100.0%,4m
1474,2,undefined,4434,2370,194,177,371,52.3%,22m
1475,3,[QTp2T]Xavier,4433,1538,83,78,161,51.6%,4m
1475,3,[Ris3n]metaphysics,4433,12,2,3,5,40.0%,27m
1475,3,Jun,4433,10,1,1,2,50.0%,12m
1478,3,[EGx]Maverick,4432,1733,90,90,180,50.0%,5m
1478,3,Stone,4432,1631,88,91,179,49.2%,41m
1478,3,vini,4432,617,37,18,55,67.3%,17m
1478,3,llllllllllll,4432,6,2,0,2,100.0%,35m
1478,3,[DGiT]BonkerZ,4432,0,0,1,1,0.0%,12m
1478,3,MarcouxxD,4432,0,0,1,1,0.0%,32m
1484,3,[FFJUST]StarDuck,4431,1701,110,91,201,54.7%,8m
1484,2,ASTIK,4431,261,31,15,46,67.4%,9m
1484,3,[PSlSTC]Daywalker,4431,14,2,2,4,50.0%,23m
1484,3,BestCapybara,4431,0,0,2,2,0.0%,27m
1488,3,Kreamy,4430,62,6,7,13,46.2%,4m
1488,2,[TGCF]FireBatHero,4430,136,3,2,5,60.0%,17m
1490,3,Strykerz,4429,196,6,4,10,60.0%,3m
1491,3,llllllllllll,4428,26,2,8,10,20.0%,41m
1492,3,Genesis,4427,262,26,21,47,55.3%,30m
1492,3,DUKnowKimchi,4427,317,20,9,29,69.0%,3m
1492,3,ONEreeler,4427,0,1,1,2,50.0%,25m
1495,2,llllllllllll,4426,2419,192,182,374,51.3%,20m
1495,3,Speaker,4426,399,21,4,25,84.0%,23m
1495,2,[Denix]Warion,4426,357,19,21,40,47.5%,9m
1495,3,[Xpk]CMenTal,4426,46,7,4,11,63.6%,42m
1495,3,llllllllllll,4426,28,3,5,8,37.5%,12m
1495,3,SpiderPig,4426,0,1,0,1,100.0%,17m
1501,3,XYFANS,4425,1026,78,86,164,47.6%,17m
1501,3,PKHALF,4425,413,23,13,36,63.9%,39m
1501,3,[DarkAG]OGsewerat,4425,196,22,20,42,52.4%,41m
1501,3,[L4WUDU]GAI,4425,0,1,0,1,100.0%,23m
1501,3,jimmy,4425,0,1,3,4,25.0%,4m
1506,3,Castillo,4424,1214,94,79,173,54.3%,25m
1506,3,[TSVB]ava,4424,406,32,30,62,51.6%,20m
1506,3,IIIlllIlIII,4424,156,22,3,25,88.0%,20m
1506,3,Onigami,4424,54,6,7,13,46.2%,42m
1506,3,[GMs]BerserK,4424,0,1,0,1,100.0%,42m
1506,3,Saying,4424,6,1,1,2,50.0%,23m
1506,3,[Ris3n]EterNaL,4424,0,0,4,4,0.0%,4m
1513,2,llllllllllll,4423,222,12,17,29,41.4%,21m
1513,3,WaRzOnE,4423,0,1,1,2,50.0%,6m
1513,1,[RiGO]PrayeR,4423,0,0,1,1,0.0%,2m
1516,2,[FRMAGE]ColWombaT,4422,2371,188,212,400,47.0%,11m
1517,3,Buff,4421,237,62,57,119,52.1%,6m
1517,3,[Xpk]Liriko,4421,36,6,3,9,66.7%,3m
1517,2,IlIlllIIll,4421,0,1,0,1,100.0%,15m
1517,3,ZEROBlast,4421,0,0,2,2,0.0%,27m
1521,2,[UpeV]ZUNZET,4420,1451,93,95,188,49.5%,9m
1521,3,GeTouT,4420,1009,53,26,79,67.1%,21m
1521,3,MMA,4420,76,10,8,18,55.6%,12m
1521,3,[CaptA]CrimsonChaos,4420,8,2,1,3,66.7%,42m
1525,3,[TAsc]MxGLasender,4419,1136,59,63,122,48.4%,3m
1525,3,Oni,4419,201,15,10,25,60.0%,35m
1525,3,[2desu]Koy,4419,219,10,1,11,90.9%,8m
1525,3,[eXoPH]Xenos,4419,0,1,0,1,100.0%,6m
1529,3,[TeamUR]Stifle,4418,492,31,41,72,43.1%,20m
1529,3,revenge,4418,66,10,7,17,58.8%,32m
1529,3,Spectral,4418,0,0,1,1,0.0%,12m
1532,2,iOiAlive,4417,631,53,64,117,45.3%,31m
1532,3,TFO,4417,0,0,1,1,0.0%,23m
1534,3,roachan,4416,0,1,0,1,100.0%,39m
1534,3,[CMU]XiaoXiao,4416,12,1,1,2,50.0%,27m
1534,3,[JUMONG]DUKNOWFAKER,4416,0,0,1,1,0.0%,26m
1537,2,[CBRA]COOLIO,4415,745,61,71,132,46.2%,9m
1537,3,Strolch,4415,367,15,2,17,88.2%,20m
1537,3,YooSiJin,4415,130,13,10,23,56.5%,35m
1537,3,Ajax,4415,0,0,1,1,0.0%,8m
1541,3,SerZ,4414,54,4,8,12,33.3%,42m
1541,3,[eX]ReMy,4414,0,1,0,1,100.0%,12m
1541,2,MorganWallen,4414,0,0,1,1,0.0%,36m
1544,3,EatTheRich,4413,152,20,16,36,55.6%,17m
1545,3,[DhZPro]siraniki,4412,386,28,29,57,49.1%,23m
1546,3,[LEB]TSRQwertY,4411,996,56,48,104,53.8%,26m
1546,3,Retsof,4411,0,1,1,2,50.0%,41m
1548,1,[ZerO]AlexPKeaton,4410,2649,592,688,1280,46.2%,27m
1548,3,Elision,4410,688,52,53,105,49.5%,41m
1548,3,[IMDSI]RAMEN,4410,645,39,36,75,52.0%,37m
1548,3,RedStorm,4410,70,10,9,19,52.6%,35m
1548,3,[ØFoxF2]MeRciLeSs,4410,86,8,12,20,40.0%,37m
1548,3,Golden,4410,46,6,4,10,60.0%,17m
1548,3,[ValidG]NinjaKWick,4410,12,3,0,3,100.0%,5m
1548,3,Bobprime,4410,28,3,3,6,50.0%,30m
1548,3,Lukman,4410,54,3,7,10,30.0%,23m
1548,3,llllllllllll,4410,6,2,2,4,50.0%,4m
1548,3,[MadK]Mavos,4410,0,0,1,1,0.0%,4m
1559,3,[DarkAG]PKV,4409,366,29,27,56,51.8%,11m
1559,3,[TKCT]NecrO,4409,376,25,31,56,44.6%,11m
1559,3,DiVeRsioN,4409,14,3,0,3,100.0%,4m
1559,3,PhagoCytE,4409,0,0,1,1,0.0%,3m
1563,1,[ZeeIot]ZealotMailer,4408,2662,315,334,649,48.5%,3m
1563,3,MVP,4408,739,63,45,108,58.3%,23m
1563,3,DoodyBop,4408,275,42,19,61,68.9%,4m
1563,3,NguyenLopez,4408,534,42,30,72,58.3%,8m
1563,3,BootyClap,4408,18,4,7,11,36.4%,4m
1563,3,RookieTerran,4408,18,3,0,3,100.0%,8m
1563,3,[f0ad]foad,4408,0,1,4,5,20.0%,12m
1570,3,WarBoss,4407,1768,89,66,155,57.4%,39m
1571,3,[TAW]ZeRgBrOkEn,4406,8,2,4,6,33.3%,6m
1571,3,Adja,4406,0,1,0,1,100.0%,25m
1571,3,MechDamon,4406,0,0,1,1,0.0%,6m
1574,2,Primming,4405,1097,99,87,186,53.2%,9m
1574,3,MDT,4405,440,33,17,50,66.0%,4m
1574,3,[CH1LE]Haneul,4405,591,26,13,39,66.7%,21m
1574,1,Xylophone,4405,96,3,0,3,100.0%,27m
1578,2,IIIIIIIIIIII,4404,1347,63,59,122,51.6%,17m
1578,3,Mazrok,4404,80,7,9,16,43.8%,4m
1578,3,Marth,4404,10,1,2,3,33.3%,39m
1581,3,Wigz,4403,1534,126,99,225,56.0%,20m
1581,3,[cl0udM]kenshin,4403,1325,96,73,169,56.8%,26m
1581,2,Thanatos,4403,740,56,53,109,51.4%,21m
1581,3,[TGCrew]Dae,4403,242,22,22,44,50.0%,23m
1581,3,Best,4403,0,3,2,5,60.0%,25m
1581,3,[CTOP]Echo,4403,0,0,1,1,0.0%,25m
1587,3,[TGosuA]LeChatonNoir,4402,476,21,20,41,51.2%,39m
1587,3,LighterSkies,4402,342,16,5,21,76.2%,4m
1587,3,BMpoo,4402,0,0,1,1,0.0%,23m
1587,3,Zeruph,4402,0,0,1,1,0.0%,35m
1587,3,Kim,4402,0,0,1,1,0.0%,4m
1592,3,shakal,4401,34,5,5,10,50.0%,39m
1593,2,[RBTH]Soza,4400,1828,126,126,252,50.0%,21m
1593,2,[NwAs]Gonzalo,4400,2416,114,113,227,50.2%,11m
1593,3,[NwAs]speakdown,4400,773,37,23,60,61.7%,26m
1593,2,[SydTT]IIIIIIIIIIII,4400,252,19,12,31,61.3%,9m
1593,3,[xTQc]Arther,4400,156,16,19,35,45.7%,21m
1593,3,lshksh,4400,0,1,0,1,100.0%,21m
1599,3,[αB]PVequalsNRT,4399,1950,202,195,397,50.9%,35m
1599,3,[VDNKh]ElHenryettas,4399,1437,69,70,139,49.6%,26m
1599,2,[GØSU]Brute,4399,74,5,14,19,26.3%,11m
1599,3,LazyTiTan,4399,0,4,1,5,80.0%,32m
1599,3,Marines,4399,6,2,2,4,50.0%,23m
1599,3,Tatan,4399,0,0,1,1,0.0%,4m
1599,3,[EBT]Snacks,4399,0,0,2,2,0.0%,4m
1606,3,[B33RCr]HateNate,4398,12,3,2,5,60.0%,3m
1606,3,IIIIIIIIIIII,4398,8,1,2,3,33.3%,4m
1608,1,TrashToss,4397,432,19,3,22,86.4%,18m
1608,3,[MufRyd]Cooley,4397,407,16,11,27,59.3%,32m
1608,3,Marine,4397,150,16,15,31,51.6%,30m
1611,3,ReZniK,4396,1189,75,56,131,57.3%,32m
1611,2,[LimaSC]KoriKilinchu,4396,318,56,52,108,51.9%,13m
1611,3,Hels,4396,375,25,14,39,64.1%,17m
1611,3,Math,4396,358,19,12,31,61.3%,26m
1611,3,[DhZPro]COSMOS,4396,112,8,10,18,44.4%,34m
1611,3,rickybobby,4396,18,4,1,5,80.0%,41m
1611,3,[NPhase]Parkson,4396,18,3,11,14,21.4%,17m
1611,3,FrogRay,4396,0,1,0,1,100.0%,35m
1619,3,EmailAddress,4395,385,43,39,82,52.4%,20m
1619,3,[1dC]synapse,4395,50,5,11,16,31.2%,27m
1621,3,[ØFoxF2]Smylodon,4394,1129,62,63,125,49.6%,5m
1621,3,IIIIIIIIIIII,4394,526,34,42,76,44.7%,34m
1621,3,[iMkS]AdreNa,4394,84,11,13,24,45.8%,26m
1621,3,[LimLim]Sound,4394,58,7,10,17,41.2%,5m
1621,3,Terran,4394,42,6,7,13,46.2%,26m
1621,3,Pegasides,4394,60,6,10,16,37.5%,35m
1621,3,[Parkto]JYP,4394,4,1,2,3,33.3%,35m
1628,2,JanoyCresva,4393,2199,242,229,471,51.4%,31m
1628,3,[TSØP]BriKc,4393,604,35,32,67,52.2%,37m
1628,3,[MDPKR]Walujie,4393,531,32,32,64,50.0%,37m
1628,3,XLIMIT,4393,12,3,1,4,75.0%,42m
1632,2,llllllllllll,4392,2440,157,145,302,52.0%,9m
1632,3,WhoDaresWins,4392,316,20,14,34,58.8%,23m
1632,3,ArriSTv,4392,64,10,10,20,50.0%,6m
1632,3,[Xpk]Rawfist,4392,6,2,2,4,50.0%,21m
1632,3,Snake,4392,0,1,0,1,100.0%,30m
1637,3,icecup,4391,513,85,65,150,56.7%,39m
1637,3,Megalodon,4391,803,41,16,57,71.9%,17m
1637,3,dEaf,4391,125,10,3,13,76.9%,12m
1637,3,navymaru,4391,48,6,7,13,46.2%,4m
1637,3,[NalsEz]Timo,4391,0,3,0,3,100.0%,6m
1637,3,[CIoud9]HeroMarine,4391,144,3,2,5,60.0%,25m
1643,3,Bridic,4390,1056,96,87,183,52.5%,23m
1643,3,ProtossOP,4390,500,21,4,25,84.0%,12m
1643,3,FairyLaw,4390,30,4,3,7,57.1%,3m
1643,3,Sparkles,4390,6,2,0,2,100.0%,27m
1643,1,glhf,4390,0,1,3,4,25.0%,4m
1648,3,DJstankdaddy,4389,233,18,16,34,52.9%,11m
1648,3,[iIoveU]Aphroditeve,4389,0,1,0,1,100.0%,5m
1648,3,SimplyOwnage,4389,0,1,2,3,33.3%,4m
1651,2,HoTsHoT,4388,655,105,111,216,48.6%,18m
1651,3,Kachinsky,4388,0,0,1,1,0.0%,12m
1651,3,ohbaby,4388,0,0,1,1,0.0%,23m
1654,3,[FiFo]CrackFurtado,4387,1616,117,131,248,47.2%,37m
1654,3,Kratom,4387,6,4,3,7,57.1%,32m
1654,3,llllllllllll,4387,10,3,1,4,75.0%,41m
1654,3,TuckFrance,4387,12,3,2,5,60.0%,17m
1654,3,[EPIDEV]Mularski,4387,4,1,1,2,50.0%,12m
1659,3,BenchPress,4386,1747,244,220,464,52.6%,8m
1659,2,[αB]LOTB,4386,2417,156,184,340,45.9%,9m
1659,3,[NAsux]Rosie,4386,0,0,1,1,0.0%,37m
1662,3,Zenith,4385,307,19,3,22,86.4%,37m
1662,3,[SM1L3]IlIlIlIlIlIl,4385,287,18,8,26,69.2%,30m
1662,3,[IL1]hellosputnik,4385,0,1,0,1,100.0%,3m
1662,3,Finoss,4385,0,0,2,2,0.0%,4m
1666,3,volimar,4384,151,8,3,11,72.7%,30m
1666,3,llllllllllll,4384,0,0,1,1,0.0%,39m
1668,3,cayaty,4383,2110,282,269,551,51.2%,11m
1668,3,[FMX]Pompeyo,4383,2263,130,124,254,51.2%,4m
1668,2,pooopman,4383,0,4,2,6,66.7%,9m
1668,3,Drawing,4383,26,4,5,9,44.4%,6m
1668,3,Wirt,4383,4,1,3,4,25.0%,30m
1673,3,AhmaudAvery,4382,1240,134,132,266,50.4%,12m
1673,2,Rachmaninoff,4382,810,33,46,79,41.8%,27m
1673,3,NaCl,4382,8,2,3,5,40.0%,5m
1673,3,[Micr0]defiler,4382,0,1,0,1,100.0%,12m
1673,3,RebuildHabit,4382,0,0,1,1,0.0%,8m
1673,3,Hellbatman,4382,0,0,2,2,0.0%,17m
1679,2,llllllllllll,4381,1489,105,107,212,49.5%,34m
1679,3,[lDaTl]ProtossImba,4381,1708,93,74,167,55.7%,25m
1679,3,Erodius,4381,78,7,12,19,36.8%,5m
1679,3,PuMbA,4381,0,1,0,1,100.0%,27m
1683,3,Legacy,4380,4,2,0,2,100.0%,8m
1683,3,[4RUM]DerMeister,4380,0,1,1,2,50.0%,8m
1685,3,AposFanGirl,4379,622,70,35,105,66.7%,30m
1685,3,llllllllllll,4379,172,10,1,11,90.9%,4m
1685,3,Leisen,4379,0,0,2,2,0.0%,26m
1688,3,Kibi,4378,1252,67,61,128,52.3%,6m
1688,3,HeAdShoT,4378,432,23,2,25,92.0%,34m
1688,3,[P00PY]DenerldTremp,4378,0,0,1,1,0.0%,23m
1688,3,Ravenator,4378,0,0,1,1,0.0%,27m
1692,3,AKIDA,4377,973,64,40,104,61.5%,8m
1692,3,Machine,4377,271,18,16,34,52.9%,30m
1692,2,IIIIIIIIIIII,4377,229,7,2,9,77.8%,42m
1695,3,TUXerino,4376,251,10,5,15,66.7%,21m
1695,3,[QTp2T]PicKles,4376,20,4,2,6,66.7%,30m
1695,2,porklegoguy,4376,0,0,1,1,0.0%,4m
1698,2,[Msia]Animal,4375,2342,244,271,515,47.4%,31m
1698,3,Doc,4375,1575,81,88,169,47.9%,5m
1698,3,BECK,4375,672,42,41,83,50.6%,41m
1698,3,Jaceybot,4375,257,11,14,25,44.0%,25m
1698,3,[Flam3s]RedRyder,4375,50,6,11,17,35.3%,17m
1703,3,kevinzitho,4374,2156,120,123,243,49.4%,30m
1703,3,Keen,4374,539,21,12,33,63.6%,17m
1703,3,Pepe,4374,0,0,1,1,0.0%,41m
1703,3,[INextI]Borking,4374,0,0,1,1,0.0%,12m
1703,3,[57717]TRiZ,4374,0,0,7,7,0.0%,4m
1708,3,TryHard,4373,2178,120,104,224,53.6%,6m
1708,3,RedGears,4373,426,43,25,68,63.2%,42m
1708,2,Wowee,4373,223,10,18,28,35.7%,13m
1711,3,BlueSky,4372,296,17,2,19,89.5%,5m
1711,3,ACID,4372,0,1,3,4,25.0%,23m
1713,3,Janook,4371,47,24,26,50,48.0%,41m
1713,3,ImbATerraN,4371,298,13,12,25,52.0%,32m
1713,3,[FANXY]Vex,4371,0,1,1,2,50.0%,42m
1713,3,NWMike,4371,0,1,1,2,50.0%,42m
1717,2,[Msia]zroMICROugot,4370,2278,214,217,431,49.7%,40m
1717,3,blastaman,4370,0,0,1,1,0.0%,11m
1717,3,Spaceman,4370,0,0,1,1,0.0%,4m
1720,2,[TTT]chente,4369,2299,554,506,1060,52.3%,13m
1720,3,SirCoOkie,4369,2209,286,299,585,48.9%,39m
1720,3,[lmbaF]Surprise,4369,0,1,0,1,100.0%,30m
1723,2,Synbio,4368,1593,113,67,180,62.8%,37m
1723,3,[GR33D]ElClapo,4368,20,3,1,4,75.0%,4m
1723,3,[xRtG]MaFia,4368,10,2,2,4,50.0%,22m
1723,3,leeplayer,4368,0,1,0,1,100.0%,12m
1723,3,Schniedel,4368,0,1,0,1,100.0%,6m
1723,3,[Frnzy]SHELTERin,4368,0,0,1,1,0.0%,37m
1729,2,LesTat,4367,2417,674,661,1335,50.5%,21m
1729,2,[C96]LeeMongChuPa,4367,2466,165,172,337,49.0%,20m
1729,3,BigData,4367,846,49,50,99,49.5%,4m
1729,3,IIIIIIIIIIII,4367,0,1,0,1,100.0%,12m
1729,3,[cl0udM]SarsSan,4367,0,1,0,1,100.0%,11m
1729,3,[EvilPe]KaEL,4367,0,0,1,1,0.0%,39m
1735,3,[UpeV]DantrozT,4366,1552,86,88,174,49.4%,6m
1735,3,Ratsahoy,4366,211,6,5,11,54.5%,6m
1735,3,[EZDUNK]EZkiel,4366,40,6,6,12,50.0%,39m
1735,3,[MAAGIC]CMarTZ,4366,0,1,0,1,100.0%,23m
1735,3,SONUS,4366,0,0,1,1,0.0%,26m
1740,3,[IWCP]snackerS,4365,1431,103,58,161,64.0%,6m
1740,3,TheBiGPeaT,4365,196,18,17,35,51.4%,30m
1740,3,JonBonjovi,4365,289,15,2,17,88.2%,4m
1740,1,Rain,4365,192,5,4,9,55.6%,42m
1740,3,Brom,4365,30,2,2,4,50.0%,12m
1740,2,fourHead,4365,46,1,2,3,33.3%,28m
1746,3,GreeneChron,4364,1320,71,76,147,48.3%,12m
1746,3,ChiHiRo,4364,84,6,8,14,42.9%,12m
1746,3,CaptWaffles,4364,32,5,11,16,31.2%,4m
1746,3,GhostMarine,4364,0,0,1,1,0.0%,42m
1750,3,AbLe,4363,0,1,0,1,100.0%,39m
1750,3,[ROTTK]OlorinWolong,4363,0,0,1,1,0.0%,27m
1752,1,Life,4362,143,4,1,5,80.0%,21m
1753,3,Potiguar,4360,1038,74,38,112,66.1%,30m
1753,3,Iris,4360,201,9,7,16,56.2%,4m
1755,1,[BRSKR]Washikie,4359,1805,202,237,439,46.0%,18m
1755,3,[LTK]bakla,4359,1292,122,110,232,52.6%,6m
1755,2,Liitosp,4359,2025,104,92,196,53.1%,14m
1755,3,IIIIIIIIIIII,4359,1020,48,35,83,57.8%,4m
1755,3,Light,4359,498,47,23,70,67.1%,4m
1755,3,[1dC]statiC,4359,4,1,4,5,20.0%,4m
1755,3,Krahnicz,4359,0,0,2,2,0.0%,20m
1762,3,SoralARaison,4358,249,13,10,23,56.5%,12m
1762,1,slam,4358,0,1,0,1,100.0%,29m
1762,1,[SuperZ]Hellfire,4358,0,0,2,2,0.0%,29m
1765,3,llllllllllll,4356,165,13,11,24,54.2%,17m
1765,2,BlackRa,4356,58,4,11,15,26.7%,17m
1765,3,[RUMB]PieForever,4356,0,1,0,1,100.0%,34m
1765,2,IllIIllllIIl,4356,0,1,1,2,50.0%,23m
1769,3,RobinSwaN,4355,1284,157,121,278,56.5%,32m
1769,3,Timo,4355,596,42,45,87,48.3%,20m
1769,3,sociopath,4355,677,28,9,37,75.7%,12m
1769,3,MechItHappen,4355,180,6,3,9,66.7%,4m
1769,3,index,4355,121,2,1,3,66.7%,35m
1769,1,Mother,4355,96,2,5,7,28.6%,15m
1769,3,Zax,4355,4,1,1,2,50.0%,12m
1769,3,[INextI]Jimher,4355,0,0,1,1,0.0%,12m
1777,3,James,4354,253,61,27,88,69.3%,42m
1777,3,IIIIIIIIIIII,4354,554,28,9,37,75.7%,32m
1777,3,[DETER]Masterxexe,4354,0,1,0,1,100.0%,17m
1777,3,THEMECHSSIAH,4354,0,1,0,1,100.0%,25m
1781,3,[5555]Zoundz,4352,1773,424,426,850,49.9%,23m
1781,3,sjShark,4352,1678,126,128,254,49.6%,39m
1781,3,[Cryptc]KRUM,4352,672,38,50,88,43.2%,20m
1781,3,InSaNe,4352,449,27,19,46,58.7%,25m
1781,3,AmuroRay,4352,396,15,8,23,65.2%,6m
1781,3,Destroyer,4352,0,1,5,6,16.7%,4m
1787,1,Malgor,4351,429,19,3,22,86.4%,29m
1787,3,scttooo,4351,0,1,0,1,100.0%,27m
1787,3,FadingAces,4351,0,0,1,1,0.0%,17m
1787,3,IIIIIIIIIIII,4351,0,0,1,1,0.0%,4m
1787,3,llllllllllll,4351,0,0,1,1,0.0%,32m
1792,3,[SuperZ]luissuarez,4350,1614,409,403,812,50.4%,17m
1792,3,Fenix,4350,1694,99,69,168,58.9%,12m
1792,3,BOONGBOONG,4350,610,30,8,38,78.9%,30m
1792,3,[CIoud9]llllllllllll,4350,480,23,11,34,67.6%,32m
1792,3,fluxi,4350,428,22,5,27,81.5%,35m
1792,3,IIIIIIIIIIII,4350,189,9,5,14,64.3%,32m
1792,3,RaylanGivens,4350,181,6,5,11,54.5%,4m
1792,3,dio,4350,12,2,4,6,33.3%,4m
1792,3,OIOQ,4350,0,1,0,1,100.0%,26m
1792,3,llololosea,4350,0,0,2,2,0.0%,6m
1802,3,RepubTja,4349,1508,87,84,171,50.9%,39m
1802,3,[eXoPH]eXoBLaZeR,4349,730,32,31,63,50.8%,32m
1802,3,[PTHero]IAmVivenna,4349,122,13,17,30,43.3%,4m
1802,3,hellviper,4349,140,6,3,9,66.7%,23m
1802,3,Axe,4349,6,1,1,2,50.0%,22m
1802,3,OnionKnight,4349,0,1,2,3,33.3%,23m
1802,2,[UpeV]Lapadula,4349,2,1,7,8,12.5%,14m
1809,3,Cxteam,4348,576,38,25,63,60.3%,3m
1809,3,barcode,4348,386,16,8,24,66.7%,32m
1811,1,Bonesaw,4347,244,12,1,13,92.3%,27m
1811,3,Drake,4347,20,7,7,14,50.0%,23m
1813,3,Chronos,4346,1449,148,138,286,51.7%,8m
1813,3,YeosuBambada,4346,1071,68,55,123,55.3%,25m
1813,3,[DC3]Ghostking,4346,12,2,3,5,40.0%,37m
1813,3,Higgs,4346,0,1,0,1,100.0%,26m
1817,3,[NovaX]BoomTT,4345,277,20,20,40,50.0%,41m
1817,3,Ryung,4345,302,17,1,18,94.4%,22m
1817,3,SelenaGomez,4345,144,14,24,38,36.8%,12m
1817,3,Lazuli,4345,68,10,11,21,47.6%,34m
1817,3,jTgY,4345,0,1,0,1,100.0%,22m
1817,3,[TGosuB]Silverknight,4345,0,0,1,1,0.0%,5m
1823,3,vividvision,4344,1163,89,69,158,56.3%,3m
1823,3,[UpeV]LaniaKea,4344,6,2,4,6,33.3%,12m
1823,3,[FkJeff]Laili,4344,0,1,0,1,100.0%,35m
1823,2,[αX]MaidenSlayer,4344,16,1,6,7,14.3%,14m
1823,3,JKap,4344,0,0,5,5,0.0%,39m
1828,3,ConcepT,4343,828,44,23,67,65.7%,30m
1828,3,Havior,4343,882,43,31,74,58.1%,8m
1828,3,llllllllllll,4343,64,11,11,22,50.0%,8m
1828,3,IlIIlIIlIIIl,4343,193,6,0,6,100.0%,39m
1828,3,NTT,4343,121,3,1,4,75.0%,6m
1828,3,damo,4343,121,2,2,4,50.0%,39m
1834,3,[GTnLB]DooM,4342,1830,230,233,463,49.7%,6m
1834,3,[ValidG]PeeAndKeele,4342,1259,82,76,158,51.9%,32m
1834,3,MacroPhage,4342,359,13,2,15,86.7%,6m
1834,3,[XpKAc]TheEzztrax,4342,6,1,2,3,33.3%,6m
1838,3,[DHZ0ne]LVC,4341,744,85,85,170,50.0%,25m
1838,3,llllllllllll,4341,97,2,0,2,100.0%,18m
1838,3,[CornZ]Primal,4341,0,1,0,1,100.0%,27m
1838,3,callmechamp,4341,0,1,1,2,50.0%,41m
1842,3,[B8B]HueyFreeman,4340,2205,260,263,523,49.7%,11m
1842,3,OltyNation,4340,333,43,20,63,68.3%,17m
1842,1,IIIIIIIIIIII,4340,359,19,4,23,82.6%,26m
1842,3,Montolovich,4340,110,10,14,24,41.7%,26m
1842,3,ONECHANCE,4340,34,5,7,12,41.7%,25m
1842,3,[REPORT]Fetor,4340,0,0,1,1,0.0%,5m
1848,3,Makero,4339,682,39,23,62,62.9%,26m
1848,3,[AnUB]MEGATRON,4339,490,35,37,72,48.6%,12m
1848,2,Rednax,4339,318,17,6,23,73.9%,14m
1848,3,FETWGRKIFG,4339,0,1,2,3,33.3%,4m
1852,3,Teva,4338,466,162,155,317,51.1%,4m
1852,3,Wigz,4338,1210,140,115,255,54.9%,5m
1852,3,[TGCrew]Evelyn,4338,844,53,40,93,57.0%,8m
1852,2,IIIIIIIIIIII,4338,910,45,54,99,45.5%,37m
1852,3,IIIIIIIIIII,4338,250,15,5,20,75.0%,6m
1852,3,Geo,4338,343,11,8,19,57.9%,22m
1858,3,[NwAs]chicho,4337,2186,708,717,1425,49.7%,6m
1858,3,ltDan,4337,521,112,98,210,53.3%,27m
1858,3,[SCX2]xnofub,4337,799,41,11,52,78.8%,17m
1858,3,[SqR]zbawl,4337,474,34,40,74,45.9%,4m
1858,3,Rolli,4337,267,21,19,40,52.5%,4m
1858,3,[xRtG]zzSKY,4337,237,16,11,27,59.3%,4m
1858,3,[G1tgud]Greed,4337,265,9,1,10,90.0%,32m
1858,3,BaRrCoDe,4337,0,1,2,3,33.3%,32m
1866,3,Mager,4336,670,41,42,83,49.4%,42m
1866,3,Protass,4336,496,31,25,56,55.4%,26m
1866,3,IPMAN,4336,535,28,17,45,62.2%,30m
1866,3,DUDUDU,4336,354,15,12,27,55.6%,4m
1866,3,Maru,4336,97,1,1,2,50.0%,8m
1871,3,AcuteColitis,4335,1971,185,197,382,48.4%,6m
1871,3,lllllllIIIIl,4335,1461,97,65,162,59.9%,22m
1871,3,fqwrtewtsdds,4335,814,51,57,108,47.2%,4m
1871,3,SKT,4335,859,43,14,57,75.4%,22m
1871,3,[JOSUN]IIIIIIIIIII,4335,36,5,10,15,33.3%,6m
1871,3,[INextI]Dysix,4335,121,2,1,3,66.7%,27m
1871,3,[BtnBot]tyzor,4335,97,1,1,2,50.0%,11m
1871,3,Belial,4335,0,0,1,1,0.0%,32m
1879,3,[ØFoxF2]SHUTER,4334,2186,601,640,1241,48.4%,8m
1879,3,[theBSL]Horizon,4334,817,319,291,610,52.3%,30m
1879,3,[DarkAG]Dargel,4334,2161,311,289,600,51.8%,26m
1879,3,[DRKRPT]WAFFLES,4334,1511,301,280,581,51.8%,6m
1879,3,[1E100]Magni,4334,896,263,239,502,52.4%,25m
1879,3,Cacty,4334,509,26,6,32,81.2%,18m
1879,3,ozz,4334,0,1,0,1,100.0%,23m
1879,3,Mrdragon,4334,0,0,1,1,0.0%,4m
1887,3,Brookie,4333,751,108,94,202,53.5%,26m
1887,3,Saiph,4333,1145,74,72,146,50.7%,39m
1887,3,BoMcGumption,4333,99,4,2,6,66.7%,6m
1887,3,piggysmalls,4333,96,3,1,4,75.0%,4m
1887,3,[G0G0G0]Kienzays,4333,97,1,1,2,50.0%,4m
1892,3,[1C1C]RipNHammer,4332,1509,214,220,434,49.3%,22m
1892,3,kimnoir,4332,906,145,128,273,53.1%,25m
1892,3,Tewan,4332,510,78,53,131,59.5%,3m
1892,3,lllIIIllllll,4332,1100,47,42,89,52.8%,4m
1892,3,PréWorkout,4332,752,44,45,89,49.4%,23m
1892,3,GoliaThus,4332,171,4,4,8,50.0%,4m
1892,3,MeronG,4332,8,3,4,7,42.9%,12m
1892,3,Sherminator,4332,97,2,0,2,100.0%,3m
1892,3,TKL,4332,4,2,5,7,28.6%,4m
1901,3,DeadSouL,4331,1089,321,332,653,49.2%,4m
1901,3,[DarkAG]PocketRocket,4331,2160,160,160,320,50.0%,30m
1901,3,[Cryptc]Doije,4331,1192,145,139,284,51.1%,3m
1901,3,mattfus,4331,1309,104,98,202,51.5%,41m
1901,3,Natural,4331,738,89,76,165,53.9%,12m
1901,3,[MEEMR]Hagabooga,4331,278,22,31,53,41.5%,11m
1901,2,Xanax,4331,446,20,32,52,38.5%,20m
1901,3,Hybrid,4331,503,19,8,27,70.4%,23m
1901,3,[TMMM]Achilles,4331,169,4,1,5,80.0%,42m
1901,3,llllllllllll,4331,120,3,0,3,100.0%,30m
1901,3,Gambeulin,4331,146,3,2,5,60.0%,5m
1901,3,McLoviN,4331,97,1,1,2,50.0%,42m
1901,3,JhnyFaplseed,4331,0,0,1,1,0.0%,6m
1914,3,[NeAs]Anxiety,4330,2223,377,395,772,48.8%,12m
1914,3,[OvrDsd]nooooobie,4330,1254,193,173,366,52.7%,32m
1914,3,[EZDUNK]NAvation,4330,1088,145,135,280,51.8%,4m
1914,3,ACD,4330,1004,58,36,94,61.7%,8m
1914,3,llllllllllll,4330,624,41,31,72,56.9%,11m
1914,3,[DhZAc1]MrTesla,4330,253,29,19,48,60.4%,42m
1914,3,[RBTH]CALLO,4330,480,17,9,26,65.4%,41m
1914,3,Vegito,4330,306,13,1,14,92.9%,35m
1914,3,[Exfil]Alpharius,4330,267,9,2,11,81.8%,5m
1914,3,[Atira]Akoo,4330,121,2,1,3,66.7%,35m
1914,3,IIIIIIIIIIII,4330,4,2,3,5,40.0%,35m
1914,3,Medic,4330,0,0,1,1,0.0%,12m
1914,3,[SHS]Osmics,4330,0,0,2,2,0.0%,41m
1914,3,King,4330,0,0,3,3,0.0%,3m
1928,2,Sunlight,4329,2251,362,407,769,47.1%,40m
1928,3,[CWKz]Maker,4329,918,233,231,464,50.2%,25m
1928,2,[EZDUNK]chuckdoodle,4329,2294,106,104,210,50.5%,37m
1928,3,karkara,4329,806,38,18,56,67.9%,22m
1928,3,[NwAs]Abdiel,4329,433,24,2,26,92.3%,18m
1928,3,Yui,4329,402,24,34,58,41.4%,32m
1928,3,Sapphire,4329,442,22,19,41,53.7%,41m
1928,3,[XpKAc]CaptainRoss,4329,117,6,5,11,54.5%,41m
1928,3,barberousse,4329,97,1,1,2,50.0%,3m
1928,3,[LREM]MrCastaner,4329,0,1,4,5,20.0%,30m
1928,3,zerg,4329,0,0,1,1,0.0%,6m
1939,3,heckbat,4328,850,57,68,125,45.6%,4m
1939,3,[Sune]KriXuS,4328,832,46,55,101,45.5%,3m
1939,3,ralph,4328,870,45,9,54,83.3%,35m
1939,3,Paranoid,4328,705,36,17,53,67.9%,6m
1939,3,GamIsSecHome,4328,292,20,20,40,50.0%,18m
1939,3,llllIlIlIlIl,4328,18,3,10,13,23.1%,39m
1939,3,FreshMilkTea,4328,121,2,2,4,50.0%,26m
1946,3,[papapa]SmiLence,4327,1007,135,113,248,54.4%,35m
1946,3,[DrThrx]GLAToxin,4327,652,37,16,53,69.8%,23m
1946,3,ReDA,4327,379,15,14,29,51.7%,12m
1946,3,[NOBULY]DISD,4327,323,12,3,15,80.0%,18m
1946,2,[TeChef]Pikminftw,4327,176,9,18,27,33.3%,36m
1946,3,[INCA]Sleepwalker,4327,4,2,2,4,50.0%,5m
1946,3,Kryy,4327,10,2,4,6,33.3%,12m
1946,3,[NC]pczergrocks,4327,0,1,0,1,100.0%,35m
1946,3,[EGx]Falcon,4327,97,1,1,2,50.0%,42m
1946,2,[ValidG]SolarWind,4327,48,1,2,3,33.3%,25m
1956,3,LiquidClem,4326,1080,106,92,198,53.5%,30m
1956,3,Dominick,4326,917,37,30,67,55.2%,18m
1956,3,Incens,4326,64,8,9,17,47.1%,41m
1956,3,Present,4326,184,7,5,12,58.3%,8m
1956,3,KIMCHI,4326,52,6,8,14,42.9%,12m
1956,3,[aivNA]fig,4326,38,5,10,15,33.3%,12m
1956,3,Herrenmensch,4326,0,1,0,1,100.0%,6m
1956,3,KeepoMa,4326,0,0,1,1,0.0%,39m
1956,3,[FunSC]Frank,4326,0,0,1,1,0.0%,42m
1965,3,[QTp2T]qtDassarin,4325,191,64,72,136,47.1%,37m
1965,3,[TGCF]heyyouyesyou,4325,904,37,30,67,55.2%,5m
1965,3,Improving,4325,604,23,12,35,65.7%,32m
1965,1,Pokemon,4325,364,17,3,20,85.0%,16m
1965,3,Sai,4325,356,12,2,14,85.7%,22m
1965,1,JakeTheSnake,4325,246,11,6,17,64.7%,42m
1965,3,Yeon,4325,18,3,5,8,37.5%,12m
1965,3,[SydTT]CNmarineking,4325,0,1,0,1,100.0%,6m
1965,3,[FMX]Maya,4325,2,1,3,4,25.0%,23m
1974,3,Einstein,4324,358,52,33,85,61.2%,41m
1974,3,MechPaladin,4324,467,18,3,21,85.7%,22m
1974,3,Jpat,4324,38,5,6,11,45.5%,18m
1974,3,MicroJackson,4324,121,3,1,4,75.0%,32m
1974,3,Mech,4324,97,2,0,2,100.0%,6m
1974,3,isaac,4324,97,1,1,2,50.0%,22m
1980,3,AverageJoe,4323,436,72,63,135,53.3%,42m
1980,3,[UofC]Pancakes,4323,174,36,50,86,41.9%,37m
1980,3,llllllllllll,4323,405,23,5,28,82.1%,12m
1983,3,IhaveIBS,4322,1036,291,306,597,48.7%,12m
1983,3,Etc,4322,982,86,61,147,58.5%,25m
1983,3,JvckiWai,4322,378,35,26,61,57.4%,35m
1983,3,Haggis,4322,242,15,5,20,75.0%,11m
1987,3,[UpeV]Matt,4321,2217,243,256,499,48.7%,35m
1987,3,[VTech]Shacknu,4321,770,156,130,286,54.5%,26m
1987,3,Notabarcode,4321,390,51,42,93,54.8%,39m
1987,3,BobaBoy,4321,337,14,0,14,100.0%,32m
1987,3,PAOLO,4321,121,3,1,4,75.0%,4m
1987,3,[FriGD]Excelle,4321,6,3,6,9,33.3%,18m
1987,3,[notRa]Chuggo,4321,2,2,2,4,50.0%,37m
1994,3,KORslayer,4320,958,52,12,64,81.2%,35m
1994,3,Yeet,4320,315,51,34,85,60.0%,20m
1994,2,[TOYOTA]CamryPower,4320,313,14,2,16,87.5%,28m
1997,3,[DRKFOX]Apothenes,4319,2181,487,465,952,51.2%,23m
1997,3,[TPGGXD]IziBoy,4319,504,28,24,52,53.8%,27m
1997,3,IIIIIIIIIIII,4319,200,6,5,11,54.5%,27m
1997,3,Inflames,4319,16,3,5,8,37.5%,23m
2001,3,[PSISTM]EndOfLine,4318,2202,272,269,541,50.3%,6m
2001,3,[PiGPan]ljfed,4318,710,47,54,101,46.5%,5m
2001,3,[OIGE]Calixter,4318,262,21,24,45,46.7%,27m
2001,3,Vesper,4318,194,16,16,32,50.0%,4m
2001,3,[Aspho]Tontuen,4318,26,8,8,16,50.0%,5m
2001,3,[NOPVP]pHSPUq,4318,123,7,6,13,53.8%,37m
2001,3,[HMTeam]Lixow,4318,131,5,2,7,71.4%,18m
2001,1,Player,4318,0,1,0,1,100.0%,6m
2001,3,[eX]Darkluke,4318,0,0,2,2,0.0%,37m
2010,1,RogZardo,4316,2266,159,148,307,51.8%,14m
2010,3,SkyWalker,4316,391,15,7,22,68.2%,4m
2012,1,llllllllll,4315,2583,424,439,863,49.1%,8m
2012,3,[ValidG]Rove,4315,96,11,15,26,42.3%,20m
2012,3,Xauri,4315,0,0,4,4,0.0%,12m
2015,3,[Msia]Hunter,4314,673,32,13,45,71.1%,22m
2015,1,TossEzRace,4314,1102,30,19,49,61.2%,42m
2015,1,DeusXmachinA,4314,525,11,2,13,84.6%,24m
2015,2,Sorry,4314,94,3,6,9,33.3%,18m
2015,1,SeoulSTALE,4314,0,0,1,1,0.0%,24m
2020,3,[SsaYnS]Clairvoyance,4313,2062,219,211,430,50.9%,6m
2020,3,[GosuCw]FanTaSy,4313,213,12,6,18,66.7%,30m
2020,3,Moderate,4313,0,3,3,6,50.0%,22m
2020,3,VioLenT,4313,14,3,4,7,42.9%,4m
2024,2,[GnR]RetrO,4312,441,89,93,182,48.9%,22m
2024,3,BikturBBYAGA,4312,112,11,16,27,40.7%,6m
2024,1,IIllllllllll,4312,0,0,1,1,0.0%,12m
2027,3,IIIIIIIIIIII,4311,510,43,31,74,58.1%,18m
2027,1,IIllllllllII,4311,499,23,8,31,74.2%,33m
2027,1,[OSCE]Vivid,4311,0,1,0,1,100.0%,19m
2030,3,llllllllllll,4310,842,38,21,59,64.4%,4m
2030,3,LoveGauGau,4310,208,18,33,51,35.3%,20m
2030,1,[GBBxxx]StorkMan,4310,0,0,1,1,0.0%,18m
2030,1,PuroMacho,4310,0,0,1,1,0.0%,29m
2034,1,Spezi,4309,461,21,2,23,91.3%,3m
2034,3,slide,4309,97,1,2,3,33.3%,20m
2036,3,nayuta,4308,498,30,42,72,41.7%,39m
2036,1,Liverpool,4308,286,7,2,9,77.8%,6m
2038,2,[wd1GC]wolfDiaz,4307,1255,94,117,211,44.5%,27m
2038,3,TheHelldude,4307,645,42,45,87,48.3%,26m
2038,1,[vthree]dropsvthree,4307,0,0,1,1,0.0%,26m
2041,3,[UTexas]HellbatKinG,4306,1345,327,331,658,49.7%,32m
2041,3,[MFSC2]MightyKiwi,4306,163,10,12,22,45.5%,23m
2041,3,[DNKCFT]iveseensmolr,4306,154,4,6,10,40.0%,23m
2041,1,AlphaSeven,4306,0,1,0,1,100.0%,5m
2045,3,[gaPe]MilkMan,4305,744,47,43,90,52.2%,12m
2045,1,Egal,4305,445,11,6,17,64.7%,30m
2045,3,[Elphnt]JAMIE,4305,8,3,4,7,42.9%,4m
2045,1,Deklan,4305,0,1,0,1,100.0%,29m
2049,3,[xRtG]TheGiantNome,4304,121,2,2,4,50.0%,3m
2049,3,[UrBoo]ElbowMittens,4304,97,1,2,3,33.3%,4m
2051,3,[BBN]Guldas,4303,1380,177,138,315,56.2%,6m
2051,3,IIIIIIIIIIII,4303,466,31,9,40,77.5%,4m
2051,1,OMEGALUL,4303,144,3,2,5,60.0%,3m
2051,3,[αX]hiohu,4303,0,0,4,4,0.0%,18m
2055,3,[DhZCom]perhark,4302,244,7,6,13,53.8%,12m
2055,3,Biondo,4302,0,0,3,3,0.0%,12m
2057,2,IIIIIIIIIIII,4301,2174,172,147,319,53.9%,20m
2057,1,SlayersMarch,4301,48,2,1,3,66.7%,12m
2057,3,IIIIIIIIIIII,4301,97,1,3,4,25.0%,4m
2060,3,[INextI]RoTtiN,4300,1593,78,83,161,48.4%,23m
2060,3,[UpeV]PicudoCDMX,4300,923,55,68,123,44.7%,5m
2060,3,Forscience,4300,932,47,43,90,52.2%,25m
2060,3,llllllllllll,4300,42,14,15,29,48.3%,5m
2060,1,Anytime,4300,0,0,1,1,0.0%,36m
2065,3,probex,4299,2194,354,322,676,52.4%,3m
2065,3,Atlas,4299,1673,283,274,557,50.8%,11m
2067,3,XellOs,4298,1040,43,31,74,58.1%,25m
2067,3,[BcnSqd]Drayke,4298,168,27,33,60,45.0%,12m
2067,1,KnockKnock,4298,0,0,2,2,0.0%,40m
2070,3,droid,4297,1154,62,40,102,60.8%,4m
2070,3,Nox,4297,574,44,42,86,51.2%,20m
2070,3,llllllllllll,4297,236,13,7,20,65.0%,18m
2070,3,Autumn,4297,34,5,11,16,31.2%,20m
2070,3,LastSupper,4297,28,3,13,16,18.8%,30m
2075,3,Goobey,4296,1500,100,96,196,51.0%,4m
2075,3,[Groovy]Reanimated,4296,1531,78,73,151,51.7%,27m
2075,3,[KSGT]Viole,4296,752,44,26,70,62.9%,30m
2075,3,[oJKo]IShatMyself,4296,488,28,21,49,57.1%,22m
2075,3,[4evr]NAchobo,4296,434,27,29,56,48.2%,30m
2075,1,[NwAs]Awaken,4296,0,0,1,1,0.0%,13m
2081,3,Makaveli,4295,807,59,67,126,46.8%,12m
2081,3,MasterKenobi,4295,810,49,46,95,51.6%,22m
2081,3,ForbZ,4295,654,44,52,96,45.8%,4m
2081,3,[SUFI]IDivineAllah,4295,516,20,15,35,57.1%,23m
2081,3,IlllIlIlIIIl,4295,66,12,19,31,38.7%,41m
2081,3,MrKrabs,4295,159,11,12,23,47.8%,35m
2087,3,[oGu]Max,4294,1953,261,261,522,50.0%,37m
2087,2,OonoAkira,4294,1253,58,82,140,41.4%,22m
2087,3,ShiaLaBeouf,4294,395,22,6,28,78.6%,18m
2087,3,SaYBoT,4294,22,3,6,9,33.3%,12m
2087,1,llllllllllll,4294,42,2,0,2,100.0%,18m
2092,3,[iMkS]theMike,4293,2044,304,333,637,47.7%,11m
2092,3,[Khaoz]Catscratch,4293,676,71,53,124,57.3%,3m
2092,1,NXC,4293,0,0,2,2,0.0%,27m
2095,1,AsterDrawing,4292,322,17,3,20,85.0%,23m
2095,1,stOic,4292,190,4,4,8,50.0%,16m
2095,1,SacredCoco,4292,0,0,1,1,0.0%,33m
2095,1,lllIIIlI,4292,0,0,1,1,0.0%,12m
2095,2,[JOSUN]paradox,4292,0,0,2,2,0.0%,18m
2095,3,Fury,4292,0,0,3,3,0.0%,26m
2101,1,IIIIIIIIIIII,4291,96,3,2,5,60.0%,7m
2102,1,[ValidG]Wrips,4290,2186,145,132,277,52.3%,3m
2102,3,Smett,4290,172,20,22,42,47.6%,23m
2102,1,QYQY,4290,0,0,1,1,0.0%,25m
2105,3,Dishoom,4289,636,29,17,46,63.0%,6m
2105,3,blurr,4289,4,2,6,8,25.0%,20m
2105,1,[ROOT]Mackintac,4289,48,1,1,2,50.0%,8m
2108,1,[HankH]DangitBobby,4288,2289,221,226,447,49.4%,35m
2108,1,SunDestroyer,4288,955,30,10,40,75.0%,24m
2108,3,[HPC]JimmyRustles,4288,192,19,19,38,50.0%,12m
2108,1,[Janna]medivacs,4288,798,18,8,26,69.2%,12m
2108,2,[lLiTl]Houzi,4288,44,2,5,7,28.6%,30m
2108,1,ByeonGgEo,4288,0,0,5,5,0.0%,33m
2114,3,CorsairThor,4287,2202,754,814,1568,48.1%,26m
2114,1,[G0G0G0]Magnum,4287,1696,44,52,96,45.8%,19m
2114,3,LeGeNd,4287,118,14,17,31,45.2%,23m
2114,1,dave,4287,0,0,1,1,0.0%,3m
2118,1,PooFeet,4286,2130,203,193,396,51.3%,33m
2119,3,UWouldLose,4285,2129,377,379,756,49.9%,12m
2119,2,Simple,4285,2355,235,248,483,48.7%,22m
2119,3,Zerocool,4285,172,20,23,43,46.5%,42m
2119,1,Bucket,4285,144,3,1,4,75.0%,43m
2123,3,BigBear,4284,972,47,48,95,49.5%,26m
2123,3,Shask,4284,174,22,27,49,44.9%,37m
2123,1,IIIlIIlIIlll,4284,504,11,5,16,68.8%,30m
2123,1,Ark,4284,0,1,0,1,100.0%,34m
2123,1,Dnine,4284,0,1,1,2,50.0%,26m
2123,1,[HBOOST]sparkling,4284,0,0,2,2,0.0%,11m
2129,3,Sorde,4283,2171,352,329,681,51.7%,6m
2129,1,EwwNAServer,4283,1008,28,17,45,62.2%,16m
2129,1,[SCxPH]Reppageki,4283,0,1,0,1,100.0%,16m
2132,3,Loki,4281,588,112,112,224,50.0%,35m
2132,3,Dyce,4281,836,47,28,75,62.7%,22m
2132,1,llllllllllll,4281,1037,38,9,47,80.9%,29m
2132,1,[ØFoxF2]henryguty,4281,1365,38,36,74,51.4%,31m
2132,1,Silence,4281,451,20,5,25,80.0%,36m
2132,3,[ImaDog]Esroh,4281,334,20,18,38,52.6%,4m
2138,1,ProtossOp,4280,1101,28,17,45,62.2%,7m
2138,1,Vox,4280,792,18,10,28,64.3%,13m
2138,3,SulHwa,4280,184,9,9,18,50.0%,8m
2138,1,[s7z]CoRviX,4280,96,3,2,5,60.0%,7m
2142,3,[DETER]Dacechio,4279,1996,167,173,340,49.1%,12m
2142,1,uenoeki,4279,2064,60,52,112,53.6%,26m
2142,3,KEY,4279,313,10,8,18,55.6%,4m
2142,1,Goliath,4279,0,0,1,1,0.0%,20m
2142,1,tap,4279,0,0,1,1,0.0%,26m
2147,3,Xeus,4278,270,9,6,15,60.0%,4m
2148,2,[ZTemp]pincher,4277,1196,57,77,134,42.5%,14m
2148,3,SohN,4277,28,4,6,10,40.0%,27m
2148,2,IIIIIIIIIIII,4277,0,0,1,1,0.0%,11m
2148,3,Ykrang,4277,0,0,6,6,0.0%,4m
2152,1,Geoff,4274,1375,197,221,418,47.1%,15m
2152,3,[UoM]Duckling,4274,618,30,25,55,54.5%,3m
2152,3,HoneySC,4274,104,13,14,27,48.1%,35m
2152,1,Mime,4274,0,0,1,1,0.0%,27m
2156,3,LLiiiLLLiiLL,4273,258,26,12,38,68.4%,42m
2157,1,TossGoBRRRRR,4272,0,0,1,1,0.0%,27m
2158,3,[KaGaN]lwlwllwl,4271,2119,401,392,793,50.6%,26m
2158,1,[gohchu]yubang,4271,670,18,13,31,58.1%,6m
2158,1,XsLel,4271,105,3,3,6,50.0%,13m
2161,3,yann,4269,266,159,177,336,47.3%,41m
2161,3,[LimaSC]Yuyu,4269,537,41,19,60,68.3%,27m
2163,1,Name,4268,1462,270,271,541,49.9%,13m
2163,3,yaoyao,4268,1519,102,104,206,49.5%,35m
2163,1,Derek,4268,676,15,5,20,75.0%,26m
2163,1,Nimra,4268,238,5,18,23,21.7%,28m
2167,1,ORGRIM,4267,2265,343,345,688,49.9%,36m
2168,2,[EZDUNK]Drift,4266,2335,560,581,1141,49.1%,18m
2168,1,IIIIIIIIIIII,4266,910,23,22,45,51.1%,33m
2168,3,tossisop,4266,301,15,19,34,44.1%,30m
2168,3,[PCAKE]Anewb,4266,14,3,11,14,21.4%,23m
2168,3,flawlessZ,4266,0,0,7,7,0.0%,37m
2173,3,[TSØP]jomare,4265,1804,92,91,183,50.3%,8m
2173,3,[UCI]NaoKyan,4265,614,46,52,98,46.9%,11m
2173,3,[TGosuB]kirby,4265,508,32,46,78,41.0%,23m
2173,2,JCGamerPrime,4265,226,7,9,16,43.8%,33m
2173,2,[Suan]llllllllllll,4265,0,3,5,8,37.5%,15m
2173,3,[DROWN]lethe,4265,22,2,5,7,28.6%,6m
2173,1,lllGGGXIII,4265,0,1,0,1,100.0%,24m
2180,3,InDove,4263,27,7,10,17,41.2%,11m
2181,3,Blank,4262,22,6,9,15,40.0%,6m
2181,1,LiFeisGOOD,4262,96,2,2,4,50.0%,26m
2183,3,[LgnTDS]Yeti,4261,2145,147,156,303,48.5%,5m
2183,1,Magikagus,4261,142,4,2,6,66.7%,43m
2185,1,RONE,4260,566,13,12,25,52.0%,25m
2185,3,[HRBNGR]SeOuLStEaL,4260,6,2,12,14,14.3%,12m
2187,1,theNuclide,4259,1187,34,13,47,72.3%,24m
2187,1,[TGCrew]LittleMac,4259,1358,33,22,55,60.0%,18m
2187,3,[Scoop]FunkyMonke,4259,58,12,18,30,40.0%,5m
2187,2,Kadabeu,4259,170,4,4,8,50.0%,9m
2191,3,BigCec,4258,2142,426,435,861,49.5%,6m
2191,3,[eXoPH]iMBurNaL,4258,1359,228,208,436,52.3%,23m
2191,3,llllllllllll,4258,219,17,17,34,50.0%,37m
2191,2,SayL,4258,305,9,2,11,81.8%,21m
2195,3,seks,4257,1570,88,56,144,61.1%,18m
2195,3,[UpeV]STARBOY,4257,1036,55,51,106,51.9%,4m
2195,3,Faker,4257,892,52,32,84,61.9%,22m
2198,3,[Kappa]MuffinPuff,4256,470,34,43,77,44.2%,35m
2198,1,[ValidG]Orion,4256,0,0,1,1,0.0%,20m
2200,1,hide,4255,144,4,5,9,44.4%,13m
2200,1,owen,4255,96,2,4,6,33.3%,4m
2200,1,AbNTT,4255,48,1,1,2,50.0%,35m
2203,3,AAAAAAAAAAAA,4254,386,18,6,24,75.0%,22m
2203,1,[FG]EGG,4254,144,4,7,11,36.4%,29m
2203,1,ShowKhan,4254,144,3,5,8,37.5%,3m
2203,1,[Msia]Tze,4254,48,2,0,2,100.0%,28m
2207,1,amychant,4253,2077,154,101,255,60.4%,38m
2207,1,lllIlIlIIllI,4253,0,1,1,2,50.0%,28m
2209,1,IIIIIIIIIIII,4252,0,0,1,1,0.0%,5m
2210,2,[FvR]Flamyblade,4251,1681,152,178,330,46.1%,22m
2210,3,[ClanZN]EXTERMINADOR,4251,488,34,49,83,41.0%,11m
2210,1,Bolt,4251,0,0,1,1,0.0%,5m
2210,1,BurritoRiTo,4251,0,0,4,4,0.0%,5m
2214,1,XYFans,4250,1128,34,18,52,65.4%,34m
2214,1,Barcodelllll,4250,545,13,3,16,81.2%,27m
2214,3,[TGosuB]eliteslayer,4250,76,11,19,30,36.7%,8m
2214,1,lllllllllll,4250,314,9,4,13,69.2%,7m
2214,3,[FoTG]Monkey,4250,16,3,10,13,23.1%,30m
2214,3,RAWD,4250,10,2,8,10,20.0%,5m
2214,1,BoomUrDed,4250,0,1,0,1,100.0%,12m
2221,2,[Dadash]Jaedolph,4249,2279,155,164,319,48.6%,20m
2221,3,[xRtG]Armleg,4249,1970,96,100,196,49.0%,37m
2221,1,[NwAs]DestroyerTT,4249,0,0,3,3,0.0%,29m
2224,1,RangeR,4248,1968,111,110,221,50.2%,2m
2224,1,DizzyFlores,4248,1519,45,34,79,57.0%,26m
2226,1,xmasunicorn,4246,576,15,4,19,78.9%,16m
2226,1,[EPSTIN]DINTKILHMSF,4246,48,2,0,2,100.0%,12m
2228,1,llllllllllll,4245,362,8,9,17,47.1%,13m
2228,1,[Wiggin]GreatArchon,4245,130,3,1,4,75.0%,40m
2228,1,Ahri,4245,48,1,3,4,25.0%,24m
2228,2,[ZTemp]Mariuslol,4245,0,0,5,5,0.0%,4m
2232,1,JYSG,4244,1379,47,20,67,70.1%,33m
2232,1,ElmerFudd,4244,976,25,13,38,65.8%,32m
2232,1,[GOPERÚ]LILBRAIN,4244,476,10,15,25,40.0%,12m
2232,1,[InSghT]JDFrosty,4244,0,2,3,5,40.0%,12m
2236,3,[VetZCo]daboss,4243,562,36,51,87,41.4%,4m
2236,1,IIIIIIIIIIII,4243,330,8,14,22,36.4%,16m
2236,1,Phantom,4243,0,0,1,1,0.0%,28m
2239,1,IllIllIllIll,4242,1472,41,27,68,60.3%,21m
2239,1,[MnM]Trump,4242,144,4,3,7,57.1%,29m
2239,3,nonoseplace,4242,8,3,8,11,27.3%,4m
2242,1,[BoRnGo]Steffan,4241,1085,34,29,63,54.0%,19m
2242,3,[ScSwrm]JadedShard,4241,557,24,27,51,47.1%,23m
2242,1,lllll,4241,0,1,0,1,100.0%,29m
2245,3,PeaKnuckles,4240,466,26,32,58,44.8%,12m
2245,1,JSweatshirt,4240,692,16,9,25,64.0%,28m
2247,3,nikwelik,4239,1402,119,110,229,52.0%,3m
2247,3,[SsaYnS]Caloreen,4239,1081,102,86,188,54.3%,30m
2247,1,Kappablanca,4239,855,51,32,83,61.4%,13m
2247,1,ImicroUdont,4239,169,5,6,11,45.5%,7m
2247,1,[Inflow]PlzSendFunds,4239,0,2,3,5,40.0%,21m
2252,2,Virus,4238,1627,293,305,598,49.0%,22m
2252,1,abcdefg,4238,336,7,10,17,41.2%,12m
2252,3,[NAFish]seworstdes,4238,0,1,3,4,25.0%,39m
2255,3,[IL1]nStrage,4237,1295,205,222,427,48.0%,11m
2255,3,[xLgNx]Holden,4237,513,33,35,68,48.5%,39m
2255,1,[SKT]recon,4237,0,0,1,1,0.0%,16m
2258,1,[H264]iNOOB,4236,240,6,5,11,54.5%,29m
2259,2,[cl0udM]Nagaeiku,4235,1922,86,103,189,45.5%,22m
2259,1,Yiazmat,4235,1362,46,30,76,60.5%,27m
2259,1,[TGCrew]LittleMac,4235,586,13,9,22,59.1%,28m
2259,2,[Ris3n]Heisenzerg,4235,0,0,1,1,0.0%,41m
2263,3,[BajaB]Ward,4234,516,40,48,88,45.5%,39m
2263,1,Vardek,4234,858,20,16,36,55.6%,39m
2263,1,[DkOuT]Anytime,4234,0,0,1,1,0.0%,21m
2263,1,Malazan,4234,0,0,1,1,0.0%,24m
2267,3,llllllllllll,4233,120,15,23,38,39.5%,27m
2267,1,CHOMP,4233,186,8,0,8,100.0%,24m
2269,3,[UrMove]MangoSpice,4232,1367,206,185,391,52.7%,7m
2269,1,Bango,4232,478,10,8,18,55.6%,19m
2269,1,[Astute]CHARIZARD,4232,0,0,2,2,0.0%,19m
2272,1,GreenTeaLeaf,4230,2246,165,173,338,48.8%,32m
2272,3,[juggr]Arcanewinds,4230,960,55,65,120,45.8%,7m
2272,1,zenus,4230,1085,50,21,71,70.4%,16m
2272,1,huh,4230,1245,47,29,76,61.8%,31m
2272,3,[ZTempz]Zara,4230,555,46,35,81,56.8%,12m
2272,1,INnoVatioN,4230,778,17,13,30,56.7%,26m
2272,1,[iMkS]Dengx,4230,654,15,11,26,57.7%,13m
2272,1,PigRabbit,4230,0,0,1,1,0.0%,36m
2280,3,[GdAT]xyxer,4229,1739,208,207,415,50.1%,32m
2280,1,Hyperion,4229,736,16,12,28,57.1%,19m
2282,1,[outCo]imbaKent,4228,978,34,24,58,58.6%,26m
2282,3,Vengeance,4228,492,26,31,57,45.6%,27m
2282,1,[DhZPro]pdrtrembala,4228,702,22,9,31,71.0%,21m
2282,3,[FkJeff]IIIIIIIIIIII,4228,210,10,10,20,50.0%,4m
2282,2,TheJoeRogan,4228,92,3,6,9,33.3%,18m
2282,1,[NovaX]BurSt,4228,48,2,2,4,50.0%,35m
2282,1,[xNtG]Tasty,4228,0,1,2,3,33.3%,12m
2282,1,Vari,4228,0,0,2,2,0.0%,27m
2290,2,[αXLa]HASSEBOSSE,4227,1165,61,69,130,46.9%,34m
2290,1,[DikBoy]Blodge,4227,1519,59,44,103,57.3%,3m
2290,1,[grape1]lIIIllIIllIl,4227,96,3,0,3,100.0%,36m
2290,1,[LGNxx]ScubaSteve,4227,48,1,3,4,25.0%,28m
2290,1,DeadCops,4227,0,0,1,1,0.0%,35m
2295,2,YoloMGB,4226,175,9,1,10,90.0%,11m
2295,1,ReMaIN,4226,330,7,6,13,53.8%,33m
2297,3,[HMTeam]saVio,4225,2059,230,265,495,46.5%,37m
2297,3,Kaelthalas,4225,0,9,12,21,42.9%,6m
2297,1,[HAV0C]unLimiTed,4225,144,3,3,6,50.0%,6m
2297,2,LizrdChuckle,4225,0,1,0,1,100.0%,15m
2297,1,FourCuteCats,4225,0,0,1,1,0.0%,29m
2302,1,Triste,4224,1510,38,32,70,54.3%,36m
2302,1,Sam,4224,1074,37,34,71,52.1%,33m
2302,3,Taimyr,4224,237,14,16,30,46.7%,32m
2302,1,UmøjáOfiocko,4224,48,1,6,7,14.3%,13m
2302,1,[dLife]NewMetaNoob,4224,0,0,1,1,0.0%,12m
2307,1,TypeSeven,4223,2120,116,124,240,48.3%,2m
2307,1,unIQue,4223,955,29,16,45,64.4%,5m
2309,3,Holy,4222,504,40,46,86,46.5%,4m
2309,3,[GRNSKN]Uninspire,4222,190,25,23,48,52.1%,37m
2309,1,[nspeak]ImbATerraN,4222,532,19,2,21,90.5%,20m
2312,3,afoulpigeon,4221,1463,186,192,378,49.2%,32m
2312,1,[Random]Paradise,4221,522,17,1,18,94.4%,33m
2312,3,Archile,4221,14,4,12,16,25.0%,35m
2312,1,MaD,4221,0,1,0,1,100.0%,25m
2312,1,llllllllllll,4221,0,0,1,1,0.0%,24m
2312,2,repoV,4221,0,0,1,1,0.0%,11m
2318,3,UnikChezze,4220,923,263,225,488,53.9%,12m
2318,1,Hikari,4220,0,1,0,1,100.0%,16m
2318,1,wake,4220,0,0,1,1,0.0%,30m
2321,3,[DBAA]iCoke,4219,121,2,6,8,25.0%,35m
2322,3,[FxB]Yona,4218,605,41,48,89,46.1%,23m
2323,3,RebelCincy,4217,1296,281,300,581,48.4%,20m
2323,3,[SsaYnS]LilPetit,4217,2091,257,260,517,49.7%,35m
2323,2,weston,4217,942,46,60,106,43.4%,27m
2323,1,funcool,4217,1666,42,38,80,52.5%,29m
2323,1,Wigglywaffle,4217,0,0,2,2,0.0%,27m
2328,2,IIIIIIIIIIII,4216,2045,153,170,323,47.4%,22m
2328,1,llllllllllll,4216,1318,32,33,65,49.2%,12m
2328,1,[SftVgn]ropponkim,4216,698,16,16,32,50.0%,36m
2328,1,kimo,4216,48,3,4,7,42.9%,4m
2332,2,Fender,4215,2312,184,207,391,47.1%,31m
2332,3,ImportMesh,4215,1778,134,150,284,47.2%,35m
2332,2,llllllllllll,4215,168,5,5,10,50.0%,19m
2335,3,RockEr,4214,137,10,14,24,41.7%,40m
2335,1,IlIIIlllIIll,4214,328,8,3,11,72.7%,8m
2337,3,[fagz]HybridGnome,4213,616,82,92,174,47.1%,7m
2337,1,Nate,4213,192,5,4,9,55.6%,26m
2337,1,Nobody,4213,238,5,9,14,35.7%,26m
2340,3,Shmantalope,4212,782,85,54,139,61.2%,26m
2340,1,sephistoeu,4212,1077,67,60,127,52.8%,29m
2340,1,[iMkS]KaLiD,4212,144,4,5,9,44.4%,12m
2340,1,SgtRatlaGOD,4212,48,2,0,2,100.0%,26m
2344,1,[EtrOy]MrJI,4211,1364,33,32,65,50.8%,3m
2344,3,[aivNA]Devichi,4211,140,20,30,50,40.0%,18m
2344,1,inferiior,4211,96,2,6,8,25.0%,29m
2344,1,Zero,4211,48,1,5,6,16.7%,35m
2348,1,CountDunkula,4210,240,7,4,11,63.6%,29m
2348,1,[TCone]Tygo,4210,192,4,5,9,44.4%,4m
2348,1,robotter,4210,0,1,0,1,100.0%,32m
2348,1,[G0G0G0]XingLing,4210,0,1,0,1,100.0%,27m
2352,3,Ales,4209,151,43,49,92,46.7%,41m
2352,1,MacNCheese,4209,1278,30,32,62,48.4%,25m
2352,1,[GUILKY]LoveLive,4209,144,4,4,8,50.0%,42m
2352,1,ImApOtato,4209,0,0,3,3,0.0%,27m
2356,1,Aruiz,4208,1844,101,90,191,52.9%,31m
2356,2,Gosuhenke,4208,0,0,1,1,0.0%,33m
2358,1,Charlotte,4207,822,18,13,31,58.1%,6m
2358,3,[SCTP]llllllllllll,4207,283,18,24,42,42.9%,11m
2358,1,AzurLane,4207,518,11,5,16,68.8%,42m
2358,1,kobracai,4207,0,1,0,1,100.0%,29m
2358,1,[FFJUST]Pookie,4207,48,1,4,5,20.0%,42m
2363,1,[NPhase]MrBrownstone,4206,2179,138,139,277,49.8%,6m
2363,3,sirPlayALot,4206,1960,125,136,261,47.9%,11m
2363,3,BrutalBenjy,4206,97,5,3,8,62.5%,4m
2363,1,[NwAs]SmokPiers,4206,0,0,1,1,0.0%,35m
2367,1,IIIIIIlllIII,4205,2220,127,130,257,49.4%,26m
2367,1,hamalaw,4205,96,3,5,8,37.5%,16m
2369,1,Terminus,4204,984,40,60,100,40.0%,26m
2369,1,RedAlert,4204,598,23,7,30,76.7%,20m
2369,3,[YUNHAO]Flume,4204,102,9,17,26,34.6%,12m
2369,1,[G0G0G0]GOGOGO,4204,48,1,1,2,50.0%,8m
2373,3,llllllllllll,4203,833,154,137,291,52.9%,27m
2373,1,[J2R]Crovy,4203,1167,40,31,71,56.3%,36m
2373,1,[Th3Bad]TarcísioXD,4203,1420,37,28,65,56.9%,12m
2373,1,Seki,4203,314,11,4,15,73.3%,16m
2373,1,TuPrinceSa,4203,142,4,1,5,80.0%,26m
2378,1,[cl0udM]Divi,4202,2231,147,140,287,51.2%,35m
2378,3,llllllllllll,4202,850,51,52,103,49.5%,5m
2380,3,JVARQ,4201,421,17,13,30,56.7%,30m
2380,3,AntifaDemon,4201,20,8,12,20,40.0%,23m
2380,1,Makoto,4201,96,2,4,6,33.3%,26m
2380,1,ForrestGump,4201,48,1,4,5,20.0%,36m
2384,1,Ghostie,4200,748,17,15,32,53.1%,40m
2384,1,[Call]Waffelz,4200,349,9,9,18,50.0%,34m
2386,3,HeReTic,4199,1604,84,89,173,48.6%,3m
2386,1,kaykoose,4199,1706,63,56,119,52.9%,40m
2386,1,ILoveAnime,4199,651,28,7,35,80.0%,27m
2386,1,Mzimzim,4199,861,21,20,41,51.2%,4m
2386,1,[G0G0G0]BangoBonito,4199,696,16,10,26,61.5%,24m
2391,3,Cristos,4198,2126,314,312,626,50.2%,4m
2391,3,Hozem,4198,1640,104,97,201,51.7%,8m
2391,1,flipp,4198,902,60,56,116,51.7%,12m
2391,1,[BxLxM]MarkHenry,4198,0,2,3,5,40.0%,42m
2391,1,[realUW]DVD,4198,0,0,6,6,0.0%,3m
2396,1,NukeDukem,4197,860,19,11,30,63.3%,42m
2397,1,[Yuhang]haha,4196,1468,49,38,87,56.3%,12m
2397,1,IceWorker,4196,890,21,24,45,46.7%,32m
2399,3,[xRtG]theseparator,4195,695,41,54,95,43.2%,5m
2399,1,SykO,4195,0,1,0,1,100.0%,13m
2399,1,ThiccGothGF,4195,0,0,1,1,0.0%,24m
2402,1,[Ghorth]Gheorghe,4194,1410,39,30,69,56.5%,32m
2402,1,[AlIin]frugs,4194,233,7,10,17,41.2%,12m
2402,1,[Cryptc]SaYu,4194,48,2,3,5,40.0%,40m
2402,2,frankie,4194,0,1,0,1,100.0%,34m
2402,1,NoScared,4194,0,0,1,1,0.0%,29m
2402,1,BabySharkDDD,4194,0,0,1,1,0.0%,17m
2408,3,StarPlatinum,4193,738,98,83,181,54.1%,40m
2408,1,StevieWunder,4193,847,21,14,35,60.0%,28m
2408,1,Vin,4193,376,9,5,14,64.3%,26m
2408,2,TCaldwell,4193,44,2,4,6,33.3%,42m
2408,1,AlexZugas,4193,0,1,0,1,100.0%,43m
2413,1,[JTDPRK]kimilsong,4192,2068,185,194,379,48.8%,8m
2413,1,Lazyglue,4192,0,0,2,2,0.0%,20m
2415,1,[UpeV]elwither,4191,2239,173,188,361,47.9%,36m
2415,1,[BRSKR]Rainier,4191,1448,34,39,73,46.6%,14m
2415,1,Brom,4191,95,1,3,4,25.0%,7m
2418,1,SelenitaM,4190,558,13,13,26,50.0%,6m
2418,2,Lokk,4190,126,8,1,9,88.9%,21m
2420,1,Vero,4189,1244,59,47,106,55.7%,4m
2420,1,Dream,4189,1371,37,34,71,52.1%,42m
2420,1,BiGGame,4189,972,27,16,43,62.8%,29m
2420,1,IIIIIIIIIIII,4189,428,9,14,23,39.1%,36m
2420,1,[Exper]DYa,4189,0,0,1,1,0.0%,11m
2425,1,GoooGiE,4188,2226,196,184,380,51.6%,16m
2425,1,samsaradance,4188,2017,58,63,121,47.9%,34m
2425,1,FadingAces,4188,0,0,3,3,0.0%,27m
2428,3,MuCephei,4187,2008,98,114,212,46.2%,4m
2428,1,Nooblet,4187,584,14,15,29,48.3%,16m
2430,1,Replica,4186,2039,87,88,175,49.7%,14m
2430,3,Pokemon,4186,906,60,65,125,48.0%,35m
2430,1,Niy,4186,376,15,2,17,88.2%,18m
2433,1,[SsaYnS]Schwinny,4185,2232,199,161,360,55.3%,27m
2433,1,[s1K]FerDeLancY,4185,0,0,1,1,0.0%,6m
2433,1,[TrpleT]Zaratul,4185,0,0,3,3,0.0%,26m
2436,1,RichaD,4184,2016,65,49,114,57.0%,21m
2436,1,MochiDonut,4184,1083,40,8,48,83.3%,12m
2436,1,epicBeginner,4184,490,12,16,28,42.9%,7m
2436,1,ButterTart,4184,144,3,2,5,60.0%,24m
2436,3,[αXLa]Rare,4184,0,1,7,8,12.5%,35m
2436,1,Alice,4184,0,0,5,5,0.0%,18m
2442,3,[IM]KrisxBell,4183,1793,92,99,191,48.2%,23m
2442,3,Castillo,4183,606,51,43,94,54.3%,8m
2444,1,TerranBoiii,4182,607,21,6,27,77.8%,7m
2444,1,[TGCF]TRUNKS,4182,73,0,4,4,0.0%,3m
2446,3,Likemybutton,4181,144,18,27,45,40.0%,35m
2446,1,fastr,4181,48,2,5,7,28.6%,36m
2446,1,IlIIIlllIllI,4181,0,1,2,3,33.3%,28m
2449,3,GuessWho,4180,1645,374,385,759,49.3%,4m
2449,1,[Gen54]generationcw,4180,2118,132,138,270,48.9%,25m
2449,1,Griefed,4180,1751,59,31,90,65.6%,23m
2449,1,BruceBanner,4180,864,19,19,38,50.0%,31m
2449,1,Semek,4180,510,14,4,18,77.8%,24m
2449,1,SoLo,4180,0,1,0,1,100.0%,6m
2449,1,MarineBoy,4180,0,1,0,1,100.0%,21m
2449,1,SocialistBoi,4180,0,1,0,1,100.0%,31m
2457,1,CeezNuts,4179,48,2,0,2,100.0%,30m
2457,1,[M4A1]ISOMER,4179,0,0,4,4,0.0%,29m
2459,1,Computer,4178,2205,340,341,681,49.9%,31m
2459,1,[AIlin]Leon,4178,2144,98,92,190,51.6%,40m
2459,1,Roma,4178,1966,89,75,164,54.3%,38m
2459,1,liberty,4178,1212,28,21,49,57.1%,27m
2459,3,FNX,4178,332,24,35,59,40.7%,40m
2459,3,sxsx,4178,24,7,14,21,33.3%,35m
2465,1,[PTsc2]Ethurion,4177,320,17,5,22,77.3%,29m
2465,3,llllllllllll,4177,112,14,22,36,38.9%,35m
2465,1,[AlIin]Hamish,4177,336,7,10,17,41.2%,31m
2465,2,llllllllllll,4177,105,5,2,7,71.4%,38m
2465,1,LeSorHaiChap,4177,96,2,8,10,20.0%,26m
2465,1,Spaceman,4177,0,1,0,1,100.0%,11m
2465,2,[PCAKE]darktemplar,4177,0,0,1,1,0.0%,40m
2472,2,lllIlllIlllI,4176,1142,66,95,161,41.0%,9m
2472,1,TheBigWurst,4176,239,12,0,12,100.0%,39m
2472,1,llllllllllll,4176,428,9,11,20,45.0%,16m
2472,1,PinkBunny,4176,238,5,11,16,31.2%,3m
2472,1,SonOfByuN,4176,192,4,5,9,44.4%,7m
2477,1,Pyatkh,4175,2000,81,82,163,49.7%,26m
2477,3,[InfB]IIIIIIIIIIII,4175,172,18,15,33,54.5%,20m
2477,3,HOSTILE,4175,0,4,1,5,80.0%,27m
2477,1,Evelyn,4175,94,2,3,5,40.0%,33m
2477,1,[TGosuB]Focus,4175,0,0,1,1,0.0%,23m
2477,1,[M13K]MKscore,4175,0,0,1,1,0.0%,27m
2483,3,INExoRaBle,4173,1463,220,205,425,51.8%,27m
2483,1,[xDMx]SIICmanSIIN,4173,374,20,1,21,95.2%,16m
2483,2,ZARD,4173,220,12,0,12,100.0%,33m
2486,1,Influenced,4172,1723,111,93,204,54.4%,24m
2486,1,[PK]Montero,4172,0,1,0,1,100.0%,11m
2486,1,SMBHs,4172,0,1,0,1,100.0%,6m
2486,1,[RlSKE]Sniper,4172,0,0,1,1,0.0%,27m
2486,1,MONUMENTS,4172,0,0,4,4,0.0%,16m
2491,1,[Xpk]DarKraii,4171,1729,130,107,237,54.9%,42m
2491,1,Krunk,4171,1184,29,17,46,63.0%,24m
2491,2,[SNlPED]EZcheezy,4171,310,11,6,17,64.7%,15m
2491,1,llllllllllll,4171,322,7,14,21,33.3%,36m
2491,1,[xRtG]Lightning,4171,0,1,2,3,33.3%,31m
2491,1,[BoRnGo]TorA,4171,48,1,4,5,20.0%,3m
2497,1,BuffloBEAST,4170,2158,163,149,312,52.2%,38m
2497,1,[Cryptc]IntoTheLoVeR,4170,391,11,9,20,55.0%,40m
2497,1,EZPZTossOP,4170,144,4,2,6,66.7%,32m
2500,1,IntiFada,4169,1741,100,87,187,53.5%,29m
2500,3,TheLawCop,4169,280,40,35,75,53.3%,42m
2502,1,[Aiyu]Jjajan,4168,2192,86,81,167,51.5%,16m
2502,1,[BIZCUT]Kulshan,4168,1256,44,35,79,55.7%,13m
2502,1,PPAP,4168,583,20,7,27,74.1%,12m
2502,1,Vorck,4168,0,0,1,1,0.0%,30m
2506,3,Roses,4167,483,40,46,86,46.5%,4m
2506,3,TossboySYF,4167,516,31,26,57,54.4%,26m
2506,1,AppaJung,4167,998,23,28,51,45.1%,20m
2506,1,llllllllllll,4167,770,22,26,48,45.8%,12m
2506,1,llllllllllll,4167,246,6,0,6,100.0%,19m
2506,1,RendeSZvous,4167,190,5,2,7,71.4%,13m
2506,1,[TGosuA]Bukkit,4167,192,5,8,13,38.5%,8m
2506,1,[GEEKED]CoronaMarine,4167,144,4,1,5,80.0%,29m
2506,2,Recovery,4167,0,1,0,1,100.0%,11m
2506,1,WHa,4167,0,1,1,2,50.0%,3m
2516,1,Treebeard,4166,1470,127,124,251,50.6%,13m
2516,1,LyriC,4166,2035,72,78,150,48.0%,18m
2516,1,Claudio,4166,1039,24,13,37,64.9%,28m
2516,2,NEWPLAYER,4166,216,12,0,12,100.0%,42m
2516,1,Nooblet,4166,48,2,0,2,100.0%,36m
2521,1,Jeff,4165,1975,125,116,241,51.9%,18m
2521,1,[StucD1]BriD,4165,142,4,1,5,80.0%,4m
2523,1,[Cryptc]SlooTh,4164,96,3,1,4,75.0%,29m
2524,3,tokaplan,4163,707,51,60,111,45.9%,4m
2524,1,[SMB]WEALTH,4163,1306,39,22,61,63.9%,25m
2524,2,DEADGAME,4163,359,16,3,19,84.2%,38m
2524,1,[SsaYnS]rock,4163,476,11,14,25,44.0%,4m
2524,1,skygarden,4163,48,1,1,2,50.0%,26m
2529,1,BigDog,4162,192,5,3,8,62.5%,17m
2529,1,IIIIIIIIIIII,4162,0,0,3,3,0.0%,7m
2531,1,[REnC]SwedishStyle,4161,2201,259,265,524,49.4%,32m
2531,1,EnemaGiver,4161,820,21,17,38,55.3%,29m
2531,1,IIIIllllIII,4161,0,0,1,1,0.0%,21m
2531,1,[PFBS]RTtoDO,4161,0,0,2,2,0.0%,27m
2535,1,kevshoe,4160,2153,468,397,865,54.1%,29m
2535,1,llllllllllll,4160,332,16,1,17,94.1%,12m
2535,1,[1stttt]ONECHINA,4160,240,5,9,14,35.7%,25m
2535,3,ChristMyLORD,4160,0,0,9,9,0.0%,26m
2539,1,[OMGBAN]Tieng,4159,1626,67,70,137,48.9%,4m
2539,3,[TXOP]MaTaTO,4159,444,33,42,75,44.0%,23m
2539,2,[ReB]nOobO,4159,0,2,4,6,33.3%,6m
2539,1,everNExt,4159,0,1,1,2,50.0%,35m
2543,1,[JaMiT]Flexxi,4157,1456,131,127,258,50.8%,3m
2543,1,HasHe,4157,1327,96,62,158,60.8%,11m
2543,1,Felvo,4157,0,1,4,5,20.0%,16m
2543,2,Kiryu,4157,0,0,2,2,0.0%,12m
2547,1,[OIGE]Demi,4156,1450,56,59,115,48.7%,28m
2547,1,ImmarudamuNA,4156,694,15,12,27,55.6%,20m
2547,1,Ttofinator,4156,96,2,1,3,66.7%,34m
2550,1,[DRFS]Sehun,4155,713,18,5,23,78.3%,13m
2550,1,Tekniqs,4155,96,3,0,3,100.0%,36m
2550,2,Yennefer,4155,130,3,4,7,42.9%,14m
2550,1,wantyommr,4155,48,1,2,3,33.3%,32m
2554,1,[X17]EvetS,4154,1185,239,223,462,51.7%,43m
2554,3,[VetZCo]torky,4154,1935,140,144,284,49.3%,12m
2554,1,ElWhiterFake,4154,1094,63,52,115,54.8%,34m
2554,1,Friskyqt,4154,1056,33,18,51,64.7%,39m
2554,1,[xOptic]Firefly,4154,788,17,25,42,40.5%,31m
2554,1,[PENSOO]vffff,4154,48,3,4,7,42.9%,6m
2554,1,Pokemon,4154,0,1,2,3,33.3%,26m
2554,1,scv,4154,48,1,3,4,25.0%,20m
2554,3,[2TETON]Lefraisacap,4154,0,0,1,1,0.0%,34m
2563,1,Hirudin,4153,1873,241,202,443,54.4%,35m
2563,1,hahaha,4153,957,25,22,47,53.2%,18m
2563,1,TrumpMAGA,4153,118,4,0,4,100.0%,12m
2563,1,lIlIlIlIlIlI,4153,190,4,0,4,100.0%,35m
2563,1,[Giffel]YoloSwaggins,4153,0,0,1,1,0.0%,26m
2568,3,OULoveMe,4152,1665,236,228,464,50.9%,23m
2568,1,[SaeKon]Azoth,4152,308,6,5,11,54.5%,17m
2568,1,IIIIIIIIIIII,4152,48,2,2,4,50.0%,3m
2571,1,[SC2BOL]Alwaysready,4151,2204,692,713,1405,49.3%,13m
2571,1,Happy,4151,2197,210,213,423,49.6%,8m
2571,3,Devon,4151,1422,75,73,148,50.7%,7m
2571,1,[Enculé]IlIllIllIll,4151,96,3,0,3,100.0%,27m
2571,1,[BoRnGo]brian,4151,0,0,1,1,0.0%,4m
2576,1,ZarKo,4150,1984,265,248,513,51.7%,7m
2576,1,ViiBunny,4150,48,1,2,3,33.3%,29m
2578,1,Buddaaaay,4149,1874,81,82,163,49.7%,13m
2578,1,[xRtG]MagiciaN,4149,1286,33,27,60,55.0%,28m
2578,1,JohnRambo,4149,1301,32,23,55,58.2%,42m
2578,1,Maww,4149,566,13,13,26,50.0%,26m
2578,1,Midnight,4149,48,1,1,2,50.0%,24m
2583,3,[xGenGx]LeRuJ,4148,2085,145,157,302,48.0%,7m
2583,1,[MirG]HeaT,4148,2062,79,88,167,47.3%,13m
2583,1,ImNotObama,4148,910,61,56,117,52.1%,29m
2583,1,[SSEAS]kayZ,4148,179,6,3,9,66.7%,33m
2583,1,[αXLa]MooD,4148,84,3,5,8,37.5%,11m
2588,3,rogba,4147,284,25,35,60,41.7%,4m
2588,1,[EZDUNK]Hornet,4147,880,20,16,36,55.6%,25m
2588,2,UpATree,4147,257,13,1,14,92.9%,42m
2588,1,[JaMiT]BigBoyLing,4147,424,10,8,18,55.6%,32m
2588,1,[CHIRP]nightblade,4147,0,0,2,2,0.0%,6m
2593,3,SneakyTurtle,4146,2010,143,139,282,50.7%,8m
2593,3,badassburito,4146,852,71,87,158,44.9%,27m
2593,1,Terminator,4146,845,27,8,35,77.1%,35m
2593,1,Santacleavas,4146,48,2,0,2,100.0%,8m
2597,1,[VKNG5]RedHorse,4145,2219,170,192,362,47.0%,18m
2597,1,[m8z]Quicksabre,4145,1258,136,140,276,49.3%,12m
2599,1,[UoM]SparkleHands,4144,714,17,7,24,70.8%,33m
2599,1,MacaRong,4144,92,3,6,9,33.3%,33m
2599,1,[FZ]BumbleFubber,4144,94,2,2,4,50.0%,7m
2599,1,HaZen,4144,0,0,7,7,0.0%,30m
2603,3,[Graal]SuperTramp,4143,1244,196,192,388,50.5%,18m
2603,1,Blackpink,4143,410,17,11,28,60.7%,12m
2603,1,TylerOkurbak,4143,423,11,10,21,52.4%,32m
2603,1,BuffReavers,4143,190,7,4,11,63.6%,20m
2603,1,[sc2rep]Breath,4143,48,2,2,4,50.0%,24m
2608,3,AnubisKing,4142,2057,574,578,1152,49.8%,21m
2608,2,[TMKOs]ARTOFBOXING,4142,1798,321,302,623,51.5%,27m
2608,2,Horiken,4142,2136,114,138,252,45.2%,27m
2608,1,[BIacer]MogarFNSMASH,4142,692,23,1,24,95.8%,20m
2608,1,[JPPR]Jduncan,4142,876,22,10,32,68.8%,17m
2613,1,[ACSS]Osiris,4141,1942,54,57,111,48.6%,29m
2613,1,SteelWar,4141,284,13,1,14,92.9%,6m
2613,1,[FANXY]Floob,4141,164,4,2,6,66.7%,39m
2613,1,greenLeaf,4141,0,0,1,1,0.0%,12m
2617,1,Ociffer,4140,409,10,4,14,71.4%,30m
2617,1,Ironic,4140,286,7,3,10,70.0%,13m
2617,1,MGR,4140,0,0,4,4,0.0%,24m
2620,3,[αX]Lanfear,4139,1458,153,171,324,47.2%,5m
2620,1,[ESCEE]Koi,4139,957,28,23,51,54.9%,12m
2620,1,llllllllllll,4139,376,9,8,17,52.9%,34m
2620,1,SeoulHyun,4139,238,5,6,11,45.5%,4m
2624,3,[eSun]Toshiro,4138,463,32,38,70,45.7%,42m
2624,1,Snow,4138,285,13,1,14,92.9%,20m
2626,3,[lNI]DiaRC,4137,1978,182,188,370,49.2%,4m
2626,1,[FRNAVY]Beltalowda,4137,990,32,10,42,76.2%,36m
2628,1,eoS,4136,654,16,17,33,48.5%,12m
2628,2,RIPhairline,4136,147,5,2,7,71.4%,14m
2628,1,[ZiYou]LonelyShadow,4136,48,1,3,4,25.0%,26m
2631,1,BigDaddy,4135,1251,47,38,85,55.3%,26m
2631,2,Zerg,4135,359,16,2,18,88.9%,12m
2633,1,[UpeV]TheSmirnoff,4134,1912,98,88,186,52.7%,33m
2633,1,[SLW]YNotZoidberg,4134,1864,68,61,129,52.7%,25m
2633,1,[Cakius]yeskis,4134,1258,41,44,85,48.2%,32m
2633,1,DYNHP,4134,705,31,8,39,79.5%,12m
2633,1,[IMkaC]ghostdop,4134,743,21,18,39,53.8%,4m
2633,1,yuki,4134,92,3,4,7,42.9%,12m
2633,1,PewPewPewPew,4134,0,1,0,1,100.0%,33m
2633,1,[INextI]ºAriesº,4134,0,0,3,3,0.0%,14m
2641,1,[RakF]Corp,4133,2183,691,678,1369,50.5%,25m
2641,1,[PCAKE]RageHunter,4133,2075,75,69,144,52.1%,12m
2641,1,Aristides,4133,686,15,10,25,60.0%,39m
2641,1,madOne,4133,552,13,6,19,68.4%,4m
2641,1,Nahagliiv,4133,0,0,1,1,0.0%,35m
2646,1,zBrook,4132,646,25,8,33,75.8%,6m
2646,1,Maru,4132,655,19,11,30,63.3%,43m
2646,1,SLIDE,4132,508,12,9,21,57.1%,28m
2646,1,IlIlIlIlI,4132,515,11,17,28,39.3%,31m
2650,1,[POPOL]ParisISmagic,4131,385,20,3,23,87.0%,13m
2650,2,Pech,4131,311,15,2,17,88.2%,40m
2650,1,ComoEstas,4131,330,7,11,18,38.9%,14m
2650,1,Rendorian,4131,0,1,0,1,100.0%,16m
2654,1,BernardMorin,4130,1850,53,45,98,54.1%,39m
2654,1,SanguineIce,4130,316,8,9,17,47.1%,25m
2654,1,BlackSaxon,4130,240,6,4,10,60.0%,34m
2654,1,[NM8]Matt,4130,0,0,1,1,0.0%,40m
2654,1,Noel,4130,0,0,4,4,0.0%,24m
2659,1,PncdaBlizz,4129,278,9,4,13,69.2%,8m
2659,1,Raigeki,4129,250,6,11,17,35.3%,21m
2659,1,randompotato,4129,0,0,1,1,0.0%,16m
2659,1,[NPhasA]PigRabbit,4129,0,0,2,2,0.0%,27m
2663,3,Kudohlol,4128,1923,380,388,768,49.5%,35m
2663,1,trueuntrue,4128,1000,150,129,279,53.8%,8m
2663,1,Hammerseele,4128,988,82,85,167,49.1%,12m
2663,1,llllllllllll,4128,0,1,1,2,50.0%,26m
2667,1,BlueBeaR,4127,2079,145,118,263,55.1%,39m
2667,1,USSR,4127,957,31,14,45,68.9%,29m
2667,1,Ender,4127,217,7,15,22,31.8%,33m
2667,3,[SsaYnS]xxxxxxxxxxxx,4127,16,4,18,22,18.2%,26m
2667,1,[SsaYnS]Paladin,4127,48,1,4,5,20.0%,39m
2667,1,Robin,4127,0,0,1,1,0.0%,28m
2673,1,IIIIIIIIIIII,4126,731,27,11,38,71.1%,7m
2673,3,LHC,4126,300,25,34,59,42.4%,35m
2673,1,chOice,4126,904,21,23,44,47.7%,43m
2673,1,ChocosJunge,4126,365,16,2,18,88.9%,12m
2673,1,Capitalist,4126,0,1,0,1,100.0%,33m
2678,1,Detour,4125,2105,166,156,322,51.6%,28m
2678,3,[αXLa]StrucK,4125,1566,140,153,293,47.8%,3m
2678,1,[ValidG]kali,4125,1441,135,117,252,53.6%,26m
2678,1,cmizzles,4125,1489,60,62,122,49.2%,6m
2678,1,[cl0udM]BlackViper,4125,690,16,15,31,51.6%,20m
2678,1,Spot,4125,240,6,4,10,60.0%,36m
2684,1,[f2win]DaedGaem,4124,2150,330,332,662,49.8%,25m
2684,1,JonKing,4124,1983,191,202,393,48.6%,28m
2684,1,URANOOB,4124,1718,56,35,91,61.5%,30m
2684,1,[ShoaL]Smile,4124,1285,43,27,70,61.4%,31m
2684,1,ComeAtMeBrah,4124,353,13,5,18,72.2%,17m
2684,1,MoXLey,4124,48,1,4,5,20.0%,27m
2684,1,[NwAs]Angelnex,4124,0,0,1,1,0.0%,12m
2691,1,Estwald,4123,1725,72,72,144,50.0%,31m
2691,3,MooNLighT,4123,1375,69,74,143,48.3%,3m
2691,1,TerranHerAss,4123,802,18,12,30,60.0%,8m
2691,1,[Ris3n]Richard,4123,192,5,6,11,45.5%,3m
2691,1,Teuca,4123,144,4,3,7,57.1%,13m
2696,3,[Kaii]Fenix,4122,1862,183,220,403,45.4%,41m
2696,1,[TGCrew]Defiance,4122,2088,166,157,323,51.4%,32m
2696,1,YOkoBlack,4122,1427,100,100,200,50.0%,14m
2696,1,Twrecks,4122,1510,39,46,85,45.9%,25m
2696,1,Wyko,4122,0,1,0,1,100.0%,34m
2696,1,Chewy,4122,0,0,1,1,0.0%,29m
2702,1,[QTp2T]AlucarD,4121,2064,297,297,594,50.0%,20m
2702,3,INFINITY,4121,996,68,86,154,44.2%,23m
2702,1,[AoBDE]multicolor,4121,1108,27,24,51,52.9%,32m
2702,1,hola,4121,792,23,10,33,69.7%,30m
2702,1,[RØR]HankeL,4121,192,4,7,11,36.4%,39m
2702,1,JoeDaddy,4121,0,1,1,2,50.0%,24m
2708,1,[Galley]HaveyWavey,4120,0,1,5,6,16.7%,24m
2709,1,BestName,4119,1575,45,46,91,49.5%,12m
2709,1,[BBooYa]IIIIIIIIIIII,4119,374,15,2,17,88.2%,31m
2709,1,[GGBr0]hihellowhihi,4119,514,11,14,25,44.0%,20m
2709,1,Kingslayer,4119,296,8,9,17,47.1%,8m
2709,1,Konosuba,4119,94,3,2,5,60.0%,13m
2709,1,fastr,4119,144,3,6,9,33.3%,3m
2709,1,llllllllllll,4119,0,0,2,2,0.0%,3m
2716,1,[CXMP]Yoshi,4118,1218,88,90,178,49.4%,14m
2716,1,CoralReef,4118,177,6,5,11,54.5%,13m
2718,1,JonSmurf,4117,1076,33,25,58,56.9%,3m
2718,1,[Niemi]llllllllllll,4117,248,8,0,8,100.0%,20m
2718,1,[xGenGx]TreeStump,4117,266,7,4,11,63.6%,28m
2721,1,Aztrack,4116,1106,35,19,54,64.8%,3m
2722,1,[UAP]TheJedi,4115,1552,110,100,210,52.4%,3m
2722,1,[eLvSC2]Bails,4115,411,15,4,19,78.9%,11m
2722,1,Ozymandias,4115,560,13,18,31,41.9%,20m
2722,1,Mausami,4115,188,5,4,9,55.6%,29m
2722,1,Cholaskid,4115,190,4,5,9,44.4%,29m
2722,3,[iDrunk]BarcodeKilla,4115,0,0,1,1,0.0%,16m
2728,1,FreeHongKong,4114,2067,109,96,205,53.2%,16m
2728,1,KiRiTo,4114,2151,89,79,168,53.0%,4m
2728,1,MaydupNaim,4114,1041,56,42,98,57.1%,17m
2731,1,kali,4113,1439,52,37,89,58.4%,23m
2731,1,Elmo,4113,712,28,22,50,56.0%,29m
2731,1,[AlIin]robinoprime,4113,0,1,0,1,100.0%,34m
2734,1,Pato,4112,1549,78,69,147,53.1%,13m
2734,1,lIIIIIIlll,4112,698,27,11,38,71.1%,23m
2736,1,breaker,4111,1966,120,108,228,52.6%,34m
2736,1,[Ris3n]fshhsdhf,4111,1425,74,42,116,63.8%,29m
2736,1,[SPCBR]Barcode,4111,474,11,19,30,36.7%,6m
2736,2,dkttkdls,4111,215,7,1,8,87.5%,31m
2736,1,Furbiford,4111,96,3,2,5,60.0%,3m
2736,1,Endoyo,4111,48,2,4,6,33.3%,20m
2742,1,[Pig2]Stephan,4110,2152,430,419,849,50.6%,19m
2742,1,[TwoNB]Walnuts,4110,1830,47,52,99,47.5%,40m
2742,1,Bragitas,4110,749,40,24,64,62.5%,8m
2742,1,xJuwLoz,4110,0,1,1,2,50.0%,26m
2742,1,[NPhasA]DanieLBee,4110,0,0,2,2,0.0%,34m
2742,1,MeGaRe,4110,0,0,2,2,0.0%,34m
2748,1,grimZ,4109,1851,95,68,163,58.3%,32m
2748,1,MrMidnight,4109,1928,57,49,106,53.8%,28m
2748,1,Ascendead,4109,1014,24,16,40,60.0%,29m
2748,1,ADreNaLinE,4109,763,20,13,33,60.6%,13m
2748,3,[xTQc]FiNiTioN,4109,24,6,16,22,27.3%,37m
2748,1,EmperorMeiji,4109,192,5,2,7,71.4%,14m
2748,1,[juggr]Grahan,4109,96,3,5,8,37.5%,25m
2748,1,[PSlSTC]Ghostchant,4109,0,1,0,1,100.0%,4m
2748,1,Kingfisher,4109,0,1,1,2,50.0%,7m
2757,1,Vitross,4108,1822,108,105,213,50.7%,31m
2757,1,KelviN,4108,1683,89,48,137,65.0%,17m
2757,1,[Lp]MariNe,4108,1261,34,28,62,54.8%,17m
2757,1,Park,4108,328,8,6,14,57.1%,17m
2757,1,BGGHHGGG,4108,334,8,13,21,38.1%,26m
2762,2,iMpulse,4107,1690,170,190,360,47.2%,22m
2762,3,[ZerOi]llllllllllll,4107,1402,72,75,147,49.0%,42m
2762,1,[ZTemps]OneMoreTime,4107,1509,71,63,134,53.0%,8m
2762,1,[PTHero]ProgX,4107,332,8,12,20,40.0%,43m
2762,2,Mothrah,4107,0,1,0,1,100.0%,6m
2767,1,MuleHammer,4106,1419,95,90,185,51.4%,31m
2767,1,Moonerz,4106,363,9,16,25,36.0%,18m
2767,1,SofaKingAlfa,4106,284,8,8,16,50.0%,12m
2767,1,jakesully,4106,0,0,1,1,0.0%,23m
2767,3,[Kaii]BabyDriver,4106,0,0,1,1,0.0%,24m
2772,1,[SsaYnS]Eggnog,4105,2142,232,222,454,51.1%,13m
2772,1,[M0DE]BLISSMODE,4105,1656,61,64,125,48.8%,12m
2772,3,dirtycheeser,4105,1198,61,65,126,48.4%,8m
2772,1,[UpeV]NastyJoker,4105,1771,48,45,93,51.6%,40m
2772,3,[AbcCo]AxelGun,4105,515,35,46,81,43.2%,35m
2772,1,FearfulButon,4105,736,16,23,39,41.0%,32m
2772,2,[M4nLUV]BaldSavage,4105,195,5,5,10,50.0%,28m
2772,1,Bobby,4105,96,2,3,5,40.0%,6m
2780,3,Logarithm,4104,1540,81,85,166,48.8%,22m
2780,1,llllllllllll,4104,1858,57,49,106,53.8%,26m
2780,1,Chronically,4104,1797,56,42,98,57.1%,32m
2780,1,KaBoomBabY,4104,1216,39,23,62,62.9%,3m
2780,1,BruhMoment,4104,709,22,27,49,44.9%,29m
2780,1,Heziao,4104,605,15,17,32,46.9%,6m
2780,1,[EZDUNK]bolbol,4104,464,10,7,17,58.8%,26m
2780,1,Drasher,4104,375,9,28,37,24.3%,7m
2780,1,Benownurass,4104,0,1,4,5,20.0%,12m
2780,1,PeterHartz,4104,0,0,1,1,0.0%,13m
2780,1,OnlIlIlyRush,4104,0,0,1,1,0.0%,3m
2791,1,[Det0x]Forever,4103,584,18,13,31,58.1%,29m
2791,1,Thugachu,4103,464,11,4,15,73.3%,3m
2791,3,Blitzkrieg,4103,86,7,1,8,87.5%,2m
2794,1,[Fpz]Echo,4102,728,17,19,36,47.2%,39m
2794,1,[H0PES]HopeTurtle,4102,378,9,9,18,50.0%,29m
2794,1,[UpxV]llllllllll,4102,0,1,0,1,100.0%,24m
2797,1,PaperKut,4101,2157,293,271,564,52.0%,34m
2797,1,[Ris3n]SticksBender,4101,1322,31,37,68,45.6%,3m
2797,1,Rivaul,4101,604,14,12,26,53.8%,29m
2797,1,[FANXY]llllllllllll,4101,190,4,3,7,57.1%,39m
2797,1,Implying,4101,0,0,1,1,0.0%,43m
2797,1,[Slayor]Noomi,4101,0,0,2,2,0.0%,35m
2803,1,[RushTw]BorisRush,4100,1061,36,20,56,64.3%,26m
2803,1,Drumstick,4100,838,32,36,68,47.1%,29m
2803,1,corpsepose,4100,140,3,3,6,50.0%,11m
2803,1,Illidan,4100,0,0,1,1,0.0%,29m
2807,1,btanae,4099,1042,25,29,54,46.3%,16m
2807,1,[AbcCo]ATField,4099,634,15,9,24,62.5%,3m
2807,1,Obamabinalin,4099,222,11,0,11,100.0%,12m
2810,3,[EZDUNK]CHADMARINE,4098,410,31,46,77,40.3%,35m
2810,1,JustinBieber,4098,341,15,2,17,88.2%,20m
2810,1,[HOTDAM]MileyCyrus,4098,426,10,6,16,62.5%,24m
2810,1,[ShoaL]Clementine,4098,240,6,4,10,60.0%,13m
2810,2,llIIllIIll,4098,40,2,1,3,66.7%,33m
2810,1,Heart,4098,0,0,1,1,0.0%,21m
2810,1,lIlIlIlIlIlI,4098,0,0,8,8,0.0%,13m
2817,1,[AthSun]Chai,4097,48,2,2,4,50.0%,13m
2818,3,Destro,4096,1992,363,360,723,50.2%,23m
2818,1,Lake,4096,2118,180,178,358,50.3%,3m
2818,1,[CCP20]IIIIIIIIIIII,4096,322,7,10,17,41.2%,29m
2818,1,[αB]Melody,4096,140,4,4,8,50.0%,8m
2818,1,ljootQln,4096,48,1,2,3,33.3%,7m
2823,3,[AD3C]SlayersMvP,4095,1924,494,484,978,50.5%,23m
2823,1,[PSlSTC]brololo,4095,1778,51,45,96,53.1%,21m
2823,1,IlIlIlIlIlIl,4095,192,5,9,14,35.7%,25m
2823,2,VergaFlacida,4095,78,3,0,3,100.0%,17m
2823,1,[EinFal]WestWood,4095,48,1,2,3,33.3%,29m
2828,3,[nieBla]RaynorWins,4094,1735,135,130,265,50.9%,31m
2828,3,MadStar,4094,1189,85,103,188,45.2%,37m
2828,1,JacquelineJ,4094,1207,32,26,58,55.2%,12m
2828,1,Skwal,4094,813,30,22,52,57.7%,40m
2828,1,Vengeance,4094,802,23,21,44,52.3%,3m
2833,1,limitless,4093,2167,104,109,213,48.8%,19m
2833,1,Joe,4093,0,0,1,1,0.0%,26m
2835,1,Sorry,4092,1318,32,33,65,49.2%,29m
2835,1,[SC2PH]Retsu,4092,190,5,7,12,41.7%,17m
2835,1,StorM,4092,142,4,6,10,40.0%,32m
2838,1,Ghostmakerx,4091,1714,147,114,261,56.3%,13m
2838,1,[CtpSat]PkE,4091,2163,89,93,182,48.9%,40m
2838,1,[GOPERÚ]SrSARCASMO,4091,1670,45,39,84,53.6%,23m
2838,1,TorukMakto,4091,784,29,12,41,70.7%,19m
2838,1,HuanRosie,4091,46,2,0,2,100.0%,40m
2843,1,Terran,4090,1408,77,67,144,53.5%,3m
2843,1,Player,4090,711,59,22,81,72.8%,17m
2843,1,llllllllllll,4090,1972,55,60,115,47.8%,6m
2843,1,[αXLa]Mercy,4090,48,1,3,4,25.0%,20m
2847,1,Masami,4089,2147,133,139,272,48.9%,29m
2847,1,jackbauer,4089,2017,61,61,122,50.0%,40m
2847,1,baechufield,4089,657,19,9,28,67.9%,19m
2847,1,[CIoud9]IlllllI,4089,233,14,9,23,60.9%,8m
2847,1,IIIIIIIIIIII,4089,48,5,3,8,62.5%,12m
2852,1,IIIIIIIIIIII,4088,1356,75,31,106,70.8%,27m
2852,1,[nG]PerfectPlay,4088,690,23,20,43,53.5%,40m
2852,1,Spiffin,4088,628,15,20,35,42.9%,3m
2855,1,IvanesChad,4087,2050,265,246,511,51.9%,28m
2855,1,kryfie,4087,2137,162,146,308,52.6%,16m
2855,1,TheMauryShow,4087,1466,38,41,79,48.1%,28m
2855,1,Xenon,4087,552,13,10,23,56.5%,33m
2855,1,byippy,4087,0,1,0,1,100.0%,3m
2860,1,[TGCF]USVirus,4086,48,2,0,2,100.0%,32m
2861,1,Kafei,4085,1196,38,25,63,60.3%,12m
2861,1,COSRX,4085,142,4,4,8,50.0%,28m
2863,3,CoreaTeam,4084,189,31,34,65,47.7%,35m
2863,1,[HBGSJR]GladiaThor,4084,687,15,17,32,46.9%,31m
2863,1,[HRBNGR]Hupsaiya,4084,46,2,0,2,100.0%,13m
2863,1,pdx,4084,66,2,2,4,50.0%,39m
2867,1,Jonas,4083,236,5,10,15,33.3%,27m
2867,1,sKILLwisER,4083,0,1,0,1,100.0%,16m
2869,1,SmokinDank,4082,2093,211,207,418,50.5%,27m
2869,3,atrium,4082,1312,96,100,196,49.0%,13m
2869,1,[BUTFUQ]reikai,4082,385,8,9,17,47.1%,25m
2869,1,[ValidG]eDxX,4082,0,0,3,3,0.0%,14m
2873,1,[NovaX]octomologyst,4081,1732,48,44,92,52.2%,29m
2873,1,[FFAA]Tlaloc,4081,1397,43,37,80,53.8%,18m
2873,1,IIIIIIIIIIII,4081,814,21,10,31,67.7%,13m
2873,1,BradPitt,4081,696,20,9,29,69.0%,28m
2873,1,[WHTN]Exotic,4081,502,16,6,22,72.7%,13m
2873,1,[Fugma]Sugma,4081,412,9,4,13,69.2%,24m
2873,1,[pSC20]NaCl,4081,0,1,2,3,33.3%,26m
2880,1,scoli,4080,2036,128,106,234,54.7%,39m
2880,1,blackship,4080,1705,81,67,148,54.7%,24m
2880,3,Primming,4080,487,29,21,50,58.0%,26m
2880,1,Boo,4080,906,22,21,43,51.2%,16m
2884,1,nostalgc,4078,123,4,7,11,36.4%,29m
2884,1,DaXxTeR,4078,0,0,3,3,0.0%,36m
2886,1,JaCrispy,4077,1858,269,260,529,50.9%,34m
2886,1,ALM,4077,316,7,8,15,46.7%,24m
2886,1,lIlIIllIlI,4077,192,5,7,12,41.7%,4m
2886,1,Eintopf,4077,0,1,0,1,100.0%,14m
2890,1,[FackU]Coldwaters,4076,1404,57,64,121,47.1%,43m
2890,3,Mengsk,4076,729,44,59,103,42.7%,5m
2890,3,dooz,4076,582,43,59,102,42.2%,42m
2890,1,DarkNess,4076,831,37,12,49,75.5%,26m
2890,1,[FxB]caiobex,4076,654,16,10,26,61.5%,29m
2890,3,[BuBbLe]Air,4076,12,4,16,20,20.0%,18m
2890,1,Jedi,4076,96,2,9,11,18.2%,29m
2897,1,Duffy,4075,832,51,55,106,48.1%,13m
2897,1,distortion,4075,96,2,7,9,22.2%,24m
2897,1,[GRNSKN]ChiefColin,4075,0,1,4,5,20.0%,43m
2897,1,CGK,4075,0,0,1,1,0.0%,23m
2901,3,[UIUC]icebuddha,4074,2028,190,204,394,48.2%,23m
2901,1,[FateTw]Chance,4074,1710,106,103,209,50.7%,29m
2901,1,IMMVP,4074,1740,65,50,115,56.5%,3m
2901,1,Dev,4074,282,7,2,9,77.8%,14m
2901,1,[lDream]LosT,4074,178,4,13,17,23.5%,29m
2901,1,CherryLiLi,4074,0,1,0,1,100.0%,13m
2901,1,[WNTRLY]Fencar,4074,0,0,1,1,0.0%,26m
2901,1,[TSØP]RenesoundGB,4074,0,0,1,1,0.0%,24m
2909,1,Retsof,4073,1140,43,50,93,46.2%,39m
2909,1,IllIIllIllll,4073,424,20,4,24,83.3%,20m
2909,1,[PCAKE]Jimmy,4073,0,0,1,1,0.0%,29m
2912,1,KyZer,4072,1775,129,117,246,52.4%,20m
2912,1,StrubbleS,4072,348,21,7,28,75.0%,3m
2914,1,[SL7R]Voodoo,4071,1241,41,46,87,47.1%,33m
2914,1,zxcvf,4071,334,7,3,10,70.0%,16m
2914,1,[Cakius]Yëskis,4071,140,4,2,6,66.7%,20m
2914,1,[Bee]Athena,4071,141,2,3,5,40.0%,20m
2918,1,[ValidG]AverageDude,4070,1272,71,62,133,53.4%,4m
2918,1,[xTz]PedoG,4070,1227,47,29,76,61.8%,12m
2918,1,[ZTemp]Zaratul,4070,96,2,4,6,33.3%,28m
2918,1,BigGayBob,4070,48,1,3,4,25.0%,29m
2918,1,ThEraXis,4070,0,0,3,3,0.0%,27m
2923,1,Air,4069,829,125,99,224,55.8%,27m
2923,1,Dexter,4069,835,26,16,42,61.9%,29m
2923,3,Strategyzer,4069,127,7,8,15,46.7%,18m
2923,1,[Dante]Dante,4069,236,6,4,10,60.0%,40m
2923,1,[TSan]Veniar,4069,224,5,5,10,50.0%,39m
2928,1,[NwAs]LiquidAJ,4068,989,26,20,46,56.5%,3m
2928,1,Papai,4068,228,7,3,10,70.0%,3m
2928,1,Atheris,4068,142,4,0,4,100.0%,26m
2928,1,[BirosK]JNR,4068,0,0,2,2,0.0%,12m
2932,1,[FMX]RENDER,4067,2106,117,121,238,49.2%,3m
2932,1,llllllllllll,4067,2122,90,85,175,51.4%,11m
2932,3,[TxC1]TakeMyHand,4067,11,28,36,64,43.8%,11m
2932,1,[POPOL]OPMVPC,4067,452,14,9,23,60.9%,28m
2932,1,Avilo,4067,429,10,2,12,83.3%,29m
2932,1,Kojiro,4067,140,4,2,6,66.7%,13m
2932,1,[VetZCo]POODLEHAT,4067,96,2,4,6,33.3%,8m
2932,1,JDC,4067,0,0,1,1,0.0%,33m
2932,2,ZapBranigan,4067,0,0,2,2,0.0%,38m
2941,1,[xRtG]HondaCivic,4066,1612,44,45,89,49.4%,12m
2941,1,IZIIII,4066,663,31,27,58,53.4%,36m
2941,1,Sage,4066,888,22,16,38,57.9%,21m
2941,1,Gilgameheart,4066,462,11,10,21,52.4%,4m
2941,1,[TAW]Henpe,4066,48,1,1,2,50.0%,3m
2946,1,TheMango,4065,681,29,6,35,82.9%,18m
2946,1,clindsteben,4065,347,18,3,21,85.7%,13m
2946,1,lVlagic,4065,642,15,17,32,46.9%,20m
2946,1,Geralt,4065,48,2,2,4,50.0%,43m
2950,3,JeanPaul,4064,6,150,162,312,48.1%,21m
2950,1,Pianistickz,4064,736,27,26,53,50.9%,18m
2950,1,Indominus,4064,476,12,14,26,46.2%,31m
2950,1,Trasgo,4064,236,6,4,10,60.0%,12m
2950,3,IIIIIIIII,4064,0,1,0,1,100.0%,36m
2950,1,Linkage,4064,0,0,3,3,0.0%,12m
2956,1,Dollybird,4063,2139,336,323,659,51.0%,33m
2956,1,SnækPlatypus,4063,2069,168,171,339,49.6%,13m
2956,1,Memeling,4063,425,26,2,28,92.9%,23m
2956,1,BlueKnight,4063,439,19,5,24,79.2%,19m
2956,1,PedoJoeBiden,4063,666,16,10,26,61.5%,43m
2956,1,thedude,4063,238,5,2,7,71.4%,6m
2956,1,SweetChickP,4063,90,3,6,9,33.3%,36m
2956,3,[UpeV]BLord,4063,30,1,3,4,25.0%,41m
2956,1,Demyx,4063,48,1,7,8,12.5%,27m
2956,2,Evose,4063,0,0,1,1,0.0%,23m
2956,1,RicheyRich,4063,0,0,2,2,0.0%,3m
2967,1,Lulzorness,4062,1454,128,118,246,52.0%,16m
2967,1,[LTlord]ZON,4062,1869,64,55,119,53.8%,28m
2967,1,PaCMichi,4062,1599,54,36,90,60.0%,30m
2967,1,hubs,4062,930,23,24,47,48.9%,13m
2967,1,AngryChobo,4062,467,13,9,22,59.1%,28m
2967,1,LASVEGASCASE,4062,0,1,0,1,100.0%,34m
2973,1,[NwAs]delcrimen,4061,2000,121,132,253,47.8%,13m
2973,1,BiggestNoob,4061,618,25,8,33,75.8%,28m
2973,1,xXoXx,4061,0,1,0,1,100.0%,33m
2976,1,[IONA]Universe,4060,1115,36,26,62,58.1%,35m
2976,1,[vRIEu]BitcoinBosse,4060,497,23,5,28,82.1%,24m
2976,1,CoffeeTime,4060,432,13,7,20,65.0%,30m
2976,1,HeroSCV,4060,357,11,11,22,50.0%,18m
2976,2,[Afreca]FlaSh,4060,42,2,4,6,33.3%,14m
2981,1,BarCode,4059,1162,113,82,195,57.9%,29m
2981,1,[PiGPan]alpaca,4059,1823,78,77,155,50.3%,17m
2981,1,microbes,4059,930,22,33,55,40.0%,34m
2981,1,Shrike,4059,45,2,3,5,40.0%,39m
2981,1,[OIGE]POseiDOn,4059,0,1,0,1,100.0%,31m
2981,1,[Tyber]jameszhou,4059,0,1,4,5,20.0%,3m
2987,1,KaiBee,4058,2115,261,245,506,51.6%,4m
2987,1,DTRAWW,4058,538,13,12,25,52.0%,3m
2987,1,[SsaYnS]Rain,4058,144,3,1,4,75.0%,13m
2987,1,[UcanWn]DayDream,4058,48,2,0,2,100.0%,16m
2987,1,[Sluce]DaddyChill,4058,96,2,3,5,40.0%,25m
2987,1,Segin,4058,48,2,4,6,33.3%,39m
2987,1,[InGt]GhostPants,4058,48,1,1,2,50.0%,30m
2994,1,[eyedea]abilities,4057,1467,87,84,171,50.9%,40m
2994,2,Suigetsu,4057,366,17,7,24,70.8%,11m
2994,1,PeaCH,4057,232,5,6,11,45.5%,32m
2997,1,[G0G0G0]Mayan,4056,1341,62,20,82,75.6%,33m
2997,1,[LgnTDS]OldGregg,4056,312,8,7,15,53.3%,33m
2997,1,chelseafan,4056,363,8,9,17,47.1%,39m
2997,1,noctom,4056,96,3,1,4,75.0%,26m
2997,2,Malarki,4056,0,1,1,2,50.0%,30m
2997,3,IIIIIIIIIIII,4056,0,1,1,2,50.0%,9m
3003,1,[INextI]Fenix,4055,1632,155,155,310,50.0%,29m
3003,3,Badboy,4055,1711,133,151,284,46.8%,28m
3003,1,lololololol,4055,2106,108,97,205,52.7%,19m
3003,3,Ender,4055,636,51,69,120,42.5%,32m
3003,3,[N0ne]IIIIIIIIIIII,4055,943,47,38,85,55.3%,26m
3003,1,[UpeV]DayZ,4055,900,29,29,58,50.0%,29m
3003,1,Ephemeral,4055,188,11,0,11,100.0%,27m
3003,1,KhainGonuyo,4055,0,1,0,1,100.0%,20m
3003,1,[DRKAPP]lilpikachu,4055,0,0,1,1,0.0%,35m
3012,1,[αXLa]PrinceMarine,4054,2080,143,147,290,49.3%,39m
3012,1,thaichili,4054,2101,140,140,280,50.0%,3m
3012,1,mroz,4054,672,28,12,40,70.0%,12m
3012,1,MaestroRF,4054,296,17,4,21,81.0%,20m
3012,1,JoelVanesco,4054,186,4,6,10,40.0%,28m
3012,2,[SMB]AbsoluteZero,4054,38,2,0,2,100.0%,43m
3018,1,MechTastic,4053,2134,75,78,153,49.0%,39m
3018,1,[Jing]Hyewon,4053,799,24,34,58,41.4%,12m
3018,1,[Perfec]ThreeInches,4053,0,1,0,1,100.0%,12m
3018,1,MaxPower,4053,0,0,4,4,0.0%,23m
3022,1,DreadLord,4052,380,9,9,18,50.0%,18m
3022,1,MochiMuffin,4052,234,5,3,8,62.5%,30m
3022,1,Trakia,4052,142,3,5,8,37.5%,26m
3022,2,[BmJn]Homeboy,4052,0,1,0,1,100.0%,23m
3026,1,jcjc,4051,1577,104,107,211,49.3%,20m
3026,1,xpope,4051,2035,81,86,167,48.5%,20m
3026,1,Artyom,4051,950,27,14,41,65.9%,27m
3026,1,[ggNtus]Kixantrix,4051,724,17,26,43,39.5%,40m
3026,1,[425]delta,4051,406,10,19,29,34.5%,27m
3026,1,[3GG]Scrambled,4051,0,1,0,1,100.0%,43m
3032,1,[ID10TS]piepulls,4050,2096,199,197,396,50.3%,18m
3032,1,IUI,4050,1725,62,48,110,56.4%,3m
3032,1,[DRFS]ElfandOak,4050,689,17,8,25,68.0%,36m
3032,1,[xRtG]Random,4050,280,6,7,13,46.2%,26m
3032,1,Xiaose,4050,46,1,3,4,25.0%,31m
3037,1,plopdude,4049,2124,258,258,516,50.0%,3m
3037,1,coolwhip,4049,1589,168,164,332,50.6%,14m
3037,3,[BoRnGo]LizardKingly,4049,1680,143,162,305,46.9%,21m
3037,1,StrikeR,4049,458,14,14,28,50.0%,34m
3037,1,Triaina,4049,278,7,1,8,87.5%,17m
3037,1,[RotMG]Turbulence,4049,284,6,22,28,21.4%,11m
3037,1,[C9G]SamGamgi,4049,0,0,2,2,0.0%,7m
3044,1,stylz,4048,2113,280,282,562,49.8%,25m
3044,1,DrTalos,4048,1568,47,46,93,50.5%,31m
3044,1,[Random]xNPi,4048,91,2,3,5,40.0%,3m
3047,1,[EhTeam]Myst,4047,1972,61,73,134,45.5%,35m
3047,2,Horizon,4047,210,13,1,14,92.9%,20m
3047,1,[NPhasA]OverPowered,4047,96,3,7,10,30.0%,25m
3050,1,IMassGhosts,4046,1838,49,50,99,49.5%,11m
3050,1,NoobDay,4046,930,37,33,70,52.9%,4m
3050,2,lIllIIllII,4046,277,9,5,14,64.3%,29m
3050,1,[Amend]Terror,4046,200,6,8,14,42.9%,36m
3050,1,[xSAGA]GanziSAGA,4046,96,2,6,8,25.0%,25m
3050,1,Jun,4046,0,1,0,1,100.0%,28m
3056,1,[Th3Bad]firebat,4045,2095,336,357,693,48.5%,29m
3056,1,Apex,4045,566,18,20,38,47.4%,18m
3056,1,Marlon,4045,0,0,2,2,0.0%,3m
3059,1,[DikBoy]Light,4044,1397,47,45,92,51.1%,18m
3059,3,Marko,4044,50,17,29,46,37.0%,11m
3059,2,ByuNnoVation,4044,0,0,2,2,0.0%,36m
3059,1,OPOP,4044,0,0,3,3,0.0%,11m
3063,1,Autodidact,4043,1885,266,275,541,49.2%,34m
3063,1,llllllllllll,4043,1442,39,35,74,52.7%,27m
3063,1,IIIIIIIIIIII,4043,140,8,2,10,80.0%,34m
3063,1,DaXxTeR,4043,0,1,2,3,33.3%,36m
3063,1,[Cind3r]ethanhunt,4043,0,0,2,2,0.0%,24m
3068,1,[nPnSX]Hippyjet,4042,1674,54,42,96,56.2%,26m
3068,1,llllllllllll,4042,1214,29,34,63,46.0%,35m
3068,2,THORISHERE,4042,46,2,2,4,50.0%,13m
3068,1,EhMove,4042,0,0,1,1,0.0%,26m
3068,1,[eSun]Vraspik,4042,0,0,5,5,0.0%,33m
3073,1,[TeamUR]KiWi,4041,1728,118,123,241,49.0%,29m
3073,1,IIIIIIIIIIII,4041,94,2,3,5,40.0%,17m
3073,1,RobBedstain,4041,0,1,0,1,100.0%,34m
3076,1,[GlRTH]JustMe,4040,1819,252,255,507,49.7%,20m
3076,1,[BNJWA]Mobius,4040,1837,109,89,198,55.1%,25m
3076,1,[4am]Ability,4040,2102,105,90,195,53.8%,26m
3076,1,Babivegita,4040,48,1,2,3,33.3%,12m
3076,1,[Ladon]void,4040,0,0,1,1,0.0%,23m
3081,1,Addict,4039,538,22,7,29,75.9%,39m
3081,1,Dxros,4039,179,8,2,10,80.0%,4m
3081,1,Egwene,4039,217,7,2,9,77.8%,3m
3081,3,jazzzkk,4039,0,4,1,5,80.0%,21m
3081,1,abcdefghijkl,4039,0,0,1,1,0.0%,25m
3086,1,mnepovezlo,4038,2104,244,238,482,50.6%,20m
3086,3,[lLiTl]MauiWaui,4038,1481,219,221,440,49.8%,23m
3086,1,HelmPeter,4038,2067,62,54,116,53.4%,20m
3089,1,[IMDSI]Sarrel,4037,796,18,28,46,39.1%,3m
3089,1,[ValidG]Bandit,4037,400,14,13,27,51.9%,13m
3089,1,Pragmatist,4037,206,8,3,11,72.7%,3m
3089,1,blackship,4037,0,0,5,5,0.0%,35m
3093,3,[SuperZ]Honor,4036,86,6,3,9,66.7%,27m
3093,1,[ReList]PikaPika,4036,190,5,2,7,71.4%,12m
3093,3,lllIIIllllll,4036,58,3,0,3,100.0%,41m
3093,1,bigbanana,4036,46,1,1,2,50.0%,25m
3097,1,[αX]KOBA,4035,1008,24,22,46,52.2%,7m
3097,1,Cerdoken,4035,580,15,12,27,55.6%,12m
3097,1,IIllIIIllIIl,4035,280,6,7,13,46.2%,29m
3097,1,cheeseme,4035,0,0,1,1,0.0%,13m
3101,1,[PSU]Guillermoman,4034,2022,137,127,264,51.9%,16m
3101,1,Goblin,4034,1077,40,20,60,66.7%,20m
3101,1,DisCoWinTeR,4034,0,0,1,1,0.0%,25m
3104,3,llllllllllll,4033,2033,167,195,362,46.1%,27m
3104,1,[Lp]TheDarkOne,4033,756,18,18,36,50.0%,33m
3104,3,Pearcey,4033,191,10,0,10,100.0%,38m
3104,2,Special,4033,130,3,1,4,75.0%,18m
3108,1,IlIlllIlIlll,4032,1038,60,40,100,60.0%,4m
3108,1,Klimrod,4032,378,19,6,25,76.0%,3m
3108,1,Chief,4032,192,4,9,13,30.8%,14m
3111,1,[qOjOp]eurotrash,4031,1108,59,46,105,56.2%,14m
3111,1,Cxo,4031,1528,57,61,118,48.3%,40m
3111,1,Darknight,4031,1529,44,39,83,53.0%,3m
3111,2,Aramos,4031,205,11,2,13,84.6%,38m
3111,1,Enigma,4031,274,6,0,6,100.0%,17m
3111,1,Azu,4031,234,6,2,8,75.0%,13m
3111,1,Phive,4031,280,6,8,14,42.9%,4m
3111,1,Levity,4031,186,5,4,9,55.6%,25m
3111,1,Yours,4031,144,4,2,6,66.7%,14m
3111,1,Unique,4031,96,2,3,5,40.0%,35m
3111,1,[DDDDD]KMNZ,4031,96,2,4,6,33.3%,17m
3111,1,[Yuhang]Launcelot,4031,48,2,5,7,28.6%,19m
3111,1,IIIIIIIIIIII,4031,0,1,1,2,50.0%,16m
3111,2,Timeh,4031,0,0,6,6,0.0%,38m
3125,3,[HFXX]Humfluxx,4030,157,10,0,10,100.0%,31m
3125,1,Klevski,4030,460,10,14,24,41.7%,35m
3125,1,[IWCP]Daner,4030,326,7,9,16,43.8%,40m
3125,1,[HueJas]llll,4030,282,6,13,19,31.6%,13m
3125,1,StupidMcOink,4030,0,0,1,1,0.0%,25m
3125,1,LetsbeFriend,4030,0,0,3,3,0.0%,43m
3131,1,eNVy,4029,2050,74,72,146,50.7%,40m
3131,1,dieYoung,4029,308,17,4,21,81.0%,19m
3131,1,DylanReese,4029,276,9,5,14,64.3%,21m
3131,1,[INextI]Capablanca,4029,192,4,5,9,44.4%,6m
3131,1,[DIN]Lias,4029,0,1,1,2,50.0%,23m
3136,1,[UpeV]Electricmano,4028,1622,42,49,91,46.2%,11m
3136,1,[GØSU]bobabomber,4028,762,19,23,42,45.2%,14m
3136,1,Rowan,4028,48,1,8,9,11.1%,17m
3139,1,[TheRs]LiberTea,4027,1387,97,68,165,58.8%,20m
3139,1,StimPack,4027,547,19,8,27,70.4%,43m
3139,2,abraKadabra,4027,308,14,4,18,77.8%,42m
3139,2,ProStyMay,4027,263,8,4,12,66.7%,15m
3139,1,Wenson,4027,0,1,0,1,100.0%,29m
3144,1,Schnitzel,4026,1070,96,92,188,51.1%,29m
3144,3,Vindicarian,4026,316,28,47,75,37.3%,5m
3144,1,Agnoletto,4026,190,4,3,7,57.1%,25m
3144,1,IIIIIIIIIIII,4026,0,0,3,3,0.0%,28m
3148,1,MDG,4025,890,20,28,48,41.7%,24m
3148,1,Jenny,4025,70,2,2,4,50.0%,28m
3148,1,gazza,4025,96,2,5,7,28.6%,20m
3148,1,zachxxx,4025,0,1,0,1,100.0%,27m
3152,1,[TSØP]bepCito,4024,1974,132,128,260,50.8%,14m
3152,3,Freean,4024,73,34,38,72,47.2%,21m
3152,1,[HØST]Fehlen,4024,0,0,2,2,0.0%,28m
3155,1,Raistlin,4023,792,75,64,139,54.0%,14m
3155,1,[DETER]DeltaStar,4023,688,15,30,45,33.3%,8m
3155,1,Resistance,4023,0,1,0,1,100.0%,3m
3158,1,Serendipity,4022,220,13,1,14,92.9%,31m
3158,1,Spidey,4022,372,9,10,19,47.4%,36m
3158,1,Bíqq,4022,320,7,7,14,50.0%,43m
3158,1,slide,4022,144,4,5,9,44.4%,3m
3158,1,Shallow,4022,192,4,7,11,36.4%,6m
3158,1,Bjl,4022,0,0,1,1,0.0%,35m
3158,1,[EWM]Itzwil,4022,0,0,5,5,0.0%,3m
3165,1,[PerúPe]AlegriA,4021,1904,79,64,143,55.2%,4m
3165,1,[αXLa]CEMAFATHI,4021,1751,58,51,109,53.2%,39m
3165,1,[MIT]SyZyGy,4021,1677,58,68,126,46.0%,25m
3165,1,Seahorse,4021,314,14,6,20,70.0%,4m
3165,1,[ESUB]Baguette,4021,369,9,3,12,75.0%,29m
3165,1,[8Range]ShugenDo,4021,238,6,8,14,42.9%,29m
3165,1,LUNATIC,4021,0,0,3,3,0.0%,6m
3165,2,Victor,4021,0,0,4,4,0.0%,24m
3173,1,TaNJiRo,4020,2087,197,181,378,52.1%,33m
3173,1,WildBob,4020,1503,45,52,97,46.4%,3m
3173,1,burp,4020,321,17,4,21,81.0%,19m
3173,1,InebriatedSc,4020,192,5,5,10,50.0%,27m
3173,1,[Ash3s]zOrkz,4020,188,4,7,11,36.4%,33m
3173,1,DharmaKiller,4020,0,1,0,1,100.0%,13m
3173,1,Slate,4020,0,0,2,2,0.0%,26m
3180,1,SpecialForce,4019,1399,233,203,436,53.4%,20m
3180,1,imageteller,4019,1193,117,123,240,48.8%,3m
3180,1,UmMaBobJoe,4019,436,33,14,47,70.2%,32m
3180,1,Marshmellow,4019,684,21,16,37,56.8%,14m
3180,1,[Zopop]Crosby,4019,264,15,5,20,75.0%,23m
3180,1,JohnRambo,4019,359,12,4,16,75.0%,25m
3180,1,ateapotist,4019,316,7,7,14,50.0%,14m
3180,1,Reppa,4019,0,1,0,1,100.0%,4m
3180,1,ROROROOOOOOO,4019,48,1,3,4,25.0%,7m
3189,1,Summer,4018,1742,207,199,406,51.0%,18m
3189,1,Mintboy,4018,1949,118,86,204,57.8%,21m
3189,1,Trickster,4018,1053,76,61,137,55.5%,28m
3189,1,IIIIIIIlllII,4018,1452,69,38,107,64.5%,25m
3189,1,Blowtorch,4018,326,7,13,20,35.0%,28m
3189,2,JimmyBob,4018,186,5,1,6,83.3%,42m
3189,2,PANTERA,4018,0,1,0,1,100.0%,10m
3189,1,diamond,4018,0,1,1,2,50.0%,34m
3189,1,taegyeom,4018,48,1,5,6,16.7%,40m
3198,1,Pikedastr,4017,2022,125,123,248,50.4%,6m
3198,1,[ValidG]YolBolsun,4017,1138,30,29,59,50.8%,13m
3198,1,laThief,4017,370,8,11,19,42.1%,25m
3198,1,FIGJAM,4017,144,4,2,6,66.7%,20m
3198,1,BigBoner,4017,0,0,1,1,0.0%,33m
3203,1,Koro,4016,1406,46,32,78,59.0%,36m
3203,1,llllllllllll,4016,717,26,14,40,65.0%,13m
3203,1,IIIIIIIIIIII,4016,725,23,15,38,60.5%,20m
3203,1,BabyTerran,4016,197,5,5,10,50.0%,36m
3203,1,[tired]Winter,4016,48,1,3,4,25.0%,21m
3208,1,Cure,4015,574,23,7,30,76.7%,43m
3208,1,FreedomEagle,4015,693,17,22,39,43.6%,33m
3208,3,PokimaneSimp,4015,193,8,2,10,80.0%,6m
3211,1,qqq,4014,48,3,4,7,42.9%,36m
3212,1,llllllllllll,4013,768,19,14,33,57.6%,7m
3212,1,CrazyMadMan,4013,0,0,1,1,0.0%,13m
3214,1,gaucho,4012,1999,409,374,783,52.2%,21m
3214,1,[12WERT]OGFindMuck,4012,1119,114,104,218,52.3%,4m
3214,1,[HPC]MedivacKing,4012,1533,74,71,145,51.0%,30m
3214,1,[Chibii]kwantsUWU,4012,785,20,21,41,48.8%,21m
3214,1,[TGosuC]DeadLyDoSe,4012,46,2,5,7,28.6%,31m
3214,1,WINGs,4012,0,1,1,2,50.0%,28m
3214,1,egg,4012,48,1,2,3,33.3%,6m
3214,1,[INextI]BarónAight,4012,48,1,2,3,33.3%,3m
3214,1,ViKinG,4012,0,0,4,4,0.0%,21m
3214,1,[HECKS]Stealthydog,4012,0,0,7,7,0.0%,35m
3224,1,[3D]TrencH,4011,1996,78,79,157,49.7%,3m
3224,1,ElquinesS,4011,806,37,19,56,66.1%,13m
3224,2,ByuNruim,4011,293,16,3,19,84.2%,21m
3224,1,[LxV]ChibiRobo,4011,94,2,4,6,33.3%,17m
3228,1,[KoopaZ]hollowman,4010,2071,70,77,147,47.6%,43m
3228,1,IIIIIIIIIIII,4010,615,22,10,32,68.8%,7m
3228,1,Hybrid,4010,940,21,31,52,40.4%,26m
3228,2,SpaceBase,4010,206,12,2,14,85.7%,43m
3232,1,[X17]antahoNy,4009,1566,66,48,114,57.9%,28m
3232,1,[PTHero]Vales,4009,617,25,10,35,71.4%,6m
3232,1,Jakobson,4009,145,10,0,10,100.0%,12m
3232,2,[lLiTl]LiquidFluid,4009,0,0,1,1,0.0%,26m
3236,1,[boijwa]hookahmaster,4008,1084,93,103,196,47.4%,39m
3236,1,lllIllIllIIl,4008,1286,56,47,103,54.4%,35m
3236,1,Avgust,4008,142,4,4,8,50.0%,20m
3239,3,[Parkto]LALALA,4007,1063,181,193,374,48.4%,35m
3239,1,[SsaYnS]Garbageman,4007,1205,52,45,97,53.6%,27m
3239,1,MaruWkdWkdao,4007,1104,27,27,54,50.0%,27m
3239,1,TYCHUS,4007,182,5,2,7,71.4%,13m
3239,1,llllllllllll,4007,0,1,0,1,100.0%,43m
3239,1,edge,4007,46,1,1,2,50.0%,7m
3239,1,Freeze,4007,0,0,1,1,0.0%,33m
3246,1,Crocodile,4006,330,7,13,20,35.0%,43m
3246,1,LGA,4006,0,1,0,1,100.0%,7m
3248,1,dahcheat,4005,524,19,9,28,67.9%,6m
3248,1,[PiGPan]Kilkenny,4005,558,16,13,29,55.2%,3m
3250,1,[iNJC]UncleIroh,4004,1725,109,104,213,51.2%,30m
3250,1,ROMA,4004,1156,39,23,62,62.9%,23m
3250,1,Renardastico,4004,446,18,17,35,51.4%,35m
3250,1,Stim,4004,420,11,10,21,52.4%,16m
3250,1,AlexHonnold,4004,0,1,0,1,100.0%,39m
3255,1,[KiMBR]CrOsShAiR,4003,1322,135,128,263,51.3%,6m
3255,1,[GØSU]TomboKai,4003,635,19,9,28,67.9%,26m
3255,3,TossTooEasy,4003,0,1,0,1,100.0%,8m
3255,1,[Ex0n]Montu,4003,0,1,1,2,50.0%,27m
3255,2,lIIIIlllII,4003,0,0,1,1,0.0%,40m
3260,1,[TACOST]Balthier,4002,2051,349,363,712,49.0%,34m
3260,1,[KingSC]MrFrozen,4002,1100,159,155,314,50.6%,17m
3260,1,SunRise,4002,858,20,25,45,44.4%,43m
3260,1,zekimar,4002,48,2,0,2,100.0%,3m
3260,1,IIIIIIllllll,4002,0,0,1,1,0.0%,19m
3260,3,[DirtyP]Wubbey,4002,0,0,4,4,0.0%,24m
3266,3,Vetman,4001,1855,349,346,695,50.2%,5m
3266,1,tslegidowitz,4001,910,42,48,90,46.7%,3m
3268,2,BriaR,4000,354,14,3,17,82.4%,20m
3268,1,[DTokes]TerranTears,4000,234,6,3,9,66.7%,27m
3268,1,[FARMS]claizen,4000,0,1,0,1,100.0%,26m
3268,1,Santi,4000,0,0,1,1,0.0%,32m
3272,1,[SIClan]CAC,3999,1350,144,126,270,53.3%,43m
3272,1,JeiDuH,3999,1872,80,81,161,49.7%,3m
3272,1,[LgnTDS]katuu,3999,1082,35,25,60,58.3%,23m
3272,1,Haven,3999,236,5,8,13,38.5%,26m
3272,1,[S2BTS]Charlotte,3999,48,2,1,3,66.7%,31m
3277,1,Railgun,3998,1375,45,41,86,52.3%,35m
3277,1,Lelouch,3998,535,14,25,39,35.9%,40m
3277,1,[Brober]Shard,3998,94,2,2,4,50.0%,27m
3280,1,Homicide,3997,2005,153,152,305,50.2%,4m
3280,1,[TXOP]SeÑorGuerrA,3997,1345,89,94,183,48.6%,40m
3280,3,GahnJah,3997,30,6,1,7,85.7%,31m
3280,1,XDXD,3997,46,2,1,3,66.7%,25m
3280,1,[BRSKR]Zomby,3997,0,0,1,1,0.0%,19m
3285,1,Microjackson,3996,2095,230,240,470,48.9%,19m
3285,1,MagiC,3996,877,49,48,97,50.5%,13m
3285,1,Hydro,3996,665,43,12,55,78.2%,43m
3285,1,Trickster,3996,420,11,7,18,61.1%,28m
3285,2,IIIIIIIIIIII,3996,150,3,2,5,60.0%,25m
3285,1,Sanji,3996,94,3,3,6,50.0%,28m
3285,3,SgtBadBoomer,3996,30,2,1,3,66.7%,43m
3285,1,[GrIB]ZITFRIT,3996,0,0,2,2,0.0%,26m
3293,1,HJJ,3995,2013,85,77,162,52.5%,23m
3293,1,[Th3Bad]smoke,3995,995,48,34,82,58.5%,26m
3293,1,Lucasdart,3995,124,4,0,4,100.0%,13m
3293,2,[GdAT]Jakdax,3995,0,0,3,3,0.0%,17m
3297,1,[NubTos]MystP,3994,1571,131,113,244,53.7%,20m
3297,1,[213]RedgraZ,3994,1906,65,56,121,53.7%,6m
3297,1,[JaMiT]Vero,3994,804,42,38,80,52.5%,27m
3297,1,[LTK]Redeye,3994,1279,32,28,60,53.3%,31m
3297,1,bigBUTts,3994,143,10,0,10,100.0%,3m
3297,3,IIIIIIIIIIII,3994,192,10,1,11,90.9%,25m
3297,3,BlackEagles,3994,60,2,8,10,20.0%,3m
3304,1,[AD3C]ToXavieR,3993,1014,27,26,53,50.9%,29m
3304,2,HowdyDude,3993,367,17,5,22,77.3%,42m
3304,1,llllllllllll,3993,326,8,5,13,61.5%,35m
3304,1,[ValidG]Warhawk,3993,0,0,4,4,0.0%,14m
3308,1,Barcode,3992,923,41,24,65,63.1%,28m
3308,1,Wilhelm,3992,769,39,34,73,53.4%,34m
3308,1,Merry,3992,534,12,21,33,36.4%,17m
3308,1,llllllllllll,3992,457,10,7,17,58.8%,20m
3308,1,Tohatzu,3992,177,5,7,12,41.7%,29m
3308,1,Kami,3992,0,4,1,5,80.0%,6m
3308,1,gag,3992,0,0,1,1,0.0%,29m
3315,1,[FalNe]opl,3991,1156,55,61,116,47.4%,34m
3316,1,YungCorona,3990,873,30,18,48,62.5%,39m
3316,2,FrOstGiAnT,3990,253,13,3,16,81.2%,8m
3318,1,[AD3C]Asth,3989,2069,323,312,635,50.9%,17m
3318,1,[SV]FErNanDo,3989,1526,44,44,88,50.0%,18m
3318,1,[Cryptc]MaZWaRrIoR,3989,884,21,29,50,42.0%,14m
3318,1,LonGiNuS,3989,137,3,0,3,100.0%,13m
3318,1,llllllllllll,3989,0,0,2,2,0.0%,36m
3323,1,[notCo]Yaddle,3988,472,18,7,25,72.0%,20m
3323,1,Grrrrrrrrrrr,3988,136,3,2,5,60.0%,43m
3323,1,YoursTruly,3988,46,1,1,2,50.0%,40m
3323,1,[GnR]Cactusman,3988,0,0,3,3,0.0%,35m
3327,1,[BoRnGo]Fara,3987,1997,152,140,292,52.1%,3m
3327,1,[ZANY]AlprozoMAN,3987,1845,104,101,205,50.7%,18m
3327,1,[UpeV]SrPipeneisho,3987,368,9,9,18,50.0%,4m
3327,1,rookywu,3987,182,4,0,4,100.0%,13m
3327,1,[ViP3R]BlueLabel,3987,180,4,10,14,28.6%,14m
3327,1,[AoTu]King,3987,0,1,0,1,100.0%,14m
3327,1,[Pobie]Swanson,3987,0,0,1,1,0.0%,21m
3334,1,Cris,3986,2037,140,145,285,49.1%,29m
3334,1,[TILL]uncriss,3986,1093,42,35,77,54.5%,21m
3334,1,[2qq]OooLaLa,3986,0,0,1,1,0.0%,39m
3334,1,[CrnKy]Daunted,3986,0,0,1,1,0.0%,31m
3338,1,Kulerio,3985,522,50,35,85,58.8%,20m
3338,1,Errection,3985,1610,49,43,92,53.3%,20m
3338,1,IIllIlIIllII,3985,700,25,12,37,67.6%,23m
3338,2,Bulugulu,3985,399,18,6,24,75.0%,8m
3342,1,[Aika2]RhombusRhino,3984,1623,44,46,90,48.9%,29m
3342,1,[xGenGx]Galaxy,3984,581,14,10,24,58.3%,37m
3342,1,Simz,3984,0,0,1,1,0.0%,43m
3342,2,[eSun]Ciel,3984,0,0,3,3,0.0%,18m
3346,1,Jams,3983,335,12,4,16,75.0%,29m
3346,1,OneManArmy,3983,48,2,1,3,66.7%,6m
3348,1,[Globe]Kan,3982,1504,78,67,145,53.8%,26m
3348,1,[OIGE]ghost,3982,1056,33,40,73,45.2%,18m
3348,1,Nyun,3982,138,10,0,10,100.0%,12m
3348,1,[MtS]Shark,3982,322,9,13,22,40.9%,13m
3348,1,[mocat]Shadow,3982,48,2,2,4,50.0%,33m
3348,1,[AgK]BAEM,3982,0,0,1,1,0.0%,28m
3348,1,[DarkAG]Ace,3982,0,0,2,2,0.0%,29m
3355,1,setharrow,3981,1661,72,75,147,49.0%,33m
3355,1,IIIIIIIIII,3981,627,20,11,31,64.5%,28m
3355,1,[xTQc]sikens,3981,92,3,0,3,100.0%,27m
3355,1,[EvilGC]ZpectroX,3981,0,1,0,1,100.0%,33m
3355,1,[GUCCl]BAAZOOOMINEE,3981,0,1,0,1,100.0%,13m
3360,1,Blu,3980,2039,168,156,324,51.9%,13m
3360,1,[F0cus]dozer,3980,1402,54,49,103,52.4%,27m
3360,1,JarJarBinks,3980,0,1,0,1,100.0%,26m
3360,1,MariahCarry,3980,0,0,3,3,0.0%,26m
3364,1,Kronk,3979,1307,102,96,198,51.5%,4m
3364,3,[HI420]WOLF,3979,531,26,33,59,44.1%,26m
3364,1,IIIIIIIIIIII,3979,875,23,21,44,52.3%,14m
3364,1,ateapotist,3979,234,9,12,21,42.9%,13m
3364,1,[BLMBLM]Justice,3979,282,7,16,23,30.4%,27m
3364,1,ReynorSCII,3979,142,3,2,5,60.0%,27m
3364,1,Phattyasmo,3979,0,0,2,2,0.0%,39m
3364,1,kkiatho,3979,0,0,3,3,0.0%,13m
3372,1,[NovaX]HJM,3978,1899,73,86,159,45.9%,13m
3372,1,[SocDis]IlIlllIlllII,3978,592,44,0,44,100.0%,12m
3372,1,[AIways]NumberOne,3978,885,29,20,49,59.2%,6m
3372,1,YouMadBro,3978,418,14,9,23,60.9%,12m
3372,1,[cl0udM]ZanitY,3978,340,8,5,13,61.5%,33m
3372,1,[NrFms]ReasoN,3978,240,5,14,19,26.3%,26m
3372,1,ReDeYe,3978,0,0,1,1,0.0%,28m
3372,2,CookieWizard,3978,0,0,2,2,0.0%,15m
3380,1,[lASUl]Cavalieri,3977,0,1,5,6,16.7%,17m
3380,1,WindowsXD,3977,0,0,5,5,0.0%,23m
3382,1,[OGbros]GypsyQueen,3976,632,18,15,33,54.5%,28m
3382,1,[GØSU]SkyWalkeR,3976,589,14,11,25,56.0%,27m
3382,1,ENIAC,3976,450,10,12,22,45.5%,16m
3382,1,[UpxV]sebastian,3976,239,9,4,13,69.2%,6m
3386,1,[TSØP]dante,3975,1437,46,38,84,54.8%,14m
3386,1,[RBTH]LokiSaurioEs,3975,801,20,15,35,57.1%,33m
3386,1,Bloodbank,3975,48,1,7,8,12.5%,25m
3386,1,[LilHo]tehdoctor,3975,0,0,1,1,0.0%,27m
3390,1,moki,3974,1498,92,72,164,56.1%,8m
3390,1,[T1T5]MarineQueen,3974,1164,31,26,57,54.4%,28m
3390,1,Sarkan,3974,626,25,11,36,69.4%,35m
3390,1,DerFickerr,3974,414,22,6,28,78.6%,26m
3390,1,ScumBag,3974,872,21,19,40,52.5%,31m
3390,1,BobRoss,3974,692,16,30,46,34.8%,13m
3390,1,SIDINHO,3974,376,8,23,31,25.8%,20m
3390,1,sugarbiscuit,3974,186,5,2,7,71.4%,18m
3390,1,[AlIin]NineK,3974,92,2,5,7,28.6%,14m
3399,1,[Ssip]YUuKi,3973,455,21,7,28,75.0%,32m
3399,1,[SsaYnS]Caloreen,3973,582,18,11,29,62.1%,20m
3399,2,lIlllIlIlIll,3973,364,17,6,23,73.9%,40m
3399,1,[lLiTl]KingVulture,3973,140,4,2,6,66.7%,12m
3399,1,Evenstar,3973,90,3,3,6,50.0%,13m
3399,1,Arcane,3973,48,1,7,8,12.5%,31m
3399,3,TheRex,3973,0,0,1,1,0.0%,31m
3406,1,llllllllllll,3972,1612,85,90,175,48.6%,30m
3406,1,MilkyWay,3972,452,20,9,29,69.0%,17m
3406,1,TPRobinhood,3972,547,15,8,23,65.2%,28m
3406,1,[nolotv]iHateLotV,3972,388,12,6,18,66.7%,11m
3406,2,IIIIIIIIIIII,3972,116,4,1,5,80.0%,40m
3406,1,Gsix,3972,0,1,0,1,100.0%,28m
3412,1,Tetsuo,3971,1985,259,247,506,51.2%,26m
3412,1,Trash,3971,2015,219,219,438,50.0%,8m
3412,1,[Stell]ENDER,3971,1339,72,89,161,44.7%,37m
3412,2,[EZPTS]talisman,3971,412,19,5,24,79.2%,13m
3412,1,[CRAKS]stats,3971,172,5,1,6,83.3%,20m
3412,1,[SPINGC]Feyd,3971,0,1,0,1,100.0%,33m
3412,1,modest,3971,46,1,4,5,20.0%,28m
3412,1,Hasjarl,3971,0,0,1,1,0.0%,16m
3420,1,[STB]Ghost,3970,2050,348,351,699,49.8%,30m
3420,1,[SsaYnS]HEAVYMETAL,3970,1980,89,99,188,47.3%,29m
3420,1,[cloudM]playerknight,3970,140,4,4,8,50.0%,40m
3420,1,[Lp]NoXeR,3970,92,2,4,6,33.3%,35m
3420,1,ImaGinE,3970,0,1,1,2,50.0%,24m
3420,1,RockAndRoll,3970,0,0,1,1,0.0%,36m
3426,1,[xMDx]Bezerk,3969,1564,69,52,121,57.0%,12m
3426,1,BERSERK,3969,1176,29,31,60,48.3%,6m
3426,1,DVB,3969,806,21,22,43,48.8%,18m
3426,1,[Æ420]LunatiC,3969,186,5,5,10,50.0%,27m
3430,1,[YD2K]mikeho,3968,1893,371,379,750,49.5%,12m
3430,1,[PTHero]lovegames,3968,2059,168,184,352,47.7%,25m
3430,1,[ØÛ]SanDeR,3968,408,24,16,40,60.0%,16m
3430,1,[hTx]Squid,3968,0,1,0,1,100.0%,4m
3430,1,Lyuganok,3968,48,1,2,3,33.3%,24m
3430,3,Koloss,3968,0,0,1,1,0.0%,33m
3436,1,[ulost]NVC,3967,1690,76,72,148,51.4%,28m
3436,1,[Smart]sentiNeL,3967,1220,31,33,64,48.4%,28m
3436,1,ANnihilatioN,3967,519,14,10,24,58.3%,26m
3436,1,TheDoorMan,3967,210,12,0,12,100.0%,33m
3436,1,[CRAKS]FarmerPoopy,3967,96,2,4,6,33.3%,6m
3436,1,Pandaiga,3967,0,1,0,1,100.0%,4m
3442,1,Bullgom,3966,1373,80,54,134,59.7%,19m
3442,1,Sisifo,3966,1038,45,30,75,60.0%,12m
3442,1,NILETTO,3966,848,36,19,55,65.5%,43m
3442,1,ChiboloMeepo,3966,1236,32,34,66,48.5%,28m
3442,1,[Y0shi]Determined,3966,0,0,1,1,0.0%,35m
3447,1,IIIIIIIIIIII,3965,1855,179,178,357,50.1%,26m
3447,1,[αXLa]iPencil,3965,956,33,27,60,55.0%,12m
3447,1,[07657]RainbowYosh,3965,1142,33,37,70,47.1%,20m
3447,1,DouyuTVFTD,3965,186,6,1,7,85.7%,39m
3451,3,[ValidG]Kwas,3964,1411,112,130,242,46.3%,21m
3451,1,LoveLess,3964,558,13,30,43,30.2%,12m
3451,1,TerranDisco,3964,0,1,0,1,100.0%,12m
3451,1,Conut,3964,46,1,1,2,50.0%,27m
3455,1,KORllllll,3963,751,61,28,89,68.5%,27m
3455,1,tryhard,3963,846,20,27,47,42.6%,43m
3455,1,Bluesader,3963,330,8,17,25,32.0%,24m
3458,1,[LTB666]MrSpin,3962,2026,193,178,371,52.0%,24m
3458,1,Lowko,3962,1799,75,54,129,58.1%,39m
3458,1,IiXxXiI,3962,1271,61,33,94,64.9%,37m
3458,1,Largo,3962,738,19,18,37,51.4%,17m
3458,1,SuperChoque,3962,138,2,2,4,50.0%,14m
3458,1,[Cind3r]NoMercy,3962,0,1,0,1,100.0%,34m
3458,1,Chadry,3962,48,1,2,3,33.3%,4m
3465,1,[eSun]Dibblz,3961,2036,164,178,342,48.0%,37m
3465,1,[EZDUNK]CEoGTX,3961,1268,46,59,105,43.8%,39m
3465,1,[QcSuB]Joker,3961,569,18,10,28,64.3%,17m
3465,2,Deceiver,3961,296,15,2,17,88.2%,43m
3465,1,lIlIlIlIlIlI,3961,440,10,9,19,52.6%,25m
3465,1,veryvery,3961,134,7,1,8,87.5%,36m
3465,1,[WaIl]Chriso,3961,0,0,1,1,0.0%,28m
3472,1,[BACK2R]IamNotByun,3960,318,6,6,12,50.0%,21m
3472,1,Alpha,3960,0,0,1,1,0.0%,16m
3472,1,Dark,3960,0,0,3,3,0.0%,31m
3475,1,Darrenc,3959,2037,63,72,135,46.7%,25m
3475,1,jetblackMGX,3959,982,39,37,76,51.3%,43m
3475,1,HesiHeyyyy,3959,841,33,18,51,64.7%,13m
3475,1,Radek,3959,389,20,5,25,80.0%,28m
3475,1,DeathMarine,3959,360,9,5,14,64.3%,29m
3475,1,[PSISTM]ZeRgWaVe,3959,274,7,12,19,36.8%,32m
3475,1,[Emb3rs]Dragonskin,3959,46,1,2,3,33.3%,31m
3475,1,[Eylin]Estefania,3959,48,1,7,8,12.5%,29m
3483,1,iRLFayTz,3958,498,12,8,20,60.0%,43m
3484,1,[Toker]PuffSwishers,3957,1665,89,98,187,47.6%,30m
3484,1,[HØST]Kiloliuton,3957,1598,58,63,121,47.9%,12m
3484,1,FLawLesS,3957,985,52,59,111,46.8%,43m
3484,1,[ZTemps]phiL,3957,549,28,16,44,63.6%,17m
3484,1,Strker,3957,370,16,6,22,72.7%,3m
3484,2,Maru,3957,116,4,2,6,66.7%,23m
3484,1,[YD2K]yuChoR,3957,44,1,1,2,50.0%,43m
3484,3,Coronavirus,3957,0,0,1,1,0.0%,7m
3492,1,[IMDSI]Kirigãya,3956,2052,154,161,315,48.9%,20m
3492,1,[ZTempz]Nova,3956,1047,66,64,130,50.8%,14m
3492,1,hummusai,3956,811,23,19,42,54.8%,26m
3492,3,Glück,3956,240,12,1,13,92.3%,10m
3492,1,hahagotem,3956,0,1,0,1,100.0%,26m
3497,1,[EvilGC]GothicGhost,3955,93,2,0,2,100.0%,12m
3497,1,soOphir,3955,0,1,0,1,100.0%,24m
3499,1,[MirG]PuGGy,3954,1512,251,231,482,52.1%,6m
3499,1,snowstorm,3954,1992,195,166,361,54.0%,19m
3499,1,[MRU]JasonU,3954,1404,92,83,175,52.6%,3m
3499,1,[Z0HR]MacroZerg,3954,811,24,20,44,54.5%,24m
3499,1,CautioN,3954,203,19,9,28,67.9%,27m
3499,1,[TAsc]ToSsGirL,3954,614,15,16,31,48.4%,40m
3499,1,JCrossover,3954,159,5,2,7,71.4%,28m
3499,1,GreatRaging,3954,92,2,5,7,28.6%,39m
3499,1,Booger,3954,48,1,3,4,25.0%,24m
3499,3,[xFear]Khaos,3954,0,0,2,2,0.0%,38m
3499,1,HaloWarsDude,3954,0,0,6,6,0.0%,33m
3510,1,Grin,3953,1701,119,95,214,55.6%,31m
3510,1,eZCapeEvil,3953,1097,106,80,186,57.0%,27m
3510,1,Bruno,3953,377,12,14,26,46.2%,3m
3510,1,sswhosu,3953,0,1,3,4,25.0%,17m
3510,3,[cLsSC]BruceLee,3953,0,0,5,5,0.0%,33m
3515,1,Player,3952,791,229,243,472,48.5%,39m
3515,1,[FuFu]KnickKnack,3952,181,7,2,9,77.8%,17m
3515,2,Minong,3952,181,7,8,15,46.7%,34m
3515,1,[W33b4u]Dejablue,3952,148,4,4,8,50.0%,26m
3515,1,kArArArUy,3952,0,0,1,1,0.0%,4m
3520,1,[SsaYnS]iAlwaySGG,3951,2068,156,165,321,48.6%,4m
3520,1,Stopcheesing,3951,1771,89,87,176,50.6%,4m
3520,1,[ClIQ]TranceMuzik,3951,738,26,21,47,55.3%,26m
3520,1,llllllllllll,3951,393,19,6,25,76.0%,28m
3520,2,TwitchGeEm,3951,255,14,4,18,77.8%,3m
3520,1,[FxB]Trumpet,3951,356,8,6,14,57.1%,29m
3520,1,TSWIFT,3951,109,4,1,5,80.0%,40m
3520,1,[EvilCa]Dragonrs,3951,48,2,1,3,66.7%,43m
3520,1,HyperScorpio,3951,91,1,1,2,50.0%,24m
3520,1,Zeus,3951,48,1,4,5,20.0%,27m
3520,1,BigPeet,3951,0,0,3,3,0.0%,13m
3531,1,Therapist,3950,2049,227,238,465,48.8%,33m
3531,3,Motion,3950,1217,168,202,370,45.4%,7m
3531,1,NlgerFoTrump,3950,1384,36,45,81,44.4%,26m
3531,1,[Lp]Hellscream,3950,658,32,16,48,66.7%,12m
3531,1,IIIIIIIII,3950,774,18,19,37,48.6%,33m
3531,1,xilocamp,3950,0,1,0,1,100.0%,4m
3531,3,IIIIIIIIIIII,3950,0,1,0,1,100.0%,29m
3531,1,RociNante,3950,94,1,1,2,50.0%,43m
3539,1,Konfusion,3949,2060,101,116,217,46.5%,37m
3539,1,[Lp]Trululu,3949,1801,87,97,184,47.3%,34m
3539,1,BetterSalt,3949,322,7,10,17,41.2%,4m
3539,1,DonkBacon,3949,126,3,5,8,37.5%,25m
3539,1,Stoland,3949,0,0,1,1,0.0%,29m
3544,1,[EncuIé]proutsodique,3948,495,16,13,29,55.2%,25m
3544,1,[BME]Apollo,3948,280,8,11,19,42.1%,29m
3544,1,Nosferatu,3948,91,2,0,2,100.0%,4m
3544,1,[LoF]KaYroZ,3948,0,1,0,1,100.0%,24m
3544,1,Pillowmaker,3948,92,1,1,2,50.0%,43m
3544,1,SgtBadBoomer,3948,0,0,1,1,0.0%,32m
3550,1,[Lp]theManiX,3947,2043,147,138,285,51.6%,43m
3550,1,AmericoOlO,3947,1172,40,28,68,58.8%,26m
3550,1,leatherhat,3947,92,1,1,2,50.0%,20m
3550,1,[CRAKS]KAUR,3947,0,0,1,1,0.0%,31m
3550,1,[HØST]ManOfOneWay,3947,0,0,2,2,0.0%,20m
3555,1,[CnfOD]CharAznable,3946,2048,160,169,329,48.6%,24m
3555,1,Roberth,3946,1026,51,44,95,53.7%,6m
3555,1,ProxyVoidray,3946,409,24,7,31,77.4%,12m
3555,1,SKM,3946,706,16,19,35,45.7%,37m
3555,1,KilltheVIRUS,3946,270,9,9,18,50.0%,31m
3555,1,VenusaurNINE,3946,374,8,17,25,32.0%,4m
3555,3,MettEagle,3946,171,5,2,7,71.4%,38m
3555,1,ThePhysicist,3946,110,2,1,3,66.7%,24m
3555,1,OKGo,3946,48,1,4,5,20.0%,29m
3555,1,[G0Iden]Fire,3946,0,0,3,3,0.0%,6m
3565,1,IRegret,3945,895,32,20,52,61.5%,43m
3565,2,[ZTemps]Raszagal,3945,298,12,5,17,70.6%,13m
3565,1,[KingSC]IMDaggoth,3945,92,3,7,10,30.0%,39m
3565,1,[NwAs]Tiratuga,3945,0,0,1,1,0.0%,26m
3565,1,fractal,3945,0,0,2,2,0.0%,4m
3565,1,[YMTT]Love,3945,0,0,3,3,0.0%,6m
3571,1,IIIIIIIIIIII,3944,1946,109,112,221,49.3%,28m
3571,1,[xRtG]SpiritOfDice,3944,2008,90,89,179,50.3%,3m
3571,1,Slayer,3944,515,28,10,38,73.7%,13m
3571,1,Leviatán,3944,139,18,10,28,64.3%,14m
3571,1,Protonin,3944,182,5,4,9,55.6%,3m
3571,1,Eulogy,3944,0,1,0,1,100.0%,8m
3571,1,Syncker,3944,0,1,2,3,33.3%,12m
3571,1,Stainless,3944,0,0,2,2,0.0%,20m
3579,1,[DhZPro]Zodte,3943,1382,65,62,127,51.2%,25m
3579,1,IIIIIIIIIIII,3943,607,64,41,105,61.0%,28m
3579,2,PIMBA,3943,324,18,4,22,81.8%,39m
3579,1,jeon,3943,764,17,21,38,44.7%,39m
3579,1,ProtossOP,3943,181,6,3,9,66.7%,4m
3579,1,UwUPimpollo,3943,92,5,1,6,83.3%,28m
3579,1,Bumi,3943,48,2,4,6,33.3%,21m
3579,1,IllIllIlIlII,3943,48,1,5,6,16.7%,33m
3587,1,[eX]Guilheh,3942,1467,62,71,133,46.6%,3m
3587,1,[YUNHAO]Sweet,3942,246,7,4,11,63.6%,25m
3589,1,MicroJackson,3941,328,48,34,82,58.5%,43m
3589,1,HyperGemini,3941,809,45,42,87,51.7%,14m
3589,1,lIlllIIllIII,3941,1210,32,32,64,50.0%,26m
3589,1,Protoss,3941,357,11,9,20,55.0%,43m
3589,1,Calc,3941,113,3,2,5,60.0%,26m
3589,1,[1vsM]acoolguy,3941,94,2,5,7,28.6%,4m
3589,3,glumanda,3941,0,0,2,2,0.0%,3m
3596,1,[yukup]wavedmarques,3940,1039,95,88,183,51.9%,17m
3596,1,YES,3940,1717,88,96,184,47.8%,34m
3596,1,[Lyza]surpassWORLD,3940,1551,71,63,134,53.0%,24m
3596,1,[DarkAG]juanitorl,3940,1724,53,57,110,48.2%,29m
3596,1,uuuuuuuuuuuu,3940,330,14,5,19,73.7%,13m
3596,1,[Ato2]ROKNavy,3940,0,1,5,6,16.7%,8m
3596,1,[KLIMT]Klimrod,3940,46,1,5,6,16.7%,28m
3596,1,[MYDK]Sync,3940,0,0,1,1,0.0%,4m
3596,1,[G0G0G0]IIIIIIIIIIII,3940,0,0,1,1,0.0%,9m
3596,1,tankerzor,3940,0,0,3,3,0.0%,14m
3606,1,Balance,3939,1778,449,440,889,50.5%,35m
3606,1,[EIder]Drift,3939,1325,223,231,454,49.1%,11m
3606,1,XXLPANTS,3939,884,219,204,423,51.8%,35m
3606,1,Uniswap,3939,2033,146,142,288,50.7%,25m
3606,1,Ragnarok,3939,455,55,41,96,57.3%,28m
3606,1,Ayac,3939,873,40,21,61,65.6%,39m
3606,1,MrDeBlarg,3939,613,23,15,38,60.5%,3m
3606,1,[NA7]Enjoy,3939,92,2,3,5,40.0%,39m
3606,1,TonyPerkis,3939,0,0,1,1,0.0%,39m
3615,1,MilkTee,3938,1512,95,48,143,66.4%,12m
3615,1,GenBan,3938,865,45,25,70,64.3%,39m
3615,1,[NPhasA]BalletDump,3938,267,16,4,20,80.0%,13m
3615,1,[CRAKS]TheNewAlarak,3938,170,6,1,7,85.7%,13m
3615,1,JayTeee,3938,230,6,9,15,40.0%,6m
3615,1,[MEXsc]CRONOS,3938,0,0,1,1,0.0%,27m
3615,1,[errDay]Lumpy,3938,0,0,1,1,0.0%,39m
3622,1,[cl0udM]jjoolo,3937,1581,421,382,803,52.4%,43m
3622,1,YELKAO,3937,1678,165,135,300,55.0%,25m
3622,1,Sophie,3937,1538,161,131,292,55.1%,12m
3622,3,[B0N3R]Kino,3937,899,83,98,181,45.9%,21m
3622,1,[UpeV]Cornholio,3937,528,13,13,26,50.0%,13m
3622,1,AinsOoalGown,3937,207,7,3,10,70.0%,3m
3622,1,DarkPlanet,3937,89,2,0,2,100.0%,4m
3622,1,[N0FKz]Cadog,3937,48,2,5,7,28.6%,14m
3630,1,PawnPoker,3936,2014,453,442,895,50.6%,30m
3630,1,[TGCrew]Darkblade,3936,1095,56,58,114,49.1%,18m
3630,2,[DHZ0ne]baratitas,3936,168,9,4,13,69.2%,40m
3630,1,[SCxPH]MfcGuru,3936,138,2,2,4,50.0%,6m
3630,1,[3Z]BLUMPKINg,3936,0,1,0,1,100.0%,4m
3630,1,ZEROBLASTIN,3936,0,0,1,1,0.0%,31m
3636,1,[Cryptc]Beardedsayn,3935,1422,228,227,455,50.1%,12m
3636,1,galactopoulp,3935,978,44,37,81,54.3%,27m
3636,1,[ZTempz]NotNova,3935,379,17,14,31,54.8%,14m
3636,1,PeeKnees,3935,0,1,0,1,100.0%,9m
3636,1,Carlin,3935,0,0,1,1,0.0%,25m
3636,1,Lesile,3935,0,0,1,1,0.0%,29m
3642,3,[LimaSC]IMStarker,3934,1262,107,119,226,47.3%,21m
3642,1,SpamPants,3934,1446,84,53,137,61.3%,12m
3642,1,Jehee,3934,1229,48,34,82,58.5%,31m
3642,1,tankecito,3934,522,43,31,74,58.1%,17m
3642,1,ZaViEr,3934,474,20,17,37,54.1%,29m
3642,1,BluePray,3934,563,19,6,25,76.0%,4m
3642,1,enchantment,3934,226,12,2,14,85.7%,25m
3642,1,[Amb3rs]BluntReality,3934,109,2,1,3,66.7%,26m
3642,1,[OIGE]PaulRock,3934,0,0,1,1,0.0%,26m
3651,1,[UpeV]Jerry,3933,1621,70,68,138,50.7%,17m
3651,1,MacroMan,3933,350,11,6,17,64.7%,4m
3651,1,Moon,3933,130,9,0,9,100.0%,12m
3651,3,TuTiFruTi,3933,167,9,0,9,100.0%,28m
3651,1,[lLiTl]Veryrare,3933,139,3,1,4,75.0%,35m
3651,1,[IMDSI]DoctorGarcía,3933,92,2,1,3,66.7%,29m
3657,1,MBDTF,3932,1292,85,78,163,52.1%,30m
3657,2,BLUEDEVIL,3932,1080,46,27,73,63.0%,41m
3657,1,Graspian,3932,320,7,16,23,30.4%,29m
3657,2,Conan,3932,70,3,0,3,100.0%,19m
3661,1,[SH0]freemaN,3931,1151,43,41,84,51.2%,9m
3661,1,Grisgris,3931,274,7,21,28,25.0%,3m
3661,2,MrGigglez,3931,0,1,0,1,100.0%,10m
3661,2,[FANXY]Elfantome,3931,0,0,1,1,0.0%,5m
3661,3,[lNI]Eldrid,3931,0,0,1,1,0.0%,13m
3661,2,recon,3931,0,0,1,1,0.0%,4m
3661,2,[CUCU]Stank,3931,0,0,1,1,0.0%,39m
3668,1,[UpeV]blackdead,3930,1913,144,129,273,52.7%,30m
3668,1,Nash,3930,1012,104,88,192,54.2%,31m
3668,1,masterchief,3930,235,43,38,81,53.1%,35m
3668,1,[mYogum]Oppaya,3930,201,4,4,8,50.0%,9m
3668,1,[HBLM]Cprice,3930,46,1,3,4,25.0%,43m
3668,1,WLR,3930,48,1,5,6,16.7%,8m
3674,1,UbkbPeng,3929,558,28,25,53,52.8%,11m
3674,1,Venser,3929,344,25,16,41,61.0%,9m
3674,1,Poleman,3929,328,13,7,20,65.0%,24m
3674,2,moonlightOuO,3929,44,2,2,4,50.0%,18m
3674,1,[DhZPro]Macaxeira,3929,0,1,2,3,33.3%,28m
3679,1,Melbourne,3928,2003,264,261,525,50.3%,4m
3679,1,Symvi,3928,1591,61,67,128,47.7%,27m
3679,1,[Nanjol]Yoshino,3928,437,17,9,26,65.4%,25m
3679,1,Kristo,3928,239,11,1,12,91.7%,39m
3679,1,[lNI]GeNiuS,3928,362,8,11,19,42.1%,31m
3679,1,[PROB]ArianaGrande,3928,48,2,2,4,50.0%,28m
3679,1,Cruncharoo,3928,0,0,2,2,0.0%,8m
3686,1,starmuscle,3927,1093,28,35,63,44.4%,12m
3686,1,MicroJackson,3927,313,8,22,30,26.7%,25m
3686,1,ParkBoGeom,3927,140,3,9,12,25.0%,27m
3689,1,Nayeon,3926,1999,146,144,290,50.3%,21m
3689,1,MrZurkon,3926,1995,133,134,267,49.8%,13m
3689,1,DarkWolfdog,3926,1685,128,112,240,53.3%,27m
3689,1,[UpeV]DarkSpear,3926,1809,89,73,162,54.9%,35m
3689,1,llllllll,3926,1584,55,60,115,47.8%,6m
3689,3,NotCleaR,3926,30,1,1,2,50.0%,8m
3695,1,Nemea,3925,1482,110,115,225,48.9%,13m
3695,1,[TTRS]Great,3925,1485,101,107,208,48.6%,34m
3695,1,[SONOW]daken,3925,1592,87,76,163,53.4%,13m
3695,1,[TGosuB]NOMAD,3925,1504,78,89,167,46.7%,13m
3695,2,[1E100]You,3925,346,13,3,16,81.2%,17m
3695,1,Necromortis,3925,203,6,8,14,42.9%,3m
3695,1,[TheCry]SwiftCrane,3925,140,3,8,11,27.3%,39m
3695,1,Sheepy,3925,0,1,1,2,50.0%,4m
3695,2,[Rival]Spagoots,3925,0,0,1,1,0.0%,12m
3704,1,[TAC05]iBeatAlfaStr,3924,2022,487,510,997,48.8%,14m
3704,1,aaa,3924,1113,39,34,73,53.4%,16m
3704,1,Zero,3924,1092,29,34,63,46.0%,26m
3704,2,Mandalorian,3924,214,13,3,16,81.2%,39m
3704,1,dominga,3924,236,6,17,23,26.1%,39m
3709,3,PhoSaurus,3923,1785,206,207,413,49.9%,4m
3709,1,General,3923,1952,146,158,304,48.0%,34m
3709,3,Matsuri,3923,1504,138,138,276,50.0%,18m
3709,1,SFO,3923,1183,73,55,128,57.0%,9m
3709,1,[TUNT]Lagforce,3923,791,59,27,86,68.6%,35m
3709,2,[GDJ]DrunkMaster,3923,312,11,6,17,64.7%,42m
3709,1,llllllllllll,3923,125,2,5,7,28.6%,11m
3709,2,Chad,3923,36,1,2,3,33.3%,39m
3717,1,[InGt]AtomicFather,3922,724,17,19,36,47.2%,11m
3718,1,HungryJ,3921,1939,168,161,329,51.1%,39m
3718,1,[WPIOat]Penguinmage,3921,492,11,16,27,40.7%,29m
3718,3,Hurricane,3921,193,10,1,11,90.9%,30m
3721,1,General,3920,2023,155,151,306,50.7%,3m
3721,2,Snow,3920,848,31,25,56,55.4%,18m
3721,1,Suwushi,3920,598,22,14,36,61.1%,27m
3721,1,nightstar,3920,585,21,10,31,67.7%,12m
3721,1,MacroPlayer,3920,446,10,13,23,43.5%,16m
3721,2,[UpeV]Viciuos,3920,42,2,1,3,66.7%,31m
3727,1,Osprey,3919,1989,309,314,623,49.6%,43m
3727,1,[FMX]Espartano,3919,389,15,8,23,65.2%,13m
3727,1,[BRSKR]ElChefe,3919,0,0,2,2,0.0%,24m
3730,1,[QTclub]wahmenAPM,3918,788,18,20,38,47.4%,19m
3730,2,Maru,3918,0,1,0,1,100.0%,20m
3732,1,Daddy,3917,1864,113,104,217,52.1%,27m
3732,1,[LOTTE]speaknow,3917,260,15,9,24,62.5%,31m
3732,1,[AITest]Zerg,3917,215,6,3,9,66.7%,31m
3732,2,[CLONEZ]KillerKoala,3917,0,1,0,1,100.0%,24m
3732,1,[CIMKR]Fever,3917,0,0,4,4,0.0%,11m
3737,1,iAmNesTea,3916,2031,130,126,256,50.8%,31m
3737,1,Ghost,3916,849,41,23,64,64.1%,6m
3737,1,COREA,3916,1036,26,26,52,50.0%,13m
3740,1,[iMkS]STLord,3915,2003,161,148,309,52.1%,33m
3740,1,IIIIllIIlllI,3915,2028,125,144,269,46.5%,30m
3740,1,LeQuackz,3915,903,26,32,58,44.8%,35m
3740,1,[KUMS]TickleMiCulo,3915,108,2,2,4,50.0%,29m
3740,2,MeemoSaan,3915,0,1,0,1,100.0%,35m
3740,2,[RLR]happy,3915,0,1,0,1,100.0%,18m
3746,1,gOerilla,3914,1884,314,310,624,50.3%,3m
3746,1,Reaper,3914,762,20,25,45,44.4%,29m
3746,1,[SCNS]MyNameAlice,3914,314,11,7,18,61.1%,16m
3746,2,[X1eHu1]chinchinsuke,3914,0,0,4,4,0.0%,19m
3750,2,[GGBr0]starzzang,3913,1451,63,36,99,63.6%,29m
3750,2,Burger,3913,681,46,30,76,60.5%,39m
3750,1,Teatime,3913,310,13,6,19,68.4%,13m
3750,1,IIIIIIIIIIII,3913,0,1,1,2,50.0%,43m
3754,1,[αB]Mercy,3912,2017,409,424,833,49.1%,3m
3754,1,DamnAmerica,3912,1470,162,166,328,49.4%,40m
3754,1,[Impact]SushiSamurai,3912,1441,54,53,107,50.5%,27m
3754,3,SORRYGUYS,3912,167,9,0,9,100.0%,8m
3758,1,[bouncy]sweetcheeks,3911,2017,92,106,198,46.5%,3m
3758,1,[UpeV]Arrow,3911,403,12,13,25,48.0%,3m
3758,2,Redsand,3911,0,0,1,1,0.0%,7m
3761,1,[EZDUNK]TheEvilOne,3910,764,78,72,150,52.0%,43m
3761,1,[NwAs]LPanda,3910,1186,51,36,87,58.6%,13m
3761,1,LazyTitan,3910,795,33,20,53,62.3%,24m
3761,1,MarineKing,3910,821,28,24,52,53.8%,19m
3761,1,soonsiri,3910,122,4,1,5,80.0%,19m
3761,1,PinoyGamer,3910,176,4,4,8,50.0%,11m
3761,2,Papa,3910,0,1,0,1,100.0%,31m
3761,1,Sayners,3910,0,0,2,2,0.0%,19m
3769,3,Nickatak,3909,1735,544,578,1122,48.5%,18m
3769,1,ender,3909,1771,129,123,252,51.2%,20m
3769,2,MaruFan,3909,168,9,0,9,100.0%,9m
3769,2,radiant,3909,264,9,6,15,60.0%,7m
3769,2,[xSMVx]DOOM,3909,46,2,1,3,66.7%,10m
3769,2,Michael,3909,97,2,4,6,33.3%,22m
3769,1,Lynx,3909,90,2,4,6,33.3%,17m
3769,1,[IMDSI]Funcky,3909,0,1,5,6,16.7%,26m
3777,1,IIIIIIIIIIII,3908,1968,70,64,134,52.2%,31m
3777,1,[SsaYnS]MiolO,3908,1758,68,53,121,56.2%,24m
3777,2,ImABaller,3908,330,12,6,18,66.7%,16m
3777,1,Duphin,3908,96,3,7,10,30.0%,25m
3777,1,Xerox,3908,94,2,15,17,11.8%,19m
3777,1,VonHugenrod,3908,0,1,3,4,25.0%,24m
3783,1,[ZTempz]BetaDre,3907,1978,465,458,923,50.4%,35m
3783,2,Renzokuken,3907,963,124,103,227,54.6%,40m
3783,1,DeChristian,3907,1170,37,36,73,50.7%,25m
3783,1,Computer,3907,860,31,22,53,58.5%,21m
3783,3,Versus,3907,171,9,1,10,90.0%,38m
3783,3,Byun,3907,171,5,2,7,71.4%,22m
3783,1,[SWD325]PrOsperity,3907,92,2,5,7,28.6%,25m
3783,2,BattleCruser,3907,0,0,1,1,0.0%,30m
3791,1,[m8z]radioMS,3906,1563,215,217,432,49.8%,17m
3791,1,Populous,3906,1958,91,102,193,47.2%,3m
3791,2,Azazel,3906,305,15,5,20,75.0%,3m
3791,2,Solace,3906,254,12,2,14,85.7%,41m
3791,1,MechTerran,3906,207,11,1,12,91.7%,8m
3791,2,IIIIIIIIIIII,3906,38,2,0,2,100.0%,13m
3797,1,WinSpren,3905,1969,378,368,746,50.7%,36m
3797,1,[KGH6]Xioeng,3905,1998,282,284,566,49.8%,6m
3797,1,MilkBag,3905,1928,163,181,344,47.4%,14m
3797,2,loit,3905,1704,159,133,292,54.5%,41m
3797,2,Luzensia,3905,279,15,4,19,78.9%,22m
3797,2,Zugg,3905,130,5,1,6,83.3%,40m
3803,1,[420]CuteAznGirl,3904,1991,364,373,737,49.4%,14m
3803,1,ByunFan,3904,770,23,36,59,39.0%,40m
3803,2,[UpeV]Ganjhaman,3904,192,7,1,8,87.5%,7m
3803,1,DneperRisinG,3904,46,1,5,6,16.7%,3m
3807,1,[NPhasA]asheZ,3903,1990,212,227,439,48.3%,13m
3807,1,[Xpk]PaTiMoViL,3903,902,53,41,94,56.4%,21m
3807,2,Ulatec,3903,34,2,1,3,66.7%,21m
3807,2,Zorro,3903,0,0,1,1,0.0%,14m
3807,2,Calista,3903,0,0,1,1,0.0%,41m
3812,1,[SsaYnS]IIIIIIIIIIII,3902,1903,259,254,513,50.5%,25m
3812,1,[XpKAc]FACU,3902,1571,66,67,133,49.6%,17m
3812,1,[OIGE]JFrame,3902,92,2,2,4,50.0%,43m
3812,2,llllllllllll,3902,0,1,1,2,50.0%,16m
3812,1,[Meeoww]Unutuku,3902,46,1,5,6,16.7%,14m
3812,2,TGNPS,3902,0,0,1,1,0.0%,39m
3818,1,bamboo,3901,1829,87,94,181,48.1%,40m
3818,1,IIIIIIIIIIII,3901,874,20,26,46,43.5%,14m
3818,3,[LuNaaa]ShifuMnt,3901,166,9,0,9,100.0%,14m
3818,2,[LHRS]Charlie,3901,72,2,2,4,50.0%,32m
3818,1,[FriGD]HashtagSwag,3901,0,1,2,3,33.3%,13m
3818,1,ZKay,3901,0,1,8,9,11.1%,20m
3818,1,Time,3901,0,0,4,4,0.0%,29m
3825,1,MadMadsen,3900,1992,345,339,684,50.4%,11m
3825,1,[MRCYLS]Zaraki,3900,1972,209,200,409,51.1%,20m
3825,1,[J33W]Usurper,3900,2005,97,118,215,45.1%,31m
3825,3,IIIIIIIIIIII,3900,156,5,0,5,100.0%,23m
3825,2,DawnSnow,3900,0,1,0,1,100.0%,23m
3830,2,sonamoo,3899,532,46,25,71,64.8%,20m
3830,1,[m00tA]Xco,3899,697,18,20,38,47.4%,43m
3830,2,[QUIEEE]Schapel,3899,64,5,3,8,62.5%,39m
3830,2,Acrebitas,3899,0,0,1,1,0.0%,40m
3834,1,[INextI]Pali,3898,94,3,6,9,33.3%,29m
3835,1,[Ris3n]butterfly,3897,1652,132,139,271,48.7%,30m
3835,2,[yGook]TaiwanNoOne,3897,390,16,7,23,69.6%,31m
3835,1,Coronachan,3897,128,4,3,7,57.1%,13m
3835,2,gNat,3897,0,0,1,1,0.0%,32m
3839,1,[Lp]BuDucLp,3896,2016,181,186,367,49.3%,30m
3839,1,[sirW]Fifaterran,3896,1380,74,73,147,50.3%,33m
3839,1,Departure,3896,1574,65,51,116,56.0%,3m
3839,1,[M2A5]Kaiserator,3896,1735,56,61,117,47.9%,30m
3839,1,[INextI]Alecio,3896,1064,45,40,85,52.9%,17m
3839,1,[MyMan]Richard,3896,1284,38,33,71,53.5%,34m
3839,1,Frank,3896,946,36,30,66,54.5%,43m
3839,2,Macedon,3896,0,1,1,2,50.0%,4m
3839,1,Sorrygtg,3896,0,1,2,3,33.3%,20m
3848,1,IIIIIIIIIIII,3895,1245,204,178,382,53.4%,43m
3848,1,Haro,3895,1665,59,58,117,50.4%,14m
3848,1,[fagz]TheBigGay,3895,706,41,29,70,58.6%,26m
3848,2,Ulatec,3895,210,10,8,18,55.6%,37m
3848,1,xelnegro,3895,92,3,13,16,18.8%,30m
3848,2,Sparklehands,3895,38,1,2,3,33.3%,18m
3848,2,Romeo,3895,0,0,1,1,0.0%,24m
3855,1,[ØFoxF2]GiorLian,3894,572,33,43,76,43.4%,37m
3855,2,DefyAncients,3894,359,18,7,25,72.0%,29m
3855,2,[UCI]FrozenFlame,3894,34,2,1,3,66.7%,4m
3855,2,Sgtbeaudry,3894,0,2,3,5,40.0%,9m
3859,1,General,3893,1928,142,146,288,49.3%,34m
3859,1,GrampaBeezos,3893,1596,68,68,136,50.0%,14m
3859,1,[GØSU]zyclon,3893,138,4,9,13,30.8%,25m
3859,2,ItzMeMarco,3893,0,0,1,1,0.0%,6m
3859,2,[TKPL]ChAoss,3893,0,0,1,1,0.0%,29m
3864,2,LegalizePCP,3892,444,16,8,24,66.7%,43m
3864,1,[LGNxxx]rendevie,3892,180,4,9,13,30.8%,3m
3864,2,[DETER]JellyKing,3892,0,1,0,1,100.0%,40m
3864,2,[Frnzy]Valentine,3892,0,0,1,1,0.0%,37m
3864,2,[xVIPx]Necrolust,3892,0,0,2,2,0.0%,16m
3869,1,[αX]Dinkleswerve,3891,910,45,64,109,41.3%,25m
3869,2,IlIlIlIlIlIl,3891,94,3,1,4,75.0%,22m
3869,2,ReeAgent,3891,106,3,3,6,50.0%,29m
3869,2,subreality,3891,0,1,0,1,100.0%,13m
3873,1,samaitch,3890,1944,124,117,241,51.5%,34m
3873,2,shromsdaburd,3890,396,17,1,18,94.4%,13m
3873,2,Tossim,3890,118,7,3,10,70.0%,29m
3873,1,gugugu,3890,138,3,6,9,33.3%,37m
3873,1,[FANXY]TheOne,3890,92,2,5,7,28.6%,35m
3873,3,[KiMBR]Brucutu,3890,0,0,1,1,0.0%,20m
3873,2,exXxecutor,3890,0,0,1,1,0.0%,41m
3873,2,[UpeV]Tailon,3890,0,0,2,2,0.0%,7m
3881,1,[WuTang]Satyr,3889,2000,368,375,743,49.5%,14m
3881,2,Tread,3889,568,22,15,37,59.5%,4m
3881,2,Quarantine,3889,222,8,3,11,72.7%,15m
3881,1,lllllllIIIII,3889,380,8,23,31,25.8%,28m
3881,1,iTrululu,3889,134,4,4,8,50.0%,29m
3881,2,DeGaulle,3889,132,3,1,4,75.0%,18m
3881,1,Edgard,3889,0,0,3,3,0.0%,32m
3888,1,Schmieds,3888,1782,186,156,342,54.4%,8m
3888,2,AvernOLyX,3888,520,21,7,28,75.0%,20m
3890,2,Olty,3887,287,14,6,20,70.0%,43m
3890,2,TTTTTTTTT,3887,190,10,1,11,90.9%,42m
3890,1,[N8D]PandaExpress,3887,416,9,14,23,39.1%,34m
3890,1,Rhaegal,3887,184,4,12,16,25.0%,43m
3890,2,[SuperZ]strength,3887,38,2,0,2,100.0%,24m
3890,2,MartyMcFly,3887,0,1,0,1,100.0%,28m
3890,2,[TUED]Arourou,3887,0,0,1,1,0.0%,39m
3890,2,SneakyTurtle,3887,0,0,1,1,0.0%,41m
3898,2,PhatCat,3886,1688,221,191,412,53.6%,22m
3898,1,OldGuy,3886,2012,180,185,365,49.3%,39m
3898,1,feederkhan,3886,1514,159,160,319,49.8%,20m
3898,1,lampshade,3886,1631,123,114,237,51.9%,12m
3898,1,GuZrCn,3886,1620,109,96,205,53.2%,43m
3898,1,[TGosuD]Lightborn,3886,931,30,26,56,53.6%,28m
3898,1,ddssan,3886,829,20,21,41,48.8%,20m
3905,2,HotS,3885,238,6,11,17,35.3%,23m
3905,1,[MIT]Nik,3885,232,6,14,20,30.0%,30m
3905,2,[GrnBrd]ryzo,3885,132,4,2,6,66.7%,31m
3905,1,illmatiC,3885,91,2,3,5,40.0%,28m
3905,2,[SuperZ]DeanCain,3885,68,2,3,5,40.0%,22m
3905,1,dejii,3885,46,2,5,7,28.6%,30m
3905,2,[Thorin]OaknShield,3885,0,0,1,1,0.0%,32m
3912,2,ILoveHaters,3884,1182,118,110,228,51.8%,11m
3912,2,[Pyr3s]maurice,3884,0,0,2,2,0.0%,13m
3912,1,[Fals3E]PatchNorris,3884,0,0,4,4,0.0%,26m
3915,1,[AiMB]Juglare,3883,1976,233,217,450,51.8%,24m
3915,1,[Kaii]Hobby,3883,1922,128,121,249,51.4%,35m
3915,2,NoScared,3883,710,45,15,60,75.0%,17m
3915,1,[TeamUR]MuleKing,3883,1040,38,49,87,43.7%,27m
3915,1,[GanGan]IdentitY,3883,568,20,17,37,54.1%,39m
3915,1,[DhZAc1]RockyCoRe,3883,508,12,26,38,31.6%,25m
3915,2,Tual,3883,208,7,2,9,77.8%,34m
3915,3,AlcoMarine,3883,97,5,1,6,83.3%,28m
3915,1,Ryan,3883,224,5,9,14,35.7%,9m
3915,2,Angus,3883,72,3,0,3,100.0%,29m
3925,1,[RedSup]aaronru,3882,1965,543,539,1082,50.2%,32m
3925,1,[ØFoxF2]Maher,3882,1938,88,92,180,48.9%,25m
3925,1,Growatt,3882,334,17,5,22,77.3%,36m
3925,2,Aerials,3882,0,0,1,1,0.0%,13m
3925,2,HwaSin,3882,0,0,1,1,0.0%,41m
3930,1,TheArtOfWar,3881,1774,316,333,649,48.7%,31m
3930,2,[XLNT]NovaStrike,3881,450,17,8,25,68.0%,37m
3930,1,hairball,3881,226,5,5,10,50.0%,21m
3930,2,[StaRed]Tulkas,3881,98,4,3,7,57.1%,15m
3930,2,JiMnY,3881,38,1,1,2,50.0%,24m
3930,2,Trion,3881,0,0,2,2,0.0%,17m
3936,1,[GumZ]NatroNix,3880,1933,188,192,380,49.5%,40m
3936,3,Gavibear,3880,261,13,3,16,81.2%,39m
3936,1,dryou,3880,174,11,2,13,84.6%,13m
3936,2,TufiMeme,3880,338,11,11,22,50.0%,17m
3936,2,bobinski,3880,270,9,3,12,75.0%,39m
3936,1,IIIIIIIIIIII,3880,396,9,11,20,45.0%,32m
3936,1,[R4VE]Emeriki,3880,138,3,10,13,23.1%,19m
3936,3,[VEGANA]sail,3880,0,1,0,1,100.0%,40m
3936,2,[PSISTM]Freeedom,3880,0,0,1,1,0.0%,26m
3936,2,[SaberX]NoSpecChar,3880,0,0,1,1,0.0%,35m
3936,3,Free,3880,0,0,2,2,0.0%,17m
3947,1,Bob,3879,1938,107,109,216,49.5%,5m
3947,1,[ShowMe]EunKyo,3879,1357,56,55,111,50.5%,28m
3947,1,KiRuZ,3879,591,28,35,63,44.4%,13m
3947,2,IIIIIIIIIIII,3879,0,1,0,1,100.0%,10m
3951,1,purpleheart,3878,1966,63,67,130,48.5%,20m
3951,1,[Lp]gatoloco,3878,1325,43,45,88,48.9%,24m
3951,1,Yora,3878,1093,39,36,75,52.0%,28m
3951,2,Boreau,3878,914,33,29,62,53.2%,16m
3951,2,[TPGGXD]Kilpinga,3878,914,32,31,63,50.8%,24m
3951,1,Heisenberg,3878,286,12,8,20,60.0%,8m
3951,2,POWER,3878,200,6,8,14,42.9%,26m
3958,1,cucsca,3877,1499,224,227,451,49.7%,4m
3958,1,[cl0udM]Doodsmack,3877,973,28,28,56,50.0%,8m
3958,2,XVIII,3877,338,10,6,16,62.5%,26m
3958,2,[UFL]Havoc,3877,32,1,2,3,33.3%,22m
3962,1,[sucit]ZeZeBear,3876,1371,262,245,507,51.7%,28m
3962,1,srsqtee,3876,1333,93,85,178,52.2%,43m
3962,1,[Di3N1g]PuppyOfJust,3876,1065,36,46,82,43.9%,13m
3962,1,Karolyn,3876,794,18,33,51,35.3%,40m
3962,1,Danny,3876,506,12,18,30,40.0%,39m
3967,1,VictoryX,3875,1975,307,311,618,49.7%,19m
3967,1,MosesHooves,3875,1950,80,68,148,54.1%,30m
3967,2,[xTQc]AziaQc,3875,1486,61,46,107,57.0%,4m
3967,2,[Sc2F]TTT,3875,927,58,52,110,52.7%,22m
3967,2,Laracroft,3875,216,11,1,12,91.7%,18m
3967,2,Novacaine,3875,200,11,2,13,84.6%,40m
3967,3,Dhako,3875,187,10,1,11,90.9%,8m
3967,3,Aethereal,3875,114,5,2,7,71.4%,3m
3967,2,[iDrunk]llllllIIIIIl,3875,110,4,3,7,57.1%,20m
3967,2,[CTsix]BeardPapa,3875,34,2,2,4,50.0%,41m
3967,2,Goofball,3875,34,1,2,3,33.3%,11m
3978,1,PingPang,3874,1893,74,81,155,47.7%,13m
3978,1,[DIKOUT]cowSPHERE,3874,756,17,30,47,36.2%,9m
3978,2,GooD,3874,32,1,1,2,50.0%,18m
3978,1,Rebellion,3874,95,1,3,4,25.0%,28m
3982,1,llllllllllll,3873,1890,339,324,663,51.1%,30m
3982,2,[LTWS]Crisis,3873,1666,77,81,158,48.7%,7m
3982,2,[RUMB]ÖrjanVilma,3873,504,17,14,31,54.8%,31m
3982,1,FartinG,3873,653,16,20,36,44.4%,34m
3982,2,Leeplayer,3873,0,1,0,1,100.0%,26m
3982,2,[Zweie]MiSa,3873,0,1,0,1,100.0%,10m
3988,1,romavictoria,3872,1955,240,236,476,50.4%,32m
3988,2,ExAmple,3872,628,27,13,40,67.5%,10m
3988,2,[MNG]TsogiMaster,3872,326,15,4,19,78.9%,10m
3988,2,GLaDOS,3872,70,2,5,7,28.6%,17m
3988,2,IIIIIIIIIIII,3872,0,1,0,1,100.0%,12m
3993,1,[Xpk]kachaviejas,3871,1885,144,109,253,56.9%,3m
3993,1,HBOL,3871,1076,77,63,140,55.0%,24m
3993,1,WaterDemon,3871,705,24,17,41,58.5%,8m
3993,2,PartyWater,3871,501,23,9,32,71.9%,12m
3993,1,[VSOU]Crass,3871,886,21,32,53,39.6%,14m
3993,1,FinalBoss,3871,653,17,21,38,44.7%,4m
3993,2,Midge,3871,348,13,8,21,61.9%,10m
3993,2,eXeSilver,3871,0,0,2,2,0.0%,19m
4001,1,PCprincipal,3870,781,60,45,105,57.1%,43m
4001,2,kakaru,3870,1013,49,16,65,75.4%,19m
4001,2,Marine,3870,741,47,32,79,59.5%,22m
4001,2,Rachael,3870,786,44,33,77,57.1%,43m
4001,2,[AaW]Tobyas,3870,377,17,7,24,70.8%,16m
4001,3,SkyCola,3870,171,9,2,11,81.8%,35m
4001,2,[Shrek5]HanniibAL,3870,36,2,1,3,66.7%,34m
4001,3,[Xpk]LoliHero,3870,0,0,3,3,0.0%,3m
4009,1,Erlidd,3869,1543,73,80,153,47.7%,13m
4009,2,thePimpoyo,3869,1088,44,33,77,57.1%,26m
4009,2,[WECRKT]StonkLord,3869,744,27,22,49,55.1%,13m
4009,1,[LEGROS]BIG,3869,392,9,14,23,39.1%,17m
4009,1,MiKa,3869,366,8,13,21,38.1%,22m
4009,2,TerranHard,3869,114,4,2,6,66.7%,20m
4009,2,Nexxie,3869,128,4,5,9,44.4%,22m
4016,1,[DarkAG]Terranitup,3868,1968,212,218,430,49.3%,13m
4016,1,XenoMorphKai,3868,1619,97,99,196,49.5%,3m
4016,1,MacroKing,3868,1658,89,61,150,59.3%,24m
4016,2,Syocto,3868,1408,56,53,109,51.4%,43m
4016,2,[LowIQ]Fergus,3868,858,32,24,56,57.1%,9m
4016,2,mEtRo,3868,314,15,5,20,75.0%,21m
4016,2,[Ech0s]Forge,3868,70,2,4,6,33.3%,32m
4016,2,Jasper,3868,0,0,1,1,0.0%,31m
4024,2,Stramtheman,3867,1692,133,123,256,52.0%,24m
4024,2,IIIIIIIIIIII,3867,1523,99,75,174,56.9%,42m
4024,2,billybob,3867,0,0,1,1,0.0%,26m
4027,2,[TRTR]Deas,3866,1603,98,92,190,51.6%,17m
4027,2,Boolone,3866,1102,53,43,96,55.2%,13m
4027,2,[GGu2EZ]HeReTiC,3866,227,9,5,14,64.3%,17m
4027,1,[KingSC]TheWolF,3866,158,5,7,12,41.7%,37m
4027,2,lIlIlI,3866,102,3,0,3,100.0%,37m
4027,2,[RlSKE]Necroshader,3866,0,0,1,1,0.0%,27m
4027,2,AppleTV,3866,0,0,1,1,0.0%,17m
4027,2,llllllllllll,3866,0,0,2,2,0.0%,37m
4027,2,Waves,3866,0,0,2,2,0.0%,5m
4036,1,MaZWaRrIoR,3865,1639,62,52,114,54.4%,27m
4036,2,TerranBoi,3865,479,23,8,31,74.2%,10m
4036,2,Victor,3865,0,1,1,2,50.0%,12m
4036,2,daybreak,3865,0,1,2,3,33.3%,29m
4040,1,[SsaYnS]CMStormPolt,3864,808,488,472,960,50.8%,4m
4040,1,OBCD,3864,1948,138,132,270,51.1%,33m
4040,2,ENaSSaJJaGa,3864,1245,53,32,85,62.4%,5m
4040,2,[Lp]NoXeRnK,3864,128,4,7,11,36.4%,16m
4040,2,NoFear,3864,36,2,2,4,50.0%,24m
4040,2,llllllllllll,3864,0,1,2,3,33.3%,11m
4040,2,[SSoSS]HzO,3864,0,0,1,1,0.0%,15m
4047,1,MorganzZz,3863,481,31,29,60,51.7%,30m
4047,1,MaHe,3863,741,28,32,60,46.7%,43m
4047,1,ProtossOP,3863,514,22,14,36,61.1%,25m
4047,1,ForExAmple,3863,393,19,8,27,70.4%,40m
4047,1,[EZDUNK]OKBoomer,3863,394,9,14,23,39.1%,14m
4047,2,[FxB]DaleJR,3863,0,1,0,1,100.0%,18m
4047,2,[EXECP]WOLF,3863,0,0,1,1,0.0%,29m
4047,1,SCVUser,3863,0,0,11,11,0.0%,25m
4055,1,NoobPro,3862,1968,239,243,482,49.6%,19m
4055,2,[GrnBay]Duncan,3862,936,71,53,124,57.3%,28m
4055,1,[TGosuA]BaldEagle,3862,1241,63,62,125,50.4%,28m
4055,2,Huntthequest,3862,106,3,5,8,37.5%,5m
4055,2,[WaIl]Caesar,3862,0,0,1,1,0.0%,8m
4060,1,tingeltangel,3861,1622,376,379,755,49.8%,25m
4060,1,Elkone,3861,2000,183,170,353,51.8%,6m
4060,1,Computer,3861,1700,49,59,108,45.4%,6m
4060,2,Jeremy,3861,525,29,9,38,76.3%,43m
4060,2,Architorture,3861,366,15,13,28,53.6%,18m
4060,2,llllllllllll,3861,0,0,1,1,0.0%,24m
4060,2,[scvffs]Hepzibah,3861,0,0,1,1,0.0%,31m
4067,1,Comineinter,3860,1961,436,430,866,50.3%,43m
4067,2,[αB]AZAZEL,3860,519,20,12,32,62.5%,20m
4067,3,RuNnGuN,3860,97,1,1,2,50.0%,16m
4067,2,Somnolent,3860,0,0,1,1,0.0%,40m
4067,2,AluKarD,3860,0,0,2,2,0.0%,39m
4072,2,Deadpool,3859,1426,51,50,101,50.5%,43m
4072,1,[2fps]Secret,3859,809,34,26,60,56.7%,17m
4072,2,[ValidG]Ins,3859,838,30,28,58,51.7%,22m
4072,2,yeunk,3859,754,27,24,51,52.9%,31m
4072,2,[XpKAc]iShiMuRa,3859,654,24,19,43,55.8%,18m
4072,2,[Xpk]lechuga,3859,606,23,13,36,63.9%,31m
4072,2,[TMGSC]Perfidy,3859,232,9,8,17,52.9%,23m
4072,2,[AdaptG]Ecchi,3859,0,1,0,1,100.0%,41m
4072,2,TheLaw,3859,0,0,1,1,0.0%,13m
4081,1,TheBorg,3858,1940,102,99,201,50.7%,33m
4081,2,NOrEselecT,3858,1096,99,49,148,66.9%,7m
4081,2,Abstract,3858,270,9,5,14,64.3%,26m
4081,2,Sponge,3858,250,8,5,13,61.5%,31m
4081,2,forza,3858,76,3,4,7,42.9%,4m
4081,2,llllllllllll,3858,0,0,1,1,0.0%,24m
4087,1,[hTx]BoneZ,3857,1611,75,82,157,47.8%,28m
4087,2,JYL,3857,970,46,38,84,54.8%,31m
4087,2,BoBJoNeZ,3857,244,8,9,17,47.1%,39m
4087,2,Spunky,3857,116,5,1,6,83.3%,4m
4087,2,[sENaTe]beepis,3857,90,3,6,9,33.3%,10m
4087,2,[TheB4d]AsgoRe,3857,0,1,0,1,100.0%,5m
4093,1,peanut,3855,1911,109,109,218,50.0%,14m
4093,2,Termination,3855,966,36,33,69,52.2%,28m
4093,1,[ZTemp]MrMaryJane,3855,567,25,17,42,59.5%,14m
4093,2,[SuperZ]Bruce,3855,123,4,6,10,40.0%,5m
4093,2,chickntender,3855,0,1,0,1,100.0%,29m
4093,2,Gabagool,3855,0,0,1,1,0.0%,34m
4099,2,BraumIRL,3854,202,7,2,9,77.8%,20m
4099,2,Aquas,3854,36,2,1,3,66.7%,19m
4101,2,[NPhasA]Brainwasher,3853,1651,199,181,380,52.4%,42m
4101,1,Cheno,3853,1950,156,144,300,52.0%,11m
4101,1,Jacopana,3853,1861,81,83,164,49.4%,6m
4101,2,[DhZPro]Novais,3853,1263,62,51,113,54.9%,15m
4101,2,Slylandro,3853,830,33,23,56,58.9%,4m
4101,2,[xLiTx]Skeptic,3853,478,22,10,32,68.8%,5m
4101,2,IIIIIIIIIIII,3853,469,19,14,33,57.6%,43m
4101,2,[WXG]Spook,3853,244,9,2,11,81.8%,34m
4101,2,five,3853,220,8,2,10,80.0%,31m
4101,2,[500CC]MiraCle,3853,252,8,6,14,57.1%,32m
4101,3,[CrtCrw]CrazyCritter,3853,219,6,6,12,50.0%,36m
4101,1,Daigoro,3853,92,3,9,12,25.0%,26m
4113,1,zurglinz,3852,1983,244,241,485,50.3%,19m
4113,2,BabyYoda,3852,1441,102,93,195,52.3%,22m
4113,2,[Lp]GatoTapia,3852,1360,83,59,142,58.5%,41m
4113,1,[EtrOy]CptCool,3852,1272,35,37,72,48.6%,16m
4113,1,BOMBARY,3852,446,11,13,24,45.8%,13m
4113,2,[isGG]robotter,3852,104,4,2,6,66.7%,40m
4119,1,[microd]SteezyStims,3851,1948,243,242,485,50.1%,11m
4119,1,OwNaGeForce,3851,1672,85,90,175,48.6%,27m
4119,2,Meditor,3851,1593,84,73,157,53.5%,34m
4119,2,GameImba,3851,448,16,12,28,57.1%,19m
4119,2,[FL]SimpShady,3851,434,14,14,28,50.0%,18m
4119,2,NoMercy,3851,0,1,0,1,100.0%,24m
4119,2,Alkarian,3851,0,1,1,2,50.0%,43m
4119,2,[ProSC]BRYAN,3851,0,0,1,1,0.0%,29m
4119,2,lorekipo,3851,0,0,3,3,0.0%,41m
4128,2,[uGG]xEnvy,3850,1613,458,418,876,52.3%,42m
4128,2,SiegeMode,3850,776,159,146,305,52.1%,27m
4128,2,BlizzHackCHK,3850,610,100,88,188,53.2%,37m
4128,2,mds,3850,1289,86,79,165,52.1%,16m
4128,2,SyNcGHTYII,3850,1312,72,34,106,67.9%,16m
4128,2,IllllIlllII,3850,334,32,29,61,52.5%,24m
4128,2,[RUMB]Relinquish,3850,460,17,14,31,54.8%,37m
4128,3,YogSothoth,3850,168,5,0,5,100.0%,7m
4128,2,MachineHead,3850,60,3,0,3,100.0%,13m
4128,2,Jakttornet,3850,96,3,1,4,75.0%,41m
4128,2,[Ðiçk]thatplimp,3850,102,2,4,6,33.3%,20m
4128,2,[NPhase]Mugzy,3850,68,2,6,8,25.0%,31m
4140,1,[IMDSI]Kichan,3849,1682,128,127,255,50.2%,28m
4140,1,CalaVera,3849,1230,80,86,166,48.2%,25m
4140,2,Alco,3849,1188,69,56,125,55.2%,40m
4140,1,Gator,3849,831,25,28,53,47.2%,6m
4140,1,[Asar]Fish,3849,468,12,15,27,44.4%,6m
4140,2,[Atira]DieselMP,3849,114,2,3,5,40.0%,19m
4140,2,Sober,3849,0,0,2,2,0.0%,13m
4147,2,[TWC]Zoom,3848,1308,231,218,449,51.4%,32m
4147,1,[dBASED]thecynic,3848,1923,166,135,301,55.1%,31m
4149,2,Espresso,3847,397,17,6,23,73.9%,37m
4149,1,Destructo,3847,523,15,14,29,51.7%,6m
4149,2,Beastin,3847,288,10,7,17,58.8%,17m
4149,2,spooder,3847,126,5,2,7,71.4%,43m
4149,2,[420whg]Avaek,3847,0,3,2,5,60.0%,10m
4149,2,noitVonNI,3847,102,3,2,5,60.0%,40m
4149,1,NdNo,3847,82,2,11,13,15.4%,17m
4156,3,doodledinks,3846,1806,209,204,413,50.6%,13m
4156,1,helloRJ,3846,451,12,15,27,44.4%,27m
4156,1,[scMAUI]Maxbrutus,3846,318,7,12,19,36.8%,5m
4156,2,llllllllllll,3846,192,6,4,10,60.0%,21m
4156,3,Wyndpulse,3846,4,3,13,16,18.8%,22m
4156,1,MomenT,3846,92,2,9,11,18.2%,40m
4156,2,[UpeV]Shakaro,3846,0,1,0,1,100.0%,31m
4163,1,[AIN]Sunlight,3845,1890,180,185,365,49.3%,14m
4163,1,Furia,3845,1211,163,153,316,51.6%,28m
4163,1,PanTo,3845,1974,149,123,272,54.8%,30m
4163,2,[eFt0ss]ExpiredBaker,3845,1527,120,115,235,51.1%,18m
4163,1,Ketse,3845,1267,112,100,212,52.8%,25m
4163,2,Rinoie,3845,152,6,3,9,66.7%,22m
4163,2,[NPhase]Diannabol,3845,152,5,2,7,71.4%,17m
4163,2,OFE,3845,100,3,1,4,75.0%,11m
4163,2,[LoF]DVVvilla,3845,0,0,2,2,0.0%,27m
4172,1,[NPhasA]Massari,3844,1969,321,311,632,50.8%,8m
4172,2,MMRDonor,3844,1453,179,179,358,50.0%,35m
4172,1,[GOPERÚ]TheEliteBro,3844,1932,128,136,264,48.5%,35m
4172,1,Zantetsuken,3844,834,94,87,181,51.9%,24m
4172,2,[7IP]Escanor,3844,1587,82,75,157,52.2%,12m
4172,2,dlwlrmafans,3844,626,26,12,38,68.4%,26m
4172,2,[Ikar0s]ExecutorFil,3844,538,20,14,34,58.8%,14m
4172,3,mACROpLAYER,3844,97,4,2,6,66.7%,35m
4172,2,[inCo]srain,3844,30,1,1,2,50.0%,9m
4172,2,ToroYMoi,3844,0,1,2,3,33.3%,4m
4172,1,Nipa,3844,0,0,5,5,0.0%,25m
4183,2,[NPhase]MeltedCheese,3843,782,32,19,51,62.7%,43m
4183,2,[Chich1]Tatoks,3843,240,11,1,12,91.7%,8m
4185,2,Snuffles,3842,1243,52,49,101,51.5%,43m
4185,1,[PTHero]CrazySoldier,3842,714,18,23,41,43.9%,30m
4185,2,[αB]AlCaPwneD,3842,134,4,6,10,40.0%,39m
4185,2,Kuri,3842,0,0,4,4,0.0%,11m
4189,2,[BaCo]Lazerus,3841,256,8,4,12,66.7%,12m
4189,2,Lunzer,3841,234,7,11,18,38.9%,13m
4191,1,NONAME,3840,1022,24,29,53,45.3%,22m
4191,2,UYScuti,3840,0,0,1,1,0.0%,24m
4191,2,Easydoesit,3840,0,0,2,2,0.0%,19m
4194,2,[TwiHur]DaNang,3839,430,20,8,28,71.4%,26m
4194,2,[GrEv]EasYi,3839,414,14,10,24,58.3%,15m
4194,2,Kagami,3839,31,1,1,2,50.0%,18m
4194,2,[NTDL]Lofty,3839,0,0,1,1,0.0%,15m
4194,2,Citrus,3839,0,0,2,2,0.0%,31m
4199,1,[Amb3rs]UGamer,3838,1938,78,88,166,47.0%,13m
4199,1,dirtyplayer,3838,1327,72,85,157,45.9%,34m
4199,2,idea,3838,660,23,24,47,48.9%,30m
4199,2,thepooptruck,3838,202,6,9,15,40.0%,42m
4199,2,SuppLyPoweR,3838,32,2,0,2,100.0%,26m
4199,2,Khun,3838,34,1,1,2,50.0%,8m
4199,2,[ANIMOO]BANGBANG,3838,88,1,6,7,14.3%,31m
4199,2,[BLM4Ev]RIPGeorgeF,3838,0,0,6,6,0.0%,23m
4207,2,NightFalllll,3837,1653,101,69,170,59.4%,23m
4207,2,SpinW,3837,1231,59,29,88,67.0%,10m
4207,3,llllllllllll,3837,218,11,3,14,78.6%,21m
4207,1,PreciseAlien,3837,143,4,14,18,22.2%,34m
4207,2,[EtrOy]Hypno,3837,0,0,3,3,0.0%,31m
4212,1,Deylinia,3836,1993,494,459,953,51.8%,13m
4212,1,Xellows,3836,638,108,93,201,53.7%,9m
4212,1,NamelessT,3836,1646,60,73,133,45.1%,20m
4212,1,[Xpk]marinero,3836,1163,43,55,98,43.9%,5m
4212,2,[Tweet]Zeta,3836,806,31,24,55,56.4%,31m
4212,2,noodles,3836,30,1,2,3,33.3%,22m
4212,1,ArtofTerran,3836,46,1,7,8,12.5%,13m
4212,2,[WTZ]ZugZagZug,3836,0,0,1,1,0.0%,10m
4212,2,llllllllllll,3836,0,0,1,1,0.0%,5m
4212,3,[DETER]Infinite,3836,0,0,3,3,0.0%,14m
4222,1,asdfg,3835,1942,124,117,241,51.5%,35m
4222,2,[aKa]Corone,3835,1208,114,100,214,53.3%,14m
4222,2,[evilo]Titich,3835,666,43,43,86,50.0%,15m
4222,2,Wyko,3835,617,31,19,50,62.0%,29m
4222,2,IIIIIIIIIIII,3835,501,20,5,25,80.0%,39m
4222,2,[iDrunk]Benevolence,3835,0,1,3,4,25.0%,11m
4222,2,Protijay,3835,0,0,2,2,0.0%,4m
4229,2,Redds,3834,907,49,38,87,56.3%,40m
4229,2,SlayerS,3834,376,27,16,43,62.8%,19m
4229,1,[UCSD]Artistic,3834,723,23,28,51,45.1%,11m
4229,2,[afterM]Albino,3834,0,1,0,1,100.0%,24m
4229,2,IIIIIIIIIIII,3834,0,1,1,2,50.0%,37m
4229,2,KoeL,3834,0,0,1,1,0.0%,19m
4235,1,llllllllllll,3833,1681,57,52,109,52.3%,6m
4235,2,NumberYellow,3833,497,23,8,31,74.2%,5m
4235,1,nEAnS,3833,369,17,13,30,56.7%,27m
4235,2,Khucumber,3833,334,12,6,18,66.7%,32m
4235,1,[NPhase]RektTrashEZ,3833,392,9,19,28,32.1%,3m
4235,2,[Weac]FreezingRain,3833,104,3,3,6,50.0%,35m
4235,2,dayday,3833,0,1,0,1,100.0%,43m
4235,2,[NAGARA]Nyaong,3833,0,0,1,1,0.0%,43m
4235,2,ByuN,3833,0,0,1,1,0.0%,18m
4244,1,VoidZero,3832,1923,393,405,798,49.2%,9m
4244,1,markit,3832,1965,316,325,641,49.3%,37m
4244,2,[Kuguya]DeathGun,3832,1610,187,181,368,50.8%,8m
4244,2,[αX]Anansi,3832,1445,67,48,115,58.3%,42m
4244,1,NiTGriT,3832,386,8,14,22,36.4%,43m
4244,2,llllllllllll,3832,0,0,1,1,0.0%,43m
4250,3,Tjure,3831,116,6,10,16,37.5%,38m
4251,2,UpInYourBum,3830,655,47,36,83,56.6%,13m
4251,2,MechItCry,3830,831,35,24,59,59.3%,26m
4251,1,[3AM]TheIndianOne,3830,393,19,10,29,65.5%,19m
4251,3,[JOOMA]Megaicefenix,3830,282,13,2,15,86.7%,38m
4251,2,IIIIIIIIII,3830,167,9,1,10,90.0%,21m
4256,2,RoeJogan,3829,1224,178,158,336,53.0%,18m
4256,2,TheKH,3829,864,96,55,151,63.6%,22m
4256,1,[DarkAG]Dro,3829,1145,94,82,176,53.4%,22m
4256,1,[TJET]Bonein,3829,1536,45,54,99,45.5%,27m
4256,3,[ByBys]Valdas,3829,261,12,4,16,75.0%,11m
4256,2,INnovation,3829,216,7,4,11,63.6%,39m
4256,2,[EtrOy]Dieyoenz,3829,0,1,0,1,100.0%,39m
4256,3,Papadragon,3829,0,1,0,1,100.0%,36m
4256,2,Nerdicus,3829,0,0,3,3,0.0%,21m
4265,1,[DaeNA]will,3828,1882,289,287,576,50.2%,35m
4265,1,[Exper]Vyop,3828,1185,33,42,75,44.0%,6m
4265,2,[HankH]bobbyShmurda,3828,100,3,2,5,60.0%,39m
4265,1,Zerko,3828,0,2,1,3,66.7%,33m
4265,2,[notCo]Yoda,3828,0,0,1,1,0.0%,18m
4270,2,Rock,3827,330,17,5,22,77.3%,27m
4270,2,Fall,3827,34,1,1,2,50.0%,31m
4272,1,chedarface,3826,1130,190,195,385,49.4%,17m
4272,1,Devil,3826,1839,126,135,261,48.3%,27m
4272,2,CatsThirdPaw,3826,463,21,10,31,67.7%,29m
4272,1,[VAPE7]LuNaTiC,3826,306,9,13,22,40.9%,33m
4272,2,Jeremy,3826,36,2,0,2,100.0%,41m
4272,2,JmaC,3826,0,0,3,3,0.0%,18m
4272,2,WaifuWarrior,3826,0,0,4,4,0.0%,32m
4279,2,DecoY,3825,548,47,38,85,55.3%,22m
4279,2,[αB]NeO,3825,412,14,14,28,50.0%,31m
4279,1,BBSolarwind,3825,46,2,7,9,22.2%,34m
4279,2,[UofC]calomando,3825,0,1,0,1,100.0%,43m
4279,2,SpiderShlong,3825,73,1,2,3,33.3%,40m
4284,1,RedMind,3824,1752,1801,1759,3560,50.6%,13m
4284,2,Vanguard,3824,404,19,9,28,67.9%,30m
4284,2,[TSØP]MacroAKNI,3824,500,18,16,34,52.9%,43m
4284,2,[AtL450]RealoG,3824,0,0,1,1,0.0%,26m
4288,1,DamageINC,3823,1905,176,171,347,50.7%,5m
4288,2,[DRKAPP]OCOMON,3823,98,4,4,8,50.0%,43m
4288,2,noodles,3823,92,4,5,9,44.4%,5m
4288,2,[OmaeWa]ChiliChip,3823,130,4,5,9,44.4%,39m
4288,2,[UKclan]Joesol,3823,134,4,6,10,40.0%,4m
4288,1,AitchPea,3823,46,1,7,8,12.5%,28m
4288,1,Spinozah,3823,46,1,8,9,11.1%,8m
4295,1,QwertyMaster,3822,1722,316,321,637,49.6%,19m
4295,2,[AoE3]BudaIsTheWay,3822,1232,66,58,124,53.2%,23m
4295,2,ReaPerTeRRaN,3822,385,16,9,25,64.0%,18m
4295,3,HanLin,3822,315,14,6,20,70.0%,3m
4295,2,magbar,3822,334,11,8,19,57.9%,24m
4295,2,gradeschool,3822,122,5,8,13,38.5%,8m
4295,2,IIIIIIIIIIII,3822,134,4,8,12,33.3%,13m
4295,3,llllllllllll,3822,97,2,0,2,100.0%,42m
4295,2,[KiMBR]WiN,3822,36,2,1,3,66.7%,25m
4295,2,Terror,3822,0,1,0,1,100.0%,30m
4295,3,IIIIIIIIIIII,3822,0,1,0,1,100.0%,12m
4306,1,[SsaYnS]James,3821,1927,202,196,398,50.8%,27m
4306,1,SonofTy,3821,1597,75,80,155,48.4%,31m
4306,1,Dan,3821,128,4,7,11,36.4%,33m
4309,2,TimePointer,3820,358,11,15,26,42.3%,37m
4309,2,Arctic,3820,96,4,0,4,100.0%,22m
4311,1,[Sune]yermi,3819,1877,187,179,366,51.1%,27m
4311,2,CoLe,3819,1597,171,174,345,49.6%,34m
4311,2,MarineKing,3819,906,94,65,159,59.1%,6m
4311,2,fortnite,3819,814,47,31,78,60.3%,23m
4311,2,GamMa,3819,272,13,4,17,76.5%,31m
4311,2,[ValidG]IzzyMeanWeeb,3819,64,2,6,8,25.0%,27m
4311,2,azerty,3819,0,1,1,2,50.0%,35m
4318,2,[ScSwrm]IronLung,3818,1182,44,47,91,48.4%,14m
4318,2,[Bes]Gawzilla,3818,900,31,35,66,47.0%,31m
4318,2,DaNang,3818,442,20,10,30,66.7%,41m
4318,1,llllllllllll,3818,554,12,18,30,40.0%,28m
4318,2,[DhZPro]Terranosaur,3818,340,11,12,23,47.8%,11m
4318,2,[RSP3CT]Horus,3818,64,3,0,3,100.0%,20m
4318,3,smr,3818,0,1,0,1,100.0%,3m
4318,2,[Toss]MountPutuo,3818,0,0,1,1,0.0%,18m
4326,2,[SnW]PeoNSaGe,3817,1593,172,157,329,52.3%,16m
4326,1,Eiseleid,3817,934,145,131,276,52.5%,20m
4326,2,Pubby,3817,947,39,23,62,62.9%,32m
4326,1,universals,3817,270,6,13,19,31.6%,3m
4326,2,hmoobyaj,3817,98,4,1,5,80.0%,41m
4326,2,TiggyMcWiggy,3817,30,1,1,2,50.0%,31m
4326,2,IGoBrs,3817,0,0,1,1,0.0%,39m
4333,2,[KGH]smoOthster,3816,912,40,28,68,58.8%,30m
4333,2,[PPrime]prfm,3816,212,10,2,12,83.3%,11m
4333,2,[xDsi]MiznBartlett,3816,170,7,1,8,87.5%,40m
4333,2,[DRKESP]DrunkSCV,3816,132,5,6,11,45.5%,30m
4333,2,Chedoo,3816,64,3,4,7,42.9%,18m
4333,2,[GØSU]Kandrew,3816,36,2,1,3,66.7%,29m
4333,2,ClemenC,3816,34,1,3,4,25.0%,11m
4340,2,IlIllIlllIll,3815,1549,383,378,761,50.3%,43m
4340,2,[ICL]Karthdaddy,3815,1636,81,79,160,50.6%,27m
4340,2,BlacK,3815,1347,80,51,131,61.1%,43m
4340,2,[Akori]javimamer,3815,1581,71,62,133,53.4%,32m
4340,2,[PlzOut]Captaincave,3815,541,30,17,47,63.8%,34m
4340,2,[GY]PrussiaCream,3815,466,18,14,32,56.2%,13m
4340,2,DOBRO,3815,182,6,8,14,42.9%,30m
4340,3,makoplux,3815,0,0,2,2,0.0%,29m
4340,2,HuaCheng,3815,0,0,3,3,0.0%,42m
4349,1,brownhemp,3814,966,25,32,57,43.9%,40m
4349,2,[AV8]Tidgey,3814,210,11,8,19,57.9%,32m
4349,2,llllllllllll,3814,0,5,0,5,100.0%,9m
4349,2,ValLa,3814,0,1,0,1,100.0%,40m
4349,2,llllllllllll,3814,0,1,4,5,20.0%,32m
4354,2,blinkDK,3813,876,38,25,63,60.3%,22m
4354,2,llllllllllll,3813,469,21,16,37,56.8%,32m
4354,2,Otter,3813,524,19,15,34,55.9%,36m
4354,3,TwoBaseInc,3813,143,8,0,8,100.0%,29m
4354,2,Beyondexx,3813,128,3,1,4,75.0%,27m
4354,2,Computer,3813,36,2,0,2,100.0%,42m
4354,2,spoon,3813,0,0,2,2,0.0%,5m
4361,1,[UpeV]Deadpool,3812,1923,496,486,982,50.5%,8m
4361,1,llllllllllll,3812,911,257,201,458,56.1%,28m
4361,2,TeChief,3812,1561,216,210,426,50.7%,20m
4361,1,[αB]CaptainClub,3812,1642,119,110,229,52.0%,28m
4361,2,[DTokes]Chickenhawk,3812,1633,95,80,175,54.3%,7m
4361,2,TwelveAPM,3812,467,19,13,32,59.4%,43m
4361,2,[lDream]IIIIIIIII,3812,550,19,20,39,48.7%,18m
4361,2,FlukeShow,3812,372,14,10,24,58.3%,31m
4361,2,[Kappa]Chigadigadee,3812,0,1,0,1,100.0%,9m
4361,2,[ZGRB]JESTJERVYN,3812,0,0,1,1,0.0%,20m
4361,2,[1SN1]norton,3812,0,0,1,1,0.0%,32m
4372,1,[C80585]AvilosArmy,3811,1752,125,99,224,55.8%,37m
4372,2,mistermister,3811,1324,84,82,166,50.6%,42m
4372,2,veryhardgame,3811,1272,57,39,96,59.4%,35m
4372,2,TsogiMaster,3811,419,20,4,24,83.3%,28m
4372,2,[Ow0]lackey,3811,230,8,7,15,53.3%,19m
4372,2,IGuNoVoDaMI,3811,0,1,0,1,100.0%,43m
4378,1,[TSØP]sTRockeTT,3810,1943,190,202,392,48.5%,9m
4378,2,GUNDAM,3810,622,21,21,42,50.0%,17m
4378,2,[RakF]kakoki,3810,560,19,20,39,48.7%,30m
4378,2,masterbreakr,3810,372,13,17,30,43.3%,35m
4378,2,HotS,3810,102,2,4,6,33.3%,7m
4378,2,Positive,3810,30,1,4,5,20.0%,27m
4384,1,[RUMB]UnitedGGK,3809,1619,54,51,105,51.4%,22m
4384,1,town,3809,1288,36,45,81,44.4%,27m
4384,2,SorryGTG,3809,88,8,4,12,66.7%,32m
4384,2,[REGN]ChocoRain,3809,32,2,0,2,100.0%,5m
4388,2,Bryson,3808,1629,190,166,356,53.4%,42m
4388,1,Kamino,3808,1288,81,78,159,50.9%,35m
4388,2,Lawlsack,3808,804,33,28,61,54.1%,34m
4388,2,[GRU]Camander,3808,178,5,8,13,38.5%,31m
4392,1,RoodsMagoods,3807,1929,157,156,313,50.2%,5m
4392,1,Powerhouse,3807,1239,89,84,173,51.4%,28m
4392,1,WestCoastIPA,3807,983,34,41,75,45.3%,17m
4392,1,MrG,3807,0,1,2,3,33.3%,6m
4392,2,[Ex0n]DOlPH,3807,73,1,4,5,20.0%,10m
4392,2,IIIIIIIIIIII,3807,0,0,5,5,0.0%,20m
4398,2,[tzpOP]BOO,3806,1547,104,94,198,52.5%,5m
4398,2,[Robin]Menko,3806,1362,81,84,165,49.1%,16m
4398,1,RipGeoff,3806,1208,35,36,71,49.3%,19m
4398,2,SoftTufu,3806,648,22,28,50,44.0%,6m
4398,2,[Zatra]blacklotus,3806,337,14,8,22,63.6%,17m
4398,2,Bowchicabow,3806,217,9,8,17,52.9%,26m
4398,2,Weenersaurus,3806,94,3,1,4,75.0%,43m
4398,2,FeloSentient,3806,58,3,3,6,50.0%,19m
4398,2,Apolas,3806,74,2,8,10,20.0%,42m
4398,2,Blue,3806,30,1,2,3,33.3%,29m
4398,2,[hTx]LilOrbitz,3806,0,0,3,3,0.0%,17m
4409,1,[xO]Mizuie,3805,1907,235,239,474,49.6%,8m
4409,2,BananaTerran,3805,1090,41,34,75,54.7%,12m
4409,2,[Cryptc]TakeMeHome,3805,640,28,22,50,56.0%,32m
4409,2,[chEdd]Stallions,3805,502,20,9,29,69.0%,43m
4409,2,[STRIDE]Stride,3805,458,18,11,29,62.1%,22m
4414,2,[Slayor]Cube,3804,1378,159,111,270,58.9%,27m
4414,1,HammyOG,3804,1711,74,76,150,49.3%,25m
4414,2,Sabre,3804,428,14,16,30,46.7%,30m
4414,3,Timowerner,3804,237,8,2,10,80.0%,20m
4414,2,IIIIIIIIIIII,3804,68,4,0,4,100.0%,29m
4414,2,[PPM]OLDPAINLESS,3804,114,4,2,6,66.7%,43m
4414,2,amis,3804,0,0,1,1,0.0%,16m
4421,2,GektorGrom,3803,1587,77,73,150,51.3%,20m
4421,1,llllllllllll,3803,962,40,46,86,46.5%,32m
4421,2,ProxyReapers,3803,326,16,6,22,72.7%,41m
4421,3,[TurtIe]ejade,3803,167,9,1,10,90.0%,30m
4421,2,[DeSS]Winemonkey,3803,36,2,2,4,50.0%,39m
4421,2,SINN,3803,0,1,0,1,100.0%,39m
4427,1,[eXoNC]Thome,3802,1914,499,525,1024,48.7%,30m
4427,2,keria,3802,317,16,7,23,69.6%,13m
4427,2,CptProtoss,3802,0,0,1,1,0.0%,39m
4430,2,[MaCU]Chance,3801,1630,303,267,570,53.2%,42m
4430,2,DarthBhan,3801,1626,291,286,577,50.4%,15m
4430,2,somnus,3801,819,62,44,106,58.5%,11m
4430,1,dropthebeat,3801,1191,39,45,84,46.4%,37m
4430,2,[BRSKR]MUDABANG,3801,602,28,12,40,70.0%,22m
4430,2,ThorIsHere,3801,358,13,18,31,41.9%,13m
4430,1,BlueLeaf,3801,422,12,20,32,37.5%,3m
4430,2,[EZDUNK]Wasp,3801,172,7,0,7,100.0%,17m
4430,2,Voodou,3801,30,2,2,4,50.0%,32m
4430,2,FINGERinBUM,3801,0,2,3,5,40.0%,10m
4440,1,Anonymous,3800,1927,377,381,758,49.7%,6m
4440,2,Thanatos,3800,616,74,46,120,61.7%,41m
4440,2,Monster,3800,853,68,60,128,53.1%,16m
4440,2,[WiGGz]SoulPosessed,3800,688,26,21,47,55.3%,42m
4440,2,BlueBalls,3800,301,12,11,23,52.2%,35m
4440,2,[pwrIX]DOOMHURT,3800,60,3,1,4,75.0%,18m
4440,2,Nentio,3800,70,3,1,4,75.0%,10m
4440,2,MajesticMatt,3800,0,0,1,1,0.0%,31m
4448,2,[LCE]Miki,3799,1106,251,235,486,51.6%,10m
4448,2,Lune,3799,570,18,21,39,46.2%,37m
4448,2,[ThNtS]SlayerSoul,3799,322,11,11,22,50.0%,14m
4448,2,NoGG,3799,92,4,2,6,66.7%,24m
4448,2,eXecution,3799,30,1,4,5,20.0%,9m
4448,3,DukeofEarle,3799,30,1,10,11,9.1%,11m
4448,2,[AD3C]CuBaNo,3799,0,0,1,1,0.0%,22m
4448,2,Dignitos,3799,0,0,1,1,0.0%,31m
4448,2,[SMB]maxpower,3799,0,0,2,2,0.0%,20m
4448,2,[LgnTDS]Lifesavor,3799,0,0,2,2,0.0%,18m
4458,1,[CSW]Lugia,3798,812,166,168,334,49.7%,30m
4458,2,GoodMannered,3798,927,38,39,77,49.4%,15m
4458,1,[Peso]SupperStar,3798,1042,29,32,61,47.5%,4m
4458,3,SleepyJoe,3798,234,12,1,13,92.3%,14m
4458,2,llllllllllll,3798,166,5,9,14,35.7%,41m
4458,2,[NovaX]andy,3798,64,2,4,6,33.3%,23m
4464,1,Ponix,3797,1150,51,61,112,45.5%,14m
4464,2,goldhat,3797,451,22,25,47,46.8%,5m
4464,2,Bismarkbb,3797,96,4,3,7,57.1%,41m
4464,2,sYstim,3797,92,3,2,5,60.0%,43m
4464,3,YeeHaw,3797,86,3,3,6,50.0%,3m
4464,3,ByuN,3797,121,2,1,3,66.7%,35m
4464,2,[VOY3UR]RithoWkdman,3797,0,1,6,7,14.3%,35m
4464,2,[ffaaak]Amur,3797,0,0,4,4,0.0%,22m
4472,2,DimSum,3796,492,18,15,33,54.5%,22m
4472,2,Dnxz,3796,78,6,5,11,54.5%,16m
4472,2,Prz,3796,40,2,3,5,40.0%,34m
4472,2,Tirailleur,3796,0,0,1,1,0.0%,35m
4472,2,AlphaJY,3796,0,0,4,4,0.0%,39m
4477,1,zacarizac,3795,1309,75,64,139,54.0%,28m
4477,2,[QTclub]niknovichkov,3795,690,24,26,50,48.0%,32m
4477,1,[EZDUNK]GrannyWatta,3795,331,13,13,26,50.0%,24m
4477,1,[HYXJM]MGJTerran,3795,224,5,13,18,27.8%,27m
4477,2,OceanBlu,3795,30,2,4,6,33.3%,4m
4482,2,[XpKb]Nada,3794,1575,272,252,524,51.9%,41m
4482,2,Sonic,3794,1585,172,161,333,51.7%,16m
4482,2,Oink,3794,1535,93,65,158,58.9%,27m
4482,2,CondorBomber,3794,919,41,40,81,50.6%,20m
4482,1,[PSlSTC]BraDaDiah,3794,1038,32,34,66,48.5%,17m
4482,2,Constant,3794,490,23,10,33,69.7%,35m
4482,1,[ProSC]toutoune,3794,822,21,30,51,41.2%,30m
4482,2,[LDCO]Flamback,3794,152,5,5,10,50.0%,23m
4482,2,kaiser,3794,108,3,8,11,27.3%,25m
4482,2,QuikKilla,3794,0,0,2,2,0.0%,30m
4492,2,RocketJockey,3793,1637,406,411,817,49.7%,16m
4492,1,SiDeEfFeCtZ,3793,1826,221,227,448,49.3%,20m
4492,1,[FFAA]NITRØ,3793,1812,75,71,146,51.4%,28m
4492,2,Liberty,3793,864,31,33,64,48.4%,41m
4492,1,okayfortoday,3793,488,11,18,29,37.9%,5m
4492,2,mom,3793,30,1,1,2,50.0%,26m
4498,2,EasyKatka,3792,1554,170,165,335,50.7%,19m
4498,2,[MONO]Lucretius,3792,1622,107,107,214,50.0%,20m
4498,2,AverageJoe,3792,1432,90,77,167,53.9%,29m
4498,2,llllllllllll,3792,721,34,23,57,59.6%,22m
4498,1,[hTx]IMSpookeh,3792,1111,33,37,70,47.1%,27m
4498,2,[Cryptc]SageFantasma,3792,678,25,21,46,54.3%,39m
4498,2,Nameless,3792,345,19,4,23,82.6%,20m
4498,2,[SCLA]WiperElite,3792,356,13,13,26,50.0%,7m
4498,3,llllllllll,3792,142,8,0,8,100.0%,26m
4498,2,TigersMilk,3792,227,7,6,13,53.8%,13m
4498,2,Hunterlisk,3792,196,5,4,9,55.6%,23m
4498,2,niCK,3792,60,2,3,5,40.0%,13m
4498,2,[5555]TERRANHERUP,3792,0,2,4,6,33.3%,10m
4498,2,[SDWWF]Odranoel,3792,0,1,0,1,100.0%,20m
4498,2,llllllllllll,3792,30,1,2,3,33.3%,5m
4513,2,[MEP]Jing,3791,1630,128,117,245,52.2%,31m
4513,2,[RathFr]Raws,3791,1495,82,64,146,56.2%,16m
4513,1,Enigma,3791,864,36,41,77,46.8%,32m
4513,3,lllllllllll,3791,210,11,2,13,84.6%,16m
4513,2,[GdAT]Starsense,3791,302,11,9,20,55.0%,40m
4513,2,Lavigne,3791,116,9,2,11,81.8%,21m
4513,2,[CCUO]JervisBute,3791,194,7,2,9,77.8%,11m
4513,2,Lock,3791,0,1,1,2,50.0%,28m
4513,2,[WildAF]WildCard,3791,0,1,1,2,50.0%,30m
4522,1,[cl0udM]CowboyDan,3790,1816,177,193,370,47.8%,17m
4522,2,DASH,3790,600,75,76,151,49.7%,43m
4522,2,signroyal,3790,975,42,25,67,62.7%,30m
4522,2,Anthorn,3790,650,23,24,47,48.9%,42m
4522,1,[MilkIt]Odin,3790,842,21,31,52,40.4%,30m
4522,2,LoliCapitali,3790,219,12,5,17,70.6%,41m
4522,2,[UpeV]ExegoL,3790,256,9,10,19,47.4%,40m
4522,2,[CURLS]WiseBoy,3790,188,6,10,16,37.5%,10m
4530,1,[TGosuA]Mac,3789,1929,197,193,390,50.5%,4m
4530,1,MartinOne,3789,784,29,32,61,47.5%,9m
4530,2,Nubster,3789,344,28,23,51,54.9%,20m
4530,2,[xTQc]Freak,3789,373,13,20,33,39.4%,31m
4530,2,gangstagoose,3789,30,2,0,2,100.0%,22m
4530,1,[L0nely]SgtPepper,3789,48,2,0,2,100.0%,8m
4530,2,ZJBillionair,3789,54,2,3,5,40.0%,8m
4530,2,[Moiist]Nghtmare,3789,62,2,5,7,28.6%,19m
4530,2,ByuNoVation,3789,0,1,0,1,100.0%,19m
4539,2,colcrom,3788,1336,222,209,431,51.5%,11m
4539,3,Nubb,3788,191,10,2,12,83.3%,34m
4539,1,[Mimic]YellowFlash,3788,176,6,13,19,31.6%,13m
4539,2,HiTboXer,3788,58,3,0,3,100.0%,18m
4539,2,Ming,3788,0,1,0,1,100.0%,43m
4539,2,Lambda,3788,0,0,1,1,0.0%,10m
4539,2,Gar,3788,0,0,1,1,0.0%,19m
4546,1,[EUGGE]AwNotATerran,3787,1527,57,63,120,47.5%,41m
4546,1,BIGKING,3787,864,46,56,102,45.1%,14m
4546,1,[lNI]QueensGambit,3787,926,32,26,58,55.2%,25m
4546,2,[Asar]SnoW,3787,585,28,19,47,59.6%,4m
4546,1,[UpeV]Garule,3787,413,27,20,47,57.4%,6m
4546,2,bmwNick,3787,530,19,20,39,48.7%,31m
4546,2,itsMerikh,3787,498,18,19,37,48.6%,21m
4546,3,UrMum,3787,336,15,5,20,75.0%,38m
4546,2,[Cryptc]CyStorm,3787,222,7,10,17,41.2%,14m
4546,3,ToucHh,3787,30,2,1,3,66.7%,43m
4546,1,[NZER0]Ghoul,3787,46,1,9,10,10.0%,35m
4546,1,urixop,3787,0,0,1,1,0.0%,14m
4558,1,TheMacroKing,3786,1399,211,214,425,49.6%,44m
4558,2,IIIIIIIIIIII,3786,58,7,0,7,100.0%,10m
4558,2,[Msia]MaxShockyo,3786,30,1,6,7,14.3%,27m
4558,2,promet,3786,0,0,3,3,0.0%,12m
4562,2,[NPhasA]TheHamman,3785,1042,40,33,73,54.8%,32m
4562,1,MenaceRDX,3785,1042,39,45,84,46.4%,25m
4562,2,[Naglan]AgeRM,3785,606,32,34,66,48.5%,41m
4562,2,IBGreedy,3785,128,4,7,11,36.4%,32m
4562,1,ArAyA,3785,138,3,14,17,17.6%,30m
4562,2,[Macac0]liszt,3785,0,0,1,1,0.0%,17m
4562,2,[Fever]Prod,3785,0,0,5,5,0.0%,42m
4569,2,Omgilyuwu,3784,1145,285,267,552,51.6%,35m
4569,1,[CeMx]Thunderbolt,3784,741,72,52,124,58.1%,5m
4569,1,llIlIHillIl,3784,300,10,11,21,47.6%,28m
4569,3,Koalataxi,3784,142,8,0,8,100.0%,8m
4569,2,[MBQ]BoukarDiouf,3784,275,8,7,15,53.3%,26m
4569,2,[QTp2T]ShadowHunter,3784,102,4,3,7,57.1%,24m
4569,1,[FMX]Esquire,3784,0,2,3,5,40.0%,39m
4569,2,Paranoia,3784,0,1,2,3,33.3%,30m
4569,2,[2AhB]Omedon,3784,0,0,1,1,0.0%,43m
4569,3,CuKu,3784,0,0,1,1,0.0%,44m
4579,1,Yeung,3783,1907,312,314,626,49.8%,17m
4579,1,Soap,3783,1900,136,138,274,49.6%,32m
4579,2,TheBreaker,3783,993,61,60,121,50.4%,15m
4579,2,Hup,3783,501,25,30,55,45.5%,43m
4579,2,[BGOK]Chickenman,3783,546,20,17,37,54.1%,25m
4579,2,[outCo]ggKent,3783,302,12,3,15,80.0%,35m
4579,2,[NextDC]GAMEL,3783,60,3,3,6,50.0%,27m
4579,2,Sailinglion,3783,0,1,0,1,100.0%,41m
4587,2,[wOaS]horseypistac,3782,1409,61,55,116,52.6%,17m
4587,2,[Sasqtc]ChiliBurger,3782,165,57,57,114,50.0%,19m
4587,2,WhitE,3782,1058,51,25,76,67.1%,11m
4587,2,PatsFan,3782,417,20,20,40,50.0%,34m
4587,2,IlIIIlllIlIl,3782,88,4,0,4,100.0%,26m
4587,2,[Lt6]dvolpi,3782,0,1,0,1,100.0%,10m
4587,2,ByuNPrime,3782,0,1,0,1,100.0%,22m
4587,3,Ralphie,3782,0,1,1,2,50.0%,31m
4587,2,Matt,3782,36,1,3,4,25.0%,34m
4587,2,Xsir,3782,0,0,1,1,0.0%,7m
4597,1,LeonPowalski,3781,1591,50,51,101,49.5%,25m
4597,2,SpeCial,3781,280,11,0,11,100.0%,32m
4597,1,Bruin,3781,471,10,17,27,37.0%,37m
4597,2,Zoon,3781,62,3,1,4,75.0%,42m
4597,2,xiaochun,3781,90,3,2,5,60.0%,27m
4602,1,Chrosis,3780,1901,199,191,390,51.0%,40m
4602,2,Clean,3780,397,20,26,46,43.5%,19m
4602,2,rUready,3780,30,3,3,6,50.0%,26m
4605,1,IllI,3779,1209,97,102,199,48.7%,12m
4605,1,[AbcCo]Frost,3779,1293,55,52,107,51.4%,17m
4605,2,IIIIIIIIIlll,3779,1002,46,35,81,56.8%,5m
4605,1,rexTOLA,3779,708,26,25,51,51.0%,7m
4605,2,henryci,3779,230,7,11,18,38.9%,40m
4605,3,NoScared,3779,197,6,3,9,66.7%,25m
4605,3,ImbaForever,3779,88,4,5,9,44.4%,24m
4605,2,[Koshka]Xenakis,3779,0,1,0,1,100.0%,7m
4605,2,[TGosuB]Doomby,3779,34,1,2,3,33.3%,39m
4614,2,[Cryptc]Legendary,3778,1613,107,115,222,48.2%,27m
4614,2,BennyHill,3778,1425,80,69,149,53.7%,13m
4614,2,[ValidG]MauriceMoss,3778,1580,76,74,150,50.7%,22m
4614,2,[X17]SCV,3778,342,60,60,120,50.0%,22m
4614,1,[Igbt]LETSGOOOOOOO,3778,656,25,22,47,53.2%,30m
4614,1,[GtB2]minimarauder,3778,502,13,16,29,44.8%,12m
4614,2,llllllllllll,3778,138,5,0,5,100.0%,39m
4614,2,[LimaZC]steimers,3778,78,3,1,4,75.0%,29m
4614,2,OfrParis,3778,0,1,0,1,100.0%,22m
4614,2,Triceratops,3778,0,0,1,1,0.0%,28m
4614,2,Kwehhh,3778,0,0,1,1,0.0%,8m
4614,2,[Teufel]Rogar,3778,0,0,1,1,0.0%,22m
4614,2,[OceanT]Daladier,3778,0,0,3,3,0.0%,10m
4627,1,[EGx]baphomet,3777,1919,491,516,1007,48.8%,37m
4627,2,Aezelon,3777,34,1,2,3,33.3%,17m
4629,1,[NeAs]LeoDark,3776,1415,53,63,116,45.7%,30m
4629,2,socks,3776,849,52,56,108,48.1%,26m
4629,2,Fallenangel,3776,593,46,32,78,59.0%,19m
4629,2,[KingSC]Maydaz,3776,816,32,30,62,51.6%,26m
4629,1,FanofStuff,3776,522,12,20,32,37.5%,32m
4629,2,[αB]ReaLiTy,3776,208,8,4,12,66.7%,42m
4629,2,[LimaSC]SoldieR,3776,0,1,0,1,100.0%,4m
4629,2,MMMM,3776,0,1,0,1,100.0%,9m
4629,2,dgunzoid,3776,0,1,0,1,100.0%,23m
4629,1,hwang,3776,0,0,1,1,0.0%,16m
4639,1,terranstyle,3775,1864,69,75,144,47.9%,39m
4639,2,[xTQc]AziaQc,3775,1484,58,54,112,51.8%,8m
4639,2,Max,3775,608,31,11,42,73.8%,18m
4639,2,[L0GAN]Misery,3775,260,8,11,19,42.1%,20m
4639,2,[Kaii]Iluminado,3775,62,2,2,4,50.0%,39m
4639,2,[Yamaha]BlackSheep,3775,0,1,2,3,33.3%,44m
4645,2,Kevz,3774,285,25,21,46,54.3%,24m
4645,2,NooooooooUse,3774,260,12,19,31,38.7%,26m
4645,1,Knusper,3774,247,10,6,16,62.5%,4m
4645,3,KrazyHorse,3774,60,2,2,4,50.0%,17m
4645,2,[Pton]Jellyfish,3774,0,1,4,5,20.0%,27m
4645,2,[HUS]JakkLe,3774,0,0,1,1,0.0%,21m
4645,1,Rudais,3774,0,0,1,1,0.0%,5m
4645,3,Antoine,3774,0,0,14,14,0.0%,31m
4653,1,[ØFoxF2]NANA,3773,1444,48,59,107,44.9%,4m
4653,2,CroNoS,3773,958,37,30,67,55.2%,43m
4653,2,[SsaYnS]KoalaSoup,3773,877,35,30,65,53.8%,20m
4653,2,nightknight,3773,343,12,7,19,63.2%,39m
4653,2,Gabriel,3773,278,10,3,13,76.9%,5m
4653,2,Michael,3773,86,4,0,4,100.0%,20m
4653,2,jjllama,3773,0,0,1,1,0.0%,13m
4660,1,[TESLAS]Crafty,3772,1889,147,148,295,49.8%,25m
4660,2,Mineralthief,3772,720,87,87,174,50.0%,31m
4660,2,Lennek,3772,460,37,27,64,57.8%,16m
4660,2,VXD,3772,558,21,19,40,52.5%,41m
4660,2,nuclearpro,3772,184,7,13,20,35.0%,5m
4660,2,Dampth,3772,0,1,0,1,100.0%,5m
4660,2,tRankill,3772,0,0,1,1,0.0%,17m
4667,1,[EYELID]pbj,3771,1887,472,474,946,49.9%,14m
4667,2,[SdPM]Fouty,3771,1620,81,65,146,55.5%,32m
4667,2,Kuyzz,3771,1227,76,72,148,51.4%,34m
4667,1,IIIIIIIIIIII,3771,1559,53,56,109,48.6%,37m
4667,2,BaronessLeah,3771,195,18,7,25,72.0%,37m
4667,1,[Chase]dbo,3771,548,17,36,53,32.1%,30m
4667,2,[Lp]JerrodSwag,3771,62,3,0,3,100.0%,15m
4667,2,YungSally,3771,30,1,4,5,20.0%,44m
4675,3,MightyMungo,3770,30,2,1,3,66.7%,11m
4675,2,GrizzLy,3770,30,2,2,4,50.0%,29m
4675,2,Kama,3770,30,1,4,5,20.0%,13m
4678,1,IIIIIIIIIIII,3769,1685,142,162,304,46.7%,37m
4678,2,theBobs,3769,1622,79,70,149,53.0%,5m
4678,1,[TGCrew]KCal,3769,892,23,34,57,40.4%,15m
4678,2,Raynor,3769,152,5,9,14,35.7%,13m
4678,2,[CTsix]pazzkat,3769,30,2,1,3,66.7%,20m
4678,2,JustZyriakTV,3769,0,1,0,1,100.0%,22m
4684,1,[SuperZ]brunornovais,3768,1743,235,241,476,49.4%,25m
4684,2,Oddjob,3768,1635,199,203,402,49.5%,43m
4684,1,[LimLim]ngsWarning,3768,1379,183,165,348,52.6%,22m
4684,2,JustYourHero,3768,832,35,22,57,61.4%,11m
4684,1,TovEazy,3768,131,2,10,12,16.7%,4m
4684,3,[JAEGER]Charlie,3768,30,1,2,3,33.3%,19m
4690,1,Kustersam,3767,1873,186,204,390,47.7%,5m
4690,2,Lockhead,3767,1635,91,90,181,50.3%,22m
4690,2,[SINSTR]roberhpp,3767,539,87,75,162,53.7%,17m
4690,2,[SsaYnS]Javelot,3767,566,19,24,43,44.2%,42m
4690,2,chupacabras,3767,70,3,4,7,42.9%,5m
4695,2,PlzTrump,3766,528,20,15,35,57.1%,39m
4695,2,[1NG]RatsAhoy,3766,324,13,1,14,92.9%,42m
4695,2,Dane,3766,163,10,2,12,83.3%,42m
4695,2,[SsaYnS]KanyeEast,3766,30,2,2,4,50.0%,22m
4695,2,Darknesszz,3766,0,0,1,1,0.0%,39m
4700,2,[Sune]Pilaf,3765,960,72,66,138,52.2%,16m
4700,2,[TLAF]FamLove,3765,878,48,35,83,57.8%,30m
4700,2,[lHMOl]MooOne,3765,795,32,25,57,56.1%,30m
4700,2,[SABO]Colourizing,3765,336,13,6,19,68.4%,21m
4700,2,[urdone]Formula,3765,0,1,0,1,100.0%,38m
4700,2,[VaVTS]Dunkel,3765,0,0,1,1,0.0%,43m
4706,2,Polaco,3764,1311,120,113,233,51.5%,5m
4706,2,PillowFight,3764,991,43,28,71,60.6%,19m
4706,3,lllIIIlllllI,3764,261,13,4,17,76.5%,25m
4706,2,Singularity,3764,272,10,12,22,45.5%,32m
4706,3,[NPhase]Caquil,3764,173,5,8,13,38.5%,40m
4706,2,ZergMutaLing,3764,0,1,0,1,100.0%,36m
4706,2,PotatoMuffin,3764,0,1,2,3,33.3%,22m
4713,2,Terranium,3763,1612,236,184,420,56.2%,41m
4713,2,Preeminent,3763,1547,79,39,118,66.9%,35m
4713,2,Lhama,3763,735,39,38,77,50.6%,22m
4713,1,[GUCCl]BOOOOOOOOOoM,3763,1208,33,38,71,46.5%,15m
4713,2,Rautha,3763,572,24,14,38,63.2%,5m
4713,1,elnovatoxD,3763,864,21,33,54,38.9%,20m
4713,2,UmojanElite,3763,494,18,12,30,60.0%,36m
4713,2,lllllllllll,3763,431,17,17,34,50.0%,43m
4713,2,[GnR]DrKobra,3763,0,2,3,5,40.0%,28m
4713,2,[NwAs]LiquidRaque,3763,60,2,4,6,33.3%,35m
4713,3,IlIlIlIlIlIl,3763,30,1,1,2,50.0%,21m
4713,2,ProteinShake,3763,0,0,1,1,0.0%,9m
4713,2,GOOCHER,3763,0,0,1,1,0.0%,7m
4726,2,[GOPERÚ]ELGRANn,3762,1606,250,246,496,50.4%,19m
4726,1,Clarky,3762,877,100,125,225,44.4%,35m
4726,2,Poryphorion,3762,1463,74,73,147,50.3%,14m
4726,2,Link,3762,1281,62,60,122,50.8%,31m
4726,1,AbNT,3762,1032,32,40,72,44.4%,7m
4726,3,[RØR]Flexner,3762,339,16,6,22,72.7%,42m
4726,1,TrashLord,3762,119,7,0,7,100.0%,23m
4726,2,Chass,3762,0,3,3,6,50.0%,30m
4726,2,[BROFLX]VADER,3762,60,2,1,3,66.7%,22m
4726,2,[RUMB]Messin,3762,0,1,0,1,100.0%,22m
4726,2,[Gather]victorque,3762,32,1,2,3,33.3%,18m
4726,2,NMJ,3762,34,1,4,5,20.0%,30m
4738,2,babyduckfart,3761,1584,127,123,250,50.8%,24m
4738,2,[TSØP]Denexuz,3761,1255,115,101,216,53.2%,12m
4738,2,INnoV,3761,1242,113,112,225,50.2%,5m
4738,2,Ihavenoshoes,3761,1263,53,49,102,52.0%,22m
4738,2,Spectre,3761,446,16,23,39,41.0%,5m
4738,2,GrimReaperUK,3761,398,14,17,31,45.2%,23m
4738,2,DarkWingDuck,3761,358,12,9,21,57.1%,31m
4738,3,BigLupu,3761,99,6,1,7,85.7%,31m
4738,1,SweetHomeAL,3761,0,3,3,6,50.0%,38m
4738,2,[BNYCNE]Olmek,3761,30,2,0,2,100.0%,39m
4738,2,Cruiser,3761,0,0,1,1,0.0%,43m
4749,2,Tollhouse,3760,264,10,9,19,52.6%,19m
4749,2,[AiMB]RaTe,3760,62,3,5,8,37.5%,24m
4749,2,Lanparty,3760,0,0,1,1,0.0%,12m
4752,1,[DhZPro]Limasan,3759,1455,83,96,179,46.4%,39m
4752,1,IIIIIIIIIIII,3759,145,3,0,3,100.0%,23m
4752,2,TheOracle,3759,62,3,2,5,60.0%,16m
4752,2,[MinzS]SwordWielder,3759,0,1,0,1,100.0%,32m
4756,1,[sMi]sMiLucky,3758,1881,701,648,1349,52.0%,6m
4756,1,[ZTempz]MEMEBOY,3758,1907,485,481,966,50.2%,37m
4756,2,Jazy,3758,1106,51,31,82,62.2%,24m
4756,2,marin,3758,383,19,7,26,73.1%,27m
4756,2,[NwAs]ILifeI,3758,0,1,0,1,100.0%,23m
4756,3,[HRDS]Audet,3758,0,0,1,1,0.0%,42m
4756,2,[Frnzy]EightBall,3758,0,0,1,1,0.0%,43m
4756,2,Modena,3758,0,0,1,1,0.0%,5m
4764,2,SuchName,3757,1605,117,102,219,53.4%,23m
4764,1,ZZorange,3757,1684,69,89,158,43.7%,24m
4764,1,ViTaL,3757,1451,50,62,112,44.6%,44m
4764,2,[XIICDO]ByuN,3757,596,22,22,44,50.0%,26m
4764,2,[GIANNI]VERSACE,3757,507,21,9,30,70.0%,22m
4764,3,Sehoon,3757,192,10,2,12,83.3%,39m
4764,2,AnGeLBoT,3757,200,6,13,19,31.6%,14m
4764,2,[B0F]Taerran,3757,34,2,1,3,66.7%,41m
4764,1,[dLife]BrokenLatex,3757,46,2,10,12,16.7%,27m
4764,2,Seven,3757,0,1,0,1,100.0%,22m
4764,2,HakanSlash,3757,0,1,2,3,33.3%,34m
4775,2,Philo,3756,1207,144,141,285,50.5%,5m
4775,1,Kirtner,3756,750,26,20,46,56.5%,34m
4775,3,FcukAmerica,3756,144,8,1,9,88.9%,28m
4775,3,YoYoMan,3756,90,4,3,7,57.1%,9m
4775,2,Goatherd,3756,62,3,0,3,100.0%,43m
4775,2,Lslurpeek,3756,0,1,0,1,100.0%,32m
4775,2,[sbuX]SGxQtpiE,3756,0,0,1,1,0.0%,19m
4775,2,Kneeper,3756,0,0,2,2,0.0%,20m
4783,2,FamilyGuy,3755,1415,105,94,199,52.8%,13m
4783,2,HotSoupForJD,3755,1115,51,30,81,63.0%,10m
4783,2,TerranShtUp,3755,124,5,5,10,50.0%,28m
4783,1,[PCAKE]NOFLAMYBLADE,3755,119,3,0,3,100.0%,22m
4783,2,LowApm,3755,96,3,4,7,42.9%,30m
4783,2,CycoDragon,3755,32,2,2,4,50.0%,30m
4789,2,[AiMY0N]JoSeonHurJun,3754,1050,56,51,107,52.3%,34m
4789,2,[SmokeH]Evilbullet,3754,265,12,15,27,44.4%,20m
4789,2,Zoe,3754,242,9,6,15,60.0%,8m
4789,2,Novarion,3754,151,8,5,13,61.5%,17m
4789,2,Sweusa,3754,222,8,10,18,44.4%,16m
4789,2,FiftyNinth,3754,142,5,9,14,35.7%,13m
4789,2,Coolkid,3754,60,2,4,6,33.3%,22m
4789,2,[UWSC]SqR,3754,0,1,1,2,50.0%,30m
4797,1,[TeriS]rollinondubs,3753,1891,412,366,778,53.0%,14m
4797,2,SoulShine,3753,1180,96,70,166,57.8%,26m
4797,2,[LCE]Kageyama,3753,1081,81,7,88,92.0%,18m
4797,2,Nowhere,3753,1388,55,46,101,54.5%,40m
4797,1,ApieceOfCake,3753,991,28,35,63,44.4%,12m
4797,2,[MLC]JelQQing,3753,547,20,25,45,44.4%,16m
4797,2,FURY,3753,450,17,18,35,48.6%,16m
4797,2,Harpegnathos,3753,112,7,0,7,100.0%,5m
4797,3,ripcodebarre,3753,30,4,5,9,44.4%,38m
4797,2,TheSaintBat,3753,58,3,0,3,100.0%,23m
4797,2,TheReapist,3753,0,1,0,1,100.0%,23m
4797,2,GeneralSuYu,3753,0,0,3,3,0.0%,41m
4797,2,Kodiak,3753,0,0,5,5,0.0%,43m
4810,2,IIIIIIIIIIII,3752,62,3,1,4,75.0%,25m
4810,2,[KingSC]LSPisBack,3752,30,2,1,3,66.7%,16m
4810,2,[ShoutV]ZITFRIT,3752,60,2,6,8,25.0%,13m
4810,2,Mint,3752,0,1,1,2,50.0%,39m
4810,2,TraderJoe,3752,0,0,1,1,0.0%,32m
4810,2,FTJ,3752,0,0,2,2,0.0%,30m
4816,1,fredy,3751,1796,144,142,286,50.3%,14m
4816,2,[WeMore]Jaba,3751,804,133,132,265,50.2%,13m
4816,1,CoolDeath,3751,1266,71,64,135,52.6%,17m
4816,2,[Inner]Slayer,3751,206,8,3,11,72.7%,30m
4816,2,moki,3751,90,4,1,5,80.0%,11m
4816,2,PRoSu,3751,88,3,2,5,60.0%,42m
4816,2,steve,3751,0,0,3,3,0.0%,43m
4823,1,Metagenesis,3750,1327,93,93,186,50.0%,7m
4823,2,NBK,3750,728,35,17,52,67.3%,15m
4823,2,jimmypoi,3750,340,11,16,27,40.7%,25m
4823,2,[VENSC2]Lucho,3750,90,4,2,6,66.7%,27m
4823,2,moistcheetos,3750,30,1,1,2,50.0%,32m
4828,2,[urEZaF]Nerd,3749,789,37,30,67,55.2%,43m
4828,2,South,3749,30,2,0,2,100.0%,39m
4828,2,Lolutooeasy,3749,36,2,1,3,66.7%,39m
4828,2,shrooooooomz,3749,0,1,0,1,100.0%,43m
4832,1,Smarty,3748,1900,273,274,547,49.9%,30m
4832,1,[SolOGS]WHYsoSERioUs,3748,948,24,36,60,40.0%,22m
4832,2,happyhusky,3748,496,21,17,38,55.3%,27m
4832,3,DeGaulle,3748,210,11,1,12,91.7%,21m
4832,2,lllIIIlIIllI,3748,194,7,2,9,77.8%,16m
4832,2,Flower,3748,252,6,10,16,37.5%,35m
4832,2,[hTx]JackStark,3748,114,5,7,12,41.7%,37m
4832,2,Stranger,3748,98,3,3,6,50.0%,36m
4832,3,Jutso,3748,97,2,0,2,100.0%,28m
4832,2,[KPG]SeleiXi,3748,30,1,1,2,50.0%,31m
4842,2,[ZTempz]Fluorescent,3747,1593,210,197,407,51.6%,39m
4842,2,[SAUNA]kakapoopie,3747,1673,154,124,278,55.4%,22m
4842,1,[cl0udM]OveR,3747,1780,55,68,123,44.7%,30m
4842,2,Mordant,3747,537,30,22,52,57.7%,43m
4842,2,IIIllIlIlIIl,3747,174,6,5,11,54.5%,5m
4842,2,[GdAT]Uply,3747,132,5,8,13,38.5%,30m
4842,2,[PuffWC]Allen,3747,34,1,2,3,33.3%,14m
4842,2,SpartnBlade,3747,0,0,1,1,0.0%,9m
4850,2,[xRtG]TheSizzler,3746,338,13,13,26,50.0%,20m
4850,1,[SqR]KaySee,3746,140,7,0,7,100.0%,31m
4850,3,llllllllllll,3746,0,0,3,3,0.0%,41m
4853,2,[CP5]Jokerx,3745,1157,84,75,159,52.8%,8m
4853,2,[ExcIgN]RTavik,3745,1514,57,56,113,50.4%,18m
4853,2,[APTX]CyborgChina,3745,1072,54,42,96,56.2%,42m
4853,2,dolingo,3745,489,35,22,57,61.4%,35m
4853,2,FenceJumper,3745,828,29,32,61,47.5%,39m
4853,2,Matt,3745,674,28,26,54,51.9%,32m
4853,1,[Digged]LastMarine,3745,119,7,0,7,100.0%,39m
4853,2,SteveMcQueen,3745,0,1,0,1,100.0%,23m
4853,2,KingNothing,3745,0,1,4,5,20.0%,22m
4862,2,[CMU]MagejiToss,3744,1405,143,152,295,48.5%,16m
4862,2,[xLgNx]terran,3744,1018,119,102,221,53.8%,31m
4862,2,[BoAVN]ddeaf,3744,1246,62,67,129,48.1%,30m
4862,2,MungTheKing,3744,811,38,18,56,67.9%,22m
4862,2,[lCeMan]iCeMan,3744,513,19,15,34,55.9%,11m
4862,2,Demonee,3744,330,12,11,23,52.2%,43m
4862,2,HectorOfTroy,3744,0,1,0,1,100.0%,25m
4862,2,Boban,3744,88,1,1,2,50.0%,32m
4870,2,Gatsby,3743,684,56,39,95,58.9%,23m
4870,2,[ShoaL]Archie,3743,821,48,41,89,53.9%,8m
4870,2,[Pig2]MaelStorm,3743,1132,45,37,82,54.9%,5m
4870,2,[BELDA]Geno,3743,120,5,5,10,50.0%,25m
4870,2,SharpShooter,3743,0,1,0,1,100.0%,36m
4870,2,IronmanDies,3743,0,1,0,1,100.0%,23m
4870,3,[GEEKED]Laurience,3743,0,1,0,1,100.0%,38m
4870,2,Leben,3743,30,1,1,2,50.0%,30m
4870,3,[xRtG]Nesquik,3743,30,1,2,3,33.3%,25m
4870,2,[htpk]htpkChancE,3743,0,0,1,1,0.0%,22m
4870,2,Veni,3743,0,0,1,1,0.0%,42m
4870,2,ItsJunKie,3743,0,0,2,2,0.0%,16m
4870,2,Sammuelmumm,3743,0,0,2,2,0.0%,39m
4883,2,LostMarine,3742,1222,97,79,176,55.1%,26m
4883,2,Tallarin,3742,811,92,85,177,52.0%,32m
4883,2,phantomking,3742,404,87,5,92,94.6%,34m
4883,2,[Sc2Bo]StarWalker,3742,421,31,24,55,56.4%,26m
4883,2,MiniSpeCial,3742,109,18,5,23,78.3%,16m
4883,2,BePositive,3742,354,17,9,26,65.4%,43m
4883,2,IlIlllllIIII,3742,154,7,11,18,38.9%,5m
4883,2,llllllllllll,3742,170,5,8,13,38.5%,35m
4883,2,KaddyGirl,3742,0,1,2,3,33.3%,32m
4883,2,TokenBlack,3742,0,0,1,1,0.0%,42m
4893,1,[NeOx1]Cygnus,3741,1859,234,241,475,49.3%,27m
4893,2,[Ari0n]Iceman,3741,1619,216,205,421,51.3%,34m
4893,2,[YD2K]rAEL,3741,1607,130,126,256,50.8%,13m
4893,2,BigTerran,3741,731,39,11,50,78.0%,27m
4893,2,TsogiMaster,3741,229,12,4,16,75.0%,20m
4893,2,[GØSU]GluffalO,3741,0,1,0,1,100.0%,29m
4893,2,JoeBiden,3741,0,1,1,2,50.0%,43m
4900,2,sosimhanori,3740,1653,171,160,331,51.7%,5m
4900,1,[Crew]RallosZek,3740,1694,69,80,149,46.3%,5m
4900,2,TheFirstOne,3740,1051,53,25,78,67.9%,18m
4900,2,[GRNSKN]monkaSniper,3740,298,11,12,23,47.8%,23m
4900,2,TwoOutOfTen,3740,34,1,1,2,50.0%,27m
4900,2,iGreedyBoy,3740,0,1,1,2,50.0%,10m
4900,2,[SoVA]Shaeman,3740,0,0,5,5,0.0%,33m
4907,2,BaDNeWs,3739,1603,88,97,185,47.6%,13m
4907,1,[SftVgn]bAnza,3739,1786,76,94,170,44.7%,26m
4907,2,Obnehz,3739,1466,63,50,113,55.8%,18m
4907,1,[HAAAAI]MiaTheDog,3739,1088,31,43,74,41.9%,27m
4907,2,vvoven,3739,602,22,21,43,51.2%,18m
4907,2,Dengthink,3739,146,16,19,35,45.7%,19m
4907,2,Houdini,3739,122,2,3,5,40.0%,29m
4907,2,[DoNai]corn,3739,0,2,3,5,40.0%,17m
4907,2,[QTp2T]AaronChan,3739,0,0,1,1,0.0%,18m
4907,2,SuperiaHands,3739,0,0,1,1,0.0%,23m
4907,2,DrGonzo,3739,0,0,3,3,0.0%,41m
4918,2,[FoxeR]FoxeR,3738,1449,146,127,273,53.5%,5m
4918,1,[Cryptc]Mantra,3738,972,26,38,64,40.6%,18m
4918,2,PickleJuice,3738,30,2,2,4,50.0%,39m
4918,2,[NOCTU]Endeavor,3738,60,2,3,5,40.0%,8m
4918,2,RazieL,3738,0,0,2,2,0.0%,31m
4923,1,VDeezNuts,3737,1860,334,351,685,48.8%,7m
4923,1,[OIGE]Droped,3737,1833,215,217,432,49.8%,37m
4923,2,Destroy,3737,412,14,18,32,43.8%,29m
4923,1,IIIIIIIIIIII,3737,97,6,0,6,100.0%,37m
4923,2,oxycodone,3737,30,6,0,6,100.0%,23m
4923,2,[NPhase]Corsive,3737,30,1,1,2,50.0%,24m
4923,2,san,3737,30,1,2,3,33.3%,13m
4930,1,notBonjwa,3736,1862,360,334,694,51.9%,4m
4930,2,[cl0udM]Kakarott,3736,406,16,11,27,59.3%,5m
4930,2,Rolipan,3736,202,9,8,17,52.9%,39m
4930,2,[TGCrew]Carter,3736,90,4,5,9,44.4%,18m
4930,2,Overlord,3736,92,3,4,7,42.9%,43m
4930,2,Sarah,3736,58,2,2,4,50.0%,19m
4930,2,BuddyFred,3736,0,1,0,1,100.0%,24m
4930,2,llllllllllll,3736,0,0,1,1,0.0%,19m
4930,2,[AUC]War,3736,0,0,2,2,0.0%,5m
4939,1,Mesha,3735,1204,161,149,310,51.9%,32m
4939,2,Hazel,3735,1564,156,159,315,49.5%,32m
4939,2,WhatABaka,3735,1128,110,97,207,53.1%,21m
4939,1,Bedsheets,3735,420,56,57,113,49.6%,30m
4939,2,Melon,3735,334,13,3,16,81.2%,9m
4939,3,llllllllllll,3735,263,12,4,16,75.0%,39m
4939,2,IIlllIIlllIl,3735,160,6,3,9,66.7%,33m
4939,2,[SNSD]Zemagdnim,3735,150,5,6,11,45.5%,26m
4939,2,dgs,3735,0,0,1,1,0.0%,30m
4948,1,[GGK]Metaphysics,3734,1854,147,159,306,48.0%,15m
4948,1,nowitzki,3734,1861,127,128,255,49.8%,27m
4948,2,[PTHero]CharactR,3734,1178,50,42,92,54.3%,34m
4948,2,[muGGer]Fatman,3734,106,10,15,25,40.0%,30m
4948,1,Mon,3734,118,7,0,7,100.0%,43m
4948,3,[xMARlA]Avilo,3734,162,7,1,8,87.5%,7m
4948,2,[CallGG]TerranNoob,3734,202,6,8,14,42.9%,27m
4948,2,Dream,3734,86,4,2,6,66.7%,41m
4948,2,INnoWill,3734,0,1,0,1,100.0%,39m
4948,2,XxXxCYKAxXxX,3734,0,0,1,1,0.0%,14m
4958,2,Dart,3733,248,10,9,19,52.6%,13m
4958,2,koodoo,3733,148,6,5,11,54.5%,21m
4958,2,[AthSun]BeNzX,3733,0,1,0,1,100.0%,7m
4958,2,[AFM]NastyStorm,3733,0,0,2,2,0.0%,19m
4958,2,SoShy,3733,0,0,2,2,0.0%,34m
4963,2,Uruk,3732,1578,112,113,225,49.8%,24m
4963,2,Loon,3732,496,18,13,31,58.1%,5m
4963,2,[SsaYnS]BigMac,3732,437,17,14,31,54.8%,32m
4963,2,Chihaya,3732,292,11,1,12,91.7%,13m
4963,2,Halfquake,3732,207,11,2,13,84.6%,11m
4963,2,WkDx,3732,266,11,3,14,78.6%,7m
4963,1,lililillliil,3732,119,7,0,7,100.0%,43m
4963,2,iGeddit,3732,136,5,3,8,62.5%,33m
4963,2,Totrasmek,3732,0,0,1,1,0.0%,30m
4963,3,Zappy,3732,0,0,1,1,0.0%,34m
4963,2,Qwoto,3732,0,0,2,2,0.0%,10m
4963,2,IlIIIlIIlIII,3732,0,0,2,2,0.0%,19m
4963,2,HugeTosser,3732,0,0,2,2,0.0%,26m
4976,2,Mstrkrft,3731,1398,148,126,274,54.0%,7m
4976,2,TheBest,3731,996,42,22,64,65.6%,24m
4976,2,[YD2K]LinHan,3731,635,35,20,55,63.6%,9m
4976,2,PITTIPIT,3731,286,11,6,17,64.7%,43m
4976,2,Biel,3731,109,5,2,7,71.4%,5m
4976,2,[JPOW]DankMaster,3731,0,0,1,1,0.0%,35m
4976,2,Realstreetg,3731,0,0,2,2,0.0%,31m
4976,2,TheFatOne,3731,0,0,5,5,0.0%,21m
4984,1,JBlaze,3730,1763,205,190,395,51.9%,8m
4984,2,[GOPERÚ]AyaxFenix,3730,1229,60,30,90,66.7%,17m
4984,2,[MSUsc2]Crimson,3730,1320,50,60,110,45.5%,20m
4984,2,Skewmer,3730,432,16,14,30,53.3%,31m
4984,2,Volundr,3730,180,7,8,15,46.7%,11m
4984,3,FunkyMonkey,3730,206,6,1,7,85.7%,40m
4984,2,Boop,3730,30,2,2,4,50.0%,29m
4984,2,[BioTek]Guren,3730,64,2,6,8,25.0%,17m
4984,2,[OPLB]LoribleStar,3730,0,0,1,1,0.0%,16m
4993,1,JOSE,3729,1866,325,323,648,50.2%,25m
4993,2,[xLgNx]BOMBER,3729,1610,252,248,500,50.4%,16m
4993,2,[TeamLT]eeMoo,3729,875,132,132,264,50.0%,30m
4993,2,[eX]Death,3729,513,123,106,229,53.7%,25m
4993,2,WeirdRat,3729,1392,67,65,132,50.8%,40m
4993,2,Ramen,3729,824,29,36,65,44.6%,8m
4993,3,BossOfTheGym,3729,194,10,4,14,71.4%,39m
4993,3,TeppaH,3729,0,1,0,1,100.0%,28m
4993,2,[CARNES]Ekemet,3729,0,0,1,1,0.0%,23m
5002,1,[HØST]Hotfy,3728,1866,265,271,536,49.4%,27m
5002,2,MRFRISBEEGUY,3728,1452,62,48,110,56.4%,19m
5002,2,[PiGPan]Piccolo,3728,806,57,53,110,51.8%,24m
5002,2,IIIIIIIIIIII,3728,360,17,0,17,100.0%,10m
5002,2,[juggr]PinkFloyd,3728,304,12,5,17,70.6%,24m
5002,2,Johnney,3728,176,6,2,8,75.0%,11m
5002,2,StormShower,3728,114,5,0,5,100.0%,15m
5002,2,[ZTempz]PaRaGoNPasT,3728,58,2,1,3,66.7%,33m
5002,2,[keke]Legotimebomb,3728,32,2,4,6,33.3%,32m
5002,2,DICE,3728,0,0,1,1,0.0%,5m
5002,2,schmuttt,3728,0,0,3,3,0.0%,5m
5002,2,[LONDO]Banagher,3728,0,0,4,4,0.0%,35m
5014,2,IlIlIlIl,3727,890,90,62,152,59.2%,14m
5014,2,rexy,3727,693,29,12,41,70.7%,5m
5014,2,CKCK,3727,538,18,28,46,39.1%,18m
5014,2,CIitorousRex,3727,396,14,18,32,43.8%,16m
5014,2,[TØXIC]Horror,3727,90,4,2,6,66.7%,43m
5014,2,QcGold,3727,30,1,7,8,12.5%,39m
5020,1,[SALTDY]inEVItabLe,3726,1732,287,285,572,50.2%,5m
5020,1,Whackatoe,3726,1860,126,133,259,48.6%,31m
5020,1,Erlidd,3726,1486,69,84,153,45.1%,13m
5020,2,[Ex7rA]Nobody,3726,364,39,27,66,59.1%,12m
5020,1,REEEESCE,3726,1104,29,50,79,36.7%,15m
5020,1,ExpectUs,3726,470,12,23,35,34.3%,21m
5020,2,[CalEnt]chubs,3726,0,1,2,3,33.3%,31m
5020,2,[urdone]Nujabes,3726,0,0,1,1,0.0%,27m
5028,2,[TeamUR]Andacht,3725,1615,74,75,149,49.7%,26m
5028,2,Oriens,3725,228,8,7,15,53.3%,42m
5028,3,[So0]youkka,3725,120,6,14,20,30.0%,3m
5028,2,[MSCE]Pochi,3725,0,1,0,1,100.0%,41m
5028,2,[GR33D]wert,3725,0,0,1,1,0.0%,33m
5028,2,LADodgers,3725,0,0,1,1,0.0%,43m
5034,2,Saladin,3724,1594,86,83,169,50.9%,43m
5034,2,Random,3724,764,38,13,51,74.5%,21m
5034,2,[SDairy]Sheepwalla,3724,250,26,25,51,51.0%,32m
5034,2,DeKuJ,3724,449,21,8,29,72.4%,11m
5034,2,BobEsponja,3724,378,18,0,18,100.0%,8m
5034,2,Eureka,3724,268,10,8,18,55.6%,17m
5034,2,[AgK]Yatogami,3724,188,7,9,16,43.8%,13m
5034,2,rokgrlee,3724,114,4,4,8,50.0%,11m
5034,3,Bogue,3724,121,3,1,4,75.0%,23m
5043,2,VIPstabcity,3723,1529,134,131,265,50.6%,31m
5043,1,AceHawk,3723,597,95,108,203,46.8%,37m
5043,2,Sharedw,3723,324,16,17,33,48.5%,19m
5043,3,OnEWiPe,3723,240,12,4,16,75.0%,9m
5043,2,[ZNsc]elTavo,3723,214,9,0,9,100.0%,36m
5043,2,[0sC]fasTfingah,3723,130,4,8,12,33.3%,39m
5043,2,zakeN,3723,114,3,3,6,50.0%,13m
5043,2,ace,3723,0,1,1,2,50.0%,35m
5043,2,[Sugoi]KaZTy,3723,0,0,1,1,0.0%,43m
5043,2,Werm,3723,0,0,1,1,0.0%,16m
5043,2,GaryTheDrone,3723,0,0,1,1,0.0%,14m
5054,2,[BlTEL]Orus,3722,1463,61,55,116,52.6%,34m
5054,2,PAPAMUSK,3722,683,49,53,102,48.0%,20m
5054,2,Sam,3722,312,17,4,21,81.0%,33m
5054,2,Mando,3722,183,10,11,21,47.6%,27m
5054,1,[NoBads]pimba,3722,204,6,20,26,23.1%,35m
5054,1,FourGate,3722,48,1,2,3,33.3%,14m
5054,2,Thx,3722,0,0,1,1,0.0%,29m
5061,2,Edson,3721,1532,276,273,549,50.3%,25m
5061,2,MustBeHaxBro,3721,499,124,83,207,59.9%,20m
5061,1,Angus,3721,1221,101,119,220,45.9%,30m
5061,1,Shockz,3721,645,46,41,87,52.9%,21m
5061,2,[DRKAPP]Aquarius,3721,831,37,37,74,50.0%,32m
5061,2,TenDer,3721,726,28,21,49,57.1%,21m
5061,2,[Sliq]Samo,3721,402,14,15,29,48.3%,36m
5061,2,MsCarriage,3721,281,10,7,17,58.8%,36m
5061,3,nOobO,3721,173,5,8,13,38.5%,25m
5061,2,Lienax,3721,30,1,3,4,25.0%,39m
5061,2,Scottbear,3721,0,0,1,1,0.0%,43m
5061,2,[C96741]Ares,3721,0,0,1,1,0.0%,35m
5073,2,IIIIIII,3720,1346,56,60,116,48.3%,22m
5073,2,Penguin,3720,344,12,17,29,41.4%,22m
5073,3,[TryHrd]MasterMind,3720,224,9,8,17,52.9%,40m
5073,2,CaliberX,3720,71,8,6,14,57.1%,34m
5073,3,[XIE233]TTslucifer,3720,60,2,3,5,40.0%,28m
5073,2,YeN,3720,0,1,0,1,100.0%,9m
5073,2,[FMX]Slar,3720,0,1,0,1,100.0%,12m
5073,1,[KTFBRO]HyanGToSS,3720,0,0,1,1,0.0%,22m
5073,2,[LVLZ8]EverLovelyz,3720,0,0,1,1,0.0%,33m
5082,1,[Unify]CouzinX,3719,1784,150,141,291,51.5%,7m
5082,2,Wolfhead,3719,1455,85,39,124,68.5%,5m
5082,2,IllIIlIlllI,3719,406,15,13,28,53.6%,41m
5082,3,Erik,3719,310,14,5,19,73.7%,22m
5082,1,[Flam3s]SatoRhythm,3719,444,10,33,43,23.3%,25m
5082,2,mQvQm,3719,119,6,0,6,100.0%,10m
5082,2,Sosh,3719,114,4,3,7,57.1%,35m
5082,2,llllllllllll,3719,60,3,4,7,42.9%,12m
5082,2,Unknown,3719,68,2,5,7,28.6%,11m
5082,2,Jones,3719,0,1,0,1,100.0%,7m
5092,1,murkertrer,3718,1768,228,232,460,49.6%,18m
5092,1,[AD3C]Whisper,3718,1626,137,144,281,48.8%,29m
5092,1,Salieri,3718,1181,124,125,249,49.8%,26m
5092,2,CakeEater,3718,30,2,4,6,33.3%,24m
5092,2,[SsaYnS]HerTia,3718,30,1,3,4,25.0%,34m
5097,2,Pinakaleada,3717,1093,56,44,100,56.0%,14m
5097,2,yak,3717,210,11,3,14,78.6%,21m
5097,2,Salamanca,3717,0,2,3,5,40.0%,26m
5097,2,Dalton,3717,0,0,1,1,0.0%,23m
5097,2,FinalFlash,3717,0,0,1,1,0.0%,7m
5102,2,Prime,3716,1594,71,59,130,54.6%,38m
5102,2,OnlyLoveYou,3716,1334,53,50,103,51.5%,39m
5102,1,[LexL]xHELLxGab,3716,1622,51,63,114,44.7%,44m
5102,2,Maraudeur,3716,811,43,14,57,75.4%,33m
5102,2,[Lp]Zelaznog,3716,710,30,22,52,57.7%,37m
5102,2,Justonemore,3716,225,8,1,9,88.9%,6m
5102,1,stevensigal,3716,118,7,0,7,100.0%,32m
5102,2,baramz,3716,212,7,7,14,50.0%,41m
5102,2,Ralphlauren,3716,180,6,9,15,40.0%,7m
5102,2,Resolution,3716,0,1,1,2,50.0%,33m
5112,2,[cumy]Updraft,3715,371,22,24,46,47.8%,16m
5112,2,LastHurrah,3715,262,14,6,20,70.0%,25m
5112,2,llIlIllllllI,3715,214,11,3,14,78.6%,11m
5112,2,Reaper,3715,266,9,9,18,50.0%,43m
5112,3,[αXLa]HeartBeatX,3715,242,8,3,11,72.7%,21m
5112,2,ThorBlob,3715,166,7,7,14,50.0%,39m
5112,2,Frosty,3715,68,2,8,10,20.0%,31m
5112,2,YOUNG,3715,0,0,1,1,0.0%,33m
5112,2,Saenz,3715,0,0,3,3,0.0%,34m
5121,1,[TheReg]Frost,3714,1808,269,261,530,50.8%,25m
5121,2,[Maegis]Red,3714,844,169,137,306,55.2%,44m
5121,1,[ØFoxF2]MrFahrenheit,3714,1434,113,122,235,48.1%,5m
5121,1,FroggyStylez,3714,1231,62,66,128,48.4%,5m
5121,2,[αB]Bloodless,3714,1401,60,60,120,50.0%,43m
5121,2,[GgARMY]TaitaCáceres,3714,1023,59,62,121,48.8%,21m
5121,1,Megatron,3714,767,28,39,67,41.8%,34m
5121,2,DeezNutz,3714,262,25,24,49,51.0%,31m
5121,2,AwsomeOcelot,3714,215,10,5,15,66.7%,37m
5121,2,Xzibit,3714,0,3,2,5,60.0%,10m
5121,2,[cloudM]Yarters,3714,0,0,1,1,0.0%,18m
5132,2,Maru,3713,1529,165,153,318,51.9%,42m
5132,2,infestEd,3713,748,45,30,75,60.0%,26m
5132,2,IIIIIIIIIIII,3713,778,32,28,60,53.3%,24m
5132,2,DescenT,3713,450,20,11,31,64.5%,34m
5132,2,HonestIago,3713,370,15,9,24,62.5%,43m
5132,3,Spoon,3713,151,4,3,7,57.1%,37m
5132,2,NONvirgin,3713,66,3,3,6,50.0%,31m
5132,2,UgandaFlaSh,3713,97,2,1,3,66.7%,10m
5132,2,[HOV]vivialdi,3713,0,0,1,1,0.0%,18m
5141,2,TheSecret,3712,1579,188,195,383,49.1%,27m
5141,2,CTRL,3712,520,19,22,41,46.3%,16m
5141,1,IIIIIIIIII,3712,144,7,1,8,87.5%,25m
5141,2,asdasd,3712,88,5,7,12,41.7%,31m
5141,2,Dishnoutlulz,3712,0,1,0,1,100.0%,37m
5141,2,llllllllllll,3712,0,1,0,1,100.0%,39m
5147,2,vme,3711,1399,110,105,215,51.2%,30m
5147,2,[phog]Savage,3711,831,75,56,131,57.3%,35m
5147,2,[SHMALO]Python,3711,692,26,21,47,55.3%,37m
5147,2,RedShadow,3711,656,25,29,54,46.3%,41m
5147,3,SkytosPrintr,3711,165,4,1,5,80.0%,42m
5147,2,gNASHER,3711,0,1,0,1,100.0%,22m
5147,2,Brothers,3711,30,1,3,4,25.0%,12m
5147,2,Symphony,3711,0,0,1,1,0.0%,39m
5155,2,[ZTemps]Christopher,3710,1258,69,40,109,63.3%,30m
5155,2,[ZTemp]karen,3710,1010,66,32,98,67.3%,26m
5155,2,WOLAIZHENGFU,3710,357,26,27,53,49.1%,25m
5155,2,MushoBetis,3710,478,17,20,37,45.9%,17m
5155,1,[NLTN]fob,3710,470,11,21,32,34.4%,26m
5155,2,DVV,3710,30,2,2,4,50.0%,34m
5155,2,boxxxcutter,3710,60,2,2,4,50.0%,17m
5155,2,[DTXt]Deluxe,3710,0,0,1,1,0.0%,36m
5163,1,Ashby,3709,1699,123,132,255,48.2%,18m
5163,2,Critter,3709,660,86,72,158,54.4%,43m
5163,2,HairyPawter,3709,994,40,32,72,55.6%,6m
5163,2,ZigSputnik,3709,168,5,8,13,38.5%,30m
5163,2,Fluffy,3709,0,1,5,6,16.7%,39m
5168,2,historian,3708,178,10,3,13,76.9%,39m
5168,2,MiseryCloud,3708,120,4,7,11,36.4%,18m
5168,2,Jawsbar,3708,18,2,1,3,66.7%,41m
5168,3,[KSGT]pusagi,3708,30,2,3,5,40.0%,3m
5172,2,[JERGLS]Moe,3707,857,47,48,95,49.5%,4m
5172,2,Apollo,3707,650,30,19,49,61.2%,35m
5172,2,[SuperZ]MINiUltra,3707,246,9,3,12,75.0%,43m
5172,2,THAGUNSHOW,3707,30,1,2,3,33.3%,24m
5172,2,LukasVane,3707,0,0,1,1,0.0%,19m
5172,2,ImbaLaCouill,3707,0,0,1,1,0.0%,12m
5172,1,Protoss,3707,0,0,3,3,0.0%,10m
5179,1,lamycnd,3706,1756,162,186,348,46.6%,17m
5179,2,[jCp]sTandUhmAn,3706,1547,91,77,168,54.2%,17m
5179,2,[SsaYnS]SabeRLighT,3706,730,31,17,48,64.6%,18m
5179,2,[cl0udM]KilgoreTrout,3706,842,29,34,63,46.0%,13m
5179,2,[uWu69]CollinCobra,3706,662,26,23,49,53.1%,16m
5179,1,[DontRN]Anunnaki,3706,542,13,25,38,34.2%,34m
5179,2,Stoys,3706,114,5,5,10,50.0%,29m
5179,2,[UpeV]Slayer,3706,121,5,7,12,41.7%,22m
5179,3,[Hattck]Sleek,3706,141,4,0,4,100.0%,33m
5179,1,dgs,3706,0,1,0,1,100.0%,28m
5179,2,[NKP]ponigomBR,3706,0,0,1,1,0.0%,18m
5190,1,Stone,3705,1862,200,220,420,47.6%,4m
5190,2,Knight,3705,1578,178,190,368,48.4%,30m
5190,2,[BIZCUT]Maphtar,3705,1569,149,136,285,52.3%,26m
5190,2,AsherBro,3705,782,43,29,72,59.7%,19m
5190,2,Lcm,3705,564,41,39,80,51.2%,24m
5190,2,TAO,3705,434,19,14,33,57.6%,31m
5190,3,COA,3705,167,9,2,11,81.8%,11m
5190,2,Fsd,3705,204,7,8,15,46.7%,25m
5190,3,[Dopa]Dopa,3705,0,1,0,1,100.0%,5m
5190,2,[Monash]Potdunk,3705,0,1,0,1,100.0%,23m
5190,2,[X17]Kyhol,3705,0,1,2,3,33.3%,23m
5201,2,Bleh,3704,1606,214,201,415,51.6%,11m
5201,2,Ganman,3704,896,96,87,183,52.5%,20m
5201,2,[TGosuC]Neptune,3704,1201,59,52,111,53.2%,12m
5201,2,meva,3704,889,37,22,59,62.7%,4m
5201,2,Jersey,3704,579,34,32,66,51.5%,19m
5201,2,[DhZon3]Rangel,3704,596,23,20,43,53.5%,22m
5201,2,BetaStar,3704,312,12,11,23,52.2%,19m
5201,2,Jimihendrix,3704,52,3,2,5,60.0%,30m
5201,3,Aztrack,3704,0,1,0,1,100.0%,26m
5201,2,[MMBCA]VISION,3704,30,1,1,2,50.0%,33m
5201,2,[LimaSC]Metalero,3704,30,1,2,3,33.3%,17m
5201,3,Nalyd,3704,30,1,3,4,25.0%,35m
5201,2,ZynKy,3704,0,0,1,1,0.0%,10m
5201,2,[ScOGs]Camms,3704,0,0,3,3,0.0%,26m
5215,2,llllllIIIIII,3703,871,62,28,90,68.9%,41m
5215,2,jason,3703,599,30,14,44,68.2%,10m
5215,3,IIIIIIIIIII,3703,337,12,2,14,85.7%,32m
5215,2,[NKT1]MaZarinE,3703,234,9,5,14,64.3%,11m
5215,2,[SsaYnS]Tachypsychia,3703,142,6,10,16,37.5%,22m
5215,1,IlIlIlIlIlll,3703,118,5,1,6,83.3%,25m
5215,2,[AlIin]sandri,3703,0,0,1,1,0.0%,17m
5215,2,[Amiwis]dementor,3703,0,0,1,1,0.0%,27m
5223,1,Acedia,3702,1738,101,117,218,46.3%,26m
5223,2,general,3702,1000,83,81,164,50.6%,43m
5223,2,[Fever]obamasmom,3702,1076,61,51,112,54.5%,30m
5223,2,[UVUSC2]Sojourn,3702,630,23,25,48,47.9%,17m
5223,2,Ironface,3702,340,14,8,22,63.6%,24m
5223,2,[KappaN]TayFio,3702,410,14,22,36,38.9%,19m
5223,3,Maximus,3702,313,11,5,16,68.8%,40m
5223,1,Imp,3702,97,4,0,4,100.0%,17m
5223,2,[ValidG]blast,3702,86,3,4,7,42.9%,27m
5223,2,BigHoss,3702,70,3,5,8,37.5%,17m
5223,2,[MSganG]Zaria,3702,58,2,6,8,25.0%,34m
5223,2,[lLiTl]Paradimez,3702,0,0,2,2,0.0%,39m
5223,2,Yooshiii,3702,73,0,4,4,0.0%,33m
5236,2,Tacoeveryday,3701,1609,140,131,271,51.7%,8m
5236,2,ALuCARD,3701,1573,99,91,190,52.1%,23m
5236,2,[Schwar]Sky,3701,1133,99,101,200,49.5%,31m
5236,2,Bazse,3701,1540,94,80,174,54.0%,7m
5236,2,[NwAs]Kche,3701,1619,84,83,167,50.3%,24m
5236,2,Gaia,3701,469,22,12,34,64.7%,25m
5236,2,zoolander,3701,374,21,15,36,58.3%,24m
5236,3,[WKNDA]Phungus,3701,238,9,4,13,69.2%,21m
5236,1,Yopi,3701,141,8,0,8,100.0%,34m
5236,2,[CO0MY]Skeetus,3701,168,7,2,9,77.8%,18m
5236,2,[FANXY]KYCHEN,3701,92,4,1,5,80.0%,6m
5236,3,OGRIM,3701,147,4,2,6,66.7%,9m
5236,2,[hahaez]Nuhzadon,3701,60,2,2,4,50.0%,39m
5236,2,SCAChoi,3701,0,2,3,5,40.0%,26m
5236,2,BlueRa,3701,99,1,4,5,20.0%,22m
5251,2,BobEsponja,3700,1533,126,117,243,51.9%,34m
5251,1,[PLOWU]DayMan,3700,1470,63,62,125,50.4%,18m
5251,2,[ROCKSC]BAEM,3700,1210,52,50,102,51.0%,32m
5251,1,[FKBOIS]Vandal,3700,426,41,47,88,46.6%,26m
5251,2,Parker,3700,145,25,28,53,47.2%,24m
5251,2,[trolz]llllllllllll,3700,468,18,15,33,54.5%,7m
5251,2,Kitten,3700,338,13,7,20,65.0%,39m
5251,2,[NwAs]ROY,3700,294,11,7,18,61.1%,21m
5251,2,wat,3700,154,9,1,10,90.0%,10m
5251,2,stacysmom,3700,166,7,1,8,87.5%,27m
5251,2,[FANXY]rocto,3700,243,7,7,14,50.0%,11m
5251,3,DaiRY,3700,197,5,5,10,50.0%,11m
5251,2,TakTok,3700,0,1,0,1,100.0%,14m
5251,2,SGTdaTroll,3700,0,0,2,2,0.0%,18m
5265,2,IIIIIIIIIIII,3699,1625,126,122,248,50.8%,19m
5265,2,DeerPark,3699,1530,67,68,135,49.6%,23m
5265,2,hotshot,3699,1141,58,58,116,50.0%,33m
5265,2,[FurheR]ThugLife,3699,388,32,23,55,58.2%,43m
5265,2,Buckshot,3699,486,24,12,36,66.7%,27m
5265,2,[AngelA]Angelus,3699,192,10,4,14,71.4%,32m
5265,2,HTOowen,3699,86,4,1,5,80.0%,16m
5265,2,ions,3699,30,1,2,3,33.3%,44m
5273,2,Comandante,3698,1250,159,138,297,53.5%,34m
5273,2,DOdoubleG,3698,386,12,21,33,36.4%,44m
5273,1,Shinister,3698,426,11,22,33,33.3%,14m
5273,2,legat,3698,256,9,9,18,50.0%,30m
5273,2,lIlIlIlIlIlI,3698,232,8,8,16,50.0%,18m
5273,2,Atlas,3698,0,1,0,1,100.0%,20m
5273,2,[NaDa]Chobo,3698,0,1,2,3,33.3%,30m
5273,2,CrudeAssault,3698,0,0,1,1,0.0%,21m
5273,2,KaiChu,3698,0,0,8,8,0.0%,8m
5282,2,ZurieL,3697,1177,83,91,174,47.7%,15m
5282,2,Lumon,3697,376,51,41,92,55.4%,41m
5282,2,[Figure]Serendipity,3697,783,36,30,66,54.5%,21m
5282,2,Monch,3697,732,26,28,54,48.1%,11m
5282,2,[Labor]noggnowp,3697,327,16,6,22,72.7%,11m
5282,2,GoodLuckHave,3697,0,0,1,1,0.0%,38m
5282,2,SkepticBrain,3697,0,0,1,1,0.0%,37m
5282,2,game,3697,0,0,1,1,0.0%,19m
5282,2,Sankaku,3697,0,0,3,3,0.0%,19m
5291,2,iloom,3696,1549,224,217,441,50.8%,11m
5291,2,[Macac0]Warbandit,3696,1347,116,127,243,47.7%,21m
5291,2,[PiGPan]MaruAmoriani,3696,1449,86,80,166,51.8%,14m
5291,2,[ØFoxF2]XCoNviCTo,3696,1511,83,76,159,52.2%,42m
5291,2,[PobSC]GGMAN,3696,330,11,17,28,39.3%,4m
5291,2,juiCe,3696,102,4,2,6,66.7%,30m
5291,3,[ROS8th]llllIIIIIlIl,3696,0,1,0,1,100.0%,39m
5298,2,Jonatas,3695,821,47,13,60,78.3%,24m
5298,2,Garnovich,3695,971,34,40,74,45.9%,17m
5298,1,llllllllllll,3695,144,8,1,9,88.9%,14m
5298,2,bobthebo,3695,146,6,7,13,46.2%,7m
5298,2,[2faded]LGIMMvp,3695,58,3,0,3,100.0%,19m
5298,2,[EZhax]DonaldTrump,3695,62,2,6,8,25.0%,5m
5298,3,[TSS]Underoath,3695,0,0,1,1,0.0%,25m
5298,2,[Fever]Zarko,3695,0,0,1,1,0.0%,36m
5306,1,BulldogAbby,3694,1678,614,633,1247,49.2%,30m
5306,1,TerranYOUup,3694,1545,408,408,816,50.0%,4m
5306,2,Defender,3694,1633,318,306,624,51.0%,16m
5306,2,[DarkAG]BreaKer,3694,1481,118,115,233,50.6%,32m
5306,2,iAMDEJOUR,3694,1317,84,89,173,48.6%,22m
5306,2,[EvilGC]RodKA,3694,906,71,72,143,49.7%,17m
5306,2,BombQ,3694,472,19,14,33,57.6%,30m
5306,2,happykenny,3694,238,10,2,12,83.3%,27m
5306,2,Hermes,3694,97,2,0,2,100.0%,42m
5306,2,joro,3694,30,1,6,7,14.3%,41m
5306,2,wenks,3694,0,0,1,1,0.0%,25m
5306,2,[CLogic]llllllllllll,3694,0,0,3,3,0.0%,35m
5318,2,nOus,3693,1340,103,105,208,49.5%,21m
5318,2,zzgodmodezz,3693,254,9,14,23,39.1%,21m
5318,2,[Swage]Potential,3693,0,2,3,5,40.0%,38m
5318,2,Zizir,3693,0,1,0,1,100.0%,17m
5322,1,[TSOUR]Rheagan,3692,1229,169,174,343,49.3%,30m
5322,2,[KingSC]Android,3692,1468,123,122,245,50.2%,33m
5322,2,Apollo,3692,551,23,16,39,59.0%,24m
5322,2,[ROCKSC]Yato,3692,590,21,24,45,46.7%,35m
5322,2,sosh,3692,428,18,6,24,75.0%,32m
5322,2,KWH,3692,30,1,1,2,50.0%,19m
5322,2,FullNA,3692,0,0,1,1,0.0%,15m
5329,2,Valdas,3691,498,25,12,37,67.6%,9m
5329,2,LiquiCity,3691,384,14,12,26,53.8%,41m
5329,2,WhiteMonster,3691,188,10,3,13,76.9%,10m
5329,2,[NovaX]TwoMeows,3691,204,8,5,13,61.5%,27m
5329,2,LIM,3691,172,6,5,11,54.5%,39m
5329,2,AuronJecht,3691,30,1,3,4,25.0%,32m
5329,2,Theradorei,3691,0,0,1,1,0.0%,27m
5336,2,SeedingChaos,3690,883,38,40,78,48.7%,41m
5336,2,grosstoss,3690,382,23,17,40,57.5%,18m
5336,2,DIOS,3690,640,22,23,45,48.9%,11m
5336,2,pineapplePie,3690,260,8,15,23,34.8%,27m
5336,2,GMarine,3690,82,3,14,17,17.6%,30m
5336,3,[FyHr]Andy,3690,30,2,0,2,100.0%,38m
5336,2,diamondDRG,3690,0,0,2,2,0.0%,11m
5336,2,ColiNerTiA,3690,0,0,4,4,0.0%,30m
5344,1,[LQV]HasuGosuSoju,3689,1495,80,89,169,47.3%,14m
5344,2,[Emb3rs]NeveaH,3689,722,26,30,56,46.4%,7m
5344,2,[TGosuB]Mack,3689,798,26,35,61,42.6%,29m
5344,1,Zard,3689,118,7,0,7,100.0%,27m
5344,2,llllllllllll,3689,150,6,4,10,60.0%,33m
5349,2,TimonTilT,3688,994,46,42,88,52.3%,17m
5349,2,MiRaGe,3688,438,20,14,34,58.8%,5m
5349,2,llllllllllll,3688,88,3,5,8,37.5%,18m
5349,1,Sandtrout,3688,86,3,11,14,21.4%,44m
5353,2,[MacrOP]Tokie,3687,1562,407,399,806,50.5%,17m
5353,2,[YE3T]ForrestGump,3687,1603,295,278,573,51.5%,11m
5353,2,pBon,3687,1585,278,259,537,51.8%,33m
5353,2,WombRaider,3687,568,21,20,41,51.2%,26m
5353,2,SlayrOfSmoke,3687,92,3,7,10,30.0%,30m
5353,2,[nucle]Evacuate,3687,58,2,1,3,66.7%,5m
5359,2,VDrake,3686,1594,1092,1074,2166,50.4%,44m
5359,2,[TGosuC]xKyouma,3686,1051,50,34,84,59.5%,23m
5359,2,SmackHisFace,3686,756,29,26,55,52.7%,21m
5359,2,[LimaSC]ThinkMV,3686,372,13,17,30,43.3%,5m
5359,2,[CGB]IshBoSheth,3686,140,6,3,9,66.7%,37m
5359,2,[xRtGac]Blue,3686,146,6,3,9,66.7%,39m
5359,2,[Cryptc]Yuey,3686,191,5,3,8,62.5%,42m
5359,2,Destiny,3686,96,4,4,8,50.0%,44m
5359,2,[PSU]OGBerM,3686,0,1,0,1,100.0%,23m
5359,2,Neutrino,3686,0,0,2,2,0.0%,32m
5369,1,BCA,3685,1116,315,314,629,50.1%,7m
5369,1,[RGNK]Sursurrus,3685,734,169,172,341,49.6%,15m
5369,2,IIIIIIIIIIII,3685,1179,61,50,111,55.0%,34m
5369,2,[TB0C]ThousandSons,3685,738,27,27,54,50.0%,30m
5369,2,SandyRavage,3685,548,20,20,40,50.0%,24m
5369,2,NiicDK,3685,164,9,2,11,81.8%,6m
5369,3,Poke,3685,121,3,1,4,75.0%,15m
5369,2,llllllllllll,3685,60,3,3,6,50.0%,18m
5369,2,Grixis,3685,34,1,6,7,14.3%,14m
5369,2,dookies,3685,0,0,1,1,0.0%,27m
5379,2,Zhuderkov,3684,1361,60,50,110,54.5%,39m
5379,2,HeaRT,3684,0,0,1,1,0.0%,27m
5379,2,[xLgNx]Treacherous,3684,0,0,3,3,0.0%,27m
5382,2,Ledrash,3683,946,41,28,69,59.4%,7m
5382,2,Babybean,3683,191,10,3,13,76.9%,4m
5382,2,Multimorbid,3683,97,6,0,6,100.0%,34m
5382,2,[LAGCR]KiPToR,3683,30,2,1,3,66.7%,42m
5382,2,[NPhasA]ThreeBarrack,3683,30,1,3,4,25.0%,25m
5387,2,Rejuxst,3682,1626,317,279,596,53.2%,38m
5387,2,Elios,3682,1578,145,145,290,50.0%,32m
5387,2,[INextI]Destruccion,3682,1111,79,76,155,51.0%,43m
5387,1,llllllllllll,3682,693,26,21,47,55.3%,41m
5387,2,Dksi,3682,93,11,9,20,55.0%,17m
5387,2,[MadK]Marte,3682,120,5,2,7,71.4%,34m
5387,2,GreasyWiener,3682,60,3,1,4,75.0%,33m
5387,2,Mesina,3682,0,3,2,5,60.0%,39m
5387,2,gch,3682,58,2,5,7,28.6%,17m
5387,2,Whirros,3682,0,1,4,5,20.0%,18m
5397,2,[LDCO]dosportres,3681,1577,251,230,481,52.2%,44m
5397,2,Nungg,3681,853,59,72,131,45.0%,30m
5397,3,Darkimal,3681,236,11,4,15,73.3%,19m
5397,2,DouDou,3681,268,9,13,22,40.9%,4m
5397,2,prinscipe,3681,90,3,4,7,42.9%,27m
5397,2,Zenith,3681,0,0,1,1,0.0%,11m
5397,2,JiriBird,3681,0,0,2,2,0.0%,41m
5397,2,YemaThar,3681,0,0,2,2,0.0%,33m
5405,1,GarbageCan,3680,1699,149,155,304,49.0%,22m
5405,2,[TheSix]CerpinTaxt,3680,1554,97,79,176,55.1%,33m
5405,1,[OIGE]RENDER,3680,1845,67,83,150,44.7%,12m
5405,1,[BBN]Akamu,3680,1204,56,48,104,53.8%,22m
5405,2,[MIT]flyingtaco,3680,1491,54,64,118,45.8%,44m
5405,2,[LPDeTV]Maturtle,3680,30,1,2,3,33.3%,23m
5411,2,Ceazon,3679,1214,145,141,286,50.7%,43m
5411,2,[KNSH]Imar,3679,1553,124,123,247,50.2%,33m
5411,2,[o42o]XiwAngleDuck,3679,1003,54,63,117,46.2%,44m
5411,2,lIlIlIlIlI,3679,1040,47,45,92,51.1%,30m
5411,2,hodor,3679,928,36,29,65,55.4%,40m
5411,2,tank,3679,411,27,31,58,46.6%,27m
5411,2,LioN,3679,500,19,25,44,43.2%,12m
5411,2,[BRSKR]mmcalum,3679,86,4,0,4,100.0%,32m
5411,1,[Scuba]Carouse,3679,0,0,1,1,0.0%,27m
5420,2,Algaz,3678,1620,124,105,229,54.1%,30m
5420,2,PingPongRice,3678,614,45,34,79,57.0%,9m
5420,2,[Ssok]ian,3678,870,33,34,67,49.3%,42m
5420,2,Grabgesänge,3678,552,20,18,38,52.6%,22m
5420,2,Dackes,3678,188,6,12,18,33.3%,25m
5420,2,IllIIIlllllI,3678,53,2,8,10,20.0%,17m
5420,2,[REPORT]Killer,3678,0,0,1,1,0.0%,11m
5420,2,cozzE,3678,0,0,2,2,0.0%,40m
5428,2,ATC,3677,1611,171,155,326,52.5%,11m
5428,2,[LimaSC]Steimers,3677,674,51,41,92,55.4%,18m
5428,2,[AirA]Blackcat,3677,984,34,39,73,46.6%,27m
5428,2,TrashTier,3677,620,22,23,45,48.9%,24m
5428,2,Speedy,3677,258,12,7,19,63.2%,18m
5428,2,LastDance,3677,216,8,12,20,40.0%,11m
5428,2,[CRAKS]combo,3677,138,5,6,11,45.5%,24m
5428,2,BarackOdrama,3677,0,0,1,1,0.0%,24m
5436,2,ChobitS,3676,1615,128,120,248,51.6%,6m
5436,3,[JlNAIR]IIIIIIIIIIII,3676,233,8,0,8,100.0%,42m
5438,2,[xRtG]Tokuchi,3675,1587,205,193,398,51.5%,32m
5438,2,PurpleMonkey,3675,1363,154,139,293,52.6%,26m
5438,2,[E04]GhOsT,3675,919,41,26,67,61.2%,22m
5438,2,NOGG,3675,694,26,24,50,52.0%,14m
5438,2,PKT,3675,342,11,15,26,42.3%,16m
5438,2,TravTheBav,3675,180,7,10,17,41.2%,39m
5438,2,Shogun,3675,88,4,3,7,57.1%,43m
5438,1,JonKing,3675,48,2,0,2,100.0%,5m
5446,2,[EzyPzY]Darkness,3674,711,55,38,93,59.1%,34m
5446,2,[MOMRF]ChoColate,3674,426,23,22,45,51.1%,16m
5446,2,[CWAL]Changsta,3674,538,19,22,41,46.3%,23m
5446,2,[TGCF]Ransom,3674,152,6,15,21,28.6%,44m
5446,2,[TGosuB]eNrO,3674,0,0,1,1,0.0%,10m
5451,2,blakey,3673,825,248,244,492,50.4%,32m
5451,2,Nocturnal,3673,599,64,54,118,54.2%,23m
5451,2,veemz,3673,662,55,39,94,58.5%,14m
5451,2,BullocH,3673,579,26,22,48,54.2%,32m
5451,2,MorningLappy,3673,32,5,4,9,55.6%,22m
5451,2,nephilim,3673,0,2,3,5,40.0%,13m
5451,2,Kwyjibo,3673,30,2,3,5,40.0%,14m
5451,2,smi,3673,0,1,1,2,50.0%,10m
5451,2,llllllllllll,3673,0,1,4,5,20.0%,10m
5451,2,[ZCAce]SofaKingGood,3673,0,0,1,1,0.0%,31m
5451,2,Kahnwald,3673,0,0,1,1,0.0%,22m
5462,1,FrostDog,3672,1816,609,607,1216,50.1%,18m
5462,2,[OCN]DoomDash,3672,244,9,13,22,40.9%,4m
5462,2,scv,3672,226,8,14,22,36.4%,4m
5462,2,Proxytoss,3672,142,6,9,15,40.0%,23m
5462,2,PATRICK,3672,32,1,2,3,33.3%,9m
5462,2,PooCreator,3672,0,0,1,1,0.0%,43m
5462,2,[ClanZN]DaaD,3672,0,0,3,3,0.0%,5m
5462,2,Echo,3672,0,0,3,3,0.0%,41m
5470,2,KasakiNozomi,3671,1539,120,114,234,51.3%,21m
5470,2,[YD2K]nkapple,3671,1449,117,122,239,49.0%,21m
5470,2,[ShoaL]Robin,3671,490,17,18,35,48.6%,35m
5470,2,Vegunna,3671,272,10,7,17,58.8%,11m
5470,2,Moxie,3671,252,8,3,11,72.7%,27m
5470,2,ilovegoodscv,3671,0,1,0,1,100.0%,18m
5476,2,[4Trump]Spektr,3670,1313,92,98,190,48.4%,14m
5476,2,[WIDOWZ]Mendokusee,3670,1570,90,86,176,51.1%,44m
5476,2,Clean,3670,1404,69,74,143,48.3%,7m
5476,1,zomgscii,3670,1364,35,63,98,35.7%,21m
5476,2,AbsurdEvo,3670,313,22,11,33,66.7%,14m
5476,2,Doucher,3670,517,20,19,39,51.3%,32m
5476,3,[ARNF]TuckingFypo,3670,308,14,8,22,63.6%,44m
5476,2,Shenanigans,3670,374,13,15,28,46.4%,6m
5476,3,TerranHerAss,3670,322,10,10,20,50.0%,33m
5476,2,Sean,3670,120,5,10,15,33.3%,28m
5476,2,Abaddon,3670,116,4,4,8,50.0%,14m
5476,2,Jashin,3670,0,1,0,1,100.0%,22m
5476,2,timenb,3670,0,1,0,1,100.0%,31m
5476,2,WaP,3670,0,1,0,1,100.0%,23m
5476,2,[tr0n]TheZealot,3670,0,0,1,1,0.0%,40m
5491,2,[DIQPTE]aaaaaaaaab,3669,979,91,80,171,53.2%,12m
5491,1,Concrete,3669,1677,82,81,163,50.3%,21m
5491,2,Slaget,3669,1435,70,78,148,47.3%,19m
5491,2,JustAFrog,3669,973,56,13,69,81.2%,4m
5491,2,klover,3669,1360,52,49,101,51.5%,5m
5491,2,LsVtec,3669,1000,43,36,79,54.4%,32m
5491,1,Rammlied,3669,1221,42,66,108,38.9%,12m
5491,2,Barcode,3669,567,23,20,43,53.5%,16m
5491,2,chichoo,3669,30,5,2,7,71.4%,35m
5491,2,[ExcIgN]JoSS,3669,126,4,6,10,40.0%,39m
5491,2,CarBoon,3669,0,1,0,1,100.0%,33m
5491,2,[BREA]Kenny,3669,30,1,2,3,33.3%,30m
5503,2,HyperSco,3668,1238,46,54,100,46.0%,32m
5503,2,[trolz]Dino,3668,622,33,22,55,60.0%,5m
5503,2,[KingSC]DraKen,3668,615,32,25,57,56.1%,44m
5503,2,[DarkAG]SciFiSamurai,3668,544,20,27,47,42.6%,7m
5503,2,Balance,3668,86,3,2,5,60.0%,25m
5503,2,Elonaias,3668,0,1,0,1,100.0%,30m
5503,2,rappeftwlol,3668,0,1,4,5,20.0%,29m
5503,2,DarkShazam,3668,0,0,1,1,0.0%,37m
5503,2,ManoBraw,3668,0,0,1,1,0.0%,19m
5512,1,windfish,3667,850,151,142,293,51.5%,27m
5512,2,MAC,3667,1441,70,72,142,49.3%,33m
5512,2,GAOTU,3667,1029,43,32,75,57.3%,18m
5512,3,SaltySalmon,3667,345,16,8,24,66.7%,36m
5512,2,ÐangerOus,3667,0,3,2,5,60.0%,35m
5512,2,[Axony]LuzAriels,3667,0,0,1,1,0.0%,44m
5518,2,Weever,3666,233,18,18,36,50.0%,38m
5518,2,SPACEJUNGLER,3666,60,3,2,5,60.0%,43m
5518,2,CHARGER,3666,0,1,0,1,100.0%,30m
5521,2,crazybanana,3665,1576,249,245,494,50.4%,17m
5521,2,Trilobite,3665,868,30,38,68,44.1%,39m
5521,2,[UpeV]Dijovi,3665,224,7,15,22,31.8%,44m
5521,2,wolfmanIII,3665,146,6,3,9,66.7%,17m
5521,2,FreshJuice,3665,0,1,0,1,100.0%,5m
5526,2,IIIIIIIIIIII,3664,790,108,110,218,49.5%,24m
5526,2,Eli,3664,830,73,57,130,56.2%,30m
5526,2,BsseeJ,3664,769,54,57,111,48.6%,19m
5526,2,CarolineDana,3664,451,36,32,68,52.9%,19m
5526,2,Steven,3664,494,33,23,56,58.9%,14m
5526,2,DeepOnes,3664,830,30,32,62,48.4%,34m
5526,2,TaNk,3664,223,13,9,22,59.1%,18m
5526,2,turtle,3664,202,11,3,14,78.6%,22m
5526,2,JamesZip,3664,166,9,2,11,81.8%,31m
5526,2,NoKeyboard,3664,90,3,8,11,27.3%,19m
5526,2,Tenu,3664,30,2,1,3,66.7%,6m
5526,2,meksuh,3664,0,1,1,2,50.0%,30m
5526,2,Dfenestrator,3664,0,0,1,1,0.0%,39m
5539,1,Gladiator,3663,1780,312,296,608,51.3%,30m
5539,2,[lLiTl]Swift,3663,1217,103,105,208,49.5%,25m
5539,2,MancoForLife,3663,334,21,14,35,60.0%,17m
5539,2,[UpeV]SMSakurazawa,3663,370,12,17,29,41.4%,19m
5539,3,chris,3663,62,3,4,7,42.9%,14m
5539,3,[xENTx]Messo,3663,58,2,3,5,40.0%,18m
5539,2,Tasty,3663,0,1,2,3,33.3%,30m
5539,2,Diogonies,3663,0,0,1,1,0.0%,5m
5539,2,siCc,3663,0,0,2,2,0.0%,41m
5548,2,[PSlSTC]HanGaram,3662,802,149,132,281,53.0%,43m
5548,2,[Dicboy]IAmSacul,3662,780,117,118,235,49.8%,27m
5548,2,[GamCub]Jean,3662,913,103,93,196,52.6%,41m
5548,2,Doof,3662,502,74,57,131,56.5%,35m
5548,2,THOR,3662,400,62,64,126,49.2%,34m
5548,2,[Lapis]Ignia,3662,574,29,18,47,61.7%,30m
5548,3,AKor,3662,254,12,3,15,80.0%,26m
5548,2,WhoKnew,3662,62,3,7,10,30.0%,30m
5548,2,Trick,3662,58,2,5,7,28.6%,19m
5548,2,IlIlIlIlIlIl,3662,30,1,1,2,50.0%,6m
5548,2,Sirkappuccio,3662,0,0,1,1,0.0%,31m
5559,2,[SIClan]Catinga,3661,1615,195,188,383,50.9%,32m
5559,2,[GGK]zAndreas,3661,0,1,4,5,20.0%,42m
5561,2,blinkSCV,3660,1117,192,140,332,57.8%,12m
5561,1,Business,3660,1600,138,146,284,48.6%,30m
5561,2,lovely,3660,394,14,19,33,42.4%,6m
5561,2,[M4nLUV]TitusZell,3660,60,3,4,7,42.9%,27m
5561,1,[αB]eXiled,3660,90,2,14,16,12.5%,4m
5566,2,[GGMESP]AberamaGold,3659,1605,373,363,736,50.7%,19m
5566,2,Rasgard,3659,1169,159,141,300,53.0%,7m
5566,2,[GR33D]SilentFight,3659,1531,113,116,229,49.3%,33m
5566,2,Shion,3659,853,60,49,109,55.0%,32m
5566,2,[CNAKER]boccy,3659,1355,56,48,104,53.8%,27m
5566,2,IcyDust,3659,229,12,4,16,75.0%,36m
5566,2,SilentKnight,3659,150,5,9,14,35.7%,11m
5566,2,[Cryptc]MacroGame,3659,86,3,4,7,42.9%,44m
5566,2,[hTx]Defy,3659,0,0,1,1,0.0%,8m
5575,2,[αXLa]TOGrizzly,3658,1584,174,171,345,50.4%,18m
5575,2,Argomatic,3658,836,45,43,88,51.1%,26m
5575,2,[Slugzz]Monophonic,3658,724,42,35,77,54.5%,29m
5575,2,[TGosuA]KimJongBoom,3658,506,19,24,43,44.2%,39m
5575,2,[TOXlC]eXiled,3658,389,13,10,23,56.5%,33m
5575,2,FatAmy,3658,216,10,1,11,90.9%,31m
5575,2,TheGoodOne,3658,154,6,10,16,37.5%,19m
5575,2,Noctisxiii,3658,96,4,7,11,36.4%,11m
5575,2,UltimateHype,3658,58,2,3,5,40.0%,32m
5575,2,herozergling,3658,0,2,3,5,40.0%,39m
5575,2,FriedRice,3658,73,2,7,9,22.2%,18m
5575,2,chiwawa,3658,0,1,0,1,100.0%,14m
5575,2,ALEX,3658,0,0,1,1,0.0%,36m
5575,2,dhyung,3658,0,0,3,3,0.0%,14m
5589,2,Asurmen,3657,942,119,119,238,50.0%,39m
5589,2,[MJ23]Beniii,3657,432,61,44,105,58.1%,39m
5589,2,[Zulu]ReiGn,3657,290,10,10,20,50.0%,30m
5589,2,IIIIIIIIIIII,3657,30,4,1,5,80.0%,27m
5589,2,Fortitudo,3657,0,2,3,5,40.0%,14m
5589,2,PopPeteyBear,3657,58,2,3,5,40.0%,18m
5589,2,jisoO,3657,88,1,2,3,33.3%,22m
5589,2,Zebra,3657,0,0,1,1,0.0%,5m
5589,2,Hyperion,3657,0,0,1,1,0.0%,34m
5589,2,DDoreore,3657,0,0,7,7,0.0%,4m
5599,2,NotinMKSens,3656,1552,74,68,142,52.1%,32m
5599,2,CDNLandmine,3656,624,44,41,85,51.8%,34m
5599,2,Computer,3656,352,26,12,38,68.4%,33m
5599,2,Geney,3656,182,18,15,33,54.5%,16m
5599,2,JubilantCows,3656,460,17,23,40,42.5%,21m
5599,2,Weedson,3656,267,15,6,21,71.4%,38m
5599,2,DirkDiggler,3656,314,12,5,17,70.6%,32m
5599,3,Chirana,3656,86,3,1,4,75.0%,39m
5599,2,sunshine,3656,0,0,1,1,0.0%,10m
5608,2,Horsewood,3655,1635,137,120,257,53.3%,11m
5608,2,[GFP]MrLazyyy,3655,1630,133,121,254,52.4%,24m
5608,2,NNNostaliii,3655,1634,88,80,168,52.4%,38m
5608,2,FachoPobre,3655,790,35,15,50,70.0%,11m
5608,2,[hTx]SaraNghae,3655,134,4,15,19,21.1%,41m
5608,3,Tassadar,3655,147,3,3,6,50.0%,42m
5608,2,[juggr]Elloguvna,3655,30,1,3,4,25.0%,29m
5608,2,tdOmega,3655,30,1,5,6,16.7%,42m
5608,2,SkyNeT,3655,0,0,2,2,0.0%,25m
5617,2,Profisee,3654,1480,72,48,120,60.0%,25m
5617,3,Liberty,3654,257,11,3,14,78.6%,42m
5617,2,United,3654,140,7,0,7,100.0%,7m
5617,2,[Viola]Evangeline,3654,172,7,9,16,43.8%,27m
5617,2,EnTaroDHo,3654,166,5,14,19,26.3%,12m
5617,2,imatzel,3654,90,3,3,6,50.0%,44m
5617,2,adosva,3654,0,1,0,1,100.0%,4m
5617,2,[autodi]bXdPuNk,3654,0,0,1,1,0.0%,10m
5617,1,BeBoo,3654,0,0,1,1,0.0%,38m
5626,2,Rick,3653,1160,212,212,424,50.0%,5m
5626,2,Zerg,3653,1009,44,33,77,57.1%,39m
5626,2,Serenity,3653,660,33,25,58,56.9%,32m
5626,2,MadHat,3653,254,10,8,18,55.6%,32m
5626,2,freshsashimi,3653,218,8,5,13,61.5%,5m
5626,2,[xBM]ImmuneEH,3653,90,4,6,10,40.0%,30m
5626,2,YouOnTilt,3653,66,2,8,10,20.0%,14m
5626,2,[AiMB]InsertName,3653,30,1,2,3,33.3%,41m
5626,2,[NotEQ]InEquality,3653,0,0,1,1,0.0%,33m
5626,2,DKDK,3653,0,0,2,2,0.0%,22m
5636,2,ATREYU,3652,881,153,142,295,51.9%,16m
5636,1,[LCE]Chupetinxxx,3652,1376,56,45,101,55.4%,37m
5636,2,azimuthkaden,3652,1106,55,40,95,57.9%,22m
5636,2,[GdAT]iamorni,3652,213,16,19,35,45.7%,19m
5636,2,LLL,3652,434,16,19,35,45.7%,11m
5636,2,Aitian,3652,140,6,1,7,85.7%,30m
5636,2,MarbleArch,3652,0,0,1,1,0.0%,36m
5643,1,[PobSC]Shigure,3651,1800,173,178,351,49.3%,14m
5643,2,goodK,3651,1261,78,74,152,51.3%,5m
5643,2,[BRSKR]Bootyslaya,3651,390,28,36,64,43.8%,15m
5643,2,ladder,3651,88,3,4,7,42.9%,42m
5643,2,[AnUjin]Name,3651,60,2,4,6,33.3%,41m
5643,2,dragoon,3651,30,1,7,8,12.5%,11m
5643,2,IronCore,3651,0,0,1,1,0.0%,24m
5643,2,IMYURI,3651,73,0,3,3,0.0%,38m
5651,1,Zakarumae,3650,1808,221,223,444,49.8%,29m
5651,2,lxlGlacier,3650,1530,70,45,115,60.9%,27m
5651,2,[IMDSI]SMURFIN,3650,322,12,12,24,50.0%,32m
5651,2,[JaMiT]astroemi,3650,302,10,13,23,43.5%,18m
5651,2,[Wlpch]JorgePeña,3650,218,8,6,14,57.1%,18m
5651,2,[Sliq]spoopatron,3650,60,3,3,6,50.0%,21m
5651,2,Prost,3650,48,2,0,2,100.0%,41m
5651,2,[WNTR]ghostman,3650,0,0,1,1,0.0%,32m
5651,2,Degeneration,3650,0,0,2,2,0.0%,7m
5660,2,sLeight,3649,852,32,30,62,51.6%,41m
5660,2,CryLegion,3649,684,27,23,50,54.0%,22m
5660,2,Barcode,3649,389,20,8,28,71.4%,24m
5660,2,UsEd,3649,159,18,16,34,52.9%,16m
5660,2,[EADM8]Stevos,3649,222,8,16,24,33.3%,7m
5660,2,[Th3Bad]Barcellos,3649,30,1,9,10,10.0%,22m
5660,2,[CHlNK]InBeijing,3649,0,0,1,1,0.0%,18m
5667,1,[SsaYnS]Pumauno,3648,1769,157,162,319,49.2%,28m
5667,2,[Schwar]lØzl,3648,850,29,38,67,43.3%,32m
5667,2,[KingSC]Zero,3648,676,25,26,51,49.0%,32m
5667,2,FrizZ,3648,180,7,10,17,41.2%,43m
5667,3,HellraiserX,3648,144,6,4,10,60.0%,44m
5667,2,Asalum,3648,137,6,5,11,54.5%,27m
5667,2,[IMAC]IIIIIIIIIIII,3648,176,6,7,13,46.2%,18m
5667,2,[REPORT]ByaKko,3648,120,4,5,9,44.4%,11m
5667,2,[BeGees]Kenshin,3648,62,3,7,10,30.0%,41m
5667,1,noSKILLnoAPM,3648,0,1,1,2,50.0%,32m
5667,2,IIIIIIIIIIII,3648,30,1,2,3,33.3%,27m
5667,2,LudO,3648,0,0,1,1,0.0%,23m
5667,2,Determined,3648,0,0,4,4,0.0%,16m
5680,2,PingPongHero,3647,1460,189,204,393,48.1%,19m
5680,2,pOptArt,3647,380,17,9,26,65.4%,14m
5680,2,DonZoVanni,3647,230,12,5,17,70.6%,33m
5680,2,Tails,3647,90,3,8,11,27.3%,14m
5680,2,[NwAs]LEINAD,3647,0,1,0,1,100.0%,11m
5680,2,[NwAs]Ordin,3647,30,1,1,2,50.0%,26m
5680,2,IIIIIIIIIIII,3647,0,0,2,2,0.0%,22m
5680,2,Icebear,3647,0,0,4,4,0.0%,41m
5688,2,ProbeiusCorp,3646,1436,108,95,203,53.2%,19m
5688,2,ioiio,3646,874,100,97,197,50.8%,22m
5688,2,tossOP,3646,1235,87,73,160,54.4%,17m
5688,2,[FMX]PumaAzulYOro,3646,1433,83,90,173,48.0%,44m
5688,2,[Akash]pakolas,3646,305,12,4,16,75.0%,31m
5688,2,[TGosuD]eggroll,3646,210,10,2,12,83.3%,42m
5688,2,Zildy,3646,280,10,14,24,41.7%,17m
5688,2,lllIllIlllll,3646,58,7,1,8,87.5%,27m
5688,2,AdQ,3646,88,6,0,6,100.0%,19m
5688,2,IIIIIIIIIIII,3646,0,4,1,5,80.0%,33m
5688,2,[CIV]YumYum,3646,30,2,1,3,66.7%,43m
5688,2,Hanzos,3646,0,1,0,1,100.0%,26m
5688,2,BOMBO,3646,0,0,1,1,0.0%,14m
5688,1,FruitsCode,3646,0,0,1,1,0.0%,24m
5688,2,Bigroostah,3646,0,0,2,2,0.0%,18m
5688,2,[ZotZ]doc,3646,0,0,2,2,0.0%,7m
5704,1,Aan,3645,1646,92,109,201,45.8%,7m
5704,2,DuckY,3645,507,31,16,47,66.0%,30m
5704,2,[MarinC]lIIlIIIIIIlI,3645,288,15,9,24,62.5%,24m
5704,2,Jay,3645,204,7,3,10,70.0%,6m
5704,2,PapaPalps,3645,142,6,4,10,60.0%,30m
5704,2,llllllllllll,3645,30,1,1,2,50.0%,14m
5704,2,[CtpSat]Dakob,3645,0,0,3,3,0.0%,6m
5711,2,Yak,3644,1354,143,151,294,48.6%,39m
5711,2,[Imr]Chaino,3644,1594,96,78,174,55.2%,18m
5711,2,Contoss,3644,384,16,8,24,66.7%,34m
5711,2,[iTE]SCARLIGHT,3644,299,12,3,15,80.0%,14m
5711,2,HerO,3644,158,6,12,18,33.3%,44m
5711,2,AnimeLove,3644,0,5,0,5,100.0%,18m
5711,2,[910]MechinHappen,3644,30,2,1,3,66.7%,18m
5711,2,Rush,3644,0,1,0,1,100.0%,32m
5719,2,HoyaHoya,3643,1559,184,180,364,50.5%,8m
5719,2,Nightmare,3643,416,18,8,26,69.2%,22m
5719,3,[SvXy]YippyKiYay,3643,0,0,1,1,0.0%,41m
5722,2,[ExcIgN]sebastis,3642,1609,184,166,350,52.6%,36m
5722,1,[Fir3s]Saviour,3642,1747,90,104,194,46.4%,18m
5722,2,[ØÛ]Skull,3642,960,80,73,153,52.3%,22m
5722,2,Crazy,3642,1058,51,30,81,63.0%,43m
5722,1,[UTK]Kevin,3642,715,47,43,90,52.2%,29m
5722,2,glaxor,3642,1076,45,37,82,54.9%,22m
5722,2,deadinside,3642,738,44,34,78,56.4%,39m
5722,2,Wormms,3642,747,33,18,51,64.7%,22m
5722,2,[YOLT]wayside,3642,647,25,29,54,46.3%,16m
5722,3,Skylie,3642,288,14,7,21,66.7%,41m
5722,2,[TGCF]Random,3642,318,12,7,19,63.2%,21m
5722,2,swale,3642,142,5,2,7,71.4%,32m
5722,1,[xRHx]Eden,3642,140,3,1,4,75.0%,23m
5722,2,PhoboZ,3642,0,1,0,1,100.0%,11m
5722,2,[TCHC]UnderfireCHI,3642,0,0,2,2,0.0%,10m
5737,2,[xlTWlx]bMaRiku,3641,1530,180,191,371,48.5%,20m
5737,1,[lMathl]Doggy,3641,1693,123,129,252,48.8%,18m
5737,2,[MRCYLS]Human,3641,1539,79,81,160,49.4%,26m
5737,2,[PTHero]NikMan,3641,1018,50,26,76,65.8%,33m
5737,2,[EtrOy]lançamorte,3641,660,23,33,56,41.1%,22m
5737,2,[Cvfefe]ZiggysFan,3641,210,7,9,16,43.8%,31m
5737,2,[TheRs]MarkyMark,3641,88,4,7,11,36.4%,22m
5737,2,[Italis]ttime,3641,30,1,2,3,33.3%,26m
5737,2,[NwAs]noke,3641,0,0,1,1,0.0%,37m
5737,2,ProMarine,3641,0,0,1,1,0.0%,23m
5737,2,Knar,3641,0,0,2,2,0.0%,34m
5748,2,RTFufkin,3640,1331,141,125,266,53.0%,12m
5748,2,MrGoliath,3640,984,38,36,74,51.4%,27m
5748,2,Zar,3640,273,13,7,20,65.0%,23m
5748,2,[eXtra1]SneakySnake,3640,334,13,16,29,44.8%,24m
5748,2,Qwan,3640,112,7,1,8,87.5%,43m
5748,1,IIIIIIIII,3640,262,6,21,27,22.2%,4m
5748,2,[SsaYnS]Zealot,3640,0,4,0,4,100.0%,6m
5748,2,[ShRa]Hiroshan,3640,30,1,3,4,25.0%,16m
5748,2,Jacob,3640,0,0,1,1,0.0%,40m
5748,2,[sOLsc]Ingeleo,3640,0,0,2,2,0.0%,36m
5748,2,Endymion,3640,0,0,3,3,0.0%,18m
5759,1,TaYYaN,3639,1719,157,174,331,47.4%,30m
5759,2,VladImpaler,3639,1172,129,117,246,52.4%,14m
5759,2,XxSCOTTxX,3639,95,6,0,6,100.0%,29m
5759,2,Apolo,3639,132,5,16,21,23.8%,27m
5759,2,[Smegz]Elmo,3639,58,2,5,7,28.6%,39m
5759,2,LevarBurton,3639,23,2,5,7,28.6%,22m
5759,2,Kaiman,3639,0,1,0,1,100.0%,7m
5759,2,[OKz]FunisLoserz,3639,32,1,5,6,16.7%,24m
5767,2,jbroscII,3638,1257,127,123,250,50.8%,25m
5767,2,[TeamUR]Razziki,3638,1531,84,65,149,56.4%,10m
5767,2,[ohMYES]Yoner,3638,1050,40,45,85,47.1%,12m
5767,2,[Kaii]DoM,3638,856,32,38,70,45.7%,27m
5767,2,[LimaSC]KamoTee,3638,363,15,5,20,75.0%,19m
5767,2,Firebat,3638,213,12,5,17,70.6%,25m
5767,2,[MJT]OSPescador,3638,256,10,8,18,55.6%,19m
5767,2,[Kleets]Kolado,3638,264,10,12,22,45.5%,5m
5767,2,poiuy,3638,0,0,1,1,0.0%,18m
5767,2,Snoooopy,3638,0,0,2,2,0.0%,4m
5777,2,[Koshka]SureShot,3637,1664,353,332,685,51.5%,30m
5777,2,Loki,3637,605,74,69,143,51.7%,9m
5777,2,[aplol]KeithLemons,3637,1526,74,70,144,51.4%,36m
5777,2,RyuuShiBaRi,3637,985,61,65,126,48.4%,12m
5777,2,MEGALOVANIA,3637,569,26,19,45,57.8%,32m
5777,2,lead,3637,582,20,26,46,43.5%,32m
5777,2,[YGK]Boozy,3637,281,10,5,15,66.7%,18m
5777,2,Rsterminador,3637,290,10,8,18,55.6%,11m
5777,2,[KGH]TwoFace,3637,120,4,8,12,33.3%,9m
5777,2,[EtrOy]CoorsLight,3637,0,1,0,1,100.0%,30m
5777,2,[MvN]Neony,3637,30,1,7,8,12.5%,8m
5777,2,[ZTemp]Vicious,3637,0,0,1,1,0.0%,17m
5777,2,[Pray4u]pdidz,3637,0,0,1,1,0.0%,33m
5790,2,KarlHungus,3636,1508,261,268,529,49.3%,11m
5790,2,CaptinFalcon,3636,1512,219,222,441,49.7%,43m
5790,2,Bushido,3636,939,47,26,73,64.4%,30m
5790,3,PaRaDoX,3636,313,11,6,17,64.7%,10m
5790,2,BrokenLatex,3636,86,3,12,15,20.0%,16m
5790,2,[PiRapa]ParapPo,3636,0,1,0,1,100.0%,12m
5790,2,TepidCharlie,3636,30,1,2,3,33.3%,22m
5790,2,Superluminal,3636,0,1,4,5,20.0%,39m
5798,1,[Ever]TinkerJoe,3635,1258,87,109,196,44.4%,4m
5798,2,[JaMiT]POP,3635,1090,79,79,158,50.0%,25m
5798,2,daof,3635,700,24,30,54,44.4%,14m
5798,2,[TSC1]Origin,3635,392,15,16,31,48.4%,42m
5798,2,JungleViet,3635,170,7,3,10,70.0%,44m
5798,2,[αX]Pensai,3635,92,4,6,10,40.0%,18m
5798,2,[KBH]WankelEngine,3635,88,4,9,13,30.8%,11m
5798,2,Novorosi,3635,58,3,0,3,100.0%,40m
5798,2,IIIIIIIIIIII,3635,60,3,1,4,75.0%,40m
5798,2,StackingKing,3635,30,1,2,3,33.3%,5m
5798,2,Wildcide,3635,0,0,1,1,0.0%,22m
5809,2,amb,3634,1042,67,58,125,53.6%,39m
5809,2,[Kaii]JonWick,3634,352,12,20,32,37.5%,22m
5809,2,Manabu,3634,240,9,1,10,90.0%,11m
5809,2,AKIRA,3634,184,6,1,7,85.7%,12m
5809,2,Zyr,3634,0,1,0,1,100.0%,25m
5814,2,JAZ,3633,1647,268,252,520,51.5%,21m
5814,2,daoklyn,3633,767,194,172,366,53.0%,7m
5814,2,[InGt]Smite,3633,1524,133,146,279,47.7%,8m
5814,2,Schism,3633,1155,78,69,147,53.1%,25m
5814,2,TTY,3633,1145,49,49,98,50.0%,38m
5814,2,Exquisite,3633,557,20,17,37,54.1%,42m
5814,2,[GnR]Phil,3633,237,10,12,22,45.5%,21m
5814,2,tossop,3633,152,5,16,21,23.8%,36m
5814,2,Destrucity,3633,0,1,0,1,100.0%,25m
5814,2,SickAwesome,3633,0,1,0,1,100.0%,23m
5814,2,FakingTrix,3633,0,1,0,1,100.0%,41m
5814,2,[EvilGC]MaxFire,3633,0,0,5,5,0.0%,16m
5826,1,PapaBear,3632,1199,82,95,177,46.3%,34m
5826,2,mojave,3632,1551,79,59,138,57.2%,10m
5826,2,MasterAce,3632,1539,72,53,125,57.6%,31m
5826,2,zizira,3632,625,51,52,103,49.5%,8m
5826,2,Halt,3632,255,21,17,38,55.3%,22m
5826,2,[2214]Jtrax,3632,436,15,13,28,53.6%,40m
5826,2,olddriver,3632,358,12,16,28,42.9%,36m
5826,2,[blacLM]CheesePizza,3632,184,7,1,8,87.5%,33m
5826,2,[MSUsc2]SpiKeYMaN,3632,104,5,8,13,38.5%,21m
5826,2,Mwalimu,3632,90,4,5,9,44.4%,30m
5826,2,[plannB]Doctor,3632,58,3,1,4,75.0%,11m
5826,2,[AIlin]Augustus,3632,90,3,9,12,25.0%,18m
5826,2,eKko,3632,0,1,0,1,100.0%,40m
5826,2,[KORKOR]Sun,3632,0,1,0,1,100.0%,37m
5826,2,[MlGHTY]PlayLikeMaru,3632,30,1,3,4,25.0%,30m
5826,2,ManofOneway,3632,30,1,4,5,20.0%,5m
5826,2,Duck,3632,0,1,4,5,20.0%,21m
5826,2,[RnGpro]Guildelin,3632,109,1,10,11,9.1%,6m
5826,2,[2V2G0d]iHasTHIGHS,3632,0,0,5,5,0.0%,27m
5845,2,Sunny,3631,1356,310,289,599,51.8%,16m
5845,2,GGu,3631,1512,65,50,115,56.5%,33m
5845,2,[sblxs]Jigsaw,3631,1014,57,33,90,63.3%,19m
5845,2,Spectre,3631,1418,52,58,110,47.3%,16m
5845,2,[MAYN]RipNTerran,3631,948,34,45,79,43.0%,8m
5845,2,[HKN]jlai,3631,558,20,24,44,45.5%,6m
5845,2,intelliJ,3631,302,11,8,19,57.9%,32m
5845,2,[ShoaL]RIHAN,3631,58,2,1,3,66.7%,22m
5845,2,Atticus,3631,0,2,3,5,40.0%,30m
5845,2,BoBeck,3631,0,0,5,5,0.0%,32m
5855,2,Danny,3630,456,21,13,34,61.8%,22m
5855,2,MutaPrinter,3630,542,20,21,41,48.8%,30m
5855,2,[TMO]MONO,3630,506,19,16,35,54.3%,5m
5855,3,HeroSCV,3630,315,15,8,23,65.2%,25m
5855,2,Hunter,3630,202,7,11,18,38.9%,40m
5855,2,vicO,3630,172,6,8,14,42.9%,6m
5855,2,BPR,3630,95,3,0,3,100.0%,5m
5855,2,[REXH]Travis,3630,30,1,2,3,33.3%,41m
5855,2,[badzrg]NaN,3630,0,1,5,6,16.7%,29m
5855,2,JiroRakurai,3630,0,0,1,1,0.0%,24m
5855,2,[RwtM]Dman,3630,0,0,1,1,0.0%,21m
5855,2,[PALY]Lazzer,3630,0,0,1,1,0.0%,21m
5855,2,agingybingy,3630,0,0,1,1,0.0%,33m
5855,2,BUTTQUACK,3630,0,0,2,2,0.0%,18m
5869,2,BLACKPINK,3629,98,4,8,12,33.3%,41m
5869,2,ShowbuTerran,3629,60,2,4,6,33.3%,33m
5869,2,llllllllllll,3629,30,2,5,7,28.6%,21m
5869,3,BLEE,3629,30,1,2,3,33.3%,25m
5869,2,LifeBook,3629,0,0,1,1,0.0%,10m
5874,2,philosophi,3628,1236,117,103,220,53.2%,21m
5874,2,Souljah,3628,546,46,56,102,45.1%,18m
5874,2,[Duran]Duran,3628,444,19,13,32,59.4%,6m
5874,2,[dtwist]SHlTSKlN,3628,96,6,0,6,100.0%,9m
5874,2,[GrimmC]Marcelo,3628,30,4,2,6,66.7%,31m
5874,2,Temoc,3628,0,3,2,5,60.0%,5m
5880,2,[SV]SAVD,3627,1521,157,167,324,48.5%,22m
5880,2,Madruga,3627,558,80,76,156,51.3%,8m
5880,2,[fiea]WaSiD,3627,1174,45,48,93,48.4%,21m
5880,2,scared,3627,415,21,10,31,67.7%,41m
5880,2,Klocks,3627,362,14,10,24,58.3%,25m
5880,2,IIIIIIIIIII,3627,114,7,6,13,53.8%,35m
5880,2,xRdyx,3627,238,6,9,15,40.0%,6m
5880,2,Father,3627,186,6,13,19,31.6%,35m
5880,2,CowLevelNoGG,3627,30,2,0,2,100.0%,5m
5880,1,WTF,3627,0,0,1,1,0.0%,37m
5880,2,FedoraLord,3627,0,0,1,1,0.0%,6m
5891,2,pink,3626,919,41,29,70,58.6%,23m
5891,2,TheTerran,3626,751,39,16,55,70.9%,5m
5891,1,oatmeeL,3626,888,29,56,85,34.1%,15m
5891,2,[ZTemps]LostP,3626,588,22,19,41,53.7%,37m
5891,3,USSR,3626,249,12,3,15,80.0%,9m
5891,2,Malicious,3626,240,10,2,12,83.3%,36m
5891,1,DRad,3626,186,9,1,10,90.0%,22m
5891,1,[OIdMen]MacroS,3626,232,9,4,13,69.2%,37m
5891,2,SeanKendich,3626,222,9,7,16,56.2%,26m
5891,1,llllllllllll,3626,119,7,1,8,87.5%,35m
5891,2,Illegitimate,3626,88,6,0,6,100.0%,22m
5891,2,[LTlord]shakon,3626,30,2,1,3,66.7%,25m
5891,2,IIIIIIIIIIII,3626,30,2,1,3,66.7%,30m
5891,2,[NKT1]YuiHatano,3626,0,1,0,1,100.0%,19m
5891,2,IceFire,3626,0,1,0,1,100.0%,19m
5906,2,Taz,3625,442,21,11,32,65.6%,25m
5906,2,[2TETON]Equinox,3625,451,21,12,33,63.6%,31m
5906,2,NaomiKlein,3625,371,17,13,30,56.7%,13m
5906,2,[TGosuD]Dingo,3625,302,12,6,18,66.7%,16m
5906,3,IIIIlllIlIII,3625,219,11,7,18,61.1%,25m
5906,2,[IIDA]FRAGA,3625,202,7,3,10,70.0%,1m
5906,3,sWiTcH,3625,116,4,2,6,66.7%,31m
5906,2,Brill,3625,60,3,5,8,37.5%,25m
5906,2,Pacheco,3625,30,1,1,2,50.0%,32m
5906,2,ChiliSpice,3625,30,1,6,7,14.3%,33m
5916,2,NastyNugs,3624,1557,183,169,352,52.0%,40m
5916,2,Konichiwa,3624,679,38,26,64,59.4%,23m
5916,2,Rickstar,3624,683,29,33,62,46.8%,30m
5916,2,argonkingdom,3624,686,27,24,51,52.9%,13m
5916,2,IIII,3624,467,24,21,45,53.3%,3m
5916,3,Pugeun,3624,156,10,1,11,90.9%,28m
5916,2,IIIIIIIIIIII,3624,176,9,8,17,52.9%,5m
5916,2,NoTime,3624,116,4,7,11,36.4%,36m
5916,2,Draconus,3624,58,2,1,3,66.7%,30m
5916,2,mCudonarudo,3624,0,1,0,1,100.0%,30m
5916,2,Cerulean,3624,0,1,0,1,100.0%,23m
5916,2,[TXOP]Nimrod,3624,30,1,1,2,50.0%,36m
5916,2,[DPGame]ikki,3624,0,0,1,1,0.0%,21m
5929,2,nimsec,3623,1561,239,238,477,50.1%,32m
5929,2,[DVU]Xero,3623,861,52,40,92,56.5%,10m
5929,2,NanatoScop,3623,656,29,12,41,70.7%,27m
5929,1,IIIIIIIIIIII,3623,403,12,26,38,31.6%,29m
5929,2,Key,3623,314,11,16,27,40.7%,24m
5929,1,yayaya,3623,166,9,1,10,90.0%,22m
5929,2,Terran,3623,140,5,3,8,62.5%,18m
5936,2,Aclickmarine,3622,342,17,7,24,70.8%,19m
5936,2,[SydTT]ByuN,3622,436,17,14,31,54.8%,22m
5936,2,[FDLint]Student,3622,174,9,1,10,90.0%,1m
5936,1,SnoodleDoodl,3622,120,7,1,8,87.5%,33m
5936,2,[KingSC]blezz,3622,60,2,3,5,40.0%,32m
5936,2,Alejandro,3622,0,0,2,2,0.0%,11m
5936,2,DFTBA,3622,73,0,3,3,0.0%,40m
5943,1,[DhZAc1]Giap,3621,1797,867,888,1755,49.4%,15m
5943,2,[ELeeT]andyH,3621,1597,530,518,1048,50.6%,36m
5943,2,[eSun]maVerick,3621,1255,88,54,142,62.0%,25m
5943,2,[425]DrW,3621,403,27,28,55,49.1%,18m
5943,2,DarthSidious,3621,440,22,10,32,68.8%,36m
5943,2,GabrielS,3621,494,22,19,41,53.7%,11m
5943,2,reflection,3621,428,18,9,27,66.7%,2m
5943,2,IIIIIIIIII,3621,88,6,0,6,100.0%,6m
5943,2,Neutrino,3621,92,4,5,9,44.4%,26m
5943,2,Harry,3621,58,2,13,15,13.3%,4m
5943,2,medivac,3621,0,1,0,1,100.0%,7m
5943,2,Empirimancer,3621,0,0,1,1,0.0%,17m
5955,2,QuanticPsych,3620,1665,1116,1103,2219,50.3%,14m
5955,2,Bear,3620,1332,95,104,199,47.7%,1m
5955,2,[Kappa]Blargh,3620,989,44,31,75,58.7%,36m
5955,2,scboy,3620,596,28,16,44,63.6%,2m
5955,2,Illia,3620,95,6,0,6,100.0%,17m
5955,2,Thx,3620,90,4,7,11,36.4%,6m
5955,2,[WNTRLY]jscabra,3620,0,1,0,1,100.0%,21m
5955,3,LunatikGG,3620,0,0,1,1,0.0%,42m
5963,2,GhostComet,3619,1593,341,328,669,51.0%,14m
5963,1,Morgoth,3619,1785,294,288,582,50.5%,36m
5963,2,[GoBrrr]Shockwave,3619,1327,199,185,384,51.8%,20m
5963,2,NobodY,3619,1570,194,190,384,50.5%,24m
5963,2,Longzdalez,3619,1524,170,159,329,51.7%,40m
5963,2,lobster,3619,844,71,70,141,50.4%,3m
5963,2,[GRNSKN]Nordres,3619,1181,61,51,112,54.5%,36m
5963,2,DarkMarine,3619,163,5,0,5,100.0%,7m
5963,2,Nerevar,3619,0,0,3,3,0.0%,2m
5972,1,LemonVillain,3618,1745,542,543,1085,50.0%,18m
5972,2,RatsAhoy,3618,866,43,16,59,72.9%,30m
5972,2,[R43]Prometheus,3618,631,28,15,43,65.1%,10m
5972,2,Checkmate,3618,498,22,13,35,62.9%,31m
5972,2,[GGu2EZ]Trapintime,3618,281,20,12,32,62.5%,7m
5972,2,[defun]specialk,3618,0,4,3,7,57.1%,11m
5972,2,[KingSC]Diurno,3618,0,1,0,1,100.0%,2m
5972,2,Dinero,3618,30,1,5,6,16.7%,11m
5980,2,MicroMarine,3617,1496,83,82,165,50.3%,38m
5980,2,Warz,3617,243,6,6,12,50.0%,40m
5980,2,JohnJiang,3617,58,3,4,7,42.9%,14m
5983,2,AMR,3616,1535,250,247,497,50.3%,28m
5983,2,Helg,3616,1112,164,166,330,49.7%,3m
5983,2,Trout,3616,1010,38,37,75,50.7%,16m
5983,2,[Bento]ricochet,3616,658,34,28,62,54.8%,19m
5983,2,[NmOnes]JungleJuice,3616,364,13,12,25,52.0%,17m
5983,1,stärcraft,3616,163,8,1,9,88.9%,30m
5983,1,OWNAGEMAN,3616,143,8,2,10,80.0%,13m
5983,2,Enryu,3616,257,8,5,13,61.5%,33m
5983,2,SyndiCate,3616,88,6,0,6,100.0%,6m
5983,2,[420SMO]Moldy,3616,30,2,1,3,66.7%,32m
5983,2,[NPhase]Bolt,3616,0,0,1,1,0.0%,27m
5994,2,[Poway]SpiritBuddy,3615,1302,120,108,228,52.6%,31m
5994,2,Snikerdoodle,3615,1203,53,38,91,58.2%,1m
5994,2,FleGiaS,3615,740,28,33,61,45.9%,5m
5994,2,PinkZebra,3615,112,10,9,19,52.6%,3m
5994,2,IIIIIIIIIIII,3615,0,1,0,1,100.0%,41m
5994,2,Kez,3615,0,1,2,3,33.3%,42m
5994,2,[TGosuC]noahfecks,3615,30,1,4,5,20.0%,7m
5994,2,barcOde,3615,0,0,2,2,0.0%,28m
6002,2,[IWC]Microstash,3614,1648,93,81,174,53.4%,17m
6002,2,Josmar,3614,964,93,99,192,48.4%,41m
6002,2,[tCo9]Archcamus,3614,981,70,78,148,47.3%,18m
6002,2,McBain,3614,1532,69,54,123,56.1%,3m
6002,2,meaningless,3614,1107,48,38,86,55.8%,42m
6002,2,[KingSC]Eddy,3614,362,13,11,24,54.2%,36m
6002,2,[INextI]ELECTRIC,3614,218,8,8,16,50.0%,32m
6002,2,NillaWafers,3614,148,7,7,14,50.0%,21m
6002,2,Happy,3614,30,2,1,3,66.7%,11m
6002,2,Daniel,3614,58,2,1,3,66.7%,3m
6002,2,[ProSC]Soujiro,3614,0,0,1,1,0.0%,23m
6002,2,[CHEWIN]Jumper,3614,0,0,1,1,0.0%,36m
6002,2,[DUNGR]FTL,3614,0,0,1,1,0.0%,9m
6015,2,HanGaram,3613,1588,132,124,256,51.6%,42m
6015,2,Agrrrrrrrrrr,3613,523,22,23,45,48.9%,11m
6015,2,[GGxC]NissanZOwner,3613,0,2,3,5,40.0%,5m
6018,2,[xTQc]NotinMkSens,3612,1109,57,54,111,51.4%,18m
6018,2,FreeCoaching,3612,286,12,4,16,75.0%,10m
6018,3,nanancux,3612,193,10,5,15,66.7%,29m
6018,2,Jaesung,3612,237,9,2,11,81.8%,24m
6018,2,[Macac0]Nutela,3612,86,3,2,5,60.0%,1m
6018,2,[Globe]HIGUMA,3612,0,1,0,1,100.0%,11m
6018,2,[NwAs]JabalsalFB,3612,30,1,1,2,50.0%,19m
6018,2,[3D]Melkor,3612,0,1,1,2,50.0%,11m
6018,2,DAI,3612,0,0,6,6,0.0%,2m
6027,2,sudonull,3611,689,103,114,217,47.5%,3m
6027,2,eagleVISION,3611,140,5,5,10,50.0%,22m
6027,1,LingBling,3611,48,2,1,3,66.7%,25m
6027,2,SkimCulture,3611,30,2,2,4,50.0%,21m
6027,2,infamousbob,3611,0,1,0,1,100.0%,12m
6027,2,[HGG]Oxygen,3611,0,1,0,1,100.0%,32m
6027,2,[SpecA]Nano,3611,0,0,1,1,0.0%,2m
6027,2,[BSAA1]KingOfB,3611,0,0,1,1,0.0%,33m
6035,2,[MuFns]Patches,3610,1358,235,216,451,52.1%,19m
6035,1,Frost,3610,1737,151,178,329,45.9%,14m
6035,2,Solorolo,3610,1233,148,136,284,52.1%,16m
6035,2,Philocide,3610,1030,65,52,117,55.6%,30m
6035,2,[xASOTx]TheHeart,3610,1181,47,38,85,55.3%,7m
6035,1,LiquidClem,3610,48,2,1,3,66.7%,15m
6035,2,Recovery,3610,0,1,0,1,100.0%,36m
6035,2,[MBBOYS]jjjzy,3610,0,1,0,1,100.0%,37m
6043,1,[eX]Gadernal,3609,1413,138,148,286,48.3%,27m
6043,2,BioT,3609,1530,82,79,161,50.9%,6m
6043,2,[NGRz]Fasho,3609,602,27,19,46,58.7%,3m
6043,2,yusef,3609,122,7,10,17,41.2%,3m
6043,2,asdf,3609,0,1,0,1,100.0%,27m
6043,2,Duhrdy,3609,0,1,1,2,50.0%,3m
6043,2,[DGxx]GTLChase,3609,30,1,3,4,25.0%,8m
6043,2,Back,3609,0,0,1,1,0.0%,40m
6051,2,[Amb3rs]DrpShipMagic,3608,1588,193,199,392,49.2%,19m
6051,2,Bones,3608,1599,101,60,161,62.7%,32m
6051,1,[MadK]Goronox,3608,1232,101,110,211,47.9%,3m
6051,2,XLordZayidX,3608,1092,83,75,158,52.5%,36m
6051,2,DontBeSad,3608,225,40,34,74,54.1%,3m
6051,2,Equinox,3608,600,23,25,48,47.9%,18m
6051,2,[UpeV]BBGonzales,3608,268,14,5,19,73.7%,18m
6051,2,[RlSKE]assassinXY,3608,236,8,11,19,42.1%,32m
6051,2,CommanderPim,3608,88,4,1,5,80.0%,18m
6060,2,Kimu,3607,1342,136,129,265,51.3%,14m
6060,2,Alex,3607,1600,108,101,209,51.7%,36m
6060,2,Moridin,3607,573,69,20,89,77.5%,6m
6060,2,[XpKb]NaOH,3607,1064,66,62,128,51.6%,17m
6060,2,[PTHero]ToonDragon,3607,1346,55,56,111,49.5%,21m
6060,2,[Xenos]FriedShrimp,3607,495,30,24,54,55.6%,11m
6060,2,AKASD,3607,260,12,18,30,40.0%,3m
6060,2,[IXTeam]IIIXMauK,3607,60,2,4,6,33.3%,40m
6060,2,Eagle,3607,0,1,0,1,100.0%,40m
6060,3,[P00P2]Sandman,3607,30,1,2,3,33.3%,21m
6070,1,nazari,3606,1546,196,202,398,49.2%,20m
6070,1,redturtle,3606,1746,113,115,228,49.6%,32m
6070,2,beefsupreme,3606,1013,41,47,88,46.6%,25m
6070,2,UnEarThly,3606,530,39,30,69,56.5%,11m
6070,3,PPY,3606,234,11,3,14,78.6%,1m
6070,2,Doom,3606,312,11,7,18,61.1%,18m
6070,3,llllllllllll,3606,200,6,5,11,54.5%,22m
6070,2,[TGosuD]DrakkenGay,3606,0,5,0,5,100.0%,25m
6070,2,Polarbear,3606,30,1,1,2,50.0%,27m
6070,2,[CBO]Vromrig,3606,30,1,3,4,25.0%,40m
6080,2,SqueakyBoots,3605,701,98,88,186,52.7%,10m
6080,2,Ares,3605,260,44,33,77,57.1%,33m
6080,2,Dirk,3605,1006,42,34,76,55.3%,28m
6080,2,[FnaTYC]LaPAJArita,3605,654,27,30,57,47.4%,19m
6080,2,llllllllllll,3605,483,21,14,35,60.0%,21m
6080,2,Baddu,3605,331,13,7,20,65.0%,2m
6080,2,ppmk,3605,291,12,5,17,70.6%,40m
6080,2,flax,3605,0,1,0,1,100.0%,11m
6080,2,[CrnKy]ChronoS,3605,0,1,1,2,50.0%,38m
6080,2,[Xotua]Vielden,3605,0,1,2,3,33.3%,29m
6080,2,Mugician,3605,0,0,2,2,0.0%,17m
6091,2,[TPGGXD]GeekRaynor,3604,1587,301,288,589,51.1%,24m
6091,2,yolkyasian,3604,1574,206,200,406,50.7%,32m
6091,2,prestonscs,3604,1575,201,173,374,53.7%,4m
6091,2,TheXaah,3604,975,39,39,78,50.0%,11m
6091,2,[Viola]KillB,3604,784,28,32,60,46.7%,30m
6091,2,theripperr,3604,353,15,9,24,62.5%,36m
6091,2,yokister,3604,166,9,3,12,75.0%,11m
6091,2,[D4RkS]SOUL,3604,0,0,1,1,0.0%,10m
6091,3,[LMI42]KKKKK,3604,0,0,1,1,0.0%,25m
6100,2,[LBAJK]Aurum,3603,1561,129,106,235,54.9%,24m
6100,1,ManAtSea,3603,1533,111,112,223,49.8%,15m
6100,2,MMeRchant,3603,344,15,14,29,51.7%,27m
6100,2,Heywood,3603,448,15,22,37,40.5%,16m
6100,2,[TGosuD]cVU,3603,229,12,5,17,70.6%,41m
6100,2,Random,3603,140,5,6,11,45.5%,19m
6100,2,[SsaYnS]HappyHippo,3603,92,3,8,11,27.3%,16m
6100,2,Ezend,3603,64,3,10,13,23.1%,14m
6100,2,Dielon,3603,0,1,0,1,100.0%,10m
6100,2,[RushTw]asiF,3603,30,1,11,12,8.3%,23m
6100,2,TheGodzilla,3603,0,0,1,1,0.0%,23m
6100,2,GhostMalone,3603,0,0,1,1,0.0%,32m
6100,2,comsci,3603,0,0,2,2,0.0%,1m
6113,2,Txking,3602,1549,78,60,138,56.5%,18m
6113,2,[LOHs]BrOkEn,3602,1078,50,47,97,51.5%,11m
6113,2,Papprittar,3602,614,27,20,47,57.4%,23m
6113,2,Cbiscuit,3602,358,12,17,29,41.4%,16m
6113,3,ycgsgggame,3602,143,11,5,16,68.8%,39m
6113,2,[NubBR]Aquiles,3602,0,1,0,1,100.0%,10m
6113,2,[FMX]BULLTERRIER,3602,0,0,1,1,0.0%,31m
6113,2,DatGuyGaming,3602,0,0,1,1,0.0%,5m
6113,1,Yoda,3602,0,0,1,1,0.0%,36m
6122,2,llllllllllll,3601,1284,49,52,101,48.5%,1m
6122,2,planetninex,3601,675,28,22,50,56.0%,27m
6122,2,[SBoys]Franco,3601,406,15,12,27,55.6%,10m
6122,1,WasteOfTime,3601,254,12,1,13,92.3%,34m
6122,2,wormzor,3601,278,11,5,16,68.8%,23m
6122,2,TheMuffinMan,3601,284,10,12,22,45.5%,17m
6122,1,HanCha,3601,118,7,1,8,87.5%,7m
6122,2,[UpeV]LegendHero,3601,142,6,7,13,46.2%,3m
6122,2,[UNCCH]BLACKSPACE,3601,0,1,0,1,100.0%,32m
6131,1,juhee,3600,1699,408,411,819,49.8%,29m
6131,2,NoobCake,3600,1523,339,335,674,50.3%,3m
6131,2,maxPOWERS,3600,1640,217,198,415,52.3%,33m
6131,2,[PRZM]Scrapnublet,3600,798,30,25,55,54.5%,18m
6131,2,IIIIIIIIIIII,3600,424,18,10,28,64.3%,33m
6131,2,[Igbtq]DOMMYMOMMY,3600,167,9,3,12,75.0%,25m
6131,2,OneAPro,3600,90,8,4,12,66.7%,11m
6131,1,TosstheWay,3600,184,5,12,17,29.4%,31m
6131,2,[Vales]Kalthazard,3600,0,4,1,5,80.0%,2m
6140,2,[GØSU]SkinMilk,3599,1615,559,519,1078,51.9%,6m
6140,2,CyrusII,3599,840,45,52,97,46.4%,32m
6140,2,CSantder,3599,925,39,32,71,54.9%,31m
6140,2,technologh,3599,734,33,22,55,60.0%,2m
6140,2,[H3xPr0]Rivercat,3599,624,32,38,70,45.7%,35m
6140,2,GEANTOR,3599,472,22,9,31,71.0%,18m
6140,2,ScarsofTime,3599,304,14,8,22,63.6%,23m
6140,2,llllllllllll,3599,226,8,3,11,72.7%,11m
6140,2,GULPing,3599,60,2,2,4,50.0%,3m
6140,2,AnastasiaRU,3599,0,0,1,1,0.0%,32m
6150,1,[Raytar]TheShortCook,3598,1785,444,456,900,49.3%,31m
6150,2,Mrkiller,3598,1512,379,377,756,50.1%,19m
6150,2,[SHKDIV]Pangz,3598,986,41,34,75,54.7%,11m
6150,2,[SCJL]tim,3598,552,29,10,39,74.4%,27m
6150,2,QueensGambit,3598,535,27,14,41,65.9%,10m
6150,2,llllllllllll,3598,201,16,14,30,53.3%,3m
6150,2,[GRNSKN]Sadist,3598,394,13,24,37,35.1%,13m
6150,2,Maru,3598,117,6,1,7,85.7%,18m
6150,2,RobotWizard,3598,86,3,2,5,60.0%,27m
6150,1,[BiW]Illusion,3598,117,3,5,8,37.5%,15m
6150,2,[PRDA]Sneakysnake,3598,0,1,1,2,50.0%,25m
6150,2,BigBang,3598,0,0,5,5,0.0%,31m
6162,2,[UpeV]Mark,3597,1596,361,345,706,51.1%,25m
6162,2,Sabertooth,3597,1203,118,121,239,49.4%,3m
6162,2,rango,3597,658,84,43,127,66.1%,6m
6162,2,TwinkleToes,3597,1157,73,51,124,58.9%,20m
6162,2,Lutris,3597,877,43,48,91,47.3%,8m
6162,2,Anthonee,3597,311,36,22,58,62.1%,3m
6162,2,[lDFK]Devitaliza,3597,794,36,29,65,55.4%,1m
6162,2,MonoGlove,3597,529,30,31,61,49.2%,19m
6162,2,Twisted,3597,588,22,24,46,47.8%,27m
6162,2,Galactus,3597,520,18,16,34,52.9%,23m
6162,2,Bot,3597,152,10,1,11,90.9%,11m
6162,2,[cl0udM]gRiT,3597,0,1,0,1,100.0%,23m
6162,2,[SMSC]SirDoofus,3597,30,1,2,3,33.3%,31m
6175,2,delay,3596,1527,137,120,257,53.3%,30m
6175,1,Pete,3596,1760,133,154,287,46.3%,20m
6175,2,KurtBlock,3596,1142,122,106,228,53.5%,6m
6175,2,HellaLate,3596,568,61,49,110,55.5%,19m
6175,2,[500CC]CoreDefender,3596,724,35,19,54,64.8%,18m
6175,2,Mvp,3596,350,12,16,28,42.9%,28m
6175,2,IIIIIIIII,3596,220,9,6,15,60.0%,22m
6175,3,kayo,3596,149,4,2,6,66.7%,36m
6175,2,[RLR]Lusira,3596,62,2,11,13,15.4%,18m
6175,2,marbles,3596,0,1,0,1,100.0%,30m
6175,2,[Vampir]Alucard,3596,88,1,1,2,50.0%,23m
6175,2,Stella,3596,0,1,3,4,25.0%,6m
6175,2,zzSKY,3596,0,1,4,5,20.0%,30m
6175,2,[RlSKE]MapleSizzurp,3596,30,1,8,9,11.1%,17m
6189,2,Leo,3595,1547,64,50,114,56.1%,1m
6189,2,Mithrilangel,3595,198,32,34,66,48.5%,16m
6189,2,[NPFR]molozilla,3595,489,23,24,47,48.9%,3m
6189,2,STLord,3595,308,12,6,18,66.7%,15m
6189,2,superhiero,3595,336,12,19,31,38.7%,33m
6189,2,Chapis,3595,234,9,9,18,50.0%,21m
6189,2,ooioinva,3595,174,7,6,13,53.8%,18m
6189,2,[cl0udM]DeathByToss,3595,154,6,9,15,40.0%,3m
6189,2,JohnnySinz,3595,188,6,13,19,31.6%,14m
6189,2,Cetza,3595,122,5,7,12,41.7%,36m
6189,2,[juggr]Gandalf,3595,62,2,8,10,20.0%,25m
6189,2,[bsaur]Fylypek,3595,0,0,1,1,0.0%,22m
6189,2,[SWMX]Poethi,3595,0,0,2,2,0.0%,32m
6202,2,[SBoys]sPiN,3594,1262,245,260,505,48.5%,25m
6202,2,[BRSKR]Siumo,3594,1286,110,104,214,51.4%,11m
6202,2,DANKMEMES,3594,1058,40,40,80,50.0%,19m
6202,2,[Sr420]GaMBiTz,3594,164,5,12,17,29.4%,25m
6202,2,TITAN,3594,0,1,0,1,100.0%,6m
6207,2,DemonSlayer,3593,1606,104,70,174,59.8%,41m
6207,2,Ghost,3593,1018,58,57,115,50.4%,30m
6207,2,[ROSC2]JagassarBR,3593,636,49,23,72,68.1%,20m
6207,2,Kerolox,3593,561,37,21,58,63.8%,12m
6207,2,Donkey,3593,434,22,13,35,62.9%,10m
6207,2,BenObear,3593,440,16,13,29,55.2%,20m
6207,3,llllllllllll,3593,285,13,6,19,68.4%,37m
6207,2,[NwAs]PinkFloyd,3593,253,11,9,20,55.0%,33m
6207,1,[MyEggs]MOLGADO,3593,141,3,2,5,60.0%,26m
6207,1,IIIIIIIIIIII,3593,0,1,0,1,100.0%,9m
6207,2,Eldred,3593,0,1,1,2,50.0%,3m
6207,2,[TIBU]MrChicken,3593,30,1,3,4,25.0%,41m
6207,1,[dBASED]Serenity,3593,0,0,7,7,0.0%,8m
6220,2,[PTHero]shWall,3592,1586,153,121,274,55.8%,22m
6220,2,[KawKaw]Gumbyy,3592,1606,138,136,274,50.4%,41m
6220,1,TheHaars,3592,1050,73,82,155,47.1%,7m
6220,2,taken,3592,851,55,17,72,76.4%,11m
6220,2,QtoWE,3592,0,2,3,5,40.0%,25m
6220,2,llllllllllll,3592,58,2,3,5,40.0%,30m
6220,2,Niki,3592,0,0,1,1,0.0%,42m
6220,2,Leifur,3592,0,0,2,2,0.0%,11m
6228,2,JaviX,3591,1253,51,41,92,55.4%,33m
6228,2,[TATR]Toasty,3591,327,35,23,58,60.3%,3m
6228,2,Orthonormal,3591,555,25,12,37,67.6%,17m
6228,2,[MWM]miomamo,3591,446,17,16,33,51.5%,24m
6228,2,eninyaD,3591,114,5,4,9,55.6%,17m
6228,2,[TgAg]IULICA,3591,140,5,5,10,50.0%,10m
6228,2,[Lukerk]SpikeWesker,3591,0,1,0,1,100.0%,19m
6228,2,Hyjack,3591,30,1,4,5,20.0%,16m
6228,1,Ramenman,3591,0,0,2,2,0.0%,21m
6237,2,Nemesis,3590,1575,90,87,177,50.8%,5m
6237,2,[C3PO]Nio,3590,1128,52,36,88,59.1%,11m
6237,2,IIIIIIIIIIII,3590,838,35,26,61,57.4%,42m
6237,2,[NZER0]Ghost,3590,331,15,6,21,71.4%,30m
6237,2,JoKer,3590,374,15,15,30,50.0%,25m
6237,2,resolvz,3590,154,6,0,6,100.0%,18m
6237,2,llIIIllllIll,3590,126,4,0,4,100.0%,18m
6237,2,Adapt,3590,60,2,2,4,50.0%,5m
6237,2,DwightShrute,3590,0,0,1,1,0.0%,17m
6237,2,WashedUp,3590,0,0,2,2,0.0%,6m
6247,2,[M0P]Hellangel,3589,1615,429,424,853,50.3%,28m
6247,2,[BQT]BIGQTBALLER,3589,1347,121,117,238,50.8%,30m
6247,2,[FnATlC]OPprotoszerg,3589,314,62,49,111,55.9%,25m
6247,2,Goliath,3589,848,29,34,63,46.0%,32m
6247,2,AcerScarlett,3589,95,6,0,6,100.0%,12m
6247,2,Eggiman,3589,30,2,0,2,100.0%,21m
6247,2,Weslicus,3589,30,2,4,6,33.3%,3m
6247,2,DlCKFEET,3589,0,0,2,2,0.0%,3m
6247,2,[eSun]DeathBringer,3589,0,0,2,2,0.0%,28m
6256,1,[FTTD]Bubba,3588,1776,154,173,327,47.1%,38m
6256,2,[GDJ]ThelOniouS,3588,1403,123,85,208,59.1%,29m
6256,2,red,3588,838,52,52,104,50.0%,32m
6256,2,Ivraa,3588,681,47,31,78,60.3%,22m
6256,2,[KiMBR]MaTriX,3588,788,30,30,60,50.0%,32m
6256,2,IIIIIIIIIIII,3588,393,20,21,41,48.8%,35m
6256,3,klmoo,3588,216,11,4,15,73.3%,9m
6256,2,lIlIlIlIlIlI,3588,180,7,2,9,77.8%,23m
6256,2,SHlTSHOW,3588,60,3,1,4,75.0%,19m
6256,1,BsKCoto,3588,145,3,1,4,75.0%,3m
6256,2,[SsaYnS]Terranous,3588,0,0,1,1,0.0%,3m
6267,2,RAEMIAN,3587,1582,121,101,222,54.5%,6m
6267,2,[TGCF]MarcoMan,3587,1589,64,73,137,46.7%,19m
6267,2,[MIDMX]DAVICO,3587,337,25,19,44,56.8%,11m
6267,3,Bababooey,3587,111,13,9,22,59.1%,40m
6267,3,IIIIIIIIIIII,3587,121,5,3,8,62.5%,35m
6267,3,BIGPAPA,3587,121,3,0,3,100.0%,40m
6267,2,[LlQUlD]Jinro,3587,88,3,3,6,50.0%,31m
6267,2,[LowIQ]KingSonic,3587,146,3,3,6,50.0%,11m
6267,2,[CCAV]nxdask,3587,90,3,8,11,27.3%,28m
6267,2,[DRKDMN]warrior,3587,58,2,4,6,33.3%,10m
6267,2,IIIIIIIIIIII,3587,0,1,0,1,100.0%,25m
6267,2,[GSHXD6]bobo,3587,0,0,3,3,0.0%,3m
6279,2,SovereigN,3586,1517,302,279,581,52.0%,18m
6279,2,Ease,3586,148,8,7,15,53.3%,6m
6279,2,iden,3586,120,4,7,11,36.4%,20m
6279,2,llllllllllll,3586,30,3,7,10,30.0%,14m
6279,2,Luke,3586,0,1,0,1,100.0%,14m
6279,2,[FOUR29]blind,3586,0,0,4,4,0.0%,11m
6285,2,coralreefer,3585,1584,146,135,281,52.0%,25m
6285,2,CLaw,3585,598,71,64,135,52.6%,18m
6285,2,KingMarine,3585,1546,64,57,121,52.9%,32m
6285,2,disruptorOp,3585,577,37,31,68,54.4%,5m
6285,2,wham,3585,826,34,30,64,53.1%,14m
6285,2,protoss,3585,503,21,15,36,58.3%,3m
6285,2,ToddMargaret,3585,244,13,5,18,72.2%,25m
6285,2,iksnaphetnie,3585,140,6,4,10,60.0%,5m
6285,2,LuckyPants,3585,170,6,6,12,50.0%,23m
6285,2,noslop,3585,62,4,8,12,33.3%,28m
6285,3,gucci,3585,64,3,15,18,16.7%,21m
6285,2,[New2it]ARabidDogg,3585,0,1,1,2,50.0%,3m
6285,2,[l3l3l]SpaceSteak,3585,0,0,1,1,0.0%,30m
6285,2,Throttle,3585,0,0,1,1,0.0%,36m
6285,2,JoOSeon,3585,0,0,3,3,0.0%,3m
6300,2,OooOoO,3584,1350,205,169,374,54.8%,27m
6300,2,[DarkAG]Avatar,3584,1603,146,141,287,50.9%,11m
6300,2,[Bobjr]bobjr,3584,1459,127,74,201,63.2%,6m
6300,2,[ValidG]MiNTy,3584,904,34,36,70,48.6%,36m
6300,2,[CMU]Qoo,3584,735,30,26,56,53.6%,24m
6300,2,[AFM]cookie,3584,736,29,24,53,54.7%,14m
6300,3,Protossop,3584,365,17,7,24,70.8%,15m
6300,2,Terra,3584,452,16,20,36,44.4%,19m
6300,2,hiphopman,3584,165,6,1,7,85.7%,5m
6300,2,JimKasama,3584,30,2,2,4,50.0%,41m
6300,2,Tang,3584,0,1,0,1,100.0%,30m
6300,2,Twatlord,3584,0,0,1,1,0.0%,30m
6312,2,Gunner,3583,1558,141,140,281,50.2%,35m
6312,2,mirageC,3583,1450,96,72,168,57.1%,11m
6312,2,Darknez,3583,323,42,43,85,49.4%,27m
6312,2,[TrckPd]vVvOxOvVv,3583,904,34,33,67,50.7%,36m
6312,2,xYz,3583,768,32,26,58,55.2%,18m
6312,2,[GanGan]Rykuu,3583,114,4,4,8,50.0%,6m
6312,2,[SkAL]Skalinas,3583,118,4,9,13,30.8%,21m
6312,2,Dionysus,3583,90,3,5,8,37.5%,23m
6312,2,Rupert,3583,0,1,0,1,100.0%,35m
6312,2,[ITTC]IntoTheBLINK,3583,0,1,0,1,100.0%,4m
6312,2,GoldenWafers,3583,30,1,2,3,33.3%,38m
6312,2,MightyMuffin,3583,0,0,1,1,0.0%,32m
6324,2,APOLO,3582,1524,314,309,623,50.4%,9m
6324,2,[NwAs]CBSINFERNAL,3582,1556,98,92,190,51.6%,11m
6324,2,Saulo,3582,1458,86,85,171,50.3%,25m
6324,2,Sirokuma,3582,757,73,63,136,53.7%,21m
6324,2,[GEEKED]Amorfo,3582,594,48,11,59,81.4%,19m
6324,2,MIcroGG,3582,645,35,13,48,72.9%,36m
6324,2,Net,3582,167,9,3,12,75.0%,18m
6324,2,[AFK]BerryBar,3582,252,9,6,15,60.0%,21m
6324,2,LeeSeol,3582,138,4,1,5,80.0%,14m
6324,2,dareonion,3582,120,4,4,8,50.0%,27m
6324,3,[BRSS]CheeseZealot,3582,60,3,3,6,50.0%,36m
6324,2,KassToa,3582,0,1,0,1,100.0%,14m
6324,2,[CRAKS]rikolas,3582,0,1,1,2,50.0%,19m
6324,2,All,3582,0,1,6,7,14.3%,33m
6338,2,[TGosuB]water,3581,1536,129,127,256,50.4%,30m
6338,2,[UNpT]Hommega,3581,1363,64,42,106,60.4%,41m
6338,2,[YD2K]ARES,3581,969,40,32,72,55.6%,20m
6338,2,Twinfun,3581,323,17,8,25,68.0%,5m
6338,2,Skyler,3581,165,10,2,12,83.3%,11m
6338,2,chuntle,3581,164,8,1,9,88.9%,16m
6338,2,llllllllll,3581,140,4,1,5,80.0%,5m
6338,2,[CDJT]WarDaddy,3581,126,3,1,4,75.0%,25m
6338,2,[Cryptc]Terra,3581,30,2,2,4,50.0%,36m
6338,2,MarineKingII,3581,30,1,3,4,25.0%,24m
6338,2,zainAU,3581,0,0,3,3,0.0%,3m
6349,2,LMGW,3580,518,22,20,42,52.4%,2m
6349,2,JIN,3580,246,18,20,38,47.4%,11m
6349,3,Gengar,3580,60,18,58,76,23.7%,8m
6349,2,Starform,3580,166,8,1,9,88.9%,9m
6349,2,[TGCF]erOsRAGE,3580,114,8,5,13,61.5%,32m
6349,2,[DSLAM]Cookie,3580,228,8,20,28,28.6%,3m
6349,2,delvur,3580,146,5,7,12,41.7%,30m
6349,2,[PBN]PandaKicker,3580,126,3,1,4,75.0%,40m
6349,2,meg,3580,62,3,3,6,50.0%,12m
6349,2,[BxLxM]Skipper,3580,58,2,2,4,50.0%,9m
6349,2,Macdady,3580,30,1,1,2,50.0%,23m
6349,2,[LifeIn]Chaos,3580,0,0,1,1,0.0%,6m
6349,2,Wayne,3580,0,0,5,5,0.0%,32m
6349,3,IIIIIIIIIIII,3580,0,0,5,5,0.0%,29m
6363,2,Andrew,3579,356,15,11,26,57.7%,22m
6363,2,VINDICTIVE,3579,90,3,6,9,33.3%,19m
6363,2,RideTheSky,3579,46,2,1,3,66.7%,28m
6363,2,Synergy,3579,0,1,2,3,33.3%,35m
6363,2,richardesu,3579,0,0,4,4,0.0%,40m
6368,2,SoapNShampoo,3578,1357,113,114,227,49.8%,25m
6368,2,murK,3578,1444,54,58,112,48.2%,42m
6368,2,TheBest,3578,866,42,19,61,68.9%,25m
6368,2,[lLiTl]Broketail,3578,525,22,20,42,52.4%,40m
6368,2,JoeBiden,3578,347,17,10,27,63.0%,25m
6368,2,ConbiniFee,3578,271,11,7,18,61.1%,40m
6368,2,Hyouka,3578,193,8,2,10,80.0%,40m
6368,2,HoPe,3578,102,7,1,8,87.5%,6m
6368,2,Pinkkiwi,3578,183,7,2,9,77.8%,24m
6368,2,Crosby,3578,95,6,0,6,100.0%,26m
6368,2,StarPlatinum,3578,88,4,2,6,66.7%,3m
6368,2,IlIIIIIIIIlI,3578,0,0,1,1,0.0%,5m
6380,2,Cameron,3577,894,95,90,185,51.4%,41m
6380,1,Blackbeard,3577,1718,91,102,193,47.2%,28m
6380,2,[AbcCo]Nexo,3577,1505,90,99,189,47.6%,8m
6380,2,MrYellow,3577,477,56,39,95,58.9%,14m
6380,1,TotalPackage,3577,1244,38,53,91,41.8%,28m
6380,2,ShriekinGeek,3577,883,37,29,66,56.1%,30m
6380,2,iLoveCrack,3577,365,26,7,33,78.8%,36m
6380,2,[KMRD]Duststar,3577,388,13,17,30,43.3%,19m
6380,2,Devitaliza,3577,194,10,4,14,71.4%,11m
6380,2,[GeekA]Dekamolisher,3577,210,8,13,21,38.1%,17m
6380,2,MAD,3577,200,6,3,9,66.7%,41m
6380,2,WhoAU,3577,151,5,3,8,62.5%,16m
6380,2,[AKLsc]Kupoop,3577,90,4,4,8,50.0%,25m
6380,2,Nanami,3577,88,3,5,8,37.5%,36m
6394,2,[nieBla]aODI,3576,1562,255,256,511,49.9%,24m
6394,2,MMRDonation,3576,690,32,33,65,49.2%,11m
6394,2,HarveyVV,3576,647,26,20,46,56.5%,38m
6394,2,JackFrost,3576,229,14,15,29,48.3%,11m
6394,2,Shakedown,3576,60,3,2,5,60.0%,19m
6394,2,jojamOn,3576,90,3,7,10,30.0%,5m
6394,2,colbutus,3576,30,2,0,2,100.0%,8m
6394,2,[GTWITM]jackiechan,3576,0,1,1,2,50.0%,9m
6394,2,[HØST]Moraes,3576,30,1,5,6,16.7%,32m
6394,2,SINN,3576,0,0,2,2,0.0%,20m
6404,2,Cools,3575,651,122,119,241,50.6%,19m
6404,2,[iNJC]Sproll,3575,773,54,62,116,46.6%,9m
6404,2,Rezian,3575,497,25,23,48,52.1%,37m
6404,2,[Zatra]zid,3575,454,17,14,31,54.8%,25m
6404,1,Ewells,3575,163,5,3,8,62.5%,14m
6404,2,Nepho,3575,30,1,5,6,16.7%,14m
6404,2,[LimaSC]Shield,3575,0,0,6,6,0.0%,41m
6411,2,snow,3574,356,136,133,269,50.6%,14m
6411,2,ShrimpMoney,3574,683,99,107,206,48.1%,23m
6411,2,Markiavelo,3574,672,51,54,105,48.6%,25m
6411,2,JOHNCENA,3574,610,41,32,73,56.2%,25m
6411,2,[Cryptc]draingang,3574,906,34,34,68,50.0%,2m
6411,2,MarineLad,3574,218,8,16,24,33.3%,38m
6411,2,aiforvictory,3574,86,4,3,7,57.1%,17m
6411,2,Vilification,3574,138,3,3,6,50.0%,28m
6419,1,KYLE,3573,1465,316,315,631,50.1%,3m
6419,2,[JiEun]Garry,3573,1577,138,114,252,54.8%,3m
6419,2,Sovereign,3573,934,116,100,216,53.7%,19m
6419,2,[FANN]FANN,3573,1479,60,65,125,48.0%,14m
6419,2,Messi,3573,895,59,30,89,66.3%,19m
6419,2,Chaos,3573,425,31,23,54,57.4%,21m
6419,2,jianhuiben,3573,290,11,6,17,64.7%,2m
6419,2,draconian,3573,122,4,10,14,28.6%,17m
6419,2,[AkaZki]devel,3573,0,1,0,1,100.0%,23m
6419,2,ChumllllChum,3573,0,0,1,1,0.0%,23m
6419,2,Jhdk,3573,0,0,1,1,0.0%,22m
6430,2,[LTlord]HermeScLL,3572,982,98,101,199,49.2%,21m
6430,2,ReD,3572,627,94,99,193,48.7%,11m
6430,2,KIT,3572,687,33,20,53,62.3%,24m
6430,2,lambulancia,3572,504,24,11,35,68.6%,19m
6430,2,[RolIin]Floydle,3572,237,12,2,14,85.7%,5m
6430,2,[b0sss]Argyle,3572,130,5,0,5,100.0%,7m
6430,2,veiledforest,3572,152,5,1,6,83.3%,22m
6430,2,Roteight,3572,152,3,5,8,37.5%,17m
6430,2,OREO,3572,97,3,5,8,37.5%,33m
6430,2,Exar,3572,0,1,0,1,100.0%,16m
6430,2,NeronX,3572,0,1,0,1,100.0%,35m
6430,2,footman,3572,30,1,1,2,50.0%,10m
6430,2,EmoTurtle,3572,0,1,2,3,33.3%,2m
6430,2,Beanfield,3572,0,0,1,1,0.0%,2m
6430,2,IIIlll,3572,0,0,1,1,0.0%,33m
6430,2,Kplr,3572,0,0,4,4,0.0%,14m
6446,2,[men69]denko,3571,517,42,34,76,55.3%,9m
6446,2,MASSUKKAMURA,3571,438,23,12,35,65.7%,5m
6446,2,[Lp]Gollumcha,3571,517,21,16,37,56.8%,23m
6446,2,IIIIIIIIIIII,3571,313,12,7,19,63.2%,17m
6446,2,[Kaii]CyBorg,3571,268,10,6,16,62.5%,30m
6446,2,FPV,3571,96,2,0,2,100.0%,11m
6446,1,MadeinChina,3571,0,1,0,1,100.0%,14m
6446,1,[HSPLR]WayTooGood,3571,0,0,1,1,0.0%,14m
6446,2,[scMAUI]Deltia,3571,0,0,1,1,0.0%,3m
6446,2,[UCLA]QiQi,3571,0,0,2,2,0.0%,5m
6446,1,Turtlemech,3571,0,0,4,4,0.0%,9m
6457,2,[EvilGC]dXRks,3570,778,59,53,112,52.7%,8m
6457,2,[TeamUR]geokilla,3570,1374,59,60,119,49.6%,38m
6457,2,[mGG]Kikkoman,3570,1180,43,53,96,44.8%,17m
6457,2,llllllllllll,3570,333,17,7,24,70.8%,25m
6457,1,Vertigo,3570,240,6,18,24,25.0%,7m
6457,2,Deadlift,3570,0,1,0,1,100.0%,32m
6457,2,[fucla]Michael,3570,0,0,4,4,0.0%,11m
6464,2,[cl0udM]Dedo,3569,1519,358,354,712,50.3%,28m
6464,2,BFsaucebox,3569,1595,91,101,192,47.4%,11m
6464,2,dvi,3569,975,69,69,138,50.0%,32m
6464,2,yyystar,3569,528,35,27,62,56.5%,41m
6464,2,[JABW]aRcAngel,3569,299,14,6,20,70.0%,19m
6464,2,HiWoxs,3569,86,3,6,9,33.3%,1m
6464,2,Luffy,3569,0,0,1,1,0.0%,25m
6471,2,BboySmilez,3568,1236,65,64,129,50.4%,11m
6471,2,smallPP,3568,1349,51,49,100,51.0%,23m
6471,2,[lNI]IceCold,3568,500,34,19,53,64.2%,14m
6471,2,[αX]Kyboi,3568,222,8,9,17,47.1%,3m
6471,2,Brasida,3568,216,7,6,13,53.8%,5m
6471,2,Reddington,3568,178,6,3,9,66.7%,15m
6471,3,LunatiC,3568,0,5,0,5,100.0%,5m
6471,2,darkpouet,3568,88,1,1,2,50.0%,13m
6479,2,Inertia,3567,1595,100,120,220,45.5%,11m
6479,2,llllllllllll,3567,1176,60,57,117,51.3%,40m
6479,2,Ketchup,3567,377,21,7,28,75.0%,41m
6479,3,Schema,3567,324,14,4,18,77.8%,24m
6479,2,OHNOMYDUNGUS,3567,187,7,9,16,43.8%,2m
6479,2,Prana,3567,88,6,0,6,100.0%,41m
6479,3,Odayle,3567,0,5,0,5,100.0%,36m
6479,2,Desier,3567,86,3,3,6,50.0%,3m
6479,2,[PGoose]PurpleGoose,3567,30,2,2,4,50.0%,35m
6479,2,popcorn,3567,0,0,1,1,0.0%,3m
6479,3,MrTredifer,3567,0,0,1,1,0.0%,37m
6479,2,[JDPWN]SkeleJelly,3567,0,0,1,1,0.0%,30m
6479,2,SCSensei,3567,0,0,1,1,0.0%,36m
6492,2,Assissino,3566,828,117,97,214,54.7%,14m
6492,2,Kedar,3566,1420,88,101,189,46.6%,18m
6492,2,[ArchSC]Jerm,3566,1348,84,86,170,49.4%,7m
6492,2,[CGxx]WarWolf,3566,1504,84,91,175,48.0%,14m
6492,2,briznokovic,3566,1415,80,66,146,54.8%,8m
6492,2,Hercules,3566,648,24,24,48,50.0%,27m
6492,2,[Doges]Gimli,3566,316,12,7,19,63.2%,27m
6492,2,RooTCatc,3566,169,10,2,12,83.3%,41m
6492,2,superdemon,3566,142,9,1,10,90.0%,18m
6492,2,[Jah]NineMile,3566,214,6,6,12,50.0%,36m
6492,2,Eugenie,3566,138,4,5,9,44.4%,6m
6492,2,AiSaranG,3566,127,3,8,11,27.3%,21m
6492,2,[HvnDvl]Drath,3566,30,2,1,3,66.7%,41m
6492,2,MauiCali,3566,46,1,3,4,25.0%,29m
6492,2,Antibiotics,3566,30,1,3,4,25.0%,32m
6492,2,PhoenixKING,3566,0,0,2,2,0.0%,19m
6508,2,PonySoprano,3565,1575,395,376,771,51.2%,20m
6508,2,[touchy]Robtimus,3565,1544,198,187,385,51.4%,3m
6508,2,[EoMX]Felpas,3565,1525,152,146,298,51.0%,30m
6508,2,Sun,3565,962,112,104,216,51.9%,23m
6508,2,IlIlllllIIll,3565,1533,91,68,159,57.2%,41m
6508,2,BigBang,3565,1132,45,42,87,51.7%,23m
6508,2,Mad,3565,330,17,7,24,70.8%,29m
6508,2,[ABPK]Vyse,3565,531,16,26,42,38.1%,21m
6508,2,thepokguy,3565,380,15,14,29,51.7%,3m
6508,2,elkum,3565,270,13,4,17,76.5%,19m
6508,1,kanal,3565,183,12,3,15,80.0%,39m
6508,2,[MHSX]Dreadlord,3565,204,8,7,15,53.3%,15m
6508,2,[Zoeiro]Chivas,3565,256,8,9,17,47.1%,9m
6508,2,[H3xPr0]Mwahaha,3565,120,4,5,9,44.4%,25m
6508,2,[SWIF7]DontBlameMe,3565,0,3,0,3,100.0%,28m
6508,2,tinyhos,3565,0,2,3,5,40.0%,6m
6508,2,SuperMetal,3565,30,1,4,5,20.0%,5m
6508,2,JDP,3565,0,0,1,1,0.0%,14m
6526,1,[CToL]FractalSky,3564,1136,100,117,217,46.1%,41m
6526,2,dabi,3564,1545,90,64,154,58.4%,25m
6526,2,Hexenreise,3564,1198,48,44,92,52.2%,20m
6526,2,Chonger,3564,842,38,37,75,50.7%,8m
6526,2,XxSergioPSxX,3564,606,27,16,43,62.8%,31m
6526,3,Olyx,3564,374,13,9,22,59.1%,13m
6526,2,PLAYLIKEDUMB,3564,197,9,2,11,81.8%,11m
6526,2,LaLechuga,3564,206,7,8,15,46.7%,18m
6526,2,Jecktor,3564,30,1,2,3,33.3%,31m
6526,2,XIAOTIME,3564,0,0,4,4,0.0%,6m
6526,2,Draztik,3564,0,0,5,5,0.0%,22m
6537,2,quissential,3563,688,69,60,129,53.5%,23m
6537,2,RAXonRAX,3563,694,54,47,101,53.5%,6m
6537,2,HanNiBal,3563,680,35,23,58,60.3%,10m
6537,2,ImMINING,3563,242,11,3,14,78.6%,10m
6537,2,ReVenGeRAG,3563,30,5,2,7,71.4%,26m
6537,2,[INextI]Gergy,3563,86,4,4,8,50.0%,3m
6537,2,[VTV]SeuFrancisco,3563,120,4,6,10,40.0%,7m
6537,2,toll,3563,0,1,0,1,100.0%,5m
6537,2,[dK]MetalSpirit,3563,88,1,1,2,50.0%,3m
6537,2,ManMythMurse,3563,30,1,2,3,33.3%,6m
6537,2,veder,3563,30,1,2,3,33.3%,3m
6537,2,[LGNxx]Shadow,3563,0,0,1,1,0.0%,33m
6537,2,[ValidG]RabidMonkey,3563,0,0,3,3,0.0%,27m
6550,2,BillyJohnson,3562,1555,136,119,255,53.3%,22m
6550,2,[Sune]Galactus,3562,1491,122,111,233,52.4%,38m
6550,2,[ZTemp]Observer,3562,981,65,9,74,87.8%,36m
6550,2,[GnR]Robot,3562,124,10,4,14,71.4%,21m
6550,3,[αXLa]Supremo,3562,286,10,9,19,52.6%,19m
6550,2,llllllllllll,3562,167,9,4,13,69.2%,23m
6550,2,[Ato2]Bozi,3562,116,4,5,9,44.4%,30m
6550,2,llllllllllll,3562,90,4,9,13,30.8%,32m
6550,2,IlIlIlIlIlIl,3562,102,3,0,3,100.0%,18m
6550,2,[EvilGC]infernal,3562,58,3,3,6,50.0%,41m
6550,1,[5150BB]JJMax,3562,96,2,0,2,100.0%,21m
6550,2,[Shardz]ThatOneDude,3562,88,1,1,2,50.0%,40m
6550,2,[Chikki]Cantankerous,3562,0,0,1,1,0.0%,3m
6550,2,[TCCrew]SneakyCuack,3562,0,0,1,1,0.0%,20m
6564,2,[SsaYnS]Boundless,3561,1551,156,153,309,50.5%,20m
6564,2,BlooDy,3561,427,110,100,210,52.4%,21m
6564,2,Zerus,3561,779,68,45,113,60.2%,30m
6564,2,hulkus,3561,739,62,43,105,59.0%,5m
6564,2,lIlIlIlIl,3561,982,51,46,97,52.6%,33m
6564,2,Anthony,3561,297,10,23,33,30.3%,23m
6564,3,deadlykitten,3561,0,5,0,5,100.0%,35m
6564,3,IIIIIIIIIIII,3561,0,4,1,5,80.0%,30m
6564,2,[FEETww]FEETLOVER,3561,183,4,5,9,44.4%,19m
6564,2,GlebKaroch,3561,0,4,5,9,44.4%,35m
6564,1,poll,3561,96,2,0,2,100.0%,26m
6564,2,Ryry,3561,88,1,1,2,50.0%,29m
6564,2,penlsgoblin,3561,0,0,5,5,0.0%,20m
6577,2,[NKor]OgataHaruna,3560,1524,196,207,403,48.6%,17m
6577,2,[AbcCo]Eivici,3560,1506,82,86,168,48.8%,5m
6577,2,Maffer,3560,914,56,60,116,48.3%,28m
6577,2,Neox,3560,116,4,6,10,40.0%,21m
6577,2,GhostDragon,3560,102,3,0,3,100.0%,3m
6582,2,Mree,3559,1562,169,158,327,51.7%,8m
6582,2,[DC420]DanCLan,3559,1534,140,143,283,49.5%,3m
6582,2,[TOPZ]BananaMan,3559,608,32,19,51,62.7%,31m
6582,2,Thursty,3559,844,29,32,61,47.5%,5m
6582,2,[DE]Ashlyn,3559,538,18,29,47,38.3%,30m
6582,2,Mingyu,3559,236,13,5,18,72.2%,38m
6582,2,Slackoh,3559,271,12,9,21,57.1%,42m
6582,2,UdUwUdU,3559,30,2,1,3,66.7%,12m
6582,2,SpliTe,3559,0,0,1,1,0.0%,23m
6591,2,[CrnKy]Yakuzaku,3558,1253,63,61,124,50.8%,17m
6591,2,[DNKCFT]HoRNET,3558,325,45,37,82,54.9%,14m
6591,2,[TSDSB]Bonjwa,3558,572,23,19,42,54.8%,23m
6591,2,Jabalsal,3558,232,8,6,14,57.1%,5m
6591,2,[9Lives]NineTailz,3558,216,7,13,20,35.0%,38m
6591,2,IIIIIIIIIIII,3558,88,6,1,7,85.7%,18m
6591,3,llllllllllll,3558,0,5,0,5,100.0%,32m
6591,2,BLforK,3558,0,0,1,1,0.0%,41m
6591,2,[5UP]SeksNugget,3558,0,0,1,1,0.0%,28m
6591,2,Meiji,3558,0,0,3,3,0.0%,36m
6601,2,Burcx,3557,1566,75,72,147,51.0%,39m
6601,2,[unooob]dOsiZ,3557,194,45,56,101,44.6%,33m
6601,2,Bladevision,3557,173,23,13,36,63.9%,24m
6601,2,THXHXD,3557,492,20,19,39,51.3%,10m
6601,3,piemel,3557,254,8,9,17,47.1%,10m
6601,2,Bearwidme,3557,216,8,9,17,47.1%,3m
6601,2,Aks,3557,0,1,0,1,100.0%,12m
6601,2,Shuriken,3557,97,1,1,2,50.0%,6m
6601,3,[NoTvT]MouseKing,3557,0,0,1,1,0.0%,8m
6601,2,Bedau,3557,0,0,1,1,0.0%,14m
6601,2,[xlVlen]Magneto,3557,0,0,1,1,0.0%,39m
6612,2,alexdrg,3556,1198,97,93,190,51.1%,14m
6612,2,[LOHd]CryWolf,3556,1031,38,42,80,47.5%,3m
6612,2,[DarkAG]Solstice,3556,903,36,39,75,48.0%,23m
6612,2,[KingSC]Bunker,3556,270,10,17,27,37.0%,12m
6612,2,Gambos,3556,46,6,2,8,75.0%,7m
6612,2,Radiation,3556,92,4,9,13,30.8%,23m
6612,2,[UCSD]nobodywonder,3556,118,3,1,4,75.0%,24m
6612,2,[FataI]ReBeL,3556,48,3,6,9,33.3%,26m
6612,2,[haidua]MetallicaVN,3556,58,2,3,5,40.0%,31m
6612,2,AgentSquall,3556,30,1,3,4,25.0%,11m
6612,2,Stacy,3556,0,1,5,6,16.7%,36m
6612,2,ohey,3556,0,0,1,1,0.0%,40m
6624,2,Jayne,3555,1606,402,397,799,50.3%,31m
6624,2,[TkQ]BeauFlex,3555,1616,360,351,711,50.6%,42m
6624,2,[MaxWin]Dream,3555,603,213,195,408,52.2%,24m
6624,2,IMgorgeous,3555,1032,38,37,75,50.7%,25m
6624,2,NateAndMimsy,3555,272,37,21,58,63.8%,3m
6624,2,unforgivable,3555,390,22,5,27,81.5%,3m
6624,2,pookie,3555,520,18,25,43,41.9%,42m
6624,2,[DHZAcD]Madruga,3555,360,17,18,35,48.6%,11m
6624,2,[Cryptc]Lazorcat,3555,366,15,9,24,62.5%,28m
6624,2,[TKS]Time,3555,0,0,1,1,0.0%,27m
6624,3,[TeamLT]XFong,3555,0,0,1,1,0.0%,4m
6624,2,[Lp]NeoShaGgy,3555,0,0,2,2,0.0%,6m
6624,2,[91Fans]Ezreal,3555,0,0,2,2,0.0%,23m
6637,2,Apolohessi,3554,1379,138,130,268,51.5%,10m
6637,2,statsfan,3554,1595,76,80,156,48.7%,41m
6637,2,llllllllllll,3554,1251,59,40,99,59.6%,28m
6637,2,Barcode,3554,666,43,37,80,53.8%,20m
6637,2,kumiho,3554,393,17,13,30,56.7%,2m
6637,2,[OD2019]SwissCheese,3554,279,13,5,18,72.2%,32m
6637,2,SkOOg,3554,364,12,11,23,52.2%,2m
6637,2,RicocheT,3554,126,8,1,9,88.9%,36m
6637,2,dirtyplayer,3554,114,3,5,8,37.5%,24m
6637,2,[SIG762]Masonry,3554,30,2,3,5,40.0%,32m
6637,2,Tazel,3554,30,1,4,5,20.0%,35m
6648,2,[33]IIIIBreeksta,3553,552,148,147,295,50.2%,26m
6648,2,GhostKing,3553,1193,74,81,155,47.7%,33m
6648,2,Wehrmacht,3553,434,26,8,34,76.5%,36m
6648,2,Xecuter,3553,324,12,18,30,40.0%,17m
6648,2,batty,3553,205,7,8,15,46.7%,25m
6648,3,Sushi,3553,166,5,1,6,83.3%,21m
6648,2,ByuN,3553,120,4,5,9,44.4%,40m
6648,2,Integrity,3553,60,2,3,5,40.0%,10m
6648,2,[GØSU]DruidMDT,3553,0,0,1,1,0.0%,12m
6648,2,LuckyTiger,3553,0,0,1,1,0.0%,31m
6658,2,[TXOP]Milo,3552,1209,118,114,232,50.9%,30m
6658,2,JoNyYezPaPa,3552,279,44,44,88,50.0%,3m
6658,2,SisZer,3552,518,39,30,69,56.5%,14m
6658,2,AdeptMan,3552,421,18,13,31,58.1%,36m
6658,3,Galaxy,3552,277,13,8,21,61.9%,34m
6658,2,Deathskippy,3552,404,13,25,38,34.2%,25m
6658,2,Ruefio,3552,102,2,1,3,66.7%,25m
6658,2,[1SBT1]Marcotte,3552,60,2,4,6,33.3%,14m
6658,2,Cayde,3552,62,2,6,8,25.0%,35m
6658,2,bumdiggity,3552,88,1,1,2,50.0%,6m
6668,2,Rapter,3551,1595,530,523,1053,50.3%,17m
6668,2,[Miracl]xakota,3551,1566,223,220,443,50.3%,33m
6668,2,[BoRnGo]MooCowThon,3551,1538,134,116,250,53.6%,33m
6668,2,TuFF,3551,638,131,57,188,69.7%,22m
6668,2,Johann,3551,1500,61,61,122,50.0%,21m
6668,1,RanaAsesina,3551,249,11,3,14,78.6%,21m
6668,2,[OpT1cZ]Potato,3551,256,11,4,15,73.3%,33m
6668,2,ElkKiller,3551,348,11,11,22,50.0%,28m
6668,2,[BlmBob]Ctone,3551,230,10,3,13,76.9%,37m
6668,2,Rapture,3551,230,9,10,19,47.4%,23m
6668,2,LomayLica,3551,0,5,0,5,100.0%,11m
6668,2,[GOPERÚ]GhostShadow,3551,88,2,0,2,100.0%,40m
6668,2,[MMRDKS]BuddhaMan,3551,30,1,5,6,16.7%,6m
6681,1,llllllllllll,3550,1734,839,848,1687,49.7%,26m
6681,2,RAT,3550,1454,375,378,753,49.8%,17m
6681,2,sketch,3550,1553,231,212,443,52.1%,28m
6681,2,platinumfire,3550,1629,168,164,332,50.6%,21m
6681,2,[TaRus]Shinigami,3550,319,79,55,134,59.0%,35m
6681,2,[dLife]Brewmaster,3550,259,49,35,84,58.3%,35m
6681,2,GeneralZ,3550,584,23,19,42,54.8%,41m
6681,2,[Suxor]KlutZ,3550,458,18,22,40,45.0%,27m
6681,2,[CUMBAT]koi,3550,428,16,15,31,51.6%,23m
6681,2,Shadow,3550,315,14,6,20,70.0%,31m
6681,2,[Dicboy]Zeprox,3550,321,13,7,20,65.0%,4m
6681,3,TraGic,3550,166,5,2,7,71.4%,22m
6681,2,[MRCYLS]Nightmare,3550,18,2,1,3,66.7%,18m
6681,2,[SPARK]Wulfe,3550,88,1,1,2,50.0%,27m
6681,2,[maj]Ninjz,3550,0,1,2,3,33.3%,31m
6681,2,[YeRlN]Gfriends,3550,0,1,3,4,25.0%,33m
6681,3,Heisenberg,3550,0,0,1,1,0.0%,33m
6681,2,[SkFIm]FenixLizard,3550,0,0,1,1,0.0%,13m
6699,2,[2Pac96]HeathCliff,3549,1539,313,298,611,51.2%,11m
6699,2,Saerodor,3549,819,34,25,59,57.6%,42m
6699,2,[SuperZ]Montréalais,3549,176,7,7,14,50.0%,23m
6699,2,[APM]Genuine,3549,90,6,7,13,46.2%,18m
6699,2,Fewd,3549,179,6,7,13,46.2%,20m
6699,2,JanMVincent,3549,88,2,0,2,100.0%,36m
6699,2,Liger,3549,62,2,6,8,25.0%,10m
6699,2,BattleHouser,3549,0,0,1,1,0.0%,7m
6707,2,[Mc]THEALCHEMIST,3548,1454,284,282,566,50.2%,21m
6707,2,ChaseJuggler,3548,1463,176,163,339,51.9%,2m
6707,2,Fornax,3548,1574,136,131,267,50.9%,35m
6707,2,[EZDUNK]AlexKidd,3548,1596,91,81,172,52.9%,13m
6707,2,[inHell]TheSirFM,3548,1172,70,51,121,57.9%,20m
6707,2,Photon,3548,1416,58,70,128,45.3%,17m
6707,2,[IMDSI]Gtrimal,3548,952,48,26,74,64.9%,36m
6707,2,[NPhasA]wicky,3548,1115,45,56,101,44.6%,3m
6707,2,Kapowy,3548,570,42,31,73,57.5%,19m
6707,2,[SsaYnS]Bull,3548,469,35,31,66,53.0%,31m
6707,2,[GØSU]Ironkun,3548,765,33,22,55,60.0%,25m
6707,2,pomf,3548,368,16,12,28,57.1%,2m
6707,2,[DETER]aOtherGuy,3548,430,16,15,31,51.6%,12m
6707,2,SCBoyIsRich,3548,232,8,13,21,38.1%,32m
6707,2,yolomarine,3548,60,2,7,9,22.2%,27m
6707,2,Lemon,3548,0,0,2,2,0.0%,30m
6723,2,[XpKb]Laraku,3547,1333,179,126,305,58.7%,6m
6723,2,Megaman,3547,1311,164,152,316,51.9%,14m
6723,2,blackjack,3547,1074,77,42,119,64.7%,2m
6723,2,FlashOver,3547,596,39,34,73,53.4%,32m
6723,2,Fire,3547,541,30,30,60,50.0%,16m
6723,2,glloyd,3547,694,25,28,53,47.2%,17m
6723,2,CannaBicol,3547,517,23,14,37,62.2%,33m
6723,2,ggwp,3547,664,21,32,53,39.6%,33m
6723,2,[PinkPi]LittlePony,3547,319,17,6,23,73.9%,33m
6723,2,PlowChimp,3547,204,9,2,11,81.8%,23m
6723,2,Mimir,3547,229,8,6,14,57.1%,6m
6723,2,[64WeNi]Nightmare,3547,0,1,0,1,100.0%,6m
6723,2,[YE71]aYawningLion,3547,0,1,5,6,16.7%,20m
6723,2,[Spiffs]Spiffy,3547,0,0,1,1,0.0%,14m
6723,2,Stimpack,3547,0,0,1,1,0.0%,25m
6723,2,Phoenix,3547,0,0,3,3,0.0%,20m
6739,2,[PiGPan]Teach,3546,1505,128,128,256,50.0%,21m
6739,2,[eSun]NorM,3546,845,45,55,100,45.0%,6m
6739,2,BodakEyes,3546,407,19,12,31,61.3%,33m
6739,2,[WO0K]WhiteClaw,3546,483,17,25,42,40.5%,19m
6739,2,Mantecol,3546,114,3,1,4,75.0%,3m
6739,2,SmellyOnion,3546,0,1,1,2,50.0%,27m
6739,3,Stanky,3546,0,0,1,1,0.0%,5m
6746,2,[esDGs]DGsTroNiCk,3545,1568,118,118,236,50.0%,11m
6746,2,sunnyD,3545,1284,106,91,197,53.8%,6m
6746,2,crazy,3545,1473,59,59,118,50.0%,16m
6746,2,IIIIIIIIIIII,3545,333,14,9,23,60.9%,39m
6746,2,GalaxyDDH,3545,376,14,15,29,48.3%,41m
6746,2,[SHle]molecular,3545,168,6,3,9,66.7%,17m
6746,3,Ouroboros,3545,0,5,0,5,100.0%,14m
6746,3,[CaptA]Sentinel,3545,0,5,0,5,100.0%,35m
6746,3,brandon,3545,0,1,0,1,100.0%,28m
6746,3,[MBRFN]KaRkhas,3545,0,0,1,1,0.0%,16m
6746,3,[SCboys]Coopernana,3545,0,0,1,1,0.0%,24m
6746,2,[Cind3r]FightDiaper,3545,0,0,2,2,0.0%,35m
6746,2,Fate,3545,73,0,10,10,0.0%,40m
6759,2,GuapoWen,3544,1031,462,473,935,49.4%,29m
6759,2,[TGosuC]Niobium,3544,915,189,189,378,50.0%,38m
6759,2,[Mooist]JayTheMaster,3544,1202,44,54,98,44.9%,33m
6759,2,John,3544,496,24,15,39,61.5%,5m
6759,3,GHOSTSHADOW,3544,0,5,0,5,100.0%,3m
6759,2,Jhdk,3544,30,2,2,4,50.0%,9m
6759,2,[PwT]Twoice,3544,30,2,3,5,40.0%,30m
6759,3,[LgnTDS]MachoMantis,3544,0,1,0,1,100.0%,7m
6759,3,Loladin,3544,0,0,1,1,0.0%,17m
6759,3,davidit,3544,0,0,1,1,0.0%,15m
6769,2,luckyterran,3543,556,116,96,212,54.7%,30m
6769,2,KevMcAlister,3543,1370,64,60,124,51.6%,35m
6769,2,Epicktroll,3543,735,54,63,117,46.2%,31m
6769,2,MontyBurns,3543,658,25,23,48,52.1%,28m
6769,3,[Gh0std]SemiPOlaR,3543,317,14,8,22,63.6%,3m
6769,2,[TGosuC]Dogfobmal,3543,288,11,7,18,61.1%,30m
6769,2,Wildmilf,3543,99,6,8,14,42.9%,32m
6769,2,Theory,3543,184,5,5,10,50.0%,42m
6769,3,Shoegaze,3543,123,3,6,9,33.3%,18m
6769,3,dlinqnt,3543,0,1,0,1,100.0%,28m
6769,2,Frankenstein,3543,30,1,4,5,20.0%,3m
6769,3,Lexender,3543,0,0,1,1,0.0%,13m
6769,3,bigL,3543,0,0,1,1,0.0%,39m
6769,3,[XpKb]Nanoha,3543,0,0,1,1,0.0%,16m
6769,3,ssjsc,3543,0,0,1,1,0.0%,33m
6784,2,[DRKRPT]iamsobuf,3542,1604,191,191,382,50.0%,2m
6784,2,[RUMB]Vlad,3542,1599,77,72,149,51.7%,23m
6784,2,[NPhase]Droneicus,3542,1098,43,43,86,50.0%,32m
6784,2,xellowgetfuk,3542,826,38,26,64,59.4%,25m
6784,2,DhOjhA,3542,445,28,45,73,38.4%,17m
6784,2,[Hawkz]Colson,3542,560,22,22,44,50.0%,25m
6784,2,TaKeAwaY,3542,546,22,22,44,50.0%,3m
6784,3,Poumpopbadaw,3542,401,17,8,25,68.0%,4m
6784,3,Dostoevsky,3542,0,5,0,5,100.0%,5m
6784,3,Tinker,3542,117,5,1,6,83.3%,12m
6784,2,[HgravH]Varaxious,3542,0,1,1,2,50.0%,23m
6784,2,[αB]Mythikdawn,3542,0,1,4,5,20.0%,35m
6784,3,[DHZAcD]Andprett,3542,0,0,1,1,0.0%,15m
6784,3,[MOBOZ]extremities,3542,0,0,1,1,0.0%,18m
6798,2,yubba,3541,1553,162,147,309,52.4%,10m
6798,2,HiddenSquid,3541,1272,137,113,250,54.8%,10m
6798,2,haaLe,3541,1478,86,83,169,50.9%,19m
6798,2,Cray,3541,1181,48,44,92,52.2%,37m
6798,2,[Xpk]Sedna,3541,1000,42,36,78,53.8%,10m
6798,3,GameIMBA,3541,398,14,15,29,48.3%,10m
6798,2,Kraulenth,3541,156,5,10,15,33.3%,16m
6798,3,HUSKY,3541,0,3,2,5,60.0%,7m
6798,3,Sean,3541,0,1,0,1,100.0%,19m
6798,3,aeiou,3541,0,1,0,1,100.0%,3m
6798,2,RiasGremory,3541,0,1,1,2,50.0%,11m
6809,2,HeHateMe,3540,1576,376,370,746,50.4%,42m
6809,2,JusTice,3540,1573,101,102,203,49.8%,16m
6809,2,TerranItUp,3540,452,16,21,37,43.2%,40m
6809,3,Glorify,3540,310,10,5,15,66.7%,20m
6809,3,[MURKYA]CazZaH,3540,168,7,2,9,77.8%,31m
6809,3,[P00S1E]blubr,3540,234,7,5,12,58.3%,23m
6809,2,[cl0udM]Thimius,3540,144,6,12,18,33.3%,31m
6809,2,Seiyan,3540,178,5,5,10,50.0%,9m
6809,3,TheKeystone,3540,0,4,1,5,80.0%,4m
6809,3,[inCo]SystemCall,3540,0,4,1,5,80.0%,39m
6809,3,[NW5]YoGoldorak,3540,92,4,19,23,17.4%,37m
6809,3,ArtVandelay,3540,0,0,1,1,0.0%,26m
6821,2,[CAT7]gwat,3539,1567,120,107,227,52.9%,25m
6821,2,[Yamaha]FATCHOOCHIE,3539,1260,107,103,210,51.0%,17m
6821,2,[VTClan]DaBigKevocho,3539,390,31,25,56,55.4%,19m
6821,2,llllllllllll,3539,796,29,39,68,42.6%,39m
6821,2,[UpeV]Lionel,3539,102,3,1,4,75.0%,28m
6821,3,[icon]Lildaver,3539,0,1,0,1,100.0%,6m
6821,3,Dragon,3539,0,0,1,1,0.0%,21m
6821,2,ToastBones,3539,0,0,6,6,0.0%,42m
6829,2,[ValidG]Lemonio,3538,1540,376,375,751,50.1%,33m
6829,2,[QMS]TheVoid,3538,1487,250,252,502,49.8%,41m
6829,2,lowlygulper,3538,1627,199,196,395,50.4%,42m
6829,2,[Wizzrd]WickedAkuba,3538,1270,119,110,229,52.0%,40m
6829,2,Morpheus,3538,932,94,83,177,53.1%,12m
6829,2,HUASCAR,3538,1163,65,65,130,50.0%,6m
6829,2,DangaZone,3538,639,56,58,114,49.1%,25m
6829,2,hasu,3538,561,21,17,38,55.3%,39m
6829,3,MicroJackson,3538,0,5,0,5,100.0%,10m
6829,3,SpaceJustice,3538,30,1,1,2,50.0%,11m
6829,2,MasterChef,3538,88,1,2,3,33.3%,35m
6829,3,DieInStyle,3538,0,0,1,1,0.0%,9m
6841,2,[JAGWN]Kakaroto,3537,1572,268,251,519,51.6%,39m
6841,3,bobinski,3537,1642,251,221,472,53.2%,28m
6841,2,RobotNinja,3537,1438,61,59,120,50.8%,17m
6841,3,cGSHeartlesS,3537,668,59,53,112,52.7%,18m
6841,2,aLite,3537,1348,57,48,105,54.3%,11m
6841,2,Smoughys,3537,262,9,20,29,31.0%,21m
6841,3,Curtains,3537,117,6,1,7,85.7%,9m
6841,3,FemboyDoomer,3537,0,5,0,5,100.0%,31m
6841,3,GhostDog,3537,0,5,0,5,100.0%,24m
6841,2,[CRAKS]schnaider,3537,180,5,5,10,50.0%,35m
6841,2,wolfhead,3537,114,4,9,13,30.8%,12m
6852,2,IIIIIIIIIII,3536,1550,362,348,710,51.0%,5m
6852,2,[MSFT]LuisG,3536,1640,258,246,504,51.2%,8m
6852,2,Weebles,3536,1378,89,89,178,50.0%,19m
6852,2,Alternate,3536,507,55,47,102,53.9%,36m
6852,2,[trolz]Hakase,3536,482,41,39,80,51.2%,30m
6852,3,[WarCo]lukija,3536,403,18,0,18,100.0%,28m
6852,1,Perttu,3536,258,11,4,15,73.3%,3m
6852,2,Chocolate,3536,116,5,6,11,45.5%,8m
6852,2,[VERUM]Enigma,3536,30,2,7,9,22.2%,20m
6852,3,Skav,3536,30,1,1,2,50.0%,11m
6852,3,Scorpion,3536,30,1,1,2,50.0%,16m
6863,2,ssktotoro,3535,1619,314,295,609,51.6%,14m
6863,2,[Aprica]LynN,3535,1187,74,64,138,53.6%,27m
6863,2,PiFace,3535,1069,48,37,85,56.5%,18m
6863,2,[3g0]RedRibbon,3535,314,11,24,35,31.4%,42m
6863,3,LeeSiTsyn,3535,0,5,0,5,100.0%,28m
6863,3,Haru,3535,0,5,0,5,100.0%,35m
6863,3,Nuffy,3535,0,5,0,5,100.0%,5m
6863,2,llllIIIlIlll,3535,60,2,4,6,33.3%,17m
6863,3,Ergo,3535,30,1,2,3,33.3%,36m
6863,2,Giraffe,3535,30,1,7,8,12.5%,42m
6863,3,applegrower,3535,0,0,1,1,0.0%,39m
6874,2,SemiC,3534,258,9,9,18,50.0%,11m
6874,2,[ToRQ]Wade,3534,226,8,11,19,42.1%,29m
6874,3,[ilmba]llllllllllll,3534,141,7,1,8,87.5%,36m
6874,3,[CH3ES3]ColonelHamm,3534,121,2,1,3,66.7%,36m
6874,2,Shoefish,3534,88,2,1,3,66.7%,33m
6879,2,[A225]Ecnunn,3533,1636,360,342,702,51.3%,40m
6879,2,Perfect,3533,561,21,24,45,46.7%,25m
6879,2,SherifRaynor,3533,446,16,22,38,42.1%,42m
6879,2,[MTMRK]HunterKiller,3533,359,14,15,29,48.3%,32m
6879,2,BROKERONE,3533,220,6,6,12,50.0%,11m
6879,3,[TMBls]Mooie,3533,0,1,0,1,100.0%,26m
6879,2,littleone,3533,30,1,5,6,16.7%,6m
6886,2,[SsaYnS]Gustel,3532,1604,223,220,443,50.3%,38m
6886,2,[EZDUNK]Oberyn,3532,1370,181,173,354,51.1%,19m
6886,2,[nieBla]Aban,3532,1624,96,90,186,51.6%,7m
6886,2,Coltron,3532,1075,67,75,142,47.2%,26m
6886,2,Serenity,3532,1100,37,50,87,42.5%,42m
6886,2,adamsun,3532,692,28,23,51,54.9%,31m
6886,2,ahfatlee,3532,455,23,12,35,65.7%,33m
6886,2,IIIIIIIIIII,3532,300,15,9,24,62.5%,42m
6886,2,Juggler,3532,350,13,15,28,46.4%,41m
6886,3,buttery,3532,140,5,2,7,71.4%,13m
6886,3,[ROSC2]Avalox,3532,0,1,0,1,100.0%,28m
6886,3,[HGNXXX]Bloog,3532,30,1,2,3,33.3%,41m
6886,3,[FMX]Jackblaster,3532,0,0,1,1,0.0%,39m
6899,2,Spectre,3531,457,81,87,168,48.2%,23m
6899,2,TheFountain,3531,1177,75,79,154,48.7%,25m
6899,2,TripleDeke,3531,688,42,42,84,50.0%,23m
6899,2,[KGH2]Typhon,3531,268,11,10,21,52.4%,33m
6899,1,Twitchy,3531,224,10,3,13,76.9%,15m
6899,2,RandomMan,3531,154,6,2,8,75.0%,33m
6899,1,Omega,3531,160,5,1,6,83.3%,35m
6899,2,jaymeson,3531,178,5,5,10,50.0%,5m
6899,2,[PZDC]KeyserSoze,3531,92,3,6,9,33.3%,31m
6899,3,Griezon,3531,30,1,1,2,50.0%,22m
6909,2,zxlxhx,3530,1198,45,54,99,45.5%,6m
6909,3,HydraKing,3530,613,40,31,71,56.3%,39m
6909,2,commanderh,3530,889,37,31,68,54.4%,40m
6909,3,Orangeknight,3530,0,5,0,5,100.0%,7m
6909,2,MacK,3530,154,5,5,10,50.0%,27m
6909,3,[MdCzBd]Charkosh,3530,0,0,1,1,0.0%,22m
6909,3,LifeSouL,3530,0,0,1,1,0.0%,24m
6916,2,[BootyD]BBBootyDaddy,3529,1509,121,126,247,49.0%,3m
6916,2,Metal,3529,1566,73,61,134,54.5%,41m
6916,2,IIIIIIIIIIII,3529,1423,60,51,111,54.1%,27m
6916,3,[Despi]Oxymoron,3529,504,22,13,35,62.9%,12m
6916,2,Rifer,3529,596,21,23,44,47.7%,3m
6916,2,[EtrOy]Tythus,3529,438,16,14,30,53.3%,9m
6916,2,llllllllllll,3529,307,14,23,37,37.8%,26m
6916,2,Lol,3529,281,13,9,22,59.1%,36m
6916,3,DUEÑODETUANO,3529,367,13,12,25,52.0%,7m
6916,2,[PHAN]Phantom,3529,319,12,13,25,48.0%,5m
6916,3,IIIIIIIIIIII,3529,0,5,0,5,100.0%,15m
6916,2,Sticky,3529,88,3,3,6,50.0%,32m
6916,2,classic,3529,58,2,5,7,28.6%,19m
6929,2,orion,3528,1530,200,174,374,53.5%,5m
6929,2,TalexT,3528,1601,153,153,306,50.0%,9m
6929,2,trtr,3528,1425,125,90,215,58.1%,14m
6929,2,Dirk,3528,1404,118,127,245,48.2%,22m
6929,2,wowaka,3528,336,27,21,48,56.2%,7m
6929,2,[DRKFOX]Knighter,3528,394,23,18,41,56.1%,7m
6929,2,AirGoodman,3528,365,16,21,37,43.2%,33m
6929,3,[CatBad]MarsuPilami,3528,357,15,5,20,75.0%,5m
6929,2,[nieBla]Life,3528,268,13,13,26,50.0%,33m
6929,3,[GOPERÚ]Fox,3528,80,7,1,8,87.5%,18m
6929,2,Drement,3528,105,6,8,14,42.9%,33m
6929,2,TheGiant,3528,58,3,4,7,42.9%,3m
6941,2,person,3527,1134,75,86,161,46.6%,28m
6941,2,Vlad,3527,771,61,71,132,46.2%,41m
6941,2,BreadForceXY,3527,879,34,40,74,45.9%,28m
6941,3,Jellyfish,3527,764,31,17,48,64.6%,37m
6941,2,Erebus,3527,860,29,38,67,43.3%,11m
6941,2,wqe,3527,142,7,1,8,87.5%,14m
6941,2,[hM]seannyELITE,3527,47,7,13,20,35.0%,3m
6941,3,Glem,3527,0,5,0,5,100.0%,35m
6941,3,Hypnos,3527,114,5,1,6,83.3%,17m
6941,3,pyle,3527,0,3,2,5,60.0%,31m
6941,2,ceturion,3527,88,2,1,3,66.7%,27m
6941,3,Echo,3527,0,1,4,5,20.0%,2m
6941,3,[BA5B]Whoozie,3527,0,0,1,1,0.0%,22m
6941,3,Orbit,3527,0,0,1,1,0.0%,11m
6941,2,zzq,3527,0,0,4,4,0.0%,39m
6956,2,SCV,3526,1042,94,78,172,54.7%,4m
6956,2,onestratterr,3526,1279,62,65,127,48.8%,37m
6956,2,[Kyrie]Loveivy,3526,732,40,36,76,52.6%,23m
6956,2,[0PGC0]Marat,3526,921,39,34,73,53.4%,12m
6956,2,bigwaN,3526,617,31,15,46,67.4%,19m
6956,2,Ketchup,3526,434,19,15,34,55.9%,42m
6956,2,Ares,3526,226,8,6,14,57.1%,36m
6956,3,Muneee,3526,0,1,3,4,25.0%,7m
6956,3,[Hi5]Checkmate,3526,0,0,1,1,0.0%,39m
6956,2,Mentanje,3526,0,0,3,3,0.0%,32m
6966,2,Bunn,3525,1547,151,145,296,51.0%,40m
6966,3,AwfullChrono,3525,1627,120,101,221,54.3%,31m
6966,2,Snofus,3525,419,118,114,232,50.9%,21m
6966,2,[N4S]Zephyr,3525,1593,109,110,219,49.8%,40m
6966,2,ExTrEaM,3525,1032,44,36,80,55.0%,25m
6966,2,[URUC]VGhost,3525,697,31,28,59,52.5%,40m
6966,2,ProTerran,3525,507,28,11,39,71.8%,33m
6966,2,FALAPARK,3525,595,28,18,46,60.9%,19m
6966,3,[N2F]YoSep,3525,482,26,22,48,54.2%,12m
6966,2,Faith,3525,240,9,9,18,50.0%,42m
6966,2,fireegg,3525,120,5,5,10,50.0%,21m
6966,3,snAck,3525,0,3,0,3,100.0%,34m
6966,1,Khan,3525,0,1,0,1,100.0%,39m
6966,3,Diogo,3525,0,1,0,1,100.0%,22m
6966,3,[tTZz]InitialLiMiT,3525,0,1,1,2,50.0%,42m
6981,2,fIGhter,3524,928,36,35,71,50.7%,5m
6981,3,NightFire,3524,760,33,22,55,60.0%,17m
6981,3,[xAAx]Hunterrr,3524,580,22,23,45,48.9%,10m
6981,3,Jiga,3524,219,9,4,13,69.2%,39m
6981,2,Axelroose,3524,86,4,4,8,50.0%,40m
6981,3,eqe,3524,30,1,1,2,50.0%,15m
6981,3,roLLanD,3524,0,0,1,1,0.0%,24m
6981,3,dreambeing,3524,0,0,1,1,0.0%,37m
6981,3,[Ash3s]BeingPool,3524,0,0,2,2,0.0%,21m
6990,2,IIIIIIIIIIII,3523,1491,231,228,459,50.3%,3m
6990,3,Tayester,3523,1620,202,145,347,58.2%,20m
6990,2,SupremeJozan,3523,902,174,167,341,51.0%,23m
6990,2,campbell,3523,958,151,130,281,53.7%,19m
6990,2,gTimes,3523,1544,121,101,222,54.5%,23m
6990,2,[OKUMA]shinjp,3523,349,85,78,163,52.1%,33m
6990,3,Jihoon,3523,641,27,17,44,61.4%,17m
6990,3,[RUMB]CapsLock,3523,30,2,0,2,100.0%,11m
6990,3,LloydAurion,3523,58,2,3,5,40.0%,29m
6999,3,Ouch,3522,265,29,17,46,63.0%,3m
6999,3,Vaala,3522,411,19,9,28,67.9%,24m
6999,2,[hTx]LIBERTAD,3522,338,11,18,29,37.9%,27m
6999,3,Dictator,3522,0,5,0,5,100.0%,39m
6999,2,[lMercy]Link,3522,58,3,5,8,37.5%,6m
7004,2,YANHOOD,3521,829,190,182,372,51.1%,2m
7004,2,[ASC1]WillemL,3521,1055,55,42,97,56.7%,40m
7004,2,[Chizu]Innovaciones,3521,914,51,51,102,50.0%,31m
7004,2,Joeyy,3521,1140,43,42,85,50.6%,22m
7004,2,llllllllllll,3521,590,25,24,49,51.0%,24m
7004,2,[MiG]Covalent,3521,234,13,11,24,54.2%,34m
7004,2,NoGGNoSkill,3521,118,4,7,11,36.4%,3m
7004,2,Meek,3521,60,2,13,15,13.3%,31m
7004,3,[DuCKen]Gastritis,3521,30,1,2,3,33.3%,42m
7004,3,ballsdickins,3521,0,0,2,2,0.0%,4m
7014,2,[Caki]Hope,3520,1526,128,138,266,48.1%,13m
7014,2,Maxwell,3520,899,94,73,167,56.3%,25m
7014,2,QuigonJin,3520,835,40,37,77,51.9%,31m
7014,2,OverweightHD,3520,116,8,2,10,80.0%,2m
7014,1,IIIIIIIIII,3520,166,8,3,11,72.7%,15m
7014,2,Roasted,3520,187,6,6,12,50.0%,39m
7014,3,IIIIIIIIIIII,3520,0,5,0,5,100.0%,41m
7014,3,Snake,3520,118,5,2,7,71.4%,18m
7014,3,Azepro,3520,0,4,1,5,80.0%,41m
7014,2,HOUsE,3520,30,1,8,9,11.1%,31m
7014,3,llllllllllll,3520,0,0,1,1,0.0%,37m
7014,3,CoCoFam,3520,0,0,2,2,0.0%,29m
7026,2,[goodp]DudeAustin,3519,1616,194,184,378,51.3%,35m
7026,2,[MEP]nightcrawler,3519,1441,186,200,386,48.2%,9m
7026,2,MagicTurtle,3519,668,150,145,295,50.8%,16m
7026,2,[ChV]JyNo,3519,1470,103,105,208,49.5%,38m
7026,2,[IPCSI]BARBOL,3519,948,84,86,170,49.4%,21m
7026,2,[TGCrew]FoxCatcher,3519,1370,78,88,166,47.0%,32m
7026,2,[Plasma]Bruce,3519,1232,56,54,110,50.9%,24m
7026,3,COMBATwombat,3519,315,15,5,20,75.0%,22m
7026,2,[DfL]Kinraju,3519,411,15,15,30,50.0%,32m
7026,2,[TeamLT]Manoch,3519,376,14,16,30,46.7%,23m
7026,2,llllllllllll,3519,205,11,6,17,64.7%,25m
7026,3,gOOdbOOg,3519,168,7,1,8,87.5%,28m
7026,2,FoxCom,3519,154,4,5,9,44.4%,3m
7026,3,Barrichello,3519,58,3,0,3,100.0%,28m
7026,2,[lNI]AlwaysHigh,3519,128,3,4,7,42.9%,5m
7026,3,[SMB]SebbieMikos,3519,0,1,0,1,100.0%,31m
7026,3,RamenEmpire,3519,0,0,2,2,0.0%,22m
7026,2,TheUnseen,3519,0,0,3,3,0.0%,42m
7044,3,One,3518,490,68,58,126,54.0%,26m
7044,2,tothefux,3518,557,26,14,40,65.0%,13m
7044,3,wtu,3518,243,19,17,36,52.8%,18m
7044,2,Starp,3518,246,14,7,21,66.7%,13m
7044,2,Hydrocod,3518,282,10,10,20,50.0%,14m
7044,3,PaulSanity,3518,30,2,1,3,66.7%,35m
7044,3,Heemang,3518,97,2,2,4,50.0%,10m
7044,3,malsem,3518,0,2,3,5,40.0%,2m
7044,3,MysticGx,3518,0,0,1,1,0.0%,20m
7053,2,wzq,3517,160,7,9,16,43.8%,24m
7053,3,PutinBoss,3517,30,6,2,8,75.0%,27m
7053,3,BioLence,3517,65,5,6,11,45.5%,34m
7053,2,LetsFighting,3517,126,5,8,13,38.5%,38m
7053,1,ArtOfWar,3517,102,3,14,17,17.6%,38m
7053,2,[StrFre]FluidKMC,3517,30,2,3,5,40.0%,29m
7053,2,BigJoe,3517,30,1,7,8,12.5%,13m
7053,2,[ACSS]Torn,3517,0,0,5,5,0.0%,42m
7061,2,STIN,3516,1532,137,131,268,51.1%,17m
7061,2,ZeRaTuL,3516,533,57,54,111,51.4%,18m
7061,2,FORT,3516,777,32,26,58,55.2%,5m
7061,3,[StaRed]DarkShadeRC,3516,227,11,3,14,78.6%,4m
7065,2,Frobous,3515,1549,355,339,694,51.2%,2m
7065,2,Michy,3515,1499,185,151,336,55.1%,19m
7065,2,Funkmasta,3515,1327,158,131,289,54.7%,20m
7065,3,[bstMD]claytonbigzb,3515,1065,121,159,280,43.2%,2m
7065,2,[EtrOy]Hawkeye,3515,564,88,77,165,53.3%,38m
7065,2,exp,3515,1076,63,77,140,45.0%,32m
7065,2,KittyLove,3515,963,43,32,75,57.3%,14m
7065,2,[AlIin]Nano,3515,633,27,18,45,60.0%,23m
7065,3,[XHB]TaibaiXu,3515,584,21,21,42,50.0%,8m
7065,3,MicroMarine,3515,408,18,6,24,75.0%,13m
7065,3,phil,3515,357,16,11,27,59.3%,39m
7065,3,DPGPartinG,3515,232,11,4,15,73.3%,11m
7065,2,[TNBII]wzqwzq,3515,207,10,14,24,41.7%,21m
7065,3,[REPORT]ERAU,3515,149,7,4,11,63.6%,13m
7065,2,[xLgNx]walker,3515,62,2,5,7,28.6%,3m
7065,3,[cutes]unForGiven,3515,0,1,0,1,100.0%,35m
7065,2,MLN,3515,0,1,2,3,33.3%,3m
7065,3,DiaToX,3515,0,1,11,12,8.3%,42m
7065,2,[SSN]SmashKAB,3515,30,1,11,12,8.3%,5m
7065,2,[Diverg]Sandyclam,3515,0,0,3,3,0.0%,38m
7065,2,ARCH,3515,0,0,14,14,0.0%,8m
7086,2,woodpecker,3514,1409,414,391,805,51.4%,20m
7086,2,[FMX]VicThOr,3514,1624,197,194,391,50.4%,13m
7086,2,melville,3514,1481,150,148,298,50.3%,40m
7086,1,[RUMB]Daddy,3514,737,57,68,125,45.6%,4m
7086,3,[LüpCat]LampMoth,3514,903,39,31,70,55.7%,22m
7086,2,[TGosuB]Drewski,3514,482,17,25,42,40.5%,11m
7086,3,[nipl]DrLoveStrong,3514,392,15,12,27,55.6%,9m
7086,3,[MoistB]skinnybenis,3514,202,8,5,13,61.5%,13m
7086,2,dafafdaf,3514,204,7,10,17,41.2%,30m
7086,3,fAkeSpeeD,3514,121,3,0,3,100.0%,8m
7086,2,Dorime,3514,142,3,5,8,37.5%,19m
7097,2,Nocturnal,3513,1116,46,44,90,51.1%,5m
7097,2,[SNIP]Archie,3513,316,18,22,40,45.0%,32m
7097,2,[IMDSI]Bazuka,3513,438,17,20,37,45.9%,3m
7097,3,LazyTurtle,3513,277,15,7,22,68.2%,5m
7097,2,Terra,3513,436,15,22,37,40.5%,20m
7097,2,[Larry]Anaxagore,3513,270,13,9,22,59.1%,12m
7097,3,[REALG4]Yukiteru,3513,218,8,3,11,72.7%,24m
7097,3,[SoulK]Thimius,3513,81,8,7,15,53.3%,38m
7097,2,TigerLily,3513,48,2,2,4,50.0%,15m
7106,3,[NPhase]ZergSucks,3512,748,33,17,50,66.0%,37m
7106,2,supermage,3512,374,19,6,25,76.0%,42m
7106,3,[TYWay]Bronze,3512,258,13,4,17,76.5%,21m
7106,3,Mike,3512,166,7,3,10,70.0%,20m
7106,3,auggy,3512,114,5,3,8,62.5%,12m
7106,2,Eyetalian,3512,141,5,4,9,55.6%,23m
7106,2,[GuaPi]Artorias,3512,0,1,0,1,100.0%,16m
7106,3,sss,3512,0,1,0,1,100.0%,8m
7114,2,OHDADDY,3511,938,111,89,200,55.5%,22m
7114,2,Tay,3511,1485,84,89,173,48.6%,8m
7114,3,[MCRmy]CutMESilly,3511,670,69,58,127,54.3%,14m
7114,2,iwantsnacks,3511,439,17,17,34,50.0%,32m
7114,2,Baam,3511,88,6,1,7,85.7%,28m
7114,3,EmperorNZ,3511,0,5,0,5,100.0%,35m
7114,2,Dragonborn,3511,113,5,8,13,38.5%,3m
7114,2,Theldos,3511,58,3,4,7,42.9%,4m
7114,3,Alpha,3511,30,1,2,3,33.3%,2m
7114,2,llllllllllll,3511,0,1,2,3,33.3%,6m
7114,3,zzSKY,3511,0,0,1,1,0.0%,24m
7114,3,[EndPro]conkero,3511,0,0,2,2,0.0%,36m
7114,2,WindyDays,3511,0,0,3,3,0.0%,23m
7127,2,EVerdancy,3510,1519,352,342,694,50.7%,2m
7127,1,Skippy,3510,1369,141,151,292,48.3%,27m
7127,2,[LDCO]Cronopio,3510,1583,98,101,199,49.2%,20m
7127,2,NOISYBOY,3510,1237,48,46,94,51.1%,28m
7127,2,PrimeAqasix,3510,227,18,11,29,62.1%,23m
7127,3,[UcanWn]Einstein,3510,373,16,3,19,84.2%,10m
7127,3,DarkStar,3510,320,12,9,21,57.1%,39m
7127,3,LpGiNa,3510,0,5,0,5,100.0%,28m
7127,3,HomoClaus,3510,0,5,0,5,100.0%,7m
7127,3,Chime,3510,30,2,0,2,100.0%,4m
7127,1,carmen,3510,96,1,1,2,50.0%,12m
7127,3,[RdLzrd]LindyHopper,3510,0,0,1,1,0.0%,25m
7127,3,brokeN,3510,0,0,2,2,0.0%,8m
7140,2,Jacobi,3509,1596,131,88,219,59.8%,39m
7140,3,happyterran,3509,630,24,21,45,53.3%,29m
7140,2,onlynukes,3509,432,20,12,32,62.5%,32m
7140,3,nerdnic,3509,288,11,10,21,52.4%,33m
7140,3,[αXi]Tsuneo,3509,30,2,1,3,66.7%,24m
7140,2,skek,3509,60,2,4,6,33.3%,19m
7140,3,DeeDee,3509,30,1,1,2,50.0%,19m
7140,3,[SSH7]Shana,3509,0,0,2,2,0.0%,26m
7140,2,[UoM]Bamboo,3509,0,0,3,3,0.0%,21m
7140,2,Hakan,3509,0,0,3,3,0.0%,34m
7150,2,[StarC2]behAviOr,3508,1391,162,151,313,51.8%,19m
7150,3,Beck,3508,1526,93,84,177,52.5%,14m
7150,2,[EvilGC]barcodexd,3508,748,68,64,132,51.5%,31m
7150,3,CriscoDisco,3508,264,10,7,17,58.8%,12m
7150,3,Alterach,3508,0,5,0,5,100.0%,9m
7150,3,Halogen,3508,58,3,1,4,75.0%,10m
7150,1,Badliar,3508,142,3,3,6,50.0%,24m
7150,3,IIIIIIIIIIII,3508,0,1,0,1,100.0%,3m
7150,2,[SaintJ]Anakin,3508,30,1,5,6,16.7%,12m
7150,3,Beast,3508,0,0,1,1,0.0%,17m
7150,2,[Tl2ON]TRON,3508,0,0,3,3,0.0%,11m
7161,2,[Toiley]Klog,3507,1377,60,72,132,45.5%,33m
7161,3,[DhZAc1]Baratitas,3507,597,41,14,55,74.5%,15m
7161,3,zergina,3507,859,34,26,60,56.7%,9m
7161,2,RedemptioN,3507,714,32,23,55,58.2%,2m
7161,2,WaynaTakiri,3507,672,25,31,56,44.6%,34m
7161,2,Infernal,3507,426,18,12,30,60.0%,24m
7161,2,[FxB]Whitexcat,3507,486,16,24,40,40.0%,37m
7161,3,[TGCrew]CholmesInk,3507,286,10,8,18,55.6%,42m
7161,3,GGEZlmao,3507,0,5,0,5,100.0%,40m
7161,2,HMaK,3507,188,5,7,12,41.7%,35m
7161,3,[ScSwrm]PlayerTwo,3507,0,0,1,1,0.0%,28m
7172,1,marinekinggg,3506,1706,267,265,532,50.2%,35m
7172,2,MrDaepa,3506,856,52,36,88,59.1%,22m
7172,2,[T4TG]evansb,3506,877,52,42,94,55.3%,28m
7172,2,[SsaYnS]clutchmaster,3506,539,46,36,82,56.1%,30m
7172,2,[zling1]stabs,3506,362,13,16,29,44.8%,3m
7172,2,winterfell,3506,354,12,18,30,40.0%,3m
7172,3,[Conway]cosmos,3506,196,8,4,12,66.7%,16m
7172,3,[TCCrew]Spring,3506,154,7,2,9,77.8%,22m
7172,2,HIUSAN,3506,220,7,5,12,58.3%,19m
7172,3,[200pin]commandermin,3506,30,6,1,7,85.7%,16m
7172,2,Battle,3506,120,4,9,13,30.8%,38m
7172,3,[LAAR]Cervantes,3506,58,2,4,6,33.3%,17m
7172,3,MirãoJr,3506,0,1,1,2,50.0%,28m
7172,3,TigerYao,3506,0,0,2,2,0.0%,9m
7186,2,[BioTek]JALNARE,3505,1427,52,64,116,44.8%,17m
7186,3,[SuperZ]NorthAnor,3505,548,21,15,36,58.3%,37m
7186,3,[MOBO]Micotarie,3505,372,14,12,26,53.8%,2m
7186,3,[143s4]Wenoice,3505,215,8,8,16,50.0%,20m
7186,3,IlIlIlIlIlIl,3505,193,6,5,11,54.5%,19m
7186,3,Ekitai,3505,169,5,5,10,50.0%,35m
7186,3,BlackSpur,3505,120,5,5,10,50.0%,31m
7186,3,Mawun,3505,60,2,3,5,40.0%,39m
7186,3,llllllllllll,3505,0,1,1,2,50.0%,10m
7186,3,Leungz,3505,0,0,2,2,0.0%,31m
7196,2,Strack,3504,1569,168,178,346,48.6%,38m
7196,2,JeffreyWho,3504,1469,83,61,144,57.6%,39m
7196,2,Guillermo,3504,501,72,66,138,52.2%,38m
7196,2,Fubar,3504,1125,52,50,102,51.0%,8m
7196,2,Xiaomo,3504,524,23,19,42,54.8%,14m
7196,3,AsuraPhil,3504,295,18,14,32,56.2%,29m
7196,3,REDS,3504,390,17,4,21,81.0%,36m
7196,3,ElCapitano,3504,308,12,4,16,75.0%,41m
7196,2,Perseus,3504,298,11,16,27,40.7%,25m
7196,2,Leper,3504,302,10,11,21,47.6%,38m
7196,1,[Sailor]MovE,3504,210,9,4,13,69.2%,41m
7196,2,[eFight]yabukijoe,3504,310,9,14,23,39.1%,28m
7196,2,[KingSC]Pxnditx,3504,214,7,14,21,33.3%,15m
7196,3,Terranitup,3504,0,5,0,5,100.0%,17m
7196,3,SelFelatio,3504,0,5,0,5,100.0%,39m
7196,3,DANKMEMES,3504,140,5,2,7,71.4%,27m
7196,3,GoRush,3504,134,5,4,9,55.6%,24m
7196,3,[V0R]CubanFrank,3504,58,3,2,5,60.0%,20m
7196,3,bzzzzzzzzzzz,3504,0,2,3,5,40.0%,27m
7196,2,DNIVRA,3504,0,1,5,6,16.7%,13m
7196,3,Thisisfun,3504,42,1,6,7,14.3%,33m
7196,3,SluttyMagoo,3504,0,0,1,1,0.0%,9m
7196,3,IIIIIIII,3504,0,0,1,1,0.0%,33m
7219,2,pjospoul,3503,1419,222,198,420,52.9%,40m
7219,3,llllllllllll,3503,1645,130,110,240,54.2%,34m
7219,2,[KiMBR]KiM,3503,1376,57,56,113,50.4%,5m
7219,2,[HypE]GreenEchO,3503,748,53,43,96,55.2%,20m
7219,2,[GaOn]SupeRNovA,3503,1141,45,45,90,50.0%,6m
7219,2,[lLiTl]HektorOfTroy,3503,924,33,39,72,45.8%,32m
7219,2,[Msia]Iscariot,3503,276,9,12,21,42.9%,28m
7219,3,CTVStarFox,3503,116,4,4,8,50.0%,42m
7219,3,[GGBr0]NightShade,3503,30,2,0,2,100.0%,6m
7219,3,BarCraft,3503,0,2,3,5,40.0%,12m
7219,3,Iwould,3503,0,1,0,1,100.0%,42m
7219,3,Montana,3503,30,1,2,3,33.3%,9m
7231,3,DAVID,3502,1510,360,313,673,53.5%,35m
7231,1,[FReNs]LEGENDARY,3502,1689,185,200,385,48.1%,9m
7231,2,Krombopulos,3502,1580,119,99,218,54.6%,23m
7231,2,[bfBE]GEN,3502,1471,101,90,191,52.9%,21m
7231,2,Abu,3502,1470,100,102,202,49.5%,6m
7231,2,Barcode,3502,1305,84,76,160,52.5%,23m
7231,2,[LgnTDS]Zerg,3502,1307,72,49,121,59.5%,21m
7231,3,HateTerrans,3502,1119,49,33,82,59.8%,4m
7231,3,Hoovie,3502,210,7,1,8,87.5%,37m
7231,3,llllllllllll,3502,90,3,3,6,50.0%,8m
7231,3,BigSame,3502,30,1,2,3,33.3%,2m
7231,2,IIIIIIIIIIII,3502,0,0,3,3,0.0%,40m
7243,2,SerBronn,3501,1570,191,192,383,49.9%,18m
7243,2,[Exper]Earendil,3501,1431,97,89,186,52.2%,20m
7243,2,[TaRus]PakCha,3501,436,40,47,87,46.0%,9m
7243,2,HesiJimbo,3501,565,24,15,39,61.5%,5m
7243,3,TumerzuKING,3501,316,15,9,24,62.5%,40m
7243,2,Oberyn,3501,194,9,8,17,52.9%,12m
7243,3,AmanoHina,3501,190,7,4,11,63.6%,9m
7243,3,Lazy,3501,178,7,7,14,50.0%,12m
7243,1,Cyanoid,3501,138,4,1,5,80.0%,34m
7243,3,Fenomenal,3501,58,2,4,6,33.3%,31m
7243,3,RoXXoRz,3501,0,1,1,2,50.0%,11m
7243,3,HolyCrap,3501,0,1,2,3,33.3%,23m
7243,3,[USofAY]Milano,3501,30,1,4,5,20.0%,10m
7243,3,DgoCrack,3501,0,0,1,1,0.0%,10m
7243,3,Nico,3501,0,0,1,1,0.0%,4m
7243,2,[TGosuB]water,3501,0,0,6,6,0.0%,36m
7259,1,verminsuprem,3500,1083,323,309,632,51.1%,23m
7259,2,natedog,3500,1533,113,111,224,50.4%,25m
7259,2,[Na5ty]ForGE,3500,266,8,10,18,44.4%,2m
7259,3,Wally,3500,146,6,5,11,54.5%,13m
7259,3,[CANNON]UnknownHero,3500,0,5,0,5,100.0%,24m
7259,1,PtZpTz,3500,48,2,1,3,66.7%,17m
7259,3,Frag,3500,30,2,5,7,28.6%,41m
7259,3,CarachAngren,3500,30,1,2,3,33.3%,13m
7267,3,GammaPlot,3499,600,34,28,62,54.8%,39m
7267,3,[DASUL]LaloAssassin,3499,114,5,2,7,71.4%,6m
7269,1,[UpeV]Googlebot,3498,1658,345,362,707,48.8%,18m
7269,2,[AiMB]Jenin,3498,1441,131,137,268,48.9%,33m
7269,3,[WWU]jlin,3498,1450,119,107,226,52.7%,2m
7269,2,Squirrel,3498,1468,96,98,194,49.5%,27m
7269,2,JMan,3498,1362,88,99,187,47.1%,25m
7269,2,VISION,3498,1230,47,47,94,50.0%,12m
7269,2,[FvR]ShOckWavE,3498,790,39,33,72,54.2%,13m
7269,2,Fasho,3498,662,38,35,73,52.1%,13m
7269,3,[SCTP]UltraMarine,3498,142,9,3,12,75.0%,40m
7269,3,jjthekeed,3498,0,5,0,5,100.0%,9m
7269,3,VulturCadens,3498,0,1,0,1,100.0%,2m
7269,2,Talin,3498,73,1,3,4,25.0%,13m
7269,2,[αXLa]TuPadrastroG,3498,0,1,6,7,14.3%,2m
7282,2,[DarkAG]MicroJackson,3497,898,184,172,356,51.7%,12m
7282,2,[TGosuD]prOgsnOb,3497,1098,89,84,173,51.4%,28m
7282,2,[Macac0]NANDO,3497,1051,42,38,80,52.5%,40m
7282,2,llllllllllll,3497,230,11,11,22,50.0%,21m
7282,2,Pwnography,3497,226,8,7,15,53.3%,8m
7282,3,[1aArmy]SC2Player,3497,174,7,4,11,63.6%,39m
7282,3,OdicHastings,3497,60,2,3,5,40.0%,27m
7282,3,[2Sweet]Whiteboy,3497,30,1,1,2,50.0%,32m
7282,3,[VkG]Ryuk,3497,0,0,1,1,0.0%,16m
7291,2,[LTK]WubWub,3496,1228,99,88,187,52.9%,25m
7291,2,CapSto,3496,1444,76,80,156,48.7%,2m
7291,2,Boon,3496,304,35,37,72,48.6%,12m
7291,2,[KingSC]OFF,3496,727,33,49,82,40.2%,9m
7291,3,Anomaly,3496,142,6,2,8,75.0%,3m
7291,3,[NEEGZ]Xelloss,3496,30,1,4,5,20.0%,36m
7291,2,Cruiser,3496,88,1,4,5,20.0%,17m
7291,2,[Rus32]DeadPool,3496,0,1,6,7,14.3%,26m
7299,2,[DarkAG]cbearfresh,3495,1517,167,151,318,52.5%,6m
7299,2,[cl0udM]Boreal,3495,1472,153,160,313,48.9%,23m
7299,2,[SAAM]PherisWiel,3495,1561,100,97,197,50.8%,21m
7299,2,Mithrandir,3495,590,95,97,192,49.5%,21m
7299,3,Trot,3495,1641,80,55,135,59.3%,13m
7299,2,[Aprica]MaGicTeRRan,3495,1163,80,84,164,48.8%,36m
7299,3,Voracity,3495,1158,51,34,85,60.0%,39m
7299,3,SadisTx,3495,858,41,29,70,58.6%,40m
7299,2,Addon,3495,763,29,28,57,50.9%,11m
7299,3,higuys,3495,526,20,17,37,54.1%,38m
7299,3,Amadeus,3495,281,10,7,17,58.8%,20m
7299,3,MARU,3495,226,9,5,14,64.3%,9m
7299,2,[Exehn]Topspin,3495,152,4,7,11,36.4%,40m
7299,3,[NPhasA]dlinqnt,3495,0,1,0,1,100.0%,39m
7313,2,NarcyZ,3494,1527,396,404,800,49.5%,15m
7313,2,[R0X]Ronix,3494,810,159,145,304,52.3%,6m
7313,2,Ultrajohn,3494,803,132,131,263,50.2%,31m
7313,2,[CHEZ]Mortify,3494,1151,113,108,221,51.1%,6m
7313,2,[GnR]abstructa,3494,1462,67,53,120,55.8%,19m
7313,2,llllllllllll,3494,1058,44,40,84,52.4%,32m
7313,2,[PRDUE]Steelman,3494,265,10,3,13,76.9%,18m
7313,1,[TSOUP]Nompaku,3494,183,10,4,14,71.4%,27m
7313,2,JRG,3494,192,7,14,21,33.3%,12m
7313,3,Farnoér,3494,0,5,0,5,100.0%,24m
7313,3,LIOMK,3494,0,5,0,5,100.0%,23m
7313,3,[TS4U]Asteaksaucce,3494,60,3,2,5,60.0%,21m
7313,3,asdasdasd,3494,122,2,4,6,33.3%,13m
7313,3,MrSnuggles,3494,0,1,0,1,100.0%,38m
7313,3,Mako,3494,0,0,2,2,0.0%,21m
7328,2,Ohkek,3493,1107,200,178,378,52.9%,27m
7328,2,Cytoss,3493,1392,84,87,171,49.1%,33m
7328,2,[Macac0]HeartAttack,3493,327,62,64,126,49.2%,20m
7328,2,Razor,3493,201,19,20,39,48.7%,35m
7328,2,Mattlas,3493,234,8,15,23,34.8%,22m
7328,3,youwin,3493,166,7,1,8,87.5%,23m
7328,3,[SkAL]KalipsoW,3493,86,3,1,4,75.0%,42m
7328,3,DavidB,3493,0,3,2,5,60.0%,27m
7328,3,MicroMarine,3493,0,1,1,2,50.0%,39m
7328,3,[JPN51]MsT,3493,0,0,1,1,0.0%,5m
7328,3,Snaxcinto,3493,0,0,1,1,0.0%,29m
7328,3,[E2E]Dengue,3493,0,0,2,2,0.0%,21m
7340,2,CyrusII,3492,1511,166,154,320,51.9%,40m
7340,3,KenShin,3492,1334,57,46,103,55.3%,24m
7340,2,Hase,3492,230,11,7,18,61.1%,23m
7340,2,Tanagra,3492,30,2,8,10,20.0%,32m
7340,3,[Myles]AlumniScv,3492,0,0,1,1,0.0%,18m
7340,3,habeo,3492,0,0,1,1,0.0%,39m
7340,3,Poseidon,3492,0,0,2,2,0.0%,17m
7347,2,[STSP]RLI,3491,1519,224,226,450,49.8%,28m
7347,2,DjWaters,3491,631,158,152,310,51.0%,23m
7347,3,[EvilGC]Quetzalcóatl,3491,1630,65,62,127,51.2%,3m
7347,2,[bcheez]JusticeTip,3491,1063,42,39,81,51.9%,42m
7347,3,MaGeBaN,3491,86,5,1,6,83.3%,8m
7347,2,[4RLZs]Asteroc,3491,94,3,9,12,25.0%,27m
7347,3,Phsyco,3491,0,1,0,1,100.0%,42m
7347,3,Leopold,3491,0,0,1,1,0.0%,18m
7347,3,ctwo,3491,0,0,1,1,0.0%,23m
7356,2,[MnM]DirtyProtoss,3490,1614,852,853,1705,50.0%,6m
7356,2,gearator,3490,1590,519,504,1023,50.7%,32m
7356,2,liweixys,3490,1615,163,144,307,53.1%,27m
7356,2,[iMkS]Dax,3490,1499,64,58,122,52.5%,19m
7356,3,BowtiE,3490,602,22,22,44,50.0%,23m
7356,2,horsewussy,3490,314,11,17,28,39.3%,19m
7356,2,WhoAU,3490,232,8,14,22,36.4%,16m
7356,3,llllllllllll,3490,0,5,0,5,100.0%,24m
7356,3,Mykal,3490,0,1,0,1,100.0%,20m
7365,3,lIIIIIlll,3489,1483,110,91,201,54.7%,36m
7365,1,[BROgmr]null,3489,888,27,49,76,35.5%,30m
7365,3,TheDoctor,3489,593,25,9,34,73.5%,23m
7365,2,Quantic,3489,578,25,22,47,53.2%,36m
7365,3,[LCE]LastWave,3489,250,10,6,16,62.5%,28m
7365,3,Tossboy,3489,0,5,0,5,100.0%,24m
7365,3,LastSamurai,3489,0,1,0,1,100.0%,38m
7365,3,ChildPlease,3489,0,0,1,1,0.0%,24m
7365,1,StepBrother,3489,0,0,1,1,0.0%,15m
7374,3,BigBoss,3488,499,20,14,34,58.8%,25m
7374,2,Journey,3488,556,19,29,48,39.6%,31m
7374,3,zzdot,3488,479,17,10,27,63.0%,18m
7374,2,Therius,3488,188,6,15,21,28.6%,26m
7374,2,VeNGeaNcE,3488,0,2,3,5,40.0%,14m
7374,3,[ValidG]JIMMY,3488,0,0,1,1,0.0%,5m
7380,2,[SsaYnS]SiLVeRLeAF,3487,1599,231,225,456,50.7%,38m
7380,2,ALLAHUAKVAR,3487,1614,125,116,241,51.9%,11m
7380,3,[Olay]Churd,3487,1301,79,45,124,63.7%,18m
7380,2,Banger,3487,554,18,28,46,39.1%,42m
7380,3,[ZTemp]Carr,3487,397,14,6,20,70.0%,5m
7380,2,Sin,3487,434,14,27,41,34.1%,9m
7380,3,[Yamet]Chimi,3487,114,5,1,6,83.3%,31m
7380,3,[eznore]KDT,3487,30,1,3,4,25.0%,18m
7380,2,Secretariat,3487,88,1,5,6,16.7%,19m
7380,3,[arSBel]kikiswaggg,3487,0,0,1,1,0.0%,18m
7380,3,gdoggcasey,3487,0,0,2,2,0.0%,5m
7380,3,llllllllllll,3487,0,0,2,2,0.0%,41m
7380,2,HlO,3487,0,0,2,2,0.0%,16m
7393,2,Horus,3486,1493,119,102,221,53.8%,25m
7393,2,Dog,3486,1378,110,110,220,50.0%,17m
7393,2,[AIlin]Nano,3486,1554,102,106,208,49.0%,21m
7393,2,[TGosuC]gonjareya,3486,718,86,79,165,52.1%,13m
7393,2,jazZ,3486,1199,51,46,97,52.6%,11m
7393,3,[HQ]Hyerquality,3486,426,17,13,30,56.7%,12m
7393,1,yoyo,3486,191,10,5,15,66.7%,4m
7393,2,Toilet,3486,114,7,2,9,77.8%,40m
7393,3,WhoAmI,3486,0,5,0,5,100.0%,2m
7393,3,Yeet,3486,58,5,2,7,71.4%,9m
7393,3,[Fr0zeN]Sleep,3486,0,0,1,1,0.0%,19m
7404,2,[LDCO]LETE,3485,1438,183,184,367,49.9%,31m
7404,2,[LCLP]NezahuaPilli,3485,1558,164,164,328,50.0%,12m
7404,2,MOMO,3485,1516,157,144,301,52.2%,12m
7404,3,[1E100]whoyou,3485,1499,94,89,183,51.4%,36m
7404,2,Hunpa,3485,1329,73,70,143,51.0%,6m
7404,3,Maverick,3485,1517,67,57,124,54.0%,12m
7404,2,[SM0K3]conspiracy,3485,833,59,59,118,50.0%,40m
7404,3,[CadeGs]Ultimifier,3485,788,32,30,62,51.6%,9m
7404,3,[Flar3s]LrdCraniaL,3485,549,27,25,52,51.9%,26m
7404,2,PocketSand,3485,200,8,11,19,42.1%,40m
7404,3,TASSADAR,3485,0,5,0,5,100.0%,11m
7404,3,[AXlS]Suspension,3485,0,3,0,3,100.0%,17m
7404,3,TheNWord,3485,58,3,1,4,75.0%,40m
7404,2,darxon,3485,0,3,3,6,50.0%,31m
7404,3,lil,3485,58,2,4,6,33.3%,16m
7404,3,QueenDadDy,3485,60,2,5,7,28.6%,24m
7404,3,bamboosheet,3485,0,1,1,2,50.0%,10m
7404,2,xpaperclip,3485,0,1,4,5,20.0%,12m
7404,2,PandaMoon,3485,30,1,6,7,14.3%,42m
7423,3,[SC2PH]NewVagabond,3484,1599,148,122,270,54.8%,37m
7423,2,[Ninpo]HnicZ,3484,785,36,24,60,60.0%,19m
7423,2,[CRAKS]Lefchoike,3484,844,30,34,64,46.9%,19m
7423,3,[xLgNx]Kalo,3484,212,8,9,17,47.1%,12m
7423,3,[IIDA]FEIJÓO,3484,0,5,0,5,100.0%,17m
7423,3,[ScrLg]HandBanana,3484,30,1,2,3,33.3%,30m
7423,3,[TgAg]Bronx,3484,0,0,1,1,0.0%,10m
7430,2,alberttt,3483,1155,219,191,410,53.4%,40m
7430,2,[RnM4EV]MortestMorty,3483,1565,103,107,210,49.0%,20m
7430,2,Dreier,3483,1432,67,57,124,54.0%,8m
7430,2,MrSockYoHoe,3483,513,21,19,40,52.5%,3m
7430,2,[xLOLZx]JaxKraync,3483,502,17,26,43,39.5%,31m
7430,2,ThuNderPusXX,3483,514,17,28,45,37.8%,18m
7430,2,splay,3483,363,13,25,38,34.2%,25m
7430,3,Tragamor,3483,142,5,4,9,55.6%,42m
7430,2,[Ris3n]MogSkynet,3483,182,5,8,13,38.5%,36m
7430,3,DeDeDeDerp,3483,0,4,1,5,80.0%,33m
7430,3,IIIIIIIIIIII,3483,137,3,2,5,60.0%,36m
7441,3,Include,3482,1415,121,118,239,50.6%,10m
7441,3,nangoo,3482,884,65,61,126,51.6%,40m
7441,2,Hysteric,3482,1091,57,55,112,50.9%,32m
7441,2,[iMkS]Stimpack,3482,1294,51,51,102,50.0%,36m
7441,2,Nas,3482,1118,46,42,88,52.3%,40m
7441,2,[PES]Silver,3482,706,25,29,54,46.3%,32m
7441,3,BABsukidesu,3482,484,21,13,34,61.8%,16m
7441,3,[Lp]DarkChris,3482,472,18,19,37,48.6%,12m
7441,1,Reesey,3482,118,7,2,9,77.8%,32m
7441,1,[MFD]FancyJeffrey,3482,192,5,2,7,71.4%,16m
7441,3,[Plasmo]DrPlasma,3482,86,5,5,10,50.0%,33m
7441,3,Lotus,3482,144,5,8,13,38.5%,8m
7441,2,Patches,3482,114,4,10,14,28.6%,40m
7441,2,Clue,3482,94,2,0,2,100.0%,8m
7441,3,[FOTBA]Kaien,3482,30,1,5,6,16.7%,27m
7441,2,[umadID]Kush,3482,30,1,13,14,7.1%,28m
7441,3,Bulasandusky,3482,0,0,2,2,0.0%,5m
7458,2,IIIIlllII,3481,931,84,56,140,60.0%,19m
7458,2,[glhfSC]rafayel,3481,1056,44,44,88,50.0%,36m
7458,3,ilililililil,3481,342,16,10,26,61.5%,27m
7458,3,[Cryptc]EviLs,3481,254,10,11,21,47.6%,28m
7458,2,suhama,3481,318,10,18,28,35.7%,16m
7458,3,Sage,3481,58,6,1,7,85.7%,29m
7458,2,Nimbus,3481,90,4,6,10,40.0%,37m
7458,3,DonaldTrurmp,3481,62,3,11,14,21.4%,13m
7458,1,Scare,3481,96,2,1,3,66.7%,11m
7467,3,Supermarmota,3480,1313,267,251,518,51.5%,7m
7467,3,head,3480,1501,97,95,192,50.5%,37m
7467,2,Superbud,3480,685,78,66,144,54.2%,5m
7467,3,Daniel,3480,271,11,5,16,68.8%,23m
7467,2,Jeff,3480,298,10,21,31,32.3%,12m
7467,3,WeenieHutJrs,3480,60,2,2,4,50.0%,11m
7467,3,taxi,3480,58,2,3,5,40.0%,39m
7467,3,[NIntN]Rhodesian,3480,30,1,5,6,16.7%,10m
7467,3,[Weac]diSoriEntEd,3480,0,0,1,1,0.0%,17m
7467,3,[ExcIgN]IIIIIIIIIIII,3480,0,0,3,3,0.0%,40m
7477,1,Agreda,3479,1665,436,431,867,50.3%,6m
7477,2,leonwiki,3479,1612,104,102,206,50.5%,34m
7477,2,[Cakius]Tavo,3479,987,93,81,174,53.4%,8m
7477,3,MasterBuns,3479,1583,70,48,118,59.3%,13m
7477,3,DanFil,3479,956,38,32,70,54.3%,2m
7477,2,chickenoodle,3479,644,33,21,54,61.1%,23m
7477,2,IIIIIIIIIIII,3479,466,19,15,34,55.9%,25m
7477,3,llllllllllll,3479,292,10,6,16,62.5%,39m
7477,3,BlackPink,3479,30,5,1,6,83.3%,4m
7477,3,[SptakS]MrE,3479,118,4,5,9,44.4%,10m
7477,3,[TCRC]duncgardner,3479,60,3,3,6,50.0%,3m
7477,3,Synergy,3479,88,3,4,7,42.9%,9m
7477,3,owsk,3479,60,2,3,5,40.0%,20m
7477,3,Vinaka,3479,50,2,5,7,28.6%,13m
7477,1,DedGaem,3479,78,2,23,25,8.0%,26m
7477,3,DotPain,3479,0,1,0,1,100.0%,31m
7477,3,[AqpSC]Ian,3479,0,1,3,4,25.0%,9m
7477,2,[Macac0]EsKiaf,3479,30,1,7,8,12.5%,35m
7477,2,[UNTSC2]Osiris,3479,0,0,1,1,0.0%,8m
7477,3,Etsimitsay,3479,0,0,1,1,0.0%,27m
7477,3,[FL4]exumeran,3479,0,0,1,1,0.0%,16m
7477,3,IIIIIIIIIII,3479,0,0,2,2,0.0%,37m
7499,2,[1E100]scissorseven,3478,985,139,138,277,50.2%,22m
7499,1,Inertia,3478,1195,124,142,266,46.6%,27m
7499,3,Legend,3478,548,64,61,125,51.2%,14m
7499,3,Han,3478,1363,61,44,105,58.1%,16m
7499,3,Inory,3478,1406,59,45,104,56.7%,18m
7499,2,[AD3C]RoCkEt,3478,1236,53,59,112,47.3%,33m
7499,3,[PKMNH]ZeroHeroQ,3478,60,6,2,8,75.0%,33m
7499,3,Quokka,3478,0,5,0,5,100.0%,3m
7499,1,[StVb]BlueDream,3478,48,2,1,3,66.7%,33m
7499,3,Jeedy,3478,0,0,1,1,0.0%,13m
7509,2,[PUSH]Smooph,3477,1387,439,431,870,50.5%,23m
7509,2,[ARNAIZ]Æffeks,3477,1420,234,222,456,51.3%,42m
7509,3,perkyderky,3477,728,94,63,157,59.9%,38m
7509,2,[TGCF]MumboJumPoo,3477,1491,84,89,173,48.6%,28m
7509,2,GitGud,3477,1032,79,77,156,50.6%,17m
7509,2,Chaos,3477,971,55,57,112,49.1%,15m
7509,3,Areck,3477,823,48,26,74,64.9%,31m
7509,3,lllIIIIlllll,3477,467,38,5,43,88.4%,6m
7509,2,[REDSTR]TheHacker,3477,697,29,24,53,54.7%,40m
7509,3,[AiMB]Rudolpho,3477,370,15,7,22,68.2%,40m
7509,2,ImALooooser,3477,168,10,4,14,71.4%,19m
7509,2,MingQ,3477,177,9,16,25,36.0%,42m
7509,3,Gray,3477,58,3,1,4,75.0%,5m
7509,3,IIIIIIIIIIII,3477,0,3,3,6,50.0%,24m
7509,3,Ixa,3477,30,2,0,2,100.0%,41m
7509,3,Mvp,3477,0,1,0,1,100.0%,2m
7509,3,oGizMo,3477,0,0,1,1,0.0%,23m
7509,3,[MaCro1]FriedKimChi,3477,0,0,1,1,0.0%,42m
7527,2,KitcoMeSCBr,3476,977,43,50,93,46.2%,15m
7527,3,CCAA,3476,30,2,1,3,66.7%,13m
7527,3,[iMkS]MVP,3476,0,1,0,1,100.0%,28m
7530,2,[JRW]SilvrSmurfer,3475,793,175,171,346,50.6%,42m
7530,2,[1337s]jamesees,3475,1540,100,104,204,49.0%,28m
7530,3,Random,3475,750,75,71,146,51.4%,33m
7530,2,[K1]Jimmy,3475,1157,46,54,100,46.0%,22m
7530,3,[Cryptc]hotdogSherif,3475,422,16,11,27,59.3%,41m
7530,2,RageQuitPliz,3475,264,11,8,19,57.9%,12m
7530,2,[YAZI]Shujaa,3475,112,7,2,9,77.8%,16m
7530,3,Atlas,3475,210,7,8,15,46.7%,20m
7530,3,SceneSlip,3475,86,4,5,9,44.4%,31m
7530,3,PatientZero,3475,58,3,4,7,42.9%,41m
7530,3,[GnR]Duster,3475,58,2,4,6,33.3%,39m
7530,2,[MrPres]DonaldTrump,3475,0,1,0,1,100.0%,8m
7530,3,Ranila,3475,0,1,0,1,100.0%,15m
7530,3,[copain]apple,3475,0,0,1,1,0.0%,41m
7530,3,[Toss]LifeforAihr,3475,0,0,1,1,0.0%,35m
7545,2,Saltosis,3474,1507,161,158,319,50.5%,28m
7545,2,ArisaPants,3474,528,20,20,40,50.0%,7m
7545,3,Saber,3474,320,13,5,18,72.2%,14m
7545,3,[TGCrew]FedSmoker,3474,358,13,11,24,54.2%,19m
7545,3,[cl0udM]OldFashion,3474,284,11,11,22,50.0%,22m
7545,3,Player,3474,222,9,5,14,64.3%,14m
7545,1,RealTalkRaVi,3474,188,3,5,8,37.5%,6m
7545,3,Zero,3474,0,0,2,2,0.0%,21m
7553,2,ChairmanMaus,3473,1542,388,382,770,50.4%,13m
7553,2,tkM,3473,1254,126,111,237,53.2%,7m
7553,3,JAV,3473,1017,105,98,203,51.7%,36m
7553,2,Gandalf,3473,722,67,61,128,52.3%,4m
7553,3,idaniel,3473,1287,62,53,115,53.9%,40m
7553,2,bulletbill,3473,1480,62,72,134,46.3%,21m
7553,3,Terran,3473,1186,54,33,87,62.1%,29m
7553,2,YaaR,3473,450,19,16,35,54.3%,24m
7553,2,djcg,3473,458,16,20,36,44.4%,18m
7553,3,ALDASAM,3473,272,13,8,21,61.9%,4m
7553,3,PickleRicK,3473,266,12,5,17,70.6%,8m
7553,3,Jenny,3473,88,3,6,9,33.3%,22m
7553,3,nick,3473,0,0,1,1,0.0%,39m
7553,3,Leshty,3473,0,0,1,1,0.0%,40m
7553,3,[Flume1]wehttam,3473,0,0,1,1,0.0%,36m
7568,2,RTSCookie,3472,1510,169,176,345,49.0%,31m
7568,3,EveryEier,3472,780,81,53,134,60.4%,2m
7568,2,lIlIIIlIIllI,3472,965,50,45,95,52.6%,20m
7568,3,letztewelt,3472,1000,45,33,78,57.7%,38m
7568,2,OstrichEgg,3472,1016,41,49,90,45.6%,32m
7568,3,KEN,3472,708,29,19,48,60.4%,31m
7568,2,[BearMe]NightOwl,3472,236,11,8,19,57.9%,34m
7568,2,[xLgNx]GunnerBlade,3472,186,9,18,27,33.3%,31m
7568,3,[TITSSS]Dalgalak,3472,114,8,2,10,80.0%,16m
7568,3,[Moogs]DangoFamily,3472,86,4,1,5,80.0%,21m
7568,3,BIN,3472,60,3,2,5,60.0%,19m
7568,3,dREYFUSS,3472,62,2,4,6,33.3%,24m
7568,3,SenderBeware,3472,30,1,1,2,50.0%,23m
7568,2,pog,3472,0,1,5,6,16.7%,28m
7568,3,TrauerBauer,3472,0,0,1,1,0.0%,26m
7568,3,Dacalux,3472,0,0,1,1,0.0%,16m
7584,2,[ExcIgN]Gaboo,3471,1342,292,280,572,51.0%,6m
7584,2,Jhowser,3471,1305,165,156,321,51.4%,15m
7584,2,SEMINENCE,3471,1513,108,96,204,52.9%,31m
7584,3,PresterJohn,3471,1140,106,91,197,53.8%,18m
7584,2,[OceanT]Platyny,3471,1613,102,102,204,50.0%,21m
7584,2,FunkyMonk,3471,1304,56,61,117,47.9%,35m
7584,3,Ctwister,3471,962,53,33,86,61.6%,38m
7584,2,[sbboys]geoluo,3471,605,44,33,77,57.1%,28m
7584,1,VALUETOWN,3471,182,12,3,15,80.0%,13m
7584,3,soldierguy,3471,342,12,11,23,52.2%,21m
7584,3,Zangief,3471,58,5,1,6,83.3%,37m
7584,3,cradle,3471,93,5,2,7,71.4%,12m
7584,3,[uy]Mega,3471,120,5,7,12,41.7%,18m
7584,3,[Bee]LiviRAWR,3471,90,4,4,8,50.0%,10m
7598,3,MenaMAKS,3470,1477,168,140,308,54.5%,41m
7598,3,BLADE,3470,920,52,28,80,65.0%,34m
7598,2,ZOrMitO,3470,466,36,29,65,55.4%,27m
7598,2,ZombieHobbit,3470,502,21,16,37,56.8%,19m
7598,3,Mattagon,3470,355,14,4,18,77.8%,19m
7598,3,Happi,3470,166,6,6,12,50.0%,3m
7598,3,Preeminent,3470,0,5,0,5,100.0%,37m
7598,3,TilT,3470,30,1,2,3,33.3%,31m
7598,3,[ACGFAN]Magician,3470,0,1,2,3,33.3%,37m
7598,3,Scubiesteve,3470,0,0,1,1,0.0%,10m
7598,3,[FFAA]Kdyz,3470,0,0,1,1,0.0%,25m
7609,2,[Cheees]NickTactics,3469,1539,181,179,360,50.3%,15m
7609,2,Ges,3469,805,76,78,154,49.4%,26m
7609,3,SifoDyas,3469,840,73,56,129,56.6%,2m
7609,3,[B1GDic]MajorLazer,3469,1588,71,57,128,55.5%,22m
7609,2,zwak,3469,313,63,58,121,52.1%,38m
7609,3,[ClanZN]YumKimil,3469,376,13,18,31,41.9%,5m
7609,3,[GT5]FinalDoorman,3469,117,9,6,15,60.0%,31m
7609,3,[WHITEE]goldbrick,3469,58,7,0,7,100.0%,14m
7609,2,IIIIIIII,3469,30,3,6,9,33.3%,23m
7609,3,IIIIIIIIIIII,3469,30,2,0,2,100.0%,8m
7609,3,[Lowko]Assassin,3469,30,2,4,6,33.3%,38m
7609,3,SATTHU,3469,58,2,4,6,33.3%,10m
7609,2,INnoVation,3469,95,1,5,6,16.7%,2m
7622,2,[LGNxx]DeadlyPants,3468,1602,318,299,617,51.5%,39m
7622,2,Wickster,3468,1276,128,133,261,49.0%,23m
7622,2,Calus,3468,1342,82,76,158,51.9%,15m
7622,3,IIIIIII,3468,868,52,10,62,83.9%,41m
7622,2,OkCan,3468,604,32,28,60,53.3%,13m
7622,2,neurobacter,3468,429,21,31,52,40.4%,17m
7622,3,[knewbe]LlLl,3468,376,13,13,26,50.0%,20m
7622,2,[YD2K]Brayjunaz,3468,254,8,10,18,44.4%,24m
7622,2,kokain,3468,102,7,2,9,77.8%,7m
7622,3,LuckedOut,3468,143,4,1,5,80.0%,18m
7622,3,RussianVodka,3468,30,1,1,2,50.0%,20m
7622,3,MicroMarine,3468,0,1,1,2,50.0%,13m
7622,3,[CcTtSs]calebr,3468,0,0,1,1,0.0%,20m
7635,2,[GyB]urielcarlos,3467,1598,271,262,533,50.8%,12m
7635,2,[CHAOS]Dapz,3467,1598,189,158,347,54.5%,7m
7635,2,[OPOUI]themadnoah,3467,1025,100,86,186,53.8%,10m
7635,2,[ØÛ]StartinHP,3467,723,61,58,119,51.3%,31m
7635,3,Wolfspear,3467,1372,53,49,102,52.0%,15m
7635,2,Moridin,3467,855,50,13,63,79.4%,40m
7635,2,[neuroS]Ultrahugs,3467,804,27,38,65,41.5%,33m
7635,2,PNess,3467,684,26,26,52,50.0%,23m
7635,3,FlyingWhale,3467,88,3,4,7,42.9%,22m
7635,3,nicos,3467,0,1,0,1,100.0%,39m
7645,2,[HsDL]xXTreboXx,3466,781,38,31,69,55.1%,31m
7645,3,[NLTTJ]Yue,3466,486,19,12,31,61.3%,40m
7645,3,ZOD,3466,351,16,6,22,72.7%,7m
7645,2,Rethy,3466,303,10,11,21,47.6%,32m
7645,2,bdstrategist,3466,182,6,3,9,66.7%,6m
7645,2,TheBoxeR,3466,152,5,7,12,41.7%,23m
7645,2,ignap,3466,0,1,0,1,100.0%,10m
7645,3,Vinicius,3466,0,1,0,1,100.0%,31m
7645,3,[Bxop]ian,3466,97,1,2,3,33.3%,19m
7645,3,BernsteinD,3466,0,1,3,4,25.0%,10m
7655,2,[425]MazTer,3465,1598,221,217,438,50.5%,15m
7655,2,[TRTECH]EpiC,3465,505,41,47,88,46.6%,32m
7655,3,FatWerm,3465,356,15,5,20,75.0%,22m
7655,3,Timbits,3465,119,3,0,3,100.0%,6m
7655,3,iCheeseUcry,3465,30,2,0,2,100.0%,26m
7660,2,[NA7]Thatch,3464,1574,448,463,911,49.2%,15m
7660,2,Dan,3464,1369,169,139,308,54.9%,2m
7660,2,[TeamUR]FireKlaw,3464,1492,79,84,163,48.5%,9m
7660,3,[SECUAS]ironman,3464,1456,59,47,106,55.7%,40m
7660,2,BinhMinh,3464,443,42,33,75,56.0%,10m
7660,3,Korty,3464,628,25,13,38,65.8%,26m
7660,3,Yuzu,3464,596,22,18,40,55.0%,23m
7660,3,BestNoob,3464,413,12,17,29,41.4%,36m
7660,2,[toungy]PDIDDY,3464,264,10,16,26,38.5%,32m
7660,3,Sanedude,3464,244,9,4,13,69.2%,8m
7660,3,[MUCS]reallynewbie,3464,182,6,8,14,42.9%,17m
7660,3,[FMX]TYRION,3464,88,4,3,7,57.1%,12m
7660,3,[N2L8]MandrilocK,3464,86,3,5,8,37.5%,23m
7660,3,mTzhunter,3464,60,2,3,5,40.0%,34m
7660,2,Evolution,3464,58,2,6,8,25.0%,20m
7675,2,virtuoSUS,3463,1325,97,94,191,50.8%,17m
7675,3,aequitas,3463,500,21,15,36,58.3%,14m
7675,3,probeslol,3463,425,19,9,28,67.9%,19m
7675,3,[Fatslb]MrMineMan,3463,254,9,7,16,56.2%,26m
7675,3,Noodle,3463,171,4,5,9,44.4%,23m
7675,2,[YNL]Jkim,3463,0,0,8,8,0.0%,33m
7681,2,IceFox,3462,1554,392,406,798,49.1%,28m
7681,2,[tCo9]thor,3462,1557,190,181,371,51.2%,13m
7681,2,Crusader,3462,1532,131,120,251,52.2%,37m
7681,3,Lemonescence,3462,947,56,56,112,50.0%,37m
7681,3,NiTreXxX,3462,1126,48,37,85,56.5%,10m
7681,2,[M2A5]Well,3462,936,35,38,73,47.9%,4m
7681,3,[N4K3D]Archoff,3462,467,17,18,35,48.6%,13m
7681,2,llllllllllll,3462,270,12,8,20,60.0%,34m
7681,2,[EvilGC]Mvivanc,3462,114,4,10,14,28.6%,13m
7681,3,SugarRayRobi,3462,30,2,1,3,66.7%,27m
7681,3,MatCauthon,3462,0,1,0,1,100.0%,12m
7681,3,Scruffy,3462,0,1,0,1,100.0%,39m
7681,3,Viper,3462,0,1,1,2,50.0%,16m
7681,3,[DarkAG]Nantrix,3462,0,0,1,1,0.0%,10m
7681,3,issue,3462,0,0,2,2,0.0%,4m
7696,3,nobody,3461,1513,70,71,141,49.6%,23m
7696,3,Narumi,3461,742,47,43,90,52.2%,5m
7696,2,poums,3461,916,40,35,75,53.3%,7m
7696,2,[EFFELQ]CHEFBANDIT,3461,438,38,29,67,56.7%,6m
7696,3,TerransHill,3461,392,14,14,28,50.0%,34m
7696,3,JINXXD,3461,225,12,7,19,63.2%,30m
7696,3,breckognize,3461,30,2,1,3,66.7%,40m
7696,3,[NextDC]SunTzu,3461,0,1,0,1,100.0%,27m
7696,3,BlueRare,3461,0,1,4,5,20.0%,37m
7696,1,[hxhchi]Azathoth,3461,0,0,1,1,0.0%,9m
7696,3,[UpeV]RikrdoDj,3461,0,0,1,1,0.0%,40m
7696,3,Senpuden,3461,0,0,2,2,0.0%,35m
7708,2,Pina,3460,1351,67,79,146,45.9%,25m
7708,2,Meyr,3460,1028,48,40,88,54.5%,8m
7708,2,[MATTO]Milquetoast,3460,180,6,8,14,42.9%,22m
7708,2,BeserkBunnie,3460,30,1,9,10,10.0%,31m
7708,3,[sPurs]microstar,3460,0,0,2,2,0.0%,18m
7713,2,[AIlin]Catalyst,3459,1292,46,53,99,46.5%,15m
7713,2,CyrusII,3459,745,35,48,83,42.2%,4m
7713,2,[ANGST]SideShow,3459,612,20,27,47,42.6%,28m
7713,3,[C96741]Spencer,3459,88,4,3,7,57.1%,20m
7713,3,[CRAKS]defiler,3459,116,3,0,3,100.0%,3m
7713,2,[DPRKr]YOLOSWAGGINS,3459,0,1,0,1,100.0%,8m
7713,3,irishexpress,3459,0,0,2,2,0.0%,31m
7713,3,SToRm,3459,0,0,4,4,0.0%,16m
7721,2,[NPhasA]Orange,3458,1561,175,174,349,50.1%,35m
7721,2,Fenrir,3458,1035,48,41,89,53.9%,42m
7721,2,JBiZZ,3458,967,42,31,73,57.5%,9m
7721,3,SCHardNips,3458,1042,38,35,73,52.1%,40m
7721,3,jiN,3458,951,38,38,76,50.0%,4m
7721,2,StinkyBrain,3458,137,4,6,10,40.0%,42m
7721,3,MeBeGrubbin,3458,0,1,1,2,50.0%,16m
7721,3,Deepo,3458,0,1,1,2,50.0%,37m
7721,1,HanGoon,3458,0,0,1,1,0.0%,27m
7730,2,Adonnen,3457,627,187,192,379,49.3%,23m
7730,2,BMC,3457,1543,120,130,250,48.0%,15m
7730,2,[ØFoxF2]kyo,3457,1421,80,89,169,47.3%,34m
7730,2,Techno,3457,940,35,39,74,47.3%,42m
7730,2,BobbyFaustus,3457,373,13,17,30,43.3%,13m
7730,3,ftwl,3457,314,12,10,22,54.5%,37m
7730,3,surreal,3457,222,9,4,13,69.2%,19m
7730,3,[4eG]TheRedArmy,3457,166,7,0,7,100.0%,13m
7730,3,Vital,3457,121,7,0,7,100.0%,11m
7730,3,ZukarCrash,3457,139,7,2,9,77.8%,27m
7730,3,Riski,3457,97,4,2,6,66.7%,27m
7730,3,[SCrack]dUTtrOACh,3457,118,4,5,9,44.4%,19m
7730,3,[DETER]Mirko,3457,0,1,0,1,100.0%,26m
7730,3,Duffman,3457,0,1,1,2,50.0%,10m
7730,3,[TM7]CptTripps,3457,0,1,2,3,33.3%,24m
7730,3,[KingSC]MGFrost,3457,0,0,1,1,0.0%,24m
7730,3,[NEFN]Pollux,3457,0,0,2,2,0.0%,16m
7747,1,IIIIIIIIIIII,3456,1654,315,334,649,48.5%,5m
7747,3,Drakab,3456,1321,179,154,333,53.8%,31m
7747,2,[BoRnGo]AYK,3456,986,88,87,175,50.3%,33m
7747,3,Sherpad,3456,1000,66,52,118,55.9%,39m
7747,2,fuquer,3456,1138,47,41,88,53.4%,31m
7747,2,[VFam]Zaechus,3456,641,27,22,49,55.1%,24m
7747,2,shisan,3456,358,18,12,30,60.0%,26m
7747,3,YouSoMadBro,3456,332,14,9,23,60.9%,30m
7747,2,[LGNxx]YAERU,3456,337,14,11,25,56.0%,35m
7747,3,WaGe,3456,326,13,10,23,56.5%,7m
7747,3,ScumBagNA,3456,174,10,4,14,71.4%,7m
7747,3,blajjj,3456,144,6,3,9,66.7%,11m
7747,3,AngryPenguin,3456,0,5,0,5,100.0%,13m
7747,3,ForWarD,3456,88,3,5,8,37.5%,19m
7747,3,[AD3C]MICHEL,3456,30,2,4,6,33.3%,41m
7747,2,[S0Bs]KevFabrikant,3456,30,2,6,8,25.0%,4m
7747,3,iiiiiii,3456,30,1,1,2,50.0%,4m
7747,3,Nero,3456,0,1,4,5,20.0%,30m
7747,2,supercell,3456,30,1,10,11,9.1%,30m
7747,3,Toxico,3456,0,0,1,1,0.0%,24m
7767,2,Agrodotus,3455,1570,196,184,380,51.6%,8m
7767,3,Inomorata,3455,869,186,165,351,53.0%,5m
7767,2,[TRDTRU]YoRHa,3455,389,45,44,89,50.6%,3m
7767,3,BuffTerranPl,3455,822,34,23,57,59.6%,25m
7767,3,System,3455,728,28,23,51,54.9%,37m
7767,2,Ares,3455,228,8,14,22,36.4%,22m
7767,3,[AoBC]shiki,3455,88,4,3,7,57.1%,10m
7767,1,[CrTr]HarryPooter,3455,0,1,0,1,100.0%,38m
7767,3,MsTea,3455,0,1,0,1,100.0%,37m
7767,3,DivineDust,3455,0,1,1,2,50.0%,20m
7767,3,Randox,3455,0,0,2,2,0.0%,24m
7767,3,Logan,3455,0,0,3,3,0.0%,17m
7779,2,Alex,3454,1461,316,322,638,49.5%,21m
7779,3,[Fellaz]Galigus,3454,327,13,12,25,52.0%,22m
7779,3,Sorry,3454,58,6,1,7,85.7%,5m
7779,3,[FateTw]VOIDRAYS,3454,152,5,7,12,41.7%,31m
7779,3,Odanrot,3454,0,0,1,1,0.0%,37m
7779,3,LiquidFlem,3454,0,0,1,1,0.0%,18m
7785,2,Sichuan,3453,1523,125,123,248,50.4%,42m
7785,3,Topsy,3453,536,34,29,63,54.0%,5m
7785,3,[Gpause]UareMyToy,3453,283,10,2,12,83.3%,15m
7785,3,Flawed,3453,116,7,4,11,63.6%,8m
7785,3,Korax,3453,58,6,1,7,85.7%,19m
7785,3,[TGCrew]Ploop,3453,120,5,6,11,45.5%,10m
7785,3,[TCProG]MillerLee,3453,88,4,1,5,80.0%,14m
7785,3,JoJo,3453,120,3,1,4,75.0%,11m
7785,3,Akella,3453,0,0,1,1,0.0%,8m
7785,3,Stethan,3453,0,0,1,1,0.0%,5m
7785,2,[100T]Arkham,3453,73,0,4,4,0.0%,39m
7796,2,Tyki,3452,1558,135,136,271,49.8%,25m
7796,2,[BiBlak]wewehead,3452,474,101,84,185,54.6%,4m
7796,2,Phantom,3452,1544,81,100,181,44.8%,23m
7796,2,[TFOS]zOne,3452,1548,68,73,141,48.2%,18m
7796,3,[ROYALz]mrjakk,3452,747,51,44,95,53.7%,40m
7796,3,kylock,3452,833,41,41,82,50.0%,18m
7796,2,[KingSC]Gonsu,3452,1089,41,42,83,49.4%,13m
7796,3,[SMB]GameOfDrones,3452,642,40,28,68,58.8%,5m
7796,3,ExtraCrispy,3452,467,28,27,55,50.9%,36m
7796,3,Python,3452,453,19,10,29,65.5%,22m
7796,2,TheOx,3452,381,17,25,42,40.5%,18m
7796,2,deathNtaxes,3452,451,15,18,33,45.5%,9m
7796,3,Raptor,3452,267,8,5,13,61.5%,41m
7796,3,alieN,3452,121,6,7,13,46.2%,15m
7796,3,[Vitami]Vitamins,3452,90,4,2,6,66.7%,35m
7796,3,[Ohyo]Gupps,3452,30,2,2,4,50.0%,7m
7796,3,Bainz,3452,30,2,4,6,33.3%,28m
7796,3,[WuTang]Bishop,3452,60,2,4,6,33.3%,35m
7796,2,Mort,3452,30,2,9,11,18.2%,22m
7796,3,[Th3Bad]matheusT,3452,0,1,0,1,100.0%,21m
7796,3,ChuckTbone,3452,0,1,0,1,100.0%,21m
7817,2,[pzv]superpants,3451,1575,140,123,263,53.2%,33m
7817,3,Saraphira,3451,1042,59,53,112,52.7%,6m
7817,2,[OhSnap]ItSOnRaNDoM,3451,704,29,29,58,50.0%,4m
7817,3,[PSTRAT]roguebadass,3451,196,8,5,13,61.5%,40m
7817,1,lllIIlIlIIII,3451,211,7,4,11,63.6%,35m
7817,2,[Maaad]SatoRi,3451,30,1,7,8,12.5%,33m
7817,3,[AiMB]Heed,3451,0,0,1,1,0.0%,25m
7817,1,SiriusApe,3451,0,0,1,1,0.0%,14m
7817,3,QTpieTerran,3451,0,0,2,2,0.0%,24m
7826,1,amumu,3450,1390,830,806,1636,50.7%,30m
7826,2,[3mm]NoMad,3450,327,51,48,99,51.5%,4m
7826,3,SEMPER,3450,1202,47,43,90,52.2%,18m
7826,2,ditron,3450,766,32,35,67,47.8%,13m
7826,3,Chey,3450,472,19,11,30,63.3%,19m
7826,3,[18TC]FlyingToilet,3450,435,18,11,29,62.1%,29m
7826,2,clairvoyant,3450,299,11,12,23,47.8%,2m
7826,3,[Pizzy]Sakura,3450,176,7,6,13,53.8%,10m
7826,3,IgnaBardos,3450,124,7,6,13,53.8%,40m
7826,2,INnoVation,3450,135,4,1,5,80.0%,27m
7826,3,SoulKey,3450,0,1,0,1,100.0%,19m
7826,3,HotDryNoodle,3450,30,1,2,3,33.3%,42m
7826,3,ItmeDP,3450,0,0,1,1,0.0%,26m
7826,3,NoobMan,3450,0,0,1,1,0.0%,37m
7826,3,BlueWarrior,3450,0,0,1,1,0.0%,10m
7826,3,BabyBeerus,3450,0,0,2,2,0.0%,42m
7842,3,[RIPOU]Matroide,3449,1339,96,86,182,52.7%,19m
7842,3,lindyhopper,3449,1285,92,78,170,54.1%,2m
7842,3,marine,3449,1193,47,37,84,56.0%,29m
7842,2,[TmT4va]lilryu,3449,670,43,36,79,54.4%,15m
7842,3,[Fever]Zane,3449,411,18,10,28,64.3%,37m
7842,3,IlIlIlIlIlIl,3449,376,16,9,25,64.0%,13m
7842,3,GLHF,3449,161,9,9,18,50.0%,40m
7842,3,PoisoN,3449,145,8,5,13,61.5%,40m
7842,3,Hephaestus,3449,254,8,5,13,61.5%,37m
7842,3,[jacasb]VELKAN,3449,0,0,1,1,0.0%,41m
7842,3,[PINGON]portaco,3449,0,0,1,1,0.0%,38m
7842,3,MamaLaMicra,3449,0,0,1,1,0.0%,38m
7854,3,InoobAtion,3448,1266,111,105,216,51.4%,33m
7854,3,mineeater,3448,832,59,40,99,59.6%,27m
7854,3,[SC2AU]vEnergyDrink,3448,624,46,40,86,53.5%,40m
7854,2,hoopaholik,3448,313,42,45,87,48.3%,42m
7854,3,Missingno,3448,788,29,30,59,49.2%,21m
7854,3,JoeyDonuts,3448,281,11,12,23,47.8%,34m
7854,2,[RusWin]Alcoworld,3448,296,11,17,28,39.3%,18m
7854,3,seVen,3448,86,4,1,5,80.0%,34m
7854,2,DeadSpWnZerG,3448,60,3,7,10,30.0%,40m
7854,1,Oti,3448,96,2,2,4,50.0%,38m
7854,2,[MaInT]Poke,3448,44,2,2,4,50.0%,28m
7854,1,Salamandra,3448,142,2,4,6,33.3%,36m
7854,3,[HotsPL]NipleSlap,3448,0,1,0,1,100.0%,12m
7854,3,Blizzfreak,3448,30,1,5,6,16.7%,33m
7854,3,Voodoochilli,3448,0,0,1,1,0.0%,37m
7869,3,Cidragon,3447,634,100,72,172,58.1%,29m
7869,2,GeneralBTNKD,3447,1520,93,109,202,46.0%,25m
7869,2,[Snifar]RatBoy,3447,270,71,53,124,57.3%,15m
7869,2,Assypod,3447,1227,55,49,104,52.9%,3m
7869,3,GinetteReno,3447,634,22,25,47,46.8%,29m
7869,3,[lDream]CRISLAYER,3447,221,10,3,13,76.9%,34m
7869,3,Moridin,3447,242,9,3,12,75.0%,27m
7869,3,Lgkk,3447,146,6,4,10,60.0%,31m
7869,1,llllllllllll,3447,113,3,0,3,100.0%,38m
7869,3,Guluheend,3447,0,1,1,2,50.0%,16m
7869,3,ZZZ,3447,0,0,3,3,0.0%,24m
7869,1,Voidray,3447,0,0,3,3,0.0%,42m
7881,2,Ranga,3446,1491,143,114,257,55.6%,36m
7881,2,Trofee,3446,1334,101,81,182,55.5%,20m
7881,3,JEREMII,3446,1412,69,67,136,50.7%,26m
7881,2,lkcadiz,3446,1519,58,64,122,47.5%,23m
7881,2,PowerPuffin,3446,556,37,38,75,49.3%,12m
7881,2,Makerosc,3446,412,14,18,32,43.8%,11m
7881,3,[yoTN]Pipiolo,3446,176,11,7,18,61.1%,24m
7881,2,BarrackS,3446,164,8,3,11,72.7%,26m
7881,3,[BoAVN]Ice,3446,242,8,9,17,47.1%,10m
7881,3,Qwig,3446,114,4,6,10,40.0%,4m
7881,3,IIIIIIIIII,3446,58,2,1,3,66.7%,16m
7881,3,FrosT,3446,60,2,5,7,28.6%,39m
7881,3,Shivvy,3446,0,0,1,1,0.0%,36m
7881,3,[Gh0stp]Danglars,3446,0,0,1,1,0.0%,6m
7881,3,Pepega,3446,0,0,1,1,0.0%,27m
7881,3,luckycat,3446,0,0,1,1,0.0%,38m
7897,2,Erasmus,3445,1534,265,267,532,49.8%,23m
7897,2,Sen,3445,907,97,107,204,47.5%,4m
7897,3,[LTlord]GokuLeGana,3445,1403,62,52,114,54.4%,15m
7897,3,Solanin,3445,1114,49,32,81,60.5%,15m
7897,2,Wolvrine,3445,1120,43,45,88,48.9%,32m
7897,3,[cl0udM]TaggedOnce,3445,541,30,26,56,53.6%,23m
7897,3,Chilaquil,3445,314,13,6,19,68.4%,14m
7897,3,[NovaX]MajiNCue,3445,146,6,3,9,66.7%,9m
7897,2,wonbee,3445,156,5,12,17,29.4%,19m
7897,3,[Splyce]BudgetTYTY,3445,141,4,0,4,100.0%,33m
7897,3,[TGCrew]BasherSlice,3445,58,2,1,3,66.7%,13m
7897,3,MASSUKA,3445,30,2,3,5,40.0%,42m
7897,3,Mic,3445,0,1,0,1,100.0%,22m
7897,3,[RwtM]SniperGLyo,3445,30,1,1,2,50.0%,28m
7897,3,[FMX]FraperRush,3445,0,0,1,1,0.0%,11m
7897,3,gatokio,3445,0,0,1,1,0.0%,18m
7913,2,Daigle,3444,1259,128,125,253,50.6%,40m
7913,3,[XpKb]WhiteVoid,3444,1423,127,97,224,56.7%,15m
7913,3,BuDz,3444,1051,95,77,172,55.2%,3m
7913,2,[ACSS]Lanthus,3444,640,43,43,86,50.0%,19m
7913,2,Fishcakes,3444,904,42,34,76,55.3%,6m
7913,2,[YD2K]AoNxWookie,3444,914,41,54,95,43.2%,2m
7913,2,[HØST]Salgarello,3444,747,27,28,55,49.1%,7m
7913,2,[SPSM3]Ralfe,3444,468,17,23,40,42.5%,31m
7913,2,[ANIMOO]Dannie,3444,255,14,17,31,45.2%,15m
7913,3,Marauder,3444,302,11,6,17,64.7%,10m
7913,3,[DHaLL]SirAenys,3444,226,9,7,16,56.2%,32m
7913,3,[xLgNx]Calm,3444,232,7,5,12,58.3%,5m
7913,3,Nokker,3444,0,5,1,6,83.3%,24m
7913,3,Kilgrow,3444,88,3,2,5,60.0%,37m
7913,3,THEXYCON,3444,58,2,1,3,66.7%,10m
7913,3,[ARLA]FGThjklzEX,3444,0,1,0,1,100.0%,7m
7913,1,Caleb,3444,0,0,1,1,0.0%,38m
7913,3,[a99]Bloodbyte,3444,0,0,2,2,0.0%,35m
7931,3,RickeyBobby,3443,1004,39,33,72,54.2%,41m
7931,3,[ZTemp]Norman,3443,391,18,17,35,51.4%,10m
7931,3,Goku,3443,340,13,10,23,56.5%,33m
7931,2,kishan,3443,392,13,19,32,40.6%,12m
7931,3,sambomaster,3443,105,11,12,23,47.8%,13m
7931,3,[2faded]Random,3443,254,10,10,20,50.0%,8m
7931,3,Jaesung,3443,250,8,12,20,40.0%,34m
7931,3,dirty,3443,114,7,5,12,58.3%,22m
7931,3,Gazedo,3443,146,6,7,13,46.2%,7m
7931,1,[SASG]Rainbow,3443,0,4,1,5,80.0%,1h
7931,3,[PTHero]JTgalactica,3443,30,2,0,2,100.0%,34m
7931,2,zim,3443,0,1,0,1,100.0%,26m
7931,3,[bXd]PuNk,3443,0,1,3,4,25.0%,41m
7931,3,[Nag]Josher,3443,0,0,1,1,0.0%,14m
7931,3,jerryPE,3443,0,0,3,3,0.0%,10m
7946,3,SiNE,3442,1026,106,96,202,52.5%,36m
7946,2,[IMDSI]DaNnEL,3442,1071,83,82,165,50.3%,17m
7946,3,[IPCSI]JuamPI,3442,576,24,18,42,57.1%,25m
7946,2,CoolG,3442,472,19,18,37,51.4%,5m
7946,3,Sek,3442,372,17,12,29,58.6%,9m
7946,3,[weFish]Zero,3442,222,11,5,16,68.8%,23m
7946,3,[x519]wolfgang,3442,236,8,9,17,47.1%,30m
7946,3,frobe,3442,97,2,0,2,100.0%,32m
7946,3,LOVEBYUN,3442,58,2,6,8,25.0%,38m
7946,3,[KJDW]tron,3442,0,1,0,1,100.0%,16m
7946,3,Hachiroku,3442,0,0,2,2,0.0%,35m
7957,2,[GARREN]xxxx,3441,1586,445,426,871,51.1%,22m
7957,2,[LOOPY]SINN,3441,1491,205,208,413,49.6%,33m
7957,2,Redbaron,3441,1567,189,182,371,50.9%,20m
7957,2,[cl0udM]INject,3441,1352,88,84,172,51.2%,7m
7957,3,IIInnovation,3441,1578,70,52,122,57.4%,25m
7957,3,AnthonellaMC,3441,822,52,44,96,54.2%,41m
7957,3,RobertV,3441,187,14,11,25,56.0%,41m
7957,3,therialumon,3441,168,8,6,14,57.1%,33m
7957,2,himsir,3441,147,7,3,10,70.0%,8m
7957,3,[eXtra1]TheFerretKin,3441,60,2,5,7,28.6%,14m
7957,3,[MRCYLS]HudsonHornet,3441,0,1,0,1,100.0%,40m
7957,3,[MEP]AkicitaWaste,3441,0,0,1,1,0.0%,37m
7957,3,[QcScT]BlacKSuN,3441,0,0,1,1,0.0%,5m
7970,2,Charlie,3440,1461,191,183,374,51.1%,8m
7970,2,[suPine]supinejellie,3440,502,17,20,37,45.9%,6m
7970,3,HandiQuacked,3440,353,15,7,22,68.2%,27m
7970,2,Vend,3440,256,10,16,26,38.5%,32m
7970,3,YuSmoLpeen,3440,223,7,6,13,53.8%,9m
7970,3,[LCE]Chipana,3440,120,4,9,13,30.8%,9m
7970,3,[Yuhang]Guider,3440,0,1,0,1,100.0%,42m
7970,3,[AnXN]VeRisiMiLAr,3440,0,1,3,4,25.0%,2m
7970,3,[MSFT]LightBrigade,3440,0,0,1,1,0.0%,7m
7970,3,STIMPYRUSH,3440,0,0,1,1,0.0%,34m
7980,3,Saltlord,3439,1075,199,182,381,52.2%,38m
7980,2,[Wrekrs]Sparky,3439,1598,181,177,358,50.6%,26m
7980,2,[DHZAcD]Plavalaguna,3439,1595,164,162,326,50.3%,35m
7980,3,Watertop,3439,870,33,31,64,51.6%,42m
7980,2,KarKaroto,3439,376,13,21,34,38.2%,40m
7980,2,PongO,3439,196,6,14,20,30.0%,4m
7980,3,[SIClan]INnoVation,3439,88,4,4,8,50.0%,37m
7980,3,diksuckr,3439,30,2,1,3,66.7%,41m
7980,3,IlIlIlIlIIll,3439,0,1,0,1,100.0%,2m
7980,3,AIphaStar,3439,0,1,0,1,100.0%,40m
7980,3,defucted,3439,0,1,0,1,100.0%,26m
7980,3,appledas,3439,0,0,3,3,0.0%,13m
7992,3,Nivek,3438,1244,162,137,299,54.2%,23m
7992,3,[NLTTJ]sohot,3438,412,17,8,25,68.0%,5m
7992,3,mansagna,3438,446,17,14,31,54.8%,40m
7992,3,sugar,3438,214,10,6,16,62.5%,19m
7992,2,FishNugget,3438,241,9,11,20,45.0%,10m
7992,3,[AMBP]HotAmbush,3438,298,9,12,21,42.9%,23m
7992,3,UncleRoger,3438,86,6,3,9,66.7%,4m
7992,3,mcVV,3438,114,6,4,10,60.0%,29m
7992,3,MatrixLegend,3438,116,5,6,11,45.5%,41m
7992,3,sasum,3438,86,3,5,8,37.5%,2m
7992,3,renaissance,3438,0,0,1,1,0.0%,30m
7992,3,Balls,3438,0,0,1,1,0.0%,4m
7992,3,Vlign,3438,0,0,1,1,0.0%,19m
8005,2,Layz,3437,1577,221,210,431,51.3%,4m
8005,2,[ValidG]Dajak,3437,1557,200,182,382,52.4%,2m
8005,3,[B055]ShadowTiger,3437,1553,197,178,375,52.5%,7m
8005,2,zion,3437,1532,187,178,365,51.2%,4m
8005,2,[Magic3]DEADSNAKE,3437,1482,181,168,349,51.9%,8m
8005,2,CaptainJP,3437,1569,123,117,240,51.2%,3m
8005,3,LEO,3437,1573,103,92,195,52.8%,8m
8005,3,SimasTurbo,3437,922,44,39,83,53.0%,39m
8005,3,[ØØ]NerfHerder,3437,568,22,17,39,56.4%,26m
8005,3,TerranPlayer,3437,142,8,0,8,100.0%,19m
8005,1,TYTY,3437,221,6,6,12,50.0%,4m
8005,3,[Verley]Bumblebee,3437,96,2,2,4,50.0%,23m
8005,3,MiniNinja,3437,60,2,8,10,20.0%,33m
8005,3,[DETER]SectorTora,3437,0,1,0,1,100.0%,41m
8005,2,Scyther,3437,0,1,0,1,100.0%,38m
8005,3,[NPhase]Wittgenstein,3437,30,1,3,4,25.0%,33m
8005,3,[TACOST]VAKER,3437,0,0,1,1,0.0%,29m
8022,3,[SydTT]wulala,3436,1640,164,151,315,52.1%,39m
8022,3,[GOPERÚ]Dorian,3436,429,21,11,32,65.6%,31m
8022,3,[ezzzz1]FalconPawnch,3436,560,21,27,48,43.8%,27m
8022,2,[TBoYs]Maldhar,3436,168,9,5,14,64.3%,26m
8022,3,[GEEKED]KillaClown,3436,172,6,10,16,37.5%,9m
8022,3,HaSingPlay,3436,30,2,0,2,100.0%,12m
8022,3,poorboy,3436,58,2,1,3,66.7%,10m
8022,3,[eX]Trolcidanos,3436,0,1,0,1,100.0%,28m
8022,3,SputniK,3436,30,1,2,3,33.3%,40m
8031,3,kingKorean,3435,1605,273,256,529,51.6%,23m
8031,3,Turkeltown,3435,1272,68,60,128,53.1%,23m
8031,3,[Cryptc]Blackknight,3435,853,40,40,80,50.0%,42m
8031,2,[UpeV]Kvothe,3435,622,21,30,51,41.2%,30m
8031,3,[Epic]Medii,3435,328,11,7,18,61.1%,30m
8031,3,HighCat,3435,162,7,2,9,77.8%,19m
8031,3,Junnykuper,3435,202,7,8,15,46.7%,3m
8031,3,Sair,3435,0,5,1,6,83.3%,31m
8031,2,TejonSalvaje,3435,30,2,8,10,20.0%,23m
8031,3,[VGL]Sloaneus,3435,0,0,1,1,0.0%,40m
8031,3,nAPoleonDyna,3435,0,0,5,5,0.0%,28m
8042,3,IIIlllIIIlll,3434,1598,335,320,655,51.1%,40m
8042,3,BainCompany,3434,1542,316,297,613,51.5%,2m
8042,2,[SSoSS]QKSGz,3434,1518,147,147,294,50.0%,23m
8042,2,[ConFed]Markuverse,3434,1192,57,71,128,44.5%,38m
8042,3,theist,3434,546,23,16,39,59.0%,12m
8042,3,Hong,3434,405,17,10,27,63.0%,13m
8042,3,[CRAKS]NightWolf,3434,318,11,13,24,45.8%,17m
8042,3,LazyOyO,3434,259,9,3,12,75.0%,40m
8042,3,foreveralone,3434,58,7,0,7,100.0%,16m
8042,3,MechItHappen,3434,144,7,1,8,87.5%,4m
8042,3,Jetstream,3434,0,5,1,6,83.3%,38m
8042,3,Peace,3434,86,4,2,6,66.7%,23m
8042,3,IlIlIlIlIlIl,3434,58,3,1,4,75.0%,41m
8042,3,Peirce,3434,60,2,5,7,28.6%,34m
8042,3,Xibuzanfa,3434,0,0,2,2,0.0%,17m
8057,1,bluefyre,3433,1377,216,224,440,49.1%,18m
8057,2,[UpxV]Gwyndd,3433,1447,149,155,304,49.0%,3m
8057,3,Tweek,3433,1603,73,72,145,50.3%,35m
8057,3,HiThere,3433,873,39,29,68,57.4%,16m
8057,2,MtaWrldPc,3433,299,21,26,47,44.7%,4m
8057,2,Sosa,3433,261,11,11,22,50.0%,32m
8057,3,[Twitch]wimpy,3433,176,7,11,18,38.9%,23m
8057,3,[RHGP]SammoBammo,3433,0,1,1,2,50.0%,10m
8057,3,RedStar,3433,30,1,2,3,33.3%,16m
8057,3,CoreRazzer,3433,30,1,3,4,25.0%,10m
8057,3,Kennuh,3433,0,0,1,1,0.0%,12m
8068,2,layzzie,3432,976,62,64,126,49.2%,4m
8068,2,SuSy,3432,652,34,29,63,54.0%,12m
8068,2,speaknow,3432,678,33,37,70,47.1%,22m
8068,2,Twingster,3432,619,25,23,48,52.1%,36m
8068,3,KainPrime,3432,326,13,6,19,68.4%,10m
8068,3,Pants,3432,281,11,8,19,57.9%,34m
8068,2,Domino,3432,226,7,11,18,38.9%,42m
8068,3,[LPnet]DARKING,3432,120,5,6,11,45.5%,12m
8068,3,RichRad,3432,30,2,1,3,66.7%,18m
8068,3,FartStimson,3432,0,1,0,1,100.0%,27m
8068,3,deepblue,3432,0,0,1,1,0.0%,22m
8079,3,CaptKroger,3431,1606,143,136,279,51.3%,19m
8079,3,Epitaph,3431,1010,53,43,96,55.2%,23m
8079,2,snu,3431,687,33,40,73,45.2%,31m
8079,3,[95O]DayOne,3431,442,17,11,28,60.7%,39m
8079,3,loveandmusic,3431,259,9,4,13,69.2%,7m
8079,3,ChipS,3431,176,7,3,10,70.0%,38m
8079,3,[LADIES]Blitchiz,3431,142,5,3,8,62.5%,10m
8079,3,dcfm,3431,88,4,5,9,44.4%,37m
8079,3,Peacemaker,3431,0,0,1,1,0.0%,41m
8088,3,mic,3430,1041,177,168,345,51.3%,34m
8088,3,Enex,3430,584,25,19,44,56.8%,10m
8088,3,[Khole]Sketchcraft,3430,380,18,9,27,66.7%,9m
8088,3,Plott,3430,246,9,3,12,75.0%,22m
8088,3,shakingcow,3430,212,7,8,15,46.7%,35m
8088,3,Nightwell,3430,200,7,8,15,46.7%,16m
8088,3,[LQV]BigMinnow,3430,97,3,4,7,42.9%,22m
8088,3,Leviatan,3430,30,2,0,2,100.0%,26m
8088,3,Insolation,3430,62,2,5,7,28.6%,20m
8088,3,yob,3430,0,0,1,1,0.0%,4m
8098,2,Illiabad,3429,627,51,48,99,51.5%,4m
8098,3,Dackes,3429,370,18,11,29,62.1%,13m
8098,3,IIIIIIIIIIII,3429,228,11,5,16,68.8%,20m
8098,3,[Thanat]InviShadow,3429,238,8,6,14,57.1%,39m
8098,1,llllllllllll,3429,171,5,4,9,55.6%,13m
8098,3,Tinash,3429,58,3,2,5,60.0%,37m
8098,3,HamtaroSan,3429,58,3,7,10,30.0%,37m
8098,3,OHOOUO,3429,58,2,3,5,40.0%,11m
8098,3,[ANFA]Super,3429,60,2,7,9,22.2%,26m
8098,3,PANIE,3429,0,1,0,1,100.0%,3m
8098,3,UmpaLumpa,3429,0,1,0,1,100.0%,34m
8098,2,KomJeBoaMonT,3429,0,0,1,1,0.0%,26m
8098,3,Rigzer,3429,0,0,3,3,0.0%,3m
8111,3,PetitFromage,3428,976,38,30,68,55.9%,14m
8111,3,Dougyfresh,3428,642,25,27,52,48.1%,10m
8111,3,GUYINTHECHAT,3428,88,8,2,10,80.0%,16m
8111,3,Yugo,3428,192,7,5,12,58.3%,12m
8111,2,aaa,3428,60,2,9,11,18.2%,20m
8111,3,[ZTemps]iPnTheElder,3428,0,1,0,1,100.0%,16m
8111,3,[hood]Maximus,3428,30,1,3,4,25.0%,2m
8111,1,[GnR]Cruel,3428,48,1,6,7,14.3%,37m
8111,3,[Xpk]SPONZHER,3428,0,0,1,1,0.0%,13m
8120,2,gamer,3427,1517,109,130,239,45.6%,33m
8120,3,Icedeamon,3427,614,24,19,43,55.8%,25m
8120,3,Droptuned,3427,412,16,14,30,53.3%,35m
8120,3,[MSFT]ViceAdmiral,3427,460,16,18,34,47.1%,27m
8120,3,Playrafa,3427,376,14,15,29,48.3%,16m
8120,3,[M4nLUV]SacSurgeon,3427,310,13,2,15,86.7%,38m
8120,3,Fragrant,3427,173,8,4,12,66.7%,40m
8120,3,lililililili,3427,207,6,1,7,85.7%,5m
8120,3,Snow,3427,121,4,4,8,50.0%,39m
8120,3,Airbornedsm,3427,88,3,4,7,42.9%,4m
8120,3,deuce,3427,30,1,2,3,33.3%,20m
8120,3,[NCMEME]Ryyuuuu,3427,30,1,2,3,33.3%,12m
8120,2,Triumph,3427,30,1,9,10,10.0%,22m
8120,3,[LQV]Sparta,3427,0,0,1,1,0.0%,19m
8134,2,MetalMaestro,3426,1540,222,231,453,49.0%,34m
8134,2,[ZCCCFE]Mxy,3426,1626,117,125,242,48.3%,19m
8134,2,Rafaq,3426,1518,110,105,215,51.2%,12m
8134,3,totokuitro,3426,306,25,25,50,50.0%,30m
8134,2,Dreamboat,3426,310,10,19,29,34.5%,8m
8134,3,[EM0]gothic,3426,190,9,1,10,90.0%,25m
8134,3,xcolosusx,3426,206,8,8,16,50.0%,5m
8134,3,[UFC]MasterP,3426,168,7,4,11,63.6%,25m
8134,1,llllllllllll,3426,0,5,0,5,100.0%,3h
8134,3,Force,3426,120,5,6,11,45.5%,37m
8134,3,Frosty,3426,0,4,1,5,80.0%,34m
8134,3,[dLife]DarkStar,3426,0,1,2,3,33.3%,10m
8134,3,monkeydoo,3426,0,0,1,1,0.0%,29m
8147,3,llllllllllll,3425,1356,102,49,151,67.5%,33m
8147,2,GoneFishing,3425,972,74,84,158,46.8%,28m
8147,3,FlowerMinam,3425,710,27,33,60,45.0%,35m
8147,3,cosmoton,3425,466,20,11,31,64.5%,13m
8147,2,FightingRabb,3425,263,15,22,37,40.5%,4m
8147,2,[PLA2N]tommygun,3425,295,11,13,24,45.8%,23m
8147,2,PoultryFeed,3425,187,8,4,12,66.7%,5m
8147,3,hairEeE,3425,0,1,0,1,100.0%,11m
8147,3,Obsidian,3425,30,1,2,3,33.3%,33m
8147,3,[uy]VJtenacious,3425,0,0,1,1,0.0%,26m
8147,3,RemakeOfStar,3425,0,0,1,1,0.0%,35m
8147,3,asq,3425,0,0,1,1,0.0%,30m
8159,3,[0PAIN0]PainFellow,3424,1610,105,105,210,50.0%,18m
8159,3,Player,3424,1639,84,63,147,57.1%,19m
8159,3,XxGhostxXD,3424,1127,64,51,115,55.7%,37m
8159,2,[3939]Vendor,3424,577,55,55,110,50.0%,20m
8159,2,Ozymandias,3424,1082,54,47,101,53.5%,23m
8159,2,Jeffkhan,3424,888,41,51,92,44.6%,36m
8159,2,miamilow,3424,426,18,15,33,54.5%,33m
8159,3,MightySaint,3424,470,17,18,35,48.6%,20m
8159,3,Faith,3424,308,15,7,22,68.2%,16m
8159,2,MurderProbes,3424,231,13,12,25,52.0%,6m
8159,2,[v1rgin]Zelevin,3424,292,10,19,29,34.5%,41m
8159,3,HardWalnut,3424,0,5,1,6,83.3%,31m
8159,2,[NBSvet]VICIOUS,3424,130,4,9,13,30.8%,34m
8159,2,Smooth,3424,46,2,3,5,40.0%,27m
8159,3,[nG]KraKen,3424,0,1,2,3,33.3%,35m
8159,3,LovelyCaTTT,3424,0,0,1,1,0.0%,33m
8175,2,Benzo,3423,1463,277,275,552,50.2%,13m
8175,2,[Sopita]MaNuS,3423,1511,231,226,457,50.5%,37m
8175,2,[EtrOy]Irre,3423,874,139,142,281,49.5%,12m
8175,2,Sullust,3423,1513,122,123,245,49.8%,22m
8175,2,[Foosed]ZeusBruce,3423,490,35,33,68,51.5%,31m
8175,3,[flux]Dantaro,3423,192,8,5,13,61.5%,34m
8175,2,[SMB]Rainstorm,3423,58,3,7,10,30.0%,31m
8175,3,[PiGPan]QuiGonJinn,3423,0,1,0,1,100.0%,37m
8175,3,ThePunisher,3423,0,1,0,1,100.0%,4m
8175,3,Ohmduph,3423,0,1,0,1,100.0%,42m
8175,3,[BoRnGo]Skyhook,3423,0,0,1,1,0.0%,7m
8175,3,[Ex7rA]RaiN,3423,0,0,1,1,0.0%,8m
8175,3,dawn,3423,0,0,1,1,0.0%,30m
8188,2,noobfasho,3422,1540,287,275,562,51.1%,17m
8188,2,[YEM]DogLog,3422,1411,52,54,106,49.1%,23m
8188,3,[FMX]MetaLHero,3422,532,22,19,41,53.7%,42m
8188,3,Eddie,3422,448,18,10,28,64.3%,12m
8188,3,llllllllllll,3422,356,14,5,19,73.7%,33m
8188,2,vanilla,3422,346,13,19,32,40.6%,27m
8188,3,[Frzen]Lanaya,3422,254,10,6,16,62.5%,40m
8188,3,[Cryptc]Krispee,3422,262,9,14,23,39.1%,13m
8188,3,[NwAs]FaraonDLT,3422,0,1,0,1,100.0%,21m
8188,3,VaderMort,3422,30,1,2,3,33.3%,3m
8198,3,[DarkAG]JKOBE,3421,1393,319,293,612,52.1%,19m
8198,2,CiTr,3421,1484,137,142,279,49.1%,33m
8198,2,[Igbt]FlyinHealBus,3421,1184,91,79,170,53.5%,28m
8198,2,ELPecador,3421,1238,84,93,177,47.5%,34m
8198,3,Squid,3421,1031,47,23,70,67.1%,16m
8198,3,Tiramisu,3421,684,29,13,42,69.0%,41m
8198,3,Rhymenoceros,3421,425,23,13,36,63.9%,24m
8198,3,[BLKISH]BlackishWolf,3421,466,18,18,36,50.0%,30m
8198,3,[Pibo3]strahlor,3421,491,17,17,34,50.0%,37m
8198,3,[UpeV]Kelevra,3421,242,10,2,12,83.3%,10m
8198,3,ReVeHUN,3421,73,6,11,17,35.3%,10m
8198,3,Mozzer,3421,60,2,4,6,33.3%,31m
8198,1,iAmZero,3421,0,1,0,1,100.0%,3m
8198,3,IIIIIIIIIII,3421,0,1,1,2,50.0%,35m
8198,2,[FloH]ZizekLobster,3421,0,0,1,1,0.0%,31m
8213,3,Infinnity,3420,1572,110,107,217,50.7%,31m
8213,3,TheLakeshow,3420,1459,97,102,199,48.7%,40m
8213,3,[GEEKED]Artificial,3420,926,36,31,67,53.7%,19m
8213,3,glacier,3420,646,26,19,45,57.8%,40m
8213,3,Yautja,3420,236,8,10,18,44.4%,15m
8213,2,StreetFightR,3420,226,7,5,12,58.3%,36m
8213,3,[BRSKR]Immigrant,3420,58,5,3,8,62.5%,14m
8213,3,oOo,3420,0,4,1,5,80.0%,23m
8213,3,ImEmperor,3420,58,3,0,3,100.0%,16m
8213,3,IIIIIIIIIIII,3420,30,2,1,3,66.7%,19m
8213,3,Phonypony,3420,58,2,2,4,50.0%,35m
8213,3,AllAlone,3420,58,2,3,5,40.0%,26m
8213,3,Emigo,3420,30,1,3,4,25.0%,37m
8213,3,[Comedy]Tenu,3420,0,0,1,1,0.0%,14m
8213,3,PETTER,3420,0,0,1,1,0.0%,8m
8213,1,BOOOOOOOOO,3420,0,0,1,1,0.0%,47m
8213,3,[bLoser]LOSE,3420,0,0,2,2,0.0%,15m
8230,2,coman,3419,1430,315,308,623,50.6%,19m
8230,3,DreamJob,3419,1607,193,171,364,53.0%,38m
8230,3,[SizZIe]RaynorsRaper,3419,1632,101,75,176,57.4%,16m
8230,3,juancho,3419,1520,98,82,180,54.4%,4m
8230,2,bankatinos,3419,747,57,67,124,46.0%,34m
8230,3,Rin,3419,691,56,51,107,52.3%,41m
8230,2,[T600]palido,3419,506,22,19,41,53.7%,23m
8230,3,Andrew,3419,518,21,17,38,55.3%,29m
8230,3,[FxB]Visser,3419,457,21,19,40,52.5%,13m
8230,3,nonamemembra,3419,202,7,7,14,50.0%,14m
8230,3,[lNI]Hobe,3419,140,5,3,8,62.5%,10m
8230,3,[WarCom]YaaR,3419,60,3,2,5,60.0%,23m
8230,3,Saxy,3419,88,3,3,6,50.0%,5m
8230,3,[TGCrew]gililore,3419,60,2,4,6,33.3%,35m
8230,3,DoctorFatso,3419,30,1,4,5,20.0%,27m
8230,2,[LPlay]PROMETHEUS,3419,30,1,8,9,11.1%,37m
8230,3,[KingSC]InFected,3419,0,0,1,1,0.0%,15m
8230,3,dragonhelix,3419,0,0,4,4,0.0%,41m
8248,2,Lepsid,3418,1243,124,126,250,49.6%,22m
8248,3,Panda,3418,1400,57,57,114,50.0%,33m
8248,2,Soul,3418,990,38,59,97,39.2%,20m
8248,3,Artemisia,3418,636,27,20,47,57.4%,23m
8248,2,[xMDx]RedDog,3418,530,18,26,44,40.9%,23m
8248,3,[Meeoww]avenger,3418,220,15,12,27,55.6%,2m
8248,3,[GGGG]Airduke,3418,144,4,1,5,80.0%,28m
8248,3,[CatRG]ZergButchery,3418,0,2,4,6,33.3%,12m
8248,3,math,3418,30,1,1,2,50.0%,20m
8257,3,Zibbles,3417,1516,224,202,426,52.6%,20m
8257,3,stungun,3417,1030,134,135,269,49.8%,5m
8257,2,Zaku,3417,1519,84,88,172,48.8%,36m
8257,3,[XpKb]aTiLaCrAfT,3417,1502,61,50,111,55.0%,33m
8257,3,[AbcCo]Endimión,3417,1050,52,20,72,72.2%,11m
8257,3,[LoF]Time,3417,700,33,24,57,57.9%,15m
8257,3,[lo0lo0]mike,3417,384,14,15,29,48.3%,10m
8257,3,coefes,3417,242,9,3,12,75.0%,24m
8257,2,AkusTa,3417,205,9,4,13,69.2%,8m
8257,3,[TGosuA]Kyroh,3417,252,9,7,16,56.2%,2m
8257,3,Subvertio,3417,214,6,5,11,54.5%,11m
8257,2,[Fronds]DarkPRamza,3417,118,6,13,19,31.6%,31m
8257,3,Gongmyung,3417,0,1,4,5,20.0%,12m
8257,3,[Random]JiveTurkey,3417,0,0,1,1,0.0%,11m
8257,1,YeE,3417,0,0,2,2,0.0%,60m
8272,2,[CRAKS]TIGERVESSEL,3416,1445,66,78,144,45.8%,33m
8272,3,ArieS,3416,1296,51,44,95,53.7%,8m
8272,3,Amouri,3416,770,30,17,47,63.8%,2m
8272,3,heckbat,3416,226,9,16,25,36.0%,26m
8272,3,[WldHog]SnowBomber,3416,142,6,4,10,60.0%,8m
8272,3,eKKo,3416,103,6,4,10,60.0%,6m
8272,3,RandomRaiser,3416,0,5,0,5,100.0%,20m
8272,3,Warbringer,3416,30,1,1,2,50.0%,8m
8272,2,[Apprvd]Soup,3416,0,0,1,1,0.0%,26m
8272,1,[KingSC]BattoSai,3416,0,0,3,3,0.0%,37m
8282,2,Fishincrisis,3415,1583,237,220,457,51.9%,7m
8282,3,Maddogg,3415,1199,89,74,163,54.6%,14m
8282,3,megadeth,3415,1068,81,75,156,51.9%,18m
8282,3,VeganDeity,3415,674,59,53,112,52.7%,13m
8282,3,Zosyn,3415,1330,50,51,101,49.5%,4m
8282,3,RonSwanson,3415,1296,48,50,98,49.0%,4m
8282,3,Lieutenant,3415,935,43,30,73,58.9%,29m
8282,2,Sohjiro,3415,430,15,18,33,45.5%,42m
8282,2,TigerStyle,3415,164,8,3,11,72.7%,30m
8282,2,Redux,3415,181,8,5,13,61.5%,6m
8282,3,[EZCs]Vaskora,3415,198,8,7,15,53.3%,15m
8282,3,Fexx,3415,219,7,8,15,46.7%,22m
8282,3,[DmnTz]ArtiC,3415,18,2,1,3,66.7%,19m
8282,3,DarKSeid,3415,0,1,0,1,100.0%,11m
8296,3,uoYkcuF,3414,309,41,29,70,58.6%,15m
8296,3,Hknight,3414,688,31,23,54,57.4%,41m
8296,3,Berkoff,3414,744,27,23,50,54.0%,41m
8296,3,llPerfection,3414,322,16,8,24,66.7%,22m
8296,3,[JSLs]SunQuan,3414,268,10,6,16,62.5%,5m
8296,3,[TopFlt]Grave,3414,198,7,10,17,41.2%,39m
8296,3,WafflyTripod,3414,182,6,4,10,60.0%,41m
8296,3,MrPubes,3414,176,6,11,17,35.3%,22m
8296,3,purdy,3414,137,2,3,5,40.0%,35m
8296,3,IIIIIII,3414,42,1,1,2,50.0%,19m
8306,3,Azrael,3413,1524,277,266,543,51.0%,31m
8306,3,TheDarkLord,3413,1645,200,189,389,51.4%,23m
8306,3,mhf,3413,1604,200,194,394,50.8%,41m
8306,3,STUAR,3413,1267,95,80,175,54.3%,40m
8306,2,ChampuScuti,3413,1544,60,71,131,45.8%,4m
8306,3,StarMail,3413,879,41,18,59,69.5%,37m
8306,3,AleGreatness,3413,481,20,6,26,76.9%,42m
8306,3,JMF,3413,392,19,8,27,70.4%,9m
8306,3,TMcorvo,3413,476,19,15,34,55.9%,16m
8306,3,masterGIL,3413,432,17,11,28,60.7%,20m
8306,3,renDEzVoUS,3413,430,16,15,31,51.6%,10m
8306,3,[McCu]TheFortyTwo,3413,364,14,7,21,66.7%,22m
8306,2,DriebZ,3413,120,13,18,31,41.9%,33m
8306,3,[vLg]Jing,3413,275,10,5,15,66.7%,20m
8306,3,AlphaMale,3413,0,5,1,6,83.3%,3m
8306,3,TouchMe,3413,30,1,1,2,50.0%,29m
8306,3,[WEEEEE]jam,3413,0,0,1,1,0.0%,40m
8323,2,[TSØP]Fear,3412,1581,286,291,577,49.6%,23m
8323,2,[UpxV]DaeR,3412,1537,160,170,330,48.5%,25m
8323,2,[33rd]Mozzi,3412,1267,65,69,134,48.5%,37m
8323,3,IIIIIIIIIlll,3412,292,13,9,22,59.1%,11m
8323,2,TheRinger,3412,408,13,18,31,41.9%,25m
8323,3,Orestes,3412,152,5,9,14,35.7%,30m
8323,3,Romulus,3412,0,1,0,1,100.0%,4m
8323,2,Leclerc,3412,88,1,8,9,11.1%,19m
8323,3,[DRONGO]Indominable,3412,0,0,1,1,0.0%,30m
8332,2,PotionSeller,3411,1348,249,248,497,50.1%,17m
8332,2,Clippy,3411,1447,135,149,284,47.5%,16m
8332,3,[UpeV]TyrJose,3411,1592,101,90,191,52.9%,18m
8332,3,Gamuda,3411,618,61,50,111,55.0%,29m
8332,3,[nieBla]nightmarionn,3411,1076,60,52,112,53.6%,15m
8332,3,ifakeram,3411,645,58,54,112,51.8%,12m
8332,3,[SMHC]BoxerYK,3411,1226,56,55,111,50.5%,15m
8332,3,Changaz,3411,828,30,27,57,52.6%,29m
8332,3,[SMX]MForce,3411,388,14,15,29,48.3%,14m
8332,3,[InGt]thurston,3411,222,13,8,21,61.9%,39m
8332,3,BoosterGold,3411,266,11,3,14,78.6%,15m
8332,3,SagerKing,3411,170,11,6,17,64.7%,41m
8332,2,[eZzZzZ]VictuM,3411,342,11,20,31,35.5%,31m
8332,3,MEGAMAN,3411,0,4,1,5,80.0%,3m
8332,1,YoshiCity,3411,48,3,3,6,50.0%,9m
8332,3,[M32]HOFF,3411,0,1,0,1,100.0%,16m
8332,3,DTKCarterIII,3411,0,1,0,1,100.0%,15m
8332,3,[VENSC2]SCHOMBERG,3411,0,1,0,1,100.0%,6m
8332,3,[UoM]AveSharia,3411,0,1,0,1,100.0%,10m
8332,3,[ROCKSC]TroubleMaker,3411,30,1,1,2,50.0%,10m
8352,2,[INextI]REDFURY,3410,1586,491,484,975,50.4%,21m
8352,2,[WaIl]Yasgar,3410,1577,96,105,201,47.8%,42m
8352,3,[xTQc]AnzoImpact,3410,522,20,19,39,51.3%,34m
8352,3,BehHa,3410,357,16,8,24,66.7%,13m
8352,3,SolidSKD,3410,336,13,8,21,61.9%,12m
8352,3,[RMS]Mark,3410,86,3,5,8,37.5%,5m
8352,3,ARN,3410,30,2,0,2,100.0%,29m
8352,3,Aleks,3410,0,0,1,1,0.0%,12m
8352,3,eeeeeeeeeeee,3410,0,0,2,2,0.0%,38m
8352,1,[KmDeYb]NineVolt,3410,0,0,5,5,0.0%,42m
8362,2,[YD2K]Crino,3409,1012,139,163,302,46.0%,17m
8362,2,SweetNLo,3409,557,92,91,183,50.3%,40m
8362,3,[UpeV]KaiserLeo,3409,1428,79,68,147,53.7%,40m
8362,3,UvIm,3409,614,43,38,81,53.1%,8m
8362,3,[SCST]Gieve,3409,222,8,6,14,57.1%,42m
8362,3,AHCImode,3409,42,6,2,8,75.0%,27m
8362,3,Crausss,3409,140,5,8,13,38.5%,16m
8362,3,IIIIIIIIIIII,3409,0,0,1,1,0.0%,35m
8362,3,Rocker,3409,0,0,1,1,0.0%,9m
8371,3,ArthurDent,3408,918,162,153,315,51.4%,10m
8371,3,KAMiKZ,3408,1324,51,50,101,50.5%,39m
8371,3,[Dskwlf]Rorik,3408,972,37,36,73,50.7%,5m
8371,2,ICe,3408,523,33,37,70,47.1%,23m
8371,3,NarumiX,3408,271,23,13,36,63.9%,31m
8371,2,Geaux,3408,423,22,15,37,59.5%,24m
8371,2,FÆïì,3408,350,15,11,26,57.7%,42m
8371,3,Legion,3408,356,13,11,24,54.2%,7m
8371,3,Cannon,3408,266,10,11,21,47.6%,7m
8371,3,Kronos,3408,166,7,3,10,70.0%,12m
8371,3,[BoAVN]PapaYaGa,3408,172,7,7,14,50.0%,42m
8371,3,[RUINPP]BugsBunny,3408,192,7,9,16,43.8%,18m
8371,3,LoneStar,3408,86,4,0,4,100.0%,35m
8371,3,Squiggleyy,3408,0,1,0,1,100.0%,35m
8371,3,[PROG]GuruInfernal,3408,0,0,1,1,0.0%,4m
8371,3,unuuna,3408,0,0,1,1,0.0%,15m
8371,3,[eXoPH]eXoSkeletor,3408,0,0,2,2,0.0%,39m
8388,2,IIIIIIIIIIII,3407,1052,258,248,506,51.0%,20m
8388,2,LLegacies,3407,1024,81,71,152,53.3%,12m
8388,2,narghwar,3407,986,34,40,74,45.9%,30m
8388,3,HYVAA,3407,486,20,11,31,64.5%,41m
8388,3,WaSiD,3407,463,18,5,23,78.3%,12m
8388,3,IIIIIIIIIIII,3407,308,11,13,24,45.8%,35m
8388,3,[Flar3s]Kiaph,3407,88,4,4,8,50.0%,19m
8388,3,[LSU]Bizzell,3407,0,1,0,1,100.0%,12m
8396,2,[LGNxx]Shaman,3406,1570,208,201,409,50.9%,28m
8396,3,[Chibii]BloodOrange,3406,720,30,15,45,66.7%,41m
8396,3,[CHATO]PedroHBD,3406,144,9,4,13,69.2%,41m
8396,3,Tanjiro,3406,270,9,10,19,47.4%,13m
8396,3,[FBK]MystMir,3406,114,4,3,7,57.1%,10m
8396,3,luckygirl,3406,58,3,1,4,75.0%,38m
8396,3,PopCorn,3406,58,3,2,5,60.0%,13m
8396,3,Maru,3406,0,1,0,1,100.0%,19m
8396,3,xdeaththreat,3406,30,1,5,6,16.7%,12m
8396,3,bedevuono,3406,0,0,1,1,0.0%,16m
8406,3,[tCo9]Perabola,3405,1139,131,128,259,50.6%,41m
8406,2,mark,3405,1094,40,44,84,47.6%,13m
8406,3,[STBX]Turtlezzz,3405,433,15,21,36,41.7%,11m
8406,1,[boiss]LiuKunLin,3405,273,12,6,18,66.7%,41m
8406,2,KimuChi,3405,227,9,6,15,60.0%,10m
8406,3,[NwAs]Sebas,3405,208,7,12,19,36.8%,5m
8406,3,[JBRONI]TerranDan,3405,0,1,0,1,100.0%,41m
8406,3,bigsad,3405,0,1,0,1,100.0%,35m
8406,3,Diogo,3405,30,1,4,5,20.0%,23m
8406,3,[CEO]YOunGOne,3405,0,0,1,1,0.0%,27m
8416,2,TheUnknown,3404,1541,159,155,314,50.6%,7m
8416,3,[nieBla]waINe,3404,1416,87,70,157,55.4%,30m
8416,3,happymunkee,3404,1482,69,48,117,59.0%,12m
8416,3,Toranaga,3404,218,23,19,42,54.8%,29m
8416,3,UnFoRgIvEnN,3404,416,15,18,33,45.5%,40m
8416,3,PlayerOne,3404,171,12,10,22,54.5%,39m
8416,3,[MrtN]ebok,3404,336,11,17,28,39.3%,15m
8416,3,[Cryptc]Tonstor,3404,88,3,4,7,42.9%,27m
8416,3,BigLightning,3404,62,2,7,9,22.2%,40m
8416,3,max,3404,0,0,1,1,0.0%,20m
8416,3,[zzBB]GirthControl,3404,0,0,1,1,0.0%,21m
8416,3,[CFSM]Kanaya,3404,0,0,1,1,0.0%,37m
8416,3,[Amb3rs]Rhaegar,3404,0,0,5,5,0.0%,27m
8429,3,[CRAKS]Bronzium,3403,1640,272,252,524,51.9%,30m
8429,3,[Fellaz]Jaguar,3403,1437,74,73,147,50.3%,11m
8429,3,Orz,3403,1019,56,44,100,56.0%,30m
8429,2,sboxer,3403,1132,39,51,90,43.3%,24m
8429,3,YOSHI,3403,499,36,28,64,56.2%,13m
8429,2,[PPleb]Blodzil,3403,976,35,44,79,44.3%,16m
8429,3,Zuo,3403,206,8,7,15,53.3%,5m
8429,3,MikuOkazaki,3403,166,6,7,13,46.2%,39m
8429,3,[TGosuC]dillydickles,3403,86,4,0,4,100.0%,37m
8429,3,remainders,3403,30,3,5,8,37.5%,19m
8429,3,Tassadar,3403,30,1,2,3,33.3%,10m
8429,2,[69OGC]iTBanK,3403,30,1,7,8,12.5%,4m
8441,2,Gremus,3402,1458,177,135,312,56.7%,34m
8441,3,[MIT]Vlad,3402,1314,169,162,331,51.1%,33m
8441,2,[NOOb13]MONKIKI,3402,1095,85,86,171,49.7%,13m
8441,3,Loyo,3402,1180,47,44,91,51.6%,41m
8441,2,[QTp2T]GGAllin,3402,1085,45,54,99,45.5%,31m
8441,3,[TCGsP]Iglooburner,3402,798,36,20,56,64.3%,10m
8441,3,[ValidG]SpoOky,3402,510,32,31,63,50.8%,23m
8441,3,[UMCP]RebeccaBlack,3402,516,21,17,38,55.3%,32m
8441,3,[DarkLS]Apolinario,3402,153,8,13,21,38.1%,27m
8441,3,kjpeans,3402,142,7,5,12,58.3%,12m
8441,3,Spenouh,3402,0,5,0,5,100.0%,4m
8441,3,[dadvan]MattyMay,3402,30,2,4,6,33.3%,37m
8453,2,IIIIIIIIIIII,3401,1399,634,634,1268,50.0%,26m
8453,2,Bob,3401,1048,138,150,288,47.9%,15m
8453,3,[RazerO]AchaAcha,3401,1301,79,75,154,51.3%,18m
8453,2,ttime,3401,1236,50,43,93,53.8%,3m
8453,3,Sebastis,3401,739,44,39,83,53.0%,33m
8453,3,Steam,3401,370,14,13,27,51.9%,4m
8453,3,[uT4]kawaninja,3401,332,11,13,24,45.8%,2m
8453,3,nobody,3401,0,5,0,5,100.0%,41m
8453,3,GhostFace,3401,146,5,6,11,45.5%,31m
8453,3,[Cind3r]dreambeing,3401,30,2,0,2,100.0%,37m
8453,2,[Ochako]Trafford,3401,30,2,4,6,33.3%,7m
8453,3,[sOLsc]Zeiko,3401,0,0,1,1,0.0%,37m
8465,2,Chumbiwayo,3400,1631,813,825,1638,49.6%,17m
8465,3,[NrFms]Priebe,3400,1302,185,180,365,50.7%,10m
8465,3,[SCTues]BigToesano,3400,1397,140,138,278,50.4%,26m
8465,3,HollowShade,3400,995,64,52,116,55.2%,10m
8465,3,icecaloric,3400,1144,46,41,87,52.9%,14m
8465,2,[xRtGac]DrWidowMine,3400,889,38,35,73,52.1%,34m
8465,3,Ishmish,3400,271,11,10,21,52.4%,19m
8465,3,koka,3400,202,9,3,12,75.0%,4m
8465,3,llllllllllll,3400,0,5,1,6,83.3%,11m
8465,3,Protoss,3400,118,5,3,8,62.5%,26m
8465,1,Hush,3400,97,2,1,3,66.7%,42m
8465,3,OsIrIs,3400,0,1,0,1,100.0%,15m
8465,3,[DFault]Aeon,3400,0,0,1,1,0.0%,42m
8465,3,[Cryptc]SirDidymus,3400,0,0,2,2,0.0%,13m
8479,3,Isaac,3399,204,7,10,17,41.2%,13m
8479,3,lIlIlIlIlIlI,3399,114,5,0,5,100.0%,30m
8479,3,RienWave,3399,0,0,1,1,0.0%,9m
8479,3,[QTclub]TriumphR,3399,0,0,1,1,0.0%,11m
8483,2,TossCraftSux,3398,1515,292,297,589,49.6%,36m
8483,3,DKarnage,3398,1621,217,219,436,49.8%,41m
8483,3,SOLOKOKO,3398,1609,87,75,162,53.7%,16m
8483,3,RitterBruder,3398,1304,63,51,114,55.3%,29m
8483,3,[TSMGG]MPTheGunny,3398,697,31,21,52,59.6%,32m
8483,3,philosophe,3398,85,3,3,6,50.0%,34m
8483,3,HyperNova,3398,88,3,5,8,37.5%,15m
8483,3,[SIClan]morulis,3398,120,2,2,4,50.0%,30m
8483,3,KurtBlock,3398,0,1,0,1,100.0%,16m
8483,3,[FEARZ]Vultran,3398,30,1,1,2,50.0%,42m
8483,3,Jnk,3398,0,0,5,5,0.0%,9m
8494,3,MarineDoge,3397,1496,160,140,300,53.3%,12m
8494,2,Symbiosis,3397,872,70,68,138,50.7%,2m
8494,3,Broxy,3397,271,13,5,18,72.2%,29m
8494,3,cid,3397,0,1,1,2,50.0%,10m
8494,3,caesar,3397,0,0,1,1,0.0%,24m
8494,3,[uTi]Tehpinusdood,3397,0,0,1,1,0.0%,23m
8494,3,ACHI,3397,0,0,1,1,0.0%,11m
8501,2,[TheCMA]CustardTart,3396,1412,241,224,465,51.8%,7m
8501,3,stephen,3396,1191,107,102,209,51.2%,12m
8501,3,MAP,3396,951,81,74,155,52.3%,40m
8501,3,[Viola]lllDFGlll,3396,1490,67,65,132,50.8%,30m
8501,2,SwankyOrc,3396,910,58,66,124,46.8%,24m
8501,3,Applecore,3396,709,38,30,68,55.9%,29m
8501,3,badog,3396,708,28,18,46,60.9%,4m
8501,3,LuizZeus,3396,500,19,16,35,54.3%,16m
8501,3,Megatron,3396,272,10,6,16,62.5%,14m
8501,2,IIfkIIIIUIII,3396,194,10,7,17,58.8%,24m
8501,2,Shogun,3396,168,8,4,12,66.7%,7m
8501,1,FalseFlag,3396,0,5,0,5,100.0%,3m
8501,3,[TGCrew]Lithus,3396,148,5,5,10,50.0%,13m
8501,3,unabated,3396,58,3,0,3,100.0%,4m
8501,3,PlumpAvo,3396,0,2,3,5,40.0%,12m
8501,3,[TIGGER]Delirium,3396,30,2,4,6,33.3%,20m
8501,1,ERichtofen,3396,0,1,0,1,100.0%,3h
8501,3,[KJedi]thespartan,3396,30,1,4,5,20.0%,33m
8501,3,Ohmiegosh,3396,0,0,1,1,0.0%,26m
8501,3,[EDFsc2]Darkblade,3396,0,0,2,2,0.0%,8m
8521,3,TYTY,3395,1582,207,187,394,52.5%,5m
8521,3,[BAZNGA]BazingaIstab,3395,1599,141,135,276,51.1%,11m
8521,3,Visixis,3395,933,112,104,216,51.9%,10m
8521,3,[d1ldo]Tonkatwuck,3395,880,52,45,97,53.6%,34m
8521,3,ImScV,3395,260,9,10,19,47.4%,31m
8521,3,Mistgun,3395,118,8,5,13,61.5%,20m
8521,2,[MSUsc2]ShadowHero,3395,208,6,12,18,33.3%,19m
8521,3,[lLiTl]Sleepy,3395,120,4,8,12,33.3%,21m
8521,3,Bladewise,3395,30,1,1,2,50.0%,34m
8530,2,[LQV]GatzuPE,3394,1540,234,220,454,51.5%,8m
8530,3,Ace,3394,1170,58,44,102,56.9%,30m
8530,3,Goliath,3394,787,32,31,63,50.8%,20m
8530,3,Chris,3394,573,27,24,51,52.9%,23m
8530,2,TypicoTerran,3394,774,27,32,59,45.8%,41m
8530,3,[HighKo]TheBlank,3394,658,26,17,43,60.5%,33m
8530,2,Llowlit,3394,540,19,26,45,42.2%,22m
8530,3,superherode,3394,88,4,6,10,40.0%,42m
8530,3,Deemo,3394,30,2,2,4,50.0%,33m
8530,3,[Hym3n]HoldUp,3394,0,1,0,1,100.0%,11m
8530,3,[JDG]Silentstorm,3394,0,0,1,1,0.0%,14m
8541,3,Enoch,3393,1277,259,263,522,49.6%,14m
8541,2,[GOPERÚ]Josero,3393,1430,129,112,241,53.5%,34m
8541,3,Ambiguity,3393,566,65,64,129,50.4%,5m
8541,3,jrdnRabbit,3393,1508,58,55,113,51.3%,16m
8541,3,[xbS]SnowPea,3393,478,18,15,33,54.5%,18m
8541,2,Uruk,3393,450,17,19,36,47.2%,12m
8541,3,ZergRush,3393,417,15,12,27,55.6%,8m
8541,3,MrPotatoHead,3393,172,7,8,15,46.7%,14m
8541,3,[InqU]Sonsy,3393,60,3,5,8,37.5%,9m
8541,1,Cake,3393,139,2,2,4,50.0%,9m
8541,1,Borzinator,3393,0,1,4,5,20.0%,6m
8552,3,Carcarjou,3392,1529,95,87,182,52.2%,25m
8552,2,Superman,3392,1424,64,51,115,55.7%,19m
8552,3,IMBATMAN,3392,606,22,19,41,53.7%,19m
8552,3,[MxSC]Reaper,3392,476,18,15,33,54.5%,19m
8552,3,tombo,3392,356,12,18,30,40.0%,31m
8552,3,Sam,3392,172,6,8,14,42.9%,40m
8552,2,[DGP]Osukaru,3392,58,2,12,14,14.3%,31m
8552,1,patxi,3392,0,1,0,1,100.0%,1h
8552,3,NikuUdon,3392,0,0,1,1,0.0%,10m
8561,3,RonnickTC,3391,1330,148,129,277,53.4%,40m
8561,3,EUREKA,3391,1395,102,94,196,52.0%,18m
8561,2,HomerSub,3391,1169,94,82,176,53.4%,19m
8561,3,[Nut69]Ike,3391,847,65,51,116,56.0%,32m
8561,2,[0iq]ZlingPrinter,3391,1154,39,49,88,44.3%,25m
8561,2,CumBuble,3391,214,6,5,11,54.5%,10m
8561,3,Ubick,3391,118,4,7,11,36.4%,39m
8561,3,valkryie,3391,30,3,6,9,33.3%,25m
8561,1,Hisoka,3391,0,1,0,1,100.0%,3h
8561,3,lllllllIIII,3391,0,0,1,1,0.0%,16m
8571,3,[RuthLs]Caasis,3390,1100,42,42,84,50.0%,16m
8571,2,FURIOSA,3390,970,32,52,84,38.1%,24m
8571,3,Shockwave,3390,162,30,23,53,56.6%,40m
8571,3,[BoRnGo]Joeypow,3390,640,25,20,45,55.6%,37m
8571,3,raymadereck,3390,528,20,17,37,54.1%,33m
8571,1,BrutonGaster,3390,345,14,5,19,73.7%,9m
8571,3,Sphax,3390,350,13,17,30,43.3%,30m
8571,3,[FFAA]shinji,3390,184,12,9,21,57.1%,40m
8571,1,IAmNotAGamer,3390,97,5,1,6,83.3%,3h
8571,3,BigFungus,3390,30,5,1,6,83.3%,31m
8571,3,Bigbisoux,3390,142,5,4,9,55.6%,38m
8571,3,Crofty,3390,124,4,8,12,33.3%,7m
8571,3,[ValidG]MiroSlav,3390,124,4,10,14,28.6%,40m
8571,3,MunchyMan,3390,30,1,5,6,16.7%,3m
8571,3,Malaks,3390,0,0,1,1,0.0%,7m
8586,3,improvise,3389,1537,192,170,362,53.0%,41m
8586,3,Brittany,3389,1543,68,68,136,50.0%,19m
8586,3,[GRU]Heelion,3389,560,43,38,81,53.1%,41m
8586,3,[LFC]MamMoTH,3389,691,31,16,47,66.0%,14m
8586,3,NiNJa,3389,563,25,10,35,71.4%,13m
8586,1,FadaInDaUSA,3389,347,13,8,21,61.9%,23m
8586,3,[LCE]PartinG,3389,286,11,9,20,55.0%,21m
8586,3,[DarkAG]Somnium,3389,206,8,7,15,53.3%,16m
8586,2,[Wrekrs]Terror,3389,208,7,12,19,36.8%,36m
8586,3,[BFGs]BearWrastler,3389,90,4,5,9,44.4%,3m
8596,3,kOwzKing,3388,801,57,56,113,50.4%,23m
8596,3,[LDCO]PerroLoco,3388,1028,40,35,75,53.3%,7m
8596,2,[Lp]AlejandroMVP,3388,416,24,34,58,41.4%,42m
8596,3,Romsmasters,3388,460,18,16,34,52.9%,15m
8596,2,[SWAG88]Devotee,3388,180,16,19,35,45.7%,31m
8596,3,EDGE,3388,324,11,17,28,39.3%,29m
8596,3,NowPlaySmurf,3388,247,8,6,14,57.1%,23m
8596,1,Blitz,3388,142,7,7,14,50.0%,11m
8596,3,[VENSC2]FreeStyler,3388,144,5,10,15,33.3%,23m
8596,3,SixGuns,3388,0,2,1,3,66.7%,15m
8596,3,[OGbros]Amadeus,3388,131,2,4,6,33.3%,19m
8596,3,OnePunchMan,3388,0,1,4,5,20.0%,12m
8596,3,Draven,3388,0,0,1,1,0.0%,40m
8596,3,koper,3388,0,0,1,1,0.0%,26m
8596,3,[2TETON]JoggerHunter,3388,0,0,1,1,0.0%,12m
8611,3,trailerzs,3387,1647,286,229,515,55.5%,8m
8611,3,biiiiiiird,3387,1413,125,106,231,54.1%,35m
8611,2,BabyZerg,3387,1192,92,81,173,53.2%,22m
8611,2,ChBrM,3387,1615,81,81,162,50.0%,20m
8611,2,Derp,3387,1367,67,89,156,42.9%,43m
8611,3,ArEmKay,3387,1094,52,27,79,65.8%,8m
8611,3,Angel,3387,642,31,19,50,62.0%,8m
8611,3,[R3M]rokcdrigo,3387,537,23,5,28,82.1%,20m
8611,2,[500CC]Kaboel,3387,290,12,20,32,37.5%,41m
8611,3,MagicLi,3387,256,9,9,18,50.0%,23m
8611,3,lIlIlIlIlIlI,3387,149,6,4,10,60.0%,15m
8611,3,[KICT]Klondike,3387,120,4,6,10,40.0%,13m
8611,3,Konkual,3387,60,3,3,6,50.0%,41m
8611,3,abcd,3387,97,3,3,6,50.0%,41m
8611,3,Alive,3387,60,2,3,5,40.0%,41m
8611,3,Bluntbread,3387,30,2,6,8,25.0%,26m
8611,1,CaoCao,3387,0,1,0,1,100.0%,2h
8611,3,Chilakill,3387,30,1,1,2,50.0%,16m
8611,3,[Exa]Omnivalent,3387,0,1,3,4,25.0%,11m
8611,3,FosTA,3387,30,1,3,4,25.0%,29m
8611,3,YeastySmile,3387,0,0,1,1,0.0%,5m
8611,3,[NextDC]Sarasdrs,3387,0,0,2,2,0.0%,7m
8611,3,BoxeR,3387,0,0,5,5,0.0%,3m
8634,2,WagonWheel,3386,1591,427,428,855,49.9%,38m
8634,3,[NPhasA]RagingPeru,3386,1523,190,181,371,51.2%,41m
8634,3,[FCF]EBITDA,3386,1542,147,143,290,50.7%,15m
8634,3,snoisiv,3386,702,56,51,107,52.3%,15m
8634,3,look,3386,1146,47,40,87,54.0%,4m
8634,3,Riesenlurch,3386,885,46,17,63,73.0%,22m
8634,3,flOn,3386,1036,43,30,73,58.9%,20m
8634,3,[TSKOS]MIKEHR,3386,468,34,28,62,54.8%,14m
8634,3,chelsea,3386,325,25,31,56,44.6%,5m
8634,2,IIIIIIIIIIII,3386,580,24,30,54,44.4%,34m
8634,3,Eitchen,3386,240,14,10,24,58.3%,15m
8634,3,Pacific,3386,312,11,11,22,50.0%,5m
8634,3,LazyGuyIIIII,3386,86,4,3,7,57.1%,32m
8634,1,BeautyAnd,3386,46,2,0,2,100.0%,33m
8634,3,SpaceDog,3386,30,2,2,4,50.0%,16m
8634,3,ThiccScV,3386,30,2,3,5,40.0%,29m
8634,3,[KofW]TheSandman,3386,60,2,5,7,28.6%,36m
8634,3,[WINDD]slyTiger,3386,0,1,1,2,50.0%,12m
8634,3,shublox,3386,0,0,1,1,0.0%,7m
8634,3,[ExBl]Urahara,3386,0,0,2,2,0.0%,23m
8634,3,[TSØP]Darkill,3386,0,0,2,2,0.0%,33m
8655,2,Itzakaya,3385,1590,250,245,495,50.5%,42m
8655,2,[CCinc]QuantuM,3385,1529,147,156,303,48.5%,34m
8655,2,RogueHunter,3385,1313,96,111,207,46.4%,28m
8655,3,Circular,3385,1006,83,68,151,55.0%,36m
8655,2,Jesibet,3385,859,78,78,156,50.0%,14m
8655,3,Runtime,3385,1165,64,50,114,56.1%,8m
8655,2,mint,3385,1432,60,71,131,45.8%,34m
8655,2,Notorious,3385,290,13,13,26,50.0%,42m
8655,1,PoonZ,3385,204,10,5,15,66.7%,41m
8655,3,foxdoc,3385,142,6,6,12,50.0%,5m
8655,3,Ghast,3385,114,4,4,8,50.0%,15m
8655,3,[KGC]slyp,3385,119,3,0,3,100.0%,23m
8655,3,[Dchk]Kestal,3385,30,2,0,2,100.0%,4m
8655,3,[3g0]ChlnO,3385,0,1,0,1,100.0%,20m
8655,1,Savicious,3385,0,1,0,1,100.0%,41m
8655,3,[xGGNx]BrooDLørD,3385,0,0,1,1,0.0%,13m
8655,3,ObamaDaCuck,3385,0,0,1,1,0.0%,6m
8655,3,Davis,3385,0,0,2,2,0.0%,5m
8673,3,Zero,3384,1527,402,362,764,52.6%,24m
8673,2,[REALG4]Spawn,3384,1526,205,199,404,50.7%,22m
8673,2,[NLTN]BRADI,3384,1032,127,116,243,52.3%,15m
8673,2,forotdds,3384,1586,73,80,153,47.7%,4m
8673,3,[SCxPH]DLSMIZEL,3384,1408,72,75,147,49.0%,29m
8673,3,zurita,3384,501,22,17,39,56.4%,18m
8673,3,[CUMING]maxwelljones,3384,460,16,17,33,48.5%,19m
8673,3,SheepHappens,3384,266,8,11,19,42.1%,32m
8673,3,OogelyBoogly,3384,95,5,2,7,71.4%,11m
8673,3,Castplay,3384,0,0,1,1,0.0%,14m
8673,3,jedi,3384,0,0,6,6,0.0%,5m
8684,3,Chody,3383,1631,521,511,1032,50.5%,31m
8684,3,noflo,3383,1567,248,240,488,50.8%,29m
8684,3,RED,3383,1636,136,80,216,63.0%,30m
8684,3,[LCE]GaToo,3383,1557,70,70,140,50.0%,26m
8684,3,ZacKass,3383,556,20,23,43,46.5%,36m
8684,3,usucha,3383,0,5,1,6,83.3%,12m
8684,3,SleepyJoe,3383,0,0,2,2,0.0%,27m
8684,3,Twon,3383,0,0,3,3,0.0%,32m
8692,3,jerrymouse,3382,1572,90,83,173,52.0%,6m
8692,2,[PhxAge]FatmaN,3382,1298,70,81,151,46.4%,24m
8692,3,Pexavi,3382,1400,60,47,107,56.1%,7m
8692,3,Zeya,3382,730,60,61,121,49.6%,34m
8692,3,KTCU,3382,1019,42,31,73,57.5%,40m
8692,2,Dmutri,3382,283,35,34,69,50.7%,24m
8692,3,MLP,3382,270,16,18,34,47.1%,39m
8692,2,[CTsix]shpooom,3382,390,12,26,38,31.6%,41m
8692,2,JohnMayer,3382,192,9,5,14,64.3%,22m
8692,3,NoEffort,3382,86,7,2,9,77.8%,40m
8692,3,Luru,3382,116,5,2,7,71.4%,40m
8692,3,RyboRage,3382,142,5,3,8,62.5%,38m
8692,3,[Nerdz]Swift,3382,30,2,0,2,100.0%,27m
8692,3,Rage,3382,58,2,3,5,40.0%,13m
8692,3,[Year06]Crime,3382,0,1,0,1,100.0%,20m
8692,3,[eXtra1]RogueSniper,3382,30,1,1,2,50.0%,41m
8692,3,bigsmoke,3382,0,1,1,2,50.0%,30m
8692,3,Hizzay,3382,30,1,1,2,50.0%,25m
8692,3,Osau,3382,30,1,3,4,25.0%,36m
8711,3,Altair,3381,1587,694,692,1386,50.1%,35m
8711,2,loupenical,3381,1602,217,212,429,50.6%,28m
8711,3,FGMxD,3381,1547,130,112,242,53.7%,22m
8711,2,omgwtfbbq,3381,1371,124,126,250,49.6%,22m
8711,3,ReverendPete,3381,1604,103,101,204,50.5%,33m
8711,2,ShookNCooked,3381,637,77,75,152,50.7%,24m
8711,3,Maru,3381,1084,42,40,82,51.2%,23m
8711,3,OpticParadox,3381,497,38,27,65,58.5%,41m
8711,2,Virus,3381,973,38,53,91,41.8%,17m
8711,3,Kilana,3381,652,30,22,52,57.7%,37m
8711,3,[αXLa]Faesbuca,3381,628,25,17,42,59.5%,31m
8711,2,Care,3381,605,23,22,45,51.1%,32m
8711,3,Cotab,3381,517,22,18,40,55.0%,28m
8711,3,MikuOkazaki,3381,456,19,11,30,63.3%,11m
8711,3,Mango,3381,260,13,10,23,56.5%,25m
8711,3,FiveGnetwork,3381,270,12,11,23,52.2%,19m
8711,3,IIIIIIIIIIII,3381,202,11,5,16,68.8%,30m
8711,3,[JJPOOR]Noctis,3381,252,10,7,17,58.8%,4m
8711,3,[EzyPzY]TopRahman,3381,203,6,5,11,54.5%,7m
8711,3,Terran,3381,86,4,1,5,80.0%,38m
8711,3,[TGosuB]SimplePickUp,3381,90,4,3,7,57.1%,25m
8711,3,Sidelines,3381,60,3,4,7,42.9%,4m
8711,3,ShinRufus,3381,0,1,0,1,100.0%,5m
8711,3,[1Cat1]StingrayVoid,3381,30,1,1,2,50.0%,13m
8711,3,[StrTrk]Brobocop,3381,0,0,1,1,0.0%,27m
8711,3,[MiMsc2]pheenoMiC,3381,0,0,1,1,0.0%,17m
8711,3,[Atone]Eboelachan,3381,0,0,1,1,0.0%,5m
8738,3,kneeces,3380,1624,180,176,356,50.6%,22m
8738,3,CharlyKing,3380,842,36,36,72,50.0%,40m
8738,3,Tayyy,3380,386,16,11,27,59.3%,5m
8738,3,[CatRG]Harambe,3380,388,16,13,29,55.2%,19m
8738,3,FeedWhy,3380,304,12,8,20,60.0%,37m
8738,3,fanaticoxd,3380,118,4,4,8,50.0%,15m
8738,3,[143s4]RKL,3380,119,2,2,4,50.0%,16m
8738,3,[POOiP]DarkArchon,3380,0,1,0,1,100.0%,12m
8738,3,Digger,3380,0,1,0,1,100.0%,29m
8738,3,Diamefbaal,3380,0,1,1,2,50.0%,27m
8738,3,DonMClean,3380,0,1,1,2,50.0%,20m
8738,3,rumokay,3380,30,1,1,2,50.0%,4m
8738,3,[UFC]KrazyDago,3380,0,0,1,1,0.0%,40m
8751,3,PrivateRyan,3379,392,73,52,125,58.4%,11m
8751,2,[UpeV]JACO,3379,914,32,41,73,43.8%,20m
8751,3,dldkfma,3379,314,15,10,25,60.0%,8m
8751,3,[INextI]Ozzy,3379,0,1,0,1,100.0%,20m
8751,3,elPapuGomez,3379,0,1,0,1,100.0%,34m
8751,3,Trogdor,3379,30,1,3,4,25.0%,26m
8751,3,[SCVM]NoblePhoenix,3379,0,0,1,1,0.0%,4m
8751,1,[KingSC]roma,3379,0,0,5,5,0.0%,7m
8759,3,[HBNC]VenomVirus,3378,1424,216,208,424,50.9%,40m
8759,3,[GØSU]Illivanilli,3378,1617,172,152,324,53.1%,27m
8759,3,GuRa,3378,1375,96,86,182,52.7%,42m
8759,2,matsuyamaMN,3378,398,70,69,139,50.4%,6m
8759,3,Sirrus,3378,1101,55,54,109,50.5%,30m
8759,3,homestuck,3378,310,11,14,25,44.0%,22m
8759,3,BustOnYou,3378,198,8,5,13,61.5%,5m
8759,2,BlkLiesMatta,3378,141,7,3,10,70.0%,26m
8759,3,[LgnTDS]Elegacy,3378,168,4,4,8,50.0%,26m
8759,3,TRUMP,3378,0,0,3,3,0.0%,29m
8769,2,Hiholic,3377,1158,93,86,179,52.0%,3m
8769,2,[AFM]Spootie,3377,1002,47,41,88,53.4%,24m
8769,3,[IpTime]DestinyCake,3377,833,46,6,52,88.5%,30m
8769,3,Artos,3377,582,23,19,42,54.8%,23m
8769,3,[ScSwrm]hunter,3377,430,17,10,27,63.0%,22m
8769,3,Effervescent,3377,342,15,8,23,65.2%,21m
8769,1,Shasta,3377,249,12,8,20,60.0%,23m
8769,3,nevanotag,3377,350,11,20,31,35.5%,29m
8769,3,Mousline,3377,207,5,13,18,27.8%,33m
8769,2,cabris,3377,44,1,1,2,50.0%,26m
8769,3,[dLife]Anomie,3377,30,1,2,3,33.3%,29m
8769,3,[ZTemp]BombSquad,3377,0,1,3,4,25.0%,36m
8769,3,RedNovember,3377,30,1,6,7,14.3%,36m
8769,3,Hyungunn,3377,0,0,2,2,0.0%,3m
8783,2,[lSDLGl]LMENTRIX,3376,1078,68,78,146,46.6%,20m
8783,3,SuperSloth,3376,214,10,8,18,55.6%,23m
8783,2,HarlemTron,3376,202,9,4,13,69.2%,6m
8783,3,[SuperZ]ChuckNorris,3376,222,8,5,13,61.5%,12m
8783,2,MrBigshot,3376,208,7,17,24,29.2%,2m
8783,1,IIlIlIIIllll,3376,97,6,0,6,100.0%,41m
8783,3,Jim,3376,0,1,0,1,100.0%,37m
8783,1,Revolverlady,3376,0,1,0,1,100.0%,16m
8783,3,[JPN51]MsT,3376,30,1,4,5,20.0%,37m
8783,2,[Xpk]LimeLight,3376,0,0,2,2,0.0%,38m
8783,3,SirHood,3376,0,0,2,2,0.0%,31m
8794,2,Mercy,3375,1465,120,129,249,48.2%,24m
8794,2,Airframer,3375,1509,98,97,195,50.3%,34m
8794,2,RICE,3375,1438,93,85,178,52.2%,22m
8794,3,[Exitus]Miro,3375,975,63,60,123,51.2%,23m
8794,3,Fam,3375,1359,62,56,118,52.5%,18m
8794,3,BarrackOhana,3375,987,37,39,76,48.7%,34m
8794,3,[WonHog]Star,3375,490,22,14,36,61.1%,8m
8794,3,BlackCan,3375,254,10,9,19,52.6%,21m
8794,3,[NeAs]exeKiAz,3375,226,9,10,19,47.4%,25m
8794,1,RickSanchez,3375,0,4,1,5,80.0%,1h
8794,3,[nubPWR]SlubberScrub,3375,0,3,2,5,60.0%,41m
8794,3,shut,3375,88,3,6,9,33.3%,38m
8794,3,TheRinger,3375,58,3,6,9,33.3%,19m
8794,3,Burrito,3375,78,2,4,6,33.3%,18m
8794,3,[xMQx]NightWolf,3375,62,2,10,12,16.7%,29m
8794,3,[GRIMEY]Raycon,3375,0,1,0,1,100.0%,4m
8794,2,Takra,3375,0,1,0,1,100.0%,26m
8794,3,[r4mp4g]RamJam,3375,30,1,3,4,25.0%,8m
8794,1,Destroyer,3375,0,0,1,1,0.0%,42m
8813,3,Eyeoh,3374,1371,69,59,128,53.9%,15m
8813,3,[ValidG]Seizmik,3374,829,54,50,104,51.9%,7m
8813,3,ØnGØ,3374,963,43,37,80,53.8%,3m
8813,2,CalMeEzekiel,3374,258,35,30,65,53.8%,38m
8813,2,[EØ]TucanMistico,3374,554,20,29,49,40.8%,28m
8813,3,[UoM]Tortle,3374,458,19,6,25,76.0%,40m
8813,3,[ZC]Legacy,3374,275,11,16,27,40.7%,34m
8813,3,simsimma,3374,228,9,7,16,56.2%,3m
8813,1,Vlixes,3374,190,5,14,19,26.3%,3m
8813,3,Emu,3374,0,1,3,4,25.0%,6m
8813,3,[cl0udM]isthisfun,3374,0,0,1,1,0.0%,16m
8813,3,Pingu,3374,0,0,6,6,0.0%,26m
8825,3,[AD3C]Osangri,3373,1608,162,151,313,51.8%,35m
8825,3,[BONES]Teeks,3373,1540,104,103,207,50.2%,30m
8825,3,bQscbQsc,3373,1547,102,100,202,50.5%,30m
8825,3,[Xpk]RaulCarpio,3373,1542,94,85,179,52.5%,40m
8825,2,GenKenobi,3373,981,83,84,167,49.7%,28m
8825,3,[C2G]TheMule,3373,1217,53,38,91,58.2%,4m
8825,3,pog,3373,385,17,11,28,60.7%,4m
8825,3,Smokenham,3373,260,12,11,23,52.2%,40m
8825,3,Grogu,3373,58,7,3,10,70.0%,22m
8825,3,[emcdos]Soul,3373,140,5,3,8,62.5%,35m
8825,3,Arisa,3373,116,4,4,8,50.0%,40m
8825,3,JMG,3373,110,3,1,4,75.0%,25m
8825,3,Narwal,3373,90,3,4,7,42.9%,35m
8825,1,Clydefrog,3373,94,2,3,5,40.0%,26m
8825,3,Tsun,3373,0,0,1,1,0.0%,22m
8825,3,Tok,3373,0,0,1,1,0.0%,25m
8841,3,Whipper,3372,1250,67,66,133,50.4%,30m
8841,3,[PLASM]LavaFlow,3372,404,17,23,40,42.5%,14m
8841,3,[GdAT]Zod,3372,116,4,9,13,30.8%,29m
8841,3,Slurp,3372,54,3,3,6,50.0%,14m
8841,3,[TeamUR]Kamarill,3372,92,3,12,15,20.0%,3m
8841,1,Relentless,3372,48,2,5,7,28.6%,3h
8841,3,TIMPOY,3372,0,1,4,5,20.0%,5m
8841,3,AjtOsS,3372,0,0,2,2,0.0%,14m
8849,3,[uGG]czapre,3371,1451,142,140,282,50.4%,5m
8849,2,BabyFreeze,3371,1486,99,115,214,46.3%,17m
8849,3,Scrooge,3371,938,66,56,122,54.1%,25m
8849,2,[TGCF]BlindSide,3371,1044,36,48,84,42.9%,42m
8849,3,gooseduck,3371,674,23,28,51,45.1%,30m
8849,3,omgitsduane,3371,334,12,9,21,57.1%,37m
8849,3,StaTe,3371,166,7,1,8,87.5%,12m
8849,3,Gavibear,3371,30,6,0,6,100.0%,41m
8849,3,[AbcCo]McLovin,3371,148,6,3,9,66.7%,18m
8849,3,TSMCoffeeBoy,3371,223,6,8,14,42.9%,30m
8849,3,[BGOK]JUSTICE,3371,0,3,2,5,60.0%,40m
8849,1,Nanaki,3371,97,3,3,6,50.0%,43m
8849,3,SmashBoomPow,3371,0,2,5,7,28.6%,35m
8849,3,[LDCO]COLD,3371,116,2,5,7,28.6%,22m
8849,3,Poisonpez,3371,30,1,6,7,14.3%,33m
8849,3,SodaMachine,3371,0,0,1,1,0.0%,4m
8849,3,YingXiong,3371,0,0,2,2,0.0%,19m
8866,3,MattDeitz,3370,1553,273,265,538,50.7%,34m
8866,3,MasterFree,3370,1562,94,89,183,51.4%,16m
8866,3,BudgetSteak,3370,1517,90,89,179,50.3%,3m
8866,3,MrWhiskers,3370,980,70,64,134,52.2%,19m
8866,3,xXDERECKXx,3370,828,49,1,50,98.0%,38m
8866,3,[NABG]ConVersion,3370,516,22,15,37,59.5%,38m
8866,3,CheeseCake,3370,534,22,16,38,57.9%,4m
8866,3,[AiMB]fiziokrat,3370,408,14,14,28,50.0%,23m
8866,3,llllllllllll,3370,236,13,8,21,61.9%,32m
8866,3,[Lp]Larso,3370,182,10,14,24,41.7%,4m
8866,3,[EZDUNK]Paradox,3370,234,9,9,18,50.0%,4m
8866,3,[NrFms]LingLeadeR,3370,142,5,6,11,45.5%,5m
8866,3,Xenomorph,3370,152,5,8,13,38.5%,21m
8866,3,UncommonN,3370,0,4,3,7,57.1%,25m
8866,2,gurbler,3370,0,4,4,8,50.0%,18m
8866,3,jex,3370,60,3,4,7,42.9%,14m
8866,3,MillerLEE,3370,30,2,1,3,66.7%,10m
8866,3,[LNRZ]TheBear,3370,0,0,1,1,0.0%,13m
8866,3,[1AMOVE]Clinch,3370,0,0,3,3,0.0%,30m
8885,3,Asembler,3369,1103,170,164,334,50.9%,25m
8885,3,Uriel,3369,821,46,31,77,59.7%,31m
8885,3,[DhZAc1]xUPx,3369,982,41,27,68,60.3%,5m
8885,3,[AtoSis]Ependyma,3369,592,31,19,50,62.0%,16m
8885,3,[TGosuD]Beammeup,3369,684,29,20,49,59.2%,5m
8885,3,[DRGNS]Damogron,3369,726,26,29,55,47.3%,21m
8885,3,[Exper]Newton,3369,580,23,20,43,53.5%,34m
8885,3,GuardeMarine,3369,262,9,12,21,42.9%,13m
8885,3,terrannoob,3369,86,7,3,10,70.0%,11m
8885,3,Keepo,3369,0,5,0,5,100.0%,38m
8885,3,[xLgNx]Frug,3369,30,2,0,2,100.0%,3m
8885,3,TrooperZzz,3369,60,2,5,7,28.6%,3m
8885,3,AssDestroyer,3369,0,1,0,1,100.0%,40m
8885,3,Rise,3369,30,1,1,2,50.0%,5m
8885,3,MiniAussie,3369,0,0,1,1,0.0%,19m
8885,3,[EtrOy]Raku,3369,0,0,2,2,0.0%,11m
8901,3,Halleluwah,3368,1610,100,99,199,50.3%,27m
8901,2,Andy,3368,1227,53,51,104,51.0%,2m
8901,3,Ender,3368,270,45,45,90,50.0%,11m
8901,3,[HEWITT]ChrisJudd,3368,826,33,23,56,58.9%,40m
8901,2,[LIR]TheSergeant,3368,400,13,25,38,34.2%,24m
8901,3,IIIIIIIIIIII,3368,88,7,3,10,70.0%,4m
8901,3,Emperor,3368,58,3,0,3,100.0%,4m
8901,3,[BaIIz]almightyalf,3368,0,3,2,5,60.0%,40m
8901,3,[TNT4U]NoLivesMater,3368,58,2,2,4,50.0%,40m
8901,3,[WeX]KueTep,3368,60,2,3,5,40.0%,13m
8901,3,TANIOS,3368,0,1,0,1,100.0%,37m
8901,1,purdy,3368,94,1,1,2,50.0%,31m
8913,2,TBSS,3367,1538,300,302,602,49.8%,32m
8913,2,irogrom,3367,1593,295,292,587,50.3%,14m
8913,3,Dyslexia,3367,954,48,24,72,66.7%,4m
8913,3,chakapipo,3367,494,19,15,34,55.9%,21m
8913,3,MacroGG,3367,387,18,6,24,75.0%,8m
8913,3,Tentative,3367,258,16,25,41,39.0%,26m
8913,3,FaZer,3367,382,15,12,27,55.6%,40m
8913,3,[INCARD]BigRat,3367,409,14,18,32,43.8%,33m
8913,3,[zeez]Justinian,3367,304,11,10,21,52.4%,14m
8913,3,BigDiggaNick,3367,30,5,1,6,83.3%,38m
8913,3,[Walls]Deathlisk,3367,86,4,1,5,80.0%,22m
8913,3,Apple,3367,58,4,3,7,57.1%,19m
8913,3,eAzyRageQuit,3367,0,3,2,5,60.0%,29m
8913,2,TimoCore,3367,87,3,2,5,60.0%,42m
8913,1,[izHere]AJax,3367,0,2,2,4,50.0%,3h
8913,3,[KHAN]MysticalPlex,3367,0,0,1,1,0.0%,25m
8913,3,Ohmie,3367,0,0,1,1,0.0%,26m
8913,3,[Nek0es]Azure,3367,0,0,1,1,0.0%,22m
8931,3,NTA,3366,1551,106,95,201,52.7%,11m
8931,2,[DATTE]Papi,3366,1141,65,83,148,43.9%,32m
8931,3,Sushi,3366,446,20,17,37,54.1%,29m
8931,3,onemarine,3366,299,10,11,21,47.6%,37m
8931,3,[HECKS]DogDog,3366,224,7,7,14,50.0%,37m
8931,3,Nick,3366,74,3,2,5,60.0%,5m
8931,3,GambleFIsh,3366,0,1,0,1,100.0%,8m
8931,3,[EKQUO]Alu,3366,0,1,3,4,25.0%,5m
8939,3,ukiya,3365,1506,93,89,182,51.1%,30m
8939,3,Skarpi,3365,1635,86,82,168,51.2%,11m
8939,2,RushInLight,3365,1272,65,74,139,46.8%,33m
8939,3,[KingSC]CHAPAS,3365,911,39,43,82,47.6%,41m
8939,3,SiRe,3365,901,37,28,65,56.9%,19m
8939,3,[NSD]slapshotttt,3365,294,22,24,46,47.8%,41m
8939,2,[Garka]DuRaN,3365,412,21,22,43,48.8%,33m
8939,3,frank,3365,284,11,12,23,47.8%,13m
8939,3,Dove,3365,143,7,3,10,70.0%,4m
8939,1,Ragnorak,3365,230,6,6,12,50.0%,36m
8939,2,[INextI]Itzcoatl,3365,192,6,13,19,31.6%,33m
8939,3,Hemocles,3365,191,5,2,7,71.4%,27m
8939,3,[4GATES]Attzy,3365,126,5,12,17,29.4%,4m
8939,3,IlIlIlIlIlIl,3365,86,4,2,6,66.7%,9m
8939,3,[Efflux]ryann,3365,92,3,9,12,25.0%,19m
8939,3,Nightmare,3365,92,3,12,15,20.0%,12m
8939,3,papiPolt,3365,30,2,4,6,33.3%,20m
8939,3,[JSH]LactationMac,3365,30,2,6,8,25.0%,7m
8939,3,[Chaell]Rigido,3365,0,1,0,1,100.0%,23m
8939,3,[xVIPx]NECROFVCK,3365,0,0,1,1,0.0%,38m
8939,2,Murti,3365,0,0,1,1,0.0%,11m
8939,3,Nahnix,3365,0,0,3,3,0.0%,25m
8961,3,[PC0512]aCe,3364,1598,563,538,1101,51.1%,42m
8961,3,JoeBar,3364,463,19,6,25,76.0%,43m
8961,3,Agent,3364,378,16,10,26,61.5%,23m
8961,1,GispyDanger,3364,253,11,6,17,64.7%,8m
8961,3,pboyle,3364,254,10,10,20,50.0%,37m
8961,3,[TushAn]SooVation,3364,222,8,9,17,47.1%,23m
8961,3,IllIIIllllll,3364,162,7,9,16,43.8%,31m
8961,3,HoneyBadger,3364,148,6,9,15,40.0%,20m
8961,3,ggTOP,3364,114,5,5,10,50.0%,32m
8961,3,[FORCE9]Rhazz,3364,30,2,1,3,66.7%,8m
8961,3,[DVINCI]Magic,3364,0,1,0,1,100.0%,28m
8961,2,TrueSouth,3364,0,1,7,8,12.5%,15m
8961,3,Mintt,3364,0,0,1,1,0.0%,16m
8974,2,Taknam,3363,738,206,199,405,50.9%,37m
8974,3,[GOPERÚ]BellCranel,3363,1637,123,111,234,52.6%,24m
8974,3,EnolaGay,3363,1606,76,54,130,58.5%,9m
8974,3,Degnoob,3363,422,34,24,58,58.6%,3m
8974,3,zforce,3363,206,22,25,47,46.8%,4m
8974,3,[VSI]ACL,3363,127,11,17,28,39.3%,37m
8974,2,[WuTang]KMA,3363,204,6,12,18,33.3%,18m
8974,1,Algeroth,3363,48,2,0,2,100.0%,16m
8974,3,daniel,3363,30,2,0,2,100.0%,11m
8974,3,Robtek,3363,0,1,1,2,50.0%,19m
8984,2,felixwang,3362,1055,278,260,538,51.7%,43m
8984,2,Aptenodytes,3362,1537,208,201,409,50.9%,18m
8984,3,[AD3C]Legola,3362,1508,163,163,326,50.0%,18m
8984,2,Soul,3362,1311,113,107,220,51.4%,20m
8984,2,[No0Bs]FluffyZling,3362,1508,88,98,186,47.3%,22m
8984,2,[YD2K]Strykerr,3362,528,62,78,140,44.3%,24m
8984,3,LINTLICKER,3362,531,21,11,32,65.6%,18m
8984,3,[SuperZ]LetsGetSilly,3362,466,18,15,33,54.5%,3m
8984,3,[xLgNx]SilentGhostt,3362,398,16,11,27,59.3%,4m
8984,3,elcom,3362,223,7,7,14,50.0%,31m
8984,3,MMX,3362,204,7,9,16,43.8%,21m
8984,3,[iBorg]ZapBraniBorg,3362,30,2,2,4,50.0%,12m
8996,2,[TGosuA]Rolch,3361,1447,280,280,560,50.0%,19m
8996,3,IPLObserver,3361,426,18,13,31,58.1%,16m
8996,3,Tyrael,3361,86,7,3,10,70.0%,9m
8996,3,DrunkMaru,3361,140,6,2,8,75.0%,29m
8996,3,Unclenoob,3361,0,0,1,1,0.0%,10m
8996,3,[LNRZ]StarBuck,3361,0,0,1,1,0.0%,10m
9002,2,Bortolotto,3360,1444,220,222,442,49.8%,24m
9002,3,Tiki,3360,1442,142,122,264,53.8%,13m
9002,3,[EtrOy]dougt,3360,1336,88,85,173,50.9%,18m
9002,3,yeeezy,3360,1249,56,49,105,53.3%,5m
9002,3,[SsaYn2]DyNaSTY,3360,140,8,3,11,72.7%,20m
9002,3,MMMMM,3360,210,7,16,23,30.4%,14m
9002,3,Ancientz,3360,152,6,8,14,42.9%,26m
9002,3,[425]TRxArce,3360,30,2,2,4,50.0%,11m
9010,3,Elzizel,3359,1573,448,432,880,50.9%,39m
9010,2,MathMan,3359,1471,164,167,331,49.5%,34m
9010,3,PROTOSSLORD,3359,1621,108,83,191,56.5%,22m
9010,2,[EtrOy]Shiva,3359,1472,92,95,187,49.2%,4m
9010,3,[EndPro]YeIBoRG,3359,599,61,62,123,49.6%,38m
9010,3,[FxB]Delicious,3359,1197,59,62,121,48.8%,8m
9010,3,pillowpants,3359,488,17,23,40,42.5%,29m
9010,3,[NPhasA]roboEarth,3359,377,16,16,32,50.0%,11m
9010,3,BLackCat,3359,285,13,7,20,65.0%,17m
9010,2,hollabrrack,3359,274,9,4,13,69.2%,36m
9010,2,Dylluna,3359,310,9,16,25,36.0%,22m
9010,3,[IAMI]Asurmen,3359,200,7,4,11,63.6%,25m
9010,2,Whistpoo,3359,198,5,7,12,41.7%,6m
9010,3,rainbowspace,3359,58,2,1,3,66.7%,5m
9010,3,[MaxraX]Banchan,3359,30,1,1,2,50.0%,15m
9010,3,reckoner,3359,30,1,3,4,25.0%,23m
9010,3,TCNero,3359,0,0,1,1,0.0%,14m
9010,3,Bartomeu,3359,0,0,1,1,0.0%,40m
9010,3,Shortandfat,3359,0,0,1,1,0.0%,14m
9029,3,deeerrrp,3358,1561,530,516,1046,50.7%,37m
9029,3,YogurtBeing,3358,1394,63,53,116,54.3%,35m
9029,3,[GetThm]Ample,3358,650,42,29,71,59.2%,20m
9029,2,blackship,3358,503,26,41,67,38.8%,27m
9029,1,pocker,3358,338,9,34,43,20.9%,28m
9029,3,REDEFINEDD,3358,170,6,11,17,35.3%,5m
9029,3,snoop,3358,30,5,1,6,83.3%,42m
9029,1,Frijolero,3358,0,2,3,5,40.0%,21m
9037,3,[D3LUX3]HOSTILITY,3357,1644,352,348,700,50.3%,26m
9037,3,[FUC3]MorelShroom,3357,545,24,17,41,58.5%,23m
9037,3,[NPhasA]TTTGGG,3357,658,24,26,50,48.0%,22m
9037,2,Glunch,3357,350,22,29,51,43.1%,26m
9037,3,sparkster,3357,455,19,13,32,59.4%,12m
9037,3,[EscaDa]lIIlIlIIIllI,3357,127,10,7,17,58.8%,11m
9037,3,[MAAGIC]Petrel,3357,0,2,4,6,33.3%,25m
9037,2,ohnogg,3357,0,1,2,3,33.3%,17m
9037,3,[BALAUR]Korlay,3357,0,0,1,1,0.0%,24m
9037,3,Ograf,3357,0,0,2,2,0.0%,14m
9047,3,[M1A5]MadHatter,3356,1475,243,236,479,50.7%,34m
9047,3,metaltaco,3356,999,51,45,96,53.1%,12m
9047,3,GareBear,3356,928,35,38,73,47.9%,27m
9047,3,[GGHGGH]rVvLTr,3356,328,33,30,63,52.4%,34m
9047,3,jen,3356,387,17,12,29,58.6%,37m
9047,2,essnov,3356,396,15,19,34,44.1%,24m
9047,3,barcode,3356,218,8,6,14,57.1%,28m
9047,3,BoB,3356,166,8,6,14,57.1%,15m
9047,3,SlurpMe,3356,58,5,2,7,71.4%,18m
9047,2,Lifeless,3356,153,4,3,7,57.1%,34m
9047,3,Slipils,3356,0,1,2,3,33.3%,25m
9047,3,llllllllllll,3356,97,1,4,5,20.0%,5m
9047,3,mjs,3356,30,1,9,10,10.0%,33m
9047,3,IIlIIlIIIl,3356,0,0,1,1,0.0%,33m
9047,3,[TFEC]adept,3356,0,0,3,3,0.0%,7m
9062,2,[Hyrule]TAPION,3355,1112,175,180,355,49.3%,19m
9062,2,poums,3355,1331,70,63,133,52.6%,25m
9062,3,[AMDpow]KillerGT,3355,712,29,23,52,55.8%,28m
9062,3,porkythepig,3355,612,25,25,50,50.0%,26m
9062,3,influenced,3355,455,20,10,30,66.7%,14m
9062,3,[Thee1]LtDAmN,3355,30,1,2,3,33.3%,27m
9062,3,[SWAT]Valderakz,3355,0,0,1,1,0.0%,16m
9069,3,TempestMaker,3354,1001,237,225,462,51.3%,30m
9069,3,SGZZZ,3354,1635,119,96,215,55.3%,16m
9069,3,ERICISABROAD,3354,1276,106,90,196,54.1%,13m
9069,3,tInyHMAN,3354,672,27,27,54,50.0%,16m
9069,3,Firevillager,3354,208,18,7,25,72.0%,34m
9069,3,[OIGE]LaccSteve,3354,0,0,1,1,0.0%,16m
9069,3,xericparkx,3354,0,0,1,1,0.0%,13m
9076,3,ZeratulZule,3353,1572,98,84,182,53.8%,36m
9076,3,[theBSL]Lincredible,3353,765,97,101,198,49.0%,23m
9076,3,Vroom,3353,702,32,20,52,61.5%,37m
9076,3,Kav,3353,455,28,24,52,53.8%,31m
9076,3,MrMotes,3353,456,18,14,32,56.2%,37m
9076,2,[SuperZ]HAL,3353,484,18,21,39,46.2%,23m
9076,3,StrangeGuy,3353,250,9,9,18,50.0%,18m
9076,3,XaresEU,3353,60,6,3,9,66.7%,25m
9076,3,joelsleftbal,3353,58,2,3,5,40.0%,22m
9076,3,WannaBeRuFF,3353,30,2,4,6,33.3%,40m
9076,3,Hemocles,3353,0,1,0,1,100.0%,40m
9076,1,killadona,3353,0,1,4,5,20.0%,2h
9076,3,[ICLD]Evan,3353,0,0,2,2,0.0%,19m
9089,3,Juanma,3352,1561,247,233,480,51.5%,37m
9089,3,joon,3352,1550,142,125,267,53.2%,15m
9089,2,Pintosaur,3352,525,83,83,166,50.0%,30m
9089,3,ISNspelljack,3352,1212,49,38,87,56.3%,10m
9089,3,Zekiah,3352,1034,45,35,80,56.2%,4m
9089,3,[NPhasA]Sketch,3352,402,15,14,29,51.7%,25m
9089,3,TKingDragon,3352,338,14,13,27,51.9%,12m
9089,3,Targetdummy,3352,278,10,15,25,40.0%,31m
9089,3,[NYAAAA]PandaPrime,3352,174,7,10,17,41.2%,7m
9089,3,Hiyori,3352,44,3,6,9,33.3%,18m
9089,3,[RUMB]Frog,3352,30,2,1,3,66.7%,43m
9089,3,HanZolo,3352,0,0,1,1,0.0%,12m
9089,3,NovaCaine,3352,0,0,1,1,0.0%,16m
9089,3,[WTR]Gerrard,3352,0,0,4,4,0.0%,19m
9103,2,PierO,3351,1483,95,99,194,49.0%,7m
9103,3,[GGKz]BenstAA,3351,831,58,40,98,59.2%,33m
9103,3,Mageban,3351,881,37,28,65,56.9%,25m
9103,3,Pokka,3351,937,36,43,79,45.6%,39m
9103,3,TheOtherOne,3351,461,21,10,31,67.7%,42m
9103,2,Ancalagon,3351,158,8,9,17,47.1%,23m
9103,1,SuperTux,3351,117,6,1,7,85.7%,1h
9103,3,Ghost,3351,116,5,3,8,62.5%,3m
9103,3,Mustybucket,3351,120,5,7,12,41.7%,40m
9103,3,PapaMisty,3351,30,2,0,2,100.0%,29m
9103,1,[PPAP]SmartSputnik,3351,97,2,1,3,66.7%,3h
9103,3,Sun,3351,58,2,2,4,50.0%,4m
9103,3,[TKSgg]Ixider,3351,30,1,1,2,50.0%,37m
9103,3,PigsEatTrash,3351,30,1,1,2,50.0%,18m
9103,3,[GnR]OmegaLSA,3351,0,1,4,5,20.0%,5m
9103,3,Ryry,3351,0,0,3,3,0.0%,19m
9119,3,[peepoC]Cascade,3350,1411,461,456,917,50.3%,34m
9119,2,Sporks,3350,595,167,161,328,50.9%,31m
9119,3,Crazyrain,3350,1400,108,100,208,51.9%,26m
9119,3,[UpxV]Parre,3350,1237,108,102,210,51.4%,27m
9119,3,Graham,3350,859,37,31,68,54.4%,15m
9119,3,Biscuit,3350,278,21,25,46,45.7%,37m
9119,3,[Virtus]Myth,3350,432,18,10,28,64.3%,7m
9119,3,Picard,3350,347,15,10,25,60.0%,20m
9119,3,dexter,3350,101,6,1,7,85.7%,39m
9119,3,IIIIIIIIIIII,3350,184,6,5,11,54.5%,4m
9119,3,Adieu,3350,58,3,0,3,100.0%,42m
9119,1,IIIIIIIIIIII,3350,24,2,1,3,66.7%,36m
9119,3,Saitama,3350,62,2,4,6,33.3%,34m
9119,3,cake,3350,0,1,0,1,100.0%,14m
9119,3,AchillesTent,3350,0,1,0,1,100.0%,10m
9119,3,Icon,3350,0,1,3,4,25.0%,5m
9135,3,KarmaAgent,3349,1518,73,56,129,56.6%,34m
9135,3,[EpicG]elAdmin,3349,836,35,23,58,60.3%,12m
9135,3,IIIIIIIIIIII,3349,514,22,19,41,53.7%,13m
9135,3,Esco,3349,457,19,23,42,45.2%,14m
9135,1,hootis,3349,210,7,2,9,77.8%,29m
9135,3,Seiya,3349,95,6,1,7,85.7%,16m
9135,3,Stone,3349,121,6,2,8,75.0%,35m
9135,3,Rytting,3349,88,3,4,7,42.9%,33m
9135,3,CristCypher,3349,60,2,2,4,50.0%,29m
9135,1,Stress,3349,0,2,3,5,40.0%,8m
9135,3,[Macac0]Tiger,3349,60,2,3,5,40.0%,7m
9135,3,Ratkhan,3349,58,2,3,5,40.0%,36m
9135,3,GhostStorm,3349,30,1,1,2,50.0%,37m
9135,3,lnx,3349,0,0,1,1,0.0%,40m
9135,3,[JVngrd]FrozenFlame,3349,0,0,4,4,0.0%,31m
9150,3,ironblade,3348,0,4,2,6,66.7%,18m
9150,3,[PSU]Throcky,3348,0,1,0,1,100.0%,32m
9152,3,ketaMINE,3347,1488,278,245,523,53.2%,10m
9152,3,LimpyMcDix,3347,833,95,88,183,51.9%,18m
9152,3,[HORSE]Pariah,3347,622,22,24,46,47.8%,27m
9152,2,Stone,3347,136,13,24,37,35.1%,25m
9152,2,JTTizzle,3347,178,7,14,21,33.3%,29m
9152,3,Redondo,3347,86,3,9,12,25.0%,42m
9152,3,GameStrength,3347,30,2,3,5,40.0%,15m
9152,2,[H4VOC]FunkMasterP,3347,46,2,4,6,33.3%,28m
9152,3,IIIIIIIIIIII,3347,30,2,4,6,33.3%,12m
9152,3,luckgirl,3347,30,1,1,2,50.0%,22m
9152,3,spacerape,3347,0,0,2,2,0.0%,37m
9163,2,LedOverLord,3346,1076,48,43,91,52.7%,19m
9163,3,[SCGA]AGMiaoB,3346,958,35,36,71,49.3%,20m
9163,3,xuzyit,3346,300,12,9,21,57.1%,34m
9163,3,[FwithT]BIGGLESWORTH,3346,246,10,6,16,62.5%,21m
9163,3,CheesePolice,3346,212,9,2,11,81.8%,26m
9163,3,PeaceOfHaven,3346,114,4,7,11,36.4%,14m
9163,1,Patate,3346,0,3,3,6,50.0%,3h
9163,3,Archonia,3346,58,3,5,8,37.5%,10m
9163,3,[VENSC2]JerVzla,3346,30,2,0,2,100.0%,38m
9163,3,[Note]vamp,3346,30,2,1,3,66.7%,18m
9163,3,Moridin,3346,0,1,0,1,100.0%,10m
9163,3,zzSKY,3346,0,1,4,5,20.0%,23m
9163,3,DonVaquero,3346,0,0,1,1,0.0%,8m
9163,3,[Eanix]Fatal,3346,0,0,1,1,0.0%,19m
9177,3,[RtKa]CRAM,3345,1179,216,219,435,49.7%,11m
9177,3,pipn,3345,1322,73,54,127,57.5%,11m
9177,3,Sherekan,3345,959,39,33,72,54.2%,11m
9177,3,llllllllllll,3345,656,23,33,56,41.1%,34m
9177,3,FlyingDog,3345,382,14,11,25,56.0%,15m
9177,3,[XNo1]SherryOK,3345,86,4,2,6,66.7%,26m
9177,1,Ayamine,3345,0,1,0,1,100.0%,22m
9177,3,[DTXt]Proprietor,3345,0,0,1,1,0.0%,29m
9177,1,Rataerix,3345,0,0,1,1,0.0%,34m
9186,3,[BrHero]jumplnjac,3344,1387,92,87,179,51.4%,11m
9186,2,KFChicken,3344,1472,71,86,157,45.2%,26m
9186,3,loliSlayer,3344,988,52,44,96,54.2%,34m
9186,3,FortyEZ,3344,547,26,13,39,66.7%,13m
9186,3,FSolo,3344,608,26,16,42,61.9%,31m
9186,3,DrukenGaijin,3344,656,25,21,46,54.3%,10m
9186,3,sticky,3344,596,23,18,41,56.1%,11m
9186,3,tobias,3344,301,17,18,35,48.6%,42m
9186,3,Shortcut,3344,336,16,8,24,66.7%,32m
9186,3,kokonat,3344,218,9,4,13,69.2%,11m
9186,3,NTRKing,3344,86,4,1,5,80.0%,41m
9186,3,[Wndrrs]QuipQuop,3344,58,2,1,3,66.7%,5m
9186,3,Siisyphus,3344,0,1,6,7,14.3%,23m
9186,3,[Echo3s]dragon,3344,30,1,7,8,12.5%,27m
9186,3,SOCCIA,3344,0,0,2,2,0.0%,27m
9186,3,TakeToSky,3344,0,0,5,5,0.0%,17m
9202,2,RockyRUS,3343,1510,396,395,791,50.1%,41m
9202,3,ssjds,3343,1455,169,154,323,52.3%,13m
9202,3,[nieBla]supermago,3343,1586,121,111,232,52.2%,40m
9202,3,[LQV]Dieuy,3343,1119,99,86,185,53.5%,34m
9202,3,[UoM]SLadE,3343,1519,67,70,137,48.9%,27m
9202,3,RonaldRayGun,3343,766,31,23,54,57.4%,42m
9202,3,[MRCYLS]SpeCiaList,3343,688,31,38,69,44.9%,43m
9202,3,iMPRo,3343,561,20,20,40,50.0%,40m
9202,3,MechnCheese,3343,172,6,14,20,30.0%,3m
9202,3,[YD2K]FirE,3343,30,5,1,6,83.3%,33m
9202,2,[SsaYnS]Matt,3343,218,5,10,15,33.3%,14m
9202,3,HedgeHog,3343,0,4,1,5,80.0%,35m
9202,3,Plucault,3343,0,1,2,3,33.3%,19m
9202,3,[RoGT]SweetAngel,3343,30,1,4,5,20.0%,37m
9202,3,[CadeGs]Pandora,3343,0,0,1,1,0.0%,16m
9202,3,uhoh,3343,0,0,1,1,0.0%,36m
9202,3,BLACKJACK,3343,0,0,2,2,0.0%,4m
9219,3,Stnicholas,3342,1239,192,177,369,52.0%,41m
9219,2,Chavezishugo,3342,1499,187,170,357,52.4%,41m
9219,3,[IJB]DrDolittle,3342,1596,154,150,304,50.7%,14m
9219,3,[ISD9]YAMAZAKI,3342,546,19,26,45,42.2%,22m
9219,3,SteHorz,3342,322,16,11,27,59.3%,18m
9219,3,UltraNoob,3342,320,16,12,28,57.1%,33m
9219,3,skylong,3342,254,10,15,25,40.0%,36m
9219,2,singlemom,3342,134,3,2,5,60.0%,13m
9219,3,Ryz,3342,30,2,0,2,100.0%,28m
9219,3,[EndPro]ROCKO,3342,30,2,3,5,40.0%,34m
9219,3,HamiltonRC,3342,0,1,0,1,100.0%,5m
9219,3,Zarc,3342,0,0,1,1,0.0%,17m
9219,3,[QTclub]Darragh,3342,0,0,1,1,0.0%,36m
9232,3,dmenggg,3341,1583,235,209,444,52.9%,16m
9232,3,Reuleaux,3341,1519,206,166,372,55.4%,25m
9232,3,whitecrusada,3341,1270,171,149,320,53.4%,22m
9232,3,GitterDunn,3341,1041,61,50,111,55.0%,26m
9232,3,CivilianUK,3341,1088,47,37,84,56.0%,14m
9232,3,DaveDavidson,3341,730,35,12,47,74.5%,10m
9232,3,[MSet]Disaster,3341,354,13,9,22,59.1%,40m
9232,3,[I8M]Rahemoth,3341,160,9,12,21,42.9%,20m
9232,3,Adapt,3341,180,6,12,18,33.3%,31m
9232,3,Reynor,3341,74,4,0,4,100.0%,25m
9232,3,Petrovich,3341,86,3,1,4,75.0%,16m
9232,2,Allphastar,3341,88,3,3,6,50.0%,26m
9232,3,ReallyManny,3341,30,2,3,5,40.0%,11m
9232,3,RontuPrime,3341,58,2,7,9,22.2%,6m
9232,3,acuamarco,3341,0,1,0,1,100.0%,37m
9232,3,[TGosuA]CiTiZiN,3341,0,1,3,4,25.0%,4m
9232,3,[DaBurn]Stevie,3341,0,0,2,2,0.0%,32m
9249,3,EDWARSACE,3340,1432,163,163,326,50.0%,11m
9249,3,Phantera,3340,822,119,112,231,51.5%,15m
9249,3,[SiG7]Chiffins,3340,625,109,93,202,54.0%,9m
9249,3,jmudukes,3340,1388,92,57,149,61.7%,34m
9249,3,Rossco,3340,567,38,39,77,49.4%,31m
9249,3,FDJok,3340,314,16,11,27,59.3%,6m
9249,3,roboEarth,3340,192,7,5,12,58.3%,12m
9249,3,[NwAs]Kimba,3340,58,3,2,5,60.0%,15m
9249,3,Cricket,3340,121,2,4,6,33.3%,37m
9249,3,FirestarX,3340,0,1,0,1,100.0%,41m
9249,3,[FaeG]TotesMaGoats,3340,0,1,6,7,14.3%,38m
9249,1,MIAphins,3340,0,0,1,1,0.0%,45m
9261,3,mtyf,3339,1064,44,29,73,60.3%,11m
9261,3,BENTANCUR,3339,1108,44,32,76,57.9%,22m
9261,3,IIIIIIIIIIII,3339,121,6,2,8,75.0%,39m
9261,3,lIlIIIllIl,3339,30,5,1,6,83.3%,4m
9261,1,Metamorph,3339,0,4,1,5,80.0%,46m
9261,3,Delti,3339,60,3,3,6,50.0%,5m
9261,3,SaMa,3339,86,3,5,8,37.5%,33m
9261,3,[ACSS]CoBro,3339,0,2,3,5,40.0%,3m
9261,3,[KingSC]Luigi,3339,0,1,0,1,100.0%,41m
9261,3,Sparkly,3339,30,1,1,2,50.0%,32m
9261,3,Gurgles,3339,0,1,1,2,50.0%,16m
9261,3,Sillyfoxy,3339,94,1,3,4,25.0%,5m
9261,2,[GHS]HideYoKids,3339,0,0,1,1,0.0%,9m
9261,3,YakuzaMan,3339,0,0,1,1,0.0%,25m
9275,3,TacticalCorn,3338,1470,208,200,408,51.0%,3m
9275,3,[LAFFY]LXZ,3338,1477,111,96,207,53.6%,37m
9275,3,Ray,3338,1638,101,80,181,55.8%,9m
9275,3,Reyna,3338,1332,52,48,100,52.0%,24m
9275,3,Sweaters,3338,796,39,30,69,56.5%,27m
9275,2,[TGosuC]Kloof,3338,1041,38,45,83,45.8%,4m
9275,3,[8iSh]TheKazootie,3338,468,19,13,32,59.4%,40m
9275,3,Notorials,3338,217,9,15,24,37.5%,27m
9275,2,mars,3338,117,7,3,10,70.0%,9m
9275,3,Yuki,3338,30,5,1,6,83.3%,33m
9275,3,[ezELO]Acrylics,3338,116,4,5,9,44.4%,37m
9275,3,[Magix]Wizard,3338,116,4,10,14,28.6%,23m
9275,3,[iG3]Jokerking,3338,97,2,1,3,66.7%,42m
9275,3,Nesroca,3338,58,2,2,4,50.0%,10m
9275,2,[CodeB]RonRon,3338,0,1,0,1,100.0%,11m
9275,2,lol,3338,0,1,0,1,100.0%,3m
9275,3,Xenarius,3338,96,1,1,2,50.0%,37m
9275,3,INfernal,3338,30,1,1,2,50.0%,22m
9275,1,RaveMaster,3338,97,1,5,6,16.7%,1h
9275,3,[CS0]Samwise,3338,0,0,1,1,0.0%,13m
9295,3,IIIIIIIIIIII,3337,874,119,99,218,54.6%,26m
9295,3,upyours,3337,1187,89,80,169,52.7%,42m
9295,3,KMAGyoyo,3337,1214,45,44,89,50.6%,37m
9295,3,[URUC]Invader,3337,1032,41,38,79,51.9%,33m
9295,3,SevereDeath,3337,931,39,35,74,52.7%,14m
9295,2,water,3337,1112,38,51,89,42.7%,33m
9295,3,blainebell,3337,566,19,24,43,44.2%,21m
9295,3,Kira,3337,455,17,8,25,68.0%,11m
9295,3,Phrygian,3337,101,9,12,21,42.9%,31m
9295,3,LUNi,3337,144,5,3,8,62.5%,18m
9295,3,[EpicG]Dorthy,3337,168,5,3,8,62.5%,10m
9295,3,Timber,3337,0,4,3,7,57.1%,25m
9295,1,VHCF,3337,46,2,2,4,50.0%,27m
9295,3,JOJO,3337,0,1,0,1,100.0%,2m
9295,3,[xTCFx]Thalinden,3337,0,1,1,2,50.0%,4m
9295,3,IIIIIIIIIIII,3337,11,1,5,6,16.7%,29m
9295,3,LAOTIAN,3337,30,1,6,7,14.3%,19m
9312,3,Player,3336,1596,296,288,584,50.7%,31m
9312,3,Ekchuah,3336,1528,222,223,445,49.9%,1m
9312,3,BroastGarlic,3336,1633,185,169,354,52.3%,19m
9312,3,TheJayBird,3336,715,25,28,53,47.2%,34m
9312,3,Physics,3336,572,24,8,32,75.0%,37m
9312,3,Normandin,3336,382,15,16,31,48.4%,23m
9312,1,Ranzard,3336,349,14,9,23,60.9%,10m
9312,1,[PHOEVA]dncheesmeplz,3336,0,1,2,3,33.3%,41m
9312,3,Kipo,3336,0,0,1,1,0.0%,40m
9321,2,[aIMIa]Cebuano,3335,1508,133,136,269,49.4%,3m
9321,2,[USOMAD]MadMo,3335,1461,84,86,170,49.4%,15m
9321,3,whitecats,3335,907,54,35,89,60.7%,27m
9321,3,[TgAg]Quetz,3335,1296,50,48,98,51.0%,14m
9321,3,xWeedWizardx,3335,817,47,37,84,56.0%,40m
9321,3,[Lp]Diecinueveee,3335,674,36,31,67,53.7%,35m
9321,3,Tyrael,3335,745,30,20,50,60.0%,13m
9321,3,nissin,3335,466,18,14,32,56.2%,25m
9321,3,[RIMAS]MAUROTERRAN,3335,389,17,15,32,53.1%,14m
9321,3,[Flam3s]Dias,3335,360,14,13,27,51.9%,2m
9321,2,notme,3335,162,8,4,12,66.7%,38m
9321,3,Thoben,3335,261,8,10,18,44.4%,20m
9321,3,[eyesT]Sanchez,3335,188,7,14,21,33.3%,28m
9321,3,Destiny,3335,30,6,3,9,66.7%,29m
9321,1,MacroFree,3335,97,4,2,6,66.7%,49m
9321,3,SofaKingGood,3335,120,4,8,12,33.3%,38m
9321,3,Profit,3335,90,3,5,8,37.5%,21m
9321,3,kgrzy,3335,92,3,7,10,30.0%,40m
9321,3,XAleXOwnZX,3335,58,2,3,5,40.0%,7m
9321,3,Taydon,3335,0,1,0,1,100.0%,30m
9321,3,CaelumValor,3335,0,1,1,2,50.0%,3m
9321,3,[tboe]Marton,3335,0,0,1,1,0.0%,16m
9321,3,Dustin,3335,0,0,1,1,0.0%,15m
9321,3,mesh,3335,0,0,3,3,0.0%,30m
9345,3,[mtrays]new,3334,1569,97,102,199,48.7%,15m
9345,3,[F4R7Z]IIIIIIIIIIII,3334,602,96,96,192,50.0%,33m
9345,2,SnarfSnarf,3334,1485,90,86,176,51.1%,24m
9345,3,[NPA]Phump,3334,1457,88,84,172,51.2%,11m
9345,3,Bastelion,3334,1114,66,61,127,52.0%,8m
9345,3,BUTTl,3334,955,40,24,64,62.5%,15m
9345,3,aNdoRi,3334,350,14,10,24,58.3%,13m
9345,3,Hassan,3334,118,5,7,12,41.7%,13m
9345,3,iNZoLitO,3334,58,3,4,7,42.9%,3m
9345,3,LazyElm,3334,58,3,4,7,42.9%,17m
9345,3,Demo,3334,0,1,1,2,50.0%,19m
9345,3,[UL]Bauski,3334,0,0,2,2,0.0%,40m
9357,3,lobO,3333,1553,133,119,252,52.8%,24m
9357,3,[SC2IDN]COMOCOM,3333,834,56,38,94,59.6%,36m
9357,3,Galivan,3333,853,53,35,88,60.2%,19m
9357,3,AllStimmedUp,3333,932,46,28,74,62.2%,19m
9357,2,LiquidSouL,3333,1194,45,54,99,45.5%,23m
9357,3,[SVY]GHOSTMARINE,3333,652,23,24,47,48.9%,21m
9357,3,Momo,3333,323,20,13,33,60.6%,31m
9357,3,ZeroCool,3333,444,18,6,24,75.0%,38m
9357,3,[DEPRS]Eauxcaigh,3333,470,17,16,33,51.5%,5m
9357,3,LiFEisMatrix,3333,408,16,8,24,66.7%,3m
9357,3,SokaR,3333,196,8,4,12,66.7%,7m
9357,3,Mow,3333,157,6,2,8,75.0%,19m
9357,3,MooseWayne,3333,114,4,2,6,66.7%,16m
9357,3,eric,3333,29,4,7,11,36.4%,5m
9357,3,Probiotic,3333,86,3,1,4,75.0%,27m
9357,3,Mycatsinheat,3333,0,3,2,5,60.0%,22m
9357,3,Caxtusjones,3333,92,3,8,11,27.3%,5m
9357,3,zendarK,3333,58,2,1,3,66.7%,12m
9357,3,[CULUN]sonyB,3333,0,1,1,2,50.0%,11m
9357,3,Detiner,3333,0,1,2,3,33.3%,7m
9357,3,qwertyisme,3333,0,0,1,1,0.0%,40m
9378,3,marv,3332,1079,157,151,308,51.0%,6m
9378,3,Matt,3332,1348,147,143,290,50.7%,40m
9378,3,Randomer,3332,1146,124,95,219,56.6%,11m
9378,3,elitenoob,3332,944,94,62,156,60.3%,30m
9378,2,[TGosuA]Max,3332,1546,91,102,193,47.2%,3m
9378,3,TheMuffinman,3332,796,64,60,124,51.6%,10m
9378,3,SiRe,3332,1327,58,58,116,50.0%,36m
9378,3,Link,3332,650,52,35,87,59.8%,5m
9378,3,[YD2K]You,3332,713,31,17,48,64.6%,11m
9378,3,ishi,3332,723,31,24,55,56.4%,34m
9378,3,[UpeV]Maverick,3332,550,29,25,54,53.7%,41m
9378,3,GoVeg,3332,548,25,16,41,61.0%,2m
9378,3,YorkHawk,3332,439,20,5,25,80.0%,40m
9378,3,[iHCE]nova,3332,179,16,15,31,51.6%,13m
9378,3,MarineKing,3332,313,14,9,23,60.9%,14m
9378,3,ZhiPower,3332,226,9,5,14,64.3%,10m
9378,3,[Ottas]AznKing,3332,60,5,5,10,50.0%,37m
9378,3,Scorpion,3332,0,4,1,5,80.0%,11m
9378,3,Cereal,3332,0,1,4,5,20.0%,41m
9397,2,llllllllllll,3331,1584,283,280,563,50.3%,37m
9397,3,[nieBla]GhostKiller,3331,1557,167,165,332,50.3%,11m
9397,2,Lobachevski,3331,1401,65,53,118,55.1%,26m
9397,3,[KiTeam]KitZoa,3331,1424,56,56,112,50.0%,22m
9397,3,imawuman,3331,517,39,33,72,54.2%,5m
9397,3,Marvin,3331,711,32,22,54,59.3%,42m
9397,3,[GØSU]badnickton,3331,608,24,22,46,52.2%,20m
9397,3,Colton,3331,238,10,9,19,52.6%,14m
9397,3,Jimson,3331,202,7,5,12,58.3%,7m
9397,3,MauiSpartan,3331,144,6,5,11,54.5%,17m
9397,3,IIIIIIIIIIII,3331,192,5,2,7,71.4%,36m
9397,3,Shakey,3331,60,2,3,5,40.0%,6m
9397,3,llllllllll,3331,0,1,2,3,33.3%,8m
9397,3,PewPewPew,3331,0,0,1,1,0.0%,41m
9411,3,[ValidG]RapidDuck,3330,764,26,33,59,44.1%,39m
9411,3,Forget,3330,524,18,24,42,42.9%,22m
9411,3,[xFaDe]HealZ,3330,192,8,4,12,66.7%,33m
9411,3,jamee,3330,30,6,3,9,66.7%,11m
9411,3,Subject,3330,58,3,7,10,30.0%,1m
9411,3,[GnR]Kingbenjamin,3330,0,1,0,1,100.0%,42m
9411,3,PeterPiper,3330,0,1,0,1,100.0%,12m
9411,3,[FAPFAP]benji,3330,0,1,2,3,33.3%,25m
9411,3,Resonant,3330,0,0,1,1,0.0%,17m
9411,3,[WNTR]DysfunctioN,3330,0,0,1,1,0.0%,1m
9411,3,Chris,3330,0,0,7,7,0.0%,40m
9422,3,[gaPe]ZSwordfish,3329,1585,199,195,394,50.5%,40m
9422,3,[TLibre]patal,3329,1616,130,128,258,50.4%,25m
9422,3,[ICBA]Younglin,3329,966,53,41,94,56.4%,38m
9422,3,TRUMPCORONA,3329,831,46,27,73,63.0%,20m
9422,3,Sound,3329,1038,46,47,93,49.5%,11m
9422,3,[CDest]Mercury,3329,609,41,43,84,48.8%,14m
9422,3,chowder,3329,244,22,18,40,55.0%,12m
9422,3,[Macac0]Cannibalize,3329,414,17,10,27,63.0%,2m
9422,3,etaripluons,3329,352,16,8,24,66.7%,38m
9422,3,Epiclucas,3329,356,14,13,27,51.9%,30m
9422,3,BleueDry,3329,386,13,17,30,43.3%,25m
9422,3,[JUGOS]PERCYE,3329,208,8,8,16,50.0%,15m
9422,3,BREAKTHROUGH,3329,131,7,5,12,58.3%,3m
9422,3,Terg,3329,128,6,11,17,35.3%,32m
9422,3,[Lp]SaCrOs,3329,86,4,1,5,80.0%,14m
9422,1,DaBeast,3329,97,4,2,6,66.7%,42m
9422,3,[CLEM]Soul,3329,86,3,7,10,30.0%,5m
9422,3,HouseOfPain,3329,30,2,1,3,66.7%,12m
9422,3,[UTMVAN]Whycolt,3329,58,2,2,4,50.0%,19m
9422,3,[TXOP]Artekario,3329,0,1,1,2,50.0%,15m
9422,3,supahotfire,3329,0,1,2,3,33.3%,8m
9422,3,llllllllllll,3329,0,1,5,6,16.7%,37m
9422,3,[Ash3s]ExMachina,3329,0,0,1,1,0.0%,10m
9422,3,abSTRAkt,3329,0,0,2,2,0.0%,29m
9446,3,PopoPepeMan,3328,642,84,69,153,54.9%,18m
9446,3,[ggzvz]llllllllllll,3328,1405,76,60,136,55.9%,16m
9446,3,AOAJimin,3328,1037,52,43,95,54.7%,33m
9446,3,MOUNTAINDEW,3328,1257,51,49,100,51.0%,25m
9446,3,[YD2K]GBFK,3328,1060,40,41,81,49.4%,7m
9446,3,[CaveR]vitaminTuna,3328,334,22,4,26,84.6%,17m
9446,3,Takú,3328,90,7,13,20,35.0%,11m
9446,2,[TeamDS]Nick,3328,60,4,8,12,33.3%,3m
9446,3,[Brslov]PeterAn,3328,90,3,7,10,30.0%,38m
9446,3,OverLoadinG,3328,0,1,1,2,50.0%,30m
9446,1,ORaZ,3328,48,1,7,8,12.5%,2h
9446,3,CLiu,3328,0,0,1,1,0.0%,5m
9446,3,IgNeal,3328,0,0,1,1,0.0%,3m
9446,2,FearItself,3328,0,0,2,2,0.0%,56m
9460,3,jambe,3327,1553,209,195,404,51.7%,36m
9460,3,BuffTerranPl,3327,1527,99,81,180,55.0%,21m
9460,3,[DRKRIS]Perfect,3327,1460,73,73,146,50.0%,41m
9460,2,[GOPERÚ]Acel,3327,1581,73,82,155,47.1%,36m
9460,3,[IOwOl]Stephenwb,3327,1033,53,58,111,47.7%,25m
9460,3,Search,3327,336,11,17,28,39.3%,9m
9460,3,Why,3327,179,8,4,12,66.7%,19m
9460,3,llllllllllll,3327,116,5,3,8,62.5%,8m
9460,1,[TTri]Shaada,3327,149,4,4,8,50.0%,39m
9460,1,sugar,3327,93,2,0,2,100.0%,41m
9460,3,PincheTaco,3327,60,2,4,6,33.3%,41m
9460,3,JackDaniel,3327,0,2,4,6,33.3%,6m
9460,3,daPlunja,3327,0,1,0,1,100.0%,15m
9460,3,Kirsi,3327,0,1,0,1,100.0%,2m
9460,3,Scale,3327,0,0,1,1,0.0%,25m
9475,3,Mikro,3326,1064,49,26,75,65.3%,13m
9475,3,DuckBoy,3326,1035,42,34,76,55.3%,16m
9475,3,iwannacupee,3326,891,38,39,77,49.4%,5m
9475,3,[Btata1]NightMare,3326,369,17,9,26,65.4%,40m
9475,3,Aseos,3326,374,15,9,24,62.5%,32m
9475,3,llllllllllll,3326,228,9,9,18,50.0%,35m
9475,3,[FalPal]Terronic,3326,116,5,4,9,55.6%,21m
9475,3,cot,3326,0,4,1,5,80.0%,8m
9475,3,[LGNxx]RobStark,3326,86,4,2,6,66.7%,37m
9475,3,Morlag,3326,58,3,1,4,75.0%,40m
9475,3,Mayucchi,3326,0,1,0,1,100.0%,11m
9475,3,sunjay,3326,0,1,0,1,100.0%,11m
9475,3,Rocktopus,3326,0,1,6,7,14.3%,38m
9475,3,junius,3326,0,0,1,1,0.0%,38m
9475,3,[SC2BOL]NepGear,3326,0,0,2,2,0.0%,26m
9475,3,PotatoParty,3326,0,0,6,6,0.0%,31m
9491,2,Noname,3325,1373,210,206,416,50.5%,27m
9491,3,Scully,3325,1585,194,167,361,53.7%,3m
9491,3,Hiramekarei,3325,1583,128,131,259,49.4%,41m
9491,3,Graupel,3325,1132,49,37,86,57.0%,16m
9491,3,[ValidG]Indroves,3325,786,29,30,59,49.2%,34m
9491,3,[Pharoh]Erikor,3325,681,27,25,52,51.9%,11m
9491,3,MAGNETO,3325,598,23,22,45,51.1%,13m
9491,3,LeBoss,3325,497,20,7,27,74.1%,32m
9491,3,[LgnTDS]CORNIJA,3325,420,16,10,26,61.5%,25m
9491,1,LoliComunist,3325,385,15,9,24,62.5%,15m
9491,3,Valerius,3325,224,10,8,18,55.6%,11m
9491,3,[Chow]Intrepid,3325,246,9,9,18,50.0%,17m
9491,1,BizzaroBird,3325,259,8,4,12,66.7%,40m
9491,3,[xRtG]Smartie,3325,190,5,8,13,38.5%,3m
9491,3,[DhZone]hercules,3325,62,2,13,15,13.3%,32m
9491,3,ALtrocity,3325,30,1,2,3,33.3%,9m
9491,3,NoSpoon,3325,30,1,4,5,20.0%,40m
9491,3,[mBL1]KahTze,3325,0,0,1,1,0.0%,18m
9509,3,Shakey,3324,1634,108,91,199,54.3%,6m
9509,3,Rogue,3324,1525,69,69,138,50.0%,42m
9509,3,[NTrio]Zandel,3324,1474,60,61,121,49.6%,11m
9509,3,StonedGnome,3324,1342,53,45,98,54.1%,24m
9509,3,[KKGG]WALUWALUWALU,3324,749,51,41,92,55.4%,10m
9509,3,FunnyUndies,3324,530,19,25,44,43.2%,27m
9509,3,Oddsbodikins,3324,376,14,11,25,56.0%,15m
9509,3,disciplE,3324,234,7,5,12,58.3%,17m
9509,3,Killtech,3324,0,5,1,6,83.3%,4m
9509,3,DaymanaaAAa,3324,0,4,1,5,80.0%,4m
9509,3,TrussesSuck,3324,92,4,4,8,50.0%,5m
9509,3,[Pres45]TRUMP,3324,88,4,10,14,28.6%,37m
9509,3,Midas,3324,60,3,2,5,60.0%,38m
9509,3,[ISteal]TheBigPeenis,3324,86,3,3,6,50.0%,28m
9509,1,LeeSeol,3324,117,3,4,7,42.9%,25m
9509,3,Chamillitary,3324,30,2,2,4,50.0%,5m
9509,1,KuKu,3324,0,1,0,1,100.0%,36m
9509,3,moke,3324,0,1,0,1,100.0%,26m
9509,3,crunchatized,3324,0,0,1,1,0.0%,16m
9509,3,[ZWars]DarkPrinceX,3324,0,0,1,1,0.0%,16m
9529,3,DeathByDuck,3323,992,54,50,104,51.9%,25m
9529,3,[LALALE]HuRRicane,3323,811,42,19,61,68.9%,10m
9529,3,KHG,3323,619,38,16,54,70.4%,40m
9529,3,[NPhasA]florencio,3323,663,32,34,66,48.5%,40m
9529,2,EvgenAvt,3323,266,13,6,19,68.4%,2m
9529,3,[LOVEIN]TTisME,3323,258,13,15,28,46.4%,12m
9529,3,Dijkstra,3323,324,12,2,14,85.7%,28m
9529,3,[Rollin]Supreme,3323,315,12,7,19,63.2%,30m
9529,3,dslidd,3323,192,8,1,9,88.9%,7m
9529,3,ChimpwOw,3323,142,7,2,9,77.8%,30m
9529,3,Vizjeri,3323,104,5,2,7,71.4%,27m
9529,3,[ExcIgN]Raiter,3323,0,0,6,6,0.0%,13m
9541,3,[JUIN]avp,3322,1619,150,138,288,52.1%,38m
9541,3,PlayRisk,3322,1529,64,69,133,48.1%,11m
9541,3,[LOLITO]Lumpitaz,3322,1363,58,42,100,58.0%,13m
9541,3,chloesaurus,3322,214,22,14,36,61.1%,15m
9541,2,[Accel]Manganate,3322,664,22,34,56,39.3%,3m
9541,3,LionKing,3322,83,10,11,21,47.6%,3m
9541,2,[weFish]YoloSwaggins,3322,328,10,21,31,32.3%,9m
9541,3,HapPybOy,3322,145,7,3,10,70.0%,20m
9541,3,Smebu,3322,0,5,2,7,71.4%,22m
9541,3,ChugsRoundup,3322,90,4,7,11,36.4%,24m
9541,3,Wobbu,3322,0,1,0,1,100.0%,26m
9541,3,[AMCL]AluDark,3322,30,1,3,4,25.0%,13m
9541,3,MollyWater,3322,0,1,4,5,20.0%,10m
9541,3,[LimaSC]Darkoxalc,3322,0,0,1,1,0.0%,10m
9541,3,[TGosuC]Grim,3322,0,0,3,3,0.0%,30m
9556,3,Jtamm,3321,864,32,35,67,47.8%,27m
9556,3,Junkorus,3321,477,19,15,34,55.9%,31m
9556,3,ManCanCan,3321,282,13,9,22,59.1%,42m
9556,3,KIMCHILOVE,3321,220,9,3,12,75.0%,36m
9556,1,[ØFoxF2]Boxco,3321,97,2,0,2,100.0%,3h
9556,3,holaqhace,3321,0,1,4,5,20.0%,11m
9556,3,[PMT]spinnercat,3321,0,0,1,1,0.0%,4m
9556,3,[ØFoxF2]casti,3321,0,0,2,2,0.0%,3m
9556,3,Ronnie,3321,0,0,3,3,0.0%,13m
9565,2,GOLEZ,3320,1162,117,95,212,55.2%,13m
9565,3,MYBADMUSIC,3320,773,57,49,106,53.8%,19m
9565,3,Biscuit,3320,1187,51,43,94,54.3%,11m
9565,3,UBIN,3320,1166,45,46,91,49.5%,24m
9565,3,[SLATT]bignastybert,3320,452,35,35,70,50.0%,38m
9565,2,TheMarine,3320,701,32,26,58,55.2%,10m
9565,3,[YEEK]cheelofwheeZ,3320,384,17,12,29,58.6%,6m
9565,3,IlIlIlIIlIlI,3320,308,11,13,24,45.8%,21m
9565,3,Bruce,3320,142,9,5,14,64.3%,28m
9565,3,xMRxGNDFx,3320,190,8,2,10,80.0%,33m
9565,3,Gouda,3320,250,8,5,13,61.5%,5m
9565,1,[5Svrt]Mongrethod,3320,114,3,4,7,42.9%,4m
9565,3,timoket,3320,92,3,10,13,23.1%,2m
9565,3,Yuno,3320,58,2,1,3,66.7%,11m
9565,1,IlIlIlIlIlIl,3320,97,1,6,7,14.3%,10m
9580,3,Detra,3319,1633,237,219,456,52.0%,12m
9580,3,[ExcIgN]eloy,3319,1605,141,127,268,52.6%,22m
9580,3,Riddle,3319,727,122,93,215,56.7%,12m
9580,3,Hercules,3319,1306,95,89,184,51.6%,11m
9580,3,lMercuryl,3319,1037,45,42,87,51.7%,12m
9580,3,phlipzter,3319,912,37,29,66,56.1%,22m
9580,3,Bloodpack,3319,90,7,3,10,70.0%,8m
9580,3,RAMSES,3319,140,6,2,8,75.0%,31m
9580,3,tshook,3319,145,5,5,10,50.0%,30m
9580,2,LoserTrump,3319,140,4,0,4,100.0%,22m
9580,2,Elongation,3319,0,4,1,5,80.0%,42m
9580,3,tutter,3319,30,2,4,6,33.3%,5m
9580,3,[BobBrz]Trufflebase,3319,30,1,3,4,25.0%,42m
9580,3,Beanfox,3319,0,0,2,2,0.0%,29m
9594,2,[SkyHoe]Odin,3318,1226,156,168,324,48.1%,21m
9594,3,Eidolon,3318,1250,111,111,222,50.0%,13m
9594,3,[GanSi]ZXwho,3318,1244,67,52,119,56.3%,29m
9594,3,DroneKing,3318,870,33,31,64,51.6%,29m
9594,3,[OSFluX]DiscreTe,3318,601,29,15,44,65.9%,34m
9594,3,RareCandy,3318,378,14,12,26,53.8%,23m
9594,2,nirvash,3318,255,11,6,17,64.7%,8m
9594,3,[YE71]Faceless,3318,192,8,3,11,72.7%,29m
9594,1,Solo,3318,97,5,2,7,71.4%,25m
9594,3,AdmiralSmash,3318,120,3,1,4,75.0%,25m
9594,3,Huh,3318,133,3,3,6,50.0%,15m
9594,3,LiquidRet,3318,58,2,5,7,28.6%,41m
9594,3,Chi,3318,0,1,2,3,33.3%,17m
9607,3,TopSprouter,3317,1559,214,208,422,50.7%,11m
9607,3,Hung,3317,1100,112,100,212,52.8%,11m
9607,3,OrganEyes,3317,1571,104,92,196,53.1%,13m
9607,3,FLOWER,3317,276,10,16,26,38.5%,16m
9607,3,connoisseur,3317,144,9,6,15,60.0%,38m
9607,3,[InGt]Sabo,3317,189,8,2,10,80.0%,41m
9607,2,Nucleus,3317,183,8,5,13,61.5%,28m
9607,3,Rokman,3317,146,6,4,10,60.0%,42m
9607,3,JJAZ,3317,146,5,6,11,45.5%,37m
9607,3,IlIlllIIIlIl,3317,0,4,1,5,80.0%,25m
9607,3,Roker,3317,60,2,3,5,40.0%,28m
9607,3,TEMplar,3317,0,0,1,1,0.0%,11m
9619,3,Anazka,3316,1425,149,143,292,51.0%,34m
9619,3,Hiddenhat,3316,1604,68,65,133,51.1%,11m
9619,3,DABO,3316,1549,63,61,124,50.8%,6m
9619,3,MrBeef,3316,1386,62,49,111,55.9%,16m
9619,3,aggresor,3316,1257,57,35,92,62.0%,38m
9619,2,MagicTerran,3316,1176,45,53,98,45.9%,41m
9619,3,[VoHox]beastti,3316,518,19,26,45,42.2%,20m
9619,3,[NwAs]Judith,3316,390,15,20,35,42.9%,3m
9619,3,TriasElPony,3316,188,7,3,10,70.0%,13m
9619,2,OvniFuXy,3316,40,2,0,2,100.0%,36m
9619,3,MacrO,3316,119,2,2,4,50.0%,35m
9619,3,[Co0nS]Emperortaco,3316,30,2,2,4,50.0%,41m
9619,3,BillS,3316,60,2,5,7,28.6%,14m
9619,3,spaidy,3316,0,1,0,1,100.0%,10m
9619,3,[Flam3s]yenisimo,3316,0,0,7,7,0.0%,17m
9634,3,Cryomatrix,3315,1601,151,136,287,52.6%,37m
9634,3,[GRU]FapperDupley,3315,732,46,40,86,53.5%,30m
9634,3,MicrO,3315,721,30,15,45,66.7%,42m
9634,3,[YZYSZN]TREYTREYTREY,3315,711,30,30,60,50.0%,36m
9634,3,tryHard,3315,385,15,4,19,78.9%,35m
9634,3,procat,3315,204,10,3,13,76.9%,42m
9634,3,Haqua,3315,233,10,6,16,62.5%,14m
9634,3,ark,3315,48,8,13,21,38.1%,13m
9634,3,OliToot,3315,210,7,12,19,36.8%,41m
9634,1,qer,3315,97,5,1,6,83.3%,42m
9634,3,MasterAndrew,3315,118,5,4,9,55.6%,17m
9634,3,fumom,3315,126,5,8,13,38.5%,11m
9634,3,Wicle,3315,159,4,6,10,40.0%,24m
9634,3,player,3315,30,2,2,4,50.0%,11m
9634,3,[kOuT]SidiuS,3315,30,1,1,2,50.0%,1m
9634,3,[xLgNx]IcyGoblin,3315,0,0,1,1,0.0%,37m
9650,2,[Wrs]Norke,3314,1577,301,300,601,50.1%,28m
9650,2,Doge,3314,889,82,73,155,52.9%,20m
9650,3,IMSleeping,3314,1313,82,84,166,49.4%,31m
9650,3,[GvSQD]GoveaKun,3314,982,38,36,74,51.4%,24m
9650,3,icemanida,3314,670,29,20,49,59.2%,41m
9650,3,KRmadness,3314,639,26,24,50,52.0%,40m
9650,3,[FnS]DiZ,3314,521,24,5,29,82.8%,4m
9650,3,MarineKing,3314,145,4,3,7,57.1%,38m
9650,3,[TMKOs]ElTrululú,3314,30,2,4,6,33.3%,16m
9650,1,[Flacyd]NatPort,3314,0,1,0,1,100.0%,9m
9650,3,[UDPC]Battingus,3314,0,0,1,1,0.0%,7m
9650,3,[NovaX]Realone,3314,0,0,6,6,0.0%,10m
9650,3,[dioses]Alberthor,3314,0,0,7,7,0.0%,29m
9663,3,[DarkAG]Solas,3313,1595,291,272,563,51.7%,25m
9663,3,[OhMG]BigManager,3313,1221,86,85,171,50.3%,33m
9663,3,qqq,3313,529,29,21,50,58.0%,27m
9663,3,DEAFXROBOT,3313,420,25,19,44,56.8%,14m
9663,3,OrneryPants,3313,528,21,27,48,43.8%,7m
9663,3,[ShB]Blayum,3313,499,18,29,47,38.3%,42m
9663,3,SaveTheJelly,3313,336,12,18,30,40.0%,14m
9663,3,Tempestor,3313,274,10,8,18,55.6%,14m
9663,3,[3DLANS]Nvilela,3313,180,7,10,17,41.2%,3m
9663,3,Soulreaver,3313,86,4,1,5,80.0%,11m
9663,3,LeX,3313,131,3,2,5,60.0%,22m
9674,3,Xray,3312,1550,297,300,597,49.7%,34m
9674,3,[Lp]RapSolo,3312,1551,148,120,268,55.2%,37m
9674,3,GGtuntunder,3312,1061,45,37,82,54.9%,41m
9674,3,[IMDSI]jhonatan,3312,1032,44,26,70,62.9%,9m
9674,3,mayden,3312,737,32,21,53,60.4%,19m
9674,3,alberttttttt,3312,734,31,25,56,55.4%,25m
9674,3,[MenMae]daniel,3312,526,19,24,43,44.2%,40m
9674,3,lejneb,3312,484,18,21,39,46.2%,38m
9674,3,czteryKej,3312,314,10,19,29,34.5%,17m
9674,3,[XpKb]Tmato,3312,204,8,6,14,57.1%,3m
9674,3,AgentSmith,3312,86,4,1,5,80.0%,10m
9674,3,[iDrunk]Trollinator,3312,88,3,2,5,60.0%,9m
9674,3,[MZHS]AviloHAHAHA,3312,0,0,1,1,0.0%,42m
9674,3,Stephano,3312,0,0,3,3,0.0%,18m
9688,3,[neuroS]jdubya,3311,1609,258,242,500,51.6%,11m
9688,3,Certiorari,3311,1581,239,236,475,50.3%,34m
9688,3,Yaldabaoth,3311,1557,149,148,297,50.2%,3m
9688,2,ReDiBuLouS,3311,1485,125,133,258,48.4%,41m
9688,3,Moridin,3311,783,38,8,46,82.6%,17m
9688,3,Rapture,3311,897,38,26,64,59.4%,21m
9688,3,[FlTM]PerFectRT,3311,361,24,24,48,50.0%,34m
9688,3,AnalKarnaval,3311,415,16,10,26,61.5%,4m
9688,3,stonekiller,3311,306,11,8,19,57.9%,24m
9688,3,ZeDarkMaMu,3311,278,10,2,12,83.3%,12m
9688,2,qwerty,3311,117,8,4,12,66.7%,9m
9688,3,[SGAus]BlindOmatic,3311,182,7,11,18,38.9%,11m
9688,3,dareOfficer,3311,94,4,7,11,36.4%,38m
9688,3,Puddless,3311,58,3,1,4,75.0%,25m
9688,3,Taklone,3311,30,2,1,3,66.7%,42m
9688,3,raKontuR,3311,62,2,4,6,33.3%,18m
9688,3,[VFam]WarHammer,3311,0,1,0,1,100.0%,5m
9688,3,NYCWarWolf,3311,0,1,1,2,50.0%,10m
9706,2,StimToWin,3310,1509,252,248,500,50.4%,9m
9706,3,Motitajok,3310,819,103,111,214,48.1%,14m
9706,3,Macklayne,3310,1369,98,98,196,50.0%,5m
9706,3,NotSoBright,3310,1476,64,59,123,52.0%,9m
9706,3,[1E100]Pacifists,3310,861,36,33,69,52.2%,6m
9706,3,ProtossFury,3310,350,34,33,67,50.7%,2m
9706,3,[1Fenix]Atom,3310,576,24,18,42,57.1%,40m
9706,2,SuperNinja,3310,248,12,12,24,50.0%,24m
9706,3,[UpeV]BarCode,3310,118,5,5,10,50.0%,27m
9706,2,Spaghetti,3310,0,4,1,5,80.0%,3h
9706,3,[AlIin]zumpy,3310,144,4,3,7,57.1%,18m
9706,3,[Sensei]Zombie,3310,116,4,5,9,44.4%,6m
9706,3,[OxEx]StoneDawg,3310,90,3,5,8,37.5%,30m
9706,3,Garous,3310,86,3,5,8,37.5%,17m
9706,3,[Sune]Pistola,3310,30,1,1,2,50.0%,21m
9706,3,BlackBoiz,3310,0,0,1,1,0.0%,27m
9722,2,KILLABEE,3309,1567,350,363,713,49.1%,20m
9722,3,Khan,3309,1574,192,174,366,52.5%,34m
9722,3,RoughMercies,3309,1344,181,157,338,53.6%,13m
9722,3,[StarBW]xOFluid,3309,1445,65,48,113,57.5%,41m
9722,2,[ShoaL]Red,3309,442,14,31,45,31.1%,16m
9722,3,ImNotScary,3309,278,10,7,17,58.8%,7m
9722,3,Bisu,3309,272,10,14,24,41.7%,27m
9722,3,PaPaya,3309,170,6,3,9,66.7%,30m
9722,3,[Thacc]LightNinG,3309,184,6,8,14,42.9%,25m
9722,2,[OSOHT]EScape,3309,181,5,3,8,62.5%,18m
9722,3,Napolitain,3309,0,4,1,5,80.0%,30m
9722,3,Calvary,3309,0,1,1,2,50.0%,15m
9722,3,JuanitoOoO,3309,30,1,2,3,33.3%,35m
9722,3,GTMaic,3309,0,0,1,1,0.0%,11m
9722,3,[KGH]Kalindor,3309,0,0,1,1,0.0%,9m
9722,3,[PWNDya]TangoCharlie,3309,0,0,2,2,0.0%,12m
9738,2,ElitexFenix,3308,1367,170,167,337,50.4%,32m
9738,3,Probius,3308,1568,162,149,311,52.1%,2m
9738,3,Rho,3308,524,22,14,36,61.1%,30m
9738,3,MechncSpecal,3308,266,11,5,16,68.8%,29m
9738,3,Skins,3308,278,11,15,26,42.3%,2m
9738,3,LaurenWitzke,3308,118,8,4,12,66.7%,19m
9738,3,Miller,3308,114,5,5,10,50.0%,24m
9738,3,[Xpk]Cabelin,3308,30,2,1,3,66.7%,42m
9738,3,[ISDP]Taco,3308,0,1,0,1,100.0%,25m
9738,3,theTRASHman,3308,30,1,1,2,50.0%,40m
9738,3,Hydro,3308,0,1,5,6,16.7%,9m
9738,2,[Gh0std]KobesPilotGG,3308,0,0,1,1,0.0%,9m
9738,3,[F3DUp]kevlar,3308,0,0,1,1,0.0%,38m
9738,3,ReGioN,3308,0,0,1,1,0.0%,8m
9738,3,[REPORT]pro,3308,0,0,2,2,0.0%,40m
9753,3,Reloadingame,3307,1187,79,71,150,52.7%,38m
9753,3,Finkk,3307,1181,59,57,116,50.9%,31m
9753,3,[IPOI3]ImDewey,3307,372,13,18,31,41.9%,5m
9753,3,guguizg,3307,244,10,7,17,58.8%,18m
9753,1,IamKorean,3307,96,5,1,6,83.3%,10m
9753,3,[INextI]Buho,3307,142,5,5,10,50.0%,40m
9753,3,[LOLASO]RodolfoLord,3307,30,2,0,2,100.0%,11m
9753,3,GusBus,3307,0,1,1,2,50.0%,39m
9753,3,[HrdBdy]VanBuren,3307,0,1,2,3,33.3%,13m
9753,2,Anti,3307,0,1,2,3,33.3%,3h
9763,3,Swizzle,3306,1567,227,228,455,49.9%,40m
9763,2,Hadrian,3306,1507,160,174,334,47.9%,28m
9763,3,ThatGuy,3306,1282,141,137,278,50.7%,15m
9763,3,[iGx]kylebugg,3306,1116,98,104,202,48.5%,22m
9763,2,ruppanator,3306,1248,52,53,105,49.5%,2m
9763,3,BuffettGamer,3306,883,47,27,74,63.5%,28m
9763,3,ttk,3306,969,36,34,70,51.4%,40m
9763,3,Meow,3306,781,32,30,62,51.6%,34m
9763,3,YuuSenpai,3306,318,23,24,47,48.9%,37m
9763,3,Ori,3306,340,13,5,18,72.2%,11m
9763,2,Koromon,3306,269,12,6,18,66.7%,26m
9763,3,[rgeKIT]Kreator,3306,230,8,8,16,50.0%,41m
9763,3,IIIIIIIIIIII,3306,222,7,6,13,53.8%,13m
9763,3,bnetanel,3306,58,3,6,9,33.3%,6m
9763,3,[XXTT]commander,3306,58,2,1,3,66.7%,28m
9763,3,Pineapple,3306,60,2,9,11,18.2%,25m
9763,3,Pupu,3306,0,1,0,1,100.0%,22m
9763,3,DanielOhKOTJ,3306,0,1,0,1,100.0%,41m
9763,3,[OGbros]Ouroboros,3306,0,0,2,2,0.0%,3m
9763,3,HelloDan,3306,0,0,2,2,0.0%,10m
9783,2,Cazador,3305,1467,505,521,1026,49.2%,1m
9783,3,Mike,3305,634,24,25,49,49.0%,13m
9783,3,JACKJAS,3305,518,22,25,47,46.8%,11m
9783,3,[Poway]uwu,3305,320,12,9,21,57.1%,11m
9783,2,Fey,3305,204,9,5,14,64.3%,22m
9783,3,[JaMiT]carbon,3305,140,6,0,6,100.0%,12m
9783,3,start,3305,174,6,11,17,35.3%,13m
9783,3,BadFrog,3305,30,3,4,7,42.9%,38m
9783,3,[HotCop]Paralysis,3305,0,1,4,5,20.0%,27m
9783,3,Herrcombs,3305,0,0,1,1,0.0%,11m
9783,3,[waRp1]LacraMSI,3305,0,0,1,1,0.0%,25m
9794,3,[eo4]MilkacaDuke,3304,732,114,108,222,51.4%,34m
9794,3,WhiteWolf,3304,1367,68,63,131,51.9%,20m
9794,3,thomasrulz,3304,583,44,44,88,50.0%,34m
9794,2,[TMGF]Ishmael,3304,357,17,14,31,54.8%,3m
9794,3,ProtossOP,3304,462,16,21,37,43.2%,19m
9794,3,BicepsAtMid,3304,213,10,6,16,62.5%,20m
9794,3,TiGiDoO,3304,238,8,12,20,40.0%,40m
9794,3,[Paus3d]GrundleLickr,3304,186,7,8,15,46.7%,39m
9794,3,pokerhi,3304,86,6,3,9,66.7%,14m
9794,1,PenThief,3304,145,4,2,6,66.7%,2h
9794,3,XANDER,3304,0,4,4,8,50.0%,34m
9794,3,MrWin,3304,88,4,7,11,36.4%,5m
9794,3,[xTQc]WishDeath,3304,58,3,0,3,100.0%,11m
9794,3,[TCTG]lolcookie,3304,58,2,3,5,40.0%,24m
9794,3,dodger,3304,0,1,0,1,100.0%,21m
9794,3,mushies,3304,0,1,1,2,50.0%,16m
9794,3,IIIIIIIIIIII,3304,0,1,5,6,16.7%,32m
9794,3,[THIGHS]ArcTheOne,3304,0,0,2,2,0.0%,18m
9812,2,[crbrz]Lightboy,3303,1273,170,163,333,51.1%,29m
9812,3,DrumpfSmolPP,3303,1244,105,88,193,54.4%,6m
9812,3,VitaliiTop,3303,793,99,103,202,49.0%,8m
9812,2,[CRBK]Jodesal,3303,1546,92,100,192,47.9%,10m
9812,3,[SCABS]daydreamy,3303,934,73,70,143,51.0%,34m
9812,3,[TCPNA]Decas,3303,1043,72,54,126,57.1%,37m
9812,3,[SURUPA]VaLeskA,3303,1238,55,34,89,61.8%,10m
9812,3,Werner,3303,1042,39,35,74,52.7%,16m
9812,3,jumpman,3303,744,27,30,57,47.4%,9m
9812,3,[SISR]Phasing,3303,535,20,14,34,58.8%,6m
9812,3,[Bee]JohnnyBee,3303,494,19,15,34,55.9%,1m
9812,3,[DmonZ]AlexDuf,3303,380,15,14,29,51.7%,6m
9812,3,Storm,3303,169,8,5,13,61.5%,17m
9812,3,[AD3C]yenisimo,3303,0,1,1,2,50.0%,22m
9812,3,[VDE]Harsh,3303,0,1,1,2,50.0%,31m
9812,3,[NYESS]Grundle,3303,0,1,1,2,50.0%,14m
9812,3,DrCochon,3303,0,1,2,3,33.3%,2m
9829,3,[MSHS09]OSIRIS,3302,1606,82,62,144,56.9%,21m
9829,3,TankHero,3302,786,43,34,77,55.8%,5m
9829,3,lottse,3302,1072,41,39,80,51.2%,40m
9829,3,Korasi,3302,834,31,31,62,50.0%,31m
9829,3,[VISC]StonedNinja,3302,538,22,15,37,59.5%,27m
9829,3,[TLAN]SuperZorg,3302,618,21,29,50,42.0%,17m
9829,1,Spoody,3302,301,12,8,20,60.0%,41m
9829,3,Thx,3302,334,12,14,26,46.2%,11m
9829,3,spacecake,3302,293,11,5,16,68.8%,25m
9829,3,Baz,3302,129,5,6,11,45.5%,30m
9829,3,ZoVaNaK,3302,144,5,7,12,41.7%,40m
9829,2,joker,3302,0,4,1,5,80.0%,3h
9829,3,changhavv,3302,114,4,4,8,50.0%,23m
9829,3,LeviThaKidd,3302,58,3,2,5,60.0%,17m
9829,3,[TheDOH]ListerFiend,3302,60,3,7,10,30.0%,35m
9829,3,[FxB]MaeFire,3302,0,1,0,1,100.0%,6m
9845,3,[Carton]lorecs,3301,970,38,38,76,50.0%,10m
9845,3,FilDan,3301,286,12,7,19,63.2%,17m
9845,1,RubyTopaz,3301,252,10,3,13,76.9%,32m
9845,3,pUre,3301,114,4,1,5,80.0%,17m
9845,1,Awesomeo,3301,121,4,1,5,80.0%,53m
9845,3,[Kappa]Wormlips,3301,60,2,2,4,50.0%,41m
9845,3,[αX]Nemesis,3301,0,0,1,1,0.0%,3m
9845,3,loser,3301,0,0,6,6,0.0%,19m
9853,3,LosInmensos,3300,1504,195,189,384,50.8%,29m
9853,3,BrolyLG,3300,998,182,177,359,50.7%,15m
9853,3,[GØSU]Tracker,3300,1619,130,124,254,51.2%,6m
9853,3,HelloWorld,3300,1527,110,103,213,51.6%,16m
9853,2,Amped,3300,946,69,81,150,46.0%,2m
9853,3,[FeverC]LeJunKie,3300,956,59,53,112,52.7%,16m
9853,3,Annatar,3300,1098,51,47,98,52.0%,41m
9853,3,Mika,3300,562,26,21,47,55.3%,40m
9853,3,Elbandido,3300,256,10,13,23,43.5%,14m
9853,3,Phocas,3300,175,10,15,25,40.0%,17m
9853,3,[OlShan]Innovator,3300,155,8,2,10,80.0%,34m
9853,3,[BoAVN]ThangMercy,3300,206,7,11,18,38.9%,18m
9853,3,GEL,3300,210,7,18,25,28.0%,30m
9853,3,TWICE,3300,166,6,4,10,60.0%,14m
9853,3,[420]PuNK,3300,86,3,1,4,75.0%,5m
9853,3,Jacknife,3300,88,3,9,12,25.0%,35m
9853,3,[C2N]DeathBringer,3300,60,2,8,10,20.0%,39m
9853,3,[GGxC]thegreybush,3300,0,1,2,3,33.3%,10m
9853,3,Steak,3300,96,1,2,3,33.3%,10m
9853,3,[xBoZi]xxxSex,3300,0,0,2,2,0.0%,40m
9853,3,Conics,3300,0,0,4,4,0.0%,38m
9853,3,berryblaze,3300,0,0,5,5,0.0%,30m
9875,2,KungFooPanDa,3299,1495,255,254,509,50.1%,25m
9875,3,Taeyeon,3299,925,214,202,416,51.4%,8m
9875,3,Kubrickr,3299,1532,118,104,222,53.2%,40m
9875,2,YellowSnow,3299,1217,90,92,182,49.5%,9m
9875,3,IIIIIIIIIIII,3299,891,57,54,111,51.4%,14m
9875,3,DARWOL,3299,238,45,54,99,45.5%,27m
9875,3,Shimbalama,3299,974,37,34,71,52.1%,40m
9875,3,Gibkram,3299,774,30,28,58,51.7%,11m
9875,3,UnDeadCrunch,3299,518,28,16,44,63.6%,19m
9875,3,albin,3299,719,27,22,49,55.1%,17m
9875,3,Ghost,3299,248,19,23,42,45.2%,6m
9875,1,[4Taric]OneShot,3299,314,11,7,18,61.1%,18m
9875,3,[DReeMZ]TheQuenster,3299,302,10,18,28,35.7%,41m
9875,3,hahaha,3299,0,5,0,5,100.0%,41m
9875,3,khoejak,3299,30,2,1,3,66.7%,4m
9875,3,MANNY,3299,30,2,4,6,33.3%,13m
9875,3,milkTEA,3299,0,1,2,3,33.3%,19m
9875,3,CocoThunder,3299,0,0,1,1,0.0%,8m
9875,3,FrostyMourne,3299,0,0,1,1,0.0%,30m
9875,3,[kuShy]raijinkroniQ,3299,0,0,2,2,0.0%,20m
9895,3,Kaiizzr,3298,1609,437,405,842,51.9%,29m
9895,2,[KingSC]carlosgs,3298,1499,249,242,491,50.7%,19m
9895,3,Mike,3298,1601,184,182,366,50.3%,6m
9895,3,Teferisixsix,3298,805,111,29,140,79.3%,40m
9895,3,[kØ]Yustaf,3298,1356,96,69,165,58.2%,5m
9895,3,terrenblade,3298,1472,91,89,180,50.6%,19m
9895,3,Extrim,3298,1472,62,63,125,49.6%,39m
9895,3,[2p2]Urinedanger,3298,422,30,27,57,52.6%,5m
9895,3,[AMZN]bleatongordy,3298,756,29,22,51,56.9%,15m
9895,3,leavethegame,3298,245,27,26,53,50.9%,36m
9895,3,OnionHead,3298,410,15,20,35,42.9%,8m
9895,3,bbqlamb,3298,334,14,13,27,51.9%,9m
9895,3,scmike,3298,222,13,5,18,72.2%,30m
9895,3,GrumpyPants,3298,246,11,11,22,50.0%,40m
9895,3,[Pig2]DiVizioN,3298,260,8,8,16,50.0%,41m
9895,3,Cflo,3298,40,6,3,9,66.7%,18m
9895,2,[2fg]SgtSlick,3298,142,5,9,14,35.7%,29m
9895,3,Nowhere,3298,0,4,1,5,80.0%,12m
9895,3,kimyoungs,3298,58,3,1,4,75.0%,14m
9895,3,[RBDUSA]DevStarTimba,3298,30,2,0,2,100.0%,23m
9895,3,[PzC]SiNk,3298,58,2,2,4,50.0%,40m
9895,3,IlIlIIIIII,3298,30,2,2,4,50.0%,24m
9895,3,qnzp,3298,0,2,3,5,40.0%,16m
9918,2,TheNarnian,3297,1522,323,322,645,50.1%,20m
9918,3,tonbob,3297,847,166,149,315,52.7%,10m
9918,2,Minkeys,3297,1353,148,152,300,49.3%,32m
9918,3,ImaDiffBreed,3297,678,83,67,150,55.3%,25m
9918,2,[NutLow]TheMadBomber,3297,1330,59,66,125,47.2%,9m
9918,2,deffno,3297,1043,55,70,125,44.0%,7m
9918,3,AegResolve,3297,485,20,14,34,58.8%,4m
9918,1,newbie,3297,383,15,9,24,62.5%,15m
9918,3,[ØFoxF2]DohKo,3297,90,4,3,7,57.1%,14m
9918,3,[ZrO2]Ryz,3297,30,2,0,2,100.0%,23m
9918,3,lilac,3297,30,1,5,6,16.7%,34m
9918,3,BadKitten,3297,30,1,6,7,14.3%,14m
9918,3,[xRtG]FeaR,3297,0,0,1,1,0.0%,27m
9918,3,yeti,3297,0,0,2,2,0.0%,35m
9932,3,LoveSong,3296,1564,139,146,285,48.8%,16m
9932,3,[WONGS]Hedgz,3296,1069,51,52,103,49.5%,29m
9932,3,[Pharoh]Rainyforest,3296,965,42,33,75,56.0%,3m
9932,3,Krycek,3296,518,18,22,40,45.0%,31m
9932,3,PaintBrush,3296,296,10,14,24,41.7%,4m
9932,3,Newbie,3296,60,6,2,8,75.0%,42m
9932,1,Qwan,3296,97,5,2,7,71.4%,44m
9932,3,twicetherice,3296,115,2,1,3,66.7%,18m
9932,3,Melkor,3296,30,2,1,3,66.7%,17m
9932,3,epochsalvo,3296,0,1,0,1,100.0%,12m
9932,1,ShoeLugs,3296,0,1,1,2,50.0%,23m
9932,3,RESN,3296,30,1,5,6,16.7%,20m
9932,1,[iGOSU]Flamewarrior,3296,0,0,1,1,0.0%,3h
9945,2,Farting,3295,1103,495,517,1012,48.9%,18m
9945,3,[RectEm]TriP,3295,1483,151,145,296,51.0%,17m
9945,3,Tysunami,3295,1598,88,93,181,48.6%,19m
9945,3,WWZ,3295,526,25,19,44,56.8%,28m
9945,3,[INextI]Fenix,3295,574,21,22,43,48.8%,21m
9945,3,fetteheiDi,3295,469,20,19,39,51.3%,20m
9945,3,[mvcs]biaji,3295,453,17,10,27,63.0%,22m
9945,3,Galaxy,3295,189,9,3,12,75.0%,12m
9945,3,NoMad,3295,178,6,13,19,31.6%,7m
9945,3,DonaldPump,3295,118,5,3,8,62.5%,16m
9945,3,[QTclub]Mitz,3295,119,5,4,9,55.6%,11m
9945,3,CtaiXtine,3295,86,4,7,11,36.4%,20m
9945,2,dinnertime,3295,130,3,7,10,30.0%,17m
9945,3,Brutality,3295,30,2,0,2,100.0%,11m
9945,2,Coffee,3295,95,2,0,2,100.0%,2h
9945,3,Shibby,3295,21,1,4,5,20.0%,16m
9945,3,KiLLerKoaLa,3295,0,0,1,1,0.0%,19m
9945,3,jangens,3295,0,0,1,1,0.0%,4m
9945,3,razelazz,3295,0,0,1,1,0.0%,17m
9945,3,errorofdeath,3295,0,0,2,2,0.0%,20m
9965,2,[iMkS]Sebastián,3294,1453,485,472,957,50.7%,33m
9965,2,[Lp]martincito,3294,1583,442,424,866,51.0%,21m
9965,3,Player,3294,1574,320,318,638,50.2%,22m
9965,2,Galo,3294,1124,265,269,534,49.6%,20m
9965,3,[AbcCo]Josuuuuuu,3294,1325,193,161,354,54.5%,11m
9965,3,Alphabet,3294,1528,66,62,128,51.6%,42m
9965,3,TheSense,3294,894,56,51,107,52.3%,24m
9965,3,[FxB]Dyncommon,3294,265,15,18,33,45.5%,15m
9965,3,[EtrOy]BallsMcGee,3294,446,15,25,40,37.5%,21m
9965,3,Gengis,3294,211,6,1,7,85.7%,24m
9965,2,Silver,3294,0,3,2,5,60.0%,60m
9965,3,[ArGNA]TempoJezus,3294,58,2,2,4,50.0%,31m
9965,3,Bareleth,3294,0,1,0,1,100.0%,27m
9965,3,PUBG,3294,0,1,0,1,100.0%,10m
9965,3,benadam,3294,30,1,1,2,50.0%,40m
9965,3,Rheeza,3294,0,0,2,2,0.0%,36m
9981,3,[FyHr]ToyecaX,3293,1493,119,127,246,48.4%,11m
9981,3,FrogSkull,3293,1615,90,70,160,56.2%,12m
9981,3,[Æsir]Tyr,3293,1593,89,84,173,51.4%,41m
9981,3,Sethorak,3293,1429,65,55,120,54.2%,30m
9981,3,RpKCrown,3293,969,61,43,104,58.7%,5m
9981,3,[ValidG]Sujen,3293,708,36,37,73,49.3%,30m
9981,2,Lelouch,3293,914,31,42,73,42.5%,14m
9981,3,ErlantZ,3293,601,24,12,36,66.7%,21m
9981,3,inri,3293,416,14,20,34,41.2%,24m
9981,3,[AUNI]foREVer,3293,246,12,8,20,60.0%,24m
9981,3,Moo,3293,195,11,8,19,57.9%,11m
9981,3,[178]AThenaPrime,3293,225,7,4,11,63.6%,19m
9981,3,qqq,3293,0,4,1,5,80.0%,28m
9981,3,NoobJuice,3293,86,3,2,5,60.0%,19m
9981,3,PickleRick,3293,86,3,4,7,42.9%,40m
9981,1,Vault,3293,97,2,0,2,100.0%,9m
9981,3,Whitedeath,3293,0,1,0,1,100.0%,32m
9981,3,[YF25]CocoChanel,3293,0,1,0,1,100.0%,13m
9981,3,Dane,3293,0,0,1,1,0.0%,14m
10000,2,[suny42]SunnyD,3292,1594,138,139,277,49.8%,15m
10000,3,Fatsmurf,3292,1205,101,78,179,56.4%,3m
10000,3,Puqui,3292,916,35,31,66,53.0%,24m
10000,3,[BUSHes]mancrank,3292,916,35,36,71,49.3%,21m
10000,3,[Molt3n]SpeeeeeeeeeD,3292,490,17,26,43,39.5%,31m
10000,3,Kaus,3292,298,11,2,13,84.6%,10m
10000,3,[funand]Serral,3292,268,10,11,21,47.6%,32m
10000,3,[RBP3]nnm,3292,150,6,8,14,42.9%,5m
10000,3,InfiniteMG,3292,156,5,14,19,26.3%,29m
10000,2,TonySoprano,3292,114,4,15,19,21.1%,7m
10000,3,NeverNude,3292,30,2,0,2,100.0%,4m
10000,3,vapor,3292,58,2,1,3,66.7%,6m
10000,1,bobobo,3292,0,2,2,4,50.0%,44m
10000,1,Notes,3292,0,1,1,2,50.0%,3h
10000,3,[EoMX]BloodRaynor,3292,0,0,1,1,0.0%,2m
10015,3,[AD3C]Zeus,3291,1442,77,74,151,51.0%,27m
10015,3,Vaporflare,3291,922,49,34,83,59.0%,28m
10015,3,irmarcus,3291,727,42,26,68,61.8%,29m
10015,3,[LoFoTr]VadehT,3291,806,40,12,52,76.9%,29m
10015,3,Vanta,3291,548,19,28,47,40.4%,9m
10015,3,Admiral,3291,458,16,20,36,44.4%,27m
10015,3,Timmybob,3291,170,10,13,23,43.5%,34m
10015,3,[xTz]Domdidom,3291,121,5,2,7,71.4%,15m
10015,1,FidgetSpinnr,3291,97,5,2,7,71.4%,2h
10015,1,blink,3291,122,3,4,7,42.9%,32m
10015,3,ZZangbbo,3291,30,2,4,6,33.3%,9m
10026,2,[cl0udM]ITACHI,3290,1459,311,303,614,50.7%,2m
10026,2,Zerosum,3290,1393,109,108,217,50.2%,9m
10026,3,[Vampyr]HotBrushings,3290,1446,100,102,202,49.5%,25m
10026,3,MastrOfOrion,3290,1500,57,67,124,46.0%,31m
10026,3,Vidar,3290,1246,53,49,102,52.0%,18m
10026,3,[SSEAS]NemaR,3290,864,45,42,87,51.7%,41m
10026,2,IIIIIIII,3290,606,23,41,64,35.9%,34m
10026,3,Ashalka,3290,522,22,8,30,73.3%,21m
10026,3,stone,3290,464,16,18,34,47.1%,31m
10026,3,[Jineyo]Maru,3290,359,12,10,22,54.5%,40m
10026,3,TacoTruck,3290,221,10,5,15,66.7%,14m
10026,3,[Whet]CallDown,3290,262,10,6,16,62.5%,16m
10026,3,smorc,3290,147,7,2,9,77.8%,30m
10026,3,Blackjack,3290,168,7,3,10,70.0%,21m
10026,3,Nightwolf,3290,176,6,9,15,40.0%,36m
10026,3,Ziggo,3290,142,5,7,12,41.7%,23m
10026,3,Neo,3290,60,3,1,4,75.0%,20m
10026,3,honker,3290,30,2,0,2,100.0%,7m
10026,3,[ZTemFU]inHALEN,3290,30,2,2,4,50.0%,36m
10026,1,doublespace,3290,0,0,1,1,0.0%,5m
10026,3,[sk3tch]MRGoldenPaws,3290,0,0,1,1,0.0%,39m
10047,3,[BLGA]MadHatter,3289,1585,412,403,815,50.6%,36m
10047,3,Fajardo,3289,1159,136,134,270,50.4%,27m
10047,3,Dojkatronix,3289,1540,81,82,163,49.7%,41m
10047,3,[ARKANO]ochoaguila,3289,1197,47,37,84,56.0%,17m
10047,3,Boris,3289,898,38,43,81,46.9%,11m
10047,3,ASTROMIC,3289,653,34,27,61,55.7%,29m
10047,3,skateblind,3289,463,33,23,56,58.9%,11m
10047,3,PobreJoaquim,3289,800,31,24,55,56.4%,27m
10047,2,XPGaemr,3289,358,29,40,69,42.0%,20m
10047,3,Jay,3289,293,16,9,25,64.0%,2m
10047,3,KdxA,3289,357,13,18,31,41.9%,11m
10047,3,[INextI]CrashoLBN,3289,242,9,6,15,60.0%,19m
10047,3,redbone,3289,256,9,10,19,47.4%,41m
10047,2,IlIlIlIlIlIl,3289,0,4,0,4,100.0%,2h
10047,3,Raynor,3289,86,4,7,11,36.4%,3m
10047,3,[DTokes]Nickonov,3289,60,2,8,10,20.0%,40m
10047,3,[RolIin]Clown,3289,0,1,4,5,20.0%,17m
10047,3,lllMOSLEYlll,3289,30,1,5,6,16.7%,27m
10047,2,Fraska,3289,0,0,1,1,0.0%,26m
10047,3,[Poiint]BRUNO,3289,0,0,4,4,0.0%,28m
10067,3,Bretttibo,3288,1605,232,227,459,50.5%,34m
10067,3,Konig,3288,1624,204,184,388,52.6%,41m
10067,3,[QuenSC]OCL,3288,1453,85,82,167,50.9%,32m
10067,3,RodXander,3288,817,71,65,136,52.2%,41m
10067,3,mYst,3288,762,69,73,142,48.6%,27m
10067,3,follaboyos,3288,780,27,32,59,45.8%,34m
10067,3,Asberic,3288,596,22,17,39,56.4%,6m
10067,3,Grim,3288,311,11,5,16,68.8%,16m
10067,1,llllllllllll,3288,190,7,3,10,70.0%,1h
10067,3,GgMaChine,3288,158,5,0,5,100.0%,17m
10067,3,Taoki,3288,124,5,10,15,33.3%,19m
10067,2,[TCBT]Bota,3288,0,4,1,5,80.0%,3h
10067,3,bluebearsolo,3288,0,4,1,5,80.0%,10m
10067,3,[E77ect]KingAli,3288,86,4,2,6,66.7%,38m
10067,2,[FlTM]Tohka,3288,0,3,1,4,75.0%,1h
10067,2,RuneKj,3288,135,3,3,6,50.0%,7m
10067,3,[xTBaGx]GOOFYGOOBER,3288,90,3,12,15,20.0%,13m
10067,3,Zulivan,3288,30,2,1,3,66.7%,13m
10067,3,[PWNDya]Rlat,3288,0,1,0,1,100.0%,10m
10067,2,MohammerD,3288,0,1,1,2,50.0%,10m
10067,2,bepCito,3288,0,0,1,1,0.0%,43m
10067,2,Brofish,3288,0,0,1,1,0.0%,6m
10067,3,[PL0TE]HappyGilmore,3288,0,0,1,1,0.0%,27m
10067,3,MrPeeKaBoO,3288,0,0,3,3,0.0%,28m
10067,3,[BoAVN]Ashura,3288,0,0,3,3,0.0%,21m
10092,3,DirectTester,3287,1532,157,139,296,53.0%,9m
10092,3,DeDoSo,3287,1006,65,63,128,50.8%,16m
10092,3,Magnusgo,3287,1237,49,39,88,55.7%,28m
10092,3,sahaquiel,3287,1037,46,33,79,58.2%,39m
10092,3,Warbux,3287,655,46,56,102,45.1%,9m
10092,3,toiletduck,3287,796,35,20,55,63.6%,32m
10092,3,iiLJHii,3287,952,35,44,79,44.3%,30m
10092,3,[DHZ0ne]Vicarious,3287,450,18,14,32,56.2%,25m
10092,1,[xDYEx]KLO,3287,333,15,7,22,68.2%,39m
10092,3,KainGonuyo,3287,290,13,7,20,65.0%,8m
10092,3,[sa1t]BigFungus,3287,326,11,19,30,36.7%,17m
10092,3,[GirlPW]Blink,3287,214,9,3,12,75.0%,34m
10092,3,[Quetza]Warsong,3287,148,7,4,11,63.6%,28m
10092,3,Maru,3287,107,6,4,10,60.0%,42m
10092,3,gasbreakdip,3287,204,6,10,16,37.5%,9m
10092,3,[αB]Geeth,3287,114,4,2,6,66.7%,17m
10092,3,Wingz,3287,60,3,2,5,60.0%,10m
10092,3,slopynonsens,3287,0,2,1,3,66.7%,14m
10092,3,[TGosuB]Snailbait,3287,0,0,2,2,0.0%,28m
10111,3,deadhero,3286,1577,388,365,753,51.5%,16m
10111,3,KissShot,3286,1607,153,150,303,50.5%,26m
10111,3,Sigismundo,3286,1643,129,127,256,50.4%,32m
10111,3,[LGNxx]GHOST,3286,384,91,23,114,79.8%,3m
10111,3,CobraKai,3286,300,10,16,26,38.5%,5m
10111,3,[Pharoh]Alexander,3286,254,9,9,18,50.0%,18m
10111,2,[cl0udM]Smileey,3286,92,4,15,19,21.1%,32m
10111,3,[NPhasA]MarinePrince,3286,30,1,4,5,20.0%,10m
10111,3,[EZTAXI]GreatGoomba,3286,0,0,1,1,0.0%,4m
10111,3,[Crane]IceWolf,3286,0,0,2,2,0.0%,30m
10121,3,JokingForYou,3285,1491,194,171,365,53.2%,20m
10121,3,lachancla,3285,1487,62,57,119,52.1%,24m
10121,3,PBnJ,3285,909,38,27,65,58.5%,14m
10121,3,[KANOS]Kanopix,3285,495,34,37,71,47.9%,6m
10121,2,[Atone]angrykitten,3285,554,22,21,43,51.2%,34m
10121,3,Syntix,3285,348,14,8,22,63.6%,27m
10121,3,TulakHord,3285,194,8,5,13,61.5%,35m
10121,3,[No0Bs]Gintoki,3285,60,2,5,7,28.6%,3m
10121,3,HandiQuacked,3285,30,1,3,4,25.0%,20m
10121,1,ShadowFox,3285,0,0,1,1,0.0%,8m
10131,3,[αXLa]CAPVAM,3284,914,63,68,131,48.1%,20m
10131,3,[25ZAIS]Blackarrow,3284,1246,62,48,110,56.4%,4m
10131,3,[TGCrew]Sesso,3284,817,34,32,66,51.5%,4m
10131,3,[FyHr]Raúl,3284,460,17,16,33,51.5%,41m
10131,3,Nanomite,3284,404,14,22,36,38.9%,32m
10131,3,[Pr0h4x]FiRiST,3284,338,13,11,24,54.2%,14m
10131,3,JosephBidens,3284,0,5,1,6,83.3%,9m
10131,3,[GDTAzT]LSxNarGusx,3284,187,5,2,7,71.4%,30m
10131,3,MichaelBremi,3284,0,4,1,5,80.0%,18m
10131,3,GigglyFart,3284,114,4,4,8,50.0%,41m
10131,3,lotsofwind,3284,60,3,2,5,60.0%,18m
10131,3,Babuined,3284,86,3,4,7,42.9%,2m
10131,3,SKTIBANKY,3284,62,2,8,10,20.0%,6m
10131,3,JukeLuke,3284,0,1,0,1,100.0%,11m
10131,3,[KAGUSA]SparK,3284,0,1,0,1,100.0%,10m
10131,3,Abadon,3284,30,1,7,8,12.5%,17m
10131,3,Throatpoker,3284,0,0,1,1,0.0%,27m
10131,3,FireKill,3284,0,0,1,1,0.0%,31m
10131,3,[ANIMOO]hurdler,3284,0,0,2,2,0.0%,17m
10150,3,MDCConline,3283,1540,164,148,312,52.6%,5m
10150,3,WorstSCer,3283,605,141,130,271,52.0%,16m
10150,3,xTHExREAPERx,3283,1118,120,101,221,54.3%,7m
10150,3,[YD2K]TheMIHM,3283,1491,118,103,221,53.4%,41m
10150,3,denuden,3283,1158,66,51,117,56.4%,13m
10150,3,Virtue,3283,309,23,22,45,51.1%,28m
10150,3,IlllIlIllIIl,3283,543,21,14,35,60.0%,30m
10150,3,[INextI]Colitaz,3283,420,14,24,38,36.8%,12m
10150,1,KarhAn,3283,179,8,2,10,80.0%,1h
10150,3,Inspirit,3283,142,5,5,10,50.0%,15m
10150,3,TrainerOne,3283,82,3,1,4,75.0%,36m
10150,3,Only,3283,0,3,1,4,75.0%,34m
10150,3,Jass,3283,60,3,4,7,42.9%,15m
10150,3,Alejandro,3283,0,2,3,5,40.0%,19m
10150,3,OmegaRugal,3283,30,1,2,3,33.3%,15m
10150,3,[WuTang]GZA,3283,30,1,3,4,25.0%,41m
10150,3,[fagz]HarstemPupil,3283,0,0,1,1,0.0%,20m
10150,3,[BONES]KingSage,3283,0,0,2,2,0.0%,11m
10168,3,Clossius,3282,446,75,57,132,56.8%,34m
10168,3,youngpug,3282,1612,70,53,123,56.9%,42m
10168,3,[LimaSC]TaeJa,3282,378,14,18,32,43.8%,8m
10168,3,[SCboys]zxmmxzzxmmxz,3282,247,10,6,16,62.5%,42m
10168,3,[FkJeff]laozi,3282,222,9,4,13,69.2%,2m
10168,3,Maximus,3282,212,8,15,23,34.8%,11m
10168,3,[ggNtus]Exprtispros,3282,155,7,4,11,63.6%,41m
10168,2,sirsuckalot,3282,0,4,1,5,80.0%,42m
10168,3,[WN1]sPAWn,3282,0,4,1,5,80.0%,29m
10168,3,Coldspell,3282,58,2,6,8,25.0%,30m
10168,3,fren,3282,0,1,1,2,50.0%,21m
10168,1,Jahazzera,3282,0,1,1,2,50.0%,6m
10168,3,[hTx]Galaxi,3282,30,1,4,5,20.0%,9m
10168,3,Bman,3282,0,0,1,1,0.0%,17m
10168,3,Venom,3282,0,0,1,1,0.0%,2m
10183,2,Radamanthis,3281,1352,121,120,241,50.2%,20m
10183,3,cooc,3281,1522,78,80,158,49.4%,21m
10183,3,[xLEOx]BumRushOG,3281,826,36,20,56,64.3%,38m
10183,3,SoloSav,3281,889,34,27,61,55.7%,20m
10183,3,[PUFFN]HeresTheDeal,3281,540,23,10,33,69.7%,42m
10183,3,Durden,3281,519,20,14,34,58.8%,17m
10183,3,yokase,3281,443,19,15,34,55.9%,41m
10183,3,[SCmTS]unreaL,3281,400,16,12,28,57.1%,36m
10183,3,Satori,3281,353,13,5,18,72.2%,11m
10183,3,xSHYNE,3281,228,8,5,13,61.5%,27m
10183,2,[StepUp]DirtyFlamer,3281,203,6,2,8,75.0%,5m
10183,3,Aegis,3281,174,6,8,14,42.9%,4m
10183,3,[OMWTG]KeltWarrior,3281,114,5,2,7,71.4%,4m
10183,3,mengnan,3281,120,5,3,8,62.5%,31m
10183,1,bluetears,3281,161,5,5,10,50.0%,37m
10183,2,sothea,3281,0,4,1,5,80.0%,44m
10183,3,[YBOR]Goliath,3281,114,4,4,8,50.0%,27m
10183,3,Brobie,3281,30,2,1,3,66.7%,13m
10183,3,servantofvan,3281,58,2,2,4,50.0%,20m
10183,2,KenZo,3281,0,1,0,1,100.0%,28m
10183,3,Skedoinker,3281,0,0,3,3,0.0%,17m
10204,3,CeberousMan,3280,1247,74,65,139,53.2%,18m
10204,3,[MSotU]Mustang,3280,1514,64,72,136,47.1%,35m
10204,3,[LGNxx]Bellephron,3280,1078,59,50,109,54.1%,40m
10204,3,September,3280,1255,53,40,93,57.0%,27m
10204,3,Coffee,3280,1018,52,48,100,52.0%,6m
10204,3,lol,3280,435,43,19,62,69.4%,2m
10204,3,GameBoy,3280,817,36,20,56,64.3%,14m
10204,3,Jacobyjones,3280,507,20,13,33,60.6%,36m
10204,3,Veznite,3280,408,19,22,41,46.3%,37m
10204,3,leDaniels,3280,301,13,8,21,61.9%,10m
10204,3,[RumG]Vynillia,3280,326,13,10,23,56.5%,9m
10204,3,Duard,3280,268,10,10,20,50.0%,27m
10204,3,zzzz,3280,182,9,4,13,69.2%,29m
10204,3,[TgAg]Tex,3280,213,7,7,14,50.0%,36m
10204,3,[eDGs]TroNiCk,3280,174,6,11,17,35.3%,36m
10204,3,Elfleischo,3280,96,5,1,6,83.3%,16m
10204,3,NoTvT,3280,58,3,1,4,75.0%,7m
10204,3,RideSix,3280,0,1,2,3,33.3%,24m
10204,3,Mathias,3280,0,1,2,3,33.3%,31m
10204,3,Mackky,3280,30,1,6,7,14.3%,11m
10204,3,[NPhasA]Cutepants,3280,0,0,1,1,0.0%,8m
10204,3,[8zzzzD]DRAN,3280,0,0,1,1,0.0%,6m
10204,3,[DRKDMN]RearWithGear,3280,0,0,1,1,0.0%,38m
10204,3,[VENSC2]Pyro,3280,0,0,4,4,0.0%,5m
10228,3,PotatoPc,3279,1292,73,65,138,52.9%,34m
10228,3,[Nia2u]Interference,3279,647,67,55,122,54.9%,3m
10228,3,[nieBla]UltraMarine,3279,704,46,46,92,50.0%,14m
10228,3,Capsnip,3279,380,15,10,25,60.0%,42m
10228,3,[Fir3s]StillFly,3279,122,4,7,11,36.4%,23m
10228,3,HariWaldQc,3279,30,2,4,6,33.3%,25m
10234,3,[kapas]Richard,3278,1611,98,81,179,54.7%,21m
10234,3,TheFrantics,3278,580,24,12,36,66.7%,25m
10234,3,Leituz,3278,555,24,16,40,60.0%,41m
10234,3,[proChi]Demonios,3278,303,12,4,16,75.0%,9m
10234,2,guilhem,3278,304,12,7,19,63.2%,16m
10234,3,FaddyJosh,3278,232,10,6,16,62.5%,17m
10234,3,BCrushONLY,3278,0,4,1,5,80.0%,28m
10234,3,Pyro,3278,0,1,0,1,100.0%,35m
10234,3,[2540]CHAS,3278,0,1,0,1,100.0%,10m
10234,3,[hTx]EyesRSquared,3278,0,0,1,1,0.0%,41m
10234,3,Pesi,3278,0,0,1,1,0.0%,5m
10234,3,[Iewd]StarTaleSuzy,3278,0,0,1,1,0.0%,23m
10234,3,MECHANICS,3278,0,0,2,2,0.0%,28m
10247,3,[SsaYnS]subfive,3277,1186,101,91,192,52.6%,16m
10247,3,[TAW]DigitZ,3277,1129,95,97,192,49.5%,16m
10247,3,[StCh]Dekkum,3277,793,69,80,149,46.3%,26m
10247,3,Neptune,3277,608,20,31,51,39.2%,10m
10247,3,NeutrinO,3277,170,10,5,15,66.7%,24m
10247,2,[LgnTDS]gtCheticus,3277,238,7,15,22,31.8%,13m
10247,3,[2015]KimDaeKyung,3277,0,4,1,5,80.0%,32m
10247,3,IamDerp,3277,0,3,2,5,60.0%,13m
10247,3,slazio,3277,30,2,3,5,40.0%,15m
10247,3,HyperDragoon,3277,60,2,4,6,33.3%,20m
10247,2,Wolk,3277,0,1,0,1,100.0%,11m
10247,1,daves,3277,93,1,3,4,25.0%,34m
10259,2,[Tankem]TerranosauR,3276,1616,543,554,1097,49.5%,20m
10259,3,XQzMe,3276,1540,359,356,715,50.2%,20m
10259,2,Kablamo,3276,845,114,115,229,49.8%,32m
10259,3,YiSuS,3276,905,95,80,175,54.3%,38m
10259,3,[Abncay]OuroBoroS,3276,730,29,32,61,47.5%,26m
10259,3,[ZTemp]Runtime,3276,587,26,18,44,59.1%,1m
10259,3,EPax,3276,198,8,8,16,50.0%,29m
10259,3,turboworm,3276,215,7,1,8,87.5%,34m
10259,2,Hastatii,3276,141,5,2,7,71.4%,3h
10259,3,cam,3276,114,5,3,8,62.5%,26m
10259,3,HandBanana,3276,76,3,5,8,37.5%,37m
10259,3,Hero,3276,0,1,0,1,100.0%,39m
10259,3,[DRONGO]FirSTBloOD,3276,0,1,0,1,100.0%,38m
10259,3,[EnTrpY]Suicideking,3276,0,1,4,5,20.0%,13m
10259,3,KIWIBSC,3276,0,0,1,1,0.0%,5m
10259,3,[DSF3]FoxeR,3276,0,0,1,1,0.0%,24m
10259,3,[llII]kaysik,3276,0,0,1,1,0.0%,11m
10259,3,[HØST]NoOne,3276,0,0,1,1,0.0%,14m
10259,3,Mugen,3276,0,0,1,1,0.0%,30m
10259,3,Crylog,3276,0,0,1,1,0.0%,17m
10259,3,fgrds,3276,0,0,2,2,0.0%,14m
10259,3,Jimbravo,3276,0,0,3,3,0.0%,15m
10259,3,[xR1x]iNfEsTaTiOn,3276,0,0,5,5,0.0%,3m
10282,3,[copain]Automne,3275,1530,191,182,373,51.2%,40m
10282,3,Zerglings,3275,878,40,29,69,58.0%,30m
10282,3,Santiago,3275,668,26,17,43,60.5%,2m
10282,3,FeNiX,3275,377,19,7,26,73.1%,25m
10282,3,Sulluukun,3275,300,11,19,30,36.7%,11m
10282,3,IAMCHEESEND,3275,165,8,4,12,66.7%,15m
10282,1,ZroCuuLong,3275,46,5,3,8,62.5%,45m
10282,3,CaptHELLiCAN,3275,60,3,2,5,60.0%,6m
10282,3,Zebolt,3275,62,3,6,9,33.3%,6m
10282,3,inLeaD,3275,30,2,1,3,66.7%,36m
10282,1,Acrimony,3275,48,2,1,3,66.7%,47m
10282,3,basedRedPill,3275,0,1,6,7,14.3%,30m
10282,1,omG,3275,0,0,2,2,0.0%,7m
10295,3,melin,3274,1602,129,127,256,50.4%,6m
10295,2,JIXMIXFIX,3274,1051,122,127,249,49.0%,2m
10295,3,rolex,3274,1421,96,75,171,56.1%,14m
10295,3,Chunk,3274,1344,71,53,124,57.3%,18m
10295,3,Daja,3274,996,37,33,70,52.9%,41m
10295,3,Lingu,3274,824,36,51,87,41.4%,41m
10295,3,[RANDYZ]PickleLo,3274,896,35,33,68,51.5%,23m
10295,3,EvO,3274,442,33,37,70,47.1%,11m
10295,3,Pulsar,3274,591,25,16,41,61.0%,36m
10295,3,[SkyNA]VORTEX,3274,520,22,14,36,61.1%,39m
10295,3,PinkFrog,3274,278,10,12,22,45.5%,35m
10295,1,Reave,3274,210,9,2,11,81.8%,4m
10295,3,Grape,3274,88,5,3,8,62.5%,16m
10295,3,Junga,3274,91,5,4,9,55.6%,15m
10295,3,Ticonderoga,3274,60,2,3,5,40.0%,11m
10295,3,Zannall,3274,0,1,0,1,100.0%,33m
10295,3,Virtue,3274,0,0,1,1,0.0%,41m
10295,2,Valkyrie,3274,0,0,1,1,0.0%,1h
10313,3,niucas,3273,1585,173,167,340,50.9%,19m
10313,3,SebasElNoob,3273,845,72,75,147,49.0%,39m
10313,3,CaptainSexi,3273,1050,45,37,82,54.9%,30m
10313,3,nammer,3273,903,39,25,64,60.9%,9m
10313,3,NukeKing,3273,530,21,14,35,60.0%,3m
10313,3,IIlIIIlIlII,3273,500,20,18,38,52.6%,38m
10313,2,llllllllllll,3273,138,7,5,12,58.3%,7m
10313,3,Sakuretsu,3273,142,6,5,11,54.5%,19m
10313,3,AlmostDie,3273,154,5,10,15,33.3%,36m
10313,3,Garly,3273,30,4,3,7,57.1%,7m
10313,3,DanLou,3273,30,2,0,2,100.0%,18m
10313,3,[GOPERÚ]YosHymitsu,3273,0,1,0,1,100.0%,42m
10313,3,[hardfy]acidheart,3273,0,1,1,2,50.0%,9m
10313,3,[Alpaka]Nordy,3273,0,0,1,1,0.0%,3m
10313,3,Gliese,3273,0,0,1,1,0.0%,24m
10313,3,Microman,3273,0,0,3,3,0.0%,6m
10329,3,ahahahhahaha,3272,1575,323,308,631,51.2%,21m
10329,3,[INextI]MechaMarine,3272,1555,163,161,324,50.3%,20m
10329,3,maniac,3272,1036,96,89,185,51.9%,42m
10329,3,wlrea,3272,1590,69,50,119,58.0%,12m
10329,3,xXCrudeXx,3272,643,59,61,120,49.2%,9m
10329,3,CANCEL,3272,1155,51,47,98,52.0%,39m
10329,3,LeMaître,3272,585,30,10,40,75.0%,30m
10329,3,[SRT4]Starfire,3272,774,30,32,62,48.4%,11m
10329,2,BoGrIM,3272,550,24,36,60,40.0%,28m
10329,2,bege,3272,772,24,42,66,36.4%,36m
10329,3,Qwan,3272,222,11,4,15,73.3%,26m
10329,3,skrtskrrrrt,3272,244,9,8,17,52.9%,15m
10329,3,slikpnot,3272,268,9,11,20,45.0%,34m
10329,3,Grunzi,3272,130,6,2,8,75.0%,6m
10329,2,Shadouf,3272,0,4,1,5,80.0%,3h
10329,1,KitoO,3272,97,3,4,7,42.9%,30m
10329,3,llllllllllll,3272,95,2,0,2,100.0%,32m
10329,3,Nova,3272,58,2,1,3,66.7%,3m
10329,3,[GnR]GoodBoy,3272,30,2,4,6,33.3%,12m
10329,3,LikeaBOSS,3272,0,1,0,1,100.0%,6m
10329,3,TalknToilet,3272,30,1,1,2,50.0%,12m
10329,3,kad,3272,30,1,2,3,33.3%,28m
10329,3,SirWhite,3272,0,1,4,5,20.0%,31m
10329,1,[3TT]MarkM,3272,97,1,6,7,14.3%,2h
10329,3,Taz,3272,0,0,1,1,0.0%,3m
10329,3,[Noom]JossA,3272,0,0,1,1,0.0%,17m
10329,2,IMOp,3272,0,0,1,1,0.0%,42m
10356,3,[eexp]runemarauder,3271,363,57,54,111,51.4%,41m
10356,3,Xeralak,3271,955,38,32,70,54.3%,16m
10356,3,jizzzstain,3271,510,30,14,44,68.2%,2m
10356,3,Green,3271,170,6,5,11,54.5%,19m
10356,3,jqju,3271,0,4,1,5,80.0%,5m
10356,1,jlawbuns,3271,0,4,2,6,66.7%,24m
10356,3,[Bipin]Varmina,3271,48,3,5,8,37.5%,42m
10356,3,HARDLYWOOD,3271,28,2,4,6,33.3%,41m
10356,3,Mishka,3271,0,1,0,1,100.0%,9m
10356,3,[GRLG]MukifoTV,3271,0,1,0,1,100.0%,10m
10356,3,[SFUSC]COMBATWOMBAT,3271,0,1,1,2,50.0%,16m
10356,3,[AUNI]Oranges,3271,0,0,1,1,0.0%,14m
10356,3,[uaCyka]SpaRk,3271,0,0,1,1,0.0%,23m
10369,3,Muffinman,3270,963,289,273,562,51.4%,6m
10369,3,JPD,3270,1443,71,61,132,53.8%,35m
10369,3,[INextI]Voder,3270,1031,67,61,128,52.3%,36m
10369,3,ragnarwin,3270,892,46,49,95,48.4%,18m
10369,3,Shrek,3270,1096,42,45,87,48.3%,14m
10369,3,[TPGGXD]ELRICK,3270,771,33,19,52,63.5%,25m
10369,3,TheWildWeast,3270,454,17,16,33,51.5%,2m
10369,3,Jester,3270,378,14,12,26,53.8%,40m
10369,2,Forkstealer,3270,360,11,25,36,30.6%,32m
10369,3,[tCo9]Hilikus,3270,192,8,2,10,80.0%,20m
10369,3,llamasrule,3270,60,5,3,8,62.5%,41m
10369,2,hia,3270,0,4,1,5,80.0%,1h
10369,3,MeTaLisKGay,3270,0,4,1,5,80.0%,13m
10369,3,[Bee]TheFryRice,3270,30,2,0,2,100.0%,14m
10369,3,[SANDLR]IIllIllIlllI,3270,36,2,3,5,40.0%,10m
10369,3,Toxozus,3270,30,2,6,8,25.0%,10m
10369,3,Returns,3270,0,1,1,2,50.0%,11m
10369,3,[EGx]RicardoMilos,3270,0,1,3,4,25.0%,15m
10369,3,[420MA]goodone,3270,0,0,1,1,0.0%,13m
10369,3,[Kaii]RnGDaN,3270,0,0,1,1,0.0%,17m
10389,3,Prime,3269,1428,143,143,286,50.0%,13m
10389,3,yoyo,3269,917,76,83,159,47.8%,5m
10389,3,[WHSc]navenitram,3269,1338,64,61,125,51.2%,14m
10389,3,OliveOx,3269,1027,62,64,126,49.2%,20m
10389,3,EyeHoles,3269,420,38,24,62,61.3%,30m
10389,3,chris,3269,497,23,9,32,71.9%,38m
10389,3,VoteByMail,3269,533,21,10,31,67.7%,24m
10389,3,DNA,3269,349,18,20,38,47.4%,20m
10389,3,[UpxV]ramper,3269,226,9,10,19,47.4%,20m
10389,3,TheFleet,3269,195,8,6,14,57.1%,5m
10389,2,Hasted,3269,254,8,13,21,38.1%,27m
10389,3,WhoAU,3269,58,6,2,8,75.0%,18m
10389,3,KingOfGods,3269,154,6,9,15,40.0%,42m
10389,3,[FUNK7]Shewz,3269,154,6,11,17,35.3%,5m
10389,3,WOLF,3269,155,6,17,23,26.1%,34m
10389,3,Foundering,3269,86,4,0,4,100.0%,28m
10389,2,DVE,3269,0,3,2,5,60.0%,2h
10389,3,General,3269,30,2,1,3,66.7%,17m
10389,3,Anna,3269,0,0,1,1,0.0%,39m
10389,3,[GeekA]nilacort,3269,0,0,2,2,0.0%,27m
10389,2,Ninja,3269,0,0,2,2,0.0%,48m
10389,3,mookao,3269,0,0,8,8,0.0%,18m
10411,3,LOBO,3268,1584,294,272,566,51.9%,30m
10411,3,[B0G]Tone,3268,1604,144,134,278,51.8%,31m
10411,3,IlIlIlIlIlIl,3268,1488,100,87,187,53.5%,9m
10411,3,HydricAcid,3268,1179,73,54,127,57.5%,25m
10411,3,[iMkS]Dnzo,3268,681,42,45,87,48.3%,9m
10411,3,[LoF]Tico,3268,1026,37,42,79,46.8%,42m
10411,3,DrewShow,3268,738,30,19,49,61.2%,5m
10411,3,CoffeeCup,3268,325,21,24,45,46.7%,42m
10411,2,Love,3268,138,15,30,45,33.3%,39m
10411,3,[BSSG]LaCucaracha,3268,358,14,9,23,60.9%,3m
10411,3,Sinsa,3268,0,4,1,5,80.0%,29m
10411,2,Summer,3268,0,4,1,5,80.0%,58m
10411,3,[TeamUR]squiGGles,3268,88,3,2,5,60.0%,42m
10411,3,fig,3268,30,2,0,2,100.0%,36m
10411,3,[MHack]SURREAL,3268,0,0,2,2,0.0%,18m
10426,3,[DRKPMT]Neverlast,3267,1542,113,107,220,51.4%,3m
10426,3,[EvilGC]Raphae,3267,1223,70,45,115,60.9%,35m
10426,3,[Toxity]liberty,3267,1266,59,39,98,60.2%,23m
10426,3,ProtonDecay,3267,751,59,56,115,51.3%,16m
10426,3,bearUSC,3267,1127,54,50,104,51.9%,11m
10426,3,[INextI]MachinClaun,3267,745,52,45,97,53.6%,25m
10426,2,YooperTown,3267,866,35,49,84,41.7%,13m
10426,3,Salas,3267,276,22,21,43,51.2%,31m
10426,3,BeuhShoot,3267,427,21,8,29,72.4%,17m
10426,3,hoop,3267,464,17,19,36,47.2%,35m
10426,3,Tweeter,3267,434,14,22,36,38.9%,41m
10426,3,Echo,3267,240,10,6,16,62.5%,12m
10426,3,Classics,3267,214,9,3,12,75.0%,12m
10426,3,NerdyGammer,3267,119,7,1,8,87.5%,30m
10426,2,HiyoriKazane,3267,248,7,10,17,41.2%,27m
10426,3,[VENSC2]Espectro,3267,86,3,3,6,50.0%,2m
10426,3,[KAYOSS]savagefox,3267,88,3,4,7,42.9%,14m
10426,3,Skittles,3267,92,3,7,10,30.0%,40m
10426,2,GETABETTERIQ,3267,58,3,10,13,23.1%,35m
10426,3,beyond,3267,30,2,1,3,66.7%,42m
10426,3,Djurosaur,3267,0,1,0,1,100.0%,10m
10447,2,[hephap]Toneman,3266,1550,231,226,457,50.5%,27m
10447,3,[TRETER]Prilust,3266,1565,145,144,289,50.2%,34m
10447,3,[PPTr]SpruceTurtle,3266,913,107,76,183,58.5%,13m
10447,3,[Zorra]LpLoYer,3266,1546,63,49,112,56.2%,10m
10447,3,[DOMP]GorillaZ,3266,671,27,21,48,56.2%,35m
10447,3,Chironx,3266,680,27,28,55,49.1%,27m
10447,3,MDMA,3266,372,23,11,34,67.6%,30m
10447,3,coldhand,3266,520,21,19,40,52.5%,34m
10447,2,[UoM]Borlin,3266,416,18,26,44,40.9%,36m
10447,3,venuslux,3266,255,8,3,11,72.7%,32m
10447,3,[TAsc]iloveyouexe,3266,230,8,9,17,47.1%,5m
10447,3,[LQV]Starklok,3266,236,8,13,21,38.1%,35m
10447,3,Netolip,3266,0,4,1,5,80.0%,19m
10447,3,Sluipen,3266,88,3,7,10,30.0%,25m
10447,3,[Poodin]Kush,3266,30,2,3,5,40.0%,16m
10447,3,[XTLR]Josh,3266,0,1,0,1,100.0%,36m
10447,3,Castalot,3266,0,1,1,2,50.0%,39m
10447,3,GoOdy,3266,30,1,2,3,33.3%,30m
10447,3,[SASHA1]Bunny,3266,0,0,1,1,0.0%,1m
10466,3,[Shota]Lakshmi,3265,1598,118,98,216,54.6%,42m
10466,3,Yoyui,3265,925,106,86,192,55.2%,14m
10466,3,CapTryhard,3265,1452,91,88,179,50.8%,14m
10466,3,FeLiUs,3265,1208,57,46,103,55.3%,20m
10466,3,[Twitch]FishStix,3265,1248,52,40,92,56.5%,3m
10466,3,TheMilkMan,3265,851,34,31,65,52.3%,17m
10466,3,Prosophilic,3265,864,34,35,69,49.3%,25m
10466,3,NiceHat,3265,596,28,18,46,60.9%,25m
10466,3,Cayeuf,3265,679,27,27,54,50.0%,12m
10466,3,Psalms,3265,404,15,16,31,48.4%,42m
10466,3,[7B]BestOfSeven,3265,246,10,16,26,38.5%,25m
10466,3,santeniel,3265,30,5,2,7,71.4%,5m
10466,3,StefanLöfven,3265,121,3,3,6,50.0%,17m
10466,3,ZERVERUZ,3265,90,3,4,7,42.9%,39m
10466,3,maru,3265,30,2,1,3,66.7%,35m
10466,3,Soul,3265,36,2,2,4,50.0%,36m
10466,3,[BNITOS]alaz,3265,0,1,0,1,100.0%,32m
10466,3,Parasite,3265,30,1,8,9,11.1%,2m
10466,3,Milo,3265,0,0,1,1,0.0%,11m
10466,3,Verndawg,3265,0,0,2,2,0.0%,3m
10466,2,[TgAg]ExoYimmY,3265,0,0,5,5,0.0%,47m
10466,3,TaeKwonDOH,3265,0,0,6,6,0.0%,37m
10488,2,[DhZAc1]Dedas,3264,1349,116,127,243,47.7%,10m
10488,3,XIII,3264,1412,56,47,103,54.4%,35m
10488,3,[DarkAG]WHOSFIRST,3264,1234,43,53,96,44.8%,36m
10488,3,Falmeer,3264,291,24,17,41,58.5%,31m
10488,3,RAGE,3264,381,16,11,27,59.3%,10m
10488,3,Dares,3264,360,15,2,17,88.2%,26m
10488,1,[uEZaF]SadInPeru,3264,144,7,2,9,77.8%,19m
10488,3,BadManner,3264,140,6,4,10,60.0%,14m
10488,3,NikkeZ,3264,114,5,1,6,83.3%,11m
10488,2,DKinSC,3264,0,4,1,5,80.0%,42m
10488,3,TooSly,3264,30,4,3,7,57.1%,17m
10488,3,[WarLT]DrDre,3264,122,3,5,8,37.5%,7m
10488,2,levenpeven,3264,0,1,0,1,100.0%,48m
10488,3,Trump,3264,0,1,1,2,50.0%,15m
10488,2,[Fir3s]LiquidCurage,3264,30,1,11,12,8.3%,12m
10488,3,Terminator,3264,0,0,1,1,0.0%,21m
10488,3,[BoAVN]AsuraSC,3264,0,0,1,1,0.0%,30m
10505,3,ghost,3263,1591,150,135,285,52.6%,38m
10505,3,DogChasnTail,3263,1604,127,109,236,53.8%,22m
10505,3,Oldpennter,3263,1359,124,126,250,49.6%,35m
10505,3,Riocks,3263,1558,123,109,232,53.0%,24m
10505,3,Guile,3263,884,95,100,195,48.7%,32m
10505,2,Kaizen,3263,341,93,96,189,49.2%,10m
10505,3,[ShNK]DeathGun,3263,1595,91,53,144,63.2%,17m
10505,3,[eX]Garlufio,3263,714,29,22,51,56.9%,12m
10505,3,[HØST]SAYRUS,3263,430,15,23,38,39.5%,11m
10505,3,Kugeda,3263,248,10,5,15,66.7%,12m
10505,3,Millioncomma,3263,274,10,13,23,43.5%,17m
10505,3,[RPQC]RagingDiablo,3263,88,3,2,5,60.0%,4m
10505,3,Helloladys,3263,30,2,0,2,100.0%,31m
10505,3,[HaZaR]Infinity,3263,58,2,1,3,66.7%,42m
10505,3,DarkTemplar,3263,58,2,2,4,50.0%,9m
10505,3,LossArtist,3263,0,1,0,1,100.0%,23m
10505,3,Angeloawawa,3263,0,1,1,2,50.0%,41m
10505,3,kadoeo,3263,0,0,3,3,0.0%,25m
10523,3,timegosu,3262,1602,91,82,173,52.6%,15m
10523,3,GoobJoob,3262,902,86,81,167,51.5%,39m
10523,3,[ExcIgN]Aldharin,3262,1415,68,50,118,57.6%,17m
10523,3,DeltaStar,3262,1218,48,42,90,53.3%,24m
10523,3,[xLgNx]Theprobe,3262,885,40,25,65,61.5%,37m
10523,3,[EZDUNK]MICROJACKSON,3262,567,22,16,38,57.9%,42m
10523,3,Kronus,3262,384,19,8,27,70.4%,5m
10523,3,Meemoo,3262,243,16,15,31,51.6%,25m
10523,3,KitCOmE,3262,279,11,4,15,73.3%,27m
10523,3,Geanthor,3262,138,5,2,7,71.4%,20m
10523,2,Raven,3262,0,4,1,5,80.0%,3h
10523,3,Julia,3262,126,4,10,14,28.6%,32m
10523,3,[FenGCN]MrMeepO,3262,60,3,3,6,50.0%,2m
10523,2,BilluPillu,3262,134,3,5,8,37.5%,37m
10523,3,Funzo,3262,0,1,1,2,50.0%,33m
10523,3,Adroseth,3262,30,1,7,8,12.5%,15m
10523,3,[MEP]Mephisto,3262,0,0,3,3,0.0%,31m
10540,3,iSuckAtCraft,3261,1633,273,266,539,50.6%,41m
10540,3,Harkonnen,3261,1129,50,33,83,60.2%,42m
10540,3,[3D]Dauntless,3261,922,35,38,73,47.9%,20m
10540,3,[IOrdoI]RUNEGooN,3261,470,18,12,30,60.0%,24m
10540,3,Rathma,3261,265,11,5,16,68.8%,17m
10540,3,[Parkto]COULDBE,3261,252,8,16,24,33.3%,31m
10540,3,[TGosuC]Dimaria,3261,114,5,2,7,71.4%,10m
10540,3,CPA,3261,122,5,4,9,55.6%,41m
10540,3,[ACM1TP]ZAZ,3261,30,4,2,6,66.7%,25m
10540,3,Button,3261,0,3,3,6,50.0%,13m
10540,3,knighty,3261,30,2,0,2,100.0%,23m
10540,3,Penetrate,3261,0,0,2,2,0.0%,34m
10552,2,[Ash3s]StarsFallDim,3260,1535,129,144,273,47.3%,34m
10552,3,CMDSHEPARD,3260,775,30,21,51,58.8%,27m
10552,3,Arben,3260,772,29,25,54,53.7%,32m
10552,3,[MEP]PuppyKing,3260,488,26,14,40,65.0%,32m
10552,3,Prospector,3260,544,22,25,47,46.8%,20m
10552,3,cdsx,3260,0,4,1,5,80.0%,38m
10552,3,Zeros,3260,0,4,1,5,80.0%,9m
10552,3,kevinkace,3260,86,3,6,9,33.3%,22m
10552,3,[BoRnGo]Treetop,3260,36,2,2,4,50.0%,24m
10552,3,DieNAGranate,3260,0,2,3,5,40.0%,30m
10552,3,shino,3260,0,1,0,1,100.0%,32m
10552,3,[TaRus]SpeedPlay,3260,0,1,0,1,100.0%,35m
10552,3,Chaospheres,3260,30,1,1,2,50.0%,8m
10552,3,Nomster,3260,30,1,1,2,50.0%,38m
10552,3,[SSCB24]HolyKaiser,3260,0,0,2,2,0.0%,12m
10567,2,[EtrOy]lightwolf,3259,1613,251,261,512,49.0%,38m
10567,3,WIN,3259,1510,127,114,241,52.7%,14m
10567,2,[sgnDK]angj,3259,1472,91,101,192,47.4%,39m
10567,3,lucho,3259,1373,59,49,108,54.6%,36m
10567,3,March,3259,328,18,23,41,43.9%,26m
10567,2,Nezdf,3259,480,18,23,41,43.9%,3m
10567,3,Codarus,3259,407,15,8,23,65.2%,25m
10567,3,[iAnc]HKVS,3259,305,13,1,14,92.9%,12m
10567,3,Bellota,3259,304,12,11,23,52.2%,25m
10567,3,CAPEDBALDY,3259,190,8,4,12,66.7%,32m
10567,3,Zens,3259,190,8,4,12,66.7%,10m
10567,2,Bren,3259,0,4,1,5,80.0%,59m
10567,3,[TGosuA]Burrell,3259,30,2,2,4,50.0%,36m
10580,2,Chinosky,3258,1547,418,417,835,50.1%,21m
10580,3,Belvita,3258,1493,168,170,338,49.7%,35m
10580,3,[Ichnac]Fideox,3258,1306,96,91,187,51.3%,42m
10580,2,[EMORY]FatGoose,3258,1344,73,89,162,45.1%,23m
10580,3,SiRa,3258,273,48,47,95,50.5%,34m
10580,3,DarkAngel,3258,1073,43,39,82,52.4%,24m
10580,3,Gambit,3258,870,41,19,60,68.3%,9m
10580,3,IIIlllIIIlll,3258,780,32,21,53,60.4%,39m
10580,3,Moridin,3258,595,31,8,39,79.5%,20m
10580,3,Lee,3258,700,29,26,55,52.7%,31m
10580,3,THAlLAND,3258,470,19,14,33,57.6%,10m
10580,3,Splashmaster,3258,564,19,24,43,44.2%,8m
10580,3,[OBE]sukerpuncher,3258,382,13,16,29,44.8%,4m
10580,3,VasperKnight,3258,285,13,16,29,44.8%,11m
10580,3,valasco,3258,332,12,12,24,50.0%,6m
10580,3,Evan,3258,107,9,6,15,60.0%,33m
10580,1,cRude,3258,170,6,5,11,54.5%,23m
10580,1,NivisOwl,3258,96,4,6,10,40.0%,3h
10580,3,Grumza,3258,58,3,2,5,60.0%,19m
10580,3,FajitaEata,3258,30,2,1,3,66.7%,24m
10580,3,[SCTF]RaVeN,3258,0,1,0,1,100.0%,10m
10580,3,BigLewandow,3258,0,1,0,1,100.0%,22m
10580,3,[C96741]faker,3258,0,1,1,2,50.0%,42m
10580,3,PangY,3258,30,1,12,13,7.7%,35m
10580,3,Kevin,3258,0,0,3,3,0.0%,2m
10605,3,STARKILLER,3257,1532,323,328,651,49.6%,27m
10605,3,Moist,3257,1423,170,156,326,52.1%,19m
10605,3,Lers,3257,1347,164,156,320,51.2%,34m
10605,3,Mario,3257,1549,105,104,209,50.2%,40m
10605,2,[QcScT]wanted,3257,556,97,111,208,46.6%,28m
10605,3,[NextDC]IceDRothen,3257,1473,70,68,138,50.7%,36m
10605,3,Plantax,3257,922,36,36,72,50.0%,27m
10605,3,ShooterMiku,3257,270,34,19,53,64.2%,36m
10605,3,[JURT]Baalie,3257,766,30,29,59,50.8%,25m
10605,3,selym,3257,458,17,21,38,44.7%,41m
10605,3,[lLiTl]Acey,3257,312,11,17,28,39.3%,25m
10605,3,Scarfone,3257,223,10,4,14,71.4%,29m
10605,1,[AD3C]Vyse,3257,258,7,10,17,41.2%,6m
10605,3,Leonard,3257,0,5,2,7,71.4%,35m
10605,3,Goody,3257,92,4,5,9,44.4%,10m
10605,3,Courage,3257,58,2,1,3,66.7%,25m
10605,3,Magi,3257,30,1,2,3,33.3%,2m
10605,3,[MEP]sao,3257,0,0,1,1,0.0%,23m
10605,3,[KiMBR]Jonathas,3257,0,0,1,1,0.0%,10m
10605,3,Interium,3257,0,0,1,1,0.0%,29m
10625,3,VLADEX,3256,1572,67,50,117,57.3%,38m
10625,3,[Astute]Innovatable,3256,830,33,35,68,48.5%,39m
10625,3,[PobSC]Miracle,3256,672,32,12,44,72.7%,6m
10625,3,TerranisBad,3256,463,18,8,26,69.2%,26m
10625,3,RuyLopez,3256,436,14,23,37,37.8%,23m
10625,3,Mateocos,3256,199,9,7,16,56.2%,30m
10625,3,Fallenleaves,3256,166,6,5,11,54.5%,21m
10625,3,[TGosuD]hohner,3256,192,5,14,19,26.3%,25m
10625,3,Ghost,3256,0,4,1,5,80.0%,17m
10625,2,Scarecrow,3256,0,4,1,5,80.0%,57m
10625,3,MANvsSC,3256,0,4,1,5,80.0%,10m
10625,3,[Pls]Narah,3256,118,4,4,8,50.0%,19m
10625,3,ººººº,3256,60,2,4,6,33.3%,5m
10625,3,lIlIlIlIlIl,3256,0,1,0,1,100.0%,16m
10625,1,Brogrammer,3256,0,1,0,1,100.0%,36m
10625,3,[Smutty]Shamu,3256,0,1,1,2,50.0%,13m
10625,3,PussiBarcode,3256,30,1,2,3,33.3%,5m
10625,3,reneg,3256,0,0,1,1,0.0%,41m
10625,1,Monday,3256,0,0,1,1,0.0%,17m
10625,3,ArdVark,3256,0,0,1,1,0.0%,30m
10625,2,bloodbrother,3256,0,0,1,1,0.0%,17m
10625,3,BabyShoes,3256,0,0,3,3,0.0%,32m
10647,2,Lightning,3255,1524,491,485,976,50.3%,13m
10647,3,iru,3255,1452,66,62,128,51.6%,6m
10647,3,Projectt,3255,768,56,45,101,55.4%,11m
10647,3,MacroMantis,3255,693,39,28,67,58.2%,27m
10647,3,Blank,3255,906,39,30,69,56.5%,20m
10647,3,Computer,3255,359,16,1,17,94.1%,15m
10647,3,Rabito,3255,430,15,9,24,62.5%,20m
10647,3,super,3255,262,11,11,22,50.0%,26m
10647,3,RansesII,3255,304,11,14,25,44.0%,39m
10647,3,Felef,3255,136,5,1,6,83.3%,37m
10647,3,BYBY,3255,94,5,1,6,83.3%,13m
10647,2,[trolz]llllllllll,3255,48,5,2,7,71.4%,2h
10647,1,[BeSuzy]ARAGONK,3255,97,2,1,3,66.7%,42m
10647,3,xenathode,3255,30,2,5,7,28.6%,3m
10647,3,Drift,3255,60,2,9,11,18.2%,1m
10647,3,[zelniq]Starkilla,3255,0,1,0,1,100.0%,25m
10647,3,Iconoclast,3255,0,0,1,1,0.0%,5m
10664,3,[NPhasA]Antares,3254,789,62,64,126,49.2%,15m
10664,3,LiquidFLem,3254,1212,61,20,81,75.3%,38m
10664,3,TLife,3254,789,38,38,76,50.0%,25m
10664,3,[FxB]floski,3254,978,36,40,76,47.4%,2m
10664,3,Spagzii,3254,798,33,27,60,55.0%,10m
10664,3,Kelkun,3254,826,30,36,66,45.5%,5m
10664,3,Magus,3254,436,14,17,31,45.2%,10m
10664,2,Voodow,3254,330,13,8,21,61.9%,26m
10664,3,CreamPie,3254,218,7,6,13,53.8%,10m
10664,3,[RS69]SteveFox,3254,86,3,1,4,75.0%,19m
10664,3,[BRUHHV]WhoisYe,3254,58,3,2,5,60.0%,29m
10664,1,Augstone,3254,97,3,4,7,42.9%,50m
10664,3,Tomus,3254,90,3,7,10,30.0%,19m
10664,3,PeraL,3254,90,3,8,11,27.3%,38m
10664,3,[DhZAc1]halakaluf,3254,0,0,1,1,0.0%,19m
10664,3,PlayerSMD,3254,0,0,1,1,0.0%,24m
10664,3,[KAG20]BowHunter,3254,0,0,1,1,0.0%,12m
10664,1,[Poway]StormBringer,3254,0,0,2,2,0.0%,37m
10682,3,[Hulu]classpath,3253,1576,408,400,808,50.5%,20m
10682,3,Allrecks,3253,1585,109,85,194,56.2%,35m
10682,3,jerry,3253,1125,87,74,161,54.0%,25m
10682,3,WerzMyBackup,3253,928,49,56,105,46.7%,30m
10682,3,ehdeelee,3253,893,34,34,68,50.0%,17m
10682,3,[EZDUNK]Monkie,3253,644,33,11,44,75.0%,17m
10682,3,TheGreat,3253,539,30,7,37,81.1%,9m
10682,3,saucy,3253,305,25,8,33,75.8%,17m
10682,3,cuBe,3253,414,15,16,31,48.4%,39m
10682,3,[xLgNx]colliebob,3253,356,13,19,32,40.6%,19m
10682,3,[EtrOy]AnloreRH,3253,158,6,12,18,33.3%,41m
10682,3,[Xpk]Seths,3253,116,5,5,10,50.0%,26m
10682,3,xjlonelystar,3253,92,4,4,8,50.0%,35m
10682,3,ImAsian,3253,163,4,6,10,40.0%,38m
10682,3,[Uetzi]Mesias,3253,30,2,0,2,100.0%,27m
10682,3,TrashCan,3253,60,2,6,8,25.0%,8m
10682,3,[BRSKR]SnowEMeadowS,3253,95,1,10,11,9.1%,8m
10682,3,FilthyBeaver,3253,0,0,1,1,0.0%,5m
10700,3,zuez,3252,1566,549,542,1091,50.3%,14m
10700,2,Jestin,3252,1515,257,256,513,50.1%,42m
10700,3,Renrag,3252,1602,248,219,467,53.1%,6m
10700,3,dsds,3252,1548,219,215,434,50.5%,40m
10700,3,[2faded]koadyawn,3252,1124,214,179,393,54.5%,5m
10700,3,MGUH,3252,1514,100,84,184,54.3%,19m
10700,3,Illinichamps,3252,356,70,77,147,47.6%,11m
10700,2,[WNZ]Graycode,3252,647,53,53,106,50.0%,21m
10700,3,LaQuiCa,3252,1015,44,33,77,57.1%,13m
10700,3,Abraxas,3252,726,33,32,65,50.8%,35m
10700,3,Bio,3252,676,31,13,44,70.5%,37m
10700,3,AwwUrDead,3252,774,30,23,53,56.6%,14m
10700,3,SuperTable,3252,269,22,18,40,55.0%,36m
10700,3,ghOst,3252,366,13,12,25,52.0%,26m
10700,3,tiaomaren,3252,150,7,4,11,63.6%,28m
10700,3,MogrA,3252,116,5,4,9,55.6%,39m
10700,3,EatMySperm,3252,0,4,1,5,80.0%,35m
10700,3,[Xpk]DaggothC,3252,58,4,3,7,57.1%,14m
10700,3,[LgnTDS]shivi,3252,58,3,2,5,60.0%,4m
10700,3,[CoCoWa]TrashPanda,3252,30,2,3,5,40.0%,6m
10700,3,[MadK]heymikey,3252,0,0,1,1,0.0%,22m
10700,3,TomatoHorse,3252,0,0,5,5,0.0%,34m
10722,2,SteamBOT,3251,1548,208,209,417,49.9%,34m
10722,2,Oppenheimer,3251,1316,123,124,247,49.8%,3m
10722,3,laver,3251,1542,90,94,184,48.9%,13m
10722,3,LateGameKing,3251,269,83,19,102,81.4%,7m
10722,3,[FFAA]hyperion,3251,1117,48,39,87,55.2%,33m
10722,3,[hTx]microjackson,3251,1089,41,44,85,48.2%,6m
10722,3,[XpKb]Ramzzez,3251,865,36,33,69,52.2%,38m
10722,2,Dotty,3251,802,24,49,73,32.9%,6m
10722,2,[GGMESP]TossOP,3251,443,22,27,49,44.9%,7m
10722,3,MikeLeithal,3251,190,22,30,52,42.3%,16m
10722,3,llllllllllll,3251,502,17,25,42,40.5%,21m
10722,3,EpicNoob,3251,171,12,10,22,54.5%,24m
10722,3,PERFORMANCE,3251,194,10,9,19,52.6%,26m
10722,3,[JoJo]Archer,3251,0,4,1,5,80.0%,13m
10722,3,[ASPAVA]YanSanayi,3251,88,3,6,9,33.3%,6m
10722,3,Toucan,3251,58,2,2,4,50.0%,11m
10722,3,Joker,3251,0,1,0,1,100.0%,42m
10722,3,Kaizen,3251,0,1,0,1,100.0%,11m
10722,2,ElManotas,3251,0,1,0,1,100.0%,43m
10741,3,Innoveishon,3250,1603,229,198,427,53.6%,5m
10741,3,KBG,3250,977,121,92,213,56.8%,16m
10741,3,niubi,3250,1540,65,68,133,48.9%,14m
10741,3,TheMuffinMan,3250,822,35,22,57,61.4%,19m
10741,3,Senteras,3250,718,27,24,51,52.9%,34m
10741,3,Zel,3250,593,25,23,48,52.1%,24m
10741,3,[BRSKR]xswishaxward,3250,314,10,17,27,37.0%,32m
10741,3,Pato,3250,178,7,5,12,58.3%,5m
10741,2,Neptis,3250,0,5,0,5,100.0%,6m
10741,3,luna,3250,0,4,1,5,80.0%,16m
10741,1,Trigger,3250,117,3,0,3,100.0%,50m
10741,3,kunibee,3250,0,1,0,1,100.0%,23m
10741,3,HYB,3250,0,1,0,1,100.0%,13m
10741,3,KIN,3250,30,1,1,2,50.0%,25m
10741,3,Grimey,3250,0,0,1,1,0.0%,41m
10741,3,[TSØP]AbOsX,3250,0,0,1,1,0.0%,6m
10757,3,xXuntitledxX,3249,1550,141,153,294,48.0%,30m
10757,3,DrWhoopAss,3249,1529,133,134,267,49.8%,36m
10757,3,[eX]ppw,3249,1611,106,76,182,58.2%,26m
10757,3,Boxzer,3249,1406,105,88,193,54.4%,9m
10757,3,Auckland,3249,992,45,24,69,65.2%,21m
10757,3,[Zer01]ZeroS,3249,641,28,35,63,44.4%,41m
10757,3,SeamenTosser,3249,636,23,25,48,47.9%,28m
10757,3,TerranOP,3249,455,21,9,30,70.0%,9m
10757,3,[66B]Firstblood,3249,325,18,20,38,47.4%,34m
10757,3,[BroCo]Jer,3249,412,14,15,29,48.3%,24m
10757,3,Splntr,3249,234,9,5,14,64.3%,15m
10757,3,aka,3249,120,5,3,8,62.5%,17m
10757,3,[iDrunk]LulisBay,3249,58,2,5,7,28.6%,30m
10757,3,Neighbor,3249,0,1,0,1,100.0%,25m
10757,3,[TKS]Alanix,3249,30,1,4,5,20.0%,26m
10757,3,chiLL,3249,0,0,1,1,0.0%,33m
10757,3,[Tidal]Undertow,3249,0,0,4,4,0.0%,14m
10774,3,william,3248,1120,65,56,121,53.7%,39m
10774,3,ParAruia,3248,1284,52,46,98,53.1%,11m
10774,3,supremoking,3248,952,40,32,72,55.6%,36m
10774,3,[Akita]CultOfCroft,3248,940,37,28,65,56.9%,27m
10774,3,Doctore,3248,384,21,33,54,38.9%,35m
10774,3,TheRats,3248,418,16,14,30,53.3%,13m
10774,3,[LGnD]Exia,3248,369,15,10,25,60.0%,16m
10774,3,Epiic,3248,368,15,14,29,51.7%,42m
10774,3,foREVer,3248,297,13,8,21,61.9%,9m
10774,3,sxiesiX,3248,332,11,13,24,45.8%,30m
10774,3,Caritas,3248,288,11,16,27,40.7%,20m
10774,2,javarush,3248,0,4,1,5,80.0%,1h
10774,3,Moridin,3248,60,3,3,6,50.0%,13m
10774,3,BluERaiN,3248,88,3,5,8,37.5%,23m
10774,3,ComputerEasy,3248,30,2,1,3,66.7%,20m
10774,3,[TPGGXD]Smile,3248,0,1,0,1,100.0%,6m
10774,3,[KGH]Dakota,3248,0,0,1,1,0.0%,14m
10774,3,[Pig2]NoSavedDATA,3248,0,0,1,1,0.0%,36m
10774,3,Harash,3248,0,0,5,5,0.0%,11m
10793,3,BluntKatana,3247,1556,257,247,504,51.0%,42m
10793,3,floatingbase,3247,1570,148,136,284,52.1%,34m
10793,3,jaydahitta,3247,1112,132,124,256,51.6%,24m
10793,3,TwoLaydish,3247,1572,66,61,127,52.0%,27m
10793,3,FiberOptik,3247,737,51,42,93,54.8%,15m
10793,3,PlanB,3247,938,48,59,107,44.9%,9m
10793,3,AlienAnton,3247,898,34,33,67,50.7%,40m
10793,3,DMFH,3247,286,14,12,26,53.8%,10m
10793,3,Cystemic,3247,139,10,13,23,43.5%,41m
10793,3,SoulAnthony,3247,0,5,0,5,100.0%,24m
10793,3,SirBlue,3247,30,4,4,8,50.0%,31m
10793,3,Dallinator,3247,58,2,2,4,50.0%,17m
10793,2,[TYANO]Caine,3247,90,1,1,2,50.0%,14m
10793,2,Squeech,3247,96,1,1,2,50.0%,32m
10793,2,[BirosK]Szion,3247,0,1,4,5,20.0%,20m
10793,3,SleazyTuna,3247,0,0,1,1,0.0%,6m
10809,3,[ZTempz]Kyleh,3246,719,29,22,51,56.9%,24m
10809,3,[zort]IceCofee,3246,326,11,11,22,50.0%,20m
10809,3,[EasyOn]Smile,3246,252,9,13,22,40.9%,8m
10809,3,Tumult,3246,140,6,2,8,75.0%,23m
10809,3,Vinny,3246,142,6,3,9,66.7%,20m
10809,3,KTFlaSh,3246,30,5,4,9,55.6%,37m
10809,3,Nurdzzz,3246,0,1,0,1,100.0%,36m
10809,3,ShaunWhite,3246,0,1,1,2,50.0%,28m
10809,3,Gunnermcolie,3246,30,1,2,3,33.3%,31m
10809,1,IIIIIIIIII,3246,0,1,4,5,20.0%,42m
10809,1,Fourby,3246,30,1,18,19,5.3%,6m
10809,3,Irv,3246,0,0,1,1,0.0%,5m
10809,3,DeltaForces,3246,0,0,1,1,0.0%,20m
10809,3,ButterSnapps,3246,0,0,2,2,0.0%,9m
10809,3,Tomeofviolet,3246,0,0,3,3,0.0%,34m
10824,3,Ender,3245,1427,130,122,252,51.6%,31m
10824,3,[Dmonik]Belial,3245,1539,107,98,205,52.2%,3m
10824,3,Jabaja,3245,902,48,38,86,55.8%,40m
10824,3,[xLgNx]MrsAhrim,3245,989,45,27,72,62.5%,17m
10824,3,vomitkittens,3245,545,20,12,32,62.5%,36m
10824,3,Silmarilioon,3245,423,16,11,27,59.3%,29m
10824,3,OJogador,3245,238,10,7,17,58.8%,2m
10824,3,[xLiTx]WarTankPrime,3245,0,1,0,1,100.0%,17m
10824,3,Marine,3245,0,1,0,1,100.0%,36m
10824,3,[Axia]August,3245,0,0,1,1,0.0%,35m
10824,3,[CBRA]snkz,3245,0,0,1,1,0.0%,20m
10824,3,Hell,3245,0,0,1,1,0.0%,21m
10824,3,IIIIIIIIIIII,3245,0,0,4,4,0.0%,3m
10837,3,BlueRider,3244,1553,446,446,892,50.0%,5m
10837,3,ladeleonidas,3244,1553,429,422,851,50.4%,13m
10837,3,[IPCSI]Carmesino,3244,1549,317,318,635,49.9%,7m
10837,2,LXR,3244,1387,269,268,537,50.1%,29m
10837,3,puchO,3244,1606,167,167,334,50.0%,34m
10837,2,MATARONAKENY,3244,1530,156,165,321,48.6%,12m
10837,3,Hans,3244,1607,125,109,234,53.4%,14m
10837,3,Kanax,3244,954,70,56,126,55.6%,24m
10837,3,Geezer,3244,882,60,55,115,52.2%,17m
10837,3,asdas,3244,505,49,7,56,87.5%,41m
10837,3,[xNGx]WokeAssClown,3244,506,22,8,30,73.3%,39m
10837,3,SneakyToss,3244,504,19,21,40,47.5%,13m
10837,3,Jules,3244,326,15,11,26,57.7%,20m
10837,3,Wizard,3244,384,15,12,27,55.6%,24m
10837,3,TheBoxeR,3244,392,14,21,35,40.0%,17m
10837,3,heldmar,3244,159,11,13,24,45.8%,9m
10837,3,[ØFoxF2]Jimmy,3244,160,6,7,13,46.2%,17m
10837,3,KoScHmArChE,3244,30,2,0,2,100.0%,38m
10837,3,Closetmonkey,3244,58,2,1,3,66.7%,11m
10837,3,terapyon,3244,0,1,0,1,100.0%,30m
10837,3,jjt,3244,0,1,1,2,50.0%,15m
10837,3,iloveicy,3244,95,1,2,3,33.3%,28m
10859,3,Jeroldmouse,3243,1554,114,103,217,52.5%,2m
10859,3,[13und]iceking,3243,1620,90,78,168,53.6%,9m
10859,3,RonKing,3243,359,62,63,125,49.6%,31m
10859,3,MOJ,3243,1465,60,74,134,44.8%,32m
10859,3,Serbasian,3243,919,55,53,108,50.9%,26m
10859,3,DireRaven,3243,503,39,32,71,54.9%,27m
10859,3,[lLiTl]Suspicious,3243,609,34,29,63,54.0%,7m
10859,1,grubsiud,3243,240,11,10,21,52.4%,27m
10859,3,[GL0CK]CowboyVesper,3243,251,7,7,14,50.0%,6m
10859,3,[UIDF]TheOvermind,3243,142,6,7,13,46.2%,17m
10859,3,Atopos,3243,221,6,7,13,46.2%,21m
10859,1,[HODE]xploD,3243,121,5,2,7,71.4%,31m
10859,2,[LCE]Wizard,3243,112,4,1,5,80.0%,27m
10859,3,GhostDog,3243,36,2,2,4,50.0%,36m
10859,3,TONYLJK,3243,0,1,0,1,100.0%,10m
10859,1,RailBunnysMA,3243,0,1,0,1,100.0%,42m
10859,3,Astrael,3243,30,1,1,2,50.0%,12m
10859,3,[HEHEXD]Okona,3243,0,1,2,3,33.3%,22m
10859,3,TrutleMagic,3243,0,0,1,1,0.0%,13m
10878,3,BrickFrog,3242,1580,409,401,810,50.5%,31m
10878,3,Jizanthapuss,3242,1583,329,326,655,50.2%,15m
10878,3,aline,3242,1329,285,276,561,50.8%,26m
10878,3,MexMarine,3242,1536,185,181,366,50.5%,27m
10878,2,steakncheese,3242,1492,160,162,322,49.7%,5m
10878,3,snakeson,3242,1607,125,112,237,52.7%,42m
10878,3,cpkarson,3242,1413,67,74,141,47.5%,16m
10878,3,Murica,3242,1483,65,64,129,50.4%,12m
10878,2,[GR33D]Ritho,3242,964,32,46,78,41.0%,5m
10878,3,ForFun,3242,466,16,19,35,45.7%,31m
10878,3,benjalol,3242,410,14,20,34,41.2%,25m
10878,3,NachosDelQue,3242,329,12,8,20,60.0%,38m
10878,3,[ArGNA]AutoNAtic,3242,170,7,7,14,50.0%,17m
10878,3,[gGgO]SummerZerg,3242,174,6,10,16,37.5%,42m
10878,3,[UpeV]BlackPhillip,3242,86,4,1,5,80.0%,13m
10878,3,Aardbark,3242,30,2,0,2,100.0%,34m
10878,3,[QueseG]DanTheMan,3242,30,2,1,3,66.7%,41m
10878,3,[LGNxx]FosTA,3242,0,1,1,2,50.0%,38m
10878,3,[AD3C]Sasuke,3242,0,0,2,2,0.0%,30m
10878,3,xdlgxtrgop,3242,0,0,12,12,0.0%,40m
10898,3,zasheek,3241,1607,132,127,259,51.0%,11m
10898,3,KannOx,3241,1465,94,85,179,52.5%,6m
10898,3,Sunday,3241,303,75,74,149,50.3%,36m
10898,3,Crimsonn,3241,1615,69,53,122,56.6%,14m
10898,3,jeremy,3241,1060,42,38,80,52.5%,24m
10898,3,Scar,3241,617,38,5,43,88.4%,32m
10898,3,Serfio,3241,969,38,35,73,52.1%,26m
10898,3,Giantorange,3241,565,25,20,45,55.6%,30m
10898,3,[Asnd]Wombat,3241,534,19,24,43,44.2%,8m
10898,3,[95O]Kaito,3241,339,18,18,36,50.0%,35m
10898,3,LazyTitan,3241,416,16,12,28,57.1%,14m
10898,3,[XpKb]klow,3241,420,16,18,34,47.1%,36m
10898,3,darklordlegi,3241,343,15,14,29,51.7%,2m
10898,3,[EZDUNK]Ganktrain,3241,172,7,7,14,50.0%,42m
10898,3,[YSP]WhaleHunter,3241,140,5,6,11,45.5%,13m
10898,3,[FReNs]Bababooey,3241,30,2,2,4,50.0%,42m
10898,3,SilverHawk,3241,30,2,3,5,40.0%,34m
10898,3,Shadowbee,3241,0,1,0,1,100.0%,20m
10898,3,Glaede,3241,0,0,1,1,0.0%,16m
10898,3,Trucker,3241,0,0,2,2,0.0%,24m
10918,3,[TRRNCH]luis,3240,1619,200,190,390,51.3%,3m
10918,3,Shortacus,3240,1523,69,58,127,54.3%,34m
10918,3,Maquiavelo,3240,1504,63,63,126,50.0%,6m
10918,3,Melchizedek,3240,1207,52,49,101,51.5%,12m
10918,3,CorporalSky,3240,1027,41,38,79,51.9%,30m
10918,3,[NeAs]PANDARIA,3240,791,33,28,61,54.1%,8m
10918,3,[cbox]Aronator,3240,732,28,28,56,50.0%,32m
10918,3,[Th3Bad]ralphwbms,3240,478,25,9,34,73.5%,38m
10918,3,[ACSS]Swi,3240,490,19,11,30,63.3%,31m
10918,3,[CatRG]llllllllllll,3240,352,15,4,19,78.9%,35m
10918,3,SpritR,3240,124,6,2,8,75.0%,30m
10918,3,MoriNana,3240,144,4,2,6,66.7%,28m
10918,3,Praetor,3240,114,4,6,10,40.0%,16m
10918,3,[NPhasA]AKanator,3240,62,2,5,7,28.6%,13m
10918,3,[INextI]Videsyn,3240,0,1,0,1,100.0%,11m
10918,3,soBased,3240,30,1,6,7,14.3%,13m
10918,2,Teo,3240,0,0,6,6,0.0%,27m
10935,3,Bigfish,3239,1554,247,247,494,50.0%,3m
10935,3,Roham,3239,1571,221,211,432,51.2%,9m
10935,3,[ARM]Dymer,3239,1559,123,126,249,49.4%,28m
10935,3,[747]RUNI,3239,1589,108,99,207,52.2%,6m
10935,3,[LQV]MasterYoda,3239,1410,86,90,176,48.9%,5m
10935,3,lllRaGouzi,3239,1408,75,70,145,51.7%,41m
10935,3,Piero,3239,1493,68,60,128,53.1%,17m
10935,3,Aldebaran,3239,1031,64,57,121,52.9%,41m
10935,3,chainfire,3239,822,34,30,64,53.1%,25m
10935,3,[lLiTl]IlIlIlIlIllI,3239,388,13,14,27,48.1%,31m
10935,3,plop,3239,296,13,15,28,46.4%,27m
10935,3,Blitzkrieg,3239,244,8,17,25,32.0%,32m
10935,3,kaine,3239,213,7,11,18,38.9%,17m
10935,3,[TrumpN]AlphaStar,3239,30,2,0,2,100.0%,26m
10935,1,[GIBE]Flowers,3239,0,2,11,13,15.4%,41m
10935,3,[DRONGO]bega,3239,0,1,0,1,100.0%,11m
10935,3,[PNS]Tek,3239,0,1,0,1,100.0%,3m
10935,3,[SuperZ]Meat,3239,0,1,0,1,100.0%,14m
10935,3,ReadyAimSing,3239,0,1,0,1,100.0%,17m
10935,3,[Planka]IIIIIIIIIIII,3239,0,0,1,1,0.0%,2m
10935,3,Raider,3239,0,0,5,5,0.0%,17m
10956,3,Crix,3238,1478,145,139,284,51.1%,14m
10956,3,[ThW]CaioRavi,3238,922,71,55,126,56.3%,6m
10956,3,GetBONKED,3238,505,69,52,121,57.0%,14m
10956,3,Mauricio,3238,689,54,41,95,56.8%,2m
10956,3,Daskper,3238,1074,51,52,103,49.5%,24m
10956,3,FrostyWB,3238,1144,46,42,88,52.3%,13m
10956,3,WeakAsDirt,3238,704,32,35,67,47.8%,35m
10956,3,matrix,3238,497,28,20,48,58.3%,17m
10956,3,junstin,3238,168,6,4,10,60.0%,32m
10956,1,showmax,3238,161,5,3,8,62.5%,24m
10956,1,Vazilard,3238,139,4,1,5,80.0%,1h
10956,2,MYMP,3238,0,4,2,6,66.7%,3h
10956,3,[lLiTl]potato,3238,90,4,4,8,50.0%,23m
10956,3,Strybosch,3238,141,3,7,10,30.0%,41m
10956,3,Zerggslayer,3238,60,2,3,5,40.0%,10m
10956,3,[MURKYA]Relax,3238,0,1,0,1,100.0%,25m
10956,3,PoggedGourd,3238,0,0,2,2,0.0%,17m
10956,3,LillySatou,3238,0,0,3,3,0.0%,35m
10974,3,DeathKnight,3237,1255,198,208,406,48.8%,5m
10974,3,Silverdro,3237,1466,184,172,356,51.7%,5m
10974,3,tmak,3237,1475,105,86,191,55.0%,42m
10974,3,TtL,3237,649,44,34,78,56.4%,32m
10974,3,[JUIC3Y]Jango,3237,948,38,31,69,55.1%,9m
10974,3,[INextI]JUKUMARU,3237,488,16,24,40,40.0%,19m
10974,1,Durt,3237,294,14,9,23,60.9%,14m
10974,3,Dildow,3237,267,11,9,20,55.0%,32m
10974,3,Ninx,3237,229,8,2,10,80.0%,12m
10974,3,IIIIIIII,3237,224,8,4,12,66.7%,23m
10974,3,Cerulean,3237,142,6,3,9,66.7%,24m
10974,3,PinPonWea,3237,109,5,2,7,71.4%,36m
10974,3,[mator]Zeldris,3237,92,4,6,10,40.0%,31m
10974,3,[SC2PH]Azzin,3237,30,2,1,3,66.7%,40m
10974,3,[143s4]Kaizen,3237,118,2,1,3,66.7%,6m
10974,3,Eyze,3237,0,1,0,1,100.0%,2m
10974,3,Bulma,3237,0,1,1,2,50.0%,21m
10974,3,TorTugaa,3237,30,1,1,2,50.0%,34m
10974,3,Marzen,3237,0,0,1,1,0.0%,20m
10974,3,IlIlIlIlIlIl,3237,0,0,4,4,0.0%,19m
10994,3,oneoneelone,3236,1491,514,504,1018,50.5%,15m
10994,3,Inevitable,3236,1440,131,134,265,49.4%,42m
10994,3,CashMeOwside,3236,1189,78,55,133,58.6%,14m
10994,3,[Mlnz]MichaelT,3236,669,77,78,155,49.7%,35m
10994,3,lavenderlich,3236,1451,55,63,118,46.6%,2m
10994,3,Waysamah,3236,1021,51,52,103,49.5%,35m
10994,3,[XpKb]Hackmalware,3236,1058,49,30,79,62.0%,42m
10994,3,Raoul,3236,1139,49,41,90,54.4%,7m
10994,3,RGLuckedOutt,3236,574,26,27,53,49.1%,9m
10994,3,llllllllllll,3236,291,19,14,33,57.6%,31m
10994,3,[Luxae]LuxaNova,3236,312,13,7,20,65.0%,9m
10994,1,jackman,3236,123,6,3,9,66.7%,2m
10994,2,LegenDary,3236,0,5,0,5,100.0%,3h
10994,3,cassius,3236,120,5,7,12,41.7%,5m
10994,2,[NalsEz]KatzeGud,3236,0,4,1,5,80.0%,2h
10994,3,NewEnd,3236,88,3,7,10,30.0%,4m
10994,3,[Mntaya]JimReaper,3236,30,2,2,4,50.0%,5m
10994,3,[ChFo]Dracomalco,3236,30,2,5,7,28.6%,28m
10994,3,Pangú,3236,0,1,0,1,100.0%,6m
10994,3,[Z1O1]ColVSleevIII,3236,0,1,0,1,100.0%,41m
10994,3,[qlp]MasqDoom,3236,0,1,1,2,50.0%,5m
10994,3,[GIM]WHTMORPHEUS,3236,0,1,2,3,33.3%,13m
10994,3,[1E100]Tapirus,3236,0,0,1,1,0.0%,23m
10994,3,Apple,3236,0,0,2,2,0.0%,41m
11018,3,[Filth1]NEMETHIL,3235,751,116,117,233,49.8%,12m
11018,3,[Ash3s]Eleven,3235,1097,63,62,125,50.4%,36m
11018,3,[TGCrew]Cognite,3235,999,49,44,93,52.7%,28m
11018,3,Waterways,3235,494,21,18,39,53.8%,17m
11018,3,Byun,3235,508,17,24,41,41.5%,40m
11018,3,Rebent,3235,304,15,8,23,65.2%,8m
11018,3,PacFROST,3235,286,13,7,20,65.0%,25m
11018,3,BadKitten,3235,346,12,10,22,54.5%,17m
11018,3,Genesis,3235,114,7,1,8,87.5%,9m
11018,2,DrRotinaj,3235,147,6,11,17,35.3%,2m
11018,3,[C96741]Morpheus,3235,142,5,4,9,55.6%,26m
11018,2,Shokuji,3235,0,4,1,5,80.0%,1h
11018,3,Azreal,3235,118,4,4,8,50.0%,4m
11018,1,lOKIOKI,3235,187,4,7,11,36.4%,1h
11018,3,MedoedTV,3235,144,3,2,5,60.0%,32m
11018,3,ION,3235,30,2,2,4,50.0%,16m
11018,3,turbokid,3235,30,2,3,5,40.0%,4m
11018,3,[DRYK]Tabercorn,3235,12,1,4,5,20.0%,41m
11018,2,[AoBDE]SneezyDwarf,3235,0,0,1,1,0.0%,26m
11018,3,MaryaReisy,3235,0,0,3,3,0.0%,11m
11038,3,Zip,3234,1612,350,326,676,51.8%,42m
11038,3,Mameng,3234,1615,205,196,401,51.1%,36m
11038,3,[UpxV]HeavyWar,3234,1548,197,182,379,52.0%,31m
11038,3,CRAZZZ,3234,1191,58,55,113,51.3%,41m
11038,3,rootbeer,3234,891,45,30,75,60.0%,17m
11038,3,[SABO]ChewChilla,3234,424,19,4,23,82.6%,24m
11038,3,[TnyDck]Saadli,3234,387,19,13,32,59.4%,4m
11038,3,[JUIC3Y]WangerBanger,3234,295,10,6,16,62.5%,41m
11038,3,[αX]CaptCanuck,3234,170,7,6,13,53.8%,11m
11038,3,[KingSC]NATALI,3234,86,3,1,4,75.0%,38m
11038,3,liquid,3234,86,3,2,5,60.0%,39m
11038,2,[GGMESP]MarineQueen,3234,0,3,2,5,60.0%,26m
11038,3,SUN,3234,30,2,2,4,50.0%,13m
11038,3,[Undone]UndoneXP,3234,0,1,0,1,100.0%,38m
11038,3,Grimreaper,3234,0,1,1,2,50.0%,38m
11038,3,SIERRA,3234,0,0,1,1,0.0%,25m
11038,3,[SINSTR]wamo,3234,0,0,1,1,0.0%,28m
11038,2,horhe,3234,0,0,7,7,0.0%,4m
11056,3,Prot,3233,1394,158,127,285,55.4%,16m
11056,3,[GOPERÚ]Angeluz,3233,1443,81,63,144,56.2%,42m
11056,3,fantasybo,3233,1444,56,58,114,49.1%,36m
11056,3,Jendker,3233,936,39,33,72,54.2%,31m
11056,3,Nayr,3233,336,19,10,29,65.5%,4m
11056,3,Pirro,3233,314,14,10,24,58.3%,4m
11056,3,HellFat,3233,384,14,15,29,48.3%,4m
11056,3,[NKT1]Thor,3233,265,9,6,15,60.0%,15m
11056,3,[5555]RickSanchez,3233,170,6,7,13,46.2%,5m
11056,3,sangrefria,3233,79,4,1,5,80.0%,11m
11056,3,[57717]SolemnWookie,3233,86,4,6,10,40.0%,20m
11056,3,CHAOS,3233,88,3,3,6,50.0%,21m
11056,3,spook,3233,18,2,3,5,40.0%,6m
11056,3,Alphabet,3233,0,1,0,1,100.0%,6m
11056,3,Galad,3233,0,1,0,1,100.0%,20m
11056,3,Warthog,3233,0,1,1,2,50.0%,28m
11056,3,KHANkiritoKu,3233,0,0,1,1,0.0%,8m
11056,3,Arthisios,3233,0,0,4,4,0.0%,14m
11074,3,Irrusive,3232,864,224,225,449,49.9%,4m
11074,3,inkblot,3232,1521,192,177,369,52.0%,26m
11074,3,Espectro,3232,1515,102,91,193,52.8%,19m
11074,3,Caul,3232,1405,87,82,169,51.5%,32m
11074,3,xXMessiXx,3232,954,70,63,133,52.6%,13m
11074,2,HSS,3232,1353,66,73,139,47.5%,34m
11074,3,[9inub]BuyEthereum,3232,815,43,32,75,57.3%,38m
11074,3,[UpxV]raide,3232,601,42,25,67,62.7%,23m
11074,3,[EhTeam]Duke,3232,931,41,23,64,64.1%,17m
11074,3,[Zatra]itzlogan,3232,823,36,19,55,65.5%,17m
11074,3,UnaPapusa,3232,433,15,10,25,60.0%,15m
11074,3,[RUMB]TyDo,3232,30,2,1,3,66.7%,17m
11074,3,[A4172]ReapinReaper,3232,0,1,1,2,50.0%,30m
11074,3,WinterHawk,3232,30,1,8,9,11.1%,42m
11074,3,Rofepe,3232,0,0,1,1,0.0%,38m
11074,1,MrVine,3232,0,0,1,1,0.0%,25m
11074,3,[xRtG]Zen,3232,0,0,4,4,0.0%,16m
11074,3,CraftStar,3232,0,0,6,6,0.0%,5m
11092,3,strelink,3231,979,50,40,90,55.6%,4m
11092,3,[XMX]NitrosOxyde,3231,540,26,23,49,53.1%,31m
11092,3,Rycat,3231,493,22,16,38,57.9%,24m
11092,3,canister,3231,518,18,23,41,43.9%,5m
11092,3,Einstein,3231,162,15,12,27,55.6%,4m
11092,2,MarineKing,3231,164,9,7,16,56.2%,20m
11092,3,Dooki,3231,184,9,11,20,45.0%,35m
11092,1,HeyBro,3231,165,7,4,11,63.6%,23m
11092,3,Peaches,3231,86,3,1,4,75.0%,16m
11092,3,[PiGPan]emctwo,3231,58,3,6,9,33.3%,14m
11092,3,[Ier]Bosh,3231,30,2,2,4,50.0%,31m
11092,3,sLaViC,3231,0,1,0,1,100.0%,15m
11092,3,[EtrOy]Lucuus,3231,0,0,1,1,0.0%,27m
11092,3,Stringerbell,3231,0,0,2,2,0.0%,24m
11092,2,[SENZU]JOO,3231,0,0,3,3,0.0%,45m
11092,2,glhf,3231,0,0,5,5,0.0%,25m
11108,2,FJPONY,3230,1397,186,180,366,50.8%,27m
11108,3,xMrTongits,3230,1525,141,132,273,51.6%,19m
11108,3,[ConFed]MsbowElite,3230,1396,94,78,172,54.7%,8m
11108,3,[ConFed]Deathletter,3230,623,86,63,149,57.7%,31m
11108,3,QplantiumP,3230,731,56,36,92,60.9%,23m
11108,3,Roy,3230,652,37,43,80,46.2%,24m
11108,3,MooStar,3230,389,23,27,50,46.0%,35m
11108,3,Iamnico,3230,514,20,13,33,60.6%,41m
11108,3,[Chrev]Tahnks,3230,408,14,10,24,58.3%,4m
11108,3,[FFAA]NewDevil,3230,244,10,9,19,52.6%,42m
11108,1,McFeast,3230,211,8,4,12,66.7%,2h
11108,3,sUPerSMuRf,3230,187,7,2,9,77.8%,41m
11108,2,NickWild,3230,119,6,0,6,100.0%,58m
11108,3,[PMN]LibYourLife,3230,124,5,8,13,38.5%,35m
11108,3,TwoDblDbls,3230,86,4,0,4,100.0%,11m
11108,2,Maretto,3230,0,4,1,5,80.0%,3h
11108,3,Stoker,3230,0,4,1,5,80.0%,11m
11108,3,[SV]Grant,3230,88,3,4,7,42.9%,20m
11108,3,WiTTy,3230,21,2,1,3,66.7%,41m
11108,3,[AD3C]SilentStrikE,3230,30,2,6,8,25.0%,28m
11108,2,[ScSwrm]Apoptosis,3230,0,1,0,1,100.0%,1h
11108,3,Julius,3230,30,1,2,3,33.3%,19m
11108,3,[SWOLJ]NinjafOx,3230,30,1,2,3,33.3%,34m
11108,3,ThatOneGuy,3230,0,0,2,2,0.0%,41m
11108,1,XerXes,3230,0,0,3,3,0.0%,30m
11133,3,kpman,3229,1152,215,204,419,51.3%,7m
11133,3,starkiller,3229,1095,56,47,103,54.4%,31m
11133,3,TChalla,3229,1117,56,47,103,54.4%,11m
11133,3,Hippopotamus,3229,1226,49,41,90,54.4%,8m
11133,3,[GRNSKN]NeoZoom,3229,719,35,29,64,54.7%,23m
11133,3,Xenopoad,3229,607,26,25,51,51.0%,17m
11133,3,[FxB]zil,3229,706,26,32,58,44.8%,8m
11133,3,cartman,3229,522,21,20,41,51.2%,13m
11133,3,[EZT]juulphone,3229,228,9,9,18,50.0%,11m
11133,3,[Lp]DaRkneSS,3229,220,8,7,15,53.3%,32m
11133,3,Fish,3229,139,6,3,9,66.7%,13m
11133,3,suirad,3229,176,6,8,14,42.9%,19m
11133,3,trolinglife,3229,18,2,1,3,66.7%,30m
11133,3,BLEST,3229,0,1,0,1,100.0%,37m
11133,3,kaokao,3229,0,1,0,1,100.0%,33m
11133,3,[AiMB]CeeDee,3229,0,1,2,3,33.3%,21m
11133,3,KBphan,3229,0,0,1,1,0.0%,19m
11150,3,lochtext,3228,1229,141,144,285,49.5%,14m
11150,3,DorvenKiller,3228,973,118,103,221,53.4%,38m
11150,3,VeinDrainage,3228,924,83,71,154,53.9%,38m
11150,3,[909090]elPoma,3228,1022,39,42,81,48.1%,37m
11150,3,[SvgApe]TipCap,3228,882,37,32,69,53.6%,11m
11150,3,[TACOST]ZERO,3228,585,24,21,45,53.3%,35m
11150,3,MtotheC,3228,467,18,21,39,46.2%,34m
11150,3,promaximus,3228,280,11,5,16,68.8%,42m
11150,3,Levi,3228,232,8,13,21,38.1%,6m
11150,3,WESG,3228,0,4,1,5,80.0%,33m
11150,3,[500CC]llllllllllll,3228,0,1,0,1,100.0%,27m
11150,3,[LYON]Matt,3228,0,1,0,1,100.0%,19m
11150,2,Immortal,3228,48,1,4,5,20.0%,58m
11163,3,Optimize,3227,710,36,31,67,53.7%,15m
11163,3,Colgate,3227,846,34,26,60,56.7%,38m
11163,3,Solilonarova,3227,801,30,29,59,50.8%,15m
11163,3,[GOPERÚ]Force,3227,530,21,21,42,50.0%,32m
11163,3,Lef,3227,460,18,22,40,45.0%,5m
11163,3,Sil,3227,238,8,10,18,44.4%,12m
11163,3,AKiller,3227,206,7,17,24,29.2%,31m
11163,3,llllllllllll,3227,86,4,1,5,80.0%,21m
11163,3,[Boooiz]ETPhoneHome,3227,86,3,3,6,50.0%,32m
11163,3,Vanilla,3227,0,0,1,1,0.0%,21m
11163,3,FiKnight,3227,0,0,2,2,0.0%,9m
11163,2,[SQUADW]TOOLGTTOQYT,3227,0,0,3,3,0.0%,31m
11175,3,therepublik,3226,1590,169,150,319,53.0%,39m
11175,3,Corvo,3226,992,66,49,115,57.4%,4m
11175,2,[DieX3]chuckEcheese,3226,1483,55,72,127,43.3%,25m
11175,3,DarthLordIke,3226,710,28,29,57,49.1%,8m
11175,3,Azunia,3226,533,22,20,42,52.4%,18m
11175,3,Lohikäärme,3226,432,17,19,36,47.2%,25m
11175,3,NWO,3226,364,13,22,35,37.1%,38m
11175,3,YuriOrlov,3226,196,7,6,13,53.8%,19m
11175,3,Dally,3226,257,7,13,20,35.0%,38m
11175,3,satiety,3226,114,4,6,10,40.0%,32m
11175,3,Dualblades,3226,58,3,0,3,100.0%,6m
11175,3,[zelniq]HogNiqqa,3226,90,3,3,6,50.0%,15m
11175,3,Renzhitoo,3226,0,1,0,1,100.0%,42m
11175,3,Grubox,3226,0,1,0,1,100.0%,36m
11189,3,[Rosie]srikar,3225,1591,237,229,466,50.9%,9m
11189,3,UnknownXD,3225,1540,108,110,218,49.5%,13m
11189,3,medusa,3225,1390,97,104,201,48.3%,16m
11189,3,JustSilence,3225,1459,70,70,140,50.0%,39m
11189,3,Enable,3225,793,37,12,49,75.5%,9m
11189,3,[KingSC]PlasmaHN,3225,703,36,11,47,76.6%,5m
11189,3,Rowdydevil,3225,664,25,25,50,50.0%,6m
11189,3,PROXY,3225,651,24,15,39,61.5%,18m
11189,3,SnipSnip,3225,266,11,11,22,50.0%,32m
11189,3,FullMetal,3225,198,7,9,16,43.8%,17m
11189,3,Kachinsky,3225,198,6,5,11,54.5%,36m
11189,3,Ares,3225,30,2,3,5,40.0%,21m
11189,3,[9bit]TheVoice,3225,0,1,0,1,100.0%,32m
11189,3,[HID3]TheRest,3225,94,1,3,4,25.0%,19m
11189,3,DizzyOG,3225,0,0,1,1,0.0%,9m
11204,3,goqsane,3224,1631,488,478,966,50.5%,21m
11204,3,[AD3C]Luffy,3224,1498,111,125,236,47.0%,27m
11204,3,PenguinGamer,3224,1590,80,74,154,51.9%,8m
11204,3,Fractal,3224,1207,61,59,120,50.8%,26m
11204,3,[TGCF]OpenTour,3224,1580,57,64,121,47.1%,19m
11204,3,[UpxV]MLunaBella,3224,352,49,46,95,51.6%,35m
11204,3,OGguapoh,3224,634,29,23,52,55.8%,19m
11204,3,Zenit,3224,397,29,31,60,48.3%,36m
11204,3,[GOPERÚ]CrossStroke,3224,447,21,6,27,77.8%,17m
11204,3,Korne,3224,416,15,18,33,45.5%,24m
11204,3,nyx,3224,195,9,6,15,60.0%,28m
11204,3,[DarkAG]LUDEMEISTER,3224,58,3,2,5,60.0%,10m
11204,3,Typhooey,3224,0,1,0,1,100.0%,35m
11204,3,FatherDrift,3224,0,1,0,1,100.0%,22m
11204,3,Akipi,3224,30,1,7,8,12.5%,31m
11204,3,Thither,3224,0,0,1,1,0.0%,11m
11204,3,[Flam3s]Awakes,3224,0,0,4,4,0.0%,28m
11221,3,RDSnake,3223,1583,341,332,673,50.7%,11m
11221,3,Bukowskinatr,3223,807,185,183,368,50.3%,16m
11221,3,[xARGx]FallpaESP,3223,419,22,9,31,71.0%,30m
11221,3,Sodon,3223,143,7,4,11,63.6%,31m
11221,3,mogwai,3223,172,5,10,15,33.3%,6m
11221,3,[EZDUNK]Alexius,3223,30,2,0,2,100.0%,30m
11221,3,jevons,3223,30,2,2,4,50.0%,24m
11221,2,lIlIlllIIlI,3223,82,2,4,6,33.3%,11m
11221,3,MeistR,3223,58,2,4,6,33.3%,22m
11221,3,Nightmare,3223,0,1,0,1,100.0%,9m
11221,3,[xDBZx]Vegeta,3223,0,1,1,2,50.0%,31m
11221,3,Bega,3223,30,1,2,3,33.3%,4m
11221,3,Mokss,3223,30,1,3,4,25.0%,41m
11221,2,[tSn]getkilled,3223,0,0,1,1,0.0%,3h
11221,3,Seraphim,3223,0,0,1,1,0.0%,17m
11221,3,Fishbed,3223,0,0,2,2,0.0%,13m
11221,3,VVienerwhack,3223,0,0,3,3,0.0%,8m
11238,3,[ixM]tetec,3222,1510,238,234,472,50.4%,11m
11238,3,kenprime,3222,1601,116,120,236,49.2%,42m
11238,3,surefire,3222,1317,91,55,146,62.3%,9m
11238,3,CHIMICHURRI,3222,525,67,47,114,58.8%,11m
11238,3,EdSHero,3222,938,51,48,99,51.5%,32m
11238,3,Fhurer,3222,1174,43,49,92,46.7%,12m
11238,3,[Hayze]ARedTornadO,3222,615,41,36,77,53.2%,21m
11238,3,NOTORIOUS,3222,746,38,31,69,55.1%,4m
11238,3,Baxtor,3222,803,36,23,59,61.0%,24m
11238,3,Shipa,3222,719,26,30,56,46.4%,19m
11238,3,[Pinoys]Katsu,3222,420,18,17,35,51.4%,11m
11238,3,SleepyOwl,3222,398,16,13,29,55.2%,24m
11238,3,lucifroom,3222,468,15,30,45,33.3%,24m
11238,3,Black,3222,342,14,11,25,56.0%,17m
11238,2,gena,3222,208,9,6,15,60.0%,8m
11238,3,[Tricky]Labrop,3222,210,6,3,9,66.7%,16m
11238,3,trolix,3222,146,5,5,10,50.0%,35m
11238,3,Harrison,3222,116,4,7,11,36.4%,23m
11238,1,llllllllllll,3222,184,4,14,18,22.2%,32m
11238,3,[NZER0]OBLIVION,3222,0,1,0,1,100.0%,39m
11238,3,Esmer,3222,30,1,4,5,20.0%,20m
11238,1,[lMiAl]eLephaNt,3222,96,1,6,7,14.3%,22m
11260,2,UNinstalll,3221,1489,312,313,625,49.9%,10m
11260,3,TheChamp,3221,1509,227,220,447,50.8%,42m
11260,3,cxu,3221,962,105,99,204,51.5%,6m
11260,3,Dori,3221,1349,81,79,160,50.6%,6m
11260,3,ImTaurus,3221,1206,75,72,147,51.0%,9m
11260,3,HappyNomad,3221,1213,58,34,92,63.0%,12m
11260,3,FranJa,3221,821,54,56,110,49.1%,35m
11260,3,[OGbros]TheDude,3221,951,42,28,70,60.0%,14m
11260,3,Sarandia,3221,980,39,33,72,54.2%,2m
11260,3,TheKing,3221,936,38,25,63,60.3%,19m
11260,3,BiggMojo,3221,595,26,27,53,49.1%,11m
11260,3,Asterius,3221,282,15,3,18,83.3%,5m
11260,3,[tCo9]KingScottIV,3221,308,15,25,40,37.5%,7m
11260,3,TETE,3221,281,10,7,17,58.8%,22m
11260,3,ICEMAN,3221,220,8,15,23,34.8%,21m
11260,3,LooDogg,3221,127,5,2,7,71.4%,30m
11260,3,Maitoparta,3221,118,3,0,3,100.0%,26m
11260,3,GulDukat,3221,30,2,2,4,50.0%,27m
11260,3,Guts,3221,60,2,8,10,20.0%,17m
11260,3,BabyShark,3221,122,2,8,10,20.0%,23m
11260,3,Blackbear,3221,0,0,2,2,0.0%,14m
11281,3,Estanislao,3220,1338,174,136,310,56.1%,27m
11281,3,Noobulater,3220,1370,93,77,170,54.7%,9m
11281,3,KoralOcean,3220,1501,72,66,138,52.2%,31m
11281,3,Tyhjio,3220,1594,67,80,147,45.6%,17m
11281,3,Fahrenheit,3220,562,19,27,46,41.3%,27m
11281,3,potatohead,3220,358,18,17,35,51.4%,38m
11281,3,LatinoKiller,3220,238,12,5,17,70.6%,15m
11281,3,blueDECK,3220,188,10,4,14,71.4%,18m
11281,2,michealean,3220,315,9,7,16,56.2%,37m
11281,3,RiP,3220,162,8,3,11,72.7%,27m
11281,3,[tdrs]MyNeighbor,3220,142,5,1,6,83.3%,35m
11281,3,nope,3220,30,5,2,7,71.4%,28m
11281,3,[FAAAAP]ghostrequiem,3220,0,4,1,5,80.0%,26m
11281,3,[M5K]vvash,3220,86,4,4,8,50.0%,19m
11281,3,Lamphouse,3220,116,4,5,9,44.4%,25m
11281,3,[EndPro]Poooooooooli,3220,30,2,2,4,50.0%,11m
11281,3,mnmlst,3220,30,2,4,6,33.3%,20m
11281,3,Adapt,3220,30,1,5,6,16.7%,17m
11281,3,Zypher,3220,0,0,1,1,0.0%,11m
11300,3,UncleVelvet,3219,1577,78,76,154,50.6%,42m
11300,3,Animoxin,3219,348,76,78,154,49.4%,7m
11300,3,BicepsAtMid,3219,494,44,29,73,60.3%,41m
11300,3,mangoboy,3219,485,19,24,43,44.2%,32m
11300,3,TheFaTOnE,3219,353,13,11,24,54.2%,19m
11300,3,OldGeroTook,3219,308,10,2,12,83.3%,31m
11300,3,[nieBla]Woltstrider,3219,226,9,0,9,100.0%,9m
11300,3,Ghost,3219,250,9,14,23,39.1%,17m
11300,3,Antiegoist,3219,88,7,4,11,63.6%,30m
11300,3,Mazer,3219,213,7,10,17,41.2%,21m
11300,3,Dansator,3219,0,4,1,5,80.0%,12m
11300,3,[NLTN]ShuLi,3219,88,3,4,7,42.9%,41m
11300,3,Acquati,3219,30,2,0,2,100.0%,38m
11300,3,Koegan,3219,30,2,6,8,25.0%,4m
11300,3,wcchairman,3219,62,2,6,8,25.0%,29m
11300,3,Dreammaker,3219,30,1,3,4,25.0%,19m
11316,3,jhosep,3218,1391,201,201,402,50.0%,32m
11316,3,Quiss,3218,867,138,107,245,56.3%,4m
11316,3,[zzzzz]Zur,3218,962,89,75,164,54.3%,33m
11316,3,[MadK]POLUX,3218,1595,77,65,142,54.2%,4m
11316,3,[RushA]SuperKingdom,3218,892,53,28,81,65.4%,38m
11316,3,[UIE]Henry,3218,1184,47,41,88,53.4%,26m
11316,3,Bertxi,3218,1058,47,44,91,51.6%,38m
11316,3,Corrigan,3218,139,28,22,50,56.0%,15m
11316,3,jito,3218,600,23,19,42,54.8%,42m
11316,3,TurboPotato,3218,332,12,19,31,38.7%,35m
11316,3,ARealBoi,3218,303,11,6,17,64.7%,37m
11316,3,uwu,3218,179,6,0,6,100.0%,14m
11316,3,Flanz,3218,174,6,8,14,42.9%,42m
11316,2,Chio,3218,0,5,0,5,100.0%,47m
11316,3,SomeJobber,3218,58,2,2,4,50.0%,16m
11316,2,qweqweqw,3218,0,2,3,5,40.0%,37m
11316,3,Riaz,3218,0,2,3,5,40.0%,15m
11316,3,[TYBROS]Yalmic,3218,0,1,0,1,100.0%,11m
11316,1,sanZeNeX,3218,0,1,1,2,50.0%,6m
11316,3,[Schiga]CireNeikual,3218,30,1,4,5,20.0%,35m
11316,3,[NatiBN]BMovieFan,3218,0,0,2,2,0.0%,34m
11337,3,realone,3217,1563,200,196,396,50.5%,15m
11337,3,CKB,3217,1522,183,172,355,51.5%,13m
11337,3,Magnusgo,3217,1457,130,119,249,52.2%,38m
11337,3,DuganCosby,3217,1576,111,114,225,49.3%,33m
11337,3,JoseCHIP,3217,1436,107,80,187,57.2%,34m
11337,3,StarBurst,3217,1006,45,29,74,60.8%,5m
11337,3,Fang,3217,821,33,33,66,50.0%,32m
11337,3,[7BG]ChiefDondre,3217,572,24,20,44,54.5%,6m
11337,3,Zapranoth,3217,353,23,20,43,53.5%,41m
11337,3,hellrazer,3217,284,19,18,37,51.4%,35m
11337,3,Steffen,3217,162,10,10,20,50.0%,34m
11337,3,Mag,3217,122,5,7,12,41.7%,4m
11337,3,DanDan,3217,58,3,4,7,42.9%,23m
11337,3,Panda,3217,88,3,9,12,25.0%,33m
11337,3,aLv,3217,86,3,9,12,25.0%,22m
11337,3,AndyPandy,3217,118,2,1,3,66.7%,5m
11337,3,[MoSun]YellowLarva,3217,30,2,2,4,50.0%,30m
11337,1,liquid,3217,0,1,1,2,50.0%,49m
11337,3,Skippy,3217,30,1,2,3,33.3%,11m
11337,3,Shadowstorm,3217,30,1,3,4,25.0%,31m
11337,3,[SolOGS]LavarsBalls,3217,0,0,1,1,0.0%,17m
11337,3,[XTGZ]AirNiran,3217,0,0,2,2,0.0%,32m
11337,3,[KIRK]LeadFarmer,3217,0,0,4,4,0.0%,7m
11360,3,Elbuen,3216,1518,281,225,506,55.5%,13m
11360,3,Thirdburd,3216,1635,251,257,508,49.4%,16m
11360,3,[HaMz]ebilice,3216,1057,120,65,185,64.9%,11m
11360,3,Koffy,3216,840,93,78,171,54.4%,4m
11360,3,guy,3216,1276,78,70,148,52.7%,38m
11360,3,[GIBE]AlfieStar,3216,1021,72,70,142,50.7%,38m
11360,3,[TGosuB]PROMETHIUM,3216,1353,56,52,108,51.9%,39m
11360,3,Peas,3216,771,35,22,57,61.4%,22m
11360,3,oGGmuX,3216,850,33,32,65,50.8%,17m
11360,3,DANI,3216,674,25,29,54,46.3%,23m
11360,3,UIIIIUIII,3216,370,15,16,31,48.4%,15m
11360,3,SHOOTERJ,3216,192,11,9,20,55.0%,41m
11360,3,GLeeary,3216,214,7,2,9,77.8%,13m
11360,3,mataperuanos,3216,0,4,1,5,80.0%,10m
11360,3,Araki,3216,65,4,2,6,66.7%,15m
11360,3,iJiGSaw,3216,0,1,0,1,100.0%,24m
11360,3,[4DPS]icedbalut,3216,0,1,0,1,100.0%,42m
11360,3,[CHEE53]BitsPlease,3216,0,1,1,2,50.0%,31m
11360,3,Exoticfritos,3216,0,0,1,1,0.0%,28m
11360,3,Neurology,3216,0,0,1,1,0.0%,17m
11360,3,III,3216,0,0,1,1,0.0%,10m
11381,3,GoldenRatio,3215,1684,134,127,261,51.3%,19m
11381,3,moonrise,3215,1499,111,84,195,56.9%,42m
11381,3,[JaMiT]Machete,3215,1549,63,61,124,50.8%,12m
11381,3,Sigma,3215,568,31,32,63,49.2%,38m
11381,3,[LoFAc]Drizent,3215,555,25,32,57,43.9%,14m
11381,3,blacKaKaRi,3215,554,21,19,40,52.5%,30m
11381,3,[ScSwrm]VaeVictus,3215,472,17,18,35,48.6%,11m
11381,3,Thal,3215,372,14,12,26,53.8%,41m
11381,3,Paum,3215,309,13,9,22,59.1%,10m
11381,3,[QP]Mrfarfadet,3215,284,10,12,22,45.5%,39m
11381,1,valithor,3215,164,7,3,10,70.0%,2h
11381,3,Agodak,3215,0,5,0,5,100.0%,6m
11381,3,[UpeV]MaXiiMoO,3215,151,5,1,6,83.3%,23m
11381,3,dogjlao,3215,0,3,2,5,60.0%,9m
11381,3,covid,3215,30,2,0,2,100.0%,12m
11381,3,CrazySushi,3215,30,2,1,3,66.7%,12m
11381,3,[Yoga1]MbaliZulu,3215,0,2,3,5,40.0%,26m
11381,2,IIIIIIIIIIII,3215,96,1,1,2,50.0%,57m
11381,3,Ictus,3215,0,1,4,5,20.0%,20m
11381,3,DarkSatyr,3215,30,1,5,6,16.7%,26m
11381,3,Kano,3215,0,0,1,1,0.0%,31m
11381,3,[BoAVN]SirTriPixz,3215,0,0,1,1,0.0%,27m
11403,3,ASlowLoris,3214,1578,143,130,273,52.4%,28m
11403,3,[PacheK]thedickdans,3214,1126,69,38,107,64.5%,13m
11403,3,[AbcCo]genjiro,3214,1276,67,56,123,54.5%,38m
11403,3,Yuger,3214,1494,55,63,118,46.6%,31m
11403,3,llllllllllll,3214,627,26,20,46,56.5%,25m
11403,3,UrineTrouble,3214,567,23,18,41,56.1%,41m
11403,3,[therat]JuanPunchMan,3214,456,18,14,32,56.2%,11m
11403,3,[plannB]Ryansdad,3214,446,16,17,33,48.5%,26m
11403,3,Depression,3214,280,14,12,26,53.8%,17m
11403,1,[NUGT]biloulebilou,3214,96,6,4,10,60.0%,5m
11403,3,LeftStroke,3214,93,4,2,6,66.7%,23m
11403,2,Ponch,3214,0,3,0,3,100.0%,26m
11403,3,SunSinK,3214,58,3,0,3,100.0%,39m
11403,3,Fulot,3214,88,3,3,6,50.0%,32m
11403,3,[biigpp]BlipDoolPoon,3214,0,1,0,1,100.0%,21m
11403,3,pork,3214,0,1,1,2,50.0%,33m
11403,3,[cell5]BigmaC,3214,0,1,4,5,20.0%,22m
11403,3,IMissYouGrMa,3214,0,0,1,1,0.0%,26m
11403,2,numnum,3214,0,0,1,1,0.0%,4m
11422,3,pewp,3213,1360,312,288,600,52.0%,5m
11422,3,FacadaNoBuxo,3213,583,158,158,316,50.0%,40m
11422,3,[FTYP]PKParK,3213,1169,75,57,132,56.8%,2m
11422,3,buffzerg,3213,1540,69,55,124,55.6%,26m
11422,3,James,3213,967,57,42,99,57.6%,12m
11422,3,Alect,3213,879,53,32,85,62.4%,12m
11422,3,Atmaling,3213,434,28,19,47,59.6%,4m
11422,3,loosecannon,3213,696,27,26,53,50.9%,21m
11422,2,Theifz,3213,341,12,5,17,70.6%,26m
11422,3,[Big117]theprobelem,3213,304,12,13,25,48.0%,30m
11422,3,Flash,3213,270,10,11,21,47.6%,11m
11422,2,Matthew,3213,134,4,15,19,21.1%,35m
11422,3,[GOPERÚ]AjiDeGallina,3213,30,2,0,2,100.0%,16m
11422,3,TheBestfOu,3213,60,2,6,8,25.0%,35m
11422,3,BishopGainzz,3213,0,1,0,1,100.0%,21m
11422,3,[DIVZ]vaguito,3213,30,1,1,2,50.0%,21m
11422,3,Artanis,3213,0,0,1,1,0.0%,26m
11422,3,MissClick,3213,0,0,1,1,0.0%,12m
11422,3,jojoispig,3213,0,0,2,2,0.0%,6m
11441,3,WhatIsLife,3212,1437,155,148,303,51.2%,5m
11441,3,dodo,3212,1452,105,86,191,55.0%,20m
11441,3,[BRUVV]Telephone,3212,812,61,57,118,51.7%,23m
11441,3,Dittaspank,3212,1208,44,50,94,46.8%,14m
11441,3,SuperBug,3212,957,40,31,71,56.3%,41m
11441,3,dreambeing,3212,551,21,14,35,60.0%,42m
11441,3,CubeCow,3212,508,20,9,29,69.0%,42m
11441,3,[SDeoG]chub,3212,428,19,12,31,61.3%,28m
11441,3,Batman,3212,482,18,21,39,46.2%,26m
11441,3,rithosDOOM,3212,375,14,9,23,60.9%,17m
11441,2,[AoBDE]Snaker,3212,155,4,1,5,80.0%,13m
11441,3,Poseidon,3212,0,4,1,5,80.0%,24m
11441,3,HeroPalo,3212,30,2,0,2,100.0%,4m
11441,2,erwuzai,3212,0,2,3,5,40.0%,59m
11441,3,oath,3212,0,1,0,1,100.0%,42m
11441,3,Sylar,3212,30,1,1,2,50.0%,26m
11441,3,Babauzis,3212,30,1,1,2,50.0%,39m
11441,3,zerg,3212,30,1,2,3,33.3%,13m
11441,3,Fokkert,3212,0,1,4,5,20.0%,25m
11441,3,[st0bs]CupCokeYum,3212,30,1,4,5,20.0%,4m
11441,3,Tortilla,3212,18,1,4,5,20.0%,38m
11441,3,billcipher,3212,30,1,7,8,12.5%,38m
11441,3,[Epic]Cauchy,3212,0,0,1,1,0.0%,33m
11441,3,BowHobaWitz,3212,0,0,1,1,0.0%,31m
11465,3,daku,3211,1482,412,396,808,51.0%,8m
11465,3,grEEngLade,3211,1409,66,66,132,50.0%,32m
11465,3,Corrales,3211,1337,58,50,108,53.7%,37m
11465,3,Finestim,3211,725,55,36,91,60.4%,6m
11465,3,HamChoi,3211,272,35,31,66,53.0%,27m
11465,3,[tworm]MajesticFury,3211,773,27,37,64,42.2%,27m
11465,3,DanielXian,3211,726,25,31,56,44.6%,20m
11465,3,KeyBlader,3211,580,22,22,44,50.0%,28m
11465,3,Davester,3211,532,20,22,42,47.6%,25m
11465,3,BJW,3211,486,17,24,41,41.5%,11m
11465,3,[Peeepz]rocky,3211,278,10,9,19,52.6%,19m
11465,3,[TPGGXD]Infected,3211,288,10,12,22,45.5%,11m
11465,3,[HIPASS]urexxxx,3211,226,8,8,16,50.0%,41m
11465,3,[7IP]Bael,3211,109,6,1,7,85.7%,10m
11465,3,SeMa,3211,123,6,2,8,75.0%,5m
11465,3,[ConFed]drgreenthumb,3211,150,5,7,12,41.7%,27m
11465,3,CheF,3211,118,5,8,13,38.5%,13m
11465,3,Justanoob,3211,0,4,1,5,80.0%,5m
11465,3,Hipperia,3211,60,2,2,4,50.0%,2m
11465,3,DfjKcaka,3211,0,2,3,5,40.0%,30m
11465,3,[daBBC]FreshPrince,3211,0,1,0,1,100.0%,36m
11465,3,Shootz,3211,0,0,1,1,0.0%,12m
11465,3,oGreZerGameR,3211,0,0,2,2,0.0%,28m
11488,3,LegacyOfVoid,3210,1573,208,151,359,57.9%,27m
11488,3,bapingus,3210,339,68,55,123,55.3%,19m
11488,3,CorgiTerrier,3210,703,63,66,129,48.8%,13m
11488,3,Spatzle,3210,1372,54,54,108,50.0%,13m
11488,3,Thorminator,3210,1018,37,34,71,52.1%,31m
11488,3,UrineTrouble,3210,436,23,24,47,48.9%,7m
11488,3,GrimDawn,3210,462,17,17,34,50.0%,41m
11488,3,[gam30n]kiobod,3210,518,17,24,41,41.5%,10m
11488,3,DSTittyBang,3210,353,14,12,26,53.8%,22m
11488,3,SpaceApe,3210,242,10,6,16,62.5%,7m
11488,3,Patronus,3210,159,8,9,17,47.1%,34m
11488,3,DoGG,3210,250,8,15,23,34.8%,11m
11488,3,appnori,3210,0,4,1,5,80.0%,30m
11488,3,SirePotato,3210,0,4,1,5,80.0%,5m
11488,3,[MLPog]Astealthyko,3210,60,3,3,6,50.0%,12m
11488,3,[KaGaN]Chinesenoob,3210,88,3,3,6,50.0%,8m
11488,3,Pnissushi,3210,88,3,10,13,23.1%,38m
11488,3,[xBoZi]DaTwoOrda,3210,114,2,5,7,28.6%,29m
11488,3,eatmorefish,3210,0,1,0,1,100.0%,42m
11488,3,MrMad,3210,30,1,1,2,50.0%,39m
11488,3,[oJKo]JoshEE,3210,0,1,2,3,33.3%,17m
11488,3,Nat,3210,30,1,2,3,33.3%,39m
11488,3,nicolasbeer,3210,0,0,1,1,0.0%,14m
11488,3,[HUSHrx]Interstellar,3210,0,0,1,1,0.0%,41m
11488,3,[twlfs]SRM,3210,0,0,1,1,0.0%,15m
11488,3,onakua,3210,0,0,5,5,0.0%,31m
11514,3,[VOY3UR]JimNiteBlade,3209,1482,237,223,460,51.5%,12m
11514,3,[TeamUR]BlingBlong,3209,557,23,13,36,63.9%,14m
11514,3,equinox,3209,474,20,21,41,48.8%,11m
11514,3,Kimchijjigae,3209,88,4,3,7,57.1%,22m
11514,3,[PD2D]Killakure,3209,86,3,2,5,60.0%,6m
11514,3,Sloth,3209,30,3,5,8,37.5%,9m
11514,3,[Dicboy]DrEvil,3209,58,2,2,4,50.0%,17m
11514,1,FaPLiNG,3209,96,2,6,8,25.0%,11m
11514,3,[VIOC]STAROS,3209,30,1,1,2,50.0%,2m
11514,3,Love,3209,30,1,1,2,50.0%,39m
11514,3,[Maths]Steven,3209,0,0,3,3,0.0%,23m
11525,3,[LOHs]CAZADOR,3208,1536,269,267,536,50.2%,15m
11525,3,SuperMan,3208,1553,132,115,247,53.4%,28m
11525,3,Jabooobooo,3208,919,60,51,111,54.1%,19m
11525,3,EasyMac,3208,1174,49,36,85,57.6%,9m
11525,3,ALUCARDHELL,3208,294,46,46,92,50.0%,20m
11525,3,Ben,3208,1012,41,34,75,54.7%,11m
11525,3,wbckulty,3208,952,39,30,69,56.5%,16m
11525,3,BBCallking,3208,598,27,16,43,62.8%,18m
11525,3,[ZCAce]Captain,3208,524,19,19,38,50.0%,41m
11525,3,[Rbrth]JesseBlue,3208,183,11,16,27,40.7%,30m
11525,3,CaptainHook,3208,204,8,9,17,47.1%,40m
11525,1,[1A2A]Hyouka,3208,169,6,5,11,54.5%,1h
11525,3,llllllllllll,3208,175,5,3,8,62.5%,40m
11525,3,[HMX]Regal,3208,106,5,5,10,50.0%,34m
11525,3,MAXGJ,3208,88,3,3,6,50.0%,21m
11525,3,[BlTEL]HidenTiger,3208,0,2,3,5,40.0%,33m
11525,3,[Lowko]Velharnin,3208,0,1,0,1,100.0%,16m
11525,3,DueSs,3208,0,1,0,1,100.0%,23m
11543,3,[SSEAS]silverking,3207,1511,180,156,336,53.6%,39m
11543,1,[MS13]Zenzou,3207,1466,73,99,172,42.4%,9m
11543,3,hehexd,3207,661,72,67,139,51.8%,31m
11543,3,[QTclub]Les,3207,502,55,47,102,53.9%,34m
11543,3,Cyro,3207,764,44,28,72,61.1%,31m
11543,3,[1vsM]CrimeWave,3207,322,11,12,23,47.8%,41m
11543,3,Kureiton,3207,250,10,1,11,90.9%,9m
11543,3,stonks,3207,219,7,3,10,70.0%,21m
11543,3,[Wat3rs]Logos,3207,204,7,13,20,35.0%,17m
11543,3,Crayon,3207,204,7,16,23,30.4%,41m
11543,3,Romeo,3207,173,5,3,8,62.5%,40m
11543,3,[AD3C]Sensus,3207,88,3,3,6,50.0%,42m
11543,2,Life,3207,40,2,2,4,50.0%,39m
11543,3,Cambam,3207,60,2,3,5,40.0%,35m
11543,3,Water,3207,62,2,8,10,20.0%,2m
11543,3,Agent,3207,0,1,1,2,50.0%,18m
11543,3,Duxy,3207,97,1,2,3,33.3%,39m
11543,3,[TGULS]miko,3207,0,0,1,1,0.0%,26m
11543,3,Gnarpig,3207,0,0,1,1,0.0%,29m
11562,3,[EZTZPZ]Blank,3206,1408,125,120,245,51.0%,34m
11562,3,[B2TF]Lox,3206,1274,60,58,118,50.8%,34m
11562,3,DrossRotzank,3206,617,36,8,44,81.8%,18m
11562,3,DrGuiLao,3206,551,31,26,57,54.4%,19m
11562,3,AcSplit,3206,517,26,9,35,74.3%,6m
11562,3,Yes,3206,433,21,10,31,67.7%,23m
11562,3,KamalaHaRriS,3206,435,19,15,34,55.9%,16m
11562,3,JoesAhoge,3206,522,18,27,45,40.0%,12m
11562,3,[scMAUI]mbarde,3206,503,17,24,41,41.5%,42m
11562,3,Boss,3206,252,10,11,21,47.6%,24m
11562,3,SoulBaby,3206,169,5,1,6,83.3%,25m
11562,1,[lCSt]Salitrex,3206,96,5,2,7,71.4%,2h
11562,2,[SCCoop]BachVN,3206,138,5,2,7,71.4%,6m
11562,3,[FofS]Rain,3206,120,5,3,8,62.5%,17m
11562,3,[SANGRE]Valentina,3206,58,2,1,3,66.7%,3m
11562,2,Insomnia,3206,0,1,0,1,100.0%,2m
11562,3,mondro,3206,0,1,0,1,100.0%,15m
11562,3,DerPadawan,3206,0,1,0,1,100.0%,14m
11562,3,Shrike,3206,0,0,1,1,0.0%,41m
11562,3,Rocky,3206,0,0,1,1,0.0%,13m
11562,3,[NSDC]mbarnett,3206,0,0,3,3,0.0%,32m
11583,3,[FacTat]Jizzles,3205,933,213,205,418,51.0%,5m
11583,3,Carbon,3205,735,68,66,134,50.7%,37m
11583,3,GeneraltheOG,3205,455,17,13,30,56.7%,15m
11583,3,ObliWan,3205,327,15,10,25,60.0%,21m
11583,3,[Igbt]FlyinHurtBus,3205,114,7,1,8,87.5%,42m
11583,3,[ZFz]AnUglyOkapi,3205,188,6,8,14,42.9%,11m
11583,3,[DIQPTE]beerandmath,3205,168,6,18,24,25.0%,33m
11583,3,Necro,3205,121,3,2,5,60.0%,19m
11583,3,Mazerakham,3205,30,2,1,3,66.7%,26m
11583,3,[Risque]malakarlian,3205,0,1,0,1,100.0%,40m
11583,3,EMP,3205,18,1,1,2,50.0%,42m
11583,3,QuestionMark,3205,30,1,2,3,33.3%,19m
11583,3,SWARM,3205,0,1,5,6,16.7%,18m
11583,3,[LORRA]BubbleBoy,3205,0,0,2,2,0.0%,41m
11583,3,[FVHS03]SiR,3205,0,0,3,3,0.0%,42m
11598,3,CitizenSnips,3204,1561,590,585,1175,50.2%,7m
11598,3,Ryz,3204,1370,196,194,390,50.3%,32m
11598,3,TrashPandA,3204,939,124,99,223,55.6%,6m
11598,3,[sk3tch]MegaDancerZF,3204,1276,67,65,132,50.8%,41m
11598,3,lazytemplar,3204,1288,46,56,102,45.1%,16m
11598,3,atlantane,3204,1086,40,45,85,47.1%,40m
11598,3,BAYACETO,3204,410,18,6,24,75.0%,17m
11598,1,LouisVitton,3204,351,15,10,25,60.0%,5m
11598,3,[NPhase]Swiftdaddy,3204,336,11,10,21,52.4%,31m
11598,3,Deathkillerz,3204,312,11,20,31,35.5%,12m
11598,3,BickusDickus,3204,275,9,7,16,56.2%,5m
11598,3,Asch,3204,180,8,5,13,61.5%,10m
11598,3,DireBearForm,3204,237,7,5,12,58.3%,6m
11598,3,StimMarine,3204,42,6,12,18,33.3%,32m
11598,3,[SYNDCT]DarthZerg,3204,90,4,2,6,66.7%,39m
11598,3,LeWildWolf,3204,34,3,1,4,75.0%,13m
11598,3,problems,3204,0,3,2,5,60.0%,1h
11598,3,NewZeratul,3204,30,2,1,3,66.7%,31m
11598,3,LiquidPaper,3204,0,2,4,6,33.3%,9m
11598,3,[SGsc18]TROVAS,3204,0,1,0,1,100.0%,6m
11598,3,Deri,3204,0,0,1,1,0.0%,41m
11619,3,rakom,3203,876,150,141,291,51.5%,39m
11619,3,CaQcMtlVSL,3203,1426,148,138,286,51.7%,38m
11619,3,[DKGLL]KALDALIZ,3203,1521,87,87,174,50.0%,32m
11619,3,[FMX]KmpaOne,3203,1498,57,60,117,48.7%,20m
11619,3,[Pig2]Nedserd,3203,416,38,42,80,47.5%,42m
11619,3,Avantasia,3203,834,36,22,58,62.1%,13m
11619,3,marklar,3203,999,36,33,69,52.2%,28m
11619,3,NoobKiller,3203,744,33,34,67,49.3%,5m
11619,3,AchinX,3203,428,30,21,51,58.8%,37m
11619,3,kobe,3203,667,26,21,47,55.3%,33m
11619,3,JChul,3203,436,16,15,31,51.6%,31m
11619,3,vonster,3203,355,15,10,25,60.0%,4m
11619,3,GKO,3203,254,15,19,34,44.1%,7m
11619,3,sleeperserv,3203,241,13,12,25,52.0%,32m
11619,3,upsidedown,3203,260,11,7,18,61.1%,24m
11619,3,Hawks,3203,237,8,2,10,80.0%,39m
11619,3,Dreemurr,3203,206,7,8,15,46.7%,38m
11619,3,icheese,3203,193,6,2,8,75.0%,3m
11619,3,[Sune]Mako,3203,170,6,4,10,60.0%,2m
11619,3,IIIIIIIII,3203,0,4,1,5,80.0%,5m
11619,3,[hklee]SpyTe,3203,161,4,1,5,80.0%,10m
11619,3,dkssud,3203,0,4,1,5,80.0%,9m
11619,1,DictatorKev,3203,48,3,14,17,17.6%,11m
11619,3,JessyDivaG,3203,142,2,5,7,28.6%,17m
11619,3,taktIK,3203,0,1,0,1,100.0%,12m
11619,3,[nieBla]QQuisoteSan,3203,30,1,1,2,50.0%,12m
11619,3,SLAYER,3203,0,1,1,2,50.0%,9m
11646,2,GypsyDanger,3202,1537,179,182,361,49.6%,12m
11646,2,Pragster,3202,1052,135,139,274,49.3%,22m
11646,3,[RAMorz]LargeCharles,3202,1273,104,98,202,51.5%,19m
11646,3,QcPac,3202,1570,89,76,165,53.9%,8m
11646,3,DarkFox,3202,1466,83,88,171,48.5%,21m
11646,3,JORGE,3202,1510,77,84,161,47.8%,35m
11646,3,[Asilo]raphaeldark,3202,1424,69,63,132,52.3%,42m
11646,3,NoahParks,3202,1075,59,57,116,50.9%,41m
11646,3,TheWitcher,3202,943,38,24,62,61.3%,11m
11646,3,DreamX,3202,731,30,27,57,52.6%,17m
11646,3,murkleston,3202,505,20,15,35,57.1%,23m
11646,3,[GdAT]Legendk,3202,174,6,5,11,54.5%,24m
11646,3,[StrMed]YØkoXi,3202,114,4,7,11,36.4%,13m
11646,3,AloudSound,3202,97,2,2,4,50.0%,24m
11646,3,CadetChoRet,3202,60,2,4,6,33.3%,12m
11646,3,ParGeLeNniS,3202,0,1,0,1,100.0%,30m
11646,3,[UpeV]PLATANO,3202,30,1,2,3,33.3%,37m
11646,3,[cl0udM]AIphaStar,3202,30,1,2,3,33.3%,16m
11646,3,WongWong,3202,0,0,1,1,0.0%,19m
11646,3,Gnomo,3202,0,0,5,5,0.0%,34m
11666,3,[i8]MojoJojo,3201,1580,430,386,816,52.7%,13m
11666,3,[sk3tch]DarkVil,3201,1547,327,317,644,50.8%,24m
11666,2,[RLSM]jdc,3201,1612,263,264,527,49.9%,21m
11666,3,[xNPGx]Jhandro,3201,1437,105,74,179,58.7%,10m
11666,3,Fox,3201,642,105,96,201,52.2%,26m
11666,3,OldDriver,3201,1598,89,93,182,48.9%,22m
11666,3,Dking,3201,1130,85,61,146,58.2%,14m
11666,3,bbbbb,3201,980,67,59,126,53.2%,32m
11666,3,Leo,3201,1236,52,44,96,54.2%,14m
11666,3,Dizbiotch,3201,741,49,44,93,52.7%,31m
11666,3,[EoMX]artanis,3201,984,48,61,109,44.0%,28m
11666,3,Catalyst,3201,793,30,26,56,53.6%,4m
11666,3,DaBunkaKid,3201,786,30,34,64,46.9%,29m
11666,3,Dayman,3201,144,11,14,25,44.0%,12m
11666,3,[sOLsc]Dante,3201,176,10,7,17,58.8%,31m
11666,3,NoMicro,3201,236,9,8,17,52.9%,28m
11666,1,Zerg,3201,141,6,4,10,60.0%,43m
11666,3,TheMadBug,3201,86,3,2,5,60.0%,19m
11666,3,TavinhO,3201,30,2,2,4,50.0%,23m
11666,3,NapoleonDynA,3201,0,1,0,1,100.0%,30m
11666,3,MmmHmm,3201,0,1,1,2,50.0%,5m
11666,3,toshy,3201,0,0,1,1,0.0%,21m
11666,3,[SHILE]ThomDark,3201,0,0,1,1,0.0%,13m
11689,3,alxzzz,3200,1555,179,175,354,50.6%,13m
11689,3,Garett,3200,1577,148,135,283,52.3%,10m
11689,3,[IrmBRs]MicroAngelo,3200,1583,77,72,149,51.7%,42m
11689,3,Durant,3200,782,32,26,58,55.2%,33m
11689,3,SodaGrackers,3200,701,30,21,51,58.8%,33m
11689,3,[icCCce]InfernoForce,3200,714,26,26,52,50.0%,26m
11689,3,YeePs,3200,462,18,20,38,47.4%,39m
11689,3,[S980K]juanitoOo,3200,270,9,13,22,40.9%,6m
11689,3,MaK,3200,195,7,1,8,87.5%,14m
11689,2,[MRK]MkLuvin,3200,142,6,2,8,75.0%,41m
11689,3,[UpxV]aletonii,3200,160,5,2,7,71.4%,37m
11689,3,[EvilGC]SkillHunter,3200,156,5,5,10,50.0%,17m
11689,3,Newbie,3200,0,4,1,5,80.0%,23m
11689,3,[FyHr]RakeIsSerral,3200,30,2,0,2,100.0%,30m
11689,3,MTD,3200,107,2,1,3,66.7%,23m
11689,3,Napko,3200,30,2,2,4,50.0%,12m
11689,3,Cheesecake,3200,0,1,0,1,100.0%,2m
11689,3,[notCo]HerOTimE,3200,30,1,1,2,50.0%,6m
11689,3,Fraska,3200,0,1,2,3,33.3%,22m
11708,3,[DETER]DJMerlin,3199,1576,248,234,482,51.5%,10m
11708,3,Urbandanish,3199,1590,224,218,442,50.7%,41m
11708,3,simcity,3199,1537,163,149,312,52.2%,12m
11708,3,BradLee,3199,1344,142,121,263,54.0%,2m
11708,3,[SyLx]Corkscrew,3199,356,69,26,95,72.6%,41m
11708,3,IamMrV,3199,583,63,49,112,56.2%,42m
11708,3,[ZTemp]Carnage,3199,470,34,21,55,61.8%,4m
11708,3,DåTrsSpkViEt,3199,838,33,32,65,50.8%,18m
11708,3,xlx,3199,654,25,27,52,48.1%,28m
11708,3,Coral,3199,334,13,15,28,46.4%,7m
11708,3,Rice,3199,198,7,7,14,50.0%,3m
11708,3,TylerP,3199,179,6,2,8,75.0%,21m
11708,3,Dingles,3199,120,5,5,10,50.0%,15m
11708,3,OGDrDre,3199,165,4,2,6,66.7%,20m
11708,3,samfoolery,3199,113,4,8,12,33.3%,26m
11708,3,Atrauma,3199,86,3,4,7,42.9%,6m
11708,3,GoldenChickn,3199,30,2,2,4,50.0%,5m
11708,3,[OhYaaa]Dragan,3199,60,2,3,5,40.0%,27m
11708,3,[AntiNs]gwagwa,3199,0,2,3,5,40.0%,24m
11708,3,Egoist,3199,60,2,4,6,33.3%,12m
11708,3,Afixis,3199,30,2,5,7,28.6%,12m
11708,3,BWage,3199,0,1,0,1,100.0%,17m
11708,3,ParThree,3199,0,1,0,1,100.0%,21m
11708,3,Magnifico,3199,0,0,1,1,0.0%,19m
11708,2,Cerbero,3199,0,0,1,1,0.0%,49m
11708,3,[NPhasA]DSAFreikorps,3199,0,0,2,2,0.0%,5m
11734,3,dirtyliberal,3198,1523,690,689,1379,50.0%,35m
11734,3,DevilZ,3198,1621,279,272,551,50.6%,28m
11734,3,StMichael,3198,1580,211,200,411,51.3%,9m
11734,3,[BoRnGo]Lance,3198,1444,77,80,157,49.0%,35m
11734,3,DubCaesar,3198,1232,70,71,141,49.6%,20m
11734,3,[DrgnEg]MAHLERHAMMER,3198,689,66,46,112,58.9%,15m
11734,3,PandaParadis,3198,1248,64,53,117,54.7%,35m
11734,3,Caliburn,3198,1250,50,50,100,50.0%,17m
11734,3,superbimbo,3198,986,41,43,84,48.8%,35m
11734,3,GrandCaravan,3198,344,15,11,26,57.7%,24m
11734,3,[biboi]NecroN,3198,398,14,16,30,46.7%,43m
11734,2,[I3ro]Donjuancho,3198,291,10,12,22,45.5%,37m
11734,3,THSquareD,3198,0,4,1,5,80.0%,40m
11734,3,[REPORT]mappyz,3198,0,4,1,5,80.0%,9m
11734,3,Galactagon,3198,108,4,7,11,36.4%,5m
11734,3,IIIIIIIIIIII,3198,0,3,1,4,75.0%,12m
11734,3,HeatEngine,3198,30,2,0,2,100.0%,25m
11734,3,SibuCAT,3198,30,2,1,3,66.7%,6m
11734,3,Loveless,3198,58,2,6,8,25.0%,11m
11734,3,[THR4SH]KlubSandwich,3198,0,1,0,1,100.0%,2m
11734,3,Hector,3198,0,1,0,1,100.0%,26m
11734,3,[ILPl]TrippyWolf,3198,0,0,1,1,0.0%,43m
11734,3,HappyPants,3198,0,0,1,1,0.0%,34m
11734,3,[iFinal]Egobrain,3198,0,0,1,1,0.0%,41m
11734,3,CaptainBurnz,3198,0,0,2,2,0.0%,7m
11734,1,SpRaYFartt,3198,0,0,8,8,0.0%,1h
11760,3,Hero,3197,1592,241,207,448,53.8%,10m
11760,3,[TSØP]RoBoT,3197,913,58,52,110,52.7%,38m
11760,3,SoEasy,3197,1042,47,35,82,57.3%,17m
11760,3,OGhost,3197,1166,42,44,86,48.8%,13m
11760,3,iWon,3197,803,37,31,68,54.4%,28m
11760,2,Epoch,3197,1004,36,57,93,38.7%,17m
11760,3,ggnore,3197,344,17,11,28,60.7%,25m
11760,3,Whatlight,3197,426,15,18,33,45.5%,15m
11760,3,cichlisuite,3197,328,12,17,29,41.4%,31m
11760,3,dounut,3197,231,9,4,13,69.2%,19m
11760,3,[lMMl]Revo,3197,166,8,4,12,66.7%,17m
11760,3,[D0J0]Nihjanix,3197,219,7,11,18,38.9%,2m
11760,3,OleCob,3197,30,5,2,7,71.4%,13m
11760,3,[Macac0]JimenoKTKZS,3197,86,4,2,6,66.7%,32m
11760,3,FleurDeMur,3197,30,2,0,2,100.0%,19m
11760,3,[SiiR]Sanguine,3197,90,2,3,5,40.0%,30m
11760,3,SickFlick,3197,0,1,0,1,100.0%,39m
11760,3,[SLBGF]FauxFox,3197,30,1,1,2,50.0%,17m
11760,3,Toddpiece,3197,0,1,1,2,50.0%,25m
11760,3,BoysNightOut,3197,95,1,3,4,25.0%,42m
11760,3,BrockSamson,3197,30,1,3,4,25.0%,17m
11760,1,[CASS]Cassidy,3197,0,0,1,1,0.0%,3h
11782,3,GauchoBagual,3196,1521,102,84,186,54.8%,30m
11782,3,[iAm]Clandestinus,3196,1505,87,88,175,49.7%,10m
11782,3,Clamjam,3196,1408,80,78,158,50.6%,14m
11782,3,[Weac]bananaman,3196,1020,43,39,82,52.4%,25m
11782,3,Lithium,3196,498,26,22,48,54.2%,3m
11782,3,iwillrush,3196,366,13,15,28,46.4%,26m
11782,3,[iTrolI]Badgerfc,3196,270,8,8,16,50.0%,42m
11782,2,IIIllllIIIIl,3196,96,5,2,7,71.4%,3h
11782,3,Nicolodian,3196,0,4,1,5,80.0%,26m
11782,3,DaveyGunface,3196,60,2,4,6,33.3%,26m
11782,3,OniOn,3196,0,0,1,1,0.0%,12m
11782,3,[4Fun]JVKMARCO,3196,0,0,1,1,0.0%,21m
11782,3,[CRAKS]zeusstrike,3196,0,0,1,1,0.0%,21m
11782,3,INnoVation,3196,0,0,1,1,0.0%,11m
11782,3,[ETTyeh]ETT,3196,0,0,5,5,0.0%,7m
11797,3,Qikaiyao,3195,1361,104,87,191,54.5%,37m
11797,3,TulleBukken,3195,903,39,33,72,54.2%,37m
11797,3,Pure,3195,808,38,30,68,55.9%,5m
11797,3,kAraSU,3195,474,20,11,31,64.5%,9m
11797,3,[KiTeam]KiTScarleTT,3195,519,19,30,49,38.8%,39m
11797,3,IlIlIlIlIlIl,3195,389,17,20,37,45.9%,22m
11797,3,Sinbad,3195,422,15,14,29,51.7%,23m
11797,3,Swift,3195,269,13,7,20,65.0%,26m
11797,3,Miyagi,3195,306,12,14,26,46.2%,16m
11797,3,[Kappa8]TricoCV,3195,130,9,11,20,45.0%,37m
11797,3,CarolBaskin,3195,201,8,3,11,72.7%,15m
11797,2,RedStar,3195,254,8,6,14,57.1%,23m
11797,3,Evaneslink,3195,205,6,4,10,60.0%,21m
11797,1,MrGhosty,3195,121,5,4,9,55.6%,58m
11797,3,Asuka,3195,86,4,4,8,50.0%,27m
11797,3,IllIIIllllII,3195,117,3,0,3,100.0%,34m
11797,3,Alex,3195,62,2,4,6,33.3%,5m
11797,3,Alsanders,3195,0,1,3,4,25.0%,25m
11797,2,[CLord]Hipertex,3195,0,1,4,5,20.0%,29m
11797,3,DChoi,3195,0,1,5,6,16.7%,26m
11797,3,WellFedSyco,3195,0,0,1,1,0.0%,15m
11797,3,Bubba,3195,0,0,1,1,0.0%,7m
11797,3,Joseph,3195,0,0,1,1,0.0%,12m
11820,3,MotitaTheDog,3194,1516,333,334,667,49.9%,19m
11820,3,[AgK]Jmint,3194,1588,187,185,372,50.3%,20m
11820,3,[UNoS]Player,3194,1537,184,175,359,51.3%,12m
11820,3,hERO,3194,1297,157,127,284,55.3%,36m
11820,3,Nezvick,3194,1567,134,119,253,53.0%,9m
11820,3,[UpxV]CondorAlfa,3194,1545,67,57,124,54.0%,34m
11820,3,Panzora,3194,1020,51,58,109,46.8%,10m
11820,3,Ravek,3194,675,41,37,78,52.6%,6m
11820,3,LeMec,3194,691,36,15,51,70.6%,42m
11820,3,PsYcHoTiC,3194,551,25,6,31,80.6%,13m
11820,3,ATLien,3194,402,15,18,33,45.5%,12m
11820,3,Wodan,3194,378,12,12,24,50.0%,37m
11820,3,aXFireUpGG,3194,153,5,1,6,83.3%,24m
11820,3,asereje,3194,0,4,1,5,80.0%,1h
11820,3,[LGRW]Stuke,3194,0,1,0,1,100.0%,6m
11820,3,[ScrBnG]SCArium,3194,30,1,1,2,50.0%,23m
11820,3,AncientAstra,3194,0,0,1,1,0.0%,19m
11837,2,Bail,3193,1507,437,423,860,50.8%,30m
11837,3,[BONCK]BokiDirty,3193,770,113,95,208,54.3%,13m
11837,3,Ranger,3193,1091,84,81,165,50.9%,13m
11837,3,SpaceTime,3193,757,50,41,91,54.9%,37m
11837,3,StylesPapich,3193,797,49,51,100,49.0%,16m
11837,3,Quarky,3193,876,46,48,94,48.9%,34m
11837,3,SeabsisKing,3193,482,21,12,33,63.6%,21m
11837,3,[MCBR]ShinCobra,3193,427,20,9,29,69.0%,39m
11837,3,NoobsRUs,3193,372,17,13,30,56.7%,8m
11837,3,FriendComp,3193,407,15,15,30,50.0%,25m
11837,3,[765]Bakon,3193,294,9,21,30,30.0%,6m
11837,3,[GSXR1K]LionelMessi,3193,224,8,14,22,36.4%,40m
11837,3,kynigos,3193,212,7,3,10,70.0%,7m
11837,3,[PTHero]Vampire,3193,140,7,10,17,41.2%,41m
11837,3,OPPA,3193,191,6,3,9,66.7%,5m
11837,3,lGoDaRkMaNll,3193,134,3,5,8,37.5%,21m
11837,1,Specialist,3193,0,2,3,5,40.0%,33m
11837,1,WarlorD,3193,0,1,1,2,50.0%,3h
11837,2,[A5]JunLong,3193,0,0,1,1,0.0%,3h
11837,3,repayment,3193,0,0,3,3,0.0%,12m
11857,2,ovelisco,3192,1571,149,149,298,50.0%,42m
11857,3,Frankyboy,3192,1554,95,82,177,53.7%,5m
11857,3,SCV,3192,1145,86,68,154,55.8%,13m
11857,3,Lock,3192,1568,78,61,139,56.1%,7m
11857,3,Legolas,3192,882,77,75,152,50.7%,19m
11857,3,viruzvz,3192,1143,50,40,90,55.6%,23m
11857,3,Delay,3192,1280,45,57,102,44.1%,19m
11857,3,[GOPERÚ]Alan,3192,744,44,21,65,67.7%,20m
11857,3,aBarcode,3192,1071,44,45,89,49.4%,28m
11857,3,Cyclone,3192,1032,40,40,80,50.0%,38m
11857,3,helpme,3192,687,30,23,53,56.6%,30m
11857,3,Bland,3192,452,17,17,34,50.0%,25m
11857,3,LuckyMoney,3192,232,8,10,18,44.4%,38m
11857,3,Unsu,3192,185,6,1,7,85.7%,37m
11857,3,mindgames,3192,86,4,4,8,50.0%,2m
11857,3,ToFuBoY,3192,90,4,6,10,40.0%,26m
11857,3,[myLORT]Nostalgia,3192,122,3,2,5,60.0%,24m
11857,3,jojo,3192,60,3,5,8,37.5%,41m
11857,3,BLueDream,3192,88,3,7,10,30.0%,35m
11857,3,Lucius,3192,30,2,0,2,100.0%,26m
11857,3,Lasagna,3192,0,2,3,5,40.0%,33m
11857,3,[Kaii]dOMAIn,3192,30,1,2,3,33.3%,36m
11857,3,Wickerman,3192,0,0,1,1,0.0%,3m
11880,3,ZynKa,3191,1455,293,272,565,51.9%,38m
11880,3,modulo,3191,1340,139,134,273,50.9%,42m
11880,3,Audioslave,3191,1475,72,61,133,54.1%,20m
11880,3,[LCE]HeroMarine,3191,1378,63,63,126,50.0%,16m
11880,3,Falco,3191,1241,58,61,119,48.7%,31m
11880,3,MATHEMATIK,3191,814,31,30,61,50.8%,37m
11880,3,[GOCHOO]ThaWesT,3191,379,23,20,43,53.5%,26m
11880,3,SuperMage,3191,313,10,8,18,55.6%,22m
11880,3,goblin,3191,114,8,5,13,61.5%,35m
11880,3,[BIGFUT]Symtex,3191,234,8,18,26,30.8%,34m
11880,3,trentgorg,3191,119,3,0,3,100.0%,11m
11880,3,iWind,3191,58,3,1,4,75.0%,8m
11880,3,JackalOprah,3191,60,3,5,8,37.5%,41m
11880,3,iloveUSA,3191,30,2,4,6,33.3%,41m
11880,2,[nr]nrTwenty,3191,0,1,0,1,100.0%,18m
11880,3,Nemegon,3191,30,1,2,3,33.3%,7m
11880,3,LiquidSoap,3191,0,1,5,6,16.7%,18m
11880,3,DreWRanger,3191,0,0,1,1,0.0%,32m
11898,3,dant,3190,1575,517,514,1031,50.1%,8m
11898,3,[MlLK]Aleph,3190,983,43,27,70,61.4%,7m
11898,3,leavethegame,3190,200,18,11,29,62.1%,15m
11898,3,CrossSTi,3190,381,15,11,26,57.7%,9m
11898,2,JeanJean,3190,241,11,8,19,57.9%,7m
11898,3,[ZkStN]ack,3190,260,9,17,26,34.6%,28m
11898,3,[421]Tyho,3190,237,8,5,13,61.5%,40m
11898,3,hovsinger,3190,204,7,16,23,30.4%,14m
11898,1,[DY2K]DJmix,3190,96,6,2,8,75.0%,3h
11898,3,[GrnBrd]Notausername,3190,168,6,6,12,50.0%,10m
11898,3,Yellow,3190,94,5,1,6,83.3%,11m
11898,3,Frost,3190,0,4,1,5,80.0%,1h
11898,3,[LIBRTD]Simba,3190,86,4,2,6,66.7%,6m
11898,3,MNVikings,3190,86,4,2,6,66.7%,9m
11898,3,Gaskal,3190,148,4,3,7,57.1%,5m
11898,2,[69420]TitsMcgee,3190,117,3,1,4,75.0%,26m
11898,3,Space,3190,0,3,4,7,42.9%,39m
11898,3,SONIC,3190,30,2,0,2,100.0%,42m
11898,3,eibl,3190,60,2,5,7,28.6%,26m
11898,3,PandaExpress,3190,30,1,1,2,50.0%,6m
11898,3,[868]Ardin,3190,0,0,1,1,0.0%,7m
11898,3,[LTTB]eMpTy,3190,0,0,2,2,0.0%,27m
11920,3,MastaYoshi,3189,657,38,40,78,48.7%,36m
11920,3,JehuOni,3189,778,34,27,61,55.7%,18m
11920,3,MojoJoGio,3189,819,30,32,62,48.4%,15m
11920,3,GoFast,3189,482,24,11,35,68.6%,26m
11920,3,GrumpyMonk,3189,435,19,17,36,52.8%,39m
11920,3,Getafix,3189,455,17,14,31,54.8%,32m
11920,3,VespinKahn,3189,222,13,2,15,86.7%,12m
11920,3,Macaxeira,3189,288,11,12,23,47.8%,9m
11920,3,Ziekr,3189,142,6,5,11,54.5%,32m
11920,3,[dreamG]Ryun,3189,86,4,4,8,50.0%,43m
11920,2,Pastaparty,3189,95,2,1,3,66.7%,44m
11920,3,Walruslisk,3189,0,1,0,1,100.0%,16m
11920,3,[Emb3rs]Neeblet,3189,30,1,1,2,50.0%,7m
11920,3,Balvinn,3189,30,1,7,8,12.5%,32m
11920,3,TrippelM,3189,0,0,1,1,0.0%,10m
11920,2,[WNTRCO]Beastly,3189,0,0,1,1,0.0%,19m
11920,3,[LAW]RedwoodLynx,3189,0,0,1,1,0.0%,16m
11920,3,Matt,3189,0,0,1,1,0.0%,12m
11920,3,Nemrood,3189,0,0,2,2,0.0%,12m
11939,2,GGFoU,3188,1457,71,72,143,49.7%,25m
11939,3,[RustLg]sctwosuxcoc,3188,1387,56,46,102,54.9%,37m
11939,3,EXIA,3188,505,45,40,85,52.9%,37m
11939,3,BenJa,3188,710,42,36,78,53.8%,4m
11939,3,IIIIIIIIIIII,3188,486,22,23,45,48.9%,11m
11939,3,theredone,3188,450,15,28,43,34.9%,35m
11939,3,giveusamask,3188,302,14,5,19,73.7%,27m
11939,3,Mocorongo,3188,402,14,17,31,45.2%,26m
11939,3,[PeelMe]iBuildTanks,3188,278,10,15,25,40.0%,31m
11939,3,VIP,3188,277,9,6,15,60.0%,12m
11939,3,[stbr0s]agenttan,3188,230,9,9,18,50.0%,18m
11939,3,[FSAF]Joseph,3188,166,7,7,14,50.0%,6m
11939,1,PrinterGoBrr,3188,97,5,3,8,62.5%,23m
11939,3,NitroDubs,3188,126,4,0,4,100.0%,10m
11939,3,[Mgoose]PuroFeeling,3188,0,4,1,5,80.0%,14m
11939,3,GookusKhan,3188,92,3,5,8,37.5%,15m
11939,3,cindysue,3188,86,3,7,10,30.0%,12m
11939,3,Banterran,3188,90,3,9,12,25.0%,41m
11939,3,Mononoke,3188,30,2,0,2,100.0%,9m
11939,3,Modra,3188,94,2,4,6,33.3%,25m
11939,3,Frank,3188,0,1,1,2,50.0%,25m
11939,1,[JUIN]leek,3188,0,0,1,1,0.0%,2h
11961,3,IMSORRYLOLGG,3187,1616,213,196,409,52.1%,7m
11961,3,Spacca,3187,1466,134,127,261,51.3%,10m
11961,3,[GOPERÚ]Marinechan,3187,1401,102,88,190,53.7%,11m
11961,3,Kevin,3187,1344,61,63,124,49.2%,30m
11961,3,Boze,3187,792,53,37,90,58.9%,25m
11961,3,TwlvGgShogun,3187,440,44,39,83,53.0%,32m
11961,3,zZRockeRosZz,3187,985,40,31,71,56.3%,34m
11961,3,[Krim]heavysetname,3187,823,33,30,63,52.4%,6m
11961,3,Faker,3187,322,21,16,37,56.8%,4m
11961,3,oranGe,3187,300,11,11,22,50.0%,5m
11961,3,Chaos,3187,214,9,3,12,75.0%,22m
11961,3,AkiraSai,3187,58,7,2,9,77.8%,13m
11961,3,[SenraC]Mag,3187,174,6,11,17,35.3%,12m
11961,3,[6D37]AKONG,3187,0,4,1,5,80.0%,33m
11961,3,BrugerHein,3187,0,4,1,5,80.0%,1h
11961,3,[4IUR]Araragi,3187,41,3,2,5,60.0%,16m
11961,3,Bean,3187,30,2,6,8,25.0%,24m
11961,3,[GGBGll]SColddriver,3187,0,0,1,1,0.0%,16m
11961,3,[EpicG]LavienRose,3187,0,0,2,2,0.0%,30m
11980,3,icecreamsoft,3186,1578,220,216,436,50.5%,32m
11980,3,Torimen,3186,1515,155,131,286,54.2%,13m
11980,2,[CG]Adama,3186,1431,151,180,331,45.6%,22m
11980,3,commandant,3186,1398,107,82,189,56.6%,19m
11980,3,Oofsmoofs,3186,1447,98,85,183,53.6%,6m
11980,3,xGiceKiLler,3186,1545,90,85,175,51.4%,29m
11980,3,Zhivago,3186,1571,66,66,132,50.0%,28m
11980,3,Conotor,3186,647,30,22,52,57.7%,25m
11980,3,Aqme,3186,572,28,16,44,63.6%,8m
11980,3,GrumpyPants,3186,571,24,19,43,55.8%,33m
11980,3,Red,3186,250,22,14,36,61.1%,23m
11980,3,RedhairShank,3186,387,18,9,27,66.7%,31m
11980,3,[CG]racoongoon,3186,398,18,11,29,62.1%,42m
11980,3,DrinkVespene,3186,397,18,12,30,60.0%,30m
11980,3,suprnovaynwa,3186,236,16,10,26,61.5%,12m
11980,3,BDT,3186,317,15,7,22,68.2%,28m
11980,3,MBZ,3186,325,12,7,19,63.2%,22m
11980,3,ProbiusSC,3186,175,7,2,9,77.8%,41m
11980,3,JlLopaTpax,3186,94,4,2,6,66.7%,30m
11980,3,Brobz,3186,86,4,5,9,44.4%,15m
11980,3,asean,3186,60,3,4,7,42.9%,22m
11980,3,Deberst,3186,30,2,0,2,100.0%,7m
11980,3,nightraven,3186,0,1,0,1,100.0%,42m
11980,3,[SKyber]sirCRS,3186,30,1,2,3,33.3%,28m
11980,2,Thundrhammer,3186,91,1,2,3,33.3%,30m
11980,3,LiquidMaru,3186,0,0,1,1,0.0%,38m
11980,3,VoidRayOP,3186,0,0,1,1,0.0%,24m
11980,3,Durham,3186,0,0,1,1,0.0%,37m
11980,3,superman,3186,0,0,1,1,0.0%,38m
11980,3,Neechay,3186,0,0,1,1,0.0%,32m
11980,3,Kìzna,3186,0,0,1,1,0.0%,5m
11980,3,hyulch,3186,0,0,1,1,0.0%,31m
11980,3,[SsaYnS]Jdban,3186,0,0,2,2,0.0%,17m
11980,3,[BusBoi]JimmyBeans,3186,0,0,3,3,0.0%,21m
12014,2,DemiGaud,3185,1614,1237,1225,2462,50.2%,10m
12014,2,jejejean,3185,1497,186,195,381,48.8%,38m
12014,3,Creepus,3185,1175,95,78,173,54.9%,6m
12014,3,David,3185,510,24,10,34,70.6%,38m
12014,3,IllIIIIlIlIl,3185,600,21,25,46,45.7%,31m
12014,3,Emily,3185,239,10,4,14,71.4%,12m
12014,3,nDubs,3185,296,9,12,21,42.9%,27m
12014,3,TerryBogard,3185,270,9,13,22,40.9%,35m
12014,3,Volt,3185,185,8,5,13,61.5%,6m
12014,3,[BNKRZ]Jeffy,3185,233,8,5,13,61.5%,33m
12014,3,[4thLaw]AnUIntensity,3185,212,6,5,11,54.5%,3m
12014,3,llllllllllll,3185,93,4,2,6,66.7%,30m
12014,2,IIIIIIIIIIII,3185,0,4,2,6,66.7%,5m
12014,3,[TeamUR]Parka,3185,120,4,5,9,44.4%,23m
12014,3,Gidar,3185,30,2,1,3,66.7%,4m
12014,3,[xLgNx]DANTE,3185,58,2,2,4,50.0%,2m
12014,3,MSTY,3185,0,1,0,1,100.0%,19m
12014,3,Null,3185,0,1,1,2,50.0%,18m
12014,3,IIIIIIIIIIII,3185,30,1,8,9,11.1%,26m
12014,3,[FALURS]Marvel,3185,0,0,1,1,0.0%,36m
12014,3,[FMX]Petros,3185,0,0,1,1,0.0%,5m
12035,3,eSpeC,3184,1439,287,283,570,50.4%,41m
12035,3,Sphenny,3184,1261,107,89,196,54.6%,26m
12035,3,[UpxV]rach,3184,1529,105,85,190,55.3%,7m
12035,3,codebu,3184,809,77,66,143,53.8%,25m
12035,3,Sindred,3184,879,48,43,91,52.7%,24m
12035,3,[WiNgSS]CommanderJM,3184,1110,43,53,96,44.8%,41m
12035,3,Boro,3184,761,34,22,56,60.7%,11m
12035,3,NEO,3184,842,34,32,66,51.5%,12m
12035,3,Hawtshawt,3184,634,27,15,42,64.3%,8m
12035,3,Clonemaster,3184,697,26,22,48,54.2%,27m
12035,3,[GSP0T]MacroMancer,3184,537,25,18,43,58.1%,26m
12035,3,Makaidos,3184,362,14,14,28,50.0%,35m
12035,3,Beffy,3184,243,12,7,19,63.2%,19m
12035,3,[TGosuC]Lucid,3184,264,9,16,25,36.0%,13m
12035,3,BakedGoods,3184,206,7,8,15,46.7%,13m
12035,3,Phosphoid,3184,97,5,4,9,55.6%,23m
12035,3,Solstice,3184,0,4,1,5,80.0%,12m
12035,3,Alakazam,3184,60,3,2,5,60.0%,6m
12035,3,Marcus,3184,0,1,0,1,100.0%,26m
12035,3,rsvp,3184,0,1,0,1,100.0%,12m
12035,3,mirreyMX,3184,0,1,0,1,100.0%,26m
12035,1,AyaseXKirino,3184,96,1,6,7,14.3%,32m
12035,3,[YAS]Knowledge,3184,0,0,1,1,0.0%,8m
12035,3,Pencil,3184,0,0,1,1,0.0%,7m
12035,3,MrOblivious,3184,0,0,1,1,0.0%,26m
12060,3,Kaevek,3183,1618,183,161,344,53.2%,9m
12060,3,peenutnoodle,3183,755,60,31,91,65.9%,13m
12060,3,xtremeplayer,3183,509,23,10,33,69.7%,24m
12060,3,AgentSmith,3183,595,23,24,47,48.9%,32m
12060,3,zabac,3183,180,10,12,22,45.5%,38m
12060,1,[ToxicP]XYDHZ,3183,190,8,4,12,66.7%,1h
12060,1,llllllllllll,3183,180,6,0,6,100.0%,2h
12060,2,[noob69]Honnse,3183,139,6,3,9,66.7%,15m
12060,3,skilled,3183,30,5,2,7,71.4%,27m
12060,2,onealio,3183,0,4,2,6,66.7%,1h
12060,3,StonedMarine,3183,90,3,5,8,37.5%,41m
12060,3,tQCheerMe,3183,95,2,0,2,100.0%,22m
12060,3,[buyBTC]eightyWon,3183,22,2,1,3,66.7%,37m
12060,3,[ROKEA]ToonArmy,3183,58,2,3,5,40.0%,33m
12060,3,lumps,3183,0,1,0,1,100.0%,20m
12060,3,Kolya,3183,0,1,0,1,100.0%,18m
12060,3,Chace,3183,0,1,0,1,100.0%,39m
12060,3,cHaoTic,3183,0,0,5,5,0.0%,1h
12078,3,TheKnightOwl,3182,1430,173,168,341,50.7%,41m
12078,2,XFilez,3182,1529,84,91,175,48.0%,26m
12078,3,Forlornhero,3182,437,31,26,57,54.4%,39m
12078,3,BLARG,3182,497,18,18,36,50.0%,25m
12078,3,PSyCongroo,3182,221,10,4,14,71.4%,41m
12078,3,[Hilas2]manoyyy,3182,256,9,4,13,69.2%,31m
12078,3,[mseb]AdzMaLite,3182,187,8,5,13,61.5%,29m
12078,3,Nightmare,3182,132,6,3,9,66.7%,30m
12078,3,TuZi,3182,0,4,1,5,80.0%,35m
12078,3,DaS,3182,95,2,0,2,100.0%,21m
12078,3,llllllllllll,3182,97,2,1,3,66.7%,2m
12078,3,GSLegacy,3182,121,2,2,4,50.0%,2m
12078,1,[MeXx]SpeedyG,3182,0,2,4,6,33.3%,1h
12078,3,Julio,3182,0,1,1,2,50.0%,10m
12078,3,Andychrist,3182,30,1,2,3,33.3%,36m
12078,3,Anya,3182,0,1,2,3,33.3%,36m
12078,3,[WRuniv]STRENTWILL,3182,30,1,3,4,25.0%,12m
12078,3,RANDOM,3182,0,0,1,1,0.0%,17m
12078,2,Freaking,3182,0,0,2,2,0.0%,22m
12097,3,llllllllllll,3181,1558,291,281,572,50.9%,24m
12097,3,[FateTw]Soapyjeans,3181,1061,43,42,85,50.6%,32m
12097,3,criSpyBacon,3181,548,23,18,41,56.1%,25m
12097,3,[FEARZ]Yes,3181,271,10,6,16,62.5%,5m
12097,3,[SBlock]Omar,3181,138,8,8,16,50.0%,7m
12097,3,ZaptaX,3181,137,7,3,10,70.0%,14m
12097,3,[MvL]Steiner,3181,234,7,5,12,58.3%,8m
12097,3,[S2sex]ILOVESEX,3181,174,6,9,15,40.0%,20m
12097,3,[m8z]ladygaga,3181,146,6,13,19,31.6%,36m
12097,3,fatal,3181,88,3,4,7,42.9%,30m
12097,3,DebugCode,3181,0,2,3,5,40.0%,43m
12097,3,[bOvOd]VIOLstar,3181,30,2,8,10,20.0%,33m
12097,2,[AdvTme]MagicMan,3181,90,1,1,2,50.0%,4m
12097,3,[LOCO]Teim,3181,0,1,2,3,33.3%,22m
12097,1,GrimLock,3181,97,1,2,3,33.3%,11m
12097,3,[NLTN]Innerself,3181,30,1,2,3,33.3%,16m
12097,3,[IYI]YYYYYYYY,3181,30,1,3,4,25.0%,31m
12097,3,[SoaP42]Pie,3181,0,0,1,1,0.0%,36m
12097,3,[Hilas2]RJVP,3181,0,0,1,1,0.0%,31m
12097,3,Champs,3181,0,0,5,5,0.0%,20m
12117,3,ContraBaby,3180,826,81,70,151,53.6%,15m
12117,3,SoYBaconator,3180,1543,78,69,147,53.1%,29m
12117,3,woodivison,3180,1068,51,47,98,52.0%,30m
12117,3,[BfLaD]Bazar,3180,656,36,37,73,49.3%,43m
12117,3,[STG]ElTrujas,3180,771,29,35,64,45.3%,43m
12117,3,FastGo,3180,484,24,10,34,70.6%,14m
12117,3,Vas,3180,658,24,21,45,53.3%,19m
12117,3,[Shout]DWolves,3180,266,20,27,47,42.6%,36m
12117,3,AnubiS,3180,362,19,6,25,76.0%,17m
12117,3,StupidPig,3180,329,14,5,19,73.7%,3m
12117,3,[EZDUNK]Mindgames,3180,206,11,7,18,61.1%,7m
12117,3,Dancore,3180,162,9,9,18,50.0%,31m
12117,3,SerralJR,3180,174,6,12,18,33.3%,11m
12117,2,Maxum,3180,117,5,2,7,71.4%,43m
12117,3,Rarescanner,3180,58,3,1,4,75.0%,9m
12117,3,Maomao,3180,139,3,2,5,60.0%,6m
12117,3,MarineKawaii,3180,44,3,3,6,50.0%,2h
12117,3,Topgun,3180,115,2,1,3,66.7%,15m
12117,3,Hikikomori,3180,115,2,2,4,50.0%,27m
12117,3,[GOPERÚ]RampagePks,3180,62,2,7,9,22.2%,3m
12117,3,RxDealer,3180,0,1,0,1,100.0%,18m
12117,3,LiuKi,3180,0,0,1,1,0.0%,32m
12139,3,FullTLight,3179,1430,130,113,243,53.5%,2m
12139,3,[iDeX]ForaBolsonar,3179,1274,62,65,127,48.8%,37m
12139,3,Papabear,3179,573,57,63,120,47.5%,38m
12139,3,Egg,3179,920,43,29,72,59.7%,42m
12139,3,elevenS,3179,384,32,33,65,49.2%,20m
12139,3,MasterSquid,3179,591,26,19,45,57.8%,5m
12139,3,NavySil,3179,492,25,24,49,51.0%,6m
12139,3,[DhZPro]FuSioN,3179,466,18,19,37,48.6%,31m
12139,3,[TheRs]DrunkenRadio,3179,304,18,22,40,45.0%,28m
12139,3,CSEddieEdit,3179,426,17,10,27,63.0%,30m
12139,3,[iDrunk]Zach,3179,245,11,18,29,37.9%,39m
12139,3,Stinkfist,3179,132,9,7,16,56.2%,4m
12139,3,Ziemson,3179,169,8,6,14,57.1%,26m
12139,3,Peen,3179,206,8,7,15,53.3%,17m
12139,1,Kankedort,3179,257,7,7,14,50.0%,25m
12139,3,TheGreatIshk,3179,97,6,0,6,100.0%,16m
12139,1,phi,3179,162,4,2,6,66.7%,3m
12139,3,Pirate,3179,60,3,3,6,50.0%,4m
12139,3,Siouxsie,3179,106,3,3,6,50.0%,14m
12139,3,[DarkLS]MyedMArtineZ,3179,86,3,4,7,42.9%,26m
12139,3,RedSpartan,3179,62,3,7,10,30.0%,8m
12139,3,LngsTasteBad,3179,92,3,9,12,25.0%,6m
12139,3,SingleMalt,3179,30,1,2,3,33.3%,12m
12139,3,quanto,3179,0,0,1,1,0.0%,37m
12139,3,TheDarkLord,3179,0,0,2,2,0.0%,40m
12164,3,kady,3178,1601,282,271,553,51.0%,37m
12164,3,Phoenix,3178,1025,141,121,262,53.8%,38m
12164,3,[AbcCo]FleshMan,3178,1547,133,121,254,52.4%,24m
12164,3,[TlLT]Otis,3178,870,76,60,136,55.9%,20m
12164,3,CapnMaphacks,3178,858,57,54,111,51.4%,12m
12164,3,[Sune]Cabutt,3178,910,36,44,80,45.0%,6m
12164,3,Ghost,3178,624,24,28,52,46.2%,42m
12164,3,Jereel,3178,384,16,7,23,69.6%,20m
12164,3,Dragracing,3178,217,14,2,16,87.5%,29m
12164,3,[OvnMen]WeebWacker,3178,402,14,19,33,42.4%,6m
12164,3,EndFrost,3178,309,11,7,18,61.1%,18m
12164,3,Caseysgay,3178,120,8,5,13,61.5%,17m
12164,3,Martin,3178,152,5,12,17,29.4%,4m
12164,2,[HolyTE]CloudIII,3178,158,5,13,18,27.8%,4m
12164,3,ArgonKing,3178,156,5,14,19,26.3%,29m
12164,3,[SC2IDN]FireKing,3178,116,4,4,8,50.0%,42m
12164,3,Weedamins,3178,143,3,3,6,50.0%,33m
12164,3,[Italis]CrimsonHalo,3178,0,0,2,2,0.0%,12m
12164,3,[500CC]Guitha,3178,0,0,3,3,0.0%,6m
12183,2,Loki,3177,1227,147,150,297,49.5%,10m
12183,3,Alterach,3177,1562,105,103,208,50.5%,17m
12183,3,innnnovation,3177,763,101,104,205,49.3%,16m
12183,3,[CSB]coolstorybro,3177,842,93,74,167,55.7%,7m
12183,3,SteinwayKing,3177,1278,78,60,138,56.5%,15m
12183,3,Arael,3177,1330,59,57,116,50.9%,3m
12183,3,[JaMiT]Teejhan,3177,922,44,37,81,54.3%,25m
12183,3,Xylen,3177,991,38,40,78,48.7%,19m
12183,3,Striker,3177,896,32,38,70,45.7%,41m
12183,3,angrypirate,3177,645,27,21,48,56.2%,26m
12183,3,Maestro,3177,463,19,17,36,52.8%,8m
12183,3,[ISTOP]SOlaReX,3177,423,15,13,28,53.6%,22m
12183,3,Slagsdale,3177,343,11,11,22,50.0%,27m
12183,2,JasperNoone,3177,137,5,3,8,62.5%,41m
12183,3,HiImPiglet,3177,0,4,1,5,80.0%,24m
12183,3,Gom,3177,141,4,2,6,66.7%,41m
12183,3,[LQV]NoobT,3177,146,3,3,6,50.0%,25m
12183,1,CronJ,3177,96,2,1,3,66.7%,53m
12183,2,[iNcL]toaae,3177,0,2,4,6,33.3%,1h
12183,3,[Astute]MarcDaGreat,3177,0,0,1,1,0.0%,37m
12183,3,Professor,3177,0,0,2,2,0.0%,16m
12204,3,Sortarius,3176,1533,146,147,293,49.8%,7m
12204,3,[EvilGC]Groncalonca,3176,1578,123,120,243,50.6%,35m
12204,3,[UpxV]HachaBlanca,3176,1424,100,80,180,55.6%,8m
12204,3,Quenza,3176,1071,94,79,173,54.3%,12m
12204,3,Mer,3176,1067,78,82,160,48.8%,33m
12204,3,DeathKat,3176,578,72,53,125,57.6%,6m
12204,3,VstaFan,3176,926,47,25,72,65.3%,39m
12204,3,Tettarus,3176,814,37,20,57,64.9%,25m
12204,3,TheOne,3176,504,21,8,29,72.4%,2m
12204,3,Brambleshire,3176,333,13,6,19,68.4%,42m
12204,3,[MLG69]Peperino,3176,323,12,7,19,63.2%,39m
12204,3,[Fir3s]HomeTownCrib,3176,318,12,10,22,54.5%,28m
12204,3,[2AND80]galloots,3176,283,11,6,17,64.7%,3m
12204,3,Sese,3176,229,9,8,17,52.9%,28m
12204,1,Sooty,3176,115,7,2,9,77.8%,2h
12204,3,OVO,3176,199,6,2,8,75.0%,30m
12204,3,Nothing,3176,120,5,4,9,55.6%,8m
12204,3,[Macac0]Oturanx,3176,141,5,9,14,35.7%,35m
12204,3,[TGosuA]bunK,3176,114,3,0,3,100.0%,21m
12204,2,Fiyero,3176,0,1,1,2,50.0%,27m
12204,3,Maz,3176,94,1,1,2,50.0%,41m
12225,3,Jokin,3175,1591,499,489,988,50.5%,35m
12225,3,KOUZIimbaOP,3175,1500,321,271,592,54.2%,5m
12225,3,BufTerranThx,3175,617,211,211,422,50.0%,20m
12225,2,SilverDollar,3175,892,168,175,343,49.0%,10m
12225,3,life,3175,1543,145,117,262,55.3%,23m
12225,3,[Hemm]yesmeow,3175,1264,66,49,115,57.4%,35m
12225,3,Lumin,3175,780,35,43,78,44.9%,32m
12225,3,Noobforreal,3175,526,32,12,44,72.7%,37m
12225,3,[EZDUNK]Exusiai,3175,666,25,26,51,49.0%,42m
12225,3,OneUp,3175,498,21,14,35,60.0%,6m
12225,3,[NeAs]RiverS,3175,530,21,20,41,51.2%,30m
12225,3,Zero,3175,473,20,15,35,57.1%,2m
12225,3,ToniElGordo,3175,450,19,13,32,59.4%,17m
12225,3,BonesBrook,3175,244,16,18,34,47.1%,4m
12225,3,MedivhWu,3175,429,15,14,29,51.7%,8m
12225,3,aled,3175,105,8,3,11,72.7%,28m
12225,3,NATerranPleb,3175,176,7,8,15,46.7%,41m
12225,3,IttoShura,3175,182,6,11,17,35.3%,10m
12225,3,Scruffy,3175,122,5,8,13,38.5%,28m
12225,3,PfCla,3175,0,4,2,6,66.7%,11m
12225,3,Valynah,3175,122,4,7,11,36.4%,40m
12225,3,nizoral,3175,90,4,8,12,33.3%,41m
12225,3,Rexraynor,3175,58,2,6,8,25.0%,30m
12225,3,[Dim]ClockworK,3175,60,2,10,12,16.7%,18m
12225,3,EricSon,3175,0,1,0,1,100.0%,34m
12225,3,[HBNC]hbdisfoo,3175,30,1,4,5,20.0%,41m
12225,3,LetsBeJaimz,3175,30,1,9,10,10.0%,32m
12225,3,[lNI]KungFuSanta,3175,0,1,12,13,7.7%,22m
12225,2,[TSØP]mOntag,3175,0,0,1,1,0.0%,49m
12225,3,Goliath,3175,0,0,7,7,0.0%,27m
12255,3,IIIIIIIIIIII,3174,1538,234,234,468,50.0%,12m
12255,3,leto,3174,1404,106,113,219,48.4%,15m
12255,3,noobish,3174,1118,80,70,150,53.3%,17m
12255,3,MercyPlease,3174,1534,79,65,144,54.9%,6m
12255,3,[cSec]SuperMutant,3174,1242,66,61,127,52.0%,38m
12255,3,[xSYNx]Impaler,3174,1428,64,66,130,49.2%,4m
12255,3,[TPGGXD]LinKras,3174,903,40,38,78,51.3%,41m
12255,3,MadNoob,3174,688,35,17,52,67.3%,5m
12255,3,Microondas,3174,756,32,22,54,59.3%,26m
12255,3,Ivellios,3174,259,26,33,59,44.1%,36m
12255,3,Casey,3174,413,20,27,47,42.6%,25m
12255,3,Barcode,3174,413,16,13,29,55.2%,37m
12255,3,OwlSlake,3174,315,15,16,31,48.4%,16m
12255,2,Ares,3174,321,14,10,24,58.3%,13m
12255,3,Shingles,3174,273,13,5,18,72.2%,22m
12255,3,BluShifT,3174,178,12,5,17,70.6%,20m
12255,3,[YLG]NuTz,3174,246,10,4,14,71.4%,9m
12255,1,[SDTL]Ian,3174,268,10,12,22,45.5%,28m
12255,3,[meobol]moriarty,3174,212,9,6,15,60.0%,29m
12255,3,Quarantino,3174,292,9,9,18,50.0%,28m
12255,3,Rumtumtum,3174,88,7,4,11,63.6%,8m
12255,3,TopeX,3174,198,7,9,16,43.8%,14m
12255,3,MrTingly,3174,118,5,7,12,41.7%,28m
12255,3,SilentOne,3174,124,4,8,12,33.3%,19m
12255,3,llllllllll,3174,120,4,9,13,30.8%,8m
12255,3,[B2]Regulator,3174,108,3,4,7,42.9%,26m
12255,3,TrueNorth,3174,30,2,1,3,66.7%,39m
12255,2,Trista,3174,113,2,2,4,50.0%,43m
12255,3,[DhZAc1]Celebrantion,3174,6,1,3,4,25.0%,7m
12255,3,[kolkid]Fuzzy,3174,0,1,4,5,20.0%,16m
12255,3,BrentheGreat,3174,0,0,1,1,0.0%,2h
12255,3,Amadeous,3174,0,0,1,1,0.0%,6m
12287,3,Zodiac,3173,1510,148,151,299,49.5%,36m
12287,3,[YGD]Sephiroth,3173,1573,130,134,264,49.2%,41m
12287,3,[RathFr]Nick,3173,1341,99,86,185,53.5%,6m
12287,3,Nemesis,3173,1282,82,94,176,46.6%,12m
12287,3,DoYou,3173,934,43,32,75,57.3%,25m
12287,3,NutDealeR,3173,581,39,28,67,58.2%,24m
12287,3,SisNab,3173,710,32,25,57,56.1%,21m
12287,3,iMPRo,3173,748,31,28,59,52.5%,12m
12287,3,[xRtGac]RuneX,3173,699,30,34,64,46.9%,12m
12287,3,LeapFrog,3173,536,19,17,36,52.8%,43m
12287,1,OhMyDayum,3173,346,16,12,28,57.1%,29m
12287,3,wonky,3173,353,13,10,23,56.5%,13m
12287,3,[TGosuB]Aroux,3173,310,10,8,18,55.6%,36m
12287,3,Bjebis,3173,202,7,4,11,63.6%,19m
12287,3,HeroMarauder,3173,204,7,12,19,36.8%,38m
12287,1,KoomBoom,3173,139,5,0,5,100.0%,47m
12287,3,TYFAN,3173,120,5,6,11,45.5%,39m
12287,3,ayeyo,3173,0,4,2,6,66.7%,31m
12287,1,SlaitlyTipsy,3173,139,4,4,8,50.0%,38m
12287,3,[TheDOH]Nekro,3173,119,2,2,4,50.0%,39m
12287,3,SunWillRise,3173,0,1,0,1,100.0%,3h
12287,3,[qt]Mugen,3173,0,1,1,2,50.0%,34m
12287,3,Shadowstorm,3173,94,1,1,2,50.0%,11m
12287,3,[xTQc]Maz,3173,95,1,1,2,50.0%,40m
12287,3,przGOD,3173,92,1,1,2,50.0%,31m
12287,3,NormCharlton,3173,0,0,1,1,0.0%,41m
12287,3,[S0mBr4]MzT,3173,0,0,1,1,0.0%,42m
12287,3,Arisaí,3173,0,0,1,1,0.0%,12m
12287,3,Noodle,3173,0,0,1,1,0.0%,18m
12316,2,[DarkPG]Kondor,3172,1503,236,237,473,49.9%,32m
12316,3,ChuttMcBugg,3172,1538,125,104,229,54.6%,33m
12316,3,Soggyfeather,3172,1514,91,71,162,56.2%,26m
12316,3,[SABO]Adam,3172,602,76,51,127,59.8%,29m
12316,3,[PobSC]ChicoCuagulo,3172,1118,69,60,129,53.5%,34m
12316,3,aBsolutiO,3172,477,64,50,114,56.1%,6m
12316,3,derp,3172,1189,45,41,86,52.3%,18m
12316,3,dreamx,3172,509,38,30,68,55.9%,15m
12316,3,thefatninja,3172,624,31,17,48,64.6%,38m
12316,3,DirtyDan,3172,428,30,20,50,60.0%,40m
12316,3,[BRUTH]TanithsFirst,3172,377,25,17,42,59.5%,27m
12316,3,Bob,3172,677,25,32,57,43.9%,12m
12316,3,Prabhdas,3172,495,21,24,45,46.7%,35m
12316,3,[FxB]dere,3172,428,19,9,28,67.9%,39m
12316,3,LightPenguin,3172,428,19,10,29,65.5%,40m
12316,3,KingBonobo,3172,472,18,14,32,56.2%,31m
12316,3,Freesia,3172,249,12,7,19,63.2%,35m
12316,3,Innovator,3172,167,11,2,13,84.6%,27m
12316,3,Wantoch,3172,328,11,17,28,39.3%,30m
12316,3,Barcode,3172,257,10,5,15,66.7%,7m
12316,3,Skiiman,3172,88,7,5,12,58.3%,33m
12316,1,Landro,3172,215,7,5,12,58.3%,1h
12316,3,LeoMinelli,3172,214,7,6,13,53.8%,12m
12316,3,JSheppard,3172,0,4,1,5,80.0%,3h
12316,2,UHUstic,3172,122,3,0,3,100.0%,7m
12316,3,sSPAZz,3172,115,3,1,4,75.0%,33m
12316,3,Jimmi,3172,0,3,2,5,60.0%,10m
12316,3,[BallX]SoloSavior,3172,30,2,2,4,50.0%,7m
12316,2,noobplayer,3172,0,1,0,1,100.0%,43m
12316,3,Adfiaz,3172,94,1,1,2,50.0%,28m
12316,3,lllIIIIllll,3172,0,1,4,5,20.0%,43m
12316,3,Matrix,3172,0,0,2,2,0.0%,25m
12316,3,ghydsg,3172,0,0,2,2,0.0%,21m
12349,3,GILL,3171,1483,426,409,835,51.0%,3m
12349,3,NombreBacán,3171,1577,306,270,576,53.1%,22m
12349,3,[NeAs]Rattini,3171,1435,139,119,258,53.9%,14m
12349,3,[GOPERÚ]DehakA,3171,1014,46,29,75,61.3%,9m
12349,3,[SC2IDN]Jangbingo,3171,516,26,10,36,72.2%,5m
12349,3,DaEliminator,3171,462,24,26,50,48.0%,41m
12349,3,[NLTN]Tarkor,3171,482,21,15,36,58.3%,34m
12349,2,Wingman,3171,218,13,11,24,54.2%,4m
12349,3,DrCharles,3171,220,7,4,11,63.6%,20m
12349,3,[CptMal]Tango,3171,170,7,8,15,46.7%,7m
12349,3,bLiNd,3171,180,6,1,7,85.7%,18m
12349,3,[UCF]SbaerO,3171,198,6,20,26,23.1%,13m
12349,3,MaxSteel,3171,0,4,1,5,80.0%,35m
12349,3,Bukovietski,3171,169,4,4,8,50.0%,5m
12349,3,IEatCrayons,3171,117,3,1,4,75.0%,37m
12349,3,Luishas,3171,0,1,0,1,100.0%,24m
12349,3,Ramblingfool,3171,94,1,1,2,50.0%,23m
12349,3,[9OH5]THugs,3171,0,0,1,1,0.0%,29m
12367,3,Kibbler,3170,1543,434,406,840,51.7%,10m
12367,3,Anatolio,3170,1509,89,79,168,53.0%,18m
12367,3,[BdGirl]ToiletPaper,3170,1488,89,94,183,48.6%,20m
12367,3,Ikswoot,3170,832,59,59,118,50.0%,7m
12367,3,MegaMariner,3170,259,55,15,70,78.6%,31m
12367,3,Waitforit,3170,1160,54,49,103,52.4%,17m
12367,3,[Moo0]Smuckers,3170,537,48,34,82,58.5%,4m
12367,3,[AMDATI]Ryzen,3170,830,45,37,82,54.9%,20m
12367,3,[FkHost]Altectech,3170,481,44,29,73,60.3%,19m
12367,2,JDMorgan,3170,800,32,35,67,47.8%,36m
12367,3,NoRelax,3170,513,20,13,33,60.6%,5m
12367,3,[cl0udM]Guito,3170,502,18,23,41,43.9%,14m
12367,3,[DETER]Kasuno,3170,253,15,19,34,44.1%,27m
12367,3,ImSupremee,3170,368,13,10,23,56.5%,42m
12367,3,[aL1998]SuNie,3170,372,13,17,30,43.3%,12m
12367,3,NAkiller,3170,362,13,19,32,40.6%,43m
12367,3,MustardTigeR,3170,323,12,8,20,60.0%,13m
12367,3,[ZTemps]ZeN,3170,250,10,4,14,71.4%,31m
12367,3,IIIIIIIIIIII,3170,122,9,5,14,64.3%,12m
12367,3,Clarking,3170,234,8,5,13,61.5%,12m
12367,1,Sigma,3170,120,6,7,13,46.2%,11m
12367,3,SpartanGhost,3170,150,6,12,18,33.3%,41m
12367,3,Blackbird,3170,146,5,8,13,38.5%,9m
12367,3,Jinx,3170,62,3,5,8,37.5%,22m
12367,3,[BalLzz]Gooby,3170,90,3,8,11,27.3%,21m
12367,3,[SLan]BlueSteel,3170,0,1,0,1,100.0%,32m
12367,3,TheWorst,3170,0,1,4,5,20.0%,1h
12367,3,avega,3170,0,0,1,1,0.0%,11m
12367,3,Santiafaker,3170,0,0,3,3,0.0%,18m
12367,3,[IIIllI]lIlIlIlIlIlI,3170,0,0,6,6,0.0%,10m
12397,3,MadNoob,3169,1271,143,137,280,51.1%,27m
12397,3,[xCTMx]KaiSer,3169,1593,93,98,191,48.7%,27m
12397,3,momasbiscuit,3169,1405,70,75,145,48.3%,26m
12397,3,eXorcist,3169,721,63,61,124,50.8%,12m
12397,3,Xende,3169,572,58,52,110,52.7%,42m
12397,3,Jack,3169,307,46,44,90,51.1%,36m
12397,3,[INextI]IMomotaro,3169,277,45,45,90,50.0%,14m
12397,3,JSora,3169,942,40,33,73,54.8%,26m
12397,3,Darkanus,3169,658,28,22,50,56.0%,15m
12397,3,[MALCMX]OprahWinfrey,3169,94,10,7,17,58.8%,6m
12397,3,Ronin,3169,254,9,12,21,42.9%,34m
12397,3,Zen,3169,250,8,6,14,57.1%,7m
12397,3,[UWCSC]Zvory,3169,172,7,7,14,50.0%,3m
12397,3,Jyten,3169,129,6,3,9,66.7%,25m
12397,3,[Miasma]ToeKnee,3169,218,6,6,12,50.0%,29m
12397,3,kurby,3169,110,6,8,14,42.9%,36m
12397,3,[DarkLS]elbryans,3169,93,4,0,4,100.0%,36m
12397,1,singularity,3169,134,4,1,5,80.0%,17m
12397,3,[WAHAHA]OceanMan,3169,0,3,1,4,75.0%,39m
12397,3,[SANGRE]Bartleby,3169,88,3,6,9,33.3%,41m
12397,3,[Thanat]woderif,3169,30,2,1,3,66.7%,31m
12397,3,[ITCx]Impact,3169,0,0,1,1,0.0%,22m
12397,3,Driscoll,3169,0,0,3,3,0.0%,43m
12397,3,[HDZB]ccrich,3169,0,0,3,3,0.0%,21m
12421,2,whosonfirst,3168,1528,660,665,1325,49.8%,42m
12421,3,Marc,3168,1500,305,300,605,50.4%,35m
12421,3,Balo,3168,1613,224,217,441,50.8%,12m
12421,3,Risperidona,3168,1417,197,177,374,52.7%,28m
12421,3,hughy,3168,1300,169,157,326,51.8%,23m
12421,2,kushinhaler,3168,508,103,105,208,49.5%,40m
12421,3,Josu,3168,1177,75,62,137,54.7%,10m
12421,3,Ezra,3168,707,72,21,93,77.4%,8m
12421,3,wired,3168,1555,67,57,124,54.0%,3m
12421,3,[0rdr66]Trollossus,3168,645,56,58,114,49.1%,25m
12421,3,plateau,3168,421,44,16,60,73.3%,39m
12421,3,[FMX]PROProtocolo,3168,717,28,24,52,53.8%,9m
12421,3,Zoltan,3168,486,23,12,35,65.7%,15m
12421,3,[5Tango]likeaboss,3168,348,13,14,27,48.1%,3m
12421,3,[TheB4d]LazyMetroid,3168,289,10,8,18,55.6%,5m
12421,1,Zahard,3168,189,8,4,12,66.7%,1h
12421,3,[NYOOM]Johann,3168,122,5,0,5,100.0%,43m
12421,3,[TeamUR]Chip,3168,158,5,1,6,83.3%,20m
12421,3,[ChoCo]PieDealer,3168,0,4,2,6,66.7%,13m
12421,3,[IroMan]Eicr,3168,163,4,3,7,57.1%,42m
12421,3,jacy,3168,88,4,4,8,50.0%,29m
12421,3,Jackhammer,3168,114,4,5,9,44.4%,22m
12421,1,CrustySA,3168,96,2,0,2,100.0%,23m
12421,3,Kiwiking,3168,89,1,2,3,33.3%,5m
12421,3,Glez,3168,30,1,11,12,8.3%,13m
12421,3,[DadsSC]WwWat,3168,0,0,1,1,0.0%,3m
12421,3,FlickFiebeR,3168,0,0,1,1,0.0%,21m
12421,3,[AniFTW]Terminator,3168,0,0,2,2,0.0%,43m
12421,3,MilOne,3168,0,0,3,3,0.0%,42m
12450,3,frankisfrunk,3167,1161,107,100,207,51.7%,6m
12450,3,anonymous,3167,1579,91,83,174,52.3%,5m
12450,3,Hos,3167,1012,71,52,123,57.7%,6m
12450,3,JAM,3167,1070,47,44,91,51.6%,31m
12450,3,[813ice]AntxTen,3167,278,11,5,16,68.8%,23m
12450,3,Cantataz,3167,180,10,6,16,62.5%,12m
12450,3,Pink,3167,242,9,16,25,36.0%,5m
12450,3,NapoSS,3167,181,8,5,13,61.5%,10m
12450,1,Gecks,3167,132,7,4,11,63.6%,3h
12450,3,teaz,3167,146,6,6,12,50.0%,41m
12450,3,[PN1S]floless,3167,135,4,0,4,100.0%,18m
12450,3,KillerOB,3167,135,3,1,4,75.0%,6m
12450,3,Chillaxing,3167,94,2,1,3,66.7%,7m
12450,3,[prim8s]SlayersAzen,3167,60,2,3,5,40.0%,14m
12450,3,hunter,3167,0,2,3,5,40.0%,43m
12450,3,JADDEN,3167,0,1,0,1,100.0%,26m
12450,3,FroMan,3167,93,1,1,2,50.0%,43m
12450,3,Neat,3167,30,1,3,4,25.0%,33m
12450,3,xelex,3167,0,0,1,1,0.0%,17m
12450,2,[qoou]Falco,3167,0,0,2,2,0.0%,22m
12470,3,Askavia,3166,1549,114,77,191,59.7%,11m
12470,3,JokerStatus,3166,371,42,29,71,59.2%,39m
12470,3,BringItOn,3166,727,30,19,49,61.2%,18m
12470,3,HappyKittens,3166,758,27,31,58,46.6%,40m
12470,3,[GOPERÚ]coronavirus,3166,671,26,23,49,53.1%,5m
12470,3,Benny,3166,505,23,12,35,65.7%,40m
12470,3,inHALEN,3166,173,19,16,35,54.3%,21m
12470,3,[GOPERÚ]bianlistico,3166,432,16,12,28,57.1%,40m
12470,3,[ExecUt]Alienshark,3166,125,14,8,22,63.6%,26m
12470,3,banana,3166,225,10,8,18,55.6%,42m
12470,3,WiseHero,3166,173,8,4,12,66.7%,18m
12470,3,Boogeyman,3166,203,7,2,9,77.8%,41m
12470,3,NeverMine,3166,201,7,5,12,58.3%,9m
12470,3,[NODANE]boofberry,3166,180,6,8,14,42.9%,9m
12470,3,Lovoh,3166,139,5,0,5,100.0%,37m
12470,3,Karizma,3166,88,3,6,9,33.3%,36m
12470,3,IIIlllIIIIll,3166,0,0,1,1,0.0%,10m
12487,3,KTrooper,3165,1370,183,141,324,56.5%,19m
12487,3,Pinguino,3165,1195,103,92,195,52.8%,17m
12487,3,Kitfox,3165,1165,101,107,208,48.6%,36m
12487,3,Bruce,3165,1394,94,76,170,55.3%,18m
12487,3,[Xpk]Asnario,3165,1161,79,84,163,48.5%,28m
12487,3,[RH]Dolomyte,3165,710,30,22,52,57.7%,38m
12487,3,Pokketz,3165,340,25,15,40,62.5%,11m
12487,3,[CodeA]Beatme,3165,461,24,5,29,82.8%,39m
12487,3,Celebrant,3165,589,23,18,41,56.1%,18m
12487,3,[CC19]Shature,3165,120,22,14,36,61.1%,16m
12487,3,[GOPERÚ]dantrax,3165,289,12,10,22,54.5%,14m
12487,1,[DUPA]SiZZerB,3165,274,11,6,17,64.7%,26m
12487,3,[SLAPD]AscenT,3165,244,8,4,12,66.7%,35m
12487,1,[Qu333r]zeX,3165,190,7,3,10,70.0%,1h
12487,3,Zerg,3165,97,6,0,6,100.0%,1h
12487,3,[Shang]Zam,3165,215,6,7,13,46.2%,11m
12487,3,[Calx]XanderTerry,3165,139,4,1,5,80.0%,35m
12487,3,Simplified,3165,0,2,3,5,40.0%,17m
12487,3,[PTHero]Aggy,3165,94,1,1,2,50.0%,25m
12487,3,SlayerToshi,3165,30,1,5,6,16.7%,40m
12487,3,[MTFKEZ]danyDark,3165,0,0,1,1,0.0%,20m
12487,3,FatePawn,3165,0,0,1,1,0.0%,13m
12487,3,WildCrane,3165,0,0,2,2,0.0%,19m
12487,3,Xylum,3165,0,0,3,3,0.0%,38m
12487,1,cHiNaHoP,3165,0,0,5,5,0.0%,8m
12512,3,Wolverine,3164,871,407,381,788,51.6%,6m
12512,3,RURU,3164,919,66,71,137,48.2%,32m
12512,3,[LDCO]anduin,3164,889,59,57,116,50.9%,7m
12512,3,HughMungus,3164,1041,43,35,78,55.1%,6m
12512,3,[xENTx]Simo,3164,199,42,22,64,65.6%,18m
12512,2,bobby,3164,1000,37,47,84,44.0%,26m
12512,3,CanCel,3164,520,21,14,35,60.0%,14m
12512,3,CowBoyYeh,3164,400,19,10,29,65.5%,6m
12512,3,DiceRoll,3164,331,14,6,20,70.0%,13m
12512,3,[Illapu]VIRACOCHA,3164,331,14,7,21,66.7%,17m
12512,1,Tystic,3164,207,6,2,8,75.0%,45m
12512,3,PlayAtDrink,3164,229,6,6,12,50.0%,4m
12512,3,[UDPC]DrCoktapuss,3164,180,6,13,19,31.6%,4m
12512,3,FaTeFailZ,3164,0,5,0,5,100.0%,9m
12512,3,Noctis,3164,0,5,0,5,100.0%,10m
12512,1,JayAlexis,3164,0,5,2,7,71.4%,43m
12512,3,ShaZaM,3164,88,4,3,7,57.1%,14m
12512,2,nani,3164,0,3,4,7,42.9%,19m
12512,3,blood,3164,120,2,2,4,50.0%,29m
12512,2,SuperJobab,3164,0,1,0,1,100.0%,19m
12512,3,Janim,3164,93,1,1,2,50.0%,31m
12512,3,TripleCow,3164,0,0,1,1,0.0%,3m
12512,3,SalientWevil,3164,0,0,1,1,0.0%,11m
12512,3,[LÞ]Matrix,3164,0,0,1,1,0.0%,28m
12536,3,Solden,3163,1523,219,213,432,50.7%,19m
12536,3,oldfishdk,3163,847,91,69,160,56.9%,12m
12536,3,kakjoin,3163,520,75,58,133,56.4%,4m
12536,3,ToxicShock,3163,511,74,61,135,54.8%,29m
12536,3,Unusual,3163,1479,73,62,135,54.1%,14m
12536,3,Jude,3163,845,58,27,85,68.2%,12m
12536,3,Nighthawk,3163,1001,44,34,78,56.4%,11m
12536,3,Cure,3163,781,37,26,63,58.7%,20m
12536,3,[BHJ]StillTK,3163,429,23,4,27,85.2%,11m
12536,3,Korsar,3163,260,20,14,34,58.8%,31m
12536,3,Trash,3163,330,17,2,19,89.5%,35m
12536,3,black,3163,304,14,16,30,46.7%,18m
12536,3,BIDENBOI,3163,257,11,14,25,44.0%,3m
12536,2,StepCV,3163,186,9,1,10,90.0%,60m
12536,3,[GCells]PsYoNiK,3163,236,8,8,16,50.0%,42m
12536,3,PoLard,3163,156,7,3,10,70.0%,13m
12536,3,[11001]Amoveattack,3163,209,6,4,10,60.0%,25m
12536,3,JMarcelo,3163,162,6,12,18,33.3%,5m
12536,2,RonzeB,3163,0,5,2,7,71.4%,1h
12536,3,Vision,3163,141,4,1,5,80.0%,13m
12536,3,MyThOs,3163,30,1,7,8,12.5%,40m
12536,3,ghost,3163,0,0,2,2,0.0%,39m
12558,3,Borg,3162,1288,239,208,447,53.5%,9m
12558,3,stupidface,3162,1558,163,156,319,51.1%,11m
12558,3,Mirrh,3162,1284,112,94,206,54.4%,22m
12558,3,MAL,3162,381,49,60,109,45.0%,37m
12558,3,WiseKoala,3162,1015,43,37,80,53.8%,26m
12558,3,[cl0udM]DaCooGa,3162,971,39,33,72,54.2%,42m
12558,3,Maduin,3162,733,33,25,58,56.9%,33m
12558,3,mercurio,3162,572,23,18,41,56.1%,22m
12558,3,[PMN]WhoGotDaMumf,3162,448,19,8,27,70.4%,25m
12558,3,[Onnor]Kris,3162,182,17,10,27,63.0%,43m
12558,3,winCe,3162,190,10,5,15,66.7%,5m
12558,3,Eci,3162,116,8,6,14,57.1%,3m
12558,3,[DB420]JDilla,3162,225,7,7,14,50.0%,27m
12558,2,varador,3162,95,6,1,7,85.7%,46m
12558,2,OriGiN,3162,95,4,3,7,57.1%,60m
12558,3,Inho,3162,0,3,2,5,60.0%,35m
12558,3,[BIGSTD]Syphilis,3162,86,3,5,8,37.5%,41m
12558,3,pluto,3162,90,3,11,14,21.4%,6m
12558,3,qazsedc,3162,114,2,1,3,66.7%,12m
12558,3,killerp,3162,62,2,5,7,28.6%,24m
12558,3,Shivyk,3162,95,1,1,2,50.0%,35m
12558,1,[142]Kurenzar,3162,0,1,3,4,25.0%,1h
12558,2,[RCSM]clovis,3162,0,1,3,4,25.0%,4m
12558,3,Twasapug,3162,0,1,4,5,20.0%,15m
12558,3,ThePatriot,3162,0,0,1,1,0.0%,26m
12558,3,[3BDK]BadPanda,3162,0,0,2,2,0.0%,9m
12558,3,TheBigCheese,3162,0,0,2,2,0.0%,13m
12558,3,Mechromatt,3162,0,0,3,3,0.0%,39m
12586,3,Acidix,3161,1356,183,160,343,53.4%,36m
12586,3,ikamony,3161,1481,142,113,255,55.7%,35m
12586,3,Rayoclay,3161,1063,72,47,119,60.5%,25m
12586,3,gammonflaps,3161,1223,51,58,109,46.8%,15m
12586,3,[void44]epicvoid,3161,729,31,22,53,58.5%,17m
12586,3,Muahaahaa,3161,443,28,19,47,59.6%,19m
12586,3,xkrimzonx,3161,772,26,38,64,40.6%,24m
12586,3,Scurrilous,3161,446,18,11,29,62.1%,22m
12586,3,Vales,3161,348,15,8,23,65.2%,11m
12586,3,Raider,3161,486,15,30,45,33.3%,40m
12586,3,[CBCQC]LarryEnticer,3161,329,13,6,19,68.4%,22m
12586,3,INfernal,3161,264,11,6,17,64.7%,31m
12586,3,[SGSPP]Sushiagogo,3161,295,10,6,16,62.5%,3m
12586,3,TankDestroyr,3161,280,10,17,27,37.0%,39m
12586,3,[LCKY]Lucky,3161,286,9,21,30,30.0%,15m
12586,1,Doghead,3161,168,8,4,12,66.7%,5m
12586,3,[DHZAcD]Diamonaizer,3161,177,7,12,19,36.8%,42m
12586,3,[ID10TS]Endless,3161,106,6,1,7,85.7%,10m
12586,3,DreaMs,3161,190,5,5,10,50.0%,21m
12586,3,Mariano,3161,58,3,3,6,50.0%,41m
12586,3,lllIIIIlllll,3161,95,2,0,2,100.0%,21m
12586,3,SEFY,3161,60,2,3,5,40.0%,23m
12586,3,YummyCupCake,3161,0,2,3,5,40.0%,15m
12586,3,[xnSx]SpkrFrDead,3161,0,1,1,2,50.0%,33m
12586,1,Yellow,3161,96,1,1,2,50.0%,1h
12586,1,llllIIllIlII,3161,97,1,3,4,25.0%,2h
12586,3,Avión,3161,0,0,1,1,0.0%,15m
12586,3,TossUp,3161,0,0,1,1,0.0%,21m
12586,3,[SLIsc]Xelank,3161,0,0,4,4,0.0%,22m
12615,3,hughGrection,3160,1620,292,270,562,52.0%,20m
12615,3,Mitch,3160,1298,161,133,294,54.8%,19m
12615,3,drip,3160,1334,62,39,101,61.4%,9m
12615,3,[3DLANS]LINKINCHARS,3160,1142,45,46,91,49.5%,13m
12615,2,CaulkMaster,3160,1258,40,65,105,38.1%,9m
12615,3,weather,3160,822,37,25,62,59.7%,14m
12615,3,[eX]Foca,3160,280,29,26,55,52.7%,12m
12615,3,[SC2DD]MadSon,3160,483,20,12,32,62.5%,40m
12615,1,Maxwell,3160,491,16,16,32,50.0%,27m
12615,3,Syrop,3160,314,13,12,25,52.0%,28m
12615,3,SixPackMuk,3160,316,12,7,19,63.2%,13m
12615,2,[AWSL]AGMiao,3160,143,6,2,8,75.0%,3h
12615,3,[PUCP]monkeyBug,3160,194,6,4,10,60.0%,14m
12615,3,PowerInk,3160,0,4,2,6,66.7%,18m
12615,3,admiration,3160,126,4,11,15,26.7%,20m
12615,3,FlyOnSky,3160,135,3,3,6,50.0%,7m
12615,3,ENDER,3160,115,2,2,4,50.0%,10m
12615,3,MarineFeign,3160,62,2,4,6,33.3%,42m
12615,3,[GBros]sSFeisty,3160,0,1,0,1,100.0%,2m
12615,3,THECOON,3160,30,1,3,4,25.0%,30m
12615,1,[FYD]SilkyJenkins,3160,96,1,3,4,25.0%,11m
12615,1,[AbcCo]AlexG,3160,0,1,4,5,20.0%,23m
12615,3,Desamunt,3160,0,0,1,1,0.0%,20m
12615,3,vergapeluda,3160,0,0,2,2,0.0%,29m
12639,3,[C0RN]brikkity,3159,1508,206,196,402,51.2%,40m
12639,3,[PCNTE]Zepo,3159,1582,194,180,374,51.9%,39m
12639,3,[DarkAG]Rinez,3159,1460,79,56,135,58.5%,13m
12639,3,Cast,3159,942,60,64,124,48.4%,41m
12639,3,Brock,3159,1138,59,62,121,48.8%,4m
12639,3,[UpxV]HarDan,3159,998,36,39,75,48.0%,31m
12639,3,[SMHC]Yongbari,3159,532,35,38,73,47.9%,6m
12639,3,Maru,3159,728,31,29,60,51.7%,35m
12639,3,SkeViHuE,3159,689,28,20,48,58.3%,31m
12639,3,INnoVation,3159,572,22,18,40,55.0%,11m
12639,3,Jugo,3159,220,19,14,33,57.6%,12m
12639,3,Poony,3159,403,18,13,31,58.1%,18m
12639,3,Chau,3159,359,17,12,29,58.6%,21m
12639,3,igoairok,3159,453,17,16,33,51.5%,21m
12639,1,[NerfZg]Aguero,3159,460,15,7,22,68.2%,13m
12639,3,sawat,3159,252,11,7,18,61.1%,9m
12639,3,[RANDYZ]FightBrOWN,3159,144,10,14,24,41.7%,36m
12639,3,TheChamp,3159,184,6,3,9,66.7%,18m
12639,3,[ÆON]sevenzica,3159,144,6,6,12,50.0%,29m
12639,3,ChantToGreen,3159,0,4,1,5,80.0%,2h
12639,3,Bdonski,3159,0,4,1,5,80.0%,7m
12639,1,RedPepper,3159,0,3,2,5,60.0%,32m
12639,2,Ancient,3159,138,3,8,11,27.3%,39m
12639,1,TerraSigma,3159,40,1,1,2,50.0%,11m
12663,3,chunkybaby,3158,1174,51,37,88,58.0%,31m
12663,3,ALPHASTAER,3158,915,37,29,66,56.1%,13m
12663,3,[Macac0]pungthewolf,3158,650,24,27,51,47.1%,36m
12663,3,[cluez]llllllllllll,3158,347,13,16,29,44.8%,39m
12663,3,lmc,3158,178,7,11,18,38.9%,29m
12663,3,Lopert,3158,142,6,8,14,42.9%,10m
12663,1,yodice,3158,238,5,6,11,45.5%,26m
12663,2,Mybo,3158,0,4,2,6,66.7%,46m
12663,2,[spragg]Parapingo,3158,46,4,4,8,50.0%,43m
12663,1,Bashkim,3158,40,2,0,2,100.0%,3m
12663,1,[HØST]HaÐes,3158,0,1,0,1,100.0%,10m
12663,3,[Mexxco]DANTE,3158,0,1,2,3,33.3%,6m
12663,1,[LÞ]ReXoR,3158,92,1,2,3,33.3%,35m
12663,1,[60Pho]Trainzor,3158,0,1,2,3,33.3%,8m
12677,3,Chinzilla,3157,1608,368,366,734,50.1%,37m
12677,3,[XpKAc]marinexd,3157,1618,234,226,460,50.9%,19m
12677,3,[juggr]Mkuki,3157,563,20,19,39,51.3%,7m
12677,3,SKARY,3157,407,17,10,27,63.0%,9m
12677,3,[bleave]mesodens,3157,464,16,20,36,44.4%,42m
12677,3,CronoLuminai,3157,174,15,13,28,53.6%,16m
12677,1,Troddler,3157,319,14,4,18,77.8%,30m
12677,3,[1Fenix]MASIVO,3157,327,10,10,20,50.0%,26m
12677,3,RoV,3157,316,10,23,33,30.3%,18m
12677,2,RickyBui,3157,96,5,2,7,71.4%,2h
12677,3,[Macac0]KuRo,3157,146,5,7,12,41.7%,26m
12677,2,iado,3157,0,4,2,6,66.7%,45m
12677,1,[OLV]Tesomas,3157,78,2,2,4,50.0%,13m
12677,3,[JustFF]Nibiru,3157,0,0,2,2,0.0%,21m
12677,3,[ReZipE]WhiteChoCoLa,3157,0,0,2,2,0.0%,43m
12692,3,FalseHope,3156,1570,178,166,344,51.7%,11m
12692,3,ValKyrie,3156,1522,110,111,221,49.8%,17m
12692,3,SnobbyOcto,3156,1511,99,85,184,53.8%,19m
12692,3,bwag,3156,857,42,27,69,60.9%,11m
12692,3,Airlock,3156,794,33,28,61,54.1%,12m
12692,3,bucketcart,3156,583,21,24,45,46.7%,16m
12692,3,[IMDSI]JepitoBv,3156,317,16,9,25,64.0%,28m
12692,3,TheCube,3156,436,15,17,32,46.9%,17m
12692,3,IIIIIIIIIIII,3156,217,10,6,16,62.5%,23m
12692,1,WaltMarc,3156,264,8,5,13,61.5%,33m
12692,3,[LGC]Spark,3156,172,7,8,15,46.7%,6m
12692,3,[DSKapa]MIke,3156,179,6,2,8,75.0%,6m
12692,1,DejaVu,3156,38,2,0,2,100.0%,8m
12692,1,GoudaNuff,3156,0,2,3,5,40.0%,38m
12692,1,SAIA,3156,0,1,0,1,100.0%,34m
12692,3,ShadowDragon,3156,30,1,3,4,25.0%,11m
12692,1,LoTTaR,3156,0,0,1,1,0.0%,26m
12692,3,Fenris,3156,0,0,2,2,0.0%,21m
12692,3,Snow,3156,0,0,2,2,0.0%,7m
12711,3,GaarWars,3155,1405,217,219,436,49.8%,37m
12711,3,Clocking,3155,893,51,41,92,55.4%,6m
12711,3,[FFAA]CHIKIMASTER,3155,1114,49,35,84,58.3%,33m
12711,3,jeorge,3155,1131,45,39,84,53.6%,38m
12711,3,PopitGht,3155,790,30,25,55,54.5%,14m
12711,3,[Carat]Hanzos,3155,318,11,11,22,50.0%,40m
12711,3,[ZDE20]llllllllllll,3155,227,9,10,19,47.4%,7m
12711,1,[Cryptc]Kazooie,3155,42,2,1,3,66.7%,10m
12711,3,[SCVM]Artemis,3155,120,2,3,5,40.0%,18m
12711,1,TheDude,3155,0,1,2,3,33.3%,47m
12711,3,UleakRed,3155,30,1,3,4,25.0%,43m
12711,3,Chany,3155,30,1,7,8,12.5%,9m
12711,2,JasonMraz,3155,0,0,1,1,0.0%,29m
12724,3,Kioelf,3154,1527,207,200,407,50.9%,15m
12724,1,[Nua]pattaya,3154,1580,104,86,190,54.7%,34m
12724,3,heemoon,3154,913,66,57,123,53.7%,12m
12724,1,pixel,3154,813,30,16,46,65.2%,11m
12724,3,[NeAs]fullermarcus,3154,434,16,20,36,44.4%,26m
12724,2,AntMan,3154,287,12,9,21,57.1%,17m
12724,3,[Prison]REV,3154,299,10,12,22,45.5%,15m
12724,1,Kluwe,3154,110,7,2,9,77.8%,38m
12724,1,Dirtyjoe,3154,82,3,0,3,100.0%,25m
12724,3,ZXOmegaXZ,3154,0,1,2,3,33.3%,43m
12734,3,pancc,3153,1552,77,59,136,56.6%,18m
12734,3,lonelyson,3153,1499,67,50,117,57.3%,23m
12734,3,[VFam2]EZDeschanel,3153,1164,64,55,119,53.8%,15m
12734,3,Maestro,3153,958,37,36,73,50.7%,25m
12734,3,[Awooos]Nyagon,3153,716,32,16,48,66.7%,15m
12734,3,MrTerribad,3153,672,25,28,53,47.2%,10m
12734,3,ethos,3153,287,23,15,38,60.5%,24m
12734,3,Macrogasm,3153,588,21,32,53,39.6%,43m
12734,3,Illlllllllll,3153,325,18,17,35,51.4%,31m
12734,1,[iDrunk]Trumpi,3153,429,17,12,29,58.6%,33m
12734,3,[8kPLUS]KimJungNuke,3153,524,17,29,46,37.0%,15m
12734,1,[MCFT]RollinNooBs,3153,310,11,6,17,64.7%,27m
12734,3,[ARGENT]NITRAM,3153,220,7,21,28,25.0%,41m
12734,2,Chronos,3153,133,6,2,8,75.0%,60m
12734,3,Vizen,3153,121,6,4,10,60.0%,33m
12734,3,[HBB]DiorGalore,3153,0,5,0,5,100.0%,31m
12734,1,[ClanS4]TerraniusD,3153,40,2,0,2,100.0%,9m
12734,2,Executor,3153,0,1,0,1,100.0%,1h
12734,1,[Pharoh]MarineTeam,3153,0,1,0,1,100.0%,17m
12734,1,hunglo,3153,96,1,1,2,50.0%,31m
12734,1,Fantasy,3153,0,0,1,1,0.0%,36m
12734,3,Omnivore,3153,0,0,3,3,0.0%,1h
12756,3,tomato,3152,1351,322,336,658,48.9%,36m
12756,3,sliultron,3152,1611,144,131,275,52.4%,10m
12756,3,SinGiRu,3152,1070,57,54,111,51.4%,35m
12756,3,Goooey,3152,314,53,41,94,56.4%,4m
12756,3,Ikepono,3152,815,34,28,62,54.8%,31m
12756,3,Youiur,3152,540,19,18,37,51.4%,27m
12756,3,XXXBlumpkin,3152,274,11,9,20,55.0%,20m
12756,3,LumpySpaceEa,3152,323,11,11,22,50.0%,12m
12756,3,[ROCKSC]Tonyrock,3152,274,9,8,17,52.9%,29m
12756,2,wipeOut,3152,290,8,12,20,40.0%,23m
12756,1,salaheddine,3152,253,7,0,7,100.0%,35m
12756,3,[DRKESP]Bas,3152,125,6,5,11,54.5%,16m
12756,3,llllllllllll,3152,122,5,6,11,45.5%,5m
12756,1,AlmondMilk,3152,196,4,2,6,66.7%,31m
12756,3,[LimaSC]KaMui,3152,146,4,3,7,57.1%,10m
12756,3,[Wrs]NeoGeo,3152,118,4,7,11,36.4%,43m
12756,1,Negligent,3152,80,2,1,3,66.7%,9m
12756,3,Keegan,3152,0,1,0,1,100.0%,41m
12756,1,[FxB]happenss,3152,42,1,1,2,50.0%,23m
12775,3,Sam,3151,1513,349,328,677,51.6%,29m
12775,3,[BORGES]MarineChe,3151,914,76,61,137,55.5%,37m
12775,3,Edarelleb,3151,332,31,25,56,55.4%,39m
12775,3,[LQV]TronBurnBant,3151,627,31,29,60,51.7%,42m
12775,1,RAA,3151,490,15,21,36,41.7%,16m
12775,1,[WBDS]majneb,3151,400,14,9,23,60.9%,32m
12775,3,Striker,3151,209,7,4,11,63.6%,15m
12775,3,Takashi,3151,121,5,2,7,71.4%,52m
12775,3,Samu,3151,164,5,3,8,62.5%,18m
12775,2,AerkH,3151,0,2,5,7,28.6%,17m
12775,1,[lXlXl]Crame,3151,0,1,4,5,20.0%,38m
12775,1,MMMMML,3151,0,0,1,1,0.0%,25m
12775,3,TheJuice,3151,0,0,1,1,0.0%,52m
12775,3,rakshin,3151,0,0,2,2,0.0%,15m
12789,3,iceman,3150,1521,183,174,357,51.3%,9m
12789,3,inHALEN,3150,1591,66,74,140,47.1%,8m
12789,3,[425]Asediante,3150,1281,61,60,121,50.4%,17m
12789,3,Lycan,3150,569,52,46,98,53.1%,12m
12789,3,DreamX,3150,1251,47,55,102,46.1%,35m
12789,3,Dovermore,3150,910,34,36,70,48.6%,41m
12789,3,TheeMaTyLoko,3150,491,22,13,35,62.9%,36m
12789,3,[DarkAG]Sleepy,3150,368,14,11,25,56.0%,25m
12789,1,StupidProbe,3150,456,13,12,25,52.0%,38m
12789,2,nebule,3150,286,10,19,29,34.5%,29m
12789,1,[Cryptc]Soul,3150,236,7,3,10,70.0%,15m
12789,3,DrekHad,3150,203,6,8,14,42.9%,33m
12789,3,LukeSc,3150,82,5,2,7,71.4%,25m
12789,3,NMxMrStabby,3150,150,5,15,20,25.0%,18m
12789,1,MoOdY,3150,0,4,0,4,100.0%,13m
12789,1,PrivateSamso,3150,0,4,1,5,80.0%,11m
12789,1,username,3150,116,3,3,6,50.0%,11m
12789,3,[HUSTLA]minkus,3150,94,2,1,3,66.7%,12m
12789,3,txf,3150,60,2,7,9,22.2%,43m
12789,1,GoHawks,3150,0,1,0,1,100.0%,22m
12789,3,Scare,3150,0,1,2,3,33.3%,17m
12789,3,bluestar,3150,0,1,5,6,16.7%,26m
12811,3,BTomzzz,3149,1457,329,305,634,51.9%,21m
12811,3,[xdbx]Blade,3149,1362,90,86,176,51.1%,43m
12811,3,mazzy,3149,586,68,62,130,52.3%,43m
12811,3,[DNKCFT]Aerialace,3149,623,29,21,50,58.0%,12m
12811,3,Johny,3149,691,27,24,51,52.9%,23m
12811,3,AcidFalls,3149,650,26,27,53,49.1%,6m
12811,3,[AzTeK]JRB,3149,422,20,22,42,47.6%,10m
12811,3,Proteus,3149,504,19,15,34,55.9%,12m
12811,3,JustLap,3149,239,11,7,18,61.1%,25m
12811,3,[BYOD]GWkey,3149,296,11,13,24,45.8%,10m
12811,3,[BiTE]mononoke,3149,109,7,1,8,87.5%,35m
12811,3,[WNTRLY]Leethor,3149,58,4,5,9,44.4%,20m
12811,3,[HBNC]QuipsQuaff,3149,0,2,3,5,40.0%,1h
12811,3,[ACDBRz]joel,3149,60,2,6,8,25.0%,22m
12811,3,pride,3149,0,1,2,3,33.3%,6m
12811,3,[EGx]KevineytorXD,3149,30,1,3,4,25.0%,9m
12811,3,[HaMz]Parm,3149,0,0,1,1,0.0%,46m
12811,3,[CodeB]Decrata,3149,0,0,2,2,0.0%,18m
12829,3,[InGt]LittOGg,3148,1587,349,334,683,51.1%,7m
12829,3,fridor,3148,1126,109,97,206,52.9%,6m
12829,3,[3210]countzero,3148,1073,55,44,99,55.6%,12m
12829,3,sevenOfour,3148,1293,54,56,110,49.1%,24m
12829,1,[Over1]Manuel,3148,1432,51,44,95,53.7%,15m
12829,3,xSPHxChill,3148,1052,46,37,83,55.4%,39m
12829,3,AkusTa,3148,710,25,28,53,47.2%,36m
12829,3,pigbussy,3148,234,8,4,12,66.7%,18m
12829,3,Mopup,3148,147,4,3,7,57.1%,28m
12829,1,[ZTemps]Fibonacci,3148,0,1,0,1,100.0%,34m
12829,1,TurtleSageWS,3148,0,1,0,1,100.0%,13m
12829,3,[DNKCFT]OhStephy,3148,0,0,2,2,0.0%,40m
12829,3,[NPhase]dbBreak,3148,0,0,4,4,0.0%,15m
12829,3,Lawliet,3148,0,0,6,6,0.0%,11m
12843,1,TSLA,3147,1787,77,61,138,55.8%,31m
12843,3,davekind,3147,1352,69,77,146,47.3%,16m
12843,3,BestNA,3147,409,24,27,51,47.1%,40m
12843,3,Complete,3147,531,23,18,41,56.1%,10m
12843,3,Justsimple,3147,318,15,14,29,51.7%,29m
12843,1,[07657]rikywoo,3147,279,9,5,14,64.3%,8m
12843,3,Ormandy,3147,0,5,4,9,55.6%,42m
12843,3,Meatpuller,3147,126,4,14,18,22.2%,28m
12843,1,Pinche,3147,0,0,1,1,0.0%,25m
12852,2,silverhawk,3146,1358,70,89,159,44.0%,25m
12852,3,[D4KSDE]Mauri,3146,760,30,30,60,50.0%,20m
12852,3,TheRight,3146,350,13,15,28,46.4%,33m
12852,3,[ValidG]anfurrax,3146,184,6,6,12,50.0%,25m
12852,3,[EtrOy]Meatball,3146,144,4,3,7,57.1%,7m
12852,3,dholma,3146,60,4,7,11,36.4%,4m
12852,2,Harrypajotes,3146,86,3,33,36,8.3%,3m
12852,2,chatoooooo,3146,88,1,2,3,33.3%,36m
12852,3,Matersky,3146,30,1,5,6,16.7%,31m
12852,1,[Ar4]Miyeon,3146,0,0,1,1,0.0%,32m
12862,3,Elivyndyr,3145,1098,186,167,353,52.7%,40m
12862,3,Mtb,3145,1542,168,171,339,49.6%,21m
12862,3,[KBH]Parrywinkle,3145,1489,155,148,303,51.2%,5m
12862,3,Corporate,3145,1409,144,115,259,55.6%,15m
12862,3,[xMDx]LKDUB,3145,1004,68,74,142,47.9%,27m
12862,3,[BIZCUT]DJRUFIO,3145,705,35,26,61,57.4%,39m
12862,1,Nivek,3145,913,32,21,53,60.4%,15m
12862,3,Malloc,3145,699,31,26,57,54.4%,25m
12862,3,ZeusWayne,3145,354,15,16,31,48.4%,14m
12862,3,jonathan,3145,412,13,22,35,37.1%,7m
12862,3,Mesrob,3145,266,9,6,15,60.0%,7m
12862,3,[T4X]easyway,3145,120,6,14,20,30.0%,37m
12862,1,ThyPower,3145,155,5,1,6,83.3%,42m
12862,3,BCtwogold,3145,86,4,7,11,36.4%,14m
12862,1,[lNI]PrismMike,3145,146,3,1,4,75.0%,24m
12862,3,[NaNiii]TurtleMoans,3145,128,3,2,5,60.0%,39m
12862,3,[GFZ]Angelo,3145,60,2,6,8,25.0%,28m
12862,1,stargodzilla,3145,0,1,0,1,100.0%,25m
12862,3,Slazbot,3145,93,1,2,3,33.3%,25m
12862,1,DaiZhekGo,3145,0,0,1,1,0.0%,34m
12882,3,MadVillain,3144,1120,133,140,273,48.7%,32m
12882,3,DrNeptune,3144,1320,55,48,103,53.4%,11m
12882,3,arietta,3144,576,49,59,108,45.4%,17m
12882,3,shadow,3144,578,28,16,44,63.6%,6m
12882,3,grannit,3144,505,24,14,38,63.2%,12m
12882,3,Tinygodzilla,3144,412,24,23,47,51.1%,26m
12882,3,Pingu,3144,588,23,22,45,51.1%,35m
12882,3,IIIIIIIIIIII,3144,405,17,14,31,54.8%,10m
12882,3,XiuhcOatl,3144,327,15,18,33,45.5%,35m
12882,3,[GØSU]PickleWeed,3144,304,10,13,23,43.5%,40m
12882,1,Aqme,3144,142,6,3,9,66.7%,23m
12882,3,[cl0udM]aButtPirate,3144,146,5,8,13,38.5%,3m
12882,1,RedEyedSmurf,3144,38,4,2,6,66.7%,32m
12882,3,Boi,3144,95,2,1,3,66.7%,9m
12896,3,berT,3143,1554,383,356,739,51.8%,18m
12896,3,Apkuhi,3143,1105,72,57,129,55.8%,31m
12896,3,alltheagents,3143,1123,60,62,122,49.2%,43m
12896,3,LostYurHead,3143,1423,59,50,109,54.1%,20m
12896,3,Free,3143,1064,55,41,96,57.3%,14m
12896,3,[BCSz]SilentK,3143,1266,49,51,100,49.0%,13m
12896,3,[FxB]Remain,3143,692,29,27,56,51.8%,25m
12896,3,[Jerkz]kuryarammr,3143,281,12,8,20,60.0%,18m
12896,2,ChadBroChill,3143,143,11,9,20,55.0%,29m
12896,3,Hershey,3143,248,9,6,15,60.0%,11m
12896,3,Zare,3143,203,7,4,11,63.6%,10m
12896,2,Papaya,3143,154,6,3,9,66.7%,3h
12896,3,Saibogu,3143,184,6,10,16,37.5%,41m
12896,1,Bacon,3143,0,4,1,5,80.0%,19m
12896,1,[SMBBD]VarmintCong,3143,188,4,3,7,57.1%,23m
12896,1,Sutro,3143,150,4,5,9,44.4%,34m
12896,1,JAB,3143,80,3,0,3,100.0%,33m
12896,3,SCVHero,3143,144,3,6,9,33.3%,16m
12896,3,garro,3143,0,0,2,2,0.0%,4m
12896,3,[AcOIGE]kil,3143,0,0,5,5,0.0%,5m
12916,3,Dmoraliser,3142,1540,208,194,402,51.7%,41m
12916,3,Potato,3142,640,28,22,50,56.0%,11m
12916,3,CHOEzilla,3142,550,25,22,47,53.2%,14m
12916,3,GFRIEND,3142,452,17,21,38,44.7%,6m
12916,3,[Skwirl]Gazorp,3142,238,7,7,14,50.0%,19m
12916,1,TôTranquilo,3142,160,3,2,5,60.0%,8m
12916,3,Jonakill,3142,151,3,4,7,42.9%,24m
12916,1,[4aRaza]LUCIFER,3142,40,2,0,2,100.0%,25m
12916,1,[UMCP]leopluradon,3142,0,2,3,5,40.0%,35m
12916,3,dasadsadsa,3142,30,2,4,6,33.3%,15m
12916,3,ProfessorZou,3142,0,1,4,5,20.0%,24m
12916,3,Heart,3142,0,0,3,3,0.0%,36m
12928,3,MKultra,3141,1596,633,626,1259,50.3%,20m
12928,1,Perseverance,3141,1750,212,201,413,51.3%,23m
12928,3,LeonK,3141,1601,120,122,242,49.6%,12m
12928,1,[ScSwrm]Aldric,3141,757,27,17,44,61.4%,33m
12928,3,Solarc,3141,628,27,20,47,57.4%,3m
12928,3,Setur,3141,598,20,28,48,41.7%,13m
12928,1,[CBAS]DaGuill,3141,208,6,2,8,75.0%,3h
12928,1,Hugbleem,3141,161,5,7,12,41.7%,1h
12928,2,ThorOfHeaven,3141,0,4,2,6,66.7%,3h
12928,2,[TOR0]Arkutunus,3141,0,2,4,6,33.3%,22m
12928,1,qqqqqq,3141,0,1,0,1,100.0%,17m
12928,1,zOmBy,3141,40,1,1,2,50.0%,21m
12928,1,[WaP]bewdah,3141,0,1,2,3,33.3%,23m
12928,3,Diomed,3141,0,1,2,3,33.3%,20m
12928,1,Ato,3141,40,1,2,3,33.3%,36m
12928,3,Awfeel,3141,0,0,1,1,0.0%,17m
12928,1,[EoC]ICE,3141,0,0,1,1,0.0%,10m
12928,1,Aurangzeb,3141,0,0,1,1,0.0%,35m
12928,3,Rush,3141,0,0,2,2,0.0%,36m
12947,2,[LHRS]TypeRinteg,3140,1516,453,457,910,49.8%,5m
12947,2,banscii,3140,1538,363,356,719,50.5%,30m
12947,3,[SCULLZ]Nightly,3140,1494,145,142,287,50.5%,29m
12947,3,[V1nD]Double,3140,915,107,108,215,49.8%,42m
12947,3,Danuk,3140,1219,78,80,158,49.4%,6m
12947,3,llllllllllll,3140,298,56,39,95,58.9%,39m
12947,3,NoxyBo,3140,854,46,48,94,48.9%,4m
12947,3,JLDthrasher,3140,1200,44,53,97,45.4%,14m
12947,3,lililililili,3140,384,41,15,56,73.2%,3m
12947,3,Alextf,3140,583,38,30,68,55.9%,11m
12947,1,[RndNgr]WhimsOfFate,3140,409,16,7,23,69.6%,32m
12947,3,carrydacarro,3140,418,16,19,35,45.7%,28m
12947,1,Quasar,3140,412,14,10,24,58.3%,24m
12947,3,[FMX]morphling,3140,265,8,7,15,53.3%,4m
12947,1,ETERNY,3140,238,6,3,9,66.7%,6m
12947,2,SaibaJoichir,3140,0,1,1,2,50.0%,6m
12963,3,ProudPaw,3139,1443,184,187,371,49.6%,11m
12963,3,[DMONlC]SonofMan,3139,1484,132,116,248,53.2%,25m
12963,3,Voodoo,3139,1594,93,97,190,48.9%,33m
12963,3,Gregh,3139,1000,70,58,128,54.7%,14m
12963,3,[DBSM]ACTARUS,3139,334,53,49,102,52.0%,39m
12963,1,sleepybear,3139,655,28,14,42,66.7%,13m
12963,3,sdf,3139,686,28,25,53,52.8%,32m
12963,3,ZDoritoSan,3139,544,25,15,40,62.5%,24m
12963,3,ced,3139,558,19,19,38,50.0%,6m
12963,1,tanooky,3139,448,16,12,28,57.1%,33m
12963,3,Metradime,3139,440,15,18,33,45.5%,8m
12963,3,[Peco]Pecorine,3139,318,14,15,29,48.3%,4m
12963,3,BobLouange,3139,332,11,20,31,35.5%,38m
12963,3,bart,3139,140,7,3,10,70.0%,28m
12963,1,ROTTENFEET,3139,116,3,0,3,100.0%,9m
12963,2,Maverick,3139,128,3,3,6,50.0%,40m
12963,1,WulfBane,3139,97,2,2,4,50.0%,23m
12963,1,llllllllllll,3139,117,2,3,5,40.0%,32m
12963,3,[SGxx]Eville,3139,0,0,1,1,0.0%,48m
12982,3,[cl0udM]Cid,3138,1543,299,282,581,51.5%,29m
12982,3,Hellcat,3138,1404,58,56,114,50.9%,43m
12982,3,StupidBob,3138,516,29,24,53,54.7%,39m
12982,3,[Skier]Babykilla,3138,332,26,18,44,59.1%,11m
12982,3,[grity]Torva,3138,508,21,17,38,55.3%,29m
12982,3,CHEESEforYOU,3138,576,21,23,44,47.7%,31m
12982,3,Crescenzo,3138,516,18,21,39,46.2%,9m
12982,3,[GdAT]ScarlettUK,3138,90,6,9,15,40.0%,42m
12982,1,orlyOWL,3138,38,4,2,6,66.7%,23m
12982,1,VinCenT,3138,161,3,1,4,75.0%,20m
12982,3,SCGoGo,3138,0,3,2,5,60.0%,1h
12982,3,pamesc,3138,118,3,3,6,50.0%,33m
12982,3,kwon,3138,60,3,4,7,42.9%,33m
12982,3,[PTHero]Chuck,3138,0,2,6,8,25.0%,20m
12982,3,Platahalcon,3138,0,1,2,3,33.3%,21m
12982,3,JaneWalkeR,3138,30,1,3,4,25.0%,31m
12982,2,SenpaiSugoi,3138,42,1,4,5,20.0%,27m
12999,3,PandaMachine,3137,1601,202,201,403,50.1%,42m
12999,3,[vvjjvv]VictorChern,3137,1509,199,199,398,50.0%,27m
12999,3,mago,3137,1595,145,127,272,53.3%,26m
12999,3,[CodeGe]ZHERO,3137,1369,130,127,257,50.6%,22m
12999,3,noobbz,3137,1483,119,124,243,49.0%,20m
12999,3,JuanLemonMan,3137,1061,90,71,161,55.9%,20m
12999,2,[GanGan]KleberKM,3137,1274,68,92,160,42.5%,3m
12999,3,SaVIoR,3137,1179,52,46,98,53.1%,12m
12999,3,[Repahs]Jbao,3137,1250,49,55,104,47.1%,32m
12999,3,Pyromancer,3137,654,30,19,49,61.2%,11m
12999,1,Elkahest,3137,424,13,6,19,68.4%,22m
12999,3,[ELTEMW]Nyquist,3137,353,12,11,23,52.2%,43m
12999,1,[62a]Vega,3137,326,11,6,17,64.7%,23m
12999,3,Playerone,3137,292,10,13,23,43.5%,43m
12999,3,JamJam,3137,260,10,15,25,40.0%,14m
12999,3,Flyingmonkye,3137,253,9,6,15,60.0%,18m
12999,1,[OGViet]Tofu,3137,189,8,3,11,72.7%,15m
12999,1,SolBraves,3137,0,4,1,5,80.0%,3m
12999,3,[RINGTA]KinkajouVice,3137,30,2,2,4,50.0%,12m
12999,1,James,3137,0,2,3,5,40.0%,38m
13019,3,Malupeyt,3136,1405,147,143,290,50.7%,28m
13019,3,Lumer,3136,1556,58,66,124,46.8%,18m
13019,3,TheJewFro,3136,913,50,51,101,49.5%,12m
13019,1,Pdeex,3136,1328,45,47,92,48.9%,32m
13019,3,otk,3136,805,36,29,65,55.4%,32m
13019,3,Carlson,3136,354,32,27,59,54.2%,18m
13019,3,[hTx]Holden,3136,283,12,6,18,66.7%,35m
13019,3,lllllllllll,3136,30,5,3,8,62.5%,4m
13019,3,[Macac0]PuNiShEr,3136,156,4,5,9,44.4%,39m
13019,1,liquid,3136,84,3,0,3,100.0%,10m
13019,1,Lovekhj,3136,82,3,2,5,60.0%,3m
13019,3,pEpEeLtOrO,3136,30,2,5,7,28.6%,15m
13019,3,ImBiggMojo,3136,125,2,8,10,20.0%,40m
13019,1,Fallen,3136,0,1,0,1,100.0%,23m
13019,1,[Potate]Bob,3136,38,1,1,2,50.0%,24m
13019,1,Bushwack,3136,0,1,1,2,50.0%,19m
13019,1,FearOf,3136,0,0,1,1,0.0%,25m
13036,1,[EvStar]Galactica,3135,1797,251,234,485,51.8%,5m
13036,3,Saskuk,3135,1335,105,98,203,51.7%,42m
13036,3,[NPhase]Havok,3135,1366,49,59,108,45.4%,14m
13036,3,Joker,3135,858,47,39,86,54.7%,15m
13036,3,[DRAKE7]FosterGIZMO,3135,970,37,39,76,48.7%,16m
13036,3,[SftVgn]DoTcom,3135,860,31,42,73,42.5%,42m
13036,3,[SKyber]yoshymaro,3135,366,14,10,24,58.3%,9m
13036,3,Desibandit,3135,350,13,8,21,61.9%,26m
13036,3,Poppy,3135,305,13,9,22,59.1%,11m
13036,3,SUBmyDIC,3135,377,13,11,24,54.2%,11m
13036,3,rednelB,3135,265,12,8,20,60.0%,16m
13036,3,IIIIIIIIIIII,3135,230,11,7,18,61.1%,30m
13036,1,llllllllllll,3135,253,11,11,22,50.0%,41m
13036,3,[FMO]Cybad,3135,238,10,7,17,58.8%,20m
13036,3,CaptBigBoss,3135,150,5,8,13,38.5%,26m
13036,2,[NAROKO]NAROKO,3135,0,3,4,7,42.9%,3h
13036,2,Meathead,3135,89,2,0,2,100.0%,27m
13036,2,InitiumNovu,3135,94,2,0,2,100.0%,2h
13036,3,awker,3135,0,2,4,6,33.3%,9m
13036,1,[dLife]Odin,3135,0,1,0,1,100.0%,37m
13036,3,Colin,3135,0,1,2,3,33.3%,21m
13036,3,Revalence,3135,95,1,3,4,25.0%,12m
13036,1,kawaii,3135,0,0,1,1,0.0%,15m
13036,1,FinnTheHuman,3135,0,0,3,3,0.0%,18m
13036,3,[xTMGx]TeeMoneyGrip,3135,0,0,4,4,0.0%,43m
13061,3,IIIIIIIIIIII,3134,1521,820,815,1635,50.2%,14m
13061,2,forSCIENCE,3134,1319,104,109,213,48.8%,33m
13061,3,jvnDIGITAL,3134,1058,78,80,158,49.4%,31m
13061,1,NightMare,3134,816,28,25,53,52.8%,24m
13061,3,Santik,3134,464,18,19,37,48.6%,20m
13061,3,SunKing,3134,468,17,17,34,50.0%,12m
13061,3,grinding,3134,378,16,10,26,61.5%,12m
13061,3,kancio,3134,209,9,16,25,36.0%,19m
13061,3,[PTHero]Cybertron,3134,112,6,12,18,33.3%,36m
13061,1,Royal,3134,162,5,4,9,55.6%,12m
13061,1,ImbaTuba,3134,126,3,3,6,50.0%,32m
13061,3,iReach,3134,145,3,4,7,42.9%,24m
13061,1,SonZoo,3134,134,3,4,7,42.9%,13m
13061,1,[RLR2]valithor,3134,44,2,1,3,66.7%,23m
13061,3,Gladys,3134,30,1,8,9,11.1%,3m
13061,1,[GRBP]Rubicon,3134,0,0,2,2,0.0%,17m
13061,1,Erra,3134,0,0,2,2,0.0%,5m
13078,2,[CF2]ESPECIAL,3133,1766,257,264,521,49.3%,39m
13078,3,IronLung,3133,1485,185,191,376,49.2%,17m
13078,3,Jasian,3133,1499,95,90,185,51.4%,25m
13078,3,[GGMESP]NERISEND,3133,576,87,68,155,56.1%,33m
13078,3,deadlift,3133,691,80,49,129,62.0%,2m
13078,1,Kris,3133,653,42,20,62,67.7%,38m
13078,3,Avarice,3133,701,31,33,64,48.4%,35m
13078,1,BattlePants,3133,785,31,33,64,48.4%,42m
13078,1,Conkk,3133,304,8,7,15,53.3%,35m
13078,3,Bominate,3133,182,7,8,15,46.7%,13m
13078,3,TheUubstar,3133,58,6,4,10,60.0%,29m
13078,1,Hellscythe,3133,142,3,2,5,60.0%,50m
13078,3,[aham]GuiZika,3133,62,2,5,7,28.6%,20m
13078,1,DreamX,3133,0,1,0,1,100.0%,23m
13078,1,blahsank,3133,0,1,0,1,100.0%,3m
13078,1,HellGrow,3133,0,1,0,1,100.0%,34m
13078,3,[hTx]DroneCapone,3133,0,1,2,3,33.3%,11m
13078,1,Tyler,3133,44,1,3,4,25.0%,38m
13078,1,Sendarian,3133,0,0,1,1,0.0%,19m
13078,1,SalSalSibalA,3133,0,0,1,1,0.0%,29m
13078,1,Dobs,3133,0,0,2,2,0.0%,23m
13099,3,[ZpaceX]XIIITijax,3132,1617,183,167,350,52.3%,24m
13099,3,[AD3C]Silver,3132,1266,87,69,156,55.8%,25m
13099,3,[MaxraX]Diomedes,3132,1571,82,77,159,51.6%,42m
13099,1,rex,3132,1098,64,56,120,53.3%,23m
13099,3,Kazzdro,3132,590,29,22,51,56.9%,37m
13099,3,[VAPE7]THEGUY,3132,565,25,22,47,53.2%,11m
13099,1,Trinity,3132,517,24,19,43,55.8%,33m
13099,3,[HØST]RuiterD,3132,600,23,27,50,46.0%,43m
13099,1,RedSteel,3132,584,21,16,37,56.8%,24m
13099,3,Canuck,3132,404,15,14,29,51.7%,13m
13099,3,[CBAS2]thematt,3132,366,13,22,35,37.1%,6m
13099,3,SwissBam,3132,372,12,21,33,36.4%,3m
13099,1,ChampStat,3132,255,9,5,14,64.3%,2h
13099,3,higl,3132,182,8,7,15,53.3%,40m
13099,1,Jacky,3132,234,6,6,12,50.0%,23m
13099,3,[eFt0ss]Zerg,3132,140,5,9,14,35.7%,42m
13099,3,Dee,3132,94,2,2,4,50.0%,9m
13099,3,Boss,3132,0,1,1,2,50.0%,18m
13099,1,[R4NK3D]StBarbara,3132,42,1,1,2,50.0%,25m
13099,1,MlonEusk,3132,0,0,1,1,0.0%,34m
13099,2,[MikAlx]SetoKaiba,3132,0,0,1,1,0.0%,1h
13099,1,[DRKNS]LucaDeSupply,3132,0,0,1,1,0.0%,2h
13099,1,[QcScT]JAHMAII,3132,0,0,2,2,0.0%,11m
13122,3,[xLgNx]baeseokil,3131,1582,151,147,298,50.7%,6m
13122,3,[MadK]Long,3131,1005,124,108,232,53.4%,18m
13122,3,Malcs,3131,410,54,59,113,47.8%,7m
13122,2,kilvan,3131,1036,39,48,87,44.8%,19m
13122,3,Grimkz,3131,796,37,46,83,44.6%,35m
13122,3,DrunkEr,3131,694,29,25,54,53.7%,43m
13122,3,HeroMystic,3131,521,21,17,38,55.3%,22m
13122,3,[2faded]ToxicRexha,3131,317,21,22,43,48.8%,12m
13122,3,BudgetedSole,3131,333,13,16,29,44.8%,25m
13122,1,[Agros]AmadusMozart,3131,216,9,5,14,64.3%,18m
13122,3,HugoStiglitz,3131,88,8,4,12,66.7%,25m
13122,1,VanillaWafer,3131,274,8,4,12,66.7%,18m
13122,3,Wyld,3131,171,7,13,20,35.0%,33m
13122,1,[Dre4mT]Moon,3131,158,5,2,7,71.4%,29m
13122,1,[MinzS]AjSvoboda,3131,80,3,1,4,75.0%,10m
13122,1,[TheDOH]Grubson,3131,38,3,1,4,75.0%,11m
13122,1,[MOBOZ]Axiom,3131,0,2,3,5,40.0%,38m
13122,1,IamBog,3131,0,2,3,5,40.0%,11m
13122,3,Lacross,3131,119,2,4,6,33.3%,6m
13122,3,[NwAs]Odinsc,3131,0,1,2,3,33.3%,29m
13122,1,eCakes,3131,0,0,1,1,0.0%,10m
13122,3,GroinShark,3131,0,0,3,3,0.0%,18m
13144,1,VIPER,3130,1304,57,38,95,60.0%,24m
13144,3,RebelChara,3130,667,31,17,48,64.6%,20m
13144,3,Oswald,3130,542,24,15,39,61.5%,17m
13144,3,Gurrpah,3130,326,11,14,25,44.0%,33m
13144,3,Nachtigallen,3130,118,8,6,14,57.1%,6m
13144,3,ONEEEPUNCHHH,3130,86,4,8,12,33.3%,26m
13144,1,[OnLIOn]Specter,3130,122,3,3,6,50.0%,38m
13144,1,[Cakius]lsound,3130,76,2,3,5,40.0%,23m
13144,3,Memnarch,3130,60,2,7,9,22.2%,35m
13144,2,IIllIlIIIlll,3130,0,1,0,1,100.0%,29m
13144,3,Tugonbob,3130,0,1,1,2,50.0%,13m
13144,1,[neuroW]PrivateRyan,3130,0,1,3,4,25.0%,1h
13144,1,Erix,3130,42,1,3,4,25.0%,13m
13144,1,CatchingZeno,3130,0,0,1,1,0.0%,26m
13144,2,[LKS69]IIIIIIIIIIII,3130,0,0,1,1,0.0%,20m
13144,1,[AL33T]Silentdeath,3130,0,0,2,2,0.0%,11m
13144,3,[ctrs]Naki,3130,0,0,4,4,0.0%,40m
13161,3,Quarfelburg,3129,1548,143,133,276,51.8%,12m
13161,3,[KRZY]DeMaharlika,3129,1598,98,88,186,52.7%,3m
13161,3,[RustLg]XxkilljoyxX,3129,1288,77,52,129,59.7%,9m
13161,3,Mursaat,3129,1013,60,43,103,58.3%,39m
13161,3,[URQ]McPupu,3129,398,39,32,71,54.9%,42m
13161,3,Maximus,3129,676,30,20,50,60.0%,41m
13161,3,[DSGoku]JovietUnion,3129,446,19,13,32,59.4%,25m
13161,1,avilo,3129,333,8,4,12,66.7%,3m
13161,3,Luna,3129,200,8,9,17,47.1%,38m
13161,3,[Aye]Jun,3129,165,7,4,11,63.6%,35m
13161,2,MaxPayne,3129,134,7,5,12,58.3%,17m
13161,3,scCharacter,3129,62,6,7,13,46.2%,36m
13161,3,[BiGRiD]Feridun,3129,0,4,1,5,80.0%,3m
13161,3,ErM,3129,147,4,3,7,57.1%,12m
13161,3,Ramas,3129,88,4,5,9,44.4%,10m
13161,3,DrRex,3129,90,4,11,15,26.7%,9m
13161,3,Alvi,3129,108,3,4,7,42.9%,14m
13161,3,Dece,3129,97,2,0,2,100.0%,38m
13161,2,Exile,3129,96,2,1,3,66.7%,2h
13161,1,[80kS]Ramyun,3129,145,2,5,7,28.6%,37m
13161,1,[VFam]Rayvn,3129,42,1,2,3,33.3%,40m
13161,3,BlueDream,3129,0,1,2,3,33.3%,54m
13161,1,[JustFF]Nibiru,3129,38,1,3,4,25.0%,23m
13161,1,[TIM]VLAD,3129,0,0,1,1,0.0%,19m
13185,3,sleet,3128,1581,527,508,1035,50.9%,6m
13185,3,mimori,3128,1169,466,452,918,50.8%,6m
13185,3,Anakin,3128,1028,139,129,268,51.9%,15m
13185,3,powerjp,3128,726,99,82,181,54.7%,24m
13185,3,[UpxV]TheBullyMan,3128,692,98,98,196,50.0%,15m
13185,3,ribbie,3128,466,21,17,38,55.3%,2m
13185,3,Bolsomito,3128,372,19,11,30,63.3%,27m
13185,3,UxorialRook,3128,114,6,4,10,60.0%,10m
13185,1,Emma,3128,168,5,4,9,55.6%,37m
13185,1,Kodiac,3128,0,4,1,5,80.0%,10m
13185,1,[IXXRA]FALKOR,3128,160,4,4,8,50.0%,38m
13185,1,RandyLahey,3128,119,3,0,3,100.0%,51m
13185,1,[ValidG]Mac,3128,134,3,1,4,75.0%,10m
13185,3,ArchersMike,3128,58,2,9,11,18.2%,24m
13185,1,[LMC]shredmastr,3128,0,1,1,2,50.0%,10m
13185,3,[PROWLR]Harse,3128,0,1,4,5,20.0%,1h
13185,3,[NLTN]Ultralisk,3128,0,1,4,5,20.0%,6m
13185,1,Mistaclean,3128,0,0,1,1,0.0%,21m
13185,1,Skyline,3128,0,0,1,1,0.0%,24m
13185,1,Wish,3128,0,0,1,1,0.0%,23m
13185,1,CHOP,3128,0,0,1,1,0.0%,41m
13185,1,[CBAS]BROODy,3128,0,0,2,2,0.0%,16m
13185,3,twitchRpasta,3128,0,0,6,6,0.0%,55m
13208,3,TownhallGuy,3127,1602,181,173,354,51.1%,3m
13208,1,polololo,3127,1416,94,92,186,50.5%,39m
13208,3,boubou,3127,770,29,30,59,49.2%,7m
13208,3,EPICFPV,3127,558,20,25,45,44.4%,3m
13208,1,ScripsShot,3127,73,4,1,5,80.0%,26m
13208,1,HaoMao,3127,0,4,1,5,80.0%,35m
13208,3,Roarrshach,3127,0,3,2,5,60.0%,7m
13208,3,Hipperman,3127,30,1,14,15,6.7%,37m
13208,1,Joaco,3127,0,0,1,1,0.0%,43m
13217,3,[Chibii]Ichigo,3126,1550,237,237,474,50.0%,42m
13217,3,YRIOS,3126,1552,166,168,334,49.7%,36m
13217,3,[NLTTJ]ParadOx,3126,1263,95,84,179,53.1%,42m
13217,3,gLhF,3126,1234,93,47,140,66.4%,15m
13217,3,Madao,3126,1172,81,69,150,54.0%,17m
13217,1,SayNoMore,3126,736,66,41,107,61.7%,25m
13217,3,MakiYoutuber,3126,525,30,20,50,60.0%,5m
13217,3,[Mc]Chikara,3126,430,14,17,31,45.2%,20m
13217,1,SecretPoo,3126,194,6,2,8,75.0%,38m
13217,3,swampdonkey,3126,178,6,16,22,27.3%,11m
13217,3,[HURSES]Honeybadger,3126,0,4,1,5,80.0%,17m
13217,3,[TX]ChuckWagon,3126,122,4,7,11,36.4%,21m
13217,1,Lightnuz,3126,78,3,1,4,75.0%,35m
13217,3,thotleader,3126,68,3,4,7,42.9%,24m
13217,3,deVas,3126,86,3,8,11,27.3%,10m
13217,1,LeQueef,3126,117,2,3,5,40.0%,54m
13217,1,[SUNBRA]Solaire,3126,40,1,3,4,25.0%,31m
13234,3,Shulty,3125,1550,215,169,384,56.0%,25m
13234,3,Renegade,3125,1476,187,167,354,52.8%,21m
13234,3,Skygurner,3125,1522,148,124,272,54.4%,29m
13234,1,[Aprica]Richardo,3125,1186,61,51,112,54.5%,39m
13234,3,Bagman,3125,1421,56,61,117,47.9%,31m
13234,3,[Taller]TMOE,3125,1269,53,46,99,53.5%,9m
13234,3,CloudBoi,3125,1241,50,51,101,49.5%,9m
13234,3,Tethys,3125,691,28,22,50,56.0%,9m
13234,3,[ORTSS]VeganDragon,3125,673,24,24,48,50.0%,12m
13234,3,[LGNxx]Danny,3125,510,22,15,37,59.5%,32m
13234,1,pizza,3125,560,16,11,27,59.3%,25m
13234,1,TheLoneRaven,3125,337,9,4,13,69.2%,10m
13234,3,TheGermster,3125,88,3,6,9,33.3%,20m
13234,3,DoDawn,3125,18,2,4,6,33.3%,38m
13234,3,[NMPro]Megatron,3125,0,1,0,1,100.0%,41m
13234,1,[BfLaD]DensitY,3125,0,1,1,2,50.0%,36m
13234,1,[eViL1z]GameToTheMax,3125,0,0,1,1,0.0%,24m
13234,3,Nomad,3125,0,0,1,1,0.0%,15m
13234,3,ByRuZ,3125,0,0,5,5,0.0%,20m
13234,1,PenduLum,3125,0,0,5,5,0.0%,32m
13254,1,GunsX,3124,1661,292,268,560,52.1%,10m
13254,1,lMl,3124,1252,155,129,284,54.6%,31m
13254,3,Grant,3124,1458,88,82,170,51.8%,17m
13254,3,Morianer,3124,1437,80,67,147,54.4%,11m
13254,1,[WEED77]xXDeadPoolXx,3124,1218,46,39,85,54.1%,19m
13254,3,[CrnKy]MeoMaikasCat,3124,1019,45,39,84,53.6%,18m
13254,1,Playsumgames,3124,715,38,29,67,56.7%,26m
13254,3,john,3124,312,25,24,49,51.0%,20m
13254,3,Shogunkillah,3124,365,23,29,52,44.2%,29m
13254,3,Yuraeha,3124,111,10,14,24,41.7%,13m
13254,2,Indra,3124,166,7,3,10,70.0%,45m
13254,1,[Aisaka]Shinobu,3124,211,6,7,13,46.2%,25m
13254,3,PABLO,3124,94,3,7,10,30.0%,43m
13254,1,bass,3124,44,2,2,4,50.0%,26m
13254,3,BallastedGem,3124,62,2,7,9,22.2%,6m
13254,1,Antigonus,3124,40,1,1,2,50.0%,43m
13254,1,Schuman,3124,0,0,1,1,0.0%,28m
13271,3,ShadowStorm,3123,1563,390,388,778,50.1%,27m
13271,3,[AiMB]MissMicro,3123,1535,241,216,457,52.7%,21m
13271,3,[Cryptc]RagnarDnskld,3123,1243,159,154,313,50.8%,26m
13271,1,Joe,3123,582,70,53,123,56.9%,14m
13271,3,ZDubs,3123,728,49,47,96,51.0%,15m
13271,3,ShadowWalker,3123,229,23,23,46,50.0%,21m
13271,3,[MLPog]Stupefier,3123,621,22,22,44,50.0%,43m
13271,1,[Exper]Monu,3123,216,8,5,13,61.5%,51m
13271,3,[NeOx1]resOrt,3123,236,8,10,18,44.4%,2m
13271,1,IceBox,3123,121,5,2,7,71.4%,3h
13271,3,Cynical,3123,116,5,7,12,41.7%,20m
13271,1,[GRUMEC]ornstein,3123,0,4,0,4,100.0%,11m
13271,1,TheKerfuffle,3123,91,4,2,6,66.7%,15m
13271,3,killopino,3123,60,3,5,8,37.5%,24m
13271,3,Omer,3123,97,2,4,6,33.3%,48m
13271,2,Pplay,3123,0,1,1,2,50.0%,26m
13271,3,Boudichon,3123,0,1,2,3,33.3%,42m
13271,3,TheDudeMan,3123,30,1,10,11,9.1%,31m
13271,1,HardTime,3123,0,0,2,2,0.0%,35m
13290,1,Wreckz,3122,1779,269,259,528,50.9%,13m
13290,3,ELTORITO,3122,1358,82,90,172,47.7%,29m
13290,3,EpickOne,3122,1332,76,66,142,53.5%,30m
13290,1,RobbieKarate,3122,375,13,9,22,59.1%,29m
13290,3,[Alt95]Underscore,3122,202,11,23,34,32.4%,36m
13290,1,MAVNI,3122,250,8,7,15,53.3%,28m
13290,1,Rems,3122,0,5,0,5,100.0%,36m
13290,1,MercuryX,3122,0,4,1,5,80.0%,23m
13290,2,llllllllllll,3122,116,4,3,7,57.1%,60m
13290,3,Bfgiant,3122,146,4,4,8,50.0%,25m
13290,1,parkouralvoi,3122,138,4,4,8,50.0%,24m
13290,3,FatherOfTeam,3122,30,2,3,5,40.0%,43m
13290,1,[Ris3n]PhoenixKing,3122,40,1,1,2,50.0%,24m
13290,1,[SRiC]Obsidian,3122,0,0,1,1,0.0%,10m
13290,1,JeffGoat,3122,0,0,1,1,0.0%,23m
13290,1,lllllllllll,3122,0,0,1,1,0.0%,11m
13306,3,nitechaos,3121,1292,102,89,191,53.4%,42m
13306,3,[TheDOH]JOEY,3121,1561,66,62,128,51.6%,43m
13306,3,BoyFresh,3121,573,38,37,75,50.7%,7m
13306,3,GreGo,3121,586,22,17,39,56.4%,15m
13306,3,saken,3121,540,22,27,49,44.9%,39m
13306,1,vnmZor,3121,361,17,7,24,70.8%,3m
13306,3,fenix,3121,391,17,9,26,65.4%,18m
13306,3,[LGNxx]TyranT,3121,406,14,14,28,50.0%,34m
13306,3,AngryPegouin,3121,114,7,7,14,50.0%,30m
13306,1,sSniper,3121,255,6,9,15,40.0%,11m
13306,1,Luminescence,3121,82,3,1,4,75.0%,43m
13306,3,Revenger,3121,60,3,3,6,50.0%,39m
13306,1,Kizamidal,3121,120,3,4,7,42.9%,37m
13306,3,TeRranLiFe,3121,30,2,3,5,40.0%,11m
13306,1,[TGosuB]RaiderKnight,3121,0,1,0,1,100.0%,32m
13306,1,[DanTub]JustinYing,3121,40,1,1,2,50.0%,37m
13306,1,Nubtorious,3121,38,1,1,2,50.0%,25m
13306,3,[Zno]mengdada,3121,94,1,3,4,25.0%,5m
13306,1,SigNatuS,3121,96,1,4,5,20.0%,9m
13306,3,CupidStunt,3121,30,1,5,6,16.7%,18m
13306,3,Qwel,3121,30,1,6,7,14.3%,38m
13327,3,DarkenRahl,3120,1583,233,243,476,48.9%,10m
13327,3,[BndRyn]Titoi,3120,1553,115,118,233,49.4%,32m
13327,3,Joel,3120,1552,90,77,167,53.9%,14m
13327,3,AoGSapo,3120,664,85,86,171,49.7%,9m
13327,3,Dangermouse,3120,1210,50,40,90,55.6%,43m
13327,3,Nathan,3120,1028,41,42,83,49.4%,26m
13327,3,[C66602]miclo,3120,928,35,36,71,49.3%,39m
13327,3,MixedBiscuit,3120,543,24,21,45,53.3%,12m
13327,3,lxwarr,3120,457,23,19,42,54.8%,26m
13327,3,ASPuzzle,3120,188,8,6,14,57.1%,25m
13327,3,lawroad,3120,174,7,9,16,43.8%,32m
13327,3,[KhanTv]konodioda,3120,182,7,10,17,41.2%,12m
13327,1,[Razor]Pierrot,3120,194,6,4,10,60.0%,11m
13327,1,Helifas,3120,164,5,1,6,83.3%,11m
13327,1,llllllllllll,3120,42,3,3,6,50.0%,27m
13327,3,Ferrar,3120,139,3,5,8,37.5%,16m
13327,3,Snoky,3120,0,1,2,3,33.3%,25m
13327,1,FatKid,3120,38,1,3,4,25.0%,32m
13345,3,SpaceTime,3119,1647,535,520,1055,50.7%,42m
13345,3,[Coll]COLESLAW,3119,1519,273,279,552,49.5%,4m
13345,3,[TPGGXD]sebmati,3119,1552,157,150,307,51.1%,9m
13345,3,[iSpeed]Vald,3119,755,75,70,145,51.7%,18m
13345,3,codehead,3119,862,62,55,117,53.0%,12m
13345,3,BabyOnBoard,3119,387,51,33,84,60.7%,42m
13345,3,[sblxs]jolencrasher,3119,511,51,55,106,48.1%,42m
13345,3,Falcon,3119,637,30,21,51,58.8%,18m
13345,3,Asolend,3119,555,20,19,39,51.3%,14m
13345,1,[TK]CamPanda,3119,58,3,1,4,75.0%,36m
13345,3,[LIMSC2]MagicSocks,3119,30,2,3,5,40.0%,5m
13345,1,[Macac0]JonSnow,3119,0,1,1,2,50.0%,24m
13345,3,SmirPio,3119,30,1,4,5,20.0%,18m
13345,3,Nygma,3119,0,0,1,1,0.0%,39m
13345,3,LegoMan,3119,0,0,2,2,0.0%,39m
13345,1,john,3119,0,0,3,3,0.0%,29m
13361,3,Cobalt,3118,822,185,177,362,51.1%,25m
13361,1,alredo,3118,1492,79,58,137,57.7%,34m
13361,3,Terran,3118,766,57,47,104,54.8%,35m
13361,1,[6ixS]Carbon,3118,1093,43,27,70,61.4%,18m
13361,3,Vance,3118,565,23,31,54,42.6%,31m
13361,3,Jocker,3118,393,17,11,28,60.7%,33m
13361,1,KonamiKode,3118,484,13,13,26,50.0%,10m
13361,3,Oobleck,3118,324,13,17,30,43.3%,3m
13361,1,Enzo,3118,142,6,4,10,60.0%,18m
13361,3,[IDKS5]Sham,3118,0,4,2,6,66.7%,42m
13361,3,Marauder,3118,58,3,6,9,33.3%,43m
13361,1,Marijuander,3118,0,1,0,1,100.0%,24m
13361,3,[AiMB]Steelo,3118,0,1,1,2,50.0%,56m
13361,1,JackDanger,3118,44,1,3,4,25.0%,31m
13361,3,[BOERUH]Açaí,3118,30,1,5,6,16.7%,26m
13376,3,NikkoLAN,3117,1339,74,57,131,56.5%,10m
13376,3,[HØST]VicBansemer,3117,427,16,14,30,53.3%,18m
13376,1,IsayGGdude,3117,190,7,4,11,63.6%,18m
13376,3,Flash,3117,210,7,7,14,50.0%,36m
13376,1,CaptSchmidt,3117,158,5,4,9,55.6%,7m
13376,1,[REALYY]Minet,3117,112,4,2,6,66.7%,24m
13376,1,Victor,3117,40,2,0,2,100.0%,43m
13376,3,DuxDucis,3117,120,2,1,3,66.7%,37m
13376,1,[Cavalo]Lee,3117,0,1,0,1,100.0%,26m
13376,1,StarScream,3117,0,1,0,1,100.0%,50m
13376,3,fuo,3117,30,1,5,6,16.7%,21m
13376,3,KrAuti,3117,30,1,7,8,12.5%,34m
13388,3,[UpeV]Aioria,3116,1576,120,113,233,51.5%,6m
13388,3,NewLife,3116,1601,88,86,174,50.6%,12m
13388,3,[CBAS2]GiantReaver,3116,1266,81,79,160,50.6%,31m
13388,3,[ØÛ]Alxa,3116,1619,74,74,148,50.0%,20m
13388,1,[ALTF04]DiegoxD,3116,483,17,6,23,73.9%,34m
13388,1,Harambe,3116,219,14,7,21,66.7%,28m
13388,3,[ZMBELT]FrzStar,3116,336,13,9,22,59.1%,10m
13388,3,MARVIN,3116,352,12,12,24,50.0%,37m
13388,3,Redshift,3116,108,7,10,17,41.2%,12m
13388,1,llllllllllll,3116,119,6,3,9,66.7%,1h
13388,1,RWBY,3116,196,5,5,10,50.0%,28m
13388,1,hamzod,3116,164,4,4,8,50.0%,38m
13388,1,[SsaYnS]Goku,3116,76,3,0,3,100.0%,35m
13388,3,Freidenberg,3116,93,2,3,5,40.0%,32m
13388,1,JonXnoL,3116,96,2,4,6,33.3%,3m
13388,3,KindSir,3116,121,2,5,7,28.6%,39m
13388,1,[lKoDl]Atila,3116,0,1,0,1,100.0%,39m
13388,1,MainlanderNC,3116,0,1,1,2,50.0%,16m
13388,1,[JaMiT]Hunter,3116,0,0,1,1,0.0%,32m
13407,2,HumanSee,3115,1551,250,265,515,48.5%,28m
13407,3,Malak,3115,1536,240,221,461,52.1%,9m
13407,3,[cun7]Budmaster,3115,1189,181,166,347,52.2%,13m
13407,3,Deathstalker,3115,1623,81,85,166,48.8%,41m
13407,1,JoshGordon,3115,1280,56,47,103,54.4%,25m
13407,3,AceofAbyss,3115,1251,52,51,103,50.5%,39m
13407,3,[BoAVN]JerryFunk,3115,737,38,37,75,50.7%,17m
13407,3,DoubleZero,3115,723,36,40,76,47.4%,12m
13407,3,JimHacker,3115,611,30,9,39,76.9%,30m
13407,3,Angelmaker,3115,593,21,21,42,50.0%,7m
13407,1,blink,3115,535,19,9,28,67.9%,12m
13407,1,Bubamofobear,3115,618,19,16,35,54.3%,25m
13407,3,[FrD]FAWFUL,3115,320,11,14,25,44.0%,33m
13407,1,Peet,3115,264,7,4,11,63.6%,18m
13407,3,freehongkong,3115,121,5,3,8,62.5%,58m
13407,1,nomad,3115,0,1,0,1,100.0%,20m
13407,1,Kavaryx,3115,0,1,0,1,100.0%,13m
13407,3,[ArmoX]Batou,3115,30,1,5,6,16.7%,20m
13407,1,Haven,3115,0,0,2,2,0.0%,19m
13426,3,Lastexit,3114,1595,228,206,434,52.5%,4m
13426,3,Ebalin,3114,1571,224,208,432,51.9%,27m
13426,1,Alex,3114,1766,201,194,395,50.9%,36m
13426,3,[ZTempz]Tsalt,3114,1145,50,39,89,56.2%,10m
13426,3,[GOPERÚ]PerroCruel,3114,794,48,51,99,48.5%,6m
13426,1,Turarthdur,3114,403,18,14,32,56.2%,37m
13426,3,[UrBX]Callnoway,3114,272,9,8,17,52.9%,39m
13426,1,[GOPERÚ]Edward,3114,186,6,2,8,75.0%,35m
13426,3,[USAofA]TRUMP,3114,120,3,4,7,42.9%,30m
13426,2,Smith,3114,88,3,11,14,21.4%,25m
13426,1,OnePercent,3114,0,1,0,1,100.0%,3m
13426,1,NizzyP,3114,0,1,2,3,33.3%,15m
13426,3,[DarkAG]zelkova,3114,0,1,6,7,14.3%,18m
13426,1,KelThuzad,3114,0,0,1,1,0.0%,32m
13426,1,[iCumz]JerkInHoff,3114,0,0,1,1,0.0%,21m
13441,3,mastertiger,3113,1573,201,188,389,51.7%,18m
13441,3,Dutchy,3113,1447,92,93,185,49.7%,5m
13441,3,Freki,3113,889,48,33,81,59.3%,12m
13441,1,RedClay,3113,895,40,39,79,50.6%,38m
13441,3,[Y4NG20]SiPpyCuP,3113,557,36,34,70,51.4%,3m
13441,3,Ikkyu,3113,784,33,34,67,49.3%,26m
13441,3,Rodrigo,3113,665,27,24,51,52.9%,14m
13441,2,SingleShot,3113,173,8,3,11,72.7%,1h
13441,2,Edicted,3113,226,8,30,38,21.1%,14m
13441,3,panda,3113,0,5,0,5,100.0%,2h
13441,1,NoeL,3113,148,5,1,6,83.3%,25m
13441,3,[Severe]StormCluster,3113,121,5,2,7,71.4%,2h
13441,3,Lynyrd,3113,86,3,8,11,27.3%,18m
13441,2,GoogleMap,3113,46,2,2,4,50.0%,38m
13441,3,[KingSC]Alemania,3113,30,2,3,5,40.0%,39m
13441,3,[lLiTl]mitOmega,3113,62,2,10,12,16.7%,37m
13441,1,[Squidy]ThrillHo,3113,0,1,0,1,100.0%,29m
13441,1,ecruzol,3113,0,1,0,1,100.0%,12m
13441,1,GeneralToa,3113,97,1,3,4,25.0%,19m
13441,1,[SBlock]Alan,3113,0,0,1,1,0.0%,15m
13441,1,Cruor,3113,0,0,1,1,0.0%,23m
13441,2,Rayzer,3113,0,0,2,2,0.0%,13m
13463,1,RoboGodXD,3112,1778,494,485,979,50.5%,42m
13463,3,[1LIDER]bboyeyou,3112,1591,154,149,303,50.8%,12m
13463,3,sequester,3112,742,62,51,113,54.9%,11m
13463,1,[LUE]yorick,3112,1011,38,28,66,57.6%,33m
13463,1,KuDoS,3112,855,30,18,48,62.5%,40m
13463,1,ThatOneDude,3112,194,9,8,17,52.9%,21m
13463,3,[ExcIgN]Fernanda,3112,130,6,8,14,42.9%,36m
13463,1,llllllllllll,3112,103,5,2,7,71.4%,25m
13463,1,FrankMawn,3112,0,4,1,5,80.0%,23m
13463,1,[DMD]DrKim,3112,118,3,2,5,60.0%,13m
13463,1,[GRNSKN]SlubberBub,3112,126,3,6,9,33.3%,17m
13463,3,Crs,3112,30,2,4,6,33.3%,7m
13463,1,MiracLe,3112,0,1,0,1,100.0%,25m
13463,1,VanillaLove,3112,0,0,3,3,0.0%,42m
13463,3,[BROBES]GBEX,3112,0,0,5,5,0.0%,12m
13463,3,LlamaKing,3112,0,0,6,6,0.0%,58m
13479,3,[DarkAG]Meta,3111,1295,101,102,203,49.8%,11m
13479,3,ArkenSk,3111,681,29,26,55,52.7%,27m
13479,3,Slowtoss,3111,476,25,22,47,53.2%,26m
13479,3,DesertFox,3111,631,25,24,49,51.0%,39m
13479,1,[SsaYnS]johnrodjohn,3111,581,22,13,35,62.9%,35m
13479,1,Sondaljan,3111,257,11,13,24,45.8%,6m
13479,1,StevieJay,3111,150,5,2,7,71.4%,5m
13479,1,Romy,3111,36,2,0,2,100.0%,32m
13479,1,[FxB]DJCylon,3111,0,2,3,5,40.0%,33m
13479,1,DaNoob,3111,0,2,3,5,40.0%,23m
13479,1,Hitmanp,3111,86,2,3,5,40.0%,35m
13479,3,XLeoNarX,3111,0,1,0,1,100.0%,14m
13479,1,Scorpio,3111,40,1,2,3,33.3%,28m
13479,3,RazeriaN,3111,38,1,8,9,11.1%,42m
13479,1,CAGS,3111,0,0,1,1,0.0%,20m
13494,3,Fulcrum,3110,1591,229,221,450,50.9%,28m
13494,1,[DKBR]AltIIIIItlA,3110,1775,149,104,253,58.9%,23m
13494,3,JSLanz,3110,1086,57,75,132,43.2%,25m
13494,1,[Ex7rA]Chaos,3110,1239,53,41,94,56.4%,26m
13494,1,LMntBeast,3110,922,34,21,55,61.8%,26m
13494,1,lolostar,3110,515,22,7,29,75.9%,10m
13494,3,SomewhatOdd,3110,606,21,30,51,41.2%,42m
13494,3,HwaLiM,3110,546,20,22,42,47.6%,42m
13494,3,Abernasty,3110,316,17,13,30,56.7%,24m
13494,3,Cinnamonlrv,3110,456,16,25,41,39.0%,20m
13494,1,[H3xPr0]snowditer,3110,496,14,15,29,48.3%,25m
13494,1,[spa3c]stonecoat,3110,438,13,9,22,59.1%,15m
13494,3,[KGH3]BlackHydra,3110,320,12,14,26,46.2%,39m
13494,3,[DHZ0ne]matcos,3110,234,9,12,21,42.9%,7m
13494,1,Adamantium,3110,260,8,6,14,57.1%,10m
13494,3,[FU2]BiggaNWigga,3110,252,8,15,23,34.8%,12m
13494,1,Luchito,3110,209,6,4,10,60.0%,23m
13494,3,Anh,3110,163,5,4,9,55.6%,35m
13494,3,[TrpleT]Croaker,3110,88,4,5,9,44.4%,42m
13494,1,Freesoul,3110,44,2,1,3,66.7%,10m
13494,1,WebOn,3110,40,1,3,4,25.0%,11m
13494,3,[BAUS]farQ,3110,0,1,5,6,16.7%,1h
13494,1,Tyve,3110,0,0,1,1,0.0%,4m
13494,1,[3DLANS]kevin,3110,0,0,1,1,0.0%,13m
13518,3,maruuuis,3109,1545,301,282,583,51.6%,12m
13518,1,tjshen,3109,1594,133,114,247,53.8%,25m
13518,3,[ExcIgN]InsertText,3109,1453,84,90,174,48.3%,31m
13518,1,xuisp,3109,1219,72,50,122,59.0%,23m
13518,3,Solamento,3109,1107,48,43,91,52.7%,31m
13518,3,[SsaYnS]Sleeky,3109,876,32,36,68,47.1%,21m
13518,3,[AbcCo]HojuelaDMaiz,3109,703,28,24,52,53.8%,26m
13518,1,eom,3109,546,21,16,37,56.8%,17m
13518,3,Paru,3109,290,10,11,21,47.6%,40m
13518,3,Staaryun,3109,165,8,5,13,61.5%,4m
13518,1,Planetes,3109,230,7,1,8,87.5%,36m
13518,3,[Mc]MrSatan,3109,214,7,11,18,38.9%,7m
13518,3,[FateTw]Neroc,3109,174,6,9,15,40.0%,18m
13518,1,Bard,3109,161,5,5,10,50.0%,26m
13518,3,Serral,3109,88,5,7,12,41.7%,24m
13518,1,[LMen]trenchshot,3109,166,4,5,9,44.4%,28m
13518,1,[Simios]Luxuxiao,3109,0,1,0,1,100.0%,37m
13518,1,[PrbOne]Felisk,3109,0,1,0,1,100.0%,25m
13518,1,Wizard,3109,42,1,1,2,50.0%,4m
13518,3,FriendlyFire,3109,0,1,1,2,50.0%,17m
13518,1,[PuStLe]tugfa,3109,42,1,3,4,25.0%,30m
13518,1,NuStream,3109,0,0,1,1,0.0%,25m
13518,1,[ValidG]Penguin,3109,0,0,3,3,0.0%,4m
13541,3,Poony,3108,480,69,64,133,51.9%,42m
13541,3,unknownagent,3108,1233,63,66,129,48.8%,27m
13541,3,lucifer,3108,1389,60,62,122,49.2%,27m
13541,3,FatboyStim,3108,791,58,55,113,51.3%,35m
13541,3,[DHZ0ne]Fodon,3108,777,56,50,106,52.8%,16m
13541,3,SaucyMcPain,3108,952,38,37,75,50.7%,21m
13541,1,[CFSMY]KrystaL,3108,886,34,23,57,59.6%,43m
13541,3,[ExcIgN]piñuflonter,3108,673,26,26,52,50.0%,5m
13541,3,theplen,3108,294,24,28,52,46.2%,33m
13541,3,[DNKCFT]DANKCRAFT,3108,404,14,14,28,50.0%,42m
13541,3,Broheim,3108,303,13,11,24,54.2%,13m
13541,1,TheBoom,3108,359,12,8,20,60.0%,32m
13541,1,Traktorist,3108,284,9,3,12,75.0%,9m
13541,1,Celebrant,3108,348,9,5,14,64.3%,40m
13541,2,Spartan,3108,160,7,6,13,53.8%,17m
13541,1,[JTown1]abattlor,3108,97,5,4,9,55.6%,1h
13541,1,[CCFCA]Fringe,3108,139,3,2,5,60.0%,3m
13541,1,[WW1]ProHunter,3108,0,1,0,1,100.0%,43m
13541,2,LittleSnow,3108,0,1,1,2,50.0%,5m
13541,1,TheLionEye,3108,0,0,1,1,0.0%,23m
13541,1,oldhobosam,3108,0,0,2,2,0.0%,11m
13541,2,GhostWansui,3108,0,0,7,7,0.0%,20m
13563,2,[MSFT]MDM,3107,1536,320,339,659,48.6%,4m
13563,3,SwagKing,3107,1345,149,151,300,49.7%,12m
13563,3,KrazyEyez,3107,1442,103,97,200,51.5%,31m
13563,3,[a99]Megabyte,3107,848,70,83,153,45.8%,6m
13563,3,[EEG12]IdrAhaha,3107,760,42,49,91,46.2%,34m
13563,3,[BAGLS]Yanny,3107,295,10,9,19,52.6%,39m
13563,3,[JAZ]SKIKS,3107,148,6,11,17,35.3%,14m
13563,1,[CH3ES3]FluffyKitten,3107,154,4,3,7,57.1%,37m
13563,3,KwonOldMan,3107,30,2,5,7,28.6%,18m
13563,1,WhiteWhaleLo,3107,0,1,1,2,50.0%,39m
13563,3,[neuroW]Seamonsta,3107,42,1,7,8,12.5%,31m
13563,1,Roke,3107,0,0,1,1,0.0%,9m
13563,1,KingOfBlades,3107,0,0,3,3,0.0%,7m
13576,1,TripleD,3106,1779,194,175,369,52.6%,31m
13576,3,[Habil]RODACKS,3106,1544,126,121,247,51.0%,36m
13576,3,[YD2K]Daniel,3106,440,68,40,108,63.0%,42m
13576,1,grelezmrze,3106,863,31,26,57,54.4%,38m
13576,1,tommytommy,3106,430,12,15,27,44.4%,15m
13576,3,Grrrr,3106,366,12,18,30,40.0%,40m
13576,1,TMGODZILLA,3106,328,10,11,21,47.6%,33m
13576,3,ShootingDuck,3106,77,10,14,24,41.7%,20m
13576,1,manodemo,3106,328,9,8,17,52.9%,33m
13576,2,[MKting]LizardKing,3106,141,5,1,6,83.3%,17m
13576,3,wonder,3106,194,5,8,13,38.5%,25m
13576,1,MyLove,3106,161,4,5,9,44.4%,3h
13576,3,Rapsoda,3106,109,3,2,5,60.0%,11m
13576,1,Jarib,3106,44,2,2,4,50.0%,43m
13576,1,GeardFord,3106,0,1,0,1,100.0%,10m
13576,3,xSilencedRPG,3106,30,1,5,6,16.7%,13m
13592,3,ALaSToR,3105,1530,221,202,423,52.2%,7m
13592,3,Popols,3105,1274,64,63,127,50.4%,32m
13592,3,Harrison,3105,684,47,42,89,52.8%,15m
13592,1,hereicome,3105,936,39,19,58,67.2%,11m
13592,3,Aiden,3105,168,6,6,12,50.0%,39m
13592,1,CptDENNis,3105,119,5,3,8,62.5%,23m
13592,2,Young,3105,46,2,0,2,100.0%,3h
13592,1,LargePeniz,3105,40,2,0,2,100.0%,14m
13592,3,Daizer,3105,96,2,0,2,100.0%,27m
13592,1,Hylian,3105,0,2,6,8,25.0%,2h
13592,3,maninaqloop,3105,60,2,10,12,16.7%,28m
13592,1,Pshar,3105,38,1,1,2,50.0%,21m
13592,3,doran,3105,30,1,7,8,12.5%,7m
13592,1,[UCI]QuickDraw,3105,0,0,1,1,0.0%,23m
13592,1,Laon,3105,0,0,1,1,0.0%,7m
13592,1,Vortex,3105,0,0,1,1,0.0%,25m
13592,1,ExpGerbil,3105,0,0,3,3,0.0%,24m
13609,3,ramsay,3104,1332,348,347,695,50.1%,39m
13609,3,Vueman,3104,1553,298,293,591,50.4%,22m
13609,3,soniiC,3104,960,67,56,123,54.5%,32m
13609,1,shvonder,3104,711,28,20,48,58.3%,10m
13609,3,scottimus,3104,342,22,19,41,53.7%,4m
13609,1,Defider,3104,583,21,16,37,56.8%,35m
13609,3,wobbaone,3104,425,20,16,36,55.6%,31m
13609,3,[Grand]CodeOfBars,3104,506,17,21,38,44.7%,9m
13609,1,[GRNSKN]Taurus,3104,524,16,16,32,50.0%,24m
13609,1,grannit,3104,474,14,10,24,58.3%,27m
13609,3,Blake,3104,114,4,10,14,28.6%,12m
13609,1,Sparkling,3104,0,3,2,5,60.0%,28m
13609,1,NotToxic,3104,0,1,0,1,100.0%,43m
13609,1,KinGViraL,3104,0,0,1,1,0.0%,23m
13609,3,Grizzly,3104,0,0,8,8,0.0%,9m
13624,3,crushCo,3103,1572,114,116,230,49.6%,35m
13624,1,Ryan,3103,1274,103,89,192,53.6%,25m
13624,3,Cobra,3103,1274,50,47,97,51.5%,3m
13624,1,Thumb,3103,1291,44,44,88,50.0%,28m
13624,3,[XpKb]Rterrakion,3103,716,38,27,65,58.5%,29m
13624,1,tofuwitgame,3103,437,16,15,31,51.6%,35m
13624,3,[BL]Kevingalls,3103,347,13,11,24,54.2%,26m
13624,2,[TATR]StreetSharx,3103,350,12,12,24,50.0%,3m
13624,1,Pyroide,3103,440,12,12,24,50.0%,40m
13624,1,Kermy,3103,414,11,11,22,50.0%,24m
13624,1,[IOvOI]Broodie,3103,300,9,10,19,47.4%,38m
13624,1,[SolOGS]Black,3103,158,6,3,9,66.7%,3h
13624,1,[AD3C]RAZZER,3103,0,5,3,8,62.5%,29m
13624,1,[slvHRo]BrOnzeHerO,3103,116,4,4,8,50.0%,16m
13624,3,PigInMud,3103,118,4,10,14,28.6%,6m
13624,1,LLTQueen,3103,42,2,2,4,50.0%,11m
13624,3,brosidius,3103,0,1,4,5,20.0%,37m
13624,3,QLmindless,3103,30,1,7,8,12.5%,40m
13624,1,[Seek]QCD,3103,0,0,1,1,0.0%,43m
13624,1,Devil,3103,0,0,1,1,0.0%,11m
13644,3,[1LPD]Darkmerlinn,3102,1547,175,173,348,50.3%,21m
13644,3,Hadrian,3102,701,62,68,130,47.7%,10m
13644,3,Tumbao,3102,914,39,31,70,55.7%,26m
13644,1,Bearoo,3102,856,38,27,65,58.5%,6m
13644,3,[KSGT]EnDerrJr,3102,524,23,15,38,60.5%,10m
13644,3,[GGK]Pillowpants,3102,316,12,16,28,42.9%,28m
13644,1,liturtle,3102,369,11,5,16,68.8%,19m
13644,1,Purity,3102,274,7,7,14,50.0%,18m
13644,3,oneshot,3102,222,7,24,31,22.6%,14m
13644,3,HandOfMidas,3102,40,3,5,8,37.5%,11m
13644,3,IIIIIIIIIIII,3102,123,2,6,8,25.0%,22m
13644,3,JoNes,3102,0,1,1,2,50.0%,14m
13644,1,[BM5]Tamiskk,3102,0,1,1,2,50.0%,4m
13644,1,Chaos,3102,0,0,1,1,0.0%,27m
13644,3,Dookiemon,3102,0,0,3,3,0.0%,6m
13644,3,Owaka,3102,0,0,4,4,0.0%,40m
13660,1,ChipHazard,3101,1781,254,237,491,51.7%,4m
13660,3,[iRango]GoldenFancy,3101,1233,143,128,271,52.8%,15m
13660,3,Hammer,3101,1471,115,97,212,54.2%,43m
13660,3,[DETER]Dan,3101,1575,105,95,200,52.5%,9m
13660,3,GoatOfMendes,3101,1546,70,57,127,55.1%,11m
13660,1,Joeguar,3101,908,36,26,62,58.1%,16m
13660,1,[GTY]GTYbaboon,3101,831,32,26,58,55.2%,25m
13660,3,[iDrunk]IIIIIIIIIIII,3101,434,21,16,37,56.8%,14m
13660,3,iNFiNiTE,3101,542,19,29,48,39.6%,6m
13660,1,Swimpy,3101,428,12,9,21,57.1%,6m
13660,3,[NPhase]money,3101,137,4,4,8,50.0%,10m
13660,3,bluetears,3101,94,3,4,7,42.9%,6m
13660,3,WorstZergNa,3101,30,2,1,3,66.7%,21m
13660,1,ChicknSlayer,3101,38,2,3,5,40.0%,24m
13660,1,[Nfreak]Kerplunk,3101,0,0,1,1,0.0%,35m
13675,3,chino,3100,1119,209,199,408,51.2%,23m
13675,3,shiz,3100,1469,192,182,374,51.3%,24m
13675,3,[DRKRIS]PaPaFeNiX,3100,974,103,100,203,50.7%,18m
13675,3,IIIIIIIIIII,3100,735,45,39,84,53.6%,36m
13675,3,LEMOUR,3100,352,16,12,28,57.1%,31m
13675,1,ChiLeNo,3100,295,9,10,19,47.4%,30m
13675,3,[TRETER]Splice,3100,239,8,13,21,38.1%,13m
13675,1,[Wufei]poiuykr,3100,0,5,4,9,55.6%,44m
13675,3,marmelloh,3100,162,4,1,5,80.0%,37m
13675,1,Timmic,3100,102,4,2,6,66.7%,18m
13675,1,NightRaven,3100,160,4,3,7,57.1%,23m
13675,1,[AnUB]bloodsaenz,3100,152,4,4,8,50.0%,6m
13675,3,llllllllll,3100,0,3,2,5,60.0%,19m
13675,1,[FAPFAP]MaceWangdu,3100,112,3,3,6,50.0%,29m
13675,1,[JaMiT]Trethris,3100,0,1,0,1,100.0%,23m
13675,1,Nevarion,3100,0,1,0,1,100.0%,6m
13675,1,MundoPc,3100,0,0,1,1,0.0%,10m
13692,3,markcf,3099,1598,167,169,336,49.7%,32m
13692,1,[CRAKS]LaGaRTo,3099,1309,58,52,110,52.7%,35m
13692,1,[XpKAc]CsCena,3099,1033,43,32,75,57.3%,37m
13692,1,CIVIL,3099,539,16,11,27,59.3%,12m
13692,3,RedPanda,3099,312,11,9,20,55.0%,35m
13692,1,[TGosuC]Thor,3099,370,10,13,23,43.5%,41m
13692,1,Gueville,3099,274,6,3,9,66.7%,13m
13692,3,mercimek,3099,0,4,2,6,66.7%,12m
13692,1,[GTnLB]Enderson,3099,82,3,5,8,37.5%,43m
13692,1,[Repov]STAR,3099,40,2,1,3,66.7%,20m
13692,1,flufluf,3099,80,2,4,6,33.3%,24m
13692,1,[CRPCO]Rackio,3099,0,1,0,1,100.0%,30m
13692,1,TuSKachetes,3099,40,1,1,2,50.0%,33m
13692,1,Soychi,3099,40,1,4,5,20.0%,4m
13692,1,nErva,3099,42,1,4,5,20.0%,28m
13692,3,StickyRice,3099,0,0,6,6,0.0%,10m
13708,1,[RITSC]Exile,3098,1518,107,83,190,56.3%,10m
13708,3,zoO,3098,516,90,94,184,48.9%,13m
13708,3,Future,3098,1137,87,86,173,50.3%,30m
13708,3,Rust,3098,197,66,74,140,47.1%,8m
13708,3,Progamer,3098,247,62,52,114,54.4%,15m
13708,1,CafeDeSade,3098,1191,54,47,101,53.5%,9m
13708,3,MadAppleDoc,3098,1102,41,46,87,47.1%,14m
13708,1,Bjebis,3098,719,31,21,52,59.6%,3m
13708,3,Bacchus,3098,817,30,32,62,48.4%,6m
13708,3,wingsofheart,3098,271,11,5,16,68.8%,11m
13708,1,Rashid,3098,265,9,1,10,90.0%,6m
13708,3,[PCNTE]TrygerMortis,3098,202,7,12,19,36.8%,22m
13708,3,SirDraKe,3098,132,5,8,13,38.5%,32m
13708,3,CycRH,3098,142,3,6,9,33.3%,26m
13708,2,ninofabula,3098,0,1,0,1,100.0%,10m
13708,2,earthlinG,3098,0,1,1,2,50.0%,3h
13708,3,Jeedai,3098,0,1,2,3,33.3%,19m
13708,1,[DERDD]OOOOOOLOLOOO,3098,0,0,1,1,0.0%,24m
13708,1,Myrrhcy,3098,0,0,1,1,0.0%,10m
13727,1,Dant,3097,1314,217,211,428,50.7%,42m
13727,3,Idarinis,3097,845,78,63,141,55.3%,7m
13727,1,[iDrunk]StimMarine,3097,1408,74,70,144,51.4%,6m
13727,1,varush,3097,1214,49,38,87,56.3%,25m
13727,1,Takumon,3097,755,36,13,49,73.5%,40m
13727,3,mouna,3097,406,20,23,43,46.5%,4m
13727,3,Testament,3097,183,6,9,15,40.0%,23m
13727,3,[Calx]Lemaitre,3097,154,6,15,21,28.6%,16m
13727,1,KillerApe,3097,155,5,2,7,71.4%,31m
13727,1,Bishop,3097,216,5,11,16,31.2%,38m
13727,3,Jtan,3097,140,5,15,20,25.0%,37m
13727,1,BeltaLowda,3097,0,1,1,2,50.0%,35m
13727,3,[MaLiZ]Tangobsesion,3097,0,0,1,1,0.0%,5m
13727,1,superninja,3097,0,0,1,1,0.0%,10m
13741,3,TheHellHound,3096,1607,184,187,371,49.6%,6m
13741,3,[CBDThc]essolect,3096,1444,79,84,163,48.5%,7m
13741,3,SCatological,3096,1324,48,57,105,45.7%,31m
13741,3,[InGt]GaryTheSnail,3096,1199,47,45,92,51.1%,25m
13741,3,[BGGBOI]PinkiePie,3096,357,36,14,50,72.0%,42m
13741,3,[KoYoTe]Nuke,3096,647,35,29,64,54.7%,14m
13741,1,riskybadger,3096,499,31,11,42,73.8%,15m
13741,3,[dLife]Monkey,3096,381,31,31,62,50.0%,25m
13741,1,[PMN]Lockdown,3096,289,12,8,20,60.0%,23m
13741,1,Player,3096,170,10,7,17,58.8%,23m
13741,3,SpeedRacer,3096,310,10,17,27,37.0%,7m
13741,1,FFXIVqueue,3096,254,8,6,14,57.1%,43m
13741,3,BossHog,3096,188,6,2,8,75.0%,20m
13741,3,ReusableTP,3096,0,4,2,6,66.7%,41m
13741,1,hackertitan,3096,90,3,3,6,50.0%,6m
13741,2,DaWhiteMan,3096,96,2,1,3,66.7%,60m
13741,1,[BoRnGo]ACuteSnek,3096,40,1,1,2,50.0%,26m
13741,1,[Squigr]volumez,3096,0,0,1,1,0.0%,43m
13741,1,supermech,3096,0,0,2,2,0.0%,35m
13760,1,KittyCatBar,3095,1709,830,793,1623,51.1%,15m
13760,3,[xozT]goku,3095,1556,409,414,823,49.7%,36m
13760,3,[BEAF]UncleChe,3095,1515,164,167,331,49.5%,36m
13760,1,[MluvK]MyBFMadeMe,3095,1657,88,54,142,62.0%,35m
13760,1,[MadK]Kevin,3095,1628,87,70,157,55.4%,27m
13760,3,Croe,3095,1587,82,67,149,55.0%,10m
13760,3,DrMario,3095,1196,64,61,125,51.2%,36m
13760,1,Tazerface,3095,1472,59,40,99,59.6%,16m
13760,3,JhonyLeon,3095,962,35,40,75,46.7%,15m
13760,1,Hushpuppy,3095,627,21,14,35,60.0%,43m
13760,1,LuckyLarry,3095,372,12,9,21,57.1%,11m
13760,2,Strider,3095,187,7,3,10,70.0%,1h
13760,1,[shttrz]dudeman,3095,167,7,4,11,63.6%,29m
13760,3,Rexx,3095,0,4,1,5,80.0%,1h
13760,3,Rolly,3095,120,3,4,7,42.9%,42m
13760,1,[TFFO]Meh,3095,32,2,2,4,50.0%,13m
13760,1,[YouGet]vagin,3095,42,1,2,3,33.3%,11m
13760,3,LyneMartel,3095,30,1,10,11,9.1%,32m
13760,1,[TheSho]StimzCapone,3095,0,0,1,1,0.0%,13m
13760,3,Kakee,3095,0,0,7,7,0.0%,18m
13780,3,[LimaSC]ZATOX,3094,1592,156,138,294,53.1%,22m
13780,1,prolapse,3094,1704,118,111,229,51.5%,14m
13780,3,SunTzu,3094,1474,110,98,208,52.9%,7m
13780,3,Koncha,3094,1487,87,86,173,50.3%,15m
13780,3,DukeWilliam,3094,1326,57,62,119,47.9%,42m
13780,1,BlazedOne,3094,1047,56,45,101,55.4%,33m
13780,3,KtrsterFlash,3094,831,44,41,85,51.8%,32m
13780,3,AntonioRC,3094,786,39,26,65,60.0%,27m
13780,3,Atreides,3094,844,35,33,68,51.5%,25m
13780,3,[SOAR]ImperialGuar,3094,711,27,25,52,51.9%,15m
13780,1,hatchet,3094,646,20,20,40,50.0%,7m
13780,3,StableGenius,3094,376,19,16,35,54.3%,18m
13780,1,mcnugger,3094,410,13,7,20,65.0%,12m
13780,3,Joker,3094,386,13,17,30,43.3%,12m
13780,3,[QTp2T]ARc,3094,326,11,16,27,40.7%,29m
13780,3,[3OS]Dreki,3094,330,11,23,34,32.4%,35m
13780,2,[GURLLL]LiquidDeath,3094,211,8,5,13,61.5%,3h
13780,3,Eatme,3094,121,5,3,8,62.5%,1h
13780,3,[NN421]scrambldeggs,3094,0,4,2,6,66.7%,1h
13780,1,Coestberg,3094,116,4,3,7,57.1%,26m
13780,1,Cheesey,3094,80,2,2,4,50.0%,10m
13780,1,[QTLING]VismanMMXXIV,3094,76,2,3,5,40.0%,12m
13780,1,IIIIIIIIIIII,3094,88,2,4,6,33.3%,26m
13780,3,Yoda,3094,62,2,9,11,18.2%,13m
13780,3,[TeamUR]Datenstreber,3094,0,1,5,6,16.7%,3m
13780,3,LouKoo,3094,0,0,1,1,0.0%,52m
13780,2,IIHarryll,3094,0,0,1,1,0.0%,5m
13780,1,Cassa,3094,0,0,2,2,0.0%,35m
13780,1,FroZ,3094,0,0,4,4,0.0%,2h
13809,3,Pinkerton,3093,917,106,100,206,51.5%,35m
13809,3,Charlypesc,3093,923,61,45,106,57.5%,37m
13809,3,Greedo,3093,879,48,33,81,59.3%,29m
13809,1,NoobMaster,3093,502,16,14,30,53.3%,9m
13809,3,CptKreep,3093,205,9,7,16,56.2%,11m
13809,2,Titan,3093,219,7,6,13,53.8%,8m
13809,3,[MSCE]MADCERBERO,3093,221,6,9,15,40.0%,6m
13809,1,Nemesis,3093,180,5,4,9,55.6%,41m
13809,3,SeRgiio,3093,94,4,6,10,40.0%,15m
13809,3,AyeCaptain,3093,86,3,21,24,12.5%,18m
13809,1,[GRUMEC]SOLDIER,3093,38,2,2,4,50.0%,9m
13809,1,Blackchips,3093,0,0,1,1,0.0%,25m
13809,1,IIIIIIIIII,3093,0,0,1,1,0.0%,14m
13809,1,BlissDemonz,3093,0,0,2,2,0.0%,35m
13823,3,SwiftJam,3092,422,279,274,553,50.5%,7m
13823,3,[PTHero]Effay,3092,278,33,37,70,47.1%,6m
13823,1,ThePretender,3092,380,19,13,32,59.4%,25m
13823,3,BADLIAR,3092,345,17,15,32,53.1%,15m
13823,1,[iDrunk]GetmTheCrow,3092,593,16,25,41,39.0%,16m
13823,3,[ILMP]RepenT,3092,448,15,21,36,41.7%,31m
13823,2,Recurrence,3092,46,6,2,8,75.0%,46m
13823,1,NexTime,3092,116,6,3,9,66.7%,16m
13823,1,cccccccccccc,3092,144,5,3,8,62.5%,14m
13823,1,AtlasEndured,3092,164,5,6,11,45.5%,32m
13823,1,[OGbros]OGmicah,3092,120,4,2,6,66.7%,4m
13823,3,[AngryB]Relapse,3092,181,4,7,11,36.4%,35m
13823,1,[1for2]maximo,3092,113,3,1,4,75.0%,26m
13823,1,[SDLB]lalo,3092,40,2,0,2,100.0%,34m
13823,1,[PUMPZ]Vidra,3092,0,1,0,1,100.0%,38m
13823,1,BCBudz,3092,38,1,1,2,50.0%,41m
13823,1,[FUUD]nonissue,3092,0,0,1,1,0.0%,9m
13823,1,TruePhenom,3092,0,0,2,2,0.0%,17m
13841,1,Saldanha,3091,1662,201,179,380,52.9%,33m
13841,3,[Engrs]Azlan,3091,1527,175,177,352,49.7%,7m
13841,3,Joey,3091,1502,87,87,174,50.0%,20m
13841,3,tonishii,3091,1038,86,75,161,53.4%,39m
13841,3,capslocking,3091,1377,74,50,124,59.7%,25m
13841,3,leelee,3091,441,71,68,139,51.1%,18m
13841,3,Fugazi,3091,1511,67,73,140,47.9%,5m
13841,1,Jordyf,3091,1156,43,34,77,55.8%,39m
13841,1,ttboii,3091,884,38,23,61,62.3%,42m
13841,3,[LQV]Philip,3091,530,19,24,43,44.2%,39m
13841,1,Jackco,3091,497,15,11,26,57.7%,27m
13841,1,Krillin,3091,307,11,4,15,73.3%,12m
13841,3,Machine,3091,86,8,6,14,57.1%,13m
13841,1,Phirrup,3091,158,7,4,11,63.6%,23m
13841,1,Vaw,3091,188,5,1,6,83.3%,5m
13841,1,Eastratusky,3091,100,5,2,7,71.4%,39m
13841,1,Fenga,3091,184,5,5,10,50.0%,23m
13841,1,[rFs]BrownGuy,3091,0,4,1,5,80.0%,3m
13841,3,Stimmin,3091,0,4,2,6,66.7%,2h
13841,3,[LWSS]MikeHawwke,3091,62,2,11,13,15.4%,18m
13841,1,[SDC12]Peste,3091,0,0,3,3,0.0%,23m
13862,3,AOC,3090,1543,204,216,420,48.6%,20m
13862,3,[WOTDL]bray,3090,1303,168,147,315,53.3%,15m
13862,3,dahaka,3090,1380,108,107,215,50.2%,42m
13862,3,Macrophage,3090,1596,82,66,148,55.4%,35m
13862,1,scrapper,3090,1735,68,64,132,51.5%,25m
13862,1,PhenotypEd,3090,1242,45,42,87,51.7%,10m
13862,3,AllahAkbar,3090,669,33,36,69,47.8%,35m
13862,3,KrombopulosM,3090,342,12,11,23,52.2%,6m
13862,3,[1Fenix]luky,3090,160,6,5,11,54.5%,16m
13862,1,[IVIars]HanFei,3090,242,6,8,14,42.9%,17m
13862,3,URst,3090,0,4,2,6,66.7%,7m
13862,3,Maximum,3090,88,4,7,11,36.4%,24m
13862,1,Kingbeto,3090,114,3,7,10,30.0%,17m
13862,3,llllllllllll,3090,58,2,7,9,22.2%,20m
13862,1,Spirithound,3090,42,1,1,2,50.0%,18m
13862,3,herO,3090,0,0,1,1,0.0%,1h
13862,1,[ØFoxF2]Matador,3090,0,0,1,1,0.0%,23m
13862,1,[αXLa]CHEF,3090,0,0,2,2,0.0%,1h
13862,1,dustycat,3090,0,0,2,2,0.0%,35m
13862,3,rds,3090,0,0,5,5,0.0%,25m
13882,3,Ketchup,3089,1233,139,145,284,48.9%,32m
13882,3,Cervelas,3089,1467,92,100,192,47.9%,42m
13882,3,mèoméomeomèo,3089,1428,89,74,163,54.6%,11m
13882,1,VeloxFelidae,3089,843,33,19,52,63.5%,6m
13882,1,[UNoobs]DPH,3089,428,16,9,25,64.0%,31m
13882,3,[Poway]CableSC,3089,455,16,19,35,45.7%,42m
13882,3,[haidua]CuongNgo,3089,236,9,12,21,42.9%,28m
13882,3,[InGt]Sleepycook,3089,154,6,10,16,37.5%,42m
13882,1,FallenHero,3089,0,5,0,5,100.0%,25m
13882,3,MostGroce,3089,94,4,7,11,36.4%,28m
13882,1,ScapE,3089,154,3,2,5,60.0%,10m
13882,1,Nachito,3089,112,3,4,7,42.9%,35m
13882,3,paulconroy,3089,58,3,8,11,27.3%,42m
13882,3,[GRONKS]Gronktastic,3089,0,1,0,1,100.0%,55m
13882,1,[SuperZ]Pelouse,3089,0,1,4,5,20.0%,11m
13882,1,FranDogg,3089,0,0,3,3,0.0%,15m
13898,3,[32]DRDEATH,3088,1537,410,392,802,51.1%,20m
13898,3,Mustacracken,3088,1352,313,311,624,50.2%,6m
13898,2,Zhenos,3088,1390,215,239,454,47.4%,4m
13898,3,COTEBMG,3088,800,92,103,195,47.2%,33m
13898,3,[SsaYnS]littlefs,3088,1129,49,40,89,55.1%,36m
13898,1,TheCurian,3088,791,33,27,60,55.0%,26m
13898,1,AzzenKa,3088,330,22,14,36,61.1%,17m
13898,3,Nidstang,3088,385,13,14,27,48.1%,5m
13898,1,StarLORDinc,3088,384,12,14,26,46.2%,3m
13898,3,[hapy]HapierCarrot,3088,225,10,8,18,55.6%,25m
13898,1,[BrBa]DaRyN,3088,248,8,6,14,57.1%,13m
13898,1,PeraUmPouco,3088,110,4,2,6,66.7%,41m
13898,1,UchihaMadara,3088,97,2,3,5,40.0%,3h
13898,3,Hurdsaucey,3088,0,1,0,1,100.0%,13m
13898,1,minseo,3088,0,0,2,2,0.0%,42m
13913,3,Aspassia,3087,982,117,107,224,52.2%,14m
13913,3,[Pinoys]BOLT,3087,1600,105,106,211,49.8%,33m
13913,3,RamDass,3087,418,16,22,38,42.1%,40m
13913,1,Hippedfish,3087,371,14,11,25,56.0%,12m
13913,3,TrueNorth,3087,396,13,21,34,38.2%,42m
13913,3,Dinglebock,3087,198,6,11,17,35.3%,28m
13913,3,pony,3087,144,4,1,5,80.0%,10m
13913,1,Zelkonar,3087,158,4,1,5,80.0%,24m
13913,1,Chewy,3087,80,2,2,4,50.0%,33m
13913,1,Psiyan,3087,0,0,1,1,0.0%,3h
13913,1,Darling,3087,0,0,1,1,0.0%,10m
13924,1,Rising,3086,1771,789,732,1521,51.9%,43m
13924,3,[UpxV]RennerHalley,3086,1605,179,174,353,50.7%,17m
13924,3,HellSorC,3086,1521,169,153,322,52.5%,15m
13924,3,CatFish,3086,786,34,30,64,53.1%,3m
13924,1,ProToZ,3086,481,15,11,26,57.7%,43m
13924,3,Stouticuss,3086,149,12,12,24,50.0%,35m
13924,1,PorcoRei,3086,294,11,8,19,57.9%,33m
13924,1,moooilkshake,3086,0,5,0,5,100.0%,31m
13924,1,JpDestrok,3086,139,4,0,4,100.0%,37m
13924,1,Fruityloop,3086,146,4,5,9,44.4%,4m
13924,1,LetsMacro,3086,160,4,6,10,40.0%,33m
13924,3,Lorsted,3086,0,0,1,1,0.0%,1h
13924,2,IlIllIlllIll,3086,0,0,1,1,0.0%,60m
13924,1,Samurai,3086,0,0,2,2,0.0%,6m
13938,3,MrMcGown,3085,1582,371,352,723,51.3%,19m
13938,3,time,3085,1431,141,132,273,51.6%,18m
13938,3,SilentHazard,3085,1558,75,77,152,49.3%,6m
13938,3,CmonToss,3085,1216,64,71,135,47.4%,27m
13938,1,Newcreation,3085,815,33,30,63,52.4%,16m
13938,3,DonPajerin,3085,405,30,35,65,46.2%,31m
13938,3,mac,3085,506,21,16,37,56.8%,18m
13938,3,[GnR]TitsMcgee,3085,516,20,22,42,47.6%,20m
13938,3,[NOllll]IIIIIIIIIIII,3085,230,15,9,24,62.5%,29m
13938,3,Cellermaker,3085,368,12,19,31,38.7%,34m
13938,1,ASD,3085,254,7,6,13,53.8%,6m
13938,1,[zuu]Reaganomics,3085,103,6,2,8,75.0%,42m
13938,1,Bregi,3085,0,5,0,5,100.0%,23m
13938,3,Terrantula,3085,30,5,3,8,62.5%,13m
13938,1,TheBOMB,3085,228,5,6,11,45.5%,6m
13938,3,name,3085,144,5,10,15,33.3%,15m
13938,3,oiL,3085,124,4,19,23,17.4%,43m
13938,1,[ExceI]Modranidrem,3085,78,3,4,7,42.9%,29m
13938,1,[MeLFtw]MaverickOca,3085,140,2,4,6,33.3%,3h
13938,3,PaPaHH,3085,0,2,4,6,33.3%,3h
13938,1,krumz,3085,40,1,4,5,20.0%,18m
13938,3,Tharsan,3085,0,0,1,1,0.0%,21m
13960,3,honk,3084,1327,170,165,335,50.7%,8m
13960,3,[FyHr]DarkFenix,3084,1483,102,101,203,50.2%,24m
13960,3,Vlaider,3084,1594,78,73,151,51.7%,34m
13960,1,kram,3084,725,73,63,136,53.7%,43m
13960,3,[xRI]killeroflife,3084,653,67,74,141,47.5%,9m
13960,3,overkill,3084,701,34,21,55,61.8%,20m
13960,3,Urso,3084,914,31,45,76,40.8%,33m
13960,3,Scoub,3084,702,25,35,60,41.7%,12m
13960,1,Dallred,3084,330,9,6,15,60.0%,37m
13960,3,Auron,3084,200,7,8,15,46.7%,6m
13960,3,[PFFN]Brickmaster,3084,94,6,1,7,85.7%,15m
13960,3,YeoSK,3084,202,6,7,13,46.2%,37m
13960,1,beno,3084,0,5,0,5,100.0%,43m
13960,1,Santi,3084,136,5,2,7,71.4%,38m
13960,1,Chepi,3084,112,3,3,6,50.0%,12m
13960,3,Poptart,3084,116,3,4,7,42.9%,11m
13960,1,[TGCF]Pascual,3084,0,1,0,1,100.0%,20m
13960,1,Giff,3084,40,1,4,5,20.0%,3m
13960,3,tasdingos,3084,0,1,5,6,16.7%,31m
13960,1,RonDamon,3084,0,0,1,1,0.0%,36m
13960,1,[XHB]Ayuooo,3084,0,0,1,1,0.0%,12m
13960,1,[Pravda]Xandier,3084,0,0,1,1,0.0%,17m
13960,3,JSJSJS,3084,0,0,1,1,0.0%,39m
13960,1,[LoGiQ]Voges,3084,0,0,2,2,0.0%,7m
13960,1,[FGG]TylerBLe,3084,73,0,5,5,0.0%,27m
13985,3,rysqui,3083,1489,262,246,508,51.6%,16m
13985,3,Lobão,3083,893,109,87,196,55.6%,7m
13985,1,ShadyDealer,3083,1081,48,39,87,55.2%,16m
13985,3,Junkdog,3083,1148,47,53,100,47.0%,13m
13985,1,[DILFS]Grofflcopter,3083,927,34,29,63,54.0%,32m
13985,1,funwithdirt,3083,798,26,24,50,52.0%,27m
13985,3,[Foton]Pulsar,3083,550,25,19,44,56.8%,42m
13985,3,Salt,3083,414,14,16,30,46.7%,20m
13985,1,[SANGRE]TAIGTHU,3083,300,8,8,16,50.0%,24m
13985,3,keit,3083,145,6,2,8,75.0%,1h
13985,1,filthysanchz,3083,44,2,0,2,100.0%,6m
13985,3,EasyComeUp,3083,0,2,5,7,28.6%,41m
13985,1,[BRZLGN]Ripflash,3083,0,1,0,1,100.0%,34m
13985,1,NeverminD,3083,0,1,0,1,100.0%,32m
13985,1,blossom,3083,0,1,1,2,50.0%,27m
13985,1,[GTWITM]SALMON,3083,0,1,2,3,33.3%,41m
13985,1,TBZ,3083,0,1,4,5,20.0%,39m
13985,1,IIIIllllIIlI,3083,0,0,1,1,0.0%,21m
13985,1,[KRD]chaitea,3083,0,0,1,1,0.0%,23m
13985,1,[DoRQ]GaseousDeath,3083,0,0,2,2,0.0%,21m
13985,1,tpk,3083,0,0,4,4,0.0%,15m
14006,3,lanczse,3082,1523,271,263,534,50.7%,11m
14006,3,[TLibre]JoRgE,3082,1324,197,203,400,49.2%,39m
14006,1,deathshoot,3082,1488,167,136,303,55.1%,15m
14006,3,Citrus,3082,1510,162,133,295,54.9%,11m
14006,3,Chelaman,3082,1572,96,96,192,50.0%,36m
14006,1,DrastcMedusa,3082,1115,74,61,135,54.8%,13m
14006,3,[NFLDs]Imperator,3082,712,31,25,56,55.4%,16m
14006,3,[NPhasA]alex,3082,513,20,24,44,45.5%,12m
14006,1,[R3V0LT]Karlinator,3082,490,19,11,30,63.3%,42m
14006,1,Citizenkangg,3082,498,19,16,35,54.3%,39m
14006,1,[cl0udM]shiptor,3082,358,15,3,18,83.3%,23m
14006,1,Supply,3082,211,9,6,15,60.0%,14m
14006,3,AlianAnt,3082,159,7,5,12,58.3%,21m
14006,3,[bigFan]FruitDealer,3082,202,7,18,25,28.0%,32m
14006,1,[nieBla]Krouz,3082,0,5,0,5,100.0%,30m
14006,1,vitamin,3082,88,3,5,8,37.5%,10m
14006,1,Chaos,3082,40,2,0,2,100.0%,23m
14006,1,IlIlIlIlIlIl,3082,73,1,1,2,50.0%,10m
14006,1,[monudo]DonPolano,3082,40,1,4,5,20.0%,29m
14006,1,ioOoi,3082,0,0,1,1,0.0%,42m
14006,1,Peaches,3082,0,0,1,1,0.0%,29m
14006,1,Delta,3082,0,0,1,1,0.0%,12m
14006,1,Sharts,3082,0,0,4,4,0.0%,42m
14029,3,ELocON,3081,1250,258,244,502,51.4%,35m
14029,3,[XZEROX]VoidWolf,3081,859,125,105,230,54.3%,7m
14029,3,[MOMRF]flamingcheto,3081,858,47,44,91,51.6%,39m
14029,3,[SsaYnS]DarkPrelate,3081,1134,46,45,91,50.5%,27m
14029,3,Brebeau,3081,171,23,24,47,48.9%,17m
14029,1,Pichael,3081,247,11,11,22,50.0%,25m
14029,1,[FwithT]Night,3081,348,10,9,19,52.6%,31m
14029,3,[dMdC]PaulAtreides,3081,257,9,9,18,50.0%,18m
14029,1,WhiteFangmsi,3081,158,3,2,5,60.0%,11m
14029,1,Emily,3081,129,3,4,7,42.9%,33m
14029,3,Assassin,3081,119,3,5,8,37.5%,10m
14029,2,RandomName,3081,121,2,2,4,50.0%,1h
14029,1,mookid,3081,0,1,0,1,100.0%,29m
14029,1,goudon,3081,0,1,0,1,100.0%,35m
14029,1,[WNTRCH]TableTop,3081,0,0,1,1,0.0%,33m
14044,3,[DSGoku]ArgentSouL,3080,1560,187,177,364,51.4%,39m
14044,1,Slater,3080,965,155,125,280,55.4%,27m
14044,3,Ghost,3080,1536,147,121,268,54.9%,15m
14044,3,VLADIMIR,3080,1534,86,76,162,53.1%,12m
14044,1,[BATMF]Toposgg,3080,1074,59,47,106,55.7%,25m
14044,1,InsangelouS,3080,506,41,27,68,60.3%,29m
14044,3,[iDrunk]Fox,3080,795,36,36,72,50.0%,32m
14044,3,cosecant,3080,941,34,35,69,49.3%,29m
14044,3,[MAMBA]Intel,3080,590,25,27,52,48.1%,13m
14044,1,Throwback,3080,345,14,11,25,56.0%,11m
14044,2,IIIIIllIlIll,3080,166,6,5,11,54.5%,3h
14044,1,[5Svrt]Nyctor,3080,196,4,2,6,66.7%,35m
14044,3,QueueQueue,3080,97,4,3,7,57.1%,1h
14044,1,Kurare,3080,152,4,6,10,40.0%,42m
14044,1,Darkxan,3080,78,3,4,7,42.9%,24m
14044,3,hatethisgame,3080,120,3,5,8,37.5%,34m
14044,1,[X17]TraP,3080,76,2,1,3,66.7%,24m
14044,1,NeoSlayer,3080,78,2,2,4,50.0%,3m
14044,1,snoopy,3080,80,2,5,7,28.6%,37m
14044,1,[MOAV]TANKITTT,3080,0,0,1,1,0.0%,24m
14044,1,[KORR]mangko,3080,0,0,1,1,0.0%,23m
14065,3,[iGOSU]KennyRogers,3079,1557,208,209,417,49.9%,34m
14065,3,[Sn50]evilhologram,3079,1251,197,198,395,49.9%,43m
14065,2,[NrFms]Matriarchy,3079,1495,155,178,333,46.5%,6m
14065,3,Drhashimoto,3079,1539,144,130,274,52.6%,43m
14065,3,NarcoS,3079,1340,140,132,272,51.5%,28m
14065,1,Juul,3079,1708,109,89,198,55.1%,12m
14065,3,FireScale,3079,995,89,85,174,51.1%,7m
14065,3,Dallas,3079,1208,65,56,121,53.7%,11m
14065,3,[DNuts]CoKiller,3079,788,46,50,96,47.9%,19m
14065,1,TsarBomba,3079,980,34,30,64,53.1%,27m
14065,1,Meb,3079,835,26,22,48,54.2%,27m
14065,1,[LimaSC]TBDayMasacre,3079,602,25,20,45,55.6%,23m
14065,1,[Krizby]Player,3079,406,16,11,27,59.3%,14m
14065,3,Sergio,3079,426,16,35,51,31.4%,42m
14065,1,Clutch,3079,405,13,9,22,59.1%,21m
14065,3,CatheaD,3079,185,11,10,21,52.4%,13m
14065,3,[XpKb]FranciS,3079,261,9,9,18,50.0%,25m
14065,3,bob,3079,135,5,3,8,62.5%,19m
14065,3,fate,3079,97,4,2,6,66.7%,1h
14065,3,SneakyTurtle,3079,97,4,2,6,66.7%,58m
14065,3,[MooSha]regulator,3079,30,3,5,8,37.5%,11m
14065,1,jonry,3079,0,2,3,5,40.0%,3h
14065,1,sYnNaCl,3079,34,1,1,2,50.0%,14m
14065,1,TheDivinial,3079,0,0,1,1,0.0%,43m
14089,3,wooky,3078,761,115,120,235,48.9%,32m
14089,1,[mrclen]MrFresh,3078,1752,111,99,210,52.9%,35m
14089,3,muiltpower,3078,397,51,43,94,54.3%,6m
14089,1,SmokeRus,3078,806,36,34,70,51.4%,18m
14089,3,[UDTna]JacDraco,3078,762,33,31,64,51.6%,17m
14089,3,Raka,3078,705,33,33,66,50.0%,16m
14089,3,GoTerran,3078,348,14,14,28,50.0%,39m
14089,3,[Nightz]FrostyNightz,3078,283,12,8,20,60.0%,40m
14089,1,CobraCommand,3078,300,12,13,25,48.0%,25m
14089,2,Marodox,3078,92,7,4,11,63.6%,3h
14089,1,chinchinsuke,3078,175,5,0,5,100.0%,14m
14089,1,mookhail,3078,139,4,0,4,100.0%,33m
14089,1,Vagabondyjx,3078,146,4,6,10,40.0%,9m
14089,1,[AMZN]juice,3078,0,1,0,1,100.0%,43m
14089,1,Illuminus,3078,94,1,2,3,33.3%,27m
14089,1,[DoRQ]TheLordGersh,3078,0,1,4,5,20.0%,26m
14089,1,FUNK,3078,38,1,4,5,20.0%,39m
14089,1,Citrus,3078,42,1,7,8,12.5%,37m
14089,1,WooriJib,3078,0,0,1,1,0.0%,35m
14089,1,KillaMagilla,3078,0,0,1,1,0.0%,29m
14089,1,revolution,3078,0,0,1,1,0.0%,35m
14089,1,[LOPELU]johanpicc,3078,0,0,1,1,0.0%,29m
14111,3,diamondduck,3077,1085,167,173,340,49.1%,21m
14111,1,[NR6]Espartaco,3077,1278,143,135,278,51.4%,43m
14111,1,BloodHawk,3077,1600,142,131,273,52.0%,10m
14111,3,[ACS]nightwing,3077,1569,98,92,190,51.6%,11m
14111,3,[FFAA]Nattramn,3077,920,80,73,153,52.3%,33m
14111,1,CaptainSpiff,3077,1382,50,48,98,51.0%,12m
14111,1,Icarus,3077,767,42,43,85,49.4%,24m
14111,1,Cancel,3077,430,16,12,28,57.1%,42m
14111,1,Juxtapose,3077,328,13,8,21,61.9%,24m
14111,1,joaquin,3077,386,12,14,26,46.2%,36m
14111,1,[IDumb]meeees,3077,330,10,8,18,55.6%,24m
14111,1,Automatic,3077,206,9,6,15,60.0%,34m
14111,3,DPlayerFour,3077,193,7,4,11,63.6%,23m
14111,1,TerdFerguson,3077,155,5,7,12,41.7%,29m
14111,1,[EtrOy]helloworld,3077,136,4,1,5,80.0%,31m
14111,3,OcarinOfTime,3077,0,4,2,6,66.7%,1h
14111,1,[InDoGa]BakBak,3077,144,4,6,10,40.0%,18m
14111,1,[T0PK3K]fuzzyBUNNY,3077,64,3,1,4,75.0%,18m
14111,1,[DHZ0ne]TIRIRICA,3077,42,1,3,4,25.0%,16m
14111,3,Aneurysm,3077,0,0,1,1,0.0%,1h
14111,3,SVETA,3077,0,0,3,3,0.0%,15m
14111,2,Rhagnar,3077,0,0,6,6,0.0%,58m
14133,1,SuperElitPro,3076,1678,174,159,333,52.3%,35m
14133,3,[ntrx]JhonnyPienso,3076,1615,143,134,277,51.6%,9m
14133,3,HaoD,3076,1488,136,135,271,50.2%,17m
14133,3,Daniel,3076,1460,60,61,121,49.6%,27m
14133,3,[INRI]BadSkel,3076,688,29,24,53,54.7%,22m
14133,3,Ckl,3076,320,13,11,24,54.2%,22m
14133,1,[CSUF]ImGMbtw,3076,274,9,5,14,64.3%,35m
14133,3,[Ballz]Kaisad,3076,155,7,5,12,58.3%,6m
14133,3,[OPLADR]Axe,3076,105,5,3,8,62.5%,25m
14133,1,[Janna]CaNut,3076,150,4,7,11,36.4%,25m
14133,1,Scizor,3076,0,1,0,1,100.0%,12m
14133,1,FrozenCloud,3076,0,1,0,1,100.0%,30m
14133,1,Zodiac,3076,0,1,2,3,33.3%,20m
14133,1,jed,3076,96,1,2,3,33.3%,34m
14133,1,Katz,3076,48,1,3,4,25.0%,1h
14133,2,Leaky,3076,0,1,6,7,14.3%,45m
14133,1,[Mnard]BOO,3076,0,0,2,2,0.0%,31m
14150,3,raw,3075,1503,245,244,489,50.1%,11m
14150,3,stevill,3075,1326,141,114,255,55.3%,18m
14150,3,sYn,3075,1519,91,90,181,50.3%,29m
14150,3,yensfjori,3075,1117,87,63,150,58.0%,22m
14150,1,[MielGB]Borimir,3075,789,28,22,50,56.0%,41m
14150,3,IIIIIlllllII,3075,479,20,16,36,55.6%,38m
14150,3,sharp,3075,603,20,21,41,48.8%,8m
14150,3,Water,3075,395,15,15,30,50.0%,42m
14150,1,NobleGenesis,3075,302,12,5,17,70.6%,26m
14150,2,[NYOOM]BOSSMAMAMAN,3075,206,8,5,13,61.5%,18m
14150,1,IIBarcodeIII,3075,222,6,6,12,50.0%,35m
14150,1,[ZWars]Roboross,3075,153,5,8,13,38.5%,6m
14150,3,ChiefDankNug,3075,98,4,10,14,28.6%,4m
14150,3,LANDA,3075,0,2,4,6,33.3%,42m
14150,1,ShanknSpank,3075,0,0,1,1,0.0%,35m
14150,1,[SoSMD]Flauros,3075,0,0,1,1,0.0%,12m
14150,1,LDraGo,3075,0,0,1,1,0.0%,5m
14150,1,INDETECTABLE,3075,0,0,2,2,0.0%,26m
14168,3,ZXQ,3074,1085,267,238,505,52.9%,18m
14168,3,PewPewPew,3074,1577,111,99,210,52.9%,39m
14168,1,[FHM]BossMode,3074,1698,83,79,162,51.2%,10m
14168,3,[3CKSD3]RoldGold,3074,870,65,66,131,49.6%,7m
14168,3,Eternal,3074,786,59,54,113,52.2%,22m
14168,3,[dLife]RuSh,3074,400,14,27,41,34.1%,12m
14168,1,JarJarStinky,3074,344,13,12,25,52.0%,14m
14168,1,blacK,3074,348,11,11,22,50.0%,3m
14168,3,[Jokn]Pippin,3074,299,10,5,15,66.7%,27m
14168,3,Nightmare,3074,309,10,20,30,33.3%,5m
14168,1,Sivic,3074,199,8,4,12,66.7%,38m
14168,1,Cryz,3074,0,4,1,5,80.0%,2h
14168,1,NGCKDY,3074,70,3,3,6,50.0%,41m
14168,3,Dime,3074,0,1,1,2,50.0%,15m
14168,1,[Black0]xXDaganonXx,3074,0,0,1,1,0.0%,37m
14168,1,Crested,3074,0,0,2,2,0.0%,23m
14168,1,Bello,3074,0,0,2,2,0.0%,6m
14185,3,Kaiser,3073,1616,323,309,632,51.1%,42m
14185,3,sausage,3073,1608,136,129,265,51.3%,20m
14185,1,superhuman,3073,1633,107,91,198,54.0%,33m
14185,3,ork,3073,609,78,82,160,48.8%,27m
14185,3,RealVelour,3073,1230,68,66,134,50.7%,27m
14185,3,Gpremier,3073,1095,48,51,99,48.5%,14m
14185,3,Marinator,3073,658,24,24,48,50.0%,32m
14185,1,FudgyXD,3073,331,14,4,18,77.8%,20m
14185,3,[BalLzz]llllllllllll,3073,264,13,13,26,50.0%,22m
14185,1,[vacuum]Nick,3073,209,8,4,12,66.7%,37m
14185,1,Raiden,3073,122,5,4,9,55.6%,39m
14185,2,[BRAP]Xterminator,3073,90,5,5,10,50.0%,1h
14185,3,Tommy,3073,154,5,12,17,29.4%,6m
14185,3,Isu,3073,90,4,12,16,25.0%,21m
14185,1,ImmortalDude,3073,112,3,4,7,42.9%,33m
14185,3,Spazzola,3073,42,2,1,3,66.7%,48m
14185,1,OutCold,3073,0,2,3,5,40.0%,10m
14185,1,YIIQ,3073,0,1,0,1,100.0%,23m
14185,3,Aurelius,3073,96,1,2,3,33.3%,42m
14185,1,AntoineJayus,3073,40,1,2,3,33.3%,35m
14185,1,[UpeV]Prometeo,3073,42,1,5,6,16.7%,43m
14185,1,Wrest,3073,0,0,1,1,0.0%,4m
14185,1,[KeepPG]blurry,3073,0,0,3,3,0.0%,17m
14208,3,[JaMiT]Appoloin,3072,1580,260,256,516,50.4%,20m
14208,1,[An1me1]YouAreClown,3072,1604,163,127,290,56.2%,20m
14208,1,TiGuai,3072,1659,146,127,273,53.5%,33m
14208,3,[Connah]Lancelot,3072,530,79,74,153,51.6%,42m
14208,1,Chin,3072,784,76,72,148,51.4%,43m
14208,1,havoc,3072,1073,43,32,75,57.3%,37m
14208,3,[TwiLit]BlueJay,3072,428,24,32,56,42.9%,21m
14208,1,[JRT]Hikikomori,3072,665,22,18,40,55.0%,35m
14208,1,QuickHands,3072,487,19,11,30,63.3%,41m
14208,3,illuSiOn,3072,187,9,6,15,60.0%,10m
14208,1,AceOfWar,3072,128,4,0,4,100.0%,6m
14208,1,Piglet,3072,112,4,1,5,80.0%,24m
14208,3,BlueFlame,3072,90,3,8,11,27.3%,43m
14208,1,[M4G4]MoreThor,3072,0,2,1,3,66.7%,37m
14208,1,[PwT]Crazy,3072,0,0,1,1,0.0%,17m
14208,1,Alyatasy,3072,0,0,1,1,0.0%,25m
14208,3,Terran,3072,0,0,1,1,0.0%,1h
14208,1,StroWilD,3072,0,0,5,5,0.0%,31m
14226,3,Gorpdork,3071,1570,116,95,211,55.0%,24m
14226,3,Shroud,3071,1520,74,68,142,52.1%,30m
14226,1,WinStar,3071,1517,59,47,106,55.7%,27m
14226,1,ANDRENCIO,3071,1391,55,41,96,57.3%,34m
14226,1,[xLOLx]panchgringe,3071,1349,48,44,92,52.2%,8m
14226,1,StarBaby,3071,582,25,21,46,54.3%,29m
14226,3,BryanZ,3071,402,19,20,39,48.7%,6m
14226,1,Theriph,3071,630,19,21,40,47.5%,13m
14226,1,MKP,3071,226,18,13,31,58.1%,23m
14226,3,Pygy,3071,311,15,11,26,57.7%,15m
14226,1,MCMAP,3071,174,13,9,22,59.1%,13m
14226,3,Stryk,3071,236,7,10,17,41.2%,13m
14226,2,lllllllll,3071,165,5,1,6,83.3%,1h
14226,3,woorak,3071,30,5,3,8,62.5%,32m
14226,2,[xLCFC]ReeRee,3071,117,4,4,8,50.0%,3h
14226,1,AngelOfChaos,3071,114,3,1,4,75.0%,9m
14226,3,hzheng,3071,30,2,9,11,18.2%,39m
14226,1,Sovereign,3071,0,1,0,1,100.0%,29m
14226,1,Teberle,3071,0,1,0,1,100.0%,42m
14226,2,IMPROMPTU,3071,0,1,0,1,100.0%,46m
14226,1,RKN,3071,0,1,2,3,33.3%,43m
14226,1,domda,3071,0,0,2,2,0.0%,39m
14248,3,rumblefish,3070,1551,197,192,389,50.6%,19m
14248,1,OctavioMT,3070,1601,70,63,133,52.6%,29m
14248,1,Minerals,3070,1272,54,46,100,54.0%,4m
14248,3,lxky,3070,906,49,52,101,48.5%,39m
14248,1,Finn,3070,920,33,27,60,55.0%,10m
14248,1,[kØ]Huasozerlin,3070,990,33,30,63,52.4%,39m
14248,1,Fallout,3070,282,9,10,19,47.4%,20m
14248,1,kira,3070,284,9,10,19,47.4%,4m
14248,3,CrazyChicken,3070,151,7,4,11,63.6%,12m
14248,3,neub,3070,185,6,6,12,50.0%,20m
14248,2,NiceHat,3070,185,5,5,10,50.0%,46m
14248,3,Firefly,3070,97,4,2,6,66.7%,1h
14248,1,GunR,3070,76,4,5,9,44.4%,14m
14248,1,HDI,3070,76,3,3,6,50.0%,30m
14248,1,[PTHero]Ganondorf,3070,34,2,5,7,28.6%,32m
14248,1,Goldsmurf,3070,48,1,2,3,33.3%,3h
14248,1,[NM8]Koljac,3070,0,0,1,1,0.0%,14m
14248,1,YellowDemon,3070,0,0,1,1,0.0%,23m
14266,1,[SCBIA]Spidermanno,3069,1543,214,190,404,53.0%,20m
14266,3,[1E100]Niubility,3069,1566,135,129,264,51.1%,31m
14266,3,skim,3069,1349,55,59,114,48.2%,15m
14266,1,JUGGERNAUT,3069,691,50,53,103,48.5%,30m
14266,3,NaughtyOne,3069,935,39,41,80,48.8%,29m
14266,1,glacius,3069,721,29,22,51,56.9%,43m
14266,1,LEET,3069,646,28,27,55,50.9%,10m
14266,1,[IAT]Gorignac,3069,716,23,24,47,48.9%,25m
14266,1,[TgAg]Ghosted,3069,283,9,4,13,69.2%,18m
14266,1,Isabel,3069,143,6,6,12,50.0%,44m
14266,1,[TACTEC]awfulplayer,3069,97,4,3,7,57.1%,55m
14266,1,skywalkerZ,3069,38,2,3,5,40.0%,35m
14266,1,ElRauld,3069,0,0,1,1,0.0%,39m
14266,1,Nephira,3069,0,0,1,1,0.0%,25m
14280,1,Matt,3068,1618,82,77,159,51.6%,16m
14280,3,RaphaelGa,3068,1001,72,66,138,52.2%,18m
14280,3,[HØST]Alfafa,3068,729,49,45,94,52.1%,16m
14280,3,logix,3068,1038,44,46,90,48.9%,29m
14280,3,Sammysamsam,3068,499,18,21,39,46.2%,16m
14280,1,tempix,3068,395,14,9,23,60.9%,4m
14280,1,Lauroman,3068,313,10,5,15,66.7%,38m
14280,1,Vague,3068,338,10,8,18,55.6%,43m
14280,1,sWang,3068,40,2,0,2,100.0%,6m
14280,1,FearNot,3068,78,2,2,4,50.0%,27m
14280,2,[LIKAN]GeibelSimeon,3068,0,1,0,1,100.0%,57m
14280,3,[xLgNx]Iron,3068,30,1,8,9,11.1%,27m
14280,3,SirWhiskers,3068,30,1,9,10,10.0%,44m
14280,2,OnLYImMoRTaL,3068,0,0,1,1,0.0%,3h
14280,1,GuineaPig,3068,0,0,1,1,0.0%,39m
14280,1,JoJo,3068,0,0,1,1,0.0%,13m
14280,1,Striker,3068,0,0,2,2,0.0%,33m
14280,3,Skoda,3068,0,0,6,6,0.0%,13m
14298,3,BuffTerranPl,3067,1493,98,97,195,50.3%,5m
14298,3,JoeyHands,3067,1527,78,84,162,48.1%,11m
14298,1,[BoAVN]tumulu,3067,821,60,45,105,57.1%,13m
14298,3,PlayItLeo,3067,854,34,31,65,52.3%,14m
14298,1,[JJPOOR]UzziDarwesh,3067,709,28,21,49,57.1%,34m
14298,1,[BB]Demosthenes,3067,400,15,11,26,57.7%,36m
14298,3,[GGTOEZ]Microjackson,3067,328,13,15,28,46.4%,44m
14298,3,[XOLDX]Hillbilly,3067,265,11,10,21,52.4%,27m
14298,1,Sinchikary,3067,105,7,10,17,41.2%,27m
14298,1,CcyL,3067,158,5,6,11,45.5%,35m
14298,1,[xNG4x]Knaves,3067,122,3,0,3,100.0%,35m
14298,1,LionS,3067,89,1,1,2,50.0%,27m
14298,1,NpHart,3067,42,1,4,5,20.0%,9m
14298,1,DeGen,3067,0,1,5,6,16.7%,24m
14298,2,CAVEMAN,3067,0,1,7,8,12.5%,1h
14298,1,[JJANGS]Zaki,3067,0,0,1,1,0.0%,35m
14314,1,Darknight,3066,1752,227,199,426,53.3%,12m
14314,3,[DarkAG]Rinez,3066,1471,202,197,399,50.6%,26m
14314,3,[MDLP]scali,3066,1599,185,166,351,52.7%,37m
14314,3,[QOSQO]FoXx,3066,851,127,115,242,52.5%,42m
14314,1,Mictlan,3066,1686,124,112,236,52.5%,31m
14314,3,Stingººpac,3066,1580,124,124,248,50.0%,20m
14314,1,XiajiaBang,3066,991,70,52,122,57.4%,4m
14314,3,[ConFed]kaitorin,3066,1372,66,65,131,50.4%,23m
14314,3,MiLoMaNDRaKe,3066,658,22,32,54,40.7%,40m
14314,1,ErickSumire,3066,576,17,15,32,53.1%,33m
14314,3,Pibkabu,3066,429,14,15,29,48.3%,3m
14314,1,kami,3066,133,12,16,28,42.9%,18m
14314,3,[ZTemps]Noxnake,3066,315,11,13,24,45.8%,41m
14314,3,nicco,3066,229,9,8,17,52.9%,15m
14314,1,GarbalageMan,3066,228,7,7,14,50.0%,18m
14314,1,panda,3066,128,4,5,9,44.4%,4m
14314,1,JavaSelenium,3066,34,2,2,4,50.0%,39m
14314,1,IAmNoob,3066,0,1,0,1,100.0%,24m
14314,1,lostmarbles,3066,40,1,1,2,50.0%,23m
14314,1,HankoBrat,3066,36,1,2,3,33.3%,16m
14314,3,Zooko,3066,0,0,1,1,0.0%,11m
14314,3,[αB]SniperSC,3066,0,0,1,1,0.0%,34m
14336,1,Ratel,3065,1429,162,148,310,52.3%,11m
14336,3,Meadowlark,3065,849,152,150,302,50.3%,33m
14336,1,Laguna,3065,1676,103,81,184,56.0%,36m
14336,3,Maximoe,3065,872,102,108,210,48.6%,3m
14336,3,jbg,3065,1147,72,82,154,46.8%,16m
14336,1,[Cryptc]SevenLions,3065,1080,61,22,83,73.5%,23m
14336,1,[uKnR]Fullmetal,3065,917,42,27,69,60.9%,26m
14336,3,nmly,3065,875,36,48,84,42.9%,20m
14336,1,[αXLa]Eintrag,3065,461,15,13,28,53.6%,21m
14336,1,[nnnn]Enrique,3065,262,8,9,17,47.1%,29m
14336,1,soniiC,3065,166,4,1,5,80.0%,29m
14336,3,WarRier,3065,0,4,3,7,57.1%,3m
14336,1,[Macac0]Nirvanero,3065,0,0,1,1,0.0%,27m
14336,1,Yam,3065,0,0,2,2,0.0%,33m
14350,3,MMA,3064,1134,249,237,486,51.2%,4m
14350,3,BleedingME,3064,1512,128,124,252,50.8%,23m
14350,1,puzzledazn,3064,1624,96,78,174,55.2%,23m
14350,3,[N0F34R]JackDawg,3064,1146,55,56,111,49.5%,5m
14350,1,Omega,3064,546,23,11,34,67.6%,13m
14350,3,Samtehman,3064,644,22,29,51,43.1%,7m
14350,1,reQuiem,3064,412,16,8,24,66.7%,32m
14350,3,Jehudda,3064,96,15,12,27,55.6%,16m
14350,1,BusiGoose,3064,512,15,12,27,55.6%,4m
14350,1,ASDF,3064,228,13,3,16,81.2%,38m
14350,1,[NrFms]BadBoy,3064,256,11,15,26,42.3%,41m
14350,1,[xTQc]MatS,3064,346,10,14,24,41.7%,23m
14350,1,Barcode,3064,193,6,1,7,85.7%,26m
14350,1,[umoron]llllllllllll,3064,160,4,1,5,80.0%,4m
14350,1,[JMX]JAAM,3064,0,0,2,2,0.0%,4m
14350,1,Dorijohn,3064,0,0,2,2,0.0%,42m
14350,1,Mercer,3064,0,0,5,5,0.0%,29m
14367,3,mota,3063,580,110,105,215,51.2%,5m
14367,3,Rowan,3063,1561,77,75,152,50.7%,40m
14367,1,adug,3063,1054,58,53,111,52.3%,24m
14367,1,Kerrigan,3063,591,28,13,41,68.3%,38m
14367,1,JoeMufferaw,3063,412,22,25,47,46.8%,35m
14367,1,[Zorron]rodrox,3063,593,19,16,35,54.3%,39m
14367,2,Majora,3063,240,10,10,20,50.0%,27m
14367,3,nurseboy,3063,160,6,4,10,60.0%,6m
14367,1,Acai,3063,141,4,0,4,100.0%,12m
14367,3,Cayito,3063,0,4,2,6,66.7%,6m
14367,1,Chevic,3063,142,3,2,5,60.0%,32m
14367,3,Emile,3063,0,3,3,6,50.0%,39m
14367,1,Jarebear,3063,92,2,0,2,100.0%,31m
14367,1,BestFoodTown,3063,0,2,2,4,50.0%,27m
14367,3,[VlPeRz]Tree,3063,30,1,7,8,12.5%,31m
14367,1,[void44]Lilac,3063,0,0,1,1,0.0%,12m
14383,1,jorgeneo,3062,1736,300,275,575,52.2%,29m
14383,3,Spherion,3062,872,38,31,69,55.1%,14m
14383,1,TheNinja,3062,861,34,26,60,56.7%,13m
14383,1,[spinas]hunterxlolis,3062,772,25,23,48,52.1%,30m
14383,3,Knowva,3062,481,21,25,46,45.7%,17m
14383,1,Aelearian,3062,241,14,13,27,51.9%,36m
14383,1,Yompi,3062,357,10,8,18,55.6%,38m
14383,1,TheInzanity,3062,242,8,3,11,72.7%,16m
14383,1,Turbo,3062,59,3,1,4,75.0%,6m
14383,1,cato,3062,78,3,1,4,75.0%,38m
14383,1,MarcosR,3062,110,3,4,7,42.9%,35m
14383,1,Goliath,3062,82,2,6,8,25.0%,12m
14383,1,Neurodrive,3062,0,1,0,1,100.0%,8m
14383,2,[MureoW]Kellbor,3062,0,1,2,3,33.3%,36m
14383,1,Tropiczz,3062,0,0,1,1,0.0%,36m
14383,1,raynor,3062,0,0,3,3,0.0%,14m
14383,3,Shrub,3062,0,0,6,6,0.0%,25m
14400,3,venividivici,3061,1558,252,253,505,49.9%,28m
14400,3,Oldman,3061,1484,156,160,316,49.4%,33m
14400,1,ggyo,3061,1681,97,106,203,47.8%,35m
14400,1,mauro,3061,1240,46,41,87,52.9%,26m
14400,1,BackFromBan,3061,898,43,36,79,54.4%,9m
14400,1,[CPiece]Bill,3061,655,32,23,55,58.2%,37m
14400,1,RippnNTerran,3061,546,27,21,48,56.2%,10m
14400,3,[xF1RE]PRETORIANO,3061,728,27,26,53,50.9%,10m
14400,1,GLYDE,3061,492,16,11,27,59.3%,31m
14400,1,Elrohir,3061,419,15,9,24,62.5%,4m
14400,1,Duke,3061,261,11,10,21,52.4%,12m
14400,3,Lovelyrita,3061,26,9,14,23,39.1%,37m
14400,1,[ASC1]USSR,3061,238,7,6,13,53.8%,17m
14400,1,Depression,3061,154,5,3,8,62.5%,35m
14400,2,DarkGoYeR,3061,0,1,0,1,100.0%,16m
14400,1,[dK]EMPItToWinIt,3061,89,1,1,2,50.0%,27m
14400,1,[LAZRKT]waratuman,3061,0,0,1,1,0.0%,20m
14400,1,[SyLx]Diouz,3061,0,0,1,1,0.0%,14m
14418,1,Divine,3060,1084,76,27,103,73.8%,24m
14418,3,Roseia,3060,1375,69,65,134,51.5%,32m
14418,3,DAF,3060,684,69,74,143,48.3%,17m
14418,3,[NPhasA]kuppo,3060,1236,51,55,106,48.1%,24m
14418,1,[NPhase]PrbeLfeMatta,3060,759,35,18,53,66.0%,16m
14418,1,MacroKING,3060,592,31,22,53,58.5%,30m
14418,1,Zeta,3060,688,27,19,46,58.7%,24m
14418,1,Kyren,3060,623,24,16,40,60.0%,33m
14418,1,[SFUSC]MingA,3060,327,15,9,24,62.5%,37m
14418,1,Tails,3060,430,11,10,21,52.4%,6m
14418,1,daftcraft,3060,285,9,5,14,64.3%,21m
14418,3,OGplayer,3060,120,8,6,14,57.1%,30m
14418,1,vikinghammer,3060,274,8,9,17,47.1%,39m
14418,1,Prafes,3060,202,7,4,11,63.6%,29m
14418,3,ZacAiur,3060,161,4,3,7,57.1%,2h
14418,1,BingoBlaster,3060,122,2,2,4,50.0%,20m
14418,1,TurdSandwich,3060,0,0,1,1,0.0%,12m
14418,2,McLovin,3060,0,0,1,1,0.0%,1h
14436,3,[GØSU]ULIKEIT,3059,1574,161,160,321,50.2%,5m
14436,3,IsrOcVce,3059,1298,136,135,271,50.2%,13m
14436,3,Trowabarton,3059,1490,119,120,239,49.8%,7m
14436,3,PvtPile,3059,1040,117,118,235,49.8%,42m
14436,3,[Hyrule]Chucry,3059,959,69,78,147,46.9%,10m
14436,1,Fizzle,3059,1425,66,53,119,55.5%,41m
14436,1,Alexandros,3059,1226,61,47,108,56.5%,39m
14436,3,[HØST]Pletz,3059,976,59,53,112,52.7%,22m
14436,1,[9thAve]ShoeBaD,3059,1035,43,35,78,55.1%,33m
14436,1,Knowing,3059,369,20,10,30,66.7%,27m
14436,1,gameface,3059,634,20,24,44,45.5%,36m
14436,1,Murphy,3059,372,18,5,23,78.3%,27m
14436,1,jaydubzsc,3059,285,11,6,17,64.7%,24m
14436,1,SuperBurger,3059,303,11,9,20,55.0%,35m
14436,3,Random,3059,356,11,32,43,25.6%,5m
14436,1,Brian,3059,253,7,4,11,63.6%,38m
14436,1,Serenaall,3059,40,5,2,7,71.4%,36m
14436,1,WhoAmI,3059,166,4,3,7,57.1%,18m
14436,1,[GRAPE]BarakaFlocka,3059,34,4,4,8,50.0%,39m
14436,2,Gandalf,3059,90,3,4,7,42.9%,3h
14436,1,[TRASHH]PukimakCibai,3059,91,2,0,2,100.0%,25m
14436,1,GoFMidoNA,3059,32,2,1,3,66.7%,27m
14436,1,KinguvcheeZL,3059,0,1,2,3,33.3%,29m
14436,1,Keidrox,3059,0,0,1,1,0.0%,29m
14436,1,RaMM,3059,0,0,1,1,0.0%,1h
14436,1,[prIK]trooper,3059,0,0,2,2,0.0%,30m
14462,1,Yair,3058,1747,257,261,518,49.6%,27m
14462,1,[ZTemp]Whiskers,3058,810,134,111,245,54.7%,25m
14462,3,JoMamma,3058,783,64,63,127,50.4%,43m
14462,1,Bebashis,3058,744,38,29,67,56.7%,14m
14462,1,[pXo]GOJIRA,3058,577,25,15,40,62.5%,21m
14462,1,[JA]Jaminator,3058,671,23,25,48,47.9%,29m
14462,1,Noobz,3058,454,14,12,26,53.8%,19m
14462,1,Bushido,3058,434,12,13,25,48.0%,35m
14462,1,light,3058,0,3,2,5,60.0%,20m
14462,1,[SsaYnS]Anubis,3058,95,2,2,4,50.0%,16m
14462,1,nOnsa,3058,72,2,6,8,25.0%,24m
14462,1,[DHZAcD]LeonardoKara,3058,0,0,2,2,0.0%,10m
14462,1,Pieman,3058,0,0,3,3,0.0%,39m
14475,3,Timoncito,3057,1545,307,290,597,51.4%,10m
14475,3,marco,3057,1464,153,132,285,53.7%,15m
14475,3,JUNITSUKA,3057,655,137,123,260,52.7%,13m
14475,3,twdnewh,3057,1583,120,114,234,51.3%,23m
14475,3,SPARTAKO,3057,1486,114,110,224,50.9%,12m
14475,1,Raynor,3057,1564,69,56,125,55.2%,36m
14475,3,[GreeDy]JteCreme,3057,1278,56,44,100,56.0%,24m
14475,1,Bloodshedy,3057,915,56,55,111,50.5%,16m
14475,3,Fernz,3057,552,26,24,50,52.0%,42m
14475,1,[ValidG]Blitz,3057,743,25,22,47,53.2%,43m
14475,1,QueenBean,3057,259,24,15,39,61.5%,10m
14475,3,Minhinks,3057,282,9,19,28,32.1%,15m
14475,1,poYo,3057,205,8,3,11,72.7%,37m
14475,1,[AKPZ]Arendal,3057,278,7,5,12,58.3%,27m
14475,1,[WSCSC2]Zhueeee,3057,208,7,6,13,53.8%,30m
14475,1,KuRiCobbY,3057,120,4,3,7,57.1%,6m
14475,2,Kush,3057,0,4,3,7,57.1%,3h
14475,1,Necrosis,3057,0,3,1,4,75.0%,2h
14475,3,you,3057,0,3,2,5,60.0%,20m
14475,1,Jello,3057,160,3,2,5,60.0%,14m
14475,1,GachaMaster,3057,112,2,1,3,66.7%,26m
14475,1,Evertale,3057,46,2,3,5,40.0%,3h
14475,1,[TgAg]GameMaster,3057,0,0,3,3,0.0%,39m
14475,3,[AbcCo]FinnyInLove,3057,0,0,3,3,0.0%,15m
14475,3,Sheep,3057,0,0,7,7,0.0%,7m
14500,1,Jenga,3056,1631,64,57,121,52.9%,27m
14500,3,[TPGGXD]DARONSUE,3056,819,55,52,107,51.4%,14m
14500,1,Alpha,3056,678,46,28,74,62.2%,41m
14500,3,Jato,3056,133,30,37,67,44.8%,16m
14500,1,AhnYuJin,3056,778,24,29,53,45.3%,36m
14500,3,TReXXX,3056,378,18,26,44,40.9%,42m
14500,3,IIIIIIIIIII,3056,404,17,20,37,45.9%,8m
14500,3,Nerdking,3056,376,15,6,21,71.4%,12m
14500,1,[JRB]Henri,3056,317,11,11,22,50.0%,4m
14500,1,DarkTemplar,3056,220,6,2,8,75.0%,26m
14500,1,[8kPLUS]Moradagh,3056,170,6,7,13,46.2%,35m
14500,1,Lord,3056,130,4,0,4,100.0%,11m
14500,3,DragonWarior,3056,0,4,1,5,80.0%,31m
14500,1,McBreez,3056,112,4,2,6,66.7%,4m
14500,1,Doratum,3056,0,1,0,1,100.0%,34m
14500,3,Cullinan,3056,0,1,0,1,100.0%,12m
14500,1,AVK,3056,42,1,2,3,33.3%,13m
14500,1,[CHARR]Tmoy,3056,0,1,5,6,16.7%,24m
14500,1,[ØFoxF2]Moxterr,3056,40,1,5,6,16.7%,43m
14500,1,Envy,3056,0,0,5,5,0.0%,34m
14520,3,[DRKAPP]BioChungus,3055,888,424,419,843,50.3%,44m
14520,3,Fate,3055,1490,255,259,514,49.6%,33m
14520,3,[SSCl]dethpony,3055,1545,115,107,222,51.8%,23m
14520,3,[bm4Fun]FullToiletX,3055,1443,71,72,143,49.7%,27m
14520,3,Zaur,3055,1439,55,57,112,49.1%,34m
14520,3,Graphite,3055,510,53,47,100,53.0%,5m
14520,3,[CHARR]CHARMANDER,3055,472,23,17,40,57.5%,19m
14520,1,Skateboard,3055,458,18,11,29,62.1%,43m
14520,1,Faust,3055,265,9,8,17,52.9%,35m
14520,2,DeadlyGrub,3055,208,8,5,13,61.5%,2h
14520,1,DukeTougo,3055,118,6,5,11,54.5%,6m
14520,1,[Tarran]HighRoller,3055,211,5,3,8,62.5%,33m
14520,3,wunani,3055,201,5,10,15,33.3%,14m
14520,3,[iTE]KingKO,3055,156,5,12,17,29.4%,5m
14520,1,[0sD]zeroTWOhero,3055,0,3,2,5,60.0%,33m
14520,1,Realphil,3055,118,3,6,9,33.3%,26m
14520,3,Rhodoknight,3055,0,2,4,6,33.3%,3h
14520,2,[PVZ5o]CourtGentry,3055,112,2,7,9,22.2%,34m
14520,1,Glorious,3055,42,1,5,6,16.7%,16m
14520,1,Goose,3055,0,0,1,1,0.0%,3h
14540,3,Slayer,3054,1580,187,188,375,49.9%,3m
14540,1,[PKMSSS]RAICHU,3054,1622,64,55,119,53.8%,23m
14540,1,[ValidG]Wendingo,3054,1193,40,41,81,49.4%,38m
14540,3,ApeIsland,3054,838,35,35,70,50.0%,16m
14540,3,[TCool]Blinky,3054,332,21,23,44,47.7%,32m
14540,1,Theawesomest,3054,604,18,19,37,48.6%,4m
14540,1,Anachronism,3054,389,12,11,23,52.2%,12m
14540,1,[220ms]Mightily,3054,361,11,7,18,61.1%,12m
14540,3,dikkkkkkkkkk,3054,97,6,1,7,85.7%,1h
14540,1,[Whaaaa]Koluuthar,3054,0,5,0,5,100.0%,33m
14540,3,CaptainUP,3054,94,4,13,17,23.5%,33m
14540,1,ToysforTrots,3054,123,3,0,3,100.0%,19m
14540,1,Moonstuck,3054,118,3,4,7,42.9%,38m
14540,1,TomNook,3054,0,1,0,1,100.0%,25m
14540,2,Chip,3054,0,1,1,2,50.0%,46m
14540,1,Gamma,3054,0,0,1,1,0.0%,12m
14540,1,[Cryptc]TurretOne,3054,0,0,1,1,0.0%,20m
14540,3,VIGOS,3054,0,0,1,1,0.0%,1h
14540,1,Reaper,3054,0,0,5,5,0.0%,10m
14559,1,JChen,3053,1744,181,175,356,50.8%,25m
14559,1,[KrAce]cris,3053,1149,80,53,133,60.2%,6m
14559,1,lennytheboi,3053,1029,37,34,71,52.1%,32m
14559,3,MARINEKING,3053,121,4,3,7,57.1%,6m
14559,3,[dede]ayf,3053,122,4,12,16,25.0%,13m
14559,1,ArKain,3053,40,2,2,4,50.0%,9m
14559,1,ThatFailure,3053,80,2,5,7,28.6%,25m
14559,1,Brotoss,3053,0,1,0,1,100.0%,29m
14559,1,Geraning,3053,0,0,1,1,0.0%,23m
14559,3,JPie,3053,0,0,1,1,0.0%,13m
14559,2,Alfa,3053,0,0,3,3,0.0%,3h
14570,3,GeorgeSoros,3052,1365,89,81,170,52.4%,18m
14570,1,Ryo,3052,908,45,38,83,54.2%,30m
14570,3,[αXLa]terreviento,3052,762,35,38,73,47.9%,6m
14570,1,ACE,3052,298,23,18,41,56.1%,36m
14570,1,[WNTRLY]aRsony,3052,327,19,4,23,82.6%,32m
14570,1,Dex,3052,431,17,13,30,56.7%,12m
14570,3,josse,3052,244,11,8,19,57.9%,26m
14570,1,goldfever,3052,306,10,7,17,58.8%,33m
14570,2,TheGiantham,3052,191,8,4,12,66.7%,46m
14570,3,alantothe,3052,207,6,10,16,37.5%,40m
14570,3,[TGCITU]HAMMERSMASH,3052,154,6,14,20,30.0%,39m
14570,1,AppleJax,3052,154,4,6,10,40.0%,27m
14570,1,Tediathan,3052,126,3,5,8,37.5%,21m
14570,1,[DRFS]Dysutopia,3052,40,3,5,8,37.5%,35m
14570,3,DRoxxy,3052,42,2,4,6,33.3%,46m
14570,1,[PuStLe]Chilenazo,3052,82,2,5,7,28.6%,14m
14570,1,[NLTN]Duff,3052,34,1,2,3,33.3%,27m
14570,1,DavidO,3052,0,0,1,1,0.0%,23m
14570,1,[SmokeH]Leo,3052,0,0,6,6,0.0%,38m
14589,3,Jonas,3051,1109,92,91,183,50.3%,5m
14589,1,Walker,3051,1343,60,38,98,61.2%,27m
14589,3,[TUTTER]Cubra,3051,913,56,60,116,48.3%,17m
14589,1,[Scamps]Krizon,3051,1005,55,52,107,51.4%,35m
14589,3,DragonHunter,3051,1062,48,55,103,46.6%,13m
14589,1,Akkaidian,3051,1294,46,50,96,47.9%,43m
14589,1,ToastProxy,3051,676,25,23,48,52.1%,34m
14589,1,atom,3051,435,18,8,26,69.2%,30m
14589,1,sog,3051,384,14,9,23,60.9%,14m
14589,1,Kree,3051,428,13,14,27,48.1%,31m
14589,1,GunnerStahl,3051,171,8,4,12,66.7%,36m
14589,1,[EvilGC]Zeratul,3051,290,8,9,17,47.1%,42m
14589,3,MarineKing,3051,60,6,4,10,60.0%,36m
14589,3,TheSchafes,3051,141,5,4,9,55.6%,21m
14589,1,[OndaVT]Jorm,3051,110,4,2,6,66.7%,38m
14589,3,josephlevita,3051,90,4,10,14,28.6%,10m
14589,1,[PiGPan]Singularity,3051,42,2,5,7,28.6%,27m
14589,3,LovAge,3051,30,2,8,10,20.0%,23m
14589,1,jjjjjjjjj,3051,0,1,0,1,100.0%,30m
14589,1,Speedracer,3051,30,1,1,2,50.0%,41m
14589,1,ZetZu,3051,40,1,5,6,16.7%,6m
14589,1,Deity,3051,0,0,2,2,0.0%,27m
14611,3,SizzleChest,3050,1652,417,419,836,49.9%,39m
14611,1,TuéTué,3050,1268,167,154,321,52.0%,42m
14611,3,Poiskail,3050,839,113,113,226,50.0%,32m
14611,1,NestorHead,3050,1532,56,53,109,51.4%,29m
14611,3,[ValidG]oldparr,3050,1383,56,57,113,49.6%,36m
14611,1,GenadiBukin,3050,963,49,49,98,50.0%,6m
14611,3,[INF101]AmbroseMX,3050,512,36,45,81,44.4%,42m
14611,1,Zazaki,3050,616,35,25,60,58.3%,34m
14611,1,EZZ,3050,362,30,20,50,60.0%,43m
14611,1,FLaSHy,3050,455,19,13,32,59.4%,4m
14611,1,forceTen,3050,165,11,7,18,61.1%,35m
14611,3,QuietMind,3050,279,9,6,15,60.0%,13m
14611,1,Dadzarg,3050,265,9,11,20,45.0%,27m
14611,1,Kui,3050,274,8,7,15,53.3%,37m
14611,1,[ZEClan]DreamGhost,3050,172,6,4,10,60.0%,26m
14611,1,[Tthcn]Qzed,3050,176,6,12,18,33.3%,26m
14611,1,DIANE,3050,74,3,1,4,75.0%,16m
14611,1,Jarf,3050,0,3,2,5,60.0%,10m
14611,1,JustAnSCV,3050,56,3,3,6,50.0%,36m
14611,1,[IMIron]jaNOS,3050,76,2,3,5,40.0%,35m
14611,3,kimcheese,3050,0,2,5,7,28.6%,10m
14611,1,[AD3C]rathmA,3050,0,1,0,1,100.0%,18m
14611,1,[InGt]EatMyDT,3050,0,1,4,5,20.0%,12m
14611,1,zuGZWAng,3050,0,0,1,1,0.0%,9m
14611,1,[6MR6]MasterRines,3050,0,0,1,1,0.0%,6m
14636,3,behaviorvr,3049,1521,170,162,332,51.2%,42m
14636,3,BakedLizard,3049,1216,125,111,236,53.0%,13m
14636,1,Galaxy,3049,1604,78,65,143,54.5%,16m
14636,1,workwork,3049,1710,69,63,132,52.3%,10m
14636,1,GarouxZx,3049,1314,55,49,104,52.9%,35m
14636,3,BlueBear,3049,716,42,46,88,47.7%,11m
14636,3,[LPAq]alexlesuper,3049,440,16,23,39,41.0%,22m
14636,1,BlackStar,3049,271,12,7,19,63.2%,11m
14636,1,[SsaYnS]kanstar,3049,207,7,5,12,58.3%,41m
14636,1,RoadDoc,3049,127,5,1,6,83.3%,5m
14636,1,[BlTEL]sirCRS,3049,146,5,3,8,62.5%,13m
14636,1,IIIIIIIIIIII,3049,121,4,0,4,100.0%,12m
14636,3,Zaswedyg,3049,94,4,9,13,30.8%,36m
14636,1,[αB]Duckpool,3049,74,3,2,5,60.0%,44m
14636,1,James,3049,70,2,4,6,33.3%,4m
14651,3,[LQV]Duster,3048,1584,922,903,1825,50.5%,28m
14651,1,specialed,3048,1739,318,314,632,50.3%,7m
14651,1,Abridged,3048,372,23,20,43,53.5%,13m
14651,1,[NPhasA]Tokein,3048,290,13,4,17,76.5%,16m
14651,1,Brook,3048,465,13,16,29,44.8%,4m
14651,3,GiftedRay,3048,203,6,9,15,40.0%,5m
14651,1,[FMST]Potti,3048,126,5,10,15,33.3%,17m
14651,1,[mrtise]NIGGRFLEX,3048,48,4,2,6,66.7%,3h
14651,1,FlockaFlame,3048,110,4,4,8,50.0%,25m
14651,1,[GØSU]rainque,3048,0,3,2,5,60.0%,36m
14651,1,CaptainYU,3048,38,3,4,7,42.9%,12m
14651,1,[DarkAG]AeroSoap,3048,82,2,5,7,28.6%,31m
14651,2,llllllllllll,3048,0,0,1,1,0.0%,3h
14651,1,[4LOBOS]Anibal,3048,0,0,2,2,0.0%,38m
14665,1,Roakin,3047,1553,95,71,166,57.2%,26m
14665,1,MAXPAYNE,3047,1534,74,36,110,67.3%,23m
14665,1,AMADEUS,3047,1255,74,62,136,54.4%,33m
14665,1,DameDaNe,3047,1033,45,30,75,60.0%,4m
14665,1,[FU2]MrJack,3047,933,39,31,70,55.7%,43m
14665,3,[Deathn]DestinyKid,3047,973,35,39,74,47.3%,28m
14665,1,[HØST]hugobw,3047,757,29,25,54,53.7%,6m
14665,1,CrckdRiceBwl,3047,742,27,19,46,58.7%,14m
14665,3,IIIlllI,3047,569,25,20,45,55.6%,35m
14665,3,[M1]Gekko,3047,458,16,17,33,48.5%,43m
14665,2,NotPregnant,3047,158,8,3,11,72.7%,1h
14665,1,[Pls]ThorCL,3047,252,7,7,14,50.0%,16m
14665,1,KimchiNoob,3047,0,4,2,6,66.7%,32m
14665,2,Mike,3047,94,2,0,2,100.0%,60m
14665,1,HeroScv,3047,89,2,0,2,100.0%,14m
14665,1,Shocks,3047,0,2,2,4,50.0%,3h
14665,1,[HOBOZ]DezoForezo,3047,0,0,1,1,0.0%,11m
14665,1,danzel,3047,0,0,1,1,0.0%,39m
14665,1,Razor,3047,0,0,2,2,0.0%,32m
14684,3,FUTECH,3046,1452,266,251,517,51.5%,44m
14684,3,[EtrOy]Ironman,3046,1608,208,217,425,48.9%,32m
14684,3,[LunchZ]Lunchbox,3046,1069,49,48,97,50.5%,7m
14684,1,dyto,3046,867,35,25,60,58.3%,14m
14684,1,Nults,3046,584,33,31,64,51.6%,13m
14684,1,VeNoM,3046,522,18,17,35,51.4%,15m
14684,3,fhou,3046,436,16,23,39,41.0%,13m
14684,1,quetzal,3046,235,13,10,23,56.5%,30m
14684,1,Avocado,3046,379,13,11,24,54.2%,12m
14684,3,dmoo,3046,122,6,2,8,75.0%,56m
14684,3,danny,3046,190,6,14,20,30.0%,28m
14684,1,CASTTROY,3046,0,5,0,5,100.0%,14m
14684,3,TwistedTea,3046,121,5,3,8,62.5%,2h
14684,1,[GNGT]fluentmonkey,3046,30,4,3,7,57.1%,12m
14684,1,[TXOP]CorvoIIV,3046,193,4,3,7,57.1%,26m
14684,3,Dune,3046,121,2,1,3,66.7%,1h
14684,1,wellness,3046,80,2,3,5,40.0%,35m
14684,1,[SnCity]TMan,3046,0,1,2,3,33.3%,30m
14684,1,[uWg]KhangBang,3046,0,0,1,1,0.0%,42m
14684,1,IIIIIIIIIIII,3046,0,0,2,2,0.0%,4m
14684,1,[JISL]Fenrir,3046,0,0,4,4,0.0%,23m
14684,1,GoldenArmada,3046,73,0,4,4,0.0%,9m
14684,1,Wempy,3046,0,0,5,5,0.0%,34m
14707,3,Mastacheff,3045,1446,200,206,406,49.3%,40m
14707,3,[M1V1P]Immortal,3045,1577,148,125,273,54.2%,22m
14707,1,Speedysyed,3045,1723,135,128,263,51.3%,38m
14707,3,RonaldoJr,3045,982,121,120,241,50.2%,14m
14707,1,alexF,3045,1586,103,102,205,50.2%,4m
14707,3,Veigar,3045,1530,71,67,138,51.4%,13m
14707,1,Starchild,3045,898,40,21,61,65.6%,23m
14707,3,Anarchy,3045,744,33,26,59,55.9%,24m
14707,3,MOIO,3045,712,27,27,54,50.0%,14m
14707,3,[ACGI]Cantshoot,3045,748,23,39,62,37.1%,27m
14707,1,[IL1]diddi,3045,228,7,8,15,46.7%,20m
14707,3,[REIKI]NonMeltIce,3045,178,7,9,16,43.8%,38m
14707,3,[GLG]FiNiTE,3045,216,6,8,14,42.9%,6m
14707,1,[WWC]Skellen,3045,173,5,3,8,62.5%,20m
14707,1,Deadking,3045,143,5,3,8,62.5%,24m
14707,3,Koast,3045,192,5,10,15,33.3%,40m
14707,3,[TILL]ThisIstheWAY,3045,46,3,3,6,50.0%,55m
14707,1,[VlPeRz]SkullStew,3045,124,3,7,10,30.0%,33m
14707,3,Air,3045,84,2,8,10,20.0%,54m
14707,1,Trumpy,3045,30,1,3,4,25.0%,7m
14707,1,worstscplaya,3045,0,0,1,1,0.0%,12m
14707,1,Red,3045,0,0,2,2,0.0%,20m
14729,1,LopezTheHero,3044,1545,209,193,402,52.0%,12m
14729,1,DREDAY,3044,1722,87,75,162,53.7%,34m
14729,1,kendo,3044,1362,71,63,134,53.0%,20m
14729,1,Dan,3044,275,68,47,115,59.1%,4m
14729,1,DrCheng,3044,723,41,13,54,75.9%,33m
14729,3,GVIA,3044,988,40,42,82,48.8%,16m
14729,1,NastyFart,3044,635,29,14,43,67.4%,20m
14729,1,Deymar,3044,675,29,16,45,64.4%,10m
14729,1,xSvDGen,3044,303,11,5,16,68.8%,25m
14729,1,SCVrush,3044,196,10,1,11,90.9%,38m
14729,3,Mars,3044,145,6,2,8,75.0%,3h
14729,3,OuiPapi,3044,139,6,4,10,60.0%,58m
14729,1,Hoplita,3044,275,6,6,12,50.0%,38m
14729,1,[NLTN]rip,3044,142,3,1,4,75.0%,34m
14729,3,sKout,3044,97,2,0,2,100.0%,3h
14729,1,MedioToss,3044,0,1,0,1,100.0%,39m
14729,1,blackjedi,3044,0,1,0,1,100.0%,43m
14729,1,Oldtimer,3044,0,1,0,1,100.0%,21m
14729,1,Nessquik,3044,89,1,1,2,50.0%,36m
14729,1,[Squidy]RavinBailiff,3044,36,1,2,3,33.3%,27m
14729,3,[MWaves]Jimbro,3044,0,1,6,7,14.3%,5m
14729,3,MadMentat,3044,30,1,8,9,11.1%,19m
14729,1,Ibaka,3044,0,0,1,1,0.0%,10m
14729,1,canalla,3044,0,0,2,2,0.0%,27m
14729,1,FecalFeast,3044,0,0,3,3,0.0%,39m
14729,3,[FFAA]KINGWAR,3044,0,0,3,3,0.0%,23m
14729,1,Kreeper,3044,0,0,4,4,0.0%,14m
14756,3,MAYCOL,3043,1170,321,274,595,53.9%,18m
14756,3,DuckOfDeath,3043,1531,253,255,508,49.8%,39m
14756,3,[EtrOy]hairyewok,3043,1427,231,229,460,50.2%,13m
14756,3,CrediNation,3043,1522,163,165,328,49.7%,37m
14756,3,Alessfenix,3043,1569,105,100,205,51.2%,24m
14756,1,[kermit]Kermitdfrog,3043,1656,77,73,150,51.3%,20m
14756,3,Bighentai,3043,848,74,67,141,52.5%,29m
14756,3,ChuRups,3043,1384,59,54,113,52.2%,11m
14756,1,HoboRaynor,3043,1313,54,45,99,54.5%,13m
14756,3,[BigBrd]hazelnut,3043,560,51,39,90,56.7%,13m
14756,1,[sk3tch]Richarddaddy,3043,926,48,26,74,64.9%,24m
14756,3,[Tensor]sLing,3043,636,41,37,78,52.6%,35m
14756,1,Pravis,3043,788,32,31,63,50.8%,42m
14756,1,Urican,3043,321,12,9,21,57.1%,10m
14756,1,InsaneKoz,3043,364,11,14,25,44.0%,8m
14756,3,lamond,3043,144,5,13,18,27.8%,5m
14756,1,Karalime,3043,88,4,2,6,66.7%,35m
14756,1,Torafugu,3043,88,4,2,6,66.7%,20m
14756,1,TheVelorFog,3043,136,4,4,8,50.0%,35m
14756,1,Stratocaster,3043,142,4,5,9,44.4%,39m
14756,3,balbalta,3043,114,4,7,11,36.4%,40m
14756,1,[LBHS]Tebas,3043,88,4,8,12,33.3%,10m
14756,1,[LDr]BluuJoker,3043,40,2,1,3,66.7%,32m
14756,1,CTPAX,3043,38,2,3,5,40.0%,27m
14756,1,[GoMeLZ]Paquirri,3043,78,2,4,6,33.3%,35m
14756,1,Berseker,3043,0,0,1,1,0.0%,33m
14756,1,pulunga,3043,0,0,1,1,0.0%,30m
14783,3,trojanwarior,3042,803,176,169,345,51.0%,23m
14783,3,hybridi,3042,1518,91,84,175,52.0%,11m
14783,3,[DRKFOX]RonTonTui,3042,604,52,42,94,55.3%,35m
14783,3,Korelo,3042,968,47,34,81,58.0%,27m
14783,3,[D5FTWA]DJJoel,3042,1249,47,62,109,43.1%,7m
14783,3,[xQWQx]sobadsick,3042,730,25,38,63,39.7%,27m
14783,1,ericcartman,3042,587,22,19,41,53.7%,14m
14783,1,syrus,3042,403,17,15,32,53.1%,5m
14783,1,Jag,3042,335,16,0,16,100.0%,26m
14783,1,BLMTrumpSux,3042,486,14,18,32,43.8%,38m
14783,1,[SI4yeR]xxxZHITZUxxx,3042,313,12,9,21,57.1%,26m
14783,1,[Th3Bad]Bondrewd,3042,208,9,10,19,47.4%,27m
14783,1,ZIDHARD,3042,147,6,1,7,85.7%,35m
14783,1,[JLEM]marinejoe,3042,177,5,2,7,71.4%,33m
14783,1,Plusaq,3042,191,5,4,9,55.6%,33m
14783,1,Tiremou,3042,157,4,2,6,66.7%,4m
14783,1,[Siory]Inspiratione,3042,76,3,2,5,60.0%,43m
14783,1,AAAAAAAAA,3042,123,3,3,6,50.0%,4m
14783,1,protein,3042,114,3,4,7,42.9%,8m
14783,1,[FBK]Chowmander,3042,0,1,0,1,100.0%,35m
14783,1,nostro,3042,0,0,1,1,0.0%,12m
14783,1,[HENT4l]pablo,3042,0,0,2,2,0.0%,25m
14805,1,[cluez]NightMan,3041,1718,480,453,933,51.4%,36m
14805,3,ZombiegNice,3041,1549,422,380,802,52.6%,5m
14805,1,PernosticoDF,3041,1488,221,201,422,52.4%,30m
14805,1,WarJester,3041,745,85,59,144,59.0%,8m
14805,1,[ZTempz]Progenex,3041,1250,79,62,141,56.0%,37m
14805,1,Krugessin,3041,989,47,31,78,60.3%,33m
14805,1,PhantomMojo,3041,889,39,33,72,54.2%,32m
14805,1,[ANDYy]Hwaang,3041,548,26,12,38,68.4%,12m
14805,1,[dMdC]SuperHella,3041,223,24,13,37,64.9%,16m
14805,1,Gary,3041,405,24,19,43,55.8%,33m
14805,1,[LoShay]UnitStar,3041,564,22,14,36,61.1%,32m
14805,1,Schnitzel,3041,424,16,19,35,45.7%,26m
14805,3,Macropoxy,3041,461,14,21,35,40.0%,20m
14805,1,[MLGB]AOldDustShoe,3041,376,11,12,23,47.8%,27m
14805,1,Lisandro,3041,225,9,4,13,69.2%,16m
14805,1,StimPackFury,3041,242,9,5,14,64.3%,33m
14805,1,[iiVI]NameLess,3041,68,2,2,4,50.0%,37m
14805,1,[Nuggin]PaZuzUu,3041,88,2,4,6,33.3%,12m
14805,2,sluniavchik,3041,0,1,0,1,100.0%,20m
14805,3,wetsis,3041,30,1,2,3,33.3%,23m
14805,2,[RBL]DaNkSpAdE,3041,0,0,1,1,0.0%,3h
14805,1,Koreddy,3041,0,0,1,1,0.0%,13m
14805,1,[R4NK3D]CrashxD,3041,0,0,1,1,0.0%,26m
14828,1,[LOHs]ludeña,3040,1498,225,204,429,52.4%,39m
14828,3,[Hilas2]JRCP,3040,1529,110,78,188,58.5%,26m
14828,1,[baêa]veiosol,3040,859,94,85,179,52.5%,7m
14828,1,AlienUser,3040,1036,84,71,155,54.2%,35m
14828,1,IanGhost,3040,1002,46,34,80,57.5%,27m
14828,1,[TONIC]Dabboy,3040,1241,46,39,85,54.1%,4m
14828,1,Death,3040,923,38,31,69,55.1%,25m
14828,1,Nick,3040,741,35,35,70,50.0%,29m
14828,3,Pastiche,3040,924,31,40,71,43.7%,19m
14828,3,[lKoDl]Choreza,3040,772,28,31,59,47.5%,20m
14828,1,Raaaawr,3040,494,15,18,33,45.5%,33m
14828,1,Trillix,3040,320,11,6,17,64.7%,19m
14828,1,Joles,3040,202,9,2,11,81.8%,24m
14828,1,Rod,3040,207,9,4,13,69.2%,16m
14828,1,jeibox,3040,260,9,5,14,64.3%,7m
14828,3,gameboy,3040,224,9,10,19,47.4%,38m
14828,3,[DuJour]CelebiPZ,3040,252,9,16,25,36.0%,21m
14828,1,LLLLLLLLLLl,3040,131,5,1,6,83.3%,9m
14828,1,QuackDonal,3040,158,4,2,6,66.7%,38m
14828,1,SirNoobsAlot,3040,40,2,2,4,50.0%,19m
14828,1,Porphyrion,3040,40,2,5,7,28.6%,27m
14828,1,CruelBigDog,3040,0,1,0,1,100.0%,29m
14828,1,[Muggle]Crunk,3040,0,0,1,1,0.0%,25m
14828,1,SteEZySteve,3040,0,0,2,2,0.0%,33m
14852,3,NessT,3039,1183,105,104,209,50.2%,41m
14852,1,[LTK]CaDanGr,3039,1599,66,58,124,53.2%,23m
14852,1,tom,3039,1198,53,45,98,54.1%,33m
14852,1,[GT2020]Estiven,3039,565,49,43,92,53.3%,25m
14852,3,[DEFUP]Aummadour,3039,698,27,33,60,45.0%,15m
14852,1,JimBoogie,3039,482,22,9,31,71.0%,35m
14852,1,[FiFo]RudeBoi,3039,598,22,18,40,55.0%,32m
14852,3,Platnumvirus,3039,520,19,26,45,42.2%,9m
14852,3,Davidgive,3039,394,18,13,31,58.1%,22m
14852,3,[Akita]HumanLife,3039,308,11,18,29,37.9%,7m
14852,1,BurgerKPrime,3039,198,10,8,18,55.6%,19m
14852,1,[xUSMCx]Devildoc,3039,147,6,0,6,100.0%,38m
14852,3,[ssexxy]Corvus,3039,152,5,14,19,26.3%,25m
14852,1,UpThenight,3039,140,4,1,5,80.0%,15m
14852,1,[WNTRLH]Xarnlee,3039,48,4,2,6,66.7%,3h
14852,1,TheDrone,3039,88,3,3,6,50.0%,10m
14852,1,Klepto,3039,84,2,5,7,28.6%,25m
14852,1,LuizPaulo,3039,88,1,1,2,50.0%,14m
14852,1,[SFP]Delmin,3039,38,1,2,3,33.3%,15m
14852,3,AtaHualpA,3039,0,0,1,1,0.0%,12m
14872,1,Pebbo,3038,1579,149,108,257,58.0%,26m
14872,3,Massiv,3038,1582,122,111,233,52.4%,5m
14872,1,[FxB]Orlandi,3038,1736,95,90,185,51.4%,16m
14872,1,CORN,3038,1615,63,57,120,52.5%,34m
14872,1,Nazareth,3038,1194,62,53,115,53.9%,12m
14872,1,[UED]Keyno,3038,758,50,23,73,68.5%,43m
14872,1,MARU,3038,990,41,36,77,53.2%,19m
14872,3,Cygon,3038,378,35,30,65,53.8%,21m
14872,1,Thansies,3038,412,27,20,47,57.4%,18m
14872,1,TerranCotta,3038,449,19,11,30,63.3%,10m
14872,1,llllllllllll,3038,442,17,11,28,60.7%,11m
14872,1,Shikamaru,3038,333,14,8,22,63.6%,38m
14872,1,Rapage,3038,437,14,11,25,56.0%,9m
14872,1,McBoucher,3038,281,8,6,14,57.1%,10m
14872,1,LooseNukes,3038,253,7,5,12,58.3%,13m
14872,1,llllllllllll,3038,129,6,4,10,60.0%,16m
14872,1,Death,3038,163,6,5,11,54.5%,48m
14872,1,Nimrod,3038,89,5,0,5,100.0%,33m
14872,1,ooksei,3038,155,5,1,6,83.3%,23m
14872,1,GoodP,3038,38,5,3,8,62.5%,12m
14872,1,[FMX]BULL,3038,150,5,5,10,50.0%,33m
14872,1,ElLameBotas,3038,34,2,2,4,50.0%,32m
14872,2,[LoliGG]Nubiles,3038,32,2,13,15,13.3%,21m
14872,3,Artanis,3038,0,1,0,1,100.0%,3h
14872,3,emPty,3038,0,0,1,1,0.0%,55m
14872,3,[SCMK]LOKOE,3038,0,0,2,2,0.0%,12m
14872,1,[DarkAG]OmegaStar,3038,0,0,3,3,0.0%,27m
14872,1,[flyrev]flyrev,3038,0,0,5,5,0.0%,24m
14900,3,SauceBauce,3037,1438,113,116,229,49.3%,29m
14900,1,[ValpoK]Zsamora,3037,1518,92,79,171,53.8%,25m
14900,1,Komodo,3037,1199,69,72,141,48.9%,25m
14900,1,DefundCops,3037,1237,52,34,86,60.5%,38m
14900,1,Mastermind,3037,826,42,32,74,56.8%,25m
14900,1,ElPianisto,3037,1207,40,41,81,49.4%,14m
14900,3,[AD3C]Maximo,3037,993,39,41,80,48.8%,42m
14900,1,pandafloo,3037,519,24,17,41,58.5%,44m
14900,1,Blazek,3037,464,17,14,31,54.8%,27m
14900,1,[ACSS]Fiorano,3037,502,15,17,32,46.9%,14m
14900,3,[αB]BushZk,3037,491,15,22,37,40.5%,42m
14900,3,sonata,3037,319,14,8,22,63.6%,6m
14900,1,Atomos,3037,431,12,10,22,54.5%,34m
14900,1,PREDADOR,3037,217,10,4,14,71.4%,12m
14900,3,Taiga,3037,252,10,12,22,45.5%,38m
14900,1,[Parkto]PentaAccel,3037,215,8,4,12,66.7%,16m
14900,3,AngelAlado,3037,161,7,6,13,53.8%,19m
14900,1,chenkaiser,3037,49,3,7,10,30.0%,38m
14900,1,[cluez]Hope,3037,88,2,0,2,100.0%,35m
14900,1,TmG,3037,108,2,1,3,66.7%,41m
14900,3,[Lp]Slayertoss,3037,123,2,4,6,33.3%,19m
14900,1,newbie,3037,0,1,0,1,100.0%,34m
14900,1,DrWho,3037,0,1,1,2,50.0%,38m
14900,1,[DMADG]Elpelado,3037,0,1,1,2,50.0%,39m
14900,3,Galiadus,3037,0,1,1,2,50.0%,1h
14900,1,Kirarin,3037,36,1,2,3,33.3%,27m
14900,1,[VPES]coolbreeze,3037,0,0,1,1,0.0%,39m
14927,3,JKGenius,3036,1563,197,170,367,53.7%,23m
14927,1,[Th3Bad]BrAti,3036,447,110,105,215,51.2%,41m
14927,3,Iceman,3036,1576,71,69,140,50.7%,7m
14927,1,Fattality,3036,799,30,25,55,54.5%,21m
14927,1,Jasmine,3036,758,25,24,49,51.0%,27m
14927,1,[AIN]jaimenak,3036,500,17,15,32,53.1%,42m
14927,3,[AofE]IamPREZSTEVE,3036,121,5,3,8,62.5%,9m
14927,1,malahaas,3036,124,3,8,11,27.3%,36m
14927,1,[forgg]shwinfodawin,3036,44,1,5,6,16.7%,36m
14927,1,Bobbydou,3036,0,0,2,2,0.0%,27m
14937,3,NelsonIBF,3035,1606,329,328,657,50.1%,12m
14937,1,[VNZ]echeloN,3035,1443,183,183,366,50.0%,38m
14937,3,[tCo9]Keysersoze,3035,1544,155,161,316,49.1%,36m
14937,3,[αXLa]Nocturnal,3035,1423,133,132,265,50.2%,25m
14937,3,yami,3035,1028,93,106,199,46.7%,36m
14937,1,HELLFIRE,3035,1018,74,59,133,55.6%,36m
14937,3,[NeRB]Chuk,3035,866,67,69,136,49.3%,39m
14937,1,Farruks,3035,470,47,20,67,70.1%,5m
14937,1,Dakalo,3035,1104,45,43,88,51.1%,24m
14937,1,[SBoys]DangerMarine,3035,1051,40,36,76,52.6%,12m
14937,1,IAN,3035,883,39,32,71,54.9%,26m
14937,1,lryS,3035,581,34,23,57,59.6%,16m
14937,1,[ETWN]TheMaFrey,3035,472,15,11,26,57.7%,36m
14937,1,[TeamUR]Dragonklaw,3035,360,12,11,23,52.2%,11m
14937,1,Chikara,3035,302,9,10,19,47.4%,39m
14937,1,HoneyBadger,3035,286,8,12,20,40.0%,27m
14937,1,watdoink,3035,140,4,7,11,36.4%,24m
14937,1,[NPhasA]Ãdolf,3035,207,4,7,11,36.4%,36m
14937,1,[Macac0]FasUwU,3035,0,1,0,1,100.0%,36m
14937,1,[IH8TOS]onfireAlvaro,3035,0,1,0,1,100.0%,7m
14937,1,laloforce,3035,0,1,0,1,100.0%,14m
14937,1,llllllllllll,3035,88,1,1,2,50.0%,34m
14937,1,Anime,3035,0,0,1,1,0.0%,27m
14937,1,Joey,3035,0,0,1,1,0.0%,34m
14937,1,[Slippy]Julie,3035,0,0,2,2,0.0%,1h
14962,3,AliasDayne,3034,1465,173,175,348,49.7%,8m
14962,3,IIIIIIIIIIII,3034,1641,136,153,289,47.1%,44m
14962,1,Curry,3034,393,28,16,44,63.6%,26m
14962,3,novareynor,3034,466,15,30,45,33.3%,9m
14962,1,NervE,3034,308,10,8,18,55.6%,38m
14962,3,wewe,3034,136,7,2,9,77.8%,27m
14962,1,[GOURDS]APD,3034,274,7,7,14,50.0%,12m
14962,1,[GRNSKN]Ebondawn,3034,78,3,3,6,50.0%,44m
14962,1,[xXSs]xFriedrichSS,3034,89,2,0,2,100.0%,24m
14962,3,[Slops]Mongo,3034,135,2,1,3,66.7%,1h
14962,1,Savingalife,3034,128,2,4,6,33.3%,26m
14962,1,[ElYeet]herroherro,3034,0,1,1,2,50.0%,20m
14962,1,[MCPWN]Vindicator,3034,38,1,2,3,33.3%,25m
14962,1,maMMaAffriCa,3034,0,1,2,3,33.3%,16m
14962,1,[InstaF]Nivarana,3034,0,0,1,1,0.0%,26m
14962,3,[Blade]sam,3034,0,0,8,8,0.0%,32m
14978,3,XxDraxlerxX,3033,1580,202,192,394,51.3%,11m
14978,1,theunknown,3033,1548,94,43,137,68.6%,5m
14978,1,winCe,3033,1662,69,62,131,52.7%,19m
14978,3,cds,3033,526,60,57,117,51.3%,43m
14978,3,KYYYYYYY,3033,786,35,38,73,47.9%,32m
14978,3,jaehores,3033,765,31,39,70,44.3%,44m
14978,1,Sailax,3033,634,27,18,45,60.0%,38m
14978,1,MeatPienSce,3033,397,24,20,44,54.5%,33m
14978,3,[UJäger]Lautaro,3033,572,22,26,48,45.8%,13m
14978,1,Barkcode,3033,451,19,7,26,73.1%,24m
14978,1,SirK,3033,411,14,10,24,58.3%,18m
14978,1,LXXV,3033,373,11,14,25,44.0%,18m
14978,3,Arno,3033,248,10,16,26,38.5%,42m
14978,1,Louzunck,3033,143,7,10,17,41.2%,4m
14978,1,Dcm,3033,100,4,3,7,57.1%,11m
14978,1,[0BAMA]ObmaAteMaKFC,3033,102,3,1,4,75.0%,12m
14978,1,Reagan,3033,0,3,2,5,60.0%,31m
14978,3,Zaxord,3033,58,2,11,13,15.4%,21m
14978,1,BATTLEKING,3033,0,1,0,1,100.0%,14m
14978,1,[QTclub]Dust,3033,0,1,1,2,50.0%,31m
14998,3,Eurotrix,3032,1467,150,127,277,54.2%,43m
14998,1,[ANFA]Martinox,3032,1386,100,90,190,52.6%,16m
14998,1,[WARLEY]DarlesBarkly,3032,733,68,59,127,53.5%,20m
14998,3,Campte,3032,1375,61,77,138,44.2%,9m
14998,3,TruthbeTold,3032,1188,45,49,94,47.9%,40m
14998,1,DBxenon,3032,391,14,11,25,56.0%,20m
14998,1,Wiever,3032,285,13,6,19,68.4%,21m
14998,1,[TPGGXD]adrian,3032,346,13,9,22,59.1%,25m
14998,3,NadaPure,3032,276,11,18,29,37.9%,44m
14998,1,Byunsito,3032,220,10,7,17,58.8%,24m
14998,1,BlueSky,3032,182,6,2,8,75.0%,12m
14998,1,CerealKiller,3032,167,6,6,12,50.0%,21m
14998,2,[NGL]dargon,3032,44,3,4,7,42.9%,3h
14998,1,envySmoke,3032,0,1,0,1,100.0%,12m
14998,1,TomTomTommy,3032,0,1,1,2,50.0%,26m
14998,1,blakeOCE,3032,0,1,3,4,25.0%,42m
14998,1,sunnyBRO,3032,0,0,1,1,0.0%,39m
14998,1,NinaLapochka,3032,0,0,1,1,0.0%,16m
14998,1,[AoBDE]Niko,3032,0,0,2,2,0.0%,5m
14998,3,PobreInfeliz,3032,0,0,7,7,0.0%,40m
15018,1,Flatballer,3031,1569,115,91,206,55.8%,16m
15018,1,Isaacsdad,3031,1718,93,85,178,52.2%,44m
15018,1,[M4CR0]Tristan,3031,1529,65,58,123,52.8%,25m
15018,3,[SaveNA]Frdyan,3031,487,55,49,104,52.9%,5m
15018,3,SLanz,3031,1132,52,64,116,44.8%,9m
15018,1,Aviator,3031,1025,39,42,81,48.1%,44m
15018,3,[GnR]Redgunnerguy,3031,844,32,41,73,43.8%,34m
15018,1,monteeun,3031,353,25,26,51,49.0%,18m
15018,3,[LQV]starwarex,3031,678,22,37,59,37.3%,7m
15018,1,mOt,3031,346,12,11,23,52.2%,42m
15018,3,Chingon,3031,261,11,11,22,50.0%,27m
15018,3,Keiyu,3031,213,9,9,18,50.0%,28m
15018,1,JaBc,3031,260,8,8,16,50.0%,38m
15018,1,nevernal,3031,102,5,3,8,62.5%,26m
15018,3,whatever,3031,0,4,2,6,66.7%,57m
15018,1,[PiN0YS]Parusa,3031,30,4,3,7,57.1%,35m
15018,1,WellDone,3031,111,3,2,5,60.0%,35m
15018,1,[WNTRGG]Wolf,3031,0,3,2,5,60.0%,26m
15018,1,[PTHero]zax,3031,74,3,2,5,60.0%,7m
15018,1,Faiya,3031,84,3,3,6,50.0%,9m
15018,1,Primne,3031,88,2,4,6,33.3%,24m
15018,1,RAMSFAN,3031,0,1,0,1,100.0%,25m
15018,3,timlon,3031,0,1,0,1,100.0%,3h
15018,3,[PSC]RockLobster,3031,0,1,3,4,25.0%,38m
15018,1,llllllllllll,3031,0,0,1,1,0.0%,29m
15018,1,Cobb,3031,0,0,1,1,0.0%,26m
15018,1,[xRtGac]Zippy,3031,0,0,1,1,0.0%,1h
15045,1,Galoonga,3030,1719,179,175,354,50.6%,24m
15045,1,JoeBiden,3030,1259,88,61,149,59.1%,18m
15045,3,NOUB,3030,697,58,58,116,50.0%,5m
15045,1,Epic,3030,1071,51,47,98,52.0%,21m
15045,1,dynamics,3030,749,33,22,55,60.0%,36m
15045,1,Italapino,3030,403,17,12,29,58.6%,29m
15045,1,Theowa,3030,443,17,14,31,54.8%,7m
15045,1,Nerdastic,3030,317,13,13,26,50.0%,35m
15045,1,YenYeri,3030,252,9,12,21,42.9%,11m
15045,1,Mrcursed,3030,262,8,9,17,47.1%,37m
15045,3,[FOOK]Pocky,3030,145,6,2,8,75.0%,1h
15045,3,Anything,3030,122,5,10,15,33.3%,39m
15045,1,molleee,3030,106,3,0,3,100.0%,31m
15045,1,Friff,3030,104,2,2,4,50.0%,14m
15045,1,[DTL]KillaChri,3030,89,1,3,4,25.0%,10m
15045,1,McHootsman,3030,0,0,1,1,0.0%,24m
15045,1,[LBYC]Kabom,3030,0,0,1,1,0.0%,48m
15045,1,TheHeroSCV,3030,0,0,2,2,0.0%,38m
15045,1,JotaDe,3030,0,0,6,6,0.0%,11m
15064,3,Bob,3029,1496,192,184,376,51.1%,44m
15064,1,Archer,3029,1595,166,143,309,53.7%,34m
15064,3,GusPer,3029,1471,164,169,333,49.2%,37m
15064,1,Bronze,3029,1627,92,85,177,52.0%,34m
15064,3,Trojan,3029,1291,58,61,119,48.7%,13m
15064,1,Dibs,3029,1418,50,51,101,49.5%,29m
15064,1,[TGosuB]BisDaQ,3029,739,28,19,47,59.6%,32m
15064,1,AEsir,3029,192,9,5,14,64.3%,24m
15064,1,icon,3029,145,5,2,7,71.4%,3h
15064,1,[αXLa]JessicaHyde,3029,148,5,5,10,50.0%,29m
15064,1,victor,3029,170,5,5,10,50.0%,26m
15064,2,GoldenArmada,3029,137,2,6,8,25.0%,3h
15064,1,[COVD19]CORONAVIRUS,3029,88,1,1,2,50.0%,33m
15064,1,JaegerMeistr,3029,36,1,3,4,25.0%,16m
15078,1,Izsamex,3028,1554,290,279,569,51.0%,26m
15078,1,Straika,3028,897,169,149,318,53.1%,37m
15078,3,Tubby,3028,1429,57,66,123,46.3%,38m
15078,1,skyG,3028,1024,43,29,72,59.7%,8m
15078,1,FingerNails,3028,1167,43,43,86,50.0%,35m
15078,3,Lee,3028,1001,41,38,79,51.9%,21m
15078,1,[TeriS]Hoontar,3028,883,37,30,67,55.2%,17m
15078,1,MURDOCK,3028,604,22,18,40,55.0%,11m
15078,1,[SWOF]Inertiatic,3028,318,17,7,24,70.8%,29m
15078,1,Aleluia,3028,467,17,14,31,54.8%,39m
15078,3,Blardin,3028,286,12,9,21,57.1%,34m
15078,1,[Msia]nornia,3028,219,9,9,18,50.0%,2h
15078,1,Zwark,3028,226,6,9,15,40.0%,6m
15078,1,WhalterWhite,3028,146,4,6,10,40.0%,7m
15078,3,SkyDiveJZ,3028,0,1,0,1,100.0%,41m
15078,1,[CFSM]Luka,3028,0,1,0,1,100.0%,37m
15078,1,dsfgd,3028,40,1,3,4,25.0%,23m
15078,1,glasS,3028,0,0,1,1,0.0%,36m
15078,1,illuminati,3028,0,0,1,1,0.0%,36m
15078,1,LingKing,3028,0,0,4,4,0.0%,6m
15098,1,radix,3027,1714,111,112,223,49.8%,18m
15098,3,Striker,3027,939,72,69,141,51.1%,7m
15098,3,[ZTempz]Taucer,3027,1307,52,53,105,49.5%,21m
15098,1,[JOOMA]moon,3027,798,41,17,58,70.7%,30m
15098,3,JeRe,3027,918,35,36,71,49.3%,43m
15098,1,[CUCKSS]Hurogi,3027,724,31,26,57,54.4%,44m
15098,3,Rahwinia,3027,788,27,41,68,39.7%,32m
15098,1,Seveso,3027,779,25,23,48,52.1%,26m
15098,1,[xDSG]Mapache,3027,828,25,27,52,48.1%,36m
15098,3,DommyT,3027,496,17,23,40,42.5%,31m
15098,1,mouse,3027,232,16,12,28,57.1%,7m
15098,2,CoralBeans,3027,283,14,3,17,82.4%,5m
15098,1,HelloThere,3027,264,10,8,18,55.6%,24m
15098,3,MochiKat,3027,178,10,10,20,50.0%,36m
15098,1,[muGGer]Littleboy,3027,135,6,2,8,75.0%,11m
15098,3,lIlIlIIIIl,3027,122,6,4,10,60.0%,12m
15098,2,Estrong,3027,46,5,4,9,55.6%,60m
15098,1,[Dicboy]Mannheim,3027,146,4,5,9,44.4%,19m
15098,1,Appollo,3027,89,2,0,2,100.0%,12m
15098,1,PoKwan,3027,0,1,0,1,100.0%,39m
15098,1,Search,3027,88,1,1,2,50.0%,16m
15098,1,WNTRALEX,3027,0,0,1,1,0.0%,25m
15098,1,Cypherdroid,3027,0,0,2,2,0.0%,23m
15121,3,Aquiles,3026,1588,273,271,544,50.2%,40m
15121,1,[cluez]LeoVilla,3026,1371,176,147,323,54.5%,34m
15121,1,PsychOps,3026,886,176,168,344,51.2%,10m
15121,1,STATS,3026,1595,99,97,196,50.5%,14m
15121,1,[Litez]Shadowslayer,3026,1098,94,85,179,52.5%,23m
15121,1,[KurWa]NefariouS,3026,605,27,23,50,54.0%,26m
15121,1,suhpreme,3026,611,24,23,47,51.1%,31m
15121,1,Spinoza,3026,327,12,7,19,63.2%,6m
15121,1,BPSOO,3026,238,11,10,21,52.4%,36m
15121,1,[gaPe]Siv,3026,259,7,7,14,50.0%,42m
15121,2,LazyGuyIIIII,3026,148,6,3,9,66.7%,35m
15121,1,silverhawk,3026,178,6,7,13,46.2%,31m
15121,1,FWQCQ,3026,136,5,3,8,62.5%,4m
15121,1,Kazolas,3026,90,4,3,7,57.1%,39m
15121,2,thisname,3026,60,3,0,3,100.0%,41m
15121,1,[KRAFTT]EluSivE,3026,88,3,3,6,50.0%,42m
15121,1,[SULFER]raypurchase,3026,112,3,6,9,33.3%,41m
15121,3,elmatarchis,3026,0,2,1,3,66.7%,26m
15121,3,[Dnwlkr]taigel,3026,0,2,7,9,22.2%,33m
15121,1,ParkingGoose,3026,0,1,3,4,25.0%,29m
15121,3,PuPPaBeaR,3026,42,1,5,6,16.7%,3h
15121,2,Titans,3026,0,0,1,1,0.0%,29m
15121,2,skunklee,3026,0,0,1,1,0.0%,29m
15144,3,BrunoAP,3025,1543,117,107,224,52.2%,29m
15144,2,[ValidG]Commacozzee,3025,1329,86,65,151,57.0%,14m
15144,1,Pekka,3025,633,25,21,46,54.3%,13m
15144,3,[EWJ]Waza,3025,449,23,23,46,50.0%,26m
15144,1,Inoue,3025,454,22,11,33,66.7%,43m
15144,1,BadPlayer,3025,437,17,17,34,50.0%,38m
15144,1,minidaddy,3025,410,13,10,23,56.5%,11m
15144,1,bigdemetrio,3025,217,5,5,10,50.0%,25m
15144,1,Angus,3025,225,5,6,11,45.5%,26m
15144,1,[SRVTS]Claudinhodf,3025,131,4,2,6,66.7%,39m
15144,1,[ØÛ]gorilarosado,3025,190,4,4,8,50.0%,13m
15144,1,MiniGhost,3025,95,1,1,2,50.0%,34m
15144,3,IordOfFlies,3025,30,1,8,9,11.1%,12m
15144,2,Loub,3025,0,0,1,1,0.0%,5m
15144,2,ItimKIllah,3025,0,0,1,1,0.0%,23m
15144,1,Conviction,3025,0,0,2,2,0.0%,27m
15160,3,bigdoof,3024,1442,332,277,609,54.5%,40m
15160,3,[GOPERÚ]Wyvern,3024,1518,309,299,608,50.8%,9m
15160,1,grannit,3024,845,33,25,58,56.9%,24m
15160,3,[MtnDwd]MuchosPylons,3024,490,18,25,43,41.9%,37m
15160,1,retador,3024,387,15,9,24,62.5%,13m
15160,1,FourRax,3024,298,9,7,16,56.2%,4m
15160,2,[oxen]BewsTomahawk,3024,168,8,7,15,53.3%,40m
15160,1,BIANG,3024,150,7,4,11,63.6%,33m
15160,3,Cyrali,3024,169,7,7,14,50.0%,13m
15160,3,[TXA]BusinessCat,3024,197,6,4,10,60.0%,14m
15160,1,[XTGZ]XtremeNubi,3024,162,5,3,8,62.5%,5m
15160,2,[GrW]MeD,3024,30,1,1,2,50.0%,28m
15160,1,Imreallybad,3024,90,1,2,3,33.3%,21m
15160,2,[MURI0C]dragon,3024,0,0,1,1,0.0%,5m
15160,2,Diaz,3024,0,0,1,1,0.0%,30m
15175,3,lllllll,3023,1490,369,363,732,50.4%,8m
15175,3,[NOMMM]rofltarts,3023,1554,153,145,298,51.3%,10m
15175,3,sitskrieg,3023,1326,62,71,133,46.6%,36m
15175,3,[theBSL]Jamieb,3023,543,33,18,51,64.7%,20m
15175,1,[Gudr]Kavi,3023,824,31,29,60,51.7%,30m
15175,1,simply,3023,677,26,18,44,59.1%,31m
15175,3,nvision,3023,356,13,12,25,52.0%,19m
15175,1,[JChill]stickerplane,3023,284,10,7,17,58.8%,44m
15175,2,[BIGBC]LeDerp,3023,250,9,5,14,64.3%,12m
15175,3,Snorri,3023,162,8,7,15,53.3%,30m
15175,1,EnZimE,3023,30,5,2,7,71.4%,34m
15175,2,[MoLaMa]Tony,3023,30,4,2,6,66.7%,14m
15175,2,GolDaniels,3023,116,4,2,6,66.7%,5m
15175,1,[UpxV]RAYDER,3023,112,3,5,8,37.5%,19m
15175,1,[MutasT]Horuss,3023,76,2,6,8,25.0%,26m
15175,2,Notorious,3023,0,1,1,2,50.0%,3h
15175,2,[Swilly]SuperSaiyan,3023,0,0,1,1,0.0%,12m
15175,2,Euco,3023,0,0,1,1,0.0%,5m
15175,2,Eshko,3023,0,0,1,1,0.0%,38m
15175,1,Androide,3023,0,0,3,3,0.0%,19m
15175,1,[biofit]LiNuxZerO,3023,0,0,4,4,0.0%,6m
15196,1,[BNITOS]jltt,3022,1619,131,122,253,51.8%,24m
15196,1,RoadCrew,3022,1685,84,70,154,54.5%,44m
15196,1,[CTCiav]MKiller,3022,1524,69,51,120,57.5%,24m
15196,1,Chaldi,3022,962,30,33,63,47.6%,32m
15196,1,[JaMiT]Achilles,3022,656,19,22,41,46.3%,28m
15196,3,Gabagool,3022,166,16,5,21,76.2%,20m
15196,1,UrineTrouble,3022,152,5,7,12,41.7%,44m
15196,1,Rufio,3022,116,4,4,8,50.0%,36m
15196,2,sAviOr,3022,97,4,4,8,50.0%,1h
15196,2,MapleLord,3022,0,1,0,1,100.0%,31m
15196,1,[iDrunk]xplicity,3022,0,1,1,2,50.0%,3h
15196,2,Mosckvin,3022,0,0,1,1,0.0%,15m
15208,3,[EtrOy]SoTaN,3021,1519,516,502,1018,50.7%,4m
15208,3,TonyStark,3021,704,134,132,266,50.4%,41m
15208,1,LERC,3021,1671,110,76,186,59.1%,21m
15208,3,meegan,3021,1592,60,69,129,46.5%,39m
15208,3,[Mark]PeRseVeraNcE,3021,864,58,58,116,50.0%,43m
15208,1,[TGCrew]ZeCroiSSanT,3021,1040,35,40,75,46.7%,30m
15208,1,Nihs,3021,275,12,9,21,57.1%,7m
15208,2,[Scans]Slickvinny,3021,244,8,6,14,57.1%,40m
15208,2,Damian,3021,186,7,6,13,53.8%,1h
15208,2,DakotasTag,3021,202,7,6,13,53.8%,9m
15208,1,Douglie,3021,154,5,6,11,45.5%,44m
15208,2,Verjo,3021,92,4,1,5,80.0%,44m
15208,3,JBalla,3021,121,3,0,3,100.0%,1h
15208,3,[JlHAD]Apocalyptron,3021,94,2,3,5,40.0%,22m
15208,2,[HaYn]Cario,3021,30,1,1,2,50.0%,22m
15208,2,[USSAF]Commodore,3021,0,0,1,1,0.0%,12m
15208,2,[GeekA]dkSan,3021,0,0,1,1,0.0%,9m
15208,1,[UVC]Canami,3021,0,0,2,2,0.0%,18m
15226,1,fruitofdoom,3020,1165,45,40,85,52.9%,4m
15226,2,[Dundy]ClydeBOT,3020,641,26,17,43,60.5%,30m
15226,2,Weep,3020,604,24,21,45,53.3%,4m
15226,1,Donubu,3020,440,18,13,31,58.1%,36m
15226,1,JoeSoul,3020,438,14,17,31,45.2%,39m
15226,1,[TGCF]SprCommander,3020,165,6,2,8,75.0%,42m
15226,2,Kapai,3020,175,6,9,15,40.0%,50m
15226,2,snotrag,3020,66,3,0,3,100.0%,5m
15226,2,[Possay]Grossemolle,3020,0,1,0,1,100.0%,8m
15226,1,Cabeson,3020,88,1,2,3,33.3%,28m
15226,1,Choukaki,3020,38,1,3,4,25.0%,25m
15226,2,coolraymi,3020,0,0,1,1,0.0%,16m
15238,3,utmosTTerror,3019,1539,295,282,577,51.1%,17m
15238,1,[sk3tch]noobIII,3019,1643,241,227,468,51.5%,39m
15238,3,JayMunger,3019,1547,171,179,350,48.9%,10m
15238,1,Homu,3019,1710,159,154,313,50.8%,37m
15238,1,Laelsa,3019,1496,68,62,130,52.3%,35m
15238,3,Scylarix,3019,983,39,37,76,51.3%,16m
15238,1,[ZTemp]DujekOnearm,3019,725,29,23,52,55.8%,16m
15238,1,[Vtta]AndreNg,3019,516,28,20,48,58.3%,30m
15238,3,reanimation,3019,506,21,21,42,50.0%,32m
15238,2,Endless,3019,382,16,10,26,61.5%,10m
15238,2,Swan,3019,352,14,6,20,70.0%,31m
15238,1,JiPa,3019,374,14,20,34,41.2%,14m
15238,1,[ZTemp]BroodWar,3019,265,9,12,21,42.9%,14m
15238,1,Jhonatan,3019,240,7,11,18,38.9%,39m
15238,2,Metalord,3019,87,6,3,9,66.7%,50m
15238,2,Cory,3019,0,4,1,5,80.0%,9m
15238,2,[KingSC]JotaCe,3019,117,4,6,10,40.0%,30m
15238,2,[AiPink]Auralique,3019,114,3,0,3,100.0%,8m
15238,2,XIInite,3019,0,3,2,5,60.0%,6m
15238,3,Znarf,3019,121,2,1,3,66.7%,44m
15238,1,MarcoNeri,3019,40,2,2,4,50.0%,9m
15238,2,ColonelW,3019,30,2,4,6,33.3%,16m
15238,2,Mechatronic,3019,0,1,0,1,100.0%,28m
15238,3,aTroubador,3019,0,1,1,2,50.0%,35m
15238,1,Executioner,3019,0,1,2,3,33.3%,14m
15238,2,Xepto,3019,0,0,1,1,0.0%,37m
15238,1,Snowman,3019,0,0,6,6,0.0%,13m
15238,1,Perna,3019,0,0,6,6,0.0%,44m
15266,3,Stinky,3018,1533,253,253,506,50.0%,38m
15266,1,DeepNet,3018,1577,120,72,192,62.5%,42m
15266,1,gnomees,3018,1654,116,102,218,53.2%,27m
15266,3,[ROSC2]MaFiaROX,3018,934,104,99,203,51.2%,27m
15266,3,Kraken,3018,1504,65,65,130,50.0%,32m
15266,2,[ZAVC]PitaPanic,3018,422,39,34,73,53.4%,41m
15266,1,YouDoUBoo,3018,679,32,23,55,58.2%,12m
15266,1,BrenoCunha,3018,553,21,20,41,51.2%,20m
15266,1,OWENATOR,3018,617,20,18,38,52.6%,21m
15266,3,Choco,3018,350,16,13,29,55.2%,6m
15266,3,Mindtaker,3018,362,13,5,18,72.2%,30m
15266,1,TalDarim,3018,256,10,8,18,55.6%,12m
15266,1,cplusplus,3018,214,7,4,11,63.6%,30m
15266,1,LuckyOwl,3018,196,6,10,16,37.5%,10m
15266,3,Takamichika,3018,30,5,4,9,55.6%,44m
15266,2,[kallpa]Haoda,3018,92,4,0,4,100.0%,7m
15266,3,DonoWall,3018,117,3,1,4,75.0%,43m
15266,1,[HoYung]doinwork,3018,82,3,4,7,42.9%,29m
15266,2,Juank,3018,64,2,1,3,66.7%,34m
15266,2,Hybrid,3018,0,1,0,1,100.0%,33m
15266,1,vástago,3018,0,1,2,3,33.3%,15m
15266,2,Blast,3018,0,0,1,1,0.0%,16m
15266,2,Wisp,3018,0,0,1,1,0.0%,19m
15266,1,Sine,3018,0,0,3,3,0.0%,38m
15290,1,TiPoux,3017,1656,142,135,277,51.3%,34m
15290,3,[IMarul]Bullet,3017,222,32,38,70,45.7%,13m
15290,1,llllIIIIllII,3017,560,17,21,38,44.7%,39m
15290,1,WizWaz,3017,392,16,12,28,57.1%,12m
15290,1,ExtremePlaY,3017,461,15,11,26,57.7%,39m
15290,1,IIIIIIllllII,3017,319,14,12,26,53.8%,32m
15290,2,thecrazyone,3017,297,11,8,19,57.9%,24m
15290,1,[InMind]Aficionado,3017,211,7,5,12,58.3%,33m
15290,1,zero,3017,176,6,5,11,54.5%,20m
15290,1,Keijo,3017,177,5,2,7,71.4%,3h
15290,1,Diabolous,3017,140,4,6,10,40.0%,35m
15290,3,GrandMaster,3017,122,3,5,8,37.5%,12m
15290,1,Arete,3017,36,2,3,5,40.0%,34m
15290,2,Synin,3017,0,1,0,1,100.0%,11m
15290,1,[VKC]CampiH,3017,0,0,1,1,0.0%,3h
15290,3,[scUN]DeadlyKitten,3017,0,0,1,1,0.0%,1h
15306,3,[SMLDRS]WaspZala,3016,1091,112,110,222,50.5%,41m
15306,1,[ÆON]DarkRost,3016,1610,106,106,212,50.0%,25m
15306,3,Pheet,3016,1414,56,55,111,50.5%,24m
15306,1,[INVT]yosmar,3016,309,13,7,20,65.0%,11m
15306,1,SUPERTIM,3016,336,13,9,22,59.1%,37m
15306,1,MaRs,3016,247,11,7,18,61.1%,24m
15306,1,Elmanchas,3016,214,7,7,14,50.0%,44m
15306,1,Xenocide,3016,175,6,6,12,50.0%,26m
15306,1,AstralPP,3016,117,4,2,6,66.7%,6m
15306,2,[ECrush]ShiniGami,3016,88,3,1,4,75.0%,12m
15306,1,MISTERDUCK,3016,0,3,2,5,60.0%,41m
15306,1,[USplan]hyunski,3016,46,2,2,4,50.0%,36m
15306,3,[KRAK3N]Vanilla,3016,97,1,1,2,50.0%,1h
15306,2,marveL,3016,36,1,2,3,33.3%,39m
15306,1,BetaStar,3016,0,1,2,3,33.3%,33m
15306,1,Riggins,3016,38,1,3,4,25.0%,36m
15306,1,[EoMX]Korax,3016,0,0,3,3,0.0%,43m
15323,3,jaja,3015,949,183,189,372,49.2%,32m
15323,1,[ValidG]Aoxus,3015,1705,166,150,316,52.5%,35m
15323,1,[n3wk1d]shishkaberb,3015,656,127,113,240,52.9%,39m
15323,3,[USplan]biznok,3015,994,121,127,248,48.8%,34m
15323,2,[R3APER]SweatyBallz,3015,1404,57,46,103,55.3%,38m
15323,3,[SirDon]DonDui,3015,1312,54,69,123,43.9%,44m
15323,1,Harusame,3015,837,39,29,68,57.4%,16m
15323,1,[Kayoz]BullDestro,3015,911,36,29,65,55.4%,34m
15323,1,Frost,3015,694,28,18,46,60.9%,24m
15323,1,[Genus]armpitkitt,3015,681,23,20,43,53.5%,26m
15323,1,[XpKb]GansitoUwU,3015,585,18,22,40,45.0%,38m
15323,3,[Quart]theWORLD,3015,221,16,21,37,43.2%,17m
15323,2,[TLCE]Roots,3015,326,12,5,17,70.6%,19m
15323,2,CptObvious,3015,221,10,3,13,76.9%,37m
15323,1,CasterFulla,3015,289,9,8,17,52.9%,24m
15323,1,SUPERMALLS,3015,231,7,6,13,53.8%,14m
15323,3,zGtDarkGhosT,3015,121,5,3,8,62.5%,3h
15323,3,[Gaypo]EmpeeDubs,3015,122,4,3,7,57.1%,1h
15323,2,logXYZ,3015,165,4,3,7,57.1%,2h
15323,3,[TPGGXD]MrPatricio,3015,175,4,11,15,26.7%,8m
15323,2,meatlonlon,3015,60,3,1,4,75.0%,22m
15323,1,[TimTom]Zzoram,3015,157,3,4,7,42.9%,35m
15323,2,Atlanta,3015,0,1,0,1,100.0%,10m
15323,2,Jaeg,3015,0,1,0,1,100.0%,12m
15323,1,[UpeV]Sweader,3015,0,1,3,4,25.0%,38m
15323,2,[GØSU]FiDell,3015,0,0,1,1,0.0%,11m
15349,3,CheeseImmune,3014,1614,535,493,1028,52.0%,21m
15349,3,ZéColméia,3014,1576,271,257,528,51.3%,27m
15349,1,XxSensuixX,3014,1293,139,119,258,53.9%,37m
15349,1,BabyMozart,3014,1399,114,105,219,52.1%,4m
15349,3,[GFA]Whitewolf,3014,967,94,102,196,48.0%,33m
15349,1,[XTULAX]NowhereMan,3014,871,62,45,107,57.9%,32m
15349,2,[lHCl]TBlackFire,3014,581,59,48,107,55.1%,6m
15349,1,[Th3Bad]ToadPoa,3014,825,42,23,65,64.6%,39m
15349,3,Cocosaurio,3014,1032,42,45,87,48.3%,10m
15349,1,Mars,3014,1006,36,36,72,50.0%,12m
15349,1,SlimSaxxy,3014,368,12,12,24,50.0%,44m
15349,1,BigBadBill,3014,205,8,5,13,61.5%,27m
15349,1,Spladow,3014,90,5,2,7,71.4%,24m
15349,3,WolfGang,3014,144,4,2,6,66.7%,1h
15349,1,[NoBP]SamLeRoux,3014,156,4,8,12,33.3%,34m
15349,1,ComAkbar,3014,0,2,3,5,40.0%,25m
15349,3,inKa,3014,0,0,1,1,0.0%,1h
15366,1,[veri]LostCause,3013,1070,38,38,76,50.0%,27m
15366,1,[SBoys]Dwonker,3013,760,26,25,51,51.0%,28m
15366,1,Kioelf,3013,275,12,7,19,63.2%,11m
15366,3,Jasb,3013,223,11,5,16,68.8%,39m
15366,3,[Meadow]detour,3013,58,4,9,13,30.8%,24m
15366,2,Smiles,3013,58,3,1,4,75.0%,7m
15366,2,HYPOTHERMIA,3013,123,3,1,4,75.0%,4m
15366,1,ProfLamb,3013,0,3,2,5,60.0%,39m
15366,1,evilcupcakes,3013,124,3,3,6,50.0%,34m
15366,1,[NoTeam]Density,3013,46,2,3,5,40.0%,47m
15366,2,FLYSON,3013,0,1,0,1,100.0%,35m
15366,2,[CGGWP]synChpo,3013,32,1,2,3,33.3%,5m
15366,2,Jmpzisbad,3013,32,1,2,3,33.3%,5m
15366,2,Gold,3013,0,1,4,5,20.0%,9m
15380,1,fermi,3012,1714,258,226,484,53.3%,24m
15380,1,Toby,3012,1676,165,154,319,51.7%,11m
15380,3,Fairplay,3012,1463,78,90,168,46.4%,13m
15380,2,kimshotgun,3012,1072,51,38,89,57.3%,8m
15380,2,HAYVAR,3012,1200,49,37,86,57.0%,33m
15380,1,Cannibal,3012,918,37,32,69,53.6%,34m
15380,1,xxardacoxx,3012,610,21,18,39,53.8%,19m
15380,1,MasterChile,3012,422,15,12,27,55.6%,14m
15380,2,llllllllllll,3012,380,13,6,19,68.4%,32m
15380,3,Zero,3012,185,8,7,15,53.3%,33m
15380,2,Tygranthis,3012,157,7,6,13,53.8%,34m
15380,2,Sylvanas,3012,118,4,4,8,50.0%,7m
15380,2,DesmondZuo,3012,0,3,2,5,60.0%,9m
15380,2,[HGL]IMMvp,3012,94,2,0,2,100.0%,25m
15380,2,andyprocrack,3012,112,2,1,3,66.7%,22m
15380,2,Okami,3012,0,1,4,5,20.0%,8m
15380,1,cRoNus,3012,42,1,6,7,14.3%,26m
15380,2,[GGDA]invictor,3012,0,0,1,1,0.0%,14m
15380,1,Dexicus,3012,0,0,2,2,0.0%,3h
15380,1,TheQueenMary,3012,0,0,3,3,0.0%,15m
15400,3,Ant,3011,1552,213,212,425,50.1%,30m
15400,3,[ValidG]StepSister,3011,1377,75,74,149,50.3%,12m
15400,3,augusti,3011,1091,67,75,142,47.2%,11m
15400,1,[ZTempz]LeoDiCaprio,3011,1264,63,29,92,68.5%,16m
15400,1,Arjay,3011,1269,52,43,95,54.7%,12m
15400,3,Kaboel,3011,490,51,58,109,46.8%,41m
15400,1,ZackRaynor,3011,872,41,29,70,58.6%,27m
15400,2,Wubb,3011,852,39,18,57,68.4%,10m
15400,1,Sonoso,3011,752,31,22,53,58.5%,22m
15400,3,Renegade,3011,703,30,27,57,52.6%,43m
15400,1,PinoyMarine,3011,570,21,22,43,48.8%,26m
15400,1,[HOMOF]GreenYoshi,3011,592,20,25,45,44.4%,36m
15400,3,alphonzo,3011,457,18,19,37,48.6%,40m
15400,2,GoSuPoSu,3011,284,14,7,21,66.7%,9m
15400,3,rgrasell,3011,344,13,20,33,39.4%,19m
15400,2,Velocipastor,3011,254,10,4,14,71.4%,10m
15400,1,Shadow,3011,336,9,9,18,50.0%,27m
15400,3,[DoRQ]Zimphar,3011,252,9,21,30,30.0%,20m
15400,3,Peatree,3011,206,7,17,24,29.2%,5m
15400,1,[LPrusa]Choripan,3011,180,5,4,9,55.6%,26m
15400,2,box,3011,138,5,4,9,55.6%,37m
15400,1,BlaCkDeatH,3011,150,4,3,7,57.1%,38m
15400,2,chaoWee,3011,122,4,4,8,50.0%,17m
15400,3,NautiluS,3011,0,3,3,6,50.0%,8m
15400,3,Wolfie,3011,62,3,8,11,27.3%,43m
15400,1,clonegj,3011,102,2,3,5,40.0%,14m
15400,3,llllllllllll,3011,97,2,6,8,25.0%,1h
15400,1,Lagunazo,3011,0,1,0,1,100.0%,2h
15400,2,Masky,3011,0,1,0,1,100.0%,5m
15400,2,FroZeNN,3011,0,1,2,3,33.3%,25m
15400,1,[αB]WarbuffII,3011,0,1,2,3,33.3%,19m
15400,1,FlyingZipper,3011,38,1,5,6,16.7%,26m
15400,1,GeneralBnice,3011,0,0,2,2,0.0%,26m
15433,1,Caster,3010,1263,141,108,249,56.6%,12m
15433,1,Emawk,3010,1707,118,114,232,50.9%,37m
15433,1,menazur,3010,1203,53,59,112,47.3%,38m
15433,1,cloven,3010,1073,46,42,88,52.3%,34m
15433,1,dragonborn,3010,824,40,19,59,67.8%,12m
15433,1,joseph,3010,391,17,12,29,58.6%,24m
15433,1,[4Karl]Nebula,3010,294,11,7,18,61.1%,11m
15433,2,Moller,3010,272,10,9,19,52.6%,28m
15433,1,Michilover,3010,336,10,13,23,43.5%,38m
15433,3,AreYouCereal,3010,105,6,3,9,66.7%,32m
15433,3,VenonVerus,3010,180,6,4,10,60.0%,25m
15433,1,SORROW,3010,222,6,10,16,37.5%,29m
15433,2,bruh,3010,0,5,2,7,71.4%,49m
15433,1,Leapordspot,3010,145,5,3,8,62.5%,12m
15433,3,[Intpro]Emanuelgame,3010,93,5,3,8,62.5%,37m
15433,3,Ubermouser,3010,0,4,4,8,50.0%,36m
15433,1,Quinten,3010,106,3,2,5,60.0%,24m
15433,2,[CHRUGE]Frosty,3010,0,3,2,5,60.0%,36m
15433,2,ImKorean,3010,0,3,2,5,60.0%,16m
15433,3,Anonymous,3010,145,3,3,6,50.0%,3h
15433,3,[HOV]RAV,3010,147,3,9,12,25.0%,12m
15433,1,josss,3010,116,2,3,5,40.0%,29m
15433,2,Amphipoda,3010,0,1,0,1,100.0%,13m
15433,2,arvz,3010,30,1,1,2,50.0%,40m
15433,1,MaxBeast,3010,90,1,2,3,33.3%,24m
15433,1,[BXK]VITTIS,3010,0,1,2,3,33.3%,17m
15433,1,[HJBE]JJmoore,3010,0,1,2,3,33.3%,41m
15433,1,[Freema]MorganFreema,3010,0,0,2,2,0.0%,7m
15461,3,momchil,3009,1303,257,239,496,51.8%,37m
15461,3,Gianzex,3009,1491,160,158,318,50.3%,7m
15461,1,Terokz,3009,1651,129,123,252,51.2%,34m
15461,1,[ØÛ]Vendettavic,3009,889,56,49,105,53.3%,36m
15461,3,SilverWings,3009,791,38,39,77,49.4%,43m
15461,1,CricK,3009,968,34,38,72,47.2%,35m
15461,1,Hungry,3009,393,22,18,40,55.0%,27m
15461,3,Frost,3009,325,14,9,23,60.9%,20m
15461,2,[PTHero]Neutralis,3009,198,7,7,14,50.0%,15m
15461,2,Aurora,3009,126,5,2,7,71.4%,21m
15461,1,Hex,3009,177,4,4,8,50.0%,32m
15461,2,HotHandSeven,3009,58,2,2,4,50.0%,7m
15461,1,Vaseline,3009,0,1,1,2,50.0%,46m
15461,2,alastor,3009,30,1,2,3,33.3%,24m
15461,1,TouchTheButt,3009,38,1,3,4,25.0%,25m
15461,2,[RtKa]Enn,3009,0,0,1,1,0.0%,8m
15461,2,[SWRV]Kai,3009,0,0,1,1,0.0%,10m
15461,1,SilentSword,3009,0,0,2,2,0.0%,19m
15461,1,Rektek,3009,0,0,4,4,0.0%,26m
15480,3,evolsteve,3008,1372,441,437,878,50.2%,40m
15480,3,Bellrogg,3008,1556,171,174,345,49.6%,7m
15480,3,[cl0udM]Jragoo,3008,1525,133,141,274,48.5%,18m
15480,1,shapoopymtg,3008,1392,57,51,108,52.8%,42m
15480,3,FoxLSB,3008,1112,39,47,86,45.3%,40m
15480,1,[SCN]Stevefrench,3008,725,25,25,50,50.0%,22m
15480,2,[LTlord]TerranKnight,3008,406,15,7,22,68.2%,19m
15480,3,SniperRaynor,3008,323,12,5,17,70.6%,32m
15480,1,LtShinySides,3008,263,7,6,13,53.8%,12m
15480,1,Condo,3008,211,7,7,14,50.0%,35m
15480,2,Bloodsand,3008,58,5,3,8,62.5%,30m
15480,3,[AXAT]MARINEKING,3008,145,4,6,10,40.0%,19m
15480,2,[NSKL]Peril,3008,0,3,2,5,60.0%,41m
15480,2,Striketroop,3008,30,2,0,2,100.0%,10m
15480,1,[OPKS]Ninja,3008,88,2,1,3,66.7%,44m
15480,1,[Rawwr]Erebus,3008,36,2,5,7,28.6%,12m
15480,1,darium,3008,76,2,7,9,22.2%,24m
15480,1,Zeeman,3008,0,1,0,1,100.0%,25m
15480,2,AlphaOmega,3008,0,0,1,1,0.0%,12m
15480,2,SaltyJohnson,3008,0,0,1,1,0.0%,25m
15480,2,[Macako]SamedarkHors,3008,0,0,1,1,0.0%,21m
15480,1,[LUNKER]BIRD,3008,0,0,1,1,0.0%,3h
15480,1,Grandknight,3008,0,0,3,3,0.0%,37m
15503,1,rflbill,3007,736,159,137,296,53.7%,6m
15503,2,[GGMESP]SilverHawk,3007,1182,48,37,85,56.5%,12m
15503,2,kollel,3007,708,26,26,52,50.0%,18m
15503,2,Marus,3007,642,24,19,43,55.8%,6m
15503,1,candlelight,3007,436,21,15,36,58.3%,33m
15503,1,Kazegami,3007,356,17,18,35,48.6%,34m
15503,3,Zeppylyn,3007,380,16,19,35,45.7%,32m
15503,2,[MTLG]Noah,3007,404,15,11,26,57.7%,14m
15503,2,[OhhGG]BakeryDragon,3007,228,9,7,16,56.2%,23m
15503,1,oneshot,3007,290,9,10,19,47.4%,44m
15503,1,[WaIl]CornyDaniels,3007,312,9,12,21,42.9%,7m
15503,1,idiZa,3007,258,8,10,18,44.4%,9m
15503,2,Joe,3007,174,6,4,10,60.0%,5m
15503,1,Aiden,3007,140,4,3,7,57.1%,36m
15503,1,Cheffy,3007,0,3,2,5,60.0%,1h
15503,1,[CWSE]Chiawang,3007,70,3,6,9,33.3%,37m
15503,1,cbben,3007,108,3,6,9,33.3%,18m
15503,2,MethodMan,3007,34,1,1,2,50.0%,9m
15503,1,[SUKKME]PooButt,3007,38,1,8,9,11.1%,22m
15522,1,JORGE,3006,1707,459,450,909,50.5%,16m
15522,2,[BoAVN]ProPK,3006,1660,104,95,199,52.3%,39m
15522,3,DunklerJager,3006,439,83,86,169,49.1%,8m
15522,3,SukCheese,3006,1250,80,82,162,49.4%,10m
15522,3,[govT]Rods,3006,673,74,71,145,51.0%,32m
15522,3,Legnacra,3006,1042,40,44,84,47.6%,42m
15522,2,[Ash3s]jay,3006,870,32,27,59,54.2%,15m
15522,1,LikeAToss,3006,573,23,13,36,63.9%,11m
15522,3,[BLZ]Blaze,3006,514,22,22,44,50.0%,4m
15522,3,Serveo,3006,464,15,32,47,31.9%,5m
15522,2,Nibsey,3006,276,10,5,15,66.7%,38m
15522,1,Crimson,3006,342,10,12,22,45.5%,39m
15522,1,goldenface,3006,224,7,7,14,50.0%,20m
15522,1,[Exper]ERICK,3006,140,4,7,11,36.4%,24m
15522,2,Omega,3006,0,3,2,5,60.0%,29m
15522,3,MoLLusK,3006,0,3,3,6,50.0%,8m
15522,2,[VALNCE]Darktek,3006,30,2,1,3,66.7%,22m
15522,2,desty,3006,0,0,1,1,0.0%,41m
15522,2,AngelusGod,3006,0,0,1,1,0.0%,28m
15522,2,Mymbro,3006,0,0,1,1,0.0%,9m
15522,2,[AIlin]Ballod,3006,0,0,1,1,0.0%,12m
15543,1,davthehamma,3005,1731,567,557,1124,50.4%,36m
15543,3,BigToughGuy,3005,1546,165,166,331,49.8%,29m
15543,3,ForgetMeNow,3005,1175,115,101,216,53.2%,29m
15543,1,Nelson,3005,1248,74,44,118,62.7%,4m
15543,1,DrMcB,3005,943,61,56,117,52.1%,41m
15543,1,IronHeadKid,3005,597,32,24,56,57.1%,8m
15543,2,tumanquito,3005,523,27,19,46,58.7%,40m
15543,1,Wolf,3005,561,21,21,42,50.0%,34m
15543,2,[07657]NAEGA,3005,442,18,15,33,54.5%,16m
15543,2,Tachibana,3005,412,14,11,25,56.0%,13m
15543,1,Debussy,3005,304,12,8,20,60.0%,34m
15543,3,[voxy]Vox,3005,300,10,25,35,28.6%,15m
15543,3,bblueberryy,3005,118,7,3,10,70.0%,21m
15543,1,Namei,3005,226,7,10,17,41.2%,17m
15543,2,TeacherTony,3005,116,4,2,6,66.7%,14m
15543,2,Resolution,3005,66,3,2,5,60.0%,18m
15543,1,[xJUSTx]Baxster,3005,114,3,6,9,33.3%,35m
15543,1,[IDDS]InNoVaTiOn,3005,108,3,6,9,33.3%,42m
15543,1,[FzyDG]BLaZe,3005,38,2,2,4,50.0%,34m
15543,2,skooz,3005,0,1,0,1,100.0%,16m
15543,1,TeaLeafGreen,3005,0,1,2,3,33.3%,44m
15543,2,[JEUB]AmbitionsEnd,3005,0,1,4,5,20.0%,29m
15543,2,Spheres,3005,0,0,1,1,0.0%,18m
15543,1,shiv,3005,0,0,1,1,0.0%,3h
15567,1,TheDuck,3004,1631,71,54,125,56.8%,33m
15567,1,Chelmsford,3004,1635,70,74,144,48.6%,41m
15567,1,avilo,3004,467,69,56,125,55.2%,26m
15567,1,[XpKAc]Hoperrs,3004,765,58,38,96,60.4%,39m
15567,1,pwnzer,3004,1535,57,52,109,52.3%,19m
15567,3,Birdenz,3004,316,45,39,84,53.6%,32m
15567,3,[cun7]Brutality,3004,248,20,20,40,50.0%,8m
15567,1,Dreadsiete,3004,514,15,18,33,45.5%,12m
15567,1,Niuzao,3004,256,10,8,18,55.6%,39m
15567,3,tenji,3004,153,8,6,14,57.1%,15m
15567,3,TheCompany,3004,155,8,7,15,53.3%,32m
15567,1,[RAlert]VirtualState,3004,181,8,9,17,47.1%,25m
15567,2,Oenari,3004,209,7,6,13,53.8%,30m
15567,1,Rockable,3004,148,5,6,11,45.5%,14m
15567,1,[SFC]Geofar,3004,185,4,3,7,57.1%,1h
15567,2,Exterminator,3004,86,3,2,5,60.0%,9m
15567,1,[Tcar]IIIIIIIIIIII,3004,0,3,2,5,60.0%,52m
15567,1,GWA,3004,48,2,0,2,100.0%,27m
15567,1,ErickX,3004,38,2,2,4,50.0%,21m
15567,3,IIIIIIIIIIII,3004,97,2,3,5,40.0%,37m
15567,1,[HØST]MentsaN,3004,0,1,2,3,33.3%,8m
15567,2,[SLAMT]Syn,3004,0,1,4,5,20.0%,6m
15567,1,SKKKTHEDK,3004,0,0,3,3,0.0%,34m
15590,3,Thanos,3003,1502,291,277,568,51.2%,15m
15590,1,OrkaBG,3003,1626,114,112,226,50.4%,17m
15590,3,[LQV]Blackwing,3003,1292,103,95,198,52.0%,15m
15590,2,[BSSG]TheFlippity,3003,684,49,41,90,54.4%,14m
15590,3,Crez,3003,1185,46,53,99,46.5%,3m
15590,2,[GGMESP]llllllllllll,3003,706,28,17,45,62.2%,31m
15590,2,Pacox,3003,610,24,19,43,55.8%,4m
15590,1,Lucky,3003,519,20,19,39,51.3%,41m
15590,3,IIIIIIIIIIII,3003,600,20,33,53,37.7%,19m
15590,3,PNUTBTRFLCN,3003,402,18,21,39,46.2%,16m
15590,1,Cuddles,3003,192,6,8,14,42.9%,26m
15590,2,Flash,3003,142,5,5,10,50.0%,40m
15590,3,ElleWhySee,3003,114,5,12,17,29.4%,40m
15590,2,AmeircaNOOB,3003,116,4,2,6,66.7%,16m
15590,1,Timheid,3003,64,4,3,7,57.1%,11m
15590,2,Kalion,3003,176,4,4,8,50.0%,9m
15590,2,CAPTCAPSLOCK,3003,46,3,4,7,42.9%,3h
15590,1,STeven,3003,36,2,2,4,50.0%,11m
15590,2,ricci,3003,30,1,1,2,50.0%,11m
15590,2,Bear,3003,32,1,2,3,33.3%,29m
15590,2,Elber,3003,30,1,2,3,33.3%,24m
15590,2,[NLDSG]GuyInGrey,3003,0,0,2,2,0.0%,5m
15590,1,PoppaSmurph,3003,0,0,3,3,0.0%,13m
15590,1,demon,3003,0,0,6,6,0.0%,34m
15614,1,ChilliPadi,3002,1520,108,78,186,58.1%,36m
15614,3,feebdaed,3002,973,35,36,71,49.3%,44m
15614,1,FXmarc,3002,437,29,20,49,59.2%,6m
15614,1,Tfunk,3002,390,23,14,37,62.2%,40m
15614,3,IcomefromEU,3002,361,20,16,36,55.6%,43m
15614,1,Offer,3002,222,20,16,36,55.6%,35m
15614,3,Nomaad,3002,134,19,24,43,44.2%,32m
15614,1,[Xpk]Jedi,3002,557,18,25,43,41.9%,39m
15614,2,BOSSPROPHET,3002,366,15,5,20,75.0%,25m
15614,3,Praziquantel,3002,333,14,10,24,58.3%,19m
15614,3,Jupiter,3002,212,14,13,27,51.9%,37m
15614,3,Yumulcak,3002,30,5,5,10,50.0%,40m
15614,2,[Moo0]SCvirgin,3002,86,3,7,10,30.0%,29m
15614,2,[EndPro]Wesnoth,3002,32,2,2,4,50.0%,5m
15614,1,[2TETON]MySteez,3002,0,2,3,5,40.0%,14m
15614,2,Jericho,3002,0,0,1,1,0.0%,4m
15614,2,GrumpyMonk,3002,0,0,1,1,0.0%,9m
15614,1,Stoic,3002,0,0,6,6,0.0%,35m
15632,2,Samaitch,3001,1519,160,163,323,49.5%,36m
15632,1,premiere,3001,1008,89,83,172,51.7%,34m
15632,1,SwissCheese,3001,1527,80,86,166,48.2%,23m
15632,1,Zac,3001,1596,66,60,126,52.4%,26m
15632,1,[Xpk]JFX,3001,1192,56,51,107,52.3%,41m
15632,1,kimjang,3001,1352,49,47,96,51.0%,14m
15632,1,zfymei,3001,469,48,38,86,55.8%,44m
15632,1,[MaxWin]BRODOZING,3001,727,24,22,46,52.2%,29m
15632,1,GilbertSicot,3001,536,21,18,39,53.8%,40m
15632,2,[tickly]FurryWolfOwO,3001,351,16,5,21,76.2%,23m
15632,1,Ícaro,3001,356,11,15,26,42.3%,12m
15632,3,TofuMan,3001,195,7,1,8,87.5%,6m
15632,2,Dutchy,3001,117,5,4,9,55.6%,1h
15632,2,lllllllllllI,3001,92,4,1,5,80.0%,19m
15632,2,EmperorDave,3001,128,4,1,5,80.0%,10m
15632,1,Shikikan,3001,129,4,4,8,50.0%,29m
15632,1,Hatz,3001,80,3,5,8,37.5%,23m
15632,1,Natibo,3001,159,3,5,8,37.5%,43m
15632,1,[LoC]zpsLoC,3001,110,3,8,11,27.3%,44m
15632,1,Bloodwolf,3001,44,2,6,8,25.0%,42m
15632,1,[T1AM]andrews,3001,80,2,8,10,20.0%,26m
15632,3,[ProKRS]Natorade,3001,30,1,8,9,11.1%,14m
15632,2,[Stra]DArkBomb,3001,0,0,1,1,0.0%,19m
15655,2,[LGNxx]ChaosEnergy,3000,924,316,327,643,49.1%,7m
15655,3,rickybobby,3000,1189,150,137,287,52.3%,19m
15655,2,[juggr]NapTime,3000,1545,133,152,285,46.7%,42m
15655,2,iloveoov,3000,1627,110,65,175,62.9%,9m
15655,1,SudoSu,3000,1025,94,81,175,53.7%,11m
15655,3,Kyzight,3000,1399,78,89,167,46.7%,36m
15655,1,Hippery,3000,1179,40,39,79,50.6%,9m
15655,1,djtone,3000,685,30,26,56,53.6%,40m
15655,1,sanguine,3000,819,29,26,55,52.7%,30m
15655,1,SirBeaker,3000,723,27,24,51,52.9%,7m
15655,3,Walrai,3000,592,23,28,51,45.1%,13m
15655,2,TheOneking,3000,384,19,2,21,90.5%,29m
15655,1,MRmunagi,3000,461,13,14,27,48.1%,25m
15655,1,[TGosuB]ShinyDialga,3000,324,12,7,19,63.2%,1h
15655,2,MaRiNe,3000,340,12,13,25,48.0%,39m
15655,1,PremierBush,3000,421,12,20,32,37.5%,20m
15655,1,[F0]uDieNoW,3000,233,9,9,18,50.0%,12m
15655,1,KopiOAis,3000,204,9,10,19,47.4%,42m
15655,1,[BNEB]GhostTK,3000,117,7,11,18,38.9%,13m
15655,2,Nomames,3000,81,5,1,6,83.3%,4m
15655,3,[0AAA1]Lion,3000,0,5,2,7,71.4%,2h
15655,1,vincter,3000,178,5,5,10,50.0%,15m
15655,1,DTerran,3000,88,4,3,7,57.1%,38m
15655,1,Decreed,3000,106,4,4,8,50.0%,12m
15655,1,omar,3000,152,3,6,9,33.3%,34m
15655,2,WiLLieNeLSoN,3000,34,2,1,3,66.7%,6m
15655,2,[haidua]quocnguyen,3000,60,2,3,5,40.0%,11m
15655,2,papa,3000,32,1,2,3,33.3%,19m
15655,1,HotDog,3000,36,1,4,5,20.0%,14m
15655,2,[TLAN]Timbits,3000,0,0,3,3,0.0%,39m
15655,1,[OceanT]DiegoS,3000,0,0,6,6,0.0%,36m
15686,3,GaryLau,2999,1539,409,380,789,51.8%,37m
15686,3,EdLightbring,2999,708,29,24,53,54.7%,22m
15686,1,[UpxV]tuclavo,2999,474,18,15,33,54.5%,39m
15686,3,snowflake,2999,315,15,13,28,53.6%,13m
15686,1,[PAICHE]KIOUJI,2999,408,12,16,28,42.9%,35m
15686,1,TheZVirus,2999,276,9,13,22,40.9%,38m
15686,1,RobotWizard,2999,235,7,8,15,46.7%,40m
15686,1,IIIIIIIIIIII,2999,236,7,10,17,41.2%,16m
15686,3,[NrFms]MaD,2999,230,7,18,25,28.0%,14m
15686,2,[lKoDl]DevilDog,2999,86,4,1,5,80.0%,28m
15686,1,Jabovl,2999,150,4,8,12,33.3%,33m
15686,1,Hopesend,2999,70,2,4,6,33.3%,18m
15686,2,[PhdX]Mentat,2999,0,1,0,1,100.0%,31m
15686,3,Hellteck,2999,0,1,0,1,100.0%,44m
15686,2,[Fir3s]LED,2999,30,1,1,2,50.0%,11m
15686,1,IIIIIIIIIIII,2999,48,1,1,2,50.0%,1h
15686,2,[QcScT]LeCanardFou,2999,30,1,2,3,33.3%,10m
15686,2,[Ahern]AnGrMaNaGmnt,2999,30,1,3,4,25.0%,15m
15686,2,Canuck,2999,30,1,3,4,25.0%,27m
15686,1,GREMORY,2999,38,1,6,7,14.3%,32m
15686,2,Abiel,2999,0,0,1,1,0.0%,16m
15686,1,Ardin,2999,0,0,2,2,0.0%,37m
15686,2,Mastercard,2999,0,0,3,3,0.0%,34m
15709,1,KarateMonkey,2998,1708,461,439,900,51.2%,4m
15709,2,BatChat,2998,1606,163,131,294,55.4%,33m
15709,2,BigDubbz,2998,1387,58,52,110,52.7%,31m
15709,1,[cluez]AbGolfing,2998,884,35,27,62,56.5%,10m
15709,1,[CHEEKS]cdkid,2998,837,27,27,54,50.0%,26m
15709,2,[Msia]GewenG,2998,426,17,12,29,58.6%,18m
15709,1,Blade,2998,524,17,24,41,41.5%,27m
15709,1,[Kappa]sweffymo,2998,528,15,22,37,40.5%,26m
15709,1,Tomboh,2998,241,9,9,18,50.0%,46m
15709,1,RandomTraini,2998,262,8,7,15,53.3%,12m
15709,1,Val,2998,89,4,3,7,57.1%,12m
15709,2,[IIlIlI]NachoRex,2998,60,3,1,4,75.0%,41m
15709,1,Nematic,2998,116,3,9,12,25.0%,14m
15709,1,DIOMEDES,2998,78,2,6,8,25.0%,40m
15709,2,Luonidas,2998,0,1,0,1,100.0%,7m
15709,2,LoCo,2998,0,0,1,1,0.0%,39m
15709,2,Dembeh,2998,0,0,2,2,0.0%,5m
15709,3,Gerard,2998,0,0,2,2,0.0%,1h
15709,1,PINHEAD,2998,0,0,6,6,0.0%,38m
15728,1,Antho,2997,1610,213,198,411,51.8%,24m
15728,3,Exclamation,2997,1542,167,161,328,50.9%,4m
15728,2,UserTh,2997,1704,120,94,214,56.1%,31m
15728,3,HerrFrost,2997,1467,105,104,209,50.2%,42m
15728,1,[TeamSC]CptPaquin,2997,1447,84,64,148,56.8%,15m
15728,1,SeekingAlpha,2997,1433,82,71,153,53.6%,39m
15728,2,feierlaune,2997,1529,67,52,119,56.3%,43m
15728,1,TheVade,2997,1619,63,57,120,52.5%,36m
15728,1,FinalWitness,2997,1699,63,64,127,49.6%,43m
15728,1,NoBushido,2997,573,48,46,94,51.1%,39m
15728,1,[GDJ]Akuma,2997,647,45,41,86,52.3%,11m
15728,1,[Kusshh]Chiu,2997,1152,44,39,83,53.0%,17m
15728,3,[Atone]Architect,2997,1078,43,40,83,51.8%,15m
15728,2,AMERKING,2997,1144,42,40,82,51.2%,32m
15728,3,CaptH,2997,1015,41,37,78,52.6%,43m
15728,1,Tiger,2997,877,27,38,65,41.5%,39m
15728,1,lIIIlllIllI,2997,284,9,12,21,42.9%,38m
15728,1,TSQN,2997,300,8,14,22,36.4%,24m
15728,1,LeatherBoy,2997,97,5,5,10,50.0%,38m
15728,3,[GetThm]TrootsMagoot,2997,0,4,3,7,57.1%,1h
15728,1,Sophie,2997,0,3,2,5,60.0%,1h
15728,2,Titin,2997,0,3,2,5,60.0%,9m
15728,2,[Astute]Anomalist,2997,0,0,1,1,0.0%,24m
15728,2,[PTHero]Janpol,2997,0,0,1,1,0.0%,9m
15728,2,alexspach,2997,0,0,1,1,0.0%,19m
15753,1,TrumpLostLOL,2996,1664,197,172,369,53.4%,12m
15753,2,Ghost,2996,1148,145,127,272,53.3%,10m
15753,1,WhatThe,2996,435,101,100,201,50.2%,15m
15753,1,Hilario,2996,1621,63,57,120,52.5%,24m
15753,2,[H0D0R]chris,2996,1205,51,42,93,54.8%,33m
15753,1,[OndaVT]Frank,2996,694,45,28,73,61.6%,36m
15753,1,eternalnoobj,2996,997,40,40,80,50.0%,12m
15753,1,purplepotato,2996,627,37,31,68,54.4%,35m
15753,1,brinky,2996,715,26,25,51,51.0%,40m
15753,1,salamandah,2996,471,23,17,40,57.5%,22m
15753,1,[ZEAG]Lavenders,2996,564,21,19,40,52.5%,7m
15753,1,Papadiche,2996,417,14,13,27,51.9%,34m
15753,1,HighAsHell,2996,258,8,11,19,42.1%,11m
15753,1,tko,2996,262,8,13,21,38.1%,19m
15753,2,Sephex,2996,150,6,4,10,60.0%,39m
15753,3,Zyrnak,2996,40,5,4,9,55.6%,2h
15753,2,Mixta,2996,118,5,4,9,55.6%,3h
15753,1,Mardel,2996,110,4,5,9,44.4%,31m
15753,2,Earthquake,2996,68,3,1,4,75.0%,11m
15753,2,ImYoona,2996,0,3,2,5,60.0%,5m
15753,2,[BHOG]doctorplug,2996,0,1,0,1,100.0%,25m
15753,2,[PERUII]SoyElCuco,2996,34,1,1,2,50.0%,6m
15753,3,Random,2996,0,1,2,3,33.3%,3m
15753,2,BPirtle,2996,0,0,1,1,0.0%,33m
15753,1,Ali,2996,0,0,1,1,0.0%,3h
15778,3,Havoc,2995,803,296,284,580,51.0%,10m
15778,1,pickemups,2995,1704,247,234,481,51.4%,15m
15778,3,[lab317]kaapsingle,2995,1567,189,183,372,50.8%,33m
15778,3,aztrozon,2995,1559,127,138,265,47.9%,11m
15778,2,[AVGGS]ImanDMC,2995,1548,101,84,185,54.6%,15m
15778,2,Hamson,2995,1641,90,88,178,50.6%,4m
15778,2,fenor,2995,1523,69,46,115,60.0%,39m
15778,2,Rithia,2995,1466,65,50,115,56.5%,16m
15778,2,[CTFX]bergeskjold,2995,1338,63,58,121,52.1%,39m
15778,3,owlptr,2995,1551,63,60,123,51.2%,29m
15778,1,[REDI]DrKrieger,2995,1136,51,45,96,53.1%,6m
15778,1,Loopy,2995,494,15,20,35,42.9%,20m
15778,1,Kenpanda,2995,200,14,16,30,46.7%,29m
15778,2,[CnfOD]iacta,2995,267,10,10,20,50.0%,27m
15778,1,oiuytu,2995,386,10,17,27,37.0%,21m
15778,3,grkblazin,2995,0,5,1,6,83.3%,1h
15778,1,Redsky,2995,122,5,7,12,41.7%,34m
15778,2,[TDoc]Davidiboy,2995,90,4,3,7,57.1%,5m
15778,3,Boom,2995,143,4,3,7,57.1%,4m
15778,1,[ORGu]Optimus,2995,0,3,1,4,75.0%,3h
15778,2,xboxsignout,2995,36,2,1,3,66.7%,12m
15778,2,cgad,2995,30,2,1,3,66.7%,7m
15778,2,[LDUwU]Thor,2995,0,0,1,1,0.0%,39m
15778,2,Zero,2995,0,0,5,5,0.0%,11m
15802,2,KingEagle,2994,1632,89,69,158,56.3%,9m
15802,3,USSYamatoJPN,2994,1352,73,59,132,55.3%,21m
15802,2,QQQQ,2994,431,16,14,30,53.3%,7m
15802,1,DeadDevil,2994,440,15,16,31,48.4%,33m
15802,1,OmAr,2994,317,13,7,20,65.0%,32m
15802,3,Gaspard,2994,282,10,18,28,35.7%,10m
15802,1,TinJuice,2994,211,6,10,16,37.5%,44m
15802,2,JKyOz,2994,190,5,5,10,50.0%,37m
15802,3,Meropenem,2994,122,4,5,9,44.4%,59m
15802,1,[LoTD]Afora,2994,38,4,5,9,44.4%,26m
15802,2,Toodles,2994,114,3,1,4,75.0%,36m
15802,3,Neat,2994,88,3,13,16,18.8%,37m
15802,2,cajhhu,2994,32,2,1,3,66.7%,28m
15802,3,Putinjjang,2994,0,1,0,1,100.0%,59m
15802,3,Advncd,2994,0,1,1,2,50.0%,26m
15802,2,[HØST]MeThOd,2994,0,1,1,2,50.0%,40m
15802,2,IIIIIIIIIIII,2994,32,1,2,3,33.3%,18m
15802,2,[DDoDD]DirtyJ,2994,0,0,1,1,0.0%,37m
15820,1,glombardig,2993,1436,136,124,260,52.3%,43m
15820,1,krouw,2993,1424,60,54,114,52.6%,4m
15820,2,robotninja,2993,1364,58,54,112,51.8%,29m
15820,1,Phain,2993,1128,45,45,90,50.0%,7m
15820,3,Attornatum,2993,736,42,42,84,50.0%,13m
15820,3,HaUNTED,2993,974,35,46,81,43.2%,15m
15820,1,ReploID,2993,777,27,33,60,45.0%,7m
15820,1,dangerski,2993,756,25,25,50,50.0%,36m
15820,1,Chronosapien,2993,572,24,16,40,60.0%,34m
15820,2,Lanre,2993,650,23,21,44,52.3%,18m
15820,2,dead,2993,564,22,14,36,61.1%,12m
15820,2,smigs,2993,474,18,13,31,58.1%,41m
15820,2,[nd83]RoboBear,2993,400,14,13,27,51.9%,19m
15820,2,Darboux,2993,203,9,6,15,60.0%,44m
15820,3,[MNR75]mrmetal,2993,236,8,13,21,38.1%,43m
15820,3,IllI,2993,135,3,7,10,30.0%,48m
15820,2,EternalRest,2993,62,2,1,3,66.7%,31m
15820,2,FRAXINUS,2993,62,2,3,5,40.0%,34m
15820,2,MagicProtoss,2993,58,2,4,6,33.3%,5m
15820,3,[TxPain]Vagician,2993,93,1,1,2,50.0%,3h
15820,2,TheFlash,2993,0,0,1,1,0.0%,18m
15820,1,blinkzelot,2993,0,0,4,4,0.0%,3h
15842,3,[LqF]fluffybunny,2992,1385,156,152,308,50.6%,19m
15842,3,jash,2992,1544,130,123,253,51.4%,40m
15842,1,Bamboo,2992,1342,94,95,189,49.7%,4m
15842,3,[SC2BOL]Neo,2992,840,66,68,134,49.3%,13m
15842,1,Tradegoods,2992,1099,59,47,106,55.7%,41m
15842,3,[281]Spacemarine,2992,815,57,57,114,50.0%,33m
15842,1,RedFlag,2992,1393,52,49,101,51.5%,26m
15842,2,lich,2992,925,42,25,67,62.7%,28m
15842,2,Ricqles,2992,479,23,5,28,82.1%,29m
15842,2,ipad,2992,529,22,14,36,61.1%,24m
15842,2,Loki,2992,336,13,8,21,61.9%,5m
15842,1,One,2992,295,12,8,20,60.0%,12m
15842,1,pandaSmart,2992,210,6,10,16,37.5%,20m
15842,3,AstorFL,2992,0,4,3,7,57.1%,16m
15842,2,[cnuo]Santiago,2992,62,3,2,5,60.0%,39m
15842,1,ForFonMoFos,2992,0,3,2,5,60.0%,31m
15842,2,wtf,2992,38,2,1,3,66.7%,29m
15842,2,MaJLioN,2992,0,2,3,5,40.0%,22m
15842,1,Pdizzle,2992,82,2,6,8,25.0%,36m
15842,2,[NewLeg]LTdan,2992,34,1,2,3,33.3%,15m
15842,2,SKORP,2992,0,0,1,1,0.0%,24m
15842,2,[PuStLe]infestorOP,2992,0,0,1,1,0.0%,29m
15842,2,[PiGPan]PitaEnigma,2992,0,0,1,1,0.0%,1h
15842,2,babyface,2992,0,0,1,1,0.0%,19m
15842,2,[WNTRLH]CaoCao,2992,0,0,2,2,0.0%,26m
15867,2,biwie,2991,1665,284,248,532,53.4%,33m
15867,3,[LY0]ELSULTAN,2991,1567,244,243,487,50.1%,37m
15867,1,CLOBBAHD,2991,1664,71,77,148,48.0%,20m
15867,1,Raptor,2991,1090,46,43,89,51.7%,34m
15867,1,David,2991,694,29,23,52,55.8%,24m
15867,3,SnowKing,2991,750,28,39,67,41.8%,37m
15867,1,Krowld,2991,566,21,18,39,53.8%,43m
15867,2,[SBLAC]IIIIIII,2991,504,20,10,30,66.7%,41m
15867,2,[FyHr]CharlyCox,2991,456,17,14,31,54.8%,41m
15867,3,djuret,2991,277,12,12,24,50.0%,32m
15867,1,[D1360]DIEGO,2991,320,11,11,22,50.0%,11m
15867,2,Fergy,2991,172,6,4,10,60.0%,21m
15867,2,DanBass,2991,52,3,0,3,100.0%,41m
15867,2,[PCAKE]InFaMouS,2991,60,3,0,3,100.0%,4m
15867,2,Cross,2991,0,3,2,5,60.0%,22m
15867,3,Dotori,2991,118,3,4,7,42.9%,9m
15867,3,Guhl,2991,133,2,3,5,40.0%,1h
15867,2,RescueRanger,2991,0,2,3,5,40.0%,26m
15867,2,Sol,2991,0,1,0,1,100.0%,15m
15867,3,[MNGOMN]JAS,2991,0,0,2,2,0.0%,32m
15867,3,redbird,2991,0,0,2,2,0.0%,57m
15888,1,Zyk,2990,794,149,130,279,53.4%,44m
15888,2,KarateKid,2990,1016,50,36,86,58.1%,29m
15888,2,[DuuDuu]BabyShark,2990,990,43,26,69,62.3%,37m
15888,3,Gaia,2990,827,33,43,76,43.4%,16m
15888,1,[GUCCl]RallyHearts,2990,558,19,17,36,52.8%,35m
15888,1,Berserker,2990,498,16,17,33,48.5%,24m
15888,1,swarmCore,2990,276,10,8,18,55.6%,27m
15888,3,KLooLESS,2990,212,9,9,18,50.0%,18m
15888,1,JonYachi,2990,0,5,1,6,83.3%,4m
15888,2,yOOK,2990,88,3,2,5,60.0%,30m
15888,1,Laflor,2990,0,3,2,5,60.0%,3h
15888,2,Firechess,2990,44,2,1,3,66.7%,1h
15888,2,snipsuper,2990,0,2,2,4,50.0%,39m
15888,1,[EGx]Varitech,2990,48,2,5,7,28.6%,3h
15888,2,[nieBla]daniov,2990,0,1,0,1,100.0%,10m
15888,2,Aether,2990,0,1,0,1,100.0%,29m
15888,2,xXxAStarxXx,2990,34,1,3,4,25.0%,15m
15888,2,Shadow,2990,0,0,1,1,0.0%,12m
15906,2,Stormtrooper,2989,1569,92,83,175,52.6%,11m
15906,2,[Pig2]Snelly,2989,991,77,65,142,54.2%,25m
15906,1,[TGosuB]ATCRacer,2989,1138,70,64,134,52.2%,40m
15906,1,[MITROM]slyshni,2989,1385,63,55,118,53.4%,35m
15906,2,John,2989,891,46,19,65,70.8%,41m
15906,1,Plas,2989,1074,38,35,73,52.1%,39m
15906,2,[SWRqc]LayeX,2989,708,26,24,50,52.0%,20m
15906,2,[xRtGac]Medivac,2989,477,18,13,31,58.1%,30m
15906,1,tukchero,2989,412,12,18,30,40.0%,35m
15906,1,BlackMamba,2989,152,9,6,15,60.0%,13m
15906,1,kwade,2989,168,8,4,12,66.7%,27m
15906,1,SneakySquid,2989,190,7,8,15,46.7%,44m
15906,2,YellingBird,2989,165,6,6,12,50.0%,8m
15906,1,heeyupchung,2989,97,5,2,7,71.4%,1h
15906,1,[GaiLo]Everest,2989,89,2,1,3,66.7%,41m
15906,2,[eXtra1]ShinyPants,2989,0,1,0,1,100.0%,32m
15906,2,[DayJ]RanDomFox,2989,0,1,1,2,50.0%,4m
15906,2,WWWWWWWWWWVW,2989,0,0,1,1,0.0%,18m
15906,2,Brute,2989,0,0,1,1,0.0%,4m
15906,3,[sinner]Convicted,2989,0,0,1,1,0.0%,1h
15926,2,Ert,2988,1630,238,262,500,47.6%,36m
15926,3,MaxReaver,2988,1365,137,131,268,51.1%,14m
15926,2,[z2o]Melvin,2988,1578,83,58,141,58.9%,39m
15926,2,VincentK,2988,1586,76,58,134,56.7%,16m
15926,1,Albi,2988,852,42,32,74,56.8%,34m
15926,2,noba,2988,908,35,27,62,56.5%,18m
15926,2,InformerHawk,2988,770,31,19,50,62.0%,10m
15926,1,CCAdv,2988,639,23,24,47,48.9%,34m
15926,1,Kira,2988,304,20,17,37,54.1%,36m
15926,1,GOGOplata,2988,426,18,13,31,58.1%,40m
15926,2,Peter,2988,357,15,13,28,53.6%,31m
15926,2,[Wat3rs]slyfox,2988,334,13,14,27,48.1%,37m
15926,2,Asnofyx,2988,230,9,5,14,64.3%,14m
15926,2,RiskyBobby,2988,184,5,1,6,83.3%,32m
15926,2,LinKiN,2988,95,5,4,9,55.6%,36m
15926,1,JediTexan,2988,0,4,2,6,66.7%,11m
15926,1,BJwin,2988,60,3,3,6,50.0%,10m
15926,2,Espionage,2988,23,2,2,4,50.0%,5m
15926,1,OwO,2988,76,2,7,9,22.2%,34m
15926,2,Ravioli,2988,92,1,1,2,50.0%,39m
15926,2,[DTP15]ICHIGO,2988,0,1,1,2,50.0%,16m
15926,2,Nah,2988,0,0,1,1,0.0%,11m
15948,1,[NLTN]QuirkyTurtle,2987,1652,163,156,319,51.1%,38m
15948,1,Tmoney,2987,1569,96,85,181,53.0%,13m
15948,1,[Pirata]PatoTopa,2987,1221,58,49,107,54.2%,6m
15948,1,Wanderer,2987,1319,53,44,97,54.6%,43m
15948,1,[xLgNx]shummy,2987,1135,50,40,90,55.6%,12m
15948,1,Altervise,2987,1032,36,34,70,51.4%,35m
15948,1,kaboosH,2987,988,36,36,72,50.0%,28m
15948,3,wakwakwak,2987,900,32,36,68,47.1%,44m
15948,1,[Ozzie]Tatsuyi,2987,722,25,26,51,49.0%,34m
15948,1,Nopolo,2987,422,14,16,30,46.7%,20m
15948,1,[LoShay]Patoxlol,2987,354,12,12,24,50.0%,16m
15948,2,Skankhunt,2987,202,10,7,17,58.8%,33m
15948,3,Jarriquoite,2987,151,6,7,13,46.2%,28m
15948,2,lapengu,2987,174,5,3,8,62.5%,24m
15948,2,JoePesci,2987,94,4,1,5,80.0%,29m
15948,1,Barcraft,2987,164,4,4,8,50.0%,33m
15948,1,[Puch]izel,2987,146,4,7,11,36.4%,16m
15948,2,[DMT1]bigcHENDO,2987,158,2,8,10,20.0%,7m
15948,2,[DSP]mSpazKNX,2987,0,1,0,1,100.0%,5m
15948,2,KBG,2987,0,1,0,1,100.0%,6m
15948,2,Zimbru,2987,0,1,0,1,100.0%,13m
15948,2,[sk3tch]TaiwanCheEZ,2987,0,1,1,2,50.0%,29m
15948,2,[FU2]BlackSlice,2987,30,1,1,2,50.0%,18m
15948,2,[425]Buymyrice,2987,30,1,3,4,25.0%,39m
15948,3,Darko,2987,0,0,1,1,0.0%,30m
15948,2,[RLA]DragonBlood,2987,0,0,1,1,0.0%,24m
15948,1,[Zohner]DrHapi,2987,0,0,6,6,0.0%,3h
15948,1,zachvac,2987,0,0,7,7,0.0%,41m
15976,3,[ConFed]George,2986,1511,219,218,437,50.1%,15m
15976,3,Phoenix,2986,1183,66,70,136,48.5%,19m
15976,2,PruneHead,2986,710,27,20,47,57.4%,19m
15976,2,Ferrell,2986,522,18,16,34,52.9%,30m
15976,3,Future,2986,206,8,16,24,33.3%,32m
15976,2,DeathMagnet,2986,162,5,1,6,83.3%,7m
15976,1,TroudBâl,2986,0,4,1,5,80.0%,1h
15976,1,Jack,2986,128,4,3,7,57.1%,12m
15976,1,GoodBacteria,2986,100,4,8,12,33.3%,11m
15976,3,eZZeCuTeR,2986,98,4,14,18,22.2%,43m
15976,3,TheHoodrat,2986,108,3,1,4,75.0%,32m
15976,1,moths,2986,0,3,2,5,60.0%,14m
15976,1,Milhouse,2986,0,3,2,5,60.0%,3h
15976,1,TWAMPSACK,2986,0,3,2,5,60.0%,1h
15976,2,Reeek,2986,0,3,2,5,60.0%,11m
15976,2,StEboSnooze,2986,0,3,2,5,60.0%,16m
15976,2,[DDragB]Ceeeeeeee,2986,30,1,2,3,33.3%,18m
15976,2,MauroCL,2986,0,0,2,2,0.0%,15m
15976,2,Neldoreth,2986,0,0,5,5,0.0%,9m
15995,3,Synergy,2985,1414,322,320,642,50.2%,40m
15995,3,paul,2985,1501,262,261,523,50.1%,6m
15995,2,CachoSnacks,2985,1583,158,139,297,53.2%,11m
15995,3,HappyRonny,2985,1490,153,141,294,52.0%,6m
15995,1,PoLard,2985,1690,137,126,263,52.1%,26m
15995,2,Envy,2985,1463,115,95,210,54.8%,35m
15995,1,Triton,2985,1115,94,96,190,49.5%,36m
15995,2,musclesmark,2985,875,33,30,63,52.4%,19m
15995,2,MTRLRX,2985,731,29,21,50,58.0%,29m
15995,2,[TGosuA]OtterFamily,2985,588,22,16,38,57.9%,23m
15995,3,[COVD20]XXXOrNothing,2985,620,19,34,53,35.8%,6m
15995,1,Keenbo,2985,536,17,17,34,50.0%,18m
15995,1,[cl0udM]Paradox,2985,446,15,15,30,50.0%,10m
15995,1,Rook,2985,396,13,11,24,54.2%,26m
15995,1,LICHTKRIEGER,2985,262,11,6,17,64.7%,17m
15995,3,GuestAGuy,2985,320,10,21,31,32.3%,44m
15995,2,Imperium,2985,236,8,6,14,57.1%,18m
15995,3,[1TL]DrWhalePants,2985,189,6,13,19,31.6%,33m
15995,2,[YALL]waltrey,2985,122,5,1,6,83.3%,10m
15995,1,Hydriad,2985,194,5,8,13,38.5%,38m
15995,1,WizarD,2985,148,5,10,15,33.3%,12m
15995,2,[YUNHAO]poosy,2985,30,4,2,6,66.7%,15m
15995,2,Necro,2985,58,2,4,6,33.3%,4m
15995,2,jedicouncil,2985,0,1,0,1,100.0%,6m
15995,2,[ALQ]Gorilla,2985,0,1,1,2,50.0%,30m
15995,1,Dyckshanker,2985,0,1,5,6,16.7%,34m
15995,2,Chewie,2985,0,0,1,1,0.0%,26m
16022,2,SHICE,2984,1409,121,109,230,52.6%,18m
16022,1,[LaOr]Abner,2984,1294,110,101,211,52.1%,12m
16022,1,[EvilGC]Arks,2984,1515,87,81,168,51.8%,36m
16022,2,ChenCheng,2984,1015,50,30,80,62.5%,21m
16022,1,[hikari]lilystar,2984,1053,50,52,102,49.0%,16m
16022,1,waldoz,2984,548,38,35,73,52.1%,34m
16022,1,INnoVatino,2984,640,31,28,59,52.5%,18m
16022,2,[SHle]Sergio,2984,614,22,15,37,59.5%,12m
16022,1,Blake,2984,690,21,23,44,47.7%,14m
16022,2,SoL,2984,297,12,3,15,80.0%,14m
16022,2,Jaraxxus,2984,310,12,5,17,70.6%,5m
16022,3,[Zosha]tOmOrrOw,2984,287,11,4,15,73.3%,28m
16022,2,Kale,2984,118,5,3,8,62.5%,21m
16022,1,PwnsDeLeon,2984,0,3,2,5,60.0%,29m
16022,2,HomerSimpson,2984,30,1,2,3,33.3%,8m
16022,2,Sazor,2984,0,0,1,1,0.0%,8m
16022,2,Zoa,2984,0,0,1,1,0.0%,6m
16022,2,ace,2984,0,0,1,1,0.0%,6m
16022,2,ShadowEmpire,2984,0,0,2,2,0.0%,24m
16041,3,OrdinaryNot,2983,1501,200,190,390,51.3%,26m
16041,1,NOLAX,2983,1682,106,108,214,49.5%,43m
16041,1,[Meadow]RatedMforPie,2983,1590,68,56,124,54.8%,24m
16041,1,kai,2983,1503,64,58,122,52.5%,37m
16041,1,Alyeva,2983,1101,41,36,77,53.2%,12m
16041,3,Drake,2983,322,40,35,75,53.3%,6m
16041,1,KingSimp,2983,582,33,21,54,61.1%,7m
16041,3,ColonelDude,2983,728,26,37,63,41.3%,5m
16041,1,Macromyers,2983,437,22,13,35,62.9%,24m
16041,1,Kuzurii,2983,409,16,14,30,53.3%,27m
16041,2,LtDerp,2983,350,15,9,24,62.5%,9m
16041,2,LTDan,2983,182,9,7,16,56.2%,42m
16041,2,Oblique,2983,120,4,4,8,50.0%,5m
16041,2,Josiah,2983,88,3,2,5,60.0%,19m
16041,1,[Zatra]KeilanMXD,2983,84,2,8,10,20.0%,37m
16041,2,Maniack,2983,0,1,1,2,50.0%,29m
16041,2,[YSHI]Aibi,2983,32,1,2,3,33.3%,22m
16041,1,Spring,2983,88,1,2,3,33.3%,11m
16059,3,[MIAY]Spartano,2982,1617,520,487,1007,51.6%,16m
16059,2,Fractal,2982,1540,178,157,335,53.1%,33m
16059,3,stardust,2982,1489,113,117,230,49.1%,13m
16059,1,[RAID5]Aarjuna,2982,656,43,40,83,51.8%,24m
16059,2,Logan,2982,770,29,27,56,51.8%,4m
16059,2,[ENI]nAzY,2982,221,11,7,18,61.1%,20m
16059,1,Everest,2982,292,11,16,27,40.7%,28m
16059,2,Farhao,2982,196,10,10,20,50.0%,29m
16059,1,Cartz,2982,191,7,4,11,63.6%,33m
16059,2,Kenfucious,2982,239,7,6,13,53.8%,22m
16059,1,Rema,2982,189,7,8,15,46.7%,46m
16059,3,[vodscc]Juice,2982,146,6,4,10,60.0%,59m
16059,2,posets,2982,172,5,2,7,71.4%,23m
16059,2,Nightmoose,2982,0,1,0,1,100.0%,31m
16059,2,idkhowtoplay,2982,30,1,1,2,50.0%,17m
16059,1,SerMaxyy,2982,0,1,2,3,33.3%,24m
16059,2,klink,2982,30,1,3,4,25.0%,28m
16076,3,WERNIX,2981,1562,96,90,186,51.6%,40m
16076,1,TheFlash,2981,1290,49,49,98,50.0%,36m
16076,2,DKDensse,2981,1138,45,37,82,54.9%,39m
16076,1,[SkAL]Almamy,2981,978,37,31,68,54.4%,40m
16076,3,WorldCrusher,2981,399,18,17,35,51.4%,13m
16076,2,[high]zTkerub,2981,383,17,3,20,85.0%,6m
16076,2,NORTHKOR,2981,328,15,10,25,60.0%,25m
16076,2,GLHF,2981,382,15,11,26,57.7%,22m
16076,1,Flash,2981,430,13,18,31,41.9%,26m
16076,2,Emselar,2981,332,12,6,18,66.7%,4m
16076,1,KoralT,2981,284,10,11,21,47.6%,4m
16076,2,Superman,2981,86,4,0,4,100.0%,12m
16076,2,Yoo,2981,0,4,1,5,80.0%,35m
16076,2,Alo,2981,0,4,1,5,80.0%,39m
16076,2,polt,2981,106,4,4,8,50.0%,7m
16076,1,Rankfield,2981,0,3,2,5,60.0%,51m
16076,2,Thraxen,2981,0,1,0,1,100.0%,25m
16076,2,PsychoNitro,2981,30,1,2,3,33.3%,9m
16076,2,GayMaster,2981,30,1,2,3,33.3%,35m
16076,1,[SoVA]StimAddict,2981,0,1,3,4,25.0%,39m
16076,1,darkyun,2981,0,1,4,5,20.0%,40m
16076,2,[TRX]Armin,2981,0,0,1,1,0.0%,15m
16076,2,[Hymir]hackedmines,2981,0,0,1,1,0.0%,35m
16076,2,Gtron,2981,0,0,2,2,0.0%,41m
16076,1,kilian,2981,0,0,4,4,0.0%,8m
16101,1,[RUSC]AviPT,2980,1697,159,155,314,50.6%,27m
16101,3,[Kappa]TerMinal,2980,500,104,99,203,51.2%,15m
16101,3,[Tao]Akadion,2980,1175,48,52,100,48.0%,13m
16101,1,HiddenSquid,2980,934,42,28,70,60.0%,3m
16101,2,HaveFun,2980,766,30,23,53,56.6%,10m
16101,1,Dvo,2980,882,29,33,62,46.8%,17m
16101,1,[ZTemp]burn,2980,489,22,20,42,52.4%,42m
16101,2,[OndaVT]Chato,2980,426,16,12,28,57.1%,28m
16101,2,mrweinen,2980,247,10,9,19,52.6%,9m
16101,2,[DrKatz]Idyl,2980,178,7,7,14,50.0%,29m
16101,1,Ricestrike,2980,0,4,2,6,66.7%,36m
16101,1,OniMuSha,2980,70,3,6,9,33.3%,36m
16101,2,CrypTonight,2980,32,1,1,2,50.0%,25m
16101,2,RYAN,2980,0,1,1,2,50.0%,39m
16101,2,[NAKA]DaddyQ,2980,0,0,1,1,0.0%,13m
16101,2,Aeon,2980,0,0,1,1,0.0%,16m
16117,3,tigre,2979,1528,383,381,764,50.1%,3m
16117,1,Telorchid,2979,1706,95,99,194,49.0%,36m
16117,1,SwarmStorm,2979,916,81,71,152,53.3%,32m
16117,1,LIFTUP,2979,1281,65,39,104,62.5%,17m
16117,1,CERC,2979,1348,49,45,94,52.1%,27m
16117,2,LazyGoat,2979,955,42,27,69,60.9%,25m
16117,2,[SPRCLB]Blaze,2979,645,34,27,61,55.7%,4m
16117,1,Armamani,2979,722,26,22,48,54.2%,10m
16117,2,Marcos,2979,326,13,12,25,52.0%,18m
16117,2,ButWait,2979,211,7,3,10,70.0%,5m
16117,2,karlox,2979,0,1,0,1,100.0%,32m
16117,2,[InGt]jenkins,2979,0,1,2,3,33.3%,12m
16117,2,Kevlar,2979,0,0,1,1,0.0%,25m
16117,2,Synthis,2979,0,0,2,2,0.0%,32m
16117,1,DaDingus,2979,0,0,2,2,0.0%,1h
16132,1,KillerSteve,2978,1163,64,64,128,50.0%,28m
16132,3,Tailon,2978,1458,64,69,133,48.1%,8m
16132,3,[GAMDAI]FlacpJack,2978,661,52,44,96,54.2%,13m
16132,2,TintedHaze,2978,501,48,46,94,51.1%,5m
16132,1,FreeHongKong,2978,1276,45,45,90,50.0%,15m
16132,3,Masterbait,2978,424,15,27,42,35.7%,38m
16132,3,Leon,2978,391,14,28,42,33.3%,7m
16132,2,[Khalta]ARCANGEL,2978,243,11,8,19,57.9%,23m
16132,2,[SOB24]Neocht,2978,240,9,2,11,81.8%,4m
16132,3,DrGaggins,2978,153,6,4,10,60.0%,57m
16132,2,ScholarsMate,2978,30,5,2,7,71.4%,25m
16132,2,[NrFms]llllllllllll,2978,0,3,2,5,60.0%,9m
16132,2,[LOOPY]Cyrus,2978,88,3,3,6,50.0%,39m
16132,2,LegendKiller,2978,36,2,2,4,50.0%,6m
16132,2,[PPLe]Alfanhui,2978,0,2,3,5,40.0%,12m
16132,3,[QP]SEAhidraz,2978,30,2,8,10,20.0%,2m
16132,2,DarkONEdereR,2978,0,1,0,1,100.0%,11m
16132,1,aRogueShark,2978,48,1,1,2,50.0%,2h
16132,1,AdderallXR,2978,0,1,2,3,33.3%,3h
16132,1,SoloQ,2978,0,0,5,5,0.0%,3h
16152,1,Vahl,2977,1621,191,184,375,50.9%,19m
16152,3,[HØST]Dortao,2977,1576,161,158,319,50.5%,33m
16152,3,[Grimes]Zambies,2977,1370,131,136,267,49.1%,21m
16152,1,DGlovPredTwo,2977,1604,118,102,220,53.6%,13m
16152,1,SoulReviver,2977,1481,107,81,188,56.9%,22m
16152,3,[N664]Kfed,2977,1110,91,86,177,51.4%,31m
16152,2,Telvare,2977,935,75,65,140,53.6%,19m
16152,1,FistEmAll,2977,541,33,32,65,50.8%,25m
16152,2,Drake,2977,420,18,7,25,72.0%,29m
16152,2,Humongous,2977,194,6,4,10,60.0%,30m
16152,2,Ngard,2977,142,5,4,9,55.6%,29m
16152,1,skfksmsrhlaf,2977,118,4,2,6,66.7%,24m
16152,2,Quirinus,2977,58,2,1,3,66.7%,11m
16152,1,AndyOh,2977,48,2,3,5,40.0%,35m
16152,2,WhiteRabbit,2977,0,1,0,1,100.0%,12m
16152,1,AnnaTheProbe,2977,0,1,0,1,100.0%,25m
16152,2,[CLoob]ptslammer,2977,30,1,3,4,25.0%,39m
16152,1,[LgnTDS]Hawking,2977,0,1,4,5,20.0%,32m
16152,2,dufeng,2977,0,0,2,2,0.0%,18m
16152,2,[S2I]Professor,2977,0,0,3,3,0.0%,15m
16172,3,TerranFreak,2976,1387,156,149,305,51.1%,30m
16172,3,[NlCER]GiMbO,2976,1529,114,114,228,50.0%,40m
16172,3,Ekanr,2976,271,45,53,98,45.9%,22m
16172,3,[BruC]RSyfer,2976,948,37,34,71,52.1%,19m
16172,1,Sync,2976,469,16,15,31,51.6%,12m
16172,1,Zamkis,2976,229,16,17,33,48.5%,28m
16172,1,Anthony,2976,244,8,11,19,42.1%,21m
16172,1,[Titans]JDX,2976,212,7,13,20,35.0%,41m
16172,3,gamer,2976,94,6,3,9,66.7%,15m
16172,2,Beef,2976,213,6,4,10,60.0%,21m
16172,2,nave,2976,181,5,3,8,62.5%,29m
16172,2,Eredek,2976,64,3,1,4,75.0%,5m
16172,2,VonKilla,2976,94,2,0,2,100.0%,1h
16172,2,CazzRenard,2976,112,2,1,3,66.7%,35m
16172,2,cracks,2976,0,1,0,1,100.0%,12m
16172,2,Watts,2976,0,1,0,1,100.0%,14m
16172,2,FENIX,2976,32,1,1,2,50.0%,5m
16172,2,OlI,2976,30,1,2,3,33.3%,25m
16172,1,[Chosen]MikeMacMan,2976,0,1,3,4,25.0%,12m
16172,2,slayer,2976,0,0,2,2,0.0%,9m
16172,2,[ODBs]KokaneeBeer,2976,0,0,2,2,0.0%,5m
16193,2,[L4Life]SwollenUvula,2975,1625,188,173,361,52.1%,5m
16193,1,Mishup,2975,1542,73,62,135,54.1%,13m
16193,3,LilBibbyGBE,2975,1497,72,76,148,48.6%,36m
16193,1,BloodyZen,2975,799,29,27,56,51.8%,15m
16193,2,[LOEHP]DrFaceFace,2975,492,23,20,43,53.5%,32m
16193,1,Diana,2975,593,22,22,44,50.0%,30m
16193,1,Ryuanh,2975,670,22,27,49,44.9%,36m
16193,2,[DrgLrd]Cyber,2975,430,16,10,26,61.5%,6m
16193,2,haha,2975,264,7,7,14,50.0%,9m
16193,2,Belisarius,2975,88,4,2,6,66.7%,41m
16193,1,WinStonSC,2975,0,3,2,5,60.0%,2h
16193,1,ElDestructor,2975,0,3,3,6,50.0%,24m
16193,1,[kitty1]ShadowPigz,2975,92,2,2,4,50.0%,34m
16193,2,Nystagmus,2975,30,1,2,3,33.3%,36m
16193,2,SethSorenson,2975,88,1,5,6,16.7%,5m
16193,2,[JDG]DECterran,2975,0,0,1,1,0.0%,23m
16209,3,FatChin,2974,1564,147,140,287,51.2%,40m
16209,3,Admiral,2974,1500,118,126,244,48.4%,35m
16209,3,[oisdjs]glllllllllll,2974,1437,100,102,202,49.5%,16m
16209,2,[FORBlD]MouxRaynor,2974,665,39,35,74,52.7%,6m
16209,2,Ladarliang,2974,765,30,24,54,55.6%,5m
16209,2,Jet,2974,636,23,23,46,50.0%,40m
16209,1,[InGt]Outburst,2974,576,16,26,42,38.1%,19m
16209,2,RyeBaz,2974,407,15,13,28,53.6%,16m
16209,2,henry,2974,336,14,7,21,66.7%,7m
16209,1,BronozaurRex,2974,359,13,17,30,43.3%,33m
16209,2,[Pvvny]Elliot,2974,308,11,10,21,52.4%,6m
16209,2,[UED666]UEDbikboi,2974,182,7,6,13,53.8%,10m
16209,1,[C4]Furytek,2974,97,6,0,6,100.0%,3h
16209,1,Squiggz,2974,184,5,9,14,35.7%,28m
16209,2,AryEsWRxX,2974,86,4,1,5,80.0%,33m
16209,1,CouchPotato,2974,48,4,4,8,50.0%,4m
16209,2,BattleBanker,2974,98,3,4,7,42.9%,1m
16209,1,Lucas,2974,70,3,5,8,37.5%,24m
16209,1,kornhouser,2974,95,3,7,10,30.0%,12m
16209,2,Tobeats,2974,0,1,0,1,100.0%,38m
16209,1,StrangeThing,2974,0,1,3,4,25.0%,12m
16209,1,AJD,2974,36,1,7,8,12.5%,12m
16209,2,[NEO]Maverick,2974,0,0,1,1,0.0%,38m
16209,2,Jakaldeen,2974,0,0,1,1,0.0%,30m
16209,1,RatonMopeur,2974,0,0,4,4,0.0%,42m
16234,3,LiquidGhost,2973,1298,108,89,197,54.8%,25m
16234,3,WaLu,2973,1517,95,99,194,49.0%,4m
16234,1,moscht,2973,1595,77,82,159,48.4%,2m
16234,1,HughMyron,2973,1555,68,55,123,55.3%,24m
16234,2,[BPM]basketcase,2973,789,48,33,81,59.3%,29m
16234,1,StudMuffin,2973,900,45,28,73,61.6%,42m
16234,1,[Pro2os]Magi,2973,991,41,33,74,55.4%,26m
16234,1,DreamWave,2973,550,17,23,40,42.5%,38m
16234,3,Oberon,2973,293,12,11,23,52.2%,15m
16234,2,fromteraperu,2973,102,6,4,10,60.0%,16m
16234,2,Slid,2973,128,5,5,10,50.0%,5m
16234,2,Schwarzes,2973,62,3,1,4,75.0%,16m
16234,2,NoPainNoGain,2973,0,3,2,5,60.0%,33m
16234,2,SamuelioX,2973,0,3,2,5,60.0%,39m
16234,1,PILO,2973,0,3,2,5,60.0%,28m
16234,2,Gouda,2973,0,2,4,6,33.3%,41m
16234,2,ChaosTheory,2973,0,1,0,1,100.0%,11m
16234,2,ChinaIsGreat,2973,0,1,0,1,100.0%,20m
16234,3,Alucion,2973,97,1,2,3,33.3%,26m
16234,1,DeMoLeDor,2973,73,1,4,5,20.0%,11m
16234,2,[BlTEL]MuzaHp,2973,0,0,2,2,0.0%,13m
16255,1,TheRustic,2972,1366,101,92,193,52.3%,25m
16255,1,SgtJoker,2972,1583,83,79,162,51.2%,18m
16255,3,Eeks,2972,397,78,68,146,53.4%,36m
16255,3,Munchies,2972,725,61,57,118,51.7%,8m
16255,2,SpetsnazHero,2972,882,55,43,98,56.1%,16m
16255,2,HavokHW,2972,607,47,34,81,58.0%,16m
16255,2,Blex,2972,1176,46,41,87,52.9%,32m
16255,1,exidas,2972,726,33,30,63,52.4%,14m
16255,2,[Box2]YERICOS,2972,674,27,18,45,60.0%,29m
16255,1,PAPANEGRA,2972,558,18,20,38,47.4%,31m
16255,1,MasterMind,2972,316,16,13,29,55.2%,3m
16255,2,Mechulus,2972,402,14,14,28,50.0%,18m
16255,1,[VENSC2]Wasabi,2972,334,11,13,24,45.8%,13m
16255,2,Zephrene,2972,216,7,2,9,77.8%,41m
16255,1,[7eZ]Kakarrot,2972,177,7,6,13,53.8%,14m
16255,1,Vlad,2972,203,6,6,12,50.0%,13m
16255,1,Edzomb,2972,97,5,1,6,83.3%,3h
16255,1,[TekNiQ]TekNiQlogic,2972,90,4,3,7,57.1%,26m
16255,2,LornAuArcos,2972,88,3,2,5,60.0%,36m
16255,3,anthony,2972,131,3,2,5,60.0%,3h
16255,1,LeeYoonYeol,2972,86,3,4,7,42.9%,14m
16255,1,[Flar3s]Coldbrant,2972,121,3,5,8,37.5%,26m
16255,3,WHAAAA,2972,0,3,9,12,25.0%,7m
16255,2,Kimchi,2972,30,2,0,2,100.0%,22m
16255,2,InDIGo,2972,66,2,3,5,40.0%,15m
16255,1,frogzero,2972,72,2,10,12,16.7%,3m
16255,2,ZeroControl,2972,0,1,0,1,100.0%,20m
16255,2,Paragon,2972,0,1,0,1,100.0%,12m
16255,2,Marinebronze,2972,0,1,0,1,100.0%,33m
16255,3,Waffles,2972,0,1,0,1,100.0%,1h
16255,2,[GOPERÚ]Toyvic,2972,0,0,1,1,0.0%,25m
16286,3,Jinx,2971,1557,174,178,352,49.4%,10m
16286,1,DavO,2971,1519,150,128,278,54.0%,33m
16286,1,ban,2971,1591,108,100,208,51.9%,26m
16286,1,blixel,2971,1693,103,102,205,50.2%,30m
16286,1,Wrecker,2971,881,41,30,71,57.7%,30m
16286,1,Rokodalin,2971,717,36,30,66,54.5%,26m
16286,1,MamaniTuCapo,2971,765,33,21,54,61.1%,20m
16286,1,[TSFD]JollyJohn,2971,898,30,33,63,47.6%,11m
16286,1,Lightworld,2971,584,25,19,44,56.8%,24m
16286,2,Shine,2971,575,22,17,39,56.4%,41m
16286,1,[MyStii]ShadowStorm,2971,332,13,10,23,56.5%,15m
16286,1,Jemster,2971,430,12,14,26,46.2%,11m
16286,2,BDRXXL,2971,58,5,8,13,38.5%,16m
16286,2,[GEMC]Titan,2971,58,3,3,6,50.0%,18m
16286,2,TripleAught,2971,60,2,1,3,66.7%,35m
16286,2,EnTaroTofu,2971,0,1,1,2,50.0%,29m
16286,1,Synergy,2971,0,1,1,2,50.0%,3m
16286,1,Redfred,2971,0,1,2,3,33.3%,7m
16286,2,Vegas,2971,0,0,1,1,0.0%,39m
16286,2,Starchy,2971,0,0,1,1,0.0%,10m
16286,2,moose,2971,0,0,2,2,0.0%,20m
16286,1,DeathNinja,2971,0,0,5,5,0.0%,2m
16308,1,LeeRoy,2970,649,105,97,202,52.0%,17m
16308,1,[LGNxx]Darigaz,2970,1318,102,106,208,49.0%,6m
16308,2,Jeremylin,2970,825,57,53,110,51.8%,40m
16308,2,[ValidG]hdmark,2970,960,45,23,68,66.2%,7m
16308,3,nebbeth,2970,1135,45,45,90,50.0%,9m
16308,1,Rexpers,2970,992,33,37,70,47.1%,33m
16308,1,sadescu,2970,781,27,29,56,48.2%,6m
16308,2,Zerg,2970,401,15,13,28,53.6%,10m
16308,1,oWoLucina,2970,420,15,14,29,51.7%,4m
16308,2,ptero,2970,330,12,7,19,63.2%,12m
16308,1,TheShy,2970,320,9,18,27,33.3%,5m
16308,2,GetToTheRim,2970,219,8,9,17,47.1%,29m
16308,2,[XpKAc]ARHAT,2970,101,6,5,11,54.5%,5m
16308,3,thePRINCE,2970,74,4,7,11,36.4%,20m
16308,2,Gaiahunter,2970,136,4,7,11,36.4%,5m
16308,1,[RakF]BALOU,2970,114,2,3,5,40.0%,5m
16308,1,[x42069]Morty,2970,72,2,6,8,25.0%,40m
16308,1,Yeeter,2970,38,2,7,9,22.2%,42m
16308,2,[ALTF04]elmishipro,2970,0,1,0,1,100.0%,29m
16308,2,[iGOSU]Sublime,2970,97,1,4,5,20.0%,25m
16308,2,SkynetIII,2970,0,1,4,5,20.0%,39m
16308,1,Fracture,2970,0,0,1,1,0.0%,12m
16308,2,Marineford,2970,0,0,1,1,0.0%,18m
16308,2,Doruru,2970,0,0,1,1,0.0%,20m
16308,2,DeanoRino,2970,0,0,2,2,0.0%,30m
16308,3,[xSDx]Jumpit,2970,0,0,11,11,0.0%,22m
16334,1,[LGNxx]Hannibal,2969,1568,187,183,370,50.5%,18m
16334,1,[1LIDER]peter,2969,1525,186,189,375,49.6%,10m
16334,1,[G0RE]Apocalypso,2969,1472,60,58,118,50.8%,40m
16334,1,HCX,2969,1181,52,38,90,57.8%,12m
16334,2,[5CP]FreeGhislain,2969,718,47,24,71,66.2%,31m
16334,1,[OhhGG]ACEsch,2969,1158,42,44,86,48.8%,15m
16334,2,Iseefor,2969,734,31,22,53,58.5%,32m
16334,2,RAFAJUNGLE,2969,738,30,18,48,62.5%,36m
16334,2,Essjay,2969,391,21,22,43,48.8%,16m
16334,3,[MAGA21]ScoTT,2969,552,20,48,68,29.4%,21m
16334,1,DarkestRaven,2969,563,18,24,42,42.9%,26m
16334,2,[ØÛ]Blaus,2969,417,15,13,28,53.6%,5m
16334,1,[NextDC]SnOw,2969,315,14,14,28,50.0%,12m
16334,1,SirBings,2969,363,12,15,27,44.4%,8m
16334,3,NoeCeraldor,2969,257,8,5,13,61.5%,49m
16334,3,Pederneras,2969,164,6,4,10,60.0%,43m
16334,1,RTSnewB,2969,138,4,6,10,40.0%,27m
16334,1,TheProdigy,2969,44,2,5,7,28.6%,5m
16334,2,dinamite,2969,32,1,2,3,33.3%,6m
16334,2,[Maaate]Googol,2969,30,1,3,4,25.0%,29m
16334,2,Hoop,2969,30,1,4,5,20.0%,16m
16334,2,[MANKOS]bearspy,2969,0,0,1,1,0.0%,40m
16334,2,[NDEAHH]Desperado,2969,0,0,4,4,0.0%,18m
16357,3,squirrlMastr,2968,1543,240,237,477,50.3%,3m
16357,1,KanBalam,2968,1559,169,141,310,54.5%,38m
16357,1,PPPPPPP,2968,873,129,111,240,53.8%,36m
16357,1,FuPnZcheats,2968,1004,111,99,210,52.9%,34m
16357,1,EliteDragon,2968,1000,55,39,94,58.5%,2m
16357,2,Rick,2968,643,28,28,56,50.0%,17m
16357,2,Magnum,2968,702,27,24,51,52.9%,37m
16357,1,[UofL]Soule,2968,570,20,19,39,51.3%,14m
16357,2,[GGMESP]Gipsy,2968,397,17,14,31,54.8%,29m
16357,2,HNGLuke,2968,365,15,15,30,50.0%,6m
16357,1,iTsJustMe,2968,457,14,14,28,50.0%,38m
16357,2,HuevoDerecho,2968,288,11,8,19,57.9%,4m
16357,2,llllllllllll,2968,228,9,11,20,45.0%,5m
16357,1,[REALG4]yaguarii,2968,242,8,7,15,53.3%,7m
16357,1,Tallmountain,2968,276,8,9,17,47.1%,33m
16357,1,[CD4G]Bastorus,2968,156,5,1,6,83.3%,1h
16357,1,AMLO,2968,144,5,8,13,38.5%,5m
16357,1,shoegaze,2968,118,4,10,14,28.6%,28m
16357,2,[FONT]BundleOfKale,2968,0,3,2,5,60.0%,15m
16357,2,Kayzen,2968,58,2,3,5,40.0%,16m
16357,2,hafdecent,2968,0,1,0,1,100.0%,6m
16357,2,Masterchief,2968,0,1,1,2,50.0%,9m
16357,2,[xGasai]AtomicTrueno,2968,30,1,1,2,50.0%,22m
16357,2,Disciple,2968,32,1,4,5,20.0%,3m
16357,2,SeneK,2968,0,0,1,1,0.0%,22m
16357,2,Gumbo,2968,0,0,5,5,0.0%,32m
16383,3,MajorPayne,2967,1554,344,341,685,50.2%,15m
16383,3,[lNI]TwoRCfourU,2967,1449,255,233,488,52.3%,26m
16383,3,Scharf,2967,1514,207,197,404,51.2%,3m
16383,1,kapsor,2967,1578,128,119,247,51.8%,26m
16383,1,zarko,2967,1163,62,53,115,53.9%,42m
16383,2,[AbcCo]peqaso,2967,1352,58,45,103,56.3%,24m
16383,2,Teer,2967,359,28,22,50,56.0%,41m
16383,1,MAGATrumpROX,2967,602,19,28,47,40.4%,38m
16383,1,Alkatraz,2967,424,13,17,30,43.3%,38m
16383,2,[AIlin]Nickos,2967,322,11,9,20,55.0%,32m
16383,1,ThangNguyen,2967,128,8,3,11,72.7%,39m
16383,1,Endless,2967,185,8,7,15,53.3%,1h
16383,3,[BIDENN]Morty,2967,227,7,3,10,70.0%,38m
16383,3,[juggr]bansi,2967,188,7,12,19,36.8%,31m
16383,1,Badger,2967,254,7,15,22,31.8%,34m
16383,3,iwatchyou,2967,178,6,4,10,60.0%,11m
16383,1,Spunions,2967,97,3,3,6,50.0%,3h
16383,1,Gatt,2967,142,3,7,10,30.0%,21m
16383,2,[CuBTaK]llllllllllll,2967,30,2,0,2,100.0%,20m
16383,1,LaRata,2967,72,2,9,11,18.2%,11m
16383,3,Roach,2967,0,1,1,2,50.0%,3h
16383,2,bokchoy,2967,0,0,1,1,0.0%,15m
16383,1,Threegnomes,2967,0,0,1,1,0.0%,37m
16383,2,SithErE,2967,0,0,2,2,0.0%,20m
16407,1,Dowfu,2966,1667,260,253,513,50.7%,10m
16407,3,[GrEv]onlyhotbabez,2966,669,81,75,156,51.9%,22m
16407,1,haq,2966,337,56,48,104,53.8%,34m
16407,2,llllllllllll,2966,1140,45,39,84,53.6%,1m
16407,3,Xyu,2966,961,34,38,72,47.2%,18m
16407,1,Farva,2966,491,30,35,65,46.2%,25m
16407,2,ilikemen,2966,180,26,5,31,83.9%,17m
16407,2,Wooli,2966,487,22,6,28,78.6%,25m
16407,1,POTATO,2966,343,21,22,43,48.8%,19m
16407,1,SpicyGum,2966,468,19,17,36,52.8%,40m
16407,2,RødGrødFløde,2966,434,17,8,25,68.0%,29m
16407,1,fleshblade,2966,544,16,23,39,41.0%,25m
16407,1,Envy,2966,97,4,2,6,66.7%,52m
16407,1,Palpatine,2966,0,3,2,5,60.0%,3h
16407,2,FatalReaper,2966,30,1,1,2,50.0%,10m
16407,2,StornHot,2966,0,0,2,2,0.0%,14m
16423,1,Krat,2965,1376,161,131,292,55.1%,3m
16423,3,ColBuendia,2965,1159,161,159,320,50.3%,40m
16423,2,MediOgre,2965,1647,113,103,216,52.3%,25m
16423,3,xMkSkally,2965,1549,113,118,231,48.9%,32m
16423,3,javabean,2965,407,34,43,77,44.2%,11m
16423,2,Alma,2965,525,21,14,35,60.0%,21m
16423,1,IDC,2965,376,14,12,26,53.8%,22m
16423,1,Baron,2965,366,11,13,24,45.8%,27m
16423,2,poO,2965,248,10,8,18,55.6%,4m
16423,2,Dasbooty,2965,167,6,5,11,54.5%,16m
16423,1,[JMafia]Pomo,2965,154,5,6,11,45.5%,24m
16423,2,LowIQPlayer,2965,88,4,2,6,66.7%,11m
16423,2,zVirGozHzGGG,2965,86,4,3,7,57.1%,12m
16423,1,[8kPLUS]KidK,2965,0,3,2,5,60.0%,42m
16423,2,WaLao,2965,30,3,3,6,50.0%,39m
16423,2,GavinSachs,2965,0,2,3,5,40.0%,16m
16423,2,LGBTandBLM,2965,60,2,3,5,40.0%,21m
16423,1,Moose,2965,96,2,4,6,33.3%,3h
16423,2,Lucius,2965,0,1,1,2,50.0%,25m
16423,2,Frankenstein,2965,32,1,4,5,20.0%,15m
16423,1,[GOPERÚ]pavdre,2965,40,1,7,8,12.5%,30m
16423,2,brybrybry,2965,0,0,1,1,0.0%,21m
16423,2,OpJeof,2965,0,0,2,2,0.0%,4m
16446,3,SayHerName,2964,1607,314,315,629,49.9%,8m
16446,2,Darliefenix,2964,1511,101,84,185,54.6%,15m
16446,1,LuLaLivRe,2964,1209,51,39,90,56.7%,25m
16446,2,Reddington,2964,668,33,11,44,75.0%,34m
16446,1,Blackstone,2964,564,21,17,38,55.3%,5m
16446,2,HornySCV,2964,459,18,11,29,62.1%,29m
16446,2,Fantasy,2964,336,15,15,30,50.0%,14m
16446,2,PYT,2964,211,10,7,17,58.8%,49m
16446,2,[FyHr]MaEkoLe,2964,286,10,8,18,55.6%,16m
16446,1,Parma,2964,283,9,10,19,47.4%,37m
16446,1,AVeryKindGuy,2964,284,8,12,20,40.0%,13m
16446,2,SuNa,2964,98,4,2,6,66.7%,11m
16446,2,Schorn,2964,118,4,5,9,44.4%,18m
16446,1,[Xpk]Juanito,2964,156,4,6,10,40.0%,17m
16446,1,DankMemes,2964,0,3,2,5,60.0%,2h
16446,1,SheeP,2964,0,3,2,5,60.0%,51m
16446,2,Nycrande,2964,114,3,5,8,37.5%,23m
16446,2,Gustavo,2964,30,2,1,3,66.7%,25m
16446,2,ScvLivesMttr,2964,60,2,2,4,50.0%,9m
16446,1,Newbie,2964,0,2,4,6,33.3%,36m
16446,2,Anti,2964,30,1,2,3,33.3%,6m
16446,3,VanSCmax,2964,97,1,2,3,33.3%,4m
16446,2,AnanZero,2964,0,0,1,1,0.0%,12m
16469,3,[Skcid]Deepvt,2963,1492,498,477,975,51.1%,24m
16469,2,[0NaCl]SpicyNoodles,2963,1614,241,227,468,51.5%,15m
16469,2,[1BSBC]EcheeZero,2963,1638,159,162,321,49.5%,32m
16469,1,agesexloc,2963,1615,110,117,227,48.5%,34m
16469,1,Statmat,2963,1579,71,59,130,54.6%,36m
16469,1,Redemption,2963,679,31,25,56,55.4%,24m
16469,3,Enter,2963,247,19,17,36,52.8%,15m
16469,1,GINTOKI,2963,494,16,21,37,43.2%,33m
16469,1,DISRESPECTOR,2963,255,10,8,18,55.6%,27m
16469,2,chakattakk,2963,253,9,5,14,64.3%,2m
16469,3,Kketnip,2963,229,8,6,14,57.1%,32m
16469,2,[CHYW]Sentiliforme,2963,170,7,5,12,58.3%,5m
16469,2,Petrucci,2963,62,4,5,9,44.4%,35m
16469,2,TouchyUncle,2963,64,3,1,4,75.0%,9m
16469,1,HelloWorld,2963,97,3,1,4,75.0%,35m
16469,1,[SNeS]GOOMBA,2963,88,2,5,7,28.6%,36m
16469,2,[SmokeH]Stubzi,2963,0,1,0,1,100.0%,11m
16469,2,[ValidG]PoisonTrail,2963,0,1,0,1,100.0%,23m
16469,2,Zevi,2963,30,1,1,2,50.0%,16m
16469,2,gshocks,2963,0,0,1,1,0.0%,30m
16469,2,Odina,2963,0,0,1,1,0.0%,19m
16469,2,arkmin,2963,0,0,1,1,0.0%,7m
16469,2,sagnew,2963,0,0,1,1,0.0%,4m
16492,1,GluteusMax,2962,1464,278,244,522,53.3%,13m
16492,2,Limbo,2962,1590,258,215,473,54.5%,6m
16492,3,[GRNSKN]MasterJames,2962,1549,167,167,334,50.0%,3m
16492,3,Theseus,2962,1361,84,88,172,48.8%,35m
16492,3,[LCE]Draco,2962,579,70,68,138,50.7%,2m
16492,3,JAC,2962,1201,68,67,135,50.4%,38m
16492,1,[SSZZ]wangsa,2962,1422,67,61,128,52.3%,33m
16492,1,BertD,2962,837,67,75,142,47.2%,36m
16492,1,Craving,2962,1365,54,54,108,50.0%,42m
16492,2,kyoani,2962,738,29,24,53,54.7%,25m
16492,2,Taxonman,2962,760,29,27,56,51.8%,28m
16492,2,Salem,2962,433,19,9,28,67.9%,30m
16492,2,Korfuffle,2962,411,16,11,27,59.3%,13m
16492,2,[Sune]Demereo,2962,373,14,11,25,56.0%,18m
16492,1,[SMRT]dampen,2962,322,14,12,26,53.8%,22m
16492,2,Scamander,2962,300,12,6,18,66.7%,8m
16492,3,JustBusiness,2962,115,11,8,19,57.9%,30m
16492,2,[SNOWR]Icebuggys,2962,141,5,4,9,55.6%,13m
16492,1,fatman,2962,122,3,12,15,20.0%,28m
16492,2,Yayo,2962,30,2,1,3,66.7%,40m
16492,2,JosephFDL,2962,66,2,2,4,50.0%,22m
16492,2,[CoOpy]SavageDragon,2962,60,2,3,5,40.0%,19m
16492,1,LeonVK,2962,38,1,6,7,14.3%,36m
16492,3,Tornado,2962,0,0,1,1,0.0%,53m
16492,2,Patou,2962,0,0,1,1,0.0%,15m
16492,1,Marcelynn,2962,0,0,6,6,0.0%,34m
16518,1,Antoni,2961,1654,199,193,392,50.8%,6m
16518,2,SrToranaga,2961,1436,182,153,335,54.3%,6m
16518,1,[sW4Rmz]ALUCARD,2961,1614,131,122,253,51.8%,11m
16518,3,forklifter,2961,767,106,103,209,50.7%,3m
16518,2,CodyG,2961,1594,78,59,137,56.9%,9m
16518,1,MTHREE,2961,1646,75,69,144,52.1%,40m
16518,3,IIiiIIiiII,2961,772,29,30,59,49.2%,28m
16518,2,[PPLe]Vrolk,2961,421,23,14,37,62.2%,41m
16518,2,Zyfe,2961,502,20,19,39,51.3%,15m
16518,1,Time,2961,446,18,9,27,66.7%,15m
16518,3,[cl0udM]Roadrunner,2961,476,16,26,42,38.1%,11m
16518,2,ZeroHedge,2961,378,14,11,25,56.0%,30m
16518,2,CaravelCoin,2961,300,10,11,21,47.6%,23m
16518,1,shroudyrowdy,2961,242,7,12,19,36.8%,38m
16518,2,chedca,2961,178,6,8,14,42.9%,20m
16518,2,Sagi,2961,58,3,0,3,100.0%,12m
16518,2,knife,2961,98,3,5,8,37.5%,20m
16518,2,Umnums,2961,0,1,0,1,100.0%,7m
16518,2,neyboy,2961,0,1,1,2,50.0%,33m
16518,1,LUIZ,2961,0,1,1,2,50.0%,47m
16518,2,[KomEEZ]QanonBgone,2961,30,1,5,6,16.7%,33m
16518,2,ArchSeth,2961,0,0,1,1,0.0%,8m
16540,1,pbfrank,2960,1705,506,486,992,51.0%,3m
16540,2,iTzEDANxPROz,2960,1634,289,270,559,51.7%,13m
16540,2,[WnB]sentientalgo,2960,1636,214,192,406,52.7%,12m
16540,3,Guil,2960,1546,150,146,296,50.7%,25m
16540,2,[NoBads]starfighter,2960,1622,131,122,253,51.8%,35m
16540,2,crat,2960,1546,66,57,123,53.7%,10m
16540,2,Squirrel,2960,1402,62,50,112,55.4%,35m
16540,2,Duo,2960,352,13,9,22,59.1%,22m
16540,2,Belzedar,2960,372,13,12,25,52.0%,29m
16540,1,whitezombie,2960,174,11,7,18,61.1%,38m
16540,1,darkstrar,2960,190,10,6,16,62.5%,34m
16540,3,llllllllllll,2960,187,7,3,10,70.0%,1h
16540,1,ChopperDave,2960,225,7,8,15,46.7%,39m
16540,2,[zDMCz]autodouche,2960,154,6,4,10,60.0%,5m
16540,2,[ZCAce]Neves,2960,166,5,3,8,62.5%,19m
16540,1,BranDonkey,2960,0,4,2,6,66.7%,1h
16540,1,Tartaucitron,2960,97,4,2,6,66.7%,1h
16540,2,Julio,2960,30,4,3,7,57.1%,41m
16540,2,Newstar,2960,120,4,6,10,40.0%,31m
16540,1,NidhogGG,2960,0,3,2,5,60.0%,2h
16540,1,rumple,2960,0,3,2,5,60.0%,3h
16540,3,[4kek]Lunacy,2960,121,2,1,3,66.7%,1h
16540,2,UDFaith,2960,134,2,3,5,40.0%,1h
16540,1,Roguetta,2960,0,1,1,2,50.0%,42m
16540,2,[SKyber]ivicaos,2960,32,1,2,3,33.3%,18m
16540,2,HaVoC,2960,30,1,2,3,33.3%,20m
16540,2,wurlitzer,2960,0,1,4,5,20.0%,26m
16540,1,Luvistras,2960,90,1,5,6,16.7%,2m
16540,2,Thechef,2960,0,0,1,1,0.0%,18m
16540,2,MrPink,2960,0,0,1,1,0.0%,16m
16540,3,bigboss,2960,0,0,1,1,0.0%,3m
16540,2,[TWI]Nidrassil,2960,0,0,2,2,0.0%,17m
16572,2,Ancient,2959,396,40,28,68,58.8%,4m
16572,2,VIER,2959,723,35,22,57,61.4%,37m
16572,1,FKCHINAGOHK,2959,616,34,24,58,58.6%,3m
16572,1,Eyedea,2959,809,29,30,59,49.2%,10m
16572,2,BigChungus,2959,415,19,7,26,73.1%,12m
16572,3,[Shiit]Xenos,2959,462,16,23,39,41.0%,12m
16572,1,[GRUMEC]WWiTigerTank,2959,374,14,13,27,51.9%,40m
16572,1,nuttysquirel,2959,291,12,12,24,50.0%,11m
16572,2,seriosblack,2959,193,11,14,25,44.0%,35m
16572,2,Quelijah,2959,276,10,4,14,71.4%,16m
16572,2,[DXPCA]Athelstan,2959,240,10,7,17,58.8%,3m
16572,2,DaNoobinator,2959,232,8,3,11,72.7%,9m
16572,2,[diaman]SIODOS,2959,224,6,7,13,46.2%,11m
16572,1,Vendetta,2959,220,6,11,17,35.3%,4m
16572,2,partkyle,2959,136,4,0,4,100.0%,29m
16572,2,[N008]Raptorteam,2959,149,4,3,7,57.1%,11m
16572,3,Victorius,2959,144,3,1,4,75.0%,3h
16572,2,ATMACS,2959,86,3,1,4,75.0%,10m
16572,2,jepi,2959,0,3,2,5,60.0%,33m
16572,2,Backup,2959,0,3,2,5,60.0%,24m
16572,3,Nightcrawler,2959,123,2,2,4,50.0%,1h
16572,2,[USCE]Allinea,2959,30,2,3,5,40.0%,12m
16572,3,Bot,2959,0,1,0,1,100.0%,3h
16572,2,stuffs,2959,0,1,1,2,50.0%,3h
16572,2,bamcis,2959,30,1,3,4,25.0%,14m
16572,1,calmoo,2959,0,1,5,6,16.7%,3h
16572,2,Publius,2959,0,0,1,1,0.0%,31m
16572,1,[NwAs]DoctorGamer,2959,0,0,1,1,0.0%,3h
16572,1,StanTheMan,2959,0,0,6,6,0.0%,24m
16601,1,Nürburgring,2958,1623,264,239,503,52.5%,13m
16601,1,ThisIsJimmy,2958,1538,175,169,344,50.9%,19m
16601,1,Ronico,2958,1565,175,169,344,50.9%,24m
16601,3,[MATTO]ShinjiGetIn,2958,1633,122,134,256,47.7%,41m
16601,1,[mrclen]Stronghold,2958,809,93,94,187,49.7%,30m
16601,2,DOU,2958,1455,87,73,160,54.4%,21m
16601,1,Phantom,2958,749,66,67,133,49.6%,18m
16601,2,Squom,2958,839,39,37,76,51.3%,39m
16601,3,[SoloOp]DMK,2958,805,32,36,68,47.1%,2m
16601,2,Alikai,2958,581,27,19,46,58.7%,10m
16601,2,[FyHr]DMNT,2958,502,20,14,34,58.8%,22m
16601,2,[SD760]MacAttack,2958,510,18,14,32,56.2%,10m
16601,2,[SCVM]FlySlendyGG,2958,406,15,11,26,57.7%,12m
16601,2,GhostFX,2958,351,14,13,27,51.9%,19m
16601,3,Infantry,2958,284,10,20,30,33.3%,39m
16601,2,OxRabbit,2958,225,9,6,15,60.0%,28m
16601,1,DCAngelo,2958,258,8,16,24,33.3%,2m
16601,1,[Valla]SilentCheese,2958,120,6,1,7,85.7%,23m
16601,2,[KOYOMI]PROBER,2958,138,3,1,4,75.0%,42m
16601,2,GolDaniels,2958,58,2,1,3,66.7%,12m
16601,2,bayareatong,2958,34,2,2,4,50.0%,31m
16601,1,[GGWPXD]COOKIE,2958,0,1,2,3,33.3%,22m
16601,1,buru,2958,0,1,4,5,20.0%,5m
16601,1,cool,2958,0,0,3,3,0.0%,55m
16601,1,Halion,2958,0,0,3,3,0.0%,3h
16626,1,BigBird,2957,1374,163,169,332,49.1%,29m
16626,1,Cgabriel,2957,1668,97,94,191,50.8%,36m
16626,2,Croyd,2957,568,31,9,40,77.5%,15m
16626,1,lWorstGodl,2957,795,26,27,53,49.1%,21m
16626,1,Tsubodai,2957,644,21,24,45,46.7%,19m
16626,2,[Azocur]Hiori,2957,232,9,6,15,60.0%,6m
16626,1,[EQSTR]UnicornJedi,2957,324,9,14,23,39.1%,25m
16626,1,[FACKER]truffles,2957,322,9,17,26,34.6%,31m
16626,2,xXNoOneXx,2957,176,7,4,11,63.6%,14m
16626,3,Charmander,2957,147,7,6,13,53.8%,10m
16626,2,PurpleDrank,2957,172,6,5,11,54.5%,34m
16626,3,[Cadete]Autócrata,2957,129,5,4,9,55.6%,26m
16626,2,Thebucko,2957,88,5,5,10,50.0%,49m
16626,1,AdultShoes,2957,0,3,2,5,60.0%,1h
16626,2,[HPSLM]NoOne,2957,30,1,1,2,50.0%,25m
16626,2,[LVARW]Oomi,2957,30,1,2,3,33.3%,41m
16626,2,fabian,2957,0,0,1,1,0.0%,6m
16626,3,[neuroW]omegatrox,2957,0,0,1,1,0.0%,3h
16626,2,Penguin,2957,0,0,2,2,0.0%,39m
16645,3,[phog]Cheese,2956,1520,299,288,587,50.9%,35m
16645,2,CrustyGoober,2956,1567,247,237,484,51.0%,5m
16645,2,LazerMind,2956,1485,97,89,186,52.2%,31m
16645,3,WALLxE,2956,1293,64,57,121,52.9%,21m
16645,1,[INl]killer,2956,780,48,49,97,49.5%,40m
16645,2,[Msia]cuteburger,2956,1266,47,45,92,51.1%,20m
16645,2,OKOKOK,2956,855,35,31,66,53.0%,32m
16645,1,lIlllIIIll,2956,470,33,33,66,50.0%,10m
16645,1,[ECrea]DeepSun,2956,362,32,25,57,56.1%,38m
16645,1,[Solas5]lllendexll,2956,667,25,22,47,53.2%,13m
16645,1,Omnipotent,2956,451,25,22,47,53.2%,27m
16645,2,GerGly,2956,259,9,4,13,69.2%,42m
16645,2,Paranoia,2956,164,8,5,13,61.5%,1m
16645,2,richyqtqt,2956,118,7,1,8,87.5%,8m
16645,2,[KiMBR]FeniX,2956,164,5,1,6,83.3%,16m
16645,3,MoSalah,2956,121,4,4,8,50.0%,7m
16645,2,Salardin,2956,0,3,2,5,60.0%,40m
16645,2,AxleChill,2956,0,3,2,5,60.0%,38m
16645,1,PIRATASKROOS,2956,38,2,7,9,22.2%,36m
16645,1,SerbianXXX,2956,0,1,0,1,100.0%,39m
16645,2,peepeepoopoo,2956,0,1,1,2,50.0%,1h
16645,1,[2v2bro]TimFromOptus,2956,0,1,5,6,16.7%,7m
16645,1,MetalMan,2956,0,0,1,1,0.0%,3h
16645,2,nGsDangerous,2956,0,0,1,1,0.0%,29m
16645,2,GGBREH,2956,0,0,1,1,0.0%,21m
16670,2,thegaijin,2955,1146,51,46,97,52.6%,37m
16670,1,Havoc,2955,695,27,28,55,49.1%,6m
16670,2,[vNc]BTSS,2955,379,14,11,25,56.0%,29m
16670,3,SleepyBear,2955,294,14,16,30,46.7%,27m
16670,2,Bronbowser,2955,316,11,10,21,52.4%,40m
16670,2,Chozo,2955,206,9,0,9,100.0%,32m
16670,3,Belennus,2955,168,6,2,8,75.0%,43m
16670,2,Quarms,2955,144,6,6,12,50.0%,1h
16670,2,FranticDeath,2955,150,5,7,12,41.7%,25m
16670,2,[PNGcl]nosoypan,2955,0,3,2,5,60.0%,31m
16670,3,Snuggle,2955,0,3,5,8,37.5%,19m
16670,2,YASUO,2955,92,3,8,11,27.3%,22m
16670,1,[LgnTDS]Locke,2955,128,2,11,13,15.4%,2m
16670,1,Camlost,2955,0,1,4,5,20.0%,3h
16684,2,Yehoshua,2954,1369,74,56,130,56.9%,16m
16684,2,FireRedJP,2954,1292,59,55,114,51.8%,8m
16684,1,[xSPTx]Bektro,2954,1248,57,51,108,52.8%,26m
16684,3,[αX]Bibbs,2954,1104,40,51,91,44.0%,34m
16684,1,SuperMat,2954,1046,38,38,76,50.0%,32m
16684,1,TJosh,2954,950,33,36,69,47.8%,34m
16684,1,Howl,2954,736,32,34,66,48.5%,7m
16684,1,StdyFriend,2954,528,22,24,46,47.8%,15m
16684,1,[AD3C]iNsAnE,2954,590,21,24,45,46.7%,19m
16684,2,MrCrab,2954,293,13,3,16,81.2%,29m
16684,1,[IGeaL]Sorces,2954,380,11,20,31,35.5%,30m
16684,2,ledevourer,2954,254,10,7,17,58.8%,39m
16684,2,[USplan]Delicious,2954,236,8,8,16,50.0%,16m
16684,1,[disabl]ImRetarded,2954,169,6,3,9,66.7%,39m
16684,3,mrDonny,2954,165,6,5,11,54.5%,3h
16684,1,Reckoner,2954,48,4,3,7,57.1%,23m
16684,1,SagaZ,2954,0,3,2,5,60.0%,26m
16684,2,speedghOst,2954,0,1,0,1,100.0%,9m
16684,2,[cxzczx]Knightmare,2954,34,1,1,2,50.0%,31m
16684,2,IlIlIlIl,2954,0,1,2,3,33.3%,29m
16684,2,ReideN,2954,0,0,1,1,0.0%,3m
16705,3,[AnUB]casimiro,2953,1273,294,297,591,49.7%,12m
16705,3,[ITaL]CAESAR,2953,1465,192,201,393,48.9%,30m
16705,1,Johnoy,2953,1683,184,169,353,52.1%,5m
16705,2,Sensii,2953,1552,122,95,217,56.2%,40m
16705,2,[TACTEC]Marex,2953,1615,80,66,146,54.8%,28m
16705,1,EzRA,2953,1486,65,55,120,54.2%,25m
16705,2,BrightHammer,2953,405,49,41,90,54.4%,13m
16705,1,DONALDTRUMP,2953,1286,49,46,95,51.6%,9m
16705,1,cupcake,2953,828,32,28,60,53.3%,30m
16705,2,redsmurf,2953,778,29,33,62,46.8%,11m
16705,2,[2EZ4us]Powadog,2953,616,23,21,44,52.3%,21m
16705,3,BFR,2953,326,17,18,35,48.6%,2m
16705,2,FabianTrend,2953,293,15,7,22,68.2%,9m
16705,2,Golferjim,2953,386,13,13,26,50.0%,29m
16705,2,Thunderthwat,2953,250,9,7,16,56.2%,3h
16705,2,pikachu,2953,262,9,12,21,42.9%,12m
16705,2,Camembert,2953,131,7,1,8,87.5%,20m
16705,1,bbcallking,2953,58,2,6,8,25.0%,39m
16705,2,[GLov]BLorD,2953,0,1,0,1,100.0%,10m
16705,1,bdofcak,2953,45,1,2,3,33.3%,1h
16705,2,[Amb3rs]woomasta,2953,34,1,4,5,20.0%,34m
16705,3,CaM,2953,0,0,1,1,0.0%,3h
16705,2,[ValidG]GrumpyGills,2953,0,0,1,1,0.0%,34m
16705,3,freedom,2953,0,0,1,1,0.0%,47m
16729,1,[BOESCA]SonusEco,2952,1601,128,120,248,51.6%,36m
16729,1,Shawnderbot,2952,1669,81,73,154,52.6%,3m
16729,2,[TvagP]Dender,2952,1130,73,59,132,55.3%,26m
16729,3,PrbeLfeMafia,2952,1290,45,63,108,41.7%,32m
16729,2,nbadrektul,2952,714,30,22,52,57.7%,18m
16729,2,Breno,2952,507,20,17,37,54.1%,4m
16729,2,Karplyuk,2952,516,20,17,37,54.1%,6m
16729,2,Clairvoyant,2952,405,16,12,28,57.1%,42m
16729,2,gaete,2952,250,11,9,20,55.0%,32m
16729,2,[TheDOH]Andy,2952,0,4,3,7,57.1%,12m
16729,2,[TaKGaM]taKMashido,2952,58,3,0,3,100.0%,23m
16729,2,Likam,2952,0,3,2,5,60.0%,23m
16729,2,MuDrone,2952,102,3,5,8,37.5%,10m
16729,2,Davastator,2952,34,1,4,5,20.0%,39m
16729,1,Kuma,2952,0,1,4,5,20.0%,13m
16729,2,[MalP]Justified,2952,0,0,1,1,0.0%,35m
16729,2,Bdoom,2952,0,0,1,1,0.0%,7m
16729,2,dandan,2952,0,0,1,1,0.0%,11m
16729,2,Smaxx,2952,0,0,1,1,0.0%,23m
16748,3,[OIGE]AZULA,2951,1567,161,161,322,50.0%,37m
16748,2,Rifshadow,2951,940,107,81,188,56.9%,10m
16748,1,MillerSPARTA,2951,1633,92,80,172,53.5%,13m
16748,1,KRISTALLNACH,2951,1610,92,95,187,49.2%,31m
16748,2,Craxz,2951,1013,51,47,98,52.0%,23m
16748,2,[MexTec]Strat,2951,800,32,25,57,56.1%,14m
16748,2,[DarkPG]ELMANCO,2951,720,27,25,52,51.9%,37m
16748,1,minp,2951,225,11,10,21,52.4%,22m
16748,1,[DRKRIS]woshinidaye,2951,280,8,11,19,42.1%,36m
16748,2,[TGosuA]belly,2951,174,7,6,13,53.8%,12m
16748,3,giesecke,2951,168,5,0,5,100.0%,7m
16748,2,Ghost,2951,168,5,3,8,62.5%,51m
16748,1,David,2951,0,4,1,5,80.0%,3h
16748,2,Sanek,2951,114,4,5,9,44.4%,39m
16748,1,Dan,2951,48,2,1,3,66.7%,1h
16748,1,Metalero,2951,38,2,6,8,25.0%,26m
16748,3,Broodweiser,2951,0,1,0,1,100.0%,2h
16748,2,whistle,2951,0,1,1,2,50.0%,7m
16748,2,Nodre,2951,0,0,1,1,0.0%,18m
16767,3,Tribulus,2950,1557,245,241,486,50.4%,13m
16767,2,grannit,2950,1437,71,41,112,63.4%,34m
16767,2,ZadokinG,2950,784,32,28,60,53.3%,41m
16767,2,lWorstGodl,2950,542,23,14,37,62.2%,29m
16767,2,Fulo,2950,397,20,17,37,54.1%,10m
16767,2,[M3H]CowboyPaul,2950,350,17,16,33,51.5%,23m
16767,3,Atlantidae,2950,359,16,17,33,48.5%,31m
16767,2,[eMoon]LoWJaKinG,2950,288,11,2,13,84.6%,10m
16767,3,[GTn]kawoq,2950,304,11,21,32,34.4%,2m
16767,2,[Bever7]serchien,2950,234,8,11,19,42.1%,6m
16767,3,Cheebs,2950,30,6,4,10,60.0%,36m
16767,2,[nfr]Santander,2950,90,4,4,8,50.0%,12m
16767,2,[StrMed]YoKoXXXi,2950,0,3,2,5,60.0%,9m
16767,2,[P3AC3]Reflection,2950,122,3,4,7,42.9%,1m
16767,2,[OSUSC2]ibelieve,2950,62,3,5,8,37.5%,12m
16767,1,[AnimaS]StarkeRath,2950,36,2,6,8,25.0%,13m
16767,2,FullDeath,2950,30,1,1,2,50.0%,4m
16767,2,[BuBBas]scuffed,2950,0,1,1,2,50.0%,16m
16767,2,[Venge]FlavaFlave,2950,32,1,2,3,33.3%,32m
16767,1,Rune,2950,0,0,4,4,0.0%,3h
16767,1,[2faded]VAfinest,2950,0,0,5,5,0.0%,42m
16788,3,SLOSHED,2949,1573,399,393,792,50.4%,21m
16788,3,Sheharyar,2949,941,108,110,218,49.5%,31m
16788,2,[soypro]cangre,2949,921,46,18,64,71.9%,35m
16788,2,Shrug,2949,1113,43,40,83,51.8%,11m
16788,2,Portrial,2949,691,29,20,49,59.2%,9m
16788,2,juanho,2949,351,23,16,39,59.0%,23m
16788,2,[NEOS]Smitherz,2949,388,17,11,28,60.7%,29m
16788,1,Greigory,2949,559,17,23,40,42.5%,14m
16788,1,Witness,2949,220,7,13,20,35.0%,14m
16788,2,Windragon,2949,89,6,2,8,75.0%,19m
16788,1,[UpeV]pegasus,2949,186,6,6,12,50.0%,35m
16788,2,Arzellous,2949,58,3,4,7,42.9%,8m
16788,2,DarknessKill,2949,30,2,1,3,66.7%,8m
16788,2,llllllllllll,2949,0,1,0,1,100.0%,10m
16788,2,KAYaeha,2949,0,0,1,1,0.0%,39m
16788,2,[CBOH]CoolNamE,2949,0,0,1,1,0.0%,8m
16788,2,[Nuken]Furiouskill,2949,0,0,1,1,0.0%,23m
16788,2,Dylan,2949,0,0,1,1,0.0%,36m
16788,2,thebert,2949,0,0,2,2,0.0%,6m
16788,1,FreePizza,2949,0,0,2,2,0.0%,55m
16808,3,mugen,2948,1570,343,345,688,49.9%,21m
16808,1,[OhMG]TaiwanJ,2948,1646,102,102,204,50.0%,28m
16808,2,[xARGx]GatoNegro,2948,1651,75,63,138,54.3%,39m
16808,3,Ozy,2948,814,65,66,131,49.6%,21m
16808,1,basher,2948,756,55,48,103,53.4%,3m
16808,1,[EvilCG]SkrOs,2948,387,14,13,27,51.9%,18m
16808,2,Misterioszo,2948,306,11,12,23,47.8%,37m
16808,1,Olka,2948,120,9,5,14,64.3%,13m
16808,2,Yodabeast,2948,98,7,4,11,63.6%,34m
16808,1,HighPeaks,2948,197,7,6,13,53.8%,27m
16808,1,Brian,2948,0,4,2,6,66.7%,3h
16808,2,qwerty,2948,124,4,5,9,44.4%,9m
16808,2,Concienciahc,2948,106,4,6,10,40.0%,29m
16808,1,Lky,2948,145,3,0,3,100.0%,2h
16808,1,RushIfGay,2948,70,2,9,11,18.2%,13m
16808,2,Bubby,2948,0,1,0,1,100.0%,6m
16808,2,Hellen,2948,32,1,3,4,25.0%,10m
16808,2,coffeeboy,2948,95,1,3,4,25.0%,60m
16808,2,RayyyLmao,2948,73,0,2,2,0.0%,7m
16827,3,Lexor,2947,1542,359,337,696,51.6%,33m
16827,1,Metrobius,2947,1464,121,110,231,52.4%,34m
16827,1,ForAiur,2947,1033,102,86,188,54.3%,3m
16827,1,UkWildcat,2947,1500,92,87,179,51.4%,1m
16827,2,[BrLg]AwesomeSauce,2947,977,85,74,159,53.5%,29m
16827,2,PlebsFebs,2947,1588,81,62,143,56.6%,25m
16827,2,Santana,2947,566,33,14,47,70.2%,41m
16827,2,jqn,2947,822,30,30,60,50.0%,25m
16827,3,ImbaCyL,2947,712,28,32,60,46.7%,18m
16827,2,Nano,2947,439,22,12,34,64.7%,9m
16827,2,Rigel,2947,415,18,10,28,64.3%,12m
16827,1,LoribleStar,2947,432,12,17,29,41.4%,5m
16827,1,BryanzZ,2947,258,11,10,21,52.4%,38m
16827,2,TaX,2947,284,9,8,17,52.9%,11m
16827,2,Pandemic,2947,305,9,11,20,45.0%,21m
16827,1,[CHCKEM]KingGrunkus,2947,242,7,12,19,36.8%,28m
16827,2,[BONCK]DiolaH,2947,152,5,1,6,83.3%,35m
16827,1,Siege,2947,0,5,1,6,83.3%,3h
16827,3,MAGA,2947,160,5,4,9,55.6%,1m
16827,2,[SMB]zart,2947,86,3,3,6,50.0%,12m
16827,2,Nosfearatu,2947,30,2,3,5,40.0%,20m
16827,2,[DhZAc1]SkyDrago,2947,36,2,3,5,40.0%,10m
16827,3,Orcus,2947,30,1,6,7,14.3%,14m
16827,2,KaraAge,2947,0,0,1,1,0.0%,6m
16827,2,YUCK,2947,0,0,2,2,0.0%,29m
16852,1,FusedBlue,2946,1549,59,59,118,50.0%,26m
16852,2,Buttface,2946,882,39,33,72,54.2%,11m
16852,3,GromiT,2946,1002,37,49,86,43.0%,26m
16852,2,[QTp2T]Voden,2946,846,32,29,61,52.5%,10m
16852,1,BADD,2946,652,24,22,46,52.2%,26m
16852,2,Rooster,2946,423,23,12,35,65.7%,32m
16852,3,jumahh,2946,244,12,12,24,50.0%,11m
16852,2,Reckless,2946,284,10,9,19,52.6%,23m
16852,2,Galerunner,2946,208,8,6,14,57.1%,3h
16852,1,Spindoktor,2946,208,7,11,18,38.9%,39m
16852,3,tsukabon,2946,46,5,4,9,55.6%,50m
16852,2,PipBoyTwoK,2946,114,4,4,8,50.0%,11m
16852,1,Arud,2946,0,3,2,5,60.0%,3h
16852,2,LubbsDubbs,2946,0,3,2,5,60.0%,25m
16852,2,Jonsalo,2946,86,3,7,10,30.0%,8m
16852,3,Vortex,2946,98,3,14,17,17.6%,9m
16852,2,[glgghf]Illidan,2946,30,2,0,2,100.0%,4m
16852,2,Drekn,2946,112,2,1,3,66.7%,41m
16852,2,Deimos,2946,30,2,2,4,50.0%,11m
16852,2,kev,2946,30,2,2,4,50.0%,41m
16852,2,[TPGGXD]Asendoras,2946,0,1,0,1,100.0%,25m
16852,1,CreepinDeath,2946,0,1,1,2,50.0%,1h
16852,2,[OGbros]DrunkUnit,2946,0,0,1,1,0.0%,12m
16852,2,Stutterbox,2946,0,0,1,1,0.0%,21m
16852,2,Illusive,2946,0,0,2,2,0.0%,2h
16877,2,Stryfe,2945,1599,145,141,286,50.7%,17m
16877,2,xLuizx,2945,1498,109,110,219,49.8%,17m
16877,2,[SoD]SoDMysT,2945,881,105,84,189,55.6%,29m
16877,3,skydiver,2945,1514,104,102,206,50.5%,14m
16877,1,Preston,2945,1612,94,94,188,50.0%,3m
16877,2,ThEmPLE,2945,641,87,66,153,56.9%,12m
16877,1,SamFaRien,2945,1663,83,55,138,60.1%,25m
16877,2,Zione,2945,1596,70,56,126,55.6%,39m
16877,1,vixolin,2945,633,21,24,45,46.7%,39m
16877,1,IIIIIIIIIIII,2945,378,13,26,39,33.3%,21m
16877,2,Flowulf,2945,285,11,5,16,68.8%,23m
16877,1,[004572]Noah,2945,302,10,10,20,50.0%,36m
16877,1,[FxB]cHrono,2945,290,9,13,22,40.9%,7m
16877,1,Loewanbrau,2945,130,7,7,14,50.0%,12m
16877,2,[ClanHs]ThorsGoBrrrr,2945,190,6,2,8,75.0%,35m
16877,1,Feufeux,2945,185,6,3,9,66.7%,14m
16877,1,Jeramaya,2945,216,6,15,21,28.6%,28m
16877,2,iGauU,2945,102,4,2,6,66.7%,29m
16877,2,Halcyon,2945,118,4,3,7,57.1%,14m
16877,2,BLUETEARS,2945,96,3,2,5,60.0%,10m
16877,2,Butternuts,2945,34,2,2,4,50.0%,18m
16877,2,DOOM,2945,95,1,3,4,25.0%,2h
16877,2,nosferatus,2945,0,0,1,1,0.0%,15m
16877,1,Neilex,2945,0,0,2,2,0.0%,42m
16877,3,[uwur]Fappy,2945,0,0,2,2,0.0%,47m
16877,3,PolskaPro,2945,0,0,2,2,0.0%,26m
16903,1,[ººDKºº]VelvetJester,2944,1578,292,299,591,49.4%,30m
16903,1,Ricky,2944,1677,238,240,478,49.8%,16m
16903,3,Sedca,2944,1273,112,96,208,53.8%,40m
16903,1,KOBALT,2944,1670,97,92,189,51.3%,39m
16903,2,[TWNNO1]Master,2944,1551,60,62,122,49.2%,23m
16903,1,Execellent,2944,841,42,40,82,51.2%,7m
16903,1,[1kbt8]danny,2944,983,42,40,82,51.2%,27m
16903,2,MintyFresh,2944,964,39,32,71,54.9%,23m
16903,2,[NPA]Maverick,2944,762,37,30,67,55.2%,16m
16903,2,YodaSlim,2944,694,28,21,49,57.1%,28m
16903,1,dracoKnights,2944,375,21,25,46,45.7%,10m
16903,2,Cort,2944,448,17,15,32,53.1%,15m
16903,1,[SP4M]lobosurf,2944,502,16,22,38,42.1%,27m
16903,1,[LGNxx]CplCates,2944,462,15,22,37,40.5%,32m
16903,2,diccks,2944,311,11,5,16,68.8%,40m
16903,1,McNasty,2944,166,8,6,14,57.1%,27m
16903,2,eKKo,2944,205,7,1,8,87.5%,3h
16903,2,[PATOS]acdc,2944,180,7,8,15,46.7%,6m
16903,2,MecMan,2944,178,6,7,13,46.2%,41m
16903,2,WidowMaker,2944,142,5,4,9,55.6%,29m
16903,2,[Vtta]Leveleando,2944,114,5,5,10,50.0%,17m
16903,2,[PROLE]Omega,2944,88,4,2,6,66.7%,6m
16903,2,BigTepija,2944,118,4,3,7,57.1%,4m
16903,2,[EoT]Lorekt,2944,130,3,2,5,60.0%,1h
16903,2,Hemloch,2944,88,3,5,8,37.5%,12m
16903,2,[Bvalla]Hazuta,2944,34,2,4,6,33.3%,25m
16903,2,[tXLS]forgiveN,2944,0,1,0,1,100.0%,13m
16903,2,Lumpy,2944,0,1,2,3,33.3%,29m
16903,3,jayden,2944,0,1,2,3,33.3%,18m
16903,2,Mesobeshe,2944,0,1,4,5,20.0%,1h
16903,2,AguaPotable,2944,0,0,1,1,0.0%,41m
16903,2,[eSx]Foodsbane,2944,0,0,1,1,0.0%,8m
16903,2,Gabriel,2944,0,0,1,1,0.0%,3m
16903,2,[MIT]vEnhance,2944,0,0,1,1,0.0%,9m
16903,2,[FFAA]spectrosans,2944,0,0,2,2,0.0%,3m
16938,3,CerealKilla,2943,1601,255,253,508,50.2%,14m
16938,1,cemt,2943,1659,188,185,373,50.4%,5m
16938,1,Loser,2943,1642,109,116,225,48.4%,26m
16938,1,Bors,2943,1499,96,86,182,52.7%,28m
16938,1,[DR4G]PwndaBear,2943,718,85,74,159,53.5%,38m
16938,2,funney,2943,1392,58,52,110,52.7%,29m
16938,2,xOff,2943,1161,49,35,84,58.3%,4m
16938,1,DOndee,2943,998,46,39,85,54.1%,27m
16938,3,TopDeadCentr,2943,1235,46,50,96,47.9%,8m
16938,2,Hammer,2943,299,16,9,25,64.0%,6m
16938,2,SkrSkrSkr,2943,301,13,12,25,52.0%,39m
16938,1,Tetsuro,2943,343,9,23,32,28.1%,5m
16938,2,UtterPollock,2943,168,8,4,12,66.7%,36m
16938,1,dazak,2943,188,8,7,15,53.3%,3h
16938,1,[HazIPA]Zen,2943,48,6,1,7,85.7%,3h
16938,2,[Kaii]Yaguar,2943,180,6,1,7,85.7%,10m
16938,2,Bungo,2943,197,6,9,15,40.0%,42m
16938,1,[Mammal]MeowMeow,2943,143,5,3,8,62.5%,39m
16938,1,xOxOxOxO,2943,48,4,3,7,57.1%,1h
16938,2,Garrett,2943,116,4,4,8,50.0%,24m
16938,2,WoodenShed,2943,0,4,4,8,50.0%,3h
16938,2,froddparents,2943,88,3,2,5,60.0%,42m
16938,1,Akuro,2943,111,3,3,6,50.0%,21m
16938,2,KxBoKula,2943,30,2,3,5,40.0%,6m
16938,2,kobetj,2943,30,1,2,3,33.3%,29m
16938,2,IIIIIIIIIIII,2943,0,1,2,3,33.3%,21m
16938,2,llllllllllll,2943,0,0,1,1,0.0%,6m
16938,2,opprotoss,2943,0,0,1,1,0.0%,8m
16966,1,DINO,2942,1612,172,167,339,50.7%,42m
16966,3,[Sailx]AHZeus,2942,1290,172,181,353,48.7%,2m
16966,2,Devils,2942,1557,124,117,241,51.5%,4m
16966,1,[P2W]jmrkmr,2942,1392,123,111,234,52.6%,25m
16966,2,[STuNT]DumpsterFire,2942,1616,73,68,141,51.8%,29m
16966,1,EasyComputer,2942,1460,70,62,132,53.0%,39m
16966,2,CheesePlz,2942,1001,64,50,114,56.1%,31m
16966,1,torquestomp,2942,1086,57,51,108,52.8%,11m
16966,1,Schumie,2942,1278,46,47,93,49.5%,37m
16966,2,[MyButt]Pinky,2942,1112,42,40,82,51.2%,6m
16966,3,jcmark,2942,1066,41,49,90,45.6%,2m
16966,2,NightsDeath,2942,306,20,20,40,50.0%,16m
16966,1,[lDOGEl]Cacdac,2942,292,18,20,38,47.4%,5m
16966,2,[WiCCa]TheHaraldr,2942,340,12,8,20,60.0%,6m
16966,2,Gibs,2942,260,9,6,15,60.0%,20m
16966,2,jkjkjk,2942,205,9,6,15,60.0%,16m
16966,2,jppmang,2942,190,8,5,13,61.5%,17m
16966,2,SleepyJoe,2942,178,7,2,9,77.8%,12m
16966,2,VagrantTable,2942,188,7,5,12,58.3%,34m
16966,3,bkuze,2942,0,4,3,7,57.1%,1h
16966,2,[NSKL]Django,2942,0,3,2,5,60.0%,26m
16966,1,Notoee,2942,0,3,2,5,60.0%,26m
16966,2,LOBO,2942,0,3,2,5,60.0%,29m
16966,2,JimHalpert,2942,62,2,3,5,40.0%,39m
16966,1,[nieBla]Axwel,2942,0,2,5,7,28.6%,11m
16966,1,[GMBRs]GANK,2942,97,2,8,10,20.0%,35m
16966,3,Vezza,2942,0,1,1,2,50.0%,1h
16966,1,[DETER]MrCallOfDuty,2942,0,1,1,2,50.0%,3h
16966,2,[LTlord]daryl,2942,0,1,3,4,25.0%,10m
16966,2,BEEEEJ,2942,0,0,3,3,0.0%,10m
16966,3,[TRETER]Wavic,2942,0,0,8,8,0.0%,19m
16997,2,Engorage,2941,1614,203,167,370,54.9%,12m
16997,1,Woods,2941,480,118,102,220,53.6%,7m
16997,1,[ITSDC]ThorEGo,2941,1624,118,114,232,50.9%,31m
16997,1,NinjaDubs,2941,944,33,39,72,45.8%,20m
16997,1,EbE,2941,450,14,20,34,41.2%,15m
16997,2,Benjanator,2941,301,12,6,18,66.7%,10m
16997,2,[Pharoh]JDM,2941,255,10,10,20,50.0%,6m
16997,2,aku,2941,238,9,7,16,56.2%,6m
16997,1,ElPope,2941,220,8,7,15,53.3%,19m
16997,2,NOOBSLAYER,2941,230,8,11,19,42.1%,21m
16997,3,Erica,2941,211,7,8,15,46.7%,39m
16997,2,LEXUS,2941,30,2,2,4,50.0%,10m
16997,1,[ZGZGZG]ultralisc,2941,70,2,6,8,25.0%,28m
16997,1,Sefirot,2941,71,2,8,10,20.0%,8m
16997,2,[Vtta]Rasec,2941,0,1,1,2,50.0%,12m
16997,2,LongJohnson,2941,0,1,1,2,50.0%,37m
16997,2,[TNGVN]Aorum,2941,36,1,3,4,25.0%,20m
16997,1,DegradedMeat,2941,0,0,1,1,0.0%,3h
16997,2,eloz,2941,0,0,1,1,0.0%,16m
16997,2,DingusKhan,2941,0,0,5,5,0.0%,23m
17017,2,Hadouken,2940,871,79,71,150,52.7%,21m
17017,2,EggandToast,2940,1005,59,41,100,59.0%,4m
17017,1,toesh,2940,1313,54,53,107,50.5%,22m
17017,2,[CCBB]TrainXII,2940,732,38,22,60,63.3%,31m
17017,3,Bleak,2940,662,22,34,56,39.3%,17m
17017,1,Marasy,2940,124,13,10,23,56.5%,14m
17017,1,[Emb3rs]Skipper,2940,418,12,15,27,44.4%,25m
17017,1,HellRaiseR,2940,186,10,9,19,52.6%,21m
17017,2,Homie,2940,166,8,5,13,61.5%,9m
17017,1,FRANCHU,2940,0,5,1,6,83.3%,53m
17017,2,[TANn]PlairE,2940,90,4,2,6,66.7%,4m
17017,2,Yici,2940,114,4,3,7,57.1%,13m
17017,2,RUSHBANSHEE,2940,0,3,2,5,60.0%,12m
17017,2,HiddenSquid,2940,30,2,1,3,66.7%,12m
17017,1,[NEO]Divine,2940,30,2,5,7,28.6%,30m
17017,2,KalxViper,2940,0,1,0,1,100.0%,15m
17017,2,[GOPERÚ]miamius,2940,32,1,1,2,50.0%,4m
17017,1,[Flexy]FarenHaight,2940,0,1,1,2,50.0%,42m
17017,2,panes,2940,0,0,1,1,0.0%,23m
17036,3,[MD420]Placenta,2939,1552,455,403,858,53.0%,19m
17036,1,Spiff,2939,1628,168,168,336,50.0%,36m
17036,1,NiGhT,2939,1069,129,116,245,52.7%,25m
17036,1,Rildenfor,2939,1567,104,84,188,55.3%,37m
17036,1,[BUTIFL]Zeebz,2939,1374,58,48,106,54.7%,13m
17036,2,hatsunemiku,2939,165,9,3,12,75.0%,42m
17036,2,[CHAPU]DARK,2939,254,8,6,14,57.1%,16m
17036,1,Closed,2939,259,7,9,16,43.8%,13m
17036,1,CyMyRy,2939,266,6,10,16,37.5%,28m
17036,2,TankBoyUSA,2939,50,5,4,9,55.6%,29m
17036,1,StoneWallJck,2939,0,3,3,6,50.0%,23m
17036,2,rookie,2939,0,1,1,2,50.0%,14m
17036,2,LanceGabriel,2939,0,1,4,5,20.0%,6m
17036,1,ASPEC,2939,0,1,10,11,9.1%,13m
17036,1,JRH,2939,0,0,1,1,0.0%,1h
17036,2,KPisNOOB,2939,0,0,1,1,0.0%,20m
17036,2,strikehard,2939,0,0,5,5,0.0%,31m
17053,3,CMax,2938,1580,400,400,800,50.0%,12m
17053,3,TheForce,2938,1615,296,300,596,49.7%,15m
17053,1,xiaobaibai,2938,1484,167,140,307,54.4%,39m
17053,2,Brotoss,2938,1581,132,121,253,52.2%,34m
17053,1,vitamin,2938,1608,100,98,198,50.5%,39m
17053,1,DarKo,2938,1301,82,80,162,50.6%,3m
17053,3,luckytiger,2938,1245,76,82,158,48.1%,5m
17053,1,[LGNxx]Outlawz,2938,1347,53,48,101,52.5%,24m
17053,2,IIIlllIlIlIl,2938,306,51,43,94,54.3%,4m
17053,2,[XpKAc]Lorsond,2938,955,43,29,72,59.7%,40m
17053,2,Winger,2938,758,31,31,62,50.0%,29m
17053,2,razE,2938,400,26,16,42,61.9%,6m
17053,2,ProtossHuntr,2938,519,24,16,40,60.0%,42m
17053,2,Jackco,2938,602,24,17,41,58.5%,10m
17053,3,MrRosewater,2938,159,6,5,11,54.5%,1h
17053,2,[Tang]Gawyn,2938,152,5,6,11,45.5%,34m
17053,1,Xian,2938,97,4,2,6,66.7%,45m
17053,3,YuhangYuhang,2938,0,4,3,7,57.1%,3h
17053,2,CWCHW,2938,114,4,4,8,50.0%,6m
17053,2,VapoR,2938,118,4,7,11,36.4%,29m
17053,1,[Helsm]Cosmotology,2938,144,3,1,4,75.0%,7m
17053,2,Mrdie,2938,60,3,4,7,42.9%,24m
17053,2,RubeGamer,2938,90,3,4,7,42.9%,18m
17053,2,Sean,2938,90,3,6,9,33.3%,10m
17053,3,Fury,2938,94,3,8,11,27.3%,11m
17053,2,[TMSF]STARFOX,2938,0,1,0,1,100.0%,19m
17053,2,[CHAPU]JulinkG,2938,0,1,1,2,50.0%,10m
17053,2,[xLgNx]rageMarine,2938,30,1,2,3,33.3%,39m
17053,2,shoukaku,2938,30,1,3,4,25.0%,25m
17053,1,DarkPhoenix,2938,48,1,5,6,16.7%,1h
17053,2,Matt,2938,0,0,1,1,0.0%,40m
17053,2,ThePhoBros,2938,0,0,5,5,0.0%,21m
17085,2,roofkorean,2937,733,45,36,81,55.6%,10m
17085,1,kLooTCh,2937,1026,39,39,78,50.0%,5m
17085,1,[BUTIFL]Daoh,2937,992,33,43,76,43.4%,28m
17085,2,[PTMR]elTioPatas,2937,718,29,21,50,58.0%,17m
17085,2,Giovanna,2937,672,28,20,48,58.3%,37m
17085,2,GoldMaster,2937,548,22,14,36,61.1%,6m
17085,2,DiegoRSG,2937,462,17,15,32,53.1%,15m
17085,2,DarkyiesLord,2937,299,11,8,19,57.9%,10m
17085,2,[cl0udM]Hunter,2937,278,10,5,15,66.7%,25m
17085,2,NeoBlade,2937,152,4,2,6,66.7%,32m
17085,2,YUM,2937,102,2,1,3,66.7%,29m
17085,2,CaMm,2937,0,2,1,3,66.7%,10m
17085,2,[Gakki]Syruvy,2937,62,2,2,4,50.0%,17m
17085,2,BeevrTeezr,2937,58,2,2,4,50.0%,10m
17085,2,Hypersnail,2937,0,1,0,1,100.0%,29m
17085,2,[FlENDS]Element,2937,0,1,0,1,100.0%,6m
17085,1,PRiestC,2937,0,1,1,2,50.0%,3h
17085,2,Target,2937,0,1,2,3,33.3%,16m
17085,1,Nosde,2937,0,1,2,3,33.3%,1h
17085,2,mortem,2937,0,0,1,1,0.0%,39m
17085,2,BladeKain,2937,0,0,1,1,0.0%,42m
17085,2,Chris,2937,0,0,1,1,0.0%,39m
17107,3,Sauer,2936,833,106,106,212,50.0%,30m
17107,3,AkFortySeven,2936,1482,98,86,184,53.3%,41m
17107,2,HavocWreaker,2936,1209,74,73,147,50.3%,31m
17107,1,[LDLF]KOHLER,2936,1519,60,58,118,50.8%,24m
17107,3,BleuElephant,2936,1190,43,53,96,44.8%,17m
17107,2,[ONutz]entropy,2936,451,19,17,36,52.8%,31m
17107,2,Arostegui,2936,392,15,13,28,53.6%,31m
17107,3,Rumata,2936,294,14,14,28,50.0%,23m
17107,1,TheBoss,2936,254,8,11,19,42.1%,19m
17107,2,[DSTN]Spyko,2936,139,6,5,11,54.5%,45m
17107,2,Moremost,2936,176,6,6,12,50.0%,10m
17107,3,PhotonNoob,2936,170,5,1,6,83.3%,3h
17107,2,[BLLRMF]BoTSyriO,2936,88,4,6,10,40.0%,7m
17107,2,millemille,2936,0,3,2,5,60.0%,24m
17107,2,thecurrent,2936,60,2,5,7,28.6%,1m
17107,2,[killpp]Bloodinface,2936,30,1,1,2,50.0%,15m
17107,1,PlasmaMarine,2936,97,1,1,2,50.0%,1h
17107,2,JUAN,2936,0,0,1,1,0.0%,42m
17107,2,TeejayYou,2936,0,0,1,1,0.0%,13m
17126,3,Benev,2935,1554,393,373,766,51.3%,13m
17126,2,MindGrape,2935,1412,60,51,111,54.1%,40m
17126,1,Screwface,2935,539,18,21,39,46.2%,39m
17126,2,Bell,2935,336,12,8,20,60.0%,6m
17126,2,Everost,2935,300,11,11,22,50.0%,29m
17126,2,lllbluelll,2935,266,10,11,21,47.6%,6m
17126,2,GreasyJoe,2935,296,10,12,22,45.5%,15m
17126,2,RICKY,2935,266,10,13,23,43.5%,11m
17126,3,Crash,2935,222,7,3,10,70.0%,50m
17126,2,Achex,2935,168,7,4,11,63.6%,7m
17126,1,[Thepik]Scars,2935,145,5,3,8,62.5%,3h
17126,2,PROTOSS,2935,73,3,3,6,50.0%,32m
17126,1,PantsMcEnzie,2935,36,2,4,6,33.3%,39m
17126,2,Azhrei,2935,30,2,5,7,28.6%,15m
17126,2,[xiuer]MagicTerran,2935,0,1,0,1,100.0%,4m
17126,1,Pariah,2935,97,1,1,2,50.0%,1h
17126,2,Neoxs,2935,0,1,1,2,50.0%,25m
17126,2,SystemFlamme,2935,30,1,3,4,25.0%,18m
17126,1,Yuma,2935,0,0,1,1,0.0%,55m
17145,3,gigabitte,2934,1591,321,313,634,50.6%,2m
17145,2,InPuls,2934,1604,199,181,380,52.4%,20m
17145,2,Ghost,2934,1563,185,158,343,53.9%,11m
17145,1,Tacity,2934,1659,101,99,200,50.5%,27m
17145,2,Lecmik,2934,849,36,27,63,57.1%,31m
17145,2,[BJWD]llllllllllll,2934,744,32,20,52,61.5%,7m
17145,2,eCakes,2934,430,27,16,43,62.8%,28m
17145,1,Xerolag,2934,352,10,17,27,37.0%,27m
17145,2,Killosopher,2934,221,9,8,17,52.9%,30m
17145,2,[DJNKoo]TheFlock,2934,268,9,9,18,50.0%,10m
17145,2,Sprite,2934,174,6,7,13,46.2%,26m
17145,2,ferror,2934,95,5,8,13,38.5%,4m
17145,3,Sheer,2934,134,3,1,4,75.0%,3m
17145,2,BurningMan,2934,86,3,4,7,42.9%,25m
17145,1,[p0o]GrandMJAber,2934,30,2,3,5,40.0%,36m
17145,2,ShockSword,2934,88,2,4,6,33.3%,32m
17161,2,Pepe,2933,1085,124,96,220,56.4%,15m
17161,1,[BNKRZ]Tyler,2933,1503,106,91,197,53.8%,11m
17161,1,trululord,2933,1657,94,81,175,53.7%,34m
17161,2,Slawsh,2933,938,52,43,95,54.7%,29m
17161,2,Anders,2933,809,33,24,57,57.9%,42m
17161,1,[WDRE]BDsnickers,2933,905,33,36,69,47.8%,39m
17161,1,Bradders,2933,423,15,8,23,65.2%,11m
17161,2,[ChiFan]MindSpiritG,2933,342,12,9,21,57.1%,11m
17161,3,[35of35]CRezent,2933,317,10,9,19,52.6%,28m
17161,1,[CHNboy]hanbing,2933,223,8,8,16,50.0%,39m
17161,2,[GOPERÚ]Edukill,2933,102,7,5,12,58.3%,21m
17161,2,joydrop,2933,160,6,8,14,42.9%,6m
17161,2,GrenSuin,2933,90,4,6,10,40.0%,39m
17161,1,WicketOwl,2933,0,3,2,5,60.0%,48m
17161,1,Indigos,2933,0,2,3,5,40.0%,3h
17161,2,TinyGabe,2933,0,1,1,2,50.0%,16m
17161,1,Mthunderlaw,2933,0,0,1,1,0.0%,3h
17161,2,SrB,2933,0,0,2,2,0.0%,17m
17161,2,pacman,2933,0,0,2,2,0.0%,12m
17161,2,KraitMarais,2933,0,0,3,3,0.0%,38m
17181,3,Guccifer,2932,1582,208,205,413,50.4%,35m
17181,2,[IGeaL]repanpan,2932,1551,144,112,256,56.2%,40m
17181,2,YokitoFokyto,2932,1430,79,45,124,63.7%,39m
17181,2,Jauvil,2932,1557,67,60,127,52.8%,26m
17181,2,ADMBeaver,2932,1012,59,40,99,59.6%,22m
17181,2,SupDepReq,2932,620,58,43,101,57.4%,31m
17181,1,Savage,2932,1371,54,55,109,49.5%,37m
17181,1,horizon,2932,1428,51,54,105,48.6%,3m
17181,2,Sif,2932,795,37,20,57,64.9%,30m
17181,2,[DarkAG]Zergasm,2932,898,34,28,62,54.8%,29m
17181,3,myamsar,2932,867,28,40,68,41.2%,27m
17181,1,Serrif,2932,628,25,27,52,48.1%,40m
17181,3,PhattyNutz,2932,330,19,29,48,39.6%,37m
17181,2,zim,2932,477,18,19,37,48.6%,6m
17181,1,Chuck,2932,460,13,24,37,35.1%,3m
17181,3,JohnDanaher,2932,286,12,11,23,52.2%,9m
17181,2,HoTCHoCo,2932,140,8,6,14,57.1%,39m
17181,2,joemama,2932,176,6,1,7,85.7%,6m
17181,2,lockon,2932,158,6,7,13,46.2%,20m
17181,2,superkiller,2932,177,5,3,8,62.5%,39m
17181,2,[vGDM]santy,2932,120,4,4,8,50.0%,10m
17181,1,Lebron,2932,0,3,2,5,60.0%,17m
17181,2,titan,2932,92,3,5,8,37.5%,19m
17181,2,[SoaP42]Brayday,2932,30,2,1,3,66.7%,35m
17181,2,[AK48]RayKnight,2932,31,1,2,3,33.3%,24m
17181,2,GhostEffect,2932,0,0,1,1,0.0%,37m
17181,2,ShtStain,2932,0,0,1,1,0.0%,6m
17181,2,PaulGR,2932,0,0,2,2,0.0%,15m
17209,2,PCsito,2931,1606,123,105,228,53.9%,26m
17209,2,[MPE]Calamardo,2931,1463,75,70,145,51.7%,30m
17209,2,Mahambah,2931,928,64,48,112,57.1%,32m
17209,2,KozanFanOne,2931,1102,64,53,117,54.7%,15m
17209,3,[WPG87]peter,2931,531,63,73,136,46.3%,10m
17209,1,[FRASC2]Jung,2931,660,22,27,49,44.9%,42m
17209,1,ShipWreack,2931,271,12,5,17,70.6%,25m
17209,2,MolarBear,2931,356,12,15,27,44.4%,25m
17209,2,kevin,2931,314,11,12,23,47.8%,6m
17209,2,Tatanka,2931,205,7,9,16,43.8%,29m
17209,1,[P00P2]RocketMan,2931,198,7,10,17,41.2%,27m
17209,1,Fireball,2931,165,6,4,10,60.0%,1h
17209,3,ALTLSnine,2931,113,5,7,12,41.7%,33m
17209,2,DeathFog,2931,126,4,0,4,100.0%,26m
17209,2,pipos,2931,130,4,0,4,100.0%,23m
17209,1,acccky,2931,180,4,8,12,33.3%,18m
17209,2,GoGoGo,2931,0,3,2,5,60.0%,39m
17209,2,Valandir,2931,53,2,3,5,40.0%,4m
17209,2,PhotophilouS,2931,32,1,2,3,33.3%,23m
17209,2,TYYT,2931,0,1,2,3,33.3%,22m
17209,2,Hello,2931,0,0,1,1,0.0%,13m
17209,2,CZMEX,2931,0,0,1,1,0.0%,12m
17209,2,Quantum,2931,0,0,1,1,0.0%,17m
17232,1,Slauney,2930,1512,206,199,405,50.9%,25m
17232,2,steven,2930,1214,127,110,237,53.6%,35m
17232,3,SaulGoodman,2930,1388,85,105,190,44.7%,6m
17232,2,Revoke,2930,1368,76,59,135,56.3%,7m
17232,1,Seeing,2930,1458,65,57,122,53.3%,36m
17232,3,Loamy,2930,424,65,70,135,48.1%,33m
17232,3,[Ash3s]SNK,2930,621,57,68,125,45.6%,22m
17232,2,TorqueAU,2930,941,50,48,98,51.0%,10m
17232,2,Xanthus,2930,889,36,26,62,58.1%,13m
17232,2,Ryahri,2930,317,35,24,59,59.3%,7m
17232,3,Violento,2930,1054,34,52,86,39.5%,3m
17232,2,JHJH,2930,715,32,24,56,57.1%,20m
17232,1,THEwomnKillr,2930,844,29,31,60,48.3%,11m
17232,1,Teddy,2930,259,21,17,38,55.3%,28m
17232,2,Leuthas,2930,365,15,8,23,65.2%,17m
17232,2,Samsung,2930,323,13,14,27,48.1%,34m
17232,2,leviatan,2930,354,12,10,22,54.5%,10m
17232,2,MrMcNasty,2930,340,11,9,20,55.0%,34m
17232,1,[Ech0s]ArabiaKnight,2930,346,11,17,28,39.3%,21m
17232,1,TryingBio,2930,255,10,9,19,52.6%,28m
17232,1,[Cryptc]ScaryPancake,2930,150,5,6,11,45.5%,34m
17232,2,HomerovCv,2930,120,4,4,8,50.0%,6m
17232,1,MeldrathxDBx,2930,0,3,2,5,60.0%,1h
17232,2,[NFKing]moonknight,2930,0,3,2,5,60.0%,35m
17232,2,[BRACE]Sstorm,2930,0,3,2,5,60.0%,17m
17232,1,MaoShiSi,2930,0,2,1,3,66.7%,1h
17232,2,Wahishh,2930,30,2,3,5,40.0%,20m
17232,2,Zaenger,2930,0,1,0,1,100.0%,10m
17232,2,TSoB,2930,30,1,1,2,50.0%,29m
17232,3,LosLings,2930,0,1,2,3,33.3%,29m
17232,2,[Fir3s]StporA,2930,30,1,3,4,25.0%,10m
17232,1,Gaussios,2930,0,1,6,7,14.3%,35m
17232,2,[M1]StarGeneral,2930,0,0,1,1,0.0%,34m
17265,2,Wukong,2929,1585,241,228,469,51.4%,30m
17265,1,axzzzzx,2929,1520,151,134,285,53.0%,38m
17265,2,Doran,2929,1574,138,118,256,53.9%,29m
17265,2,DNO,2929,963,79,67,146,54.1%,28m
17265,2,koyo,2929,826,58,51,109,53.2%,28m
17265,2,[Cafés]carloscraft,2929,962,55,46,101,54.5%,15m
17265,2,[FyHr]RicardinniZ,2929,720,52,39,91,57.1%,17m
17265,1,RuneHopper,2929,1174,42,45,87,48.3%,36m
17265,2,[ME123]CDRshepards,2929,922,31,58,89,34.8%,40m
17265,2,FinnMB,2929,666,27,23,50,54.0%,6m
17265,2,hache,2929,568,22,20,42,52.4%,19m
17265,2,SwigLee,2929,292,13,3,16,81.2%,15m
17265,1,SteeL,2929,306,12,9,21,57.1%,3h
17265,2,[Broxit]SeansFriend,2929,269,11,4,15,73.3%,13m
17265,2,[MaxWin]HypaLinx,2929,208,8,9,17,47.1%,3m
17265,2,momofuku,2929,226,7,6,13,53.8%,29m
17265,2,NovaBlood,2929,182,6,9,15,40.0%,20m
17265,1,[xGashx]TonyMontana,2929,186,6,15,21,28.6%,11m
17265,2,Spell,2929,118,5,7,12,41.7%,42m
17265,2,SangreShot,2929,124,3,1,4,75.0%,30m
17265,1,deathterran,2929,90,2,3,5,40.0%,25m
17265,1,Suchidoggo,2929,0,2,3,5,40.0%,1h
17265,2,[GLHFAG]skhighcraft,2929,0,1,0,1,100.0%,34m
17265,1,[BIaze]Grey,2929,0,1,1,2,50.0%,2h
17265,2,[TEAMwC]GoatHerder,2929,121,1,9,10,10.0%,6m
17265,1,Reggimiah,2929,0,0,1,1,0.0%,15m
17265,3,[TlLT]gollahon,2929,0,0,1,1,0.0%,58m
17292,1,AceToneGom,2928,1657,236,216,452,52.2%,25m
17292,3,[ØÛ]Knd,2928,1520,208,217,425,48.9%,33m
17292,1,HerrKamerad,2928,1654,163,153,316,51.6%,35m
17292,2,[Astrus]Kobaian,2928,1140,96,91,187,51.3%,35m
17292,3,SonOfSand,2928,1187,58,68,126,46.0%,30m
17292,1,[NrFms]RenegadeX,2928,1064,49,34,83,59.0%,24m
17292,2,[dtwist]Singleparent,2928,541,47,10,57,82.5%,39m
17292,2,[K9]TaSSaDaR,2928,858,37,29,66,56.1%,10m
17292,1,[Sqnch]Slaz,2928,277,10,12,22,45.5%,27m
17292,2,[Klukun]Zacek,2928,309,9,9,18,50.0%,20m
17292,3,RosMaria,2928,184,8,4,12,66.7%,2h
17292,2,DumDum,2928,212,8,6,14,57.1%,33m
17292,2,folly,2928,172,7,6,13,53.8%,29m
17292,2,Momin,2928,140,5,7,12,41.7%,41m
17292,3,DRTfootman,2928,98,3,19,22,13.6%,17m
17292,2,matcha,2928,0,1,0,1,100.0%,24m
17292,2,MarCraft,2928,0,1,1,2,50.0%,16m
17292,1,Mopsi,2928,88,1,1,2,50.0%,13m
17292,3,[RoyaI]SAKA,2928,97,1,4,5,20.0%,1h
17292,2,[Chibii]BrokenJarX,2928,91,1,8,9,11.1%,23m
17292,2,[SRCHA]JBont,2928,0,0,1,1,0.0%,1m
17292,3,[DthWng]OrionTC,2928,0,0,1,1,0.0%,4m
17292,3,Magoo,2928,0,0,1,1,0.0%,60m
17315,2,Conotoxin,2927,1369,111,79,190,58.4%,35m
17315,2,joshcold,2927,934,52,52,104,50.0%,11m
17315,2,[sk3tch]Music,2927,746,35,23,58,60.3%,15m
17315,2,[PooNys]Chuncocoo,2927,776,35,26,61,57.4%,6m
17315,2,KibeXx,2927,733,31,20,51,60.8%,21m
17315,2,AvtarChupito,2927,565,25,24,49,51.0%,30m
17315,2,[Sense]Galileo,2927,470,18,16,34,52.9%,22m
17315,1,Ragnarok,2927,373,15,14,29,51.7%,2m
17315,1,[RUSHya]Ares,2927,447,14,17,31,45.2%,2m
17315,1,HENTAILOLI,2927,154,9,6,15,60.0%,37m
17315,1,Julian,2927,274,8,16,24,33.3%,2m
17315,2,skarloey,2927,198,7,8,15,46.7%,42m
17315,2,[PONYS]PandaKrator,2927,164,6,2,8,75.0%,10m
17315,2,[llKSll]Inca,2927,146,6,4,10,60.0%,12m
17315,2,UNSLAUGHT,2927,174,6,8,14,42.9%,20m
17315,1,[LifeF]Frimp,2927,32,5,4,9,55.6%,38m
17315,2,[x519]Debooter,2927,116,4,0,4,100.0%,34m
17315,2,[QuAzar]pinguchingu,2927,147,4,4,8,50.0%,34m
17315,2,Pheidias,2927,108,4,4,8,50.0%,41m
17315,2,LcCG,2927,112,3,0,3,100.0%,16m
17315,2,meatlonlon,2927,86,3,4,7,42.9%,17m
17315,2,Flow,2927,107,2,2,4,50.0%,39m
17315,2,Hosomi,2927,38,1,3,4,25.0%,6m
17315,2,ridik,2927,30,1,3,4,25.0%,7m
17315,2,Chewy,2927,44,1,6,7,14.3%,43m
17315,2,[dBASED]BigFloppa,2927,0,0,1,1,0.0%,6m
17315,2,Cosmoz,2927,0,0,1,1,0.0%,13m
17315,2,VITESSE,2927,0,0,1,1,0.0%,37m
17343,2,Bert,2926,1587,251,207,458,54.8%,4m
17343,2,[Blacer]jovani,2926,1600,250,234,484,51.7%,3m
17343,2,ITBYY,2926,1613,76,53,129,58.9%,24m
17343,1,[INextI]Angel,2926,1010,66,58,124,53.2%,3m
17343,2,altrix,2926,822,41,40,81,50.6%,21m
17343,1,Dreak,2926,732,36,26,62,58.1%,2m
17343,1,ossian,2926,684,28,32,60,46.7%,31m
17343,1,[DhZAc1]Zeusgf,2926,176,6,12,18,33.3%,15m
17343,1,Bogdan,2926,40,5,4,9,55.6%,6m
17343,2,Blackheart,2926,142,5,5,10,50.0%,19m
17343,2,[HaCoLa]Krabator,2926,162,4,3,7,57.1%,6m
17343,2,Jack,2926,106,4,5,9,44.4%,17m
17343,2,[eX]KillerBR,2926,90,3,4,7,42.9%,34m
17343,2,FlasControl,2926,102,3,5,8,37.5%,16m
17343,2,[BEANNN]llSickGame,2926,0,1,0,1,100.0%,15m
17343,2,SolidSnake,2926,36,1,1,2,50.0%,11m
17343,2,XxeckerxX,2926,30,1,1,2,50.0%,18m
17343,2,CornStar,2926,30,1,3,4,25.0%,12m
17343,2,PatroClus,2926,30,1,5,6,16.7%,12m
17343,1,Strange,2926,38,1,7,8,12.5%,15m
17343,2,[CORON4]vIrUS,2926,0,0,1,1,0.0%,4m
17364,2,[BoAVN]NewGenOfJer,2925,1574,233,212,445,52.4%,6m
17364,1,[SPAZ8]BIGZ,2925,1559,146,141,287,50.9%,2m
17364,3,PennyBoy,2925,1278,138,135,273,50.5%,26m
17364,2,Rosas,2925,643,94,74,168,56.0%,6m
17364,2,NousDefions,2925,1238,59,35,94,62.8%,25m
17364,2,Alexeon,2925,720,31,24,55,56.4%,17m
17364,2,[JoroSC]Viruz,2925,557,25,18,43,58.1%,10m
17364,1,SamuraiPizza,2925,582,19,21,40,47.5%,11m
17364,2,NotMyDay,2925,427,16,14,30,53.3%,8m
17364,1,Tapatio,2925,477,14,17,31,45.2%,15m
17364,1,Azrapsel,2925,212,11,14,25,44.0%,30m
17364,2,guppy,2925,268,8,5,13,61.5%,2h
17364,2,Fergs,2925,217,8,7,15,53.3%,16m
17364,1,[Conway]Chenzewei,2925,86,5,13,18,27.8%,30m
17364,2,PleaseCheese,2925,136,4,1,5,80.0%,10m
17364,3,[BTHT]Vannen,2925,97,4,4,8,50.0%,1h
17364,2,Anthropomed,2925,118,4,5,9,44.4%,42m
17364,1,chuhbaby,2925,130,4,11,15,26.7%,5m
17364,2,[OokOok]Ape,2925,96,3,7,10,30.0%,28m
17364,2,vokobe,2925,112,2,1,3,66.7%,16m
17364,2,PatchTerran,2925,60,2,2,4,50.0%,19m
17364,1,TooFoxy,2925,38,2,6,8,25.0%,36m
17364,2,[NiERDS]bohdan,2925,0,1,0,1,100.0%,6m
17364,2,StarkTony,2925,0,1,0,1,100.0%,25m
17364,2,[FalPal]FattyESQ,2925,0,0,1,1,0.0%,10m
17364,2,KimJongUn,2925,0,0,1,1,0.0%,41m
17364,2,[Black0]NoalKing,2925,0,0,1,1,0.0%,6m
17364,2,DGproRD,2925,0,0,1,1,0.0%,29m
17364,2,[LCE]CRICRO,2925,0,0,2,2,0.0%,20m
17393,1,ElGuapo,2924,1414,145,130,275,52.7%,3m
17393,3,[GAP]Canasian,2924,1530,116,124,240,48.3%,33m
17393,1,[monin]Yaxhiro,2924,1045,45,40,85,52.9%,11m
17393,2,cmyr,2924,292,14,8,22,63.6%,23m
17393,2,inaban,2924,302,12,10,22,54.5%,24m
17393,2,fiftySupply,2924,244,11,7,18,61.1%,13m
17393,2,Reaper,2924,170,6,6,12,50.0%,35m
17393,1,[Colrs]VeryCool,2924,199,6,9,15,40.0%,13m
17393,2,NEWTON,2924,81,5,3,8,62.5%,24m
17393,2,OLBAID,2924,142,5,6,11,45.5%,29m
17393,1,Biden,2924,214,4,2,6,66.7%,3h
17393,3,brrrrrrr,2924,173,4,8,12,33.3%,40m
17393,1,Jnops,2924,0,3,2,5,60.0%,2h
17393,3,BangDingOw,2924,64,3,12,15,20.0%,28m
17393,1,HelpMe,2924,0,2,3,5,40.0%,40m
17393,2,KilluaZoldiK,2924,30,2,4,6,33.3%,29m
17393,2,Absolut,2924,0,1,1,2,50.0%,1m
17393,2,BugsBunny,2924,30,1,1,2,50.0%,19m
17411,2,piggy,2923,1184,55,35,90,61.1%,23m
17411,2,Yinzknow,2923,1216,55,51,106,51.9%,20m
17411,1,DemoDude,2923,413,39,29,68,57.4%,15m
17411,1,Narkobear,2923,539,30,17,47,63.8%,10m
17411,2,[Deez]Incubus,2923,527,23,14,37,62.2%,10m
17411,1,lili,2923,522,23,17,40,57.5%,34m
17411,2,Beluga,2923,377,15,14,29,51.7%,12m
17411,2,soft,2923,285,9,7,16,56.2%,20m
17411,1,[EndPro]Yered,2923,314,9,16,25,36.0%,5m
17411,2,[imHard]unco,2923,128,7,3,10,70.0%,38m
17411,2,KardKaj,2923,107,4,6,10,40.0%,29m
17411,1,Dolskin,2923,0,3,2,5,60.0%,40m
17411,2,JeanFer,2923,60,3,4,7,42.9%,29m
17411,1,bluenoodle,2923,38,3,6,9,33.3%,12m
17411,2,[Cullen]Alcatranz,2923,30,2,0,2,100.0%,33m
17411,3,[DarkAG]LvlTwoNinja,2923,0,2,7,9,22.2%,4m
17411,2,Nobita,2923,0,1,0,1,100.0%,10m
17411,2,[p4p]CCbarsoap,2923,30,1,1,2,50.0%,4m
17411,2,[kdUb]INcrypted,2923,30,1,4,5,20.0%,12m
17411,2,Freack,2923,30,1,4,5,20.0%,23m
17411,2,Loritolord,2923,0,0,1,1,0.0%,39m
17411,2,lost,2923,0,0,1,1,0.0%,26m
17411,2,[TGosuC]Moglie,2923,0,0,2,2,0.0%,16m
17411,2,[Emb3rs]Tell,2923,0,0,3,3,0.0%,31m
17411,1,[RUMB]Moustro,2923,0,0,5,5,0.0%,3h
17436,1,MrFOX,2922,1670,309,281,590,52.4%,12m
17436,3,swish,2922,1193,277,257,534,51.9%,22m
17436,2,Andovski,2922,858,176,153,329,53.5%,16m
17436,1,bustercat,2922,1420,137,138,275,49.8%,5m
17436,1,Cyborg,2922,869,71,62,133,53.4%,27m
17436,2,[PTHero]RoguePianist,2922,1462,69,56,125,55.2%,12m
17436,2,Beefi,2922,1150,45,44,89,50.6%,12m
17436,1,[CS0]ShadowWil,2922,634,29,25,54,53.7%,16m
17436,2,loner,2922,570,28,21,49,57.1%,8m
17436,2,Max,2922,698,27,20,47,57.4%,20m
17436,1,SkepticSloth,2922,296,9,13,22,40.9%,40m
17436,3,[LASG]Exodus,2922,189,7,7,14,50.0%,54m
17436,2,KennyPowers,2922,148,6,4,10,60.0%,12m
17436,2,[KerriS]Beyongsong,2922,0,1,0,1,100.0%,29m
17436,3,sicilias,2922,0,1,1,2,50.0%,47m
17436,3,linhprobodoi,2922,0,1,1,2,50.0%,18m
17436,2,SuperJohn,2922,30,1,3,4,25.0%,6m
17436,3,anabuki,2922,0,0,7,7,0.0%,10m
17454,2,crysys,2921,1574,307,285,592,51.9%,13m
17454,3,[MKT]CHICKENstar,2921,1462,217,207,424,51.2%,39m
17454,3,mike,2921,1478,99,91,190,52.1%,28m
17454,2,Gygy,2921,1578,73,52,125,58.4%,17m
17454,2,BulldozedAU,2921,792,31,30,61,50.8%,11m
17454,1,SimpleJack,2921,360,13,7,20,65.0%,39m
17454,2,Yawar,2921,330,12,12,24,50.0%,9m
17454,1,[Rang3r]BDizzy,2921,296,12,14,26,46.2%,32m
17454,3,SgtSasquatch,2921,185,10,13,23,43.5%,39m
17454,2,PipBoyTwoK,2921,196,7,10,17,41.2%,28m
17454,1,weenuk,2921,162,4,6,10,40.0%,50m
17454,3,[InGt]Yukon,2921,209,4,11,15,26.7%,48m
17454,2,Cernoborg,2921,102,3,0,3,100.0%,30m
17454,2,PelicanWhomp,2921,126,3,1,4,75.0%,7m
17454,1,babyboi,2921,0,3,2,5,60.0%,3h
17454,2,[NexusP]CurseTerran,2921,114,2,2,4,50.0%,31m
17454,2,Dopen,2921,0,1,0,1,100.0%,25m
17454,2,[TheOGz]Operational,2921,0,1,0,1,100.0%,25m
17454,2,RavingMadd,2921,0,1,0,1,100.0%,7m
17454,2,NUCE,2921,0,1,1,2,50.0%,7m
17454,2,[LFUT]Alexis,2921,30,1,3,4,25.0%,20m
17454,2,SmurfysLaw,2921,0,0,1,1,0.0%,4m
17476,1,Potsie,2920,1655,363,362,725,50.1%,12m
17476,2,CrayonEater,2920,1583,176,149,325,54.2%,10m
17476,1,Devgru,2920,1467,169,149,318,53.1%,36m
17476,3,[DLe]Stargazer,2920,1496,150,158,308,48.7%,39m
17476,2,[USrp]Animosity,2920,1604,70,67,137,51.1%,42m
17476,1,Reagan,2920,1103,70,70,140,50.0%,36m
17476,2,[Kramer]JimRaynor,2920,621,23,20,43,53.5%,31m
17476,1,cookingcat,2920,346,14,8,22,63.6%,3h
17476,1,Cartman,2920,430,12,24,36,33.3%,20m
17476,1,Smurf,2920,248,11,9,20,55.0%,7m
17476,1,jjc,2920,241,10,10,20,50.0%,48m
17476,2,Bikerboyz,2920,283,10,11,21,47.6%,19m
17476,1,coffeeco,2920,294,9,14,23,39.1%,27m
17476,2,Practitioner,2920,222,8,4,12,66.7%,34m
17476,2,Indy,2920,151,6,0,6,100.0%,38m
17476,2,Goodbye,2920,168,5,3,8,62.5%,26m
17476,2,Nonloso,2920,0,4,1,5,80.0%,17m
17476,2,[juert]Juert,2920,150,4,5,9,44.4%,21m
17476,2,Archiluse,2920,0,3,2,5,60.0%,6m
17476,1,StableGenius,2920,72,3,10,13,23.1%,18m
17476,2,[MkwPE]RaptorDecc,2920,42,2,4,6,33.3%,6m
17476,2,Mongose,2920,30,1,4,5,20.0%,12m
17476,2,Brotoss,2920,0,0,1,1,0.0%,1h
17476,2,WhitEFang,2920,0,0,1,1,0.0%,29m
17500,2,[HARLET]SENJUxMIGUEL,2919,1520,75,77,152,49.3%,34m
17500,1,Jiraya,2919,850,34,32,66,51.5%,40m
17500,2,Tankamaya,2919,768,32,22,54,59.3%,31m
17500,2,Indo,2919,828,32,29,61,52.5%,42m
17500,2,ThanatosRp,2919,485,19,13,32,59.4%,23m
17500,1,[BoAVN]ngovihao,2919,546,17,23,40,42.5%,31m
17500,2,jadO,2919,415,15,17,32,46.9%,26m
17500,1,Pepsin,2919,251,8,10,18,44.4%,30m
17500,3,GetPolitical,2919,144,7,3,10,70.0%,9m
17500,2,GrandHazard,2919,164,4,6,10,40.0%,21m
17500,2,[TWITS]BigHead,2919,126,4,8,12,33.3%,4m
17500,2,SAVAGEDEAD,2919,86,3,3,6,50.0%,23m
17500,2,Cythiel,2919,0,3,3,6,50.0%,10m
17500,2,VIPsedan,2919,0,2,1,3,66.7%,13m
17500,2,Danilo,2919,102,2,1,3,66.7%,30m
17500,2,chanman,2919,106,2,2,4,50.0%,16m
17500,3,[F91GKD]OshinoDio,2919,38,2,2,4,50.0%,57m
17500,2,Kalgara,2919,30,2,3,5,40.0%,5m
17500,2,Kini,2919,0,1,0,1,100.0%,11m
17500,1,[ReX416]Canolio,2919,0,1,10,11,9.1%,1h
17500,2,effoff,2919,0,0,1,1,0.0%,13m
17500,2,Smores,2919,0,0,1,1,0.0%,41m
17500,2,[XDRAX8]DraXSlave,2919,0,0,1,1,0.0%,4m
17500,2,ArcticFox,2919,0,0,2,2,0.0%,31m
17524,3,[SWRBVR]CheezyPutin,2918,1390,334,328,662,50.5%,4m
17524,3,Macroking,2918,1469,286,290,576,49.7%,37m
17524,2,Tomás,2918,1248,92,66,158,58.2%,17m
17524,1,RazorEdge,2918,1388,61,70,131,46.6%,38m
17524,3,thundercat,2918,657,50,62,112,44.6%,2m
17524,1,[EThugz]WiZecraX,2918,590,24,30,54,44.4%,15m
17524,2,[Nitho]Nikthekiller,2918,531,23,13,36,63.9%,29m
17524,1,myself,2918,502,16,22,38,42.1%,26m
17524,1,JKslayer,2918,372,12,17,29,41.4%,31m
17524,2,[nieBla]ZERUEL,2918,292,11,7,18,61.1%,40m
17524,2,[MAYN]twitchChat,2918,240,8,10,18,44.4%,35m
17524,2,aNTi,2918,218,7,11,18,38.9%,16m
17524,2,Wolfshund,2918,184,5,10,15,33.3%,6m
17524,1,Mantis,2918,0,3,3,6,50.0%,1h
17524,2,[ELIDS]ManMallow,2918,78,3,4,7,42.9%,14m
17524,2,[N3RDST]BigJoeLogs,2918,0,1,0,1,100.0%,4m
17524,2,magNETar,2918,0,1,0,1,100.0%,17m
17524,2,WHcov,2918,0,0,1,1,0.0%,12m
17524,2,Peugeot,2918,0,0,1,1,0.0%,1h
17524,2,[tCo9]SuperJoshua,2918,0,0,1,1,0.0%,4m
17524,1,[TØXIC]mtk,2918,0,0,1,1,0.0%,49m
17524,2,BiGBITE,2918,0,0,2,2,0.0%,32m
17546,3,Subaru,2917,1191,372,366,738,50.4%,23m
17546,3,[xLgNx]VisherLord,2917,1569,242,250,492,49.2%,28m
17546,1,[CV0101]memo,2917,1580,162,151,313,51.8%,40m
17546,1,Melkor,2917,1272,109,100,209,52.2%,42m
17546,2,[KJN]KimJongNuke,2917,812,94,92,186,50.5%,34m
17546,2,Andox,2917,1615,68,54,122,55.7%,23m
17546,2,muse,2917,1116,48,38,86,55.8%,39m
17546,2,Focus,2917,1154,44,41,85,51.8%,34m
17546,1,GGKAIROS,2917,1048,42,46,88,47.7%,15m
17546,2,MugrosoCarl,2917,1019,39,36,75,52.0%,30m
17546,1,iCOMEinPEACE,2917,527,23,19,42,54.8%,9m
17546,2,EpicDXT,2917,211,20,20,40,50.0%,12m
17546,2,Pita,2917,357,14,11,25,56.0%,26m
17546,1,SpAzTiC,2917,380,12,18,30,40.0%,32m
17546,1,Solace,2917,408,12,19,31,38.7%,31m
17546,2,[WCNM]TrueBlue,2917,232,9,8,17,52.9%,45m
17546,3,NicaGizmody,2917,173,8,5,13,61.5%,23m
17546,1,Ryanest,2917,196,6,5,11,54.5%,12m
17546,2,Kenshin,2917,30,4,3,7,57.1%,17m
17546,3,Fruit,2917,97,2,2,4,50.0%,2h
17546,1,Damagekill,2917,94,2,7,9,22.2%,25m
17546,2,reggie,2917,0,1,0,1,100.0%,10m
17546,3,Vynix,2917,0,1,1,2,50.0%,8m
17546,2,FRENDOM,2917,30,1,1,2,50.0%,37m
17546,2,[CCCMF]testicana,2917,30,1,2,3,33.3%,10m
17546,1,annbenji,2917,32,1,6,7,14.3%,19m
17546,2,Reaver,2917,0,0,1,1,0.0%,19m
17546,2,oDiNe,2917,0,0,1,1,0.0%,25m
17574,1,BadgKat,2916,833,175,164,339,51.6%,9m
17574,2,Rushi,2916,1570,150,131,281,53.4%,10m
17574,3,greenTree,2916,1573,145,161,306,47.4%,17m
17574,2,owldamage,2916,1399,93,68,161,57.8%,35m
17574,1,[ZTempz]LuNaTiC,2916,1555,87,83,170,51.2%,37m
17574,2,hagar,2916,443,54,41,95,56.8%,29m
17574,2,Kevin,2916,1360,54,52,106,50.9%,23m
17574,1,axel,2916,801,51,44,95,53.7%,28m
17574,2,Notsokoolaid,2916,1133,44,41,85,51.8%,30m
17574,2,Cahuide,2916,755,43,31,74,58.1%,19m
17574,1,DipDuckDive,2916,1037,38,45,83,45.8%,9m
17574,2,JuanBobo,2916,447,25,3,28,89.3%,3m
17574,2,DeadlyKitten,2916,485,22,10,32,68.8%,26m
17574,2,Data,2916,428,18,16,34,52.9%,11m
17574,3,Kryten,2916,328,13,11,24,54.2%,21m
17574,1,Kingman,2916,314,11,20,31,35.5%,15m
17574,1,Natezy,2916,167,6,3,9,66.7%,15m
17574,2,AlTeRaTiOn,2916,112,3,0,3,100.0%,25m
17574,2,MicroJackson,2916,116,3,1,4,75.0%,23m
17574,2,batzi,2916,60,2,3,5,40.0%,39m
17574,2,Mastuur,2916,60,2,4,6,33.3%,25m
17574,1,[NOZO]IngPin,2916,91,2,5,7,28.6%,54m
17574,2,Salty,2916,0,1,0,1,100.0%,6m
17574,1,ImpotentRage,2916,0,1,2,3,33.3%,21m
17574,2,ADAM,2916,0,1,2,3,33.3%,30m
17574,1,Icemanstan,2916,48,1,3,4,25.0%,3h
17574,2,Ghost,2916,30,1,5,6,16.7%,39m
17574,2,tranBot,2916,0,0,1,1,0.0%,40m
17574,2,MauRuS,2916,0,0,1,1,0.0%,9m
17574,2,rob,2916,0,0,3,3,0.0%,17m
17574,2,[Macac0]Yorkatt,2916,0,0,4,4,0.0%,15m
17574,2,PhaseLethal,2916,0,0,5,5,0.0%,49m
17606,1,parka,2915,1311,210,201,411,51.1%,38m
17606,1,Necromancer,2915,1511,115,105,220,52.3%,5m
17606,1,BigT,2915,1122,91,91,182,50.0%,15m
17606,1,blitz,2915,688,28,30,58,48.3%,38m
17606,2,BlueSol,2915,776,28,32,60,46.7%,31m
17606,2,ninecorpses,2915,357,14,9,23,60.9%,29m
17606,3,[YAZI]TypeZerO,2915,303,12,11,23,52.2%,7m
17606,1,ReFuGee,2915,390,12,18,30,40.0%,8m
17606,3,TheKingMelon,2915,318,11,24,35,31.4%,38m
17606,2,FleetAdmiral,2915,119,6,1,7,85.7%,38m
17606,2,[DDLT]Searinoxco,2915,133,6,3,9,66.7%,36m
17606,2,Rakon,2915,186,6,4,10,60.0%,30m
17606,2,[CrazyC]MXGRE,2915,219,6,8,14,42.9%,13m
17606,2,Degenerator,2915,144,5,8,13,38.5%,15m
17606,1,[ZTemp]GrimKeeper,2915,0,3,2,5,60.0%,2h
17606,2,Nick,2915,60,3,3,6,50.0%,12m
17606,2,Tawl,2915,0,1,0,1,100.0%,17m
17606,1,[GOPERÚ]ShadowBoy,2915,0,1,1,2,50.0%,53m
17606,2,Rampage,2915,30,1,6,7,14.3%,23m
17606,2,Dusan,2915,0,0,1,1,0.0%,17m
17626,2,DASMAN,2914,1177,110,92,202,54.5%,6m
17626,2,foxuno,2914,926,92,75,167,55.1%,31m
17626,2,[ANZ]KermitoniT,2914,1387,86,65,151,57.0%,42m
17626,1,Carlton,2914,1557,65,60,125,52.0%,15m
17626,1,JusticeCat,2914,1453,61,53,114,53.5%,34m
17626,2,Inquisitor,2914,965,49,36,85,57.6%,40m
17626,2,Sisifo,2914,893,36,27,63,57.1%,15m
17626,2,[b7rk]Bastrdorck,2914,512,21,22,43,48.8%,30m
17626,2,Migz,2914,437,17,14,31,54.8%,39m
17626,3,Jackintosh,2914,190,7,5,12,58.3%,54m
17626,1,EscaladE,2914,96,4,2,6,66.7%,3h
17626,1,[HQ]smilyking,2914,97,4,3,7,57.1%,15m
17626,1,[EtrOy]patarike,2914,120,4,3,7,57.1%,3h
17626,1,Powerade,2914,48,4,4,8,50.0%,3h
17626,3,[420SD]TonyChocolo,2914,144,3,2,5,60.0%,33m
17626,1,liarez,2914,0,3,2,5,60.0%,40m
17626,1,PowerFly,2914,0,3,2,5,60.0%,51m
17626,2,[JOSUN]Sylar,2914,84,3,7,10,30.0%,7m
17626,2,nathaly,2914,88,2,0,2,100.0%,3m
17626,2,[VetZCo]Crafty,2914,0,1,0,1,100.0%,25m
17626,2,[dreamG]lorienGA,2914,30,1,3,4,25.0%,5m
17626,1,[CGAT]GospelToss,2914,89,1,7,8,12.5%,22m
17626,2,[StmBrk]GeckO,2914,0,0,1,1,0.0%,31m
17626,2,[FreeZi]Contessa,2914,0,0,2,2,0.0%,29m
17650,2,CanCauser,2913,1491,164,144,308,53.2%,9m
17650,1,Poblhaa,2913,1406,94,80,174,54.0%,34m
17650,1,deso,2913,1524,91,82,173,52.6%,33m
17650,1,hani,2913,1611,69,73,142,48.6%,40m
17650,2,sang,2913,506,22,13,35,62.9%,38m
17650,2,GusGamer,2913,298,13,7,20,65.0%,12m
17650,2,Samson,2913,334,13,11,24,54.2%,17m
17650,2,WAJUNG,2913,312,13,14,27,48.1%,12m
17650,2,supertulon,2913,209,10,4,14,71.4%,20m
17650,2,terradogesky,2913,296,10,13,23,43.5%,41m
17650,1,phodu,2913,202,7,4,11,63.6%,5m
17650,2,TehSoulman,2913,152,7,5,12,58.3%,11m
17650,1,[CLPRTY]Beenk,2913,116,5,8,13,38.5%,25m
17650,1,[DKim]lifeforchoir,2913,48,4,4,8,50.0%,38m
17650,2,Duns,2913,89,2,2,4,50.0%,37m
17650,1,Winchester,2913,0,2,3,5,40.0%,3h
17650,2,MooSaShe,2913,0,1,0,1,100.0%,7m
17650,2,Eckart,2913,30,1,2,3,33.3%,10m
17650,2,[KGH]XtremeJPR,2913,93,1,4,5,20.0%,26m
17650,2,Quizic,2913,0,0,1,1,0.0%,16m
17650,1,KnightMares,2913,0,0,1,1,0.0%,54m
17650,2,SoiBoi,2913,0,0,1,1,0.0%,4m
17650,2,[TWPE]Mesta,2913,0,0,1,1,0.0%,17m
17650,2,patoXD,2913,0,0,2,2,0.0%,11m
17650,2,Devil,2913,0,0,6,6,0.0%,30m
17675,2,WangJangler,2912,1345,189,184,373,50.7%,31m
17675,3,Entropian,2912,742,119,115,234,50.9%,42m
17675,3,Flatliner,2912,1087,94,93,187,50.3%,2m
17675,1,star,2912,1079,46,38,84,54.8%,35m
17675,2,IceColdWater,2912,1100,42,42,84,50.0%,19m
17675,3,SonicX,2912,1016,36,55,91,39.6%,33m
17675,1,Dolmatt,2912,829,31,34,65,47.7%,18m
17675,3,HotKeyPlayer,2912,612,21,34,55,38.2%,20m
17675,2,[DhZAc1]Seven,2912,506,19,14,33,57.6%,7m
17675,3,Slayer,2912,298,14,15,29,48.3%,22m
17675,2,jbrooks,2912,332,12,7,19,63.2%,9m
17675,2,bigslaw,2912,361,12,10,22,54.5%,5m
17675,2,haribro,2912,254,10,7,17,58.8%,14m
17675,1,[22IQ]Blitzer,2912,278,8,16,24,33.3%,31m
17675,1,SolidEye,2912,240,7,8,15,46.7%,1h
17675,1,barcodeterra,2912,96,5,4,9,55.6%,55m
17675,3,OliverZ,2912,97,4,4,8,50.0%,58m
17675,2,Carl,2912,102,2,3,5,40.0%,25m
17675,1,Eliptic,2912,0,2,5,7,28.6%,2h
17675,2,Noodlelisk,2912,0,1,0,1,100.0%,9m
17675,2,NeX,2912,0,1,2,3,33.3%,2h
17675,1,LiquidGrass,2912,48,1,2,3,33.3%,23m
17675,2,thedesertfox,2912,30,1,3,4,25.0%,30m
17675,2,Mikhail,2912,30,1,4,5,20.0%,20m
17675,2,Panoramix,2912,0,0,1,1,0.0%,25m
17675,2,dwqdwq,2912,0,0,1,1,0.0%,34m
17675,2,RaioN,2912,0,0,1,1,0.0%,20m
17702,1,Grizz,2911,1656,633,617,1250,50.6%,40m
17702,2,VictorAg,2911,1599,100,73,173,57.8%,5m
17702,1,strategery,2911,1654,84,90,174,48.3%,36m
17702,2,Ragnar,2911,1242,65,58,123,52.8%,2m
17702,3,[CRAKS]ShauN,2911,948,31,51,82,37.8%,33m
17702,2,Beetlejuice,2911,458,21,16,37,56.8%,37m
17702,3,XforesterX,2911,478,17,30,47,36.2%,19m
17702,1,Monolite,2911,418,15,7,22,68.2%,26m
17702,2,memhooz,2911,256,9,5,14,64.3%,23m
17702,2,SacredSelf,2911,172,7,8,15,46.7%,16m
17702,3,[CHAT0S]Anabolic,2911,121,5,5,10,50.0%,60m
17702,1,[TGCF]ace,2911,185,5,6,11,45.5%,40m
17702,2,ROOTBEER,2911,88,4,2,6,66.7%,17m
17702,2,Rookie,2911,18,4,3,7,57.1%,34m
17702,2,blakeN,2911,135,3,1,4,75.0%,16m
17702,1,FrAnKmDD,2911,0,3,2,5,60.0%,3h
17702,1,LiuBei,2911,0,3,2,5,60.0%,3h
17702,1,AiGiLaA,2911,0,3,2,5,60.0%,42m
17702,2,[BJohns]Sonicfire,2911,0,3,3,6,50.0%,26m
17702,2,[BLuRJr]BLuRJr,2911,86,3,4,7,42.9%,14m
17702,2,Wicholmaster,2911,30,2,2,4,50.0%,32m
17702,2,Misael,2911,112,2,2,4,50.0%,13m
17702,2,[10cm]Gunnar,2911,0,2,3,5,40.0%,42m
17702,2,[CosB]Queven,2911,0,1,0,1,100.0%,34m
17702,2,[SyLx]NightMoose,2911,0,1,0,1,100.0%,14m
17702,2,KodiakBear,2911,0,1,0,1,100.0%,37m
17702,2,Senpai,2911,0,0,1,1,0.0%,10m
17702,2,ilovekitkat,2911,0,0,1,1,0.0%,34m
17702,2,Gabolasa,2911,0,0,1,1,0.0%,13m
17731,2,Zeratul,2910,1609,304,304,608,50.0%,25m
17731,1,Grimlock,2910,1650,223,213,436,51.1%,32m
17731,1,[UTCorp]DYF,2910,1166,133,116,249,53.4%,30m
17731,2,FilthyCasual,2910,820,44,37,81,54.3%,6m
17731,2,Martineitor,2910,997,43,35,78,55.1%,34m
17731,2,Gosh,2910,687,34,31,65,52.3%,5m
17731,3,ThePunisher,2910,647,28,24,52,53.8%,4m
17731,2,MacGruber,2910,698,27,31,58,46.6%,7m
17731,2,[Kinkie]lineal,2910,558,20,21,41,48.8%,29m
17731,2,Dexcalibur,2910,474,19,16,35,54.3%,18m
17731,1,NumberSix,2910,460,15,24,39,38.5%,38m
17731,2,[HD7K]sirdunksalot,2910,292,13,5,18,72.2%,14m
17731,2,RHClouD,2910,372,13,15,28,46.4%,17m
17731,1,ScrappyDoo,2910,410,13,19,32,40.6%,27m
17731,1,Miclette,2910,319,12,10,22,54.5%,3h
17731,2,Del,2910,234,8,4,12,66.7%,30m
17731,2,draco,2910,175,7,7,14,50.0%,36m
17731,1,Pro,2910,70,6,5,11,54.5%,26m
17731,2,Vástago,2910,142,6,5,11,54.5%,9m
17731,2,envisible,2910,0,3,2,5,60.0%,17m
17731,2,Xexphos,2910,0,3,2,5,60.0%,30m
17731,2,RGT,2910,70,2,6,8,25.0%,5m
17731,2,[Ash3s]Kingomi,2910,58,2,6,8,25.0%,31m
17731,2,Bishop,2910,0,1,0,1,100.0%,29m
17731,2,FearReprisal,2910,0,1,0,1,100.0%,31m
17731,2,Sonda,2910,0,1,0,1,100.0%,6m
17731,1,ShardZ,2910,0,1,1,2,50.0%,1h
17731,2,Tin,2910,88,1,1,2,50.0%,28m
17731,2,[RQsc]Impstomper,2910,0,0,1,1,0.0%,5m
17731,2,[FTLTX]xxPUNKROCKxx,2910,0,0,2,2,0.0%,20m
17761,2,Heisenberg,2909,1629,162,144,306,52.9%,6m
17761,2,notMaru,2909,1525,134,125,259,51.7%,34m
17761,2,Guilliman,2909,1566,131,128,259,50.6%,22m
17761,1,YtoDom,2909,1613,86,91,177,48.6%,27m
17761,1,AssyMcgee,2909,863,82,70,152,53.9%,7m
17761,2,KrakenSlayer,2909,212,23,9,32,71.9%,6m
17761,2,[POROSS]xkensyt,2909,602,22,19,41,53.7%,25m
17761,2,Dusfim,2909,516,19,15,34,55.9%,11m
17761,2,Skiv,2909,137,15,3,18,83.3%,16m
17761,2,ArtieShaw,2909,356,14,10,24,58.3%,17m
17761,2,[PTHero]Heen,2909,360,12,10,22,54.5%,14m
17761,3,LakiSrb,2909,240,12,12,24,50.0%,8m
17761,2,Stargo,2909,138,10,2,12,83.3%,9m
17761,2,ironlawyer,2909,314,10,9,19,52.6%,6m
17761,2,SwankyPants,2909,274,10,11,21,47.6%,31m
17761,1,Swithly,2909,133,6,5,11,54.5%,12m
17761,1,Chilongo,2909,186,6,11,17,35.3%,8m
17761,2,OneInchPunch,2909,88,5,1,6,83.3%,41m
17761,1,[WnyBby]Sheeppy,2909,163,5,2,7,71.4%,11m
17761,2,Wrath,2909,128,4,1,5,80.0%,6m
17761,1,koros,2909,0,3,3,6,50.0%,3h
17761,2,Flower,2909,30,3,4,7,42.9%,34m
17761,2,Bigal,2909,86,3,5,8,37.5%,30m
17761,2,smokem,2909,58,2,2,4,50.0%,31m
17761,1,[CadeGs]Nepee,2909,34,2,7,9,22.2%,25m
17761,2,RiceNinja,2909,0,1,0,1,100.0%,17m
17761,2,Iniemamocny,2909,0,1,2,3,33.3%,30m
17761,1,RandyBobandy,2909,0,1,3,4,25.0%,1h
17761,2,spineforest,2909,0,1,5,6,16.7%,39m
17761,2,iiillliiiiii,2909,34,1,5,6,16.7%,16m
17761,2,Mave,2909,0,0,1,1,0.0%,10m
17761,2,iGGnacious,2909,0,0,2,2,0.0%,20m
17761,2,Locoster,2909,0,0,2,2,0.0%,17m
17761,2,[wwwO]LMary,2909,0,0,4,4,0.0%,17m
17795,3,kIMOsaBE,2908,1591,291,299,590,49.3%,27m
17795,3,malvakt,2908,1513,237,246,483,49.1%,24m
17795,2,Grace,2908,1439,210,176,386,54.4%,30m
17795,1,[IH8TOS]waltiostias,2908,963,73,78,151,48.3%,15m
17795,1,[SNND]Datu,2908,819,49,47,96,51.0%,30m
17795,2,Akusete,2908,912,40,30,70,57.1%,17m
17795,2,[BONCK]BoKi,2908,870,31,36,67,46.3%,22m
17795,2,Lefsa,2908,511,29,15,44,65.9%,17m
17795,2,Akatsaky,2908,239,28,20,48,58.3%,6m
17795,1,zeratul,2908,549,28,24,52,53.8%,38m
17795,2,[ec5]Mools,2908,668,24,23,47,51.1%,16m
17795,2,jAy,2908,410,15,10,25,60.0%,11m
17795,2,BeachBoy,2908,314,13,14,27,48.1%,31m
17795,1,RogerThat,2908,252,12,11,23,52.2%,39m
17795,2,[EvilGC]elpaps,2908,206,7,4,11,63.6%,20m
17795,1,Violino,2908,150,7,4,11,63.6%,12m
17795,2,MrWin,2908,193,6,2,8,75.0%,13m
17795,2,ALE,2908,166,5,2,7,71.4%,36m
17795,2,zero,2908,126,4,1,5,80.0%,36m
17795,1,LarryMcfly,2908,0,3,2,5,60.0%,40m
17795,2,[Nwebs]HappySalami,2908,30,2,1,3,66.7%,25m
17795,1,fbBigRed,2908,127,2,7,9,22.2%,26m
17795,2,BigNoob,2908,30,1,3,4,25.0%,16m
17795,1,Doughboy,2908,38,1,11,12,8.3%,13m
17795,1,Victor,2908,0,0,2,2,0.0%,45m
17795,1,[BNDA]MasterChief,2908,0,0,5,5,0.0%,3h
17821,2,Rmarq,2907,1472,232,204,436,53.2%,36m
17821,2,[LgnTDS]Rhasta,2907,1285,84,77,161,52.2%,14m
17821,1,[309]Art,2907,356,67,50,117,57.3%,30m
17821,1,DieMeissner,2907,490,66,59,125,52.8%,27m
17821,1,[VRC]ChunchuMaru,2907,1440,52,60,112,46.4%,12m
17821,1,Alcazaz,2907,739,49,48,97,50.5%,4m
17821,2,HotDogYesPlz,2907,1150,44,50,94,46.8%,5m
17821,2,keen,2907,699,39,29,68,57.4%,11m
17821,1,INfermal,2907,1101,39,41,80,48.8%,8m
17821,3,TruAznWuN,2907,717,35,41,76,46.1%,4m
17821,1,Dawserg,2907,508,24,26,50,48.0%,21m
17821,1,BasketballQC,2907,660,23,30,53,43.4%,30m
17821,2,Saga,2907,437,16,13,29,55.2%,12m
17821,2,Ledhed,2907,154,6,3,9,66.7%,6m
17821,2,NikoN,2907,141,5,3,8,62.5%,14m
17821,1,[mexic]KeYsHåWn,2907,176,5,9,14,35.7%,25m
17821,2,Kactra,2907,167,4,8,12,33.3%,1h
17821,2,Tongbalance,2907,106,3,6,9,33.3%,20m
17821,2,Commander,2907,90,3,8,11,27.3%,40m
17821,3,[Cind3r]ZeDuctTape,2907,97,1,1,2,50.0%,3h
17821,2,HBK,2907,0,0,1,1,0.0%,14m
17821,2,IIIIOOOIIII,2907,0,0,1,1,0.0%,31m
17821,2,PandaGirl,2907,0,0,3,3,0.0%,37m
17844,2,botsmasher,2906,1585,322,312,634,50.8%,35m
17844,2,TygerZero,2906,1403,162,142,304,53.3%,31m
17844,2,Gamaser,2906,1555,118,114,232,50.9%,17m
17844,2,Chowwnny,2906,1158,60,45,105,57.1%,10m
17844,2,[MAT371]endBehavior,2906,629,30,27,57,52.6%,12m
17844,2,Maikol,2906,616,27,16,43,62.8%,31m
17844,1,Machiavelli,2906,526,20,18,38,52.6%,40m
17844,1,OTRWalKer,2906,560,20,22,42,47.6%,35m
17844,2,dagon,2906,407,17,9,26,65.4%,25m
17844,2,EoN,2906,319,13,8,21,61.9%,31m
17844,2,IMaximus,2906,266,13,9,22,59.1%,25m
17844,2,[BRUTAL]FeedtheFeet,2906,278,11,5,16,68.8%,11m
17844,2,wesAGGRO,2906,187,8,8,16,50.0%,1h
17844,1,Pezz,2906,140,6,5,11,54.5%,40m
17844,1,Culley,2906,145,5,3,8,62.5%,3h
17844,1,TdotCamby,2906,96,5,4,9,55.6%,2m
17844,1,grunt,2906,177,5,4,9,55.6%,13m
17844,2,[KREAP]Grassassin,2906,128,4,1,5,80.0%,11m
17844,2,BackSooKing,2906,99,4,3,7,57.1%,47m
17844,2,[BRAP]Overdriven,2906,118,3,0,3,100.0%,48m
17844,1,Enzo,2906,0,3,2,5,60.0%,52m
17844,2,SticklerMac,2906,124,3,6,9,33.3%,19m
17844,2,[TELMO]SLASH,2906,102,2,1,3,66.7%,18m
17844,2,erbol,2906,30,2,1,3,66.7%,4m
17844,2,[KGH4]Revamp,2906,60,2,4,6,33.3%,40m
17844,2,WHTVRTTKS,2906,30,1,3,4,25.0%,5m
17844,2,[HomGr]CplHudson,2906,30,1,6,7,14.3%,16m
17844,2,[New2it]Carmax,2906,0,0,1,1,0.0%,41m
17844,2,Yaokuikatl,2906,0,0,1,1,0.0%,12m
17844,2,DAV,2906,0,0,1,1,0.0%,3m
17844,2,[PELO]Iceman,2906,0,0,2,2,0.0%,5m
17844,2,[Rated]Jakolokol,2906,0,0,2,2,0.0%,32m
17876,3,SPECIALK,2905,1583,250,234,484,51.7%,4m
17876,2,Skydiver,2905,1259,51,45,96,53.1%,41m
17876,2,Orion,2905,611,49,41,90,54.4%,20m
17876,2,Psuedo,2905,1017,47,39,86,54.7%,23m
17876,2,[WNDF]Gfunkhouse,2905,1016,46,41,87,52.9%,12m
17876,2,theSadZealoT,2905,824,34,23,57,59.6%,20m
17876,2,[Astute]BroodKingEXE,2905,477,29,31,60,48.3%,32m
17876,2,poggers,2905,702,29,33,62,46.8%,23m
17876,1,[LAMDA]MexiknBooM,2905,553,19,22,41,46.3%,35m
17876,1,sadTT,2905,134,8,7,15,53.3%,29m
17876,2,[ZTemps]Sonder,2905,260,8,8,16,50.0%,19m
17876,2,Koro,2905,248,8,10,18,44.4%,5m
17876,1,[F33d3r]Skilled,2905,223,8,13,21,38.1%,12m
17876,2,[DPRx]Nosology,2905,181,7,2,9,77.8%,7m
17876,2,cümber,2905,160,6,1,7,85.7%,9m
17876,2,[INCW]Ghost,2905,162,6,7,13,46.2%,15m
17876,2,SrChoripan,2905,188,6,10,16,37.5%,6m
17876,2,Jason,2905,116,4,0,4,100.0%,34m
17876,2,Ryu,2905,208,4,5,9,44.4%,2h
17876,2,Janke,2905,58,4,5,9,44.4%,34m
17876,2,BlackRX,2905,121,3,3,6,50.0%,14m
17876,2,Shadowsun,2905,90,3,6,9,33.3%,35m
17876,2,BULLETRUSH,2905,30,2,1,3,66.7%,33m
17876,2,Sorrow,2905,30,2,2,4,50.0%,15m
17876,2,Foxis,2905,0,1,0,1,100.0%,14m
17876,2,[JEGUY]Halpha,2905,0,1,0,1,100.0%,36m
17876,1,Andythenerd,2905,0,1,0,1,100.0%,2h
17876,2,boxbattle,2905,0,1,1,2,50.0%,11m
17876,2,TinLeague,2905,0,1,1,2,50.0%,20m
17876,2,[TSØP]GosuGhost,2905,30,1,5,6,16.7%,22m
17876,2,SPARTACUS,2905,0,0,1,1,0.0%,12m
17876,2,Loveman,2905,0,0,1,1,0.0%,17m
17876,2,[3COX]HighCommand,2905,0,0,4,4,0.0%,35m
17909,3,Blobmob,2904,1086,133,144,277,48.0%,16m
17909,2,[Raip]Ghost,2904,1498,125,117,242,51.7%,30m
17909,2,NoQuarter,2904,1333,103,84,187,55.1%,14m
17909,3,[ouin]Wyck,2904,1383,85,83,168,50.6%,22m
17909,2,[097]XXXanin,2904,1397,71,74,145,49.0%,14m
17909,1,Chuqui,2904,864,70,69,139,50.4%,5m
17909,1,cKain,2904,560,67,63,130,51.5%,4m
17909,2,bbreed,2904,944,55,45,100,55.0%,5m
17909,1,[kØ]NAIRTENS,2904,608,39,39,78,50.0%,9m
17909,3,[xBFMx]CheckURsix,2904,1020,38,47,85,44.7%,40m
17909,2,Kellynator,2904,844,31,32,63,49.2%,22m
17909,2,OldMan,2904,479,27,20,47,57.4%,32m
17909,2,DontSquirt,2904,130,26,18,44,59.1%,18m
17909,2,sykeasaurus,2904,389,14,12,26,53.8%,6m
17909,2,Wifeyloves,2904,296,13,5,18,72.2%,12m
17909,2,Cantata,2904,325,11,9,20,55.0%,12m
17909,2,[tay]MooGoo,2904,105,11,13,24,45.8%,10m
17909,2,Euber,2904,121,4,1,5,80.0%,6m
17909,1,SecretAsian,2904,0,4,3,7,57.1%,55m
17909,2,[DiaOrg]Stormer,2904,114,3,1,4,75.0%,36m
17909,2,[CUPAL]Nudibranch,2904,69,3,7,10,30.0%,6m
17909,1,Wolfroar,2904,78,3,9,12,25.0%,9m
17909,2,proxima,2904,0,2,4,6,33.3%,30m
17909,2,[SDC12]AltOfCtrl,2904,0,1,1,2,50.0%,41m
17909,2,[Xotiic]FaTe,2904,30,1,2,3,33.3%,25m
17909,2,megaTRIXww,2904,30,1,3,4,25.0%,31m
17909,2,Sage,2904,0,0,1,1,0.0%,13m
17909,2,PEPINWARS,2904,0,0,1,1,0.0%,30m
17909,1,Ethan,2904,0,0,1,1,0.0%,1h
17909,2,Wind,2904,0,0,2,2,0.0%,32m
17939,3,[Macac0]Dehaka,2903,1072,37,50,87,42.5%,5m
17939,3,Grandpa,2903,948,32,51,83,38.6%,4m
17939,2,Cutialcapro,2903,564,23,20,43,53.5%,19m
17939,2,[lMathl]Blue,2903,297,11,9,20,55.0%,30m
17939,2,Starriftvoid,2903,280,9,8,17,52.9%,36m
17939,2,[PzC]graelin,2903,266,9,12,21,42.9%,24m
17939,2,[FuTD]Rockfenix,2903,232,8,8,16,50.0%,7m
17939,3,CptRobinson,2903,200,6,3,9,66.7%,55m
17939,1,Nyaruko,2903,58,6,5,11,54.5%,40m
17939,2,[juert]Pablohoney,2903,116,4,0,4,100.0%,31m
17939,1,Pepoga,2903,119,4,3,7,57.1%,28m
17939,1,Slayer,2903,169,4,8,12,33.3%,13m
17939,2,ShadowDemon,2903,102,3,1,4,75.0%,19m
17939,2,Mandia,2903,30,1,3,4,25.0%,30m
17939,2,Sicktitan,2903,0,0,1,1,0.0%,31m
17939,2,[GRU]ZenithX,2903,0,0,1,1,0.0%,10m
17939,2,unGGoy,2903,0,0,1,1,0.0%,17m
17939,2,[prim8s]WHO,2903,0,0,1,1,0.0%,17m
17939,2,Gathunox,2903,0,0,2,2,0.0%,3m
17958,3,davisonbass,2902,1460,300,283,583,51.5%,11m
17958,2,tattin,2902,1521,206,166,372,55.4%,17m
17958,1,Aries,2902,1548,139,140,279,49.8%,22m
17958,2,Gage,2902,1445,98,65,163,60.1%,31m
17958,1,Wando,2902,1096,96,94,190,50.5%,31m
17958,1,[TWTV]Autopsee,2902,1255,92,61,153,60.1%,13m
17958,1,StimAddict,2902,757,72,67,139,51.8%,33m
17958,2,Naza,2902,1403,63,45,108,58.3%,25m
17958,1,NakSuKao,2902,1447,54,58,112,48.2%,34m
17958,2,[ChLife]Dan,2902,951,50,33,83,60.2%,4m
17958,2,KHALTHEBOLD,2902,720,42,42,84,50.0%,6m
17958,2,TTSSTT,2902,975,41,34,75,54.7%,32m
17958,2,[TheDOH]LuisLJ,2902,577,22,23,45,48.9%,5m
17958,2,SnakeBitez,2902,507,21,16,37,56.8%,42m
17958,2,Jabroni,2902,464,19,13,32,59.4%,23m
17958,2,nåthan,2902,432,15,18,33,45.5%,6m
17958,2,thanes,2902,316,11,15,26,42.3%,16m
17958,2,WorldPeace,2902,238,9,8,17,52.9%,44m
17958,1,Toaster,2902,246,8,12,20,40.0%,26m
17958,3,LuckyCandy,2902,178,7,6,13,53.8%,3h
17958,1,ProtCantLose,2902,213,6,10,16,37.5%,27m
17958,3,[RushTw]CKRush,2902,165,4,1,5,80.0%,59m
17958,2,[DJJ]JAMER,2902,112,3,1,4,75.0%,25m
17958,2,Gownta,2902,0,3,2,5,60.0%,10m
17958,2,FrOst,2902,30,2,1,3,66.7%,14m
17958,2,Okor,2902,0,2,3,5,40.0%,16m
17958,2,Onslaught,2902,0,1,0,1,100.0%,31m
17958,2,[SWOU]XxXFlashXxX,2902,88,1,1,2,50.0%,25m
17958,2,[LTWAR]krazykid,2902,0,1,1,2,50.0%,33m
17958,2,henari,2902,0,1,2,3,33.3%,6m
17958,2,FridCR,2902,0,0,1,1,0.0%,5m
17989,1,JonesTour,2901,1557,513,486,999,51.4%,21m
17989,1,Issib,2901,1613,447,439,886,50.5%,23m
17989,3,bkwolf,2901,1330,177,171,348,50.9%,27m
17989,2,Davel,2901,1556,166,156,322,51.6%,5m
17989,2,[Saludo]BRAD,2901,1245,87,81,168,51.8%,16m
17989,2,asdfer,2901,995,63,49,112,56.2%,34m
17989,1,mason,2901,1075,59,57,116,50.9%,3m
17989,2,CHAR,2901,573,23,27,50,46.0%,32m
17989,2,[CIC]Skwittles,2901,347,19,14,33,57.6%,12m
17989,1,CREabx,2901,434,16,23,39,41.0%,13m
17989,1,TataPinochet,2901,445,15,17,32,46.9%,7m
17989,3,Vex,2901,241,11,12,23,47.8%,17m
17989,2,rafa,2901,301,9,12,21,42.9%,15m
17989,2,Goatse,2901,180,6,4,10,60.0%,36m
17989,2,[CRushs]Alterium,2901,148,6,4,10,60.0%,19m
17989,2,Kawaihae,2901,142,6,7,13,46.2%,35m
17989,1,StarRage,2901,208,6,10,16,37.5%,45m
17989,2,[Yamaha]LaurenCraft,2901,159,5,2,7,71.4%,8m
17989,3,Kiryu,2901,148,5,8,13,38.5%,1h
17989,1,PervyKaiser,2901,0,4,2,6,66.7%,42m
17989,2,Skyrim,2901,88,4,3,7,57.1%,10m
17989,2,sLaughter,2901,116,4,9,13,30.8%,34m
17989,2,[kvac]Kremer,2901,88,3,4,7,42.9%,25m
17989,2,alwaysnoob,2901,88,2,0,2,100.0%,27m
17989,2,[DRKDNA]HeavenScream,2901,117,2,5,7,28.6%,29m
17989,1,BLUEDEVIL,2901,0,2,5,7,28.6%,38m
17989,1,kush,2901,48,1,8,9,11.1%,29m
18016,2,archdrafter,2900,1599,304,306,610,49.8%,6m
18016,3,IIIIIIIIIIII,2900,1439,193,204,397,48.6%,14m
18016,1,llllllllllll,2900,1195,192,180,372,51.6%,42m
18016,1,[AbcCo]LaMorza,2900,1600,115,101,216,53.2%,35m
18016,2,DoctorGentle,2900,1068,46,37,83,55.4%,22m
18016,2,Draynan,2900,742,45,37,82,54.9%,19m
18016,1,Anti,2900,312,37,48,85,43.5%,40m
18016,2,Hoplite,2900,807,36,27,63,57.1%,38m
18016,2,joagk,2900,807,30,26,56,53.6%,11m
18016,2,MetalHorse,2900,366,15,11,26,57.7%,34m
18016,2,gimozzi,2900,314,12,14,26,46.2%,9m
18016,2,[DhZAc1]OlavinhoXD,2900,244,10,5,15,66.7%,31m
18016,1,XDchinchilla,2900,165,8,7,15,53.3%,13m
18016,1,bpin,2900,233,7,3,10,70.0%,1h
18016,2,Coldferret,2900,247,7,6,13,53.8%,3h
18016,2,InNoVation,2900,170,6,7,13,46.2%,14m
18016,2,fartburn,2900,94,4,6,10,40.0%,40m
18016,2,GClutch,2900,124,4,9,13,30.8%,41m
18016,3,Sam,2900,30,2,0,2,100.0%,8m
18016,2,isaactlv,2900,32,2,4,6,33.3%,31m
18016,2,[PO342]Toxic,2900,88,1,1,2,50.0%,6m
18016,2,UnKnowN,2900,0,0,1,1,0.0%,16m
18016,2,mrquorr,2900,0,0,1,1,0.0%,11m
18016,1,haRa,2900,0,0,8,8,0.0%,39m
18040,1,[LCE]InnoVation,2899,1649,239,218,457,52.3%,13m
18040,1,[LVTEAM]Siddhartha,2899,1524,146,141,287,50.9%,12m
18040,2,Chuqui,2899,830,107,91,198,54.0%,25m
18040,2,[Tyber]Badgingworth,2899,1453,87,82,169,51.5%,6m
18040,2,SimpleJACK,2899,924,74,68,142,52.1%,41m
18040,2,majikZ,2899,515,63,54,117,53.8%,15m
18040,2,fhsa,2899,309,29,12,41,70.7%,31m
18040,1,NukeChina,2899,512,19,22,41,46.3%,7m
18040,2,[Weac]SOFTANDWET,2899,410,18,10,28,64.3%,26m
18040,2,[VFam2]Vindex,2899,282,18,14,32,56.2%,7m
18040,2,trodox,2899,419,16,12,28,57.1%,40m
18040,2,[LHdH]EdEvans,2899,370,14,10,24,58.3%,32m
18040,2,[WW1]ckSwoof,2899,148,11,6,17,64.7%,35m
18040,2,Allegseuh,2899,258,11,13,24,45.8%,9m
18040,1,Reprobate,2899,330,10,21,31,32.3%,4m
18040,3,Thethinker,2899,190,7,5,12,58.3%,43m
18040,2,gazua,2899,167,6,4,10,60.0%,25m
18040,2,jjalru,2899,112,5,3,8,62.5%,34m
18040,2,CptMcChooch,2899,118,5,4,9,55.6%,41m
18040,1,BOB,2899,198,5,14,19,26.3%,7m
18040,2,thetreecat,2899,0,4,0,4,100.0%,58m
18040,2,[Topper]WeaponOfWar,2899,94,4,4,8,50.0%,25m
18040,2,SubZeroMotor,2899,118,4,6,10,40.0%,31m
18040,2,Tchipe,2899,0,3,2,5,60.0%,27m
18040,3,DuckStation,2899,44,3,14,17,17.6%,34m
18040,2,[FMX]KUKUSYO,2899,60,2,9,11,18.2%,11m
18040,2,[WLFSPK]WolfsButcher,2899,0,1,0,1,100.0%,6m
18040,2,Ozzie,2899,0,1,0,1,100.0%,30m
18040,2,CAPA,2899,0,1,0,1,100.0%,17m
18040,2,[CFZL]coldfuzion,2899,88,1,2,3,33.3%,30m
18040,2,Ein,2899,0,0,1,1,0.0%,32m
18040,1,Balto,2899,0,0,1,1,0.0%,3h
18072,2,DrinkingNow,2898,1294,57,44,101,56.4%,23m
18072,1,Lukers,2898,1412,53,54,107,49.5%,34m
18072,2,[SKO303]MastaBlasta,2898,1195,52,51,103,50.5%,25m
18072,1,[xRtGac]Achillies,2898,1118,47,42,89,52.8%,21m
18072,2,Fletcher,2898,1062,45,41,86,52.3%,17m
18072,1,BSAA,2898,885,33,33,66,50.0%,4m
18072,2,matyatya,2898,722,32,25,57,56.1%,34m
18072,2,[DarkAG]Joerock,2898,418,18,10,28,64.3%,11m
18072,2,[PuffWC]Acceptance,2898,185,9,5,14,64.3%,23m
18072,3,yuaAar,2898,146,4,2,6,66.7%,27m
18072,1,CAD,2898,119,4,3,7,57.1%,3h
18072,2,[FlameB]DrPillz,2898,156,4,4,8,50.0%,10m
18072,2,Csle,2898,58,3,6,9,33.3%,38m
18072,1,achose,2898,48,2,0,2,100.0%,1h
18072,1,MosesFlakes,2898,48,2,1,3,66.7%,3h
18072,2,[Hm00ng]IceCream,2898,60,2,4,6,33.3%,20m
18072,2,Zrevryr,2898,0,2,4,6,33.3%,36m
18072,1,EndOfTheory,2898,0,1,0,1,100.0%,16m
18072,2,[AD3C]KKiLL,2898,0,1,0,1,100.0%,6m
18072,2,Zoba,2898,30,1,2,3,33.3%,28m
18072,2,[FaO]TheBeesKnees,2898,0,1,4,5,20.0%,32m
18072,2,Rev,2898,0,0,1,1,0.0%,27m
18072,2,[PROMX]DinoCasual,2898,0,0,1,1,0.0%,10m
18072,3,Tangy,2898,0,0,2,2,0.0%,54m
18096,3,contralogic,2897,1492,380,376,756,50.3%,20m
18096,1,Ebenn,2897,851,180,182,362,49.7%,22m
18096,2,daedelis,2897,353,151,132,283,53.4%,16m
18096,1,CptPlanet,2897,1287,82,84,166,49.4%,31m
18096,3,Toon,2897,1308,77,89,166,46.4%,32m
18096,1,KawaiiRob,2897,698,56,49,105,53.3%,13m
18096,1,ugly,2897,389,48,50,98,49.0%,39m
18096,2,hitch,2897,955,40,33,73,54.8%,40m
18096,2,[NM8]JAIMELEPROX,2897,917,39,30,69,56.5%,16m
18096,2,Boomy,2897,564,33,15,48,68.8%,18m
18096,2,[SPCTAC]PullTheBOYS,2897,798,31,27,58,53.4%,25m
18096,2,DayNine,2897,195,21,17,38,55.3%,10m
18096,2,starveliz,2897,556,21,20,41,51.2%,38m
18096,2,IlIlIlIlIlIl,2897,520,19,21,40,47.5%,12m
18096,2,aners,2897,474,18,17,35,51.4%,30m
18096,2,Guigo,2897,376,17,13,30,56.7%,6m
18096,2,DrOgadicto,2897,398,15,11,26,57.7%,17m
18096,3,Daicho,2897,242,11,11,22,50.0%,9m
18096,2,Sedna,2897,230,9,8,17,52.9%,13m
18096,2,Treefiddy,2897,189,8,6,14,57.1%,3h
18096,1,EZarMaDa,2897,250,8,12,20,40.0%,21m
18096,3,Sonny,2897,268,8,20,28,28.6%,20m
18096,2,ASSASING,2897,166,5,4,9,55.6%,15m
18096,2,mingfei,2897,116,4,1,5,80.0%,30m
18096,2,jcrcastillo,2897,0,4,1,5,80.0%,15m
18096,1,[ProSC]ElTioDer,2897,122,3,1,4,75.0%,2h
18096,2,Golurk,2897,0,3,2,5,60.0%,31m
18096,2,[Chozn1]WOLFKING,2897,86,3,5,8,37.5%,14m
18096,2,VoidRay,2897,0,1,0,1,100.0%,23m
18096,2,Alexslayer,2897,0,1,1,2,50.0%,16m
18096,2,Brythebeast,2897,30,1,2,3,33.3%,42m
18096,2,[SdwGmg]Sonic,2897,0,0,1,1,0.0%,41m
18096,2,Riss,2897,0,0,1,1,0.0%,13m
18096,2,tubUrOnZin,2897,0,0,2,2,0.0%,41m
18130,2,JoPumbaa,2896,1287,148,122,270,54.8%,6m
18130,1,yervx,2896,1064,102,97,199,51.3%,38m
18130,1,Siri,2896,1122,72,72,144,50.0%,25m
18130,2,[FFAA]KaleJarret,2896,1041,71,61,132,53.8%,16m
18130,1,[LoF]Malignant,2896,701,36,24,60,60.0%,20m
18130,1,Manic,2896,977,36,35,71,50.7%,3m
18130,2,[ÆON]RyuJeonghwa,2896,616,35,4,39,89.7%,41m
18130,3,[CNBNZ]Doraleix,2896,972,35,45,80,43.8%,38m
18130,2,Cesane,2896,809,34,29,63,54.0%,16m
18130,2,hugo,2896,635,31,17,48,64.6%,32m
18130,2,[THESG]IMoGsPrime,2896,707,29,26,55,52.7%,31m
18130,2,[TGosuA]TORPADEKA,2896,680,24,22,46,52.2%,5m
18130,3,madCenosha,2896,514,22,21,43,51.2%,10m
18130,1,NTCrash,2896,665,21,30,51,41.2%,7m
18130,1,Kioal,2896,377,13,14,27,48.1%,27m
18130,2,omgECYOR,2896,266,12,6,18,66.7%,31m
18130,2,Kryptograf,2896,210,12,7,19,63.2%,6m
18130,1,[KSGT]Suebee,2896,400,12,25,37,32.4%,15m
18130,3,[RdLzrd]MadRaccoon,2896,172,8,5,13,61.5%,43m
18130,2,DuncanF,2896,149,7,7,14,50.0%,9m
18130,3,echarlesss,2896,131,4,0,4,100.0%,27m
18130,2,Lawlderp,2896,102,3,1,4,75.0%,41m
18130,2,[UnlQTs]UnLucKy,2896,0,3,2,5,60.0%,27m
18130,2,Taroro,2896,0,3,2,5,60.0%,37m
18130,2,Kera,2896,0,3,3,6,50.0%,41m
18130,2,[Weac]Inceron,2896,0,0,1,1,0.0%,7m
18130,2,[WIGL]LucidStalker,2896,0,0,1,1,0.0%,22m
18130,1,DASA,2896,0,0,1,1,0.0%,5m
18158,1,RKBT,2895,1648,252,231,483,52.2%,25m
18158,1,Alita,2895,1626,234,238,472,49.6%,4m
18158,1,XYU,2895,1623,176,159,335,52.5%,25m
18158,2,brseiye,2895,1598,156,149,305,51.1%,16m
18158,1,eldrummer,2895,1642,108,109,217,49.8%,19m
18158,1,Elijah,2895,1297,47,54,101,46.5%,35m
18158,1,wabbajack,2895,484,33,35,68,48.5%,29m
18158,1,GLHF,2895,549,23,23,46,50.0%,2m
18158,2,TrollingPoll,2895,264,10,11,21,47.6%,24m
18158,2,PumpFister,2895,180,7,3,10,70.0%,28m
18158,3,oyang,2895,146,6,6,12,50.0%,3h
18158,2,Newo,2895,90,4,4,8,50.0%,8m
18158,1,[Pyr3s]SasQuatch,2895,97,3,3,6,50.0%,32m
18158,2,Striker,2895,90,3,5,8,37.5%,19m
18158,3,Peatree,2895,42,3,7,10,30.0%,3h
18158,2,nightknight,2895,30,2,3,5,40.0%,12m
18158,2,boogeh,2895,58,2,8,10,20.0%,8m
18158,2,delfin,2895,0,1,2,3,33.3%,27m
18158,1,[Necrtc]Rontoc,2895,97,1,5,6,16.7%,35m
18158,2,AlphaDecay,2895,0,0,1,1,0.0%,40m
18158,2,[DCGA]TheSpot,2895,0,0,1,1,0.0%,28m
18158,2,RyderB,2895,0,0,1,1,0.0%,23m
18180,1,[sk3tch]Goldenshield,2894,1650,284,276,560,50.7%,27m
18180,1,Hunter,2894,1342,162,147,309,52.4%,40m
18180,1,[akileh]Wick,2894,1590,67,78,145,46.2%,25m
18180,1,[T4STY]ShartScream,2894,821,61,66,127,48.0%,12m
18180,3,Zeolite,2894,383,52,50,102,51.0%,7m
18180,2,nxtIvI,2894,827,37,29,66,56.1%,23m
18180,2,Stonewall,2894,299,34,23,57,59.6%,12m
18180,2,[CriHE]GetRage,2894,690,26,24,50,52.0%,7m
18180,2,YLsIntoTanks,2894,455,20,7,27,74.1%,12m
18180,2,[UpxV]Rattini,2894,390,18,8,26,69.2%,7m
18180,2,[FYous]chris,2894,299,12,13,25,48.0%,8m
18180,2,HERRNIELS,2894,279,9,5,14,64.3%,31m
18180,3,littlesteim,2894,151,6,5,11,54.5%,3h
18180,2,Ender,2894,88,4,3,7,57.1%,40m
18180,2,Ryan,2894,0,3,2,5,60.0%,1h
18180,1,hoi,2894,118,3,2,5,60.0%,40m
18180,2,ivSeenBigger,2894,125,3,5,8,37.5%,40m
18180,2,HotShot,2894,92,3,6,9,33.3%,3m
18180,2,Valhalla,2894,102,2,1,3,66.7%,9m
18180,2,Master,2894,0,1,0,1,100.0%,16m
18180,2,[YS420]Shaffty,2894,0,1,1,2,50.0%,19m
18180,1,FoBuLouS,2894,48,1,2,3,33.3%,3h
18180,2,Zabimaru,2894,44,1,4,5,20.0%,2h
18180,2,Monstrous,2894,0,0,1,1,0.0%,11m
18180,2,[TGosuB]Bum,2894,0,0,1,1,0.0%,6m
18205,2,winterishere,2893,1158,83,79,162,51.2%,19m
18205,2,DarkVhyll,2893,974,76,73,149,51.0%,12m
18205,2,dlrgr,2893,1612,66,65,131,50.4%,12m
18205,2,Greed,2893,661,45,42,87,51.7%,30m
18205,2,Zaktorra,2893,492,24,17,41,58.5%,31m
18205,2,ChosenOne,2893,622,22,23,45,48.9%,26m
18205,2,[cOOM]Peroucho,2893,335,16,17,33,48.5%,17m
18205,2,sogonyeon,2893,351,15,17,32,46.9%,10m
18205,3,derskoschnu,2893,412,15,35,50,30.0%,20m
18205,2,Hateable,2893,258,11,6,17,64.7%,27m
18205,2,Skum,2893,288,10,12,22,45.5%,17m
18205,2,SodiumBarcod,2893,210,7,10,17,41.2%,30m
18205,2,SnacKin,2893,164,5,3,8,62.5%,34m
18205,3,InigoMontoya,2893,148,5,4,9,55.6%,22m
18205,2,[QTe]KurryKing,2893,184,5,5,10,50.0%,19m
18205,3,[SurfC]Maths,2893,114,4,2,6,66.7%,39m
18205,2,Amx,2893,0,3,3,6,50.0%,23m
18205,2,Paxha,2893,92,3,8,11,27.3%,40m
18205,1,[GRUMEC]Joseph,2893,102,3,13,16,18.8%,18m
18205,2,[DNO13]Listen,2893,0,1,1,2,50.0%,20m
18205,3,Chislic,2893,30,1,5,6,16.7%,2m
18205,3,xkyru,2893,0,0,1,1,0.0%,33m
18205,2,battlechode,2893,0,0,2,2,0.0%,10m
18205,1,Olmeca,2893,0,0,7,7,0.0%,3h
18229,1,[xLgNx]flapjack,2892,1632,234,230,464,50.4%,15m
18229,1,ScotchWhisky,2892,945,106,108,214,49.5%,15m
18229,2,woodsmoneys,2892,1335,66,65,131,50.4%,34m
18229,2,CheeseMe,2892,845,41,18,59,69.5%,23m
18229,2,[TRNST]NOLOGY,2892,980,38,36,74,51.4%,20m
18229,2,[CHAPU]Cuarenterran,2892,879,36,32,68,52.9%,19m
18229,2,[13und]Goomy,2892,537,24,13,37,64.9%,25m
18229,2,Crete,2892,522,20,16,36,55.6%,16m
18229,2,[Grayon]CPCHOWDER,2892,474,19,14,33,57.6%,13m
18229,2,[SlPt]Proston,2892,364,13,11,24,54.2%,42m
18229,1,Celeriak,2892,404,12,17,29,41.4%,5m
18229,1,ThisGuy,2892,328,10,13,23,43.5%,40m
18229,2,iechoi,2892,166,7,6,13,53.8%,20m
18229,1,Armin,2892,194,7,15,22,31.8%,37m
18229,2,TaskForce,2892,202,6,5,11,54.5%,14m
18229,2,NightMare,2892,163,5,4,9,55.6%,3h
18229,2,GhTakahashi,2892,112,3,1,4,75.0%,19m
18229,2,Huai,2892,58,3,5,8,37.5%,12m
18229,3,dkwlrchqh,2892,58,2,1,3,66.7%,2m
18229,3,Kuro,2892,58,2,1,3,66.7%,42m
18229,1,CalicO,2892,135,2,8,10,20.0%,1h
18229,3,DeX,2892,0,1,0,1,100.0%,39m
18229,2,Rafterman,2892,0,1,4,5,20.0%,3h
18229,2,luke,2892,0,1,5,6,16.7%,40m
18229,2,[STAS]Apex,2892,30,1,7,8,12.5%,10m
18229,3,Ghost,2892,0,0,1,1,0.0%,40m
18229,3,DrAkNeT,2892,0,0,1,1,0.0%,43m
18229,3,ShinyHero,2892,0,0,1,1,0.0%,22m
18229,3,Kasius,2892,0,0,1,1,0.0%,26m
18229,1,EmoSnek,2892,0,0,6,6,0.0%,56m
18259,3,[YALL]skate,2891,1433,252,254,506,49.8%,7m
18259,1,DsDs,2891,1645,180,170,350,51.4%,15m
18259,2,handsomeman,2891,1655,157,146,303,51.8%,31m
18259,3,[iDrunk]MrSmits,2891,1098,90,92,182,49.5%,39m
18259,2,Tambrak,2891,1376,73,69,142,51.4%,17m
18259,1,Bambi,2891,922,58,46,104,55.8%,16m
18259,2,CoolBoy,2891,1149,52,38,90,57.8%,10m
18259,2,geko,2891,1008,52,48,100,52.0%,36m
18259,2,ObamaGaming,2891,666,42,35,77,54.5%,29m
18259,2,[LOPELU]xepiyinn,2891,745,36,28,64,56.2%,12m
18259,1,StreetFIend,2891,904,36,35,71,50.7%,2m
18259,1,[SUNBRA]thatsjustice,2891,806,28,30,58,48.3%,33m
18259,2,ONESHOT,2891,626,23,25,48,47.9%,2m
18259,3,AlienEggs,2891,334,13,7,20,65.0%,21m
18259,1,SCVlivesMatr,2891,389,12,18,30,40.0%,25m
18259,2,BigBadWolf,2891,269,10,9,19,52.6%,37m
18259,2,Atos,2891,219,9,9,18,50.0%,9m
18259,3,TheRooster,2891,170,6,3,9,66.7%,32m
18259,3,Samichs,2891,93,5,1,6,83.3%,23m
18259,3,DDRINTER,2891,86,3,1,4,75.0%,36m
18259,3,Ripper,2891,58,2,1,3,66.7%,16m
18259,3,james,2891,91,2,2,4,50.0%,8m
18259,1,Harry,2891,97,2,4,6,33.3%,2h
18259,3,ElWeirdo,2891,0,1,0,1,100.0%,47m
18259,3,[wNt]RatedR,2891,0,0,1,1,0.0%,24m
18259,2,[mocat]TBONE,2891,0,0,2,2,0.0%,10m
18259,2,Juanisimo,2891,0,0,3,3,0.0%,7m
18286,1,cooper,2890,1175,244,231,475,51.4%,6m
18286,2,[scMAUI]Tuf,2890,1619,171,153,324,52.8%,30m
18286,2,mliljhikhnkj,2890,1576,164,150,314,52.2%,30m
18286,2,GGAllin,2890,1584,106,99,205,51.7%,34m
18286,2,Fox,2890,1408,89,82,171,52.0%,8m
18286,2,[4mHead]Rattini,2890,1334,68,57,125,54.4%,8m
18286,3,Quiksilver,2890,447,66,70,136,48.5%,16m
18286,3,Zulu,2890,1243,54,34,88,61.4%,26m
18286,2,xxxxxxxxxxxx,2890,1117,48,40,88,54.5%,31m
18286,2,Wookie,2890,389,38,33,71,53.5%,13m
18286,2,MMoraarom,2890,193,18,7,25,72.0%,21m
18286,2,[DRKRPT]Pyx,2890,203,9,6,15,60.0%,3h
18286,2,SadKingBilly,2890,212,9,8,17,52.9%,40m
18286,2,Melkor,2890,86,4,3,7,57.1%,20m
18286,2,Madhin,2890,114,4,6,10,40.0%,16m
18286,2,Ewok,2890,118,4,7,11,36.4%,31m
18286,2,Ozzie,2890,0,3,2,5,60.0%,40m
18286,3,[TxT]Sopes,2890,30,2,0,2,100.0%,29m
18286,2,Kaishin,2890,58,2,4,6,33.3%,10m
18286,1,snapcall,2890,34,2,7,9,22.2%,13m
18286,3,[TTW]Jason,2890,0,1,0,1,100.0%,12m
18286,3,Naviaux,2890,0,1,0,1,100.0%,38m
18286,3,DunkaDanku,2890,0,1,0,1,100.0%,18m
18286,3,BucketMan,2890,0,1,0,1,100.0%,22m
18286,3,TerranBoss,2890,30,1,2,3,33.3%,22m
18286,3,[WWP2]Livestar,2890,0,0,1,1,0.0%,35m
18286,3,EbolaStorm,2890,0,0,1,1,0.0%,31m
18286,2,iffysolution,2890,0,0,2,2,0.0%,12m
18286,2,qsdqsd,2890,0,0,2,2,0.0%,34m
18286,2,justinweaver,2890,0,0,3,3,0.0%,7m
18316,3,Wedgiepicker,2889,1503,330,328,658,50.2%,15m
18316,3,TruffleButta,2889,1555,269,280,549,49.0%,29m
18316,2,Tule,2889,1388,214,181,395,54.2%,26m
18316,1,Maddoggiedog,2889,709,73,73,146,50.0%,13m
18316,2,jasonrich,2889,1066,70,70,140,50.0%,20m
18316,2,Ender,2889,1080,55,55,110,50.0%,6m
18316,2,[imN0ob]ITVboyXsX,2889,493,19,16,35,54.3%,13m
18316,2,BonBonBon,2889,514,19,19,38,50.0%,29m
18316,2,SightHound,2889,484,18,20,38,47.4%,26m
18316,2,iloveketamin,2889,407,15,15,30,50.0%,19m
18316,1,LieGuy,2889,331,13,9,22,59.1%,35m
18316,1,SpaceAnimal,2889,403,12,20,32,37.5%,8m
18316,3,Nikky,2889,277,11,0,11,100.0%,23m
18316,2,RRam,2889,290,10,9,19,52.6%,41m
18316,2,[BOOT]Goldo,2889,268,10,13,23,43.5%,16m
18316,3,Daxin,2889,168,6,3,9,66.7%,39m
18316,2,Chaffey,2889,141,4,4,8,50.0%,3h
18316,2,ducked,2889,118,4,5,9,44.4%,10m
18316,1,NERO,2889,0,3,3,6,50.0%,3h
18316,3,rNbOlicornjr,2889,58,3,11,14,21.4%,33m
18316,3,[2AhB]MikeZane,2889,58,2,1,3,66.7%,40m
18316,2,[DSFTWA]Nedved,2889,0,2,1,3,66.7%,3h
18316,1,[DHZ0ne]Locutus,2889,48,2,5,7,28.6%,3h
18316,2,[LoF]MyMomIsAlive,2889,30,2,5,7,28.6%,5m
18316,1,[80HD]CycL,2889,0,0,2,2,0.0%,3h
18316,2,JordanGamer,2889,0,0,2,2,0.0%,30m
18316,2,[iDrunk]Oddiescell,2889,0,0,2,2,0.0%,15m
18316,2,Arax,2889,0,0,3,3,0.0%,5m
18316,3,[LaOr]TheArchitect,2889,0,0,4,4,0.0%,24m
18345,2,[XpKAc]bondrewd,2888,1595,397,374,771,51.5%,15m
18345,2,[MutasT]Mac,2888,1604,141,119,260,54.2%,19m
18345,3,DROGOLIKA,2888,1533,129,114,243,53.1%,8m
18345,1,WildCat,2888,1590,110,107,217,50.7%,12m
18345,1,Ark,2888,1441,82,81,163,50.3%,17m
18345,1,eYang,2888,1245,68,62,130,52.3%,42m
18345,3,[MoLeZa]CDA,2888,1330,68,79,147,46.3%,37m
18345,2,srgnto,2888,481,59,38,97,60.8%,32m
18345,1,BauerDSN,2888,1327,53,59,112,47.3%,5m
18345,3,LEZombiE,2888,720,35,28,63,55.6%,3m
18345,3,DiveBomber,2888,642,26,34,60,43.3%,17m
18345,2,MrDabuliu,2888,472,20,17,37,54.1%,37m
18345,3,[GHS]FeelGood,2888,572,18,31,49,36.7%,7m
18345,1,Anekdotin,2888,565,17,23,40,42.5%,41m
18345,1,Curtis,2888,416,14,20,34,41.2%,27m
18345,3,[EW3]Mastiff,2888,231,11,11,22,50.0%,11m
18345,1,[GGxC]MoriOptans,2888,307,10,11,21,47.6%,13m
18345,2,Terran,2888,170,8,7,15,53.3%,22m
18345,2,Darth,2888,175,6,4,10,60.0%,33m
18345,3,Shazbot,2888,206,6,10,16,37.5%,35m
18345,2,[ToOr]ApexLogic,2888,30,1,3,4,25.0%,10m
18345,3,Foozbond,2888,0,0,1,1,0.0%,4m
18345,3,Peeair,2888,0,0,1,1,0.0%,6m
18345,3,JayCee,2888,0,0,1,1,0.0%,38m
18345,2,CHoke,2888,0,0,2,2,0.0%,40m
18345,2,Jeff,2888,0,0,6,6,0.0%,11m
18371,1,Psiclone,2887,1548,109,97,206,52.9%,13m
18371,2,[xLgNx]BillyUdders,2887,1131,96,80,176,54.5%,25m
18371,2,CTiger,2887,665,49,48,97,50.5%,18m
18371,1,Igile,2887,1190,46,53,99,46.5%,14m
18371,2,Akron,2887,633,39,36,75,52.0%,20m
18371,2,[WNTRG]luckymansogo,2887,316,17,17,34,50.0%,7m
18371,3,[GOPERÚ]Jamj,2887,406,15,11,26,57.7%,35m
18371,2,intrepidmonk,2887,420,15,14,29,51.7%,8m
18371,2,Noctus,2887,308,13,9,22,59.1%,25m
18371,3,IIIIIIIIII,2887,296,10,3,13,76.9%,2m
18371,2,NanO,2887,253,10,5,15,66.7%,16m
18371,2,DivisionNine,2887,228,9,10,19,47.4%,28m
18371,2,NeaPawn,2887,154,6,2,8,75.0%,16m
18371,2,silurus,2887,0,4,1,5,80.0%,16m
18371,2,Jmars,2887,126,4,2,6,66.7%,36m
18371,2,[MDKM]SlimJim,2887,90,4,3,7,57.1%,42m
18371,1,edwinSTZ,2887,86,3,7,10,30.0%,13m
18371,2,TyC,2887,86,3,8,11,27.3%,40m
18371,2,Salo,2887,0,2,2,4,50.0%,3h
18371,1,Pansinsal,2887,0,2,2,4,50.0%,3h
18371,2,Flash,2887,30,2,4,6,33.3%,36m
18371,2,[TTKOPF]GrajoSombrío,2887,30,2,4,6,33.3%,38m
18371,1,ComradConnor,2887,96,2,8,10,20.0%,3h
18371,3,[PBK]Aegis,2887,0,1,0,1,100.0%,28m
18371,2,[xMDx]kobugiman,2887,0,1,0,1,100.0%,3h
18371,3,mastuur,2887,0,1,0,1,100.0%,42m
18371,3,Chicken,2887,0,1,0,1,100.0%,20m
18371,3,TNwade,2887,0,1,0,1,100.0%,28m
18371,1,Ghost,2887,0,1,2,3,33.3%,38m
18371,2,Incenstious,2887,30,1,4,5,20.0%,34m
18371,3,Koplss,2887,0,0,1,1,0.0%,16m
18371,2,[QCPB]MasterCheese,2887,0,0,3,3,0.0%,16m
18403,2,JimRaynor,2886,1573,217,210,427,50.8%,10m
18403,2,Fritzmeister,2886,1277,192,173,365,52.6%,6m
18403,3,[1vsM]devilsonso,2886,1616,102,100,202,50.5%,32m
18403,1,riben,2886,1618,100,97,197,50.8%,11m
18403,3,BossBone,2886,1631,84,73,157,53.5%,3m
18403,1,Minusc,2886,1615,76,70,146,52.1%,18m
18403,3,xXRebelXx,2886,1566,70,48,118,59.3%,24m
18403,2,Terranasaur,2886,1306,58,51,109,53.2%,3m
18403,2,MagmaShark,2886,975,52,49,101,51.5%,7m
18403,2,[Ne0x1]AARON,2886,1133,50,36,86,58.1%,6m
18403,1,power,2886,637,46,39,85,54.1%,39m
18403,2,[cFG]Six,2886,1087,44,35,79,55.7%,17m
18403,2,Alec,2886,545,43,18,61,70.5%,19m
18403,2,VRman,2886,987,40,34,74,54.1%,26m
18403,3,StoneyBalony,2886,872,33,37,70,47.1%,41m
18403,2,pat,2886,481,20,15,35,57.1%,17m
18403,2,SilentSwordX,2886,546,20,19,39,51.3%,32m
18403,2,Arrhythmia,2886,330,19,18,37,51.4%,10m
18403,1,[cluez]Kassadar,2886,427,14,19,33,42.4%,28m
18403,1,Whale,2886,496,14,21,35,40.0%,11m
18403,3,[OpPl]Rileside,2886,241,9,6,15,60.0%,59m
18403,3,[GGMESP]RICKY,2886,172,7,5,12,58.3%,3m
18403,2,[GRDN]Rotini,2886,214,7,6,13,53.8%,13m
18403,2,astigflip,2886,174,7,8,15,46.7%,11m
18403,2,Fourplay,2886,30,5,3,8,62.5%,23m
18403,1,GoSuGumiho,2886,0,3,5,8,37.5%,17m
18403,1,[CoPa]Lexicon,2886,97,2,2,4,50.0%,1h
18403,2,Bob,2886,0,1,1,2,50.0%,14m
18403,3,Exarch,2886,30,1,2,3,33.3%,2m
18432,3,[Shang]obama,2885,1551,349,349,698,50.0%,15m
18432,2,[EZDUNK]IIIIIIIIIIII,2885,1577,195,156,351,55.6%,13m
18432,1,Thana,2885,1691,151,144,295,51.2%,4m
18432,2,laughingpowe,2885,1120,80,65,145,55.2%,3m
18432,2,Shorzy,2885,962,41,39,80,51.2%,42m
18432,2,Chet,2885,912,38,38,76,50.0%,32m
18432,2,Rommel,2885,560,33,29,62,53.2%,36m
18432,2,Skiar,2885,309,27,22,49,55.1%,20m
18432,3,ztromet,2885,501,26,19,45,57.8%,10m
18432,2,HighDied,2885,473,19,15,34,55.9%,16m
18432,2,[GgARMY]Jardshock,2885,488,18,15,33,54.5%,10m
18432,2,[TRKPAD]Aristaeus,2885,332,14,15,29,48.3%,7m
18432,1,retrodino,2885,334,12,13,25,48.0%,22m
18432,3,[Yoga1]Perfectus,2885,167,7,4,11,63.6%,34m
18432,2,TheSoupStore,2885,218,7,6,13,53.8%,30m
18432,2,ArtOfAutumn,2885,86,6,5,11,54.5%,3m
18432,3,knight,2885,174,6,6,12,50.0%,15m
18432,2,TheEngineer,2885,170,6,7,13,46.2%,30m
18432,3,Alyiation,2885,131,5,3,8,62.5%,13m
18432,3,Zakolopochtl,2885,142,5,3,8,62.5%,24m
18432,3,[Atone]Dadbod,2885,0,4,1,5,80.0%,16m
18432,2,belowbronze,2885,90,4,7,11,36.4%,16m
18432,2,Johnjohn,2885,92,3,6,9,33.3%,11m
18432,2,RaulPudd,2885,90,3,7,10,30.0%,31m
18432,2,turtleBeak,2885,30,2,2,4,50.0%,25m
18432,2,HeyBlake,2885,58,2,5,7,28.6%,20m
18432,3,Liberty,2885,0,1,0,1,100.0%,33m
18432,3,bobthebuilde,2885,0,1,0,1,100.0%,11m
18432,3,CerealKiller,2885,30,1,2,3,33.3%,14m
18432,1,llllllllllll,2885,97,1,2,3,33.3%,29m
18432,2,[8iSh]Midivh,2885,30,1,4,5,20.0%,11m
18432,3,Zyone,2885,97,1,8,9,11.1%,1h
18432,3,FoxyAvida,2885,0,0,1,1,0.0%,19m
18432,3,Nicee,2885,0,0,1,1,0.0%,42m
18466,3,Ramso,2884,1400,90,78,168,53.6%,24m
18466,1,[DEARTH]Sephiroth,2884,698,54,44,98,55.1%,33m
18466,2,[αXLa]Fox,2884,1108,49,39,88,55.7%,17m
18466,2,JJJ,2884,812,31,28,59,52.5%,19m
18466,2,WalkingBass,2884,461,22,10,32,68.8%,21m
18466,2,FagenLuck,2884,462,19,15,34,55.9%,31m
18466,2,katxl,2884,395,17,11,28,60.7%,10m
18466,2,JOEsh,2884,397,17,13,30,56.7%,13m
18466,2,IMSorryManGG,2884,373,16,13,29,55.2%,36m
18466,2,SCV,2884,321,15,19,34,44.1%,31m
18466,3,[BUMFUK]kneeinthesac,2884,254,9,5,14,64.3%,12m
18466,3,DuCkTales,2884,212,9,6,15,60.0%,36m
18466,1,[LTWAR]COBackbond,2884,266,8,7,15,53.3%,45m
18466,2,Zudapiggy,2884,217,7,7,14,50.0%,10m
18466,3,[ESL]Eyescar,2884,138,6,2,8,75.0%,60m
18466,2,shyguy,2884,144,5,7,12,41.7%,12m
18466,3,Faith,2884,0,4,4,8,50.0%,20m
18466,1,LicoPe,2884,0,3,5,8,37.5%,12m
18466,3,cadoarruda,2884,0,1,0,1,100.0%,30m
18466,3,[25ZAIS]Oreo,2884,0,1,0,1,100.0%,1h
18466,3,TerranPotato,2884,0,1,0,1,100.0%,42m
18487,1,Copper,2883,1625,319,312,631,50.6%,33m
18487,2,[NLK]Wormsign,2883,1500,78,66,144,54.2%,36m
18487,1,JFizzl,2883,1279,77,67,144,53.5%,3m
18487,2,[PAsaga]jarhead,2883,660,45,42,87,51.7%,7m
18487,1,JoeMama,2883,588,19,28,47,40.4%,18m
18487,1,[R3SET]RenegadeX,2883,432,12,20,32,37.5%,12m
18487,2,[LPZR]DangerDog,2883,378,11,18,29,37.9%,17m
18487,2,[Cind3r]Amotokai,2883,216,7,10,17,41.2%,6m
18487,2,YangMin,2883,145,6,5,11,54.5%,10m
18487,2,capmaid,2883,116,4,2,6,66.7%,32m
18487,2,MrSunrise,2883,140,4,3,7,57.1%,29m
18487,1,Strann,2883,97,4,3,7,57.1%,3h
18487,2,[gromp]Ragnarokette,2883,92,4,6,10,40.0%,30m
18487,3,ZeroHxH,2883,147,4,9,13,30.8%,14m
18487,3,[Alphaa]DBOSS,2883,48,3,2,5,60.0%,39m
18487,1,MrMeeseeks,2883,0,3,3,6,50.0%,3h
18487,3,[UpxV]Narry,2883,88,3,4,7,42.9%,26m
18487,3,CREST,2883,60,2,2,4,50.0%,3m
18487,3,[MutasT]Tomi,2883,0,1,0,1,100.0%,23m
18487,3,Bobenrieth,2883,34,1,10,11,9.1%,27m
18487,3,Kirito,2883,0,0,1,1,0.0%,23m
18487,2,Javm,2883,0,0,2,2,0.0%,29m
18487,2,Jazzler,2883,0,0,2,2,0.0%,30m
18510,2,Siven,2882,1655,412,400,812,50.7%,16m
18510,3,defaspect,2882,1169,201,202,403,49.9%,8m
18510,3,Santana,2882,1358,91,76,167,54.5%,27m
18510,2,Jenkins,2882,1478,78,59,137,56.9%,19m
18510,1,CraZyKaun,2882,1162,71,58,129,55.0%,21m
18510,1,bayaNiHan,2882,1291,71,73,144,49.3%,15m
18510,2,skeith,2882,1481,55,54,109,50.5%,7m
18510,2,Heisenberg,2882,1385,54,53,107,50.5%,14m
18510,1,Garnett,2882,924,32,39,71,45.1%,15m
18510,2,Eth,2882,746,27,33,60,45.0%,10m
18510,2,ManBearPig,2882,393,16,11,27,59.3%,29m
18510,3,JJeezy,2882,367,15,11,26,57.7%,24m
18510,2,[TGosuB]BigIslandGuy,2882,362,15,11,26,57.7%,14m
18510,2,Dovle,2882,345,13,11,24,54.2%,8m
18510,2,watermelon,2882,225,9,7,16,56.2%,26m
18510,3,Harvesterant,2882,216,7,3,10,70.0%,1h
18510,1,[xVIPx]Stomped,2882,216,6,5,11,54.5%,13m
18510,1,pfemano,2882,176,6,12,18,33.3%,34m
18510,3,[WNTRGC]HJGL,2882,0,3,2,5,60.0%,26m
18510,2,socksoff,2882,90,3,8,11,27.3%,40m
18510,3,EpicBeans,2882,0,0,1,1,0.0%,42m
18510,3,Reaps,2882,0,0,1,1,0.0%,7m
18510,3,Pheonix,2882,0,0,1,1,0.0%,2m
18533,2,FatalCrow,2881,1447,206,196,402,51.2%,26m
18533,1,MuttleyBr,2881,1644,199,193,392,50.8%,28m
18533,2,FANDANGLER,2881,1569,152,148,300,50.7%,13m
18533,1,Solareon,2881,1367,89,89,178,50.0%,4m
18533,1,Polesel,2881,1449,69,63,132,52.3%,21m
18533,2,[Petsen]Shaky,2881,1267,56,47,103,54.4%,6m
18533,2,Bossman,2881,627,25,24,49,51.0%,30m
18533,3,[LgnTDS]IIIITesta,2881,498,18,15,33,54.5%,7m
18533,2,[DGNBFT]ThorsWrath,2881,460,18,19,37,48.6%,6m
18533,1,You,2881,511,17,21,38,44.7%,22m
18533,2,[Coknut]bobcao,2881,197,7,7,14,50.0%,26m
18533,2,Polaris,2881,143,6,1,7,85.7%,23m
18533,3,Cybercorpse,2881,146,6,4,10,60.0%,13m
18533,2,[WOTDL]ALUCARD,2881,152,6,8,14,42.9%,5m
18533,1,[XpKAc]YNSDA,2881,136,4,8,12,33.3%,23m
18533,2,Senya,2881,34,2,1,3,66.7%,3h
18533,2,Mersaree,2881,60,2,5,7,28.6%,13m
18533,3,[SDTL]Kham,2881,0,0,1,1,0.0%,38m
18533,3,MissIodine,2881,0,0,1,1,0.0%,28m
18533,1,NeroDeath,2881,0,0,1,1,0.0%,3h
18553,2,Dre,2880,1442,241,216,457,52.7%,37m
18553,2,[SLACK]CaptainSmack,2880,1155,115,107,222,51.8%,21m
18553,2,[BT44]Mako,2880,1555,80,69,149,53.7%,17m
18553,3,StOnedas,2880,1571,80,73,153,52.3%,31m
18553,2,[SCCJ]ProvenceDevi,2880,1277,76,64,140,54.3%,40m
18553,1,Huey,2880,1015,62,59,121,51.2%,37m
18553,1,NordPeel,2880,830,55,58,113,48.7%,15m
18553,2,[ChiFan]Vivi,2880,951,37,36,73,50.7%,12m
18553,3,[ÐxStar]JORGEX,2880,924,36,34,70,51.4%,40m
18553,2,FighterZero,2880,855,33,39,72,45.8%,11m
18553,2,[EtrOy]Jingleheimer,2880,664,24,28,52,46.2%,21m
18553,3,macrox,2880,579,22,12,34,64.7%,34m
18553,3,NineTails,2880,589,22,25,47,46.8%,16m
18553,2,[SHLA]VacancyYY,2880,286,19,9,28,67.9%,7m
18553,3,NightRaven,2880,355,15,8,23,65.2%,29m
18553,1,[YPR]YPR,2880,449,14,19,33,42.4%,11m
18553,3,[NwAs]SandiaYLimon,2880,314,13,4,17,76.5%,40m
18553,2,[Zohner]Ashmar,2880,315,11,10,21,52.4%,39m
18553,2,Macro,2880,307,11,13,24,45.8%,13m
18553,1,[THC420]Drone,2880,356,11,16,27,40.7%,21m
18553,1,[Tiamat]Droid,2880,96,4,3,7,57.1%,1h
18553,2,AMON,2880,92,4,4,8,50.0%,12m
18553,2,Doctorius,2880,118,4,6,10,40.0%,10m
18553,2,Arkuss,2880,114,4,6,10,40.0%,7m
18553,2,FlyingHorse,2880,128,4,7,11,36.4%,37m
18553,2,[KOIC]Seraphim,2880,0,3,2,5,60.0%,3h
18553,1,Legion,2880,145,3,2,5,60.0%,18m
18553,2,[PMSSS]Elven,2880,0,3,3,6,50.0%,30m
18553,2,DIABLA,2880,102,2,2,4,50.0%,5m
18553,3,IIIIIIIIIIII,2880,58,2,3,5,40.0%,14m
18553,2,Hoppochan,2880,30,2,4,6,33.3%,16m
18553,3,madara,2880,30,1,1,2,50.0%,33m
18553,2,justhavefunn,2880,0,1,1,2,50.0%,12m
18553,2,DonQuijote,2880,30,1,3,4,25.0%,16m
18553,3,ILikeToWin,2880,0,0,1,1,0.0%,26m
18553,3,Nova,2880,0,0,1,1,0.0%,12m
18553,3,naband,2880,0,0,1,1,0.0%,26m
18590,3,DannyM,2879,1415,117,123,240,48.8%,14m
18590,1,joelsuo,2879,1634,104,102,206,50.5%,8m
18590,2,Hebe,2879,1595,95,93,188,50.5%,34m
18590,2,Yunka,2879,1573,81,59,140,57.9%,23m
18590,1,Cody,2879,1583,68,65,133,51.1%,28m
18590,2,[EvilGC]Fenrir,2879,731,54,53,107,50.5%,30m
18590,2,PlayerTwo,2879,1084,50,30,80,62.5%,41m
18590,2,Complistik,2879,172,14,17,31,45.2%,22m
18590,2,liniix,2879,299,13,8,21,61.9%,11m
18590,3,Meals,2879,332,13,12,25,52.0%,39m
18590,2,ShizBiz,2879,213,12,7,19,63.2%,30m
18590,2,Spartann,2879,324,12,10,22,54.5%,16m
18590,3,Annunnaki,2879,284,11,4,15,73.3%,37m
18590,3,BluRay,2879,232,8,4,12,66.7%,31m
18590,2,IUhead,2879,102,6,2,8,75.0%,20m
18590,1,Troll,2879,0,3,3,6,50.0%,30m
18590,2,Barbi,2879,98,3,8,11,27.3%,14m
18590,2,Tirf,2879,30,2,1,3,66.7%,41m
18590,3,Herpderk,2879,58,2,1,3,66.7%,31m
18590,3,art,2879,0,2,3,5,40.0%,19m
18590,2,Ganjalf,2879,0,1,1,2,50.0%,5m
18590,3,pumba,2879,30,1,1,2,50.0%,41m
18590,3,OniiChan,2879,30,1,1,2,50.0%,33m
18590,2,[APK]SAnjos,2879,0,1,2,3,33.3%,5m
18590,2,TheKirbos,2879,85,1,2,3,33.3%,4m
18590,2,dreamliner,2879,88,1,2,3,33.3%,42m
18590,2,[USWAG]MartinER,2879,0,0,2,2,0.0%,30m
18590,2,[REPORT]Fearless,2879,0,0,2,2,0.0%,15m
18590,1,Kershaw,2879,0,0,3,3,0.0%,5m
18590,2,WarHog,2879,0,0,4,4,0.0%,30m
18620,1,[xNPGx]PaPu,2878,1610,196,166,362,54.1%,39m
18620,2,[EGM]krousners,2878,1563,139,133,272,51.1%,40m
18620,2,MKDuFreeBird,2878,884,99,89,188,52.7%,26m
18620,1,[PAROLE]Cleef,2878,914,49,49,98,50.0%,26m
18620,2,CarnCarby,2878,1060,47,39,86,54.7%,31m
18620,1,ElMameitor,2878,1014,40,43,83,48.2%,27m
18620,1,Janice,2878,1142,38,49,87,43.7%,30m
18620,2,Infinity,2878,725,29,27,56,51.8%,30m
18620,2,JacqCirq,2878,566,22,22,44,50.0%,30m
18620,1,ChefBacon,2878,272,15,28,43,34.9%,26m
18620,3,frontbutfevr,2878,386,13,8,21,61.9%,20m
18620,3,[Exper]KALEL,2878,321,11,3,14,78.6%,29m
18620,2,MikuHusband,2878,198,6,6,12,50.0%,12m
18620,1,[AKAY47]TigOlBitties,2878,138,5,2,7,71.4%,2h
18620,1,LLLLLLLLLLLL,2878,159,5,7,12,41.7%,3h
18620,1,Yangkikikiki,2878,185,4,10,14,28.6%,39m
18620,2,WillTam,2878,102,3,1,4,75.0%,12m
18620,3,CorgiElvis,2878,0,3,2,5,60.0%,16m
18620,1,Zhiver,2878,193,3,7,10,30.0%,6m
18620,2,[GGSC2]Grinch,2878,88,2,1,3,66.7%,7m
18620,3,Hardlinemonk,2878,30,1,1,2,50.0%,26m
18620,3,[TPGGXD]CLERIGO,2878,30,1,1,2,50.0%,15m
18620,2,[UpxV]RisingStar,2878,0,1,1,2,50.0%,21m
18620,2,OolongTea,2878,0,1,2,3,33.3%,40m
18620,2,DJDespawn,2878,30,1,3,4,25.0%,17m
18620,2,supernova,2878,0,1,3,4,25.0%,13m
18620,3,NEWPE,2878,0,0,1,1,0.0%,33m
18620,3,mikestar,2878,0,0,1,1,0.0%,13m
18620,3,Atraedies,2878,0,0,1,1,0.0%,9m
18620,3,Bionhard,2878,0,0,1,1,0.0%,42m
18620,2,[FU2]Skull,2878,0,0,2,2,0.0%,17m
18651,1,Giafar,2877,1628,547,531,1078,50.7%,16m
18651,1,[SCNTS]Balmung,2877,1562,269,253,522,51.5%,32m
18651,2,[TACTEC]cRAZeEyE,2877,1600,228,232,460,49.6%,10m
18651,2,[NwAs]iAaronLuna,2877,1580,161,142,303,53.1%,10m
18651,2,Igbarash,2877,1541,140,168,308,45.5%,23m
18651,2,[Exper]Victor,2877,1665,118,114,232,50.9%,13m
18651,1,JeveStobs,2877,1578,69,77,146,47.3%,12m
18651,2,[TeamEz]DrBloom,2877,806,47,48,95,49.5%,6m
18651,1,[RAAS]GoHUnThAr,2877,827,34,33,67,50.7%,19m
18651,2,yvkj,2877,532,26,15,41,63.4%,8m
18651,2,Archer,2877,664,26,24,50,52.0%,16m
18651,2,Echang,2877,465,23,18,41,56.1%,30m
18651,2,Petrichor,2877,351,16,12,28,57.1%,19m
18651,2,NickDaMan,2877,306,13,14,27,48.1%,22m
18651,3,Bio,2877,280,11,5,16,68.8%,23m
18651,3,McNasty,2877,324,11,12,23,47.8%,15m
18651,2,Tunfi,2877,210,7,6,13,53.8%,17m
18651,2,IAMCANADIAN,2877,152,6,7,13,46.2%,33m
18651,2,Stratego,2877,117,5,3,8,62.5%,30m
18651,2,limitlist,2877,124,4,6,10,40.0%,30m
18651,2,leono,2877,122,4,10,14,28.6%,31m
18651,3,[BSNK]Ciryusken,2877,88,3,2,5,60.0%,27m
18651,2,mikmonk,2877,0,3,3,6,50.0%,39m
18651,2,waldito,2877,128,3,3,6,50.0%,10m
18651,3,SROpressor,2877,34,2,2,4,50.0%,3h
18651,3,Silverity,2877,0,2,3,5,40.0%,5m
18651,3,DEADLYPANTS,2877,0,1,0,1,100.0%,4m
18651,3,Synrgy,2877,0,0,1,1,0.0%,16m
18651,2,[ExcIgN]matiascba,2877,0,0,2,2,0.0%,33m
18651,2,[LdS]LIGHT,2877,0,0,3,3,0.0%,12m
18681,2,Tekrebel,2876,1245,82,83,165,49.7%,20m
18681,2,NRF,2876,736,69,56,125,55.2%,8m
18681,1,[vaping]DERP,2876,1348,51,51,102,50.0%,43m
18681,2,[Cryptc]Maverick,2876,982,40,35,75,53.3%,33m
18681,1,Brenda,2876,879,34,37,71,47.9%,41m
18681,2,[Po0pY]aenos,2876,612,25,20,45,55.6%,10m
18681,3,LuckyLuciano,2876,646,22,25,47,46.8%,37m
18681,1,FORTRESS,2876,353,13,14,27,48.1%,25m
18681,1,[LPlay]winsc,2876,305,11,22,33,33.3%,36m
18681,2,MustardTiger,2876,88,4,4,8,50.0%,6m
18681,2,[Neil]Berno,2876,92,4,6,10,40.0%,20m
18681,3,elainlon,2876,146,4,8,12,33.3%,1h
18681,3,Chadders,2876,0,3,2,5,60.0%,22m
18681,2,[TLibre]XélHáYáotl,2876,30,2,2,4,50.0%,16m
18681,2,[OPERA]MRUIJIAKING,2876,102,2,3,5,40.0%,30m
18681,2,[DxB]rich,2876,0,1,0,1,100.0%,3h
18681,3,DptOfDefence,2876,0,1,0,1,100.0%,9m
18681,3,[4GH]thepatchman,2876,0,0,1,1,0.0%,31m
18681,3,Warlock,2876,0,0,1,1,0.0%,43m
18681,2,Machete,2876,0,0,4,4,0.0%,7m
18701,3,[TGosuB]HSXVR,2875,1656,266,251,517,51.5%,22m
18701,3,Hoff,2875,1556,129,135,264,48.9%,34m
18701,2,Stinger,2875,1519,108,85,193,56.0%,32m
18701,2,ZARD,2875,1587,88,63,151,58.3%,40m
18701,2,spauce,2875,1361,80,76,156,51.3%,33m
18701,2,Rivette,2875,1146,74,71,145,51.0%,7m
18701,2,izuru,2875,1503,60,51,111,54.1%,34m
18701,2,[ØÛ]matiBTC,2875,752,36,30,66,54.5%,14m
18701,2,UnoOchoSiete,2875,660,23,29,52,44.2%,20m
18701,3,Netslayer,2875,340,13,9,22,59.1%,42m
18701,1,Mauve,2875,303,13,9,22,59.1%,13m
18701,2,[DadsSC]Nukelele,2875,328,12,12,24,50.0%,12m
18701,2,TheChosen,2875,268,11,11,22,50.0%,17m
18701,2,[UpeV]AfterHours,2875,324,11,14,25,44.0%,13m
18701,1,[SENZU]Aleksandr,2875,96,6,4,10,60.0%,45m
18701,2,[APTX06]Castx,2875,206,6,7,13,46.2%,6m
18701,3,polarxddd,2875,62,5,2,7,71.4%,22m
18701,3,[m8z]newLeaf,2875,86,3,1,4,75.0%,22m
18701,3,Hammer,2875,97,3,6,9,33.3%,33m
18701,2,shatterrook,2875,94,3,8,11,27.3%,6m
18701,1,[MacJu]Beginner,2875,0,2,1,3,66.7%,18m
18701,3,[DT50]Thrembode,2875,134,2,4,6,33.3%,32m
18701,2,zerg,2875,30,2,4,6,33.3%,34m
18701,3,[IMDSI]Murillox,2875,0,1,0,1,100.0%,22m
18701,3,[TdotO]TdotDavid,2875,30,1,2,3,33.3%,39m
18701,2,[QTp2T]Akea,2875,0,1,2,3,33.3%,30m
18701,3,ROOM,2875,34,1,2,3,33.3%,33m
18701,2,FEDERER,2875,32,1,3,4,25.0%,30m
18701,3,[CCCT]RadarPrince,2875,0,0,1,1,0.0%,5m
18701,3,[1tk]DGfiSHtixs,2875,0,0,1,1,0.0%,37m
18701,2,Lyle,2875,0,0,2,2,0.0%,7m
18732,3,optobear,2874,1522,281,273,554,50.7%,18m
18732,2,Carlos,2874,1607,124,122,246,50.4%,42m
18732,1,WiseBigDaddy,2874,1647,121,108,229,52.8%,4m
18732,2,[EpicG]Marquis,2874,1440,68,45,113,60.2%,3m
18732,2,[909090]CarloPg,2874,997,47,37,84,56.0%,15m
18732,3,CausticVom,2874,596,44,30,74,59.5%,4m
18732,1,[CARO]AfterNoonD,2874,758,30,34,64,46.9%,27m
18732,2,[PiN0YS]Mithraic,2874,614,29,17,46,63.0%,34m
18732,3,Galaxy,2874,481,19,9,28,67.9%,26m
18732,3,Torbaz,2874,516,16,32,48,33.3%,7m
18732,3,IIIIII,2874,394,15,12,27,55.6%,9m
18732,2,[SBlock]Chebas,2874,306,14,10,24,58.3%,32m
18732,2,[SFx]Iporazzam,2874,307,12,16,28,42.9%,6m
18732,2,[CF2]GrimFandango,2874,196,11,14,25,44.0%,12m
18732,2,[iGOSU]Losss,2874,294,10,17,27,37.0%,5m
18732,3,[Moneey]Gryzm,2874,218,8,5,13,61.5%,39m
18732,3,GoldenElite,2874,168,7,5,12,58.3%,5m
18732,3,Sebilla,2874,140,6,1,7,85.7%,7m
18732,3,SCJONES,2874,86,3,3,6,50.0%,26m
18732,2,[Janna]Sie,2874,30,2,2,4,50.0%,33m
18732,2,Stillearning,2874,58,2,6,8,25.0%,28m
18732,3,Cannibal,2874,0,0,1,1,0.0%,42m
18732,3,[DezNuz]Espere,2874,0,0,1,1,0.0%,10m
18732,2,[ARRRRG]LariX,2874,0,0,2,2,0.0%,10m
18756,1,Frostee,2873,1601,208,200,408,51.0%,6m
18756,2,[FORCE9]joesmine,2873,1191,68,58,126,54.0%,26m
18756,2,MoreLife,2873,1523,59,61,120,49.2%,12m
18756,2,Snorlax,2873,624,31,24,55,56.4%,17m
18756,2,Harold,2873,715,28,33,61,45.9%,12m
18756,2,Foodstamp,2873,453,20,13,33,60.6%,27m
18756,2,Eutria,2873,378,15,19,34,44.1%,10m
18756,1,bat,2873,347,13,9,22,59.1%,26m
18756,3,ZQX,2873,232,9,6,15,60.0%,37m
18756,1,Scufflaw,2873,178,8,10,18,44.4%,43m
18756,2,LuckyOwl,2873,210,8,12,20,40.0%,21m
18756,2,[GOPERÚ]Rohan,2873,178,7,13,20,35.0%,13m
18756,2,SliQster,2873,142,6,6,12,50.0%,50m
18756,2,Deneb,2873,209,6,16,22,27.3%,2m
18756,3,urbad,2873,114,5,2,7,71.4%,22m
18756,2,Laser,2873,102,3,1,4,75.0%,8m
18756,3,tmak,2873,0,3,2,5,60.0%,24m
18756,2,david,2873,114,3,2,5,60.0%,7m
18756,2,[αB]Quark,2873,88,2,1,3,66.7%,7m
18756,3,GaijinSan,2873,0,2,3,5,40.0%,42m
18756,3,IIIIIIIIIIII,2873,0,2,3,5,40.0%,35m
18756,3,sbearn,2873,30,1,2,3,33.3%,27m
18756,2,OMGTerranOP,2873,30,1,3,4,25.0%,15m
18756,1,BeepBeepJeep,2873,97,1,6,7,14.3%,1h
18756,3,[BaT]Thyralas,2873,0,0,1,1,0.0%,31m
18756,3,StratoS,2873,0,0,1,1,0.0%,26m
18782,3,Adimus,2872,1498,184,177,361,51.0%,9m
18782,3,ShrimpsRBugs,2872,1509,169,171,340,49.7%,30m
18782,1,krea,2872,1498,112,114,226,49.6%,25m
18782,2,Vantage,2872,511,60,50,110,54.5%,10m
18782,2,[DRKRPT]LOLwhat,2872,684,28,30,58,48.3%,15m
18782,3,ROB,2872,421,15,11,26,57.7%,34m
18782,2,infamous,2872,276,13,15,28,46.4%,5m
18782,1,technobully,2872,111,10,5,15,66.7%,2h
18782,3,aSherGamer,2872,338,10,28,38,26.3%,13m
18782,1,Kappa,2872,260,9,19,28,32.1%,41m
18782,3,[FAECES]Uriel,2872,191,6,2,8,75.0%,1h
18782,3,shagito,2872,160,6,5,11,54.5%,24m
18782,2,MajorHoax,2872,158,6,8,14,42.9%,30m
18782,1,arthasLOVE,2872,0,4,3,7,57.1%,3h
18782,3,[d3stn3]GAMEofDRONEz,2872,153,3,6,9,33.3%,49m
18782,3,NuclearCore,2872,0,1,0,1,100.0%,10m
18782,3,raigomaru,2872,0,1,0,1,100.0%,36m
18782,3,Sekiix,2872,0,1,1,2,50.0%,34m
18782,3,devwu,2872,30,1,2,3,33.3%,16m
18782,2,FinalSong,2872,0,0,5,5,0.0%,17m
18782,2,[Xpk]kairos,2872,0,0,5,5,0.0%,18m
18782,3,SERGIOJR,2872,0,0,5,5,0.0%,23m
18804,2,IVARD,2871,1419,283,272,555,51.0%,30m
18804,2,Shane,2871,1572,169,163,332,50.9%,6m
18804,2,YourDaddy,2871,1436,121,104,225,53.8%,35m
18804,2,[LNNS]adap,2871,1560,105,100,205,51.2%,22m
18804,3,[MagB]Ujimushi,2871,939,57,78,135,42.2%,41m
18804,1,JPThor,2871,1093,53,36,89,59.6%,25m
18804,2,Falco,2871,1183,49,42,91,53.8%,34m
18804,3,Erick,2871,1350,47,64,111,42.3%,31m
18804,3,Broach,2871,823,44,38,82,53.7%,4m
18804,3,Ginja,2871,922,43,32,75,57.3%,31m
18804,2,ducksgoquook,2871,762,37,20,57,64.9%,26m
18804,1,Dumbo,2871,927,37,44,81,45.7%,41m
18804,2,HappyPanda,2871,405,28,19,47,59.6%,9m
18804,1,piliaborza,2871,560,26,30,56,46.4%,41m
18804,2,Samura,2871,484,18,21,39,46.2%,11m
18804,1,MechNcheese,2871,384,15,13,28,53.6%,39m
18804,2,starjunkie,2871,194,10,10,20,50.0%,39m
18804,3,Option,2871,216,9,5,14,64.3%,19m
18804,2,[2024]TRUMP,2871,178,6,12,18,33.3%,11m
18804,3,nex,2871,148,5,5,10,50.0%,18m
18804,2,[ProTPZ]Kos,2871,122,4,8,12,33.3%,15m
18804,2,FunkyMunky,2871,0,3,2,5,60.0%,40m
18804,3,[18e]TroLLRaT,2871,96,3,3,6,50.0%,23m
18804,2,Elvis,2871,104,3,3,6,50.0%,29m
18804,2,Kjubaran,2871,30,3,5,8,37.5%,39m
18804,3,Andys,2871,30,2,0,2,100.0%,10m
18804,3,[CEC]DaddyisKing,2871,58,2,2,4,50.0%,2m
18804,3,JRyujin,2871,0,1,0,1,100.0%,23m
18804,3,[Mammal]moomoo,2871,30,1,2,3,33.3%,39m
18804,3,VeN,2871,0,1,4,5,20.0%,2m
18804,2,gJaxx,2871,30,1,4,5,20.0%,32m
18804,2,mrChem,2871,0,1,6,7,14.3%,12m
18804,3,[Zin]Truean,2871,0,0,1,1,0.0%,2m
18804,1,Alphesie,2871,0,0,1,1,0.0%,3h
18804,2,Howl,2871,0,0,1,1,0.0%,1h
18804,3,[UpeV]Mugiwara,2871,0,0,1,1,0.0%,26m
18804,3,Tetsuo,2871,0,0,2,2,0.0%,2m
18804,2,oceansss,2871,0,0,2,2,0.0%,6m
18842,3,Thos,2870,1659,387,369,756,51.2%,23m
18842,2,[UpeV]BERSERK,2870,1591,226,218,444,50.9%,30m
18842,1,[JaMiT]Justin,2870,1338,160,169,329,48.6%,30m
18842,2,pepe,2870,1295,119,113,232,51.3%,15m
18842,2,Mauiwowie,2870,1005,82,69,151,54.3%,14m
18842,2,Nyssa,2870,636,71,12,83,85.5%,36m
18842,2,KilleR,2870,1553,69,64,133,51.9%,6m
18842,3,Mjolnir,2870,1165,60,56,116,51.7%,23m
18842,2,raulcs,2870,1326,56,50,106,52.8%,4m
18842,3,jaxkzz,2870,984,42,29,71,59.2%,23m
18842,2,Benski,2870,669,33,21,54,61.1%,13m
18842,3,Wille,2870,304,27,13,40,67.5%,4m
18842,2,UNEMSE,2870,352,24,21,45,53.3%,11m
18842,2,[GGMESP]THEINIUQ,2870,314,16,11,27,59.3%,17m
18842,1,REnoVation,2870,396,15,9,24,62.5%,1h
18842,2,rOdRiGeX,2870,246,9,11,20,45.0%,13m
18842,2,Gimli,2870,154,6,9,15,40.0%,19m
18842,2,[RAHMUS]ImAPro,2870,120,4,10,14,28.6%,11m
18842,1,Zero,2870,140,3,5,8,37.5%,3h
18842,2,Nismo,2870,147,3,7,10,30.0%,26m
18842,2,HanzyKeat,2870,30,2,4,6,33.3%,29m
18842,3,Atmosfear,2870,0,1,0,1,100.0%,22m
18842,3,MadKappa,2870,0,0,1,1,0.0%,22m
18842,3,helpME,2870,0,0,1,1,0.0%,35m
18866,3,LuckYWMQB,2869,1559,460,445,905,50.8%,7m
18866,3,Selbor,2869,1539,246,261,507,48.5%,39m
18866,1,SteroiD,2869,1620,213,199,412,51.7%,41m
18866,3,ConnivingJoo,2869,1259,200,226,426,46.9%,27m
18866,2,stupidanimal,2869,1449,96,100,196,49.0%,5m
18866,2,[Pton]Crystal,2869,1235,53,47,100,53.0%,23m
18866,3,Lemons,2869,856,34,30,64,53.1%,13m
18866,2,Enzo,2869,564,20,20,40,50.0%,17m
18866,1,[LOYAPÚ]MOSK,2869,496,17,27,44,38.6%,14m
18866,3,Sicarius,2869,359,16,11,27,59.3%,22m
18866,2,[GeM]Rhynowins,2869,249,8,4,12,66.7%,1h
18866,2,sPaAsM,2869,102,4,5,9,44.4%,6m
18866,3,Trout,2869,94,4,11,15,26.7%,26m
18866,2,[TPSQD]KOG,2869,102,3,2,5,60.0%,26m
18866,3,Wszuwa,2869,0,3,2,5,60.0%,26m
18866,2,Firebou,2869,30,2,3,5,40.0%,7m
18866,3,Kena,2869,0,1,0,1,100.0%,15m
18866,3,Dandrel,2869,0,1,1,2,50.0%,4m
18866,3,Nicaruga,2869,0,0,1,1,0.0%,3m
18866,3,blur,2869,0,0,1,1,0.0%,15m
18866,3,[Fract]Karel,2869,0,0,2,2,0.0%,35m
18866,3,[PASTY]rootbeer,2869,0,0,2,2,0.0%,40m
18866,2,Alvin,2869,0,0,8,8,0.0%,10m
18889,3,MAKER,2868,1570,484,477,961,50.4%,8m
18889,1,Indigo,2868,1597,256,256,512,50.0%,17m
18889,1,[LDCO]NinoFindlay,2868,1593,173,174,347,49.9%,12m
18889,2,CAPTAINblack,2868,1421,116,93,209,55.5%,26m
18889,2,venize,2868,968,108,96,204,52.9%,33m
18889,2,Unknown,2868,1125,51,39,90,56.7%,15m
18889,2,[LQV]kfcnhl,2868,496,32,28,60,53.3%,5m
18889,2,[Gudnes]Doge,2868,815,31,31,62,50.0%,29m
18889,3,[Cryptc]SirBearicus,2868,376,14,12,26,53.8%,15m
18889,2,YasserKim,2868,308,11,10,21,52.4%,7m
18889,3,[PRT]Tavo,2868,202,7,5,12,58.3%,26m
18889,3,Bob,2868,208,7,8,15,46.7%,43m
18889,3,Riaden,2868,30,6,6,12,50.0%,29m
18889,1,CalySwish,2868,119,5,0,5,100.0%,1h
18889,2,Bman,2868,146,5,12,17,29.4%,42m
18889,3,[LgnTDS]DrWerm,2868,114,4,2,6,66.7%,6m
18889,1,PetroHP,2868,0,3,2,5,60.0%,1h
18889,2,XYFANS,2868,0,3,2,5,60.0%,3h
18889,3,[MBS209]Gzus,2868,30,2,1,3,66.7%,40m
18889,3,kurtox,2868,0,2,3,5,40.0%,13m
18889,2,FlamingPanda,2868,0,1,1,2,50.0%,47m
18889,3,[WarCom]Yarev,2868,0,1,1,2,50.0%,13m
18889,3,ghoss,2868,0,0,1,1,0.0%,2m
18889,3,MONO,2868,0,0,1,1,0.0%,1h
18913,1,battlepants,2867,1550,243,221,464,52.4%,11m
18913,2,DerpVader,2867,1263,59,47,106,55.7%,8m
18913,2,[LgnTDS]fatnice,2867,1037,43,36,79,54.4%,18m
18913,2,RazieL,2867,251,26,25,51,51.0%,7m
18913,2,Batleforever,2867,438,24,24,48,50.0%,10m
18913,2,[CLnBOi]Nebuchadnrzr,2867,660,24,30,54,44.4%,26m
18913,2,JUAN,2867,604,22,22,44,50.0%,15m
18913,3,Fremen,2867,389,20,12,32,62.5%,37m
18913,3,LetUWin,2867,450,18,13,31,58.1%,38m
18913,2,[Nat20s]TVE,2867,396,16,11,27,59.3%,9m
18913,2,[Loli4u]MoneyChanger,2867,279,13,8,21,61.9%,13m
18913,2,Cryopump,2867,241,9,9,18,50.0%,9m
18913,2,RoyaleWChees,2867,268,9,11,20,45.0%,19m
18913,2,[GameSC]MrMarshall,2867,208,8,6,14,57.1%,31m
18913,2,[XCPT]TheJuicer,2867,128,6,4,10,60.0%,13m
18913,3,[XpKAc]MonKeyDLuffY,2867,146,5,6,11,45.5%,4m
18913,2,[LBF]Hawkeye,2867,116,3,2,5,60.0%,13m
18913,2,TwiceDahyun,2867,62,3,4,7,42.9%,29m
18913,2,[SonaT]BimboConPC,2867,92,3,8,11,27.3%,7m
18913,3,llllllllllll,2867,0,2,2,4,50.0%,27m
18913,3,Lucid,2867,58,2,3,5,40.0%,27m
18913,3,SaintsWarcry,2867,0,2,7,9,22.2%,1h
18913,1,Church,2867,0,1,0,1,100.0%,3h
18913,2,PTNXLO,2867,30,1,4,5,20.0%,29m
18913,3,[FMB23]RitaVrataski,2867,0,0,1,1,0.0%,2m
18913,3,Assassin,2867,0,0,1,1,0.0%,42m
18939,2,bomberice,2866,1418,150,127,277,54.2%,40m
18939,2,[GFP]GreyGoon,2866,1568,137,122,259,52.9%,10m
18939,2,Cefghi,2866,1367,127,116,243,52.3%,14m
18939,3,FullTDark,2866,755,103,83,186,55.4%,37m
18939,1,xSlayerx,2866,1360,53,55,108,49.1%,30m
18939,2,Muffn,2866,614,50,39,89,56.2%,17m
18939,2,[LIONES]PerroRabioso,2866,995,46,40,86,53.5%,15m
18939,1,[SkAL]FrostyFenix,2866,958,32,42,74,43.2%,33m
18939,2,Tomás,2866,726,28,26,54,51.9%,19m
18939,2,MadeInQuebec,2866,464,19,19,38,50.0%,7m
18939,2,[xARGx]MataPros,2866,397,17,13,30,56.7%,2m
18939,2,angel,2866,448,17,17,34,50.0%,21m
18939,3,[BlHawk]Quantum,2866,314,12,9,21,57.1%,32m
18939,2,Hidoria,2866,336,12,14,26,46.2%,12m
18939,3,[MBRV]Sindrew,2866,241,10,8,18,55.6%,19m
18939,3,Dom,2866,194,8,5,13,61.5%,16m
18939,3,[PINGON]Army,2866,202,6,1,7,85.7%,22m
18939,3,hurryslowly,2866,60,5,4,9,55.6%,43m
18939,2,TheD,2866,130,4,4,8,50.0%,7m
18939,1,ZergOP,2866,36,4,5,9,44.4%,22m
18939,2,Jeebi,2866,142,3,4,7,42.9%,18m
18939,2,JiNyoGi,2866,60,3,8,11,27.3%,9m
18939,2,Eskaz,2866,58,2,5,7,28.6%,29m
18939,3,ArtOfWar,2866,0,1,0,1,100.0%,20m
18939,3,Sidebar,2866,0,1,0,1,100.0%,24m
18939,3,Einarin,2866,30,1,1,2,50.0%,42m
18939,1,MilkNCookies,2866,0,0,3,3,0.0%,3h
18966,3,KingofRawDog,2865,1371,108,88,196,55.1%,19m
18966,2,defn,2865,1569,97,91,188,51.6%,33m
18966,1,hobonomo,2865,1548,79,89,168,47.0%,6m
18966,1,ErikTheJet,2865,765,57,63,120,47.5%,29m
18966,3,Sagara,2865,1253,56,38,94,59.6%,31m
18966,2,Juge,2865,995,55,48,103,53.4%,21m
18966,2,[FyHr]ShadyStyle,2865,783,49,48,97,50.5%,21m
18966,2,IslandCow,2865,173,30,22,52,57.7%,18m
18966,3,[UpxV]EmpOhSoGoT,2865,654,30,42,72,41.7%,15m
18966,2,llllllllllll,2865,479,20,14,34,58.8%,30m
18966,3,TryTryTry,2865,490,18,13,31,58.1%,18m
18966,2,kvd,2865,372,14,10,24,58.3%,16m
18966,2,[TMSyN]oxjosh,2865,266,10,14,24,41.7%,8m
18966,2,[TGP2]Kuvin,2865,308,10,14,24,41.7%,40m
18966,3,noobmaster,2865,213,8,6,14,57.1%,3m
18966,3,Tassadar,2865,190,7,5,12,58.3%,15m
18966,2,saberisaboy,2865,118,7,6,13,53.8%,41m
18966,2,[WNTRBL]Daishan,2865,124,5,8,13,38.5%,30m
18966,2,Drezdensiti,2865,30,4,4,8,50.0%,27m
18966,3,malletoh,2865,153,3,1,4,75.0%,15m
18966,2,ltwonapoca,2865,48,3,3,6,50.0%,3h
18966,3,[RPheno]Exterminator,2865,30,2,2,4,50.0%,18m
18966,2,TonyDanza,2865,30,2,4,6,33.3%,13m
18966,2,[KnM]Mitsunami,2865,30,2,5,7,28.6%,11m
18966,3,[EvAlAn]TonyBeteta,2865,0,1,0,1,100.0%,22m
18966,3,[LiPy]waxccino,2865,0,1,1,2,50.0%,26m
18966,3,[TVV]TWSolar,2865,0,1,4,5,20.0%,2m
18966,2,[1Fenix]jzapata,2865,30,1,5,6,16.7%,29m
18966,1,[BrLc]Fenix,2865,30,1,7,8,12.5%,4m
18966,3,[IDKH]Barbro,2865,0,0,1,1,0.0%,22m
18966,3,sqaz,2865,0,0,1,1,0.0%,5m
18966,1,[BCCHEE]Jonthekilr,2865,0,0,1,1,0.0%,23m
18998,2,stellar,2864,1635,133,131,264,50.4%,30m
18998,2,Drako,2864,1478,89,85,174,51.1%,36m
18998,3,[Exist]Finnholio,2864,1397,61,39,100,61.0%,40m
18998,2,ataklos,2864,938,59,50,109,54.1%,20m
18998,2,JackSparrow,2864,1153,52,48,100,52.0%,14m
18998,2,NameName,2864,1073,46,37,83,55.4%,36m
18998,1,wehrmacht,2864,1049,38,48,86,44.2%,29m
18998,2,Stairs,2864,460,18,18,36,50.0%,7m
18998,1,ChookUS,2864,318,12,16,28,42.9%,11m
18998,2,ExoSquad,2864,116,11,10,21,52.4%,22m
18998,3,samsim,2864,254,10,5,15,66.7%,29m
18998,3,[SkAL]ViewtifulJoe,2864,246,9,5,14,64.3%,18m
18998,3,sanz,2864,176,7,4,11,63.6%,39m
18998,2,[EMP451]Winter,2864,152,5,5,10,50.0%,11m
18998,3,Visceroid,2864,114,5,5,10,50.0%,17m
18998,2,Emressynn,2864,0,4,1,5,80.0%,13m
18998,1,LXXV,2864,117,4,3,7,57.1%,1h
18998,2,[gumba]nlgerianscam,2864,88,2,1,3,66.7%,19m
18998,2,PhoenixFire,2864,30,2,3,5,40.0%,29m
18998,2,Gronde,2864,102,2,3,5,40.0%,42m
18998,3,FantasmaIXI,2864,0,1,0,1,100.0%,21m
18998,2,rafa,2864,0,1,0,1,100.0%,2h
18998,2,SpikedTea,2864,0,1,2,3,33.3%,6m
18998,2,SloWdeath,2864,30,1,4,5,20.0%,5m
18998,2,BattleOOZE,2864,48,1,5,6,16.7%,13m
18998,1,aXBoulanger,2864,30,1,9,10,10.0%,14m
18998,3,Kavu,2864,0,0,1,1,0.0%,43m
18998,3,Spclchar,2864,0,0,1,1,0.0%,29m
18998,3,Gabriel,2864,0,0,1,1,0.0%,22m
18998,3,confuzed,2864,0,0,1,1,0.0%,43m
18998,2,Armorine,2864,0,0,3,3,0.0%,32m
19029,1,Sentenced,2863,1651,405,375,780,51.9%,27m
19029,3,Tigger,2863,1633,257,247,504,51.0%,5m
19029,1,[XpKAc]ska,2863,1610,211,213,424,49.8%,4m
19029,2,[OGbros]StarMax,2863,902,110,92,202,54.5%,18m
19029,2,Bernard,2863,1335,109,90,199,54.8%,15m
19029,2,CrazyAsshol,2863,1405,80,76,156,51.3%,21m
19029,1,Cesiboy,2863,1110,38,46,84,45.2%,36m
19029,3,[ANDYy]CoolPants,2863,473,34,13,47,72.3%,34m
19029,1,oscarluq,2863,793,31,33,64,48.4%,15m
19029,2,SniperElite,2863,770,28,32,60,46.7%,9m
19029,2,DHH,2863,651,25,15,40,62.5%,11m
19029,2,RevanderDrag,2863,652,24,21,45,53.3%,17m
19029,2,Grok,2863,543,19,20,39,48.7%,20m
19029,1,DrOiD,2863,416,15,23,38,39.5%,31m
19029,2,Gizmo,2863,390,14,20,34,41.2%,39m
19029,2,DuskTower,2863,312,11,9,20,55.0%,31m
19029,2,pawel,2863,283,11,14,25,44.0%,32m
19029,3,FlynHwn,2863,233,10,5,15,66.7%,19m
19029,2,[Locnes]Fiddycent,2863,123,9,6,15,60.0%,29m
19029,1,Valerie,2863,290,9,6,15,60.0%,1h
19029,2,[EZDUNK]Pianoloid,2863,211,7,4,11,63.6%,10m
19029,2,SirNemo,2863,226,6,8,14,42.9%,43m
19029,1,SANA,2863,140,5,1,6,83.3%,1h
19029,3,DREWPICKLES,2863,172,5,3,8,62.5%,59m
19029,3,Alicc,2863,86,4,0,4,100.0%,16m
19029,1,[EoMX]egoboxer,2863,97,4,1,5,80.0%,1h
19029,3,Napoleon,2863,97,4,5,9,44.4%,27m
19029,3,[ssexxy]BehindYou,2863,53,3,1,4,75.0%,11m
19029,1,Darkchobes,2863,0,3,3,6,50.0%,1h
19029,3,sooyaaa,2863,90,3,4,7,42.9%,27m
19029,2,[Shardz]Brendon,2863,58,2,7,9,22.2%,23m
19029,3,[BWSC]Guerrilla,2863,0,1,0,1,100.0%,20m
19029,3,[Zatra]Anvorguesa,2863,0,1,0,1,100.0%,8m
19029,3,Hamilton,2863,30,1,3,4,25.0%,10m
19029,3,RooR,2863,0,0,1,1,0.0%,16m
19029,3,AllinToTTi,2863,0,0,1,1,0.0%,21m
19029,2,choiboy,2863,0,0,1,1,0.0%,2h
19029,3,[PNKN]Peadan,2863,0,0,1,1,0.0%,43m
19029,3,EquinoxAngel,2863,0,0,1,1,0.0%,43m
19068,1,Hoz,2862,1497,268,242,510,52.5%,26m
19068,1,BIANCHIROCK,2862,1571,141,124,265,53.2%,41m
19068,2,Coágulo,2862,1596,118,116,234,50.4%,13m
19068,1,MaTrikeanEuX,2862,1626,103,91,194,53.1%,39m
19068,2,cazanova,2862,1434,75,63,138,54.3%,17m
19068,3,Joaoarara,2862,914,37,33,70,52.9%,43m
19068,3,Twarn,2862,464,19,7,26,73.1%,29m
19068,2,Markle,2862,426,19,12,31,61.3%,32m
19068,3,CaZeTty,2862,305,18,6,24,75.0%,23m
19068,3,[11001]Yggdrasil,2862,479,18,12,30,60.0%,19m
19068,2,Hitchslap,2862,416,15,16,31,48.4%,43m
19068,3,Sausage,2862,309,12,10,22,54.5%,37m
19068,3,[delTRN]SwarmyBoi,2862,174,7,7,14,50.0%,29m
19068,2,[ClanGB]Andritow,2862,156,6,8,14,42.9%,17m
19068,2,Casper,2862,137,5,2,7,71.4%,32m
19068,3,Jermz,2862,161,5,11,16,31.2%,10m
19068,2,CMGtml,2862,116,4,2,6,66.7%,10m
19068,3,Gabito,2862,30,4,3,7,57.1%,22m
19068,1,Ztee,2862,88,4,5,9,44.4%,31m
19068,3,Octopus,2862,163,4,6,10,40.0%,34m
19068,2,Ourlad,2862,141,3,1,4,75.0%,35m
19068,2,DADA,2862,38,3,4,7,42.9%,33m
19068,3,Razodium,2862,58,2,2,4,50.0%,35m
19068,2,[DanTub]Joey,2862,120,2,3,5,40.0%,32m
19068,3,gbmKSquare,2862,0,1,0,1,100.0%,12m
19068,3,Gravitation,2862,0,1,0,1,100.0%,32m
19068,1,[AbcCo]elvilca,2862,0,1,0,1,100.0%,1h
19068,3,Digital,2862,0,0,1,1,0.0%,35m
19096,3,Doxylamine,2861,605,34,47,81,42.0%,31m
19096,1,[Rela]JamirL,2861,898,31,39,70,44.3%,26m
19096,1,[CRAKS]RaYo,2861,628,29,26,55,52.7%,12m
19096,2,Skywalker,2861,752,26,29,55,47.3%,32m
19096,2,[TMCsc]Jaltaro,2861,447,25,17,42,59.5%,10m
19096,2,[SKES]SubMarine,2861,660,24,24,48,50.0%,38m
19096,1,Hateme,2861,465,20,22,42,47.6%,12m
19096,3,MasterMind,2861,190,7,4,11,63.6%,26m
19096,3,HERMESE,2861,183,6,3,9,66.7%,2h
19096,3,Geraldo,2861,140,5,2,7,71.4%,25m
19096,3,CarpeDiem,2861,202,5,9,14,35.7%,5m
19096,2,blink,2861,0,4,2,6,66.7%,26m
19096,1,CheeseLord,2861,119,4,3,7,57.1%,2h
19096,2,Satsuri,2861,90,4,5,9,44.4%,15m
19096,3,Kerlif,2861,0,3,2,5,60.0%,39m
19096,3,JorgeRG,2861,58,2,3,5,40.0%,4m
19096,2,RayJFTW,2861,62,2,5,7,28.6%,18m
19096,3,[LIVER]Wuxy,2861,30,1,1,2,50.0%,1h
19096,2,[Subaru]Nardii,2861,0,1,4,5,20.0%,3h
19096,3,Arkalinoso,2861,0,0,1,1,0.0%,16m
19096,1,Fweston,2861,0,0,1,1,0.0%,40m
19096,3,[420JJ]Clock,2861,0,0,2,2,0.0%,32m
19096,3,Aschroft,2861,0,0,2,2,0.0%,43m
19096,3,Ghost,2861,0,0,2,2,0.0%,2m
19096,1,jugger,2861,0,0,2,2,0.0%,3h
19121,1,BrownWook,2860,1594,163,131,294,55.4%,14m
19121,3,Kunka,2860,1067,161,154,315,51.1%,16m
19121,1,Gauss,2860,1276,79,65,144,54.9%,41m
19121,3,slyhardcore,2860,555,49,43,92,53.3%,42m
19121,3,THEWOOD,2860,1240,43,54,97,44.3%,24m
19121,1,Chumbo,2860,1042,37,47,84,44.0%,35m
19121,2,[Manics]AAABattery,2860,732,33,28,61,54.1%,29m
19121,2,TamyOne,2860,316,21,25,46,45.7%,14m
19121,1,UNKO,2860,515,20,23,43,46.5%,35m
19121,2,LastHope,2860,411,17,8,25,68.0%,36m
19121,3,Themaster,2860,268,10,1,11,90.9%,28m
19121,1,[1CORPS]GENERALKILL,2860,199,10,13,23,43.5%,12m
19121,2,wholemulk,2860,150,6,8,14,42.9%,7m
19121,2,FelixUwU,2860,131,5,5,10,50.0%,18m
19121,2,[dtwist]DOMAH,2860,160,5,7,12,41.7%,17m
19121,1,Sirus,2860,97,4,3,7,57.1%,30m
19121,2,BenedictAD,2860,92,4,9,13,30.8%,32m
19121,1,[69Rx69]Assprin,2860,0,3,3,6,50.0%,1h
19121,2,[DontRN]GerarldH,2860,30,2,3,5,40.0%,13m
19121,3,[AFNC]LeoV,2860,0,2,3,5,40.0%,43m
19121,1,Privet,2860,0,2,5,7,28.6%,52m
19121,3,Prime,2860,0,0,2,2,0.0%,2h
19121,2,[SDAE]lego,2860,0,0,3,3,0.0%,36m
19121,2,AKDoak,2860,0,0,5,5,0.0%,41m
19145,2,zoolander,2859,700,78,65,143,54.5%,40m
19145,2,[SCRuBx]fatrtime,2859,1579,74,70,144,51.4%,10m
19145,2,Signicher,2859,1377,51,53,104,49.0%,21m
19145,2,AskarDog,2859,980,40,32,72,55.6%,4m
19145,2,[whalez]jabberjabber,2859,747,34,27,61,55.7%,32m
19145,2,Tenko,2859,637,31,22,53,58.5%,40m
19145,3,SteamedMilk,2859,414,17,13,30,56.7%,15m
19145,2,oldmannap,2859,184,6,11,17,35.3%,11m
19145,1,Rejiz,2859,97,4,3,7,57.1%,56m
19145,3,NiGhTRIdER,2859,88,4,4,8,50.0%,13m
19145,3,gnome,2859,30,4,7,11,36.4%,8m
19145,2,SparkySparky,2859,0,3,2,5,60.0%,13m
19145,2,MarCraft,2859,50,3,4,7,42.9%,17m
19145,2,Atom,2859,98,3,9,12,25.0%,18m
19145,3,Jasperrr,2859,0,1,1,2,50.0%,39m
19145,2,Omega,2859,0,1,2,3,33.3%,15m
19145,3,Kal,2859,0,1,2,3,33.3%,56m
19145,2,[DUEL]QuackerZ,2859,30,1,5,6,16.7%,8m
19145,3,MrBojangles,2859,0,0,1,1,0.0%,23m
19145,1,Stormtrooper,2859,0,0,6,6,0.0%,3h
19165,2,BoostY,2858,1234,124,117,241,51.5%,11m
19165,2,jhec,2858,1266,47,52,99,47.5%,5m
19165,2,Robespierre,2858,606,22,22,44,50.0%,7m
19165,1,Manguera,2858,559,21,20,41,51.2%,25m
19165,3,[YGD]Diarukia,2858,317,13,4,17,76.5%,40m
19165,2,[MAQTAS]canabiis,2858,386,12,15,27,44.4%,4m
19165,2,[ACRE]Keniow,2858,287,10,10,20,50.0%,13m
19165,2,HiHeye,2858,287,10,10,20,50.0%,52m
19165,3,[ValidG]SafteScizors,2858,242,7,4,11,63.6%,37m
19165,2,hahanever,2858,191,7,8,15,46.7%,7m
19165,3,[GoldPo]TheCold,2858,0,5,0,5,100.0%,43m
19165,3,Slim,2858,197,5,8,13,38.5%,9m
19165,3,BroCookie,2858,0,3,2,5,60.0%,21m
19165,1,Herbmann,2858,0,3,3,6,50.0%,54m
19165,2,[SlrpMe]Grundle,2858,0,2,0,2,100.0%,3h
19165,3,[MAYN]Marcusromius,2858,58,2,4,6,33.3%,2m
19165,2,[N40GF]Kaleem,2858,30,2,4,6,33.3%,12m
19165,2,[EpicG]ElCónclave,2858,62,2,7,9,22.2%,19m
19165,3,Raziel,2858,0,1,0,1,100.0%,39m
19165,3,LCH,2858,0,1,1,2,50.0%,9m
19165,2,[2ES]Toxic,2858,0,1,2,3,33.3%,9m
19165,3,djayfeel,2858,0,0,1,1,0.0%,18m
19165,3,jeaen,2858,0,0,1,1,0.0%,29m
19165,1,[ScSwrm]FutureNights,2858,0,0,2,2,0.0%,3h
19189,1,sinneD,2857,1643,184,169,353,52.1%,10m
19189,2,[Chubak]Endurance,2857,1314,112,99,211,53.1%,24m
19189,2,JOHN,2857,1303,87,86,173,50.3%,29m
19189,2,striker,2857,1467,73,66,139,52.5%,37m
19189,1,[Chlvrs]LORVAL,2857,1239,55,54,109,50.5%,33m
19189,2,pidgey,2857,654,38,35,73,52.1%,21m
19189,1,Maiev,2857,503,36,33,69,52.2%,32m
19189,1,[ZNsc]Nanozstorm,2857,931,32,38,70,45.7%,39m
19189,3,waves,2857,681,28,20,48,58.3%,39m
19189,2,ETET,2857,719,28,28,56,50.0%,11m
19189,3,Fourlan,2857,446,17,12,29,58.6%,3m
19189,2,[FATwS]FatIsaac,2857,270,10,16,26,38.5%,36m
19189,3,CakePie,2857,225,8,7,15,53.3%,22m
19189,3,SPLINTER,2857,100,7,3,10,70.0%,18m
19189,3,lizardman,2857,192,7,7,14,50.0%,3h
19189,1,ZyRoN,2857,120,5,5,10,50.0%,29m
19189,2,ELVIC,2857,76,5,8,13,38.5%,24m
19189,3,[BrnchB]PancakeFlip,2857,86,4,3,7,57.1%,24m
19189,3,ghostsafari,2857,92,4,4,8,50.0%,16m
19189,3,cucasxdxdxd,2857,0,3,2,5,60.0%,3m
19189,2,Kendal,2857,0,3,3,6,50.0%,30m
19189,3,supraspeed,2857,30,2,0,2,100.0%,9m
19189,3,[BMamba]CAPTAINBUTT,2857,30,2,1,3,66.7%,40m
19189,3,GLHF,2857,30,2,1,3,66.7%,29m
19189,3,fifou,2857,123,2,2,4,50.0%,23m
19189,3,whitewolf,2857,0,1,0,1,100.0%,22m
19189,3,Nightshade,2857,30,1,3,4,25.0%,15m
19189,3,Blade,2857,0,0,1,1,0.0%,15m
19189,2,SilentStorm,2857,0,0,3,3,0.0%,7m
19218,1,ark,2856,1543,454,461,915,49.6%,26m
19218,2,[MMSC]Owenthemac,2856,1599,132,126,258,51.2%,30m
19218,3,blurr,2856,1523,68,47,115,59.1%,23m
19218,2,OuDatSpell,2856,977,45,42,87,51.7%,12m
19218,2,lyubisebya,2856,736,34,25,59,57.6%,14m
19218,2,Peas,2856,332,34,32,66,51.5%,20m
19218,2,[LARM]Beregonds,2856,687,28,26,54,51.9%,40m
19218,2,mossses,2856,210,14,17,31,45.2%,14m
19218,2,[HAWD]hulksmash,2856,312,12,13,25,48.0%,21m
19218,2,modcrac,2856,177,6,8,14,42.9%,3h
19218,3,[MANDEZ]bastianpp,2856,90,4,2,6,66.7%,43m
19218,3,[GOPERÚ]pandafloo,2856,90,4,3,7,57.1%,34m
19218,3,Dagashiya,2856,89,4,6,10,40.0%,21m
19218,3,soulk,2856,0,3,2,5,60.0%,43m
19218,2,[ExLa]Exclux,2856,90,3,11,14,21.4%,33m
19218,3,Auron,2856,0,2,3,5,40.0%,5m
19218,3,[Itachl]IIIIIIIIIIII,2856,0,1,0,1,100.0%,18m
19218,1,[CBOG]ZéDoXaPeu,2856,48,1,1,2,50.0%,3h
19218,3,crazypenguin,2856,0,0,1,1,0.0%,22m
19218,3,[Yuki8]Forgotten,2856,0,0,2,2,0.0%,29m
19218,1,Timmy,2856,0,0,5,5,0.0%,27m
19239,2,Poulpe,2855,687,121,107,228,53.1%,17m
19239,3,[GGWP]PANDREX,2855,1579,69,57,126,54.8%,33m
19239,1,Majaax,2855,1540,69,71,140,49.3%,8m
19239,2,Effort,2855,894,31,36,67,46.3%,7m
19239,3,BOBOME,2855,462,18,9,27,66.7%,19m
19239,1,Ken,2855,313,13,14,27,48.1%,29m
19239,3,IlIKaiLII,2855,173,7,7,14,50.0%,58m
19239,2,BanelingTrum,2855,102,6,3,9,66.7%,40m
19239,1,Czechowicz,2855,146,6,5,11,54.5%,26m
19239,3,[ZCNOOB]megapimp,2855,0,3,2,5,60.0%,27m
19239,3,PlayMaker,2855,116,2,1,3,66.7%,7m
19239,2,Dominatus,2855,102,2,3,5,40.0%,14m
19239,2,JKPW,2855,62,2,8,10,20.0%,21m
19239,2,[TeamUR]SmutnaRzeka,2855,60,2,8,10,20.0%,40m
19239,1,rleon,2855,38,2,9,11,18.2%,18m
19239,2,remyhahn,2855,30,1,4,5,20.0%,5m
19239,2,dirk,2855,30,1,7,8,12.5%,32m
19239,3,[Daimyo]Draconis,2855,0,0,1,1,0.0%,28m
19257,3,Sapporo,2854,1720,182,179,361,50.4%,22m
19257,3,CRATE,2854,1387,173,181,354,48.9%,28m
19257,2,HELPMEDECIDE,2854,1138,43,42,85,50.6%,30m
19257,1,ckck,2854,580,19,24,43,44.2%,29m
19257,2,Kenta,2854,490,17,19,36,47.2%,11m
19257,1,CmndrYoshi,2854,502,17,27,44,38.6%,41m
19257,3,Wintergrasp,2854,391,15,9,24,62.5%,9m
19257,3,Datedorck,2854,330,11,6,17,64.7%,39m
19257,3,CRISTHIAN,2854,90,4,3,7,57.1%,36m
19257,2,Procrastinat,2854,30,4,4,8,50.0%,14m
19257,2,[NwAs]osueka,2854,140,4,4,8,50.0%,9m
19257,2,[DarkAG]Red,2854,92,3,6,9,33.3%,22m
19257,3,BilboBaggins,2854,30,2,0,2,100.0%,31m
19257,2,Cristalis,2854,30,2,5,7,28.6%,11m
19257,2,Chrnos,2854,30,2,5,7,28.6%,5m
19257,3,[TC2]GenBen,2854,0,1,0,1,100.0%,43m
19257,3,GIo,2854,0,1,0,1,100.0%,22m
19257,3,[DhZAc1]sterbs,2854,30,1,2,3,33.3%,42m
19257,3,PelosiBestB,2854,0,0,1,1,0.0%,37m
19257,3,Cahizaaa,2854,0,0,1,1,0.0%,28m
19277,2,fungk,2853,1547,216,199,415,52.0%,18m
19277,1,hnrcbx,2853,1445,82,85,167,49.1%,33m
19277,2,TheDogBarked,2853,1468,70,68,138,50.7%,13m
19277,2,ObstfWurm,2853,811,59,58,117,50.4%,4m
19277,2,[EvilGC]yarley,2853,861,33,34,67,49.3%,24m
19277,2,AstroBlaster,2853,458,16,18,34,47.1%,9m
19277,1,Caution,2853,344,11,20,31,35.5%,41m
19277,3,MicroMoti,2853,223,7,2,9,77.8%,5m
19277,2,CheesePizza,2853,128,5,5,10,50.0%,36m
19277,3,leyen,2853,86,4,1,5,80.0%,13m
19277,2,Purple,2853,149,4,2,6,66.7%,2h
19277,3,[cluez]ArcticMonkey,2853,0,3,2,5,60.0%,33m
19277,1,HansLanda,2853,0,3,3,6,50.0%,1h
19277,2,daFisherman,2853,60,3,4,7,42.9%,11m
19277,1,pistolon,2853,97,2,5,7,28.6%,3h
19277,3,Nanology,2853,0,1,0,1,100.0%,34m
19277,3,[Atone]Base,2853,96,1,2,3,33.3%,7m
19277,2,Alucard,2853,30,1,4,5,20.0%,27m
19277,3,[Katsu]Katsuraji,2853,0,0,1,1,0.0%,26m
19296,2,DsC,2852,1571,138,141,279,49.5%,7m
19296,2,[TriFP]JotaJonas,2852,1560,115,95,210,54.8%,40m
19296,1,bonzi,2852,1591,111,110,221,50.2%,37m
19296,2,Dante,2852,949,60,46,106,56.6%,24m
19296,2,Csuth,2852,977,48,53,101,47.5%,10m
19296,2,NictusWayde,2852,395,32,31,63,50.8%,8m
19296,2,xalalaô,2852,727,27,25,52,51.9%,14m
19296,3,liquidpain,2852,625,25,13,38,65.8%,2m
19296,1,beto,2852,341,11,19,30,36.7%,4m
19296,2,JSRR,2852,173,9,6,15,60.0%,18m
19296,3,YEETMAS,2852,187,7,8,15,46.7%,11m
19296,3,[TPGGXD]DarKar,2852,145,3,5,8,37.5%,3h
19296,3,RaccoonV,2852,0,2,3,5,40.0%,31m
19296,3,PowerYoda,2852,0,1,0,1,100.0%,34m
19296,3,GOLDENEAGLE,2852,0,1,0,1,100.0%,27m
19296,3,Edgex,2852,30,1,1,2,50.0%,7m
19296,3,ChaosPigeon,2852,30,1,2,3,33.3%,31m
19296,3,Ramy,2852,0,0,1,1,0.0%,2m
19296,3,[HIVIZ]Vision,2852,0,0,1,1,0.0%,14m
19296,3,JobChae,2852,0,0,1,1,0.0%,19m
19296,3,Emerik,2852,0,0,1,1,0.0%,37m
19296,3,pepitonaso,2852,0,0,1,1,0.0%,29m
19318,3,Robosushi,2851,1581,129,124,253,51.0%,22m
19318,3,Soap,2851,1185,109,98,207,52.7%,3m
19318,2,[VPB]JunKie,2851,1344,99,88,187,52.9%,17m
19318,2,Jadwick,2851,1555,75,70,145,51.7%,17m
19318,2,Zaphtark,2851,398,18,12,30,60.0%,11m
19318,2,FishAndChips,2851,363,14,8,22,63.6%,48m
19318,3,PhOeNiX,2851,234,10,6,16,62.5%,15m
19318,3,[BNATA]Kexin,2851,243,9,2,11,81.8%,10m
19318,3,[SLAMT]ElecTrAsY,2851,127,6,2,8,75.0%,16m
19318,1,[KING3]greg,2851,230,6,10,16,37.5%,26m
19318,3,[MilkPi]DrLiberty,2851,120,4,5,9,44.4%,38m
19318,3,alex,2851,120,4,5,9,44.4%,22m
19318,3,IIIIIIIIIII,2851,0,3,2,5,60.0%,40m
19318,3,[TSCP]Ashtah,2851,0,3,2,5,60.0%,31m
19318,3,VOID,2851,0,3,2,5,60.0%,2m
19318,3,[Coknut]MCer,2851,60,3,3,6,50.0%,9m
19318,3,happystick,2851,30,2,1,3,66.7%,7m
19318,1,Flow,2851,132,2,3,5,40.0%,33m
19318,1,Shuriken,2851,96,2,5,7,28.6%,3h
19318,1,[oMAGAo]PengPongShow,2851,0,1,0,1,100.0%,6m
19318,1,CountDooku,2851,0,1,0,1,100.0%,3h
19318,3,[DarkAG]Dath,2851,0,0,1,1,0.0%,34m
19318,3,[X17]Thor,2851,0,0,1,1,0.0%,39m
19318,3,[NYOOOM]Direlict,2851,0,0,1,1,0.0%,19m
19318,2,[SsaYnS]Khaine,2851,0,0,1,1,0.0%,48m
19318,3,Mantecrise,2851,0,0,1,1,0.0%,42m
19318,1,[Cruxis]GoobynDolon,2851,0,0,2,2,0.0%,15m
19318,3,Vanillawho,2851,0,0,2,2,0.0%,9m
19318,3,Lukelberry,2851,0,0,2,2,0.0%,33m
19318,2,Paladin,2851,0,0,4,4,0.0%,18m
19348,3,Verus,2850,1143,221,202,423,52.2%,12m
19348,3,[Desani]WildWest,2850,1070,121,127,248,48.8%,19m
19348,1,AzaSMtt,2850,1603,95,98,193,49.2%,4m
19348,3,TiggerTony,2850,1450,62,56,118,52.5%,31m
19348,2,postmortem,2850,920,50,49,99,50.5%,13m
19348,1,HongWu,2850,1226,44,54,98,44.9%,38m
19348,3,Spudward,2850,436,19,10,29,65.5%,39m
19348,3,[Dogee]biznatch,2850,419,18,4,22,81.8%,15m
19348,2,AeDerone,2850,375,18,21,39,46.2%,19m
19348,2,Rocktopus,2850,264,9,13,22,40.9%,16m
19348,2,baduserna,2850,207,7,4,11,63.6%,37m
19348,2,roofus,2850,188,7,6,13,53.8%,32m
19348,3,carloxd,2850,166,6,4,10,60.0%,1m
19348,1,Neboluz,2850,121,5,4,9,55.6%,56m
19348,3,Wuandalo,2850,114,4,3,7,57.1%,16m
19348,3,[MoonR]Alicorn,2850,60,3,1,4,75.0%,3m
19348,1,Sveet,2850,0,3,3,6,50.0%,3h
19348,2,kirk,2850,88,2,2,4,50.0%,36m
19348,3,Prominence,2850,58,2,3,5,40.0%,32m
19348,3,[FORCE9]VidCooler,2850,0,1,0,1,100.0%,22m
19348,3,[TBPP]enDyeAh,2850,0,1,0,1,100.0%,23m
19348,2,Nintendo,2850,0,1,3,4,25.0%,7m
19348,2,[KhanZ]radaguest,2850,0,0,1,1,0.0%,28m
19348,3,RichGuys,2850,0,0,1,1,0.0%,26m
19348,3,YaMajesty,2850,0,0,1,1,0.0%,17m
19348,2,[LCE]WilliamsDK,2850,0,0,2,2,0.0%,37m
19374,1,[WOTDL]xiozone,2849,1554,259,250,509,50.9%,32m
19374,1,MarineLord,2849,1000,230,244,474,48.5%,27m
19374,2,IKRAM,2849,1038,112,114,226,49.6%,30m
19374,3,Influenzahah,2849,721,38,5,43,88.4%,14m
19374,2,[6G]Denisplayer,2849,856,31,33,64,48.4%,7m
19374,2,[AIN]atomicbato,2849,796,30,31,61,49.2%,24m
19374,3,SkullCapVR,2849,642,25,20,45,55.6%,39m
19374,2,becareful,2849,548,23,21,44,52.3%,24m
19374,1,Envious,2849,678,22,28,50,44.0%,28m
19374,3,BaseDAD,2849,478,19,16,35,54.3%,7m
19374,1,BUMMYBUMMY,2849,298,15,14,29,51.7%,25m
19374,2,mimja,2849,338,11,14,25,44.0%,12m
19374,3,Battlemaster,2849,252,10,5,15,66.7%,22m
19374,2,Floco,2849,221,9,5,14,64.3%,7m
19374,2,NoCheesePlz,2849,143,6,4,10,60.0%,16m
19374,2,[M2A5]bloodyparrot,2849,88,3,10,13,23.1%,8m
19374,1,MajorSparkle,2849,68,2,11,13,15.4%,31m
19374,3,Golden,2849,0,1,0,1,100.0%,7m
19374,1,Ceskart,2849,0,1,0,1,100.0%,22m
19374,2,Anzac,2849,0,1,1,2,50.0%,35m
19374,3,HalcyonOne,2849,30,1,4,5,20.0%,4m
19374,3,[AIURxT]DragonSlayer,2849,0,0,1,1,0.0%,7m
19374,3,[ffaaak]CGenius,2849,0,0,1,1,0.0%,19m
19397,2,BananaPuddin,2848,384,87,69,156,55.8%,17m
19397,1,SgtPatches,2848,1252,80,68,148,54.1%,11m
19397,2,ZombieBrains,2848,1550,67,65,132,50.8%,8m
19397,3,Kyoumadess,2848,760,31,23,54,57.4%,8m
19397,2,Hsamp,2848,619,25,23,48,52.1%,40m
19397,2,Karamazov,2848,314,17,18,35,48.6%,9m
19397,3,AngeluS,2848,340,16,11,27,59.3%,3m
19397,2,[BBDB]Zalathor,2848,408,14,19,33,42.4%,17m
19397,3,BlackKnight,2848,184,12,1,13,92.3%,1m
19397,3,[Lp]lllIlIlIIlIl,2848,275,10,35,45,22.2%,31m
19397,2,[UpxV]Centurion,2848,174,9,9,18,50.0%,20m
19397,1,riceHero,2848,140,5,4,9,55.6%,2h
19397,3,CascadeBoom,2848,146,5,5,10,50.0%,22m
19397,3,Wigglytuff,2848,133,5,5,10,50.0%,8m
19397,1,YogaMat,2848,97,4,3,7,57.1%,34m
19397,3,[SEAT]bbitO,2848,30,4,3,7,57.1%,39m
19397,2,SayCheese,2848,30,4,4,8,50.0%,30m
19397,2,[DRKAPP]YOLO,2848,98,4,8,12,33.3%,24m
19397,3,Alebris,2848,86,3,1,4,75.0%,29m
19397,3,[ValidG]Wanderer,2848,86,3,3,6,50.0%,22m
19397,3,[JaMiT]Greenknight,2848,30,1,1,2,50.0%,12m
19397,3,YoloSwagtron,2848,0,0,1,1,0.0%,28m
19397,1,Stalk,2848,0,0,2,2,0.0%,35m
19420,1,TheK,2847,1577,263,266,529,49.7%,28m
19420,1,[KingSC]Azazel,2847,1582,111,106,217,51.2%,29m
19420,1,darkness,2847,1372,95,84,179,53.1%,13m
19420,3,Nutcracker,2847,1595,67,59,126,53.2%,19m
19420,1,William,2847,826,60,51,111,54.1%,18m
19420,3,Glazed,2847,1163,55,34,89,61.8%,16m
19420,2,[YBDBD]LastRebel,2847,1174,44,48,92,47.8%,7m
19420,2,SuperPlayer,2847,975,42,35,77,54.5%,18m
19420,3,[WOTG]Guingon,2847,911,35,31,66,53.0%,15m
19420,2,Phantompuff,2847,441,35,31,66,53.0%,22m
19420,2,Eric,2847,495,34,26,60,56.7%,17m
19420,2,asigaru,2847,474,17,16,33,51.5%,42m
19420,3,Kameh,2847,396,15,14,29,51.7%,37m
19420,2,Edelen,2847,252,8,7,15,53.3%,29m
19420,3,Hawkeye,2847,156,7,5,12,58.3%,19m
19420,2,Ether,2847,224,7,15,22,31.8%,10m
19420,3,MorningWood,2847,168,5,2,7,71.4%,2h
19420,1,Kill,2847,145,4,3,7,57.1%,3h
19420,3,Shiho,2847,58,4,4,8,50.0%,32m
19420,1,[anusXX]CaboB,2847,138,3,6,9,33.3%,29m
19420,3,[ZsDrag]DragonZeus,2847,30,2,0,2,100.0%,24m
19420,3,seven,2847,30,2,1,3,66.7%,8m
19420,3,Hope,2847,58,2,1,3,66.7%,3m
19420,3,realisation,2847,30,1,1,2,50.0%,27m
19420,3,Thunder,2847,0,0,1,1,0.0%,1h
19420,3,Zir,2847,0,0,1,1,0.0%,1m
19420,2,llllllllllll,2847,0,0,1,1,0.0%,1h
19420,3,Bulfango,2847,0,0,1,1,0.0%,14m
19420,3,Justus,2847,0,0,2,2,0.0%,15m
19449,1,baltcl,2846,1527,172,166,338,50.9%,25m
19449,2,Shofixti,2846,1601,167,158,325,51.4%,30m
19449,2,[P3R]Georgetown,2846,1035,116,113,229,50.7%,20m
19449,1,[Furryß]TicklishWolf,2846,888,59,70,129,45.7%,29m
19449,3,supnice,2846,650,47,36,83,56.6%,27m
19449,3,mariano,2846,661,44,23,67,65.7%,4m
19449,2,ShroudWalker,2846,467,37,34,71,52.1%,31m
19449,2,[NPhasA]Defamation,2846,215,30,31,61,49.2%,30m
19449,1,sausey,2846,787,27,33,60,45.0%,40m
19449,2,[gotBTC]Revenant,2846,722,25,32,57,43.9%,13m
19449,3,Nox,2846,617,24,17,41,58.5%,3m
19449,3,Anomaly,2846,558,20,20,40,50.0%,22m
19449,2,AndysMOM,2846,522,18,19,37,48.6%,12m
19449,3,bobtubba,2846,442,16,13,29,55.2%,1m
19449,1,[Toast]Flightless,2846,343,12,13,25,48.0%,1h
19449,2,makcre,2846,305,12,13,25,48.0%,15m
19449,2,trreva,2846,320,10,11,21,47.6%,19m
19449,1,OrangeDragon,2846,195,8,7,15,53.3%,12m
19449,2,DelfinMagico,2846,163,5,2,7,71.4%,3h
19449,1,ubixxx,2846,97,4,3,7,57.1%,3h
19449,2,Yenazzi,2846,48,4,3,7,57.1%,14m
19449,3,TheLaw,2846,143,4,4,8,50.0%,33m
19449,3,WayGroovy,2846,145,4,5,9,44.4%,19m
19449,1,Pacer,2846,0,3,3,6,50.0%,27m
19449,1,Catlubber,2846,0,3,3,6,50.0%,3h
19449,3,MpK,2846,30,2,1,3,66.7%,20m
19449,3,Pseudolife,2846,30,1,3,4,25.0%,36m
19449,1,[Kalra]Angelic,2846,0,1,5,6,16.7%,3h
19449,3,Moopyloser,2846,0,0,1,1,0.0%,3m
19478,2,sonra,2845,1586,236,233,469,50.3%,30m
19478,1,[LOHs]goOda,2845,1611,223,198,421,53.0%,29m
19478,2,Realism,2845,1323,90,68,158,57.0%,14m
19478,3,[UpxV]DMD,2845,1164,82,85,167,49.1%,8m
19478,2,Nuclear,2845,1449,62,53,115,53.9%,11m
19478,2,[MoSun]kiatigers,2845,1177,59,48,107,55.1%,7m
19478,2,[cl0udM]chris,2845,965,48,44,92,52.2%,18m
19478,3,KernelPanic,2845,866,39,22,61,63.9%,5m
19478,2,DeKu,2845,787,34,37,71,47.9%,4m
19478,3,BlackStar,2845,794,32,26,58,55.2%,26m
19478,1,Sherocko,2845,742,27,32,59,45.8%,18m
19478,2,PIPELON,2845,551,26,14,40,65.0%,40m
19478,1,Jakknife,2845,606,20,32,52,38.5%,11m
19478,2,NotSteve,2845,435,18,14,32,56.2%,35m
19478,2,SCV,2845,212,10,7,17,58.8%,14m
19478,3,Techko,2845,226,9,14,23,39.1%,12m
19478,3,DYLue,2845,196,8,4,12,66.7%,19m
19478,1,[hTx]ColdSC,2845,185,8,8,16,50.0%,25m
19478,3,Sironimo,2845,170,7,6,13,53.8%,46m
19478,1,MagicTerran,2845,64,6,5,11,54.5%,12m
19478,3,lIlIIIlI,2845,146,4,4,8,50.0%,1h
19478,2,[TGCF]Matt,2845,120,4,7,11,36.4%,7m
19478,3,Ronaldo,2845,0,3,2,5,60.0%,31m
19478,3,Erowid,2845,90,3,5,8,37.5%,13m
19478,3,BTitan,2845,122,2,2,4,50.0%,3h
19478,3,Temü,2845,30,2,5,7,28.6%,9m
19478,2,sirfluffy,2845,123,2,8,10,20.0%,5m
19478,3,KiFlo,2845,0,1,0,1,100.0%,40m
19478,3,FrameBonjwa,2845,0,1,0,1,100.0%,25m
19478,3,[ethicc]Yackob,2845,0,1,0,1,100.0%,2m
19478,3,[AbcCo]UnknownStorm,2845,0,1,0,1,100.0%,31m
19478,3,Unsafe,2845,0,1,0,1,100.0%,40m
19478,2,Saladora,2845,0,1,4,5,20.0%,3h
19478,3,DarkFate,2845,0,0,1,1,0.0%,29m
19478,3,Alex,2845,0,0,2,2,0.0%,3m
19478,1,[Ajuna]Indigo,2845,0,0,6,6,0.0%,3h
19514,2,Koda,2844,1548,206,196,402,51.2%,14m
19514,2,[TACOMD]BeefnCheese,2844,1537,103,97,200,51.5%,24m
19514,2,jaku,2844,971,98,83,181,54.1%,8m
19514,2,Ols,2844,1538,77,71,148,52.0%,18m
19514,1,enterovirus,2844,489,66,63,129,51.2%,41m
19514,2,Andrukha,2844,1024,54,53,107,50.5%,18m
19514,3,Marcus,2844,857,44,21,65,67.7%,22m
19514,1,[PTHero]Drizzt,2844,926,44,41,85,51.8%,16m
19514,3,BANjOKAZOOiE,2844,931,43,34,77,55.8%,28m
19514,3,Virus,2844,780,37,20,57,64.9%,29m
19514,2,Mike,2844,491,33,30,63,52.4%,1m
19514,2,[XpKAc]Torosc,2844,678,24,29,53,45.3%,21m
19514,3,[ºEGUº]deleigox,2844,552,21,19,40,52.5%,2m
19514,2,vegatron,2844,320,12,14,26,46.2%,7m
19514,3,BMcFatty,2844,207,6,5,11,54.5%,3h
19514,3,Whrloo,2844,97,5,5,10,50.0%,58m
19514,2,Jake,2844,88,4,1,5,80.0%,11m
19514,2,[EoTD]death,2844,0,3,1,4,75.0%,12m
19514,3,[Might]Shadowmaster,2844,0,3,2,5,60.0%,22m
19514,2,ThethinkerLA,2844,46,3,3,6,50.0%,53m
19514,3,[DFNCÉ]JoeKony,2844,36,2,1,3,66.7%,55m
19514,2,TheAbhorsen,2844,107,2,3,5,40.0%,3h
19514,3,Yesauir,2844,0,2,3,5,40.0%,2m
19514,2,[Yoga1]Kundalini,2844,0,2,4,6,33.3%,24m
19514,3,[Tierra]Olais,2844,0,1,0,1,100.0%,36m
19514,3,sickie,2844,0,0,1,1,0.0%,24m
19514,3,QuBuS,2844,0,0,1,1,0.0%,15m
19541,3,CptBadger,2843,1261,169,151,320,52.8%,2m
19541,1,[Mitsu]IIIIlllIIlIl,2843,1247,56,52,108,51.9%,40m
19541,2,TimmyBurnrs,2843,1154,51,42,93,54.8%,11m
19541,2,[AbcCo]CaritaFeliz,2843,954,37,35,72,51.4%,14m
19541,3,ERWINplateni,2843,956,36,33,69,52.2%,31m
19541,1,[TFinal]MOUNTAINFALL,2843,371,23,17,40,57.5%,28m
19541,2,chingolin,2843,450,19,22,41,46.3%,10m
19541,3,[GeoEng]DrGeotech,2843,354,13,12,25,52.0%,37m
19541,3,[110111]BigMomma,2843,193,8,6,14,57.1%,3h
19541,3,CrazyAsain,2843,193,6,2,8,75.0%,36m
19541,2,heckubiss,2843,95,5,1,6,83.3%,1h
19541,3,Sunnyhundred,2843,60,5,3,8,62.5%,13m
19541,3,Nam,2843,0,4,3,7,57.1%,3h
19541,3,Shurtugal,2843,121,4,4,8,50.0%,36m
19541,3,[GESPA]Economics,2843,0,3,2,5,60.0%,22m
19541,2,[TGCrew]TheLimester,2843,130,3,3,6,50.0%,38m
19541,1,YellowRuby,2843,48,2,2,4,50.0%,3h
19541,3,urbanite,2843,58,2,5,7,28.6%,8m
19541,3,Dengue,2843,0,1,0,1,100.0%,5m
19541,3,DoctorGonzo,2843,30,1,2,3,33.3%,36m
19541,2,lllllllll,2843,0,0,1,1,0.0%,22m
19541,2,Razo,2843,0,0,1,1,0.0%,48m
19541,2,BruceWayne,2843,0,0,6,6,0.0%,5m
19564,2,jwill,2842,790,60,53,113,53.1%,33m
19564,3,WetDreams,2842,737,58,42,100,58.0%,35m
19564,2,Skynet,2842,859,54,44,98,55.1%,7m
19564,2,BloodMood,2842,488,21,15,36,58.3%,11m
19564,1,[RAMPER]Berserker,2842,185,20,19,39,51.3%,16m
19564,2,Jat,2842,378,17,21,38,44.7%,12m
19564,1,OpWaNaGeThY,2842,507,16,23,39,41.0%,40m
19564,1,Mafiosis,2842,372,14,10,24,58.3%,57m
19564,3,[AbcCo]BlackScorpio,2842,283,12,3,15,80.0%,34m
19564,2,[NoBads]tfp,2842,265,10,6,16,62.5%,18m
19564,3,[RSoBS]Ilich,2842,258,10,7,17,58.8%,8m
19564,3,[VoF]ZealotRQ,2842,265,8,20,28,28.6%,21m
19564,1,dlpjdlpj,2842,260,7,6,13,53.8%,3h
19564,2,[XPN]PainKiller,2842,46,5,1,6,83.3%,40m
19564,2,Juy,2842,168,5,5,10,50.0%,33m
19564,2,cLouDeaD,2842,148,5,9,14,35.7%,19m
19564,2,[Exper]elvikingo,2842,118,4,2,6,66.7%,7m
19564,3,MARTINEZ,2842,0,2,0,2,100.0%,23m
19564,3,MiLO,2842,30,2,0,2,100.0%,1m
19564,3,starhunter,2842,60,2,2,4,50.0%,33m
19564,3,[HBeavs]Cai,2842,0,1,3,4,25.0%,43m
19564,2,jomonroe,2842,0,1,3,4,25.0%,18m
19564,3,psimonkey,2842,0,0,1,1,0.0%,18m
19564,3,Tatoks,2842,0,0,1,1,0.0%,29m
19564,3,LeV,2842,0,0,1,1,0.0%,11m
19564,3,Sterben,2842,0,0,1,1,0.0%,39m
19564,3,DavidUnidad,2842,0,0,1,1,0.0%,24m
19564,2,Zolets,2842,0,0,4,4,0.0%,10m
19592,3,TMiler,2841,1569,286,270,556,51.4%,20m
19592,1,superdd,2841,978,207,205,412,50.2%,12m
19592,1,skan,2841,1519,164,158,322,50.9%,35m
19592,3,AbsoluteKill,2841,1481,57,70,127,44.9%,15m
19592,3,PUMAPOWER,2841,749,54,51,105,51.4%,37m
19592,3,Frank,2841,693,30,24,54,55.6%,39m
19592,3,fooliodoolio,2841,572,23,15,38,60.5%,35m
19592,2,BzKTab,2841,542,21,25,46,45.7%,4m
19592,3,McOri,2841,337,17,20,37,45.9%,8m
19592,2,[BrnchB]BorderRazer,2841,312,16,16,32,50.0%,13m
19592,1,Cyclo,2841,48,4,4,8,50.0%,3h
19592,3,Azgalor,2841,58,2,1,3,66.7%,1m
19592,1,shadow,2841,48,2,2,4,50.0%,3h
19592,1,DataTime,2841,48,2,3,5,40.0%,1h
19592,3,speedyss,2841,0,1,0,1,100.0%,33m
19592,3,jorgezno,2841,34,1,1,2,50.0%,2h
19592,3,[F7E]myrmiKen,2841,0,1,2,3,33.3%,35m
19592,1,Zupper,2841,0,1,6,7,14.3%,54m
19592,3,Mondragon,2841,0,0,1,1,0.0%,37m
19592,3,ELDEVE,2841,0,0,1,1,0.0%,2h
19592,3,curlz,2841,0,0,1,1,0.0%,42m
19592,3,[Jointz]Matt,2841,0,0,2,2,0.0%,24m
19592,3,CrazyCat,2841,0,0,3,3,0.0%,1h
19615,2,Shul,2840,870,62,63,125,49.6%,31m
19615,2,Sgcairús,2840,396,57,40,97,58.8%,21m
19615,2,[503ES]cazador,2840,972,42,36,78,53.8%,30m
19615,2,nemesis,2840,435,27,32,59,45.8%,14m
19615,2,IIIIIIIIIIII,2840,494,26,34,60,43.3%,19m
19615,3,Jhologan,2840,628,22,22,44,50.0%,39m
19615,3,[SHLA]PartinG,2840,427,15,11,26,57.7%,2m
19615,3,abe,2840,341,14,13,27,51.9%,8m
19615,3,Nameless,2840,166,7,2,9,77.8%,9m
19615,3,Pejelargarto,2840,176,6,7,13,46.2%,28m
19615,1,[AlIin]Warlord,2840,216,5,18,23,21.7%,10m
19615,3,Meticulous,2840,125,4,7,11,36.4%,3h
19615,2,[BNJWA]NuclearTaco,2840,130,3,2,5,60.0%,19m
19615,3,WilliamIce,2840,86,3,3,6,50.0%,39m
19615,2,IRONMAN,2840,0,3,3,6,50.0%,19m
19615,3,FrostBird,2840,90,3,5,8,37.5%,37m
19615,3,ARDENTIX,2840,94,2,1,3,66.7%,27m
19615,3,Hellpyro,2840,0,2,2,4,50.0%,33m
19615,2,Hestia,2840,88,2,2,4,50.0%,31m
19615,1,[roclan]Metabaron,2840,48,2,6,8,25.0%,2h
19615,3,[OND]VampLord,2840,0,1,0,1,100.0%,26m
19615,2,[PELO]Cots,2840,0,1,1,2,50.0%,3h
19615,3,Asimov,2840,30,1,1,2,50.0%,27m
19615,3,[JUIC3Y]Bean,2840,30,1,2,3,33.3%,24m
19615,3,DiscountMule,2840,30,1,2,3,33.3%,31m
19615,3,[UofC]BigBeniir,2840,30,1,3,4,25.0%,10m
19615,1,EnderElderU,2840,94,1,3,4,25.0%,10m
19615,3,RaynorsRaid,2840,0,1,4,5,20.0%,32m
19615,3,Mahavishnu,2840,0,0,1,1,0.0%,29m
19615,3,[Macac0]Armisael,2840,0,0,1,1,0.0%,31m
19645,2,[M1A5]AbsintheNova,2839,1563,327,313,640,51.1%,11m
19645,1,[GGMESP]zZslenyerZz,2839,1583,160,156,316,50.6%,40m
19645,2,[BQB]BaleiaDumba,2839,1610,85,78,163,52.1%,30m
19645,2,BlanQ,2839,662,77,61,138,55.8%,17m
19645,3,[KiMBR]TASSADAR,2839,1235,69,53,122,56.6%,33m
19645,3,GoldenTlair,2839,1066,48,67,115,41.7%,6m
19645,3,HawK,2839,1233,46,43,89,51.7%,36m
19645,3,[GOPERÚ]LORKAOS,2839,860,40,19,59,67.8%,19m
19645,3,nomad,2839,888,34,29,63,54.0%,26m
19645,2,BarCode,2839,455,16,19,35,45.7%,33m
19645,2,RoyalPro,2839,362,14,12,26,53.8%,11m
19645,2,[Juneau]Chances,2839,293,11,10,21,52.4%,38m
19645,3,Sorry,2839,192,8,12,20,40.0%,3m
19645,2,Duzkboy,2839,238,8,14,22,36.4%,13m
19645,2,Xxpandaking,2839,210,7,10,17,41.2%,31m
19645,1,[GOPES]Hobbitstyle,2839,204,6,1,7,85.7%,3h
19645,2,booyea,2839,154,5,5,10,50.0%,40m
19645,3,[ZotZ]Cou,2839,114,5,5,10,50.0%,28m
19645,3,[EtrOy]Teppo,2839,131,5,6,11,45.5%,55m
19645,2,houseoftang,2839,118,4,8,12,33.3%,30m
19645,3,[BoAVN]CCnight,2839,90,3,3,6,50.0%,5m
19645,2,Knohart,2839,0,3,3,6,50.0%,35m
19645,1,FxcKenBEAST,2839,118,3,15,18,16.7%,31m
19645,3,DAVISITO,2839,30,2,0,2,100.0%,22m
19645,3,dabarbs,2839,0,1,0,1,100.0%,25m
19645,1,Maclaren,2839,0,1,2,3,33.3%,3h
19645,1,[AMKSS]zenny,2839,88,1,2,3,33.3%,3h
19645,2,ALottaDamage,2839,0,1,4,5,20.0%,16m
19645,2,GGWP,2839,0,1,5,6,16.7%,18m
19645,3,[SCTues]patch,2839,0,0,1,1,0.0%,10m
19645,3,frogician,2839,0,0,1,1,0.0%,38m
19645,3,Vilkai,2839,0,0,2,2,0.0%,33m
19677,1,[Dab710]KingDeuce,2838,1589,156,168,324,48.1%,27m
19677,2,Dominator,2838,1336,66,65,131,50.4%,10m
19677,2,FFCBooid,2838,1084,45,36,81,55.6%,14m
19677,3,pomello,2838,850,30,32,62,48.4%,25m
19677,1,IamTheBoss,2838,816,29,32,61,47.5%,14m
19677,3,Marvelous,2838,331,16,5,21,76.2%,19m
19677,2,MaiPai,2838,403,15,14,29,51.7%,13m
19677,3,IamWater,2838,348,13,5,18,72.2%,23m
19677,1,AlCrotz,2838,324,13,16,29,44.8%,2m
19677,2,FrostyMourne,2838,356,12,18,30,40.0%,13m
19677,3,Skittles,2838,278,11,9,20,55.0%,21m
19677,2,[SMRT]OoObernOOb,2838,258,9,12,21,42.9%,16m
19677,2,DAVID,2838,254,9,14,23,39.1%,11m
19677,2,Rathias,2838,197,8,8,16,50.0%,24m
19677,1,SteamedRice,2838,96,5,6,11,45.5%,3h
19677,1,Vezon,2838,125,4,2,6,66.7%,1h
19677,3,[WNTRCH]Broomhill,2838,120,4,7,11,36.4%,22m
19677,3,Sean,2838,0,1,1,2,50.0%,42m
19677,3,[GRNSKN]Lurker,2838,30,1,6,7,14.3%,24m
19677,3,SpaceWolf,2838,0,0,1,1,0.0%,7m
19677,1,Confetti,2838,0,0,1,1,0.0%,3h
19677,3,KimJongNuke,2838,0,0,2,2,0.0%,26m
19699,2,BernieForPrz,2837,1353,278,258,536,51.9%,17m
19699,1,[USOMAD]NameHere,2837,1375,119,116,235,50.6%,27m
19699,2,Replay,2837,1461,107,76,183,58.5%,14m
19699,2,SOVEREIGN,2837,1096,81,62,143,56.6%,17m
19699,2,[RaZerz]coltfourfive,2837,1283,79,67,146,54.1%,2m
19699,2,[STBs54]magasho,2837,1265,69,58,127,54.3%,32m
19699,1,Alex,2837,1490,59,58,117,50.4%,22m
19699,3,Zhef,2837,585,58,26,84,69.0%,23m
19699,3,poodoo,2837,1116,45,38,83,54.2%,16m
19699,2,Visionz,2837,953,39,34,73,53.4%,7m
19699,2,[P1ZZ4]CptnCouch,2837,737,33,25,58,56.9%,25m
19699,3,XEnviadoX,2837,313,33,43,76,43.4%,36m
19699,2,ThirdEye,2837,501,26,24,50,52.0%,42m
19699,3,StRiFe,2837,518,19,19,38,50.0%,7m
19699,2,Bisu,2837,434,16,21,37,43.2%,17m
19699,3,Mahiron,2837,283,11,4,15,73.3%,19m
19699,3,xJugGernautx,2837,276,10,9,19,52.6%,21m
19699,3,Nateychan,2837,166,6,7,13,46.2%,35m
19699,2,DavSer,2837,92,4,7,11,36.4%,20m
19699,3,TheCarlosMan,2837,58,3,2,5,60.0%,21m
19699,3,ShaggyLlama,2837,58,3,5,8,37.5%,19m
19699,3,[ARCsc2]Wrynn,2837,58,2,1,3,66.7%,29m
19699,3,RageSpectre,2837,60,2,5,7,28.6%,42m
19699,3,[Macac0]juangoil,2837,0,1,0,1,100.0%,19m
19699,2,KiRa,2837,0,1,0,1,100.0%,25m
19699,3,faite,2837,0,1,2,3,33.3%,39m
19699,3,[HBNC]puddlez,2837,30,1,3,4,25.0%,16m
19699,2,AsseT,2837,30,1,8,9,11.1%,4m
19699,2,Erubu,2837,0,0,1,1,0.0%,11m
19728,3,Redaction,2836,1625,287,270,557,51.5%,21m
19728,2,cnnn,2836,1367,88,87,175,50.3%,13m
19728,3,madek,2836,1361,85,64,149,57.0%,21m
19728,3,CptCantelope,2836,1611,80,74,154,51.9%,3m
19728,3,samytheth,2836,1595,77,62,139,55.4%,25m
19728,1,[OPMs]galayS,2836,673,53,56,109,48.6%,21m
19728,2,[dlk5]mrmoses,2836,993,47,48,95,49.5%,21m
19728,3,SpiderMonkey,2836,693,40,33,73,54.8%,26m
19728,3,sweet,2836,450,37,29,66,56.1%,1m
19728,2,WebCorno,2836,379,19,9,28,67.9%,12m
19728,2,Mhao,2836,462,19,18,37,51.4%,8m
19728,2,Fortune,2836,492,17,23,40,42.5%,20m
19728,2,GalaxyBrain,2836,175,12,10,22,54.5%,11m
19728,2,oscid,2836,304,12,15,27,44.4%,16m
19728,3,Ward,2836,275,11,12,23,47.8%,40m
19728,3,crossmity,2836,183,10,8,18,55.6%,18m
19728,3,fooliodoolio,2836,144,5,4,9,55.6%,1m
19728,3,itsatrap,2836,152,3,5,8,37.5%,22m
19728,2,Chime,2836,128,3,5,8,37.5%,7m
19728,3,lllllllllll,2836,0,2,3,5,40.0%,7m
19728,3,Toothpaste,2836,0,1,0,1,100.0%,36m
19728,3,[Wat3rs]Colder,2836,30,1,3,4,25.0%,16m
19728,3,[CLord]Hammer,2836,30,1,4,5,20.0%,27m
19728,3,chippedstick,2836,0,0,1,1,0.0%,16m
19728,3,[TeamDE]BOSSNAGGA,2836,0,0,1,1,0.0%,37m
19728,3,[VEoC]Goehle,2836,0,0,1,1,0.0%,16m
19728,3,[HvnDvl]Ekho,2836,0,0,1,1,0.0%,22m
19755,2,[SCX2]CRIAGarm,2835,1539,150,139,289,51.9%,1m
19755,2,WashNMachine,2835,1374,135,116,251,53.8%,31m
19755,1,PUNKXISTA,2835,1566,131,136,267,49.1%,13m
19755,2,[EpicG]Davirex,2835,1398,105,100,205,51.2%,40m
19755,2,[Makia]ChuckNorris,2835,1246,84,85,169,49.7%,22m
19755,3,Leviathan,2835,1544,68,66,134,50.7%,16m
19755,2,PutinsNipple,2835,1558,62,67,129,48.1%,11m
19755,3,MashedPotato,2835,1323,55,46,101,54.5%,26m
19755,2,Gnome,2835,589,42,43,85,49.4%,2m
19755,1,[DhZPro]Rhapsody,2835,874,39,36,75,52.0%,12m
19755,3,wildstar,2835,488,37,27,64,57.8%,17m
19755,1,ikeeya,2835,886,30,39,69,43.5%,12m
19755,2,Ozzy,2835,515,22,18,40,55.0%,21m
19755,2,tommy,2835,361,16,19,35,45.7%,30m
19755,2,BloodTitan,2835,382,13,17,30,43.3%,10m
19755,3,BobGraham,2835,258,11,7,18,61.1%,29m
19755,2,[TROP]Usuario,2835,315,10,10,20,50.0%,10m
19755,3,Dawse,2835,266,9,6,15,60.0%,31m
19755,1,hasaghe,2835,30,6,3,9,66.7%,25m
19755,3,[INextI]sirlorddavid,2835,168,6,5,11,54.5%,20m
19755,3,ttt,2835,170,6,6,12,50.0%,22m
19755,3,Phnetty,2835,126,5,2,7,71.4%,32m
19755,3,DeathDragon,2835,0,4,1,5,80.0%,14m
19755,2,Maximus,2835,116,4,11,15,26.7%,7m
19755,3,[ZTemp]GameofDrones,2835,60,3,1,4,75.0%,8m
19755,3,Dionysus,2835,0,3,2,5,60.0%,16m
19755,3,DrSeuss,2835,94,3,3,6,50.0%,33m
19755,3,BakkaBot,2835,30,2,1,3,66.7%,22m
19755,3,Isaac,2835,0,1,0,1,100.0%,42m
19755,3,[SupCli]SupremeJ,2835,0,0,1,1,0.0%,5m
19755,3,DDRCHAMP,2835,0,0,2,2,0.0%,8m
19755,3,GwwwG,2835,0,0,3,3,0.0%,28m
19787,2,[Kixeye]Seek,2834,1078,250,207,457,54.7%,29m
19787,2,Duskjuan,2834,941,112,114,226,49.6%,13m
19787,3,Namu,2834,361,46,33,79,58.2%,31m
19787,2,AnisLee,2834,549,25,22,47,53.2%,21m
19787,3,DirkDiggs,2834,510,19,15,34,55.9%,36m
19787,3,[Pig2]ACGeneral,2834,309,12,13,25,48.0%,28m
19787,2,joemeister,2834,293,10,11,21,47.6%,10m
19787,2,Smiling,2834,114,5,4,9,55.6%,14m
19787,3,[LHdH]Kimblee,2834,86,4,1,5,80.0%,3m
19787,1,AlphaWolf,2834,97,4,3,7,57.1%,3h
19787,2,Tassadar,2834,48,3,3,6,50.0%,3h
19787,3,[awa666]ElGatako,2834,58,2,2,4,50.0%,32m
19787,2,Troy,2834,60,2,6,8,25.0%,14m
19787,3,[GNXPOP]Aífe,2834,0,1,0,1,100.0%,27m
19787,3,[Dnwlkr]NikoXD,2834,30,1,2,3,33.3%,15m
19787,2,[Stigma]BouncyBear,2834,30,1,3,4,25.0%,16m
19787,3,SpOOkyCraul,2834,0,0,1,1,0.0%,39m
19787,2,[IVB]Mookie,2834,0,0,2,2,0.0%,1h
19787,3,[BADMFS]Technodynamc,2834,0,0,2,2,0.0%,23m
19806,3,CosmicTurtle,2833,1610,156,121,277,56.3%,7m
19806,2,Olorin,2833,857,128,93,221,57.9%,40m
19806,2,[UpxV]RealSC,2833,1448,62,49,111,55.9%,17m
19806,3,[SN3KS]andLadders,2833,375,54,46,100,54.0%,22m
19806,2,Vegeta,2833,428,37,30,67,55.2%,31m
19806,2,bishop,2833,456,32,29,61,52.5%,12m
19806,2,MAGAfakevote,2833,819,31,30,61,50.8%,25m
19806,1,[Makia]ChuckNorris,2833,768,26,39,65,40.0%,14m
19806,2,McSweetness,2833,692,24,31,55,43.6%,7m
19806,1,Ludaman,2833,678,22,30,52,42.3%,7m
19806,2,Luckyflux,2833,438,17,19,36,47.2%,15m
19806,2,Kwongz,2833,331,14,19,33,42.4%,7m
19806,3,Bluntmaster,2833,384,13,15,28,46.4%,12m
19806,2,PeiPei,2833,124,7,2,9,77.8%,41m
19806,1,CusTrain,2833,97,5,2,7,71.4%,3h
19806,3,WildCupcake,2833,113,5,4,9,55.6%,15m
19806,1,ILoveMath,2833,116,5,6,11,45.5%,41m
19806,3,Speck,2833,50,4,1,5,80.0%,18m
19806,3,Zambowskie,2833,121,3,0,3,100.0%,1h
19806,1,DontSleep,2833,0,3,3,6,50.0%,24m
19806,2,NoseBlow,2833,94,3,7,10,30.0%,13m
19806,3,[RVNSBL]PakJungHe,2833,30,2,3,5,40.0%,1m
19806,3,ghostTT,2833,60,2,4,6,33.3%,32m
19806,1,StreamZZang,2833,0,2,5,7,28.6%,4m
19806,3,[DSEZPZ]Clique,2833,0,1,0,1,100.0%,41m
19806,2,[GOPERÚ]Silver,2833,0,1,4,5,20.0%,7m
19806,1,Hex,2833,0,0,1,1,0.0%,48m
19806,3,Jaguaticrazy,2833,0,0,1,1,0.0%,22m
19806,3,antisatsuma,2833,0,0,1,1,0.0%,3m
19835,1,MeNaS,2832,1609,196,193,389,50.4%,30m
19835,3,Worldchanger,2832,1640,156,133,289,54.0%,42m
19835,3,Jundie,2832,1495,131,124,255,51.4%,15m
19835,1,TillySmack,2832,1378,84,85,169,49.7%,26m
19835,2,arkitekt,2832,985,65,74,139,46.8%,7m
19835,3,NoxPanthera,2832,1290,48,47,95,50.5%,32m
19835,3,Vagitarian,2832,800,37,41,78,47.4%,19m
19835,3,KaiGreene,2832,791,35,20,55,63.6%,14m
19835,1,[Taasty]Cocothunda,2832,498,21,30,51,41.2%,3m
19835,2,milckie,2832,216,15,15,30,50.0%,19m
19835,2,Esen,2832,409,14,17,31,45.2%,16m
19835,3,OverZero,2832,247,10,7,17,58.8%,8m
19835,3,PapuGuapu,2832,279,9,6,15,60.0%,40m
19835,3,KusHbd,2832,238,8,7,15,53.3%,27m
19835,3,irCasper,2832,120,5,5,10,50.0%,40m
19835,2,SHJ,2832,141,4,1,5,80.0%,3h
19835,3,platykiller,2832,53,3,2,5,60.0%,5m
19835,2,Sety,2832,142,3,6,9,33.3%,11m
19835,3,fizzwiththiz,2832,60,2,4,6,33.3%,37m
19835,3,Warlord,2832,0,1,1,2,50.0%,13m
19835,3,[TERRlS]Supay,2832,30,1,1,2,50.0%,7m
19835,3,ProTerrZer,2832,30,1,2,3,33.3%,30m
19835,3,Bulletcradle,2832,0,0,1,1,0.0%,5m
19835,3,bLeepBLOOp,2832,0,0,1,1,0.0%,41m
19835,3,RoBoT,2832,0,0,2,2,0.0%,39m
19835,1,sickviscious,2832,0,0,2,2,0.0%,1h
19835,2,ribo,2832,0,0,6,6,0.0%,40m
19862,2,Tony,2831,684,183,161,344,53.2%,40m
19862,2,Sabbath,2831,1288,81,72,153,52.9%,4m
19862,2,Brady,2831,807,81,73,154,52.6%,14m
19862,3,Fleischchääs,2831,596,63,78,141,44.7%,19m
19862,3,josephweed,2831,1222,61,44,105,58.1%,38m
19862,1,[BatCav]BatMan,2831,1247,46,57,103,44.7%,30m
19862,3,fxdx,2831,920,37,31,68,54.4%,37m
19862,2,Timousse,2831,532,37,36,73,50.7%,11m
19862,3,[1for2]Billgates,2831,807,35,22,57,61.4%,13m
19862,2,[SBoys]LoboDroid,2831,726,31,29,60,51.7%,4m
19862,3,LiebreLunar,2831,670,26,21,47,55.3%,14m
19862,2,GiftFrmKevin,2831,354,13,18,31,41.9%,19m
19862,3,Hatchet,2831,301,11,5,16,68.8%,40m
19862,2,[LATERs]EAGames,2831,149,9,9,18,50.0%,11m
19862,3,HANS,2831,144,6,4,10,60.0%,5m
19862,3,llScorPionll,2831,189,5,3,8,62.5%,3m
19862,3,[IGeaL]Wuiishoo,2831,0,4,1,5,80.0%,23m
19862,3,SergeantVang,2831,86,3,1,4,75.0%,40m
19862,2,PvtJoker,2831,114,3,3,6,50.0%,2m
19862,2,SirKibbleX,2831,0,3,3,6,50.0%,27m
19862,3,Potjack,2831,30,2,2,4,50.0%,27m
19862,2,Dubstep,2831,0,2,3,5,40.0%,1h
19862,3,Vangrel,2831,60,2,4,6,33.3%,26m
19862,3,Marshall,2831,0,1,0,1,100.0%,33m
19862,2,[BUTTE]KilgoreTrout,2831,0,1,1,2,50.0%,3h
19862,3,FlyBoy,2831,92,1,1,2,50.0%,34m
19862,3,[Sc2Maf]DoctorNut,2831,0,1,2,3,33.3%,24m
19862,1,WHAT,2831,0,1,4,5,20.0%,23m
19862,3,[EDMxxx]MrWaffels,2831,0,0,1,1,0.0%,49m
19862,2,goliad,2831,0,0,4,4,0.0%,30m
19892,1,CABEPAO,2830,1608,498,490,988,50.4%,20m
19892,2,Tess,2830,1555,309,298,607,50.9%,7m
19892,1,guerokno,2830,1573,225,223,448,50.2%,36m
19892,2,Badger,2830,1521,121,123,244,49.6%,13m
19892,2,[AbcCo]papibatman,2830,1484,105,81,186,56.5%,24m
19892,2,Billberto,2830,1573,98,87,185,53.0%,11m
19892,3,[dGreat]CloudGamer,2830,1633,93,79,172,54.1%,39m
19892,3,Chazbot,2830,1249,54,42,96,56.2%,3m
19892,2,elperron,2830,784,47,46,93,50.5%,7m
19892,2,AussieCat,2830,571,27,22,49,55.1%,17m
19892,3,DoubleD,2830,522,23,15,38,60.5%,19m
19892,2,NIUHURRU,2830,512,18,24,42,42.9%,13m
19892,3,[OPbois]liltrump,2830,450,17,10,27,63.0%,42m
19892,2,[HGDO]ColdHands,2830,394,14,16,30,46.7%,27m
19892,1,ZeiiN,2830,384,12,20,32,37.5%,38m
19892,2,Dahlmann,2830,249,10,22,32,31.2%,32m
19892,1,Mindtaker,2830,233,7,5,12,58.3%,34m
19892,3,Energie,2830,217,7,7,14,50.0%,2m
19892,3,LeBas,2830,190,6,1,7,85.7%,32m
19892,3,Anandamide,2830,146,6,5,11,54.5%,40m
19892,3,Maverik,2830,132,6,7,13,46.2%,24m
19892,1,Arios,2830,210,5,2,7,71.4%,20m
19892,3,Cat,2830,114,5,2,7,71.4%,32m
19892,1,[TBUDS]Ninja,2830,0,3,3,6,50.0%,3h
19892,3,uzer,2830,86,3,5,8,37.5%,23m
19892,3,Blackwasp,2830,30,2,1,3,66.7%,28m
19892,3,[αXLa]Mabels,2830,30,2,2,4,50.0%,12m
19892,3,MataMuta,2830,94,2,4,6,33.3%,25m
19892,3,PoundingDeer,2830,30,1,1,2,50.0%,16m
19892,3,[VtBoot]DaZerganator,2830,30,1,1,2,50.0%,33m
19892,3,ComeWhatMay,2830,30,1,1,2,50.0%,3m
19892,3,[ZFGODZ]KiLey,2830,0,0,1,1,0.0%,18m
19892,3,Python,2830,0,0,1,1,0.0%,40m
19892,3,Rafa,2830,0,0,3,3,0.0%,16m
19892,1,[LuVz]TheThigh,2830,0,0,7,7,0.0%,3h
19927,1,Raptor,2829,1668,118,119,237,49.8%,29m
19927,3,KirbyAu,2829,886,102,94,196,52.0%,38m
19927,2,grassula,2829,861,45,41,86,52.3%,16m
19927,3,Demael,2829,876,42,61,103,40.8%,27m
19927,1,Sonnar,2829,1162,40,53,93,43.0%,37m
19927,3,warriorheart,2829,830,31,30,61,50.8%,15m
19927,2,espartaco,2829,616,29,29,58,50.0%,6m
19927,1,NEsmha,2829,499,27,38,65,41.5%,9m
19927,2,soljax,2829,631,22,23,45,48.9%,15m
19927,3,[BGPP]ObiwanKenedy,2829,359,15,3,18,83.3%,31m
19927,2,Wildfire,2829,395,15,17,32,46.9%,42m
19927,3,ZzimmerR,2829,242,9,7,16,56.2%,8m
19927,1,kingstar,2829,268,9,18,27,33.3%,29m
19927,3,[guffaw]izniknok,2829,74,6,6,12,50.0%,34m
19927,3,llllllllllll,2829,60,6,7,13,46.2%,32m
19927,2,Izaon,2829,148,6,9,15,40.0%,2m
19927,2,Behemoth,2829,90,6,10,16,37.5%,21m
19927,2,[CRU5H]SedAwk,2829,122,5,8,13,38.5%,13m
19927,3,WirdNah,2829,88,4,2,6,66.7%,18m
19927,3,lllllllllll,2829,114,4,5,9,44.4%,32m
19927,3,McPechugas,2829,58,3,2,5,60.0%,14m
19927,3,SirTuna,2829,88,3,3,6,50.0%,36m
19927,1,Nickname,2829,0,3,3,6,50.0%,23m
19927,2,Infected,2829,86,3,9,12,25.0%,40m
19927,2,[Vrmin]SamZwDFine,2829,88,2,0,2,100.0%,1h
19927,3,[MSet]tomzZor,2829,120,2,3,5,40.0%,20m
19927,3,[sjstm]JoshieInGold,2829,60,2,3,5,40.0%,26m
19927,3,[TgAg]ItsRichieBTW,2829,58,2,3,5,40.0%,36m
19927,1,[WNTRLY]Athol,2829,0,1,0,1,100.0%,33m
19927,3,KKnD,2829,0,1,0,1,100.0%,3m
19927,3,CptSand,2829,30,1,1,2,50.0%,2m
19927,1,Swell,2829,0,1,1,2,50.0%,3h
19927,3,EarthII,2829,0,1,2,3,33.3%,3m
19927,3,ThePinkHippo,2829,0,1,2,3,33.3%,28m
19927,2,Anka,2829,88,1,2,3,33.3%,3h
19927,2,hdnfdq,2829,30,1,8,9,11.1%,26m
19927,3,Velocitas,2829,0,0,1,1,0.0%,3m
19927,3,[Eagls]Hugo,2829,0,0,1,1,0.0%,22m
19927,3,[Dac]Rommelfoxx,2829,0,0,1,1,0.0%,36m
19927,3,Cavadrio,2829,0,0,2,2,0.0%,27m
19927,3,TheLeyend,2829,0,0,3,3,0.0%,8m
19968,2,Javelin,2828,1185,254,230,484,52.5%,31m
19968,2,Superman,2828,1529,155,147,302,51.3%,13m
19968,2,Atom,2828,1449,129,119,248,52.0%,20m
19968,3,BigBang,2828,491,111,87,198,56.1%,11m
19968,1,SkillGame,2828,1239,68,74,142,47.9%,31m
19968,2,[GTWITM]RAZzER,2828,454,55,56,111,49.5%,14m
19968,3,FRANZ,2828,1239,48,67,115,41.7%,24m
19968,2,Torch,2828,443,18,17,35,51.4%,41m
19968,3,[LMI42]MasterBaiter,2828,355,13,5,18,72.2%,27m
19968,3,Iezael,2828,256,10,1,11,90.9%,7m
19968,3,[LMBD]Lambda,2828,214,8,7,15,53.3%,14m
19968,2,MoltKe,2828,260,8,10,18,44.4%,25m
19968,1,MVP,2828,140,6,5,11,54.5%,2h
19968,2,[8282]FLIP,2828,30,5,3,8,62.5%,11m
19968,2,BlackBox,2828,131,5,5,10,50.0%,35m
19968,3,SAKMAIDIK,2828,131,5,5,10,50.0%,22m
19968,2,HateGGONG,2828,142,4,4,8,50.0%,32m
19968,1,[lober]Shadowmeteor,2828,0,3,4,7,42.9%,3h
19968,3,[Thorre]Richard,2828,30,2,0,2,100.0%,32m
19968,3,[LowIQ]GetSmacked,2828,30,2,0,2,100.0%,32m
19968,3,[SOCOMD]Zanven,2828,58,2,1,3,66.7%,41m
19968,1,[XHB]SSB,2828,72,2,5,7,28.6%,40m
19968,3,Death,2828,0,1,0,1,100.0%,16m
19968,2,TheKiest,2828,30,1,5,6,16.7%,6m
19968,2,darthsethius,2828,73,0,2,2,0.0%,38m
19968,3,[MEELX]DuffBeer,2828,0,0,3,3,0.0%,2h
19968,3,[C0oL6]Coolgiaco,2828,0,0,3,3,0.0%,12m
19995,3,SirWilliam,2827,1591,192,177,369,52.0%,16m
19995,2,Maroon,2827,1549,170,156,326,52.1%,20m
19995,2,[DEoC]CkOwnage,2827,1547,91,90,181,50.3%,10m
19995,2,poamt,2827,1209,62,69,131,47.3%,21m
19995,2,[2TETON]AndreiFranca,2827,1089,57,50,107,53.3%,12m
19995,2,Slon,2827,1415,53,52,105,50.5%,27m
19995,3,Arcinacaid,2827,374,14,7,21,66.7%,10m
19995,2,[Chance]Bassicman,2827,285,11,10,21,52.4%,9m
19995,3,Camo,2827,261,9,4,13,69.2%,22m
19995,3,BigWeWe,2827,293,9,6,15,60.0%,36m
19995,3,Acehilm,2827,214,7,3,10,70.0%,42m
19995,3,Skynet,2827,30,4,2,6,66.7%,24m
19995,3,Primevil,2827,108,4,3,7,57.1%,19m
19995,3,MasterChief,2827,114,4,4,8,50.0%,10m
19995,2,FlyingSquid,2827,30,4,4,8,50.0%,27m
19995,3,Circle,2827,116,4,6,10,40.0%,24m
19995,3,RBG,2827,0,3,2,5,60.0%,13m
19995,2,DavidMartin,2827,141,3,3,6,50.0%,3h
19995,1,[2CREW]WhattheDeuce,2827,0,3,4,7,42.9%,3h
19995,3,BigRick,2827,60,3,5,8,37.5%,36m
19995,3,Punisher,2827,30,2,1,3,66.7%,27m
19995,3,drivby,2827,0,1,0,1,100.0%,8m
19995,3,Kinke,2827,0,1,0,1,100.0%,10m
19995,3,fireblaze,2827,30,1,4,5,20.0%,41m
19995,3,[DCS]PARAGONIMUS,2827,0,0,1,1,0.0%,34m
19995,1,[9C]FoxySocks,2827,0,0,1,1,0.0%,46m
19995,3,[LAMMS]Lammy,2827,0,0,1,1,0.0%,18m
20022,3,CMactin,2826,1547,163,177,340,47.9%,4m
20022,1,[XpKAc]Eurotruck,2826,1348,146,143,289,50.5%,29m
20022,2,Brotus,2826,908,143,123,266,53.8%,12m
20022,2,SenArrow,2826,1384,122,116,238,51.3%,11m
20022,3,Dare,2826,1106,85,64,149,57.0%,40m
20022,2,EugeneKim,2826,1118,79,59,138,57.2%,35m
20022,1,[CUKZ]Shorttown,2826,567,25,37,62,40.3%,31m
20022,2,[NPhasA]BenDrummin,2826,568,21,27,48,43.8%,25m
20022,1,[RiseWC]Fistocuffs,2826,566,17,33,50,34.0%,6m
20022,3,IIIIIIIIIIII,2826,311,12,7,19,63.2%,22m
20022,3,heyguy,2826,245,10,7,17,58.8%,23m
20022,3,cancigol,2826,163,8,6,14,57.1%,16m
20022,3,Kmill,2826,235,8,8,16,50.0%,23m
20022,3,Deane,2826,186,6,2,8,75.0%,9m
20022,2,MaxInferno,2826,161,5,8,13,38.5%,12m
20022,2,Antho,2826,85,4,13,17,23.5%,25m
20022,3,BeckNasty,2826,58,2,5,7,28.6%,20m
20022,3,ARIKAOS,2826,0,1,0,1,100.0%,3m
20022,3,[JINGO]Bluecat,2826,0,1,1,2,50.0%,36m
20022,3,ponchomonkey,2826,0,1,1,2,50.0%,42m
20022,1,Amer,2826,0,0,1,1,0.0%,2h
20022,3,Cranky,2826,0,0,1,1,0.0%,3h
20022,3,RoloTron,2826,0,0,3,3,0.0%,41m
20045,2,[GL0CK]Terran,2825,1523,314,308,622,50.5%,35m
20045,3,Skeptic,2825,1491,216,223,439,49.2%,28m
20045,3,[BONES]NightFly,2825,1413,142,143,285,49.8%,28m
20045,1,donito,2825,1601,94,100,194,48.5%,10m
20045,3,Gamelen,2825,1055,45,32,77,58.4%,31m
20045,1,Kohu,2825,365,33,35,68,48.5%,30m
20045,3,marineXD,2825,350,13,6,19,68.4%,11m
20045,2,[Pig2]Whackmeat,2825,348,13,12,25,52.0%,24m
20045,1,cheekycheef,2825,168,6,5,11,54.5%,1h
20045,2,WhiteWolf,2825,167,6,10,16,37.5%,13m
20045,2,clarkritenow,2825,71,5,12,17,29.4%,33m
20045,2,Nomadar,2825,0,4,1,5,80.0%,3h
20045,3,Brad,2825,114,4,3,7,57.1%,31m
20045,3,SEQUEL,2825,86,4,4,8,50.0%,35m
20045,2,Glenn,2825,117,4,4,8,50.0%,37m
20045,3,Karizma,2825,166,4,7,11,36.4%,2m
20045,3,SNooBle,2825,86,3,1,4,75.0%,27m
20045,2,LuckyTerran,2825,0,3,1,4,75.0%,3h
20045,2,Potato,2825,88,3,10,13,23.1%,41m
20045,3,illfingas,2825,119,2,2,4,50.0%,40m
20045,3,[Milkyy]decurion,2825,0,2,3,5,40.0%,24m
20045,2,WolfieRa,2825,48,1,1,2,50.0%,1h
20045,2,[αB]Ifiwereasoup,2825,88,1,5,6,16.7%,8m
20045,3,Valens,2825,0,0,1,1,0.0%,21m
20045,2,[RVSV]Rocha,2825,0,0,1,1,0.0%,3h
20070,2,Jeremy,2824,1665,446,431,877,50.9%,30m
20070,1,Gramz,2824,1604,270,257,527,51.2%,37m
20070,3,goodmen,2824,1472,240,233,473,50.7%,24m
20070,2,Enforcer,2824,1587,213,170,383,55.6%,14m
20070,2,[LMI42]Adam,2824,1552,129,121,250,51.6%,41m
20070,3,lediledi,2824,1282,75,59,134,56.0%,2m
20070,3,[LGL]Siul,2824,1335,54,45,99,54.5%,5m
20070,1,[PTHero]Dex,2824,568,47,55,102,46.1%,37m
20070,2,Birry,2824,480,20,18,38,52.6%,32m
20070,3,bluewhale,2824,514,19,16,35,54.3%,26m
20070,2,Exercise,2824,356,17,11,28,60.7%,13m
20070,2,die,2824,383,16,11,27,59.3%,5m
20070,2,TunerBlack,2824,432,15,20,35,42.9%,7m
20070,1,Tictock,2824,216,14,16,30,46.7%,21m
20070,1,Clamsys,2824,338,12,26,38,31.6%,36m
20070,3,[Ballz]Shachi,2824,213,8,6,14,57.1%,32m
20070,3,Glephnir,2824,171,6,4,10,60.0%,22m
20070,3,[NextDC]Øµßø,2824,86,3,2,5,60.0%,3m
20070,3,Jzaan,2824,135,3,5,8,37.5%,51m
20070,3,GEAR,2824,0,1,0,1,100.0%,35m
20070,1,Dragoon,2824,0,1,2,3,33.3%,3h
20070,2,AlxhemisTxD,2824,0,1,3,4,25.0%,34m
20070,3,Rook,2824,0,0,1,1,0.0%,16m
20093,2,Ziad,2823,1634,298,291,589,50.6%,32m
20093,1,DogOfWar,2823,1614,182,180,362,50.3%,2m
20093,3,ljamericanpa,2823,1622,83,55,138,60.1%,9m
20093,3,[usbr]Broformist,2823,1447,70,43,113,61.9%,32m
20093,2,[FyHr]Elven,2823,1047,46,34,80,57.5%,11m
20093,3,Ramatuscus,2823,685,31,18,49,63.3%,3m
20093,2,Npc,2823,488,19,17,36,52.8%,32m
20093,2,MadMonkeyMan,2823,446,16,23,39,41.0%,14m
20093,3,Geeman,2823,308,11,15,26,42.3%,23m
20093,3,Tom,2823,232,9,6,15,60.0%,11m
20093,2,iTzXxxLimp,2823,261,9,12,21,42.9%,41m
20093,1,NerO,2823,294,9,22,31,29.0%,6m
20093,3,Legalsnowman,2823,221,7,4,11,63.6%,3h
20093,3,Wiverno,2823,133,5,3,8,62.5%,29m
20093,2,Gamma,2823,86,5,5,10,50.0%,26m
20093,3,[PTHero]Subang,2823,187,5,10,15,33.3%,37m
20093,1,Zergolot,2823,61,5,17,22,22.7%,20m
20093,2,Moldetoh,2823,30,4,4,8,50.0%,24m
20093,2,CrunchBerry,2823,0,3,2,5,60.0%,3h
20093,3,DRACO,2823,0,1,0,1,100.0%,19m
20093,3,mojo,2823,30,1,2,3,33.3%,37m
20093,3,dbug,2823,0,1,2,3,33.3%,21m
20093,3,LearnY,2823,0,0,1,1,0.0%,27m
20093,2,Carba,2823,0,0,1,1,0.0%,14m
20093,3,[DKMP]SibekJialat,2823,0,0,1,1,0.0%,4m
20093,3,[GRU]Trippleblack,2823,0,0,3,3,0.0%,24m
20093,2,[S4RK]Rafo,2823,0,0,6,6,0.0%,21m
20120,3,MegaD,2822,1544,206,196,402,51.2%,2m
20120,2,aannddrreess,2822,1448,85,82,167,50.9%,33m
20120,3,Drewbie,2822,1408,85,103,188,45.2%,34m
20120,3,Cryo,2822,370,16,10,26,61.5%,16m
20120,2,EnemyAI,2822,422,16,15,31,51.6%,15m
20120,1,IIIIIIIIIIII,2822,361,15,9,24,62.5%,1h
20120,3,Zero,2822,335,13,14,27,48.1%,29m
20120,2,CivFan,2822,364,13,19,32,40.6%,25m
20120,3,[ViRu5]THRiiLLSHOTz,2822,234,11,3,14,78.6%,3m
20120,2,aldeon,2822,322,11,16,27,40.7%,17m
20120,3,Zero,2822,262,9,5,14,64.3%,17m
20120,2,Cnj,2822,120,8,6,14,57.1%,13m
20120,1,[PvZMa]CONTRA,2822,97,4,4,8,50.0%,1h
20120,3,Foe,2822,86,3,3,6,50.0%,5m
20120,3,[CUBAAA]MrAPM,2822,30,2,0,2,100.0%,10m
20120,3,Kiblijana,2822,30,2,2,4,50.0%,3m
20120,1,KetamineYoda,2822,48,2,3,5,40.0%,50m
20120,3,AssyrianKing,2822,0,1,0,1,100.0%,27m
20120,2,[EZDUNK]PokimaneSimp,2822,0,1,0,1,100.0%,6m
20120,3,OmniKai,2822,93,1,1,2,50.0%,8m
20120,3,Gualter,2822,0,0,1,1,0.0%,8m
20120,3,Drakeor,2822,0,0,1,1,0.0%,3m
20120,3,[BoAVN]SCGaming,2822,0,0,1,1,0.0%,37m
20120,3,BipolarBear,2822,0,0,1,1,0.0%,32m
20120,2,epicwamm,2822,0,0,1,1,0.0%,14m
20145,2,Jeb,2821,841,93,80,173,53.8%,41m
20145,3,Rjae,2821,485,21,14,35,60.0%,41m
20145,1,Darkneos,2821,608,20,32,52,38.5%,14m
20145,2,lilpotatozz,2821,469,18,17,35,51.4%,21m
20145,2,SgtCrow,2821,514,18,20,38,47.4%,40m
20145,2,connor,2821,496,18,21,39,46.2%,10m
20145,3,[1vsM]Setadoon,2821,254,8,5,13,61.5%,39m
20145,3,Fumbles,2821,148,6,6,12,50.0%,2m
20145,3,marmelloh,2821,114,5,1,6,83.3%,8m
20145,3,[Canela]ToribioGamer,2821,109,5,4,9,55.6%,33m
20145,1,Spaz,2821,88,4,4,8,50.0%,13m
20145,3,PCterran,2821,86,3,2,5,60.0%,28m
20145,1,Leverage,2821,0,3,3,6,50.0%,1h
20145,3,Yooky,2821,30,3,3,6,50.0%,7m
20145,3,[2Z1MTV]Tempesta,2821,30,2,0,2,100.0%,22m
20145,3,FALKONDX,2821,60,2,4,6,33.3%,40m
20145,3,Feartheflay,2821,0,1,3,4,25.0%,32m
20145,2,IIIIIIIIIIII,2821,30,1,6,7,14.3%,7m
20145,3,[JaMiT]TrinalG,2821,0,0,1,1,0.0%,4m
20145,3,MiCARUS,2821,0,0,1,1,0.0%,2m
20145,3,Gauss,2821,0,0,1,1,0.0%,42m
20145,3,[LDPro]Numberthree,2821,0,0,5,5,0.0%,3m
20145,2,LogoFive,2821,0,0,6,6,0.0%,30m
20168,3,[bm4Fun]TerranKaren,2820,1468,365,384,749,48.7%,15m
20168,1,babytofu,2820,1170,44,48,92,47.8%,41m
20168,2,Nasm,2820,951,38,38,76,50.0%,9m
20168,2,ARASTAFASTA,2820,798,28,37,65,43.1%,11m
20168,3,Aziris,2820,495,24,26,50,48.0%,37m
20168,3,HereItComes,2820,387,18,9,27,66.7%,7m
20168,3,[2025]fireredeel,2820,377,18,19,37,48.6%,28m
20168,2,Intermittent,2820,443,17,14,31,54.8%,32m
20168,2,rmlolool,2820,140,16,19,35,45.7%,7m
20168,3,Bjornbrandr,2820,266,15,4,19,78.9%,14m
20168,3,Vito,2820,370,14,12,26,53.8%,7m
20168,2,joselun,2820,272,11,11,22,50.0%,37m
20168,3,PinkPony,2820,224,9,6,15,60.0%,19m
20168,3,[xLgNx]SmoKeyX,2820,180,7,9,16,43.8%,36m
20168,2,Worst,2820,174,5,10,15,33.3%,14m
20168,3,Metatron,2820,108,4,3,7,57.1%,26m
20168,1,soju,2820,48,4,4,8,50.0%,1h
20168,3,TheMachine,2820,58,3,0,3,100.0%,6m
20168,2,Destructoid,2820,96,3,3,6,50.0%,47m
20168,3,Goose,2820,94,2,0,2,100.0%,25m
20168,3,[LQV]Asebkuo,2820,58,2,1,3,66.7%,8m
20168,2,[HURSES]Bengi,2820,0,2,3,5,40.0%,1h
20168,2,Teslon,2820,0,2,3,5,40.0%,3h
20168,3,AnungUnRama,2820,94,2,4,6,33.3%,16m
20168,3,ArtofAnti,2820,0,0,1,1,0.0%,2m
20168,3,goulash,2820,0,0,1,1,0.0%,21m
20168,1,TheDankyYoyo,2820,0,0,1,1,0.0%,3h
20168,2,[xRI]Moazzam,2820,0,0,1,1,0.0%,3h
20168,3,noone,2820,0,0,2,2,0.0%,2m
20168,3,Dwyerdorf,2820,0,0,3,3,0.0%,4m
20198,2,Toastie,2819,1354,297,277,574,51.7%,12m
20198,2,JSJD,2819,1592,253,225,478,52.9%,31m
20198,1,iceblack,2819,1600,193,187,380,50.8%,13m
20198,3,Player,2819,740,164,145,309,53.1%,3m
20198,3,Whoeveris,2819,1584,154,132,286,53.8%,17m
20198,2,Antares,2819,1545,110,96,206,53.4%,18m
20198,2,Harry,2819,1579,84,88,172,48.8%,17m
20198,2,Castle,2819,1302,56,58,114,49.1%,11m
20198,3,MemesterOPs,2819,426,47,35,82,57.3%,4m
20198,2,sheep,2819,836,36,42,78,46.2%,7m
20198,2,TJCIII,2819,343,22,21,43,51.2%,17m
20198,3,BrainCrumbs,2819,461,18,11,29,62.1%,14m
20198,3,Falafel,2819,446,17,18,35,48.6%,34m
20198,2,CasCada,2819,282,16,7,23,69.6%,24m
20198,3,Graphic,2819,396,15,14,29,51.7%,4m
20198,2,[AD3C]NoFear,2819,303,11,10,21,52.4%,35m
20198,3,Djota,2819,237,10,6,16,62.5%,38m
20198,2,JOSHUA,2819,179,8,6,14,57.1%,39m
20198,3,Juanette,2819,176,7,8,15,46.7%,3m
20198,3,TeRrAnBeAsT,2819,62,6,8,14,42.9%,13m
20198,2,Generate,2819,114,5,5,10,50.0%,3m
20198,1,Dodgson,2819,194,5,13,18,27.8%,23m
20198,3,Terrano,2819,46,3,0,3,100.0%,18m
20198,3,Hoody,2819,58,2,3,5,40.0%,8m
20198,3,PuertoMontt,2819,30,1,2,3,33.3%,32m
20198,2,Sushi,2819,0,1,4,5,20.0%,3h
20198,3,[UpxV]CarlosG,2819,0,0,1,1,0.0%,1m
20198,3,[Tekes]JeAnViAl,2819,0,0,1,1,0.0%,35m
20198,3,TossYaSalad,2819,0,0,1,1,0.0%,21m
20198,3,[MadK]Fenrir,2819,0,0,2,2,0.0%,21m
20228,1,BigDaddyD,2818,1224,210,209,419,50.1%,21m
20228,3,finessipov,2818,604,57,54,111,51.4%,20m
20228,3,TheProdigal,2818,1309,53,49,102,52.0%,3m
20228,2,AtoTheK,2818,673,51,51,102,50.0%,35m
20228,2,[xLgNx]Orange,2818,764,29,33,62,46.8%,2m
20228,3,[iMkS]WEISSERxWOLF,2818,581,22,15,37,59.5%,35m
20228,3,Nuance,2818,516,22,16,38,57.9%,24m
20228,2,Mathispell,2818,256,21,19,40,52.5%,30m
20228,2,OrLaWaDaaA,2818,80,17,18,35,48.6%,7m
20228,2,[G1K]GuiltyRise,2818,538,17,21,38,44.7%,6m
20228,2,Wobupei,2818,297,12,6,18,66.7%,1h
20228,2,MaRs,2818,262,11,10,21,52.4%,26m
20228,3,WarsBlkGhs,2818,265,9,4,13,69.2%,24m
20228,3,[H0T3R]BlizzGeek,2818,192,9,5,14,64.3%,3h
20228,2,[FalPal]Alchemy,2818,268,8,11,19,42.1%,4m
20228,3,Precision,2818,178,6,4,10,60.0%,27m
20228,3,[jCp]Billiardwolf,2818,183,6,5,11,54.5%,34m
20228,3,anaujiraM,2818,142,6,5,11,54.5%,1m
20228,3,TohsakaRin,2818,0,4,1,5,80.0%,3m
20228,3,[AQM]Tyer,2818,166,4,2,6,66.7%,4m
20228,2,WalrusCow,2818,90,4,8,12,33.3%,33m
20228,2,LucasC,2818,0,3,3,6,50.0%,32m
20228,3,Rodemito,2818,60,2,4,6,33.3%,14m
20228,3,NaClDaddy,2818,30,1,2,3,33.3%,27m
20228,3,[BrNzUP]Tiny,2818,0,0,1,1,0.0%,10m
20228,3,LitrinAzul,2818,0,0,1,1,0.0%,2m
20228,3,JoeBlow,2818,0,0,2,2,0.0%,8m
20228,3,Zeitgeist,2818,0,0,3,3,0.0%,36m
20228,3,Arkadio,2818,0,0,5,5,0.0%,17m
20257,2,DeividCraft,2817,1632,332,329,661,50.2%,7m
20257,3,NRG,2817,1531,178,169,347,51.3%,29m
20257,3,Nhantuna,2817,1575,150,137,287,52.3%,24m
20257,2,IronRome,2817,1569,140,142,282,49.6%,11m
20257,3,BoomBabyBoom,2817,969,99,113,212,46.7%,4m
20257,1,llllllllllll,2817,1383,92,90,182,50.5%,13m
20257,3,Anmdra,2817,1217,63,44,107,58.9%,3m
20257,2,[NoWind]eleven,2817,800,49,47,96,51.0%,16m
20257,2,SaltyClam,2817,623,26,29,55,47.3%,33m
20257,2,Dranos,2817,604,20,29,49,40.8%,31m
20257,2,[ANKL]Ghost,2817,432,19,13,32,59.4%,26m
20257,2,[ScSwrm]laminar,2817,530,18,24,42,42.9%,21m
20257,3,[V3RM]Gustave,2817,420,15,9,24,62.5%,16m
20257,3,henkypenky,2817,329,12,8,20,60.0%,10m
20257,2,Young,2817,268,9,13,22,40.9%,18m
20257,3,[Nuutzz]ToxicJackal,2817,236,8,11,19,42.1%,35m
20257,3,Nattura,2817,127,5,1,6,83.3%,34m
20257,2,DrAcula,2817,152,5,11,16,31.2%,15m
20257,2,[GGWP]Nerofourm,2817,156,5,13,18,27.8%,6m
20257,1,pewy,2817,0,3,3,6,50.0%,3h
20257,3,Adun,2817,90,3,4,7,42.9%,5m
20257,3,[BVRDVR]Spartacan,2817,30,2,0,2,100.0%,32m
20257,3,iNeedAir,2817,88,2,1,3,66.7%,35m
20257,3,[tehbut]Voketo,2817,0,1,0,1,100.0%,40m
20257,3,PaulBlart,2817,0,1,0,1,100.0%,37m
20257,3,[R4NK3D]Chans,2817,30,1,2,3,33.3%,7m
20257,3,bowzr,2817,97,1,4,5,20.0%,1h
20257,3,Nero,2817,0,0,1,1,0.0%,30m
20257,3,Joseph,2817,0,0,1,1,0.0%,24m
20257,3,HeavyCura,2817,0,0,1,1,0.0%,19m
20257,3,HikeGhost,2817,0,0,2,2,0.0%,30m
20257,3,ThickOnigiri,2817,0,0,2,2,0.0%,38m
20257,1,Asdqwdfas,2817,0,0,3,3,0.0%,2h
20257,3,Nergal,2817,0,0,4,4,0.0%,34m
20291,2,Kron,2816,1482,190,188,378,50.3%,20m
20291,1,[DXPCA]more,2816,1512,170,159,329,51.7%,13m
20291,3,[Chibii]USER,2816,1373,105,94,199,52.8%,27m
20291,2,FuzzyFrog,2816,1511,97,95,192,50.5%,11m
20291,2,[GGMESP]Mexidios,2816,1185,94,80,174,54.0%,29m
20291,3,[mijin]HeroScV,2816,1512,91,74,165,55.2%,19m
20291,3,HatePnZcheat,2816,302,71,38,109,65.1%,40m
20291,1,[DXPCA]FJgg,2816,1256,63,70,133,47.4%,16m
20291,3,[Rach]PoisonUrMom,2816,970,39,32,71,54.9%,40m
20291,1,locoboy,2816,706,27,37,64,42.2%,5m
20291,2,ZroXD,2816,451,19,14,33,57.6%,15m
20291,3,[BoAVN]Legosii,2816,176,6,6,12,50.0%,39m
20291,3,KingZ,2816,183,5,2,7,71.4%,15m
20291,3,Fredis,2816,109,4,3,7,57.1%,40m
20291,2,Presidential,2816,48,3,3,6,50.0%,14m
20291,1,DemonMaster,2816,96,2,1,3,66.7%,3h
20291,2,itzmealex,2816,0,1,1,2,50.0%,3h
20291,3,HonokaUwUr,2816,30,1,1,2,50.0%,3m
20291,3,Sillonson,2816,30,1,4,5,20.0%,28m
20291,3,Cuong,2816,0,0,1,1,0.0%,39m
20291,3,[wwoww]shmit,2816,0,0,1,1,0.0%,28m
20291,3,SkyyCaptain,2816,0,0,5,5,0.0%,3m
20313,2,[MalddB]Danomight,2815,1509,163,159,322,50.6%,18m
20313,2,[LowIQ]EvolFighter,2815,1554,91,92,183,49.7%,41m
20313,2,Turtle,2815,596,67,72,139,48.2%,36m
20313,2,[LRND1S]Novic,2815,533,38,36,74,51.4%,6m
20313,1,llllllllllll,2815,218,20,4,24,83.3%,3h
20313,3,Edelweiss,2815,137,5,7,12,41.7%,28m
20313,3,RichardHead,2815,114,4,4,8,50.0%,20m
20313,3,ENTANG,2815,0,3,2,5,60.0%,30m
20313,3,Abraxas,2815,93,3,3,6,50.0%,2m
20313,3,NYCDOT,2815,30,2,1,3,66.7%,36m
20313,3,Asterix,2815,30,2,1,3,66.7%,19m
20313,3,Hawke,2815,30,2,1,3,66.7%,21m
20313,3,CaptainLays,2815,58,2,2,4,50.0%,3m
20313,3,Pirate,2815,30,1,2,3,33.3%,2m
20313,3,gangnamstyle,2815,30,1,2,3,33.3%,39m
20313,2,vegatal,2815,0,1,3,4,25.0%,31m
20313,2,SWATZINATOR,2815,0,0,3,3,0.0%,35m
20313,2,HardBounce,2815,0,0,5,5,0.0%,41m
20313,2,[GlRTH]Dan,2815,0,0,5,5,0.0%,32m
20332,3,weishin,2814,1622,317,303,620,51.1%,19m
20332,2,ChesDale,2814,1435,283,270,553,51.2%,29m
20332,3,Biz,2814,1654,278,252,530,52.5%,27m
20332,2,Bassvantage,2814,1659,162,157,319,50.8%,10m
20332,2,[Exper]Biohazard,2814,1453,156,153,309,50.5%,11m
20332,2,[Dusky]mexorcist,2814,668,67,52,119,56.3%,29m
20332,2,Creager,2814,616,44,19,63,69.8%,13m
20332,2,Cin,2814,815,37,30,67,55.2%,21m
20332,3,WinDriX,2814,788,35,23,58,60.3%,23m
20332,2,Mica,2814,424,25,27,52,48.1%,21m
20332,2,OveThRainbow,2814,678,25,28,53,47.2%,35m
20332,2,First,2814,516,19,20,39,48.7%,17m
20332,2,[FL4]PoCoYo,2814,508,18,19,37,48.6%,11m
20332,3,SonicRush,2814,409,16,11,27,59.3%,32m
20332,2,spartan,2814,438,16,20,36,44.4%,7m
20332,3,Phibonnachee,2814,297,12,7,19,63.2%,1h
20332,2,JuneCloud,2814,278,11,9,20,55.0%,1h
20332,1,DwixSuPerFly,2814,248,10,10,20,50.0%,22m
20332,3,Ricodius,2814,278,10,10,20,50.0%,7m
20332,1,[MCOS]Frutilloso,2814,324,10,20,30,33.3%,14m
20332,3,Gianca,2814,228,9,1,10,90.0%,14m
20332,3,[CHEEKS]Voods,2814,254,9,13,22,40.9%,4m
20332,1,llllllllllll,2814,234,7,5,12,58.3%,3h
20332,3,wiblyspceman,2814,227,7,7,14,50.0%,1h
20332,2,aLordsMobile,2814,94,5,2,7,71.4%,3h
20332,3,[Tyber]albarodrigo,2814,148,5,5,10,50.0%,2m
20332,3,illusion,2814,152,5,7,12,41.7%,40m
20332,3,BOOMBOOM,2814,140,4,1,5,80.0%,15m
20332,1,Pietman,2814,48,4,4,8,50.0%,43m
20332,2,wgeun,2814,30,4,4,8,50.0%,35m
20332,2,JessBess,2814,0,3,3,6,50.0%,6m
20332,3,DarthVaderXD,2814,154,3,4,7,42.9%,23m
20332,3,[papayo]LJAS,2814,30,2,1,3,66.7%,32m
20332,3,ConTroL,2814,30,1,1,2,50.0%,27m
20332,1,[Trlvla]ULayYeMyat,2814,0,1,1,2,50.0%,1h
20332,3,Potoquis,2814,0,1,3,4,25.0%,21m
20332,2,seVeN,2814,88,1,7,8,12.5%,13m
20332,3,jimywins,2814,0,0,1,1,0.0%,11m
20332,3,Wyler,2814,0,0,1,1,0.0%,41m
20332,3,RavenousOne,2814,0,0,1,1,0.0%,20m
20332,2,[DN3]ARTHISTA,2814,0,0,5,5,0.0%,3h
20373,1,[SBoys]Elterranazul,2813,1598,578,575,1153,50.1%,9m
20373,3,[FTLTX]METATRÓN,2813,1487,329,338,667,49.3%,35m
20373,2,SICKBOY,2813,1512,248,222,470,52.8%,27m
20373,3,treviento,2813,1432,156,169,325,48.0%,2m
20373,2,dagogut,2813,994,155,137,292,53.1%,21m
20373,2,Nehc,2813,1514,119,121,240,49.6%,26m
20373,3,Sword,2813,1029,83,81,164,50.6%,24m
20373,3,BuryMeSmilin,2813,1631,67,60,127,52.8%,24m
20373,2,Gus,2813,1429,60,60,120,50.0%,7m
20373,2,[TRETER]Sueltox,2813,773,33,34,67,49.3%,33m
20373,3,[FKYA]ShTouR,2813,147,20,19,39,51.3%,35m
20373,1,SerrA,2813,464,15,22,37,40.5%,20m
20373,3,Colossus,2813,343,12,6,18,66.7%,40m
20373,1,Shadow,2813,316,10,21,31,32.3%,39m
20373,3,bigsauceguy,2813,242,8,11,19,42.1%,18m
20373,3,[PSF]Matik,2813,140,6,5,11,54.5%,4m
20373,3,huhu,2813,157,5,9,14,35.7%,1h
20373,3,Gene,2813,0,4,1,5,80.0%,3m
20373,3,Zannzen,2813,118,4,5,9,44.4%,26m
20373,2,Solace,2813,130,3,6,9,33.3%,12m
20373,3,Seven,2813,58,2,1,3,66.7%,27m
20373,3,[TGosuC]RecoH,2813,30,2,2,4,50.0%,35m
20373,3,doofus,2813,30,2,2,4,50.0%,30m
20373,2,aMan,2813,130,2,3,5,40.0%,48m
20373,3,Zolek,2813,30,2,4,6,33.3%,11m
20373,3,RipSteakface,2813,51,2,5,7,28.6%,46m
20373,3,OffaLion,2813,0,1,1,2,50.0%,1m
20373,3,[KerriS]Smallz,2813,0,0,1,1,0.0%,18m
20373,3,Live,2813,0,0,3,3,0.0%,41m
20402,1,Wolf,2812,1589,266,260,526,50.6%,28m
20402,2,zeckal,2812,1336,76,73,149,51.0%,31m
20402,3,[BGKing]footlettuce,2812,1203,53,45,98,54.1%,13m
20402,2,xFelkos,2812,441,52,34,86,60.5%,7m
20402,3,YelloWood,2812,633,45,31,76,59.2%,23m
20402,2,Goobypls,2812,789,44,44,88,50.0%,10m
20402,1,Dan,2812,1068,42,42,84,50.0%,40m
20402,3,Ddpskizzle,2812,833,36,31,67,53.7%,18m
20402,3,[CBA]ManOfGold,2812,549,33,27,60,55.0%,22m
20402,1,Attila,2812,730,28,30,58,48.3%,38m
20402,3,[iKing]Blue,2812,375,23,16,39,59.0%,10m
20402,3,[OBDT]Sejota,2812,560,23,16,39,59.0%,35m
20402,2,BIFF,2812,263,11,13,24,45.8%,20m
20402,1,[DIDI]didi,2812,185,5,4,9,55.6%,33m
20402,3,Eliteknives,2812,92,4,2,6,66.7%,2m
20402,1,AnthonioRC,2812,95,3,3,6,50.0%,52m
20402,3,[flexed]AIDAN,2812,58,2,3,5,40.0%,16m
20402,3,derickvill,2812,120,2,3,5,40.0%,29m
20402,3,iamcomma,2812,0,1,0,1,100.0%,24m
20402,3,[ØÛ]Noroox,2812,0,1,0,1,100.0%,2m
20402,3,Turkeyfood,2812,0,1,0,1,100.0%,21m
20402,3,[Xpk]yourdead,2812,30,1,1,2,50.0%,13m
20402,3,[0825]LisaCookie,2812,30,1,2,3,33.3%,38m
20402,3,Firzen,2812,0,0,1,1,0.0%,10m
20402,3,[1987]LARGEpete,2812,0,0,2,2,0.0%,24m
20402,3,Avenizy,2812,0,0,2,2,0.0%,39m
20402,3,Twwitchy,2812,0,0,2,2,0.0%,29m
20402,3,[BRTHRS]Boss,2812,0,0,3,3,0.0%,25m
20402,3,Didac,2812,0,0,3,3,0.0%,2m
20431,2,[tutin]Tarantula,2811,1521,228,212,440,51.8%,18m
20431,3,rapscallion,2811,1512,128,125,253,50.6%,30m
20431,2,pirata,2811,1131,93,78,171,54.4%,14m
20431,1,Patsy,2811,1552,71,74,145,49.0%,15m
20431,3,[RngRng]SLeeP,2811,1564,60,57,117,51.3%,2m
20431,3,Romanrat,2811,1217,59,43,102,57.8%,35m
20431,3,DustyHobo,2811,487,58,37,95,61.1%,10m
20431,3,LIGHT,2811,1034,46,33,79,58.2%,6m
20431,2,guevarodrigo,2811,850,33,34,67,49.3%,29m
20431,3,AlanSama,2811,587,24,15,39,61.5%,4m
20431,2,mathcore,2811,507,22,16,38,57.9%,21m
20431,2,KiRA,2811,613,22,22,44,50.0%,4m
20431,2,TooAwesome,2811,548,21,24,45,46.7%,39m
20431,2,spida,2811,614,21,30,51,41.2%,30m
20431,3,Kaiser,2811,451,20,15,35,57.1%,14m
20431,3,KittyCat,2811,244,8,9,17,47.1%,23m
20431,2,fantasyz,2811,282,8,12,20,40.0%,13m
20431,3,alexgamer,2811,144,5,6,11,45.5%,16m
20431,2,[0825]Kissarate,2811,100,4,2,6,66.7%,48m
20431,2,ThEWaFfLe,2811,62,4,7,11,36.4%,7m
20431,3,IceKnight,2811,142,3,1,4,75.0%,39m
20431,3,BringTheFunk,2811,120,3,1,4,75.0%,17m
20431,2,Marty,2811,0,3,2,5,60.0%,28m
20431,2,ScvRdy,2811,46,3,3,6,50.0%,30m
20431,2,PaltryNewt,2811,0,2,5,7,28.6%,17m
20431,3,Planar,2811,0,1,0,1,100.0%,19m
20431,3,Malaack,2811,30,1,1,2,50.0%,3m
20431,3,Apulsive,2811,0,1,1,2,50.0%,36m
20431,3,Flypk,2811,0,0,2,2,0.0%,5m
20460,2,choasong,2810,1438,252,232,484,52.1%,2m
20460,2,Dave,2810,1630,192,178,370,51.9%,9m
20460,2,Rafa,2810,1592,137,140,277,49.5%,8m
20460,3,lAraeLl,2810,1451,114,97,211,54.0%,28m
20460,2,[The248]LTon,2810,1571,83,81,164,50.6%,18m
20460,2,xXSMDXx,2810,1581,66,68,134,49.3%,12m
20460,2,Chetstar,2810,1266,58,60,118,49.2%,19m
20460,1,[UpxV]mugen,2810,1362,54,58,112,48.2%,37m
20460,3,[MEEGS]Pathogen,2810,677,26,22,48,54.2%,14m
20460,3,KoRnMLC,2810,580,21,22,43,48.8%,24m
20460,3,Nerdsie,2810,300,19,13,32,59.4%,40m
20460,3,starcrooft,2810,465,18,15,33,54.5%,2m
20460,3,SCIIPlayer,2810,363,16,5,21,76.2%,27m
20460,3,[JAY]AggieCoolGuy,2810,406,15,13,28,53.6%,34m
20460,2,[wNt2]Jamestown,2810,360,12,10,22,54.5%,30m
20460,1,[TGCF]Meteorain,2810,254,11,13,24,45.8%,3h
20460,3,[xTQc]Katamundi,2810,238,9,7,16,56.2%,44m
20460,2,CaptLours,2810,222,9,8,17,52.9%,31m
20460,3,[Xpk]Allegseu,2810,146,6,6,12,50.0%,35m
20460,2,[Chotus]Hope,2810,0,5,0,5,100.0%,48m
20460,3,sparkup,2810,154,5,9,14,35.7%,2m
20460,3,cmeTaHa,2810,0,3,2,5,60.0%,27m
20460,2,[BRSKR]ToxicChicken,2810,88,3,4,7,42.9%,14m
20460,3,warcha,2810,62,3,5,8,37.5%,30m
20460,1,thiccboi,2810,142,3,7,10,30.0%,3h
20460,3,[KingSC]DarkDelta,2810,0,1,0,1,100.0%,3m
20460,3,[CaveR]HudsonHack,2810,0,1,2,3,33.3%,5m
20460,1,Xenopsylla,2810,48,1,2,3,33.3%,48m
20460,1,[DarkLS]skiline,2810,0,1,2,3,33.3%,28m
20460,2,[ZeTa]PaInLeSs,2810,48,1,7,8,12.5%,24m
20460,3,OneSoFun,2810,0,0,1,1,0.0%,24m
20460,3,[BlTEL]ALEX,2810,0,0,1,1,0.0%,19m
20492,1,MiNdSeT,2809,1536,182,185,367,49.6%,26m
20492,3,ninetwofiver,2809,1261,89,74,163,54.6%,32m
20492,2,MevylmeT,2809,1456,88,84,172,51.2%,41m
20492,3,Clam,2809,1181,84,82,166,50.6%,27m
20492,3,[DiuRex]Sakashima,2809,995,68,52,120,56.7%,19m
20492,3,[Echo3s]salvagesoul,2809,1215,52,54,106,49.1%,37m
20492,2,Purpose,2809,1069,46,38,84,54.8%,2m
20492,3,[FuNg]Mushroom,2809,350,42,28,70,60.0%,15m
20492,1,[Strk5]jdge,2809,537,39,46,85,45.9%,3m
20492,2,EnTaroDEHAKA,2809,982,36,38,74,48.6%,29m
20492,3,Primordial,2809,791,34,29,63,54.0%,4m
20492,3,GimmeSugar,2809,643,25,42,67,37.3%,20m
20492,2,[MARV3L]ChipperT,2809,550,24,21,45,53.3%,26m
20492,2,Alakaid,2809,550,20,24,44,45.5%,17m
20492,3,Diao,2809,344,15,11,26,57.7%,22m
20492,3,Ted,2809,409,15,13,28,53.6%,32m
20492,3,ThatGuy,2809,341,13,7,20,65.0%,36m
20492,3,[NEU]zApitoOoOoO,2809,214,8,8,16,50.0%,19m
20492,2,Paradoxical,2809,150,5,14,19,26.3%,16m
20492,1,ICE,2809,215,4,3,7,57.1%,41m
20492,3,Bloodbraid,2809,114,4,4,8,50.0%,24m
20492,3,[Poise]Zukane,2809,0,1,0,1,100.0%,28m
20492,3,BoganArmy,2809,0,1,0,1,100.0%,3m
20492,3,Avocadeado,2809,0,1,0,1,100.0%,23m
20492,3,Hyo,2809,30,1,3,4,25.0%,2m
20492,3,duomaxwell,2809,30,1,5,6,16.7%,19m
20492,2,SgtApone,2809,30,1,6,7,14.3%,20m
20492,3,Faust,2809,0,1,9,10,10.0%,44m
20492,3,Pat,2809,0,0,1,1,0.0%,8m
20521,2,[XpKAc]CORONAVIRUS,2808,1594,410,404,814,50.4%,15m
20521,2,[LOHd]Willian,2808,1563,316,296,612,51.6%,17m
20521,2,[JUGOS2]Javier,2808,1469,276,248,524,52.7%,26m
20521,3,Refrigerator,2808,1430,79,63,142,55.6%,41m
20521,2,[ValidG]Creature,2808,373,17,11,28,60.7%,9m
20521,3,clintwstwood,2808,387,15,13,28,53.6%,24m
20521,2,Blaster,2808,338,14,11,25,56.0%,9m
20521,3,Blamt,2808,194,8,4,12,66.7%,3m
20521,3,Durotan,2808,234,8,9,17,47.1%,23m
20521,2,[xdface]Irukandji,2808,120,7,7,14,50.0%,28m
20521,1,[Ex7rA]ExtrA,2808,147,5,5,10,50.0%,35m
20521,3,Zipper,2808,120,5,7,12,41.7%,35m
20521,1,DominSpectre,2808,139,4,6,10,40.0%,1h
20521,2,MrSadistic,2808,126,4,10,14,28.6%,13m
20521,2,[DHZ0ne]diogo,2808,88,3,9,12,25.0%,21m
20521,3,[Abstra]Haraldo,2808,30,2,0,2,100.0%,13m
20521,2,mcscenario,2808,0,2,0,2,100.0%,3h
20521,3,xxNoéDavidxx,2808,123,2,2,4,50.0%,44m
20521,3,Relayer,2808,94,1,7,8,12.5%,17m
20521,2,toyorom,2808,0,0,1,1,0.0%,3h
20521,3,Jasper,2808,0,0,1,1,0.0%,27m
20521,3,Snow,2808,0,0,5,5,0.0%,40m
20543,1,lyyy,2807,1654,228,225,453,50.3%,41m
20543,2,Soulless,2807,1596,175,168,343,51.0%,17m
20543,2,ElCaBrOn,2807,978,112,116,228,49.1%,25m
20543,1,[chair]KalEl,2807,1123,82,92,174,47.1%,41m
20543,3,CourtLizard,2807,854,52,42,94,55.3%,32m
20543,2,Cobra,2807,687,42,41,83,50.6%,18m
20543,1,NoodleRine,2807,1121,41,46,87,47.1%,35m
20543,3,Zergg,2807,736,37,23,60,61.7%,14m
20543,3,LolPlayerxd,2807,480,26,8,34,76.5%,23m
20543,2,GUnit,2807,306,22,22,44,50.0%,24m
20543,3,[SloBum]Yoda,2807,490,18,20,38,47.4%,36m
20543,3,DavTerran,2807,420,16,15,31,51.6%,35m
20543,2,Kaphis,2807,388,14,21,35,40.0%,13m
20543,2,Asakura,2807,396,13,24,37,35.1%,41m
20543,2,redELMO,2807,281,12,9,21,57.1%,15m
20543,3,[Zesttt]JustPlayLike,2807,272,10,5,15,66.7%,21m
20543,3,TakeSixty,2807,293,10,6,16,62.5%,3h
20543,3,Theswan,2807,309,10,8,18,55.6%,51m
20543,3,[grity]BearSan,2807,181,8,8,16,50.0%,17m
20543,3,Xclash,2807,187,7,7,14,50.0%,11m
20543,3,Topher,2807,166,6,8,14,42.9%,8m
20543,3,MeowMaster,2807,181,6,8,14,42.9%,3m
20543,3,[UoW]JohnZaller,2807,212,6,12,18,33.3%,27m
20543,3,belak,2807,140,5,4,9,55.6%,34m
20543,1,[TnyDck]greedy,2807,96,5,5,10,50.0%,1h
20543,2,destripador,2807,154,4,7,11,36.4%,7m
20543,3,WugsaW,2807,58,3,0,3,100.0%,18m
20543,2,[LGNxx]MasterHater,2807,58,3,7,10,30.0%,18m
20543,2,Danyo,2807,0,2,0,2,100.0%,3h
20543,1,[Meower]JMaury,2807,48,2,1,3,66.7%,44m
20543,3,elegance,2807,0,1,0,1,100.0%,20m
20543,3,ElSucioDan,2807,22,1,2,3,33.3%,20m
20543,3,[JRT]ReaperPy,2807,0,1,4,5,20.0%,3m
20543,3,Rebel,2807,0,0,1,1,0.0%,3m
20543,1,Trululu,2807,0,0,1,1,0.0%,27m
20578,2,Philosopher,2806,1536,141,124,265,53.2%,26m
20578,3,Love,2806,1585,118,88,206,57.3%,22m
20578,2,magNETar,2806,1492,102,85,187,54.5%,16m
20578,2,DJMufasa,2806,1506,91,94,185,49.2%,7m
20578,2,Destroyer,2806,1272,53,48,101,52.5%,3m
20578,2,jack,2806,1152,43,45,88,48.9%,20m
20578,1,Apothecera,2806,848,42,49,91,46.2%,16m
20578,2,[HoSeeB]Tracy,2806,635,36,27,63,57.1%,20m
20578,3,[LPrD]Tri,2806,572,34,21,55,61.8%,39m
20578,3,LingLing,2806,552,24,14,38,63.2%,34m
20578,2,[Bee]AgentX,2806,361,14,11,25,56.0%,35m
20578,2,Jarvis,2806,283,12,10,22,54.5%,1h
20578,2,Roses,2806,140,4,3,7,57.1%,1h
20578,3,Moose,2806,86,4,3,7,57.1%,36m
20578,2,MrChestnut,2806,88,4,4,8,50.0%,28m
20578,2,[nieBla]Kukulza,2806,30,2,5,7,28.6%,11m
20578,3,Jarvid,2806,0,0,1,1,0.0%,59m
20578,3,ElCreador,2806,0,0,5,5,0.0%,32m
20596,2,Blablabla,2805,974,274,240,514,53.3%,41m
20596,1,Davek,2805,1550,197,192,389,50.6%,38m
20596,2,TLYASS,2805,1597,169,171,340,49.7%,7m
20596,2,[T4TG]kurbo,2805,1614,131,138,269,48.7%,7m
20596,3,[RCESP]Atari,2805,1439,122,98,220,55.5%,38m
20596,2,[TBKR]Powered,2805,657,121,110,231,52.4%,6m
20596,2,[0l0l0]GranFranco,2805,1227,120,119,239,50.2%,42m
20596,1,Rhydant,2805,1544,116,115,231,50.2%,35m
20596,2,[sk3tch]sillypanda,2805,983,113,99,212,53.3%,7m
20596,3,[nCrphL]TigerSpider,2805,1543,110,102,212,51.9%,23m
20596,1,[CovidX]Perseus,2805,1000,86,76,162,53.1%,38m
20596,3,HOTSHOTS,2805,1214,64,82,146,43.8%,23m
20596,3,stegaphone,2805,713,32,19,51,62.7%,27m
20596,3,IIIIIIIIIIII,2805,906,29,45,74,39.2%,8m
20596,3,WLL,2805,448,16,10,26,61.5%,16m
20596,3,[New2it]CasualGamer,2805,312,13,16,29,44.8%,5m
20596,3,Rebehleinad,2805,241,9,8,17,52.9%,27m
20596,3,miGao,2805,290,9,9,18,50.0%,36m
20596,3,KotNaBicycle,2805,264,9,10,19,47.4%,14m
20596,3,PantaRhei,2805,192,7,1,8,87.5%,29m
20596,2,seaworm,2805,174,7,6,13,53.8%,28m
20596,1,BigMath,2805,172,7,7,14,50.0%,20m
20596,2,[4LOBOS]Pavel,2805,210,7,14,21,33.3%,31m
20596,3,Emprorpinapl,2805,30,5,2,7,71.4%,24m
20596,2,alaskaRUS,2805,0,3,2,5,60.0%,1h
20596,3,RIPRAW,2805,30,2,0,2,100.0%,15m
20596,3,Ivan,2805,0,1,0,1,100.0%,35m
20596,3,IIIIIIIIIIII,2805,0,1,1,2,50.0%,3m
20596,3,bang,2805,0,1,3,4,25.0%,23m
20596,3,Mandíbula,2805,0,0,7,7,0.0%,3h
20626,1,[AbcCo]Megab,2804,1427,281,261,542,51.8%,35m
20626,2,Alejosaurio,2804,1373,110,101,211,52.1%,31m
20626,2,[Igbt]FlyinHealBus,2804,1325,90,87,177,50.8%,19m
20626,3,[ClanHs]Sweetgoodnes,2804,1376,84,75,159,52.8%,3m
20626,2,Pedretti,2804,1546,79,79,158,50.0%,17m
20626,2,[FyHr]cheche,2804,899,60,47,107,56.1%,28m
20626,3,Brocciu,2804,438,32,27,59,54.2%,32m
20626,3,[yukup]ARFifteenkil,2804,842,31,29,60,51.7%,30m
20626,2,[OTEL]ROOMMAA,2804,430,15,22,37,40.5%,16m
20626,3,[LTlord]Nevada,2804,260,9,11,20,45.0%,36m
20626,3,CreepDead,2804,165,6,7,13,46.2%,4m
20626,2,Dragneel,2804,0,3,3,6,50.0%,9m
20626,3,[Lp]ElNoob,2804,30,2,1,3,66.7%,38m
20626,3,FiretoBlaze,2804,91,2,2,4,50.0%,26m
20626,2,Luken,2804,0,1,0,1,100.0%,32m
20626,3,[LQV]TerranDeath,2804,0,1,0,1,100.0%,19m
20626,1,onegu,2804,0,1,0,1,100.0%,39m
20626,3,Yoshi,2804,30,1,1,2,50.0%,14m
20626,3,daniel,2804,0,1,1,2,50.0%,39m
20626,1,Puff,2804,0,1,2,3,33.3%,1h
20626,3,playerbig,2804,0,1,2,3,33.3%,17m
20626,3,Bliss,2804,0,0,1,1,0.0%,29m
20626,3,StayHydrated,2804,0,0,1,1,0.0%,2m
20626,3,HellzAdvocat,2804,0,0,2,2,0.0%,2m
20626,3,REMNola,2804,0,0,2,2,0.0%,35m
20626,3,oldskool,2804,0,0,3,3,0.0%,20m
20626,2,rAkEn,2804,0,0,3,3,0.0%,3m
20653,3,[Exper]Billionaire,2803,1518,412,422,834,49.4%,1m
20653,1,[SuperZ]JoHidding,2803,1564,260,258,518,50.2%,30m
20653,2,[LETAL]Amón,2803,991,147,134,281,52.3%,13m
20653,3,cinderlord,2803,1559,103,63,166,62.0%,25m
20653,1,DHG,2803,1438,72,47,119,60.5%,39m
20653,2,[GT301]AlienProphet,2803,1482,61,66,127,48.0%,20m
20653,3,CAIS,2803,1086,47,40,87,54.0%,39m
20653,3,dspecialist,2803,318,16,10,26,61.5%,10m
20653,2,Tama,2803,341,12,10,22,54.5%,5m
20653,3,[Tecomi]UOSS,2803,252,9,6,15,60.0%,4m
20653,3,ScifiToilet,2803,165,5,1,6,83.3%,24m
20653,3,Ricky,2803,30,4,3,7,57.1%,17m
20653,2,Rogue,2803,0,3,2,5,60.0%,18m
20653,3,Maknus,2803,60,3,2,5,60.0%,4m
20653,3,Awkin,2803,143,3,2,5,60.0%,22m
20653,3,Rufus,2803,58,2,3,5,40.0%,40m
20653,3,Judah,2803,0,0,1,1,0.0%,22m
20653,3,[LoSD]NewBB,2803,0,0,2,2,0.0%,23m
20653,1,[FkJeff]chlamydia,2803,0,0,2,2,0.0%,3h
20653,1,IIIIIIIIIIII,2803,0,0,2,2,0.0%,1h
20673,2,[SANGRE]SMach,2802,1007,243,210,453,53.6%,13m
20673,3,[SWOU]LoordMishiu,2802,1595,175,166,341,51.3%,3m
20673,2,QStorm,2802,1378,123,96,219,56.2%,21m
20673,3,Miudera,2802,1627,98,74,172,57.0%,14m
20673,2,[Best01]MaverickPerú,2802,687,69,58,127,54.3%,41m
20673,3,[TinyED]TinYsOs,2802,533,32,17,49,65.3%,30m
20673,3,Sarge,2802,559,22,16,38,57.9%,17m
20673,3,NicoplaysSC,2802,316,11,12,23,47.8%,4m
20673,3,Brynxi,2802,86,4,3,7,57.1%,2m
20673,3,Vision,2802,118,3,0,3,100.0%,17m
20673,3,Leopard,2802,58,3,0,3,100.0%,2m
20673,3,BigBoss,2802,94,2,0,2,100.0%,8m
20673,2,[TAKANA]Wulfrano,2802,0,2,1,3,66.7%,3h
20673,1,[BNITOS]Adrianks,2802,48,2,1,3,66.7%,44m
20673,1,bingus,2802,97,2,3,5,40.0%,1h
20673,3,VashtaNerada,2802,0,1,0,1,100.0%,58m
20673,1,OngCheeBang,2802,0,1,1,2,50.0%,56m
20673,3,Jcampos,2802,0,0,1,1,0.0%,15m
20673,3,[Devout]Freezepop,2802,0,0,1,1,0.0%,20m
20673,3,TheSandman,2802,0,0,1,1,0.0%,30m
20673,2,[Hoxy]Whyrano,2802,0,0,1,1,0.0%,3h
20673,3,[IiUiI]KoshNaranek,2802,0,0,1,1,0.0%,38m
20673,3,[DarkLS]cavg,2802,0,0,1,1,0.0%,23m
20673,3,[BATTOD]AngryElf,2802,0,0,2,2,0.0%,10m
20673,3,MrMcDirtNsty,2802,0,0,3,3,0.0%,21m
20673,3,ALSdjkas,2802,0,0,3,3,0.0%,19m
20673,2,MagicJohnson,2802,0,0,3,3,0.0%,20m
20700,3,FLORENCIO,2801,1184,237,222,459,51.6%,21m
20700,3,[CS0]Supersquare,2801,1029,64,44,108,59.3%,23m
20700,3,[UMTD]Donut,2801,819,49,38,87,56.3%,4m
20700,3,clane,2801,1054,46,34,80,57.5%,3m
20700,3,[LMS69]Bane,2801,618,37,35,72,51.4%,2m
20700,3,NateBlatz,2801,941,35,35,70,50.0%,20m
20700,1,[ZTemps]ZugZug,2801,524,25,33,58,43.1%,31m
20700,3,trumplover,2801,567,23,19,42,54.8%,3m
20700,3,Kirynn,2801,500,23,20,43,53.5%,4m
20700,2,Precursor,2801,284,21,18,39,53.8%,21m
20700,2,[MDCo]Alxpenguin,2801,346,12,15,27,44.4%,6m
20700,3,WildRage,2801,277,10,7,17,58.8%,1h
20700,2,Stiffnights,2801,283,10,14,24,41.7%,1h
20700,3,Licht,2801,190,8,6,14,57.1%,32m
20700,3,YoungOG,2801,113,8,6,14,57.1%,24m
20700,3,[COOP2]Gdspeeds,2801,223,7,5,12,58.3%,23m
20700,2,YinYang,2801,150,7,10,17,41.2%,31m
20700,3,ivtec,2801,119,5,2,7,71.4%,33m
20700,3,[WFV]freya,2801,160,4,2,6,66.7%,22m
20700,1,CENTURION,2801,168,4,3,7,57.1%,8m
20700,2,DarK,2801,140,4,4,8,50.0%,1h
20700,1,Hsix,2801,89,4,5,9,44.4%,26m
20700,3,SSRSnake,2801,0,3,2,5,60.0%,27m
20700,2,LaquabAkhahb,2801,0,3,3,6,50.0%,37m
20700,2,Rugal,2801,132,3,6,9,33.3%,10m
20700,3,[ZTemp]painNgain,2801,30,2,1,3,66.7%,8m
20700,3,VeNoMoUzShOt,2801,58,2,5,7,28.6%,10m
20700,3,LUXOX,2801,0,1,0,1,100.0%,23m
20700,3,Proyoh,2801,95,1,1,2,50.0%,27m
20700,3,[PN1S]HawtDonkey,2801,30,1,2,3,33.3%,42m
20700,3,[ecoron]ecorona,2801,0,0,1,1,0.0%,9m
20700,3,[GGMESP]Geron,2801,0,0,1,1,0.0%,9m
20700,3,[xdddxd]cocainomano,2801,0,0,1,1,0.0%,14m
20700,2,Nolboo,2801,0,0,1,1,0.0%,41m
20734,1,[ConFed]SeventhSign,2800,1607,127,136,263,48.3%,14m
20734,1,Boondoggle,2800,1534,122,118,240,50.8%,31m
20734,2,Bogie,2800,1538,111,105,216,51.4%,23m
20734,3,Exodus,2800,772,51,39,90,56.7%,14m
20734,2,[7KINGS]JediKnight,2800,798,42,44,86,48.8%,10m
20734,2,[AzTeK]MVP,2800,723,34,23,57,59.6%,11m
20734,2,SpartanRD,2800,653,25,30,55,45.5%,24m
20734,2,Creature,2800,362,23,11,34,67.6%,20m
20734,3,PoH,2800,596,22,21,43,51.2%,39m
20734,3,IIIIIIIIIIII,2800,530,20,13,33,60.6%,36m
20734,3,Edituss,2800,221,12,8,20,60.0%,28m
20734,3,[DHZ0ne]Aldrich,2800,317,12,13,25,48.0%,26m
20734,3,colonelmusta,2800,346,12,14,26,46.2%,4m
20734,3,therageking,2800,350,12,14,26,46.2%,21m
20734,3,Nalisha,2800,229,8,3,11,72.7%,24m
20734,3,[TPGGXD]ULIGJ,2800,174,7,4,11,63.6%,33m
20734,3,Skeletor,2800,180,5,2,7,71.4%,17m
20734,3,[YelJaK]BlazinBlind,2800,86,4,2,6,66.7%,40m
20734,3,Sydirian,2800,88,4,3,7,57.1%,9m
20734,2,OFERYS,2800,0,3,3,6,50.0%,18m
20734,3,[TGosuD]swister,2800,92,3,6,9,33.3%,9m
20734,3,Chaos,2800,60,2,5,7,28.6%,28m
20734,3,Ghostwalker,2800,30,1,1,2,50.0%,15m
20734,1,[cluez]crashx,2800,97,1,3,4,25.0%,1h
20734,3,[Dadash]ARMIN,2800,0,0,1,1,0.0%,16m
20734,1,[iCOKi]RebornfOu,2800,0,0,1,1,0.0%,3h
20734,3,[KAIBIL]StevenBuyaka,2800,0,0,1,1,0.0%,40m
20734,3,RedStar,2800,0,0,1,1,0.0%,32m
20734,3,[NTrio]DirigoX,2800,0,0,3,3,0.0%,10m
20763,1,votedonnyt,2799,1563,258,241,499,51.7%,35m
20763,2,Bill,2799,1278,147,140,287,51.2%,33m
20763,2,Balute,2799,809,115,108,223,51.6%,39m
20763,2,DIngle,2799,841,113,90,203,55.7%,23m
20763,3,DarkHunter,2799,1570,90,69,159,56.6%,23m
20763,3,Quebrantador,2799,1572,78,73,151,51.7%,32m
20763,2,Static,2799,1555,71,61,132,53.8%,37m
20763,2,bigbopper,2799,534,68,56,124,54.8%,8m
20763,1,GoofyBoy,2799,702,59,62,121,48.8%,27m
20763,1,[GOPERÚ]DAIRANIS,2799,509,51,48,99,51.5%,17m
20763,3,Platinum,2799,1020,51,55,106,48.1%,8m
20763,3,RedFalcon,2799,634,26,19,45,57.8%,18m
20763,3,renniehoek,2799,392,15,14,29,51.7%,17m
20763,3,[PYRES]Ahndwoo,2799,332,13,6,19,68.4%,39m
20763,3,Yamaxanadu,2799,318,13,7,20,65.0%,16m
20763,3,RAMBO,2799,247,8,5,13,61.5%,38m
20763,2,[Ash3s]Lelithian,2799,30,5,4,9,55.6%,2m
20763,3,FartGoblin,2799,181,5,9,14,35.7%,39m
20763,2,bIgKeV,2799,118,4,9,13,30.8%,35m
20763,2,[SBlock]SEBASTIAN,2799,94,4,11,15,26.7%,37m
20763,1,junpyo,2799,96,2,2,4,50.0%,1h
20763,1,[IiUiI]demon,2799,0,1,0,1,100.0%,3h
20763,3,[VAPD]Pipsonator,2799,0,1,4,5,20.0%,4m
20763,1,Shura,2799,0,0,2,2,0.0%,3h
20763,3,Blessthefall,2799,0,0,3,3,0.0%,2m
20788,2,RandomWasabi,2798,1575,87,85,172,50.6%,15m
20788,2,sleazypnut,2798,925,47,54,101,46.5%,15m
20788,2,[MP1]CODEX,2798,756,37,48,85,43.5%,24m
20788,2,notKevin,2798,732,31,26,57,54.4%,10m
20788,3,happy,2798,600,25,23,48,52.1%,13m
20788,3,Alicanto,2798,515,24,14,38,63.2%,16m
20788,2,[PoSu]Sariel,2798,582,23,26,49,46.9%,26m
20788,2,ChrisDaWiz,2798,467,20,17,37,54.1%,33m
20788,3,SpineshanK,2798,496,19,19,38,50.0%,22m
20788,3,Jupiter,2798,283,13,10,23,56.5%,10m
20788,3,[Fatty]HateLoad,2798,368,12,28,40,30.0%,23m
20788,1,kanbara,2798,185,8,1,9,88.9%,1h
20788,3,Blizzaro,2798,240,8,12,20,40.0%,22m
20788,2,demerick,2798,242,8,19,27,29.6%,13m
20788,3,ChugCafeBro,2798,166,5,1,6,83.3%,16m
20788,2,Harnj,2798,140,4,4,8,50.0%,3h
20788,1,vortex,2798,97,4,4,8,50.0%,41m
20788,2,Money,2798,126,4,12,16,25.0%,33m
20788,3,Ttori,2798,117,3,0,3,100.0%,40m
20788,3,[PJCWNT]VaporTMO,2798,58,2,2,4,50.0%,27m
20788,3,XanderCrews,2798,120,2,4,6,33.3%,11m
20788,3,[MaryJa]BendyStraw,2798,0,1,0,1,100.0%,19m
20788,3,[WoLv3S]AngelofDeath,2798,0,1,0,1,100.0%,3m
20788,2,[SORTof]Bamboozled,2798,0,1,4,5,20.0%,54m
20788,3,Knavik,2798,0,0,5,5,0.0%,13m
20788,1,Grazx,2798,0,0,6,6,0.0%,40m
20814,3,SIMAYI,2797,1651,398,401,799,49.8%,39m
20814,3,[1v1me]SCUnicorn,2797,1623,242,218,460,52.6%,27m
20814,1,SleepTerror,2797,1565,121,123,244,49.6%,13m
20814,2,EjercitoSalv,2797,1427,79,84,163,48.5%,8m
20814,2,CoffeeMilk,2797,530,75,80,155,48.4%,5m
20814,2,WAVE,2797,1163,60,58,118,50.8%,33m
20814,2,TerHan,2797,886,54,61,115,47.0%,13m
20814,2,Inception,2797,1331,50,52,102,49.0%,17m
20814,3,[DubDom]LithicLeafy,2797,482,27,21,48,56.2%,6m
20814,2,[csif]Alex,2797,471,21,20,41,51.2%,22m
20814,2,chrisugru,2797,230,19,20,39,48.7%,13m
20814,3,royliuboy,2797,374,15,21,36,41.7%,34m
20814,3,xizi,2797,260,13,17,30,43.3%,2m
20814,3,SilenceReno,2797,298,12,9,21,57.1%,35m
20814,2,Drdumais,2797,290,12,14,26,46.2%,10m
20814,3,Zivaero,2797,256,11,2,13,84.6%,23m
20814,3,[Pro2os]FireFistAce,2797,282,11,11,22,50.0%,20m
20814,2,[EnTrWu]comsteele,2797,273,11,11,22,50.0%,41m
20814,2,JHONYCACERES,2797,274,10,15,25,40.0%,42m
20814,3,[GØSU]dex,2797,212,10,18,28,35.7%,25m
20814,3,[142]AnneMarie,2797,289,9,4,13,69.2%,6m
20814,3,JaeD,2797,294,9,11,20,45.0%,29m
20814,3,Xero,2797,174,7,2,9,77.8%,16m
20814,2,[142]Genjie,2797,222,7,5,12,58.3%,8m
20814,1,KissTheRain,2797,96,6,4,10,60.0%,38m
20814,1,TOpesuji,2797,201,6,5,11,54.5%,1h
20814,1,PLA,2797,96,5,5,10,50.0%,43m
20814,3,DefconVI,2797,0,4,1,5,80.0%,17m
20814,3,lebbra,2797,0,4,2,6,66.7%,6m
20814,1,maseface,2797,97,4,4,8,50.0%,16m
20814,1,CoreyJJ,2797,150,4,18,22,18.2%,21m
20814,3,sparda,2797,0,3,2,5,60.0%,3m
20814,3,[NGCR]Ted,2797,93,3,3,6,50.0%,6m
20814,3,Coasti,2797,30,2,2,4,50.0%,17m
20814,3,JZTD,2797,60,2,3,5,40.0%,19m
20814,3,Emhey,2797,0,1,0,1,100.0%,2m
20814,2,[xLgNx]valTiel,2797,0,1,2,3,33.3%,2m
20814,3,reeceken,2797,30,1,2,3,33.3%,6m
20814,3,Obstruction,2797,0,0,1,1,0.0%,3m
20814,3,[WLSC]SchachSG,2797,0,0,3,3,0.0%,23m
20854,2,SoldierBoy,2796,1025,255,236,491,51.9%,13m
20854,2,[MC40]KaveBlack,2796,1612,115,117,232,49.6%,18m
20854,3,Gandalf,2796,1256,61,37,98,62.2%,36m
20854,3,[NM8]sTony,2796,1216,50,45,95,52.6%,2m
20854,3,BJR,2796,706,26,26,52,50.0%,24m
20854,3,GreenDragon,2796,632,24,24,48,50.0%,20m
20854,2,INMORTAL,2796,368,14,15,29,48.3%,13m
20854,3,Luxy,2796,290,12,8,20,60.0%,36m
20854,3,martinesk,2796,250,10,7,17,58.8%,3m
20854,2,BLAHSUM,2796,256,10,9,19,52.6%,45m
20854,2,[Emb3rs]Greezon,2796,198,7,13,20,35.0%,5m
20854,3,Adam,2796,175,5,2,7,71.4%,3m
20854,3,SimonxRuri,2796,132,4,0,4,100.0%,3m
20854,3,[SFMC]haachamasimp,2796,0,3,2,5,60.0%,13m
20854,1,[XDRAX8]IRONSOUL,2796,114,3,18,21,14.3%,10m
20854,2,[DuSted]NIGHTWING,2796,0,2,2,4,50.0%,3h
20854,3,Bladerr,2796,0,1,0,1,100.0%,2m
20854,3,[BBLINE]MarkMiller,2796,0,1,0,1,100.0%,7m
20854,3,Terminator,2796,0,1,0,1,100.0%,33m
20854,3,Boreal,2796,30,1,1,2,50.0%,10m
20854,2,Sweetdice,2796,0,0,1,1,0.0%,48m
20854,2,PyLah,2796,0,0,4,4,0.0%,10m
20876,2,MajorasAss,2795,469,58,47,105,55.2%,20m
20876,2,Rachiu,2795,1006,42,41,83,50.6%,40m
20876,3,DMK,2795,819,38,32,70,54.3%,15m
20876,3,Curbo,2795,810,33,27,60,55.0%,24m
20876,3,Bombastic,2795,568,22,22,44,50.0%,28m
20876,3,Jester,2795,440,17,17,34,50.0%,24m
20876,2,Cyberllama,2795,450,16,16,32,50.0%,5m
20876,3,MXBorderWall,2795,309,12,6,18,66.7%,24m
20876,3,encguitarist,2795,202,8,6,14,57.1%,14m
20876,2,BooMeR,2795,214,8,9,17,47.1%,2m
20876,3,[iUm]LimitSEA,2795,230,7,5,12,58.3%,4m
20876,2,verjox,2795,186,7,9,16,43.8%,8m
20876,3,Hunter,2795,151,6,6,12,50.0%,4m
20876,2,[poe12]STERBEN,2795,115,6,12,18,33.3%,30m
20876,2,Tommaco,2795,166,5,7,12,41.7%,9m
20876,3,TheGuard,2795,111,3,0,3,100.0%,23m
20876,2,Angelofdeath,2795,0,3,1,4,75.0%,1h
20876,1,RedSoul,2795,0,3,4,7,42.9%,3h
20876,3,Troll,2795,30,2,0,2,100.0%,32m
20876,3,DarckMaster,2795,95,2,2,4,50.0%,21m
20876,3,SherifofAiur,2795,60,2,2,4,50.0%,38m
20876,3,Artiz,2795,0,2,3,5,40.0%,29m
20876,3,ThatGinger,2795,0,1,0,1,100.0%,39m
20876,3,ayeh,2795,30,1,1,2,50.0%,15m
20876,3,Etansnail,2795,30,1,2,3,33.3%,29m
20876,3,Philthy,2795,0,0,1,1,0.0%,23m
20876,3,TheLordNukem,2795,0,0,1,1,0.0%,27m
20876,3,[Bee]MrMister,2795,0,0,1,1,0.0%,19m
20904,2,GaeL,2794,1577,430,435,865,49.7%,34m
20904,1,[BSQUAD]BigGuwap,2794,1550,224,208,432,51.9%,32m
20904,3,Granmaluco,2794,1191,175,163,338,51.8%,40m
20904,3,krayziemario,2794,1517,169,153,322,52.5%,27m
20904,1,BongHits,2794,1624,168,162,330,50.9%,38m
20904,2,SNAFU,2794,1178,47,47,94,50.0%,11m
20904,2,Kropotkid,2794,898,47,52,99,47.5%,23m
20904,3,padrote,2794,1158,43,41,84,51.2%,16m
20904,3,Wreneagle,2794,1020,41,39,80,51.2%,38m
20904,2,[RAMEN]ouTlier,2794,673,26,30,56,46.4%,2m
20904,1,CallMeTino,2794,529,19,25,44,43.2%,28m
20904,3,IIIIIIIIIIII,2794,388,18,6,24,75.0%,8m
20904,2,[xEx]Banjo,2794,340,16,14,30,53.3%,32m
20904,3,[WuTang]Hurky,2794,176,13,10,23,56.5%,32m
20904,3,JapJap,2794,265,11,4,15,73.3%,39m
20904,1,RevlutionMan,2794,239,10,4,14,71.4%,57m
20904,3,TangoRocker,2794,228,10,8,18,55.6%,3h
20904,3,KBack,2794,168,6,6,12,50.0%,39m
20904,3,solitaryarmy,2794,30,5,3,8,62.5%,34m
20904,3,Division,2794,138,5,4,9,55.6%,23m
20904,3,[CLan12]PiJiRoNy,2794,152,5,8,13,38.5%,30m
20904,3,[Orisai]Ulven,2794,145,4,1,5,80.0%,36m
20904,3,maikirex,2794,90,4,3,7,57.1%,40m
20904,3,[RLA]Shinyhero,2794,120,4,9,13,30.8%,32m
20904,3,Kapis,2794,0,3,2,5,60.0%,24m
20904,3,Max,2794,30,2,0,2,100.0%,7m
20904,3,Lydious,2794,30,2,0,2,100.0%,19m
20904,3,ZnaH,2794,60,2,3,5,40.0%,25m
20904,3,BestNameEver,2794,0,1,2,3,33.3%,21m
20904,3,[CRAKS]Ferreira,2794,0,1,2,3,33.3%,2m
20904,3,mna,2794,89,1,2,3,33.3%,2m
20904,3,[viwar]Megaroth,2794,30,1,3,4,25.0%,20m
20904,3,Monkey,2794,0,0,1,1,0.0%,21m
20937,1,Chirps,2793,1523,115,126,241,47.7%,21m
20937,1,bryan,2793,1296,91,88,179,50.8%,26m
20937,2,poe,2793,1257,65,66,131,49.6%,11m
20937,3,[SWOU]Radamanthys,2793,1105,53,39,92,57.6%,39m
20937,3,Stein,2793,671,28,19,47,59.6%,15m
20937,3,alienbaby,2793,236,21,15,36,58.3%,41m
20937,3,Gary,2793,256,9,9,18,50.0%,32m
20937,2,Woland,2793,255,9,15,24,37.5%,6m
20937,3,Appleeater,2793,123,5,4,9,55.6%,20m
20937,3,MzCori,2793,138,4,1,5,80.0%,17m
20937,3,Quim,2793,118,4,16,20,20.0%,34m
20937,1,Imply,2793,0,1,0,1,100.0%,1h
20937,1,[DhZone]DeNieD,2793,0,1,1,2,50.0%,3h
20937,3,Jadch,2793,30,1,2,3,33.3%,41m
20937,1,yuvius,2793,0,1,2,3,33.3%,3h
20937,3,[TPLUSS]marsman,2793,0,1,3,4,25.0%,8m
20937,3,[GRNSKN]Ashiro,2793,30,1,3,4,25.0%,22m
20937,3,gentelmen,2793,91,1,4,5,20.0%,11m
20937,3,Borzinator,2793,0,0,1,1,0.0%,40m
20937,3,zen,2793,0,0,2,2,0.0%,16m
20957,2,yfamily,2792,1547,89,92,181,49.2%,33m
20957,3,[TGosuB]Spawtan,2792,1279,81,60,141,57.4%,40m
20957,2,ArGhOs,2792,1429,80,74,154,51.9%,19m
20957,3,[GTWITM]MrKwan,2792,1038,75,67,142,52.8%,36m
20957,3,Lopikong,2792,1026,61,46,107,57.0%,33m
20957,3,Constantine,2792,1199,56,32,88,63.6%,17m
20957,3,GiN,2792,1412,55,71,126,43.7%,11m
20957,3,[ValidG]Willwillwin,2792,673,54,54,108,50.0%,19m
20957,2,Gaijin,2792,645,27,21,48,56.2%,15m
20957,2,VSEPR,2792,511,22,21,43,51.2%,13m
20957,3,[LCE]Roots,2792,457,20,19,39,51.3%,12m
20957,2,mark,2792,458,19,19,38,50.0%,28m
20957,2,[Crond6]Ltv,2792,336,18,16,34,52.9%,11m
20957,3,doud,2792,406,16,13,29,55.2%,33m
20957,2,zcc,2792,383,16,15,31,51.6%,26m
20957,3,ROROROX,2792,210,10,9,19,52.6%,3m
20957,1,TMoney,2792,232,10,13,23,43.5%,36m
20957,3,Cyo,2792,212,6,4,10,60.0%,1h
20957,1,KoSC,2792,168,6,10,16,37.5%,2m
20957,2,Imran,2792,118,5,9,14,35.7%,41m
20957,2,[BLTTLB]Thozwhor,2792,163,4,0,4,100.0%,41m
20957,1,JanekPL,2792,118,4,4,8,50.0%,3h
20957,2,bluepickles,2792,30,4,4,8,50.0%,11m
20957,2,Randomwalk,2792,128,4,13,17,23.5%,20m
20957,3,Prodigy,2792,58,3,1,4,75.0%,41m
20957,3,[PiGPan]Mediocre,2792,30,2,0,2,100.0%,23m
20957,2,NewToSC,2792,0,2,3,5,40.0%,1h
20957,1,[BroBlo]Axumi,2792,96,2,6,8,25.0%,34m
20957,3,urbanstereo,2792,0,0,1,1,0.0%,21m
20957,3,IMPERIO,2792,0,0,1,1,0.0%,19m
20957,1,ghostdog,2792,0,0,1,1,0.0%,28m
20957,3,[LevelR]CarribouYa,2792,0,0,1,1,0.0%,5m
20957,1,namaste,2792,0,0,1,1,0.0%,3h
20990,3,[FORCE9]samurairiver,2791,1562,365,352,717,50.9%,6m
20990,2,Bernard,2791,1437,363,324,687,52.8%,18m
20990,2,Joserenu,2791,1586,86,87,173,49.7%,13m
20990,3,[YAOII]Tunk,2791,722,31,20,51,60.8%,6m
20990,2,[DgDzNt]Trogdor,2791,686,26,28,54,48.1%,33m
20990,3,GagamelsRage,2791,514,24,8,32,75.0%,5m
20990,2,Deif,2791,451,22,23,45,48.9%,9m
20990,3,MajinCroix,2791,544,21,19,40,52.5%,8m
20990,3,Daz,2791,457,18,13,31,58.1%,23m
20990,3,KingCat,2791,416,14,12,26,53.8%,20m
20990,3,[PobSC]Mauwi,2791,344,13,10,23,56.5%,41m
20990,3,SuperStopper,2791,265,11,8,19,57.9%,2m
20990,3,AVF,2791,320,11,8,19,57.9%,8m
20990,2,[Kixeye]Kukuro,2791,276,11,11,22,50.0%,11m
20990,3,[Fir3s]BHen,2791,168,10,4,14,71.4%,24m
20990,2,Yani,2791,168,7,13,20,35.0%,20m
20990,2,prttygrlrock,2791,220,7,14,21,33.3%,25m
20990,2,Trickis,2791,128,6,4,10,60.0%,11m
20990,3,Silas,2791,132,6,7,13,46.2%,37m
20990,3,killerXD,2791,142,5,7,12,41.7%,6m
20990,2,Tetsui,2791,146,5,13,18,27.8%,15m
20990,1,[PUSA]FlynnScifo,2791,48,4,4,8,50.0%,1h
20990,3,Gameknight,2791,122,4,5,9,44.4%,2m
20990,2,[5ITH]Anzac,2791,142,4,7,11,36.4%,31m
20990,1,yaco,2791,119,3,1,4,75.0%,46m
20990,3,Vedrak,2791,0,3,2,5,60.0%,17m
20990,3,bassface,2791,62,3,3,6,50.0%,5m
20990,3,battlepants,2791,92,3,3,6,50.0%,27m
20990,1,Defection,2791,97,3,5,8,37.5%,3h
20990,2,LumDiDum,2791,86,3,9,12,25.0%,24m
20990,3,Juice,2791,30,2,2,4,50.0%,5m
20990,3,[BrnzPr]Jeffdarippa,2791,30,2,3,5,40.0%,3h
20990,3,Ferg,2791,60,2,4,6,33.3%,20m
20990,1,Tinathellama,2791,0,1,0,1,100.0%,2h
20990,1,koo,2791,48,1,1,2,50.0%,2h
20990,2,IndraRinne,2791,30,1,8,9,11.1%,31m
20990,2,Quickhitta,2791,0,0,2,2,0.0%,3h
21027,1,praz,2790,1376,80,90,170,47.1%,16m
21027,2,RaidersRoll,2790,1469,71,73,144,49.3%,6m
21027,3,Operator,2790,1026,42,33,75,56.0%,10m
21027,2,Squanchy,2790,713,31,31,62,50.0%,18m
21027,1,MaxBlazer,2790,572,21,26,47,44.7%,7m
21027,2,YuKO,2790,360,19,24,43,44.2%,18m
21027,2,[DRKRPT]QUEBEC,2790,520,18,27,45,40.0%,20m
21027,2,GLOBALXON,2790,412,17,14,31,54.8%,6m
21027,3,DaSwarm,2790,384,14,11,25,56.0%,15m
21027,3,[DRUNKK]Renzzz,2790,312,13,6,19,68.4%,17m
21027,3,mlau,2790,297,11,10,21,52.4%,2m
21027,3,[Best01]Kochito,2790,265,10,6,16,62.5%,14m
21027,2,PotatoMan,2790,242,9,11,20,45.0%,12m
21027,3,ImNotReady,2790,195,6,3,9,66.7%,21m
21027,3,ORANGEJUICE,2790,138,4,0,4,100.0%,42m
21027,3,JakeSully,2790,116,3,0,3,100.0%,32m
21027,3,zuse,2790,90,3,8,11,27.3%,38m
21027,3,KirihaKaisei,2790,60,2,2,4,50.0%,21m
21027,3,FrankPZT,2790,0,2,3,5,40.0%,14m
21027,2,ILLUMINATI,2790,42,2,5,7,28.6%,41m
21027,3,ACERTIJO,2790,0,1,2,3,33.3%,2m
21027,1,[TFinal]Lucky,2790,0,0,1,1,0.0%,57m
21027,3,Coolwhip,2790,0,0,4,4,0.0%,34m
21050,3,Lycan,2789,1627,169,146,315,53.7%,15m
21050,2,KTiuFinesse,2789,541,110,119,229,48.0%,23m
21050,3,[Rocket]Heisenberg,2789,1493,91,77,168,54.2%,15m
21050,3,[Joker1]Teppy,2789,911,37,32,69,53.6%,32m
21050,3,mikesoccer,2789,662,28,19,47,59.6%,6m
21050,3,Psyntist,2789,410,14,17,31,45.2%,11m
21050,3,[3HMONG]HmoobKiddd,2789,226,11,1,12,91.7%,21m
21050,3,[SABO]Zig,2789,303,10,6,16,62.5%,23m
21050,3,MelGibson,2789,307,10,7,17,58.8%,28m
21050,3,[NuEra]Wolf,2789,292,10,10,20,50.0%,38m
21050,2,crash,2789,222,9,7,16,56.2%,3m
21050,1,[WNTRLY]Corn,2789,282,9,22,31,29.0%,22m
21050,3,Apollo,2789,215,7,3,10,70.0%,2m
21050,3,KasSadaR,2789,179,6,4,10,60.0%,24m
21050,1,[MoMaze]captainyahhz,2789,237,6,5,11,54.5%,8m
21050,2,[HighKo]Trifolium,2789,192,6,15,21,28.6%,20m
21050,3,ROBERT,2789,90,5,1,6,83.3%,17m
21050,3,[C32G]Brisingr,2789,152,5,10,15,33.3%,37m
21050,3,toast,2789,58,3,1,4,75.0%,20m
21050,3,Nikzfi,2789,86,3,3,6,50.0%,2m
21050,3,Magistrum,2789,58,2,2,4,50.0%,24m
21050,3,CHUYACHAQUI,2789,60,2,3,5,40.0%,38m
21050,3,JAPWangjaesu,2789,58,2,4,6,33.3%,3m
21050,1,Forsaken,2789,0,1,1,2,50.0%,16m
21050,1,Henry,2789,0,1,1,2,50.0%,43m
21050,3,minimean,2789,0,1,2,3,33.3%,25m
21050,2,Ochre,2789,0,1,4,5,20.0%,26m
21050,3,asskickula,2789,0,0,1,1,0.0%,26m
21050,3,Matho,2789,0,0,1,1,0.0%,27m
21079,2,brents,2788,602,79,78,157,50.3%,31m
21079,3,Yaytec,2788,1452,65,54,119,54.6%,23m
21079,3,[USGUI]ReaDY,2788,864,49,30,79,62.0%,6m
21079,3,Vysedomo,2788,574,35,26,61,57.4%,9m
21079,3,[FIow]madSCIeNTiSt,2788,819,34,26,60,56.7%,40m
21079,3,[TCHC]Crumbs,2788,747,31,25,56,55.4%,8m
21079,2,Aqua,2788,664,27,35,62,43.5%,5m
21079,3,Marine,2788,532,19,19,38,50.0%,23m
21079,3,Azula,2788,430,17,9,26,65.4%,27m
21079,3,[NLTN]Defeater,2788,315,11,6,17,64.7%,25m
21079,3,FlutterDank,2788,316,11,7,18,61.1%,9m
21079,3,[RaWH]Thefollower,2788,288,11,11,22,50.0%,4m
21079,2,zUnOriginalz,2788,362,11,21,32,34.4%,6m
21079,3,Stevano,2788,306,10,9,19,52.6%,28m
21079,3,VotePlease,2788,216,9,4,13,69.2%,23m
21079,3,Pamelo,2788,223,9,7,16,56.2%,3m
21079,3,NewPlay,2788,198,8,6,14,57.1%,40m
21079,3,[TTKOPF]Blitztod,2788,219,8,6,14,57.1%,20m
21079,3,Schnoz,2788,220,7,5,12,58.3%,3m
21079,3,Jukex,2788,170,6,10,16,37.5%,30m
21079,3,AirForce,2788,171,5,2,7,71.4%,36m
21079,3,BarCode,2788,120,5,4,9,55.6%,27m
21079,1,DoubleSealed,2788,96,5,6,11,45.5%,16m
21079,3,bringdead,2788,131,4,0,4,100.0%,27m
21079,2,Cydpkt,2788,92,4,4,8,50.0%,14m
21079,2,[GaMTaK]TaKMashido,2788,124,4,10,14,28.6%,8m
21079,3,CptFalcon,2788,58,3,2,5,60.0%,28m
21079,2,[Deadly]SugarsFmk,2788,0,3,4,7,42.9%,18m
21079,2,lmaoball,2788,0,3,4,7,42.9%,6m
21079,3,Hegbert,2788,144,3,7,10,30.0%,33m
21079,3,Caboose,2788,30,2,1,3,66.7%,21m
21079,2,[BWLL]Marusvineyrd,2788,0,2,2,4,50.0%,3h
21079,1,[YD2K]VrgaPercutor,2788,145,2,3,5,40.0%,17m
21079,3,PIA,2788,58,2,3,5,40.0%,27m
21079,2,Saicess,2788,0,2,5,7,28.6%,12m
21079,2,Kuni,2788,89,1,1,2,50.0%,9m
21079,3,Kryptake,2788,0,0,1,1,0.0%,16m
21079,3,Geoff,2788,0,0,5,5,0.0%,4m
21117,2,[zeita1]SOYTUCACHERO,2787,1552,196,192,388,50.5%,34m
21117,2,[Cookin]Chefer,2787,1446,117,119,236,49.6%,20m
21117,3,theprobe,2787,1599,77,69,146,52.7%,22m
21117,2,HamsterNet,2787,957,74,66,140,52.9%,18m
21117,2,GuamBum,2787,725,72,49,121,59.5%,8m
21117,1,[APT8]IOnlyAMove,2787,1194,59,50,109,54.1%,13m
21117,2,Freedom,2787,1211,47,47,94,50.0%,4m
21117,2,Flatline,2787,1164,44,49,93,47.3%,9m
21117,2,MeXikO,2787,1132,41,44,85,48.2%,14m
21117,1,Virtex,2787,695,30,30,60,50.0%,29m
21117,2,Gilgamesh,2787,736,29,30,59,49.2%,30m
21117,3,Semiw,2787,575,24,18,42,57.1%,35m
21117,3,[GGK]Symmetry,2787,393,15,15,30,50.0%,35m
21117,3,[NLTN]Icebrand,2787,379,14,9,23,60.9%,24m
21117,2,[ALUST]BlG,2787,132,13,17,30,43.3%,30m
21117,1,pnwn,2787,387,12,18,30,40.0%,28m
21117,3,Brgrthemeaty,2787,286,10,10,20,50.0%,24m
21117,2,ZAKON,2787,213,9,10,19,47.4%,3h
21117,1,CCBEAR,2787,190,6,6,12,50.0%,3h
21117,1,MormonHotSau,2787,97,5,5,10,50.0%,6m
21117,3,ProXL,2787,144,5,10,15,33.3%,19m
21117,3,Noobie,2787,88,4,3,7,57.1%,2m
21117,3,ETOVE,2787,108,4,4,8,50.0%,40m
21117,3,Skaliwag,2787,58,3,2,5,60.0%,2m
21117,3,Dillon,2787,93,3,3,6,50.0%,25m
21117,2,TheDark,2787,90,3,10,13,23.1%,13m
21117,3,[michgn]Harbaugh,2787,62,2,4,6,33.3%,11m
21117,3,DEMOLIDOR,2787,112,2,6,8,25.0%,20m
21117,3,[TODD]Link,2787,0,1,0,1,100.0%,32m
21117,3,Brioche,2787,0,1,1,2,50.0%,6m
21117,1,Serral,2787,96,1,2,3,33.3%,3h
21117,3,Ham,2787,30,1,3,4,25.0%,25m
21117,3,MetalSoul,2787,0,1,4,5,20.0%,17m
21117,3,[YIFFME]GhosTe,2787,0,0,1,1,0.0%,60m
21117,3,AIVeryEasy,2787,0,0,2,2,0.0%,36m
21117,2,Alatriste,2787,0,0,6,6,0.0%,32m
21153,3,[ZTemps]Omnomnious,2786,1572,272,259,531,51.2%,32m
21153,2,[GGMESP]ShanksLeRoux,2786,1502,215,215,430,50.0%,31m
21153,1,DobleTroble,2786,1593,100,97,197,50.8%,13m
21153,3,[EpicG]Disconnected,2786,932,75,75,150,50.0%,23m
21153,3,Keyleian,2786,608,26,25,51,51.0%,22m
21153,3,LiquidSteven,2786,528,22,12,34,64.7%,2m
21153,3,[Lp]Iniwalker,2786,451,21,8,29,72.4%,33m
21153,2,[GROG]Dodec,2786,474,18,25,43,41.9%,18m
21153,3,shballa,2786,390,16,8,24,66.7%,4m
21153,3,obeyHim,2786,417,15,11,26,57.7%,16m
21153,3,[ARGENT]Khamus,2786,376,14,15,29,48.3%,23m
21153,3,[TGosuD]Warchief,2786,352,13,6,19,68.4%,8m
21153,3,DarkRushies,2786,330,11,15,26,42.3%,13m
21153,3,CJBSpender,2786,241,9,3,12,75.0%,3m
21153,2,Chort,2786,223,9,9,18,50.0%,11m
21153,3,Mexkrax,2786,241,9,9,18,50.0%,23m
21153,3,Bibbs,2786,167,5,2,7,71.4%,11m
21153,3,NewCocacola,2786,118,5,3,8,62.5%,8m
21153,3,[Snoopy]Drummerdude,2786,120,5,4,9,55.6%,13m
21153,3,[Augghh]Scorpius,2786,175,5,4,9,55.6%,38m
21153,3,myelf,2786,96,3,2,5,60.0%,3m
21153,3,kittykins,2786,0,3,2,5,60.0%,33m
21153,3,JohnKimYaY,2786,94,3,3,6,50.0%,39m
21153,3,JohnRalphio,2786,58,3,4,7,42.9%,8m
21153,2,[woot]Dshark,2786,60,3,8,11,27.3%,25m
21153,3,tonycabj,2786,60,2,2,4,50.0%,3m
21153,1,Cosmicen,2786,48,2,3,5,40.0%,1h
21153,3,KindScumbag,2786,30,2,3,5,40.0%,24m
21153,2,Seozim,2786,0,1,0,1,100.0%,17m
21153,3,palkia,2786,30,1,2,3,33.3%,42m
21153,3,maxQ,2786,0,0,1,1,0.0%,25m
21153,3,[425]MDK,2786,0,0,1,1,0.0%,28m
21185,1,[C66]Punalilikui,2785,861,180,182,362,49.7%,39m
21185,2,Falke,2785,1465,174,169,343,50.7%,41m
21185,3,SSdank,2785,1610,99,93,192,51.6%,27m
21185,3,[GdAT]WithoutAclue,2785,1293,79,69,148,53.4%,23m
21185,3,Yes,2785,596,45,43,88,51.1%,36m
21185,2,Henoir,2785,716,43,37,80,53.8%,31m
21185,3,Thomasblue,2785,705,29,22,51,56.9%,32m
21185,3,Bling,2785,632,27,18,45,60.0%,17m
21185,3,Drip,2785,573,25,12,37,67.6%,30m
21185,3,Communist,2785,432,16,10,26,61.5%,28m
21185,3,Indianadrone,2785,275,15,11,26,57.7%,30m
21185,3,[WOTDL]Laser,2785,356,13,7,20,65.0%,32m
21185,3,[Xpk]mxpandrax,2785,109,9,11,20,45.0%,8m
21185,3,vector,2785,276,9,13,22,40.9%,25m
21185,3,Fester,2785,236,8,10,18,44.4%,24m
21185,2,yeetsville,2785,207,8,10,18,44.4%,15m
21185,3,Xenon,2785,171,7,6,13,53.8%,32m
21185,3,Mophideus,2785,133,5,5,10,50.0%,33m
21185,3,Briefs,2785,177,5,5,10,50.0%,3m
21185,3,Mugetsu,2785,138,4,2,6,66.7%,24m
21185,3,Ladranix,2785,161,4,3,7,57.1%,9m
21185,3,shawwn,2785,110,3,0,3,100.0%,17m
21185,2,[blmp]Broian,2785,0,3,3,6,50.0%,30m
21185,3,Jashin,2785,121,2,2,4,50.0%,35m
21185,3,[LgnTDS]Uncensored,2785,0,2,3,5,40.0%,26m
21185,3,RotRokki,2785,0,2,3,5,40.0%,23m
21185,3,Grayskull,2785,60,2,4,6,33.3%,20m
21185,3,GiAnAkiN,2785,0,1,0,1,100.0%,38m
21185,3,Chae,2785,0,1,4,5,20.0%,4m
21185,3,Alex,2785,0,0,1,1,0.0%,1h
21185,2,sisechnik,2785,0,0,1,1,0.0%,1h
21185,2,optomus,2785,0,0,1,1,0.0%,51m
21185,3,Sebastian,2785,0,0,1,1,0.0%,32m
21185,3,Wishian,2785,0,0,1,1,0.0%,26m
21185,3,Serenity,2785,0,0,3,3,0.0%,35m
21220,2,[ValidG]SHIKA,2784,1520,179,173,352,50.9%,18m
21220,3,[NastyB]Androzeus,2784,1589,149,132,281,53.0%,40m
21220,2,Sebbie,2784,874,60,48,108,55.6%,2m
21220,3,OniiChan,2784,865,46,16,62,74.2%,10m
21220,2,NBTime,2784,768,40,36,76,52.6%,27m
21220,3,Elpatas,2784,774,32,26,58,55.2%,41m
21220,3,Draig,2784,306,15,8,23,65.2%,27m
21220,2,Prokofiev,2784,270,9,20,29,31.0%,31m
21220,3,Ares,2784,194,8,7,15,53.3%,3h
21220,2,[ReB3L]KoRe,2784,226,8,15,23,34.8%,12m
21220,3,[TRETER]Sworder,2784,60,6,7,13,46.2%,16m
21220,3,Ratjar,2784,146,6,7,13,46.2%,4m
21220,3,MAX,2784,93,5,1,6,83.3%,6m
21220,3,MagicPants,2784,42,4,3,7,57.1%,19m
21220,3,[NM8]TwinCain,2784,60,2,3,5,40.0%,16m
21220,3,Target,2784,92,2,4,6,33.3%,8m
21220,2,ToastWhisper,2784,0,2,6,8,25.0%,3h
21220,3,SNE,2784,0,1,0,1,100.0%,21m
21220,2,blaleopty,2784,0,1,0,1,100.0%,24m
21220,3,[FRDM35]Iddins,2784,0,0,1,1,0.0%,37m
21220,2,[ooPLoo]QuBuS,2784,0,0,2,2,0.0%,1h
21220,3,herOS,2784,0,0,5,5,0.0%,5m
21242,2,[SyLx]Sefussssh,2783,1253,354,349,703,50.4%,8m
21242,1,Jonman,2783,1598,327,296,623,52.5%,14m
21242,3,Neto,2783,1262,288,266,554,52.0%,33m
21242,3,Comandocesar,2783,835,136,118,254,53.5%,28m
21242,3,[UDPC]Beugsman,2783,1632,103,89,192,53.6%,3m
21242,2,Aldebaran,2783,842,89,76,165,53.9%,22m
21242,3,JavierMilei,2783,1124,67,58,125,53.6%,27m
21242,3,[126]snopon,2783,1067,49,30,79,62.0%,3m
21242,3,[ZTempz]Hawk,2783,1011,48,33,81,59.3%,8m
21242,3,shagpub,2783,519,32,24,56,57.1%,28m
21242,1,[sLuxx]Jumenta,2783,562,18,29,47,38.3%,28m
21242,3,[C2N]GeneralGnome,2783,364,14,11,25,56.0%,28m
21242,3,TecFenix,2783,376,13,14,27,48.1%,23m
21242,3,IntrepidBlue,2783,326,11,13,24,45.8%,11m
21242,2,CosmosBreack,2783,300,11,19,30,36.7%,14m
21242,3,MrTech,2783,183,8,6,14,57.1%,38m
21242,3,[Plyska]ABigPotato,2783,231,7,5,12,58.3%,2m
21242,3,xDiShPiGx,2783,173,5,1,6,83.3%,23m
21242,2,SorryForWhat,2783,96,5,1,6,83.3%,3h
21242,3,[UHBG]sobigNiuzi,2783,167,5,1,6,83.3%,33m
21242,3,StarDonkey,2783,114,5,4,9,55.6%,40m
21242,2,HoeKogan,2783,0,4,1,5,80.0%,3h
21242,3,[TMSyN]Syphylis,2783,130,3,1,4,75.0%,8m
21242,3,VeridisQuo,2783,117,3,1,4,75.0%,3m
21242,3,DireRaven,2783,30,3,5,8,37.5%,25m
21242,3,[KOTZ]Dawson,2783,30,2,3,5,40.0%,27m
21242,2,brunonasc,2783,0,2,3,5,40.0%,3h
21242,3,myniggha,2783,113,2,5,7,28.6%,19m
21242,2,MadeYouLook,2783,32,1,6,7,14.3%,34m
21242,3,tplusd,2783,0,0,1,1,0.0%,17m
21242,2,Rinzler,2783,0,0,1,1,0.0%,14m
21242,2,Effortless,2783,0,0,1,1,0.0%,59m
21242,3,[eX]saxopanda,2783,0,0,1,1,0.0%,7m
21275,2,[SINSTR]SoloWing,2782,1477,323,316,639,50.5%,11m
21275,3,Kmach,2782,1587,163,138,301,54.2%,23m
21275,3,elijk,2782,423,81,72,153,52.9%,4m
21275,3,geku,2782,1302,72,63,135,53.3%,2m
21275,2,terraqueo,2782,1141,60,56,116,51.7%,13m
21275,3,SgtMac,2782,451,58,37,95,61.1%,20m
21275,3,AceAceAceAce,2782,765,58,47,105,55.2%,19m
21275,3,lllllllllll,2782,708,38,7,45,84.4%,6m
21275,2,[XpKAc]Sher,2782,876,36,43,79,45.6%,8m
21275,2,Fulanito,2782,774,27,35,62,43.5%,7m
21275,3,[DefNot]Lacrimah,2782,320,25,18,43,58.1%,16m
21275,3,Vorazun,2782,474,23,8,31,74.2%,39m
21275,3,[EZYtgt]Torn,2782,328,11,14,25,44.0%,38m
21275,3,jhon,2782,239,8,4,12,66.7%,6m
21275,3,[Cov818]EracDrone,2782,236,8,11,19,42.1%,41m
21275,3,[fking]Gobbul,2782,178,7,9,16,43.8%,37m
21275,2,Elfuego,2782,120,7,9,16,43.8%,49m
21275,3,EvilEoz,2782,0,4,4,8,50.0%,28m
21275,3,Aarchduu,2782,60,3,2,5,60.0%,16m
21275,3,Leewey,2782,95,3,3,6,50.0%,4m
21275,3,GaboGavalo,2782,88,3,6,9,33.3%,32m
21275,3,Fitz,2782,89,2,2,4,50.0%,17m
21275,3,panda,2782,0,1,0,1,100.0%,28m
21275,3,today,2782,94,1,1,2,50.0%,15m
21275,3,XenomorpH,2782,30,1,3,4,25.0%,33m
21275,3,Solarbird,2782,30,1,3,4,25.0%,13m
21275,3,[DBers]LetsBFriends,2782,0,0,1,1,0.0%,27m
21275,3,RCPninety,2782,0,0,2,2,0.0%,3m
21303,3,marciallimon,2781,1614,357,343,700,51.0%,27m
21303,3,Spectactix,2781,1631,149,147,296,50.3%,2m
21303,2,lIIIlIIIlIII,2781,1578,96,86,182,52.7%,33m
21303,2,[KoHell]Avenger,2781,1095,58,58,116,50.0%,9m
21303,2,Archivaldo,2781,1112,57,53,110,51.8%,33m
21303,2,[waRp1]DMPlay,2781,925,51,56,107,47.7%,6m
21303,3,[OGbros]POSIDEN,2781,344,44,43,87,50.6%,24m
21303,3,DuagNada,2781,743,30,26,56,53.6%,27m
21303,3,SecondGear,2781,712,26,31,57,45.6%,6m
21303,2,Hoobawapa,2781,393,17,15,32,53.1%,41m
21303,2,potatina,2781,469,17,20,37,45.9%,31m
21303,3,PooHerder,2781,305,16,7,23,69.6%,2m
21303,3,[ZTemp]ShadowZero,2781,384,16,8,24,66.7%,13m
21303,3,Spacelord,2781,348,15,12,27,55.6%,20m
21303,1,IxooxI,2781,240,12,12,24,50.0%,35m
21303,3,rhoj,2781,303,11,6,17,64.7%,6m
21303,3,LiTrox,2781,316,11,9,20,55.0%,20m
21303,3,shiaonan,2781,174,5,4,9,55.6%,1h
21303,3,HappyBob,2781,143,5,5,10,50.0%,10m
21303,3,Pigglet,2781,144,5,8,13,38.5%,6m
21303,3,RunSCV,2781,94,4,8,12,33.3%,36m
21303,2,Cattledebt,2781,94,3,3,6,50.0%,1h
21303,1,EGDraGoNLive,2781,97,3,4,7,42.9%,3h
21303,3,DodoDumper,2781,93,2,0,2,100.0%,24m
21303,3,NotSaitama,2781,0,1,0,1,100.0%,27m
21303,2,Yololxd,2781,0,1,0,1,100.0%,15m
21303,3,lyfeofpablo,2781,0,1,2,3,33.3%,4m
21303,3,llBalanaRll,2781,30,1,2,3,33.3%,27m
21303,2,NDKyouknow,2781,0,1,3,4,25.0%,31m
21303,3,Zach,2781,30,1,6,7,14.3%,20m
21303,3,Joobian,2781,0,0,1,1,0.0%,40m
21303,3,[Chrisp]Jdog,2781,0,0,1,1,0.0%,36m
21303,3,Drfeelbad,2781,0,0,2,2,0.0%,26m
21303,3,[eX]Belle,2781,0,0,3,3,0.0%,13m
21303,2,[NLTN]GamiinYager,2781,0,0,5,5,0.0%,31m
21338,3,pushNbuttons,2780,1472,303,285,588,51.5%,32m
21338,3,IceFrog,2780,1577,189,167,356,53.1%,14m
21338,3,GuiLhotina,2780,1311,98,68,166,59.0%,40m
21338,3,Zand,2780,1217,55,37,92,59.8%,17m
21338,3,GhostWalk,2780,358,32,25,57,56.1%,9m
21338,3,Dunsidian,2780,543,23,17,40,57.5%,27m
21338,2,IcyFather,2780,269,15,7,22,68.2%,53m
21338,3,wizmander,2780,360,15,15,30,50.0%,35m
21338,3,dandan,2780,315,14,10,24,58.3%,22m
21338,3,Aither,2780,313,13,12,25,52.0%,23m
21338,3,[CRPCO]Pacha,2780,330,12,12,24,50.0%,36m
21338,3,marinking,2780,348,12,13,25,48.0%,36m
21338,3,CartonPro,2780,157,10,5,15,66.7%,21m
21338,3,leonir,2780,139,10,10,20,50.0%,23m
21338,1,Bosko,2780,233,10,11,21,47.6%,57m
21338,2,[TGosuA]Silverfox,2780,209,10,17,27,37.0%,34m
21338,3,HeyDoc,2780,226,9,9,18,50.0%,20m
21338,2,[MoreGG]KateWissen,2780,240,8,12,20,40.0%,6m
21338,3,[TuMom]NoonRising,2780,114,7,6,13,53.8%,27m
21338,1,Bountie,2780,133,6,8,14,42.9%,29m
21338,1,Vegeta,2780,169,5,6,11,45.5%,2h
21338,3,[WNTRCO]Jrblood,2780,150,5,11,16,31.2%,2m
21338,2,SeeNoEvill,2780,200,5,11,16,31.2%,31m
21338,3,[HoFoCo]spoonodoom,2780,100,4,12,16,25.0%,28m
21338,3,NutCracker,2780,30,3,4,7,42.9%,3m
21338,3,[JaMiT]Dub,2780,30,2,1,3,66.7%,5m
21338,2,SuperGrim,2780,90,2,3,5,40.0%,53m
21338,2,Soultaker,2780,30,2,4,6,33.3%,18m
21338,3,Tempo,2780,60,2,5,7,28.6%,20m
21338,3,DrManhattan,2780,96,1,1,2,50.0%,15m
21338,3,pedropsn,2780,0,0,2,2,0.0%,37m
21338,1,TOXICTURKEY,2780,0,0,2,2,0.0%,1h
21370,2,VaRooom,2779,1574,300,273,573,52.4%,20m
21370,2,GotRice,2779,1172,279,261,540,51.7%,10m
21370,3,Vládimir,2779,1537,77,66,143,53.8%,8m
21370,2,[LNTM]SpartanTy,2779,1452,60,50,110,54.5%,2m
21370,1,NoBrainTrump,2779,1482,54,63,117,46.2%,36m
21370,3,MarineThots,2779,787,36,28,64,56.2%,3m
21370,3,oATmeal,2779,705,32,28,60,53.3%,27m
21370,2,TheUndermind,2779,828,32,38,70,45.7%,10m
21370,3,EMKENS,2779,790,30,31,61,49.2%,20m
21370,2,Solindar,2779,747,28,28,56,50.0%,8m
21370,3,Nekofugu,2779,447,26,18,44,59.1%,24m
21370,3,apocalypse,2779,526,25,3,28,89.3%,30m
21370,3,DennyDeniro,2779,636,22,23,45,48.9%,5m
21370,2,HANS,2779,483,21,16,37,56.8%,9m
21370,3,Karandras,2779,186,12,5,17,70.6%,30m
21370,3,JaYu,2779,335,12,9,21,57.1%,21m
21370,3,[Xpk]NATHUS,2779,206,7,8,15,46.7%,20m
21370,3,[Ricc]ForTheBoys,2779,146,6,8,14,42.9%,13m
21370,3,Flurry,2779,193,5,6,11,45.5%,3h
21370,3,Triggered,2779,118,4,7,11,36.4%,41m
21370,2,Aldwin,2779,48,3,1,4,75.0%,3h
21370,2,Echo,2779,95,3,3,6,50.0%,1h
21370,3,BooneTheBold,2779,95,3,3,6,50.0%,26m
21370,3,peace,2779,60,2,2,4,50.0%,21m
21370,3,ZachAttack,2779,34,2,2,4,50.0%,1h
21370,3,Lock,2779,30,2,3,5,40.0%,17m
21370,3,Lastresort,2779,0,1,0,1,100.0%,33m
21370,3,Pactus,2779,30,1,1,2,50.0%,42m
21370,2,[T1G]ThatOneGuy,2779,94,1,4,5,20.0%,38m
21370,3,[DenSC2]Bear,2779,0,0,1,1,0.0%,24m
21370,2,PatataPwel,2779,0,0,2,2,0.0%,13m
21401,2,Destroyer,2778,1060,83,77,160,51.9%,33m
21401,3,WuhanPeople,2778,501,78,65,143,54.5%,30m
21401,2,BARRON,2778,1207,73,77,150,48.7%,13m
21401,3,BadFantasy,2778,1070,52,27,79,65.8%,23m
21401,3,Sapientem,2778,494,24,8,32,75.0%,41m
21401,2,Rutland,2778,516,22,33,55,40.0%,14m
21401,3,[lIIlll]lIllIlllIlll,2778,318,16,1,17,94.1%,20m
21401,1,awuacrosh,2778,318,13,12,25,52.0%,1h
21401,3,MedievalMan,2778,105,12,14,26,46.2%,21m
21401,2,Logeeker,2778,307,11,5,16,68.8%,3h
21401,3,[UpxV]goher,2778,174,11,8,19,57.9%,37m
21401,3,[PL347]QuBuS,2778,134,7,2,9,77.8%,8m
21401,2,Sky,2778,196,6,9,15,40.0%,12m
21401,3,PotatoW,2778,146,4,2,6,66.7%,33m
21401,3,[Arcus]Seritas,2778,140,4,3,7,57.1%,25m
21401,3,becojr,2778,88,4,3,7,57.1%,2m
21401,3,Alvaro,2778,94,4,6,10,40.0%,3m
21401,3,Tenamaztle,2778,120,4,7,11,36.4%,21m
21401,2,Roguenite,2778,94,3,3,6,50.0%,35m
21401,3,Jake,2778,94,3,3,6,50.0%,6m
21401,3,[detres]minyaron,2778,88,3,4,7,42.9%,5m
21401,3,[Ph15h]MrBeebop,2778,93,2,0,2,100.0%,34m
21401,3,thedesertfox,2778,117,2,2,4,50.0%,15m
21401,3,Craussie,2778,60,2,7,9,22.2%,4m
21401,2,MaximusHN,2778,30,2,8,10,20.0%,31m
21401,3,Nex,2778,0,1,0,1,100.0%,27m
21401,3,SCIIsavant,2778,0,1,0,1,100.0%,3m
21401,3,Xerith,2778,0,1,2,3,33.3%,16m
21401,3,[NZER0]Trogdar,2778,18,1,4,5,20.0%,15m
21401,3,MicroJackson,2778,30,1,4,5,20.0%,16m
21401,3,GalaxySea,2778,0,0,1,1,0.0%,35m
21401,3,Aatrex,2778,0,0,2,2,0.0%,41m
21433,2,[TXOP]Pradoxs,2777,1541,224,206,430,52.1%,27m
21433,2,[cluez]Neeb,2777,1449,122,121,243,50.2%,22m
21433,3,[CLWA]Axsalkira,2777,1426,87,100,187,46.5%,8m
21433,2,MagnusDeyker,2777,914,73,65,138,52.9%,31m
21433,1,[GeekA]NERV,2777,1278,53,58,111,47.7%,38m
21433,2,Shazmo,2777,1178,50,42,92,54.3%,13m
21433,3,Lamaza,2777,528,47,38,85,55.3%,20m
21433,3,FezWhatley,2777,951,39,31,70,55.7%,29m
21433,3,Hunk,2777,865,36,30,66,54.5%,39m
21433,3,gnostic,2777,656,31,22,53,58.5%,21m
21433,3,adamk,2777,726,31,24,55,56.4%,6m
21433,3,[OwOu]LeKenze,2777,575,29,24,53,54.7%,32m
21433,3,Jonny,2777,366,16,15,31,51.6%,43m
21433,3,tiderfra,2777,326,12,12,24,50.0%,23m
21433,2,ZergXR,2777,310,12,13,25,48.0%,18m
21433,3,Tsukidasu,2777,265,10,3,13,76.9%,34m
21433,3,Gacek,2777,266,9,6,15,60.0%,2h
21433,3,cal,2777,174,7,7,14,50.0%,23m
21433,3,Player,2777,58,6,3,9,66.7%,32m
21433,3,[UQQ2ME]BIG,2777,193,6,5,11,54.5%,35m
21433,3,[YEOBO]yeobo,2777,145,4,2,6,66.7%,45m
21433,1,Breadmaster,2777,96,4,4,8,50.0%,3h
21433,3,Vork,2777,30,4,5,9,44.4%,41m
21433,3,SirBlahDBlah,2777,58,2,4,6,33.3%,6m
21433,3,VelvetThundr,2777,58,2,5,7,28.6%,23m
21433,3,catukun,2777,30,1,4,5,20.0%,33m
21433,3,Michael,2777,0,0,1,1,0.0%,2h
21433,1,[RLA]Sheepy,2777,0,0,1,1,0.0%,2h
21433,3,[Y4NG20]DizzyRough,2777,0,0,1,1,0.0%,10m
21433,3,[WZZUP]Jammer,2777,0,0,2,2,0.0%,5m
21463,3,LittleWhiner,2776,1576,255,245,500,51.0%,8m
21463,2,DonaldTrump,2776,1495,163,153,316,51.6%,2m
21463,3,Naruhito,2776,1404,106,73,179,59.2%,40m
21463,2,[LQV]eRADICATE,2776,1049,65,62,127,51.2%,18m
21463,3,RadRx,2776,1448,63,54,117,53.8%,23m
21463,3,Apocalypse,2776,1420,56,56,112,50.0%,29m
21463,3,Elengil,2776,603,27,19,46,58.7%,25m
21463,2,Gorgoron,2776,450,27,26,53,50.9%,43m
21463,3,life,2776,351,17,9,26,65.4%,21m
21463,2,OhMyZeRo,2776,402,14,22,36,38.9%,21m
21463,3,Talos,2776,372,13,12,25,52.0%,23m
21463,1,Dmillz,2776,196,8,8,16,50.0%,14m
21463,2,Eduardo,2776,240,8,11,19,42.1%,36m
21463,3,awesome,2776,216,7,9,16,43.8%,3h
21463,3,entorpecente,2776,163,5,6,11,45.5%,27m
21463,2,InsungMungae,2776,240,5,12,17,29.4%,3h
21463,2,[CARIO]CariocoKille,2776,0,4,2,6,66.7%,1h
21463,3,Ants,2776,108,3,1,4,75.0%,21m
21463,3,AllIn,2776,115,3,1,4,75.0%,13m
21463,2,[DNKCFT]FappyToad,2776,0,3,2,5,60.0%,3h
21463,3,[GØSU]Daydream,2776,135,3,2,5,60.0%,3m
21463,2,[HDFs]dprett,2776,116,3,5,8,37.5%,38m
21463,1,Yamanouchi,2776,0,3,7,10,30.0%,27m
21463,3,WTFDUDE,2776,94,1,1,2,50.0%,11m
21463,3,[Subaru]tixop,2776,0,1,4,5,20.0%,3m
21463,1,[TheRs]Starman,2776,48,1,4,5,20.0%,1h
21463,3,[Ex7rA]Pan,2776,0,0,1,1,0.0%,26m
21463,3,NicoResko,2776,0,0,1,1,0.0%,7m
21491,3,KnightRider,2775,1337,213,179,392,54.3%,33m
21491,3,[G79]imzesok,2775,1358,106,94,200,53.0%,31m
21491,3,Sejaay,2775,1320,66,53,119,55.5%,38m
21491,3,[LagBoi]Cyberhound,2775,745,35,24,59,59.3%,27m
21491,3,[AlIin]DaBoss,2775,501,21,12,33,63.6%,38m
21491,3,[Msia]ShadowAyi,2775,238,15,10,25,60.0%,12m
21491,3,Hawk,2775,378,15,11,26,57.7%,36m
21491,2,dante,2775,393,14,19,33,42.4%,31m
21491,3,[Binghi]Ether,2775,365,12,10,22,54.5%,22m
21491,3,Captain,2775,286,11,3,14,78.6%,28m
21491,3,[PKMSSS]SUNHEE,2775,148,11,5,16,68.8%,10m
21491,1,xiaojifan,2775,237,10,12,22,45.5%,9m
21491,2,[EvilGC]Leonidas,2775,212,7,17,24,29.2%,30m
21491,3,Kibo,2775,174,6,7,13,46.2%,27m
21491,3,Stryker,2775,231,6,8,14,42.9%,28m
21491,2,xcjcx,2775,95,5,2,7,71.4%,34m
21491,3,pupperoni,2775,163,5,4,9,55.6%,6m
21491,3,BloodGang,2775,141,5,4,9,55.6%,34m
21491,2,ROADHUGGY,2775,94,4,8,12,33.3%,16m
21491,3,[AZTRO]BeakyBuzzard,2775,0,3,3,6,50.0%,23m
21491,3,[WuTang]Tofu,2775,62,3,4,7,42.9%,28m
21491,2,ThioCyanate,2775,48,3,4,7,42.9%,3h
21491,3,Zerg,2775,94,3,6,9,33.3%,36m
21491,3,[BLSHD]THEHOFF,2775,60,2,3,5,40.0%,12m
21491,3,mcxlee,2775,30,2,4,6,33.3%,25m
21491,3,schmidty,2775,0,1,0,1,100.0%,19m
21491,3,Fernandoc,2775,0,1,5,6,16.7%,35m
21491,3,Mengsk,2775,0,0,2,2,0.0%,6m
21491,3,[myLORT]Cogii,2775,0,0,3,3,0.0%,27m
21520,2,Krikri,2774,1398,108,101,209,51.7%,37m
21520,2,[Rebel]nycosborne,2774,1492,63,65,128,49.2%,16m
21520,2,Noobs,2774,1062,46,36,82,56.1%,33m
21520,3,DuMa,2774,817,37,24,61,60.7%,37m
21520,3,Strudel,2774,918,36,37,73,49.3%,30m
21520,3,[Mc]Fenrir,2774,780,31,23,54,57.4%,3m
21520,3,[CqAce]AceAceAce,2774,619,28,29,57,49.1%,6m
21520,2,[xRtG]Freedomflyer,2774,632,27,26,53,50.9%,2m
21520,3,KingsnO,2774,708,24,28,52,46.2%,20m
21520,3,Tsubasa,2774,454,22,13,35,62.9%,3m
21520,3,KalVentis,2774,616,22,21,43,51.2%,18m
21520,1,IIIllllIIlll,2774,312,13,13,26,50.0%,40m
21520,3,Luca,2774,118,7,7,14,50.0%,23m
21520,3,[Rodd]MintWizard,2774,193,5,5,10,50.0%,9m
21520,3,EARFQUAKE,2774,114,5,5,10,50.0%,21m
21520,1,Noodles,2774,143,5,5,10,50.0%,21m
21520,3,Adams,2774,120,5,8,13,38.5%,28m
21520,1,Cealer,2774,96,4,4,8,50.0%,53m
21520,1,Rags,2774,97,4,4,8,50.0%,16m
21520,3,orKisT,2774,116,4,7,11,36.4%,18m
21520,1,CandyMan,2774,121,3,1,4,75.0%,3h
21520,3,Yodaman,2774,60,3,2,5,60.0%,30m
21520,3,AlbertoHc,2774,119,3,5,8,37.5%,27m
21520,3,AHHHHHHHHHHH,2774,0,0,1,1,0.0%,23m
21520,3,ojotaAsesina,2774,0,0,1,1,0.0%,16m
21520,3,StrickNine,2774,0,0,1,1,0.0%,34m
21520,3,zstats,2774,0,0,2,2,0.0%,16m
21520,3,MechItWork,2774,0,0,5,5,0.0%,4m
21548,3,protoTYP,2773,1620,105,86,191,55.0%,27m
21548,3,NaCl,2773,430,93,77,170,54.7%,2m
21548,3,MrHacker,2773,642,90,83,173,52.0%,8m
21548,3,DEEM,2773,1233,69,67,136,50.7%,25m
21548,2,Varthlokkur,2773,817,64,63,127,50.4%,41m
21548,3,Crysis,2773,1527,63,62,125,50.4%,40m
21548,3,ChookyWonky,2773,978,49,36,85,57.6%,3m
21548,2,Alex,2773,1084,47,51,98,48.0%,16m
21548,3,[5LuGeR]Jaxo,2773,876,37,36,73,50.7%,43m
21548,2,Light,2773,768,30,33,63,47.6%,14m
21548,3,Blaster,2773,573,26,20,46,56.5%,3m
21548,3,[Pharoh]bksc,2773,572,25,21,46,54.3%,30m
21548,3,Sami,2773,456,17,16,33,51.5%,34m
21548,3,Davezis,2773,432,15,16,31,48.4%,13m
21548,3,PPA,2773,290,10,10,20,50.0%,35m
21548,3,Cheese,2773,231,7,4,11,63.6%,18m
21548,3,Cinnabun,2773,200,7,10,17,41.2%,2m
21548,1,XAAA,2773,120,5,4,9,55.6%,1h
21548,1,west,2773,97,4,4,8,50.0%,3h
21548,3,alx,2773,119,4,4,8,50.0%,4m
21548,1,qbanito,2773,145,4,5,9,44.4%,1h
21548,2,Lss,2773,0,3,3,6,50.0%,3m
21548,3,Dirt,2773,88,3,4,7,42.9%,24m
21548,1,Castrator,2773,30,3,9,12,25.0%,7m
21548,3,Metelllus,2773,0,2,3,5,40.0%,3m
21548,3,Static,2773,62,2,5,7,28.6%,40m
21548,2,[ARCHIE]AleeSxander,2773,30,2,9,11,18.2%,8m
21548,3,killa,2773,0,1,0,1,100.0%,23m
21548,3,[3DLANS]dany,2773,97,1,1,2,50.0%,3m
21548,3,Strifium,2773,0,1,2,3,33.3%,10m
21548,3,[BIaze]MilkSteak,2773,30,1,4,5,20.0%,34m
21548,3,garykim,2773,0,0,1,1,0.0%,3m
21548,3,EtHerNAlll,2773,0,0,1,1,0.0%,31m
21581,3,Lelk,2772,1614,381,353,734,51.9%,29m
21581,3,[NCIA]Jam,2772,1443,185,169,354,52.3%,28m
21581,3,[OMGAT]nickmarca,2772,1596,180,160,340,52.9%,40m
21581,3,[ph0t0n]robab,2772,1399,153,141,294,52.0%,6m
21581,3,eddy,2772,1519,92,115,207,44.4%,38m
21581,3,Roeboat,2772,1401,75,59,134,56.0%,40m
21581,3,TANKBURGER,2772,1341,70,50,120,58.3%,29m
21581,3,dtb,2772,874,49,34,83,59.0%,23m
21581,3,[ZEXT]Jorath,2772,766,34,21,55,61.8%,6m
21581,3,msowrex,2772,234,28,24,52,53.8%,32m
21581,3,Yohanimus,2772,552,19,22,41,46.3%,4m
21581,2,[UPto11]Ulcer,2772,422,14,18,32,43.8%,18m
21581,3,Waru,2772,337,13,7,20,65.0%,33m
21581,1,tough,2772,406,12,22,34,35.3%,29m
21581,3,yungkev,2772,294,10,16,26,38.5%,3m
21581,3,[FaIlen]FTWpoppy,2772,188,9,5,14,64.3%,3h
21581,3,Men,2772,202,7,7,14,50.0%,41m
21581,2,BenZin,2772,84,6,8,14,42.9%,47m
21581,3,GeneralJM,2772,159,5,2,7,71.4%,40m
21581,3,Bowen,2772,92,4,3,7,57.1%,6m
21581,1,Crash,2772,192,4,4,8,50.0%,21m
21581,2,Kyle,2772,137,4,4,8,50.0%,15m
21581,3,NoBoww,2772,113,3,0,3,100.0%,31m
21581,3,BabyZergling,2772,93,3,1,4,75.0%,6m
21581,3,Lauerto,2772,0,3,2,5,60.0%,29m
21581,3,Yolzex,2772,89,3,3,6,50.0%,23m
21581,2,[Xpk]YELSIN,2772,30,2,7,9,22.2%,8m
21581,3,superkyler,2772,0,1,1,2,50.0%,37m
21581,3,[Tflaps]Oatzor,2772,0,0,1,1,0.0%,24m
21581,3,Raccoon,2772,0,0,1,1,0.0%,2m
21581,3,[imbaGG]MVP,2772,0,0,1,1,0.0%,19m
21581,3,byzzy,2772,0,0,1,1,0.0%,23m
21581,3,oJMAOMOEKSo,2772,0,0,2,2,0.0%,3m
21581,3,scotte,2772,0,0,4,4,0.0%,41m
21615,3,Obth,2771,1606,290,279,569,51.0%,5m
21615,2,irany,2771,1507,119,118,237,50.2%,12m
21615,2,Spezialist,2771,1531,98,106,204,48.0%,13m
21615,2,SaltineBomb,2771,297,86,90,176,48.9%,25m
21615,3,BigEZ,2771,1297,58,38,96,60.4%,6m
21615,2,[ZTemps]IShootUDie,2771,1187,49,45,94,52.1%,38m
21615,3,Aldros,2771,667,31,20,51,60.8%,40m
21615,3,[DANKEM]Cæsarius,2771,537,26,11,37,70.3%,3m
21615,1,PBcrusTLesSs,2771,756,25,36,61,41.0%,15m
21615,3,Electro,2771,256,16,16,32,50.0%,2m
21615,3,FunkyMonk,2771,81,16,20,36,44.4%,37m
21615,3,victorinox,2771,238,15,7,22,68.2%,11m
21615,3,panico,2771,294,11,12,23,47.8%,40m
21615,3,EhWhoAmI,2771,266,10,6,16,62.5%,25m
21615,3,[LKTNES]ONE,2771,232,7,4,11,63.6%,1h
21615,3,cyclohexane,2771,130,6,6,12,50.0%,13m
21615,3,Mescaline,2771,174,6,8,14,42.9%,23m
21615,3,EUisbetter,2771,86,5,5,10,50.0%,9m
21615,2,Spocchio,2771,132,5,6,11,45.5%,27m
21615,2,[MDWST]Krezz,2771,141,4,4,8,50.0%,3h
21615,1,KGKoala,2771,218,4,8,12,33.3%,25m
21615,3,Brachydios,2771,112,3,0,3,100.0%,25m
21615,2,NetthO,2771,0,3,2,5,60.0%,3h
21615,3,blue,2771,109,3,3,6,50.0%,23m
21615,3,Mateo,2771,60,3,3,6,50.0%,25m
21615,3,Osiris,2771,0,2,3,5,40.0%,33m
21615,3,[DBZK]TheKhala,2771,0,1,0,1,100.0%,22m
21615,3,[GnR]Baratheon,2771,0,1,0,1,100.0%,34m
21615,3,[C0RB]Xerfel,2771,0,1,1,2,50.0%,40m
21615,3,OrthESius,2771,95,1,1,2,50.0%,12m
21615,3,AlanHG,2771,0,0,1,1,0.0%,24m
21615,3,GgCheapShot,2771,0,0,1,1,0.0%,26m
21615,3,Desh,2771,0,0,4,4,0.0%,33m
21648,3,FahrenHeit,2770,1541,190,162,352,54.0%,23m
21648,1,[TGosuD]Lakattack,2770,1408,123,114,237,51.9%,15m
21648,2,Dooby,2770,1023,83,52,135,61.5%,14m
21648,3,[HØST]URIEL,2770,1436,79,58,137,57.7%,4m
21648,1,ODSTJacob,2770,1341,72,78,150,48.0%,9m
21648,3,Bunkers,2770,1415,65,41,106,61.3%,10m
21648,2,HowSad,2770,960,55,54,109,50.5%,31m
21648,2,GhostPants,2770,1320,48,55,103,46.6%,31m
21648,2,Román,2770,1076,47,40,87,54.0%,27m
21648,3,rage,2770,852,41,27,68,60.3%,23m
21648,2,Zatrux,2770,953,37,38,75,49.3%,33m
21648,3,AvengingNut,2770,617,31,35,66,47.0%,23m
21648,3,Harm,2770,726,28,29,57,49.1%,40m
21648,3,RelieF,2770,491,18,16,34,52.9%,4m
21648,3,GQD,2770,397,14,11,25,56.0%,4m
21648,3,[MITO22]Stepbrother,2770,247,12,2,14,85.7%,37m
21648,3,hardwork,2770,303,11,6,17,64.7%,41m
21648,3,ArkKnight,2770,264,9,12,21,42.9%,15m
21648,3,margincall,2770,207,7,3,10,70.0%,8m
21648,3,MotherRussia,2770,114,4,6,10,40.0%,16m
21648,3,Yarik,2770,134,3,1,4,75.0%,23m
21648,3,JimRayner,2770,132,3,2,5,60.0%,30m
21648,3,LquidPoo,2770,0,3,2,5,60.0%,34m
21648,3,Mars,2770,115,2,1,3,66.7%,14m
21648,3,[Yuko]Chiristinayo,2770,0,2,3,5,40.0%,29m
21648,3,zeratul,2770,58,2,6,8,25.0%,2m
21648,1,BioDaddy,2770,96,2,6,8,25.0%,1h
21648,2,DIO,2770,88,2,7,9,22.2%,5m
21648,2,StixZadinia,2770,62,2,9,11,18.2%,31m
21648,3,[GDUP]Mordecai,2770,0,1,1,2,50.0%,39m
21648,3,Logan,2770,0,1,3,4,25.0%,37m
21648,3,AFstephen,2770,0,0,1,1,0.0%,19m
21648,3,[LTlord]guterfosh,2770,0,0,1,1,0.0%,41m
21648,1,[AEBC]Feanor,2770,0,0,2,2,0.0%,30m
21648,3,[GRLG]Radclyffe,2770,0,0,2,2,0.0%,5m
21648,3,[Twtn]AntonyCq,2770,0,0,2,2,0.0%,29m
21684,3,Rollins,2769,1000,248,227,475,52.2%,5m
21684,2,Orgulthar,2769,1512,204,178,382,53.4%,11m
21684,3,chaval,2769,1431,123,112,235,52.3%,6m
21684,3,[Mriola]Zid,2769,1460,88,84,172,51.2%,21m
21684,2,[ChronB]BabySmuggler,2769,1273,65,64,129,50.4%,8m
21684,3,Huitza,2769,1120,57,44,101,56.4%,20m
21684,3,Ostrich,2769,571,40,25,65,61.5%,32m
21684,3,GunMaster,2769,842,34,32,66,51.5%,29m
21684,3,[RPL]cLinto,2769,684,29,23,52,55.8%,36m
21684,3,[YCP]BossLI,2769,556,27,12,39,69.2%,8m
21684,3,[sk3tch]TwiX,2769,463,22,18,40,55.0%,24m
21684,3,[Picard]NterpriseNCC,2769,515,20,18,38,52.6%,27m
21684,3,[Stale]YaBoiJohn,2769,530,20,19,39,51.3%,3m
21684,3,[AGHS]heby,2769,436,18,12,30,60.0%,24m
21684,3,Sareth,2769,419,18,13,31,58.1%,35m
21684,2,[THlNG]BLFUmoocow,2769,251,14,21,35,40.0%,6m
21684,3,Stuntin,2769,264,10,4,14,71.4%,41m
21684,3,[LoF]FlashLight,2769,241,8,5,13,61.5%,23m
21684,3,DANN,2769,208,8,10,18,44.4%,17m
21684,3,aquamarine,2769,231,7,7,14,50.0%,14m
21684,1,SweetGoggles,2769,155,6,5,11,54.5%,3h
21684,3,[MHI]Bjornfort,2769,194,6,8,14,42.9%,19m
21684,2,BelowAverage,2769,94,3,3,6,50.0%,59m
21684,1,[DarQ]Lecompton,2769,0,3,4,7,42.9%,41m
21684,3,Radioactive,2769,110,3,5,8,37.5%,4m
21684,3,JheyssonVII,2769,88,2,0,2,100.0%,24m
21684,3,[XDRAX8]Faraoh,2769,0,2,3,5,40.0%,3m
21684,3,[LEBL]Master,2769,0,1,3,4,25.0%,38m
21684,3,schonsten,2769,0,1,3,4,25.0%,1h
21684,3,xmvc,2769,0,0,2,2,0.0%,24m
21714,3,[INextI]Shadow,2768,1540,218,211,429,50.8%,30m
21714,3,cholo,2768,765,152,139,291,52.2%,14m
21714,2,DankCrank,2768,1560,82,79,161,50.9%,2m
21714,3,PGABlack,2768,1236,68,51,119,57.1%,10m
21714,2,Cowclops,2768,1357,68,69,137,49.6%,5m
21714,2,[XpKAc]WolfComando,2768,459,65,62,127,51.2%,13m
21714,2,Tyler,2768,1451,58,56,114,50.9%,23m
21714,3,troll,2768,446,50,32,82,61.0%,33m
21714,2,CuteNoobT,2768,1067,44,39,83,53.0%,11m
21714,3,GlamisOG,2768,231,39,41,80,48.8%,41m
21714,3,VanLeonidas,2768,585,38,24,62,61.3%,25m
21714,2,Fenixfallen,2768,934,38,34,72,52.8%,32m
21714,1,IamMachine,2768,383,33,42,75,44.0%,4m
21714,2,medmed,2768,856,32,33,65,49.2%,33m
21714,3,Terrano,2768,678,30,21,51,58.8%,36m
21714,3,[AD3C]TIBURSIO,2768,373,19,11,30,63.3%,27m
21714,3,[sk3tch]Lowko,2768,532,19,20,39,48.7%,24m
21714,3,Pablo,2768,352,13,8,21,61.9%,27m
21714,3,mcnugger,2768,297,12,7,19,63.2%,9m
21714,3,Dyucrane,2768,288,10,11,21,47.6%,24m
21714,3,Jhakir,2768,191,7,2,9,77.8%,24m
21714,3,LaPolitesse,2768,167,7,6,13,53.8%,20m
21714,3,JoeMama,2768,193,6,4,10,60.0%,14m
21714,3,EVAG,2768,195,6,5,11,54.5%,3m
21714,3,[HnTr]PhillyGunna,2768,211,6,6,12,50.0%,6m
21714,3,[StrWnd]Hucklebeary,2768,167,6,8,14,42.9%,9m
21714,3,INfalible,2768,131,5,3,8,62.5%,28m
21714,3,[GGBaka]DJRADE,2768,176,5,5,10,50.0%,49m
21714,3,SpaceForceII,2768,30,4,4,8,50.0%,23m
21714,2,Braaap,2768,120,4,8,12,33.3%,3m
21714,3,kalvin,2768,96,2,0,2,100.0%,16m
21714,3,HotdogFinger,2768,58,2,5,7,28.6%,30m
21714,3,bub,2768,93,1,1,2,50.0%,3m
21714,3,Zim,2768,30,1,2,3,33.3%,15m
21714,3,IIIIIIIII,2768,30,1,2,3,33.3%,8m
21714,3,Metric,2768,0,1,4,5,20.0%,3m
21714,1,aleiux,2768,0,1,6,7,14.3%,1h
21714,2,OperationSC,2768,0,0,1,1,0.0%,3h
21714,3,dgs,2768,0,0,1,1,0.0%,41m
21714,3,[WNTRGC]Rageamon,2768,0,0,2,2,0.0%,40m
21714,3,[WO0K]SpinDrs,2768,0,0,3,3,0.0%,21m
21714,3,Regis,2768,0,0,5,5,0.0%,41m
21756,3,speaknow,2767,1342,66,74,140,47.1%,17m
21756,2,zojefski,2767,474,61,58,119,51.3%,37m
21756,3,Bekusa,2767,343,32,37,69,46.4%,30m
21756,3,PhoenixRises,2767,416,15,16,31,48.4%,5m
21756,3,YuYuu,2767,327,12,9,21,57.1%,16m
21756,3,[PROG]chaplin,2767,245,12,10,22,54.5%,3m
21756,2,[soplop]GGnRtodos,2767,248,9,10,19,47.4%,10m
21756,3,Archangelmoo,2767,256,8,6,14,57.1%,41m
21756,3,stackof,2767,223,8,7,15,53.3%,27m
21756,3,letrusscook,2767,180,7,6,13,53.8%,8m
21756,3,Alucard,2767,146,6,5,11,54.5%,35m
21756,3,BOBSOAR,2767,154,5,1,6,83.3%,38m
21756,2,Edoras,2767,188,5,4,9,55.6%,23m
21756,1,Gabriel,2767,97,4,4,8,50.0%,41m
21756,3,Splitt,2767,58,3,2,5,60.0%,28m
21756,2,DariusKLS,2767,95,2,2,4,50.0%,1h
21756,3,Barcode,2767,30,1,2,3,33.3%,27m
21756,2,[BYOD]grass,2767,48,1,2,3,33.3%,3h
21756,3,Spinel,2767,0,0,1,1,0.0%,3m
21756,3,NationalFire,2767,0,0,1,1,0.0%,4m
21756,3,Raffi,2767,0,0,2,2,0.0%,3m
21777,2,MacDaddy,2766,1485,213,196,409,52.1%,16m
21777,2,PremisseS,2766,1502,120,118,238,50.4%,8m
21777,2,CaptMoroni,2766,1541,114,112,226,50.4%,33m
21777,3,ndlozano,2766,1000,54,32,86,62.8%,25m
21777,3,SrRéquiem,2766,1214,46,56,102,45.1%,27m
21777,3,Ethann,2766,864,44,23,67,65.7%,35m
21777,2,lllllllllIll,2766,704,37,40,77,48.1%,25m
21777,3,Sirmagicman,2766,551,24,14,38,63.2%,21m
21777,3,[LMI42]DENNIS,2766,480,18,22,40,45.0%,3m
21777,3,BonerGuideMe,2766,407,16,14,30,53.3%,27m
21777,3,Rainmaker,2766,316,15,9,24,62.5%,32m
21777,2,[xiuer]Tiger,2766,350,15,17,32,46.9%,15m
21777,2,Monty,2766,438,15,23,38,39.5%,14m
21777,2,[BNat]Sankara,2766,334,12,19,31,38.7%,18m
21777,3,Azuna,2766,183,10,5,15,66.7%,3m
21777,3,Half,2766,149,6,0,6,100.0%,20m
21777,2,Kajing,2766,174,6,13,19,31.6%,14m
21777,3,[UpxV]PAINKILLER,2766,116,5,6,11,45.5%,21m
21777,3,[KnG]BunShow,2766,19,4,8,12,33.3%,38m
21777,3,lato,2766,90,3,4,7,42.9%,12m
21777,3,[BRSKR]WookieMonsta,2766,94,2,0,2,100.0%,6m
21777,3,[kokisa]Kotomi,2766,60,2,7,9,22.2%,8m
21777,3,Abbakus,2766,123,2,7,9,22.2%,3h
21777,3,[VECT]seanzor,2766,0,1,0,1,100.0%,24m
21777,3,SixtyNine,2766,0,1,0,1,100.0%,38m
21777,3,[PISCO]CAPITAN,2766,0,1,1,2,50.0%,23m
21777,3,[GldBoy]Carson,2766,0,1,4,5,20.0%,24m
21777,3,JapupampaMan,2766,30,1,7,8,12.5%,16m
21777,3,Heero,2766,0,0,1,1,0.0%,20m
21777,3,[TX8]Gomper,2766,0,0,1,1,0.0%,36m
21777,3,Drew,2766,0,0,2,2,0.0%,23m
21777,2,kron,2766,0,0,2,2,0.0%,1h
21777,3,Paracosmic,2766,0,0,3,3,0.0%,27m
21810,2,[FORCE9]MARINER,2765,1581,432,392,824,52.4%,27m
21810,1,Haxpath,2765,1528,301,290,591,50.9%,5m
21810,1,StormTrooper,2765,1234,131,120,251,52.2%,26m
21810,3,willyam,2765,1491,122,97,219,55.7%,35m
21810,2,Striggy,2765,924,118,125,243,48.6%,31m
21810,3,conkdean,2765,1581,105,93,198,53.0%,8m
21810,3,markdos,2765,1161,53,37,90,58.9%,14m
21810,3,BARCODE,2765,1152,50,38,88,56.8%,28m
21810,3,[PiN0YS]TantanPH,2765,318,50,44,94,53.2%,4m
21810,1,[NOBDGR]QBLA,2765,1206,49,59,108,45.4%,32m
21810,3,schmike,2765,887,39,32,71,54.9%,8m
21810,3,[MCGBRO]STRGTHNHNR,2765,853,37,28,65,56.9%,17m
21810,3,Cixelsyd,2765,476,31,29,60,51.7%,10m
21810,1,vvvscs,2765,363,27,40,67,40.3%,7m
21810,3,Xists,2765,601,25,21,46,54.3%,3m
21810,2,[PNboyz]PiNNacleDMG,2765,546,20,24,44,45.5%,12m
21810,3,valeragf,2765,175,15,17,32,46.9%,22m
21810,3,DeutschMark,2765,328,14,5,19,73.7%,4m
21810,1,spockley,2765,378,14,16,30,46.7%,26m
21810,1,itsanap,2765,201,8,7,15,53.3%,31m
21810,2,bukubadguy,2765,248,8,16,24,33.3%,33m
21810,2,ReggaeShark,2765,208,7,12,19,36.8%,20m
21810,3,HenriqueFS,2765,150,6,9,15,40.0%,21m
21810,3,BaliHai,2765,138,3,3,6,50.0%,39m
21810,3,LazyTitan,2765,30,3,4,7,42.9%,22m
21810,3,kratos,2765,30,2,3,5,40.0%,32m
21810,1,painkiller,2765,144,2,3,5,40.0%,15m
21810,2,Aiursengard,2765,0,1,0,1,100.0%,1h
21810,3,[PrA26]Levftraru,2765,0,1,2,3,33.3%,24m
21810,3,LoneWolf,2765,0,1,4,5,20.0%,12m
21810,2,blazexoutlaw,2765,0,0,1,1,0.0%,35m
21810,3,kris,2765,0,0,2,2,0.0%,37m
21842,3,[WASM]Buster,2764,1489,83,80,163,50.9%,9m
21842,3,Icarus,2764,1296,74,70,144,51.4%,12m
21842,3,[SABO]Alditux,2764,650,32,16,48,66.7%,35m
21842,3,[GGF]Gfnk,2764,684,32,17,49,65.3%,40m
21842,3,lHARDCOREl,2764,580,29,15,44,65.9%,41m
21842,3,[AiMB]ASH,2764,618,26,18,44,59.1%,14m
21842,3,yabuyabu,2764,550,24,21,45,53.3%,32m
21842,3,Brickashaw,2764,539,22,22,44,50.0%,8m
21842,3,dig,2764,638,22,25,47,46.8%,32m
21842,2,Nick,2764,107,21,24,45,46.7%,8m
21842,3,Axe,2764,372,16,15,31,51.6%,3m
21842,3,ImperialYT,2764,410,15,10,25,60.0%,19m
21842,2,[sc2ele]xpo,2764,378,14,18,32,43.8%,38m
21842,3,[sk3tch]TokesMcGanja,2764,145,12,7,19,63.2%,2m
21842,3,DildoSaggins,2764,321,12,12,24,50.0%,27m
21842,2,Canister,2764,215,10,8,18,55.6%,28m
21842,3,[JUGOSH]brianxd,2764,230,9,10,19,47.4%,6m
21842,3,Toxic,2764,223,7,8,15,46.7%,29m
21842,3,[UpxV]Ehécatl,2764,30,4,4,8,50.0%,16m
21842,3,TimStodz,2764,113,2,1,3,66.7%,29m
21842,3,Mordred,2764,30,2,2,4,50.0%,13m
21842,1,CerBerUs,2764,48,2,3,5,40.0%,7m
21842,3,[XpKAc]TnteManteca,2764,34,2,3,5,40.0%,1h
21842,3,[TheLP]Jdog,2764,62,2,4,6,33.3%,14m
21842,3,deadboltz,2764,0,1,1,2,50.0%,4m
21842,3,[R32]Herb,2764,0,0,1,1,0.0%,15m
21842,3,Quetzalcoatl,2764,0,0,1,1,0.0%,23m
21842,3,[DHZ0ne]cyborg,2764,0,0,2,2,0.0%,3m
21842,3,Terranimo,2764,0,0,2,2,0.0%,16m
21842,3,gamepadAKU,2764,0,0,3,3,0.0%,36m
21872,1,PnZareCheats,2763,660,163,153,316,51.6%,29m
21872,2,eastcommon,2763,1448,84,82,166,50.6%,3m
21872,3,[HMTeam]KoyaTeckKpv,2763,981,51,32,83,61.4%,3m
21872,3,ShekHess,2763,848,32,28,60,53.3%,34m
21872,3,valentino,2763,614,28,18,46,60.9%,27m
21872,2,[FFAA]Sico,2763,658,23,26,49,46.9%,31m
21872,3,Pogo,2763,460,17,14,31,54.8%,3m
21872,3,Husker,2763,240,10,2,12,83.3%,9m
21872,3,[IoO7]Gweetarist,2763,203,6,4,10,60.0%,12m
21872,3,Sgnimm,2763,116,5,4,9,55.6%,9m
21872,3,CHILLING,2763,165,4,3,7,57.1%,8m
21872,2,FlashRevs,2763,30,4,4,8,50.0%,12m
21872,3,Mortalitor,2763,88,3,5,8,37.5%,4m
21872,1,[C22]Hellbreaker,2763,119,2,1,3,66.7%,3h
21872,3,Haywire,2763,0,1,0,1,100.0%,23m
21872,3,blastandfast,2763,0,1,1,2,50.0%,28m
21872,1,Kafu,2763,48,1,1,2,50.0%,57m
21872,3,[H1M1D]Jonny,2763,95,1,2,3,33.3%,23m
21872,3,SirMarc,2763,0,0,1,1,0.0%,23m
21872,2,BigUzii,2763,0,0,1,1,0.0%,1h
21872,3,wuichu,2763,0,0,3,3,0.0%,24m
21872,2,[GGMESP]SNELX,2763,0,0,7,7,0.0%,7m
21894,1,[0825]King,2762,1581,133,129,262,50.8%,28m
21894,3,Laughingman,2762,855,123,114,237,51.9%,4m
21894,3,[S4LMON]Khaztr,2762,724,119,113,232,51.3%,30m
21894,2,Thisguy,2762,1529,102,107,209,48.8%,31m
21894,3,FluffyBois,2762,948,71,60,131,54.2%,25m
21894,3,[valhal]Tholstein,2762,469,30,16,46,65.2%,9m
21894,2,[XDRAX8]GenRommel,2762,544,19,30,49,38.8%,38m
21894,3,[PSlSTC]reaper,2762,339,13,14,27,48.1%,34m
21894,3,HULKAMANIA,2762,342,12,7,19,63.2%,33m
21894,3,Vortextron,2762,97,11,5,16,68.8%,38m
21894,3,newbie,2762,189,6,3,9,66.7%,33m
21894,3,jnpzc,2762,151,5,1,6,83.3%,12m
21894,1,BigB,2762,184,5,6,11,45.5%,55m
21894,3,[ABSLT]Vira,2762,132,4,1,5,80.0%,17m
21894,3,[DryHop]wolfjack,2762,162,4,4,8,50.0%,34m
21894,3,Murkinator,2762,93,3,3,6,50.0%,16m
21894,3,[Th3Bad]VerdinShow,2762,126,3,4,7,42.9%,8m
21894,3,[CLAM]Clam,2762,146,3,6,9,33.3%,6m
21894,3,Drake,2762,120,2,3,5,40.0%,13m
21894,3,botoxman,2762,0,1,0,1,100.0%,34m
21894,3,lasag,2762,0,1,1,2,50.0%,41m
21894,3,Deathwing,2762,0,1,3,4,25.0%,11m
21894,3,[Growl]Kjal,2762,30,1,3,4,25.0%,5m
21894,3,ClubGlam,2762,0,0,1,1,0.0%,4m
21894,3,FULLNA,2762,0,0,1,1,0.0%,23m
21894,3,Bulletproof,2762,0,0,2,2,0.0%,2m
21894,2,DraboK,2762,0,0,2,2,0.0%,53m
21894,2,BlowinWater,2762,0,0,3,3,0.0%,59m
21894,3,Shattered,2762,0,0,5,5,0.0%,23m
21923,1,volker,2761,1397,147,150,297,49.5%,22m
21923,1,Edril,2761,1595,139,155,294,47.3%,30m
21923,3,liva,2761,780,87,74,161,54.0%,15m
21923,3,luffy,2761,464,60,47,107,56.1%,20m
21923,2,GGOAT,2761,1219,51,51,102,50.0%,10m
21923,3,GhostDog,2761,903,37,30,67,55.2%,39m
21923,3,Ilúvatar,2761,754,30,26,56,53.6%,23m
21923,3,[KOUNC]Real,2761,782,29,30,59,49.2%,41m
21923,2,Morringan,2761,509,23,24,47,48.9%,25m
21923,3,[M3A5]ARTANIS,2761,316,18,13,31,58.1%,37m
21923,3,Anarki,2761,371,15,12,27,55.6%,14m
21923,3,GanSuMao,2761,370,12,17,29,41.4%,20m
21923,2,JuhwanJeong,2761,238,8,17,25,32.0%,23m
21923,3,Entropy,2761,175,6,7,13,46.2%,25m
21923,2,[SuperZ]KillerCraft,2761,128,6,7,13,46.2%,38m
21923,3,mEDiocrLemur,2761,159,4,2,6,66.7%,33m
21923,2,LeChatBach,2761,139,4,4,8,50.0%,3h
21923,1,VladNastase,2761,122,4,5,9,44.4%,3h
21923,3,[CBAS]chessiiimate,2761,146,3,3,6,50.0%,3m
21923,3,LANDAZAR,2761,60,3,4,7,42.9%,32m
21923,3,Dusk,2761,0,1,0,1,100.0%,8m
21923,3,Qrou,2761,0,0,1,1,0.0%,20m
21923,3,James,2761,0,0,1,1,0.0%,23m
21923,2,YogurtEater,2761,0,0,2,2,0.0%,3h
21923,2,RoughDayTeam,2761,0,0,2,2,0.0%,3h
21923,3,Jorge,2761,0,0,3,3,0.0%,4m
21923,3,[eX]FnX,2761,0,0,5,5,0.0%,28m
21950,3,AdamTheMeta,2760,561,56,46,102,54.9%,21m
21950,3,Rain,2760,1068,49,40,89,55.1%,8m
21950,3,Absolute,2760,841,40,45,85,47.1%,3m
21950,3,Chp,2760,804,34,28,62,54.8%,30m
21950,3,LittlePants,2760,470,17,14,31,54.8%,37m
21950,3,MXDANIEL,2760,234,16,19,35,45.7%,12m
21950,2,Toph,2760,386,13,18,31,41.9%,8m
21950,3,Dogo,2760,222,11,4,15,73.3%,10m
21950,3,sinear,2760,109,10,5,15,66.7%,34m
21950,3,ConVexPrime,2760,251,8,5,13,61.5%,17m
21950,3,[LGNxx]klanosk,2760,245,8,7,15,53.3%,28m
21950,1,[antich]LANDRAIDER,2760,152,4,4,8,50.0%,21m
21950,3,[ValidG]MetriC,2760,116,3,0,3,100.0%,23m
21950,3,[O6ama]CatStrom,2760,0,3,3,6,50.0%,6m
21950,3,TheBazinga,2760,88,2,0,2,100.0%,23m
21950,3,[Osexc]Ovensniffer,2760,30,2,1,3,66.7%,33m
21950,2,HenryG,2760,120,2,4,6,33.3%,52m
21950,3,ivan,2760,0,1,1,2,50.0%,8m
21950,3,LineTwist,2760,0,0,1,1,0.0%,19m
21950,3,[LSHLD]DeadpoolMX,2760,0,0,1,1,0.0%,3m
21950,3,RICHMOND,2760,0,0,2,2,0.0%,15m
21950,3,JusticeBunny,2760,0,0,3,3,0.0%,3h
21972,2,Davott,2759,1553,208,203,411,50.6%,31m
21972,2,orz,2759,1498,135,129,264,51.1%,3m
21972,2,[QMS]TRILL,2759,1201,122,120,242,50.4%,19m
21972,3,[FEEC]Ogov,2759,1398,105,96,201,52.2%,35m
21972,3,entropi,2759,908,101,80,181,55.8%,30m
21972,1,Tomatoron,2759,1587,98,86,184,53.3%,35m
21972,3,Ragna,2759,890,50,34,84,59.5%,37m
21972,2,Ares,2759,920,34,44,78,43.6%,2m
21972,3,Nautilus,2759,356,13,10,23,56.5%,4m
21972,3,[SC2PH]Jrdbulatich,2759,174,6,9,15,40.0%,36m
21972,3,[Mago]Mago,2759,118,5,4,9,55.6%,3m
21972,1,notmaster,2759,215,4,3,7,57.1%,1h
21972,1,BoxBox,2759,36,2,2,4,50.0%,1h
21972,1,Ranger,2759,0,2,3,5,40.0%,1h
21972,1,IlIllllIII,2759,44,1,2,3,33.3%,1h
21972,3,[GRAPEZ]NoobPWNzor,2759,0,1,2,3,33.3%,3m
21972,1,Cowboy,2759,0,0,1,1,0.0%,21m
21972,3,LargePelican,2759,0,0,2,2,0.0%,20m
21990,2,Blacky,2758,1533,104,97,201,51.7%,39m
21990,3,[YKJK]thunderman,2758,1194,56,52,108,51.9%,39m
21990,1,FromParis,2758,1536,56,71,127,44.1%,30m
21990,3,[Golds]HelloThere,2758,463,48,39,87,55.2%,27m
21990,2,BWS,2758,780,35,71,106,33.0%,37m
21990,3,[GGMESP]RoseewalQloO,2758,617,34,22,56,60.7%,8m
21990,3,Chema,2758,680,30,24,54,55.6%,20m
21990,3,EzRoll,2758,153,19,21,40,47.5%,35m
21990,3,Felix,2758,244,11,4,15,73.3%,19m
21990,3,[TBLP]Brutus,2758,223,9,9,18,50.0%,59m
21990,3,MajorHoots,2758,239,9,10,19,47.4%,1h
21990,2,Fengtree,2758,210,8,9,17,47.1%,47m
21990,3,bloop,2758,202,7,8,15,46.7%,28m
21990,3,Bean,2758,210,7,12,19,36.8%,41m
21990,1,xDiShPiGx,2758,168,6,0,6,100.0%,3h
21990,3,liszt,2758,150,6,9,15,40.0%,32m
21990,1,[ZTempz]Mike,2758,153,5,4,9,55.6%,30m
21990,3,DKR,2758,144,5,8,13,38.5%,25m
21990,3,Yangkai,2758,136,4,3,7,57.1%,37m
21990,2,KOMODODRAGON,2758,30,4,5,9,44.4%,40m
21990,1,[TK3]FdGodVinc,2758,118,3,3,6,50.0%,1h
21990,1,[DoRQ]RionSnow,2758,0,2,3,5,40.0%,34m
21990,1,CmdrYamato,2758,0,1,0,1,100.0%,33m
21990,1,Grampz,2758,0,0,1,1,0.0%,3h
21990,2,[nomame]FuzzyMittens,2758,0,0,3,3,0.0%,36m
22015,3,chafanet,2757,1565,315,314,629,50.1%,41m
22015,1,DangDuc,2757,1653,83,69,152,54.6%,9m
22015,2,Campbell,2757,1358,51,56,107,47.7%,15m
22015,3,Tycho,2757,568,23,17,40,57.5%,6m
22015,3,Twohey,2757,421,17,12,29,58.6%,35m
22015,3,[TELA]NabsPietrO,2757,432,16,18,34,47.1%,27m
22015,2,Kuho,2757,375,15,17,32,46.9%,17m
22015,3,[E2E]PABON,2757,338,13,8,21,61.9%,38m
22015,3,[SCST]gerrer,2757,339,12,10,22,54.5%,8m
22015,3,toks,2757,268,10,11,21,47.6%,22m
22015,3,[AiMB]BiggaJigga,2757,272,10,11,21,47.6%,28m
22015,2,chibs,2757,150,6,12,18,33.3%,8m
22015,3,Joannaho,2757,177,5,5,10,50.0%,16m
22015,2,Tastyone,2757,0,4,2,6,66.7%,54m
22015,2,Paxters,2757,180,4,6,10,40.0%,17m
22015,3,streeD,2757,180,4,12,16,25.0%,22m
22015,2,flatboy,2757,0,3,3,6,50.0%,3h
22015,3,NunGaru,2757,0,3,3,6,50.0%,4m
22015,3,[SKyber]Hiperpawn,2757,95,2,3,5,40.0%,23m
22015,1,iogo,2757,0,2,3,5,40.0%,3h
22015,1,ShoWTimEFaN,2757,0,2,3,5,40.0%,6m
22015,1,Azaeraith,2757,0,2,4,6,33.3%,3h
22015,3,[LOHd]NeOJbenz,2757,0,1,1,2,50.0%,38m
22015,1,Venom,2757,0,0,1,1,0.0%,1h
22015,1,Venom,2757,0,0,5,5,0.0%,1h
22040,2,[chzbyz]iDunWanaDiee,2756,1549,272,264,536,50.7%,9m
22040,2,[JABW]YaoiMin,2756,1305,148,130,278,53.2%,41m
22040,3,[PpK69]MrLycra,2756,1414,128,108,236,54.2%,23m
22040,2,Serral,2756,1268,107,80,187,57.2%,41m
22040,3,MrWipeOut,2756,902,35,38,73,47.9%,22m
22040,3,Snapdragon,2756,697,30,29,59,50.8%,23m
22040,3,Xkrowth,2756,707,29,24,53,54.7%,4m
22040,3,KrillinSucks,2756,483,18,15,33,54.5%,12m
22040,2,[ThCORE]mellooyelloo,2756,362,12,22,34,35.3%,21m
22040,3,[nMMA]Guigows,2756,288,10,12,22,45.5%,43m
22040,3,[DarkPG]DabMax,2756,254,9,13,22,40.9%,20m
22040,1,Unreliable,2756,208,7,6,13,53.8%,3h
22040,3,[TGCF]baddriver,2756,172,6,7,13,46.2%,40m
22040,3,Lehzee,2756,180,6,11,17,35.3%,37m
22040,1,blackjack,2756,190,5,3,8,62.5%,14m
22040,1,Teajang,2756,142,5,6,11,45.5%,3h
22040,3,LHTS,2756,152,5,10,15,33.3%,27m
22040,2,TWre,2756,0,4,6,10,40.0%,1h
22040,2,NuclearGoo,2756,95,3,3,6,50.0%,7m
22040,3,[FLOW1]RickHunter,2756,0,0,4,4,0.0%,32m
22060,3,IIIIIIIIIIII,2755,1500,742,735,1477,50.2%,18m
22060,1,Cabrinha,2755,732,269,255,524,51.3%,32m
22060,2,BeastaLaMode,2755,1551,113,120,233,48.5%,30m
22060,3,DrakeLE,2755,1062,65,60,125,52.0%,10m
22060,3,oof,2755,1433,55,51,106,51.9%,37m
22060,2,Tata,2755,870,39,34,73,53.4%,14m
22060,3,RyoGin,2755,685,29,24,53,54.7%,21m
22060,3,MedicsUp,2755,583,23,19,42,54.8%,40m
22060,2,[GrnBrd]BREAKR,2755,173,23,25,48,47.9%,20m
22060,3,Lynx,2755,437,17,17,34,50.0%,40m
22060,2,THOR,2755,484,16,24,40,40.0%,37m
22060,2,Villain,2755,159,5,8,13,38.5%,8m
22060,1,Darzkane,2755,159,4,2,6,66.7%,34m
22060,2,[PUA]Rama,2755,95,3,3,6,50.0%,3h
22060,3,Schematic,2755,142,3,5,8,37.5%,38m
22060,1,shadowmonk,2755,40,2,1,3,66.7%,15m
22060,1,iNTER,2755,0,2,3,5,40.0%,47m
22060,3,TerranScrub,2755,121,2,3,5,40.0%,5m
22060,3,DontSneezeMe,2755,60,2,5,7,28.6%,20m
22060,1,Dextrocity,2755,42,1,1,2,50.0%,1h
22060,1,Peanuts,2755,0,1,1,2,50.0%,2h
22060,1,Feddas,2755,0,0,1,1,0.0%,3h
22060,1,SLICE,2755,0,0,1,1,0.0%,3h
22060,1,QuBuS,2755,0,0,1,1,0.0%,17m
22060,2,[StgNig]Brassballs,2755,0,0,2,2,0.0%,3h
22085,2,[SNSC]lunster,2754,1133,292,294,586,49.8%,13m
22085,2,Pharaoh,2754,1458,129,117,246,52.4%,25m
22085,3,wookiefist,2754,1069,48,34,82,58.5%,10m
22085,2,rain,2754,392,23,25,48,47.9%,16m
22085,3,polarcoconut,2754,412,16,13,29,55.2%,10m
22085,3,CKArakawa,2754,451,16,14,30,53.3%,26m
22085,3,Topotamdr,2754,450,16,19,35,45.7%,43m
22085,3,Bloodborne,2754,344,12,13,25,48.0%,34m
22085,1,[SmokeH]imnoskill,2754,199,8,9,17,47.1%,21m
22085,3,ztek,2754,159,7,11,18,38.9%,37m
22085,3,irvins,2754,211,7,13,20,35.0%,29m
22085,1,Popopega,2754,218,5,4,9,55.6%,2h
22085,2,[Pig2]cototK,2754,92,4,6,10,40.0%,3h
22085,1,[SttE]CMF,2754,44,3,3,6,50.0%,3h
22085,2,firebird,2754,154,3,4,7,42.9%,1h
22085,1,Gendarme,2754,34,2,0,2,100.0%,50m
22085,1,kotok,2754,38,2,0,2,100.0%,5m
22085,1,ZenKraken,2754,131,2,2,4,50.0%,47m
22085,1,BearSlayer,2754,0,2,3,5,40.0%,33m
22085,3,Singularity,2754,60,2,5,7,28.6%,37m
22085,1,IAIXIPI,2754,0,0,1,1,0.0%,33m
22085,3,[IBMN]Forfun,2754,0,0,4,4,0.0%,33m
22107,3,MittRomney,2753,1530,68,58,126,54.0%,28m
22107,2,DOIN,2753,1372,64,66,130,49.2%,41m
22107,2,Nicodemus,2753,1324,60,62,122,49.2%,41m
22107,2,ThorKen,2753,725,55,52,107,51.4%,34m
22107,1,Nutmegg,2753,279,38,53,91,41.8%,17m
22107,2,Fields,2753,471,18,19,37,48.6%,3m
22107,3,[TCHNO]UncleBanjo,2753,331,18,20,38,47.4%,23m
22107,3,UrdnotMark,2753,244,9,5,14,64.3%,6m
22107,3,[R0SeN]RosenRitter,2753,174,6,10,16,37.5%,25m
22107,1,[xNPGx]AnThoN,2753,142,4,5,9,44.4%,16m
22107,3,Karma,2753,115,3,1,4,75.0%,15m
22107,3,Tsamaunk,2753,90,3,6,9,33.3%,2m
22107,2,[yito]Alimen,2753,0,2,3,5,40.0%,3h
22107,3,[F33D]MOSTKILL,2753,30,2,3,5,40.0%,35m
22107,1,iNnoVation,2753,0,1,0,1,100.0%,1h
22107,3,[sk3tch]Calm,2753,0,1,3,4,25.0%,20m
22107,1,[Mriola]Vuldalack,2753,0,1,4,5,20.0%,46m
22107,3,[KGH]darkpickle,2753,0,0,1,1,0.0%,59m
22107,1,[SW45]Reflection,2753,0,0,1,1,0.0%,3h
22126,3,Dynamico,2752,1241,175,159,334,52.4%,17m
22126,3,Harlech,2752,1626,154,149,303,50.8%,36m
22126,3,[Cryptc]Juicy,2752,1401,93,65,158,58.9%,8m
22126,3,weaponEyes,2752,1288,50,50,100,50.0%,20m
22126,2,gouda,2752,1043,48,43,91,52.7%,37m
22126,1,[dtwist]SwampyTaint,2752,705,31,16,47,66.0%,46m
22126,2,SirZechs,2752,576,21,27,48,43.8%,31m
22126,1,Wreckursive,2752,282,11,11,22,50.0%,14m
22126,1,Voulskin,2752,360,10,6,16,62.5%,3h
22126,1,Telemachus,2752,156,5,1,6,83.3%,21m
22126,3,aztechhh,2752,58,3,4,7,42.9%,9m
22126,3,ItsReRay,2752,30,2,2,4,50.0%,28m
22126,2,[Nighbr]Statric,2752,119,2,3,5,40.0%,1h
22126,3,[dLife]Hiturunk,2752,60,2,5,7,28.6%,38m
22126,1,ZiiiDrate,2752,40,1,2,3,33.3%,59m
22126,1,[IvD]GosuAppa,2752,0,0,1,1,0.0%,1h
22126,1,Tanubis,2752,0,0,1,1,0.0%,1h
22126,3,LeFern,2752,0,0,3,3,0.0%,8m
22126,3,richard,2752,0,0,5,5,0.0%,35m
22145,2,Pipo,2751,1521,218,213,431,50.6%,36m
22145,3,Juice,2751,1430,149,134,283,52.7%,14m
22145,3,[DGTZR]JIMMYNEUTRON,2751,993,137,124,261,52.5%,18m
22145,3,Palmer,2751,1355,106,99,205,51.7%,36m
22145,3,Ditmar,2751,1170,77,74,151,51.0%,22m
22145,2,WyverN,2751,1180,54,53,107,50.5%,37m
22145,3,Traubon,2751,1156,48,42,90,53.3%,33m
22145,3,nah,2751,666,26,24,50,52.0%,41m
22145,3,[HØST]EliasParrini,2751,523,25,12,37,67.6%,28m
22145,2,RedBeard,2751,240,15,18,33,45.5%,13m
22145,1,ptero,2751,318,8,7,15,53.3%,3h
22145,3,[FalPal]PlaysBadly,2751,253,8,8,16,50.0%,4m
22145,2,ARCADE,2751,143,6,7,13,46.2%,34m
22145,1,stalker,2751,167,6,7,13,46.2%,7m
22145,3,IXXXI,2751,182,6,10,16,37.5%,3m
22145,1,[lighti]Ironsquire,2751,97,4,5,9,44.4%,1h
22145,3,BouncyBear,2751,140,3,4,7,42.9%,9m
22145,3,helmaroc,2751,30,3,5,8,37.5%,14m
22145,3,DIEGO,2751,94,3,6,9,33.3%,24m
22145,3,Fuzzydeath,2751,94,2,1,3,66.7%,15m
22145,2,AlbinoLion,2751,0,2,3,5,40.0%,3h
22145,3,hornyhorenet,2751,60,2,6,8,25.0%,26m
22145,2,mommymilkers,2751,0,1,2,3,33.3%,3h
22145,2,Arthas,2751,38,1,4,5,20.0%,3h
22145,1,KimS,2751,0,0,1,1,0.0%,9m
22145,3,[DEVAST]Galan,2751,0,0,3,3,0.0%,25m
22145,3,[XpKAc]Bramnagh,2751,0,0,3,3,0.0%,34m
22172,2,Shippy,2750,1444,135,128,263,51.3%,22m
22172,1,HughDangler,2750,1426,86,85,171,50.3%,35m
22172,3,Deimos,2750,1595,82,75,157,52.2%,22m
22172,3,squidwardddd,2750,1331,59,60,119,49.6%,4m
22172,2,[WSPSuk]NoWorries,2750,1392,58,63,121,47.9%,6m
22172,3,[eX]Koébro,2750,537,32,31,63,50.8%,43m
22172,3,leanderHCCA,2750,518,27,18,45,60.0%,31m
22172,2,Funkling,2750,715,27,29,56,48.2%,24m
22172,3,Energie,2750,395,26,29,55,47.3%,32m
22172,3,Julius,2750,488,23,15,38,60.5%,28m
22172,3,[MadK]ChatarraSS,2750,450,21,9,30,70.0%,32m
22172,1,marton,2750,331,12,15,27,44.4%,42m
22172,3,[ValidG]daveyboy,2750,324,11,16,27,40.7%,9m
22172,1,Aristifor,2750,266,9,7,16,56.2%,3h
22172,3,[GRUMEC]Hades,2750,250,8,6,14,57.1%,20m
22172,2,MrJoeSmith,2750,30,4,5,9,44.4%,37m
22172,1,Trinity,2750,143,3,1,4,75.0%,1h
22172,1,[UoM]PandaKing,2750,84,3,1,4,75.0%,3h
22172,2,SneakyKraken,2750,0,3,4,7,42.9%,40m
22172,2,Chichumunga,2750,0,1,0,1,100.0%,3h
22172,3,ZOSO,2750,0,1,1,2,50.0%,4m
22172,1,IAO,2750,42,1,1,2,50.0%,49m
22172,3,TheOneNOnly,2750,93,1,2,3,33.3%,32m
22172,3,[NPhase]Kmerengetsum,2750,30,1,3,4,25.0%,36m
22172,1,Gromdown,2750,0,0,1,1,0.0%,3h
22172,2,Spacewood,2750,0,0,1,1,0.0%,3h
22198,2,Redsnapper,2749,1475,299,295,594,50.3%,9m
22198,3,enrrique,2749,1408,136,124,260,52.3%,16m
22198,3,RedPeppery,2749,1496,115,114,229,50.2%,2m
22198,2,BenitoBodoqe,2749,1306,98,88,186,52.7%,41m
22198,3,GrrrSprite,2749,981,86,75,161,53.4%,14m
22198,2,Converge,2749,1497,61,64,125,48.8%,21m
22198,3,Tok,2749,937,41,35,76,53.9%,21m
22198,3,applepear,2749,580,26,30,56,46.4%,36m
22198,3,Soapstone,2749,558,25,15,40,62.5%,26m
22198,3,[GGRM]KAISERHOFF,2749,295,10,7,17,58.8%,23m
22198,3,angel,2749,278,8,9,17,47.1%,43m
22198,3,SCVling,2749,200,7,9,16,43.8%,30m
22198,3,Ollraaaa,2749,120,5,6,11,45.5%,12m
22198,3,Faesroll,2749,142,5,10,15,33.3%,2m
22198,2,BrknTime,2749,154,5,16,21,23.8%,8m
22198,1,[501sq]BossNoss,2749,186,4,10,14,28.6%,21m
22198,3,BunnyReborn,2749,36,3,3,6,50.0%,41m
22198,1,RAHITA,2749,38,3,3,6,50.0%,33m
22198,2,Stevo,2749,48,3,4,7,42.9%,1h
22198,3,[Pig2]Kawaiiprobe,2749,117,2,3,5,40.0%,12m
22198,1,Samsara,2749,0,2,3,5,40.0%,1h
22198,3,Kappachino,2749,30,2,4,6,33.3%,4m
22198,3,nanu,2749,97,2,5,7,28.6%,1h
22198,3,pijaman,2749,30,2,6,8,25.0%,6m
22198,2,BlueIce,2749,0,1,0,1,100.0%,1h
22198,1,SpaceProject,2749,0,1,0,1,100.0%,49m
22198,3,[LIEF]Panquesito,2749,0,1,2,3,33.3%,4m
22198,3,FishSangwich,2749,30,1,7,8,12.5%,6m
22198,3,[Derpz]Gwenom,2749,0,0,1,1,0.0%,60m
22198,3,Proxy,2749,0,0,1,1,0.0%,16m
22198,2,[CGB]TOSSIngEmUp,2749,0,0,1,1,0.0%,54m
22229,3,[500CC]JerryLee,2748,914,342,335,677,50.5%,11m
22229,3,RENASS,2748,1394,152,143,295,51.5%,4m
22229,2,atquiel,2748,1517,136,129,265,51.3%,12m
22229,3,[SwOoNz]Goatboy,2748,1503,98,83,181,54.1%,27m
22229,1,[Z69]SpacedDude,2748,1454,63,61,124,50.8%,3h
22229,2,Flank,2748,1621,61,69,130,46.9%,14m
22229,3,Deasy,2748,1079,48,44,92,52.2%,24m
22229,2,WombatWisdom,2748,183,28,30,58,48.3%,19m
22229,2,Smree,2748,420,16,16,32,50.0%,24m
22229,3,Yeti,2748,371,15,7,22,68.2%,37m
22229,3,Coletrane,2748,396,14,18,32,43.8%,33m
22229,2,spike,2748,263,13,11,24,54.2%,12m
22229,1,Lethik,2748,289,12,9,21,57.1%,9m
22229,3,[GAlNZ]TRUST,2748,282,11,15,26,42.3%,24m
22229,1,condurr,2748,238,6,7,13,46.2%,28m
22229,2,yukimura,2748,238,6,13,19,31.6%,18m
22229,1,PPelican,2748,204,5,3,8,62.5%,1h
22229,2,Romo,2748,164,5,4,9,55.6%,48m
22229,3,cardician,2748,144,5,7,12,41.7%,15m
22229,3,NOONE,2748,127,4,4,8,50.0%,24m
22229,1,WarAvenger,2748,38,3,1,4,75.0%,34m
22229,1,TheMan,2748,76,2,3,5,40.0%,2h
22229,3,TeeWhy,2748,30,2,3,5,40.0%,5m
22229,2,YOSHI,2748,96,2,4,6,33.3%,1h
22229,1,GeANFRANco,2748,0,1,0,1,100.0%,34m
22229,1,[TGCrew]JDShinsk,2748,0,0,1,1,0.0%,3h
22229,3,Zdebyman,2748,0,0,5,5,0.0%,20m
22256,2,Rubiocuhh,2747,1515,90,84,174,51.7%,40m
22256,2,aYuwOki,2747,1527,74,67,141,52.5%,42m
22256,2,bakihanma,2747,434,23,26,49,46.9%,10m
22256,1,TobyMcShane,2747,576,19,12,31,61.3%,35m
22256,3,Solace,2747,460,17,14,31,54.8%,6m
22256,3,Reaper,2747,470,16,18,34,47.1%,35m
22256,1,[N1GO]SloppyMayor,2747,421,15,16,31,48.4%,3m
22256,2,vicccccccccc,2747,279,11,12,23,47.8%,1h
22256,3,Amcore,2747,313,10,9,19,52.6%,41m
22256,3,SLASH,2747,265,8,8,16,50.0%,37m
22256,3,XFactor,2747,158,4,3,7,57.1%,37m
22256,2,DragonReborn,2747,141,4,4,8,50.0%,1h
22256,3,JeffSwolblum,2747,69,4,6,10,40.0%,9m
22256,1,wachito,2747,121,3,0,3,100.0%,47m
22256,3,AlmaDorada,2747,0,3,3,6,50.0%,39m
22256,2,ridgediffine,2747,114,3,5,8,37.5%,15m
22256,1,Pandeum,2747,30,3,8,11,27.3%,36m
22256,3,wavey,2747,0,3,9,12,25.0%,2m
22256,3,Roofus,2747,94,1,2,3,33.3%,4m
22256,1,[Dist9]XxEvolutionX,2747,94,1,7,8,12.5%,2h
22256,1,[BCBP5]SpiritOfFire,2747,0,0,1,1,0.0%,9m
22256,1,[BCBZ]FRSKN,2747,0,0,1,1,0.0%,21m
22256,1,Instanbul,2747,0,0,1,1,0.0%,2h
22256,1,Billybob,2747,0,0,1,1,0.0%,51m
22256,1,Desvirgensen,2747,0,0,1,1,0.0%,30m
22281,1,Chalee,2746,1588,380,371,751,50.6%,42m
22281,3,Havoc,2746,1501,128,147,275,46.5%,25m
22281,2,Aerodactyl,2746,758,121,109,230,52.6%,34m
22281,2,[PpK69]kidlasanha,2746,1499,78,73,151,51.7%,19m
22281,2,[sk3tch]theman,2746,1213,65,64,129,50.4%,21m
22281,2,youngtsen,2746,1134,56,58,114,49.1%,32m
22281,3,UnxplndBacon,2746,1286,51,51,102,50.0%,2m
22281,3,HenryFloss,2746,390,34,42,76,44.7%,2m
22281,2,Stardu,2746,531,22,30,52,42.3%,14m
22281,1,Knight,2746,514,21,23,44,47.7%,24m
22281,3,locowarpro,2746,490,19,20,39,48.7%,43m
22281,3,[xLiTx]HoboMcGavs,2746,379,18,13,31,58.1%,27m
22281,3,[LPG2]GABRIELPEREZ,2746,418,17,7,24,70.8%,23m
22281,1,[SDMG]Keifer,2746,344,15,13,28,53.6%,1h
22281,3,Smykea,2746,425,15,16,31,48.4%,24m
22281,1,dinkydoodle,2746,264,9,7,16,56.2%,53m
22281,1,McDuff,2746,195,8,5,13,61.5%,15m
22281,1,BusterBrown,2746,96,5,6,11,45.5%,2h
22281,3,ZEN,2746,120,5,7,12,41.7%,9m
22281,1,BronzeLegend,2746,0,4,1,5,80.0%,34m
22281,1,albi,2746,117,4,4,8,50.0%,1h
22281,3,Grza,2746,109,3,1,4,75.0%,20m
22281,1,[0GFY0]Lateralus,2746,0,3,2,5,60.0%,46m
22281,3,Splinter,2746,30,2,5,7,28.6%,5m
22281,1,Dennis,2746,0,1,0,1,100.0%,3h
22281,1,Caribou,2746,40,1,1,2,50.0%,15m
22281,1,Aguiluz,2746,0,0,1,1,0.0%,1h
22281,3,Raindog,2746,0,0,2,2,0.0%,22m
22309,3,FoxBodyCoupe,2745,1607,365,345,710,51.4%,4m
22309,1,photon,2745,1412,229,210,439,52.2%,40m
22309,3,AwesomeShot,2745,1615,189,185,374,50.5%,36m
22309,3,Consultant,2745,1424,140,130,270,51.9%,31m
22309,1,TRONCOJARO,2745,1569,83,94,177,46.9%,34m
22309,3,alex,2745,656,46,38,84,54.8%,4m
22309,3,[PPOCA]DvHm,2745,772,42,41,83,50.6%,6m
22309,2,bossdawg,2745,806,33,33,66,50.0%,8m
22309,1,Caldbry,2745,699,23,35,58,39.7%,20m
22309,3,Breezy,2745,331,21,18,39,53.8%,20m
22309,3,DJDSmooth,2745,341,18,18,36,50.0%,41m
22309,3,DarkJiMMy,2745,484,17,21,38,44.7%,8m
22309,3,NaiFace,2745,206,8,12,20,40.0%,19m
22309,3,Emperor,2745,180,6,3,9,66.7%,17m
22309,3,Abstemius,2745,154,6,8,14,42.9%,11m
22309,1,MxL,2745,121,5,4,9,55.6%,1h
22309,1,Raieth,2745,173,4,5,9,44.4%,3h
22309,3,LaidbackJ,2745,0,3,3,6,50.0%,19m
22309,2,lunaflower,2745,48,3,4,7,42.9%,7m
22309,2,SkyLine,2745,46,2,5,7,28.6%,3h
22309,1,[ClanHs]Aryk,2745,130,2,6,8,25.0%,30m
22309,3,ShoryuKen,2745,92,1,6,7,14.3%,31m
22309,1,gangmember,2745,0,0,1,1,0.0%,30m
22309,3,BigSteve,2745,0,0,3,3,0.0%,26m
22333,2,BlindstuckGG,2744,1568,134,121,255,52.5%,18m
22333,3,Nexus,2744,1246,49,44,93,52.7%,36m
22333,3,[GOPERÚ]Kuxito,2744,524,30,23,53,56.6%,2m
22333,3,[C96741]canadianfury,2744,761,30,25,55,54.5%,15m
22333,3,Ntsuag,2744,663,28,22,50,56.0%,33m
22333,1,[FenxAZ]BigCaesar,2744,589,21,18,39,53.8%,1h
22333,3,[sk3tch]Jensen,2744,462,20,11,31,64.5%,41m
22333,3,[CISD]KaCHINsky,2744,382,17,14,31,54.8%,41m
22333,3,Pepsibrah,2744,330,13,16,29,44.8%,2m
22333,3,[1PA]PWNerOfSouls,2744,235,10,3,13,76.9%,20m
22333,3,xandertroope,2744,248,10,15,25,40.0%,29m
22333,1,Moosemandude,2744,190,7,4,11,63.6%,1h
22333,1,Tntacles,2744,164,4,0,4,100.0%,42m
22333,1,Xithe,2744,120,4,2,6,66.7%,26m
22333,1,[AK48]ChAvAChAvA,2744,80,3,0,3,100.0%,3h
22333,1,FishSticks,2744,76,2,2,4,50.0%,1h
22333,1,xxxolegrampy,2744,127,2,5,7,28.6%,3h
22333,3,Subatchi,2744,30,2,6,8,25.0%,38m
22333,3,Jangus,2744,0,1,1,2,50.0%,37m
22333,2,Malichi,2744,0,1,2,3,33.3%,3h
22333,3,Canyonero,2744,30,1,6,7,14.3%,18m
22333,1,TerToss,2744,0,0,1,1,0.0%,1h
22333,1,Flomotion,2744,0,0,1,1,0.0%,3h
22333,1,MoOn,2744,0,0,1,1,0.0%,1h
22333,3,NME,2744,0,0,1,1,0.0%,1h
22333,3,[RUnoob]MrBuckLee,2744,0,0,2,2,0.0%,41m
22333,3,TheFunk,2744,0,0,4,4,0.0%,3m
22360,3,[QOSQO]HarrYTM,2743,1303,85,73,158,53.8%,28m
22360,3,DaPopeM,2743,1367,85,78,163,52.1%,9m
22360,3,Rihannna,2743,1313,70,71,141,49.6%,21m
22360,3,DaNIELA,2743,1305,61,58,119,51.3%,37m
22360,3,[MadK]DProberth,2743,1089,47,40,87,54.0%,16m
22360,3,[C70]Avisuara,2743,488,38,34,72,52.8%,21m
22360,2,jwang,2743,353,38,40,78,48.7%,12m
22360,3,Moisabra,2743,688,30,20,50,60.0%,23m
22360,3,PaulSanchez,2743,410,16,17,33,48.5%,26m
22360,3,ElephantKing,2743,388,15,15,30,50.0%,17m
22360,1,[Astute]HyunTKC,2743,144,8,5,13,61.5%,42m
22360,1,[N0M]Monsanto,2743,298,8,7,15,53.3%,22m
22360,1,stability,2743,136,5,4,9,55.6%,3h
22360,1,[aganar]GOLDIXG,2743,145,5,6,11,45.5%,53m
22360,3,GareBear,2743,111,2,3,5,40.0%,20m
22360,2,[LQV]IlIlIlIlIl,2743,0,2,3,5,40.0%,22m
22360,2,Noel,2743,0,2,3,5,40.0%,3h
22360,2,Shades,2743,0,2,3,5,40.0%,3h
22360,1,[DMaid]Chintarou,2743,0,0,1,1,0.0%,1h
22360,2,Elessar,2743,0,0,1,1,0.0%,26m
22380,1,[egamer]Buddhalove,2742,1406,111,116,227,48.9%,30m
22380,1,[queret]GhostMoiKaS,2742,1748,104,76,180,57.8%,9m
22380,2,[0sC]eLdV,2742,1533,82,69,151,54.3%,27m
22380,3,Epsilon,2742,701,41,28,69,59.4%,19m
22380,3,ArcadiumRice,2742,644,38,28,66,57.6%,33m
22380,2,WarMaster,2742,978,36,41,77,46.8%,36m
22380,3,SnackSneiter,2742,559,23,20,43,53.5%,32m
22380,3,Groove,2742,366,16,10,26,61.5%,33m
22380,1,[UWCSC]gcrl,2742,299,10,10,20,50.0%,30m
22380,3,Kinpatsu,2742,208,6,7,13,46.2%,13m
22380,2,ZAW,2742,188,6,18,24,25.0%,25m
22380,1,Ellipsis,2742,0,5,3,8,62.5%,13m
22380,2,SlikNdSneaky,2742,114,5,6,11,45.5%,13m
22380,3,EVILONE,2742,0,4,2,6,66.7%,23m
22380,1,[SaKula]IIIIIIIIIIII,2742,171,4,4,8,50.0%,24m
22380,2,Cassyfat,2742,46,3,3,6,50.0%,3h
22380,3,[TheRs]vis,2742,34,2,3,5,40.0%,7m
22380,1,TheDumbOx,2742,0,1,0,1,100.0%,1h
22380,3,Devastador,2742,0,1,0,1,100.0%,20m
22380,3,[SK0REA]SParkXD,2742,0,1,1,2,50.0%,38m
22380,3,sharks,2742,0,1,1,2,50.0%,33m
22380,2,TheCaveMan,2742,0,1,5,6,16.7%,12m
22380,3,[EvilGC]Chino,2742,30,1,5,6,16.7%,42m
22380,3,QuantumMech,2742,30,1,6,7,14.3%,27m
22404,3,Kaladin,2741,1029,87,75,162,53.7%,16m
22404,2,BalotPenoy,2741,1057,85,87,172,49.4%,20m
22404,2,Cherio,2741,1219,52,55,107,48.6%,13m
22404,3,humansherdog,2741,838,30,35,65,46.2%,29m
22404,3,[AD3C]togetherAll,2741,483,20,19,39,51.3%,8m
22404,2,aSgNitzer,2741,316,12,20,32,37.5%,26m
22404,2,[GENTOO]Mute,2741,310,11,10,21,52.4%,21m
22404,3,Nightmare,2741,268,10,5,15,66.7%,3m
22404,1,AgentRooty,2741,183,8,5,13,61.5%,3h
22404,3,IrateIceberg,2741,198,8,10,18,44.4%,20m
22404,1,OmarCa,2741,213,6,2,8,75.0%,41m
22404,1,Isaac,2741,176,4,2,6,66.7%,55m
22404,2,Bootzey,2741,140,4,4,8,50.0%,3h
22404,3,csael,2741,0,3,2,5,60.0%,17m
22404,1,QueenCheese,2741,0,3,2,5,60.0%,30m
22404,2,runtothehill,2741,0,3,3,6,50.0%,13m
22404,3,MunchkiN,2741,60,3,4,7,42.9%,26m
22404,3,Solimar,2741,106,3,5,8,37.5%,22m
22404,2,KaVkAzI,2741,97,2,0,2,100.0%,1h
22404,2,Dustin,2741,0,2,3,5,40.0%,3h
22404,1,SusanaHoria,2741,0,1,0,1,100.0%,47m
22404,1,[FIow]Synergyst,2741,48,1,1,2,50.0%,29m
22404,2,Willskii,2741,0,1,2,3,33.3%,3h
22404,3,TopHatRhino,2741,30,1,3,4,25.0%,41m
22404,1,ZeafeR,2741,0,0,1,1,0.0%,3h
22404,1,Bilkenator,2741,0,0,1,1,0.0%,3h
22404,3,[ChfSho]chef,2741,0,0,2,2,0.0%,30m
22431,2,KayoYayo,2740,1506,214,222,436,49.1%,13m
22431,3,louie,2740,1079,90,86,176,51.1%,29m
22431,3,Reedy,2740,818,79,81,160,49.4%,12m
22431,2,MrLeoTrader,2740,1384,58,53,111,52.3%,33m
22431,2,Brainleur,2740,826,47,45,92,51.1%,41m
22431,3,Jesuko,2740,827,34,26,60,56.7%,11m
22431,3,chunchunmaru,2740,784,30,26,56,53.6%,8m
22431,2,[Skyzo]Dantto,2740,842,29,39,68,42.6%,33m
22431,1,GingerFro,2740,476,25,15,40,62.5%,1h
22431,2,AlfaStar,2740,562,22,24,46,47.8%,42m
22431,1,hasaboo,2740,402,14,11,25,56.0%,47m
22431,3,bilboswagins,2740,248,10,12,22,45.5%,23m
22431,3,[Fukr]ChildXXChaos,2740,182,6,3,9,66.7%,23m
22431,3,nitsuJ,2740,175,6,3,9,66.7%,34m
22431,2,Lliks,2740,189,6,9,15,40.0%,21m
22431,1,MiVidaxAiur,2740,109,5,3,8,62.5%,1h
22431,1,BigThiccVic,2740,121,5,3,8,62.5%,57m
22431,1,Tiozin,2740,189,5,4,9,55.6%,1h
22431,3,coorsllte,2740,40,5,6,11,45.5%,30m
22431,2,PCGamer,2740,143,5,8,13,38.5%,11m
22431,2,[Jaegr]Wazak,2740,0,3,3,6,50.0%,48m
22431,3,[Cind3r]gobow,2740,92,3,9,12,25.0%,25m
22431,3,[8llllD]bwTerran,2740,115,2,2,4,50.0%,37m
22431,1,TassadarFan,2740,88,2,2,4,50.0%,3h
22431,3,JNealy,2740,118,2,3,5,40.0%,23m
22431,1,iNzOnE,2740,145,2,3,5,40.0%,31m
22431,1,KimJongLi,2740,0,1,0,1,100.0%,11m
22431,2,Conker,2740,46,1,3,4,25.0%,3h
22431,2,TANKnelson,2740,0,1,4,5,20.0%,3h
22431,3,Balanar,2740,0,1,5,6,16.7%,22m
22431,1,Arimic,2740,0,0,1,1,0.0%,57m
22431,2,Firewall,2740,0,0,1,1,0.0%,47m
22431,3,Kerry,2740,0,0,2,2,0.0%,4m
22464,3,Matherat,2739,1427,95,79,174,54.6%,34m
22464,3,Slid,2739,699,27,26,53,50.9%,33m
22464,3,JPX,2739,272,16,23,39,41.0%,15m
22464,3,ghostypine,2739,338,14,7,21,66.7%,28m
22464,3,Orbitalperid,2739,350,13,8,21,61.9%,4m
22464,1,[iSTACK]Imhotep,2739,369,13,11,24,54.2%,3h
22464,3,TheKid,2739,343,12,10,22,54.5%,8m
22464,3,HeavyD,2739,332,12,15,27,44.4%,3m
22464,2,SOLO,2739,310,10,19,29,34.5%,34m
22464,1,Cherry,2739,136,7,4,11,63.6%,5m
22464,1,beasy,2739,206,6,7,13,46.2%,3h
22464,1,[Bee]BrownBear,2739,116,3,3,6,50.0%,5m
22464,2,blessdtoflex,2739,116,3,5,8,37.5%,32m
22464,3,Arguz,2739,88,3,6,9,33.3%,25m
22464,2,[CBAS]MGDaGuill,2739,132,3,8,11,27.3%,52m
22464,1,Lazarus,2739,0,2,3,5,40.0%,3h
22464,3,Mist,2739,95,1,2,3,33.3%,3m
22464,3,Heavydog,2739,30,1,6,7,14.3%,28m
22464,1,Azirov,2739,0,0,1,1,0.0%,3h
22464,2,VTrider,2739,0,0,3,3,0.0%,23m
22464,1,Miroliubov,2739,0,0,3,3,0.0%,1h
22485,1,[TSRata]Felipe,2738,1784,221,181,402,55.0%,26m
22485,3,Ofcourse,2738,1611,147,154,301,48.8%,41m
22485,2,[UpxV]CRIPTO,2738,1540,127,105,232,54.7%,20m
22485,3,hei,2738,787,30,35,65,46.2%,15m
22485,2,[BlGD]ghost,2738,796,27,36,63,42.9%,10m
22485,1,[420kil]CoronaVirus,2738,764,25,22,47,53.2%,3h
22485,3,Beto,2738,580,24,22,46,52.2%,20m
22485,2,PHDonLSD,2738,358,13,22,35,37.1%,33m
22485,3,[Beans2]SonoranDawg,2738,320,12,14,26,46.2%,11m
22485,3,llllllllllll,2738,247,10,8,18,55.6%,6m
22485,3,soibac,2738,218,10,12,22,45.5%,17m
22485,1,[MLKMEN]Milkman,2738,230,6,0,6,100.0%,2h
22485,3,[BBBTC]MarineKondo,2738,175,6,5,11,54.5%,2m
22485,2,[porbe]woooooober,2738,46,5,3,8,62.5%,7m
22485,3,[ktkzs]STigMA,2738,172,5,5,10,50.0%,3m
22485,3,SyIVThETiC,2738,145,4,4,8,50.0%,27m
22485,3,Gollum,2738,118,4,7,11,36.4%,28m
22485,3,Achilles,2738,0,3,3,6,50.0%,28m
22485,2,angjim,2738,0,3,5,8,37.5%,40m
22485,3,[xLiTx]Kougar,2738,112,2,5,7,28.6%,17m
22485,1,cyclove,2738,0,1,0,1,100.0%,3h
22485,1,[F33D]RockyStarr,2738,0,1,1,2,50.0%,1h
22485,1,Thedestroyer,2738,0,0,1,1,0.0%,13m
22485,3,darkflame,2738,0,0,3,3,0.0%,20m
22509,3,mudon,2737,1618,249,230,479,52.0%,19m
22509,3,BananaKush,2737,1587,193,178,371,52.0%,5m
22509,2,sCv,2737,1516,127,123,250,50.8%,6m
22509,3,Staggs,2737,1190,87,77,164,53.0%,38m
22509,1,JpBruiser,2737,799,56,33,89,62.9%,58m
22509,1,Violentllama,2737,1001,49,29,78,62.8%,1h
22509,2,itchyrear,2737,1114,47,40,87,54.0%,12m
22509,2,Killer,2737,150,7,11,18,38.9%,1h
22509,3,[CRAKS]RaOnFire,2737,48,6,8,14,42.9%,14m
22509,2,jimmyrustle,2737,95,5,13,18,27.8%,6m
22509,3,Sonoloso,2737,0,4,2,6,66.7%,23m
22509,1,KimJongNuke,2737,96,4,8,12,33.3%,3h
22509,2,MSP,2737,94,3,3,6,50.0%,2h
22509,1,[SENJOU]Mitsuha,2737,94,2,4,6,33.3%,3h
22509,2,[Fletzr]SoundsofRain,2737,60,2,5,7,28.6%,41m
22509,3,scumbag,2737,30,1,9,10,10.0%,41m
22509,1,dreff,2737,0,0,1,1,0.0%,3h
22509,3,SpicyFish,2737,0,0,3,3,0.0%,36m
22509,3,[NLTN]GGdarius,2737,0,0,4,4,0.0%,6m
22528,3,[Port88]SHEP,2736,1623,578,573,1151,50.2%,41m
22528,2,Tiesto,2736,1659,126,123,249,50.6%,13m
22528,3,[CyS]XGene,2736,1437,118,112,230,51.3%,40m
22528,3,VapesTheKron,2736,520,105,97,202,52.0%,17m
22528,3,[UpxV]lautitoplus,2736,849,105,100,205,51.2%,16m
22528,3,Destaghoul,2736,586,49,44,93,52.7%,37m
22528,1,Gsword,2736,976,38,26,64,59.4%,14m
22528,1,Chikoro,2736,535,34,24,58,58.6%,3h
22528,3,Metallica,2736,768,29,29,58,50.0%,23m
22528,3,Ormuz,2736,418,21,8,29,72.4%,36m
22528,1,Wizmander,2736,471,20,9,29,69.0%,29m
22528,3,NihilDaste,2736,478,18,17,35,51.4%,23m
22528,3,[nwBEAR]bear,2736,361,15,9,24,62.5%,15m
22528,1,RedMagnetic,2736,476,14,14,28,50.0%,52m
22528,3,SkratoX,2736,318,10,17,27,37.0%,22m
22528,3,[No0Bs]PandaGirl,2736,148,5,10,15,33.3%,31m
22528,1,Hamsung,2736,48,4,6,10,40.0%,16m
22528,2,Buhn,2736,200,4,11,15,26.7%,1h
22528,1,PhilowPillow,2736,0,3,4,7,42.9%,1h
22528,2,Perrin,2736,0,2,3,5,40.0%,2h
22528,1,Chííl,2736,0,2,3,5,40.0%,1h
22528,3,mrwatt,2736,60,2,9,11,18.2%,20m
22528,1,[RAID5]zergerking,2736,42,1,1,2,50.0%,47m
22528,3,Kagutsuchi,2736,0,1,1,2,50.0%,28m
22528,1,EquinoX,2736,0,1,4,5,20.0%,26m
22528,1,[SSkull]Oscar,2736,0,0,1,1,0.0%,9m
22528,1,UncleIron,2736,0,0,1,1,0.0%,58m
22555,3,BrassBallz,2735,876,95,90,185,51.4%,24m
22555,1,[DhZAc1]VeiD,2735,910,60,55,115,52.2%,3h
22555,1,Squid,2735,564,25,11,36,69.4%,1h
22555,1,NOxSeifer,2735,537,22,10,32,68.8%,33m
22555,3,JimboLizard,2735,275,19,15,34,55.9%,36m
22555,3,exama,2735,312,11,14,25,44.0%,37m
22555,2,[ZTemps]Jiguz,2735,181,6,1,7,85.7%,47m
22555,1,Varezhka,2735,239,6,4,10,60.0%,3h
22555,2,Oblivion,2735,178,6,14,20,30.0%,8m
22555,3,[V501st]MaulerX,2735,122,5,10,15,33.3%,6m
22555,1,Arkrez,2735,120,4,2,6,66.7%,3h
22555,2,Snij,2735,112,3,3,6,50.0%,1h
22555,2,[GGBr0]reggie,2735,0,3,4,7,42.9%,37m
22555,1,IsTheShadow,2735,86,2,1,3,66.7%,52m
22555,1,Dweloren,2735,38,2,1,3,66.7%,25m
22555,2,[XATUBA]ShinHAT,2735,116,2,6,8,25.0%,33m
22555,1,[IPH]xSaintApocx,2735,0,1,0,1,100.0%,51m
22555,1,Qrst,2735,44,1,1,2,50.0%,21m
22555,3,MoneyGame,2735,0,1,5,6,16.7%,17m
22555,1,JordanSF,2735,0,0,1,1,0.0%,3h
22555,1,KillerJoe,2735,0,0,1,1,0.0%,3h
22555,1,[SL3ePY]Rampart,2735,0,0,1,1,0.0%,50m
22555,2,Cornell,2735,0,0,1,1,0.0%,1h
22555,1,Achenin,2735,0,0,1,1,0.0%,15m
22555,2,[aIien]JohnnyDepp,2735,0,0,1,1,0.0%,3h
22555,1,Albatraoz,2735,0,0,1,1,0.0%,1h
22555,3,Safis,2735,0,0,4,4,0.0%,15m
22582,3,SleepyBear,2734,1527,259,252,511,50.7%,25m
22582,3,[sk3tch]Nomoreeliot,2734,1469,99,97,196,50.5%,29m
22582,2,[BBoii]TuckDogTTV,2734,1107,89,98,187,47.6%,26m
22582,3,[XIXIXI]aeligos,2734,1313,69,63,132,52.3%,33m
22582,3,PlogDropper,2734,834,55,28,83,66.3%,17m
22582,3,[UpxV]neil,2734,933,50,51,101,49.5%,11m
22582,3,TuPapi,2734,1037,41,36,77,53.2%,2m
22582,3,Reshion,2734,526,20,19,39,51.3%,12m
22582,3,BicoPreto,2734,501,19,20,39,48.7%,20m
22582,1,Austin,2734,336,12,9,21,57.1%,34m
22582,1,Rickster,2734,280,8,7,15,53.3%,15m
22582,1,Kahsinh,2734,109,7,8,15,46.7%,58m
22582,2,durdor,2734,184,6,4,10,60.0%,3h
22582,1,KMAGtv,2734,176,6,5,11,54.5%,15m
22582,1,[pikas]mickad,2734,159,6,5,11,54.5%,50m
22582,3,LutenantLATS,2734,0,4,2,6,66.7%,4m
22582,2,Xterminator,2734,0,3,4,7,42.9%,42m
22582,1,Fuhrer,2734,48,2,4,6,33.3%,1h
22582,1,Stratisfied,2734,120,2,7,9,22.2%,21m
22582,1,[420CC]UncleDrew,2734,90,1,1,2,50.0%,54m
22582,1,[YD2K]thewetlegend,2734,0,1,1,2,50.0%,1h
22582,1,DRiVE,2734,88,1,1,2,50.0%,1h
22582,1,Chris,2734,0,1,4,5,20.0%,58m
22582,3,RiceNoodles,2734,30,1,4,5,20.0%,20m
22582,1,[UFL]Punit,2734,0,0,1,1,0.0%,59m
22582,1,Whatmyname,2734,0,0,1,1,0.0%,11m
22582,1,[200107]SunnyJM,2734,0,0,2,2,0.0%,15m
22582,3,[UpeV]LuisSanHer,2734,0,0,4,4,0.0%,41m
22582,3,FXmarc,2734,0,0,6,6,0.0%,33m
22611,3,[Dire]Firestorm,2733,1573,161,175,336,47.9%,39m
22611,3,SuedePritch,2733,1506,154,146,300,51.3%,38m
22611,1,[RogueW]DarkTemplar,2733,1744,89,75,164,54.3%,3h
22611,3,Malcriex,2733,1340,84,74,158,53.2%,4m
22611,1,Deathpenguin,2733,1589,70,65,135,51.9%,58m
22611,3,Bijlee,2733,1099,50,38,88,56.8%,24m
22611,3,ForceOfWill,2733,1055,45,41,86,52.3%,8m
22611,1,ItzDokesIz,2733,457,30,21,51,58.8%,1h
22611,3,Candalistic,2733,475,29,13,42,69.0%,11m
22611,1,Marcus,2733,711,22,26,48,45.8%,3h
22611,3,mandalf,2733,227,11,15,26,42.3%,38m
22611,3,[TiibaG]Crashlanding,2733,239,8,6,14,57.1%,20m
22611,1,Jeremy,2733,232,7,2,9,77.8%,1h
22611,3,Wuxhen,2733,176,6,11,17,35.3%,5m
22611,1,scotteh,2733,124,4,2,6,66.7%,3h
22611,2,Sildenafil,2733,46,4,3,7,57.1%,3h
22611,3,[H0L0]Rivm,2733,88,3,8,11,27.3%,23m
22611,3,NPCmajor,2733,0,1,0,1,100.0%,60m
22611,3,Shadowforge,2733,0,1,2,3,33.3%,37m
22611,3,[GTDR]StevO,2733,30,1,4,5,20.0%,29m
22611,1,PLAYaNINJA,2733,0,0,1,1,0.0%,2h
22611,3,Ilikepie,2733,0,0,2,2,0.0%,24m
22611,1,[Ogygia]Herian,2733,0,0,2,2,0.0%,1h
22611,3,vkram,2733,0,0,3,3,0.0%,3m
22635,2,Captain,2732,1485,80,77,157,51.0%,19m
22635,3,RamBowzDeep,2732,670,77,71,148,52.0%,21m
22635,3,[Flar3s]Psionic,2732,800,33,28,61,54.1%,3m
22635,3,Eclipse,2732,666,27,27,54,50.0%,24m
22635,3,[SSVG]Ozmerg,2732,511,22,16,38,57.9%,3m
22635,3,Pswift,2732,186,19,16,35,54.3%,27m
22635,3,Terror,2732,548,19,25,44,43.2%,26m
22635,3,AquaBadger,2732,436,18,16,34,52.9%,28m
22635,3,WaquaPictdom,2732,352,14,15,29,48.3%,22m
22635,3,Riot,2732,91,10,7,17,58.8%,22m
22635,2,spatiager,2732,298,10,21,31,32.3%,14m
22635,1,Jacadasag,2732,195,7,5,12,58.3%,3h
22635,2,TorqueMonstr,2732,0,4,1,5,80.0%,1h
22635,2,Loop,2732,203,4,3,7,57.1%,3h
22635,3,Violater,2732,58,3,3,6,50.0%,4m
22635,3,TrashPanda,2732,58,2,10,12,16.7%,4m
22635,1,[RMW]MetalDeath,2732,0,1,0,1,100.0%,3h
22635,1,Alser,2732,38,1,1,2,50.0%,5m
22653,1,Flay,2731,1713,83,75,158,52.5%,1h
22653,2,nemui,2731,787,76,75,151,50.3%,20m
22653,2,Earlobe,2731,1217,45,46,91,49.5%,24m
22653,3,Wodan,2731,606,22,23,45,48.9%,37m
22653,2,SonicBoom,2731,582,18,26,44,40.9%,8m
22653,2,Dethan,2731,419,16,19,35,45.7%,24m
22653,3,Lemon,2731,364,13,9,22,59.1%,10m
22653,3,luisdiavole,2731,294,11,14,25,44.0%,8m
22653,2,Neweze,2731,292,11,18,29,37.9%,17m
22653,3,JepHri,2731,266,10,10,20,50.0%,22m
22653,2,TrafcoRaviol,2731,266,10,13,23,43.5%,52m
22653,1,Guigo,2731,167,7,3,10,70.0%,3h
22653,2,TheBigWeed,2731,198,7,7,14,50.0%,5m
22653,3,Gillesie,2731,134,7,10,17,41.2%,22m
22653,2,[PvZMa]BlueBob,2731,148,6,10,16,37.5%,12m
22653,1,LetzHevFun,2731,78,5,3,8,62.5%,31m
22653,1,[HvnDvl]DROOF,2731,125,2,1,3,66.7%,3h
22653,1,jhamilex,2731,0,2,3,5,40.0%,33m
22653,3,ThrasheR,2731,0,2,4,6,33.3%,42m
22653,2,BroToss,2731,0,1,0,1,100.0%,3h
22653,2,DisToPieselo,2731,0,1,0,1,100.0%,1h
22653,1,kenzington,2731,0,1,2,3,33.3%,1h
22653,1,[Bovice]Sopher,2731,0,0,1,1,0.0%,36m
22653,1,[LHRS]speeDDeeps,2731,0,0,1,1,0.0%,3h
22653,2,[1vsM]flachwichser,2731,0,0,1,1,0.0%,3h
22653,1,darkcutra,2731,0,0,1,1,0.0%,1h
22653,1,Geeman,2731,0,0,1,1,0.0%,52m
22653,3,[KTWN]Woorijip,2731,0,0,2,2,0.0%,6m
22681,2,trickooo,2730,1566,389,360,749,51.9%,19m
22681,3,IronGear,2730,1276,191,184,375,50.9%,24m
22681,3,PatBateman,2730,1058,99,97,196,50.5%,40m
22681,3,SidewaySeven,2730,1202,52,51,103,50.5%,29m
22681,2,VayVillein,2730,438,49,50,99,49.5%,9m
22681,1,LeoSchilling,2730,552,37,31,68,54.4%,12m
22681,3,SpecialKT,2730,640,24,24,48,50.0%,39m
22681,3,[LMI42]OverlordRush,2730,543,21,17,38,55.3%,20m
22681,3,[LCE]zeth,2730,570,21,21,42,50.0%,24m
22681,3,Revanite,2730,404,17,15,32,53.1%,19m
22681,3,Tafirol,2730,388,15,13,28,53.6%,17m
22681,2,Darkdaley,2730,179,9,6,15,60.0%,18m
22681,2,Bowman,2730,237,9,10,19,47.4%,30m
22681,1,Atlas,2730,190,7,8,15,46.7%,3h
22681,2,Aryis,2730,180,7,14,21,33.3%,42m
22681,1,beatboxbear,2730,152,5,0,5,100.0%,3h
22681,1,Vyr,2730,140,5,5,10,50.0%,2h
22681,1,Fjord,2730,48,4,5,9,44.4%,3h
22681,2,GreyWolf,2730,0,2,3,5,40.0%,3h
22681,1,Overlord,2730,0,2,3,5,40.0%,59m
22681,1,FaiSsaN,2730,48,1,2,3,33.3%,25m
22681,3,TheMalard,2730,94,1,3,4,25.0%,20m
22681,3,DasCeasar,2730,30,1,3,4,25.0%,50m
22681,1,Hellfour,2730,0,0,1,1,0.0%,3h
22681,1,HagardSnoman,2730,0,0,3,3,0.0%,29m
22706,1,Mcmelody,2729,1569,304,281,585,52.0%,27m
22706,2,SwHrReEkD,2729,1564,172,167,339,50.7%,8m
22706,1,GranRonald,2729,1592,161,164,325,49.5%,7m
22706,2,[LIKAN]GrAries,2729,1568,121,115,236,51.3%,42m
22706,3,Macuack,2729,669,49,51,100,49.0%,33m
22706,3,[ANTARS]Chemoundsky,2729,963,46,42,88,52.3%,14m
22706,3,Geiseric,2729,900,34,36,70,48.6%,41m
22706,2,Cyco,2729,631,30,39,69,43.5%,12m
22706,3,[TRASHH]TrojanOne,2729,494,22,16,38,57.9%,42m
22706,3,[Pls]Feanor,2729,555,21,19,40,52.5%,6m
22706,3,[JATS]TheRatKing,2729,424,19,16,35,54.3%,16m
22706,2,itssimple,2729,306,13,11,24,54.2%,60m
22706,3,[GuN]Pogi,2729,212,9,7,16,56.2%,40m
22706,1,gdr,2729,188,6,3,9,66.7%,15m
22706,3,[Atoq]RaZu,2729,116,5,5,10,50.0%,25m
22706,1,MonsterEpoch,2729,167,5,5,10,50.0%,3h
22706,2,lotus,2729,60,5,7,12,41.7%,12m
22706,3,SCOUTWITHBCS,2729,122,5,11,16,31.2%,24m
22706,1,Shredling,2729,179,4,1,5,80.0%,1h
22706,3,TYFan,2729,132,4,3,7,57.1%,27m
22706,1,tholapz,2729,117,4,4,8,50.0%,5m
22706,2,Asoloso,2729,36,4,7,11,36.4%,24m
22706,1,[Pharoh]MadeInCanada,2729,78,3,0,3,100.0%,28m
22706,1,monster,2729,72,2,2,4,50.0%,35m
22706,1,CartoonBox,2729,0,2,3,5,40.0%,1h
22706,2,Mikhan,2729,0,2,3,5,40.0%,3h
22706,3,clam,2729,60,2,5,7,28.6%,37m
22706,1,[Normie]Nathan,2729,66,2,18,20,10.0%,37m
22706,1,slicedbread,2729,0,1,0,1,100.0%,29m
22706,1,[αB]ZAWGURN,2729,0,0,1,1,0.0%,1h
22706,1,Neo,2729,0,0,1,1,0.0%,3h
22706,1,SgtTucker,2729,0,0,1,1,0.0%,14m
22738,2,sargpain,2728,1571,181,177,358,50.6%,18m
22738,2,[Kappa8]jtorres,2728,426,77,81,158,48.7%,20m
22738,3,[zecOc]LoremIpsum,2728,1329,64,59,123,52.0%,25m
22738,3,ICEMAN,2728,813,63,53,116,54.3%,41m
22738,3,PJLO,2728,531,41,29,70,58.6%,37m
22738,3,Pelure,2728,587,22,23,45,48.9%,4m
22738,3,[Bioz]Masterchile,2728,379,18,13,31,58.1%,20m
22738,1,hugo,2728,364,12,4,16,75.0%,49m
22738,2,SoloXman,2728,344,12,17,29,41.4%,14m
22738,3,llllllllllll,2728,210,7,5,12,58.3%,41m
22738,1,AFK,2728,208,6,6,12,50.0%,3h
22738,3,BePositive,2728,150,6,7,13,46.2%,42m
22738,1,[D3N]jason,2728,74,5,4,9,55.6%,34m
22738,2,CollinsAx,2728,136,5,6,11,45.5%,3h
22738,2,Gnome,2728,44,4,5,9,44.4%,3h
22738,1,DeTHS,2728,68,3,0,3,100.0%,48m
22738,2,astralwraith,2728,0,3,3,6,50.0%,3h
22738,1,Libra,2728,97,3,5,8,37.5%,47m
22738,3,HugeTree,2728,97,3,10,13,23.1%,1h
22738,3,ablaze,2728,58,2,6,8,25.0%,12m
22738,1,Hodor,2728,38,1,2,3,33.3%,15m
22738,2,[Swisss]IFGAN,2728,0,1,5,6,16.7%,26m
22738,3,MatyLight,2728,30,1,5,6,16.7%,37m
22738,1,Fives,2728,0,0,1,1,0.0%,3h
22738,1,OptimusRhyme,2728,0,0,1,1,0.0%,3h
22763,3,JorEl,2727,1610,199,202,401,49.6%,14m
22763,1,Peter,2727,1588,73,47,120,60.8%,3h
22763,3,MajorINJURY,2727,1051,48,39,87,55.2%,33m
22763,1,lowolfne,2727,504,31,26,57,54.4%,3h
22763,3,Dragon,2727,699,27,27,54,50.0%,29m
22763,3,GastonURY,2727,653,26,24,50,52.0%,34m
22763,3,[JACKY]Ingsanity,2727,445,17,16,33,51.5%,25m
22763,3,Coochiekins,2727,461,17,18,35,48.6%,31m
22763,1,Revanite,2727,370,14,5,19,73.7%,57m
22763,2,DrPhoton,2727,206,7,10,17,41.2%,18m
22763,2,Drageon,2727,88,6,6,12,50.0%,4m
22763,3,[PUlink]Unknown,2727,157,6,8,14,42.9%,34m
22763,1,Andrew,2727,118,3,2,5,60.0%,51m
22763,1,Heda,2727,0,2,3,5,40.0%,57m
22763,1,[Bonoo]JonSnow,2727,0,1,0,1,100.0%,1h
22763,3,Cranberry,2727,30,1,4,5,20.0%,20m
22763,3,Darkknight,2727,0,0,3,3,0.0%,12m
22763,1,tarita,2727,0,0,5,5,0.0%,39m
22781,2,PhantomLimb,2726,1533,641,623,1264,50.7%,15m
22781,2,PlayerOne,2726,1577,183,190,373,49.1%,9m
22781,3,MARINASILVA,2726,1551,122,99,221,55.2%,24m
22781,2,rogerfenix,2726,1555,106,110,216,49.1%,7m
22781,3,ronian,2726,1258,52,51,103,50.5%,25m
22781,3,[TeamUR]JohnnyLS,2726,698,31,21,52,59.6%,34m
22781,3,[BigChz]nineFive,2726,642,22,26,48,45.8%,2m
22781,1,Barn,2726,513,19,12,31,61.3%,28m
22781,1,Jenova,2726,486,14,12,26,53.8%,58m
22781,1,[jpx]Xico,2726,348,10,8,18,55.6%,39m
22781,1,GRTagnus,2726,188,9,6,15,60.0%,11m
22781,3,RockEnRolla,2726,226,9,12,21,42.9%,33m
22781,3,[ZDE20]MoonLight,2726,160,7,4,11,63.6%,24m
22781,3,nghiahoangg,2726,180,7,8,15,46.7%,15m
22781,1,Erickb,2726,42,6,0,6,100.0%,6m
22781,1,LowfaBREAD,2726,162,6,5,11,54.5%,3h
22781,3,Ghost,2726,114,5,7,12,41.7%,15m
22781,1,[GRU]Variance,2726,84,3,2,5,60.0%,3h
22781,2,StingAl,2726,48,3,4,7,42.9%,48m
22781,1,ldqcom,2726,82,2,3,5,40.0%,3h
22781,1,hated,2726,0,2,3,5,40.0%,1h
22781,3,Tears,2726,95,1,2,3,33.3%,40m
22781,1,TitanNose,2726,97,1,3,4,25.0%,57m
22781,3,jouker,2726,30,1,7,8,12.5%,7m
22781,1,[SAVU]Ozymandias,2726,0,0,1,1,0.0%,59m
22781,1,Vagabond,2726,0,0,1,1,0.0%,37m
22781,1,[HØST]guilherme,2726,0,0,2,2,0.0%,3h
22808,1,BoliviaGGRAM,2725,1582,126,106,232,54.3%,3h
22808,3,bruno,2725,782,92,67,159,57.9%,15m
22808,3,CornNuGgeT,2725,1446,79,87,166,47.6%,13m
22808,3,[RTLS]Kurn,2725,1294,70,69,139,50.4%,34m
22808,1,Moscadx,2725,1601,65,56,121,53.7%,47m
22808,3,Maverick,2725,1432,64,55,119,53.8%,25m
22808,3,Zeroz,2725,1430,62,49,111,55.9%,35m
22808,2,ScootalooCMC,2725,1470,54,65,119,45.4%,12m
22808,1,Laurence,2725,1202,48,42,90,53.3%,3h
22808,3,Darkuau,2725,651,28,32,60,46.7%,29m
22808,1,[FUPAzz]DrPhil,2725,274,26,18,44,59.1%,3h
22808,2,Fisch,2725,273,9,12,21,42.9%,36m
22808,3,lucaspro,2725,90,7,4,11,63.6%,40m
22808,1,dootLegenda,2725,222,6,2,8,75.0%,53m
22808,1,NukinNuggets,2725,145,6,6,12,50.0%,3h
22808,2,Slug,2725,46,5,2,7,71.4%,60m
22808,1,BoisLikeFood,2725,80,3,0,3,100.0%,3h
22808,1,[Sketti]MrKiwiism,2725,96,3,2,5,60.0%,49m
22808,2,Shinigami,2725,0,3,3,6,50.0%,3h
22808,1,visibleblack,2725,42,2,1,3,66.7%,52m
22808,1,Zventures,2725,0,2,3,5,40.0%,36m
22808,1,LonelyProbe,2725,145,2,9,11,18.2%,3h
22808,1,terrannama,2725,40,1,1,2,50.0%,15m
22808,2,yadda,2725,0,1,2,3,33.3%,22m
22808,1,FaDeCsharp,2725,43,1,5,6,16.7%,1h
22808,1,Argenias,2725,0,0,2,2,0.0%,22m
22808,3,JinAir,2725,0,0,3,3,0.0%,28m
22835,3,[LCE]ALEXYZ,2724,922,63,52,115,54.8%,26m
22835,3,[AbcCo]Loko,2724,1424,57,49,106,53.8%,15m
22835,3,RaTonLeTal,2724,793,53,36,89,59.6%,41m
22835,3,VeryNooB,2724,1008,43,37,80,53.8%,40m
22835,3,[Pinoys]HaniSalam,2724,898,38,34,72,52.8%,12m
22835,1,IIIIIIIIII,2724,602,22,18,40,55.0%,15m
22835,3,SANGUINIUZ,2724,434,19,22,41,46.3%,17m
22835,3,Findail,2724,511,17,20,37,45.9%,40m
22835,1,Wraithhunter,2724,410,13,9,22,59.1%,52m
22835,1,flypeach,2724,223,11,9,20,55.0%,51m
22835,3,Leo,2724,269,10,7,17,58.8%,7m
22835,3,[XiNoS]EinaR,2724,260,9,14,23,39.1%,29m
22835,1,fluxquantum,2724,162,4,5,9,44.4%,1h
22835,1,[GOPERÚ]Davulgani,2724,118,4,5,9,44.4%,36m
22835,1,COOKieARS,2724,0,1,0,1,100.0%,50m
22835,1,PenguinDude,2724,0,1,1,2,50.0%,13m
22835,1,SwaggieAlex,2724,0,1,1,2,50.0%,55m
22835,3,[RMFG]JimmyMac,2724,30,1,4,5,20.0%,28m
22835,1,pusydestroer,2724,48,1,4,5,20.0%,1h
22835,3,aeggin,2724,0,0,1,1,0.0%,35m
22835,3,FrapKunKou,2724,0,0,3,3,0.0%,23m
22856,3,bluesky,2723,1619,182,164,346,52.6%,31m
22856,1,Wilith,2723,1307,164,141,305,53.8%,36m
22856,3,MouseBalls,2723,1461,163,143,306,53.3%,3m
22856,2,BobaFett,2723,1402,112,105,217,51.6%,22m
22856,3,[Fir3s]RisingSun,2723,1290,69,67,136,50.7%,3m
22856,3,[Ba1t]ranger,2723,953,57,46,103,55.3%,37m
22856,3,Steve,2723,446,53,43,96,55.2%,28m
22856,3,IDPD,2723,731,47,37,84,56.0%,20m
22856,1,TissueKing,2723,1103,42,32,74,56.8%,6m
22856,1,SaltyBalz,2723,1192,41,55,96,42.7%,30m
22856,1,Angrydrunk,2723,753,39,32,71,54.9%,1h
22856,3,undeadfotr,2723,727,33,24,57,57.9%,38m
22856,1,yoshimaKATA,2723,804,33,43,76,43.4%,28m
22856,2,Fister,2723,479,29,32,61,47.5%,14m
22856,1,[LosWea]Cerok,2723,398,19,13,32,59.4%,1h
22856,3,DevilD,2723,422,18,13,31,58.1%,14m
22856,3,LOCA,2723,255,12,10,22,54.5%,28m
22856,3,Johan,2723,270,10,8,18,55.6%,3m
22856,3,Notabot,2723,263,10,12,22,45.5%,4m
22856,1,[Clasic]Obama,2723,280,8,9,17,47.1%,42m
22856,1,[EvilCC]KREESTRO,2723,112,3,3,6,50.0%,47m
22856,1,ffffffffffff,2723,44,2,1,3,66.7%,11m
22856,2,Tork,2723,0,2,3,5,40.0%,3h
22856,3,[CNG]Job,2723,0,2,5,7,28.6%,6m
22856,1,[RuNx]Honor,2723,0,1,0,1,100.0%,1h
22856,1,[WOTDL]ignaciostern,2723,0,1,1,2,50.0%,3h
22856,3,[INl]Doctorius,2723,0,1,2,3,33.3%,16m
22856,1,[SC2IDN]Rendi,2723,44,1,2,3,33.3%,3h
22856,3,ANGEL,2723,93,1,3,4,25.0%,32m
22856,1,RoadToBronze,2723,0,0,1,1,0.0%,1h
22856,3,[SanTos]SaInTBuddy,2723,0,0,2,2,0.0%,43m
22887,3,redshift,2722,928,109,98,207,52.7%,29m
22887,3,Admiral,2722,1277,102,103,205,49.8%,4m
22887,3,Eric,2722,794,81,71,152,53.3%,28m
22887,1,Fait,2722,1754,67,62,129,51.9%,48m
22887,3,nevah,2722,692,32,28,60,53.3%,24m
22887,1,jaxkzzzzz,2722,709,26,22,48,54.2%,57m
22887,1,seunghwan,2722,638,23,17,40,57.5%,6m
22887,3,[Fever]EquinsuOcha,2722,323,23,26,49,46.9%,3m
22887,3,somniferous,2722,527,21,19,40,52.5%,24m
22887,2,Xazki,2722,508,17,27,44,38.6%,13m
22887,3,Delthorin,2722,350,14,11,25,56.0%,30m
22887,2,xyyyyy,2722,184,8,9,17,47.1%,3h
22887,3,slippycat,2722,120,5,6,11,45.5%,33m
22887,1,Skynet,2722,48,4,6,10,40.0%,3h
22887,3,Aries,2722,126,4,10,14,28.6%,43m
22887,1,[OTKR]Hadening,2722,36,2,1,3,66.7%,3h
22887,1,[cell5]KongShlong,2722,0,1,0,1,100.0%,1h
22887,3,[UET]pksu,2722,0,1,4,5,20.0%,22m
22887,2,[IiUiI]Antisaint,2722,88,1,4,5,20.0%,2m
22887,1,[LMI42]FragMAN,2722,0,0,1,1,0.0%,3h
22887,2,skafia,2722,0,0,2,2,0.0%,3h
22908,3,[IMDSI]Hiroshima,2721,745,105,90,195,53.8%,9m
22908,3,Tassader,2721,1457,89,83,172,51.7%,4m
22908,2,IIIIIIIIIIII,2721,1514,85,78,163,52.1%,32m
22908,3,[Atoq]Meryiko,2721,1045,80,78,158,50.6%,28m
22908,2,Rex,2721,1642,73,65,138,52.9%,36m
22908,3,Kit,2721,821,73,66,139,52.5%,29m
22908,3,CDCLlll,2721,986,64,56,120,53.3%,25m
22908,3,Kdub,2721,1101,52,35,87,59.8%,20m
22908,3,[Knees]MajorasAss,2721,1089,40,44,84,47.6%,25m
22908,3,Enrique,2721,712,27,30,57,47.4%,14m
22908,1,suertudo,2721,538,22,9,31,71.0%,9m
22908,1,IVXX,2721,477,20,10,30,66.7%,59m
22908,1,[CU1T]DaTa,2721,418,13,9,22,59.1%,3h
22908,1,Mufaza,2721,312,13,11,24,54.2%,59m
22908,3,[DugNut]MGui,2721,382,13,16,29,44.8%,6m
22908,2,Servando,2721,283,12,14,26,46.2%,34m
22908,3,[EvilGC]AmericaSwine,2721,244,8,6,14,57.1%,1h
22908,3,[xRHx]Neo,2721,136,6,5,11,54.5%,24m
22908,3,[TGosuD]DrWatson,2721,140,6,10,16,37.5%,25m
22908,1,[tets]Sangeky,2721,154,4,0,4,100.0%,15m
22908,1,[ZTempz]chikennunget,2721,171,4,3,7,57.1%,36m
22908,3,max,2721,88,4,5,9,44.4%,38m
22908,2,Udyat,2721,0,1,3,4,25.0%,7m
22908,1,DanPochii,2721,0,0,1,1,0.0%,3h
22908,1,matos,2721,0,0,1,1,0.0%,14m
22908,1,broskYeus,2721,0,0,2,2,0.0%,3h
22908,3,SoftCatM,2721,0,0,4,4,0.0%,33m
22908,3,Abolishman,2721,0,0,5,5,0.0%,42m
22936,2,Ralans,2720,1569,324,320,644,50.3%,17m
22936,3,marchelose,2720,1392,97,74,171,56.7%,18m
22936,3,Naviester,2720,1550,68,63,131,51.9%,16m
22936,3,egyware,2720,1088,44,40,84,52.4%,37m
22936,3,Almito,2720,893,36,36,72,50.0%,17m
22936,3,[Exist]Nightknight,2720,641,33,19,52,63.5%,19m
22936,3,Grogu,2720,660,25,26,51,49.0%,5m
22936,3,[TBlink]Nosivo,2720,534,22,19,41,53.7%,5m
22936,1,[FROMOZ]BellasDad,2720,508,16,33,49,32.7%,40m
22936,3,[lnCo]Wukong,2720,213,13,14,27,48.1%,37m
22936,2,noizyBOY,2720,298,12,15,27,44.4%,35m
22936,1,LiLMaT,2720,147,5,6,11,45.5%,3h
22936,1,ZergRush,2720,185,4,2,6,66.7%,45m
22936,1,TargetMe,2720,145,4,2,6,66.7%,1h
22936,2,Gdragon,2720,0,4,4,8,50.0%,33m
22936,1,Feyd,2720,137,4,5,9,44.4%,37m
22936,2,Ichthyology,2720,120,4,17,21,19.0%,38m
22936,1,Psionic,2720,82,3,0,3,100.0%,1h
22936,2,AngryDonut,2720,140,3,1,4,75.0%,1h
22936,1,babai,2720,116,3,4,7,42.9%,3h
22936,3,captainG,2720,30,2,5,7,28.6%,3m
22936,1,lacreatura,2720,0,1,0,1,100.0%,53m
22936,3,GGSBill,2720,93,1,3,4,25.0%,42m
22959,3,LeopoldSkank,2719,1458,161,171,332,48.5%,2m
22959,1,soldiersvejk,2719,1508,107,114,221,48.4%,39m
22959,1,Starkiller,2719,1368,84,75,159,52.8%,3h
22959,1,[Rona]batllebuddy,2719,1704,71,59,130,54.6%,3h
22959,3,danielobao,2719,1060,40,42,82,48.8%,28m
22959,3,Anubis,2719,357,27,29,56,48.2%,33m
22959,3,Jeuie,2719,672,24,25,49,49.0%,31m
22959,3,sLnTsRvC,2719,494,23,20,43,53.5%,23m
22959,3,Tydro,2719,648,22,22,44,50.0%,4m
22959,3,Hanxy,2719,426,22,28,50,44.0%,6m
22959,3,Icekingwar,2719,223,11,11,22,50.0%,15m
22959,3,herovn,2719,237,8,7,15,53.3%,28m
22959,1,arkeus,2719,158,7,10,17,41.2%,27m
22959,1,Akrid,2719,163,6,6,12,50.0%,58m
22959,3,add,2719,190,6,14,20,30.0%,20m
22959,1,Anymore,2719,194,5,5,10,50.0%,3h
22959,2,KamZ,2719,112,5,14,19,26.3%,19m
22959,3,Qillzin,2719,30,4,4,8,50.0%,36m
22959,1,[BeGees]Sensei,2719,112,3,2,5,60.0%,50m
22959,1,SaCk,2719,90,3,3,6,50.0%,31m
22959,1,Adonis,2719,120,3,4,7,42.9%,47m
22959,3,ralp,2719,121,3,4,7,42.9%,30m
22959,1,[cnboys]Xlonen,2719,42,2,0,2,100.0%,3m
22959,1,[d0ngs]chadisbad,2719,93,2,3,5,40.0%,48m
22959,3,Freezing,2719,114,2,4,6,33.3%,6m
22959,1,[GOPERÚ]MINIGUUN,2719,42,1,1,2,50.0%,1h
22959,1,[HotsPL]claudiowing,2719,44,1,2,3,33.3%,39m
22959,1,[FJLAK]ddmpc,2719,97,1,2,3,33.3%,3h
22959,1,NiC,2719,0,1,2,3,33.3%,1h
22959,3,[WCKIT]ArkhamArchon,2719,30,1,4,5,20.0%,16m
22959,3,Sorli,2719,0,1,6,7,14.3%,3m
22959,1,Trynda,2719,0,0,3,3,0.0%,1h
22991,3,sdqpds,2718,1408,152,137,289,52.6%,20m
22991,2,Humantadpole,2718,1517,100,94,194,51.5%,8m
22991,3,[Lp]Pablits,2718,1514,91,88,179,50.8%,28m
22991,3,Tyrantoo,2718,1414,52,53,105,49.5%,11m
22991,1,Cro,2718,1152,49,53,102,48.0%,1h
22991,3,[Wizerd]Jafar,2718,678,29,25,54,53.7%,22m
22991,1,[TGosuB]Yeezus,2718,689,26,15,41,63.4%,10m
22991,1,XelNiqqa,2718,657,24,41,65,36.9%,4m
22991,2,[RevL]Eliezar,2718,550,21,24,45,46.7%,31m
22991,1,Grim,2718,357,19,19,38,50.0%,3h
22991,3,pigfart,2718,473,18,21,39,46.2%,41m
22991,3,HoesForYou,2718,380,16,15,31,51.6%,6m
22991,1,Stash,2718,370,13,11,24,54.2%,47m
22991,1,HeroicCookie,2718,287,12,1,13,92.3%,48m
22991,3,[TSOUR]DomaQuispes,2718,298,10,16,26,38.5%,39m
22991,1,Anya,2718,206,6,0,6,100.0%,10m
22991,1,[catcat]Anubis,2718,208,5,3,8,62.5%,3h
22991,3,Stonewall,2718,146,5,8,13,38.5%,35m
22991,3,[bLuu]TAMIR,2718,124,4,7,11,36.4%,22m
22991,1,[Preach]Killface,2718,127,3,2,5,60.0%,47m
22991,1,jonathan,2718,186,3,3,6,50.0%,18m
22991,2,Jefe,2718,96,3,4,7,42.9%,33m
22991,3,[NTPeru]gatoxx,2718,92,3,7,10,30.0%,43m
22991,1,[DHZ0ne]Pedra,2718,0,1,1,2,50.0%,1h
22991,1,YungShinji,2718,40,1,1,2,50.0%,3h
22991,3,Lentex,2718,0,1,5,6,16.7%,16m
22991,1,Fudgems,2718,0,0,1,1,0.0%,3h
22991,1,lear,2718,0,0,1,1,0.0%,13m
22991,3,DemiurgeF,2718,0,0,1,1,0.0%,6m
22991,3,iplaypong,2718,0,0,2,2,0.0%,6m
23021,3,playforreal,2717,1570,297,297,594,50.0%,12m
23021,2,LowKey,2717,1528,215,215,430,50.0%,17m
23021,2,Gerardito,2717,1436,127,122,249,51.0%,12m
23021,3,Dot,2717,929,120,106,226,53.1%,21m
23021,3,RippnNTerran,2717,1410,116,115,231,50.2%,18m
23021,3,jeanfranco,2717,1359,111,99,210,52.9%,7m
23021,3,[PAROLE]SChankira,2717,1189,108,110,218,49.5%,21m
23021,2,littlesteim,2717,1026,102,97,199,51.3%,34m
23021,3,xero,2717,1172,47,48,95,49.5%,18m
23021,1,Ratu,2717,780,43,29,72,59.7%,15m
23021,2,[OPbois]PassiveFist,2717,818,28,42,70,40.0%,8m
23021,3,Malkavian,2717,728,25,31,56,44.6%,5m
23021,3,CubeEarth,2717,518,21,21,42,50.0%,17m
23021,3,WidowMaker,2717,288,19,15,34,55.9%,3m
23021,3,janosabeee,2717,468,16,15,31,51.6%,39m
23021,1,Odina,2717,416,13,7,20,65.0%,30m
23021,3,[502nd]Infernal,2717,337,13,10,23,56.5%,25m
23021,2,Braego,2717,286,11,12,23,47.8%,36m
23021,1,star,2717,253,10,11,21,47.6%,31m
23021,1,tQPingPonG,2717,164,7,6,13,53.8%,6m
23021,3,JOPE,2717,174,7,9,16,43.8%,17m
23021,1,FadedTerran,2717,183,6,6,12,50.0%,1h
23021,1,AmUnknown,2717,185,5,3,8,62.5%,3h
23021,1,Trululu,2717,0,3,4,7,42.9%,28m
23021,1,choiboi,2717,0,2,6,8,25.0%,34m
23021,3,[GxS]Ghost,2717,30,2,7,9,22.2%,4m
23021,2,Esarel,2717,0,1,1,2,50.0%,60m
23021,3,jeqq,2717,0,1,2,3,33.3%,9m
23021,2,[FTLT]BeowulT,2717,46,1,2,3,33.3%,12m
23021,3,Davoh,2717,30,1,4,5,20.0%,22m
23021,1,Vayeate,2717,0,0,1,1,0.0%,57m
23021,1,hardwell,2717,0,0,1,1,0.0%,3h
23021,1,Neaplo,2717,0,0,10,10,0.0%,34m
23054,1,Dufflit,2716,1018,44,32,76,57.9%,57m
23054,1,Aresmar,2716,930,38,29,67,56.7%,53m
23054,2,TigerNuts,2716,637,27,32,59,45.8%,22m
23054,3,[TPGGXD]Arima,2716,476,16,19,35,45.7%,29m
23054,1,[TGCrew]Atlas,2716,336,13,4,17,76.5%,3h
23054,3,[iMOAN]Necroxion,2716,342,13,14,27,48.1%,41m
23054,3,Ashuwish,2716,390,12,15,27,44.4%,26m
23054,1,ashleysky,2716,182,6,3,9,66.7%,58m
23054,2,MoebiusFiles,2716,60,5,7,12,41.7%,32m
23054,3,[ValidG]OwnedByDrone,2716,140,4,2,6,66.7%,5m
23054,3,[KUBA]yAdIaN,2716,30,4,4,8,50.0%,28m
23054,2,[ZvP]Grendel,2716,168,4,6,10,40.0%,32m
23054,3,HIGHrider,2716,93,3,4,7,42.9%,28m
23054,2,Lehzee,2716,142,3,5,8,37.5%,38m
23054,1,RavenGloodus,2716,100,3,6,9,33.3%,3h
23054,2,sundaybrunch,2716,94,3,14,17,17.6%,15m
23054,1,LOL,2716,0,2,3,5,40.0%,3h
23054,1,qwer,2716,30,1,3,4,25.0%,9m
23054,3,DeusRekt,2716,92,1,6,7,14.3%,35m
23054,1,[Nut69]FartSmeller,2716,0,0,1,1,0.0%,3h
23054,1,Kaisher,2716,0,0,1,1,0.0%,15m
23054,1,KamikazeDuck,2716,0,0,2,2,0.0%,51m
23054,2,[XDRAX8]RaitoKun,2716,0,0,5,5,0.0%,15m
23054,3,[GOPERÚ]iProblem,2716,0,0,6,6,0.0%,23m
23078,2,Airness,2715,1568,956,913,1869,51.2%,28m
23078,2,Sebaroo,2715,1369,140,119,259,54.1%,19m
23078,3,heojinmyeong,2715,1398,64,60,124,51.6%,6m
23078,1,[SBXX]SteelVoynich,2715,549,18,15,33,54.5%,25m
23078,1,IMAVictor,2715,362,16,9,25,64.0%,47m
23078,3,Kverrr,2715,430,15,15,30,50.0%,12m
23078,3,HectorFelipe,2715,250,9,11,20,45.0%,16m
23078,1,[HDL]Raklann,2715,223,8,0,8,100.0%,5m
23078,3,mahanad,2715,200,8,10,18,44.4%,34m
23078,1,fortninja,2715,304,7,10,17,41.2%,1h
23078,1,israghetto,2715,74,3,2,5,60.0%,3m
23078,3,SebastianP,2715,62,3,9,12,25.0%,34m
23078,1,PuppetMaster,2715,0,2,3,5,40.0%,1h
23078,1,Knet,2715,80,2,3,5,40.0%,52m
23078,3,REDlips,2715,30,2,4,6,33.3%,33m
23078,1,Bob,2715,96,2,6,8,25.0%,1h
23078,1,[ABIO12]JefDahmrsKid,2715,0,1,0,1,100.0%,36m
23078,1,TurboNoob,2715,32,1,1,2,50.0%,1h
23078,3,AirOrange,2715,0,1,1,2,50.0%,4m
23078,1,Nilbog,2715,0,1,1,2,50.0%,1h
23078,1,[wafuru]MountDoom,2715,0,0,1,1,0.0%,1h
23078,1,Hariel,2715,0,0,2,2,0.0%,3h
23100,1,IOI,2714,1609,102,113,215,47.4%,15m
23100,3,[1X]MudBlood,2714,951,57,62,119,47.9%,3m
23100,2,Lego,2714,1177,46,54,100,46.0%,34m
23100,3,[Exist]DroneRush,2714,904,33,42,75,44.0%,24m
23100,3,DontHurtMe,2714,614,23,20,43,53.5%,36m
23100,1,Frostyshake,2714,536,19,17,36,52.8%,47m
23100,1,RedBloch,2714,596,19,18,37,51.4%,3h
23100,3,soopEr,2714,401,17,17,34,50.0%,23m
23100,1,MrTaco,2714,283,11,6,17,64.7%,1h
23100,1,[RaZerz]chedog,2714,271,9,9,18,50.0%,3h
23100,3,[ØFoxF2]Bossage,2714,231,7,8,15,46.7%,37m
23100,3,Rat,2714,116,4,7,11,36.4%,20m
23100,1,flop,2714,68,2,2,4,50.0%,1h
23100,1,flatearther,2714,38,2,5,7,28.6%,2h
23100,1,Nope,2714,30,1,1,2,50.0%,1h
23100,1,PORCINO,2714,0,1,2,3,33.3%,31m
23100,3,[7C]Steve,2714,30,1,6,7,14.3%,21m
23100,1,Casorus,2714,0,0,1,1,0.0%,37m
23100,1,[goooby]StronkFeast,2714,73,0,2,2,0.0%,3h
23100,2,EarMuffs,2714,0,0,7,7,0.0%,4m
23120,3,eyesnight,2713,581,111,91,202,55.0%,29m
23120,3,[CoopVN]akabavuong,2713,821,108,100,208,51.9%,40m
23120,3,idontknow,2713,1207,49,51,100,49.0%,39m
23120,1,yeeeeeeeeeet,2713,597,28,12,40,70.0%,7m
23120,3,[NFLDs]DAFOX,2713,478,17,21,38,44.7%,29m
23120,1,Arc,2713,393,15,13,28,53.6%,28m
23120,3,maicra,2713,215,13,12,25,52.0%,41m
23120,2,General,2713,244,12,14,26,46.2%,15m
23120,2,Fitzroy,2713,179,11,16,27,40.7%,9m
23120,3,TwoPump,2713,178,6,10,16,37.5%,28m
23120,1,Lemuria,2713,171,5,7,12,41.7%,3h
23120,1,llllllllllll,2713,97,4,5,9,44.4%,54m
23120,1,[LKTNES]gigio,2713,140,3,4,7,42.9%,40m
23120,2,Centi,2713,92,3,4,7,42.9%,1h
23120,1,Bravo,2713,38,2,1,3,66.7%,58m
23120,3,LoliLicker,2713,0,2,3,5,40.0%,1h
23120,3,Septtem,2713,0,2,3,5,40.0%,59m
23120,1,AmazingBread,2713,0,2,3,5,40.0%,3h
23120,3,[NoBads]BlackBirdWar,2713,90,2,5,7,28.6%,24m
23120,1,MrHeinzz,2713,0,1,0,1,100.0%,31m
23120,3,Grabber,2713,0,1,2,3,33.3%,32m
23120,3,[CUKES]Reaver,2713,95,1,4,5,20.0%,36m
23120,3,[EvilCC]LDAcnologia,2713,30,1,4,5,20.0%,7m
23120,1,Pulpa,2713,0,0,1,1,0.0%,15m
23120,1,malp,2713,0,0,2,2,0.0%,1h
23145,2,[EØ]javierusss,2712,1555,233,234,467,49.9%,40m
23145,3,exL,2712,1082,112,102,214,52.3%,5m
23145,3,Imperion,2712,1395,92,73,165,55.8%,4m
23145,2,Fluff,2712,1536,86,79,165,52.1%,18m
23145,3,DrugFreeBoy,2712,846,54,36,90,60.0%,17m
23145,3,SUDSYGOODz,2712,740,45,39,84,53.6%,43m
23145,3,muninn,2712,983,42,39,81,51.9%,17m
23145,3,Arkbennett,2712,1044,40,43,83,48.2%,17m
23145,3,[Crysis]Paradox,2712,697,28,26,54,51.9%,25m
23145,2,Ranran,2712,468,23,25,48,47.9%,32m
23145,2,YarKey,2712,506,19,24,43,44.2%,32m
23145,3,Umiale,2712,350,13,15,28,46.4%,41m
23145,3,Oaks,2712,388,13,20,33,39.4%,21m
23145,1,Zeratul,2712,259,9,10,19,47.4%,1h
23145,1,mosmos,2712,291,9,13,22,40.9%,47m
23145,2,[SMRT]angrycola,2712,161,5,4,9,55.6%,25m
23145,1,Kwanana,2712,120,4,3,7,57.1%,52m
23145,1,TheBoss,2712,152,4,5,9,44.4%,3m
23145,1,PrpaneDreams,2712,158,4,6,10,40.0%,28m
23145,3,KHAOZ,2712,75,4,8,12,33.3%,25m
23145,2,[IVA]Joel,2712,134,3,3,6,50.0%,1h
23145,2,AdmStrangler,2712,0,3,4,7,42.9%,36m
23145,2,Nitro,2712,0,3,4,7,42.9%,40m
23145,3,[hTx]DiOrcus,2712,94,3,8,11,27.3%,41m
23145,1,Maeio,2712,30,1,1,2,50.0%,3h
23145,2,STO,2712,48,1,2,3,33.3%,59m
23145,3,[BatiT]DAED,2712,0,1,2,3,33.3%,29m
23145,1,Mrevub,2712,0,1,2,3,33.3%,39m
23145,3,LatenKs,2712,0,1,3,4,25.0%,1h
23145,1,hickory,2712,0,0,1,1,0.0%,52m
23145,1,[SHILE]AlebV,2712,0,0,1,1,0.0%,1h
23145,1,Chenwy,2712,0,0,1,1,0.0%,36m
23145,1,Hero,2712,0,0,2,2,0.0%,54m
23145,1,[XurFR]Lightning,2712,0,0,2,2,0.0%,44m
23145,3,ChiliPawn,2712,0,0,4,4,0.0%,29m
23145,2,Donuts,2712,0,0,6,6,0.0%,7m
23181,1,AgentVenom,2711,805,73,54,127,57.5%,54m
23181,3,[TLIGHT]pdiddy,2711,1544,64,62,126,50.8%,35m
23181,3,Skor,2711,1407,57,56,113,50.4%,31m
23181,3,[BigMT]JefeKOHomero,2711,1170,54,57,111,48.6%,20m
23181,1,MinkTheSosa,2711,1016,37,30,67,55.2%,47m
23181,3,Balhae,2711,951,37,31,68,54.4%,32m
23181,1,[xSDBx]SauRio,2711,408,31,40,71,43.7%,28m
23181,1,IWillRushU,2711,791,27,30,57,47.4%,18m
23181,3,[TY4GG]Katarina,2711,701,24,26,50,48.0%,42m
23181,3,[ALTF04]EdgarGonzalo,2711,482,18,22,40,45.0%,40m
23181,1,blatt,2711,401,13,16,29,44.8%,3h
23181,1,LetsRave,2711,303,10,7,17,58.8%,3h
23181,1,[BaIIs]Owen,2711,345,10,9,19,52.6%,1h
23181,1,cameron,2711,268,9,1,10,90.0%,1h
23181,2,Match,2711,114,8,9,17,47.1%,11m
23181,2,Faintear,2711,217,5,6,11,45.5%,3h
23181,1,TrashCan,2711,132,4,1,5,80.0%,1h
23181,3,Thepotopa,2711,30,4,8,12,33.3%,9m
23181,1,Warflow,2711,88,3,3,6,50.0%,54m
23181,1,inebriate,2711,0,3,4,7,42.9%,51m
23181,1,Benevolence,2711,88,2,0,2,100.0%,1h
23181,1,[Fever]Dream,2711,102,2,1,3,66.7%,35m
23181,2,Lambert,2711,90,2,2,4,50.0%,3h
23181,2,Caesro,2711,64,2,13,15,13.3%,27m
23181,1,Yoon,2711,0,1,0,1,100.0%,3h
23181,1,Asento,2711,44,1,2,3,33.3%,3h
23181,3,John,2711,30,1,2,3,33.3%,1h
23181,1,JackHindell,2711,42,1,4,5,20.0%,3h
23181,1,ESPARTAXD,2711,0,0,1,1,0.0%,12m
23181,2,jBones,2711,0,0,1,1,0.0%,15m
23181,3,Khazidhea,2711,0,0,2,2,0.0%,22m
23181,1,LILWON,2711,0,0,2,2,0.0%,3h
23213,1,InstaQuasar,2710,698,96,81,177,54.2%,28m
23213,3,[FFAA]EthanR,2710,1028,70,58,128,54.7%,36m
23213,2,Viral,2710,711,58,59,117,49.6%,7m
23213,3,Fixxxer,2710,358,51,46,97,52.6%,11m
23213,2,CrstalMethod,2710,546,18,28,46,39.1%,32m
23213,1,BigJAsia,2710,513,17,11,28,60.7%,3h
23213,2,[ANC]zirp,2710,518,17,27,44,38.6%,7m
23213,1,JoeyTV,2710,318,10,4,14,71.4%,1h
23213,2,WhiteAsian,2710,156,5,5,10,50.0%,3h
23213,1,DeceiT,2710,97,4,5,9,44.4%,3h
23213,1,BobsRimjobs,2710,76,3,0,3,100.0%,36m
23213,3,Bubble,2710,0,3,2,5,60.0%,2h
23213,2,[Narval]Dragor,2710,0,3,3,6,50.0%,1h
23213,1,JayroSotto,2710,124,3,4,7,42.9%,58m
23213,1,MortalUmbra,2710,0,2,3,5,40.0%,36m
23213,3,Damascus,2710,0,2,3,5,40.0%,3h
23213,1,TRONIAN,2710,78,2,5,7,28.6%,39m
23213,3,DgDangDg,2710,0,1,1,2,50.0%,1h
23213,1,[LØGIA]FateRider,2710,0,1,2,3,33.3%,47m
23213,3,[TSFs]Grimm,2710,30,1,5,6,16.7%,42m
23213,1,[1for2]Rocketmaser,2710,0,0,1,1,0.0%,3h
23213,3,[TGosuA]TheRomanian,2710,0,0,6,6,0.0%,16m
23235,1,[maSC]ALETHEBAD,2709,1762,138,122,260,53.1%,1h
23235,3,MaskedBanana,2709,762,45,39,84,53.6%,30m
23235,1,Mauro,2709,848,34,32,66,51.5%,52m
23235,1,[Saltye]DragL,2709,578,25,15,40,62.5%,12m
23235,3,ShrekBaggins,2709,614,22,24,46,47.8%,28m
23235,2,MrEMan,2709,488,21,19,40,52.5%,14m
23235,1,Symbol,2709,565,19,18,37,51.4%,37m
23235,1,Warchief,2709,481,18,7,25,72.0%,1h
23235,3,Nugs,2709,410,14,20,34,41.2%,36m
23235,1,[NBZD]EzKill,2709,420,13,9,22,59.1%,11m
23235,3,[UKNOME]QuiRepublic,2709,349,12,11,23,52.2%,31m
23235,1,DroneGoBrr,2709,210,6,3,9,66.7%,1h
23235,3,yfgkytl,2709,159,6,7,13,46.2%,41m
23235,1,WhiteTiger,2709,152,6,9,15,40.0%,11m
23235,1,Allusive,2709,139,5,6,11,45.5%,3h
23235,1,Naypolian,2709,70,4,4,8,50.0%,55m
23235,1,[VENSC2]WILLSB,2709,112,3,1,4,75.0%,3h
23235,1,jpppppp,2709,144,3,1,4,75.0%,1h
23235,1,dopesolja,2709,78,3,2,5,60.0%,1h
23235,1,Mintbigred,2709,32,2,0,2,100.0%,3h
23235,1,EvilAbed,2709,119,2,1,3,66.7%,54m
23235,1,[cluez]Killer,2709,0,2,3,5,40.0%,3h
23235,1,[INextI]OnefOXPrime,2709,0,1,1,2,50.0%,1h
23235,1,Exeter,2709,38,1,2,3,33.3%,3h
23235,1,[DRKFOX]sunkae,2709,0,0,1,1,0.0%,15m
23260,2,[EzGaym]SpaceWranglr,2708,1573,189,193,382,49.5%,25m
23260,2,Fuino,2708,1514,178,172,350,50.9%,3m
23260,3,Red,2708,1576,169,153,322,52.5%,24m
23260,2,Geeyouknittt,2708,1603,129,139,268,48.1%,21m
23260,3,yleM,2708,431,40,38,78,51.3%,5m
23260,3,[Fir3s]Feynman,2708,842,32,34,66,48.5%,16m
23260,1,[Topos]Frijolito,2708,708,29,24,53,54.7%,3h
23260,3,[DarkAG]MinajestY,2708,477,18,17,35,51.4%,42m
23260,1,SeaUrchin,2708,251,11,11,22,50.0%,53m
23260,3,Sakthepro,2708,267,10,3,13,76.9%,3h
23260,3,hoagie,2708,144,7,11,18,38.9%,17m
23260,1,Mikebolou,2708,267,6,4,10,60.0%,15m
23260,1,[ExceI]Zechs,2708,220,6,6,12,50.0%,3h
23260,3,Gidrah,2708,85,6,9,15,40.0%,21m
23260,3,Bargosk,2708,170,5,9,14,35.7%,29m
23260,3,Enderdejoran,2708,126,5,22,27,18.5%,27m
23260,3,TigreBock,2708,169,4,8,12,33.3%,9m
23260,1,Jamepok,2708,121,3,2,5,60.0%,3h
23260,1,[Larvas]SlickPitbull,2708,96,3,6,9,33.3%,51m
23260,1,[Jue]MinOtAurGunR,2708,96,2,2,4,50.0%,9m
23260,1,primes,2708,82,2,3,5,40.0%,1h
23260,1,[Tanky]UIUCillini,2708,40,2,3,5,40.0%,3h
23260,3,Trill,2708,0,2,3,5,40.0%,13m
23260,1,Mixedbreedog,2708,0,1,0,1,100.0%,28m
23260,1,Bareleon,2708,0,1,1,2,50.0%,1h
23260,1,Rob,2708,40,1,1,2,50.0%,1h
23260,2,ICaRo,2708,95,1,1,2,50.0%,1h
23260,1,[GOPERÚ]TRAX,2708,0,1,1,2,50.0%,35m
23260,1,Jake,2708,0,1,2,3,33.3%,1h
23260,1,LuckyReaper,2708,0,1,3,4,25.0%,1h
23260,1,MARAUDER,2708,0,0,1,1,0.0%,54m
23260,2,[Hawkey]DanteShepard,2708,0,0,1,1,0.0%,1h
23260,1,MrMan,2708,0,0,1,1,0.0%,3h
23260,1,[ChemoN]Invalid,2708,0,0,2,2,0.0%,3h
23294,2,deathwalker,2707,1569,288,281,569,50.6%,32m
23294,3,lavkian,2707,1510,88,78,166,53.0%,30m
23294,1,[ALQ]ReAdosS,2707,1090,84,84,168,50.0%,39m
23294,3,beavis,2707,1387,71,63,134,53.0%,42m
23294,1,tehepicwin,2707,1240,49,39,88,55.7%,3h
23294,3,EDDY,2707,952,43,36,79,54.4%,4m
23294,3,mgaur,2707,1071,42,40,82,51.2%,25m
23294,3,[xFsNxx]sPeCtRuM,2707,860,37,44,81,45.7%,22m
23294,1,[tCo9]icecream,2707,1008,32,33,65,49.2%,1h
23294,3,REDvBLUE,2707,417,15,15,30,50.0%,17m
23294,2,feastbox,2707,159,5,4,9,55.6%,21m
23294,1,Lucian,2707,152,5,5,10,50.0%,31m
23294,2,SirZepre,2707,154,4,6,10,40.0%,32m
23294,2,[RTCLAN]Chubbabubba,2707,90,3,3,6,50.0%,3h
23294,2,Ford,2707,0,3,4,7,42.9%,13m
23294,3,[EBs]RAM,2707,0,2,3,5,40.0%,1h
23294,3,Jsizzle,2707,0,2,3,5,40.0%,3h
23294,3,Grimzey,2707,30,2,3,5,40.0%,28m
23294,1,FewFearDeath,2707,0,2,3,5,40.0%,50m
23294,1,[Astrus]rambo,2707,0,0,2,2,0.0%,54m
23314,3,sadmudcrab,2706,1540,80,77,157,51.0%,29m
23314,2,nothavephone,2706,568,21,28,49,42.9%,28m
23314,1,Tsias,2706,502,17,14,31,54.8%,51m
23314,2,alcapowned,2706,113,17,20,37,45.9%,23m
23314,1,HigherPower,2706,362,9,17,26,34.6%,58m
23314,3,Zalanax,2706,206,7,11,18,38.9%,39m
23314,3,Metternich,2706,156,6,6,12,50.0%,28m
23314,1,Cannedhodge,2706,191,5,1,6,83.3%,58m
23314,3,Exilious,2706,160,5,11,16,31.2%,5m
23314,2,ZerglingMan,2706,94,3,1,4,75.0%,3h
23314,3,ADAMGGUNIT,2706,0,3,5,8,37.5%,4m
23314,2,Ariadust,2706,42,2,1,3,66.7%,3h
23314,3,DVusWayz,2706,0,2,3,5,40.0%,3h
23314,1,DarkSlayer,2706,0,2,3,5,40.0%,1h
23314,1,[mator]Slayer,2706,122,2,3,5,40.0%,34m
23314,3,Chaos,2706,0,2,3,5,40.0%,50m
23314,2,ZergOP,2706,0,2,4,6,33.3%,1h
23314,1,PizzaPie,2706,0,1,0,1,100.0%,22m
23314,1,MerScout,2706,0,1,0,1,100.0%,3h
23314,1,AnimaOscura,2706,0,1,1,2,50.0%,56m
23314,1,[Thanat]CastAway,2706,0,0,1,1,0.0%,37m
23314,1,ALMANEGRA,2706,0,0,2,2,0.0%,3h
23336,3,hitimes,2705,679,54,58,112,48.2%,13m
23336,3,Arngrim,2705,1254,45,50,95,47.4%,4m
23336,1,[xDBZx]AlfredoCruz,2705,770,26,21,47,55.3%,37m
23336,1,PotatoTerran,2705,278,9,2,11,81.8%,53m
23336,3,[CR100]SubSeven,2705,254,9,14,23,39.1%,21m
23336,1,[CrDoom]FallenAngel,2705,204,8,10,18,44.4%,37m
23336,3,darkmage,2705,242,8,13,21,38.1%,7m
23336,1,Nugoo,2705,216,6,6,12,50.0%,3h
23336,2,Yone,2705,114,5,3,8,62.5%,3h
23336,1,YUMC,2705,192,5,11,16,31.2%,3h
23336,3,SangDang,2705,102,4,4,8,50.0%,26m
23336,3,Kaz,2705,147,4,5,9,44.4%,5m
23336,2,gettincrafty,2705,94,3,3,6,50.0%,3h
23336,1,Geoth,2705,122,3,4,7,42.9%,37m
23336,3,EpicSchiPhy,2705,121,3,4,7,42.9%,32m
23336,3,[SCboys]Imagination,2705,60,3,5,8,37.5%,17m
23336,1,Crepuscular,2705,40,2,0,2,100.0%,1h
23336,2,Jakk,2705,46,2,0,2,100.0%,42m
23336,1,MasonisHiga,2705,40,2,2,4,50.0%,58m
23336,3,NOBLEone,2705,0,2,3,5,40.0%,58m
23336,1,[AofS]Ace,2705,0,2,3,5,40.0%,1h
23336,1,MacDaddy,2705,0,1,0,1,100.0%,2h
23336,1,UrekMazino,2705,42,1,1,2,50.0%,28m
23336,1,[DADrUS]Dax,2705,42,1,1,2,50.0%,39m
23336,1,[Krator]InPulse,2705,44,1,2,3,33.3%,3h
23336,1,[VDZ]Brykenn,2705,0,0,1,1,0.0%,47m
23336,1,[Bee]holepercent,2705,0,0,1,1,0.0%,1h
23336,1,Zexonic,2705,0,0,1,1,0.0%,12m
23364,3,millermar,2704,1546,399,387,786,50.8%,37m
23364,1,spaceused,2704,937,41,27,68,60.3%,1h
23364,3,Feelix,2704,1046,38,40,78,48.7%,15m
23364,1,Physics,2704,1004,35,33,68,51.5%,3h
23364,3,[YNEZ]THCExtract,2704,474,17,22,39,43.6%,5m
23364,3,kaishakunin,2704,325,12,11,23,52.2%,40m
23364,3,RichardA,2704,256,11,6,17,64.7%,28m
23364,3,nikusRSS,2704,300,11,10,21,52.4%,60m
23364,3,Zultor,2704,266,10,9,19,52.6%,29m
23364,3,Alan,2704,191,8,7,15,53.3%,37m
23364,3,Faith,2704,142,4,1,5,80.0%,1h
23364,3,Pekorekt,2704,165,4,6,10,40.0%,34m
23364,3,Terran,2704,155,4,7,11,36.4%,58m
23364,3,[ILK]SugarSZ,2704,120,3,2,5,60.0%,20m
23364,3,FattPenguin,2704,150,3,6,9,33.3%,39m
23364,1,Cookiller,2704,128,2,1,3,66.7%,2h
23364,3,[LifeF]Nimo,2704,91,2,3,5,40.0%,33m
23364,1,Almld,2704,0,2,3,5,40.0%,48m
23364,3,ImPrettyOP,2704,58,2,6,8,25.0%,13m
23364,1,[IMDSI]huach,2704,0,1,0,1,100.0%,1h
23364,1,Timoteus,2704,34,1,3,4,25.0%,22m
23364,1,[LMASC2]Morfo,2704,0,0,1,1,0.0%,1h
23364,1,Biro,2704,0,0,1,1,0.0%,1h
23364,1,IIIIIII,2704,0,0,2,2,0.0%,51m
23364,1,paRaDe,2704,0,0,3,3,0.0%,57m
23364,1,COPA,2704,0,0,3,3,0.0%,13m
23390,3,TheIronChef,2703,1505,244,235,479,50.9%,7m
23390,3,Akare,2703,1475,165,147,312,52.9%,3m
23390,3,invalideight,2703,1624,134,127,261,51.3%,28m
23390,3,Kent,2703,1518,82,79,161,50.9%,8m
23390,1,Dazzeb,2703,720,44,28,72,61.1%,50m
23390,3,[FyHr]Riut,2703,1002,44,46,90,48.9%,37m
23390,3,LuciferSam,2703,815,34,28,62,54.8%,25m
23390,2,[KGH]RickyBeaner,2703,288,14,12,26,53.8%,32m
23390,1,[BLZN]JORDANJ,2703,330,10,5,15,66.7%,3h
23390,3,Cadrigar,2703,260,10,13,23,43.5%,21m
23390,1,dilondon,2703,219,6,8,14,42.9%,3h
23390,1,ThiccRyza,2703,96,5,5,10,50.0%,52m
23390,1,iEndeavor,2703,161,4,0,4,100.0%,9m
23390,1,[TCProG]KyGuy,2703,110,4,3,7,57.1%,3h
23390,2,[CINTAX]Noname,2703,46,4,5,9,44.4%,34m
23390,1,ZoO,2703,0,3,2,5,60.0%,1h
23390,1,[MH]DarkLee,2703,97,3,3,6,50.0%,34m
23390,2,FarmerJon,2703,141,3,6,9,33.3%,3h
23390,1,joakozamata,2703,0,1,0,1,100.0%,10m
23390,1,Lezter,2703,0,1,0,1,100.0%,3h
23390,1,GTO,2703,0,1,1,2,50.0%,1h
23390,1,[ALT]DrNick,2703,40,1,2,3,33.3%,3h
23390,3,King,2703,0,1,4,5,20.0%,33m
23390,1,[Clika]Fuchi,2703,0,0,1,1,0.0%,3h
23390,1,[CBYS]LintyAnt,2703,0,0,2,2,0.0%,48m
23390,1,Maritime,2703,0,0,5,5,0.0%,57m
23416,2,[XIAK]niagarafury,2702,1208,217,223,440,49.3%,30m
23416,3,Spartan,2702,1631,135,133,268,50.4%,28m
23416,1,GasMaskGhost,2702,1629,84,68,152,55.3%,27m
23416,3,[UxL]SwarmSlayer,2702,1423,59,60,119,49.6%,21m
23416,1,Vincini,2702,1342,57,48,105,54.3%,49m
23416,3,Gameraids,2702,202,13,10,23,56.5%,3m
23416,1,Dishonored,2702,406,13,12,25,52.0%,48m
23416,1,[Tribes]beLIEve,2702,173,11,7,18,61.1%,3h
23416,3,[Ari]Bouds,2702,139,9,7,16,56.2%,36m
23416,3,Dmoney,2702,208,8,13,21,38.1%,10m
23416,3,Gepson,2702,178,7,8,15,46.7%,46m
23416,3,Velicos,2702,60,5,6,11,45.5%,39m
23416,3,SacredFz,2702,133,4,5,9,44.4%,40m
23416,3,JSJS,2702,86,3,7,10,30.0%,40m
23416,2,evilpem,2702,62,3,11,14,21.4%,10m
23416,1,Guan,2702,0,1,1,2,50.0%,28m
23416,1,[SWAG6]Harwis,2702,0,0,1,1,0.0%,1h
23416,1,MasterRaynor,2702,0,0,3,3,0.0%,3h
23434,1,Tigger,2701,1572,300,309,609,49.3%,40m
23434,3,lui,2701,1528,179,161,340,52.6%,22m
23434,3,NovemberRain,2701,1465,136,125,261,52.1%,28m
23434,1,[rusmer]Gherol,2701,1689,87,60,147,59.2%,53m
23434,3,[BmGZ]Wolfgang,2701,1311,73,72,145,50.3%,29m
23434,3,[zXDz]Killerjp,2701,1356,61,64,125,48.8%,37m
23434,2,Probinho,2701,1076,37,50,87,42.5%,8m
23434,3,scraul,2701,659,31,34,65,47.7%,14m
23434,1,MobyLick,2701,821,30,25,55,54.5%,3h
23434,1,GOLPEOAMAMA,2701,412,14,12,26,53.8%,14m
23434,1,HybridXZ,2701,361,13,17,30,43.3%,27m
23434,1,Chonte,2701,397,12,7,19,63.2%,3h
23434,3,Revanite,2701,337,12,11,23,52.2%,7m
23434,1,[ELLOCO]Starscream,2701,315,11,4,15,73.3%,7m
23434,3,[USplan]Nukeem,2701,218,10,13,23,43.5%,12m
23434,1,Volthum,2701,267,9,8,17,52.9%,25m
23434,2,infernaldrag,2701,281,9,13,22,40.9%,11m
23434,3,Hammer,2701,126,9,13,22,40.9%,9m
23434,2,GrimReaper,2701,120,7,4,11,63.6%,3h
23434,3,Yanko,2701,172,7,9,16,43.8%,3h
23434,3,Cozy,2701,151,7,10,17,41.2%,1h
23434,1,[GiLLs]FDSBosox,2701,165,4,3,7,57.1%,32m
23434,1,weaghjjhfdss,2701,58,4,4,8,50.0%,1h
23434,1,Zollagins,2701,80,3,3,6,50.0%,37m
23434,2,Vetinari,2701,0,3,3,6,50.0%,1h
23434,1,LeBronzJames,2701,0,2,3,5,40.0%,36m
23434,1,zIn,2701,96,2,3,5,40.0%,47m
23434,2,[s1s]Khadgar,2701,0,2,5,7,28.6%,60m
23434,2,Tirano,2701,0,1,0,1,100.0%,3h
23434,1,[HEREOS]alltocrazy,2701,0,1,0,1,100.0%,3h
23434,1,vuitron,2701,0,1,0,1,100.0%,3h
23434,2,[TØXIC]ilovececy,2701,88,1,2,3,33.3%,26m
23434,1,[usmp]Klaus,2701,0,1,3,4,25.0%,37m
23467,2,chrispy,2700,1445,153,151,304,50.3%,33m
23467,3,[CHch]DanKokoro,2700,1440,120,119,239,50.2%,28m
23467,3,[YIFFME]Havok,2700,892,97,93,190,51.1%,39m
23467,1,Brick,2700,1659,73,63,136,53.7%,3h
23467,2,Meatballer,2700,1326,53,63,116,45.7%,3m
23467,1,Billiam,2700,889,30,31,61,49.2%,1h
23467,1,[nieBla]Kurisu,2700,590,20,19,39,51.3%,15m
23467,3,benedict,2700,438,19,16,35,54.3%,35m
23467,3,[GEI]FFiGhTeR,2700,426,18,25,43,41.9%,14m
23467,3,Aqua,2700,446,17,25,42,40.5%,6m
23467,1,[iCz]AsFBrolly,2700,320,14,3,17,82.4%,25m
23467,3,Isabella,2700,383,12,20,32,37.5%,14m
23467,1,Decay,2700,247,8,7,15,53.3%,4m
23467,3,mouse,2700,218,8,11,19,42.1%,13m
23467,3,AntM,2700,205,7,16,23,30.4%,8m
23467,3,[DrKatz]IIDDYYLL,2700,174,6,7,13,46.2%,4m
23467,1,Ender,2700,159,4,3,7,57.1%,2h
23467,1,[NPFR]Adele,2700,126,3,0,3,100.0%,49m
23467,2,[La]LeMoN,2700,94,3,4,7,42.9%,1h
23467,1,[VALHL]GopherChucks,2700,0,2,3,5,40.0%,3h
23467,1,PersonNight,2700,0,1,0,1,100.0%,49m
23467,1,[TgAg]Wir,2700,40,1,2,3,33.3%,55m
23467,3,cheese,2700,30,1,3,4,25.0%,26m
23467,1,Majitsu,2700,0,0,1,1,0.0%,2h
23491,3,[GIBE]Chukwu,2699,1506,325,324,649,50.1%,14m
23491,1,[LMI42]KennethCali,2699,1743,287,279,566,50.7%,41m
23491,1,[ZWars]NivlaQpix,2699,1708,91,82,173,52.6%,1h
23491,3,Illuminacci,2699,1342,83,63,146,56.8%,4m
23491,1,Quad,2699,1671,77,64,141,54.6%,3h
23491,3,Guinness,2699,600,62,57,119,52.1%,43m
23491,1,SHECKWES,2699,1003,47,40,87,54.0%,51m
23491,3,POPEYE,2699,1026,40,39,79,50.6%,22m
23491,3,Ulisses,2699,733,32,31,63,50.8%,29m
23491,1,wakanda,2699,464,29,13,42,69.0%,1h
23491,3,Crabapple,2699,416,27,23,50,54.0%,29m
23491,3,Volley,2699,686,26,25,51,51.0%,7m
23491,3,FeralPig,2699,573,20,23,43,46.5%,21m
23491,1,chaKRONOS,2699,459,19,7,26,73.1%,3m
23491,2,[GRNSKN]LenweTurtle,2699,364,16,27,43,37.2%,14m
23491,1,BUJIGANOMEMI,2699,442,14,12,26,53.8%,1h
23491,3,Gael,2699,264,10,12,22,45.5%,15m
23491,2,BadEmployee,2699,62,5,7,12,41.7%,19m
23491,3,MortHobbs,2699,139,4,4,8,50.0%,12m
23491,1,[CLWA]kazuto,2699,136,3,2,5,60.0%,50m
23491,1,Embolia,2699,0,3,2,5,60.0%,28m
23491,3,FaFaN,2699,146,3,4,7,42.9%,7m
23491,1,[a1vNA]Straus,2699,42,2,0,2,100.0%,3h
23491,3,GhostRippa,2699,0,2,3,5,40.0%,3h
23491,1,Moebeast,2699,111,2,3,5,40.0%,3h
23491,1,KimJongSkill,2699,91,2,4,6,33.3%,1h
23491,3,BobbyDeuscha,2699,120,2,5,7,28.6%,20m
23491,1,Carpediem,2699,0,1,0,1,100.0%,39m
23491,1,America,2699,40,1,3,4,25.0%,3h
23491,2,elementalec,2699,0,0,1,1,0.0%,31m
23491,3,llllllllllll,2699,0,0,1,1,0.0%,1h
23491,1,[Whaaaa]Mathurin,2699,0,0,2,2,0.0%,35m
23491,1,Tunamelt,2699,0,0,2,2,0.0%,6m
23491,1,[2faded]jchill,2699,0,0,3,3,0.0%,3h
23525,2,gwolf,2698,1602,295,296,591,49.9%,32m
23525,1,quifaklese,2698,1298,63,54,117,53.8%,5m
23525,1,Mybaran,2698,804,53,40,93,57.0%,2h
23525,1,[GOPERÚ]lllllllllll,2698,1237,49,31,80,61.2%,3h
23525,1,nattylight,2698,1192,46,39,85,54.1%,28m
23525,1,MusaranhoBR,2698,1040,41,35,76,53.9%,1h
23525,3,RPQ,2698,874,41,38,79,51.9%,38m
23525,1,[KG73]Atzuky,2698,578,29,14,43,67.4%,3h
23525,3,[Nipnum]Xpew,2698,617,22,25,47,46.8%,29m
23525,1,Daptar,2698,632,19,21,40,47.5%,13m
23525,3,Barbanegra,2698,252,14,16,30,46.7%,26m
23525,3,Sparky,2698,338,13,9,22,59.1%,4m
23525,3,White,2698,160,11,12,23,47.8%,3m
23525,3,aleXanDre,2698,279,10,11,21,47.6%,26m
23525,3,Orami,2698,246,10,13,23,43.5%,25m
23525,1,EmptyHell,2698,233,7,7,14,50.0%,59m
23525,3,[TGosuB]XLBeastmode,2698,222,7,15,22,31.8%,39m
23525,3,Cloud,2698,58,5,5,10,50.0%,3m
23525,3,STIMTOWIN,2698,145,4,1,5,80.0%,29m
23525,3,[sk3tch]MILKnCOOKIES,2698,96,4,11,15,26.7%,35m
23525,1,XaviSavi,2698,0,3,3,6,50.0%,1h
23525,3,[savitr]JCA,2698,60,3,5,8,37.5%,22m
23525,1,OrbitalSun,2698,0,2,1,3,66.7%,21m
23525,2,Glosaric,2698,138,2,1,3,66.7%,3h
23525,2,JohnSmith,2698,138,2,2,4,50.0%,3h
23525,3,Yazik,2698,0,2,3,5,40.0%,3h
23525,3,[Cactus]asillie,2698,95,2,5,7,28.6%,15m
23525,1,mitula,2698,0,1,2,3,33.3%,28m
23525,1,Juanpita,2698,32,1,3,4,25.0%,3h
23525,1,Harakiri,2698,0,0,1,1,0.0%,3h
23525,2,Blaster,2698,0,0,1,1,0.0%,3h
23525,1,Hamlet,2698,0,0,2,2,0.0%,1h
23525,1,HairyProbe,2698,0,0,3,3,0.0%,16m
23558,2,Deeznutz,2697,1416,177,169,346,51.2%,38m
23558,2,Dubba,2697,869,59,65,124,47.6%,9m
23558,3,[THlNG]Rakuoha,2697,419,56,45,101,55.4%,37m
23558,3,Hermione,2697,686,24,27,51,47.1%,28m
23558,3,Merlin,2697,368,18,19,37,48.6%,37m
23558,1,xandr,2697,396,16,12,28,57.1%,1h
23558,1,Jarzman,2697,358,16,13,29,55.2%,4m
23558,1,REDROGO,2697,435,15,17,32,46.9%,58m
23558,1,Starslayer,2697,281,11,13,24,45.8%,1h
23558,1,poxxop,2697,321,10,4,14,71.4%,3h
23558,1,TerranBoy,2697,328,10,11,21,47.6%,1h
23558,1,frank,2697,192,8,6,14,57.1%,1h
23558,3,AluPIgus,2697,204,8,10,18,44.4%,3h
23558,1,HeroGhots,2697,204,6,3,9,66.7%,40m
23558,1,bobi,2697,233,6,5,11,54.5%,3h
23558,3,CaptainTrips,2697,90,6,7,13,46.2%,40m
23558,1,MechaDoge,2697,140,5,5,10,50.0%,58m
23558,2,PomeLOS,2697,138,4,6,10,40.0%,1h
23558,1,[GTGT]BaconRape,2697,116,3,4,7,42.9%,41m
23558,1,crazystix,2697,159,3,5,8,37.5%,3h
23558,3,BlindWolf,2697,30,2,8,10,20.0%,24m
23558,1,Khaman,2697,0,1,0,1,100.0%,3h
23558,3,[Newbi3]Arkahas,2697,0,1,0,1,100.0%,1h
23558,1,PEDROTAZ,2697,38,1,2,3,33.3%,52m
23558,2,Accelerator,2697,0,0,1,1,0.0%,3h
23558,1,drkpng,2697,0,0,5,5,0.0%,1h
23558,2,Kappaccinoh,2697,0,0,9,9,0.0%,32m
23585,3,HaKi,2696,1544,322,302,624,51.6%,40m
23585,1,techsiro,2696,1590,144,148,292,49.3%,20m
23585,3,[PuffWC]AnimalMother,2696,1416,139,134,273,50.9%,27m
23585,1,stnrbob,2696,554,18,18,36,50.0%,11m
23585,3,PoNinja,2696,440,14,16,30,46.7%,42m
23585,1,DOTERO,2696,319,13,3,16,81.2%,37m
23585,1,Freekz,2696,308,13,14,27,48.1%,30m
23585,1,[Skull]Whiteskull,2696,372,13,18,31,41.9%,1h
23585,1,TalaNur,2696,239,10,14,24,41.7%,27m
23585,3,Axeloid,2696,190,8,6,14,57.1%,3m
23585,1,danstrue,2696,168,6,7,13,46.2%,7m
23585,3,eduar,2696,197,6,7,13,46.2%,39m
23585,1,Sorrow,2696,188,6,7,13,46.2%,1h
23585,1,Brederodes,2696,120,4,4,8,50.0%,3h
23585,2,Wickedboy,2696,96,3,4,7,42.9%,2h
23585,1,pussomatic,2696,0,3,4,7,42.9%,36m
23585,1,[Noon]kerntastic,2696,0,1,0,1,100.0%,53m
23585,2,BotFlamer,2696,0,1,0,1,100.0%,1h
23585,3,vinster,2696,0,1,1,2,50.0%,1h
23585,3,Rogy,2696,30,1,2,3,33.3%,3h
23585,1,Spamicus,2696,40,1,3,4,25.0%,3h
23585,2,[RSpctr]Dominicdja,2696,0,0,12,12,0.0%,34m
23607,3,SiegfriedXD,2695,769,274,248,522,52.5%,41m
23607,1,Skipper,2695,1533,239,252,491,48.7%,42m
23607,1,peepingthom,2695,1686,164,161,325,50.5%,52m
23607,3,PussCfarts,2695,583,45,43,88,51.1%,10m
23607,1,zerling,2695,428,28,18,46,60.9%,11m
23607,2,Fckboy,2695,494,16,28,44,36.4%,29m
23607,3,Maverik,2695,392,15,18,33,45.5%,32m
23607,3,[UpxV]GianSSC,2695,236,9,11,20,45.0%,3m
23607,1,IlIIllIIllII,2695,186,7,7,14,50.0%,3h
23607,1,PsYcHO,2695,88,5,6,11,45.5%,3h
23607,3,AcidWulf,2695,0,4,4,8,50.0%,16m
23607,1,Mpsmash,2695,154,4,7,11,36.4%,4m
23607,2,Coffee,2695,154,4,18,22,18.2%,1h
23607,3,[atrox]ZimbobwayOrp,2695,95,3,4,7,42.9%,36m
23607,3,XYZee,2695,0,2,3,5,40.0%,43m
23607,1,[HOZE]Sazz,2695,0,2,3,5,40.0%,1h
23607,1,Tashin,2695,0,2,3,5,40.0%,48m
23607,1,Corotex,2695,0,2,3,5,40.0%,3h
23607,1,STARLORD,2695,0,1,0,1,100.0%,1h
23607,3,Xcom,2695,0,1,2,3,33.3%,9m
23607,1,Caifas,2695,42,1,3,4,25.0%,48m
23607,1,Corcaigh,2695,0,0,1,1,0.0%,22m
23607,1,[baêa]Tau,2695,0,0,1,1,0.0%,50m
23607,1,IIIIllllIII,2695,0,0,2,2,0.0%,58m
23631,3,Kabanus,2694,1526,275,275,550,50.0%,25m
23631,3,PianoMethod,2694,1623,170,163,333,51.1%,17m
23631,3,ANDYK,2694,837,83,70,153,54.2%,21m
23631,1,Climbingbum,2694,1688,73,71,144,50.7%,3h
23631,3,RockAnarchy,2694,832,57,53,110,51.8%,26m
23631,1,KMAxStretch,2694,514,19,18,37,51.4%,21m
23631,1,ghoster,2694,552,18,12,30,60.0%,1h
23631,2,[SEEXEE]Aisthesis,2694,528,18,27,45,40.0%,8m
23631,2,[JTRUMP]MilesCru,2694,483,16,24,40,40.0%,8m
23631,3,Funkernaut,2694,454,14,45,59,23.7%,25m
23631,1,gibmadaf,2694,387,12,7,19,63.2%,30m
23631,1,AdictoAlSc,2694,346,12,7,19,63.2%,52m
23631,1,cmays,2694,306,12,15,27,44.4%,41m
23631,3,Caravan,2694,151,6,9,15,40.0%,30m
23631,3,Abdel,2694,0,4,2,6,66.7%,24m
23631,3,Cholito,2694,0,4,2,6,66.7%,17m
23631,1,MrRogers,2694,140,4,3,7,57.1%,28m
23631,3,MarkReactor,2694,147,4,4,8,50.0%,59m
23631,1,piggy,2694,118,4,4,8,50.0%,13m
23631,3,RoBot,2694,86,4,6,10,40.0%,3m
23631,1,Paul,2694,76,3,1,4,75.0%,1h
23631,1,[TTKOPF]Arrow,2694,82,2,3,5,40.0%,22m
23631,3,MidEvil,2694,0,2,3,5,40.0%,2h
23631,3,djmak,2694,0,2,3,5,40.0%,35m
23631,1,Lobato,2694,113,1,3,4,25.0%,1h
23631,1,MrPylon,2694,0,0,1,1,0.0%,31m
23657,2,HaoMao,2693,1527,471,456,927,50.8%,32m
23657,2,Mew,2693,1461,107,108,215,49.8%,14m
23657,1,Andreas,2693,1201,96,80,176,54.5%,27m
23657,2,[LOHc]Machiavelli,2693,1321,96,98,194,49.5%,14m
23657,1,Semi,2693,1575,67,62,129,51.9%,3h
23657,1,[TMSyN]Zirou,2693,827,51,50,101,50.5%,1h
23657,3,[XTCES]zach,2693,752,31,32,63,49.2%,20m
23657,3,[Msia]Firedamage,2693,510,18,26,44,40.9%,41m
23657,1,OBSIDIAN,2693,261,15,12,27,55.6%,49m
23657,2,Redrum,2693,259,12,13,25,48.0%,35m
23657,2,[EzWinn]NoobSAUCE,2693,244,9,17,26,34.6%,19m
23657,3,Spacemommy,2693,200,8,13,21,38.1%,1h
23657,1,WhiteTiger,2693,192,7,7,14,50.0%,54m
23657,1,SombraOscura,2693,233,6,5,11,54.5%,58m
23657,1,Daniel,2693,114,4,3,7,57.1%,53m
23657,3,vtflea,2693,120,4,11,15,26.7%,3m
23657,1,tholapz,2693,88,3,3,6,50.0%,7m
23657,3,jharding,2693,88,3,8,11,27.3%,5m
23657,1,bigdickdan,2693,43,2,3,5,40.0%,25m
23657,1,PacoElTaco,2693,0,2,3,5,40.0%,57m
23657,3,[ZNsc]empireyoncar,2693,62,2,9,11,18.2%,24m
23657,1,Jonny,2693,0,1,0,1,100.0%,52m
23657,1,[JUGOS]tuto,2693,0,1,0,1,100.0%,47m
23657,1,[NPhasA]tiggerwang,2693,0,1,0,1,100.0%,3h
23657,1,Bane,2693,0,1,1,2,50.0%,53m
23657,1,Raychuq,2693,0,1,1,2,50.0%,1h
23657,1,RoachArmy,2693,0,1,1,2,50.0%,58m
23657,1,krey,2693,44,1,4,5,20.0%,13m
23657,2,RotDMceh,2693,46,1,7,8,12.5%,1h
23657,1,[SlPo]AlexJ,2693,0,0,1,1,0.0%,31m
23657,3,BobZii,2693,0,0,1,1,0.0%,3h
23657,1,Justin,2693,0,0,2,2,0.0%,3h
23657,1,Rick,2693,0,0,2,2,0.0%,15m
23690,3,Singularity,2692,1546,108,92,200,54.0%,9m
23690,1,HaakuKaaley,2692,1484,83,72,155,53.5%,1h
23690,3,Matarreyess,2692,867,61,50,111,55.0%,22m
23690,3,BeliMaMa,2692,1365,51,52,103,49.5%,9m
23690,3,WilliamHa,2692,583,47,44,91,51.6%,11m
23690,3,Conan,2692,627,24,23,47,51.1%,40m
23690,1,Belbrose,2692,675,23,17,40,57.5%,3h
23690,3,[XpKAc]Pendulum,2692,632,21,28,49,42.9%,18m
23690,1,JeongSewoon,2692,390,19,3,22,86.4%,28m
23690,3,[PapaG]Specialthing,2692,348,14,10,24,58.3%,17m
23690,1,Wolla,2692,404,11,12,23,47.8%,5m
23690,3,TaSMaNiA,2692,312,11,17,28,39.3%,37m
23690,3,Guil,2692,249,9,10,19,47.4%,28m
23690,1,[KNDLA]KamiBlader,2692,250,7,3,10,70.0%,1h
23690,3,DarkCow,2692,211,7,6,13,53.8%,28m
23690,1,rusty,2692,198,7,8,15,46.7%,21m
23690,1,emeris,2692,156,5,6,11,45.5%,3h
23690,3,[DarkAG]llllllllllll,2692,88,5,8,13,38.5%,4m
23690,3,christia,2692,154,5,10,15,33.3%,37m
23690,3,[HEZUS]DietProtoss,2692,122,3,2,5,60.0%,26m
23690,1,[GnR]GrinchMaster,2692,115,3,4,7,42.9%,50m
23690,3,SubPenguin,2692,0,2,3,5,40.0%,2h
23690,1,Trainman,2692,40,2,3,5,40.0%,3h
23690,1,[KVR]SINA,2692,0,1,0,1,100.0%,3h
23690,1,GhostSpyder,2692,0,1,1,2,50.0%,1h
23690,1,Vandraus,2692,0,1,1,2,50.0%,3h
23690,3,Jefferson,2692,0,1,4,5,20.0%,8m
23690,1,WEicoke,2692,0,0,1,1,0.0%,3h
23690,1,[HepD]shmagma,2692,0,0,1,1,0.0%,10m
23690,1,Slade,2692,0,0,2,2,0.0%,32m
23690,2,Ethanalev,2692,0,0,2,2,0.0%,3h
23690,1,lucho,2692,0,0,2,2,0.0%,1h
23690,1,Castro,2692,0,0,3,3,0.0%,13m
23723,2,[Bee]WaterBat,2691,1573,309,303,612,50.5%,42m
23723,1,gatsu,2691,1704,81,73,154,52.6%,31m
23723,3,outer,2691,1563,70,86,156,44.9%,9m
23723,3,barcode,2691,734,32,32,64,50.0%,10m
23723,1,[WPKII]KimJongIl,2691,636,21,40,61,34.4%,21m
23723,1,[lFa]Wanderer,2691,303,17,22,39,43.6%,50m
23723,1,SilentStorm,2691,215,8,9,17,47.1%,3h
23723,3,Davestks,2691,190,7,14,21,33.3%,17m
23723,3,superhuman,2691,201,7,15,22,31.8%,41m
23723,2,Jimy,2691,114,6,5,11,54.5%,39m
23723,3,YungTykune,2691,30,5,3,8,62.5%,31m
23723,1,TaiMaiShu,2691,200,5,5,10,50.0%,3h
23723,1,Heat,2691,152,4,4,8,50.0%,6m
23723,1,Legolas,2691,102,4,4,8,50.0%,1h
23723,3,Optimus,2691,126,4,9,13,30.8%,21m
23723,1,[koook]Lahey,2691,105,3,4,7,42.9%,3h
23723,1,clausius,2691,124,3,4,7,42.9%,41m
23723,3,UncLeToBy,2691,86,3,7,10,30.0%,10m
23723,1,Nimbus,2691,106,2,2,4,50.0%,3h
23723,1,Gojujang,2691,48,2,4,6,33.3%,1h
23723,1,FunFacDrift,2691,57,2,5,7,28.6%,22m
23723,1,GERARDIXX,2691,0,1,0,1,100.0%,48m
23723,1,[FLGGN]highcommandr,2691,0,1,1,2,50.0%,3h
23723,1,[sk3tch]ElMosasaurio,2691,38,1,3,4,25.0%,1h
23723,1,beans,2691,0,1,3,4,25.0%,52m
23723,3,Dragon,2691,30,1,7,8,12.5%,42m
23723,1,[MSUsc2]ScionOTE,2691,0,0,1,1,0.0%,47m
23723,1,teioh,2691,0,0,3,3,0.0%,3h
23723,1,[Tanky]GoldenDragon,2691,0,0,3,3,0.0%,59m
23752,1,Cabernet,2690,1525,296,304,600,49.3%,33m
23752,3,[NO0OBZ]Vikaereon,2690,1502,215,210,425,50.6%,14m
23752,3,incenp,2690,805,184,180,364,50.5%,28m
23752,1,Maca,2690,1666,108,89,197,54.8%,1h
23752,3,Wastelander,2690,1289,77,77,154,50.0%,21m
23752,3,[No0Bs]ProKaoS,2690,1251,50,56,106,47.2%,5m
23752,1,[p4j4]khairos,2690,565,25,9,34,73.5%,1h
23752,1,DontEven,2690,230,11,5,16,68.8%,3h
23752,2,[MooLA]MaGic,2690,301,9,17,26,34.6%,17m
23752,1,[Downs1]wagonofthing,2690,277,8,3,11,72.7%,51m
23752,1,[Wienie]Fingercheese,2690,262,7,4,11,63.6%,16m
23752,1,[cluez]BoV,2690,272,7,7,14,50.0%,3h
23752,1,Legosi,2690,235,6,5,11,54.5%,31m
23752,2,NEMESIS,2690,116,5,2,7,71.4%,3h
23752,3,hault,2690,0,3,3,6,50.0%,9m
23752,1,Jeak,2690,48,2,1,3,66.7%,55m
23752,3,Tonnell,2690,0,2,2,4,50.0%,59m
23752,3,Samchee,2690,0,2,3,5,40.0%,56m
23752,1,White,2690,74,2,4,6,33.3%,35m
23752,1,Rykes,2690,0,1,0,1,100.0%,17m
23752,1,Popeye,2690,0,1,3,4,25.0%,3h
23752,3,EnteredZenn,2690,0,1,4,5,20.0%,42m
23774,2,[nieBla]TastosisLova,2689,1554,378,350,728,51.9%,32m
23774,2,[sk3tch]NigthKnight,2689,1247,70,74,144,48.6%,3m
23774,1,gersh,2689,1476,54,55,109,49.5%,15m
23774,3,FutureRain,2689,938,41,30,71,57.7%,34m
23774,2,evarlast,2689,912,33,39,72,45.8%,10m
23774,1,Amebruz,2689,675,32,31,63,50.8%,49m
23774,1,ElfoFuerte,2689,618,24,19,43,55.8%,3h
23774,1,[ZTemps]Josue,2689,651,23,16,39,59.0%,1h
23774,3,Gery,2689,188,12,11,23,52.2%,16m
23774,1,xZTzl,2689,342,11,14,25,44.0%,57m
23774,1,[Cind3r]Hayes,2689,132,6,9,15,40.0%,1h
23774,1,DocLobster,2689,201,5,7,12,41.7%,3m
23774,1,[42x]Lights,2689,131,4,3,7,57.1%,3h
23774,3,Adapt,2689,30,4,5,9,44.4%,25m
23774,3,Dingle,2689,0,2,3,5,40.0%,50m
23774,1,[2Evil]TheJanitor,2689,0,1,0,1,100.0%,49m
23774,2,[KYLE2]JebronLames,2689,0,1,0,1,100.0%,1h
23774,1,pier,2689,0,1,0,1,100.0%,3h
23774,3,DouglasBR,2689,0,1,3,4,25.0%,36m
23774,3,[TgAg]Hanibal,2689,30,1,9,10,10.0%,34m
23774,2,oromeo,2689,0,0,1,1,0.0%,25m
23774,1,Locodapraça,2689,0,0,1,1,0.0%,35m
23774,2,Falkis,2689,0,0,1,1,0.0%,3h
23774,1,[WOBA]Mira,2689,0,0,1,1,0.0%,13m
23774,1,[524E47]MarchyMarch,2689,0,0,2,2,0.0%,3h
23774,1,cal,2689,0,0,2,2,0.0%,1h
23774,1,DanKovacs,2689,0,0,3,3,0.0%,3h
23801,3,OneMind,2688,385,116,101,217,53.5%,6m
23801,3,Daniel,2688,471,40,30,70,57.1%,22m
23801,1,[HaSt]WildWest,2688,841,32,24,56,57.1%,3h
23801,1,Exodus,2688,721,29,15,44,65.9%,1h
23801,1,Stefou,2688,227,7,5,12,58.3%,49m
23801,3,llllllllllll,2688,87,6,10,16,37.5%,1h
23801,2,Xenos,2688,44,4,3,7,57.1%,3h
23801,1,Emarth,2688,86,3,4,7,42.9%,1h
23801,1,[SCLA]HALCONNEGRO,2688,40,2,2,4,50.0%,30m
23801,1,Bane,2688,72,2,2,4,50.0%,3h
23801,1,[RW3]MechaZilla,2688,78,2,4,6,33.3%,1h
23801,1,[LORDx]hunter,2688,96,2,4,6,33.3%,1h
23801,1,wasabi,2688,0,1,0,1,100.0%,3h
23801,2,DarkIce,2688,0,1,5,6,16.7%,49m
23801,3,Zalxander,2688,30,1,6,7,14.3%,21m
23801,1,Kylobe,2688,0,0,1,1,0.0%,1h
23817,3,Wulf,2687,1507,399,417,816,48.9%,42m
23817,3,Sicarius,2687,1659,108,109,217,49.8%,36m
23817,3,Mercury,2687,1361,96,79,175,54.9%,24m
23817,2,[KPx]Dnickles,2687,815,83,86,169,49.1%,7m
23817,1,Betzler,2687,1418,70,68,138,50.7%,3h
23817,3,XDCesarDX,2687,1208,58,39,97,59.8%,29m
23817,1,NinjaOscuro,2687,1054,46,40,86,53.5%,3h
23817,1,Touklakos,2687,694,32,17,49,65.3%,28m
23817,1,Thekiller,2687,744,24,24,48,50.0%,3h
23817,3,Zero,2687,644,23,27,50,46.0%,24m
23817,1,cadc,2687,439,22,15,37,59.5%,54m
23817,1,OSUGoldenBoy,2687,398,18,8,26,69.2%,60m
23817,3,[LSDX3]frijOlitO,2687,308,15,13,28,53.6%,12m
23817,3,Damon,2687,394,15,20,35,42.9%,5m
23817,1,Ajax,2687,315,13,15,28,46.4%,1h
23817,1,FartBox,2687,412,12,11,23,52.2%,49m
23817,3,Damage,2687,343,11,13,24,45.8%,10m
23817,1,[AbcCo]ZDoritoSan,2687,252,9,8,17,52.9%,15m
23817,1,PRPL,2687,274,8,7,15,53.3%,16m
23817,1,Etna,2687,100,5,6,11,45.5%,3h
23817,1,Bunkerhill,2687,135,4,5,9,44.4%,21m
23817,1,[HNP]Jackius,2687,0,3,3,6,50.0%,14m
23817,1,conXn,2687,0,3,4,7,42.9%,3h
23817,1,Ham,2687,80,3,5,8,37.5%,3h
23817,1,howtoplay,2687,114,3,5,8,37.5%,4m
23817,1,Troll,2687,48,2,1,3,66.7%,3h
23817,1,maghea,2687,0,1,0,1,100.0%,49m
23817,1,Tyrone,2687,38,1,1,2,50.0%,1h
23817,1,Khas,2687,0,1,4,5,20.0%,49m
23817,1,Sulfur,2687,0,0,1,1,0.0%,11m
23817,1,shcoffin,2687,0,0,1,1,0.0%,16m
23848,2,RadDad,2686,1602,397,391,788,50.4%,9m
23848,3,SirCallicott,2686,1244,170,161,331,51.4%,24m
23848,3,Nroc,2686,1093,110,87,197,55.8%,38m
23848,3,[sW4Rmz]HonkyOfDeath,2686,1180,107,102,209,51.2%,31m
23848,1,starcris,2686,1396,61,62,123,49.6%,3h
23848,1,[AbcCo]Amir,2686,1464,60,45,105,57.1%,48m
23848,1,[FidSC]LAKO,2686,1200,49,39,88,55.7%,1h
23848,1,Asoloso,2686,990,41,29,70,58.6%,47m
23848,1,TimidPimp,2686,426,31,20,51,60.8%,1h
23848,1,Goeres,2686,805,31,27,58,53.4%,3h
23848,3,[G4M3R5]Jaydogs,2686,823,31,29,60,51.7%,4m
23848,3,Afourteen,2686,788,29,33,62,46.8%,8m
23848,2,[LaCBA]Justiniano,2686,762,28,35,63,44.4%,14m
23848,3,daplaymaker,2686,742,25,31,56,44.6%,24m
23848,2,[CxB]vVvert,2686,598,24,27,51,47.1%,7m
23848,1,Spartan,2686,688,23,21,44,52.3%,3h
23848,3,Wolfpack,2686,586,22,23,45,48.9%,14m
23848,1,Deadmaniac,2686,508,20,11,31,64.5%,3h
23848,1,TheSecrety,2686,167,19,14,33,57.6%,3h
23848,1,Mattute,2686,530,18,17,35,51.4%,3h
23848,2,xBATTLEx,2686,306,13,11,24,54.2%,31m
23848,3,Via,2686,346,12,12,24,50.0%,37m
23848,3,LexMcGlock,2686,345,12,14,26,46.2%,34m
23848,1,ferdinand,2686,390,11,11,22,50.0%,39m
23848,1,FredPool,2686,228,9,3,12,75.0%,1h
23848,3,SplinterX,2686,242,9,12,21,42.9%,33m
23848,2,[Sune]Imperius,2686,174,6,12,18,33.3%,13m
23848,1,NoManNo,2686,116,4,1,5,80.0%,1h
23848,2,jmk,2686,111,4,4,8,50.0%,3h
23848,3,Klemon,2686,30,4,4,8,50.0%,15m
23848,3,BurglarSmith,2686,0,2,2,4,50.0%,1h
23848,1,Noobs,2686,0,2,3,5,40.0%,11m
23848,1,GianTheMan,2686,0,2,3,5,40.0%,1h
23848,1,Cobruhz,2686,0,1,1,2,50.0%,42m
23848,1,NineteenBit,2686,0,0,1,1,0.0%,59m
23848,1,Corball,2686,0,0,2,2,0.0%,16m
23848,1,[WNTRLY]leadtech,2686,0,0,3,3,0.0%,3h
23848,1,Drakthull,2686,0,0,8,8,0.0%,1h
23886,2,Joni,2685,1394,183,177,360,50.8%,23m
23886,1,kators,2685,1740,171,147,318,53.8%,3h
23886,3,TYyayayay,2685,1358,148,139,287,51.6%,4m
23886,2,RoFerCa,2685,1008,60,58,118,50.8%,36m
23886,3,[D4Bros]AeroEchelon,2685,1346,59,50,109,54.1%,8m
23886,1,[DANKEM]Yetur,2685,1327,56,46,102,54.9%,58m
23886,3,llllllllllll,2685,660,25,28,53,47.2%,13m
23886,1,Zeal,2685,405,14,11,25,56.0%,30m
23886,3,dragonfly,2685,376,14,15,29,48.3%,8m
23886,1,Barnes,2685,366,12,11,23,52.2%,49m
23886,3,jakaboy,2685,260,11,10,21,52.4%,60m
23886,1,ratonpoeta,2685,240,9,8,17,52.9%,4m
23886,1,NoobMaster,2685,226,7,7,14,50.0%,3h
23886,2,TenQ,2685,88,5,4,9,55.6%,35m
23886,1,DontRektMe,2685,156,5,6,11,45.5%,4m
23886,1,[ng123]FENIXSOMBRA,2685,114,4,3,7,57.1%,32m
23886,1,beleg,2685,84,3,2,5,60.0%,3h
23886,1,speedy,2685,40,2,1,3,66.7%,36m
23886,1,Pacemaker,2685,0,1,0,1,100.0%,47m
23886,1,Haydes,2685,40,1,2,3,33.3%,22m
23886,1,TigerBeer,2685,36,1,2,3,33.3%,35m
23886,3,Harfang,2685,0,1,4,5,20.0%,1h
23886,1,YofreBLCK,2685,0,0,1,1,0.0%,48m
23886,1,DEADSCORPION,2685,0,0,1,1,0.0%,8m
23886,1,[SANGRE]hijodeodin,2685,0,0,1,1,0.0%,3h
23886,1,seminence,2685,0,0,2,2,0.0%,16m
23912,2,Swifty,2684,1592,436,441,877,49.7%,15m
23912,1,JagHasie,2684,1533,110,112,222,49.5%,37m
23912,2,VangardOne,2684,1356,86,80,166,51.8%,31m
23912,1,enV,2684,646,80,62,142,56.3%,1h
23912,3,RobJackel,2684,1190,49,58,107,45.8%,24m
23912,2,rodystonn,2684,903,40,40,80,50.0%,42m
23912,1,[STDnbs]Cooleo,2684,436,24,15,39,61.5%,3h
23912,3,DCno,2684,323,23,18,41,56.1%,37m
23912,1,Istian,2684,722,23,19,42,54.8%,3h
23912,3,nopainnogame,2684,394,19,24,43,44.2%,29m
23912,1,[maSC]Igneel,2684,407,16,7,23,69.6%,30m
23912,1,kinsey,2684,323,16,12,28,57.1%,3h
23912,1,Malziekam,2684,324,9,9,18,50.0%,2h
23912,1,Autechre,2684,151,6,5,11,54.5%,35m
23912,1,[DSGods]Brorgar,2684,191,6,6,12,50.0%,1h
23912,2,BOTTS,2684,140,5,4,9,55.6%,31m
23912,1,[ChiFan]Liam,2684,84,5,5,10,50.0%,52m
23912,3,Polzo,2684,179,5,8,13,38.5%,28m
23912,1,tetelestai,2684,89,4,2,6,66.7%,32m
23912,3,[RSTCL]Manuelite,2684,131,4,4,8,50.0%,34m
23912,1,LazyMachine,2684,36,3,4,7,42.9%,1h
23912,2,Dthkills,2684,48,3,5,8,37.5%,3h
23912,3,iCanTell,2684,58,3,7,10,30.0%,3m
23912,1,[Pizzy]smooveAlv,2684,0,2,3,5,40.0%,3h
23912,1,nightscall,2684,90,1,1,2,50.0%,21m
23912,3,SnakeOil,2684,0,1,1,2,50.0%,45m
23912,1,Bossballoon,2684,44,1,2,3,33.3%,22m
23912,1,[navis]GZgatos,2684,30,1,2,3,33.3%,3h
23912,3,[CUUMX]Masterblade,2684,30,1,7,8,12.5%,22m
23912,1,GreetingLady,2684,0,0,1,1,0.0%,31m
23912,1,Anticlimaxic,2684,0,0,1,1,0.0%,1h
23912,2,[SC2Tja]muritopin,2684,0,0,1,1,0.0%,34m
23912,1,Cameron,2684,0,0,2,2,0.0%,52m
23945,3,james,2683,1536,115,120,235,48.9%,6m
23945,3,Martian,2683,1015,56,59,115,48.7%,10m
23945,1,OnlyLiveOnce,2683,1226,50,45,95,52.6%,48m
23945,1,Aristotle,2683,902,37,30,67,55.2%,58m
23945,3,kingswood,2683,820,30,32,62,48.4%,31m
23945,3,Rodrihunter,2683,670,24,28,52,46.2%,14m
23945,1,Chappy,2683,532,18,15,33,54.5%,54m
23945,1,[ISTOP]Maty,2683,237,11,7,18,61.1%,3h
23945,3,Charito,2683,326,11,18,29,37.9%,42m
23945,3,KaiKoz,2683,202,10,10,20,50.0%,41m
23945,2,cocohearts,2683,265,10,13,23,43.5%,37m
23945,2,Beekz,2683,330,10,26,36,27.8%,15m
23945,1,AkDj,2683,280,9,6,15,60.0%,35m
23945,1,Hal,2683,283,9,8,17,52.9%,54m
23945,1,MajorTom,2683,326,9,10,19,47.4%,3h
23945,1,Turbo,2683,261,8,11,19,42.1%,1h
23945,1,[INF3ST]BLACKstRIPPa,2683,167,5,6,11,45.5%,25m
23945,1,Warren,2683,130,5,7,12,41.7%,31m
23945,1,REjellybelly,2683,120,4,3,7,57.1%,1h
23945,3,Capidegran,2683,78,3,9,12,25.0%,24m
23945,2,WhiteFrog,2683,140,2,1,3,66.7%,27m
23945,1,[Flam3s]Pickledeggs,2683,80,2,3,5,40.0%,1h
23945,2,AhBoon,2683,0,1,0,1,100.0%,2h
23945,2,[TiWo]Ellipsis,2683,0,1,7,8,12.5%,30m
23945,1,[AOSsc]mushisushi,2683,0,0,1,1,0.0%,1h
23945,1,[Nakir]dagarota,2683,0,0,1,1,0.0%,13m
23945,1,[PTZop]Joebob,2683,0,0,3,3,0.0%,3h
23945,1,FoFu,2683,0,0,4,4,0.0%,3h
23973,2,Battleraider,2682,1592,708,685,1393,50.8%,36m
23973,3,michael,2682,1272,88,80,168,52.4%,15m
23973,3,kalimba,2682,1011,82,69,151,54.3%,25m
23973,1,[RwtM]SynthRapt,2682,594,24,18,42,57.1%,28m
23973,3,LionkanoYtb,2682,398,14,19,33,42.4%,5m
23973,3,ToastedScone,2682,319,11,12,23,47.8%,1h
23973,3,ABIMAEL,2682,306,10,15,25,40.0%,23m
23973,1,JimyTBG,2682,251,8,3,11,72.7%,47m
23973,1,aimsecond,2682,222,7,7,14,50.0%,4m
23973,1,alucard,2682,210,6,2,8,75.0%,28m
23973,1,BoxOfDenims,2682,155,5,1,6,83.3%,1h
23973,3,BoomBruv,2682,107,4,4,8,50.0%,41m
23973,1,THEASIAN,2682,38,2,1,3,66.7%,35m
23973,3,Charogne,2682,0,2,3,5,40.0%,13m
23973,1,NivixParadox,2682,82,2,4,6,33.3%,31m
23973,1,Taos,2682,0,0,1,1,0.0%,3h
23973,1,chapie,2682,0,0,2,2,0.0%,4m
23990,3,[SWOU]Cuper,2681,1400,150,129,279,53.8%,5m
23990,3,Klutch,2681,549,116,112,228,50.9%,4m
23990,3,llllllllllll,2681,1372,70,66,136,51.5%,28m
23990,1,[MD]Raedium,2681,603,29,28,57,50.9%,3h
23990,1,McBobrow,2681,607,24,23,47,51.1%,15m
23990,1,SelendisOWO,2681,408,12,12,24,50.0%,1h
23990,1,ShrubblesO,2681,213,7,1,8,87.5%,3h
23990,1,cheras,2681,231,7,7,14,50.0%,7m
23990,1,DonaldTrump,2681,186,6,5,11,54.5%,1h
23990,3,DarkHades,2681,115,5,10,15,33.3%,40m
23990,1,[xO]DukeSilver,2681,150,4,2,6,66.7%,13m
23990,1,[VM]shiro,2681,122,4,4,8,50.0%,42m
23990,1,Katanary,2681,156,4,4,8,50.0%,3h
23990,3,Flakundo,2681,111,4,5,9,44.4%,7m
23990,2,Wake,2681,30,4,6,10,40.0%,42m
23990,2,MrWhite,2681,134,3,1,4,75.0%,3h
23990,1,Pootis,2681,78,2,2,4,50.0%,50m
23990,1,Tunahan,2681,0,2,3,5,40.0%,59m
23990,1,Mack,2681,0,1,0,1,100.0%,51m
23990,1,KIRITOYK,2681,36,1,4,5,20.0%,52m
23990,1,Meech,2681,0,0,1,1,0.0%,22m
23990,1,Budderz,2681,0,0,1,1,0.0%,16m
23990,1,BooldHoot,2681,0,0,3,3,0.0%,31m
24013,3,[LTlord]ElArki,2680,1498,165,154,319,51.7%,7m
24013,3,ZergSplatter,2680,1540,130,123,253,51.4%,34m
24013,3,[SWOU]kenkiskan,2680,1328,126,110,236,53.4%,24m
24013,3,Conan,2680,1424,104,98,202,51.5%,24m
24013,3,Therapist,2680,1548,92,91,183,50.3%,36m
24013,2,tennisryan,2680,649,79,69,148,53.4%,9m
24013,1,[pandem]oggrr,2680,1611,76,70,146,52.1%,36m
24013,3,kyle,2680,1219,62,57,119,52.1%,36m
24013,3,DMac,2680,1344,59,61,120,49.2%,10m
24013,3,hxwolt,2680,1291,53,45,98,54.1%,23m
24013,3,Dranzer,2680,345,15,15,30,50.0%,42m
24013,1,npp,2680,467,15,17,32,46.9%,1h
24013,1,Crippen,2680,182,7,5,12,58.3%,3h
24013,1,MrBean,2680,208,7,6,13,53.8%,1h
24013,3,xerxes,2680,227,7,8,15,46.7%,1h
24013,3,[GOPERÚ]RonalFlores,2680,221,6,9,15,40.0%,21m
24013,1,[AbcCo]UnGato,2680,129,5,5,10,50.0%,58m
24013,1,[AOAWOL]DeathFAbove,2680,0,4,1,5,80.0%,3h
24013,1,Jai,2680,80,4,5,9,44.4%,2h
24013,3,BlessUrHeart,2680,122,4,14,18,22.2%,7m
24013,1,[juggr]BaronvonMaru,2680,74,3,1,4,75.0%,3h
24013,3,DDeSCLanes,2680,83,3,3,6,50.0%,30m
24013,3,Qyxyr,2680,0,2,3,5,40.0%,6m
24013,3,neshy,2680,0,2,3,5,40.0%,3h
24013,2,Phoenix,2680,0,2,4,6,33.3%,3h
24013,2,[BUMFUK]CptInsano,2680,113,2,6,8,25.0%,13m
24013,1,FrozenIce,2680,0,0,1,1,0.0%,1h
24013,1,[TEMT]Dion,2680,0,0,1,1,0.0%,13m
24013,1,[Foul]Novaakain,2680,0,0,4,4,0.0%,52m
24013,1,Slaughma,2680,0,0,4,4,0.0%,26m
24043,3,PowerTech,2679,1544,284,267,551,51.5%,18m
24043,2,Demarr,2679,1584,95,106,201,47.3%,7m
24043,3,Alftra,2679,1423,79,78,157,50.3%,21m
24043,3,Ryan,2679,1211,74,86,160,46.2%,35m
24043,3,Goodman,2679,1013,71,80,151,47.0%,42m
24043,3,[zxczx]Eclipse,2679,1164,68,49,117,58.1%,42m
24043,3,smokingdoink,2679,983,53,49,102,52.0%,28m
24043,3,[MLPog]TastyBacon,2679,1132,49,41,90,54.4%,34m
24043,3,Jonerys,2679,752,49,42,91,53.8%,37m
24043,1,forgetone,2679,1263,42,44,86,48.8%,34m
24043,1,qimufev,2679,812,28,25,53,52.8%,10m
24043,3,Raul,2679,758,26,35,61,42.6%,7m
24043,1,[EpicG]KnightRa,2679,436,19,10,29,65.5%,1h
24043,3,gent,2679,304,15,7,22,68.2%,29m
24043,1,SHAKER,2679,265,15,11,26,57.7%,27m
24043,1,JWOLF,2679,296,11,15,26,42.3%,3h
24043,1,Twisted,2679,285,8,10,18,44.4%,34m
24043,3,gus,2679,222,7,10,17,41.2%,15m
24043,2,llllllllllll,2679,183,5,7,12,41.7%,1h
24043,1,ALI,2679,112,4,2,6,66.7%,4m
24043,1,Doraste,2679,42,4,3,7,57.1%,3h
24043,2,[Mavv]Zolphus,2679,113,4,4,8,50.0%,3h
24043,3,Eliiitz,2679,172,4,7,11,36.4%,41m
24043,1,Lirica,2679,0,3,2,5,60.0%,54m
24043,3,Walters,2679,0,3,3,6,50.0%,23m
24043,1,[8318]lifeforce,2679,121,2,1,3,66.7%,3h
24043,1,[Lepraa]JHOSS,2679,116,2,1,3,66.7%,22m
24043,3,OnlyMarines,2679,93,2,3,5,40.0%,40m
24043,1,Ragulus,2679,48,2,3,5,40.0%,3h
24043,1,DJR,2679,122,2,4,6,33.3%,21m
24043,2,NxrFesdac,2679,0,1,1,2,50.0%,41m
24043,1,MajorMichael,2679,0,1,2,3,33.3%,2h
24043,1,Presto,2679,0,1,3,4,25.0%,22m
24043,1,[OvG]Ares,2679,0,0,1,1,0.0%,1h
24043,1,Dexter,2679,0,0,1,1,0.0%,3h
24043,1,ELVER,2679,0,0,1,1,0.0%,3h
24043,1,Lance,2679,0,0,4,4,0.0%,13m
24080,3,joepunk,2678,1502,470,470,940,50.0%,3m
24080,1,Septel,2678,1728,87,81,168,51.8%,34m
24080,3,wimbley,2678,1039,64,63,127,50.4%,34m
24080,2,Tezcatlipoca,2678,1336,50,53,103,48.5%,9m
24080,1,[AD3C]NAPSTER,2678,1083,45,47,92,48.9%,2h
24080,1,Sunshine,2678,319,14,5,19,73.7%,38m
24080,1,Nyphang,2678,395,14,8,22,63.6%,1h
24080,3,Creative,2678,264,9,12,21,42.9%,7m
24080,3,[SWORD7]Bill,2678,209,7,13,20,35.0%,5m
24080,1,[TWRxi]Gemetzel,2678,208,5,3,8,62.5%,3h
24080,1,Crazyhobo,2678,182,5,4,9,55.6%,2h
24080,1,TRANCE,2678,196,5,6,11,45.5%,48m
24080,1,baikun,2678,164,4,3,7,57.1%,3h
24080,1,xolopx,2678,164,4,6,10,40.0%,22m
24080,1,NoGas,2678,126,3,3,6,50.0%,32m
24080,3,Norbert,2678,40,3,3,6,50.0%,1h
24080,1,KesaGatame,2678,0,2,3,5,40.0%,7m
24080,3,MTGunner,2678,0,2,3,5,40.0%,33m
24080,1,christiansto,2678,78,2,5,7,28.6%,42m
24080,1,Smoke,2678,0,1,0,1,100.0%,31m
24080,3,TheGoldenKey,2678,0,1,0,1,100.0%,30m
24080,1,Matte,2678,94,1,1,2,50.0%,36m
24080,2,Senpai,2678,94,1,2,3,33.3%,3h
24080,2,[TRuble]UnderClass,2678,0,0,1,1,0.0%,3h
24080,1,Darkfuzion,2678,0,0,1,1,0.0%,58m
24080,1,anyel,2678,0,0,1,1,0.0%,16m
24080,1,saw,2678,0,0,2,2,0.0%,1h
24080,1,[I559I]datnedz,2678,0,0,3,3,0.0%,48m
24108,1,youhedadTV,2677,1384,212,216,428,49.5%,10m
24108,1,ZtPzTp,2677,1532,201,194,395,50.9%,13m
24108,1,Psylocybin,2677,1567,157,169,326,48.2%,4m
24108,1,DarkstonEr,2677,1591,76,70,146,52.1%,31m
24108,1,Yusuke,2677,1365,70,68,138,50.7%,52m
24108,3,llllllllllll,2677,883,60,50,110,54.5%,24m
24108,3,LinhVat,2677,506,56,41,97,57.7%,37m
24108,1,NEWT,2677,1037,40,32,72,55.6%,54m
24108,2,DarkPingDuck,2677,479,25,30,55,45.5%,9m
24108,1,JeanMic,2677,555,23,21,44,52.3%,42m
24108,1,BloodTemplar,2677,279,22,10,32,68.8%,50m
24108,3,HoxyHatch,2677,333,20,25,45,44.4%,41m
24108,3,Ndras,2677,429,19,13,32,59.4%,17m
24108,3,Phalynx,2677,291,14,12,26,53.8%,33m
24108,1,Dark,2677,221,8,7,15,53.3%,56m
24108,3,boultz,2677,208,7,7,14,50.0%,12m
24108,1,pria,2677,180,7,7,14,50.0%,29m
24108,3,RawDeluxe,2677,144,6,8,14,42.9%,39m
24108,1,Theophili,2677,160,5,6,11,45.5%,1h
24108,1,EoS,2677,191,4,2,6,66.7%,58m
24108,1,Mauri,2677,66,3,2,5,60.0%,3h
24108,2,fANtOM,2677,93,2,0,2,100.0%,42m
24108,1,[UgrM]Bonfire,2677,0,2,3,5,40.0%,22m
24108,1,[COSPI]killerlaval,2677,0,1,0,1,100.0%,1h
24108,1,itsalrite,2677,0,1,0,1,100.0%,50m
24108,1,KRONOSS,2677,0,1,1,2,50.0%,39m
24108,1,ScrotalWave,2677,0,1,4,5,20.0%,36m
24108,2,[Zzone]Arth,2677,96,1,6,7,14.3%,3h
24108,2,[0Rule]EmptyOOEyes,2677,40,1,8,9,11.1%,1h
24108,1,[EnTrpY]Jack,2677,0,0,1,1,0.0%,57m
24108,1,Tennishot,2677,0,0,1,1,0.0%,27m
24108,1,[SCVM]Meat,2677,0,0,1,1,0.0%,51m
24108,1,[TDT]Roger,2677,0,0,2,2,0.0%,52m
24141,3,Mirshann,2676,1433,122,86,208,58.7%,35m
24141,2,[RS69]Toxin,2676,1397,62,61,123,50.4%,16m
24141,1,TchaikIV,2676,733,55,44,99,55.6%,3h
24141,1,Polly,2676,1074,50,30,80,62.5%,54m
24141,1,[Pharoh]snowdrop,2676,881,47,10,57,82.5%,3h
24141,1,IRACUNDO,2676,394,30,21,51,58.8%,50m
24141,1,Luludoobee,2676,779,28,27,55,50.9%,3h
24141,1,Raize,2676,774,26,26,52,50.0%,50m
24141,1,SchifeR,2676,542,24,16,40,60.0%,1h
24141,3,Rolos,2676,396,18,28,46,39.1%,22m
24141,1,MarineHorDe,2676,500,16,16,32,50.0%,48m
24141,1,MALUMA,2676,490,15,14,29,51.7%,3h
24141,3,sebas,2676,316,10,20,30,33.3%,6m
24141,1,clandest,2676,295,9,7,16,56.2%,39m
24141,3,[Hazeem]Hazeem,2676,262,9,12,21,42.9%,51m
24141,2,bobnelson,2676,244,9,15,24,37.5%,9m
24141,2,Crontab,2676,146,8,9,17,47.1%,28m
24141,1,Andrew,2676,190,5,10,15,33.3%,3h
24141,1,[FBRU]DaBaptist,2676,157,4,1,5,80.0%,3h
24141,2,[DRKDNA]Shilowind,2676,85,4,15,19,21.1%,40m
24141,3,nobuild,2676,0,3,2,5,60.0%,50m
24141,1,hummerhumpty,2676,88,3,3,6,50.0%,48m
24141,1,[KoAv]Aleschyr,2676,48,2,1,3,66.7%,32m
24141,1,[XATUBA]Gozawr,2676,40,1,1,2,50.0%,1h
24141,1,[LCE]FranciscoG,2676,111,1,6,7,14.3%,7m
24141,1,[anti5z]Osoman,2676,0,0,1,1,0.0%,52m
24141,1,[AbcCo]PecesitoUwU,2676,0,0,1,1,0.0%,3h
24141,1,xDurillo,2676,0,0,1,1,0.0%,13m
24141,1,[Phi]Casis,2676,0,0,1,1,0.0%,57m
24141,2,Swarmdeath,2676,0,0,7,7,0.0%,15m
24171,3,Wick,2675,1486,358,338,696,51.4%,35m
24171,3,[PTHero]edwinb,2675,1242,307,272,579,53.0%,36m
24171,2,[b3n]Blaw,2675,1329,234,235,469,49.9%,7m
24171,2,[UpeV]viperKingHG,2675,1169,169,171,340,49.7%,32m
24171,1,Dbth,2675,1200,113,86,199,56.8%,27m
24171,3,Spirited,2675,979,81,78,159,50.9%,34m
24171,1,[ALTF04]AtreUS,2675,1235,75,58,133,56.4%,28m
24171,1,TheamazingG,2675,1360,63,50,113,55.8%,2h
24171,3,Norfensul,2675,1062,49,48,97,50.5%,24m
24171,3,Vegita,2675,722,29,28,57,50.9%,5m
24171,1,Atreides,2675,769,27,26,53,50.9%,3h
24171,3,[xLgNx]MushyMigushy,2675,410,21,29,50,42.0%,38m
24171,2,Beerfart,2675,467,18,30,48,37.5%,7m
24171,1,Heudor,2675,288,9,9,18,50.0%,16m
24171,1,LeatherySock,2675,273,7,9,16,43.8%,25m
24171,1,Roshi,2675,147,6,4,10,60.0%,3h
24171,1,Buckshot,2675,74,3,2,5,60.0%,3h
24171,3,Jugyon,2675,0,3,3,6,50.0%,27m
24171,2,DAzer,2675,0,3,4,7,42.9%,25m
24171,1,drako,2675,36,2,5,7,28.6%,1h
24171,1,Rowdy,2675,0,1,0,1,100.0%,14m
24171,1,DavelFaraday,2675,0,1,0,1,100.0%,3h
24171,1,zelinhhh,2675,0,1,0,1,100.0%,42m
24171,1,Edgar,2675,0,1,0,1,100.0%,3h
24171,2,cybaek,2675,96,1,2,3,33.3%,3h
24171,1,Biotribe,2675,97,1,4,5,20.0%,1h
24171,1,theDTA,2675,38,1,6,7,14.3%,51m
24171,3,ikki,2675,30,1,7,8,12.5%,21m
24171,1,Newb,2675,0,0,1,1,0.0%,16m
24171,1,[LFUT]Eros,2675,0,0,3,3,0.0%,3h
24201,1,asdfghjkl,2674,727,102,102,204,50.0%,3h
24201,3,SlncefrBodie,2674,1486,85,76,161,52.8%,29m
24201,1,neno,2674,1605,72,68,140,51.4%,1h
24201,3,LemonSkunk,2674,1280,56,59,115,48.7%,22m
24201,1,lagent,2674,976,52,40,92,56.5%,27m
24201,1,Vuddha,2674,1121,51,48,99,51.5%,34m
24201,3,DeSalvan,2674,965,45,34,79,57.0%,42m
24201,3,[Dem0n]Pridefleet,2674,502,19,20,39,48.7%,11m
24201,3,[mmgam]morhook,2674,448,15,25,40,37.5%,38m
24201,3,Pyttmann,2674,274,10,17,27,37.0%,13m
24201,3,FishFry,2674,220,6,7,13,46.2%,3h
24201,1,DeltaDacosta,2674,133,5,1,6,83.3%,48m
24201,1,youGotREKT,2674,105,4,4,8,50.0%,3h
24201,2,Fiddler,2674,139,4,5,9,44.4%,3h
24201,1,rastaper,2674,118,4,5,9,44.4%,3h
24201,1,[BSAA1]NeostormX,2674,68,3,1,4,75.0%,50m
24201,1,Conehead,2674,170,3,2,5,60.0%,1h
24201,1,[NGRKKK]LGCY,2674,0,3,3,6,50.0%,3h
24201,1,Rmao,2674,80,3,4,7,42.9%,3h
24201,3,[TENO]Krowlder,2674,0,2,3,5,40.0%,3h
24201,3,Marine,2674,0,2,3,5,40.0%,32m
24201,3,Pogo,2674,62,2,6,8,25.0%,24m
24201,1,Cerro,2674,48,1,1,2,50.0%,58m
24201,3,[gooby]Sightless,2674,32,1,3,4,25.0%,13m
24201,1,Blue,2674,0,0,2,2,0.0%,35m
24226,2,Wind,2673,1509,254,251,505,50.3%,40m
24226,2,jfilo,2673,1439,190,193,383,49.6%,33m
24226,3,[UpxV]batimanias,2673,973,93,83,176,52.8%,41m
24226,1,Crayak,2673,1328,91,99,190,47.9%,39m
24226,1,IlIlIlIlIlIl,2673,1013,45,35,80,56.2%,3h
24226,3,RalphAlone,2673,289,34,32,66,51.5%,20m
24226,1,[BlTEL]Bru,2673,834,33,34,67,49.3%,3h
24226,1,kickstand,2673,652,24,14,38,63.2%,27m
24226,1,[NCEs]Raycu,2673,452,18,13,31,58.1%,3h
24226,3,[PasT1]Bigshots,2673,377,12,17,29,41.4%,24m
24226,3,[Kingx]equipped,2673,324,10,15,25,40.0%,38m
24226,1,Tharius,2673,352,9,10,19,47.4%,1h
24226,3,zealous,2673,220,9,11,20,45.0%,1h
24226,1,jerzyn,2673,255,8,6,14,57.1%,58m
24226,1,heNG,2673,281,8,7,15,53.3%,3h
24226,1,[eOWN]MasterMind,2673,190,6,5,11,54.5%,52m
24226,3,Razgriz,2673,58,5,4,9,55.6%,24m
24226,3,ClpHewitt,2673,116,5,9,14,35.7%,9m
24226,1,MuffinMan,2673,118,4,4,8,50.0%,3h
24226,1,[sLuxx]Joon,2673,76,3,4,7,42.9%,3h
24226,1,trebyoyoyoyo,2673,0,2,4,6,33.3%,3m
24226,3,[xXz777]AVANGARD,2673,0,1,0,1,100.0%,48m
24226,3,Inkling,2673,0,1,1,2,50.0%,58m
24226,1,BadPro,2673,44,1,2,3,33.3%,1h
24226,2,SiFU,2673,30,1,11,12,8.3%,44m
24226,1,navijojo,2673,0,0,3,3,0.0%,15m
24226,1,Rock,2673,0,0,3,3,0.0%,1h
24253,1,[NrFms]Vermin,2672,1214,149,152,301,49.5%,4m
24253,1,SKING,2672,1494,57,53,110,51.8%,47m
24253,3,Jeffz,2672,535,40,33,73,54.8%,4m
24253,3,OmgItsVlad,2672,952,35,39,74,47.3%,3m
24253,1,[KGB]kushinator,2672,623,27,18,45,60.0%,1h
24253,3,FXmarc,2672,425,20,16,36,55.6%,36m
24253,3,Neil,2672,378,13,20,33,39.4%,22m
24253,1,Mrkill,2672,114,4,7,11,36.4%,12m
24253,3,CondePatula,2672,122,4,10,14,28.6%,23m
24253,2,[NrFms]hunter,2672,110,3,1,4,75.0%,55m
24253,1,ryanpo,2672,97,2,2,4,50.0%,3h
24253,3,gabicho,2672,0,2,3,5,40.0%,16m
24253,3,RAYMANKAPEEN,2672,0,1,0,1,100.0%,5m
24253,1,DeadSqwilla,2672,40,1,3,4,25.0%,3h
24253,1,BlackOp,2672,36,1,6,7,14.3%,3h
24253,1,Smoke,2672,0,0,1,1,0.0%,14m
24253,1,MordinSullis,2672,0,0,1,1,0.0%,3h
24253,1,Saint,2672,0,0,2,2,0.0%,3h
24253,1,[4z04z0]Stickmen,2672,0,0,3,3,0.0%,58m
24272,2,Panashe,2671,947,164,162,326,50.3%,34m
24272,1,[sk3tch]zeuscyborg,2671,1433,148,151,299,49.5%,28m
24272,1,yosmore,2671,1715,136,116,252,54.0%,1h
24272,1,Xyashe,2671,772,30,26,56,53.6%,2h
24272,1,Marv,2671,566,21,20,41,51.2%,10m
24272,3,[AbcCo]lee,2671,327,16,14,30,53.3%,35m
24272,1,Rolendubs,2671,486,15,16,31,48.4%,3h
24272,3,dexjoke,2671,276,11,6,17,64.7%,21m
24272,3,BrmdSloop,2671,250,10,15,25,40.0%,24m
24272,1,pkayfire,2671,94,6,5,11,54.5%,2h
24272,2,Zoga,2671,157,6,8,14,42.9%,3m
24272,2,[BKaG]Drguau,2671,128,5,16,21,23.8%,13m
24272,1,[DKVELO]InsanityPK,2671,76,2,2,4,50.0%,2h
24272,1,FuzzyLogic,2671,38,1,1,2,50.0%,42m
24272,1,Mister,2671,0,1,4,5,20.0%,16m
24272,1,[JdV]Edarcox,2671,0,0,1,1,0.0%,35m
24272,1,CHKNNGGT,2671,0,0,1,1,0.0%,15m
24289,2,moistchip,2670,1464,133,117,250,53.2%,29m
24289,2,ROmonk,2670,1572,126,119,245,51.4%,33m
24289,1,mazoozoo,2670,1601,117,102,219,53.4%,3h
24289,1,[UpxV]TYTY,2670,1453,86,67,153,56.2%,2h
24289,3,Barbara,2670,605,81,80,161,50.3%,42m
24289,3,macros,2670,460,63,67,130,48.5%,33m
24289,3,tongomalote,2670,845,50,42,92,54.3%,39m
24289,3,FrostyWB,2670,1118,42,70,112,37.5%,20m
24289,1,bigbss,2670,469,21,24,45,46.7%,35m
24289,3,Puzzles,2670,293,11,12,23,47.8%,35m
24289,1,Chip,2670,218,10,1,11,90.9%,15m
24289,1,MrSatan,2670,113,8,0,8,100.0%,2h
24289,3,skunkone,2670,230,7,11,18,38.9%,24m
24289,3,CALLmePiECE,2670,0,4,1,5,80.0%,31m
24289,1,[GIBE]Enigma,2670,46,2,2,4,50.0%,27m
24289,1,Cytestake,2670,0,1,1,2,50.0%,42m
24289,2,Zalamander,2670,44,1,1,2,50.0%,3h
24289,3,[MenMae]TORRES,2670,0,0,1,1,0.0%,1h
24289,1,[CHIWAC]Xerox,2670,0,0,1,1,0.0%,3h
24289,1,Coda,2670,0,0,2,2,0.0%,16m
24289,1,luker,2670,0,0,4,4,0.0%,3h
24310,2,[WNF666]Medki,2669,1297,192,173,365,52.6%,4m
24310,2,hoohaha,2669,1384,122,116,238,51.3%,38m
24310,3,[Macac0]sakura,2669,1510,96,81,177,54.2%,29m
24310,3,[AEVA]Vithar,2669,1437,92,80,172,53.5%,3m
24310,3,[Hitomi]Liquidsun,2669,1377,57,61,118,48.3%,24m
24310,3,Arganova,2669,1035,53,54,107,49.5%,42m
24310,1,[sk3tch]Steven,2669,763,49,26,75,65.3%,1h
24310,2,aaron,2669,768,40,46,86,46.5%,14m
24310,1,[Lac10]brujochilote,2669,797,37,15,52,71.2%,10m
24310,1,[lMNEW]Ccollcca,2669,570,25,17,42,59.5%,52m
24310,1,[4LOBOS]BrianPiro,2669,461,18,10,28,64.3%,39m
24310,1,REVELATE,2669,410,13,12,25,52.0%,1h
24310,1,quazz,2669,252,11,16,27,40.7%,1h
24310,3,mprvcl,2669,240,10,7,17,58.8%,5m
24310,1,BARCODE,2669,371,10,9,19,52.6%,3h
24310,2,Teiji,2669,126,4,5,9,44.4%,3h
24310,2,fryzee,2669,112,4,5,9,44.4%,3h
24310,1,MooMooThere,2669,72,3,3,6,50.0%,10m
24310,3,Salina,2669,44,3,3,6,50.0%,3h
24310,3,AmoebA,2669,0,2,3,5,40.0%,1h
24310,1,Patómico,2669,0,2,3,5,40.0%,52m
24310,3,Eleazar,2669,0,2,3,5,40.0%,13m
24310,3,Bloody,2669,0,2,3,5,40.0%,3h
24310,2,Goloden,2669,0,2,4,6,33.3%,42m
24310,3,[AMPM]Durahan,2669,62,2,8,10,20.0%,7m
24310,1,Coz,2669,40,1,3,4,25.0%,3h
24310,1,[NwAs]martinez,2669,0,0,1,1,0.0%,34m
24310,1,[kien]PerroMalo,2669,0,0,1,1,0.0%,1h
24310,3,ChocoShadowx,2669,0,0,3,3,0.0%,24m
24339,1,[P1N0Ys]GhostDragon,2668,1584,180,154,334,53.9%,3h
24339,3,WangHangLow,2668,1417,154,130,284,54.2%,28m
24339,3,KengDiego,2668,1553,141,137,278,50.7%,3m
24339,2,ItIs,2668,1365,104,102,206,50.5%,32m
24339,3,butterduck,2668,945,83,78,161,51.6%,9m
24339,3,[DATM]kirito,2668,912,70,62,132,53.0%,41m
24339,2,KawaiiKY,2668,1173,47,54,101,46.5%,14m
24339,3,xblitzx,2668,800,34,29,63,54.0%,5m
24339,1,[EndPro]ByuNcdmx,2668,508,26,5,31,83.9%,1h
24339,1,Dye,2668,575,21,17,38,55.3%,48m
24339,3,Trapnasty,2668,526,21,21,42,50.0%,37m
24339,2,[NAisOK]WEEBRATOR,2668,614,21,30,51,41.2%,24m
24339,1,toshiro,2668,404,16,23,39,41.0%,16m
24339,3,ElIceFingers,2668,279,14,16,30,46.7%,18m
24339,1,JimKnopf,2668,384,13,9,22,59.1%,59m
24339,2,sirfluffkin,2668,317,11,8,19,57.9%,39m
24339,1,Voninski,2668,241,9,7,16,56.2%,22m
24339,1,MrSpecial,2668,302,9,10,19,47.4%,1h
24339,1,[EpicG]Miguel,2668,189,6,1,7,85.7%,42m
24339,3,Clayton,2668,134,6,8,14,42.9%,11m
24339,1,Convict,2668,187,5,3,8,62.5%,3h
24339,3,Liondres,2668,130,5,3,8,62.5%,5m
24339,1,Atalanta,2668,130,5,3,8,62.5%,3h
24339,3,Yggdrasil,2668,0,4,6,10,40.0%,15m
24339,1,[BucBim]Qwerty,2668,122,3,0,3,100.0%,3h
24339,3,[XXVXX]Trihorned,2668,0,2,3,5,40.0%,27m
24339,1,[8read]Bhutthead,2668,74,2,3,5,40.0%,3h
24339,3,CrAyOn,2668,94,2,3,5,40.0%,38m
24339,3,whotswral,2668,62,2,10,12,16.7%,41m
24339,2,Sirius,2668,62,2,17,19,10.5%,44m
24339,1,DMZ,2668,0,1,0,1,100.0%,42m
24339,3,Shodan,2668,0,1,1,2,50.0%,1h
24339,1,[Juneau]Uder,2668,0,1,4,5,20.0%,3h
24339,2,Leinhart,2668,0,0,1,1,0.0%,1h
24339,2,PureOne,2668,0,0,1,1,0.0%,3h
24339,1,iAnGeLX,2668,0,0,2,2,0.0%,27m
24339,1,ChestnutMist,2668,0,0,2,2,0.0%,52m
24339,1,acesino,2668,0,0,6,6,0.0%,54m
24377,3,mBangal,2667,1565,345,338,683,50.5%,28m
24377,3,KingKory,2667,1478,101,92,193,52.3%,40m
24377,2,PiggysFriend,2667,1434,57,60,117,48.7%,26m
24377,1,Ato,2667,973,38,28,66,57.6%,28m
24377,1,dartelaryon,2667,688,28,18,46,60.9%,1h
24377,1,SoWhat,2667,414,24,34,58,41.4%,19m
24377,1,[G501st]IIIIIIIIIIII,2667,556,23,16,39,59.0%,3h
24377,1,Danimoth,2667,352,11,11,22,50.0%,1h
24377,3,[Dundy]ADM,2667,263,11,11,22,50.0%,36m
24377,3,[FTTD]CoCoToSS,2667,256,7,11,18,38.9%,20m
24377,2,[N40G]Kaleem,2667,0,3,4,7,42.9%,3h
24377,1,KILLAGUNFISH,2667,38,2,1,3,66.7%,3h
24377,1,CUERVOROJO,2667,104,2,3,5,40.0%,7m
24377,1,potlebandit,2667,0,2,3,5,40.0%,3h
24377,1,[Gavin]XLampX,2667,48,2,4,6,33.3%,3h
24377,1,Revarlaz,2667,0,1,0,1,100.0%,57m
24377,1,[FU2]StimJunky,2667,0,0,1,1,0.0%,3h
24377,1,Goodluckhave,2667,0,0,2,2,0.0%,50m
24377,2,Panthre,2667,0,0,2,2,0.0%,1h
24396,3,SayWhen,2666,1604,444,440,884,50.2%,36m
24396,3,Shabadoo,2666,1568,154,151,305,50.5%,28m
24396,3,Airys,2666,1383,108,110,218,49.5%,17m
24396,3,edge,2666,1643,106,110,216,49.1%,4m
24396,3,[MadK]pachitox,2666,630,45,38,83,54.2%,8m
24396,3,[TGosuB]Daedalus,2666,784,30,33,63,47.6%,34m
24396,1,Mash,2666,646,24,21,45,53.3%,3h
24396,1,Apes,2666,523,17,13,30,56.7%,31m
24396,1,Fishy,2666,369,12,9,21,57.1%,31m
24396,1,SaltySandJr,2666,319,9,8,17,52.9%,1h
24396,1,[xVIPx]NEMESIS,2666,193,8,4,12,66.7%,22m
24396,1,aje,2666,275,8,7,15,53.3%,1h
24396,1,Vailrul,2666,310,8,7,15,53.3%,52m
24396,1,raksaka,2666,250,7,8,15,46.7%,14m
24396,1,[D0J0]Trijiro,2666,248,7,11,18,38.9%,1h
24396,1,Gregor,2666,174,6,6,12,50.0%,1h
24396,2,llllllllllll,2666,198,6,6,12,50.0%,40m
24396,2,Chipermix,2666,100,5,3,8,62.5%,18m
24396,2,YaBuKi,2666,174,5,5,10,50.0%,15m
24396,1,Billy,2666,0,4,1,5,80.0%,53m
24396,3,Zayke,2666,112,4,5,9,44.4%,21m
24396,1,Odin,2666,106,3,3,6,50.0%,3h
24396,2,Vadar,2666,46,3,5,8,37.5%,42m
24396,1,[Zno]donvividi,2666,40,2,0,2,100.0%,34m
24396,1,Killjoy,2666,0,2,3,5,40.0%,59m
24396,3,WhippingKids,2666,0,2,3,5,40.0%,3h
24396,3,Squirrellpoo,2666,0,2,3,5,40.0%,20m
24396,1,rabies,2666,0,1,0,1,100.0%,28m
24396,1,[WNTRLY]DeadCenter,2666,0,1,1,2,50.0%,31m
24396,1,TheArmor,2666,92,1,1,2,50.0%,50m
24426,1,LuisAlonso,2665,1739,188,182,370,50.8%,6m
24426,3,RaildYoMama,2665,1095,115,104,219,52.5%,36m
24426,1,albanyamal,2665,1137,62,45,107,57.9%,52m
24426,2,MindWalkerX,2665,675,46,45,91,50.5%,19m
24426,3,Laidyn,2665,917,34,36,70,48.6%,11m
24426,1,Bobblehead,2665,530,16,19,35,45.7%,4m
24426,1,BangBoogie,2665,384,15,10,25,60.0%,53m
24426,1,KingDragon,2665,288,10,8,18,55.6%,3h
24426,1,[TxC1]IIIIIIIIIIII,2665,102,6,1,7,85.7%,48m
24426,1,[Sune]ArcangelCR,2665,200,6,9,15,40.0%,3h
24426,1,DeadlyDave,2665,176,6,9,15,40.0%,35m
24426,3,IEsouL,2665,142,4,8,12,33.3%,26m
24426,1,rOKerO,2665,114,3,4,7,42.9%,14m
24426,1,bdb,2665,118,2,1,3,66.7%,22m
24426,3,Hugo,2665,93,2,2,4,50.0%,4m
24426,3,[Foood]Alcibiades,2665,0,2,3,5,40.0%,20m
24426,3,MajorlyGamin,2665,0,2,3,5,40.0%,1h
24426,2,koolkans,2665,0,1,0,1,100.0%,55m
24426,2,MORDHAU,2665,48,1,3,4,25.0%,3h
24426,1,[NBSC]TeslaCoil,2665,0,1,4,5,20.0%,3h
24426,3,[PWNSTR]heyarn,2665,0,1,4,5,20.0%,16m
24426,1,MasterKen,2665,0,0,1,1,0.0%,1h
24426,1,xDxExAxTxHx,2665,0,0,2,2,0.0%,32m
24426,1,Junglefear,2665,0,0,3,3,0.0%,1h
24426,1,DiscoDave,2665,0,0,3,3,0.0%,1h
24451,3,Bavatar,2664,1192,71,62,133,53.4%,35m
24451,1,Grump,2664,1480,59,49,108,54.6%,1h
24451,2,Renesis,2664,1042,43,52,95,45.3%,27m
24451,1,[UncrNa]Pegge,2664,684,28,20,48,58.3%,3h
24451,3,Kevin,2664,740,25,34,59,42.4%,13m
24451,1,[SPMAF]ExpostFacto,2664,467,21,20,41,51.2%,16m
24451,1,Spardeft,2664,492,17,15,32,53.1%,16m
24451,3,Hummus,2664,446,16,17,33,48.5%,20m
24451,1,blank,2664,287,13,12,25,52.0%,55m
24451,1,[4LOBOS]xXTheLionXx,2664,203,11,5,16,68.8%,1h
24451,1,atajalatula,2664,268,10,6,16,62.5%,2h
24451,3,Ret,2664,252,8,13,21,38.1%,1h
24451,1,[5up3r]Yoshi,2664,188,6,9,15,40.0%,15m
24451,1,ALPHA,2664,129,5,3,8,62.5%,48m
24451,1,Yang,2664,200,4,8,12,33.3%,1h
24451,2,ThreeDog,2664,0,3,3,6,50.0%,3h
24451,3,Puruca,2664,30,1,1,2,50.0%,3h
24451,1,CryMeARiver,2664,34,1,2,3,33.3%,1h
24451,1,JuicyGeneral,2664,0,0,1,1,0.0%,60m
24470,1,Arhkantos,2663,1257,53,50,103,51.5%,48m
24470,3,GoldenEagles,2663,836,36,42,78,46.2%,31m
24470,1,RymzOSix,2663,934,33,30,63,52.4%,2h
24470,1,Borbizzle,2663,712,32,10,42,76.2%,1h
24470,1,lugia,2663,670,30,21,51,58.8%,50m
24470,1,[MCLL]CliitDuster,2663,684,27,32,59,45.8%,42m
24470,3,kooryan,2663,515,17,20,37,45.9%,24m
24470,1,AbsoluteZero,2663,317,12,6,18,66.7%,29m
24470,1,BlackSails,2663,225,9,6,15,60.0%,1h
24470,1,Naruto,2663,264,9,9,18,50.0%,3h
24470,3,Defadog,2663,273,8,12,20,40.0%,3m
24470,2,TKboldimeR,2663,180,6,5,11,54.5%,3h
24470,1,Hexar,2663,142,6,6,12,50.0%,3h
24470,1,SarthorioFgR,2663,174,6,7,13,46.2%,3h
24470,1,AbiC,2663,158,5,6,11,45.5%,1h
24470,2,assaro,2663,48,4,4,8,50.0%,3h
24470,3,SxyBoi,2663,58,4,7,11,36.4%,16m
24470,2,Admiral,2663,64,3,10,13,23.1%,34m
24470,1,Nirvana,2663,0,2,3,5,40.0%,3h
24470,1,[RONM]MADMAX,2663,111,2,8,10,20.0%,3h
24470,2,MILKshoot,2663,0,1,0,1,100.0%,1h
24470,1,[G0BBLE]StevoHoodson,2663,48,1,1,2,50.0%,3h
24470,1,Soundeffect,2663,0,1,1,2,50.0%,48m
24470,3,Zero,2663,0,1,1,2,50.0%,1h
24470,1,[SOOSK]Augustus,2663,0,0,1,1,0.0%,36m
24470,1,[CUMBAT]CapFox,2663,0,0,1,1,0.0%,48m
24470,1,[Altf5]WolfBlack,2663,0,0,1,1,0.0%,3h
24470,1,RANDY,2663,0,0,1,1,0.0%,22m
24470,1,abesaljr,2663,0,0,2,2,0.0%,1h
24499,2,Bizling,2662,1510,213,211,424,50.2%,29m
24499,1,[LaOr]PiPo,2662,1563,77,66,143,53.8%,3h
24499,1,[cluez]ThedoctorS,2662,1450,75,63,138,54.3%,27m
24499,1,FeelTheVirus,2662,1559,74,56,130,56.9%,54m
24499,1,Shinji,2662,953,53,47,100,53.0%,27m
24499,1,[LDHero]smellyarmpit,2662,1422,50,56,106,47.2%,24m
24499,3,Bacon,2662,761,35,37,72,48.6%,6m
24499,2,Sandoli,2662,133,28,29,57,49.1%,32m
24499,3,AbusamadresB,2662,253,24,22,46,52.2%,7m
24499,1,[YEOBO]nahcaD,2662,421,21,6,27,77.8%,35m
24499,3,Mycelium,2662,424,15,16,31,48.4%,35m
24499,2,zealot,2662,294,10,22,32,31.2%,37m
24499,2,[Fr0nt]Midnitegyro,2662,260,8,25,33,24.2%,42m
24499,1,NxPulgar,2662,154,5,1,6,83.3%,42m
24499,1,aggpee,2662,102,5,2,7,71.4%,3h
24499,2,Covid,2662,145,5,5,10,50.0%,8m
24499,2,Rabscuttle,2662,95,4,3,7,57.1%,3h
24499,1,gagag,2662,144,4,9,13,30.8%,3h
24499,1,Red,2662,119,3,3,6,50.0%,52m
24499,3,IcedSoju,2662,88,3,13,16,18.8%,28m
24499,3,Frankomora,2662,0,1,0,1,100.0%,3h
24499,1,AverageMan,2662,0,1,1,2,50.0%,3h
24499,1,Guy,2662,0,1,1,2,50.0%,3h
24499,3,[BoAVN]MrVietcong,2662,0,1,3,4,25.0%,2h
24499,2,Skerpie,2662,0,1,5,6,16.7%,31m
24499,1,Crusade,2662,0,0,1,1,0.0%,6m
24525,3,Trinity,2661,853,175,162,337,51.9%,17m
24525,3,Badgas,2661,1549,154,150,304,50.7%,21m
24525,3,Pastel,2661,511,70,61,131,53.4%,25m
24525,3,Pagnotta,2661,746,41,37,78,52.6%,16m
24525,1,Swoi,2661,699,28,21,49,57.1%,3h
24525,3,[PSISTM]PewPewPew,2661,363,26,28,54,48.1%,33m
24525,3,[NPhasA]HASPEL,2661,736,26,32,58,44.8%,3m
24525,1,SkiesofStars,2661,480,19,17,36,52.8%,3h
24525,1,Hawkeye,2661,468,14,17,31,45.2%,3h
24525,1,IIIIIIIIIIII,2661,138,9,0,9,100.0%,1h
24525,1,freya,2661,230,8,6,14,57.1%,28m
24525,1,shysheng,2661,294,8,10,18,44.4%,3h
24525,1,mjm,2661,211,7,4,11,63.6%,48m
24525,1,[FENNIX]Stacrafttoo,2661,212,5,7,12,41.7%,3h
24525,3,rejekHzII,2661,155,4,5,9,44.4%,5m
24525,1,dedmet,2661,136,4,6,10,40.0%,15m
24525,1,[TDMT]TotoX,2661,0,3,2,5,60.0%,60m
24525,1,[CoKill]IceFang,2661,145,3,8,11,27.3%,1h
24525,2,babyknight,2661,94,2,1,3,66.7%,50m
24525,1,Patterson,2661,0,2,3,5,40.0%,1h
24525,3,Neckutrek,2661,0,2,3,5,40.0%,1h
24525,3,FalcONE,2661,58,2,8,10,20.0%,1h
24525,1,Goldberg,2661,0,1,2,3,33.3%,3h
24525,1,DontSpkEngsh,2661,0,1,3,4,25.0%,28m
24525,2,[cl0udM]KindOf,2661,46,1,3,4,25.0%,50m
24525,1,[TGCrew]FGiamteuton,2661,0,0,1,1,0.0%,3h
24525,1,FPSCanada,2661,0,0,1,1,0.0%,38m
24525,1,WaffleFry,2661,0,0,2,2,0.0%,3h
24553,3,Allan,2660,1516,293,287,580,50.5%,39m
24553,1,Syrupy,2660,1708,88,83,171,51.5%,28m
24553,2,[PUPUS]LtntMork,2660,1213,49,52,101,48.5%,10m
24553,1,[Cryptc]chaoz,2660,788,36,31,67,53.7%,48m
24553,3,Windy,2660,860,35,34,69,50.7%,29m
24553,2,TheDawning,2660,348,15,17,32,46.9%,13m
24553,3,sakatoma,2660,206,9,3,12,75.0%,17m
24553,1,NexusKing,2660,178,6,3,9,66.7%,52m
24553,1,Allan,2660,139,5,2,7,71.4%,22m
24553,3,diego,2660,30,5,3,8,62.5%,5m
24553,1,[lIRoIl]esKILL,2660,88,3,3,6,50.0%,3h
24553,3,Panthone,2660,42,3,3,6,50.0%,3h
24553,2,Hubie,2660,0,3,5,8,37.5%,1h
24553,1,krixus,2660,30,2,1,3,66.7%,14m
24553,3,TINO,2660,0,2,3,5,40.0%,1h
24553,1,Zugzug,2660,72,2,7,9,22.2%,52m
24553,1,Dahn,2660,0,1,0,1,100.0%,3h
24553,1,consert,2660,0,1,2,3,33.3%,3h
24553,1,Skyline,2660,0,1,3,4,25.0%,59m
24553,2,[QGR]TICADK,2660,44,1,7,8,12.5%,3h
24553,3,[Four2o]jamchgo,2660,0,0,1,1,0.0%,19m
24553,1,Ber,2660,0,0,1,1,0.0%,24m
24553,3,SuperNova,2660,0,0,4,4,0.0%,44m
24576,1,[Sopita]Deadeye,2659,1731,299,285,584,51.2%,54m
24576,3,Prawnstar,2659,1540,253,235,488,51.8%,7m
24576,3,NightRaven,2659,1559,106,91,197,53.8%,24m
24576,2,[AlIin]Raikkles,2659,624,83,76,159,52.2%,3m
24576,1,AtreiDes,2659,594,21,25,46,45.7%,36m
24576,1,Twiddlestorm,2659,516,20,11,31,64.5%,1h
24576,2,MeliodasSama,2659,312,16,19,35,45.7%,7m
24576,1,[PDBR]xck,2659,183,9,11,20,45.0%,60m
24576,2,Chicow,2659,244,9,20,29,31.0%,16m
24576,1,Zavspheed,2659,169,7,3,10,70.0%,3h
24576,1,BrightSkull,2659,189,7,4,11,63.6%,13m
24576,1,SumBu,2659,215,7,7,14,50.0%,1h
24576,1,fate,2659,162,5,6,11,45.5%,3h
24576,2,Frost,2659,48,4,4,8,50.0%,60m
24576,3,Danny,2659,166,4,6,10,40.0%,16m
24576,3,[ßÞÐ]Morty,2659,58,4,6,10,40.0%,42m
24576,1,hejolms,2659,102,3,3,6,50.0%,3h
24576,1,[CNAKER]NeoWaffle,2659,0,2,3,5,40.0%,42m
24576,1,DAJHOR,2659,68,2,3,5,40.0%,58m
24576,3,Xoldin,2659,137,2,5,7,28.6%,1h
24576,1,Barrier,2659,0,1,0,1,100.0%,3h
24576,1,Roke,2659,0,1,1,2,50.0%,48m
24576,1,Bracho,2659,36,1,3,4,25.0%,6m
24576,1,JetStream,2659,0,0,1,1,0.0%,1h
24576,2,IIZergMindII,2659,0,0,1,1,0.0%,1h
24576,3,[TheDOH]ZePapyTHOR,2659,0,0,2,2,0.0%,15m
24602,1,Starfry,2658,894,250,223,473,52.9%,28m
24602,2,Prometheus,2658,917,182,196,378,48.1%,31m
24602,2,itsAtrap,2658,1533,161,170,331,48.6%,4m
24602,3,TonyTuna,2658,1539,126,110,236,53.4%,34m
24602,3,Breedoss,2658,1564,124,115,239,51.9%,35m
24602,3,[iMPG]LOCO,2658,1351,61,66,127,48.0%,10m
24602,1,Bobert,2658,1408,59,48,107,55.1%,3h
24602,1,Exodus,2658,1008,36,30,66,54.5%,3h
24602,3,inoscopedJFK,2658,618,20,27,47,42.6%,34m
24602,3,YungViking,2658,178,6,14,20,30.0%,28m
24602,3,[QUDS]Kerberus,2658,152,5,17,22,22.7%,34m
24602,1,SnotLicker,2658,131,4,1,5,80.0%,3m
24602,1,NoInnovation,2658,132,4,3,7,57.1%,14m
24602,1,reapersl,2658,0,4,4,8,50.0%,3h
24602,1,WalkinOnRice,2658,118,3,4,7,42.9%,3h
24602,2,papir,2658,40,2,0,2,100.0%,3h
24602,1,Maikuru,2658,80,2,3,5,40.0%,3h
24602,1,MaterLord,2658,74,2,8,10,20.0%,50m
24602,1,Ptboon,2658,0,1,0,1,100.0%,3h
24602,1,[KiDo]agodeli,2658,38,1,2,3,33.3%,3h
24602,1,SpIN,2658,0,1,4,5,20.0%,55m
24602,3,[xCZx]TerraTeddy,2658,0,0,1,1,0.0%,50m
24602,1,Olecranon,2658,0,0,1,1,0.0%,48m
24602,3,Zero,2658,0,0,1,1,0.0%,1h
24602,2,Apeist,2658,0,0,2,2,0.0%,42m
24602,3,[AoBDE]Oppenheimer,2658,0,0,3,3,0.0%,8m
24628,1,BKFPCBCHKPKR,2657,1578,188,165,353,53.3%,22m
24628,1,WatfordCity,2657,512,117,106,223,52.5%,24m
24628,1,Ruuku,2657,1443,89,76,165,53.9%,1h
24628,1,lllllIIIllll,2657,1028,62,55,117,53.0%,36m
24628,2,nameless,2657,336,47,60,107,43.9%,40m
24628,1,TryonPants,2657,811,29,24,53,54.7%,10m
24628,1,WastinG,2657,612,24,15,39,61.5%,3m
24628,1,oppie,2657,611,22,27,49,44.9%,48m
24628,3,FernandoSBC,2657,629,21,24,45,46.7%,28m
24628,3,SimpleCadet,2657,280,11,12,23,47.8%,1h
24628,3,nitwhale,2657,292,10,15,25,40.0%,34m
24628,1,James,2657,150,7,3,10,70.0%,1h
24628,1,rongalek,2657,220,6,4,10,60.0%,22m
24628,3,[LiFi]RiFt,2657,114,5,11,16,31.2%,18m
24628,1,ELperuCHOLO,2657,0,2,4,6,33.3%,3h
24628,1,Fox,2657,0,1,0,1,100.0%,54m
24628,1,BobLoblah,2657,30,1,2,3,33.3%,2h
24628,1,Stryker,2657,30,1,2,3,33.3%,3h
24628,1,Thrilmachine,2657,0,1,2,3,33.3%,3h
24628,2,ThManNervoso,2657,0,1,4,5,20.0%,3h
24628,1,PsychoMantis,2657,0,0,1,1,0.0%,36m
24628,1,HowlingElf,2657,0,0,4,4,0.0%,42m
24650,1,[Sc2Maf]MagicTurtle,2656,1683,105,95,200,52.5%,1h
24650,3,LeeManChild,2656,1201,45,47,92,48.9%,16m
24650,3,HeroGT,2656,908,37,39,76,48.7%,4m
24650,3,Zaklee,2656,946,34,41,75,45.3%,19m
24650,3,[P0PO]Saunders,2656,816,28,34,62,45.2%,38m
24650,1,josseb,2656,668,25,20,45,55.6%,48m
24650,1,Xilsy,2656,647,23,25,48,47.9%,35m
24650,1,Baskervile,2656,507,22,20,42,52.4%,48m
24650,1,Caustic,2656,302,17,9,26,65.4%,22m
24650,2,[Steves]Michaelsoft,2656,465,17,21,38,44.7%,13m
24650,1,llllIIIllII,2656,375,15,13,28,53.6%,1h
24650,1,canion,2656,319,14,6,20,70.0%,28m
24650,1,[Pnoys]Swaffelen,2656,413,14,9,23,60.9%,28m
24650,1,blackbrick,2656,292,13,21,34,38.2%,50m
24650,1,aaaaaaaaa,2656,340,11,7,18,61.1%,1h
24650,1,IdkFrandBaby,2656,34,6,2,8,75.0%,3h
24650,2,SargeLausage,2656,157,3,2,5,60.0%,49m
24650,1,[10JQKA]Baller,2656,0,3,2,5,60.0%,1h
24650,1,[HW420]DroPê,2656,88,3,3,6,50.0%,12m
24650,1,[FRING3]Lemons,2656,126,3,3,6,50.0%,59m
24650,1,Bigdaddy,2656,103,2,1,3,66.7%,54m
24650,1,[MRHAND]GreenTea,2656,113,2,2,4,50.0%,3h
24650,1,GhOxT,2656,0,2,3,5,40.0%,54m
24650,1,Ballad,2656,0,2,3,5,40.0%,3h
24650,1,RenanMauri,2656,0,2,6,8,25.0%,18m
24650,3,[Sobro]Raynor,2656,30,2,7,9,22.2%,26m
24650,1,[LQV]DMCAshirel,2656,0,1,2,3,33.3%,26m
24650,3,HugoStiglits,2656,30,1,11,12,8.3%,42m
24650,1,[N1C3]Liberspartan,2656,0,0,1,1,0.0%,28m
24650,1,EchoDriver,2656,0,0,2,2,0.0%,1h
24650,1,WNxTekk,2656,0,0,4,4,0.0%,23m
24681,1,inbalance,2655,1728,370,361,731,50.6%,36m
24681,3,Fino,2655,759,270,251,521,51.8%,25m
24681,3,Sacamano,2655,1516,187,182,369,50.7%,7m
24681,3,ToeBlake,2655,823,127,117,244,52.0%,16m
24681,1,[ZFMs]Lynk,2655,722,92,79,171,53.8%,1h
24681,1,RavenLord,2655,888,67,59,126,53.2%,28m
24681,3,CheatedByPnZ,2655,426,44,42,86,51.2%,19m
24681,1,LeonardoSt,2655,977,40,41,81,49.4%,1h
24681,1,Azura,2655,978,33,32,65,50.8%,3h
24681,3,AlwaysAngry,2655,707,29,29,58,50.0%,34m
24681,1,aTaN,2655,458,25,29,54,46.3%,50m
24681,1,pelletier,2655,619,23,23,46,50.0%,48m
24681,1,[WkdWlf]Ripit,2655,647,22,18,40,55.0%,47m
24681,1,Kikex,2655,445,18,12,30,60.0%,3h
24681,1,[MDwarz]Ryanwarrior,2655,450,14,17,31,45.2%,1h
24681,1,[GFP]Valhanis,2655,267,11,12,23,47.8%,48m
24681,1,SaltyMofou,2655,350,10,12,22,45.5%,3h
24681,1,satanas,2655,153,9,4,13,69.2%,3h
24681,3,malolo,2655,190,8,14,22,36.4%,42m
24681,3,Kyle,2655,90,6,8,14,42.9%,26m
24681,2,[Build]Crabalanche,2655,124,5,16,21,23.8%,12m
24681,3,Arepazo,2655,42,4,3,7,57.1%,3h
24681,1,jamstAR,2655,174,4,4,8,50.0%,1h
24681,1,Jovalar,2655,100,4,6,10,40.0%,55m
24681,1,denielfer,2655,0,3,2,5,60.0%,16m
24681,1,ExtraMSG,2655,118,3,4,7,42.9%,55m
24681,2,LLANCKQ,2655,0,3,4,7,42.9%,1h
24681,3,Flymite,2655,91,3,4,7,42.9%,9m
24681,1,[0d1N5]Anubis,2655,40,2,2,4,50.0%,3h
24681,3,Tautalis,2655,0,2,3,5,40.0%,1h
24681,3,DimitriKrups,2655,0,2,3,5,40.0%,20m
24681,1,SonofAresxx,2655,89,1,1,2,50.0%,1h
24681,1,[CTLJ]LiquidWater,2655,0,0,1,1,0.0%,16m
24681,1,Wallace,2655,0,0,1,1,0.0%,52m
24681,1,[OST1]Clocktwerk,2655,0,0,1,1,0.0%,31m
24681,2,[SCTR]CapMurica,2655,0,0,3,3,0.0%,8m
24717,3,batlecruser,2654,1446,124,126,250,49.6%,29m
24717,3,Sarimas,2654,1465,92,89,181,50.8%,40m
24717,1,GKL,2654,809,32,26,58,55.2%,3m
24717,1,Arks,2654,796,25,30,55,45.5%,31m
24717,1,MisterKiko,2654,230,23,22,45,51.1%,3h
24717,1,[DNYO]Lockdown,2654,221,13,10,23,56.5%,12m
24717,1,nigromantexd,2654,290,12,11,23,52.2%,60m
24717,3,SilentStorm,2654,309,11,10,21,52.4%,1h
24717,1,Felipe,2654,256,8,10,18,44.4%,1h
24717,2,iSiege,2654,206,8,11,19,42.1%,32m
24717,1,Cuckophany,2654,190,7,6,13,53.8%,57m
24717,3,SilverSpoon,2654,122,7,8,15,46.7%,26m
24717,1,etxeberrik,2654,189,5,9,14,35.7%,1h
24717,2,KillerShen,2654,117,3,3,6,50.0%,1h
24717,1,[Black0]CHELOMANO,2654,68,3,3,6,50.0%,1h
24717,1,qwq,2654,120,3,3,6,50.0%,45m
24717,1,[427427]doctorthug,2654,116,3,7,10,30.0%,3h
24717,2,Riptider,2654,90,3,7,10,30.0%,19m
24717,1,Vorbeck,2654,88,2,0,2,100.0%,27m
24717,1,CapMan,2654,0,2,3,5,40.0%,34m
24717,1,Uller,2654,0,2,3,5,40.0%,32m
24717,1,Meagles,2654,72,2,4,6,33.3%,1h
24717,1,MickyLaRata,2654,62,2,7,9,22.2%,47m
24717,1,iglooz,2654,0,1,0,1,100.0%,48m
24717,1,Vex,2654,40,1,2,3,33.3%,10m
24717,1,Renko,2654,40,1,4,5,20.0%,26m
24743,3,[ZUCCED]Ximines,2653,1620,298,298,596,50.0%,3m
24743,1,Mike,2653,1710,105,108,213,49.3%,3h
24743,3,Belslow,2653,1412,68,62,130,52.3%,33m
24743,2,[koook]bobandy,2653,1183,44,55,99,44.4%,21m
24743,1,nicolas,2653,837,36,25,61,59.0%,1h
24743,1,[buttts]DJStinkyButt,2653,405,15,12,27,55.6%,3h
24743,1,Mijongles,2653,403,14,11,25,56.0%,1h
24743,3,Soul,2653,388,14,21,35,40.0%,5m
24743,3,TEKmaster,2653,216,8,13,21,38.1%,38m
24743,1,PotatoJoe,2653,245,7,5,12,58.3%,3h
24743,1,Rider,2653,194,6,6,12,50.0%,1h
24743,2,Starlord,2653,90,6,9,15,40.0%,13m
24743,2,EVENTHOR,2653,116,4,5,9,44.4%,3h
24743,1,Cezi,2653,82,3,3,6,50.0%,53m
24743,2,Coisware,2653,0,3,4,7,42.9%,3h
24743,1,[0kyun0]SpyShadow,2653,38,2,1,3,66.7%,1h
24743,3,[xLCFC]Eibhear,2653,0,2,3,5,40.0%,3h
24743,1,[PY]shpshp,2653,0,2,3,5,40.0%,3h
24743,3,STARLORD,2653,0,2,3,5,40.0%,1h
24743,1,manu,2653,0,2,3,5,40.0%,54m
24743,3,[ExcIgN]Icaro,2653,0,2,4,6,33.3%,26m
24743,1,Bacher,2653,0,1,0,1,100.0%,30m
24743,1,Vixaso,2653,90,1,1,2,50.0%,48m
24743,1,pieces,2653,0,1,4,5,20.0%,34m
24743,1,[Frog]BlackThunder,2653,0,0,1,1,0.0%,35m
24743,1,SittingDuck,2653,0,0,2,2,0.0%,1h
24769,1,[Kodos]Nicofersar,2652,1553,500,469,969,51.6%,43m
24769,3,[HØST]StayHome,2652,1536,146,143,289,50.5%,41m
24769,1,Haydn,2652,1696,108,97,205,52.7%,52m
24769,1,Tayryu,2652,1468,81,65,146,55.5%,1h
24769,1,[MLscGs]Booperman,2652,1286,51,42,93,54.8%,1h
24769,3,adeptz,2652,841,40,33,73,54.8%,16m
24769,1,yourleftball,2652,516,20,13,33,60.6%,60m
24769,1,NightHawk,2652,552,19,24,43,44.2%,1h
24769,1,Darksu,2652,355,14,10,24,58.3%,55m
24769,1,Dugall,2652,263,12,10,22,54.5%,7m
24769,1,YoungTiger,2652,390,12,12,24,50.0%,59m
24769,1,ARTEAGA,2652,228,11,6,17,64.7%,14m
24769,3,drperron,2652,269,11,10,21,52.4%,1h
24769,1,Ghost,2652,172,6,2,8,75.0%,36m
24769,1,[TF11]Raider,2652,152,5,3,8,62.5%,29m
24769,3,Claynor,2652,120,4,10,14,28.6%,23m
24769,1,Lucas,2652,88,3,3,6,50.0%,54m
24769,1,hellokitty,2652,82,3,7,10,30.0%,3h
24769,3,[13Pool]shogi,2652,88,3,10,13,23.1%,3h
24769,1,SSjeviSS,2652,36,2,2,4,50.0%,48m
24769,1,[LOHs]Diogenes,2652,0,1,3,4,25.0%,7m
24769,3,Sethracido,2652,0,1,3,4,25.0%,21m
24769,1,MDR,2652,0,1,4,5,20.0%,3h
24769,1,Fersim,2652,0,0,1,1,0.0%,31m
24769,1,[25ml]Csheef,2652,0,0,2,2,0.0%,3h
24769,1,Langsley,2652,0,0,2,2,0.0%,3h
24795,1,AMOEBA,2651,1520,100,105,205,48.8%,14m
24795,1,edi,2651,1433,69,70,139,49.6%,3h
24795,1,[ACSS]Methyle,2651,719,24,22,46,52.2%,1h
24795,1,Redcrosse,2651,396,13,13,26,50.0%,31m
24795,1,aceplaya,2651,300,11,13,24,45.8%,23m
24795,1,[Poiint]EndShield,2651,195,6,4,10,60.0%,3h
24795,1,MenduSystem,2651,194,6,8,14,42.9%,1h
24795,1,Ahmad,2651,133,3,1,4,75.0%,1h
24795,3,Hoop,2651,143,3,1,4,75.0%,1h
24795,1,chechme,2651,89,3,3,6,50.0%,36m
24795,2,[MAXTRX]MAXTORX,2651,115,3,4,7,42.9%,50m
24795,1,Hamablam,2651,0,2,3,5,40.0%,3h
24795,1,opie,2651,0,1,0,1,100.0%,1h
24795,1,corsario,2651,0,1,0,1,100.0%,54m
24795,1,BingBong,2651,0,1,0,1,100.0%,50m
24795,1,[xDYEx]Spectre,2651,0,0,1,1,0.0%,22m
24795,1,urcommonthug,2651,0,0,1,1,0.0%,3h
24812,1,Linguini,2650,1612,199,194,393,50.6%,7m
24812,3,Jeyva,2650,1519,155,141,296,52.4%,29m
24812,1,Zylb,2650,1663,101,86,187,54.0%,16m
24812,3,Vilsmay,2650,1077,65,49,114,57.0%,18m
24812,3,Beto,2650,1469,61,61,122,50.0%,7m
24812,1,blacky,2650,902,42,29,71,59.2%,55m
24812,1,lanyy,2650,774,39,38,77,50.6%,55m
24812,2,Bagelstein,2650,439,38,43,81,46.9%,9m
24812,1,Yeti,2650,932,35,36,71,49.3%,55m
24812,3,Razulkam,2650,976,35,37,72,48.6%,34m
24812,1,Ohtbier,2650,657,32,17,49,65.3%,25m
24812,1,Costilla,2650,741,31,23,54,57.4%,32m
24812,1,Canon,2650,752,25,27,52,48.1%,40m
24812,2,Demetrium,2650,554,23,24,47,48.9%,33m
24812,1,[mAg]Orchestrate,2650,422,12,14,26,46.2%,1h
24812,1,AYOS,2650,311,9,6,15,60.0%,38m
24812,1,eEkOoK,2650,263,9,6,15,60.0%,1h
24812,1,XjesseX,2650,210,6,8,14,42.9%,22m
24812,3,[haut]grep,2650,58,5,7,12,41.7%,5m
24812,3,[IC4evr]zergerking,2650,126,5,7,12,41.7%,3h
24812,1,[SmokeH]EpidemiK,2650,160,4,2,6,66.7%,3h
24812,1,Henritus,2650,0,3,5,8,37.5%,26m
24812,2,Aarodynamix,2650,42,2,0,2,100.0%,1h
24812,1,Tyrone,2650,0,2,3,5,40.0%,54m
24812,1,clayslickwig,2650,34,1,4,5,20.0%,36m
24812,2,[Hawkey]SirHazer,2650,0,1,5,6,16.7%,3h
24838,2,[UpxV]JOSELITO,2649,1539,263,256,519,50.7%,13m
24838,2,[xUGRx]Bean,2649,1435,151,151,302,50.0%,9m
24838,3,llllllllllll,2649,1595,144,168,312,46.2%,12m
24838,3,RmasterJ,2649,1488,119,118,237,50.2%,25m
24838,3,Andreus,2649,1447,118,117,235,50.2%,17m
24838,1,Touchme,2649,1543,87,72,159,54.7%,10m
24838,1,LuckySeven,2649,1294,69,63,132,52.3%,3h
24838,3,maurice,2649,379,41,47,88,46.6%,30m
24838,1,Ketzeri,2649,666,27,24,51,52.9%,30m
24838,1,BloodyHunter,2649,682,26,29,55,47.3%,22m
24838,3,Fatal,2649,551,25,21,46,54.3%,37m
24838,1,BlackMarley,2649,734,23,22,45,51.1%,51m
24838,3,ricky,2649,684,23,33,56,41.1%,9m
24838,1,IMMORTAL,2649,407,19,11,30,63.3%,7m
24838,1,NiGhtCourT,2649,438,16,16,32,50.0%,16m
24838,3,MCnookies,2649,454,15,19,34,44.1%,12m
24838,1,TDS,2649,206,10,2,12,83.3%,10m
24838,2,SQuiDcOOkiES,2649,220,8,21,29,27.6%,22m
24838,3,JagoShadow,2649,192,6,13,19,31.6%,31m
24838,1,[SPACEX]TimeBoss,2649,117,4,2,6,66.7%,48m
24838,2,lee,2649,133,4,3,7,57.1%,1h
24838,2,Radical,2649,114,4,4,8,50.0%,3h
24838,1,Icarus,2649,102,4,4,8,50.0%,3h
24838,3,[SHPK]OPticSQuare,2649,40,3,1,4,75.0%,1h
24838,1,Quasimotron,2649,78,3,3,6,50.0%,1h
24838,3,Raetech,2649,40,3,4,7,42.9%,1h
24838,3,STALKER,2649,86,3,11,14,21.4%,20m
24838,3,[KSADOs]neoadr,2649,0,2,3,5,40.0%,43m
24838,1,Whitey,2649,0,2,3,5,40.0%,35m
24838,3,Pichon,2649,0,2,3,5,40.0%,33m
24838,3,eternalsigh,2649,0,2,3,5,40.0%,38m
24838,1,[mmKay]ManBearPig,2649,0,2,3,5,40.0%,36m
24838,1,eldric,2649,0,2,3,5,40.0%,48m
24838,1,NubbyNubbs,2649,40,1,3,4,25.0%,1h
24838,1,[VFam2]Kaladin,2649,0,0,1,1,0.0%,4m
24838,1,Xyborg,2649,0,0,1,1,0.0%,3h
24838,1,BASTIONKS,2649,0,0,1,1,0.0%,2h
24838,1,XBEASTMODEX,2649,0,0,1,1,0.0%,3h
24838,1,THEDANGEROUS,2649,0,0,2,2,0.0%,40m
24877,3,Mamuri,2648,1584,257,224,481,53.4%,20m
24877,3,Hyperion,2648,1464,210,201,411,51.1%,30m
24877,1,ZeruGiran,2648,1704,96,95,191,50.3%,3h
24877,2,AmPact,2648,389,88,97,185,47.6%,34m
24877,3,Daddy,2648,1059,62,54,116,53.4%,36m
24877,1,[NPMM]Anicca,2648,386,39,38,77,50.6%,36m
24877,3,[CovT]CodecS,2648,622,33,32,65,50.8%,25m
24877,1,Varimatas,2648,778,26,26,52,50.0%,1h
24877,1,adoooken,2648,736,23,42,65,35.4%,16m
24877,1,dblock,2648,536,22,19,41,53.7%,1h
24877,1,Peon,2648,363,20,15,35,57.1%,3h
24877,1,Alejandro,2648,666,20,22,42,47.6%,2h
24877,2,[tCo9]sogytubesock,2648,518,17,31,48,35.4%,6m
24877,3,ChouTzuyu,2648,390,16,17,33,48.5%,25m
24877,1,FelixTheCat,2648,340,12,7,19,63.2%,1h
24877,3,mbuswell,2648,287,9,12,21,42.9%,37m
24877,3,zerg,2648,165,5,8,13,38.5%,15m
24877,1,Caveira,2648,122,4,5,9,44.4%,48m
24877,1,Terminology,2648,122,4,5,9,44.4%,48m
24877,1,Youwinilose,2648,146,4,6,10,40.0%,7m
24877,3,PaddyT,2648,36,3,3,6,50.0%,14m
24877,1,bobohobo,2648,105,3,5,8,37.5%,52m
24877,1,[BraziI]Baikal,2648,91,2,0,2,100.0%,3h
24877,1,thomaskno,2648,0,2,3,5,40.0%,3h
24877,1,GreatWhale,2648,0,2,3,5,40.0%,3h
24877,1,Choka,2648,48,2,4,6,33.3%,40m
24877,2,billy,2648,0,2,4,6,33.3%,1h
24877,1,TitaniumONE,2648,118,2,5,7,28.6%,3h
24877,2,[BoXLyF]GloopGlorp,2648,46,2,7,9,22.2%,49m
24877,1,Lovus,2648,0,1,1,2,50.0%,3h
24877,1,SomEonEsbuTT,2648,95,1,1,2,50.0%,8m
24877,1,Zeltuk,2648,97,1,1,2,50.0%,3h
24877,2,ZestHZ,2648,44,1,2,3,33.3%,1h
24877,1,Killerfish,2648,0,1,2,3,33.3%,1h
24877,3,[RawDog]DrPoopyHands,2648,0,1,4,5,20.0%,19m
24877,1,DaddyLegs,2648,40,1,6,7,14.3%,14m
24877,1,Jimmyb,2648,0,0,2,2,0.0%,1h
24877,1,[PML]IrishCarBomb,2648,0,0,3,3,0.0%,12m
24915,1,NANDOX,2647,1402,240,228,468,51.3%,31m
24915,1,adrian,2647,1601,239,237,476,50.2%,3h
24915,1,ItsMe,2647,1603,96,89,185,51.9%,35m
24915,3,[CscE]Excalibur,2647,1172,72,72,144,50.0%,38m
24915,1,Xenorf,2647,1493,63,44,107,58.9%,54m
24915,3,alB,2647,1423,62,61,123,50.4%,36m
24915,1,Frestón,2647,694,58,63,121,47.9%,26m
24915,1,[LaOr]alejandrovid,2647,922,33,27,60,55.0%,1h
24915,1,[NastyB]zeroworld,2647,576,25,21,46,54.3%,1h
24915,3,[SanTos]SaInTBruno,2647,634,23,30,53,43.4%,41m
24915,1,David,2647,516,21,19,40,52.5%,29m
24915,1,taroy,2647,387,17,17,34,50.0%,1h
24915,1,[lLiTl]VikSeVeN,2647,275,13,3,16,81.2%,3h
24915,1,[SYNDCT]Jongsongs,2647,428,13,14,27,48.1%,23m
24915,1,HOPE,2647,248,8,5,13,61.5%,48m
24915,1,allmight,2647,155,5,2,7,71.4%,48m
24915,1,Gutispel,2647,166,5,3,8,62.5%,1h
24915,3,Sam,2647,117,2,4,6,33.3%,23m
24915,1,TommyT,2647,88,1,1,2,50.0%,1h
24915,1,[Hulu]pengli,2647,0,1,3,4,25.0%,36m
24915,1,McSkarff,2647,0,0,1,1,0.0%,3h
24915,1,Vudoo,2647,0,0,1,1,0.0%,1h
24915,1,DieGuish,2647,0,0,2,2,0.0%,4m
24915,1,Gigi,2647,0,0,3,3,0.0%,17m
24939,3,[CRAKS]MauricioV,2646,1579,242,232,474,51.1%,34m
24939,1,[FMX]Nordico,2646,1704,172,161,333,51.7%,23m
24939,1,KoutaKun,2646,980,106,87,193,54.9%,3h
24939,1,[NORU5H]BronzerGuy,2646,1194,64,61,125,51.2%,42m
24939,2,[ZPTFC]JDTV,2646,603,42,50,92,45.7%,13m
24939,2,LoofyDizzle,2646,960,37,44,81,45.7%,41m
24939,1,[DTML]Polyknikes,2646,855,34,27,61,55.7%,10m
24939,3,Bomberman,2646,306,10,15,25,40.0%,18m
24939,1,muffin,2646,329,9,11,20,45.0%,55m
24939,3,Jonnyquest,2646,287,9,13,22,40.9%,42m
24939,1,migs,2646,222,7,13,20,35.0%,59m
24939,3,Raynor,2646,184,6,15,21,28.6%,6m
24939,2,Deku,2646,139,5,5,10,50.0%,3h
24939,2,[Onward]Raxor,2646,142,5,6,11,45.5%,42m
24939,1,epiD,2646,131,3,2,5,60.0%,52m
24939,1,MaNiA,2646,98,3,4,7,42.9%,53m
24939,1,builder,2646,34,2,3,5,40.0%,30m
24939,1,Kreamz,2646,0,2,3,5,40.0%,48m
24939,3,Alfonso,2646,0,2,3,5,40.0%,1h
24939,1,VDRWASHERE,2646,38,2,4,6,33.3%,40m
24939,1,GGTG,2646,74,2,4,6,33.3%,3h
24939,1,Keamon,2646,96,2,7,9,22.2%,1h
24939,1,[Kerak]Andrew,2646,32,1,2,3,33.3%,42m
24939,1,WolfOfMibu,2646,38,1,3,4,25.0%,52m
24939,1,aeagaaaaaa,2646,0,0,2,2,0.0%,3h
24964,2,[BetS]Redline,2645,1408,240,237,477,50.3%,15m
24964,3,Absolute,2645,1472,193,203,396,48.7%,27m
24964,1,avtec,2645,1710,181,176,357,50.7%,3h
24964,3,ZRakim,2645,1248,106,104,210,50.5%,22m
24964,3,[PiGPan]Draknas,2645,1523,88,80,168,52.4%,41m
24964,2,Tillamanjaro,2645,1348,87,101,188,46.3%,44m
24964,1,[SyLx]Bomber,2645,1363,67,69,136,49.3%,50m
24964,1,Fade,2645,1455,59,52,111,53.2%,52m
24964,1,BlueTerran,2645,620,56,54,110,50.9%,50m
24964,3,LIlIIiil,2645,845,55,52,107,51.4%,42m
24964,1,MPL,2645,884,53,69,122,43.4%,18m
24964,1,Mattadin,2645,1008,45,34,79,57.0%,31m
24964,3,juliukas,2645,729,43,37,80,53.8%,15m
24964,1,[ORNG]zUnkP,2645,583,29,22,51,56.9%,30m
24964,1,Suitebird,2645,310,21,16,37,56.8%,3h
24964,1,JameGumb,2645,462,15,12,27,55.6%,3h
24964,1,[ccbi]Miklul,2645,329,13,9,22,59.1%,37m
24964,1,EasySkankin,2645,318,11,11,22,50.0%,36m
24964,1,Smiley,2645,229,7,4,11,63.6%,3h
24964,1,[SOya]narky,2645,194,7,6,13,53.8%,55m
24964,1,Lorinian,2645,188,5,3,8,62.5%,38m
24964,2,Lenichi,2645,116,4,5,9,44.4%,3h
24964,2,ZéRinite,2645,0,3,3,6,50.0%,3h
24964,3,sco,2645,94,3,5,8,37.5%,24m
24964,2,PaTheCat,2645,44,2,0,2,100.0%,42m
24964,3,Stryker,2645,0,2,3,5,40.0%,2h
24964,1,nooboldmen,2645,0,2,3,5,40.0%,54m
24964,1,DiegoFIPA,2645,76,2,7,9,22.2%,1h
24964,1,[C31081]LingKing,2645,88,1,1,2,50.0%,7m
24964,1,SoSGhosty,2645,88,1,1,2,50.0%,54m
24964,1,pierreyaser,2645,89,1,1,2,50.0%,48m
24964,1,[GAUCHA]xxnarusepixx,2645,16,1,4,5,20.0%,52m
24964,1,ChalloCello,2645,0,0,1,1,0.0%,1h
24964,1,[N0BLE]Freak,2645,0,0,1,1,0.0%,3h
24964,3,Qbano,2645,0,0,2,2,0.0%,30m
24964,3,TeletobyROK,2645,0,0,2,2,0.0%,16m
24964,2,TeChNo,2645,0,0,3,3,0.0%,3h
24964,1,fernando,2645,0,0,3,3,0.0%,1h
24964,1,ESPECTRO,2645,0,0,3,3,0.0%,1h
24964,1,Frito,2645,0,0,5,5,0.0%,3h
25004,1,noooooooooob,2644,1586,187,169,356,52.5%,49m
25004,1,fox,2644,1557,78,69,147,53.1%,48m
25004,1,dodisan,2644,1406,65,47,112,58.0%,1h
25004,1,Phrygian,2644,932,65,60,125,52.0%,3h
25004,1,[SmoreO]Ardrith,2644,1176,52,34,86,60.5%,42m
25004,3,[M4ND4]malaspulgas,2644,1038,47,38,85,55.3%,5m
25004,1,vug,2644,997,38,34,72,52.8%,48m
25004,1,Kikkelitikku,2644,742,33,20,53,62.3%,3h
25004,3,[xENTx]InfinitePest,2644,724,26,31,57,45.6%,20m
25004,1,WilFromEarth,2644,541,22,19,41,53.7%,13m
25004,1,dasdsaf,2644,449,15,13,28,53.6%,10m
25004,1,Sundown,2644,402,14,21,35,40.0%,59m
25004,3,Arilha,2644,304,10,20,30,33.3%,13m
25004,2,ACAHNN,2644,48,5,4,9,55.6%,2h
25004,1,gongor,2644,94,4,3,7,57.1%,22m
25004,2,MAC,2644,141,4,5,9,44.4%,1h
25004,2,[506]FiveOSix,2644,0,3,5,8,37.5%,22m
25004,1,[SANGRE]Aragorn,2644,44,2,1,3,66.7%,31m
25004,1,iMagi,2644,0,2,3,5,40.0%,60m
25004,2,[TFMG]Roma,2644,0,2,4,6,33.3%,1h
25004,2,Zackistall,2644,0,2,4,6,33.3%,3h
25004,1,Marwakii,2644,76,2,8,10,20.0%,48m
25004,1,DjBoBo,2644,0,1,0,1,100.0%,12m
25004,3,CosmicOwl,2644,0,1,1,2,50.0%,17m
25004,2,Phucus,2644,0,1,1,2,50.0%,53m
25004,1,Quentin,2644,40,1,3,4,25.0%,3h
25004,1,WowoNano,2644,0,1,4,5,20.0%,54m
25004,1,Bae,2644,0,0,1,1,0.0%,35m
25004,1,guts,2644,0,0,1,1,0.0%,3h
25004,1,LixoMolhado,2644,0,0,1,1,0.0%,37m
25004,1,gtctg,2644,0,0,1,1,0.0%,8m
25004,1,shroobs,2644,0,0,2,2,0.0%,26m
25004,1,[AlIin]wocks,2644,0,0,2,2,0.0%,22m
25004,1,OGMarvel,2644,0,0,4,4,0.0%,31m
25004,1,Sulta,2644,0,0,6,6,0.0%,31m
25039,1,Jonacs,2643,1652,352,330,682,51.6%,3h
25039,1,Curupira,2643,1007,110,90,200,55.0%,48m
25039,1,Shelby,2643,1118,65,65,130,50.0%,10m
25039,2,[Mildly]Inebriated,2643,1552,63,60,123,51.2%,33m
25039,3,[AR]SuperSixFor,2643,1506,59,61,120,49.2%,23m
25039,1,Jossué,2643,426,15,13,28,53.6%,30m
25039,1,makotochicho,2643,384,13,10,23,56.5%,3h
25039,1,HAC,2643,434,13,15,28,46.4%,50m
25039,1,Chicolz,2643,408,13,16,29,44.8%,3h
25039,1,Brucewilly,2643,269,12,6,18,66.7%,1h
25039,3,daget,2643,98,10,15,25,40.0%,9m
25039,1,[Gasai]Yuno,2643,218,7,6,13,53.8%,26m
25039,1,[pepis]ClownGamer,2643,131,5,0,5,100.0%,3h
25039,1,Wildwolf,2643,211,5,8,13,38.5%,32m
25039,3,max,2643,21,5,10,15,33.3%,18m
25039,1,KnIvIs,2643,0,4,4,8,50.0%,26m
25039,3,Chuckles,2643,0,2,3,5,40.0%,20m
25039,1,SecretSora,2643,0,2,3,5,40.0%,31m
25039,1,CamusBlue,2643,0,2,3,5,40.0%,7m
25039,1,[GRNSKN]NotFlorencio,2643,0,1,0,1,100.0%,23m
25039,1,[SCSS]Vladimir,2643,0,0,2,2,0.0%,3h
25039,1,[proGMs]GamecasterYT,2643,0,0,3,3,0.0%,1h
25061,2,Jake,2642,1221,197,193,390,50.5%,13m
25061,1,jonrocks,2642,1441,96,83,179,53.6%,3h
25061,1,[ifiru]BLACKDRAGON,2642,449,23,14,37,62.2%,34m
25061,3,ALLCAPS,2642,584,21,22,43,48.8%,18m
25061,1,NightBlade,2642,464,17,16,33,51.5%,3h
25061,1,[THREW]Eliminator,2642,430,16,14,30,53.3%,1h
25061,1,Frost,2642,454,14,12,26,53.8%,58m
25061,3,Crowiz,2642,304,12,13,25,48.0%,27m
25061,1,sincerebnana,2642,292,11,13,24,45.8%,54m
25061,1,HumanRights,2642,345,10,10,20,50.0%,3h
25061,3,Confederate,2642,30,4,5,9,44.4%,18m
25061,1,IIIIIIII,2642,76,4,6,10,40.0%,10m
25061,1,Shelly,2642,0,3,2,5,60.0%,7m
25061,2,oldman,2642,0,3,5,8,37.5%,33m
25061,3,LoveExpert,2642,0,2,3,5,40.0%,1h
25061,1,Eceer,2642,0,2,3,5,40.0%,3h
25061,3,[AXlOS]MynameisWarn,2642,0,1,3,4,25.0%,38m
25061,1,vunconker,2642,40,1,7,8,12.5%,50m
25061,1,[BaXTeR]LiLNidas,2642,0,0,1,1,0.0%,3h
25061,1,shards,2642,0,0,2,2,0.0%,3h
25061,2,Chris,2642,0,0,3,3,0.0%,3h
25082,1,[4WG]Monkey,2641,1501,206,205,411,50.1%,1h
25082,2,THELUX,2641,1440,203,195,398,51.0%,42m
25082,3,platonsio,2641,1465,199,198,397,50.1%,10m
25082,1,Davovp,2641,1560,105,107,212,49.5%,1h
25082,1,Boneless,2641,1367,65,44,109,59.6%,28m
25082,1,Anthares,2641,1270,60,50,110,54.5%,3h
25082,3,jollyrancher,2641,1154,55,47,102,53.9%,20m
25082,3,TerranGT,2641,1181,44,49,93,47.3%,21m
25082,1,Earlsling,2641,499,22,17,39,56.4%,54m
25082,1,[Recall]Vonix,2641,552,21,17,38,55.3%,4m
25082,1,matthew,2641,648,21,22,43,48.8%,6m
25082,3,Gangster,2641,526,18,24,42,42.9%,42m
25082,3,XXDONOBANXX,2641,470,17,20,37,45.9%,21m
25082,3,[TPGGXD]Bazuca,2641,453,15,17,32,46.9%,33m
25082,3,[Jok3r]Banksy,2641,358,11,21,32,34.4%,34m
25082,1,Matt,2641,253,9,5,14,64.3%,1h
25082,1,YOSHI,2641,228,8,8,16,50.0%,26m
25082,1,bonannaman,2641,260,8,8,16,50.0%,3h
25082,1,[FMX]Pupetas,2641,159,6,1,7,85.7%,3h
25082,3,[En3rgy]NotSuspicous,2641,186,5,4,9,55.6%,3h
25082,1,[PaNZR]Fwutter,2641,168,5,9,14,35.7%,3h
25082,1,Rafa,2641,137,4,2,6,66.7%,53m
25082,1,HeroStyle,2641,171,4,4,8,50.0%,3h
25082,1,[BChick]raynorlou,2641,40,2,2,4,50.0%,6m
25082,1,[Trlp0d]Evindris,2641,0,1,5,6,16.7%,3h
25082,1,LeBronzeAims,2641,0,0,1,1,0.0%,10m
25082,2,Mugg,2641,0,0,1,1,0.0%,3h
25082,1,MulletBill,2641,0,0,1,1,0.0%,2h
25110,1,[UWISH]GrewalB,2640,1386,112,97,209,53.6%,1h
25110,3,Paosds,2640,1049,64,53,117,54.7%,23m
25110,3,[TTKOPF]Blitzkrieg,2640,1171,53,56,109,48.6%,38m
25110,1,[Ozzie]Lotherien,2640,593,49,43,92,53.3%,53m
25110,1,Killerfridge,2640,468,21,13,34,61.8%,54m
25110,2,wren,2640,460,19,22,41,46.3%,16m
25110,2,jiminlee,2640,584,19,33,52,36.5%,18m
25110,2,zdyx,2640,408,14,25,39,35.9%,31m
25110,3,[VLQL]Quebexico,2640,333,12,16,28,42.9%,26m
25110,1,[TFJz]Hina,2640,184,9,10,19,47.4%,30m
25110,1,[Idkfu]DrinkWater,2640,247,8,7,15,53.3%,3h
25110,2,[CRolls]box,2640,217,7,0,7,100.0%,1h
25110,1,Farsgull,2640,237,7,5,12,58.3%,3h
25110,3,Destroya,2640,210,7,6,13,53.8%,1h
25110,2,HAL,2640,138,6,4,10,60.0%,2h
25110,2,Lua,2640,128,5,1,6,83.3%,3h
25110,1,Runic,2640,198,5,4,9,55.6%,55m
25110,2,MOTHER,2640,141,5,7,12,41.7%,1h
25110,3,Hinekan,2640,169,5,10,15,33.3%,41m
25110,1,SleepyJoe,2640,104,4,5,9,44.4%,1h
25110,1,GhostRunner,2640,126,4,5,9,44.4%,13m
25110,3,Anialater,2640,0,3,2,5,60.0%,3h
25110,1,kyle,2640,89,3,3,6,50.0%,1h
25110,3,googlypoo,2640,0,2,2,4,50.0%,1h
25110,1,CCLATE,2640,0,2,3,5,40.0%,3h
25110,1,[LOHs]ErwOfHedeby,2640,0,1,0,1,100.0%,3h
25110,3,reefes,2640,0,1,0,1,100.0%,1h
25110,1,[cl0udM]xBallsDeepx,2640,38,1,2,3,33.3%,15m
25110,2,zzxb,2640,0,0,1,1,0.0%,27m
25139,1,[PUPUS]Doom,2639,1468,108,103,211,51.2%,3h
25139,3,Garol,2639,939,38,41,79,48.1%,32m
25139,3,Branzi,2639,803,34,36,70,48.6%,26m
25139,3,Benji,2639,760,28,29,57,49.1%,21m
25139,1,pewpewpew,2639,660,26,20,46,56.5%,4m
25139,1,Jerk,2639,314,21,24,45,46.7%,6m
25139,1,[dIabR0]DeathKnight,2639,628,19,20,39,48.7%,32m
25139,3,WhiteLie,2639,494,18,20,38,47.4%,28m
25139,1,Random,2639,377,17,13,30,56.7%,7m
25139,1,[lLiTl]Maykoto,2639,409,16,15,31,51.6%,7m
25139,3,[PWNDya]RajaSonu,2639,300,10,16,26,38.5%,29m
25139,1,Mercury,2639,223,8,6,14,57.1%,58m
25139,1,[GnR]Hatchery,2639,200,6,7,13,46.2%,55m
25139,3,ZerVencedor,2639,168,6,8,14,42.9%,31m
25139,2,KhAnN,2639,180,5,4,9,55.6%,1h
25139,2,[WAGWAN]NYAAEHHH,2639,0,3,2,5,60.0%,1h
25139,1,Hayles,2639,76,3,3,6,50.0%,3h
25139,1,StormzBG,2639,108,3,5,8,37.5%,3h
25139,1,Tenseigan,2639,122,3,9,12,25.0%,3h
25139,2,Mache,2639,36,2,0,2,100.0%,3h
25139,1,Jericho,2639,44,2,2,4,50.0%,59m
25139,2,Leon,2639,0,2,3,5,40.0%,3h
25139,2,Aerun,2639,0,2,3,5,40.0%,3h
25139,2,UDeadYeah,2639,0,1,0,1,100.0%,3h
25139,1,Korky,2639,30,1,2,3,33.3%,10m
25139,3,CompasionTdT,2639,30,1,8,9,11.1%,20m
25139,2,Skywalker,2639,0,0,1,1,0.0%,44m
25139,1,TheBetterKKu,2639,0,0,1,1,0.0%,3h
25167,1,[LOHd]pablortizc,2638,1712,145,139,284,51.1%,1h
25167,3,KingWarDog,2638,1591,144,129,273,52.7%,18m
25167,3,[YKJK]UNizillian,2638,1363,124,122,246,50.4%,18m
25167,3,Ruckus,2638,1558,79,87,166,47.6%,36m
25167,3,Androbot,2638,431,72,71,143,50.3%,4m
25167,3,Jose,2638,948,63,67,130,48.5%,5m
25167,3,malibu,2638,964,55,57,112,49.1%,10m
25167,1,ALexito,2638,1234,49,41,90,54.4%,53m
25167,1,[gLk]SerGovna,2638,549,23,18,41,56.1%,4m
25167,3,CARLOSDUTY,2638,357,22,25,47,46.8%,4m
25167,1,[SP1622]SuperPenguin,2638,538,20,15,35,57.1%,1h
25167,1,PEDROLANE,2638,420,17,14,31,54.8%,3h
25167,1,SkyTuna,2638,360,15,16,31,48.4%,3h
25167,1,yChewy,2638,294,12,9,21,57.1%,1h
25167,1,[OTWAG]RectSqG,2638,407,12,10,22,54.5%,42m
25167,3,uglykid,2638,320,10,18,28,35.7%,4m
25167,1,winning,2638,290,9,10,19,47.4%,12m
25167,2,haiLIFE,2638,204,8,3,11,72.7%,15m
25167,2,MajorRichy,2638,166,8,8,16,50.0%,3h
25167,1,[GCells]TiTaN,2638,177,6,7,13,46.2%,3h
25167,2,Busters,2638,157,5,0,5,100.0%,3h
25167,1,Groovy,2638,144,5,6,11,45.5%,34m
25167,2,KWRJRTYI,2638,132,3,1,4,75.0%,2h
25167,1,Flavor,2638,132,3,2,5,60.0%,36m
25167,2,TrumpLost,2638,151,3,5,8,37.5%,1h
25167,2,[IVVVI]LazerSquid,2638,30,2,0,2,100.0%,3h
25167,3,FEAR,2638,0,2,1,3,66.7%,28m
25167,3,Kusanagi,2638,0,2,1,3,66.7%,1h
25167,2,Emilio,2638,0,2,3,5,40.0%,3h
25167,2,DerpyFappton,2638,0,2,3,5,40.0%,33m
25167,1,[sffssf]Skerelechuga,2638,74,2,6,8,25.0%,56m
25167,3,[LHDSC]cdml,2638,0,1,0,1,100.0%,1h
25167,2,[Con3s]Jibman,2638,30,1,1,2,50.0%,1h
25167,1,sleep,2638,0,1,2,3,33.3%,3h
25167,1,AAAAAAAAAAAH,2638,30,1,2,3,33.3%,3h
25167,1,lime,2638,44,1,2,3,33.3%,3h
25167,2,Lycog,2638,0,0,1,1,0.0%,1h
25167,1,[imN0ob]LgdOscurO,2638,0,0,2,2,0.0%,3h
25205,1,apetrooper,2637,1653,119,116,235,50.6%,1h
25205,1,[Wienie]datskat,2637,1700,83,75,158,52.5%,49m
25205,1,JoJotaro,2637,1716,80,55,135,59.3%,3h
25205,1,[ExcIgN]Psychology,2637,1361,64,41,105,61.0%,50m
25205,1,Microangelo,2637,1043,39,49,88,44.3%,14m
25205,1,Kossack,2637,1014,36,33,69,52.2%,53m
25205,1,Halucar,2637,947,32,50,82,39.0%,37m
25205,1,[Fellaz]BigHeadTTV,2637,764,27,26,53,50.9%,10m
25205,1,Tuberculosis,2637,620,26,23,49,53.1%,32m
25205,1,Toastey,2637,685,26,25,51,51.0%,3h
25205,1,[TWITS]TrianglePi,2637,481,21,11,32,65.6%,10m
25205,2,SeriousGoose,2637,620,20,39,59,33.9%,43m
25205,1,LeonID,2637,370,18,7,25,72.0%,14m
25205,1,Greygoo,2637,479,16,12,28,57.1%,12m
25205,2,Tornor,2637,345,15,5,20,75.0%,27m
25205,3,Avatuar,2637,400,15,16,31,48.4%,31m
25205,3,Chrono,2637,332,13,14,27,48.1%,29m
25205,1,[BlTEL]masterlol,2637,336,9,9,18,50.0%,3h
25205,2,bdawgsterr,2637,274,9,15,24,37.5%,15m
25205,1,ZestisBest,2637,229,8,5,13,61.5%,3h
25205,1,[XZEROX]dotchasvback,2637,215,7,4,11,63.6%,32m
25205,2,Flower,2637,183,6,5,11,54.5%,34m
25205,2,WiseVersed,2637,141,5,6,11,45.5%,3h
25205,2,[xEx]OpTIMaL,2637,0,3,3,6,50.0%,3h
25205,1,Marogan,2637,30,3,4,7,42.9%,1h
25205,2,kentaurus,2637,34,3,4,7,42.9%,50m
25205,3,IIIIIIIIIIII,2637,0,2,3,5,40.0%,3h
25205,2,Domlaz,2637,0,2,3,5,40.0%,3h
25205,2,DarkProudhon,2637,0,2,3,5,40.0%,38m
25205,2,Lemon,2637,0,2,3,5,40.0%,3h
25205,3,UltraLaser,2637,0,2,4,6,33.3%,18m
25205,2,shindofusi,2637,0,1,0,1,100.0%,3h
25205,2,[EtVoy]GGboy,2637,0,1,0,1,100.0%,15m
25205,1,Jynsin,2637,32,1,2,3,33.3%,1h
25205,2,Jeffji,2637,0,0,1,1,0.0%,1h
25205,2,[TZOOB]Duckyson,2637,0,0,1,1,0.0%,1h
25205,2,Minecraft,2637,0,0,1,1,0.0%,3h
25205,1,Elryu,2637,0,0,2,2,0.0%,50m
25205,1,OwnerShip,2637,0,0,2,2,0.0%,3h
25244,3,Splerch,2636,501,146,124,270,54.1%,5m
25244,1,IWantoBeliev,2636,1413,103,111,214,48.1%,38m
25244,3,MartR,2636,1216,99,80,179,55.3%,20m
25244,2,DeltaForce,2636,1500,60,74,134,44.8%,8m
25244,3,TaiNiWang,2636,211,37,37,74,50.0%,9m
25244,3,nomanchezbol,2636,739,36,37,73,49.3%,23m
25244,3,[GnR]Syblix,2636,655,28,23,51,54.9%,36m
25244,1,[LOHs]VashTzP,2636,700,23,20,43,53.5%,12m
25244,2,RuloX,2636,594,22,34,56,39.3%,12m
25244,3,[RePlz]Stratus,2636,520,21,23,44,47.7%,43m
25244,1,Blacknight,2636,443,20,13,33,60.6%,49m
25244,1,NoMad,2636,374,20,21,41,48.8%,3h
25244,2,AmigoZargon,2636,554,20,23,43,46.5%,40m
25244,1,Caboose,2636,518,16,18,34,47.1%,3h
25244,2,MikeChicken,2636,348,13,8,21,61.9%,5m
25244,2,Fluxation,2636,284,11,15,26,42.3%,19m
25244,1,[MasiYa]Othello,2636,304,10,9,19,52.6%,60m
25244,1,Vacun,2636,326,9,12,21,42.9%,38m
25244,2,Ianwick,2636,120,5,2,7,71.4%,58m
25244,3,[Konijn]WinstonSmith,2636,143,5,3,8,62.5%,22m
25244,1,KingBob,2636,195,5,11,16,31.2%,8m
25244,1,SmartAsp,2636,104,4,5,9,44.4%,53m
25244,3,osyris,2636,144,4,5,9,44.4%,5m
25244,2,[V0R]reasOn,2636,64,3,1,4,75.0%,49m
25244,3,Destonakus,2636,0,3,2,5,60.0%,3h
25244,1,Fortesque,2636,34,3,4,7,42.9%,10m
25244,1,[EvilCC]EDUARS,2636,104,3,4,7,42.9%,50m
25244,1,[xVIPx]nekroslutfvk,2636,78,2,8,10,20.0%,53m
25244,2,[MinzS]Andrene,2636,0,1,0,1,100.0%,1h
25244,2,SeAK,2636,0,0,1,1,0.0%,2h
25244,2,Golbarg,2636,0,0,1,1,0.0%,12m
25244,2,PetrolBomb,2636,0,0,1,1,0.0%,48m
25244,2,Kaetoc,2636,0,0,1,1,0.0%,58m
25244,2,[Colrs]jacob,2636,0,0,1,1,0.0%,3h
25278,3,perpecter,2635,1547,229,227,456,50.2%,30m
25278,3,SmartBeat,2635,1144,191,180,371,51.5%,7m
25278,1,Xyth,2635,1596,128,118,246,52.0%,37m
25278,1,daddykisser,2635,1704,63,65,128,49.2%,54m
25278,3,Hormigarcha,2635,1283,55,52,107,51.4%,18m
25278,1,azumagir,2635,980,40,32,72,55.6%,23m
25278,3,TwoShotsWave,2635,374,31,33,64,48.4%,7m
25278,3,IIIIIIIII,2635,496,22,17,39,56.4%,32m
25278,2,ThePainTrain,2635,421,17,16,33,51.5%,31m
25278,3,cloud,2635,467,16,19,35,45.7%,42m
25278,1,Goose,2635,362,13,10,23,56.5%,48m
25278,3,Vato,2635,281,9,14,23,39.1%,2h
25278,1,NoobKiller,2635,239,7,9,16,43.8%,60m
25278,1,Plat,2635,112,4,5,9,44.4%,1h
25278,1,Matyws,2635,189,4,5,9,44.4%,40m
25278,3,Muffens,2635,100,4,13,17,23.5%,38m
25278,1,SiegfrieD,2635,100,3,6,9,33.3%,32m
25278,1,Formikiere,2635,66,3,8,11,27.3%,3h
25278,3,Shadow,2635,0,2,3,5,40.0%,3h
25278,1,kswebster,2635,106,2,3,5,40.0%,3h
25278,1,CaK,2635,0,2,4,6,33.3%,60m
25278,1,Xito,2635,76,2,7,9,22.2%,12m
25278,3,iron,2635,0,1,0,1,100.0%,53m
25278,2,Aert,2635,30,1,1,2,50.0%,55m
25278,2,tehpwnerer,2635,0,1,4,5,20.0%,31m
25278,1,Gagarmayang,2635,0,1,6,7,14.3%,50m
25278,3,DestroyHats,2635,0,0,1,1,0.0%,22m
25305,2,bmAMbmEM,2634,1452,319,302,621,51.4%,14m
25305,2,mko,2634,1529,216,217,433,49.9%,19m
25305,1,Luiz,2634,1693,206,178,384,53.6%,6m
25305,1,RevolverOce,2634,1715,149,154,303,49.2%,3h
25305,1,zqwar,2634,1152,99,81,180,55.0%,28m
25305,1,PapaDrahgen,2634,1058,47,37,84,56.0%,3h
25305,1,MADARA,2634,901,35,24,59,59.3%,29m
25305,1,karmona,2634,855,31,28,59,52.5%,1h
25305,1,TNT,2634,854,28,25,53,52.8%,3h
25305,2,trNt,2634,451,27,24,51,52.9%,3h
25305,2,wolf,2634,659,26,16,42,61.9%,4m
25305,1,[LQV]BOTOvermind,2634,748,23,25,48,47.9%,6m
25305,1,BBYAmuB,2634,634,21,21,42,50.0%,3h
25305,1,serenitynow,2634,443,19,13,32,59.4%,13m
25305,1,Soultraverse,2634,357,16,14,30,53.3%,12m
25305,1,[NabSad]LeDuK,2634,325,13,15,28,46.4%,3h
25305,3,THCodb,2634,269,11,14,25,44.0%,9m
25305,3,[Pig2]Wizard,2634,244,9,16,25,36.0%,20m
25305,1,[FeAr24]FIRETRUCK,2634,139,7,4,11,63.6%,3h
25305,2,MiniNinja,2634,179,6,5,11,54.5%,3h
25305,1,Shadows,2634,152,5,8,13,38.5%,3h
25305,1,IIIIIIIIIIII,2634,104,4,4,8,50.0%,53m
25305,2,NeurotiCSagA,2634,140,4,5,9,44.4%,1h
25305,1,Willsanity,2634,129,4,6,10,40.0%,53m
25305,1,[5Under]BazookaFist,2634,78,3,4,7,42.9%,50m
25305,1,BoKoR,2634,118,3,5,8,37.5%,53m
25305,3,Magz,2634,0,2,2,4,50.0%,30m
25305,3,kutz,2634,0,2,3,5,40.0%,1h
25305,1,Gtc,2634,38,2,4,6,33.3%,2h
25305,2,sacred,2634,0,0,1,1,0.0%,1h
25305,3,HeresAknife,2634,0,0,3,3,0.0%,41m
25336,1,Washington,2633,1664,168,164,332,50.6%,26m
25336,3,RagingMonkey,2633,1063,112,108,220,50.9%,24m
25336,3,[RIPWoL]gravytrain,2633,1334,78,93,171,45.6%,37m
25336,1,PhilOsophy,2633,1317,73,75,148,49.3%,3h
25336,1,PROTOSAURUS,2633,1609,67,58,125,53.6%,3h
25336,3,IIIIIIIIIIII,2633,586,34,35,69,49.3%,22m
25336,1,[DRKACE]Hayden,2633,537,32,36,68,47.1%,3h
25336,3,BranMan,2633,703,27,31,58,46.6%,31m
25336,1,JohnyUtah,2633,544,15,21,36,41.7%,25m
25336,2,[TFNG]Shinigami,2633,258,8,24,32,25.0%,11m
25336,1,AethersHill,2633,215,7,9,16,43.8%,43m
25336,1,Ferrox,2633,212,7,9,16,43.8%,1h
25336,1,[0PGC0]Setgio,2633,186,6,6,12,50.0%,1h
25336,1,monkeyfeces,2633,165,5,4,9,55.6%,56m
25336,2,[PneqNP]xSUPERGLUEx,2633,118,3,1,4,75.0%,1h
25336,3,Daltonius,2633,0,3,2,5,60.0%,36m
25336,2,[TGosuC]Kind,2633,145,3,2,5,60.0%,3h
25336,3,fCFiRE,2633,0,2,3,5,40.0%,20m
25336,3,DeLuxe,2633,0,2,3,5,40.0%,1h
25336,2,[Sh33r]SeamyComic,2633,0,0,1,1,0.0%,1h
25336,2,Daddypooch,2633,0,0,1,1,0.0%,1h
25357,1,[QcScT]jayneral,2632,1693,144,140,284,50.7%,3h
25357,1,maize,2632,1499,57,53,110,51.8%,6m
25357,1,Barthim,2632,269,52,38,90,57.8%,32m
25357,1,airviper,2632,979,39,27,66,59.1%,48m
25357,1,PolloÉpico,2632,400,32,30,62,51.6%,3h
25357,2,[Galley]Atticade,2632,852,31,31,62,50.0%,3h
25357,2,Oscillator,2632,619,25,27,52,48.1%,43m
25357,1,nigz,2632,644,21,17,38,55.3%,48m
25357,1,Waffle,2632,581,19,17,36,52.8%,1h
25357,3,DarkCloud,2632,510,18,22,40,45.0%,41m
25357,1,itpanda,2632,486,16,20,36,44.4%,52m
25357,1,[GpoABX]Poseidón,2632,404,14,10,24,58.3%,4m
25357,3,Reverberate,2632,362,14,16,30,46.7%,34m
25357,1,Dobbstar,2632,480,14,17,31,45.2%,59m
25357,1,Jerry,2632,335,12,12,24,50.0%,32m
25357,1,BakingBlazed,2632,248,7,6,13,53.8%,3h
25357,2,[ssexxy]Covaena,2632,186,6,1,7,85.7%,22m
25357,1,Virtual,2632,174,6,5,11,54.5%,30m
25357,1,[PINGON]pavipollo,2632,204,6,9,15,40.0%,15m
25357,2,AGoldenKey,2632,94,2,2,4,50.0%,3h
25357,3,MoonUnit,2632,0,2,3,5,40.0%,59m
25357,2,iwllyu,2632,0,2,3,5,40.0%,38m
25357,2,[TMTFH]LesTron,2632,0,1,0,1,100.0%,3h
25357,1,HunterBiden,2632,0,1,3,4,25.0%,1h
25357,1,cbSugar,2632,34,1,3,4,25.0%,1h
25357,2,[YEEP]McD,2632,0,0,1,1,0.0%,17m
25357,2,AxaxaxasMlo,2632,0,0,1,1,0.0%,3h
25384,1,Maverik,2631,1609,207,210,417,49.6%,48m
25384,3,RamitaRVG,2631,1569,191,180,371,51.5%,5m
25384,1,[Fghij]otroperuvian,2631,1572,113,99,212,53.3%,3h
25384,1,Maeioo,2631,1399,93,96,189,49.2%,40m
25384,3,noizyBOY,2631,980,72,78,150,48.0%,42m
25384,3,Null,2631,961,45,44,89,50.6%,42m
25384,3,ispirit,2631,608,27,32,59,45.8%,38m
25384,3,byden,2631,662,26,29,55,47.3%,9m
25384,1,Hurley,2631,356,13,10,23,56.5%,3h
25384,2,Altecman,2631,224,10,5,15,66.7%,3h
25384,1,[GØSU]Cov,2631,331,10,8,18,55.6%,3h
25384,1,[Hazed]shoota,2631,348,10,13,23,43.5%,53m
25384,1,les,2631,194,7,8,15,46.7%,3h
25384,1,[lHMNGl]SCmenace,2631,220,6,12,18,33.3%,3h
25384,2,cloud,2631,148,4,5,9,44.4%,1h
25384,3,TopFossa,2631,0,3,3,6,50.0%,4m
25384,1,DHFiveAlpha,2631,0,3,4,7,42.9%,3h
25384,3,jetonosfat,2631,0,2,3,5,40.0%,1h
25384,3,[URSS07]JHIMMY,2631,0,2,3,5,40.0%,1h
25384,2,Kenshi,2631,118,2,8,10,20.0%,1h
25384,2,[GGBr0]ACNS,2631,0,1,0,1,100.0%,3h
25384,2,Littlerob,2631,0,1,0,1,100.0%,49m
25384,3,Kairos,2631,30,1,4,5,20.0%,41m
25384,1,Zippri,2631,40,1,4,5,20.0%,3h
25384,2,xzluisxz,2631,0,0,1,1,0.0%,1h
25384,2,IvanCM,2631,0,0,1,1,0.0%,3h
25384,2,Bassman,2631,0,0,1,1,0.0%,3h
25411,3,Zeus,2630,1480,167,160,327,51.1%,37m
25411,1,BluddFlagg,2630,1392,106,93,199,53.3%,3h
25411,3,DÆTH,2630,1545,87,83,170,51.2%,26m
25411,1,lowtone,2630,715,28,21,49,57.1%,3h
25411,1,Ether,2630,539,25,20,45,55.6%,23m
25411,3,McSpankyyy,2630,574,22,28,50,44.0%,14m
25411,1,[MGD2]Truthist,2630,510,16,19,35,45.7%,3h
25411,2,MEGANOOB,2630,341,14,14,28,50.0%,3h
25411,1,Barry,2630,209,9,3,12,75.0%,12m
25411,3,[TChamp]HeroHawk,2630,196,9,9,18,50.0%,41m
25411,3,HipHopotamus,2630,190,7,16,23,30.4%,38m
25411,3,Shuriken,2630,170,6,8,14,42.9%,5m
25411,3,ekrmqk,2630,144,5,6,11,45.5%,12m
25411,2,McLamb,2630,132,5,7,12,41.7%,3h
25411,3,Torn,2630,0,3,2,5,60.0%,31m
25411,2,shibe,2630,80,2,2,4,50.0%,3h
25411,1,[HØST]NyKoN,2630,105,2,2,4,50.0%,35m
25411,1,fenz,2630,76,2,5,7,28.6%,3h
25411,2,Fireworks,2630,0,1,0,1,100.0%,3h
25411,2,[DyZerO]portotec,2630,0,0,1,1,0.0%,3h
25411,3,Swarm,2630,0,0,1,1,0.0%,19m
25432,3,sobietrice,2629,1495,236,230,466,50.6%,20m
25432,1,Bloator,2629,1637,234,231,465,50.3%,32m
25432,1,camper,2629,1428,59,57,116,50.9%,1h
25432,1,[Sc9Maf]PeeFace,2629,1047,39,42,81,48.1%,51m
25432,1,bagner,2629,298,13,12,25,52.0%,1h
25432,1,eidolon,2629,342,11,8,19,57.9%,1h
25432,3,shrimpslushi,2629,254,10,10,20,50.0%,51m
25432,1,[SCDs]KingKrypton,2629,306,9,12,21,42.9%,25m
25432,2,AnnaMolli,2629,265,8,7,15,53.3%,1h
25432,1,Lucius,2629,187,7,5,12,58.3%,3h
25432,1,Fantinatti,2629,270,6,10,16,37.5%,3h
25432,2,Imperator,2629,92,3,2,5,60.0%,1h
25432,1,boutreefiddy,2629,74,3,3,6,50.0%,29m
25432,2,MrowdnaS,2629,0,3,5,8,37.5%,16m
25432,1,[Lupus]Ituralde,2629,0,1,1,2,50.0%,49m
25432,2,Pepperoni,2629,0,1,3,4,25.0%,33m
25432,2,Avatarmike,2629,46,1,4,5,20.0%,3h
25449,3,Dreadnaught,2628,1584,207,205,412,50.2%,41m
25449,3,Scarface,2628,1439,138,135,273,50.5%,29m
25449,1,Mike,2628,1664,84,81,165,50.9%,1h
25449,2,FACHO,2628,1253,77,52,129,59.7%,3h
25449,1,MiamiThrice,2628,1289,77,69,146,52.7%,1h
25449,1,NOBODY,2628,747,30,25,55,54.5%,53m
25449,3,VonBergen,2628,615,29,36,65,44.6%,38m
25449,2,nebwae,2628,635,26,17,43,60.5%,1h
25449,1,Alekazam,2628,575,20,21,41,48.8%,1h
25449,1,LooneyToon,2628,433,15,11,26,57.7%,16m
25449,2,igorallycatz,2628,199,11,26,37,29.7%,14m
25449,1,[ExcIgN]Yanzo,2628,308,9,10,19,47.4%,1h
25449,1,primes,2628,126,5,6,11,45.5%,1h
25449,2,toofattotype,2628,58,5,9,14,35.7%,28m
25449,2,cCopycaTt,2628,118,4,4,8,50.0%,1h
25449,2,Greatgarius,2628,138,4,5,9,44.4%,30m
25449,2,[1vsM]COOL,2628,92,3,3,6,50.0%,1h
25449,1,Trump,2628,74,3,4,7,42.9%,59m
25449,2,scameehr,2628,42,3,5,8,37.5%,42m
25449,1,[NoL1fe]AlanK,2628,95,3,5,8,37.5%,3h
25449,1,Mikazuki,2628,68,3,6,9,33.3%,29m
25449,3,[WWG]CHAOJIWUDI,2628,0,2,3,5,40.0%,59m
25449,3,Octobot,2628,0,2,3,5,40.0%,38m
25449,1,Prontier,2628,96,2,10,12,16.7%,55m
25449,2,silvanator,2628,0,1,0,1,100.0%,5m
25449,2,Piipoz,2628,0,1,0,1,100.0%,37m
25449,1,Kyler,2628,96,1,2,3,33.3%,1h
25449,1,Nando,2628,93,1,2,3,33.3%,42m
25449,2,[SOLNEM]SolNemesis,2628,0,0,1,1,0.0%,26m
25449,2,RavenHex,2628,0,0,1,1,0.0%,26m
25449,2,ALQuinder,2628,0,0,1,1,0.0%,1h
25449,1,Bertuswonkel,2628,0,0,2,2,0.0%,1h
25449,1,Vibram,2628,0,0,2,2,0.0%,29m
25449,2,zeesismepact,2628,0,0,2,2,0.0%,3h
25449,3,[STBA]Mojo,2628,0,0,5,5,0.0%,3h
25484,1,lampasas,2627,1674,190,185,375,50.7%,50m
25484,1,mariboul,2627,964,122,116,238,51.3%,4m
25484,3,lizardace,2627,1448,91,71,162,56.2%,26m
25484,1,friedtoad,2627,445,72,56,128,56.2%,2h
25484,1,Wendigo,2627,1466,57,55,112,50.9%,14m
25484,3,siremort,2627,1195,55,63,118,46.6%,32m
25484,1,Hazard,2627,302,35,31,66,53.0%,50m
25484,1,Bulgar,2627,709,33,29,62,53.2%,6m
25484,3,Glimmers,2627,519,29,28,57,50.9%,6m
25484,1,CucbkaCapbI,2627,540,21,19,40,52.5%,55m
25484,1,[GeekA]Oconor,2627,576,18,18,36,50.0%,3h
25484,3,dacker,2627,251,16,20,36,44.4%,30m
25484,3,[Jerkz]freshkeeper,2627,424,15,22,37,40.5%,21m
25484,2,[N0BLE]Astrostrike,2627,323,13,8,21,61.9%,1h
25484,1,WolfSavage,2627,278,10,6,16,62.5%,22m
25484,1,Dora,2627,301,10,13,23,43.5%,36m
25484,2,[RLRC]BreaktheSky,2627,232,8,3,11,72.7%,3h
25484,3,matareynor,2627,286,8,14,22,36.4%,19m
25484,3,[Alarak]Nurrdeer,2627,92,7,7,14,50.0%,16m
25484,2,LearnTerran,2627,204,6,5,11,54.5%,60m
25484,1,MattJR,2627,114,4,5,9,44.4%,1h
25484,1,DeMindcast,2627,239,4,7,11,36.4%,55m
25484,1,[LimaSC]blood,2627,116,3,6,9,33.3%,22m
25484,1,amVaquero,2627,88,2,1,3,66.7%,4m
25484,1,[JUGOS]sahid,2627,38,2,2,4,50.0%,3h
25484,1,[LY]LionHeart,2627,44,2,3,5,40.0%,37m
25484,1,PoCoYo,2627,76,2,7,9,22.2%,3h
25484,2,[DMONlC]DEMONIC,2627,0,1,0,1,100.0%,3h
25484,1,[Star4s]AzureNexusC,2627,91,1,2,3,33.3%,51m
25484,1,prometheus,2627,36,1,3,4,25.0%,1h
25484,2,CaptanRaynor,2627,0,0,1,1,0.0%,50m
25484,2,[Atena]NaHueL,2627,0,0,2,2,0.0%,3h
25484,1,SnThanos,2627,0,0,4,4,0.0%,3h
25517,3,Seansand,2626,1536,237,236,473,50.1%,37m
25517,1,[dede]Mueksi,2626,1544,79,63,142,55.6%,38m
25517,2,Cyberfire,2626,1471,59,46,105,56.2%,34m
25517,1,[Ex7rA]LEO,2626,1349,54,44,98,55.1%,31m
25517,1,[SDr]NuTak,2626,1304,49,48,97,50.5%,4m
25517,3,HugoHAO,2626,718,24,34,58,41.4%,37m
25517,3,Farmer,2626,650,22,30,52,42.3%,27m
25517,2,Saitake,2626,432,15,10,25,60.0%,3h
25517,1,Lionheart,2626,295,11,6,17,64.7%,1h
25517,1,blandboss,2626,300,11,8,19,57.9%,32m
25517,2,Cosmicraider,2626,270,9,13,22,40.9%,1h
25517,1,BUGLIFE,2626,234,7,10,17,41.2%,3h
25517,1,[Z4TS]Evanator,2626,137,5,2,7,71.4%,36m
25517,2,[haZe]CatSniper,2626,129,5,5,10,50.0%,3h
25517,1,[Gooons]lumberjack,2626,156,5,6,11,45.5%,23m
25517,3,Evolanche,2626,145,5,14,19,26.3%,30m
25517,2,SKI,2626,60,4,4,8,50.0%,31m
25517,1,bigPenzor,2626,48,4,6,10,40.0%,58m
25517,1,Asari,2626,108,3,5,8,37.5%,3h
25517,1,gabriel,2626,92,3,5,8,37.5%,1h
25517,2,Arlt,2626,94,3,5,8,37.5%,3h
25517,1,Population,2626,0,2,4,6,33.3%,25m
25517,3,Max,2626,0,1,0,1,100.0%,29m
25517,2,[diaman]DjembZone,2626,0,0,1,1,0.0%,37m
25517,2,Pyro,2626,0,0,1,1,0.0%,38m
25517,1,Solarity,2626,0,0,2,2,0.0%,15m
25517,1,RushGamingTV,2626,0,0,2,2,0.0%,23m
25544,1,Thaarb,2625,1734,265,255,520,51.0%,1h
25544,1,pinoyboi,2625,1705,134,132,266,50.4%,12m
25544,1,soltero,2625,1344,97,70,167,58.1%,3h
25544,1,PewPew,2625,1618,91,83,174,52.3%,3h
25544,2,Minimus,2625,920,67,76,143,46.9%,20m
25544,1,[Lpaz]XaviiH,2625,1103,48,39,87,55.2%,48m
25544,3,AndroideSix,2625,1231,48,49,97,49.5%,36m
25544,3,[Parry]FeedAndLeave,2625,634,24,27,51,47.1%,21m
25544,2,TotoKaMiKaZe,2625,390,18,12,30,60.0%,3h
25544,1,[FTails]Warrenator,2625,498,18,18,36,50.0%,31m
25544,1,Orzo,2625,329,15,14,29,51.7%,3h
25544,1,notBlackHaze,2625,395,14,15,29,48.3%,4m
25544,1,jackdaddy,2625,208,5,5,10,50.0%,4m
25544,3,Father,2625,157,4,13,17,23.5%,24m
25544,2,Superslimey,2625,30,2,1,3,66.7%,58m
25544,1,[XWM]Zenod,2625,42,2,2,4,50.0%,56m
25544,2,silvio,2625,93,2,2,4,50.0%,15m
25544,2,SirWallace,2625,0,2,3,5,40.0%,58m
25544,3,[FDSC]WkCof,2625,40,2,4,6,33.3%,47m
25544,1,VelvetViper,2625,78,2,4,6,33.3%,1h
25544,3,WuTang,2625,38,2,5,7,28.6%,57m
25544,2,[asco]Ritter,2625,0,1,0,1,100.0%,3h
25544,2,HOWARD,2625,0,0,1,1,0.0%,26m
25544,2,[MyWs]BoomSS,2625,0,0,1,1,0.0%,3h
25568,1,[Epokhé]grosso,2624,1692,162,146,308,52.6%,4m
25568,3,Mycah,2624,827,124,123,247,50.2%,10m
25568,1,Blackshape,2624,1689,78,68,146,53.4%,28m
25568,3,BeKindRewind,2624,621,69,65,134,51.5%,32m
25568,1,Shagon,2624,1122,48,37,85,56.5%,7m
25568,2,TheZonaBliz,2624,746,36,14,50,72.0%,33m
25568,2,LDYZnGENTLMN,2624,871,35,33,68,51.5%,37m
25568,3,Mark,2624,626,23,31,54,42.6%,23m
25568,2,tmoss,2624,436,16,13,29,55.2%,1h
25568,1,supirionxD,2624,225,9,9,18,50.0%,55m
25568,1,gambitmonk,2624,253,8,9,17,47.1%,37m
25568,3,JCookie,2624,271,8,13,21,38.1%,4m
25568,1,Rawksarz,2624,282,7,9,16,43.8%,3h
25568,1,EvilHR,2624,187,6,3,9,66.7%,1h
25568,1,oZi,2624,147,4,2,6,66.7%,1h
25568,1,JOTE,2624,0,4,2,6,66.7%,3h
25568,1,[tCo9]Kindred,2624,177,4,4,8,50.0%,32m
25568,3,nzAbyssal,2624,78,4,4,8,50.0%,33m
25568,3,[S0O]FIREGROUND,2624,144,3,2,5,60.0%,3h
25568,1,TehMack,2624,135,3,3,6,50.0%,15m
25568,2,EDHUNTER,2624,0,3,3,6,50.0%,1h
25568,1,Addamere,2624,70,3,4,7,42.9%,1h
25568,1,Koop,2624,144,3,8,11,27.3%,10m
25568,1,tiloupbine,2624,115,2,3,5,40.0%,1h
25568,1,[DarkLS]SLimE,2624,36,2,4,6,33.3%,1h
25568,3,erteymas,2624,0,2,4,6,33.3%,1h
25568,1,Edmaester,2624,42,2,6,8,25.0%,1h
25568,2,ChaosTheory,2624,0,0,1,1,0.0%,4m
25568,2,CramblCram,2624,0,0,1,1,0.0%,1h
25568,3,Darkfurios,2624,0,0,1,1,0.0%,3h
25568,2,dragoon,2624,0,0,1,1,0.0%,31m
25568,1,too,2624,0,0,2,2,0.0%,1h
25600,2,Don,2623,1512,196,205,401,48.9%,33m
25600,2,Gpro,2623,1382,81,63,144,56.2%,1h
25600,1,[XpKAc]AxelWolf,2623,445,37,21,58,63.8%,1h
25600,1,[ConFed]gerdel,2623,972,36,42,78,46.2%,3h
25600,3,JPS,2623,878,31,37,68,45.6%,37m
25600,1,nitram,2623,507,24,17,41,58.5%,29m
25600,1,Mathi,2623,381,18,24,42,42.9%,16m
25600,1,Din,2623,442,12,14,26,46.2%,54m
25600,1,SmrtyCakes,2623,307,10,10,20,50.0%,3h
25600,1,diddLY,2623,293,9,8,17,52.9%,31m
25600,1,Tachometer,2623,206,7,7,14,50.0%,29m
25600,3,GONZINTEL,2623,58,5,7,12,41.7%,5m
25600,2,[ZTemps]Trixter,2623,150,4,1,5,80.0%,1h
25600,1,neo,2623,137,4,2,6,66.7%,50m
25600,2,misterpipol,2623,30,2,0,2,100.0%,3h
25600,1,sSkiLLBiLLy,2623,18,2,2,4,50.0%,50m
25600,1,JokerPVZ,2623,36,2,2,4,50.0%,3h
25600,3,What,2623,0,2,3,5,40.0%,3h
25600,1,[forces]DeathRaven,2623,78,2,7,9,22.2%,13m
25600,2,zig,2623,0,1,0,1,100.0%,37m
25600,2,MajorWedgie,2623,0,1,0,1,100.0%,27m
25600,2,sharow,2623,46,1,3,4,25.0%,3h
25600,1,Zentenk,2623,0,0,1,1,0.0%,5m
25600,1,FOX,2623,0,0,3,3,0.0%,3h
25600,1,ironstone,2623,0,0,3,3,0.0%,3h
25625,1,DthreeR,2622,1701,203,200,403,50.4%,3h
25625,2,KONG,2622,1597,89,102,191,46.6%,25m
25625,3,Spencer,2622,774,71,61,132,53.8%,22m
25625,2,[FFBP]Stirfryed,2622,374,16,3,19,84.2%,1h
25625,1,Tyrant,2622,344,15,5,20,75.0%,32m
25625,1,PABLOKX,2622,427,15,9,24,62.5%,1h
25625,1,PnZezVrsT,2622,238,15,15,30,50.0%,1h
25625,1,llllllllllll,2622,370,15,16,31,48.4%,32m
25625,1,Pepe,2622,496,15,23,38,39.5%,4m
25625,1,Marco,2622,268,13,11,24,54.2%,3h
25625,1,wolajacy,2622,287,11,10,21,52.4%,37m
25625,2,Tranzige,2622,245,10,7,17,58.8%,1h
25625,1,GrumpyNoob,2622,254,8,10,18,44.4%,3h
25625,1,lRedRaynorl,2622,242,7,10,17,41.2%,1h
25625,2,micpha,2622,58,5,3,8,62.5%,33m
25625,2,SwankyMarine,2622,96,4,1,5,80.0%,49m
25625,2,DeBurd,2622,116,4,2,6,66.7%,3h
25625,1,slinky,2622,66,3,3,6,50.0%,11m
25625,2,ReadyDewy,2622,30,3,3,6,50.0%,1h
25625,2,BigJohnson,2622,153,3,8,11,27.3%,42m
25625,3,[XpKAc]RouSs,2622,119,2,4,6,33.3%,23m
25625,3,Larhar,2622,0,2,5,7,28.6%,4m
25625,2,Dodger,2622,32,1,1,2,50.0%,53m
25625,3,JOSUECURRY,2622,0,1,3,4,25.0%,3h
25625,2,Toastman,2622,0,0,2,2,0.0%,1h
25625,1,Bateman,2622,0,0,2,2,0.0%,3h
25625,1,[MAUF]Glaxy,2622,0,0,3,3,0.0%,50m
25652,2,gnzotarukane,2621,1146,372,352,724,51.4%,20m
25652,2,XavieriuS,2621,830,46,54,100,46.0%,9m
25652,1,[TPGGXD]elTipo,2621,1042,38,37,75,50.7%,3h
25652,1,ZuErobern,2621,569,19,18,37,51.4%,1h
25652,1,PizzatheHut,2621,330,13,8,21,61.9%,53m
25652,1,Guyles,2621,250,10,4,14,71.4%,1h
25652,2,Biorex,2621,291,9,7,16,56.2%,3h
25652,1,[WeDoSC]PepeZero,2621,252,7,8,15,46.7%,3h
25652,2,[YOSHII]GomichiX,2621,179,6,2,8,75.0%,3h
25652,1,Sacreds,2621,175,6,4,10,60.0%,3h
25652,1,DarthRevan,2621,153,5,9,14,35.7%,22m
25652,1,[Tecomi]IRAN,2621,110,4,7,11,36.4%,1h
25652,3,fvelmntnja,2621,38,3,3,6,50.0%,48m
25652,1,ZERG,2621,30,3,4,7,42.9%,60m
25652,2,[rgeKIT]JavaScripter,2621,64,2,3,5,40.0%,38m
25652,2,spadiK,2621,0,2,4,6,33.3%,3h
25652,1,Venom,2621,34,2,6,8,25.0%,32m
25652,2,leogamer,2621,0,1,0,1,100.0%,1h
25652,3,Jose,2621,0,1,3,4,25.0%,3h
25652,2,PermaNoob,2621,0,0,1,1,0.0%,49m
25652,2,Knero,2621,0,0,1,1,0.0%,3h
25652,3,Lightofhope,2621,0,0,1,1,0.0%,1h
25652,2,[sk3tch]qherman,2621,0,0,1,1,0.0%,1h
25652,2,Funcooman,2621,0,0,1,1,0.0%,3h
25652,2,Rembo,2621,0,0,1,1,0.0%,1h
25652,1,Sausage,2621,0,0,2,2,0.0%,22m
25652,2,SkynetII,2621,0,0,2,2,0.0%,31m
25652,1,Kiddeu,2621,0,0,5,5,0.0%,15m
25680,3,[LETAL]pap,2620,1501,258,236,494,52.2%,17m
25680,3,blufalosoldr,2620,1553,200,188,388,51.5%,32m
25680,2,Zartarr,2620,914,198,201,399,49.6%,31m
25680,3,powerhouse,2620,1537,105,102,207,50.7%,40m
25680,1,BenJaMinSiew,2620,1642,74,69,143,51.7%,3h
25680,3,[shnell]HoCkiLLiON,2620,594,31,32,63,49.2%,23m
25680,2,NightKnight,2620,675,29,18,47,61.7%,3h
25680,2,Grif,2620,529,21,9,30,70.0%,3h
25680,1,Ravenknight,2620,398,21,21,42,50.0%,53m
25680,1,JAHAZIEL,2620,611,19,18,37,51.4%,1h
25680,3,HanSolo,2620,409,13,19,32,40.6%,38m
25680,1,KalTar,2620,305,11,10,21,52.4%,7m
25680,3,[LCE]Ferdiablo,2620,305,10,16,26,38.5%,14m
25680,2,BuffetSnail,2620,242,9,9,18,50.0%,33m
25680,2,MMFU,2620,218,8,0,8,100.0%,32m
25680,1,Dibujante,2620,146,8,7,15,53.3%,3h
25680,2,ChiefMaster,2620,154,5,5,10,50.0%,34m
25680,1,erunky,2620,197,5,5,10,50.0%,48m
25680,3,ConsumeWhite,2620,44,3,4,7,42.9%,1h
25680,2,BIOLITE,2620,30,3,4,7,42.9%,1h
25680,2,SMH,2620,30,2,0,2,100.0%,23m
25680,2,SavirNitram,2620,93,2,1,3,66.7%,1h
25680,1,NotBatman,2620,38,2,3,5,40.0%,2h
25680,3,MENACEKIDD,2620,0,2,4,6,33.3%,1h
25680,2,[NexusK]Clockwork,2620,0,1,0,1,100.0%,4m
25680,2,SuperFly,2620,34,1,1,2,50.0%,3h
25680,2,aaa,2620,30,1,2,3,33.3%,3h
25680,2,MrCheese,2620,30,1,2,3,33.3%,1h
25680,1,[LQV]IJGI,2620,34,1,3,4,25.0%,3h
25680,1,Thehardway,2620,36,1,6,7,14.3%,10m
25680,2,Joey,2620,0,0,1,1,0.0%,3h
25680,3,crash,2620,0,0,1,1,0.0%,19m
25680,2,Eko,2620,0,0,1,1,0.0%,1h
25680,2,[Unlike]Shinigamy,2620,0,0,1,1,0.0%,50m
25680,1,JaxR,2620,0,0,2,2,0.0%,15m
25680,1,Analogy,2620,0,0,2,2,0.0%,50m
25680,1,Hydra,2620,0,0,2,2,0.0%,12m
25717,2,Rogerio,2619,1548,286,264,550,52.0%,33m
25717,1,ApparitionX,2619,957,188,174,362,51.9%,38m
25717,3,pabs,2619,794,120,119,239,50.2%,8m
25717,1,FrAnK,2619,1496,115,135,250,46.0%,43m
25717,3,dumpstermike,2619,1335,110,111,221,49.8%,5m
25717,1,BlackZe,2619,1482,68,62,130,52.3%,29m
25717,1,rookie,2619,1574,59,59,118,50.0%,3h
25717,2,nadu,2619,1052,41,36,77,53.2%,27m
25717,1,GreatFaith,2619,470,36,23,59,61.0%,1h
25717,1,Nimrod,2619,415,27,24,51,52.9%,25m
25717,1,reader,2619,674,21,23,44,47.7%,3h
25717,3,ArAgOoX,2619,509,19,28,47,40.4%,37m
25717,1,BabyFace,2619,568,18,25,43,41.9%,3h
25717,2,[ShNK]Striker,2619,311,11,7,18,61.1%,2h
25717,1,TheLastFat,2619,223,10,14,24,41.7%,50m
25717,1,[CANATT]CannonRusher,2619,284,7,11,18,38.9%,3h
25717,1,Saitama,2619,145,5,2,7,71.4%,1h
25717,2,KaiDe,2619,135,5,5,10,50.0%,3h
25717,1,runinmonkey,2619,134,5,8,13,38.5%,1h
25717,3,PHATSATCHEL,2619,0,4,1,5,80.0%,22m
25717,2,PorkJaw,2619,122,4,4,8,50.0%,1h
25717,3,redbaaron,2619,145,4,5,9,44.4%,13m
25717,2,MrWasteland,2619,64,3,0,3,100.0%,18m
25717,2,oldmen,2619,30,2,1,3,66.7%,2h
25717,2,Punisher,2619,0,2,4,6,33.3%,3h
25717,2,[GGxRE]Fetchboris,2619,0,1,0,1,100.0%,37m
25717,2,alex,2619,30,1,1,2,50.0%,2h
25717,1,machine,2619,0,1,2,3,33.3%,25m
25717,1,Celesarn,2619,0,1,2,3,33.3%,2h
25717,2,JoeGreene,2619,0,1,5,6,16.7%,1h
25717,2,[BRWIN]Judgmentgun,2619,0,0,1,1,0.0%,3h
25717,2,Zarbof,2619,0,0,1,1,0.0%,40m
25749,3,[sk3tch]JohnBrown,2618,1557,325,326,651,49.9%,4m
25749,1,[illers]Westend,2618,1384,87,87,174,50.0%,36m
25749,1,Shiro,2618,1389,59,39,98,60.2%,52m
25749,1,Kirino,2618,1420,54,50,104,51.9%,1h
25749,1,[iMpB]Armarus,2618,1253,52,43,95,54.7%,3h
25749,1,[WWWOLV]zendo,2618,374,40,29,69,58.0%,6m
25749,2,omyen,2618,800,32,33,65,49.2%,43m
25749,3,[TGosuA]Basic,2618,462,29,39,68,42.6%,6m
25749,2,QuBuS,2618,442,20,8,28,71.4%,1h
25749,1,SupBoy,2618,494,16,15,31,51.6%,1h
25749,1,Wolfkun,2618,426,16,19,35,45.7%,2h
25749,3,[Leer]MONBO,2618,441,13,19,32,40.6%,9m
25749,1,BillyDaKid,2618,315,12,10,22,54.5%,3h
25749,3,inkybinky,2618,292,11,14,25,44.0%,34m
25749,1,Paton,2618,182,9,25,34,26.5%,16m
25749,2,Hodor,2618,177,7,3,10,70.0%,3h
25749,2,[AMGR]Yomizi,2618,0,2,6,8,25.0%,50m
25749,2,RojasPerex,2618,48,1,2,3,33.3%,60m
25749,2,AnDRU,2618,0,0,1,1,0.0%,33m
25749,2,dragon,2618,0,0,1,1,0.0%,15m
25769,1,McBeasty,2617,1667,151,147,298,50.7%,3h
25769,1,KINDERMALO,2617,1221,74,71,145,51.0%,3h
25769,1,witch,2617,1179,49,34,83,59.0%,10m
25769,2,llIIIllIIIll,2617,847,43,30,73,58.9%,5m
25769,3,SKyTheBorreX,2617,631,24,26,50,48.0%,15m
25769,2,OverlordDave,2617,376,13,24,37,35.1%,10m
25769,1,[DXPCA]PAULOMF,2617,205,9,5,14,64.3%,8m
25769,1,MutniyTony,2617,202,9,7,16,56.2%,55m
25769,1,Xerxes,2617,288,8,11,19,42.1%,3h
25769,1,Ambitions,2617,262,7,8,15,46.7%,16m
25769,1,DaftGemini,2617,228,7,9,16,43.8%,53m
25769,2,FluffyBeans,2617,149,6,5,11,54.5%,1h
25769,1,Refrigerator,2617,121,6,6,12,50.0%,43m
25769,2,gabavelpo,2617,180,6,6,12,50.0%,1h
25769,3,Nixxon,2617,97,5,1,6,83.3%,2h
25769,1,Johec,2617,145,4,2,6,66.7%,22m
25769,2,HunterT,2617,62,3,0,3,100.0%,3h
25769,3,[AFR]Thor,2617,0,3,3,6,50.0%,1h
25769,2,Hukk,2617,118,3,5,8,37.5%,26m
25769,1,Bloodshockk,2617,159,3,5,8,37.5%,58m
25769,2,[limitx]Thot,2617,32,2,1,3,66.7%,43m
25769,3,Diabetes,2617,97,2,1,3,66.7%,1h
25769,2,Tay,2617,0,2,2,4,50.0%,20m
25769,3,SuperKamiG,2617,0,2,3,5,40.0%,54m
25769,3,Madeleine,2617,0,2,3,5,40.0%,1h
25769,2,bing,2617,0,2,3,5,40.0%,3h
25769,1,Drago,2617,72,2,4,6,33.3%,3h
25769,2,kaygee,2617,0,1,0,1,100.0%,1h
25769,2,[salvo]devilhand,2617,30,1,1,2,50.0%,1h
25769,3,[SQHX]SilvShepard,2617,0,1,1,2,50.0%,57m
25769,2,Todor,2617,0,0,1,1,0.0%,1h
25800,2,PigsWarfare,2616,1538,237,221,458,51.7%,3h
25800,3,[FtVk]FightinVikin,2616,1520,209,209,418,50.0%,34m
25800,1,hardflip,2616,1609,188,181,369,50.9%,48m
25800,1,[THDT]WaRMahO,2616,1172,42,45,87,48.3%,58m
25800,2,[2xGNGR]Shoosh,2616,913,40,38,78,51.3%,55m
25800,2,[KhanZ]Buttzilla,2616,1006,40,39,79,50.6%,44m
25800,2,BrotatoChip,2616,665,27,21,48,56.2%,5m
25800,1,dog,2616,262,22,12,34,64.7%,16m
25800,2,NeCkatronic,2616,397,16,17,33,48.5%,1h
25800,1,Gear,2616,336,10,10,20,50.0%,16m
25800,2,Trumptard,2616,244,9,8,17,52.9%,1h
25800,2,spreet,2616,236,9,10,19,47.4%,27m
25800,1,GhostHunter,2616,183,6,5,11,54.5%,1h
25800,2,PetePeterson,2616,102,5,7,12,41.7%,37m
25800,2,Finality,2616,88,4,5,9,44.4%,5m
25800,2,CaptainAFK,2616,124,4,5,9,44.4%,3h
25800,2,IIIIIIIIIIII,2616,118,4,6,10,40.0%,3h
25800,2,MountainYamz,2616,64,3,1,4,75.0%,1h
25800,2,kim,2616,138,3,2,5,60.0%,3h
25800,1,alego,2616,118,3,2,5,60.0%,3h
25800,2,pedrofal,2616,115,2,1,3,66.7%,3h
25800,2,zygzaufuts,2616,0,2,3,5,40.0%,31m
25800,2,Lekstin,2616,0,1,0,1,100.0%,28m
25800,1,Ryon,2616,0,1,1,2,50.0%,3h
25800,2,Ruthlesswolf,2616,0,1,2,3,33.3%,3h
25800,1,jack,2616,32,1,4,5,20.0%,36m
25800,2,Yalos,2616,0,1,4,5,20.0%,18m
25800,2,[xHHx]Canuck,2616,0,0,1,1,0.0%,1h
25800,2,EinsZweiWiFi,2616,0,0,1,1,0.0%,3h
25800,2,[NoBads]NepeGigante,2616,0,0,1,1,0.0%,1h
25830,1,TonyDiEmidio,2615,978,92,85,177,52.0%,48m
25830,1,Qdi,2615,1169,77,66,143,53.8%,59m
25830,1,aceWeed,2615,973,45,60,105,42.9%,23m
25830,2,Zeke,2615,852,36,27,63,57.1%,3h
25830,2,FAC,2615,709,31,16,47,66.0%,5m
25830,1,Steve,2615,652,28,23,51,54.9%,59m
25830,1,[EcoWar]Bronath,2615,675,26,20,46,56.5%,16m
25830,1,[Sune]UYOS,2615,599,21,21,42,50.0%,14m
25830,1,Lgedzmitry,2615,271,20,23,43,46.5%,15m
25830,3,TiltedRedMan,2615,362,16,21,37,43.2%,19m
25830,1,SuperNinja,2615,534,15,16,31,48.4%,42m
25830,2,[LitllR]LitlleRabbit,2615,391,13,11,24,54.2%,5m
25830,1,Avalanche,2615,278,12,11,23,52.2%,40m
25830,1,SCIIPolice,2615,308,9,14,23,39.1%,48m
25830,3,Ichigo,2615,295,8,15,23,34.8%,15m
25830,1,Ruso,2615,137,5,6,11,45.5%,48m
25830,1,Draks,2615,106,4,9,13,30.8%,2h
25830,2,Ninsoma,2615,125,3,2,5,60.0%,3h
25830,1,Dalynzx,2615,95,3,4,7,42.9%,58m
25830,3,Philip,2615,0,2,3,5,40.0%,1h
25830,3,elchucho,2615,0,2,3,5,40.0%,1h
25830,2,[TpLn]Brdi,2615,0,2,3,5,40.0%,1h
25830,2,Firmitas,2615,30,1,1,2,50.0%,3h
25830,1,[GaaaSQ]marcelocheXD,2615,32,1,4,5,20.0%,3h
25830,2,[C80]intotherain,2615,0,1,4,5,20.0%,1h
25830,1,[RUMB]BASHER,2615,38,1,7,8,12.5%,2h
25830,2,BUZZ,2615,0,0,1,1,0.0%,59m
25830,2,ProximaZ,2615,0,0,1,1,0.0%,3h
25830,1,Polar,2615,0,0,2,2,0.0%,45m
25830,1,[50cal]SilentSpell,2615,0,0,6,6,0.0%,3h
25830,1,[Th3Bad]maua,2615,0,0,6,6,0.0%,1h
25861,2,[StarBo]frank,2614,1631,203,199,402,50.5%,15m
25861,2,Magneto,2614,1313,134,144,278,48.2%,5m
25861,3,[SCST]microbyte,2614,1501,123,116,239,51.5%,37m
25861,3,RayRayRaynor,2614,1304,120,120,240,50.0%,25m
25861,3,arii,2614,1614,115,126,241,47.7%,37m
25861,3,aversabilis,2614,1166,100,96,196,51.0%,17m
25861,3,PhatTraxxTWO,2614,949,75,66,141,53.2%,22m
25861,1,Atreides,2614,652,38,18,56,67.9%,40m
25861,2,Whipface,2614,604,25,15,40,62.5%,3h
25861,1,ThirstyMonk,2614,611,19,19,38,50.0%,3h
25861,2,Hamisthebest,2614,197,13,5,18,72.2%,55m
25861,3,TheMechanic,2614,304,10,20,30,33.3%,31m
25861,2,FreshDeli,2614,204,8,4,12,66.7%,3h
25861,3,[kiMchz]Wonton,2614,221,8,9,17,47.1%,8m
25861,1,SweetTunes,2614,280,7,12,19,36.8%,1h
25861,1,[D3m0N]Shadow,2614,134,6,4,10,60.0%,3h
25861,2,WillitGrow,2614,172,5,6,11,45.5%,16m
25861,1,Otak,2614,130,4,6,10,40.0%,36m
25861,2,cookymonster,2614,46,2,2,4,50.0%,27m
25861,3,GonzaBlizz,2614,97,2,4,6,33.3%,31m
25861,2,telentoro,2614,44,1,2,3,33.3%,1h
25861,2,Vinyard,2614,0,1,2,3,33.3%,19m
25861,1,Lenk,2614,30,1,3,4,25.0%,3h
25861,2,[80SS]ItzMuNkyy,2614,0,0,1,1,0.0%,1h
25861,2,[Mc]Psylocibe,2614,0,0,2,2,0.0%,3h
25861,2,webo,2614,0,0,2,2,0.0%,1h
25861,2,ameba,2614,0,0,2,2,0.0%,2h
25861,1,EvilOlive,2614,0,0,2,2,0.0%,1h
25861,2,Drigax,2614,0,0,2,2,0.0%,1h
25890,2,lavalle,2613,807,212,221,433,49.0%,33m
25890,3,IronCurtain,2613,1178,72,71,143,50.3%,29m
25890,2,Syoudragon,2613,1611,68,68,136,50.0%,3h
25890,1,[EwR]Pdawg,2613,665,26,23,49,53.1%,3h
25890,2,[BLSHD]jaymul,2613,133,14,13,27,51.9%,55m
25890,3,Aryze,2613,264,11,11,22,50.0%,1h
25890,2,[TEBOW]EricTheBold,2613,150,8,10,18,44.4%,43m
25890,1,[snafer]abdu,2613,198,6,8,14,42.9%,4m
25890,2,[SYNDCT]AngelofSc,2613,116,5,2,7,71.4%,37m
25890,1,pabolmortis,2613,154,5,6,11,45.5%,8m
25890,1,Alex,2613,160,5,7,12,41.7%,3h
25890,2,SpaceLegend,2613,124,4,4,8,50.0%,54m
25890,1,[BLAH1]Kimo,2613,152,4,8,12,33.3%,3h
25890,2,ImAngry,2613,83,3,2,5,60.0%,53m
25890,1,Ryael,2613,89,3,4,7,42.9%,3h
25890,3,efincranes,2613,94,3,13,16,18.8%,4m
25890,2,Phobos,2613,0,2,4,6,33.3%,3h
25890,3,TyraelG,2613,0,1,0,1,100.0%,57m
25890,2,[Batmam]ArngrimWryn,2613,0,1,1,2,50.0%,1h
25890,2,zicario,2613,32,1,3,4,25.0%,11m
25890,2,parasitezero,2613,30,1,6,7,14.3%,11m
25890,2,substrate,2613,46,1,10,11,9.1%,3h
25890,2,SirDumpAlot,2613,0,0,1,1,0.0%,55m
25890,2,Ibakecookies,2613,0,0,1,1,0.0%,2h
25890,3,EatBluBerry,2613,0,0,1,1,0.0%,44m
25890,2,Gabriel,2613,0,0,1,1,0.0%,3h
25890,1,AdeodatusIII,2613,0,0,4,4,0.0%,1h
25890,3,llllllllllll,2613,0,0,7,7,0.0%,26m
25918,2,[Nakir]Daggoth,2612,1576,212,219,431,49.2%,15m
25918,2,[cl0udM]WyzWun,2612,1310,198,209,407,48.6%,36m
25918,3,awesomeJW,2612,1339,136,137,273,49.8%,6m
25918,1,Aalleyway,2612,1426,58,56,114,50.9%,8m
25918,1,rage,2612,1191,48,37,85,56.5%,11m
25918,3,[2up]JimmyPop,2612,859,35,35,70,50.0%,23m
25918,2,Mykle,2612,365,15,13,28,53.6%,55m
25918,1,PrimalApollo,2612,334,13,15,28,46.4%,3h
25918,1,Tweak,2612,356,11,13,24,45.8%,15m
25918,2,DatSauceTho,2612,290,9,7,16,56.2%,3h
25918,2,NMB,2612,230,6,5,11,54.5%,1h
25918,1,Xin,2612,191,6,9,15,40.0%,5m
25918,2,SleepyWeasel,2612,143,5,6,11,45.5%,2h
25918,1,EdForceOne,2612,44,3,5,8,37.5%,48m
25918,1,Kiwi,2612,168,3,9,12,25.0%,55m
25918,1,dingding,2612,38,2,3,5,40.0%,2h
25918,1,Multi,2612,97,2,4,6,33.3%,3h
25918,1,Bovice,2612,36,2,7,9,22.2%,14m
25918,2,Bouriquet,2612,0,1,0,1,100.0%,18m
25918,1,CaptainPrice,2612,0,1,1,2,50.0%,36m
25918,1,SaffronSoul,2612,90,1,3,4,25.0%,42m
25918,1,Schwa,2612,30,1,4,5,20.0%,51m
25918,3,[BAcrft]Matt,2612,0,1,4,5,20.0%,20m
25918,2,marine,2612,0,0,2,2,0.0%,27m
25942,1,Eskcool,2611,1219,89,75,164,54.3%,49m
25942,1,Hellfox,2611,1278,70,60,130,53.8%,35m
25942,2,Ziglar,2611,895,45,38,83,54.2%,51m
25942,1,KorII,2611,1002,41,41,82,50.0%,23m
25942,3,Snoopyy,2611,392,31,41,72,43.1%,9m
25942,1,Hymx,2611,273,30,28,58,51.7%,3h
25942,1,Adam,2611,734,29,27,56,51.8%,1h
25942,1,[diaman]DrFriO,2611,617,28,23,51,54.9%,1h
25942,1,[ICdRI]LoKoMoTioN,2611,766,23,22,45,51.1%,1h
25942,2,[Lowko]Artanis,2611,482,20,23,43,46.5%,33m
25942,2,Drakkae,2611,518,19,19,38,50.0%,1h
25942,1,Milli,2611,528,18,17,35,51.4%,3h
25942,1,[Atena]Gerarca,2611,440,16,11,27,59.3%,48m
25942,1,jesuwolf,2611,390,14,8,22,63.6%,3h
25942,1,[ffaaak]bigdaddy,2611,321,11,9,20,55.0%,1h
25942,2,SgtSeastand,2611,315,11,15,26,42.3%,55m
25942,1,[xBLx]Spo,2611,235,8,8,16,50.0%,55m
25942,1,[MLWK]Vermilion,2611,235,8,9,17,47.1%,1h
25942,1,Vibb,2611,286,8,14,22,36.4%,26m
25942,1,Andy,2611,238,6,9,15,40.0%,1h
25942,2,Straightdraw,2611,116,5,1,6,83.3%,44m
25942,2,[UCHlH4]RAFIQQI,2611,126,4,2,6,66.7%,3h
25942,2,[Sc2ARK]Rexx,2611,159,4,4,8,50.0%,54m
25942,1,[SuperZ]FireDylan,2611,138,3,4,7,42.9%,37m
25942,2,EDROCCH,2611,0,2,3,5,40.0%,34m
25942,1,alejo,2611,38,2,4,6,33.3%,29m
25942,3,ColdArsenic,2611,0,2,4,6,33.3%,31m
25942,1,KiwiGen,2611,74,2,5,7,28.6%,3h
25942,2,Tendock,2611,0,2,6,8,25.0%,1h
25942,2,Fishmael,2611,0,1,0,1,100.0%,1h
25942,2,emoMarine,2611,0,1,0,1,100.0%,11m
25942,2,Barracuda,2611,0,1,1,2,50.0%,23m
25942,2,Roermond,2611,0,1,1,2,50.0%,38m
25942,2,PIER,2611,0,1,1,2,50.0%,51m
25942,2,Captnhammer,2611,0,1,1,2,50.0%,47m
25942,2,Grating,2611,0,0,1,1,0.0%,3h
25942,2,[Mortum]RyanTheRiper,2611,0,0,1,1,0.0%,1h
25979,1,MrUnderhill,2610,1592,130,122,252,51.6%,3h
25979,3,Sonic,2610,1344,90,98,188,47.9%,30m
25979,1,EDMONKAII,2610,1350,55,49,104,52.9%,1h
25979,1,TuMaMa,2610,814,31,26,57,54.4%,48m
25979,2,Solevita,2610,492,18,13,31,58.1%,3h
25979,2,iiNGloriouS,2610,383,14,10,24,58.3%,1h
25979,1,[DKGLL]eldestructor,2610,366,12,11,23,52.2%,3h
25979,1,StoobingTown,2610,327,12,13,25,48.0%,48m
25979,1,[KaKaKa]ToTTe,2610,155,5,6,11,45.5%,22m
25979,3,Kenji,2610,97,4,2,6,66.7%,30m
25979,3,scottypoz,2610,153,4,4,8,50.0%,1h
25979,2,CodeRace,2610,64,3,0,3,100.0%,2h
25979,2,Giygas,2610,153,3,2,5,60.0%,16m
25979,2,[LACRAS]RATAMASTA,2610,114,2,1,3,66.7%,27m
25979,2,Booster,2610,46,2,2,4,50.0%,43m
25979,2,llllllllllll,2610,0,2,3,5,40.0%,51m
25979,2,[Khalta]MERCENARIO,2610,60,2,4,6,33.3%,3h
25979,2,GERT,2610,30,2,4,6,33.3%,3h
25979,2,[BfLaD]AdmiralKwan,2610,0,1,2,3,33.3%,3h
25998,1,Humito,2609,1681,111,100,211,52.6%,1h
25998,2,[DXPCA]Ryokogami,2609,1488,107,91,198,54.0%,1h
25998,1,AFA,2609,1004,72,68,140,51.4%,1h
25998,1,FDen,2609,1141,72,73,145,49.7%,3h
25998,1,WILY,2609,986,69,59,128,53.9%,50m
25998,3,TheKing,2609,1073,64,62,126,50.8%,19m
25998,1,[EoMX]REINOR,2609,1036,56,55,111,50.5%,53m
25998,2,Boxxxx,2609,853,47,28,75,62.7%,3h
25998,2,AtlaStar,2609,717,47,42,89,52.8%,14m
25998,1,[URP]Vulcano,2609,888,29,29,58,50.0%,6m
25998,1,DjJazzyGeoff,2609,686,21,29,50,42.0%,3h
25998,2,[GOPERÚ]Levyathanxzx,2609,491,20,9,29,69.0%,53m
25998,2,[Exper]JuanPlatanit,2609,434,18,5,23,78.3%,11m
25998,2,NicsTan,2609,453,18,13,31,58.1%,59m
25998,2,[ClanHs]Vaticide,2609,385,17,6,23,73.9%,27m
25998,3,Hades,2609,338,12,21,33,36.4%,13m
25998,1,Rafastary,2609,176,7,10,17,41.2%,51m
25998,2,Destiny,2609,194,6,1,7,85.7%,1h
25998,2,Guywithgun,2609,150,6,5,11,54.5%,3h
25998,2,RaffaLops,2609,90,4,2,6,66.7%,9m
25998,3,kigden,2609,36,2,1,3,66.7%,1h
25998,1,Fresca,2609,115,2,1,3,66.7%,1h
25998,3,kupsman,2609,0,2,2,4,50.0%,3h
25998,2,Krukov,2609,0,2,3,5,40.0%,3h
25998,3,[MBR420]PARTYSMARTIE,2609,0,2,3,5,40.0%,20m
25998,2,Arcanjounder,2609,0,2,3,5,40.0%,3h
25998,1,[SmokeH]samocles,2609,0,1,2,3,33.3%,11m
25998,2,Ben,2609,0,0,1,1,0.0%,48m
25998,1,CoLeBuRns,2609,0,0,1,1,0.0%,3h
25998,2,StarMaster,2609,0,0,3,3,0.0%,3h
26028,3,[ÆON]Mateomedi,2608,1069,173,157,330,52.4%,22m
26028,3,uchihasenpai,2608,1470,127,112,239,53.1%,5m
26028,3,Stark,2608,1443,84,82,166,50.6%,26m
26028,3,Pepo,2608,1515,84,97,181,46.4%,38m
26028,3,[M90s]ADN,2608,841,43,50,93,46.2%,10m
26028,3,ToffyUK,2608,407,37,32,69,53.6%,35m
26028,2,Nag,2608,628,25,22,47,53.2%,1h
26028,2,Bluestar,2608,472,16,16,32,50.0%,5m
26028,1,smokedleader,2608,357,12,13,25,48.0%,3h
26028,2,Trexem,2608,332,11,26,37,29.7%,34m
26028,1,Boxiii,2608,199,10,4,14,71.4%,3h
26028,2,WzLang,2608,148,6,6,12,50.0%,3h
26028,3,[EpicG]Hiromi,2608,0,3,2,5,60.0%,30m
26028,1,Deathwish,2608,118,3,3,6,50.0%,56m
26028,1,RoY,2608,24,3,8,11,27.3%,53m
26028,2,MagnumBolt,2608,30,2,0,2,100.0%,3h
26028,2,[Gayduz]void,2608,30,2,2,4,50.0%,1h
26028,2,AngMonster,2608,0,2,4,6,33.3%,3h
26028,2,JordanPB,2608,94,2,5,7,28.6%,3h
26028,1,ARABASTA,2608,84,2,6,8,25.0%,1h
26028,2,[V1nD]Dragonsword,2608,0,1,0,1,100.0%,1h
26028,2,MORTUS,2608,0,1,0,1,100.0%,38m
26028,2,[WicWac]stever,2608,91,1,1,2,50.0%,3h
26028,2,IsmaTerr,2608,30,1,2,3,33.3%,34m
26028,3,GERALDPEREZ,2608,0,1,2,3,33.3%,1h
26028,2,AldoRguez,2608,0,0,1,1,0.0%,38m
26028,2,UncleMagic,2608,0,0,1,1,0.0%,1h
26028,3,[CFFL]Spirit,2608,0,0,2,2,0.0%,30m
26028,2,ScareCroW,2608,0,0,9,9,0.0%,40m
26057,1,aarontruong,2607,979,219,202,421,52.0%,3h
26057,1,CENTAURO,2607,1597,202,190,392,51.5%,58m
26057,2,yourMOM,2607,666,57,40,97,58.8%,1h
26057,1,zeroskill,2607,1130,48,38,86,55.8%,60m
26057,1,ARTANIS,2607,799,28,29,57,49.1%,3h
26057,2,DaveHedgehog,2607,527,20,18,38,52.6%,3h
26057,1,BORAsaurrr,2607,394,18,14,32,56.2%,3h
26057,3,ChikenNuggy,2607,282,11,19,30,36.7%,26m
26057,1,[cumple]lamonajimene,2607,352,10,14,24,41.7%,3h
26057,2,JonathanD,2607,169,6,1,7,85.7%,1h
26057,2,Kmach,2607,0,4,2,6,66.7%,1h
26057,2,IIIIIIII,2607,0,3,2,5,60.0%,44m
26057,3,MetronomE,2607,60,3,6,9,33.3%,22m
26057,1,[Aztec]Fuji,2607,112,3,10,13,23.1%,1h
26057,2,denan,2607,58,2,1,3,66.7%,3h
26057,2,[XANNY]AfterDark,2607,0,2,3,5,40.0%,38m
26057,2,SKYNET,2607,0,1,0,1,100.0%,38m
26057,1,Phantom,2607,0,1,2,3,33.3%,3h
26057,2,Riley,2607,32,1,2,3,33.3%,1h
26057,2,Minscandpoo,2607,0,1,2,3,33.3%,3h
26057,1,WGFURY,2607,38,1,4,5,20.0%,25m
26057,2,[ppgang]DrFuzzBottom,2607,99,1,4,5,20.0%,1h
26057,2,[VINGAD]matias,2607,0,0,2,2,0.0%,13m
26080,1,DeathStroke,2606,1695,362,355,717,50.5%,1h
26080,3,ShadowX,2606,1543,237,227,464,51.1%,36m
26080,1,Xólotl,2606,1694,237,234,471,50.3%,1h
26080,1,thonixxx,2606,1553,143,128,271,52.8%,3h
26080,2,[TWC]CaKeEatR,2606,1508,91,101,192,47.4%,20m
26080,3,JorEl,2606,1500,74,86,160,46.2%,6m
26080,3,[3Dots]whodis,2606,1537,67,61,128,52.3%,16m
26080,1,Rusty,2606,952,48,39,87,55.2%,1h
26080,1,BBJmagnus,2606,979,45,36,81,55.6%,1h
26080,3,NoMads,2606,465,27,20,47,57.4%,37m
26080,2,Carosk,2606,696,27,34,61,44.3%,5m
26080,3,Insanity,2606,180,20,18,38,52.6%,8m
26080,1,campeon,2606,506,18,18,36,50.0%,53m
26080,1,CanUDigIt,2606,365,16,15,31,51.6%,3h
26080,2,Sonic,2606,326,11,12,23,47.8%,3h
26080,2,EnfernoVIII,2606,180,7,3,10,70.0%,44m
26080,1,Comunismo,2606,179,5,5,10,50.0%,54m
26080,2,Galletita,2606,88,4,1,5,80.0%,1h
26080,3,Ykahala,2606,112,4,6,10,40.0%,5m
26080,3,Meow,2606,60,4,7,11,36.4%,29m
26080,3,TMH,2606,32,3,2,5,60.0%,1h
26080,1,[rltcos]EEMMCR,2606,94,3,5,8,37.5%,1h
26080,2,[KTBOSS]xShadowx,2606,32,2,2,4,50.0%,3h
26080,2,Stevo,2606,66,2,4,6,33.3%,13m
26080,1,chickengods,2606,48,1,6,7,14.3%,3h
26080,1,CplHicks,2606,34,1,7,8,12.5%,3h
26080,2,larrydizzle,2606,0,0,1,1,0.0%,51m
26080,3,Slimeee,2606,0,0,1,1,0.0%,1h
26080,2,SerghioMart,2606,0,0,2,2,0.0%,1h
26080,2,[LoZOoT]new,2606,0,0,2,2,0.0%,3h
26110,3,SENSO,2605,1562,710,703,1413,50.2%,43m
26110,2,[xSaSx]Matanza,2605,1514,285,262,547,52.1%,31m
26110,1,Covert,2605,753,188,176,364,51.6%,49m
26110,1,coolhandluke,2605,1687,180,172,352,51.1%,3h
26110,1,CompleTR,2605,1663,88,89,177,49.7%,3h
26110,1,FatDog,2605,850,36,28,64,56.2%,3h
26110,1,[sBOI]lei,2605,710,29,21,50,58.0%,1h
26110,3,[JGG]ishatmypants,2605,666,23,33,56,41.1%,29m
26110,1,TheMule,2605,458,13,19,32,40.6%,49m
26110,2,LittleHands,2605,170,8,6,14,57.1%,1h
26110,2,Script,2605,223,7,8,15,46.7%,3h
26110,1,gapple,2605,186,6,7,13,46.2%,3h
26110,1,TheJessMann,2605,153,4,3,7,57.1%,41m
26110,3,DivineChief,2605,97,3,3,6,50.0%,33m
26110,2,Lorinis,2605,92,3,4,7,42.9%,1h
26110,2,Table,2605,58,2,2,4,50.0%,22m
26110,2,Einzelganger,2605,46,2,3,5,40.0%,1h
26110,2,[SsaYnS]Kiar,2605,0,1,25,26,3.8%,17m
26110,3,monsoone,2605,0,0,1,1,0.0%,3h
26129,3,Kaashif,2604,1557,210,205,415,50.6%,17m
26129,2,[LOOPY]Scheyla,2604,701,97,45,142,68.3%,1h
26129,2,Quintues,2604,1305,95,78,173,54.9%,3h
26129,2,irsgreece,2604,1094,80,90,170,47.1%,33m
26129,1,[SyLx]JulioTche,2604,878,40,27,67,59.7%,53m
26129,2,Lapilofu,2604,805,30,28,58,51.7%,3h
26129,1,[OADGQ]arthaz,2604,732,29,24,53,54.7%,39m
26129,1,artemis,2604,657,26,23,49,53.1%,1h
26129,1,[Exper]Tanus,2604,534,21,18,39,53.8%,3h
26129,3,irascible,2604,446,17,19,36,47.2%,25m
26129,1,joselewis,2604,364,14,12,26,53.8%,31m
26129,2,[BHBD]Hank,2604,260,11,11,22,50.0%,15m
26129,2,PurpleRanger,2604,308,11,15,26,42.3%,1h
26129,1,[veVivi]Vendetta,2604,269,10,10,20,50.0%,22m
26129,1,[Lato]Schlossberg,2604,186,8,7,15,53.3%,3h
26129,1,Lushy,2604,212,7,8,15,46.7%,3h
26129,1,Governa,2604,122,5,7,12,41.7%,3h
26129,2,TrickyMoon,2604,130,4,5,9,44.4%,1h
26129,2,odinthebrave,2604,161,4,6,10,40.0%,3h
26129,1,Branco,2604,102,4,7,11,36.4%,1h
26129,3,AQPDESTROYER,2604,119,3,2,5,60.0%,1h
26129,1,kittybandito,2604,90,3,4,7,42.9%,22m
26129,2,lllllllgllll,2604,0,3,5,8,37.5%,20m
26129,2,[SANGRE]Frank,2604,60,2,1,3,66.7%,34m
26129,2,RyzeZed,2604,58,2,3,5,40.0%,3h
26129,3,DanielR,2604,0,2,3,5,40.0%,58m
26129,2,SquishyXP,2604,0,2,3,5,40.0%,38m
26129,3,Eclipse,2604,0,2,4,6,33.3%,30m
26129,2,JoshYouAhh,2604,0,1,0,1,100.0%,37m
26129,2,[MMSTAR]Terror,2604,0,1,0,1,100.0%,26m
26129,2,AvatarHyru,2604,0,0,2,2,0.0%,3h
26160,1,Max,2603,1681,175,179,354,49.4%,12m
26160,1,Mike,2603,1507,97,86,183,53.0%,3h
26160,1,Perraian,2603,755,62,49,111,55.9%,59m
26160,2,[cluez]MacJS,2603,1223,55,54,109,50.5%,1h
26160,2,BANE,2603,563,51,43,94,54.3%,40m
26160,3,Agonia,2603,1121,50,52,102,49.0%,43m
26160,3,[ZTemp]DarkRazor,2603,635,49,47,96,51.0%,14m
26160,2,DIEGOINDUSTR,2603,320,16,12,28,57.1%,3h
26160,1,Yamcha,2603,372,13,11,24,54.2%,29m
26160,3,Nemesis,2603,326,11,20,31,35.5%,25m
26160,2,DinoBandino,2603,222,6,8,14,42.9%,3h
26160,1,Deltronk,2603,212,6,10,16,37.5%,3h
26160,2,RisingDusk,2603,46,5,4,9,55.6%,3h
26160,2,SkeeZeL,2603,144,4,1,5,80.0%,3h
26160,1,NotTooShabby,2603,120,4,6,10,40.0%,3h
26160,1,TKing,2603,112,4,8,12,33.3%,1h
26160,1,[HDOG]Ephaestus,2603,146,4,9,13,30.8%,1h
26160,3,waveLength,2603,121,3,4,7,42.9%,25m
26160,3,Noroi,2603,129,3,4,7,42.9%,3h
26160,1,[ILikeU]YOUNgLUCKy,2603,42,2,3,5,40.0%,60m
26160,3,Wolf,2603,0,2,3,5,40.0%,4m
26160,1,Kiimport,2603,0,2,3,5,40.0%,1h
26160,3,Dave,2603,97,2,4,6,33.3%,18m
26160,1,Sirtokealot,2603,72,2,6,8,25.0%,55m
26160,2,tomatobasil,2603,0,1,0,1,100.0%,18m
26160,3,clane,2603,0,1,1,2,50.0%,24m
26160,2,CDiddy,2603,0,1,4,5,20.0%,1h
26160,2,ToneT,2603,0,0,2,2,0.0%,3h
26160,2,EzMelon,2603,0,0,5,5,0.0%,44m
26160,2,[Boooiz]SourDough,2603,0,0,5,5,0.0%,3h
26190,1,jamesbondtra,2602,1716,230,213,443,51.9%,17m
26190,1,ARES,2602,852,93,84,177,52.5%,15m
26190,1,[TESTI]Lapox,2602,766,27,25,52,51.9%,40m
26190,3,Drott,2602,519,25,32,57,43.9%,38m
26190,3,Haka,2602,488,17,20,37,45.9%,29m
26190,2,Agbonavbare,2602,391,16,11,27,59.3%,3h
26190,1,Dire,2602,328,11,12,23,47.8%,1h
26190,2,[TF66]LEVIATAN,2602,294,10,8,18,55.6%,1h
26190,1,MrSpectre,2602,272,10,10,20,50.0%,8m
26190,2,ChesterNoob,2602,162,7,6,13,53.8%,38m
26190,2,JIMMY,2602,86,3,2,5,60.0%,40m
26190,2,THEFALLENONE,2602,30,2,1,3,66.7%,16m
26190,2,[secks]Rice,2602,30,1,1,2,50.0%,3h
26190,2,Chad,2602,30,1,1,2,50.0%,1h
26190,2,CommanderAl,2602,30,1,2,3,33.3%,23m
26190,1,PiBOMC,2602,0,1,2,3,33.3%,35m
26190,2,[HEZUS]Boff,2602,91,1,2,3,33.3%,3h
26190,3,Traviz,2602,0,0,1,1,0.0%,38m
26190,2,Ger,2602,0,0,1,1,0.0%,1h
26190,2,Sniper,2602,0,0,2,2,0.0%,44m
26190,1,DeaderRedd,2602,0,0,4,4,0.0%,8m
26211,3,DCfromOaktow,2601,1555,313,309,622,50.3%,21m
26211,2,Mafiosis,2601,849,70,49,119,58.8%,49m
26211,1,Xarl,2601,1455,61,51,112,54.5%,4m
26211,3,Xpo,2601,1300,55,55,110,50.0%,32m
26211,1,Mustafa,2601,458,44,27,71,62.0%,50m
26211,1,cryonics,2601,824,41,37,78,52.6%,23m
26211,1,[SsaYnS]uziboozi,2601,715,32,24,56,57.1%,1h
26211,1,QuirkyTurtle,2601,591,20,26,46,43.5%,3h
26211,1,Filburth,2601,490,19,15,34,55.9%,40m
26211,1,Bitemarks,2601,518,17,17,34,50.0%,50m
26211,1,Aletheia,2601,439,15,17,32,46.9%,39m
26211,2,Chapito,2601,388,13,10,23,56.5%,40m
26211,1,SDuranDuran,2601,378,13,12,25,52.0%,35m
26211,1,[XpKAc]OsoMaloso,2601,340,11,10,21,52.4%,1h
26211,1,[EZkill]shawnjr,2601,350,9,12,21,42.9%,29m
26211,1,Zmei,2601,222,8,10,18,44.4%,3h
26211,1,Rupicols,2601,199,7,4,11,63.6%,35m
26211,3,calypso,2601,221,7,11,18,38.9%,1h
26211,3,Jaxx,2601,145,5,7,12,41.7%,25m
26211,1,thegurney,2601,169,5,10,15,33.3%,3h
26211,3,[WAAL]Masturbazn,2601,155,3,1,4,75.0%,30m
26211,2,[Dudss]Shopa,2601,86,3,4,7,42.9%,1h
26211,2,[XpKAc]alvarojurado,2601,62,2,3,5,40.0%,1h
26211,1,[DROM]BichoMena,2601,36,2,4,6,33.3%,16m
26211,1,Fib,2601,0,2,8,10,20.0%,18m
26211,3,Scott,2601,0,1,4,5,20.0%,3h
26211,2,TinRoXx,2601,0,0,2,2,0.0%,47m
26238,1,Sandwich,2600,1286,57,59,116,49.1%,7m
26238,1,Chrome,2600,1355,48,57,105,45.7%,2m
26238,2,[Shardz]nhduia,2600,1091,44,32,76,57.9%,1h
26238,1,[gotBTC]TimeIsMoney,2600,860,33,31,64,51.6%,5m
26238,1,[tSC2LP]Nieuw,2600,778,26,27,53,49.1%,14m
26238,2,INnoJing,2600,400,15,10,25,60.0%,1h
26238,1,blueballed,2600,333,13,11,24,54.2%,33m
26238,2,RockyMaivia,2600,254,8,11,19,42.1%,1h
26238,2,Miyuki,2600,168,6,5,11,54.5%,3h
26238,2,PaiZuZe,2600,165,6,6,12,50.0%,3h
26238,1,Klappertaart,2600,133,6,7,13,46.2%,1h
26238,3,kaizer,2600,60,6,9,15,40.0%,25m
26238,1,mspiggy,2600,210,6,11,17,35.3%,3m
26238,1,bigdave,2600,190,5,11,16,31.2%,3h
26238,2,SantoGamer,2600,135,3,2,5,60.0%,44m
26238,3,cardenasq,2600,0,3,2,5,60.0%,3h
26238,3,kenji,2600,117,3,3,6,50.0%,3h
26238,2,[DhZone]Guima,2600,34,2,1,3,66.7%,40m
26238,3,ZenoDorus,2600,0,2,4,6,33.3%,3h
26238,2,Mun,2600,0,2,6,8,25.0%,3h
26238,2,Guackamo,2600,0,1,0,1,100.0%,1h
26238,2,ghosttemplar,2600,0,0,1,1,0.0%,32m
26260,2,MyLord,2599,1568,871,821,1692,51.5%,19m
26260,1,StrkrOmalley,2599,1589,125,127,252,49.6%,4m
26260,2,Mortal,2599,891,93,86,179,52.0%,3h
26260,3,[LOHs]alexlim,2599,775,88,83,171,51.5%,31m
26260,1,wooyiwoo,2599,1415,65,57,122,53.3%,28m
26260,3,BlackTruth,2599,648,58,64,122,47.5%,17m
26260,2,Artofwar,2599,587,22,15,37,59.5%,26m
26260,1,Prometheus,2599,536,19,17,36,52.8%,35m
26260,3,PINECONE,2599,503,18,24,42,42.9%,30m
26260,1,llllllllllll,2599,552,17,21,38,44.7%,14m
26260,2,Simonsaysz,2599,350,14,5,19,73.7%,18m
26260,3,Galower,2599,285,11,10,21,52.4%,32m
26260,1,FloppyMcNuts,2599,198,9,5,14,64.3%,33m
26260,2,[αXLa]ZerGAcTiOn,2599,194,6,1,7,85.7%,3m
26260,3,[PRO604]Akira,2599,219,6,11,17,35.3%,51m
26260,2,ROGE,2599,0,4,1,5,80.0%,50m
26260,2,[EtrOy]Magneto,2599,122,4,6,10,40.0%,3h
26260,2,ghettojeddo,2599,0,3,6,9,33.3%,33m
26260,2,Pandora,2599,95,2,3,5,40.0%,3h
26260,1,SombraLetal,2599,0,2,4,6,33.3%,3h
26260,2,[KGH]thedark,2599,0,1,0,1,100.0%,1h
26260,2,MasterOogway,2599,0,1,0,1,100.0%,51m
26260,1,GLcrip,2599,34,1,6,7,14.3%,17m
26260,2,Razorsedge,2599,0,0,1,1,0.0%,32m
26260,1,Matthew,2599,0,0,4,4,0.0%,39m
26285,2,[FU2]zopilotech,2598,1021,120,120,240,50.0%,1h
26285,3,Ethereal,2598,1304,108,91,199,54.3%,18m
26285,1,[HuALaR]JayDanger,2598,922,106,105,211,50.2%,15m
26285,1,[GC2042]Axolotl,2598,1669,65,62,127,51.2%,17m
26285,1,Anxienty,2598,739,35,15,50,70.0%,3h
26285,1,noobfiveever,2598,994,33,34,67,49.3%,3h
26285,2,Liest,2598,850,32,28,60,53.3%,26m
26285,1,Slamonkey,2598,320,23,22,45,51.1%,3h
26285,2,ranger,2598,368,13,11,24,54.2%,1h
26285,3,TenShun,2598,324,12,14,26,46.2%,19m
26285,3,Bruto,2598,171,9,11,20,45.0%,1m
26285,2,[Animau]FrogTeamXD,2598,222,7,5,12,58.3%,1h
26285,1,Endo,2598,290,7,10,17,41.2%,16m
26285,1,[CV0101]AmonRA,2598,117,4,2,6,66.7%,11m
26285,2,CartMakn,2598,139,4,5,9,44.4%,1h
26285,2,[Broy]AlexDNinja,2598,60,3,3,6,50.0%,1h
26285,1,Insulate,2598,141,2,1,3,66.7%,3h
26285,2,Eny,2598,30,1,2,3,33.3%,45m
26285,2,Heemlo,2598,30,1,5,6,16.7%,27m
26285,2,Imagination,2598,0,0,1,1,0.0%,3h
26285,2,RiOoMa,2598,0,0,1,1,0.0%,3h
26285,2,Kenny,2598,0,0,3,3,0.0%,3h
26307,1,Grindmax,2597,1707,447,437,884,50.6%,3m
26307,1,pNzAreCheats,2597,1369,148,171,319,46.4%,10m
26307,3,[TOYOTA]CelicaPower,2597,1528,141,145,286,49.3%,16m
26307,3,Obama,2597,666,102,140,242,42.1%,3m
26307,1,Kenobi,2597,1690,73,76,149,49.0%,4m
26307,1,elEspartan,2597,933,38,39,77,49.4%,49m
26307,3,OldManWillow,2597,939,36,41,77,46.8%,16m
26307,1,PiratitaNoob,2597,811,30,28,58,51.7%,1h
26307,3,TheFast,2597,786,27,30,57,47.4%,25m
26307,3,Hazard,2597,388,26,31,57,45.6%,42m
26307,1,ZWylde,2597,740,25,27,52,48.1%,3h
26307,2,lbaseterran,2597,418,15,10,25,60.0%,1h
26307,3,FbSIII,2597,442,14,19,33,42.4%,25m
26307,1,Stinger,2597,324,13,9,22,59.1%,3h
26307,3,LifePoint,2597,260,10,13,23,43.5%,1m
26307,1,PandaExpress,2597,293,9,8,17,52.9%,3h
26307,2,BNoice,2597,266,9,8,17,52.9%,1h
26307,1,ipxC,2597,212,7,9,16,43.8%,3h
26307,1,[ZTemps]PSYCH,2597,237,6,2,8,75.0%,3h
26307,2,Goldsound,2597,161,6,6,12,50.0%,1h
26307,2,Kiva,2597,172,6,8,14,42.9%,4m
26307,1,UnKnOwN,2597,232,6,12,18,33.3%,1h
26307,2,zim,2597,155,5,6,11,45.5%,3h
26307,2,[DETER]Alsadair,2597,174,4,6,10,40.0%,3h
26307,2,Phizzler,2597,120,3,0,3,100.0%,22m
26307,1,[Msia]MiEHV,2597,117,3,3,6,50.0%,3h
26307,2,Dew,2597,30,2,0,2,100.0%,3h
26307,1,Reesepup,2597,88,2,2,4,50.0%,51m
26307,1,Rockandroll,2597,92,2,2,4,50.0%,35m
26307,1,BattleSmurf,2597,68,2,6,8,25.0%,22m
26307,2,MrT,2597,30,1,1,2,50.0%,3h
26307,1,superdude,2597,0,1,2,3,33.3%,3h
26307,3,GoldStapo,2597,0,1,4,5,20.0%,1h
26307,2,TheChosunOne,2597,0,0,1,1,0.0%,52m
26307,2,[UpxV]MigueBS,2597,0,0,5,5,0.0%,1h
26342,1,DevilDoc,2596,1691,214,215,429,49.9%,1h
26342,2,[Dizz]RuiN,2596,909,62,53,115,53.9%,40m
26342,1,IsaacNewton,2596,1130,43,41,84,51.2%,56m
26342,3,Haste,2596,762,38,47,85,44.7%,25m
26342,2,Neophyte,2596,473,22,3,25,88.0%,3h
26342,2,HumanShield,2596,558,22,18,40,55.0%,50m
26342,3,ALEXANDROS,2596,537,21,20,41,51.2%,26m
26342,3,SlayDaVulva,2596,614,21,29,50,42.0%,22m
26342,2,Dolby,2596,399,17,22,39,43.6%,3m
26342,3,Predator,2596,380,15,20,35,42.9%,43m
26342,2,Legendary,2596,404,14,9,23,60.9%,2m
26342,1,[ktkzs]XycoDelics,2596,370,12,17,29,41.4%,7m
26342,2,Chuwashere,2596,333,11,10,21,52.4%,3h
26342,1,HOPLITE,2596,264,9,13,22,40.9%,43m
26342,1,Maucho,2596,232,8,6,14,57.1%,59m
26342,1,Valkyrie,2596,160,7,8,15,46.7%,26m
26342,2,[FLMi]Flameck,2596,169,6,6,12,50.0%,1h
26342,3,Sofiane,2596,200,6,10,16,37.5%,43m
26342,2,[Tasteb]DDugi,2596,133,5,7,12,41.7%,3h
26342,1,Nethmes,2596,178,5,8,13,38.5%,43m
26342,2,Rahui,2596,151,4,0,4,100.0%,53m
26342,2,LiquidRa,2596,30,4,3,7,57.1%,3h
26342,1,Rage,2596,105,3,1,4,75.0%,22m
26342,2,ikros,2596,0,3,2,5,60.0%,4m
26342,3,Racetrack,2596,0,2,4,6,33.3%,30m
26342,2,[SCCoop]CôEmMaCàRông,2596,0,1,0,1,100.0%,55m
26342,1,[umadID]BlackWidow,2596,0,1,0,1,100.0%,46m
26342,1,Losche,2596,0,1,0,1,100.0%,1h
26342,1,Sharpe,2596,0,1,0,1,100.0%,1h
26342,2,[HRZCOK]sPiKe,2596,0,1,2,3,33.3%,32m
26342,1,[strtgy]NeuH,2596,48,1,6,7,14.3%,46m
26342,2,Megatronis,2596,0,0,1,1,0.0%,3h
26374,1,TorpedoDiver,2595,1547,188,178,366,51.4%,7m
26374,1,PopPop,2595,1570,105,100,205,51.2%,3h
26374,2,Lunatic,2595,658,67,53,120,55.8%,1h
26374,2,itzMaybe,2595,847,38,34,72,52.8%,3h
26374,1,deff,2595,447,36,39,75,48.0%,32m
26374,1,kotoxqui,2595,606,27,20,47,57.4%,3h
26374,3,PACO,2595,592,23,26,49,46.9%,2m
26374,1,[XWAQcX]LolmalletteL,2595,589,21,19,40,52.5%,53m
26374,2,[NOSTV]Marcman,2595,580,20,32,52,38.5%,17m
26374,3,[ChiFan]Quetzal,2595,344,14,20,34,41.2%,22m
26374,2,[nieBla]ZoneZero,2595,342,13,7,20,65.0%,23m
26374,1,[NMPro]Roosterfoo,2595,350,13,17,30,43.3%,11m
26374,3,Smashblade,2595,303,11,12,23,47.8%,14m
26374,1,Syous,2595,256,8,11,19,42.1%,1h
26374,2,Sklaper,2595,234,7,4,11,63.6%,20m
26374,2,CDIO,2595,132,7,7,14,50.0%,1h
26374,1,Azzazzin,2595,170,7,11,18,38.9%,15m
26374,2,Noora,2595,198,6,3,9,66.7%,37m
26374,2,ElMecanico,2595,184,5,2,7,71.4%,28m
26374,2,Etherium,2595,168,5,3,8,62.5%,3h
26374,2,KitnKabood,2595,146,4,3,7,57.1%,59m
26374,2,Mimizuku,2595,140,4,5,9,44.4%,1h
26374,1,[DOOHS]Artiiistx,2595,110,4,6,10,40.0%,1h
26374,1,Druggy,2595,119,4,7,11,36.4%,40m
26374,2,[UpxV]escaver,2595,32,2,2,4,50.0%,23m
26374,2,Fingolfin,2595,0,1,0,1,100.0%,3h
26374,2,neo,2595,88,1,1,2,50.0%,3h
26374,1,[C66]Bigpoppa,2595,88,1,3,4,25.0%,49m
26374,1,rFenyx,2595,0,1,3,4,25.0%,3h
26374,2,[CPU1]SubSonic,2595,0,0,2,2,0.0%,1h
26374,1,[AsiEq]Thanhan,2595,0,0,3,3,0.0%,3h
26374,1,Masares,2595,0,0,7,7,0.0%,11m
26406,3,blizardwitch,2594,1521,134,142,276,48.6%,15m
26406,1,Magistrate,2594,1660,65,61,126,51.6%,3h
26406,3,[MrSolo]BOOMKING,2594,1063,56,56,112,50.0%,25m
26406,2,KDGwicK,2594,1424,46,66,112,41.1%,33m
26406,1,JWJW,2594,601,22,18,40,55.0%,3h
26406,1,ChocoboKing,2594,476,21,15,36,58.3%,1h
26406,1,GlockSmok,2594,408,19,22,41,46.3%,55m
26406,2,Milotook,2594,313,14,12,26,53.8%,55m
26406,1,Exitus,2594,332,11,17,28,39.3%,1h
26406,2,[Carton]Aventurero,2594,236,8,5,13,61.5%,3h
26406,1,[AbcCo]Kaminav,2594,220,8,5,13,61.5%,23m
26406,1,MisterCheta,2594,212,8,7,15,53.3%,32m
26406,2,[PVZ50]VodkaApple,2594,212,7,6,13,53.8%,53m
26406,1,BenDover,2594,194,5,10,15,33.3%,3h
26406,1,Heffe,2594,194,5,12,17,29.4%,49m
26406,1,[SCVM]nightkiller,2594,156,4,3,7,57.1%,11m
26406,3,[CHWABO]gasudobles,2594,62,4,5,9,44.4%,39m
26406,2,LegoCoyMan,2594,0,3,5,8,37.5%,60m
26406,2,[Xhyshu]Shioh,2594,30,2,0,2,100.0%,3h
26406,2,[PeSt]Arael,2594,0,1,0,1,100.0%,4m
26406,2,[M1A5]Adare,2594,0,1,0,1,100.0%,1h
26406,2,grgrgrrr,2594,93,1,1,2,50.0%,51m
26406,2,Kierhel,2594,94,1,2,3,33.3%,3h
26406,2,Gold,2594,95,1,6,7,14.3%,1h
26406,1,ElZombie,2594,36,1,8,9,11.1%,29m
26406,2,[Sapbe]ZeroCl,2594,0,0,1,1,0.0%,3h
26406,1,RjdaIII,2594,0,0,2,2,0.0%,49m
26433,3,Outlier,2593,1550,249,244,493,50.5%,34m
26433,3,terminator,2593,1466,110,104,214,51.4%,8m
26433,1,DKingLinch,2593,1195,73,79,152,48.0%,3h
26433,3,[msNms]Spizzo,2593,1470,70,78,148,47.3%,42m
26433,2,jaytee,2593,1514,65,48,113,57.5%,23m
26433,2,Wutsherface,2593,1059,58,44,102,56.9%,32m
26433,3,kotino,2593,1208,49,51,100,49.0%,39m
26433,2,KINGDANK,2593,854,41,32,73,56.2%,3m
26433,3,[TeRr4n]AndresBosco,2593,683,35,37,72,48.6%,32m
26433,2,[boeuf]Gateaux,2593,819,33,27,60,55.0%,1h
26433,2,chunky,2593,768,25,46,71,35.2%,43m
26433,2,RoosterAfro,2593,593,24,23,47,51.1%,6m
26433,2,[Paus3d]BLivesMatr,2593,376,18,16,34,52.9%,3h
26433,1,chinloko,2593,344,13,14,27,48.1%,11m
26433,2,Thomas,2593,294,13,14,27,48.1%,1h
26433,2,zzzz,2593,307,12,13,25,48.0%,2m
26433,2,Forsaken,2593,198,7,6,13,53.8%,50m
26433,1,SteelSpeedy,2593,239,7,11,18,38.9%,3h
26433,3,player,2593,166,5,2,7,71.4%,14m
26433,2,Evilcedric,2593,95,5,4,9,55.6%,3h
26433,2,[SSEAS]DemonSlayer,2593,88,5,6,11,45.5%,3h
26433,2,[Tiddys]Typhus,2593,94,4,2,6,66.7%,1h
26433,1,CannibalKarl,2593,118,4,10,14,28.6%,52m
26433,1,llllllllllll,2593,0,3,1,4,75.0%,36m
26433,1,GigiPiscu,2593,123,2,4,6,33.3%,3h
26433,1,Excon,2593,80,2,6,8,25.0%,55m
26433,2,opFor,2593,0,1,1,2,50.0%,1h
26433,2,BigBob,2593,30,1,2,3,33.3%,27m
26433,2,TheLegiOn,2593,0,1,2,3,33.3%,1h
26433,2,yumedoko,2593,0,0,1,1,0.0%,4m
26463,2,[1for2]GeneralGhost,2592,1615,247,234,481,51.4%,1h
26463,1,Kuds,2592,1617,226,220,446,50.7%,1h
26463,2,Williaz,2592,1247,109,104,213,51.2%,13m
26463,3,Decepticon,2592,1540,108,115,223,48.4%,15m
26463,2,Sildenafil,2592,939,57,53,110,51.8%,28m
26463,1,ChimpStrngth,2592,1069,36,38,74,48.6%,11m
26463,1,Drew,2592,854,28,34,62,45.2%,23m
26463,2,Heist,2592,664,24,24,48,50.0%,1h
26463,1,BigBird,2592,530,20,19,39,51.3%,1h
26463,1,darkdan,2592,331,8,10,18,44.4%,58m
26463,2,frostydog,2592,204,7,6,13,53.8%,1h
26463,3,Jindo,2592,86,7,6,13,53.8%,16m
26463,1,[s1K]xXNimaXx,2592,204,5,8,13,38.5%,53m
26463,2,SaintEzlon,2592,154,4,1,5,80.0%,33m
26463,2,SirStichUp,2592,86,3,3,6,50.0%,49m
26463,1,Jeff,2592,112,3,8,11,27.3%,31m
26463,2,Karplyuk,2592,32,2,1,3,66.7%,35m
26463,2,karlmarxred,2592,0,2,3,5,40.0%,3h
26463,2,Acharat,2592,0,1,0,1,100.0%,3h
26463,2,[8CAsh]ATM,2592,0,1,0,1,100.0%,3h
26463,3,LETME,2592,0,1,0,1,100.0%,1h
26463,2,Assembly,2592,0,1,0,1,100.0%,16m
26463,2,luisferaoi,2592,0,1,1,2,50.0%,33m
26463,2,[Discor]Iolar,2592,30,1,2,3,33.3%,2m
26463,1,Eisenhorn,2592,91,1,4,5,20.0%,3h
26488,1,SubZero,2591,1667,230,221,451,51.0%,40m
26488,2,[xLgNx]Aidzula,2591,1489,121,119,240,50.4%,39m
26488,1,Ftoss,2591,1628,109,101,210,51.9%,25m
26488,1,PAGF,2591,1370,99,88,187,52.9%,55m
26488,1,BRod,2591,1614,85,85,170,50.0%,3h
26488,1,HanDSomeP,2591,1468,77,77,154,50.0%,28m
26488,2,Elric,2591,1243,50,45,95,52.6%,43m
26488,2,iNguyen,2591,1094,44,60,104,42.3%,21m
26488,2,Thanatos,2591,754,34,36,70,48.6%,38m
26488,1,blink,2591,456,30,32,62,48.4%,3h
26488,3,Andromedus,2591,574,22,29,51,43.1%,7m
26488,1,LaughingPug,2591,569,18,18,36,50.0%,25m
26488,1,AgentZ,2591,237,17,16,33,51.5%,3h
26488,2,[BigK]alejadro,2591,400,15,13,28,53.6%,5m
26488,1,PiterFuentes,2591,410,13,16,29,44.8%,3h
26488,1,[MAR1]pYami,2591,379,12,11,23,52.2%,52m
26488,1,Raidillon,2591,379,12,14,26,46.2%,1h
26488,2,Klem,2591,300,11,9,20,55.0%,3h
26488,2,mishiprro,2591,251,10,2,12,83.3%,3h
26488,2,[Mntaya]erwin,2591,245,9,3,12,75.0%,1h
26488,2,Sipecor,2591,262,9,7,16,56.2%,23m
26488,1,Myth,2591,231,7,8,15,46.7%,18m
26488,3,FrostHorneth,2591,210,7,8,15,46.7%,26m
26488,2,DrMuelitas,2591,90,4,3,7,57.1%,1h
26488,1,mike,2591,91,2,2,4,50.0%,8m
26488,2,[second]Ganymede,2591,0,2,5,7,28.6%,7m
26488,1,[GeekA]DarthJulius,2591,70,2,6,8,25.0%,1h
26488,1,Jeniba,2591,74,2,6,8,25.0%,3h
26488,2,[zto]USX,2591,0,1,0,1,100.0%,51m
26488,2,Anthony,2591,0,1,0,1,100.0%,1h
26488,2,[ZTemp]Alfred,2591,30,1,1,2,50.0%,38m
26488,1,SuzyQQQ,2591,0,1,1,2,50.0%,33m
26488,2,Chibabti,2591,46,1,3,4,25.0%,1h
26488,1,PulloutKing,2591,0,1,6,7,14.3%,3h
26488,2,basuraman,2591,0,0,1,1,0.0%,3m
26488,2,KirinPham,2591,0,0,1,1,0.0%,51m
26488,3,BrYaLeXander,2591,0,0,1,1,0.0%,51m
26488,2,bASSist,2591,0,0,3,3,0.0%,40m
26488,2,DocJuandy,2591,0,0,3,3,0.0%,3h
26488,3,SrRed,2591,0,0,5,5,0.0%,59m
26528,1,Xeras,2590,828,72,66,138,52.2%,1h
26528,2,Sandman,2590,676,47,57,104,45.2%,16m
26528,2,[VFam2]Sirgamermore,2590,574,26,11,37,70.3%,33m
26528,1,[SSSPP]killlometer,2590,397,16,13,29,55.2%,3h
26528,2,Savage,2590,328,13,9,22,59.1%,33m
26528,1,Bloodychaos,2590,398,13,16,29,44.8%,49m
26528,1,Mormegil,2590,263,12,6,18,66.7%,56m
26528,1,Asphyxiate,2590,344,11,13,24,45.8%,4m
26528,1,BigPapi,2590,152,5,10,15,33.3%,1h
26528,2,Taeyang,2590,30,2,0,2,100.0%,51m
26528,2,pingasolina,2590,0,2,2,4,50.0%,33m
26528,2,ReotardoDV,2590,0,1,0,1,100.0%,53m
26528,1,Rametude,2590,0,1,0,1,100.0%,3h
26528,2,maus,2590,0,1,0,1,100.0%,16m
26528,2,GreenMachine,2590,0,1,1,2,50.0%,3h
26528,2,Milox,2590,0,1,3,4,25.0%,3h
26528,1,Fromagerie,2590,36,1,7,8,12.5%,26m
26528,2,[PvZMa]toastyface,2590,0,0,1,1,0.0%,1h
26528,2,ERW,2590,0,0,1,1,0.0%,1h
26528,2,XRyotasX,2590,0,0,1,1,0.0%,3h
26528,1,HomerMatador,2590,0,0,2,2,0.0%,1h
26528,1,FlyingToast,2590,0,0,3,3,0.0%,29m
26550,3,solo,2589,1546,217,221,438,49.5%,37m
26550,1,LockHard,2589,1650,118,106,224,52.7%,3h
26550,1,IIIIIIIIIIII,2589,1212,94,75,169,55.6%,35m
26550,1,Azarsi,2589,1257,81,76,157,51.6%,32m
26550,1,TheSTiG,2589,1562,66,57,123,53.7%,3h
26550,3,ala,2589,1046,40,40,80,50.0%,8m
26550,3,[beleza]Mau,2589,373,39,39,78,50.0%,29m
26550,1,LatinSlave,2589,774,35,24,59,59.3%,55m
26550,1,Neato,2589,791,26,30,56,46.4%,1h
26550,2,cashew,2589,501,22,8,30,73.3%,3m
26550,3,Bwahmer,2589,478,20,18,38,52.6%,11m
26550,2,NAVIAR,2589,261,18,11,29,62.1%,53m
26550,2,llllllllllll,2589,358,12,16,28,42.9%,3h
26550,2,Anrive,2589,218,10,10,20,50.0%,1h
26550,1,william,2589,216,6,8,14,42.9%,1h
26550,2,Slap,2589,166,5,1,6,83.3%,38m
26550,2,[Sn0w]Munktor,2589,124,5,6,11,45.5%,16m
26550,2,Asgard,2589,188,5,8,13,38.5%,6m
26550,2,Shakuras,2589,172,5,12,17,29.4%,40m
26550,2,[LWTB]Cheese,2589,136,4,1,5,80.0%,3h
26550,2,terratron,2589,65,4,3,7,57.1%,52m
26550,2,DamianKaneza,2589,60,3,0,3,100.0%,1h
26550,2,OnyxMario,2589,122,3,1,4,75.0%,6m
26550,2,[No0Bs]Poiza,2589,92,3,6,9,33.3%,3h
26550,2,Heckyeah,2589,30,2,1,3,66.7%,1h
26550,2,abc,2589,0,1,0,1,100.0%,3h
26550,2,anonymousDog,2589,0,1,0,1,100.0%,3h
26550,2,Atrius,2589,93,1,1,2,50.0%,19m
26550,2,serbnz,2589,30,1,1,2,50.0%,1h
26550,1,Dngercarrot,2589,36,1,6,7,14.3%,3h
26550,1,Adezx,2589,40,1,6,7,14.3%,53m
26550,2,CrzyJester,2589,0,0,1,1,0.0%,7m
26550,2,TheAxe,2589,0,0,2,2,0.0%,3h
26550,2,SumTingWong,2589,0,0,7,7,0.0%,3h
26584,3,egrojtheogre,2588,1554,213,213,426,50.0%,29m
26584,1,eRRRpAKI,2588,1537,84,72,156,53.8%,8m
26584,3,TIBZ,2588,561,64,63,127,50.4%,17m
26584,2,Kirito,2588,1604,62,62,124,50.0%,1h
26584,1,DarkZirius,2588,500,29,33,62,46.8%,3h
26584,3,dzenukes,2588,816,27,33,60,45.0%,25m
26584,1,sleepybear,2588,458,26,28,54,48.1%,17m
26584,1,[Atira]Nutrino,2588,713,24,24,48,50.0%,3h
26584,2,IIIIIIIIIIII,2588,598,22,22,44,50.0%,28m
26584,1,Kome,2588,475,17,14,31,54.8%,3h
26584,2,SALTAPATRAS,2588,398,15,14,29,51.7%,38m
26584,2,AznEquation,2588,308,11,6,17,64.7%,3h
26584,2,Xantoniel,2588,245,7,8,15,46.7%,1h
26584,1,shdwpuppet,2588,162,6,8,14,42.9%,3h
26584,2,danebear,2588,159,4,4,8,50.0%,1h
26584,2,zkht,2588,0,3,6,9,33.3%,30m
26584,3,BroliN,2588,0,2,3,5,40.0%,59m
26584,2,John,2588,103,2,3,5,40.0%,51m
26584,2,Escendo,2588,0,1,0,1,100.0%,47m
26584,3,[SyLx]jack,2588,0,1,1,2,50.0%,1h
26584,2,Phoebe,2588,0,1,3,4,25.0%,33m
26584,2,SKELEER,2588,46,1,5,6,16.7%,7m
26584,2,[Pvvny]Bashton,2588,0,0,1,1,0.0%,1h
26607,1,Weezy,2587,1685,148,131,279,53.0%,52m
26607,3,GscDarkiL,2587,1337,135,128,263,51.3%,4m
26607,2,Kentucky,2587,1470,132,115,247,53.4%,43m
26607,3,CrypReaver,2587,1398,74,64,138,53.6%,26m
26607,1,Blank,2587,1200,44,42,86,51.2%,1h
26607,2,[TSOTI]DeathnDisco,2587,334,17,9,26,65.4%,50m
26607,1,HANS,2587,334,14,17,31,45.2%,28m
26607,1,AreYouMadYet,2587,252,7,11,18,38.9%,1h
26607,2,Zeeaan,2587,154,6,3,9,66.7%,3h
26607,2,vash,2587,98,5,6,11,45.5%,3h
26607,2,PaTureBa,2587,88,4,2,6,66.7%,40m
26607,2,fadedspice,2587,94,4,5,9,44.4%,38m
26607,2,DreamAtlas,2587,137,4,5,9,44.4%,1h
26607,2,PHANTOM,2587,6,2,2,4,50.0%,38m
26607,3,SuperTets,2587,0,2,3,5,40.0%,21m
26607,2,andiro,2587,0,1,0,1,100.0%,3h
26607,2,IsaacAsimov,2587,30,1,1,2,50.0%,20m
26607,1,ColdFusion,2587,46,1,3,4,25.0%,3h
26607,1,PeruvianMan,2587,0,1,3,4,25.0%,23m
26607,2,[4METAL]WolFen,2587,0,0,3,3,0.0%,3h
26627,2,Solomon,2586,1573,331,327,658,50.3%,38m
26627,2,Renegade,2586,1651,237,218,455,52.1%,3h
26627,1,QQHan,2586,1597,182,173,355,51.3%,3h
26627,1,WANGOBANGO,2586,1677,126,122,248,50.8%,32m
26627,2,NewLife,2586,1119,86,74,160,53.8%,1h
26627,2,Ang,2586,704,35,40,75,46.7%,41m
26627,3,[JDG]JIMBITCOIN,2586,956,32,44,76,42.1%,8m
26627,2,PhanToM,2586,623,23,21,44,52.3%,3h
26627,2,[DGotO]Grizzslays,2586,594,23,26,49,46.9%,19m
26627,1,[steel]Aion,2586,373,22,26,48,45.8%,3h
26627,1,TheDrizzle,2586,502,21,15,36,58.3%,1h
26627,2,Mariman,2586,516,18,15,33,54.5%,3h
26627,3,[loTicI]StormBP,2586,527,18,23,41,43.9%,3m
26627,2,sobos,2586,322,14,11,25,56.0%,6m
26627,2,[OD2019]Raise,2586,352,13,7,20,65.0%,1h
26627,1,negatron,2586,318,13,15,28,46.4%,3h
26627,1,Dahgreyman,2586,218,11,15,26,42.3%,19m
26627,1,[UofC]Maladroit,2586,90,6,6,12,50.0%,3h
26627,2,GhostDragon,2586,88,4,1,5,80.0%,23m
26627,2,[BURNIN]VulvaTronics,2586,162,3,3,6,50.0%,3h
26627,2,Grambo,2586,88,3,3,6,50.0%,33m
26627,1,llllllllllll,2586,104,3,6,9,33.3%,3h
26627,2,EntreHojas,2586,58,2,3,5,40.0%,51m
26627,2,CupCakes,2586,60,2,4,6,33.3%,3h
26627,1,damil,2586,0,2,4,6,33.3%,11m
26627,1,MicroJackson,2586,78,2,9,11,18.2%,25m
26627,2,McTwizle,2586,32,1,1,2,50.0%,3h
26627,2,RABS,2586,36,1,1,2,50.0%,1h
26627,2,Ericthered,2586,0,1,4,5,20.0%,1h
26627,2,Bwidow,2586,0,0,2,2,0.0%,3h
26627,2,ZerGUseR,2586,0,0,2,2,0.0%,33m
26627,3,IdgitGaloot,2586,0,0,5,5,0.0%,1h
26659,2,FrescoV,2585,846,84,59,143,58.7%,47m
26659,1,jag,2585,911,58,47,105,55.2%,3h
26659,1,Bobbus,2585,1442,53,59,112,47.3%,1h
26659,2,OGwax,2585,1070,47,39,86,54.7%,33m
26659,1,PGODx,2585,825,29,30,59,49.2%,25m
26659,1,coward,2585,670,27,26,53,50.9%,55m
26659,2,WeaselFace,2585,581,21,18,39,53.8%,11m
26659,1,[GC2042]sooopersonic,2585,510,17,17,34,50.0%,3h
26659,2,Goliath,2585,384,14,15,29,48.3%,3h
26659,3,SpaceCrimes,2585,362,13,16,29,44.8%,26m
26659,3,Moistie,2585,275,11,14,25,44.0%,26m
26659,1,Rocksteady,2585,392,11,15,26,42.3%,1h
26659,3,ttorrrr,2585,287,11,17,28,39.3%,43m
26659,2,[VNZ]aNu,2585,224,9,6,15,60.0%,27m
26659,2,[PrpStU]Proletariat,2585,280,7,1,8,87.5%,3h
26659,2,FINNISHSMURF,2585,92,4,2,6,66.7%,40m
26659,1,TStorm,2585,101,4,13,17,23.5%,53m
26659,2,Jubilador,2585,62,3,3,6,50.0%,53m
26659,1,Zmyth,2585,158,3,6,9,33.3%,3h
26659,2,colorchick,2585,172,3,7,10,30.0%,3h
26659,2,[VTMed]Magdern,2585,30,2,0,2,100.0%,39m
26659,1,MEKANO,2585,121,2,3,5,40.0%,48m
26659,2,MERINOXD,2585,0,1,0,1,100.0%,3h
26659,2,ginabsters,2585,0,1,0,1,100.0%,43m
26659,2,[FOXB]BowsiEU,2585,0,1,4,5,20.0%,39m
26659,1,shortytheman,2585,0,0,1,1,0.0%,59m
26659,2,[XpKAc]Keyn,2585,0,0,1,1,0.0%,1h
26659,2,SeabornSword,2585,0,0,2,2,0.0%,3h
26659,3,Shadams,2585,0,0,4,4,0.0%,22m
26688,1,Pershing,2584,1675,191,174,365,52.3%,3h
26688,3,Wesman,2584,1498,154,153,307,50.2%,2m
26688,1,Rorschach,2584,1181,131,125,256,51.2%,11m
26688,1,CommunistAK,2584,1057,96,74,170,56.5%,1h
26688,1,Frustration,2584,1632,90,87,177,50.8%,3h
26688,1,[GOPERÚ]percyto,2584,1358,57,57,114,50.0%,17m
26688,1,HENRYHOBO,2584,1496,55,58,113,48.7%,3h
26688,2,Silky,2584,1032,49,32,81,60.5%,1h
26688,1,MagnusXtian,2584,1122,41,44,85,48.2%,51m
26688,2,[QMS]RoW,2584,810,37,32,69,53.6%,1h
26688,2,War,2584,742,35,21,56,62.5%,59m
26688,1,Etheros,2584,690,26,21,47,55.3%,60m
26688,1,Cortcyber,2584,564,21,17,38,55.3%,49m
26688,1,[xTQc]Moulehumide,2584,486,15,19,34,44.1%,3h
26688,2,ArchDruid,2584,344,14,6,20,70.0%,53m
26688,1,[YStars]AlphaSystems,2584,484,14,21,35,40.0%,1h
26688,1,TinHenry,2584,164,7,8,15,46.7%,55m
26688,1,asfd,2584,234,7,13,20,35.0%,53m
26688,2,[TGosuB]Nukemaster,2584,115,4,2,6,66.7%,59m
26688,2,GhettoDude,2584,140,4,5,9,44.4%,51m
26688,1,badboyfreud,2584,132,4,9,13,30.8%,3h
26688,1,StarRaft,2584,68,3,3,6,50.0%,1h
26688,3,Underwood,2584,42,3,4,7,42.9%,1h
26688,2,[PCAKE]Benok,2584,121,2,1,3,66.7%,1h
26688,2,Solus,2584,0,2,3,5,40.0%,3h
26688,2,darcharchon,2584,0,2,3,5,40.0%,32m
26688,3,Chyureu,2584,0,2,3,5,40.0%,25m
26688,2,Billy,2584,60,2,4,6,33.3%,3h
26688,2,keno,2584,0,1,0,1,100.0%,1h
26688,2,[Bee]Sharkbait,2584,0,1,0,1,100.0%,1h
26688,2,[JZiRui]JustinD,2584,0,1,1,2,50.0%,53m
26688,1,luyx,2584,0,0,3,3,0.0%,3h
26688,3,TheBetterLai,2584,0,0,10,10,0.0%,2m
26721,2,[Onixx]DracoYuki,2583,1600,120,108,228,52.6%,3h
26721,3,[TPGGXD]noeaguantaa,2583,1130,92,92,184,50.0%,43m
26721,1,kamotechunks,2583,942,70,66,136,51.5%,49m
26721,2,[Rtaz]Gandalf,2583,1293,63,74,137,46.0%,16m
26721,2,SMASH,2583,1312,61,48,109,56.0%,55m
26721,3,MagicHeart,2583,1455,57,69,126,45.2%,40m
26721,1,Dattacker,2583,1027,44,38,82,53.7%,3h
26721,1,cannonrush,2583,943,41,28,69,59.4%,3h
26721,3,Avonac,2583,937,40,48,88,45.5%,35m
26721,2,[TnKn]OlllO,2583,899,34,36,70,48.6%,53m
26721,1,Morgeno,2583,627,20,22,42,47.6%,53m
26721,2,Drale,2583,498,19,15,34,55.9%,4m
26721,3,MauMori,2583,514,19,22,41,46.3%,41m
26721,2,llÀngelsll,2583,420,18,3,21,85.7%,3h
26721,2,panchito,2583,312,14,10,24,58.3%,53m
26721,2,jqhju,2583,260,13,5,18,72.2%,1h
26721,2,Noble,2583,202,9,9,18,50.0%,33m
26721,1,Maurice,2583,219,8,6,14,57.1%,1h
26721,2,SoftBoy,2583,183,8,8,16,50.0%,1h
26721,1,Sniker,2583,231,7,9,16,43.8%,1h
26721,3,[KNinja]NinjaJo,2583,60,5,7,12,41.7%,2m
26721,2,[OnFght]Founiman,2583,154,5,7,12,41.7%,3h
26721,2,Melegnis,2583,134,5,8,13,38.5%,3h
26721,2,Dawg,2583,165,4,4,8,50.0%,1h
26721,2,Mobbins,2583,110,4,6,10,40.0%,3h
26721,1,pefgo,2583,36,3,6,9,33.3%,1h
26721,1,Neeb,2583,32,2,5,7,28.6%,1h
26721,2,Horatius,2583,92,2,6,8,25.0%,50m
26721,2,Kratos,2583,38,1,1,2,50.0%,1h
26721,2,[BfsA]BaLF,2583,36,1,2,3,33.3%,1h
26721,2,xShadow,2583,0,1,2,3,33.3%,3h
26721,2,[xToxic]Flatlander,2583,0,0,1,1,0.0%,33m
26721,2,Penguins,2583,0,0,1,1,0.0%,37m
26721,2,[100T]RGBEAST,2583,0,0,1,1,0.0%,49m
26721,2,[1vsM]Pale,2583,0,0,3,3,0.0%,1h
26721,1,trinket,2583,0,0,4,4,0.0%,1h
26757,2,One,2582,1597,242,226,468,51.7%,3h
26757,1,IGTurfComedy,2582,1286,151,145,296,51.0%,4m
26757,1,Macloud,2582,1605,117,105,222,52.7%,1h
26757,3,Rykurd,2582,1279,86,86,172,50.0%,42m
26757,1,Andrade,2582,1034,71,69,140,50.7%,49m
26757,1,Akillies,2582,770,59,62,121,48.8%,23m
26757,2,Ivanaxo,2582,1342,55,46,101,54.5%,40m
26757,2,Amigo,2582,1046,39,41,80,48.8%,1h
26757,1,Fedaykin,2582,727,26,24,50,52.0%,3h
26757,1,tesla,2582,651,24,24,48,50.0%,51m
26757,3,[AGHS]Shinigami,2582,608,22,30,52,42.3%,7m
26757,2,FuZzy,2582,471,19,10,29,65.5%,1h
26757,2,AdmusSaint,2582,461,18,10,28,64.3%,27m
26757,2,[TY4GG]Crisps,2582,378,14,6,20,70.0%,23m
26757,3,RoorinRyan,2582,197,8,2,10,80.0%,3h
26757,2,[sc2ded]Revival,2582,92,3,5,8,37.5%,4m
26757,3,jaurII,2582,0,2,1,3,66.7%,1h
26757,2,OscarVel,2582,30,2,3,5,40.0%,11m
26757,2,TheDirector,2582,0,2,5,7,28.6%,3h
26757,2,ProtossPete,2582,0,1,0,1,100.0%,3m
26757,2,Pirog,2582,44,1,4,5,20.0%,35m
26757,2,NightMare,2582,0,0,1,1,0.0%,1h
26757,2,ArTNoC,2582,0,0,1,1,0.0%,11m
26757,1,Arcadia,2582,0,0,4,4,0.0%,1h
26781,2,[XpKAc]AbelFabian,2581,1200,61,45,106,57.5%,43m
26781,3,HastyHorse,2581,599,51,49,100,51.0%,37m
26781,1,homosexaul,2581,1372,50,52,102,49.0%,3h
26781,2,RmRfSlash,2581,885,39,28,67,58.2%,25m
26781,2,GranBajoPode,2581,974,35,36,71,49.3%,3h
26781,1,wirorioux,2581,670,32,17,49,65.3%,33m
26781,2,[sk3tch]BillDipperly,2581,706,28,20,48,58.3%,26m
26781,1,Gusto,2581,706,28,24,52,53.8%,22m
26781,1,[PSUMHA]HydeShepard,2581,550,18,19,37,48.6%,60m
26781,3,Zeothul,2581,334,12,18,30,40.0%,19m
26781,1,Gooz,2581,358,11,15,26,42.3%,26m
26781,2,Yamcha,2581,250,8,3,11,72.7%,16m
26781,1,jumpman,2581,220,8,8,16,50.0%,3h
26781,2,Brr,2581,244,8,12,20,40.0%,3h
26781,1,BeastMode,2581,154,5,5,10,50.0%,40m
26781,2,Krutk,2581,120,5,5,10,50.0%,3h
26781,2,food,2581,92,4,1,5,80.0%,33m
26781,2,Behastie,2581,137,2,3,5,40.0%,3h
26781,3,NumbNutz,2581,0,2,4,6,33.3%,59m
26781,1,MrBWin,2581,0,2,4,6,33.3%,32m
26781,2,vik,2581,88,2,4,6,33.3%,3h
26781,1,Ilocler,2581,0,2,4,6,33.3%,27m
26781,1,Sócrates,2581,46,2,5,7,28.6%,3h
26781,2,GeeK,2581,30,1,2,3,33.3%,38m
26781,1,Tinytank,2581,46,1,5,6,16.7%,3h
26781,1,[5252]Jokertrue,2581,0,1,5,6,16.7%,7m
26781,2,[TeamEz]JayWoozer,2581,0,0,3,3,0.0%,1h
26781,3,[APR]Seamour,2581,0,0,5,5,0.0%,16m
26781,2,icantwin,2581,0,0,5,5,0.0%,3h
26810,1,[Lp]Blessmen,2580,1682,330,309,639,51.6%,11m
26810,2,chickenfeast,2580,1512,164,171,335,49.0%,12m
26810,2,Justin,2580,1609,86,84,170,50.6%,35m
26810,3,[UCHlH4]SONGOKU,2580,1351,86,92,178,48.3%,38m
26810,1,[lBoW]WACHO,2580,1678,70,71,141,49.6%,51m
26810,1,Dago,2580,1054,45,33,78,57.7%,53m
26810,1,megapipe,2580,827,38,30,68,55.9%,23m
26810,3,KPwagner,2580,543,18,24,42,42.9%,34m
26810,2,BranTheHuman,2580,471,17,12,29,58.6%,3h
26810,3,[Over1]SUPAPI,2580,378,16,18,34,47.1%,29m
26810,3,NeZeK,2580,355,13,25,38,34.2%,11m
26810,2,BdubzThaG,2580,205,11,7,18,61.1%,22m
26810,1,TheDarkNite,2580,366,11,13,24,45.8%,29m
26810,3,VIKINGS,2580,231,8,2,10,80.0%,26m
26810,2,pompeii,2580,182,7,7,14,50.0%,38m
26810,3,Pistolitas,2580,76,4,6,10,40.0%,28m
26810,1,[BBCR]Feebs,2580,91,4,8,12,33.3%,3h
26810,2,Oswarners,2580,135,3,1,4,75.0%,2m
26810,2,rayit,2580,90,3,3,6,50.0%,37m
26810,2,Ender,2580,0,3,5,8,37.5%,17m
26810,2,[20]CRS,2580,38,2,1,3,66.7%,1h
26810,2,Starsword,2580,0,2,5,7,28.6%,3h
26810,2,Rougenight,2580,32,1,2,3,33.3%,1h
26810,2,GALGO,2580,30,1,2,3,33.3%,1h
26810,2,Frosty,2580,0,0,1,1,0.0%,35m
26810,3,Peloquen,2580,0,0,1,1,0.0%,3h
26810,1,Blenger,2580,0,0,1,1,0.0%,1h
26810,3,[KRTs]barraXXobama,2580,0,0,8,8,0.0%,25m
26838,3,Hotspotter,2579,1537,489,481,970,50.4%,30m
26838,2,DrZejB,2579,1617,245,233,478,51.3%,3h
26838,1,[EZkill]AgentVX,2579,1490,56,57,113,49.6%,11m
26838,3,Vitor,2579,732,52,58,110,47.3%,38m
26838,3,ClamComunity,2579,843,51,63,114,44.7%,24m
26838,2,ByuN,2579,1166,47,42,89,52.8%,1h
26838,1,Matthew,2579,654,44,47,91,48.4%,3h
26838,1,[TATR]Freddy,2579,595,37,41,78,47.4%,3m
26838,1,[ÆON]KeyBumpJones,2579,898,28,33,61,45.9%,23m
26838,2,Julius,2579,466,18,13,31,58.1%,1h
26838,2,[Test42]dbrophy,2579,396,15,9,24,62.5%,3h
26838,1,[ISTC]ShadyMuffin,2579,426,14,16,30,46.7%,37m
26838,2,[FOFD]Jsantillan,2579,348,12,13,25,48.0%,1h
26838,2,Kessel,2579,342,12,14,26,46.2%,1h
26838,1,LTSmash,2579,281,9,12,21,42.9%,3h
26838,2,[ZCCCFE]mas,2579,108,8,5,13,61.5%,1h
26838,1,RenanN,2579,204,8,9,17,47.1%,49m
26838,2,Atmosfir,2579,184,7,10,17,41.2%,23m
26838,2,ClowNeko,2579,62,4,5,9,44.4%,23m
26838,1,FuNdaMentaL,2579,104,3,11,14,21.4%,1h
26838,3,Ade,2579,0,2,3,5,40.0%,34m
26838,1,IIIIIIIIIIII,2579,0,2,4,6,33.3%,48m
26838,3,cuchin,2579,58,2,7,9,22.2%,37m
26838,2,Rob,2579,0,1,0,1,100.0%,28m
26838,2,havoc,2579,0,1,0,1,100.0%,26m
26838,2,Alan,2579,0,1,1,2,50.0%,1h
26838,2,[RnB]IceNine,2579,0,0,1,1,0.0%,3h
26865,2,[zerg89]Alex,2578,1669,124,117,241,51.5%,55m
26865,1,[bsDg]JBMoney,2578,1433,116,86,202,57.4%,23m
26865,2,jaf,2578,811,69,65,134,51.5%,54m
26865,1,RoboTurd,2578,1119,43,39,82,52.4%,48m
26865,2,AMANGBS,2578,624,41,42,83,49.4%,3h
26865,1,[INVADS]Mandalorian,2578,944,40,40,80,50.0%,51m
26865,2,MasterChief,2578,932,35,30,65,53.8%,3h
26865,2,McBlanc,2578,495,27,1,28,96.4%,3h
26865,2,ren,2578,462,17,15,32,53.1%,51m
26865,1,[LQV]Socrator,2578,494,15,23,38,39.5%,49m
26865,1,[IMDSI]Arkoboz,2578,414,13,16,29,44.8%,1h
26865,1,neJANIS,2578,308,10,16,26,38.5%,49m
26865,3,[XpKAc]lenin,2578,270,10,19,29,34.5%,31m
26865,2,MrSparkle,2578,215,9,10,19,47.4%,4m
26865,2,Heatseeker,2578,148,6,3,9,66.7%,55m
26865,2,GUEVARA,2578,158,6,6,12,50.0%,38m
26865,2,Vermillion,2578,62,5,8,13,38.5%,42m
26865,2,Pyron,2578,185,5,9,14,35.7%,31m
26865,3,[RCSM]dapperboxer,2578,141,4,3,7,57.1%,17m
26865,2,[FALURS]Squeeky,2578,104,3,0,3,100.0%,39m
26865,2,Carlitos,2578,120,3,2,5,60.0%,35m
26865,2,spacefire,2578,95,3,5,8,37.5%,1h
26865,3,TheCrazyGoat,2578,92,3,6,9,33.3%,40m
26865,1,JStew,2578,191,3,7,10,30.0%,1h
26865,2,komodowagon,2578,0,2,3,5,40.0%,1h
26865,2,Kommandant,2578,0,2,3,5,40.0%,51m
26865,2,Pineapple,2578,0,0,1,1,0.0%,23m
26865,2,imbaCOMBO,2578,0,0,1,1,0.0%,13m
26893,1,[PHclan]SpEnCeRcOmPh,2577,1696,125,127,252,49.6%,1h
26893,1,Janmooji,2577,1310,102,100,202,50.5%,35m
26893,2,peppercorn,2577,1152,57,24,81,70.4%,43m
26893,3,[Astute]Earlyreraise,2577,1465,57,62,119,47.9%,28m
26893,3,IINomisII,2577,960,38,43,81,46.9%,25m
26893,1,BigPharma,2577,829,35,34,69,50.7%,49m
26893,2,Comfy,2577,341,31,17,48,64.6%,54m
26893,1,Bhageera,2577,586,19,21,40,47.5%,7m
26893,1,[TxT]jimmyneutron,2577,447,16,13,29,55.2%,1h
26893,1,fenix,2577,361,16,14,30,53.3%,3h
26893,1,[FE595]KyroChi,2577,308,12,15,27,44.4%,32m
26893,2,huntdog,2577,232,9,6,15,60.0%,59m
26893,1,MrCoolDude,2577,282,9,11,20,45.0%,3h
26893,1,AlanarKo,2577,254,8,8,16,50.0%,1h
26893,1,Makaveli,2577,154,5,8,13,38.5%,59m
26893,2,PatienceZ,2577,160,4,4,8,50.0%,1h
26893,1,NightWolf,2577,98,3,6,9,33.3%,3h
26893,1,[SHMALO]alien,2577,117,2,3,5,40.0%,30m
26893,3,ZODIAC,2577,0,2,4,6,33.3%,28m
26893,2,Toto,2577,0,1,1,2,50.0%,21m
26893,2,GainsGoblin,2577,30,1,2,3,33.3%,49m
26893,3,Zark,2577,0,1,4,5,20.0%,51m
26893,3,EasyTee,2577,0,0,2,2,0.0%,31m
26916,3,hegelsboner,2576,1419,172,160,332,51.8%,17m
26916,1,Player,2576,832,104,96,200,52.0%,3h
26916,2,[DXPCA]FMCBotGamer,2576,1241,49,41,90,54.4%,3m
26916,1,buttplugz,2576,608,33,37,70,47.1%,37m
26916,3,GEMINUS,2576,541,20,21,41,48.8%,25m
26916,2,KRIS,2576,365,13,11,24,54.2%,50m
26916,2,Whatsittoya,2576,301,9,5,14,64.3%,3h
26916,1,[Syphil]David,2576,284,9,8,17,52.9%,3h
26916,2,skywalker,2576,114,5,6,11,45.5%,23m
26916,1,[T3RA]BooneGoon,2576,114,3,12,15,20.0%,52m
26916,2,drisxyz,2576,44,2,0,2,100.0%,1h
26916,2,saturnity,2576,30,2,0,2,100.0%,45m
26916,2,jlee,2576,30,2,2,4,50.0%,1h
26916,2,Animus,2576,0,2,3,5,40.0%,50m
26916,2,ThomasShelby,2576,0,2,8,10,20.0%,43m
26916,1,[MENDUC]RiverPlate,2576,0,1,1,2,50.0%,3h
26916,2,DarkStar,2576,0,0,1,1,0.0%,3h
26916,2,Master,2576,0,0,1,1,0.0%,2m
26916,2,Sandstorm,2576,0,0,3,3,0.0%,6m
26916,1,moonaiea,2576,0,0,6,6,0.0%,3h
26916,1,DYEL,2576,0,0,7,7,0.0%,3m
26937,2,Dainsleif,2575,1044,101,90,191,52.9%,49m
26937,2,DyrtyByrd,2575,1265,88,89,177,49.7%,20m
26937,1,Prestige,2575,1436,78,89,167,46.7%,3h
26937,3,Dhruv,2575,831,67,73,140,47.9%,23m
26937,1,wtchhnt,2575,1030,53,50,103,51.5%,15m
26937,2,Froman,2575,920,51,44,95,53.7%,47m
26937,2,Corrision,2575,947,43,35,78,55.1%,3h
26937,1,dax,2575,629,18,23,41,43.9%,1h
26937,1,glhf,2575,538,16,20,36,44.4%,37m
26937,2,matchyou,2575,349,13,10,23,56.5%,4m
26937,2,CarlFG,2575,287,12,11,23,52.2%,1h
26937,2,[6G]Jankof,2575,354,12,12,24,50.0%,3h
26937,1,Gaous,2575,266,9,8,17,52.9%,3h
26937,1,PooopDollar,2575,197,9,11,20,45.0%,3h
26937,2,Prime,2575,188,8,5,13,61.5%,1h
26937,2,Ironhearts,2575,237,8,7,15,53.3%,3h
26937,1,Curiosity,2575,191,6,7,13,46.2%,27m
26937,1,JAX,2575,245,6,9,15,40.0%,3h
26937,2,Hydroseven,2575,62,5,8,13,38.5%,38m
26937,1,RonnySCV,2575,148,5,11,16,31.2%,3h
26937,1,AznPak,2575,146,4,11,15,26.7%,3h
26937,2,[DhZexp]DoctorVR,2575,0,3,2,5,60.0%,6m
26937,2,RogueLEphant,2575,90,3,5,8,37.5%,49m
26937,1,acidfenix,2575,36,2,4,6,33.3%,55m
26937,2,Guarus,2575,58,2,6,8,25.0%,1h
26937,2,[XpKAc]alberto,2575,0,1,0,1,100.0%,1h
26937,1,[FFAA]Santorio,2575,95,1,1,2,50.0%,1h
26937,2,killu,2575,36,1,2,3,33.3%,37m
26937,2,benbenben,2575,0,1,3,4,25.0%,3h
26937,2,[77over]ROMANO,2575,32,1,4,5,20.0%,52m
26937,2,PewPewPH,2575,0,0,1,1,0.0%,1h
26937,2,[Over1]joel,2575,0,0,1,1,0.0%,3h
26969,3,tankrush,2574,1623,582,581,1163,50.0%,37m
26969,3,JIM,2574,1299,122,110,232,52.6%,22m
26969,1,[KingSC]Rock,2574,1621,65,70,135,48.1%,3h
26969,2,valkiryion,2574,1272,58,41,99,58.6%,1h
26969,3,General,2574,1024,44,37,81,54.3%,36m
26969,1,winston,2574,663,28,25,53,52.8%,55m
26969,2,SmartMunion,2574,724,28,32,60,46.7%,43m
26969,3,[TGosuC]NuGooYa,2574,598,25,25,50,50.0%,8m
26969,2,palion,2574,548,23,14,37,62.2%,3h
26969,3,Mike,2574,348,15,18,33,45.5%,3m
26969,2,FirstShadow,2574,416,14,18,32,43.8%,3h
26969,2,[WNTR]Liko,2574,142,10,3,13,76.9%,3h
26969,1,Fenrir,2574,264,9,14,23,39.1%,3h
26969,2,LecheAbajo,2574,218,7,3,10,70.0%,1h
26969,2,[UpxV]angel,2574,185,6,1,7,85.7%,55m
26969,1,[0l0l0]TERKANO,2574,190,5,13,18,27.8%,39m
26969,2,[sk3tch]minksta,2574,160,4,2,6,66.7%,54m
26969,1,OBPagan,2574,64,3,11,14,21.4%,53m
26969,2,sault,2574,30,2,0,2,100.0%,38m
26969,2,[MBPug]XCharta,2574,0,2,3,5,40.0%,3h
26969,2,Proximash,2574,0,2,5,7,28.6%,1h
26969,1,HappyTwoBe,2574,121,2,6,8,25.0%,40m
26969,2,Czarlight,2574,30,1,2,3,33.3%,3h
26969,2,kickass,2574,30,1,3,4,25.0%,43m
26969,2,[PCAKE]billythekid,2574,0,0,1,1,0.0%,3h
26969,2,StriderDeath,2574,0,0,1,1,0.0%,3h
26969,2,CowPuncher,2574,0,0,1,1,0.0%,14m
26969,3,TheNobleSixx,2574,0,0,1,1,0.0%,1h
26969,2,eGirl,2574,0,0,2,2,0.0%,52m
26998,1,BuckNasty,2573,1580,263,250,513,51.3%,49m
26998,1,Malthael,2573,1043,44,46,90,48.9%,15m
26998,2,Kratos,2573,558,25,11,36,69.4%,3h
26998,2,narreT,2573,594,24,24,48,50.0%,3h
26998,2,ChillPenguin,2573,428,16,12,28,57.1%,32m
26998,3,LethalBunny,2573,300,10,18,28,35.7%,25m
26998,1,Blade,2573,121,7,12,19,36.8%,3h
26998,2,vikingexplor,2573,172,6,2,8,75.0%,6m
26998,1,BlueBurst,2573,176,6,10,16,37.5%,1h
26998,3,LuisRomero,2573,62,5,8,13,38.5%,25m
26998,1,MackyLain,2573,166,5,9,14,35.7%,4m
26998,3,gravity,2573,202,5,10,15,33.3%,24m
26998,1,[BVR]cuts,2573,210,5,12,17,29.4%,53m
26998,2,[PATM]Typhoon,2573,88,3,4,7,42.9%,1h
26998,1,Arkhamtos,2573,0,3,6,9,33.3%,3h
26998,2,DOGGYSLEAZE,2573,95,2,1,3,66.7%,3h
26998,3,Hinds,2573,0,2,3,5,40.0%,1h
26998,3,Brock,2573,0,2,3,5,40.0%,3h
26998,2,Blizzy,2573,60,2,3,5,40.0%,1h
26998,2,Travis,2573,0,1,0,1,100.0%,1h
26998,2,ThorScream,2573,42,1,4,5,20.0%,3h
26998,2,ricci,2573,0,0,1,1,0.0%,3h
26998,2,cheesytaters,2573,0,0,1,1,0.0%,1h
26998,2,Zelda,2573,0,0,1,1,0.0%,1h
26998,2,Ust,2573,0,0,1,1,0.0%,1h
27023,1,Trovals,2572,1644,366,366,732,50.0%,39m
27023,3,MAU,2572,1531,322,318,640,50.3%,34m
27023,3,guillezamca,2572,1539,214,201,415,51.6%,44m
27023,1,Fabrix,2572,1652,179,164,343,52.2%,23m
27023,1,OldManSam,2572,1606,64,65,129,49.6%,3h
27023,2,[TheDOH]Rodrigo,2572,867,59,48,107,55.1%,47m
27023,2,yiyocraft,2572,534,55,38,93,59.1%,22m
27023,1,Nalateshnia,2572,1092,55,58,113,48.7%,3h
27023,2,Whytho,2572,764,41,9,50,82.0%,32m
27023,2,[LTlord]frozt,2572,854,36,24,60,60.0%,10m
27023,2,Inka,2572,788,30,31,61,49.2%,1h
27023,2,RodolfoGuti,2572,609,26,16,42,61.9%,32m
27023,2,[SINSTR]bichoman,2572,252,24,22,46,52.2%,53m
27023,2,[ALTF04]Mike,2572,461,19,8,27,70.4%,4m
27023,2,CapMarmota,2572,413,16,10,26,61.5%,39m
27023,2,[xKMAx]PandaMech,2572,340,12,8,20,60.0%,55m
27023,1,Evets,2572,322,12,13,25,48.0%,23m
27023,2,[L3]chiubaka,2572,237,8,19,27,29.6%,3h
27023,2,zealis,2572,184,6,5,11,54.5%,3h
27023,1,SudsNBubbles,2572,169,3,4,7,42.9%,3h
27023,3,Urano,2572,121,3,4,7,42.9%,59m
27023,3,vgman,2572,133,3,5,8,37.5%,3h
27023,3,[Neewbe]Boxer,2572,161,3,6,9,33.3%,1h
27023,3,[M1A5]Dominian,2572,0,2,3,5,40.0%,30m
27023,3,COVID,2572,0,2,4,6,33.3%,1h
27023,1,DReaMe,2572,90,2,5,7,28.6%,57m
27023,1,zebidy,2572,72,2,8,10,20.0%,28m
27023,2,[churrr]Thysle,2572,0,1,0,1,100.0%,3h
27023,2,QuiDx,2572,0,1,1,2,50.0%,50m
27023,1,ACES,2572,0,1,3,4,25.0%,3h
27023,2,kingpenguin,2572,30,1,3,4,25.0%,50m
27023,2,[V4D3R]YoungWow,2572,0,0,1,1,0.0%,1h
27023,2,akblabla,2572,0,0,2,2,0.0%,1h
27056,2,[LY0]GameMaker,2571,1236,197,187,384,51.3%,38m
27056,3,Udderball,2571,1297,117,115,232,50.4%,17m
27056,2,MoonCheese,2571,666,103,94,197,52.3%,1h
27056,1,TomCruise,2571,1337,73,69,142,51.4%,3h
27056,1,Tisartktw,2571,1364,52,53,105,49.5%,3h
27056,2,Joel,2571,1016,42,38,80,52.5%,35m
27056,1,[worlf]Mazakykun,2571,996,40,45,85,47.1%,53m
27056,2,KanyeFan,2571,817,35,25,60,58.3%,26m
27056,2,[arum]SubparMar,2571,839,33,27,60,55.0%,3h
27056,1,[WW1]Vrashley,2571,367,29,36,65,44.6%,3h
27056,1,Nesty,2571,654,21,27,48,43.8%,1h
27056,1,qwertycopter,2571,604,19,21,40,47.5%,3h
27056,1,Kyosai,2571,248,17,22,39,43.6%,16m
27056,1,Rayko,2571,404,13,17,30,43.3%,11m
27056,2,[DSGods]HecticViesto,2571,216,10,11,21,47.6%,16m
27056,2,Swather,2571,228,8,4,12,66.7%,3h
27056,1,Darksun,2571,191,7,9,16,43.8%,23m
27056,3,Jimp,2571,203,7,9,16,43.8%,8m
27056,1,[OotG]Malo,2571,163,7,12,19,36.8%,29m
27056,1,iDomikitz,2571,213,6,11,17,35.3%,3h
27056,3,Awp,2571,122,4,16,20,20.0%,40m
27056,2,TheLostSoul,2571,94,2,1,3,66.7%,3h
27056,3,TRIgEr,2571,0,2,3,5,40.0%,1h
27056,2,[IoO7]BigBoy,2571,0,1,0,1,100.0%,6m
27056,1,HomeDepot,2571,88,1,2,3,33.3%,3h
27056,3,orangespire,2571,0,1,4,5,20.0%,3h
27056,3,Sandwichpak,2571,30,1,11,12,8.3%,32m
27056,2,Melfice,2571,0,0,1,1,0.0%,3h
27056,2,[KrAce]AlphaRomeo,2571,0,0,1,1,0.0%,23m
27085,3,George,2570,1581,561,568,1129,49.7%,3m
27085,2,[QcP]Torvic,2570,1490,96,85,181,53.0%,3h
27085,2,EYEN,2570,1616,88,82,170,51.8%,28m
27085,2,Bosha,2570,640,75,72,147,51.0%,3h
27085,2,Ryeezy,2570,1129,58,31,89,65.2%,25m
27085,2,CountZero,2570,1073,55,51,106,51.9%,3h
27085,1,Nubig,2570,1145,50,40,90,55.6%,54m
27085,1,Takenawa,2570,618,43,45,88,48.9%,23m
27085,2,Ohnekanos,2570,660,24,27,51,47.1%,3h
27085,2,Megalectium,2570,579,22,13,35,62.9%,54m
27085,3,BoxNinPlay,2570,335,22,35,57,38.6%,14m
27085,2,[FCKRS]Jshen,2570,402,15,17,32,46.9%,13m
27085,1,RageForger,2570,263,11,12,23,47.8%,49m
27085,1,[SBCG]Judson,2570,278,11,14,25,44.0%,1h
27085,2,Breeze,2570,180,6,8,14,42.9%,51m
27085,2,[0825]andresperuan,2570,69,5,2,7,71.4%,1h
27085,1,xENZOx,2570,174,5,9,14,35.7%,3h
27085,1,GrandManco,2570,152,5,11,16,31.2%,54m
27085,2,[L4Life]Threeppholes,2570,160,4,3,7,57.1%,23m
27085,1,IIIIIIIIIIII,2570,152,4,10,14,28.6%,36m
27085,2,SNAKE,2570,0,3,4,7,42.9%,9m
27085,2,Kharlitos,2570,48,3,7,10,30.0%,32m
27085,2,HENRAYNOR,2570,32,2,0,2,100.0%,1h
27085,2,Trogsucks,2570,30,2,3,5,40.0%,3h
27085,3,Twanz,2570,0,2,4,6,33.3%,2m
27085,1,[RW5150]ogzxro,2570,68,2,7,9,22.2%,49m
27085,2,erichthered,2570,88,1,1,2,50.0%,50m
27085,2,SneakyBig,2570,30,1,1,2,50.0%,3h
27085,2,NovasHusband,2570,30,1,2,3,33.3%,1h
27085,2,[SsaYnS]itchyallover,2570,30,1,3,4,25.0%,10m
27085,1,[FSTM]FireStar,2570,90,1,6,7,14.3%,8m
27085,1,Airstorm,2570,30,1,7,8,12.5%,1h
27085,2,Furby,2570,0,0,1,1,0.0%,28m
27085,1,[LOHc]Rutger,2570,0,0,1,1,0.0%,1h
27085,2,polarstr,2570,0,0,1,1,0.0%,51m
27085,2,Infamous,2570,0,0,1,1,0.0%,3h
27085,2,TheslaveD,2570,0,0,1,1,0.0%,1h
27085,2,CaptainVG,2570,0,0,2,2,0.0%,1h
27085,3,[Patas]FuNNY,2570,0,0,3,3,0.0%,3h
27124,2,sparks,2569,1526,220,223,443,49.7%,14m
27124,2,[TY4GG]Keeshano,2569,1561,193,194,387,49.9%,10m
27124,2,[EpicG]synowin,2569,1553,82,78,160,51.2%,3h
27124,2,Gus,2569,1212,77,69,146,52.7%,38m
27124,2,[DRKRPT]Dillza,2569,1552,71,64,135,52.6%,1h
27124,1,Dandouli,2569,1208,68,61,129,52.7%,39m
27124,2,walnut,2569,1643,67,65,132,50.8%,50m
27124,3,xXMrTrollXx,2569,646,47,46,93,50.5%,39m
27124,1,Colacao,2569,847,40,30,70,57.1%,23m
27124,1,ArtieWFG,2569,1091,39,41,80,48.8%,3h
27124,2,ArthurDent,2569,876,36,23,59,61.0%,3h
27124,2,[BOLVIA]ricksanchez,2569,550,21,17,38,55.3%,1h
27124,2,ElementaL,2569,196,17,6,23,73.9%,55m
27124,1,[Calx]guillermo,2569,415,12,18,30,40.0%,3h
27124,2,furry,2569,274,10,17,27,37.0%,34m
27124,2,Archnimzo,2569,281,9,9,18,50.0%,45m
27124,2,Brohammid,2569,224,8,10,18,44.4%,1h
27124,2,Virre,2569,136,4,0,4,100.0%,22m
27124,2,STUXVII,2569,128,4,5,9,44.4%,55m
27124,3,[BoAVN]Metablade,2569,145,3,1,4,75.0%,21m
27124,2,metralha,2569,144,3,2,5,60.0%,53m
27124,2,Quazar,2569,30,2,2,4,50.0%,5m
27124,2,daywalker,2569,60,2,2,4,50.0%,51m
27124,2,[lHUGl]Zhorus,2569,62,2,3,5,40.0%,12m
27124,2,Gumii,2569,0,2,3,5,40.0%,32m
27124,1,[TaWa]Nowel,2569,42,2,4,6,33.3%,3h
27124,3,[TrDoS]Gokit,2569,0,1,0,1,100.0%,30m
27151,2,froztycat,2568,1640,147,145,292,50.3%,3h
27151,2,Nazareth,2568,1010,86,101,187,46.0%,25m
27151,2,Axios,2568,1395,62,42,104,59.6%,3h
27151,2,VaeVictisSC,2568,983,45,44,89,50.6%,3h
27151,2,FunkyDrummer,2568,1293,45,57,102,44.1%,17m
27151,1,Rajauskas,2568,448,19,15,34,55.9%,1h
27151,1,Hachiko,2568,303,13,9,22,59.1%,3h
27151,2,Letsu,2568,258,11,9,20,55.0%,55m
27151,2,[TMSyN]ChieF,2568,207,7,4,11,63.6%,39m
27151,1,AlexSwet,2568,213,6,7,13,46.2%,18m
27151,2,[SINSTR]emmanuelgx,2568,118,5,2,7,71.4%,1h
27151,1,[cluez]henferper,2568,103,5,6,11,45.5%,3h
27151,3,Cynkar,2568,30,4,7,11,36.4%,25m
27151,3,[nbgPH]Napster,2568,97,3,2,5,60.0%,1h
27151,2,Kstor,2568,58,2,1,3,66.7%,13m
27151,1,Danyk,2568,95,2,1,3,66.7%,37m
27151,2,[Nu]Apophis,2568,0,1,0,1,100.0%,3h
27151,3,DragonBlood,2568,0,1,1,2,50.0%,60m
27151,2,[GAA20]DeathAngel,2568,0,1,3,4,25.0%,1h
27151,2,[Macac0]RickRoss,2568,0,0,1,1,0.0%,1h
27151,2,bob,2568,0,0,1,1,0.0%,53m
27151,2,Boognish,2568,0,0,1,1,0.0%,1h
27151,2,JanyeWest,2568,0,0,2,2,0.0%,3h
27151,2,EscherAU,2568,0,0,2,2,0.0%,53m
27151,2,ArctuL,2568,0,0,5,5,0.0%,21m
27176,1,chan,2567,1702,149,145,294,50.7%,3h
27176,2,LoudChris,2567,1560,148,129,277,53.4%,1h
27176,1,MincheRrat,2567,866,52,51,103,50.5%,3h
27176,1,sasson,2567,1362,51,55,106,48.1%,29m
27176,2,Frijolito,2567,935,45,29,74,60.8%,1h
27176,2,LukeBR,2567,887,37,31,68,54.4%,1h
27176,1,Rex,2567,791,30,27,57,52.6%,3h
27176,2,Latinloover,2567,694,28,25,53,52.8%,45m
27176,1,Augusto,2567,684,27,26,53,50.9%,3h
27176,2,myLOWapmOWNu,2567,336,19,16,35,54.3%,28m
27176,1,Mabller,2567,370,12,14,26,46.2%,53m
27176,2,swayce,2567,215,10,10,20,50.0%,3h
27176,2,RaZZ,2567,272,9,8,17,52.9%,3h
27176,1,Espartanlf,2567,284,8,12,20,40.0%,54m
27176,2,kowenje,2567,182,7,6,13,53.8%,1h
27176,2,Polkg,2567,140,5,0,5,100.0%,22m
27176,2,[XZL]leon,2567,118,5,3,8,62.5%,35m
27176,1,BigÐickRick,2567,105,4,5,9,44.4%,3h
27176,2,mewthree,2567,102,3,5,8,37.5%,1h
27176,2,Darcii,2567,102,2,3,5,40.0%,3h
27176,1,[NEVG]Cbog,2567,141,2,10,12,16.7%,1h
27176,2,Nightowl,2567,30,1,1,2,50.0%,1h
27176,2,hankito,2567,30,1,1,2,50.0%,41m
27176,2,[RvN]AquilesJump,2567,30,1,4,5,20.0%,3h
27176,2,[NOPENE]BAGRE,2567,0,0,2,2,0.0%,3h
27201,1,[b1azin]Script,2566,1575,167,158,325,51.4%,49m
27201,1,BobLobLaw,2566,1481,143,124,267,53.6%,3h
27201,2,[NIF]Alfa,2566,1590,72,62,134,53.7%,3h
27201,2,bovine,2566,1042,42,39,81,51.9%,3h
27201,2,Exdeath,2566,628,28,17,45,62.2%,1h
27201,3,panicfrog,2566,716,23,36,59,39.0%,12m
27201,2,[CH1MP]Lemono,2566,185,7,3,10,70.0%,35m
27201,1,Practice,2566,202,7,8,15,46.7%,1h
27201,2,MaRiNe,2566,114,6,2,8,75.0%,34m
27201,1,Sealdelta,2566,144,5,6,11,45.5%,11m
27201,1,[PiGPan]Brain,2566,102,5,9,14,35.7%,1h
27201,2,[WAYV]billsthedog,2566,90,4,3,7,57.1%,1h
27201,2,BastoInst,2566,90,4,4,8,50.0%,3h
27201,2,morehardcore,2566,112,4,5,9,44.4%,1h
27201,1,Vector,2566,60,4,13,17,23.5%,23m
27201,2,[GRYRE]BilboBaggins,2566,86,3,3,6,50.0%,38m
27201,2,JuliusCeaser,2566,138,3,3,6,50.0%,23m
27201,2,YOSHIRO,2566,30,2,0,2,100.0%,1h
27201,2,[BURKE]Dover,2566,32,2,1,3,66.7%,3h
27201,2,Shadow,2566,58,2,2,4,50.0%,51m
27201,2,Terminator,2566,0,2,2,4,50.0%,1h
27201,2,Teranasaurus,2566,0,2,3,5,40.0%,1h
27201,2,UTNHELLFIRE,2566,60,2,5,7,28.6%,12m
27201,1,ReD,2566,124,2,6,8,25.0%,3h
27201,2,Wallace,2566,36,1,2,3,33.3%,1h
27201,2,[LPEM]JRZM,2566,97,1,2,3,33.3%,51m
27201,2,GeOaLe,2566,30,1,3,4,25.0%,1h
27201,2,WarTorn,2566,36,1,4,5,20.0%,1h
27201,3,ScarletYNEZ,2566,0,0,1,1,0.0%,20m
27201,2,TheGodmentha,2566,0,0,1,1,0.0%,38m
27201,2,Zeniba,2566,0,0,1,1,0.0%,6m
27232,3,Mainxenocide,2565,1116,263,255,518,50.8%,14m
27232,3,[VrNice]Perix,2565,1500,119,116,235,50.6%,30m
27232,3,Magnetar,2565,1431,105,106,211,49.8%,28m
27232,2,[BfLaD]Jayjuan,2565,1230,98,79,177,55.4%,3h
27232,3,dex,2565,1522,67,67,134,50.0%,8m
27232,1,HALOOS,2565,1529,65,69,134,48.5%,53m
27232,2,ZerGi,2565,1359,60,39,99,60.6%,51m
27232,2,RaCeL,2565,1129,47,38,85,55.3%,35m
27232,2,[blacLM]SOS,2565,778,30,25,55,54.5%,52m
27232,2,LoneWolf,2565,692,27,22,49,55.1%,33m
27232,1,Spendle,2565,756,27,30,57,47.4%,13m
27232,2,Elwaifu,2565,680,26,18,44,59.1%,3h
27232,1,[JM2]beecookie,2565,562,24,22,46,52.2%,43m
27232,2,OrganicOwl,2565,660,24,22,46,52.2%,1h
27232,1,toditron,2565,682,21,25,46,45.7%,1h
27232,2,ABabyKoala,2565,415,18,15,33,54.5%,33m
27232,1,[TuBE]Woltube,2565,438,17,18,35,48.6%,15m
27232,1,ReyLatino,2565,384,15,22,37,40.5%,60m
27232,1,josh,2565,356,11,15,26,42.3%,3h
27232,2,[SANGRE]Basganar,2565,184,9,8,17,52.9%,1h
27232,2,CIDER,2565,265,9,10,19,47.4%,3h
27232,1,[gr4nd3]Kikaro,2565,329,9,11,20,45.0%,4m
27232,1,StarScream,2565,279,9,12,21,42.9%,3h
27232,1,Punizzle,2565,312,9,16,25,36.0%,56m
27232,1,Diaw,2565,204,8,7,15,53.3%,55m
27232,2,[nSGI]alwaysTrigrd,2565,263,8,9,17,47.1%,3h
27232,1,brainsrgood,2565,211,7,10,17,41.2%,3h
27232,2,TaZ,2565,96,3,9,12,25.0%,1h
27232,2,silray,2565,30,2,2,4,50.0%,3h
27232,3,[Stokr]Lee,2565,0,2,3,5,40.0%,17m
27232,2,[FARGAR]RoyalBenson,2565,60,2,6,8,25.0%,3h
27232,2,Debonair,2565,0,1,0,1,100.0%,1h
27232,2,Smileyfase,2565,0,1,0,1,100.0%,35m
27232,3,Toxic,2565,0,1,1,2,50.0%,30m
27232,1,SCV,2565,88,1,3,4,25.0%,1h
27232,2,OneA,2565,0,0,1,1,0.0%,3h
27232,1,JimRaynor,2565,0,0,1,1,0.0%,1h
27232,2,[BkAt]Ivhuis,2565,0,0,3,3,0.0%,52m
27232,2,IIIIIIlIlIlI,2565,0,0,5,5,0.0%,3h
27271,3,[jugoso]THENAME,2564,1537,179,184,363,49.3%,23m
27271,2,Duatithoi,2564,1248,74,59,133,55.6%,1h
27271,3,killa,2564,1492,71,75,146,48.6%,22m
27271,1,ShadowMe,2564,891,33,36,69,47.8%,49m
27271,1,[GØSU]Virtual,2564,778,26,33,59,44.1%,15m
27271,2,Pabloterror,2564,610,24,19,43,55.8%,55m
27271,3,PsiMatrix,2564,698,23,35,58,39.7%,22m
27271,1,AeaMan,2564,496,18,15,33,54.5%,3h
27271,1,[DhZAc1]NightFour,2564,415,17,16,33,51.5%,40m
27271,2,[CUMIES]Gia,2564,216,15,5,20,75.0%,1h
27271,2,Popeye,2564,380,13,13,26,50.0%,1h
27271,2,[smpbz]gwashington,2564,335,12,22,34,35.3%,36m
27271,2,[UpxV]Marrows,2564,301,11,6,17,64.7%,18m
27271,2,CapsJr,2564,233,10,1,11,90.9%,3h
27271,2,[btrks]JeanBlast,2564,204,8,8,16,50.0%,1h
27271,1,[HTP450]angel,2564,210,5,6,11,45.5%,1h
27271,2,Tethgret,2564,92,4,3,7,57.1%,3h
27271,2,[OGDRTY]FrankyMerman,2564,135,3,3,6,50.0%,55m
27271,2,[anti5z]Aldaris,2564,68,2,2,4,50.0%,32m
27271,2,TrevorSeeth,2564,0,1,0,1,100.0%,1h
27271,3,DonMoses,2564,36,1,2,3,33.3%,1h
27271,3,whiterice,2564,0,1,4,5,20.0%,34m
27271,1,Deceptichron,2564,0,1,6,7,14.3%,3h
27271,2,BMan,2564,0,0,1,1,0.0%,1h
27271,3,[Tiddys]SauceMaster,2564,0,0,2,2,0.0%,1h
27271,2,[Alpha8]Uniquebpm,2564,0,0,3,3,0.0%,4m
27297,1,Cloverfield,2563,1650,186,177,363,51.2%,48m
27297,1,rego,2563,1634,90,74,164,54.9%,1h
27297,2,[iS1MP]thomas,2563,1300,66,36,102,64.7%,50m
27297,2,Fbpro,2563,610,51,39,90,56.7%,37m
27297,1,Demexo,2563,758,35,32,67,52.2%,1h
27297,1,Taxman,2563,623,32,28,60,53.3%,3h
27297,2,Ktonamor,2563,823,32,31,63,50.8%,1h
27297,1,VictorTM,2563,749,29,25,54,53.7%,30m
27297,2,PiterPunker,2563,423,19,8,27,70.4%,3h
27297,2,[FxB]Revenant,2563,153,14,8,22,63.6%,53m
27297,2,KKangs,2563,306,13,10,23,56.5%,3h
27297,2,FranticRage,2563,328,12,8,20,60.0%,37m
27297,1,[LTWAR]BRICK,2563,264,10,10,20,50.0%,23m
27297,2,Billy,2563,251,9,4,13,69.2%,55m
27297,2,KrazyFarm,2563,135,7,3,10,70.0%,3h
27297,2,[1944]Zaredos,2563,102,4,4,8,50.0%,23m
27297,3,lucasispapa,2563,68,4,4,8,50.0%,1h
27297,2,[Albino]ItsHappening,2563,86,3,4,7,42.9%,38m
27297,1,solarknight,2563,0,2,4,6,33.3%,3h
27297,2,Xbuster,2563,70,2,5,7,28.6%,1h
27297,3,[MSTRD]GrImReApEr,2563,129,2,6,8,25.0%,3h
27297,2,Patrick,2563,92,1,1,2,50.0%,1h
27297,2,[FMX]Restaurador,2563,96,1,2,3,33.3%,3h
27297,1,TheScientist,2563,0,1,2,3,33.3%,1h
27297,2,Hedzu,2563,97,1,2,3,33.3%,1h
27297,1,Thunder,2563,48,1,3,4,25.0%,3h
27297,2,[GpsyDg]Shadow,2563,0,0,1,1,0.0%,37m
27297,2,Sterber,2563,0,0,1,1,0.0%,1h
27297,2,[LBGF]anslod,2563,0,0,3,3,0.0%,1h
27297,2,[DETER]ChaosSquirre,2563,0,0,3,3,0.0%,50m
27327,1,Commander,2562,1621,102,98,200,51.0%,3h
27327,1,vamak,2562,1441,76,81,157,48.4%,54m
27327,2,xyKara,2562,578,70,75,145,48.3%,23m
27327,1,TheOne,2562,1543,65,66,131,49.6%,56m
27327,1,NOMOOKOON,2562,1497,50,87,137,36.5%,9m
27327,1,spacecowboy,2562,1126,46,46,92,50.0%,1h
27327,3,[xLgNx]IamGroot,2562,335,43,52,95,45.3%,8m
27327,2,GOPbIHbI,2562,864,36,31,67,53.7%,3m
27327,3,ArthurTei,2562,854,31,35,66,47.0%,3m
27327,2,XxMisoxX,2562,562,30,27,57,52.6%,1h
27327,2,ElectronNine,2562,747,29,24,53,54.7%,34m
27327,1,MercYD,2562,544,27,28,55,49.1%,3h
27327,2,CostaRica,2562,500,19,17,36,52.8%,1h
27327,1,Aquinokira,2562,341,13,13,26,50.0%,49m
27327,2,wilber,2562,240,10,1,11,90.9%,35m
27327,1,SWAGpocalyps,2562,309,9,11,20,45.0%,3h
27327,2,[3Drs]rObOdOg,2562,226,8,9,17,47.1%,1h
27327,1,IrmaGurd,2562,152,7,9,16,43.8%,32m
27327,2,[Pearm]Ryan,2562,0,4,1,5,80.0%,3h
27327,2,Gaunce,2562,74,4,5,9,44.4%,18m
27327,2,LuNar,2562,157,4,5,9,44.4%,16m
27327,2,tgsgds,2562,116,3,1,4,75.0%,39m
27327,2,[WolfGT]abnerPF,2562,90,3,3,6,50.0%,18m
27327,1,Terran,2562,48,2,0,2,100.0%,3h
27327,2,Glaedr,2562,32,2,1,3,66.7%,1h
27327,1,iNiQuitY,2562,0,2,4,6,33.3%,3h
27327,2,[MadK]Aldarick,2562,58,2,4,6,33.3%,3h
27327,2,Cyclone,2562,0,1,0,1,100.0%,26m
27327,2,Wibze,2562,32,1,1,2,50.0%,52m
27327,2,meliner,2562,0,1,1,2,50.0%,26m
27327,2,Ekis,2562,30,1,3,4,25.0%,1h
27327,2,ritual,2562,0,0,1,1,0.0%,1h
27327,2,[Onnor]colonelxc,2562,0,0,2,2,0.0%,1h
27327,2,[Moka]frappuchino,2562,0,0,2,2,0.0%,1h
27327,1,BlackBloc,2562,0,0,5,5,0.0%,1h
27362,1,VichoSalinas,2561,1182,261,235,496,52.6%,3h
27362,1,[INextI]SevenCr,2561,1575,230,239,469,49.0%,60m
27362,2,TukiTukiLuLu,2561,1603,113,100,213,53.1%,3h
27362,1,CandyBear,2561,823,105,97,202,52.0%,1h
27362,1,eddie,2561,1348,90,87,177,50.8%,30m
27362,2,[ffaaak]iqui,2561,1088,42,40,82,51.2%,49m
27362,2,[LGDI]Arenium,2561,922,40,30,70,57.1%,49m
27362,2,[lmLx]Benavente,2561,973,38,36,74,51.4%,32m
27362,1,HockeyKraut,2561,522,17,20,37,45.9%,3h
27362,2,Perseus,2561,357,16,11,27,59.3%,5m
27362,3,SirPickled,2561,307,10,15,25,40.0%,34m
27362,2,SCVready,2561,231,6,7,13,46.2%,33m
27362,1,Sawada,2561,166,6,7,13,46.2%,1h
27362,3,felixrcruz,2561,177,6,10,16,37.5%,8m
27362,2,square,2561,128,5,6,11,45.5%,38m
27362,2,Kataskopos,2561,167,5,6,11,45.5%,2m
27362,1,MartyMcFly,2561,153,4,4,8,50.0%,55m
27362,2,trevol,2561,60,3,3,6,50.0%,51m
27362,2,Manowar,2561,0,2,3,5,40.0%,1h
27362,1,ggman,2561,0,2,4,6,33.3%,5m
27362,3,Xeno,2561,0,2,4,6,33.3%,2m
27362,1,NineRings,2561,0,2,4,6,33.3%,11m
27362,2,[Coatza]Leon,2561,0,1,0,1,100.0%,59m
27362,2,Joputa,2561,0,1,1,2,50.0%,1h
27362,2,RyloKen,2561,0,1,3,4,25.0%,28m
27362,2,VODKANCRAN,2561,30,1,4,5,20.0%,1h
27362,2,cristian,2561,0,0,1,1,0.0%,3h
27362,2,SALT,2561,0,0,1,1,0.0%,26m
27362,2,FartOfDaSwrm,2561,0,0,2,2,0.0%,3h
27391,3,SCTryhard,2560,1569,1145,1176,2321,49.3%,3m
27391,3,Ziggaro,2560,1560,250,241,491,50.9%,11m
27391,3,keman,2560,1528,161,162,323,49.8%,30m
27391,1,Luke,2560,1285,115,111,226,50.9%,23m
27391,2,gogoia,2560,1319,97,100,197,49.2%,17m
27391,1,wuyue,2560,1599,95,98,193,49.2%,3m
27391,1,Netero,2560,1593,81,86,167,48.5%,3h
27391,1,[Macac0]belmont,2560,983,33,37,70,47.1%,3h
27391,2,bEkAchI,2560,753,31,30,61,50.8%,24m
27391,3,[Incred]Shreazla,2560,507,29,39,68,42.6%,4m
27391,2,Pluto,2560,478,21,16,37,56.8%,41m
27391,3,AzzPounder,2560,356,18,23,41,43.9%,26m
27391,2,Negrita,2560,338,12,14,26,46.2%,4m
27391,1,Sancheez,2560,162,8,4,12,66.7%,1h
27391,2,[CBoard]Yummygun,2560,148,7,8,15,46.7%,55m
27391,3,Enkin,2560,30,5,6,11,45.5%,22m
27391,2,[SIKK]iBENsick,2560,92,4,4,8,50.0%,55m
27391,1,rafaMEN,2560,108,4,8,12,33.3%,5m
27391,2,[DkVb]DTCory,2560,0,3,2,5,60.0%,1h
27391,1,Andruidus,2560,120,3,5,8,37.5%,49m
27391,1,[FRJ]SIRSMOOTH,2560,36,3,5,8,37.5%,1h
27391,2,Grinch,2560,40,3,6,9,33.3%,1h
27391,2,[Dogge]tigger,2560,44,3,6,9,33.3%,43m
27391,2,Youaresmelly,2560,88,2,0,2,100.0%,28m
27391,2,Tony,2560,0,1,4,5,20.0%,3h
27391,2,[CLan12]GATO,2560,97,1,5,6,16.7%,1h
27391,3,Daedales,2560,0,0,1,1,0.0%,44m
27418,2,DRAID,2559,1174,123,107,230,53.5%,3h
27418,2,dancun,2559,1165,97,93,190,51.1%,1h
27418,1,MaxLi,2559,597,90,76,166,54.2%,49m
27418,3,Extinction,2559,1543,79,84,163,48.5%,43m
27418,2,Broverlordd,2559,1257,73,70,143,51.0%,3h
27418,2,ardvark,2559,481,71,83,154,46.1%,10m
27418,2,[RAX14]XxReimsSC,2559,1106,53,46,99,53.5%,21m
27418,1,Erock,2559,475,49,52,101,48.5%,1h
27418,2,Mercury,2559,846,47,40,87,54.0%,3h
27418,2,terran,2559,701,31,20,51,60.8%,45m
27418,2,armindroid,2559,825,31,28,59,52.5%,3h
27418,2,DragonSlayer,2559,810,30,32,62,48.4%,3m
27418,1,[99th]Faker,2559,522,21,20,41,51.2%,1h
27418,2,Voltarez,2559,428,15,13,28,53.6%,1h
27418,2,Isaku,2559,294,14,14,28,50.0%,3h
27418,1,litterin,2559,423,13,18,31,41.9%,51m
27418,2,DumAndDumer,2559,297,12,6,18,66.7%,3h
27418,2,chargelot,2559,354,12,15,27,44.4%,3h
27418,1,[PATM]SirCharles,2559,312,10,15,25,40.0%,60m
27418,1,[SIClan]bushido,2559,304,9,17,26,34.6%,1h
27418,1,[LGNxx]LePotter,2559,248,8,11,19,42.1%,3h
27418,1,RUTHLESS,2559,235,7,10,17,41.2%,1h
27418,2,Danger,2559,192,6,8,14,42.9%,51m
27418,2,MadMartigan,2559,118,5,4,9,55.6%,1h
27418,2,Bohjaangles,2559,94,4,4,8,50.0%,39m
27418,2,PartyBoy,2559,146,3,3,6,50.0%,50m
27418,3,riptoast,2559,121,3,4,7,42.9%,3h
27418,2,GrimtheNoble,2559,30,2,0,2,100.0%,3h
27418,3,Boboski,2559,0,2,3,5,40.0%,1h
27418,1,[bugrp]Hazard,2559,0,2,4,6,33.3%,1h
27418,2,chief,2559,0,1,0,1,100.0%,1h
27418,2,[KSRP]LizardPity,2559,0,1,0,1,100.0%,1h
27418,2,Andrex,2559,0,1,0,1,100.0%,3h
27418,1,Cheesus,2559,0,1,0,1,100.0%,46m
27418,2,DaBuDing,2559,0,1,0,1,100.0%,54m
27418,2,alexsebasxd,2559,30,1,1,2,50.0%,10m
27418,2,[5Head]MacroToss,2559,30,1,5,6,16.7%,53m
27455,2,Maybenx,2558,1409,188,180,368,51.1%,28m
27455,1,CHEESEHEAD,2558,1652,139,139,278,50.0%,1h
27455,2,[TnKn]Dolodiar,2558,1222,48,43,91,52.7%,13m
27455,2,[lwhy]RealLeader,2558,667,30,24,54,55.6%,3m
27455,3,BATMAN,2558,687,29,32,61,47.5%,25m
27455,1,DRoyalArmy,2558,461,24,9,33,72.7%,4m
27455,1,[Trigga]chubbles,2558,662,23,29,52,44.2%,15m
27455,1,Chance,2558,557,22,21,43,51.2%,54m
27455,2,[Silica]Hadez,2558,353,21,17,38,55.3%,1h
27455,2,asdfjkl,2558,285,10,6,16,62.5%,32m
27455,1,[SHMT]ToneBone,2558,291,10,7,17,58.8%,28m
27455,3,razE,2558,183,5,5,10,50.0%,3h
27455,1,Sinick,2558,170,5,10,15,33.3%,24m
27455,2,Heisenzerg,2558,140,4,1,5,80.0%,38m
27455,3,WcSkratos,2558,70,4,5,9,44.4%,3h
27455,2,SpaceAgePimp,2558,107,3,4,7,42.9%,3h
27455,1,tobsucht,2558,0,3,4,7,42.9%,1h
27455,2,jmamora,2558,88,2,0,2,100.0%,5m
27455,2,FrancoVS,2558,72,2,2,4,50.0%,34m
27455,2,Alexstrasza,2558,62,2,3,5,40.0%,3h
27455,2,Archer,2558,0,2,3,5,40.0%,35m
27455,2,Wersema,2558,58,2,10,12,16.7%,23m
27455,2,PICKLEREEEEE,2558,0,1,0,1,100.0%,50m
27455,3,Rush,2558,0,1,1,2,50.0%,3h
27455,2,Mak,2558,30,1,3,4,25.0%,39m
27455,2,Terminator,2558,0,0,1,1,0.0%,27m
27455,2,FabohIgnacio,2558,0,0,2,2,0.0%,37m
27455,2,JON,2558,73,0,4,4,0.0%,52m
27483,3,[BAP01]ElChapirete,2557,1545,365,359,724,50.4%,24m
27483,1,Tigran,2557,1628,302,302,604,50.0%,39m
27483,2,Kismet,2557,963,115,94,209,55.0%,3h
27483,1,neoncokein,2557,1654,112,105,217,51.6%,3h
27483,2,ALUCARD,2557,1192,89,75,164,54.3%,37m
27483,1,Inti,2557,1503,81,75,156,51.9%,3h
27483,1,[Lp]CoNcE,2557,807,40,35,75,53.3%,3h
27483,2,Sqwa,2557,935,39,39,78,50.0%,1h
27483,1,ScottWick,2557,1056,35,38,73,47.9%,1h
27483,3,[NTPeru]ZoideX,2557,952,34,45,79,43.0%,39m
27483,2,KillerClown,2557,732,30,20,50,60.0%,50m
27483,1,[PTHero]HyperTurtle,2557,791,29,27,56,51.8%,3h
27483,1,PotatoMan,2557,363,26,29,55,47.3%,24m
27483,2,Arctic,2557,487,17,20,37,45.9%,45m
27483,2,[HØST]Snakespe,2557,354,13,11,24,54.2%,1h
27483,2,[xf3]nApAlm,2557,326,11,10,21,52.4%,41m
27483,2,Kaboos,2557,223,7,8,15,46.7%,3h
27483,2,xreaperx,2557,180,7,9,16,43.8%,3h
27483,3,vultum,2557,244,6,16,22,27.3%,19m
27483,2,Baam,2557,188,5,3,8,62.5%,33m
27483,3,ReadingIsFun,2557,92,5,10,15,33.3%,28m
27483,3,takohunta,2557,0,4,2,6,66.7%,3h
27483,2,Seigaku,2557,120,4,6,10,40.0%,52m
27483,1,aris,2557,116,3,6,9,33.3%,38m
27483,2,[JUGOS2]Miltoniuss,2557,112,2,1,3,66.7%,1h
27483,2,Greatniz,2557,0,2,3,5,40.0%,49m
27483,1,clampKK,2557,48,1,4,5,20.0%,3h
27483,1,Snakeirving,2557,48,1,5,6,16.7%,1h
27483,2,WheelHorse,2557,0,0,2,2,0.0%,3h
27483,2,artanis,2557,0,0,2,2,0.0%,55m
27513,1,[CHch]DoubleBrown,2556,1510,136,127,263,51.7%,55m
27513,1,Wasin,2556,1092,117,108,225,52.0%,3h
27513,1,[FTLT]SpiderPrimus,2556,1357,76,80,156,48.7%,3h
27513,1,TerranoCool,2556,1554,74,65,139,53.2%,3h
27513,1,Screptis,2556,1518,66,55,121,54.5%,3h
27513,1,[SUDAKA]ElMataPerras,2556,208,60,44,104,57.7%,3h
27513,2,OgreLord,2556,1047,42,36,78,53.8%,6m
27513,1,RickJames,2556,458,32,32,64,50.0%,1h
27513,1,[INVT]SHADOW,2556,545,20,17,37,54.1%,1h
27513,2,blueberrypie,2556,456,16,18,34,47.1%,41m
27513,1,[FROMOZ]Bluee,2556,323,10,11,21,47.6%,28m
27513,2,[TGosuB]PureVoltage,2556,186,7,7,14,50.0%,1h
27513,1,jjokkoo,2556,276,7,9,16,43.8%,46m
27513,2,Juanpavz,2556,114,5,2,7,71.4%,3h
27513,2,Ringo,2556,100,5,8,13,38.5%,24m
27513,1,Darkness,2556,192,4,4,8,50.0%,27m
27513,3,Hydro,2556,0,3,2,5,60.0%,1h
27513,2,bonedraman,2556,120,3,5,8,37.5%,3h
27513,1,[MexTec]neogeo,2556,118,3,9,12,25.0%,3m
27513,1,DylanJohn,2556,30,2,6,8,25.0%,54m
27513,2,NotToGood,2556,0,1,0,1,100.0%,25m
27513,2,Ragnaroth,2556,0,1,0,1,100.0%,1h
27513,2,LoSt,2556,0,0,1,1,0.0%,3h
27513,2,SlackrTehufn,2556,0,0,1,1,0.0%,1h
27513,2,[J0K3R]iAmStOoPid,2556,0,0,1,1,0.0%,1h
27513,2,[CWRU]BBaller,2556,0,0,2,2,0.0%,3h
27513,2,MARITOSKY,2556,0,0,2,2,0.0%,54m
27540,2,verzvs,2555,1622,201,198,399,50.4%,50m
27540,2,Maton,2555,787,82,72,154,53.2%,3h
27540,2,NukeSeven,2555,635,82,75,157,52.2%,55m
27540,1,mishan,2555,1396,64,56,120,53.3%,49m
27540,1,BENDER,2555,876,57,45,102,55.9%,49m
27540,2,[JRS]BrianMV,2555,1040,38,38,76,50.0%,1h
27540,2,Marcus,2555,663,24,21,45,53.3%,1h
27540,1,[MyHase]LauraKslng,2555,663,22,27,49,44.9%,54m
27540,3,xson,2555,486,16,26,42,38.1%,8m
27540,2,JTKmonkey,2555,338,14,10,24,58.3%,1h
27540,2,Amboopa,2555,157,14,12,26,53.8%,28m
27540,1,RebornGildo,2555,409,14,14,28,50.0%,26m
27540,2,CapTuralion,2555,314,12,7,19,63.2%,28m
27540,2,RadicalDecay,2555,282,11,9,20,55.0%,53m
27540,1,Heniiix,2555,334,11,12,23,47.8%,49m
27540,1,Moonga,2555,328,11,15,26,42.3%,23m
27540,1,Manner,2555,256,10,8,18,55.6%,56m
27540,2,[ALSB]Andaya,2555,221,9,3,12,75.0%,1h
27540,1,iEatAss,2555,212,9,11,20,45.0%,1h
27540,2,KeitokuCR,2555,188,7,7,14,50.0%,23m
27540,2,[ch33z3]imthecub,2555,152,5,2,7,71.4%,3h
27540,2,[Na5ty]NotAPatwick,2555,88,4,4,8,50.0%,1h
27540,1,HÿÐÐEN,2555,118,4,8,12,33.3%,51m
27540,2,CaptainKnots,2555,107,3,4,7,42.9%,49m
27540,2,elcaperucito,2555,30,2,1,3,66.7%,3h
27540,2,kirky,2555,58,2,3,5,40.0%,1h
27540,1,Deku,2555,0,2,4,6,33.3%,1h
27540,3,Dusk,2555,0,1,0,1,100.0%,31m
27540,1,Roberth,2555,46,1,2,3,33.3%,3h
27540,2,[HD7K]SkueruolJ,2555,92,1,2,3,33.3%,1h
27540,3,MAUTHUS,2555,44,1,2,3,33.3%,5m
27540,2,MorcY,2555,0,0,4,4,0.0%,44m
27540,1,TOFFEPANDERO,2555,0,0,5,5,0.0%,32m
27573,1,snazty,2554,1645,119,119,238,50.0%,56m
27573,2,lhenrik,2554,1580,108,104,212,50.9%,55m
27573,1,[LY0]ALEX,2554,1509,77,72,149,51.7%,3h
27573,1,Zaius,2554,985,63,48,111,56.8%,50m
27573,1,DMZCRAZY,2554,1082,62,61,123,50.4%,3h
27573,1,SorryBud,2554,833,30,24,54,55.6%,53m
27573,1,[PobSC]Spaceman,2554,714,29,21,50,58.0%,32m
27573,2,[Gover]Sacidpatinet,2554,337,12,14,26,46.2%,6m
27573,1,Hansy,2554,431,12,16,28,42.9%,3h
27573,2,SiNtEcLaDo,2554,311,11,9,20,55.0%,51m
27573,1,Heileos,2554,294,10,12,22,45.5%,3h
27573,2,crackcocain,2554,267,7,9,16,43.8%,26m
27573,2,FRLrandom,2554,176,6,2,8,75.0%,23m
27573,2,seep,2554,126,5,3,8,62.5%,3h
27573,2,SPAM,2554,126,4,0,4,100.0%,55m
27573,3,PenguinLord,2554,149,4,5,9,44.4%,25m
27573,2,PaRaMa,2554,96,3,5,8,37.5%,23m
27573,2,Xombees,2554,46,3,6,9,33.3%,51m
27573,2,snoopdawg,2554,60,3,6,9,33.3%,3h
27573,3,Oblivion,2554,0,2,3,5,40.0%,48m
27573,3,StarMal,2554,0,2,4,6,33.3%,26m
27573,1,Archer,2554,0,2,4,6,33.3%,1h
27573,2,jmcmahon,2554,62,2,5,7,28.6%,52m
27573,2,BoomerTown,2554,30,1,4,5,20.0%,3h
27573,3,axel,2554,0,0,1,1,0.0%,2m
27573,3,AgusNavari,2554,0,0,1,1,0.0%,39m
27573,2,Chubs,2554,0,0,1,1,0.0%,59m
27600,1,Atey,2553,1376,180,182,362,49.7%,3h
27600,2,MinersCorp,2553,630,28,17,45,62.2%,3h
27600,2,Leibniz,2553,594,26,14,40,65.0%,1h
27600,2,[XDRAX8]CELIOKILL,2553,590,26,25,51,51.0%,32m
27600,1,StuKov,2553,347,15,18,33,45.5%,43m
27600,2,gooselinG,2553,322,12,17,29,41.4%,3h
27600,2,LeoMessiFan,2553,279,11,7,18,61.1%,34m
27600,2,ExtremeJoy,2553,183,9,4,13,69.2%,1h
27600,2,[JCN]ACDCLIVE,2553,234,8,8,16,50.0%,50m
27600,2,MirrrRr,2553,214,7,4,11,63.6%,44m
27600,2,General,2553,90,4,5,9,44.4%,3h
27600,1,mot,2553,137,4,6,10,40.0%,24m
27600,2,NoStaples,2553,159,4,7,11,36.4%,3h
27600,2,litch,2553,102,3,4,7,42.9%,41m
27600,1,ChittyChay,2553,139,3,5,8,37.5%,3h
27600,2,Imangry,2553,156,3,6,9,33.3%,55m
27600,2,Clarity,2553,96,2,0,2,100.0%,24m
27600,2,kuhntucker,2553,30,2,0,2,100.0%,10m
27600,2,ohana,2553,30,2,2,4,50.0%,3h
27600,2,AsIWasSaying,2553,60,2,3,5,40.0%,1h
27600,1,[Cryptc]Syngularity,2553,74,2,9,11,18.2%,1h
27600,3,Bored,2553,58,2,17,19,10.5%,22m
27600,2,Hamarthas,2553,0,1,0,1,100.0%,23m
27600,2,Kitt,2553,0,1,0,1,100.0%,50m
27600,2,Zeke,2553,0,1,0,1,100.0%,3h
27600,2,[RH]Rave,2553,0,1,2,3,33.3%,13m
27600,2,BinLaden,2553,30,1,3,4,25.0%,51m
27600,2,StarProz,2553,0,1,4,5,20.0%,3h
27600,2,[Mankis]mastero,2553,40,1,4,5,20.0%,3h
27600,3,ketherio,2553,0,0,1,1,0.0%,39m
27600,2,[AbcCo]ELWACHIN,2553,0,0,1,1,0.0%,1h
27600,2,[PHY2PE]CKT,2553,0,0,1,1,0.0%,39m
27600,3,LonelyTeen,2553,0,0,2,2,0.0%,58m
27600,2,Colin,2553,0,0,4,4,0.0%,55m
27634,2,QQON,2552,1626,311,313,624,49.8%,3h
27634,1,Dkorj,2552,1457,100,87,187,53.5%,3h
27634,2,[LosK]tuto,2552,1058,52,40,92,56.5%,3h
27634,1,Skyguy,2552,1190,41,46,87,47.1%,7m
27634,1,DontRushMe,2552,348,36,24,60,60.0%,3h
27634,2,Khorn,2552,677,30,23,53,56.6%,1h
27634,2,[JUGOS]MIAU,2552,468,17,15,32,53.1%,44m
27634,2,[ValidG]Regalia,2552,418,16,16,32,50.0%,53m
27634,2,Barrikade,2552,368,14,9,23,60.9%,55m
27634,2,Nala,2552,348,13,13,26,50.0%,1h
27634,1,BakeEyes,2552,422,13,19,32,40.6%,60m
27634,1,Stukov,2552,314,10,16,26,38.5%,33m
27634,2,pungkow,2552,254,9,11,20,45.0%,51m
27634,2,ArqLeO,2552,202,7,3,10,70.0%,51m
27634,2,[VoF]cannedmeat,2552,156,5,6,11,45.5%,5m
27634,2,Jdr,2552,88,4,2,6,66.7%,1h
27634,2,STAN,2552,185,4,3,7,57.1%,3h
27634,2,joxeus,2552,145,4,3,7,57.1%,3h
27634,2,Perck,2552,92,4,3,7,57.1%,3h
27634,2,amede,2552,136,4,5,9,44.4%,3h
27634,2,Leeshinobi,2552,120,4,6,10,40.0%,51m
27634,2,angel,2552,60,3,1,4,75.0%,3h
27634,3,iReflex,2552,42,3,5,8,37.5%,60m
27634,2,Alcatraz,2552,96,3,5,8,37.5%,1h
27634,2,OldWolf,2552,30,2,3,5,40.0%,23m
27634,3,RestlessAPI,2552,97,2,4,6,33.3%,1h
27634,2,[OEG]Pain,2552,68,2,4,6,33.3%,1h
27634,2,Joony,2552,60,2,5,7,28.6%,13m
27634,2,[Cind3r]Sly,2552,0,1,0,1,100.0%,51m
27634,2,Secko,2552,30,1,1,2,50.0%,1h
27634,2,Zyxven,2552,0,1,1,2,50.0%,3h
27634,2,Angel,2552,30,1,1,2,50.0%,39m
27634,2,Pantera,2552,30,1,2,3,33.3%,1h
27634,2,[SQUANK]DaZergRolla,2552,96,1,4,5,20.0%,3h
27634,2,RastaPigg,2552,0,0,1,1,0.0%,27m
27634,2,steve,2552,0,0,1,1,0.0%,3h
27634,2,MonkeyButt,2552,0,0,3,3,0.0%,3m
27671,1,elMANCO,2551,1536,186,171,357,52.1%,1h
27671,2,MedmanX,2551,1593,173,166,339,51.0%,3h
27671,2,Lariat,2551,1611,153,143,296,51.7%,32m
27671,2,JuanLuis,2551,1631,149,142,291,51.2%,21m
27671,1,TorvaMessor,2551,1568,101,90,191,52.9%,33m
27671,2,vIzZ,2551,1149,98,84,182,53.8%,3h
27671,1,[IMl]Cruise,2551,1490,89,82,171,52.0%,59m
27671,1,cardtoon,2551,1263,86,68,154,55.8%,3h
27671,2,FlokY,2551,1285,70,69,139,50.4%,10m
27671,1,AceXIII,2551,684,57,56,113,50.4%,17m
27671,2,[Xpk]darkdragon,2551,927,36,33,69,52.2%,55m
27671,1,ModernMotive,2551,432,32,35,67,47.8%,27m
27671,1,[CeMx]Vryko,2551,545,25,14,39,64.1%,49m
27671,1,RocketS,2551,433,17,16,33,51.5%,3h
27671,2,Dacz,2551,266,9,7,16,56.2%,41m
27671,2,Pegasus,2551,190,7,2,9,77.8%,1h
27671,2,[VMW3]Yisas,2551,170,7,6,13,53.8%,1h
27671,2,MonkeyKing,2551,218,6,4,10,60.0%,3h
27671,2,[Center]CovidVirous,2551,188,6,8,14,42.9%,28m
27671,2,Slevankelev,2551,212,6,8,14,42.9%,3h
27671,2,INNOVA,2551,114,5,3,8,62.5%,41m
27671,2,Tal,2551,152,5,7,12,41.7%,1h
27671,2,[NextDC]Adrián,2551,154,5,10,15,33.3%,50m
27671,3,dninvrz,2551,97,3,3,6,50.0%,26m
27671,2,RanGOo,2551,90,2,0,2,100.0%,3h
27671,2,Mectojic,2551,0,1,0,1,100.0%,3h
27671,3,CleanDog,2551,0,1,0,1,100.0%,29m
27671,2,swayzak,2551,30,1,1,2,50.0%,1h
27671,2,[BUR1T0]guitar,2551,0,0,1,1,0.0%,32m
27671,2,[GudC]Lightworker,2551,0,0,1,1,0.0%,6m
27671,2,Dwolkoff,2551,0,0,1,1,0.0%,6m
27671,2,Vellmyster,2551,0,0,1,1,0.0%,50m
27671,3,bdfg,2551,0,0,1,1,0.0%,39m
27671,2,[YFDS]jordanwins,2551,0,0,2,2,0.0%,3h
27671,2,MariOx,2551,0,0,3,3,0.0%,3h
27706,3,DevaDarshana,2550,1538,164,170,334,49.1%,26m
27706,3,Troll,2550,1314,54,56,110,49.1%,22m
27706,1,kingnoob,2550,1047,39,39,78,50.0%,55m
27706,2,[PinChe]SiegeTank,2550,900,30,46,76,39.5%,24m
27706,2,Lactulose,2550,731,28,27,55,50.9%,10m
27706,2,Fsociaty,2550,243,12,5,17,70.6%,33m
27706,1,[VIRGII]Zod,2550,270,10,11,21,47.6%,3h
27706,2,[GØSU]Daxon,2550,315,8,16,24,33.3%,38m
27706,2,[YETll]TacoBell,2550,200,7,22,29,24.1%,9m
27706,2,SIC,2550,114,5,6,11,45.5%,33m
27706,2,[II4WI]mcdoogs,2550,150,5,6,11,45.5%,34m
27706,2,Maracuchex,2550,60,5,9,14,35.7%,21m
27706,2,UnusualPlay,2550,0,3,2,5,60.0%,1h
27706,3,derron,2550,42,3,5,8,37.5%,52m
27706,2,Snowcow,2550,93,2,0,2,100.0%,3h
27706,3,Triumph,2550,0,2,0,2,100.0%,1h
27706,2,Digits,2550,38,2,2,4,50.0%,1h
27706,3,SixWizards,2550,0,2,2,4,50.0%,17m
27706,2,Mingchingy,2550,0,2,3,5,40.0%,1h
27706,2,TheWiz,2550,74,2,3,5,40.0%,1h
27706,3,lovingxt,2550,0,2,4,6,33.3%,3h
27706,3,zram,2550,0,2,4,6,33.3%,3h
27706,2,AnimeBoy,2550,95,2,7,9,22.2%,31m
27706,3,[BWSC]Rath,2550,0,1,5,6,16.7%,21m
27706,2,[STE]Red,2550,98,1,5,6,16.7%,3h
27706,2,Genadi,2550,88,1,5,6,16.7%,59m
27706,3,ShiftyHP,2550,0,1,5,6,16.7%,30m
27706,2,CheSSe,2550,0,1,5,6,16.7%,3h
27706,3,ARCHSS,2550,0,1,7,8,12.5%,3m
27706,2,Grouper,2550,0,0,1,1,0.0%,53m
27706,2,alanthedark,2550,0,0,1,1,0.0%,3h
27706,2,llllllllllll,2550,0,0,2,2,0.0%,3h
27706,2,Jake,2550,0,0,2,2,0.0%,3h
27706,2,katsune,2550,0,0,3,3,0.0%,54m
27706,2,subzero,2550,0,0,4,4,0.0%,3h
27741,2,Ronin,2549,1617,222,212,434,51.2%,51m
27741,3,[NM8]ROnDEAu,2549,1564,201,191,392,51.3%,11m
27741,1,Søren,2549,1294,159,141,300,53.0%,1h
27741,2,[1Love]Element,2549,1426,77,73,150,51.3%,25m
27741,2,DasSchwerin,2549,1490,76,65,141,53.9%,23m
27741,2,Trust,2549,1265,55,43,98,56.1%,1h
27741,2,Stigma,2549,1252,53,48,101,52.5%,3h
27741,1,MARCHBANK,2549,936,31,36,67,46.3%,51m
27741,2,RAPIDFIRE,2549,669,30,21,51,58.8%,1h
27741,1,Vegeta,2549,598,20,21,41,48.8%,3h
27741,3,togy,2549,522,20,22,42,47.6%,27m
27741,1,[sk3tch]ANestesiA,2549,415,18,12,30,60.0%,30m
27741,2,Beast,2549,284,11,5,16,68.8%,3h
27741,2,DonAce,2549,187,9,3,12,75.0%,47m
27741,1,EddyHong,2549,291,9,6,15,60.0%,3h
27741,2,IIIIIIIIII,2549,267,9,20,29,31.0%,3h
27741,2,DoctorFunk,2549,255,7,9,16,43.8%,1h
27741,2,Santiago,2549,191,6,6,12,50.0%,3h
27741,2,kasteriris,2549,175,6,8,14,42.9%,3h
27741,1,Polar,2549,210,5,2,7,71.4%,3h
27741,2,Aneren,2549,122,5,4,9,55.6%,3h
27741,1,NFi,2549,133,5,6,11,45.5%,3h
27741,3,Prediocasa,2549,147,4,5,9,44.4%,10m
27741,2,Fragile,2549,88,3,3,6,50.0%,3m
27741,1,JhuN,2549,0,3,7,10,30.0%,3h
27741,1,[USWAG]iLBraenz,2549,94,3,9,12,25.0%,1h
27741,1,veryNiuBi,2549,97,2,0,2,100.0%,1h
27741,3,ColFox,2549,30,1,17,18,5.6%,40m
27741,3,IIIIIIIIIIII,2549,0,0,1,1,0.0%,26m
27770,1,TARIKBAYAR,2548,1660,246,227,473,52.0%,49m
27770,2,[DsSypL]AFrkngBrcd,2548,1470,122,110,232,52.6%,34m
27770,2,MidasMiky,2548,669,76,69,145,52.4%,55m
27770,1,[SM0K3]minjhoppa,2548,1675,73,70,143,51.0%,59m
27770,1,Dreams,2548,1644,71,64,135,52.6%,3h
27770,2,valladolid,2548,843,63,48,111,56.8%,25m
27770,2,Tredicim,2548,841,63,49,112,56.2%,3h
27770,2,StoneSoldier,2548,1240,52,38,90,57.8%,1h
27770,1,DarkFish,2548,440,15,18,33,45.5%,3h
27770,1,[NXLsc]Diaval,2548,338,13,12,25,52.0%,59m
27770,2,Uppercut,2548,282,9,15,24,37.5%,4m
27770,1,vryvel,2548,200,7,12,19,36.8%,1h
27770,2,Toni,2548,177,5,7,12,41.7%,3h
27770,2,XFITTER,2548,149,5,8,13,38.5%,51m
27770,2,[2027]HolySquid,2548,88,2,0,2,100.0%,1h
27770,1,[RN20]ScarFinger,2548,140,2,1,3,66.7%,27m
27770,1,[ZTemp]Jataru,2548,48,2,1,3,66.7%,3h
27770,2,XeÍAfrojacK,2548,58,2,3,5,40.0%,55m
27770,3,Syon,2548,0,2,4,6,33.3%,20m
27770,1,[HLKT]PraporWorker,2548,0,2,4,6,33.3%,1h
27770,2,cristian,2548,32,1,3,4,25.0%,52m
27770,1,[EdArk]XcoldxbloodX,2548,0,1,3,4,25.0%,3h
27770,2,neonfighter,2548,88,1,4,5,20.0%,18m
27770,1,GhostDragon,2548,36,1,7,8,12.5%,15m
27770,2,[N2B]BigRay,2548,0,0,1,1,0.0%,1h
27770,2,[YurBad]Scoobies,2548,0,0,1,1,0.0%,1h
27770,2,FrozenSabre,2548,0,0,1,1,0.0%,25m
27797,2,Sunstrider,2547,1610,121,115,236,51.3%,3h
27797,3,QuietHawkk,2547,1684,110,123,233,47.2%,21m
27797,2,TimzNastyy,2547,1348,54,47,101,53.5%,28m
27797,1,cesteves,2547,495,51,45,96,53.1%,16m
27797,2,ActualRetard,2547,916,46,27,73,63.0%,1h
27797,2,[LTK]SaltyDad,2547,852,37,29,66,56.1%,3h
27797,2,Jerry,2547,1030,37,36,73,50.7%,3h
27797,1,Ptolemaios,2547,980,35,41,76,46.1%,60m
27797,3,Metalgear,2547,269,34,37,71,47.9%,8m
27797,2,disregard,2547,660,32,28,60,53.3%,41m
27797,2,Kuzmich,2547,665,28,31,59,47.5%,25m
27797,2,Rorrihim,2547,522,21,19,40,52.5%,1h
27797,1,[Flar3s]MaximuS,2547,584,21,26,47,44.7%,52m
27797,2,Savel,2547,528,20,19,39,51.3%,3h
27797,2,[Blacer]Satori,2547,504,19,19,38,50.0%,3h
27797,3,MrHatter,2547,258,19,24,43,44.2%,18m
27797,2,Emerick,2547,439,18,11,29,62.1%,3h
27797,2,toastking,2547,404,14,14,28,50.0%,24m
27797,2,Demutro,2547,292,12,8,20,60.0%,52m
27797,2,TooMuchLeaf,2547,357,10,13,23,43.5%,41m
27797,2,IWILLWIN,2547,218,7,9,16,43.8%,52m
27797,1,[Snooot]moose,2547,212,6,6,12,50.0%,3h
27797,2,Darksaigo,2547,172,6,7,13,46.2%,3h
27797,2,[CRAKS]GoliatKing,2547,148,6,7,13,46.2%,3h
27797,3,[UpxV]DarkSoul,2547,150,5,13,18,27.8%,43m
27797,2,[BANK]Achilies,2547,30,2,1,3,66.7%,1h
27797,2,FallenMechX,2547,0,2,3,5,40.0%,3h
27797,2,[1Fenix]mackigamer,2547,60,2,4,6,33.3%,3h
27797,3,GeckoMan,2547,0,2,4,6,33.3%,2m
27797,1,kvicho,2547,0,2,4,6,33.3%,1h
27797,2,TheMarine,2547,62,2,6,8,25.0%,54m
27797,2,ERZA,2547,62,2,6,8,25.0%,48m
27797,1,SlayersReign,2547,68,2,9,11,18.2%,3h
27797,2,TesseracT,2547,0,1,0,1,100.0%,1h
27797,2,error,2547,0,1,0,1,100.0%,38m
27797,2,impactblu,2547,0,1,0,1,100.0%,44m
27797,2,Pineberry,2547,0,1,1,2,50.0%,3h
27797,3,PorkChop,2547,0,1,3,4,25.0%,1h
27797,2,Cheesefry,2547,34,1,3,4,25.0%,38m
27797,2,vdawns,2547,32,1,3,4,25.0%,55m
27797,2,[GESC2]EpicFencPost,2547,30,1,4,5,20.0%,39m
27797,1,pukirocks,2547,0,1,6,7,14.3%,1h
27797,2,bbade,2547,0,0,2,2,0.0%,16m
27797,2,Indomie,2547,0,0,2,2,0.0%,3h
27841,1,Farmboy,2546,1292,183,178,361,50.7%,1h
27841,3,SpicyMeatBal,2546,1147,131,137,268,48.9%,25m
27841,1,APEist,2546,1575,120,119,239,50.2%,23m
27841,2,diGGEr,2546,653,60,50,110,54.5%,50m
27841,1,[UpxV]iXplode,2546,1298,58,40,98,59.2%,3h
27841,2,Sinow,2546,1061,45,38,83,54.2%,50m
27841,3,underdognew,2546,774,44,51,95,46.3%,40m
27841,2,[SWOU]FIDALGO,2546,652,23,23,46,50.0%,50m
27841,2,HenXirts,2546,582,22,23,45,48.9%,1h
27841,1,SilkyMcNasty,2546,469,17,20,37,45.9%,49m
27841,1,[UGDC]convictioN,2546,273,15,15,30,50.0%,3h
27841,2,[VNZ]kroys,2546,279,14,9,23,60.9%,1h
27841,2,Langer,2546,300,11,10,21,52.4%,34m
27841,2,sakura,2546,280,10,7,17,58.8%,55m
27841,2,lennon,2546,260,8,7,15,53.3%,1h
27841,2,Bob,2546,228,8,8,16,50.0%,1h
27841,2,Hacker,2546,166,6,3,9,66.7%,1h
27841,3,Finest,2546,108,6,5,11,54.5%,27m
27841,1,AiViktor,2546,94,5,8,13,38.5%,3h
27841,2,[MirMak]Tannjon,2546,125,4,5,9,44.4%,1h
27841,2,Devo,2546,30,3,5,8,37.5%,50m
27841,2,[Abisma]Banceline,2546,30,2,0,2,100.0%,1h
27841,3,SLOBODAN,2546,0,2,2,4,50.0%,29m
27841,2,weedlock,2546,32,1,1,2,50.0%,23m
27841,2,aguabuffalo,2546,0,1,4,5,20.0%,39m
27841,1,Squall,2546,30,1,26,27,3.7%,3m
27841,2,DMDM,2546,0,0,1,1,0.0%,3h
27841,2,Fizzy,2546,0,0,1,1,0.0%,1h
27841,2,LILYINYANG,2546,0,0,1,1,0.0%,13m
27841,2,Lambshaker,2546,0,0,1,1,0.0%,24m
27841,1,[EvilCC]AMON,2546,0,0,1,1,0.0%,53m
27841,2,[NtRoPE]Yakuz,2546,0,0,2,2,0.0%,1h
27841,2,[PTHero]Kurowasun,2546,0,0,3,3,0.0%,12m
27874,1,Tim,2545,1654,211,208,419,50.4%,33m
27874,1,BurritoWin,2545,1606,176,160,336,52.4%,8m
27874,2,sawyerCity,2545,1584,117,95,212,55.2%,33m
27874,2,Gingerbaker,2545,1528,95,93,188,50.5%,1h
27874,1,Ariel,2545,768,43,45,88,48.9%,30m
27874,2,DarthWeiner,2545,760,40,34,74,54.1%,3h
27874,2,Morphia,2545,610,39,37,76,51.3%,3h
27874,2,[ØÛ]Chiyuu,2545,773,35,27,62,56.5%,1h
27874,1,dreamachine,2545,464,16,16,32,50.0%,1h
27874,1,Captainsalt,2545,403,14,14,28,50.0%,5m
27874,1,PNP,2545,215,12,16,28,42.9%,60m
27874,1,limrod,2545,373,11,15,26,42.3%,1h
27874,2,aznaznazn,2545,212,7,8,15,46.7%,24m
27874,2,IZeroXI,2545,214,6,5,11,54.5%,3h
27874,1,HERO,2545,197,6,10,16,37.5%,52m
27874,2,REICHL,2545,112,3,1,4,75.0%,3h
27874,3,Lust,2545,46,3,5,8,37.5%,1h
27874,2,[E4]Blue,2545,115,3,5,8,37.5%,3h
27874,1,[PMXM]AlanZa,2545,46,2,0,2,100.0%,3h
27874,2,[Skwirl]Squirrel,2545,92,2,0,2,100.0%,24m
27874,2,Jinky,2545,88,2,0,2,100.0%,3h
27874,2,Ryuichimaru,2545,94,2,2,4,50.0%,3h
27874,3,MuddyNutts,2545,0,2,3,5,40.0%,1h
27874,1,[EPMP]Jaeguer,2545,0,2,4,6,33.3%,1h
27874,2,mangeboule,2545,30,1,5,6,16.7%,6m
27874,2,Moroboshi,2545,0,0,1,1,0.0%,3h
27900,1,GrassTree,2544,1625,192,202,394,48.7%,26m
27900,2,Rodent,2544,1457,64,59,123,52.0%,21m
27900,2,ZzZz,2544,648,55,36,91,60.4%,3h
27900,2,Souvenyr,2544,1252,55,44,99,55.6%,48m
27900,3,SirHScotch,2544,895,33,35,68,48.5%,42m
27900,1,Villoria,2544,826,30,35,65,46.2%,3h
27900,1,digmaan,2544,287,28,20,48,58.3%,1h
27900,1,Derek,2544,715,23,26,49,46.9%,31m
27900,2,mike,2544,583,22,19,41,53.7%,55m
27900,1,[DaFo]sdarck,2544,606,22,21,43,51.2%,39m
27900,2,rmasob,2544,370,12,17,29,41.4%,1h
27900,1,BillNye,2544,340,10,12,22,45.5%,1h
27900,1,Wildcat,2544,156,7,7,14,50.0%,13m
27900,1,Andrew,2544,134,5,6,11,45.5%,37m
27900,2,[SWOU]Zera,2544,136,4,1,5,80.0%,3h
27900,3,Prismatic,2544,143,4,4,8,50.0%,45m
27900,2,MaximusDecM,2544,159,4,8,12,33.3%,1h
27900,1,Melmac,2544,42,3,6,9,33.3%,38m
27900,3,Bojo,2544,97,2,0,2,100.0%,48m
27900,2,Leulz,2544,95,2,5,7,28.6%,3h
27900,2,[BSC4E]MagicTurtle,2544,0,2,5,7,28.6%,17m
27900,2,[GGCTTV]BlackWolf,2544,30,1,2,3,33.3%,56m
27900,2,[MCSC]sugarcookie,2544,32,1,6,7,14.3%,3h
27900,1,BolivianodOr,2544,0,1,6,7,14.3%,59m
27900,2,Camdeon,2544,0,0,1,1,0.0%,3h
27900,2,MichaelJordn,2544,0,0,1,1,0.0%,19m
27900,2,SuperFamicom,2544,0,0,1,1,0.0%,44m
27900,3,Edwinsito,2544,0,0,3,3,0.0%,1h
27928,1,Dartvadercal,2543,1516,131,123,254,51.6%,5m
27928,1,EGOWAVE,2543,1612,93,97,190,48.9%,11m
27928,1,lol,2543,682,55,45,100,55.0%,3h
27928,2,alvinator,2543,1142,53,40,93,57.0%,6m
27928,2,Chatiko,2543,1118,53,47,100,53.0%,3h
27928,1,juneyi,2543,1192,43,44,87,49.4%,1h
27928,2,Natesurf,2543,583,27,21,48,56.2%,3h
27928,1,alee,2543,619,24,26,50,48.0%,30m
27928,1,RangosLocos,2543,578,19,25,44,43.2%,13m
27928,1,[GoDk]oPKingTroy,2543,504,18,22,40,45.0%,3h
27928,1,Chris,2543,420,17,15,32,53.1%,3h
27928,2,stokes,2543,344,15,11,26,57.7%,51m
27928,2,RawbDoggy,2543,334,12,13,25,48.0%,52m
27928,2,GentlemanSam,2543,338,12,23,35,34.3%,1h
27928,2,Lenin,2543,248,10,10,20,50.0%,12m
27928,2,FromTheFalen,2543,183,8,2,10,80.0%,1h
27928,1,hochizito,2543,106,7,6,13,53.8%,49m
27928,2,raedenjin,2543,194,7,9,16,43.8%,49m
27928,2,Dentdollar,2543,155,5,7,12,41.7%,1h
27928,2,Rick,2543,164,4,3,7,57.1%,23m
27928,3,Kirbeh,2543,102,4,4,8,50.0%,52m
27928,2,[VEoC]Ocarinahero,2543,138,3,2,5,60.0%,1h
27928,2,Chaotic,2543,97,2,0,2,100.0%,3h
27928,3,OliverVielma,2543,0,2,4,6,33.3%,10m
27928,1,[VsK]snake,2543,123,2,7,9,22.2%,1h
27928,1,Max,2543,69,2,8,10,20.0%,3h
27928,2,Gundanium,2543,30,1,3,4,25.0%,23m
27928,1,[EvilCC]CHEESER,2543,0,1,4,5,20.0%,33m
27928,1,bnz,2543,0,1,6,7,14.3%,30m
27928,3,Warguby,2543,0,0,1,1,0.0%,45m
27958,1,MAC,2542,1591,100,95,195,51.3%,3h
27958,2,Aotae,2542,1530,97,66,163,59.5%,26m
27958,3,[SWOU]Zarrrk,2542,1232,93,92,185,50.3%,27m
27958,1,Alandri,2542,1168,56,49,105,53.3%,1h
27958,3,maahhhm,2542,569,47,59,106,44.3%,27m
27958,1,[GRU]christsaved,2542,187,46,61,107,43.0%,41m
27958,1,Panda,2542,839,40,35,75,53.3%,1h
27958,2,[1vsM]Agares,2542,1066,40,44,84,47.6%,24m
27958,2,[AbcCo]xXMelvinGVXx,2542,969,39,38,77,50.6%,1h
27958,2,Zero,2542,652,23,21,44,52.3%,39m
27958,2,Breeze,2542,528,21,26,47,44.7%,24m
27958,1,[DaPlug]leopshef,2542,487,16,17,33,48.5%,3h
27958,2,[BRCKRI]lokimenethil,2542,364,13,18,31,41.9%,1h
27958,2,Polvorita,2542,270,9,6,15,60.0%,3h
27958,1,TheSlyMurloc,2542,128,5,8,13,38.5%,3h
27958,1,Dany,2542,88,4,3,7,57.1%,54m
27958,2,alexby,2542,164,4,3,7,57.1%,56m
27958,2,fshgfdh,2542,38,4,3,7,57.1%,3h
27958,3,KushMan,2542,58,3,5,8,37.5%,9m
27958,2,Rurtur,2542,96,3,6,9,33.3%,1h
27958,2,pyruvicAcid,2542,122,3,7,10,30.0%,17m
27958,1,applejuice,2542,114,3,14,17,17.6%,11m
27958,2,Zarola,2542,34,2,1,3,66.7%,1h
27958,3,[GOOBUE]Cameron,2542,36,2,1,3,66.7%,29m
27958,3,YaBoiCarl,2542,38,2,1,3,66.7%,48m
27958,2,Whippersnap,2542,0,2,3,5,40.0%,3h
27958,1,Zeca,2542,140,2,4,6,33.3%,21m
27958,2,chuck,2542,60,2,4,6,33.3%,1h
27958,3,VernonKellen,2542,0,1,1,2,50.0%,20m
27958,2,Vilepredator,2542,0,1,2,3,33.3%,27m
27958,1,RaptorII,2542,46,1,4,5,20.0%,27m
27958,2,Lobo,2542,30,1,5,6,16.7%,1h
27958,2,gsosa,2542,0,0,1,1,0.0%,1h
27958,2,cool,2542,0,0,2,2,0.0%,21m
27992,1,PhononDr,2541,1281,113,112,225,50.2%,5m
27992,2,[YCP]BigDickNick,2541,1142,47,40,87,54.0%,3h
27992,1,mouse,2541,489,33,35,68,48.5%,3h
27992,2,[YD2K]BlaqSasQuach,2541,757,28,25,53,52.8%,1h
27992,2,Dualboy,2541,575,23,17,40,57.5%,39m
27992,3,[AGUILA]CORONEL,2541,457,15,25,40,37.5%,38m
27992,3,CaptainPea,2541,342,14,18,32,43.8%,42m
27992,2,[ValidG]Druidic,2541,290,11,7,18,61.1%,3h
27992,1,[PNS]Ziguela,2541,270,10,14,24,41.7%,3h
27992,2,[LY0]TheCareCuy,2541,180,6,2,8,75.0%,3h
27992,2,areakon,2541,178,6,8,14,42.9%,3h
27992,1,MADDOCK,2541,140,5,10,15,33.3%,3h
27992,2,[UpxV]astana,2541,102,3,4,7,42.9%,1h
27992,3,[SRNT]Shihao,2541,42,3,5,8,37.5%,26m
27992,1,[G79]Crayton,2541,106,3,10,13,23.1%,51m
27992,2,[Antss]Zawaz,2541,88,2,0,2,100.0%,53m
27992,2,mitochondria,2541,96,2,0,2,100.0%,52m
27992,2,Haland,2541,0,1,0,1,100.0%,28m
27992,2,Blackjack,2541,0,1,0,1,100.0%,54m
27992,3,beardontcare,2541,97,1,3,4,25.0%,34m
27992,1,Zegabe,2541,0,0,1,1,0.0%,3h
27992,2,Ezekiel,2541,0,0,1,1,0.0%,54m
27992,2,[FuTD]Mouse,2541,0,0,1,1,0.0%,3h
27992,2,chuushi,2541,0,0,3,3,0.0%,51m
28016,2,jfarrell,2540,1564,138,139,277,49.8%,1h
28016,2,BonesThGhost,2540,1244,86,62,148,58.1%,3h
28016,1,Marte,2540,749,73,63,136,53.7%,3h
28016,2,Hazard,2540,1156,47,41,88,53.4%,1h
28016,3,Noobler,2540,1043,42,46,88,47.7%,32m
28016,2,chicken,2540,816,36,34,70,51.4%,1h
28016,1,[NAUG3]CrazyJezuz,2540,652,21,30,51,41.2%,3h
28016,1,[NLTN]VARES,2540,228,13,16,29,44.8%,14m
28016,1,Barry,2540,296,10,18,28,35.7%,26m
28016,1,ELPATRON,2540,322,10,19,29,34.5%,3h
28016,2,Trial,2540,208,8,5,13,61.5%,3h
28016,2,Ryan,2540,202,8,9,17,47.1%,38m
28016,3,WizardBear,2540,130,7,3,10,70.0%,8m
28016,2,Saldarriaga,2540,178,7,6,13,53.8%,54m
28016,2,Marvin,2540,167,6,2,8,75.0%,39m
28016,1,Hindrance,2540,130,3,2,5,60.0%,1h
28016,2,CaptainPoop,2540,60,3,5,8,37.5%,3h
28016,2,ThatGuy,2540,30,2,2,4,50.0%,51m
28016,2,[towor]egrot,2540,36,2,2,4,50.0%,37m
28016,3,[IBIB]juggernaut,2540,0,2,4,6,33.3%,58m
28016,3,Teketeza,2540,0,2,4,6,33.3%,45m
28016,3,Rise,2540,0,1,0,1,100.0%,58m
28016,2,Guardian,2540,0,1,1,2,50.0%,56m
28016,2,STIMPY,2540,0,1,4,5,20.0%,3h
28016,3,[WeLivn]KidNickles,2540,0,0,1,1,0.0%,45m
28016,2,[FFAA]archdegreed,2540,0,0,1,1,0.0%,1h
28016,2,Dagormath,2540,0,0,1,1,0.0%,3h
28043,2,[Fkit]Neo,2539,1588,208,197,405,51.4%,41m
28043,1,Bhunt,2539,1474,124,110,234,53.0%,33m
28043,1,Polaris,2539,1560,98,98,196,50.0%,17m
28043,1,TonyQuerubin,2539,946,71,69,140,50.7%,1h
28043,3,ByunsUncle,2539,860,41,49,90,45.6%,22m
28043,3,EMPEROR,2539,414,37,49,86,43.0%,8m
28043,2,LINK,2539,616,23,20,43,53.5%,1h
28043,1,Resol,2539,390,16,26,42,38.1%,42m
28043,3,Chris,2539,463,15,20,35,42.9%,26m
28043,2,Nerdikles,2539,305,13,6,19,68.4%,3h
28043,2,WaDzA,2539,258,9,10,19,47.4%,3h
28043,3,Mcnoob,2539,179,5,0,5,100.0%,31m
28043,3,XTHUNDERX,2539,120,5,8,13,38.5%,3m
28043,3,Ninjackowski,2539,40,4,4,8,50.0%,17m
28043,1,[EGG]Anofir,2539,168,4,6,10,40.0%,1h
28043,1,DinOchEnzO,2539,146,4,11,15,26.7%,3h
28043,3,Donsken,2539,30,3,4,7,42.9%,45m
28043,3,Ray,2539,121,3,4,7,42.9%,3h
28043,3,auRElIiuz,2539,125,3,5,8,37.5%,19m
28043,3,ilceratul,2539,90,3,7,10,30.0%,17m
28043,2,[IG4L]STEELEZ,2539,30,2,1,3,66.7%,34m
28043,2,[TKRP]LoganBr,2539,114,2,2,4,50.0%,27m
28043,3,Marshy,2539,0,2,3,5,40.0%,59m
28043,2,[DaFo]Darkness,2539,0,1,0,1,100.0%,3h
28043,2,Orion,2539,30,1,2,3,33.3%,51m
28043,2,[Wahya]TaxiSpill,2539,0,1,3,4,25.0%,3h
28043,2,linguiniboyo,2539,0,1,4,5,20.0%,38m
28043,2,BascH,2539,93,1,6,7,14.3%,17m
28043,2,mahony,2539,0,0,1,1,0.0%,3h
28043,3,methos,2539,0,0,1,1,0.0%,1h
28043,1,Rusted,2539,0,0,8,8,0.0%,1h
28074,1,tdurden,2538,1352,166,159,325,51.1%,3h
28074,1,blessA,2538,1363,85,78,163,52.1%,1h
28074,2,iSickBlocK,2538,836,79,61,140,56.4%,3h
28074,1,Atreides,2538,1361,71,65,136,52.2%,49m
28074,2,seraphs,2538,1010,60,62,122,49.2%,24m
28074,2,Aconte,2538,137,49,61,110,44.5%,14m
28074,2,[SsaYnS]rin,2538,778,34,18,52,65.4%,34m
28074,3,[LaCreW]PhantoMenace,2538,620,33,46,79,41.8%,43m
28074,1,Tenderoni,2538,732,25,36,61,41.0%,1h
28074,2,guts,2538,512,20,13,33,60.6%,1h
28074,3,RickB,2538,551,20,35,55,36.4%,38m
28074,2,[PobSC]Pachon,2538,547,18,21,39,46.2%,3h
28074,2,NATURAL,2538,343,14,10,24,58.3%,54m
28074,2,CiTroN,2538,156,7,8,15,46.7%,1h
28074,1,PastorRussel,2538,242,7,15,22,31.8%,26m
28074,2,[HERAVI]chenteztein,2538,150,5,5,10,50.0%,51m
28074,2,Khazok,2538,166,5,7,12,41.7%,1h
28074,2,TRUMPWIN,2538,107,3,4,7,42.9%,38m
28074,1,daveeeed,2538,38,3,5,8,37.5%,38m
28074,3,zDarkHeroVN,2538,0,2,3,5,40.0%,3h
28074,2,ThePylonHoe,2538,58,2,5,7,28.6%,3h
28074,2,HgMerK,2538,0,1,0,1,100.0%,1h
28074,2,Comrade,2538,30,1,2,3,33.3%,1h
28074,2,[OR2016]DRACUL,2538,0,0,1,1,0.0%,1h
28098,2,[sk3tch]PaulJim,2537,1595,473,481,954,49.6%,3h
28098,3,[TLIVM]fran,2537,1417,418,409,827,50.5%,27m
28098,3,SmileyGuy,2537,1579,222,210,432,51.4%,26m
28098,2,pabloav,2537,1518,156,148,304,51.3%,3h
28098,1,Skerrit,2537,1567,140,135,275,50.9%,30m
28098,3,formerloki,2537,1529,89,98,187,47.6%,24m
28098,2,itsNyy,2537,1069,44,35,79,55.7%,3h
28098,1,NightRaven,2537,493,16,21,37,43.2%,57m
28098,2,juliannovent,2537,382,12,16,28,42.9%,3h
28098,2,Gabu,2537,275,10,7,17,58.8%,27m
28098,1,Spicehunter,2537,155,8,6,14,57.1%,3h
28098,2,Drake,2537,247,7,9,16,43.8%,3h
28098,2,zuperc,2537,198,6,5,11,54.5%,52m
28098,1,XenoKai,2537,192,6,8,14,42.9%,3h
28098,2,Runescape,2537,144,5,9,14,35.7%,1h
28098,2,ieatcrayons,2537,136,4,1,5,80.0%,38m
28098,2,Diego,2537,128,4,1,5,80.0%,3h
28098,2,arkho,2537,140,4,8,12,33.3%,16m
28098,3,Thepsico,2537,121,3,3,6,50.0%,39m
28098,2,Kaligula,2537,30,2,1,3,66.7%,23m
28098,2,jackiye,2537,0,2,3,5,40.0%,32m
28098,1,Mateo,2537,0,2,4,6,33.3%,55m
28098,1,yourdaddy,2537,40,2,7,9,22.2%,3h
28098,2,AnUnAkI,2537,0,1,0,1,100.0%,1h
28098,2,LittleFinBoy,2537,0,1,0,1,100.0%,44m
28098,2,SSSbanhmi,2537,0,1,1,2,50.0%,3h
28098,3,CosiEmano,2537,0,1,1,2,50.0%,58m
28098,2,[lagy]Archangel,2537,0,1,2,3,33.3%,3h
28098,3,Fecal,2537,30,1,10,11,9.1%,27m
28098,2,Varum,2537,0,0,1,1,0.0%,52m
28098,2,crazydog,2537,0,0,1,1,0.0%,44m
28098,3,Aboss,2537,0,0,1,1,0.0%,5m
28098,2,Grax,2537,0,0,2,2,0.0%,6m
28098,1,[STHL]stonts,2537,0,0,4,4,0.0%,1h
28132,2,Slav,2536,1410,157,159,316,49.7%,12m
28132,3,SilentStorm,2536,1613,78,85,163,47.9%,22m
28132,1,SockGiant,2536,1151,65,52,117,55.6%,33m
28132,2,holypony,2536,1269,62,59,121,51.2%,3h
28132,1,josepler,2536,1083,56,46,102,54.9%,41m
28132,1,[GDTAzT]LEIRUZ,2536,1142,53,49,102,52.0%,39m
28132,2,Retreat,2536,539,30,18,48,62.5%,52m
28132,1,THEPUNISHER,2536,640,21,28,49,42.9%,1h
28132,3,[UofC]Oldman,2536,516,20,23,43,46.5%,13m
28132,2,PayN,2536,350,13,12,25,52.0%,1h
28132,2,nicolaser,2536,183,9,5,14,64.3%,1h
28132,2,Cucantor,2536,238,9,8,17,52.9%,3h
28132,2,Esteban,2536,198,7,4,11,63.6%,3h
28132,2,Arbeiters,2536,212,7,5,12,58.3%,33m
28132,2,Cymyry,2536,184,6,7,13,46.2%,1h
28132,2,[R0DANT]Cranium,2536,145,6,8,14,42.9%,1h
28132,3,ALLAIRE,2536,97,5,8,13,38.5%,1h
28132,2,ZergRush,2536,88,4,3,7,57.1%,1h
28132,3,thinktank,2536,146,4,5,9,44.4%,21m
28132,1,[NPhasA]MuckStar,2536,160,4,8,12,33.3%,38m
28132,2,[DRKAPP]Beethoven,2536,102,3,0,3,100.0%,1h
28132,2,Ultranuma,2536,32,2,3,5,40.0%,1h
28132,2,BoJack,2536,0,2,3,5,40.0%,59m
28132,2,Ramirotrox,2536,30,2,6,8,25.0%,3h
28132,3,[AOeOP]CreepBlitz,2536,0,1,1,2,50.0%,23m
28132,2,[cl0udM]burmel,2536,0,1,4,5,20.0%,38m
28132,3,PanOceania,2536,0,1,4,5,20.0%,54m
28132,1,LoveMachine,2536,26,1,8,9,11.1%,30m
28132,2,[BOERUH]Jinx,2536,0,0,1,1,0.0%,3h
28132,3,FenixStorm,2536,0,0,1,1,0.0%,5m
28132,2,EnigmaTome,2536,0,0,2,2,0.0%,3h
28132,1,KiBroT,2536,0,0,9,9,0.0%,1h
28164,2,Odacar,2535,1345,96,87,183,52.5%,3h
28164,2,[SWOU]Bregains,2535,1663,85,87,172,49.4%,1h
28164,1,Eric,2535,1453,69,72,141,48.9%,54m
28164,1,ArkannoSol,2535,687,48,40,88,54.5%,3h
28164,1,ZxTArpeTxZ,2535,834,47,47,94,50.0%,54m
28164,2,pastrolo,2535,946,38,32,70,54.3%,53m
28164,2,[PRATAZ]Dengue,2535,720,31,24,55,56.4%,3h
28164,2,[n3wk1d]Dinobryce,2535,592,28,25,53,52.8%,24m
28164,2,[Sune]HavelTheRock,2535,612,26,15,41,63.4%,52m
28164,2,Waimea,2535,642,22,34,56,39.3%,41m
28164,2,SgtGumby,2535,564,20,22,42,47.6%,51m
28164,2,Jos,2535,479,19,15,34,55.9%,19m
28164,2,Achilles,2535,391,16,5,21,76.2%,3h
28164,2,Weibull,2535,430,15,14,29,51.7%,28m
28164,2,James,2535,395,14,13,27,51.9%,3h
28164,2,GoGetEmTiger,2535,214,7,9,16,43.8%,1h
28164,2,UncleLee,2535,42,4,5,9,44.4%,1h
28164,1,WispOFire,2535,134,4,11,15,26.7%,52m
28164,2,ELdar,2535,0,3,2,5,60.0%,39m
28164,2,Vofman,2535,88,3,4,7,42.9%,1h
28164,2,[JRT]DrCacho,2535,70,2,7,9,22.2%,3h
28164,2,[Berryz]slyknight,2535,0,1,1,2,50.0%,38m
28164,2,[JkSKS]Arcaik,2535,88,1,1,2,50.0%,50m
28164,2,[BIGPPS]Newtreeant,2535,0,1,3,4,25.0%,3h
28164,2,IAmTheTeam,2535,0,1,4,5,20.0%,27m
28164,1,HiAFTemplar,2535,36,1,8,9,11.1%,60m
28164,2,KingKee,2535,0,0,1,1,0.0%,1h
28164,2,[BCBZ]KissedUrDad,2535,0,0,1,1,0.0%,23m
28164,2,Dargon,2535,73,0,3,3,0.0%,48m
28164,3,chrisyazu,2535,0,0,3,3,0.0%,3h
28194,1,Talon,2534,922,160,150,310,51.6%,39m
28194,2,TeaSnack,2534,644,50,32,82,61.0%,1h
28194,2,CrazyBacon,2534,1054,46,43,89,51.7%,38m
28194,1,[TGCF]Yuki,2534,630,35,34,69,50.7%,3h
28194,1,[SANGRE]Orue,2534,452,28,23,51,54.9%,3h
28194,2,kingbitty,2534,451,23,28,51,45.1%,12m
28194,2,[SorMik]BDBlaffy,2534,230,19,24,43,44.2%,26m
28194,2,Swindyy,2534,371,15,9,24,62.5%,55m
28194,2,MelIris,2534,336,14,15,29,48.3%,3h
28194,2,POLLUXcastor,2534,369,13,12,25,52.0%,21m
28194,1,FakeMoon,2534,355,12,10,22,54.5%,36m
28194,1,[H264]cluncher,2534,333,11,13,24,45.8%,3h
28194,2,[ABP]Medecigo,2534,269,11,14,25,44.0%,3h
28194,3,Snufflupagus,2534,342,11,24,35,31.4%,35m
28194,2,[FFAA]EFRAIN,2534,271,10,6,16,62.5%,3h
28194,2,Foolish,2534,242,9,11,20,45.0%,41m
28194,2,Nevermore,2534,208,8,10,18,44.4%,16m
28194,2,[SEVX]Avarice,2534,137,6,3,9,66.7%,24m
28194,2,BANG,2534,73,4,3,7,57.1%,10m
28194,2,Slay,2534,124,4,23,27,14.8%,10m
28194,3,BooKaki,2534,0,3,2,5,60.0%,1h
28194,2,MonzteR,2534,88,3,5,8,37.5%,51m
28194,2,ElJo,2534,0,3,5,8,37.5%,27m
28194,2,WaffleDaze,2534,87,3,5,8,37.5%,28m
28194,2,Agustin,2534,112,2,2,4,50.0%,45m
28194,2,TheOrder,2534,137,2,3,5,40.0%,3h
28194,3,[BBLINE]Kryptor,2534,0,2,4,6,33.3%,2m
28194,3,AlgoGrey,2534,0,2,4,6,33.3%,31m
28194,2,lllllllll,2534,88,2,4,6,33.3%,5m
28194,2,mattluke,2534,0,1,2,3,33.3%,6m
28194,3,Oglethorpe,2534,0,1,4,5,20.0%,1h
28194,3,Gunz,2534,42,1,5,6,16.7%,58m
28194,3,Foxer,2534,30,1,19,20,5.0%,36m
28194,2,[RNF]HardCounter,2534,0,0,1,1,0.0%,1h
28194,2,degenerate,2534,0,0,1,1,0.0%,32m
28194,2,Espectro,2534,0,0,1,1,0.0%,3h
28194,2,sveryost,2534,0,0,1,1,0.0%,1h
28194,2,Mystic,2534,0,0,1,1,0.0%,1h
28194,2,CptComeback,2534,0,0,1,1,0.0%,28m
28194,3,Nommad,2534,0,0,1,1,0.0%,1h
28194,1,[ÆON]DollyNazBol,2534,0,0,7,7,0.0%,7m
28235,1,arienco,2533,1644,167,152,319,52.4%,54m
28235,3,Hiori,2533,1210,156,152,308,50.6%,8m
28235,2,deadlyraven,2533,1211,115,110,225,51.1%,1h
28235,1,[I8I]EyeArmMarinE,2533,790,113,121,234,48.3%,3h
28235,1,Bones,2533,1466,76,71,147,51.7%,3h
28235,2,Mmg,2533,1426,69,58,127,54.3%,1h
28235,1,PeedroLol,2533,1325,60,47,107,56.1%,36m
28235,1,Zeint,2533,1381,53,52,105,50.5%,1h
28235,1,rest,2533,1378,50,56,106,47.2%,1h
28235,2,[D0NGL]skyoctopi,2533,1182,44,44,88,50.0%,1h
28235,3,yoyo,2533,892,36,45,81,44.4%,7m
28235,2,warlord,2533,352,17,15,32,53.1%,51m
28235,2,InfernoCmdr,2533,214,10,11,21,47.6%,20m
28235,2,DaaaamnGirl,2533,258,9,8,17,52.9%,43m
28235,2,MisterKiller,2533,242,8,8,16,50.0%,3h
28235,1,DUG,2533,155,7,11,18,38.9%,51m
28235,2,[shd0w]ShadowWalker,2533,164,5,2,7,71.4%,3h
28235,2,Futuristic,2533,178,5,6,11,45.5%,34m
28235,1,shedevil,2533,98,3,9,12,25.0%,33m
28235,2,[SA2SE]IronThunder,2533,66,2,4,6,33.3%,1h
28235,2,SpeCial,2533,30,2,5,7,28.6%,4m
28235,1,[TTB]Bannor,2533,34,2,7,9,22.2%,49m
28235,2,Rabbit,2533,0,1,0,1,100.0%,28m
28235,3,PHOFENIX,2533,97,1,1,2,50.0%,1h
28235,2,eazyono,2533,48,1,4,5,20.0%,3h
28235,3,Pucklemod,2533,0,0,1,1,0.0%,17m
28235,2,[RinNya]Alice,2533,0,0,1,1,0.0%,3h
28235,3,Franko,2533,0,0,2,2,0.0%,1h
28235,2,dvdseller,2533,0,0,2,2,0.0%,4m
28235,2,[ThCz]CMC,2533,0,0,3,3,0.0%,38m
28235,2,Sprinx,2533,0,0,6,6,0.0%,34m
28266,2,Bemo,2532,1012,154,153,307,50.2%,14m
28266,1,Patrick,2532,1412,122,110,232,52.6%,5m
28266,2,WPH,2532,1504,101,94,195,51.8%,3h
28266,1,Shin,2532,1570,98,100,198,49.5%,60m
28266,2,Gaogaigar,2532,1004,86,79,165,52.1%,3h
28266,1,JYHYorch,2532,1627,82,97,179,45.8%,1h
28266,1,[VIXIII]SnakeMan,2532,1419,65,59,124,52.4%,36m
28266,2,FLOPPA,2532,980,43,40,83,51.8%,1h
28266,1,Chiwasam,2532,963,37,33,70,52.9%,3h
28266,2,Conebeam,2532,569,34,22,56,60.7%,33m
28266,2,Duloxetine,2532,611,29,20,49,59.2%,3h
28266,3,SiriusB,2532,568,21,31,52,40.4%,35m
28266,2,[KhanZ]Ferre,2532,501,20,19,39,51.3%,38m
28266,1,Pat,2532,468,19,23,42,45.2%,55m
28266,2,Bash,2532,392,14,15,29,48.3%,1h
28266,2,NoteIT,2532,330,13,10,23,56.5%,3h
28266,2,[VatiCL]Robocop,2532,210,8,9,17,47.1%,1h
28266,1,Rheese,2532,168,7,7,14,50.0%,1h
28266,3,LeTigre,2532,30,5,5,10,50.0%,36m
28266,2,Boom,2532,150,5,6,11,45.5%,48m
28266,3,warlock,2532,36,4,3,7,57.1%,6m
28266,1,Ren,2532,92,4,7,11,36.4%,3h
28266,2,shinnok,2532,60,3,2,5,60.0%,54m
28266,2,Shimon,2532,108,3,4,7,42.9%,4m
28266,2,Ozzy,2532,92,3,7,10,30.0%,23m
28266,2,ZeraFX,2532,0,2,4,6,33.3%,51m
28266,3,[FLUFFS]KCHU,2532,0,1,1,2,50.0%,8m
28266,3,Bulova,2532,30,1,5,6,16.7%,42m
28266,2,PRES,2532,0,0,1,1,0.0%,51m
28295,2,Depredador,2531,1434,197,196,393,50.1%,3h
28295,2,[OCBO]chickenlota,2531,449,45,35,80,56.2%,44m
28295,3,ACHTUNG,2531,804,29,37,66,43.9%,27m
28295,2,[ImbaPL]SataniCK,2531,531,24,18,42,57.1%,3h
28295,1,Yeung,2531,423,18,16,34,52.9%,3h
28295,1,lobo,2531,444,15,19,34,44.1%,5m
28295,2,llllllllllll,2531,93,13,9,22,59.1%,56m
28295,3,Fabrebel,2531,330,13,13,26,50.0%,11m
28295,2,SiCKO,2531,225,7,9,16,43.8%,3h
28295,1,StuffedGuy,2531,202,7,10,17,41.2%,34m
28295,1,[T600]Megadave,2531,220,6,2,8,75.0%,1h
28295,2,[TWAS]ChopSuey,2531,174,6,7,13,46.2%,3h
28295,2,stupify,2531,122,5,1,6,83.3%,38m
28295,3,Limep,2531,116,4,8,12,33.3%,26m
28295,1,Mark,2531,143,4,11,15,26.7%,34m
28295,3,Cakevanilla,2531,95,3,2,5,60.0%,60m
28295,2,NEON,2531,88,2,0,2,100.0%,1h
28295,3,leebshow,2531,0,2,4,6,33.3%,1h
28295,2,Rynar,2531,0,1,0,1,100.0%,26m
28295,2,UNITARK,2531,0,1,2,3,33.3%,1h
28295,2,Kallam,2531,0,1,3,4,25.0%,12m
28295,2,Excecutor,2531,30,1,3,4,25.0%,3m
28295,2,Eon,2531,0,1,4,5,20.0%,3h
28295,2,Stark,2531,0,0,2,2,0.0%,38m
28295,2,[NPhasA]Chow,2531,0,0,3,3,0.0%,3h
28295,2,[CROSS]AZRAEL,2531,0,0,3,3,0.0%,3h
28321,2,GLHF,2530,1252,106,102,208,51.0%,4m
28321,2,[UpxV]MrLimn,2530,1435,76,74,150,50.7%,3m
28321,1,JazZzoN,2530,1565,66,66,132,50.0%,3h
28321,2,Boussy,2530,1127,49,33,82,59.8%,39m
28321,2,Logun,2530,497,48,42,90,53.3%,1h
28321,1,[Pig2]GGCowabunga,2530,1003,48,47,95,50.5%,3h
28321,2,Specter,2530,841,46,32,78,59.0%,54m
28321,3,Zohan,2530,1021,38,40,78,48.7%,12m
28321,2,Dman,2530,470,18,19,37,48.6%,3m
28321,2,[DreamK]DAN,2530,442,16,19,35,45.7%,55m
28321,1,[ProKRS]Smittbrah,2530,261,11,13,24,45.8%,3h
28321,2,techuosuelo,2530,226,9,5,14,64.3%,54m
28321,2,malcolm,2530,272,9,12,21,42.9%,28m
28321,2,[Mgumin]IventHalcon,2530,146,6,8,14,42.9%,54m
28321,2,XDARKWOLF,2530,149,5,2,7,71.4%,16m
28321,1,Albare,2530,0,3,4,7,42.9%,56m
28321,2,Tincho,2530,58,3,4,7,42.9%,3h
28321,2,[ojj]Essexs,2530,30,2,2,4,50.0%,29m
28321,2,NAisaJOKE,2530,0,2,4,6,33.3%,1h
28321,3,[4K4K4K]telaenbanano,2530,0,1,0,1,100.0%,26m
28321,1,Iceman,2530,0,1,0,1,100.0%,26m
28321,2,[SmartD]Monster,2530,88,1,1,2,50.0%,51m
28321,2,[Cp0LaB]Learner,2530,30,1,3,4,25.0%,28m
28321,2,[HØST]Gyako,2530,0,0,1,1,0.0%,3h
28321,2,ninjoi,2530,0,0,1,1,0.0%,44m
28321,2,Onebigspaz,2530,0,0,1,1,0.0%,34m
28321,2,cden,2530,0,0,2,2,0.0%,29m
28321,2,DestroyersKa,2530,0,0,2,2,0.0%,52m
28349,1,TaxistaLB,2529,1658,280,276,556,50.4%,15m
28349,1,Nobody,2529,1570,233,232,465,50.1%,3h
28349,1,[KrAce]edgysarcasm,2529,1299,129,130,259,49.8%,23m
28349,3,[Mgoose]monotron,2529,1458,124,121,245,50.6%,27m
28349,2,Blinded,2529,1646,102,101,203,50.2%,3h
28349,1,PlayerTwo,2529,1657,74,78,152,48.7%,36m
28349,2,Atharios,2529,1270,57,40,97,58.8%,32m
28349,1,geiger,2529,1466,57,62,119,47.9%,24m
28349,2,[SyLx]blackbelt,2529,946,51,47,98,52.0%,3h
28349,2,KSCZAFYP,2529,967,43,29,72,59.7%,3h
28349,2,[CAMOTE]Pimmpernel,2529,757,30,25,55,54.5%,45m
28349,2,[PeePz]MadeInChina,2529,663,27,21,48,56.2%,1h
28349,2,kaidoson,2529,601,23,28,51,45.1%,3h
28349,2,Jimi,2529,552,22,15,37,59.5%,35m
28349,2,[SRCHA]KrisKon,2529,594,21,26,47,44.7%,56m
28349,1,Bravehydra,2529,537,18,21,39,46.2%,3h
28349,2,[TBBM]ahhdestroy,2529,414,14,18,32,43.8%,1h
28349,2,Ritchan,2529,239,13,14,27,48.1%,55m
28349,2,Kimchiman,2529,279,10,8,18,55.6%,3h
28349,2,dayHaas,2529,150,5,9,14,35.7%,38m
28349,1,CHUCKNORRIS,2529,0,3,4,7,42.9%,36m
28349,2,NDFS,2529,46,3,7,10,30.0%,3h
28349,2,Harmony,2529,0,1,1,2,50.0%,52m
28349,2,Levi,2529,0,1,4,5,20.0%,1h
28349,2,xXREGIOXx,2529,0,1,4,5,20.0%,3h
28349,2,[MILFss]TheOwl,2529,0,0,1,1,0.0%,1h
28349,2,CuPours,2529,0,0,3,3,0.0%,1h
28376,2,[Mamona]MadWarrior,2528,1230,240,230,470,51.1%,56m
28376,1,Cream,2528,1594,128,126,254,50.4%,1h
28376,2,Govic,2528,763,81,73,154,52.6%,1h
28376,1,BWS,2528,433,78,91,169,46.2%,23m
28376,2,Felipe,2528,1563,73,72,145,50.3%,23m
28376,1,[kisay]Relover,2528,1255,60,64,124,48.4%,3h
28376,1,cotorrakl,2528,908,46,40,86,53.5%,3h
28376,2,ProTerZer,2528,1092,43,45,88,48.9%,39m
28376,1,Eyen,2528,936,42,41,83,50.6%,1h
28376,1,Ezzy,2528,397,40,41,81,49.4%,51m
28376,2,DarkKnight,2528,768,33,27,60,55.0%,1h
28376,1,Torch,2528,397,20,16,36,55.6%,13m
28376,2,AckermaN,2528,518,19,19,38,50.0%,3h
28376,1,TotalNooB,2528,669,18,29,47,38.3%,49m
28376,2,MDZZ,2528,271,14,12,26,53.8%,26m
28376,2,TrueMaroon,2528,269,12,2,14,85.7%,3h
28376,2,[Chocs]KKique,2528,304,12,8,20,60.0%,1h
28376,1,BOSS,2528,270,10,14,24,41.7%,3h
28376,2,SirWinsAlot,2528,192,9,4,13,69.2%,1h
28376,1,[NLTTJ]onemolroach,2528,246,9,11,20,45.0%,1h
28376,1,squid,2528,240,9,13,22,40.9%,3h
28376,2,[ZTDF]Syphse,2528,192,8,2,10,80.0%,3h
28376,2,MPM,2528,186,6,8,14,42.9%,1h
28376,1,ludomaniaa,2528,121,5,9,14,35.7%,3h
28376,1,Yamato,2528,64,4,6,10,40.0%,3h
28376,2,Rodion,2528,96,3,6,9,33.3%,52m
28376,2,FuuriousD,2528,60,3,6,9,33.3%,3h
28376,2,Naxos,2528,88,2,0,2,100.0%,50m
28376,2,Carpiquet,2528,30,2,2,4,50.0%,45m
28376,2,Kinetic,2528,68,2,3,5,40.0%,1h
28376,3,Michael,2528,0,2,4,6,33.3%,20m
28376,3,Ergott,2528,0,2,4,6,33.3%,34m
28376,2,[Mexxco]thebebo,2528,58,2,6,8,25.0%,1h
28376,2,[G00SE]MicroJackson,2528,62,2,7,9,22.2%,3h
28376,2,Barbaro,2528,0,1,0,1,100.0%,1h
28376,3,Vesser,2528,0,1,0,1,100.0%,32m
28376,3,SlothEater,2528,0,1,3,4,25.0%,3h
28376,2,AstralPlane,2528,0,0,1,1,0.0%,34m
28376,2,Insanity,2528,0,0,2,2,0.0%,3h
28376,1,Hlokt,2528,0,0,3,3,0.0%,3h
28376,2,[Th3Bad]MName,2528,0,0,4,4,0.0%,1h
28417,3,[LoI]prefection,2527,1619,376,372,748,50.3%,25m
28417,1,LevTolstoy,2527,1643,128,132,260,49.2%,15m
28417,2,bugs,2527,1629,109,115,224,48.7%,6m
28417,2,[Dnwlkr]Austin,2527,1557,72,63,135,53.3%,32m
28417,2,Thermo,2527,1118,53,33,86,61.6%,3h
28417,2,COLOSUSS,2527,1143,47,40,87,54.0%,3h
28417,1,[ÆON]nock,2527,651,44,34,78,56.4%,49m
28417,2,[Parque]JackDiaz,2527,314,12,8,20,60.0%,3h
28417,1,Hitch,2527,274,8,16,24,33.3%,30m
28417,1,Caprica,2527,201,5,10,15,33.3%,3h
28417,2,Gabriels,2527,86,3,5,8,37.5%,27m
28417,2,[GFUEL]iUnicycle,2527,102,2,1,3,66.7%,3h
28417,2,Ragingmoose,2527,30,2,4,6,33.3%,1h
28417,3,Andrew,2527,97,2,4,6,33.3%,15m
28417,2,RandAlThor,2527,123,2,6,8,25.0%,1h
28417,2,angelparka,2527,0,1,1,2,50.0%,23m
28417,2,[PiN0YS]NoisyBoy,2527,30,1,5,6,16.7%,3h
28417,2,[Macac0]KidzaRama,2527,0,0,1,1,0.0%,23m
28417,2,DaRK,2527,0,0,6,6,0.0%,1h
28436,2,ManLoli,2526,1440,144,135,279,51.6%,34m
28436,3,Perro,2526,1499,119,118,237,50.2%,39m
28436,1,rEAPER,2526,1541,103,102,205,50.2%,57m
28436,1,[HeHe72]Abzntminded,2526,723,85,75,160,53.1%,1h
28436,2,Nutek,2526,1180,53,49,102,52.0%,34m
28436,2,[Dooski]Matooski,2526,1006,41,41,82,50.0%,3h
28436,1,[Talio]Ferrum,2526,632,26,26,52,50.0%,1h
28436,1,JorGeXxX,2526,629,24,30,54,44.4%,52m
28436,2,night,2526,342,12,9,21,57.1%,1h
28436,1,jonathan,2526,146,11,17,28,39.3%,37m
28436,1,Akraptor,2526,296,11,19,30,36.7%,3h
28436,2,Bibulus,2526,242,9,6,15,60.0%,1h
28436,2,[HØST]Raven,2526,271,9,7,16,56.2%,60m
28436,2,Tyrannosaur,2526,268,8,8,16,50.0%,1h
28436,2,NorikSigma,2526,218,7,8,15,46.7%,38m
28436,2,SpykeAK,2526,194,6,4,10,60.0%,1h
28436,2,[Trebol]Josello,2526,163,5,5,10,50.0%,3h
28436,2,AlaniaLDS,2526,108,4,6,10,40.0%,56m
28436,2,[qoou]Dean,2526,58,3,2,5,60.0%,39m
28436,3,NGSerenity,2526,97,3,3,6,50.0%,17m
28436,2,[ZTempz]WeaponX,2526,92,1,1,2,50.0%,1h
28436,2,SooS,2526,0,1,2,3,33.3%,38m
28436,2,TheDave,2526,0,0,1,1,0.0%,57m
28436,1,GViper,2526,0,0,1,1,0.0%,3h
28436,1,TarMinyatur,2526,0,0,1,1,0.0%,9m
28436,2,FurioGuardia,2526,0,0,1,1,0.0%,52m
28436,3,IIIIIIIIIIII,2526,0,0,6,6,0.0%,3h
28463,1,[HBLLY]Purdell,2525,1628,350,345,695,50.4%,56m
28463,2,[EXTC]Arthur,2525,1554,178,164,342,52.0%,41m
28463,2,Rotula,2525,1402,95,80,175,54.3%,3h
28463,2,DevianJos,2525,1589,74,70,144,51.4%,1h
28463,2,[sk3tch]justusleague,2525,1094,62,54,116,53.4%,1h
28463,2,Azerial,2525,828,48,44,92,52.2%,3h
28463,2,leo,2525,767,43,42,85,50.6%,3h
28463,2,[Nby]Dkelfdeath,2525,570,31,22,53,58.5%,1h
28463,1,PietrosPrime,2525,596,23,24,47,48.9%,1h
28463,2,Slarck,2525,543,22,18,40,55.0%,3m
28463,1,[DeBoyz]Sniper,2525,648,20,29,49,40.8%,17m
28463,2,monSTEARCK,2525,263,14,9,23,60.9%,1h
28463,1,goeasyonme,2525,260,8,6,14,57.1%,3h
28463,3,[Vibing]AntiAntiChad,2525,147,6,4,10,60.0%,1h
28463,1,therealsumme,2525,199,6,10,16,37.5%,1h
28463,2,Sinonimos,2525,142,5,2,7,71.4%,3h
28463,2,Darksifo,2525,169,5,7,12,41.7%,38m
28463,2,spottedpig,2525,116,4,0,4,100.0%,5m
28463,2,zekion,2525,0,3,2,5,60.0%,38m
28463,3,[RNSF]Ricen,2525,0,3,3,6,50.0%,1h
28463,2,LisaSCToo,2525,58,2,3,5,40.0%,29m
28463,2,Gamma,2525,60,2,3,5,40.0%,21m
28463,3,DadDestroyer,2525,0,2,4,6,33.3%,20m
28463,3,bardarbar,2525,0,2,4,6,33.3%,15m
28463,1,ScaryFeet,2525,0,2,5,7,28.6%,30m
28463,2,Dan,2525,0,1,0,1,100.0%,3h
28463,2,Nfestid,2525,0,1,0,1,100.0%,19m
28463,2,CrixGames,2525,0,1,2,3,33.3%,1h
28463,2,[fui]hazenblaze,2525,0,1,3,4,25.0%,5m
28463,2,[xDYEx]BlackWood,2525,0,1,3,4,25.0%,1h
28463,2,Juno,2525,42,1,4,5,20.0%,3h
28463,2,Nase,2525,0,0,2,2,0.0%,41m
28495,2,ORIS,2524,1555,118,118,236,50.0%,1h
28495,2,MEHRAN,2524,1623,115,103,218,52.8%,53m
28495,2,LilBrudder,2524,1462,102,78,180,56.7%,1h
28495,2,LastStarlord,2524,1344,77,70,147,52.4%,1h
28495,1,GranCapitán,2524,1383,63,51,114,55.3%,36m
28495,3,Saint,2524,1273,57,63,120,47.5%,37m
28495,2,TSandwich,2524,1311,56,49,105,53.3%,1h
28495,2,[Arions]Halion,2524,1292,53,54,107,49.5%,3h
28495,2,suka,2524,934,40,35,75,53.3%,3h
28495,2,[CIAD]Alexander,2524,595,30,29,59,50.8%,53m
28495,2,Protoszoario,2524,571,23,33,56,41.1%,37m
28495,1,[ktkzs]HSM,2524,441,13,18,31,41.9%,1h
28495,2,[JGDIFF]masaru,2524,280,10,8,18,55.6%,23m
28495,2,[8kPLUS]BroodWeed,2524,188,7,10,17,41.2%,44m
28495,1,MarkdesS,2524,95,6,3,9,66.7%,38m
28495,2,AXASTOS,2524,176,6,8,14,42.9%,3h
28495,3,killgun,2524,97,4,3,7,57.1%,60m
28495,2,ghostNIGHT,2524,132,4,5,9,44.4%,3h
28495,2,[Girls]LePoopEater,2524,116,4,6,10,40.0%,49m
28495,2,Dark,2524,154,4,6,10,40.0%,52m
28495,1,Gimbo,2524,166,4,9,13,30.8%,14m
28495,1,Terragig,2524,0,3,6,9,33.3%,3h
28495,2,Bulby,2524,96,3,7,10,30.0%,1h
28495,2,[KIOS]comunidad,2524,88,2,0,2,100.0%,38m
28495,2,Boom,2524,88,2,0,2,100.0%,51m
28495,2,Nozid,2524,58,2,5,7,28.6%,21m
28495,2,DLSG,2524,0,2,5,7,28.6%,1h
28495,2,Thrall,2524,0,1,1,2,50.0%,3h
28495,2,antraxX,2524,0,0,1,1,0.0%,3h
28495,2,Quichangkane,2524,0,0,2,2,0.0%,19m
28495,2,[StarCT]ForTheSwarm,2524,0,0,2,2,0.0%,1h
28495,2,chrisownsall,2524,0,0,3,3,0.0%,1h
28495,2,EliasJV,2524,0,0,5,5,0.0%,1h
28528,3,lamaxa,2523,821,123,122,245,50.2%,39m
28528,1,[OKC]Napoleon,2523,1614,73,79,152,48.0%,3h
28528,3,JoeBiden,2523,678,70,101,171,40.9%,22m
28528,2,kaio,2523,1007,44,36,80,55.0%,51m
28528,2,Vivalavida,2523,771,42,35,77,54.5%,3m
28528,2,Nojuanlikesu,2523,624,28,29,57,49.1%,3h
28528,2,Strat,2523,557,22,18,40,55.0%,51m
28528,2,[6SWAG9]DDT,2523,580,22,26,48,45.8%,4m
28528,3,Andreglg,2523,501,21,18,39,53.8%,3m
28528,2,mattz,2523,497,19,14,33,57.6%,14m
28528,2,wildrage,2523,130,4,1,5,80.0%,54m
28528,2,JamesLuna,2523,58,2,4,6,33.3%,33m
28528,2,RustyHelix,2523,60,2,4,6,33.3%,52m
28528,2,THEKILLER,2523,0,2,5,7,28.6%,3h
28528,2,nigitynig,2523,60,2,6,8,25.0%,3h
28528,2,[ojj]mugentime,2523,30,1,2,3,33.3%,28m
28528,1,[NGFR]MrKrabs,2523,0,1,6,7,14.3%,7m
28528,2,brotoss,2523,0,0,1,1,0.0%,51m
28528,2,tluongMD,2523,0,0,1,1,0.0%,3h
28528,2,JuanxD,2523,0,0,2,2,0.0%,3h
28528,2,amonrah,2523,0,0,2,2,0.0%,3h
28549,3,[DLe]chatoworld,2522,1137,259,260,519,49.9%,27m
28549,1,Scarecrow,2522,1560,216,237,453,47.7%,26m
28549,1,MisterPug,2522,1628,161,152,313,51.4%,50m
28549,2,[DhZAc1]Carpano,2522,691,88,77,165,53.3%,1h
28549,2,Tygrrr,2522,966,84,74,158,53.2%,3h
28549,2,LaBlague,2522,1326,68,60,128,53.1%,32m
28549,2,KumärGhi,2522,1283,61,58,119,51.3%,41m
28549,1,Tazur,2522,1246,57,57,114,50.0%,6m
28549,2,Wingman,2522,707,55,52,107,51.4%,23m
28549,1,rizzo,2522,1030,46,51,97,47.4%,3h
28549,1,wolney,2522,371,44,41,85,51.8%,51m
28549,2,Tombmv,2522,620,25,24,49,51.0%,4m
28549,2,seal,2522,597,24,18,42,57.1%,60m
28549,2,[IDoom]Harbinger,2522,487,21,14,35,60.0%,4m
28549,1,[FyHr]Bond,2522,571,19,20,39,48.7%,26m
28549,2,CropDrop,2522,406,16,10,26,61.5%,51m
28549,2,whamsicore,2522,340,15,12,27,55.6%,5m
28549,1,NohVarr,2522,444,14,18,32,43.8%,7m
28549,2,goldsmell,2522,267,12,5,17,70.6%,3h
28549,3,Frost,2522,176,7,12,19,36.8%,10m
28549,1,Aang,2522,212,5,10,15,33.3%,33m
28549,2,Ballzerko,2522,147,4,6,10,40.0%,7m
28549,3,[NotZ]NakedPancake,2522,97,2,4,6,33.3%,2m
28549,2,Pipo,2522,32,2,4,6,33.3%,24m
28549,3,seven,2522,0,2,5,7,28.6%,3h
28549,2,[112222]Amonymous,2522,60,2,6,8,25.0%,1h
28549,3,SoulRaeb,2522,0,1,0,1,100.0%,10m
28549,2,[4aRaza]EntaroAdun,2522,0,1,1,2,50.0%,41m
28549,3,Douxs,2522,0,1,5,6,16.7%,10m
28549,2,heyya,2522,0,0,1,1,0.0%,39m
28549,2,HANS,2522,0,0,2,2,0.0%,1h
28580,1,HanibalBarca,2521,1645,667,665,1332,50.1%,50m
28580,1,Cornbread,2521,1638,268,267,535,50.1%,53m
28580,1,CarLos,2521,1353,137,133,270,50.7%,1h
28580,3,Dezmon,2521,1537,98,104,202,48.5%,28m
28580,3,[NVYTE]robicheaux,2521,1452,82,90,172,47.7%,26m
28580,2,[qtech]Quantum,2521,1493,72,55,127,56.7%,34m
28580,2,[LIPESC]Biaggio,2521,1207,47,49,96,49.0%,38m
28580,1,[BeTaPi]QuirkyTurtle,2521,902,43,39,82,52.4%,30m
28580,1,[DarkLS]Etto,2521,799,27,36,63,42.9%,54m
28580,2,Star,2521,708,25,28,53,47.2%,1h
28580,2,Spud,2521,586,24,21,45,53.3%,45m
28580,2,lIlIlIlIlIlI,2521,338,11,16,27,40.7%,54m
28580,2,KnightZ,2521,238,8,11,19,42.1%,24m
28580,2,EverlastingD,2521,180,7,6,13,53.8%,3h
28580,2,[WABPOD]Hoodlum,2521,127,6,7,13,46.2%,52m
28580,1,felipe,2521,194,6,14,20,30.0%,55m
28580,2,wrw,2521,143,5,1,6,83.3%,45m
28580,1,IcemaN,2521,146,5,12,17,29.4%,6m
28580,2,EvilButtHair,2521,142,4,2,6,66.7%,3h
28580,2,PsYxX,2521,116,3,1,4,75.0%,3h
28580,2,ProMyToss,2521,30,2,2,4,50.0%,3h
28580,2,Fish,2521,112,2,3,5,40.0%,32m
28580,2,xEcsharp,2521,30,1,3,4,25.0%,3h
28580,3,Soraldin,2521,0,0,2,2,0.0%,3h
28580,2,Labryth,2521,0,0,4,4,0.0%,3h
28580,2,[WebOS]Tlacoyito,2521,0,0,5,5,0.0%,34m
28606,1,WikusVDMerwe,2520,1615,209,216,425,49.2%,3h
28606,1,glhfImTroll,2520,348,93,88,181,51.4%,1h
28606,1,Toaster,2520,884,44,39,83,53.0%,1h
28606,1,[xxxbow]Glub,2520,488,20,24,44,45.5%,3h
28606,2,BlazingNinja,2520,443,18,11,29,62.1%,1h
28606,1,Eliott,2520,407,17,15,32,53.1%,3h
28606,3,Pistol,2520,396,15,7,22,68.2%,1h
28606,1,BEERTIME,2520,437,14,31,45,31.1%,3h
28606,1,Turbopotato,2520,360,12,14,26,46.2%,6m
28606,1,ClownFiesta,2520,314,10,15,25,40.0%,57m
28606,2,malateman,2520,90,5,6,11,45.5%,16m
28606,2,Deadeye,2520,139,4,7,11,36.4%,3h
28606,3,Andy,2520,124,4,14,18,22.2%,23m
28606,3,theRed,2520,49,3,1,4,75.0%,7m
28606,1,OGKorupter,2520,0,3,2,5,60.0%,58m
28606,2,JohnWayne,2520,177,3,3,6,50.0%,1h
28606,3,[PRTOS]CaptainLevi,2520,34,3,6,9,33.3%,32m
28606,3,HULK,2520,32,2,5,7,28.6%,11m
28606,2,SoccerMom,2520,45,2,5,7,28.6%,29m
28606,2,BigPapaPimp,2520,0,1,1,2,50.0%,29m
28606,1,LordRadamant,2520,0,1,3,4,25.0%,3h
28606,1,CarrierImba,2520,48,1,4,5,20.0%,27m
28606,3,Freakmode,2520,0,0,1,1,0.0%,31m
28606,2,TheMonstaR,2520,0,0,1,1,0.0%,3h
28606,2,COSSY,2520,0,0,1,1,0.0%,38m
28606,3,[XpKAc]bleephk,2520,0,0,1,1,0.0%,9m
28606,3,mizaki,2520,0,0,1,1,0.0%,21m
28633,1,[Khalta]edrian,2519,1630,264,258,522,50.6%,3h
28633,1,LANCE,2519,1590,245,235,480,51.0%,56m
28633,1,HeheDevil,2519,1401,158,135,293,53.9%,3h
28633,2,Pandemic,2519,1554,154,132,286,53.8%,3h
28633,2,Bryan,2519,924,41,28,69,59.4%,24m
28633,2,[ØÛ]Arepakun,2519,1125,41,42,83,49.4%,19m
28633,2,HugePark,2519,486,23,22,45,51.1%,38m
28633,3,RIPidra,2519,368,13,17,30,43.3%,35m
28633,1,SilentNova,2519,333,11,13,24,45.8%,3h
28633,2,Kabelo,2519,156,5,9,14,35.7%,21m
28633,1,[deegg]Carrot,2519,162,4,2,6,66.7%,3h
28633,3,[micro]SUNG,2519,34,4,3,7,57.1%,3h
28633,1,GeneralCross,2519,0,4,5,9,44.4%,3h
28633,2,[MVJ]MVJToRy,2519,115,4,6,10,40.0%,1h
28633,1,vector,2519,104,4,9,13,30.8%,1h
28633,3,BeBack,2519,88,3,4,7,42.9%,20m
28633,2,[VFam]LoveMachine,2519,131,3,5,8,37.5%,3h
28633,3,Canceled,2519,46,3,5,8,37.5%,3h
28633,1,Shazam,2519,0,2,3,5,40.0%,16m
28633,1,KnightOfHell,2519,70,2,9,11,18.2%,1h
28633,3,Wimwardius,2519,0,1,0,1,100.0%,19m
28633,3,[XWIS]FOodLiOn,2519,97,1,2,3,33.3%,10m
28633,2,BizLeZ,2519,30,1,4,5,20.0%,1h
28633,2,Nihlathak,2519,0,0,1,1,0.0%,3h
28633,3,Tenente,2519,0,0,1,1,0.0%,47m
28633,3,[nieBla]DonkomanTHC,2519,0,0,1,1,0.0%,18m
28633,2,ItsGeomecraf,2519,0,0,2,2,0.0%,3h
28633,2,[xPH0x]OShava,2519,0,0,4,4,0.0%,1h
28661,1,MetalWarrior,2518,1665,252,237,489,51.5%,1h
28661,1,Lukemac,2518,1601,113,107,220,51.4%,56m
28661,1,Winterfreak,2518,1552,96,87,183,52.5%,9m
28661,3,Sqigy,2518,1373,54,48,102,52.9%,1h
28661,3,barbaerotica,2518,838,32,35,67,47.8%,43m
28661,2,DKRG,2518,528,21,21,42,50.0%,21m
28661,2,elsebo,2518,369,16,10,26,61.5%,51m
28661,2,[II7]MohrsCircle,2518,348,14,9,23,60.9%,6m
28661,3,[EpicG]MasterMold,2518,128,9,2,11,81.8%,17m
28661,2,[BNUwU]WinScent,2518,116,6,7,13,46.2%,1h
28661,2,Rizla,2518,114,5,4,9,55.6%,26m
28661,3,[SaWu]Kamus,2518,162,5,6,11,45.5%,3h
28661,1,[LDUwU]resident,2518,191,5,10,15,33.3%,3h
28661,3,Sethy,2518,96,4,2,6,66.7%,3h
28661,2,SpectreNinja,2518,133,4,3,7,57.1%,48m
28661,1,hector,2518,104,4,9,13,30.8%,1h
28661,1,sisotre,2518,132,4,14,18,22.2%,3h
28661,2,GhostWhite,2518,0,2,4,6,33.3%,23m
28661,3,ZDan,2518,97,2,4,6,33.3%,3h
28661,1,SacredBalion,2518,0,2,5,7,28.6%,3h
28661,3,[ggO]ggOWillSmiff,2518,0,1,0,1,100.0%,25m
28661,2,SaintSaucy,2518,0,1,1,2,50.0%,3h
28661,1,OceanMan,2518,0,1,4,5,20.0%,41m
28661,3,FTLooseBaBu,2518,0,0,1,1,0.0%,23m
28661,3,Bugz,2518,0,0,1,1,0.0%,23m
28661,3,HARMICHAEL,2518,0,0,1,1,0.0%,1h
28661,3,catfishguy,2518,0,0,2,2,0.0%,1h
28688,2,PIL,2517,1476,98,93,191,51.3%,3h
28688,2,sako,2517,1566,87,74,161,54.0%,3h
28688,1,[Dicboy]INeedHelp,2517,1441,62,53,115,53.9%,3h
28688,1,Huglow,2517,1175,60,64,124,48.4%,3h
28688,2,MendoSlay,2517,829,44,33,77,57.1%,52m
28688,1,Viper,2517,1026,35,56,91,38.5%,41m
28688,2,COFRAN,2517,585,21,20,41,51.2%,52m
28688,2,OrangeMan,2517,304,12,6,18,66.7%,1h
28688,1,[UpxV]PapaDopulos,2517,232,8,12,20,40.0%,3h
28688,2,Apes,2517,194,7,4,11,63.6%,14m
28688,2,[tCo9]Kalamity,2517,212,7,5,12,58.3%,1h
28688,2,LtAscott,2517,181,5,8,13,38.5%,3h
28688,2,KingIggy,2517,160,4,4,8,50.0%,32m
28688,2,Matt,2517,90,3,5,8,37.5%,38m
28688,2,[nieBla]Frosgul,2517,90,3,8,11,27.3%,16m
28688,3,Jacob,2517,30,2,0,2,100.0%,3h
28688,1,JBJB,2517,92,2,3,5,40.0%,47m
28688,1,elvajito,2517,0,2,3,5,40.0%,3h
28688,2,[SLAMT]Enclave,2517,0,2,4,6,33.3%,1h
28688,2,blade,2517,60,2,6,8,25.0%,1h
28688,3,[ARGT]Asperum,2517,0,1,0,1,100.0%,1h
28688,3,Chem,2517,0,1,0,1,100.0%,3h
28688,3,TParr,2517,97,1,1,2,50.0%,11m
28688,3,[tCo9]Ace,2517,30,1,1,2,50.0%,59m
28688,3,GenPurge,2517,0,1,1,2,50.0%,3h
28688,3,Smile,2517,0,1,1,2,50.0%,1h
28688,3,PearlMilkTea,2517,0,0,1,1,0.0%,16m
28688,3,Gokucr,2517,0,0,1,1,0.0%,19m
28688,3,Arrilious,2517,0,0,1,1,0.0%,31m
28717,2,Kaneda,2516,1528,114,115,229,49.8%,56m
28717,2,[ggUNlT]BlackMesaINC,2516,1483,83,66,149,55.7%,1h
28717,2,SneezeGuard,2516,1516,69,66,135,51.1%,34m
28717,1,ProteusKel,2516,1568,64,61,125,51.2%,3h
28717,2,wafermaker,2516,272,20,13,33,60.6%,1h
28717,2,DrWizzles,2516,650,19,35,54,35.2%,14m
28717,2,mat,2516,279,12,5,17,70.6%,3h
28717,2,pbjams,2516,206,7,5,12,58.3%,19m
28717,2,Talrissa,2516,222,6,8,14,42.9%,3h
28717,2,kingslayer,2516,192,6,9,15,40.0%,5m
28717,2,FireDragon,2516,118,5,9,14,35.7%,12m
28717,3,GigaFlop,2516,139,4,4,8,50.0%,1h
28717,1,[ArGNA]BeNeFiT,2516,152,4,6,10,40.0%,1h
28717,3,Rick,2516,121,3,5,8,37.5%,39m
28717,3,Jorlor,2516,30,2,0,2,100.0%,17m
28717,3,djt,2516,30,2,0,2,100.0%,17m
28717,2,[UFC]Phillip,2516,30,2,3,5,40.0%,51m
28717,1,Overkill,2516,88,2,6,8,25.0%,51m
28717,1,Swoop,2516,34,2,6,8,25.0%,1h
28717,1,Zerglaive,2516,60,2,7,9,22.2%,3h
28717,2,Leonkid,2516,89,1,2,3,33.3%,56m
28717,2,[Exper]GuilhermeC,2516,88,1,3,4,25.0%,52m
28717,3,[SigmaV]GegMopak,2516,0,0,1,1,0.0%,9m
28717,3,[DORB]Demodani,2516,0,0,1,1,0.0%,3h
28717,2,[LifeF]Chopin,2516,0,0,2,2,0.0%,44m
28717,3,RUFF,2516,0,0,2,2,0.0%,31m
28717,2,MrMurder,2516,0,0,3,3,0.0%,1h
28717,2,Jay,2516,0,0,4,4,0.0%,1h
28745,2,RNS,2515,1312,99,103,202,49.0%,19m
28745,3,Will,2515,1638,80,79,159,50.3%,29m
28745,2,TheBigOne,2515,1302,69,59,128,53.9%,4m
28745,1,[Gr33zy]MagicBeast,2515,1365,54,55,109,49.5%,1h
28745,3,SerkanII,2515,981,45,32,77,58.4%,1h
28745,1,Renegade,2515,454,18,19,37,48.6%,54m
28745,1,Jörmund,2515,454,17,19,36,47.2%,49m
28745,2,ThePPWiz,2515,365,16,18,34,47.1%,3h
28745,2,Profesitor,2515,422,15,12,27,55.6%,1h
28745,1,WinningOctoi,2515,268,11,9,20,55.0%,3h
28745,1,PyroRyan,2515,364,11,19,30,36.7%,1h
28745,1,NightyKnight,2515,250,9,12,21,42.9%,3h
28745,1,FiftyCal,2515,162,7,6,13,53.8%,3h
28745,3,BLACKOUT,2515,167,5,3,8,62.5%,1h
28745,1,yangzhihao,2515,237,5,7,12,41.7%,17m
28745,1,fryzee,2515,94,5,9,14,35.7%,1h
28745,3,MEGAGECKO,2515,30,2,0,2,100.0%,44m
28745,3,Veracity,2515,121,2,1,3,66.7%,1h
28745,3,WarLinG,2515,0,2,3,5,40.0%,1h
28745,2,FixItFelix,2515,62,2,8,10,20.0%,38m
28745,3,darong,2515,0,0,1,1,0.0%,3h
28745,2,Hotel,2515,0,0,1,1,0.0%,15m
28745,3,PainTrain,2515,0,0,1,1,0.0%,3h
28745,3,[PvZMa]xsaberdragon,2515,0,0,1,1,0.0%,27m
28745,2,NoSSteF,2515,0,0,2,2,0.0%,48m
28745,2,deadstock,2515,0,0,2,2,0.0%,7m
28745,3,Notty,2515,0,0,2,2,0.0%,20m
28745,2,andysnowking,2515,0,0,5,5,0.0%,1h
28773,1,generic,2514,1659,192,189,381,50.4%,54m
28773,2,BlindingSW,2514,1580,117,106,223,52.5%,1h
28773,1,Lionel,2514,499,72,82,154,46.8%,3h
28773,1,[FyHr]JOSEmalaga,2514,926,65,68,133,48.9%,4m
28773,1,MrBushido,2514,348,52,29,81,64.2%,1h
28773,2,[SLDSNK]natediggler,2514,611,47,34,81,58.0%,14m
28773,1,ARAGORN,2514,564,33,32,65,50.8%,30m
28773,2,[ARGENT]Tutsinator,2514,781,31,28,59,52.5%,1h
28773,2,[BAYLF]PinkUndies,2514,739,30,26,56,53.6%,3h
28773,2,GuruSnot,2514,600,26,18,44,59.1%,3h
28773,2,MonoDSL,2514,688,26,23,49,53.1%,39m
28773,2,Alanx,2514,376,14,13,27,51.9%,3h
28773,2,[Mlol]Nane,2514,240,11,1,12,91.7%,3h
28773,2,Ralf,2514,212,9,13,22,40.9%,1h
28773,3,SHARpsHOOT,2514,92,8,13,21,38.1%,58m
28773,2,AVA,2514,200,7,4,11,63.6%,1h
28773,2,[BTCoyn]Cybrewski,2514,174,7,7,14,50.0%,23m
28773,3,Therenar,2514,114,5,4,9,55.6%,52m
28773,3,Journey,2514,158,5,19,24,20.8%,22m
28773,3,[EffM]Tavis,2514,30,4,3,7,57.1%,33m
28773,2,Fatarnouche,2514,94,4,4,8,50.0%,1h
28773,1,ace,2514,0,3,1,4,75.0%,32m
28773,2,ADXE,2514,130,2,1,3,66.7%,1h
28773,3,StarKiller,2514,58,2,1,3,66.7%,52m
28773,3,Sandivin,2514,97,2,4,6,33.3%,3h
28773,1,[NeAs]Asteur,2514,30,2,5,7,28.6%,3h
28773,3,tego,2514,30,1,1,2,50.0%,3h
28773,3,[elLS]Akrotz,2514,0,0,1,1,0.0%,1h
28773,1,Protoss,2514,0,0,9,9,0.0%,32m
28802,1,Keuper,2513,1606,120,122,242,49.6%,3h
28802,2,Nide,2513,1040,98,86,184,53.3%,3h
28802,2,Spartz,2513,1278,60,57,117,51.3%,3h
28802,2,JhonwIck,2513,1484,57,58,115,49.6%,1h
28802,2,[KanZan]KanSanZio,2513,930,35,39,74,47.3%,1h
28802,1,Pirate,2513,693,26,34,60,43.3%,24m
28802,2,Fiddlefiend,2513,518,20,19,39,51.3%,24m
28802,3,snail,2513,364,14,8,22,63.6%,1h
28802,1,[Meower]Bootycat,2513,446,14,22,36,38.9%,24m
28802,1,Jyack,2513,352,12,13,25,48.0%,3h
28802,2,AkilaeTribe,2513,316,11,13,24,45.8%,17m
28802,1,[MiLt]Kitten,2513,210,10,16,26,38.5%,51m
28802,2,Lazartes,2513,231,9,6,15,60.0%,3h
28802,2,[DPatos]PatoAmarelo,2513,288,9,9,18,50.0%,38m
28802,1,[SUX]Seek,2513,147,5,9,14,35.7%,3h
28802,1,gringoslayer,2513,124,3,7,10,30.0%,5m
28802,2,loqoman,2513,0,2,4,6,33.3%,1h
28802,3,Tautou,2513,0,1,0,1,100.0%,32m
28802,1,brown,2513,0,1,4,5,20.0%,1h
28802,2,AMCC,2513,0,0,2,2,0.0%,8m
28802,2,Cross,2513,0,0,2,2,0.0%,39m
28823,2,TamilTerra,2512,1462,135,123,258,52.3%,3h
28823,1,Thelerk,2512,1198,111,105,216,51.4%,27m
28823,3,JFCD,2512,677,107,103,210,51.0%,1h
28823,2,[0825]StubbyCore,2512,1392,83,87,170,48.8%,56m
28823,2,[Vindic]Longbob,2512,1212,61,50,111,55.0%,3h
28823,1,Smudge,2512,771,47,49,96,49.0%,3h
28823,1,JSON,2512,964,34,41,75,45.3%,54m
28823,2,DuckLuck,2512,479,33,34,67,49.3%,3h
28823,1,PuChi,2512,727,31,36,67,46.3%,3h
28823,1,Mallec,2512,418,14,19,33,42.4%,3h
28823,2,Davestator,2512,288,11,10,21,52.4%,32m
28823,2,[Asilo]xJACx,2512,226,9,11,20,45.0%,1h
28823,3,[CHUNK]reddotsniper,2512,217,7,2,9,77.8%,4m
28823,2,ComeGatos,2512,182,6,4,10,60.0%,27m
28823,3,farry,2512,113,6,5,11,54.5%,42m
28823,2,mijio,2512,238,5,6,11,45.5%,51m
28823,1,[NTPeru]nucmachin,2512,176,4,11,15,26.7%,1h
28823,3,bigfella,2512,60,3,1,4,75.0%,1h
28823,2,lluckyday,2512,58,3,3,6,50.0%,52m
28823,3,idleWorker,2512,30,3,4,7,42.9%,3h
28823,2,[MexTab]Chelozskyy,2512,95,2,2,4,50.0%,3h
28823,2,Atamu,2512,30,2,3,5,40.0%,1h
28823,3,Killpretty,2512,0,2,5,7,28.6%,1h
28823,3,[Ayhur]Redion,2512,0,2,5,7,28.6%,3h
28823,2,Quovatis,2512,88,2,5,7,28.6%,3h
28823,3,Ramishka,2512,0,1,0,1,100.0%,1h
28823,3,[IMAGIN]IDTenTea,2512,30,1,1,2,50.0%,52m
28823,3,[DarkPG]Checo,2512,30,1,2,3,33.3%,3h
28823,3,[XpKAc]Stive,2512,0,0,1,1,0.0%,3h
28823,2,Veggies,2512,0,0,2,2,0.0%,32m
28853,1,Coldfran,2511,1657,255,259,514,49.6%,3h
28853,1,YEY,2511,1305,99,87,186,53.2%,3h
28853,2,KyotaZ,2511,893,90,91,181,49.7%,51m
28853,2,Bekrom,2511,1079,42,40,82,51.2%,56m
28853,3,Lugaru,2511,799,38,45,83,45.8%,35m
28853,3,Barmin,2511,710,23,38,61,37.7%,33m
28853,2,MansNotHot,2511,151,21,15,36,58.3%,23m
28853,2,[25th]ZealotMadnes,2511,248,10,9,19,52.6%,54m
28853,2,BoHateTerran,2511,171,5,4,9,55.6%,1h
28853,1,Reitrof,2511,144,5,7,12,41.7%,49m
28853,2,Terrano,2511,90,4,5,9,44.4%,1h
28853,3,BobBonheur,2511,151,4,5,9,44.4%,11m
28853,2,Incognito,2511,120,4,7,11,36.4%,1h
28853,3,[asco]Ekrinoch,2511,58,3,0,3,100.0%,1h
28853,1,Rufio,2511,60,3,4,7,42.9%,54m
28853,1,Bruh,2511,97,3,4,7,42.9%,39m
28853,3,AlcoHulk,2511,0,2,2,4,50.0%,15m
28853,2,MicroScrotum,2511,30,2,4,6,33.3%,3h
28853,3,Vargs,2511,0,1,0,1,100.0%,45m
28853,3,Primo,2511,0,1,0,1,100.0%,15m
28853,3,Azavar,2511,30,1,1,2,50.0%,47m
28853,2,Countersmell,2511,0,1,2,3,33.3%,39m
28853,1,slashnut,2511,0,1,4,5,20.0%,3h
28853,2,CucciMane,2511,30,1,6,7,14.3%,1h
28853,3,Watcher,2511,40,1,7,8,12.5%,31m
28853,1,[GØSU]VonBiggCatt,2511,38,1,8,9,11.1%,1h
28853,1,Sesshin,2511,0,0,2,2,0.0%,1h
28880,1,CookieCannon,2510,1430,83,80,163,50.9%,1h
28880,3,Roger,2510,1546,80,96,176,45.5%,19m
28880,2,icyrail,2510,219,52,49,101,51.5%,44m
28880,2,Lucas,2510,951,40,30,70,57.1%,1h
28880,3,[B2Life]rvlRSP,2510,683,28,42,70,40.0%,12m
28880,2,South,2510,635,27,14,41,65.9%,39m
28880,2,ACOSTACHU,2510,570,23,18,41,56.1%,38m
28880,1,pepedmx,2510,608,23,25,48,47.9%,23m
28880,1,XxPerverzoxX,2510,477,19,28,47,40.4%,1h
28880,2,[Chibii]Chang,2510,402,14,14,28,50.0%,28m
28880,2,JIM,2510,429,14,21,35,40.0%,3h
28880,3,Jisho,2510,349,13,12,25,52.0%,7m
28880,2,NeOH,2510,322,12,11,23,52.2%,1h
28880,2,elgatito,2510,314,11,11,22,50.0%,41m
28880,1,wingwanglo,2510,233,8,11,19,42.1%,24m
28880,1,[GGMESP]roge,2510,181,6,5,11,54.5%,36m
28880,2,Miguel,2510,207,5,5,10,50.0%,3h
28880,3,Chechin,2510,174,5,7,12,41.7%,3h
28880,2,[Havana]Nahumnator,2510,62,5,10,15,33.3%,14m
28880,3,Tearz,2510,166,4,8,12,33.3%,5m
28880,3,[LOHs]Bortolindo,2510,0,2,0,2,100.0%,52m
28880,2,FirstToFire,2510,93,2,2,4,50.0%,3h
28880,3,NoOneNoName,2510,0,1,0,1,100.0%,3h
28880,3,Filick,2510,0,1,0,1,100.0%,1h
28880,3,[DarkLS]coronavirus,2510,0,1,0,1,100.0%,3h
28880,3,[PAWPAT]YOCF,2510,0,1,0,1,100.0%,19m
28880,1,EGrackulate,2510,0,1,4,5,20.0%,11m
28880,3,PANCETA,2510,0,0,1,1,0.0%,52m
28880,3,Dragoraan,2510,0,0,2,2,0.0%,6m
28880,2,Laks,2510,0,0,2,2,0.0%,51m
28910,3,AlphaRosa,2509,1020,103,84,187,55.1%,1h
28910,2,[sk3tch]Billiethekid,2509,1594,93,93,186,50.0%,54m
28910,1,Luddite,2509,1574,60,69,129,46.5%,18m
28910,2,Fantas,2509,804,54,52,106,50.9%,3h
28910,1,mizu,2509,1359,51,53,104,49.0%,3h
28910,1,kekkers,2509,871,30,42,72,41.7%,1h
28910,2,[BUKÉ]CHOROEPUENTE,2509,666,25,22,47,53.2%,3h
28910,3,EVANGELION,2509,624,24,28,52,46.2%,26m
28910,2,oldmanthinke,2509,386,13,16,29,44.8%,10m
28910,2,Chappy,2509,284,10,9,19,52.6%,46m
28910,1,[CO64]Alexander,2509,304,10,12,22,45.5%,1h
28910,2,Joshytime,2509,165,5,3,8,62.5%,3h
28910,3,Donut,2509,96,4,2,6,66.7%,41m
28910,3,[ThW]Bill,2509,36,4,5,9,44.4%,1h
28910,2,Seyo,2509,112,3,2,5,60.0%,3h
28910,3,Lucifer,2509,90,3,3,6,50.0%,17m
28910,3,Luisito,2509,86,3,3,6,50.0%,29m
28910,3,JMC,2509,0,3,4,7,42.9%,1h
28910,3,Captain,2509,100,3,6,9,33.3%,17m
28910,3,Zerceo,2509,137,3,6,9,33.3%,1h
28910,3,CrazyCow,2509,30,3,7,10,30.0%,37m
28910,2,Scorpion,2509,24,2,3,5,40.0%,56m
28910,1,Nonstop,2509,0,2,3,5,40.0%,1h
28910,3,[72o]Sundeath,2509,30,2,4,6,33.3%,26m
28910,2,HoneyBadger,2509,60,2,4,6,33.3%,26m
28910,2,loko,2509,86,2,5,7,28.6%,3h
28910,1,Frankthetank,2509,0,1,0,1,100.0%,15m
28910,3,Bart,2509,0,1,0,1,100.0%,37m
28910,2,SCORPION,2509,0,1,1,2,50.0%,51m
28910,1,llllllllllll,2509,0,0,3,3,0.0%,1h
28940,2,pARadoxicalA,2508,1336,165,153,318,51.9%,33m
28940,2,Dephe,2508,380,59,52,111,53.2%,41m
28940,2,PapaBear,2508,1510,59,60,119,49.6%,1h
28940,3,Ramza,2508,741,40,35,75,53.3%,19m
28940,1,niborsaile,2508,799,32,34,66,48.5%,29m
28940,2,Fliegen,2508,648,27,20,47,57.4%,1h
28940,3,Shampsky,2508,566,21,22,43,48.8%,1h
28940,2,[Bommmm]Pepitochan,2508,307,19,12,31,61.3%,39m
28940,2,Morfeo,2508,298,11,14,25,44.0%,51m
28940,2,[GoPctm]HectorJC,2508,247,10,14,24,41.7%,1h
28940,1,SparkleFart,2508,253,9,10,19,47.4%,60m
28940,1,[JGalt]Elflago,2508,274,8,13,21,38.1%,3h
28940,3,Samantha,2508,172,6,6,12,50.0%,1h
28940,2,Plumage,2508,120,6,7,13,46.2%,52m
28940,3,MolEMan,2508,132,5,3,8,62.5%,48m
28940,2,Brock,2508,150,5,8,13,38.5%,1h
28940,3,Marshadrin,2508,30,2,0,2,100.0%,1h
28940,3,HerDerHerDer,2508,30,2,1,3,66.7%,19m
28940,2,rrrrrrrrrrrr,2508,89,2,2,4,50.0%,48m
28940,3,ziriuz,2508,0,2,3,5,40.0%,3h
28940,2,Artex,2508,0,2,4,6,33.3%,1h
28940,2,Kuo,2508,93,2,5,7,28.6%,1h
28940,2,Clemens,2508,111,2,7,9,22.2%,1h
28940,3,[DXPCA]KaZiel,2508,0,1,0,1,100.0%,1h
28940,3,[Morg4n]AngoDaMango,2508,0,0,1,1,0.0%,15m
28940,3,squirrel,2508,0,0,1,1,0.0%,4m
28940,3,Dbelzberg,2508,0,0,1,1,0.0%,1h
28940,1,[ZpaceX]KingGuacamol,2508,0,0,3,3,0.0%,3h
28968,3,areesu,2507,1417,254,248,502,50.6%,36m
28968,2,[Altari]SebaXsss,2507,1265,104,98,202,51.5%,3h
28968,1,REZNOV,2507,1527,94,97,191,49.2%,3h
28968,2,BenchMetal,2507,1228,80,76,156,51.3%,3h
28968,2,jeffy,2507,712,29,31,60,48.3%,41m
28968,2,MRREEEEETTV,2507,506,27,24,51,52.9%,39m
28968,2,[Brohan]Matthias,2507,611,23,26,49,46.9%,3h
28968,1,MeAndTheBoyS,2507,371,15,14,29,51.7%,13m
28968,1,Kael,2507,358,11,20,31,35.5%,30m
28968,3,WARBOSS,2507,170,7,4,11,63.6%,1h
28968,2,Noblefire,2507,176,7,9,16,43.8%,39m
28968,2,boomcan,2507,260,7,10,17,41.2%,44m
28968,2,[TOYK]TOYKronic,2507,84,6,5,11,54.5%,36m
28968,2,SirEbrawl,2507,150,6,6,12,50.0%,52m
28968,2,barto,2507,124,5,7,12,41.7%,23m
28968,2,[ALTF04]Alexander,2507,116,4,2,6,66.7%,24m
28968,2,geozdiegoXD,2507,92,4,6,10,40.0%,3h
28968,2,KarrinGan,2507,122,4,9,13,30.8%,3h
28968,3,sirkaylefty,2507,121,3,3,6,50.0%,17m
28968,2,NecroWizard,2507,125,2,1,3,66.7%,10m
28968,3,Nice,2507,0,2,5,7,28.6%,3h
28968,2,[tCo9]RnchroCsmico,2507,30,2,6,8,25.0%,1h
28968,2,bees,2507,0,1,0,1,100.0%,1h
28968,3,PatatoBRAINS,2507,0,1,1,2,50.0%,1h
28968,2,Aladin,2507,30,1,4,5,20.0%,29m
28968,3,[KMS69]Okami,2507,0,0,1,1,0.0%,1h
28968,2,GHOST,2507,0,0,2,2,0.0%,39m
28968,3,MARCHELOOOOO,2507,0,0,2,2,0.0%,3h
28968,2,ARTHUR,2507,0,0,3,3,0.0%,3h
28968,2,mobius,2507,0,0,4,4,0.0%,1h
28998,1,ADISO,2506,1523,199,196,395,50.4%,3h
28998,2,Qoo,2506,1566,140,157,297,47.1%,9m
28998,2,offthemedz,2506,1589,115,111,226,50.9%,41m
28998,2,Santos,2506,1554,95,82,177,53.7%,34m
28998,1,[XForce]KingWardog,2506,797,82,85,167,49.1%,3h
28998,1,[FUERTE]gald,2506,1552,63,64,127,49.6%,3h
28998,3,OKY,2506,1056,46,38,84,54.8%,1h
28998,2,[HeLiuM]Creefter,2506,879,45,28,73,61.6%,3h
28998,1,Sebaa,2506,873,37,38,75,49.3%,1h
28998,1,[ghostk]TERREVIENTO,2506,1048,35,47,82,42.7%,27m
28998,1,[AbcCo]javier,2506,609,29,22,51,56.9%,18m
28998,2,Raiya,2506,524,17,22,39,43.6%,3h
28998,1,[REDX11]Diegopool,2506,496,17,23,40,42.5%,60m
28998,2,[SA2SE]Aron,2506,430,15,15,30,50.0%,1h
28998,1,Charito,2506,371,14,18,32,43.8%,3h
28998,2,HeroLu,2506,344,13,15,28,46.4%,26m
28998,1,juanPAnt,2506,320,10,14,24,41.7%,16m
28998,2,Mackermicker,2506,206,7,6,13,53.8%,27m
28998,2,NTwAin,2506,96,7,7,14,50.0%,1h
28998,2,AmazingWonny,2506,162,5,3,8,62.5%,3h
28998,3,[WW0LF]gooberdz,2506,66,4,5,9,44.4%,21m
28998,1,Helix,2506,187,4,8,12,33.3%,3h
28998,3,[INextI]Cheesos,2506,88,3,2,5,60.0%,3h
28998,2,Fenshawe,2506,58,3,4,7,42.9%,1h
28998,1,BearyHamsup,2506,0,3,4,7,42.9%,1h
28998,3,ChefJ,2506,30,2,1,3,66.7%,3h
28998,2,RamseySkyFly,2506,30,2,2,4,50.0%,3h
28998,3,SpessMarine,2506,0,1,0,1,100.0%,1h
28998,3,Drakms,2506,0,1,0,1,100.0%,58m
28998,3,Sluggernaut,2506,30,1,1,2,50.0%,27m
28998,3,Shoggoth,2506,0,1,5,6,16.7%,21m
28998,3,VampBBQ,2506,0,0,1,1,0.0%,1h
28998,3,Nevermind,2506,0,0,2,2,0.0%,58m
28998,3,ZURC,2506,0,0,3,3,0.0%,1h
29032,2,[I3ro]CodyVector,2505,1483,253,262,515,49.1%,19m
29032,2,[ANF]MauroHaller,2505,1524,172,180,352,48.9%,1h
29032,2,IndusOrange,2505,790,126,130,256,49.2%,10m
29032,3,ColdChicken,2505,1268,122,124,246,49.6%,28m
29032,2,UltimateNoob,2505,1090,47,35,82,57.3%,1h
29032,2,[CRAKS]johnnyflores,2505,875,40,32,72,55.6%,1h
29032,2,kuvkir,2505,944,38,33,71,53.5%,36m
29032,2,Svein,2505,823,37,28,65,56.9%,21m
29032,1,RJrulesSF,2505,910,35,38,73,47.9%,3h
29032,3,CollegeParkF,2505,362,19,12,31,61.3%,45m
29032,2,Naofumisama,2505,481,19,16,35,54.3%,46m
29032,1,[Rlz]Rfa,2505,212,8,14,22,36.4%,1h
29032,2,LudeBANANA,2505,167,4,4,8,50.0%,3h
29032,3,SunTzu,2505,58,3,0,3,100.0%,44m
29032,3,[MKII]MACKamandag,2505,0,2,3,5,40.0%,32m
29032,3,Taserface,2505,0,2,4,6,33.3%,17m
29032,3,javascript,2505,0,1,0,1,100.0%,1h
29032,3,RockstarBaby,2505,30,1,1,2,50.0%,1h
29032,2,TacomaTRD,2505,88,1,2,3,33.3%,51m
29032,2,YORUDAN,2505,88,1,2,3,33.3%,1h
29032,2,DonPotato,2505,88,1,3,4,25.0%,48m
29032,2,JinRaynor,2505,0,0,1,1,0.0%,3h
29032,3,VkS,2505,0,0,1,1,0.0%,60m
29055,1,LuIsMi,2504,1289,213,219,432,49.3%,27m
29055,2,ProuDleming,2504,1102,118,105,223,52.9%,3h
29055,2,[BoAVN]MrPiano,2504,1072,44,44,88,50.0%,28m
29055,1,JoshOnce,2504,931,35,39,74,47.3%,59m
29055,1,Marcrates,2504,850,28,36,64,43.8%,41m
29055,2,snoopy,2504,622,23,23,46,50.0%,40m
29055,2,ElBarto,2504,459,16,18,34,47.1%,14m
29055,1,[MPA]Mexpipe,2504,265,11,11,22,50.0%,38m
29055,2,[NM8]ZeroAPM,2504,221,9,6,15,60.0%,56m
29055,1,Akvo,2504,250,8,15,23,34.8%,3h
29055,1,DrBOFA,2504,217,7,11,18,38.9%,3h
29055,3,MicroVillain,2504,60,5,5,10,50.0%,39m
29055,1,JupiterOM,2504,181,5,13,18,27.8%,1h
29055,2,[FMX]Dante,2504,114,4,6,10,40.0%,1h
29055,3,Abridenal,2504,30,2,4,6,33.3%,1h
29055,2,IronWarsmith,2504,0,1,2,3,33.3%,1h
29055,1,althewarrior,2504,0,1,4,5,20.0%,33m
29055,2,KernelPanic,2504,0,0,1,1,0.0%,27m
29055,3,Ticus,2504,0,0,1,1,0.0%,47m
29055,2,xFragoutx,2504,0,0,2,2,0.0%,18m
29055,3,noble,2504,0,0,5,5,0.0%,1h
29076,1,khoatong,2503,1653,222,211,433,51.3%,40m
29076,1,Marine,2503,1435,145,126,271,53.5%,3h
29076,2,Vicboss,2503,1581,139,111,250,55.6%,60m
29076,2,SerJROD,2503,1504,98,88,186,52.7%,3h
29076,2,zMaximo,2503,534,85,98,183,46.4%,17m
29076,2,arthur,2503,1310,61,61,122,50.0%,3h
29076,2,CMajor,2503,318,51,53,104,49.0%,1h
29076,2,LastBlade,2503,757,30,28,58,51.7%,3h
29076,1,[SCI]paulyworld,2503,635,27,30,57,47.4%,1h
29076,2,Artanis,2503,686,24,21,45,53.3%,1h
29076,1,PANDAEXPRESS,2503,514,16,24,40,40.0%,1h
29076,2,Anasazi,2503,381,15,11,26,57.7%,39m
29076,3,SDLG,2503,361,14,8,22,63.6%,3m
29076,2,Donoblaine,2503,362,14,11,25,56.0%,3h
29076,2,adfshsjhds,2503,320,13,13,26,50.0%,19m
29076,2,Ransom,2503,278,12,6,18,66.7%,3h
29076,1,nosholosho,2503,345,12,11,23,52.2%,3h
29076,1,Chipthemonk,2503,287,9,11,20,45.0%,33m
29076,2,trixiee,2503,254,9,12,21,42.9%,3h
29076,3,[stL7]howyabenn,2503,280,9,17,26,34.6%,2m
29076,1,[PaO2]TheMango,2503,273,8,17,25,32.0%,30m
29076,2,chiiz,2503,176,7,7,14,50.0%,34m
29076,2,Strut,2503,169,6,5,11,54.5%,23m
29076,2,doomsdayy,2503,122,5,6,11,45.5%,23m
29076,2,BabyGun,2503,154,5,7,12,41.7%,27m
29076,2,PompousDingo,2503,105,5,9,14,35.7%,34m
29076,1,[LTWAR]Polarity,2503,191,5,13,18,27.8%,1h
29076,2,HitGirl,2503,140,4,6,10,40.0%,3h
29076,2,[ENCE]ByOzito,2503,30,4,8,12,33.3%,34m
29076,2,Socrate,2503,94,3,8,11,27.3%,5m
29076,2,Britckmand,2503,88,2,1,3,66.7%,52m
29076,2,[LRVS]Mrcockcito,2503,32,2,4,6,33.3%,52m
29076,3,green,2503,0,1,0,1,100.0%,3h
29076,3,gritgodx,2503,0,1,4,5,20.0%,1h
29076,3,[GBTC]GetTheBTCLLC,2503,0,0,1,1,0.0%,29m
29111,1,Wally,2502,1478,167,143,310,53.9%,3h
29111,2,Yeamuel,2502,1372,72,71,143,50.3%,54m
29111,2,Trosky,2502,550,41,39,80,51.2%,1h
29111,1,SCLSymbian,2502,926,39,31,70,55.7%,1h
29111,1,Ramjo,2502,397,30,19,49,61.2%,26m
29111,3,Pank,2502,654,28,25,53,52.8%,37m
29111,2,CommandCentr,2502,573,26,26,52,50.0%,52m
29111,1,Kvper,2502,709,26,30,56,46.4%,3h
29111,1,softblanket,2502,642,19,30,49,38.8%,1h
29111,1,Lifeforce,2502,500,16,24,40,40.0%,1h
29111,3,[TITSQ]Xuron,2502,354,14,6,20,70.0%,50m
29111,2,NsXApolion,2502,368,13,13,26,50.0%,3h
29111,2,[UNBA]Jimminx,2502,250,9,9,18,50.0%,5m
29111,2,DaveBarry,2502,274,9,11,20,45.0%,6m
29111,1,[DETER]BananaPants,2502,274,9,11,20,45.0%,5m
29111,2,Jerian,2502,166,6,3,9,66.7%,41m
29111,2,IVvoNation,2502,154,6,8,14,42.9%,1h
29111,3,flech,2502,152,6,11,17,35.3%,38m
29111,1,jcrellik,2502,134,5,12,17,29.4%,3h
29111,3,Yacobub,2502,146,4,3,7,57.1%,3h
29111,3,Protoss,2502,153,4,5,9,44.4%,1h
29111,1,Invio,2502,0,3,2,5,60.0%,3h
29111,2,[neuroS]defepona,2502,166,3,9,12,25.0%,1h
29111,3,Dros,2502,97,2,0,2,100.0%,3m
29111,2,Leined,2502,88,2,1,3,66.7%,21m
29111,2,Kevin,2502,30,2,3,5,40.0%,60m
29111,1,pahxora,2502,0,2,3,5,40.0%,37m
29111,1,MakkO,2502,0,2,4,6,33.3%,1h
29111,2,ONESHOTKILL,2502,30,1,3,4,25.0%,5m
29111,3,demopan,2502,0,0,1,1,0.0%,47m
29111,3,[KiTeam]Primo,2502,0,0,1,1,0.0%,15m
29111,3,[ZergW]Babushka,2502,0,0,2,2,0.0%,3h
29143,2,skyWalker,2501,1572,185,180,365,50.7%,52m
29143,3,SupaDupaStim,2501,1389,132,126,258,51.2%,58m
29143,2,Jamin,2501,1507,126,129,255,49.4%,1h
29143,1,Cratos,2501,1085,82,66,148,55.4%,18m
29143,2,Toyzboy,2501,1393,72,47,119,60.5%,1h
29143,3,CEthaNoob,2501,1603,66,79,145,45.5%,4m
29143,2,HeHateMe,2501,596,50,34,84,59.5%,56m
29143,3,EmsteR,2501,736,26,37,63,41.3%,2m
29143,3,neogeojr,2501,624,23,19,42,54.8%,3h
29143,2,Momanon,2501,487,19,15,34,55.9%,3h
29143,2,[Araxá]Vbq,2501,344,14,10,24,58.3%,17m
29143,1,CAMHAMMER,2501,315,13,21,34,38.2%,56m
29143,2,asdfg,2501,200,7,9,16,43.8%,29m
29143,1,davrostheIV,2501,220,7,9,16,43.8%,1h
29143,2,zelothero,2501,182,7,12,19,36.8%,56m
29143,1,Slowpoke,2501,154,6,8,14,42.9%,15m
29143,3,Pandarax,2501,142,5,4,9,55.6%,25m
29143,1,[PROPH]Prophecy,2501,30,3,5,8,37.5%,9m
29143,3,maxelement,2501,90,3,6,9,33.3%,23m
29143,2,Stokeine,2501,30,2,3,5,40.0%,24m
29143,3,Tryon,2501,95,2,4,6,33.3%,4m
29143,2,TooEasyForMe,2501,0,2,4,6,33.3%,3h
29143,2,SoggySocks,2501,60,2,6,8,25.0%,1h
29143,3,RatMuscle,2501,97,1,1,2,50.0%,1h
29143,3,SilentStorm,2501,0,1,1,2,50.0%,1h
29143,3,[MACBO]DonPatrón,2501,30,1,1,2,50.0%,1h
29143,2,[RAVENZ]DHunterHWI,2501,0,1,2,3,33.3%,40m
29143,3,Xavier,2501,30,1,2,3,33.3%,1h
29143,1,Kirrav,2501,0,1,4,5,20.0%,1h
29143,3,Nonimba,2501,0,0,1,1,0.0%,3h
29143,3,SmellyButt,2501,0,0,1,1,0.0%,12m
29143,3,smile,2501,0,0,1,1,0.0%,48m
29143,1,BiscottiMan,2501,0,0,1,1,0.0%,1h
29143,2,[RnM4EV]LrdWafer,2501,0,0,2,2,0.0%,29m
29143,2,salchi,2501,0,0,4,4,0.0%,3h
29178,2,IamNegan,2500,1514,126,126,252,50.0%,3h
29178,2,Hon,2500,1382,111,107,218,50.9%,7m
29178,1,JJbwp,2500,1367,96,90,186,51.6%,12m
29178,1,Schrinedogg,2500,571,82,77,159,51.6%,33m
29178,2,[Huffs]Imposter,2500,1338,74,58,132,56.1%,1h
29178,3,Void,2500,1298,66,43,109,60.6%,3h
29178,2,TriggerN,2500,1169,52,39,91,57.1%,1h
29178,2,[BlTEL]Vakalate,2500,490,52,45,97,53.6%,1h
29178,1,[63slas]Sivart,2500,570,38,34,72,52.8%,40m
29178,2,[Ajiooo]soky,2500,815,35,23,58,60.3%,5m
29178,2,[UxL]Flash,2500,676,29,22,51,56.9%,29m
29178,3,xourge,2500,806,29,31,60,48.3%,1h
29178,2,HaHahHaHahHa,2500,676,28,24,52,53.8%,3h
29178,2,StevenNgu,2500,555,27,14,41,65.9%,52m
29178,3,Døyhar,2500,554,24,8,32,75.0%,41m
29178,2,BouncyBear,2500,372,23,18,41,56.1%,29m
29178,3,Daxus,2500,386,13,8,21,61.9%,1h
29178,2,[NM8]Buckeye,2500,342,13,14,27,48.1%,33m
29178,1,[IsToAn]ALUCARD,2500,296,10,12,22,45.5%,36m
29178,1,Mecas,2500,308,8,10,18,44.4%,22m
29178,2,myladderpts,2500,168,6,5,11,54.5%,21m
29178,3,[Apixel]jobprogamer,2500,229,6,12,18,33.3%,1h
29178,2,HIDRA,2500,116,4,1,5,80.0%,54m
29178,3,Powerbuster,2500,81,4,2,6,66.7%,31m
29178,2,alarak,2500,140,4,4,8,50.0%,1h
29178,2,pyro,2500,128,4,9,13,30.8%,28m
29178,3,crowbar,2500,0,3,2,5,60.0%,3h
29178,2,SaintMick,2500,114,3,3,6,50.0%,42m
29178,2,SherKhan,2500,30,3,5,8,37.5%,36m
29178,3,[HØST]Loghy,2500,30,2,0,2,100.0%,1h
29178,3,JFRD,2500,0,2,3,5,40.0%,3h
29178,2,[Murk]Windseeker,2500,44,2,9,11,18.2%,55m
29178,3,[AuTz]Chaosweeds,2500,0,1,0,1,100.0%,3h
29178,3,POC,2500,0,1,1,2,50.0%,3h
29178,3,Everton,2500,0,1,4,5,20.0%,31m
29178,3,[WTD]Runderful,2500,0,0,1,1,0.0%,31m
29178,3,[Coach]HCCMAXIMO,2500,0,0,1,1,0.0%,10m
29178,2,[QcScT]WestSpirit,2500,0,0,4,4,0.0%,1h
29216,1,Adrian,2499,1352,133,120,253,52.6%,33m
29216,2,CaptFeelGood,2499,1583,86,81,167,51.5%,3h
29216,1,HalconNegro,2499,728,56,51,107,52.3%,32m
29216,1,ThorGore,2499,799,44,47,91,48.4%,15m
29216,3,Lymited,2499,613,24,21,45,53.3%,31m
29216,2,Stonelar,2499,582,24,23,47,51.1%,54m
29216,1,Perceiver,2499,710,24,28,52,46.2%,50m
29216,3,Adrian,2499,334,13,10,23,56.5%,1h
29216,2,[TJFK]kingsblood,2499,123,6,5,11,54.5%,44m
29216,2,titoiza,2499,222,6,9,15,40.0%,3h
29216,3,FakeLab,2499,140,5,2,7,71.4%,1h
29216,2,HANNIBAL,2499,171,5,6,11,45.5%,3h
29216,3,[Kunis]ben,2499,88,4,1,5,80.0%,26m
29216,1,[SAMBO]solidangle,2499,142,4,7,11,36.4%,59m
29216,2,[MBR420]BigDickRick,2499,105,3,1,4,75.0%,25m
29216,3,thebreaker,2499,0,3,2,5,60.0%,18m
29216,2,Aphasia,2499,58,3,3,6,50.0%,3h
29216,3,ZLiger,2499,145,3,6,9,33.3%,37m
29216,2,[DvaRKA]Blikman,2499,60,3,7,10,30.0%,23m
29216,3,shermannoob,2499,0,2,3,5,40.0%,3h
29216,2,[CBCQC]Tidom,2499,0,1,1,2,50.0%,1h
29216,2,zell,2499,30,1,3,4,25.0%,1h
29216,1,Eudaimonia,2499,0,0,1,1,0.0%,40m
29216,3,TheBlueSlime,2499,0,0,1,1,0.0%,3h
29216,3,Drizzle,2499,0,0,1,1,0.0%,1h
29216,3,dumbfound,2499,0,0,1,1,0.0%,3h
29242,3,bigtime,2498,752,84,79,163,51.5%,1h
29242,1,fArtanis,2498,1342,72,64,136,52.9%,3h
29242,2,GARRUS,2498,1001,64,57,121,52.9%,38m
29242,2,[αXLa]MarinDeHELAD,2498,614,29,14,43,67.4%,52m
29242,3,flocro,2498,810,28,42,70,40.0%,37m
29242,3,[SP1DER]haste,2498,785,27,36,63,42.9%,44m
29242,2,[NA7]beXcellent,2498,455,25,16,41,61.0%,1h
29242,2,rubix,2498,416,16,13,29,55.2%,60m
29242,2,Phil,2498,469,16,21,37,43.2%,52m
29242,2,slimjim,2498,317,13,12,25,52.0%,3h
29242,2,Hoyt,2498,206,8,8,16,50.0%,3h
29242,3,DrummaDrama,2498,0,4,2,6,66.7%,15m
29242,2,[SDRZK]ARgelRzk,2498,90,3,4,7,42.9%,1h
29242,3,Barn,2498,117,3,4,7,42.9%,7m
29242,2,Spirit,2498,46,3,7,10,30.0%,3h
29242,1,Avefenix,2498,97,2,4,6,33.3%,3h
29242,2,[ZLS]koydarkness,2498,0,1,1,2,50.0%,48m
29242,3,sopotamare,2498,36,1,1,2,50.0%,19m
29242,1,Deefour,2498,0,1,2,3,33.3%,1h
29242,3,quicklyspent,2498,0,1,4,5,20.0%,1h
29242,2,NastyNateV,2498,30,1,5,6,16.7%,3h
29242,3,xmvc,2498,0,0,1,1,0.0%,52m
29242,2,Tessaderes,2498,0,0,3,3,0.0%,5m
29265,2,[3x0diA]cLMarines,2497,1620,235,224,459,51.2%,3h
29265,1,USArmy,2497,1550,206,204,410,50.2%,14m
29265,2,adex,2497,655,98,91,189,51.9%,41m
29265,1,PlatooN,2497,1592,91,77,168,54.2%,49m
29265,2,[TeamUR]PapaValk,2497,919,50,38,88,56.8%,36m
29265,1,Marces,2497,1420,49,57,106,46.2%,56m
29265,2,[PTO]Kamari,2497,881,47,47,94,50.0%,1h
29265,2,Jtekill,2497,990,35,40,75,46.7%,42m
29265,2,dpdusa,2497,822,29,33,62,46.8%,29m
29265,3,Reaper,2497,743,28,32,60,46.7%,27m
29265,1,[TMU500]Jugojuice,2497,576,26,34,60,43.3%,40m
29265,1,KimchiKiller,2497,228,9,10,19,47.4%,26m
29265,2,[AFKing]CornInMaPoo,2497,176,6,5,11,54.5%,26m
29265,3,Cabuto,2497,140,6,6,12,50.0%,52m
29265,3,[ChinaR]Kotori,2497,86,4,2,6,66.7%,1h
29265,2,CoaGVrbada,2497,126,4,7,11,36.4%,10m
29265,3,Philthy,2497,175,4,7,11,36.4%,1h
29265,3,TROLLCOOKIE,2497,60,3,1,4,75.0%,3h
29265,3,arthurbryan,2497,30,2,0,2,100.0%,4m
29265,2,DroidboxED,2497,88,2,0,2,100.0%,3h
29265,3,[L0LI]Bloody,2497,97,2,4,6,33.3%,1h
29265,3,Warsteiner,2497,0,2,5,7,28.6%,1h
29265,2,ASTRON,2497,36,2,7,9,22.2%,7m
29265,2,[NASIS]MARCUZ,2497,30,1,7,8,12.5%,19m
29265,2,Shadow,2497,0,0,1,1,0.0%,3h
29265,3,Kaldyn,2497,0,0,1,1,0.0%,28m
29265,3,EXTREMEGAME,2497,0,0,1,1,0.0%,1h
29265,3,Abyss,2497,0,0,1,1,0.0%,45m
29265,3,Elder,2497,0,0,2,2,0.0%,3h
29265,3,ALitleGreeky,2497,0,0,2,2,0.0%,9m
29295,3,edoIgra,2496,1525,280,278,558,50.2%,4m
29295,2,AVATAR,2496,1555,243,259,502,48.4%,15m
29295,2,apolo,2496,994,63,56,119,52.9%,1h
29295,2,[iECO]Treyduck,2496,885,55,49,104,52.9%,3h
29295,2,Crankypants,2496,1211,47,39,86,54.7%,1h
29295,2,ROMERMARIN,2496,1205,46,44,90,51.1%,14m
29295,2,comunista,2496,1166,45,44,89,50.6%,42m
29295,1,[REXB]Submunition,2496,1089,43,45,88,48.9%,1h
29295,2,dwarrior,2496,976,36,37,73,49.3%,4m
29295,1,[FyH]MrBeeRus,2496,275,22,24,46,47.8%,16m
29295,2,Zamii,2496,389,15,15,30,50.0%,60m
29295,2,Nicknitro,2496,155,13,14,27,48.1%,24m
29295,2,itschillllll,2496,348,13,15,28,46.4%,3h
29295,2,[NorK]TheInnKeeper,2496,384,13,17,30,43.3%,3h
29295,2,SJKSDL,2496,301,10,9,19,52.6%,52m
29295,2,[ReVamp]Caronte,2496,335,10,12,22,45.5%,56m
29295,3,BarcodeBill,2496,254,9,9,18,50.0%,1h
29295,2,smilekiller,2496,209,8,8,16,50.0%,3h
29295,1,OldBag,2496,116,4,6,10,40.0%,3h
29295,2,[BCKt]mikashi,2496,176,4,8,12,33.3%,3h
29295,2,profire,2496,132,3,4,7,42.9%,46m
29295,1,andrea,2496,97,3,5,8,37.5%,3h
29295,3,lodgoro,2496,58,2,2,4,50.0%,4m
29295,3,jakesbar,2496,0,2,2,4,50.0%,1h
29295,1,poluloqq,2496,0,2,3,5,40.0%,52m
29295,2,Archetype,2496,0,2,5,7,28.6%,3m
29295,3,[m0ld]ADHD,2496,0,1,0,1,100.0%,1h
29295,3,rkdghwns,2496,30,1,4,5,20.0%,1h
29295,3,[KENT]TMoney,2496,0,0,1,1,0.0%,1h
29295,3,RoyFocker,2496,0,0,1,1,0.0%,1h
29295,3,ELG,2496,0,0,1,1,0.0%,16m
29295,3,Cado,2496,0,0,1,1,0.0%,3h
29327,1,ImTheAzzman,2495,1639,398,400,798,49.9%,3h
29327,3,ZestyLimez,2495,510,91,88,179,50.8%,4m
29327,2,SaltyDave,2495,999,43,36,79,54.4%,4m
29327,2,ZeProzin,2495,729,42,35,77,54.5%,1h
29327,3,Maer,2495,780,32,16,48,66.7%,1h
29327,1,vietnamses,2495,533,21,23,44,47.7%,1h
29327,2,DayDay,2495,502,17,21,38,44.7%,3h
29327,2,SAKDO,2495,252,9,14,23,39.1%,7m
29327,2,ITzExort,2495,193,6,6,12,50.0%,4m
29327,2,Matreazee,2495,186,6,9,15,40.0%,29m
29327,1,Lane,2495,164,5,1,6,83.3%,40m
29327,3,Kenchin,2495,171,5,3,8,62.5%,1h
29327,1,badwolf,2495,114,5,5,10,50.0%,1h
29327,1,Stone,2495,0,4,5,9,44.4%,1h
29327,3,REDRUM,2495,113,3,2,5,60.0%,3h
29327,1,HEEBSquirt,2495,0,2,3,5,40.0%,1h
29327,3,kornikz,2495,0,2,4,6,33.3%,11m
29327,2,ASUSX,2495,0,2,4,6,33.3%,27m
29327,3,FireMage,2495,0,1,0,1,100.0%,1h
29327,3,RyGuy,2495,0,1,0,1,100.0%,3h
29327,3,katuzo,2495,0,1,0,1,100.0%,28m
29327,3,IonicVoid,2495,30,1,3,4,25.0%,3h
29327,1,[lttdh]llAriesll,2495,0,1,4,5,20.0%,2m
29327,1,Kakidrosis,2495,0,1,6,7,14.3%,36m
29327,3,hiroshijag,2495,0,0,1,1,0.0%,32m
29327,3,[GLit]LiquidNature,2495,0,0,1,1,0.0%,1h
29327,3,[BigPin]Seb,2495,0,0,1,1,0.0%,29m
29327,3,[FFAA]Ikoga,2495,0,0,1,1,0.0%,53m
29327,2,ZERBO,2495,0,0,2,2,0.0%,44m
29327,2,ZION,2495,0,0,2,2,0.0%,56m
29357,1,Qibo,2494,1594,242,236,478,50.6%,34m
29357,2,jiaxinTOP,2494,1544,149,118,267,55.8%,35m
29357,1,Montskak,2494,895,72,70,142,50.7%,3h
29357,2,BronYrAur,2494,1066,49,45,94,52.1%,56m
29357,2,[IMDSI]DonFiDeoS,2494,752,29,29,58,50.0%,1h
29357,2,BeefCake,2494,568,23,25,48,47.9%,12m
29357,3,Hatt,2494,58,6,2,8,75.0%,16m
29357,1,darkenix,2494,217,6,8,14,42.9%,3h
29357,3,Zanzibar,2494,148,5,3,8,62.5%,1h
29357,3,Prower,2494,174,5,6,11,45.5%,55m
29357,2,JohnGalt,2494,143,4,2,6,66.7%,1h
29357,2,[ANF]FabriTrueno,2494,141,4,3,7,57.1%,5m
29357,1,Ranger,2494,32,4,6,10,40.0%,1h
29357,1,TheTrentster,2494,0,3,5,8,37.5%,54m
29357,3,Aba,2494,0,2,5,7,28.6%,40m
29357,2,[Mntaya]ShiNiGaMi,2494,0,1,1,2,50.0%,7m
29357,2,warchile,2494,0,1,1,2,50.0%,1h
29357,2,[AWSC]aragorn,2494,0,1,2,3,33.3%,39m
29357,3,NicFit,2494,0,1,4,5,20.0%,35m
29357,3,BruJa,2494,0,0,1,1,0.0%,1h
29357,1,Alecks,2494,0,0,1,1,0.0%,36m
29357,2,CRISFER,2494,0,0,2,2,0.0%,3h
29357,2,RadicalSquad,2494,0,0,3,3,0.0%,42m
29380,1,[MGKYOU]Amaterasu,2493,1639,237,234,471,50.3%,30m
29380,1,benny,2493,1650,190,186,376,50.5%,1h
29380,2,DrZoidberg,2493,1359,109,108,217,50.2%,52m
29380,3,Sensei,2493,1373,54,58,112,48.2%,44m
29380,2,[otacus]mrmax,2493,944,39,34,73,53.4%,1h
29380,3,Tokenhax,2493,468,38,38,76,50.0%,3h
29380,1,Warrior,2493,626,21,30,51,41.2%,3h
29380,2,Vrael,2493,355,18,13,31,58.1%,3h
29380,3,HATETERRAN,2493,360,15,1,16,93.8%,1h
29380,2,BadxMannered,2493,372,12,16,28,42.9%,54m
29380,3,nooblord,2493,187,10,4,14,71.4%,1h
29380,2,blackpanther,2493,204,8,5,13,61.5%,29m
29380,3,[0AAA1]Jarin,2493,203,7,11,18,38.9%,35m
29380,2,Dolor,2493,154,6,6,12,50.0%,3h
29380,2,Jumnag,2493,188,6,6,12,50.0%,3h
29380,2,SandKing,2493,178,5,5,10,50.0%,4m
29380,1,[B51608]killinator,2493,190,5,10,15,33.3%,3h
29380,3,pinctus,2493,86,4,0,4,100.0%,45m
29380,2,Titan,2493,114,4,5,9,44.4%,38m
29380,2,Mengano,2493,88,3,4,7,42.9%,52m
29380,2,Machina,2493,0,3,6,9,33.3%,1h
29380,2,[B33R]CaribouLou,2493,40,3,6,9,33.3%,55m
29380,3,BLANDIN,2493,0,2,2,4,50.0%,41m
29380,3,bdfg,2493,117,2,2,4,50.0%,59m
29380,2,Jakz,2493,30,2,5,7,28.6%,42m
29405,2,scott,2492,1555,192,183,375,51.2%,1h
29405,3,hcOnly,2492,1420,138,125,263,52.5%,28m
29405,1,Law,2492,1594,114,102,216,52.8%,3h
29405,1,[FTTD]southstar,2492,1422,101,99,200,50.5%,6m
29405,1,[r4mp4g]Bokonon,2492,852,33,36,69,47.8%,57m
29405,2,Rynot,2492,293,18,12,30,60.0%,7m
29405,3,Titan,2492,328,12,19,31,38.7%,17m
29405,2,[Clive]Lwoodnj,2492,260,9,11,20,45.0%,3h
29405,3,KingOfPop,2492,218,7,21,28,25.0%,25m
29405,2,Thunder,2492,189,6,4,10,60.0%,42m
29405,3,Psilos,2492,191,5,6,11,45.5%,3m
29405,3,lkunelk,2492,174,4,4,8,50.0%,20m
29405,1,[Sabo0]Ethical,2492,94,3,6,9,33.3%,18m
29405,2,madmanAA,2492,62,3,7,10,30.0%,52m
29405,2,mykatdied,2492,125,3,12,15,20.0%,1h
29405,3,Axe,2492,30,2,0,2,100.0%,3h
29405,3,Turtle,2492,58,2,3,5,40.0%,52m
29405,3,LilPinkyToe,2492,0,2,4,6,33.3%,3m
29405,1,[Lp]rayo,2492,0,1,3,4,25.0%,3h
29405,2,JJsoccer,2492,30,1,4,5,20.0%,1h
29405,3,[LOHd]Fireflame,2492,0,0,1,1,0.0%,31m
29426,1,Maverick,2491,1661,327,325,652,50.2%,3h
29426,1,XxAcExX,2491,1190,85,81,166,51.2%,1h
29426,2,THUNCARTER,2491,1545,84,82,166,50.6%,3h
29426,2,Maru,2491,1309,69,68,137,50.4%,3h
29426,2,superpraw,2491,1198,47,44,91,51.6%,3h
29426,2,zakkpage,2491,789,35,28,63,55.6%,1h
29426,1,[UpxV]CRRR,2491,976,33,43,76,43.4%,57m
29426,2,[GOPERÚ]JorgeMA,2491,701,28,24,52,53.8%,1h
29426,3,SaSa,2491,326,14,14,28,50.0%,3h
29426,3,Jaihen,2491,369,14,14,28,50.0%,31m
29426,2,Zyp,2491,306,11,13,24,45.8%,1h
29426,3,ProfNuggie,2491,146,6,5,11,54.5%,1h
29426,1,SRK,2491,184,6,14,20,30.0%,54m
29426,2,AwesomeSauce,2491,174,5,9,14,35.7%,5m
29426,3,IIIIIIIIIIII,2491,90,4,13,17,23.5%,29m
29426,3,tim,2491,86,3,2,5,60.0%,3m
29426,2,[Swanky]anticitizen,2491,60,3,3,6,50.0%,3h
29426,3,TerraL,2491,86,3,3,6,50.0%,48m
29426,3,[Titti]CodeScreds,2491,90,3,7,10,30.0%,26m
29426,1,Sabin,2491,48,2,4,6,33.3%,1h
29426,1,macroman,2491,0,2,5,7,28.6%,12m
29426,3,DankyPants,2491,0,1,0,1,100.0%,3h
29426,2,[DXPCA]Chuleton,2491,0,1,5,6,16.7%,36m
29426,3,[SoD]Aldo,2491,0,0,1,1,0.0%,3h
29426,3,[xRtGac]Atomsk,2491,0,0,1,1,0.0%,1h
29426,3,odincampox,2491,0,0,1,1,0.0%,46m
29426,3,DrPyxel,2491,0,0,2,2,0.0%,3h
29453,2,RogueLegend,2490,1510,95,70,165,57.6%,27m
29453,3,[OMArmy]Elderbury,2490,1222,52,45,97,53.6%,1h
29453,2,DarkkTemplar,2490,718,24,33,57,42.1%,46m
29453,2,NoobyNevie,2490,307,15,8,23,65.2%,54m
29453,2,Thorin,2490,354,15,15,30,50.0%,3h
29453,2,Jenesis,2490,284,12,10,22,54.5%,52m
29453,2,PlimPlim,2490,218,12,11,23,52.2%,52m
29453,3,[whodey]Nike,2490,310,11,15,26,42.3%,42m
29453,3,Robbie,2490,252,9,9,18,50.0%,48m
29453,3,masbot,2490,202,8,6,14,57.1%,1h
29453,3,Plam,2490,196,8,8,16,50.0%,1h
29453,2,[BraziI]subarrow,2490,122,5,7,12,41.7%,54m
29453,3,Golden,2490,141,3,2,5,60.0%,3m
29453,2,[HNT]RankTrooper,2490,58,3,3,6,50.0%,3h
29453,3,Lurenman,2490,90,3,5,8,37.5%,12m
29453,3,[PRO1]KCHIRUL,2490,30,2,4,6,33.3%,1h
29453,2,shysha,2490,30,2,4,6,33.3%,3h
29453,2,Zeorus,2490,0,2,4,6,33.3%,27m
29453,3,Nystari,2490,30,1,1,2,50.0%,1h
29453,3,[LSKBYB]SalamSlam,2490,30,1,1,2,50.0%,3h
29453,3,[PUCP]NoviZ,2490,30,1,2,3,33.3%,1h
29453,3,Sandwich,2490,30,1,2,3,33.3%,52m
29453,3,[CRABBR]DVDA,2490,0,1,3,4,25.0%,55m
29453,2,Kanexus,2490,88,1,3,4,25.0%,33m
29453,1,Kendman,2490,0,1,4,5,20.0%,52m
29453,2,epicprOn,2490,30,1,4,5,20.0%,24m
29453,2,Sasha,2490,30,1,5,6,16.7%,3h
29453,2,ssjchuck,2490,30,1,6,7,14.3%,29m
29453,3,[TrtEng]Picklwarrior,2490,0,0,1,1,0.0%,1h
29453,3,BelegtesBrot,2490,0,0,1,1,0.0%,29m
29453,1,[TheB4d]lucas,2490,0,0,1,1,0.0%,3h
29484,3,chris,2489,1483,164,164,328,50.0%,41m
29484,2,Rapralph,2489,730,47,35,82,57.3%,3h
29484,2,INSOLID,2489,1093,43,41,84,51.2%,4m
29484,2,Raynor,2489,868,41,47,88,46.6%,56m
29484,3,[GOPERÚ]Eral,2489,984,38,34,72,52.8%,1h
29484,2,[f331]Grimlock,2489,604,23,31,54,42.6%,1h
29484,3,Spectrelight,2489,418,18,12,30,60.0%,1h
29484,1,MuckinOnionZ,2489,416,16,24,40,40.0%,3h
29484,2,Olaf,2489,337,13,9,22,59.1%,11m
29484,1,iBurnBridges,2489,332,13,25,38,34.2%,16m
29484,2,[AbcCo]GianMarco,2489,344,11,13,24,45.8%,29m
29484,2,Tiger,2489,271,10,10,20,50.0%,4m
29484,2,Lance,2489,243,7,2,9,77.8%,3h
29484,2,[SC2BOL]MONO,2489,187,6,6,12,50.0%,3h
29484,3,Turtle,2489,154,5,4,9,55.6%,29m
29484,2,SAZZERS,2489,44,4,6,10,40.0%,8m
29484,3,[GRUSP]Waldersaint,2489,60,2,2,4,50.0%,27m
29484,2,xkenshinx,2489,30,2,3,5,40.0%,1h
29484,2,Doopmaster,2489,0,2,4,6,33.3%,1h
29484,2,nightfury,2489,0,2,4,6,33.3%,36m
29484,2,[TeamUR]Grimm,2489,0,1,3,4,25.0%,40m
29484,3,Mayhem,2489,0,0,1,1,0.0%,46m
29484,3,CateDraL,2489,0,0,1,1,0.0%,1h
29484,3,CounterSoul,2489,0,0,2,2,0.0%,1h
29484,3,pkFIRE,2489,0,0,2,2,0.0%,9m
29509,2,MaxigamerTV,2488,1527,125,123,248,50.4%,3h
29509,2,KHYRIOS,2488,670,102,102,204,50.0%,14m
29509,2,Dyckgoezinya,2488,1068,61,70,131,46.6%,1h
29509,3,firsttimesc,2488,234,36,32,68,52.9%,52m
29509,2,MrBurgandy,2488,764,32,25,57,56.1%,1h
29509,2,heWULF,2488,575,24,24,48,50.0%,1h
29509,3,Leam,2488,540,20,19,39,51.3%,3h
29509,2,charles,2488,421,18,13,31,58.1%,14m
29509,3,TurfBurn,2488,413,15,16,31,48.4%,1h
29509,3,vol,2488,325,12,9,21,57.1%,1h
29509,1,Owfyc,2488,337,12,16,28,42.9%,3h
29509,2,UsVsThem,2488,302,10,12,22,45.5%,1h
29509,1,covcg,2488,228,9,2,11,81.8%,3h
29509,1,[notBAD]TheDesertFox,2488,228,9,15,24,37.5%,3h
29509,2,MrdiegoWarSC,2488,256,9,15,24,37.5%,56m
29509,3,TnT,2488,238,8,10,18,44.4%,1h
29509,3,owenl,2488,194,8,10,18,44.4%,7m
29509,2,[FyH]Azathoth,2488,186,5,7,12,41.7%,1h
29509,2,RICE,2488,182,5,7,12,41.7%,25m
29509,3,RicocheT,2488,58,3,2,5,60.0%,37m
29509,2,Silverghost,2488,147,3,2,5,60.0%,3h
29509,1,[ttb1]Duyuhh,2488,74,3,10,13,23.1%,5m
29509,2,TheLesser,2488,102,2,2,4,50.0%,51m
29509,2,Riku,2488,121,2,5,7,28.6%,24m
29509,3,gteche,2488,0,1,0,1,100.0%,1h
29509,3,MxChrisxM,2488,0,1,0,1,100.0%,3h
29509,3,hardcarbon,2488,0,1,0,1,100.0%,45m
29509,3,[NE0]SeuMadruga,2488,0,0,2,2,0.0%,32m
29509,2,dikbut,2488,0,0,3,3,0.0%,42m
29538,1,[GOPERÚ]WJustified,2487,1585,507,506,1013,50.0%,56m
29538,3,Soonsama,2487,1467,279,279,558,50.0%,43m
29538,1,StarluvCraft,2487,1263,127,119,246,51.6%,30m
29538,2,Nooonch,2487,1578,113,104,217,52.1%,40m
29538,2,TrickyKnight,2487,1456,68,66,134,50.7%,33m
29538,3,OtoothVaho,2487,1286,54,45,99,54.5%,32m
29538,1,Ahzdeen,2487,1014,37,44,81,45.7%,25m
29538,1,PapiDx,2487,887,32,33,65,49.2%,1h
29538,1,Yuno,2487,835,31,30,61,50.8%,3h
29538,3,[hz21]hectorcito,2487,598,24,18,42,57.1%,18m
29538,2,KingCampbell,2487,558,21,25,46,45.7%,20m
29538,2,szztz,2487,522,19,21,40,47.5%,50m
29538,2,DaveyJoans,2487,239,18,12,30,60.0%,40m
29538,2,McJiggens,2487,413,17,15,32,53.1%,3h
29538,3,dango,2487,323,11,5,16,68.8%,18m
29538,2,neumann,2487,313,11,12,23,47.8%,19m
29538,2,Niko,2487,170,8,10,18,44.4%,1h
29538,1,Priapizm,2487,126,7,16,23,30.4%,43m
29538,3,Squid,2487,192,6,6,12,50.0%,3h
29538,2,DvjNayko,2487,138,5,10,15,33.3%,1h
29538,3,SnoWolverine,2487,146,4,6,10,40.0%,18m
29538,2,akoolbreeze,2487,91,4,7,11,36.4%,3h
29538,3,RadiumViper,2487,58,3,0,3,100.0%,3h
29538,1,leto,2487,0,3,2,5,60.0%,58m
29538,3,kajev,2487,0,2,3,5,40.0%,17m
29538,3,xXXXx,2487,0,2,4,6,33.3%,1h
29538,2,syid,2487,30,2,5,7,28.6%,4m
29538,3,Vitrok,2487,121,2,6,8,25.0%,3m
29538,3,bcbear,2487,0,1,0,1,100.0%,15m
29538,1,eyekiller,2487,0,1,4,5,20.0%,1h
29538,3,CeoEasyCo,2487,40,1,8,9,11.1%,45m
29538,3,Sleepbringer,2487,0,0,1,1,0.0%,3h
29538,3,ZeroStar,2487,0,0,1,1,0.0%,59m
29538,1,[Reveus]Mortred,2487,0,0,1,1,0.0%,1h
29538,1,traps,2487,0,0,1,1,0.0%,58m
29538,3,Croes,2487,0,0,2,2,0.0%,60m
29538,3,[Clan11]Falkz,2487,0,0,2,2,0.0%,31m
29538,2,Twinkeldee,2487,0,0,3,3,0.0%,50m
29576,3,die,2486,1676,167,159,326,51.2%,3m
29576,3,xxKAZUNARIxx,2486,1124,108,90,198,54.5%,47m
29576,2,CARLOS,2486,1558,88,88,176,50.0%,39m
29576,3,Alberot,2486,1620,64,64,128,50.0%,15m
29576,2,[ecdn]layhodib,2486,1213,56,38,94,59.6%,1h
29576,3,[911TEK]Spankus,2486,1076,47,36,83,56.6%,3h
29576,2,spn,2486,628,29,23,52,55.8%,51m
29576,3,SpicyBoof,2486,647,27,17,44,61.4%,3m
29576,3,John,2486,358,12,10,22,54.5%,31m
29576,2,Loser,2486,262,9,9,18,50.0%,4m
29576,2,Rain,2486,248,8,11,19,42.1%,5m
29576,2,NoSkills,2486,254,8,17,25,32.0%,1h
29576,3,Winbar,2486,211,7,2,9,77.8%,3h
29576,2,BoBnarley,2486,86,4,4,8,50.0%,1h
29576,2,Pendrosa,2486,94,4,8,12,33.3%,50m
29576,3,Shelest,2486,58,3,0,3,100.0%,1h
29576,3,ChaeHoGyun,2486,30,2,0,2,100.0%,14m
29576,3,[SORSC]CooLpeepito,2486,42,2,1,3,66.7%,59m
29576,3,JayBZ,2486,0,2,4,6,33.3%,60m
29576,2,LNSEMSF,2486,62,2,8,10,20.0%,1h
29576,1,BrazzaDiesel,2486,0,1,0,1,100.0%,3h
29576,2,[SQUEE]Castaway,2486,0,1,2,3,33.3%,1h
29576,3,Aemogen,2486,30,1,2,3,33.3%,60m
29576,2,WhySoHot,2486,88,1,3,4,25.0%,3h
29576,1,SSGCerberus,2486,0,1,4,5,20.0%,1h
29576,2,[PWands]Chaflasz,2486,0,1,5,6,16.7%,11m
29576,3,HalFdan,2486,0,0,1,1,0.0%,1h
29576,3,PieIsGood,2486,0,0,3,3,0.0%,40m
29604,1,[sk3tch]scribbles,2485,1539,183,185,368,49.7%,3h
29604,1,blackfire,2485,1157,149,147,296,50.3%,16m
29604,2,SourSquirrel,2485,1574,119,102,221,53.8%,40m
29604,2,VICTOR,2485,1256,101,81,182,55.5%,1h
29604,3,Joffyy,2485,1637,100,92,192,52.1%,1h
29604,2,Killz,2485,1491,61,57,118,51.7%,1h
29604,2,ALEX,2485,1256,60,55,115,52.2%,3h
29604,2,Lelouch,2485,890,58,55,113,51.3%,1h
29604,2,[PUPUS]toretohack,2485,668,30,28,58,51.7%,3h
29604,2,[AoBDE]Gooby,2485,371,29,44,73,39.7%,33m
29604,3,Holz,2485,332,13,13,26,50.0%,10m
29604,2,[Atomix]rooster,2485,272,11,12,23,47.8%,52m
29604,1,FatPanda,2485,263,10,13,23,43.5%,36m
29604,2,Leonitis,2485,276,9,9,18,50.0%,3h
29604,2,NeverPro,2485,178,6,11,17,35.3%,29m
29604,2,Anpaul,2485,120,5,6,11,45.5%,38m
29604,2,TheSaint,2485,62,5,6,11,45.5%,33m
29604,2,MusicGame,2485,156,4,6,10,40.0%,3h
29604,2,tomasheimer,2485,132,4,7,11,36.4%,16m
29604,2,[JetPAC]GassyGorilla,2485,116,3,2,5,60.0%,56m
29604,1,SnacK,2485,121,3,8,11,27.3%,3h
29604,3,[MSHS09]aiktheegg,2485,97,2,1,3,66.7%,3h
29604,3,[TBF]JeMus,2485,30,2,2,4,50.0%,7m
29604,3,bankok,2485,120,2,5,7,28.6%,3h
29604,2,JJSpacer,2485,0,1,0,1,100.0%,3h
29604,3,deathgun,2485,30,1,2,3,33.3%,1h
29604,2,EnderWiggin,2485,30,1,4,5,20.0%,24m
29604,2,ShinyHero,2485,30,1,4,5,20.0%,25m
29604,2,Marduck,2485,30,1,4,5,20.0%,22m
29604,3,Spartacus,2485,0,1,4,5,20.0%,1h
29604,2,IAMKOREAN,2485,30,1,6,7,14.3%,1h
29604,2,TurdFerguson,2485,0,0,2,2,0.0%,39m
29636,1,[OceanT]HugoSabara,2484,1615,234,231,465,50.3%,3h
29636,3,RDG,2484,1408,103,96,199,51.8%,1h
29636,1,BrokenTactic,2484,1026,90,97,187,48.1%,3h
29636,3,Boyle,2484,1605,69,78,147,46.9%,3m
29636,2,billy,2484,992,62,41,103,60.2%,3h
29636,2,copito,2484,1424,56,50,106,52.8%,1h
29636,3,QueAsco,2484,956,47,32,79,59.5%,28m
29636,2,[DOSC2]JayRoc,2484,837,43,49,92,46.7%,1h
29636,2,Jibathy,2484,405,30,20,50,60.0%,3h
29636,2,Upstart,2484,553,25,22,47,53.2%,3h
29636,2,Makaveli,2484,566,19,24,43,44.2%,3h
29636,2,REDSILENCEX,2484,400,16,15,31,51.6%,3h
29636,2,EASTLA,2484,103,9,15,24,37.5%,54m
29636,3,BlueBalls,2484,244,8,8,16,50.0%,42m
29636,1,AliveHero,2484,198,6,15,21,28.6%,33m
29636,3,[Hongos]RJCCORDERO,2484,148,5,5,10,50.0%,1h
29636,1,aaaa,2484,0,4,4,8,50.0%,1h
29636,3,PewPewPew,2484,120,4,5,9,44.4%,1h
29636,2,UnitLost,2484,157,4,8,12,33.3%,3h
29636,3,[Mlnz]Panander,2484,86,3,2,5,60.0%,1h
29636,3,Reverence,2484,34,3,5,8,37.5%,46m
29636,3,Vegetable,2484,30,2,0,2,100.0%,1h
29636,1,bairdos,2484,0,2,3,5,40.0%,1h
29636,3,AMan,2484,97,2,4,6,33.3%,26m
29636,3,stlouis,2484,0,1,0,1,100.0%,1h
29636,2,nil,2484,42,1,1,2,50.0%,16m
29636,3,[QcScT]Totoja,2484,30,1,2,3,33.3%,3h
29636,2,Pala,2484,0,1,2,3,33.3%,3h
29636,3,Tacitus,2484,0,0,1,1,0.0%,1h
29636,3,Liu,2484,0,0,2,2,0.0%,1h
29636,2,MaxisPrime,2484,0,0,3,3,0.0%,1h
29636,2,Reis,2484,0,0,4,4,0.0%,23m
29636,2,TFCanadian,2484,0,0,5,5,0.0%,56m
29669,2,scitts,2483,1558,195,189,384,50.8%,42m
29669,2,DuongBlizz,2483,1561,136,127,263,51.7%,3h
29669,2,DarkMoon,2483,1508,87,77,164,53.0%,25m
29669,2,LonelySumo,2483,1568,62,65,127,48.8%,1h
29669,2,IUS,2483,1112,47,41,88,53.4%,40m
29669,3,octaviotin,2483,542,44,24,68,64.7%,25m
29669,2,Legion,2483,845,44,41,85,51.8%,39m
29669,2,SpiritFriend,2483,948,40,31,71,56.3%,46m
29669,2,TheONC,2483,552,25,25,50,50.0%,1h
29669,2,ConnorDotCom,2483,536,22,23,45,48.9%,3h
29669,3,Ithasnoname,2483,383,13,14,27,48.1%,3h
29669,1,ToganX,2483,237,5,11,16,31.2%,20m
29669,3,Lego,2483,118,4,3,7,57.1%,18m
29669,2,hylia,2483,30,4,5,9,44.4%,17m
29669,1,OSMOSIS,2483,140,4,13,17,23.5%,1h
29669,2,DiamondKill,2483,126,3,1,4,75.0%,3h
29669,3,Jonathan,2483,60,3,2,5,60.0%,7m
29669,2,RhYno,2483,102,3,3,6,50.0%,3h
29669,3,Stinker,2483,0,2,3,5,40.0%,1h
29669,2,[TGosuA]Patata,2483,0,1,0,1,100.0%,36m
29669,3,PregoArgtano,2483,0,1,0,1,100.0%,17m
29669,3,Murphy,2483,30,1,1,2,50.0%,50m
29669,3,Cal,2483,0,1,4,5,20.0%,1h
29669,1,[Fir3s]CapnpwnZr,2483,97,1,6,7,14.3%,1h
29669,1,Oddjob,2483,0,0,8,8,0.0%,52m
29669,2,GwaiLo,2483,0,0,10,10,0.0%,34m
29695,1,Evilost,2482,1673,171,174,345,49.6%,24m
29695,2,Rosso,2482,1553,79,65,144,54.9%,36m
29695,3,Arjuna,2482,1522,66,59,125,52.8%,32m
29695,3,Skinare,2482,1615,66,67,133,49.6%,1h
29695,1,[NutLow]Blsnbordr,2482,976,37,40,77,48.1%,18m
29695,2,[REEFR]purplekush,2482,546,21,24,45,46.7%,5m
29695,3,Xuron,2482,565,20,21,41,48.8%,59m
29695,3,donkey,2482,435,18,19,37,48.6%,3h
29695,2,ReinorSC,2482,376,16,22,38,42.1%,6m
29695,3,Aion,2482,394,14,26,40,35.0%,4m
29695,3,[GUNITE]SomeDonkus,2482,62,5,8,13,38.5%,36m
29695,3,[PiGPan]Ricez,2482,139,4,4,8,50.0%,1h
29695,2,Jojowhite,2482,132,3,1,4,75.0%,16m
29695,2,Dimash,2482,140,3,6,9,33.3%,24m
29695,3,DRACO,2482,127,3,6,9,33.3%,3h
29695,2,Chino,2482,62,3,9,12,25.0%,54m
29695,3,YellowBanana,2482,30,3,9,12,25.0%,4m
29695,3,MrEpants,2482,0,2,3,5,40.0%,1h
29695,3,[MIKES]Mike,2482,0,2,3,5,40.0%,42m
29695,1,RutherfordBH,2482,0,2,5,7,28.6%,50m
29695,3,LightGeneral,2482,0,1,0,1,100.0%,60m
29695,2,Fenix,2482,30,1,3,4,25.0%,11m
29695,2,[AwaR]Fenix,2482,30,1,4,5,20.0%,7m
29695,1,hiroshikun,2482,0,1,4,5,20.0%,3h
29695,3,[RvN]ReMiiX,2482,0,0,1,1,0.0%,46m
29695,3,[LDLOC]RONZINNNNNNN,2482,0,0,2,2,0.0%,1h
29695,3,Sargon,2482,0,0,2,2,0.0%,1h
29695,3,BusError,2482,0,0,2,2,0.0%,1h
29723,3,LasagneWest,2481,1542,200,175,375,53.3%,3h
29723,3,Peter,2481,1279,108,101,209,51.7%,31m
29723,3,lanzgamer,2481,509,93,78,171,54.4%,37m
29723,2,qkle,2481,1613,71,72,143,49.7%,4m
29723,3,Paradiddle,2481,1040,43,34,77,55.8%,3h
29723,3,TheINKoz,2481,812,36,25,61,59.0%,3h
29723,1,[DBSQ]iMacro,2481,631,20,34,54,37.0%,38m
29723,3,Mundinho,2481,492,19,11,30,63.3%,3h
29723,2,Neo,2481,263,16,15,31,51.6%,3h
29723,2,[CHGGS]WillyThePimp,2481,369,15,17,32,46.9%,1h
29723,3,McMogus,2481,349,14,10,24,58.3%,1h
29723,2,RinI,2481,348,13,16,29,44.8%,11m
29723,2,[cluez]Blacks,2481,168,12,16,28,42.9%,55m
29723,2,[NuTFuW]KayElBee,2481,288,10,15,25,40.0%,3h
29723,3,ElCalvo,2481,201,5,4,9,55.6%,1h
29723,2,WilliamKelly,2481,162,5,8,13,38.5%,1h
29723,1,ComBiNe,2481,141,5,8,13,38.5%,45m
29723,2,TSlice,2481,86,4,6,10,40.0%,3h
29723,3,rambo,2481,122,3,5,8,37.5%,3h
29723,3,MulPen,2481,120,2,1,3,66.7%,1h
29723,3,Crocop,2481,60,2,3,5,40.0%,1h
29723,3,MemeLord,2481,0,1,0,1,100.0%,53m
29723,1,HEROPANDA,2481,0,1,1,2,50.0%,3h
29723,2,[MHCC]franchukyTZP,2481,0,1,2,3,33.3%,53m
29723,2,elviolatumba,2481,0,1,3,4,25.0%,1h
29723,2,[Pokmon]HotPockets,2481,30,1,4,5,20.0%,1h
29723,3,SrJoSe,2481,0,1,5,6,16.7%,1h
29723,3,Skullbreaker,2481,0,0,1,1,0.0%,3h
29723,3,EUPHORIA,2481,0,0,1,1,0.0%,1h
29723,2,[MDKftw]DbleAron,2481,0,0,2,2,0.0%,3h
29723,2,CommradeNiko,2481,0,0,2,2,0.0%,34m
29723,1,Dewbie,2481,0,0,2,2,0.0%,1h
29723,2,kit,2481,0,0,2,2,0.0%,1h
29723,2,WONDERBOY,2481,0,0,4,4,0.0%,40m
29757,3,billyballs,2480,1611,149,131,280,53.2%,32m
29757,2,Fegelein,2480,1319,133,120,253,52.6%,22m
29757,1,Reflect,2480,1090,101,102,203,49.8%,1h
29757,3,[MSTEIN]Johhn,2480,1552,95,94,189,50.3%,1h
29757,2,poppy,2480,507,66,45,111,59.5%,7m
29757,2,[ZWars]Apachurro,2480,1425,59,54,113,52.2%,6m
29757,1,redsaginger,2480,1029,39,44,83,47.0%,3h
29757,2,halbhalbhalb,2480,667,26,24,50,52.0%,1h
29757,2,ThePatriarch,2480,610,24,24,48,50.0%,1h
29757,2,SnakeholeRON,2480,604,23,26,49,46.9%,26m
29757,3,[ZTemp]Chesshire,2480,368,14,8,22,63.6%,32m
29757,2,TROLLMAN,2480,274,10,16,26,38.5%,48m
29757,3,Jiska,2480,242,8,2,10,80.0%,37m
29757,3,[F2AAA]randomwalk,2480,177,8,3,11,72.7%,9m
29757,3,stopufool,2480,0,4,1,5,80.0%,7m
29757,3,rainland,2480,88,4,1,5,80.0%,16m
29757,3,Sandoli,2480,0,4,1,5,80.0%,17m
29757,3,critter,2480,94,4,5,9,44.4%,3h
29757,2,Nonzoe,2480,90,4,10,14,28.6%,3h
29757,3,[ELLOCO]Mayota,2480,36,3,2,5,60.0%,40m
29757,2,Yakab,2480,88,3,6,9,33.3%,3h
29757,2,aldezerg,2480,86,3,7,10,30.0%,29m
29757,3,Chepe,2480,27,2,3,5,40.0%,1h
29757,1,Libertario,2480,0,2,5,7,28.6%,14m
29757,2,kitinha,2480,62,2,6,8,25.0%,50m
29757,1,VictarionGJ,2480,30,2,9,11,18.2%,1h
29757,3,DESCRI,2480,0,1,0,1,100.0%,10m
29757,1,sPecOpNewNom,2480,0,1,5,6,16.7%,1h
29757,2,AlphaGo,2480,30,1,6,7,14.3%,3h
29757,1,dkout,2480,0,0,1,1,0.0%,11m
29757,3,joinDSAbro,2480,0,0,1,1,0.0%,50m
29757,3,jclym,2480,0,0,1,1,0.0%,3h
29757,3,LngNEKpeople,2480,0,0,2,2,0.0%,1h
29757,3,rob,2480,0,0,2,2,0.0%,10m
29791,2,John,2479,1635,144,149,293,49.1%,27m
29791,1,Parky,2479,1147,80,82,162,49.4%,3h
29791,3,McLOVIN,2479,1526,68,52,120,56.7%,20m
29791,1,Krooked,2479,1389,54,63,117,46.2%,44m
29791,2,HuevoSplash,2479,1052,47,41,88,53.4%,3h
29791,3,[Bnotre]GreenPhoenix,2479,852,34,25,59,57.6%,19m
29791,3,CombatEX,2479,892,32,30,62,51.6%,3h
29791,3,Blastark,2479,549,26,20,46,56.5%,46m
29791,2,[XpKAc]LOKTHAR,2479,478,18,17,35,51.4%,1h
29791,3,Antonio,2479,393,15,6,21,71.4%,28m
29791,3,deakdollars,2479,322,14,11,25,56.0%,1h
29791,1,[LOHs]Spanky,2479,434,13,24,37,35.1%,52m
29791,3,[REPORT]Starzergian,2479,352,12,13,25,48.0%,3h
29791,3,Pickle,2479,227,11,8,19,57.9%,4m
29791,1,Argem,2479,237,11,10,21,52.4%,18m
29791,2,KillerDonut,2479,274,10,11,21,47.6%,50m
29791,2,RSC,2479,186,7,7,14,50.0%,22m
29791,2,[Silica]herzenlayana,2479,132,5,9,14,35.7%,1h
29791,2,Brk,2479,134,4,9,13,30.8%,48m
29791,1,MstkMooseDog,2479,130,4,12,16,25.0%,54m
29791,3,FoBoS,2479,120,3,1,4,75.0%,1h
29791,3,[detres]XxJJGAMINGxX,2479,74,3,3,6,50.0%,3h
29791,3,[3JELLY]BigJELLY,2479,30,2,0,2,100.0%,3m
29791,3,Wildebees,2479,0,2,3,5,40.0%,46m
29791,3,prokolgotki,2479,0,2,4,6,33.3%,22m
29791,1,Minoshiro,2479,48,2,8,10,20.0%,3h
29791,3,valerian,2479,0,1,0,1,100.0%,47m
29791,3,LoboSalvaje,2479,34,1,1,2,50.0%,9m
29791,2,Volghan,2479,0,1,3,4,25.0%,3h
29791,3,japshornyasf,2479,0,0,1,1,0.0%,20m
29791,1,MundayKnight,2479,0,0,1,1,0.0%,39m
29791,3,VictoriuzPRD,2479,0,0,1,1,0.0%,31m
29791,3,[SBXX]Permahost,2479,0,0,1,1,0.0%,20m
29791,3,Kozy,2479,0,0,1,1,0.0%,1h
29791,3,FireStorm,2479,0,0,2,2,0.0%,1h
29826,3,archangel,2478,1570,174,184,358,48.6%,10m
29826,3,TrumpFTW,2478,1556,163,167,330,49.4%,31m
29826,1,[SyCo]RockNRolla,2478,1575,133,136,269,49.4%,12m
29826,1,AlexSemi,2478,1606,106,109,215,49.3%,1h
29826,3,Leon,2478,1576,76,67,143,53.1%,1h
29826,2,[95O]ArthurKing,2478,1091,59,58,117,50.4%,55m
29826,1,FatherKarras,2478,493,55,60,115,47.8%,55m
29826,1,zerdeja,2478,1171,50,49,99,50.5%,9m
29826,1,[DarkPG]Akyaabil,2478,1205,50,58,108,46.3%,3h
29826,3,Shweddynuts,2478,1377,49,58,107,45.8%,30m
29826,3,isak,2478,1204,42,57,99,42.4%,27m
29826,3,BestiaNegra,2478,723,32,22,54,59.3%,1h
29826,3,[XDRAX8]Jake,2478,551,24,17,41,58.5%,10m
29826,2,JosephCT,2478,516,21,19,40,52.5%,29m
29826,2,clam,2478,481,19,17,36,52.8%,3h
29826,3,[FuCl]RustyBasterd,2478,284,10,7,17,58.8%,32m
29826,3,rammingspeed,2478,200,7,8,15,46.7%,46m
29826,2,Erri,2478,202,7,13,20,35.0%,29m
29826,2,Sike,2478,154,6,6,12,50.0%,48m
29826,2,nuggetbucket,2478,202,6,7,13,46.2%,56m
29826,3,STARFOX,2478,184,6,8,14,42.9%,3h
29826,3,NoobyKorean,2478,66,5,5,10,50.0%,1h
29826,2,LGSN,2478,122,5,6,11,45.5%,1h
29826,3,[MORT51]Zergie,2478,86,4,1,5,80.0%,3h
29826,2,eltakero,2478,0,4,2,6,66.7%,28m
29826,3,WeOutHere,2478,0,4,4,8,50.0%,11m
29826,3,FiendMaster,2478,92,4,18,22,18.2%,28m
29826,2,Poimet,2478,160,3,2,5,60.0%,1h
29826,1,Rookie,2478,92,3,5,8,37.5%,56m
29826,2,aitchkay,2478,112,3,6,9,33.3%,3h
29826,1,[EpicG]Fantom,2478,92,2,0,2,100.0%,45m
29826,1,TECHNOCRATIC,2478,48,2,4,6,33.3%,1h
29826,3,SlothBones,2478,94,2,4,6,33.3%,48m
29826,3,WineDude,2478,0,1,0,1,100.0%,3h
29826,3,BiscuitHD,2478,97,1,4,5,20.0%,1h
29826,2,[SFEEM]SFEEMdego,2478,30,1,5,6,16.7%,53m
29826,3,[BldnH]CrimsonRain,2478,0,0,1,1,0.0%,4m
29826,3,Sebastian,2478,0,0,2,2,0.0%,27m
29826,3,Lolserver,2478,0,0,2,2,0.0%,3h
29826,2,Fenix,2478,0,0,3,3,0.0%,3h
29866,2,CAPTAINDINGU,2477,1567,117,107,224,52.2%,40m
29866,2,badbunny,2477,1412,114,102,216,52.8%,1h
29866,2,[uepa]DANIEL,2477,1577,100,100,200,50.0%,3h
29866,1,DominaShaun,2477,1004,65,67,132,49.2%,32m
29866,2,SCL,2477,1397,59,61,120,49.2%,1h
29866,2,Shwindy,2477,1250,47,59,106,44.3%,35m
29866,2,Toope,2477,965,42,43,85,49.4%,1h
29866,3,cooljulz,2477,650,37,42,79,46.8%,28m
29866,2,[Sune]CarlosRo,2477,671,28,24,52,53.8%,56m
29866,2,[EpicG]TheEduGame,2477,660,25,22,47,53.2%,39m
29866,3,chqis,2477,514,22,11,33,66.7%,1h
29866,2,Zamskapon,2477,261,10,11,21,47.6%,42m
29866,1,Solarian,2477,312,9,10,19,47.4%,1h
29866,1,lovetosploog,2477,253,9,14,23,39.1%,1h
29866,2,[kins]Joskin,2477,287,8,11,19,42.1%,52m
29866,3,BIOS,2477,224,6,5,11,54.5%,1h
29866,1,HameMarco,2477,198,6,6,12,50.0%,36m
29866,3,Zlandanar,2477,172,6,6,12,50.0%,3m
29866,2,Trogdor,2477,153,6,8,14,42.9%,52m
29866,2,Celtic,2477,168,5,6,11,45.5%,3h
29866,2,AkoSiGerald,2477,142,5,7,12,41.7%,26m
29866,2,Insoo,2477,166,5,7,12,41.7%,45m
29866,2,TheAx,2477,30,4,7,11,36.4%,4m
29866,3,ItsGeorgie,2477,90,3,3,6,50.0%,38m
29866,2,TinTin,2477,89,1,2,3,33.3%,3h
29866,2,legacy,2477,30,1,9,10,10.0%,3h
29866,3,Gzuz,2477,0,0,1,1,0.0%,32m
29866,3,Onezer,2477,0,0,3,3,0.0%,3h
29866,3,leadhead,2477,0,0,4,4,0.0%,18m
29895,2,TIEightyTwo,2476,1554,223,220,443,50.3%,1h
29895,2,PapyDanone,2476,1577,184,181,365,50.4%,51m
29895,2,jmhal,2476,1561,148,141,289,51.2%,48m
29895,2,Zori,2476,1528,148,145,293,50.5%,3h
29895,3,Nitis,2476,1035,147,146,293,50.2%,39m
29895,2,dlx,2476,513,80,81,161,49.7%,1h
29895,3,aNoNyMoUs,2476,1596,75,55,130,57.7%,3h
29895,2,Uzul,2476,402,67,64,131,51.1%,56m
29895,1,contramundi,2476,1112,67,73,140,47.9%,1h
29895,3,RaxOnraX,2476,1059,50,29,79,63.3%,52m
29895,2,[DhZAc1]MrRobot,2476,933,47,42,89,52.8%,6m
29895,3,[nGeKv]KeLeVraN,2476,660,31,42,73,42.5%,32m
29895,3,Shmoofy,2476,400,30,28,58,51.7%,8m
29895,3,[Lecka]BonSchlonzoo,2476,694,27,27,54,50.0%,32m
29895,3,Theokiedoke,2476,598,22,17,39,56.4%,1h
29895,3,BlackElk,2476,379,15,15,30,50.0%,1h
29895,1,Grimes,2476,226,9,11,20,45.0%,3h
29895,2,assassin,2476,260,9,13,22,40.9%,42m
29895,3,FriALoR,2476,250,8,2,10,80.0%,44m
29895,3,JAQ,2476,144,6,4,10,60.0%,25m
29895,1,Quixotic,2476,160,6,4,10,60.0%,3h
29895,3,Mineral,2476,140,5,4,9,55.6%,3m
29895,3,Luchopsio,2476,116,5,5,10,50.0%,1h
29895,3,Dwight,2476,0,3,3,6,50.0%,59m
29895,1,Nottorius,2476,122,3,9,12,25.0%,3h
29895,2,DrBowMan,2476,117,2,3,5,40.0%,60m
29895,3,Jambone,2476,121,2,3,5,40.0%,16m
29895,2,Smushprune,2476,64,2,5,7,28.6%,22m
29895,3,ProfKim,2476,0,2,5,7,28.6%,49m
29895,3,ChiRob,2476,30,1,1,2,50.0%,14m
29895,2,STOOPS,2476,30,1,4,5,20.0%,1h
29895,3,[BTPX]Voltron,2476,0,0,1,1,0.0%,29m
29895,3,dabers,2476,0,0,1,1,0.0%,1h
29895,2,TeemoSlayer,2476,0,0,1,1,0.0%,3h
29895,3,MarineKing,2476,0,0,2,2,0.0%,32m
29895,3,HowtheHare,2476,0,0,4,4,0.0%,27m
29931,1,[Softy]AttackMan,2475,1502,174,158,332,52.4%,18m
29931,3,[carnal]HectorSR,2475,1526,78,70,148,52.7%,59m
29931,1,[ZTemps]dayodave,2475,1565,69,61,130,53.1%,16m
29931,3,IIIIIIIIIIII,2475,562,48,8,56,85.7%,3h
29931,3,[EvilGC]tomato,2475,1066,40,36,76,52.6%,1h
29931,1,[GL1ES]creeed,2475,789,40,44,84,47.6%,40m
29931,2,Dorgis,2475,979,38,36,74,51.4%,1h
29931,3,[Lp]ZeiFeR,2475,1126,37,55,92,40.2%,24m
29931,2,[Ash3s]OMNIPOTENT,2475,503,20,14,34,58.8%,1h
29931,1,jonnihyunkim,2475,440,16,19,35,45.7%,30m
29931,2,Muggu,2475,366,14,15,29,48.3%,1h
29931,2,lllIIIllllII,2475,338,12,17,29,41.4%,1h
29931,1,yogurt,2475,190,10,9,19,52.6%,1h
29931,2,SuicideMemes,2475,238,9,11,20,45.0%,3h
29931,2,Bachelett,2475,114,6,3,9,66.7%,1h
29931,3,JOHANrc,2475,170,6,7,13,46.2%,18m
29931,3,josé,2475,154,5,6,11,45.5%,32m
29931,2,KONGAR,2475,152,5,12,17,29.4%,35m
29931,3,[TRKPAD]Dwarfe,2475,136,4,1,5,80.0%,3h
29931,3,Atu,2475,0,4,5,9,44.4%,18m
29931,1,Kaleza,2475,181,4,8,12,33.3%,3h
29931,3,ESLAyed,2475,117,3,3,6,50.0%,20m
29931,3,[crispr]SantaClaus,2475,0,3,4,7,42.9%,7m
29931,3,[IVVVI]Zoboomafoo,2475,32,2,1,3,66.7%,32m
29931,2,RDawg,2475,88,2,3,5,40.0%,1h
29931,2,Walty,2475,129,2,4,6,33.3%,1h
29931,2,Sparkzey,2475,68,2,7,9,22.2%,1h
29931,3,Player,2475,0,1,0,1,100.0%,48m
29931,3,wil,2475,0,1,0,1,100.0%,1h
29931,3,Earth,2475,0,1,0,1,100.0%,53m
29931,3,Villain,2475,0,1,1,2,50.0%,3h
29931,1,[IBVz]rapednubs,2475,94,1,2,3,33.3%,22m
29931,2,Prax,2475,38,1,5,6,16.7%,44m
29931,3,[Meowbi]Lilith,2475,0,0,1,1,0.0%,3h
29931,3,MrKang,2475,0,0,1,1,0.0%,1h
29931,3,kevin,2475,0,0,1,1,0.0%,32m
29931,3,[Banqe]Leo,2475,0,0,1,1,0.0%,20m
29931,3,LessSweet,2475,0,0,1,1,0.0%,10m
29931,3,Goxellot,2475,0,0,2,2,0.0%,24m
29970,3,KARAX,2474,1213,91,43,134,67.9%,1h
29970,3,tflo,2474,1102,56,56,112,50.0%,10m
29970,1,Newool,2474,1330,55,53,108,50.9%,1h
29970,3,[HBDO]UBEREATS,2474,629,29,20,49,59.2%,28m
29970,3,jhhon,2474,594,26,11,37,70.3%,32m
29970,3,Kongming,2474,626,26,19,45,57.8%,1h
29970,3,randomzebra,2474,414,17,14,31,54.8%,48m
29970,2,Perisma,2474,430,15,22,37,40.5%,3h
29970,3,Pumpkin,2474,376,14,12,26,53.8%,3h
29970,2,SylvanNight,2474,312,10,14,24,41.7%,1h
29970,1,[TheDOH]murcoff,2474,265,10,14,24,41.7%,1h
29970,2,DKFourTwenty,2474,228,9,5,14,64.3%,3h
29970,2,ROMIK,2474,232,9,6,15,60.0%,3h
29970,2,Nichevo,2474,250,9,8,17,52.9%,3h
29970,3,SkyBreaker,2474,62,3,0,3,100.0%,18m
29970,3,[PBS]eliteshadow,2474,30,3,6,9,33.3%,31m
29970,3,Cheddar,2474,143,3,6,9,33.3%,16m
29970,2,zerloc,2474,0,2,4,6,33.3%,51m
29970,3,johnny,2474,30,1,3,4,25.0%,1h
29970,3,obiwanknubie,2474,0,0,1,1,0.0%,18m
29970,1,BigSmoke,2474,0,0,1,1,0.0%,10m
29970,3,tuntfel,2474,0,0,1,1,0.0%,31m
29992,2,Nazgoth,2473,1515,118,116,234,50.4%,26m
29992,1,FrankSinatra,2473,657,71,69,140,50.7%,3h
29992,2,Oscarbx,2473,990,64,59,123,52.0%,3h
29992,3,JACHAURU,2473,1275,60,60,120,50.0%,1h
29992,1,Toread,2473,1470,57,63,120,47.5%,36m
29992,3,grimbus,2473,881,39,24,63,61.9%,3h
29992,3,MurilloCR,2473,765,30,22,52,57.7%,1h
29992,3,akirakato,2473,714,30,23,53,56.6%,39m
29992,3,[ENCE]eletorio,2473,742,28,22,50,56.0%,3h
29992,2,[cluez]Mitegama,2473,364,17,19,36,47.2%,7m
29992,3,eric,2473,229,10,14,24,41.7%,3h
29992,2,Rixard,2473,232,8,11,19,42.1%,1h
29992,3,moomant,2473,168,5,1,6,83.3%,4m
29992,2,WarriorZero,2473,167,4,6,10,40.0%,3h
29992,2,Superkewl,2473,116,4,7,11,36.4%,1h
29992,2,ZammyBanger,2473,108,4,7,11,36.4%,1h
29992,2,[Macac0]KillerViods,2473,116,4,8,12,33.3%,1h
29992,2,PamelaUwU,2473,30,4,9,13,30.8%,30m
29992,3,Lalolink,2473,0,3,2,5,60.0%,12m
29992,3,MetamorphSC,2473,88,3,3,6,50.0%,46m
29992,3,Rizbits,2473,98,3,4,7,42.9%,1h
29992,2,AssassinLeg,2473,30,3,5,8,37.5%,35m
29992,2,tankfilms,2473,93,3,6,9,33.3%,3h
29992,2,EffeCt,2473,64,2,7,9,22.2%,3h
29992,3,AcerBR,2473,0,1,0,1,100.0%,3h
29992,3,Ninjabenji,2473,0,1,0,1,100.0%,42m
29992,3,Keriggan,2473,0,1,0,1,100.0%,55m
29992,2,Hideonbarrel,2473,30,1,4,5,20.0%,51m
29992,1,Leo,2473,0,1,4,5,20.0%,26m
29992,3,[OceanT]LowLinK,2473,0,0,1,1,0.0%,49m
29992,3,ruysso,2473,0,0,2,2,0.0%,1h
29992,3,[TiChum]Nolda,2473,0,0,16,16,0.0%,31m
30024,1,[JUGOS]Aiolia,2472,1648,302,300,602,50.2%,4m
30024,2,Kamus,2472,1110,60,57,117,51.3%,33m
30024,1,Dtrav,2472,1456,51,63,114,44.7%,1h
30024,1,Aragorn,2472,1167,43,48,91,47.3%,25m
30024,2,mollejita,2472,634,30,21,51,58.8%,1h
30024,3,CheeseLovers,2472,590,26,11,37,70.3%,38m
30024,3,livexx,2472,653,26,22,48,54.2%,3h
30024,3,Crazy,2472,571,25,8,33,75.8%,17m
30024,3,[Aiuur]GillesDeRais,2472,631,24,17,41,58.5%,1h
30024,1,Wargasm,2472,663,23,26,49,46.9%,60m
30024,1,valaka,2472,511,23,36,59,39.0%,1h
30024,3,LETHAL,2472,349,13,5,18,72.2%,59m
30024,3,SuperSethie,2472,389,13,14,27,48.1%,3h
30024,3,Skeletor,2472,266,11,5,16,68.8%,59m
30024,1,Gilgabro,2472,224,10,17,27,37.0%,17m
30024,3,RaynorTurtle,2472,259,8,3,11,72.7%,1h
30024,2,Gunnar,2472,219,6,12,18,33.3%,58m
30024,3,Yoochun,2472,66,5,6,11,45.5%,1h
30024,3,[FatMom]Player,2472,86,4,0,4,100.0%,1h
30024,2,[LABGH]juanchoxtor,2472,128,4,4,8,50.0%,51m
30024,3,Protogram,2472,58,4,5,9,44.4%,1h
30024,1,TeeehPanda,2472,121,4,6,10,40.0%,55m
30024,1,Novalk,2472,0,3,2,5,60.0%,6m
30024,3,Danpra,2472,88,3,2,5,60.0%,1h
30024,3,Mathias,2472,0,3,2,5,60.0%,3h
30024,3,HoYaTV,2472,97,3,4,7,42.9%,1h
30024,3,[Chaz69]Nightmare,2472,51,2,2,4,50.0%,1h
30024,3,Jubidada,2472,0,1,1,2,50.0%,1h
30024,3,blacksheep,2472,30,1,4,5,20.0%,1h
30024,3,Hobgoblin,2472,0,1,4,5,20.0%,42m
30024,3,Redjac,2472,0,0,1,1,0.0%,1h
30024,2,Aiolia,2472,0,0,1,1,0.0%,29m
30024,3,Kiffage,2472,0,0,1,1,0.0%,28m
30024,1,TheOvenMitt,2472,0,0,1,1,0.0%,55m
30024,3,santigold,2472,0,0,1,1,0.0%,23m
30059,1,renzotorres,2471,995,64,61,125,51.2%,27m
30059,2,Heny,2471,1075,54,47,101,53.5%,17m
30059,3,turum,2471,731,47,43,90,52.2%,3h
30059,2,dan,2471,980,44,33,77,57.1%,1h
30059,2,[eX]Fish,2471,856,43,43,86,50.0%,3h
30059,3,chaos,2471,924,36,34,70,51.4%,3h
30059,1,Miurem,2471,750,33,34,67,49.3%,30m
30059,2,Quine,2471,669,25,28,53,47.2%,1h
30059,2,taenorn,2471,427,22,28,50,44.0%,1h
30059,2,LongLiveAce,2471,492,21,19,40,52.5%,3h
30059,2,[AbcCo]NITRAM,2471,386,18,8,26,69.2%,1h
30059,3,Benaiah,2471,330,12,9,21,57.1%,1h
30059,2,[HPing]Armadesdons,2471,118,8,1,9,88.9%,39m
30059,2,[ZHK]wayo,2471,235,8,8,16,50.0%,3h
30059,2,Reptar,2471,204,7,14,21,33.3%,4m
30059,3,Sihv,2471,148,6,3,9,66.7%,32m
30059,3,Acheron,2471,200,6,5,11,54.5%,46m
30059,2,Titus,2471,204,6,9,15,40.0%,3h
30059,3,Burlap,2471,168,4,1,5,80.0%,30m
30059,2,JaymesReady,2471,152,4,3,7,57.1%,1h
30059,3,Snorgs,2471,88,3,4,7,42.9%,1h
30059,3,ReCrAkeD,2471,42,3,5,8,37.5%,1h
30059,2,bearman,2471,36,2,0,2,100.0%,3m
30059,3,LALO,2471,0,2,5,7,28.6%,3h
30059,3,Zimonte,2471,0,1,0,1,100.0%,3h
30059,3,[FUUD]kstlouis,2471,0,0,1,1,0.0%,3h
30059,3,[KAMEH]KwalityHarse,2471,0,0,1,1,0.0%,12m
30059,3,PNetron,2471,0,0,1,1,0.0%,17m
30087,2,xluisitox,2470,1068,45,42,87,51.7%,3h
30087,3,WolFmaN,2470,1067,41,33,74,55.4%,3m
30087,3,Apizzzill,2470,657,37,24,61,60.7%,1h
30087,2,BoonesZoomie,2470,538,22,25,47,46.8%,1h
30087,1,JCCE,2470,244,8,8,16,50.0%,36m
30087,2,HeatGuyJ,2470,174,8,11,19,42.1%,38m
30087,2,SickTheory,2470,150,7,4,11,63.6%,26m
30087,1,TheMustard,2470,110,5,10,15,33.3%,1h
30087,2,GeneralDuke,2470,86,4,8,12,33.3%,1h
30087,3,[Redent]Zecaida,2470,38,3,3,6,50.0%,1h
30087,2,[UAK]Feelitbrah,2470,116,3,5,8,37.5%,39m
30087,3,Jurgei,2470,38,3,6,9,33.3%,1h
30087,2,BowToMe,2470,0,3,7,10,30.0%,15m
30087,3,MissLuna,2470,0,2,4,6,33.3%,3h
30087,1,rokato,2470,0,2,5,7,28.6%,50m
30087,1,[goodho]ajam,2470,92,2,6,8,25.0%,3h
30087,3,LeeminKappa,2470,0,1,0,1,100.0%,1h
30087,3,[VACAXD]MeiMisakiNyu,2470,0,1,0,1,100.0%,53m
30087,3,PMAMODE,2470,0,1,1,2,50.0%,1h
30087,1,[BraziI]Thiago,2470,0,1,4,5,20.0%,1h
30087,3,fatperson,2470,0,0,1,1,0.0%,32m
30087,3,VaGmastRson,2470,0,0,1,1,0.0%,3h
30109,1,ZaffyX,2469,1597,175,165,340,51.5%,16m
30109,1,coffee,2469,1257,149,128,277,53.8%,3h
30109,2,Denniskyc,2469,697,58,41,99,58.6%,1h
30109,3,[DILIH]OokyBooky,2469,1278,56,56,112,50.0%,3h
30109,2,Rimctto,2469,1348,52,54,106,49.1%,51m
30109,3,[Brofrc]Samucofuco,2469,946,36,31,67,53.7%,1h
30109,3,Nosli,2469,766,34,32,66,51.5%,53m
30109,2,ShadowFall,2469,440,25,32,57,43.9%,25m
30109,1,Testrun,2469,598,19,26,45,42.2%,32m
30109,3,Jhomalex,2469,456,17,13,30,56.7%,38m
30109,3,asd,2469,333,14,8,22,63.6%,3h
30109,1,SALTAPATRAS,2469,323,12,18,30,40.0%,50m
30109,1,hassam,2469,252,11,11,22,50.0%,50m
30109,1,Fear,2469,218,10,13,23,43.5%,50m
30109,2,RockSender,2469,282,10,20,30,33.3%,19m
30109,3,afkproneob,2469,262,9,10,19,47.4%,1h
30109,3,sjnin,2469,180,8,2,10,80.0%,1h
30109,3,Masterrr,2469,211,8,4,12,66.7%,3h
30109,3,shizzer,2469,142,5,4,9,55.6%,1h
30109,3,Mozambiqued,2469,30,2,0,2,100.0%,25m
30109,3,FlyingPigs,2469,30,2,1,3,66.7%,3h
30109,3,albatoss,2469,121,2,1,3,66.7%,3h
30109,3,Tumor,2469,0,2,4,6,33.3%,1h
30109,3,IIIIIIIIIIII,2469,0,1,0,1,100.0%,4m
30109,2,VoidMarauder,2469,93,1,3,4,25.0%,3h
30109,3,SAINT,2469,0,1,4,5,20.0%,1h
30109,2,RufusFenriz,2469,0,1,5,6,16.7%,1h
30109,3,Slapfunk,2469,0,0,1,1,0.0%,3h
30109,3,DjDanj,2469,0,0,1,1,0.0%,3h
30109,3,[DhZAc1]QueriaSerBom,2469,0,0,2,2,0.0%,38m
30109,3,Chirp,2469,0,0,5,5,0.0%,53m
30140,3,[Fokuri]PylonWizard,2468,1593,100,96,196,51.0%,31m
30140,2,kingkilla,2468,1093,78,69,147,53.1%,3h
30140,2,lazyact,2468,1179,46,46,92,50.0%,35m
30140,1,ClickCartel,2468,930,43,49,92,46.7%,17m
30140,2,simmo,2468,792,35,26,61,57.4%,52m
30140,1,SmileON,2468,808,31,36,67,46.3%,13m
30140,3,Alarcondor,2468,634,28,16,44,63.6%,1h
30140,3,Food,2468,837,28,47,75,37.3%,8m
30140,3,silverrock,2468,692,24,30,54,44.4%,3h
30140,2,Lejval,2468,537,20,21,41,48.8%,51m
30140,3,River,2468,540,19,17,36,52.8%,7m
30140,3,MrCat,2468,486,18,14,32,56.2%,1h
30140,3,Derrick,2468,459,18,24,42,42.9%,15m
30140,2,Bancroft,2468,444,17,20,37,45.9%,1h
30140,2,Jamthenam,2468,496,17,22,39,43.6%,24m
30140,3,RareLNO,2468,278,11,9,20,55.0%,48m
30140,1,blueshirts,2468,157,10,18,28,35.7%,4m
30140,2,[NgtKnt]healthycell,2468,198,9,9,18,50.0%,29m
30140,1,buddydontevn,2468,344,9,14,23,39.1%,37m
30140,2,Vassili,2468,248,8,8,16,50.0%,1h
30140,3,[S3XG0D]MXS,2468,206,8,14,22,36.4%,3h
30140,1,Knowledge,2468,210,8,14,22,36.4%,3h
30140,2,Demosthenes,2468,157,6,9,15,40.0%,14m
30140,2,[SAKT1]HomeloChino,2468,228,6,9,15,40.0%,24m
30140,2,[OceanA]Seifer,2468,146,6,10,16,37.5%,29m
30140,3,Pepe,2468,154,5,7,12,41.7%,1h
30140,3,BoboKassidy,2468,164,5,21,26,19.2%,31m
30140,3,PlayDeD,2468,0,3,2,5,60.0%,28m
30140,3,Telozipazim,2468,60,3,6,9,33.3%,1h
30140,3,Madness,2468,36,3,6,9,33.3%,46m
30140,3,Yarius,2468,34,3,6,9,33.3%,9m
30140,3,Hogan,2468,58,2,1,3,66.7%,31m
30140,3,ssBsKEE,2468,0,2,3,5,40.0%,25m
30140,2,GrayFox,2468,58,2,5,7,28.6%,40m
30140,3,bulletHead,2468,0,2,5,7,28.6%,22m
30140,3,Pells,2468,0,1,0,1,100.0%,1h
30140,3,[D3stin]BillAdama,2468,0,1,0,1,100.0%,7m
30140,3,[IoO7]geauxjoel,2468,0,1,0,1,100.0%,3h
30140,2,[FTLT]SuperJonas,2468,0,1,1,2,50.0%,19m
30140,3,Mikezknight,2468,0,1,1,2,50.0%,1h
30140,3,Zarathos,2468,30,1,3,4,25.0%,3h
30140,3,Oscar,2468,0,1,4,5,20.0%,1h
30140,2,BadWolf,2468,30,1,5,6,16.7%,1h
30140,1,Qaid,2468,0,0,1,1,0.0%,1h
30140,3,CasaMax,2468,0,0,3,3,0.0%,3m
30140,2,[DRKDMN]GROV,2468,0,0,4,4,0.0%,25m
30186,2,Oreo,2467,1351,131,126,257,51.0%,3h
30186,2,juanin,2467,1515,89,95,184,48.4%,55m
30186,2,[xHC]Sone,2467,1259,88,83,171,51.5%,3h
30186,3,Pilsenboy,2467,1586,87,79,166,52.4%,39m
30186,3,[UpxV]gufuhack,2467,1001,42,43,85,49.4%,15m
30186,2,UMEtony,2467,570,41,43,84,48.8%,1h
30186,3,frostydog,2467,195,31,20,51,60.8%,1h
30186,1,Kwok,2467,774,30,33,63,47.6%,56m
30186,3,Fernando,2467,681,27,22,49,55.1%,59m
30186,3,Leixx,2467,754,24,45,69,34.8%,3m
30186,3,Torak,2467,447,16,11,27,59.3%,29m
30186,3,Berserk,2467,292,11,4,15,73.3%,1h
30186,2,[HJSDS]Danielx,2467,186,6,5,11,54.5%,3h
30186,1,PinkTae,2467,126,6,10,16,37.5%,1h
30186,2,Night,2467,138,5,1,6,83.3%,3h
30186,2,diego,2467,42,5,13,18,27.8%,1h
30186,3,KinJongPwn,2467,88,4,2,6,66.7%,25m
30186,3,YOUNGBLOOD,2467,90,3,3,6,50.0%,32m
30186,2,UniTech,2467,62,3,6,9,33.3%,4m
30186,2,liorsxsy,2467,88,2,2,4,50.0%,3h
30186,3,Marambio,2467,60,2,3,5,40.0%,1h
30186,3,Eldront,2467,0,2,3,5,40.0%,3h
30186,2,[Khalta]milcerelpro,2467,0,1,1,2,50.0%,60m
30186,1,Esparchango,2467,0,1,1,2,50.0%,23m
30186,2,PraiseHelix,2467,0,1,2,3,33.3%,1h
30186,3,Jhoncyto,2467,0,1,3,4,25.0%,6m
30186,1,AukinaUrden,2467,91,1,4,5,20.0%,34m
30186,2,KILTHEGOSPEL,2467,93,1,4,5,20.0%,33m
30186,3,Alphonso,2467,0,0,2,2,0.0%,32m
30186,2,wallyboy,2467,0,0,4,4,0.0%,60m
30216,2,NoJokeMstDpe,2466,746,35,26,61,57.4%,3h
30216,2,void,2466,787,32,27,59,54.2%,19m
30216,2,[DCP]optics,2466,271,22,19,41,53.7%,25m
30216,2,PinkPLZ,2466,246,20,22,42,47.6%,56m
30216,1,Badcatito,2466,494,16,26,42,38.1%,52m
30216,3,LeeHarvey,2466,326,15,7,22,68.2%,1h
30216,2,[kØ]LuisMiguel,2466,351,14,11,25,56.0%,30m
30216,3,Dblacksanta,2466,322,12,7,19,63.2%,1h
30216,2,Claude,2466,306,12,12,24,50.0%,3h
30216,3,[XDRAX8]crist,2466,329,11,9,20,55.0%,1h
30216,2,Jakamungo,2466,331,11,17,28,39.3%,1h
30216,2,Dafidicus,2466,156,6,10,16,37.5%,42m
30216,2,BunnyBunBun,2466,144,4,5,9,44.4%,56m
30216,3,syNkal,2466,34,3,5,8,37.5%,53m
30216,3,[1Ec0n1]gunner,2466,121,2,1,3,66.7%,35m
30216,3,[0NaCl]SugarDuck,2466,93,2,2,4,50.0%,29m
30216,2,NELZ,2466,92,1,3,4,25.0%,1h
30216,3,NoMiEnTa,2466,0,1,4,5,20.0%,1h
30216,2,rustomrobot,2466,0,1,5,6,16.7%,52m
30216,3,Zykonnn,2466,0,0,1,1,0.0%,1h
30216,3,MeWantDinDin,2466,0,0,1,1,0.0%,3h
30216,3,AurA,2466,0,0,1,1,0.0%,1h
30216,3,FreindLess,2466,0,0,2,2,0.0%,46m
30216,3,[ETG]AntracX,2466,0,0,3,3,0.0%,1h
30240,1,[2TETON]koko,2465,1600,127,125,252,50.4%,31m
30240,2,duro,2465,1539,100,104,204,49.0%,57m
30240,1,Hectoraldo,2465,1499,55,60,115,47.8%,3h
30240,2,Thrascall,2465,1359,54,57,111,48.6%,56m
30240,1,Crown,2465,806,53,35,88,60.2%,30m
30240,1,Ethan,2465,1318,50,54,104,48.1%,50m
30240,2,FranzJoseph,2465,1104,46,46,92,50.0%,3h
30240,2,joaco,2465,940,36,34,70,51.4%,4m
30240,2,Frostytatas,2465,465,19,18,37,51.4%,1h
30240,3,Airneanach,2465,432,16,7,23,69.6%,1h
30240,2,LeoMelbourne,2465,376,14,14,28,50.0%,49m
30240,2,Supremode,2465,314,10,15,25,40.0%,3h
30240,3,BlOcKBuilDeR,2465,216,6,3,9,66.7%,1h
30240,2,Stimulus,2465,118,6,8,14,42.9%,60m
30240,2,[WicWac]sussmonkey,2465,116,4,3,7,57.1%,3h
30240,2,Donator,2465,138,4,5,9,44.4%,1h
30240,2,Luffyterran,2465,145,4,5,9,44.4%,28m
30240,2,BARCODE,2465,126,4,7,11,36.4%,3h
30240,3,Zeratul,2465,58,3,3,6,50.0%,53m
30240,2,GnosGnis,2465,30,3,5,8,37.5%,52m
30240,3,[CoCo19]Broxigar,2465,30,2,0,2,100.0%,3h
30240,3,[BandY]AllinCider,2465,30,2,0,2,100.0%,1h
30240,3,[Rastah]Xerxes,2465,30,2,3,5,40.0%,32m
30240,3,Miniclipoide,2465,94,2,4,6,33.3%,1h
30240,3,Fazootle,2465,0,1,1,2,50.0%,53m
30240,3,[40oztF]Viciousblow,2465,97,1,1,2,50.0%,7m
30240,1,[ACTKK2]Rhynozeronte,2465,0,1,4,5,20.0%,1h
30240,3,MoneyBags,2465,95,1,5,6,16.7%,13m
30240,1,[ZTJ]mobuis,2465,0,0,4,4,0.0%,1h
30240,3,Lazypanda,2465,0,0,4,4,0.0%,20m
30270,2,TPR,2464,1592,100,107,207,48.3%,29m
30270,1,Owenshet,2464,1485,89,98,187,47.6%,6m
30270,2,Andres,2464,1422,82,63,145,56.6%,35m
30270,1,[CS0]UndeadPants,2464,857,64,55,119,53.8%,3h
30270,3,Kyle,2464,1244,53,45,98,54.1%,1h
30270,3,Ninja,2464,1109,48,35,83,57.8%,3h
30270,3,Crazed,2464,636,40,30,70,57.1%,45m
30270,3,MRaynor,2464,678,33,16,49,67.3%,32m
30270,2,chem,2464,702,26,29,55,47.3%,3h
30270,3,dGalactic,2464,519,21,16,37,56.8%,60m
30270,3,Smierc,2464,510,20,23,43,46.5%,1h
30270,3,Rescue,2464,432,16,11,27,59.3%,3h
30270,2,[TFGID]Dreknal,2464,466,16,22,38,42.1%,13m
30270,2,Rippy,2464,371,15,17,32,46.9%,3h
30270,2,pieroomarco,2464,362,15,19,34,44.1%,3h
30270,2,Urinetrouble,2464,307,13,12,25,52.0%,3h
30270,3,Shazbot,2464,271,10,6,16,62.5%,1h
30270,2,halphas,2464,332,10,28,38,26.3%,28m
30270,1,DieNoMight,2464,307,9,10,19,47.4%,57m
30270,2,jimbOslice,2464,214,8,12,20,40.0%,1h
30270,3,kevin,2464,139,6,4,10,60.0%,3h
30270,3,[FatPP]YumyumBB,2464,178,6,7,13,46.2%,27m
30270,2,[BlbaSq]Paragon,2464,167,5,9,14,35.7%,1h
30270,3,angelsas,2464,92,4,3,7,57.1%,3h
30270,3,Maquiavel,2464,36,3,5,8,37.5%,7m
30270,3,Tushinux,2464,66,3,7,10,30.0%,1h
30270,2,lilZergling,2464,0,3,7,10,30.0%,39m
30270,1,[Forsa]claudg,2464,93,2,0,2,100.0%,1h
30270,3,Abbas,2464,30,2,0,2,100.0%,3h
30270,2,Fibonaccho,2464,0,2,3,5,40.0%,1h
30270,3,AVICNGO,2464,95,2,4,6,33.3%,1h
30270,3,CatsGoMoo,2464,40,2,6,8,25.0%,59m
30270,2,MarcoPremier,2464,30,2,6,8,25.0%,55m
30270,3,Morning,2464,97,2,6,8,25.0%,3h
30270,3,Lork,2464,18,1,3,4,25.0%,1h
30270,1,Azure,2464,38,1,4,5,20.0%,30m
30270,3,DUTRA,2464,0,0,1,1,0.0%,48m
30307,2,UndeadChew,2463,1581,298,300,598,49.8%,3h
30307,3,Dragonlich,2463,1608,127,124,251,50.6%,3h
30307,3,Mattax,2463,1203,79,73,152,52.0%,3m
30307,1,[cluez]halfE,2463,968,77,56,133,57.9%,3h
30307,3,Soman,2463,1511,57,63,120,47.5%,32m
30307,2,[WEENIS]TheEvaulator,2463,488,40,39,79,50.6%,3h
30307,3,Chips,2463,553,25,14,39,64.1%,17m
30307,2,[MRDPOT]DeathOmen,2463,368,16,10,26,61.5%,17m
30307,3,[ELITZ]Kero,2463,357,16,21,37,43.2%,1h
30307,2,TheMomba,2463,409,15,18,33,45.5%,14m
30307,1,Skeleton,2463,398,15,22,37,40.5%,40m
30307,3,Jyn,2463,347,12,11,23,52.2%,48m
30307,3,Coolja,2463,300,11,8,19,57.9%,32m
30307,1,lleenn,2463,376,11,20,31,35.5%,1h
30307,2,NUGGETHEAD,2463,279,10,15,25,40.0%,3h
30307,2,[tonaya]OrTa,2463,264,9,10,19,47.4%,20m
30307,2,Bkstacker,2463,176,8,15,23,34.8%,13m
30307,2,Michael,2463,156,6,7,13,46.2%,3h
30307,1,IIIIIIIIIIII,2463,202,6,12,18,33.3%,27m
30307,3,tictoc,2463,156,5,4,9,55.6%,3h
30307,2,penguino,2463,159,5,6,11,45.5%,42m
30307,2,Potent,2463,152,5,7,12,41.7%,33m
30307,2,Backspace,2463,117,5,8,13,38.5%,25m
30307,2,OscaraGrouch,2463,94,4,10,14,28.6%,25m
30307,3,InManEx,2463,58,3,2,5,60.0%,1h
30307,3,TomCruiser,2463,90,3,4,7,42.9%,59m
30307,2,SpaceDude,2463,147,3,8,11,27.3%,60m
30307,2,Moofish,2463,90,3,10,13,23.1%,22m
30307,2,iceinfernal,2463,94,3,10,13,23.1%,3h
30307,3,nhat,2463,93,2,4,6,33.3%,23m
30307,3,Gonadus,2463,0,1,0,1,100.0%,23m
30307,3,InternetHero,2463,0,1,0,1,100.0%,32m
30307,2,GnarlyBrown,2463,0,1,0,1,100.0%,17m
30307,3,Twirly,2463,0,1,2,3,33.3%,3h
30307,3,Wainfleet,2463,0,1,3,4,25.0%,1h
30307,3,[TY4GG]Intentional,2463,0,1,4,5,20.0%,48m
30307,3,[REPORT]multiplyAU,2463,0,0,1,1,0.0%,3h
30307,3,xlyeysonlx,2463,0,0,1,1,0.0%,17m
30307,3,Tiriondis,2463,0,0,1,1,0.0%,4m
30307,3,McPoopyPoop,2463,0,0,2,2,0.0%,3h
30307,2,Merlin,2463,0,0,5,5,0.0%,35m
30307,2,Suyeon,2463,0,0,5,5,0.0%,44m
30349,2,Vacho,2462,1351,128,132,260,49.2%,3h
30349,1,Asuka,2462,1446,120,122,242,49.6%,56m
30349,2,kbanggg,2462,1361,76,82,158,48.1%,3h
30349,3,Maxuke,2462,486,17,15,32,53.1%,53m
30349,2,[AmaSua]Andres,2462,429,16,14,30,53.3%,1h
30349,2,TexasCOX,2462,472,15,18,33,45.5%,51m
30349,1,WiLdBeAsT,2462,364,12,23,35,34.3%,55m
30349,3,Etileyeti,2462,190,6,6,12,50.0%,16m
30349,2,[LapisL]Elaina,2462,188,6,6,12,50.0%,34m
30349,2,[jobjap]Jobi,2462,44,5,6,11,45.5%,1h
30349,3,PiPPiNRuDeS,2462,96,4,1,5,80.0%,46m
30349,3,[BlTEL]rasalghul,2462,118,4,5,9,44.4%,32m
30349,3,Otavio,2462,30,2,1,3,66.7%,12m
30349,3,Lotso,2462,94,2,3,5,40.0%,1h
30349,1,ÀLASTOR,2462,117,2,5,7,28.6%,37m
30349,3,BIGGCAT,2462,0,1,0,1,100.0%,1h
30349,1,SoyeR,2462,0,1,6,7,14.3%,24m
30349,3,GenralJ,2462,0,0,1,1,0.0%,1h
30349,3,pablolechuga,2462,0,0,1,1,0.0%,1h
30349,3,Overlord,2462,0,0,1,1,0.0%,46m
30349,3,[FTLTX]ZELITH,2462,0,0,1,1,0.0%,18m
30370,2,CoolFalcon,2461,528,89,88,177,50.3%,51m
30370,3,[scvpog]Pann,2461,1117,73,64,137,53.3%,3h
30370,2,gioo,2461,1465,67,70,137,48.9%,1h
30370,3,Dafin,2461,1465,56,59,115,48.7%,1h
30370,1,[EZDUNK]holleeze,2461,1114,56,67,123,45.5%,4m
30370,2,[JRT]MasacrePy,2461,1100,52,41,93,55.9%,34m
30370,2,[AD3C]TIBURSIO,2461,982,40,34,74,54.1%,3h
30370,3,Pulz,2461,583,34,26,60,56.7%,3h
30370,3,Tonestarcraf,2461,864,32,31,63,50.8%,55m
30370,2,Raziel,2461,543,19,24,43,44.2%,1h
30370,3,[glhf23]DarkHand,2461,388,15,14,29,51.7%,54m
30370,2,ACAGEDTIGER,2461,409,14,15,29,48.3%,3h
30370,1,Stryker,2461,306,13,17,30,43.3%,37m
30370,1,Zutroy,2461,277,10,9,19,52.6%,43m
30370,3,[Azteka]TEMPLARIO,2461,265,9,7,16,56.2%,32m
30370,2,CteGaoGao,2461,238,8,8,16,50.0%,52m
30370,1,HelloWorld,2461,176,5,6,11,45.5%,43m
30370,2,[BEHH]spacedude,2461,168,5,7,12,41.7%,25m
30370,3,Kitwan,2461,120,3,2,5,60.0%,10m
30370,3,Velderax,2461,60,2,4,6,33.3%,1h
30370,3,[SC2IDN]Ripto,2461,60,2,5,7,28.6%,1h
30370,3,[GRNSKN]KillCuddles,2461,0,1,0,1,100.0%,1h
30370,1,Alejo,2461,0,1,4,5,20.0%,3h
30370,2,Chrono,2461,0,0,1,1,0.0%,15m
30370,3,BiGFaH,2461,0,0,1,1,0.0%,1h
30370,3,SEER,2461,0,0,1,1,0.0%,3h
30370,3,jjsky,2461,0,0,1,1,0.0%,23m
30370,2,[ZHENG]KyleZone,2461,0,0,1,1,0.0%,3h
30370,3,Dux,2461,0,0,2,2,0.0%,16m
30370,2,ThufirHawat,2461,0,0,4,4,0.0%,40m
30370,3,MacroVsMicro,2461,0,0,5,5,0.0%,42m
30401,2,SauceySauce,2460,1569,259,232,491,52.7%,3h
30401,1,[VrW]Vicster,2460,1609,214,205,419,51.1%,8m
30401,2,Menjunje,2460,1590,149,140,289,51.6%,6m
30401,1,Pancake,2460,1560,146,149,295,49.5%,3h
30401,3,Nasolzu,2460,1533,93,92,185,50.3%,8m
30401,2,silverrock,2460,903,76,65,141,53.9%,3h
30401,3,Wave,2460,1580,75,60,135,55.6%,1h
30401,2,[wNt2]Tone,2460,972,53,61,114,46.5%,57m
30401,2,[JaMiT]markymarc,2460,1025,46,54,100,46.0%,1h
30401,3,juanthekill,2460,1001,43,37,80,53.8%,1h
30401,1,[USWAG]Ricran,2460,613,42,50,92,45.7%,1h
30401,3,[GEKO]GusNar,2460,738,27,29,56,48.2%,1h
30401,3,Sltd,2460,497,21,18,39,53.8%,12m
30401,2,Niplheim,2460,233,18,19,37,48.6%,3h
30401,2,Sterlix,2460,306,15,13,28,53.6%,1h
30401,3,Quixotic,2460,359,13,4,17,76.5%,3h
30401,1,Glyko,2460,326,12,19,31,38.7%,15m
30401,2,BohlBERG,2460,234,8,8,16,50.0%,3h
30401,1,DarkSkies,2460,207,8,12,20,40.0%,31m
30401,2,dantron,2460,195,6,9,15,40.0%,39m
30401,2,[SC2IDN]Bamboozle,2460,116,5,5,10,50.0%,3h
30401,3,Synix,2460,86,4,3,7,57.1%,1h
30401,3,HotPope,2460,156,4,4,8,50.0%,1h
30401,2,ProFide,2460,112,4,7,11,36.4%,3h
30401,2,JMass,2460,116,4,8,12,33.3%,3h
30401,1,Hauntedmist,2460,143,4,12,16,25.0%,3h
30401,3,GamenDeaD,2460,30,3,4,7,42.9%,3h
30401,3,[ExcIgN]Charlie,2460,30,2,1,3,66.7%,53m
30401,3,PlanckTime,2460,129,2,3,5,40.0%,1h
30401,1,Martinator,2460,48,2,9,11,18.2%,35m
30401,3,chaos,2460,0,1,0,1,100.0%,1h
30401,3,MakeMake,2460,0,1,2,3,33.3%,31m
30401,3,RickHarrison,2460,0,1,5,6,16.7%,3h
30401,3,JoelFromIowa,2460,0,0,1,1,0.0%,3h
30401,3,MetalMonkey,2460,0,0,1,1,0.0%,3h
30401,3,iMiguelAngel,2460,0,0,1,1,0.0%,3h
30401,3,[AbcCo]Mugroso,2460,0,0,2,2,0.0%,20m
30438,1,IVHAN,2459,926,328,327,655,50.1%,27m
30438,2,[CqmB]Rapture,2459,1596,234,234,468,50.0%,1h
30438,1,mac,2459,1594,180,179,359,50.1%,30m
30438,3,Planur,2459,1329,78,61,139,56.1%,3h
30438,3,[REPORT]RaNdOmIzE,2459,1041,71,69,140,50.7%,24m
30438,3,EJOA,2459,1263,70,63,133,52.6%,42m
30438,1,[FyHr]musolini,2459,674,45,40,85,52.9%,3h
30438,2,Goldenleaf,2459,821,34,23,57,59.6%,3h
30438,2,eididi,2459,546,23,26,49,46.9%,3h
30438,2,Wingbox,2459,604,20,25,45,44.4%,56m
30438,2,MEDIC,2459,249,19,14,33,57.6%,24m
30438,2,Champs,2459,237,16,11,27,59.3%,50m
30438,1,xxJETHROxx,2459,414,16,21,37,43.2%,52m
30438,3,JOFan,2459,388,15,11,26,57.7%,38m
30438,2,larryb,2459,316,13,11,24,54.2%,3h
30438,3,Numbgoon,2459,187,7,4,11,63.6%,3m
30438,2,GLHF,2459,193,7,6,13,53.8%,20m
30438,2,Ferris,2459,172,7,9,16,43.8%,46m
30438,1,Katie,2459,48,3,0,3,100.0%,3m
30438,2,ImANoob,2459,140,3,2,5,60.0%,28m
30438,3,Needsoldiers,2459,65,3,5,8,37.5%,1h
30438,3,Radley,2459,30,2,1,3,66.7%,1h
30438,1,Coffeecup,2459,0,2,2,4,50.0%,41m
30438,2,Areotitan,2459,0,2,4,6,33.3%,3h
30438,2,GrannyBacon,2459,58,2,7,9,22.2%,28m
30438,3,Killmachine,2459,0,1,0,1,100.0%,3m
30438,3,[WW2LA]NinjaRobot,2459,0,1,0,1,100.0%,3h
30438,3,Huevito,2459,0,1,0,1,100.0%,31m
30438,3,Humberto,2459,0,1,1,2,50.0%,3h
30438,2,[BooKng]Onda,2459,30,1,1,2,50.0%,3h
30438,3,yisus,2459,0,1,4,5,20.0%,17m
30438,3,[TTMLK]Sleeper,2459,0,0,1,1,0.0%,60m
30438,3,JOSEWAN,2459,0,0,2,2,0.0%,32m
30471,2,VIIthColumn,2458,960,103,105,208,49.5%,1h
30471,3,RPepez,2458,1360,55,57,112,49.1%,1h
30471,1,Xorus,2458,598,49,43,92,53.3%,50m
30471,3,InterCeptoR,2458,958,48,48,96,50.0%,50m
30471,1,Rooster,2458,1042,37,45,82,45.1%,1h
30471,3,[missA]jman,2458,712,30,17,47,63.8%,19m
30471,3,[NPMM]TheGreatRT,2458,308,30,24,54,55.6%,1h
30471,2,Quiquemann,2458,786,27,35,62,43.5%,1h
30471,2,Nikelaos,2458,656,23,31,54,42.6%,4m
30471,2,[DhZAc1]Angeo,2458,466,18,16,34,52.9%,1h
30471,3,CanonRussian,2458,307,16,13,29,55.2%,55m
30471,3,Demonsgate,2458,351,14,5,19,73.7%,1h
30471,3,[x5MeOx]Rezlin,2458,333,11,19,30,36.7%,3h
30471,3,[b1azin]TEUFELHUNDEN,2458,211,7,3,10,70.0%,52m
30471,1,[LOHd]racso,2458,0,3,2,5,60.0%,1h
30471,2,Pogipinoy,2458,202,3,10,13,23.1%,1h
30471,3,Topcross,2458,30,2,0,2,100.0%,32m
30471,3,EphraimOtter,2458,30,2,0,2,100.0%,3h
30471,1,mattrex,2458,0,2,3,5,40.0%,3m
30471,2,Balinn,2458,88,2,3,5,40.0%,45m
30471,3,BRUMHILDA,2458,30,2,3,5,40.0%,1h
30471,3,Shabsli,2458,0,1,0,1,100.0%,1h
30471,3,Daystar,2458,30,1,2,3,33.3%,11m
30471,2,Kirito,2458,88,1,7,8,12.5%,3h
30471,3,[Pyr3s]Studley,2458,0,0,1,1,0.0%,48m
30471,3,OldOneEye,2458,0,0,5,5,0.0%,45m
30497,1,[CCoWW]Willindorn,2457,1610,517,531,1048,49.3%,1h
30497,2,DARKLORD,2457,1146,271,268,539,50.3%,56m
30497,2,SpaceStretMe,2457,1615,220,220,440,50.0%,3h
30497,1,OlyNorth,2457,1542,119,111,230,51.7%,1h
30497,1,DragonReborn,2457,1454,69,77,146,47.3%,57m
30497,1,FreightTrain,2457,436,42,42,84,50.0%,8m
30497,2,Lucas,2457,878,37,29,66,56.1%,40m
30497,3,Cigratt,2457,593,31,24,55,56.4%,28m
30497,3,LOFUEN,2457,400,22,13,35,62.9%,55m
30497,3,[CIC]SCSavage,2457,473,20,15,35,57.1%,1h
30497,3,[4xDRG]Jelleton,2457,520,20,16,36,55.6%,8m
30497,1,Nopalium,2457,594,20,31,51,39.2%,56m
30497,3,Atlan,2457,350,13,4,17,76.5%,1h
30497,3,Hotdog,2457,275,9,7,16,56.2%,3h
30497,2,kazaaiiiieee,2457,268,8,12,20,40.0%,4m
30497,3,Jzdawson,2457,175,6,9,15,40.0%,28m
30497,3,sneakyshogun,2457,92,4,4,8,50.0%,48m
30497,3,RaviDaGuy,2457,58,3,0,3,100.0%,1h
30497,3,Arshnizzle,2457,30,3,4,7,42.9%,1h
30497,2,porkboss,2457,58,3,5,8,37.5%,29m
30497,3,EroLesbian,2457,138,3,6,9,33.3%,3m
30497,2,BROSS,2457,100,3,10,13,23.1%,4m
30497,1,lostoid,2457,68,3,11,14,21.4%,1h
30497,2,DanixPulent,2457,115,3,12,15,20.0%,3h
30497,2,NonoSky,2457,88,2,5,7,28.6%,1h
30497,3,Frippy,2457,0,1,0,1,100.0%,1h
30497,1,[19thID]Sherlock,2457,0,1,4,5,20.0%,52m
30497,3,Tangiblebat,2457,30,1,4,5,20.0%,3m
30497,3,Escoba,2457,0,1,4,5,20.0%,3h
30497,3,TheJewNuse,2457,34,1,7,8,12.5%,1h
30527,3,Seancy,2456,1571,166,157,323,51.4%,16m
30527,2,Kepler,2456,491,121,109,230,52.6%,3h
30527,3,davinator,2456,1591,101,98,199,50.8%,12m
30527,3,tom,2456,1317,100,90,190,52.6%,26m
30527,1,nrubby,2456,1578,68,70,138,49.3%,3h
30527,3,bladex,2456,802,36,26,62,58.1%,38m
30527,3,DeanConnor,2456,306,28,8,36,77.8%,9m
30527,2,Pamir,2456,508,21,25,46,45.7%,49m
30527,2,Felipe,2456,450,15,22,37,40.5%,3h
30527,2,Gogo,2456,282,12,11,23,52.2%,1h
30527,2,palindrome,2456,325,12,12,24,50.0%,7m
30527,2,Kiostrip,2456,286,11,17,28,39.3%,1h
30527,2,[SqBD]DoritoPop,2456,191,7,10,17,41.2%,1h
30527,3,Mszczuj,2456,195,5,7,12,41.7%,3h
30527,1,ShadowHunter,2456,208,5,10,15,33.3%,28m
30527,3,minikatz,2456,70,4,6,10,40.0%,1h
30527,3,LYON,2456,120,4,7,11,36.4%,3h
30527,3,[FyHr]Melichan,2456,30,2,1,3,66.7%,1h
30527,3,Jacky,2456,0,2,3,5,40.0%,1h
30527,3,[AnMrph]RDWRER,2456,95,2,4,6,33.3%,3h
30527,3,Cipher,2456,0,2,5,7,28.6%,35m
30527,3,[VoidRR]verycooltony,2456,0,1,0,1,100.0%,15m
30527,2,SorryIamBad,2456,0,1,0,1,100.0%,1h
30527,3,Guasky,2456,0,1,0,1,100.0%,12m
30527,3,LtSaitO,2456,30,1,2,3,33.3%,3h
30527,1,[uhZ]Frenzylishus,2456,95,1,2,3,33.3%,1h
30527,3,Sacsas,2456,30,1,3,4,25.0%,1h
30527,2,[LOHd]Adixo,2456,0,0,2,2,0.0%,44m
30527,3,Yuri,2456,0,0,2,2,0.0%,1h
30556,3,SgRedeemer,2455,1615,128,108,236,54.2%,3h
30556,2,Gerald,2455,1477,114,109,223,51.1%,1h
30556,1,[SMB]Maverick,2455,1646,76,79,155,49.0%,1h
30556,3,Ascentior,2455,397,56,42,98,57.1%,11m
30556,1,cwb,2455,1024,45,53,98,45.9%,1h
30556,1,Ski,2455,252,35,41,76,46.1%,3h
30556,1,MarineMaker,2455,596,29,27,56,51.8%,3h
30556,2,[EBAGmn]QuechoPulga,2455,518,20,19,39,51.3%,3h
30556,2,TNOZADAR,2455,522,18,25,43,41.9%,57m
30556,3,JoeBaroni,2455,452,17,12,29,58.6%,3h
30556,3,Hajunpla,2455,353,13,14,27,48.1%,48m
30556,2,PhilosoNerd,2455,286,9,12,21,42.9%,13m
30556,3,[WHYYYY]WEEBRIOSIS,2455,221,7,10,17,41.2%,28m
30556,2,jack,2455,161,7,12,19,36.8%,29m
30556,2,[BBVBB]SCARAVIA,2455,94,7,13,20,35.0%,57m
30556,3,RAG,2455,191,5,3,8,62.5%,20m
30556,3,Gordotetas,2455,115,5,5,10,50.0%,1h
30556,3,RtwoDtwo,2455,118,4,5,9,44.4%,55m
30556,3,WolFjames,2455,120,4,6,10,40.0%,1h
30556,3,onion,2455,88,3,3,6,50.0%,1h
30556,3,[xXGDXx]Qlitos,2455,85,3,7,10,30.0%,31m
30556,3,NAK,2455,30,2,1,3,66.7%,17m
30556,2,[angsub]Mjolnir,2455,0,2,4,6,33.3%,1h
30556,2,dbrown,2455,116,2,5,7,28.6%,3h
30556,3,[RwtM]Machaube,2455,0,1,0,1,100.0%,59m
30556,3,BABAchan,2455,30,1,2,3,33.3%,16m
30556,3,Destroyer,2455,0,1,4,5,20.0%,3h
30556,1,ItsJustMatt,2455,0,0,1,1,0.0%,47m
30556,3,[pSC20]ZERO,2455,0,0,1,1,0.0%,1h
30556,3,TrunkBizness,2455,0,0,2,2,0.0%,3h
30556,3,Xixfilyon,2455,0,0,3,3,0.0%,3h
30556,2,Maxaroni,2455,0,0,4,4,0.0%,1h
30588,2,ThEbUhOxXx,2454,1500,380,391,771,49.3%,12m
30588,2,OneShotKill,2454,1557,159,136,295,53.9%,1h
30588,3,togakuri,2454,1515,92,80,172,53.5%,3h
30588,2,zack,2454,1568,74,51,125,59.2%,6m
30588,3,Simple,2454,480,46,39,85,54.1%,1h
30588,2,[CLVLY]Quorky,2454,516,25,22,47,53.2%,24m
30588,2,ClevrNameSuk,2454,302,12,11,23,52.2%,1h
30588,1,[zernex]STETMANN,2454,288,10,7,17,58.8%,3h
30588,3,Joe,2454,287,10,12,22,45.5%,42m
30588,2,Manuelpty,2454,276,9,11,20,45.0%,57m
30588,1,gui,2454,277,9,12,21,42.9%,9m
30588,2,ogzxro,2454,127,6,16,22,27.3%,55m
30588,3,bananamon,2454,148,5,6,11,45.5%,3h
30588,3,Windstorm,2454,88,4,3,7,57.1%,32m
30588,3,Dante,2454,58,2,1,3,66.7%,3h
30588,3,[Jordon]jinjones,2454,0,2,4,6,33.3%,33m
30588,2,[LifeC]Lifecast,2454,116,2,5,7,28.6%,3h
30588,3,[SEK]Lecram,2454,0,1,0,1,100.0%,3h
30588,3,Libertine,2454,0,1,0,1,100.0%,1h
30588,1,HoverTaxi,2454,0,1,4,5,20.0%,52m
30588,1,Kreul,2454,0,1,4,5,20.0%,3h
30588,2,[Zohner]SWISSPIKE,2454,0,1,8,9,11.1%,3h
30610,2,ObiWan,2453,1622,226,224,450,50.2%,39m
30610,2,[TY4GG]Neptuno,2453,1588,99,85,184,53.8%,3h
30610,3,DoDoMeister,2453,1599,95,93,188,50.5%,3m
30610,2,Masaker,2453,1582,93,100,193,48.2%,1h
30610,3,THERUSSIAN,2453,1602,88,71,159,55.3%,3h
30610,3,Collin,2453,1553,78,73,151,51.7%,26m
30610,2,ErenJay,2453,923,73,73,146,50.0%,24m
30610,3,tizndat,2453,1088,48,39,87,55.2%,60m
30610,3,Longclaw,2453,675,26,22,48,54.2%,10m
30610,2,Azathoth,2453,541,24,14,38,63.2%,49m
30610,2,[200G]SentientMeat,2453,437,16,17,33,48.5%,1h
30610,2,Xenomir,2453,267,10,11,21,47.6%,1h
30610,3,applepear,2453,228,9,9,18,50.0%,3h
30610,2,zeus,2453,148,9,10,19,47.4%,3h
30610,3,SCVRUSHLOL,2453,253,8,4,12,66.7%,3h
30610,2,fred,2453,195,8,11,19,42.1%,3h
30610,3,[SKTT1]SGTxMookie,2453,205,6,7,13,46.2%,3h
30610,3,DankLeaf,2453,210,6,8,14,42.9%,50m
30610,3,[NM8]animeV,2453,165,5,0,5,100.0%,3h
30610,3,nullpha,2453,114,5,5,10,50.0%,1h
30610,2,oluz,2453,96,4,8,12,33.3%,20m
30610,3,[TheDOH]Dark,2453,118,4,14,18,22.2%,29m
30610,2,Wily,2453,58,3,3,6,50.0%,3h
30610,1,Samael,2453,88,3,5,8,37.5%,1h
30610,3,Ion,2453,119,3,8,11,27.3%,3h
30610,2,[iambad]wulfyluv,2453,44,2,2,4,50.0%,1h
30610,1,Southpaw,2453,48,2,4,6,33.3%,1h
30610,2,Teddy,2453,88,2,5,7,28.6%,33m
30610,1,Sanosuke,2453,34,2,11,13,15.4%,3h
30610,1,[ITGT]Bogarth,2453,0,1,4,5,20.0%,1h
30610,3,Keylogram,2453,0,1,4,5,20.0%,50m
30610,2,Lifeforce,2453,0,1,5,6,16.7%,3h
30610,3,[FTLTX]nivelk,2453,0,0,1,1,0.0%,1h
30610,3,Ghost,2453,0,0,1,1,0.0%,3h
30610,3,VicerExicer,2453,0,0,2,2,0.0%,4m
30610,3,shagy,2453,0,0,2,2,0.0%,28m
30610,2,LaChatumare,2453,0,0,6,6,0.0%,3h
30647,1,Jhonf,2452,1589,204,206,410,49.8%,3h
30647,2,Adrii,2452,1326,201,185,386,52.1%,28m
30647,2,SewerWizard,2452,462,148,153,301,49.2%,1h
30647,2,JayMaximus,2452,1501,85,78,163,52.1%,1h
30647,2,Rekko,2452,1326,66,71,137,48.2%,54m
30647,3,ZETHA,2452,1486,65,65,130,50.0%,25m
30647,2,Waz,2452,487,63,51,114,55.3%,7m
30647,2,Buck,2452,1302,59,55,114,51.8%,55m
30647,2,BobbyDoodoo,2452,436,50,60,110,45.5%,1h
30647,2,SyNaps,2452,829,48,38,86,55.8%,34m
30647,3,Marzq,2452,1246,46,46,92,50.0%,55m
30647,2,curita,2452,908,46,51,97,47.4%,52m
30647,1,Bambam,2452,1035,44,33,77,57.1%,31m
30647,2,SlowMan,2452,415,39,41,80,48.8%,3h
30647,2,TRIFORCE,2452,994,38,38,76,50.0%,1h
30647,2,Dufrense,2452,803,34,36,70,48.6%,3h
30647,1,Luna,2452,985,34,48,82,41.5%,12m
30647,2,Errrh,2452,414,16,21,37,43.2%,53m
30647,2,MAVERIC,2452,402,16,23,39,41.0%,54m
30647,3,DEADLYSTRIKE,2452,338,15,11,26,57.7%,1h
30647,3,PROFTSTEELS,2452,430,15,19,34,44.1%,4m
30647,1,[UpxV]Reeaper,2452,363,12,19,31,38.7%,3h
30647,3,Kam,2452,376,12,24,36,33.3%,20m
30647,2,[DRKESP]orrije,2452,248,9,16,25,36.0%,1h
30647,3,Fisher,2452,228,7,6,13,53.8%,46m
30647,2,Midnight,2452,206,7,9,16,43.8%,3h
30647,3,Juhyeon,2452,166,6,5,11,54.5%,45m
30647,1,Cloudedmind,2452,145,5,2,7,71.4%,3h
30647,3,KAKAROTO,2452,88,4,3,7,57.1%,4m
30647,3,WhiteBoy,2452,162,4,6,10,40.0%,32m
30647,2,XIII,2452,96,4,16,20,20.0%,15m
30647,3,[ESRA]Grubnerrats,2452,145,3,1,4,75.0%,1h
30647,2,[Preach]laserbits,2452,114,3,3,6,50.0%,52m
30647,1,Mustadio,2452,145,3,4,7,42.9%,52m
30647,3,[BROMO]HighHeathen,2452,30,3,5,8,37.5%,46m
30647,2,Gannon,2452,0,3,7,10,30.0%,44m
30647,3,JORDYCC,2452,60,2,6,8,25.0%,1h
30647,3,refruta,2452,0,2,6,8,25.0%,30m
30647,3,MaTT,2452,30,1,2,3,33.3%,18m
30647,3,Silverleysh,2452,0,1,4,5,20.0%,1h
30647,1,YOMERO,2452,0,1,4,5,20.0%,1h
30647,3,Cid,2452,0,0,1,1,0.0%,1h
30647,3,DAVID,2452,0,0,2,2,0.0%,38m
30647,3,Cavinha,2452,0,0,5,5,0.0%,3h
30691,2,KhristianR,2451,1409,157,148,305,51.5%,35m
30691,1,[XpKAc]ElHasho,2451,1067,72,77,149,48.3%,1h
30691,1,Monkey,2451,1422,71,70,141,50.4%,24m
30691,3,[AuSN]Swoop,2451,1167,47,39,86,54.7%,29m
30691,3,StarCruiser,2451,787,30,25,55,54.5%,1h
30691,2,Draco,2451,637,30,28,58,51.7%,30m
30691,3,EnriqueZ,2451,434,18,8,26,69.2%,3h
30691,1,[ph0t0n]MinuteHand,2451,325,12,12,24,50.0%,3h
30691,2,RoboRoberto,2451,105,10,15,25,40.0%,55m
30691,3,[TaPX]EqUiLlIbRiUm,2451,189,6,7,13,46.2%,1h
30691,3,Bobou,2451,130,6,8,14,42.9%,3h
30691,2,Slash,2451,196,6,9,15,40.0%,5m
30691,2,Amakusa,2451,207,6,11,17,35.3%,3h
30691,3,[GRetro]SnakeDaddy,2451,116,4,4,8,50.0%,1h
30691,2,Aspy,2451,88,4,6,10,40.0%,7m
30691,3,[HOT69]pjsmith,2451,116,4,7,11,36.4%,1h
30691,3,[UpeV]KingNothing,2451,86,3,3,6,50.0%,4m
30691,3,Kiljayden,2451,121,3,5,8,37.5%,46m
30691,1,[Dunkel]Rakso,2451,123,3,7,10,30.0%,44m
30691,3,Strife,2451,96,2,4,6,33.3%,16m
30691,3,BamBam,2451,0,2,5,7,28.6%,53m
30691,1,Sloth,2451,0,2,5,7,28.6%,50m
30691,3,[THESG]Giant,2451,30,1,2,3,33.3%,1h
30691,1,[Myaaa]Slothington,2451,95,1,2,3,33.3%,3h
30691,3,[AlIin]Wizzer,2451,40,1,2,3,33.3%,42m
30691,2,Wolverine,2451,30,1,3,4,25.0%,3h
30691,1,[PAWG]Snakeman,2451,0,1,4,5,20.0%,59m
30691,1,gigabeast,2451,48,1,5,6,16.7%,11m
30691,3,cRam,2451,0,0,1,1,0.0%,60m
30691,3,[TGosuC]Shogun,2451,0,0,2,2,0.0%,3h
30691,3,Wizzour,2451,0,0,3,3,0.0%,41m
30691,3,SirDanieL,2451,0,0,3,3,0.0%,3h
30691,3,Dapper,2451,0,0,6,6,0.0%,32m
30724,2,[maSC]maanlogo,2450,1265,52,45,97,53.6%,53m
30724,1,GhostDog,2450,1008,42,40,82,51.2%,50m
30724,3,melevan,2450,952,41,34,75,54.7%,1h
30724,2,aDOm,2450,642,23,26,49,46.9%,1h
30724,1,Ventricosa,2450,374,19,29,48,39.6%,17m
30724,3,fivemelodies,2450,299,12,9,21,57.1%,3h
30724,1,Intensity,2450,301,10,14,24,41.7%,3h
30724,3,IENJOYSTDS,2450,254,9,3,12,75.0%,55m
30724,2,SPICH,2450,212,9,10,19,47.4%,3h
30724,3,RhuGOD,2450,118,7,7,14,50.0%,3h
30724,1,RealHolo,2450,164,7,12,19,36.8%,7m
30724,3,Doce,2450,185,6,2,8,75.0%,17m
30724,3,DecOdeD,2450,132,6,4,10,60.0%,11m
30724,2,JeZteR,2450,60,5,9,14,35.7%,4m
30724,3,[10TKL]naturesherb,2450,170,5,16,21,23.8%,42m
30724,3,Deadlock,2450,165,4,1,5,80.0%,1h
30724,3,CAUSITA,2450,97,4,4,8,50.0%,3h
30724,1,[DhZAc1]Kim,2450,163,4,13,17,23.5%,3h
30724,3,MrWizard,2450,86,3,3,6,50.0%,1h
30724,3,King,2450,95,3,3,6,50.0%,32m
30724,3,Malkavian,2450,86,3,5,8,37.5%,18m
30724,3,Lutrelin,2450,122,3,5,8,37.5%,30m
30724,1,seisen,2450,58,3,5,8,37.5%,50m
30724,1,Tryptix,2450,48,2,1,3,66.7%,3h
30724,2,Magnos,2450,102,2,6,8,25.0%,3h
30724,3,steven,2450,60,2,6,8,25.0%,1h
30724,3,Frontalier,2450,0,1,0,1,100.0%,13m
30724,1,LiOH,2450,0,1,0,1,100.0%,1h
30724,3,[Emb3rs]SecretInk,2450,30,1,1,2,50.0%,8m
30724,3,Orimageddon,2450,0,1,2,3,33.3%,45m
30724,3,shinigami,2450,0,1,4,5,20.0%,3h
30724,3,[Gnomed]YouGotGnomed,2450,0,1,6,7,14.3%,32m
30724,3,[NDC1]yeyo,2450,30,1,13,14,7.1%,37m
30724,3,iamnotahorse,2450,0,0,1,1,0.0%,53m
30724,2,AeruTea,2450,0,0,7,7,0.0%,1h
30759,2,gestapo,2449,1251,168,161,329,51.1%,17m
30759,3,zachvara,2449,1064,63,56,119,52.9%,1h
30759,3,Koan,2449,1224,62,55,117,53.0%,1h
30759,2,damon,2449,979,40,40,80,50.0%,1h
30759,2,Clutch,2449,982,39,43,82,47.6%,52m
30759,3,Redan,2449,869,36,33,69,52.2%,1h
30759,2,Xtress,2449,877,34,36,70,48.6%,42m
30759,2,[Xpk]thelast,2449,420,25,18,43,58.1%,50m
30759,2,miniwd,2449,668,24,30,54,44.4%,3h
30759,2,SamXtreme,2449,570,23,19,42,54.8%,1h
30759,2,Rriverside,2449,348,11,20,31,35.5%,1h
30759,3,Dust,2449,223,7,6,13,53.8%,48m
30759,2,NOFX,2449,114,7,11,18,38.9%,38m
30759,3,[Z00]Gabagool,2449,64,5,4,9,55.6%,50m
30759,2,joakc,2449,120,5,8,13,38.5%,1h
30759,2,Damix,2449,146,5,11,16,31.2%,3h
30759,3,JayDx,2449,168,4,2,6,66.7%,34m
30759,2,[KoAv]Rökkur,2449,42,2,1,3,66.7%,9m
30759,3,zwallz,2449,97,2,1,3,66.7%,33m
30759,1,OneEyeJoe,2449,0,2,5,7,28.6%,24m
30759,1,[Pharoh]HyperMoose,2449,0,1,0,1,100.0%,52m
30759,3,tazzmania,2449,0,1,0,1,100.0%,3h
30759,3,MartínVizcar,2449,95,1,2,3,33.3%,1h
30759,1,Lucas,2449,0,1,3,4,25.0%,33m
30759,1,Duffman,2449,0,1,4,5,20.0%,3h
30759,3,[ZotZ]Dxs,2449,0,0,1,1,0.0%,3h
30759,3,Elvis,2449,0,0,1,1,0.0%,14m
30759,3,Kryzzum,2449,0,0,2,2,0.0%,3h
30787,2,FAHIM,2448,1566,106,112,218,48.6%,13m
30787,1,[3DuDez]Lazzino,2448,1301,86,85,171,50.3%,31m
30787,3,[lamnda]ElNicholsman,2448,1342,62,56,118,52.5%,26m
30787,3,Dingus,2448,1237,60,55,115,52.2%,1h
30787,2,[kØ]CHILLAN,2448,1379,60,57,117,51.3%,1h
30787,1,[Wizl]Kenkiskano,2448,1110,41,46,87,47.1%,3h
30787,2,Ricardo,2448,575,31,29,60,51.7%,52m
30787,3,[SBoys]ZergLemONade,2448,688,30,23,53,56.6%,1h
30787,3,billy,2448,786,30,30,60,50.0%,50m
30787,3,batlcftr,2448,680,26,30,56,46.4%,1h
30787,2,Quekchose,2448,578,23,23,46,50.0%,1h
30787,3,AsaZiN,2448,544,20,19,39,51.3%,1h
30787,2,Knightly,2448,544,20,25,45,44.4%,55m
30787,2,[Rushms]orangeroll,2448,248,8,10,18,44.4%,22m
30787,3,[Ldybys]TheBokOfRage,2448,150,6,5,11,54.5%,3h
30787,2,Destroyer,2448,128,6,9,15,40.0%,57m
30787,2,Smith,2448,184,5,10,15,33.3%,4m
30787,3,Grandee,2448,76,4,4,8,50.0%,3h
30787,3,DARKJR,2448,88,3,4,7,42.9%,26m
30787,3,ReignNoR,2448,96,2,4,6,33.3%,1h
30787,3,EgasCrusador,2448,0,2,5,7,28.6%,1h
30787,3,Chimera,2448,0,1,1,2,50.0%,30m
30787,3,Tempest,2448,30,1,1,2,50.0%,21m
30787,3,[CDAL]Rafael,2448,30,1,2,3,33.3%,33m
30787,3,steven,2448,30,1,2,3,33.3%,18m
30787,3,Userkare,2448,0,0,1,1,0.0%,1h
30787,3,Hookay,2448,0,0,1,1,0.0%,1h
30787,1,Arkium,2448,0,0,1,1,0.0%,11m
30787,3,ChangoLoco,2448,0,0,4,4,0.0%,31m
30816,1,RamHamar,2447,1584,323,324,647,49.9%,18m
30816,1,megatron,2447,1529,160,161,321,49.8%,3h
30816,3,HaveMercy,2447,1591,160,179,339,47.2%,3h
30816,3,Enforcer,2447,1656,92,86,178,51.7%,14m
30816,2,OrangeRoom,2447,709,69,57,126,54.8%,24m
30816,2,NLO,2447,689,52,41,93,55.9%,3h
30816,2,Plauge,2447,1046,44,39,83,53.0%,1h
30816,2,elchocoo,2447,946,33,39,72,45.8%,1h
30816,3,ELTERRAN,2447,684,25,20,45,55.6%,1h
30816,3,[LCE]rosedo,2447,649,25,27,52,48.1%,3h
30816,2,starscream,2447,360,12,16,28,42.9%,42m
30816,3,Zmordron,2447,302,11,7,18,61.1%,59m
30816,3,[DhZAc1]TIJOLINHO,2447,272,10,8,18,55.6%,1h
30816,2,[AkNi]akiosan,2447,228,9,12,21,42.9%,53m
30816,2,[pepis]BwahGamer,2447,248,9,12,21,42.9%,53m
30816,3,Rinzler,2447,200,7,6,13,53.8%,24m
30816,2,december,2447,176,6,3,9,66.7%,3h
30816,3,TimTan,2447,118,4,5,9,44.4%,3h
30816,1,HipsterPotat,2447,48,2,2,4,50.0%,6m
30816,2,Dragunov,2447,0,2,3,5,40.0%,3h
30816,1,sugarchicken,2447,48,2,4,6,33.3%,1h
30816,3,Freeman,2447,0,2,4,6,33.3%,1h
30816,3,[XNANIX]Renan,2447,0,1,0,1,100.0%,3h
30816,3,Fortachon,2447,78,1,2,3,33.3%,33m
30816,3,joseticona,2447,0,1,4,5,20.0%,1h
30816,3,[TheDOH]Armando,2447,0,0,1,1,0.0%,1h
30816,3,Ukraine,2447,0,0,1,1,0.0%,3h
30816,3,casH,2447,0,0,3,3,0.0%,1h
30816,1,aresel,2447,0,0,3,3,0.0%,16m
30845,2,DanielGomero,2446,1414,95,93,188,50.5%,1h
30845,3,Oghma,2446,1526,71,55,126,56.3%,29m
30845,3,Elwirfy,2446,828,33,33,66,50.0%,3h
30845,3,Mashico,2446,407,31,24,55,56.4%,1h
30845,1,marchsp,2446,769,30,32,62,48.4%,1h
30845,3,TourizT,2446,622,25,16,41,61.0%,13m
30845,3,Marinkung,2446,502,19,17,36,52.8%,5m
30845,2,Kalel,2446,184,16,11,27,59.3%,27m
30845,3,[BNITOS]MilfHunter,2446,338,12,11,23,52.2%,1h
30845,3,[OtakMs]RicardoMS,2446,317,11,7,18,61.1%,13m
30845,3,FuzzyAngel,2446,0,4,3,7,57.1%,27m
30845,3,[YD2K]BlueDucky,2446,118,4,7,11,36.4%,46m
30845,2,RonaldRaygun,2446,92,4,8,12,33.3%,50m
30845,2,Joshi,2446,40,4,8,12,33.3%,1h
30845,1,Ikarok,2446,94,4,10,14,28.6%,48m
30845,2,Spacemonster,2446,58,3,7,10,30.0%,3h
30845,1,Coldfyre,2446,140,3,8,11,27.3%,3h
30845,2,beastmode,2446,94,3,10,13,23.1%,25m
30845,3,LittleJoe,2446,68,2,3,5,40.0%,32m
30845,1,FUpayme,2446,0,2,4,6,33.3%,37m
30845,2,TheTabLe,2446,0,2,4,6,33.3%,3h
30845,3,Shless,2446,30,2,5,7,28.6%,3h
30845,1,Grohotun,2446,0,2,5,7,28.6%,39m
30845,2,Liberatah,2446,62,2,9,11,18.2%,15m
30845,3,Deathcall,2446,0,1,1,2,50.0%,1h
30845,3,[xDYEx]Iceman,2446,0,1,1,2,50.0%,24m
30845,3,TomaterBagel,2446,97,1,2,3,33.3%,1h
30845,2,RichardCH,2446,91,1,2,3,33.3%,18m
30845,3,Meraxes,2446,97,1,2,3,33.3%,39m
30845,2,Jesse,2446,0,1,2,3,33.3%,35m
30845,3,[SPPR]GeeReaper,2446,0,1,4,5,20.0%,33m
30845,3,Cosmic,2446,0,1,5,6,16.7%,18m
30845,3,keeker,2446,0,1,5,6,16.7%,46m
30845,1,EmilyFox,2446,32,1,11,12,8.3%,3h
30845,3,ackIV,2446,0,0,1,1,0.0%,19m
30845,3,PunisherThor,2446,0,0,1,1,0.0%,1h
30845,3,DRAKOSLAYER,2446,0,0,1,1,0.0%,1h
30845,3,[hxhchi]Espectrum,2446,0,0,2,2,0.0%,1h
30845,3,redxs,2446,0,0,4,4,0.0%,45m
30884,1,IIIIIIIIIIII,2445,1618,210,217,427,49.2%,1h
30884,3,LilZen,2445,1483,94,75,169,55.6%,1h
30884,2,TIANjojo,2445,1029,70,69,139,50.4%,42m
30884,3,poo,2445,763,30,22,52,57.7%,3h
30884,2,ELPERRON,2445,381,16,17,33,48.5%,50m
30884,3,freebuttouch,2445,355,13,13,26,50.0%,3h
30884,3,Sarge,2445,351,12,8,20,60.0%,1h
30884,3,Nemesis,2445,353,12,17,29,41.4%,3m
30884,3,Corvelton,2445,330,11,15,26,42.3%,3h
30884,3,Bert,2445,189,10,7,17,58.8%,10m
30884,3,OldSock,2445,234,9,11,20,45.0%,26m
30884,2,Quintus,2445,140,7,10,17,41.2%,40m
30884,3,JohnGalt,2445,148,5,5,10,50.0%,1h
30884,2,[JDG]IngArmando,2445,118,5,8,13,38.5%,1h
30884,2,EIO,2445,93,5,9,14,35.7%,25m
30884,3,KITON,2445,58,3,2,5,60.0%,3h
30884,3,[CzdT]LoPai,2445,30,2,2,4,50.0%,1h
30884,3,AceVerea,2445,0,2,4,6,33.3%,3h
30884,3,Sayasta,2445,0,1,0,1,100.0%,1h
30884,3,LOPelletier,2445,93,1,3,4,25.0%,30m
30884,3,[R4VE]Jodyze,2445,0,1,6,7,14.3%,3h
30884,3,SnowMonkey,2445,0,0,1,1,0.0%,1h
30884,3,zombie,2445,0,0,1,1,0.0%,10m
30884,3,Player,2445,0,0,4,4,0.0%,1h
30908,2,Shakyamuni,2444,1012,144,128,272,52.9%,1h
30908,3,Ondskan,2444,1573,96,88,184,52.2%,13m
30908,2,[R0CK]MrFalcon,2444,646,78,83,161,48.4%,30m
30908,3,DirtyDude,2444,1036,53,44,97,54.6%,1h
30908,2,TupaC,2444,1214,52,38,90,57.8%,1h
30908,2,Cheiseo,2444,903,38,35,73,52.1%,3h
30908,2,[LOHd]IIIIIIIIIIII,2444,917,36,30,66,54.5%,1h
30908,3,Jm,2444,551,24,11,35,68.6%,4m
30908,2,[GTHS]oswill,2444,622,24,30,54,44.4%,30m
30908,3,Johnson,2444,564,21,26,47,44.7%,28m
30908,2,Bleach,2444,276,12,12,24,50.0%,40m
30908,1,[PvZAll]Hope,2444,311,9,13,22,40.9%,3h
30908,3,rodrigo,2444,225,8,9,17,47.1%,53m
30908,3,Atishar,2444,150,7,4,11,63.6%,3h
30908,3,[UpeV]LBlanc,2444,204,7,8,15,46.7%,1h
30908,3,WhatIsHoodTV,2444,219,6,8,14,42.9%,9m
30908,3,kermit,2444,140,6,8,14,42.9%,1h
30908,3,HotMomma,2444,184,6,9,15,40.0%,3h
30908,2,Probetoss,2444,152,5,7,12,41.7%,28m
30908,2,[ZAVC]Murbebo,2444,128,4,9,13,30.8%,1h
30908,2,PaulPiche,2444,122,4,11,15,26.7%,3h
30908,3,muffnpunchr,2444,122,3,6,9,33.3%,1h
30908,2,Holidaynova,2444,102,3,9,12,25.0%,40m
30908,3,playr,2444,30,2,1,3,66.7%,18m
30908,3,BobertRoss,2444,120,2,1,3,66.7%,1h
30908,3,[HENT4l]Rambo,2444,30,2,2,4,50.0%,3h
30908,3,[MGQC]RacoonRider,2444,129,2,4,6,33.3%,59m
30908,1,Phoenix,2444,30,2,11,13,15.4%,3h
30908,3,Jpol,2444,0,1,0,1,100.0%,3h
30908,3,Xerian,2444,30,1,1,2,50.0%,20m
30908,3,[AbcCo]Nicolass,2444,0,1,2,3,33.3%,1h
30908,1,hyunjunee,2444,0,1,4,5,20.0%,1h
30908,1,ChickVanCluk,2444,0,1,4,5,20.0%,11m
30908,3,udaKu,2444,0,1,4,5,20.0%,3h
30908,3,[042292]StarEmber,2444,0,1,5,6,16.7%,3h
30908,3,[5TEN]FictoR,2444,38,1,8,9,11.1%,1h
30908,3,BlackObama,2444,0,0,1,1,0.0%,29m
30908,3,dvgamers,2444,0,0,1,1,0.0%,1h
30908,3,Anonymous,2444,0,0,1,1,0.0%,32m
30908,3,[U1KY]Clutch,2444,0,0,2,2,0.0%,5m
30908,3,[Mayku]Atreyu,2444,0,0,2,2,0.0%,1h
30908,3,youroutofgas,2444,0,0,3,3,0.0%,1h
30908,2,darknight,2444,0,0,4,4,0.0%,20m
30951,1,[DRKESP]Jon,2443,1602,346,352,698,49.6%,3h
30951,1,Saibot,2443,1614,240,240,480,50.0%,52m
30951,2,FreakyKoala,2443,1398,137,134,271,50.6%,13m
30951,3,Nivuar,2443,1381,124,119,243,51.0%,11m
30951,2,ShreddedOne,2443,1347,123,117,240,51.2%,40m
30951,3,nikoto,2443,1552,106,100,206,51.5%,39m
30951,2,HolyPohTayTe,2443,1034,75,68,143,52.4%,1h
30951,2,BigBug,2443,1478,65,61,126,51.6%,52m
30951,1,[SanTos]SaInTFer,2443,711,57,63,120,47.5%,40m
30951,3,sebascrzzzzz,2443,1301,51,54,105,48.6%,1h
30951,3,Lippy,2443,605,25,20,45,55.6%,1h
30951,3,raphonez,2443,452,17,14,31,54.8%,59m
30951,3,MGBiBo,2443,460,16,11,27,59.3%,1h
30951,1,AnThOnYPERU,2443,516,16,29,45,35.6%,52m
30951,3,Solidsnake,2443,424,15,11,26,57.7%,4m
30951,1,Blue,2443,483,15,32,47,31.9%,1h
30951,2,[YlwWfr]BloodKing,2443,366,12,15,27,44.4%,52m
30951,2,Electroid,2443,169,7,8,15,46.7%,4m
30951,2,Khan,2443,88,5,7,12,41.7%,3h
30951,2,VcSProphet,2443,196,5,9,14,35.7%,15m
30951,3,[DFBz]XenialDragon,2443,60,3,2,5,60.0%,18m
30951,3,PakoPamos,2443,58,2,1,3,66.7%,38m
30951,3,laxvega,2443,30,2,2,4,50.0%,28m
30951,3,[Sune]yukimura,2443,0,2,3,5,40.0%,24m
30951,3,InMediaRes,2443,0,2,5,7,28.6%,3h
30951,1,IHATEGAMES,2443,88,2,8,10,20.0%,39m
30951,3,[B0NERS]CAPTIANCHOAS,2443,0,1,0,1,100.0%,3h
30951,3,[C3R3AL]Fudgeeyenuh,2443,0,1,0,1,100.0%,1h
30951,3,SaltyBag,2443,0,1,0,1,100.0%,19m
30951,3,[NCMpe]CapitanDutiz,2443,30,1,2,3,33.3%,4m
30981,1,KingLee,2442,1594,168,169,337,49.9%,3h
30981,3,Cowboy,2442,1264,138,148,286,48.3%,31m
30981,2,OneStar,2442,1588,131,136,267,49.1%,3h
30981,3,OakCat,2442,1496,82,87,169,48.5%,1h
30981,1,SIRTOKEALOT,2442,789,38,48,86,44.2%,17m
30981,2,[Thyme]piepleaseeee,2442,688,28,28,56,50.0%,57m
30981,3,TonyMontana,2442,689,27,19,46,58.7%,1h
30981,2,Alpha,2442,316,13,18,31,41.9%,11m
30981,2,lowkey,2442,250,11,15,26,42.3%,3h
30981,2,Alistor,2442,126,9,10,19,47.4%,1h
30981,3,destroyeric,2442,202,8,5,13,61.5%,53m
30981,1,CHERVU,2442,213,7,5,12,58.3%,3h
30981,2,[copain]stan,2442,176,7,13,20,35.0%,3h
30981,2,Boulderdash,2442,186,5,7,12,41.7%,3h
30981,3,jupi,2442,139,4,0,4,100.0%,3h
30981,3,SoulHunter,2442,146,4,2,6,66.7%,3h
30981,2,[LOHd]FreyasGuard,2442,127,4,4,8,50.0%,28m
30981,3,juancena,2442,0,4,5,9,44.4%,15m
30981,2,jazz,2442,58,3,3,6,50.0%,29m
30981,3,echo,2442,90,3,6,9,33.3%,1h
30981,2,cosmicmuffin,2442,0,3,7,10,30.0%,1h
30981,3,MrJeef,2442,30,2,0,2,100.0%,1h
30981,3,SERAZ,2442,30,2,1,3,66.7%,1h
30981,3,[DoRQ]Ripley,2442,30,2,2,4,50.0%,1h
30981,3,ToasterBoy,2442,0,2,4,6,33.3%,59m
30981,3,dnovosel,2442,57,2,4,6,33.3%,3h
30981,1,FFrenchGeek,2442,0,1,4,5,20.0%,59m
30981,3,Noraad,2442,0,1,4,5,20.0%,3h
30981,2,Dalksser,2442,46,1,5,6,16.7%,55m
30981,3,Alex,2442,0,0,1,1,0.0%,1h
30981,3,Firestone,2442,0,0,1,1,0.0%,53m
30981,3,[ZWars]ATLESTUTRIED,2442,0,0,1,1,0.0%,1h
30981,2,Liao,2442,0,0,2,2,0.0%,3h
30981,3,[NAUG]KOBFelon,2442,0,0,3,3,0.0%,1h
30981,3,JimmyStewart,2442,0,0,5,5,0.0%,32m
31016,1,MalcolmPecs,2441,1581,206,217,423,48.7%,1h
31016,1,Latrufa,2441,1575,106,104,210,50.5%,1h
31016,3,Ballistix,2441,1549,82,77,159,51.6%,1h
31016,3,Monty,2441,1172,61,59,120,50.8%,1h
31016,3,FronFace,2441,696,43,33,76,56.6%,9m
31016,2,RaBidChicken,2441,584,20,24,44,45.5%,29m
31016,3,lilwookies,2441,174,17,10,27,63.0%,28m
31016,2,Chempo,2441,251,16,26,42,38.1%,13m
31016,2,Comie,2441,170,5,5,10,50.0%,51m
31016,2,[UKNOME]xsickBoy,2441,152,5,11,16,31.2%,42m
31016,3,Spacemonkey,2441,121,4,6,10,40.0%,1h
31016,2,RustyKuntz,2441,123,4,7,11,36.4%,3h
31016,3,[NwAs]Riverian,2441,30,2,1,3,66.7%,1h
31016,3,[NXOB]winsor,2441,0,1,0,1,100.0%,26m
31016,3,Catire,2441,0,1,1,2,50.0%,15m
31016,3,Azertol,2441,30,1,4,5,20.0%,3h
31016,1,Ender,2441,38,1,5,6,16.7%,3h
31016,3,Nayrou,2441,0,0,1,1,0.0%,45m
31016,3,Obrigkeit,2441,0,0,1,1,0.0%,3h
31016,1,SPQRpanda,2441,0,0,2,2,0.0%,1h
31016,3,Phi,2441,0,0,3,3,0.0%,1h
31016,2,Tommiknoker,2441,0,0,3,3,0.0%,29m
31016,1,joseminchola,2441,0,0,6,6,0.0%,1h
31039,2,NNHappyGirl,2440,1420,206,208,414,49.8%,22m
31039,1,goodguy,2440,1652,156,168,324,48.1%,1h
31039,1,Squanto,2440,1524,65,62,127,51.2%,3h
31039,3,[WineHQ]LoTAC,2440,922,41,28,69,59.4%,17m
31039,2,[XpKAc]Nando,2440,633,40,38,78,51.3%,25m
31039,3,[urdone]Raven,2440,307,27,25,52,51.9%,1h
31039,3,eGirl,2440,651,26,25,51,51.0%,11m
31039,3,ABYSS,2440,636,23,25,48,47.9%,3h
31039,3,kosmkdialate,2440,561,21,17,38,55.3%,3h
31039,2,Sisyphus,2440,389,18,27,45,40.0%,45m
31039,3,Milad,2440,289,9,11,20,45.0%,3h
31039,2,PlagueDoc,2440,238,9,11,20,45.0%,1h
31039,3,[SigmaV]Bernie,2440,202,8,6,14,57.1%,26m
31039,2,TroUble,2440,242,8,8,16,50.0%,3h
31039,2,David,2440,248,8,15,23,34.8%,30m
31039,2,TalesKid,2440,180,6,11,17,35.3%,30m
31039,3,Emet,2440,140,5,6,11,45.5%,1h
31039,1,raynor,2440,96,4,7,11,36.4%,1h
31039,1,Maxos,2440,92,3,12,15,20.0%,1h
31039,3,Takayoshi,2440,30,2,1,3,66.7%,3h
31039,3,Wylde,2440,58,2,7,9,22.2%,3h
31039,2,Mystic,2440,66,2,9,11,18.2%,49m
31039,3,[RDQ]Rambo,2440,0,1,0,1,100.0%,3h
31039,3,[PRB4SL]KingNickSA,2440,0,1,1,2,50.0%,31m
31039,3,SEER,2440,30,1,2,3,33.3%,18m
31039,3,[USplan]Imperatore,2440,30,1,2,3,33.3%,1h
31039,1,naranjoDF,2440,0,0,1,1,0.0%,1h
31039,3,ElisioN,2440,0,0,1,1,0.0%,42m
31039,3,[Boboyz]spacerandy,2440,0,0,1,1,0.0%,3h
31039,3,EventHorizon,2440,0,0,4,4,0.0%,53m
31069,2,emaelstrom,2439,972,122,114,236,51.7%,1h
31069,2,joechristmas,2439,727,76,72,148,51.4%,3h
31069,2,[RblSqd]Lebanese,2439,580,59,51,110,53.6%,51m
31069,1,Gailees,2439,1392,56,59,115,48.7%,13m
31069,3,DrContract,2439,1016,49,44,93,52.7%,46m
31069,3,[BCRUSE]Oscaroar,2439,888,40,41,81,49.4%,1h
31069,2,[WSF67]RickySuggs,2439,854,39,36,75,52.0%,5m
31069,2,RobotNinja,2439,610,21,26,47,44.7%,13m
31069,2,ERGHEIZ,2439,498,17,18,35,48.6%,1h
31069,2,Dinolino,2439,464,14,19,33,42.4%,1h
31069,2,zatinador,2439,324,11,20,31,35.5%,1h
31069,2,Maniac,2439,282,8,7,15,53.3%,1h
31069,3,[SerCri]Onesec,2439,150,7,9,16,43.8%,1h
31069,3,Pear,2439,55,6,7,13,46.2%,1h
31069,2,bourgot,2439,92,5,7,12,41.7%,3h
31069,3,xiboloxd,2439,151,4,2,6,66.7%,14m
31069,3,Lendarios,2439,146,4,2,6,66.7%,30m
31069,2,LaLaDa,2439,124,4,13,17,23.5%,7m
31069,3,ProbingTime,2439,60,3,2,5,60.0%,54m
31069,1,bloom,2439,30,3,6,9,33.3%,58m
31069,1,BrownRecluse,2439,0,2,3,5,40.0%,1h
31069,1,ChaosEater,2439,0,2,7,9,22.2%,24m
31069,2,RogueLeader,2439,62,2,9,11,18.2%,40m
31069,3,DonnieNarko,2439,0,1,0,1,100.0%,1h
31069,3,Weeny,2439,30,1,2,3,33.3%,11m
31069,3,[aqocea]Shadow,2439,30,1,2,3,33.3%,1h
31069,3,Noyan,2439,30,1,3,4,25.0%,38m
31069,3,[RJTS]Anex,2439,30,1,4,5,20.0%,30m
31069,1,Squamus,2439,0,1,4,5,20.0%,33m
31069,3,[R3K]ZhangFei,2439,0,0,1,1,0.0%,1h
31069,3,ruhan,2439,0,0,1,1,0.0%,3h
31069,1,cabomita,2439,0,0,1,1,0.0%,3h
31069,3,VaaZerg,2439,0,0,2,2,0.0%,3m
31069,2,Arkinos,2439,0,0,5,5,0.0%,3h
31103,2,JuanitoBboy,2438,1618,273,259,532,51.3%,40m
31103,2,xStalker,2438,1562,164,148,312,52.6%,3h
31103,1,keenzapa,2438,1397,78,76,154,50.6%,3h
31103,3,[LGNxx]macdwest,2438,1519,74,73,147,50.3%,1h
31103,1,NeemeSiS,2438,1006,72,77,149,48.3%,3h
31103,1,Dropbear,2438,1638,70,70,140,50.0%,1h
31103,2,[SMPunk]DEOWASD,2438,1170,56,43,99,56.6%,6m
31103,3,meroltha,2438,1101,54,56,110,49.1%,10m
31103,2,BULAZ,2438,1020,46,47,93,49.5%,3h
31103,3,General,2438,523,22,22,44,50.0%,1h
31103,3,[SKSR]FukdUpBack,2438,543,21,13,34,61.8%,1h
31103,3,sxtycat,2438,485,20,7,27,74.1%,1h
31103,2,BlaKiN,2438,474,19,17,36,52.8%,7m
31103,3,Kinderparty,2438,469,18,21,39,46.2%,27m
31103,1,berryboy,2438,372,14,19,33,42.4%,51m
31103,3,Darghan,2438,355,12,9,21,57.1%,30m
31103,3,zdexor,2438,264,12,12,24,50.0%,1h
31103,1,WatterMelons,2438,210,10,11,21,47.6%,54m
31103,2,DTBshadow,2438,276,10,13,23,43.5%,1h
31103,3,antimcrochip,2438,284,10,14,24,41.7%,54m
31103,2,Dart,2438,271,8,11,19,42.1%,3h
31103,2,kurama,2438,228,7,4,11,63.6%,3h
31103,3,marcki,2438,195,6,3,9,66.7%,54m
31103,1,Aximili,2438,36,5,4,9,55.6%,13m
31103,3,THEWINNER,2438,192,5,8,13,38.5%,1h
31103,3,Envy,2438,143,4,5,9,44.4%,3m
31103,2,Vietoronto,2438,92,3,11,14,21.4%,58m
31103,2,Zilog,2438,40,2,2,4,50.0%,18m
31103,2,[LAT18]Alfredo,2438,32,2,4,6,33.3%,49m
31103,2,[AR3N4]mark,2438,48,2,10,12,16.7%,3h
31103,3,Solorn,2438,0,1,0,1,100.0%,29m
31103,3,peti,2438,0,1,1,2,50.0%,1h
31103,3,Bolão,2438,30,1,2,3,33.3%,59m
31103,3,KingKongKush,2438,30,1,3,4,25.0%,3h
31103,1,Gabrelicious,2438,0,1,4,5,20.0%,3m
31103,3,Foladan,2438,0,0,1,1,0.0%,1h
31103,3,venommaster,2438,0,0,2,2,0.0%,13m
31103,3,DevOnCycle,2438,0,0,5,5,0.0%,3h
31141,3,hahanoob,2437,1158,142,127,269,52.8%,18m
31141,1,Sophon,2437,1480,141,142,283,49.8%,3h
31141,2,Nietzsche,2437,851,98,98,196,50.0%,40m
31141,3,RAZGUT,2437,1532,97,97,194,50.0%,46m
31141,2,Winnebago,2437,410,82,85,167,49.1%,55m
31141,3,WAD,2437,1274,79,87,166,47.6%,32m
31141,2,Ruffian,2437,1252,76,69,145,52.4%,1h
31141,2,[KITG]HOTShot,2437,1572,71,73,144,49.3%,11m
31141,2,Ronin,2437,766,28,35,63,44.4%,1h
31141,3,[ASS10]BirdsoPrey,2437,754,27,28,55,49.1%,31m
31141,2,SkullKrusher,2437,392,14,19,33,42.4%,13m
31141,3,Wreqz,2437,301,9,8,17,52.9%,3h
31141,2,fvvf,2437,224,9,12,21,42.9%,3h
31141,3,sbmc,2437,146,5,7,12,41.7%,1h
31141,3,Puppetkiller,2437,140,3,1,4,75.0%,1h
31141,3,DirtySecret,2437,121,3,2,5,60.0%,1h
31141,3,[RMPNEN]Xephorot,2437,106,3,3,6,50.0%,10m
31141,1,Spellbinder,2437,80,3,12,15,20.0%,24m
31141,1,ScubaSteve,2437,48,2,4,6,33.3%,7m
31141,2,[Crazed]CrazyCritter,2437,60,2,10,12,16.7%,1h
31141,3,LLiLiLiiL,2437,0,1,0,1,100.0%,32m
31141,3,Moltron,2437,30,1,2,3,33.3%,15m
31141,1,BunRieuCua,2437,0,1,4,5,20.0%,1h
31141,1,Uknwu,2437,0,1,4,5,20.0%,7m
31141,3,CutieAngels,2437,30,1,4,5,20.0%,1h
31141,3,RAGE,2437,0,0,1,1,0.0%,1h
31141,3,Crawfish,2437,0,0,1,1,0.0%,3h
31141,3,BiteMe,2437,0,0,3,3,0.0%,1h
31169,3,[a1vNA]Gontazu,2436,1603,164,167,331,49.5%,3h
31169,3,diegog,2436,1596,74,59,133,55.6%,33m
31169,2,PanchO,2436,1418,54,61,115,47.0%,3h
31169,3,DetonaRalph,2436,944,35,35,70,50.0%,1h
31169,1,Petri,2436,934,34,40,74,45.9%,31m
31169,3,Almver,2436,728,27,27,54,50.0%,8m
31169,3,[SCMK]michmx,2436,628,25,19,44,56.8%,27m
31169,3,killertwo,2436,307,25,27,52,48.1%,55m
31169,3,Hideo,2436,629,24,18,42,57.1%,1h
31169,3,Griffin,2436,630,23,20,43,53.5%,3h
31169,3,nemesis,2436,570,23,25,48,47.9%,1h
31169,2,soN,2436,343,14,10,24,58.3%,1h
31169,2,nuYOmaYO,2436,236,9,12,21,42.9%,13m
31169,2,JeanBarke,2436,230,8,11,19,42.1%,1h
31169,2,ELVECTOR,2436,148,5,5,10,50.0%,1h
31169,3,KingChess,2436,90,5,8,13,38.5%,59m
31169,2,Zeitzef,2436,164,5,13,18,27.8%,53m
31169,3,WuttaRichard,2436,168,4,2,6,66.7%,1h
31169,2,lukiller,2436,0,4,2,6,66.7%,1h
31169,3,[13]Legobawls,2436,120,4,6,10,40.0%,48m
31169,1,sangfroid,2436,70,4,8,12,33.3%,3h
31169,3,[nieBla]darloy,2436,140,3,1,4,75.0%,50m
31169,3,[IiUiI]DinoDanoDuno,2436,88,3,4,7,42.9%,1h
31169,3,SpaceGhost,2436,96,2,0,2,100.0%,60m
31169,3,chopper,2436,30,2,3,5,40.0%,1h
31169,3,[Zin]Hedman,2436,30,1,1,2,50.0%,3h
31169,3,WoodenSpoon,2436,0,1,2,3,33.3%,50m
31169,1,LuLu,2436,0,1,4,5,20.0%,1h
31169,3,[RON1N]RevMatch,2436,0,0,2,2,0.0%,3h
31169,3,[SECT4]EltioZeratul,2436,0,0,2,2,0.0%,3h
31199,2,MarcelLesale,2435,1463,100,104,204,49.0%,6m
31199,2,Graneka,2435,799,65,65,130,50.0%,3h
31199,3,Sandéconné,2435,715,26,23,49,53.1%,3h
31199,2,[RKOI]ViolentPanzi,2435,698,26,38,64,40.6%,22m
31199,3,MicroJackson,2435,429,16,19,35,45.7%,42m
31199,2,MachineOsaur,2435,324,12,16,28,42.9%,34m
31199,2,Lycanwytch,2435,228,10,12,22,45.5%,3h
31199,3,[JaMiT]FourHorsemen,2435,202,7,6,13,53.8%,1h
31199,3,coronavirus,2435,217,7,7,14,50.0%,1h
31199,2,Yvv,2435,62,5,9,14,35.7%,5m
31199,3,Steve,2435,116,4,4,8,50.0%,5m
31199,2,aksska,2435,94,4,10,14,28.6%,1h
31199,3,Oracle,2435,86,3,4,7,42.9%,53m
31199,3,ManiManitoXD,2435,30,3,5,8,37.5%,3h
31199,3,NMsinse,2435,30,2,0,2,100.0%,11m
31199,3,Lombardo,2435,60,2,2,4,50.0%,53m
31199,3,[Epokhé]RaZoR,2435,114,2,2,4,50.0%,1h
31199,3,[BlTEL]Lurp,2435,58,2,3,5,40.0%,13m
31199,1,Celtic,2435,0,2,6,8,25.0%,50m
31199,1,EightMinAbs,2435,0,1,0,1,100.0%,27m
31199,3,SombraNovaes,2435,0,1,0,1,100.0%,1h
31199,3,JPJP,2435,0,1,0,1,100.0%,3h
31199,3,[PDPGS]swordfish,2435,0,1,0,1,100.0%,21m
31199,3,yella,2435,0,1,1,2,50.0%,1h
31199,3,[CnD]RoyalKing,2435,30,1,3,4,25.0%,1h
31199,1,RagingPanda,2435,0,1,4,5,20.0%,37m
31199,1,Ryveran,2435,0,1,4,5,20.0%,3m
31199,3,[PapaG]Ben,2435,0,1,4,5,20.0%,1h
31199,3,OnlyOneWrx,2435,0,0,2,2,0.0%,3h
31199,3,[Zambo]RicaLaPiña,2435,0,0,3,3,0.0%,30m
31199,1,mahan,2435,0,0,3,3,0.0%,1h
31230,2,Freud,2434,1440,106,103,209,50.7%,51m
31230,3,Juicedance,2434,1341,99,100,199,49.7%,4m
31230,3,xxxKIRAxxx,2434,660,59,57,116,50.9%,9m
31230,2,melturBRAIN,2434,633,55,38,93,59.1%,51m
31230,2,[BOvLs]GoldenEagle,2434,527,33,24,57,57.9%,1h
31230,2,antagomiR,2434,826,29,38,67,43.3%,3h
31230,3,Habaxrolxd,2434,529,22,18,40,55.0%,1h
31230,2,sgtdeath,2434,568,19,25,44,43.2%,24m
31230,2,Christoph,2434,502,18,20,38,47.4%,34m
31230,3,JACOBY,2434,430,15,18,33,45.5%,20m
31230,3,Jimmaye,2434,323,14,15,29,48.3%,3h
31230,3,RyUkUnG,2434,166,7,8,15,46.7%,38m
31230,2,ChuckDanger,2434,112,6,9,15,40.0%,57m
31230,1,Excalibro,2434,120,6,9,15,40.0%,3h
31230,3,SwarthyMcTit,2434,173,5,1,6,83.3%,24m
31230,3,[MadK]zdamaro,2434,139,5,7,12,41.7%,1h
31230,3,ItThatBetray,2434,30,1,2,3,33.3%,1h
31230,3,Maticalz,2434,30,1,2,3,33.3%,32m
31230,3,Creativename,2434,0,1,4,5,20.0%,26m
31230,3,RogueMarine,2434,0,1,4,5,20.0%,16m
31230,3,[DarkC]BigCharles,2434,0,0,1,1,0.0%,1h
31230,3,DunkChai,2434,0,0,1,1,0.0%,1h
31230,3,[sk3tch]Ruan,2434,0,0,2,2,0.0%,42m
31230,2,[FORU]llllllllllll,2434,0,0,7,7,0.0%,3h
31254,2,[XpKAc]Nacho,2433,1556,351,350,701,50.1%,1h
31254,2,LibertyPrime,2433,1495,112,111,223,50.2%,53m
31254,2,[SWOU]RITMO,2433,1528,111,104,215,51.6%,53m
31254,2,Nasquid,2433,1339,85,81,166,51.2%,1h
31254,2,Tenek,2433,1584,76,78,154,49.4%,13m
31254,3,TITO,2433,826,71,82,153,46.4%,45m
31254,1,Windwaker,2433,1452,61,59,120,50.8%,39m
31254,3,justin,2433,790,40,33,73,54.8%,1h
31254,3,ArcoKodiak,2433,331,24,29,53,45.3%,5m
31254,3,Cegorach,2433,611,22,24,46,47.8%,8m
31254,2,[GOPERÚ]irvin,2433,202,22,26,48,45.8%,54m
31254,2,[danima]ryry,2433,546,19,22,41,46.3%,6m
31254,3,[0PGC0]Betho,2433,300,11,6,17,64.7%,3h
31254,3,DonEnzone,2433,282,10,10,20,50.0%,1h
31254,3,Aizi,2433,294,10,13,23,43.5%,1h
31254,2,BeesNSkis,2433,241,9,10,19,47.4%,53m
31254,3,StormShadow,2433,220,8,6,14,57.1%,27m
31254,2,RHAPSODY,2433,226,7,9,16,43.8%,4m
31254,2,[PCQ]BeastLight,2433,208,6,6,12,50.0%,3h
31254,3,rtroyans,2433,150,6,6,12,50.0%,5m
31254,1,TheGambler,2433,132,6,11,17,35.3%,37m
31254,3,Laith,2433,188,5,2,7,71.4%,48m
31254,3,papalo,2433,147,4,1,5,80.0%,33m
31254,1,Francisco,2433,143,4,5,9,44.4%,10m
31254,3,[Macac0]YoNoSoyArCes,2433,145,3,1,4,75.0%,48m
31254,2,khuaikhema,2433,0,3,4,7,42.9%,41m
31254,3,[iBoss]Rugor,2433,121,3,5,8,37.5%,12m
31254,2,ArmagedomBr,2433,30,3,6,9,33.3%,28m
31254,2,Starbuck,2433,62,3,8,11,27.3%,3h
31254,3,[SUDAKA]DMart,2433,30,2,1,3,66.7%,1h
31254,3,kowo,2433,30,2,1,3,66.7%,33m
31254,1,blwh,2433,0,2,1,3,66.7%,3h
31254,3,RichFeynmann,2433,48,2,2,4,50.0%,1h
31254,3,OldmemeAdwai,2433,30,2,2,4,50.0%,8m
31254,2,Millil,2433,126,2,3,5,40.0%,34m
31254,2,totemX,2433,0,2,5,7,28.6%,33m
31254,3,Chroot,2433,0,2,6,8,25.0%,1h
31254,3,[DTKA]BrownBob,2433,0,1,1,2,50.0%,32m
31254,3,DrBad,2433,96,1,1,2,50.0%,3h
31254,3,[d8D]Führer,2433,38,1,2,3,33.3%,1h
31254,3,workwork,2433,0,1,3,4,25.0%,13m
31254,2,[RLPC]Wyatt,2433,88,1,4,5,20.0%,22m
31254,3,Evader,2433,0,1,5,6,16.7%,22m
31254,2,[KREAP]FlamingPie,2433,0,1,6,7,14.3%,1h
31254,2,Testosterone,2433,0,0,1,1,0.0%,1h
31254,3,Ftmch,2433,0,0,1,1,0.0%,3h
31254,3,[1318]IndyMan,2433,0,0,2,2,0.0%,1h
31254,3,Samuel,2433,0,0,2,2,0.0%,1h
31302,3,[iDrunk]tomto,2432,1035,82,82,164,50.0%,33m
31302,3,[BCBZ]Newton,2432,1239,66,53,119,55.5%,1h
31302,3,[Derpz]Prone,2432,977,62,52,114,54.4%,16m
31302,3,[KJedi]BigDuke,2432,1374,51,63,114,44.7%,4m
31302,2,HydroPWNics,2432,667,44,49,93,47.3%,1h
31302,2,DrexBanner,2432,1090,40,44,84,47.6%,54m
31302,3,iDKxHiggins,2432,784,33,25,58,56.9%,3h
31302,3,[Atira]Atira,2432,912,33,34,67,49.3%,3h
31302,3,SilentStorm,2432,683,31,18,49,63.3%,3h
31302,3,RET,2432,630,25,19,44,56.8%,21m
31302,3,Dillwinn,2432,404,15,18,33,45.5%,1h
31302,2,OldSchoolNub,2432,358,15,20,35,42.9%,45m
31302,3,AnArKyA,2432,259,12,11,23,52.2%,50m
31302,3,Ubertizer,2432,284,10,6,16,62.5%,54m
31302,3,PsicosiS,2432,307,10,7,17,58.8%,1h
31302,2,rEvosauruS,2432,210,7,8,15,46.7%,34m
31302,3,CHALLENGER,2432,170,6,9,15,40.0%,1h
31302,3,[EMAT]TAME,2432,149,4,6,10,40.0%,30m
31302,3,Artruder,2432,149,4,6,10,40.0%,3h
31302,2,starbuck,2432,114,4,8,12,33.3%,3h
31302,3,[GrnBrd]Minimal,2432,121,3,1,4,75.0%,1h
31302,3,Roughnecks,2432,151,3,2,5,60.0%,48m
31302,3,Aylen,2432,86,3,5,8,37.5%,3h
31302,3,QUARANTINED,2432,97,3,5,8,37.5%,30m
31302,3,oOGoSuOo,2432,58,2,3,5,40.0%,53m
31302,3,DPOD,2432,115,2,3,5,40.0%,26m
31302,3,MaximusSnow,2432,133,2,4,6,33.3%,1h
31302,3,eriksen,2432,0,1,0,1,100.0%,1h
31302,1,[CrtMas]DeathsBane,2432,0,1,4,5,20.0%,3h
31302,3,dpod,2432,0,1,4,5,20.0%,17m
31302,3,lariats,2432,0,1,4,5,20.0%,3h
31302,2,nomada,2432,0,1,6,7,14.3%,3h
31302,2,Frankito,2432,0,0,1,1,0.0%,1h
31302,3,ryanfury,2432,0,0,1,1,0.0%,1h
31302,3,SentaoDePana,2432,0,0,1,1,0.0%,1h
31302,3,chixxdigit,2432,0,0,2,2,0.0%,1h
31338,3,Terramiso,2431,1556,145,154,299,48.5%,21m
31338,2,bargun,2431,1532,140,140,280,50.0%,1h
31338,3,Soulking,2431,1145,44,47,91,48.4%,1h
31338,3,SpiderMind,2431,753,43,10,53,81.1%,21m
31338,2,wing,2431,935,36,36,72,50.0%,6m
31338,2,[STFC]TrusT,2431,709,33,30,63,52.4%,6m
31338,3,Verni,2431,694,31,26,57,54.4%,21m
31338,2,kihun,2431,551,27,22,49,55.1%,3h
31338,2,[icCCce]Proginator,2431,676,23,27,50,46.0%,7m
31338,3,HURM,2431,428,17,13,30,56.7%,1h
31338,2,[MAPL]Nimzpe,2431,462,16,19,35,45.7%,3h
31338,1,thekiller,2431,224,10,14,24,41.7%,25m
31338,3,[MªnCºs]HHMM,2431,251,9,11,20,45.0%,26m
31338,3,IllIIlIIllII,2431,231,7,10,17,41.2%,13m
31338,3,BTPaladin,2431,203,6,4,10,60.0%,1h
31338,3,gasmasked,2431,199,6,9,15,40.0%,3h
31338,2,[SSZZ]Pwncraft,2431,204,5,7,12,41.7%,3h
31338,3,cJoker,2431,114,4,5,9,44.4%,1h
31338,3,zico,2431,60,3,4,7,42.9%,1h
31338,1,HERO,2431,145,3,5,8,37.5%,7m
31338,3,[ANTT]whofly,2431,120,2,1,3,66.7%,26m
31338,3,[NM8]Zombie,2431,96,2,4,6,33.3%,46m
31338,3,GerarGORE,2431,97,2,5,7,28.6%,46m
31338,3,BoastMalone,2431,30,1,1,2,50.0%,1h
31338,3,[SCVM]DespritLoon,2431,0,1,2,3,33.3%,1h
31338,1,asdfin,2431,0,1,4,5,20.0%,1h
31338,3,Luther,2431,0,1,4,5,20.0%,19m
31338,3,DARGON,2431,0,1,4,5,20.0%,1h
31338,3,fizzyelf,2431,0,1,5,6,16.7%,3m
31338,3,TANTUM,2431,0,0,2,2,0.0%,3h
31338,3,beans,2431,0,0,2,2,0.0%,1h
31338,3,[TGosuB]Dream,2431,0,0,3,3,0.0%,32m
31370,2,Dangelo,2430,1531,146,149,295,49.5%,45m
31370,2,AtotheK,2430,1388,97,97,194,50.0%,1h
31370,3,DaveZed,2430,1309,59,51,110,53.6%,3h
31370,3,Crank,2430,1217,55,54,109,50.5%,53m
31370,1,PeeOnPoo,2430,1208,45,56,101,44.6%,57m
31370,2,[HAV0C]XERO,2430,750,43,52,95,45.3%,11m
31370,3,Songyuqi,2430,571,27,20,47,57.4%,3h
31370,1,[LPDeTV]Gausk,2430,719,25,31,56,44.6%,1h
31370,3,[TVV]Anonymous,2430,534,21,20,41,51.2%,1h
31370,3,Colwell,2430,281,9,7,16,56.2%,53m
31370,2,[FxB]TheReaperMan,2430,236,9,15,24,37.5%,54m
31370,3,[NEGF]Jinx,2430,201,7,6,13,53.8%,22m
31370,3,blast,2430,144,6,3,9,66.7%,5m
31370,3,Naux,2430,140,5,7,12,41.7%,1h
31370,3,HerrHimmler,2430,94,3,6,9,33.3%,30m
31370,1,Zero,2430,0,2,2,4,50.0%,37m
31370,1,SheftIZl,2430,48,2,4,6,33.3%,8m
31370,1,Havok,2430,48,2,6,8,25.0%,59m
31370,3,[NextDC]CAMOS,2430,0,1,0,1,100.0%,26m
31370,3,DoctorC,2430,0,1,1,2,50.0%,33m
31370,2,vasdeferens,2430,90,1,2,3,33.3%,3h
31370,1,Fortress,2430,97,1,4,5,20.0%,34m
31370,2,Veigas,2430,30,1,7,8,12.5%,1h
31370,3,Rossconin,2430,0,0,1,1,0.0%,3h
31370,3,[Kapus]TheGhostOz,2430,0,0,1,1,0.0%,27m
31370,3,VEIDERZAP,2430,0,0,2,2,0.0%,16m
31396,3,AJAX,2429,1377,419,423,842,49.8%,1h
31396,3,[C4Max]Jovani,2429,1476,225,237,462,48.7%,4m
31396,1,Tarn,2429,1444,117,119,236,49.6%,1h
31396,2,ronald,2429,1519,106,105,211,50.2%,3h
31396,3,[YT]OtongaO,2429,1446,69,61,130,53.1%,32m
31396,1,Maximus,2429,1410,58,56,114,50.9%,51m
31396,2,HarryKlynn,2429,1564,57,65,122,46.7%,34m
31396,3,xbatallion,2429,961,40,35,75,53.3%,54m
31396,3,[DRKRIS]Ntraveler,2429,359,29,25,54,53.7%,1h
31396,1,kyosai,2429,584,19,31,50,38.0%,1h
31396,3,Syaoran,2429,409,15,20,35,42.9%,1h
31396,3,CasSiel,2429,209,14,13,27,51.9%,3h
31396,3,[LHDSC]David,2429,353,13,15,28,46.4%,1h
31396,2,Frenzy,2429,217,10,6,16,62.5%,1h
31396,3,Aaron,2429,273,10,11,21,47.6%,1h
31396,2,hasuprobe,2429,276,10,14,24,41.7%,1h
31396,3,Mogo,2429,282,9,14,23,39.1%,1h
31396,2,ffumagalli,2429,264,8,13,21,38.1%,1h
31396,2,Bob,2429,258,8,13,21,38.1%,3h
31396,3,[ShdwLg]pizzaboy,2429,192,7,6,13,53.8%,53m
31396,2,NYFitted,2429,208,7,14,21,33.3%,55m
31396,2,Imperium,2429,193,5,6,11,45.5%,1h
31396,3,suzhe,2429,118,4,5,9,44.4%,1h
31396,3,FormerRat,2429,123,4,6,10,40.0%,1h
31396,3,naive,2429,118,3,0,3,100.0%,1h
31396,3,KingBloBlob,2429,64,3,3,6,50.0%,1h
31396,3,SuperMerican,2429,157,3,4,7,42.9%,1h
31396,3,[sk3tch]hydra,2429,121,2,1,3,66.7%,17m
31396,3,Churky,2429,0,2,4,6,33.3%,38m
31396,2,Azedenkae,2429,0,1,0,1,100.0%,30m
31396,1,Zymral,2429,0,1,0,1,100.0%,1h
31396,3,memerweiner,2429,0,1,1,2,50.0%,27m
31396,3,Ghostlypuddl,2429,30,1,2,3,33.3%,1h
31396,3,Mogly,2429,0,1,4,5,20.0%,1h
31396,3,Sthefano,2429,97,1,4,5,20.0%,32m
31396,2,XSuzumiyaX,2429,44,1,7,8,12.5%,24m
31432,3,[AdSC2]MaVoRs,2428,1570,173,161,334,51.8%,1h
31432,3,lowkei,2428,968,83,68,151,55.0%,47m
31432,2,LingCheese,2428,1352,56,59,115,48.7%,49m
31432,2,Jason,2428,930,47,40,87,54.0%,3h
31432,2,Turjk,2428,926,45,48,93,48.4%,3h
31432,2,AlanGNR,2428,878,35,38,73,47.9%,1h
31432,3,Liquidvamp,2428,800,33,24,57,57.9%,53m
31432,2,Ararat,2428,810,32,38,70,45.7%,53m
31432,3,HASSERFUELLT,2428,633,24,24,48,50.0%,1h
31432,2,Freeman,2428,319,18,15,33,54.5%,7m
31432,3,[ALTF04]Alastor,2428,384,15,7,22,68.2%,1h
31432,3,[UpeV]ARTANIS,2428,334,13,8,21,61.9%,53m
31432,2,vash,2428,364,13,13,26,50.0%,13m
31432,3,MeatSalad,2428,365,13,20,33,39.4%,4m
31432,3,Gucci,2428,223,6,10,16,37.5%,26m
31432,3,Tediz,2428,30,2,1,3,66.7%,24m
31432,3,IIIIIIIIIIII,2428,0,1,0,1,100.0%,38m
31432,3,MrForcep,2428,30,1,2,3,33.3%,33m
31432,3,hassie,2428,93,1,2,3,33.3%,1h
31432,3,AnarchistOwl,2428,0,1,4,5,20.0%,13m
31432,1,donavon,2428,0,1,4,5,20.0%,1h
31432,3,YouBryant,2428,0,0,1,1,0.0%,1h
31432,3,[TGCrew]Bendo,2428,0,0,1,1,0.0%,3h
31432,2,MADHatter,2428,0,0,3,3,0.0%,3h
31456,1,[BGump]LtDan,2427,1595,291,280,571,51.0%,3h
31456,2,crossbow,2427,1602,279,279,558,50.0%,42m
31456,1,Wilson,2427,1579,259,254,513,50.5%,31m
31456,1,TheMark,2427,1620,250,243,493,50.7%,16m
31456,3,Mancusi,2427,1208,157,138,295,53.2%,28m
31456,3,rodrigo,2427,1093,132,112,244,54.1%,1h
31456,3,Alfredo,2427,1299,119,122,241,49.4%,1h
31456,1,Omnipresent,2427,1581,103,102,205,50.2%,51m
31456,3,SgtWonton,2427,1533,79,81,160,49.4%,53m
31456,3,HotPocket,2427,767,67,59,126,53.2%,55m
31456,3,Joaquin,2427,1059,52,52,104,50.0%,1h
31456,2,Zappy,2427,212,41,39,80,51.2%,42m
31456,2,TheOldDC,2427,876,40,44,84,47.6%,54m
31456,3,OGnerdballer,2427,1115,40,56,96,41.7%,45m
31456,3,voilierrouge,2427,850,37,34,71,52.1%,1h
31456,3,fluff,2427,772,30,25,55,54.5%,48m
31456,3,[kanda]Tatsumi,2427,626,25,21,46,54.3%,8m
31456,3,Marklongwide,2427,612,24,19,43,55.8%,3h
31456,3,Redlevi,2427,636,24,25,49,49.0%,1h
31456,3,[Shang]Killa,2427,305,17,17,34,50.0%,51m
31456,3,Oozi,2427,292,10,9,19,52.6%,1h
31456,3,Jfive,2427,256,9,9,18,50.0%,1h
31456,2,Marco,2427,184,6,12,18,33.3%,7m
31456,1,[OTty]OldManRaynor,2427,204,6,19,25,24.0%,41m
31456,3,HowieStar,2427,120,5,7,12,41.7%,1h
31456,3,Lee,2427,136,4,3,7,57.1%,60m
31456,3,chatoroller,2427,90,4,8,12,33.3%,53m
31456,3,MauKC,2427,119,3,5,8,37.5%,1h
31456,2,SARPHAN,2427,0,3,7,10,30.0%,44m
31456,2,jacob,2427,107,3,7,10,30.0%,53m
31456,3,[G3TOUT]FARMERBOY,2427,58,2,4,6,33.3%,31m
31456,1,[QcK]therhon,2427,42,2,4,6,33.3%,55m
31456,3,splinter,2427,95,2,4,6,33.3%,45m
31456,1,[Preran]guachimiri,2427,141,2,6,8,25.0%,38m
31456,2,[xXGDXx]bruno,2427,0,1,0,1,100.0%,3h
31456,3,Hanscastorp,2427,0,1,1,2,50.0%,3h
31456,3,MrBossPimp,2427,30,1,3,4,25.0%,16m
31456,3,SNJTobirama,2427,0,1,3,4,25.0%,1h
31456,3,TNVKTOD,2427,0,1,4,5,20.0%,1h
31456,3,[HCFSC]Badge,2427,0,0,1,1,0.0%,3h
31456,3,Yiseba,2427,0,0,2,2,0.0%,11m
31497,3,Durant,2426,1356,391,401,792,49.4%,39m
31497,3,hsoj,2426,1476,235,224,459,51.2%,3h
31497,3,xenon,2426,1424,141,138,279,50.5%,3h
31497,2,Alexzc,2426,1044,136,125,261,52.1%,39m
31497,3,Ender,2426,1171,111,124,235,47.2%,44m
31497,3,South,2426,1568,95,96,191,49.7%,3h
31497,1,Tapzarf,2426,1095,79,81,160,49.4%,3h
31497,3,[LPOCS]Kaskivano,2426,1269,54,55,109,49.5%,38m
31497,3,EricL,2426,298,32,28,60,53.3%,38m
31497,3,Vientofrio,2426,327,21,20,41,51.2%,1h
31497,1,Grooooooo,2426,549,21,29,50,42.0%,19m
31497,3,StarryNeko,2426,358,16,19,35,45.7%,24m
31497,3,Samsung,2426,400,15,13,28,53.6%,15m
31497,3,[RAINBO]Touchoflove,2426,380,13,8,21,61.9%,11m
31497,1,[OceanT]BLACK,2426,370,11,27,38,28.9%,1h
31497,3,OrkoPolo,2426,81,10,11,21,47.6%,1h
31497,3,FelipeHC,2426,230,9,11,20,45.0%,3h
31497,3,Chungusisyum,2426,189,6,2,8,75.0%,3h
31497,3,Dart,2426,95,4,2,6,66.7%,1h
31497,3,CrAzYdRiVeR,2426,146,4,6,10,40.0%,3h
31497,3,[lulzzz]IIIIIIIIIIII,2426,140,3,3,6,50.0%,26m
31497,3,Pharadox,2426,30,2,0,2,100.0%,1h
31497,3,Baltazar,2426,95,2,3,5,40.0%,19m
31497,2,Ryujiin,2426,62,2,7,9,22.2%,3h
31497,3,Oblik,2426,0,1,0,1,100.0%,1h
31497,3,climber,2426,0,1,0,1,100.0%,24m
31497,3,SUPERMURLOK,2426,0,1,3,4,25.0%,1h
31497,3,vanfenix,2426,0,1,4,5,20.0%,1h
31497,1,Belthazar,2426,0,1,4,5,20.0%,13m
31497,3,[LÞ]RaZeN,2426,0,1,4,5,20.0%,3h
31497,3,Snide,2426,0,1,5,6,16.7%,13m
31497,3,[JQuad]OLeee,2426,0,0,1,1,0.0%,5m
31497,2,Ironhide,2426,0,0,1,1,0.0%,18m
31497,3,Bonjwa,2426,0,0,1,1,0.0%,1h
31497,3,Duffy,2426,0,0,1,1,0.0%,13m
31497,3,SiNine,2426,0,0,1,1,0.0%,23m
31497,3,Roro,2426,0,0,2,2,0.0%,39m
31497,3,aesop,2426,0,0,4,4,0.0%,38m
31535,2,[Nico]lolpo,2425,935,73,70,143,51.0%,35m
31535,3,[FMX]SmoOkeR,2425,646,50,63,113,44.2%,1h
31535,3,PasFromage,2425,692,38,22,60,63.3%,48m
31535,3,Legendstrike,2425,746,34,26,60,56.7%,42m
31535,3,BobsUrUncle,2425,535,21,21,42,50.0%,10m
31535,3,rooster,2425,524,19,20,39,48.7%,3h
31535,1,Ethel,2425,376,13,25,38,34.2%,3h
31535,3,robert,2425,310,11,6,17,64.7%,1h
31535,1,DeadlyAnne,2425,304,11,15,26,42.3%,1h
31535,3,gudynator,2425,269,10,3,13,76.9%,1h
31535,2,yabal,2425,231,8,10,18,44.4%,3h
31535,1,Bicboooi,2425,209,8,11,19,42.1%,48m
31535,3,ONI,2425,111,6,2,8,75.0%,31m
31535,3,Joscellin,2425,228,6,8,14,42.9%,1h
31535,2,Nelo,2425,150,6,12,18,33.3%,1h
31535,3,PHUTRUNG,2425,120,5,4,9,55.6%,3h
31535,2,[fOrEvR]yOungOne,2425,136,5,11,16,31.2%,25m
31535,3,Slag,2425,138,4,11,15,26.7%,32m
31535,2,Stickman,2425,121,3,2,5,60.0%,1h
31535,2,Phil,2425,0,3,3,6,50.0%,1h
31535,2,IIIIIIIIIIII,2425,30,3,5,8,37.5%,57m
31535,1,[SC2IDN]yuzzuurruu,2425,48,2,0,2,100.0%,3h
31535,3,nullptr,2425,118,2,1,3,66.7%,1h
31535,3,MrShackly,2425,60,2,5,7,28.6%,20m
31535,3,hount,2425,0,2,5,7,28.6%,1h
31535,3,DocROCK,2425,0,1,0,1,100.0%,26m
31535,3,[BENH]Knight,2425,0,1,0,1,100.0%,38m
31535,3,XuShu,2425,96,1,1,2,50.0%,1h
31535,3,Loeei,2425,30,1,2,3,33.3%,3h
31535,3,DoctorIguazo,2425,0,0,1,1,0.0%,1h
31535,3,InsaneThots,2425,0,0,1,1,0.0%,1h
31535,3,[Clan5]BBiggs,2425,0,0,1,1,0.0%,1h
31535,3,TheDeus,2425,0,0,2,2,0.0%,31m
31535,2,luisito,2425,0,0,2,2,0.0%,21m
31569,3,GlenMoray,2424,1345,178,163,341,52.2%,3h
31569,3,Ahmyface,2424,1592,90,88,178,50.6%,30m
31569,3,daredbod,2424,1490,79,78,157,50.3%,13m
31569,2,lllllllllll,2424,1098,66,64,130,50.8%,34m
31569,3,AlexTheMage,2424,1116,51,45,96,53.1%,1h
31569,2,Blackened,2424,863,51,54,105,48.6%,3h
31569,1,DownyFlames,2424,1160,47,46,93,50.5%,38m
31569,3,NearDGeas,2424,743,32,23,55,58.2%,3h
31569,2,ChoGath,2424,294,27,23,50,54.0%,29m
31569,3,BBQmaxiXXL,2424,656,26,22,48,54.2%,30m
31569,3,DrPootytang,2424,444,23,2,25,92.0%,33m
31569,3,reteP,2424,349,22,10,32,68.8%,1h
31569,2,[C49]Sleepless,2424,469,21,18,39,53.8%,3h
31569,3,Sinalysr,2424,371,18,10,28,64.3%,45m
31569,3,CapDajed,2424,324,16,14,30,53.3%,3h
31569,3,[69rs]Infintium,2424,369,13,18,31,41.9%,8m
31569,3,Skepticism,2424,254,10,7,17,58.8%,53m
31569,3,Potato,2424,234,8,11,19,42.1%,26m
31569,3,Inticito,2424,58,5,6,11,45.5%,3h
31569,3,JOE,2424,145,4,3,7,57.1%,1h
31569,2,PeterelPanda,2424,159,4,5,9,44.4%,3h
31569,3,[XpKAc]dany,2424,88,4,6,10,40.0%,3h
31569,3,[PTZop]RmplBldSkn,2424,144,3,2,5,60.0%,48m
31569,2,Ouzo,2424,30,3,5,8,37.5%,3h
31569,1,Shadowentity,2424,0,3,5,8,37.5%,34m
31569,3,[1FAG1]TheMuscle,2424,125,3,6,9,33.3%,3h
31569,2,[N1sIC]chennnnnny,2424,46,3,8,11,27.3%,1h
31569,1,Zerg,2424,48,2,5,7,28.6%,42m
31569,2,[HD7K]MajorTom,2424,118,2,7,9,22.2%,25m
31569,2,[GRNSKN]Ironic,2424,88,2,7,9,22.2%,1h
31569,3,SniperElGato,2424,0,1,0,1,100.0%,31m
31569,3,Kolotov,2424,30,1,2,3,33.3%,1h
31569,3,RobertChew,2424,30,1,3,4,25.0%,20m
31569,3,[IsThe]HacobSu,2424,96,1,4,5,20.0%,1h
31569,1,[LANUS]ComanderDain,2424,0,1,4,5,20.0%,18m
31569,3,[sk3tch]RIMKICA,2424,0,1,5,6,16.7%,3h
31569,3,Jland,2424,0,0,1,1,0.0%,3h
31569,3,IImasterII,2424,0,0,2,2,0.0%,4m
31569,3,RoyalTwistt,2424,0,0,4,4,0.0%,1h
31608,2,Regency,2423,1322,190,193,383,49.6%,3h
31608,2,Unnovation,2423,1491,74,69,143,51.7%,1h
31608,3,Jpez,2423,1338,53,49,102,52.0%,33m
31608,2,Weesan,2423,1120,47,45,92,51.1%,29m
31608,3,Ryder,2423,1150,43,45,88,48.9%,1h
31608,3,[HDU]Punani,2423,934,35,39,74,47.3%,59m
31608,1,cimpercee,2423,841,32,39,71,45.1%,1h
31608,3,[AIURxT]Jack,2423,607,31,19,50,62.0%,56m
31608,2,eyscold,2423,811,31,33,64,48.4%,3h
31608,2,Diego,2423,554,20,25,45,44.4%,1h
31608,3,Clarus,2423,512,19,15,34,55.9%,16m
31608,1,CPTSmAcKaHo,2423,601,19,29,48,39.6%,41m
31608,2,Jdawg,2423,506,18,19,37,48.6%,1h
31608,3,JethroTroll,2423,467,16,20,36,44.4%,54m
31608,3,hadepsi,2423,350,15,12,27,55.6%,1h
31608,2,[0LD3R]HopHing,2423,426,15,17,32,46.9%,3h
31608,3,TriadRipper,2423,306,10,28,38,26.3%,24m
31608,3,[OGblue]MCSETONV,2423,142,6,6,12,50.0%,16m
31608,3,Bertoe,2423,122,5,6,11,45.5%,3h
31608,2,Max,2423,200,5,7,12,41.7%,1h
31608,3,[copain]AnisElJazair,2423,97,4,2,6,66.7%,1h
31608,3,franco,2423,163,4,7,11,36.4%,3h
31608,2,xXCryoXx,2423,94,3,7,10,30.0%,3h
31608,1,[QuAzar]Tibearius,2423,60,3,10,13,23.1%,55m
31608,2,NurSpielen,2423,42,1,1,2,50.0%,9m
31608,2,paku,2423,0,1,2,3,33.3%,3h
31608,3,HonstaMonsta,2423,0,1,4,5,20.0%,3h
31608,3,RebrO,2423,0,1,4,5,20.0%,13m
31608,1,Kirashnikova,2423,0,1,4,5,20.0%,5m
31608,2,[VINGAD]MightOak,2423,0,1,6,7,14.3%,34m
31608,3,[Apug]Rockassist,2423,0,0,1,1,0.0%,1h
31608,3,Pain,2423,0,0,1,1,0.0%,1h
31608,1,turbolight,2423,0,0,1,1,0.0%,56m
31608,3,Tranovious,2423,0,0,4,4,0.0%,59m
31642,3,sergiobredor,2422,1620,151,152,303,49.8%,11m
31642,2,DrlSgtSykes,2422,1538,141,133,274,51.5%,3h
31642,3,Rashabh,2422,1578,131,139,270,48.5%,3h
31642,2,Supremeum,2422,1448,114,108,222,51.4%,6m
31642,1,Amadeus,2422,1636,106,112,218,48.6%,3h
31642,2,[Flexy]Hellothere,2422,1084,51,41,92,55.4%,45m
31642,2,Sea,2422,1097,49,40,89,55.1%,11m
31642,2,[GOPERÚ]MACHERFL,2422,868,47,47,94,50.0%,1h
31642,3,Renegade,2422,872,33,35,68,48.5%,26m
31642,3,SchappO,2422,572,21,24,45,46.7%,3h
31642,3,Galveston,2422,390,17,5,22,77.3%,60m
31642,3,JohnGalt,2422,448,17,23,40,42.5%,1h
31642,3,PlanetXpress,2422,414,16,18,34,47.1%,1h
31642,3,ArcMufasa,2422,368,14,15,29,48.3%,1h
31642,3,CiroGames,2422,222,9,7,16,56.2%,32m
31642,3,[SCIIpy]Vash,2422,200,7,2,9,77.8%,3h
31642,1,BlkMrRogers,2422,187,4,4,8,50.0%,3h
31642,3,[Epokhé]Fachindor,2422,151,4,5,9,44.4%,51m
31642,1,Supernova,2422,145,3,3,6,50.0%,29m
31642,3,[BlTEL]Locura,2422,117,2,1,3,66.7%,3h
31642,3,ArkhamKnight,2422,34,2,1,3,66.7%,42m
31642,3,ANORMAL,2422,30,2,5,7,28.6%,30m
31642,3,NorbleDorg,2422,30,2,5,7,28.6%,24m
31642,3,AlphaWhiskey,2422,0,1,0,1,100.0%,53m
31642,3,Alejandro,2422,30,1,1,2,50.0%,45m
31642,3,Zapwai,2422,0,1,1,2,50.0%,1h
31642,3,gonchy,2422,0,1,1,2,50.0%,3h
31642,3,[TPGGXD]OMEGA,2422,30,1,1,2,50.0%,1h
31642,3,Nerón,2422,0,1,4,5,20.0%,21m
31642,3,[stkovg]Knoa,2422,30,1,5,6,16.7%,42m
31642,2,NinjaMonster,2422,30,1,9,10,10.0%,18m
31642,3,LonePorpoise,2422,0,0,1,1,0.0%,1h
31642,3,[xXxVxX]Gnix,2422,0,0,1,1,0.0%,3m
31642,1,kimJONGiL,2422,0,0,1,1,0.0%,1h
31642,3,BokalLotku,2422,0,0,1,1,0.0%,10m
31642,3,Swiftshift,2422,0,0,2,2,0.0%,26m
31678,1,Xenon,2421,1384,254,262,516,49.2%,5m
31678,2,ptr,2421,1307,58,63,121,47.9%,30m
31678,3,NomDunePipe,2421,997,39,38,77,50.6%,1h
31678,3,[SkAL]Manafiend,2421,183,29,20,49,59.2%,3h
31678,3,[DGCIM]torto,2421,632,25,25,50,50.0%,38m
31678,3,ELFornicador,2421,579,22,18,40,55.0%,3h
31678,2,[NM8]Maximilian,2421,492,19,19,38,50.0%,30m
31678,2,[C4NN0N]JeffBob,2421,324,12,15,27,44.4%,40m
31678,3,[Vtta]tustaca,2421,308,11,8,19,57.9%,3h
31678,1,DEREC,2421,188,7,18,25,28.0%,3h
31678,3,StealAway,2421,187,6,7,13,46.2%,19m
31678,3,elfaster,2421,162,5,1,6,83.3%,1h
31678,3,ZionZealot,2421,156,5,3,8,62.5%,38m
31678,3,IIlIlllI,2421,0,2,3,5,40.0%,1h
31678,3,Esau,2421,60,2,4,6,33.3%,3h
31678,1,[OBRUO]Stix,2421,0,1,0,1,100.0%,1h
31678,2,[Au4evr]Theophraste,2421,0,1,0,1,100.0%,3h
31678,2,DeathKing,2421,0,1,2,3,33.3%,3h
31678,1,JYPSY,2421,0,1,3,4,25.0%,8m
31678,3,[JUGOS]xplotacara,2421,0,0,1,1,0.0%,4m
31698,1,Assasin,2420,1488,465,472,937,49.6%,1h
31698,3,[Wat3rs]TheEnforcer,2420,1622,331,319,650,50.9%,3h
31698,3,Todd,2420,1268,117,112,229,51.1%,29m
31698,2,Honorableone,2420,725,85,81,166,51.2%,3h
31698,2,StepCV,2420,1463,85,87,172,49.4%,5m
31698,3,Mithrandir,2420,1539,75,68,143,52.4%,5m
31698,1,Guilherme,2420,1038,72,58,130,55.4%,3h
31698,2,SmRTneZ,2420,1374,65,59,124,52.4%,53m
31698,3,MJB,2420,730,51,48,99,51.5%,5m
31698,3,Mostat,2420,832,44,32,76,57.9%,1h
31698,3,Dilbert,2420,522,18,16,34,52.9%,29m
31698,3,konata,2420,438,15,16,31,48.4%,39m
31698,3,Lich,2420,270,11,8,19,57.9%,46m
31698,3,MAI,2420,288,11,13,24,45.8%,1h
31698,3,ThBstFSxy,2420,319,10,7,17,58.8%,19m
31698,3,[brehhh]Skysize,2420,320,10,11,21,47.6%,46m
31698,2,Superman,2420,272,10,11,21,47.6%,3h
31698,2,Lozz,2420,294,10,17,27,37.0%,3h
31698,3,DanyBoys,2420,226,8,3,11,72.7%,3h
31698,3,[BCBZ]NoPainNoGain,2420,178,7,7,14,50.0%,20m
31698,2,giyeterr,2420,147,7,9,16,43.8%,1h
31698,3,Shakira,2420,186,7,15,22,31.8%,38m
31698,3,KEONS,2420,120,5,4,9,55.6%,33m
31698,3,Soodlenoup,2420,94,5,5,10,50.0%,3h
31698,3,[TINKY]iguana,2420,90,4,5,9,44.4%,1h
31698,1,[Macac0]David,2420,186,4,7,11,36.4%,1h
31698,3,Rhun,2420,96,3,3,6,50.0%,3h
31698,3,Chiz,2420,119,3,5,8,37.5%,16m
31698,3,[EpicG]ElPatrick,2420,60,3,7,10,30.0%,1h
31698,3,Marsudien,2420,0,2,3,5,40.0%,53m
31698,2,Rookie,2420,62,2,7,9,22.2%,3h
31698,1,RushMyBooty,2420,0,1,0,1,100.0%,3h
31698,3,demoledor,2420,30,1,3,4,25.0%,13m
31698,1,DEEV,2420,0,1,4,5,20.0%,1h
31698,2,[Shang]Penamat,2420,0,1,5,6,16.7%,1h
31698,3,Kiefuh,2420,0,0,2,2,0.0%,1h
31698,3,Moderntotem,2420,0,0,3,3,0.0%,33m
31698,2,[BoRnGo]DarthJulius,2420,0,0,7,7,0.0%,1h
31736,1,[JRT]MaxMax,2419,1596,404,400,804,50.2%,1h
31736,2,lolomg,2419,1612,235,241,476,49.4%,1h
31736,2,Warrior,2419,1655,159,177,336,47.3%,55m
31736,3,Hicks,2419,1570,78,67,145,53.8%,1h
31736,2,Gunslinger,2419,996,65,58,123,52.8%,3h
31736,3,[812]RedREAPER,2419,839,33,29,62,53.2%,15m
31736,2,BluePanda,2419,236,24,37,61,39.3%,25m
31736,3,Eatfresh,2419,325,23,25,48,47.9%,33m
31736,3,Sam,2419,499,17,16,33,51.5%,3h
31736,3,TheNoob,2419,432,16,18,34,47.1%,1h
31736,3,ofutilit,2419,311,12,9,21,57.1%,1h
31736,3,Zerocross,2419,366,12,18,30,40.0%,3h
31736,2,echoprime,2419,165,7,10,17,41.2%,45m
31736,2,Euphoria,2419,192,7,12,19,36.8%,1h
31736,3,Gavino,2419,116,5,3,8,62.5%,48m
31736,3,JoeBlow,2419,171,4,2,6,66.7%,1h
31736,3,Mirkitox,2419,163,4,7,11,36.4%,4m
31736,3,checa,2419,64,3,3,6,50.0%,13m
31736,3,[GuST]AmirAlAsad,2419,60,2,4,6,33.3%,32m
31736,3,skyclad,2419,0,1,0,1,100.0%,1h
31736,3,sparky,2419,0,1,1,2,50.0%,27m
31736,3,SignumMortis,2419,0,1,2,3,33.3%,3h
31736,3,eric,2419,0,1,6,7,14.3%,23m
31736,3,RacirBook,2419,0,0,1,1,0.0%,3h
31736,3,OzBrYaNzO,2419,0,0,1,1,0.0%,8m
31761,2,CHINOJACKSON,2418,1482,140,139,279,50.2%,3h
31761,3,Creep,2418,1537,88,89,177,49.7%,1h
31761,3,Limnt,2418,1603,75,74,149,50.3%,1h
31761,2,tototo,2418,1137,50,55,105,47.6%,3h
31761,3,mehmehmeh,2418,1097,48,42,90,53.3%,13m
31761,2,[LOHs]AutobioTech,2418,1096,39,45,84,46.4%,3h
31761,3,iDareBear,2418,803,35,35,70,50.0%,13m
31761,2,Bovis,2418,859,34,39,73,46.6%,30m
31761,3,HowardRoark,2418,632,24,20,44,54.5%,8m
31761,3,Joe,2418,473,22,17,39,56.4%,45m
31761,3,BannedSCV,2418,440,18,13,31,58.1%,1h
31761,3,LilacDrive,2418,274,16,9,25,64.0%,3h
31761,3,[cluez]Cole,2418,452,16,16,32,50.0%,53m
31761,2,[TAPERS]vonmanstein,2418,476,16,22,38,42.1%,3h
31761,3,[Etfine]Drixenol,2418,132,15,5,20,75.0%,33m
31761,3,Amadeus,2418,434,15,13,28,53.6%,1h
31761,3,[InstaF]AtNano,2418,393,15,15,30,50.0%,1h
31761,3,[Erik]ZtingeR,2418,340,14,3,17,82.4%,33m
31761,2,Matadorkiler,2418,398,14,18,32,43.8%,15m
31761,3,fatdodobird,2418,347,12,11,23,52.2%,1h
31761,2,[whalez]Galorn,2418,188,7,8,15,46.7%,18m
31761,3,Mrartanis,2418,190,7,9,16,43.8%,18m
31761,3,HardOffender,2418,168,6,4,10,60.0%,1h
31761,2,ArgieKBatu,2418,176,6,9,15,40.0%,52m
31761,1,mariomani,2418,139,5,9,14,35.7%,1h
31761,2,XxTRONERxX,2418,102,3,3,6,50.0%,3h
31761,2,[IBIAl]wesmantooth,2418,86,3,12,15,20.0%,53m
31761,3,Ruhrak,2418,95,2,4,6,33.3%,53m
31761,2,cicario,2418,0,2,5,7,28.6%,35m
31761,3,Soul,2418,0,1,0,1,100.0%,1h
31761,3,duck,2418,0,1,0,1,100.0%,33m
31761,1,[EGGboi]MaxMagus,2418,0,1,0,1,100.0%,8m
31761,2,Plattsy,2418,93,1,1,2,50.0%,3h
31761,3,Nemix,2418,0,1,4,5,20.0%,3h
31761,2,AJlBatroS,2418,30,1,5,6,16.7%,3h
31761,3,[oompf]Kippy,2418,0,1,7,8,12.5%,9m
31761,3,BRANDO,2418,0,0,1,1,0.0%,1h
31761,3,Roach,2418,0,0,1,1,0.0%,3h
31761,1,Sheyson,2418,0,0,1,1,0.0%,13m
31761,3,[BLZ]TheSchlaack,2418,0,0,4,4,0.0%,1h
31801,2,jakedplayboy,2417,1608,170,175,345,49.3%,3h
31801,3,[Bukaki]BloodFart,2417,1082,145,144,289,50.2%,39m
31801,2,CanuckChuck,2417,1473,72,71,143,50.3%,3h
31801,3,Carlos,2417,1041,45,33,78,57.7%,1h
31801,3,[Lp]ELTERKAN,2417,795,37,29,66,56.1%,3h
31801,3,[OlVera]Edaliz,2417,708,32,22,54,59.3%,3h
31801,3,[ARCA]USuck,2417,735,27,28,55,49.1%,1h
31801,2,verzvs,2417,514,19,21,40,47.5%,25m
31801,3,Gorgon,2417,488,18,13,31,58.1%,32m
31801,3,zTerranova,2417,416,16,10,26,61.5%,1h
31801,1,SoulFly,2417,382,14,15,29,48.3%,3h
31801,3,Inception,2417,338,13,5,18,72.2%,1h
31801,2,[Lp]kesitoXD,2417,232,13,12,25,52.0%,56m
31801,2,MoonighT,2417,156,12,4,16,75.0%,33m
31801,2,Allasius,2417,280,12,17,29,41.4%,3h
31801,3,Aperson,2417,298,10,7,17,58.8%,10m
31801,3,NuttinFivin,2417,170,5,3,8,62.5%,56m
31801,1,SzaboJs,2417,214,5,7,12,41.7%,3h
31801,2,WarLord,2417,0,4,2,6,66.7%,1h
31801,3,Firebatman,2417,60,3,2,5,60.0%,8m
31801,3,[TYFTRS]Duch,2417,143,3,4,7,42.9%,1h
31801,3,[DXPCA]Grraywarrior,2417,96,2,0,2,100.0%,5m
31801,3,Bean,2417,113,2,2,4,50.0%,13m
31801,3,MikeB,2417,0,2,6,8,25.0%,20m
31801,3,Leo,2417,0,1,0,1,100.0%,3h
31801,3,REm,2417,30,1,3,4,25.0%,27m
31801,3,Thunderbolt,2417,0,0,1,1,0.0%,45m
31801,3,[PADA]captainknox,2417,0,0,1,1,0.0%,28m
31801,3,Jeyblock,2417,0,0,3,3,0.0%,19m
31830,3,Tupac,2416,1542,95,97,192,49.5%,1h
31830,3,[tCo9]Smokin,2416,1600,84,87,171,49.1%,5m
31830,1,novo,2416,1211,45,51,96,46.9%,29m
31830,3,[Colrs]Fluffy,2416,948,43,28,71,60.6%,45m
31830,3,IVANMIRROR,2416,828,42,43,85,49.4%,3h
31830,3,Karl,2416,478,25,19,44,56.8%,3h
31830,3,scottpilgrim,2416,228,18,15,33,54.5%,5m
31830,3,[RED3Y3]cheeboweebo,2416,424,16,16,32,50.0%,3h
31830,2,kkren,2416,411,14,24,38,36.8%,3h
31830,3,LikeABox,2416,343,12,8,20,60.0%,1h
31830,3,HEyueru,2416,214,8,8,16,50.0%,1h
31830,3,[XTCES]Skipper,2416,202,7,1,8,87.5%,51m
31830,3,rafajunglesp,2416,193,7,7,14,50.0%,26m
31830,2,Hopper,2416,188,6,10,16,37.5%,8m
31830,3,brainbug,2416,60,3,5,8,37.5%,1h
31830,3,ValensHawke,2416,133,3,7,10,30.0%,23m
31830,1,BearKilLeR,2416,114,2,5,7,28.6%,39m
31830,1,blipityblah,2416,48,2,5,7,28.6%,41m
31830,2,[PTHero]NOObius,2416,0,1,0,1,100.0%,1h
31830,3,KNIGHTDOMING,2416,30,1,3,4,25.0%,1h
31830,3,Gnatrick,2416,0,1,4,5,20.0%,3h
31830,3,sherminatorr,2416,0,0,1,1,0.0%,48m
31830,3,sadada,2416,0,0,1,1,0.0%,48m
31830,1,EnderJSC,2416,0,0,3,3,0.0%,1h
31854,2,Chacal,2415,1350,164,157,321,51.1%,8m
31854,3,GhostDemon,2415,1563,108,102,210,51.4%,47m
31854,3,MAEM,2415,945,85,85,170,50.0%,3h
31854,3,bikedog,2415,1142,78,74,152,51.3%,16m
31854,2,LhasaApso,2415,1075,46,48,94,48.9%,27m
31854,3,TheLastPro,2415,959,45,44,89,50.6%,1h
31854,1,Deku,2415,1234,45,53,98,45.9%,27m
31854,3,[6no6]UnwindCL,2415,677,32,24,56,57.1%,3h
31854,2,[opWeed]Accelerator,2415,782,32,28,60,53.3%,1h
31854,3,[IoO7]EnderT,2415,459,27,27,54,50.0%,28m
31854,3,CoolBreeze,2415,511,20,17,37,54.1%,16m
31854,1,NeXTLoop,2415,550,17,29,46,37.0%,3h
31854,3,cold,2415,195,13,15,28,46.4%,38m
31854,2,Goldman,2415,251,12,18,30,40.0%,39m
31854,1,Hoss,2415,144,11,12,23,47.8%,3h
31854,1,LakersPanda,2415,255,8,10,18,44.4%,3h
31854,3,supernaught,2415,198,6,9,15,40.0%,3h
31854,2,Executor,2415,155,5,6,11,45.5%,1h
31854,3,CaptainCraig,2415,92,4,6,10,40.0%,1h
31854,3,sealius,2415,0,3,2,5,60.0%,1h
31854,3,[Haus]AloNe,2415,86,3,14,17,17.6%,4m
31854,3,bmamba,2415,30,2,2,4,50.0%,8m
31854,3,Tokyo,2415,0,2,4,6,33.3%,3h
31854,3,julex,2415,0,2,5,7,28.6%,1h
31854,3,pls,2415,60,2,6,8,25.0%,1h
31854,3,Miguelteck,2415,72,2,8,10,20.0%,60m
31854,1,abril,2415,0,1,3,4,25.0%,3h
31854,2,Ashleypitt,2415,92,1,3,4,25.0%,45m
31854,2,Ultranaut,2415,0,1,4,5,20.0%,18m
31854,3,[LLSC2]Rubixdoed,2415,0,1,4,5,20.0%,1h
31854,1,Kaleidoscope,2415,0,1,4,5,20.0%,3h
31854,1,eshmesh,2415,0,1,4,5,20.0%,3h
31854,3,TCC,2415,0,1,4,5,20.0%,1h
31854,1,[SBlock]UwU,2415,0,0,1,1,0.0%,3h
31854,3,vTSkillz,2415,0,0,1,1,0.0%,39m
31854,1,WXmaster,2415,0,0,2,2,0.0%,1h
31890,1,[PiN0YS]Maximus,2414,1172,216,223,439,49.2%,3h
31890,3,BigDo,2414,1431,97,85,182,53.3%,49m
31890,3,WescraFT,2414,1329,69,61,130,53.1%,39m
31890,3,[JUGOS2]FRANK,2414,1276,67,62,129,51.9%,48m
31890,3,Rochaz,2414,1047,45,45,90,50.0%,53m
31890,3,KillerClown,2414,1066,41,43,84,48.8%,3h
31890,1,JSRMario,2414,1076,40,50,90,44.4%,1h
31890,3,[Kymer]Kryptic,2414,783,35,23,58,60.3%,29m
31890,3,BigDumpsLOL,2414,927,34,29,63,54.0%,1h
31890,2,Maxemus,2414,644,22,34,56,39.3%,1h
31890,1,Nanohck,2414,513,17,24,41,41.5%,1h
31890,3,PaulDK,2414,363,14,9,23,60.9%,26m
31890,2,Johnathan,2414,253,8,10,18,44.4%,3h
31890,3,RagnaroK,2414,221,7,4,11,63.6%,3h
31890,3,MoMoney,2414,159,7,7,14,50.0%,38m
31890,2,[TMPx]Ragnapong,2414,174,7,9,16,43.8%,1h
31890,3,Morgulspen,2414,198,6,5,11,54.5%,1h
31890,3,[PTHero]Gaddict,2414,197,6,7,13,46.2%,3h
31890,3,[SoAsc]xplodngKeys,2414,150,5,9,14,35.7%,53m
31890,3,Egoras,2414,143,4,1,5,80.0%,3h
31890,1,[Kaiba]BenAffleck,2414,144,4,4,8,50.0%,1h
31890,3,josemetaTTT,2414,58,3,6,9,33.3%,1h
31890,1,ElChapo,2414,0,2,2,4,50.0%,5m
31890,2,Darrou,2414,0,2,6,8,25.0%,33m
31890,3,nicolas,2414,0,1,1,2,50.0%,41m
31890,3,Broccoli,2414,96,1,1,2,50.0%,1h
31890,3,Zeroghost,2414,0,0,1,1,0.0%,60m
31890,3,McMeager,2414,0,0,1,1,0.0%,30m
31890,3,Karltomwaffe,2414,0,0,1,1,0.0%,1h
31919,3,Jaywood,2413,1377,113,110,223,50.7%,26m
31919,2,[PRO1]Drakon,2413,886,99,90,189,52.4%,1h
31919,3,MrTlatoani,2413,1321,91,81,172,52.9%,13m
31919,3,Masterwolf,2413,1537,83,77,160,51.9%,16m
31919,2,absolutely,2413,1460,74,69,143,51.7%,34m
31919,3,DeathPasta,2413,1428,53,50,103,51.5%,1h
31919,2,[soward]MrBones,2413,1008,46,37,83,55.4%,28m
31919,3,Heresy,2413,265,34,21,55,61.8%,3h
31919,3,bigbrothers,2413,726,29,28,57,50.9%,32m
31919,3,Dektol,2413,906,29,49,78,37.2%,5m
31919,3,illmatic,2413,747,28,32,60,46.7%,8m
31919,2,Ronaldo,2413,447,26,21,47,55.3%,3h
31919,3,[gjbdj]oskr,2413,545,24,16,40,60.0%,1h
31919,2,[GnR]Hawkmoon,2413,462,19,29,48,39.6%,1h
31919,3,xcvxc,2413,289,14,14,28,50.0%,53m
31919,2,HeavyMetal,2413,404,14,20,34,41.2%,3h
31919,1,[WinD]Gis,2413,306,13,17,30,43.3%,1h
31919,3,TyRay,2413,208,11,7,18,61.1%,1h
31919,3,ZigZak,2413,205,7,3,10,70.0%,46m
31919,3,[NVYTE]SmokingShot,2413,215,7,4,11,63.6%,26m
31919,3,Batticus,2413,138,7,5,12,58.3%,1h
31919,3,[HmlsMx]Harmlesseddy,2413,183,6,1,7,85.7%,1h
31919,3,[Pervz]Kevin,2413,162,6,7,13,46.2%,53m
31919,3,[8kPLUS]CrackLing,2413,164,5,2,7,71.4%,10m
31919,3,alvardud,2413,174,5,8,13,38.5%,3h
31919,3,[FABFOR]Darkfire,2413,152,4,3,7,57.1%,13m
31919,3,shacuras,2413,170,4,3,7,57.1%,1h
31919,2,MrIguana,2413,60,4,7,11,36.4%,41m
31919,1,gaesve,2413,118,4,21,25,16.0%,1h
31919,3,BreezyBadger,2413,90,3,3,6,50.0%,1h
31919,1,[4Proft]DaddyProphit,2413,48,3,4,7,42.9%,1h
31919,3,Sizzlee,2413,30,3,4,7,42.9%,1h
31919,3,SurPriseMDF,2413,119,3,5,8,37.5%,15m
31919,2,MichaOnYuPrn,2413,112,3,6,9,33.3%,1h
31919,3,Cupofpie,2413,30,2,1,3,66.7%,1h
31919,3,RenAir,2413,116,2,1,3,66.7%,8m
31919,1,Sloth,2413,0,2,3,5,40.0%,3h
31919,2,Dreadfight,2413,0,2,4,6,33.3%,53m
31919,2,SkyTyman,2413,0,1,0,1,100.0%,3h
31919,2,gilderjajaxd,2413,0,1,1,2,50.0%,3h
31919,2,RedBandit,2413,0,1,3,4,25.0%,4m
31919,3,mikedabike,2413,0,1,4,5,20.0%,45m
31919,1,Tersy,2413,0,1,4,5,20.0%,41m
31919,3,gNineTeen,2413,0,0,1,1,0.0%,3h
31919,1,[MCOF]Maurizion,2413,0,0,1,1,0.0%,41m
31919,3,RINGofFIRE,2413,0,0,2,2,0.0%,1h
31919,3,Khayen,2413,0,0,2,2,0.0%,3h
31919,1,Jamesv,2413,0,0,2,2,0.0%,13m
31919,1,Mortisant,2413,0,0,6,6,0.0%,3m
31968,2,TerranItUp,2412,868,205,197,402,51.0%,3h
31968,2,[KIRIOS]ARTIMUL,2412,1144,161,162,323,49.8%,43m
31968,3,perezningle,2412,960,150,140,290,51.7%,1h
31968,1,EdgarJosh,2412,1436,94,87,181,51.9%,6m
31968,3,curupira,2412,906,82,77,159,51.6%,28m
31968,3,PIKA,2412,1277,66,61,127,52.0%,1h
31968,3,LatinChile,2412,1394,65,52,117,55.6%,3h
31968,3,[DRGNS]PeruvnSwarm,2412,1004,38,38,76,50.0%,19m
31968,2,Fortress,2412,602,32,30,62,51.6%,1h
31968,3,wubwub,2412,629,29,18,47,61.7%,19m
31968,3,Overmind,2412,481,28,0,28,100.0%,16m
31968,1,Nice,2412,516,15,32,47,31.9%,18m
31968,2,JALAPEÑO,2412,223,8,9,17,47.1%,52m
31968,2,[CLVLD]Wormage,2412,245,8,11,19,42.1%,52m
31968,3,UHCHU,2412,246,7,7,14,50.0%,1h
31968,3,SaitoRijikou,2412,200,6,4,10,60.0%,43m
31968,3,LUCHO,2412,151,5,3,8,62.5%,1h
31968,3,ooZMRoo,2412,130,4,4,8,50.0%,8m
31968,3,Seth,2412,128,4,6,10,40.0%,3h
31968,1,CamachoVaca,2412,96,4,14,18,22.2%,3h
31968,3,BOBOBOBOBOBO,2412,118,3,0,3,100.0%,1h
31968,3,DrunkDwarf,2412,66,2,3,5,40.0%,60m
31968,3,juampi,2412,95,2,4,6,33.3%,3h
31968,3,[REALG4]Tombie,2412,68,2,6,8,25.0%,41m
31968,3,[TXOP]Aquox,2412,0,1,0,1,100.0%,3h
31968,3,Charlsdicken,2412,0,1,0,1,100.0%,48m
31968,3,wolf,2412,97,1,1,2,50.0%,1h
31968,3,Shimdidly,2412,94,1,1,2,50.0%,1h
31968,3,Bekom,2412,0,1,1,2,50.0%,53m
31968,3,SwarmsofZerg,2412,95,1,1,2,50.0%,3h
31968,3,[GRUMEC]Kratos,2412,30,1,2,3,33.3%,56m
31968,3,[Zambo]Orcrist,2412,97,1,2,3,33.3%,1h
31968,3,jimraynor,2412,0,1,4,5,20.0%,3h
31968,3,Greg,2412,0,0,1,1,0.0%,1h
31968,1,Mathword,2412,0,0,1,1,0.0%,3h
31968,3,[z0rg]kernylicious,2412,0,0,1,1,0.0%,1h
31968,3,Vacuaro,2412,0,0,1,1,0.0%,3h
31968,3,[iPunK]Vancey,2412,0,0,5,5,0.0%,3h
32006,3,[JySC]Chumbeque,2411,1586,137,127,264,51.9%,1h
32006,3,Adog,2411,834,136,114,250,54.4%,1h
32006,2,[Pig2]Kybrit,2411,1520,118,145,263,44.9%,12m
32006,3,ElGris,2411,1171,80,70,150,53.3%,51m
32006,3,[hundem]Laito,2411,1312,61,46,107,57.0%,3h
32006,2,danid,2411,1259,60,55,115,52.2%,3h
32006,3,clarejor,2411,658,46,37,83,55.4%,3h
32006,2,[MiSi]ChopStix,2411,532,25,28,53,47.2%,12m
32006,3,Tebanv,2411,570,21,18,39,53.8%,4m
32006,2,[Khalta]RaynorHere,2411,540,21,23,44,47.7%,57m
32006,1,ROGUEKILLER,2411,614,19,33,52,36.5%,53m
32006,2,LobsterGods,2411,422,18,24,42,42.9%,27m
32006,2,Alex,2411,492,16,24,40,40.0%,45m
32006,3,Heisenberg,2411,383,15,14,29,51.7%,3h
32006,3,[urdone]haxor,2411,159,14,11,25,56.0%,24m
32006,3,Grypus,2411,272,11,8,19,57.9%,1h
32006,2,[HØST]Krovak,2411,252,11,15,26,42.3%,3h
32006,1,[DarkAG]Duffy,2411,294,10,16,26,38.5%,33m
32006,1,SCV,2411,175,6,12,18,33.3%,1h
32006,2,Skycaptain,2411,88,5,9,14,35.7%,1h
32006,2,Leefamily,2411,30,4,4,8,50.0%,53m
32006,3,riskman,2411,177,4,5,9,44.4%,1h
32006,3,[TTSP]UrLastSight,2411,114,4,5,9,44.4%,1h
32006,2,weber,2411,88,4,9,13,30.8%,31m
32006,3,ranger,2411,121,3,4,7,42.9%,1h
32006,3,Mandrake,2411,121,3,6,9,33.3%,1h
32006,3,ccarter,2411,0,1,0,1,100.0%,1h
32006,1,Hiperion,2411,0,1,0,1,100.0%,3m
32006,3,[Yeite]Youya,2411,30,1,2,3,33.3%,1h
32006,3,Rubanious,2411,97,1,4,5,20.0%,1h
32006,1,Constantine,2411,0,1,4,5,20.0%,13m
32006,2,MPA,2411,42,1,6,7,14.3%,3h
32006,3,DrDomination,2411,0,0,1,1,0.0%,1h
32006,3,[sk3tch]Bumblebee,2411,0,0,1,1,0.0%,53m
32006,3,Chuckkyy,2411,0,0,1,1,0.0%,20m
32006,3,Krysner,2411,0,0,1,1,0.0%,21m
32006,3,Arcturus,2411,0,0,2,2,0.0%,46m
32006,1,[33V33]cookiemoney,2411,0,0,5,5,0.0%,1h
32044,2,Caputo,2410,1460,237,234,471,50.3%,1h
32044,1,SnapKing,2410,1360,150,146,296,50.7%,60m
32044,2,Jahrobokahn,2410,1488,124,134,258,48.1%,57m
32044,3,Ontologist,2410,1402,123,117,240,51.2%,1h
32044,3,Ghost,2410,1341,76,60,136,55.9%,5m
32044,3,[UFC]Aloe,2410,1581,76,70,146,52.1%,3h
32044,3,Isaac,2410,659,73,60,133,54.9%,1h
32044,2,Marvin,2410,837,60,69,129,46.5%,1h
32044,3,Modenesi,2410,1356,53,54,107,49.5%,1h
32044,2,Uneasywheat,2410,703,43,43,86,50.0%,1h
32044,3,[YomYom]ButterNugget,2410,870,37,25,62,59.7%,45m
32044,2,Kushani,2410,274,25,26,51,49.0%,40m
32044,3,CaneToad,2410,460,17,12,29,58.6%,3h
32044,1,bazz,2410,479,16,22,38,42.1%,3h
32044,3,[RNDMX]DAMIANCA,2410,421,15,18,33,45.5%,1h
32044,2,calculon,2410,416,15,21,36,41.7%,36m
32044,2,Jason,2410,294,14,15,29,48.3%,30m
32044,1,ThePeasantor,2410,233,12,17,29,41.4%,3h
32044,3,Chrisson,2410,271,10,9,19,52.6%,30m
32044,3,Crusher,2410,228,9,8,17,52.9%,4m
32044,3,Alpha,2410,219,8,10,18,44.4%,1h
32044,2,billyb,2410,260,8,15,23,34.8%,1h
32044,2,IIIIIIIIII,2410,183,6,8,14,42.9%,53m
32044,3,[gliz]spycchicken,2410,161,4,2,6,66.7%,15m
32044,1,InNovAtiOn,2410,86,4,11,15,26.7%,1h
32044,3,Balrog,2410,142,3,2,5,60.0%,3h
32044,3,Reggie,2410,0,3,2,5,60.0%,26m
32044,3,OptimusMax,2410,0,3,2,5,60.0%,3h
32044,1,luas,2410,0,3,5,8,37.5%,3h
32044,3,SolidSnake,2410,97,2,2,4,50.0%,1h
32044,3,asd,2410,0,2,3,5,40.0%,3h
32044,1,KylonB,2410,94,2,3,5,40.0%,53m
32044,3,Tyrion,2410,91,2,4,6,33.3%,13m
32044,3,[DRKLRD]Jin,2410,0,1,0,1,100.0%,1h
32044,3,Colin,2410,0,1,0,1,100.0%,3h
32044,3,Tribe,2410,0,1,1,2,50.0%,1h
32044,3,MoRaLeS,2410,0,1,4,5,20.0%,1h
32044,1,bicboi,2410,0,1,4,5,20.0%,3h
32044,1,unbourne,2410,0,1,12,13,7.7%,1h
32044,3,mrpool,2410,0,0,2,2,0.0%,26m
32044,3,kingbob,2410,0,0,4,4,0.0%,43m
32085,3,INVESTEDT,2409,1392,288,296,584,49.3%,39m
32085,3,Yeertha,2409,1243,179,160,339,52.8%,34m
32085,1,WildFree,2409,1550,129,132,261,49.4%,3h
32085,3,[sk3tch]OverFlow,2409,946,92,93,185,49.7%,26m
32085,3,ZeekeTheGeek,2409,1312,86,62,148,58.1%,3h
32085,3,RayzorC,2409,1492,80,74,154,51.9%,3h
32085,3,koolaid,2409,1444,68,62,130,52.3%,1h
32085,3,rldlimon,2409,1336,64,55,119,53.8%,1h
32085,2,Redler,2409,1091,43,45,88,48.9%,3h
32085,2,[SDC12]Cadete,2409,968,34,42,76,44.7%,7m
32085,2,KeyLock,2409,534,24,25,49,49.0%,3h
32085,3,[MGKYOU]Tsukuyomi,2409,633,24,28,52,46.2%,60m
32085,3,Geosus,2409,543,23,25,48,47.9%,45m
32085,3,Licus,2409,356,14,7,21,66.7%,1h
32085,3,JONES,2409,231,9,2,11,81.8%,1h
32085,1,[AbcCo]Alpacatzila,2409,300,9,15,24,37.5%,3h
32085,3,Gravy,2409,192,8,8,16,50.0%,1h
32085,3,[vNAM]picklez,2409,146,4,2,6,66.7%,3h
32085,3,[KHMU]SuperiorAron,2409,30,4,3,7,57.1%,8m
32085,3,[CCA]BlazerUAB,2409,118,4,6,10,40.0%,21m
32085,2,samurai,2409,98,4,9,13,30.8%,57m
32085,3,ABAR,2409,0,1,0,1,100.0%,1h
32085,3,[ExcIgN]LUISANGEL,2409,0,1,4,5,20.0%,17m
32085,1,Hunter,2409,0,1,4,5,20.0%,24m
32109,1,CHESTNUTs,2408,1585,177,172,349,50.7%,1h
32109,3,[PneqNP]caleb,2408,983,106,96,202,52.5%,3h
32109,2,[AUSMAN]Scotticus,2408,1562,92,99,191,48.2%,43m
32109,3,Abaddon,2408,1520,76,69,145,52.4%,60m
32109,3,quiquevega,2408,1124,47,45,92,51.1%,26m
32109,1,GokGok,2408,716,39,35,74,52.7%,15m
32109,3,Absel,2408,893,37,25,62,59.7%,49m
32109,3,PollSed,2408,635,28,23,51,54.9%,1h
32109,3,[ORUS]Simple,2408,624,24,21,45,53.3%,1h
32109,3,DVH,2408,412,15,20,35,42.9%,10m
32109,3,ElBarto,2408,386,14,9,23,60.9%,1h
32109,2,[LOHd]ITFANS,2408,379,13,12,25,52.0%,18m
32109,2,BigFeet,2408,398,13,21,34,38.2%,1h
32109,3,Timbergreens,2408,314,11,15,26,42.3%,56m
32109,3,cabecin,2408,298,10,12,22,45.5%,20m
32109,3,GrimDuke,2408,258,8,5,13,61.5%,1h
32109,3,[RUMB]GoGetter,2408,191,5,4,9,55.6%,1h
32109,2,Hawke,2408,237,5,9,14,35.7%,52m
32109,2,IrishZiggy,2408,100,4,6,10,40.0%,18m
32109,2,[GenF]Wolfie,2408,138,4,9,13,30.8%,28m
32109,2,FaceToucher,2408,145,4,10,14,28.6%,41m
32109,3,[TCHADS]MrGriffo,2408,60,3,2,5,60.0%,1h
32109,1,EliteGhost,2408,132,3,3,6,50.0%,11m
32109,3,Neurotic,2408,0,3,3,6,50.0%,1h
32109,2,Etelios,2408,64,3,9,12,25.0%,1h
32109,3,Groovyguy,2408,117,2,1,3,66.7%,16m
32109,3,Fading,2408,30,2,3,5,40.0%,15m
32109,3,[DSFTWA]Onions,2408,62,2,5,7,28.6%,53m
32109,3,johntitor,2408,95,1,1,2,50.0%,11m
32109,3,sarjeras,2408,30,1,2,3,33.3%,1h
32109,3,[FLOW1]XICOALT,2408,0,1,3,4,25.0%,1h
32109,3,Jaybird,2408,32,1,4,5,20.0%,17m
32109,1,Davilongo,2408,0,1,4,5,20.0%,3h
32109,3,Varyann,2408,0,1,4,5,20.0%,1h
32109,3,Xenios,2408,30,1,5,6,16.7%,51m
32144,3,MZY,2407,998,88,93,181,48.6%,53m
32144,3,Alebeard,2407,1053,47,41,88,53.4%,3h
32144,2,OmegaTuf,2407,734,37,36,73,50.7%,39m
32144,2,Jujus,2407,441,16,24,40,40.0%,12m
32144,2,Zang,2407,231,8,10,18,44.4%,3h
32144,3,Husarski,2407,211,7,3,10,70.0%,1h
32144,3,SkolViking,2407,210,7,11,18,38.9%,1h
32144,3,Tenco,2407,220,6,6,12,50.0%,19m
32144,3,[jkille]josecarmen,2407,153,6,7,13,46.2%,4m
32144,3,handicape,2407,205,6,8,14,42.9%,1h
32144,3,Nacho,2407,173,6,10,16,37.5%,30m
32144,3,RLThunder,2407,133,5,5,10,50.0%,60m
32144,3,ATLAS,2407,150,5,8,13,38.5%,21m
32144,2,ImJuicin,2407,86,4,17,21,19.0%,38m
32144,2,Robin,2407,0,3,8,11,27.3%,26m
32144,3,SukDikIsFun,2407,0,2,3,5,40.0%,3h
32144,1,SerguezNO,2407,0,2,3,5,40.0%,3h
32144,3,[Blood]DeathFrost,2407,0,2,5,7,28.6%,1h
32144,1,ProfessorQQ,2407,0,2,7,9,22.2%,3h
32144,3,Munich,2407,0,1,0,1,100.0%,54m
32144,3,melkweg,2407,0,1,4,5,20.0%,1h
32144,3,VrainHason,2407,0,1,4,5,20.0%,3h
32144,3,[sk3tch]KarlPopper,2407,30,1,5,6,16.7%,33m
32144,3,SuperNinja,2407,0,0,1,1,0.0%,3h
32144,3,pako,2407,0,0,1,1,0.0%,1h
32144,3,Rampage,2407,0,0,1,1,0.0%,1h
32144,3,AndruRock,2407,0,0,3,3,0.0%,1h
32171,3,relokito,2406,1553,122,110,232,52.6%,4m
32171,3,Deuce,2406,1467,119,113,232,51.3%,18m
32171,3,[HOT69]Jamaican,2406,1566,108,113,221,48.9%,60m
32171,3,Smedlon,2406,1186,66,69,135,48.9%,1h
32171,1,Lunkface,2406,1567,56,71,127,44.1%,1h
32171,2,streetmedic,2406,1224,49,50,99,49.5%,7m
32171,3,[THBF]Kawaii,2406,807,35,21,56,62.5%,29m
32171,3,Lag,2406,745,29,34,63,46.0%,10m
32171,1,never,2406,626,20,32,52,38.5%,1h
32171,3,Grumion,2406,435,17,11,28,60.7%,29m
32171,3,RickRossBoss,2406,298,16,16,32,50.0%,3h
32171,3,croctears,2406,396,14,11,25,56.0%,1h
32171,3,GetSome,2406,354,13,19,32,40.6%,24m
32171,3,[CATh]John,2406,301,11,5,16,68.8%,3h
32171,3,[LIPESC]GhostDragon,2406,265,9,6,15,60.0%,1h
32171,3,eldarion,2406,140,4,0,4,100.0%,1h
32171,2,duhmee,2406,133,4,7,11,36.4%,41m
32171,3,awdawd,2406,0,3,2,5,60.0%,1h
32171,3,BunsenHnydew,2406,131,2,3,5,40.0%,1h
32171,3,[NLTN]Vinartar,2406,30,2,4,6,33.3%,1h
32171,3,[CHOOOO]zavh,2406,95,2,4,6,33.3%,8m
32171,3,[SV]Peñate,2406,0,2,5,7,28.6%,3h
32171,2,PlayboiCarti,2406,30,2,6,8,25.0%,24m
32171,3,Zodiac,2406,38,2,6,8,25.0%,23m
32171,2,Gale,2406,0,2,6,8,25.0%,1h
32171,3,axxo,2406,0,1,0,1,100.0%,33m
32171,3,[Mallow]Justin,2406,97,1,4,5,20.0%,27m
32171,1,Aiur,2406,0,0,1,1,0.0%,3h
32199,3,Thomas,2405,1208,308,301,609,50.6%,3h
32199,1,[nobrk]Sheridan,2405,1615,225,230,455,49.5%,37m
32199,3,mancorevenge,2405,923,143,141,284,50.4%,60m
32199,2,Jackstraw,2405,579,76,74,150,50.7%,25m
32199,2,[SpHa]pepocasver,2405,1480,73,75,148,49.3%,3h
32199,1,[ONG]elegido,2405,1606,65,78,143,45.5%,43m
32199,3,criss,2405,1048,56,56,112,50.0%,32m
32199,3,Braden,2405,563,33,30,63,52.4%,60m
32199,3,[LSU]Crusader,2405,795,28,32,60,46.7%,28m
32199,3,Greedy,2405,696,27,21,48,56.2%,1h
32199,3,sad,2405,509,18,16,34,52.9%,24m
32199,3,Koban,2405,398,17,14,31,54.8%,3h
32199,3,[HNPro]Wolfy,2405,334,12,14,26,46.2%,1h
32199,3,[NSTYBZ]matus,2405,267,11,1,12,91.7%,32m
32199,3,SanKeR,2405,288,11,8,19,57.9%,32m
32199,2,Rampage,2405,232,8,11,19,42.1%,3h
32199,2,peryplatypus,2405,217,7,3,10,70.0%,1h
32199,3,[Aethus]BreakerFist,2405,204,7,6,13,53.8%,1h
32199,3,jhasDC,2405,203,6,6,12,50.0%,15m
32199,3,SolarCharge,2405,192,6,7,13,46.2%,4m
32199,3,[TAILED]Noobsprinter,2405,164,5,1,6,83.3%,3h
32199,2,Stef,2405,126,5,11,16,31.2%,3h
32199,3,[LHA]Hydraz,2405,148,4,2,6,66.7%,32m
32199,1,Stonewall,2405,0,4,4,8,50.0%,3h
32199,3,NotsoImba,2405,121,3,0,3,100.0%,33m
32199,3,NaCl,2405,60,3,3,6,50.0%,1h
32199,1,Neuer,2405,48,3,3,6,50.0%,3h
32199,3,eliteboyer,2405,96,3,4,7,42.9%,3h
32199,2,BabyFreddy,2405,92,3,6,9,33.3%,3h
32199,3,ETLWrath,2405,97,2,5,7,28.6%,3h
32199,2,FRabbit,2405,76,2,5,7,28.6%,3h
32199,1,Keav,2405,0,1,2,3,33.3%,3h
32199,3,Pumpkin,2405,0,1,4,5,20.0%,17m
32199,2,[ZOMO]Edufardo,2405,0,1,6,7,14.3%,1h
32199,3,Idontknow,2405,0,0,1,1,0.0%,1h
32199,3,Hideyourcar,2405,0,0,1,1,0.0%,1h
32199,3,[SST]BCUEM,2405,0,0,2,2,0.0%,4m
32236,2,Caikera,2404,873,133,132,265,50.2%,15m
32236,2,Greasy,2404,709,111,93,204,54.4%,3h
32236,3,[clow]jeffestive,2404,1419,89,82,171,52.0%,1h
32236,2,Niro,2404,1245,82,77,159,51.6%,23m
32236,3,Icarus,2404,1222,76,79,155,49.0%,1h
32236,2,[GSP0T]JONNY,2404,1509,69,67,136,50.7%,7m
32236,3,Sunbringer,2404,1162,67,59,126,53.2%,1h
32236,1,oelsheri,2404,1139,59,63,122,48.4%,3h
32236,3,RvltionGuard,2404,870,38,23,61,62.3%,29m
32236,3,[ZTemp]Dufresne,2404,718,32,21,53,60.4%,8m
32236,2,Bleh,2404,800,29,32,61,47.5%,49m
32236,3,UNREAL,2404,491,25,24,49,51.0%,60m
32236,2,MeowMeowKat,2404,587,23,22,45,51.1%,3h
32236,3,Napalmeon,2404,389,23,27,50,46.0%,32m
32236,3,[viwar]Heloderma,2404,447,19,12,31,61.3%,3h
32236,2,[GARBAJ]TugBoat,2404,388,15,25,40,37.5%,55m
32236,3,Perjam,2404,260,10,5,15,66.7%,5m
32236,3,[Titti]BonerJams,2404,236,9,2,11,81.8%,17m
32236,3,[ICSC2]Music,2404,198,6,6,12,50.0%,1h
32236,3,[Fir3s]xtreme,2404,96,5,8,13,38.5%,3h
32236,3,duckwheat,2404,30,4,3,7,57.1%,3h
32236,3,ShadeGhost,2404,146,3,5,8,37.5%,24m
32236,1,Symonomicon,2404,97,3,5,8,37.5%,3h
32236,3,[ecdn]Shaynk,2404,0,2,3,5,40.0%,33m
32236,1,Thejhonee,2404,97,2,4,6,33.3%,4m
32236,3,Rhemmy,2404,0,1,3,4,25.0%,1h
32236,1,Unclejuden,2404,0,1,4,5,20.0%,3h
32236,3,baricool,2404,0,1,7,8,12.5%,56m
32236,3,theonendonly,2404,0,0,2,2,0.0%,3h
32236,3,[BXXT]KaizerNTBR,2404,0,0,4,4,0.0%,19m
32266,3,[z2o]Sandino,2403,1590,177,182,359,49.3%,54m
32266,3,[0425]NEMO,2403,1147,155,147,302,51.3%,1h
32266,2,LeTurkeh,2403,1614,103,105,208,49.5%,1h
32266,3,EasyTrigger,2403,1578,83,89,172,48.3%,39m
32266,3,IUlove,2403,1501,75,79,154,48.7%,32m
32266,2,SeguinINC,2403,703,66,53,119,55.5%,3h
32266,3,SanVyrish,2403,1296,58,47,105,55.2%,13m
32266,2,rudolf,2403,1202,50,56,106,47.2%,1h
32266,2,JordanElFake,2403,1280,48,51,99,48.5%,39m
32266,2,Joeski,2403,821,47,52,99,47.5%,1h
32266,3,Bobbylee,2403,1078,44,39,83,53.0%,1h
32266,2,REVENGE,2403,689,30,31,61,49.2%,1h
32266,3,Radar,2403,468,22,24,46,47.8%,1h
32266,2,Remalaz,2403,390,14,16,30,46.7%,30m
32266,2,Apagon,2403,316,14,20,34,41.2%,3h
32266,3,trashPanda,2403,385,13,19,32,40.6%,3h
32266,3,painkiller,2403,316,11,12,23,47.8%,3h
32266,3,MrPoopman,2403,311,11,13,24,45.8%,3h
32266,3,[TPGGXD]supermancito,2403,336,11,15,26,42.3%,3h
32266,1,KiwiLionNZK,2403,232,9,15,24,37.5%,48m
32266,3,MNCAD,2403,183,6,3,9,66.7%,1h
32266,3,[Macac0]ItZScanZ,2403,180,6,9,15,40.0%,1h
32266,3,CeeJ,2403,145,4,1,5,80.0%,13m
32266,3,Byte,2403,95,4,2,6,66.7%,3h
32266,2,BuggerD,2403,171,4,7,11,36.4%,53m
32266,3,[MMSTAR]Aecio,2403,58,3,3,6,50.0%,47m
32266,3,Honhe,2403,122,3,7,10,30.0%,3h
32266,3,theekilla,2403,97,2,0,2,100.0%,3h
32266,3,DirtyTWillis,2403,118,2,2,4,50.0%,33m
32266,3,[4Vic]AllAmKorean,2403,95,2,5,7,28.6%,29m
32266,1,WopMay,2403,96,2,12,14,14.3%,1h
32266,3,[xTQc]lorghandy,2403,0,1,0,1,100.0%,1h
32266,3,milski,2403,0,1,1,2,50.0%,1h
32266,3,infinity,2403,0,1,1,2,50.0%,13m
32266,3,NIHAOKAILAN,2403,0,1,4,5,20.0%,30m
32266,1,[raener]theswarm,2403,0,1,4,5,20.0%,3h
32266,3,llllllllllll,2403,0,1,4,5,20.0%,1h
32266,3,Biwan,2403,0,1,4,5,20.0%,17m
32266,3,MaikolTKG,2403,0,0,1,1,0.0%,1h
32266,3,SkullConfeti,2403,0,0,2,2,0.0%,46m
32266,1,ANDYBLACK,2403,0,0,6,6,0.0%,23m
32307,3,xam,2402,1559,124,113,237,52.3%,3h
32307,3,azareu,2402,1534,110,104,214,51.4%,28m
32307,2,MESC,2402,1318,88,75,163,54.0%,1h
32307,2,HonestAbe,2402,1022,53,46,99,53.5%,56m
32307,3,Nybs,2402,833,46,47,93,49.5%,1h
32307,3,Dressel,2402,322,38,41,79,48.1%,20m
32307,3,mUte,2402,719,27,28,55,49.1%,3h
32307,3,Shpadoinkle,2402,658,25,27,52,48.1%,1h
32307,3,[LOHd]Bella,2402,444,17,18,35,48.6%,1h
32307,2,dwatt,2402,436,17,23,40,42.5%,7m
32307,3,[RAVVR]Zerglover,2402,232,8,3,11,72.7%,11m
32307,3,icfiyida,2402,150,8,13,21,38.1%,1h
32307,3,Kishkumen,2402,192,6,7,13,46.2%,1h
32307,2,[xGLUEx]MosquitoBird,2402,139,5,4,9,55.6%,1h
32307,3,loveannie,2402,193,5,4,9,55.6%,3h
32307,1,iamzeusass,2402,143,5,10,15,33.3%,59m
32307,2,Boots,2402,92,4,9,13,30.8%,1h
32307,3,[SNICKL]WATERmouth,2402,108,3,0,3,100.0%,1h
32307,1,Dangerfield,2402,0,3,7,10,30.0%,3h
32307,3,ZonateSaturn,2402,0,1,0,1,100.0%,1h
32307,3,Rooster,2402,0,1,0,1,100.0%,32m
32307,3,pumbum,2402,97,1,1,2,50.0%,3h
32307,1,MrPerfect,2402,0,1,4,5,20.0%,4m
32307,1,TearBear,2402,0,1,4,5,20.0%,1h
32307,3,[CHNA1]Kraken,2402,30,1,6,7,14.3%,1h
32307,3,[N2112]Cygnus,2402,0,0,1,1,0.0%,32m
32307,1,[YD2K]MISTERLATE,2402,0,0,4,4,0.0%,1h
32307,1,Fenriir,2402,0,0,5,5,0.0%,3h
32307,2,QtPotato,2402,0,0,5,5,0.0%,54m
32336,3,Karto,2401,1368,161,154,315,51.1%,1h
32336,3,Griffin,2401,1582,107,90,197,54.3%,10m
32336,3,crucc,2401,656,43,38,81,53.1%,1h
32336,2,Novicas,2401,811,39,50,89,43.8%,56m
32336,3,[ELITZ]Situation,2401,821,38,22,60,63.3%,29m
32336,3,SamTheMan,2401,914,37,31,68,54.4%,1h
32336,2,ElTesla,2401,958,36,39,75,48.0%,3h
32336,3,[US]theFuzzyNeck,2401,835,32,33,65,49.2%,1h
32336,3,TheHunter,2401,772,32,34,66,48.5%,3h
32336,2,[AnWVS]Ivan,2401,695,24,31,55,43.6%,8m
32336,3,lachi,2401,620,23,22,45,51.1%,1h
32336,3,Oumuamua,2401,518,21,13,34,61.8%,3h
32336,1,Szczech,2401,620,20,34,54,37.0%,3h
32336,3,Barracks,2401,374,14,9,23,60.9%,1h
32336,3,postpunk,2401,307,12,7,19,63.2%,1h
32336,3,Hoofheartedu,2401,178,7,6,13,53.8%,45m
32336,3,jrpascal,2401,242,7,7,14,50.0%,1h
32336,3,Screamspasm,2401,179,6,8,14,42.9%,3h
32336,3,JoelMiller,2401,148,6,9,15,40.0%,19m
32336,3,entusnalgas,2401,182,5,2,7,71.4%,16m
32336,2,Torukmakto,2401,66,5,6,11,45.5%,54m
32336,3,hunter,2401,151,4,3,7,57.1%,3h
32336,2,PuroFuego,2401,0,4,4,8,50.0%,3h
32336,1,waffen,2401,151,4,5,9,44.4%,59m
32336,3,Bub,2401,147,4,8,12,33.3%,1h
32336,3,Benjy,2401,141,3,1,4,75.0%,1h
32336,1,Fury,2401,0,3,3,6,50.0%,1h
32336,3,KAPIROTO,2401,118,3,5,8,37.5%,1h
32336,3,[SuiX]Hache,2401,96,2,0,2,100.0%,47m
32336,3,CamoKeeper,2401,0,2,3,5,40.0%,48m
32336,3,jojo,2401,0,2,3,5,40.0%,1h
32336,3,GangstaBlu,2401,0,2,5,7,28.6%,20m
32336,2,allhail,2401,88,2,8,10,20.0%,1h
32336,3,GHOST,2401,0,1,0,1,100.0%,1h
32336,2,XxDurielxX,2401,0,1,0,1,100.0%,26m
32336,3,[cuak64]Max,2401,0,1,1,2,50.0%,33m
32336,3,[KnOSh]LazyFrost,2401,0,1,3,4,25.0%,33m
32336,3,whistleblowr,2401,0,0,1,1,0.0%,1h
32336,2,ConfidentMop,2401,0,0,2,2,0.0%,3h
32336,1,[ExcIgN]ShadowDragon,2401,0,0,3,3,0.0%,23m
32336,3,Wyl,2401,0,0,4,4,0.0%,3h
32336,3,Barvazz,2401,0,0,5,5,0.0%,60m
32378,3,Hiroshneeb,2400,971,100,97,197,50.8%,3h
32378,2,KillerAZ,2400,1299,93,79,172,54.1%,1h
32378,3,Neuralink,2400,812,53,43,96,55.2%,3h
32378,2,hoffmann,2400,1052,38,45,83,45.8%,3h
32378,3,[eX]EFFECT,2400,916,36,38,74,48.6%,1h
32378,2,[OGblue]Juanderful,2400,776,28,34,62,45.2%,3h
32378,3,Death,2400,451,21,18,39,53.8%,46m
32378,2,Phenetic,2400,303,20,21,41,48.8%,1h
32378,3,tzpr,2400,449,19,8,27,70.4%,24m
32378,2,[Atone]Clothes,2400,464,19,19,38,50.0%,1h
32378,3,BearMode,2400,394,13,17,30,43.3%,3h
32378,3,Jazza,2400,276,11,3,14,78.6%,47m
32378,3,Gual,2400,219,8,2,10,80.0%,3h
32378,2,ThanosSnap,2400,224,8,10,18,44.4%,1h
32378,3,dga,2400,117,3,0,3,100.0%,5m
32378,3,chaosknight,2400,136,3,3,6,50.0%,1h
32378,2,PISTOLAxHERO,2400,30,3,5,8,37.5%,36m
32378,3,ronnieky,2400,88,3,7,10,30.0%,3h
32378,1,lhuiz,2400,36,2,4,6,33.3%,1h
32378,3,[Desani]Terminator,2400,0,1,0,1,100.0%,10m
32378,3,Drewsus,2400,96,1,2,3,33.3%,1h
32378,3,[5T]aitch,2400,30,1,4,5,20.0%,1h
32378,1,kirito,2400,0,1,4,5,20.0%,1h
32378,3,Jguaz,2400,0,0,2,2,0.0%,1h
32378,3,wally,2400,0,0,2,2,0.0%,47m
32403,2,DOGthirteen,2399,1547,128,120,248,51.6%,7m
32403,1,LouieYorke,2399,1385,117,124,241,48.5%,1h
32403,2,Jotagv,2399,1498,108,79,187,57.8%,1h
32403,1,[VENSC2]Asimov,2399,1556,106,105,211,50.2%,1h
32403,3,[ZITAB1]thorset,2399,1387,97,89,186,52.2%,1h
32403,3,Cesium,2399,1534,94,86,180,52.2%,1h
32403,3,builderman,2399,1175,68,64,132,51.5%,1h
32403,3,chewbacca,2399,725,37,28,65,56.9%,5m
32403,2,Xibalba,2399,606,28,31,59,47.5%,1h
32403,3,LiLCeasar,2399,676,26,25,51,51.0%,3h
32403,1,[IMDSI]Ciceron,2399,776,26,39,65,40.0%,15m
32403,3,Stza,2399,432,21,11,32,65.6%,1h
32403,1,Zaellon,2399,108,15,29,44,34.1%,1h
32403,3,Jellyman,2399,264,9,6,15,60.0%,15m
32403,3,[CCUUCC]BOHGGIE,2399,230,8,9,17,47.1%,54m
32403,3,RyanKoeh,2399,189,6,9,15,40.0%,29m
32403,1,Yeezus,2399,193,5,4,9,55.6%,1h
32403,1,[AlexK]JJRedeck,2399,153,5,10,15,33.3%,3h
32403,3,Barnabus,2399,148,4,7,11,36.4%,33m
32403,1,[4aRaza]KakashiSan,2399,122,3,2,5,60.0%,3h
32403,3,LilNig,2399,60,3,4,7,42.9%,3h
32403,3,[BEEBOY]vitototote,2399,88,3,4,7,42.9%,10m
32403,3,NameThere,2399,30,3,4,7,42.9%,3h
32403,1,GrEEkSoLdIeR,2399,155,3,6,9,33.3%,3h
32403,3,natycraft,2399,30,2,3,5,40.0%,1h
32403,3,[Kako]Charguy,2399,0,1,1,2,50.0%,1h
32403,1,masterslapQC,2399,0,1,4,5,20.0%,37m
32403,2,laracraft,2399,93,1,10,11,9.1%,52m
32403,1,[WNTRCO]Kiljaden,2399,0,0,1,1,0.0%,39m
32403,2,GoldKnight,2399,0,0,1,1,0.0%,3h
32403,1,Aummadour,2399,0,0,1,1,0.0%,16m
32403,3,[Weeeeb]Starkoss,2399,0,0,2,2,0.0%,3h
32403,3,Thundercat,2399,0,0,3,3,0.0%,48m
32403,2,Snocone,2399,0,0,4,4,0.0%,37m
32437,2,KafkaCrow,2398,1525,346,347,693,49.9%,52m
32437,2,AromaticOoze,2398,1122,97,81,178,54.5%,6m
32437,1,clvndvrk,2398,1278,48,57,105,45.7%,1h
32437,3,Waddar,2398,459,36,31,67,53.7%,32m
32437,3,EduartxESPÑx,2398,608,23,22,45,51.1%,1h
32437,3,Ender,2398,151,16,18,34,47.1%,11m
32437,3,Atlas,2398,407,14,12,26,53.8%,49m
32437,3,MAYKOLINO,2398,396,14,19,33,42.4%,1h
32437,3,XICOALT,2398,150,11,9,20,55.0%,11m
32437,3,[AbcCo]slenderman,2398,312,11,12,23,47.8%,1h
32437,1,Edelaz,2398,194,8,5,13,61.5%,3h
32437,3,Wonder,2398,197,6,5,11,54.5%,10m
32437,3,Robinson,2398,162,5,1,6,83.3%,3h
32437,3,Vitojuice,2398,139,5,6,11,45.5%,5m
32437,1,Exaltia,2398,114,5,7,12,41.7%,3h
32437,3,blackFlame,2398,148,5,9,14,35.7%,3h
32437,3,[DKMC]Mercy,2398,124,4,6,10,40.0%,10m
32437,1,[Xe1nal]SkyWalker,2398,134,3,1,4,75.0%,3h
32437,3,DaddyBoi,2398,123,3,3,6,50.0%,1h
32437,1,potatoman,2398,0,1,4,5,20.0%,29m
32437,1,Radar,2398,0,1,4,5,20.0%,1h
32437,1,[TDKS]trippyspade,2398,0,0,1,1,0.0%,3h
32437,1,Samcanjam,2398,0,0,1,1,0.0%,3h
32437,1,Smaito,2398,0,0,1,1,0.0%,3h
32437,3,[Kyo]Nemesis,2398,0,0,3,3,0.0%,4m
32462,3,AGR,2397,1167,112,98,210,53.3%,49m
32462,2,Lucas,2397,1567,62,60,122,50.8%,1h
32462,1,PrinceSChan,2397,1321,61,70,131,46.6%,1h
32462,1,Hamburgers,2397,830,33,32,65,50.8%,3h
32462,3,DittyDonuts,2397,437,31,28,59,52.5%,26m
32462,3,Dunnyslice,2397,376,28,20,48,58.3%,49m
32462,1,BrainMachine,2397,669,23,6,29,79.3%,3h
32462,1,Patouzorus,2397,738,22,16,38,57.9%,3h
32462,3,[1vsM]NovasKotiA,2397,519,19,24,43,44.2%,1h
32462,3,[FyHr]Cazador,2397,414,15,16,31,48.4%,1h
32462,2,James,2397,378,15,18,33,45.5%,35m
32462,2,[SCLK]silvestre,2397,260,12,15,27,44.4%,37m
32462,3,[SSND]Scrubbles,2397,313,12,16,28,42.9%,1h
32462,2,[pTFBq]Brennan,2397,366,12,22,34,35.3%,43m
32462,3,snowblack,2397,282,10,7,17,58.8%,32m
32462,2,KotW,2397,128,5,12,17,29.4%,1h
32462,1,Florencio,2397,192,5,23,28,17.9%,5m
32462,1,TheViper,2397,0,4,1,5,80.0%,3h
32462,2,Shankyj,2397,44,4,7,11,36.4%,3h
32462,2,Calc,2397,195,4,8,12,33.3%,1h
32462,1,bwe,2397,44,2,0,2,100.0%,10m
32462,3,SpadeZ,2397,121,2,2,4,50.0%,1h
32462,2,Bioz,2397,91,2,3,5,40.0%,1h
32462,3,[Best01]Daniel,2397,30,2,4,6,33.3%,5m
32462,3,Wizard,2397,30,2,5,7,28.6%,4m
32462,2,WearYMAN,2397,122,2,6,8,25.0%,1h
32462,1,EyeWeaver,2397,46,1,2,3,33.3%,3h
32462,1,trance,2397,0,1,3,4,25.0%,7m
32462,1,Grumblemauer,2397,0,1,5,6,16.7%,28m
32462,1,Alex,2397,0,0,1,1,0.0%,44m
32462,1,DillaryClump,2397,0,0,1,1,0.0%,28m
32462,3,EquiNoX,2397,0,0,2,2,0.0%,3h
32462,2,[AZPK]KDIGGITYDIZZ,2397,0,0,3,3,0.0%,3h
32462,3,skunk,2397,0,0,3,3,0.0%,5m
32496,2,[PwnCat]HELLRAISER,2396,1105,168,154,322,52.2%,1h
32496,3,[CRAKS]ChinoG,2396,1568,88,86,174,50.6%,53m
32496,3,DarkHorse,2396,892,83,69,152,54.6%,1h
32496,2,NastyChuck,2396,1545,54,64,118,45.8%,1h
32496,1,ThePvK,2396,771,36,44,80,45.0%,54m
32496,3,AlphaMega,2396,810,29,34,63,46.0%,10m
32496,3,Forkster,2396,397,24,14,38,63.2%,24m
32496,3,Assassin,2396,378,14,13,27,51.9%,1h
32496,3,KHYRIOS,2396,403,14,20,34,41.2%,1h
32496,1,KillerRa,2396,351,11,21,32,34.4%,56m
32496,1,Forasasbeel,2396,216,5,3,8,62.5%,41m
32496,3,Necreport,2396,88,5,7,12,41.7%,56m
32496,2,Razul,2396,90,4,8,12,33.3%,29m
32496,3,[ProW]AtomicWaffle,2396,145,3,2,5,60.0%,1h
32496,1,[T0XlK]Gengar,2396,44,2,0,2,100.0%,58m
32496,3,[SSquad]SubtleStone,2396,121,2,1,3,66.7%,1h
32496,1,WeirdZ,2396,0,1,0,1,100.0%,3h
32496,1,[CD4G]ChikN,2396,0,1,0,1,100.0%,38m
32496,2,[Soy]BILLYMAYS,2396,0,1,0,1,100.0%,10m
32496,3,Jord,2396,0,1,1,2,50.0%,8m
32496,2,Manny,2396,42,1,1,2,50.0%,3h
32496,2,[Mints]Reichtangle,2396,0,1,2,3,33.3%,33m
32496,3,[Petz]TheZhen,2396,0,1,3,4,25.0%,1h
32496,2,HavelTheRock,2396,88,1,3,4,25.0%,3h
32496,1,Relik,2396,0,1,4,5,20.0%,56m
32496,1,ralph,2396,0,1,4,5,20.0%,3h
32496,3,SeveN,2396,30,1,5,6,16.7%,5m
32496,1,Blaarslaai,2396,0,1,5,6,16.7%,5m
32496,3,panzerlied,2396,0,0,2,2,0.0%,1h
32496,3,[GOPERÚ]PXS,2396,0,0,4,4,0.0%,1h
32526,1,[FatMom]Shooter,2395,1339,627,645,1272,49.3%,35m
32526,2,powermoves,2395,1561,236,239,475,49.7%,1h
32526,3,Hippiesss,2395,1059,111,116,227,48.9%,19m
32526,1,UnitFoxhound,2395,1196,110,112,222,49.5%,19m
32526,1,[PERGT]WilliaM,2395,1037,85,94,179,47.5%,1h
32526,2,Murphy,2395,1552,79,77,156,50.6%,56m
32526,3,LeSammer,2395,950,67,57,124,54.0%,1h
32526,1,GoodBanana,2395,1338,45,42,87,51.7%,1h
32526,2,[Lp]theRastafary,2395,903,36,36,72,50.0%,3h
32526,1,Superstar,2395,989,35,45,80,43.8%,40m
32526,3,RTUDTU,2395,544,34,38,72,47.2%,60m
32526,3,[sk3tch]MidNight,2395,845,32,31,63,50.8%,1h
32526,3,JeezisShiva,2395,539,31,14,45,68.9%,3h
32526,2,RudeOffender,2395,601,25,25,50,50.0%,3h
32526,1,jwbrain,2395,442,16,1,17,94.1%,33m
32526,2,BadHunter,2395,246,11,9,20,55.0%,3h
32526,1,royerrs,2395,0,5,1,6,83.3%,3h
32526,1,[Chezle]mccloud,2395,92,3,4,7,42.9%,35m
32526,3,DIegoS,2395,95,3,4,7,42.9%,1h
32526,2,RedNinja,2395,0,3,4,7,42.9%,3h
32526,1,TheEncrypter,2395,96,3,7,10,30.0%,4m
32526,1,Carlos,2395,48,2,0,2,100.0%,1h
32526,3,Conan,2395,0,1,1,2,50.0%,26m
32526,1,hakunaYatiti,2395,30,1,1,2,50.0%,3h
32526,3,Truckingman,2395,0,1,3,4,25.0%,10m
32526,1,Slayster,2395,0,1,4,5,20.0%,13m
32526,1,pedro,2395,0,1,4,5,20.0%,1h
32526,1,Natsirt,2395,0,1,4,5,20.0%,49m
32526,1,RonHua,2395,0,0,1,1,0.0%,3h
32526,1,Michovs,2395,0,0,1,1,0.0%,3h
32526,1,[BRZLGN]Monsterosity,2395,0,0,1,1,0.0%,10m
32526,3,Dex,2395,0,0,4,4,0.0%,1h
32526,1,Leonidas,2395,0,0,5,5,0.0%,3h
32559,3,jelsomino,2394,695,121,130,251,48.2%,51m
32559,2,[DmDee]Seymose,2394,1297,77,79,156,49.4%,3h
32559,3,terrorblack,2394,846,62,50,112,55.4%,8m
32559,3,YoloDemShots,2394,1393,60,53,113,53.1%,1h
32559,3,SIlverSword,2394,638,33,26,59,55.9%,49m
32559,2,Baboon,2394,785,31,36,67,46.3%,1h
32559,3,Krang,2394,801,29,28,57,50.9%,3h
32559,2,KISS,2394,747,28,27,55,50.9%,1h
32559,2,PLADIN,2394,696,27,29,56,48.2%,39m
32559,2,Rooaaarrrrr,2394,483,25,18,43,58.1%,1h
32559,3,KillemAll,2394,469,19,12,31,61.3%,30m
32559,3,[cfaftw]MagicTurtle,2394,306,19,16,35,54.3%,19m
32559,3,[SM0K3]Quaid,2394,422,15,17,32,46.9%,39m
32559,3,Nomad,2394,388,14,10,24,58.3%,1h
32559,3,GoldLabel,2394,426,14,19,33,42.4%,30m
32559,3,Rougher,2394,297,9,10,19,47.4%,1h
32559,1,GRAVES,2394,285,9,15,24,37.5%,31m
32559,3,[SC2Pob]topito,2394,176,6,7,13,46.2%,1h
32559,3,[AD3C]LeoElCubano,2394,30,4,5,9,44.4%,39m
32559,3,[BoyinB]BulgeIndulge,2394,66,4,8,12,33.3%,1h
32559,3,unflojo,2394,138,3,2,5,60.0%,29m
32559,3,[TRVMPD]skinnyM,2394,30,2,2,4,50.0%,54m
32559,3,Tanster,2394,0,2,4,6,33.3%,3h
32559,1,RayLiotta,2394,42,2,5,7,28.6%,3h
32559,3,AleUwU,2394,30,2,5,7,28.6%,1h
32559,1,[GnR]boombardo,2394,0,1,0,1,100.0%,1h
32559,1,[ROSC2]laranjafull,2394,0,1,0,1,100.0%,3h
32559,3,[StPats]RexBanner,2394,97,1,1,2,50.0%,1h
32559,1,Binary,2394,0,1,3,4,25.0%,1h
32559,1,lolenricoxd,2394,0,1,4,5,20.0%,42m
32559,3,Boandlgramer,2394,30,1,5,6,16.7%,1h
32559,1,FOXX,2394,48,1,7,8,12.5%,41m
32559,1,[Elys]RatlerX,2394,0,0,1,1,0.0%,3h
32559,1,Qetkut,2394,0,0,1,1,0.0%,38m
32559,1,Manson,2394,0,0,1,1,0.0%,1h
32559,3,[SKDRT]WBSIceFox,2394,0,0,2,2,0.0%,1h
32559,3,Dogman,2394,0,0,4,4,0.0%,33m
32559,3,[FENC]DrgonCN,2394,0,0,5,5,0.0%,1h
32597,1,Pavillions,2393,1921,201,202,403,49.9%,11m
32597,2,IrishJohn,2393,1520,125,119,244,51.2%,1h
32597,2,NICODEMUS,2393,1439,116,104,220,52.7%,57m
32597,2,NikkiSixx,2393,507,84,81,165,50.9%,1h
32597,2,SegFault,2393,1370,74,77,151,49.0%,1h
32597,3,[Trebol]Mario,2393,926,40,30,70,57.1%,4m
32597,2,KelionS,2393,762,28,30,58,48.3%,37m
32597,3,xxKINGREKTxx,2393,584,21,18,39,53.8%,1h
32597,3,[HEZUS]BottledDJinn,2393,330,12,11,23,52.2%,26m
32597,3,MarineForce,2393,264,12,11,23,52.2%,24m
32597,1,[Pius]Aeneas,2393,436,11,9,20,55.0%,3h
32597,3,RevanitE,2393,247,9,9,18,50.0%,3h
32597,3,Djmabes,2393,158,5,7,12,41.7%,1h
32597,1,Kinuven,2393,88,4,6,10,40.0%,1h
32597,3,[LWBB]Kemo,2393,140,4,6,10,40.0%,1h
32597,2,Hawk,2393,166,4,15,19,21.1%,35m
32597,3,Megashark,2393,146,3,4,7,42.9%,3h
32597,3,Calibri,2393,122,2,3,5,40.0%,1h
32597,3,[PSALM]Brodicus,2393,58,2,4,6,33.3%,53m
32597,1,TubZy,2393,48,2,5,7,28.6%,1h
32597,3,Rxt,2393,0,2,6,8,25.0%,3h
32597,1,DeltaAccel,2393,48,2,6,8,25.0%,1h
32597,2,ElJakeo,2393,0,1,1,2,50.0%,46m
32597,1,TerrianXX,2393,0,1,4,5,20.0%,3h
32597,1,BlackRaven,2393,0,1,4,5,20.0%,3h
32597,1,Wagner,2393,0,1,4,5,20.0%,3h
32597,1,zanak,2393,0,1,4,5,20.0%,1h
32597,1,minh,2393,0,0,1,1,0.0%,1h
32597,1,Maya,2393,0,0,1,1,0.0%,16m
32597,1,shyguy,2393,0,0,1,1,0.0%,25m
32597,1,[LegSC]BixO,2393,0,0,1,1,0.0%,48m
32597,3,[weWide]SaintKrok,2393,0,0,2,2,0.0%,33m
32597,2,[xXGDXx]PABLOSS,2393,0,0,4,4,0.0%,46m
32630,1,Gonzo,2392,1639,135,129,264,51.1%,3h
32630,1,Gator,2392,1563,114,120,234,48.7%,19m
32630,3,[PPDC]Bloodshadow,2392,1548,100,98,198,50.5%,39m
32630,1,Sheptennis,2392,1511,81,93,174,46.6%,35m
32630,3,Alikischa,2392,919,63,52,115,54.8%,1h
32630,2,Bigmeeech,2392,1407,61,71,132,46.2%,56m
32630,2,Gomer,2392,1164,44,42,86,51.2%,1h
32630,3,SGoodman,2392,859,36,28,64,56.2%,3h
32630,2,MrAbraham,2392,713,31,29,60,51.7%,53m
32630,2,[LGNxx]AiDz,2392,814,30,40,70,42.9%,1h
32630,2,exzplosive,2392,614,20,27,47,42.6%,34m
32630,3,Pitch,2392,395,15,10,25,60.0%,9m
32630,3,Salemsking,2392,347,15,13,28,53.6%,10m
32630,1,blaylock,2392,343,13,14,27,48.1%,3h
32630,2,ninja,2392,349,13,15,28,46.4%,55m
32630,3,Nekron,2392,173,6,8,14,42.9%,34m
32630,2,KimchiMan,2392,143,5,9,14,35.7%,3h
32630,1,YSAC,2392,130,4,11,15,26.7%,1h
32630,1,TheLaw,2392,168,3,4,7,42.9%,3h
32630,3,odin,2392,30,3,5,8,37.5%,3h
32630,3,Dpp,2392,121,3,6,9,33.3%,56m
32630,3,ExtremeTact,2392,90,3,7,10,30.0%,30m
32630,3,[t3k]Lep,2392,93,2,1,3,66.7%,1h
32630,1,[SyLx]TheHumansLie,2392,88,2,2,4,50.0%,25m
32630,1,Rachmaninoff,2392,96,2,3,5,40.0%,1h
32630,3,razbarrie,2392,58,2,5,7,28.6%,3h
32630,3,[BBall]Reinbuggy,2392,0,1,0,1,100.0%,33m
32630,3,CommieClapp,2392,30,1,3,4,25.0%,33m
32630,3,[Dikbub]Boxcar,2392,30,1,4,5,20.0%,4m
32630,1,Falcon,2392,0,1,4,5,20.0%,8m
32630,1,Howiedo,2392,0,1,4,5,20.0%,3h
32630,3,Brew,2392,0,1,5,6,16.7%,29m
32630,3,blankyeti,2392,0,1,5,6,16.7%,1h
32630,3,samuxdham,2392,0,1,6,7,14.3%,3h
32630,1,Sonlir,2392,0,0,1,1,0.0%,21m
32630,3,Renyip,2392,0,0,1,1,0.0%,36m
32630,3,ToRmAnZ,2392,0,0,2,2,0.0%,33m
32630,1,CakeBoss,2392,0,0,2,2,0.0%,1h
32630,3,Castronez,2392,0,0,2,2,0.0%,3h
32669,2,ELCAZADORZ,2391,1551,126,135,261,48.3%,3h
32669,3,Xerife,2391,1061,52,29,81,64.2%,1h
32669,3,HelpfulNavi,2391,591,23,16,39,59.0%,3h
32669,2,Carth,2391,561,23,24,47,48.9%,8m
32669,3,DukeNukem,2391,420,17,11,28,60.7%,29m
32669,3,Blar,2391,450,17,14,31,54.8%,47m
32669,3,[SAFNC]Joe,2391,409,15,17,32,46.9%,39m
32669,3,Goibniu,2391,362,13,8,21,61.9%,33m
32669,1,Wonka,2391,354,10,4,14,71.4%,3h
32669,1,Anderzone,2391,356,10,9,19,52.6%,1h
32669,3,[90RN]Hess,2391,262,9,12,21,42.9%,5m
32669,3,rorschach,2391,255,8,4,12,66.7%,1h
32669,1,IlBWBS,2391,189,4,5,9,44.4%,3h
32669,3,[ZTemp]Chesshire,2391,86,3,5,8,37.5%,10m
32669,2,[LuxVI]Faust,2391,102,3,6,9,33.3%,46m
32669,3,exitspectral,2391,58,3,6,9,33.3%,1h
32669,3,Drucipher,2391,30,2,2,4,50.0%,3h
32669,1,dotablaze,2391,0,2,3,5,40.0%,3h
32669,1,Macaroni,2391,0,1,0,1,100.0%,29m
32669,3,[Zulu]King,2391,30,1,4,5,20.0%,3h
32669,1,Sokit,2391,0,1,4,5,20.0%,27m
32669,1,ImanC,2391,0,1,4,5,20.0%,3h
32669,1,[ActUse]Zeyther,2391,0,0,1,1,0.0%,1h
32692,1,urankom,2390,1575,189,197,386,49.0%,10m
32692,3,danpunker,2390,540,50,48,98,51.0%,60m
32692,2,TolietSkunk,2390,926,39,35,74,52.7%,12m
32692,1,Guardian,2390,1146,35,33,68,51.5%,15m
32692,3,redbaron,2390,692,28,25,53,52.8%,53m
32692,3,Brasides,2390,604,24,24,48,50.0%,3h
32692,1,[M2A5]Jugdish,2390,576,18,31,49,36.7%,33m
32692,3,[LOLASO]DELION,2390,428,15,16,31,48.4%,49m
32692,1,[EliiT]adriano,2390,425,14,14,28,50.0%,3h
32692,2,kdubs,2390,404,14,19,33,42.4%,25m
32692,1,Jonny,2390,450,12,7,19,63.2%,40m
32692,2,butcher,2390,304,12,15,27,44.4%,47m
32692,1,Maximus,2390,334,11,28,39,28.2%,3h
32692,1,Beastmode,2390,353,9,2,11,81.8%,3h
32692,2,Diosneed,2390,278,8,10,18,44.4%,3h
32692,2,Gerhard,2390,199,8,11,19,42.1%,52m
32692,3,FBSUPER,2390,238,8,12,20,40.0%,39m
32692,3,Pendragon,2390,206,7,13,20,35.0%,1h
32692,3,[cop3]benwillmorr,2390,189,6,8,14,42.9%,26m
32692,3,Celestial,2390,30,5,3,8,62.5%,18m
32692,3,six,2390,134,5,9,14,35.7%,44m
32692,3,[forces]CooperTrosky,2390,121,3,0,3,100.0%,12m
32692,1,Chris,2390,134,3,3,6,50.0%,3h
32692,1,Maigawd,2390,150,3,5,8,37.5%,44m
32692,3,DRIGOX,2390,145,3,7,10,30.0%,3h
32692,2,BlackFire,2390,60,3,9,12,25.0%,1h
32692,3,LiquidFusion,2390,117,2,3,5,40.0%,3h
32692,3,TestOfTime,2390,30,2,5,7,28.6%,22m
32692,1,Arnold,2390,0,1,4,5,20.0%,20m
32692,1,Jack,2390,0,1,4,5,20.0%,3h
32692,2,[1623]pluk,2390,88,1,7,8,12.5%,57m
32692,1,[CRAKS]DeadHeart,2390,0,0,1,1,0.0%,3h
32692,1,ButAidsNoPlz,2390,0,0,2,2,0.0%,1h
32725,3,Atymus,2389,1614,142,139,281,50.5%,1h
32725,1,Mamani,2389,1856,73,60,133,54.9%,3h
32725,2,Horelt,2389,1084,54,59,113,47.8%,1h
32725,3,[MMINGU]Mrwarp,2389,1244,52,41,93,55.9%,1h
32725,2,KINGKONG,2389,1110,50,53,103,48.5%,8m
32725,1,Alucard,2389,854,39,28,67,58.2%,1h
32725,3,xFickle,2389,850,33,34,67,49.3%,3h
32725,3,[ÆON]OscarEduardo,2389,683,33,35,68,48.5%,56m
32725,3,CoffeePoopz,2389,728,26,34,60,43.3%,1h
32725,2,YALLI,2389,830,26,49,75,34.7%,37m
32725,3,ColonelW,2389,601,23,20,43,53.5%,3h
32725,3,[TY4GG]BlessedG,2389,415,20,3,23,87.0%,49m
32725,3,[SD760]Anubis,2389,374,20,14,34,58.8%,1h
32725,2,JAIVA,2389,524,18,20,38,47.4%,30m
32725,3,[ADEC17]MenteMaestra,2389,357,13,9,22,59.1%,33m
32725,3,BillyShakes,2389,371,13,15,28,46.4%,1h
32725,1,CarlosNecu,2389,434,11,13,24,45.8%,1h
32725,2,Sonic,2389,253,10,21,31,32.3%,53m
32725,1,[MacJu]Remix,2389,279,9,11,20,45.0%,38m
32725,1,GilKo,2389,300,8,6,14,57.1%,3h
32725,3,Parmesano,2389,170,8,9,17,47.1%,17m
32725,2,sacrificefru,2389,211,6,8,14,42.9%,8m
32725,3,[iMkS]PAPU,2389,64,4,5,9,44.4%,23m
32725,2,LinuxBird,2389,86,4,11,15,26.7%,1h
32725,1,Cypher,2389,97,2,6,8,25.0%,1h
32725,1,Umpalumpa,2389,0,1,0,1,100.0%,3h
32725,1,Zenrath,2389,0,1,3,4,25.0%,1h
32725,1,[qWTFp]Krinque,2389,0,1,3,4,25.0%,17m
32725,1,[ft3]Ogre,2389,0,1,4,5,20.0%,1h
32725,1,Frenjyboi,2389,0,1,4,5,20.0%,3h
32725,1,Sune,2389,0,1,4,5,20.0%,1h
32725,3,[LIMSC2]WPR,2389,30,1,6,7,14.3%,24m
32725,1,ChinceMaster,2389,0,0,1,1,0.0%,41m
32725,1,Darthlazor,2389,0,0,1,1,0.0%,1h
32759,3,Joekar,2388,1525,222,210,432,51.4%,24m
32759,2,druidlad,2388,1437,134,131,265,50.6%,36m
32759,3,Specter,2388,1224,121,106,227,53.3%,19m
32759,1,Deliriun,2388,1478,116,115,231,50.2%,51m
32759,2,lReyNorZz,2388,1466,86,85,171,50.3%,3h
32759,3,VISARII,2388,1304,50,50,100,50.0%,26m
32759,1,Esteban,2388,1367,48,32,80,60.0%,1h
32759,3,texugão,2388,1081,47,39,86,54.7%,3h
32759,3,McVillaLobos,2388,923,43,37,80,53.8%,3h
32759,2,pgastan,2388,532,18,21,39,46.2%,3h
32759,3,[grimgr]ntrol,2388,404,16,18,34,47.1%,1h
32759,3,MintyFresh,2388,413,14,12,26,53.8%,4m
32759,3,BUCEFALO,2388,310,11,7,18,61.1%,18m
32759,1,Retro,2388,375,11,22,33,33.3%,3h
32759,1,Stirfriday,2388,214,5,3,8,62.5%,25m
32759,1,CoolBarcode,2388,173,4,0,4,100.0%,3h
32759,3,ZeroSiiXxx,2388,97,4,3,7,57.1%,1h
32759,3,Earnie,2388,172,4,6,10,40.0%,3h
32759,3,[2fTz]fixerjj,2388,60,3,4,7,42.9%,29m
32759,3,OhNoRobot,2388,121,3,6,9,33.3%,19m
32759,1,dlwlrma,2388,92,2,2,4,50.0%,38m
32759,1,Kellen,2388,0,2,3,5,40.0%,1h
32759,1,SeaBreeze,2388,0,2,3,5,40.0%,1h
32759,1,Razor,2388,0,1,0,1,100.0%,3h
32759,3,SleepyBoar,2388,0,1,0,1,100.0%,1h
32759,3,letmelive,2388,0,1,1,2,50.0%,1h
32759,3,ajkrate,2388,0,1,1,2,50.0%,4m
32759,1,[CodeS]Juiced,2388,44,1,2,3,33.3%,59m
32759,3,MyrLord,2388,0,1,2,3,33.3%,1h
32759,3,Killemofdeep,2388,32,1,2,3,33.3%,36m
32759,2,fartvader,2388,0,1,3,4,25.0%,3h
32759,3,[SRTSS]LegionOfTime,2388,30,1,3,4,25.0%,16m
32759,3,Ezekiel,2388,30,1,4,5,20.0%,1h
32759,1,RRWrestlr,2388,0,1,4,5,20.0%,4m
32759,1,HazBaz,2388,0,1,4,5,20.0%,12m
32759,1,Badger,2388,0,1,4,5,20.0%,8m
32759,1,TooSlick,2388,0,1,4,5,20.0%,20m
32759,2,[220V]Thessla,2388,0,1,8,9,11.1%,1h
32759,1,azitowolf,2388,0,0,1,1,0.0%,3h
32759,3,Octave,2388,0,0,1,1,0.0%,1h
32759,1,Ramius,2388,73,0,2,2,0.0%,3h
32759,3,MacrodrniNcz,2388,0,0,3,3,0.0%,1h
32801,2,[ZTemp]theredferrit,2387,964,167,165,332,50.3%,1h
32801,2,Terence,2387,1608,146,147,293,49.8%,1h
32801,3,flatlander,2387,676,137,134,271,50.6%,1h
32801,3,Markone,2387,1408,114,123,237,48.1%,1h
32801,2,Glockcoma,2387,1223,113,95,208,54.3%,6m
32801,3,CaptLogan,2387,1075,72,73,145,49.7%,3h
32801,3,slade,2387,941,60,57,117,51.3%,39m
32801,3,communistFAT,2387,963,56,48,104,53.8%,1h
32801,2,Velken,2387,847,31,32,63,49.2%,3h
32801,3,winnebago,2387,482,18,21,39,46.2%,3h
32801,3,Trigs,2387,401,15,14,29,51.7%,1h
32801,1,jarofivetoes,2387,368,12,28,40,30.0%,7m
32801,3,MaJaeYoon,2387,226,6,10,16,37.5%,40m
32801,2,[Silly1]ZINGLINGS,2387,192,6,11,17,35.3%,1h
32801,3,[MTMOON]Nidoking,2387,104,5,8,13,38.5%,3h
32801,2,BETOLIN,2387,92,5,8,13,38.5%,7m
32801,3,pook,2387,60,4,5,9,44.4%,39m
32801,3,Malthael,2387,88,4,9,13,30.8%,1h
32801,3,cyberdragon,2387,122,3,6,9,33.3%,1h
32801,3,korndog,2387,30,2,4,6,33.3%,33m
32801,1,[URSS07]Lirius,2387,97,2,4,6,33.3%,1h
32801,3,Legit,2387,0,2,5,7,28.6%,33m
32801,1,bogan,2387,0,1,0,1,100.0%,34m
32801,1,keebzMT,2387,44,1,1,2,50.0%,33m
32801,1,MrCaballvs,2387,46,1,1,2,50.0%,1h
32801,1,[FUFXx]IIIIIIIIIIII,2387,0,1,3,4,25.0%,5m
32801,1,[Pizzy]PotatoGrill,2387,0,1,4,5,20.0%,3h
32801,1,primehat,2387,0,0,1,1,0.0%,33m
32801,2,[Dave]Armageddon,2387,0,0,1,1,0.0%,1h
32830,1,WildBurns,2386,1503,163,169,332,49.1%,1h
32830,3,Drone,2386,505,86,84,170,50.6%,51m
32830,3,[iDrunk]Rayback,2386,1335,73,81,154,47.4%,32m
32830,2,[sk3tch]Adrian,2386,1493,70,81,151,46.4%,1h
32830,3,Baston,2386,1040,69,75,144,47.9%,33m
32830,2,[HØST]McNel,2386,1398,56,57,113,49.6%,26m
32830,2,Shwing,2386,1089,53,57,110,48.2%,1h
32830,3,Spacelord,2386,818,47,41,88,53.4%,3h
32830,1,FBHC,2386,1222,38,38,76,50.0%,3h
32830,3,MaxPower,2386,710,28,21,49,57.1%,10m
32830,3,[SULFER]steventoast,2386,488,20,23,43,46.5%,1h
32830,3,Tassadar,2386,409,17,16,33,51.5%,1h
32830,1,[LQV]lor,2386,536,13,14,27,48.1%,4m
32830,3,JumpingJax,2386,120,5,5,10,50.0%,20m
32830,3,[MNVN]Perdue,2386,172,5,8,13,38.5%,3h
32830,1,[AK7]PWNADILE,2386,127,5,9,14,35.7%,1h
32830,1,HawkOlive,2386,172,4,4,8,50.0%,14m
32830,3,bolso,2386,88,4,4,8,50.0%,39m
32830,3,Selrahc,2386,148,4,11,15,26.7%,53m
32830,3,GigemGarv,2386,120,3,5,8,37.5%,3h
32830,3,damarderer,2386,144,3,5,8,37.5%,53m
32830,3,Shamas,2386,34,2,2,4,50.0%,1h
32830,3,GreatGatsby,2386,58,2,5,7,28.6%,10m
32830,3,Tazerface,2386,62,2,7,9,22.2%,3h
32830,1,[ARIER]HairBert,2386,58,2,10,12,16.7%,3h
32830,1,groverian,2386,0,1,0,1,100.0%,1h
32830,3,TawxikJuepo,2386,0,1,1,2,50.0%,17m
32830,3,HUHU,2386,96,1,2,3,33.3%,1h
32830,3,radar,2386,95,1,2,3,33.3%,5m
32830,3,fmL,2386,0,1,2,3,33.3%,47m
32830,3,RuggedMusic,2386,0,0,2,2,0.0%,1h
32830,1,[SC2prm]prime,2386,0,0,3,3,0.0%,1h
32862,1,SJtinyhatsDC,2385,1570,378,378,756,50.0%,1h
32862,3,lightTornado,2385,1556,247,242,489,50.5%,1h
32862,2,BlueFire,2385,1535,166,157,323,51.4%,5m
32862,3,DavePrime,2385,1217,103,108,211,48.8%,43m
32862,2,king,2385,1592,88,99,187,47.1%,37m
32862,3,ricolocotito,2385,1254,46,46,92,50.0%,3h
32862,3,BlacKShEeP,2385,1056,40,42,82,48.8%,14m
32862,3,Intermundia,2385,783,36,22,58,62.1%,33m
32862,2,SATURNOvO,2385,502,20,20,40,50.0%,57m
32862,2,[1488HH]Player,2385,308,16,12,28,57.1%,43m
32862,2,purpleglop,2385,463,16,22,38,42.1%,1h
32862,2,wolk,2385,320,11,17,28,39.3%,46m
32862,3,Shadows,2385,305,10,8,18,55.6%,19m
32862,3,ubermensch,2385,239,8,5,13,61.5%,3h
32862,1,[PZTT]Ghost,2385,132,5,8,13,38.5%,1h
32862,1,CplWakefield,2385,130,4,2,6,66.7%,3h
32862,3,cOnFused,2385,0,4,5,9,44.4%,11m
32862,2,AlexGrady,2385,98,4,8,12,33.3%,35m
32862,3,breistar,2385,97,3,5,8,37.5%,28m
32862,3,Kcesar,2385,115,2,2,4,50.0%,19m
32862,1,Joshie,2385,0,2,3,5,40.0%,42m
32862,1,Oscar,2385,90,2,4,6,33.3%,39m
32862,1,theDreamKing,2385,0,2,7,9,22.2%,51m
32862,1,Cryzologo,2385,38,2,9,11,18.2%,3h
32862,1,LES,2385,0,1,1,2,50.0%,1h
32862,3,edu,2385,0,1,1,2,50.0%,3h
32862,3,VaJoNGas,2385,30,1,3,4,25.0%,53m
32862,1,Enderhack,2385,0,1,4,5,20.0%,3h
32862,3,Mike,2385,0,0,2,2,0.0%,11m
32891,3,StickyPants,2384,1569,203,221,424,47.9%,40m
32891,2,CoolEthan,2384,1211,130,117,247,52.6%,5m
32891,2,Rick,2384,916,74,79,153,48.4%,53m
32891,2,JustSayNo,2384,791,70,62,132,53.0%,1h
32891,3,Chey,2384,1480,60,58,118,50.8%,1h
32891,3,joshue,2384,921,37,33,70,52.9%,1h
32891,3,Diaza,2384,386,31,33,64,48.4%,33m
32891,3,KvotheLost,2384,724,28,34,62,45.2%,26m
32891,3,pinetree,2384,560,21,18,39,53.8%,1h
32891,3,MonkEllipse,2384,556,19,20,39,48.7%,49m
32891,3,Stoneman,2384,243,13,14,27,48.1%,11m
32891,3,MasteroDeath,2384,269,9,8,17,52.9%,39m
32891,3,htiffirg,2384,265,9,10,19,47.4%,1h
32891,1,howrutoday,2384,204,9,12,21,42.9%,38m
32891,1,NekoToss,2384,227,6,8,14,42.9%,21m
32891,3,Nitrate,2384,220,6,8,14,42.9%,1h
32891,3,techy,2384,159,5,4,9,55.6%,5m
32891,1,[BAAF]wargazmz,2384,137,3,5,8,37.5%,14m
32891,3,demon,2384,90,3,7,10,30.0%,11m
32891,3,Dsolr,2384,60,3,7,10,30.0%,1h
32891,2,Noaob,2384,134,2,2,4,50.0%,45m
32891,3,Conspiration,2384,62,2,7,9,22.2%,33m
32891,1,Ratóncito,2384,0,1,0,1,100.0%,60m
32891,3,aMFSorcerer,2384,97,1,1,2,50.0%,3h
32891,1,NordicMoose,2384,97,1,2,3,33.3%,3h
32891,3,Ridley,2384,30,1,3,4,25.0%,1h
32891,3,SsjPrince,2384,30,1,4,5,20.0%,1h
32891,1,johnnydkilla,2384,0,1,4,5,20.0%,3h
32891,1,Lumpy,2384,0,1,4,5,20.0%,44m
32891,3,TonyG,2384,30,1,5,6,16.7%,27m
32891,1,[ATL]JimLahey,2384,0,0,1,1,0.0%,1h
32891,1,nowwissonn,2384,0,0,1,1,0.0%,28m
32891,3,muhyat,2384,0,0,3,3,0.0%,3h
32891,1,shyguy,2384,73,0,5,5,0.0%,55m
32925,3,FIDO,2383,1395,140,122,262,53.4%,1h
32925,2,[SC2PH]TheKush,2383,1534,67,66,133,50.4%,7m
32925,3,[AbcCo]Washovietic,2383,738,63,57,120,52.5%,60m
32925,3,relasin,2383,1307,57,54,111,51.4%,17m
32925,3,FriendlyChem,2383,809,49,33,82,59.8%,4m
32925,1,zancudo,2383,1038,36,47,83,43.4%,57m
32925,1,ChinoDSK,2383,742,23,13,36,63.9%,3h
32925,3,Artanis,2383,532,21,17,38,55.3%,3h
32925,3,DeModa,2383,402,14,17,31,45.2%,1h
32925,3,[SCR0TE]WrathOfBong,2383,266,9,6,15,60.0%,33m
32925,3,MacroKing,2383,117,7,1,8,87.5%,4m
32925,3,[kolkid]john,2383,191,5,4,9,55.6%,3h
32925,3,dave,2383,146,5,5,10,50.0%,29m
32925,1,Goobie,2383,132,4,1,5,80.0%,1h
32925,3,Kraytin,2383,175,4,2,6,66.7%,1h
32925,2,johnny,2383,88,4,4,8,50.0%,1h
32925,1,Ross,2383,132,3,5,8,37.5%,3h
32925,3,beldenge,2383,0,2,5,7,28.6%,42m
32925,2,NineLines,2383,0,2,5,7,28.6%,36m
32925,3,Nothxu,2383,34,2,7,9,22.2%,33m
32925,1,PBJ,2383,0,1,0,1,100.0%,1h
32925,3,Demonicangle,2383,0,1,0,1,100.0%,1h
32925,2,Metalfreak,2383,0,1,1,2,50.0%,1h
32925,1,Waracle,2383,46,1,1,2,50.0%,35m
32925,3,Sambu,2383,0,1,1,2,50.0%,60m
32925,1,Verge,2383,46,1,2,3,33.3%,41m
32925,1,Ace,2383,48,1,2,3,33.3%,3h
32925,1,Vormirk,2383,0,1,4,5,20.0%,3h
32925,1,Ben,2383,0,0,1,1,0.0%,3h
32925,3,[BGE]Boodriah,2383,0,0,2,2,0.0%,1h
32925,1,Grungus,2383,0,0,2,2,0.0%,42m
32925,2,Psycho,2383,0,0,3,3,0.0%,3h
32957,2,CaptainHowdy,2382,1471,92,96,188,48.9%,1h
32957,1,fuzwuzbear,2382,1038,90,87,177,50.8%,3h
32957,1,[ANSC]DarKSidE,2382,1217,83,88,171,48.5%,41m
32957,3,KentNizzy,2382,1072,49,41,90,54.4%,3h
32957,3,danBrox,2382,830,35,27,62,56.5%,17m
32957,1,Bagels,2382,874,34,37,71,47.9%,59m
32957,1,LatinoBlast,2382,899,30,23,53,56.6%,25m
32957,3,LouLullabyTV,2382,568,25,21,46,54.3%,1h
32957,3,Meselgroth,2382,427,23,24,47,48.9%,1h
32957,1,[5252]YesNoah,2382,579,19,13,32,59.4%,3h
32957,3,IroncladEli,2382,394,16,12,28,57.1%,1h
32957,1,[KrAce]chardino,2382,445,14,24,38,36.8%,3h
32957,3,[AbcCo]Blanka,2382,286,11,7,18,61.1%,1h
32957,1,[BRODY]elNuv,2382,254,9,6,15,60.0%,4m
32957,3,[LMI42]DyE,2382,213,6,9,15,40.0%,1h
32957,3,gohanngasusu,2382,174,5,3,8,62.5%,3h
32957,3,Cozart,2382,0,4,3,7,57.1%,1h
32957,3,[GOPERÚ]AZOPOTAMO,2382,118,4,6,10,40.0%,1h
32957,3,MrButterBean,2382,60,4,7,11,36.4%,1h
32957,1,[WTFNEL]AngeloPiasZ,2382,88,3,1,4,75.0%,59m
32957,1,Toast,2382,46,1,1,2,50.0%,3h
32957,3,Ghostpepper,2382,95,1,2,3,33.3%,3h
32957,3,[FAPFAP]FreeGordon,2382,95,1,2,3,33.3%,1h
32957,1,Radic,2382,0,1,4,5,20.0%,1h
32957,1,rhyno,2382,0,1,4,5,20.0%,13m
32957,1,Grimmreefer,2382,0,0,1,1,0.0%,49m
32957,2,Deimo,2382,0,0,1,1,0.0%,34m
32957,2,Bonhomme,2382,0,0,2,2,0.0%,1h
32957,3,TapeWorm,2382,0,0,3,3,0.0%,43m
32986,3,erickfire,2381,1542,199,187,386,51.6%,22m
32986,3,Rostislav,2381,1514,91,98,189,48.1%,60m
32986,3,Bad,2381,693,70,54,124,56.5%,1h
32986,2,bao,2381,951,69,65,134,51.5%,51m
32986,3,GangstrChimp,2381,917,35,30,65,53.8%,1h
32986,3,[AXlOS]Manssquito,2381,760,28,30,58,48.3%,1h
32986,2,TokyoJager,2381,620,22,30,52,42.3%,5m
32986,1,SutanBasa,2381,524,21,19,40,52.5%,1h
32986,2,[SCuca]Xtian,2381,498,18,24,42,42.9%,12m
32986,3,DBullet,2381,312,15,15,30,50.0%,28m
32986,2,TigerWoo,2381,363,14,21,35,40.0%,1h
32986,3,[Gbm0d]Pdepuma,2381,294,11,12,23,47.8%,4m
32986,1,Canserbero,2381,296,10,11,21,47.6%,3h
32986,2,bUdDhAmAn,2381,259,8,13,21,38.1%,1h
32986,1,Herpaherm,2381,278,8,16,24,33.3%,44m
32986,3,Bmamba,2381,122,6,9,15,40.0%,3h
32986,3,Praesidium,2381,149,4,4,8,50.0%,5m
32986,2,ziriguidum,2381,171,4,7,11,36.4%,3h
32986,3,HentaiSenpai,2381,0,3,3,6,50.0%,3h
32986,1,Mcatnip,2381,132,3,3,6,50.0%,1h
32986,1,JadedKronos,2381,66,3,8,11,27.3%,58m
32986,3,Vejolta,2381,60,2,4,6,33.3%,49m
32986,3,IrishPredatR,2381,0,2,5,7,28.6%,33m
32986,3,LyotoMachida,2381,97,2,6,8,25.0%,1h
32986,1,gerardo,2381,0,2,6,8,25.0%,51m
32986,1,[Koiwai]Bikko,2381,0,1,0,1,100.0%,4m
32986,1,Duffs,2381,0,1,4,5,20.0%,3h
32986,1,PooShipMcGee,2381,0,1,4,5,20.0%,42m
32986,2,Jormungand,2381,30,1,10,11,9.1%,46m
32986,1,LeXX,2381,0,0,1,1,0.0%,1h
32986,1,[LDCO]darkjulio,2381,0,0,1,1,0.0%,1h
32986,1,Storm,2381,0,0,1,1,0.0%,1h
32986,3,Azte,2381,0,0,3,3,0.0%,25m
33019,2,Saigon,2380,1577,149,142,291,51.2%,8m
33019,1,KluverBucy,2380,1812,131,126,257,51.0%,56m
33019,2,[ZTemps]IIIIIIIIIIII,2380,1020,124,123,247,50.2%,40m
33019,3,ANTHOLOGY,2380,1038,115,106,221,52.0%,3h
33019,2,ShArK,2380,1357,106,94,200,53.0%,3h
33019,3,Azzonglia,2380,568,25,26,51,49.0%,3h
33019,3,jalo,2380,712,24,39,63,38.1%,19m
33019,3,Ghost,2380,404,17,8,25,68.0%,1h
33019,3,XvaT,2380,341,12,11,23,52.2%,1h
33019,2,ANDY,2380,284,9,18,27,33.3%,37m
33019,3,FuchsiaDaddy,2380,212,8,11,19,42.1%,56m
33019,1,[GLHFJJ]AlarakSTX,2380,204,5,1,6,83.3%,49m
33019,3,NikkzZz,2380,147,4,7,11,36.4%,21m
33019,1,Tiberius,2380,42,2,0,2,100.0%,1h
33019,3,Solace,2380,0,2,5,7,28.6%,1h
33019,3,SquirrelFang,2380,0,2,5,7,28.6%,47m
33019,1,FreakAndEll,2380,111,2,6,8,25.0%,38m
33019,3,[CGLAN]tian,2380,0,1,0,1,100.0%,33m
33019,1,penny,2380,0,1,4,5,20.0%,1h
33019,3,assassinT,2380,0,0,1,1,0.0%,60m
33019,1,RogueRebel,2380,0,0,2,2,0.0%,3h
33019,3,RUBENZERGIO,2380,0,0,3,3,0.0%,1h
33019,3,senier,2380,0,0,4,4,0.0%,1h
33042,2,[SRs28]bladirock,2379,1386,131,138,269,48.7%,18m
33042,1,Odinez,2379,1336,86,68,154,55.8%,3h
33042,3,PiPe,2379,1001,83,76,159,52.2%,1h
33042,3,GriPs,2379,1132,74,61,135,54.8%,20m
33042,3,RicFer,2379,1030,53,43,96,55.2%,3h
33042,3,CoronaVirus,2379,1139,46,45,91,50.5%,1h
33042,3,[gksrnr]Class,2379,645,41,25,66,62.1%,1h
33042,3,Jhimy,2379,503,22,21,43,51.2%,33m
33042,3,DeltaX,2379,571,22,23,45,48.9%,3h
33042,3,SQHP,2379,485,22,24,46,47.8%,53m
33042,3,slashr,2379,511,19,21,40,47.5%,49m
33042,1,Monolicho,2379,606,17,9,26,65.4%,60m
33042,1,Eccentrix,2379,516,16,27,43,37.2%,3h
33042,2,[LTWAR]Boogieman,2379,355,14,14,28,50.0%,40m
33042,1,[uDuh]XpermentorX,2379,371,13,4,17,76.5%,1h
33042,1,Nocturis,2379,434,13,33,46,28.3%,57m
33042,1,[KUMS]lUkifer,2379,403,12,13,25,48.0%,4m
33042,3,Min,2379,210,7,4,11,63.6%,3h
33042,3,Alonsoone,2379,213,6,9,15,40.0%,1h
33042,1,LeShark,2379,171,6,12,18,33.3%,29m
33042,3,MaeGovannen,2379,192,5,2,7,71.4%,33m
33042,2,[75ARR]allfon,2379,141,5,7,12,41.7%,1h
33042,3,Premium,2379,114,4,8,12,33.3%,3h
33042,1,PROBINSYANO,2379,136,3,3,6,50.0%,1h
33042,1,Crafty,2379,46,2,0,2,100.0%,11m
33042,1,Draco,2379,44,2,4,6,33.3%,59m
33042,1,HyperionX,2379,48,2,5,7,28.6%,8m
33042,1,KINGFRANCE,2379,48,2,5,7,28.6%,3h
33042,3,Phoenix,2379,50,2,7,9,22.2%,3h
33042,3,[FxB]Mudflap,2379,0,1,1,2,50.0%,41m
33042,1,Saxon,2379,0,1,5,6,16.7%,53m
33042,1,Ginseng,2379,0,0,1,1,0.0%,1h
33042,1,Gaara,2379,0,0,4,4,0.0%,3h
33075,3,JosephZito,2378,1059,100,80,180,55.6%,1h
33075,3,LuckyPig,2378,616,56,41,97,57.7%,1h
33075,2,Dlow,2378,335,50,63,113,44.2%,30m
33075,1,ApmTen,2378,746,25,23,48,52.1%,4m
33075,2,[GGLMNX]Lancastrater,2378,621,25,24,49,51.0%,43m
33075,3,Elsolapa,2378,426,23,20,43,53.5%,1h
33075,1,jose,2378,548,15,14,29,51.7%,1h
33075,3,[B3Pros]GawdOfEzwin,2378,396,14,15,29,48.3%,54m
33075,2,MrToss,2378,411,14,16,30,46.7%,51m
33075,1,Def,2378,303,9,15,24,37.5%,48m
33075,1,KHAELFABIO,2378,220,6,4,10,60.0%,1h
33075,3,soba,2378,0,3,5,8,37.5%,34m
33075,1,nekuJay,2378,0,2,1,3,66.7%,3h
33075,3,[TSOTH]Insaineack,2378,58,2,4,6,33.3%,9m
33075,3,Fox,2378,30,2,4,6,33.3%,47m
33075,3,joesmith,2378,0,2,5,7,28.6%,1h
33075,1,mar,2378,0,1,1,2,50.0%,42m
33075,3,[fart5]decimalplace,2378,18,1,6,7,14.3%,39m
33075,3,ImAdams,2378,42,1,6,7,14.3%,3h
33075,1,nlists,2378,0,0,1,1,0.0%,3h
33075,3,DARCKAN,2378,0,0,2,2,0.0%,60m
33075,1,[KGH]Tangosix,2378,0,0,12,12,0.0%,45m
33097,3,RichardGasqu,2377,1549,259,253,512,50.6%,3h
33097,3,Fax,2377,1208,50,48,98,51.0%,25m
33097,3,Peaches,2377,1103,45,46,91,49.5%,5m
33097,1,[posta]edacx,2377,722,22,23,45,48.9%,22m
33097,1,FiredArtist,2377,624,19,19,38,50.0%,1h
33097,3,[sanwch]Goods,2377,360,17,5,22,77.3%,22m
33097,2,Zaife,2377,420,16,21,37,43.2%,34m
33097,3,[LBES]allmadden,2377,407,15,21,36,41.7%,19m
33097,3,Peter,2377,374,12,18,30,40.0%,3h
33097,3,Cade,2377,313,11,8,19,57.9%,54m
33097,2,shadow,2377,316,9,5,14,64.3%,3h
33097,2,Genralscott,2377,228,8,12,20,40.0%,1h
33097,1,hogger,2377,233,7,14,21,33.3%,3h
33097,3,annaKIN,2377,171,4,3,7,57.1%,1h
33097,2,Dalgom,2377,44,4,9,13,30.8%,11m
33097,3,DiorArtist,2377,109,4,9,13,30.8%,28m
33097,1,llIIIIllllI,2377,0,3,2,5,60.0%,3h
33097,2,[MAYN]LittleShilla,2377,88,3,14,17,17.6%,1h
33097,1,INFERNOPRO,2377,0,1,0,1,100.0%,41m
33097,2,TORN,2377,0,1,1,2,50.0%,11m
33097,3,[MJREX]Tobrox,2377,0,1,2,3,33.3%,3h
33097,1,Juanko,2377,0,0,2,2,0.0%,22m
33097,2,Gorpse,2377,0,0,2,2,0.0%,3h
33097,1,YDeaD,2377,73,0,6,6,0.0%,38m
33121,3,Jroosta,2376,1422,52,59,111,46.8%,33m
33121,2,ShuraEX,2376,850,30,39,69,43.5%,25m
33121,3,Dominator,2376,662,27,21,48,56.2%,3h
33121,2,soulstealer,2376,522,25,34,59,42.4%,3h
33121,1,NNNNNNN,2376,546,16,11,27,59.3%,3h
33121,2,RainbowzBK,2376,422,15,20,35,42.9%,3h
33121,1,[imN0ob]Kevo,2376,500,15,27,42,35.7%,3h
33121,1,[EasyAI]philthetank,2376,332,8,5,13,61.5%,3h
33121,3,[LMI42]Sadik,2376,199,8,12,20,40.0%,1h
33121,3,ving,2376,200,6,4,10,60.0%,54m
33121,3,Dlwlrma,2376,192,6,8,14,42.9%,3h
33121,2,KiritoBast,2376,30,5,3,8,62.5%,29m
33121,3,Jak,2376,195,5,7,12,41.7%,26m
33121,3,ZAGA,2376,122,4,7,11,36.4%,1h
33121,1,Lappetam,2376,147,4,7,11,36.4%,41m
33121,1,keltuzard,2376,90,3,0,3,100.0%,13m
33121,1,[zUwU]zUwUz,2376,90,3,3,6,50.0%,51m
33121,3,GrimReaper,2376,96,2,5,7,28.6%,40m
33121,2,[CLCH]WintersFury,2376,0,2,5,7,28.6%,40m
33121,3,Hiddennight,2376,0,2,5,7,28.6%,8m
33121,3,TERRART,2376,64,2,6,8,25.0%,22m
33121,3,ozkar,2376,30,2,6,8,25.0%,33m
33121,1,[buteco]BRADOCK,2376,0,1,0,1,100.0%,3h
33121,1,mgspunk,2376,44,1,1,2,50.0%,1h
33121,1,DamperNut,2376,46,1,1,2,50.0%,41m
33121,1,Gvysccar,2376,46,1,1,2,50.0%,3h
33121,1,Zairrif,2376,0,1,4,5,20.0%,58m
33121,1,garde,2376,0,1,10,11,9.1%,59m
33121,1,Diego,2376,0,0,1,1,0.0%,3h
33121,1,Faraday,2376,0,0,2,2,0.0%,1h
33151,3,[sk3tch]RobinSCII,2375,1513,174,185,359,48.5%,44m
33151,3,[0825]CandyLand,2375,1035,115,116,231,49.8%,33m
33151,2,kshahzada,2375,605,59,47,106,55.7%,1h
33151,3,dabrunol,2375,1319,53,48,101,52.5%,30m
33151,3,PotatoHead,2375,756,47,40,87,54.0%,3h
33151,2,OrionX,2375,1088,37,48,85,43.5%,8m
33151,2,TuxedoMask,2375,765,36,36,72,50.0%,3h
33151,1,Geminus,2375,994,31,25,56,55.4%,46m
33151,3,happysc,2375,794,28,42,70,40.0%,33m
33151,3,VoidzPhinix,2375,545,21,22,43,48.8%,3h
33151,3,Starman,2375,498,20,21,41,48.8%,4m
33151,3,Fatal,2375,450,17,16,33,51.5%,39m
33151,1,[PvZAll]noLemon,2375,481,14,6,20,70.0%,3h
33151,2,CanadianTux,2375,326,12,14,26,46.2%,1h
33151,3,Rez,2375,328,12,16,28,42.9%,56m
33151,1,DrZarkov,2375,388,12,28,40,30.0%,35m
33151,2,oJeDo,2375,320,11,7,18,61.1%,46m
33151,3,CoolFace,2375,350,11,12,23,47.8%,1h
33151,1,TwerkCEO,2375,330,9,8,17,52.9%,3h
33151,2,[KGH4]SirJohny,2375,152,8,9,17,47.1%,3h
33151,2,Jamret,2375,157,7,8,15,46.7%,1h
33151,2,[BgBear]FRANKTHETANK,2375,120,7,13,20,35.0%,43m
33151,3,ernesto,2375,168,5,5,10,50.0%,33m
33151,1,bluecheetah,2375,180,4,5,9,44.4%,55m
33151,3,[IMDSI]nachobros,2375,121,3,0,3,100.0%,34m
33151,3,[danuts]tonsofdamage,2375,153,3,12,15,20.0%,49m
33151,3,kevlp,2375,97,2,1,3,66.7%,28m
33151,3,[ELNENE]Wintermaul,2375,97,2,1,3,66.7%,57m
33151,1,JavierFusser,2375,92,2,3,5,40.0%,11m
33151,2,Heisenberg,2375,84,2,3,5,40.0%,1h
33151,1,Jhon,2375,97,2,4,6,33.3%,1h
33151,3,Anezthetik,2375,58,2,7,9,22.2%,4m
33151,1,animosity,2375,0,1,1,2,50.0%,3h
33151,3,mcdabbie,2375,0,1,1,2,50.0%,1h
33151,1,[ZTempz]belhieg,2375,0,1,4,5,20.0%,1h
33151,1,Alphakenyone,2375,0,1,4,5,20.0%,3h
33151,1,lenin,2375,0,1,4,5,20.0%,39m
33151,3,[500CC]jernokoko,2375,30,1,5,6,16.7%,3h
33151,1,ClarinetKeys,2375,0,0,1,1,0.0%,41m
33151,1,Mael,2375,0,0,1,1,0.0%,3h
33151,1,ELCUERVO,2375,0,0,1,1,0.0%,59m
33192,1,pinkhot,2374,1561,288,292,580,49.7%,19m
33192,2,Howhaw,2374,1544,228,223,451,50.6%,34m
33192,2,Ricochet,2374,1564,126,131,257,49.0%,1h
33192,3,mussshassho,2374,1094,96,94,190,50.5%,4m
33192,1,blitzkriegHD,2374,1533,91,97,188,48.4%,3h
33192,2,mobyfish,2374,1607,84,83,167,50.3%,21m
33192,3,DRAKITO,2374,991,52,41,93,55.9%,30m
33192,3,[XpKAc]aaron,2374,828,46,40,86,53.5%,33m
33192,2,FrutillitA,2374,828,37,39,76,48.7%,1h
33192,3,XENOACOLYTE,2374,871,34,32,66,51.5%,1h
33192,3,Derpafiscus,2374,693,27,27,54,50.0%,1h
33192,1,Scarito,2374,762,26,43,69,37.7%,2m
33192,1,melgarfbc,2374,842,25,14,39,64.1%,53m
33192,3,lito,2374,470,20,24,44,45.5%,26m
33192,3,Daimyo,2374,523,18,19,37,48.6%,20m
33192,2,vtmati,2374,450,17,22,39,43.6%,3h
33192,1,[Nose02]Djokovic,2374,560,16,11,27,59.3%,29m
33192,1,IVANCITO,2374,376,14,3,17,82.4%,1h
33192,2,Ping,2374,336,11,16,27,40.7%,8m
33192,2,Galan,2374,304,10,11,21,47.6%,3h
33192,1,drccada,2374,260,7,4,11,63.6%,3h
33192,3,KMoracle,2374,227,7,5,12,58.3%,47m
33192,3,StarJ,2374,185,6,3,9,66.7%,3h
33192,1,forlornish,2374,198,5,15,20,25.0%,51m
33192,3,Wuarike,2374,174,4,7,11,36.4%,1h
33192,2,Stormwolf,2374,144,4,9,13,30.8%,1h
33192,3,ZBuffered,2374,122,3,6,9,33.3%,1h
33192,2,lalo,2374,88,3,14,17,17.6%,3h
33192,3,[DICBOI]Oniichan,2374,30,2,3,5,40.0%,51m
33192,1,WIchawin,2374,0,2,3,5,40.0%,3h
33192,2,[JB420]Nopi,2374,84,2,7,9,22.2%,1h
33192,1,Andrew,2374,0,1,0,1,100.0%,1h
33192,1,NERCUS,2374,0,1,0,1,100.0%,3h
33192,1,Ferraille,2374,0,1,0,1,100.0%,51m
33192,1,cris,2374,0,1,0,1,100.0%,1h
33192,3,SeBoM,2374,97,1,1,2,50.0%,1h
33192,1,napleon,2374,0,1,1,2,50.0%,1h
33192,1,CreatureKane,2374,38,1,2,3,33.3%,49m
33192,1,[QCQCQC]MajorScienti,2374,97,1,2,3,33.3%,58m
33192,3,Legendling,2374,94,1,4,5,20.0%,29m
33192,1,OMEGA,2374,0,1,4,5,20.0%,4m
33192,1,JuicBlueJr,2374,0,1,4,5,20.0%,3h
33192,1,DivadRyc,2374,0,1,4,5,20.0%,3h
33192,1,HAVOC,2374,0,1,5,6,16.7%,3h
33192,2,Joemamma,2374,0,0,1,1,0.0%,11m
33192,1,UBIQUE,2374,0,0,1,1,0.0%,1h
33192,1,HUZMA,2374,0,0,1,1,0.0%,1h
33192,3,wasoski,2374,0,0,4,4,0.0%,1h
33240,2,Lud,2373,1550,398,394,792,50.3%,29m
33240,3,LuckyStrike,2373,767,48,38,86,55.8%,9m
33240,3,Mavekashi,2373,369,29,18,47,61.7%,28m
33240,2,MichoTito,2373,656,27,28,55,49.1%,3h
33240,1,Facker,2373,781,24,23,47,51.1%,1h
33240,1,MasterCat,2373,716,23,23,46,50.0%,3h
33240,3,MyNameBill,2373,505,20,17,37,54.1%,25m
33240,3,Channels,2373,350,13,9,22,59.1%,33m
33240,1,Xcne,2373,369,10,4,14,71.4%,21m
33240,3,cwicktricks,2373,312,10,8,18,55.6%,50m
33240,3,Performapal,2373,170,5,7,12,41.7%,54m
33240,1,BeefCake,2373,176,4,2,6,66.7%,3m
33240,3,SinfulBread,2373,86,4,4,8,50.0%,1h
33240,2,[ALTF04]Catire,2373,94,4,11,15,26.7%,1h
33240,1,Gvent,2373,42,2,4,6,33.3%,3h
33240,3,[RNGsus]Rdino,2373,60,2,6,8,25.0%,51m
33240,1,Chalo,2373,48,2,6,8,25.0%,1h
33240,1,[oye]VirusNK,2373,0,1,1,2,50.0%,1h
33240,3,DragonAzul,2373,97,1,2,3,33.3%,17m
33240,3,Klima,2373,0,1,2,3,33.3%,1h
33240,1,[WW1]jarefosuprem,2373,93,1,2,3,33.3%,3h
33240,3,Alex,2373,0,1,2,3,33.3%,33m
33240,1,neto,2373,0,1,4,5,20.0%,14m
33263,3,OrbOfChaos,2372,1468,136,116,252,54.0%,33m
33263,2,castortroy,2372,1470,124,125,249,49.8%,36m
33263,3,Stevius,2372,1520,83,89,172,48.3%,4m
33263,3,Aperture,2372,842,66,62,128,51.6%,3h
33263,3,[CHOJON]Pepo,2372,1138,43,42,85,50.6%,1h
33263,3,Celeritas,2372,1054,41,41,82,50.0%,3h
33263,2,Badger,2372,470,39,43,82,47.6%,3h
33263,3,Moist,2372,610,22,25,47,46.8%,1h
33263,3,ReapSoulGhos,2372,535,20,21,41,48.8%,1h
33263,1,helio,2372,513,16,6,22,72.7%,3h
33263,1,Dadbod,2372,534,15,11,26,57.7%,25m
33263,1,[Carton]elmamao,2372,313,11,11,22,50.0%,1h
33263,2,Beef,2372,275,10,10,20,50.0%,29m
33263,3,[Betona]Mustang,2372,268,10,15,25,40.0%,1h
33263,2,[MBS209]Almosthuman,2372,244,9,18,27,33.3%,1h
33263,1,JavierHV,2372,221,8,7,15,53.3%,58m
33263,1,ZayNar,2372,271,8,9,17,47.1%,32m
33263,2,dragonfly,2372,173,5,3,8,62.5%,1h
33263,3,carlse,2372,0,4,3,7,57.1%,3h
33263,1,[xTMGx]nik,2372,90,4,11,15,26.7%,58m
33263,3,Blue,2372,88,3,4,7,42.9%,34m
33263,3,Fabrien,2372,145,3,5,8,37.5%,1h
33263,1,[m0ld]ProzakJack,2372,48,2,5,7,28.6%,4m
33263,3,Peketo,2372,97,1,2,3,33.3%,1h
33263,3,Ozz,2372,30,1,4,5,20.0%,49m
33263,1,aziz,2372,0,0,1,1,0.0%,1h
33263,3,MSGArmyEd,2372,0,0,2,2,0.0%,22m
33263,1,Pong,2372,0,0,2,2,0.0%,3h
33263,1,fatalerror,2372,0,0,5,5,0.0%,51m
33263,3,[Blizzc]JurisTerran,2372,0,0,6,6,0.0%,1h
33293,2,REPO,2371,802,152,135,287,53.0%,1h
33293,2,Rasputin,2371,1447,57,60,117,48.7%,3h
33293,3,PatoDriver,2371,713,49,46,95,51.6%,10m
33293,1,EllenRipley,2371,1302,41,41,82,50.0%,3h
33293,1,Adama,2371,729,25,11,36,69.4%,44m
33293,3,[GrandF]Doblerre,2371,210,20,22,42,47.6%,3h
33293,2,Leade,2371,380,18,14,32,56.2%,41m
33293,3,Dancer,2371,272,14,7,21,66.7%,11m
33293,1,[NSB01]Bladder,2371,338,14,20,34,41.2%,1m
33293,3,DROTH,2371,208,11,17,28,39.3%,27m
33293,2,BrIGht,2371,319,10,13,23,43.5%,3h
33293,3,[TPGGXD]Dark,2371,251,9,6,15,60.0%,1h
33293,3,CriticalKush,2371,236,9,6,15,60.0%,1h
33293,2,Cecil,2371,240,8,18,26,30.8%,45m
33293,3,stu,2371,202,7,14,21,33.3%,1h
33293,3,UnCrissDeQc,2371,207,6,5,11,54.5%,3h
33293,3,Sean,2371,236,6,8,14,42.9%,3h
33293,1,SharpKnife,2371,124,6,11,17,35.3%,51m
33293,3,Bastiano,2371,154,5,8,13,38.5%,1h
33293,3,DrBratwurst,2371,166,5,9,14,35.7%,1h
33293,2,cimplex,2371,128,4,7,11,36.4%,28m
33293,3,roughninja,2371,146,3,5,8,37.5%,33m
33293,3,Schmitty,2371,0,2,4,6,33.3%,22m
33293,3,NidhoogBeast,2371,60,2,6,8,25.0%,6m
33293,3,SNP,2371,62,2,8,10,20.0%,49m
33293,3,ale,2371,97,1,1,2,50.0%,1h
33293,1,Westopolis,2371,0,1,4,5,20.0%,3h
33293,1,unclebernie,2371,0,1,4,5,20.0%,58m
33293,1,superpants,2371,0,1,4,5,20.0%,3h
33293,1,Uhthis,2371,0,1,4,5,20.0%,2m
33293,1,Dmoy,2371,36,1,5,6,16.7%,41m
33293,1,bichuken,2371,0,0,1,1,0.0%,13m
33293,3,[SloBum]jtwojbeast,2371,0,0,4,4,0.0%,1h
33326,3,Peril,2370,1555,156,149,305,51.1%,3h
33326,3,Mobius,2370,1167,128,118,246,52.0%,3h
33326,1,BGERO,2370,1081,80,80,160,50.0%,1h
33326,3,Carlyle,2370,518,50,31,81,61.7%,1h
33326,1,maldypants,2370,1382,48,34,82,58.5%,3h
33326,2,barluda,2370,1043,46,48,94,48.9%,58m
33326,3,TDAVIS,2370,450,43,28,71,60.6%,25m
33326,2,Cyondor,2370,464,41,37,78,52.6%,1h
33326,1,Sonny,2370,1112,35,32,67,52.2%,58m
33326,3,paulns,2370,978,35,43,78,44.9%,1h
33326,3,HaNz,2370,930,34,39,73,46.6%,40m
33326,3,Boushiki,2370,814,33,34,67,49.3%,1h
33326,3,GOÐ,2370,620,30,33,63,47.6%,1h
33326,3,Focho,2370,667,27,27,54,50.0%,1h
33326,1,Weezer,2370,554,19,11,30,63.3%,58m
33326,3,Confidant,2370,570,19,26,45,42.2%,3h
33326,3,Cosmo,2370,388,15,16,31,48.4%,3h
33326,1,NoRushTen,2370,426,11,12,23,47.8%,1h
33326,1,[QuaSa]Lexinator,2370,235,7,5,12,58.3%,46m
33326,3,GangGang,2370,196,6,7,13,46.2%,3h
33326,3,Xiuhcoatl,2370,217,6,9,15,40.0%,17m
33326,3,Blksheepwall,2370,150,6,15,21,28.6%,37m
33326,1,Leon,2370,92,3,2,5,60.0%,21m
33326,1,DeathLeopard,2370,0,3,2,5,60.0%,1h
33326,3,[Mexxco]CRIS,2370,88,3,6,9,33.3%,29m
33326,1,jraul,2370,96,3,6,9,33.3%,1h
33326,3,nerror,2370,49,3,7,10,30.0%,9m
33326,3,TheRealOne,2370,40,3,7,10,30.0%,3h
33326,1,Maureencita,2370,42,2,0,2,100.0%,3h
33326,3,JulioPonce,2370,97,2,1,3,66.7%,19m
33326,1,Chepaev,2370,97,2,4,6,33.3%,28m
33326,3,Stacks,2370,0,1,0,1,100.0%,1h
33326,1,[TACOST]Abundio,2370,0,1,0,1,100.0%,3h
33326,3,Admiral,2370,30,1,4,5,20.0%,1h
33326,1,Rogue,2370,0,1,4,5,20.0%,3h
33326,1,dudemanski,2370,0,0,1,1,0.0%,57m
33362,2,VIPERJ,2369,1208,44,50,94,46.8%,3h
33362,3,Hailey,2369,939,41,34,75,54.7%,3h
33362,3,mrkisawsome,2369,655,29,23,52,55.8%,54m
33362,2,Nevermore,2369,754,23,51,74,31.1%,18m
33362,3,highwater,2369,538,20,19,39,51.3%,1h
33362,3,Loon,2369,438,20,20,40,50.0%,50m
33362,3,Orion,2369,350,18,14,32,56.2%,19m
33362,1,OJay,2369,626,16,14,30,53.3%,3h
33362,1,Rooke,2369,556,15,9,24,62.5%,3h
33362,2,SnZgt,2369,318,13,18,31,41.9%,41m
33362,1,UncrwnedKing,2369,494,12,9,21,57.1%,3h
33362,3,Amish,2369,326,11,8,19,57.9%,3h
33362,3,[SPQ]RMJ,2369,196,10,11,21,47.6%,54m
33362,3,DorjeDradul,2369,240,9,13,22,40.9%,40m
33362,2,Junction,2369,245,9,15,24,37.5%,3h
33362,3,[coins]Terramo,2369,208,8,9,17,47.1%,3h
33362,1,Krboncito,2369,152,8,11,19,42.1%,3h
33362,1,attik,2369,32,4,7,11,36.4%,56m
33362,3,YagamiLight,2369,34,3,4,7,42.9%,9m
33362,1,FENIX,2369,86,2,2,4,50.0%,3h
33362,1,[PudS1]FazzyJ,2369,0,1,0,1,100.0%,1h
33362,1,MediAzero,2369,0,1,0,1,100.0%,3h
33362,1,[Xtre]Skailen,2369,73,1,1,2,50.0%,1h
33362,3,VORTEX,2369,0,1,2,3,33.3%,1h
33362,1,lobogelido,2369,73,1,2,3,33.3%,3h
33362,1,MAQUINAJHON,2369,0,1,3,4,25.0%,1h
33362,1,Drizzo,2369,0,1,4,5,20.0%,1h
33362,3,DrDacosta,2369,0,0,2,2,0.0%,3h
33390,3,Wukaa,2368,1344,81,70,151,53.6%,1h
33390,1,Nykidemus,2368,999,74,66,140,52.9%,1h
33390,2,serghero,2368,683,54,59,113,47.8%,55m
33390,3,Gundamsystem,2368,664,39,36,75,52.0%,1h
33390,3,macedon,2368,737,31,27,58,53.4%,1h
33390,1,santisgamer,2368,980,30,28,58,51.7%,48m
33390,1,[1ight]GOÐ,2368,658,22,18,40,55.0%,3h
33390,3,[EvilCC]oOoYaMiNoOo,2368,411,15,14,29,51.7%,27m
33390,3,ScumbagSteve,2368,316,11,15,26,42.3%,1h
33390,3,pricesfork,2368,330,11,18,29,37.9%,5m
33390,3,Cthulhu,2368,231,10,13,23,43.5%,1h
33390,2,BiggerBag,2368,181,7,11,18,38.9%,41m
33390,3,xXjFeSpeCtXx,2368,203,6,8,14,42.9%,40m
33390,2,Julies,2368,183,6,10,16,37.5%,1h
33390,2,Datacore,2368,230,5,9,14,35.7%,17m
33390,3,Merengue,2368,146,5,11,16,31.2%,1h
33390,1,[ZergW]Richy,2368,86,3,0,3,100.0%,21m
33390,1,pasterostar,2368,42,2,1,3,66.7%,3h
33390,3,Draybengame,2368,97,2,1,3,66.7%,24m
33390,3,Stig,2368,94,2,5,7,28.6%,1h
33390,2,NikMik,2368,88,2,6,8,25.0%,3h
33390,1,[Bullys]Laffnman,2368,0,1,0,1,100.0%,3h
33390,1,ShivenDraco,2368,46,1,1,2,50.0%,1h
33390,1,Squid,2368,0,1,2,3,33.3%,3h
33390,1,Ebayy,2368,0,1,4,5,20.0%,1h
33390,1,matracador,2368,0,0,1,1,0.0%,13m
33390,3,EIGHTPLACE,2368,0,0,2,2,0.0%,60m
33390,3,Guido,2368,0,0,3,3,0.0%,3h
33390,3,juanpablo,2368,0,0,3,3,0.0%,33m
33390,1,Proverbs,2368,0,0,6,6,0.0%,12m
33420,1,njclout,2367,1373,47,41,88,53.4%,3h
33420,1,chabelin,2367,1186,39,38,77,50.6%,38m
33420,2,[TMKOs]Grifing,2367,628,39,38,77,50.6%,54m
33420,3,azure,2367,819,33,37,70,47.1%,60m
33420,3,[PREVI]NEOCANEX,2367,602,31,22,53,58.5%,47m
33420,3,[TPOTR]SpicerPirate,2367,760,30,28,58,51.7%,3h
33420,1,Squadron,2367,579,18,8,26,69.2%,21m
33420,3,Kabraxis,2367,419,16,11,27,59.3%,10m
33420,3,AustinPowers,2367,443,14,18,32,43.8%,33m
33420,3,Grim,2367,324,12,15,27,44.4%,1h
33420,3,Tycicle,2367,281,10,7,17,58.8%,33m
33420,1,[nieBla]ARES,2367,360,9,3,12,75.0%,49m
33420,2,BelethBael,2367,216,9,10,19,47.4%,3h
33420,1,[ValidG]radio,2367,256,9,11,20,45.0%,3h
33420,1,Flash,2367,118,3,2,5,60.0%,21m
33420,3,Gobalt,2367,119,3,3,6,50.0%,3h
33420,3,xxViruSxx,2367,88,3,6,9,33.3%,3h
33420,3,MITIC,2367,92,3,7,10,30.0%,1h
33420,1,[ADDU]VanHoenheim,2367,133,2,2,4,50.0%,21m
33420,1,LungSmalls,2367,44,2,4,6,33.3%,38m
33420,1,[pinoy]EightySixJun,2367,48,2,5,7,28.6%,42m
33420,1,RumHam,2367,0,1,0,1,100.0%,3h
33420,1,Achilles,2367,0,1,1,2,50.0%,3h
33420,1,Mirage,2367,0,1,5,6,16.7%,1h
33420,1,[Batmam]Felipe,2367,0,0,1,1,0.0%,1h
33420,1,Barin,2367,0,0,2,2,0.0%,3h
33420,1,hakrsakr,2367,0,0,2,2,0.0%,1h
33420,3,Beloved,2367,0,0,3,3,0.0%,3h
33448,3,Deimyts,2366,1231,114,103,217,52.5%,1h
33448,3,xiagivccd,2366,1484,104,107,211,49.3%,1h
33448,3,Gabe,2366,1523,71,52,123,57.7%,17m
33448,3,RukoOkur,2366,1092,53,43,96,55.2%,14m
33448,3,Gingivitis,2366,971,46,37,83,55.4%,1h
33448,3,Folstag,2366,562,24,24,48,50.0%,49m
33448,3,KiritoGames,2366,343,15,8,23,65.2%,56m
33448,1,Timinator,2366,547,14,8,22,63.6%,36m
33448,3,TestamenT,2366,404,14,18,32,43.8%,3h
33448,1,DJShaky,2366,294,10,14,24,41.7%,32m
33448,1,ErickDM,2366,368,9,10,19,47.4%,3h
33448,3,FREEDOM,2366,222,6,9,15,40.0%,3h
33448,1,Tehufn,2366,172,5,2,7,71.4%,1h
33448,1,paladindk,2366,225,5,7,12,41.7%,49m
33448,3,[AKMRD]Titomg,2366,154,5,11,16,31.2%,1h
33448,3,Lightspectre,2366,126,4,3,7,57.1%,1h
33448,3,map,2366,167,4,8,12,33.3%,1h
33448,1,Cuervo,2366,44,3,3,6,50.0%,21m
33448,3,[BVWG]HellBorn,2366,90,2,2,4,50.0%,34m
33448,3,[SKO]symMEISTER,2366,0,2,6,8,25.0%,1h
33448,1,[TESTI]Petherhausen,2366,0,1,0,1,100.0%,1h
33448,3,skynet,2366,0,1,1,2,50.0%,3h
33448,1,EmperikaL,2366,0,1,4,5,20.0%,3h
33448,3,aerknard,2366,30,1,4,5,20.0%,1h
33448,1,TasteeStuff,2366,0,1,4,5,20.0%,3h
33448,3,LiLFunNy,2366,0,1,5,6,16.7%,1h
33448,1,[UniVVV]hasudrone,2366,0,0,1,1,0.0%,3h
33448,3,andrewsebass,2366,0,0,1,1,0.0%,1h
33448,1,xgomljoecatx,2366,0,0,1,1,0.0%,11m
33448,1,Pouding,2366,0,0,1,1,0.0%,1h
33448,1,[DRDOOM]Enotic,2366,0,0,2,2,0.0%,2m
33448,3,Fermiman,2366,0,0,3,3,0.0%,10m
33480,3,Aloha,2365,1602,312,300,612,51.0%,39m
33480,3,Fixer,2365,870,195,193,388,50.3%,33m
33480,3,rhpmike,2365,1097,76,75,151,50.3%,1h
33480,1,Alt,2365,1579,73,63,136,53.7%,1h
33480,3,Nyoei,2365,1086,73,77,150,48.7%,15m
33480,3,[NoBads]Halcyon,2365,1336,57,53,110,51.8%,1h
33480,1,[DBLCHZ]Butterpine,2365,1433,49,45,94,52.1%,3m
33480,2,VoodooChild,2365,967,38,37,75,50.7%,1h
33480,3,TheSecondPud,2365,603,25,20,45,55.6%,47m
33480,1,PlatooN,2365,675,24,21,45,53.3%,3h
33480,3,IIIIIII,2365,478,22,26,48,45.8%,12m
33480,1,[4Etern]fuzzman,2365,446,13,8,21,61.9%,36m
33480,3,eoconn,2365,230,13,11,24,54.2%,1h
33480,1,Tamamo,2365,252,9,17,26,34.6%,1h
33480,3,APESTOSIN,2365,268,8,9,17,47.1%,3h
33480,1,Blundt,2365,157,6,5,11,54.5%,60m
33480,2,HuskyFolower,2365,175,6,9,15,40.0%,1h
33480,2,[Patrol]Tmac,2365,199,6,10,16,37.5%,1h
33480,1,Sswagh,2365,154,4,6,10,40.0%,38m
33480,3,KingSlayer,2365,145,4,7,11,36.4%,22m
33480,3,Ghostman,2365,122,4,10,14,28.6%,3h
33480,1,[EvilCC]mcfly,2365,80,3,0,3,100.0%,32m
33480,2,[MoBaW]Deflecto,2365,0,3,5,8,37.5%,25m
33480,3,epic,2365,58,3,7,10,30.0%,3h
33480,1,Spud,2365,0,1,0,1,100.0%,38m
33480,1,[M1N1]comrade,2365,0,1,0,1,100.0%,3h
33480,1,guiltyorphan,2365,0,1,0,1,100.0%,1h
33480,1,MrEarl,2365,44,1,1,2,50.0%,1h
33480,1,LieboutAbuse,2365,0,1,1,2,50.0%,3m
33480,1,genk,2365,0,1,1,2,50.0%,3h
33480,1,Miki,2365,0,1,2,3,33.3%,1h
33480,3,[3HMONG]Danny,2365,30,1,5,6,16.7%,56m
33480,1,bathory,2365,0,0,2,2,0.0%,3h
33513,2,[UNALM]MaxRG,2364,1477,68,64,132,51.5%,23m
33513,3,devastator,2364,1106,56,40,96,58.3%,1h
33513,3,Lvzbel,2364,614,32,33,65,49.2%,54m
33513,2,Haindall,2364,550,20,26,46,43.5%,3h
33513,3,MurderMage,2364,444,16,19,35,45.7%,19m
33513,2,pyroticaster,2364,419,15,20,35,42.9%,23m
33513,1,Diophantus,2364,456,12,10,22,54.5%,58m
33513,3,Venoma,2364,331,12,17,29,41.4%,3h
33513,2,[blub0i]Kirazoya,2364,206,8,4,12,66.7%,3h
33513,3,Black,2364,116,5,7,12,41.7%,29m
33513,3,[αXLa]SlaveGael,2364,155,4,3,7,57.1%,31m
33513,1,[AbcCo]Monfy,2364,84,3,0,3,100.0%,3h
33513,1,[AiUn]Kascadez,2364,179,3,6,9,33.3%,25m
33513,1,Alybaba,2364,48,2,5,7,28.6%,39m
33513,1,Zeratul,2364,40,2,5,7,28.6%,21m
33513,3,Johan,2364,0,2,6,8,25.0%,34m
33513,1,mosinr,2364,73,2,7,9,22.2%,22m
33513,1,Pavinger,2364,0,1,0,1,100.0%,10m
33513,1,TPizzle,2364,0,1,4,5,20.0%,3h
33513,3,busfullonuns,2364,0,1,5,6,16.7%,3h
33513,1,Jones,2364,0,0,1,1,0.0%,4m
33513,1,Funhole,2364,0,0,3,3,0.0%,1m
33513,3,[BCNa]Nocturnel,2364,0,0,4,4,0.0%,1h
33513,3,DreadErick,2364,0,0,5,5,0.0%,47m
33537,3,xNataS,2363,1462,82,80,162,50.6%,1h
33537,3,EmblazedOnyx,2363,1411,56,52,108,51.9%,1h
33537,3,[VODK]Fuquito,2363,979,48,34,82,58.5%,1h
33537,3,zealofwar,2363,765,46,49,95,48.4%,39m
33537,1,[NSushi]APalestino,2363,1058,33,26,59,55.9%,54m
33537,3,Cooldowns,2363,550,23,21,44,52.3%,54m
33537,2,onlyWin,2363,279,22,34,56,39.3%,31m
33537,1,pulse,2363,555,19,16,35,54.3%,58m
33537,3,zOret,2363,401,19,17,36,52.8%,3h
33537,1,Oladuthar,2363,534,16,12,28,57.1%,1h
33537,1,EvilECP,2363,502,15,13,28,53.6%,1h
33537,1,sdkf,2363,286,11,7,18,61.1%,55m
33537,1,[3GG]Souffle,2363,428,11,12,23,47.8%,11m
33537,3,Garfias,2363,358,11,14,25,44.0%,3h
33537,3,noobynewbs,2363,306,11,15,26,42.3%,1h
33537,3,lalo,2363,262,10,8,18,55.6%,3h
33537,1,RabbidLesbo,2363,288,9,6,15,60.0%,21m
33537,1,iEatGlue,2363,204,9,12,21,42.9%,3h
33537,2,Kenji,2363,188,6,7,13,46.2%,46m
33537,1,MediateMouse,2363,202,5,5,10,50.0%,5m
33537,1,Sync,2363,62,5,8,13,38.5%,1h
33537,3,exaltedshmo,2363,166,4,6,10,40.0%,3h
33537,2,Huntfalow,2363,72,3,0,3,100.0%,3h
33537,3,Lachy,2363,88,3,4,7,42.9%,3h
33537,3,TomysCiborg,2363,64,3,7,10,30.0%,27m
33537,3,[CDXXL]decky,2363,126,2,6,8,25.0%,3h
33537,1,armaSoAmaze,2363,0,1,0,1,100.0%,25m
33537,3,[PEQL]Hysteria,2363,0,1,2,3,33.3%,33m
33537,1,FarmerGiles,2363,46,1,3,4,25.0%,1h
33537,1,Yeyo,2363,38,1,3,4,25.0%,35m
33537,1,Sislix,2363,0,1,4,5,20.0%,12m
33537,1,Vastatur,2363,0,1,5,6,16.7%,39m
33537,1,FrankNBeans,2363,0,0,1,1,0.0%,3h
33537,1,Sanelite,2363,0,0,2,2,0.0%,5m
33537,3,Zilencet,2363,0,0,3,3,0.0%,1h
33572,3,ladyTina,2362,1601,273,266,539,50.6%,3h
33572,2,annuler,2362,1063,78,84,162,48.1%,41m
33572,2,TwelveSeven,2362,1154,48,47,95,50.5%,1h
33572,2,[AbcCo]Roy,2362,705,33,39,72,45.8%,2m
33572,2,Ghostrider,2362,854,31,36,67,46.3%,3h
33572,1,posses,2362,737,22,20,42,52.4%,1h
33572,3,WOLLKATZE,2362,316,12,15,27,44.4%,3h
33572,3,[Ballz]VespaDrone,2362,245,8,8,16,50.0%,49m
33572,3,lilmold,2362,122,5,6,11,45.5%,54m
33572,1,simulation,2362,141,3,1,4,75.0%,3h
33572,1,THEShooter,2362,134,3,4,7,42.9%,1h
33572,1,Dragon,2362,130,3,5,8,37.5%,21m
33572,3,Espoir,2362,58,3,7,10,30.0%,3h
33572,1,KazDKazzy,2362,46,2,0,2,100.0%,1h
33572,1,[Venudo]FLEIA,2362,92,2,3,5,40.0%,44m
33572,2,Mortisskrum,2362,30,2,4,6,33.3%,2m
33572,1,[BLTTLB]Kalorbins,2362,0,1,0,1,100.0%,5m
33572,1,[pogga]GreenPenguin,2362,0,1,1,2,50.0%,29m
33572,1,[SRank]EvilOreoCake,2362,0,1,4,5,20.0%,3h
33572,1,Moua,2362,0,1,4,5,20.0%,15m
33572,1,[KiMBR]Laizen,2362,0,0,1,1,0.0%,54m
33572,1,Sarpedon,2362,0,0,1,1,0.0%,28m
33572,1,AlCapwn,2362,0,0,3,3,0.0%,29m
33572,1,mArK,2362,73,0,4,4,0.0%,3h
33596,2,[Pécov]MarcioBaptis,2361,1295,117,122,239,49.0%,3h
33596,3,LogDog,2361,867,88,95,183,48.1%,1h
33596,3,[EpicG]johny,2361,1512,87,81,168,51.8%,34m
33596,3,[Aw00ga]GasPasser,2361,1202,83,85,168,49.4%,34m
33596,3,PrinceKing,2361,936,67,64,131,51.1%,3h
33596,1,Sebastian,2361,1488,55,66,121,45.5%,17m
33596,3,Ethan,2361,394,51,42,93,54.8%,54m
33596,3,Balvenie,2361,1373,50,51,101,49.5%,55m
33596,3,SrSQUANCHYdc,2361,995,45,34,79,57.0%,1h
33596,3,Gold,2361,1223,45,52,97,46.4%,1h
33596,1,Pumpkinpod,2361,891,27,25,52,51.9%,3h
33596,1,Roku,2361,793,25,21,46,54.3%,1h
33596,2,Ripnugget,2361,610,22,28,50,44.0%,37m
33596,3,CHUNCHUNMARU,2361,417,15,21,36,41.7%,34m
33596,2,Wolfey,2361,476,15,38,53,28.3%,38m
33596,2,[SQWD]Earthbend,2361,245,9,11,20,45.0%,3h
33596,1,[GOPERÚ]Danatextraño,2361,307,8,3,11,72.7%,40m
33596,3,[wheres]vvaldo,2361,208,8,7,15,53.3%,14m
33596,1,trevix,2361,168,5,2,7,71.4%,1h
33596,3,XxLLxX,2361,156,4,7,11,36.4%,31m
33596,1,[TOG]PickleRick,2361,0,3,2,5,60.0%,1h
33596,1,[kaYomi]pokefeli,2361,128,3,2,5,60.0%,3h
33596,1,InfernEx,2361,96,3,2,5,60.0%,3h
33596,3,THenley,2361,38,3,6,9,33.3%,1h
33596,1,Sanghoonio,2361,0,1,1,2,50.0%,3h
33596,1,Schwarzenegg,2361,48,1,2,3,33.3%,3h
33596,3,Blackelk,2361,0,1,2,3,33.3%,1h
33596,3,dvelz,2361,30,1,4,5,20.0%,27m
33596,1,Dancinonyofa,2361,42,1,4,5,20.0%,15m
33596,3,RaffaLoko,2361,0,1,5,6,16.7%,1h
33596,1,Kizzal,2361,0,0,1,1,0.0%,1h
33596,1,Khan,2361,0,0,2,2,0.0%,45m
33596,3,[FUERTE]misaelo,2361,0,0,2,2,0.0%,13m
33596,3,TaLGhost,2361,0,0,2,2,0.0%,19m
33630,1,xxLodgeOnexx,2360,1538,237,250,487,48.7%,20m
33630,2,BrainPain,2360,1365,73,56,129,56.6%,54m
33630,1,[MPC]Belikin,2360,1524,53,49,102,52.0%,3h
33630,1,dillardino,2360,1218,43,31,74,58.1%,3h
33630,3,Xasdex,2360,1010,40,37,77,51.9%,49m
33630,1,Slappy,2360,712,21,21,42,50.0%,3h
33630,3,pepegrillo,2360,391,14,15,29,48.3%,3h
33630,2,YesMeLord,2360,404,14,19,33,42.4%,3h
33630,1,Lancelot,2360,422,11,13,24,45.8%,49m
33630,1,PolarBear,2360,172,5,0,5,100.0%,3h
33630,1,Edem,2360,128,4,2,6,66.7%,3h
33630,2,[MURKYA]ARAN,2360,138,4,8,12,33.3%,29m
33630,3,[FKTRUK]Hero,2360,92,4,9,13,30.8%,39m
33630,3,vendettaC,2360,32,3,6,9,33.3%,34m
33630,3,Bigdaddy,2360,123,3,6,9,33.3%,1h
33630,3,[TVtwit]CheeseTroll,2360,120,2,3,5,40.0%,54m
33630,1,NightDownsey,2360,48,2,5,7,28.6%,15m
33630,1,[LBYC]YoungBlood,2360,0,1,2,3,33.3%,3h
33630,1,aldargames,2360,0,1,4,5,20.0%,57m
33630,1,thor,2360,0,1,4,5,20.0%,1h
33630,1,AmE,2360,0,0,2,2,0.0%,3h
33651,3,IkerAS,2359,1570,184,192,376,48.9%,21m
33651,3,Nova,2359,1534,143,139,282,50.7%,49m
33651,3,Wolf,2359,1566,117,109,226,51.8%,27m
33651,3,TomatoFarmer,2359,1401,103,106,209,49.3%,3h
33651,3,MrMayhem,2359,1507,78,86,164,47.6%,43m
33651,2,Polybius,2359,1254,53,52,105,50.5%,3h
33651,3,TREVORIANO,2359,997,45,46,91,49.5%,1h
33651,3,OnlyRick,2359,702,31,25,56,55.4%,1h
33651,2,Corynna,2359,682,30,22,52,57.7%,1h
33651,1,Appexx,2359,730,30,29,59,50.8%,1h
33651,3,ShadowDragon,2359,752,28,32,60,46.7%,3h
33651,3,ttsou,2359,612,23,23,46,50.0%,3h
33651,2,HARrassment,2359,552,23,26,49,46.9%,50m
33651,2,[frijol]CapPPN,2359,576,21,29,50,42.0%,3h
33651,3,[IiUiI]blinkGhost,2359,326,12,15,27,44.4%,32m
33651,2,FYTSone,2359,220,9,16,25,36.0%,26m
33651,1,Iroqouis,2359,250,7,5,12,58.3%,1h
33651,1,[fap69]MaKySan,2359,263,6,3,9,66.7%,3h
33651,1,tugfa,2359,192,6,4,10,60.0%,1h
33651,1,Prestdo,2359,254,6,6,12,50.0%,1h
33651,1,[LoShay]Draiquin,2359,157,5,5,10,50.0%,38m
33651,3,Unorthodox,2359,88,4,9,13,30.8%,1h
33651,1,SirDox,2359,120,3,4,7,42.9%,3h
33651,1,ElvoidPlay,2359,48,2,1,3,66.7%,49m
33651,2,Thomas,2359,0,2,6,8,25.0%,3h
33651,3,Cavain,2359,0,1,5,6,16.7%,1h
33651,3,ronpaulcoin,2359,0,1,5,6,16.7%,1h
33651,3,[GenVZ]QuickDropz,2359,0,0,1,1,0.0%,42m
33651,1,Birdo,2359,0,0,1,1,0.0%,1h
33651,1,SometimesCan,2359,0,0,1,1,0.0%,1h
33651,3,Sweet,2359,0,0,4,4,0.0%,43m
33682,3,dbx,2358,1569,155,160,315,49.2%,21m
33682,2,Daweed,2358,1480,97,98,195,49.7%,8m
33682,3,Spartacus,2358,1092,43,43,86,50.0%,27m
33682,3,[scMAUI]Endymion,2358,923,34,39,73,46.6%,1h
33682,2,NightRaven,2358,942,34,41,75,45.3%,3h
33682,2,FanTom,2358,519,28,26,54,51.9%,34m
33682,3,[ECrush]FcoLomas,2358,453,16,17,33,48.5%,9m
33682,1,Pieroagw,2358,377,13,2,15,86.7%,1h
33682,1,[diaman]takuH,2358,266,9,4,13,69.2%,39m
33682,3,MARP,2358,129,6,9,15,40.0%,39m
33682,1,Vardyn,2358,169,5,2,7,71.4%,1h
33682,1,DaOriginalGG,2358,137,5,8,13,38.5%,3h
33682,3,TiTanIum,2358,106,5,10,15,33.3%,1h
33682,1,Gronkmen,2358,120,4,0,4,100.0%,3h
33682,1,[AVSC]Artucraft,2358,0,2,2,4,50.0%,1h
33682,1,Asystole,2358,96,2,3,5,40.0%,1h
33682,1,Hivemind,2358,0,2,3,5,40.0%,1h
33682,3,Manuelito,2358,96,2,5,7,28.6%,30m
33682,1,Jeyplay,2358,48,1,2,3,33.3%,1h
33682,3,dimchee,2358,0,1,5,6,16.7%,1h
33682,3,ElVato,2358,0,0,1,1,0.0%,7m
33682,1,Coninox,2358,0,0,1,1,0.0%,46m
33682,2,KasTaH,2358,0,0,2,2,0.0%,3h
33705,3,Oscar,2357,1478,140,133,273,51.3%,10m
33705,1,[MAJ0R]Kusanagi,2357,1433,108,122,230,47.0%,3m
33705,3,seansc,2357,1441,91,88,179,50.8%,18m
33705,3,ORen,2357,1049,84,82,166,50.6%,14m
33705,3,[CFHfh]mvanucci,2357,937,76,67,143,53.1%,5m
33705,1,Zealot,2357,1525,73,66,139,52.5%,39m
33705,2,[AZPK]Nakamoto,2357,1277,61,59,120,50.8%,5m
33705,3,[FAITES]tanghelo,2357,931,42,45,87,48.3%,1h
33705,1,[HBDO]MENULOG,2357,1018,40,46,86,46.5%,1h
33705,2,Mecs,2357,950,38,37,75,50.7%,1h
33705,2,Combustion,2357,838,28,37,65,43.1%,55m
33705,2,VDkF,2357,272,21,21,42,50.0%,46m
33705,1,SirLouis,2357,544,18,9,27,66.7%,3h
33705,3,Steeves,2357,429,18,13,31,58.1%,40m
33705,3,BeatNIX,2357,428,14,23,37,37.8%,1h
33705,1,[x9o5x]SonGOKU,2357,334,8,3,11,72.7%,22m
33705,2,IIIIIIIIIIII,2357,282,8,9,17,47.1%,1h
33705,3,Berfdz,2357,218,7,7,14,50.0%,54m
33705,1,frnkjr,2357,266,7,10,17,41.2%,3h
33705,3,[DmnTz]Samura,2357,136,6,4,10,60.0%,56m
33705,3,ExistentialC,2357,199,6,10,16,37.5%,30m
33705,1,sass,2357,172,5,2,7,71.4%,3h
33705,1,kakaname,2357,218,5,4,9,55.6%,3h
33705,1,Jbeazy,2357,164,5,7,12,41.7%,1h
33705,2,Higgsboson,2357,82,4,9,13,30.8%,45m
33705,3,khaldrogo,2357,149,3,2,5,60.0%,1h
33705,1,[lolies]OniiChanWant,2357,48,3,2,5,60.0%,54m
33705,1,TerranYouUp,2357,120,3,5,8,37.5%,51m
33705,3,[JAR]TheNightKing,2357,30,3,6,9,33.3%,43m
33705,1,DavidCr,2357,30,3,7,10,30.0%,51m
33705,3,kring,2357,62,2,8,10,20.0%,1h
33705,1,RAWR,2357,0,1,1,2,50.0%,3h
33705,1,[RUMB]Player,2357,40,1,1,2,50.0%,3h
33705,3,[Rohiov]Rohiov,2357,34,1,1,2,50.0%,39m
33705,1,Pulsar,2357,0,1,4,5,20.0%,3h
33705,1,[GOPERÚ]FANTASMAgogo,2357,0,1,6,7,14.3%,1h
33705,1,Saphyron,2357,0,0,2,2,0.0%,3h
33705,2,Niceman,2357,0,0,2,2,0.0%,5m
33705,1,Parga,2357,0,0,3,3,0.0%,38m
33744,1,[ZyrG]Kraus,2356,760,170,175,345,49.3%,3h
33744,2,callmedadi,2356,1593,129,132,261,49.4%,1h
33744,2,[IOgI]Kuhoolyn,2356,1258,101,105,206,49.0%,1h
33744,3,[FNTSTC]Fox,2356,1014,76,63,139,54.7%,17m
33744,3,Amsterdam,2356,1567,62,59,121,51.2%,1h
33744,2,Dragonslayer,2356,673,62,65,127,48.8%,52m
33744,1,[33OP]DiamondKTK,2356,1570,51,47,98,52.0%,5m
33744,1,AndrossTrue,2356,1121,37,27,64,57.8%,10m
33744,3,[TOP7]Fredyviper,2356,742,34,33,67,50.7%,1h
33744,3,StaleCracker,2356,772,26,35,61,42.6%,1h
33744,3,SebastianCN,2356,584,22,27,49,44.9%,1h
33744,3,Chunks,2356,538,21,23,44,47.7%,1h
33744,1,Blank,2356,384,11,13,24,45.8%,58m
33744,3,Impulse,2356,286,10,13,23,43.5%,3h
33744,1,iony,2356,306,8,6,14,57.1%,8m
33744,1,[TEKN]radtereon,2356,230,8,10,18,44.4%,5m
33744,1,[Shang]Scythe,2356,196,7,4,11,63.6%,3h
33744,1,[PTANFW]JVpew,2356,198,7,6,13,53.8%,3h
33744,1,AaronzxcPro,2356,273,7,7,14,50.0%,3h
33744,1,wisthons,2356,172,7,10,17,41.2%,51m
33744,1,[FL4PS]FUDGEFLAPS,2356,207,6,5,11,54.5%,49m
33744,3,BiLiCoOO,2356,192,6,15,21,28.6%,1h
33744,3,IIURANOSII,2356,146,5,11,16,31.2%,43m
33744,3,BoilerXVI,2356,136,3,7,10,30.0%,1h
33744,2,ForTheLulz,2356,42,3,9,12,25.0%,38m
33744,3,Olimac,2356,60,2,5,7,28.6%,34m
33744,1,Astronomync,2356,0,1,0,1,100.0%,3h
33744,1,DireWolf,2356,44,1,1,2,50.0%,12m
33744,1,Lingo,2356,46,1,1,2,50.0%,1h
33744,1,blackgendro,2356,44,1,1,2,50.0%,24m
33744,3,Babushka,2356,97,1,2,3,33.3%,13m
33744,3,Zildjian,2356,30,1,8,9,11.1%,3h
33744,2,SpaceTiger,2356,30,1,15,16,6.2%,3h
33744,1,StarLight,2356,0,0,1,1,0.0%,49m
33744,3,puppycat,2356,0,0,3,3,0.0%,1h
33744,1,TheBviruS,2356,0,0,5,5,0.0%,3h
33780,1,[ICTH]Vicious,2355,1881,285,293,578,49.3%,24m
33780,2,mar,2355,1482,124,116,240,51.7%,1h
33780,3,DarthRick,2355,1111,107,90,197,54.3%,16m
33780,2,Wizang,2355,1368,53,60,113,46.9%,14m
33780,2,Daedalus,2355,378,15,13,28,53.6%,54m
33780,1,James,2355,416,10,7,17,58.8%,3h
33780,1,iron,2355,203,7,12,19,36.8%,36m
33780,3,MindoX,2355,238,6,10,16,37.5%,1h
33780,3,[LGNxx]Gouda,2355,175,5,5,10,50.0%,33m
33780,2,LoneRanger,2355,153,4,3,7,57.1%,1h
33780,1,Cbass,2355,129,4,4,8,50.0%,3h
33780,3,asph,2355,122,4,8,12,33.3%,3h
33780,1,Bayonet,2355,82,3,1,4,75.0%,5m
33780,3,THESHIDE,2355,119,3,2,5,60.0%,1h
33780,1,[CHILN]Demo,2355,48,2,4,6,33.3%,1h
33780,1,[SMooK]NARSISTA,2355,0,1,0,1,100.0%,3h
33780,1,junie,2355,0,1,0,1,100.0%,1h
33780,3,bunkwgn,2355,0,1,1,2,50.0%,17m
33780,1,Fresh,2355,0,1,1,2,50.0%,3h
33780,1,ShadePrizRak,2355,48,1,1,2,50.0%,38m
33780,3,Chimaera,2355,30,1,4,5,20.0%,1h
33780,1,SKYLEADER,2355,0,1,4,5,20.0%,22m
33780,1,[Targus]dobisPR,2355,0,0,1,1,0.0%,26m
33780,1,SushiiTCTTV,2355,0,0,1,1,0.0%,1h
33804,2,[Krush]DoUgZ,2354,1554,328,327,655,50.1%,38m
33804,2,hayabusa,2354,1393,98,97,195,50.3%,58m
33804,3,Donkone,2354,1167,68,49,117,58.1%,5m
33804,3,KillaTO,2354,978,46,41,87,52.9%,32m
33804,2,PapaSita,2354,931,39,43,82,47.6%,19m
33804,1,Bassics,2354,651,30,43,73,41.1%,54m
33804,1,PunZao,2354,785,28,33,61,45.9%,58m
33804,1,CommandoBdog,2354,586,19,36,55,34.5%,28m
33804,1,BlakRevolver,2354,434,15,21,36,41.7%,35m
33804,2,Meat,2354,319,13,7,20,65.0%,3h
33804,1,JiPabloskyNa,2354,284,11,13,24,45.8%,49m
33804,3,NARSONER,2354,298,10,10,20,50.0%,25m
33804,3,Rodolfinho,2354,210,8,10,18,44.4%,3h
33804,2,DonTony,2354,220,8,10,18,44.4%,3h
33804,3,Lorenzo,2354,209,8,12,20,40.0%,3h
33804,1,[DNEdge]Nagasaki,2354,229,8,17,25,32.0%,25m
33804,1,pororo,2354,137,6,7,13,46.2%,52m
33804,1,Grummsh,2354,214,5,7,12,41.7%,42m
33804,1,DionsTk,2354,166,4,2,6,66.7%,35m
33804,1,buzzlesworth,2354,82,3,6,9,33.3%,1h
33804,1,[WEgym]BOUNCEN,2354,133,3,7,10,30.0%,13m
33804,3,Diagoras,2354,94,2,3,5,40.0%,1h
33804,1,Broomstick,2354,84,2,6,8,25.0%,1h
33804,3,David,2354,0,1,2,3,33.3%,17m
33804,3,JulzTheBulz,2354,95,1,3,4,25.0%,21m
33804,1,[lIIII1]Boxman,2354,0,1,4,5,20.0%,43m
33804,1,OrcoMalo,2354,0,1,4,5,20.0%,3h
33804,1,EDUARDO,2354,0,1,4,5,20.0%,3h
33804,1,Blaze,2354,0,0,1,1,0.0%,1h
33804,1,NorthernDash,2354,0,0,1,1,0.0%,3h
33834,3,ChiefChimpy,2353,1582,175,177,352,49.7%,49m
33834,3,[Wat3rs]Assassino,2353,1463,150,138,288,52.1%,1h
33834,1,TOPS,2353,1810,108,105,213,50.7%,1h
33834,3,[Pharoh]Vamp,2353,1458,79,87,166,47.6%,9m
33834,3,[Bhros]Feljator,2353,1339,78,77,155,50.3%,28m
33834,1,GGRRAAUUWW,2353,1394,46,39,85,54.1%,15m
33834,3,Bierbaumzwei,2353,703,29,21,50,58.0%,1h
33834,1,Aya,2353,996,29,27,56,51.8%,42m
33834,3,Darwin,2353,585,26,24,50,52.0%,1h
33834,3,Karmaeleon,2353,664,25,26,51,49.0%,5m
33834,1,Chumchum,2353,717,19,14,33,57.6%,20m
33834,3,Cashicoi,2353,440,15,13,28,53.6%,54m
33834,3,NBDad,2353,358,12,17,29,41.4%,1h
33834,1,weebgrape,2353,316,10,10,20,50.0%,3h
33834,1,Krux,2353,210,9,14,23,39.1%,1m
33834,3,peyton,2353,215,8,9,17,47.1%,14m
33834,3,[Eags]mortsco,2353,140,5,6,11,45.5%,22m
33834,3,WILLIAMS,2353,142,5,11,16,31.2%,50m
33834,3,[GHOSDT]CitySidewalk,2353,64,4,9,13,30.8%,1h
33834,1,Xisting,2353,122,3,2,5,60.0%,44m
33834,3,ELPUTAS,2353,30,2,3,5,40.0%,25m
33834,1,Solar,2353,0,1,0,1,100.0%,21m
33834,3,idkfleming,2353,30,1,2,3,33.3%,34m
33834,1,TheSauce,2353,0,1,2,3,33.3%,1h
33834,3,prime,2353,0,1,5,6,16.7%,32m
33834,3,Arphios,2353,0,1,6,7,14.3%,1h
33834,2,[EGx]Butterdarck,2353,0,1,7,8,12.5%,1h
33834,1,dakes,2353,0,0,1,1,0.0%,60m
33834,3,Rodoswar,2353,0,0,2,2,0.0%,3h
33834,1,spotlightkid,2353,0,0,2,2,0.0%,3h
33834,3,[1025]HyperVirus,2353,0,0,6,6,0.0%,5m
33865,3,[FTLT]angelo,2352,1577,180,175,355,50.7%,1h
33865,2,chaddysdaddy,2352,1583,109,118,227,48.0%,3h
33865,1,KillerBee,2352,1798,72,57,129,55.8%,1h
33865,3,Matt,2352,1016,66,49,115,57.4%,33m
33865,1,dirtbird,2352,1315,45,37,82,54.9%,3h
33865,2,Toxicator,2352,241,34,31,65,52.3%,41m
33865,3,ClashOfLings,2352,296,10,14,24,41.7%,3h
33865,1,IIIIIIIII,2352,246,7,3,10,70.0%,3h
33865,1,IIIIIIIIIIII,2352,254,7,7,14,50.0%,3h
33865,3,EltioNakita,2352,120,5,11,16,31.2%,60m
33865,3,MarineLord,2352,146,5,12,17,29.4%,3h
33865,1,ZERO,2352,159,4,3,7,57.1%,60m
33865,2,[Gooman]TonyChunga,2352,140,4,10,14,28.6%,3h
33865,1,INVICTUS,2352,84,3,0,3,100.0%,46m
33865,1,[tCo9]DreamyBudder,2352,133,3,4,7,42.9%,1h
33865,2,Alzales,2352,120,3,6,9,33.3%,2m
33865,2,Macintosh,2352,0,2,5,7,28.6%,1h
33865,1,WWolf,2352,0,1,2,3,33.3%,3h
33865,1,gerkmigy,2352,0,1,4,5,20.0%,59m
33865,1,Boomhauer,2352,0,1,4,5,20.0%,43m
33865,1,VirtuaPT,2352,0,1,4,5,20.0%,1h
33865,1,JonJoe,2352,0,1,4,5,20.0%,4m
33865,1,CoffinNail,2352,0,0,2,2,0.0%,1h
33865,1,Glassman,2352,0,0,2,2,0.0%,49m
33889,1,cancalsusion,2351,1585,501,501,1002,50.0%,20m
33889,3,RELA,2351,1419,89,82,171,52.0%,3h
33889,2,Gabdragon,2351,1171,47,56,103,45.6%,1h
33889,3,Shinwelwensa,2351,852,32,35,67,47.8%,11m
33889,3,[SCTF]Zen,2351,576,21,22,43,48.8%,56m
33889,3,hidsam,2351,614,21,23,44,47.7%,28m
33889,3,hibro,2351,258,10,12,22,45.5%,3h
33889,3,[Flam3s]BattleSpoon,2351,312,10,16,26,38.5%,14m
33889,1,wayward,2351,303,9,17,26,34.6%,3h
33889,3,[LastKT]Ridley,2351,226,7,5,12,58.3%,35m
33889,3,[TPGGXD]MaLeR,2351,189,6,2,8,75.0%,3h
33889,2,kingkong,2351,88,6,7,13,46.2%,1h
33889,3,harleyjuan,2351,58,6,7,13,46.2%,21m
33889,3,JustBlaze,2351,152,6,11,17,35.3%,1h
33889,3,[Cheees]sweetsalad,2351,154,5,7,12,41.7%,3h
33889,2,[Xinji]Xen,2351,117,4,0,4,100.0%,3h
33889,2,Phetality,2351,138,4,4,8,50.0%,46m
33889,3,elpatron,2351,143,4,6,10,40.0%,17m
33889,3,skymaxi,2351,147,4,11,15,26.7%,1h
33889,3,Silvioow,2351,0,3,3,6,50.0%,30m
33889,1,CENP,2351,120,3,4,7,42.9%,3h
33889,1,JoeCamera,2351,46,2,1,3,66.7%,1h
33889,1,[LMI42]BootyLord,2351,44,2,1,3,66.7%,3h
33889,3,Ramona,2351,96,2,5,7,28.6%,1h
33889,1,Alvin,2351,0,1,0,1,100.0%,28m
33889,1,[ShTiLe]sludgeminer,2351,44,1,1,2,50.0%,1h
33889,1,[scMAUI]Jayden,2351,46,1,3,4,25.0%,37m
33889,3,Pixel,2351,0,1,3,4,25.0%,1h
33889,1,Bigbongtoker,2351,44,1,3,4,25.0%,44m
33889,1,IgnoreTaName,2351,0,1,4,5,20.0%,1h
33889,1,Everssen,2351,0,1,4,5,20.0%,29m
33889,3,Calcium,2351,0,1,5,6,16.7%,3h
33889,1,ratt,2351,0,0,1,1,0.0%,3h
33889,1,Voidboy,2351,0,0,1,1,0.0%,3h
33889,1,ElectricEye,2351,0,0,2,2,0.0%,56m
33889,3,Artende,2351,0,0,2,2,0.0%,19m
33889,1,Nol,2351,0,0,3,3,0.0%,1h
33889,3,Kizar,2351,0,0,3,3,0.0%,3h
33927,3,escipion,2350,1649,115,105,220,52.3%,9m
33927,2,[OceanT]Fabusnardo,2350,1491,82,86,168,48.8%,1h
33927,3,TLA,2350,810,65,52,117,55.6%,14m
33927,3,LambKebab,2350,863,50,49,99,50.5%,1h
33927,1,[ZTemps]Ragnarock,2350,1132,37,34,71,52.1%,1h
33927,3,[AbcCo]alpaco,2350,936,36,38,74,48.6%,48m
33927,2,BradleyATG,2350,671,32,32,64,50.0%,7m
33927,1,ValennTeana,2350,971,31,29,60,51.7%,10m
33927,1,Crocop,2350,776,25,22,47,53.2%,15m
33927,3,[EpicG]FLASH,2350,762,25,43,68,36.8%,32m
33927,1,xigency,2350,570,16,8,24,66.7%,41m
33927,3,[mewth]Catman,2350,289,11,12,23,47.8%,54m
33927,1,cameo,2350,303,11,14,25,44.0%,3h
33927,2,retype,2350,238,11,15,26,42.3%,21m
33927,1,Peppone,2350,358,11,19,30,36.7%,1h
33927,1,[TheVD]ZealousShad,2350,326,10,10,20,50.0%,20m
33927,3,FurryTime,2350,230,9,8,17,52.9%,3h
33927,1,innovenision,2350,263,8,7,15,53.3%,1h
33927,1,WildApache,2350,246,7,1,8,87.5%,3h
33927,3,Xibalba,2350,210,6,3,9,66.7%,3h
33927,3,HAJINVATOR,2350,222,6,10,16,37.5%,47m
33927,1,BluTxtOvrGrn,2350,200,5,5,10,50.0%,3h
33927,1,Macklin,2350,204,5,7,12,41.7%,1h
33927,3,BouncyKnight,2350,203,5,8,13,38.5%,27m
33927,1,AceInTheFace,2350,279,5,13,18,27.8%,40m
33927,1,Fizzik,2350,216,4,2,6,66.7%,4m
33927,1,[IF]Paul,2350,0,3,2,5,60.0%,1h
33927,2,MarceloBr,2350,136,3,3,6,50.0%,3h
33927,1,[RdmS]ManuxDDD,2350,48,3,3,6,50.0%,1h
33927,1,SuperMan,2350,46,2,2,4,50.0%,21m
33927,3,demolisher,2350,0,2,4,6,33.3%,1h
33927,1,TAIII,2350,0,1,0,1,100.0%,10m
33927,1,SeoulReaper,2350,0,1,2,3,33.3%,3h
33927,1,Revenant,2350,0,1,4,5,20.0%,38m
33927,2,fer,2350,0,1,4,5,20.0%,1h
33927,1,bisk,2350,0,0,1,1,0.0%,58m
33927,1,theTrite,2350,0,0,1,1,0.0%,1h
33927,1,Pmz,2350,0,0,1,1,0.0%,3h
33927,1,ACERO,2350,0,0,1,1,0.0%,3h
33927,3,FernanYC,2350,0,0,2,2,0.0%,13m
33927,3,WaMpaCDG,2350,0,0,3,3,0.0%,23m
33968,3,[PwnCat]Jah,2349,1255,134,137,271,49.4%,17m
33968,3,Elpepe,2349,1364,117,102,219,53.4%,1h
33968,1,ZergBurger,2349,1822,116,106,222,52.3%,3h
33968,3,[LosFC]FREDYFX,2349,1595,94,101,195,48.2%,1h
33968,2,Jhorman,2349,935,71,85,156,45.5%,3h
33968,3,[Damasc]RODFIC,2349,1139,50,44,94,53.2%,22m
33968,3,DarKsTAr,2349,1328,46,56,102,45.1%,49m
33968,3,Seb,2349,1020,38,40,78,48.7%,12m
33968,1,PaChEcO,2349,461,17,10,27,63.0%,1h
33968,3,Cigarrinho,2349,279,17,19,36,47.2%,1h
33968,2,soulstate,2349,456,15,25,40,37.5%,6m
33968,2,Kuso,2349,244,11,10,21,52.4%,3h
33968,3,RazerTeran,2349,290,10,16,26,38.5%,22m
33968,1,qosa,2349,272,7,6,13,53.8%,1h
33968,1,[MEX501]Pichon,2349,282,7,7,14,50.0%,54m
33968,2,andhual,2349,116,6,9,15,40.0%,7m
33968,1,badatsc,2349,188,5,3,8,62.5%,1h
33968,1,Battlesteak,2349,203,5,5,10,50.0%,3h
33968,1,Stunner,2349,0,4,4,8,50.0%,1h
33968,3,Sklea,2349,64,4,5,9,44.4%,28m
33968,3,Ortho,2349,178,4,6,10,40.0%,40m
33968,1,MartinPlan,2349,124,4,7,11,36.4%,1h
33968,1,Wittelman,2349,104,3,2,5,60.0%,3h
33968,1,MagicEarth,2349,173,3,5,8,37.5%,40m
33968,2,PrinceVegeta,2349,0,3,8,11,27.3%,3h
33968,1,Interceptor,2349,46,2,0,2,100.0%,3h
33968,1,[FWS]Sora,2349,0,2,3,5,40.0%,4m
33968,1,HeisenZerg,2349,88,2,4,6,33.3%,2m
33968,1,RandOm,2349,112,2,6,8,25.0%,49m
33968,1,cyb,2349,46,1,1,2,50.0%,1h
33968,1,Frantik,2349,0,1,1,2,50.0%,3h
33968,1,SmokyDaBear,2349,0,1,3,4,25.0%,1h
33968,1,ELIEZERG,2349,0,0,1,1,0.0%,4m
33968,1,MadaxOlimpus,2349,0,0,1,1,0.0%,15m
33968,1,crazylegz,2349,0,0,2,2,0.0%,3h
33968,1,SuperPooper,2349,0,0,3,3,0.0%,39m
33968,3,Tabender,2349,0,0,3,3,0.0%,3h
33968,3,otuku,2349,0,0,9,9,0.0%,1h
34006,1,lucho,2348,1753,155,142,297,52.2%,3h
34006,1,ELCHD,2348,1842,137,128,265,51.7%,3h
34006,3,RobotWizard,2348,1567,130,130,260,50.0%,21m
34006,3,Lucas,2348,944,82,85,167,49.1%,1h
34006,2,Schutzwolf,2348,1021,49,60,109,45.0%,54m
34006,1,scouter,2348,1213,42,43,85,49.4%,3h
34006,1,[ClapAC]GeneralCavy,2348,1105,39,30,69,56.5%,12m
34006,1,AMagicFatGuy,2348,1080,34,29,63,54.0%,3h
34006,1,ZERO,2348,770,20,24,44,45.5%,3h
34006,3,louddan,2348,306,10,12,22,45.5%,1h
34006,3,NoisE,2348,134,7,4,11,63.6%,3h
34006,3,[Auth]Anthatar,2348,217,6,7,13,46.2%,22m
34006,3,Totaro,2348,220,6,10,16,37.5%,24m
34006,3,MWFriesen,2348,172,5,11,16,31.2%,17m
34006,3,Guybrush,2348,116,4,3,7,57.1%,1h
34006,1,Rami,2348,162,4,6,10,40.0%,56m
34006,3,Evo,2348,114,4,10,14,28.6%,1h
34006,1,Carreironuke,2348,104,3,5,8,37.5%,10m
34006,2,AgentSmith,2348,42,2,3,5,40.0%,3h
34006,3,deguchi,2348,134,2,5,7,28.6%,6m
34006,1,BeRandom,2348,0,1,4,5,20.0%,45m
34006,1,AByCyy,2348,0,1,4,5,20.0%,3h
34006,1,Silence,2348,0,1,4,5,20.0%,1h
34006,1,itachi,2348,0,1,4,5,20.0%,14m
34006,1,[SGOLO]ThillyThnail,2348,0,0,1,1,0.0%,3h
34006,1,OptimusPrime,2348,0,0,1,1,0.0%,56m
34006,1,peluche,2348,0,0,2,2,0.0%,1h
34006,1,Brandon,2348,0,0,2,2,0.0%,3h
34006,3,Ricardo,2348,0,0,2,2,0.0%,60m
34006,3,FrostWolves,2348,0,0,3,3,0.0%,9m
34006,1,overpowerd,2348,0,0,5,5,0.0%,3h
34037,2,KaiserSoze,2347,1596,170,177,347,49.0%,1h
34037,1,Antiaereo,2347,1723,159,158,317,50.2%,29m
34037,1,Arxch,2347,1580,123,135,258,47.7%,52m
34037,3,ptyred,2347,1502,92,114,206,44.7%,22m
34037,2,Zerovelocity,2347,927,72,82,154,46.8%,31m
34037,1,EobardThawne,2347,1340,58,77,135,43.0%,3h
34037,3,Donnadiee,2347,1256,53,48,101,52.5%,1h
34037,1,ahdes,2347,1135,40,39,79,50.6%,1h
34037,1,yunierbello,2347,944,37,23,60,61.7%,3h
34037,1,[THEOLD]lunchbox,2347,731,22,17,39,56.4%,3h
34037,1,FlavinJR,2347,518,22,21,43,51.2%,3h
34037,3,[Sakile]Shadowfall,2347,366,13,13,26,50.0%,1h
34037,2,[Spain]frankk,2347,360,12,26,38,31.6%,1h
34037,1,Lagarto,2347,236,7,2,9,77.8%,3h
34037,1,CriticalM,2347,172,5,3,8,62.5%,40m
34037,1,SubThreeHour,2347,208,5,5,10,50.0%,35m
34037,2,[TB0C]ExcuseMaker,2347,128,5,14,19,26.3%,56m
34037,1,JDBOSU,2347,170,4,4,8,50.0%,5m
34037,3,DerKoarl,2347,149,4,6,10,40.0%,48m
34037,3,Firefrizzle,2347,58,4,7,11,36.4%,24m
34037,3,Quinte,2347,100,4,8,12,33.3%,34m
34037,1,[ASOT]dayenkee,2347,110,3,0,3,100.0%,3h
34037,1,QuBuS,2347,130,3,5,8,37.5%,1h
34037,3,RNGesus,2347,0,2,7,9,22.2%,3h
34037,3,[ADDU]MangKated,2347,97,2,8,10,20.0%,33m
34037,1,Nelzy,2347,0,1,1,2,50.0%,57m
34037,2,Flintstone,2347,0,1,1,2,50.0%,28m
34037,1,ReaListic,2347,44,1,2,3,33.3%,1h
34037,1,mattab,2347,0,1,3,4,25.0%,39m
34037,1,Djangough,2347,0,1,5,6,16.7%,25m
34037,1,red,2347,0,0,1,1,0.0%,54m
34037,1,[Gg20]jaimer,2347,0,0,1,1,0.0%,1h
34037,3,alemanu,2347,0,0,2,2,0.0%,23m
34037,3,shawnshawn,2347,0,0,4,4,0.0%,1h
34071,2,resvictory,2346,1348,176,172,348,50.6%,9m
34071,1,SCalp,2346,1142,118,126,244,48.4%,1h
34071,3,JTFLordBlue,2346,1441,56,56,112,50.0%,22m
34071,3,Mathias,2346,433,49,34,83,59.0%,57m
34071,1,HumbleTiger,2346,791,35,28,63,55.6%,3h
34071,1,RFRAMO,2346,1068,34,33,67,50.7%,3h
34071,3,osofuzzy,2346,631,26,28,54,48.1%,3h
34071,1,SphYnoX,2346,774,22,19,41,53.7%,3h
34071,1,Zephyr,2346,480,13,16,29,44.8%,41m
34071,3,timofy,2346,268,9,9,18,50.0%,39m
34071,1,Nogards,2346,200,7,1,8,87.5%,3h
34071,1,juaquin,2346,234,6,3,9,66.7%,1h
34071,2,Bored,2346,162,4,5,9,44.4%,35m
34071,1,Aries,2346,90,3,1,4,75.0%,1h
34071,1,Cirquee,2346,115,3,1,4,75.0%,3h
34071,1,Ryuichi,2346,92,3,5,8,37.5%,1h
34071,1,Alright,2346,73,3,6,9,33.3%,3h
34071,1,BundlOfStiks,2346,84,2,2,4,50.0%,6m
34071,1,lemonade,2346,97,2,4,6,33.3%,1h
34071,3,biggerboot,2346,30,2,8,10,20.0%,1h
34071,1,RVS,2346,0,1,4,5,20.0%,4m
34071,1,ThArRnGeL,2346,0,1,4,5,20.0%,35m
34071,3,pwndy,2346,30,1,5,6,16.7%,9m
34071,1,Sentinel,2346,0,1,5,6,16.7%,1h
34071,1,Megatron,2346,0,1,5,6,16.7%,4m
34071,1,tom,2346,0,0,1,1,0.0%,58m
34071,1,Xman,2346,0,0,1,1,0.0%,47m
34071,1,MajorHavok,2346,0,0,1,1,0.0%,1h
34071,1,REDoSCOUT,2346,0,0,1,1,0.0%,1h
34071,3,DeeT,2346,0,0,2,2,0.0%,3h
34071,3,[W513]zeus,2346,0,0,2,2,0.0%,20m
34071,3,Bromeo,2346,0,0,2,2,0.0%,1h
34071,1,MrLeading,2346,0,0,3,3,0.0%,1h
34071,3,Goldeneko,2346,0,0,3,3,0.0%,25m
34105,2,HERPIZ,2345,1486,131,124,255,51.4%,36m
34105,3,zonnamothae,2345,973,39,42,81,48.1%,3h
34105,3,[FMX]DarthVader,2345,635,29,17,46,63.0%,46m
34105,3,Terranoise,2345,606,25,18,43,58.1%,16m
34105,1,NECRODRAGON,2345,504,15,14,29,51.7%,1h
34105,3,HentaiJessus,2345,373,14,10,24,58.3%,29m
34105,3,ZeNEXJaned,2345,333,14,32,46,30.4%,42m
34105,1,TheWitch,2345,403,12,12,24,50.0%,1h
34105,3,VIG,2345,391,12,14,26,46.2%,3h
34105,3,TheZergling,2345,252,10,13,23,43.5%,34m
34105,1,RustyShacky,2345,298,10,15,25,40.0%,1h
34105,1,Ripley,2345,318,8,6,14,57.1%,21m
34105,3,[BooKng]RAYNORT,2345,143,4,5,9,44.4%,3h
34105,3,Lezaf,2345,88,4,7,11,36.4%,1h
34105,3,prometeo,2345,86,4,8,12,33.3%,29m
34105,1,Marcuxx,2345,84,3,0,3,100.0%,26m
34105,1,poisonrush,2345,0,3,2,5,60.0%,51m
34105,1,HOLYWAR,2345,72,2,3,5,40.0%,3h
34105,3,Vani,2345,0,2,4,6,33.3%,40m
34105,2,rain,2345,106,2,4,6,33.3%,1h
34105,3,Jello,2345,30,2,6,8,25.0%,10m
34105,2,[B4RN]Bryan,2345,0,2,6,8,25.0%,7m
34105,1,argonzalc,2345,0,1,2,3,33.3%,59m
34105,1,[LZTs]Aiur,2345,0,1,3,4,25.0%,1h
34105,1,[KICKED]CmdrWilmot,2345,0,0,1,1,0.0%,3h
34105,1,[8kPLUS]Hemroid,2345,0,0,1,1,0.0%,1h
34105,1,Lartith,2345,0,0,2,2,0.0%,3h
34132,3,Desertor,2344,1538,227,213,440,51.6%,1h
34132,1,[ConFed]Python,2344,685,176,186,362,48.6%,34m
34132,3,Julian,2344,1622,135,129,264,51.1%,1h
34132,3,Strat,2344,1093,126,121,247,51.0%,3h
34132,2,BOB,2344,1318,98,97,195,50.3%,3h
34132,2,Flech,2344,1280,86,92,178,48.3%,28m
34132,1,zeebeezee,2344,1434,79,81,160,49.4%,1h
34132,2,Gutervin,2344,1001,77,73,150,51.3%,3h
34132,1,JAIME,2344,1042,68,70,138,49.3%,3h
34132,3,OrcoExotico,2344,640,61,66,127,48.0%,1h
34132,2,SimonScott,2344,1366,50,60,110,45.5%,36m
34132,2,[LoE1]BlackbirdArg,2344,697,43,50,93,46.2%,1h
34132,3,Arme,2344,658,41,36,77,53.2%,1h
34132,3,wombatvilage,2344,1016,37,42,79,46.8%,1h
34132,3,MininoFiero,2344,262,12,15,27,44.4%,17m
34132,1,elmaldito,2344,399,11,7,18,61.1%,20m
34132,1,[xBOZOx]PISSJUGS,2344,305,10,14,24,41.7%,1h
34132,1,DuffMcWhalen,2344,278,8,2,10,80.0%,3h
34132,3,GeorgeRayire,2344,210,7,6,13,53.8%,1h
34132,1,[BOLVIA]Daher,2344,208,6,4,10,60.0%,1h
34132,2,TheFlood,2344,186,6,11,17,35.3%,1h
34132,2,Briariose,2344,90,5,5,10,50.0%,3h
34132,3,djtal,2344,150,5,10,15,33.3%,9m
34132,3,ligion,2344,157,4,4,8,50.0%,21m
34132,1,[C34858]PlaYBooY,2344,127,4,10,14,28.6%,3h
34132,2,SteakTARTAR,2344,141,3,5,8,37.5%,3h
34132,1,Sammy,2344,79,2,1,3,66.7%,3h
34132,2,Regulus,2344,88,2,8,10,20.0%,3h
34132,3,[CovRay]Lawrence,2344,62,2,10,12,16.7%,34m
34132,1,Mike,2344,44,1,1,2,50.0%,14m
34132,1,Starman,2344,0,1,4,5,20.0%,3h
34132,1,Gsnyder,2344,0,1,4,5,20.0%,9m
34132,1,Diogenes,2344,0,1,4,5,20.0%,3h
34132,1,LadyCloset,2344,0,1,4,5,20.0%,3h
34132,2,Keatton,2344,0,0,2,2,0.0%,22m
34132,1,[proChi]Josefer,2344,0,0,2,2,0.0%,1h
34168,1,nescaltoddy,2343,1888,118,106,224,52.7%,47m
34168,1,Colmillo,2343,1594,65,57,122,53.3%,1h
34168,3,[Khillr]BadBoyRoRo,2343,1064,61,46,107,57.0%,6m
34168,1,mcbjj,2343,1218,38,39,77,49.4%,3h
34168,1,trevthegreat,2343,958,31,29,60,51.7%,1h
34168,2,Johnny,2343,747,31,40,71,43.7%,1h
34168,3,nitecrwler,2343,718,26,23,49,53.1%,3h
34168,1,BeDaddy,2343,654,25,15,40,62.5%,1h
34168,3,Elax,2343,500,17,23,40,42.5%,3h
34168,1,brian,2343,548,15,8,23,65.2%,1h
34168,2,TheMitt,2343,233,15,24,39,38.5%,28m
34168,1,ChewChow,2343,371,13,14,27,48.1%,29m
34168,3,[KhanZ]unimatrix,2343,204,8,11,19,42.1%,1h
34168,3,kenshinGX,2343,176,6,12,18,33.3%,34m
34168,3,[SC2BOL]danimatas,2343,194,5,6,11,45.5%,1h
34168,1,suspect,2343,196,5,9,14,35.7%,1h
34168,2,mrgreen,2343,183,5,10,15,33.3%,1h
34168,1,SneakyPigeon,2343,173,3,1,4,75.0%,21m
34168,1,MULGOM,2343,53,3,3,6,50.0%,12m
34168,1,Carrascal,2343,138,3,5,8,37.5%,3h
34168,2,Jalad,2343,96,3,8,11,27.3%,34m
34168,1,Gundam,2343,97,2,0,2,100.0%,1h
34168,2,Shadowdog,2343,76,2,4,6,33.3%,20m
34168,3,JuliBashir,2343,78,2,4,6,33.3%,37m
34168,2,[WoLv3S]Knightghost,2343,62,2,9,11,18.2%,3h
34168,1,[ZWars]TokenSmoke,2343,0,0,1,1,0.0%,3h
34168,1,[C0LT]BAMF,2343,0,0,2,2,0.0%,1h
34168,1,Dolling,2343,0,0,3,3,0.0%,3h
34168,3,Mijals,2343,0,0,4,4,0.0%,5m
34197,2,Grateful,2342,1503,146,158,304,48.0%,58m
34197,3,[xDYEx]Portfirebird,2342,1229,79,79,158,50.0%,5m
34197,3,COSSIERMUSSE,2342,1263,68,69,137,49.6%,54m
34197,1,emaj,2342,1088,36,35,71,50.7%,21m
34197,2,FunkyMonk,2342,480,19,28,47,40.4%,3h
34197,3,[DFWU]HateGames,2342,264,12,10,22,54.5%,3h
34197,3,[AMP]JamesMop,2342,300,11,13,24,45.8%,34m
34197,3,[Mdtk]DiosOtaku,2342,247,9,15,24,37.5%,27m
34197,1,tokero,2342,0,3,2,5,60.0%,1h
34197,2,Shepard,2342,94,3,7,10,30.0%,3h
34197,3,Chriscuits,2342,0,2,5,7,28.6%,7m
34197,3,[PiChMK]chinaxo,2342,97,1,2,3,33.3%,1h
34197,1,RAFOJURADO,2342,44,1,3,4,25.0%,45m
34197,1,[VVPPGG]Fanatic,2342,44,1,3,4,25.0%,3h
34197,1,SHAWNER,2342,0,1,4,5,20.0%,3h
34197,1,KingDOM,2342,0,0,2,2,0.0%,3h
34197,3,SupayPisco,2342,0,0,5,5,0.0%,20m
34197,1,sladen,2342,0,0,5,5,0.0%,49m
34215,2,[Ugge]IronBeetle,2341,1531,151,143,294,51.4%,3h
34215,1,Recker,2341,1767,123,120,243,50.6%,25m
34215,3,GPS,2341,1252,91,93,184,49.5%,3h
34215,3,[aisg]Temperau,2341,636,78,73,151,51.7%,27m
34215,1,[PiN0YS]youngone,2341,1374,51,46,97,52.6%,47m
34215,3,Stealth,2341,1030,45,40,85,52.9%,18m
34215,1,Charstuky,2341,1034,29,34,63,46.0%,54m
34215,3,GridLocK,2341,417,14,15,29,48.3%,1h
34215,1,PerfectDay,2341,394,14,15,29,48.3%,22m
34215,2,[THE402]nemo,2341,330,13,15,28,46.4%,57m
34215,2,Siddharth,2341,374,13,17,30,43.3%,53m
34215,1,Wassabi,2341,274,8,7,15,53.3%,30m
34215,3,asdf,2341,247,7,9,16,43.8%,1h
34215,1,Jose,2341,155,5,5,10,50.0%,15m
34215,1,Daios,2341,122,4,5,9,44.4%,48m
34215,1,Mjeh,2341,192,4,6,10,40.0%,2m
34215,1,KingGalvez,2341,88,3,3,6,50.0%,58m
34215,3,Alfangelwolf,2341,90,3,11,14,21.4%,3h
34215,2,[TDRGN]LeyendaGK,2341,64,3,12,15,20.0%,3h
34215,1,arbmas,2341,0,2,3,5,40.0%,41m
34215,2,Happytaco,2341,0,1,0,1,100.0%,3h
34215,1,star,2341,0,1,0,1,100.0%,4m
34215,1,kiaaaaaaaaaa,2341,44,1,1,2,50.0%,3m
34215,3,Palvin,2341,0,1,1,2,50.0%,49m
34215,2,lmxclaude,2341,0,1,2,3,33.3%,3h
34215,1,Tonyj,2341,0,1,4,5,20.0%,41m
34241,1,TAZ,2340,806,118,118,236,50.0%,1h
34241,1,Hidrogeo,2340,1677,83,81,164,50.6%,12m
34241,3,enuve,2340,1227,63,66,129,48.8%,27m
34241,3,burrito,2340,1399,60,59,119,50.4%,54m
34241,1,Wilblur,2340,1072,56,53,109,51.4%,3h
34241,1,Notlim,2340,1157,44,31,75,58.7%,49m
34241,2,XeroKuhl,2340,1014,36,48,84,42.9%,56m
34241,1,Probelims,2340,903,34,17,51,66.7%,1h
34241,1,Corrupt,2340,696,22,12,34,64.7%,33m
34241,1,Lineu,2340,529,18,18,36,50.0%,24m
34241,1,Jacob,2340,560,18,23,41,43.9%,3h
34241,3,SHUT,2340,473,17,21,38,44.7%,1h
34241,3,Hai,2340,243,11,21,32,34.4%,1h
34241,1,YamaArashi,2340,218,8,13,21,38.1%,1h
34241,3,[UnitQC]Gates,2340,246,7,7,14,50.0%,1h
34241,3,[CHZWIZ]ICBMChucker,2340,187,5,5,10,50.0%,34m
34241,1,[NoProB]BrrossCT,2340,214,5,5,10,50.0%,14m
34241,3,putridfungus,2340,181,5,10,15,33.3%,1h
34241,3,PyroMeerkat,2340,90,4,6,10,40.0%,1h
34241,3,Mauloco,2340,118,4,8,12,33.3%,1h
34241,3,[JIT]JitAstafas,2340,93,3,8,11,27.3%,24m
34241,1,Proteinovich,2340,0,2,3,5,40.0%,6m
34241,3,Dragos,2340,0,2,5,7,28.6%,1h
34241,1,GooseKeeper,2340,44,1,4,5,20.0%,12m
34241,3,johanpaul,2340,0,1,4,5,20.0%,52m
34241,1,coba,2340,44,1,5,6,16.7%,14m
34241,3,Bigboogy,2340,0,1,5,6,16.7%,3h
34241,3,qiana,2340,94,1,6,7,14.3%,1h
34241,1,Bubly,2340,0,0,1,1,0.0%,1h
34241,2,[sR]HTY,2340,0,0,2,2,0.0%,22m
34241,1,[Lamort]FabroManiac,2340,0,0,4,4,0.0%,3h
34272,2,partydoor,2339,1561,342,343,685,49.9%,1h
34272,2,CapnCrunch,2339,1250,108,112,220,49.1%,35m
34272,1,[SHCrew]Luxes,2339,1493,79,74,153,51.6%,3h
34272,2,RedFarfura,2339,1299,72,70,142,50.7%,3h
34272,2,JohnClark,2339,1250,54,61,115,47.0%,26m
34272,3,ShotgunB,2339,1075,53,49,102,52.0%,49m
34272,1,Wombats,2339,1170,46,36,82,56.1%,5m
34272,2,[wrrd]Raptor,2339,1099,43,43,86,50.0%,3h
34272,3,Reclaimer,2339,585,23,29,52,44.2%,1h
34272,3,[Jungy]OPRATIONFREE,2339,532,19,26,45,42.2%,1h
34272,1,PCerDock,2339,381,14,7,21,66.7%,42m
34272,3,VillegasIV,2339,302,10,8,18,55.6%,54m
34272,2,kkkk,2339,286,10,11,21,47.6%,35m
34272,1,[KingSC]DarkSoul,2339,172,4,2,6,66.7%,3h
34272,3,[Lepraa]PersaMaldito,2339,154,4,7,11,36.4%,3h
34272,1,[RlSK]Zenith,2339,126,3,1,4,75.0%,1h
34272,1,Davidson,2339,88,3,1,4,75.0%,59m
34272,1,Fairez,2339,88,3,3,6,50.0%,54m
34272,3,[AthSun]Crusader,2339,66,3,6,9,33.3%,1h
34272,1,haka,2339,38,3,8,11,27.3%,1h
34272,2,[CHINGA]EduardoAco,2339,124,2,1,3,66.7%,22m
34272,2,[BYYYYS]JUNEprof,2339,40,2,4,6,33.3%,1h
34272,1,TokinTurtle,2339,48,2,6,8,25.0%,54m
34272,1,zergulino,2339,44,1,1,2,50.0%,49m
34272,1,Exploratus,2339,48,1,3,4,25.0%,1h
34272,1,Artemis,2339,0,1,4,5,20.0%,15m
34272,1,MaxStanton,2339,0,0,1,1,0.0%,41m
34299,1,Eliasleck,2338,1883,266,293,559,47.6%,51m
34299,3,martruta,2338,718,69,48,117,59.0%,1h
34299,1,PatCH,2338,672,42,7,49,85.7%,35m
34299,3,ELVERGAS,2338,1047,40,38,78,51.3%,1h
34299,3,TooTall,2338,974,39,36,75,52.0%,3h
34299,1,WitchKunnt,2338,1215,39,38,77,50.6%,20m
34299,3,[PobSC]Rasghul,2338,906,33,35,68,48.5%,3h
34299,1,[WNTRCO]WindWard,2338,758,21,17,38,55.3%,1h
34299,1,BabyJ,2338,716,21,23,44,47.7%,3h
34299,1,bappo,2338,600,17,15,32,53.1%,3m
34299,1,[Pyl0nZ]porkey,2338,307,12,16,28,42.9%,30m
34299,1,[GTHS]SHURAOA,2338,250,7,6,13,53.8%,47m
34299,1,aminora,2338,268,6,7,13,46.2%,41m
34299,2,Dazzelhoff,2338,110,5,6,11,45.5%,12m
34299,1,benwonwen,2338,88,4,5,9,44.4%,56m
34299,2,touchpad,2338,124,4,14,18,22.2%,3h
34299,1,CoorsLight,2338,97,3,3,6,50.0%,3h
34299,3,Guchito,2338,58,3,8,11,27.3%,1h
34299,1,Ericon,2338,44,2,1,3,66.7%,3h
34299,1,Ahmed,2338,46,2,5,7,28.6%,3h
34299,3,NoobStar,2338,30,2,6,8,25.0%,34m
34299,1,Mrgotohell,2338,0,1,0,1,100.0%,3m
34299,1,Leeroy,2338,0,1,2,3,33.3%,57m
34299,1,SuperStrats,2338,44,1,2,3,33.3%,42m
34299,3,SlickNick,2338,0,1,4,5,20.0%,3h
34299,1,ZeroAPM,2338,0,1,4,5,20.0%,1h
34299,3,Drater,2338,34,1,8,9,11.1%,33m
34299,1,Spu,2338,0,0,1,1,0.0%,15m
34299,1,[Wining]BattlePanda,2338,0,0,1,1,0.0%,1h
34299,1,sniperpro,2338,0,0,1,1,0.0%,1h
34299,1,RSINIK,2338,0,0,2,2,0.0%,3h
34299,1,huntbroncos,2338,0,0,2,2,0.0%,8m
34331,2,Darthspectre,2337,1315,367,380,747,49.1%,1h
34331,1,[12YD]Doug,2337,1870,201,196,397,50.6%,13m
34331,2,[LMI42]Baboolal,2337,1508,114,117,231,49.4%,31m
34331,3,Squid,2337,744,36,20,56,64.3%,1h
34331,2,OtakuSlave,2337,473,30,36,66,45.5%,1h
34331,3,[AbcCo]LuisLipaXD,2337,435,18,11,29,62.1%,21m
34331,3,charliekilo,2337,471,18,19,37,48.6%,33m
34331,3,JoyJoker,2337,486,18,20,38,47.4%,17m
34331,3,SuperDeez,2337,340,11,17,28,39.3%,3h
34331,2,Dulcet,2337,319,10,19,29,34.5%,3h
34331,3,TNTMiners,2337,158,7,4,11,63.6%,3h
34331,1,SHROOM,2337,48,4,3,7,57.1%,38m
34331,1,[LEC]Lucky,2337,170,4,4,8,50.0%,1h
34331,3,daveruski,2337,58,3,8,11,27.3%,3h
34331,3,[QFTA]Chanute,2337,0,2,4,6,33.3%,46m
34331,3,MrBaggins,2337,62,2,7,9,22.2%,9m
34331,1,Kolet,2337,0,1,4,5,20.0%,3h
34331,1,[Gt1]ELE,2337,44,1,5,6,16.7%,54m
34331,1,mike,2337,0,1,6,7,14.3%,13m
34331,1,[GOOOSE]tpafs,2337,0,1,7,8,12.5%,54m
34331,1,pony,2337,0,0,1,1,0.0%,1h
34331,3,Notagamer,2337,0,0,4,4,0.0%,3h
34353,3,tariel,2336,1594,264,272,536,49.3%,30m
34353,3,mauthocxic,2336,1218,96,88,184,52.2%,34m
34353,3,Tekken,2336,1197,95,107,202,47.0%,34m
34353,3,InputTank,2336,973,63,46,109,57.8%,1h
34353,1,ajh,2336,1148,51,65,116,44.0%,17m
34353,1,[GRUDGE]KraMBCooL,2336,1358,42,41,83,50.6%,47m
34353,1,DJCOPCOM,2336,1166,42,48,90,46.7%,3h
34353,1,[JaMiT]SyFy,2336,832,29,18,47,61.7%,49m
34353,3,KimLao,2336,618,27,27,54,50.0%,1h
34353,3,Beardo,2336,683,25,28,53,47.2%,20m
34353,3,Koniu,2336,618,23,31,54,42.6%,34m
34353,1,Splash,2336,732,21,18,39,53.8%,13m
34353,3,[NKsL]Nukspltter,2336,432,15,20,35,42.9%,50m
34353,1,GrosMalin,2336,456,12,8,20,60.0%,15m
34353,2,iXGEN,2336,170,8,12,20,40.0%,3h
34353,3,RedStrike,2336,250,8,14,22,36.4%,3h
34353,2,Wolf,2336,208,7,17,24,29.2%,1h
34353,1,[CCoRee]CoreSenpai,2336,212,6,4,10,60.0%,3m
34353,3,Yehoshua,2336,204,6,6,12,50.0%,48m
34353,1,Autism,2336,231,6,13,19,31.6%,1h
34353,3,TQluis,2336,172,5,5,10,50.0%,20m
34353,1,[pARA2x]LCVR,2336,86,3,2,5,60.0%,45m
34353,1,clzy,2336,126,3,4,7,42.9%,3h
34353,3,Niknoc,2336,125,3,5,8,37.5%,42m
34353,1,Scyphozoa,2336,120,3,5,8,37.5%,8m
34353,3,Vile,2336,151,3,6,9,33.3%,3h
34353,1,SmartTopHat,2336,0,2,3,5,40.0%,1h
34353,1,Gillis,2336,121,2,5,7,28.6%,54m
34353,3,Zodiac,2336,30,2,6,8,25.0%,1h
34353,1,Maicke,2336,0,1,0,1,100.0%,1h
34353,1,zeratul,2336,42,1,2,3,33.3%,3h
34353,1,Jinyu,2336,0,1,4,5,20.0%,57m
34353,2,Devon,2336,0,1,5,6,16.7%,3h
34353,3,[REDES]Kunimi,2336,30,1,6,7,14.3%,1h
34353,2,ProbeRush,2336,0,0,1,1,0.0%,29m
34353,1,[yander]Havoc,2336,0,0,2,2,0.0%,1h
34353,1,Hiponano,2336,0,0,4,4,0.0%,3h
34390,3,BigHeady,2335,1410,239,230,469,51.0%,1h
34390,3,VNCH,2335,919,78,79,157,49.7%,29m
34390,3,[Bommmm]CapeGoblin,2335,1213,72,62,134,53.7%,5m
34390,3,Joven,2335,1532,72,67,139,51.8%,1h
34390,3,HideyHinder,2335,1524,57,64,121,47.1%,3h
34390,2,Termopilas,2335,1068,41,41,82,50.0%,22m
34390,1,Hando,2335,1122,39,56,95,41.1%,3h
34390,2,[6ixS]NattyLight,2335,938,33,41,74,44.6%,3h
34390,3,BlackHawk,2335,449,15,17,32,46.9%,5m
34390,2,Stannis,2335,342,14,17,31,45.2%,1h
34390,3,erosleda,2335,406,13,16,29,44.8%,1h
34390,1,Zombie,2335,368,12,6,18,66.7%,3h
34390,3,[Dac]Wolney,2335,286,11,13,24,45.8%,52m
34390,3,HornyElmo,2335,174,8,7,15,53.3%,19m
34390,3,SquishyFish,2335,206,7,12,19,36.8%,14m
34390,2,[GoPctm]Chemere,2335,210,7,13,20,35.0%,36m
34390,3,mutantK,2335,205,5,8,13,38.5%,24m
34390,1,maxent,2335,159,4,7,11,36.4%,1h
34390,1,Eternalzeero,2335,0,3,2,5,60.0%,39m
34390,1,Jhakrem,2335,145,2,2,4,50.0%,19m
34390,1,lucasmm,2335,86,2,2,4,50.0%,6m
34390,1,Lidoh,2335,0,2,3,5,40.0%,49m
34390,3,Malevolent,2335,121,2,3,5,40.0%,33m
34390,1,Zuko,2335,0,1,0,1,100.0%,1h
34390,1,TTVMathew,2335,0,1,2,3,33.3%,3h
34390,1,JJRRWW,2335,46,1,3,4,25.0%,3h
34390,3,TerranR,2335,0,1,5,6,16.7%,3h
34390,3,ZombieCG,2335,0,0,3,3,0.0%,1h
34418,3,StillWill,2334,1584,136,138,274,49.6%,52m
34418,1,couleee,2334,1825,135,137,272,49.6%,1h
34418,3,Brobocop,2334,1604,114,112,226,50.4%,3h
34418,3,GoblinZ,2334,1473,110,107,217,50.7%,1h
34418,2,Jtellez,2334,1265,56,69,125,44.8%,1h
34418,2,Sylas,2334,784,30,38,68,44.1%,3h
34418,1,TheWizard,2334,403,10,10,20,50.0%,3h
34418,2,Cirdan,2334,236,7,11,18,38.9%,7m
34418,1,IIIIIIIIIIII,2334,244,6,7,13,46.2%,26m
34418,3,Prodigy,2334,124,5,8,13,38.5%,1h
34418,3,Stoked,2334,94,5,10,15,33.3%,5m
34418,2,Batman,2334,112,3,2,5,60.0%,1h
34418,3,Tyler,2334,30,3,5,8,37.5%,3h
34418,1,Antyga,2334,80,3,6,9,33.3%,10m
34418,3,Pombolino,2334,62,3,8,11,27.3%,3h
34418,1,[opwr]SmoyBoy,2334,44,2,0,2,100.0%,47m
34418,1,SecretSquid,2334,46,2,2,4,50.0%,3h
34418,1,GuineaPiglet,2334,92,2,5,7,28.6%,26m
34418,2,Daroal,2334,0,2,6,8,25.0%,3h
34418,1,Darius,2334,0,1,1,2,50.0%,1h
34418,1,[Xpk]Eclipse,2334,46,1,2,3,33.3%,5m
34418,2,jimmydo,2334,89,1,3,4,25.0%,57m
34418,1,HareTrigger,2334,0,1,4,5,20.0%,25m
34418,1,jimsbob,2334,0,1,4,5,20.0%,13m
34418,1,Dcapri,2334,0,1,5,6,16.7%,3h
34443,1,HotSoup,2333,1420,99,98,197,50.3%,47m
34443,3,Zaraki,2333,1442,72,74,146,49.3%,48m
34443,2,Braynztorm,2333,1295,52,53,105,49.5%,2m
34443,3,Roxic,2333,957,46,54,100,46.0%,52m
34443,1,GigaTabloid,2333,1252,44,39,83,53.0%,1h
34443,2,JGC,2333,680,44,46,90,48.9%,3h
34443,3,Dremian,2333,441,41,39,80,51.2%,34m
34443,3,Piwo,2333,671,36,30,66,54.5%,1h
34443,1,[FEEDS]Erick,2333,992,34,28,62,54.8%,12m
34443,1,kyrie,2333,921,32,23,55,58.2%,3h
34443,3,nullPointer,2333,865,32,31,63,50.8%,1h
34443,1,[SvEvK]OmegaWaffle,2333,844,32,34,66,48.5%,1h
34443,1,[Haze4z]Bluedreamz,2333,950,28,27,55,50.9%,1h
34443,1,[TGosuA]Ramshack,2333,323,22,13,35,62.9%,1h
34443,2,[Kappa8]Mmbrillo,2333,550,21,26,47,44.7%,58m
34443,1,coaliz,2333,546,16,8,24,66.7%,41m
34443,1,[BROoD1]ArmyOfOne,2333,496,12,14,26,46.2%,3h
34443,1,Deathbringer,2333,420,11,12,23,47.8%,38m
34443,1,Kira,2333,212,10,13,23,43.5%,1h
34443,1,Xperience,2333,298,9,10,19,47.4%,3h
34443,1,GamerTorture,2333,384,9,18,27,33.3%,45m
34443,2,Yhurnero,2333,253,8,12,20,40.0%,34m
34443,2,[lBRA]lenxos,2333,160,5,17,22,22.7%,3h
34443,3,LicanX,2333,97,4,4,8,50.0%,3h
34443,3,Starfox,2333,144,4,7,11,36.4%,1h
34443,1,ZiloroN,2333,0,3,2,5,60.0%,38m
34443,1,BabyMeat,2333,90,3,3,6,50.0%,38m
34443,1,lightning,2333,88,3,3,6,50.0%,1h
34443,3,[Au4evr]Crocopotkine,2333,146,3,5,8,37.5%,1h
34443,2,Crown,2333,0,3,7,10,30.0%,3h
34443,3,NRGBanned,2333,36,3,8,11,27.3%,47m
34443,1,legnar,2333,84,2,1,3,66.7%,3h
34443,2,cell,2333,40,2,4,6,33.3%,35m
34443,1,sgthugo,2333,67,2,4,6,33.3%,1h
34443,1,Statik,2333,44,2,5,7,28.6%,60m
34443,3,Manuel,2333,96,2,5,7,28.6%,5m
34443,1,METTAK,2333,86,2,6,8,25.0%,3h
34443,1,Pierosimple,2333,0,1,1,2,50.0%,1h
34443,1,pcspecs,2333,32,1,3,4,25.0%,20m
34443,1,Keiboben,2333,0,1,3,4,25.0%,20m
34443,1,[LETAL]Rasthak,2333,0,1,4,5,20.0%,39m
34443,3,autechre,2333,0,1,5,6,16.7%,3h
34443,1,TytoFurcata,2333,0,1,5,6,16.7%,41m
34443,3,Fuzzy,2333,0,0,1,1,0.0%,1h
34443,3,[cl0udM]Deftruptor,2333,0,0,1,1,0.0%,51m
34443,1,YouSeeMe,2333,0,0,1,1,0.0%,58m
34443,1,DreGuss,2333,0,0,1,1,0.0%,1h
34443,1,[Roblox]Nexzuz,2333,0,0,2,2,0.0%,3h
34491,1,stanlortm,2332,1568,186,193,379,49.1%,1h
34491,3,legends,2332,1544,98,87,185,53.0%,55m
34491,2,[ChiFan]dahx,2332,1567,94,101,195,48.2%,1h
34491,3,Lobocósmico,2332,993,46,48,94,48.9%,1h
34491,3,[DNKCET]KloacaHarris,2332,1131,39,44,83,47.0%,49m
34491,3,SPowell,2332,514,19,21,40,47.5%,17m
34491,2,Kierkeggard,2332,305,19,26,45,42.2%,13m
34491,3,Isaac,2332,288,11,11,22,50.0%,1h
34491,2,DustyDusters,2332,362,11,13,24,45.8%,1h
34491,1,EXTREMIX,2332,224,6,7,13,46.2%,1h
34491,1,[oneTop]chronis,2332,159,5,4,9,55.6%,3h
34491,1,zeus,2332,163,4,0,4,100.0%,42m
34491,1,kane,2332,178,4,4,8,50.0%,51m
34491,2,CaptainHowdy,2332,130,4,8,12,33.3%,1h
34491,1,PhatTank,2332,44,2,2,4,50.0%,3h
34491,1,PoliceState,2332,42,2,5,7,28.6%,1h
34491,3,HurpDaDerp,2332,30,2,5,7,28.6%,1h
34491,3,[R4Skin]Trippy,2332,0,1,0,1,100.0%,1h
34491,1,llllllllllll,2332,36,1,2,3,33.3%,3h
34491,1,alamo,2332,44,1,2,3,33.3%,13m
34491,1,Windybill,2332,44,1,2,3,33.3%,15m
34491,1,TSTRO,2332,0,1,2,3,33.3%,6m
34491,3,Mosquito,2332,0,1,3,4,25.0%,20m
34491,1,[TnGn]Rokobungi,2332,46,1,4,5,20.0%,3h
34491,3,SomeLink,2332,0,1,5,6,16.7%,1h
34491,1,[CoolLC]TheKiller,2332,0,0,2,2,0.0%,1h
34491,3,TassadarX,2332,0,0,3,3,0.0%,31m
34491,3,Mauricio,2332,0,0,5,5,0.0%,1h
34519,2,[GrnBrd]DarthBrookes,2331,1592,397,401,798,49.7%,3h
34519,3,[JRT]TererePy,2331,1228,97,99,196,49.5%,1h
34519,3,Duster,2331,1480,93,85,178,52.2%,14m
34519,2,GRANJONA,2331,1413,77,75,152,50.7%,3h
34519,1,riq,2331,1832,75,72,147,51.0%,30m
34519,3,legionario,2331,933,59,60,119,49.6%,29m
34519,1,lowAPM,2331,383,24,25,49,49.0%,3h
34519,1,Zhuman,2331,640,23,34,57,40.4%,14m
34519,3,Lyenor,2331,569,20,22,42,47.6%,5m
34519,1,DJspyhappy,2331,604,17,12,29,58.6%,44m
34519,1,Nightfire,2331,494,14,11,25,56.0%,3h
34519,2,[DRKESP]Drew,2331,338,11,19,30,36.7%,13m
34519,1,insaneff,2331,230,8,5,13,61.5%,3h
34519,1,Iselin,2331,226,7,9,16,43.8%,1h
34519,1,xFuuuuuryRed,2331,232,7,9,16,43.8%,1h
34519,3,WarMachine,2331,186,6,6,12,50.0%,1h
34519,3,Titanium,2331,30,4,4,8,50.0%,54m
34519,3,CoBo,2331,58,4,8,12,33.3%,34m
34519,1,Guduranis,2331,86,3,0,3,100.0%,3h
34519,1,MojoJojo,2331,134,3,4,7,42.9%,42m
34519,3,Glipys,2331,0,3,4,7,42.9%,33m
34519,3,[NLTN]War,2331,146,3,6,9,33.3%,1h
34519,1,moadib,2331,126,3,7,10,30.0%,60m
34519,1,[mustaf]greenshorts,2331,44,2,0,2,100.0%,39m
34519,1,[TGCrew]Function,2331,0,1,0,1,100.0%,1h
34519,1,Shiftster,2331,0,1,0,1,100.0%,3h
34519,1,MauCo,2331,0,1,1,2,50.0%,3h
34519,1,naminator,2331,0,1,1,2,50.0%,15m
34519,1,andrew,2331,0,1,2,3,33.3%,17m
34519,1,[EzyPzY]raydo,2331,0,1,4,5,20.0%,44m
34519,1,[OverW]DarkDiamond,2331,0,1,4,5,20.0%,1h
34519,1,Namnueng,2331,0,0,3,3,0.0%,3h
34551,1,ZOCALEBZRG,2330,1366,88,77,165,53.3%,3h
34551,2,[XTLGX]Lanzeloth,2330,1286,76,75,151,50.3%,3h
34551,2,DEEBO,2330,1391,75,89,164,45.7%,1h
34551,3,Olivich,2330,1090,71,63,134,53.0%,49m
34551,3,Luckyboy,2330,1463,65,67,132,49.2%,18m
34551,1,Yanlsama,2330,1547,64,44,108,59.3%,3h
34551,2,redbusman,2330,637,39,40,79,49.4%,3h
34551,3,[Fefe]Terratron,2330,625,37,43,80,46.2%,29m
34551,1,[STRCRA]GESU,2330,698,26,21,47,55.3%,3h
34551,3,McLindão,2330,667,24,23,47,51.1%,16m
34551,3,[BlTEL]stef,2330,680,24,31,55,43.6%,29m
34551,3,PixelLaird,2330,573,23,22,45,51.1%,48m
34551,1,ergo,2330,742,22,19,41,53.7%,47m
34551,1,[Nag]FrOgMaN,2330,685,19,17,36,52.8%,35m
34551,1,alex,2330,654,19,21,40,47.5%,3h
34551,1,[GLHFJJ]AClaireSTX,2330,346,14,20,34,41.2%,3h
34551,3,Tyson,2330,340,11,18,29,37.9%,3h
34551,1,ForTheHorde,2330,350,9,7,16,56.2%,1h
34551,1,Greg,2330,260,7,7,14,50.0%,3h
34551,3,Ares,2330,163,6,5,11,54.5%,1h
34551,3,[JaMiT]Nerd,2330,94,6,11,17,35.3%,34m
34551,3,gggggggggggg,2330,200,5,9,14,35.7%,3h
34551,3,Saga,2330,148,5,10,15,33.3%,21m
34551,1,KaiserND,2330,163,4,4,8,50.0%,3h
34551,1,vorian,2330,0,4,6,10,40.0%,1h
34551,3,Denali,2330,126,4,10,14,28.6%,1h
34551,2,Fark,2330,113,3,1,4,75.0%,3h
34551,3,BsBbgun,2330,121,3,7,10,30.0%,3h
34551,2,corvo,2330,0,2,5,7,28.6%,37m
34551,3,Optimystic,2330,97,1,1,2,50.0%,57m
34551,3,Puker,2330,0,1,1,2,50.0%,13m
34551,3,jelipe,2330,30,1,1,2,50.0%,5m
34551,1,[TPGGXD]danny,2330,36,1,2,3,33.3%,5m
34551,1,[sk3tch]CptDanK,2330,42,1,4,5,20.0%,13m
34551,1,Solman,2330,0,1,4,5,20.0%,3h
34551,3,Cheese,2330,0,1,5,6,16.7%,17m
34551,1,[NoH2O]Tynamo,2330,0,0,1,1,0.0%,1h
34551,1,Itsme,2330,0,0,1,1,0.0%,49m
34551,2,FoxyCox,2330,0,0,2,2,0.0%,12m
34590,3,Robert,2329,1582,526,526,1052,50.0%,6m
34590,1,ByuN,2329,1867,331,327,658,50.3%,3h
34590,3,Deo,2329,559,71,75,146,48.6%,16m
34590,3,GoliathOnlne,2329,1535,69,55,124,55.6%,29m
34590,1,DarthSeverus,2329,1117,47,35,82,57.3%,39m
34590,1,Bysharp,2329,440,13,4,17,76.5%,1h
34590,1,hunttr,2329,306,12,7,19,63.2%,3h
34590,3,[TLSS]sdfgmtp,2329,307,12,11,23,52.2%,14m
34590,3,Rodrigo,2329,339,12,13,25,48.0%,12m
34590,3,AlEltz,2329,338,11,14,25,44.0%,1h
34590,3,Sanitizer,2329,264,9,14,23,39.1%,1h
34590,3,[pigs]GetGot,2329,252,9,14,23,39.1%,11m
34590,3,[Khron]RavenwolF,2329,236,8,14,22,36.4%,19m
34590,2,Tunstall,2329,218,7,15,22,31.8%,1h
34590,1,PrinceVegeta,2329,157,6,10,16,37.5%,1h
34590,1,cguajardo,2329,229,5,8,13,38.5%,1h
34590,3,Flumdog,2329,121,3,6,9,33.3%,34m
34590,3,[maes]craftthis,2329,92,3,8,11,27.3%,1h
34590,1,Alandemian,2329,42,2,0,2,100.0%,56m
34590,1,Saieie,2329,92,2,1,3,66.7%,3h
34590,1,[FatMom]BigChungus,2329,48,2,1,3,66.7%,1h
34590,1,[BANZ]Kinufix,2329,109,2,3,5,40.0%,3h
34590,1,BrewedWar,2329,97,2,5,7,28.6%,1h
34590,1,Deckboy,2329,0,1,0,1,100.0%,3h
34590,1,Bohunk,2329,0,1,0,1,100.0%,3h
34590,1,unfortunate,2329,0,1,4,5,20.0%,29m
34590,1,[TGCrew]Cronosphere,2329,46,1,5,6,16.7%,3m
34590,3,Contrajoe,2329,0,1,7,8,12.5%,3h
34590,1,[SJT]Tristan,2329,0,0,1,1,0.0%,1h
34590,1,[SDC12]BlackSoul,2329,0,0,1,1,0.0%,1h
34590,1,Tiburonzin,2329,0,0,1,1,0.0%,3h
34621,1,Lukicies,2328,1173,220,220,440,50.0%,3h
34621,1,EnabranTain,2328,1712,210,220,430,48.8%,3h
34621,1,[RedHat]ChozSun,2328,1450,61,49,110,55.5%,3h
34621,1,TrueBlue,2328,626,27,5,32,84.4%,1h
34621,2,Citidel,2328,640,23,34,57,40.4%,3h
34621,1,gabrieleitor,2328,604,19,18,37,51.4%,1h
34621,2,Treadstone,2328,546,19,25,44,43.2%,6m
34621,3,[ppS0ft]DARKMAN,2328,214,6,9,15,40.0%,11m
34621,1,[LTlord]JUSTaGAME,2328,38,4,1,5,80.0%,48m
34621,2,[LaOr]Thorrox,2328,60,3,6,9,33.3%,3h
34621,3,[AHPUCH]Alpha,2328,146,3,9,12,25.0%,13m
34621,1,[LMI42]iNkA,2328,48,2,0,2,100.0%,25m
34621,1,ZOIDOBICHO,2328,97,2,2,4,50.0%,3h
34621,1,[BGN]TheCrumb,2328,46,2,3,5,40.0%,3h
34621,1,Cesar,2328,0,1,0,1,100.0%,29m
34621,1,Japox,2328,0,1,5,6,16.7%,3h
34621,3,Rojobo,2328,0,1,5,6,16.7%,31m
34621,3,KaraTonus,2328,0,1,5,6,16.7%,1h
34621,3,Teamdbz,2328,0,1,5,6,16.7%,47m
34621,1,Guillermo,2328,0,0,1,1,0.0%,47m
34621,1,Collectibles,2328,0,0,1,1,0.0%,50m
34621,1,inksoul,2328,0,0,2,2,0.0%,1h
34621,1,foundthemust,2328,0,0,2,2,0.0%,3h
34621,3,OPWonShnobe,2328,0,0,2,2,0.0%,18m
34621,1,Meliodas,2328,0,0,3,3,0.0%,1h
34621,2,Iruam,2328,0,0,10,10,0.0%,1h
34647,1,mattathias,2327,1784,61,58,119,51.3%,3h
34647,1,lightpure,2327,988,29,26,55,52.7%,33m
34647,3,rockmonkey,2327,744,28,35,63,44.4%,3h
34647,1,Earendil,2327,477,18,23,41,43.9%,56m
34647,1,walkure,2327,208,10,5,15,66.7%,3h
34647,2,Learning,2327,325,10,12,22,45.5%,3h
34647,2,Nitz,2327,277,10,12,22,45.5%,3h
34647,1,Mike,2327,316,9,8,17,52.9%,57m
34647,2,[NXLsc]CrimsonAA,2327,265,8,12,20,40.0%,3h
34647,3,rhwjdaud,2327,176,7,10,17,41.2%,34m
34647,3,ETdeVarginha,2327,216,7,12,19,36.8%,27m
34647,1,[3DLANS]joyo,2327,158,7,16,23,30.4%,18m
34647,1,kokeloco,2327,147,5,9,14,35.7%,52m
34647,1,CapRato,2327,172,4,6,10,40.0%,1h
34647,1,[DokiSC]harichris,2327,90,3,3,6,50.0%,3h
34647,1,xVigelantex,2327,168,3,4,7,42.9%,14m
34647,3,invoker,2327,123,3,7,10,30.0%,3h
34647,3,[AXIOS]BattlePants,2327,98,3,7,10,30.0%,34m
34647,1,Sinfully,2327,0,2,3,5,40.0%,9m
34647,3,Cylon,2327,0,2,5,7,28.6%,34m
34647,1,Kev,2327,0,1,0,1,100.0%,33m
34647,1,[CHIRP]younggang,2327,0,1,0,1,100.0%,1h
34647,1,aRuHZoNa,2327,0,1,0,1,100.0%,3h
34647,1,[Cliaos]Warpants,2327,0,1,0,1,100.0%,3h
34647,1,GAIA,2327,0,1,2,3,33.3%,47m
34647,1,SirLuis,2327,42,1,3,4,25.0%,24m
34647,1,[VALHL]Aragorn,2327,0,1,3,4,25.0%,3h
34647,1,[BRSUL]AcDroiD,2327,0,1,4,5,20.0%,3h
34647,1,Taggert,2327,0,1,4,5,20.0%,3h
34647,3,[DenuxD]tuquesadilla,2327,0,1,4,5,20.0%,34m
34647,3,Tank,2327,0,1,5,6,16.7%,1h
34647,3,Jonbot,2327,0,1,5,6,16.7%,1h
34647,2,Zandor,2327,46,1,7,8,12.5%,46m
34647,1,Swidge,2327,0,0,1,1,0.0%,30m
34647,2,Alex,2327,0,0,5,5,0.0%,1h
34682,2,[PFOD]DonkeyTeeth,2326,1515,290,293,583,49.7%,54m
34682,3,[a1vNA]blackstar,2326,1459,130,133,263,49.4%,1h
34682,3,Snntiago,2326,1291,111,105,216,51.4%,1h
34682,1,SilentGhost,2326,1851,82,73,155,52.9%,3h
34682,3,theromerex,2326,797,80,54,134,59.7%,48m
34682,1,[57717]Abathur,2326,1703,62,60,122,50.8%,1h
34682,2,kyrralse,2326,1330,53,51,104,51.0%,3h
34682,1,CannonFodder,2326,933,28,22,50,56.0%,3h
34682,1,Shadar,2326,964,27,28,55,49.1%,25m
34682,3,mit,2326,576,27,33,60,45.0%,52m
34682,3,[PREGG]SpartanG,2326,667,23,26,49,46.9%,1h
34682,2,thumper,2326,558,21,30,51,41.2%,48m
34682,1,Gonekix,2326,548,16,10,26,61.5%,3h
34682,2,cLrasak,2326,416,15,25,40,37.5%,27m
34682,1,Lallaar,2326,498,13,13,26,50.0%,48m
34682,1,[DTROIT]WarBaron,2326,398,10,8,18,55.6%,12m
34682,3,emayrolol,2326,169,6,7,13,46.2%,3h
34682,2,MrOvo,2326,160,6,9,15,40.0%,1h
34682,1,RCKLES,2326,172,5,3,8,62.5%,30m
34682,1,[OpVal]DARCAR,2326,176,5,5,10,50.0%,40m
34682,1,Manta,2326,178,5,8,13,38.5%,35m
34682,1,Yoshiyahoo,2326,44,2,0,2,100.0%,1h
34682,1,[GRNSKN]SupplyZone,2326,0,1,1,2,50.0%,1h
34682,1,Nicomatty,2326,0,1,5,6,16.7%,1h
34682,3,RIPlStarCTwo,2326,0,0,1,1,0.0%,1h
34682,1,[BBCR]adamwv,2326,0,0,2,2,0.0%,1h
34682,1,Murdertrain,2326,0,0,3,3,0.0%,3h
34709,3,JimCroce,2325,1584,212,193,405,52.3%,1h
34709,1,[J4K]Newbie,2325,1759,196,193,389,50.4%,49m
34709,3,[ReB3L]nerdaton,2325,1196,49,50,99,49.5%,27m
34709,1,Anax,2325,1376,48,51,99,48.5%,1h
34709,2,Cromulent,2325,635,29,40,69,42.0%,1h
34709,1,Monk,2325,781,26,21,47,55.3%,3h
34709,1,HeroOfChrist,2325,699,25,18,43,58.1%,10m
34709,1,YippeeKiYay,2325,411,16,5,21,76.2%,39m
34709,1,[JeNiX]Cochecho,2325,536,15,12,27,55.6%,3h
34709,2,MrChimmie,2325,328,12,15,27,44.4%,19m
34709,1,BASURA,2325,258,11,6,17,64.7%,1h
34709,1,[FTLTX]akullico,2325,380,11,12,23,47.8%,3h
34709,1,GGingingDer,2325,228,8,6,14,57.1%,42m
34709,1,[RdRC]TcoR,2325,297,8,9,17,47.1%,3h
34709,2,CGxFatal,2325,249,7,7,14,50.0%,3h
34709,1,Alex,2325,264,7,7,14,50.0%,3h
34709,1,Paused,2325,225,6,2,8,75.0%,10m
34709,1,[ZTempz]Oraces,2325,128,6,2,8,75.0%,3h
34709,2,[HIBOYZ]DandyCandy,2325,204,6,16,22,27.3%,1h
34709,1,TheFool,2325,124,4,19,23,17.4%,35m
34709,3,Demian,2325,141,3,7,10,30.0%,1h
34709,1,Netikular,2325,132,3,7,10,30.0%,3h
34709,1,Birthday,2325,44,2,3,5,40.0%,24m
34709,3,Yarkle,2325,96,2,6,8,25.0%,3h
34709,1,POLKAXFE,2325,0,1,0,1,100.0%,1h
34709,1,[Peww]icecoldjuice,2325,44,1,1,2,50.0%,13m
34709,1,docjeckyl,2325,0,1,4,5,20.0%,1h
34709,1,[BeDilf]Dilph,2325,0,1,5,6,16.7%,6m
34709,1,FierceDeity,2325,0,0,1,1,0.0%,3h
34709,1,Bombasstic,2325,0,0,2,2,0.0%,3h
34709,1,Morisawa,2325,0,0,2,2,0.0%,3h
34709,1,Arlan,2325,0,0,3,3,0.0%,45m
34741,1,[GBombs]UncleFrank,2324,1827,111,97,208,53.4%,40m
34741,3,Oorgle,2324,1419,93,78,171,54.4%,12m
34741,3,FunkedUp,2324,1571,63,70,133,47.4%,30m
34741,3,GinoRuesta,2324,1488,55,60,115,47.8%,1h
34741,1,KingKenny,2324,1224,44,51,95,46.3%,3h
34741,3,[PANNNN]panconcafe,2324,812,27,37,64,42.2%,3h
34741,3,vlas,2324,363,17,20,37,45.9%,1h
34741,1,Noogie,2324,584,16,16,32,50.0%,1h
34741,2,[RuS98]UberNOobster,2324,504,16,25,41,39.0%,37m
34741,1,tigre,2324,358,11,1,12,91.7%,3h
34741,1,BarbarianLeo,2324,406,11,10,21,52.4%,3h
34741,1,mGaHypocrite,2324,332,10,6,16,62.5%,3h
34741,1,Luke,2324,211,7,3,10,70.0%,5m
34741,1,daisy,2324,283,7,3,10,70.0%,3h
34741,1,Plotman,2324,224,6,4,10,60.0%,1h
34741,3,[MPA]Skramble,2324,193,6,9,15,40.0%,1h
34741,1,Zorro,2324,44,5,4,9,55.6%,1h
34741,1,Storm,2324,90,3,3,6,50.0%,3h
34741,1,bppaoloob,2324,44,2,2,4,50.0%,13m
34741,1,Taxman,2324,92,2,3,5,40.0%,3h
34741,1,[SuSl]philo,2324,0,2,3,5,40.0%,6m
34741,1,excalibur,2324,88,2,5,7,28.6%,3h
34741,3,[H264]Mrwolve,2324,119,2,5,7,28.6%,55m
34741,1,bXdkillfast,2324,0,1,0,1,100.0%,26m
34741,1,DJM,2324,34,1,1,2,50.0%,3h
34741,1,Tony,2324,48,1,1,2,50.0%,1h
34741,1,oneil,2324,42,1,2,3,33.3%,3h
34741,1,Mazer,2324,46,1,2,3,33.3%,3h
34741,1,jbeeear,2324,42,1,3,4,25.0%,1h
34741,1,Zipo,2324,0,1,4,5,20.0%,1h
34741,3,KnobJockey,2324,30,1,5,6,16.7%,5m
34741,1,Kozyapki,2324,0,1,5,6,16.7%,25m
34741,1,Gunsoo,2324,0,1,5,6,16.7%,3h
34741,1,SRP,2324,0,0,1,1,0.0%,51m
34775,2,TriniHavoc,2323,1564,276,278,554,49.8%,3h
34775,3,oNifiro,2323,1531,238,230,468,50.9%,25m
34775,2,Hard,2323,1184,146,159,305,47.9%,44m
34775,3,[DORB]Sincron,2323,1537,138,148,286,48.3%,6m
34775,2,Nifice,2323,1175,69,72,141,48.9%,50m
34775,3,[DADE]SkyzdLimit,2323,866,53,56,109,48.6%,11m
34775,1,Kingbalong,2323,668,50,46,96,52.1%,3h
34775,1,shoppingcart,2323,1123,37,29,66,56.1%,1h
34775,3,Harukaze,2323,789,36,22,58,62.1%,11m
34775,3,AMaussie,2323,1020,35,42,77,45.5%,5m
34775,1,Sadus,2323,636,33,29,62,53.2%,1h
34775,3,KIRITO,2323,274,10,15,25,40.0%,21m
34775,2,bootlegAzn,2323,304,9,9,18,50.0%,1h
34775,1,Bloodshot,2323,286,8,3,11,72.7%,12m
34775,3,Generalbob,2323,214,8,12,20,40.0%,1h
34775,1,Serchhh,2323,279,7,2,9,77.8%,48m
34775,1,WatWatInDaBu,2323,177,6,5,11,54.5%,6m
34775,1,Stardust,2323,262,6,9,15,40.0%,12m
34775,3,RabbiDefiler,2323,158,5,3,8,62.5%,1h
34775,3,[DHZAcD]SeaWulf,2323,97,4,4,8,50.0%,30m
34775,1,Sporkredfox,2323,130,3,3,6,50.0%,3h
34775,1,ACE,2323,88,3,4,7,42.9%,3h
34775,1,Vagrantkilla,2323,96,3,7,10,30.0%,30m
34775,3,Meowza,2323,60,3,7,10,30.0%,1h
34775,1,Faraonts,2323,0,1,0,1,100.0%,34m
34775,1,[Royal9]RAWR,2323,0,1,1,2,50.0%,3h
34775,1,tomosato,2323,0,1,1,2,50.0%,49m
34775,1,[Blawuk]Cohagen,2323,0,1,1,2,50.0%,3h
34775,1,[S2D]Senpai,2323,0,1,4,5,20.0%,1h
34775,1,Descendant,2323,0,1,4,5,20.0%,59m
34775,2,Megiddart,2323,42,1,6,7,14.3%,1h
34775,1,shinefourHIM,2323,0,0,1,1,0.0%,1h
34775,1,Keindise,2323,0,0,1,1,0.0%,4m
34775,1,[CHEEKS]hyperdyper,2323,0,0,2,2,0.0%,59m
34775,1,JONSNOW,2323,0,0,4,4,0.0%,56m
34810,1,RocketMan,2322,1853,129,124,253,51.0%,3h
34810,1,Crash,2322,1188,51,23,74,68.9%,3h
34810,3,PtonerBoner,2322,828,44,37,81,54.3%,34m
34810,1,Macca,2322,862,30,45,75,40.0%,14m
34810,2,OldAndSlow,2322,468,18,29,47,38.3%,43m
34810,1,NERO,2322,574,16,16,32,50.0%,13m
34810,1,Valhallaus,2322,326,11,16,27,40.7%,1h
34810,1,[Shang]Justice,2322,408,10,10,20,50.0%,30m
34810,3,bekicot,2322,315,10,14,24,41.7%,9m
34810,1,PaoloDtelo,2322,342,9,5,14,64.3%,1h
34810,2,Belthazarr,2322,285,9,13,22,40.9%,36m
34810,3,CrytoKittie,2322,182,6,9,15,40.0%,5m
34810,2,[JAAM]JAAM,2322,158,5,16,21,23.8%,1h
34810,1,montaguy,2322,124,4,4,8,50.0%,1h
34810,3,SneakyTurtle,2322,121,3,0,3,100.0%,5m
34810,1,[JACPAR]FARAJ,2322,145,3,1,4,75.0%,4m
34810,3,COMMANDO,2322,30,3,8,11,27.3%,3h
34810,3,EMI,2322,95,2,5,7,28.6%,3h
34810,1,[Dark1s]DarkHUNTER,2322,0,1,0,1,100.0%,40m
34810,1,JorgeClooney,2322,38,1,2,3,33.3%,59m
34810,1,Viral,2322,0,1,4,5,20.0%,1h
34810,1,RubberDucky,2322,48,1,4,5,20.0%,25m
34810,1,GauntletVII,2322,0,1,4,5,20.0%,1h
34810,1,vanizzle,2322,0,1,4,5,20.0%,59m
34810,1,Cebrius,2322,44,1,5,6,16.7%,1h
34810,1,PlayerTwo,2322,0,1,5,6,16.7%,2m
34810,1,[Sopita]Rodomeo,2322,0,0,1,1,0.0%,50m
34810,2,Kleemore,2322,0,0,1,1,0.0%,30m
34810,1,UZCON,2322,0,0,1,1,0.0%,58m
34839,3,[KhanZ]Skye,2321,1503,310,310,620,50.0%,20m
34839,3,Sohrab,2321,1528,264,250,514,51.4%,1h
34839,3,Marthbar,2321,1580,126,125,251,50.2%,1h
34839,2,MENGSK,2321,822,65,70,135,48.1%,3h
34839,2,MadeofStars,2321,1153,64,74,138,46.4%,1h
34839,3,Schweder,2321,1055,60,42,102,58.8%,15m
34839,1,[XpKAc]MADEATH,2321,1575,60,46,106,56.6%,30m
34839,1,Everlust,2321,255,38,56,94,40.4%,3h
34839,2,[DOJMB]Havok,2321,930,37,39,76,48.7%,9m
34839,2,xtrem,2321,947,36,42,78,46.2%,24m
34839,1,Arkham,2321,1122,34,34,68,50.0%,3h
34839,1,Redmage,2321,748,26,16,42,61.9%,45m
34839,3,Rhino,2321,458,16,24,40,40.0%,1h
34839,1,qrtpasdca,2321,664,16,26,42,38.1%,3m
34839,3,Pikadvanced,2321,404,15,21,36,41.7%,1h
34839,3,NoCheesePls,2321,269,9,14,23,39.1%,3h
34839,3,lttlboy,2321,254,9,16,25,36.0%,3h
34839,3,Hahahahaha,2321,249,9,20,29,31.0%,3h
34839,1,AVR,2321,299,7,6,13,53.8%,39m
34839,3,aRcHaNgEl,2321,188,7,13,20,35.0%,33m
34839,1,KingGeorge,2321,230,6,4,10,60.0%,41m
34839,3,AVA,2321,118,5,6,11,45.5%,19m
34839,2,Pjohson,2321,60,5,8,13,38.5%,53m
34839,2,[FyHr]Setban,2321,134,4,5,9,44.4%,3h
34839,1,zecrAg,2321,131,3,4,7,42.9%,3h
34839,1,DonMafa,2321,44,2,0,2,100.0%,3m
34839,1,SCAFER,2321,80,2,3,5,40.0%,1h
34839,1,TrashPleb,2321,44,1,1,2,50.0%,1h
34839,1,MasterOfGods,2321,40,1,2,3,33.3%,56m
34839,3,mike,2321,0,1,3,4,25.0%,23m
34839,1,SINDLU,2321,0,1,3,4,25.0%,1h
34839,1,abas,2321,0,1,4,5,20.0%,3h
34839,1,scvready,2321,0,1,4,5,20.0%,13m
34839,1,parkhyun,2321,0,1,4,5,20.0%,1h
34839,3,billbuster,2321,42,1,5,6,16.7%,3h
34839,1,Warpig,2321,0,0,1,1,0.0%,38m
34839,2,Proxy,2321,0,0,2,2,0.0%,3h
34839,1,LtAssHat,2321,0,0,3,3,0.0%,1h
34839,3,[0AAA1]Dragunov,2321,0,0,4,4,0.0%,11m
34878,1,[SECT4]Joheyko,2320,1246,163,145,308,52.9%,1h
34878,3,ohmeingott,2320,614,57,54,111,51.4%,1h
34878,3,contravene,2320,944,34,41,75,45.3%,1h
34878,1,biscuit,2320,811,31,30,61,50.8%,3m
34878,2,Dodo,2320,836,28,44,72,38.9%,27m
34878,3,Matador,2320,571,21,27,48,43.8%,44m
34878,2,Poseidon,2320,406,14,22,36,38.9%,3h
34878,1,[IowAPM]FuzZzERD,2320,404,10,7,17,58.8%,13m
34878,2,ErlFiend,2320,260,10,10,20,50.0%,18m
34878,1,[Ch33s]TimtheLucky,2320,218,5,6,11,45.5%,30m
34878,3,Swankypants,2320,190,5,7,12,41.7%,1h
34878,2,starman,2320,198,5,8,13,38.5%,1h
34878,1,Cuahutemoc,2320,132,3,3,6,50.0%,1h
34878,1,hepeto,2320,92,3,4,7,42.9%,1h
34878,1,[TBPC]Bacchus,2320,88,2,6,8,25.0%,1h
34878,1,remi,2320,0,1,0,1,100.0%,3h
34878,1,[5one50]theriotmaker,2320,0,1,2,3,33.3%,1h
34878,1,Icemax,2320,0,1,4,5,20.0%,3h
34878,1,[LY0]BigXavy,2320,0,1,6,7,14.3%,1h
34878,3,[Cryptc]Stealth,2320,30,1,11,12,8.3%,1h
34878,1,TheReptile,2320,0,0,1,1,0.0%,3h
34878,1,DawnsElite,2320,0,0,2,2,0.0%,42m
34878,1,Cerberus,2320,0,0,3,3,0.0%,47m
34878,1,Ratatron,2320,0,0,5,5,0.0%,1h
34902,3,garlicnaan,2319,1599,360,366,726,49.6%,17m
34902,1,[FFAA]Matt,2319,1874,136,134,270,50.4%,3h
34902,3,Earth,2319,1212,81,85,166,48.8%,9m
34902,2,Titanius,2319,1586,80,81,161,49.7%,28m
34902,1,Draknar,2319,1159,40,38,78,51.3%,1h
34902,1,[4L0k0]NightCrawler,2319,659,26,18,44,59.1%,39m
34902,1,PoonPoon,2319,552,21,40,61,34.4%,20m
34902,1,DrSmashy,2319,401,11,18,29,37.9%,5m
34902,3,Pourya,2319,144,9,11,20,45.0%,1h
34902,3,[MACETA]KILLNITRON,2319,251,8,12,20,40.0%,1h
34902,1,[WRFs87]Soriano,2319,174,5,7,12,41.7%,54m
34902,3,azzurro,2319,171,5,9,14,35.7%,3h
34902,3,[SOAF]ZobelPrize,2319,160,5,9,14,35.7%,3h
34902,1,KingOfWar,2319,167,5,9,14,35.7%,1h
34902,1,Xenoknight,2319,88,4,5,9,44.4%,3h
34902,3,OhHellYeah,2319,121,3,0,3,100.0%,1h
34902,3,[YD2K]Zebregts,2319,0,3,5,8,37.5%,1h
34902,1,Lko,2319,44,2,5,7,28.6%,3h
34902,1,DioBrando,2319,48,2,6,8,25.0%,42m
34902,1,Joss,2319,0,1,0,1,100.0%,40m
34902,1,GeorgeWKush,2319,0,1,1,2,50.0%,3h
34902,1,carlos,2319,0,1,1,2,50.0%,3h
34902,1,Stoop,2319,0,1,1,2,50.0%,45m
34902,1,Barkan,2319,44,1,1,2,50.0%,36m
34902,1,Fedasus,2319,38,1,2,3,33.3%,1h
34902,3,willywise,2319,0,1,4,5,20.0%,3h
34902,3,madalex,2319,36,1,5,6,16.7%,3h
34902,1,[xTPCx]Chamipon,2319,0,1,5,6,16.7%,3h
34902,1,Hackbenjamin,2319,0,1,5,6,16.7%,4m
34902,1,[G0RE]ravin,2319,0,0,1,1,0.0%,59m
34902,1,[KGH7]ColeMichael,2319,0,0,2,2,0.0%,1h
34902,1,KaloAgo,2319,0,0,3,3,0.0%,25m
34902,1,Norda,2319,0,0,5,5,0.0%,25m
34935,1,PaoloLawas,2318,1871,173,196,369,46.9%,47m
34935,3,sece,2318,924,90,100,190,47.4%,33m
34935,2,menace,2318,1409,55,59,114,48.2%,3h
34935,1,[Bajos]Cadmusdr,2318,1037,50,40,90,55.6%,3h
34935,1,Felman,2318,1024,44,54,98,44.9%,17m
34935,3,colainglesa,2318,1026,37,41,78,47.4%,34m
34935,1,WhiteShadow,2318,963,33,34,67,49.3%,35m
34935,1,[DePana]Razor,2318,695,26,16,42,61.9%,3h
34935,1,butterman,2318,518,18,9,27,66.7%,3h
34935,1,[nomame]minifig,2318,613,18,21,39,46.2%,1h
34935,1,[ÆON]Qcbouchard,2318,598,17,15,32,53.1%,1h
34935,1,YourAnimeGF,2318,652,17,22,39,43.6%,22m
34935,1,SgtHugo,2318,314,11,7,18,61.1%,15m
34935,1,[Awiiir]Colt,2318,280,9,4,13,69.2%,1h
34935,3,Robert,2318,257,8,16,24,33.3%,1h
34935,1,walkingfish,2318,219,7,6,13,53.8%,1h
34935,2,Fenrir,2318,220,7,18,25,28.0%,1h
34935,3,Lolz,2318,178,6,7,13,46.2%,18m
34935,1,krung,2318,192,5,6,11,45.5%,3h
34935,1,warfare,2318,143,3,7,10,30.0%,1h
34935,1,Duke,2318,44,2,0,2,100.0%,49m
34935,1,XXL,2318,44,2,3,5,40.0%,6m
34935,3,doctorman,2318,133,2,5,7,28.6%,1h
34935,1,GreenMachine,2318,44,2,5,7,28.6%,39m
34935,1,GaLaXoR,2318,0,1,1,2,50.0%,1h
34935,1,[Eat314]BigTityGirls,2318,0,1,1,2,50.0%,5m
34935,3,Kyo,2318,0,1,2,3,33.3%,1h
34935,1,wwr,2318,0,0,1,1,0.0%,1h
34935,1,KottonTooth,2318,0,0,1,1,0.0%,36m
34935,1,LTH,2318,0,0,1,1,0.0%,42m
34965,1,LuchoQwerty,2317,1847,125,117,242,51.7%,3h
34965,3,Chava,2317,1539,118,107,225,52.4%,47m
34965,1,[JOSOWE]HeroZealot,2317,1373,53,34,87,60.9%,3h
34965,1,CARDOS,2317,735,30,23,53,56.6%,3h
34965,1,diegumm,2317,559,26,19,45,57.8%,60m
34965,3,Chiddybang,2317,476,24,30,54,44.4%,54m
34965,1,DaMoon,2317,424,12,9,21,57.1%,3h
34965,2,Fragolds,2317,265,8,15,23,34.8%,3h
34965,1,[ATEA]GayAngel,2317,242,6,10,16,37.5%,30m
34965,2,WingmanCZ,2317,108,4,4,8,50.0%,11m
34965,1,[a1b2]charque,2317,42,2,2,4,50.0%,59m
34965,3,vidaloka,2317,30,2,6,8,25.0%,3h
34965,1,[DBOIZ]CliffBooth,2317,44,1,1,2,50.0%,21m
34965,1,Who,2317,0,1,2,3,33.3%,17m
34965,1,Huataki,2317,0,1,4,5,20.0%,1h
34965,1,LeoCompa,2317,0,1,4,5,20.0%,3h
34965,3,Dolokhov,2317,0,1,5,6,16.7%,1h
34965,1,[hekya]atticus,2317,0,1,5,6,16.7%,1h
34965,1,[Dimand]MenYmaN,2317,0,0,1,1,0.0%,1h
34965,1,Gunner,2317,0,0,1,1,0.0%,3h
34965,1,DaRkSniper,2317,0,0,2,2,0.0%,1h
34986,1,Term,2316,1839,100,87,187,53.5%,44m
34986,3,BisonBiscuts,2316,1553,90,90,180,50.0%,34m
34986,1,TheProphet,2316,1860,68,67,135,50.4%,21m
34986,3,Chemyst,2316,731,48,48,96,50.0%,57m
34986,1,CABECHIME,2316,1196,40,44,84,47.6%,1h
34986,1,Paylaylay,2316,1047,38,25,63,60.3%,1h
34986,2,Zelph,2316,880,38,44,82,46.3%,57m
34986,1,goose,2316,1006,37,30,67,55.2%,41m
34986,1,Carnium,2316,480,14,9,23,60.9%,1h
34986,3,Vinpumaman,2316,378,13,20,33,39.4%,27m
34986,1,RikAxe,2316,354,10,12,22,45.5%,26m
34986,1,ElConejito,2316,324,8,8,16,50.0%,6m
34986,1,[Sc2Maf]Tossangel,2316,208,6,4,10,60.0%,1h
34986,2,[LOVEMA]NachoEater,2316,88,4,4,8,50.0%,8m
34986,1,iliminator,2316,88,3,2,5,60.0%,3h
34986,1,Vincet,2316,0,2,4,6,33.3%,14m
34986,2,[N2F]Prelude,2316,118,2,5,7,28.6%,3h
34986,1,MaxMaximus,2316,42,2,5,7,28.6%,21m
34986,3,Christxpher,2316,0,2,5,7,28.6%,34m
34986,3,Foamy,2316,60,2,12,14,14.3%,3h
34986,1,[M1ghty]Salok,2316,0,1,0,1,100.0%,3h
34986,1,SoapyCoyote,2316,42,1,1,2,50.0%,3h
34986,1,Vurhaast,2316,44,1,2,3,33.3%,9m
34986,3,Qriator,2316,0,1,6,7,14.3%,1h
34986,1,PapaAlfrego,2316,0,0,1,1,0.0%,1h
34986,1,STARKING,2316,0,0,1,1,0.0%,1h
34986,1,PmaMode,2316,0,0,2,2,0.0%,2m
34986,1,imtatjr,2316,0,0,3,3,0.0%,59m
35014,2,Jimmothy,2315,1564,193,193,386,50.0%,2m
35014,2,deFragNZ,2315,1398,94,109,203,46.3%,1h
35014,1,ALEJANDRO,2315,1799,76,77,153,49.7%,3h
35014,2,SureCheese,2315,1302,47,63,110,42.7%,26m
35014,1,Cavanagh,2315,775,38,31,69,55.1%,9m
35014,2,tibudweiser,2315,1026,36,47,83,43.4%,3h
35014,1,Abasio,2315,1066,33,32,65,50.8%,3h
35014,1,blarg,2315,791,23,23,46,50.0%,59m
35014,1,[BLKOPS]Mellomike,2315,573,20,20,40,50.0%,3h
35014,1,Sykosys,2315,630,18,13,31,58.1%,3h
35014,1,Tirith,2315,332,13,21,34,38.2%,3h
35014,1,locojuhi,2315,293,10,6,16,62.5%,56m
35014,1,Aone,2315,264,10,12,22,45.5%,1h
35014,2,Wolf,2315,280,10,20,30,33.3%,1h
35014,1,Dolothion,2315,215,9,2,11,81.8%,3h
35014,1,[JUGOS]catalanex,2315,153,4,2,6,66.7%,3h
35014,3,BernieSander,2315,141,4,7,11,36.4%,5m
35014,1,ELSpartano,2315,131,3,0,3,100.0%,3h
35014,1,OurGuy,2315,193,3,3,6,50.0%,1h
35014,3,Légion,2315,90,3,6,9,33.3%,3h
35014,1,[HN504]noobleak,2315,0,2,2,4,50.0%,5m
35014,1,Rustyfetus,2315,48,2,5,7,28.6%,1h
35014,2,Astro,2315,0,2,7,9,22.2%,48m
35014,1,Shaboo,2315,0,1,1,2,50.0%,1h
35014,1,shlimerP,2315,0,1,2,3,33.3%,41m
35014,1,Juda,2315,0,1,2,3,33.3%,29m
35014,1,[buddy]BigChano,2315,0,1,4,5,20.0%,3m
35014,1,theHoff,2315,0,1,4,5,20.0%,1h
35014,1,Crimson,2315,0,0,1,1,0.0%,3h
35014,1,ZhouEnlai,2315,0,0,1,1,0.0%,45m
35014,1,MarkAramayo,2315,0,0,2,2,0.0%,3h
35014,1,VORTEX,2315,0,0,3,3,0.0%,48m
35046,3,[KiMBR]Utred,2314,743,125,128,253,49.4%,34m
35046,3,[XpKAc]Xavidin,2314,1583,93,91,184,50.5%,1h
35046,3,akaba,2314,852,74,61,135,54.8%,1h
35046,1,undeadZOMBIE,2314,1110,42,39,81,51.9%,3h
35046,3,worms,2314,729,36,32,68,52.9%,3h
35046,1,[FyHr]MacKayA,2314,1132,34,38,72,47.2%,3h
35046,3,[KLR]MajorTaco,2314,853,33,40,73,45.2%,1h
35046,3,OneAndOnlyAB,2314,577,21,25,46,45.7%,3h
35046,1,KRONOX,2314,515,21,25,46,45.7%,2m
35046,1,BOWLIN,2314,664,19,21,40,47.5%,1h
35046,1,[GOPERÚ]deathwork,2314,460,17,5,22,77.3%,11m
35046,1,TheBoomer,2314,424,16,10,26,61.5%,49m
35046,2,AFatCow,2314,464,15,27,42,35.7%,30m
35046,1,[SEMPAY]Marcus,2314,386,12,10,22,54.5%,3h
35046,3,Ancient,2314,276,11,15,26,42.3%,41m
35046,3,mirnuri,2314,253,9,11,20,45.0%,5m
35046,2,Nietzsche,2314,236,8,10,18,44.4%,41m
35046,3,[RPGmng]TryMeh,2314,200,7,9,16,43.8%,13m
35046,1,Dark,2314,206,6,6,12,50.0%,58m
35046,1,[DETER]Nom,2314,172,5,3,8,62.5%,35m
35046,1,JBreezy,2314,120,4,3,7,57.1%,36m
35046,1,[SCVM]NightKnight,2314,170,4,4,8,50.0%,56m
35046,3,[RMFG]ElPeron,2314,90,4,8,12,33.3%,3h
35046,1,YearSeven,2314,128,3,3,6,50.0%,1h
35046,2,Erus,2314,32,3,13,16,18.8%,57m
35046,1,popyoegg,2314,46,2,3,5,40.0%,49m
35046,3,Kraken,2314,58,2,5,7,28.6%,54m
35046,2,Simonlemu,2314,0,2,5,7,28.6%,1h
35046,3,sebbers,2314,94,2,6,8,25.0%,47m
35046,1,[GRNSKN]Skynet,2314,0,1,0,1,100.0%,1h
35046,1,katto,2314,46,1,2,3,33.3%,59m
35046,1,Hunterpier,2314,0,1,4,5,20.0%,1h
35046,1,HoundaNation,2314,0,1,4,5,20.0%,5m
35046,1,Penguin,2314,0,0,2,2,0.0%,40m
35046,1,Gaboo,2314,0,0,2,2,0.0%,1h
35046,3,[Sketti]Grains,2314,0,0,3,3,0.0%,1h
35046,3,[ISMs]TimeTraveler,2314,0,0,3,3,0.0%,1h
35046,1,JaggerTerran,2314,0,0,5,5,0.0%,3h
35084,2,Hodor,2313,1309,199,187,386,51.6%,1h
35084,1,FuhkrCarlson,2313,1871,143,142,285,50.2%,3h
35084,1,BeoWtfuuu,2313,1417,62,52,114,54.4%,3h
35084,1,Darkside,2313,1296,43,43,86,50.0%,59m
35084,1,Timba,2313,1256,39,35,74,52.7%,1h
35084,1,monolicho,2313,876,28,34,62,45.2%,3h
35084,1,Rosseti,2313,554,15,15,30,50.0%,3h
35084,1,KaizzerVanAs,2313,509,14,10,24,58.3%,3h
35084,1,ASU,2313,307,14,12,26,53.8%,1h
35084,3,AshY,2313,300,9,12,21,42.9%,3h
35084,1,CrimsonChin,2313,326,9,14,23,39.1%,3h
35084,1,betotto,2313,328,8,7,15,53.3%,3h
35084,2,ACE,2313,176,6,8,14,42.9%,3h
35084,3,rAndom,2313,118,4,10,14,28.6%,1h
35084,1,Der,2313,84,3,1,4,75.0%,3h
35084,1,[110011]wolfofshades,2313,128,3,4,7,42.9%,1h
35084,3,DonkeyRunner,2313,60,3,5,8,37.5%,1h
35084,3,KhalemOdune,2313,121,3,7,10,30.0%,5m
35084,1,cfresno,2313,0,2,5,7,28.6%,1h
35084,2,CptThomas,2313,0,2,6,8,25.0%,58m
35084,1,Galleta,2313,36,2,6,8,25.0%,6m
35084,2,Captanprotae,2313,0,2,7,9,22.2%,30m
35084,1,LewsTherin,2313,0,1,3,4,25.0%,39m
35084,1,Archer,2313,0,1,3,4,25.0%,13m
35084,1,sujo,2313,0,1,4,5,20.0%,3h
35084,3,angelsuper,2313,0,1,6,7,14.3%,3h
35084,2,RoNalDD,2313,0,0,1,1,0.0%,53m
35084,3,Dormammu,2313,0,0,2,2,0.0%,1h
35112,1,wildmonster,2312,1726,187,216,403,46.4%,1h
35112,2,CONQUISTADOR,2312,1570,129,132,261,49.4%,42m
35112,3,[MIDMX]Ale,2312,1502,117,110,227,51.5%,1h
35112,2,jamoink,2312,1352,103,105,208,49.5%,2m
35112,2,[GJoyy]ngdwilson,2312,1012,73,76,149,49.0%,1h
35112,3,Blackram,2312,1392,61,56,117,52.1%,20m
35112,3,ChaptheBold,2312,1106,52,42,94,55.3%,1h
35112,2,yorsh,2312,450,24,33,57,42.1%,1h
35112,1,henry,2312,565,20,9,29,69.0%,3h
35112,2,shuman,2312,546,17,29,46,37.0%,1h
35112,1,DrewIQ,2312,492,15,13,28,53.6%,9m
35112,1,KayChuck,2312,440,11,14,25,44.0%,3h
35112,3,willkingjr,2312,183,8,11,19,42.1%,34m
35112,1,Sxycle,2312,244,7,10,17,41.2%,1h
35112,1,Roow,2312,144,5,6,11,45.5%,3h
35112,3,Texugo,2312,154,5,10,15,33.3%,11m
35112,1,llllllllllll,2312,162,4,5,9,44.4%,45m
35112,1,BrickWiggles,2312,88,3,1,4,75.0%,1h
35112,1,Lucas,2312,94,3,1,4,75.0%,49m
35112,1,[Zetha]Feder,2312,42,2,1,3,66.7%,1h
35112,1,[RawBBC]Mittens,2312,0,2,3,5,40.0%,3h
35112,1,KRATOS,2312,86,2,4,6,33.3%,3h
35112,2,Fabricuy,2312,0,2,6,8,25.0%,16m
35112,1,Breakthree,2312,0,1,0,1,100.0%,1h
35112,1,[TY4GG]Dominator,2312,0,1,1,2,50.0%,42m
35112,1,Ikaro,2312,46,1,1,2,50.0%,3h
35112,1,Blackout,2312,44,1,2,3,33.3%,50m
35112,1,[AKNewb]camduto,2312,0,1,3,4,25.0%,7m
35112,1,Stigma,2312,0,1,4,5,20.0%,5m
35112,3,MachBambino,2312,0,1,6,7,14.3%,18m
35112,1,CowardlyCpl,2312,0,0,1,1,0.0%,14m
35112,1,scnightfire,2312,0,0,1,1,0.0%,43m
35112,1,TheCook,2312,0,0,1,1,0.0%,54m
35112,1,StarBallsmac,2312,0,0,1,1,0.0%,3h
35146,3,GLaDOS,2311,1241,96,96,192,50.0%,3h
35146,1,WetNightmare,2311,1530,86,80,166,51.8%,3h
35146,1,Stilgar,2311,1682,78,62,140,55.7%,40m
35146,1,Dramaster,2311,1203,75,89,164,45.7%,1h
35146,3,escanor,2311,1029,66,52,118,55.9%,1h
35146,3,pelaz,2311,792,27,35,62,43.5%,16m
35146,3,Gamalas,2311,693,26,36,62,41.9%,3h
35146,3,[tutin]Ricardo,2311,199,8,12,20,40.0%,1h
35146,3,MauSystem,2311,150,5,7,12,41.7%,34m
35146,1,[ÆON]Zerg,2311,120,4,4,8,50.0%,3h
35146,1,draco,2311,142,4,9,13,30.8%,1h
35146,1,hoeze,2311,90,3,4,7,42.9%,44m
35146,1,[fromQc]matraka,2311,96,3,6,9,33.3%,4m
35146,3,Youkelele,2311,30,3,7,10,30.0%,1h
35146,1,[NLTN]lazvar,2311,84,2,1,3,66.7%,21m
35146,1,XDIILeon,2311,40,2,3,5,40.0%,3h
35146,1,ThisIsAWar,2311,122,2,5,7,28.6%,21m
35146,3,SuperMamani,2311,93,2,5,7,28.6%,3h
35146,3,buster,2311,30,2,6,8,25.0%,1h
35146,1,Madenlee,2311,0,1,0,1,100.0%,12m
35146,1,[BKill]BaLLocKs,2311,44,1,1,2,50.0%,1h
35146,1,[ZTemps]LevelNN,2311,0,1,1,2,50.0%,33m
35146,1,lother,2311,44,1,5,6,16.7%,12m
35146,1,TheTrueKing,2311,0,0,1,1,0.0%,3h
35146,3,[AbcCo]yozerg,2311,0,0,1,1,0.0%,20m
35171,1,SteveS,2310,1730,97,82,179,54.2%,1h
35171,1,Risuvirus,2310,985,56,60,116,48.3%,22m
35171,1,DaRkFoX,2310,1529,51,57,108,47.2%,11m
35171,3,[Zno]CaptainTuna,2310,1044,46,47,93,49.5%,5m
35171,3,Universalink,2310,878,32,37,69,46.4%,27m
35171,1,squarebeak,2310,908,29,20,49,59.2%,3h
35171,1,wrandas,2310,833,24,25,49,49.0%,1h
35171,1,OneUglyAsian,2310,437,23,17,40,57.5%,3h
35171,1,wikisqueaks,2310,784,22,23,45,48.9%,14m
35171,3,Icks,2310,624,22,25,47,46.8%,1h
35171,3,Smokeybud,2310,334,11,16,27,40.7%,1h
35171,3,BigBoy,2310,290,11,18,29,37.9%,16m
35171,3,Xson,2310,256,9,14,23,39.1%,1h
35171,2,skanks,2310,238,8,6,14,57.1%,3h
35171,3,Fusti,2310,199,8,11,19,42.1%,43m
35171,1,[Bunge]TunaTrench,2310,230,6,10,16,37.5%,5m
35171,1,NeuroGhost,2310,258,6,11,17,35.3%,42m
35171,2,koop,2310,160,4,6,10,40.0%,38m
35171,1,surpass,2310,97,2,1,3,66.7%,3h
35171,1,tdbronco,2310,120,2,5,7,28.6%,1h
35171,1,Vustec,2310,48,2,5,7,28.6%,6m
35171,1,Rchive,2310,48,2,6,8,25.0%,3h
35171,2,Chard,2310,115,2,7,9,22.2%,1h
35171,1,IceDemon,2310,0,1,2,3,33.3%,5m
35171,1,Matce,2310,46,1,3,4,25.0%,40m
35171,1,zeit,2310,97,1,5,6,16.7%,3h
35171,3,DrJ,2310,0,1,5,6,16.7%,57m
35171,2,DAvEX,2310,0,1,7,8,12.5%,53m
35171,1,Serethriel,2310,0,0,1,1,0.0%,1h
35171,1,TCSConfine,2310,0,0,1,1,0.0%,1h
35171,1,[FONDE]Gastondalf,2310,0,0,2,2,0.0%,42m
35202,2,theArtist,2309,1507,102,121,223,45.7%,26m
35202,1,Mantis,2309,1680,100,97,197,50.8%,1h
35202,3,moonwatch,2309,1532,90,106,196,45.9%,1h
35202,1,Hesawinner,2309,1632,75,65,140,53.6%,3h
35202,3,[tagg]Retromojo,2309,1341,70,73,143,49.0%,1h
35202,3,Fanfa,2309,1036,58,54,112,51.8%,3h
35202,1,LeTaLMaChinE,2309,428,47,57,104,45.2%,40m
35202,3,NorbanSentha,2309,1244,42,63,105,40.0%,42m
35202,3,Arcane,2309,608,25,26,51,49.0%,1h
35202,3,[MaxWin]GralDuck,2309,531,22,24,46,47.8%,40m
35202,2,Pronker,2309,676,22,33,55,40.0%,1h
35202,1,[WWI]Drewpy,2309,572,14,20,34,41.2%,1h
35202,2,BountyHunter,2309,311,12,16,28,42.9%,1h
35202,3,Gaba,2309,252,10,17,27,37.0%,1h
35202,3,Poida,2309,206,6,5,11,54.5%,3h
35202,1,tiojofa,2309,262,6,6,12,50.0%,59m
35202,2,Polymorph,2309,186,5,10,15,33.3%,37m
35202,3,[dodgy]TorpicalFish,2309,149,5,12,17,29.4%,3h
35202,1,BRstarkiller,2309,134,3,6,9,33.3%,1h
35202,3,[ZLS]FulkerGG,2309,62,3,7,10,30.0%,40m
35202,1,HugoElias,2309,48,2,5,7,28.6%,13m
35202,1,Twiz,2309,0,1,0,1,100.0%,3h
35202,1,nivlaq,2309,46,1,1,2,50.0%,12m
35202,1,Dibbles,2309,0,1,1,2,50.0%,1h
35202,1,guihbat,2309,44,1,2,3,33.3%,3h
35202,1,Lazerbang,2309,0,0,2,2,0.0%,3h
35228,3,CheezIt,2308,1333,370,378,748,49.5%,1h
35228,3,XumboMito,2308,1436,117,116,233,50.2%,3h
35228,1,LuanOwnedz,2308,1192,43,33,76,56.6%,39m
35228,3,lStrykerl,2308,652,26,27,53,49.1%,1h
35228,1,jay,2308,700,21,18,39,53.8%,1h
35228,1,Dusty,2308,641,18,15,33,54.5%,1h
35228,3,ComancheMoon,2308,505,18,26,44,40.9%,1h
35228,1,JordyJoesta,2308,487,14,11,25,56.0%,3h
35228,1,Asantos,2308,423,14,19,33,42.4%,3h
35228,1,ZerglyBergly,2308,396,13,22,35,37.1%,6m
35228,1,Noja,2308,399,12,15,27,44.4%,59m
35228,3,RAY,2308,328,12,19,31,38.7%,30m
35228,1,[StFx]NAQNAQ,2308,455,11,14,25,44.0%,3h
35228,1,[GRNSKN]DLCForcesTTV,2308,318,9,6,15,60.0%,12m
35228,3,[ThShMe]DarkStark,2308,287,9,9,18,50.0%,10m
35228,1,stork,2308,305,9,9,18,50.0%,3h
35228,3,HarborBay,2308,225,7,10,17,41.2%,52m
35228,1,LewsTherin,2308,128,4,6,10,40.0%,3h
35228,2,Kraftik,2308,90,4,9,13,30.8%,48m
35228,1,Phantasy,2308,0,3,2,5,60.0%,44m
35228,1,davinci,2308,128,3,5,8,37.5%,3h
35228,1,VoyagerZ,2308,97,2,1,3,66.7%,1h
35228,1,Kosmic,2308,0,1,0,1,100.0%,21m
35228,1,Near,2308,40,1,5,6,16.7%,3h
35228,1,Deploy,2308,34,1,5,6,16.7%,14m
35228,1,[nieBla]Heinsenberg,2308,105,1,11,12,8.3%,47m
35228,1,jabberwookie,2308,0,0,1,1,0.0%,3h
35228,1,Brokenaegis,2308,0,0,1,1,0.0%,3h
35228,3,ParanoidMarv,2308,0,0,5,5,0.0%,1h
35257,2,Torraxe,2307,1536,205,219,424,48.3%,1h
35257,2,DangerFlow,2307,1505,170,182,352,48.3%,9m
35257,1,Wesley,2307,1534,105,97,202,52.0%,36m
35257,1,cScott,2307,1280,84,64,148,56.8%,3h
35257,2,SlimShady,2307,1304,82,99,181,45.3%,7m
35257,1,[ValidG]Interupt,2307,835,37,17,54,68.5%,49m
35257,3,CHIPPER,2307,828,30,36,66,45.5%,55m
35257,1,TomTerran,2307,846,24,21,45,53.3%,1h
35257,1,Avenger,2307,630,19,19,38,50.0%,3h
35257,1,[KGRILL]iseek,2307,698,18,27,45,40.0%,1h
35257,2,ConfuseEagle,2307,419,14,20,34,41.2%,3h
35257,3,blckbsct,2307,352,12,13,25,48.0%,44m
35257,3,[bergh]deyl,2307,210,7,12,19,36.8%,3h
35257,3,[oRuRo]ERICKSON,2307,178,5,7,12,41.7%,13m
35257,3,AONEC,2307,126,5,10,15,33.3%,1h
35257,2,ReTuNe,2307,130,4,15,19,21.1%,35m
35257,1,BANEEXPLODE,2307,48,2,1,3,66.7%,18m
35257,2,JeanLuc,2307,103,2,2,4,50.0%,30m
35257,1,Izraf,2307,86,2,2,4,50.0%,1h
35257,1,iATechnique,2307,95,2,2,4,50.0%,56m
35257,3,newlegade,2307,122,2,3,5,40.0%,20m
35257,1,Dropinurhome,2307,97,2,5,7,28.6%,1h
35257,3,[KashG]Invader,2307,72,2,8,10,20.0%,18m
35257,1,Dodogama,2307,0,1,0,1,100.0%,3h
35257,1,NightRaven,2307,42,1,1,2,50.0%,3h
35257,1,PalomoCojo,2307,0,1,1,2,50.0%,50m
35257,1,[PacheK]TONY,2307,0,1,1,2,50.0%,30m
35257,1,Deethdelir,2307,0,0,2,2,0.0%,1h
35257,1,Bismarck,2307,0,0,3,3,0.0%,3h
35257,1,[NOTEK]blackbandit,2307,0,0,4,4,0.0%,3h
35287,1,WaveRider,2306,620,23,24,47,48.9%,1h
35287,2,FyrECatZ,2306,392,16,1,17,94.1%,3h
35287,1,[AmSs]Algoz,2306,372,11,13,24,45.8%,3h
35287,1,KingChrono,2306,366,10,8,18,55.6%,1h
35287,3,raynor,2306,200,8,2,10,80.0%,1h
35287,1,RCC,2306,316,8,3,11,72.7%,3h
35287,2,naftar,2306,262,8,12,20,40.0%,19m
35287,3,Wolfareasome,2306,220,7,9,16,43.8%,23m
35287,1,franzbeets,2306,283,6,2,8,75.0%,26m
35287,1,ASSASSINS,2306,260,6,7,13,46.2%,60m
35287,3,Dolodiar,2306,202,5,9,14,35.7%,21m
35287,1,ComradeRezno,2306,88,3,2,5,60.0%,3h
35287,1,Kole,2306,97,3,3,6,50.0%,4m
35287,1,SigmaGaboz,2306,42,2,0,2,100.0%,3h
35287,3,Mangyis,2306,94,2,5,7,28.6%,30m
35287,3,Xandros,2306,96,2,5,7,28.6%,3h
35287,1,WhatsUpLadys,2306,0,1,0,1,100.0%,1h
35287,3,MacMuffin,2306,0,1,1,2,50.0%,23m
35287,1,Gcrooster,2306,44,1,2,3,33.3%,3h
35287,1,Freks,2306,115,1,2,3,33.3%,3h
35287,3,[McT]Doomhammer,2306,97,1,2,3,33.3%,1h
35287,1,GrippaNOOBYO,2306,46,1,3,4,25.0%,1h
35287,1,KimTaeHyung,2306,0,1,4,5,20.0%,30m
35287,1,Drifter,2306,95,1,5,6,16.7%,3m
35287,2,[Chummp]DALEG,2306,0,1,8,9,11.1%,1h
35287,1,[PzC]submit,2306,0,0,1,1,0.0%,3h
35287,1,philiprivers,2306,0,0,1,1,0.0%,3h
35314,3,bochita,2305,638,113,125,238,47.5%,57m
35314,2,BreathUnseen,2305,1527,79,90,169,46.7%,41m
35314,3,DanTheMan,2305,424,47,53,100,47.0%,40m
35314,3,WhiteLight,2305,825,43,40,83,51.8%,10m
35314,1,killa,2305,1114,38,39,77,49.4%,30m
35314,3,Fireteam,2305,564,23,21,44,52.3%,1h
35314,1,[ZTemps]GhOst,2305,629,18,13,31,58.1%,3h
35314,1,RebelDragon,2305,426,18,14,32,56.2%,56m
35314,3,Crog,2305,494,17,22,39,43.6%,57m
35314,3,WhiskeyPete,2305,238,11,14,25,44.0%,34m
35314,1,Toast,2305,306,10,12,22,45.5%,26m
35314,1,Potatomaster,2305,282,8,11,19,42.1%,1h
35314,3,[hewwo1]Rint,2305,223,7,5,12,58.3%,24m
35314,1,Nebula,2305,177,6,10,16,37.5%,3h
35314,3,Taskmaster,2305,156,5,9,14,35.7%,1h
35314,1,[B1223]bobwise,2305,144,4,9,13,30.8%,25m
35314,1,Gabito,2305,130,2,1,3,66.7%,57m
35314,1,blme,2305,48,2,5,7,28.6%,4m
35314,1,Thirawatus,2305,48,2,6,8,25.0%,1h
35314,3,[TGosuA]DookieButter,2305,58,2,10,12,16.7%,25m
35314,1,gabo,2305,48,1,1,2,50.0%,30m
35314,1,SeekNDestroy,2305,0,1,2,3,33.3%,30m
35314,1,Brother,2305,0,1,3,4,25.0%,1h
35314,1,iloucremv,2305,0,1,4,5,20.0%,3h
35314,3,Cobaki,2305,0,1,5,6,16.7%,17m
35314,3,[C66602]jet,2305,0,1,5,6,16.7%,3h
35314,1,[TRR]ventfan,2305,0,0,1,1,0.0%,59m
35314,1,[FAECES]TypicalGenra,2305,73,0,2,2,0.0%,59m
35314,1,BigDead,2305,0,0,6,6,0.0%,6m
35343,1,[LOHs]SerHei,2304,1613,121,133,254,47.6%,5m
35343,1,BetaStar,2304,1344,43,45,88,48.9%,40m
35343,1,[TGCrew]Krakpot,2304,847,33,35,68,48.5%,1h
35343,3,Deathgear,2304,794,32,34,66,48.5%,3h
35343,2,Lokrin,2304,766,25,35,60,41.7%,37m
35343,1,[BYU]DragonMage,2304,574,22,19,41,53.7%,30m
35343,3,PopeLeo,2304,356,13,20,33,39.4%,1h
35343,2,[d0ngZi]chaosjon,2304,148,7,12,19,36.8%,3h
35343,1,Redi,2304,258,6,10,16,37.5%,12m
35343,2,[KerriS]Andreus,2304,113,3,7,10,30.0%,53m
35343,1,Arctico,2304,0,2,3,5,40.0%,20m
35343,3,Ampt,2304,0,1,1,2,50.0%,1h
35343,3,Elchinolopez,2304,0,1,3,4,25.0%,40m
35343,1,[TeamEz]WarriorBoy,2304,0,1,4,5,20.0%,3h
35343,1,PoohBear,2304,40,1,4,5,20.0%,45m
35343,1,[EtPh]wolf,2304,42,1,4,5,20.0%,11m
35343,1,Rations,2304,44,1,4,5,20.0%,5m
35343,1,NoWayOut,2304,97,1,5,6,16.7%,54m
35343,1,Joker,2304,0,0,3,3,0.0%,44m
35343,1,YES,2304,0,0,3,3,0.0%,28m
35363,2,MegaSpeeD,2303,1549,157,157,314,50.0%,19m
35363,1,MFGATRUMP,2303,1832,99,101,200,49.5%,42m
35363,3,[SABO]ORAGNA,2303,1449,70,56,126,55.6%,20m
35363,3,ColKrumpler,2303,1540,61,70,131,46.6%,1h
35363,2,Thyme,2303,932,61,76,137,44.5%,53m
35363,3,MrSauceman,2303,549,43,39,82,52.4%,1h
35363,3,[CHAOSV]Griffin,2303,1126,42,43,85,49.4%,1h
35363,1,Talnorosh,2303,902,30,24,54,55.6%,36m
35363,2,[DRGNS]Cucho,2303,508,21,26,47,44.7%,3h
35363,3,Dirty,2303,532,20,23,43,46.5%,1h
35363,3,mcnasty,2303,518,19,25,44,43.2%,28m
35363,1,[neuroS]Duro,2303,299,15,8,23,65.2%,3h
35363,3,PizzaZubuzo,2303,383,15,12,27,55.6%,1h
35363,3,[TheB4d]Mineiro,2303,230,13,21,34,38.2%,40m
35363,1,SilverHawk,2303,289,10,11,21,47.6%,1h
35363,2,munstruo,2303,379,10,23,33,30.3%,1h
35363,2,Nicolas,2303,195,7,13,20,35.0%,1h
35363,1,bewm,2303,248,6,11,17,35.3%,3h
35363,1,[DNKCFT]warseeker,2303,166,4,4,8,50.0%,3h
35363,3,VOLSUM,2303,94,4,5,9,44.4%,20m
35363,3,SketchyTexan,2303,147,4,8,12,33.3%,8m
35363,1,[ASC1]TiredRaptor,2303,92,3,5,8,37.5%,3h
35363,1,bestbuys,2303,88,3,5,8,37.5%,21m
35363,1,[7FP]YEETdaWHEAT,2303,90,2,3,5,40.0%,36m
35363,1,[EZTZPZ]ArchSyntropy,2303,92,2,6,8,25.0%,3h
35363,1,Krean,2303,97,2,6,8,25.0%,49m
35363,1,Johnski,2303,48,2,6,8,25.0%,49m
35363,2,trashboat,2303,0,2,6,8,25.0%,2m
35363,1,[DRKESP]oryan,2303,0,1,0,1,100.0%,3h
35363,1,[6G]morgan,2303,48,1,1,2,50.0%,3h
35363,1,JMFV,2303,97,1,2,3,33.3%,1h
35363,1,kamisarada,2303,0,1,4,5,20.0%,3h
35363,1,MagicTurtle,2303,0,0,1,1,0.0%,1h
35363,1,Sallix,2303,0,0,2,2,0.0%,59m
35363,1,sevenonethre,2303,73,0,5,5,0.0%,36m
35398,3,HornyJ,2302,1529,297,300,597,49.7%,18m
35398,3,freeWheeler,2302,1501,237,228,465,51.0%,31m
35398,3,Sprinter,2302,1508,185,177,362,51.1%,3h
35398,3,[IsToAn]Morgoth,2302,1166,159,149,308,51.6%,1h
35398,2,lronSkin,2302,1564,156,167,323,48.3%,48m
35398,2,Brian,2302,1098,74,88,162,45.7%,47m
35398,3,Marcelo,2302,347,27,24,51,52.9%,1h
35398,1,JERRYIAH,2302,763,26,14,40,65.0%,3h
35398,1,Ruli,2302,766,22,21,43,51.2%,3h
35398,1,[UCF]TitanWarrior,2302,732,20,22,42,47.6%,3h
35398,1,Fido,2302,703,19,17,36,52.8%,22m
35398,1,[ApmTen]Bronze,2302,606,16,10,26,61.5%,1h
35398,1,PNusBreath,2302,260,8,9,17,47.1%,3h
35398,1,[YouNo]BaitsbyDre,2302,322,8,13,21,38.1%,45m
35398,3,Hyun,2302,179,7,7,14,50.0%,3h
35398,1,[WarLT]illidam,2302,174,5,5,10,50.0%,1h
35398,3,Pryce,2302,104,5,9,14,35.7%,3h
35398,3,Kuzakani,2302,152,5,12,17,29.4%,1h
35398,1,[LOHs]Pertado,2302,130,4,2,6,66.7%,3h
35398,1,GlazMain,2302,0,1,0,1,100.0%,20m
35398,1,HUGO,2302,0,1,3,4,25.0%,3h
35398,1,Terran,2302,46,1,7,8,12.5%,57m
35398,1,[FTLT]elgranpapu,2302,0,0,1,1,0.0%,22m
35398,1,Alex,2302,0,0,1,1,0.0%,44m
35398,3,DrHika,2302,0,0,2,2,0.0%,1h
35423,1,jose,2301,1801,121,113,234,51.7%,16m
35423,3,[Epokhé]gallitodeoro,2301,792,89,82,171,52.0%,21m
35423,3,kevin,2301,1204,61,69,130,46.9%,1h
35423,3,GOLDENBOY,2301,798,29,29,58,50.0%,3h
35423,3,Poon,2301,568,24,21,45,53.3%,44m
35423,1,BloodReaver,2301,438,16,14,30,53.3%,14m
35423,3,NoMad,2301,319,11,12,23,47.8%,29m
35423,1,KOROLA,2301,411,10,13,23,43.5%,1h
35423,1,Joey,2301,318,9,8,17,52.9%,3h
35423,3,AdamNguyen,2301,254,8,12,20,40.0%,1h
35423,3,[DhZAc1]TheMarine,2301,222,6,5,11,54.5%,1h
35423,1,Kember,2301,84,3,1,4,75.0%,2m
35423,1,Meeps,2301,133,3,3,6,50.0%,7m
35423,1,derrickk,2301,44,2,0,2,100.0%,3h
35423,1,[UAE]agilepotato,2301,130,2,1,3,66.7%,1h
35423,1,Ank,2301,46,2,2,4,50.0%,3h
35423,1,Claptrap,2301,34,2,2,4,50.0%,3h
35423,1,[CoVid]IIIIIIIIIIII,2301,0,2,3,5,40.0%,50m
35423,1,[LOHe]DEMNTE,2301,48,2,6,8,25.0%,5m
35423,2,[MURDD]zorb,2301,0,2,6,8,25.0%,3h
35423,3,Tarzul,2301,60,2,7,9,22.2%,1h
35423,1,NeO,2301,46,1,3,4,25.0%,1h
35423,1,[THDT]rogonzalez,2301,0,1,4,5,20.0%,15m
35423,1,[CBAS3]commander,2301,0,1,4,5,20.0%,38m
35423,1,psw,2301,0,0,2,2,0.0%,4m
35423,1,Gilbert,2301,0,0,3,3,0.0%,34m
35423,1,Gengar,2301,0,0,5,5,0.0%,21m
35423,3,pantalon,2301,0,0,10,10,0.0%,3h
35451,3,[GrnBrd]Quadrivium,2300,1538,437,441,878,49.8%,1h
35451,2,ffnando,2300,1481,147,149,296,49.7%,55m
35451,3,Baker,2300,1484,82,90,172,47.7%,55m
35451,1,[GLYN]Jfuster,2300,1460,76,75,151,50.3%,3h
35451,2,SOMARS,2300,393,57,68,125,45.6%,57m
35451,1,nono,2300,1135,42,42,84,50.0%,39m
35451,1,CEROCUATRO,2300,575,17,17,34,50.0%,4m
35451,1,[MMB]wilnaldo,2300,459,15,16,31,48.4%,3h
35451,1,[EoC]Luxsong,2300,403,15,22,37,40.5%,1h
35451,3,OptimusPrime,2300,380,14,14,28,50.0%,1h
35451,3,[CaC4s]efrain,2300,248,9,8,17,52.9%,21m
35451,1,SLATI,2300,287,8,8,16,50.0%,40m
35451,3,Donk,2300,200,6,11,17,35.3%,34m
35451,1,Murdura,2300,122,4,1,5,80.0%,52m
35451,3,mupon,2300,178,4,9,13,30.8%,1h
35451,1,theghost,2300,124,4,9,13,30.8%,3h
35451,1,[UpxV]Coronavirus,2300,88,3,2,5,60.0%,38m
35451,1,Yajmoxaj,2300,38,3,9,12,25.0%,57m
35451,3,MistakesMade,2300,131,2,1,3,66.7%,34m
35451,1,TheBoulder,2300,0,2,5,7,28.6%,44m
35451,2,Bot,2300,90,1,1,2,50.0%,20m
35451,3,Gengiskant,2300,0,1,5,6,16.7%,41m
35451,1,Superman,2300,0,0,1,1,0.0%,3h
35451,1,[KG73]Isaaxsin,2300,0,0,1,1,0.0%,3h
35451,1,Zergalicious,2300,0,0,2,2,0.0%,1h
35451,3,Theodore,2300,0,0,4,4,0.0%,1h
35451,3,RoyalewthChz,2300,0,0,6,6,0.0%,1h
35451,3,Scantron,2300,0,0,7,7,0.0%,1h
35479,3,GangstaBling,2299,1517,185,182,367,50.4%,18m
35479,3,galaxyking,2299,1516,104,117,221,47.1%,3h
35479,3,mayguns,2299,1288,50,51,101,49.5%,1h
35479,1,RaidGuy,2299,657,50,60,110,45.5%,8m
35479,2,DrCYH,2299,1105,48,73,121,39.7%,21m
35479,3,Trottskydm,2299,1095,45,53,98,45.9%,1h
35479,3,MIRAGE,2299,383,43,46,89,48.3%,16m
35479,3,ArmoredBus,2299,544,38,35,73,52.1%,6m
35479,3,LukeAdams,2299,584,34,39,73,46.6%,30m
35479,3,eetmabalz,2299,465,26,33,59,44.1%,55m
35479,3,mamatroll,2299,505,19,26,45,42.2%,34m
35479,1,XYON,2299,590,18,19,37,48.6%,1h
35479,2,Ragna,2299,492,16,25,41,39.0%,1h
35479,1,wOckhardt,2299,471,16,30,46,34.8%,3h
35479,1,xXAscensionX,2299,462,15,16,31,48.4%,3h
35479,1,Gallio,2299,323,12,5,17,70.6%,1h
35479,1,mintyfresh,2299,410,12,14,26,46.2%,3h
35479,1,ISIS,2299,362,12,16,28,42.9%,1h
35479,1,docholidayyy,2299,406,11,8,19,57.9%,56m
35479,1,israe,2299,164,10,19,29,34.5%,3h
35479,1,Bosko,2299,327,8,6,14,57.1%,59m
35479,3,TroNine,2299,90,5,10,15,33.3%,3h
35479,1,hevyapocs,2299,114,4,1,5,80.0%,3h
35479,1,Mazer,2299,168,4,7,11,36.4%,39m
35479,3,oze,2299,179,4,8,12,33.3%,3h
35479,3,[LagBoi]Skywalker,2299,142,3,7,10,30.0%,1h
35479,1,Akolatroink,2299,44,2,1,3,66.7%,3h
35479,1,[GeM]Balefire,2299,44,2,4,6,33.3%,14m
35479,1,Drizzle,2299,97,2,5,7,28.6%,3h
35479,3,Gaba,2299,30,2,6,8,25.0%,1h
35479,2,Ramos,2299,0,1,4,5,20.0%,1h
35479,1,IIIIIIIIIIII,2299,0,0,1,1,0.0%,54m
35479,1,[TTSP]AlastorIOB,2299,0,0,2,2,0.0%,3h
35512,3,[R0DANT]river,2298,1553,219,224,443,49.4%,1h
35512,1,NenoZ,2298,1734,162,162,324,50.0%,16m
35512,3,JuSho,2298,1495,160,162,322,49.7%,3h
35512,2,GumGumPistol,2298,1526,145,139,284,51.1%,54m
35512,3,Kickash,2298,1567,105,117,222,47.3%,1h
35512,1,OwnageJuice,2298,709,69,61,130,53.1%,3h
35512,1,SCC,2298,931,61,72,133,45.9%,1h
35512,3,LuchoYh,2298,1007,51,56,107,47.7%,33m
35512,3,RatSlayer,2298,462,34,35,69,49.3%,1h
35512,1,McClane,2298,928,30,28,58,51.7%,3h
35512,1,YEET,2298,643,19,13,32,59.4%,39m
35512,3,Quantinum,2298,404,15,16,31,48.4%,1h
35512,1,elpapi,2298,360,13,15,28,46.4%,1h
35512,1,CoolGuy,2298,311,9,6,15,60.0%,60m
35512,1,Jacques,2298,356,9,11,20,45.0%,3h
35512,3,[STB]giantpanda,2298,259,9,16,25,36.0%,1h
35512,3,deathMarine,2298,202,7,8,15,46.7%,3h
35512,3,Victim,2298,190,6,8,14,42.9%,1h
35512,1,LoseImprove,2298,172,5,5,10,50.0%,3h
35512,1,Crazyspx,2298,187,5,8,13,38.5%,3h
35512,3,XRAY,2298,0,5,10,15,33.3%,1h
35512,1,TreefurHighe,2298,112,4,0,4,100.0%,1h
35512,1,ThriftyRhino,2298,172,4,6,10,40.0%,3h
35512,1,[CRABBR]GPowell,2298,137,3,3,6,50.0%,3h
35512,3,Baujahr,2298,143,3,5,8,37.5%,1h
35512,3,PznSensation,2298,117,3,6,9,33.3%,55m
35512,1,Ymit,2298,167,3,6,9,33.3%,9m
35512,1,[MPPA]blitox,2298,44,2,2,4,50.0%,1h
35512,1,TheMonkies,2298,141,2,4,6,33.3%,49m
35512,3,bergstrome,2298,30,2,5,7,28.6%,1h
35512,1,crisscross,2298,40,1,4,5,20.0%,1h
35512,1,terry,2298,0,0,1,1,0.0%,57m
35512,1,[cl0udM]Hellfire,2298,0,0,1,1,0.0%,1h
35545,3,[CeRr]Adicts,2297,1323,114,106,220,51.8%,55m
35545,1,TARVIS,2297,1560,60,51,111,54.1%,3h
35545,2,Attidude,2297,1044,53,59,112,47.3%,1h
35545,2,MajorMOTAMAN,2297,680,24,37,61,39.3%,41m
35545,3,Lem,2297,590,20,29,49,40.8%,1h
35545,1,Slab,2297,548,18,23,41,43.9%,1h
35545,3,[W8C]AdrenalinE,2297,364,12,19,31,38.7%,3h
35545,2,ShAdOwShArK,2297,300,9,14,23,39.1%,1h
35545,1,GrandLarsony,2297,320,8,8,16,50.0%,12m
35545,2,MikeZulu,2297,214,8,13,21,38.1%,3h
35545,1,WINTERGREEN,2297,163,7,3,10,70.0%,3h
35545,1,[SANGRE]Luisangel,2297,256,7,8,15,46.7%,1h
35545,1,[0PS202]LEWIS,2297,168,6,5,11,54.5%,9m
35545,1,[MeanM]Alaren,2297,244,6,7,13,46.2%,54m
35545,1,MacroKing,2297,177,5,9,14,35.7%,42m
35545,1,[PSTRAT]GoldCaesar,2297,73,4,3,7,57.1%,42m
35545,1,TLtommu,2297,96,4,6,10,40.0%,19m
35545,3,PandaStorm,2297,125,4,8,12,33.3%,37m
35545,2,[3D]Dayton,2297,144,4,9,13,30.8%,1h
35545,1,Ruffeo,2297,0,2,3,5,40.0%,59m
35545,1,GTgaming,2297,0,1,0,1,100.0%,5m
35545,1,timto,2297,48,1,1,2,50.0%,3h
35545,1,Cannon,2297,46,1,1,2,50.0%,45m
35545,1,fortnice,2297,97,1,2,3,33.3%,3h
35545,2,Dysentery,2297,0,1,4,5,20.0%,3h
35545,3,soueuuai,2297,0,0,1,1,0.0%,26m
35545,3,Polver,2297,0,0,1,1,0.0%,3h
35545,1,Condorsureño,2297,0,0,2,2,0.0%,1h
35545,2,[BYU]Andystan,2297,0,0,3,3,0.0%,3h
35545,3,nicoelmico,2297,0,0,3,3,0.0%,30m
35575,3,bobgui,2296,1464,155,141,296,52.4%,27m
35575,1,GordoChapado,2296,1420,116,107,223,52.0%,8m
35575,2,[IiUiI]roger,2296,1541,101,111,212,47.6%,27m
35575,3,[SpcBar]Xari,2296,1053,98,100,198,49.5%,28m
35575,1,Bejlor,2296,1692,81,86,167,48.5%,36m
35575,1,RawItalian,2296,1742,76,78,154,49.4%,56m
35575,3,[Dipz]KAISER,2296,1407,73,83,156,46.8%,54m
35575,1,[4aRaza]Warryx,2296,977,38,34,72,52.8%,49m
35575,1,BrandonMusic,2296,1042,35,29,64,54.7%,33m
35575,1,ThanaThost,2296,1013,33,53,86,38.4%,2m
35575,1,Lawrence,2296,866,30,28,58,51.7%,45m
35575,1,killface,2296,633,23,19,42,54.8%,3h
35575,1,Arinya,2296,653,18,15,33,54.5%,3h
35575,3,Inactivepawn,2296,480,18,21,39,46.2%,1h
35575,3,Exadius,2296,418,16,20,36,44.4%,1h
35575,1,[COAI]cheatAI,2296,419,12,5,17,70.6%,47m
35575,1,Yasser,2296,391,11,6,17,64.7%,24m
35575,1,NicoPro,2296,404,11,8,19,57.9%,3h
35575,1,cacktissmire,2296,298,8,11,19,42.1%,5m
35575,1,Skwid,2296,168,6,7,13,46.2%,3h
35575,3,XIII,2296,242,6,11,17,35.3%,1h
35575,1,Wheelchamps,2296,122,5,5,10,50.0%,3h
35575,1,Bugha,2296,161,5,14,19,26.3%,50m
35575,1,ViolentFlame,2296,144,4,7,11,36.4%,1h
35575,1,Michael,2296,145,4,8,12,33.3%,1h
35575,2,ChefCharles,2296,135,4,9,13,30.8%,20m
35575,1,Miker,2296,74,3,6,9,33.3%,48m
35575,3,HotbreadPP,2296,36,3,8,11,27.3%,9m
35575,1,LTDAN,2296,0,1,2,3,33.3%,16m
35575,1,harryman,2296,44,1,3,4,25.0%,33m
35575,1,[WW2SA]ImTheLegend,2296,0,1,3,4,25.0%,30m
35575,2,dagio,2296,0,1,4,5,20.0%,1h
35575,3,SnickersII,2296,32,1,4,5,20.0%,9m
35575,3,GooseWillis,2296,96,1,7,8,12.5%,40m
35609,2,jon,2295,1354,58,64,122,47.5%,1h
35609,3,[sk3tch]Vawk,2295,1488,58,82,140,41.4%,26m
35609,1,aflyguy,2295,414,38,42,80,47.5%,3h
35609,1,Crow,2295,998,33,26,59,55.9%,49m
35609,2,PKsDC,2295,920,31,41,72,43.1%,3m
35609,1,xuniverseIVG,2295,793,29,25,54,53.7%,11m
35609,1,DANTESINFER,2295,742,23,18,41,56.1%,50m
35609,1,[AbcCo]JorgeGamer,2295,682,23,26,49,46.9%,22m
35609,1,Prygames,2295,365,11,13,24,45.8%,3h
35609,2,ICEMAN,2295,263,9,15,24,37.5%,3h
35609,1,[NPFR]Lickitac,2295,215,7,4,11,63.6%,1h
35609,1,Vinild,2295,186,5,5,10,50.0%,1h
35609,3,asdfsf,2295,106,5,11,16,31.2%,1h
35609,1,[Mexxco]Custo,2295,0,1,0,1,100.0%,41m
35609,1,disruptor,2295,0,1,0,1,100.0%,50m
35609,3,LiquidRock,2295,30,1,1,2,50.0%,26m
35609,2,Gatchaman,2295,0,1,1,2,50.0%,3h
35609,3,[VatiCL]DEY,2295,0,1,2,3,33.3%,1h
35609,1,[WxCR]killemall,2295,42,1,2,3,33.3%,3h
35609,3,[unliph]adrian,2295,97,1,6,7,14.3%,3h
35609,1,[ISNULL]MajorOwnage,2295,0,0,1,1,0.0%,1h
35609,1,DropdeadRain,2295,0,0,1,1,0.0%,3h
35609,1,HsS,2295,0,0,3,3,0.0%,3h
35632,1,[dengue]Jaum,2294,1438,68,53,121,56.2%,15m
35632,1,Bit,2294,776,65,59,124,52.4%,1h
35632,3,Madmartygan,2294,1520,64,66,130,49.2%,11m
35632,3,DREEP,2294,1023,58,54,112,51.8%,56m
35632,3,REBEC,2294,979,56,48,104,53.8%,1h
35632,1,mimo,2294,671,21,23,44,47.7%,22m
35632,3,EarlGrey,2294,554,21,28,49,42.9%,3h
35632,1,Bonst,2294,267,11,5,16,68.8%,1h
35632,2,JamesBreznev,2294,316,9,20,29,31.0%,3h
35632,1,cocokrench,2294,235,8,14,22,36.4%,4m
35632,1,[BNITOS]Goku,2294,132,4,4,8,50.0%,3h
35632,1,Pictus,2294,0,3,4,7,42.9%,58m
35632,2,ChuckChunder,2294,0,3,5,8,37.5%,1h
35632,1,STank,2294,100,3,5,8,37.5%,60m
35632,3,SirWeanorMan,2294,59,3,7,10,30.0%,10m
35632,2,showmax,2294,88,2,0,2,100.0%,12m
35632,1,Meowmii,2294,0,1,0,1,100.0%,1h
35632,2,DarkShroud,2294,0,1,0,1,100.0%,59m
35632,1,yehosua,2294,0,1,1,2,50.0%,3h
35632,1,[BS1]Gargolos,2294,0,1,4,5,20.0%,3h
35632,3,Reddlake,2294,97,1,4,5,20.0%,1h
35632,1,Change,2294,42,1,6,7,14.3%,22m
35632,1,LaVaca,2294,0,0,1,1,0.0%,3h
35632,1,[OkT3am]Holaquehace,2294,0,0,1,1,0.0%,1h
35632,1,pablinflow,2294,73,0,3,3,0.0%,3h
35657,2,RadioManTodd,2293,1468,114,120,234,48.7%,31m
35657,1,NightCrawler,2293,1768,96,92,188,51.1%,3h
35657,3,renegado,2293,1490,73,60,133,54.9%,14m
35657,1,[MaxraX]abunny,2293,1687,69,60,129,53.5%,5m
35657,1,[Pgna]ArtVandeley,2293,1559,69,71,140,49.3%,3h
35657,1,MaloaD,2293,1109,39,40,79,49.4%,11m
35657,1,THESALTLORD,2293,947,32,28,60,53.3%,36m
35657,2,Xerses,2293,159,30,34,64,46.9%,1h
35657,1,DimiGodd,2293,650,20,22,42,47.6%,36m
35657,1,[azer]azer,2293,328,14,16,30,46.7%,1h
35657,3,Alphabet,2293,394,14,18,32,43.8%,6m
35657,2,dROCJJ,2293,292,12,17,29,41.4%,55m
35657,3,runswithbear,2293,267,11,10,21,52.4%,21m
35657,1,Priest,2293,388,11,11,22,50.0%,24m
35657,1,[RCSM]Frankkexx,2293,226,4,3,7,57.1%,5m
35657,1,[GiLLs]Gilligan,2293,122,4,3,7,57.1%,3h
35657,3,[PHUB]DoNoHoes,2293,149,4,9,13,30.8%,1h
35657,3,Sirviolent,2293,153,4,9,13,30.8%,32m
35657,1,pwavvy,2293,80,3,1,4,75.0%,2m
35657,1,Atlas,2293,90,3,4,7,42.9%,39m
35657,1,Meedzee,2293,145,3,6,9,33.3%,1h
35657,1,[OKC]dArchon,2293,90,3,7,10,30.0%,34m
35657,1,DeviousDump,2293,136,3,10,13,23.1%,49m
35657,1,Lecram,2293,82,2,3,5,40.0%,3h
35657,2,AlphaBobcat,2293,0,2,3,5,40.0%,48m
35657,1,[Gideon]Smiteyou,2293,0,2,5,7,28.6%,30m
35657,1,Winslow,2293,0,1,1,2,50.0%,4m
35657,1,[Mekz]twomanytacos,2293,38,1,2,3,33.3%,37m
35657,3,alecel,2293,0,1,3,4,25.0%,1h
35657,1,BadLadurette,2293,0,1,4,5,20.0%,9m
35657,2,Shintaro,2293,0,1,4,5,20.0%,55m
35657,1,photer,2293,0,1,5,6,16.7%,4m
35657,1,YungRicey,2293,0,1,5,6,16.7%,1h
35657,1,VitoKoMiX,2293,0,1,6,7,14.3%,9m
35657,1,SkyLounge,2293,0,0,1,1,0.0%,3h
35657,1,GhostSnake,2293,0,0,1,1,0.0%,4m
35657,1,Martin,2293,0,0,1,1,0.0%,1h
35694,1,Huburt,2292,1545,88,74,162,54.3%,1h
35694,3,eliteleadrr,2292,927,61,67,128,47.7%,3h
35694,1,Rasimate,2292,1040,57,65,122,46.7%,19m
35694,3,Tapyu,2292,1269,48,51,99,48.5%,1h
35694,3,Aaron,2292,896,34,38,72,47.2%,3h
35694,1,Triven,2292,1009,32,26,58,55.2%,45m
35694,1,[MJ23]niickgeo,2292,410,14,15,29,48.3%,45m
35694,3,[GGMB]Fritigern,2292,391,14,16,30,46.7%,1h
35694,1,Gnumer,2292,290,12,15,27,44.4%,22m
35694,1,COALMAN,2292,309,11,6,17,64.7%,6m
35694,3,ELJ,2292,282,9,14,23,39.1%,1h
35694,3,Ripped,2292,198,8,7,15,53.3%,9m
35694,3,Lolis,2292,247,8,10,18,44.4%,1h
35694,1,Rioku,2292,276,7,3,10,70.0%,3h
35694,3,BigWolfe,2292,150,6,11,17,35.3%,21m
35694,3,Serum,2292,160,6,13,19,31.6%,1h
35694,1,Liber,2292,108,4,6,10,40.0%,14m
35694,1,GatJoseRizal,2292,193,4,8,12,33.3%,3h
35694,3,pedroraptor,2292,155,4,9,13,30.8%,1h
35694,3,Deadlyremi,2292,95,3,5,8,37.5%,47m
35694,3,Remdit,2292,120,3,6,9,33.3%,18m
35694,1,Dave,2292,88,3,7,10,30.0%,1h
35694,1,JupiterJazz,2292,44,2,5,7,28.6%,3h
35694,1,Edings,2292,42,2,5,7,28.6%,3h
35694,3,Deadly,2292,0,2,6,8,25.0%,3h
35694,1,[AbcCo]RatStyle,2292,0,1,0,1,100.0%,44m
35694,1,RGB,2292,61,0,5,5,0.0%,3h
35721,3,Julio,2291,1533,139,150,289,48.1%,1h
35721,1,wdboct,2291,1828,110,100,210,52.4%,3h
35721,3,viajerojack,2291,1550,108,115,223,48.4%,1h
35721,1,sammas,2291,1736,96,99,195,49.2%,3h
35721,3,ChalyMaster,2291,1300,93,94,187,49.7%,1h
35721,1,NoMirrorGame,2291,1119,69,59,128,53.9%,22m
35721,1,prad,2291,1502,53,49,102,52.0%,1h
35721,1,AwakenToGrey,2291,1472,49,48,97,50.5%,1h
35721,1,[C31081]ISRAELKHAN,2291,1305,45,46,91,49.5%,1h
35721,1,Arbiter,2291,419,28,35,63,44.4%,16m
35721,1,denilson,2291,835,26,22,48,54.2%,50m
35721,3,Rival,2291,682,24,26,50,48.0%,17m
35721,1,[SyLx]ccccc,2291,541,22,10,32,68.8%,3h
35721,3,[x0i]EditiongTe,2291,508,18,15,33,54.5%,56m
35721,1,Laggan,2291,644,18,21,39,46.2%,3h
35721,3,[NastyB]FuzzSlasher,2291,432,16,20,36,44.4%,1h
35721,1,cabo,2291,356,11,13,24,45.8%,39m
35721,1,Vano,2291,146,7,12,19,36.8%,3h
35721,3,MysterE,2291,262,7,13,20,35.0%,52m
35721,3,Che,2291,208,7,14,21,33.3%,52m
35721,1,Anniemouse,2291,220,6,9,15,40.0%,3h
35721,1,JoshRaynor,2291,94,4,4,8,50.0%,1h
35721,3,PlzDntHurtMe,2291,171,4,5,9,44.4%,3h
35721,1,babyboy,2291,132,3,5,8,37.5%,44m
35721,1,[MncsGG]Diego,2291,95,2,0,2,100.0%,11m
35721,1,gringocho,2291,111,2,1,3,66.7%,3h
35721,2,Chileno,2291,0,2,3,5,40.0%,3h
35721,1,Strive,2291,48,2,6,8,25.0%,1h
35721,2,[GTWITM]Ecneb,2291,91,1,2,3,33.3%,5m
35721,1,Boyue,2291,0,1,2,3,33.3%,3h
35721,1,NukeForce,2291,0,1,2,3,33.3%,1h
35721,1,iiiiii,2291,42,1,3,4,25.0%,30m
35721,2,jules,2291,0,1,4,5,20.0%,4m
35721,1,RockRocker,2291,0,1,5,6,16.7%,4m
35721,2,Hendo,2291,0,0,1,1,0.0%,1h
35721,2,Snake,2291,0,0,1,1,0.0%,1h
35721,1,Vanillag,2291,0,0,2,2,0.0%,22m
35721,1,[BraziI]walkers,2291,0,0,2,2,0.0%,37m
35721,2,Aurelicus,2291,0,0,5,5,0.0%,1h
35760,1,Twizzler,2290,1832,116,115,231,50.2%,1h
35760,3,Sunkist,2290,1162,44,41,85,51.8%,17m
35760,3,[zeez]Carnivorous,2290,981,36,44,80,45.0%,40m
35760,1,YBae,2290,770,33,20,53,62.3%,7m
35760,1,Áine,2290,1020,33,29,62,53.2%,13m
35760,1,DrSegway,2290,615,27,14,41,65.9%,22m
35760,1,OldSchool,2290,572,23,22,45,51.1%,6m
35760,1,InvoquerM,2290,586,21,12,33,63.6%,42m
35760,3,Ammo,2290,550,18,19,37,48.6%,3h
35760,1,[nieBla]SOLDADOP,2290,452,12,11,23,52.2%,1h
35760,3,DeLaRiva,2290,284,9,12,21,42.9%,6m
35760,1,eldesk,2290,190,6,6,12,50.0%,56m
35760,1,PeterPan,2290,224,6,7,13,46.2%,13m
35760,1,Kiko,2290,130,5,7,12,41.7%,1h
35760,3,Sikansi,2290,204,5,13,18,27.8%,34m
35760,1,kanuk,2290,168,4,5,9,44.4%,1h
35760,1,GrimmTalez,2290,32,4,10,14,28.6%,26m
35760,1,ssss,2290,90,3,4,7,42.9%,3h
35760,3,[iEats]KiX,2290,157,3,6,9,33.3%,3h
35760,3,paul,2290,123,2,3,5,40.0%,3h
35760,1,RICK,2290,0,2,6,8,25.0%,1h
35760,1,tripleTP,2290,60,2,20,22,9.1%,3h
35760,1,GBL,2290,0,1,0,1,100.0%,9m
35760,1,Eldrazi,2290,0,1,0,1,100.0%,26m
35760,1,DariusTelman,2290,42,1,2,3,33.3%,39m
35760,3,[TXV]razerpin,2290,88,1,3,4,25.0%,1h
35760,1,Datralo,2290,0,1,5,6,16.7%,3h
35760,1,[HmlsMx]Markku,2290,0,0,1,1,0.0%,16m
35760,1,CAMPBELL,2290,0,0,1,1,0.0%,3h
35760,1,AggroBearHug,2290,0,0,1,1,0.0%,1h
35760,1,[SHOPPE]Andy,2290,0,0,1,1,0.0%,4m
35760,1,Titans,2290,0,0,1,1,0.0%,5m
35792,2,MATO,2289,1509,138,135,273,50.5%,1h
35792,3,JackDLakes,2289,1091,117,118,235,49.8%,57m
35792,3,Roasted,2289,819,61,65,126,48.4%,10m
35792,1,Devastador,2289,660,30,12,42,71.4%,26m
35792,1,StarSamurai,2289,948,28,30,58,48.3%,49m
35792,2,remedy,2289,634,24,27,51,47.1%,3h
35792,1,Pazuzu,2289,636,19,17,36,52.8%,3h
35792,2,Cobra,2289,326,13,16,29,44.8%,3h
35792,1,[st0bs]dumplingman,2289,313,12,17,29,41.4%,3h
35792,1,Carma,2289,292,11,12,23,47.8%,39m
35792,1,[NSushi]nighthawk,2289,257,6,2,8,75.0%,3h
35792,1,McCloud,2289,204,6,9,15,40.0%,50m
35792,2,[FyHr]CeroCatorce,2289,177,5,10,15,33.3%,1h
35792,3,SUPETEN,2289,145,3,5,8,37.5%,33m
35792,2,MrNoOB,2289,148,3,5,8,37.5%,35m
35792,1,bugatti,2289,92,2,1,3,66.7%,3h
35792,1,CamoKat,2289,46,2,2,4,50.0%,47m
35792,1,Sopro,2289,86,2,6,8,25.0%,3h
35792,1,RenatinhoBR,2289,46,2,6,8,25.0%,43m
35792,1,Kamino,2289,0,1,0,1,100.0%,40m
35792,3,XBlackDracoX,2289,0,1,0,1,100.0%,1h
35792,2,[Luntik]GRUMPYKITTEN,2289,0,1,0,1,100.0%,23m
35792,1,sharknuts,2289,0,1,1,2,50.0%,4m
35792,1,ElyTEe,2289,48,1,2,3,33.3%,1h
35792,1,RepoMan,2289,0,1,2,3,33.3%,1h
35792,1,devilstriker,2289,73,1,3,4,25.0%,45m
35792,1,Error,2289,0,1,4,5,20.0%,1h
35792,1,Thanh,2289,0,1,5,6,16.7%,3h
35792,1,MorbiLudio,2289,0,0,1,1,0.0%,8m
35792,1,Kalon,2289,0,0,3,3,0.0%,3h
35822,3,whak,2288,1501,299,313,612,48.9%,55m
35822,1,Monkey,2288,1828,210,225,435,48.3%,1h
35822,1,[FTLTX]rushell,2288,856,26,24,50,52.0%,1h
35822,1,[DhZAc1]Sadhak,2288,726,23,29,52,44.2%,3h
35822,3,[Alzh]dcokuyama,2288,444,21,21,42,50.0%,1h
35822,3,mrjamesnice,2288,548,19,19,38,50.0%,1h
35822,1,ELPAPAS,2288,396,10,9,19,52.6%,34m
35822,3,Eversmen,2288,240,10,10,20,50.0%,1h
35822,1,[fatego]artoria,2288,163,6,7,13,46.2%,1h
35822,1,JUAN,2288,140,6,11,17,35.3%,3h
35822,3,[PobSC]Elesho,2288,195,5,6,11,45.5%,48m
35822,1,Rainbringer,2288,154,5,10,15,33.3%,48m
35822,3,Shagon,2288,150,5,13,18,27.8%,55m
35822,1,[1PA]BeNgay,2288,154,4,3,7,57.1%,1h
35822,1,[LESSP]Shado,2288,128,4,4,8,50.0%,30m
35822,3,Pepridge,2288,60,4,9,13,30.8%,50m
35822,1,Eddybhum,2288,86,3,1,4,75.0%,43m
35822,1,ArT,2288,86,3,2,5,60.0%,1h
35822,1,Calico,2288,30,2,0,2,100.0%,56m
35822,1,BreathOfLife,2288,48,1,2,3,33.3%,8m
35822,1,ColdCrescent,2288,44,1,4,5,20.0%,3h
35822,1,GneralisimuS,2288,97,1,5,6,16.7%,3h
35822,1,balam,2288,0,1,5,6,16.7%,5m
35822,1,Reddaddy,2288,0,0,1,1,0.0%,56m
35822,1,KgZNachos,2288,0,0,1,1,0.0%,1h
35822,1,MadWolf,2288,0,0,2,2,0.0%,25m
35848,1,mikepgx,2287,1634,213,207,420,50.7%,4m
35848,3,PPE,2287,1579,74,77,151,49.0%,1h
35848,3,mermer,2287,1315,65,62,127,51.2%,1h
35848,2,Zannis,2287,702,51,64,115,44.3%,9m
35848,1,DarkMatter,2287,1292,50,52,102,49.0%,14m
35848,1,Steven,2287,815,32,31,63,50.8%,3h
35848,2,tolss,2287,547,23,24,47,48.9%,1h
35848,3,Huey,2287,554,21,24,45,46.7%,1h
35848,1,bthugger,2287,676,19,20,39,48.7%,3h
35848,1,[ValidG]GoodTrip,2287,564,16,16,32,50.0%,1h
35848,1,Diaz,2287,234,14,10,24,58.3%,60m
35848,3,Arothin,2287,364,13,15,28,46.4%,3h
35848,1,[SACLyf]Cameinsecond,2287,542,13,17,30,43.3%,12m
35848,1,Cashman,2287,482,13,17,30,43.3%,1h
35848,1,[QBALL]QRAZR,2287,386,10,10,20,50.0%,22m
35848,1,MaticusPrime,2287,305,8,14,22,36.4%,6m
35848,3,fuze,2287,223,7,10,17,41.2%,1h
35848,3,[Mataco]Yorick,2287,178,7,13,20,35.0%,1h
35848,1,wat,2287,161,5,0,5,100.0%,33m
35848,1,Mandalorian,2287,86,3,1,4,75.0%,3h
35848,2,Awakened,2287,0,2,3,5,40.0%,23m
35848,1,BionicBimbo,2287,48,2,5,7,28.6%,3h
35848,1,Temperz,2287,44,2,6,8,25.0%,46m
35848,3,DasWish,2287,109,2,6,8,25.0%,3h
35848,1,MaiLyf,2287,91,1,5,6,16.7%,3h
35848,1,Mosnar,2287,0,0,1,1,0.0%,1h
35848,2,SaulHudson,2287,0,0,14,14,0.0%,1h
35875,3,[3jk2j3]BadGuts,2286,862,50,34,84,59.5%,1h
35875,1,[SWOU]AlexBrain,2286,832,26,25,51,51.0%,1h
35875,3,[pobhla]Ironkong,2286,597,24,21,45,53.3%,3h
35875,1,[GTO4]AkhunDelar,2286,443,12,6,18,66.7%,1h
35875,1,Stuart,2286,377,11,13,24,45.8%,3h
35875,2,[7EK]Shishkabob,2286,287,11,25,36,30.6%,1h
35875,1,Rampage,2286,381,10,15,25,40.0%,1h
35875,2,Dud,2286,269,6,14,20,30.0%,3h
35875,1,Neoxter,2286,166,5,5,10,50.0%,4m
35875,1,Jarclock,2286,102,4,2,6,66.7%,3h
35875,3,Pocoyo,2286,30,4,6,10,40.0%,1h
35875,3,[theBKS]HDStarbursts,2286,145,4,8,12,33.3%,55m
35875,3,Noalapiedad,2286,144,4,8,12,33.3%,1h
35875,1,[FlynHI]BIGbudz,2286,120,3,4,7,42.9%,5m
35875,1,Durex,2286,145,3,5,8,37.5%,3h
35875,3,[4Taric]Dreadnafious,2286,133,3,8,11,27.3%,3h
35875,2,RichardButte,2286,103,2,1,3,66.7%,3h
35875,2,[TWI]Nietsnie,2286,0,2,6,8,25.0%,8m
35875,1,Nerup,2286,0,1,0,1,100.0%,50m
35875,1,Shivana,2286,0,1,0,1,100.0%,6m
35875,1,ChubbyPanda,2286,0,1,0,1,100.0%,3h
35875,1,MarinKinPrim,2286,40,1,3,4,25.0%,2m
35875,1,DeezNoodlezz,2286,0,1,4,5,20.0%,16m
35875,1,Baru,2286,0,1,4,5,20.0%,3h
35875,1,Stencovich,2286,0,1,5,6,16.7%,50m
35875,3,protoman,2286,0,1,5,6,16.7%,3h
35875,3,TopWop,2286,0,1,6,7,14.3%,31m
35875,1,Beebz,2286,0,0,2,2,0.0%,52m
35875,1,[13]PainsEmbrace,2286,0,0,4,4,0.0%,1h
35904,3,davidg,2285,1504,201,191,392,51.3%,11m
35904,1,[MBurns]killazerg,2285,1446,178,193,371,48.0%,57m
35904,1,NaClGlaive,2285,1460,72,68,140,51.4%,46m
35904,2,[maSC]Rdlc,2285,623,65,71,136,47.8%,26m
35904,1,[ValpoK]Kako,2285,1409,62,63,125,49.6%,3h
35904,1,Alexsomer,2285,1648,55,55,110,50.0%,41m
35904,1,alexx,2285,850,30,28,58,51.7%,1h
35904,3,LaRonJeremy,2285,398,22,21,43,51.2%,30m
35904,1,MissMicro,2285,722,22,21,43,51.2%,1h
35904,3,Arrietowski,2285,296,10,17,27,37.0%,40m
35904,1,sward,2285,250,10,18,28,35.7%,3h
35904,1,Innate,2285,325,9,12,21,42.9%,1h
35904,3,machobear,2285,236,7,10,17,41.2%,1h
35904,1,Gyro,2285,193,6,6,12,50.0%,3h
35904,1,Zeppu,2285,174,5,5,10,50.0%,3h
35904,3,TJCarnage,2285,30,4,10,14,28.6%,29m
35904,3,Gyoza,2285,123,3,7,10,30.0%,29m
35904,3,madumlao,2285,92,3,9,12,25.0%,3m
35904,1,BOB,2285,0,1,0,1,100.0%,9m
35904,1,[Rag1n]BonerGawd,2285,48,1,2,3,33.3%,3h
35904,1,[BFCURT]Munner,2285,40,1,3,4,25.0%,1h
35904,2,TNT,2285,0,1,3,4,25.0%,1h
35904,1,shandsgator,2285,0,0,1,1,0.0%,14m
35904,1,Ricardo,2285,0,0,1,1,0.0%,1h
35904,1,angelo,2285,0,0,2,2,0.0%,1h
35929,1,alvatron,2284,1773,87,74,161,54.0%,59m
35929,1,Follamadres,2284,1450,87,95,182,47.8%,7m
35929,1,Tactician,2284,837,33,16,49,67.3%,59m
35929,1,JabRoney,2284,444,25,27,52,48.1%,14m
35929,3,AcarajeX,2284,384,16,24,40,40.0%,21m
35929,3,PARTYGO,2284,388,13,17,30,43.3%,3h
35929,1,Forgotten,2284,277,9,6,15,60.0%,3h
35929,1,koCo,2284,352,9,12,21,42.9%,1h
35929,1,Sophistar,2284,263,7,5,12,58.3%,22m
35929,1,MachineIV,2284,189,5,1,6,83.3%,47m
35929,1,[BUKÉ]Zepol,2284,182,4,7,11,36.4%,39m
35929,1,[HardCo]Wompas,2284,108,4,8,12,33.3%,39m
35929,3,Dromic,2284,74,4,9,13,30.8%,35m
35929,1,Rives,2284,78,3,2,5,60.0%,1h
35929,1,Souvent,2284,44,3,5,8,37.5%,3h
35929,1,GalfordxXD,2284,112,2,5,7,28.6%,48m
35929,1,Xivi,2284,0,1,1,2,50.0%,18m
35929,2,[nieBla]Supre,2284,0,1,4,5,20.0%,23m
35929,2,[blmp]gitgudkid,2284,0,0,1,1,0.0%,3h
35929,1,Venom,2284,0,0,1,1,0.0%,3h
35929,1,HuatArr,2284,0,0,1,1,0.0%,3h
35929,1,LGOELZER,2284,0,0,2,2,0.0%,3h
35929,1,kburns,2284,0,0,3,3,0.0%,57m
35929,3,Bentley,2284,0,0,4,4,0.0%,33m
35953,1,SirCraft,2283,1752,150,136,286,52.4%,3h
35953,3,garrett,2283,610,38,51,89,42.7%,1h
35953,1,[WCSOil]OctopusMan,2283,602,22,24,46,47.8%,3h
35953,3,chickeneater,2283,648,21,30,51,41.2%,15m
35953,1,Keltar,2283,600,16,19,35,45.7%,5m
35953,1,Samman,2283,490,14,11,25,56.0%,3h
35953,3,ChuckChunder,2283,304,12,12,24,50.0%,1h
35953,1,Paranoid,2283,264,7,6,13,53.8%,3h
35953,3,reconone,2283,58,6,8,14,42.9%,38m
35953,1,[2ES]JayD,2283,207,5,12,17,29.4%,3h
35953,1,traceless,2283,156,4,4,8,50.0%,37m
35953,1,jazzyjeff,2283,148,4,7,11,36.4%,3h
35953,1,[CLogic]Projectshady,2283,102,4,16,20,20.0%,8m
35953,1,PuncherKJKB,2283,124,3,3,6,50.0%,48m
35953,3,PiGCommander,2283,90,3,10,13,23.1%,41m
35953,1,randompoop,2283,44,2,0,2,100.0%,26m
35953,1,mbehlok,2283,97,2,5,7,28.6%,1h
35953,3,yeyo,2283,30,2,7,9,22.2%,1h
35953,3,MINMIR,2283,30,2,7,9,22.2%,55m
35953,1,DaggerRPM,2283,0,1,0,1,100.0%,7m
35953,1,Kyanide,2283,0,1,0,1,100.0%,1h
35953,1,[GDKND]DeathLotus,2283,0,1,5,6,16.7%,5m
35953,3,Wolfenfluffy,2283,0,1,6,7,14.3%,6m
35953,1,iTzfer,2283,0,0,1,1,0.0%,3h
35953,3,Ryan,2283,0,0,1,1,0.0%,1h
35953,1,[VMW3]Octans,2283,0,0,1,1,0.0%,1h
35953,1,Papi,2283,0,0,2,2,0.0%,3h
35980,3,AMAZING,2282,1560,163,172,335,48.7%,40m
35980,3,TUNGY,2282,1567,124,112,236,52.5%,3h
35980,1,[DRKESP]AntonioVT,2282,1833,117,120,237,49.4%,57m
35980,3,ADGN,2282,1366,114,116,230,49.6%,35m
35980,3,chapaco,2282,1591,114,121,235,48.5%,10m
35980,3,Crassy,2282,544,112,110,222,50.5%,3h
35980,1,matrix,2282,1760,101,94,195,51.8%,3h
35980,1,extrapills,2282,1664,92,76,168,54.8%,39m
35980,3,irishDev,2282,1583,89,90,179,49.7%,23m
35980,1,JSAA,2282,1763,82,78,160,51.2%,12m
35980,1,IIIIIIIIIIII,2282,1192,41,41,82,50.0%,41m
35980,3,Gibbons,2282,728,40,46,86,46.5%,55m
35980,3,summer,2282,740,30,30,60,50.0%,1h
35980,3,Loki,2282,687,25,38,63,39.7%,31m
35980,3,Alex,2282,708,24,33,57,42.1%,3h
35980,3,Bohdan,2282,686,23,27,50,46.0%,3h
35980,1,KronkKing,2282,359,15,11,26,57.7%,50m
35980,1,tmania,2282,520,13,19,32,40.6%,3h
35980,2,Eric,2282,281,12,9,21,57.1%,3h
35980,1,Darmel,2282,426,12,12,24,50.0%,33m
35980,3,Haneikut,2282,265,8,10,18,44.4%,1h
35980,2,Jet,2282,174,7,7,14,50.0%,37m
35980,1,fernandio,2282,124,4,2,6,66.7%,22m
35980,3,joao,2282,163,4,5,9,44.4%,13m
35980,1,[CR1]Tomahawkcr,2282,84,3,4,7,42.9%,57m
35980,1,[ImbTos]DontRushMe,2282,84,3,4,7,42.9%,38m
35980,3,Shadowswarm,2282,116,3,7,10,30.0%,1h
35980,3,[OBMACR]Balamaninov,2282,145,3,8,11,27.3%,11m
35980,1,Usernemo,2282,90,3,8,11,27.3%,26m
35980,3,lee,2282,62,3,9,12,25.0%,7m
35980,1,[MA21]kennyhong,2282,46,2,1,3,66.7%,3h
35980,3,[GgTEAM]Saclepto,2282,30,2,7,9,22.2%,1h
35980,1,[PADA]Phantom,2282,0,1,0,1,100.0%,1h
35980,1,therxy,2282,0,1,1,2,50.0%,44m
35980,1,[PUSA]tegan,2282,0,1,1,2,50.0%,52m
35980,1,Phenomenon,2282,42,1,1,2,50.0%,45m
35980,1,ASHISHxFTW,2282,0,1,5,6,16.7%,1h
35980,1,Arem,2282,0,1,5,6,16.7%,15m
35980,1,Schway,2282,0,0,1,1,0.0%,3h
35980,1,Bigsvenyo,2282,0,0,2,2,0.0%,1h
35980,2,BDeezy,2282,0,0,3,3,0.0%,28m
35980,1,[w0rm]Freelo,2282,0,0,5,5,0.0%,13m
36022,3,AlfredPollo,2281,1520,135,135,270,50.0%,1h
36022,1,[DNO13]Covfefe,2281,1519,79,63,142,55.6%,3h
36022,1,neeKXeee,2281,1520,70,58,128,54.7%,3h
36022,3,bleak,2281,904,46,55,101,45.5%,10m
36022,1,Pablo,2281,1143,41,30,71,57.7%,1h
36022,2,[SKSR]zephyr,2281,593,36,49,85,42.4%,1h
36022,3,ColeBurns,2281,646,24,31,55,43.6%,1h
36022,1,Dynamo,2281,382,20,1,21,95.2%,3h
36022,1,[RwtM]Blaze,2281,590,19,10,29,65.5%,1h
36022,1,ApmTen,2281,352,12,8,20,60.0%,36m
36022,2,BiZZBuZZ,2281,287,9,15,24,37.5%,54m
36022,3,gotenks,2281,252,8,13,21,38.1%,1h
36022,1,Edimaker,2281,274,7,7,14,50.0%,3h
36022,1,grecoman,2281,122,7,13,20,35.0%,36m
36022,2,Kaizen,2281,157,5,2,7,71.4%,19m
36022,2,Blom,2281,182,5,7,12,41.7%,1h
36022,1,SteamRoller,2281,168,4,0,4,100.0%,12m
36022,1,gnolen,2281,170,4,7,11,36.4%,50m
36022,1,Royaltomato,2281,0,2,2,4,50.0%,50m
36022,1,FunkyMonk,2281,0,1,2,3,33.3%,3h
36022,2,[MaxWin]Mazz,2281,0,1,3,4,25.0%,59m
36022,1,TeamChatan,2281,0,1,5,6,16.7%,40m
36022,1,Azura,2281,0,0,1,1,0.0%,3h
36022,1,ToXic,2281,0,0,1,1,0.0%,26m
36022,1,Ptizizi,2281,0,0,3,3,0.0%,58m
36022,2,irishkid,2281,0,0,5,5,0.0%,38m
36048,1,ElTata,2280,1692,61,65,126,48.4%,15m
36048,1,Brandon,2280,1370,55,41,96,57.3%,3h
36048,3,[ZTempz]NOOBSTAH,2280,476,55,56,111,49.5%,3h
36048,3,isellpiff,2280,957,50,47,97,51.5%,1h
36048,3,[ZTemp]Wolv,2280,428,20,26,46,43.5%,10m
36048,1,XIAOHU,2280,528,15,15,30,50.0%,1h
36048,1,[LOSPLR]gerard,2280,459,13,8,21,61.9%,6m
36048,1,PauloXD,2280,407,12,9,21,57.1%,34m
36048,1,Iggy,2280,353,12,19,31,38.7%,23m
36048,2,goliathekens,2280,287,11,11,22,50.0%,3h
36048,1,hola,2280,284,8,8,16,50.0%,3h
36048,1,Knightrain,2280,279,7,3,10,70.0%,3h
36048,1,KingXvPvX,2280,262,7,9,16,43.8%,1h
36048,1,[Jimson]Thehightimes,2280,136,4,7,11,36.4%,3h
36048,1,LaMomiAggpe,2280,62,3,2,5,60.0%,56m
36048,1,[BalLzz]Porkins,2280,106,2,2,4,50.0%,3h
36048,1,Ballenita,2280,44,1,3,4,25.0%,3h
36048,2,[OD2019]TypeReaL,2280,0,0,1,1,0.0%,55m
36048,1,TEHb,2280,0,0,1,1,0.0%,59m
36048,1,Michael,2280,0,0,1,1,0.0%,1h
36048,1,IIIIIIIIIIII,2280,0,0,1,1,0.0%,30m
36069,3,legionkiller,2279,1347,238,239,477,49.9%,48m
36069,2,pinoygator,2279,1166,134,153,287,46.7%,1h
36069,2,BurnLoveSlay,2279,1388,131,121,252,52.0%,3h
36069,3,MarlonBrando,2279,845,82,86,168,48.8%,1h
36069,1,RoastSalmon,2279,1300,69,55,124,55.6%,3h
36069,2,Daddio,2279,354,48,57,105,45.7%,3h
36069,1,Nope,2279,382,12,8,20,60.0%,3h
36069,2,Lan,2279,150,6,19,25,24.0%,41m
36069,1,SavageOpress,2279,158,4,6,10,40.0%,57m
36069,1,mobzilla,2279,134,4,6,10,40.0%,1h
36069,1,CMonika,2279,122,3,6,9,33.3%,3h
36069,2,Pyro,2279,0,1,4,5,20.0%,3h
36069,1,assasinpanda,2279,0,0,1,1,0.0%,29m
36082,1,Tait,2278,1124,104,98,202,51.5%,41m
36082,1,RynoRyne,2278,1377,98,106,204,48.0%,3h
36082,1,ElGordoT,2278,1374,86,76,162,53.1%,1h
36082,3,[KGH6]Fenix,2278,715,76,79,155,49.0%,1h
36082,2,[MNAM]Wil,2278,1488,63,68,131,48.1%,1h
36082,1,Constantine,2278,1214,61,58,119,51.3%,3h
36082,3,[ZTemp]Thunder,2278,629,37,41,78,47.4%,7m
36082,1,KJStarKiller,2278,896,34,27,61,55.7%,2m
36082,3,[xTMCx]TheFireman,2278,441,23,34,57,40.4%,52m
36082,1,orangachang,2278,514,19,15,34,55.9%,50m
36082,1,Chaca,2278,630,18,17,35,51.4%,23m
36082,3,GuideBot,2278,483,17,18,35,48.6%,1h
36082,1,congb,2278,552,16,16,32,50.0%,1h
36082,1,Balian,2278,342,12,15,27,44.4%,34m
36082,1,PureJank,2278,384,10,8,18,55.6%,6m
36082,1,Evilblade,2278,301,9,7,16,56.2%,3h
36082,3,Demose,2278,148,9,15,24,37.5%,31m
36082,3,LUKAS,2278,165,5,10,15,33.3%,1h
36082,1,[GOTSl]Clifford,2278,210,5,12,17,29.4%,14m
36082,2,ieatsmalldog,2278,0,3,2,5,60.0%,9m
36082,3,[Flam3s]Salt,2278,147,3,5,8,37.5%,11m
36082,1,[BlTEL]Warpath,2278,34,2,0,2,100.0%,1h
36082,1,yoked,2278,0,2,3,5,40.0%,3h
36082,1,Konann,2278,76,2,3,5,40.0%,3h
36082,1,DeadlyMouse,2278,78,2,4,6,33.3%,3h
36082,1,Lirk,2278,0,1,0,1,100.0%,1h
36082,3,Arcangel,2278,0,1,0,1,100.0%,3h
36082,1,raimundog,2278,42,1,3,4,25.0%,37m
36082,1,Opponent,2278,44,1,3,4,25.0%,3h
36082,2,BlackHK,2278,0,1,4,5,20.0%,1h
36082,1,FiQ,2278,0,0,1,1,0.0%,3h
36082,1,zacheeus,2278,0,0,2,2,0.0%,14m
36114,3,Mohamed,2277,1010,124,132,256,48.4%,1h
36114,1,santiii,2277,1817,101,88,189,53.4%,3h
36114,1,TheSnake,2277,1189,99,95,194,51.0%,3h
36114,2,[llLife]wtwb,2277,1542,85,102,187,45.5%,41m
36114,1,GnarFury,2277,1606,61,59,120,50.8%,3h
36114,1,Morcilla,2277,1191,42,38,80,52.5%,40m
36114,1,[QTclub]SrLobo,2277,584,17,17,34,50.0%,33m
36114,1,[j4zz]Dated,2277,432,12,11,23,52.2%,30m
36114,1,VoidCugar,2277,490,12,18,30,40.0%,3h
36114,1,Caterpie,2277,315,10,4,14,71.4%,1h
36114,1,ARES,2277,166,8,12,20,40.0%,26m
36114,3,aletzzz,2277,279,8,13,21,38.1%,19m
36114,1,Mauricio,2277,201,7,4,11,63.6%,1h
36114,1,Snow,2277,244,7,8,15,46.7%,3h
36114,2,[LY0]inteldarvid,2277,206,7,22,29,24.1%,1h
36114,1,Discretizer,2277,248,6,8,14,42.9%,3h
36114,3,[PbFtCb]Kertic,2277,171,5,4,9,55.6%,1h
36114,1,Artemis,2277,144,5,9,14,35.7%,39m
36114,1,kevincash,2277,192,4,5,9,44.4%,1h
36114,1,HungrBatl,2277,129,3,0,3,100.0%,43m
36114,3,[Ventr2]Suagalishes,2277,119,3,6,9,33.3%,3h
36114,1,Kuno,2277,84,2,3,5,40.0%,1h
36114,1,TERRAFORMER,2277,40,2,6,8,25.0%,3h
36114,1,Jonstons,2277,0,2,6,8,25.0%,3h
36114,2,PerroFaldero,2277,88,2,6,8,25.0%,1h
36114,1,Nagami,2277,0,1,2,3,33.3%,1h
36114,1,Xavier,2277,0,1,2,3,33.3%,59m
36114,1,dmzou,2277,38,1,3,4,25.0%,55m
36114,1,[Hayze]Lachina,2277,0,1,5,6,16.7%,3h
36114,3,PAT,2277,0,1,6,7,14.3%,47m
36114,1,Fransua,2277,0,0,5,5,0.0%,47m
36145,1,[cluez]kramos,2276,1843,119,117,236,50.4%,20m
36145,1,liluzihurt,2276,1763,86,85,171,50.3%,1h
36145,3,[SivD]Hellscythe,2276,819,36,38,74,48.6%,17m
36145,1,Limberger,2276,756,33,45,78,42.3%,3h
36145,3,Crasus,2276,849,31,32,63,49.2%,19m
36145,3,Krlam,2276,560,26,29,55,47.3%,1h
36145,1,MINIWING,2276,748,22,20,42,52.4%,1h
36145,2,Matt,2276,438,17,21,38,44.7%,1h
36145,1,HEXLET,2276,532,14,17,31,45.2%,3h
36145,1,[nieBla]STARSET,2276,352,13,8,21,61.9%,41m
36145,3,Kamba,2276,198,8,14,22,36.4%,28m
36145,1,[PTHero]oSeabass,2276,141,5,3,8,62.5%,44m
36145,1,[ExcIgN]Grondow,2276,147,4,7,11,36.4%,14m
36145,2,lIIIllllllll,2276,98,4,17,21,19.0%,47m
36145,1,dusk,2276,84,3,2,5,60.0%,1h
36145,3,[Lgi2]korinho,2276,0,2,7,9,22.2%,1h
36145,1,Wilber,2276,42,1,2,3,33.3%,4m
36145,1,KingDaso,2276,44,1,3,4,25.0%,7m
36145,2,Vizzik,2276,0,1,4,5,20.0%,3h
36145,1,Shawn,2276,0,1,4,5,20.0%,45m
36145,1,Mannatee,2276,0,1,5,6,16.7%,5m
36145,1,Ailluach,2276,0,0,1,1,0.0%,22m
36145,1,AmErickano,2276,0,0,1,1,0.0%,4m
36145,1,zapdog,2276,0,0,1,1,0.0%,4m
36145,1,Shadow,2276,0,0,2,2,0.0%,3m
36170,1,Kahn,2275,1831,185,175,360,51.4%,1h
36170,3,Evan,2275,980,96,84,180,53.3%,1h
36170,3,[f10]DronesToMen,2275,1000,74,69,143,51.7%,35m
36170,1,Karma,2275,903,28,30,58,48.3%,50m
36170,3,MikeOxBig,2275,792,28,36,64,43.8%,1h
36170,2,azZurri,2275,664,25,33,58,43.1%,22m
36170,1,Freday,2275,767,24,20,44,54.5%,41m
36170,3,jennie,2275,614,21,33,54,38.9%,1h
36170,3,OUOU,2275,591,21,33,54,38.9%,6m
36170,1,DraCko,2275,628,20,21,41,48.8%,1h
36170,1,Lissander,2275,330,9,11,20,45.0%,1h
36170,1,NoFeedPLZ,2275,217,7,0,7,100.0%,1h
36170,1,AshyLarry,2275,187,6,6,12,50.0%,50m
36170,1,mms,2275,215,4,3,7,57.1%,3h
36170,3,[PRSM]Kael,2275,72,4,10,14,28.6%,3h
36170,3,Shanly,2275,0,3,6,9,33.3%,29m
36170,2,[HBDO]DELIVEROO,2275,62,3,11,14,21.4%,3h
36170,3,IzzyGoo,2275,97,2,7,9,22.2%,3h
36170,3,sbs,2275,0,2,7,9,22.2%,5m
36170,1,rookshanks,2275,0,1,0,1,100.0%,3h
36170,3,[TeamUR]DrEuclidean,2275,0,0,1,1,0.0%,1h
36170,1,RoyaltyCeo,2275,0,0,4,4,0.0%,3h
36192,3,HarvNation,2274,1527,272,267,539,50.5%,48m
36192,3,[Rataz]Gwyon,2274,1562,140,134,274,51.1%,1h
36192,1,Alitogdl,2274,1718,88,86,174,50.6%,1h
36192,3,TheElder,2274,1243,59,64,123,48.0%,44m
36192,1,Matt,2274,1394,45,43,88,51.1%,50m
36192,3,Rodrikenobi,2274,880,30,40,70,42.9%,34m
36192,1,Snake,2274,754,26,19,45,57.8%,1h
36192,3,[PSYON]Royce,2274,339,25,26,51,49.0%,22m
36192,1,ZapBrannigan,2274,796,22,23,45,48.9%,1h
36192,2,athmsvt,2274,497,19,23,42,45.2%,22m
36192,1,discotheque,2274,638,18,18,36,50.0%,47m
36192,3,illinem,2274,516,18,23,41,43.9%,3h
36192,1,flibber,2274,520,17,15,32,53.1%,30m
36192,1,Andrew,2274,358,12,16,28,42.9%,3h
36192,1,DAve,2274,308,9,7,16,56.2%,1h
36192,1,Ilusion,2274,322,9,7,16,56.2%,3h
36192,1,RYSE,2274,250,7,10,17,41.2%,3h
36192,1,[BATMF]Tapion,2274,184,6,6,12,50.0%,3h
36192,3,white,2274,94,4,6,10,40.0%,3h
36192,1,Odiseo,2274,164,4,9,13,30.8%,57m
36192,1,[TipHat]Mnun,2274,0,1,1,2,50.0%,1h
36192,1,[MINGEL]ttom,2274,0,1,1,2,50.0%,1h
36192,1,EbonyShade,2274,34,1,2,3,33.3%,38m
36192,1,[XpKAc]Koin,2274,36,1,2,3,33.3%,1h
36192,1,[FUSlON]Friedtoast,2274,32,1,2,3,33.3%,1h
36192,1,Guez,2274,42,1,4,5,20.0%,50m
36192,1,Clutch,2274,0,1,5,6,16.7%,3h
36192,1,MLegs,2274,0,1,6,7,14.3%,15m
36192,1,[nochee]Wolfe,2274,0,0,1,1,0.0%,11m
36192,1,ChrisAngelo,2274,0,0,1,1,0.0%,3h
36222,3,MAJCHRISTIAN,2273,1499,230,235,465,49.5%,3h
36222,2,mark,2273,1470,141,141,282,50.0%,59m
36222,3,Bendito,2273,1504,70,75,145,48.3%,55m
36222,3,Nulled,2273,1300,65,61,126,51.6%,1h
36222,2,jessto,2273,379,63,65,128,49.2%,13m
36222,1,HotKhocket,2273,1058,40,32,72,55.6%,3h
36222,1,darkpiwii,2273,674,21,17,38,55.3%,22m
36222,2,warhead,2273,386,16,20,36,44.4%,3h
36222,1,Wampbit,2273,510,15,16,31,48.4%,3h
36222,1,SOMETHING,2273,526,15,18,33,45.5%,3h
36222,2,Bowjob,2273,312,11,11,22,50.0%,54m
36222,2,scarab,2273,216,8,14,22,36.4%,3h
36222,1,bloodmarine,2273,217,7,11,18,38.9%,1h
36222,1,Somasae,2273,64,5,19,24,20.8%,48m
36222,1,ICEBREAKER,2273,111,3,5,8,37.5%,38m
36222,2,Potato,2273,0,3,6,9,33.3%,22m
36222,1,IIIIIIIIIIII,2273,78,2,1,3,66.7%,1h
36222,1,Demarcus,2273,97,1,1,2,50.0%,15m
36222,1,ratamortal,2273,0,1,4,5,20.0%,1h
36222,1,[LUD]BillyBoi,2273,0,1,5,6,16.7%,36m
36222,1,[SCMW]JCDJ,2273,46,1,6,7,14.3%,46m
36222,1,[SxyMxN]Quetzalcoatl,2273,0,0,1,1,0.0%,30m
36222,1,dizzzzy,2273,0,0,1,1,0.0%,30m
36222,1,[FSCN]JUMATTO,2273,0,0,1,1,0.0%,5m
36222,1,[YetiFC]DrkYeti,2273,0,0,2,2,0.0%,55m
36222,1,TakeWarning,2273,0,0,2,2,0.0%,4m
36248,3,JDT,2272,1473,176,179,355,49.6%,1h
36248,1,YANAHUMA,2272,1579,66,63,129,51.2%,3h
36248,1,Will,2272,1750,63,55,118,53.4%,3h
36248,1,ininfallible,2272,799,33,22,55,60.0%,13m
36248,1,[HIBOYZ]RobotDandy,2272,892,28,26,54,51.9%,3h
36248,1,[oziozi]COLL,2272,496,21,11,32,65.6%,20m
36248,1,TwoFaces,2272,505,18,4,22,81.8%,3h
36248,1,Jansen,2272,390,15,17,32,46.9%,22m
36248,2,YogurtCereal,2272,366,13,20,33,39.4%,39m
36248,1,CaliFromPC,2272,396,10,14,24,41.7%,34m
36248,1,[COIL]Ogre,2272,290,10,16,26,38.5%,3h
36248,3,Anders,2272,220,8,13,21,38.1%,15m
36248,1,tiny,2272,96,4,6,10,40.0%,3h
36248,2,PAINTRAIN,2272,0,2,7,9,22.2%,3h
36248,1,HUEngineer,2272,0,1,0,1,100.0%,1h
36248,2,Luffy,2272,0,1,1,2,50.0%,1h
36248,1,AndyChocopie,2272,88,1,3,4,25.0%,1h
36248,1,[APT109]DarthVejnar,2272,0,1,3,4,25.0%,34m
36248,1,[SM7]Attila,2272,40,1,3,4,25.0%,1h
36248,1,DAVEMYSTER,2272,0,1,5,6,16.7%,4m
36248,1,EtrnlNghtmr,2272,0,1,6,7,14.3%,58m
36248,1,tunasandwich,2272,0,0,1,1,0.0%,3h
36248,1,jojo,2272,0,0,1,1,0.0%,3h
36248,1,MAINVISITOR,2272,0,0,2,2,0.0%,25m
36272,2,SuperGlue,2271,1486,183,195,378,48.4%,1h
36272,1,Julian,2271,1445,76,74,150,50.7%,3h
36272,1,EasilyBribed,2271,1725,66,72,138,47.8%,1h
36272,1,Sooperdork,2271,734,30,20,50,60.0%,3h
36272,1,Pauba,2271,820,25,26,51,49.0%,3h
36272,1,KingSmash,2271,635,24,20,44,54.5%,22m
36272,3,shinaldo,2271,477,18,17,35,51.4%,1h
36272,1,[IIEKII]Pantera,2271,398,17,10,27,63.0%,1h
36272,1,chimpanzee,2271,564,14,18,32,43.8%,47m
36272,1,sirpeen,2271,256,7,9,16,43.8%,3h
36272,1,fraN,2271,208,6,9,15,40.0%,1h
36272,1,[LRN]Plux,2271,124,6,12,18,33.3%,3h
36272,3,[GØ]Lemurian,2271,150,5,5,10,50.0%,3h
36272,1,mumfordbioz,2271,40,2,5,7,28.6%,38m
36272,2,Busho,2271,88,2,7,9,22.2%,1h
36272,3,Reaper,2271,40,2,8,10,20.0%,14m
36272,1,James,2271,0,1,0,1,100.0%,48m
36272,2,Serrif,2271,0,0,1,1,0.0%,24m
36272,2,LinuxZulu,2271,0,0,1,1,0.0%,8m
36272,1,Matthew,2271,0,0,3,3,0.0%,55m
36292,3,TAO,2270,1524,169,162,331,51.1%,18m
36292,1,Cristeros,2270,1016,71,66,137,51.8%,34m
36292,1,iNcontroL,2270,1454,45,72,117,38.5%,60m
36292,1,Juzzhall,2270,997,40,40,80,50.0%,1h
36292,1,[CRAKS]DAXMAU,2270,818,25,26,51,49.0%,3h
36292,3,Jambiya,2270,669,25,28,53,47.2%,1h
36292,1,DockKing,2270,890,24,30,54,44.4%,1h
36292,3,Lionheart,2270,402,15,18,33,45.5%,1h
36292,1,Traus,2270,465,15,19,34,44.1%,39m
36292,3,Argwoster,2270,362,13,18,31,41.9%,40m
36292,1,[chzbyz]HiddenSquid,2270,466,12,10,22,54.5%,56m
36292,1,AdjutantCore,2270,277,11,10,21,52.4%,60m
36292,2,Jimmy,2270,289,9,13,22,40.9%,3h
36292,2,Roy,2270,229,7,8,15,46.7%,3h
36292,1,HOLLA,2270,162,5,9,14,35.7%,36m
36292,3,[SPBz]JohnGroenlin,2270,162,4,6,10,40.0%,3h
36292,1,palmach,2270,130,4,9,13,30.8%,25m
36292,2,[CrLine]darkrex,2270,0,3,2,5,60.0%,1h
36292,1,lookdasoup,2270,126,3,3,6,50.0%,37m
36292,1,Rattlebag,2270,102,3,4,7,42.9%,1h
36292,1,ZzzangelzzZ,2270,120,3,5,8,37.5%,37m
36292,1,Siape,2270,132,3,6,9,33.3%,3h
36292,1,SGBetelgeuse,2270,123,2,4,6,33.3%,52m
36292,1,BENEZ,2270,0,1,0,1,100.0%,12m
36292,1,Baastardo,2270,0,1,1,2,50.0%,38m
36292,1,TwinkleToes,2270,0,1,1,2,50.0%,4m
36292,1,[VRC]ChuquiMaster,2270,73,1,3,4,25.0%,3h
36292,1,TMPLR,2270,0,1,4,5,20.0%,3h
36292,1,[STUB]juggalotis,2270,0,0,1,1,0.0%,15m
36292,1,forgottenscv,2270,0,0,1,1,0.0%,30m
36292,2,McLovin,2270,0,0,4,4,0.0%,3h
36292,1,redfenix,2270,0,0,5,5,0.0%,23m
36292,2,DONRAMON,2270,0,0,5,5,0.0%,1h
36325,3,Jagrote,2269,1335,274,273,547,50.1%,3h
36325,3,Eruantale,2269,1567,186,196,382,48.7%,55m
36325,3,Wolf,2269,1537,171,170,341,50.1%,3h
36325,3,Oppressor,2269,1032,63,54,117,53.8%,28m
36325,1,Alexisherre,2269,668,42,38,80,52.5%,1h
36325,1,Deather,2269,964,42,42,84,50.0%,3h
36325,3,Sanjeewa,2269,1114,42,43,85,49.4%,15m
36325,3,PALACIOS,2269,449,34,32,66,51.5%,1h
36325,1,jmac,2269,628,31,27,58,53.4%,1h
36325,1,Jukes,2269,881,31,30,61,50.8%,3h
36325,1,MULGOM,2269,1042,28,42,70,40.0%,3h
36325,1,MASTERPELU,2269,609,19,14,33,57.6%,3h
36325,1,[CCFCA]Fobulouz,2269,338,13,16,29,44.8%,3h
36325,1,Captain,2269,341,11,8,19,57.9%,1h
36325,1,bebedeRo,2269,231,6,2,8,75.0%,3h
36325,1,[BChick]Theluca,2269,235,6,9,15,40.0%,1h
36325,1,MarkAntigua,2269,172,5,10,15,33.3%,3h
36325,1,[IDKB]JacknCoke,2269,124,5,13,18,27.8%,41m
36325,3,yaboiSQISHY,2269,0,4,3,7,57.1%,1h
36325,1,MarbLShooter,2269,144,4,4,8,50.0%,3h
36325,1,NEBUR,2269,82,3,1,4,75.0%,11m
36325,1,[USWAG]Tenkinoko,2269,157,3,5,8,37.5%,45m
36325,1,fernando,2269,108,2,1,3,66.7%,3h
36325,1,FlyJ,2269,44,2,4,6,33.3%,3h
36325,1,CodeUD,2269,0,1,2,3,33.3%,3h
36325,1,THEPIPOL,2269,0,0,1,1,0.0%,3h
36325,1,[JOSKYS]osky,2269,0,0,3,3,0.0%,3h
36325,1,Toshatine,2269,0,0,3,3,0.0%,1h
36353,3,ASMOTHEUS,2268,1482,103,111,214,48.1%,3h
36353,3,Qusk,2268,1546,94,91,185,50.8%,3h
36353,1,Odin,2268,748,67,85,152,44.1%,20m
36353,1,cooking,2268,810,59,77,136,43.4%,30m
36353,1,Lotus,2268,1592,56,51,107,52.3%,3h
36353,1,Andy,2268,1111,44,49,93,47.3%,30m
36353,1,RioFunk,2268,1021,33,41,74,44.6%,3h
36353,3,Bahumuth,2268,414,24,30,54,44.4%,57m
36353,1,XxxManatexxX,2268,419,14,17,31,45.2%,3h
36353,1,iamsas,2268,344,12,16,28,42.9%,57m
36353,1,RanggaNs,2268,290,10,10,20,50.0%,42m
36353,1,[JusfFF]SoPlayNet,2268,402,10,12,22,45.5%,50m
36353,1,[AssSZN]SpankMaster,2268,342,9,12,21,42.9%,1h
36353,1,Neurobear,2268,250,8,7,15,53.3%,30m
36353,1,BakpoPtaKsup,2268,237,6,4,10,60.0%,59m
36353,1,anlord,2268,170,6,7,13,46.2%,1h
36353,1,Desquarius,2268,212,6,8,14,42.9%,3h
36353,1,jean,2268,221,5,7,12,41.7%,3h
36353,1,[GGdogs]Postre,2268,157,4,0,4,100.0%,3h
36353,3,BigKeithNRG,2268,107,3,5,8,37.5%,1h
36353,3,Orange,2268,122,3,6,9,33.3%,51m
36353,2,Duke,2268,0,3,10,13,23.1%,24m
36353,1,StormFarron,2268,46,2,6,8,25.0%,26m
36353,1,[FyHr]kronos,2268,0,1,0,1,100.0%,3h
36353,1,Cosmos,2268,0,1,0,1,100.0%,3h
36353,1,Esaliine,2268,48,1,2,3,33.3%,1h
36353,1,jojulien,2268,42,1,3,4,25.0%,1h
36353,1,Hoobitces,2268,0,1,3,4,25.0%,1h
36353,1,enrike,2268,0,1,5,6,16.7%,3h
36353,2,Bubbles,2268,0,1,8,9,11.1%,3h
36353,1,Ervicec,2268,0,0,1,1,0.0%,23m
36353,1,diego,2268,0,0,1,1,0.0%,3h
36353,1,Nanorine,2268,0,0,1,1,0.0%,3h
36353,1,DJWHY,2268,0,0,3,3,0.0%,3h
36353,3,[Blokes]Tekkadan,2268,0,0,3,3,0.0%,1h
36388,3,DocOcto,2267,1389,225,221,446,50.4%,32m
36388,3,[SCRlM]Bonzalez,2267,1252,118,102,220,53.6%,17m
36388,3,outraged,2267,1412,90,91,181,49.7%,3h
36388,1,Thunderstone,2267,1331,51,41,92,55.4%,3h
36388,3,Wei,2267,1264,47,52,99,47.5%,1h
36388,3,[AoLSC]Fearmy,2267,673,24,27,51,47.1%,21m
36388,3,SethSword,2267,608,23,27,50,46.0%,1h
36388,2,[R4MR0D]Xerxes,2267,399,15,23,38,39.5%,3h
36388,1,optimuschwdr,2267,434,12,14,26,46.2%,36m
36388,1,oXEJECUTORXo,2267,212,6,7,13,46.2%,3h
36388,1,MortyHot,2267,148,5,4,9,55.6%,56m
36388,1,[Calx]Gravity,2267,122,4,3,7,57.1%,39m
36388,1,Shamoa,2267,189,4,4,8,50.0%,36m
36388,1,DZOGI,2267,142,4,6,10,40.0%,60m
36388,1,[12YOLD]Minimuffin,2267,156,4,7,11,36.4%,3h
36388,1,AxelSteel,2267,92,3,3,6,50.0%,3h
36388,1,PersonKiller,2267,44,2,1,3,66.7%,1h
36388,1,[latrom]Exothermic,2267,0,2,3,5,40.0%,58m
36388,1,JohnnyTuktuk,2267,88,2,3,5,40.0%,1h
36388,1,[ESP0RT]Maru,2267,97,2,3,5,40.0%,3h
36388,1,[ZiB]Starflown,2267,0,2,5,7,28.6%,1h
36388,1,TeedesT,2267,48,2,6,8,25.0%,1h
36388,1,Pashton,2267,0,2,7,9,22.2%,3h
36388,1,Princess,2267,0,1,0,1,100.0%,21m
36388,1,[BOXNET]Dieuguerre,2267,44,1,19,20,5.0%,22m
36388,1,[DSFTWA]TheGodfather,2267,0,0,1,1,0.0%,3h
36388,1,Backlash,2267,0,0,1,1,0.0%,50m
36388,1,[TwiLit]Ham,2267,0,0,1,1,0.0%,13m
36388,1,Izraador,2267,0,0,2,2,0.0%,48m
36388,3,RAshinMO,2267,0,0,3,3,0.0%,3h
36388,1,Pibbdrippe,2267,0,0,5,5,0.0%,16m
36419,3,FreedomZone,2266,1537,285,287,572,49.8%,50m
36419,1,[EpicG]FraNChiLeNo,2266,1829,254,251,505,50.3%,16m
36419,1,[CZN]filster,2266,1844,142,132,274,51.8%,1h
36419,2,[ChiFan]Zeus,2266,1502,108,115,223,48.4%,41m
36419,3,[FatMom]ODDMX,2266,949,92,90,182,50.5%,6m
36419,1,tomates,2266,1647,90,92,182,49.5%,45m
36419,3,[Mc]Jupiter,2266,1519,82,92,174,47.1%,7m
36419,3,Anathema,2266,1328,63,82,145,43.4%,15m
36419,1,Vega,2266,1156,49,39,88,55.7%,3h
36419,1,camrpage,2266,874,26,28,54,48.1%,1h
36419,1,MrPink,2266,689,25,34,59,42.4%,3h
36419,1,Congi,2266,724,22,21,43,51.2%,58m
36419,1,Dmitry,2266,562,19,19,38,50.0%,42m
36419,1,[Sobro]BosstonSwag,2266,534,18,18,36,50.0%,36m
36419,1,DanWolfgang,2266,394,15,7,22,68.2%,3h
36419,1,talentless,2266,484,13,15,28,46.4%,1h
36419,1,[UpxV]Erennor,2266,488,13,17,30,43.3%,3h
36419,1,PandaLad,2266,404,12,16,28,42.9%,3h
36419,1,BonelessTaco,2266,326,11,13,24,45.8%,31m
36419,1,latter,2266,298,10,11,21,47.6%,1h
36419,1,MrBig,2266,336,10,16,26,38.5%,50m
36419,3,[HFN]PrimalKing,2266,120,5,10,15,33.3%,19m
36419,2,Blind,2266,142,4,13,17,23.5%,3h
36419,1,Mist,2266,145,3,1,4,75.0%,1h
36419,1,harrypostres,2266,90,3,2,5,60.0%,3h
36419,3,KINGofF,2266,125,3,4,7,42.9%,1h
36419,1,HiddenSquid,2266,48,2,6,8,25.0%,1h
36419,1,DarkHunter,2266,0,1,3,4,25.0%,1h
36419,1,lgs,2266,0,1,4,5,20.0%,34m
36419,1,Dedalus,2266,0,1,5,6,16.7%,1h
36419,1,[SO4P]NightHawk,2266,0,1,5,6,16.7%,46m
36419,1,Zartan,2266,0,0,1,1,0.0%,55m
36419,1,matt,2266,0,0,1,1,0.0%,38m
36419,1,[Fl4ams]Ibrahim,2266,0,0,1,1,0.0%,3h
36419,2,Holyight,2266,0,0,1,1,0.0%,3h
36419,3,lukaax,2266,0,0,4,4,0.0%,1h
36419,2,HumanEb,2266,0,0,7,7,0.0%,35m
36456,3,rubenpoli,2265,1627,268,268,536,50.0%,7m
36456,3,[Beer20]BeerMMXX,2265,1665,115,127,242,47.5%,3h
36456,2,[DRKDMN]GreenDeath,2265,1487,91,101,192,47.4%,26m
36456,1,Antinomy,2265,623,58,120,178,32.6%,3h
36456,1,Dazz,2265,1279,46,52,98,46.9%,60m
36456,3,MrRabbit,2265,715,42,31,73,57.5%,55m
36456,3,[FAPFAP]hebrewhammer,2265,830,38,43,81,46.9%,1h
36456,1,Littlebee,2265,406,27,19,46,58.7%,21m
36456,1,David,2265,370,15,6,21,71.4%,3h
36456,1,SoldieRT,2265,470,14,16,30,46.7%,3h
36456,1,MASTERED,2265,462,13,14,27,48.1%,14m
36456,1,SaladToss,2265,518,13,18,31,41.9%,1h
36456,1,[kaptor]Legoshi,2265,327,9,9,18,50.0%,27m
36456,1,Jack,2265,280,8,9,17,47.1%,47m
36456,3,MumenRider,2265,228,8,19,27,29.6%,22m
36456,2,Trevaldi,2265,114,6,10,16,37.5%,3h
36456,1,Fiiishy,2265,58,3,1,4,75.0%,31m
36456,1,KYO,2265,128,3,3,6,50.0%,6m
36456,1,[KerriS]NeroKaijin,2265,126,3,6,9,33.3%,3h
36456,3,Bullshooter,2265,30,3,8,11,27.3%,34m
36456,1,procras,2265,40,2,0,2,100.0%,3h
36456,1,KingQuazi,2265,86,2,3,5,40.0%,40m
36456,1,[DSS]Ranma,2265,48,2,6,8,25.0%,3h
36456,3,EUPHONIUM,2265,97,2,8,10,20.0%,1h
36456,1,Dubtron,2265,0,1,0,1,100.0%,4m
36456,1,[OSIM]Thoreau,2265,0,1,0,1,100.0%,52m
36456,3,ghostdragon,2265,0,1,1,2,50.0%,1h
36456,1,AngelAbraxas,2265,0,1,5,6,16.7%,5m
36456,1,[SoAC]SirSchnitzel,2265,0,0,1,1,0.0%,3h
36456,2,QuickChick,2265,0,0,1,1,0.0%,3h
36456,1,WARMACHINE,2265,0,0,2,2,0.0%,3h
36456,1,Enthused,2265,0,0,2,2,0.0%,3h
36488,2,Bingley,2264,357,92,94,186,49.5%,1h
36488,1,[LaTW]Disperso,2264,1808,73,76,149,49.0%,3h
36488,1,[Damasc]Azulito,2264,1689,61,60,121,50.4%,7m
36488,1,RobvonRofl,2264,1337,53,47,100,53.0%,3h
36488,3,Firemelon,2264,984,37,41,78,47.4%,1h
36488,1,Cyborg,2264,838,29,38,67,43.3%,3h
36488,2,Chris,2264,808,26,38,64,40.6%,1h
36488,1,SpaceMarine,2264,755,22,20,42,52.4%,9m
36488,1,dylan,2264,382,20,14,34,58.8%,3h
36488,1,[Macac0]Yimi,2264,592,19,18,37,51.4%,23m
36488,1,Cursedgamer,2264,381,15,19,34,44.1%,3h
36488,1,JurgenK,2264,370,10,14,24,41.7%,1h
36488,2,[Jamin]SbCarrisai,2264,240,7,12,19,36.8%,1h
36488,1,[PY]Uil,2264,148,5,3,8,62.5%,1h
36488,1,Maurinaz,2264,160,5,5,10,50.0%,60m
36488,1,GRANADOS,2264,210,5,10,15,33.3%,1h
36488,1,Blsdwarrior,2264,84,3,3,6,50.0%,30m
36488,3,[phofu]SenTz,2264,30,3,8,11,27.3%,1h
36488,3,HansLandaSS,2264,94,3,12,15,20.0%,1h
36488,1,mothoglan,2264,0,2,4,6,33.3%,1h
36488,1,JustinWZ,2264,0,1,2,3,33.3%,3h
36488,2,Orcpeon,2264,0,1,3,4,25.0%,8m
36488,1,MrWatt,2264,0,1,4,5,20.0%,1h
36488,2,Nicalds,2264,0,1,4,5,20.0%,39m
36488,1,holygost,2264,0,1,5,6,16.7%,3h
36488,1,[USplan]tonydatank,2264,0,0,1,1,0.0%,40m
36488,1,Runslow,2264,0,0,1,1,0.0%,3h
36488,1,Xenomorph,2264,0,0,1,1,0.0%,1h
36488,2,SEVEN,2264,0,0,1,1,0.0%,1h
36488,2,odaesu,2264,0,0,4,4,0.0%,3h
36518,2,Mateo,2263,1520,140,139,279,50.2%,3h
36518,2,RainbowFruit,2263,1075,84,88,172,48.8%,3h
36518,3,[MZHS]pilo,2263,1403,75,74,149,50.3%,3h
36518,1,MagicOps,2263,1064,63,57,120,52.5%,34m
36518,1,[KDPL]kaonashi,2263,1420,59,50,109,54.1%,3h
36518,1,null,2263,1112,41,38,79,51.9%,1h
36518,2,cen,2263,936,33,43,76,43.4%,3h
36518,1,Criswir,2263,264,16,9,25,64.0%,3h
36518,1,MissBelks,2263,376,10,11,21,47.6%,3h
36518,3,DrewDudeSS,2263,257,8,12,20,40.0%,3h
36518,1,tak,2263,241,5,8,13,38.5%,31m
36518,1,[BraziI]rafael,2263,159,4,1,5,80.0%,1h
36518,2,Pejaro,2263,60,4,8,12,33.3%,42m
36518,2,CrOwlKinG,2263,0,3,2,5,60.0%,8m
36518,1,TheGrapist,2263,36,3,4,7,42.9%,36m
36518,1,xmbie,2263,78,3,6,9,33.3%,31m
36518,1,ANBU,2263,128,3,7,10,30.0%,1h
36518,1,TraukoDV,2263,42,2,1,3,66.7%,50m
36518,1,REEactive,2263,0,2,3,5,40.0%,50m
36518,1,Mierdaz,2263,0,1,1,2,50.0%,40m
36518,2,YogSothoth,2263,0,1,4,5,20.0%,1h
36518,1,toro,2263,0,1,5,6,16.7%,1h
36518,1,FDfall,2263,0,0,1,1,0.0%,4m
36518,1,Johnqpublic,2263,0,0,1,1,0.0%,31m
36518,1,[Enable]BoOYaz,2263,0,0,1,1,0.0%,1h
36543,1,COACHESPT,2262,1813,124,131,255,48.6%,11m
36543,2,Triberious,2262,1502,58,62,120,48.3%,36m
36543,1,DmS,2262,1023,38,30,68,55.9%,34m
36543,3,WreckTango,2262,876,38,37,75,50.7%,1h
36543,1,SoruDark,2262,524,22,12,34,64.7%,1h
36543,1,Volatility,2262,447,15,12,27,55.6%,1h
36543,1,Immortal,2262,540,15,14,29,51.7%,1h
36543,3,Salivon,2262,395,15,15,30,50.0%,1h
36543,3,Cutuvelo,2262,388,15,20,35,42.9%,1h
36543,1,Aayuiasesino,2262,433,13,7,20,65.0%,4m
36543,3,[SANGRE]POOLFREAK,2262,344,13,23,36,36.1%,1h
36543,1,helpimstuc,2262,438,12,13,25,48.0%,58m
36543,1,KrookedMan,2262,252,12,18,30,40.0%,3h
36543,1,Fortnite,2262,312,9,7,16,56.2%,42m
36543,1,[593UP]StarDust,2262,356,9,9,18,50.0%,3h
36543,1,[CWSE]somanyname,2262,324,8,14,22,36.4%,1h
36543,1,lilbaby,2262,154,7,7,14,50.0%,21m
36543,1,bapolex,2262,224,7,12,19,36.8%,42m
36543,3,[POL]WildRage,2262,212,6,3,9,66.7%,25m
36543,1,BrownTown,2262,198,6,10,16,37.5%,14m
36543,1,eltikastik,2262,210,5,12,17,29.4%,3h
36543,1,Kasparov,2262,97,2,1,3,66.7%,3h
36543,2,Epiphany,2262,0,2,3,5,40.0%,47m
36543,1,XxchonksxX,2262,135,2,4,6,33.3%,6m
36543,1,Alibaba,2262,46,2,6,8,25.0%,55m
36543,3,YaboyNick,2262,93,2,6,8,25.0%,3h
36543,2,rawrskis,2262,0,1,1,2,50.0%,3h
36543,2,ElsaPato,2262,0,1,4,5,20.0%,8m
36543,3,[SwampT]panxi,2262,0,1,5,6,16.7%,15m
36543,1,[RR4]Runtastico,2262,0,0,2,2,0.0%,55m
36543,1,Moonblade,2262,0,0,2,2,0.0%,45m
36543,1,DarkAvenger,2262,0,0,2,2,0.0%,34m
36543,1,[TCJN]SneezyDwarf,2262,0,0,6,6,0.0%,3h
36576,1,BlueSea,2261,986,105,113,218,48.2%,1h
36576,1,Waldeezy,2261,1475,71,65,136,52.2%,1h
36576,1,Red,2261,1392,61,65,126,48.4%,45m
36576,3,[lSCMXl]SCDO,2261,1466,55,60,115,47.8%,1h
36576,3,DUNit,2261,511,37,42,79,46.8%,1h
36576,3,[Macac0]MoisesOtaku,2261,563,28,27,55,50.9%,30m
36576,2,Paquiro,2261,776,28,36,64,43.8%,17m
36576,2,benji,2261,738,26,36,62,41.9%,1h
36576,1,jackJR,2261,802,24,27,51,47.1%,56m
36576,1,noles,2261,830,23,25,48,47.9%,1h
36576,1,Siege,2261,665,20,20,40,50.0%,52m
36576,1,[FyHr]ComandoRojo,2261,467,18,17,35,51.4%,50m
36576,1,Bluejayz,2261,423,13,17,30,43.3%,30m
36576,1,GoodKnight,2261,380,12,12,24,50.0%,3h
36576,1,[IncSC]badseed,2261,364,11,7,18,61.1%,13m
36576,1,BrookzDERP,2261,349,11,9,20,55.0%,3h
36576,1,MechEng,2261,395,10,9,19,52.6%,4m
36576,3,MRroger,2261,260,10,18,28,35.7%,1h
36576,3,[SQ]Guyome,2261,116,7,8,15,46.7%,3h
36576,1,elmachaco,2261,206,6,6,12,50.0%,1h
36576,3,Zakk,2261,100,5,11,16,31.2%,1h
36576,3,[LEG1ON]Basti,2261,162,5,17,22,22.7%,3h
36576,1,Pakichay,2261,82,3,1,4,75.0%,3h
36576,1,MajestiChaos,2261,126,3,1,4,75.0%,3h
36576,1,Kognitive,2261,96,3,7,10,30.0%,40m
36576,1,TheEndDragon,2261,126,3,8,11,27.3%,4m
36576,1,BigDog,2261,0,0,1,1,0.0%,3h
36576,1,DudeOfAstora,2261,0,0,1,1,0.0%,27m
36576,1,[CHOG]SNIPERDUDE,2261,0,0,4,4,0.0%,5m
36576,3,Keyzx,2261,0,0,5,5,0.0%,22m
36606,1,Amigo,2260,1732,160,155,315,50.8%,1h
36606,3,Amomonkeys,2260,1362,118,121,239,49.4%,1h
36606,1,fierrero,2260,1670,117,102,219,53.4%,36m
36606,1,[TnGn]tetsu,2260,1796,109,112,221,49.3%,16m
36606,3,[DBS999]Winterstein,2260,1515,94,99,193,48.7%,1h
36606,1,Bandido,2260,1758,86,82,168,51.2%,3h
36606,3,mayormilo,2260,1263,63,60,123,51.2%,35m
36606,1,[COV69]ROBOTOMOJO,2260,1302,53,40,93,57.0%,22m
36606,1,NANIiii,2260,1069,38,32,70,54.3%,3h
36606,1,Seabas,2260,786,36,22,58,62.1%,42m
36606,3,AHW,2260,696,26,28,54,48.1%,41m
36606,1,Purcpower,2260,874,26,32,58,44.8%,58m
36606,1,Archeantus,2260,772,25,18,43,58.1%,1h
36606,1,Skapari,2260,601,19,17,36,52.8%,48m
36606,1,[LOLASO]velizz,2260,376,15,17,32,46.9%,1h
36606,1,Matrix,2260,462,13,15,28,46.4%,49m
36606,1,abasg,2260,326,11,10,21,52.4%,13m
36606,3,Presa,2260,294,10,17,27,37.0%,1h
36606,3,[SyncFr]FrankStrong,2260,361,10,18,28,35.7%,1h
36606,1,dæmon,2260,273,9,7,16,56.2%,3h
36606,1,Mayniak,2260,318,9,8,17,52.9%,22m
36606,3,[ClanHs]Rezpectful,2260,267,7,10,17,41.2%,1h
36606,1,Gianpaolo,2260,111,7,11,18,38.9%,1h
36606,3,[Necron]TheDoomBlade,2260,167,5,2,7,71.4%,14m
36606,1,[iGYo]frankdatank,2260,222,5,17,22,22.7%,3h
36606,1,CujoWillaby,2260,68,3,1,4,75.0%,4m
36606,2,[MCLRSN]MichaelRosen,2260,48,2,3,5,40.0%,3h
36606,1,FennixElPoli,2260,84,2,3,5,40.0%,43m
36606,1,pXpollo,2260,0,1,2,3,33.3%,3h
36606,1,AnimaciónG,2260,44,1,3,4,25.0%,14m
36606,1,Esnipea,2260,48,1,3,4,25.0%,26m
36606,1,Harclos,2260,0,1,5,6,16.7%,1h
36606,1,Dave,2260,0,0,1,1,0.0%,3h
36606,2,mrRAGER,2260,0,0,4,4,0.0%,19m
36640,3,KingJames,2259,1478,215,198,413,52.1%,1h
36640,2,UliKunkel,2259,1462,145,151,296,49.0%,32m
36640,1,JAMES,2259,1833,109,117,226,48.2%,11m
36640,3,EgonMusk,2259,1310,74,69,143,51.7%,28m
36640,1,Rexdawn,2259,1243,65,63,128,50.8%,1h
36640,3,JHONNYBLACK,2259,1040,52,51,103,50.5%,50m
36640,3,DennisCousin,2259,1076,40,45,85,47.1%,3h
36640,1,swy,2259,904,31,35,66,47.0%,1h
36640,1,TeddyGold,2259,750,22,23,45,48.9%,1h
36640,1,[LisaAn]GDTheKid,2259,542,17,16,33,51.5%,3h
36640,1,LucasTerran,2259,218,10,6,16,62.5%,3h
36640,3,[LMI42]fatbaldoldma,2259,184,6,19,25,24.0%,6m
36640,1,VolcanoMaN,2259,171,5,4,9,55.6%,1h
36640,1,PeterQuill,2259,80,5,4,9,55.6%,46m
36640,1,PigSlayer,2259,212,5,10,15,33.3%,3h
36640,1,ncv,2259,98,3,9,12,25.0%,1h
36640,1,[Epokhé]elegunkaya,2259,122,2,1,3,66.7%,3h
36640,1,[NU11]PsychoFlyer,2259,48,2,2,4,50.0%,1h
36640,1,Moda,2259,121,2,6,8,25.0%,1h
36640,1,eli,2259,48,2,6,8,25.0%,3h
36640,1,Microraptor,2259,32,1,2,3,33.3%,3h
36640,1,LeroyJenkins,2259,36,1,3,4,25.0%,3h
36640,1,MiyanoShiho,2259,0,1,4,5,20.0%,37m
36640,1,Lokitroy,2259,0,1,5,6,16.7%,3h
36640,1,Nitromech,2259,44,1,5,6,16.7%,3h
36640,3,Matt,2259,30,1,8,9,11.1%,58m
36640,1,[SUDAKA]DONDIABLO,2259,0,0,1,1,0.0%,3h
36640,1,[Ichnac]Jarito,2259,0,0,1,1,0.0%,25m
36640,1,DropSudden,2259,0,0,2,2,0.0%,1h
36640,2,Binro,2259,0,0,5,5,0.0%,48m
36640,1,Alewpzy,2259,0,0,6,6,0.0%,26m
36671,3,Ezequiel,2258,1521,140,135,275,50.9%,6m
36671,3,[DETER]Low,2258,1425,101,124,225,44.9%,19m
36671,2,happyliar,2258,1127,93,107,200,46.5%,54m
36671,1,Hector,2258,1225,91,85,176,51.7%,3h
36671,1,edimenpa,2258,1828,70,73,143,49.0%,23m
36671,3,Shadow,2258,1454,67,72,139,48.2%,50m
36671,1,Anahuac,2258,1502,54,53,107,50.5%,50m
36671,1,[HOT69]JamesRaven,2258,1108,33,36,69,47.8%,1h
36671,1,ctiulhu,2258,635,24,19,43,55.8%,3h
36671,1,Lucas,2258,358,12,5,17,70.6%,1h
36671,2,Cineris,2258,263,8,11,19,42.1%,13m
36671,2,MakeAWish,2258,238,8,15,23,34.8%,6m
36671,2,WeaponX,2258,154,6,17,23,26.1%,7m
36671,3,Spartacus,2258,64,4,8,12,33.3%,52m
36671,1,[StarMT]KapTain,2258,42,2,1,3,66.7%,1h
36671,1,Pipebre,2258,0,2,6,8,25.0%,3h
36671,1,STFU,2258,0,1,0,1,100.0%,3h
36671,1,Ghost,2258,42,1,2,3,33.3%,58m
36671,1,SANDAN,2258,46,1,4,5,20.0%,3h
36671,1,Brando,2258,0,1,5,6,16.7%,22m
36671,1,Rambo,2258,0,1,6,7,14.3%,3m
36671,1,HarthBringer,2258,0,0,1,1,0.0%,1h
36693,2,CoronaSucks,2257,1565,254,238,492,51.6%,1h
36693,1,SWE,2257,1562,181,184,365,49.6%,20m
36693,1,Aterrador,2257,1830,174,172,346,50.3%,56m
36693,1,LICKY,2257,1778,158,170,328,48.2%,25m
36693,2,ClayDavis,2257,1532,133,141,274,48.5%,55m
36693,1,tDQSCK,2257,1840,92,93,185,49.7%,1h
36693,1,[12YD]EatMyButt,2257,1370,47,43,90,52.2%,1h
36693,1,Maru,2257,961,32,31,63,50.8%,37m
36693,3,Armadica,2257,525,22,18,40,55.0%,56m
36693,1,Pava,2257,470,19,16,35,54.3%,1h
36693,3,KUDOKASHI,2257,580,19,24,43,44.2%,17m
36693,1,Latvia,2257,602,18,38,56,32.1%,60m
36693,1,ELBROOEBP,2257,448,14,18,32,43.8%,16m
36693,1,[flayte]Matapacos,2257,206,6,6,12,50.0%,1h
36693,1,Exams,2257,42,4,4,8,50.0%,3h
36693,1,NieL,2257,189,4,5,9,44.4%,5m
36693,1,DaBlob,2257,108,3,3,6,50.0%,40m
36693,1,[UtPowr]TopTap,2257,102,3,3,6,50.0%,3h
36693,1,PNP,2257,0,2,1,3,66.7%,7m
36693,1,WickedY,2257,48,2,2,4,50.0%,39m
36693,1,[RdRC]Phleppse,2257,103,2,5,7,28.6%,3h
36693,1,Supershots,2257,48,2,6,8,25.0%,55m
36693,3,[MicroW]linkluke,2257,95,2,6,8,25.0%,1h
36693,1,Dragon,2257,44,1,1,2,50.0%,1h
36693,1,xtianb,2257,0,1,1,2,50.0%,22m
36693,1,Weebi,2257,90,1,1,2,50.0%,59m
36693,2,[NSB01]Caprisun,2257,0,1,4,5,20.0%,4m
36693,2,Rocastil,2257,48,1,5,6,16.7%,1h
36693,1,vortex,2257,0,1,5,6,16.7%,3h
36693,3,tortboi,2257,0,1,7,8,12.5%,30m
36693,1,Karzek,2257,0,0,2,2,0.0%,60m
36693,1,MiniError,2257,0,0,2,2,0.0%,3h
36693,1,[NLTN]carlostito,2257,0,0,2,2,0.0%,1h
36693,1,Bang,2257,0,0,3,3,0.0%,34m
36693,1,RckSteady,2257,0,0,3,3,0.0%,4m
36693,1,ESCORPIO,2257,0,0,4,4,0.0%,41m
36729,1,XLATUS,2256,1826,197,202,399,49.4%,14m
36729,3,Hector,2256,1541,140,140,280,50.0%,35m
36729,1,Tyrael,2256,1836,93,93,186,50.0%,1h
36729,1,RippIN,2256,1443,58,51,109,53.2%,57m
36729,3,MightyBeast,2256,938,45,50,95,47.4%,1h
36729,1,Mael,2256,797,27,17,44,61.4%,48m
36729,1,Nosorogh,2256,856,27,24,51,52.9%,40m
36729,1,[FatMom]Gaminmastre,2256,420,16,14,30,53.3%,1h
36729,1,YoungBucky,2256,360,10,12,22,45.5%,1h
36729,1,Pistallion,2256,239,9,5,14,64.3%,38m
36729,1,[Raytar]TheAngryNoob,2256,274,8,3,11,72.7%,13m
36729,1,bebruda,2256,272,7,8,15,46.7%,6m
36729,1,buttfor,2256,244,7,11,18,38.9%,3h
36729,1,danielisto,2256,144,4,2,6,66.7%,51m
36729,2,GrosToss,2256,58,4,8,12,33.3%,8m
36729,1,[GLCO]fer,2256,96,2,0,2,100.0%,14m
36729,1,BenJAMMIN,2256,82,2,3,5,40.0%,3h
36729,1,SuperToddy,2256,32,2,3,5,40.0%,3h
36729,1,NAKAMA,2256,40,2,5,7,28.6%,55m
36729,3,axios,2256,96,2,6,8,25.0%,3h
36729,1,LukTat,2256,0,2,7,9,22.2%,57m
36729,1,keo,2256,0,1,0,1,100.0%,15m
36729,1,Chilakil,2256,0,1,0,1,100.0%,41m
36729,1,Aye,2256,0,1,5,6,16.7%,3h
36729,1,Niklaus,2256,34,1,8,9,11.1%,3h
36729,2,Poche,2256,0,0,1,1,0.0%,47m
36755,1,KrattoS,2255,1315,151,159,310,48.7%,22m
36755,1,Gloat,2255,1622,105,103,208,50.5%,3h
36755,1,Iplayfalcon,2255,1259,48,41,89,53.9%,22m
36755,1,Castlevania,2255,979,32,30,62,51.6%,59m
36755,1,[LMI42]DaBoss,2255,693,21,23,44,47.7%,40m
36755,1,Ryuzaki,2255,678,19,22,41,46.3%,3h
36755,1,spenceju,2255,521,18,17,35,51.4%,25m
36755,1,NOC,2255,409,14,18,32,43.8%,1h
36755,1,[OOOOOF]pozzolio,2255,459,13,9,22,59.1%,3h
36755,3,cole,2255,306,11,20,31,35.5%,30m
36755,1,StarKnight,2255,329,10,12,22,45.5%,11m
36755,1,Ridiculombre,2255,193,7,2,9,77.8%,1h
36755,1,Rick,2255,274,7,13,20,35.0%,4m
36755,1,TheHolyPizza,2255,162,5,8,13,38.5%,37m
36755,3,EazyPeazy,2255,160,5,9,14,35.7%,41m
36755,3,HeatedDragon,2255,102,4,9,13,30.8%,21m
36755,1,Suh,2255,145,3,6,9,33.3%,14m
36755,3,BigBoss,2255,94,3,11,14,21.4%,58m
36755,1,Coburn,2255,0,2,4,6,33.3%,3h
36755,1,[GBOYZ]Dondroid,2255,97,2,6,8,25.0%,48m
36755,1,[Howce]Twink,2255,0,1,0,1,100.0%,1h
36755,1,[oSRt]BlackFangDog,2255,46,1,1,2,50.0%,3h
36755,1,EyeCan,2255,44,1,1,2,50.0%,3h
36755,1,JackRo,2255,40,1,1,2,50.0%,1h
36755,1,[BoAVN]ZRT,2255,0,1,2,3,33.3%,9m
36755,2,maximus,2255,0,1,4,5,20.0%,1h
36755,3,[LUCS]GigaYeet,2255,0,1,8,9,11.1%,24m
36755,1,Judged,2255,0,0,1,1,0.0%,40m
36755,1,Chelino,2255,0,0,1,1,0.0%,13m
36755,2,EnrAlaMD,2255,0,0,1,1,0.0%,41m
36755,1,[Squidy]NotThisTime,2255,0,0,2,2,0.0%,26m
36755,1,doc,2255,0,0,4,4,0.0%,46m
36755,2,[P3RR0S]Malevich,2255,0,0,5,5,0.0%,47m
36788,1,Drink,2254,1558,417,442,859,48.5%,36m
36788,1,Linkkair,2254,1767,232,235,467,49.7%,3h
36788,1,mcgrue,2254,1523,165,179,344,48.0%,1h
36788,3,XxCasperxX,2254,729,162,159,321,50.5%,1h
36788,2,Apex,2254,1053,91,103,194,46.9%,55m
36788,1,VisibleIvan,2254,1184,89,87,176,50.6%,1h
36788,3,patribun,2254,1448,85,90,175,48.6%,1h
36788,1,lucas,2254,1499,77,68,145,53.1%,45m
36788,1,TheValyrian,2254,1168,47,46,93,50.5%,23m
36788,1,[Yeeeea]Pathen,2254,722,19,26,45,42.2%,1h
36788,1,ToastieXO,2254,428,16,12,28,57.1%,3h
36788,1,[INVT]vico,2254,480,13,16,29,44.8%,3h
36788,3,Metal,2254,406,13,27,40,32.5%,1h
36788,1,Wileykyoti,2254,306,7,9,16,43.8%,4m
36788,1,lethal,2254,251,7,12,19,36.8%,4m
36788,2,Parker,2254,190,6,12,18,33.3%,55m
36788,1,ZEVILLANO,2254,210,5,9,14,35.7%,13m
36788,1,Raikyouu,2254,130,5,9,14,35.7%,39m
36788,1,Nobunagada,2254,82,3,2,5,60.0%,16m
36788,2,Zdawgman,2254,60,3,6,9,33.3%,3h
36788,1,cacosh,2254,82,2,4,6,33.3%,49m
36788,1,Mook,2254,30,2,6,8,25.0%,3h
36788,1,Zulu,2254,0,1,0,1,100.0%,3h
36788,1,FatalFuze,2254,0,1,0,1,100.0%,3h
36788,1,[SW0RD]Brandyn,2254,0,1,1,2,50.0%,1h
36788,1,[ROT3K]TRANKOZ,2254,30,1,5,6,16.7%,1h
36788,1,[unRa]nikrep,2254,0,0,1,1,0.0%,1h
36788,1,cyrriusblack,2254,0,0,3,3,0.0%,1m
36816,1,AnGGELLo,2253,1302,63,65,128,49.2%,3h
36816,2,MagicTerran,2253,973,57,67,124,46.0%,59m
36816,1,LengeLenge,2253,1222,51,44,95,53.7%,3h
36816,3,DfraN,2253,1223,49,51,100,49.0%,1h
36816,1,[SBlock]Vergara,2253,996,46,25,71,64.8%,60m
36816,1,BRZhadouken,2253,613,39,40,79,49.4%,3h
36816,3,ShdowNight,2253,782,30,28,58,51.7%,3h
36816,1,ZEUS,2253,918,29,31,60,48.3%,1h
36816,1,AleFerrari,2253,602,22,21,43,51.2%,1h
36816,1,IlIIlIlIllIl,2253,640,18,15,33,54.5%,3h
36816,1,[FFAA]Enmanuel,2253,391,18,17,35,51.4%,40m
36816,1,[Osexc]Tezzeret,2253,257,16,16,32,50.0%,31m
36816,1,Amar,2253,210,10,11,21,47.6%,1h
36816,1,Sublime,2253,339,10,11,21,47.6%,43m
36816,1,Kulick,2253,284,7,7,14,50.0%,1h
36816,1,magicahn,2253,216,6,7,13,46.2%,1h
36816,2,Bungle,2253,190,6,22,28,21.4%,38m
36816,1,DANLLEL,2253,0,5,0,5,100.0%,3h
36816,1,zoidberg,2253,192,5,10,15,33.3%,1h
36816,3,[papayo]frandux,2253,120,5,15,20,25.0%,1h
36816,3,Parraguez,2253,141,4,8,12,33.3%,3h
36816,1,DarthPreator,2253,169,3,2,5,60.0%,1h
36816,1,SrZombie,2253,127,3,2,5,60.0%,1h
36816,1,Kyle,2253,86,3,7,10,30.0%,46m
36816,3,[DEREZZ]ACM,2253,88,3,14,17,17.6%,48m
36816,1,[LQV]Fliparto,2253,44,2,4,6,33.3%,4m
36816,2,[FalPal]CrestForever,2253,30,2,5,7,28.6%,42m
36816,1,ZZK,2253,36,2,5,7,28.6%,60m
36816,1,Coronachina,2253,97,2,6,8,25.0%,5m
36816,1,[NLTN]TioVrits,2253,88,2,9,11,18.2%,45m
36816,1,[LESSP]KINGFATOUCH,2253,91,1,1,2,50.0%,1h
36816,1,Terra,2253,0,1,4,5,20.0%,1h
36816,1,MVMNOOOB,2253,0,1,5,6,16.7%,5m
36816,1,Ivanosky,2253,0,0,1,1,0.0%,1h
36816,1,element,2253,0,0,1,1,0.0%,14m
36816,1,Firechrome,2253,73,0,5,5,0.0%,3h
36852,2,BlackMetal,2252,1513,239,251,490,48.8%,55m
36852,1,TreeSteamer,2252,957,99,92,191,51.8%,3h
36852,2,terran,2252,970,92,96,188,48.9%,47m
36852,1,Ace,2252,1601,66,80,146,45.2%,38m
36852,1,EpikFrost,2252,1088,37,47,84,44.0%,3h
36852,1,seCure,2252,1058,36,34,70,51.4%,3m
36852,3,[MaxWin]Watain,2252,388,24,33,57,42.1%,20m
36852,1,[JueCas]jcze,2252,412,12,8,20,60.0%,3m
36852,1,Guardian,2252,458,12,16,28,42.9%,36m
36852,1,ThisbeKline,2252,352,9,10,19,47.4%,1h
36852,1,SpartaKevin,2252,314,8,8,16,50.0%,1h
36852,1,[Cind3r]smirnoft,2252,182,8,10,18,44.4%,30m
36852,2,EndersisxEW,2252,192,6,2,8,75.0%,54m
36852,3,NakeDwarfGuy,2252,120,6,16,22,27.3%,3m
36852,2,Atmetcalf,2252,123,4,9,13,30.8%,59m
36852,1,[DaPeep]DarkBullet,2252,145,3,4,7,42.9%,7m
36852,1,LAGT,2252,96,3,4,7,42.9%,35m
36852,1,Monte,2252,97,3,8,11,27.3%,16m
36852,1,UNDERTAKER,2252,94,2,4,6,33.3%,40m
36852,1,Jango,2252,54,2,4,6,33.3%,56m
36852,3,Explicit,2252,97,2,6,8,25.0%,5m
36852,2,ThisGuy,2252,0,1,4,5,20.0%,1h
36852,1,SmoteurGoat,2252,0,1,5,6,16.7%,30m
36852,1,StorminAppSt,2252,0,1,5,6,16.7%,3h
36852,3,GoatsMaToats,2252,95,1,7,8,12.5%,31m
36852,1,Xavier,2252,0,0,1,1,0.0%,1h
36852,1,kurt,2252,0,0,1,1,0.0%,46m
36852,1,Vodafone,2252,0,0,2,2,0.0%,1h
36880,1,solidvhero,2251,1833,222,219,441,50.3%,59m
36880,1,Wayne,2251,1822,153,154,307,49.8%,1h
36880,3,Auxesys,2251,1233,80,79,159,50.3%,34m
36880,1,atlbraves,2251,714,63,62,125,50.4%,3h
36880,1,Kjot,2251,1589,60,54,114,52.6%,40m
36880,1,MarcosT,2251,1780,60,66,126,47.6%,45m
36880,3,DaftTank,2251,1023,47,55,102,46.1%,1h
36880,1,[Metric]SkyLighter,2251,818,35,23,58,60.3%,1h
36880,1,GrooveDrBoom,2251,1064,32,35,67,47.8%,3h
36880,2,iPotatoes,2251,487,31,39,70,44.3%,1h
36880,1,[TMKOs]Chasky,2251,469,14,14,28,50.0%,1h
36880,1,zerging,2251,353,12,9,21,57.1%,13m
36880,3,zaiken,2251,385,12,15,27,44.4%,1h
36880,1,[ZOMO]Edu,2251,332,12,19,31,38.7%,3h
36880,1,darkside,2251,208,7,5,12,58.3%,3h
36880,1,[ybhapp]yuhappy,2251,235,7,7,14,50.0%,1h
36880,1,DLaw,2251,202,6,6,12,50.0%,3h
36880,3,[FaZePF]OGMudbone,2251,152,6,15,21,28.6%,1h
36880,1,[SCX2]EduAlphaCH,2251,166,4,5,9,44.4%,3h
36880,3,Locoloco,2251,169,4,5,9,44.4%,12m
36880,3,Kirbyay,2251,124,3,8,11,27.3%,1h
36880,1,coffee,2251,0,2,4,6,33.3%,1h
36880,1,sambi,2251,38,2,5,7,28.6%,3h
36880,1,nameless,2251,0,2,5,7,28.6%,1h
36880,1,Slith,2251,94,2,5,7,28.6%,43m
36880,1,HaloTach,2251,0,1,1,2,50.0%,31m
36880,1,[1TL]Simbaa,2251,0,1,1,2,50.0%,29m
36880,1,SnakeEyes,2251,0,1,1,2,50.0%,57m
36880,1,LifeInsense,2251,0,1,5,6,16.7%,46m
36880,3,yomomyoface,2251,0,1,7,8,12.5%,25m
36880,1,Ocelot,2251,0,0,1,1,0.0%,9m
36880,1,SolArgenti,2251,0,0,1,1,0.0%,3h
36880,2,Loz,2251,0,0,1,1,0.0%,1h
36880,1,HDRePaNdIDrO,2251,0,0,2,2,0.0%,21m
36880,1,rankin,2251,0,0,4,4,0.0%,5m
36915,3,Felix,2250,1576,234,236,470,49.8%,1h
36915,1,Corndog,2250,1836,105,102,207,50.7%,1h
36915,1,LetsDoThis,2250,1624,96,95,191,50.3%,1h
36915,3,[Jok3r]harsky,2250,1207,86,83,169,50.9%,3h
36915,2,BlackSoul,2250,1416,66,80,146,45.2%,1h
36915,2,otaking,2250,679,43,57,100,43.0%,3h
36915,1,Skyywalkerr,2250,939,37,36,73,50.7%,14m
36915,1,Raynor,2250,808,31,22,53,58.5%,3h
36915,3,Soulless,2250,705,23,31,54,42.6%,49m
36915,1,Ohanamontana,2250,714,21,24,45,46.7%,55m
36915,1,GAOLANG,2250,536,20,17,37,54.1%,1h
36915,1,kirally,2250,600,17,19,36,47.2%,52m
36915,1,[AbcCo]Lionx,2250,361,16,10,26,61.5%,31m
36915,1,[RELAX]SensaiFISH,2250,394,15,17,32,46.9%,1h
36915,1,[TGosuA]Halcyonic,2250,604,15,23,38,39.5%,3h
36915,1,VINCENTVLOGS,2250,438,13,18,31,41.9%,22m
36915,1,Drone,2250,400,11,12,23,47.8%,6m
36915,1,Bobby,2250,205,8,10,18,44.4%,1h
36915,3,AiaraTech,2250,146,7,11,18,38.9%,1h
36915,1,Vownstille,2250,227,6,4,10,60.0%,3h
36915,1,Zodiac,2250,204,6,6,12,50.0%,1h
36915,1,[Incan]Lefty,2250,188,6,9,15,40.0%,58m
36915,3,Tuz,2250,148,6,12,18,33.3%,14m
36915,3,AirForceOne,2250,183,5,11,16,31.2%,1h
36915,3,JIMBO,2250,134,4,1,5,80.0%,14m
36915,1,Warlord,2250,126,4,3,7,57.1%,2m
36915,1,PST,2250,131,3,0,3,100.0%,43m
36915,1,Marvelous,2250,84,3,3,6,50.0%,30m
36915,3,BobbyBunz,2250,58,3,8,11,27.3%,1h
36915,1,Speltz,2250,40,2,1,3,66.7%,1h
36915,1,sawer,2250,30,2,1,3,66.7%,1h
36915,1,AshyLarry,2250,42,2,1,3,66.7%,3h
36915,1,Ascendacy,2250,80,2,2,4,50.0%,1h
36915,1,Ironman,2250,97,2,5,7,28.6%,10m
36915,3,Bahra,2250,97,2,7,9,22.2%,3m
36915,1,Fiigue,2250,0,1,0,1,100.0%,1h
36915,1,suchpro,2250,0,1,2,3,33.3%,3h
36915,1,EruX,2250,0,1,5,6,16.7%,3h
36915,3,[L0EG]GeTheFunkOut,2250,97,1,6,7,14.3%,38m
36915,1,Khal,2250,0,1,6,7,14.3%,1h
36915,3,Sonny,2250,0,1,6,7,14.3%,6m
36915,1,BrianLaw,2250,0,0,1,1,0.0%,16m
36915,1,[MDNG]Wolfpapa,2250,0,0,2,2,0.0%,1h
36915,1,AvalonPrince,2250,0,0,2,2,0.0%,3h
36959,2,Vicsam,2249,1535,115,121,236,48.7%,1h
36959,1,Lystat,2249,1102,95,82,177,53.7%,3h
36959,3,KDIN,2249,1199,88,82,170,51.8%,1h
36959,1,Snipu,2249,1588,65,60,125,52.0%,50m
36959,1,Empire,2249,1128,42,34,76,55.3%,59m
36959,2,ICE,2249,914,33,42,75,44.0%,1h
36959,3,Lunchbox,2249,634,21,32,53,39.6%,1h
36959,1,RaithSensei,2249,321,18,10,28,64.3%,22m
36959,1,[SCGals]Karen,2249,515,17,15,32,53.1%,1h
36959,3,DDan,2249,444,16,26,42,38.1%,3h
36959,1,Mongke,2249,572,14,16,30,46.7%,50m
36959,1,Jeffreysz,2249,329,9,13,22,40.9%,1h
36959,3,[M82XS]XPULSAR,2249,226,7,18,25,28.0%,1h
36959,1,arq,2249,139,4,9,13,30.8%,59m
36959,3,BtkWarmBlood,2249,64,4,10,14,28.6%,12m
36959,1,[SDTL]HellDragon,2249,172,4,11,15,26.7%,2m
36959,1,Armagedon,2249,70,3,6,9,33.3%,1h
36959,1,Tpum,2249,86,2,2,4,50.0%,1h
36959,1,CRYP,2249,73,2,5,7,28.6%,3h
36959,1,EadG,2249,0,1,0,1,100.0%,3h
36959,1,ColMustard,2249,0,1,1,2,50.0%,39m
36959,3,LargePizza,2249,97,1,2,3,33.3%,25m
36959,1,[ZTemps]Tengu,2249,42,1,2,3,33.3%,31m
36959,1,[TERRlS]Pdubbsss,2249,0,1,3,4,25.0%,23m
36959,1,Ycaster,2249,0,1,5,6,16.7%,3h
36959,1,torro,2249,36,1,7,8,12.5%,3h
36959,1,thumper,2249,0,0,1,1,0.0%,27m
36959,1,DanTheDrone,2249,0,0,1,1,0.0%,34m
36987,3,KMU,2248,1549,135,129,264,51.1%,3h
36987,1,dhuangal,2248,986,81,85,166,48.8%,1h
36987,1,Leonides,2248,746,57,49,106,53.8%,22m
36987,1,delve,2248,1353,50,53,103,48.5%,1h
36987,1,Ángel,2248,966,34,30,64,53.1%,45m
36987,3,athelric,2248,689,27,37,64,42.2%,28m
36987,1,Deado,2248,540,21,16,37,56.8%,6m
36987,1,ZergWorm,2248,688,20,20,40,50.0%,50m
36987,3,SilkySmooth,2248,400,16,24,40,40.0%,3m
36987,3,ThiefOfEden,2248,299,10,16,26,38.5%,1h
36987,1,Apolum,2248,310,9,13,22,40.9%,3h
36987,1,caballero,2248,272,8,7,15,53.3%,3h
36987,1,james,2248,193,7,4,11,63.6%,45m
36987,1,Viper,2248,269,7,11,18,38.9%,22m
36987,1,Zentrix,2248,234,6,7,13,46.2%,1h
36987,1,DYSON,2248,156,4,4,8,50.0%,4m
36987,1,Booger,2248,126,4,7,11,36.4%,3h
36987,1,Maverick,2248,96,3,6,9,33.3%,1h
36987,1,THEHUNYT,2248,0,1,0,1,100.0%,3h
36987,1,[LOHe]Overlord,2248,0,1,3,4,25.0%,1h
36987,1,LazyTitan,2248,0,1,3,4,25.0%,1h
36987,1,karimjp,2248,42,1,4,5,20.0%,4m
36987,1,Tootsfamous,2248,40,1,7,8,12.5%,57m
36987,1,kstein,2248,0,0,1,1,0.0%,1h
36987,1,Alexginames,2248,0,0,3,3,0.0%,1h
36987,3,stickineye,2248,0,0,4,4,0.0%,27m
37013,1,XJXSX,2247,1792,131,128,259,50.6%,1h
37013,3,GameChanger,2247,616,80,86,166,48.2%,1h
37013,1,COVID,2247,1821,74,70,144,51.4%,3h
37013,1,Xact,2247,1013,39,42,81,48.1%,3h
37013,1,Unpluks,2247,1048,35,36,71,49.3%,3h
37013,1,Merodomax,2247,437,27,24,51,52.9%,21m
37013,1,PenguinsRflu,2247,562,27,25,52,51.9%,37m
37013,1,Emau,2247,631,23,19,42,54.8%,42m
37013,1,Turtlecrunch,2247,710,22,24,46,47.8%,46m
37013,1,Tigerbombz,2247,437,20,8,28,71.4%,50m
37013,1,WarDrum,2247,423,14,10,24,58.3%,1h
37013,3,chuckforest,2247,354,14,20,34,41.2%,1h
37013,1,Lexicom,2247,452,13,15,28,46.4%,48m
37013,1,Stock,2247,394,11,11,22,50.0%,1h
37013,1,[bich0]hOrmighOst,2247,204,8,0,8,100.0%,1m
37013,1,KIRITO,2247,265,7,6,13,53.8%,3h
37013,1,papitafrita,2247,240,6,10,16,37.5%,3h
37013,2,Ray,2247,116,6,10,16,37.5%,1h
37013,1,Yesselm,2247,236,6,11,17,35.3%,50m
37013,1,CaptHysteria,2247,62,6,12,18,33.3%,42m
37013,1,Spiraling,2247,194,6,12,18,33.3%,43m
37013,1,creedence,2247,164,5,8,13,38.5%,1h
37013,1,SmallFrog,2247,198,5,10,15,33.3%,6m
37013,1,careta,2247,128,4,7,11,36.4%,1h
37013,3,EDonKillah,2247,156,4,11,15,26.7%,48m
37013,1,Jake,2247,122,3,1,4,75.0%,48m
37013,1,RaynorII,2247,84,3,5,8,37.5%,3h
37013,1,[TNOSc2]MARQUIUS,2247,82,2,2,4,50.0%,3h
37013,1,[OPGame]SoFX,2247,42,2,3,5,40.0%,11m
37013,1,BATTLEMASTER,2247,0,1,3,4,25.0%,58m
37013,1,[MARV3L]dreddllama,2247,40,1,4,5,20.0%,1h
37013,1,[beebo]SadJewish,2247,0,1,4,5,20.0%,37m
37013,1,ProMetheus,2247,0,1,5,6,16.7%,3h
37013,3,forhead,2247,30,1,5,6,16.7%,21m
37013,3,cheeseman,2247,0,1,6,7,14.3%,1h
37013,1,ReaperActual,2247,0,0,2,2,0.0%,52m
37013,1,PSIONIC,2247,0,0,5,5,0.0%,3h
37050,1,arthur,2246,1301,88,82,170,51.8%,3h
37050,1,hello,2246,1712,64,71,135,47.4%,1h
37050,3,Rschacko,2246,1148,44,43,87,50.6%,1h
37050,1,TuPapi,2246,961,33,28,61,54.1%,26m
37050,2,DrakinClaw,2246,586,32,38,70,45.7%,29m
37050,3,[Z4RA]YoucefM,2246,800,29,34,63,46.0%,10m
37050,1,manyvii,2246,915,27,30,57,47.4%,52m
37050,2,NicRaph,2246,560,19,27,46,41.3%,36m
37050,1,AngelofDeath,2246,258,10,10,20,50.0%,3h
37050,3,McKrashy,2246,252,8,18,26,30.8%,13m
37050,1,HoneyReeRee,2246,278,7,11,18,38.9%,3h
37050,1,Paingolin,2246,202,6,5,11,54.5%,3h
37050,1,terranmaster,2246,158,4,5,9,44.4%,3h
37050,1,[ITH]loth,2246,0,3,4,7,42.9%,3h
37050,1,Deeznuts,2246,120,3,4,7,42.9%,40m
37050,1,FaRiZeUS,2246,120,3,6,9,33.3%,1h
37050,1,kingapple,2246,84,2,5,7,28.6%,59m
37050,1,YazUro,2246,0,1,0,1,100.0%,1h
37050,1,Harmmynee,2246,0,1,1,2,50.0%,3h
37050,1,Flex,2246,0,1,2,3,33.3%,3h
37050,1,Saphire,2246,0,1,5,6,16.7%,5m
37050,1,Abacoot,2246,48,1,8,9,11.1%,40m
37050,1,[TGosuD]Beetlejuice,2246,0,0,1,1,0.0%,3h
37050,1,NEOMATRIX,2246,0,0,1,1,0.0%,3h
37050,2,Papagal,2246,0,0,1,1,0.0%,3h
37050,1,Renobymkus,2246,0,0,2,2,0.0%,21m
37050,3,[FASTR]NETFER,2246,0,0,3,3,0.0%,1h
37050,3,ion,2246,0,0,3,3,0.0%,1h
37050,3,interLTU,2246,0,0,3,3,0.0%,1h
37050,1,DrColossus,2246,0,0,5,5,0.0%,1h
37080,3,AurelioMax,2245,1517,210,214,424,49.5%,1h
37080,1,tchulo,2245,1816,176,188,364,48.4%,7m
37080,3,Zeno,2245,920,175,170,345,50.7%,1h
37080,3,kreestoff,2245,1446,175,173,348,50.3%,1h
37080,1,chris,2245,1334,135,126,261,51.7%,3h
37080,1,GLOOSH,2245,1380,103,103,206,50.0%,50m
37080,1,MyQuil,2245,1538,93,93,186,50.0%,2m
37080,1,EdstaphX,2245,1016,43,37,80,53.8%,49m
37080,1,[SWOU]spartanops,2245,944,40,21,61,65.6%,59m
37080,3,Heener,2245,914,32,39,71,45.1%,1h
37080,1,Jaefcope,2245,711,28,21,49,57.1%,31m
37080,1,PhoenixBalls,2245,654,22,27,49,44.9%,1h
37080,1,Kevincito,2245,518,17,14,31,54.8%,1h
37080,1,Diegorodri,2245,570,16,16,32,50.0%,50m
37080,1,Serials,2245,329,13,4,17,76.5%,34m
37080,1,CaptScar,2245,331,13,24,37,35.1%,1h
37080,1,MammaDuck,2245,424,12,14,26,46.2%,1h
37080,1,Maromar,2245,446,11,16,27,40.7%,3h
37080,3,Alexangel,2245,243,8,10,18,44.4%,1h
37080,3,[CovT]Elbatro,2245,154,8,15,23,34.8%,28m
37080,1,[EpicG]tupapichulo,2245,227,7,2,9,77.8%,1h
37080,1,[BigMcS]Opaloso,2245,156,4,1,5,80.0%,3h
37080,3,illy,2245,174,4,5,9,44.4%,1h
37080,1,[Astute]Mago,2245,217,4,5,9,44.4%,3h
37080,1,[Ex0n]iveseenbiggr,2245,84,3,2,5,60.0%,4m
37080,1,acmunpt,2245,0,3,3,6,50.0%,30m
37080,1,WilliamRiker,2245,48,3,5,8,37.5%,5m
37080,3,snugglepuss,2245,97,3,7,10,30.0%,30m
37080,1,penguin,2245,120,2,5,7,28.6%,5m
37080,1,SlimShocky,2245,46,2,5,7,28.6%,1m
37080,1,PantherX,2245,73,2,7,9,22.2%,3h
37080,1,ale,2245,0,1,1,2,50.0%,1h
37080,1,SwtSasMolass,2245,40,1,3,4,25.0%,34m
37080,2,Badgerfoot,2245,0,1,4,5,20.0%,1h
37080,1,Reorx,2245,0,1,5,6,16.7%,5m
37080,1,PizziaRolls,2245,0,0,1,1,0.0%,1h
37080,1,prosorsmash,2245,0,0,1,1,0.0%,22m
37080,2,Todynho,2245,0,0,1,1,0.0%,55m
37080,1,[cluez]THEBIGPOPPA,2245,0,0,2,2,0.0%,3h
37119,1,kayo,2244,1430,73,61,134,54.5%,1h
37119,1,Mickdedley,2244,1168,58,49,107,54.2%,1h
37119,2,Burrito,2244,1282,50,56,106,47.2%,3h
37119,1,ROOT,2244,1346,45,49,94,47.9%,31m
37119,1,[GCH]Smoke,2244,600,20,20,40,50.0%,1h
37119,1,Bonus,2244,676,19,22,41,46.3%,3h
37119,1,ChrisWhyTY,2244,516,15,15,30,50.0%,50m
37119,1,Stoltis,2244,473,14,10,24,58.3%,3h
37119,3,Starlord,2244,332,11,25,36,30.6%,1h
37119,1,[5689]darwar,2244,246,8,2,10,80.0%,3h
37119,1,[Groovy]eryo,2244,211,8,6,14,57.1%,3h
37119,1,BobTheKiller,2244,222,8,9,17,47.1%,3h
37119,2,Korya,2244,223,8,15,23,34.8%,3h
37119,3,Church,2244,146,6,7,13,46.2%,3h
37119,1,MeeMeeSiku,2244,212,6,12,18,33.3%,10m
37119,1,MercilesTrol,2244,134,5,5,10,50.0%,3h
37119,1,prokion,2244,160,4,2,6,66.7%,1h
37119,3,[C4NN0N]Conspiracy,2244,94,4,5,9,44.4%,1h
37119,1,[bfBE]neochild,2244,191,4,7,11,36.4%,3h
37119,3,madskittles,2244,58,3,0,3,100.0%,1m
37119,3,ChoachOhhh,2244,30,3,7,10,30.0%,36m
37119,1,traktat,2244,90,3,8,11,27.3%,43m
37119,3,Kenkilla,2244,86,3,12,15,20.0%,2m
37119,2,[Shardz]Shade,2244,88,2,0,2,100.0%,3h
37119,1,Bryson,2244,48,2,4,6,33.3%,3h
37119,1,estamos,2244,130,2,6,8,25.0%,43m
37119,1,Bennabus,2244,48,2,7,9,22.2%,26m
37119,1,jackreyson,2244,0,1,0,1,100.0%,50m
37119,1,BigBlackBob,2244,0,0,1,1,0.0%,14m
37119,1,[NM8]XcrixosX,2244,0,0,1,1,0.0%,3h
37119,1,[TCRPAF]Redfield,2244,73,0,2,2,0.0%,1h
37150,1,Serenity,2243,1532,432,438,870,49.7%,3h
37150,1,qamay,2243,1213,173,164,337,51.3%,25m
37150,1,Quantum,2243,649,157,165,322,48.8%,56m
37150,1,Star,2243,1407,127,108,235,54.0%,3h
37150,1,MULE,2243,1544,110,93,203,54.2%,1h
37150,1,eagleselfs,2243,1117,92,84,176,52.3%,3h
37150,3,[SGK1]HineyKin,2243,1042,65,64,129,50.4%,41m
37150,3,ilikeladies,2243,1294,54,60,114,47.4%,40m
37150,1,Bruno,2243,1297,46,42,88,52.3%,3h
37150,1,[AoE3]UncleTongi,2243,1238,42,46,88,47.7%,43m
37150,1,CreamFart,2243,832,35,26,61,57.4%,1h
37150,1,NemV,2243,782,31,28,59,52.5%,22m
37150,1,SEAN,2243,828,30,21,51,58.8%,1h
37150,1,NKtealc,2243,347,12,11,23,52.2%,16m
37150,1,Gunther,2243,250,12,21,33,36.4%,3h
37150,1,[Wesye]Wesye,2243,436,11,18,29,37.9%,3h
37150,1,fascinateOCE,2243,314,10,15,25,40.0%,3h
37150,1,[TFTG]Heven,2243,287,9,8,17,52.9%,50m
37150,1,Fisher,2243,246,9,9,18,50.0%,1h
37150,1,emmademon,2243,212,7,3,10,70.0%,3h
37150,1,LUCIFER,2243,343,7,18,25,28.0%,3h
37150,1,Bnjo,2243,240,6,2,8,75.0%,55m
37150,2,spyder,2243,182,5,8,13,38.5%,6m
37150,3,raphaelblg,2243,207,5,10,15,33.3%,14m
37150,1,Girth,2243,88,3,2,5,60.0%,10m
37150,1,[TnyPns]Hall,2243,124,3,5,8,37.5%,3h
37150,1,Nano,2243,124,3,7,10,30.0%,50m
37150,1,rocker,2243,44,2,0,2,100.0%,1h
37150,3,Dey,2243,97,2,6,8,25.0%,42m
37150,2,Lunar,2243,0,1,3,4,25.0%,1h
37150,1,[SSC]DeepWade,2243,0,1,4,5,20.0%,1h
37150,2,[WOTG]LomoSaltado,2243,0,0,1,1,0.0%,1h
37182,3,LeroyBoy,2242,1525,186,193,379,49.1%,20m
37182,2,Darius,2242,1201,95,106,201,47.3%,41m
37182,1,bEkAchI,2242,1550,91,107,198,46.0%,53m
37182,3,JoseAbel,2242,988,41,41,82,50.0%,1m
37182,1,zegs,2242,882,31,31,62,50.0%,3h
37182,1,monku,2242,666,23,24,47,48.9%,3h
37182,3,Mugger,2242,603,21,24,45,46.7%,1h
37182,1,Skyspartan,2242,374,11,11,22,50.0%,3m
37182,1,Suunnn,2242,272,11,16,27,40.7%,3h
37182,2,[CamP]FocustManiac,2242,124,7,13,20,35.0%,1h
37182,3,Skrii,2242,85,4,7,11,36.4%,3h
37182,1,Syyrup,2242,127,3,1,4,75.0%,34m
37182,1,HashPoppers,2242,0,3,3,6,50.0%,5m
37182,1,Demon,2242,124,3,4,7,42.9%,3h
37182,1,RoyalChief,2242,97,2,1,3,66.7%,1h
37182,1,[xHTx]FenixOfWar,2242,38,2,3,5,40.0%,39m
37182,1,moridinamael,2242,40,2,3,5,40.0%,1h
37182,1,ZehWallace,2242,86,2,7,9,22.2%,3h
37182,1,Osisi,2242,95,1,1,2,50.0%,1h
37182,1,[Oopsy]ZeeWes,2242,42,1,2,3,33.3%,1h
37182,1,Ateamplayer,2242,48,1,3,4,25.0%,1h
37182,3,shepeard,2242,0,1,3,4,25.0%,1h
37182,1,SecondPlanB,2242,0,1,4,5,20.0%,21m
37182,1,[CHlMP]Fluke,2242,42,1,5,6,16.7%,3h
37182,1,[Kunz]MElegend,2242,73,1,11,12,8.3%,14m
37182,1,Prodigy,2242,0,0,1,1,0.0%,1h
37182,2,Kryoschdr,2242,0,0,1,1,0.0%,48m
37182,1,OSTILIN,2242,0,0,1,1,0.0%,3h
37210,1,[BNITOS]dkchalo,2241,1728,153,148,301,50.8%,46m
37210,1,DaBi,2241,1678,82,84,166,49.4%,3h
37210,1,claudiioo,2241,1815,76,73,149,51.0%,1h
37210,3,PUZZYSLAYR,2241,1198,68,72,140,48.6%,22m
37210,3,Mijail,2241,1513,63,56,119,52.9%,1h
37210,1,TIBURONCIN,2241,1030,52,49,101,51.5%,1h
37210,3,[raaa]BlackSoul,2241,1326,48,59,107,44.9%,18m
37210,1,DavetheGreat,2241,1215,43,40,83,51.8%,3h
37210,1,Orca,2241,786,22,25,47,46.8%,4m
37210,1,CocoJones,2241,480,19,15,34,55.9%,3m
37210,1,KNOLLMEXICO,2241,594,19,17,36,52.8%,3h
37210,1,Frozz,2241,532,14,23,37,37.8%,1h
37210,2,Chuck,2241,412,13,29,42,31.0%,3h
37210,1,MartyMcFly,2241,369,9,12,21,42.9%,31m
37210,3,Jeef,2241,248,8,9,17,47.1%,3h
37210,1,[GOPERÚ]TheBest,2241,207,7,9,16,43.8%,58m
37210,1,[ØÛ]greedxgraff,2241,164,6,7,13,46.2%,1h
37210,1,[warwar]radzinger,2241,166,5,5,10,50.0%,1h
37210,1,Cell,2241,160,5,8,13,38.5%,1h
37210,1,PackerBack,2241,114,4,2,6,66.7%,3h
37210,1,Havok,2241,162,4,5,9,44.4%,1h
37210,3,Bugachug,2241,92,4,12,16,25.0%,56m
37210,1,[LaOr]CacoAdodo,2241,82,3,3,6,50.0%,1h
37210,1,[qu]XxKqwertyxX,2241,36,2,1,3,66.7%,22m
37210,1,CYLEO,2241,40,2,3,5,40.0%,58m
37210,1,Wolfgaru,2241,48,2,6,8,25.0%,1h
37210,1,Jaxom,2241,48,2,6,8,25.0%,3m
37210,3,Tauntilus,2241,0,2,8,10,20.0%,1h
37210,3,TaiQi,2241,97,1,1,2,50.0%,48m
37210,3,samuel,2241,0,1,6,7,14.3%,3h
37210,1,SMH,2241,0,0,1,1,0.0%,43m
37210,1,Bellzybub,2241,0,0,2,2,0.0%,1h
37242,1,Sincityflip,2240,1643,322,332,654,49.2%,1h
37242,2,SnakeEyes,2240,1609,135,133,268,50.4%,10m
37242,2,[SWOU]Leocadione,2240,1542,121,116,237,51.1%,1h
37242,1,MachineGon,2240,1375,62,60,122,50.8%,50m
37242,2,Ronin,2240,995,56,56,112,50.0%,3h
37242,1,[LgnTDS]KIRI,2240,926,31,26,57,54.4%,3h
37242,2,EucaliptoSor,2240,718,27,46,73,37.0%,7m
37242,1,ChanclaLetal,2240,672,22,25,47,46.8%,58m
37242,1,[DarkAG]Ocelot,2240,571,21,14,35,60.0%,50m
37242,2,LoneWolf,2240,589,21,27,48,43.8%,42m
37242,1,JuneBug,2240,626,19,23,42,45.2%,1h
37242,3,Joseph,2240,482,17,24,41,41.5%,1h
37242,1,Donkey,2240,390,13,13,26,50.0%,3h
37242,1,TheGuy,2240,351,10,15,25,40.0%,50m
37242,1,Dekar,2240,311,10,16,26,38.5%,6m
37242,3,ozuwarudo,2240,280,10,19,29,34.5%,1h
37242,1,zherem,2240,269,7,8,15,46.7%,2m
37242,3,senjo,2240,175,5,6,11,45.5%,1h
37242,1,TakingSouls,2240,212,5,11,16,31.2%,3h
37242,3,DRAGONMASTER,2240,0,4,4,8,50.0%,18m
37242,1,ACE,2240,148,4,8,12,33.3%,16m
37242,1,Beowulf,2240,166,4,12,16,25.0%,34m
37242,3,YouLoveMuta,2240,140,4,30,34,11.8%,6m
37242,1,NuKeHappY,2240,96,3,6,9,33.3%,3h
37242,3,decapitador,2240,30,2,0,2,100.0%,25m
37242,1,[FAPFAP]JJBarea,2240,42,2,0,2,100.0%,30m
37242,1,PNTROMAN,2240,48,2,2,4,50.0%,15m
37242,1,Scarbruh,2240,96,2,5,7,28.6%,3h
37242,1,DJWHALE,2240,0,2,5,7,28.6%,7m
37242,1,GolasRushGod,2240,102,2,5,7,28.6%,3h
37242,1,[DXPCA]Sebastian,2240,97,2,6,8,25.0%,3h
37242,1,Odin,2240,0,1,0,1,100.0%,39m
37242,1,EARNEST,2240,0,1,0,1,100.0%,1h
37242,1,Layer,2240,38,1,2,3,33.3%,1h
37242,1,sim,2240,42,1,2,3,33.3%,52m
37242,1,Wreckon,2240,0,1,5,6,16.7%,3h
37242,1,ZGL,2240,0,1,6,7,14.3%,1h
37242,2,atnssn,2240,0,0,1,1,0.0%,3h
37242,1,JoseMunoz,2240,0,0,1,1,0.0%,1h
37242,3,StompinTom,2240,0,0,9,9,0.0%,3h
37282,3,Tonydarklee,2239,1552,182,186,368,49.5%,3h
37282,1,Elyzium,2239,1752,90,94,184,48.9%,1h
37282,1,IIIIIIIIIIII,2239,1698,79,86,165,47.9%,39m
37282,3,[ExcIgN]ferand,2239,1363,56,60,116,48.3%,1h
37282,1,Dally,2239,959,30,29,59,50.8%,41m
37282,1,bobin,2239,656,26,21,47,55.3%,50m
37282,1,Austinpowas,2239,537,25,24,49,51.0%,3h
37282,1,Snowbllind,2239,694,24,20,44,54.5%,1h
37282,1,ItachiUchiha,2239,612,24,26,50,48.0%,3h
37282,1,[RE34]MinH,2239,524,18,18,36,50.0%,3h
37282,1,Malignus,2239,231,10,7,17,58.8%,3h
37282,1,Jeong,2239,338,10,8,18,55.6%,21m
37282,1,cheekywanker,2239,275,9,9,18,50.0%,3h
37282,2,Botswaa,2239,140,5,9,14,35.7%,10m
37282,1,karmel,2239,159,4,2,6,66.7%,3h
37282,3,ToasterBomb,2239,30,2,1,3,66.7%,21m
37282,1,KMPLT,2239,82,2,5,7,28.6%,3h
37282,1,Bruuh,2239,0,1,0,1,100.0%,1h
37282,1,[Vulk]Jymix,2239,40,1,2,3,33.3%,3h
37282,1,BuffTerran,2239,42,1,2,3,33.3%,50m
37282,1,Switchy,2239,36,1,3,4,25.0%,1h
37282,1,[NoVaNA]Kyand,2239,0,1,4,5,20.0%,51m
37282,1,slappy,2239,96,1,5,6,16.7%,51m
37282,1,ClanMclaren,2239,0,1,5,6,16.7%,16m
37282,3,[GhoSTL]CONCAT,2239,30,1,11,12,8.3%,2m
37282,1,xlPinheadlx,2239,0,0,1,1,0.0%,3h
37282,1,TITAN,2239,0,0,1,1,0.0%,1h
37282,1,[Exper]miguel,2239,0,0,2,2,0.0%,3h
37310,1,BadaBadaBoom,2238,1376,130,135,265,49.1%,59m
37310,1,RiUk,2238,1441,52,46,98,53.1%,3h
37310,3,[orgNES]jObLessVoid,2238,304,51,53,104,49.0%,12m
37310,1,exogram,2238,1130,36,39,75,48.0%,3h
37310,1,chikinita,2238,832,31,22,53,58.5%,31m
37310,1,Gnkku,2238,554,25,24,49,51.0%,1h
37310,1,Killstatic,2238,758,22,22,44,50.0%,50m
37310,1,Rick,2238,548,19,19,38,50.0%,22m
37310,1,DarsZ,2238,554,16,18,34,47.1%,1h
37310,1,JUAN,2238,376,11,13,24,45.8%,3h
37310,3,twothercanoe,2238,229,9,10,19,47.4%,1h
37310,1,edtravs,2238,388,9,10,19,47.4%,3h
37310,1,jsn,2238,240,7,10,17,41.2%,3h
37310,3,AlexanderNoe,2238,129,4,3,7,57.1%,33m
37310,1,MaNinjaCockL,2238,124,4,5,9,44.4%,37m
37310,1,CroKwiT,2238,144,4,8,12,33.3%,1h
37310,1,Rhythmis,2238,144,4,9,13,30.8%,26m
37310,3,[NeAs]Zippo,2238,90,4,10,14,28.6%,7m
37310,1,StyleBender,2238,40,2,6,8,25.0%,3h
37310,3,Lunomis,2238,0,1,1,2,50.0%,1h
37310,3,AlvisTurner,2238,30,1,2,3,33.3%,3h
37310,3,Butts,2238,0,1,4,5,20.0%,6m
37310,1,BDFP,2238,0,1,5,6,16.7%,40m
37310,1,HolleezeFan,2238,0,1,5,6,16.7%,43m
37310,1,kirito,2238,0,0,1,1,0.0%,41m
37310,1,Lunchtime,2238,0,0,2,2,0.0%,31m
37310,1,Jose,2238,0,0,3,3,0.0%,3h
37310,2,Duckey,2238,0,0,4,4,0.0%,60m
37310,3,HashManz,2238,0,0,7,7,0.0%,1h
37339,1,[DAJ]jasonhoblin,2237,1800,118,121,239,49.4%,1h
37339,1,[xAK7x]Carlangas,2237,1398,56,55,111,50.5%,1h
37339,3,fingermagic,2237,1231,56,61,117,47.9%,1h
37339,2,MASTERSUPLI,2237,1195,47,52,99,47.5%,10m
37339,1,exile,2237,583,30,26,56,53.6%,4m
37339,1,FrancoXD,2237,628,27,18,45,60.0%,1h
37339,1,[CKG]Aprendiz,2237,706,21,26,47,44.7%,3h
37339,1,[MCAD]marver,2237,561,17,19,36,47.2%,3h
37339,1,oldRon,2237,318,9,6,15,60.0%,3h
37339,1,Tony,2237,198,5,5,10,50.0%,34m
37339,3,bubytrap,2237,122,4,4,8,50.0%,23m
37339,1,Ratakiller,2237,0,3,2,5,60.0%,50m
37339,3,lazy,2237,121,3,4,7,42.9%,3h
37339,1,McMinn,2237,122,3,5,8,37.5%,40m
37339,1,bobflintlock,2237,42,2,1,3,66.7%,3h
37339,1,elxmemo,2237,97,2,3,5,40.0%,1h
37339,2,MORTAL,2237,46,2,5,7,28.6%,1h
37339,1,laze,2237,73,1,1,2,50.0%,46m
37339,1,Araddon,2237,0,1,4,5,20.0%,1h
37339,1,Veronika,2237,0,1,5,6,16.7%,35m
37339,1,Bug,2237,0,1,5,6,16.7%,43m
37339,1,secrets,2237,44,1,5,6,16.7%,16m
37339,2,MussoliniArc,2237,0,0,1,1,0.0%,1h
37339,1,TerranUrAss,2237,0,0,2,2,0.0%,46m
37363,1,HardyGV,2236,1518,65,46,111,58.6%,3h
37363,1,datyfist,2236,673,47,38,85,55.3%,3h
37363,1,manuel,2236,1095,46,21,67,68.7%,58m
37363,1,Duckwhite,2236,357,33,25,58,56.9%,10m
37363,1,[HMLESS]TeddyBear,2236,586,20,17,37,54.1%,3h
37363,1,RodryGO,2236,430,13,14,27,48.1%,1h
37363,1,Peach,2236,332,8,7,15,53.3%,46m
37363,3,vodkaAcidiC,2236,237,7,5,12,58.3%,48m
37363,1,GoodFella,2236,170,6,6,12,50.0%,1h
37363,2,Drock,2236,80,6,9,15,40.0%,1h
37363,1,HelenKiller,2236,202,5,6,11,45.5%,3h
37363,1,Phthalo,2236,154,5,7,12,41.7%,1h
37363,1,DankGreens,2236,164,5,8,13,38.5%,57m
37363,3,karambolauwu,2236,170,5,10,15,33.3%,38m
37363,1,[Hakir0]Razzell,2236,171,4,2,6,66.7%,3h
37363,2,InnvencibleC,2236,93,4,9,13,30.8%,7m
37363,2,TwentySeven,2236,171,4,11,15,26.7%,12m
37363,1,[KR20]WISDOM,2236,126,3,1,4,75.0%,46m
37363,1,Dineley,2236,107,2,1,3,66.7%,42m
37363,1,[LetsGo]mattanator,2236,0,2,3,5,40.0%,46m
37363,1,LuCkSs,2236,54,2,5,7,28.6%,3h
37363,1,SMOG,2236,102,2,6,8,25.0%,43m
37363,1,wacko,2236,0,1,0,1,100.0%,3h
37363,1,AngryGayMan,2236,0,1,0,1,100.0%,7m
37363,1,Diligence,2236,44,1,5,6,16.7%,1h
37363,1,[SNKNG]TheCommodore,2236,34,1,5,6,16.7%,50m
37363,1,weweweyou,2236,0,0,1,1,0.0%,26m
37390,2,Layate,2235,1432,157,162,319,49.2%,1h
37390,3,ZSweet,2235,1390,67,70,137,48.9%,10m
37390,1,BaToLoKOO,2235,1214,41,33,74,55.4%,1h
37390,1,BjornTheWise,2235,853,29,30,59,49.2%,2m
37390,2,[neuroS]FRZBRN,2235,436,17,32,49,34.7%,19m
37390,1,GeneralPaul,2235,424,16,10,26,61.5%,46m
37390,1,RyanGosling,2235,286,14,16,30,46.7%,3h
37390,1,StarSim,2235,496,13,16,29,44.8%,3h
37390,1,[SANAG]Ihradikeytor,2235,411,12,9,21,57.1%,1h
37390,1,MikolaSraka,2235,434,12,17,29,41.4%,57m
37390,1,LukeSkywalkr,2235,263,10,4,14,71.4%,16m
37390,1,TossOP,2235,122,6,2,8,75.0%,6m
37390,1,David,2235,156,5,3,8,62.5%,3h
37390,1,SCUD,2235,116,5,7,12,41.7%,1h
37390,3,LiLVienna,2235,68,5,16,21,23.8%,1h
37390,1,Diegonidaz,2235,126,4,3,7,57.1%,3h
37390,3,Trojan,2235,97,4,5,9,44.4%,24m
37390,3,GeneralJJ,2235,149,4,9,13,30.8%,9m
37390,1,gem,2235,179,4,9,13,30.8%,3h
37390,2,alphavirus,2235,30,3,7,10,30.0%,1h
37390,1,Rocher,2235,73,2,8,10,20.0%,51m
37390,1,[6801]CivicR,2235,42,1,3,4,25.0%,3h
37390,1,Sakku,2235,0,1,3,4,25.0%,30m
37390,1,conkistador,2235,0,1,4,5,20.0%,3h
37390,1,holeshotseph,2235,0,1,5,6,16.7%,1h
37390,1,shmagmhar,2235,0,1,5,6,16.7%,6m
37390,1,Threenil,2235,0,0,1,1,0.0%,37m
37390,3,NewNate,2235,0,0,2,2,0.0%,36m
37390,2,Thanatos,2235,0,0,2,2,0.0%,25m
37390,1,bucksAplenty,2235,0,0,3,3,0.0%,1h
37420,3,MasDK,2234,1515,125,130,255,49.0%,3h
37420,1,BigBawls,2234,1254,76,65,141,53.9%,3h
37420,1,birdman,2234,1406,55,49,104,52.9%,37m
37420,2,[NORU5H]Pwnu,2234,1281,54,65,119,45.4%,3h
37420,3,jamesepewpew,2234,764,34,44,78,43.6%,3h
37420,3,Lllllluke,2234,542,26,20,46,56.5%,49m
37420,1,SneakySquid,2234,705,25,22,47,53.2%,3h
37420,3,Zerveruz,2234,398,13,24,37,35.1%,1h
37420,1,Forthepeople,2234,310,11,7,18,61.1%,1h
37420,1,GreassyGamer,2234,246,10,4,14,71.4%,3h
37420,1,[PobSC]latineltunas,2234,272,8,6,14,57.1%,1h
37420,1,aang,2234,236,7,5,12,58.3%,16m
37420,1,[Boba07]GrisMonster,2234,257,7,6,13,53.8%,1h
37420,1,cristian,2234,221,6,6,12,50.0%,3h
37420,3,Rugger,2234,192,6,19,25,24.0%,1h
37420,1,hoanglan,2234,30,5,5,10,50.0%,1h
37420,1,Trifox,2234,96,4,7,11,36.4%,5m
37420,1,minhtuannc,2234,0,3,7,10,30.0%,1h
37420,1,Dog,2234,183,3,8,11,27.3%,1h
37420,1,SkUnCh,2234,0,1,2,3,33.3%,3h
37420,2,Narines,2234,0,1,4,5,20.0%,1h
37420,3,Magdalenita,2234,90,1,6,7,14.3%,15m
37420,1,knubie,2234,44,1,6,7,14.3%,15m
37420,1,ChiefBZ,2234,0,0,1,1,0.0%,41m
37420,3,TheKingXx,2234,0,0,1,1,0.0%,1h
37420,1,boozh,2234,0,0,1,1,0.0%,44m
37420,1,BlackGhost,2234,0,0,2,2,0.0%,16m
37420,1,ChefAnferny,2234,0,0,3,3,0.0%,12m
37420,1,[StrL]fjr,2234,0,0,3,3,0.0%,3h
37449,3,[0825]cptsparrow,2233,1534,243,245,488,49.8%,1h
37449,1,[soypro]iminini,2233,1559,88,86,174,50.6%,40m
37449,1,SeuCuca,2233,1082,65,52,117,55.6%,59m
37449,3,Destroyer,2233,562,60,66,126,47.6%,17m
37449,1,PeterPan,2233,734,34,24,58,58.6%,3h
37449,1,fritch,2233,988,30,31,61,49.2%,1h
37449,1,Yeldarb,2233,945,30,33,63,47.6%,13m
37449,1,CountDooku,2233,685,28,23,51,54.9%,3h
37449,3,PHDPRO,2233,355,28,35,63,44.4%,1h
37449,3,Notagonist,2233,594,25,39,64,39.1%,1h
37449,1,Kaelthalaz,2233,557,19,18,37,51.4%,50m
37449,1,kennybruvs,2233,496,16,23,39,41.0%,1h
37449,1,[nieBla]ELJAJAS,2233,522,15,14,29,51.7%,1h
37449,3,FENIX,2233,422,15,20,35,42.9%,35m
37449,1,CaptainSiek,2233,470,14,21,35,40.0%,3h
37449,1,Nossgoth,2233,306,10,9,19,52.6%,31m
37449,1,VoidStar,2233,282,7,13,20,35.0%,1h
37449,3,[CLord]VilugArZa,2233,201,5,12,17,29.4%,19m
37449,1,MiniMax,2233,118,4,4,8,50.0%,48m
37449,1,[XpKAc]Diaguita,2233,148,4,5,9,44.4%,3h
37449,1,[EZkill]SpaceJanitor,2233,143,3,1,4,75.0%,3m
37449,1,Tigolbitties,2233,114,3,3,6,50.0%,40m
37449,1,crxr,2233,86,2,4,6,33.3%,1h
37449,1,DeanLofi,2233,0,2,8,10,20.0%,1h
37449,2,[CryTek]ILLUMINATED,2233,0,1,0,1,100.0%,25m
37449,1,DarkFantom,2233,0,1,0,1,100.0%,3h
37449,3,robbie,2233,0,1,0,1,100.0%,38m
37449,2,Ceezy,2233,48,1,5,6,16.7%,3h
37449,1,[fap69]Ravnn,2233,0,0,1,1,0.0%,3h
37449,1,HOTGIRLMEG,2233,0,0,1,1,0.0%,46m
37449,1,[DOOHS]Warbosjustin,2233,0,0,1,1,0.0%,3h
37449,1,kyrSpeeder,2233,0,0,1,1,0.0%,3h
37449,1,[FTLTX]Versace,2233,0,0,3,3,0.0%,10m
37449,1,megakill,2233,0,0,4,4,0.0%,2m
37449,1,Starman,2233,0,0,4,4,0.0%,1h
37449,1,perach,2233,0,0,5,5,0.0%,31m
37485,3,[NLTN]laguz,2232,1255,199,206,405,49.1%,1h
37485,1,[VENSC2]SantiniR,2232,1820,105,103,208,50.5%,3h
37485,1,AJKryzak,2232,1714,99,92,191,51.8%,3h
37485,1,WayZ,2232,1270,76,69,145,52.4%,46m
37485,1,Hadgavis,2232,1325,56,39,95,58.9%,7m
37485,3,[Black0]Mirageman,2232,1368,49,56,105,46.7%,17m
37485,2,MiloLissn,2232,1189,47,56,103,45.6%,1h
37485,1,[ExcIgN]GaBiTo,2232,613,27,19,46,58.7%,3h
37485,1,[LA13]Tlky,2232,783,27,26,53,50.9%,40m
37485,1,pasapam,2232,677,23,26,49,46.9%,46m
37485,2,WolveElite,2232,577,22,32,54,40.7%,3h
37485,1,Nathaniel,2232,478,17,14,31,54.8%,59m
37485,1,SabuesoListr,2232,446,15,9,24,62.5%,10m
37485,1,[HABLA]RASEC,2232,498,15,13,28,53.6%,42m
37485,2,Geb,2232,238,8,14,22,36.4%,3h
37485,2,[SIPA]DREAD,2232,94,6,10,16,37.5%,3h
37485,1,masterkille,2232,154,5,2,7,71.4%,3h
37485,1,peec,2232,119,4,2,6,66.7%,41m
37485,1,[Crip1]StarRax,2232,180,4,7,11,36.4%,1h
37485,3,fuMoffU,2232,95,3,5,8,37.5%,1h
37485,1,[pigs]Kalashnikov,2232,88,3,7,10,30.0%,22m
37485,3,Zep,2232,30,3,9,12,25.0%,1h
37485,1,fetwoplus,2232,0,2,4,6,33.3%,17m
37485,1,TrapWizzard,2232,0,2,6,8,25.0%,3h
37485,3,RickyC,2232,30,2,7,9,22.2%,1h
37485,2,iiiiiiiiiiii,2232,125,2,17,19,10.5%,3h
37485,1,JohnnyBolts,2232,0,1,0,1,100.0%,43m
37485,1,nthr,2232,0,1,1,2,50.0%,1h
37485,1,Marcotulio,2232,0,1,2,3,33.3%,46m
37485,1,[OhWoW]ThEdUdE,2232,0,0,1,1,0.0%,26m
37485,1,EricLuddeMan,2232,0,0,1,1,0.0%,31m
37485,1,SrMojon,2232,0,0,2,2,0.0%,3h
37485,1,HucK,2232,0,0,2,2,0.0%,37m
37485,1,FabrizioGG,2232,0,0,5,5,0.0%,3h
37519,1,Zerored,2231,923,146,137,283,51.6%,3h
37519,1,[USM]Rondiablo,2231,1498,140,150,290,48.3%,1h
37519,1,Fate,2231,1595,90,98,188,47.9%,1h
37519,1,xin,2231,1784,67,72,139,48.2%,24m
37519,1,Piripiripiri,2231,1355,55,58,113,48.7%,13m
37519,2,Pireo,2231,1144,47,57,104,45.2%,3h
37519,1,Arhistal,2231,709,30,21,51,58.8%,3h
37519,3,[sk3tch]RobertStark,2231,847,30,38,68,44.1%,51m
37519,1,Milo,2231,617,25,27,52,48.1%,1h
37519,1,[DXPCA]BondFire,2231,544,18,17,35,51.4%,49m
37519,1,HappyHatMan,2231,444,14,21,35,40.0%,1h
37519,1,[MCY]JpBlacker,2231,258,7,4,11,63.6%,3h
37519,3,KobeBryant,2231,243,7,11,18,38.9%,1h
37519,1,WickedOne,2231,209,6,9,15,40.0%,41m
37519,1,QuickTurtle,2231,173,5,8,13,38.5%,1h
37519,1,MicroToWin,2231,124,4,9,13,30.8%,3h
37519,1,notsogood,2231,0,3,2,5,60.0%,3h
37519,1,rider,2231,124,3,5,8,37.5%,3h
37519,1,[AllRA]armoar,2231,48,3,6,9,33.3%,5m
37519,1,Qbear,2231,46,2,1,3,66.7%,23m
37519,1,rufuss,2231,44,2,2,4,50.0%,60m
37519,1,sonoma,2231,64,2,4,6,33.3%,43m
37519,3,[RoEg]ROKStomper,2231,0,2,7,9,22.2%,3h
37519,3,ESPmodern,2231,95,2,7,9,22.2%,55m
37519,1,XxelpapixX,2231,0,1,3,4,25.0%,48m
37519,1,Mitrelmax,2231,42,1,3,4,25.0%,3h
37519,3,Blingk,2231,0,1,4,5,20.0%,24m
37519,1,Overlord,2231,0,0,1,1,0.0%,1h
37519,1,SmokyGhost,2231,0,0,2,2,0.0%,60m
37519,1,XxcoryxX,2231,0,0,2,2,0.0%,8m
37519,1,Liyu,2231,0,0,2,2,0.0%,3h
37519,1,AidsForSale,2231,0,0,2,2,0.0%,45m
37551,1,Piker,2230,1714,106,96,202,52.5%,4m
37551,1,lbs,2230,1013,44,41,85,51.8%,40m
37551,1,[TGosuB]lulu,2230,830,38,33,71,53.5%,1h
37551,1,deriver,2230,868,36,22,58,62.1%,1h
37551,3,xsx,2230,659,23,30,53,43.4%,1h
37551,3,cccjames,2230,616,21,32,53,39.6%,1h
37551,1,Nirat,2230,511,20,12,32,62.5%,4m
37551,3,Symba,2230,600,20,31,51,39.2%,1h
37551,3,[LY0]Peter,2230,492,18,28,46,39.1%,1h
37551,1,muffinboy,2230,554,15,19,34,44.1%,3h
37551,1,troyanos,2230,320,11,13,24,45.8%,3h
37551,1,DeMenD,2230,253,8,6,14,57.1%,27m
37551,3,joklamar,2230,184,8,11,19,42.1%,1h
37551,1,Adam,2230,169,7,2,9,77.8%,3h
37551,3,Takatora,2230,124,6,11,17,35.3%,3h
37551,2,Alexi,2230,140,4,3,7,57.1%,3h
37551,3,noobathon,2230,169,4,4,8,50.0%,1h
37551,1,MADKING,2230,100,4,8,12,33.3%,1h
37551,1,[FatMom]enrique,2230,80,3,2,5,60.0%,23m
37551,1,[Akeno]GOTMEGAMILK,2230,86,3,4,7,42.9%,40m
37551,2,Ivory,2230,139,3,4,7,42.9%,1h
37551,1,JAVU,2230,108,2,1,3,66.7%,1h
37551,2,[Satday]PotLuck,2230,0,2,4,6,33.3%,5m
37551,1,JHOG,2230,70,2,4,6,33.3%,1h
37551,3,UtopiaDave,2230,0,2,7,9,22.2%,3h
37551,1,[IBIU]davseb,2230,0,1,1,2,50.0%,1h
37551,1,[AOSsc]Sinchijackal,2230,0,1,5,6,16.7%,41m
37551,1,NEOV,2230,0,0,1,1,0.0%,42m
37551,1,[3M2]Zodiac,2230,0,0,1,1,0.0%,3h
37551,1,[720p]Snapperkai,2230,0,0,5,5,0.0%,1h
37581,1,rob,2229,1772,357,363,720,49.6%,37m
37581,1,Juice,2229,1389,75,69,144,52.1%,1h
37581,1,Scharfff,2229,1611,70,79,149,47.0%,3h
37581,3,[SkAL]Khiva,2229,1307,67,72,139,48.2%,30m
37581,1,Buss,2229,558,38,28,66,57.6%,37m
37581,1,CheryPoppins,2229,1156,37,44,81,45.7%,31m
37581,1,REEAL,2229,944,31,36,67,46.3%,35m
37581,1,Teacher,2229,796,29,29,58,50.0%,1h
37581,1,Firekloud,2229,743,24,26,50,48.0%,31m
37581,1,firulai,2229,409,17,7,24,70.8%,3h
37581,1,zwung,2229,546,17,19,36,47.2%,23m
37581,3,Gerard,2229,356,14,15,29,48.3%,51m
37581,1,oooooooooooo,2229,508,14,21,35,40.0%,3h
37581,1,Stazza,2229,292,9,11,20,45.0%,1h
37581,3,BRAYAN,2229,198,8,9,17,47.1%,1h
37581,1,Zebgoraj,2229,271,8,14,22,36.4%,1h
37581,1,[SLI55]sullivan,2229,212,6,8,14,42.9%,3h
37581,1,ericshen,2229,184,6,8,14,42.9%,60m
37581,1,[RLSM]Sebazzu,2229,244,6,10,16,37.5%,1h
37581,1,Santino,2229,224,6,11,17,35.3%,15m
37581,1,OnceMoreInto,2229,146,5,11,16,31.2%,16m
37581,3,[FoxBR]ZéRuela,2229,143,4,8,12,33.3%,1h
37581,1,CptNeckbeard,2229,169,3,7,10,30.0%,1h
37581,1,Samboelpatro,2229,0,1,1,2,50.0%,3h
37581,1,vazad,2229,48,1,3,4,25.0%,1h
37581,1,ravioli,2229,0,1,4,5,20.0%,1h
37581,1,ken,2229,0,0,5,5,0.0%,7m
37608,2,SrAmable,2228,1506,176,185,361,48.8%,3h
37608,2,naswil,2228,1446,74,88,162,45.7%,55m
37608,1,Ghosito,2228,1658,73,71,144,50.7%,3h
37608,1,MrLonely,2228,1155,62,39,101,61.4%,1h
37608,1,BOB,2228,753,32,18,50,64.0%,51m
37608,1,[VODK]POROTOTITO,2228,806,30,23,53,56.6%,25m
37608,3,MonstaGoliat,2228,496,16,26,42,38.1%,1h
37608,1,paranOidjOel,2228,401,12,8,20,60.0%,50m
37608,1,PREDAWOLF,2228,418,12,11,23,52.2%,3h
37608,1,[Zulu]Slabba,2228,374,11,12,23,47.8%,3h
37608,3,sanghyunhan,2228,254,11,18,29,37.9%,31m
37608,1,Spilteran,2228,268,10,5,15,66.7%,1h
37608,1,Trax,2228,378,10,8,18,55.6%,42m
37608,1,Kenny,2228,218,6,8,14,42.9%,43m
37608,1,Tuco,2228,212,6,10,16,37.5%,1h
37608,1,[LTlord]Sombra,2228,140,5,5,10,50.0%,1h
37608,1,TacoPablo,2228,145,3,0,3,100.0%,1h
37608,1,Charmed,2228,128,3,7,10,30.0%,27m
37608,1,QuelpoHelpo,2228,118,3,9,12,25.0%,22m
37608,1,[MexPw]VACHOS,2228,84,2,5,7,28.6%,55m
37608,3,Zurox,2228,0,2,7,9,22.2%,43m
37608,1,[Keyote]Arisu,2228,92,1,1,2,50.0%,31m
37608,1,Avenaquaker,2228,0,1,1,2,50.0%,1h
37608,1,JKwizzle,2228,0,1,5,6,16.7%,3h
37608,1,JavierRomero,2228,42,1,6,7,14.3%,1h
37608,3,[PR0G0D]GrafoS,2228,0,1,6,7,14.3%,6m
37608,1,custoin,2228,0,0,1,1,0.0%,36m
37608,3,patata,2228,0,0,1,1,0.0%,1h
37608,2,PoloPAC,2228,0,0,2,2,0.0%,3h
37608,3,Pinto,2228,0,0,4,4,0.0%,14m
37608,1,corza,2228,0,0,5,5,0.0%,6m
37608,2,Vayne,2228,0,0,5,5,0.0%,1h
37640,1,[xlTWlx]Federation,2227,1710,149,136,285,52.3%,40m
37640,3,JoakorVF,2227,1495,81,78,159,50.9%,1h
37640,1,Tellion,2227,1624,64,63,127,50.4%,3h
37640,1,RCDC,2227,1480,55,55,110,50.0%,3h
37640,1,SrPapafrita,2227,531,16,14,30,53.3%,17m
37640,1,Loki,2227,430,14,21,35,40.0%,24m
37640,2,PORQUEMEBANE,2227,234,12,12,24,50.0%,20m
37640,1,Redx,2227,303,12,13,25,48.0%,13m
37640,1,Ishtar,2227,362,10,11,21,47.6%,21m
37640,1,[TPGGXD]Oxxoman,2227,326,9,11,20,45.0%,21m
37640,1,crankR,2227,257,9,12,21,42.9%,42m
37640,3,[TypeZ]haven,2227,205,7,17,24,29.2%,6m
37640,1,Narbarn,2227,144,5,4,9,55.6%,3h
37640,2,Harvesta,2227,130,5,11,16,31.2%,1h
37640,1,[WolfX]SINVERGUENZA,2227,166,5,11,16,31.2%,3h
37640,2,XxPisadinha,2227,0,4,5,9,44.4%,1h
37640,1,Sidithis,2227,189,4,7,11,36.4%,16m
37640,1,Diego,2227,144,4,9,13,30.8%,1h
37640,1,Warlord,2227,126,4,9,13,30.8%,3h
37640,1,Lucas,2227,132,3,5,8,37.5%,3h
37640,1,JHAZZO,2227,126,3,6,9,33.3%,21m
37640,1,[Azocur]Louhyzt,2227,89,2,0,2,100.0%,37m
37640,2,johncrosby,2227,0,1,4,5,20.0%,1h
37640,1,[YEGG]Kasnio,2227,0,1,5,6,16.7%,12m
37640,1,[USN]monty,2227,0,0,1,1,0.0%,10m
37640,2,SERGIO,2227,0,0,1,1,0.0%,1h
37640,1,Starman,2227,0,0,2,2,0.0%,1h
37640,2,Briannicus,2227,0,0,3,3,0.0%,1h
37640,1,BerryScary,2227,0,0,6,6,0.0%,1h
37669,1,Tathos,2226,1007,78,77,155,50.3%,25m
37669,3,MRLIU,2226,1145,77,81,158,48.7%,1h
37669,3,Bigcat,2226,1212,74,69,143,51.7%,1h
37669,1,ayymar,2226,1116,73,66,139,52.5%,23m
37669,3,Underscore,2226,1499,56,65,121,46.3%,21m
37669,1,Aridan,2226,1023,42,44,86,48.8%,3h
37669,3,ANDREAS,2226,337,40,43,83,48.2%,35m
37669,1,TAZADAR,2226,431,20,7,27,74.1%,48m
37669,2,ZED,2226,474,16,22,38,42.1%,59m
37669,1,Librarian,2226,393,14,19,33,42.4%,50m
37669,1,Indrael,2226,510,13,15,28,46.4%,3h
37669,1,[Ideia]Fblack,2226,428,12,10,22,54.5%,1h
37669,1,JohnyDaMylla,2226,450,12,14,26,46.2%,1h
37669,3,Killer,2226,347,11,17,28,39.3%,32m
37669,1,[McFIy]CharlieDangr,2226,267,10,7,17,58.8%,1h
37669,1,Armagnac,2226,302,7,12,19,36.8%,24m
37669,3,[cl0udM]Applesauce,2226,231,7,12,19,36.8%,1h
37669,1,Lopan,2226,162,4,5,9,44.4%,25m
37669,1,agamenon,2226,134,4,8,12,33.3%,50m
37669,1,[Cind3r]Potatoe,2226,106,3,0,3,100.0%,3h
37669,1,salsaverde,2226,72,3,2,5,60.0%,1h
37669,3,TASTIN,2226,123,3,2,5,60.0%,35m
37669,3,Squog,2226,40,3,9,12,25.0%,35m
37669,1,JezuzLOLYOO,2226,119,2,2,4,50.0%,1h
37669,1,MeSmart,2226,0,2,4,6,33.3%,37m
37669,1,ENDER,2226,117,2,8,10,20.0%,3h
37669,1,bixnood,2226,0,1,0,1,100.0%,4m
37669,1,[NzAs]kushkilla,2226,30,1,2,3,33.3%,3h
37669,2,lolzebra,2226,0,1,4,5,20.0%,3h
37669,1,[HvenFi]GabrieLx,2226,0,1,5,6,16.7%,10m
37669,1,Aik,2226,0,1,5,6,16.7%,22m
37669,1,Mike,2226,0,1,6,7,14.3%,1h
37669,1,RDSTHEREKOJ,2226,0,0,6,6,0.0%,3h
37702,3,Sinaps,2225,1513,245,243,488,50.2%,1h
37702,1,ecpsssante,2225,1568,126,130,256,49.2%,3h
37702,1,bloody,2225,1047,109,109,218,50.0%,1h
37702,1,Ditter,2225,1238,77,62,139,55.4%,48m
37702,1,DANIEL,2225,1786,75,82,157,47.8%,1h
37702,1,Jdur,2225,1348,48,48,96,50.0%,3h
37702,1,[YODEL]AlejoCarPa,2225,1207,44,43,87,50.6%,3h
37702,2,Steok,2225,936,39,42,81,48.1%,1h
37702,3,Hippodon,2225,225,31,35,66,47.0%,41m
37702,1,[ExcIgN]THEVICE,2225,519,22,23,45,48.9%,1h
37702,1,[Ayhur]RemJoan,2225,401,20,13,33,60.6%,34m
37702,1,Fokus,2225,640,20,22,42,47.6%,4m
37702,1,[KUMS]MiDickHertz,2225,599,19,18,37,51.4%,3h
37702,1,[D4RkS]SHADOW,2225,341,14,12,26,53.8%,15m
37702,1,Constantine,2225,251,9,6,15,60.0%,3h
37702,1,XxSEABEASTxX,2225,379,9,13,22,40.9%,35m
37702,1,brayan,2225,322,8,13,21,38.1%,6m
37702,1,darksider,2225,162,7,7,14,50.0%,3h
37702,1,[femFX]DeSperaTioN,2225,208,6,7,13,46.2%,3h
37702,3,[PoSu]breadedtoast,2225,92,5,17,22,22.7%,48m
37702,1,[Nose02]MrPotato,2225,42,2,2,4,50.0%,1h
37702,1,nfw,2225,40,2,6,8,25.0%,3m
37702,1,HabanaClub,2225,0,1,0,1,100.0%,39m
37702,1,DaMayoMan,2225,0,1,5,6,16.7%,3h
37702,1,JFLC,2225,0,0,1,1,0.0%,1h
37702,1,Youngbloke,2225,0,0,2,2,0.0%,42m
37702,1,RomanArson,2225,0,0,2,2,0.0%,29m
37729,3,auror,2224,1463,105,95,200,52.5%,3h
37729,1,MinecraftPro,2224,1805,102,105,207,49.3%,3h
37729,1,[MuSaFi]VoidCron,2224,1585,67,69,136,49.3%,13m
37729,1,DIEGO,2224,1197,61,47,108,56.5%,51m
37729,1,[neverb]SoloOp,2224,1418,48,53,101,47.5%,3h
37729,1,starliberty,2224,396,29,32,61,47.5%,1h
37729,1,ToneOSarcasm,2224,782,28,23,51,54.9%,48m
37729,1,WHITEEYYYY,2224,488,27,7,34,79.4%,3h
37729,3,Itman,2224,405,13,23,36,36.1%,35m
37729,1,PaleBlueDot,2224,397,12,8,20,60.0%,16m
37729,1,Element,2224,478,12,20,32,37.5%,3h
37729,3,jaiprime,2224,138,10,14,24,41.7%,51m
37729,1,Tehuti,2224,324,8,12,20,40.0%,3h
37729,1,Broly,2224,213,8,16,24,33.3%,3h
37729,1,proggleyes,2224,178,7,6,13,53.8%,3h
37729,1,VanceMillion,2224,220,6,4,10,60.0%,3h
37729,1,BlackFly,2224,120,4,8,12,33.3%,1h
37729,1,llllllllllll,2224,102,3,4,7,42.9%,1h
37729,1,Himura,2224,34,2,6,8,25.0%,1h
37729,1,[GZC]zgjsb,2224,90,1,1,2,50.0%,1h
37729,1,silentham,2224,40,1,2,3,33.3%,12m
37729,1,ShuaSlays,2224,0,1,6,7,14.3%,1h
37729,1,MawineLife,2224,0,1,6,7,14.3%,45m
37729,1,Uwucosmico,2224,0,1,6,7,14.3%,1h
37729,2,TYMYOTUL,2224,0,0,1,1,0.0%,1h
37729,1,Carmesi,2224,0,0,1,1,0.0%,3h
37755,2,nObOdy,2223,1509,153,159,312,49.0%,1h
37755,1,Trone,2223,1710,120,116,236,50.8%,50m
37755,1,JeanC,2223,1594,96,93,189,50.8%,3h
37755,1,noahneevz,2223,1789,78,82,160,48.8%,1h
37755,1,MiggzFresh,2223,1413,75,74,149,50.3%,31m
37755,1,DEZINGUER,2223,1374,60,48,108,55.6%,46m
37755,3,imaazhol,2223,1068,54,64,118,45.8%,1h
37755,1,GRANSEMENTAL,2223,1438,51,51,102,50.0%,1h
37755,3,TambaMamba,2223,1502,47,77,124,37.9%,29m
37755,1,[VinG]Sasori,2223,1132,38,38,76,50.0%,50m
37755,1,URUALFA,2223,1142,37,41,78,47.4%,1h
37755,1,[OndaVT]BlasterNerd,2223,1045,33,35,68,48.5%,1h
37755,1,AbdielCrack,2223,673,22,20,42,52.4%,3h
37755,1,Reedyseth,2223,701,20,21,41,48.8%,60m
37755,3,Devastador,2223,554,20,27,47,42.6%,3h
37755,1,Copperhead,2223,497,16,16,32,50.0%,3h
37755,1,felon,2223,279,11,12,23,47.8%,1h
37755,3,underwhelmd,2223,284,10,11,21,47.6%,1h
37755,1,dRdubS,2223,256,8,8,16,50.0%,3h
37755,1,WizardJump,2223,222,7,9,16,43.8%,1h
37755,1,Matix,2223,260,7,11,18,38.9%,1h
37755,3,MisterMoose,2223,170,6,8,14,42.9%,3h
37755,2,SENICH,2223,133,5,2,7,71.4%,54m
37755,3,Kaiser,2223,153,5,10,15,33.3%,33m
37755,1,boris,2223,167,4,2,6,66.7%,3h
37755,1,zeblitaema,2223,188,4,7,11,36.4%,3h
37755,1,molito,2223,183,4,8,12,33.3%,3h
37755,1,Bureaucrate,2223,144,4,8,12,33.3%,1h
37755,1,[BlTEL]frayanx,2223,40,2,1,3,66.7%,1h
37755,1,LeadJunkie,2223,36,2,3,5,40.0%,12m
37755,1,MeatScepter,2223,84,2,5,7,28.6%,3h
37755,1,SolidSky,2223,48,2,6,8,25.0%,1h
37755,1,RedViking,2223,121,2,7,9,22.2%,7m
37755,1,PatrioticP,2223,48,1,2,3,33.3%,19m
37755,1,[dodgy]ReBourne,2223,0,1,4,5,20.0%,58m
37755,1,BouncyBear,2223,42,1,4,5,20.0%,46m
37755,1,Soluço,2223,0,1,5,6,16.7%,9m
37755,1,andres,2223,0,1,6,7,14.3%,1h
37755,3,Miguelito,2223,0,1,6,7,14.3%,3h
37755,1,zergking,2223,0,0,1,1,0.0%,3h
37755,1,[DVU]DooWopJoel,2223,0,0,1,1,0.0%,3h
37755,2,iKyuu,2223,0,0,1,1,0.0%,1h
37755,1,Unhiplemming,2223,0,0,6,6,0.0%,1h
37798,3,evan,2222,1532,154,157,311,49.5%,28m
37798,1,grumpgunner,2222,1790,147,139,286,51.4%,1h
37798,3,Cid,2222,1553,140,136,276,50.7%,1h
37798,3,LidSS,2222,1565,100,105,205,48.8%,12m
37798,1,voodoo,2222,587,69,69,138,50.0%,1h
37798,1,Slime,2222,481,34,27,61,55.7%,3h
37798,3,hamletsghost,2222,740,25,34,59,42.4%,3h
37798,1,[sk3tch]milhd,2222,782,23,25,48,47.9%,1h
37798,1,FireGoose,2222,594,19,27,46,41.3%,3h
37798,1,[Dark20]MaestroDark,2222,567,16,27,43,37.2%,2m
37798,1,xFreakss,2222,382,14,11,25,56.0%,15m
37798,1,AiryShift,2222,384,14,18,32,43.8%,13m
37798,1,RizqEloheem,2222,446,12,15,27,44.4%,3h
37798,1,BobbyVe,2222,310,11,15,26,42.3%,3h
37798,1,[K0D]Carb,2222,234,10,18,28,35.7%,3m
37798,1,Satin,2222,123,7,2,9,77.8%,50m
37798,3,ESRUBIO,2222,90,5,9,14,35.7%,6m
37798,3,UltraGuy,2222,152,4,8,12,33.3%,21m
37798,3,[400s]Project,2222,74,4,10,14,28.6%,41m
37798,1,Dieguito,2222,145,3,1,4,75.0%,8m
37798,1,Kendor,2222,94,3,4,7,42.9%,3h
37798,1,leoncio,2222,126,3,5,8,37.5%,1h
37798,1,[SMCE]SILVERWOLF,2222,174,3,12,15,20.0%,1h
37798,1,Xenocide,2222,44,2,4,6,33.3%,3h
37798,1,Samuraidust,2222,48,2,6,8,25.0%,3h
37798,1,HeadKeeper,2222,0,1,0,1,100.0%,1h
37798,2,[TPLL]HeLlToXiC,2222,48,1,1,2,50.0%,3h
37798,1,crazyfists,2222,0,1,1,2,50.0%,3h
37798,1,[Sc2F]ToaFolks,2222,38,1,2,3,33.3%,46m
37798,2,Toxon,2222,0,1,3,4,25.0%,1h
37798,1,Flipadelphia,2222,42,1,3,4,25.0%,3h
37798,1,GIAN,2222,42,1,3,4,25.0%,3h
37798,3,ChadPasta,2222,0,0,1,1,0.0%,6m
37798,1,[AntCC]Hunter,2222,0,0,1,1,0.0%,44m
37798,1,Seckstrong,2222,0,0,2,2,0.0%,10m
37798,1,Ammonium,2222,0,0,2,2,0.0%,3h
37834,2,Rabbit,2221,1542,441,443,884,49.9%,3h
37834,2,CatBoxes,2221,1513,315,320,635,49.6%,1h
37834,1,[KYLE]CptKrunch,2221,1586,236,243,479,49.3%,1h
37834,1,Gersbot,2221,766,81,71,152,53.3%,31m
37834,1,Tron,2221,1418,50,50,100,50.0%,3h
37834,1,SwepZeratul,2221,758,34,25,59,57.6%,4m
37834,1,zigman,2221,650,34,44,78,43.6%,21m
37834,1,Sonnie,2221,764,25,25,50,50.0%,3h
37834,1,PauCalde,2221,502,19,19,38,50.0%,36m
37834,1,[clow]AndresJPZ,2221,368,13,14,27,48.1%,31m
37834,1,Cameron,2221,358,11,12,23,47.8%,60m
37834,1,Supaplex,2221,171,6,1,7,85.7%,3h
37834,1,[amva]KHRATOS,2221,215,5,1,6,83.3%,1h
37834,1,[8OO8S]mrpaintrain,2221,165,4,5,9,44.4%,3h
37834,1,[bysa]MiguelThor,2221,112,4,5,9,44.4%,1h
37834,1,josem,2221,120,4,7,11,36.4%,24m
37834,1,IIIIIII,2221,163,4,7,11,36.4%,1h
37834,1,Crossette,2221,161,4,11,15,26.7%,1h
37834,1,Gedeon,2221,145,3,6,9,33.3%,8m
37834,1,[Sbr2th]Matius,2221,143,2,2,4,50.0%,3h
37834,1,GgamNol,2221,113,2,2,4,50.0%,46m
37834,1,COSand,2221,0,2,3,5,40.0%,37m
37834,1,Maru,2221,48,2,7,9,22.2%,45m
37834,1,jtung,2221,30,1,4,5,20.0%,1h
37834,2,supot,2221,0,1,4,5,20.0%,1h
37834,1,[DXTNY]SKSword,2221,0,0,1,1,0.0%,5m
37834,1,dreacarys,2221,0,0,1,1,0.0%,3h
37834,2,eLEMent,2221,0,0,1,1,0.0%,3h
37834,1,Curandera,2221,0,0,2,2,0.0%,53m
37834,1,KoolAidMan,2221,0,0,2,2,0.0%,31m
37864,1,valente,2220,1786,190,199,389,48.8%,3h
37864,1,cacalo,2220,1743,114,114,228,50.0%,34m
37864,3,Kelthos,2220,1613,75,70,145,51.7%,3h
37864,1,MrWars,2220,666,50,47,97,51.5%,6m
37864,3,Edu,2220,1191,43,52,95,45.3%,6m
37864,1,DarthVader,2220,494,42,32,74,56.8%,6m
37864,1,PiggyBuckle,2220,656,21,18,39,53.8%,3h
37864,1,ELNegro,2220,382,20,19,39,51.3%,42m
37864,3,MGUNZ,2220,514,19,28,47,40.4%,1h
37864,1,[ZPT019]superhero,2220,426,14,10,24,58.3%,60m
37864,1,Dieguito,2220,396,11,13,24,45.8%,1h
37864,1,dbsoneshot,2220,432,11,15,26,42.3%,3h
37864,1,BlizzMist,2220,426,11,19,30,36.7%,23m
37864,1,Niki,2220,264,9,7,16,56.2%,31m
37864,1,Parrot,2220,336,9,11,20,45.0%,1h
37864,1,WarGodOdin,2220,288,8,10,18,44.4%,3h
37864,1,ByuN,2220,157,5,1,6,83.3%,13m
37864,1,Ramosboys,2220,183,5,4,9,55.6%,46m
37864,3,MORG,2220,0,4,4,8,50.0%,1h
37864,1,[Gaemer]IIIIIIIIIIII,2220,145,3,3,6,50.0%,41m
37864,3,Timmyr,2220,146,3,5,8,37.5%,49m
37864,3,Pnuemonia,2220,98,3,13,16,18.8%,51m
37864,1,Shoda,2220,97,2,3,5,40.0%,1h
37864,2,KelesoKMS,2220,0,2,3,5,40.0%,60m
37864,1,Fatcat,2220,97,2,3,5,40.0%,22m
37864,1,[LQV]Dalabaya,2220,139,2,6,8,25.0%,16m
37864,1,freeorDie,2220,88,2,9,11,18.2%,8m
37864,1,Dawgman,2220,0,1,0,1,100.0%,1h
37864,1,cantdecide,2220,0,1,0,1,100.0%,4m
37864,1,wlins,2220,40,1,2,3,33.3%,3h
37864,1,Ainsophaur,2220,0,1,5,6,16.7%,49m
37864,2,[THD]Dreamer,2220,46,1,5,6,16.7%,1h
37864,1,[S0D1UM]RetCraft,2220,0,0,1,1,0.0%,3h
37864,1,LaserTime,2220,0,0,2,2,0.0%,24m
37864,1,CaesarPatton,2220,0,0,5,5,0.0%,13m
37899,1,BlacPower,2219,1665,126,126,252,50.0%,31m
37899,1,Bob,2219,1724,69,57,126,54.8%,46m
37899,1,SconeBoy,2219,1360,61,50,111,55.0%,3h
37899,1,Azkaal,2219,891,47,41,88,53.4%,53m
37899,1,UniverseL,2219,509,24,18,42,57.1%,60m
37899,3,[niBBaz]McBrownie,2219,532,18,27,45,40.0%,1m
37899,1,[SoCh1]thecurl,2219,403,13,11,24,54.2%,3h
37899,1,[Atena]JoãoPaulo,2219,380,10,15,25,40.0%,3h
37899,1,banzai,2219,344,9,10,19,47.4%,2m
37899,1,[fancyb]brottage,2219,310,8,8,16,50.0%,1h
37899,1,LuckThirteen,2219,285,8,11,19,42.1%,51m
37899,1,aleden,2219,103,6,2,8,75.0%,39m
37899,1,[RatsPE]carkll,2219,256,6,12,18,33.3%,34m
37899,1,[CWF]JeangamerXD,2219,154,4,4,8,50.0%,3h
37899,1,[McGiby]Praxis,2219,122,4,7,11,36.4%,3h
37899,1,Broth,2219,128,4,9,13,30.8%,31m
37899,1,Ravec,2219,104,2,1,3,66.7%,57m
37899,1,eltioemilio,2219,42,2,3,5,40.0%,21m
37899,1,[Meuh]SillyWilly,2219,0,2,5,7,28.6%,1h
37899,1,ShinobI,2219,0,1,0,1,100.0%,40m
37899,1,brogrimfall,2219,0,1,3,4,25.0%,3h
37899,1,MadVolf,2219,44,1,5,6,16.7%,60m
37899,1,lyle,2219,0,1,5,6,16.7%,2m
37899,3,ACE,2219,0,1,7,8,12.5%,3h
37899,2,SABYSALAS,2219,0,0,1,1,0.0%,1h
37899,1,[KANGS]TalkShlt,2219,73,0,3,3,0.0%,3h
37899,1,[RkGang]Hijack,2219,0,0,3,3,0.0%,3h
37926,3,Bariumenemy,2218,1510,546,562,1108,49.3%,1h
37926,1,Pendragon,2218,1660,107,103,210,51.0%,57m
37926,1,TaBorQt,2218,1557,69,60,129,53.5%,27m
37926,1,Resickulous,2218,1654,68,65,133,51.1%,1h
37926,1,HUGH,2218,1127,40,46,86,46.5%,25m
37926,3,GNIVRY,2218,655,37,39,76,48.7%,1h
37926,1,[S1MPZ]Zinclord,2218,1041,31,36,67,46.3%,57m
37926,1,[40oztF]Dominus,2218,753,28,25,53,52.8%,3h
37926,1,Pakdhe,2218,682,22,19,41,53.7%,3h
37926,3,Weezer,2218,238,9,16,25,36.0%,12m
37926,1,FrenzyMaster,2218,363,8,14,22,36.4%,3h
37926,1,pipat,2218,156,8,15,23,34.8%,37m
37926,1,[KAD3]Lavo,2218,280,7,8,15,46.7%,43m
37926,1,CDRCC,2218,276,7,12,19,36.8%,3h
37926,3,arkantos,2218,216,6,7,13,46.2%,1h
37926,1,FilthyBeaver,2218,56,6,22,28,21.4%,18m
37926,1,[FaD]Dravidian,2218,271,5,10,15,33.3%,3m
37926,1,[DRKDNA]Lythander,2218,128,4,8,12,33.3%,3h
37926,1,[xDPx]Visceral,2218,78,3,3,6,50.0%,1h
37926,1,ENKI,2218,88,3,4,7,42.9%,1h
37926,1,Phoenix,2218,107,2,1,3,66.7%,5m
37926,2,Hapo,2218,110,2,7,9,22.2%,3h
37926,1,zippykillr,2218,34,2,7,9,22.2%,3h
37926,1,BattleDruxs,2218,90,1,1,2,50.0%,3h
37926,1,[CmrK]ficaball,2218,0,1,3,4,25.0%,1h
37926,1,SAGIL,2218,0,1,5,6,16.7%,3h
37926,1,Kralin,2218,0,1,5,6,16.7%,5m
37926,3,Kaltmacher,2218,0,1,13,14,7.1%,1h
37926,1,Protoss,2218,0,0,2,2,0.0%,4m
37926,3,Ethan,2218,0,0,4,4,0.0%,49m
37926,1,zeroarea,2218,0,0,6,6,0.0%,1h
37957,1,MIAMI,2217,1466,161,156,317,50.8%,3h
37957,3,baldzordxion,2217,1572,117,122,239,49.0%,1h
37957,1,NatorNZ,2217,830,38,23,61,62.3%,1h
37957,3,Perovskite,2217,759,26,33,59,44.1%,27m
37957,1,Halfbroken,2217,738,23,25,48,47.9%,3h
37957,1,[EXØDUS]Jezza,2217,559,21,16,37,56.8%,3h
37957,1,fragile,2217,282,7,9,16,43.8%,2m
37957,1,NTX,2217,200,7,11,18,38.9%,3h
37957,1,KEPO,2217,202,6,4,10,60.0%,2m
37957,1,cody,2217,138,5,0,5,100.0%,40m
37957,3,Wildernsmike,2217,112,4,6,10,40.0%,3h
37957,1,HUSARZ,2217,131,3,1,4,75.0%,37m
37957,1,wickedftw,2217,80,3,6,9,33.3%,42m
37957,3,Sebastianix,2217,60,3,7,10,30.0%,45m
37957,1,[5X5]Losermobile,2217,154,3,11,14,21.4%,3h
37957,1,HierarchAdun,2217,89,2,0,2,100.0%,1h
37957,1,KageS,2217,0,2,3,5,40.0%,3h
37957,1,Joragi,2217,0,1,3,4,25.0%,1h
37957,1,valerii,2217,0,1,5,6,16.7%,7m
37957,1,kirlionik,2217,91,1,6,7,14.3%,3h
37957,1,ROGER,2217,0,1,6,7,14.3%,3h
37957,1,[Rogg]Thundercatol,2217,0,0,1,1,0.0%,3h
37957,3,Lava,2217,0,0,1,1,0.0%,35m
37957,1,[wertb]AmigoCastor,2217,0,0,1,1,0.0%,3h
37957,3,RagnarokSoul,2217,0,0,2,2,0.0%,10m
37982,1,turbo,2216,1651,81,80,161,50.3%,58m
37982,3,GoMarines,2216,626,78,81,159,49.1%,1h
37982,1,LightofAiur,2216,1409,53,57,110,48.2%,3h
37982,1,MasterKill,2216,1076,46,41,87,52.9%,40m
37982,1,Kamilna,2216,583,26,30,56,46.4%,3h
37982,1,Mondragon,2216,790,24,28,52,46.2%,3h
37982,1,Chickenskin,2216,712,23,21,44,52.3%,3h
37982,1,Nech,2216,499,22,23,45,48.9%,57m
37982,1,[LoShay]NachoCapony,2216,671,21,20,41,51.2%,35m
37982,2,LiVE,2216,641,21,32,53,39.6%,7m
37982,1,GhostMFCome,2216,310,12,15,27,44.4%,3h
37982,1,Dohko,2216,278,10,11,21,47.6%,3h
37982,3,bitsden,2216,260,7,11,18,38.9%,35m
37982,1,Terminator,2216,232,7,12,19,36.8%,3h
37982,2,Sam,2216,187,7,13,20,35.0%,3h
37982,3,[TJoker]System,2216,220,7,15,22,31.8%,1h
37982,1,[OlNA]Olimpos,2216,259,6,14,20,30.0%,57m
37982,1,Riff,2216,197,5,4,9,55.6%,46m
37982,1,bLEECH,2216,159,5,8,13,38.5%,3h
37982,1,Someone,2216,186,5,9,14,35.7%,5m
37982,1,[GOPERÚ]Nagato,2216,74,3,5,8,37.5%,1h
37982,1,[DSAL]GOLIAT,2216,48,2,5,7,28.6%,1h
37982,1,Thesuperamo,2216,97,2,6,8,25.0%,8m
37982,1,WHYerenWHY,2216,0,1,0,1,100.0%,3h
37982,1,[ME123]Crowd,2216,0,1,1,2,50.0%,13m
37982,1,Captivated,2216,96,1,2,3,33.3%,30m
37982,1,kser,2216,48,1,2,3,33.3%,14m
37982,1,SumOneBetta,2216,40,1,4,5,20.0%,1h
37982,1,ETorpedo,2216,0,1,5,6,16.7%,3h
37982,1,corb,2216,0,1,6,7,14.3%,3h
37982,1,[DhZAc1]NTnikc,2216,0,0,1,1,0.0%,38m
37982,1,[sk3tch]popeye,2216,0,0,2,2,0.0%,6m
37982,1,ChrisK,2216,0,0,2,2,0.0%,3h
37982,1,[ALTF04]Elsopas,2216,0,0,4,4,0.0%,3h
38016,3,[VEoC]GIGANTOR,2215,1560,218,227,445,49.0%,11m
38016,1,NoobForLife,2215,1517,155,139,294,52.7%,3h
38016,3,[AZN4BL]Appa,2215,1166,75,81,156,48.1%,1h
38016,1,miguelkarman,2215,917,61,55,116,52.6%,15m
38016,1,ArnoldANF,2215,1289,47,47,94,50.0%,51m
38016,3,[SANGRE]darmtres,2215,1192,44,56,100,44.0%,1h
38016,1,RECON,2215,831,36,29,65,55.4%,39m
38016,1,[LY]ARCANGEL,2215,754,25,26,51,49.0%,1h
38016,1,Brahms,2215,618,24,19,43,55.8%,1h
38016,1,Miojo,2215,373,14,20,34,41.2%,3h
38016,1,[nieBla]Skaði,2215,448,13,16,29,44.8%,1h
38016,1,YouNeedLube,2215,306,12,10,22,54.5%,3h
38016,2,Emilia,2215,186,9,6,15,60.0%,21m
38016,1,Tag,2215,275,9,10,19,47.4%,39m
38016,1,AverageJoe,2215,310,9,17,26,34.6%,46m
38016,1,xLetzulx,2215,164,6,9,15,40.0%,3h
38016,1,Heroxilies,2215,191,5,5,10,50.0%,6m
38016,1,Zergling,2215,138,5,9,14,35.7%,3h
38016,1,fenix,2215,108,4,1,5,80.0%,55m
38016,1,Nero,2215,157,3,5,8,37.5%,16m
38016,1,ZukuPollo,2215,124,3,7,10,30.0%,31m
38016,1,ianomictin,2215,124,2,2,4,50.0%,41m
38016,2,owie,2215,90,2,9,11,18.2%,31m
38016,1,Hiken,2215,0,1,0,1,100.0%,35m
38016,1,Eliasdguezr,2215,0,1,1,2,50.0%,1h
38016,1,Ammasu,2215,88,1,1,2,50.0%,3h
38016,2,bjj,2215,88,1,4,5,20.0%,3h
38016,1,[BgBear]ATHINGA,2215,0,1,5,6,16.7%,5m
38016,1,[2pz2ez]maelstrom,2215,0,0,1,1,0.0%,3h
38016,1,Shervert,2215,0,0,1,1,0.0%,3h
38016,1,Lasidar,2215,0,0,3,3,0.0%,3h
38016,2,broxus,2215,0,0,5,5,0.0%,60m
38048,3,LAXMAN,2214,1562,166,175,341,48.7%,1h
38048,1,oioi,2214,1796,110,112,222,49.5%,3h
38048,1,Intrasync,2214,1308,98,91,189,51.9%,1h
38048,1,ChrisGriffin,2214,1257,91,85,176,51.7%,3h
38048,1,Raynor,2214,1749,77,69,146,52.7%,1h
38048,1,iiiiiiiiiiii,2214,1418,68,55,123,55.3%,3h
38048,1,windowpane,2214,790,54,46,100,54.0%,1h
38048,1,MOhawk,2214,708,28,22,50,56.0%,57m
38048,1,kksjfkl,2214,488,15,17,32,46.9%,37m
38048,1,grizzlyadams,2214,466,14,14,28,50.0%,3h
38048,1,isocubed,2214,538,14,16,30,46.7%,1h
38048,1,YourDemise,2214,468,12,13,25,48.0%,1h
38048,1,thrasher,2214,359,12,17,29,41.4%,1h
38048,1,SENSUI,2214,230,8,6,14,57.1%,3h
38048,1,Wargian,2214,312,8,10,18,44.4%,57m
38048,1,KhalDrog,2214,137,3,3,6,50.0%,31m
38048,1,ppsmalls,2214,132,3,3,6,50.0%,1h
38048,1,bruuuuh,2214,168,3,7,10,30.0%,3h
38048,1,Jose,2214,86,3,8,11,27.3%,8m
38048,3,KermitDaFrog,2214,121,2,1,3,66.7%,1h
38048,1,JakeRyan,2214,123,2,2,4,50.0%,3h
38048,1,DJDecker,2214,111,2,3,5,40.0%,3h
38048,1,bitfighter,2214,0,2,3,5,40.0%,1h
38048,1,Heddie,2214,0,1,0,1,100.0%,3h
38048,1,BrodyRatchet,2214,0,1,0,1,100.0%,48m
38048,1,WILLYARIEL,2214,90,1,1,2,50.0%,60m
38048,1,thorswrath,2214,0,1,5,6,16.7%,5m
38048,1,WTMN,2214,0,0,1,1,0.0%,3h
38048,3,Ares,2214,0,0,2,2,0.0%,1h
38048,1,ORIN,2214,0,0,2,2,0.0%,35m
38048,2,coopalooper,2214,0,0,2,2,0.0%,1h
38048,3,Frisk,2214,0,0,3,3,0.0%,1h
38080,1,marcosgbc,2213,1764,154,159,313,49.2%,15m
38080,3,Rick,2213,1499,144,152,296,48.6%,16m
38080,1,[Lp]Gatosensual,2213,1580,85,91,176,48.3%,39m
38080,2,Nihilum,2213,621,53,69,122,43.4%,1h
38080,1,NazgulBlazin,2213,729,35,43,78,44.9%,1h
38080,1,YeahItsPanda,2213,621,29,16,45,64.4%,22m
38080,2,[EpicG]Sovereign,2213,574,25,20,45,55.6%,39m
38080,1,[FK0USA]FkTrump,2213,411,23,18,41,56.1%,1h
38080,1,[CBAS2]AimbotEcho,2213,667,21,25,46,45.7%,37m
38080,1,Wizzleli,2213,623,20,14,34,58.8%,3h
38080,3,Brannigan,2213,500,19,27,46,41.3%,30m
38080,3,pipoca,2213,300,17,26,43,39.5%,29m
38080,1,MadBoy,2213,380,13,13,26,50.0%,1h
38080,1,alex,2213,321,10,6,16,62.5%,35m
38080,1,Moonkhalifa,2213,205,7,8,15,46.7%,3h
38080,1,Tuzain,2213,132,6,8,14,42.9%,42m
38080,2,Pizzagoat,2213,78,6,9,15,40.0%,35m
38080,2,MrBangoJango,2213,198,6,14,20,30.0%,1h
38080,1,hectorconcar,2213,192,5,10,15,33.3%,19m
38080,3,Labadiena,2213,30,4,5,9,44.4%,1h
38080,3,tuscawaras,2213,153,4,10,14,28.6%,19m
38080,2,Alik,2213,76,3,0,3,100.0%,3m
38080,2,[CUCO]Hardcorex,2213,72,3,1,4,75.0%,3h
38080,1,SimbaSC,2213,84,3,5,8,37.5%,1h
38080,1,LOCOTAKU,2213,124,3,5,8,37.5%,1h
38080,1,FiftyBliss,2213,120,2,2,4,50.0%,41m
38080,2,Roleiz,2213,0,2,3,5,40.0%,3h
38080,3,BeefyWeefiez,2213,0,2,8,10,20.0%,25m
38080,2,Smalls,2213,0,1,0,1,100.0%,3h
38080,1,ElPalomoxD,2213,0,1,0,1,100.0%,8m
38080,2,SeñorSandia,2213,0,1,0,1,100.0%,3h
38080,1,Vrael,2213,0,1,1,2,50.0%,35m
38080,2,migatte,2213,0,1,1,2,50.0%,60m
38080,1,KrimsonIce,2213,0,1,2,3,33.3%,31m
38080,1,Milton,2213,38,1,2,3,33.3%,1h
38080,2,NATANOSS,2213,0,0,1,1,0.0%,3h
38080,2,nightblood,2213,0,0,1,1,0.0%,32m
38080,2,[Boboyz]SteveCherry,2213,0,0,1,1,0.0%,1h
38080,1,Grimi,2213,0,0,2,2,0.0%,31m
38080,1,Peni,2213,0,0,3,3,0.0%,8m
38120,1,Synthroid,2212,1804,352,362,714,49.3%,50m
38120,3,Anh,2212,1438,263,248,511,51.5%,7m
38120,1,kubo,2212,1637,93,100,193,48.2%,5m
38120,1,Vinngeance,2212,1714,85,72,157,54.1%,45m
38120,2,Armagelipsis,2212,1315,55,53,108,50.9%,3h
38120,1,GabrielP,2212,722,27,21,48,56.2%,43m
38120,1,Beeper,2212,715,24,25,49,49.0%,1h
38120,3,zarchon,2212,568,21,24,45,46.7%,1h
38120,1,Johann,2212,624,20,27,47,42.6%,10m
38120,1,[Danilo]XeraMeuOvo,2212,547,16,13,29,55.2%,6m
38120,3,RyanCannibal,2212,402,15,20,35,42.9%,51m
38120,2,Terranize,2212,337,12,17,29,41.4%,21m
38120,1,tony,2212,294,10,10,20,50.0%,1h
38120,1,AirForcE,2212,294,9,13,22,40.9%,48m
38120,3,StarLegions,2212,96,8,3,11,72.7%,44m
38120,2,kennedysynd,2212,218,7,13,20,35.0%,3h
38120,3,OCamden,2212,194,6,4,10,60.0%,15m
38120,1,Tsukune,2212,174,6,5,11,54.5%,17m
38120,1,Georges,2212,190,5,8,13,38.5%,8m
38120,2,Sunshine,2212,172,4,8,12,33.3%,24m
38120,1,Sulli,2212,144,4,10,14,28.6%,58m
38120,1,[ZergW]Fad,2212,40,3,6,9,33.3%,46m
38120,2,STARWORLD,2212,30,3,9,12,25.0%,1h
38120,1,Deller,2212,131,2,2,4,50.0%,43m
38120,1,Thrang,2212,44,2,5,7,28.6%,3h
38120,3,[HRLOCA]DeiAurea,2212,58,2,9,11,18.2%,1h
38120,3,jimpop,2212,0,1,1,2,50.0%,1h
38120,2,Bucktruck,2212,48,1,2,3,33.3%,1h
38120,3,[AN4I]MartinSsempa,2212,0,1,6,7,14.3%,3h
38120,1,Yannis,2212,0,1,7,8,12.5%,55m
38150,3,[QcWars]Rambosixnine,2211,1511,101,101,202,50.0%,1h
38150,1,mcthepro,2211,1328,68,71,139,48.9%,3h
38150,1,strikereurek,2211,895,38,27,65,58.5%,48m
38150,2,Staeron,2211,805,29,47,76,38.2%,1h
38150,1,KnobGoblin,2211,920,27,27,54,50.0%,3h
38150,1,Darktears,2211,647,21,26,47,44.7%,7m
38150,2,[iar]AcousticZues,2211,498,16,20,36,44.4%,3h
38150,1,FreezeReaper,2211,546,16,21,37,43.2%,57m
38150,2,baladanelson,2211,385,14,14,28,50.0%,1h
38150,3,[RAND0M]Juxtapolemic,2211,202,12,30,42,28.6%,16m
38150,3,BillMurray,2211,146,7,16,23,30.4%,42m
38150,2,CRIXUS,2211,0,4,4,8,50.0%,9m
38150,2,[R4NK3D]DEVILTARI,2211,98,3,4,7,42.9%,3h
38150,2,Kezerg,2211,30,2,0,2,100.0%,3h
38150,1,[GushMu]Sanguran,2211,48,2,6,8,25.0%,35m
38150,2,Ace,2211,0,0,1,1,0.0%,48m
38150,1,HokuPaniolo,2211,0,0,3,3,0.0%,3h
38150,1,binho,2211,0,0,3,3,0.0%,31m
38168,1,MathFerret,2210,1404,52,40,92,56.5%,3h
38168,1,Theodore,2210,1159,52,59,111,46.8%,60m
38168,3,[FatMom]Jason,2210,1212,46,58,104,44.2%,1h
38168,2,Sentree,2210,980,35,32,67,52.2%,1h
38168,1,[phofu]tht,2210,667,26,19,45,57.8%,13m
38168,2,Northside,2210,440,16,24,40,40.0%,3h
38168,1,MrMario,2210,276,13,13,26,50.0%,50m
38168,3,PatientBEAR,2210,242,10,14,24,41.7%,6m
38168,2,DrBeans,2210,279,8,8,16,50.0%,32m
38168,3,Conqueror,2210,164,8,13,21,38.1%,34m
38168,1,[TGCrew]fadedspecter,2210,144,6,6,12,50.0%,15m
38168,2,Max,2210,144,5,8,13,38.5%,3h
38168,3,clouddxv,2210,30,4,5,9,44.4%,3h
38168,1,IceyaHo,2210,214,4,6,10,40.0%,43m
38168,1,TRUMP,2210,168,4,9,13,30.8%,3h
38168,2,DevilDany,2210,74,3,1,4,75.0%,10m
38168,1,juggernaught,2210,72,3,2,5,60.0%,3h
38168,2,Lighwave,2210,70,2,1,3,66.7%,48m
38168,1,Ossim,2210,97,2,1,3,66.7%,15m
38168,2,[ClanHs]DreaMy,2210,0,2,8,10,20.0%,47m
38168,2,MissSahar,2210,30,1,1,2,50.0%,42m
38168,3,[XxPwnX]LLShadowsX,2210,34,1,5,6,16.7%,3h
38168,1,Minato,2210,0,1,5,6,16.7%,43m
38168,1,DaroLisko,2210,0,1,5,6,16.7%,1h
38168,2,Nexwap,2210,0,0,1,1,0.0%,12m
38168,2,spacewolf,2210,0,0,1,1,0.0%,1h
38168,2,lukitzu,2210,0,0,1,1,0.0%,1h
38168,1,RedComet,2210,0,0,2,2,0.0%,8m
38196,1,bmxfreebird,2209,1803,106,114,220,48.2%,3h
38196,1,LEONRAGNAR,2209,1630,87,83,170,51.2%,10m
38196,1,GitGot,2209,1627,84,62,146,57.5%,42m
38196,1,Mosko,2209,1097,48,41,89,53.9%,37m
38196,1,JAVI,2209,1012,38,35,73,52.1%,41m
38196,3,wolfcasl,2209,842,37,49,86,43.0%,35m
38196,2,Jilian,2209,838,32,26,58,55.2%,17m
38196,1,HNetty,2209,829,27,24,51,52.9%,60m
38196,1,Blue,2209,486,22,28,50,44.0%,1h
38196,1,AutoNooB,2209,611,19,25,44,43.2%,2m
38196,1,KARATESOLO,2209,598,16,21,37,43.2%,23m
38196,1,Leefunnn,2209,412,13,13,26,50.0%,44m
38196,1,erick,2209,207,8,8,16,50.0%,3h
38196,3,QESOconPAPA,2209,200,7,19,26,26.9%,3h
38196,2,Mydogsmia,2209,202,6,0,6,100.0%,36m
38196,1,JodFour,2209,238,6,2,8,75.0%,1h
38196,1,asdfwqer,2209,120,6,13,19,31.6%,16m
38196,1,Alank,2209,116,4,4,8,50.0%,3h
38196,1,Yough,2209,157,4,10,14,28.6%,58m
38196,2,Jebodiah,2209,66,3,1,4,75.0%,13m
38196,2,Pedrojhc,2209,96,2,4,6,33.3%,1h
38196,1,Jae,2209,94,2,5,7,28.6%,3h
38196,1,BigPoocky,2209,42,1,4,5,20.0%,44m
38196,1,MoeMoe,2209,48,1,4,5,20.0%,20m
38196,1,tiberius,2209,40,1,5,6,16.7%,3h
38196,1,terranstico,2209,0,1,5,6,16.7%,1h
38196,1,buttonio,2209,91,1,6,7,14.3%,3h
38196,1,[Seps]MasterFish,2209,0,0,1,1,0.0%,3h
38196,2,MitchPar,2209,0,0,1,1,0.0%,1h
38196,1,blkflash,2209,0,0,2,2,0.0%,1h
38196,1,Wayne,2209,0,0,2,2,0.0%,3h
38196,2,Malthael,2209,0,0,5,5,0.0%,1h
38196,2,MicroniCs,2209,0,0,5,5,0.0%,3h
38229,2,Veratek,2208,1541,293,308,601,48.8%,3h
38229,1,Lux,2208,1772,146,144,290,50.3%,44m
38229,1,SgtFluffy,2208,1745,106,96,202,52.5%,3h
38229,1,NateDogg,2208,1737,102,93,195,52.3%,3h
38229,2,SHCO,2208,823,63,28,91,69.2%,3h
38229,1,CCCP,2208,745,44,47,91,48.4%,55m
38229,1,Chuck,2208,775,32,44,76,42.1%,1h
38229,3,ChilenoSinga,2208,383,14,20,34,41.2%,1h
38229,1,BigBoss,2208,284,7,7,14,50.0%,51m
38229,2,thepredator,2208,174,7,10,17,41.2%,42m
38229,1,IVDenisovich,2208,184,6,7,13,46.2%,3h
38229,2,CazadorFalso,2208,100,4,0,4,100.0%,3h
38229,2,canavaro,2208,64,4,3,7,57.1%,3h
38229,2,[DETER]Ohbey,2208,94,3,0,3,100.0%,9m
38229,1,AngelofLight,2208,86,3,8,11,27.3%,2m
38229,1,Falken,2208,80,3,9,12,25.0%,1h
38229,3,KiLLer,2208,122,2,5,7,28.6%,1h
38229,1,[GTQMV]Moultronn,2208,0,1,1,2,50.0%,5m
38229,1,Stranger,2208,38,1,4,5,20.0%,51m
38229,2,cybertronph,2208,0,1,4,5,20.0%,3h
38229,1,[Cytus2]NaRang,2208,0,1,4,5,20.0%,5m
38229,1,LucksWithMe,2208,0,1,5,6,16.7%,3h
38229,1,Jonathan,2208,0,1,5,6,16.7%,1h
38229,2,ImaDrag,2208,34,1,5,6,16.7%,3h
38229,2,[ffaaak]raven,2208,0,0,3,3,0.0%,1h
38229,1,[BCRUSE]FredFred,2208,0,0,3,3,0.0%,6m
38255,1,HastyFERN,2207,1658,71,73,144,49.3%,1h
38255,1,[INKA5]abathur,2207,1269,48,50,98,49.0%,1h
38255,1,Tre,2207,889,33,38,71,46.5%,50m
38255,1,Purpura,2207,359,24,19,43,55.8%,3h
38255,1,LegitBrit,2207,571,20,18,38,52.6%,3h
38255,2,Kousei,2207,378,17,17,34,50.0%,1h
38255,1,Biff,2207,412,12,17,29,41.4%,1h
38255,1,SamuraiJack,2207,331,11,14,25,44.0%,3h
38255,1,FoolOfATook,2207,299,10,8,18,55.6%,48m
38255,1,flyeversheep,2207,343,10,14,24,41.7%,3h
38255,1,JPG,2207,362,9,9,18,50.0%,3h
38255,1,Alex,2207,269,9,10,19,47.4%,1h
38255,2,STORM,2207,205,5,4,9,55.6%,3h
38255,1,StarGunner,2207,196,5,9,14,35.7%,1h
38255,2,DrKallet,2207,132,4,2,6,66.7%,47m
38255,3,dishplacemat,2207,151,4,9,13,30.8%,3h
38255,1,NocTuM,2207,181,4,10,14,28.6%,3h
38255,1,AlpinexQc,2207,82,3,7,10,30.0%,3h
38255,1,destroyer,2207,30,2,1,3,66.7%,1h
38255,2,[4aRaza]Koagulo,2207,30,2,1,3,66.7%,3h
38255,1,WrongAnswer,2207,33,2,2,4,50.0%,1h
38255,1,[LBanda]Cris,2207,89,2,3,5,40.0%,1h
38255,3,[SGxx]sly,2207,97,2,7,9,22.2%,1h
38255,3,GreyFox,2207,0,2,7,9,22.2%,1h
38255,1,aeda,2207,48,2,7,9,22.2%,9m
38255,1,MARIOtaylor,2207,0,1,4,5,20.0%,3h
38255,2,bobe,2207,0,1,4,5,20.0%,9m
38255,2,[Xeroz]PANZER,2207,30,1,5,6,16.7%,3h
38255,2,[CatMou]alex,2207,48,1,5,6,16.7%,49m
38255,1,Skywalker,2207,0,1,6,7,14.3%,39m
38255,1,FireBladeL,2207,0,0,1,1,0.0%,1h
38255,1,conor,2207,0,0,1,1,0.0%,3h
38287,1,[GrW]Nub,2206,1592,148,152,300,49.3%,1h
38287,1,nolimills,2206,1790,129,133,262,49.2%,1h
38287,1,Zortag,2206,1289,74,79,153,48.4%,3h
38287,1,BelonMe,2206,991,60,57,117,51.3%,1h
38287,1,[D3MON]Jestorick,2206,1234,42,48,90,46.7%,34m
38287,1,DanteInferno,2206,975,36,37,73,49.3%,1h
38287,1,Kuj,2206,627,34,30,64,53.1%,3h
38287,3,Nooze,2206,319,26,29,55,47.3%,22m
38287,1,[SSkull]TDAUE,2206,630,20,18,38,52.6%,46m
38287,1,GHINGADOR,2206,630,19,22,41,46.3%,53m
38287,1,Ares,2206,574,17,22,39,43.6%,37m
38287,1,LightWolf,2206,588,17,22,39,43.6%,45m
38287,1,cityhunter,2206,542,16,22,38,42.1%,3h
38287,2,lileiva,2206,322,13,6,19,68.4%,3h
38287,2,Waldomani,2206,288,9,5,14,64.3%,4m
38287,3,inombrableDD,2206,193,5,7,12,41.7%,1h
38287,1,WDNMD,2206,141,4,5,9,44.4%,3h
38287,1,Dharma,2206,191,4,8,12,33.3%,3h
38287,1,JotitaChan,2206,90,3,7,10,30.0%,6m
38287,2,Calamity,2206,158,3,9,12,25.0%,21m
38287,2,ELCAB,2206,64,2,1,3,66.7%,3h
38287,3,andric,2206,30,2,9,11,18.2%,1h
38287,1,Dekoba,2206,0,1,1,2,50.0%,15m
38287,2,Ivl,2206,30,1,5,6,16.7%,54m
38287,2,[Zeus17]Braincool,2206,0,0,1,1,0.0%,31m
38287,2,kelso,2206,0,0,1,1,0.0%,1h
38287,1,JrRappa,2206,0,0,2,2,0.0%,3h
38314,2,SpidermanXXL,2205,775,196,211,407,48.2%,9m
38314,1,[b1azin]NukeDaddy,2205,1199,117,117,234,50.0%,44m
38314,1,Redoblante,2205,1294,48,62,110,43.6%,3h
38314,1,[MaxWin]tychoon,2205,881,43,39,82,52.4%,40m
38314,2,[PrA1]UnexHeuer,2205,1161,43,46,89,48.3%,3h
38314,1,bigacend,2205,377,14,14,28,50.0%,3h
38314,2,[xMETAx]GavaBoo,2205,381,14,23,37,37.8%,1h
38314,1,turron,2205,293,12,8,20,60.0%,51m
38314,1,PBU,2205,352,9,10,19,47.4%,1h
38314,1,Elendil,2205,306,8,13,21,38.1%,34m
38314,1,revolt,2205,194,5,11,16,31.2%,3h
38314,1,Azatol,2205,38,4,4,8,50.0%,1h
38314,1,[SWOU]Breaker,2205,42,3,5,8,37.5%,3h
38314,3,xXLordZedXx,2205,129,3,8,11,27.3%,1h
38314,2,WhitePhantom,2205,0,1,0,1,100.0%,1h
38314,2,Jhery,2205,0,1,2,3,33.3%,1h
38330,3,[DiPSeT]VitaminTHCK,2204,1165,182,194,376,48.4%,49m
38330,3,Lumpia,2204,1041,99,99,198,50.0%,30m
38330,1,ByAndres,2204,1219,53,38,91,58.2%,3h
38330,3,HumaNoid,2204,495,30,32,62,48.4%,1h
38330,2,[0825]Bubblez,2204,408,23,18,41,56.1%,3h
38330,1,[RaVEC]bruniho,2204,328,10,12,22,45.5%,44m
38330,2,JACKLON,2204,230,8,5,13,61.5%,3h
38330,2,Balisongman,2204,242,8,16,24,33.3%,1h
38330,2,petetheheat,2204,124,5,3,8,62.5%,12m
38330,1,Fantasmacr,2204,200,5,13,18,27.8%,60m
38330,1,Mayday,2204,132,4,5,9,44.4%,53m
38330,1,Insecc,2204,88,2,1,3,66.7%,3h
38330,1,Cyclone,2204,44,2,2,4,50.0%,1h
38330,2,hbbaboy,2204,0,1,0,1,100.0%,17m
38330,2,[EpicG]King,2204,30,1,5,6,16.7%,1h
38330,1,Edein,2204,0,0,2,2,0.0%,3h
38346,1,Ozram,2203,1657,162,164,326,49.7%,3h
38346,1,kemikim,2203,1701,109,111,220,49.5%,1h
38346,1,Juno,2203,1281,74,72,146,50.7%,3h
38346,1,jean,2203,1308,62,62,124,50.0%,3h
38346,1,KimchiJuice,2203,816,26,28,54,48.1%,21m
38346,1,felipexx,2203,700,25,26,51,49.0%,46m
38346,1,Billy,2203,653,24,22,46,52.2%,3h
38346,1,VanWalker,2203,481,16,15,31,51.6%,51m
38346,1,PondWood,2203,303,10,20,30,33.3%,26m
38346,2,[Zanis]EpicLeonel,2203,188,6,2,8,75.0%,3h
38346,1,Blueskull,2203,231,6,13,19,31.6%,1h
38346,1,Smiley,2203,188,4,7,11,36.4%,55m
38346,1,BRCancun,2203,113,3,2,5,60.0%,1h
38346,1,uncleDumDum,2203,114,3,5,8,37.5%,23m
38346,1,MtnMan,2203,96,3,8,11,27.3%,1h
38346,3,ButterflyFX,2203,0,1,0,1,100.0%,1h
38346,1,Mose,2203,0,1,1,2,50.0%,16m
38346,3,matracas,2203,97,1,3,4,25.0%,56m
38346,2,theviper,2203,0,1,4,5,20.0%,24m
38346,1,MalcolmXmas,2203,0,1,7,8,12.5%,1h
38346,1,ApT,2203,0,0,1,1,0.0%,3h
38346,1,Aydo,2203,0,0,2,2,0.0%,1h
38346,2,xel,2203,0,0,5,5,0.0%,56m
38369,1,[Voyage]CaptainDOTd,2202,1520,158,157,315,50.2%,1h
38369,1,[MMSTAR]tommyrod,2202,980,60,34,94,63.8%,1h
38369,1,[CRAKS]cavb,2202,1043,44,43,87,50.6%,60m
38369,1,Buck,2202,1132,43,42,85,50.6%,1h
38369,1,easytime,2202,988,37,38,75,49.3%,1h
38369,1,eggsaisle,2202,835,31,22,53,58.5%,8m
38369,2,LittleChance,2202,372,12,13,25,48.0%,19m
38369,1,[MKING]ZERO,2202,301,10,15,25,40.0%,1h
38369,1,Murakami,2202,234,9,12,21,42.9%,41m
38369,1,TheMustach,2202,324,9,16,25,36.0%,2m
38369,1,SuppliedWing,2202,230,8,7,15,53.3%,47m
38369,1,Braden,2202,240,8,9,17,47.1%,7m
38369,1,[LoE1]BRUServer,2202,194,6,6,12,50.0%,1h
38369,1,GrayToar,2202,32,4,4,8,50.0%,3h
38369,1,STRANGEE,2202,154,4,5,9,44.4%,40m
38369,1,Ghandee,2202,114,3,3,6,50.0%,48m
38369,3,codabear,2202,149,3,5,8,37.5%,1h
38369,2,nano,2202,30,2,0,2,100.0%,3h
38369,1,Sprinklepie,2202,42,2,4,6,33.3%,3h
38369,2,[TerPro]Deunnopalazo,2202,0,1,0,1,100.0%,14m
38369,1,natel,2202,0,1,1,2,50.0%,20m
38369,2,Jay,2202,0,1,4,5,20.0%,10m
38369,2,Player,2202,0,1,4,5,20.0%,1h
38369,1,zzz,2202,0,1,5,6,16.7%,3h
38369,1,czuhc,2202,0,1,6,7,14.3%,6m
38369,2,Swagneto,2202,0,0,1,1,0.0%,10m
38369,2,[TCAMLO]jama,2202,0,0,1,1,0.0%,1h
38369,2,[Y4NG20]JohanV,2202,0,0,1,1,0.0%,3h
38369,2,[MLGAOS]MrGreen,2202,0,0,1,1,0.0%,48m
38369,1,DirtyWatah,2202,0,0,7,7,0.0%,1h
38399,2,ryany,2201,1496,316,315,631,50.1%,25m
38399,1,likmedik,2201,1566,112,126,238,47.1%,3h
38399,1,paelle,2201,1554,106,115,221,48.0%,3h
38399,1,konanIII,2201,1431,49,56,105,46.7%,14m
38399,1,XXXXXXXXXXXX,2201,1216,44,52,96,45.8%,2m
38399,1,LucidRem,2201,695,31,26,57,54.4%,17m
38399,1,SurpriseMF,2201,572,19,23,42,45.2%,26m
38399,1,lostradamus,2201,361,16,9,25,64.0%,10m
38399,1,NoObMove,2201,584,16,25,41,39.0%,15m
38399,1,DROWNALD,2201,432,15,14,29,51.7%,50m
38399,1,MikeSeaver,2201,220,14,22,36,38.9%,14m
38399,3,Blackout,2201,422,13,22,35,37.1%,2m
38399,3,DoomTune,2201,318,11,19,30,36.7%,3h
38399,1,Ace,2201,318,9,12,21,42.9%,3h
38399,1,[Buge]Shag,2201,280,8,11,19,42.1%,26m
38399,3,Entreri,2201,172,5,9,14,35.7%,3h
38399,3,APEX,2201,164,4,7,11,36.4%,3h
38399,1,Successor,2201,149,4,7,11,36.4%,37m
38399,3,[A30]Battousai,2201,173,4,8,12,33.3%,43m
38399,3,Destroyer,2201,123,3,2,5,60.0%,3h
38399,1,Willow,2201,96,3,8,11,27.3%,36m
38399,1,Morlo,2201,91,2,1,3,66.7%,3h
38399,1,BlueFlame,2201,0,2,5,7,28.6%,31m
38399,2,[TUFNUT]IROCJake,2201,92,2,6,8,25.0%,3h
38399,1,Andrew,2201,110,2,9,11,18.2%,3h
38399,2,[Trebol]Kikex,2201,0,1,0,1,100.0%,33m
38399,2,Eones,2201,0,1,0,1,100.0%,1h
38399,1,TheWarlord,2201,0,1,1,2,50.0%,3h
38399,1,MaTeO,2201,0,1,1,2,50.0%,1h
38399,1,Marcinhoz,2201,0,1,3,4,25.0%,1h
38399,2,ChrisDonDada,2201,0,0,1,1,0.0%,20m
38399,1,DadsLasagna,2201,0,0,2,2,0.0%,3h
38399,1,DarthBalls,2201,0,0,3,3,0.0%,5m
38399,1,PoKaiChu,2201,0,0,4,4,0.0%,48m
38433,2,Crouton,2200,1460,170,180,350,48.6%,45m
38433,1,[uwouwo]RedDevilJack,2200,1785,114,116,230,49.6%,3h
38433,1,FatYeti,2200,1698,89,80,169,52.7%,47m
38433,1,SamSung,2200,1017,52,39,91,57.1%,3h
38433,1,BravoONE,2200,638,51,40,91,56.0%,3h
38433,1,[RTHNB]amberlites,2200,1002,44,48,92,47.8%,1h
38433,1,huskiesaver,2200,794,34,29,63,54.0%,1h
38433,1,Wasabi,2200,695,31,17,48,64.6%,3h
38433,1,eif,2200,551,15,20,35,42.9%,3h
38433,1,[ShiPal]DrNexium,2200,424,12,18,30,40.0%,2m
38433,1,Legend,2200,313,11,9,20,55.0%,35m
38433,2,Smiley,2200,220,11,26,37,29.7%,1h
38433,1,[FxB]munchies,2200,272,10,5,15,66.7%,3h
38433,1,fluufy,2200,332,10,14,24,41.7%,58m
38433,1,AxJay,2200,451,10,21,31,32.3%,42m
38433,1,lazelot,2200,174,7,8,15,46.7%,15m
38433,1,[UAK]Deries,2200,264,7,11,18,38.9%,38m
38433,1,GUB,2200,216,6,10,16,37.5%,27m
38433,2,Chancellor,2200,30,5,5,10,50.0%,3h
38433,1,ShamanTrance,2200,0,4,6,10,40.0%,1h
38433,3,[ffaake]sakjgha,2200,124,3,8,11,27.3%,3h
38433,3,Wonerless,2200,62,3,9,12,25.0%,1h
38433,3,Floki,2200,151,3,12,15,20.0%,48m
38433,1,Morpheuz,2200,48,2,1,3,66.7%,1h
38433,1,Kreutz,2200,123,2,3,5,40.0%,1h
38433,2,xSpanki,2200,0,2,3,5,40.0%,3h
38433,1,Atu,2200,48,2,7,9,22.2%,3h
38433,2,[SPQR]Diam,2200,60,2,14,16,12.5%,1h
38433,2,[VFam2]ElArquiMx,2200,0,1,0,1,100.0%,28m
38433,2,TangoTN,2200,30,1,1,2,50.0%,3h
38433,2,caotuongvy,2200,0,0,1,1,0.0%,13m
38464,3,GRUMMY,2199,1446,201,199,400,50.2%,56m
38464,1,ChiruChiru,2199,1662,101,95,196,51.5%,15m
38464,1,UwU,2199,794,25,23,48,52.1%,1h
38464,3,Blümchen,2199,511,20,26,46,43.5%,3h
38464,2,Jake,2199,342,14,11,25,56.0%,1h
38464,1,Matam,2199,339,13,12,25,52.0%,3h
38464,1,SeaHam,2199,110,6,5,11,54.5%,1h
38464,1,[chomac]Drago,2199,228,6,10,16,37.5%,3h
38464,2,[R3J]Seifer,2199,209,6,12,18,33.3%,55m
38464,1,[LaCraG]Ferna,2199,215,5,0,5,100.0%,30m
38464,1,peteplantman,2199,96,5,9,14,35.7%,3h
38464,1,Motosai,2199,67,4,3,7,57.1%,1h
38464,1,cabomayonesa,2199,146,4,4,8,50.0%,14m
38464,2,KAISERX,2199,96,3,11,14,21.4%,40m
38464,2,EpicEOP,2199,36,2,0,2,100.0%,48m
38464,2,renorco,2199,38,1,2,3,33.3%,3h
38464,1,[DRU1DS]aaldwyn,2199,38,1,3,4,25.0%,1h
38464,1,John,2199,42,1,9,10,10.0%,3h
38464,2,sudoer,2199,0,0,1,1,0.0%,3h
38464,2,TacoFever,2199,0,0,1,1,0.0%,31m
38464,2,heyst,2199,0,0,1,1,0.0%,1h
38464,2,okboyok,2199,0,0,1,1,0.0%,34m
38464,1,defecapo,2199,0,0,3,3,0.0%,51m
38487,3,Carebear,2198,1460,228,240,468,48.7%,32m
38487,1,Assjooc,2198,1674,125,124,249,50.2%,37m
38487,1,DOOMSDAY,2198,1587,90,84,174,51.7%,3h
38487,1,HamesJarden,2198,1446,54,62,116,46.6%,2m
38487,1,JManter,2198,1127,37,38,75,49.3%,56m
38487,2,pocoyo,2198,858,34,31,65,52.3%,58m
38487,2,imhigh,2198,685,25,17,42,59.5%,1h
38487,2,Double,2198,620,23,30,53,43.4%,3h
38487,1,NotSure,2198,752,22,23,45,48.9%,51m
38487,1,Rivermender,2198,422,18,13,31,58.1%,3h
38487,1,Matter,2198,608,17,24,41,41.5%,40m
38487,3,Denzille,2198,450,14,20,34,41.2%,1h
38487,1,Green,2198,266,13,11,24,54.2%,3h
38487,1,[Maton]Ralf,2198,264,10,10,20,50.0%,3h
38487,2,Solipsist,2198,246,10,11,21,47.6%,1h
38487,2,LealFernandz,2198,230,7,8,15,46.7%,19m
38487,1,RRRMMM,2198,280,6,11,17,35.3%,1h
38487,1,AyeAye,2198,96,5,16,21,23.8%,3h
38487,1,Chandl,2198,162,4,6,10,40.0%,26m
38487,2,[BSW]Amatrake,2198,116,3,10,13,23.1%,3h
38487,1,[3v4]Jeff,2198,80,2,6,8,25.0%,46m
38487,2,SpeedRogue,2198,60,2,6,8,25.0%,18m
38487,1,Saimon,2198,0,1,1,2,50.0%,1h
38487,1,Caracarn,2198,0,1,2,3,33.3%,51m
38487,1,fastshadow,2198,0,1,6,7,14.3%,26m
38487,2,[DETER]Mowk,2198,0,0,1,1,0.0%,40m
38487,1,elnaveganteI,2198,0,0,2,2,0.0%,42m
38487,1,Doom,2198,0,0,2,2,0.0%,31m
38487,3,Paul,2198,0,0,3,3,0.0%,1h
38487,2,DELFIN,2198,0,0,5,5,0.0%,3h
38517,1,Krazynasty,2197,1301,53,56,109,48.6%,1h
38517,1,Firestoned,2197,1302,42,47,89,47.2%,16m
38517,1,SCUBASTEVE,2197,303,36,39,75,48.0%,1h
38517,1,Spartacus,2197,207,17,12,29,58.6%,21m
38517,2,ACE,2197,298,10,17,27,37.0%,3h
38517,2,Markalofagus,2197,229,9,3,12,75.0%,1h
38517,3,[SCxRH]TylerJohnson,2197,154,7,13,20,35.0%,25m
38517,2,ANGROD,2197,62,5,10,15,33.3%,3h
38517,2,aKaMaikol,2197,116,5,17,22,22.7%,4m
38517,2,[KBL]akano,2197,98,4,0,4,100.0%,3h
38517,1,[SSBic]PlenS,2197,158,4,11,15,26.7%,42m
38517,2,[LSKBYB]cyanbushier,2197,30,3,7,10,30.0%,1h
38517,3,hcteks,2197,95,3,7,10,30.0%,23m
38517,2,[AbcCo]SapitoFacha,2197,88,2,0,2,100.0%,58m
38517,1,Bossatronian,2197,0,1,0,1,100.0%,1h
38517,1,PFDry,2197,42,1,5,6,16.7%,23m
38517,1,Egarr,2197,48,1,8,9,11.1%,3h
38517,3,Bossmaster,2197,0,0,1,1,0.0%,12m
38517,2,Spaceman,2197,0,0,1,1,0.0%,39m
38517,2,KingNubleaux,2197,0,0,5,5,0.0%,5m
38537,1,PhillyEagle,2196,1772,225,224,449,50.1%,23m
38537,1,Ligmatix,2196,1793,207,224,431,48.0%,14m
38537,1,[Hayze]DaAce,2196,1758,112,113,225,49.8%,3h
38537,1,[ProCol]Andres,2196,1220,86,82,168,51.2%,3h
38537,1,Jester,2196,556,31,28,59,52.5%,1h
38537,3,Nidhogg,2196,688,26,31,57,45.6%,58m
38537,1,bdubdub,2196,888,26,32,58,44.8%,56m
38537,2,SaltyDogg,2196,400,21,15,36,58.3%,3h
38537,1,AsakujakU,2196,591,21,25,46,45.7%,31m
38537,1,bluemind,2196,605,19,20,39,48.7%,46m
38537,3,Ppito,2196,464,16,26,42,38.1%,1h
38537,2,[DXPCA]Maycol,2196,452,15,21,36,41.7%,55m
38537,1,JkGerar,2196,492,13,14,27,48.1%,46m
38537,3,Lubry,2196,360,12,20,32,37.5%,1h
38537,2,Guiab,2196,228,9,3,12,75.0%,3h
38537,1,Rasthag,2196,320,9,10,19,47.4%,48m
38537,1,ARot,2196,334,9,18,27,33.3%,1h
38537,2,[ARCHIE]FonS,2196,220,8,7,15,53.3%,3h
38537,2,[OBDT]magriola,2196,206,7,6,13,53.8%,1h
38537,2,bigsox,2196,260,6,23,29,20.7%,32m
38537,2,[MuSaFi]Mexa,2196,36,4,2,6,66.7%,3h
38537,1,Idiot,2196,0,3,4,7,42.9%,3h
38537,1,Jostom,2196,124,3,7,10,30.0%,44m
38537,2,MRHAZZARD,2196,30,2,0,2,100.0%,3h
38537,1,[BSauce]crodey,2196,0,1,0,1,100.0%,40m
38537,1,deathcyth,2196,92,1,2,3,33.3%,3h
38537,1,Reknbal,2196,40,1,3,4,25.0%,51m
38537,3,Thor,2196,30,1,4,5,20.0%,44m
38537,2,Winters,2196,0,1,5,6,16.7%,1h
38537,1,NastyNateFCF,2196,0,1,5,6,16.7%,1h
38537,2,Peluzon,2196,0,0,1,1,0.0%,3h
38537,2,Dingus,2196,0,0,1,1,0.0%,3h
38537,2,[ZvP]Bushidoninja,2196,0,0,2,2,0.0%,39m
38537,1,Totoro,2196,0,0,7,7,0.0%,7m
38571,1,Sprog,2195,1689,164,192,356,46.1%,31m
38571,1,NightKnight,2195,1607,161,151,312,51.6%,3h
38571,1,Allunak,2195,1417,121,115,236,51.3%,51m
38571,2,Kala,2195,1470,78,75,153,51.0%,1h
38571,1,nbm,2195,1118,51,44,95,53.7%,3h
38571,1,wpaul,2195,1133,48,43,91,52.7%,57m
38571,1,Berong,2195,599,38,31,69,55.1%,1h
38571,3,plucas,2195,1075,38,49,87,43.7%,48m
38571,1,dantena,2195,946,31,29,60,51.7%,3h
38571,1,chrisrepf,2195,345,30,25,55,54.5%,1h
38571,1,[XpKAc]Evilwings,2195,351,24,17,41,58.5%,43m
38571,1,dlo,2195,438,17,10,27,63.0%,3h
38571,2,halimaw,2195,420,16,5,21,76.2%,1h
38571,1,[GnR]HeHateMe,2195,392,11,16,27,40.7%,27m
38571,2,JEANPIPILOVE,2195,150,10,7,17,58.8%,3h
38571,2,Anticeptik,2195,332,10,16,26,38.5%,1h
38571,1,Epocast,2195,230,9,5,14,64.3%,15m
38571,1,Dielon,2195,279,8,10,18,44.4%,3h
38571,1,AeoMaxiamus,2195,244,8,12,20,40.0%,3h
38571,3,Chaos,2195,212,7,18,25,28.0%,32m
38571,1,[MA50N]crispcheese,2195,160,6,6,12,50.0%,1h
38571,2,Swoop,2195,146,6,6,12,50.0%,7m
38571,1,Franklinniii,2195,190,5,4,9,55.6%,1h
38571,1,Kaiser,2195,182,5,6,11,45.5%,3h
38571,1,hernismall,2195,190,5,8,13,38.5%,1h
38571,1,Rylowe,2195,132,5,8,13,38.5%,3h
38571,1,Zetawing,2195,128,4,8,12,33.3%,1h
38571,1,GregoryPie,2195,145,3,7,10,30.0%,1h
38571,1,DukeDuck,2195,96,3,10,13,23.1%,6m
38571,1,[UoN]Tarsonis,2195,109,2,3,5,40.0%,1h
38571,3,MarTe,2195,0,2,6,8,25.0%,1h
38571,1,KloudNine,2195,120,2,7,9,22.2%,3h
38571,2,NickNate,2195,0,1,0,1,100.0%,1h
38571,2,RIVERA,2195,0,1,0,1,100.0%,3h
38571,1,BALLZY,2195,0,1,5,6,16.7%,60m
38571,2,RobsonVESS,2195,46,1,6,7,14.3%,32m
38571,1,JakTheRipper,2195,0,1,6,7,14.3%,1h
38571,2,snickers,2195,0,0,1,1,0.0%,3h
38571,2,bjnone,2195,0,0,1,1,0.0%,1h
38571,3,Chuckman,2195,0,0,2,2,0.0%,1h
38571,3,[KGH4]EskimoJoe,2195,0,0,2,2,0.0%,27m
38571,1,SerralsPinky,2195,0,0,2,2,0.0%,3h
38571,1,Soseji,2195,0,0,4,4,0.0%,3h
38571,1,[OGB]YungSwagLord,2195,0,0,7,7,0.0%,3h
38615,1,[THNT]Tarniac,2194,1788,248,258,506,49.0%,1h
38615,1,Kurogami,2194,1783,166,170,336,49.4%,49m
38615,3,Cimeries,2194,1557,123,126,249,49.4%,19m
38615,1,GunsGoBlaka,2194,1588,112,113,225,49.8%,3h
38615,3,DomadorToros,2194,1196,91,83,174,52.3%,1h
38615,1,yanysley,2194,1134,69,57,126,54.8%,24m
38615,1,luisarturo,2194,863,67,60,127,52.8%,3h
38615,1,Verethragna,2194,1187,52,50,102,51.0%,46m
38615,1,BlkICE,2194,827,31,30,61,50.8%,51m
38615,1,[QcSuB]Grimmjow,2194,934,28,31,59,47.5%,28m
38615,2,Seismic,2194,500,18,10,28,64.3%,1h
38615,3,[KEKISH]YOLO,2194,412,13,26,39,33.3%,3h
38615,1,DarkSky,2194,351,11,9,20,55.0%,51m
38615,1,Ravager,2194,342,9,10,19,47.4%,3h
38615,2,DUTILIEN,2194,178,6,4,10,60.0%,3h
38615,1,strongEddy,2194,277,6,11,17,35.3%,51m
38615,3,diefool,2194,30,2,1,3,66.7%,24m
38615,1,NEIL,2194,48,2,2,4,50.0%,19m
38615,1,Sariel,2194,109,2,5,7,28.6%,43m
38615,2,Sam,2194,0,1,3,4,25.0%,1h
38615,1,UPDRIFT,2194,0,1,6,7,14.3%,3h
38615,1,hither,2194,0,1,6,7,14.3%,34m
38615,2,[BPRU]BladeRunner,2194,0,0,1,1,0.0%,6m
38615,2,[catcat]Arcadeo,2194,0,0,1,1,0.0%,3h
38615,2,[DUMY]jesur,2194,0,0,1,1,0.0%,1h
38615,3,Ragnarok,2194,0,0,1,1,0.0%,1h
38615,1,GpainSwag,2194,0,0,3,3,0.0%,9m
38642,1,CHINZILLA,2193,1267,61,68,129,47.3%,12m
38642,1,KRTizzle,2193,1108,44,43,87,50.6%,3h
38642,1,[SC2BOL]POZ,2193,1163,33,41,74,44.6%,1h
38642,1,Grunze,2193,454,16,22,38,42.1%,31m
38642,1,GANGHAPS,2193,324,10,11,21,47.6%,24m
38642,2,FoRAiuR,2193,218,7,11,18,38.9%,37m
38642,1,Mortal,2193,232,7,14,21,33.3%,3h
38642,1,AZAZEL,2193,156,5,8,13,38.5%,3h
38642,1,Aventurion,2193,42,5,8,13,38.5%,40m
38642,1,squidto,2193,198,5,10,15,33.3%,3h
38642,1,Evig,2193,192,4,7,11,36.4%,3h
38642,1,[2027]fancystar,2193,107,3,2,5,60.0%,1h
38642,1,[PZ]Ross,2193,97,2,6,8,25.0%,6m
38642,2,TheBlackLion,2193,30,1,1,2,50.0%,3h
38642,2,Gamerving,2193,48,1,4,5,20.0%,1h
38642,1,BIGBLUEBALLS,2193,97,1,7,8,12.5%,3h
38642,2,SilentSword,2193,0,1,8,9,11.1%,1h
38642,2,[CatImp]Iconicion,2193,0,0,1,1,0.0%,3h
38642,2,IkarosRT,2193,0,0,1,1,0.0%,1h
38642,2,[ZChamp]hunter,2193,0,0,1,1,0.0%,1h
38642,2,lukura,2193,0,0,1,1,0.0%,56m
38642,1,[Ricers]PatrickB,2193,0,0,2,2,0.0%,1h
38642,2,MRX,2193,0,0,2,2,0.0%,1h
38665,3,Pouncer,2192,1541,294,307,601,48.9%,1h
38665,1,DarthKan,2192,1658,65,59,124,52.4%,3h
38665,1,SmoothSello,2192,1329,53,60,113,46.9%,41m
38665,1,WistfulJoker,2192,1196,49,43,92,53.3%,3h
38665,1,Supremo,2192,941,48,55,103,46.6%,23m
38665,2,starkilla,2192,724,34,30,64,53.1%,1h
38665,3,FullMetalRob,2192,542,23,34,57,40.4%,3h
38665,1,Rencee,2192,701,22,22,44,50.0%,60m
38665,1,NoMicro,2192,570,19,20,39,48.7%,16m
38665,1,Ellusion,2192,420,12,13,25,48.0%,58m
38665,1,Loboman,2192,254,9,10,19,47.4%,1h
38665,2,[OPLADR]ForbiddenOne,2192,234,7,10,17,41.2%,58m
38665,3,Asparagus,2192,146,6,12,18,33.3%,45m
38665,2,Sertorius,2192,176,5,2,7,71.4%,40m
38665,1,GustavoD,2192,97,5,2,7,71.4%,3h
38665,2,[Zno]yomama,2192,30,5,6,11,45.5%,23m
38665,3,marshmellow,2192,102,4,11,15,26.7%,57m
38665,1,Ender,2192,78,3,3,6,50.0%,3h
38665,1,[ANFA]david,2192,84,3,7,10,30.0%,3h
38665,1,Darknight,2192,125,3,7,10,30.0%,23m
38665,1,UpgrayDDD,2192,118,2,2,4,50.0%,3h
38665,1,lalo,2192,46,2,6,8,25.0%,3h
38665,1,[SUDAKA]SrInmortal,2192,76,2,7,9,22.2%,3h
38665,3,sagipopu,2192,0,1,1,2,50.0%,1h
38665,2,LuchoAV,2192,0,1,1,2,50.0%,1h
38665,1,MrT,2192,91,1,3,4,25.0%,1h
38665,1,SonoraQB,2192,92,1,3,4,25.0%,3h
38665,2,ThickSkull,2192,0,1,5,6,16.7%,5m
38665,2,[HRDep]giantbighuge,2192,0,1,6,7,14.3%,37m
38665,1,SopaPowa,2192,0,1,6,7,14.3%,3h
38665,2,Zeigfreid,2192,0,0,1,1,0.0%,25m
38665,2,RolloTomassi,2192,0,0,1,1,0.0%,24m
38665,2,JaydenJoshua,2192,0,0,1,1,0.0%,3h
38665,2,JuuzouSuzuya,2192,0,0,2,2,0.0%,3h
38665,2,InvazorPer,2192,0,0,7,7,0.0%,1h
38700,1,lIlIlIIIlIlI,2191,1107,42,36,78,53.8%,49m
38700,1,Adam,2191,1093,36,34,70,51.4%,7m
38700,2,cinder,2191,597,22,27,49,44.9%,1h
38700,1,Ravenbery,2191,419,15,20,35,42.9%,3h
38700,1,Zeca,2191,294,12,8,20,60.0%,3h
38700,1,DaneOMite,2191,260,8,12,20,40.0%,1h
38700,1,Arenosa,2191,199,6,4,10,60.0%,2m
38700,1,TheLight,2191,237,6,6,12,50.0%,46m
38700,3,nekko,2191,90,6,8,14,42.9%,45m
38700,1,[C0L0R]SenorAzul,2191,176,5,12,17,29.4%,3h
38700,1,DEDPEHTO,2191,188,5,13,18,27.8%,40m
38700,1,WhiteThunder,2191,110,4,4,8,50.0%,1h
38700,1,DEPOGAR,2191,118,4,6,10,40.0%,51m
38700,2,ItsMartinez,2191,138,3,6,9,33.3%,1h
38700,3,Eltreum,2191,0,2,6,8,25.0%,37m
38700,1,Anarchy,2191,120,2,6,8,25.0%,6m
38700,1,RooWattsBalí,2191,42,1,3,4,25.0%,3h
38700,1,[nieBla]Perkinstar,2191,0,1,3,4,25.0%,60m
38700,2,Zantory,2191,0,1,4,5,20.0%,39m
38700,2,Cyphress,2191,0,0,1,1,0.0%,3h
38700,2,lacruzitopa,2191,0,0,1,1,0.0%,3h
38700,3,Consumed,2191,0,0,4,4,0.0%,45m
38722,1,[sk3tch]dogsquad,2190,1787,319,328,647,49.3%,23m
38722,1,carloncho,2190,1800,287,284,571,50.3%,1h
38722,2,[Watame]ReinerBraun,2190,618,197,207,404,48.8%,1h
38722,1,KillaD,2190,1640,129,142,271,47.6%,13m
38722,1,[TeamEz]BISONHEAD,2190,1554,100,96,196,51.0%,1h
38722,1,BruiserBrew,2190,1644,57,58,115,49.6%,1h
38722,1,[cluez]royery,2190,1340,52,45,97,53.6%,3h
38722,1,Derobelisk,2190,768,38,42,80,47.5%,23m
38722,1,Zero,2190,1081,37,36,73,50.7%,48m
38722,1,yosspp,2190,907,30,34,64,46.9%,57m
38722,1,Woplick,2190,912,29,42,71,40.8%,3h
38722,2,AJPC,2190,792,28,26,54,51.9%,1h
38722,2,defra,2190,564,20,17,37,54.1%,31m
38722,2,[zerg39]DXG,2190,390,17,3,20,85.0%,1h
38722,1,xXOverMindXx,2190,406,11,15,26,42.3%,48m
38722,1,DANZH,2190,281,8,12,20,40.0%,23m
38722,1,Electrokloud,2190,206,6,15,21,28.6%,3h
38722,1,MrBoater,2190,152,5,5,10,50.0%,3h
38722,2,[platos]GigaTom,2190,170,4,7,11,36.4%,1h
38722,1,IIChanyII,2190,193,3,3,6,50.0%,44m
38722,2,MagicTurtle,2190,97,1,2,3,33.3%,31m
38722,2,Painkila,2190,46,1,5,6,16.7%,3h
38722,2,Teivel,2190,30,1,5,6,16.7%,15m
38722,1,NostraDamus,2190,0,1,6,7,14.3%,3h
38722,1,tarzan,2190,0,1,6,7,14.3%,8m
38722,1,awkwardfart,2190,0,0,3,3,0.0%,3h
38722,2,[Valt]Valthem,2190,0,0,5,5,0.0%,10m
38749,3,[sk3tch]UnSimpleNoob,2189,1457,226,240,466,48.5%,29m
38749,3,picoroto,2189,1506,187,184,371,50.4%,1h
38749,3,[LUTBAG]TempusFugit,2189,1133,135,148,283,47.7%,3h
38749,1,RobieShark,2189,1587,125,123,248,50.4%,1h
38749,1,[Oarbix]Dabruce,2189,901,77,71,148,52.0%,1h
38749,2,khaleesi,2189,962,58,58,116,50.0%,3h
38749,3,Tobtien,2189,906,57,61,118,48.3%,1h
38749,1,BEARDSCRATCH,2189,936,34,40,74,45.9%,1h
38749,1,curtis,2189,820,24,30,54,44.4%,31m
38749,1,[aTmDt]Enoch,2189,483,21,14,35,60.0%,3h
38749,1,Bot,2189,553,21,24,45,46.7%,1h
38749,1,Sidonus,2189,720,21,26,47,44.7%,23m
38749,1,darkpenguin,2189,564,17,16,33,51.5%,46m
38749,2,Copernicus,2189,150,11,10,21,52.4%,3h
38749,1,Wartyme,2189,202,6,12,18,33.3%,48m
38749,2,methodL,2189,150,5,5,10,50.0%,15m
38749,2,Woopwoop,2189,192,5,5,10,50.0%,3h
38749,1,Immagram,2189,188,5,11,16,31.2%,1h
38749,2,Wildman,2189,62,3,0,3,100.0%,1h
38749,1,ian,2189,159,3,5,8,37.5%,3h
38749,3,AbyssWalker,2189,60,3,7,10,30.0%,1h
38749,2,[Mldr]Reminex,2189,64,2,2,4,50.0%,3h
38749,2,[nieBla]CJR,2189,76,2,4,6,33.3%,3h
38749,3,TurtleMcTurt,2189,0,2,7,9,22.2%,9m
38749,2,Maximus,2189,0,1,0,1,100.0%,1h
38749,2,lorsilva,2189,0,1,0,1,100.0%,1h
38749,2,flipper,2189,0,1,1,2,50.0%,31m
38749,1,[ViP3Rs]Anderson,2189,0,1,1,2,50.0%,59m
38749,1,Canineprizem,2189,0,1,5,6,16.7%,8m
38749,1,[Cannel]KelayrChanel,2189,73,1,8,9,11.1%,39m
38749,2,logiebear,2189,0,0,1,1,0.0%,3h
38749,1,[cluez]Maquinakill,2189,0,0,2,2,0.0%,3h
38749,2,Crezuss,2189,0,0,4,4,0.0%,3h
38749,2,CalebC,2189,0,0,5,5,0.0%,39m
38783,1,krebsloth,2188,1612,130,126,256,50.8%,8m
38783,1,Veterano,2188,1701,115,118,233,49.4%,3h
38783,3,Pavel,2188,1509,97,101,198,49.0%,1h
38783,1,MarineVegeta,2188,1010,79,85,164,48.2%,12m
38783,1,Tecxis,2188,1711,75,76,151,49.7%,42m
38783,3,eod,2188,1530,68,80,148,45.9%,7m
38783,1,lzbthb,2188,925,56,51,107,52.3%,32m
38783,2,Shukaki,2188,886,55,63,118,46.6%,58m
38783,1,vitao,2188,986,53,41,94,56.4%,3h
38783,3,[Eñders]SARGENTO,2188,1276,48,58,106,45.3%,1h
38783,1,feb,2188,1202,43,40,83,51.8%,3h
38783,2,NeosGX,2188,299,41,35,76,53.9%,19m
38783,2,stritlybinis,2188,1012,38,36,74,51.4%,3h
38783,1,repsajmas,2188,581,24,18,42,57.1%,2m
38783,1,[tsmph]Spencer,2188,600,18,21,39,46.2%,12m
38783,1,andrefelipe,2188,494,14,21,35,40.0%,35m
38783,1,sneetch,2188,300,9,12,21,42.9%,2m
38783,1,AlmaDeHusky,2188,124,6,8,14,42.9%,16m
38783,2,KGtheGreat,2188,206,6,11,17,35.3%,3h
38783,1,[Larvax]Maquina,2188,183,5,5,10,50.0%,3h
38783,3,Togarashi,2188,118,5,13,18,27.8%,53m
38783,1,BlessedG,2188,133,3,7,10,30.0%,41m
38783,1,[BlakMa]ATAT,2188,78,2,4,6,33.3%,27m
38783,1,SniperZ,2188,0,2,10,12,16.7%,47m
38783,2,skb,2188,46,1,1,2,50.0%,5m
38783,1,Uzi,2188,115,1,7,8,12.5%,7m
38783,2,Drago,2188,0,0,1,1,0.0%,1h
38783,2,[FxB]sherpard,2188,0,0,1,1,0.0%,11m
38783,2,[LFMR]Slinky,2188,0,0,1,1,0.0%,59m
38783,2,Bibi,2188,0,0,1,1,0.0%,1h
38783,2,CrazyM,2188,0,0,1,1,0.0%,3h
38783,1,Katharus,2188,0,0,2,2,0.0%,51m
38783,1,Heexor,2188,0,0,3,3,0.0%,3h
38783,1,[6G]Seal,2188,0,0,3,3,0.0%,3h
38817,3,therealjerry,2187,1478,191,191,382,50.0%,1h
38817,1,NECRON,2187,1510,75,60,135,55.6%,1h
38817,1,Rupea,2187,1706,72,74,146,49.3%,1h
38817,1,PCHdaniel,2187,1572,55,60,115,47.8%,3h
38817,1,pfsempire,2187,1179,47,36,83,56.6%,1h
38817,1,dbreezy,2187,509,14,14,28,50.0%,3h
38817,1,DrKing,2187,457,14,22,36,38.9%,51m
38817,2,edgarlift,2187,312,12,19,31,38.7%,1h
38817,1,Spazthegamer,2187,412,11,13,24,45.8%,1h
38817,1,Kenneth,2187,243,7,10,17,41.2%,16m
38817,2,Psymon,2187,124,7,14,21,33.3%,3h
38817,3,mcfrank,2187,217,6,10,16,37.5%,25m
38817,2,Silby,2187,173,5,10,15,33.3%,1h
38817,2,Majestic,2187,149,4,3,7,57.1%,55m
38817,2,ZAMBRANOCTMR,2187,94,4,5,9,44.4%,1h
38817,1,Ammonkey,2187,84,3,9,12,25.0%,51m
38817,2,Shazam,2187,34,2,2,4,50.0%,1h
38817,1,Etrain,2187,42,2,3,5,40.0%,1h
38817,3,sonhodevalsa,2187,30,2,9,11,18.2%,36m
38817,2,[GPIGS]Petruxy,2187,0,1,0,1,100.0%,1h
38817,2,Daniels,2187,48,1,2,3,33.3%,1h
38817,1,JNPRATT,2187,48,1,3,4,25.0%,40m
38817,1,Goomba,2187,0,1,5,6,16.7%,39m
38817,2,MontanaLogan,2187,0,0,1,1,0.0%,1h
38817,2,Broadsword,2187,0,0,1,1,0.0%,39m
38817,2,power,2187,0,0,2,2,0.0%,1h
38817,2,Fasto,2187,0,0,2,2,0.0%,1h
38817,1,JUSTINtime,2187,0,0,3,3,0.0%,3h
38817,1,[TGCrew]koszonom,2187,0,0,3,3,0.0%,1h
38817,2,Elodin,2187,0,0,5,5,0.0%,1h
38847,3,Wagner,2186,1160,140,150,290,48.3%,36m
38847,3,adamconduit,2186,999,117,111,228,51.3%,1h
38847,1,[sanwch]Spud,2186,1476,88,84,172,51.2%,3h
38847,2,BruhhdaMan,2186,1654,82,67,149,55.0%,1h
38847,1,Kelti,2186,1091,75,77,152,49.3%,23m
38847,1,Ihatewindups,2186,1113,72,76,148,48.6%,60m
38847,1,FatLazyZerg,2186,1430,55,54,109,50.5%,3h
38847,1,Effectery,2186,1248,48,47,95,50.5%,3h
38847,1,Duran,2186,884,30,26,56,53.6%,3h
38847,2,Magnok,2186,561,26,24,50,52.0%,1h
38847,1,[LhL]ComanderVolt,2186,616,17,17,34,50.0%,3h
38847,1,TatuHD,2186,430,14,18,32,43.8%,3h
38847,1,[C13263]GGKNEEGA,2186,498,13,18,31,41.9%,1h
38847,1,halec,2186,194,10,3,13,76.9%,16m
38847,2,Racksito,2186,234,9,3,12,75.0%,6m
38847,1,DVIDA,2186,258,6,9,15,40.0%,15m
38847,2,Zizou,2186,198,6,12,18,33.3%,1h
38847,3,ÐixieRëkt,2186,178,6,22,28,21.4%,56m
38847,1,Sickspinda,2186,0,4,3,7,57.1%,1h
38847,1,[KWG]hewhoatepie,2186,130,4,6,10,40.0%,3h
38847,1,Merpetual,2186,102,4,8,12,33.3%,3h
38847,1,AlmiusJuez,2186,162,4,10,14,28.6%,15m
38847,2,timhuang,2186,138,4,10,14,28.6%,9m
38847,2,Zognolo,2186,0,3,2,5,60.0%,1h
38847,3,Chaotic,2186,96,2,4,6,33.3%,7m
38847,2,Hunter,2186,0,1,1,2,50.0%,3h
38847,2,RosharKnight,2186,42,1,2,3,33.3%,55m
38847,1,Promethean,2186,42,1,5,6,16.7%,1h
38847,3,CityBoy,2186,30,1,6,7,14.3%,9m
38847,2,PINCU,2186,0,0,1,1,0.0%,1h
38847,2,Warrionn,2186,0,0,2,2,0.0%,15m
38847,2,Eax,2186,0,0,3,3,0.0%,1h
38847,1,llilloman,2186,0,0,3,3,0.0%,1h
38847,2,Mataitus,2186,0,0,5,5,0.0%,1h
38847,2,Kicktwo,2186,0,0,5,5,0.0%,3h
38882,3,Sargasm,2185,1538,179,190,369,48.5%,29m
38882,1,Cheeze,2185,1796,119,111,230,51.7%,3h
38882,1,Teabe,2185,1334,112,100,212,52.8%,1h
38882,1,[Edmund]JerryHeldens,2185,1434,95,90,185,51.4%,3h
38882,1,Chelotukito,2185,1483,88,84,172,51.2%,44m
38882,1,[FatMom]David,2185,1583,83,81,164,50.6%,51m
38882,1,Thumper,2185,601,19,19,38,50.0%,3h
38882,1,KiraLacus,2185,514,17,17,34,50.0%,1h
38882,2,JKL,2185,410,14,12,26,53.8%,12m
38882,1,kEVIn,2185,260,9,11,20,45.0%,60m
38882,2,[LOSCTM]Dronka,2185,224,8,5,13,61.5%,3h
38882,1,[SWOU]Amagno,2185,320,8,13,21,38.1%,3h
38882,1,Phantasma,2185,166,5,8,13,38.5%,16m
38882,3,Miedrine,2185,170,4,3,7,57.1%,15m
38882,1,Félrias,2185,152,4,9,13,30.8%,15m
38882,3,[D10S]Arthas,2185,150,4,10,14,28.6%,3h
38882,1,RACSO,2185,119,3,3,6,50.0%,3h
38882,1,Shadow,2185,98,3,5,8,37.5%,58m
38882,2,abc,2185,0,1,0,1,100.0%,3h
38882,1,Sharkbait,2185,91,1,3,4,25.0%,1h
38882,1,Cookiemnster,2185,38,1,4,5,20.0%,1h
38882,1,Qwone,2185,0,1,5,6,16.7%,3h
38882,1,Jeff,2185,0,1,5,6,16.7%,8m
38882,1,[R77R]Wolf,2185,0,0,1,1,0.0%,1h
38882,1,Dvelking,2185,0,0,2,2,0.0%,3h
38907,1,Terranosaur,2184,1489,165,178,343,48.1%,3h
38907,1,Tuggah,2184,1375,61,61,122,50.0%,48m
38907,1,[ThW]Emmanuclear,2184,1085,55,38,93,59.1%,1h
38907,1,[SCVM]NightTrain,2184,1292,48,48,96,50.0%,51m
38907,2,FXC,2184,475,41,37,78,52.6%,29m
38907,1,utntlqkf,2184,813,36,40,76,47.4%,23m
38907,1,Overlord,2184,1082,34,44,78,43.6%,56m
38907,1,alskjdfkljas,2184,719,31,35,66,47.0%,16m
38907,1,Maverick,2184,478,14,15,29,48.3%,50m
38907,1,[gbag]Opi,2184,458,12,16,28,42.9%,1h
38907,2,EarnsTurns,2184,228,11,6,17,64.7%,22m
38907,1,[SL0PPY]KingJon,2184,274,9,9,18,50.0%,40m
38907,2,Mickabooo,2184,150,6,3,9,66.7%,31m
38907,2,Advaita,2184,136,6,6,12,50.0%,1h
38907,2,Sephiroth,2184,0,3,2,5,60.0%,3h
38907,1,Daraku,2184,0,3,4,7,42.9%,59m
38907,2,[TOTALD]squid,2184,0,2,4,6,33.3%,1h
38907,1,[Crip1]Gustavo,2184,0,1,1,2,50.0%,3h
38907,2,Amove,2184,0,1,2,3,33.3%,1h
38907,1,SpookyPlant,2184,0,1,5,6,16.7%,3h
38907,2,LEO,2184,30,1,5,6,16.7%,21m
38907,3,ElzarC,2184,0,1,6,7,14.3%,3h
38907,1,ALEX,2184,0,1,6,7,14.3%,6m
38907,1,Grixis,2184,0,1,8,9,11.1%,21m
38907,2,grappa,2184,0,0,1,1,0.0%,1h
38907,2,VinnyTheChin,2184,0,0,1,1,0.0%,3h
38907,2,CorrGMR,2184,0,0,1,1,0.0%,32m
38907,1,[KOYOMI]MauTRAX,2184,0,0,2,2,0.0%,3h
38907,2,MuSclEHam,2184,0,0,5,5,0.0%,39m
38936,3,[3us]RAGNOR,2183,1334,111,127,238,46.6%,3h
38936,1,WILPMFMH,2183,1684,99,100,199,49.7%,1h
38936,1,Wufferus,2183,1580,79,73,152,52.0%,47m
38936,1,Phoxx,2183,1470,54,58,112,48.2%,3h
38936,1,Pabino,2183,1430,48,58,106,45.3%,1h
38936,1,Trigger,2183,1056,41,37,78,52.6%,3h
38936,2,goodman,2183,827,34,39,73,46.6%,3h
38936,1,Shrugs,2183,582,24,22,46,52.2%,37m
38936,2,ItsNotButler,2183,444,14,16,30,46.7%,3h
38936,1,llSongBirdll,2183,274,9,12,21,42.9%,3h
38936,2,ItchyBalls,2183,224,7,6,13,53.8%,3h
38936,1,deapoolx,2183,222,7,8,15,46.7%,1h
38936,1,KIRAKUN,2183,184,6,7,13,46.2%,40m
38936,1,brynnerelpro,2183,194,6,8,14,42.9%,3h
38936,1,FUNKYFUNTIME,2183,237,6,17,23,26.1%,3h
38936,1,RollForward,2183,48,4,6,10,40.0%,3h
38936,1,arikiblack,2183,96,3,10,13,23.1%,3h
38936,1,macros,2183,121,2,3,5,40.0%,1h
38936,2,Tincho,2183,76,2,6,8,25.0%,3h
38936,1,WinterWood,2183,34,2,6,8,25.0%,1h
38936,2,ScaryToaster,2183,0,2,7,9,22.2%,1h
38936,2,CueroMagico,2183,0,1,1,2,50.0%,1h
38936,2,PloppyFenis,2183,36,1,2,3,33.3%,14m
38936,2,Byrd,2183,30,1,2,3,33.3%,40m
38936,2,luchosb,2183,0,0,1,1,0.0%,1h
38936,2,destutor,2183,0,0,1,1,0.0%,3h
38962,1,David,2182,1508,105,105,210,50.0%,3h
38962,2,ggg,2182,1521,64,80,144,44.4%,27m
38962,1,Exscalion,2182,1313,56,47,103,54.4%,3h
38962,1,[NUTTT]Kieltheshado,2182,527,23,21,44,52.3%,3h
38962,1,Jess,2182,744,21,27,48,43.8%,1h
38962,1,DXTOR,2182,523,20,23,43,46.5%,3h
38962,1,Rambo,2182,467,16,15,31,51.6%,3h
38962,1,Artii,2182,200,6,8,14,42.9%,3h
38962,1,[raa]JimHalpert,2182,173,6,10,16,37.5%,1h
38962,1,FUSER,2182,134,5,9,14,35.7%,1h
38962,1,zeratul,2182,130,4,2,6,66.7%,1h
38962,3,[n3wk1d]clashvalian,2182,145,3,1,4,75.0%,1h
38962,1,zennguyen,2182,143,3,7,10,30.0%,1h
38962,1,HiddenTroll,2182,90,3,7,10,30.0%,23m
38962,1,CapaBlanca,2182,84,2,8,10,20.0%,23m
38962,2,SANTASD,2182,30,1,1,2,50.0%,3h
38962,2,Dildpiece,2182,0,0,1,1,0.0%,15m
38962,2,SDADSDD,2182,0,0,4,4,0.0%,3h
38980,2,IIIIIIIIIIII,2181,906,46,59,105,43.8%,56m
38980,1,DoctorElkay,2181,1065,43,42,85,50.6%,3h
38980,1,[FoxBR]Charlinnn,2181,693,28,29,57,49.1%,14m
38980,2,Crossover,2181,514,18,14,32,56.2%,56m
38980,1,chewbacca,2181,344,11,14,25,44.0%,3h
38980,1,steezvinny,2181,375,11,18,29,37.9%,3h
38980,2,SIDESWIPE,2181,280,10,4,14,71.4%,19m
38980,2,OSI,2181,256,9,5,14,64.3%,1h
38980,2,AnviD,2181,202,5,11,16,31.2%,7m
38980,3,Ironshax,2181,0,4,4,8,50.0%,19m
38980,3,[zrg4wi]TheWaffler,2181,179,4,10,14,28.6%,25m
38980,1,MamaDude,2181,138,3,3,6,50.0%,27m
38980,2,ThorRush,2181,36,2,2,4,50.0%,3h
38980,1,[ThicAF]Mikomi,2181,80,2,6,8,25.0%,35m
38980,1,[MPPA]Piperrak,2181,97,2,6,8,25.0%,1h
38980,1,Jedi,2181,30,2,7,9,22.2%,3h
38980,2,JustSeth,2181,0,1,0,1,100.0%,1h
38980,3,villevalo,2181,30,1,1,2,50.0%,3h
38980,2,JaVa,2181,37,1,2,3,33.3%,14m
38980,2,vikinglore,2181,46,1,5,6,16.7%,1h
38980,1,koz,2181,0,0,2,2,0.0%,8m
39001,3,MrPZS,2180,1558,180,172,352,51.1%,49m
39001,1,[P3RR0S]MauricioAP,2180,1753,117,117,234,50.0%,1h
39001,1,frugele,2180,1572,117,117,234,50.0%,3h
39001,3,LoneGunman,2180,1522,109,111,220,49.5%,16m
39001,3,rasencio,2180,1480,99,97,196,50.5%,51m
39001,1,clownassasin,2180,813,77,77,154,50.0%,26m
39001,1,SpokenTruth,2180,1609,71,67,138,51.4%,1h
39001,1,Sloth,2180,1379,52,48,100,52.0%,3h
39001,1,GreenLeafer,2180,885,35,39,74,47.3%,32m
39001,1,UncleSam,2180,606,24,34,58,41.4%,60m
39001,2,DannyDevito,2180,473,19,14,33,57.6%,11m
39001,1,Andrew,2180,607,18,21,39,46.2%,7m
39001,1,kunifer,2180,350,8,13,21,38.1%,41m
39001,1,Jcaleman,2180,171,7,3,10,70.0%,3h
39001,1,TouchMyBelly,2180,184,6,8,14,42.9%,48m
39001,3,Gamchi,2180,153,5,9,14,35.7%,1h
39001,3,Juice,2180,157,4,12,16,25.0%,3h
39001,1,NoBody,2180,105,3,3,6,50.0%,1h
39001,2,franciscopd,2180,68,2,3,5,40.0%,3h
39001,2,[LBO]MaddSkillz,2180,48,2,5,7,28.6%,60m
39001,2,JuanDSOYPROO,2180,30,1,1,2,50.0%,3h
39001,2,RedderButton,2180,48,1,2,3,33.3%,1h
39001,2,NoLifeMatter,2180,34,1,2,3,33.3%,3h
39001,1,Polaris,2180,91,1,3,4,25.0%,3h
39001,1,BlayKiller,2180,0,1,4,5,20.0%,49m
39001,2,TEDDY,2180,0,1,4,5,20.0%,15m
39001,2,Lucky,2180,0,0,1,1,0.0%,3h
39001,2,DikPound,2180,0,0,1,1,0.0%,3h
39001,2,Ashi,2180,0,0,1,1,0.0%,19m
39001,1,SeaLion,2180,0,0,3,3,0.0%,16m
39001,2,TROUBLENC,2180,0,0,5,5,0.0%,7m
39032,2,[FyHr]MrGlycrM,2179,796,47,29,76,61.8%,55m
39032,2,Betrayer,2179,1149,40,44,84,47.6%,1h
39032,1,BenAffleck,2179,1226,38,46,84,45.2%,59m
39032,2,Erick,2179,910,34,32,66,51.5%,3h
39032,1,FameAK,2179,928,28,32,60,46.7%,3h
39032,2,[LLSC2]Whyaretherec,2179,456,17,23,40,42.5%,55m
39032,1,ValminX,2179,420,12,14,26,46.2%,3h
39032,3,JokeR,2179,336,11,20,31,35.5%,19m
39032,2,balduvian,2179,162,5,4,9,55.6%,1h
39032,2,[GgARMY]ChiboloMeepo,2179,120,4,5,9,44.4%,1h
39032,2,Knightwar,2179,64,3,1,4,75.0%,33m
39032,3,MicroG,2179,124,3,8,11,27.3%,24m
39032,2,Tanthan,2179,0,2,0,2,100.0%,3h
39032,1,EduardoAB,2179,38,2,3,5,40.0%,1h
39032,2,Jeeewlyfe,2179,34,1,1,2,50.0%,3h
39032,2,Uashi,2179,48,1,1,2,50.0%,40m
39032,1,Turncoat,2179,48,1,3,4,25.0%,8m
39032,1,[Lukss]DoMiNiCk,2179,0,0,1,1,0.0%,44m
39032,1,Wegality,2179,0,0,2,2,0.0%,3h
39032,2,iiiiii,2179,0,0,5,5,0.0%,48m
39052,2,[TheDOH]Elkslayer,2178,1515,524,538,1062,49.3%,1h
39052,1,eduasotoXD,2178,1676,106,110,216,49.1%,3h
39052,3,[CTBD]MadMarine,2178,1465,91,93,184,49.5%,3m
39052,1,Nemesis,2178,1420,51,59,110,46.4%,1h
39052,2,[LosCra]RafaCraft,2178,866,32,27,59,54.2%,1h
39052,1,deeznutz,2178,799,30,23,53,56.6%,40m
39052,1,Nanokirito,2178,600,23,34,57,40.4%,1h
39052,1,[br0cef]NetSurge,2178,622,22,24,46,47.8%,41m
39052,2,FIRSTCANNON,2178,511,17,18,35,48.6%,3h
39052,1,Will,2178,456,15,17,32,46.9%,56m
39052,1,[NT4]Achilles,2178,359,12,19,31,38.7%,1h
39052,1,Saaomi,2178,176,7,5,12,58.3%,7m
39052,2,Juay,2178,240,7,5,12,58.3%,3h
39052,1,MrEisme,2178,276,7,11,18,38.9%,32m
39052,1,LTCage,2178,225,7,12,19,36.8%,51m
39052,1,[SBZg]Missmisery,2178,168,5,6,11,45.5%,8m
39052,1,Alpha,2178,186,5,12,17,29.4%,51m
39052,3,Ranksy,2178,124,3,8,11,27.3%,3h
39052,2,[DVHSC]RATMATAZZ,2178,0,2,3,5,40.0%,25m
39052,2,Celestial,2178,0,2,3,5,40.0%,3h
39052,2,Dicer,2178,0,1,0,1,100.0%,14m
39052,2,meOW,2178,34,1,3,4,25.0%,3h
39052,1,[SIKS]Vincanity,2178,44,1,5,6,16.7%,7m
39052,1,Anubis,2178,0,1,5,6,16.7%,1h
39052,2,[1earth]Girthquake,2178,0,1,5,6,16.7%,25m
39052,1,OgDaddy,2178,0,1,6,7,14.3%,59m
39052,1,BoldnBrash,2178,0,1,6,7,14.3%,1h
39052,2,[FUMON]Talos,2178,0,0,2,2,0.0%,28m
39080,1,schupalla,2177,1757,127,131,258,49.2%,3h
39080,1,Deacon,2177,1581,62,60,122,50.8%,1h
39080,3,badguy,2177,637,50,57,107,46.7%,1h
39080,1,bluedog,2177,1364,49,50,99,49.5%,1h
39080,1,DopeyKoala,2177,785,27,29,56,48.2%,3h
39080,2,esteban,2177,557,22,14,36,61.1%,22m
39080,2,Shea,2177,494,17,19,36,47.2%,3h
39080,3,Jettlight,2177,240,8,15,23,34.8%,20m
39080,2,[1NTAMA]yusepe,2177,216,7,4,11,63.6%,3h
39080,2,Razor,2177,195,6,4,10,60.0%,58m
39080,3,Quiroz,2177,124,6,11,17,35.3%,41m
39080,2,skyrapider,2177,120,5,2,7,71.4%,7m
39080,1,Gusbgog,2177,193,4,8,12,33.3%,6m
39080,1,mendosi,2177,118,4,10,14,28.6%,17m
39080,1,TOSH,2177,119,3,2,5,60.0%,1h
39080,2,aerolegendz,2177,94,2,6,8,25.0%,1h
39080,1,chobo,2177,48,2,7,9,22.2%,3h
39080,2,EvilCheeto,2177,0,2,7,9,22.2%,1h
39080,2,Dracosmaug,2177,0,1,0,1,100.0%,1h
39080,2,Eskate,2177,0,1,0,1,100.0%,3h
39080,2,[ReZ]Daghmar,2177,0,1,1,2,50.0%,30m
39080,1,SierraSierra,2177,0,1,2,3,33.3%,1h
39080,2,FrankStebs,2177,46,1,5,6,16.7%,1h
39080,2,knghtstalker,2177,0,1,5,6,16.7%,3h
39080,3,SanTisimo,2177,0,0,1,1,0.0%,26m
39080,1,Caleb,2177,0,0,6,6,0.0%,24m
39106,2,Edder,2176,1267,122,108,230,53.0%,3h
39106,1,Thablackman,2176,664,74,75,149,49.7%,60m
39106,1,Mendozazuzui,2176,1130,42,48,90,46.7%,3h
39106,2,[SANGRE]LaMala,2176,794,28,28,56,50.0%,14m
39106,3,Allezo,2176,752,28,35,63,44.4%,1h
39106,2,plario,2176,352,26,21,47,55.3%,12m
39106,1,CristaGoga,2176,485,24,15,39,61.5%,15m
39106,1,[ÆON]gammullus,2176,664,21,26,47,44.7%,1h
39106,1,Madness,2176,428,15,17,32,46.9%,3h
39106,2,naquos,2176,404,14,11,25,56.0%,18m
39106,1,JATOMAN,2176,423,14,18,32,43.8%,46m
39106,1,lacontraseña,2176,408,12,16,28,42.9%,3h
39106,2,[Domare]SeanJohn,2176,267,8,5,13,61.5%,1h
39106,1,foxinsocks,2176,254,6,7,13,46.2%,43m
39106,2,Pho,2176,132,4,4,8,50.0%,48m
39106,3,ELK,2176,141,4,9,13,30.8%,48m
39106,2,Xenfurion,2176,88,2,2,4,50.0%,3h
39106,1,KenMasters,2176,0,2,4,6,33.3%,1h
39106,3,exceed,2176,0,1,0,1,100.0%,3h
39106,2,youngbouzin,2176,0,1,5,6,16.7%,39m
39106,2,WarriorElite,2176,48,1,6,7,14.3%,1h
39106,1,Ryno,2176,0,1,6,7,14.3%,11m
39106,2,CurtDirty,2176,0,0,1,1,0.0%,15m
39106,2,SteveInTime,2176,0,0,1,1,0.0%,1h
39106,2,HarunA,2176,0,0,5,5,0.0%,49m
39131,1,Musa,2175,1719,195,190,385,50.6%,60m
39131,1,Nocturnian,2175,1470,60,53,113,53.1%,3h
39131,2,Bob,2175,919,57,58,115,49.6%,55m
39131,1,ttttt,2175,1196,46,41,87,52.9%,37m
39131,1,HomeyJabrone,2175,807,43,43,86,50.0%,1h
39131,1,FishMadness,2175,1120,36,42,78,46.2%,15m
39131,1,Pan,2175,203,19,17,36,52.8%,50m
39131,1,Fish,2175,381,11,10,21,52.4%,24m
39131,1,WillyBombBay,2175,432,11,14,25,44.0%,1h
39131,2,NachoSupreme,2175,314,10,15,25,40.0%,1h
39131,1,glOpP,2175,306,9,13,22,40.9%,1h
39131,1,Morphosis,2175,114,4,9,13,30.8%,31m
39131,2,Lynest,2175,173,4,9,13,30.8%,3h
39131,2,mistakes,2175,138,3,3,6,50.0%,3h
39131,2,Gsquared,2175,96,3,4,7,42.9%,7m
39131,2,Soul,2175,30,2,2,4,50.0%,32m
39131,2,Parity,2175,64,2,2,4,50.0%,1h
39131,1,LIGHTTHERION,2175,113,2,8,10,20.0%,51m
39131,2,yameteh,2175,0,2,8,10,20.0%,40m
39131,1,WhatFun,2175,48,1,1,2,50.0%,3h
39131,2,Twona,2175,0,1,4,5,20.0%,3h
39131,2,AJkuptz,2175,0,1,5,6,16.7%,35m
39131,2,[MLGP]SWAMPAZZ,2175,0,0,1,1,0.0%,1h
39131,2,BurntNugg,2175,0,0,2,2,0.0%,1h
39155,1,RoninWorkout,2174,1015,98,85,183,53.6%,3h
39155,3,Salchipapu,2174,1361,74,83,157,47.1%,7m
39155,1,cubanpapi,2174,893,36,35,71,50.7%,3h
39155,1,BananaLisk,2174,719,31,40,71,43.7%,3h
39155,3,juancamaney,2174,816,30,34,64,46.9%,1h
39155,1,lazer,2174,837,28,38,66,42.4%,3h
39155,1,GeeGee,2174,552,16,23,39,41.0%,46m
39155,1,Listerin,2174,418,13,20,33,39.4%,1h
39155,1,Whatever,2174,269,7,11,18,38.9%,1h
39155,1,[ctrlF]BalphEubank,2174,180,6,5,11,54.5%,31m
39155,3,Lee,2174,88,5,9,14,35.7%,3h
39155,2,Kappa,2174,175,5,11,16,31.2%,3h
39155,1,RPG,2174,96,4,7,11,36.4%,1h
39155,1,Holoyuri,2174,108,4,10,14,28.6%,1h
39155,1,OdebYaráPium,2174,0,3,3,6,50.0%,37m
39155,1,JavierG,2174,137,3,8,11,27.3%,49m
39155,2,Nostalgic,2174,60,2,3,5,40.0%,3h
39155,2,Macklemore,2174,123,2,3,5,40.0%,1h
39155,3,Cory,2174,30,2,7,9,22.2%,24m
39155,2,Shadow,2174,0,1,0,1,100.0%,3h
39155,1,irindale,2174,0,1,6,7,14.3%,1h
39155,1,KALEB,2174,0,0,1,1,0.0%,1h
39155,2,coolmc,2174,0,0,1,1,0.0%,36m
39155,1,[FL1P]Parkdaddy,2174,0,0,1,1,0.0%,15m
39155,2,MetalX,2174,0,0,2,2,0.0%,49m
39180,1,JASONBOURNE,2173,1347,126,133,259,48.6%,57m
39180,1,[TGosuD]Deadfield,2173,1074,119,115,234,50.9%,1h
39180,2,Puck,2173,1138,65,60,125,52.0%,1h
39180,1,BattleCruise,2173,1481,55,51,106,51.9%,3h
39180,1,ALDEBARAM,2173,1261,50,43,93,53.8%,4m
39180,1,ShaneFalco,2173,732,35,24,59,59.3%,1h
39180,1,CuteHusky,2173,809,32,23,55,58.2%,49m
39180,1,kingsingh,2173,739,29,23,52,55.8%,3h
39180,1,Kurisuten,2173,638,20,23,43,46.5%,1h
39180,1,COFRAN,2173,612,17,23,40,42.5%,1h
39180,2,monkeyko,2173,385,15,7,22,68.2%,7m
39180,2,paputh,2173,234,7,9,16,43.8%,3h
39180,1,scheissty,2173,48,6,5,11,54.5%,31m
39180,1,Warchief,2173,212,6,10,16,37.5%,1h
39180,3,ToiletPaper,2173,166,6,13,19,31.6%,22m
39180,2,regress,2173,120,5,4,9,55.6%,3h
39180,2,Mikel,2173,86,3,2,5,60.0%,1h
39180,2,Rob,2173,94,3,3,6,50.0%,37m
39180,1,[GaaaSQ]iSrAlex,2173,135,3,4,7,42.9%,3h
39180,1,fatman,2173,89,2,2,4,50.0%,32m
39180,1,SGbmannyx,2173,74,2,7,9,22.2%,50m
39180,1,TAZZ,2173,48,2,7,9,22.2%,3h
39180,1,Carnage,2173,48,2,7,9,22.2%,1h
39180,1,Nuckoholic,2173,113,2,7,9,22.2%,51m
39180,2,GoldeNesto,2173,0,1,0,1,100.0%,3h
39180,1,[ODESSA]MaxemOut,2173,97,1,2,3,33.3%,3h
39180,1,BlackList,2173,0,1,3,4,25.0%,3h
39180,1,QWDQD,2173,0,1,6,7,14.3%,11m
39180,1,Rev,2173,0,1,6,7,14.3%,8m
39180,1,KurdishFood,2173,0,1,7,8,12.5%,3h
39180,2,SNOWMAN,2173,0,0,1,1,0.0%,5m
39180,1,HowDoYouPlay,2173,0,0,1,1,0.0%,3h
39180,2,Thor,2173,0,0,5,5,0.0%,1h
39213,1,Bachatu,2172,1669,105,114,219,47.9%,32m
39213,1,MrQuintus,2172,1132,95,85,180,52.8%,3h
39213,1,CesarDTmay,2172,1608,69,67,136,50.7%,3h
39213,1,Jake,2172,569,59,56,115,51.3%,3h
39213,1,Matt,2172,841,56,60,116,48.3%,49m
39213,1,LheKris,2172,1144,51,55,106,48.1%,38m
39213,1,[lmflui]RebelPilot,2172,784,26,26,52,50.0%,3h
39213,1,SilentStorm,2172,423,22,18,40,55.0%,3h
39213,1,oweneljisus,2172,634,20,20,40,50.0%,1h
39213,1,testrun,2172,557,19,22,41,46.3%,32m
39213,2,OogyBoogy,2172,525,17,21,38,44.7%,56m
39213,3,Wilsoncooks,2172,370,12,18,30,40.0%,2m
39213,2,[GGMESP]FabioSR,2172,302,10,10,20,50.0%,48m
39213,1,[Dubbed]Hero,2172,274,9,14,23,39.1%,1h
39213,2,[DDST]BadLarry,2172,256,8,11,19,42.1%,59m
39213,2,pyro,2172,167,7,15,22,31.8%,3h
39213,2,[SBoys]THEKiwininja,2172,154,6,3,9,66.7%,24m
39213,1,darksbane,2172,191,5,9,14,35.7%,32m
39213,2,Jeremeu,2172,152,4,4,8,50.0%,19m
39213,2,sdfghjkldfgh,2172,142,3,1,4,75.0%,30m
39213,2,DuqueDuFraam,2172,66,3,2,5,60.0%,40m
39213,2,[SANGRE]Kurozawa,2172,60,3,2,5,60.0%,3h
39213,1,tossnb,2172,82,3,7,10,30.0%,3h
39213,1,[4N0RZN]Saladin,2172,122,3,10,13,23.1%,3h
39213,1,SkullBlargh,2172,48,2,0,2,100.0%,52m
39213,1,agent,2172,96,2,0,2,100.0%,11m
39213,2,ForThebugs,2172,30,2,1,3,66.7%,58m
39213,2,TerranKilla,2172,62,2,2,4,50.0%,22m
39213,2,Pocornia,2172,34,2,3,5,40.0%,1h
39213,1,Disciple,2172,44,2,3,5,40.0%,15m
39213,1,[HYD2]psychopanda,2172,0,1,2,3,33.3%,1h
39213,1,Vison,2172,48,1,3,4,25.0%,3h
39213,1,Player,2172,0,1,5,6,16.7%,3h
39213,2,[KoT]Zava,2172,0,0,1,1,0.0%,3h
39213,2,[DlN0]BANAM,2172,0,0,1,1,0.0%,3h
39213,3,CnelSheppard,2172,0,0,1,1,0.0%,1h
39213,2,ComeInYourEy,2172,0,0,1,1,0.0%,4m
39213,2,Dinayru,2172,0,0,1,1,0.0%,3h
39213,2,gaston,2172,0,0,1,1,0.0%,11m
39213,2,bkkim,2172,0,0,3,3,0.0%,1h
39213,1,Flamingpst,2172,0,0,4,4,0.0%,14m
39254,1,Nnils,2171,1512,103,104,207,49.8%,3h
39254,2,gab,2171,1653,79,76,155,51.0%,21m
39254,3,BlastFinger,2171,1056,50,72,122,41.0%,31m
39254,3,DuhFly,2171,726,34,51,85,40.0%,30m
39254,1,BattleMaraux,2171,536,16,18,34,47.1%,3h
39254,3,ObeList,2171,324,11,23,34,32.4%,1h
39254,1,Apple,2171,346,10,12,22,45.5%,5m
39254,1,[TCHNO]Octopuss,2171,364,10,17,27,37.0%,14m
39254,3,Cmon,2171,268,9,12,21,42.9%,1h
39254,1,BouncyKnight,2171,144,7,3,10,70.0%,6m
39254,3,TheOtherLeft,2171,122,4,10,14,28.6%,3h
39254,2,Hekamiah,2171,86,3,3,6,50.0%,55m
39254,1,[MCRN]FlyingHusky,2171,76,3,4,7,42.9%,1h
39254,3,Adrian,2171,30,3,10,13,23.1%,36m
39254,2,SpaceRanger,2171,30,2,4,6,33.3%,58m
39254,1,Odalv,2171,48,2,4,6,33.3%,1h
39254,3,[ConFed]winnethepooh,2171,73,2,5,7,28.6%,44m
39254,2,Xugo,2171,40,2,8,10,20.0%,1h
39254,2,CDman,2171,0,1,0,1,100.0%,48m
39254,1,iLuMiNaTi,2171,0,1,3,4,25.0%,3h
39254,2,AriusGz,2171,48,1,4,5,20.0%,1h
39254,2,Thaitan,2171,94,1,5,6,16.7%,1h
39254,1,kaiju,2171,0,1,6,7,14.3%,3h
39254,1,gorganty,2171,0,1,6,7,14.3%,41m
39254,2,ezbud,2171,0,0,1,1,0.0%,3h
39254,2,Yoryo,2171,0,0,1,1,0.0%,1h
39254,2,JDlove,2171,0,0,1,1,0.0%,3h
39254,1,BipolarBear,2171,0,0,2,2,0.0%,1h
39254,2,jish,2171,0,0,5,5,0.0%,5m
39254,2,[ATL]RagnarLoth,2171,0,0,5,5,0.0%,25m
39254,1,phlanic,2171,0,0,6,6,0.0%,3h
39285,1,NAVy,2170,1741,254,291,545,46.6%,3h
39285,1,Sernath,2170,1469,154,161,315,48.9%,3h
39285,1,PARSIVAL,2170,1701,126,127,253,49.8%,3m
39285,1,delisair,2170,1732,75,72,147,51.0%,3h
39285,1,FreshPrince,2170,1347,64,64,128,50.0%,50m
39285,1,Dizzyangel,2170,1110,36,47,83,43.4%,3h
39285,1,Divi,2170,645,34,40,74,45.9%,1h
39285,2,Farnot,2170,881,33,41,74,44.6%,55m
39285,1,Kingfischer,2170,640,27,20,47,57.4%,3h
39285,1,[CrLine]benja,2170,833,27,32,59,45.8%,1h
39285,2,lecturillas,2170,522,20,12,32,62.5%,3h
39285,1,hammerghost,2170,601,19,17,36,52.8%,1h
39285,2,Littleween,2170,534,19,19,38,50.0%,1h
39285,2,Sujay,2170,453,15,9,24,62.5%,1h
39285,2,wochoamec,2170,296,12,6,18,66.7%,1h
39285,2,goosehide,2170,275,12,16,28,42.9%,1h
39285,2,dildopuncher,2170,332,11,7,18,61.1%,58m
39285,1,iNsticT,2170,319,11,11,22,50.0%,3h
39285,2,[PPLOYS]GRJLS,2170,159,7,4,11,63.6%,31m
39285,1,GhostDemon,2170,223,7,11,18,38.9%,1h
39285,3,Kashmir,2170,237,7,14,21,33.3%,51m
39285,1,Mixpx,2170,156,6,13,19,31.6%,1h
39285,3,mansman,2170,147,4,10,14,28.6%,42m
39285,3,Tydas,2170,58,3,2,5,60.0%,1h
39285,1,mendieta,2170,120,3,8,11,27.3%,1h
39285,2,joaquineg,2170,90,2,1,3,66.7%,39m
39285,1,ciberninja,2170,72,2,7,9,22.2%,57m
39285,2,BigBoss,2170,0,1,0,1,100.0%,1h
39285,2,gynecologist,2170,46,1,6,7,14.3%,1h
39285,1,Prrito,2170,0,0,3,3,0.0%,3h
39285,2,Hayjak,2170,0,0,5,5,0.0%,1h
39316,1,Jon,2169,1717,114,96,210,54.3%,3h
39316,1,Gabenciso,2169,816,39,33,72,54.2%,1h
39316,1,Raven,2169,1076,38,41,79,48.1%,5m
39316,1,PARKER,2169,599,21,17,38,55.3%,1h
39316,1,[FatMom]Xenocide,2169,595,20,19,39,51.3%,3h
39316,1,[LibTec]MERUPRIME,2169,364,15,21,36,41.7%,53m
39316,1,[GGMESP]Mozart,2169,478,14,15,29,48.3%,51m
39316,2,SantiXtreme,2169,340,13,19,32,40.6%,11m
39316,1,trickyhunter,2169,396,11,19,30,36.7%,3h
39316,2,Monra,2169,272,9,4,13,69.2%,3h
39316,2,userinput,2169,168,6,2,8,75.0%,3h
39316,1,CHOLOPOWER,2169,212,6,6,12,50.0%,1h
39316,1,PROPHET,2169,148,5,10,15,33.3%,1h
39316,1,Shinoa,2169,118,4,3,7,57.1%,19m
39316,1,cdqmcp,2169,192,4,9,13,30.8%,24m
39316,2,[DhZon3]Tsunami,2169,30,2,1,3,66.7%,3h
39316,2,nednil,2169,0,1,1,2,50.0%,3h
39316,2,EeXxPeErToO,2169,0,1,2,3,33.3%,3h
39316,2,DuckZongXi,2169,48,1,6,7,14.3%,3h
39316,1,kirbstomper,2169,0,0,2,2,0.0%,3h
39336,2,Eltongoro,2168,1579,532,576,1108,48.0%,3h
39336,3,HiDef,2168,1505,219,229,448,48.9%,51m
39336,3,Blinder,2168,762,91,101,192,47.4%,18m
39336,2,Siul,2168,1230,47,44,91,51.6%,31m
39336,3,knorpnad,2168,498,19,25,44,43.2%,1h
39336,1,Arkadi,2168,551,18,21,39,46.2%,3h
39336,1,vbt,2168,518,14,22,36,38.9%,3h
39336,2,[SIPA]Maik,2168,212,7,8,15,46.7%,1h
39336,2,Sejun,2168,223,6,8,14,42.9%,39m
39336,2,MaglevSmash,2168,0,5,0,5,100.0%,1h
39336,2,TPCWave,2168,62,5,5,10,50.0%,9m
39336,1,boomstick,2168,117,4,7,11,36.4%,21m
39336,3,Cowboy,2168,149,4,11,15,26.7%,1h
39336,3,ATHAN,2168,121,3,5,8,37.5%,1h
39336,1,Kanco,2168,165,3,7,10,30.0%,1h
39336,2,Korgoth,2168,62,2,3,5,40.0%,22m
39336,2,crazyshot,2168,44,2,9,11,18.2%,1h
39336,2,SomiSomi,2168,0,1,0,1,100.0%,1h
39336,2,[Pharoh]GorillaPug,2168,0,1,0,1,100.0%,3h
39336,1,Zephyr,2168,0,1,1,2,50.0%,1h
39336,2,Retro,2168,88,1,3,4,25.0%,48m
39336,2,LazyTurtle,2168,30,1,4,5,20.0%,22m
39336,3,Constantine,2168,30,1,5,6,16.7%,1h
39336,1,VietNamHello,2168,0,1,5,6,16.7%,47m
39336,2,klzoncin,2168,0,0,1,1,0.0%,56m
39336,2,QinKai,2168,0,0,2,2,0.0%,1h
39362,3,Duemellon,2167,1576,214,223,437,49.0%,56m
39362,1,Husky,2167,1621,111,127,238,46.6%,1h
39362,3,Arky,2167,1248,103,113,216,47.7%,42m
39362,1,fenixalfa,2167,1644,93,100,193,48.2%,3h
39362,2,Alyt,2167,1651,80,79,159,50.3%,3h
39362,2,TerranAss,2167,1500,59,50,109,54.1%,3h
39362,2,CTlegacy,2167,1154,46,37,83,55.4%,3h
39362,1,SHD,2167,614,24,24,48,50.0%,1h
39362,1,JRCoyote,2167,822,24,31,55,43.6%,1h
39362,1,llllIIIllIlI,2167,564,22,19,41,53.7%,1h
39362,2,Isaimax,2167,475,18,13,31,58.1%,1h
39362,2,TdogGSR,2167,452,16,16,32,50.0%,7m
39362,3,[BAMF]BadJudgment,2167,384,14,17,31,45.2%,46m
39362,2,Johan,2167,349,12,20,32,37.5%,39m
39362,1,Jonester,2167,366,12,21,33,36.4%,1h
39362,1,UnboundSun,2167,335,11,23,34,32.4%,51m
39362,2,ALcO,2167,362,11,30,41,26.8%,28m
39362,1,PUCHERITOX,2167,299,10,17,27,37.0%,3h
39362,1,Hades,2167,322,10,19,29,34.5%,1h
39362,1,donutLORD,2167,269,8,10,18,44.4%,3h
39362,1,Phalanxo,2167,221,8,11,19,42.1%,3h
39362,2,GUNGNIR,2167,206,6,4,10,60.0%,1h
39362,1,Primate,2167,92,6,14,20,30.0%,3h
39362,2,Zeratul,2167,118,5,3,8,62.5%,3h
39362,1,RAVEN,2167,92,5,15,20,25.0%,3h
39362,2,louluu,2167,116,4,6,10,40.0%,48m
39362,3,TheDarkVoid,2167,62,4,10,14,28.6%,1h
39362,2,Tysonian,2167,62,2,1,3,66.7%,20m
39362,2,Sumilidon,2167,30,2,1,3,66.7%,59m
39362,1,[HR666]XmustainX,2167,46,2,9,11,18.2%,1h
39362,2,lux,2167,0,1,0,1,100.0%,7m
39362,2,Bittenflame,2167,0,1,4,5,20.0%,3h
39362,1,Gasser,2167,0,0,3,3,0.0%,27m
39362,1,POOONME,2167,0,0,4,4,0.0%,44m
39362,2,Heinsenzerg,2167,0,0,7,7,0.0%,56m
39397,2,[ZFC]yaolt,2166,1524,238,244,482,49.4%,48m
39397,3,CrazyLazyT,2166,1559,130,139,269,48.3%,51m
39397,3,MnTLbreak,2166,681,104,112,216,48.1%,1h
39397,1,Angkorian,2166,1706,96,96,192,50.0%,1h
39397,2,Clybrewa,2166,931,91,99,190,47.9%,3h
39397,1,alex,2166,634,54,54,108,50.0%,3h
39397,1,tejuguasu,2166,1203,45,50,95,47.4%,53m
39397,2,HighPlayer,2166,1010,37,33,70,52.9%,3h
39397,1,[BlTEL]Banban,2166,1034,35,37,72,48.6%,50m
39397,2,KozukiOden,2166,274,17,12,29,58.6%,40m
39397,2,LongSchlong,2166,354,15,3,18,83.3%,3h
39397,1,DAJEVI,2166,430,15,24,39,38.5%,3h
39397,2,Trump,2166,425,14,17,31,45.2%,11m
39397,3,YourCat,2166,366,12,24,36,33.3%,31m
39397,1,KAKITAS,2166,384,11,15,26,42.3%,1h
39397,1,GARY,2166,280,9,14,23,39.1%,23m
39397,1,ANCIENT,2166,214,7,10,17,41.2%,7m
39397,1,Ciga,2166,161,7,12,19,36.8%,53m
39397,2,jabas,2166,172,6,2,8,75.0%,1h
39397,1,bleep,2166,204,6,5,11,54.5%,3h
39397,1,SgTmCnasty,2166,218,6,9,15,40.0%,41m
39397,2,Moleskine,2166,100,4,3,7,57.1%,1h
39397,1,bigmanneo,2166,217,4,4,8,50.0%,3h
39397,1,Wizards,2166,154,4,6,10,40.0%,14m
39397,2,[Kreep]Aquaman,2166,60,3,3,6,50.0%,3h
39397,1,Philippe,2166,88,2,3,5,40.0%,1h
39397,2,Huntemall,2166,0,2,3,5,40.0%,58m
39397,2,TonTon,2166,0,1,0,1,100.0%,3h
39397,2,Hcier,2166,0,1,0,1,100.0%,59m
39397,2,Sikiww,2166,46,1,5,6,16.7%,39m
39397,2,Poyt,2166,30,1,5,6,16.7%,3h
39397,2,[LOSCTM]PICHULOTOTE,2166,0,0,1,1,0.0%,3h
39397,1,Ltabyss,2166,0,0,5,5,0.0%,1h
39397,2,[DCNG]DylanZoster,2166,0,0,5,5,0.0%,1h
39431,1,ChucklesD,2165,1759,177,178,355,49.9%,2m
39431,1,Zathras,2165,1427,68,61,129,52.7%,3h
39431,2,KillerKiller,2165,1025,49,69,118,41.5%,1h
39431,1,[SCVM]wxray,2165,642,48,55,103,46.6%,1h
39431,1,Logannic,2165,1216,40,41,81,49.4%,3h
39431,1,[FAQWAY]CrowBro,2165,781,27,26,53,50.9%,40m
39431,1,ALDEBARÁN,2165,617,25,21,46,54.3%,23m
39431,1,YAN,2165,517,19,20,39,48.7%,43m
39431,1,Drankuz,2165,452,13,13,26,50.0%,1h
39431,2,[DSGs]Roquefort,2165,314,12,8,20,60.0%,3h
39431,2,GNARSQUATCH,2165,269,7,11,18,38.9%,3h
39431,3,Malefactor,2165,228,7,14,21,33.3%,39m
39431,3,Kaitabch,2165,169,5,2,7,71.4%,1h
39431,3,Ninjapie,2165,177,5,11,16,31.2%,29m
39431,2,Commander,2165,0,3,2,5,60.0%,9m
39431,2,Kaj,2165,143,3,3,6,50.0%,15m
39431,1,LimbertXtLv,2165,106,3,3,6,50.0%,3h
39431,2,TUNALAG,2165,58,2,1,3,66.7%,3h
39431,1,proxicon,2165,84,2,10,12,16.7%,1h
39431,1,ManyFeathers,2165,48,2,10,12,16.7%,1h
39431,1,Martron,2165,91,1,3,4,25.0%,35m
39431,2,Starfish,2165,30,1,3,4,25.0%,15m
39431,1,Duke,2165,94,1,3,4,25.0%,1h
39431,1,Knuckles,2165,0,1,4,5,20.0%,3h
39431,1,sleepyvw,2165,0,1,6,7,14.3%,15m
39431,2,pockets,2165,0,0,1,1,0.0%,3h
39431,2,Quinlan,2165,0,0,1,1,0.0%,25m
39431,2,Bandit,2165,0,0,2,2,0.0%,19m
39431,1,nestor,2165,0,0,2,2,0.0%,40m
39431,2,GirlForces,2165,0,0,2,2,0.0%,1h
39431,2,Pezz,2165,0,0,5,5,0.0%,1h
39462,1,energia,2164,1598,200,217,417,48.0%,43m
39462,1,grundle,2164,1688,176,187,363,48.5%,44m
39462,1,DankB,2164,1748,111,117,228,48.7%,3h
39462,2,Zombie,2164,612,47,47,94,50.0%,33m
39462,1,[TDRGN]Destructor,2164,433,15,15,30,50.0%,1h
39462,2,needles,2164,312,12,7,19,63.2%,33m
39462,1,azapheus,2164,412,12,15,27,44.4%,17m
39462,1,spook,2164,296,10,8,18,55.6%,1h
39462,1,TifaTelui,2164,246,8,11,19,42.1%,43m
39462,2,Muztang,2164,122,6,7,13,46.2%,1h
39462,1,MineralMike,2164,198,6,10,16,37.5%,1h
39462,1,ACT,2164,201,6,12,18,33.3%,3h
39462,1,Pan,2164,192,5,11,16,31.2%,3h
39462,3,TheStruggler,2164,172,4,5,9,44.4%,22m
39462,1,NiN,2164,148,4,5,9,44.4%,59m
39462,1,[TAoG]Bstrange,2164,152,4,7,11,36.4%,3h
39462,2,Neox,2164,90,3,1,4,75.0%,3h
39462,2,truth,2164,92,3,2,5,60.0%,3h
39462,1,[ISTC]Blackslash,2164,120,3,5,8,37.5%,50m
39462,1,[PhaZe]Sasquatch,2164,165,3,6,9,33.3%,8m
39462,2,elegantwalru,2164,123,3,8,11,27.3%,42m
39462,1,SpectreH,2164,36,2,3,5,40.0%,32m
39462,1,lucho,2164,48,2,4,6,33.3%,3h
39462,1,Franfein,2164,76,2,6,8,25.0%,3h
39462,1,BioHazardous,2164,48,2,7,9,22.2%,3h
39462,2,Ricky,2164,0,0,1,1,0.0%,19m
39462,2,Floof,2164,0,0,2,2,0.0%,24m
39462,1,Woodish,2164,0,0,3,3,0.0%,1h
39462,2,fightinbob,2164,0,0,5,5,0.0%,32m
39491,1,VIKING,2163,1705,174,184,358,48.6%,1h
39491,1,Jamie,2163,1568,153,148,301,50.8%,12m
39491,3,chad,2163,1691,143,173,316,45.3%,19m
39491,1,COBALT,2163,1759,122,123,245,49.8%,1h
39491,3,NEFI,2163,1528,83,90,173,48.0%,11m
39491,1,CHERRA,2163,1704,66,71,137,48.2%,3h
39491,1,GeoRock,2163,1040,45,49,94,47.9%,1h
39491,3,nuhret,2163,774,41,50,91,45.1%,31m
39491,2,Lucvic,2163,380,38,41,79,48.1%,24m
39491,2,ManEatsPants,2163,901,34,28,62,54.8%,20m
39491,1,Parvius,2163,661,30,18,48,62.5%,60m
39491,1,Demon,2163,645,26,32,58,44.8%,37m
39491,1,Jangus,2163,306,24,24,48,50.0%,1h
39491,1,MrFufu,2163,570,16,17,33,48.5%,1h
39491,3,[GOOOSE]mooplet,2163,376,16,19,35,45.7%,16m
39491,3,JohnMartin,2163,394,13,20,33,39.4%,2m
39491,3,BootCrust,2163,330,11,20,31,35.5%,13m
39491,2,[DarkLS]BlueNait,2163,252,10,1,11,90.9%,29m
39491,3,[DkSs]arturoblack,2163,205,8,18,26,30.8%,52m
39491,2,JhonFx,2163,224,7,7,14,50.0%,1h
39491,1,[Konir]CaptClaymore,2163,161,5,15,20,25.0%,1h
39491,2,ZandsT,2163,158,4,2,6,66.7%,7m
39491,1,Alvaro,2163,108,4,11,15,26.7%,1h
39491,1,SparkyStar,2163,193,3,5,8,37.5%,7m
39491,3,Zaccboy,2163,30,3,7,10,30.0%,33m
39491,1,Mutton,2163,97,2,0,2,100.0%,59m
39491,3,Gunners,2163,30,2,1,3,66.7%,9m
39491,2,TAKAMURA,2163,70,2,2,4,50.0%,3h
39491,3,Stopcap,2163,60,2,3,5,40.0%,3h
39491,2,Aragon,2163,0,1,0,1,100.0%,1h
39491,2,Rimogard,2163,0,1,1,2,50.0%,1h
39491,2,[1for2]KonBnLoZeeko,2163,0,1,2,3,33.3%,3h
39491,2,popsodaguy,2163,88,1,4,5,20.0%,1h
39491,2,[RatsPE]enlabe,2163,0,0,1,1,0.0%,48m
39491,1,Nquar,2163,0,0,1,1,0.0%,56m
39491,2,Blackness,2163,0,0,2,2,0.0%,3h
39491,2,oneeye,2163,0,0,2,2,0.0%,3h
39491,2,Meliodaz,2163,0,0,2,2,0.0%,3h
39491,1,[FFAA]Blackghost,2163,0,0,7,7,0.0%,59m
39530,1,Diogenes,2162,1750,145,135,280,51.8%,3h
39530,1,SgtWilly,2162,1777,142,143,285,49.8%,1h
39530,2,[TPride]FitzWing,2162,845,64,52,116,55.2%,7m
39530,2,bossplaya,2162,927,35,38,73,47.9%,1h
39530,1,Zuthanatos,2162,830,31,30,61,50.8%,3h
39530,1,ZeroMarine,2162,427,29,31,60,48.3%,1h
39530,2,Deiva,2162,446,17,13,30,56.7%,55m
39530,1,WtSucks,2162,508,14,19,33,42.4%,3h
39530,2,gfaweg,2162,188,12,11,23,52.2%,3h
39530,1,FrostyFlakes,2162,321,11,10,21,52.4%,1h
39530,2,MarineGirl,2162,336,10,10,20,50.0%,3h
39530,1,[0825]Frostyninja,2162,272,9,9,18,50.0%,15m
39530,2,SinRumboFijo,2162,271,9,14,23,39.1%,9m
39530,1,raynor,2162,218,7,9,16,43.8%,32m
39530,1,Antares,2162,234,7,12,19,36.8%,1h
39530,2,[BO1Z]klmg,2162,247,5,8,13,38.5%,1h
39530,1,DrProfessor,2162,134,5,10,15,33.3%,47m
39530,1,genghiscat,2162,96,4,6,10,40.0%,6m
39530,1,SneakyTurtle,2162,170,4,7,11,36.4%,1h
39530,2,MacRay,2162,54,3,5,8,37.5%,3h
39530,2,[PRTOS]NOOOOOOBBOT,2162,0,2,1,3,66.7%,18m
39530,3,TotalNoob,2162,34,2,2,4,50.0%,1h
39530,3,GoBanana,2162,30,1,1,2,50.0%,45m
39530,2,Kiiropanda,2162,0,1,2,3,33.3%,40m
39530,2,BeatleJuice,2162,48,1,6,7,14.3%,1h
39530,2,[PiGPan]conn,2162,0,0,1,1,0.0%,14m
39530,3,silany,2162,0,0,2,2,0.0%,3h
39530,2,LuisaCaCri,2162,0,0,3,3,0.0%,25m
39530,1,Krimson,2162,0,0,4,4,0.0%,1h
39530,2,grouch,2162,0,0,5,5,0.0%,6m
39560,1,eternalclan,2161,1734,163,159,322,50.6%,49m
39560,2,Caleb,2161,1583,80,78,158,50.6%,7m
39560,1,Prowzer,2161,1250,62,75,137,45.3%,51m
39560,1,Monkey,2161,1488,50,59,109,45.9%,3h
39560,1,DanielBarjas,2161,992,39,43,82,47.6%,1h
39560,2,TheArtist,2161,677,28,19,47,59.6%,1h
39560,2,Wattie,2161,820,28,46,74,37.8%,3h
39560,1,Kristjan,2161,639,23,22,45,51.1%,3h
39560,2,[BNNN]Mystery,2161,698,22,40,62,35.5%,43m
39560,1,electric,2161,419,13,14,27,48.1%,47m
39560,1,[HØST]FLunaX,2161,283,12,15,27,44.4%,3h
39560,2,[12YD]Skrumpf,2161,313,10,5,15,66.7%,59m
39560,2,maadcx,2161,272,9,3,12,75.0%,1h
39560,1,[KRKEN]David,2161,336,9,15,24,37.5%,3h
39560,2,Boubz,2161,241,8,6,14,57.1%,3h
39560,1,renan,2161,253,8,8,16,50.0%,3m
39560,1,[TeamKa]FerNanDo,2161,268,8,10,18,44.4%,3h
39560,3,Saoshyant,2161,269,8,12,20,40.0%,37m
39560,3,BigRic,2161,282,8,15,23,34.8%,46m
39560,1,elChule,2161,184,4,5,9,44.4%,1h
39560,2,KillerK,2161,0,3,3,6,50.0%,3h
39560,2,Madmartigan,2161,147,3,4,7,42.9%,28m
39560,2,PinkBlood,2161,64,2,1,3,66.7%,37m
39560,2,Ian,2161,42,2,1,3,66.7%,56m
39560,1,baleeet,2161,0,2,5,7,28.6%,1h
39560,3,sukithoe,2161,30,2,8,10,20.0%,42m
39560,2,RonDrugs,2161,0,1,0,1,100.0%,14m
39560,2,CookieHunter,2161,0,1,4,5,20.0%,18m
39560,1,LiVinGunXII,2161,0,1,5,6,16.7%,3h
39560,1,Vultuz,2161,0,1,5,6,16.7%,1h
39560,2,[TECPLA]wilder,2161,0,0,1,1,0.0%,3h
39560,2,[SALADO]CristianOMG,2161,0,0,1,1,0.0%,9m
39560,2,Aramis,2161,0,0,3,3,0.0%,11m
39560,2,Zoltan,2161,0,0,5,5,0.0%,1h
39594,1,dukkyfuzz,2160,1736,262,261,523,50.1%,3h
39594,1,headstalker,2160,1705,93,105,198,47.0%,50m
39594,1,METRIKAL,2160,1090,88,97,185,47.6%,32m
39594,2,MangoMan,2160,920,83,87,170,48.8%,1h
39594,3,wilber,2160,1047,65,70,135,48.1%,18m
39594,1,AntuJn,2160,1366,56,53,109,51.4%,3h
39594,1,Dire,2160,784,29,28,57,50.9%,3h
39594,1,KaminoAkira,2160,645,25,24,49,51.0%,1h
39594,2,jpnd,2160,506,17,20,37,45.9%,3h
39594,1,NeoAyan,2160,558,17,28,45,37.8%,1h
39594,1,Elindel,2160,551,16,23,39,41.0%,3h
39594,1,iceyeti,2160,450,12,19,31,38.7%,3h
39594,1,Capiau,2160,187,7,8,15,46.7%,3h
39594,3,AjaxsHammer,2160,154,7,12,19,36.8%,36m
39594,1,StaleManaflo,2160,44,4,4,8,50.0%,3h
39594,1,Robinwongg,2160,40,4,4,8,50.0%,15m
39594,1,[Arions]Destroyer,2160,161,4,5,9,44.4%,36m
39594,1,vuvictor,2160,120,4,10,14,28.6%,3h
39594,2,[Hulu]MarkAndSweep,2160,70,3,4,7,42.9%,3h
39594,1,pog,2160,112,3,8,11,27.3%,41m
39594,3,Daddytaco,2160,121,3,11,14,21.4%,22m
39594,2,Megatron,2160,60,2,3,5,40.0%,1h
39594,2,CosmicKiller,2160,46,2,6,8,25.0%,1h
39594,1,BablieMikel,2160,48,2,8,10,20.0%,3h
39594,1,Cineman,2160,0,1,0,1,100.0%,56m
39594,2,[iLag]ShadowSlayer,2160,0,1,2,3,33.3%,25m
39594,2,[MLI]StarCracker,2160,38,1,3,4,25.0%,1h
39594,1,[ZRN]KungFuUnicrn,2160,0,1,3,4,25.0%,3h
39594,2,[MiniC]isaac,2160,0,0,1,1,0.0%,22m
39594,2,Bart,2160,0,0,3,3,0.0%,1h
39624,2,Neuromancer,2159,1489,215,230,445,48.3%,43m
39624,3,filmnoir,2159,1545,212,220,432,49.1%,22m
39624,1,cristian,2159,1748,75,84,159,47.2%,3h
39624,2,Biaggio,2159,456,18,20,38,47.4%,28m
39624,1,Regulhaters,2159,508,17,26,43,39.5%,35m
39624,3,skazeta,2159,258,9,12,21,42.9%,3h
39624,1,gunty,2159,247,6,7,13,46.2%,7m
39624,3,Reach,2159,114,6,11,17,35.3%,31m
39624,1,[TTRT]BDT,2159,212,6,12,18,33.3%,3h
39624,2,zambo,2159,148,5,8,13,38.5%,3h
39624,1,[PTHero]ibuildmarine,2159,108,3,7,10,30.0%,1h
39624,1,[FiFo]Verblazo,2159,86,3,13,16,18.8%,3m
39624,2,Ykub,2159,30,2,1,3,66.7%,36m
39624,2,poeta,2159,58,2,6,8,25.0%,15m
39624,2,Killix,2159,0,1,0,1,100.0%,18m
39624,2,Instability,2159,0,1,3,4,25.0%,1h
39624,2,IGD,2159,0,0,1,1,0.0%,3h
39624,2,[JBSE]BIGCNL,2159,0,0,1,1,0.0%,60m
39624,1,iPoo,2159,0,0,2,2,0.0%,1h
39624,2,FewerSun,2159,0,0,5,5,0.0%,25m
39644,3,TimTheGreat,2158,1188,245,256,501,48.9%,7m
39644,1,glenelg,2158,971,70,85,155,45.2%,18m
39644,1,MiniMarine,2158,1051,63,45,108,58.3%,51m
39644,1,[ainme]OnlyD,2158,1224,44,48,92,47.8%,3h
39644,1,NeilHaws,2158,1054,40,37,77,51.9%,1h
39644,1,[Pirobo]Koyikabuto,2158,858,29,43,72,40.3%,3h
39644,2,[GRNSKN]Neroxas,2158,554,22,21,43,51.2%,3h
39644,1,Garnet,2158,421,14,17,31,45.2%,3h
39644,3,Stiqdrift,2158,150,7,17,24,29.2%,3m
39644,2,[NUTZZZ]Andy,2158,86,4,3,7,57.1%,1h
39644,1,Diablos,2158,96,4,7,11,36.4%,1h
39644,1,Colin,2158,164,4,10,14,28.6%,1h
39644,2,MrMeeseeks,2158,70,3,2,5,60.0%,1h
39644,3,JazZz,2158,60,3,9,12,25.0%,20m
39644,3,Scyther,2158,121,2,1,3,66.7%,1h
39644,2,josue,2158,30,2,4,6,33.3%,22m
39644,2,AlphaDavis,2158,0,2,4,6,33.3%,37m
39644,2,VINCE,2158,48,2,5,7,28.6%,3h
39644,1,GoodGame,2158,97,2,6,8,25.0%,50m
39644,2,Razziel,2158,30,2,9,11,18.2%,8m
39644,2,KamerDeep,2158,0,1,0,1,100.0%,33m
39644,2,Belteshazzar,2158,0,1,0,1,100.0%,24m
39644,2,PartinGG,2158,32,1,1,2,50.0%,33m
39644,1,Spoke,2158,0,1,6,7,14.3%,3h
39644,2,[Apinks]Apink,2158,0,0,1,1,0.0%,48m
39644,2,jojo,2158,0,0,2,2,0.0%,3h
39644,3,jOtv,2158,0,0,4,4,0.0%,50m
39644,2,aito,2158,0,0,5,5,0.0%,59m
39644,2,MagnusV,2158,0,0,5,5,0.0%,6m
39644,2,CaptianSlaug,2158,0,0,6,6,0.0%,6m
39674,1,CrazySnake,2157,1760,117,111,228,51.3%,47m
39674,1,DiegoTezca,2157,1673,86,87,173,49.7%,2m
39674,1,ShooterMcG,2157,832,39,38,77,50.6%,3h
39674,2,HentaiLover,2157,964,38,36,74,51.4%,3h
39674,1,AAA,2157,962,27,41,68,39.7%,3h
39674,1,IROPacker,2157,469,14,17,31,45.2%,1h
39674,2,GeborenSly,2157,300,12,12,24,50.0%,58m
39674,2,EJstyles,2157,228,10,7,17,58.8%,3h
39674,1,[HSCT]SquashedDuck,2157,246,8,8,16,50.0%,5m
39674,1,PAUL,2157,144,5,9,14,35.7%,50m
39674,2,FSDRKSLDR,2157,155,4,8,12,33.3%,3h
39674,3,Deceivr,2157,44,3,9,12,25.0%,53m
39674,1,Artanis,2157,92,2,4,6,33.3%,1h
39674,1,[Pirobo]Mayher,2157,88,2,7,9,22.2%,3h
39674,2,neklacaille,2157,30,1,1,2,50.0%,1h
39674,1,Zerathul,2157,97,1,1,2,50.0%,11m
39674,2,namtaog,2157,0,1,4,5,20.0%,6m
39674,1,CrystalBox,2157,0,1,4,5,20.0%,1h
39674,2,[Apink1]Apink,2157,0,0,1,1,0.0%,1h
39674,1,Artemis,2157,0,0,1,1,0.0%,1h
39674,2,AgentHippo,2157,0,0,1,1,0.0%,3h
39674,1,[MARV3L]amiu,2157,0,0,1,1,0.0%,3h
39674,1,LegallyBlind,2157,0,0,1,1,0.0%,3h
39674,2,Alexis,2157,0,0,1,1,0.0%,36m
39674,2,JustinTime,2157,0,0,5,5,0.0%,3h
39674,2,LEGEND,2157,0,0,5,5,0.0%,55m
39700,2,mobiouschode,2156,1645,117,109,226,51.8%,3h
39700,1,dan,2156,1729,71,80,151,47.0%,2m
39700,1,Lohenngramm,2156,813,38,32,70,54.3%,40m
39700,1,[DARPA]ghsotvinny,2156,1123,38,40,78,48.7%,3h
39700,1,NedKelly,2156,699,31,31,62,50.0%,27m
39700,1,[MrSolo]Fbaeza,2156,1018,31,39,70,44.3%,3h
39700,1,lucranious,2156,968,30,41,71,42.3%,53m
39700,1,Quentin,2156,203,26,15,41,63.4%,1h
39700,2,Doombringer,2156,616,23,35,58,39.7%,22m
39700,1,Burn,2156,476,19,28,47,40.4%,3h
39700,2,KibOY,2156,471,14,21,35,40.0%,40m
39700,1,Nicolas,2156,371,13,13,26,50.0%,3h
39700,2,Snooperz,2156,316,11,17,28,39.3%,3h
39700,3,chinoob,2156,131,7,2,9,77.8%,1h
39700,2,SeanFox,2156,182,6,3,9,66.7%,15m
39700,1,[PAJERO]jesuuuus,2156,246,6,5,11,54.5%,1h
39700,1,OmnNoMBomB,2156,210,5,10,15,33.3%,3h
39700,2,azzndude,2156,0,4,4,8,50.0%,1h
39700,3,SunnyBlue,2156,0,4,4,8,50.0%,20m
39700,1,DarthRez,2156,121,4,6,10,40.0%,3h
39700,2,Tempest,2156,62,2,3,5,40.0%,1h
39700,2,Bull,2156,0,0,1,1,0.0%,1h
39700,2,xception,2156,0,0,1,1,0.0%,3h
39700,2,Fransis,2156,0,0,1,1,0.0%,1h
39700,2,[OFFSTR]ZingZing,2156,0,0,2,2,0.0%,3h
39725,1,Redemptioner,2155,1465,52,65,117,44.4%,3h
39725,3,stephboiss,2155,949,45,52,97,46.4%,13m
39725,1,[Patria]DiosAnteros,2155,791,27,28,55,49.1%,47m
39725,1,Beau,2155,766,22,30,52,42.3%,1h
39725,1,Lhao,2155,645,20,21,41,48.8%,37m
39725,1,[UAK]Sykemi,2155,618,18,24,42,42.9%,3h
39725,1,TechnoBubble,2155,328,12,11,23,52.2%,51m
39725,3,brutal,2155,241,8,8,16,50.0%,36m
39725,1,[DDCaea]lechetibia,2155,0,4,1,5,80.0%,15m
39725,3,Killer,2155,151,3,3,6,50.0%,37m
39725,2,Dantocce,2155,106,3,4,7,42.9%,1h
39725,1,killer,2155,48,2,5,7,28.6%,8m
39725,1,visha,2155,97,2,6,8,25.0%,1h
39725,1,[Rac3rs]PerroRacista,2155,38,2,6,8,25.0%,53m
39725,1,LuisRaynor,2155,78,2,8,10,20.0%,5m
39725,2,Darta,2155,0,1,0,1,100.0%,15m
39725,2,naive,2155,32,1,3,4,25.0%,43m
39725,2,[1for2]Felipe,2155,94,1,3,4,25.0%,3h
39725,1,Red,2155,32,1,5,6,16.7%,47m
39725,1,Jmorfa,2155,0,1,6,7,14.3%,6m
39725,3,[LAT18]Sval,2155,0,0,1,1,0.0%,37m
39725,2,Hydrojager,2155,0,0,2,2,0.0%,3h
39725,2,Mixalot,2155,0,0,3,3,0.0%,1h
39725,1,[DE]LokiCharms,2155,0,0,5,5,0.0%,5m
39725,2,rodrigo,2155,0,0,5,5,0.0%,1h
39725,2,CrashDrill,2155,0,0,5,5,0.0%,1h
39751,1,[cusco]daniel,2154,1563,196,198,394,49.7%,3h
39751,2,KingSET,2154,1628,97,95,192,50.5%,1h
39751,2,iTaquito,2154,1648,81,77,158,51.3%,3h
39751,2,WEINERCHAP,2154,1517,71,69,140,50.7%,1h
39751,2,Ollanius,2154,350,16,11,27,59.3%,1h
39751,2,[daShop]LestweForget,2154,450,16,14,30,53.3%,1h
39751,1,ITACHI,2154,349,9,16,25,36.0%,1h
39751,3,VerumTractus,2154,216,7,12,19,36.8%,13m
39751,3,redlion,2154,224,7,21,28,25.0%,46m
39751,1,Azeta,2154,198,4,7,11,36.4%,24m
39751,1,Nannupa,2154,108,2,2,4,50.0%,40m
39751,1,UnclePoppy,2154,44,2,5,7,28.6%,1h
39751,3,Clumsycoose,2154,30,2,5,7,28.6%,25m
39751,2,maiki,2154,94,1,2,3,33.3%,3h
39751,2,[JACKY]NightHawk,2154,46,1,6,7,14.3%,1h
39751,2,Soxxii,2154,46,1,6,7,14.3%,25m
39751,1,Schlarbeck,2154,0,1,6,7,14.3%,41m
39751,2,Yazerg,2154,0,0,1,1,0.0%,1h
39751,1,deathklok,2154,0,0,3,3,0.0%,1h
39770,3,Eagle,2153,1564,342,355,697,49.1%,42m
39770,1,ELCIDFER,2153,1709,154,167,321,48.0%,3h
39770,2,HeroXapple,2153,1200,48,53,101,47.5%,40m
39770,1,Tegridad,2153,1372,45,52,97,46.4%,59m
39770,1,michealaa,2153,960,35,40,75,46.7%,40m
39770,2,HardG,2153,724,28,28,56,50.0%,3h
39770,2,Aldoapache,2153,591,23,14,37,62.2%,15m
39770,1,LittleCrown,2153,773,23,27,50,46.0%,1h
39770,1,[LJCL45]SaTo,2153,478,18,20,38,47.4%,3h
39770,1,JeansLikeMe,2153,404,14,13,27,51.9%,35m
39770,1,AwesomeSauce,2153,297,8,10,18,44.4%,1h
39770,2,SewerSquirel,2153,171,5,2,7,71.4%,1h
39770,2,uforgottodie,2153,124,5,3,8,62.5%,3h
39770,2,[RUMB]Marcus,2153,181,5,8,13,38.5%,3h
39770,1,[Shardz]Fauzi,2153,176,5,15,20,25.0%,37m
39770,2,RyanNowlan,2153,64,3,3,6,50.0%,31m
39770,2,Xenome,2153,0,3,4,7,42.9%,3h
39770,2,joel,2153,86,2,6,8,25.0%,1h
39770,1,xesarion,2153,96,2,6,8,25.0%,3h
39770,2,fishy,2153,73,2,8,10,20.0%,59m
39770,2,jifel,2153,34,1,2,3,33.3%,1h
39770,2,Moon,2153,0,1,5,6,16.7%,3h
39770,1,MrBrunelle,2153,0,1,7,8,12.5%,3h
39770,2,akiles,2153,0,0,1,1,0.0%,48m
39770,2,GzuL,2153,0,0,1,1,0.0%,1h
39770,2,CHAMACO,2153,0,0,1,1,0.0%,3h
39770,2,AlexisHF,2153,0,0,1,1,0.0%,58m
39770,2,Gabriel,2153,0,0,3,3,0.0%,3h
39770,2,Mandolore,2153,0,0,5,5,0.0%,1h
39799,1,[nieBla]ALAMUERTE,2152,1643,200,213,413,48.4%,2m
39799,1,Kbro,2152,1754,150,154,304,49.3%,3h
39799,2,Chris,2152,1609,140,142,282,49.6%,10m
39799,2,maicol,2152,1157,75,81,156,48.1%,3h
39799,1,Langoliers,2152,1440,53,55,108,49.1%,23m
39799,1,Anarkoperezo,2152,1409,49,58,107,45.8%,3h
39799,2,JNB,2152,1091,44,51,95,46.3%,29m
39799,1,SERRALNO,2152,1016,32,40,72,44.4%,1h
39799,1,Erik,2152,687,26,28,54,48.1%,50m
39799,2,RokaCola,2152,278,11,6,17,64.7%,1h
39799,1,[DCSK]Benji,2152,293,7,9,16,43.8%,49m
39799,3,Revan,2152,121,6,2,8,75.0%,45m
39799,3,EmRackk,2152,183,6,8,14,42.9%,1h
39799,1,[tCo9]steelgrim,2152,264,6,9,15,40.0%,7m
39799,2,YourLadSven,2152,183,5,4,9,55.6%,3h
39799,1,[Dv6]Xsyn,2152,142,5,11,16,31.2%,1h
39799,2,maro,2152,88,3,1,4,75.0%,14m
39799,1,[BlTEL]ARCONTE,2152,126,2,5,7,28.6%,3h
39799,2,Alex,2152,48,2,5,7,28.6%,57m
39799,3,Manox,2152,30,2,6,8,25.0%,1h
39799,2,Follamadres,2152,32,1,1,2,50.0%,1h
39799,2,Werqtor,2152,0,0,1,1,0.0%,3h
39799,2,Litware,2152,0,0,5,5,0.0%,1h
39799,2,idwaaugh,2152,0,0,5,5,0.0%,40m
39799,2,Varietal,2152,0,0,5,5,0.0%,1h
39799,2,KingGlock,2152,0,0,5,5,0.0%,15m
39825,2,Tango,2151,1498,235,249,484,48.6%,8m
39825,1,Scubasteve,2151,1577,160,144,304,52.6%,3h
39825,1,dylu,2151,1712,120,121,241,49.8%,3h
39825,2,[6661]ELFURROTAKU,2151,1322,54,48,102,52.9%,3h
39825,1,[EPCK]LightNinjaSC,2151,793,29,29,58,50.0%,26m
39825,2,TwoJ,2151,394,16,9,25,64.0%,40m
39825,2,[ISTOP]Darik,2151,92,3,3,6,50.0%,1h
39825,2,Arcturus,2151,88,3,3,6,50.0%,1h
39825,2,[Lp]JonaHxC,2151,60,2,4,6,33.3%,59m
39825,1,Bethechange,2151,34,2,5,7,28.6%,44m
39825,1,IronNose,2151,121,2,8,10,20.0%,3h
39825,2,[AVSC]ElManu,2151,0,1,1,2,50.0%,1h
39825,2,Anton,2151,32,1,3,4,25.0%,33m
39825,2,TrashRaceP,2151,42,1,5,6,16.7%,6m
39825,1,Hackbeard,2151,0,1,5,6,16.7%,3h
39825,1,martinsiete,2151,0,1,6,7,14.3%,1h
39825,2,Mothership,2151,0,0,2,2,0.0%,3h
39825,2,MacMac,2151,0,0,3,3,0.0%,3h
39825,1,HEATHER,2151,0,0,4,4,0.0%,42m
39825,2,SilkyJohnson,2151,0,0,6,6,0.0%,48m
39845,3,[Wainas]Tassadar,2150,1435,140,150,290,48.3%,1h
39845,1,PANOCHON,2150,1190,58,41,99,58.6%,3h
39845,1,Cokedajoke,2150,588,42,50,92,45.7%,32m
39845,1,[trash0]Ellisonetic,2150,1100,37,45,82,45.1%,1h
39845,1,Aguilucho,2150,752,25,27,52,48.1%,1h
39845,2,TheExecutor,2150,297,10,7,17,58.8%,3h
39845,3,Mike,2150,219,9,10,19,47.4%,25m
39845,1,HoldingW,2150,222,8,5,13,61.5%,3h
39845,2,KEN,2150,96,7,8,15,46.7%,37m
39845,2,TsarOfVodka,2150,154,5,3,8,62.5%,40m
39845,1,Ariel,2150,171,4,7,11,36.4%,1h
39845,3,Tomtom,2150,155,4,10,14,28.6%,7m
39845,2,CaptainLuke,2150,60,3,1,4,75.0%,31m
39845,2,GergtheGreat,2150,58,2,1,3,66.7%,1h
39845,2,[LOHs]popin,2150,38,1,1,2,50.0%,37m
39845,3,MikeHunt,2150,30,1,2,3,33.3%,2m
39845,2,Gromnor,2150,46,1,3,4,25.0%,3h
39845,2,DarkLight,2150,97,1,3,4,25.0%,3h
39845,1,elmarim,2150,0,1,7,8,12.5%,3m
39845,2,FelipeSantaM,2150,0,0,1,1,0.0%,1h
39845,2,DTums,2150,0,0,1,1,0.0%,3h
39845,1,marco,2150,0,0,1,1,0.0%,44m
39845,2,Xcode,2150,0,0,1,1,0.0%,25m
39845,2,BiGpUdN,2150,0,0,3,3,0.0%,1h
39869,1,hilltopbumer,2149,1040,188,178,366,51.4%,1h
39869,1,Bruno,2149,1724,129,133,262,49.2%,1h
39869,1,[GGRekt]ATruck,2149,1208,110,119,229,48.0%,1h
39869,2,PMnTHEam,2149,1378,72,72,144,50.0%,3h
39869,2,RomeoKA,2149,1031,49,47,96,51.0%,3h
39869,1,Moth,2149,1090,43,43,86,50.0%,14m
39869,3,snafu,2149,646,41,56,97,42.3%,1h
39869,1,StaelChip,2149,554,27,31,58,46.6%,51m
39869,1,PKTakeShi,2149,737,24,30,54,44.4%,22m
39869,2,[G0DB0T]deemo,2149,516,22,20,42,52.4%,3h
39869,1,Fico,2149,748,22,29,51,43.1%,13m
39869,2,[PobSC]HankScorpio,2149,434,16,9,25,64.0%,22m
39869,1,[TrshPn]Rocket,2149,480,15,19,34,44.1%,35m
39869,1,Tormey,2149,316,10,18,28,35.7%,1h
39869,1,FoxHound,2149,235,8,16,24,33.3%,50m
39869,1,tbirdxi,2149,246,7,13,20,35.0%,1h
39869,1,khemik,2149,190,5,5,10,50.0%,17m
39869,1,SneakyTurtle,2149,242,5,10,15,33.3%,3h
39869,1,BigEasy,2149,154,4,8,12,33.3%,54m
39869,2,Wezley,2149,0,3,2,5,60.0%,3h
39869,2,Cloture,2149,60,2,2,4,50.0%,14m
39869,2,Nelson,2149,84,2,6,8,25.0%,35m
39869,1,demth,2149,68,2,6,8,25.0%,3h
39869,2,WATERS,2149,0,1,0,1,100.0%,3h
39869,2,[LCE]KosaNosTTra,2149,32,1,1,2,50.0%,31m
39869,1,WishPretzel,2149,97,1,5,6,16.7%,3h
39869,1,Chxe,2149,0,1,6,7,14.3%,6m
39869,1,TheHaloJacob,2149,0,1,6,7,14.3%,1h
39869,1,Trogdor,2149,0,1,6,7,14.3%,1h
39869,1,EightBaller,2149,38,1,7,8,12.5%,1h
39869,2,Sylphrena,2149,0,0,1,1,0.0%,3h
39869,2,[ROUGES]Alamo,2149,0,0,2,2,0.0%,1h
39901,1,IIIIIIIIIIII,2148,590,192,237,429,44.8%,57m
39901,2,Majestic,2148,1562,66,64,130,50.8%,3h
39901,2,Duke,2148,1652,66,77,143,46.2%,1h
39901,1,RonnyBtancur,2148,1354,49,56,105,46.7%,41m
39901,1,HLmaster,2148,1053,35,50,85,41.2%,51m
39901,3,AnotherGonzo,2148,1004,34,47,81,42.0%,1h
39901,3,MilkAndMoney,2148,579,30,47,77,39.0%,1h
39901,2,Arathor,2148,822,28,28,56,50.0%,3h
39901,1,chzyfries,2148,880,28,35,63,44.4%,1h
39901,1,tuhermin,2148,736,23,31,54,42.6%,3h
39901,1,[LY0]grovar,2148,640,21,22,43,48.8%,1h
39901,2,Tyler,2148,464,18,15,33,54.5%,22m
39901,2,[Pyl0nZ]Roxas,2148,284,8,12,20,40.0%,59m
39901,2,InsaneDemon,2148,150,6,6,12,50.0%,3h
39901,2,SlipShade,2148,192,6,8,14,42.9%,1h
39901,3,antonio,2148,193,6,11,17,35.3%,26m
39901,1,Sam,2148,36,4,5,9,44.4%,3h
39901,1,JorgeSanchez,2148,144,4,9,13,30.8%,3h
39901,2,Donatello,2148,116,3,4,7,42.9%,29m
39901,1,pipo,2148,106,3,14,17,17.6%,3h
39901,3,Shredzilla,2148,97,2,2,4,50.0%,1h
39901,1,Gunnaz,2148,48,2,2,4,50.0%,60m
39901,1,leonC,2148,97,2,3,5,40.0%,1h
39901,2,jackfoo,2148,44,2,4,6,33.3%,3h
39901,2,jerico,2148,76,2,4,6,33.3%,24m
39901,3,[PobSC]VocaloidBot,2148,114,2,8,10,20.0%,24m
39901,2,Entertainer,2148,0,1,0,1,100.0%,43m
39901,2,Cluntang,2148,0,0,1,1,0.0%,1h
39901,2,Starlitemist,2148,0,0,1,1,0.0%,3h
39901,2,TBetaAlph,2148,0,0,3,3,0.0%,3h
39901,2,Mythos,2148,0,0,5,5,0.0%,1h
39932,1,[SCIIpy]TerranPy,2147,1503,82,83,165,49.7%,1h
39932,1,Mifune,2147,1694,81,89,170,47.6%,32m
39932,1,[CODER]centrum,2147,1591,74,78,152,48.7%,23m
39932,1,TavisAvis,2147,869,31,35,66,47.0%,1h
39932,2,[LEZZ]Delta,2147,664,23,30,53,43.4%,1h
39932,2,scarlaim,2147,494,19,16,35,54.3%,3h
39932,1,[SC2PH]RamzzZGaming,2147,482,15,20,35,42.9%,47m
39932,1,DonPablo,2147,303,7,11,18,38.9%,3h
39932,2,Amirul,2147,222,6,3,9,66.7%,32m
39932,1,zorroxf,2147,152,4,5,9,44.4%,3h
39932,1,Neto,2147,130,4,9,13,30.8%,8m
39932,2,Astraea,2147,123,3,9,12,25.0%,3h
39932,3,Disturbed,2147,30,2,1,3,66.7%,1h
39932,2,Duke,2147,30,2,1,3,66.7%,37m
39932,2,[MEERCA]SinKsa,2147,134,2,3,5,40.0%,3h
39932,1,Izanagi,2147,40,2,9,11,18.2%,3m
39932,3,darkflame,2147,30,1,1,2,50.0%,26m
39932,2,Bob,2147,0,1,3,4,25.0%,56m
39932,1,Loki,2147,97,1,3,4,25.0%,6m
39932,1,raven,2147,0,1,4,5,20.0%,3h
39932,1,duckychan,2147,96,1,5,6,16.7%,9m
39932,1,[zeez]zeezSoldat,2147,0,1,6,7,14.3%,3h
39932,2,DustDoesGood,2147,0,0,1,1,0.0%,7m
39932,3,[notman]johnrambo,2147,0,0,2,2,0.0%,1h
39932,2,DerekFF,2147,0,0,2,2,0.0%,3h
39932,2,Tristen,2147,0,0,2,2,0.0%,1h
39932,2,Kaynen,2147,0,0,5,5,0.0%,15m
39959,1,Yonstar,2146,730,68,60,128,53.1%,3h
39959,2,Jetpackracer,2146,1106,43,46,89,48.3%,10m
39959,2,Salvador,2146,406,28,29,57,49.1%,37m
39959,2,CassiusKrang,2146,646,24,22,46,52.2%,3h
39959,2,rockabilly,2146,330,11,6,17,64.7%,3h
39959,2,rustatfive,2146,314,10,32,42,23.8%,3h
39959,2,teamleader,2146,250,9,6,15,60.0%,3h
39959,1,VoidStalker,2146,358,9,15,24,37.5%,3h
39959,2,RandALthor,2146,114,4,2,6,66.7%,3h
39959,1,Player,2146,96,3,8,11,27.3%,21m
39959,2,mane,2146,60,2,4,6,33.3%,11m
39959,2,[SOfC]elpatitodos,2146,0,1,0,1,100.0%,22m
39959,1,ushiocham,2146,48,1,2,3,33.3%,3h
39959,1,IFT,2146,0,1,6,7,14.3%,3h
39959,2,FatalPopshoT,2146,0,0,1,1,0.0%,3h
39959,1,lkzr,2146,0,0,2,2,0.0%,6m
39959,3,RickGrimes,2146,0,0,2,2,0.0%,1h
39959,2,Crusher,2146,0,0,5,5,0.0%,3h
39977,2,[Nat20s]DavidicusIII,2145,1631,98,88,186,52.7%,15m
39977,1,[SWOU]ALaN,2145,1249,93,86,179,52.0%,3h
39977,1,DreamKiller,2145,1381,91,103,194,46.9%,3h
39977,2,JERMS,2145,1063,68,72,140,48.6%,1h
39977,1,JhosuaSuren,2145,1266,61,59,120,50.8%,1h
39977,1,javana,2145,1245,60,48,108,55.6%,41m
39977,2,NestoG,2145,1491,58,57,115,50.4%,1h
39977,1,JavierAlfaOP,2145,938,54,53,107,50.5%,41m
39977,1,Swoh,2145,1389,54,54,108,50.0%,5m
39977,1,[MARIO6]magolunatico,2145,1174,42,45,87,48.3%,36m
39977,2,CosmolaGamer,2145,832,41,46,87,47.1%,1h
39977,2,ogil,2145,308,12,11,23,52.2%,24m
39977,2,Monty,2145,374,12,16,28,42.9%,1h
39977,2,[USUCC]FlyAndrew,2145,264,9,12,21,42.9%,28m
39977,1,Seldon,2145,283,8,14,22,36.4%,1h
39977,1,luks,2145,108,7,5,12,58.3%,1h
39977,2,Deathtolife,2145,112,6,6,12,50.0%,1h
39977,3,MookieX,2145,102,5,21,26,19.2%,1h
39977,1,Cpkinz,2145,96,3,8,11,27.3%,3h
39977,2,danybutch,2145,30,2,2,4,50.0%,33m
39977,1,shnauu,2145,88,2,5,7,28.6%,59m
39977,3,[RUD3]jstrong,2145,30,2,7,9,22.2%,1h
39977,2,Monk,2145,48,2,7,9,22.2%,1h
39977,2,DeAtShOt,2145,0,1,1,2,50.0%,1h
39977,2,Ngozi,2145,30,1,2,3,33.3%,3h
39977,2,narutogpd,2145,0,0,1,1,0.0%,43m
39977,1,TheDoctor,2145,0,0,8,8,0.0%,3h
40004,1,[EVICT]Kilgoretrout,2144,1750,198,203,401,49.4%,46m
40004,3,claudius,2144,1304,182,180,362,50.3%,23m
40004,1,FerWolf,2144,743,128,148,276,46.4%,3h
40004,1,Keats,2144,1578,65,68,133,48.9%,3h
40004,3,Zerg,2144,1369,57,71,128,44.5%,13m
40004,1,Whion,2144,1260,49,42,91,53.8%,22m
40004,2,[420SC2]barbarian,2144,1161,46,38,84,54.8%,3h
40004,1,SpYdaBlaK,2144,1320,43,52,95,45.3%,3h
40004,2,hamsammich,2144,351,30,25,55,54.5%,3h
40004,1,muttonmitt,2144,659,24,28,52,46.2%,3h
40004,1,BigSlime,2144,465,23,18,41,56.1%,3h
40004,1,JaseEF,2144,325,12,14,26,46.2%,25m
40004,1,Biglawggg,2144,340,10,15,25,40.0%,58m
40004,1,HisokaNoob,2144,230,9,13,22,40.9%,3h
40004,2,AdrianKobe,2144,248,8,10,18,44.4%,1h
40004,3,aneurisma,2144,226,8,23,31,25.8%,1h
40004,1,Hailfire,2144,150,5,7,12,41.7%,1h
40004,1,Lucho,2144,38,2,6,8,25.0%,40m
40004,2,Nightshade,2144,58,2,6,8,25.0%,1h
40004,2,Roderick,2144,44,1,1,2,50.0%,36m
40004,2,Nate,2144,93,1,5,6,16.7%,1h
40004,1,nate,2144,0,1,6,7,14.3%,3h
40004,1,LBrAyaNPiOla,2144,0,1,6,7,14.3%,1h
40004,1,[SWOU]Angelo,2144,0,1,7,8,12.5%,3h
40004,1,[Asmbly]Smith,2144,0,0,1,1,0.0%,7m
40004,2,[FTLTX]Omega,2144,0,0,1,1,0.0%,3h
40004,2,Breezeboy,2144,0,0,1,1,0.0%,6m
40004,2,[GeM]Stealthmoe,2144,0,0,1,1,0.0%,3h
40004,2,Maverick,2144,0,0,4,4,0.0%,1h
40004,1,leeler,2144,0,0,4,4,0.0%,3h
40004,2,MSTY,2144,0,0,5,5,0.0%,3h
40035,3,Hiley,2143,1382,186,186,372,50.0%,2m
40035,1,Snider,2143,1747,104,112,216,48.1%,56m
40035,1,RhA,2143,465,74,69,143,51.7%,3h
40035,2,[Mungus]Raph,2143,354,13,13,26,50.0%,3h
40035,1,Fiorex,2143,428,11,23,34,32.4%,3h
40035,2,Prizior,2143,300,10,10,20,50.0%,29m
40035,1,vassar,2143,332,10,20,30,33.3%,1h
40035,2,Killermanic,2143,186,7,5,12,58.3%,22m
40035,3,[DUT1]diegox,2143,169,5,3,8,62.5%,1h
40035,2,ALVHP,2143,205,5,13,18,27.8%,3h
40035,2,[ZGZGZG]mike,2143,94,4,3,7,57.1%,3h
40035,2,raspberrySC,2143,118,4,3,7,57.1%,11m
40035,3,[WLHM]Fallarg,2143,147,4,4,8,50.0%,3h
40035,2,Negamaku,2143,94,1,5,6,16.7%,3h
40035,3,Nathan,2143,30,1,12,13,7.7%,59m
40035,2,Alejandro,2143,0,0,3,3,0.0%,28m
40035,1,andresrnv,2143,0,0,3,3,0.0%,15m
40035,2,SwampFox,2143,0,0,5,5,0.0%,3h
40035,2,david,2143,0,0,5,5,0.0%,1h
40054,2,[ChiFan]SHOOTER,2142,957,154,175,329,46.8%,1h
40054,1,Goofus,2142,1040,42,44,86,48.8%,3h
40054,1,STEVE,2142,978,39,43,82,47.6%,1h
40054,3,[sk3tch]faycito,2142,646,24,38,62,38.7%,8m
40054,2,JHOELORD,2142,685,22,27,49,44.9%,1h
40054,2,ZicaBraba,2142,573,21,17,38,55.3%,15m
40054,3,Meaot,2142,320,12,18,30,40.0%,3h
40054,1,echun,2142,378,11,14,25,44.0%,3h
40054,2,RyzeerDC,2142,292,10,7,17,58.8%,1h
40054,3,Percival,2142,318,10,26,36,27.8%,3h
40054,2,RECONFIGURE,2142,224,9,15,24,37.5%,48m
40054,2,Haytridd,2142,132,5,2,7,71.4%,56m
40054,2,[PBNQ]demonroots,2142,118,5,4,9,55.6%,3h
40054,1,[iMECH]Zapou,2142,194,5,15,20,25.0%,3h
40054,3,DylanHxC,2142,173,4,6,10,40.0%,3h
40054,1,Kevin,2142,118,3,6,9,33.3%,1h
40054,2,Kontroll,2142,102,2,2,4,50.0%,1h
40054,1,banana,2142,118,2,5,7,28.6%,50m
40054,1,Jester,2142,48,2,7,9,22.2%,1h
40054,2,Primex,2142,97,1,6,7,14.3%,1h
40054,2,[JaMiT]Voskof,2142,0,0,1,1,0.0%,1h
40054,2,[KePar]tanke,2142,0,0,1,1,0.0%,3h
40076,2,[OBDT]rgruner,2141,1406,220,219,439,50.1%,1h
40076,1,YCHwy,2141,1622,171,198,369,46.3%,3h
40076,2,cucu,2141,705,52,47,99,52.5%,3h
40076,2,[CTVS]Ezkalante,2141,1340,49,49,98,50.0%,3h
40076,1,Wantan,2141,1191,48,52,100,48.0%,3h
40076,2,Slava,2141,450,32,35,67,47.8%,1h
40076,1,radoholio,2141,863,27,36,63,42.9%,1h
40076,2,XXDrowZee,2141,438,26,30,56,46.4%,3h
40076,1,WAUWANT,2141,554,18,24,42,42.9%,41m
40076,1,PORRENO,2141,386,14,13,27,51.9%,49m
40076,2,AsisTyrax,2141,346,13,11,24,54.2%,1h
40076,1,LarryHolmes,2141,456,12,18,30,40.0%,3h
40076,2,SamyG,2141,244,10,10,20,50.0%,3h
40076,3,AlbinoRhino,2141,279,10,14,24,41.7%,1h
40076,3,ThunderGirth,2141,293,9,12,21,42.9%,1h
40076,1,Alucard,2141,229,6,6,12,50.0%,47m
40076,1,odnal,2141,186,6,8,14,42.9%,7m
40076,2,Padraic,2141,243,6,11,17,35.3%,3h
40076,1,[ZTemp]Drucifer,2141,162,4,10,14,28.6%,3h
40076,2,[AD3C]Maruel,2141,147,3,3,6,50.0%,3h
40076,2,VLADE,2141,141,3,4,7,42.9%,3h
40076,2,DavidH,2141,18,2,2,4,50.0%,3h
40076,2,lostcozz,2141,0,1,0,1,100.0%,6m
40076,3,Neemo,2141,0,1,0,1,100.0%,42m
40076,2,doomfish,2141,34,1,3,4,25.0%,3h
40076,2,Berrian,2141,0,1,4,5,20.0%,15m
40076,1,FreshMcPickl,2141,0,1,5,6,16.7%,1h
40076,1,UziBazooka,2141,0,1,6,7,14.3%,1h
40076,1,MAINFRAME,2141,48,1,8,9,11.1%,31m
40076,1,[rSz]OrbitalObs,2141,0,0,2,2,0.0%,3h
40076,2,Kchupenco,2141,0,0,5,5,0.0%,1h
40076,1,LucasCrack,2141,0,0,7,7,0.0%,59m
40108,1,Forex,2140,1690,86,95,181,47.5%,11m
40108,1,Eglamire,2140,1358,47,47,94,50.0%,49m
40108,2,odtorres,2140,1339,46,52,98,46.9%,43m
40108,1,SinEater,2140,1053,34,46,80,42.5%,1h
40108,1,VirtualDhruv,2140,778,30,30,60,50.0%,3h
40108,1,VikingDance,2140,342,13,13,26,50.0%,1h
40108,2,Aura,2140,304,12,9,21,57.1%,1h
40108,2,[8iSh]BossMan,2140,354,12,14,26,46.2%,1h
40108,2,ROMARIO,2140,317,10,7,17,58.8%,3h
40108,1,FateYeah,2140,262,9,10,19,47.4%,1h
40108,2,CAOQ,2140,171,6,4,10,60.0%,3h
40108,2,costica,2140,92,4,1,5,80.0%,22m
40108,1,orteliopf,2140,134,4,9,13,30.8%,3h
40108,2,Terrible,2140,86,3,4,7,42.9%,55m
40108,1,[SMV]NullPointer,2140,0,3,5,8,37.5%,3h
40108,2,Ravenexia,2140,48,3,5,8,37.5%,1h
40108,2,VENGANZA,2140,94,1,1,2,50.0%,16m
40108,1,KingKwibster,2140,0,1,2,3,33.3%,3h
40108,2,ilovecj,2140,0,1,2,3,33.3%,7m
40108,2,Olafmeister,2140,0,0,1,1,0.0%,3h
40108,3,Cordial,2140,0,0,1,1,0.0%,1h
40108,2,[MALOs]Koss,2140,0,0,1,1,0.0%,3h
40130,1,Tyrion,2139,1476,60,59,119,50.4%,3h
40130,1,Randy,2139,1131,49,60,109,45.0%,1h
40130,1,patimomoxd,2139,933,34,33,67,50.7%,50m
40130,1,[SIMPx]TottyX,2139,871,33,33,66,50.0%,3m
40130,1,alanrock,2139,645,28,21,49,57.1%,16m
40130,2,Owens,2139,636,22,24,46,47.8%,40m
40130,2,artill,2139,470,17,20,37,45.9%,3h
40130,2,[3384]IGOR,2139,402,16,10,26,61.5%,1h
40130,3,UntilMonday,2139,379,14,27,41,34.1%,7m
40130,2,[RSC2]Coronel,2139,268,11,4,15,73.3%,16m
40130,1,falconlm,2139,166,5,3,8,62.5%,26m
40130,2,DEZKARTE,2139,86,3,2,5,60.0%,3h
40130,1,Diogo,2139,48,3,7,10,30.0%,1h
40130,3,Truc,2139,64,3,10,13,23.1%,3h
40130,2,[MVPA]DocSadrik,2139,32,2,2,4,50.0%,15m
40130,2,[JSTCE]Nismo,2139,0,2,3,5,40.0%,1h
40130,2,[MBS209]TheRealMvP,2139,0,1,1,2,50.0%,1h
40130,2,[BLHL]Iamcute,2139,0,1,1,2,50.0%,3h
40130,2,ChApnU,2139,88,1,1,2,50.0%,4m
40130,1,MAFIOSOMEX,2139,0,1,3,4,25.0%,7m
40130,2,Matjay,2139,30,1,4,5,20.0%,3h
40130,1,Gust,2139,84,1,5,6,16.7%,38m
40130,2,juiko,2139,0,0,1,1,0.0%,10m
40130,2,moober,2139,0,0,1,1,0.0%,29m
40130,2,Khiggun,2139,0,0,1,1,0.0%,15m
40130,2,forzanocta,2139,0,0,2,2,0.0%,3h
40130,2,[WSxP]Steny,2139,0,0,4,4,0.0%,33m
40130,2,pool,2139,0,0,5,5,0.0%,10m
40158,1,fascist,2138,1406,181,231,412,43.9%,4m
40158,1,Lonestar,2138,1186,57,57,114,50.0%,1h
40158,1,[LDTJC]JcCharly,2138,831,45,39,84,53.6%,3h
40158,1,Otocani,2138,736,40,28,68,58.8%,52m
40158,2,Kampfer,2138,755,34,35,69,49.3%,3h
40158,1,Omar,2138,735,25,25,50,50.0%,43m
40158,2,[10MMR]Swarm,2138,504,22,16,38,57.9%,25m
40158,2,[5252]Starstriker,2138,594,22,17,39,56.4%,14m
40158,2,seerfax,2138,430,16,13,29,55.2%,3h
40158,2,FrogMan,2138,402,16,14,30,53.3%,33m
40158,3,tiffany,2138,239,7,4,11,63.6%,44m
40158,2,OzzyValkyriE,2138,172,6,7,13,46.2%,3h
40158,2,Stza,2138,178,5,9,14,35.7%,1h
40158,1,mikey,2138,162,5,13,18,27.8%,1h
40158,2,[Algebr]MathTeacher,2138,86,4,0,4,100.0%,32m
40158,1,InvalidGhost,2138,146,4,7,11,36.4%,3h
40158,3,IIIIIIIIIIII,2138,122,3,1,4,75.0%,1h
40158,1,DarkTemplar,2138,97,2,0,2,100.0%,40m
40158,2,FerBo,2138,30,2,2,4,50.0%,3h
40158,2,haraldo,2138,58,2,6,8,25.0%,3h
40158,1,CDN,2138,97,2,8,10,20.0%,25m
40158,1,Trevor,2138,0,1,0,1,100.0%,31m
40158,1,Xavi,2138,96,1,1,2,50.0%,10m
40158,2,Zeah,2138,0,1,3,4,25.0%,57m
40158,2,MagistradoAM,2138,0,1,4,5,20.0%,1h
40158,2,Wolf,2138,48,1,6,7,14.3%,50m
40158,2,ItzAfroNinja,2138,0,0,1,1,0.0%,3h
40158,2,Kastrioti,2138,0,0,1,1,0.0%,1h
40158,2,BoubsRNice,2138,0,0,2,2,0.0%,14m
40158,1,rexchancho,2138,0,0,2,2,0.0%,44m
40158,2,[FriB]RodSteward,2138,0,0,2,2,0.0%,3h
40158,1,Rave,2138,0,0,3,3,0.0%,6m
40158,2,WildRageWill,2138,0,0,5,5,0.0%,33m
40158,2,Bigmichael,2138,0,0,6,6,0.0%,1h
40192,2,[UpxV]spedross,2137,1466,207,204,411,50.4%,1h
40192,1,Domiq,2137,1571,92,82,174,52.9%,3h
40192,3,BrickLayerLV,2137,1550,61,81,142,43.0%,32m
40192,3,Ghost,2137,1117,57,67,124,46.0%,2m
40192,1,ElctricJuice,2137,851,38,40,78,48.7%,1h
40192,1,DaviXu,2137,644,20,20,40,50.0%,47m
40192,1,OMEGAman,2137,412,16,16,32,50.0%,3h
40192,1,[LOSPLR]Volfield,2137,494,16,18,34,47.1%,11m
40192,2,[nStars]Stoney,2137,234,8,7,15,53.3%,18m
40192,1,brendenator,2137,251,8,9,17,47.1%,24m
40192,1,kakarot,2137,223,8,10,18,44.4%,3h
40192,3,Hitchslap,2137,145,6,7,13,46.2%,25m
40192,2,ArguingGibon,2137,114,5,3,8,62.5%,48m
40192,2,bluetiger,2137,254,5,9,14,35.7%,33m
40192,2,ZheTPlayer,2137,58,3,0,3,100.0%,49m
40192,3,Zyeurgh,2137,109,3,2,5,60.0%,45m
40192,2,lmaonoob,2137,39,3,3,6,50.0%,24m
40192,2,Malky,2137,30,2,0,2,100.0%,3h
40192,2,[AsNa]AZsnakes,2137,68,2,2,4,50.0%,3h
40192,2,Zzang,2137,123,2,7,9,22.2%,29m
40192,2,SkyPiglet,2137,0,1,0,1,100.0%,3h
40192,2,Leekorean,2137,0,1,0,1,100.0%,3h
40192,1,Neriw,2137,0,1,0,1,100.0%,3h
40192,2,Meta,2137,0,1,0,1,100.0%,1h
40192,1,ItsMeDio,2137,0,0,1,1,0.0%,3h
40192,2,Brutus,2137,0,0,1,1,0.0%,7m
40192,2,SLOSK,2137,0,0,1,1,0.0%,1h
40192,2,Nicholai,2137,0,0,2,2,0.0%,55m
40220,1,Chuckus,2136,1678,215,224,439,49.0%,1h
40220,1,GonZoRIM,2136,1192,133,132,265,50.2%,1h
40220,1,squintavious,2136,1275,90,80,170,52.9%,41m
40220,1,Perfectcell,2136,1376,57,55,112,50.9%,44m
40220,3,TiredofLife,2136,314,38,48,86,44.2%,29m
40220,1,Disturb,2136,847,30,36,66,45.5%,1h
40220,2,MelonLord,2136,644,24,20,44,54.5%,33m
40220,1,[Umizoo]BloodSparrow,2136,848,24,32,56,42.9%,3h
40220,2,Zut,2136,624,23,23,46,50.0%,3h
40220,1,michael,2136,572,17,27,44,38.6%,3h
40220,1,Planta,2136,461,16,25,41,39.0%,3h
40220,2,Wulfing,2136,332,12,9,21,57.1%,59m
40220,1,Geobraun,2136,289,8,7,15,53.3%,3h
40220,3,DingusKhan,2136,247,7,14,21,33.3%,3h
40220,2,[AlIin]Kartoffel,2136,172,5,5,10,50.0%,1h
40220,1,[VFam2]GeneralTazz,2136,152,5,11,16,31.2%,41m
40220,2,Daniel,2136,120,4,5,9,44.4%,29m
40220,2,Talida,2136,114,4,5,9,44.4%,1h
40220,2,Biden,2136,116,4,6,10,40.0%,1h
40220,2,Eidean,2136,118,4,9,13,30.8%,1h
40220,2,[NLTN]TITANICO,2136,58,3,3,6,50.0%,4m
40220,2,JonnyScash,2136,38,1,1,2,50.0%,22m
40220,2,Saturnus,2136,0,1,2,3,33.3%,7m
40220,1,taeyun,2136,0,0,1,1,0.0%,6m
40220,2,[CDNGUY]ProudCdn,2136,73,0,3,3,0.0%,32m
40220,2,Funkymonk,2136,0,0,5,5,0.0%,13m
40246,1,[Hector]Hector,2135,1678,197,201,398,49.5%,3h
40246,1,NNYJHO,2135,923,177,187,364,48.6%,36m
40246,2,rodrycc,2135,1680,114,123,237,48.1%,1h
40246,2,Ziggydust,2135,1492,94,94,188,50.0%,14m
40246,2,Badlerman,2135,1459,85,94,179,47.5%,15m
40246,1,jhojato,2135,1393,52,55,107,48.6%,3h
40246,2,MegaChad,2135,755,40,30,70,57.1%,1h
40246,2,trvegamer,2135,726,27,36,63,42.9%,18m
40246,2,[HUL]Edzilla,2135,542,25,23,48,52.1%,40m
40246,1,[ExcIgN]JAVICHIDO,2135,438,23,24,47,48.9%,32m
40246,2,BichoOscuro,2135,542,22,18,40,55.0%,3h
40246,1,aaaaaaohhhh,2135,725,22,25,47,46.8%,1h
40246,1,FlensiGER,2135,635,22,25,47,46.8%,47m
40246,2,Navarrox,2135,403,17,8,25,68.0%,29m
40246,1,elsoplanucas,2135,598,17,21,38,44.7%,56m
40246,1,veronika,2135,362,13,24,37,35.1%,58m
40246,1,[HuVo]TAke,2135,346,12,26,38,31.6%,37m
40246,3,harshist,2135,318,10,15,25,40.0%,36m
40246,1,FinisTerre,2135,316,9,19,28,32.1%,3m
40246,2,Cendrars,2135,237,8,7,15,53.3%,16m
40246,3,RoosterBlade,2135,252,8,11,19,42.1%,36m
40246,1,[SECT4]BLAZEibaktxe,2135,327,8,19,27,29.6%,3h
40246,1,KungMarco,2135,202,6,7,13,46.2%,3h
40246,2,awesomeT,2135,180,6,12,18,33.3%,3h
40246,1,DML,2135,255,6,15,21,28.6%,3h
40246,1,Hachagigant,2135,0,3,3,6,50.0%,3h
40246,1,Slade,2135,32,2,5,7,28.6%,3h
40246,2,Metaberd,2135,0,1,0,1,100.0%,1h
40246,2,Coochtang,2135,0,0,1,1,0.0%,3h
40246,1,[SIZZLR]galactikk,2135,0,0,1,1,0.0%,1h
40246,2,[LeMono]PillanTheWte,2135,0,0,1,1,0.0%,1h
40246,1,ArthurF,2135,0,0,1,1,0.0%,1h
40246,1,kai,2135,0,0,3,3,0.0%,20m
40246,1,JeanPaul,2135,0,0,3,3,0.0%,3h
40246,1,Bakulu,2135,0,0,4,4,0.0%,1h
40246,2,MoisésZkzk,2135,0,0,5,5,0.0%,6m
40282,1,ELTURCO,2134,1736,190,195,385,49.4%,24m
40282,2,[DRKDMN]Sequetela,2134,1708,186,204,390,47.7%,3h
40282,1,jvroblero,2134,1740,149,156,305,48.9%,16m
40282,1,[alabfa]artax,2134,538,52,46,98,53.1%,47m
40282,1,TyCoAvenger,2134,857,27,35,62,43.5%,58m
40282,2,[ZTempz]NeoPeterPan,2134,611,22,18,40,55.0%,32m
40282,1,[Baitin]colossus,2134,809,22,33,55,40.0%,32m
40282,2,OPTIMIZE,2134,502,18,19,37,48.6%,3h
40282,2,sherlock,2134,334,12,11,23,52.2%,1h
40282,2,NICK,2134,310,10,11,21,47.6%,1h
40282,2,SoloxHans,2134,178,7,3,10,70.0%,36m
40282,2,dcfobreezy,2134,204,7,8,15,46.7%,40m
40282,3,Starboy,2134,238,7,8,15,46.7%,3h
40282,3,Santuy,2134,170,5,1,6,83.3%,45m
40282,2,PanBlanco,2134,122,5,6,11,45.5%,1h
40282,1,que,2134,146,5,7,12,41.7%,1h
40282,2,DarthMorice,2134,0,4,5,9,44.4%,1h
40282,2,[sbboys]Tiotao,2134,122,4,11,15,26.7%,3h
40282,1,TIGERHAZARD,2134,141,3,8,11,27.3%,1h
40282,1,jachoco,2134,96,3,9,12,25.0%,3h
40282,2,Cassius,2134,0,2,3,5,40.0%,1h
40282,1,Tonn,2134,46,2,7,9,22.2%,45m
40282,1,MARTE,2134,48,2,7,9,22.2%,59m
40282,2,Rustmuggins,2134,0,1,0,1,100.0%,33m
40282,3,[TwiLit]Hardees,2134,0,1,0,1,100.0%,59m
40282,2,TryHard,2134,0,1,0,1,100.0%,1h
40282,1,Tony,2134,0,1,7,8,12.5%,1h
40282,1,scorcrum,2134,0,0,1,1,0.0%,3h
40282,2,Veznan,2134,0,0,2,2,0.0%,3h
40282,2,CHOMS,2134,0,0,5,5,0.0%,25m
40312,1,Taviux,2133,1737,157,165,322,48.8%,16m
40312,1,Bezerkerwars,2133,1746,145,142,287,50.5%,28m
40312,1,Pedro,2133,1666,133,125,258,51.6%,3h
40312,1,Fury,2133,1594,108,109,217,49.8%,3h
40312,3,MrBeta,2133,1527,68,74,142,47.9%,3h
40312,1,CLAUESTEBAN,2133,1506,61,65,126,48.4%,1h
40312,1,YZacovelU,2133,1147,52,61,113,46.0%,16m
40312,2,ELxTIRRI,2133,1041,43,39,82,52.4%,1h
40312,1,thedecider,2133,630,20,26,46,43.5%,47m
40312,3,Maybe,2133,544,19,25,44,43.2%,3h
40312,3,rasincrasin,2133,524,17,30,47,36.2%,18m
40312,2,Killersplash,2133,458,16,17,33,48.5%,32m
40312,1,zegoblin,2133,524,15,21,36,41.7%,47m
40312,2,Allison,2133,258,9,13,22,40.9%,13m
40312,1,noOne,2133,124,4,10,14,28.6%,1h
40312,1,ShadowXlayer,2133,0,3,3,6,50.0%,47m
40312,2,PerroGelido,2133,34,2,1,3,66.7%,32m
40312,2,SERVIOTULIO,2133,0,2,8,10,20.0%,24m
40312,1,Yooxxty,2133,0,1,0,1,100.0%,60m
40312,3,tiberius,2133,0,1,2,3,33.3%,25m
40312,2,WLwanlee,2133,0,1,3,4,25.0%,1h
40312,2,Kevincap,2133,0,1,3,4,25.0%,7m
40312,2,CreepFingers,2133,94,1,5,6,16.7%,1h
40312,1,Grenouille,2133,0,1,7,8,12.5%,7m
40312,3,ZERD,2133,0,1,7,8,12.5%,56m
40312,2,raf,2133,0,0,1,1,0.0%,1h
40312,2,RIGO,2133,0,0,2,2,0.0%,16m
40312,1,URSA,2133,0,0,3,3,0.0%,1h
40312,2,Ddeathgun,2133,0,0,5,5,0.0%,6m
40341,1,[F0E]Trey,2132,1682,146,138,284,51.4%,3h
40341,2,HunterXD,2132,1287,124,131,255,48.6%,32m
40341,2,Dariuz,2132,1195,51,40,91,56.0%,3h
40341,1,Taemin,2132,1330,46,60,106,43.4%,3h
40341,2,Zaphrez,2132,878,33,30,63,52.4%,1h
40341,2,Xythe,2132,967,33,57,90,36.7%,59m
40341,2,[DEVOER]DEHAKA,2132,500,27,27,54,50.0%,37m
40341,2,Surfiesmurf,2132,570,19,27,46,41.3%,1h
40341,1,[YDRA]wirox,2132,182,18,18,36,50.0%,1h
40341,3,[LY]Denis,2132,428,18,19,37,48.6%,1h
40341,2,Tubbs,2132,463,13,19,32,40.6%,3h
40341,2,MARINESxONLY,2132,230,8,2,10,80.0%,40m
40341,2,CHeeseSAMICH,2132,190,6,11,17,35.3%,3h
40341,1,TApocalipsys,2132,94,5,12,17,29.4%,3h
40341,2,Tichoundrius,2132,90,4,2,6,66.7%,1h
40341,1,Willy,2132,143,3,1,4,75.0%,1h
40341,2,ChiMartian,2132,30,2,2,4,50.0%,58m
40341,1,heftynomad,2132,48,2,9,11,18.2%,3h
40341,2,Murphyslaw,2132,64,2,14,16,12.5%,15m
40341,2,LlamaKing,2132,32,1,1,2,50.0%,1h
40341,2,SonicYouth,2132,30,1,3,4,25.0%,14m
40341,2,ebenezer,2132,34,1,3,4,25.0%,3h
40341,1,Archer,2132,0,1,3,4,25.0%,1h
40341,2,ElCore,2132,0,1,4,5,20.0%,3h
40341,2,ZATLAN,2132,42,1,4,5,20.0%,1h
40341,2,GANNON,2132,0,0,1,1,0.0%,1h
40341,2,sungmo,2132,0,0,1,1,0.0%,29m
40341,2,[cluez]NolaSaints,2132,0,0,4,4,0.0%,37m
40341,2,Barcrawler,2132,0,0,5,5,0.0%,6m
40341,2,BSmooth,2132,0,0,6,6,0.0%,3h
40371,3,Dyln,2131,1306,154,145,299,51.5%,3h
40371,1,Darkstar,2131,1737,74,73,147,50.3%,52m
40371,1,alexxxxxx,2131,1150,45,47,92,48.9%,3h
40371,1,DanniMC,2131,868,30,35,65,46.2%,3h
40371,1,Brautigan,2131,582,19,18,37,51.4%,3h
40371,3,CubeBrick,2131,72,16,33,49,32.7%,1h
40371,1,Vanden,2131,526,15,22,37,40.5%,32m
40371,1,MastrDoG,2131,403,13,19,32,40.6%,3h
40371,2,AnthonyQ,2131,111,11,10,21,52.4%,37m
40371,1,Leoric,2131,391,11,14,25,44.0%,3h
40371,2,theMeasure,2131,184,6,5,11,54.5%,1h
40371,1,TheInfinitus,2131,230,6,12,18,33.3%,41m
40371,3,ZeCarrot,2131,169,5,12,17,29.4%,7m
40371,1,bigbigbuck,2131,120,4,7,11,36.4%,16m
40371,2,nlgxpress,2131,92,4,8,12,33.3%,29m
40371,2,[RONM]Janico,2131,74,3,1,4,75.0%,55m
40371,1,Zealen,2131,150,3,7,10,30.0%,3h
40371,1,Karper,2131,146,3,9,12,25.0%,30m
40371,1,xdetelor,2131,108,3,10,13,23.1%,3h
40371,2,CmdrSunTzu,2131,30,2,3,5,40.0%,1h
40371,2,[cipote]Terrano,2131,0,1,0,1,100.0%,16m
40371,1,[ZTempz]Microvawe,2131,0,1,0,1,100.0%,40m
40371,2,uFFoZ,2131,34,1,2,3,33.3%,22m
40371,1,Rockwell,2131,0,1,7,8,12.5%,42m
40371,2,Genidoxian,2131,0,0,1,1,0.0%,22m
40371,2,Pisnug,2131,0,0,1,1,0.0%,1h
40371,2,MUMBLES,2131,0,0,3,3,0.0%,55m
40371,2,logyko,2131,0,0,5,5,0.0%,56m
40399,2,canman,2130,1624,462,492,954,48.4%,3h
40399,1,QORIBOY,2130,1225,48,42,90,53.3%,3h
40399,1,RichixD,2130,1172,38,47,85,44.7%,3h
40399,1,[Um2]UmDoisSnake,2130,770,25,32,57,43.9%,3h
40399,2,PrinceKing,2130,550,18,19,37,48.6%,1h
40399,2,DirtyVirus,2130,373,14,8,22,63.6%,3h
40399,3,Munra,2130,246,10,12,22,45.5%,1h
40399,1,sKoRep,2130,324,9,19,28,32.1%,3h
40399,1,shadynasty,2130,199,8,6,14,57.1%,1h
40399,1,sirius,2130,210,7,10,17,41.2%,24m
40399,3,[DhZAc1]Caroles,2130,192,5,2,7,71.4%,1h
40399,1,Maxz,2130,172,5,14,19,26.3%,28m
40399,2,Bones,2130,92,3,8,11,27.3%,29m
40399,2,Coneylake,2130,0,1,1,2,50.0%,26m
40399,2,McBane,2130,0,0,1,1,0.0%,7m
40399,2,mArineEs,2130,0,0,1,1,0.0%,40m
40399,1,Kan,2130,0,0,1,1,0.0%,3h
40399,2,antiSKILLman,2130,0,0,5,5,0.0%,1h
40417,2,Darthvader,2129,1576,69,67,136,50.7%,3h
40417,1,Ruben,2129,819,55,44,99,55.6%,42m
40417,1,[MPC02]Bleezzy,2129,856,27,32,59,45.8%,3h
40417,2,SHADOWBLACK,2129,672,25,26,51,49.0%,3h
40417,2,BLIPIS,2129,157,15,15,30,50.0%,13m
40417,2,[sLuxx]CaptianG,2129,303,11,17,28,39.3%,3h
40417,2,red,2129,274,11,18,29,37.9%,3h
40417,1,NoseTypist,2129,368,10,15,25,40.0%,3h
40417,2,SteveHarvey,2129,243,10,17,27,37.0%,3h
40417,2,CamperCombo,2129,212,8,9,17,47.1%,3h
40417,2,MMRGiver,2129,255,6,6,12,50.0%,33m
40417,1,ZachChristie,2129,192,4,4,8,50.0%,59m
40417,1,iamnoobplz,2129,34,2,8,10,20.0%,1h
40417,2,SANDRAFEEDS,2129,0,1,0,1,100.0%,1h
40417,2,IIIIIIIIIIII,2129,0,1,0,1,100.0%,1h
40417,1,Mygraine,2129,38,1,7,8,12.5%,3h
40417,2,STARBLACK,2129,0,0,2,2,0.0%,1h
40417,2,[NAC2]IBeetle,2129,0,0,4,4,0.0%,3h
40435,1,[HnTr]Dekind,2128,1715,192,197,389,49.4%,44m
40435,3,Dragneel,2128,1474,72,82,154,46.8%,1h
40435,2,Topus,2128,1431,69,70,139,49.6%,16m
40435,1,[n1zzle]Ethan,2128,785,45,57,102,44.1%,14m
40435,2,Protoss,2128,792,41,21,62,66.1%,56m
40435,3,ButtCustard,2128,1096,37,52,89,41.6%,19m
40435,1,qvelle,2128,836,26,32,58,44.8%,1h
40435,1,rlo,2128,785,25,30,55,45.5%,1h
40435,1,TitanAtom,2128,598,22,24,46,47.8%,1h
40435,1,Pysical,2128,716,22,29,51,43.1%,1h
40435,1,[KEKKK]Inquits,2128,383,16,16,32,50.0%,3h
40435,1,jandres,2128,454,13,18,31,41.9%,3h
40435,2,CallMeAl,2128,320,12,7,19,63.2%,1h
40435,1,Frank,2128,372,11,15,26,42.3%,1h
40435,2,[LoWiz]Andolf,2128,216,10,7,17,58.8%,1h
40435,3,Walrus,2128,227,7,15,22,31.8%,3h
40435,2,Artanis,2128,158,4,3,7,57.1%,3h
40435,3,KniteRider,2128,0,3,7,10,30.0%,3h
40435,1,[D1kBlz]slash,2128,60,3,8,11,27.3%,47m
40435,3,kst,2128,30,3,8,11,27.3%,20m
40435,1,Russik,2128,118,2,8,10,20.0%,3h
40435,3,jjjjjjjjjjjj,2128,0,1,1,2,50.0%,15m
40435,2,craby,2128,0,1,3,4,25.0%,3h
40435,2,Luis,2128,0,0,5,5,0.0%,1h
40435,2,Hazery,2128,0,0,5,5,0.0%,1h
40435,2,Han,2128,0,0,5,5,0.0%,3h
40435,2,Spiralbound,2128,0,0,5,5,0.0%,1h
40462,1,MrFinch,2127,1749,174,183,357,48.7%,3m
40462,1,[DNKCFT]OldManAPM,2127,1755,144,152,296,48.6%,3h
40462,2,Oliver,2127,1637,73,78,151,48.3%,33m
40462,2,spiralti,2127,878,66,68,134,49.3%,40m
40462,2,AlexPrime,2127,846,34,30,64,53.1%,1h
40462,2,KeithDMW,2127,647,25,27,52,48.1%,1h
40462,2,FLESHMONGER,2127,544,20,20,40,50.0%,3h
40462,2,Luis,2127,604,20,26,46,43.5%,3h
40462,1,[LMI42]DookieToe,2127,650,19,25,44,43.2%,47m
40462,1,Manosalva,2127,377,18,14,32,56.2%,3h
40462,1,avoca,2127,462,13,21,34,38.2%,3h
40462,1,Kalmetra,2127,350,9,16,25,36.0%,11m
40462,2,DrCoven,2127,202,7,5,12,58.3%,19m
40462,2,Swagikarp,2127,228,7,10,17,41.2%,1h
40462,1,DarcStar,2127,228,7,12,19,36.8%,3h
40462,1,vILLainous,2127,152,3,8,11,27.3%,3h
40462,2,vooz,2127,62,2,4,6,33.3%,1h
40462,2,AJRon,2127,116,2,4,6,33.3%,1h
40462,1,[NYMZ]Kohaku,2127,110,2,5,7,28.6%,9m
40462,1,[NARF]Euler,2127,90,2,6,8,25.0%,38m
40462,2,Zardu,2127,0,1,0,1,100.0%,10m
40462,2,solodante,2127,0,1,1,2,50.0%,16m
40462,2,[MMSTAR]Legend,2127,48,1,7,8,12.5%,1h
40462,2,Pchelovod,2127,0,0,1,1,0.0%,19m
40462,2,maty,2127,0,0,1,1,0.0%,3h
40462,2,IQONE,2127,0,0,2,2,0.0%,1h
40462,2,Dracos,2127,0,0,5,5,0.0%,50m
40462,2,Frazlo,2127,0,0,5,5,0.0%,7m
40490,3,HardReset,2126,1206,208,212,420,49.5%,52m
40490,2,[C42]GreedyFool,2126,1248,112,130,242,46.3%,3h
40490,2,Volantys,2126,1556,56,65,121,46.3%,3h
40490,1,Grant,2126,958,43,45,88,48.9%,3h
40490,2,Kylerson,2126,598,22,24,46,47.8%,3h
40490,1,Cholokoy,2126,509,20,27,47,42.6%,3h
40490,3,Slayer,2126,578,19,26,45,42.2%,3h
40490,2,[Stardf]MaxP,2126,462,17,20,37,45.9%,1h
40490,2,thor,2126,354,13,10,23,56.5%,1h
40490,1,DoomBringer,2126,308,12,10,22,54.5%,3h
40490,2,alanlord,2126,296,11,7,18,61.1%,56m
40490,2,CuelloNegro,2126,292,11,8,19,57.9%,1h
40490,1,king,2126,341,11,15,26,42.3%,3h
40490,1,jijimuge,2126,392,11,16,27,40.7%,52m
40490,1,cochalo,2126,245,9,10,19,47.4%,52m
40490,3,Billoman,2126,230,7,8,15,46.7%,10m
40490,1,[ABADDN]bgkush,2126,264,6,5,11,54.5%,31m
40490,3,Armand,2126,154,6,12,18,33.3%,23m
40490,2,winniethepoo,2126,148,5,7,12,41.7%,1h
40490,2,CRIS,2126,58,3,2,5,60.0%,33m
40490,1,Slinky,2126,48,3,7,10,30.0%,20m
40490,1,Ryan,2126,96,3,9,12,25.0%,1h
40490,1,ChristianRG,2126,48,2,0,2,100.0%,1h
40490,2,niran,2126,68,2,1,3,66.7%,4m
40490,2,[LMdB]ShmVrolok,2126,0,2,3,5,40.0%,31m
40490,2,ELinmortal,2126,121,2,7,9,22.2%,16m
40490,2,Natsafu,2126,0,1,0,1,100.0%,1h
40490,2,veglia,2126,30,1,2,3,33.3%,3h
40490,1,Souyiro,2126,0,1,2,3,33.3%,21m
40490,1,drMustard,2126,0,1,5,6,16.7%,1h
40490,3,korko,2126,30,1,6,7,14.3%,1h
40490,1,ZCE,2126,44,1,9,10,10.0%,24m
40490,2,Micolpolo,2126,0,0,1,1,0.0%,6m
40490,2,Azulandes,2126,0,0,1,1,0.0%,3h
40490,2,wololo,2126,0,0,3,3,0.0%,3h
40490,2,Kabrera,2126,0,0,3,3,0.0%,1h
40490,2,[K0D]Varelse,2126,0,0,5,5,0.0%,14m
40490,2,Lunchbox,2126,0,0,5,5,0.0%,3h
40528,2,menow,2125,1657,333,363,696,47.8%,3h
40528,1,wildfire,2125,1757,100,101,201,49.8%,32m
40528,1,Jockling,2125,1000,36,44,80,45.0%,3m
40528,2,bghost,2125,453,19,12,31,61.3%,13m
40528,1,wololo,2125,516,18,20,38,47.4%,44m
40528,2,[CR1]IRONMONKEY,2125,180,7,6,13,53.8%,1h
40528,1,Fabrizio,2125,246,6,13,19,31.6%,9m
40528,2,Phoenix,2125,34,4,4,8,50.0%,1h
40528,2,Azur,2125,90,4,5,9,44.4%,1h
40528,2,Banmanran,2125,92,4,5,9,44.4%,25m
40528,2,RoCkeT,2125,149,3,5,8,37.5%,1h
40528,2,inginirs,2125,38,2,2,4,50.0%,40m
40528,2,MRLEX,2125,60,2,3,5,40.0%,49m
40528,1,RioRiot,2125,92,2,10,12,16.7%,1h
40528,2,Potts,2125,32,1,1,2,50.0%,1h
40528,2,EdsLove,2125,0,0,1,1,0.0%,3h
40528,2,Zaber,2125,0,0,1,1,0.0%,32m
40528,2,Ross,2125,0,0,1,1,0.0%,3h
40528,1,johnyack,2125,0,0,4,4,0.0%,3h
40528,2,IlIIIIlIllII,2125,0,0,5,5,0.0%,33m
40528,2,COMANDERKANE,2125,0,0,5,5,0.0%,3h
40549,1,KingofCheese,2124,1683,215,220,435,49.4%,41m
40549,2,[3MPTY7]Joule,2124,1358,161,168,329,48.9%,55m
40549,2,azmuy,2124,1628,63,74,137,46.0%,1h
40549,2,[AHPUCH]lion,2124,926,41,61,102,40.2%,3h
40549,1,IRISH,2124,1111,36,42,78,46.2%,3h
40549,2,Leathalone,2124,916,33,37,70,47.1%,3h
40549,2,Silent,2124,561,27,19,46,58.7%,3h
40549,2,[ACCR]belOwZerO,2124,649,22,23,45,48.9%,1h
40549,1,[WALKZ]Kazma,2124,670,21,24,45,46.7%,3h
40549,2,Lavan,2124,396,18,9,27,66.7%,16m
40549,2,voidleecher,2124,355,13,7,20,65.0%,3h
40549,2,[WCH69]Darkangel,2124,310,10,11,21,47.6%,1h
40549,1,IkutoHyuga,2124,254,8,8,16,50.0%,3h
40549,2,guilherme,2124,230,8,9,17,47.1%,3h
40549,2,wario,2124,304,8,17,25,32.0%,43m
40549,2,[OlVera]Karonte,2124,196,7,9,16,43.8%,37m
40549,3,luisenano,2124,195,6,10,16,37.5%,15m
40549,2,Alcyone,2124,73,2,5,7,28.6%,1h
40549,2,Thlandor,2124,48,2,6,8,25.0%,10m
40549,2,Memnath,2124,0,2,8,10,20.0%,37m
40549,1,TimidTortle,2124,48,2,9,11,18.2%,1h
40549,1,striker,2124,0,1,0,1,100.0%,1h
40549,3,IIIIIIIIIIII,2124,0,1,0,1,100.0%,1h
40549,1,[BW4EVA]ChowderBro,2124,0,1,0,1,100.0%,45m
40549,2,[iPGº]Chifu,2124,48,1,2,3,33.3%,1h
40549,1,Sovngarde,2124,96,1,2,3,33.3%,42m
40549,2,[GOOBUE]TheWalrus,2124,97,1,3,4,25.0%,3h
40549,1,DustyCowboy,2124,0,1,5,6,16.7%,3h
40549,2,WallyWilde,2124,0,1,5,6,16.7%,1h
40549,2,fuentisito,2124,0,0,1,1,0.0%,3h
40549,2,Etno,2124,0,0,1,1,0.0%,35m
40549,2,CaptainK,2124,0,0,1,1,0.0%,3h
40549,2,Fupaoverlord,2124,0,0,4,4,0.0%,1h
40582,1,TIMEBENDER,2123,1713,61,73,134,45.5%,1h
40582,2,[ICHIGO]kiniro,2123,1216,58,45,103,56.3%,11m
40582,1,Swashbuckler,2123,1487,56,55,111,50.5%,32m
40582,2,lsyrk,2123,891,36,28,64,56.2%,3h
40582,2,MiguelKill,2123,187,23,12,35,65.7%,1h
40582,1,DdDoOlLaArR,2123,687,23,25,48,47.9%,3h
40582,1,Tooka,2123,462,17,22,39,43.6%,1h
40582,1,WSCDEMON,2123,491,17,22,39,43.6%,1h
40582,2,dogsquad,2123,442,15,11,26,57.7%,1h
40582,2,MoonXYZ,2123,404,15,23,38,39.5%,1h
40582,2,Pele,2123,410,14,18,32,43.8%,3h
40582,2,TimmySmiles,2123,197,10,14,24,41.7%,1h
40582,2,Sylar,2123,248,9,10,19,47.4%,22m
40582,1,KoolKat,2123,299,8,12,20,40.0%,3h
40582,2,[iMkS]Andrei,2123,209,7,3,10,70.0%,59m
40582,1,Chism,2123,262,7,14,21,33.3%,1h
40582,1,SaltyNuggets,2123,218,5,5,10,50.0%,31m
40582,2,[CRmc]OJONEGRO,2123,126,4,3,7,57.1%,1h
40582,2,Ackbar,2123,90,4,5,9,44.4%,3h
40582,2,JKILLA,2123,112,3,1,4,75.0%,49m
40582,2,KevinYX,2123,58,3,2,5,60.0%,1h
40582,2,DeedGalaxy,2123,84,3,4,7,42.9%,3h
40582,2,[CPN]ThurQuan,2123,96,3,5,8,37.5%,3h
40582,2,[HOT69]Moosgoo,2123,100,3,7,10,30.0%,3h
40582,1,[COLIN]Nikolaba,2123,110,3,8,11,27.3%,3h
40582,2,Themiller,2123,40,2,1,3,66.7%,59m
40582,1,BAPHOMET,2123,120,2,3,5,40.0%,1h
40582,1,[ZTempz]namechange,2123,48,2,3,5,40.0%,1h
40582,3,theSinned,2123,0,1,1,2,50.0%,1h
40582,2,Voyd,2123,46,1,2,3,33.3%,10m
40582,2,SlimShady,2123,34,1,3,4,25.0%,21m
40582,1,TBurnius,2123,0,1,5,6,16.7%,32m
40582,2,Solma,2123,0,1,5,6,16.7%,6m
40582,1,lbc,2123,0,1,6,7,14.3%,1h
40582,2,JerryWarrior,2123,0,0,1,1,0.0%,56m
40582,2,YounGBlooD,2123,0,0,3,3,0.0%,1h
40582,2,juggala,2123,0,0,5,5,0.0%,1h
40582,1,fantasma,2123,0,0,5,5,0.0%,16m
40582,2,Desiree,2123,0,0,5,5,0.0%,3h
40621,2,Anarcho,2122,1648,134,134,268,50.0%,22m
40621,1,[BLMFTP]Thugger,2122,1672,110,116,226,48.7%,42m
40621,1,Azgul,2122,1582,100,97,197,50.8%,1h
40621,2,Dionysus,2122,1110,87,87,174,50.0%,3h
40621,1,ianshmeeyun,2122,1418,85,86,171,49.7%,24m
40621,1,Bobbytwok,2122,989,50,48,98,51.0%,59m
40621,1,Fantanic,2122,1347,46,56,102,45.1%,6m
40621,2,madlibrarian,2122,1160,43,43,86,50.0%,25m
40621,2,ArMas,2122,966,38,41,79,48.1%,48m
40621,1,Roofkop,2122,958,31,37,68,45.6%,39m
40621,1,SHlTfoBRANES,2122,867,27,40,67,40.3%,39m
40621,2,ChowderSnake,2122,320,12,11,23,52.2%,1h
40621,1,KINGTOM,2122,436,11,20,31,35.5%,3h
40621,3,RonBuan,2122,273,10,10,20,50.0%,46m
40621,2,kvu,2122,183,9,6,15,60.0%,41m
40621,2,[cluez]merchman,2122,238,7,2,9,77.8%,13m
40621,2,Shinji,2122,46,4,4,8,50.0%,1h
40621,2,Xerdo,2122,126,4,7,11,36.4%,1h
40621,3,Navugodono,2122,62,4,11,15,26.7%,22m
40621,1,cdudeRising,2122,96,3,5,8,37.5%,1h
40621,2,Crimith,2122,30,2,1,3,66.7%,3h
40621,1,[NXLsc]ptoelqlolea,2122,88,2,10,12,16.7%,1h
40621,2,Miguel,2122,0,1,0,1,100.0%,3h
40621,2,DurfSweat,2122,0,1,0,1,100.0%,3h
40621,2,Malazar,2122,0,1,0,1,100.0%,37m
40621,2,[Metric]saY,2122,0,1,1,2,50.0%,1h
40621,2,StarLORD,2122,48,1,2,3,33.3%,1h
40621,1,Culture,2122,36,1,4,5,20.0%,3h
40621,2,CSZ,2122,0,0,1,1,0.0%,32m
40621,2,MikeGreed,2122,0,0,2,2,0.0%,1h
40651,1,pacexmaker,2121,1729,64,67,131,48.9%,39m
40651,1,[MncsGG]Mau,2121,853,38,30,68,55.9%,3h
40651,1,GillyG,2121,772,30,34,64,46.9%,45m
40651,1,Carlos,2121,423,28,29,57,49.1%,3h
40651,2,flyingwind,2121,385,26,21,47,55.3%,55m
40651,2,Hero,2121,720,25,32,57,43.9%,1h
40651,1,YamaLlama,2121,632,20,24,44,45.5%,16m
40651,1,terran,2121,568,16,22,38,42.1%,1h
40651,2,Biff,2121,330,13,19,32,40.6%,3h
40651,1,tilox,2121,305,11,20,31,35.5%,7m
40651,2,jamesrp,2121,285,9,13,22,40.9%,43m
40651,3,[FQA]bomizu,2121,242,7,10,17,41.2%,3m
40651,2,charm,2121,94,6,15,21,28.6%,33m
40651,2,LULZNKEK,2121,152,5,9,14,35.7%,3h
40651,3,SodaPop,2121,94,5,12,17,29.4%,3h
40651,2,[R4NK3D]LeBoss,2121,98,4,4,8,50.0%,31m
40651,2,Vnthony,2121,0,4,5,9,44.4%,3h
40651,2,foosbro,2121,30,3,6,9,33.3%,40m
40651,2,TukimEn,2121,116,2,1,3,66.7%,3h
40651,1,[alahua]Miguel,2121,97,2,3,5,40.0%,11m
40651,2,[xHTTx]UMR,2121,0,1,0,1,100.0%,3h
40651,1,Arrow,2121,0,1,5,6,16.7%,11m
40651,1,Kheylos,2121,0,1,6,7,14.3%,3h
40651,2,Chater,2121,0,0,1,1,0.0%,40m
40651,2,SAUL,2121,0,0,2,2,0.0%,1h
40651,2,JakWall,2121,0,0,3,3,0.0%,37m
40651,2,TaylorGang,2121,0,0,6,6,0.0%,1h
40678,1,Coffee,2120,1712,162,156,318,50.9%,16m
40678,1,[Malter]gefabius,2120,1608,107,110,217,49.3%,43m
40678,1,murat,2120,1731,89,94,183,48.6%,47m
40678,2,leocomercial,2120,1416,60,54,114,52.6%,1h
40678,2,Luisiño,2120,1320,50,53,103,48.5%,7m
40678,1,Koveres,2120,1164,48,49,97,49.5%,60m
40678,2,[CHONK]HIJACK,2120,648,25,17,42,59.5%,33m
40678,2,INDRA,2120,561,24,22,46,52.2%,3h
40678,2,poloxxx,2120,584,23,20,43,53.5%,3h
40678,2,Red,2120,548,20,16,36,55.6%,22m
40678,1,MrMoon,2120,535,20,18,38,52.6%,1h
40678,1,[SWOU]Anominacion,2120,475,18,23,41,43.9%,3h
40678,1,spade,2120,290,9,16,25,36.0%,38m
40678,1,SeNTrY,2120,223,6,10,16,37.5%,3h
40678,2,mgsmid,2120,142,5,3,8,62.5%,3h
40678,2,JodbaCarnage,2120,146,4,7,11,36.4%,1h
40678,1,louzzz,2120,144,4,9,13,30.8%,1h
40678,2,[MrL]Dewrnched,2120,0,3,3,6,50.0%,1h
40678,2,[CULVER]jeepy,2120,64,3,4,7,42.9%,1h
40678,1,Moontari,2120,140,3,8,11,27.3%,43m
40678,1,Typhon,2120,179,3,9,12,25.0%,43m
40678,2,Thomas,2120,0,3,10,13,23.1%,3h
40678,2,[LDCO]starrkss,2120,30,2,0,2,100.0%,3h
40678,2,foxshadow,2120,38,2,2,4,50.0%,1h
40678,2,Guss,2120,0,2,5,7,28.6%,1h
40678,1,SIRKNIGHT,2120,110,2,7,9,22.2%,1h
40678,3,soracl,2120,94,2,8,10,20.0%,57m
40678,2,Robin,2120,30,1,3,4,25.0%,3h
40678,1,Drake,2120,93,1,6,7,14.3%,1h
40678,2,DEATHBLOW,2120,0,0,1,1,0.0%,1h
40678,2,Hwanjang,2120,0,0,5,5,0.0%,57m
40678,1,Xanerius,2120,0,0,5,5,0.0%,1h
40710,1,Ionite,2119,1487,83,86,169,49.1%,3h
40710,2,chocolateluv,2119,1328,74,72,146,50.7%,3h
40710,1,[b8]Zerick,2119,1638,60,74,134,44.8%,3h
40710,1,Keeru,2119,1389,56,57,113,49.6%,3h
40710,2,AVW,2119,1078,43,36,79,54.4%,3h
40710,1,darkwarrior,2119,1064,38,43,81,46.9%,1h
40710,1,jclee,2119,509,17,26,43,39.5%,1h
40710,2,Ferial,2119,348,14,11,25,56.0%,1h
40710,2,Gothex,2119,386,14,13,27,51.9%,3h
40710,2,MrNoisy,2119,310,12,10,22,54.5%,37m
40710,1,[Elit3C]SwankyPants,2119,254,11,7,18,61.1%,1h
40710,1,Chief,2119,404,11,17,28,39.3%,1h
40710,2,rre,2119,292,10,13,23,43.5%,1h
40710,2,KilroyJinkin,2119,234,9,7,16,56.2%,3h
40710,1,Demented,2119,133,3,8,11,27.3%,59m
40710,2,GabrielAndre,2119,88,3,9,12,25.0%,44m
40710,2,WarJester,2119,32,2,1,3,66.7%,1h
40710,1,LittleLlama,2119,105,2,7,9,22.2%,1h
40710,2,IIIIIIIIIIII,2119,0,1,0,1,100.0%,40m
40710,3,Aris,2119,0,1,0,1,100.0%,1h
40710,2,Naiko,2119,0,1,1,2,50.0%,1h
40710,3,BIGCOUNTRY,2119,0,1,7,8,12.5%,33m
40710,2,DubRhaNesh,2119,0,0,2,2,0.0%,38m
40710,2,Darknight,2119,0,0,5,5,0.0%,22m
40734,1,CowonAPlane,2118,1281,92,95,187,49.2%,52m
40734,1,Devin,2118,1736,84,92,176,47.7%,28m
40734,1,Espectrodos,2118,1568,73,79,152,48.0%,3h
40734,1,cogreen,2118,1569,67,70,137,48.9%,1h
40734,1,[RSBR]NEFILIM,2118,1202,62,79,141,44.0%,14m
40734,1,Gonz,2118,1186,43,48,91,47.3%,1h
40734,2,Alamuerte,2118,921,42,42,84,50.0%,1h
40734,2,Kush,2118,437,40,3,43,93.0%,55m
40734,1,CaptinInsano,2118,698,26,33,59,44.1%,3h
40734,2,EliasJunior,2118,581,22,26,48,45.8%,7m
40734,1,Mio,2118,520,21,21,42,50.0%,8m
40734,2,RealMcNeill,2118,403,13,11,24,54.2%,49m
40734,3,dicj,2118,345,12,12,24,50.0%,3h
40734,1,Doc,2118,392,11,19,30,36.7%,42m
40734,2,Cerdipapa,2118,185,6,5,11,54.5%,1h
40734,3,Noobtastic,2118,178,6,13,19,31.6%,26m
40734,2,Agustin,2118,136,5,8,13,38.5%,1h
40734,2,Cerberus,2118,136,4,5,9,44.4%,3h
40734,1,Whitess,2118,161,4,8,12,33.3%,3h
40734,2,ORodda,2118,46,2,6,8,25.0%,3h
40734,2,[KFClub]TheAmasianTJ,2118,0,1,0,1,100.0%,3h
40734,3,ceetabhero,2118,0,1,0,1,100.0%,1h
40734,1,ProTer,2118,0,1,0,1,100.0%,3h
40734,1,nallymeister,2118,97,1,1,2,50.0%,7m
40734,2,[X17]kerrDOG,2118,0,1,2,3,33.3%,5m
40734,1,lightning,2118,0,1,3,4,25.0%,59m
40734,2,[GTWITM]wIse,2118,48,1,5,6,16.7%,3h
40734,1,Nitrofen,2118,0,1,7,8,12.5%,3h
40734,1,KERMIT,2118,0,1,7,8,12.5%,3h
40734,2,Anyeld,2118,73,0,2,2,0.0%,29m
40734,1,FrozenYettie,2118,0,0,3,3,0.0%,21m
40734,2,[HellSi]Krusty,2118,0,0,5,5,0.0%,3h
40766,2,Ignis,2117,394,13,16,29,44.8%,56m
40766,1,REFICUL,2117,408,12,18,30,40.0%,50m
40766,1,karatesoup,2117,238,8,7,15,53.3%,8m
40766,2,Criss,2117,207,6,9,15,40.0%,3h
40766,3,[R4GN]sMoKEHhh,2117,146,4,3,7,57.1%,10m
40766,1,EedsyOudsy,2117,169,4,9,13,30.8%,7m
40766,1,Bahamut,2117,48,2,1,3,66.7%,3h
40766,3,Protoss,2117,0,2,8,10,20.0%,26m
40766,2,[Dooski]KingJim,2117,0,1,0,1,100.0%,37m
40766,1,Parker,2117,0,1,1,2,50.0%,1h
40766,2,Imperious,2117,0,1,4,5,20.0%,6m
40766,1,[Dre4mT]Aramil,2117,0,1,6,7,14.3%,3h
40766,2,lobycrack,2117,0,0,1,1,0.0%,3h
40766,2,OptiC,2117,0,0,2,2,0.0%,6m
40766,2,CaptainCrnch,2117,0,0,2,2,0.0%,3h
40766,2,Evan,2117,0,0,2,2,0.0%,1h
40766,2,poLycromatic,2117,0,0,5,5,0.0%,3h
40766,2,Rilakkuma,2117,0,0,5,5,0.0%,1h
40766,3,Robismaximus,2117,0,0,7,7,0.0%,36m
40785,1,Andy,2116,1658,72,74,146,49.3%,32m
40785,1,KarpeDiem,2116,1105,49,41,90,54.4%,52m
40785,2,KuraKura,2116,548,38,39,77,49.4%,1h
40785,2,Arie,2116,931,34,36,70,48.6%,31m
40785,1,daddypalps,2116,602,22,19,41,53.7%,3h
40785,3,Brent,2116,606,20,29,49,40.8%,4m
40785,2,Rurikari,2116,436,16,17,33,48.5%,1h
40785,2,[LONSTR]veboswa,2116,366,13,14,27,48.1%,41m
40785,2,Wordsquirrel,2116,312,11,8,19,57.9%,1h
40785,1,bingobanana,2116,388,11,12,23,47.8%,3h
40785,2,teatime,2116,223,5,9,14,35.7%,3h
40785,1,RobtgMx,2116,184,5,15,20,25.0%,47m
40785,2,[HnTr]Osiris,2116,120,4,4,8,50.0%,22m
40785,2,yourdaddavi,2116,169,4,4,8,50.0%,3h
40785,1,camoDUDUbut,2116,142,4,10,14,28.6%,3h
40785,2,[BlTEL]Abel,2116,60,3,1,4,75.0%,48m
40785,2,[DFWU]Caveman,2116,116,3,4,7,42.9%,3h
40785,1,Someguy,2116,144,3,7,10,30.0%,3h
40785,2,chispin,2116,30,2,1,3,66.7%,3h
40785,2,[1000jr]noprognosis,2116,60,2,7,9,22.2%,1h
40785,1,[2BLK]Cactuar,2116,0,1,0,1,100.0%,3h
40785,2,[MeatS]Allanon,2116,0,1,0,1,100.0%,3h
40785,2,[xAK7x]Profeta,2116,0,1,0,1,100.0%,1h
40785,1,Null,2116,0,1,2,3,33.3%,20m
40785,2,Dimsum,2116,0,1,3,4,25.0%,1h
40785,2,purginspaget,2116,30,1,4,5,20.0%,8m
40785,2,ZergYunior,2116,0,1,4,5,20.0%,1h
40785,1,BLADE,2116,48,1,5,6,16.7%,3h
40785,2,[1006]mlink,2116,0,0,1,1,0.0%,3h
40785,2,iLimitless,2116,0,0,1,1,0.0%,1h
40785,2,papu,2116,0,0,1,1,0.0%,1h
40785,1,Neuman,2116,0,0,6,6,0.0%,7m
40785,1,hostile,2116,0,0,7,7,0.0%,44m
40818,3,Lee,2115,884,178,172,350,50.9%,1h
40818,3,refryan,2115,1536,169,188,357,47.3%,50m
40818,2,[X1143]Brettx,2115,1563,97,98,195,49.7%,1h
40818,1,fauxeuphoria,2115,1670,63,82,145,43.4%,7m
40818,2,TigerFool,2115,1376,52,59,111,46.8%,3h
40818,2,Tidoc,2115,679,28,22,50,56.0%,8m
40818,2,Darckel,2115,526,22,18,40,55.0%,3h
40818,1,[seattl]Arock,2115,485,16,17,33,48.5%,3h
40818,1,daxgwapo,2115,464,14,26,40,35.0%,28m
40818,1,CIPHER,2115,305,9,11,20,45.0%,35m
40818,2,ProfBubblez,2115,272,9,16,25,36.0%,40m
40818,2,Shoul,2115,120,5,14,19,26.3%,5m
40818,1,TigadooS,2115,40,4,4,8,50.0%,1h
40818,2,BobTheUnicor,2115,118,4,5,9,44.4%,3h
40818,1,hoser,2115,96,3,8,11,27.3%,3h
40818,2,LeAcH,2115,64,2,4,6,33.3%,1h
40818,1,TerminaL,2115,34,2,9,11,18.2%,3h
40818,2,deaddrago,2115,0,1,0,1,100.0%,3h
40818,2,Ritty,2115,36,1,2,3,33.3%,8m
40818,1,MarcSS,2115,0,1,7,8,12.5%,3h
40818,1,IIIIIIIIIIII,2115,0,0,3,3,0.0%,52m
40818,2,LaFé,2115,0,0,4,4,0.0%,1h
40818,2,Henry,2115,0,0,5,5,0.0%,1h
40818,2,goatkid,2115,0,0,5,5,0.0%,3h
40818,2,LucOmar,2115,0,0,5,5,0.0%,3h
40843,1,[EAGF69]captinternet,2114,1511,110,114,224,49.1%,28m
40843,1,tatchka,2114,809,73,59,132,55.3%,3h
40843,1,Girbau,2114,1158,61,51,112,54.5%,45m
40843,1,Netro,2114,844,58,64,122,47.5%,42m
40843,2,Sans,2114,955,35,36,71,49.3%,14m
40843,2,Rambofett,2114,691,29,21,50,58.0%,3h
40843,2,Keenbean,2114,731,25,31,56,44.6%,31m
40843,2,Henso,2114,364,13,13,26,50.0%,1h
40843,1,charss,2114,402,12,17,29,41.4%,3h
40843,2,Raknarok,2114,258,10,7,17,58.8%,1h
40843,1,WillianM,2114,320,9,15,24,37.5%,25m
40843,2,Choccy,2114,330,9,16,25,36.0%,1h
40843,2,StokesANTH,2114,210,8,7,15,53.3%,3h
40843,2,Reveliark,2114,212,8,8,16,50.0%,3h
40843,1,ZOMM,2114,206,8,18,26,30.8%,1h
40843,2,Mayday,2114,198,7,1,8,87.5%,15m
40843,2,SlagBuster,2114,172,6,3,9,66.7%,3h
40843,1,[109X]mmaverick,2114,162,6,5,11,54.5%,8m
40843,1,Blaze,2114,159,5,10,15,33.3%,7m
40843,2,FourFTSzwagr,2114,60,4,12,16,25.0%,3h
40843,1,meanie,2114,108,3,6,9,33.3%,3h
40843,1,RichMasta,2114,66,3,8,11,27.3%,41m
40843,1,[Spænkd]BusinessMan,2114,121,2,3,5,40.0%,37m
40843,1,Dacokaiser,2114,30,2,6,8,25.0%,3h
40843,1,keyps,2114,80,2,10,12,16.7%,1h
40843,2,slayer,2114,30,1,2,3,33.3%,37m
40843,2,Acechador,2114,30,1,2,3,33.3%,3h
40843,1,zartanis,2114,0,1,3,4,25.0%,45m
40843,1,Ghost,2114,97,1,3,4,25.0%,3h
40843,1,[Macac0]xLoro,2114,0,0,2,2,0.0%,3h
40843,2,GharyGarcia,2114,0,0,2,2,0.0%,3h
40874,1,[Th3Bad]kombi,2113,910,69,77,146,47.3%,1h
40874,1,SamelCamel,2113,513,37,35,72,51.4%,11m
40874,1,macthunder,2113,618,25,28,53,47.2%,1h
40874,2,outage,2113,558,24,21,45,53.3%,3h
40874,2,[322]Datjiggy,2113,502,17,20,37,45.9%,59m
40874,2,UwU,2113,372,13,16,29,44.8%,1h
40874,2,ritzs,2113,332,11,8,19,57.9%,59m
40874,1,[Ec0s]Sevenofnine,2113,294,11,27,38,28.9%,17m
40874,2,soulgamer,2113,276,9,3,12,75.0%,40m
40874,1,WIZARD,2113,96,4,4,8,50.0%,1h
40874,2,Ginonino,2113,94,4,5,9,44.4%,3h
40874,2,black,2113,96,4,6,10,40.0%,10m
40874,1,Jimmy,2113,195,4,10,14,28.6%,3h
40874,2,BigPoppaJay,2113,68,3,1,4,75.0%,7m
40874,2,Dispersity,2113,30,2,0,2,100.0%,1h
40874,2,youngbuffalo,2113,30,2,0,2,100.0%,3h
40874,2,ZERG,2113,30,2,4,6,33.3%,3h
40874,2,[Cuark]Blackpower,2113,62,2,6,8,25.0%,1h
40874,2,Achilles,2113,0,1,1,2,50.0%,56m
40874,2,[ØÛ]DarkBeast,2113,30,1,1,2,50.0%,49m
40874,2,aiz,2113,30,1,2,3,33.3%,3h
40874,2,BravoCope,2113,0,1,4,5,20.0%,41m
40874,1,MoonWalker,2113,0,1,5,6,16.7%,6m
40874,1,commando,2113,0,1,6,7,14.3%,1h
40874,2,matanza,2113,0,0,1,1,0.0%,15m
40874,2,Doug,2113,0,0,2,2,0.0%,20m
40900,1,juanjo,2112,1740,175,194,369,47.4%,3h
40900,2,[GrnBrd]Neotholic,2112,1615,155,152,307,50.5%,1h
40900,1,CptBeaulac,2112,1684,130,137,267,48.7%,49m
40900,2,BlooHeda,2112,1595,123,117,240,51.2%,1h
40900,1,Eternal,2112,1663,61,80,141,43.3%,41m
40900,2,parkyourbike,2112,366,12,11,23,52.2%,3h
40900,2,Nooblet,2112,348,12,13,25,48.0%,20m
40900,1,zsaw,2112,348,11,17,28,39.3%,44m
40900,2,GreatSchism,2112,230,9,8,17,52.9%,30m
40900,2,Timinator,2112,219,7,13,20,35.0%,3h
40900,1,[Lp]Lucho,2112,160,5,14,19,26.3%,3h
40900,2,[Worrmy]RuFrigerator,2112,95,3,3,6,50.0%,40m
40900,1,CptnPlanet,2112,0,3,6,9,33.3%,1h
40900,1,[TRASHx]Detritus,2112,122,3,9,12,25.0%,10m
40900,2,[USWAG]CAMILALIAGAV,2112,60,2,6,8,25.0%,3h
40900,2,[SCVM]SailorMoon,2112,140,2,6,8,25.0%,1h
40900,1,sosusa,2112,97,1,1,2,50.0%,1h
40900,2,PunZero,2112,0,0,1,1,0.0%,15m
40900,2,[JRT]yryvu,2112,0,0,1,1,0.0%,33m
40900,2,Firelordp,2112,0,0,2,2,0.0%,1h
40900,2,josel,2112,0,0,4,4,0.0%,3h
40900,2,legado,2112,0,0,5,5,0.0%,3h
40922,1,Carbon,2111,1750,124,141,265,46.8%,1h
40922,1,elpitufog,2111,1725,98,105,203,48.3%,36m
40922,1,[Lp]LpxZLoboZx,2111,1030,52,43,95,54.7%,17m
40922,2,[ssqeez]Bruce,2111,790,52,47,99,52.5%,3h
40922,1,custodio,2111,1256,45,52,97,46.4%,41m
40922,1,CUMLAD,2111,1132,42,40,82,51.2%,3h
40922,2,[GELIUM]fenix,2111,527,20,23,43,46.5%,1h
40922,1,deepdish,2111,309,12,15,27,44.4%,3h
40922,2,nort,2111,268,10,9,19,52.6%,3h
40922,1,UncleSot,2111,302,10,20,30,33.3%,8m
40922,2,SiX,2111,286,9,12,21,42.9%,1h
40922,3,Ghosty,2111,237,8,11,19,42.1%,44m
40922,1,Samsara,2111,224,8,14,22,36.4%,3h
40922,1,[TAKANA]Dalcon,2111,240,6,10,16,37.5%,3h
40922,2,dravid,2111,187,5,3,8,62.5%,1h
40922,1,Lalo,2111,135,5,7,12,41.7%,51m
40922,1,Kohel,2111,114,4,10,14,28.6%,1h
40922,2,preb,2111,86,3,1,4,75.0%,59m
40922,2,DSPalpatine,2111,88,3,2,5,60.0%,3h
40922,2,[M1A5]War,2111,0,3,3,6,50.0%,3h
40922,1,Feanor,2111,62,3,7,10,30.0%,3h
40922,3,Tesla,2111,64,3,11,14,21.4%,1h
40922,1,kingfighter,2111,48,2,4,6,33.3%,1h
40922,1,Amescua,2111,106,2,4,6,33.3%,1h
40922,3,Loki,2111,30,2,6,8,25.0%,58m
40922,1,SteveShady,2111,42,2,8,10,20.0%,1h
40922,2,graine,2111,0,1,1,2,50.0%,3h
40922,2,NvK,2111,30,1,1,2,50.0%,1h
40922,2,tflanman,2111,40,1,3,4,25.0%,22m
40922,2,Drust,2111,0,0,1,1,0.0%,3h
40922,2,talinwulf,2111,0,0,1,1,0.0%,25m
40922,2,BLZarcorv,2111,0,0,1,1,0.0%,26m
40922,2,TinyDragon,2111,0,0,2,2,0.0%,37m
40955,2,Pililus,2110,1653,93,102,195,47.7%,1h
40955,1,Gutz,2110,838,79,81,160,49.4%,49m
40955,1,[FyH]salomon,2110,900,69,73,142,48.6%,1h
40955,2,SleepyJ,2110,1204,46,47,93,49.5%,20m
40955,1,TyTheTemplar,2110,901,31,32,63,49.2%,49m
40955,2,plagrave,2110,634,19,25,44,43.2%,56m
40955,2,speedtriple,2110,480,16,17,33,48.5%,1h
40955,2,alechuga,2110,446,16,18,34,47.1%,37m
40955,1,TropicRush,2110,450,13,18,31,41.9%,1h
40955,2,[Glizzy]TerrorOnMilk,2110,120,6,7,13,46.2%,1h
40955,2,Alexis,2110,254,6,14,20,30.0%,40m
40955,1,Diogo,2110,84,3,9,12,25.0%,1h
40955,2,ROCKlord,2110,138,2,5,7,28.6%,1h
40955,2,melquiades,2110,80,2,7,9,22.2%,10m
40955,2,Hobdawy,2110,32,1,4,5,20.0%,1h
40955,2,Dirtymike,2110,0,0,1,1,0.0%,31m
40955,2,[Crkit]Jjennassurri,2110,0,0,1,1,0.0%,3h
40955,2,KingShaft,2110,0,0,1,1,0.0%,3h
40955,1,Soundsplosin,2110,0,0,3,3,0.0%,42m
40955,2,SirWiggles,2110,0,0,4,4,0.0%,1h
40975,3,[PeeNH]raffy,2109,1023,91,97,188,48.4%,17m
40975,1,Calixto,2109,1085,40,43,83,48.2%,3h
40975,2,NightMare,2109,367,28,22,50,56.0%,3h
40975,2,Nerobert,2109,226,26,23,49,53.1%,32m
40975,2,eviltwin,2109,486,21,23,44,47.7%,1h
40975,2,Nocturne,2109,417,20,9,29,69.0%,58m
40975,1,acsimpson,2109,559,15,22,37,40.5%,11m
40975,2,[VFam]Fury,2109,302,12,8,20,60.0%,38m
40975,2,ANGELYT,2109,178,8,13,21,38.1%,32m
40975,2,AutoAutomate,2109,140,6,3,9,66.7%,40m
40975,2,CriscoDisco,2109,148,6,5,11,54.5%,3h
40975,2,MaxwelsDemon,2109,138,6,10,16,37.5%,59m
40975,1,CloudMind,2109,144,5,10,15,33.3%,1h
40975,2,kirbattak,2109,86,4,1,5,80.0%,3h
40975,2,Songa,2109,145,4,3,7,57.1%,3h
40975,1,chugh,2109,144,4,10,14,28.6%,17m
40975,1,caifan,2109,144,4,10,14,28.6%,56m
40975,2,Fridge,2109,116,2,5,7,28.6%,3h
40975,2,Grimmy,2109,62,2,6,8,25.0%,1h
40975,2,Thunder,2109,0,2,7,9,22.2%,3h
40975,1,skywalker,2109,80,2,13,15,13.3%,25m
40975,2,Max,2109,0,1,0,1,100.0%,37m
40975,2,Zeratul,2109,0,1,0,1,100.0%,1h
40975,2,DarkEternal,2109,36,1,2,3,33.3%,3h
40975,2,MyHiveonAiur,2109,0,1,3,4,25.0%,1h
40975,2,[DaFish]XxCHAOSxX,2109,30,1,4,5,20.0%,3h
40975,2,Crathos,2109,0,1,4,5,20.0%,1h
40975,3,ace,2109,0,0,1,1,0.0%,60m
40975,2,CheeuZ,2109,0,0,2,2,0.0%,3h
40975,2,catman,2109,0,0,2,2,0.0%,22m
40975,1,Buzzcola,2109,0,0,2,2,0.0%,3h
40975,2,Thanatos,2109,0,0,5,5,0.0%,1h
40975,2,[BthD]KitsumeFox,2109,0,0,5,5,0.0%,6m
40975,2,Porthos,2109,0,0,5,5,0.0%,19m
40975,2,Riban,2109,0,0,6,6,0.0%,3h
41010,2,HammerDown,2108,1025,43,35,78,55.1%,3h
41010,2,[XGang]JayKay,2108,1080,43,37,80,53.8%,37m
41010,2,kvnsystem,2108,1009,41,35,76,53.9%,1h
41010,2,ReenRush,2108,1081,39,46,85,45.9%,22m
41010,2,Blackbeard,2108,796,28,39,67,41.8%,38m
41010,1,RayninYK,2108,780,24,33,57,42.1%,1h
41010,1,MaUkTaY,2108,699,23,35,58,39.7%,41m
41010,2,[4L0k0]PELUSA,2108,354,13,11,24,54.2%,38m
41010,2,jhon,2108,371,12,16,28,42.9%,1h
41010,2,DCHERES,2108,234,8,7,15,53.3%,16m
41010,1,Exterminator,2108,236,7,16,23,30.4%,1h
41010,1,Jaweeez,2108,189,6,8,14,42.9%,18m
41010,2,Beam,2108,98,4,5,9,44.4%,1h
41010,3,icetrey,2108,90,4,10,14,28.6%,3h
41010,2,DVORAK,2108,60,3,0,3,100.0%,56m
41010,1,[Z3R10]rulli,2108,84,3,1,4,75.0%,31m
41010,2,Silent,2108,0,2,4,6,33.3%,59m
41010,2,[MSganG]Shazrock,2108,30,1,4,5,20.0%,19m
41010,2,Ajax,2108,0,0,1,1,0.0%,5m
41010,2,Elliot,2108,0,0,1,1,0.0%,1h
41010,2,[BrknPp]DaCookie,2108,0,0,1,1,0.0%,40m
41010,2,MHELL,2108,0,0,1,1,0.0%,26m
41010,1,Stick,2108,0,0,4,4,0.0%,3h
41010,2,[YS850H]SuRfErBoB,2108,0,0,5,5,0.0%,40m
41010,2,edgez,2108,0,0,5,5,0.0%,3h
41010,2,Madjester,2108,0,0,5,5,0.0%,11m
41010,2,Shakeforme,2108,0,0,5,5,0.0%,10m
41037,1,Flex,2107,1716,413,431,844,48.9%,16m
41037,2,Cepi,2107,1353,111,105,216,51.4%,1h
41037,1,Shadowstorm,2107,1729,67,75,142,47.2%,1h
41037,1,[TTKOPF]daniel,2107,902,29,34,63,46.0%,1h
41037,2,encpirate,2107,714,25,24,49,51.0%,31m
41037,1,[NM8]TheJoker,2107,778,25,29,54,46.3%,3h
41037,1,nuckfut,2107,560,22,24,46,47.8%,3h
41037,2,LIR,2107,476,19,15,34,55.9%,32m
41037,2,[xXGDXx]Godoy,2107,510,19,20,39,48.7%,30m
41037,2,Solo,2107,386,13,14,27,48.1%,16m
41037,2,byron,2107,372,12,15,27,44.4%,22m
41037,1,ragnarog,2107,344,11,17,28,39.3%,1h
41037,1,TerranLima,2107,390,11,20,31,35.5%,1h
41037,2,[TRASHH]MonkeyDunk,2107,240,9,2,11,81.8%,3h
41037,2,FireStorm,2107,214,7,5,12,58.3%,58m
41037,2,[scMAUI]KingNoivern,2107,209,7,11,18,38.9%,29m
41037,2,Akcarr,2107,125,3,8,11,27.3%,3h
41037,3,Marty,2107,30,2,9,11,18.2%,17m
41037,2,ImBatman,2107,40,1,5,6,16.7%,1h
41037,2,[SyLx]Finnian,2107,0,0,1,1,0.0%,3h
41037,2,ShadowDragon,2107,0,0,1,1,0.0%,26m
41037,2,Nokturnia,2107,0,0,6,6,0.0%,11m
41037,3,Diantre,2107,0,0,8,8,0.0%,1h
41060,2,rdog,2106,1418,125,133,258,48.4%,1h
41060,2,PotatoSuprme,2106,590,53,44,97,54.6%,1h
41060,1,Tobi,2106,1080,36,37,73,49.3%,24m
41060,3,CoolDude,2106,471,14,29,43,32.6%,13m
41060,2,dreikot,2106,246,13,19,32,40.6%,3h
41060,2,Galios,2106,220,11,13,24,45.8%,1h
41060,1,Breau,2106,247,9,10,19,47.4%,32m
41060,2,[USplan]bobgokou,2106,252,8,9,17,47.1%,41m
41060,1,[SWOU]maxpoint,2106,268,8,15,23,34.8%,1h
41060,2,Nando,2106,222,7,6,13,53.8%,3h
41060,1,Noyazz,2106,130,4,7,11,36.4%,1h
41060,2,CNNsucks,2106,90,3,4,7,42.9%,3h
41060,2,REMRAY,2106,92,3,6,9,33.3%,33m
41060,2,Lichbich,2106,114,3,8,11,27.3%,3h
41060,1,Whipee,2106,96,3,8,11,27.3%,48m
41060,2,FingerSnacks,2106,30,2,1,3,66.7%,1h
41060,2,CybaScope,2106,30,2,3,5,40.0%,48m
41060,1,Luisalg,2106,48,2,8,10,20.0%,3h
41060,1,Socalfer,2106,36,1,5,6,16.7%,32m
41060,2,willix,2106,48,1,5,6,16.7%,35m
41060,1,DepotMicro,2106,0,1,7,8,12.5%,1h
41060,2,Datnikka,2106,0,0,2,2,0.0%,1h
41060,2,AzurLane,2106,0,0,4,4,0.0%,1h
41060,1,oryan,2106,0,0,7,7,0.0%,50m
41084,1,Rekindle,2105,1724,281,295,576,48.8%,1h
41084,3,Randomized,2105,1388,235,247,482,48.8%,37m
41084,1,[cluez]Grandma,2105,1603,176,194,370,47.6%,44m
41084,3,GATSBY,2105,1498,161,165,326,49.4%,1h
41084,1,Bram,2105,739,69,72,141,48.9%,22m
41084,2,TOM,2105,562,52,43,95,54.7%,3h
41084,2,[ALTF04]DALTHON,2105,274,10,12,22,45.5%,3h
41084,1,phrOdiE,2105,369,10,14,24,41.7%,1h
41084,1,[ILAGI]Tragic,2105,310,10,15,25,40.0%,1h
41084,1,Trippinglsd,2105,377,10,18,28,35.7%,38m
41084,1,[COPPER]Oleo,2105,300,9,17,26,34.6%,1h
41084,1,Saitam,2105,330,8,15,23,34.8%,3h
41084,1,[DPGame]sturmovik,2105,289,7,15,22,31.8%,32m
41084,2,Tachinii,2105,158,6,8,14,42.9%,3h
41084,1,[DedPog]Zach,2105,222,6,14,20,30.0%,1h
41084,2,Artanis,2105,30,5,2,7,71.4%,12m
41084,2,YungSeeche,2105,132,5,8,13,38.5%,7m
41084,2,Oswin,2105,60,3,1,4,75.0%,3h
41084,2,meowsec,2105,94,3,6,9,33.3%,1h
41084,1,Battledog,2105,142,3,8,11,27.3%,11m
41084,2,hammerpie,2105,40,2,4,6,33.3%,56m
41084,1,MangJose,2105,121,2,9,11,18.2%,3h
41084,2,[TyK]RenzoZo,2105,0,1,0,1,100.0%,3h
41084,2,PaperDoor,2105,0,1,4,5,20.0%,1h
41084,2,sohrabkarim,2105,30,1,6,7,14.3%,3h
41084,2,Alcatrazl,2105,0,0,1,1,0.0%,3h
41084,1,NetProphet,2105,0,0,4,4,0.0%,3h
41111,2,Arthur,2104,1210,66,77,143,46.2%,12m
41111,1,Abductor,2104,1431,64,68,132,48.5%,28m
41111,1,misfire,2104,1026,46,56,102,45.1%,1h
41111,2,[ValidG]slowpoke,2104,1004,39,43,82,47.6%,7m
41111,2,Goliath,2104,1079,37,44,81,45.7%,29m
41111,2,Sinrob,2104,635,31,29,60,51.7%,1h
41111,2,DragónLeón,2104,490,26,16,42,61.9%,3h
41111,2,[PREVI]LuisPais,2104,616,22,20,42,52.4%,3h
41111,1,[BAP01]ESQUILAX,2104,551,22,23,45,48.9%,3h
41111,2,Rex,2104,127,10,10,20,50.0%,1h
41111,1,Fudgelsticks,2104,208,4,10,14,28.6%,24m
41111,2,Jul,2104,86,3,4,7,42.9%,31m
41111,2,Merthos,2104,60,2,3,5,40.0%,3h
41111,2,TheSpiritFox,2104,30,1,1,2,50.0%,1h
41111,2,Hiashi,2104,0,1,4,5,20.0%,3h
41111,2,Luebs,2104,30,1,6,7,14.3%,3h
41111,2,Oconner,2104,0,0,2,2,0.0%,3h
41111,1,[Shad0w]TRACYDEAN,2104,0,0,3,3,0.0%,38m
41111,2,Xtatik,2104,0,0,5,5,0.0%,3h
41130,1,TomBrady,2103,1600,88,93,181,48.6%,3h
41130,3,Chief,2103,1608,74,86,160,46.2%,22m
41130,2,KrypX,2103,1484,66,65,131,50.4%,12m
41130,2,lDIABLOl,2103,938,38,27,65,58.5%,34m
41130,1,[FyHr]leonidas,2103,711,28,35,63,44.4%,1h
41130,1,Juan,2103,777,23,29,52,44.2%,52m
41130,2,[BeTaPi]BADASSMFTODD,2103,454,16,18,34,47.1%,3h
41130,2,Dangel,2103,281,11,13,24,45.8%,25m
41130,2,Blitzkrieg,2103,114,4,2,6,66.7%,7m
41130,2,Apeiron,2103,118,4,5,9,44.4%,1h
41130,2,Tiketh,2103,42,4,13,17,23.5%,37m
41130,2,nexus,2103,68,2,2,4,50.0%,3h
41130,1,pheasant,2103,143,2,2,4,50.0%,3h
41130,2,ScubaLooter,2103,30,1,1,2,50.0%,3h
41130,1,Phatluv,2103,93,1,1,2,50.0%,7m
41130,2,[KG73]AlexThor,2103,0,1,2,3,33.3%,1h
41130,1,joshua,2103,0,1,7,8,12.5%,41m
41130,3,AlphaEight,2103,0,1,7,8,12.5%,32m
41130,2,samual,2103,0,0,1,1,0.0%,1h
41130,2,Commie,2103,0,0,1,1,0.0%,3h
41130,2,Alexander,2103,0,0,1,1,0.0%,57m
41130,2,FRZNHeir,2103,0,0,5,5,0.0%,1h
41130,2,[Th3Bad]Kyuura,2103,0,0,5,5,0.0%,3h
41130,2,diego,2103,0,0,6,6,0.0%,3h
41130,2,Moctezuma,2103,0,0,6,6,0.0%,57m
41155,1,Cybertron,2102,1548,129,141,270,47.8%,1h
41155,2,bluemeanies,2102,1536,113,113,226,50.0%,1h
41155,1,[sinkMe]trek,2102,1631,103,102,205,50.2%,1h
41155,1,Jie,2102,1294,68,68,136,50.0%,29m
41155,3,LAD,2102,910,37,42,79,46.8%,4m
41155,1,Thugnificent,2102,694,31,30,61,50.8%,25m
41155,2,Mabu,2102,598,23,26,49,46.9%,3h
41155,2,[110213]Corvin,2102,360,13,7,20,65.0%,21m
41155,2,elTugash,2102,409,13,18,31,41.9%,3h
41155,2,DrChocolate,2102,334,12,14,26,46.2%,1h
41155,2,dellano,2102,370,12,18,30,40.0%,1h
41155,2,[PtheG]Snake,2102,178,7,10,17,41.2%,58m
41155,2,[STUART]DJKg,2102,176,5,8,13,38.5%,16m
41155,1,NightKids,2102,239,5,10,15,33.3%,60m
41155,3,Spleenface,2102,118,5,14,19,26.3%,25m
41155,2,BLADErunnerX,2102,30,2,0,2,100.0%,3h
41155,2,DeathStroke,2102,32,2,0,2,100.0%,26m
41155,2,JoseÁguila,2102,32,2,1,3,66.7%,10m
41155,3,Kroeker,2102,60,2,12,14,14.3%,21m
41155,2,pmcrack,2102,0,1,0,1,100.0%,3h
41155,1,PeluchinSR,2102,0,1,1,2,50.0%,1h
41155,1,[NoGood]HappyPenguin,2102,97,1,5,6,16.7%,31m
41155,2,BLACKSMITH,2102,93,1,5,6,16.7%,50m
41155,1,Meepmop,2102,0,1,6,7,14.3%,1h
41155,1,StabStar,2102,34,1,9,10,10.0%,1h
41155,2,darckszoul,2102,0,0,1,1,0.0%,3h
41155,2,Reveen,2102,0,0,5,5,0.0%,3h
41182,2,Cahuide,2101,1556,141,146,287,49.1%,30m
41182,2,Leonid,2101,1599,98,102,200,49.0%,16m
41182,1,Boltor,2101,1333,47,54,101,46.5%,13m
41182,1,Zydruna,2101,1243,40,47,87,46.0%,1h
41182,1,Einzlander,2101,604,23,23,46,50.0%,41m
41182,1,Wattz,2101,349,12,17,29,41.4%,54m
41182,2,Selbor,2101,301,9,8,17,52.9%,3h
41182,1,beerbud,2101,240,6,13,19,31.6%,11m
41182,2,DeLaVega,2101,269,6,13,19,31.6%,3h
41182,2,Pointy,2101,88,4,1,5,80.0%,1h
41182,2,llllllllllll,2101,0,3,2,5,60.0%,10m
41182,2,Jukestar,2101,66,3,3,6,50.0%,3h
41182,2,Osam,2101,59,3,4,7,42.9%,1h
41182,2,Graphene,2101,88,2,0,2,100.0%,3h
41182,1,Kalstormblsd,2101,118,2,7,9,22.2%,6m
41182,2,DrProfessor,2101,88,1,5,6,16.7%,15m
41182,1,[IsToAn]IsaKnot,2101,0,1,6,7,14.3%,1h
41182,2,Robewolfgang,2101,0,0,1,1,0.0%,16m
41182,2,Hemlock,2101,0,0,1,1,0.0%,3h
41182,1,Erod,2101,0,0,3,3,0.0%,3h
41182,2,fandangamo,2101,0,0,5,5,0.0%,6m
41182,2,lex,2101,0,0,5,5,0.0%,3h
41204,2,Abel,2100,1611,187,211,398,47.0%,1h
41204,3,TheWorstAtSc,2100,1552,133,148,281,47.3%,1h
41204,1,[KhanZ]Twist,2100,1638,117,128,245,47.8%,3h
41204,2,[C31081]moriskillad,2100,1410,79,87,166,47.6%,3h
41204,1,Thunderthigh,2100,1602,72,77,149,48.3%,3h
41204,1,GUS,2100,1586,69,70,139,49.6%,1h
41204,1,Malek,2100,1023,50,47,97,51.5%,3h
41204,2,Bevilacqua,2100,1115,48,42,90,53.3%,16m
41204,2,Eximiusonex,2100,1168,46,43,89,51.7%,3h
41204,1,Punisher,2100,1073,35,40,75,46.7%,3h
41204,1,[ZMBELT]LuvsBonin,2100,682,20,31,51,39.2%,8m
41204,1,Coffee,2100,596,18,25,43,41.9%,3h
41204,2,kingtyranias,2100,340,12,13,25,48.0%,3h
41204,2,nazareth,2100,229,10,8,18,55.6%,30m
41204,2,Hades,2100,176,7,5,12,58.3%,1h
41204,1,Vicious,2100,214,6,13,19,31.6%,18m
41204,3,Hasevrank,2100,212,6,13,19,31.6%,16m
41204,1,veqgooff,2100,216,6,14,20,30.0%,36m
41204,2,BigBarney,2100,124,5,4,9,55.6%,1h
41204,1,Jabot,2100,126,4,11,15,26.7%,13m
41204,2,CerealKiller,2100,0,3,2,5,60.0%,3h
41204,2,jonthegreat,2100,132,3,3,6,50.0%,3h
41204,1,Apoocalypse,2100,48,2,4,6,33.3%,1h
41204,2,ErnestoUY,2100,60,2,5,7,28.6%,31m
41204,1,Alice,2100,89,1,7,8,12.5%,3h
41204,3,keki,2100,0,1,8,9,11.1%,46m
41204,2,ELRO,2100,0,0,1,1,0.0%,3h
41204,2,GeoSonis,2100,0,0,1,1,0.0%,37m
41204,2,MicroJordanX,2100,0,0,1,1,0.0%,40m
41204,2,KBD,2100,0,0,6,6,0.0%,3h
41234,2,billdkat,2099,1593,341,352,693,49.2%,1h
41234,2,makalan,2099,1410,226,223,449,50.3%,25m
41234,1,xformer,2099,1113,91,117,208,43.8%,24m
41234,2,Hugenstein,2099,1344,48,54,102,47.1%,3h
41234,2,CnlMaul,2099,1112,42,39,81,51.9%,1h
41234,2,fifthplace,2099,846,29,32,61,47.5%,3h
41234,1,spartacus,2099,650,21,30,51,41.2%,3h
41234,3,droppingload,2099,624,19,35,54,35.2%,12m
41234,2,dalfox,2099,154,16,16,32,50.0%,3h
41234,1,EnemaBagJone,2099,550,16,20,36,44.4%,44m
41234,2,[B8T]Gambit,2099,315,14,12,26,53.8%,3h
41234,2,[GoSc]Emeraldee,2099,296,14,22,36,38.9%,5m
41234,2,Kulzokid,2099,317,12,10,22,54.5%,3h
41234,2,JRA,2099,250,11,17,28,39.3%,3h
41234,2,Divernus,2099,196,8,5,13,61.5%,37m
41234,2,[BlTEL]ELRATONPEREZ,2099,58,2,2,4,50.0%,1h
41234,1,Heloch,2099,144,2,4,6,33.3%,1h
41234,2,SamPPsmol,2099,0,2,5,7,28.6%,10m
41234,1,thebslee,2099,97,2,7,9,22.2%,3h
41234,3,Yabba,2099,0,1,8,9,11.1%,50m
41234,1,resolution,2099,97,1,8,9,11.1%,45m
41234,2,Beamz,2099,0,0,2,2,0.0%,26m
41234,2,MichaelpopX,2099,0,0,5,5,0.0%,40m
41234,2,Sachiiko,2099,0,0,5,5,0.0%,10m
41258,1,MntLBreaK,2098,1658,188,204,392,48.0%,3h
41258,2,[URINE]RamMan,2098,1552,129,114,243,53.1%,3h
41258,1,macaddict,2098,1737,98,109,207,47.3%,3h
41258,2,soulsaul,2098,597,52,44,96,54.2%,1h
41258,2,MaysLanding,2098,818,32,26,58,55.2%,49m
41258,2,[iS1MP]GreatBriton,2098,775,27,34,61,44.3%,1h
41258,2,SlautaMouse,2098,656,23,29,52,44.2%,1h
41258,2,dreico,2098,360,13,14,27,48.1%,1h
41258,2,Darkkagefox,2098,304,11,16,27,40.7%,1h
41258,2,hunterdemons,2098,90,5,9,14,35.7%,3h
41258,2,Terratek,2098,134,4,9,13,30.8%,1h
41258,1,babyzero,2098,97,3,7,10,30.0%,24m
41258,1,mejai,2098,97,2,3,5,40.0%,1h
41258,2,PINKSTARFISH,2098,78,2,5,7,28.6%,1h
41258,2,DildoRaggins,2098,88,1,5,6,16.7%,6m
41258,1,ARC,2098,0,1,7,8,12.5%,1h
41258,2,Faxbian,2098,0,0,1,1,0.0%,3h
41258,2,traanix,2098,0,0,5,5,0.0%,1h
41258,2,Kieri,2098,0,0,5,5,0.0%,3h
41258,2,EDD,2098,0,0,6,6,0.0%,40m
41278,2,[TPGGXD]carlos,2097,1435,106,118,224,47.3%,3h
41278,1,Scyrus,2097,1658,86,76,162,53.1%,48m
41278,2,eradicator,2097,1587,76,76,152,50.0%,1h
41278,2,CRiMiNaL,2097,1069,42,35,77,54.5%,1h
41278,2,Shanti,2097,397,18,5,23,78.3%,3h
41278,3,ROC,2097,420,17,19,36,47.2%,49m
41278,2,Gamblelord,2097,265,11,4,15,73.3%,3h
41278,2,Jack,2097,284,11,8,19,57.9%,3h
41278,2,imabeast,2097,288,11,9,20,55.0%,1h
41278,2,dinin,2097,214,8,7,15,53.3%,34m
41278,2,Fuleyazon,2097,186,7,7,14,50.0%,3h
41278,1,Scallywag,2097,285,7,13,20,35.0%,22m
41278,3,Charlito,2097,207,7,17,24,29.2%,46m
41278,2,TheRavager,2097,162,5,0,5,100.0%,3h
41278,2,[8iSh]Protossible,2097,124,5,6,11,45.5%,34m
41278,2,Roysten,2097,170,5,9,14,35.7%,21m
41278,2,wookie,2097,138,3,2,5,60.0%,3h
41278,1,Chapchui,2097,143,3,9,12,25.0%,22m
41278,2,DarkSide,2097,58,2,4,6,33.3%,41m
41278,2,[NM8]ACE,2097,109,2,5,7,28.6%,43m
41278,1,AliaksandrB,2097,48,2,9,11,18.2%,3h
41278,2,Genostar,2097,30,1,1,2,50.0%,1h
41278,2,PedroIkeda,2097,30,1,1,2,50.0%,49m
41278,2,chaos,2097,0,1,1,2,50.0%,1h
41278,1,Leorik,2097,0,1,4,5,20.0%,17m
41278,2,Topher,2097,0,1,4,5,20.0%,3h
41278,2,[BRSKR]Nuke,2097,0,0,1,1,0.0%,3h
41278,2,KuroNekoII,2097,0,0,2,2,0.0%,16m
41278,2,[BBC0ck]VergaTron,2097,0,0,5,5,0.0%,1h
41307,2,NickP,2096,1563,84,94,178,47.2%,3h
41307,1,Germán,2096,1279,73,77,150,48.7%,1h
41307,3,ShamanWill,2096,1438,50,69,119,42.0%,15m
41307,1,FUNZOVA,2096,722,38,33,71,53.5%,3h
41307,2,[WCH69]DMAX,2096,928,36,35,71,50.7%,1h
41307,2,[p0w]DragoonCNB,2096,812,30,38,68,44.1%,3h
41307,1,Rasheed,2096,670,20,28,48,41.7%,3h
41307,2,Jcoop,2096,418,14,10,24,58.3%,3h
41307,2,Danimalhxc,2096,354,10,17,27,37.0%,3h
41307,2,ZEDATUL,2096,286,10,17,27,37.0%,1h
41307,2,TheRevenant,2096,276,9,9,18,50.0%,1h
41307,2,AbsoluteEing,2096,222,8,12,20,40.0%,3h
41307,2,[SYNDCT]Resham,2096,224,6,11,17,35.3%,1h
41307,1,MapleRag,2096,289,5,7,12,41.7%,3h
41307,2,Markov,2096,120,4,4,8,50.0%,1h
41307,1,SERMINARO,2096,86,4,9,13,30.8%,3h
41307,2,Krock,2096,126,4,9,13,30.8%,3h
41307,1,[Y4NG20]natedoggg,2096,96,2,3,5,40.0%,3h
41307,2,MisterJerico,2096,0,2,3,5,40.0%,1h
41307,1,XxXSaDXxX,2096,68,2,8,10,20.0%,3h
41307,2,fongg,2096,0,1,0,1,100.0%,3h
41307,2,Shanks,2096,0,1,3,4,25.0%,31m
41307,2,FraudBiden,2096,30,1,4,5,20.0%,3h
41307,2,donmono,2096,0,0,1,1,0.0%,3h
41307,2,[0502]ivanchelo,2096,0,0,1,1,0.0%,3h
41307,2,LARMSTONE,2096,0,0,1,1,0.0%,1h
41307,2,Goosejuice,2096,0,0,1,1,0.0%,10m
41307,2,xXJAOZINXx,2096,0,0,2,2,0.0%,3h
41307,2,Ray,2096,0,0,3,3,0.0%,1h
41307,2,RBSSskylab,2096,0,0,4,4,0.0%,26m
41307,2,authenticity,2096,0,0,5,5,0.0%,50m
41307,2,DOLCETTO,2096,0,0,5,5,0.0%,1h
41339,1,Droodlol,2095,894,80,97,177,45.2%,8m
41339,1,elElegido,2095,1607,70,70,140,50.0%,3h
41339,1,virussarini,2095,1465,68,80,148,45.9%,1h
41339,2,Thor,2095,1301,53,50,103,51.5%,3h
41339,1,Blitz,2095,1247,52,58,110,47.3%,24m
41339,2,[FNES1]OHWTV,2095,1062,43,38,81,53.1%,3h
41339,2,NateFury,2095,976,36,36,72,50.0%,34m
41339,2,zabu,2095,856,34,27,61,55.7%,3h
41339,3,bardem,2095,248,8,15,23,34.8%,3h
41339,2,pendejeitor,2095,222,7,4,11,63.6%,16m
41339,2,WillC,2095,186,7,10,17,41.2%,1h
41339,1,César,2095,164,6,4,10,60.0%,48m
41339,2,Trystero,2095,174,6,5,11,54.5%,23m
41339,2,Given,2095,190,6,7,13,46.2%,1h
41339,2,imposing,2095,150,5,0,5,100.0%,59m
41339,2,[JNX]Miler,2095,114,5,3,8,62.5%,8m
41339,2,Arjhan,2095,200,5,7,12,41.7%,3h
41339,2,[PRX]Pavlov,2095,48,4,5,9,44.4%,1h
41339,2,marcassin,2095,58,3,2,5,60.0%,3h
41339,1,dungviet,2095,97,2,1,3,66.7%,3h
41339,2,[Gatinn]gatinyooo,2095,30,2,1,3,66.7%,31m
41339,2,Gibran,2095,30,2,1,3,66.7%,3h
41339,3,Nish,2095,0,1,0,1,100.0%,1h
41339,2,Overlord,2095,109,1,4,5,20.0%,3h
41339,1,jklassmoney,2095,0,1,4,5,20.0%,3h
41339,2,bighoss,2095,0,1,5,6,16.7%,21m
41339,2,TunaGina,2095,30,1,5,6,16.7%,22m
41339,1,jones,2095,42,1,6,7,14.3%,3h
41339,3,MaTT,2095,0,1,7,8,12.5%,20m
41339,1,KIL,2095,96,1,10,11,9.1%,24m
41339,2,Dawson,2095,0,0,1,1,0.0%,3h
41339,2,Crank,2095,0,0,1,1,0.0%,1h
41339,2,Brometheus,2095,0,0,2,2,0.0%,37m
41339,1,BigBalloni,2095,0,0,3,3,0.0%,17m
41339,2,SGTPaine,2095,0,0,5,5,0.0%,36m
41339,2,SGTYX,2095,0,0,5,5,0.0%,10m
41339,2,SCORPION,2095,0,0,5,5,0.0%,1h
41376,1,Walnutz,2094,1349,113,110,223,50.7%,3h
41376,3,SHoCKZz,2094,1044,36,57,93,38.7%,28m
41376,1,AshPow,2094,591,19,27,46,41.3%,1h
41376,2,VALKYRIE,2094,445,16,14,30,53.3%,19m
41376,3,DOOMSLAYER,2094,212,11,19,30,36.7%,37m
41376,1,Boom,2094,432,11,27,38,28.9%,3h
41376,2,NoAgain,2094,326,10,14,24,41.7%,33m
41376,1,Hogan,2094,243,7,8,15,46.7%,3h
41376,1,DreamState,2094,273,7,23,30,23.3%,1h
41376,1,Bigazzfries,2094,240,6,15,21,28.6%,1h
41376,1,superman,2094,211,5,5,10,50.0%,53m
41376,2,Nanook,2094,176,5,12,17,29.4%,57m
41376,2,[YCnk]AnacletA,2094,68,3,3,6,50.0%,1h
41376,2,Afatcow,2094,100,3,4,7,42.9%,49m
41376,2,[BMbS]Shotfast,2094,30,2,0,2,100.0%,59m
41376,2,mezzomix,2094,36,2,3,5,40.0%,3h
41376,2,Acolyte,2094,0,1,4,5,20.0%,26m
41376,2,KURUTTA,2094,0,0,1,1,0.0%,48m
41376,2,Jeffry,2094,0,0,1,1,0.0%,3h
41376,2,[OdVark]Dorime,2094,0,0,1,1,0.0%,3h
41376,2,Carlomagno,2094,0,0,1,1,0.0%,1h
41376,2,MisterUwU,2094,0,0,2,2,0.0%,49m
41376,2,DNGR,2094,0,0,5,5,0.0%,3h
41376,2,Enigma,2094,0,0,5,5,0.0%,1h
41376,1,yikes,2094,0,0,9,9,0.0%,3h
41401,3,CoalitionOne,2093,1290,224,238,462,48.5%,17m
41401,1,shootingstar,2093,1002,35,44,79,44.3%,43m
41401,2,YooZwei,2093,669,27,28,55,49.1%,3h
41401,2,JackMeOnce,2093,422,21,26,47,44.7%,3h
41401,2,[MIDMX]Markus,2093,466,17,16,33,51.5%,23m
41401,2,Conquistador,2093,370,13,13,26,50.0%,23m
41401,2,Deimos,2093,342,12,16,28,42.9%,1h
41401,2,Glasslord,2093,280,11,9,20,55.0%,37m
41401,2,Little,2093,310,11,10,21,52.4%,3h
41401,2,Radiation,2093,294,10,15,25,40.0%,3h
41401,2,[MiniC]VicMarshall,2093,196,7,5,12,58.3%,15m
41401,1,[F4H]gatolzm,2093,116,6,9,15,40.0%,1h
41401,2,John,2093,148,5,6,11,45.5%,29m
41401,1,Adgor,2093,112,4,11,15,26.7%,48m
41401,2,[1BSBC]RatZSifury,2093,64,3,3,6,50.0%,3h
41401,2,[MMSTAR]VespianGas,2093,76,2,5,7,28.6%,3h
41401,2,[KGH]VolcanoVapor,2093,73,2,9,11,18.2%,60m
41401,1,Jay,2093,48,1,3,4,25.0%,3h
41401,2,celendis,2093,88,1,5,6,16.7%,3h
41401,2,Beto,2093,0,1,6,7,14.3%,6m
41401,2,Heartless,2093,0,0,1,1,0.0%,32m
41401,2,Raulfrances,2093,0,0,1,1,0.0%,22m
41401,2,[Synaps]Dak,2093,0,0,5,5,0.0%,3h
41401,2,MiguelBAM,2093,0,0,5,5,0.0%,1h
41425,2,Template,2092,1373,77,86,163,47.2%,1h
41425,1,HARDBLOW,2092,976,34,39,73,46.6%,1h
41425,1,Faraday,2092,834,26,30,56,46.4%,50m
41425,2,JuniorBacon,2092,388,23,0,23,100.0%,22m
41425,1,dominikskyce,2092,590,18,26,44,40.9%,41m
41425,2,Ropher,2092,462,15,13,28,53.6%,1h
41425,3,FourFi,2092,420,14,21,35,40.0%,1h
41425,2,kaka,2092,409,13,16,29,44.8%,3h
41425,2,Lich,2092,273,11,13,24,45.8%,34m
41425,1,basabel,2092,272,9,20,29,31.0%,1h
41425,3,UltraKael,2092,270,8,10,18,44.4%,3m
41425,1,Evilbroccoli,2092,269,8,12,20,40.0%,4m
41425,1,RMSEA,2092,178,6,6,12,50.0%,37m
41425,1,Passionfruit,2092,194,6,10,16,37.5%,46m
41425,1,Pancakes,2092,148,5,11,16,31.2%,16m
41425,2,Chris,2092,149,4,8,12,33.3%,1h
41425,1,StarEater,2092,96,3,9,12,25.0%,3h
41425,1,sharpshooter,2092,108,3,9,12,25.0%,1h
41425,1,Leori,2092,135,3,9,12,25.0%,7m
41425,3,BlackIce,2092,62,3,9,12,25.0%,43m
41425,1,McLuvin,2092,144,2,3,5,40.0%,1h
41425,3,laxer,2092,0,2,10,12,16.7%,1h
41425,2,BlindPride,2092,0,1,1,2,50.0%,1h
41425,2,TUBESTEAK,2092,30,1,3,4,25.0%,3h
41425,2,Farsight,2092,0,1,4,5,20.0%,50m
41425,3,Ant,2092,30,1,8,9,11.1%,17m
41425,3,[GOTG1]THUNDER,2092,0,0,1,1,0.0%,3m
41425,2,ladkos,2092,0,0,1,1,0.0%,1h
41425,2,jbjoker,2092,0,0,4,4,0.0%,1h
41454,2,Rush,2091,1603,99,95,194,51.0%,1h
41454,3,Suito,2091,1403,96,103,199,48.2%,1h
41454,2,PatriotValor,2091,1558,68,64,132,51.5%,3h
41454,1,Luciooz,2091,1615,66,64,130,50.8%,3h
41454,2,rkMaverick,2091,1415,56,57,113,49.6%,3h
41454,1,Chipininguo,2091,1038,51,64,115,44.3%,1h
41454,3,Carlo,2091,768,25,41,66,37.9%,1h
41454,2,Mike,2091,459,13,23,36,36.1%,3h
41454,2,BLADEOFGRASS,2091,298,11,10,21,52.4%,1h
41454,2,LebronJames,2091,262,7,11,18,38.9%,3h
41454,2,PupasWrinkle,2091,191,6,4,10,60.0%,1h
41454,2,DarkerForces,2091,193,5,2,7,71.4%,3h
41454,2,Tebotooks,2091,217,5,8,13,38.5%,12m
41454,2,CarlosObo,2091,137,3,4,7,42.9%,31m
41454,2,Dans,2091,90,3,4,7,42.9%,1h
41454,1,TheVision,2091,72,3,7,10,30.0%,1h
41454,1,Phteven,2091,97,2,2,4,50.0%,7m
41454,1,[BR3]elsubash,2091,96,1,1,2,50.0%,33m
41454,2,Dimfoxligh,2091,97,1,2,3,33.3%,1h
41454,1,Jfunk,2091,46,1,3,4,25.0%,7m
41454,2,LyonAdmiral,2091,0,0,2,2,0.0%,26m
41454,2,KingJulius,2091,0,0,5,5,0.0%,3h
41454,1,bigeasy,2091,0,0,5,5,0.0%,1h
41454,2,josue,2091,0,0,5,5,0.0%,3h
41478,1,[UFC]ATP,2090,1702,125,138,263,47.5%,1h
41478,3,Armagedon,2090,1558,112,128,240,46.7%,42m
41478,2,[EpicG]Gerhard,2090,681,57,59,116,49.1%,25m
41478,1,Johnkim,2090,1199,53,55,108,49.1%,3h
41478,2,MasterGallo,2090,522,20,14,34,58.8%,3h
41478,1,tuchka,2090,277,19,29,48,39.6%,1h
41478,2,Elmaskpo,2090,487,18,22,40,45.0%,26m
41478,1,Boudreau,2090,480,14,29,43,32.6%,29m
41478,1,NONA,2090,258,12,9,21,57.1%,3h
41478,2,MetalGearRay,2090,200,11,2,13,84.6%,3h
41478,1,FORTHEKILL,2090,162,6,7,13,46.2%,3h
41478,2,RimmJob,2090,157,5,5,10,50.0%,1h
41478,2,Ryder,2090,154,5,6,11,45.5%,3h
41478,2,SuitPants,2090,213,5,10,15,33.3%,59m
41478,2,Alcon,2090,100,4,4,8,50.0%,41m
41478,1,PrimoMax,2090,167,4,8,12,33.3%,3h
41478,1,Beardo,2090,119,3,1,4,75.0%,1h
41478,2,Birdiebird,2090,150,3,3,6,50.0%,57m
41478,2,iboostyou,2090,139,3,5,8,37.5%,1h
41478,1,Takeshi,2090,76,3,8,11,27.3%,1h
41478,2,[DRKDMN]cibergdf,2090,46,2,3,5,40.0%,1h
41478,2,IvanPMA,2090,60,2,9,11,18.2%,3h
41478,2,SpaceBussy,2090,34,1,2,3,33.3%,12m
41478,2,tan,2090,30,1,5,6,16.7%,19m
41478,2,Ritchierich,2090,0,0,1,1,0.0%,1h
41478,2,[Mc]Jerry,2090,73,0,2,2,0.0%,34m
41478,2,JohnGrif,2090,0,0,3,3,0.0%,49m
41478,2,Illusion,2090,0,0,5,5,0.0%,50m
41506,1,Pdeedee,2089,1688,246,256,502,49.0%,3h
41506,2,phantom,2089,1530,84,93,177,47.5%,1h
41506,2,SHAKA,2089,1593,70,75,145,48.3%,3h
41506,2,BetaStar,2089,1277,69,61,130,53.1%,3h
41506,1,SHADOW,2089,1633,63,68,131,48.1%,1h
41506,1,GUNDRUG,2089,782,49,50,99,49.5%,1h
41506,3,HelloKitty,2089,848,43,54,97,44.3%,1h
41506,2,SaltLakers,2089,1126,41,48,89,46.1%,37m
41506,2,sirblackman,2089,726,28,23,51,54.9%,33m
41506,2,Hillbilly,2089,546,18,22,40,45.0%,22m
41506,2,zeolot,2089,470,15,22,37,40.5%,1h
41506,2,Jwhit,2089,372,14,11,25,56.0%,21m
41506,2,privatemuffn,2089,312,10,10,20,50.0%,3h
41506,1,RaZoR,2089,370,10,19,29,34.5%,3h
41506,2,Rippitallday,2089,212,8,7,15,53.3%,1h
41506,1,AceNight,2089,254,8,10,18,44.4%,1h
41506,2,Shadow,2089,164,5,9,14,35.7%,1h
41506,3,Cloud,2089,88,4,9,13,30.8%,1h
41506,1,BatcaveBill,2089,142,4,14,18,22.2%,3h
41506,2,OtterRainbow,2089,62,3,2,5,60.0%,19m
41506,2,LWD,2089,34,3,3,6,50.0%,3h
41506,2,Abstract,2089,30,2,0,2,100.0%,3h
41506,2,Stonebender,2089,43,2,5,7,28.6%,15m
41506,2,DemonSqrl,2089,68,2,6,8,25.0%,33m
41506,2,Tark,2089,58,2,7,9,22.2%,3h
41506,2,embertap,2089,74,2,7,9,22.2%,33m
41506,1,Fusilero,2089,48,2,7,9,22.2%,3h
41506,1,HydraHero,2089,122,2,8,10,20.0%,28m
41506,1,Storm,2089,48,2,9,11,18.2%,16m
41506,1,willyum,2089,0,1,7,8,12.5%,1h
41506,2,SoulDoubt,2089,0,0,1,1,0.0%,3h
41506,2,Noada,2089,0,0,1,1,0.0%,16m
41506,2,[PotE]Camzz,2089,0,0,1,1,0.0%,8m
41506,2,Ian,2089,0,0,1,1,0.0%,8m
41506,2,Sampson,2089,0,0,1,1,0.0%,3h
41506,3,DOTARCRACK,2089,0,0,1,1,0.0%,1h
41506,2,BLATENET,2089,0,0,1,1,0.0%,3h
41506,2,Jtrux,2089,0,0,4,4,0.0%,1h
41506,2,banana,2089,0,0,5,5,0.0%,1h
41545,1,XxinfiernoxX,2088,1692,89,91,180,49.4%,1h
41545,2,Slothination,2088,1486,62,66,128,48.4%,59m
41545,2,Pinchbeef,2088,1210,49,49,98,50.0%,3h
41545,2,Tagar,2088,386,14,15,29,48.3%,22m
41545,3,[KingSC]Nathzsu,2088,448,13,53,66,19.7%,22m
41545,2,[SWOU]DarthOzz,2088,355,12,11,23,52.2%,1h
41545,2,Palacioej,2088,204,9,6,15,60.0%,1h
41545,2,[DDPPSS]wDrakeA,2088,214,7,3,10,70.0%,1h
41545,2,Nondual,2088,252,7,14,21,33.3%,29m
41545,2,Pricursor,2088,212,7,15,22,31.8%,3h
41545,1,Razumikhin,2088,246,7,18,25,28.0%,1h
41545,2,PolyShort,2088,150,5,1,6,83.3%,3h
41545,1,neutrino,2088,180,5,15,20,25.0%,47m
41545,1,FenixFox,2088,194,5,19,24,20.8%,32m
41545,2,[KhanZ]izzygar,2088,120,4,5,9,44.4%,34m
41545,1,MisterE,2088,30,3,11,14,21.4%,28m
41545,1,[ooiiyy]JerBear,2088,48,2,9,11,18.2%,3h
41545,2,Panzer,2088,0,1,1,2,50.0%,1h
41545,2,Yourthoughts,2088,30,1,2,3,33.3%,3h
41545,1,MODOM,2088,40,1,4,5,20.0%,51m
41545,2,DiegoLoDrone,2088,30,1,7,8,12.5%,1h
41545,2,[ENFql]Alec,2088,0,0,1,1,0.0%,1h
41545,2,comnuts,2088,0,0,1,1,0.0%,3h
41545,2,Thrawn,2088,0,0,5,5,0.0%,3h
41545,2,[LCRR]Quseed,2088,0,0,5,5,0.0%,26m
41570,2,Ton,2087,1179,48,49,97,49.5%,1h
41570,1,Björn,2087,1040,36,48,84,42.9%,48m
41570,1,khanh,2087,938,29,37,66,43.9%,13m
41570,2,PlackTUM,2087,506,18,22,40,45.0%,8m
41570,1,Waddles,2087,519,16,19,35,45.7%,3h
41570,1,Mapache,2087,536,16,30,46,34.8%,1h
41570,2,AkumuD,2087,432,15,16,31,48.4%,1h
41570,1,FGDFG,2087,380,13,20,33,39.4%,50m
41570,2,sadboys,2087,361,12,9,21,57.1%,13m
41570,2,Maulicious,2087,368,12,11,23,52.2%,1h
41570,2,who,2087,362,12,13,25,48.0%,3h
41570,1,[CyGor]Kraken,2087,329,10,11,21,47.6%,7m
41570,2,FLoveShady,2087,282,10,18,28,35.7%,1h
41570,2,Splurdunckle,2087,269,9,6,15,60.0%,1h
41570,2,[Jest]DaddyMcCream,2087,218,8,10,18,44.4%,1h
41570,2,[Tashas]haake,2087,176,6,10,16,37.5%,3h
41570,2,HAILSTATE,2087,66,3,1,4,75.0%,1h
41570,2,nicolas,2087,156,3,6,9,33.3%,1h
41570,1,Legalgui,2087,121,3,9,12,25.0%,1h
41570,1,SoMLic,2087,91,2,6,8,25.0%,3h
41570,2,Lieriant,2087,0,1,0,1,100.0%,1h
41570,2,WelderDude,2087,27,1,3,4,25.0%,3h
41570,1,BRASiL,2087,0,1,7,8,12.5%,48m
41570,2,[MncsGG]Dinkelberg,2087,0,0,1,1,0.0%,10m
41570,2,Deems,2087,0,0,1,1,0.0%,3h
41570,2,Cucowisc,2087,0,0,5,5,0.0%,40m
41570,2,DarkJosh,2087,0,0,5,5,0.0%,3h
41570,2,Odarenny,2087,0,0,5,5,0.0%,3h
41598,1,DJVOCHO,2086,1648,206,220,426,48.4%,3h
41598,1,GhostriderZ,2086,1465,142,150,292,48.6%,1h
41598,1,macr,2086,1217,46,51,97,47.4%,45m
41598,2,[pajaro]Kenshin,2086,806,34,30,64,53.1%,3h
41598,2,[JaMiT]ASAP,2086,553,27,12,39,69.2%,59m
41598,1,dethdoorway,2086,231,15,25,40,37.5%,42m
41598,2,rodemito,2086,246,13,37,50,26.0%,1h
41598,2,tett,2086,290,11,10,21,52.4%,3h
41598,2,[CaC4s]BobEsponja,2086,252,8,5,13,61.5%,3h
41598,2,torta,2086,158,6,6,12,50.0%,1h
41598,2,Yellow,2086,174,5,3,8,62.5%,40m
41598,2,WheelJackAtt,2086,30,3,10,13,23.1%,34m
41598,3,Hazard,2086,0,1,2,3,33.3%,3h
41598,2,jaime,2086,46,1,2,3,33.3%,1h
41598,2,notabarcode,2086,0,1,4,5,20.0%,1h
41598,2,Clutch,2086,30,1,4,5,20.0%,19m
41598,2,RagnaR,2086,30,1,6,7,14.3%,60m
41598,1,tlarock,2086,0,1,7,8,12.5%,60m
41598,2,[DlVlNE]JoshJutsu,2086,0,0,1,1,0.0%,1h
41598,2,Curtlis,2086,0,0,1,1,0.0%,3h
41598,2,[MITROM]Jamrock,2086,0,0,1,1,0.0%,8m
41598,1,[TCD]TotheMAX,2086,0,0,2,2,0.0%,11m
41598,2,Italo,2086,0,0,5,5,0.0%,3h
41621,1,Severian,2085,1685,120,129,249,48.2%,42m
41621,2,Mazinga,2085,1458,66,54,120,55.0%,8m
41621,2,jmgzch,2085,580,49,44,93,52.7%,56m
41621,1,Nguyenvufoto,2085,420,30,45,75,40.0%,54m
41621,1,uwantsum,2085,751,29,32,61,47.5%,3m
41621,2,[xMSx]GENERALZON,2085,554,22,26,48,45.8%,15m
41621,2,Ikeor,2085,560,20,17,37,54.1%,1h
41621,2,SewerSermon,2085,338,13,16,29,44.8%,40m
41621,2,Erick,2085,280,9,16,25,36.0%,8m
41621,2,TheCamryMan,2085,241,8,4,12,66.7%,3h
41621,2,Nycto,2085,154,8,7,15,53.3%,3h
41621,2,[JUGOS2]aldevaran,2085,248,8,10,18,44.4%,1h
41621,2,CHICKEN,2085,208,6,10,16,37.5%,1h
41621,2,Michael,2085,128,4,6,10,40.0%,20m
41621,2,CptnBuckaroo,2085,86,3,3,6,50.0%,41m
41621,1,LoganArakune,2085,144,3,4,7,42.9%,5m
41621,2,Razkocnicof,2085,30,3,4,7,42.9%,1h
41621,2,TuToyerLCiel,2085,46,2,6,8,25.0%,1h
41621,1,BEAN,2085,96,2,7,9,22.2%,3h
41621,1,[DGotO]Chameleon,2085,0,2,9,11,18.2%,1h
41621,2,[SyL]Danie,2085,30,1,1,2,50.0%,1h
41621,2,memoxxx,2085,30,1,5,6,16.7%,43m
41621,2,Raupp,2085,0,1,6,7,14.3%,3h
41621,2,[Raytar]Bhavish,2085,30,1,6,7,14.3%,40m
41621,2,[Mammy]Tomhumfree,2085,0,1,7,8,12.5%,1h
41646,2,mortaro,2084,1597,198,213,411,48.2%,34m
41646,1,[R33D]Sam,2084,1631,155,163,318,48.7%,52m
41646,1,willy,2084,1575,146,150,296,49.3%,3h
41646,2,raptor,2084,1608,77,70,147,52.4%,10m
41646,2,MikyWoodz,2084,260,51,64,115,44.3%,3h
41646,1,TigerRock,2084,969,43,54,97,44.3%,24m
41646,2,ElTioEmy,2084,905,35,41,76,46.1%,3h
41646,2,Reeso,2084,454,33,27,60,55.0%,8m
41646,1,Adventurer,2084,555,31,19,50,62.0%,1h
41646,2,MrPink,2084,555,23,16,39,59.0%,3h
41646,2,Lethaltempho,2084,400,14,12,26,53.8%,3h
41646,2,Simonus,2084,264,12,2,14,85.7%,10m
41646,1,Zile,2084,369,11,19,30,36.7%,1h
41646,2,Destructor,2084,240,8,13,21,38.1%,32m
41646,3,Blaze,2084,244,8,14,22,36.4%,1h
41646,1,BlackBull,2084,110,7,9,16,43.8%,3h
41646,2,elefanteHOT,2084,132,4,5,9,44.4%,15m
41646,1,SebProoX,2084,145,3,3,6,50.0%,17m
41646,1,Endrows,2084,36,3,7,10,30.0%,8m
41646,1,[TxC1]Daren,2084,44,3,7,10,30.0%,24m
41646,2,[NKW]Crosen,2084,92,2,4,6,33.3%,1h
41646,2,Detrepid,2084,30,2,5,7,28.6%,5m
41646,1,Critz,2084,48,2,8,10,20.0%,31m
41646,2,[SCpros]RedImage,2084,0,1,1,2,50.0%,3h
41646,2,maxpeinII,2084,34,1,3,4,25.0%,1h
41646,2,Ave,2084,0,1,6,7,14.3%,3h
41646,3,RealSteel,2084,0,1,7,8,12.5%,1h
41646,2,[JOSOWE]mighty,2084,0,0,3,3,0.0%,40m
41646,2,[TrTe]Frost,2084,0,0,5,5,0.0%,3h
41646,2,tholapz,2084,0,0,5,5,0.0%,33m
41646,1,XDanT,2084,0,0,7,7,0.0%,3h
41677,1,dangwheezy,2083,1621,271,282,553,49.0%,3h
41677,2,Horlerguy,2083,1209,68,73,141,48.2%,25m
41677,1,notchi,2083,1088,60,70,130,46.2%,1h
41677,2,BlessedRoman,2083,1352,56,49,105,53.3%,3h
41677,2,Lout,2083,771,31,20,51,60.8%,59m
41677,2,AapixX,2083,589,22,21,43,51.2%,12m
41677,2,zion,2083,552,20,20,40,50.0%,3h
41677,1,MrStormFlash,2083,354,9,16,25,36.0%,3h
41677,2,[CobraC]Destro,2083,172,6,8,14,42.9%,3h
41677,1,Andrew,2083,104,5,8,13,38.5%,3h
41677,2,FOX,2083,96,4,3,7,57.1%,8m
41677,2,Jcg,2083,171,4,4,8,50.0%,1h
41677,1,SonicMarine,2083,145,4,8,12,33.3%,59m
41677,1,Soul,2083,145,3,8,11,27.3%,1h
41677,2,esBozzo,2083,60,2,2,4,50.0%,1h
41677,3,Bebop,2083,121,2,2,4,50.0%,1h
41677,2,MicroMachine,2083,60,2,4,6,33.3%,3h
41677,2,TulioRocket,2083,100,2,6,8,25.0%,26m
41677,2,Commander,2083,0,1,1,2,50.0%,60m
41677,2,[LimaSC]LorKaos,2083,42,1,1,2,50.0%,3h
41677,1,WARCHE,2083,48,1,3,4,25.0%,1h
41677,2,juanDiego,2083,0,0,1,1,0.0%,10m
41677,1,CAIO,2083,0,0,1,1,0.0%,1h
41677,2,Jim,2083,0,0,5,5,0.0%,1h
41677,1,micachero,2083,0,0,6,6,0.0%,3h
41702,1,BabyCakes,2082,1542,98,92,190,51.6%,52m
41702,2,rbg,2082,1181,60,68,128,46.9%,43m
41702,2,TwoHunniD,2082,610,29,33,62,46.8%,3h
41702,2,[oRuRo]NISHINOYA,2082,499,17,17,34,50.0%,3h
41702,2,LGNoth,2082,332,12,14,26,46.2%,1h
41702,2,SrChan,2082,246,9,10,19,47.4%,3h
41702,2,damianhommie,2082,90,4,4,8,50.0%,1h
41702,2,Progamer,2082,92,3,6,9,33.3%,34m
41702,2,Toobig,2082,94,3,12,15,20.0%,1h
41702,3,BlueWave,2082,30,2,0,2,100.0%,45m
41702,2,scosco,2082,58,2,1,3,66.7%,3h
41702,1,Zekken,2082,94,2,7,9,22.2%,22m
41702,2,Zues,2082,30,1,1,2,50.0%,3h
41702,2,Suamãe,2082,0,0,1,1,0.0%,1h
41702,2,[dioses]ZannyDreamer,2082,0,0,1,1,0.0%,7m
41702,2,Momia,2082,0,0,4,4,0.0%,1h
41702,2,Kennister,2082,0,0,5,5,0.0%,1h
41719,2,HorLips,2081,1557,394,410,804,49.0%,1h
41719,2,FAITH,2081,1685,155,181,336,46.1%,33m
41719,2,Eskiman,2081,1376,67,76,143,46.9%,38m
41719,2,Rusher,2081,802,62,65,127,48.8%,57m
41719,2,Stannis,2081,1281,49,54,103,47.6%,15m
41719,2,Guardian,2081,964,40,43,83,48.2%,1h
41719,1,[GOPERÚ]killadiction,2081,932,31,41,72,43.1%,6m
41719,2,sbroker,2081,312,14,18,32,43.8%,1h
41719,1,info,2081,358,11,18,29,37.9%,1h
41719,3,FoRtHeSwArM,2081,352,11,22,33,33.3%,3h
41719,2,[ERFT]Teniente,2081,310,10,17,27,37.0%,1h
41719,1,oceanfx,2081,182,4,1,5,80.0%,3h
41719,1,[Iwdb]SadSalad,2081,216,4,14,18,22.2%,3h
41719,2,batesito,2081,94,3,8,11,27.3%,1h
41719,2,MatMalespina,2081,0,2,3,5,40.0%,1h
41719,2,InerOmnivor,2081,60,2,4,6,33.3%,10m
41719,2,OverMind,2081,0,1,0,1,100.0%,5m
41719,2,newbie,2081,0,1,1,2,50.0%,3h
41719,1,marceloco,2081,0,1,3,4,25.0%,7m
41719,1,Dizlart,2081,0,1,7,8,12.5%,39m
41719,2,Flash,2081,0,0,1,1,0.0%,38m
41719,2,[KING3]tehpenix,2081,0,0,3,3,0.0%,1h
41719,1,[SANGRE]Players,2081,0,0,3,3,0.0%,3h
41742,2,PumaSphere,2080,1010,57,46,103,55.3%,3h
41742,2,Gaylord,2080,1087,45,64,109,41.3%,1h
41742,1,Porcins,2080,950,32,38,70,45.7%,1h
41742,1,SportsFreak,2080,502,18,20,38,47.4%,3h
41742,2,[clanSD]viernes,2080,343,15,12,27,55.6%,19m
41742,2,[Pibo3]thohight,2080,384,14,11,25,56.0%,1h
41742,1,MrC,2080,376,14,14,28,50.0%,3h
41742,1,[SCIIS]RemCogito,2080,218,7,15,22,31.8%,44m
41742,1,tanKing,2080,136,5,10,15,33.3%,1h
41742,1,[isXM]Peyper,2080,192,4,2,6,66.7%,3h
41742,2,ElDorado,2080,30,4,3,7,57.1%,1h
41742,2,CharlieBrown,2080,60,3,2,5,60.0%,1h
41742,2,Tripp,2080,88,3,6,9,33.3%,15m
41742,2,mooppy,2080,90,3,6,9,33.3%,3h
41742,1,Chaffo,2080,122,3,8,11,27.3%,7m
41742,3,RacerXL,2080,133,3,12,15,20.0%,26m
41742,2,[iar]THEBUTLER,2080,58,2,2,4,50.0%,1h
41742,1,Carter,2080,107,2,7,9,22.2%,16m
41742,2,McFuss,2080,0,1,4,5,20.0%,3h
41742,1,Gigo,2080,0,1,7,8,12.5%,3h
41742,2,darthkahl,2080,0,0,1,1,0.0%,1h
41742,2,Waco,2080,0,0,2,2,0.0%,1h
41742,2,[papaov]Helcor,2080,0,0,2,2,0.0%,1h
41742,2,heropotato,2080,0,0,5,5,0.0%,50m
41742,2,SmugBanana,2080,0,0,5,5,0.0%,16m
41767,1,BossLady,2079,1698,81,93,174,46.6%,1h
41767,2,MoreGG,2079,778,30,26,56,53.6%,3h
41767,1,Minji,2079,578,27,37,64,42.2%,24m
41767,2,[NTrio]TheJadinator,2079,338,12,11,23,52.2%,23m
41767,1,VerySlowAPM,2079,272,8,35,43,18.6%,1h
41767,2,Pogz,2079,197,7,7,14,50.0%,29m
41767,2,qmx,2079,166,6,3,9,66.7%,1h
41767,2,Nubcakes,2079,128,5,5,10,50.0%,34m
41767,1,richman,2079,160,5,11,16,31.2%,1h
41767,1,ROJKA,2079,150,4,13,17,23.5%,3h
41767,2,Blakedd,2079,30,2,0,2,100.0%,22m
41767,2,Homan,2079,60,2,4,6,33.3%,1h
41767,1,TonyParrot,2079,97,2,7,9,22.2%,1h
41767,1,Burow,2079,62,2,17,19,10.5%,43m
41767,2,[TeaTym]TeVGrumpyCat,2079,30,1,1,2,50.0%,43m
41767,2,MrStrokes,2079,0,1,1,2,50.0%,1h
41767,1,Deathknight,2079,0,1,2,3,33.3%,52m
41767,2,AXY,2079,44,1,2,3,33.3%,1h
41767,1,ELTREMENDO,2079,0,1,5,6,16.7%,3h
41767,2,Detour,2079,0,0,1,1,0.0%,3h
41767,2,AhJian,2079,0,0,1,1,0.0%,1h
41767,2,Brewar,2079,0,0,5,5,0.0%,43m
41767,2,VegasViking,2079,0,0,7,7,0.0%,1h
41790,1,MSAM,2078,1610,194,196,390,49.7%,41m
41790,1,Vulture,2078,826,74,60,134,55.2%,1h
41790,1,Ulgrim,2078,1620,62,63,125,49.6%,3h
41790,2,Zelot,2078,948,44,35,79,55.7%,3h
41790,2,ProbeKing,2078,764,26,31,57,45.6%,3h
41790,1,[FFAA]beast,2078,589,18,25,43,41.9%,1h
41790,1,comanderalex,2078,422,13,22,35,37.1%,50m
41790,2,dieego,2078,281,12,5,17,70.6%,3h
41790,2,katracA,2078,261,10,13,23,43.5%,29m
41790,1,Billy,2078,234,8,9,17,47.1%,41m
41790,1,Hikero,2078,252,7,12,19,36.8%,3h
41790,2,[TGF456]gumaro,2078,144,5,6,11,45.5%,15m
41790,2,ArgentiSol,2078,153,4,5,9,44.4%,16m
41790,1,acmunpt,2078,110,3,3,6,50.0%,13m
41790,2,McJoey,2078,144,3,7,10,30.0%,34m
41790,2,[F0CK3R]TUCCI,2078,138,3,8,11,27.3%,1h
41790,3,SuperZeb,2078,97,3,10,13,23.1%,40m
41790,3,Silverdeer,2078,60,3,13,16,18.8%,3h
41790,2,Amoonda,2078,0,1,0,1,100.0%,1h
41790,2,JackPatata,2078,0,1,2,3,33.3%,30m
41790,1,GreaTOwneR,2078,48,1,3,4,25.0%,3h
41790,2,[LTK]Faninor,2078,0,1,4,5,20.0%,3h
41790,2,Elessar,2078,0,1,5,6,16.7%,1h
41790,1,gilbycourt,2078,97,1,6,7,14.3%,48m
41790,2,OmegaKent,2078,97,1,6,7,14.3%,3h
41790,3,RIALTRAPSDS,2078,0,1,7,8,12.5%,1h
41790,2,[TH2020]Robloxiano,2078,0,0,1,1,0.0%,1h
41790,2,Frank,2078,0,0,5,5,0.0%,59m
41790,2,TritonSlay,2078,0,0,6,6,0.0%,49m
41790,2,wolfauau,2078,0,0,7,7,0.0%,3h
41820,1,CHAK,2077,1700,181,177,358,50.6%,3h
41820,2,PantsHammer,2077,1619,123,124,247,49.8%,13m
41820,1,Pele,2077,1681,117,133,250,46.8%,1h
41820,2,[DOGT]Terranitup,2077,1603,103,106,209,49.3%,32m
41820,1,Rocky,2077,1515,90,97,187,48.1%,3h
41820,2,KingJames,2077,1323,59,63,122,48.4%,3h
41820,2,Bona,2077,920,40,42,82,48.8%,3h
41820,1,Ruul,2077,937,32,41,73,43.8%,48m
41820,2,[PBFlcn]Zionoddy,2077,782,25,34,59,42.4%,1h
41820,1,[MESCAL]Lelouch,2077,438,18,19,37,48.6%,1h
41820,1,RedMoonKing,2077,512,16,23,39,41.0%,15m
41820,2,[BLUNTD]MAD,2077,198,12,8,20,60.0%,34m
41820,2,wacklejackle,2077,328,11,15,26,42.3%,3h
41820,1,joacolp,2077,206,8,12,20,40.0%,1h
41820,2,walten,2077,248,7,5,12,58.3%,32m
41820,3,Trobjonr,2077,197,7,13,20,35.0%,14m
41820,1,juansurvivor,2077,154,5,6,11,45.5%,3h
41820,2,Kingslayer,2077,144,5,8,13,38.5%,3h
41820,2,tmwctw,2077,0,4,1,5,80.0%,1h
41820,1,Bamabam,2077,166,4,10,14,28.6%,3h
41820,1,[110011]Andhren,2077,116,4,13,17,23.5%,3m
41820,2,Arwivi,2077,33,3,4,7,42.9%,13m
41820,2,relentless,2077,30,1,6,7,14.3%,33m
41820,2,[ICTH]JohnWilliams,2077,30,1,6,7,14.3%,3h
41820,1,Steve,2077,0,1,7,8,12.5%,1h
41820,3,Roman,2077,0,1,7,8,12.5%,34m
41820,2,[cluez]Bubbles,2077,46,1,7,8,12.5%,3h
41820,2,[Exper]zak,2077,0,0,1,1,0.0%,23m
41820,2,kingpinsword,2077,0,0,4,4,0.0%,3h
41820,2,Zelgadis,2077,0,0,5,5,0.0%,57m
41820,2,bryceg,2077,0,0,6,6,0.0%,16m
41851,1,cAvALIER,2076,1373,173,182,355,48.7%,1h
41851,2,JoeMama,2076,1387,85,86,171,49.7%,41m
41851,2,feeedle,2076,1194,56,48,104,53.8%,3h
41851,1,meysamvatoo,2076,577,30,30,60,50.0%,3h
41851,1,Nessxd,2076,482,29,31,60,48.3%,24m
41851,1,Jukko,2076,668,23,33,56,41.1%,3h
41851,2,mlack,2076,535,20,28,48,41.7%,3h
41851,2,chifaderlys,2076,484,14,41,55,25.5%,38m
41851,2,coco,2076,293,13,17,30,43.3%,3h
41851,1,Galoker,2076,234,8,12,20,40.0%,48m
41851,1,EinDalton,2076,96,3,10,13,23.1%,7m
41851,2,Andronmaghe,2076,122,3,11,14,21.4%,3h
41851,2,stiuvenelvro,2076,94,3,12,15,20.0%,12m
41851,1,[GILLY]Kyean,2076,48,2,1,3,66.7%,3h
41851,2,[Pyr3s]Gelf,2076,0,2,3,5,40.0%,26m
41851,2,ThunderBoss,2076,88,2,3,5,40.0%,57m
41851,2,dark,2076,94,1,1,2,50.0%,1h
41851,2,[C38108]Nexu,2076,30,1,3,4,25.0%,3h
41851,1,IALWAYSLOSE,2076,0,1,8,9,11.1%,1h
41851,3,Ptosis,2076,0,0,1,1,0.0%,5m
41851,2,[WLD1s]Darkahn,2076,0,0,1,1,0.0%,1h
41851,2,HonorGuideMe,2076,0,0,5,5,0.0%,1h
41851,2,PacoVanilla,2076,0,0,5,5,0.0%,1h
41874,2,Alfaorionis,2075,1506,112,120,232,48.3%,1h
41874,1,Ronmatic,2075,579,102,106,208,49.0%,54m
41874,1,DUDE,2075,1046,74,79,153,48.4%,29m
41874,1,HAOLE,2075,1341,58,67,125,46.4%,3h
41874,2,GatoBlanco,2075,1090,45,46,91,49.5%,3h
41874,1,Winterfall,2075,902,31,43,74,41.9%,3h
41874,3,None,2075,733,30,39,69,43.5%,1h
41874,2,Praetorian,2075,818,29,30,59,49.2%,3h
41874,2,Macuco,2075,726,25,26,51,49.0%,1h
41874,1,Sobez,2075,357,20,21,41,48.8%,1h
41874,1,Edmaton,2075,276,12,17,29,41.4%,1h
41874,2,[SOAF]TANDemonium,2075,347,11,10,21,52.4%,3h
41874,1,Riku,2075,276,11,14,25,44.0%,3h
41874,1,Dragonic,2075,262,7,18,25,28.0%,15m
41874,2,kevin,2075,144,4,1,5,80.0%,25m
41874,1,peyl,2075,197,4,9,13,30.8%,9m
41874,2,Mario,2075,58,3,3,6,50.0%,3h
41874,2,Crazyhobo,2075,30,2,1,3,66.7%,3h
41874,2,Pinochet,2075,48,2,4,6,33.3%,1h
41874,2,McNugget,2075,60,2,7,9,22.2%,15m
41874,1,Thundersky,2075,73,2,8,10,20.0%,3h
41874,2,YOSVAN,2075,88,1,1,2,50.0%,10m
41874,2,Zybort,2075,0,1,4,5,20.0%,3h
41874,2,Lexx,2075,30,1,5,6,16.7%,25m
41874,2,[Wiz3r]xXkrazyXx,2075,0,0,1,1,0.0%,3h
41874,2,Davany,2075,0,0,1,1,0.0%,1h
41874,2,ElAmer,2075,0,0,2,2,0.0%,10m
41874,2,[Av0c]Pandasaurus,2075,0,0,5,5,0.0%,1h
41874,2,Ali,2075,0,0,5,5,0.0%,34m
41874,3,Arc,2075,0,0,6,6,0.0%,40m
41904,1,Wagamuru,2074,1651,156,184,340,45.9%,3h
41904,1,SirJohnEh,2074,1664,79,75,154,51.3%,9m
41904,2,[CIPE]rahmenburg,2074,893,46,49,95,48.4%,3h
41904,2,[BR101]Helemes,2074,1082,42,39,81,51.9%,3h
41904,2,Kyle,2074,712,30,20,50,60.0%,19m
41904,2,superdragon,2074,693,28,23,51,54.9%,60m
41904,1,DJeFFreYD,2074,686,27,35,62,43.5%,1h
41904,2,MiguelAngel,2074,617,24,23,47,51.1%,1h
41904,2,TheHighStorm,2074,448,16,18,34,47.1%,49m
41904,2,STUKOV,2074,416,15,17,32,46.9%,44m
41904,1,Bruno,2074,400,14,24,38,36.8%,3h
41904,2,[PYH]Baccanali,2074,392,12,23,35,34.3%,3h
41904,2,[4L0k0]destructorSC,2074,345,10,9,19,52.6%,3h
41904,2,Ricardox,2074,164,7,4,11,63.6%,15m
41904,2,titanyisus,2074,202,7,9,16,43.8%,1h
41904,1,kaan,2074,230,7,16,23,30.4%,45m
41904,2,Ricardo,2074,120,5,3,8,62.5%,3h
41904,3,AlissYourQn,2074,146,4,2,6,66.7%,3h
41904,2,Inaskii,2074,160,4,3,7,57.1%,1h
41904,2,Necklasmen,2074,60,3,3,6,50.0%,30m
41904,2,Lucaketz,2074,0,3,3,6,50.0%,3h
41904,2,FBchezy,2074,88,3,4,7,42.9%,3h
41904,1,[BroTlz]BrownPuma,2074,32,3,8,11,27.3%,3h
41904,1,Qwilliam,2074,96,3,8,11,27.3%,1h
41904,1,[UNpT]Gtr,2074,162,3,9,12,25.0%,3h
41904,2,[MxID]JOSE,2074,114,2,1,3,66.7%,3h
41904,2,[SLKNM]TaTo,2074,48,2,6,8,25.0%,3h
41904,2,SneakyNinja,2074,48,2,7,9,22.2%,12m
41904,1,Teshnuburr,2074,84,2,9,11,18.2%,45m
41904,2,JamesRaynor,2074,0,1,0,1,100.0%,3h
41904,2,Bacdrafart,2074,0,1,2,3,33.3%,1h
41904,2,Askedmed,2074,0,1,3,4,25.0%,15m
41904,2,rosasparks,2074,30,1,5,6,16.7%,15m
41904,2,Strider,2074,0,0,1,1,0.0%,56m
41904,1,Pinlight,2074,0,0,3,3,0.0%,3h
41904,2,PUTEYPIE,2074,0,0,3,3,0.0%,3h
41904,2,LIMA,2074,0,0,3,3,0.0%,12m
41904,2,Smokey,2074,0,0,5,5,0.0%,1h
41904,2,PainSerj,2074,0,0,5,5,0.0%,3h
41904,2,ERYZ,2074,0,0,6,6,0.0%,3h
41944,2,FreeSpirit,2073,785,85,89,174,48.9%,18m
41944,1,Leofrancis,2073,1091,34,44,78,43.6%,28m
41944,1,Boofi,2073,908,30,35,65,46.2%,24m
41944,2,[SCUnal]Kathartes,2073,738,27,28,55,49.1%,1h
41944,2,silverwolf,2073,469,23,24,47,48.9%,1h
41944,2,[Kappæ]Edakiller,2073,599,20,27,47,42.6%,3h
41944,2,Haxx,2073,284,10,2,12,83.3%,25m
41944,2,SirCampeon,2073,302,9,9,18,50.0%,3h
41944,2,Torbaz,2073,186,6,3,9,66.7%,23m
41944,2,[pSC20]special,2073,176,6,11,17,35.3%,3h
41944,1,Pegassus,2073,48,4,5,9,44.4%,8m
41944,1,Reid,2073,197,4,11,15,26.7%,45m
41944,2,protwolf,2073,58,3,1,4,75.0%,3h
41944,3,Dominic,2073,94,3,22,25,12.0%,3h
41944,2,ZeXaty,2073,62,2,7,9,22.2%,1h
41944,2,Oblivion,2073,68,2,7,9,22.2%,29m
41944,2,GhastlyGoat,2073,0,1,0,1,100.0%,3h
41944,2,exotic,2073,30,1,4,5,20.0%,1h
41944,2,Bensakul,2073,0,1,5,6,16.7%,59m
41944,1,LargeFungus,2073,0,0,2,2,0.0%,60m
41944,2,Bimmerfest,2073,0,0,2,2,0.0%,1h
41944,2,CHUGENSI,2073,0,0,3,3,0.0%,1h
41944,2,[DSGs]PETER,2073,0,0,3,3,0.0%,1h
41944,2,MIkethemoose,2073,0,0,4,4,0.0%,3h
41944,2,Paqueinor,2073,0,0,5,5,0.0%,3h
41944,2,callmeking,2073,0,0,5,5,0.0%,26m
41970,1,Tower,2072,1699,174,172,346,50.3%,3h
41970,2,[IMDSI]DiegoShulla,2072,1581,86,80,166,51.8%,3h
41970,1,Stubbynubby,2072,498,44,48,92,47.8%,24m
41970,2,[LTBV]Alordeymon,2072,939,35,31,66,53.0%,34m
41970,1,Xyon,2072,618,21,29,50,42.0%,3h
41970,2,[POCHA]SrSandía,2072,332,12,17,29,41.4%,5m
41970,2,FlexBox,2072,283,8,6,14,57.1%,1h
41970,2,slayerlife,2072,144,7,4,11,63.6%,13m
41970,1,Sagaz,2072,172,6,12,18,33.3%,3h
41970,2,Mordent,2072,174,5,2,7,71.4%,41m
41970,2,josdan,2072,114,5,6,11,45.5%,3h
41970,2,Enlightend,2072,114,5,7,12,41.7%,1h
41970,1,Bloodheart,2072,145,5,8,13,38.5%,1h
41970,1,CBRahn,2072,204,5,12,17,29.4%,39m
41970,2,Ironpillar,2072,100,3,6,9,33.3%,3h
41970,2,SleepyJoe,2072,92,3,8,11,27.3%,20m
41970,2,[DevilF]CartianGlory,2072,40,2,3,5,40.0%,3h
41970,2,Regnier,2072,30,2,4,6,33.3%,1h
41970,2,jonathan,2072,97,2,9,11,18.2%,22m
41970,2,WaffleMoff,2072,0,1,0,1,100.0%,3h
41970,2,PraetorianB,2072,38,1,2,3,33.3%,3h
41970,2,Camalot,2072,0,0,1,1,0.0%,1h
41970,1,voodoogoats,2072,0,0,2,2,0.0%,7m
41970,2,doctorzlo,2072,0,0,2,2,0.0%,1h
41970,2,Tahuantinsuy,2072,0,0,2,2,0.0%,1h
41970,2,[jajas]daniel,2072,0,0,2,2,0.0%,3h
41970,2,Bunting,2072,0,0,4,4,0.0%,41m
41970,2,Lairdeth,2072,0,0,5,5,0.0%,40m
41970,2,SolGoodman,2072,0,0,5,5,0.0%,1h
41970,2,[BDPB]GregSchmitz,2072,0,0,5,5,0.0%,3h
42000,2,robokitty,2071,1610,260,273,533,48.8%,1h
42000,1,Ufuxdead,2071,1522,188,189,377,49.9%,3h
42000,1,NATURESGAMES,2071,1582,145,155,300,48.3%,1h
42000,1,Krota,2071,1658,121,128,249,48.6%,1h
42000,2,nut,2071,590,26,32,58,44.8%,3h
42000,1,KillaCam,2071,736,25,34,59,42.4%,3h
42000,2,BronzeHero,2071,516,23,24,47,48.9%,1h
42000,2,BigBlock,2071,335,12,16,28,42.9%,1h
42000,2,BIGHUGEPINO,2071,306,11,15,26,42.3%,3h
42000,1,botswai,2071,147,10,23,33,30.3%,3h
42000,2,Fischer,2071,218,8,6,14,57.1%,15m
42000,1,Dantor,2071,244,7,5,12,58.3%,3h
42000,2,Bloodmurador,2071,263,7,6,13,53.8%,10m
42000,2,[LOPELU]Viper,2071,212,7,12,19,36.8%,8m
42000,1,TLMhelux,2071,212,7,15,22,31.8%,3h
42000,1,brainnagi,2071,190,6,12,18,33.3%,1h
42000,1,xXzenkyXx,2071,223,6,12,18,33.3%,1h
42000,2,ThirdRaik,2071,0,5,0,5,100.0%,3h
42000,2,poodragon,2071,201,5,7,12,41.7%,32m
42000,2,Spirit,2071,168,5,9,14,35.7%,3h
42000,2,Danny,2071,160,4,6,10,40.0%,34m
42000,2,dgdgkhiukhjk,2071,62,3,12,15,20.0%,56m
42000,2,Wscan,2071,48,2,4,6,33.3%,3h
42000,2,[WSFire]FireBorn,2071,74,2,6,8,25.0%,1h
42000,2,HLLStar,2071,97,2,9,11,18.2%,3h
42000,2,TRONOMOX,2071,30,1,2,3,33.3%,3h
42000,2,JimRaynor,2071,48,1,3,4,25.0%,1h
42000,2,Sharpsgtsnip,2071,0,1,3,4,25.0%,1h
42000,2,Magnunn,2071,30,1,7,8,12.5%,1h
42000,1,Ermezz,2071,0,1,7,8,12.5%,53m
42000,3,[LOHs]hero,2071,0,0,1,1,0.0%,1h
42000,3,[LEG1ON]Épsilon,2071,0,0,1,1,0.0%,1h
42000,1,[NO0OBZ]MAKO,2071,0,0,2,2,0.0%,9m
42000,3,FGT,2071,0,0,3,3,0.0%,35m
42034,1,LunarMexican,2070,1671,160,167,327,48.9%,3h
42034,1,GeneralTso,2070,1639,119,122,241,49.4%,1h
42034,1,RodTach,2070,1315,87,91,178,48.9%,1h
42034,2,PinkkeHwang,2070,691,45,57,102,44.1%,1h
42034,1,Eric,2070,1091,38,44,82,46.3%,24m
42034,1,Geokiller,2070,682,28,34,62,45.2%,3h
42034,2,marauder,2070,786,26,34,60,43.3%,3h
42034,3,wellbeing,2070,224,23,32,55,41.8%,14m
42034,2,[VMP]TheNatureBoy,2070,440,13,19,32,40.6%,3h
42034,2,Sage,2070,299,11,11,22,50.0%,29m
42034,2,[xDYEx]Trouble,2070,242,9,4,13,69.2%,3h
42034,2,Cloud,2070,288,7,18,25,28.0%,3h
42034,1,LMerlock,2070,237,6,5,11,54.5%,7m
42034,2,OncomingStrm,2070,88,5,4,9,55.6%,3h
42034,2,Yashiro,2070,192,5,5,10,50.0%,16m
42034,2,Order,2070,166,5,8,13,38.5%,3h
42034,2,[LAZRKT]crater,2070,46,4,4,8,50.0%,10m
42034,2,mysterygan,2070,114,3,0,3,100.0%,1h
42034,2,[SCROT]Dutchysmoke,2070,94,3,4,7,42.9%,27m
42034,1,Fixezinho,2070,122,2,4,6,33.3%,1h
42034,2,StriKer,2070,30,2,7,9,22.2%,26m
42034,1,oriondream,2070,0,1,8,9,11.1%,17m
42034,2,KingSTiiG,2070,30,1,8,9,11.1%,1h
42034,1,Storyteller,2070,0,0,1,1,0.0%,1h
42034,2,droidmademe,2070,0,0,1,1,0.0%,1h
42034,2,zerathull,2070,0,0,1,1,0.0%,3h
42034,3,greatwolflod,2070,0,0,2,2,0.0%,37m
42034,2,InstinctMode,2070,0,0,5,5,0.0%,3h
42034,2,Warriors,2070,0,0,5,5,0.0%,33m
42034,2,VitaSoy,2070,0,0,6,6,0.0%,1h
42034,2,SauceBlack,2070,0,0,6,6,0.0%,1h
42065,1,SpeedyRogue,2069,1587,80,73,153,52.3%,3h
42065,2,mayoflavored,2069,1154,60,55,115,52.2%,3h
42065,1,Mino,2069,623,45,55,100,45.0%,1h
42065,1,CSPAN,2069,1066,37,43,80,46.2%,3h
42065,2,DocMonty,2069,787,28,39,67,41.8%,3h
42065,2,razz,2069,686,26,39,65,40.0%,1h
42065,1,[VRGA]RamonShatter,2069,836,25,35,60,41.7%,1h
42065,1,[MEXGER]LSDanner,2069,615,24,23,47,51.1%,1h
42065,2,Fire,2069,516,22,17,39,56.4%,1h
42065,2,vIICHAOSIIv,2069,564,21,25,46,45.7%,3h
42065,2,PhiLLpino,2069,188,15,12,27,55.6%,33m
42065,2,Lucent,2069,370,13,17,30,43.3%,1h
42065,2,GASPER,2069,246,12,12,24,50.0%,60m
42065,2,Dan,2069,322,10,13,23,43.5%,3h
42065,1,Jiren,2069,127,4,4,8,50.0%,3h
42065,1,deadmask,2069,66,4,12,16,25.0%,1h
42065,1,[534698]GENOSAUREN,2069,109,3,1,4,75.0%,8m
42065,2,[Lpan]brunarr,2069,60,3,2,5,60.0%,33m
42065,3,ElFipe,2069,0,3,2,5,60.0%,20m
42065,2,MeatCurtains,2069,120,3,8,11,27.3%,1h
42065,1,Rgsd,2069,97,2,8,10,20.0%,1h
42065,2,Justin,2069,0,1,0,1,100.0%,41m
42065,2,[D3m0N]ZepoL,2069,0,1,0,1,100.0%,1h
42065,3,Escalt,2069,0,1,0,1,100.0%,26m
42065,2,Walker,2069,0,0,2,2,0.0%,3h
42065,2,SuperMario,2069,0,0,3,3,0.0%,1h
42065,2,Turko,2069,0,0,5,5,0.0%,1h
42065,3,READYPLAYER,2069,0,0,5,5,0.0%,3h
42065,2,Skoll,2069,0,0,5,5,0.0%,11m
42094,3,Wronin,2068,1541,191,223,414,46.1%,1h
42094,3,twonesixsix,2068,1429,139,172,311,44.7%,58m
42094,2,DaveyC,2068,1626,125,164,289,43.3%,57m
42094,2,TheAvenger,2068,687,25,28,53,47.2%,1h
42094,2,andone,2068,508,18,21,39,46.2%,1h
42094,2,mana,2068,428,15,16,31,48.4%,49m
42094,2,Jesse,2068,372,14,15,29,48.3%,1h
42094,2,Prelude,2068,397,14,23,37,37.8%,1h
42094,2,DemonKing,2068,330,12,14,26,46.2%,15m
42094,2,doofus,2068,256,11,10,21,52.4%,3h
42094,2,Fearless,2068,353,11,21,32,34.4%,1h
42094,2,Shizza,2068,230,9,9,18,50.0%,3h
42094,3,BRAINSCAN,2068,247,8,14,22,36.4%,3h
42094,2,omgPVO,2068,171,5,3,8,62.5%,3h
42094,2,[HTP450]ErenJaeger,2068,146,5,5,10,50.0%,3h
42094,1,Serocks,2068,48,4,6,10,40.0%,1h
42094,2,Mukk,2068,124,4,12,16,25.0%,1h
42094,2,Luis,2068,136,3,1,4,75.0%,3h
42094,2,[JUGOS]Mangas,2068,58,2,3,5,40.0%,41m
42094,3,reaper,2068,0,2,12,14,14.3%,9m
42094,2,[BobbyJ]bobbyjones,2068,0,1,0,1,100.0%,56m
42094,2,imoomilk,2068,0,1,1,2,50.0%,50m
42094,2,[FIEE]RONY,2068,34,1,4,5,20.0%,3h
42094,1,cjsme,2068,0,1,8,9,11.1%,3h
42094,1,kakashi,2068,0,0,2,2,0.0%,60m
42094,1,[malc]Malc,2068,0,0,4,4,0.0%,1h
42094,2,[800]ProKiller,2068,0,0,5,5,0.0%,37m
42094,3,serdar,2068,0,0,5,5,0.0%,1h
42094,3,theplumsauce,2068,0,0,5,5,0.0%,1h
42123,3,radagast,2067,1268,75,90,165,45.5%,36m
42123,2,Vali,2067,1342,50,51,101,49.5%,3h
42123,2,Stelivious,2067,997,44,36,80,55.0%,44m
42123,1,DiegoFuzatto,2067,1243,44,51,95,46.3%,1h
42123,1,Giovanni,2067,1010,37,41,78,47.4%,45m
42123,2,INTERESTELAR,2067,740,35,27,62,56.5%,1h
42123,2,xerito,2067,822,29,30,59,49.2%,3h
42123,3,[D11313]FERRARI,2067,630,24,31,55,43.6%,1h
42123,2,Syluna,2067,441,22,12,34,64.7%,1h
42123,2,bloolu,2067,535,21,14,35,60.0%,3h
42123,2,Ender,2067,492,17,17,34,50.0%,8m
42123,2,dilanquijije,2067,363,14,8,22,63.6%,56m
42123,2,RevlutionMan,2067,291,12,5,17,70.6%,3h
42123,1,Rugbydude,2067,350,11,18,29,37.9%,42m
42123,2,[KOYOMI]Ericlaser,2067,377,11,19,30,36.7%,21m
42123,2,ArchAngelz,2067,316,10,8,18,55.6%,3h
42123,2,sjschlag,2067,148,5,6,11,45.5%,3h
42123,2,hellturtle,2067,141,4,14,18,22.2%,3h
42123,2,RFAMANI,2067,112,3,0,3,100.0%,8m
42123,2,jeanfes,2067,123,3,2,5,60.0%,3h
42123,2,XTHEMASTER,2067,30,3,3,6,50.0%,1h
42123,2,rtwodeetwo,2067,92,3,6,9,33.3%,3h
42123,2,onoohyeah,2067,62,3,7,10,30.0%,1h
42123,1,DarKudo,2067,74,2,9,11,18.2%,3h
42123,2,ferd,2067,0,1,1,2,50.0%,1h
42123,2,Weasel,2067,46,1,4,5,20.0%,1h
42123,2,shootakaydo,2067,44,1,5,6,16.7%,27m
42123,1,Mikman,2067,48,1,6,7,14.3%,53m
42123,2,Mars,2067,0,0,1,1,0.0%,23m
42123,2,ziggy,2067,0,0,3,3,0.0%,30m
42123,1,Tim,2067,0,0,4,4,0.0%,8m
42123,3,Rosi,2067,0,0,4,4,0.0%,25m
42123,3,TRF,2067,0,0,5,5,0.0%,19m
42123,2,Toleo,2067,0,0,5,5,0.0%,8m
42123,2,George,2067,0,0,5,5,0.0%,3h
42158,1,Slayer,2066,854,96,94,190,50.5%,5m
42158,1,[AmSs]bubashknov,2066,1687,68,79,147,46.3%,1h
42158,1,onnithor,2066,940,62,60,122,50.8%,3h
42158,2,Simonki,2066,1194,45,54,99,45.5%,26m
42158,2,Garand,2066,570,34,27,61,55.7%,37m
42158,2,Shunzilla,2066,384,15,11,26,57.7%,1h
42158,2,Opsys,2066,204,10,14,24,41.7%,41m
42158,2,Vancharekke,2066,324,10,17,27,37.0%,3h
42158,2,Fabulouslife,2066,280,9,7,16,56.2%,3h
42158,2,shadowstorm,2066,192,7,7,14,50.0%,1h
42158,2,amenodorime,2066,221,6,6,12,50.0%,3h
42158,2,JMM,2066,106,4,3,7,57.1%,20m
42158,1,[BsNgLS]NightRaven,2066,106,4,10,14,28.6%,1h
42158,2,Lunaric,2066,112,3,0,3,100.0%,56m
42158,2,maxito,2066,0,2,3,5,40.0%,3h
42158,1,Keys,2066,30,2,8,10,20.0%,45m
42158,2,[Pro999]GhostMen,2066,0,1,1,2,50.0%,1h
42158,2,CrispyGT,2066,96,1,2,3,33.3%,1h
42158,2,Tronks,2066,30,1,2,3,33.3%,1h
42158,1,gonzalo,2066,0,1,7,8,12.5%,6m
42158,2,AKillman,2066,0,0,2,2,0.0%,16m
42158,3,Jarsoft,2066,0,0,2,2,0.0%,20m
42180,1,[Nu]kilcupcake,2065,1689,221,234,455,48.6%,52m
42180,1,RanZernoX,2065,1192,205,214,419,48.9%,1h
42180,2,SirDumpsalot,2065,881,189,220,409,46.2%,29m
42180,1,KUSH,2065,1489,104,107,211,49.3%,18m
42180,3,AMA,2065,1475,70,85,155,45.2%,3h
42180,2,spreezy,2065,1388,62,64,126,49.2%,33m
42180,1,MajinSaha,2065,1126,38,49,87,43.7%,1h
42180,1,speedo,2065,910,30,39,69,43.5%,3h
42180,2,OnFleek,2065,682,25,24,49,51.0%,49m
42180,2,BelowAvg,2065,373,24,10,34,70.6%,15m
42180,2,ZayMassakre,2065,596,22,28,50,44.0%,33m
42180,2,Yone,2065,599,21,21,42,50.0%,1h
42180,2,Noobgamerz,2065,502,19,17,36,52.8%,59m
42180,2,RAYBAN,2065,464,18,13,31,58.1%,8m
42180,2,kini,2065,463,16,14,30,53.3%,60m
42180,2,gaminggamer,2065,304,11,10,21,52.4%,49m
42180,2,SHEIKH,2065,252,9,18,27,33.3%,20m
42180,1,Oversear,2065,237,5,2,7,71.4%,7m
42180,2,[420SC2]Towel,2065,124,4,6,10,40.0%,23m
42180,2,[SYNDCT]mantis,2065,64,2,2,4,50.0%,5m
42180,2,GFZ,2065,60,2,7,9,22.2%,11m
42180,2,RCable,2065,0,1,0,1,100.0%,3h
42180,2,RabidPanzer,2065,46,1,2,3,33.3%,1h
42180,2,[Sune]Rompehuesos,2065,0,1,3,4,25.0%,1h
42180,2,SeungguLee,2065,48,1,7,8,12.5%,1h
42180,1,KEONIG,2065,42,1,13,14,7.1%,1h
42180,2,arkfire,2065,0,0,1,1,0.0%,3h
42180,2,balolang,2065,0,0,1,1,0.0%,1h
42180,2,[XTGZ]geo,2065,0,0,2,2,0.0%,7m
42180,2,SingyuChan,2065,0,0,5,5,0.0%,8m
42210,2,Ding,2064,826,34,27,61,55.7%,3h
42210,1,Fog,2064,882,27,37,64,42.2%,3h
42210,1,Rocinante,2064,490,25,31,56,44.6%,3h
42210,2,TERRANWEED,2064,386,14,22,36,38.9%,1h
42210,2,Neku,2064,167,12,6,18,66.7%,30m
42210,2,[Zambo]GONZ,2064,315,12,9,21,57.1%,15m
42210,2,Blaik,2064,221,8,9,17,47.1%,3h
42210,2,Aulah,2064,186,7,6,13,53.8%,15m
42210,1,BadAtGame,2064,242,6,20,26,23.1%,55m
42210,1,[MCGBRO]Sam,2064,144,5,11,16,31.2%,7m
42210,2,[MADPAM]Franco,2064,66,3,3,6,50.0%,3h
42210,2,xSkyEater,2064,60,2,3,5,40.0%,11m
42210,2,LIKASOHMBODE,2064,0,1,0,1,100.0%,3h
42210,2,Volucian,2064,0,1,4,5,20.0%,1h
42210,2,LilBrist,2064,30,1,5,6,16.7%,15m
42210,1,BetterThanU,2064,48,1,5,6,16.7%,3h
42210,2,[ThCz]Wraith,2064,44,1,6,7,14.3%,3h
42210,2,Quant,2064,30,1,6,7,14.3%,41m
42210,2,[LgnTDS]yumRiCExP,2064,0,0,1,1,0.0%,60m
42210,1,vovi,2064,0,0,1,1,0.0%,1h
42210,2,[Vtta]MadaraUchiha,2064,0,0,2,2,0.0%,11m
42210,2,outsider,2064,0,0,5,5,0.0%,19m
42210,2,PoseidonRage,2064,0,0,5,5,0.0%,1h
42210,2,Ray,2064,0,0,5,5,0.0%,1h
42234,1,KingDizzle,2063,1464,202,206,408,49.5%,37m
42234,1,Wandros,2063,1613,94,120,214,43.9%,1h
42234,2,[Blawuk]Praetorian,2063,892,54,53,107,50.5%,41m
42234,2,TOPTEEN,2063,755,31,24,55,56.4%,56m
42234,2,MrKoreXD,2063,692,24,22,46,52.2%,3h
42234,2,commander,2063,414,15,24,39,38.5%,1h
42234,2,adnsaitama,2063,383,11,20,31,35.5%,3h
42234,2,[Pibo3]SwarmINC,2063,235,10,5,15,66.7%,16m
42234,2,Micront,2063,232,7,13,20,35.0%,3h
42234,2,[SKGS]Elydan,2063,150,6,8,14,42.9%,3h
42234,1,Yenitze,2063,94,3,9,12,25.0%,22m
42234,2,charizar,2063,60,2,4,6,33.3%,41m
42234,2,Astird,2063,0,1,0,1,100.0%,3h
42234,1,Supreme,2063,0,1,0,1,100.0%,3h
42234,2,Dieselnutter,2063,88,1,1,2,50.0%,57m
42234,2,Minimecha,2063,0,1,3,4,25.0%,1h
42234,2,Mush,2063,96,1,6,7,14.3%,16m
42234,2,TheShowSC,2063,0,0,1,1,0.0%,7m
42234,3,triplelattes,2063,0,0,2,2,0.0%,1h
42234,3,FrontierNsmo,2063,0,0,2,2,0.0%,34m
42234,1,AlexPaul,2063,0,0,4,4,0.0%,10m
42234,2,Pablus,2063,0,0,6,6,0.0%,50m
42256,1,alien,2062,1686,238,270,508,46.9%,1h
42256,2,ARich,2062,1371,66,68,134,49.3%,33m
42256,2,Joseph,2062,335,38,40,78,48.7%,15m
42256,2,Craigcellent,2062,608,32,29,61,52.5%,22m
42256,2,ARGET,2062,432,16,19,35,45.7%,1h
42256,1,[SxyMxN]Sants,2062,485,15,23,38,39.5%,1h
42256,2,SALOHCIN,2062,228,10,19,29,34.5%,1h
42256,2,EDGAR,2062,288,8,9,17,47.1%,23m
42256,2,[ALTF04]zeuzgrande,2062,274,7,7,14,50.0%,32m
42256,2,strangel,2062,171,5,3,8,62.5%,29m
42256,1,tossomesalad,2062,174,4,4,8,50.0%,41m
42256,1,JoAnVeMaAn,2062,200,4,7,11,36.4%,3h
42256,2,Humor,2062,0,3,3,6,50.0%,3h
42256,2,fedido,2062,88,3,3,6,50.0%,3h
42256,2,BattlePants,2062,93,1,1,2,50.0%,1h
42256,2,Zelron,2062,30,1,2,3,33.3%,3h
42256,2,[dBASED]Artmageddon,2062,30,1,5,6,16.7%,3h
42256,2,Ender,2062,0,1,6,7,14.3%,1h
42256,2,DanimalBbot,2062,30,1,6,7,14.3%,1h
42256,2,TommyG,2062,0,0,1,1,0.0%,38m
42256,1,EDGARDO,2062,0,0,3,3,0.0%,1h
42256,3,PacoMX,2062,0,0,5,5,0.0%,26m
42256,2,RobertHuff,2062,0,0,5,5,0.0%,34m
42256,1,ChronoTGK,2062,0,0,7,7,0.0%,1h
42280,2,[OPMs]GrumpyPants,2061,1641,114,116,230,49.6%,49m
42280,1,LYBERTHBMD,2061,1656,98,106,204,48.0%,52m
42280,2,ChampCheese,2061,782,33,36,69,47.8%,8m
42280,2,Wohooo,2061,440,30,38,68,44.1%,3h
42280,2,mediclogi,2061,596,23,25,48,47.9%,16m
42280,1,[bfBE]ATMmachine,2061,560,23,30,53,43.4%,24m
42280,2,[felpa]CuunooPlay,2061,376,12,14,26,46.2%,37m
42280,2,Dire,2061,172,7,9,16,43.8%,32m
42280,2,Xowu,2061,214,6,6,12,50.0%,3h
42280,2,Daniel,2061,148,6,7,13,46.2%,3h
42280,3,Anthony,2061,159,5,4,9,55.6%,51m
42280,1,asderg,2061,164,5,14,19,26.3%,3h
42280,2,stevu,2061,136,4,1,5,80.0%,50m
42280,1,[LAJ]john,2061,0,4,7,11,36.4%,1h
42280,1,steadyeddy,2061,165,4,13,17,23.5%,45m
42280,3,gubby,2061,30,3,9,12,25.0%,1h
42280,1,[HotRod]Silverscorp,2061,76,3,9,12,25.0%,1h
42280,3,AzComBaT,2061,30,3,9,12,25.0%,1h
42280,2,Sacari,2061,88,2,0,2,100.0%,1h
42280,2,DonComedia,2061,60,2,3,5,40.0%,15m
42280,1,Kingryno,2061,48,2,8,10,20.0%,1h
42280,2,Jimmy,2061,0,1,4,5,20.0%,1h
42280,2,[SHVDOW]Slowrage,2061,0,1,4,5,20.0%,3h
42280,1,Flyener,2061,0,1,6,7,14.3%,25m
42280,2,Airtight,2061,0,0,1,1,0.0%,3h
42280,2,ConflictFive,2061,0,0,1,1,0.0%,1h
42280,3,heyguyssoooo,2061,0,0,2,2,0.0%,26m
42280,3,tobz,2061,0,0,4,4,0.0%,26m
42280,2,Noodles,2061,0,0,6,6,0.0%,3h
42309,2,Zetho,2060,1297,118,114,232,50.9%,3h
42309,2,alex,2060,1432,54,62,116,46.6%,60m
42309,2,Patricio,2060,1033,41,41,82,50.0%,3h
42309,1,ChickenGODD,2060,1010,32,42,74,43.2%,3h
42309,3,Aramos,2060,634,32,47,79,40.5%,14m
42309,1,oMeXiCaNxX,2060,306,9,15,24,37.5%,3h
42309,2,pha,2060,205,8,2,10,80.0%,59m
42309,2,[CaLiCo]BraxisNow,2060,186,6,11,17,35.3%,3h
42309,2,darkslayers,2060,197,6,12,18,33.3%,1h
42309,3,Glico,2060,134,6,16,22,27.3%,1h
42309,2,POXI,2060,164,5,13,18,27.8%,3h
42309,2,BobbyShaftoe,2060,166,4,11,15,26.7%,1h
42309,2,Schwardix,2060,30,2,1,3,66.7%,3h
42309,2,SlavojZizek,2060,30,2,1,3,66.7%,3h
42309,2,Skeight,2060,42,2,2,4,50.0%,1h
42309,2,Ultra,2060,60,2,3,5,40.0%,50m
42309,3,Archangel,2060,95,2,8,10,20.0%,3h
42309,2,Darkhorse,2060,0,1,0,1,100.0%,1h
42309,2,LaidToRest,2060,0,1,4,5,20.0%,1h
42309,2,BOPE,2060,0,1,4,5,20.0%,3h
42309,2,Katz,2060,48,1,7,8,12.5%,7m
42309,3,Daddy,2060,0,1,8,9,11.1%,1h
42309,2,[dixaxo]SaTzo,2060,0,0,1,1,0.0%,1h
42309,3,Vrixen,2060,0,0,2,2,0.0%,3h
42309,1,Lucas,2060,0,0,2,2,0.0%,7m
42309,3,tao,2060,0,0,5,5,0.0%,26m
42309,2,Kristhull,2060,0,0,5,5,0.0%,3h
42336,2,dirtydave,2059,1602,136,146,282,48.2%,5m
42336,1,Jspike,2059,1650,72,81,153,47.1%,3h
42336,1,FoxDie,2059,1190,50,47,97,51.5%,9m
42336,2,Mikemg,2059,595,28,17,45,62.2%,11m
42336,2,OneOneSeven,2059,738,27,33,60,45.0%,1h
42336,2,[MLTN]Mattarayer,2059,493,20,22,42,47.6%,34m
42336,2,SrMinecarlos,2059,258,8,6,14,57.1%,1h
42336,2,JBOMB,2059,208,7,11,18,38.9%,3h
42336,1,Vinex,2059,217,6,10,16,37.5%,3h
42336,2,popote,2059,183,5,6,11,45.5%,1h
42336,2,Yuuta,2059,169,5,9,14,35.7%,3h
42336,2,[Pig2]BarkingSpydr,2059,90,4,4,8,50.0%,32m
42336,2,GaWarMachine,2059,60,2,2,4,50.0%,3h
42336,2,JackBoy,2059,0,1,0,1,100.0%,1h
42336,2,SanKeHa,2059,0,1,4,5,20.0%,11m
42336,2,DarthVador,2059,0,1,4,5,20.0%,49m
42336,1,SyKoYoshi,2059,32,1,5,6,16.7%,17m
42336,1,unavailable,2059,0,1,5,6,16.7%,8m
42336,2,KingJasar,2059,0,0,2,2,0.0%,16m
42336,2,aladepollo,2059,73,0,3,3,0.0%,1h
42356,2,zigmmung,2058,1604,302,360,662,45.6%,34m
42356,2,GANDER,2058,980,138,140,278,49.6%,1h
42356,2,Jawesome,2058,1601,138,144,282,48.9%,1h
42356,1,max,2058,1346,61,68,129,47.3%,47m
42356,1,Ratcano,2058,1542,61,73,134,45.5%,39m
42356,2,DrackonHntr,2058,1275,52,52,104,50.0%,33m
42356,1,[FatMom]Unerwunscht,2058,1357,47,50,97,48.5%,3h
42356,2,Leinad,2058,998,34,41,75,45.3%,56m
42356,2,[FyH]QUEEN,2058,754,24,30,54,44.4%,60m
42356,1,Napal,2058,389,13,18,31,41.9%,1h
42356,2,Wangandtangz,2058,180,7,13,20,35.0%,34m
42356,2,Spray,2058,214,6,6,12,50.0%,10m
42356,2,Tuena,2058,112,3,4,7,42.9%,1h
42356,2,[meTREE]TreeIsMe,2058,73,3,6,9,33.3%,3h
42356,2,Federcio,2058,96,2,3,5,40.0%,1h
42356,2,Bones,2058,0,1,3,4,25.0%,1h
42356,2,Diefenbunker,2058,30,1,11,12,8.3%,1h
42356,2,[GDPx]oPkongasaur,2058,0,0,1,1,0.0%,38m
42356,2,DevilsReject,2058,0,0,1,1,0.0%,19m
42375,3,khal,2057,335,41,55,96,42.7%,1h
42375,1,IronBlade,2057,931,39,47,86,45.3%,3h
42375,1,RaoulDuke,2057,608,19,28,47,40.4%,3h
42375,2,Starlord,2057,351,18,17,35,51.4%,33m
42375,2,RAMX,2057,398,16,9,25,64.0%,38m
42375,1,[Meek]JhoeRY,2057,475,15,25,40,37.5%,1h
42375,1,Marko,2057,364,12,13,25,48.0%,50m
42375,2,BattleCraig,2057,348,11,17,28,39.3%,3h
42375,2,KingFish,2057,270,9,13,22,40.9%,3h
42375,2,PANDASALVAJE,2057,191,8,12,20,40.0%,3h
42375,1,xprincesax,2057,179,7,12,19,36.8%,17m
42375,1,TwoStep,2057,48,3,8,11,27.3%,3h
42375,2,[InGt]StarFleetDK,2057,30,2,3,5,40.0%,3h
42375,2,BlackSky,2057,94,1,4,5,20.0%,3h
42375,3,Adam,2057,0,0,5,5,0.0%,1h
42375,3,MasterChef,2057,0,0,5,5,0.0%,1h
42391,2,Starkiller,2056,1602,150,156,306,49.0%,19m
42391,2,[Hongos]XLS,2056,1542,103,111,214,48.1%,3h
42391,2,RainbowPony,2056,748,38,31,69,55.1%,3h
42391,2,yoyoslow,2056,654,38,36,74,51.4%,1h
42391,2,janzsen,2056,785,32,35,67,47.8%,3h
42391,1,stmarcellus,2056,748,26,34,60,43.3%,3h
42391,2,Rammlied,2056,484,17,14,31,54.8%,1h
42391,2,[KRAFTT]Chamelio,2056,230,9,4,13,69.2%,3h
42391,2,DokBane,2056,218,8,10,18,44.4%,25m
42391,2,Nog,2056,180,7,6,13,53.8%,26m
42391,2,Maguitoleo,2056,188,7,7,14,50.0%,1h
42391,1,KonSpiral,2056,277,7,12,19,36.8%,3h
42391,1,Midnight,2056,209,5,11,16,31.2%,3h
42391,1,[matar]Player,2056,237,4,6,10,40.0%,1h
42391,1,Stompjonson,2056,186,3,2,5,60.0%,1h
42391,2,TERRAN,2056,90,3,3,6,50.0%,1h
42391,2,[1vsM]colombiawar,2056,64,3,7,10,30.0%,3h
42391,2,DARKERG,2056,62,2,4,6,33.3%,34m
42391,3,sksk,2056,30,2,7,9,22.2%,1h
42391,2,FarkQue,2056,0,1,0,1,100.0%,1h
42391,2,Onebrow,2056,0,1,2,3,33.3%,26m
42391,2,Tikure,2056,30,1,3,4,25.0%,34m
42391,2,BRUCIFER,2056,0,1,4,5,20.0%,1h
42391,2,SirNathaniel,2056,0,0,1,1,0.0%,8m
42391,2,Rintechi,2056,0,0,1,1,0.0%,51m
42391,3,TheCtrl,2056,0,0,5,5,0.0%,3h
42391,2,LUISINHO,2056,0,0,6,6,0.0%,58m
42418,3,twonethefor,2055,1492,225,300,525,42.9%,1h
42418,1,AldurLagger,2055,908,57,77,134,42.5%,33m
42418,2,will,2055,990,37,38,75,49.3%,50m
42418,2,YoUnGbeast,2055,714,28,34,62,45.2%,19m
42418,2,Jak,2055,660,23,25,48,47.9%,29m
42418,2,[danima]postpriori,2055,383,20,26,46,43.5%,34m
42418,2,MightyGandhi,2055,492,17,15,32,53.1%,3h
42418,1,LaJoya,2055,224,7,13,20,35.0%,1h
42418,2,rebellio,2055,148,6,3,9,66.7%,11m
42418,3,hammer,2055,202,6,16,22,27.3%,50m
42418,2,TerranRB,2055,155,5,2,7,71.4%,41m
42418,2,JDawg,2055,92,4,5,9,44.4%,1h
42418,2,JMaier,2055,44,3,6,9,33.3%,1h
42418,2,Terrano,2055,98,3,9,12,25.0%,3h
42418,2,samanticz,2055,88,2,0,2,100.0%,3h
42418,2,[Dozys]eduardoxl,2055,30,2,1,3,66.7%,5m
42418,2,SamuelUchiha,2055,112,2,2,4,50.0%,1h
42418,2,AbnerBR,2055,30,2,4,6,33.3%,25m
42418,1,[GOPERÚ]acechador,2055,48,2,4,6,33.3%,1h
42418,1,Twatt,2055,32,2,7,9,22.2%,3h
42418,2,sirelkevin,2055,0,1,1,2,50.0%,3h
42418,1,Leone,2055,0,1,3,4,25.0%,3h
42418,2,Villager,2055,0,1,4,5,20.0%,12m
42418,2,IINhumane,2055,0,1,4,5,20.0%,30m
42418,2,[1PA]GamerFix,2055,97,1,6,7,14.3%,3h
42418,1,BranX,2055,0,1,8,9,11.1%,28m
42418,2,luigriel,2055,0,0,1,1,0.0%,19m
42418,2,[MOBILE]Showtime,2055,0,0,2,2,0.0%,44m
42418,1,Jefte,2055,0,0,3,3,0.0%,3h
42418,2,Azzurri,2055,0,0,3,3,0.0%,1h
42418,2,zmackostroys,2055,0,0,5,5,0.0%,3h
42449,2,Bielski,2054,1494,76,85,161,47.2%,3h
42449,1,kukulkán,2054,1298,49,53,102,48.0%,39m
42449,2,Matonax,2054,629,25,21,46,54.3%,3h
42449,1,InfestedAbe,2054,732,23,32,55,41.8%,3h
42449,1,fryzie,2054,679,23,33,56,41.1%,29m
42449,2,[8kPLUS]RadarBoy,2054,346,9,26,35,25.7%,1h
42449,2,[TpIn]Bot,2054,224,8,6,14,57.1%,1h
42449,2,[TFTG]Markito,2054,200,8,9,17,47.1%,49m
42449,2,Digital,2054,60,3,6,9,33.3%,8m
42449,1,[Bento]Ivanovic,2054,74,3,8,11,27.3%,45m
42449,2,RacerX,2054,0,1,1,2,50.0%,3h
42449,2,Shaku,2054,30,1,1,2,50.0%,1h
42449,2,Davidheim,2054,0,1,3,4,25.0%,22m
42449,2,[edft]ZickieZickie,2054,97,1,3,4,25.0%,1h
42449,1,STRYKERFOOD,2054,0,1,8,9,11.1%,7m
42449,2,Nooob,2054,0,0,5,5,0.0%,34m
42449,3,[LTlord]KippaSaurio,2054,0,0,5,5,0.0%,3h
42449,3,Hito,2054,0,0,5,5,0.0%,46m
42449,2,Jock,2054,0,0,5,5,0.0%,33m
42468,2,Showstopper,2053,1538,158,167,325,48.6%,1h
42468,2,[TPGGXD]phoenix,2053,1418,125,134,259,48.3%,56m
42468,2,ICRAFT,2053,1546,122,124,246,49.6%,1h
42468,1,[ALLIN1]MocaMagic,2053,1606,87,84,171,50.9%,6m
42468,2,RazAlGhul,2053,1541,62,52,114,54.4%,34m
42468,2,[Doko]gomezprotoss,2053,1530,59,66,125,47.2%,16m
42468,2,yotrasho,2053,1041,41,38,79,51.9%,59m
42468,2,[LBanda]luxo,2053,376,35,25,60,58.3%,50m
42468,1,VillanFarT,2053,860,27,53,80,33.8%,27m
42468,2,SpiritPuno,2053,431,22,21,43,51.2%,34m
42468,1,Libro,2053,439,14,22,36,38.9%,48m
42468,2,WildCard,2053,95,12,15,27,44.4%,3h
42468,2,TigerFish,2053,319,11,8,19,57.9%,23m
42468,2,GHOST,2053,310,10,13,23,43.5%,1h
42468,2,thedoomedguy,2053,30,3,11,14,21.4%,1h
42468,1,yomammaisfat,2053,48,2,3,5,40.0%,3h
42468,3,DesertRabbit,2053,0,2,9,11,18.2%,1h
42468,2,burkburk,2053,30,1,1,2,50.0%,3h
42468,2,kingling,2053,93,1,2,3,33.3%,1h
42468,2,Madshamus,2053,0,0,1,1,0.0%,11m
42468,2,OvrDosedSyco,2053,0,0,1,1,0.0%,11m
42468,2,MasterGamer,2053,0,0,1,1,0.0%,51m
42468,3,CVO,2053,0,0,3,3,0.0%,3h
42468,3,Raz,2053,0,0,4,4,0.0%,1h
42468,2,Pappy,2053,0,0,5,5,0.0%,3h
42468,3,RaggedMime,2053,0,0,5,5,0.0%,27m
42494,1,Percy,2052,1601,240,245,485,49.5%,3h
42494,1,admiral,2052,1333,74,77,151,49.0%,15m
42494,2,Dave,2052,1356,49,58,107,45.8%,3h
42494,2,[3AM]MangoBango,2052,990,40,36,76,52.6%,34m
42494,2,Tspite,2052,654,23,31,54,42.6%,37m
42494,2,[ALL3N]Jimmyjammzz,2052,306,12,18,30,40.0%,3h
42494,3,Modoc,2052,279,10,15,25,40.0%,1h
42494,2,tee,2052,211,6,5,11,54.5%,49m
42494,2,SirPhobos,2052,135,3,6,9,33.3%,1h
42494,2,[neptun]Balzac,2052,74,2,5,7,28.6%,3h
42494,2,FenrirX,2052,0,1,0,1,100.0%,3h
42494,2,Allan,2052,30,1,2,3,33.3%,3h
42494,2,Jinglehiemer,2052,97,1,5,6,16.7%,3h
42494,2,xxMYMANxX,2052,30,1,6,7,14.3%,41m
42494,2,Braaaan,2052,0,1,7,8,12.5%,3h
42494,2,Micromat,2052,0,0,1,1,0.0%,3h
42494,2,BOSSNIACK,2052,0,0,1,1,0.0%,1h
42494,3,[toungy]Arbiter,2052,0,0,5,5,0.0%,20m
42494,3,Shotgunaces,2052,0,0,5,5,0.0%,3h
42494,3,Kepler,2052,0,0,5,5,0.0%,3h
42494,2,Minimal,2052,0,0,5,5,0.0%,34m
42494,2,Starlion,2052,0,0,6,6,0.0%,59m
42516,1,Inferno,2051,1581,108,104,212,50.9%,48m
42516,2,paco,2051,1600,108,117,225,48.0%,1h
42516,1,[KG73]Weedman,2051,1087,85,101,186,45.7%,1h
42516,1,MunsonRoyE,2051,1450,47,63,110,42.7%,23m
42516,2,Sandman,2051,841,36,27,63,57.1%,1h
42516,2,AndyBUM,2051,191,16,13,29,55.2%,3h
42516,1,TerranYouUp,2051,494,15,28,43,34.9%,1h
42516,2,DuTheSav,2051,279,11,7,18,61.1%,1h
42516,1,Will,2051,306,11,14,25,44.0%,48m
42516,2,LAMRAVRG,2051,236,8,11,19,42.1%,1h
42516,1,Lemon,2051,198,7,13,20,35.0%,1h
42516,1,Nekroz,2051,100,5,15,20,25.0%,1h
42516,2,Cademan,2051,114,4,5,9,44.4%,1h
42516,2,Carlomagno,2051,120,3,9,12,25.0%,3h
42516,2,Linarestube,2051,60,2,4,6,33.3%,38m
42516,2,QueenOfBases,2051,95,2,4,6,33.3%,3h
42516,2,[Zatra]ChinoBlack,2051,0,2,6,8,25.0%,3h
42516,2,Allenon,2051,0,1,0,1,100.0%,1h
42516,2,ocolrotcod,2051,30,1,1,2,50.0%,1h
42516,2,Zavin,2051,30,1,4,5,20.0%,38m
42516,2,BOOTYSWEAT,2051,0,0,1,1,0.0%,51m
42516,3,Pezpito,2051,0,0,5,5,0.0%,1h
42516,2,mithrandir,2051,0,0,6,6,0.0%,11m
42539,2,[SHorse]GLEON,2050,1525,73,73,146,50.0%,3h
42539,1,Mike,2050,1045,63,68,131,48.1%,43m
42539,2,Dammongolian,2050,532,18,24,42,42.9%,1h
42539,2,Charly,2050,356,16,6,22,72.7%,1h
42539,2,Phoenix,2050,418,16,24,40,40.0%,56m
42539,1,loosekannan,2050,236,7,17,24,29.2%,52m
42539,3,Mike,2050,90,5,14,19,26.3%,8m
42539,3,MemeMachine,2050,171,4,5,9,44.4%,6m
42539,2,destruptor,2050,133,3,0,3,100.0%,3h
42539,2,Toomral,2050,117,3,5,8,37.5%,8m
42539,2,JERBA,2050,67,3,5,8,37.5%,60m
42539,3,RAY,2050,59,3,12,15,20.0%,29m
42539,2,Aaronk,2050,30,2,1,3,66.7%,1h
42539,2,Pebaw,2050,44,2,8,10,20.0%,1h
42539,2,Agnostoman,2050,0,1,0,1,100.0%,3h
42539,1,FTCarnivore,2050,0,1,7,8,12.5%,1h
42539,1,Rouby,2050,0,0,2,2,0.0%,17m
42539,3,mateusresue,2050,0,0,5,5,0.0%,3h
42557,1,[IdArmy]CABLE,2049,785,108,113,221,48.9%,4m
42557,1,Noctrnal,2049,1535,65,84,149,43.6%,25m
42557,1,KatieCat,2049,1550,56,65,121,46.3%,3h
42557,2,CucaraChaCha,2049,1295,52,47,99,52.5%,17m
42557,2,ZikZero,2049,869,46,56,102,45.1%,1h
42557,2,MindofMimir,2049,578,29,25,54,53.7%,15m
42557,2,spaceman,2049,428,14,14,28,50.0%,3h
42557,2,Alex,2049,386,14,17,31,45.2%,3h
42557,2,CHEMO,2049,294,12,17,29,41.4%,33m
42557,2,WoodOreWheat,2049,235,8,8,16,50.0%,1h
42557,2,XxXLuisXxX,2049,266,8,13,21,38.1%,1h
42557,2,[EpicG]KIOBO,2049,200,7,9,16,43.8%,33m
42557,2,[CDNGA]Jackolantern,2049,144,6,5,11,54.5%,26m
42557,2,Kily,2049,147,5,6,11,45.5%,3h
42557,1,KoopaTroopa,2049,190,5,13,18,27.8%,1h
42557,2,thewolf,2049,90,4,4,8,50.0%,12m
42557,2,MERCURIO,2049,62,2,5,7,28.6%,34m
42557,2,Bazookajoe,2049,0,1,0,1,100.0%,3h
42557,2,IAR,2049,0,1,0,1,100.0%,3h
42557,2,dumbdavid,2049,30,1,2,3,33.3%,8m
42557,2,DearDeath,2049,0,1,3,4,25.0%,3h
42557,2,Faustino,2049,32,1,4,5,20.0%,38m
42557,1,Rjlupin,2049,0,1,4,5,20.0%,7m
42557,2,coolcool,2049,48,1,8,9,11.1%,1h
42557,2,olavop,2049,0,0,1,1,0.0%,3h
42557,2,josearenedo,2049,0,0,1,1,0.0%,1h
42557,2,Warbringer,2049,0,0,6,6,0.0%,1h
42557,2,Garrett,2049,0,0,6,6,0.0%,3h
42585,2,Heffy,2048,1624,114,113,227,50.2%,1h
42585,2,[CSWS]swordz,2048,601,68,71,139,48.9%,14m
42585,1,abitTOOsalty,2048,502,47,57,104,45.2%,59m
42585,2,Arabiasz,2048,853,46,55,101,45.5%,41m
42585,1,Tronic,2048,647,40,40,80,50.0%,43m
42585,2,[PERJPN]Toyo,2048,976,35,41,76,46.1%,1h
42585,2,HaydenW,2048,696,26,31,57,45.6%,3h
42585,2,kuro,2048,452,21,14,35,60.0%,1h
42585,2,altaed,2048,477,18,19,37,48.6%,59m
42585,2,Serral,2048,438,17,18,35,48.6%,3h
42585,2,SirPatetik,2048,279,15,7,22,68.2%,1h
42585,2,Kross,2048,242,9,12,21,42.9%,20m
42585,1,Pasta,2048,251,8,12,20,40.0%,37m
42585,1,[TuxG]CristoNath,2048,206,7,14,21,33.3%,60m
42585,2,[IKGI]eclaireur,2048,88,4,4,8,50.0%,8m
42585,2,RobTheBlack,2048,58,3,2,5,60.0%,3h
42585,2,Akamegy,2048,134,3,2,5,60.0%,1h
42585,1,[SC2B]FunkiDunki,2048,42,3,7,10,30.0%,38m
42585,1,UnOso,2048,36,2,8,10,20.0%,15m
42585,1,dysaber,2048,38,2,8,10,20.0%,24m
42585,2,Malidian,2048,0,1,0,1,100.0%,49m
42585,2,Kobra,2048,0,1,0,1,100.0%,58m
42585,2,terry,2048,0,1,0,1,100.0%,23m
42585,2,MaxRoentgen,2048,30,1,2,3,33.3%,1h
42585,2,Soudo,2048,88,1,2,3,33.3%,3h
42585,2,Starking,2048,48,1,5,6,16.7%,1h
42585,2,BØnK,2048,0,1,6,7,14.3%,3h
42585,2,Bob,2048,30,1,7,8,12.5%,3h
42585,2,jimmy,2048,0,0,1,1,0.0%,3h
42585,2,HenryMusho,2048,0,0,1,1,0.0%,3h
42585,2,jimmyazc,2048,0,0,1,1,0.0%,1h
42585,3,Nikulino,2048,0,0,1,1,0.0%,1h
42585,3,grimmreaper,2048,0,0,5,5,0.0%,35m
42618,2,sertaz,2047,1411,74,76,150,49.3%,1h
42618,2,RicanVibes,2047,1362,53,54,107,49.5%,22m
42618,2,Edge,2047,433,46,48,94,48.9%,3h
42618,1,Gauchoholic,2047,710,26,30,56,46.4%,1h
42618,2,Johann,2047,455,19,14,33,57.6%,1h
42618,2,Márcio,2047,396,15,11,26,57.7%,1h
42618,1,Sunsorrow,2047,366,13,19,32,40.6%,3h
42618,2,Slaughter,2047,178,6,8,14,42.9%,1h
42618,1,JagerEins,2047,202,5,5,10,50.0%,3h
42618,1,RODRIG,2047,94,4,10,14,28.6%,8m
42618,2,QuEWeZz,2047,94,3,0,3,100.0%,12m
42618,2,[VRGA]madmaddamon,2047,92,3,0,3,100.0%,1h
42618,2,GGamrrage,2047,0,3,2,5,60.0%,16m
42618,2,Raistlin,2047,134,3,9,12,25.0%,3h
42618,1,NightRaven,2047,0,2,7,9,22.2%,1h
42618,2,lowcandrew,2047,58,2,7,9,22.2%,3h
42618,1,BadCompany,2047,30,2,7,9,22.2%,3h
42618,1,Whishterak,2047,38,2,9,11,18.2%,3h
42618,1,achirawows,2047,0,1,1,2,50.0%,1h
42618,2,EXECUTOR,2047,46,1,1,2,50.0%,1h
42618,2,[PobSC]Setyury,2047,0,1,1,2,50.0%,1h
42618,2,[Dedez]MikhailTal,2047,97,1,2,3,33.3%,1h
42618,2,Erre,2047,73,1,2,3,33.3%,11m
42618,2,billy,2047,30,1,3,4,25.0%,1h
42618,1,annihilator,2047,97,1,4,5,20.0%,3h
42618,2,THEROCK,2047,0,1,4,5,20.0%,3h
42618,2,CarRamRod,2047,0,0,1,1,0.0%,1h
42618,2,CheetoPuffs,2047,0,0,1,1,0.0%,1h
42618,2,tomas,2047,0,0,5,5,0.0%,3h
42647,1,Michael,2046,1680,261,270,531,49.2%,1h
42647,2,Gavilan,2046,1521,106,110,216,49.1%,3h
42647,2,Asciiman,2046,395,93,101,194,47.9%,1h
42647,1,xXlBroZaylXx,2046,1582,89,99,188,47.3%,60m
42647,2,SugarWater,2046,681,30,13,43,69.8%,1h
42647,2,Miguel,2046,794,29,31,60,48.3%,1h
42647,2,AZTK,2046,742,26,32,58,44.8%,3h
42647,2,Nordhem,2046,552,25,15,40,62.5%,1h
42647,2,DagiPls,2046,625,24,21,45,53.3%,8m
42647,2,ZashA,2046,673,24,25,49,49.0%,34m
42647,3,knobby,2046,464,17,25,42,40.5%,15m
42647,2,guisult,2046,462,16,25,41,39.0%,1h
42647,2,OspreyPanzer,2046,328,11,9,20,55.0%,3h
42647,2,Warrior,2046,282,10,7,17,58.8%,1h
42647,3,CrisCHL,2046,234,9,25,34,26.5%,1h
42647,2,Burarum,2046,219,8,4,12,66.7%,44m
42647,3,JdInferno,2046,211,7,12,19,36.8%,1h
42647,2,cndnsinger,2046,195,5,4,9,55.6%,3h
42647,2,Zurkseas,2046,88,2,0,2,100.0%,33m
42647,3,kaos,2046,97,1,4,5,20.0%,43m
42647,2,BoyKamote,2046,0,1,6,7,14.3%,1h
42647,2,DixieNourmos,2046,0,0,1,1,0.0%,3h
42647,3,MauroMagic,2046,0,0,2,2,0.0%,46m
42647,3,[maSC]jose,2046,0,0,2,2,0.0%,40m
42647,3,[CRG]Elendil,2046,0,0,5,5,0.0%,1h
42647,2,Kanades,2046,0,0,6,6,0.0%,3h
42673,3,KnightAtlas,2045,1478,353,376,729,48.4%,3h
42673,1,KILLER,2045,578,34,34,68,50.0%,59m
42673,2,[KingSC]LRT,2045,678,27,22,49,55.1%,3h
42673,2,Ghost,2045,556,19,26,45,42.2%,49m
42673,1,HaunterX,2045,316,12,8,20,60.0%,3h
42673,2,IvanTorres,2045,362,12,13,25,48.0%,60m
42673,2,PiKappBro,2045,178,6,7,13,46.2%,34m
42673,2,PhyscoZealot,2045,197,5,7,12,41.7%,3h
42673,2,THG,2045,145,3,3,6,50.0%,1h
42673,1,Bagera,2045,96,3,10,13,23.1%,41m
42673,1,Tyy,2045,0,1,0,1,100.0%,1h
42673,2,dennis,2045,91,1,2,3,33.3%,3h
42673,1,parkparkbark,2045,0,1,7,8,12.5%,3h
42673,2,Hernan,2045,0,0,1,1,0.0%,31m
42673,1,Gamble,2045,0,0,1,1,0.0%,7m
42673,2,Leonid,2045,0,0,2,2,0.0%,1h
42673,2,austteam,2045,0,0,2,2,0.0%,36m
42673,3,[NWAro]TAVI,2045,0,0,3,3,0.0%,1h
42673,2,TaroTassadar,2045,0,0,5,5,0.0%,1h
42692,2,SWOLYxCAT,2044,1550,102,110,212,48.1%,22m
42692,1,bujo,2044,1442,92,102,194,47.4%,59m
42692,2,spinachdip,2044,1155,67,68,135,49.6%,33m
42692,2,[SWOU]TCanuto,2044,1553,62,64,126,49.2%,1h
42692,2,[xRtG]LEXCHAKRA,2044,984,43,25,68,63.2%,17m
42692,1,mrcrs,2044,1128,41,48,89,46.1%,3h
42692,2,Potato,2044,664,24,31,55,43.6%,3h
42692,3,NambuPower,2044,714,24,33,57,42.1%,1h
42692,1,ProblemChild,2044,337,11,10,21,52.4%,11m
42692,3,WarChief,2044,314,11,19,30,36.7%,50m
42692,2,NoéAO,2044,186,7,7,14,50.0%,1h
42692,2,Joe,2044,152,5,9,14,35.7%,5m
42692,2,drcakeman,2044,92,4,4,8,50.0%,12m
42692,1,ROX,2044,0,4,4,8,50.0%,3h
42692,2,Haru,2044,126,4,6,10,40.0%,37m
42692,2,Grillote,2044,107,4,9,13,30.8%,38m
42692,2,Socrates,2044,140,3,7,10,30.0%,17m
42692,1,Girotzu,2044,126,2,8,10,20.0%,44m
42692,2,LocalPerv,2044,0,1,1,2,50.0%,1h
42692,2,kirlanx,2044,95,1,6,7,14.3%,1h
42692,1,FABRICRAK,2044,0,1,7,8,12.5%,8m
42692,2,Yed,2044,0,0,1,1,0.0%,1h
42692,2,jolt,2044,0,0,1,1,0.0%,3h
42692,2,oferlong,2044,0,0,2,2,0.0%,26m
42692,1,Goose,2044,0,0,4,4,0.0%,8m
42692,2,[TheRs]powerful,2044,0,0,5,5,0.0%,1h
42692,2,Zollpy,2044,0,0,5,5,0.0%,26m
42692,2,[teamGG]FCStrapdUp,2044,0,0,6,6,0.0%,34m
42720,2,Charlemagne,2043,1201,129,131,260,49.6%,20m
42720,2,[TITODO]MrCoyote,2043,1569,93,101,194,47.9%,3h
42720,2,WeirdEyeKing,2043,754,32,26,58,55.2%,1h
42720,2,Heracles,2043,330,14,14,28,50.0%,1h
42720,2,[CULTPi]Darth,2043,376,13,15,28,46.4%,1h
42720,2,Tiargos,2043,346,12,14,26,46.2%,3h
42720,2,dinobooot,2043,208,8,8,16,50.0%,39m
42720,2,thorim,2043,266,7,11,18,38.9%,1h
42720,2,DarkMadrikal,2043,146,5,11,16,31.2%,33m
42720,2,Valkyrie,2043,139,4,5,9,44.4%,3h
42720,2,Plissken,2043,76,3,9,12,25.0%,1h
42720,2,PressEnter,2043,97,2,0,2,100.0%,3h
42720,2,Mazoute,2043,48,2,4,6,33.3%,50m
42720,2,Adiepd,2043,30,2,6,8,25.0%,57m
42720,2,healme,2043,124,2,8,10,20.0%,51m
42720,1,SoManyBees,2043,97,2,9,11,18.2%,3h
42720,2,TranAmndiel,2043,94,1,3,4,25.0%,1h
42720,3,Aragon,2043,0,1,6,7,14.3%,1h
42720,2,smartTurtle,2043,46,1,7,8,12.5%,1h
42720,1,DonBaztian,2043,0,1,7,8,12.5%,3h
42720,3,[No0Bs]ProStyle,2043,0,0,1,1,0.0%,1h
42720,2,BeBrave,2043,0,0,1,1,0.0%,1h
42720,2,LeadsPerfect,2043,0,0,1,1,0.0%,1h
42720,1,gianmarco,2043,0,0,1,1,0.0%,3h
42720,1,mudd,2043,0,0,4,4,0.0%,1h
42720,2,allseeingeye,2043,0,0,5,5,0.0%,39m
42720,2,Duffo,2043,0,0,6,6,0.0%,3h
42747,1,Marzhin,2042,1693,425,531,956,44.5%,3h
42747,2,WorldAvenger,2042,1582,126,134,260,48.5%,23m
42747,2,[std69]RawDawg,2042,875,75,75,150,50.0%,38m
42747,2,[Devol]MoonShadow,2042,1321,73,87,160,45.6%,3h
42747,1,Radius,2042,1124,56,69,125,44.8%,37m
42747,2,WarLard,2042,736,24,33,57,42.1%,1h
42747,2,[XpKAc]Francis,2042,341,13,17,30,43.3%,1h
42747,2,Sphinxlauta,2042,322,12,11,23,52.2%,41m
42747,2,LoKeFiGhT,2042,290,10,14,24,41.7%,1h
42747,1,[aIien]Kit,2042,201,5,4,9,55.6%,46m
42747,2,Sweetie,2042,147,4,7,11,36.4%,1h
42747,2,[PsiSk]Robmelus,2042,121,2,3,5,40.0%,3h
42747,2,NightRaven,2042,62,2,7,9,22.2%,59m
42747,2,skidster,2042,181,2,8,10,20.0%,1h
42747,2,Defcon,2042,38,1,2,3,33.3%,1h
42747,2,Kyerion,2042,30,1,3,4,25.0%,3h
42747,2,onehrcleaner,2042,0,0,1,1,0.0%,1h
42747,2,DoubleSheep,2042,0,0,1,1,0.0%,33m
42747,3,Danaku,2042,0,0,4,4,0.0%,19m
42747,3,[FleetX]runawaysavvy,2042,0,0,5,5,0.0%,40m
42767,1,fury,2041,1698,327,352,679,48.2%,59m
42767,1,cristhianAC,2041,1392,125,140,265,47.2%,17m
42767,2,Cfster,2041,1615,123,132,255,48.2%,3h
42767,2,[maSC]MRGT,2041,1300,118,125,243,48.6%,1h
42767,2,spoogelocker,2041,1393,84,82,166,50.6%,50m
42767,2,Subterfuge,2041,1590,66,52,118,55.9%,1h
42767,2,buker,2041,1226,45,49,94,47.9%,1h
42767,2,huberhouse,2041,943,43,29,72,59.7%,1h
42767,2,Zancudo,2041,510,37,47,84,44.0%,3h
42767,2,SwampRat,2041,746,29,33,62,46.8%,3h
42767,2,MrNilsson,2041,384,26,26,52,50.0%,34m
42767,3,Peripoisis,2041,596,21,36,57,36.8%,34m
42767,2,JUCAYUSA,2041,410,16,13,29,55.2%,33m
42767,1,MergenDorge,2041,324,12,21,33,36.4%,53m
42767,2,[MORGUE]Ajindo,2041,140,10,7,17,58.8%,3h
42767,1,CASHFLOW,2041,330,9,23,32,28.1%,59m
42767,2,Sokuda,2041,194,7,8,15,46.7%,49m
42767,2,[LtNSL]Mento,2041,253,7,9,16,43.8%,33m
42767,2,pancakesmash,2041,176,6,13,19,31.6%,1h
42767,2,DDT,2041,130,5,1,6,83.3%,3h
42767,2,spartanIIVII,2041,155,5,2,7,71.4%,3h
42767,2,LukePhysics,2041,88,2,5,7,28.6%,17m
42767,1,Clem,2041,46,2,8,10,20.0%,8m
42767,2,Iro,2041,0,1,0,1,100.0%,1h
42767,2,Chigs,2041,0,1,1,2,50.0%,3h
42767,2,Kira,2041,88,1,1,2,50.0%,1h
42767,1,Zidjian,2041,48,1,1,2,50.0%,41m
42767,2,Arcand,2041,0,0,3,3,0.0%,3h
42767,2,[FaceVN]Lionheart,2041,0,0,6,6,0.0%,3h
42796,2,[DarkPG]Platino,2040,1619,172,163,335,51.3%,34m
42796,2,cometahalley,2040,1575,109,116,225,48.4%,33m
42796,2,westbricks,2040,1357,92,99,191,48.2%,3h
42796,1,kildabar,2040,1665,91,94,185,49.2%,3h
42796,1,Lych,2040,976,90,88,178,50.6%,3h
42796,2,Barleet,2040,1141,50,50,100,50.0%,44m
42796,2,Jitano,2040,537,39,36,75,52.0%,37m
42796,1,[CaMt]EdsonZb,2040,962,34,38,72,47.2%,1h
42796,2,ZERATULKJRS,2040,724,29,23,52,55.8%,3h
42796,2,Michh,2040,473,17,17,34,50.0%,1h
42796,2,MikeSpb,2040,316,11,16,27,40.7%,26m
42796,2,TheHolySock,2040,270,10,10,20,50.0%,1h
42796,1,[LCE]LexJauregui,2040,198,9,21,30,30.0%,3h
42796,2,giansa,2040,250,7,12,19,36.8%,33m
42796,1,autompne,2040,161,6,5,11,54.5%,3h
42796,2,Cyote,2040,127,4,4,8,50.0%,33m
42796,2,HouseKeeping,2040,114,4,6,10,40.0%,1h
42796,2,AOC,2040,134,4,11,15,26.7%,3h
42796,2,Kuozz,2040,130,3,4,7,42.9%,3h
42796,2,Monsta,2040,102,2,1,3,66.7%,1h
42796,2,[Tehs]killer,2040,102,2,2,4,50.0%,3h
42796,2,[furros]Kayfox,2040,30,2,3,5,40.0%,20m
42796,2,Chuckster,2040,58,2,4,6,33.3%,3h
42796,2,Jokio,2040,46,2,6,8,25.0%,7m
42796,2,PtoW,2040,67,2,8,10,20.0%,1h
42796,2,RONALDO,2040,0,1,0,1,100.0%,3h
42796,2,daimremREWES,2040,0,1,0,1,100.0%,33m
42796,2,Millisend,2040,0,1,6,7,14.3%,41m
42796,2,MarcusVader,2040,0,1,7,8,12.5%,58m
42796,1,JASON,2040,0,1,7,8,12.5%,7m
42796,1,NvidiaYY,2040,0,1,8,9,11.1%,3h
42796,1,Conman,2040,40,1,11,12,8.3%,3h
42796,2,MHATIUS,2040,0,0,1,1,0.0%,38m
42796,2,PELE,2040,0,0,2,2,0.0%,1h
42796,2,[ohMYES]Red,2040,0,0,5,5,0.0%,1h
42796,2,fabian,2040,0,0,5,5,0.0%,31m
42796,2,JLBlaze,2040,0,0,6,6,0.0%,1h
42796,2,Iori,2040,0,0,6,6,0.0%,50m
42834,2,[NRDWRS]Fedorovna,2039,1380,57,59,116,49.1%,1h
42834,2,[K3oudy]LUKAS,2039,728,30,30,60,50.0%,20m
42834,2,TryAgain,2039,704,26,23,49,53.1%,5m
42834,2,[Vtta]diegodavila,2039,549,22,16,38,57.9%,1h
42834,2,donerman,2039,564,21,21,42,50.0%,3h
42834,2,wedawn,2039,544,20,19,39,51.3%,1h
42834,2,Faco,2039,428,16,18,34,47.1%,3h
42834,2,Pull,2039,444,15,21,36,41.7%,34m
42834,2,bashapotato,2039,252,12,3,15,80.0%,3h
42834,2,ERROR,2039,231,8,5,13,61.5%,57m
42834,2,TwoDeuce,2039,200,8,12,20,40.0%,8m
42834,2,AmateurHour,2039,143,5,3,8,62.5%,3h
42834,2,Dirbles,2039,190,5,5,10,50.0%,3h
42834,2,[Meuuhh]MadHydra,2039,134,3,3,6,50.0%,34m
42834,2,LosChurros,2039,163,3,4,7,42.9%,1h
42834,2,pitbull,2039,106,3,11,14,21.4%,1h
42834,2,grecia,2039,0,2,3,5,40.0%,3h
42834,2,byDiego,2039,0,2,3,5,40.0%,34m
42834,3,Zarathos,2039,42,2,4,6,33.3%,1h
42834,2,kijijifordik,2039,0,2,4,6,33.3%,3h
42834,1,[FL9]tufanG,2039,94,2,8,10,20.0%,3h
42834,3,[ALxG]ALphaProdigy,2039,95,2,9,11,18.2%,15m
42834,2,nizslaugter,2039,30,1,2,3,33.3%,41m
42834,1,FurtMrtvej,2039,46,1,4,5,20.0%,10m
42834,2,Baut,2039,88,1,6,7,14.3%,1h
42834,1,lylou,2039,0,1,7,8,12.5%,39m
42834,2,Jamaicanbcn,2039,0,0,1,1,0.0%,34m
42834,2,terran,2039,0,0,1,1,0.0%,23m
42834,2,Ilucius,2039,0,0,2,2,0.0%,31m
42834,2,Cymbol,2039,0,0,3,3,0.0%,27m
42864,2,ArbyelBravo,2038,1580,189,198,387,48.8%,1h
42864,2,jforts,2038,1512,161,169,330,48.8%,14m
42864,1,victor,2038,1687,96,110,206,46.6%,52m
42864,2,lim,2038,1404,78,88,166,47.0%,3h
42864,1,OperadorX,2038,878,64,65,129,49.6%,29m
42864,1,Shesha,2038,654,26,34,60,43.3%,3h
42864,1,IIIIIIIIIIII,2038,467,18,24,42,42.9%,1h
42864,2,paz,2038,212,16,16,32,50.0%,38m
42864,2,[LOHd]BigPWNer,2038,311,15,17,32,46.9%,38m
42864,2,Swampton,2038,392,14,18,32,43.8%,44m
42864,2,molty,2038,484,14,23,37,37.8%,1h
42864,2,Luis,2038,376,13,12,25,52.0%,1h
42864,1,JENAAL,2038,267,8,5,13,61.5%,1h
42864,1,Spyder,2038,234,6,13,19,31.6%,53m
42864,2,ipster,2038,154,5,10,15,33.3%,1h
42864,1,GlhfiloveYou,2038,144,3,1,4,75.0%,53m
42864,2,TonyBravo,2038,64,3,5,8,37.5%,37m
42864,2,BlessThyNoob,2038,60,2,4,6,33.3%,3h
42864,2,Chilldemian,2038,97,2,8,10,20.0%,3h
42864,2,Sheogorath,2038,0,1,0,1,100.0%,44m
42864,2,[RiftSS]Arrowblade,2038,0,1,0,1,100.0%,50m
42864,2,[KSRP]Shmeegledork,2038,0,1,1,2,50.0%,3h
42864,2,Valkhan,2038,0,1,3,4,25.0%,19m
42864,2,niennienpein,2038,30,1,6,7,14.3%,33m
42864,2,Sinan,2038,0,0,1,1,0.0%,8m
42864,2,bosslife,2038,0,0,3,3,0.0%,17m
42864,2,franco,2038,0,0,4,4,0.0%,3h
42864,2,cooon,2038,0,0,6,6,0.0%,1h
42864,2,[NOAFK]VampirTurtle,2038,0,0,7,7,0.0%,36m
42893,2,joe,2037,1100,78,71,149,52.3%,3h
42893,2,Arjun,2037,307,50,47,97,51.5%,1h
42893,2,Ponyo,2037,760,25,34,59,42.4%,1h
42893,2,[TheEdi]Terranse,2037,514,17,31,48,35.4%,3h
42893,2,PEEpee,2037,354,13,12,25,52.0%,60m
42893,2,[JINSI]Tatagame,2037,239,10,7,17,58.8%,1h
42893,1,AwesomeAusty,2037,300,10,17,27,37.0%,1h
42893,2,[TY4GG]MadMario,2037,0,3,4,7,42.9%,3h
42893,2,SMD,2037,102,2,2,4,50.0%,32m
42893,1,IceFox,2037,76,2,10,12,16.7%,3h
42893,2,RingMaster,2037,0,1,2,3,33.3%,57m
42893,2,langostino,2037,0,1,2,3,33.3%,23m
42893,2,Angell,2037,46,1,3,4,25.0%,26m
42893,2,[8BB]aqueronte,2037,0,1,4,5,20.0%,60m
42893,2,DimebagOz,2037,30,1,4,5,20.0%,1h
42893,2,Brad,2037,30,1,4,5,20.0%,1h
42893,2,Stahlen,2037,0,0,1,1,0.0%,49m
42893,2,Leowalls,2037,0,0,2,2,0.0%,33m
42893,2,WDNMD,2037,0,0,2,2,0.0%,32m
42893,3,VoidWraith,2037,0,0,5,5,0.0%,1h
42893,3,gigioster,2037,0,0,5,5,0.0%,35m
42893,2,ELGGNOMAS,2037,0,0,5,5,0.0%,1h
42915,1,Cobain,2036,1664,117,125,242,48.3%,3h
42915,1,MACMIKE,2036,1660,76,92,168,45.2%,3h
42915,1,EricTheRed,2036,987,57,58,115,49.6%,44m
42915,1,picatrix,2036,722,41,48,89,46.1%,27m
42915,2,Lunchpail,2036,764,31,30,61,50.8%,23m
42915,2,SpaceBlock,2036,668,23,30,53,43.4%,26m
42915,2,[BW7]secuencia,2036,327,11,18,29,37.9%,60m
42915,2,[xDYEx]chad,2036,177,5,4,9,55.6%,3h
42915,2,styrako,2036,146,5,6,11,45.5%,34m
42915,2,Zhabi,2036,138,3,2,5,60.0%,26m
42915,1,perez,2036,193,3,5,8,37.5%,1h
42915,2,[aq]Dankrupt,2036,102,3,6,9,33.3%,3h
42915,2,DuneRunner,2036,126,3,10,13,23.1%,1h
42915,2,Rascal,2036,88,2,0,2,100.0%,5m
42915,2,Saphron,2036,30,2,6,8,25.0%,23m
42915,2,stunna,2036,120,2,8,10,20.0%,8m
42915,1,timsah,2036,48,1,1,2,50.0%,10m
42915,2,HowardRoark,2036,0,1,2,3,33.3%,3h
42915,2,[ChLife]ShadowKernel,2036,30,1,2,3,33.3%,3h
42915,2,Falcon,2036,36,1,2,3,33.3%,3h
42915,2,Maxwoodhouse,2036,0,1,4,5,20.0%,26m
42915,2,SeventyFU,2036,30,1,4,5,20.0%,3h
42915,2,[ROT3K]XgralduquexX,2036,30,1,6,7,14.3%,56m
42915,1,[BWO]LostCause,2036,0,1,8,9,11.1%,12m
42915,2,MOOFUS,2036,0,0,1,1,0.0%,3h
42915,3,AuntSally,2036,0,0,3,3,0.0%,1h
42915,2,LAWZ,2036,0,0,5,5,0.0%,23m
42915,3,destroyer,2036,0,0,5,5,0.0%,35m
42915,2,DEGSTOYS,2036,0,0,6,6,0.0%,1h
42944,3,WAP,2035,664,77,60,137,56.2%,1h
42944,2,mrdestiny,2035,1071,43,48,91,47.3%,15m
42944,2,GLNoobHF,2035,778,30,31,61,49.2%,60m
42944,2,Mikey,2035,540,22,21,43,51.2%,1h
42944,2,fsc,2035,359,21,30,51,41.2%,34m
42944,2,FaceBones,2035,531,19,21,40,47.5%,3h
42944,1,Bergas,2035,263,15,24,39,38.5%,1h
42944,2,VajambaJuice,2035,194,10,8,18,55.6%,3h
42944,2,lorikyo,2035,216,7,11,18,38.9%,42m
42944,2,[CHWABO]SIUL,2035,193,6,5,11,54.5%,22m
42944,2,BouncyBear,2035,181,6,6,12,50.0%,3h
42944,1,Lilgyboi,2035,281,6,7,13,46.2%,3h
42944,2,Skyra,2035,90,4,4,8,50.0%,1h
42944,2,SunTzu,2035,145,3,2,5,60.0%,1h
42944,1,DonDolken,2035,143,3,9,12,25.0%,48m
42944,2,GeneralJim,2035,97,2,8,10,20.0%,26m
42944,2,Horizon,2035,160,2,11,13,15.4%,59m
42944,2,artyom,2035,0,1,0,1,100.0%,1h
42944,2,[RomX]destroyer,2035,44,1,2,3,33.3%,1h
42944,2,Console,2035,30,1,2,3,33.3%,3h
42944,2,Rosharchk,2035,30,1,3,4,25.0%,31m
42944,2,Rakzo,2035,0,0,1,1,0.0%,3h
42944,2,[Wc3GGL]bredrer,2035,0,0,3,3,0.0%,41m
42944,3,Peaches,2035,0,0,5,5,0.0%,26m
42944,2,arraes,2035,0,0,5,5,0.0%,59m
42944,2,Zyos,2035,0,0,6,6,0.0%,1h
42944,2,Trewidant,2035,0,0,7,7,0.0%,1h
42944,1,[ACSS]Petrocules,2035,0,0,11,11,0.0%,3h
42972,3,brothermonk,2034,1499,141,155,296,47.6%,36m
42972,2,Aleksanta,2034,737,43,37,80,53.8%,5m
42972,2,[Gylos]louis,2034,1190,43,48,91,47.3%,3h
42972,2,OptimusJim,2034,832,33,51,84,39.3%,8m
42972,1,walker,2034,886,32,38,70,45.7%,3h
42972,2,Greengato,2034,520,29,29,58,50.0%,3h
42972,2,[nieBla]Skull,2034,524,24,9,33,72.7%,3h
42972,2,clock,2034,523,21,25,46,45.7%,3h
42972,2,[XpKAc]BJÓ,2034,377,14,9,23,60.9%,3h
42972,1,Adep,2034,377,11,17,28,39.3%,3h
42972,1,felo,2034,290,8,18,26,30.8%,1h
42972,2,[UAK]SmokingZerg,2034,182,6,13,19,31.6%,14m
42972,1,Plasmonic,2034,247,6,13,19,31.6%,3h
42972,1,LtDan,2034,143,4,6,10,40.0%,1h
42972,2,infectedben,2034,120,4,10,14,28.6%,5m
42972,2,[HØST]Vitorino,2034,108,3,0,3,100.0%,3h
42972,2,Iviuxs,2034,112,3,1,4,75.0%,3h
42972,3,DWandSons,2034,0,3,2,5,60.0%,1h
42972,1,Zafner,2034,143,3,13,16,18.8%,3h
42972,2,Snakob,2034,137,2,2,4,50.0%,1h
42972,2,RumNCoke,2034,60,2,4,6,33.3%,1h
42972,2,birby,2034,0,1,0,1,100.0%,1h
42972,1,drago,2034,88,1,4,5,20.0%,4m
42972,1,Plastiko,2034,0,1,8,9,11.1%,8m
42972,1,Raphael,2034,0,0,1,1,0.0%,7m
42972,2,Damian,2034,0,0,1,1,0.0%,8m
42972,2,Zayres,2034,0,0,2,2,0.0%,30m
42972,2,SlimWhitman,2034,0,0,3,3,0.0%,1h
42972,3,Chill,2034,0,0,5,5,0.0%,3h
42972,2,[1earth]Zchristophe,2034,0,0,6,6,0.0%,60m
43002,2,Krosxever,2033,1393,109,125,234,46.6%,34m
43002,2,Warman,2033,1385,51,51,102,50.0%,34m
43002,2,Rustafari,2033,903,35,33,68,51.5%,3h
43002,1,billythekid,2033,656,18,32,50,36.0%,8m
43002,2,DACORT,2033,468,15,20,35,42.9%,3h
43002,2,Ghost,2033,270,14,2,16,87.5%,38m
43002,2,DogeLord,2033,245,13,2,15,86.7%,41m
43002,2,[VIRGII]jennie,2033,364,12,20,32,37.5%,3h
43002,1,AboutTime,2033,308,10,16,26,38.5%,18m
43002,2,enller,2033,209,9,2,11,81.8%,3h
43002,2,SegV,2033,297,9,17,26,34.6%,3h
43002,2,notorouis,2033,168,8,1,9,88.9%,1h
43002,2,omardaslayer,2033,188,8,6,14,57.1%,1h
43002,2,daloco,2033,164,6,2,8,75.0%,1h
43002,2,NinjaJedi,2033,164,6,3,9,66.7%,1h
43002,2,[NLTN]bigdirty,2033,164,5,3,8,62.5%,19m
43002,3,[PWands]Dusa,2033,118,5,12,17,29.4%,3h
43002,2,SpeedRacerX,2033,118,4,6,10,40.0%,1h
43002,2,ChinaCCP,2033,102,3,0,3,100.0%,1h
43002,3,BruteForce,2033,36,3,10,13,23.1%,33m
43002,1,Arakasi,2033,64,2,15,17,11.8%,39m
43002,2,luiyox,2033,0,1,0,1,100.0%,1h
43002,2,ELVERGUDO,2033,30,1,4,5,20.0%,26m
43002,1,yihbag,2033,0,1,6,7,14.3%,47m
43002,2,Yobabydaddy,2033,30,1,6,7,14.3%,3h
43002,2,maximus,2033,30,1,7,8,12.5%,1h
43002,2,Driver,2033,0,0,4,4,0.0%,1h
43002,3,lance,2033,0,0,5,5,0.0%,3h
43002,2,direrraven,2033,0,0,6,6,0.0%,58m
43002,2,FearBlack,2033,0,0,6,6,0.0%,1h
43032,2,[cluez]PrimeXL,2032,1590,176,181,357,49.3%,3h
43032,2,jason,2032,1619,151,160,311,48.6%,34m
43032,2,Ventureign,2032,1294,61,60,121,50.4%,23m
43032,1,Binlando,2032,390,12,25,37,32.4%,9m
43032,2,plusdante,2032,176,6,7,13,46.2%,8m
43032,2,ROGUEARLB,2032,108,5,3,8,62.5%,1h
43032,2,Stormrider,2032,116,4,0,4,100.0%,1h
43032,2,Yin,2032,95,4,2,6,66.7%,3h
43032,2,[gnosis]Andre,2032,155,4,3,7,57.1%,3h
43032,1,landlady,2032,48,4,6,10,40.0%,1h
43032,3,KRIS,2032,95,4,8,12,33.3%,5m
43032,2,mangekyu,2032,102,3,0,3,100.0%,26m
43032,2,Pride,2032,144,3,7,10,30.0%,1h
43032,1,[P1N0Ys]SuperNinja,2032,130,3,20,23,13.0%,1h
43032,2,[GosuCK]Mayhem,2032,30,2,6,8,25.0%,1h
43032,2,syahrinseth,2032,58,2,8,10,20.0%,3h
43032,1,forallya,2032,0,1,0,1,100.0%,3h
43032,1,[AGGO]potukyyy,2032,48,1,1,2,50.0%,1h
43032,2,ADHL,2032,88,1,1,2,50.0%,5m
43032,2,Canek,2032,30,1,2,3,33.3%,26m
43032,2,rhino,2032,0,1,4,5,20.0%,23m
43032,1,Djmartinez,2032,0,1,8,9,11.1%,7m
43032,2,AraThorns,2032,0,0,2,2,0.0%,3h
43032,3,[MutasT]Zodak,2032,0,0,4,4,0.0%,1h
43032,2,[tggg]Authoritaria,2032,0,0,6,6,0.0%,1h
43057,1,grolif,2031,1652,101,118,219,46.1%,45m
43057,1,bebo,2031,1343,99,104,203,48.8%,1h
43057,2,Ernest,2031,1352,76,77,153,49.7%,1h
43057,2,Thegubester,2031,882,36,34,70,51.4%,1h
43057,1,john,2031,802,23,34,57,40.4%,1h
43057,2,govnr,2031,437,22,3,25,88.0%,38m
43057,1,Antoni,2031,338,12,17,29,41.4%,39m
43057,2,AlexTonette,2031,266,11,10,21,52.4%,3h
43057,3,pastthelimit,2031,282,11,17,28,39.3%,16m
43057,2,HyeuN,2031,300,9,19,28,32.1%,3h
43057,2,pxlo,2031,201,7,7,14,50.0%,34m
43057,2,BoeJangles,2031,140,5,2,7,71.4%,1h
43057,2,RogerThat,2031,143,5,2,7,71.4%,1h
43057,2,Leo,2031,151,5,2,7,71.4%,3h
43057,1,[TgJc]ThatGuyJorge,2031,178,5,4,9,55.6%,8m
43057,2,TheDawnofMan,2031,30,5,13,18,27.8%,41m
43057,1,Wind,2031,145,3,5,8,37.5%,3h
43057,2,vision,2031,30,2,2,4,50.0%,1h
43057,2,captainhjy,2031,0,1,3,4,25.0%,31m
43057,1,GoodMoJo,2031,0,1,8,9,11.1%,32m
43057,2,Santii,2031,0,0,1,1,0.0%,21m
43057,2,TANKSHOW,2031,0,0,1,1,0.0%,7m
43057,2,Mallett,2031,0,0,1,1,0.0%,3h
43057,2,[Msia]Milo,2031,0,0,1,1,0.0%,3h
43057,1,whatchadoin,2031,0,0,1,1,0.0%,32m
43057,2,OldFashioned,2031,0,0,5,5,0.0%,1h
43057,2,Storm,2031,0,0,8,8,0.0%,1h
43084,2,Rich,2030,1592,210,232,442,47.5%,3h
43084,2,[XchiX]ReiDeLaMort,2030,1443,57,60,117,48.7%,3h
43084,2,Tazee,2030,888,33,34,67,49.3%,3h
43084,2,ssergio,2030,767,30,28,58,51.7%,32m
43084,1,Magius,2030,806,30,43,73,41.1%,1h
43084,2,kmaradarti,2030,699,28,26,54,51.9%,3h
43084,3,Cauliflower,2030,276,9,14,23,39.1%,1h
43084,1,FeNuX,2030,301,8,13,21,38.1%,1h
43084,3,[Bommmm]XxxJordexxX,2030,229,7,3,10,70.0%,14m
43084,2,Yan,2030,293,6,15,21,28.6%,1h
43084,2,[VNMN]Vanimion,2030,120,5,6,11,45.5%,1h
43084,2,Motosierra,2030,94,1,2,3,33.3%,38m
43084,1,DanSemi,2030,48,1,2,3,33.3%,1h
43084,1,Torfkopp,2030,0,1,7,8,12.5%,1h
43084,2,Retrocide,2030,0,0,1,1,0.0%,3h
43084,2,yaimonhere,2030,0,0,1,1,0.0%,38m
43084,2,Norzdomun,2030,0,0,1,1,0.0%,3h
43084,2,jimmyjimjam,2030,0,0,1,1,0.0%,1h
43084,2,Tyler,2030,0,0,1,1,0.0%,3h
43084,2,[ATSMOI]Riddigan,2030,0,0,5,5,0.0%,33m
43084,1,Alex,2030,0,0,8,8,0.0%,1h
43105,1,GIKMORF,2029,1271,65,100,165,39.4%,1h
43105,2,DANY,2029,1063,62,51,113,54.9%,33m
43105,2,naps,2029,1061,42,40,82,51.2%,3h
43105,2,Mace,2029,331,15,8,23,65.2%,1h
43105,2,BooJiggeyPop,2029,280,10,7,17,58.8%,23m
43105,2,[y79097]Bluezerg,2029,214,8,5,13,61.5%,1h
43105,2,PaulRodrigo,2029,221,8,6,14,57.1%,3h
43105,3,[3TT]Rhadamanthys,2029,244,7,15,22,31.8%,1h
43105,1,DinoZerg,2029,197,6,10,16,37.5%,1h
43105,2,DISTROYER,2029,90,4,5,9,44.4%,3h
43105,2,coconutpie,2029,118,3,3,6,50.0%,19m
43105,1,LilloSucks,2029,48,2,12,14,14.3%,46m
43105,2,Zell,2029,30,1,2,3,33.3%,3h
43105,2,Srolikan,2029,87,1,2,3,33.3%,26m
43105,2,Thor,2029,30,1,3,4,25.0%,41m
43105,2,CalvinBBW,2029,0,1,3,4,25.0%,17m
43105,2,[xXGDXx]SleazyTrojan,2029,0,1,9,10,10.0%,3h
43105,2,reddrigo,2029,0,1,9,10,10.0%,25m
43105,2,Rodrigo,2029,0,0,2,2,0.0%,1h
43105,2,Prettyboy,2029,0,0,5,5,0.0%,8m
43125,2,ShadeN,2028,1583,128,155,283,45.2%,38m
43125,2,Jlore,2028,845,95,84,179,53.1%,33m
43125,3,JacobChaytor,2028,1563,78,98,176,44.3%,3h
43125,2,JerryJones,2028,492,21,20,41,51.2%,16m
43125,2,Kenodd,2028,384,11,13,24,45.8%,1h
43125,2,bedaqui,2028,312,10,17,27,37.0%,1h
43125,2,Delywer,2028,90,7,9,16,43.8%,3h
43125,3,Matt,2028,180,7,16,23,30.4%,34m
43125,2,PanSeco,2028,160,5,2,7,71.4%,1h
43125,2,[0M6M]Mijael,2028,178,5,4,9,55.6%,1h
43125,2,[CITIOS]nazart,2028,118,4,5,9,44.4%,1h
43125,3,UnicornKnigh,2028,94,4,14,18,22.2%,54m
43125,2,YourWelcome,2028,60,3,3,6,50.0%,3h
43125,2,Skninja,2028,91,3,4,7,42.9%,1h
43125,2,[BOLVIA]VICTUM,2028,96,3,5,8,37.5%,3h
43125,2,Darkprince,2028,90,3,9,12,25.0%,1h
43125,2,theo,2028,0,2,3,5,40.0%,1h
43125,2,Leto,2028,76,2,10,12,16.7%,41m
43125,2,[CABRAS]Conchita,2028,0,1,1,2,50.0%,1h
43125,1,Xitch,2028,93,1,1,2,50.0%,3h
43125,2,Studly,2028,0,0,3,3,0.0%,3h
43125,2,Grumplaw,2028,0,0,6,6,0.0%,7m
43125,2,drag,2028,0,0,6,6,0.0%,1h
43125,2,ImSoBad,2028,0,0,6,6,0.0%,1h
43149,2,DarkAnviL,2027,1099,41,39,80,51.2%,49m
43149,2,drewrheik,2027,938,38,33,71,53.5%,1h
43149,2,Arturisk,2027,858,32,38,70,45.7%,3h
43149,2,PyschoShark,2027,372,12,21,33,36.4%,23m
43149,1,FOKINI,2027,306,11,16,27,40.7%,1h
43149,3,Yio,2027,254,10,7,17,58.8%,37m
43149,3,CocoChip,2027,299,10,8,18,55.6%,1h
43149,2,Kazr,2027,307,10,15,25,40.0%,33m
43149,2,ketch,2027,242,9,14,23,39.1%,31m
43149,2,AbelCahuana,2027,215,8,10,18,44.4%,22m
43149,1,Pagonas,2027,212,8,16,24,33.3%,55m
43149,2,guido,2027,162,4,5,9,44.4%,60m
43149,2,Barolt,2027,128,3,3,6,50.0%,1h
43149,2,Mordecai,2027,44,3,6,9,33.3%,7m
43149,1,VileFoxx,2027,122,3,9,12,25.0%,57m
43149,2,maxout,2027,90,2,3,5,40.0%,58m
43149,2,MickAngel,2027,0,2,6,8,25.0%,1h
43149,1,direrraven,2027,85,2,9,11,18.2%,17m
43149,3,[FKoN]DarkJoel,2027,30,1,1,2,50.0%,1h
43149,1,kimjiye,2027,0,1,6,7,14.3%,49m
43149,1,Poly,2027,0,1,6,7,14.3%,3h
43149,3,IIIIIIIIIIII,2027,0,0,1,1,0.0%,1h
43149,1,zumokaro,2027,0,0,1,1,0.0%,53m
43149,2,Danokoro,2027,0,0,1,1,0.0%,12m
43149,2,LEO,2027,0,0,3,3,0.0%,1h
43149,2,Kronos,2027,0,0,3,3,0.0%,3h
43175,2,DufferinOG,2026,1227,50,51,101,49.5%,1h
43175,2,bonsaibois,2026,787,28,30,58,48.3%,1h
43175,2,RockyStone,2026,591,22,22,44,50.0%,1h
43175,2,Finger,2026,515,18,27,45,40.0%,1h
43175,2,Kavokolak,2026,458,15,22,37,40.5%,3h
43175,2,[TPGGXD]AliensXD,2026,396,13,17,30,43.3%,1h
43175,1,CUERVO,2026,308,10,11,21,47.6%,1h
43175,2,toonim,2026,290,9,8,17,52.9%,3h
43175,1,impone,2026,288,8,23,31,25.8%,3h
43175,2,idrasil,2026,219,7,6,13,53.8%,41m
43175,3,Goordo,2026,148,7,17,24,29.2%,1h
43175,2,Mark,2026,160,6,6,12,50.0%,33m
43175,2,Jassi,2026,120,3,9,12,25.0%,41m
43175,3,redman,2026,30,2,0,2,100.0%,29m
43175,3,Sam,2026,0,1,0,1,100.0%,3h
43175,3,[SANGRE]Arcangel,2026,0,1,0,1,100.0%,1h
43175,3,[INKA5]Sturm,2026,0,1,0,1,100.0%,1h
43175,3,Eggnooggy,2026,30,1,1,2,50.0%,3h
43175,2,GIBRAN,2026,30,1,4,5,20.0%,3h
43175,2,hemosaurus,2026,30,1,5,6,16.7%,11m
43175,2,[AHPUCH]Kable,2026,30,1,7,8,12.5%,3h
43175,3,TheShrike,2026,0,0,1,1,0.0%,1h
43175,3,pol,2026,0,0,1,1,0.0%,1h
43175,1,Bamcis,2026,0,0,1,1,0.0%,16m
43175,2,lanzer,2026,0,0,2,2,0.0%,50m
43175,2,Fenny,2026,0,0,2,2,0.0%,1h
43175,1,[PRFHN]elchapo,2026,0,0,6,6,0.0%,1h
43202,2,Tone,2025,1556,153,168,321,47.7%,3h
43202,1,Aiuda,2025,1179,68,76,144,47.2%,3h
43202,2,[GZRx]Link,2025,1279,50,59,109,45.9%,8m
43202,2,Nightwalker,2025,420,47,53,100,47.0%,1h
43202,2,VerdugoFatal,2025,1110,41,44,85,48.2%,1h
43202,2,Kramerika,2025,874,38,34,72,52.8%,57m
43202,1,Filmaister,2025,1007,32,43,75,42.7%,1h
43202,1,dan,2025,668,22,33,55,40.0%,3h
43202,2,jcarlos,2025,411,21,17,38,55.3%,50m
43202,3,Timalta,2025,588,20,22,42,47.6%,1h
43202,1,SeniorCronic,2025,182,5,9,14,35.7%,39m
43202,2,MagicT,2025,154,4,4,8,50.0%,38m
43202,1,CptBeast,2025,96,1,2,3,33.3%,3h
43202,3,MrThirtyAPM,2025,0,0,1,1,0.0%,37m
43202,3,EdWin,2025,0,0,1,1,0.0%,37m
43202,2,[FuWu]LucidTwo,2025,0,0,4,4,0.0%,57m
43202,3,Mirzayev,2025,0,0,5,5,0.0%,2h
43202,2,dwqdwq,2025,0,0,6,6,0.0%,27m
43202,2,bannamann,2025,0,0,6,6,0.0%,60m
43221,1,LittleHippo,2024,1661,368,388,756,48.7%,1h
43221,2,brandon,2024,759,30,28,58,51.7%,33m
43221,1,teem,2024,750,22,35,57,38.6%,9m
43221,2,Vindiction,2024,602,21,24,45,46.7%,3h
43221,2,debonaiyr,2024,418,20,13,33,60.6%,33m
43221,2,DarkSteel,2024,498,17,19,36,47.2%,3h
43221,1,econpro,2024,396,12,21,33,36.4%,3h
43221,3,[UMGC]Hardcoremike,2024,290,9,11,20,45.0%,58m
43221,2,[Tsurai]AraiTakahiro,2024,284,9,18,27,33.3%,3h
43221,1,Chagol,2024,261,8,14,22,36.4%,3h
43221,2,[BPV1]GamerGirl,2024,128,4,2,6,66.7%,39m
43221,3,xommander,2024,123,4,14,18,22.2%,9m
43221,3,[Mldr]stefanova,2024,60,3,1,4,75.0%,58m
43221,2,[Weac]zare,2024,92,2,7,9,22.2%,1h
43221,1,ESPsparky,2024,0,2,7,9,22.2%,45m
43221,1,Angel,2024,0,1,1,2,50.0%,1h
43221,2,iuouoi,2024,30,1,6,7,14.3%,38m
43221,1,SupermachJM,2024,44,1,10,11,9.1%,1h
43221,3,MERO,2024,0,0,1,1,0.0%,2h
43221,3,Deigamer,2024,0,0,1,1,0.0%,16m
43221,2,Evan,2024,0,0,2,2,0.0%,50m
43221,2,nanin,2024,0,0,2,2,0.0%,41m
43221,2,esclerglade,2024,0,0,2,2,0.0%,1h
43221,2,Krunkles,2024,0,0,6,6,0.0%,1h
43245,1,wuhanjiayou,2023,979,95,108,203,46.8%,3h
43245,2,ragnar,2023,1512,76,81,157,48.4%,3h
43245,1,PineTreeMan,2023,716,30,42,72,41.7%,3h
43245,1,zorron,2023,539,18,25,43,41.9%,3h
43245,2,moscowmitch,2023,446,15,23,38,39.5%,34m
43245,2,lSilvaxander,2023,312,11,16,27,40.7%,60m
43245,3,BombDigidy,2023,258,9,8,17,52.9%,1h
43245,1,[Div1]Bollinger,2023,158,5,14,19,26.3%,49m
43245,1,Tzaria,2023,0,3,8,11,27.3%,25m
43245,3,AgunneR,2023,123,3,10,13,23.1%,1h
43245,1,[kOOp]hax,2023,145,2,3,5,40.0%,7m
43245,2,cornshrimp,2023,38,2,7,9,22.2%,1h
43245,3,Duneath,2023,58,2,7,9,22.2%,27m
43245,3,MacAdavy,2023,0,1,0,1,100.0%,6m
43245,1,VPom,2023,0,1,0,1,100.0%,1h
43245,2,DoctorA,2023,0,1,2,3,33.3%,39m
43245,2,[ISTOP]PoOM,2023,42,1,2,3,33.3%,1h
43245,2,LNewlands,2023,30,1,6,7,14.3%,3h
43245,3,Pman,2023,0,0,1,1,0.0%,1h
43245,1,[hikari]Katsumi,2023,0,0,1,1,0.0%,3h
43265,2,Xerus,2022,1575,354,364,718,49.3%,3h
43265,2,deathbringer,2022,1257,83,82,165,50.3%,23m
43265,1,Nalu,2022,1538,60,67,127,47.2%,48m
43265,2,[MaxWin]LanceJasonGo,2022,759,26,30,56,46.4%,3h
43265,2,Fruits,2022,416,17,13,30,56.7%,1h
43265,2,Xyz,2022,403,14,23,37,37.8%,3h
43265,2,Irreverent,2022,382,13,19,32,40.6%,3h
43265,2,Stars,2022,264,12,11,23,52.2%,3h
43265,1,kyle,2022,369,11,18,29,37.9%,3h
43265,3,MengWhanzou,2022,313,10,19,29,34.5%,50m
43265,1,mike,2022,304,9,12,21,42.9%,3h
43265,1,[B0N3]Shadow,2022,272,9,16,25,36.0%,3h
43265,3,Jimmy,2022,140,7,17,24,29.2%,55m
43265,2,ras,2022,176,6,16,22,27.3%,26m
43265,1,Klemm,2022,137,6,17,23,26.1%,3h
43265,2,nari,2022,118,5,10,15,33.3%,33m
43265,2,[ETClan]conchimxanh,2022,90,4,5,9,44.4%,35m
43265,2,MOK,2022,0,3,4,7,42.9%,41m
43265,2,White,2022,30,2,7,9,22.2%,1h
43265,3,MisterBungle,2022,0,1,0,1,100.0%,1h
43265,2,jose,2022,0,1,1,2,50.0%,11m
43265,3,ElGavilan,2022,0,0,1,1,0.0%,21m
43265,3,IIIIIIII,2022,0,0,1,1,0.0%,26m
43265,1,Franklin,2022,0,0,1,1,0.0%,8m
43265,3,TheMostly,2022,0,0,1,1,0.0%,27m
43265,2,dmitry,2022,0,0,6,6,0.0%,7m
43291,2,DemonSeed,2021,1627,385,413,798,48.2%,23m
43291,2,enjoythegame,2021,1607,123,153,276,44.6%,3h
43291,2,ScapeKing,2021,702,108,104,212,50.9%,57m
43291,2,Billy,2021,1565,74,80,154,48.1%,3h
43291,2,Marcos,2021,1072,39,42,81,48.1%,3h
43291,2,Fury,2021,346,38,35,73,52.1%,6m
43291,2,xiaomiredmi,2021,776,33,36,69,47.8%,3h
43291,2,CronosGT,2021,436,20,11,31,64.5%,1h
43291,2,RedSorrow,2021,522,18,22,40,45.0%,44m
43291,2,Fisherton,2021,354,13,11,24,54.2%,1h
43291,3,Infowars,2021,350,12,3,15,80.0%,1h
43291,1,eldelicioso,2021,299,9,13,22,40.9%,33m
43291,2,Cody,2021,221,8,13,21,38.1%,39m
43291,2,MGoney,2021,100,5,7,12,41.7%,35m
43291,3,lekruth,2021,86,4,1,5,80.0%,12m
43291,2,[CSSG]awesomepig,2021,30,2,6,8,25.0%,1h
43291,2,SPankZ,2021,72,2,12,14,14.3%,3h
43291,3,Reldes,2021,0,1,0,1,100.0%,11m
43291,2,HECTOR,2021,30,1,4,5,20.0%,9m
43291,2,[AbcCo]IceWizard,2021,93,1,6,7,14.3%,1h
43291,2,[thermy]Zudikas,2021,0,0,2,2,0.0%,3h
43291,2,Sibbs,2021,0,0,3,3,0.0%,2m
43291,2,Parzival,2021,0,0,3,3,0.0%,3h
43291,2,[ZMBELT]BigLeo,2021,0,0,4,4,0.0%,41m
43291,2,jorge,2021,0,0,6,6,0.0%,51m
43316,2,huppster,2020,1446,127,132,259,49.0%,3h
43316,3,DralaFi,2020,1496,60,82,142,42.3%,3h
43316,2,LegendblA,2020,1296,54,55,109,49.5%,3h
43316,3,[ANKL]mackycheese,2020,727,29,31,60,48.3%,6m
43316,2,RAY,2020,574,22,32,54,40.7%,1h
43316,3,LEIRBAG,2020,300,10,12,22,45.5%,1h
43316,2,SEBASTIAN,2020,204,6,7,13,46.2%,3h
43316,2,ASCII,2020,156,6,7,13,46.2%,3h
43316,2,Ihaveto,2020,198,6,18,24,25.0%,3h
43316,3,DARKTEMPLAR,2020,195,5,7,12,41.7%,21m
43316,1,HOPE,2020,188,5,12,17,29.4%,46m
43316,2,papogian,2020,90,4,11,15,26.7%,50m
43316,2,carlos,2020,189,4,12,16,25.0%,20m
43316,2,DINGLEHOPPER,2020,22,2,3,5,40.0%,16m
43316,2,[ScootN]Raspberry,2020,90,1,6,7,14.3%,1h
43316,2,Loki,2020,30,1,7,8,12.5%,1h
43316,3,Aubiekonger,2020,0,0,1,1,0.0%,1h
43316,3,BaronvonBoom,2020,0,0,1,1,0.0%,3h
43316,2,NightstarAce,2020,0,0,2,2,0.0%,36m
43316,2,ElectroDrop,2020,0,0,3,3,0.0%,3h
43336,2,Tacitus,2019,1322,143,141,284,50.4%,2m
43336,2,ALE,2019,1583,133,141,274,48.5%,49m
43336,2,AlbertoGP,2019,1555,92,99,191,48.2%,49m
43336,2,AverageEllis,2019,1214,91,88,179,50.8%,23m
43336,2,ROLYPRO,2019,1473,88,91,179,49.2%,39m
43336,1,Winters,2019,1637,74,82,156,47.4%,3h
43336,2,xblemax,2019,1269,64,74,138,46.4%,1h
43336,1,Tfarcrats,2019,852,30,38,68,44.1%,3h
43336,2,Rodryx,2019,541,20,18,38,52.6%,3h
43336,2,Gufaza,2019,388,14,18,32,43.8%,26m
43336,2,Slaytanic,2019,321,11,15,26,42.3%,3h
43336,2,[GanNuk]jimmy,2019,248,9,9,18,50.0%,3h
43336,3,LOBITO,2019,0,3,2,5,60.0%,37m
43336,3,Valorenium,2019,58,2,2,4,50.0%,3h
43336,3,nortoff,2019,0,0,1,1,0.0%,1h
43336,3,KaShiznit,2019,0,0,1,1,0.0%,51m
43336,2,Picard,2019,0,0,1,1,0.0%,12m
43336,2,Ingas,2019,0,0,2,2,0.0%,12m
43336,2,MrLetter,2019,0,0,3,3,0.0%,1h
43336,3,jordo,2019,0,0,5,5,0.0%,37m
43336,2,Jorogos,2019,0,0,6,6,0.0%,1h
43357,2,ELAUDITOR,2018,1565,69,81,150,46.0%,1h
43357,2,Silence,2018,1042,38,47,85,44.7%,1h
43357,2,lmw,2018,576,20,24,44,45.5%,3h
43357,2,Quixotez,2018,316,13,11,24,54.2%,3h
43357,2,[LOHs]RdmFlyingCow,2018,273,12,9,21,57.1%,3m
43357,2,chimango,2018,308,10,11,21,47.6%,23m
43357,2,OiLMaN,2018,212,7,9,16,43.8%,38m
43357,1,PaoloRP,2018,218,7,12,19,36.8%,46m
43357,1,ZERGKILLER,2018,174,6,13,19,31.6%,3h
43357,1,Levi,2018,212,5,10,15,33.3%,11m
43357,2,[X1]ChevyNova,2018,128,4,4,8,50.0%,14m
43357,2,Alongi,2018,40,3,6,9,33.3%,1h
43357,2,[ZG]UnabatedWolf,2018,58,2,4,6,33.3%,23m
43357,2,VelRosita,2018,62,2,6,8,25.0%,1h
43357,3,cosec,2018,0,2,9,11,18.2%,3h
43357,2,littycomitee,2018,88,2,10,12,16.7%,3h
43357,2,Autumnredsky,2018,0,1,2,3,33.3%,1h
43357,1,Sargon,2018,0,1,8,9,11.1%,3h
43357,1,Belevedere,2018,0,1,9,10,10.0%,3h
43357,1,Isra,2018,0,1,9,10,10.0%,3h
43357,1,GhostMarine,2018,36,1,12,13,7.7%,1h
43357,2,Alvaromt,2018,0,0,2,2,0.0%,1h
43357,1,dfg,2018,0,0,3,3,0.0%,16m
43380,2,Weichafe,2017,1537,162,185,347,46.7%,1h
43380,2,CREATIVE,2017,1209,60,66,126,47.6%,1m
43380,2,IronDan,2017,441,28,25,53,52.8%,39m
43380,1,Vago,2017,762,26,40,66,39.4%,1h
43380,3,IchimaruGin,2017,308,9,9,18,50.0%,3h
43380,2,DragonRider,2017,202,7,9,16,43.8%,3h
43380,2,IRONRAY,2017,180,7,13,20,35.0%,1h
43380,3,datmanametom,2017,204,5,7,12,41.7%,30m
43380,1,MagicTurtle,2017,97,4,6,10,40.0%,8m
43380,3,lazygamer,2017,70,3,0,3,100.0%,1h
43380,1,[DASUL]SOLITARIO,2017,154,3,6,9,33.3%,1h
43380,2,[waRp1]EDUKT,2017,88,3,8,11,27.3%,2m
43380,1,[LOHe]blargon,2017,118,3,8,11,27.3%,48m
43380,2,Typhon,2017,92,3,10,13,23.1%,22m
43380,1,Christopher,2017,0,2,4,6,33.3%,1h
43380,2,agro,2017,112,2,6,8,25.0%,3h
43380,2,[Qlo]ceus,2017,92,2,9,11,18.2%,1h
43380,2,Wetty,2017,127,2,18,20,10.0%,1h
43380,3,[Baaaa]Hufflebuff,2017,30,1,1,2,50.0%,1h
43380,3,Marles,2017,0,1,4,5,20.0%,35m
43380,2,EaTASSXD,2017,94,1,6,7,14.3%,1h
43380,2,StinkJake,2017,0,1,7,8,12.5%,3m
43402,2,POIROT,2016,1543,275,325,600,45.8%,9m
43402,2,Hannibal,2016,1183,110,112,222,49.5%,3h
43402,2,Softhingz,2016,1559,106,100,206,51.5%,34m
43402,2,edward,2016,793,69,66,135,51.1%,1h
43402,2,joefish,2016,1140,44,42,86,51.2%,9m
43402,2,yuyo,2016,710,24,27,51,47.1%,1h
43402,1,Stormtrooper,2016,515,21,26,47,44.7%,16m
43402,1,Krawlher,2016,488,17,27,44,38.6%,50m
43402,2,Bonesetter,2016,416,16,12,28,57.1%,1h
43402,2,JANO,2016,323,11,16,27,40.7%,3h
43402,2,Anaya,2016,347,10,26,36,27.8%,1h
43402,2,varyable,2016,251,8,6,14,57.1%,1h
43402,2,iLoveYou,2016,273,8,11,19,42.1%,3h
43402,3,PhilMcGlackn,2016,86,4,0,4,100.0%,21m
43402,2,Colbkilla,2016,170,4,5,9,44.4%,30m
43402,2,Rugal,2016,140,4,10,14,28.6%,1h
43402,2,NullSet,2016,97,3,7,10,30.0%,1m
43402,2,[Mun50N]PYRON,2016,88,3,7,10,30.0%,6m
43402,1,[Jok3r]Dan,2016,144,2,17,19,10.5%,2m
43402,3,WZNR,2016,0,1,1,2,50.0%,37m
43402,1,ever,2016,0,1,1,2,50.0%,1h
43402,2,[ELLOCO]Slugok,2016,97,1,4,5,20.0%,1h
43402,3,BuketOfTruth,2016,0,0,1,1,0.0%,45m
43425,2,lilpeatmoss,2015,1573,122,120,242,50.4%,1h
43425,2,MangoTango,2015,1333,98,93,191,51.3%,17m
43425,2,Keats,2015,1572,97,108,205,47.3%,23m
43425,2,KDogRock,2015,554,31,29,60,51.7%,3h
43425,2,SaintCharlie,2015,710,29,36,65,44.6%,1h
43425,1,Bonkinjovi,2015,292,26,38,64,40.6%,1h
43425,2,ShepherdBoy,2015,382,13,20,33,39.4%,1h
43425,2,MrRodgers,2015,338,11,20,31,35.5%,30m
43425,1,JiveTurkey,2015,245,8,10,18,44.4%,8m
43425,3,Zaratoustra,2015,198,7,3,10,70.0%,8m
43425,2,KrimzonGuard,2015,126,5,5,10,50.0%,3h
43425,2,WaterHungry,2015,154,5,11,16,31.2%,49m
43425,2,Achilles,2015,156,5,14,19,26.3%,3h
43425,2,Scott,2015,98,3,6,9,33.3%,33m
43425,2,newroman,2015,83,3,7,10,30.0%,60m
43425,2,Quixoticelix,2015,48,3,7,10,30.0%,41m
43425,2,alaracpro,2015,48,2,0,2,100.0%,1h
43425,3,AsElHeroe,2015,58,2,1,3,66.7%,1h
43425,1,txing,2015,0,2,11,13,15.4%,3h
43425,3,[MadMON]MELEKAIJOE,2015,0,1,0,1,100.0%,35m
43425,2,JohnMisty,2015,0,1,1,2,50.0%,42m
43425,1,Sparticus,2015,46,1,9,10,10.0%,1h
43425,3,Class,2015,0,0,1,1,0.0%,43m
43425,2,Bilblo,2015,0,0,3,3,0.0%,1h
43425,3,Justinius,2015,0,0,5,5,0.0%,1h
43425,2,[EXOTIQ]SKY,2015,0,0,5,5,0.0%,3h
43425,2,[LoF]KaRioN,2015,0,0,6,6,0.0%,1h
43425,2,criss,2015,0,0,6,6,0.0%,1h
43453,2,TrouserWorm,2014,1625,453,479,932,48.6%,1h
43453,2,Lothar,2014,1570,82,81,163,50.3%,1h
43453,2,Deathgun,2014,862,35,43,78,44.9%,35m
43453,2,ARGENTO,2014,615,23,28,51,45.1%,33m
43453,3,[FyHr]DiegoRiver,2014,555,20,15,35,57.1%,1h
43453,3,Queiroga,2014,534,19,15,34,55.9%,51m
43453,2,LoreHorse,2014,414,17,12,29,58.6%,1h
43453,2,PichuloskY,2014,453,17,15,32,53.1%,13m
43453,2,Babyimreal,2014,417,15,14,29,51.7%,1h
43453,2,pibibon,2014,182,5,4,9,55.6%,50m
43453,2,xzxzorigin,2014,58,3,4,7,42.9%,3h
43453,1,Sceptical,2014,32,3,9,12,25.0%,48m
43453,1,Nicolas,2014,72,3,11,14,21.4%,1h
43453,1,[SCTR]OpaGandalf,2014,96,2,2,4,50.0%,29m
43453,2,ATLMOOHAN,2014,114,2,6,8,25.0%,3h
43453,2,Furbpl,2014,92,2,8,10,20.0%,1h
43453,2,Volkswagen,2014,60,2,11,13,15.4%,3h
43453,2,[Vtta]Dennis,2014,30,1,3,4,25.0%,1h
43453,3,shawn,2014,40,1,6,7,14.3%,3h
43453,3,LIWEILICAO,2014,0,0,1,1,0.0%,1h
43453,3,IMAN,2014,0,0,1,1,0.0%,11m
43453,3,GVII,2014,0,0,1,1,0.0%,1h
43453,2,bellotalco,2014,0,0,3,3,0.0%,3h
43453,1,Huckaboom,2014,0,0,3,3,0.0%,3h
43453,2,LucNAr,2014,0,0,8,8,0.0%,34m
43478,2,ERIKPH,2013,1576,81,89,170,47.6%,32m
43478,2,Demoledor,2013,1371,68,79,147,46.3%,3h
43478,2,[KTSC2]DANIELCPS,2013,1544,59,66,125,47.2%,44m
43478,2,SmokeyBear,2013,1317,56,57,113,49.6%,3h
43478,2,Carrymor,2013,1374,52,55,107,48.6%,11m
43478,1,Lysander,2013,789,31,35,66,47.0%,3h
43478,2,HyeuN,2013,434,14,22,36,38.9%,1h
43478,2,TiCon,2013,370,12,20,32,37.5%,16m
43478,3,[00SB00]keton,2013,120,7,13,20,35.0%,53m
43478,1,[TROLL]SoupBone,2013,190,5,12,17,29.4%,1h
43478,2,Ricardoo,2013,155,4,4,8,50.0%,1h
43478,3,ahsten,2013,0,2,2,4,50.0%,1h
43478,2,yeral,2013,0,1,0,1,100.0%,1h
43478,3,Rogoku,2013,30,1,1,2,50.0%,40m
43478,3,KYLE,2013,0,0,1,1,0.0%,21m
43478,3,MorpheoIEC,2013,0,0,1,1,0.0%,23m
43478,3,Merckx,2013,0,0,1,1,0.0%,27m
43478,3,CorlissXL,2013,0,0,1,1,0.0%,48m
43478,2,StyliAnT,2013,0,0,2,2,0.0%,26m
43478,2,[QRDZ]HolyCrusade,2013,0,0,2,2,0.0%,41m
43478,2,BenDover,2013,0,0,3,3,0.0%,2m
43478,2,SnakeEyes,2013,0,0,4,4,0.0%,14m
43478,3,NoStar,2013,0,0,5,5,0.0%,1h
43501,1,neo,2012,1593,207,215,422,49.1%,29m
43501,2,kaos,2012,1569,79,83,162,48.8%,34m
43501,2,AmeBabad,2012,814,32,33,65,49.2%,3h
43501,2,GiantTCR,2012,276,10,13,23,43.5%,3h
43501,3,Rovenegas,2012,280,9,7,16,56.2%,51m
43501,2,ELGOSU,2012,164,8,19,27,29.6%,9m
43501,3,BKG,2012,192,7,4,11,63.6%,12m
43501,2,Yongarie,2012,224,7,10,17,41.2%,3h
43501,3,[MexTab]InusMardor,2012,125,3,4,7,42.9%,41m
43501,2,[char14]dark,2012,106,3,6,9,33.3%,31m
43501,3,miroslav,2012,70,2,1,3,66.7%,38m
43501,2,[BroET]TheFinish,2012,94,2,1,3,66.7%,1h
43501,1,KHAN,2012,48,1,1,2,50.0%,3h
43501,2,JSeige,2012,30,1,4,5,20.0%,3h
43501,2,localhoney,2012,30,1,5,6,16.7%,3h
43501,1,Soondae,2012,0,1,7,8,12.5%,1h
43501,3,BCFan,2012,0,0,1,1,0.0%,8m
43518,2,Azrael,2011,1568,241,256,497,48.5%,2m
43518,2,PablO,2011,1556,89,109,198,44.9%,8m
43518,2,astro,2011,659,48,49,97,49.5%,3m
43518,2,Von,2011,789,30,31,61,49.2%,3h
43518,2,caoswhite,2011,801,30,36,66,45.5%,3h
43518,2,SNICKLEFRITZ,2011,674,24,27,51,47.1%,17m
43518,3,Prophet,2011,364,13,14,27,48.1%,35m
43518,1,[CHOG]Amplified,2011,314,10,21,31,32.3%,3h
43518,2,STOD,2011,260,9,11,20,45.0%,1h
43518,2,jofl,2011,216,7,7,14,50.0%,39m
43518,3,saulgudman,2011,166,7,7,14,50.0%,51m
43518,3,DangerousD,2011,104,3,6,9,33.3%,1h
43518,2,RogueRaleigh,2011,86,3,9,12,25.0%,1h
43518,2,NorthWood,2011,109,2,6,8,25.0%,1h
43518,2,Newbie,2011,60,2,7,9,22.2%,3m
43518,3,CORONAVIRUS,2011,30,1,1,2,50.0%,30m
43518,2,ZAGO,2011,0,1,2,3,33.3%,3m
43518,2,sLadino,2011,30,1,6,7,14.3%,1h
43518,2,[ZTempz]Lucien,2011,32,1,7,8,12.5%,1h
43518,1,ezeld,2011,0,0,1,1,0.0%,1h
43518,2,PFGHuiston,2011,0,0,1,1,0.0%,1h
43518,2,STARK,2011,0,0,4,4,0.0%,3h
43518,2,Shadow,2011,0,0,7,7,0.0%,50m
43518,2,[TY4GG]HenryZhang,2011,0,0,8,8,0.0%,1h
43542,1,josed,2010,1648,122,133,255,47.8%,3h
43542,2,lualcaro,2010,1438,81,85,166,48.8%,3h
43542,2,Twist,2010,1520,80,81,161,49.7%,3h
43542,3,[PTKS2]Peury,2010,777,35,31,66,53.0%,39m
43542,1,DeepBlue,2010,710,26,43,69,37.7%,1h
43542,2,JosHard,2010,608,24,22,46,52.2%,1h
43542,2,yuushoukouho,2010,353,21,28,49,42.9%,50m
43542,2,Guti,2010,506,18,19,37,48.6%,3m
43542,2,Totensen,2010,393,14,12,26,53.8%,50m
43542,2,NaCljerky,2010,355,12,13,25,48.0%,1h
43542,1,DorArmand,2010,368,11,21,32,34.4%,3h
43542,2,[BRTHRS]Daniel,2010,227,9,6,15,60.0%,1h
43542,2,TheMechanic,2010,222,8,10,18,44.4%,50m
43542,2,DoNaN,2010,162,5,1,6,83.3%,27m
43542,2,CleOps,2010,136,5,8,13,38.5%,1h
43542,3,Rollwit,2010,86,3,1,4,75.0%,3h
43542,3,Horyh,2010,38,3,3,6,50.0%,2h
43542,2,[ZTempz]RokMan,2010,58,3,4,7,42.9%,23m
43542,2,Swiftty,2010,90,3,7,10,30.0%,3h
43542,2,Hizamaru,2010,30,2,4,6,33.3%,1h
43542,3,[JDSIII]FalconX,2010,30,1,1,2,50.0%,1h
43542,3,Somniadolor,2010,0,1,4,5,20.0%,46m
43542,2,Julio,2010,30,1,6,7,14.3%,1h
43542,3,Chelo,2010,0,0,4,4,0.0%,1h
43542,2,Blackhalkk,2010,0,0,4,4,0.0%,41m
43567,2,Littledog,2009,1398,269,338,607,44.3%,3h
43567,1,RicardoARES,2009,1620,127,151,278,45.7%,3h
43567,2,Mazikeen,2009,838,66,89,155,42.6%,3m
43567,2,gorge,2009,718,63,80,143,44.1%,2m
43567,2,[LOHd]Caps,2009,1431,58,61,119,48.7%,38m
43567,2,jjfzero,2009,978,40,44,84,47.6%,26m
43567,2,wgc,2009,609,22,26,48,45.8%,3h
43567,1,[Huffs]craft,2009,506,18,29,47,38.3%,3h
43567,2,llllllllllll,2009,293,11,14,25,44.0%,2m
43567,2,ElSanti,2009,339,11,19,30,36.7%,16m
43567,1,PiSquared,2009,398,11,19,30,36.7%,53m
43567,1,[MEXsc]Elchicogato,2009,305,8,11,19,42.1%,3h
43567,2,YayaElAlien,2009,190,6,13,19,31.6%,1h
43567,2,Hydro,2009,122,4,11,15,26.7%,38m
43567,2,[Rokers]CARRICOCHON,2009,116,3,3,6,50.0%,1h
43567,1,havok,2009,169,3,11,14,21.4%,1h
43567,2,Ashwin,2009,74,2,8,10,20.0%,17m
43567,2,PhineasGage,2009,70,2,12,14,14.3%,57m
43567,2,poultry,2009,0,1,5,6,16.7%,33m
43567,1,mewtho,2009,0,1,8,9,11.1%,8m
43567,3,[NerdTC]lilKdoggie,2009,0,0,1,1,0.0%,3h
43567,3,AnaKonda,2009,0,0,1,1,0.0%,3h
43567,3,stanislasjan,2009,0,0,1,1,0.0%,38m
43567,3,Stark,2009,0,0,1,1,0.0%,1h
43567,3,emanucho,2009,0,0,1,1,0.0%,2h
43567,3,[RTY]CrookeD,2009,0,0,1,1,0.0%,30m
43567,2,Lucky,2009,0,0,6,6,0.0%,3m
43594,2,marquis,2008,1401,74,77,151,49.0%,33m
43594,2,nope,2008,622,44,35,79,55.7%,3h
43594,1,enytime,2008,1020,44,38,82,53.7%,3h
43594,2,[JUGOS]alexander,2008,904,32,37,69,46.4%,3m
43594,2,LloydXMas,2008,837,31,40,71,43.7%,57m
43594,2,sosa,2008,458,20,16,36,55.6%,3h
43594,3,Smokey,2008,416,16,12,28,57.1%,55m
43594,2,tatsumi,2008,424,16,20,36,44.4%,1h
43594,2,ChinoATL,2008,424,15,22,37,40.5%,50m
43594,1,Babuinoptero,2008,215,10,18,28,35.7%,1h
43594,1,Jhon,2008,244,10,28,38,26.3%,3h
43594,2,DontTalkToMe,2008,276,8,10,18,44.4%,57m
43594,1,VectorPhy,2008,145,3,10,13,23.1%,7m
43594,3,[LY]Corrupter,2008,120,2,2,4,50.0%,23m
43594,3,FindingMyslf,2008,0,2,3,5,40.0%,1h
43594,2,Kamikaze,2008,142,2,9,11,18.2%,50m
43594,1,max,2008,0,1,0,1,100.0%,18m
43594,1,neeatstere,2008,0,1,0,1,100.0%,1h
43594,3,jhonn,2008,0,1,0,1,100.0%,9m
43594,1,ymcajay,2008,0,1,0,1,100.0%,2m
43594,2,KevinRamage,2008,0,1,4,5,20.0%,34m
43594,2,FALCON,2008,30,1,7,8,12.5%,3h
43594,3,juberoller,2008,0,0,1,1,0.0%,3h
43594,2,Bepstar,2008,0,0,6,6,0.0%,1h
43618,1,Bunbury,2007,983,91,97,188,48.4%,1h
43618,2,BQsauce,2007,1499,85,78,163,52.1%,3h
43618,2,TRA,2007,610,54,50,104,51.9%,3h
43618,2,NattyRed,2007,932,33,38,71,46.5%,16m
43618,2,[NwAs]KKaIZeR,2007,884,30,36,66,45.5%,35m
43618,2,Jedi,2007,884,29,37,66,43.9%,1h
43618,2,Chhogori,2007,420,15,21,36,41.7%,1h
43618,1,wincho,2007,510,15,29,44,34.1%,7m
43618,2,rocky,2007,260,9,17,26,34.6%,1h
43618,2,bunnycutie,2007,252,9,17,26,34.6%,30m
43618,2,Fenix,2007,251,8,9,17,47.1%,38m
43618,2,cratos,2007,242,7,7,14,50.0%,1h
43618,3,HotStick,2007,150,6,10,16,37.5%,9m
43618,3,[TGOOD]Serral,2007,88,5,14,19,26.3%,9m
43618,2,DarkHunter,2007,126,4,1,5,80.0%,9m
43618,2,Helya,2007,90,3,5,8,37.5%,1h
43618,2,Kiggy,2007,108,3,7,10,30.0%,1h
43618,1,[BraziI]Darking,2007,97,3,7,10,30.0%,1m
43618,2,[SWOU]ALDAIR,2007,138,3,9,12,25.0%,1h
43618,2,[PERJPN]Kichi,2007,102,2,2,4,50.0%,3h
43618,2,FUPApacman,2007,122,2,3,5,40.0%,1h
43618,2,ShelTron,2007,76,2,8,10,20.0%,14m
43618,3,ScarletWitch,2007,0,1,0,1,100.0%,43m
43618,2,EvoFart,2007,0,1,2,3,33.3%,57m
43618,2,chalbo,2007,0,1,3,4,25.0%,33m
43618,3,Hurtcules,2007,0,1,4,5,20.0%,1h
43618,1,[SUDAKA]yorgust,2007,0,1,4,5,20.0%,3h
43618,3,SilianRail,2007,0,1,4,5,20.0%,3h
43618,3,VXLAN,2007,0,0,1,1,0.0%,31m
43618,2,[IrmBRs]valoroso,2007,0,0,3,3,0.0%,38m
43618,2,Bahamut,2007,0,0,3,3,0.0%,11m
43649,1,VictorD,2006,1663,362,374,736,49.2%,3h
43649,2,Terralex,2006,1613,87,103,190,45.8%,3h
43649,2,alejopuga,2006,1566,67,72,139,48.2%,3h
43649,1,RadDad,2006,1274,46,65,111,41.4%,1h
43649,2,porschify,2006,862,30,34,64,46.9%,1h
43649,1,[iPepsi]Josemaqp,2006,776,22,42,64,34.4%,46m
43649,3,Sciguy,2006,454,16,14,30,53.3%,1h
43649,1,xKIRAx,2006,530,15,28,43,34.9%,3h
43649,2,maddmanu,2006,357,12,11,23,52.2%,1h
43649,2,Fenris,2006,280,11,17,28,39.3%,31m
43649,3,Molonoide,2006,225,11,17,28,39.3%,3h
43649,2,Miracle,2006,256,8,15,23,34.8%,1h
43649,1,viralmass,2006,326,7,15,22,31.8%,1h
43649,3,Grox,2006,114,4,2,6,66.7%,3h
43649,2,tsunamiarrow,2006,94,4,7,11,36.4%,22m
43649,2,ThePhantom,2006,130,4,11,15,26.7%,3h
43649,1,onion,2006,189,4,11,15,26.7%,7m
43649,1,Epicbagle,2006,58,3,9,12,25.0%,19m
43649,2,Turbatronix,2006,102,2,2,4,50.0%,1h
43649,1,Drax,2006,0,1,6,7,14.3%,25m
43649,3,BlackieChan,2006,0,0,1,1,0.0%,14m
43649,1,EABlackCat,2006,0,0,1,1,0.0%,1h
43649,1,Exempt,2006,0,0,1,1,0.0%,3h
43649,2,[RnRFTP]ThePunisher,2006,0,0,1,1,0.0%,1h
43649,2,TheLich,2006,0,0,3,3,0.0%,3m
43649,3,[fcorps]Faruq,2006,0,0,5,5,0.0%,39m
43675,2,DerMann,2005,1559,141,147,288,49.0%,3h
43675,3,bruwave,2005,1474,71,87,158,44.9%,59m
43675,3,geoffthebad,2005,717,33,41,74,44.6%,47m
43675,2,Hosed,2005,706,24,31,55,43.6%,1h
43675,2,Demetriusz,2005,461,15,19,34,44.1%,11m
43675,2,Elver,2005,384,12,21,33,36.4%,31m
43675,2,[Nutr]TempestCrow,2005,204,8,8,16,50.0%,3h
43675,3,MegaKnight,2005,255,8,12,20,40.0%,21m
43675,2,tikigodlax,2005,132,4,9,13,30.8%,9m
43675,3,ARAGORN,2005,90,3,10,13,23.1%,3m
43675,2,FlanTheMan,2005,30,2,6,8,25.0%,3h
43675,3,BengalBamBam,2005,0,1,0,1,100.0%,26m
43675,2,[LOHs]Dudak,2005,0,1,1,2,50.0%,1h
43675,3,[CosEng]spectRUM,2005,30,1,1,2,50.0%,1h
43675,3,AdamX,2005,30,1,2,3,33.3%,37m
43675,1,Shiroku,2005,0,0,1,1,0.0%,1h
43675,2,sebasti,2005,0,0,6,6,0.0%,1h
43692,1,burn,2004,1589,114,117,231,49.4%,1h
43692,3,tmex,2004,1239,45,46,91,49.5%,1h
43692,2,thesnake,2004,578,19,29,48,39.6%,33m
43692,3,[ISMDI]SaberTooth,2004,457,17,19,36,47.2%,1h
43692,3,TYCHUS,2004,403,16,17,33,48.5%,1h
43692,3,IAmNoegs,2004,304,15,5,20,75.0%,3h
43692,2,SoldadoRg,2004,418,14,24,38,36.8%,38m
43692,1,Interstellar,2004,254,9,16,25,36.0%,3h
43692,2,MarS,2004,168,7,2,9,77.8%,42m
43692,2,destruckr,2004,202,7,13,20,35.0%,1h
43692,2,Tdot,2004,134,4,4,8,50.0%,1h
43692,2,Swinestein,2004,30,2,4,6,33.3%,3h
43692,2,spicedrum,2004,0,2,5,7,28.6%,1h
43692,2,Kostas,2004,0,1,1,2,50.0%,11m
43692,2,LaCrapule,2004,0,1,2,3,33.3%,1h
43692,2,[3LIFT]barwise,2004,30,1,4,5,20.0%,16m
43692,2,GAFS,2004,30,1,4,5,20.0%,3m
43692,2,Skoorb,2004,0,1,7,8,12.5%,27m
43692,2,terminator,2004,48,1,8,9,11.1%,11m
43692,3,[Dnwlkr]sapoelegante,2004,0,0,1,1,0.0%,51m
43692,3,TOMYUMKUNG,2004,0,0,1,1,0.0%,1h
43692,2,Starlord,2004,0,0,1,1,0.0%,1h
43692,1,NEPO,2004,0,0,5,5,0.0%,1h
43692,3,KBELOBR,2004,0,0,5,5,0.0%,3h
43692,3,tgibz,2004,0,0,5,5,0.0%,35m
43717,1,Styles,2003,1646,310,325,635,48.8%,3h
43717,2,Ischuros,2003,1596,182,200,382,47.6%,16m
43717,2,Dody,2003,1235,49,49,98,50.0%,1h
43717,2,pipoman,2003,906,33,39,72,45.8%,30m
43717,2,[sLuxx]Optimize,2003,751,23,33,56,41.1%,49m
43717,1,XTAIKER,2003,724,22,35,57,38.6%,1h
43717,3,victorXD,2003,366,13,8,21,61.9%,3h
43717,2,Bonefish,2003,226,6,19,25,24.0%,3h
43717,2,KenshinX,2003,109,5,11,16,31.2%,26m
43717,2,[AbcCo]JorgeReyy,2003,153,4,10,14,28.6%,38m
43717,1,herroprease,2003,92,4,10,14,28.6%,3h
43717,2,[Metric]ThortraLisk,2003,102,3,2,5,60.0%,3h
43717,2,Glenda,2003,102,3,2,5,60.0%,3h
43717,2,brunosf,2003,136,3,9,12,25.0%,3h
43717,2,ElFoxtrot,2003,0,2,9,11,18.2%,56m
43717,3,ako,2003,0,0,1,1,0.0%,32m
43717,2,ShenAltair,2003,0,0,6,6,0.0%,41m
43717,1,Fragments,2003,0,0,8,8,0.0%,1h
43735,2,OGnoob,2002,746,102,113,215,47.4%,3h
43735,2,samuelsam,2002,1110,54,59,113,47.8%,3h
43735,2,NuubSito,2002,1267,52,53,105,49.5%,3h
43735,2,kidzplaygame,2002,1068,43,47,90,47.8%,1m
43735,1,[RSGP]Aristoteles,2002,990,39,54,93,41.9%,3h
43735,2,Toshii,2002,937,38,33,71,53.5%,1h
43735,1,TheFireBro,2002,1007,36,53,89,40.4%,39m
43735,2,Kazuma,2002,405,15,14,29,51.7%,31m
43735,2,Gadget,2002,455,15,22,37,40.5%,3h
43735,2,[HENT4I]sebas,2002,284,10,15,25,40.0%,39m
43735,2,Anibal,2002,204,6,15,21,28.6%,1h
43735,2,SneakyTurtle,2002,252,6,17,23,26.1%,3h
43735,1,TENTACION,2002,146,5,11,16,31.2%,25m
43735,2,[Alphaa]DessertFox,2002,114,4,7,11,36.4%,1h
43735,3,DrDestructo,2002,157,4,8,12,33.3%,37m
43735,3,detroider,2002,58,3,2,5,60.0%,1h
43735,1,Tylenita,2002,122,3,5,8,37.5%,3h
43735,2,MychalM,2002,58,3,8,11,27.3%,42m
43735,3,TonnyUrsa,2002,95,2,0,2,100.0%,3h
43735,2,Behbehbear,2002,46,2,7,9,22.2%,41m
43735,3,[LOHs]rukster,2002,30,1,1,2,50.0%,40m
43735,2,[TE0]truth,2002,0,1,2,3,33.3%,17m
43735,3,Dovorak,2002,0,1,3,4,25.0%,29m
43735,1,BillyJean,2002,97,1,3,4,25.0%,21m
43735,3,[DhZAc1]Esttorvo,2002,0,1,4,5,20.0%,1h
43735,2,leo,2002,0,1,5,6,16.7%,1h
43735,1,Magnifeye,2002,0,1,8,9,11.1%,43m
43735,3,trejoslander,2002,0,0,1,1,0.0%,1h
43735,3,Aphakia,2002,0,0,1,1,0.0%,1h
43735,1,[evrgrn]Zee,2002,0,0,2,2,0.0%,43m
43735,2,MythLucy,2002,0,0,6,6,0.0%,1h
43766,1,[wdsd]BLAZE,2001,1587,106,119,225,47.1%,3h
43766,2,TonyMarkov,2001,923,74,88,162,45.7%,42m
43766,2,JAY,2001,947,71,80,151,47.0%,3m
43766,2,[UZD4S]Duke,2001,1092,46,67,113,40.7%,38m
43766,2,Benjy,2001,531,21,17,38,55.3%,1h
43766,1,Rez,2001,502,17,25,42,40.5%,34m
43766,2,texas,2001,234,8,14,22,36.4%,1h
43766,3,Onigari,2001,170,4,2,6,66.7%,28m
43766,3,Jerusalén,2001,0,3,3,6,50.0%,27m
43766,2,razord,2001,109,3,9,12,25.0%,1h
43766,3,Jack,2001,30,2,1,3,66.7%,26m
43766,1,JhodaGamer,2001,96,2,1,3,66.7%,1h
43766,3,Rebuildfpv,2001,58,2,1,3,66.7%,31m
43766,2,[CHASQ]Attatrix,2001,88,1,2,3,33.3%,1h
43766,1,Kabooom,2001,97,1,2,3,33.3%,46m
43766,3,Jack,2001,0,0,1,1,0.0%,48m
43766,1,GarBaer,2001,0,0,1,1,0.0%,21m
43766,3,MAURICIO,2001,0,0,2,2,0.0%,1h
43766,3,Djaywhy,2001,0,0,3,3,0.0%,47m
43785,1,Numitron,2000,1657,69,75,144,47.9%,42m
43785,3,MAURI,2000,518,24,15,39,61.5%,1h
43785,2,Mmadmax,2000,572,21,26,47,44.7%,3h
43785,2,skierro,2000,480,17,25,42,40.5%,3h
43785,2,drake,2000,328,15,8,23,65.2%,14m
43785,2,[MITO22]Bolsonaro,2000,292,11,15,26,42.3%,1h
43785,3,ordoya,2000,254,10,5,15,66.7%,21m
43785,2,[4332]ghost,2000,282,9,15,24,37.5%,44m
43785,2,Kevv,2000,166,6,14,20,30.0%,30m
43785,2,[ØFoxF2]llllllllllll,2000,168,4,7,11,36.4%,23m
43785,2,Charcoal,2000,58,3,4,7,42.9%,3h
43785,2,BiZeBoYz,2000,90,3,7,10,30.0%,3h
43785,1,[LoShay]NeMesSiLd,2000,94,3,9,12,25.0%,47m
43785,2,Rexxuz,2000,86,3,10,13,23.1%,22m
43785,2,Tfoo,2000,90,2,7,9,22.2%,3h
43785,1,[CCCCCP]Setsuna,2000,96,2,8,10,20.0%,12m
43785,2,Traptech,2000,95,1,2,3,33.3%,27m
43785,1,Lothinilus,2000,0,1,3,4,25.0%,1h
43785,2,UncleSam,2000,0,1,5,6,16.7%,9m
43785,2,lionleaf,2000,0,0,2,2,0.0%,38m
43785,2,Sinlentes,2000,0,0,4,4,0.0%,51m
43785,2,Davin,2000,0,0,6,6,0.0%,1h
43785,2,Ishtar,2000,0,0,6,6,0.0%,51m
43808,2,patrickontre,1999,1583,151,169,320,47.2%,3h
43808,1,Roblox,1999,946,130,149,279,46.6%,40m
43808,1,BoteroJF,1999,1456,94,99,193,48.7%,46m
43808,2,RiCal,1999,713,73,76,149,49.0%,1h
43808,2,Ender,1999,1490,66,69,135,48.9%,44m
43808,2,aegon,1999,577,37,33,70,52.9%,24m
43808,2,iWild,1999,462,18,26,44,40.9%,1h
43808,2,ColeKnight,1999,420,16,19,35,45.7%,11m
43808,3,IIDarkProII,1999,189,6,1,7,85.7%,1h
43808,2,Reus,1999,152,4,5,9,44.4%,1h
43808,2,maniatico,1999,30,2,6,8,25.0%,27m
43808,2,Alder,1999,48,2,7,9,22.2%,1h
43808,2,KRISG,1999,92,2,9,11,18.2%,58m
43808,3,Nope,1999,0,1,4,5,20.0%,23m
43808,3,Raptor,1999,28,1,7,8,12.5%,1h
43808,3,francisco,1999,96,1,8,9,11.1%,3h
43808,3,Steve,1999,0,0,1,1,0.0%,27m
43808,2,Brandon,1999,0,0,2,2,0.0%,1h
43808,2,Rina,1999,0,0,3,3,0.0%,3h
43808,2,[Mimir]Maedhros,1999,0,0,3,3,0.0%,27m
43808,3,Simon,1999,0,0,4,4,0.0%,1h
43829,2,[SC2IDN]JackSparroww,1998,1583,82,99,181,45.3%,33m
43829,2,Tetrapack,1998,954,70,90,160,43.8%,1h
43829,2,DONOMAR,1998,447,50,41,91,54.9%,42m
43829,2,Hitman,1998,932,32,37,69,46.4%,1h
43829,2,Karazu,1998,793,29,37,66,43.9%,3h
43829,2,[ASPIE]BananaKing,1998,456,19,17,36,52.8%,3h
43829,2,Covertseal,1998,176,14,18,32,43.8%,1h
43829,2,bobsaget,1998,267,11,10,21,52.4%,30m
43829,2,Jeguhu,1998,238,8,11,19,42.1%,27m
43829,2,Grogswiper,1998,165,7,9,16,43.8%,3h
43829,2,[cl0udM]XDkellan,1998,180,6,5,11,54.5%,1h
43829,1,Wuda,1998,182,6,15,21,28.6%,3h
43829,3,[lolzzz]Kikiriskiaga,1998,148,4,4,8,50.0%,37m
43829,2,Stugots,1998,151,4,4,8,50.0%,3h
43829,2,silvernympho,1998,92,2,4,6,33.3%,1h
43829,3,Vicc,1998,0,1,0,1,100.0%,55m
43829,3,[3MPIRE]Sebthegreat,1998,30,1,1,2,50.0%,1h
43829,2,mreevit,1998,0,1,2,3,33.3%,23m
43829,3,AndresLoor,1998,30,1,3,4,25.0%,25m
43829,3,yVinyDEFQON,1998,0,0,1,1,0.0%,6m
43829,3,NSampson,1998,0,0,1,1,0.0%,1h
43829,3,MegaMagz,1998,0,0,1,1,0.0%,1h
43829,3,Creplord,1998,0,0,1,1,0.0%,1h
43829,2,Trooper,1998,0,0,2,2,0.0%,1h
43829,2,TheChemist,1998,0,0,6,6,0.0%,1h
43829,2,lor,1998,0,0,6,6,0.0%,1h
43855,3,LaTigresa,1997,1492,184,202,386,47.7%,3h
43855,2,Peter,1997,1456,64,71,135,47.4%,3h
43855,2,VGMDETAILR,1997,1395,52,56,108,48.1%,3h
43855,3,USAndoPC,1997,1186,49,42,91,53.8%,4m
43855,2,CaptCanuck,1997,261,34,26,60,56.7%,1h
43855,2,JPunleashed,1997,762,27,34,61,44.3%,1h
43855,2,[soypro]Agakson,1997,477,25,21,46,54.3%,3m
43855,2,[LAGGT]FURIOSA,1997,578,19,28,47,40.4%,1h
43855,2,TheFck,1997,211,8,7,15,53.3%,1h
43855,2,Antotabo,1997,236,7,12,19,36.8%,34m
43855,3,Chengiskhan,1997,205,6,15,21,28.6%,26m
43855,2,[PchBgs]spacemanspif,1997,258,5,10,15,33.3%,3h
43855,2,Tareq,1997,60,3,5,8,37.5%,1h
43855,1,[RA0ARC]arc,1997,165,3,6,9,33.3%,1h
43855,1,KorbenDallas,1997,0,3,6,9,33.3%,1h
43855,3,[0825]blackjezus,1997,46,2,3,5,40.0%,1h
43855,2,LGMMaverik,1997,46,1,6,7,14.3%,1h
43855,2,Nabla,1997,46,1,7,8,12.5%,42m
43855,1,PrettyGirlk,1997,0,1,8,9,11.1%,34m
43855,2,Striker,1997,30,1,9,10,10.0%,3h
43855,3,Majestic,1997,0,1,9,10,10.0%,9m
43855,3,BurritoBoy,1997,0,0,1,1,0.0%,1h
43855,3,[PobSC]Apare,1997,0,0,1,1,0.0%,1h
43855,3,ENKI,1997,0,0,1,1,0.0%,1h
43855,2,MorningStar,1997,0,0,6,6,0.0%,1h
43880,1,Reload,1996,1623,222,240,462,48.1%,3h
43880,2,jbthekingpin,1996,1591,174,180,354,49.2%,1m
43880,2,MagicTurtle,1996,552,38,28,66,57.6%,3h
43880,1,chaman,1996,562,19,27,46,41.3%,3h
43880,1,ytrewq,1996,620,19,36,55,34.5%,10m
43880,2,deivid,1996,290,16,15,31,51.6%,1h
43880,2,JeffRD,1996,292,11,13,24,45.8%,3h
43880,2,[CLRTBS]Acerth,1996,234,9,7,16,56.2%,16m
43880,2,Makawy,1996,192,7,5,12,58.3%,16m
43880,3,Zaldre,1996,248,7,17,24,29.2%,55m
43880,2,BigRiek,1996,174,6,15,21,28.6%,32m
43880,3,DaBesht,1996,90,5,13,18,27.8%,51m
43880,1,Viri,1996,94,3,2,5,60.0%,1h
43880,1,Apollineo,1996,119,3,3,6,50.0%,1h
43880,2,skoog,1996,88,3,9,12,25.0%,1h
43880,3,PotatOzuki,1996,44,3,10,13,23.1%,1h
43880,2,Turtleterran,1996,148,3,12,15,20.0%,50m
43880,3,SHADOWDRAGON,1996,60,2,3,5,40.0%,58m
43880,2,John,1996,46,2,3,5,40.0%,3h
43880,2,IWuanaX,1996,102,2,4,6,33.3%,16m
43880,1,[iMECH]CALL,1996,94,2,4,6,33.3%,10m
43880,2,Tipples,1996,94,2,6,8,25.0%,3h
43880,2,bwalkjishin,1996,95,2,7,9,22.2%,1h
43880,2,elbermix,1996,0,1,0,1,100.0%,1h
43880,3,farid,1996,0,1,1,2,50.0%,1h
43880,2,Temperaize,1996,92,1,5,6,16.7%,1h
43880,1,manox,1996,0,1,7,8,12.5%,3h
43880,1,[LCE]Juanito,1996,0,1,8,9,11.1%,3h
43880,3,linkborg,1996,0,0,1,1,0.0%,15m
43880,2,ANDROS,1996,0,0,2,2,0.0%,3h
43880,3,Harbinger,1996,0,0,5,5,0.0%,15m
43911,1,[Fever]gebug,1995,1322,111,122,233,47.6%,58m
43911,3,[SANGRE]OldSchool,1995,1213,58,61,119,48.7%,43m
43911,2,eSentrik,1995,1098,57,67,124,46.0%,1h
43911,2,[KSRP]HarryLeTaint,1995,914,52,49,101,51.5%,1h
43911,1,Elements,1995,1045,49,56,105,46.7%,3h
43911,2,Thor,1995,1082,42,42,84,50.0%,1h
43911,3,Jeewbacca,1995,1030,36,47,83,43.4%,1h
43911,2,Galimatías,1995,660,27,23,50,54.0%,3h
43911,2,mija,1995,679,27,33,60,45.0%,3h
43911,2,retribution,1995,710,25,31,56,44.6%,6m
43911,2,FOPIPOWER,1995,438,20,25,45,44.4%,35m
43911,2,DACASHOES,1995,266,10,13,23,43.5%,60m
43911,2,[urdone]InSaNiTy,1995,217,9,6,15,60.0%,1h
43911,2,Python,1995,144,6,8,14,42.9%,42m
43911,2,Eggheadedegg,1995,200,6,14,20,30.0%,3h
43911,3,Gonza,1995,146,5,5,10,50.0%,8m
43911,2,lui,1995,133,4,6,10,40.0%,1h
43911,2,HAYDO,1995,82,3,10,13,23.1%,3h
43911,3,Bubba,1995,0,2,3,5,40.0%,1h
43911,3,Tonkxin,1995,0,1,0,1,100.0%,11m
43911,3,zerofunk,1995,30,1,2,3,33.3%,55m
43911,2,sevagphoto,1995,30,1,6,7,14.3%,3h
43911,3,Lucga,1995,30,1,6,7,14.3%,31m
43911,3,Adrian,1995,0,0,1,1,0.0%,1h
43911,3,spanky,1995,0,0,2,2,0.0%,37m
43911,2,Hydralicious,1995,0,0,4,4,0.0%,3h
43911,3,Exo,1995,0,0,5,5,0.0%,3h
43938,1,slushydesk,1994,1647,176,196,372,47.3%,3h
43938,2,NickPeique,1994,538,19,24,43,44.2%,3h
43938,2,[CRAKS]zerathul,1994,453,17,15,32,53.1%,1h
43938,1,ASequoiaTree,1994,407,16,6,22,72.7%,12m
43938,2,Storm,1994,343,14,14,28,50.0%,27m
43938,2,BlitzBizzle,1994,207,6,8,14,42.9%,26m
43938,2,kvleb,1994,104,5,8,13,38.5%,3h
43938,2,Bones,1994,44,4,7,11,36.4%,1h
43938,3,laint,1994,60,3,2,5,60.0%,41m
43938,3,wawabob,1994,86,3,3,6,50.0%,3h
43938,1,HeroHamster,1994,48,3,9,12,25.0%,1h
43938,3,Marcos,1994,121,3,10,13,23.1%,13m
43938,1,[ZTemp]Khademi,1994,143,2,5,7,28.6%,3h
43938,1,Kazimo,1994,96,2,7,9,22.2%,8m
43938,2,[METL]polzni,1994,30,1,7,8,12.5%,60m
43938,2,sqerela,1994,0,0,1,1,0.0%,1h
43938,2,Jeff,1994,0,0,4,4,0.0%,1h
43938,2,CachaCholas,1994,0,0,6,6,0.0%,1h
43938,2,DaJuAsGuard,1994,0,0,6,6,0.0%,1h
43957,2,Geoffbad,1993,1436,87,112,199,43.7%,1h
43957,2,Black,1993,1049,43,42,85,50.6%,17m
43957,2,SanShava,1993,1076,42,43,85,49.4%,38m
43957,2,SPfc,1993,954,34,41,75,45.3%,1h
43957,3,samCH,1993,429,16,7,23,69.6%,1h
43957,2,Joaquin,1993,366,14,12,26,53.8%,39m
43957,2,Steezy,1993,352,12,17,29,41.4%,34m
43957,2,ovkskull,1993,295,11,11,22,50.0%,58m
43957,2,Lighthen,1993,302,10,12,22,45.5%,3h
43957,1,Spaceghost,1993,255,9,10,19,47.4%,8m
43957,1,linlin,1993,295,9,13,22,40.9%,8m
43957,1,MDREDD,1993,320,9,24,33,27.3%,60m
43957,3,FireFlamer,1993,226,8,7,15,53.3%,32m
43957,2,[CBBC]Sarjas,1993,264,7,12,19,36.8%,1h
43957,2,arosa,1993,86,3,4,7,42.9%,3h
43957,1,prizewalnut,1993,142,3,10,13,23.1%,33m
43957,3,Veritas,1993,58,2,4,6,33.3%,1h
43957,2,KLEMESK,1993,64,2,5,7,28.6%,3h
43957,3,Farnecio,1993,0,1,0,1,100.0%,3h
43957,1,BURRITOALBIN,1993,0,1,8,9,11.1%,19m
43957,1,joesmoe,1993,0,0,1,1,0.0%,1h
43957,3,Fumbles,1993,0,0,1,1,0.0%,51m
43957,3,TvFuzz,1993,0,0,2,2,0.0%,3h
43957,3,MrShadow,1993,0,0,2,2,0.0%,3h
43981,2,[BidenW]MrCheese,1992,1568,292,315,607,48.1%,1h
43981,2,wusspie,1992,1157,79,85,164,48.2%,3h
43981,2,ALPHADRAGON,1992,959,39,44,83,47.0%,32m
43981,2,ElverG,1992,447,20,16,36,55.6%,1h
43981,2,CaptainRukuz,1992,293,12,14,26,46.2%,50m
43981,2,[GAWDz]Jazzfan,1992,300,12,17,29,41.4%,3h
43981,1,JohnPoison,1992,326,12,19,31,38.7%,51m
43981,3,Robert,1992,222,8,8,16,50.0%,1h
43981,1,Flicker,1992,182,7,14,21,33.3%,1h
43981,1,Foushbag,1992,305,7,15,22,31.8%,8m
43981,3,TisAScratch,1992,86,4,1,5,80.0%,26m
43981,1,jadiel,1992,34,4,6,10,40.0%,3h
43981,3,Frank,1992,155,4,12,16,25.0%,37m
43981,2,[10th]Badazz,1992,88,3,10,13,23.1%,6m
43981,3,Sixblade,1992,125,3,11,14,21.4%,17m
43981,3,SimpleJack,1992,58,2,1,3,66.7%,43m
43981,2,leion,1992,76,2,9,11,18.2%,3h
43981,2,[c511]Mdenny,1992,0,1,0,1,100.0%,13m
43981,3,[SKyber]Arcanjo,1992,0,1,0,1,100.0%,24m
43981,2,redmid,1992,0,0,4,4,0.0%,2m
43981,2,[LBDeA]BDJoaq,1992,0,0,6,6,0.0%,3h
43981,2,TITSxDEFIANT,1992,0,0,6,6,0.0%,20m
44003,1,HunterPig,1991,1656,193,199,392,49.2%,5m
44003,3,TheLastSith,1991,1467,165,167,332,49.7%,1h
44003,2,Gers,1991,1565,74,85,159,46.5%,27m
44003,1,[SG]SGMattC,1991,770,55,68,123,44.7%,1h
44003,2,Sirluck,1991,1293,47,52,99,47.5%,3h
44003,2,terasilfo,1991,953,39,46,85,45.9%,1h
44003,2,Nevol,1991,511,37,41,78,47.4%,1h
44003,2,FernasRPG,1991,886,34,44,78,43.6%,3h
44003,2,HSB,1991,735,31,37,68,45.6%,1h
44003,3,Zlatan,1991,704,28,28,56,50.0%,30m
44003,2,Eddie,1991,341,16,12,28,57.1%,16m
44003,2,JeffDahmer,1991,394,15,16,31,48.4%,3h
44003,3,ninñawwwwwpp,1991,347,12,6,18,66.7%,41m
44003,3,Todas,1991,287,9,16,25,36.0%,38m
44003,1,TheDude,1991,272,9,19,28,32.1%,40m
44003,3,Job,1991,58,5,2,7,71.4%,1h
44003,2,TLT,1991,124,5,6,11,45.5%,1h
44003,2,Jay,1991,106,4,17,21,19.0%,3m
44003,1,itzbrant,1991,145,3,5,8,37.5%,3h
44003,2,Wrice,1991,123,3,9,12,25.0%,30m
44003,3,YungCooper,1991,60,2,3,5,40.0%,1h
44003,3,Demononics,1991,30,1,3,4,25.0%,1h
44003,2,[KBL]YORY,1991,0,1,4,5,20.0%,21m
44003,1,[VST]Lionhard,1991,48,1,6,7,14.3%,3h
44003,2,[lmrds]Rodrogo,1991,0,0,3,3,0.0%,27m
44003,2,Mirt,1991,0,0,6,6,0.0%,1h
44029,1,Cerwill,1990,1669,203,215,418,48.6%,40m
44029,2,Pacu,1990,1531,96,96,192,50.0%,30m
44029,2,MoneyKing,1990,1521,69,61,130,53.1%,20m
44029,2,ECLIPSAUN,1990,577,22,19,41,53.7%,1h
44029,3,[Drakes]fturpin,1990,428,15,21,36,41.7%,3m
44029,3,[oRuRo]elboliviano,1990,297,11,5,16,68.8%,3h
44029,3,JdssPEvolved,1990,230,9,8,17,52.9%,1h
44029,3,PREDATOR,1990,225,7,9,16,43.8%,28m
44029,2,UncleBoy,1990,206,6,8,14,42.9%,16m
44029,3,yopolo,1990,193,6,12,18,33.3%,3h
44029,3,Yaldi,1990,93,4,3,7,57.1%,27m
44029,1,SirYanni,1990,142,4,11,15,26.7%,33m
44029,3,Darvein,1990,86,3,2,5,60.0%,37m
44029,2,Xanthus,1990,138,3,10,13,23.1%,1h
44029,3,[FTLT]Jardel,1990,58,2,1,3,66.7%,17m
44029,2,Pop,1990,138,2,2,4,50.0%,1h
44029,1,Susie,1990,132,2,9,11,18.2%,1h
44029,3,[KANGS]Adoc,1990,0,1,0,1,100.0%,1h
44029,1,Jag,1990,0,1,8,9,11.1%,8m
44029,2,chibs,1990,44,1,10,11,9.1%,58m
44029,3,Paladin,1990,0,0,1,1,0.0%,35m
44029,2,WillyWonca,1990,0,0,2,2,0.0%,11m
44029,3,[cocogr]Rico,1990,0,0,5,5,0.0%,38m
44029,2,Septraverse,1990,0,0,6,6,0.0%,1h
44029,2,Quellius,1990,0,0,6,6,0.0%,51m
44029,2,loker,1990,0,0,6,6,0.0%,16m
44055,2,irieSkants,1989,1102,119,137,256,46.5%,58m
44055,2,StarPlayer,1989,1080,73,87,160,45.6%,1h
44055,2,TwlghtSprkle,1989,1509,68,89,157,43.3%,20m
44055,2,BolsonaroRJ,1989,1164,60,56,116,51.7%,57m
44055,3,dubahyu,1989,1539,59,61,120,49.2%,8m
44055,3,Darkstar,1989,1410,58,75,133,43.6%,3m
44055,2,ToxicG,1989,630,46,53,99,46.5%,1h
44055,3,belikser,1989,1096,40,41,81,49.4%,28m
44055,2,CHARISSEYCUP,1989,1030,40,42,82,48.8%,1h
44055,1,MeanMrMustrd,1989,812,25,35,60,41.7%,17m
44055,1,[COPD]YOUNGJUN,1989,687,24,29,53,45.3%,43m
44055,2,TNT,1989,222,21,24,45,46.7%,1h
44055,2,WUNEYE,1989,454,16,31,47,34.0%,50m
44055,2,GIANCARLOQT,1989,412,13,24,37,35.1%,3h
44055,3,HiddenSquid,1989,341,10,19,29,34.5%,3m
44055,2,[504Hn]SeawolfHN,1989,244,9,7,16,56.2%,17m
44055,3,coleykens,1989,210,8,7,15,53.3%,2h
44055,2,SharkFace,1989,194,5,9,14,35.7%,1h
44055,1,polymesh,1989,218,5,13,18,27.8%,3h
44055,1,Jlerms,1989,152,5,13,18,27.8%,1h
44055,3,MorrowZombie,1989,60,4,13,17,23.5%,25m
44055,2,YOGOTES,1989,110,3,9,12,25.0%,16m
44055,1,cheeseyfart,1989,66,2,6,8,25.0%,3h
44055,2,[TRRR]Curtiss,1989,58,2,8,10,20.0%,34m
44055,3,ScorchLamar,1989,0,1,0,1,100.0%,1h
44055,2,ElCanelas,1989,0,1,2,3,33.3%,3h
44055,3,Edu,1989,0,1,4,5,20.0%,15m
44055,3,AresVico,1989,0,0,1,1,0.0%,21m
44055,3,KaKaYIV,1989,0,0,5,5,0.0%,1h
44055,2,direraven,1989,0,0,6,6,0.0%,13m
44055,2,ShadySusy,1989,0,0,7,7,0.0%,11m
44086,1,Leo,1988,1656,220,234,454,48.5%,9m
44086,1,Lazaruz,1988,1646,160,220,380,42.1%,1h
44086,1,EriktheRed,1988,861,99,102,201,49.3%,3h
44086,2,CombatJester,1988,1563,92,92,184,50.0%,3h
44086,2,Deathkeeper,1988,807,81,77,158,51.3%,9m
44086,2,SuperWamazo,1988,1474,76,87,163,46.6%,1h
44086,3,macrolord,1988,598,29,8,37,78.4%,3h
44086,2,Carlos,1988,782,29,35,64,45.3%,60m
44086,2,Pietroski,1988,617,22,30,52,42.3%,3h
44086,3,AvengerIl,1988,214,17,16,33,51.5%,24m
44086,2,[ALLIN1]DaddyJoeNZ,1988,442,16,18,34,47.1%,1h
44086,2,Zergalerg,1988,324,15,16,31,48.4%,1h
44086,2,shdowwarrior,1988,376,12,18,30,40.0%,9m
44086,3,Persona,1988,192,9,7,16,56.2%,2h
44086,2,Odin,1988,151,5,5,10,50.0%,11m
44086,2,WAARGH,1988,211,5,8,13,38.5%,3h
44086,2,[cluez]zerotwo,1988,157,3,4,7,42.9%,58m
44086,2,[INKA5]ElGatoGordo,1988,88,3,4,7,42.9%,3h
44086,3,DaGrizzman,1988,72,3,6,9,33.3%,25m
44086,2,MoPhillipz,1988,104,3,10,13,23.1%,1h
44086,2,ANGELFIRE,1988,96,2,7,9,22.2%,1h
44086,2,Otto,1988,0,1,1,2,50.0%,28m
44086,3,[KGIA]Tassillio,1988,0,1,4,5,20.0%,1h
44086,3,Twitchy,1988,0,1,5,6,16.7%,1h
44086,2,AidanPryde,1988,46,1,7,8,12.5%,8m
44086,2,LaoshiChingo,1988,44,1,8,9,11.1%,3h
44086,3,AubieJay,1988,0,0,2,2,0.0%,1h
44086,2,iSpiGaO,1988,0,0,2,2,0.0%,42m
44086,3,jarobyte,1988,0,0,5,5,0.0%,39m
44086,2,FrickinA,1988,0,0,6,6,0.0%,3h
44116,2,Sludge,1987,1072,39,42,81,48.1%,1h
44116,2,juakocrack,1987,993,37,46,83,44.6%,1h
44116,2,[OPMs]Berserk,1987,940,35,35,70,50.0%,1h
44116,3,Scubatropin,1987,760,33,20,53,62.3%,3m
44116,3,AlexRaider,1987,454,17,15,32,53.1%,3m
44116,2,alvaro,1987,396,15,20,35,42.9%,58m
44116,2,VDPtas,1987,248,10,11,21,47.6%,24m
44116,3,ASD,1987,30,5,1,6,83.3%,3m
44116,3,[TCOIH]ShadowCaster,1987,152,5,4,9,55.6%,3m
44116,1,Nitro,1987,158,5,8,13,38.5%,3h
44116,2,Govenor,1987,117,5,13,18,27.8%,3h
44116,1,Horizon,1987,152,5,13,18,27.8%,2m
44116,2,DegenWeasel,1987,60,3,4,7,42.9%,1h
44116,1,CrixusTM,1987,96,3,5,8,37.5%,29m
44116,2,Agecraft,1987,58,3,8,11,27.3%,1h
44116,3,Santapaws,1987,58,2,2,4,50.0%,41m
44116,3,[EZTAXI]Beast,1987,58,2,3,5,40.0%,11m
44116,2,[OPKZ]conceptmatt,1987,46,2,3,5,40.0%,1h
44116,1,MidnightXxX,1987,0,2,6,8,25.0%,19m
44116,3,Greygore,1987,0,1,1,2,50.0%,1h
44116,2,IBLACKIHEART,1987,0,1,2,3,33.3%,42m
44116,2,[KhanTv]Rafael,1987,94,1,4,5,20.0%,3h
44116,2,[451st]comgame,1987,99,1,5,6,16.7%,41m
44116,3,DopaminE,1987,30,1,5,6,16.7%,47m
44116,3,seno,1987,0,0,1,1,0.0%,9m
44116,3,WOMBAT,1987,0,0,1,1,0.0%,8m
44116,3,cuellonegro,1987,0,0,1,1,0.0%,22m
44116,1,REDENTOR,1987,0,0,3,3,0.0%,3h
44144,2,Arikel,1986,1572,69,79,148,46.6%,34m
44144,2,[R4PT0R]Perla,1986,1007,38,41,79,48.1%,1h
44144,2,grantemplari,1986,1002,38,45,83,45.8%,33m
44144,2,[L501st]JTKirk,1986,674,25,29,54,46.3%,50m
44144,1,Briggz,1986,828,25,41,66,37.9%,1h
44144,2,GudStuff,1986,152,5,13,18,27.8%,3h
44144,3,CRahj,1986,174,5,14,19,26.3%,3h
44144,3,JoelFH,1986,118,4,2,6,66.7%,1h
44144,2,ODBrent,1986,86,4,5,9,44.4%,1h
44144,1,Astyopyxl,1986,142,4,12,16,25.0%,1h
44144,2,goyo,1986,121,3,1,4,75.0%,3h
44144,3,Jason,1986,58,3,3,6,50.0%,3h
44144,3,JHCARAJOXD,1986,88,3,3,6,50.0%,14m
44144,1,lilgonzo,1986,38,2,9,11,18.2%,3h
44144,2,Church,1986,88,2,10,12,16.7%,1h
44144,3,TSquared,1986,0,1,1,2,50.0%,25m
44144,3,kinoks,1986,30,1,3,4,25.0%,9m
44144,1,Javo,1986,0,1,5,6,16.7%,1h
44144,2,DeadRemus,1986,0,1,6,7,14.3%,1h
44144,2,Brandonious,1986,30,1,7,8,12.5%,13m
44144,3,[KuShQc]Aurak,1986,0,0,1,1,0.0%,3h
44144,3,[GRINDR]HBarcaDiaz,1986,0,0,1,1,0.0%,52m
44144,3,elbarÇnrojo,1986,0,0,1,1,0.0%,1h
44144,3,iDonnie,1986,0,0,1,1,0.0%,1h
44144,1,ChKOW,1986,0,0,3,3,0.0%,2m
44144,2,BlackBeard,1986,0,0,4,4,0.0%,3h
44144,2,DesNTroy,1986,0,0,4,4,0.0%,1h
44144,2,XiaoQuanQuan,1986,0,0,6,6,0.0%,1h
44172,1,Stodmaster,1985,1652,483,547,1030,46.9%,49m
44172,2,JessicaSilva,1985,1546,171,181,352,48.6%,34m
44172,2,[TNTW]SaltyyMercy,1985,1104,41,45,86,47.7%,17m
44172,3,YAYO,1985,504,19,31,50,38.0%,1h
44172,3,TTH,1985,402,14,14,28,50.0%,1h
44172,2,CrowOfLight,1985,381,14,14,28,50.0%,60m
44172,2,Gabotwister,1985,404,14,20,34,41.2%,33m
44172,2,ElWaloXD,1985,208,8,7,15,53.3%,3h
44172,2,[Msia]ChangTian,1985,214,7,15,22,31.8%,1h
44172,1,JackHerrer,1985,232,7,16,23,30.4%,51m
44172,3,nimrod,1985,207,6,2,8,75.0%,3h
44172,2,Raziel,1985,213,6,7,13,46.2%,51m
44172,3,Nukeapple,1985,159,5,6,11,45.5%,1h
44172,2,basHimura,1985,170,5,8,13,38.5%,1h
44172,3,quest,1985,114,4,4,8,50.0%,55m
44172,2,[TSLP]LATCaf,1985,48,4,6,10,40.0%,13m
44172,2,dabigmac,1985,124,4,8,12,33.3%,1h
44172,2,randymarsh,1985,120,4,12,16,25.0%,42m
44172,1,[USWAG]DanielC,1985,118,3,3,6,50.0%,8m
44172,1,SeriousSenpa,1985,124,2,8,10,20.0%,51m
44172,2,VAJim,1985,110,2,8,10,20.0%,1h
44172,3,Baselerd,1985,0,1,0,1,100.0%,1h
44172,1,[Tenn]Dagus,1985,0,1,0,1,100.0%,1h
44172,3,Chief,1985,0,1,0,1,100.0%,46m
44172,3,Liquid,1985,0,0,1,1,0.0%,1h
44172,2,VLANADEK,1985,0,0,6,6,0.0%,1h
44172,2,Khyber,1985,0,0,6,6,0.0%,3m
44199,1,marriolac,1984,1526,129,140,269,48.0%,25m
44199,2,[FatMom]willwar,1984,1146,75,81,156,48.1%,1h
44199,2,TinSoldier,1984,1426,63,57,120,52.5%,3h
44199,2,[ILMG]Joey,1984,1062,57,50,107,53.3%,1h
44199,2,devastator,1984,566,20,25,45,44.4%,1h
44199,3,NickSwisk,1984,327,11,9,20,55.0%,41m
44199,3,Dumpster,1984,297,10,10,20,50.0%,28m
44199,3,Darkkingt,1984,268,8,9,17,47.1%,2h
44199,3,Meebly,1984,232,8,10,18,44.4%,1h
44199,2,Noah,1984,156,7,14,21,33.3%,39m
44199,3,ssanai,1984,228,6,7,13,46.2%,1h
44199,2,[eSx]Rave,1984,126,3,3,6,50.0%,3h
44199,2,Titanium,1984,32,2,8,10,20.0%,1h
44199,3,ImHere,1984,91,1,7,8,12.5%,2h
44199,2,Xifre,1984,0,1,8,9,11.1%,41m
44199,3,DanTheLems,1984,0,0,1,1,0.0%,3m
44199,2,thatguyyoukn,1984,0,0,3,3,0.0%,39m
44199,2,Idunidas,1984,0,0,3,3,0.0%,11m
44199,2,Therion,1984,0,0,6,6,0.0%,34m
44218,2,KAIZENLENNY,1983,1614,201,225,426,47.2%,39m
44218,3,mantiss,1983,1603,185,256,441,42.0%,3h
44218,2,johnsonyang,1983,862,103,103,206,50.0%,38m
44218,2,[VINGAD]Polegar,1983,1428,87,98,185,47.0%,39m
44218,2,glMELGAREJO,1983,1553,83,94,177,46.9%,1h
44218,1,LoTuSsSs,1983,1516,53,73,126,42.1%,30m
44218,2,TommySQM,1983,1025,49,50,99,49.5%,1h
44218,2,neftiss,1983,1174,43,51,94,45.7%,3h
44218,3,Tekuani,1983,711,32,44,76,42.1%,38m
44218,2,Ikaika,1983,681,29,27,56,51.8%,1h
44218,2,shubert,1983,709,26,38,64,40.6%,57m
44218,3,Mithrandir,1983,786,25,42,67,37.3%,1h
44218,2,XplooD,1983,545,18,29,47,38.3%,1h
44218,3,Casino,1983,278,10,10,20,50.0%,1h
44218,3,Achilles,1983,404,10,30,40,25.0%,37m
44218,3,GROZLEX,1983,290,9,10,19,47.4%,6m
44218,2,Bdogg,1983,30,5,10,15,33.3%,1h
44218,1,Nikolazgg,1983,191,5,12,17,29.4%,1h
44218,2,ShadyNasty,1983,40,5,13,18,27.8%,3m
44218,3,[FailSq]Torque,1983,100,3,5,8,37.5%,9m
44218,2,MrBota,1983,102,3,10,13,23.1%,3h
44218,1,ThegodFather,1983,0,1,2,3,33.3%,1h
44218,2,mutabeast,1983,0,1,3,4,25.0%,3h
44218,1,Dahl,1983,48,1,3,4,25.0%,1h
44218,2,PabloNz,1983,0,1,6,7,14.3%,1h
44218,3,[XPSCG]Lolso,1983,0,0,5,5,0.0%,27m
44218,2,Buck,1983,0,0,6,6,0.0%,3h
44245,3,Slay,1982,1319,55,54,109,50.5%,35m
44245,3,Wombosi,1982,867,50,50,100,50.0%,3h
44245,2,[TuRtel]Wreckful,1982,348,46,53,99,46.5%,35m
44245,2,AmonRamon,1982,928,33,44,77,42.9%,3h
44245,2,EchoShib,1982,716,28,26,54,51.9%,14m
44245,1,GeneralRygar,1982,682,23,34,57,40.4%,48m
44245,1,Fardoche,1982,596,20,29,49,40.8%,1h
44245,3,TheOne,1982,419,14,15,29,48.3%,3h
44245,2,ELMEJORPVP,1982,269,11,20,31,35.5%,58m
44245,2,Peachy,1982,130,6,18,24,25.0%,60m
44245,3,MatheusAlves,1982,60,5,3,8,62.5%,1h
44245,3,CerTaiN,1982,86,4,2,6,66.7%,46m
44245,3,Noobguy,1982,60,3,2,5,60.0%,3h
44245,2,Bolsas,1982,122,3,3,6,50.0%,1h
44245,3,Deathtowel,1982,88,3,6,9,33.3%,1h
44245,3,Kavod,1982,60,2,2,4,50.0%,38m
44245,3,FatAl,1982,58,2,3,5,40.0%,43m
44245,3,Templar,1982,139,2,3,5,40.0%,1h
44245,1,drogadicto,1982,145,2,5,7,28.6%,8m
44245,3,Hamster,1982,0,2,11,13,15.4%,11m
44245,3,BenWest,1982,30,1,1,2,50.0%,25m
44245,2,sandskee,1982,48,1,2,3,33.3%,8m
44245,3,rvntone,1982,30,1,2,3,33.3%,35m
44245,1,Ecorella,1982,0,1,6,7,14.3%,1h
44245,2,DocCovid,1982,88,1,6,7,14.3%,1h
44245,2,Eris,1982,0,0,3,3,0.0%,3h
44245,1,rolly,1982,0,0,4,4,0.0%,8m
44245,2,LittleJedi,1982,0,0,6,6,0.0%,3h
44245,2,Zaktheboss,1982,0,0,6,6,0.0%,3h
44245,2,queenSOFIA,1982,0,0,7,7,0.0%,22m
44275,1,Downtown,1981,1554,138,145,283,48.8%,49m
44275,2,[CqmB]astrozombie,1981,1248,69,79,148,46.6%,1h
44275,2,loc,1981,1018,37,41,78,47.4%,14m
44275,1,Toker,1981,482,18,23,41,43.9%,3h
44275,2,Favhos,1981,396,14,16,30,46.7%,3h
44275,2,arnabing,1981,320,11,17,28,39.3%,1h
44275,3,Blank,1981,258,8,11,19,42.1%,1h
44275,1,LrdRicardo,1981,229,8,12,20,40.0%,1h
44275,2,BigBlue,1981,30,5,3,8,62.5%,1h
44275,2,Migbon,1981,141,5,7,12,41.7%,1h
44275,2,CAZPER,1981,201,5,10,15,33.3%,16m
44275,3,satyamDaBest,1981,88,3,5,8,37.5%,58m
44275,3,[Flexy]flexon,1981,97,2,10,12,16.7%,3h
44275,3,[Hulu]TheTrain,1981,30,1,1,2,50.0%,47m
44275,2,DTMaster,1981,0,1,1,2,50.0%,1h
44275,3,Kigava,1981,0,0,5,5,0.0%,28m
44275,2,WaitForIt,1981,0,0,6,6,0.0%,1h
44275,2,krosaPH,1981,0,0,6,6,0.0%,51m
44275,2,[LHDSC]artanis,1981,0,0,7,7,0.0%,3h
44294,1,Paul,1980,347,78,88,166,47.0%,1h
44294,3,MorgunFryman,1980,1612,57,71,128,44.5%,9m
44294,2,NewFrenchman,1980,690,28,25,53,52.8%,1m
44294,2,ALLEGADOTHOR,1980,613,27,33,60,45.0%,3h
44294,2,GanDalf,1980,617,22,27,49,44.9%,2m
44294,2,Joqer,1980,270,12,15,27,44.4%,1h
44294,3,HuySunVin,1980,333,11,12,23,47.8%,38m
44294,3,STEVEN,1980,308,9,5,14,64.3%,1h
44294,3,Alseer,1980,265,9,16,25,36.0%,22m
44294,2,Matthew,1980,252,8,15,23,34.8%,3h
44294,2,Muscodor,1980,119,6,4,10,60.0%,3m
44294,1,DocGwedo,1980,188,5,7,12,41.7%,1h
44294,2,IronSide,1980,94,4,7,11,36.4%,1h
44294,1,Molotov,1980,165,4,11,15,26.7%,1h
44294,2,Aletra,1980,124,3,5,8,37.5%,42m
44294,1,YaBoiBien,1980,109,2,6,8,25.0%,49m
44294,2,Chaos,1980,0,1,6,7,14.3%,3h
44294,3,TOBEN,1980,0,0,1,1,0.0%,1h
44294,2,[GOPERÚ]FULCRUM,1980,0,0,4,4,0.0%,3h
44294,3,Pepicha,1980,0,0,5,5,0.0%,41m
44314,2,MongolKhan,1979,738,28,29,57,49.1%,41m
44314,2,WillyWagTail,1979,720,27,28,55,49.1%,3h
44314,2,Soren,1979,316,11,14,25,44.0%,3h
44314,3,Noah,1979,148,5,5,10,50.0%,1h
44314,3,SteakSauce,1979,120,4,6,10,40.0%,44m
44314,2,alisteanibal,1979,168,4,8,12,33.3%,3h
44314,1,DikTation,1979,193,4,11,15,26.7%,17m
44314,3,[SCVM]KilledJoy,1979,86,3,5,8,37.5%,1h
44314,2,[DeCan]DeRedTigeris,1979,46,2,1,3,66.7%,42m
44314,2,Elementre,1979,60,2,9,11,18.2%,3h
44314,3,SummerRiver,1979,30,1,2,3,33.3%,1h
44314,3,CrimeFighter,1979,30,1,2,3,33.3%,41m
44314,3,joe,1979,0,0,1,1,0.0%,32m
44314,2,jollybutter,1979,0,0,2,2,0.0%,28m
44314,2,MrYummy,1979,0,0,6,6,0.0%,1h
44329,1,Stilgar,1978,1547,80,99,179,44.7%,17m
44329,2,darktalker,1978,1482,79,85,164,48.2%,1h
44329,2,[grches]Repooc,1978,1137,47,44,91,51.6%,20m
44329,3,Pandemonium,1978,624,21,24,45,46.7%,1h
44329,2,Rauptimus,1978,292,12,20,32,37.5%,58m
44329,3,zxuGx,1978,198,7,17,24,29.2%,1h
44329,2,Bean,1978,196,6,13,19,31.6%,45m
44329,2,Gambit,1978,206,6,14,20,30.0%,3h
44329,3,Korsaunts,1978,154,5,5,10,50.0%,38m
44329,3,Eric,1978,155,5,9,14,35.7%,30m
44329,2,Expendable,1978,160,5,14,19,26.3%,3h
44329,2,[HYD2]Biz,1978,88,4,6,10,40.0%,3h
44329,1,[BoX]Bogan,1978,136,4,13,17,23.5%,3h
44329,3,Faradramir,1978,62,3,11,14,21.4%,1h
44329,1,Antilochus,1978,48,2,6,8,25.0%,1h
44329,2,vantorscII,1978,0,2,6,8,25.0%,1h
44329,3,Kronx,1978,0,1,0,1,100.0%,27m
44329,3,[RW5150]amartnza,1978,0,1,0,1,100.0%,1h
44329,3,omb,1978,0,1,0,1,100.0%,24m
44329,1,PTifon,1978,48,1,1,2,50.0%,6m
44329,2,Dante,1978,48,1,7,8,12.5%,1h
44329,1,killdbydeath,1978,0,1,8,9,11.1%,46m
44329,2,kolber,1978,48,1,9,10,10.0%,1h
44329,3,Jakumatuba,1978,0,0,1,1,0.0%,46m
44329,1,[MotW]Happybuttons,1978,0,0,1,1,0.0%,2m
44329,3,BattleRazer,1978,0,0,5,5,0.0%,1h
44329,2,DanxkingX,1978,0,0,7,7,0.0%,3h
44329,2,notoriousBIG,1978,0,0,7,7,0.0%,1h
44329,2,[Omadin]YourMudder,1978,0,0,7,7,0.0%,1h
44358,2,Chamuko,1977,1343,69,69,138,50.0%,6m
44358,2,Martantovic,1977,1319,48,59,107,44.9%,1h
44358,1,caole,1977,525,35,44,79,44.3%,25m
44358,2,EINAR,1977,735,29,29,58,50.0%,26m
44358,1,INTINST,1977,800,29,44,73,39.7%,1h
44358,2,[M4SS1V]ITURTLEI,1977,446,15,21,36,41.7%,3h
44358,3,[Ur0b0r]RaaHBens,1977,294,11,13,24,45.8%,28m
44358,1,eclipserP,1977,257,9,16,25,36.0%,3h
44358,1,colinmoretti,1977,228,8,15,23,34.8%,3h
44358,3,BattleLee,1977,223,6,8,14,42.9%,37m
44358,2,[XurFR]PrismGaming,1977,157,5,2,7,71.4%,3h
44358,3,DECOTRAB,1977,97,4,2,6,66.7%,1h
44358,3,[FTLTX]Chaloman,1977,98,4,3,7,57.1%,1h
44358,1,Mac,1977,110,4,12,16,25.0%,42m
44358,3,MageFar,1977,58,3,2,5,60.0%,28m
44358,3,Lucifer,1977,86,3,3,6,50.0%,4m
44358,3,goodtrouble,1977,58,2,1,3,66.7%,58m
44358,2,oscarjeff,1977,92,2,8,10,20.0%,11m
44358,3,carlangas,1977,0,1,0,1,100.0%,1h
44358,1,MarcelitoYT,1977,0,1,0,1,100.0%,10m
44358,2,[CrazyC]Antaury,1977,0,1,1,2,50.0%,3h
44358,3,IkarosKurumi,1977,30,1,3,4,25.0%,31m
44358,2,[B0NER]bloodysack,1977,0,1,7,8,12.5%,1h
44358,3,[Aiur17]Spike,1977,0,0,1,1,0.0%,1h
44358,3,Ulk,1977,0,0,1,1,0.0%,1h
44358,2,Rom,1977,0,0,3,3,0.0%,11m
44358,2,tkotap,1977,0,0,4,4,0.0%,17m
44358,2,gioothegreat,1977,0,0,5,5,0.0%,58m
44358,2,Twisteck,1977,0,0,6,6,0.0%,3m
44358,2,RedThreat,1977,0,0,6,6,0.0%,3h
44388,1,Gasman,1976,1629,272,295,567,48.0%,3h
44388,1,John,1976,1415,159,167,326,48.8%,37m
44388,2,Mikoto,1976,1411,133,170,303,43.9%,1h
44388,2,[CyeX]caveman,1976,1575,128,138,266,48.1%,57m
44388,3,elCharly,1976,1585,68,79,147,46.3%,1h
44388,3,kitsune,1976,861,37,22,59,62.7%,3h
44388,3,[C0NC1L]Woozard,1976,619,24,17,41,58.5%,3m
44388,2,[E8]Kelvinator,1976,591,19,30,49,38.8%,3h
44388,2,Dnysc,1976,363,17,27,44,38.6%,3m
44388,2,Grandis,1976,394,13,24,37,35.1%,45m
44388,3,Yellowstone,1976,216,7,9,16,43.8%,1h
44388,2,Torch,1976,122,4,8,12,33.3%,3h
44388,3,Anonymus,1976,60,3,3,6,50.0%,24m
44388,1,Gisastoj,1976,48,2,10,12,16.7%,10m
44388,2,Shugahill,1976,96,2,10,12,16.7%,1h
44388,2,[AOeOP]Bob,1976,0,1,2,3,33.3%,1h
44388,2,Jairolenze,1976,88,1,7,8,12.5%,1h
44388,3,Scooby,1976,0,0,1,1,0.0%,19m
44388,2,ruskjj,1976,0,0,5,5,0.0%,24m
44407,2,Grandpa,1975,1611,69,68,137,50.4%,60m
44407,3,[GBombs]DropADeuce,1975,1274,63,62,125,50.4%,17m
44407,1,[FUMON]elcafre,1975,707,34,43,77,44.2%,1h
44407,2,[XpKAc]BombaCasera,1975,561,27,35,62,43.5%,3h
44407,3,[TxPain]Leopardeye,1975,434,17,2,19,89.5%,17m
44407,2,GatoxD,1975,343,17,13,30,56.7%,1h
44407,3,Paul,1975,438,16,16,32,50.0%,47m
44407,1,DragonTamer,1975,395,13,18,31,41.9%,49m
44407,3,MisterDisco,1975,335,12,22,34,35.3%,37m
44407,1,Valentinex,1975,219,7,10,17,41.2%,1h
44407,3,DropVolume,1975,193,6,7,13,46.2%,31m
44407,3,[JUGOS]alexis,1975,90,4,4,8,50.0%,3m
44407,2,igierard,1975,173,4,9,13,30.8%,1h
44407,2,AsuraRage,1975,174,4,11,15,26.7%,1h
44407,2,CharlesBarni,1975,62,3,4,7,42.9%,3h
44407,2,VoteDonald,1975,30,2,4,6,33.3%,14m
44407,1,Zaik,1975,30,2,9,11,18.2%,1h
44407,3,DepressiveOw,1975,30,1,1,2,50.0%,1h
44407,3,Levi,1975,30,1,1,2,50.0%,1h
44407,3,doom,1975,30,1,2,3,33.3%,41m
44407,2,Franzylau,1975,46,1,2,3,33.3%,1h
44407,2,MrMonacle,1975,30,1,3,4,25.0%,1h
44407,3,assmcgee,1975,0,0,2,2,0.0%,3h
44407,1,[ConFed]Danteexe,1975,0,0,4,4,0.0%,12m
44431,2,Maximus,1974,1573,234,339,573,40.8%,17m
44431,2,sergiohi,1974,1297,129,149,278,46.4%,3h
44431,2,Rick,1974,1260,96,101,197,48.7%,21m
44431,2,sasin,1974,1527,75,74,149,50.3%,1h
44431,2,Linfocito,1974,1021,38,51,89,42.7%,3h
44431,3,BigNoobL,1974,791,35,26,61,57.4%,24m
44431,2,yukigira,1974,620,23,26,49,46.9%,3h
44431,2,Sekuv,1974,377,15,12,27,55.6%,3h
44431,2,deej,1974,200,10,10,20,50.0%,1h
44431,2,xOsmosx,1974,238,8,18,26,30.8%,57m
44431,1,Selektor,1974,274,7,13,20,35.0%,17m
44431,1,Inferno,1974,263,6,12,18,33.3%,8m
44431,3,eMaL,1974,86,3,3,6,50.0%,3h
44431,3,Orcidna,1974,32,2,1,3,66.7%,1h
44431,3,[4Sci]Skepsis,1974,0,2,4,6,33.3%,3h
44431,2,BlackMudFlap,1974,30,1,7,8,12.5%,1h
44431,3,DAnotnert,1974,0,0,2,2,0.0%,41m
44448,1,Dbfkid,1973,1507,164,191,355,46.2%,1h
44448,2,SgtUrAnus,1973,1505,162,187,349,46.4%,3h
44448,2,[xDYEx]Cetme,1973,1618,133,141,274,48.5%,1h
44448,3,[E10G]Bannanfage,1973,1186,54,74,128,42.2%,35m
44448,3,Lois,1973,1382,51,55,106,48.1%,3h
44448,2,HoylKnighJaY,1973,894,35,41,76,46.1%,1h
44448,2,[TrK]Corruptor,1973,683,24,31,55,43.6%,1h
44448,3,Fodcat,1973,394,15,11,26,57.7%,1h
44448,2,FelipeII,1973,410,14,21,35,40.0%,26m
44448,3,DragonEdge,1973,375,13,5,18,72.2%,38m
44448,2,Zergbriel,1973,326,12,19,31,38.7%,35m
44448,3,[POBLHA]QUETZALCOATL,1973,181,10,10,20,50.0%,1h
44448,2,Banister,1973,246,10,13,23,43.5%,17m
44448,3,pepperman,1973,142,5,4,9,55.6%,1h
44448,1,eolus,1973,161,4,12,16,25.0%,38m
44448,3,Álter,1973,86,3,4,7,42.9%,1h
44448,3,Balance,1973,30,2,0,2,100.0%,58m
44448,2,PickleRick,1973,0,2,4,6,33.3%,3h
44448,2,Taeg,1973,30,1,7,8,12.5%,1h
44448,2,Jazz,1973,42,1,7,8,12.5%,3h
44448,3,marce,1973,0,0,1,1,0.0%,1h
44448,3,engelmann,1973,0,0,2,2,0.0%,3h
44448,2,ChuckNovice,1973,0,0,4,4,0.0%,8m
44448,2,[AbcCo]sickboy,1973,0,0,6,6,0.0%,34m
44472,2,UpperUnicorn,1972,1567,126,131,257,49.0%,2m
44472,3,[SqBD]Emminent,1972,1390,122,123,245,49.8%,9m
44472,2,DPimpSnafu,1972,854,100,106,206,48.5%,9m
44472,2,[HFWJC]Harry,1972,1296,49,53,102,48.0%,3h
44472,2,Estius,1972,970,35,47,82,42.7%,3h
44472,3,LilCosmonaut,1972,434,16,12,28,57.1%,1h
44472,2,wusspie,1972,388,16,17,33,48.5%,1h
44472,1,RustGryphon,1972,304,10,23,33,30.3%,43m
44472,3,FondledMango,1972,267,9,4,13,69.2%,3h
44472,2,hOPs,1972,266,9,11,20,45.0%,3h
44472,2,BDOT,1972,218,7,7,14,50.0%,30m
44472,1,[SCS]TerranItUp,1972,148,6,13,19,31.6%,29m
44472,2,Panko,1972,151,4,6,10,40.0%,1h
44472,2,ConBen,1972,173,4,8,12,33.3%,3h
44472,3,THEDARKKING,1972,121,3,2,5,60.0%,1h
44472,1,[TSith]Exterminador,1972,70,3,10,13,23.1%,1h
44472,3,lronTomFlint,1972,60,2,3,5,40.0%,3m
44472,3,Francocala,1972,58,2,5,7,28.6%,3h
44472,1,Totarin,1972,48,2,11,13,15.4%,46m
44472,2,JamesEnky,1972,95,1,3,4,25.0%,1h
44472,2,[IRWT]lowdown,1972,30,1,5,6,16.7%,3h
44472,2,Mike,1972,30,1,6,7,14.3%,3h
44472,2,Tom,1972,30,1,7,8,12.5%,1h
44472,2,IIIIIIIIIIll,1972,30,1,7,8,12.5%,35m
44472,3,raziel,1972,0,0,1,1,0.0%,47m
44472,2,[TMKOs]Jean,1972,0,0,4,4,0.0%,1h
44472,2,MagicTurtle,1972,0,0,6,6,0.0%,3h
44472,2,[StmBrk]riding,1972,0,0,6,6,0.0%,1h
44500,2,HyperSaline,1971,1358,166,221,387,42.9%,24m
44500,2,Raptor,1971,1530,105,107,212,49.5%,24m
44500,2,KillingArt,1971,1534,102,119,221,46.2%,1h
44500,1,SaiKisaragi,1971,1335,47,59,106,44.3%,24m
44500,2,Mamba,1971,758,28,33,61,45.9%,1h
44500,3,GeneralJeff,1971,748,28,34,62,45.2%,28m
44500,2,RckMedk,1971,387,13,22,35,37.1%,3h
44500,2,leoonell,1971,317,11,11,22,50.0%,3h
44500,3,Jessup,1971,216,10,12,22,45.5%,41m
44500,2,FRAMBER,1971,302,9,11,20,45.0%,3h
44500,3,Pigo,1971,118,6,4,10,60.0%,3h
44500,3,amazon,1971,0,3,4,7,42.9%,20m
44500,2,AlmightySosa,1971,92,3,11,14,21.4%,3h
44500,2,EdoPaez,1971,138,2,3,5,40.0%,1h
44500,2,Aura,1971,88,2,4,6,33.3%,3h
44500,3,GURKHA,1971,30,1,2,3,33.3%,1h
44500,1,Nimber,1971,0,1,4,5,20.0%,43m
44500,1,sieger,1971,48,1,6,7,14.3%,1h
44500,2,Alpha,1971,30,1,6,7,14.3%,42m
44500,3,Marmot,1971,0,0,1,1,0.0%,1h
44500,3,Wladz,1971,0,0,1,1,0.0%,22m
44500,3,nguyenvansy,1971,0,0,1,1,0.0%,1h
44500,3,GLKtojlo,1971,0,0,1,1,0.0%,47m
44500,3,HoneyBadger,1971,0,0,4,4,0.0%,1h
44524,1,jmoprix,1970,1645,263,300,563,46.7%,1h
44524,2,DaBland,1970,1505,119,118,237,50.2%,58m
44524,1,[DarSt]Nained,1970,1487,89,105,194,45.9%,1h
44524,3,Charliez,1970,1532,67,57,124,54.0%,27m
44524,2,FlyFresno,1970,948,35,40,75,46.7%,34m
44524,2,[Zambo]OdiseoDItaca,1970,906,32,40,72,44.4%,1h
44524,2,Zneo,1970,364,26,34,60,43.3%,3m
44524,2,vegetalpro,1970,714,24,34,58,41.4%,33m
44524,3,Andrew,1970,441,16,13,29,55.2%,1h
44524,2,DootCaboose,1970,308,16,13,29,55.2%,3h
44524,2,Porcupine,1970,359,13,13,26,50.0%,3h
44524,2,Kexno,1970,353,10,19,29,34.5%,9m
44524,3,sWeet,1970,184,7,6,13,53.8%,46m
44524,3,[Bahu]CheetahCub,1970,126,5,2,7,71.4%,41m
44524,3,[tSC2LP]bocancamapna,1970,30,4,3,7,57.1%,1h
44524,3,zhangmu,1970,86,3,2,5,60.0%,27m
44524,3,[FyHr]IronIc,1970,109,3,3,6,50.0%,27m
44524,3,[JRB]ByGD,1970,30,2,5,7,28.6%,3h
44524,2,arKhanHell,1970,132,2,5,7,28.6%,3h
44524,2,Blockade,1970,60,2,11,13,15.4%,3h
44524,3,[CTBD]IronScorpio,1970,0,1,1,2,50.0%,1h
44524,3,[JUGOSC]woss,1970,0,0,1,1,0.0%,33m
44524,3,zooker,1970,0,0,2,2,0.0%,59m
44524,3,[LQV]alex,1970,0,0,3,3,0.0%,1h
44524,2,vicmuchina,1970,0,0,7,7,0.0%,1h
44549,2,LinkinFox,1969,990,55,45,100,55.0%,2m
44549,3,aquaquus,1969,895,38,35,73,52.1%,1h
44549,3,gamora,1969,833,33,17,50,66.0%,1h
44549,3,MagicAddict,1969,319,10,10,20,50.0%,28m
44549,2,Lisharsky,1969,294,10,15,25,40.0%,1h
44549,2,elrompeanexo,1969,281,9,9,18,50.0%,57m
44549,3,GorillaKush,1969,142,8,3,11,72.7%,1h
44549,3,Templar,1969,194,7,5,12,58.3%,1h
44549,3,sant,1969,60,5,4,9,55.6%,1h
44549,3,Nimox,1969,86,4,1,5,80.0%,1h
44549,3,Hellscream,1969,116,4,5,9,44.4%,24m
44549,2,Demali,1969,131,4,5,9,44.4%,3m
44549,2,mindkind,1969,138,3,7,10,30.0%,3h
44549,3,DeemerX,1969,127,3,10,13,23.1%,1h
44549,2,RaceRox,1969,64,2,10,12,16.7%,3h
44549,1,SgtLeonard,1969,96,1,4,5,20.0%,1h
44549,1,Rides,1969,48,1,5,6,16.7%,42m
44549,1,[4fun4]Venemouse,1969,0,1,5,6,16.7%,38m
44549,2,EduarmixISI,1969,0,0,2,2,0.0%,1h
44549,3,sim,1969,0,0,5,5,0.0%,3h
44549,3,Jovinud,1969,0,0,5,5,0.0%,36m
44570,2,Amon,1968,1659,146,167,313,46.6%,1h
44570,2,Yojimbo,1968,1150,51,57,108,47.2%,2m
44570,2,Camerw,1968,944,35,43,78,44.9%,3h
44570,3,WarGOOSE,1968,582,22,24,46,47.8%,1h
44570,2,[EpicG]HellRaiser,1968,399,12,15,27,44.4%,1h
44570,3,Tensai,1968,137,11,11,22,50.0%,1h
44570,2,Kayzerg,1968,206,7,8,15,46.7%,57m
44570,1,mix,1968,281,7,14,21,33.3%,1h
44570,2,[MRDR]fromthegetgo,1968,199,6,8,14,42.9%,9m
44570,1,CRISTIAN,1968,252,6,16,22,27.3%,43m
44570,1,barbedwire,1968,139,3,5,8,37.5%,46m
44570,3,[Ash3s]LiTuS,1968,30,2,0,2,100.0%,1h
44570,3,Peashooter,1968,60,2,2,4,50.0%,6m
44570,2,Sanchizmo,1968,102,2,4,6,33.3%,3h
44570,2,ERR,1968,30,2,5,7,28.6%,50m
44570,2,KAIJUperfect,1968,60,2,8,10,20.0%,1h
44570,2,Noremac,1968,58,2,8,10,20.0%,33m
44570,1,Eddy,1968,48,2,11,13,15.4%,1h
44570,3,DreamChaser,1968,0,1,1,2,50.0%,1h
44570,3,Skillson,1968,0,1,3,4,25.0%,3h
44570,2,bokardv,1968,30,1,7,8,12.5%,60m
44570,3,Flash,1968,0,0,1,1,0.0%,47m
44570,3,TheBest,1968,0,0,1,1,0.0%,39m
44570,3,agares,1968,0,0,6,6,0.0%,1h
44594,2,CORMACK,1967,1451,122,120,242,50.4%,1h
44594,2,BlaKryponite,1967,1395,107,106,213,50.2%,1h
44594,1,TheHolyAsdf,1967,1655,99,126,225,44.0%,3h
44594,2,bohol,1967,1429,69,76,145,47.6%,1h
44594,2,BOSSMAN,1967,1225,45,52,97,46.4%,2m
44594,2,OKA,1967,1298,43,67,110,39.1%,39m
44594,2,Kia,1967,606,25,26,51,49.0%,39m
44594,2,Slash,1967,608,20,32,52,38.5%,1h
44594,2,SigmaSucug,1967,436,18,20,38,47.4%,1h
44594,1,RomanIvac,1967,524,17,33,50,34.0%,44m
44594,2,Simon,1967,396,15,25,40,37.5%,58m
44594,1,Saito,1967,320,11,20,31,35.5%,1h
44594,1,TwitchNultsy,1967,238,10,8,18,55.6%,3h
44594,2,[Gh0stp]qila,1967,290,10,18,28,35.7%,3h
44594,2,Ralph,1967,197,8,9,17,47.1%,42m
44594,2,ElCoyoteCojo,1967,214,7,12,19,36.8%,3h
44594,3,HammerTime,1967,166,6,6,12,50.0%,7m
44594,3,CaptPutter,1967,144,5,3,8,62.5%,1h
44594,2,UNDERLAY,1967,88,3,10,13,23.1%,3h
44594,3,paulocu,1967,70,3,13,16,18.8%,17m
44594,3,saMMbal,1967,0,1,0,1,100.0%,3m
44594,3,[DIKOUT]VincentVega,1967,30,1,1,2,50.0%,9m
44594,2,Megalonix,1967,0,1,3,4,25.0%,3m
44594,3,leo,1967,30,1,4,5,20.0%,1h
44618,2,gorymaster,1966,819,74,76,150,49.3%,24m
44618,3,NPLXIV,1966,608,24,22,46,52.2%,1h
44618,3,nerok,1966,448,17,14,31,54.8%,1h
44618,3,Iroh,1966,204,11,7,18,61.1%,1h
44618,3,[SH1BA]MisplacedJoy,1966,296,11,10,21,52.4%,27m
44618,3,[IMDSI]sebastian,1966,362,10,12,22,45.5%,39m
44618,3,Doney,1966,256,8,15,23,34.8%,38m
44618,3,Terranforce,1966,255,7,8,15,46.7%,1h
44618,2,[ZWars]SeekanDstroy,1966,203,6,7,13,46.2%,24m
44618,1,AdennHydra,1966,166,5,14,19,26.3%,43m
44618,3,NIGHTBRINGER,1966,86,4,5,9,44.4%,37m
44618,2,evo,1966,132,4,10,14,28.6%,1h
44618,1,DocCoff,1966,88,3,0,3,100.0%,33m
44618,3,[GGWolf]Ghost,1966,76,3,3,6,50.0%,27m
44618,1,Skovran,1966,78,3,12,15,20.0%,1h
44618,2,Oscar,1966,92,2,4,6,33.3%,59m
44618,3,[farrrt]soup,1966,60,2,4,6,33.3%,22m
44618,2,dafuq,1966,141,2,9,11,18.2%,27m
44618,1,Ratcher,1966,48,2,12,14,14.3%,3h
44618,3,StarDron,1966,30,1,1,2,50.0%,17m
44618,3,Jeesusofmary,1966,30,1,3,4,25.0%,27m
44618,3,ThatDarkseid,1966,30,1,3,4,25.0%,1h
44618,2,anyong,1966,0,1,7,8,12.5%,3m
44618,2,nastyt,1966,46,1,8,9,11.1%,1h
44618,3,Matthew,1966,0,0,1,1,0.0%,1h
44618,3,CorbinRay,1966,0,0,1,1,0.0%,22m
44618,2,nemostar,1966,0,0,1,1,0.0%,28m
44618,3,DarkHadezs,1966,0,0,2,2,0.0%,9m
44618,2,Uranus,1966,0,0,2,2,0.0%,42m
44618,3,IkerGael,1966,0,0,2,2,0.0%,35m
44618,2,Impr,1966,0,0,4,4,0.0%,17m
44618,2,WTH,1966,0,0,4,4,0.0%,1h
44618,2,Agozar,1966,0,0,6,6,0.0%,1h
44618,1,YosemiteNP,1966,0,0,8,8,0.0%,1h
44652,2,Asky,1965,695,66,67,133,49.6%,1h
44652,2,MonkeyNOSOT,1965,722,49,55,104,47.1%,3m
44652,2,warmWater,1965,1041,46,42,88,52.3%,1h
44652,1,[WSCON]Styles,1965,805,31,50,81,38.3%,3h
44652,2,lynotline,1965,602,23,25,48,47.9%,1h
44652,2,[XNG]Kanahee,1965,540,21,18,39,53.8%,3h
44652,3,dnsc,1965,378,14,12,26,53.8%,1h
44652,2,[Huevos]BFITZ,1965,210,6,17,23,26.1%,34m
44652,3,Izdawg,1965,120,5,4,9,55.6%,41m
44652,2,WilhemX,1965,150,5,9,14,35.7%,3h
44652,2,Achilles,1965,175,4,1,5,80.0%,13m
44652,1,Amuro,1965,30,2,9,11,18.2%,3h
44652,2,Gaudrinami,1965,30,1,6,7,14.3%,9m
44652,1,zeref,1965,0,1,7,8,12.5%,16m
44652,3,Akhundelar,1965,0,0,2,2,0.0%,1h
44652,1,[RogueW]PookieWon,1965,0,0,3,3,0.0%,1h
44652,3,BenjaLorenzo,1965,0,0,5,5,0.0%,48m
44652,3,jogare,1965,0,0,5,5,0.0%,3h
44670,1,jley,1964,942,30,47,77,39.0%,3h
44670,1,Blacksheep,1964,514,20,35,55,36.4%,1h
44670,3,[JRT]BIGBOSS,1964,402,16,9,25,64.0%,28m
44670,3,MURDEREK,1964,322,12,4,16,75.0%,3h
44670,3,JoelTEC,1964,256,9,10,19,47.4%,37m
44670,3,Mufusa,1964,224,8,15,23,34.8%,3h
44670,1,Lament,1964,203,7,20,27,25.9%,3h
44670,3,SHELDONIMUS,1964,30,3,13,16,18.8%,1h
44670,3,ChavalioO,1964,120,2,1,3,66.7%,1h
44670,2,SweatStain,1964,102,2,6,8,25.0%,3h
44670,2,GoliathOnlin,1964,0,2,6,8,25.0%,1h
44670,2,Ikuo,1964,62,2,9,11,18.2%,39m
44670,3,MrVU,1964,0,1,2,3,33.3%,1h
44670,1,Flow,1964,0,0,1,1,0.0%,1h
44670,2,proper,1964,0,0,2,2,0.0%,1h
44670,2,Illwind,1964,0,0,4,4,0.0%,1h
44686,1,sierraone,1963,1552,522,554,1076,48.5%,25m
44686,3,Crawley,1963,1184,64,68,132,48.5%,9m
44686,2,MarkTH,1963,701,29,31,60,48.3%,9m
44686,3,Morpheus,1963,434,16,16,32,50.0%,1h
44686,3,CaNiBal,1963,398,13,13,26,50.0%,1h
44686,2,Vadirz,1963,336,11,15,26,42.3%,50m
44686,3,whet,1963,218,9,3,12,75.0%,36m
44686,1,[ProSC]Yakher,1963,172,7,16,23,30.4%,44m
44686,1,LikeDAN,1963,256,6,11,17,35.3%,42m
44686,3,[P34C3]Milo,1963,140,5,6,11,45.5%,1h
44686,3,Federico,1963,123,4,7,11,36.4%,2h
44686,3,[PMgaf]GoodUsopp,1963,72,3,4,7,42.9%,55m
44686,2,[H2ERO]Weeaboo,1963,88,3,9,12,25.0%,35m
44686,3,JoeExotic,1963,30,2,0,2,100.0%,1h
44686,3,[LKA]aLdebaRaN,1963,0,1,1,2,50.0%,12m
44686,3,LOLPRO,1963,0,1,2,3,33.3%,47m
44686,1,[LSTR4]VoidPurger,1963,0,1,11,12,8.3%,33m
44686,3,Doubted,1963,0,0,1,1,0.0%,12m
44686,2,Wardstar,1963,0,0,2,2,0.0%,1h
44686,3,Rayok,1963,0,0,2,2,0.0%,1h
44686,3,Simon,1963,0,0,3,3,0.0%,1h
44686,2,TheRealShaDy,1963,0,0,4,4,0.0%,16m
44708,2,Lowrystcol,1962,1530,96,105,201,47.8%,3h
44708,2,BIRR,1962,1506,87,89,176,49.4%,1h
44708,2,ElNegro,1962,1420,54,61,115,47.0%,1h
44708,2,Cruzonjaos,1962,730,27,32,59,45.8%,60m
44708,2,Melphite,1962,730,25,31,56,44.6%,2m
44708,3,SilverLines,1962,530,19,19,38,50.0%,1h
44708,3,Russell,1962,243,10,15,25,40.0%,1h
44708,3,Nathaniel,1962,86,4,3,7,57.1%,1h
44708,1,Qrinn,1962,96,2,4,6,33.3%,18m
44708,3,jaggernout,1962,0,1,9,10,10.0%,18m
44708,3,Killyourmtv,1962,0,0,1,1,0.0%,28m
44708,2,AMGKiller,1962,0,0,2,2,0.0%,1h
44708,2,Betelgeuse,1962,0,0,7,7,0.0%,1h
44721,2,LOIS,1961,1508,106,129,235,45.1%,3h
44721,3,[ManleT]partemadres,1961,1429,105,104,209,50.2%,1h
44721,3,Plantmanager,1961,1215,44,52,96,45.8%,47m
44721,2,Gremlin,1961,580,20,27,47,42.6%,35m
44721,2,Kimo,1961,371,19,23,42,45.2%,1h
44721,3,Samalmi,1961,336,11,11,22,50.0%,46m
44721,3,Juanes,1961,248,8,11,19,42.1%,30m
44721,3,Geo,1961,144,6,6,12,50.0%,46m
44721,1,[MuSaFi]sayoonara,1961,188,4,11,15,26.7%,1h
44721,2,Darkshadow,1961,90,4,11,15,26.7%,9m
44721,1,[EpicG]ADRURUS,1961,141,3,1,4,75.0%,23m
44721,3,AestheticsCh,1961,142,3,2,5,60.0%,24m
44721,3,ThrasherXG,1961,152,3,12,15,20.0%,1h
44721,3,Benjaimer,1961,114,2,3,5,40.0%,1h
44721,3,[Exiled]ditosoon,1961,0,2,4,6,33.3%,1h
44721,3,BLON,1961,30,2,5,7,28.6%,12m
44721,1,Arcana,1961,119,2,7,9,22.2%,3h
44721,2,degoplay,1961,97,2,8,10,20.0%,42m
44721,3,gloxinia,1961,30,1,1,2,50.0%,37m
44721,2,rocka,1961,0,1,2,3,33.3%,1h
44721,1,Scaden,1961,48,1,2,3,33.3%,1h
44721,2,[FoxBR]Foxtrot,1961,30,1,3,4,25.0%,17m
44721,1,Cloudless,1961,0,1,8,9,11.1%,5m
44721,1,renrad,1961,0,1,9,10,10.0%,3h
44721,3,kevinbot,1961,0,0,1,1,0.0%,1h
44721,3,WolverineMax,1961,0,0,1,1,0.0%,41m
44721,3,JBKJ,1961,0,0,2,2,0.0%,3h
44721,1,adderx,1961,0,0,3,3,0.0%,1h
44721,2,TERFW,1961,0,0,7,7,0.0%,8m
44750,2,Menkoso,1960,1575,148,165,313,47.3%,3h
44750,3,TasteTest,1960,1434,71,68,139,51.1%,1h
44750,2,breikwolf,1960,916,35,49,84,41.7%,31m
44750,3,fernando,1960,702,28,18,46,60.9%,38m
44750,3,oskarin,1960,551,24,12,36,66.7%,31m
44750,3,Minhbeard,1960,544,20,32,52,38.5%,48m
44750,3,[PTHero]Strygwyr,1960,466,17,15,32,53.1%,39m
44750,3,DANDYLOP,1960,366,14,10,24,58.3%,3h
44750,3,NickJo,1960,330,11,14,25,44.0%,1h
44750,2,PROVENMLG,1960,214,8,15,23,34.8%,15m
44750,2,nako,1960,174,7,8,15,46.7%,42m
44750,2,Bucknasty,1960,143,3,5,8,37.5%,34m
44750,3,Superior,1960,58,2,3,5,40.0%,1h
44750,2,LeBombadier,1960,48,2,9,11,18.2%,1h
44750,3,Drosras,1960,0,0,5,5,0.0%,1h
44750,2,Migz,1960,0,0,6,6,0.0%,1h
44750,2,[PSYON]Maz,1960,0,0,7,7,0.0%,1h
44767,2,[MARV3L]WarChief,1959,1473,163,180,343,47.5%,2m
44767,2,SuperRocco,1959,683,56,66,122,45.9%,3h
44767,2,SrMadeirinha,1959,644,25,25,50,50.0%,3h
44767,2,danyO,1959,222,9,11,20,45.0%,1h
44767,3,ZONIKSRR,1959,145,4,11,15,26.7%,3h
44767,1,DEATHVALLEY,1959,142,3,9,12,25.0%,29m
44767,1,Blaster,1959,30,1,6,7,14.3%,58m
44767,2,TripleJ,1959,30,1,7,8,12.5%,3h
44767,2,yabeer,1959,0,1,7,8,12.5%,3h
44767,3,MegaBlack,1959,0,0,1,1,0.0%,38m
44767,2,DaudIscandar,1959,0,0,1,1,0.0%,42m
44767,3,[ORTE]darcklord,1959,0,0,1,1,0.0%,1h
44767,2,SshipaPollo,1959,0,0,2,2,0.0%,42m
44767,2,Tuitarrista,1959,0,0,5,5,0.0%,3h
44767,2,Cerjon,1959,0,0,7,7,0.0%,1h
44782,2,hayagha,1958,1314,195,255,450,43.3%,3h
44782,2,KLRrider,1958,1475,127,146,273,46.5%,2m
44782,3,Nicklas,1958,1205,66,55,121,54.5%,17m
44782,2,Brum,1958,1128,59,64,123,48.0%,57m
44782,3,Nick,1958,1346,49,62,111,44.1%,3h
44782,3,[NTINE]gabriel,1958,482,18,8,26,69.2%,1h
44782,1,TrumpDad,1958,492,16,25,41,39.0%,3h
44782,2,QuoVadis,1958,300,14,27,41,34.1%,6m
44782,2,[SBlock]conejo,1958,266,12,6,18,66.7%,42m
44782,3,Indistrol,1958,259,10,4,14,71.4%,1h
44782,2,[PobSC]Ragnar,1958,284,10,10,20,50.0%,1h
44782,3,larr,1958,231,7,6,13,53.8%,31m
44782,3,Xavi,1958,142,5,4,9,55.6%,1h
44782,2,Swanzokills,1958,144,4,6,10,40.0%,3h
44782,3,TechmoSnowy,1958,58,3,1,4,75.0%,1h
44782,2,StarchRafts,1958,153,3,8,11,27.3%,1h
44782,2,Apolo,1958,98,3,8,11,27.3%,20m
44782,3,Jibit,1958,0,2,3,5,40.0%,1h
44782,1,mRFIcoGames,1958,46,1,1,2,50.0%,1h
44782,3,xxVidalxx,1958,0,1,1,2,50.0%,3h
44782,1,Never,1958,0,1,6,7,14.3%,53m
44782,3,Xiu,1958,0,0,1,1,0.0%,35m
44782,2,WitchDocTor,1958,0,0,1,1,0.0%,42m
44782,3,Chero,1958,0,0,1,1,0.0%,28m
44782,2,Verrda,1958,0,0,6,6,0.0%,1h
44782,2,bala,1958,0,0,7,7,0.0%,1h
44808,2,bacvd,1957,1466,88,101,189,46.6%,27m
44808,2,Jimbobaggins,1957,859,29,36,65,44.6%,1h
44808,1,MrNoob,1957,527,20,38,58,34.5%,1h
44808,1,Mengelkoch,1957,480,19,34,53,35.8%,1h
44808,2,[TPGGXD]ChristianB,1957,403,16,13,29,55.2%,1h
44808,3,PlatiusDDA,1957,424,14,22,36,38.9%,1h
44808,3,[Cvirus]MoGad,1957,258,12,8,20,60.0%,27m
44808,2,[XDRAX8]Esteban,1957,350,12,21,33,36.4%,1h
44808,3,Broseph,1957,371,12,22,34,35.3%,22m
44808,2,BlueMachine,1957,255,10,17,27,37.0%,15m
44808,3,aisored,1957,208,8,4,12,66.7%,3h
44808,2,nomadfromkz,1957,47,5,12,17,29.4%,35m
44808,3,ProBronzPlay,1957,86,4,2,6,66.7%,24m
44808,2,[BRDEFE]SRATEX,1957,92,4,5,9,44.4%,1h
44808,3,[Pr3cum]Danja,1957,0,3,2,5,60.0%,35m
44808,3,Howl,1957,90,3,5,8,37.5%,1h
44808,2,Robert,1957,146,3,8,11,27.3%,3h
44808,3,Galbat,1957,0,1,0,1,100.0%,41m
44808,2,Gustavofenix,1957,95,1,2,3,33.3%,11m
44808,1,MaxIV,1957,0,1,9,10,10.0%,10m
44808,3,[ABQPD]COVIDTRAP,1957,0,0,1,1,0.0%,31m
44808,1,StickDonkey,1957,0,0,1,1,0.0%,6m
44808,3,DAYWIN,1957,0,0,2,2,0.0%,3m
44808,2,AlAegys,1957,0,0,6,6,0.0%,23m
44832,1,TrubleTriKle,1956,1626,602,631,1233,48.8%,3h
44832,1,[kpax]Kpax,1956,847,57,78,135,42.2%,6m
44832,2,[Ziz]ElAmolcar,1956,656,29,25,54,53.7%,3m
44832,2,Starlord,1956,658,24,31,55,43.6%,34m
44832,3,Tantrika,1956,208,21,10,31,67.7%,24m
44832,3,AdoyleRules,1956,328,12,12,24,50.0%,17m
44832,1,bigjon,1956,264,12,23,35,34.3%,3h
44832,3,shadowtk,1956,226,9,6,15,60.0%,59m
44832,1,[gnosis]GralDanielFV,1956,246,7,4,11,63.6%,29m
44832,2,diegomartine,1956,222,7,16,23,30.4%,1h
44832,3,morgal,1956,146,6,6,12,50.0%,3h
44832,2,[Gr33zy]Venshion,1956,238,6,8,14,42.9%,1h
44832,3,Castle,1956,219,6,12,18,33.3%,3h
44832,3,NotTheFace,1956,161,6,21,27,22.2%,3h
44832,3,[BrVoS]GuZzOd,1956,86,4,3,7,57.1%,3h
44832,3,goatgamer,1956,58,4,5,9,44.4%,37m
44832,2,[AbcCo]sopaxx,1956,60,3,8,11,27.3%,3h
44832,3,CarlosDa,1956,30,1,2,3,33.3%,41m
44832,2,lloydxmas,1956,30,1,11,12,8.3%,50m
44832,3,[GDKND]zorg,1956,0,0,1,1,0.0%,20m
44832,2,[Mugre]termolar,1956,0,0,1,1,0.0%,1h
44832,3,Chirolo,1956,0,0,3,3,0.0%,44m
44832,3,javier,1956,0,0,6,6,0.0%,1h
44832,2,Tsundere,1956,0,0,7,7,0.0%,1h
44856,3,Komando,1955,928,31,42,73,42.5%,52m
44856,2,EACTurco,1955,758,26,38,64,40.6%,3h
44856,2,TheCoachLIVE,1955,700,23,36,59,39.0%,3h
44856,2,Ivan,1955,466,17,31,48,35.4%,3h
44856,3,Rogue,1955,142,6,4,10,60.0%,36m
44856,3,Andromedus,1955,58,3,3,6,50.0%,1h
44856,3,chris,1955,90,3,6,9,33.3%,36m
44856,2,Alphaleader,1955,98,3,12,15,20.0%,3m
44856,3,Pizza,1955,0,1,0,1,100.0%,1h
44856,1,josesanhz,1955,40,1,3,4,25.0%,23m
44856,3,DerpestWolf,1955,0,0,2,2,0.0%,44m
44856,1,[CUMMYs]CallMeJae,1955,0,0,3,3,0.0%,8m
44868,2,DancaT,1954,1455,88,85,173,50.9%,3h
44868,3,BRYANS,1954,1589,59,68,127,46.5%,1h
44868,2,Sumyeungai,1954,750,54,52,106,50.9%,3h
44868,2,eframm,1954,1213,51,58,109,46.8%,9m
44868,2,Pelantaru,1954,444,16,17,33,48.5%,3h
44868,3,TurnBackNow,1954,286,10,10,20,50.0%,1h
44868,1,Neo,1954,216,9,13,22,40.9%,1h
44868,3,henchcroft,1954,216,8,8,16,50.0%,7m
44868,2,Mrscrooge,1954,320,8,12,20,40.0%,1h
44868,3,Wellington,1954,108,5,2,7,71.4%,20m
44868,1,Boarderdude,1954,146,4,3,7,57.1%,1m
44868,1,jhonWick,1954,76,3,11,14,21.4%,3h
44868,3,[BeerLH]Zohdin,1954,0,2,3,5,40.0%,36m
44868,2,Bayerishe,1954,0,2,5,7,28.6%,1h
44868,3,[viwar]ElUrielOP,1954,30,1,2,3,33.3%,1h
44868,2,GreenLegion,1954,0,1,8,9,11.1%,15m
44868,2,lotus,1954,30,1,8,9,11.1%,17m
44868,1,[FUKSAT]kimoboy,1954,0,1,8,9,11.1%,3h
44868,3,Protosopic,1954,0,0,5,5,0.0%,31m
44868,1,CasualCnut,1954,0,0,6,6,0.0%,18m
44868,3,Jack,1954,0,0,6,6,0.0%,21m
44889,2,CANCERIAN,1953,1504,148,170,318,46.5%,27m
44889,3,Hawk,1953,1445,146,177,323,45.2%,41m
44889,3,MagicTurtle,1953,896,33,36,69,47.8%,1h
44889,2,DarkLord,1953,330,18,18,36,50.0%,3m
44889,3,[CHKRSP]RAFA,1953,502,18,20,38,47.4%,3h
44889,2,Redking,1953,486,17,16,33,51.5%,3h
44889,2,Manston,1953,474,16,25,41,39.0%,3h
44889,2,Phoenix,1953,313,11,13,24,45.8%,1h
44889,1,[PY]TerransKids,1953,329,8,14,22,36.4%,3h
44889,2,jjunnsa,1953,182,6,7,13,46.2%,24m
44889,2,Leachi,1953,126,3,3,6,50.0%,51m
44889,2,Trip,1953,96,3,9,12,25.0%,3h
44889,3,Staxs,1953,120,2,1,3,66.7%,9m
44889,3,DoctorDunlap,1953,0,2,3,5,40.0%,1h
44889,1,MrExilio,1953,117,2,3,5,40.0%,3h
44889,3,YodaGrammar,1953,0,1,0,1,100.0%,1h
44889,2,kfiref,1953,85,1,2,3,33.3%,28m
44889,3,Nidaye,1953,30,1,3,4,25.0%,9m
44889,3,slunky,1953,0,0,1,1,0.0%,3h
44889,3,[FaTlAd]Terranhero,1953,0,0,1,1,0.0%,1h
44889,3,FullHalfie,1953,0,0,1,1,0.0%,3h
44889,2,Batman,1953,0,0,3,3,0.0%,1h
44889,3,Armanai,1953,0,0,6,6,0.0%,16m
44889,3,Rodrigo,1953,0,0,6,6,0.0%,1h
44913,3,Evilworld,1952,1462,149,180,329,45.3%,24m
44913,2,PasoVeloz,1952,1582,101,130,231,43.7%,3h
44913,3,Victor,1952,1437,61,52,113,54.0%,1h
44913,2,VonBaron,1952,1626,58,73,131,44.3%,3m
44913,3,OnlyReptar,1952,1268,56,47,103,54.4%,9m
44913,2,Kamva,1952,453,49,47,96,51.0%,1h
44913,2,Matadiezmo,1952,1024,40,38,78,51.3%,9m
44913,1,donkaments,1952,671,23,31,54,42.6%,3h
44913,2,jpbisson,1952,428,14,21,35,40.0%,3h
44913,3,jmace,1952,248,9,17,26,34.6%,39m
44913,2,[JeZ]russelkiller,1952,320,8,20,28,28.6%,3h
44913,2,elmon,1952,86,4,5,9,44.4%,20m
44913,2,[Squidy]Thunderforce,1952,150,3,4,7,42.9%,37m
44913,2,EdoGodofredo,1952,46,3,7,10,30.0%,1h
44913,2,JuanRa,1952,144,3,9,12,25.0%,16m
44913,2,Hirviero,1952,90,3,9,12,25.0%,12m
44913,3,[NR6]ZEUS,1952,0,1,0,1,100.0%,1h
44913,3,toontownlego,1952,30,1,1,2,50.0%,9m
44913,3,Mihawk,1952,30,1,2,3,33.3%,33m
44913,2,[Curtis]WolfPack,1952,0,1,2,3,33.3%,1h
44913,2,Laksamit,1952,0,1,3,4,25.0%,6m
44913,2,EvilKenshin,1952,95,1,4,5,20.0%,1h
44913,2,QuirkyTurtle,1952,48,1,5,6,16.7%,1h
44913,3,Slickhick,1952,0,0,3,3,0.0%,30m
44913,2,[Emi12]valer,1952,0,0,3,3,0.0%,1h
44938,2,DariusAce,1951,1405,53,62,115,46.1%,39m
44938,3,[HSCT]Gregathon,1951,849,38,30,68,55.9%,28m
44938,3,chunchumaru,1951,513,20,10,30,66.7%,1h
44938,2,Yúsurus,1951,332,15,14,29,51.7%,3h
44938,3,[FTLT]ElCastor,1951,350,14,11,25,56.0%,3h
44938,3,publicò,1951,365,12,8,20,60.0%,26m
44938,1,careflaite,1951,192,6,11,17,35.3%,1h
44938,1,SuperNinja,1951,32,2,10,12,16.7%,3h
44938,3,Kedgann,1951,0,1,0,1,100.0%,1h
44938,3,Gonzo,1951,30,1,1,2,50.0%,3h
44938,2,jdmbucket,1951,88,1,1,2,50.0%,1h
44938,3,alejandropy,1951,0,0,1,1,0.0%,38m
44938,3,Summer,1951,0,0,1,1,0.0%,30m
44938,3,donden,1951,0,0,2,2,0.0%,9m
44938,2,Adrenaline,1951,0,0,3,3,0.0%,42m
44938,3,ThyBaz,1951,0,0,5,5,0.0%,48m
44938,3,Kryptic,1951,0,0,6,6,0.0%,21m
44938,2,[Yuka]Exterminatus,1951,0,0,8,8,0.0%,3h
44956,2,DrJ,1950,1565,83,91,174,47.7%,1h
44956,3,rzj,1950,972,37,50,87,42.5%,31m
44956,2,[MyT]zateon,1950,751,28,30,58,48.3%,3h
44956,2,Scootttwar,1950,621,22,22,44,50.0%,13m
44956,3,PEKMAN,1950,505,19,13,32,59.4%,38m
44956,3,kratos,1950,412,15,14,29,51.7%,13m
44956,1,LtWukWuk,1950,289,7,14,21,33.3%,3h
44956,1,THEKILLER,1950,168,5,11,16,31.2%,23m
44956,3,HolyCrusade,1950,86,4,0,4,100.0%,46m
44956,3,Humburgler,1950,0,3,2,5,60.0%,3h
44956,2,IvanIVI,1950,116,3,3,6,50.0%,2m
44956,3,ZerraM,1950,88,3,4,7,42.9%,1h
44956,2,SourSkittlez,1950,86,3,9,12,25.0%,3h
44956,2,Tommy,1950,165,3,10,13,23.1%,3h
44956,2,ShadowDragon,1950,30,3,11,14,21.4%,3h
44956,2,DustBiter,1950,60,2,8,10,20.0%,23m
44956,1,bujurulu,1950,136,2,10,12,16.7%,3h
44956,3,greenOx,1950,30,2,10,12,16.7%,51m
44956,3,[SCVM]ElAsesino,1950,0,1,0,1,100.0%,27m
44956,3,Zero,1950,0,1,1,2,50.0%,3h
44956,3,Reaper,1950,0,1,5,6,16.7%,16m
44956,3,Zoma,1950,0,0,1,1,0.0%,3m
44956,3,Wyvern,1950,0,0,1,1,0.0%,1h
44956,2,Deadpool,1950,0,0,4,4,0.0%,1h
44956,3,Odiance,1950,0,0,5,5,0.0%,59m
44956,3,PandaWarrior,1950,0,0,6,6,0.0%,2m
44982,1,Ben,1949,1605,319,334,653,48.9%,5m
44982,3,IIIIIIIIIII,1949,1417,303,422,725,41.8%,17m
44982,3,Cmonk,1949,846,145,161,306,47.4%,41m
44982,2,MaNtEqUiLLA,1949,1187,53,44,97,54.6%,57m
44982,2,Spiderman,1949,1331,52,70,122,42.6%,3h
44982,2,Carber,1949,577,51,52,103,49.5%,15m
44982,3,Labrat,1949,486,16,27,43,37.2%,1h
44982,3,Brian,1949,200,7,8,15,46.7%,1h
44982,3,LOLKFC,1949,114,4,2,6,66.7%,27m
44982,3,ARKANGEL,1949,114,4,3,7,57.1%,1h
44982,2,Hesh,1949,98,4,11,15,26.7%,3h
44982,3,Geterix,1949,100,3,4,7,42.9%,1h
44982,3,DarkDragon,1949,30,2,2,4,50.0%,1h
44982,2,[ks25]CriticalDMG,1949,92,2,6,8,25.0%,28m
44982,3,[ZvP]ScotianVibeZ,1949,30,2,10,12,16.7%,3h
44982,3,LPMuseFan,1949,0,1,0,1,100.0%,28m
44982,3,jeql,1949,30,1,2,3,33.3%,3h
44982,3,shadow,1949,30,1,2,3,33.3%,38m
44982,3,Yeyito,1949,0,0,1,1,0.0%,9m
44982,3,dethpunk,1949,0,0,4,4,0.0%,1h
44982,2,Marcomac,1949,0,0,6,6,0.0%,9m
45003,3,SwampLord,1948,833,58,60,118,49.2%,3h
45003,3,NinjaGamerTV,1948,788,30,24,54,55.6%,1h
45003,2,Samuraiblue,1948,341,14,9,23,60.9%,1h
45003,1,miazocool,1948,212,7,21,28,25.0%,3h
45003,3,[USUCC]LargeDiK,1948,216,6,9,15,40.0%,52m
45003,1,Giantsbro,1948,190,6,12,18,33.3%,32m
45003,2,Jorch,1948,158,6,15,21,28.6%,32m
45003,2,HolyHenry,1948,154,5,8,13,38.5%,51m
45003,2,ManuelMelo,1948,84,4,9,13,30.8%,1h
45003,1,Cerberus,1948,144,4,12,16,25.0%,2m
45003,1,Hezzz,1948,142,3,8,11,27.3%,1h
45003,3,durul,1948,86,2,1,3,66.7%,3h
45003,3,dde,1948,30,2,5,7,28.6%,1h
45003,1,noblevice,1948,48,1,3,4,25.0%,38m
45003,2,cTHREE,1948,0,1,5,6,16.7%,3h
45003,2,jaboc,1948,0,1,6,7,14.3%,34m
45003,1,Lokriek,1948,0,1,9,10,10.0%,1h
45003,2,varicosevein,1948,0,0,3,3,0.0%,1h
45003,2,JESU,1948,0,0,7,7,0.0%,3h
45003,1,[OPSF]Joe,1948,0,0,9,9,0.0%,16m
45023,2,JungleHunter,1947,1526,111,125,236,47.0%,35m
45023,2,pringles,1947,1512,103,118,221,46.6%,9m
45023,3,ramirokuay,1947,920,73,82,155,47.1%,3h
45023,2,cOdeX,1947,894,61,73,134,45.5%,1h
45023,2,URIEL,1947,1302,48,56,104,46.2%,23m
45023,1,Mike,1947,1322,47,57,104,45.2%,3h
45023,1,Mccheese,1947,1204,40,60,100,40.0%,3h
45023,3,Wizzrobe,1947,799,32,33,65,49.2%,2h
45023,3,yourface,1947,708,26,30,56,46.4%,7m
45023,2,[XPARTA]SUPERBADBOY,1947,494,15,20,35,42.9%,38m
45023,2,[SnsDrn]blacktmplars,1947,274,10,20,30,33.3%,3h
45023,2,BRANDON,1947,279,9,9,18,50.0%,57m
45023,3,[ZTempz]MINISHOUTS,1947,270,9,14,23,39.1%,9m
45023,3,Abominous,1947,245,8,6,14,57.1%,52m
45023,3,Tormenta,1947,190,7,4,11,63.6%,26m
45023,1,Rife,1947,171,6,3,9,66.7%,8m
45023,3,Barret,1947,114,5,4,9,55.6%,24m
45023,3,Sinnin,1947,187,5,6,11,45.5%,1h
45023,3,nicolas,1947,86,4,1,5,80.0%,1h
45023,1,INVASOR,1947,48,4,7,11,36.4%,3h
45023,3,[BROJOX]asdad,1947,88,3,6,9,33.3%,46m
45023,2,CORONAVIRUS,1947,76,3,8,11,27.3%,1h
45023,3,OptimusPrime,1947,143,3,9,12,25.0%,1h
45023,2,MastermindTK,1947,94,3,10,13,23.1%,3h
45023,2,Strajack,1947,95,2,13,15,13.3%,3h
45023,2,Aesris,1947,30,1,4,5,20.0%,57m
45023,3,JKa,1947,18,1,5,6,16.7%,1h
45023,2,Nihilus,1947,0,1,6,7,14.3%,1h
45023,2,DoNotForget,1947,0,0,1,1,0.0%,3h
45023,2,[jerga]shadown,1947,0,0,1,1,0.0%,51m
45023,3,[AiMB]WoodytheOG,1947,0,0,3,3,0.0%,20m
45023,2,Nags,1947,0,0,3,3,0.0%,1h
45023,2,MisioneroMAT,1947,0,0,7,7,0.0%,12m
45056,2,shilaoshi,1946,1424,91,122,213,42.7%,1h
45056,2,Scoe,1946,620,75,78,153,49.0%,1h
45056,3,Michy,1946,717,27,35,62,43.5%,39m
45056,2,Candyman,1946,363,18,29,47,38.3%,39m
45056,2,yaco,1946,312,11,22,33,33.3%,20m
45056,2,travis,1946,289,10,14,24,41.7%,50m
45056,3,tinmar,1946,164,9,10,19,47.4%,15m
45056,2,IKARI,1946,218,6,9,15,40.0%,50m
45056,1,Fahed,1946,140,4,14,18,22.2%,33m
45056,2,YashBrowns,1946,88,2,4,6,33.3%,58m
45056,3,Igneon,1946,30,2,4,6,33.3%,1h
45056,1,JLGX,1946,145,2,7,9,22.2%,47m
45056,2,Pieroyya,1946,58,2,7,9,22.2%,16m
45056,3,Asterisk,1946,0,1,0,1,100.0%,46m
45056,2,Maar,1946,88,1,4,5,20.0%,50m
45056,3,[SOCOMD]Johno,1946,44,1,6,7,14.3%,27m
45056,2,KingRobbo,1946,93,1,7,8,12.5%,11m
45056,3,[flexed]STOM,1946,0,0,2,2,0.0%,1h
45056,3,Bruce,1946,0,0,2,2,0.0%,1h
45056,3,erik,1946,0,0,4,4,0.0%,3h
45056,3,Bradylun,1946,0,0,5,5,0.0%,26m
45077,2,Hillbilly,1945,1524,172,185,357,48.2%,3h
45077,2,Urax,1945,980,63,71,134,47.0%,1h
45077,3,Ahmadeus,1945,1577,62,71,133,46.6%,28m
45077,3,[TINKU]JCTEKKEN,1945,941,60,59,119,50.4%,1h
45077,2,RGDantaz,1945,384,14,19,33,42.4%,18m
45077,2,ikermateo,1945,310,11,18,29,37.9%,1h
45077,2,Rick,1945,302,9,19,28,32.1%,3h
45077,3,GATO,1945,192,7,3,10,70.0%,38m
45077,3,TimeBomb,1945,136,5,7,12,41.7%,44m
45077,2,IKiLLSWiTCHI,1945,118,4,10,14,28.6%,24m
45077,3,PrimaNocta,1945,150,4,13,17,23.5%,35m
45077,3,HundreDemons,1945,70,3,0,3,100.0%,1h
45077,1,Ownification,1945,96,3,12,15,20.0%,9m
45077,2,HotdogFarmer,1945,60,2,9,11,18.2%,42m
45077,3,Saltazar,1945,30,1,5,6,16.7%,3h
45077,2,WolfCrimson,1945,0,1,6,7,14.3%,1h
45077,3,Fireblazzer,1945,0,0,1,1,0.0%,1h
45077,2,Zimtower,1945,0,0,2,2,0.0%,59m
45077,2,[PuffWC]Denmarksnk,1945,0,0,6,6,0.0%,1h
45077,2,Overkill,1945,0,0,8,8,0.0%,3h
45097,2,Nir,1944,1438,198,246,444,44.6%,1h
45097,2,Motorboat,1944,1610,124,142,266,46.6%,31m
45097,3,GLHaveFun,1944,1035,74,72,146,50.7%,17m
45097,3,LaChinche,1944,1093,48,58,106,45.3%,1h
45097,2,BanMondragon,1944,270,13,12,25,52.0%,17m
45097,3,MAQUIAVEL,1944,373,12,14,26,46.2%,3m
45097,2,markymark,1944,226,7,13,20,35.0%,1h
45097,3,Mayestick,1944,24,4,15,19,21.1%,1h
45097,3,NXT,1944,58,2,4,6,33.3%,1h
45097,2,gamusdeacuar,1944,30,1,5,6,16.7%,3h
45097,2,[ABorn]BlackSnow,1944,46,1,9,10,10.0%,11m
45097,3,Blurpy,1944,0,0,1,1,0.0%,9m
45097,2,Aetrix,1944,0,0,2,2,0.0%,59m
45110,3,Dagafrozen,1943,1565,109,128,237,46.0%,27m
45110,2,XxDrAigNorXx,1943,670,26,25,51,51.0%,3h
45110,2,Phinks,1943,528,21,29,50,42.0%,45m
45110,3,eltonyways,1943,354,12,18,30,40.0%,33m
45110,2,TypeA,1943,364,12,20,32,37.5%,58m
45110,3,bolvahr,1943,270,11,11,22,50.0%,41m
45110,1,flexurego,1943,238,6,15,21,28.6%,1h
45110,3,[SCVM]AdmralMurphy,1943,191,5,2,7,71.4%,28m
45110,2,GtlFrank,1943,225,5,10,15,33.3%,27m
45110,3,Aries,1943,30,2,0,2,100.0%,28m
45110,3,Stott,1943,120,2,5,7,28.6%,3h
45110,3,ZipMaiFlai,1943,70,2,5,7,28.6%,9m
45110,1,Dbinto,1943,145,2,5,7,28.6%,1h
45110,3,[ALTF04]Geo,1943,0,1,0,1,100.0%,3h
45110,1,KillerTune,1943,96,1,2,3,33.3%,3h
45110,3,OnECorNN,1943,0,1,4,5,20.0%,1h
45110,3,pejelagarto,1943,0,1,5,6,16.7%,3h
45110,2,Mikkel,1943,40,1,7,8,12.5%,1h
45110,1,ALPAKASTAR,1943,0,1,8,9,11.1%,1h
45110,2,ManazoZ,1943,48,1,9,10,10.0%,1h
45110,2,Mandy,1943,0,0,1,1,0.0%,59m
45110,3,oscar,1943,0,0,1,1,0.0%,7m
45110,2,Shiz,1943,0,0,6,6,0.0%,35m
45133,1,Kuraudo,1942,1301,246,275,521,47.2%,1h
45133,3,cptmorgan,1942,1536,83,91,174,47.7%,1h
45133,2,FHORNA,1942,1396,47,59,106,44.3%,58m
45133,3,cajachan,1942,965,36,42,78,46.2%,3h
45133,2,aimer,1942,546,24,23,47,51.1%,3h
45133,2,KryptechCode,1942,396,13,19,32,40.6%,33m
45133,2,sTrAnGeBiRd,1942,306,11,12,23,47.8%,16m
45133,2,Jimmy,1942,314,10,21,31,32.3%,50m
45133,2,RamJo,1942,116,9,6,15,60.0%,1h
45133,3,[SCVM]LilDolce,1942,281,9,8,17,52.9%,17m
45133,2,jongdae,1942,196,6,7,13,46.2%,1h
45133,1,TrueWolf,1942,140,5,15,20,25.0%,3h
45133,3,Help,1942,171,4,5,9,44.4%,38m
45133,2,KennedyHawkI,1942,162,4,7,11,36.4%,1h
45133,1,RWKAMI,1942,100,4,11,15,26.7%,3h
45133,1,SNXPFLASH,1942,96,3,13,16,18.8%,3h
45133,3,drak,1942,62,2,1,3,66.7%,1h
45133,3,viper,1942,0,1,1,2,50.0%,46m
45133,3,djmanuelnava,1942,0,1,2,3,33.3%,46m
45133,2,mobo,1942,46,1,4,5,20.0%,42m
45133,3,warduck,1942,0,0,1,1,0.0%,3h
45133,3,Agujaman,1942,0,0,2,2,0.0%,2m
45133,3,SirAnthony,1942,0,0,6,6,0.0%,41m
45156,2,PENTAGRAMA,1941,1107,134,152,286,46.9%,3h
45156,2,AlphaOneIV,1941,1465,126,135,261,48.3%,1h
45156,2,Benhard,1941,944,84,87,171,49.1%,3m
45156,1,ayudxt,1941,1637,73,107,180,40.6%,3h
45156,2,[GDKND]ANGEL,1941,935,44,38,82,53.7%,12m
45156,2,[zerg9]zergDJ,1941,607,23,33,56,41.1%,3h
45156,2,HANAND,1941,582,20,25,45,44.4%,1h
45156,3,Soccerclok,1941,366,12,17,29,41.4%,30m
45156,1,Baby,1941,304,8,15,23,34.8%,47m
45156,3,Dwerp,1941,140,6,2,8,75.0%,24m
45156,3,EmperorOfMan,1941,140,5,1,6,83.3%,1h
45156,3,Lennox,1941,172,4,7,11,36.4%,1h
45156,3,persistent,1941,199,4,8,12,33.3%,38m
45156,3,Davidcito,1941,0,3,2,5,60.0%,38m
45156,1,Hórus,1941,121,3,10,13,23.1%,1h
45156,2,llllllllllll,1941,0,1,0,1,100.0%,1h
45156,3,Yellowb,1941,30,1,1,2,50.0%,52m
45156,2,RamSshieL,1941,0,1,2,3,33.3%,28m
45156,2,[FCTR]Ragnarok,1941,40,1,7,8,12.5%,1h
45156,3,Hotshot,1941,0,0,1,1,0.0%,9m
45176,2,Shutdowner,1940,1511,158,192,350,45.1%,1h
45176,2,hazl,1940,812,44,42,86,51.2%,3h
45176,2,LUCA,1940,985,37,44,81,45.7%,3h
45176,2,Heathcliff,1940,801,32,30,62,51.6%,3h
45176,3,[DILIH]Galaxyghost,1940,838,30,31,61,49.2%,48m
45176,2,Bucy,1940,434,14,24,38,36.8%,24m
45176,3,Bulbasaurus,1940,169,10,4,14,71.4%,30m
45176,2,AlexisZa,1940,286,9,16,25,36.0%,42m
45176,2,Jeff,1940,194,5,13,18,27.8%,3h
45176,1,DRam,1940,144,4,14,18,22.2%,18m
45176,3,MrFurious,1940,151,3,6,9,33.3%,26m
45176,3,McFly,1940,119,2,2,4,50.0%,1h
45176,2,AsesinoNorti,1940,64,2,3,5,40.0%,3h
45176,2,[xIWCx]Stewymister,1940,30,2,9,11,18.2%,1h
45176,2,[GRU]sinbad,1940,30,1,10,11,9.1%,3m
45176,3,Bimo,1940,0,0,1,1,0.0%,28m
45176,2,[LMI42]Hoehammer,1940,0,0,4,4,0.0%,3h
45176,2,MobMeister,1940,0,0,4,4,0.0%,3h
45176,2,nathan,1940,0,0,4,4,0.0%,12m
45176,3,Ekikouki,1940,0,0,5,5,0.0%,1h
45176,2,mazoluminozo,1940,0,0,7,7,0.0%,1h
45197,2,rddeathlord,1939,1543,226,268,494,45.7%,3h
45197,2,lazerblazer,1939,1191,56,75,131,42.7%,16m
45197,3,[13013]Mudru,1939,984,51,65,116,44.0%,38m
45197,2,ashenlimit,1939,941,41,37,78,52.6%,3h
45197,2,magistermu,1939,217,35,34,69,50.7%,9m
45197,3,TitanKS,1939,777,27,28,55,49.1%,9m
45197,3,malcolm,1939,616,25,32,57,43.9%,1h
45197,1,Skon,1939,292,12,25,37,32.4%,3h
45197,3,HereticDBD,1939,58,6,2,8,75.0%,28m
45197,1,SleepyBear,1939,192,5,9,14,35.7%,1h
45197,2,Onerb,1939,163,5,17,22,22.7%,13m
45197,2,Jhamir,1939,90,3,9,12,25.0%,1h
45197,2,[XGang]alac,1939,0,2,5,7,28.6%,3h
45197,1,[ThEps]Nannamal,1939,48,2,10,12,16.7%,22m
45197,3,Spydr,1939,30,1,2,3,33.3%,3h
45197,3,[SITW]BLUE,1939,0,0,1,1,0.0%,1h
45197,3,[ExcIgN]lerrais,1939,0,0,1,1,0.0%,1h
45197,3,DANGA,1939,0,0,1,1,0.0%,3h
45197,2,atrydes,1939,0,0,3,3,0.0%,3h
45197,2,KIsixPSP,1939,0,0,3,3,0.0%,8m
45197,3,[LRGO]GoofyFox,1939,0,0,6,6,0.0%,1h
45218,2,MasterCpu,1938,1106,59,56,115,51.3%,3h
45218,3,JuanMAA,1938,1290,55,50,105,52.4%,9m
45218,3,MineCraft,1938,707,36,24,60,60.0%,1h
45218,3,Foxtrot,1938,340,12,14,26,46.2%,3h
45218,2,CoyaBot,1938,353,12,18,30,40.0%,1h
45218,3,machete,1938,252,10,8,18,55.6%,1h
45218,2,Rhous,1938,328,10,17,27,37.0%,3h
45218,2,Mental,1938,149,7,15,22,31.8%,3m
45218,2,ChaoticBacon,1938,147,5,6,11,45.5%,1h
45218,3,Odiseo,1938,59,5,8,13,38.5%,1h
45218,3,Poodlepuff,1938,90,4,6,10,40.0%,1h
45218,2,Godoy,1938,120,4,11,15,26.7%,50m
45218,1,GranAlfa,1938,96,2,8,10,20.0%,34m
45218,3,McFly,1938,0,1,3,4,25.0%,9m
45218,2,Antrvm,1938,32,1,8,9,11.1%,42m
45218,3,Seth,1938,0,0,2,2,0.0%,2m
45218,2,Umm,1938,0,0,7,7,0.0%,42m
45218,2,Boonanabob,1938,0,0,7,7,0.0%,1h
45236,2,DaneGRClose,1937,1105,54,55,109,49.5%,50m
45236,2,Joedan,1937,1097,40,45,85,47.1%,57m
45236,1,pplarge,1937,407,21,29,50,42.0%,3h
45236,1,Marlin,1937,654,20,42,62,32.3%,3h
45236,3,PREDATOR,1937,488,18,11,29,62.1%,47m
45236,3,MonoPelusso,1937,428,15,19,34,44.1%,3h
45236,1,ScottSizzle,1937,227,7,12,19,36.8%,48m
45236,3,RAmzap,1937,166,6,4,10,60.0%,27m
45236,3,ColdBlooded,1937,211,6,16,22,27.3%,33m
45236,3,[4I6]TERRANITUP,1937,160,4,4,8,50.0%,48m
45236,2,SandDessert,1937,118,4,9,13,30.8%,9m
45236,2,ArchMotif,1937,124,4,11,15,26.7%,1h
45236,1,[1Fenix]lateraluss,1937,96,3,10,13,23.1%,17m
45236,2,vlad,1937,88,1,3,4,25.0%,27m
45236,3,Floodslayer,1937,30,1,3,4,25.0%,1h
45236,2,HeySimon,1937,30,1,4,5,20.0%,3h
45236,3,Ticus,1937,0,0,1,1,0.0%,3h
45236,3,Levent,1937,0,0,1,1,0.0%,41m
45236,2,MuscleboyKCB,1937,0,0,3,3,0.0%,1h
45236,2,MajorTalon,1937,0,0,5,5,0.0%,1h
45256,1,Xaqar,1936,1564,308,346,654,47.1%,3h
45256,1,rapha,1936,1655,228,305,533,42.8%,1h
45256,2,AvigaFIN,1936,1469,166,166,332,50.0%,51m
45256,3,[UMCP]Shrek,1936,1413,130,156,286,45.5%,38m
45256,2,[LOPELU]celord,1936,1522,100,103,203,49.3%,1h
45256,2,Mecanicox,1936,1331,87,90,177,49.2%,1h
45256,2,Shrek,1936,1594,80,103,183,43.7%,58m
45256,2,latino,1936,1116,58,62,120,48.3%,9m
45256,3,torres,1936,800,28,30,58,48.3%,1h
45256,3,starnite,1936,427,16,13,29,55.2%,3h
45256,2,TenaciousL,1936,358,13,22,35,37.1%,33m
45256,2,Simp,1936,258,10,10,20,50.0%,3h
45256,2,Harveynz,1936,136,7,7,14,50.0%,34m
45256,2,NewMetaOrder,1936,96,3,7,10,30.0%,42m
45256,2,[GRNSKN]Shepherd,1936,90,3,9,12,25.0%,16m
45256,3,[xFUNx]Renegade,1936,0,2,3,5,40.0%,1h
45256,3,[Sl8]SmokeE,1936,30,2,4,6,33.3%,15m
45256,3,Guerilla,1936,30,2,4,6,33.3%,31m
45256,3,IIIIIIIIIIII,1936,0,1,0,1,100.0%,38m
45256,3,computer,1936,0,1,1,2,50.0%,1h
45256,3,WOJTEK,1936,0,1,1,2,50.0%,2h
45256,3,SuperJoker,1936,38,1,2,3,33.3%,52m
45256,1,ASUViper,1936,0,0,1,1,0.0%,3h
45256,3,Archimedes,1936,0,0,1,1,0.0%,3h
45256,3,[EvnKrg]Aigis,1936,0,0,1,1,0.0%,9m
45256,3,[HD7K]CHILO,1936,0,0,1,1,0.0%,1h
45256,3,Keet,1936,0,0,1,1,0.0%,3h
45256,3,HectorC,1936,0,0,2,2,0.0%,31m
45256,3,IIIIIIIIIIII,1936,0,0,6,6,0.0%,3h
45285,2,qwertyuiop,1935,1514,162,180,342,47.4%,3h
45285,3,jerkyerk,1935,1540,107,113,220,48.6%,52m
45285,2,FREDDY,1935,1604,92,98,190,48.4%,1h
45285,2,Ozkarter,1935,891,89,92,181,49.2%,3h
45285,3,Javierson,1935,1130,41,42,83,49.4%,1h
45285,3,charlicc,1935,804,31,25,56,55.4%,17m
45285,1,Vexxtor,1935,578,20,29,49,40.8%,1h
45285,3,Macromi,1935,386,13,17,30,43.3%,4m
45285,3,Dacatapiller,1935,331,11,11,22,50.0%,1h
45285,2,vvxxwxxvv,1935,324,11,22,33,33.3%,1h
45285,3,glacierx,1935,141,3,5,8,37.5%,38m
45285,2,ProjectVast,1935,90,3,9,12,25.0%,13m
45285,2,MrNiceGuy,1935,173,3,10,13,23.1%,1h
45285,1,zvmzvm,1935,36,2,10,12,16.7%,3h
45285,3,MoXnoRiL,1935,0,1,0,1,100.0%,4m
45285,1,karlitox,1935,48,1,6,7,14.3%,1h
45285,2,Dasher,1935,46,1,9,10,10.0%,1h
45285,3,BENgATSBY,1935,0,0,1,1,0.0%,24m
45285,2,DiRosa,1935,0,0,1,1,0.0%,8m
45285,2,[AbcCo]Zgiro,1935,0,0,2,2,0.0%,51m
45285,3,cuervoOSCURO,1935,0,0,2,2,0.0%,41m
45285,2,NakedMan,1935,0,0,3,3,0.0%,1h
45285,3,progressor,1935,0,0,4,4,0.0%,3h
45285,3,ZZROT,1935,0,0,6,6,0.0%,47m
45285,2,Amnzre,1935,0,0,6,6,0.0%,3h
45310,1,venom,1934,1619,261,290,551,47.4%,3h
45310,2,LeftaroO,1934,1330,91,116,207,44.0%,3h
45310,2,[DRKESP]Krgansgrampa,1934,1533,62,66,128,48.4%,3h
45310,3,Brnl,1934,775,51,50,101,50.5%,12m
45310,1,Sean,1934,1164,38,57,95,40.0%,18m
45310,3,satchmoe,1934,790,32,34,66,48.5%,3h
45310,3,Pdtroia,1934,564,24,20,44,54.5%,1h
45310,3,Atlas,1934,520,19,21,40,47.5%,1h
45310,2,CNeifert,1934,437,17,18,35,48.6%,3h
45310,2,Gopster,1934,466,16,19,35,45.7%,60m
45310,2,Odinn,1934,355,13,14,27,48.1%,35m
45310,2,ZombieHunter,1934,332,12,10,22,54.5%,9m
45310,3,Dombamdam,1934,63,4,0,4,100.0%,1h
45310,1,[AIURxT]elmenas,1934,178,4,3,7,57.1%,8m
45310,3,Walker,1934,30,4,3,7,57.1%,39m
45310,3,[asco]MusMey,1934,169,4,7,11,36.4%,3h
45310,2,Adelais,1934,0,3,3,6,50.0%,27m
45310,1,[lab317]MRALEXANDER,1934,88,2,3,5,40.0%,3h
45310,3,MMMMicha,1934,30,2,12,14,14.3%,27m
45310,2,Erio,1934,0,0,3,3,0.0%,1h
45310,2,[420v69]ButtFeast,1934,0,0,5,5,0.0%,1h
45331,3,Hal,1933,1591,271,426,697,38.9%,1h
45331,2,Kchorro,1933,1506,133,148,281,47.3%,16m
45331,2,Sinfulgonz,1933,1512,79,99,178,44.4%,3h
45331,2,SupBrown,1933,1001,47,35,82,57.3%,42m
45331,2,Eclipse,1933,968,38,42,80,47.5%,27m
45331,1,Libertybell,1933,553,21,27,48,43.8%,30m
45331,2,NightKnight,1933,272,13,13,26,50.0%,3h
45331,3,[LOCAL]Goldenboy,1933,324,11,14,25,44.0%,1h
45331,2,Atticus,1933,270,8,17,25,32.0%,16m
45331,3,Murcielago,1933,185,7,7,14,50.0%,38m
45331,1,LurIk,1933,117,3,7,10,30.0%,11m
45331,2,Atheos,1933,131,2,3,5,40.0%,8m
45331,2,halfdrunk,1933,64,2,9,11,18.2%,1h
45331,3,Secrethojo,1933,34,2,13,15,13.3%,1h
45331,3,Bazinga,1933,0,1,0,1,100.0%,9m
45331,3,JayyRR,1933,0,1,0,1,100.0%,26m
45331,3,Libor,1933,97,1,4,5,20.0%,1h
45331,2,Ermes,1933,0,1,7,8,12.5%,3h
45331,3,Scorpion,1933,0,0,1,1,0.0%,1h
45331,3,[MLP0NY]BubbaG,1933,0,0,2,2,0.0%,46m
45331,2,IronKidd,1933,0,0,2,2,0.0%,1h
45331,2,QuirkyOrc,1933,0,0,7,7,0.0%,1h
45353,3,CookieBoy,1932,1623,226,279,505,44.8%,15m
45353,2,LuckyRay,1932,1563,119,124,243,49.0%,3h
45353,3,Pikaslash,1932,912,48,46,94,51.1%,3h
45353,2,[JUGOS]elchotasi,1932,1068,44,47,91,48.4%,3m
45353,2,LonelyHeart,1932,1005,38,39,77,49.4%,31m
45353,2,PokerPlayer,1932,890,34,38,72,47.2%,1h
45353,2,StealthyChap,1932,489,21,15,36,58.3%,1h
45353,3,sujhan,1932,336,20,21,41,48.8%,1h
45353,2,ChikiPuki,1932,416,17,21,38,44.7%,3h
45353,3,[nieBla]allmikey,1932,242,9,11,20,45.0%,1h
45353,2,GabrielGP,1932,262,8,15,23,34.8%,16m
45353,2,crumb,1932,90,5,6,11,45.5%,1h
45353,1,Zombiemaster,1932,199,5,14,19,26.3%,12m
45353,3,Ittifi,1932,118,4,9,13,30.8%,27m
45353,2,WHITELION,1932,102,4,11,15,26.7%,3m
45353,3,hdhierro,1932,93,1,7,8,12.5%,38m
45353,1,sabotage,1932,0,1,8,9,11.1%,1h
45353,3,SnKSolid,1932,0,0,6,6,0.0%,3h
45353,2,[MeanM]Hélios,1932,0,0,7,7,0.0%,3h
45353,2,Rafita,1932,0,0,7,7,0.0%,23m
45373,1,yuseifrank,1931,892,261,281,542,48.2%,1h
45373,2,PassedZKT,1931,1513,95,103,198,48.0%,1h
45373,2,Papa,1931,1520,57,62,119,47.9%,3h
45373,2,Varman,1931,1223,45,52,97,46.4%,35m
45373,2,KINGZOMBIE,1931,928,39,48,87,44.8%,35m
45373,2,Shadow,1931,705,34,29,63,54.0%,9m
45373,1,CharlesVail,1931,752,25,42,67,37.3%,1h
45373,3,racistdragon,1931,537,19,27,46,41.3%,22m
45373,2,conehead,1931,448,17,19,36,47.2%,3h
45373,2,[R1DE]LATINAMERICA,1931,352,10,35,45,22.2%,52m
45373,3,katuki,1931,297,9,20,29,31.0%,1h
45373,2,Pepperwood,1931,236,7,16,23,30.4%,3h
45373,3,Rambo,1931,176,6,8,14,42.9%,3h
45373,3,DRONEXXX,1931,140,5,4,9,55.6%,3m
45373,3,Hurley,1931,30,2,1,3,66.7%,1h
45373,3,BulletEyes,1931,0,1,0,1,100.0%,1h
45373,3,[Raver2]WorldRaver,1931,0,1,2,3,33.3%,3h
45373,2,DanielEMC,1931,0,1,4,5,20.0%,3h
45373,3,MexaLuv,1931,30,1,6,7,14.3%,3h
45373,2,EnJi,1931,32,1,6,7,14.3%,3h
45373,2,ShlomoEmpire,1931,46,1,8,9,11.1%,8m
45373,1,jimraynor,1931,0,0,2,2,0.0%,17m
45373,1,Potatoehunt,1931,0,0,2,2,0.0%,33m
45373,3,[Boogi]Kiwi,1931,0,0,4,4,0.0%,3h
45373,3,limoncito,1931,0,0,6,6,0.0%,2m
45373,2,Choaslord,1931,0,0,6,6,0.0%,32m
45373,2,Bodil,1931,0,0,7,7,0.0%,3h
45400,2,wes,1930,1514,82,85,167,49.1%,1h
45400,3,[xDYEx]manzur,1930,605,43,36,79,54.4%,24m
45400,2,Alejandro,1930,840,33,40,73,45.2%,3m
45400,3,terran,1930,718,24,28,52,46.2%,56m
45400,3,Fxrede,1930,591,21,29,50,42.0%,18m
45400,2,StrangerD,1930,544,19,31,50,38.0%,3h
45400,2,LokDragon,1930,345,13,18,31,41.9%,1h
45400,3,CAMARONCIN,1930,291,9,10,19,47.4%,3h
45400,2,[4narch]tingulwen,1930,296,9,17,26,34.6%,34m
45400,3,Alan,1930,243,8,5,13,61.5%,27m
45400,3,XxTMATZxX,1930,200,5,18,23,21.7%,1h
45400,3,Jack,1930,145,4,4,8,50.0%,30m
45400,3,goANDchase,1930,30,2,4,6,33.3%,1h
45400,1,Otto,1930,96,2,11,13,15.4%,1h
45400,1,Randhyfloo,1930,0,1,0,1,100.0%,34m
45400,3,BrightDyed,1930,30,1,6,7,14.3%,3h
45400,2,YEEHAWWWWWWW,1930,30,1,7,8,12.5%,31m
45400,2,pipi,1930,30,1,8,9,11.1%,3h
45400,1,AbellaDanger,1930,0,0,1,1,0.0%,1h
45400,3,Logio,1930,0,0,2,2,0.0%,1h
45400,3,Joradrivia,1930,0,0,3,3,0.0%,36m
45400,2,Ingeniero,1930,0,0,5,5,0.0%,18m
45422,2,Enu,1929,1105,139,154,293,47.4%,3m
45422,2,Vinny,1929,1492,113,131,244,46.3%,57m
45422,2,lOPSlTerran,1929,745,29,29,58,50.0%,9m
45422,2,[AKWarr]TimmyVader,1929,786,25,37,62,40.3%,1h
45422,2,SOUSO,1929,451,19,25,44,43.2%,1h
45422,2,SogeKing,1929,313,11,24,35,31.4%,31m
45422,1,MEGAEZTRAL,1929,279,7,9,16,43.8%,1h
45422,3,JBAC,1929,205,6,9,15,40.0%,36m
45422,3,ShwiftyPants,1929,114,5,5,10,50.0%,1h
45422,3,BearHunter,1929,123,5,6,11,45.5%,27m
45422,3,[SIMPx]TEX,1929,102,4,3,7,57.1%,24m
45422,2,Cheeseling,1929,136,4,10,14,28.6%,1h
45422,3,tedpain,1929,151,3,10,13,23.1%,1h
45422,3,Leon,1929,58,2,2,4,50.0%,26m
45422,3,Ardilla,1929,58,2,5,7,28.6%,5m
45422,3,Linfocito,1929,58,2,5,7,28.6%,27m
45422,3,ProtossFS,1929,117,2,5,7,28.6%,5m
45422,1,steelmaster,1929,0,1,1,2,50.0%,1h
45422,3,BlackSkull,1929,0,1,2,3,33.3%,39m
45422,2,RubberFangz,1929,93,1,8,9,11.1%,8m
45422,3,Glouktar,1929,0,0,1,1,0.0%,28m
45422,3,JRSchnack,1929,0,0,5,5,0.0%,47m
45422,3,DanielGoldBr,1929,0,0,7,7,0.0%,3h
45422,2,xandiel,1929,0,0,7,7,0.0%,60m
45446,2,Mildandmeek,1928,950,64,74,138,46.4%,34m
45446,2,[SvgApe]Anklbrakr,1928,1257,56,55,111,50.5%,1h
45446,1,[MyLawn]Rohda,1928,702,20,40,60,33.3%,26m
45446,3,SunnyIDK,1928,398,15,27,42,35.7%,9m
45446,3,Tunechi,1928,313,10,10,20,50.0%,1h
45446,3,NAF,1928,258,9,10,19,47.4%,27m
45446,2,Lumpy,1928,309,9,20,29,31.0%,13m
45446,3,mcb,1928,202,8,4,12,66.7%,1h
45446,3,[PobSC]litrox,1928,202,7,9,16,43.8%,36m
45446,3,jarmar,1928,60,5,4,9,55.6%,3h
45446,1,Manolito,1928,0,3,9,12,25.0%,42m
45446,2,ricardo,1928,30,2,16,18,11.1%,34m
45446,3,Memorex,1928,0,1,0,1,100.0%,1h
45446,2,[xDiKx]Hijinks,1928,42,1,11,12,8.3%,1h
45446,3,Shamrock,1928,0,0,1,1,0.0%,52m
45446,3,Christine,1928,0,0,1,1,0.0%,30m
45446,3,Machina,1928,0,0,1,1,0.0%,13m
45446,2,AMLOPEJE,1928,0,0,1,1,0.0%,8m
45464,2,Jimvlad,1927,1537,368,417,785,46.9%,3h
45464,2,ajcarpio,1927,1570,111,106,217,51.2%,3h
45464,2,Herb,1927,942,52,61,113,46.0%,3h
45464,3,DEADLIFT,1927,825,36,22,58,62.1%,22m
45464,2,kerim,1927,532,25,26,51,49.0%,3m
45464,3,[SLACK]ZombieSStrut,1927,674,24,42,66,36.4%,1h
45464,1,[Chihui]bonLoz,1927,352,10,18,28,35.7%,3h
45464,3,zepedowsky,1927,269,8,19,27,29.6%,1h
45464,3,Arteros,1927,180,7,10,17,41.2%,1h
45464,3,[CRRLL2]TylerRock,1927,168,6,5,11,54.5%,1h
45464,2,robotin,1927,88,5,9,14,35.7%,57m
45464,3,LibraLucifer,1927,97,1,5,6,16.7%,1h
45464,2,Soulforge,1927,48,1,8,9,11.1%,27m
45464,1,Schmutzig,1927,0,1,9,10,10.0%,1h
45464,3,BananaKush,1927,0,0,6,6,0.0%,2h
45464,2,Capnplanet,1927,0,0,6,6,0.0%,42m
45480,2,Neox,1926,1524,147,162,309,47.6%,3h
45480,3,[xNG3x]TDiddy,1926,1166,43,46,89,48.3%,44m
45480,3,Joasab,1926,938,36,31,67,53.7%,3h
45480,2,Rabies,1926,651,24,36,60,40.0%,1h
45480,2,Zenphyto,1926,443,22,27,49,44.9%,51m
45480,3,Destroyer,1926,338,12,10,22,54.5%,2h
45480,2,Edy,1926,188,5,9,14,35.7%,13m
45480,2,NiNo,1926,197,4,9,13,30.8%,3h
45480,2,SebasDaiFort,1926,170,4,12,16,25.0%,1h
45480,2,rip,1926,0,3,3,6,50.0%,1h
45480,1,dasimpsonian,1926,149,3,7,10,30.0%,1h
45480,2,InsertQ,1926,60,3,8,11,27.3%,33m
45480,3,TheOne,1926,60,2,5,7,28.6%,1h
45480,3,pdoge,1926,0,1,0,1,100.0%,1h
45480,3,MReaTech,1926,30,1,1,2,50.0%,30m
45480,2,[SMCE]JAVIER,1926,30,1,4,5,20.0%,3h
45480,3,MDC,1926,30,1,6,7,14.3%,3h
45480,2,ancestors,1926,0,1,8,9,11.1%,27m
45480,3,Nova,1926,0,0,1,1,0.0%,38m
45480,1,tinydancer,1926,0,0,1,1,0.0%,1h
45480,3,CoughDrop,1926,0,0,5,5,0.0%,36m
45480,2,fadedlotus,1926,0,0,5,5,0.0%,51m
45502,1,Toilet,1925,1625,217,266,483,44.9%,1h
45502,2,[BraziI]LuiXOp,1925,1511,118,127,245,48.2%,3h
45502,2,[Devote]Hemingway,1925,1484,53,71,124,42.7%,3h
45502,2,[CADIVI]Mpdc,1925,1210,44,52,96,45.8%,45m
45502,3,Gregarious,1925,685,27,26,53,50.9%,3h
45502,2,Zod,1925,618,26,30,56,46.4%,3h
45502,3,NaiiYaii,1925,667,24,31,55,43.6%,1h
45502,2,Ank,1925,694,23,35,58,39.7%,3m
45502,3,Ardas,1925,474,20,20,40,50.0%,1h
45502,2,WarLordGio,1925,268,11,10,21,52.4%,3h
45502,1,Esarres,1925,246,8,15,23,34.8%,10m
45502,3,MrKush,1925,168,6,6,12,50.0%,1h
45502,2,TheSpark,1925,211,6,10,16,37.5%,28m
45502,3,[HOT69]souldev,1925,86,4,1,5,80.0%,1h
45502,3,ALGRIM,1925,142,4,4,8,50.0%,33m
45502,3,getbize,1925,30,3,12,15,20.0%,30m
45502,3,NitroJoe,1925,30,2,4,6,33.3%,1h
45502,3,[Vtta]NIEHLK,1925,0,1,1,2,50.0%,21m
45502,3,Quez,1925,0,1,2,3,33.3%,3m
45502,1,PappoST,1925,0,1,8,9,11.1%,1h
45502,1,Torch,1925,0,1,9,10,10.0%,9m
45502,3,Ender,1925,0,0,1,1,0.0%,1h
45502,1,[ADIC]Seale,1925,0,0,3,3,0.0%,1h
45502,2,fruitypebbs,1925,0,0,5,5,0.0%,1h
45502,3,SirReynolds,1925,0,0,6,6,0.0%,3h
45527,3,kamus,1924,1040,60,63,123,48.8%,1h
45527,3,Mowgli,1924,731,42,48,90,46.7%,1h
45527,3,zougoulou,1924,456,42,52,94,44.7%,46m
45527,3,[SCPER1]maza,1924,500,17,22,39,43.6%,3h
45527,3,Hungerstrike,1924,372,13,19,32,40.6%,24m
45527,2,Vint,1924,275,13,20,33,39.4%,1h
45527,2,EaZyMoneyyy,1924,163,10,19,29,34.5%,35m
45527,1,[Klukun]Gandalf,1924,283,9,19,28,32.1%,1h
45527,3,elpedoslocos,1924,97,5,7,12,41.7%,47m
45527,2,TRINTA,1924,206,4,4,8,50.0%,42m
45527,3,Fiki,1924,84,3,4,7,42.9%,1h
45527,3,OkLOKI,1924,90,3,7,10,30.0%,36m
45527,1,[NUTZZZ]Boilermaker,1924,86,3,9,12,25.0%,54m
45527,2,Jquince,1924,90,3,9,12,25.0%,3h
45527,3,MasterSmokey,1924,68,2,3,5,40.0%,1h
45527,2,mkomp,1924,0,2,6,8,25.0%,3h
45527,3,griffinator,1924,0,1,0,1,100.0%,28m
45527,2,NugerPidoras,1924,0,1,0,1,100.0%,1h
45527,3,CynicalScrub,1924,30,1,1,2,50.0%,1h
45527,3,Tomas,1924,0,1,5,6,16.7%,1h
45547,3,PELAO,1923,1512,82,87,169,48.5%,1h
45547,2,marcko,1923,1537,63,65,128,49.2%,34m
45547,3,Forecast,1923,1237,53,47,100,53.0%,1h
45547,2,Marscopone,1923,578,24,23,47,51.1%,3h
45547,3,ShadowZack,1923,322,11,15,26,42.3%,1h
45547,2,AllenIverson,1923,292,10,23,33,30.3%,1h
45547,3,ulisesteca,1923,104,5,5,10,50.0%,3m
45547,2,DeadPhones,1923,136,3,1,4,75.0%,12m
45547,2,javier,1923,114,2,5,7,28.6%,3h
45547,2,Crazywig,1923,92,2,9,11,18.2%,28m
45547,3,JKGODYT,1923,30,1,1,2,50.0%,1h
45547,3,fabrizio,1923,30,1,1,2,50.0%,3h
45547,2,Eclisto,1923,93,1,8,9,11.1%,12m
45547,3,reggieotter,1923,0,0,1,1,0.0%,1h
45547,3,Superey,1923,0,0,2,2,0.0%,15m
45547,1,Bakunin,1923,0,0,5,5,0.0%,1h
45563,3,Drona,1922,1597,271,276,547,49.5%,24m
45563,3,NiceShotTrev,1922,1399,90,105,195,46.2%,1h
45563,2,emmanuelddog,1922,1056,37,49,86,43.0%,3h
45563,3,ProfesorX,1922,723,32,41,73,43.8%,9m
45563,3,INVASOR,1922,737,30,25,55,54.5%,46m
45563,3,Android,1922,671,24,22,46,52.2%,13m
45563,3,Rexxar,1922,266,13,11,24,54.2%,2h
45563,2,Jirochgu,1922,382,13,17,30,43.3%,3m
45563,2,Angus,1922,342,13,23,36,36.1%,16m
45563,3,Overlord,1922,244,9,10,19,47.4%,48m
45563,2,BlackWolf,1922,242,9,13,22,40.9%,3h
45563,3,[CCPcl]rancochile,1922,168,7,10,17,41.2%,1h
45563,3,Japes,1922,191,6,5,11,54.5%,59m
45563,2,Dreamno,1922,193,5,3,8,62.5%,1h
45563,3,Xsixteen,1922,118,5,6,11,45.5%,1h
45563,2,BeatYourKids,1922,146,5,11,16,31.2%,1h
45563,3,xXWeedManXx,1922,0,4,1,5,80.0%,1h
45563,3,Matrix,1922,120,4,5,9,44.4%,28m
45563,2,Kojimatsu,1922,30,4,6,10,40.0%,60m
45563,3,waikeong,1922,0,0,1,1,0.0%,44m
45563,3,Jackfrost,1922,0,0,2,2,0.0%,47m
45563,3,LEXAR,1922,0,0,6,6,0.0%,3h
45585,2,elCIRuJaNo,1921,1572,65,84,149,43.6%,60m
45585,2,killlock,1921,1113,60,60,120,50.0%,3h
45585,2,WillDaBeast,1921,1373,52,57,109,47.7%,3h
45585,2,BOLSONARO,1921,826,29,44,73,39.7%,3m
45585,2,aeme,1921,530,18,27,45,40.0%,3h
45585,3,EvilCorona,1921,198,8,7,15,53.3%,1h
45585,3,XxMONGOxX,1921,247,6,5,11,54.5%,9m
45585,3,Nuke,1921,176,6,9,15,40.0%,3h
45585,2,[ML4WD]SlackRooter,1921,126,6,16,22,27.3%,3h
45585,3,XDecker,1921,142,5,5,10,50.0%,1h
45585,1,KenCause,1921,140,4,15,19,21.1%,3h
45585,2,Cochinosapo,1921,147,3,10,13,23.1%,8m
45585,3,Darckgeminis,1921,30,2,0,2,100.0%,1h
45585,2,Eorgorrt,1921,95,2,6,8,25.0%,3h
45585,3,Ludwig,1921,0,1,0,1,100.0%,3h
45585,3,TheDarcy,1921,0,1,2,3,33.3%,27m
45585,3,[DhZon3]otavio,1921,0,0,1,1,0.0%,1h
45585,1,[ECS]chandler,1921,0,0,4,4,0.0%,54m
45585,3,crediblebus,1921,0,0,6,6,0.0%,16m
45604,2,LUKECRAFT,1920,1501,138,142,280,49.3%,3h
45604,3,Cardon,1920,1594,102,107,209,48.8%,31m
45604,3,Pits,1920,1298,53,51,104,51.0%,38m
45604,2,cesar,1920,594,20,26,46,43.5%,3h
45604,2,[xKATx]Ragnar,1920,546,18,27,45,40.0%,3h
45604,2,Nothomb,1920,441,14,26,40,35.0%,24m
45604,3,Pound,1920,296,10,12,22,45.5%,41m
45604,3,Nemesis,1920,193,9,1,10,90.0%,1h
45604,1,GyroAeg,1920,172,5,14,19,26.3%,1h
45604,3,Gfc,1920,197,5,16,21,23.8%,1h
45604,1,Edrojas,1920,111,4,10,14,28.6%,3h
45604,1,[SucBol]Darkus,1920,102,3,11,14,21.4%,1h
45604,3,[XLNT]Husky,1920,96,2,0,2,100.0%,1h
45604,3,Roger,1920,30,2,4,6,33.3%,36m
45604,1,keni,1920,48,2,13,15,13.3%,47m
45604,3,Jlebeau,1920,0,1,0,1,100.0%,1h
45604,3,jepperepper,1920,0,1,0,1,100.0%,28m
45604,3,Ironfist,1920,30,1,1,2,50.0%,28m
45604,1,alfenigma,1920,0,1,2,3,33.3%,13m
45604,3,MAURICIO,1920,30,1,6,7,14.3%,3h
45604,1,cmillie,1920,97,1,6,7,14.3%,1h
45604,3,[LMI42]JDOUBLE,1920,0,0,1,1,0.0%,12m
45604,3,BentoThrash,1920,0,0,2,2,0.0%,3h
45604,3,JoeyS,1920,0,0,4,4,0.0%,18m
45628,3,JIM,1919,1592,118,137,255,46.3%,3h
45628,2,thekingdanny,1919,1147,107,135,242,44.2%,51m
45628,2,GGUIDOS,1919,1157,49,51,100,49.0%,3h
45628,2,MinuteMan,1919,686,37,36,73,50.7%,7m
45628,2,GUILE,1919,912,32,46,78,41.0%,3h
45628,2,IGCH,1919,612,22,24,46,47.8%,40m
45628,3,PlowingUrMOM,1919,464,19,22,41,46.3%,29m
45628,3,EDU,1919,440,16,18,34,47.1%,3h
45628,2,Serral,1919,103,13,28,41,31.7%,39m
45628,3,[a1vNA]Fire,1919,276,10,8,18,55.6%,27m
45628,2,[CRaPaN]IIIIIIIIIII,1919,275,8,13,21,38.1%,3h
45628,3,Gonza,1919,243,7,4,11,63.6%,38m
45628,3,AngerMan,1919,224,7,20,27,25.9%,48m
45628,2,Slyndovv,1919,122,6,9,15,40.0%,3h
45628,2,roy,1919,104,4,5,9,44.4%,3h
45628,3,[COLBOG]Leokiller,1919,90,4,7,11,36.4%,38m
45628,3,zerk,1919,134,4,8,12,33.3%,46m
45628,3,[00SB00]SpItFiRe,1919,60,2,6,8,25.0%,1h
45628,1,PROMETHEUS,1919,46,2,9,11,18.2%,3m
45628,2,[GCCLAN]ItsFrankYz,1919,0,1,0,1,100.0%,1h
45628,3,Kiramadara,1919,0,1,1,2,50.0%,9m
45628,3,Pickles,1919,0,1,1,2,50.0%,41m
45628,2,yoisan,1919,34,1,1,2,50.0%,1h
45628,3,[GpoABX]Avikla,1919,0,1,2,3,33.3%,38m
45628,3,scooterdog,1919,30,1,2,3,33.3%,9m
45628,3,[1997]TonyGFKing,1919,30,1,3,4,25.0%,9m
45628,1,[4g63]Anomaly,1919,32,1,10,11,9.1%,3h
45628,3,[NWT]CaptainMac,1919,0,0,1,1,0.0%,3h
45656,1,Torrentosky,1918,1171,74,85,159,46.5%,3h
45656,3,SoiledPants,1918,991,47,35,82,57.3%,1h
45656,3,Bloodnut,1918,289,23,32,55,41.8%,1h
45656,3,Mikey,1918,300,10,10,20,50.0%,28m
45656,3,AleciaaicelA,1918,286,10,15,25,40.0%,28m
45656,3,reizercris,1918,240,8,12,20,40.0%,3h
45656,2,Ilynn,1918,56,5,11,16,31.2%,35m
45656,3,EagleHeart,1918,88,4,1,5,80.0%,41m
45656,2,Beowolf,1918,0,1,0,1,100.0%,1h
45656,3,Ember,1918,30,1,1,2,50.0%,1h
45656,3,mkBabidi,1918,0,1,2,3,33.3%,3h
45656,3,forevasilver,1918,30,1,5,6,16.7%,3m
45656,3,[TEVÉZ]akitaxi,1918,96,1,5,6,16.7%,31m
45656,2,dustman,1918,46,1,10,11,9.1%,12m
45656,3,MagicTurtle,1918,0,0,1,1,0.0%,28m
45656,3,shago,1918,0,0,2,2,0.0%,1h
45656,3,Tarvanis,1918,0,0,5,5,0.0%,38m
45673,2,VoltaAmpere,1917,1580,186,213,399,46.6%,3h
45673,2,SLAVA,1917,1516,159,167,326,48.8%,3h
45673,2,Ottomatic,1917,1524,103,127,230,44.8%,43m
45673,3,captainbob,1917,1561,94,104,198,47.5%,13m
45673,2,omgPROHASKA,1917,1254,48,49,97,49.5%,1h
45673,3,Ledgunsmith,1917,850,34,41,75,45.3%,1h
45673,2,SORAJIANG,1917,321,19,15,34,55.9%,9m
45673,3,Rino,1917,272,10,11,21,47.6%,41m
45673,3,satcomiv,1917,258,8,8,16,50.0%,1h
45673,3,Turtle,1917,128,5,7,12,41.7%,38m
45673,3,bjai,1917,0,3,2,5,60.0%,38m
45673,3,Mandirigma,1917,58,3,11,14,21.4%,59m
45673,3,Joshpiolin,1917,30,2,0,2,100.0%,24m
45673,3,mariel,1917,0,1,1,2,50.0%,1h
45673,2,Dinkus,1917,0,1,6,7,14.3%,42m
45673,3,[AbcCo]tarilon,1917,0,0,1,1,0.0%,3h
45673,2,Ghost,1917,0,0,7,7,0.0%,42m
45690,3,ALF,1916,1026,67,68,135,49.6%,3h
45690,3,BuiltToLast,1916,1016,62,60,122,50.8%,1h
45690,2,BrknCntrlr,1916,1226,52,59,111,46.8%,9m
45690,3,Fish,1916,1136,46,48,94,48.9%,2h
45690,2,ochese,1916,1114,44,48,92,47.8%,20m
45690,2,nemesis,1916,812,28,38,66,42.4%,1h
45690,2,mudasuka,1916,139,24,29,53,45.3%,27m
45690,3,Dinker,1916,518,21,27,48,43.8%,9m
45690,3,Vandersson,1916,463,17,26,43,39.5%,41m
45690,2,varo,1916,248,9,13,22,40.9%,1h
45690,2,Wallas,1916,195,6,13,19,31.6%,31m
45690,3,Run,1916,86,3,1,4,75.0%,9m
45690,3,Adalfarus,1916,30,2,6,8,25.0%,3h
45690,3,GovtCheese,1916,0,1,1,2,50.0%,3h
45690,2,Wyvrn,1916,30,1,7,8,12.5%,4m
45690,3,Raghnzr,1916,0,0,1,1,0.0%,31m
45690,1,carlos,1916,0,0,3,3,0.0%,3h
45690,3,victor,1916,0,0,6,6,0.0%,22m
45708,1,Rudedog,1915,1603,666,696,1362,48.9%,3h
45708,2,Testosterone,1915,1288,88,93,181,48.6%,3h
45708,1,monicagalind,1915,1365,58,68,126,46.0%,44m
45708,3,Repoman,1915,755,50,45,95,52.6%,24m
45708,2,joash,1915,954,34,42,76,44.7%,1h
45708,2,FattestMouse,1915,669,32,34,66,48.5%,51m
45708,1,CerealKILLA,1915,948,32,50,82,39.0%,1h
45708,3,[SxyMxN]SuperJems,1915,608,22,25,47,46.8%,1h
45708,2,Alpacacide,1915,520,20,21,41,48.8%,3h
45708,3,[SCMK]Viaos,1915,514,18,14,32,56.2%,1h
45708,2,[WTNRCL]RyuShin,1915,336,11,22,33,33.3%,3h
45708,3,maxiviento,1915,238,9,11,20,45.0%,1h
45708,1,thekiller,1915,273,8,16,24,33.3%,29m
45708,2,BPHT,1915,148,5,12,17,29.4%,3h
45708,2,[GGMESP]MORNUN,1915,142,4,9,13,30.8%,3h
45708,3,JimmyKuddo,1915,150,4,12,16,25.0%,1h
45708,3,Craalb,1915,88,3,3,6,50.0%,1h
45708,3,[SCMK]Negas,1915,112,3,5,8,37.5%,38m
45708,3,HiveTyrant,1915,58,2,1,3,66.7%,1h
45708,1,Klak,1915,46,2,4,6,33.3%,1h
45708,3,Jooce,1915,60,2,7,9,22.2%,40m
45708,2,Steel,1915,30,2,8,10,20.0%,1h
45708,3,WildPants,1915,118,2,13,15,13.3%,39m
45708,3,aronTHEknoty,1915,30,1,1,2,50.0%,1h
45708,3,Sfero,1915,40,1,8,9,11.1%,48m
45708,2,Neyen,1915,48,1,9,10,10.0%,1h
45708,3,MrJinx,1915,0,0,1,1,0.0%,3h
45708,3,miguelsuprem,1915,0,0,1,1,0.0%,1h
45708,2,FILHODELOKE,1915,0,0,2,2,0.0%,1h
45708,3,MaxTuTerror,1915,0,0,5,5,0.0%,15m
45708,2,Teors,1915,0,0,6,6,0.0%,1h
45739,2,Nelo,1914,1172,169,192,361,46.8%,3h
45739,3,Revenger,1914,992,34,42,76,44.7%,5m
45739,3,BlueAngel,1914,576,21,21,42,50.0%,13m
45739,3,TonyU,1914,428,14,18,32,43.8%,31m
45739,3,ThinkBlue,1914,276,10,12,22,45.5%,27m
45739,3,Andrew,1914,289,9,10,19,47.4%,3m
45739,3,[xELiTE]GalaxyFire,1914,234,8,8,16,50.0%,3h
45739,3,BLKSHEEP,1914,215,7,2,9,77.8%,1h
45739,3,signur,1914,118,5,3,8,62.5%,26m
45739,3,Jay,1914,88,4,5,9,44.4%,18m
45739,2,TruePotato,1914,90,3,9,12,25.0%,59m
45739,2,Freemason,1914,90,3,14,17,17.6%,35m
45739,1,Cochiwarrior,1914,0,2,11,13,15.4%,1h
45739,3,NightKnight,1914,0,1,1,2,50.0%,17m
45739,2,Hailestorm,1914,0,1,6,7,14.3%,27m
45739,1,MACHAO,1914,0,1,9,10,10.0%,1h
45739,3,Jawsome,1914,0,0,1,1,0.0%,38m
45739,3,PulpPortman,1914,0,0,1,1,0.0%,21m
45739,3,JEDI,1914,0,0,1,1,0.0%,52m
45739,3,Deathbringer,1914,0,0,1,1,0.0%,1h
45739,1,Ainz,1914,0,0,6,6,0.0%,18m
45760,3,grobercg,1913,1454,64,71,135,47.4%,29m
45760,2,CNCAlchemist,1913,1340,47,59,106,44.3%,34m
45760,3,LanceyLance,1913,660,26,21,47,55.3%,13m
45760,2,andree,1913,550,22,33,55,40.0%,4m
45760,3,FckBTC,1913,360,11,22,33,33.3%,1h
45760,2,antares,1913,240,8,17,25,32.0%,51m
45760,2,Chalo,1913,199,7,10,17,41.2%,1h
45760,3,Solarta,1913,151,5,10,15,33.3%,36m
45760,2,ehehron,1913,140,5,12,17,29.4%,42m
45760,2,SGTSkywalker,1913,96,4,11,15,26.7%,3h
45760,2,Justin,1913,40,2,9,11,18.2%,40m
45760,3,[M0SCAS]NotCopyright,1913,30,1,1,2,50.0%,59m
45760,3,bludo,1913,30,1,1,2,50.0%,3h
45760,1,DCOSPN,1913,0,1,2,3,33.3%,9m
45760,2,allowedpanic,1913,46,1,9,10,10.0%,51m
45760,3,Saifaiman,1913,0,0,1,1,0.0%,3h
45760,3,LJthedon,1913,0,0,1,1,0.0%,7m
45760,3,[SANGRE]DreGGon,1913,0,0,2,2,0.0%,1h
45760,3,ShadowStorm,1913,0,0,4,4,0.0%,52m
45760,3,jagrjagr,1913,0,0,5,5,0.0%,9m
45760,3,ghostdragon,1913,0,0,6,6,0.0%,1h
45760,3,junbior,1913,0,0,6,6,0.0%,59m
45782,2,Masterchief,1912,1382,69,74,143,48.3%,3h
45782,3,DyingSun,1912,973,58,60,118,49.2%,44m
45782,3,JLAUDRAGON,1912,1211,45,53,98,45.9%,3m
45782,3,SANTIJAZA,1912,484,16,28,44,36.4%,13m
45782,3,PREDADOR,1912,422,15,19,34,44.1%,7m
45782,3,CiRiS,1912,305,11,4,15,73.3%,1h
45782,3,Fesax,1912,178,7,7,14,50.0%,24m
45782,3,FireStrork,1912,244,7,7,14,50.0%,1h
45782,3,siresombre,1912,212,6,5,11,54.5%,28m
45782,2,kat,1912,234,6,12,18,33.3%,1h
45782,3,Titan,1912,92,4,4,8,50.0%,12m
45782,2,ninjarobot,1912,139,3,5,8,37.5%,3h
45782,2,Doomsiren,1912,58,3,10,13,23.1%,1h
45782,3,DatNgga,1912,0,2,4,6,33.3%,27m
45782,3,orleivdemon,1912,0,1,0,1,100.0%,30m
45782,2,[LOHc]touchpadmous,1912,88,1,2,3,33.3%,27m
45782,2,Pokermaster,1912,0,1,6,7,14.3%,35m
45782,3,[JAUBE]Melv,1912,0,0,1,1,0.0%,48m
45782,2,Skoc,1912,0,0,2,2,0.0%,1h
45782,3,plusio,1912,0,0,2,2,0.0%,38m
45802,3,CutAndShoot,1911,1574,424,498,922,46.0%,1h
45802,2,Ghost,1911,1012,92,101,193,47.7%,3h
45802,3,destiny,1911,1004,42,35,77,54.5%,1h
45802,3,[RatsPE]Tutiburon,1911,873,30,46,76,39.5%,3h
45802,3,WraithRevolt,1911,519,17,20,37,45.9%,38m
45802,2,Demo,1911,284,9,18,27,33.3%,34m
45802,3,mathQc,1911,88,5,15,20,25.0%,1h
45802,1,AKILEZ,1911,203,5,17,22,22.7%,30m
45802,1,Terrose,1911,58,3,10,13,23.1%,1h
45802,3,Jim,1911,58,2,1,3,66.7%,1h
45802,3,Animositous,1911,30,2,3,5,40.0%,1h
45802,3,Craftdory,1911,60,2,4,6,33.3%,17m
45802,3,[paisa]JAAM,1911,0,1,1,2,50.0%,27m
45802,3,Ankialus,1911,89,1,1,2,50.0%,2h
45802,2,skyblue,1911,30,1,7,8,12.5%,3m
45802,3,HollowSpawn,1911,0,0,1,1,0.0%,1h
45818,1,JTaylor,1910,1611,166,195,361,46.0%,1h
45818,3,RELENTLESS,1910,1541,119,119,238,50.0%,3h
45818,2,kenshiro,1910,920,73,106,179,40.8%,1h
45818,2,Nofx,1910,463,15,34,49,30.6%,33m
45818,3,Boats,1910,304,9,19,28,32.1%,46m
45818,2,ijitus,1910,200,7,13,20,35.0%,22m
45818,3,Ittog,1910,0,1,2,3,33.3%,24m
45818,3,supersushi,1910,0,1,2,3,33.3%,3h
45818,1,weed,1910,0,1,8,9,11.1%,1h
45818,3,Whatshisface,1910,0,0,1,1,0.0%,27m
45818,3,[sk3tch]FrancWhyte,1910,0,0,1,1,0.0%,3h
45818,3,Drew,1910,0,0,2,2,0.0%,18m
45818,3,kretch,1910,0,0,6,6,0.0%,1h
45818,2,gineyjan,1910,0,0,7,7,0.0%,1h
45818,2,SPARKIIE,1910,0,0,7,7,0.0%,3h
45833,2,DaLizzard,1909,1571,124,148,272,45.6%,4m
45833,3,Retro,1909,1429,89,112,201,44.3%,3m
45833,2,Warlord,1909,868,58,61,119,48.7%,1h
45833,3,AsthmaAttack,1909,690,26,28,54,48.1%,46m
45833,2,Elius,1909,840,26,40,66,39.4%,3h
45833,2,Beastman,1909,568,24,37,61,39.3%,3h
45833,3,BENJAMIN,1909,544,21,25,46,45.7%,52m
45833,3,Hector,1909,321,13,5,18,72.2%,3h
45833,3,ketch,1909,230,10,14,24,41.7%,1h
45833,2,Zauberer,1909,176,6,14,20,30.0%,3h
45833,1,EvrenCAN,1909,236,6,17,23,26.1%,3h
45833,2,Destructor,1909,0,4,3,7,57.1%,50m
45833,3,[2Evil]Councillor,1909,58,2,3,5,40.0%,44m
45833,3,Rymac,1909,58,2,4,6,33.3%,38m
45833,3,RushEm,1909,0,2,5,7,28.6%,38m
45833,1,IronTalus,1909,0,1,1,2,50.0%,1h
45833,1,mistersir,1909,0,1,2,3,33.3%,1h
45833,3,Ariseph,1909,0,0,1,1,0.0%,1h
45833,3,ChovyMc,1909,0,0,5,5,0.0%,38m
45852,2,[SCGals]poormary,1908,1442,137,177,314,43.6%,3h
45852,3,Genosay,1908,1150,38,58,96,39.6%,3h
45852,2,KAPUA,1908,758,26,37,63,41.3%,3h
45852,2,ElanMyles,1908,518,17,27,44,38.6%,43m
45852,3,demoldas,1908,438,16,13,29,55.2%,3h
45852,3,chrisstianhc,1908,308,10,16,26,38.5%,3h
45852,2,firebat,1908,124,6,8,14,42.9%,3h
45852,3,[fap69]Ainsleyplix,1908,120,4,4,8,50.0%,48m
45852,2,Hero,1908,92,4,11,15,26.7%,1h
45852,3,Alex,1908,30,2,1,3,66.7%,2h
45852,3,TheChadGuy,1908,0,1,5,6,16.7%,16m
45852,1,TheKracken,1908,0,1,8,9,11.1%,3m
45852,3,GLPUERTOR,1908,0,0,1,1,0.0%,1h
45852,3,Nabas,1908,0,0,2,2,0.0%,1h
45852,3,EvolvingLife,1908,0,0,6,6,0.0%,1h
45852,2,Anthromorph,1908,0,0,7,7,0.0%,12m
45868,2,Jethreetwo,1907,1393,114,117,231,49.4%,1h
45868,2,Shobbie,1907,1555,91,102,193,47.2%,10m
45868,2,plecojoe,1907,926,37,37,74,50.0%,1h
45868,2,CERBERUS,1907,954,35,47,82,42.7%,1h
45868,3,MrDirty,1907,654,26,22,48,54.2%,1h
45868,3,articlump,1907,508,20,18,38,52.6%,48m
45868,3,BringThatBag,1907,380,13,15,28,46.4%,1h
45868,3,YungKylito,1907,168,9,8,17,52.9%,1h
45868,3,JAML,1907,182,7,9,16,43.8%,1h
45868,3,barza,1907,172,4,10,14,28.6%,56m
45868,3,Mwaitzhard,1907,58,3,0,3,100.0%,1h
45868,3,[MFNS]QuickSilverZ,1907,60,3,1,4,75.0%,1h
45868,3,Bryan,1907,83,3,5,8,37.5%,1h
45868,2,Ozyman,1907,78,2,2,4,50.0%,51m
45868,1,Higgons,1907,46,2,6,8,25.0%,1h
45868,1,slkboy,1907,48,2,10,12,16.7%,3h
45868,3,MaximumFatal,1907,0,1,0,1,100.0%,59m
45868,2,frame,1907,97,1,7,8,12.5%,28m
45868,3,Fngrs,1907,0,0,1,1,0.0%,1h
45868,3,JanginNipTip,1907,0,0,2,2,0.0%,13m
45868,2,ramaa,1907,0,0,3,3,0.0%,42m
45868,2,StAkeouT,1907,0,0,6,6,0.0%,60m
45868,2,PewPew,1907,0,0,8,8,0.0%,3h
45891,1,[C38108]JFANON,1906,1588,292,322,614,47.6%,45m
45891,3,MPHamilton,1906,1568,106,120,226,46.9%,33m
45891,3,Kruger,1906,1079,47,46,93,50.5%,3h
45891,2,Splatterbomb,1906,1050,43,48,91,47.3%,39m
45891,3,Ivor,1906,1119,40,47,87,46.0%,3h
45891,3,KAKYTUS,1906,865,28,36,64,43.8%,38m
45891,1,DevilFish,1906,696,24,41,65,36.9%,3h
45891,2,UshouldQuit,1906,587,22,22,44,50.0%,3h
45891,3,David,1906,250,10,11,21,47.6%,3h
45891,3,HOLYJR,1906,196,8,12,20,40.0%,3h
45891,1,Manumanu,1906,194,7,17,24,29.2%,18m
45891,3,alv,1906,96,4,6,10,40.0%,3h
45891,3,seba,1906,86,3,1,4,75.0%,3h
45891,3,JACKANIME,1906,30,2,1,3,66.7%,3h
45891,3,michaelcas,1906,30,2,1,3,66.7%,30m
45891,2,[nwBEAR]DARTHbane,1906,88,2,6,8,25.0%,3h
45891,3,Galletaman,1906,106,2,7,9,22.2%,1h
45891,3,Throw,1906,58,2,9,11,18.2%,12m
45891,3,ColdKóot,1906,0,1,4,5,20.0%,3h
45891,3,Jake,1906,30,1,7,8,12.5%,1h
45891,3,Iscariot,1906,0,0,1,1,0.0%,2h
45891,2,MattTheGreat,1906,0,0,1,1,0.0%,1h
45891,3,Tensuo,1906,0,0,1,1,0.0%,1h
45891,1,[4bronz]DARTHZERATUL,1906,0,0,1,1,0.0%,9m
45891,3,Bolim,1906,0,0,1,1,0.0%,41m
45891,2,qwert,1906,0,0,2,2,0.0%,28m
45891,1,hoon,1906,0,0,2,2,0.0%,19m
45918,3,[DMONlC]GrandMasterB,1905,1511,88,96,184,47.8%,1h
45918,3,nemesisberry,1905,560,75,83,158,47.5%,1h
45918,3,Kyle,1905,240,7,4,11,63.6%,2h
45918,3,Scooter,1905,175,5,8,13,38.5%,44m
45918,3,Geo,1905,199,5,15,20,25.0%,2h
45918,2,norm,1905,114,4,9,13,30.8%,24m
45918,3,moros,1905,145,3,1,4,75.0%,30m
45918,2,SamyHamy,1905,130,3,6,9,33.3%,3h
45918,2,Thrawn,1905,159,3,10,13,23.1%,58m
45918,3,suicidal,1905,58,2,4,6,33.3%,7m
45918,3,[Sathus]Sathus,1905,0,1,0,1,100.0%,40m
45918,2,[RCSM]rodiux,1905,92,1,3,4,25.0%,59m
45918,3,kcaniz,1905,0,1,4,5,20.0%,1h
45918,3,EdLions,1905,95,1,7,8,12.5%,1h
45918,3,paper,1905,0,0,1,1,0.0%,28m
45918,3,BeNiceToMe,1905,0,0,1,1,0.0%,1h
45918,3,AndreBurn,1905,0,0,5,5,0.0%,3h
45918,2,MASSTERIX,1905,0,0,6,6,0.0%,1h
45936,2,Kevin,1904,1529,199,214,413,48.2%,3m
45936,2,Biava,1904,1493,153,195,348,44.0%,43m
45936,2,jelipe,1904,1558,88,95,183,48.1%,3h
45936,3,Charlie,1904,803,69,71,140,49.3%,47m
45936,2,Angello,1904,1420,59,73,132,44.7%,4m
45936,3,SpecialK,1904,999,37,46,83,44.6%,38m
45936,3,[CCoWW]Rob,1904,679,24,35,59,40.7%,22m
45936,2,carrotbomber,1904,420,14,27,41,34.1%,24m
45936,1,nucularpaws,1904,448,13,26,39,33.3%,3h
45936,3,Dacro,1904,305,10,9,19,52.6%,38m
45936,3,MaxTheGreatI,1904,184,4,4,8,50.0%,1h
45936,3,[PBNQ]Jadame,1904,100,3,4,7,42.9%,52m
45936,3,GIBED,1904,60,2,4,6,33.3%,3h
45936,1,mrchac,1904,48,2,7,9,22.2%,17m
45936,2,JOTARO,1904,0,2,7,9,22.2%,37m
45936,3,CrossfireFox,1904,30,1,2,3,33.3%,3h
45936,3,resaxfa,1904,0,1,5,6,16.7%,49m
45936,1,oscarlobo,1904,0,1,15,16,6.2%,10m
45936,3,Eli,1904,0,0,2,2,0.0%,40m
45936,3,LargeBread,1904,0,0,3,3,0.0%,38m
45936,3,Akanak,1904,0,0,7,7,0.0%,22m
45957,2,[HT420]HolyTroll,1903,1581,248,289,537,46.2%,1h
45957,2,inspiron,1903,1509,142,168,310,45.8%,3h
45957,2,Misael,1903,1597,97,116,213,45.5%,1h
45957,3,rise,1903,1152,50,50,100,50.0%,3h
45957,2,Gaskike,1903,1292,47,61,108,43.5%,3h
45957,3,[WWP2]eYeSpY,1903,977,43,41,84,51.2%,1h
45957,3,Chulymiaw,1903,782,33,30,63,52.4%,3h
45957,2,Raphael,1903,742,27,30,57,47.4%,31m
45957,3,ACEBOOKER,1903,719,27,32,59,45.8%,28m
45957,2,hkx,1903,346,11,24,35,31.4%,1h
45957,3,[Scotty]laskaris,1903,192,6,9,15,40.0%,9m
45957,3,John,1903,166,5,6,11,45.5%,28m
45957,3,[mustaf]protosusalad,1903,195,5,13,18,27.8%,38m
45957,2,Dirtstick,1903,164,4,13,17,23.5%,59m
45957,1,Jeremiah,1903,152,3,11,14,21.4%,3h
45957,2,comprogr,1903,106,3,12,15,20.0%,4m
45957,3,[ThShMe]drumpil,1903,30,2,2,4,50.0%,26m
45957,1,Darth,1903,30,2,10,12,16.7%,1h
45957,3,Sennsation,1903,30,1,5,6,16.7%,41m
45957,3,sadpanda,1903,0,0,1,1,0.0%,1h
45957,3,[Wat3rs]cisco,1903,0,0,2,2,0.0%,13m
45957,3,EdyChumpitaz,1903,0,0,5,5,0.0%,42m
45979,2,neburxeos,1902,1453,71,79,150,47.3%,3h
45979,3,infoattack,1902,468,45,51,96,46.9%,12m
45979,2,Justin,1902,994,37,44,81,45.7%,35m
45979,3,bob,1902,923,36,36,72,50.0%,1h
45979,2,Snapple,1902,358,13,18,31,41.9%,18m
45979,3,Flyingprube,1902,312,11,17,28,39.3%,28m
45979,2,secu,1902,265,8,24,32,25.0%,1h
45979,3,xStarTrashx,1902,146,5,6,11,45.5%,3h
45979,3,joey,1902,70,4,4,8,50.0%,42m
45979,2,BigJim,1902,30,4,5,9,44.4%,1h
45979,3,Eleazarian,1902,118,4,7,11,36.4%,1h
45979,2,cholo,1902,124,4,9,13,30.8%,1h
45979,2,SpeedyCready,1902,179,4,10,14,28.6%,12m
45979,2,ReaperDragon,1902,0,1,0,1,100.0%,52m
45979,1,smedina,1902,40,1,9,10,10.0%,3h
45979,3,Lucas,1902,0,0,1,1,0.0%,1h
45979,3,GhostyLT,1902,0,0,1,1,0.0%,1h
45979,2,Smoked,1902,0,0,7,7,0.0%,28m
45979,2,aRx,1902,0,0,7,7,0.0%,3h
45998,2,Bootyhunter,1901,1548,86,89,175,49.1%,3h
45998,2,Hako,1901,1196,45,51,96,46.9%,1h
45998,2,IGN,1901,1316,43,69,112,38.4%,26m
45998,3,fazesoccerhp,1901,493,16,22,38,42.1%,9m
45998,3,BigTittyGF,1901,342,12,14,26,46.2%,1h
45998,3,patmanpv,1901,393,12,20,32,37.5%,3h
45998,3,[TORCH]Shmoog,1901,236,11,17,28,39.3%,1h
45998,3,KelaGOD,1901,286,9,12,21,42.9%,31m
45998,2,Triscuit,1901,244,6,13,19,31.6%,10m
45998,3,matchpoint,1901,164,5,4,9,55.6%,3h
45998,3,orangechevy,1901,60,3,1,4,75.0%,28m
45998,3,[GDKND]LayRuuna,1901,43,3,4,7,42.9%,3h
45998,3,ProfessorMEW,1901,30,3,5,8,37.5%,9m
45998,3,obe,1901,92,3,7,10,30.0%,1h
45998,3,JPARK,1901,0,2,0,2,100.0%,39m
45998,1,[OkT3am]dreamsCrazy,1901,143,2,11,13,15.4%,14m
45998,3,enriquealmad,1901,0,1,0,1,100.0%,28m
45998,3,MegaBoss,1901,34,1,2,3,33.3%,20m
45998,1,SneakyTurtle,1901,0,1,5,6,16.7%,3h
45998,2,Yulian,1901,0,1,8,9,11.1%,8m
45998,2,Cowboy,1901,44,1,9,10,10.0%,1h
45998,3,[ThGG]ninjamaximo,1901,0,0,1,1,0.0%,59m
45998,3,YearZero,1901,0,0,1,1,0.0%,3h
45998,2,souldnerd,1901,0,0,3,3,0.0%,12m
45998,3,RocketHaom,1901,0,0,5,5,0.0%,3h
45998,1,ALIEN,1901,0,0,5,5,0.0%,59m
45998,2,[Newti]RhinoRider,1901,0,0,7,7,0.0%,1h
46025,3,Almanu,1900,1195,72,70,142,50.7%,28m
46025,2,PJSBCR,1900,1369,55,65,120,45.8%,1h
46025,3,Acorazado,1900,534,24,27,51,47.1%,1h
46025,3,TOROOSCAR,1900,451,16,15,31,51.6%,1h
46025,3,BCaballero,1900,189,9,3,12,75.0%,9m
46025,3,[ACEoS]CheeCheChong,1900,148,5,4,9,55.6%,47m
46025,3,giant,1900,144,4,1,5,80.0%,4m
46025,2,[0BS]Willicus,1900,164,4,8,12,33.3%,24m
46025,1,[LPG2]santiago,1900,114,2,4,6,33.3%,3h
46025,2,Midas,1900,115,2,8,10,20.0%,3h
46025,3,ElAjenjo,1900,0,1,1,2,50.0%,1h
46025,2,Haloedge,1900,46,1,2,3,33.3%,1h
46025,3,Roddam,1900,0,0,1,1,0.0%,3h
46025,3,TheBeast,1900,0,0,1,1,0.0%,28m
46025,3,Emflo,1900,0,0,3,3,0.0%,47m
46040,2,Ahmed,1899,1573,76,86,162,46.9%,10m
46040,1,ForeverAlone,1899,476,54,61,115,47.0%,46m
46040,3,StrongEMC,1899,729,35,41,76,46.1%,1h
46040,3,CARLO,1899,926,34,37,71,47.9%,3h
46040,3,AbsoliuT,1899,636,25,23,48,52.1%,22m
46040,2,nungbung,1899,443,17,25,42,40.5%,3h
46040,3,KALDANIS,1899,258,9,4,13,69.2%,26m
46040,1,AtomicEarwax,1899,236,8,13,21,38.1%,3h
46040,3,Andy,1899,218,7,16,23,30.4%,1h
46040,2,unravel,1899,116,6,11,17,35.3%,3h
46040,2,RawBeef,1899,198,6,16,22,27.3%,25m
46040,3,jinx,1899,142,5,7,12,41.7%,1h
46040,3,fission,1899,42,3,5,8,37.5%,3h
46040,2,GiantMinion,1899,30,3,8,11,27.3%,3h
46040,2,YungWeezy,1899,90,3,10,13,23.1%,3h
46040,3,Marino,1899,0,1,0,1,100.0%,3h
46040,3,RoadToPlaty,1899,0,1,0,1,100.0%,1h
46040,3,KGB,1899,30,1,1,2,50.0%,3h
46040,3,Yobichismine,1899,0,1,1,2,50.0%,28m
46040,3,Patton,1899,0,1,3,4,25.0%,1h
46040,3,skizzll,1899,0,0,1,1,0.0%,1h
46040,3,CommanderPec,1899,0,0,1,1,0.0%,3h
46040,3,Harvester,1899,0,0,1,1,0.0%,1h
46040,3,buuuu,1899,0,0,1,1,0.0%,24m
46040,3,carlosfav,1899,0,0,1,1,0.0%,3h
46040,3,xDarkFaze,1899,0,0,2,2,0.0%,1h
46040,2,slade,1899,0,0,7,7,0.0%,1h
46040,3,Murdock,1899,0,0,7,7,0.0%,3h
46068,3,[TGosuD]DoughBoy,1898,1497,102,105,207,49.3%,1h
46068,3,Alaskawilder,1898,1586,92,92,184,50.0%,52m
46068,3,willdrewp,1898,818,30,35,65,46.2%,30m
46068,3,[HOT69]UmessUdead,1898,678,29,30,59,49.2%,10m
46068,1,TupaK,1898,241,20,31,51,39.2%,1h
46068,3,Ares,1898,312,12,13,25,48.0%,1h
46068,3,ItsTooHot,1898,336,11,15,26,42.3%,1h
46068,3,Boso,1898,170,6,6,12,50.0%,15m
46068,2,Pointyman,1898,156,5,12,17,29.4%,3h
46068,2,Starkloff,1898,235,5,13,18,27.8%,3h
46068,3,[mistak]stukov,1898,90,4,6,10,40.0%,26m
46068,3,Ingenebrio,1898,30,2,0,2,100.0%,1h
46068,3,Soyoufoundme,1898,0,1,0,1,100.0%,1h
46068,3,Cyberphunk,1898,0,1,4,5,20.0%,29m
46068,3,Gammawatt,1898,0,0,6,6,0.0%,22m
46083,2,Apollyon,1897,1503,56,73,129,43.4%,31m
46083,3,[HOT69]tonyrobot,1897,894,34,42,76,44.7%,3h
46083,3,Jay,1897,790,28,36,64,43.8%,39m
46083,2,Nightmare,1897,846,28,39,67,41.8%,3h
46083,2,OtherK,1897,554,19,31,50,38.0%,12m
46083,1,FrankWest,1897,308,8,17,25,32.0%,11m
46083,3,Jugger,1897,124,4,8,12,33.3%,10m
46083,1,[AbcCo]Craysit,1897,96,2,6,8,25.0%,3h
46083,3,Traun,1897,30,1,3,4,25.0%,28m
46083,3,[CHONK]ThisIsTheWay,1897,0,0,1,1,0.0%,9m
46083,3,Dangerfield,1897,0,0,5,5,0.0%,1h
46083,2,lordsparta,1897,0,0,5,5,0.0%,28m
46083,3,nakiTHC,1897,0,0,6,6,0.0%,1h
46096,3,[DADSON]DarkWarrior,1896,1258,69,86,155,44.5%,3h
46096,2,IvanHaze,1896,972,34,44,78,43.6%,3h
46096,2,jonses,1896,1000,34,51,85,40.0%,3h
46096,3,JUSTICE,1896,268,10,10,20,50.0%,1h
46096,3,VINCES,1896,230,9,9,18,50.0%,1h
46096,3,Lookatthat,1896,143,7,9,16,43.8%,1h
46096,2,darwinsegura,1896,196,7,15,22,31.8%,35m
46096,3,Maximo,1896,114,4,6,10,40.0%,40m
46096,3,amurp,1896,30,1,1,2,50.0%,1h
46096,3,Zeratul,1896,97,1,4,5,20.0%,1h
46096,3,joel,1896,0,0,2,2,0.0%,7m
46096,3,Gouda,1896,0,0,4,4,0.0%,49m
46108,3,DarkDoom,1895,1197,102,122,224,45.5%,4m
46108,3,[TRRNCH]janopunk,1895,870,32,33,65,49.2%,1h
46108,2,KALI,1895,585,22,27,49,44.9%,21m
46108,2,kinosouls,1895,546,19,28,47,40.4%,1h
46108,3,AshleyPaige,1895,414,15,13,28,53.6%,1h
46108,3,GLsoto,1895,379,13,24,37,35.1%,1h
46108,1,Boomheadshot,1895,255,10,11,21,47.6%,33m
46108,2,[ire1]HerozDontDie,1895,270,10,18,28,35.7%,50m
46108,3,Endure,1895,250,7,8,15,46.7%,1h
46108,3,PqExisto,1895,68,5,5,10,50.0%,27m
46108,3,Serpico,1895,69,4,5,9,44.4%,27m
46108,2,Ryker,1895,138,4,12,16,25.0%,1h
46108,3,Montaindew,1895,0,3,2,5,60.0%,9m
46108,2,Ady,1895,127,2,1,3,66.7%,1h
46108,2,Stargell,1895,128,2,3,5,40.0%,4m
46108,1,maallz,1895,40,2,6,8,25.0%,9m
46108,3,Zethar,1895,60,2,8,10,20.0%,36m
46108,3,ryyan,1895,0,1,4,5,20.0%,16m
46108,3,[SACTrE]Ckst,1895,30,1,4,5,20.0%,27m
46108,2,SabreTman,1895,0,1,5,6,16.7%,42m
46108,3,titanyu,1895,0,1,5,6,16.7%,3h
46108,3,HitchAlfred,1895,30,1,6,7,14.3%,13m
46108,2,Nightstalker,1895,0,0,2,2,0.0%,4m
46108,3,Taiki,1895,0,0,2,2,0.0%,3h
46108,3,fabi,1895,0,0,3,3,0.0%,38m
46108,2,miguel,1895,0,0,3,3,0.0%,42m
46108,2,VoxVulpes,1895,0,0,5,5,0.0%,1h
46108,2,JDub,1895,0,0,7,7,0.0%,4m
46136,2,FERNANDEZ,1894,846,28,41,69,40.6%,1h
46136,2,HeavyArmodz,1894,418,19,28,47,40.4%,58m
46136,2,[JAHA]Paablo,1894,384,12,21,33,36.4%,1h
46136,2,Morleond,1894,184,4,9,13,30.8%,12m
46136,3,Alan,1894,58,3,3,6,50.0%,1h
46136,3,[FTFC]NoGimmicks,1894,60,2,4,6,33.3%,47m
46136,1,Taylord,1894,93,1,2,3,33.3%,24m
46136,2,Bydro,1894,40,1,3,4,25.0%,4m
46136,3,ImmaFlexHo,1894,0,1,5,6,16.7%,1h
46136,2,[GUNRUN]DocterChez,1894,30,1,5,6,16.7%,1h
46136,3,tom,1894,0,0,1,1,0.0%,1h
46136,3,Andrew,1894,0,0,2,2,0.0%,1h
46148,3,Lamos,1893,762,37,46,83,44.6%,1h
46148,2,Dawnstopper,1893,1034,36,45,81,44.4%,60m
46148,3,cojiatuvieja,1893,757,28,30,58,48.3%,3h
46148,3,Reshokista,1893,478,21,28,49,42.9%,47m
46148,3,Thunderfunk,1893,398,13,25,38,34.2%,28m
46148,3,MajorPayne,1893,196,7,9,16,43.8%,41m
46148,1,Obito,1893,248,7,12,19,36.8%,33m
46148,3,armandochesh,1893,180,6,12,18,33.3%,38m
46148,3,Morloc,1893,124,6,22,28,21.4%,45m
46148,3,mrlolipop,1893,30,5,4,9,55.6%,56m
46148,1,Spacer,1893,188,4,16,20,20.0%,44m
46148,3,Novato,1893,48,3,0,3,100.0%,1h
46148,3,[N0one]Chemix,1893,30,1,2,3,33.3%,1h
46148,3,Borregong,1893,42,1,6,7,14.3%,1h
46148,3,SilverHawk,1893,0,0,1,1,0.0%,1h
46148,3,Dreamer,1893,0,0,1,1,0.0%,28m
46148,3,PaulAtreides,1893,0,0,2,2,0.0%,3h
46148,3,olipaz,1893,0,0,6,6,0.0%,1h
46166,2,Pato,1892,1283,92,102,194,47.4%,3h
46166,3,mushroom,1892,1444,60,59,119,50.4%,39m
46166,2,JÁJÁ,1892,1238,50,63,113,44.2%,1h
46166,3,vlast,1892,468,16,22,38,42.1%,25m
46166,3,CREE,1892,346,12,15,27,44.4%,1h
46166,2,HelloSheeple,1892,272,10,18,28,35.7%,43m
46166,2,Blackheart,1892,264,8,14,22,36.4%,1h
46166,3,KrisOverdriv,1892,194,6,2,8,75.0%,1h
46166,3,shinigami,1892,222,6,11,17,35.3%,22m
46166,1,Gustavo,1892,144,5,14,19,26.3%,50m
46166,3,Steve,1892,86,4,2,6,66.7%,3h
46166,2,ditxw,1892,88,3,5,8,37.5%,14m
46166,2,Liberator,1892,60,3,10,13,23.1%,18m
46166,3,JEXTAR,1892,34,2,1,3,66.7%,1h
46166,3,BorrySmell,1892,34,2,2,4,50.0%,1h
46166,1,zergswarm,1892,36,2,9,11,18.2%,1h
46166,3,WoodLeague,1892,30,1,1,2,50.0%,1h
46166,3,[ALTF04]SAMISHERMES,1892,0,1,1,2,50.0%,1h
46166,3,SunzofMan,1892,0,0,1,1,0.0%,22m
46166,3,Stephanus,1892,0,0,1,1,0.0%,3h
46166,3,XXDreykoXX,1892,0,0,2,2,0.0%,5m
46166,3,Melvik,1892,0,0,6,6,0.0%,37m
46166,2,Tbione,1892,0,0,7,7,0.0%,3h
46189,3,Ipelaez,1891,1470,100,112,212,47.2%,1h
46189,3,HasluKa,1891,1478,57,62,119,47.9%,18m
46189,3,webito,1891,747,38,57,95,40.0%,30m
46189,1,lilsturd,1891,859,30,51,81,37.0%,1h
46189,3,[uchi]RushThanos,1891,649,21,39,60,35.0%,27m
46189,2,[ERFT]Sargento,1891,520,17,31,48,35.4%,25m
46189,3,TlonUqbar,1891,168,15,16,31,48.4%,27m
46189,2,[Kerak]CHOFIYEAAAH,1891,464,14,25,39,35.9%,3h
46189,3,Dabcentric,1891,110,5,17,22,22.7%,1h
46189,2,WaTcHdOg,1891,30,3,7,10,30.0%,1h
46189,3,Hobofet,1891,0,2,3,5,40.0%,1h
46189,2,rytontym,1891,0,2,5,7,28.6%,21m
46189,3,EnrageJoze,1891,49,2,5,7,28.6%,48m
46189,3,Winter,1891,0,1,0,1,100.0%,1h
46189,3,GFluffy,1891,0,1,0,1,100.0%,30m
46189,3,ramveji,1891,0,1,1,2,50.0%,12m
46189,3,Jet,1891,30,1,2,3,33.3%,40m
46189,3,[XOA]Mooting,1891,30,1,3,4,25.0%,33m
46189,2,Invasion,1891,0,0,1,1,0.0%,1h
46189,2,FULGORE,1891,0,0,3,3,0.0%,51m
46189,2,mac,1891,0,0,4,4,0.0%,28m
46210,2,Speco,1890,1579,95,90,185,51.4%,1h
46210,3,BKFitz,1890,1446,51,67,118,43.2%,6m
46210,2,NiceMeme,1890,520,21,28,49,42.9%,1h
46210,3,[KhanTv]False,1890,222,10,12,22,45.5%,44m
46210,3,Drako,1890,120,5,5,10,50.0%,48m
46210,3,berlys,1890,120,5,6,11,45.5%,3h
46210,3,FrankDiesel,1890,58,3,2,5,60.0%,44m
46210,1,Tiago,1890,82,3,11,14,21.4%,1h
46210,3,MeisterCanon,1890,30,2,1,3,66.7%,1h
46210,3,llllllllllll,1890,121,2,5,7,28.6%,30m
46210,3,Mrlurker,1890,32,1,1,2,50.0%,42m
46210,3,leonidas,1890,0,1,1,2,50.0%,1h
46210,3,Bentangel,1890,30,1,2,3,33.3%,36m
46210,2,TOM,1890,0,0,7,7,0.0%,1h
46224,1,[BlTEL]Gap,1889,1596,221,249,470,47.0%,1h
46224,3,TAIWANBEST,1889,1498,153,196,349,43.8%,44m
46224,2,MIB,1889,966,56,57,113,49.6%,1h
46224,3,[DOSC2]CreepyJon,1889,380,53,47,100,53.0%,1h
46224,3,AAtinting,1889,775,30,25,55,54.5%,38m
46224,3,BRANDALF,1889,729,28,34,62,45.2%,3h
46224,3,COLT,1889,668,24,24,48,50.0%,3h
46224,3,[A1312]entropia,1889,440,15,15,30,50.0%,3h
46224,3,DiAbLoS,1889,427,15,25,40,37.5%,3h
46224,3,LEO,1889,350,14,17,31,45.2%,3h
46224,3,[QMS]DougieBlitzn,1889,240,9,8,17,52.9%,1h
46224,3,[JJB]jgb,1889,290,9,15,24,37.5%,52m
46224,2,Salsa,1889,188,6,18,24,25.0%,24m
46224,3,Briser,1889,157,4,9,13,30.8%,2h
46224,3,AesopJohnson,1889,138,3,5,8,37.5%,2h
46224,3,alengar,1889,30,2,2,4,50.0%,29m
46224,3,Rukawa,1889,58,2,9,11,18.2%,38m
46224,3,[BO0MER]EricTheRippr,1889,0,1,1,2,50.0%,38m
46224,3,SpaceJace,1889,42,1,3,4,25.0%,29m
46224,3,Cruss,1889,30,1,5,6,16.7%,14m
46224,1,Marranzo,1889,44,1,10,11,9.1%,3h
46224,3,holaggg,1889,0,0,4,4,0.0%,49m
46224,3,MaxZeon,1889,0,0,5,5,0.0%,29m
46224,2,[wlkt]Danielord,1889,0,0,7,7,0.0%,3h
46224,2,Foundry,1889,0,0,7,7,0.0%,14m
46249,1,prplpaisley,1888,1589,272,302,574,47.4%,3h
46249,2,clowreed,1888,1186,122,177,299,40.8%,3h
46249,2,Stabathor,1888,671,37,41,78,47.4%,1h
46249,3,IMDARLETEREN,1888,371,14,16,30,46.7%,32m
46249,3,TheRealest,1888,229,11,12,23,47.8%,1h
46249,3,Anthony,1888,174,6,7,13,46.2%,12m
46249,3,Kattsumoto,1888,126,6,9,15,40.0%,29m
46249,1,Balcefon,1888,142,5,7,12,41.7%,1h
46249,2,iTsJuStAfLu,1888,162,5,14,19,26.3%,1h
46249,3,ESTEAMED,1888,30,1,1,2,50.0%,59m
46249,3,KurtNasty,1888,42,1,3,4,25.0%,49m
46249,2,MidniteYeti,1888,0,0,1,1,0.0%,1h
46249,2,Wolfmastermx,1888,0,0,2,2,0.0%,28m
46249,2,dave,1888,0,0,5,5,0.0%,1h
46249,2,Titan,1888,0,0,7,7,0.0%,12m
46264,2,[Z1a]ZiaMonk,1887,1415,331,357,688,48.1%,3h
46264,2,WolfBoyAK,1887,1116,38,48,86,44.2%,1h
46264,3,NATURALKILL,1887,733,34,43,77,44.2%,1h
46264,3,LOONEY,1887,858,30,39,69,43.5%,1h
46264,3,CTO,1887,514,18,25,43,41.9%,29m
46264,3,Jane,1887,321,17,23,40,42.5%,28m
46264,3,Destruction,1887,382,14,17,31,45.2%,1h
46264,3,SNOWMEN,1887,262,9,14,23,39.1%,28m
46264,3,GansikAbu,1887,240,8,20,28,28.6%,29m
46264,3,marc,1887,194,6,3,9,66.7%,1h
46264,2,[DisQd]DARPAChieff,1887,126,5,16,21,23.8%,25m
46264,2,[DTML]Grumblestich,1887,0,4,4,8,50.0%,12m
46264,3,Solja,1887,0,1,4,5,20.0%,1h
46264,3,SPLiT,1887,30,1,6,7,14.3%,1h
46264,3,Moshé,1887,0,0,3,3,0.0%,20m
46279,3,Sweatshop,1886,835,52,69,121,43.0%,27m
46279,2,Incision,1886,531,45,45,90,50.0%,1h
46279,3,roo,1886,1268,43,58,101,42.6%,29m
46279,3,Paul,1886,545,26,28,54,48.1%,1h
46279,3,MIKE,1886,510,19,20,39,48.7%,1h
46279,2,BUSUSMC,1886,380,11,20,31,35.5%,39m
46279,2,Cornbread,1886,294,10,20,30,33.3%,33m
46279,3,Bando,1886,242,8,5,13,61.5%,1h
46279,1,[PLUNG]blaine,1886,180,7,17,24,29.2%,49m
46279,1,[BRobli]Tdestroyer,1886,234,6,15,21,28.6%,2m
46279,3,sixllinks,1886,60,3,2,5,60.0%,42m
46279,2,Roger,1886,30,3,6,9,33.3%,3h
46279,1,MaJaGoose,1886,48,2,4,6,33.3%,1h
46279,2,BadHarold,1886,60,2,10,12,16.7%,1h
46279,3,cabocrespo,1886,0,1,0,1,100.0%,29m
46279,2,AlexLock,1886,0,1,1,2,50.0%,1h
46279,2,dukesyukes,1886,0,1,1,2,50.0%,1h
46279,3,crocker,1886,0,1,5,6,16.7%,22m
46279,3,[VFam2]SneakyPanda,1886,0,0,1,1,0.0%,48m
46279,3,Thunderpain,1886,0,0,1,1,0.0%,42m
46279,3,[zedu]zig,1886,0,0,5,5,0.0%,1h
46279,3,Geoline,1886,0,0,6,6,0.0%,37m
46301,2,WaLdO,1885,1305,194,188,382,50.8%,2m
46301,2,Pilgrim,1885,1439,109,142,251,43.4%,36m
46301,3,betopsico,1885,1585,78,95,173,45.1%,3h
46301,3,MamaChowChow,1885,862,53,65,118,44.9%,42m
46301,3,OsusTino,1885,1154,41,48,89,46.1%,1h
46301,2,Munrai,1885,832,30,40,70,42.9%,1h
46301,3,[EPCK]joaquinad,1885,537,27,31,58,46.6%,56m
46301,2,xelnaga,1885,262,15,17,32,46.9%,1h
46301,3,MyDrunkAcct,1885,264,8,3,11,72.7%,3h
46301,3,Zerallamvuut,1885,228,7,9,16,43.8%,12m
46301,3,Lucca,1885,258,7,10,17,41.2%,1h
46301,3,Danny,1885,180,6,11,17,35.3%,22m
46301,3,KingKringlet,1885,183,6,18,24,25.0%,1h
46301,3,rasdel,1885,169,4,3,7,57.1%,29m
46301,3,Jackson,1885,42,3,4,7,42.9%,1h
46301,3,[ValpoK]venenotres,1885,96,2,5,7,28.6%,2h
46301,2,Mordred,1885,90,2,6,8,25.0%,1h
46301,3,starfenix,1885,0,1,0,1,100.0%,40m
46301,3,mau,1885,40,1,2,3,33.3%,2h
46301,1,[464]erick,1885,0,1,9,10,10.0%,44m
46301,1,Eaglenest,1885,0,1,10,11,9.1%,2m
46301,3,[0FAKE]Siury,1885,0,0,1,1,0.0%,3h
46301,3,John,1885,0,0,1,1,0.0%,38m
46324,2,Joshua,1884,888,195,211,406,48.0%,1h
46324,2,Gards,1884,1541,142,152,294,48.3%,35m
46324,2,maxrick,1884,1577,85,82,167,50.9%,1h
46324,3,[WOTG]XAXADUN,1884,934,34,41,75,45.3%,1h
46324,3,Beerlighter,1884,744,27,30,57,47.4%,3h
46324,3,jindacool,1884,333,12,8,20,60.0%,1h
46324,3,nabdos,1884,200,7,8,15,46.7%,26m
46324,2,Cjk,1884,167,4,11,15,26.7%,18m
46324,3,[RSHB]Sammypty,1884,90,3,9,12,25.0%,25m
46324,2,KiritoKun,1884,0,2,6,8,25.0%,12m
46324,2,Rozay,1884,92,2,10,12,16.7%,4m
46324,2,DeepStrut,1884,48,2,10,12,16.7%,1h
46324,3,Shenster,1884,0,1,1,2,50.0%,1h
46324,2,LILSPARKLEZ,1884,0,1,1,2,50.0%,1h
46324,3,Numnum,1884,0,1,5,6,16.7%,38m
46324,3,aTcHoI,1884,0,0,1,1,0.0%,1h
46324,3,alex,1884,0,0,1,1,0.0%,2h
46324,1,Serapion,1884,0,0,2,2,0.0%,1h
46324,3,Neodragon,1884,0,0,5,5,0.0%,32m
46324,3,Gusttavoo,1884,0,0,5,5,0.0%,39m
46344,2,Highlander,1883,1570,159,175,334,47.6%,1h
46344,3,jerry,1883,1597,98,88,186,52.7%,25m
46344,2,GeeBee,1883,1504,76,96,172,44.2%,32m
46344,3,Capitao,1883,1290,54,61,115,47.0%,25m
46344,3,[MaxWin]FrozenG,1883,1228,51,51,102,50.0%,39m
46344,3,Finith,1883,848,33,35,68,48.5%,38m
46344,3,Arthur,1883,585,24,18,42,57.1%,15m
46344,3,Dabby,1883,712,24,33,57,42.1%,38m
46344,2,[KGH3]GHOST,1883,472,17,27,44,38.6%,3h
46344,3,Akari,1883,288,10,10,20,50.0%,56m
46344,3,Washburn,1883,302,9,10,19,47.4%,3h
46344,1,[MUTX]Darius,1883,183,5,14,19,26.3%,47m
46344,3,CPT,1883,116,4,5,9,44.4%,3h
46344,2,razaunika,1883,120,4,7,11,36.4%,1h
46344,3,ClutchRumble,1883,30,2,3,5,40.0%,30m
46344,1,EngElDan,1883,96,2,12,14,14.3%,43m
46344,3,RUGAL,1883,30,1,3,4,25.0%,10m
46344,3,Braian,1883,0,0,2,2,0.0%,48m
46344,3,memo,1883,0,0,4,4,0.0%,29m
46363,2,Stealthpaw,1882,1521,131,152,283,46.3%,51m
46363,3,Fishbolman,1882,1369,70,99,169,41.4%,3h
46363,3,ZoConn,1882,922,33,37,70,47.1%,48m
46363,3,GreenPTY,1882,580,21,21,42,50.0%,18m
46363,3,[COCG]KrazyLegz,1882,320,17,14,31,54.8%,1h
46363,3,BladeKnight,1882,353,14,17,31,45.2%,29m
46363,2,Korrhil,1882,340,14,19,33,42.4%,3h
46363,3,Ranuo,1882,262,10,18,28,35.7%,1h
46363,3,Vlad,1882,116,4,5,9,44.4%,52m
46363,1,viceps,1882,0,1,2,3,33.3%,1h
46363,2,MorceGuuu,1882,94,1,4,5,20.0%,33m
46363,3,Kalamedea,1882,30,1,4,5,20.0%,36m
46363,2,Narzako,1882,0,1,9,10,10.0%,1h
46363,3,raft,1882,0,0,2,2,0.0%,1h
46363,3,benja,1882,0,0,5,5,0.0%,44m
46363,3,IHaveThree,1882,0,0,6,6,0.0%,42m
46363,3,Zanendithas,1882,0,0,6,6,0.0%,1h
46380,3,[RAR3]Nshaffer,1881,555,21,15,36,58.3%,28m
46380,3,Banana,1881,370,13,21,34,38.2%,25m
46380,2,[RATxX]SackOfWetRat,1881,145,6,7,13,46.2%,22m
46380,3,neocvl,1881,158,6,8,14,42.9%,14m
46380,3,[Pirobo]JuanchoKill,1881,130,4,8,12,33.3%,1h
46380,3,adam,1881,60,2,3,5,40.0%,1h
46380,1,tomax,1881,96,2,10,12,16.7%,1h
46380,3,[AlamoC]Major,1881,0,1,0,1,100.0%,1h
46380,3,[TPN3X]LUKZ,1881,0,1,0,1,100.0%,3h
46380,3,Sizqo,1881,30,1,1,2,50.0%,3h
46380,3,Stoicistem,1881,30,1,2,3,33.3%,3h
46380,3,Dax,1881,0,0,1,1,0.0%,32m
46392,3,[gente]Magicachesse,1880,1438,96,110,206,46.6%,47m
46392,2,pbev,1880,1592,95,112,207,45.9%,3h
46392,2,edwalph,1880,1380,76,88,164,46.3%,1h
46392,2,Itachi,1880,1392,50,63,113,44.2%,1h
46392,2,CaptAmerica,1880,832,32,42,74,43.2%,22m
46392,2,carternetty,1880,428,16,27,43,37.2%,3h
46392,2,tomrojo,1880,221,8,10,18,44.4%,8m
46392,3,bio,1880,166,7,5,12,58.3%,39m
46392,1,MMMMMHOTDOGS,1880,152,5,3,8,62.5%,1h
46392,2,dave,1880,92,3,0,3,100.0%,1h
46392,3,Swarley,1880,120,2,6,8,25.0%,52m
46392,3,BonHaus,1880,0,1,0,1,100.0%,1h
46392,3,[Dindon]Deamonz,1880,0,1,1,2,50.0%,28m
46392,3,[uepa]Tadeo,1880,0,1,2,3,33.3%,1h
46392,3,EmmayVe,1880,30,1,2,3,33.3%,31m
46392,3,Colby,1880,30,1,4,5,20.0%,3h
46392,2,gReAsYbaLlS,1880,30,1,9,10,10.0%,18m
46392,1,[Random]Taz,1880,34,1,13,14,7.1%,3h
46392,3,DaChee,1880,0,0,3,3,0.0%,1h
46392,3,Rckplay,1880,0,0,3,3,0.0%,3h
46392,2,DestroyerTwo,1880,0,0,6,6,0.0%,28m
46413,3,Bertch,1879,679,36,33,69,52.2%,48m
46413,2,SoSaltySoFU,1879,774,26,36,62,41.9%,35m
46413,3,Jester,1879,328,22,25,47,46.8%,25m
46413,3,[syrup]DarkSkon,1879,326,12,15,27,44.4%,1h
46413,3,DrBowman,1879,310,10,27,37,27.0%,5m
46413,2,RML,1879,181,6,14,20,30.0%,17m
46413,3,Hoosierboi,1879,187,5,4,9,55.6%,9m
46413,3,Aeolus,1879,156,5,14,19,26.3%,54m
46413,1,Yorch,1879,158,5,14,19,26.3%,3h
46413,3,Arjuna,1879,70,3,5,8,37.5%,28m
46413,2,Marc,1879,132,3,8,11,27.3%,42m
46413,3,XIII,1879,0,2,3,5,40.0%,36m
46413,3,Steelhead,1879,0,2,3,5,40.0%,29m
46413,3,Miravete,1879,30,2,5,7,28.6%,4m
46413,3,WarPig,1879,30,1,3,4,25.0%,3h
46413,2,ConkerMaximo,1879,36,1,9,10,10.0%,1h
46413,3,[Pirobo]JaxMetal,1879,0,0,1,1,0.0%,40m
46413,3,Jiye,1879,0,0,4,4,0.0%,26m
46413,3,HotMikeNFS,1879,0,0,6,6,0.0%,3h
46432,2,roscoe,1878,1469,66,76,142,46.5%,32m
46432,1,MAS,1878,1538,63,81,144,43.8%,26m
46432,3,Juice,1878,397,17,17,34,50.0%,1h
46432,1,[ZTemps]MystixW,1878,299,8,17,25,32.0%,9m
46432,3,justice,1878,118,6,3,9,66.7%,25m
46432,3,Mateus,1878,122,4,10,14,28.6%,3h
46432,1,[BrUtO]INGFILI,1878,137,3,6,9,33.3%,3h
46432,3,Gelo,1878,42,2,3,5,40.0%,48m
46432,1,[P0OPY]Fire,1878,90,2,9,11,18.2%,3h
46432,1,PapaMidnight,1878,0,0,7,7,0.0%,3h
46432,3,Whiskeycook,1878,0,0,7,7,0.0%,16m
46443,3,Alex,1877,1276,72,87,159,45.3%,53m
46443,2,Kunga,1877,481,71,86,157,45.2%,3h
46443,2,[RAR3]Jaccob,1877,976,48,35,83,57.8%,3h
46443,3,robomega,1877,550,19,22,41,46.3%,10m
46443,3,dyslexia,1877,403,14,22,36,38.9%,3h
46443,3,Nerva,1877,316,11,20,31,35.5%,1h
46443,3,[EnTrpY]Unfrozen,1877,308,10,15,25,40.0%,1h
46443,3,Remliklav,1877,204,9,10,19,47.4%,38m
46443,3,[GALL0S]Morrik,1877,216,6,5,11,54.5%,4m
46443,3,starlord,1877,72,5,4,9,55.6%,1h
46443,2,GlueSniffer,1877,102,4,16,20,20.0%,43m
46443,3,AbdulHakeem,1877,62,3,1,4,75.0%,28m
46443,3,Alvisimo,1877,143,3,2,5,60.0%,31m
46443,3,SEBäSyug,1877,38,1,7,8,12.5%,1h
46443,3,KillingZouav,1877,0,0,1,1,0.0%,18m
46443,3,Krasto,1877,0,0,1,1,0.0%,52m
46443,2,DubiousMD,1877,0,0,2,2,0.0%,28m
46443,3,Shirtbuffalo,1877,0,0,5,5,0.0%,1h
46443,2,Mcvander,1877,0,0,7,7,0.0%,21m
46443,2,Striker,1877,0,0,8,8,0.0%,1h
46463,2,Malick,1876,1050,83,104,187,44.4%,3h
46463,3,roschwifty,1876,312,10,15,25,40.0%,39m
46463,3,KSIClaytion,1876,287,9,11,20,45.0%,3h
46463,3,[kGreen]Nate,1876,189,5,1,6,83.3%,1h
46463,3,xPROxDivax,1876,116,5,5,10,50.0%,29m
46463,3,Chancellorj,1876,46,4,5,9,44.4%,53m
46463,3,bigman,1876,0,1,1,2,50.0%,3h
46463,3,XavyTheBest,1876,0,1,5,6,16.7%,1h
46463,2,GOLIATH,1876,0,1,9,10,10.0%,1h
46463,3,Darklight,1876,0,0,1,1,0.0%,27m
46463,3,[FROMOZ]SuperNinja,1876,0,0,1,1,0.0%,53m
46463,3,CesarblizzSt,1876,0,0,1,1,0.0%,3h
46463,3,[TFDS]PERCEPTION,1876,0,0,2,2,0.0%,18m
46463,3,Randy,1876,0,0,6,6,0.0%,3h
46463,2,Edward,1876,0,0,7,7,0.0%,4m
46463,2,drJetSki,1876,0,0,7,7,0.0%,1h
46463,2,Jefferson,1876,0,0,8,8,0.0%,1h
46480,3,MrMeow,1875,1419,119,132,251,47.4%,28m
46480,2,idiadoodman,1875,1397,114,173,287,39.7%,1h
46480,3,Danny,1875,1402,53,57,110,48.2%,29m
46480,3,murphdog,1875,747,33,27,60,55.0%,15m
46480,3,adjuracion,1875,855,32,41,73,43.8%,22m
46480,3,Angel,1875,670,30,24,54,55.6%,1h
46480,3,DrItaliano,1875,862,30,37,67,44.8%,3h
46480,3,JOSTAR,1875,512,22,27,49,44.9%,3h
46480,3,nagual,1875,512,20,25,45,44.4%,39m
46480,3,Ito,1875,338,12,17,29,41.4%,4m
46480,3,willjog,1875,236,7,15,22,31.8%,4m
46480,2,RedBird,1875,284,6,8,14,42.9%,42m
46480,3,Suneater,1875,217,6,12,18,33.3%,32m
46480,1,MARIO,1875,167,5,3,8,62.5%,1h
46480,3,flaco,1875,30,1,3,4,25.0%,1h
46480,2,dunkine,1875,46,1,8,9,11.1%,14m
46480,1,Douda,1875,0,1,9,10,10.0%,3h
46480,3,CommanderWes,1875,0,0,1,1,0.0%,27m
46480,3,RayneFoxie,1875,0,0,1,1,0.0%,49m
46480,3,GreenBasterd,1875,0,0,2,2,0.0%,29m
46480,3,Fluorescent,1875,0,0,4,4,0.0%,47m
46480,3,FrnK,1875,0,0,5,5,0.0%,27m
46480,3,redsan,1875,0,0,6,6,0.0%,5m
46480,2,DuckButt,1875,0,0,7,7,0.0%,1h
46480,2,Apollo,1875,0,0,7,7,0.0%,10m
46505,3,Navajas,1874,906,34,39,73,46.6%,1h
46505,3,THEOBSIDIAN,1874,615,22,34,56,39.3%,1h
46505,3,YEIYEI,1874,548,21,25,46,45.7%,53m
46505,3,Henrique,1874,283,8,7,15,53.3%,14m
46505,3,xayizu,1874,230,8,9,17,47.1%,1h
46505,1,BerSerKeR,1874,313,8,17,25,32.0%,39m
46505,2,gusta,1874,214,7,14,21,33.3%,32m
46505,3,Feenix,1874,114,4,2,6,66.7%,4m
46505,3,BirbyBoi,1874,121,4,4,8,50.0%,26m
46505,2,FoNCHo,1874,139,3,9,12,25.0%,1h
46505,3,Lukax,1874,96,2,0,2,100.0%,29m
46505,2,Kastle,1874,94,2,11,13,15.4%,9m
46505,1,shomepain,1874,48,2,12,14,14.3%,3h
46505,1,bladeecity,1874,0,1,0,1,100.0%,35m
46505,2,PNKmarine,1874,88,1,1,2,50.0%,3h
46505,3,SeñorMuerte,1874,30,1,2,3,33.3%,1h
46505,3,stonepwn,1874,0,1,12,13,7.7%,1h
46505,3,mApleStriKe,1874,0,0,1,1,0.0%,1h
46505,3,BeeGee,1874,0,0,1,1,0.0%,28m
46505,3,kanec,1874,0,0,1,1,0.0%,59m
46525,2,xacalus,1873,1413,80,95,175,45.7%,17m
46525,3,brechawarr,1873,697,25,21,46,54.3%,1h
46525,2,QUICKSILVER,1873,728,23,37,60,38.3%,25m
46525,2,KAOS,1873,656,22,30,52,42.3%,1h
46525,3,Supine,1873,400,15,13,28,53.6%,42m
46525,2,TuNa,1873,332,10,15,25,40.0%,3h
46525,3,Stunning,1873,236,8,14,22,36.4%,23m
46525,1,Arlock,1873,178,6,17,23,26.1%,17m
46525,3,Cangrejo,1873,128,5,10,15,33.3%,3h
46525,1,Dwer,1873,181,4,7,11,36.4%,3h
46525,3,Quidshid,1873,62,2,5,7,28.6%,1h
46525,2,MADEULOOKMUL,1873,129,2,8,10,20.0%,3h
46525,2,[Klz]Panxo,1873,109,2,8,10,20.0%,21m
46525,1,Kurakding,1873,0,1,9,10,10.0%,2m
46525,1,CaveiraGlory,1873,36,1,20,21,4.8%,1h
46525,3,Bolgie,1873,0,0,1,1,0.0%,27m
46525,2,StumblnHome,1873,0,0,8,8,0.0%,3h
46542,2,SpongyFishin,1872,1506,135,195,330,40.9%,1h
46542,3,Ford,1872,962,36,43,79,45.6%,1h
46542,2,Quazleplemp,1872,596,22,35,57,38.6%,43m
46542,3,Gizmo,1872,332,13,16,29,44.8%,10m
46542,1,MajinBooYang,1872,170,6,15,21,28.6%,1h
46542,2,Ink,1872,137,2,3,5,40.0%,1h
46542,2,PilotBoy,1872,42,2,8,10,20.0%,12m
46542,3,juggernaut,1872,0,1,0,1,100.0%,3h
46542,3,[CaC4s]alejandro,1872,0,0,1,1,0.0%,14m
46542,3,Smokedpancak,1872,0,0,1,1,0.0%,3h
46542,3,Tassadar,1872,0,0,1,1,0.0%,1h
46542,3,Pierox,1872,0,0,6,6,0.0%,1h
46554,2,Tiammat,1871,787,65,85,150,43.3%,59m
46554,3,Darkmarine,1871,1242,47,60,107,43.9%,1h
46554,2,Ren,1871,1012,42,43,85,49.4%,17m
46554,2,KilledByMe,1871,1130,41,51,92,44.6%,1h
46554,3,TurdFerguson,1871,988,37,48,85,43.5%,39m
46554,3,Giancanna,1871,650,32,31,63,50.8%,1h
46554,3,ElFossa,1871,845,29,47,76,38.2%,33m
46554,2,LynoX,1871,709,27,32,59,45.8%,3h
46554,3,Alamo,1871,434,15,18,33,45.5%,40m
46554,2,DrFlahooty,1871,200,8,14,22,36.4%,1h
46554,3,LetrasLibres,1871,120,5,10,15,33.3%,1h
46554,3,Forsaken,1871,62,3,4,7,42.9%,29m
46554,3,LOTAR,1871,62,2,9,11,18.2%,1h
46554,3,Aname,1871,72,2,9,11,18.2%,3h
46554,3,ThunderWolf,1871,0,0,2,2,0.0%,1h
46554,3,xXDXx,1871,0,0,3,3,0.0%,47m
46554,2,TenEspinosa,1871,0,0,7,7,0.0%,1h
46571,2,OWMY,1870,1288,73,88,161,45.3%,1h
46571,3,[SWOU]Rookspwnshop,1870,487,16,19,35,45.7%,33m
46571,2,Everday,1870,530,16,22,38,42.1%,1h
46571,3,miguel,1870,198,7,12,19,36.8%,1h
46571,3,TheFenix,1870,162,4,5,9,44.4%,1h
46571,3,[Lukss]Manolo,1870,160,4,5,9,44.4%,3h
46571,2,RDK,1870,136,4,11,15,26.7%,1h
46571,2,alexjklimb,1870,118,3,10,13,23.1%,3h
46571,3,bigvibein,1870,30,2,2,4,50.0%,26m
46571,3,kingodtop,1870,0,2,4,6,33.3%,25m
46571,3,AlexBlikerd,1870,60,2,6,8,25.0%,3h
46571,3,Mudma,1870,96,1,3,4,25.0%,29m
46571,3,Learning,1870,0,0,1,1,0.0%,3h
46571,3,RHINOCEROS,1870,0,0,2,2,0.0%,1h
46571,3,bardak,1870,0,0,3,3,0.0%,29m
46586,3,ShotCaller,1869,970,61,58,119,51.3%,56m
46586,2,Jex,1869,1003,41,48,89,46.1%,1h
46586,3,BoRomihR,1869,911,40,43,83,48.2%,1h
46586,2,leito,1869,722,39,41,80,48.8%,25m
46586,3,[z2o]Vissionking,1869,792,36,36,72,50.0%,14m
46586,2,AngelOfShred,1869,980,35,44,79,44.3%,3m
46586,2,Ricardoah,1869,822,35,47,82,42.7%,1h
46586,2,Kindamoist,1869,576,19,27,46,41.3%,3h
46586,3,Zerofsgiven,1869,536,19,29,48,39.6%,1h
46586,3,Vinchenzo,1869,490,16,16,32,50.0%,1h
46586,3,[LongD]letto,1869,328,11,18,29,37.9%,18m
46586,2,Punisher,1869,350,11,22,33,33.3%,3h
46586,2,Platano,1869,307,10,19,29,34.5%,36m
46586,3,Stinglex,1869,168,5,10,15,33.3%,47m
46586,3,Alexander,1869,58,4,6,10,40.0%,1h
46586,2,[TGosuD]Fullmetal,1869,144,3,10,13,23.1%,3h
46586,3,[pillan]Punkstar,1869,58,2,2,4,50.0%,1h
46586,3,turdhurdler,1869,0,2,3,5,40.0%,29m
46586,3,doeser,1869,0,1,0,1,100.0%,1h
46586,2,onehitz,1869,30,1,4,5,20.0%,42m
46586,3,Rosalina,1869,0,0,1,1,0.0%,39m
46586,2,BigC,1869,0,0,3,3,0.0%,3h
46608,3,jsoldier,1868,1576,95,114,209,45.5%,26m
46608,3,aaa,1868,1556,94,106,200,47.0%,12m
46608,3,MrHamburger,1868,1539,92,104,196,46.9%,28m
46608,3,ULTRA,1868,1053,35,41,76,46.1%,1h
46608,3,Riz,1868,817,29,31,60,48.3%,32m
46608,2,yuji,1868,543,19,26,45,42.2%,3h
46608,3,pro,1868,266,8,6,14,57.1%,18m
46608,3,LaPromesa,1868,58,5,5,10,50.0%,1h
46608,3,Dragonspirit,1868,122,5,11,16,31.2%,1h
46608,3,BaldyCron,1868,151,4,3,7,57.1%,10m
46608,2,Miles,1868,156,4,3,7,57.1%,1h
46608,1,Pure,1868,156,3,14,17,17.6%,33m
46608,2,Hawk,1868,133,2,4,6,33.3%,4m
46608,3,Aubzstein,1868,38,2,6,8,25.0%,1h
46608,2,albeatman,1868,108,2,10,12,16.7%,3h
46608,3,serbero,1868,0,1,0,1,100.0%,1h
46608,2,[xXGDXx]DRAGONGD,1868,0,1,1,2,50.0%,9m
46608,3,McClean,1868,0,0,6,6,0.0%,49m
46608,2,AndyPanda,1868,0,0,7,7,0.0%,22m
46627,3,[FCTR]Dokkisse,1867,1317,61,62,123,49.6%,10m
46627,3,[BtrBoi]Domitian,1867,854,31,35,66,47.0%,42m
46627,3,Baco,1867,676,29,31,60,48.3%,3h
46627,3,Dyujra,1867,508,17,25,42,40.5%,42m
46627,3,SpaceMiner,1867,249,11,13,24,45.8%,3h
46627,3,Edu,1867,129,9,3,12,75.0%,1h
46627,2,[EvilCC]Dragonaid,1867,217,6,17,23,26.1%,3h
46627,1,[ZTempz]shabbaranks,1867,180,6,20,26,23.1%,56m
46627,2,marius,1867,172,4,5,9,44.4%,3h
46627,3,NAVA,1867,90,3,6,9,33.3%,56m
46627,2,PhamilyMahn,1867,58,3,8,11,27.3%,1h
46627,2,[FBDPFF]DouglasCP,1867,46,2,4,6,33.3%,1h
46627,2,Mussman,1867,62,2,13,15,13.3%,1h
46627,2,Tman,1867,46,1,5,6,16.7%,3h
46627,2,FRANKP,1867,48,1,5,6,16.7%,51m
46627,1,Artix,1867,48,1,7,8,12.5%,25m
46627,3,[Wehavu]XVIILEGION,1867,0,0,1,1,0.0%,29m
46627,3,OneoftheNine,1867,0,0,1,1,0.0%,27m
46627,3,DrDickHughes,1867,0,0,2,2,0.0%,1h
46646,2,Infrared,1866,1616,127,146,273,46.5%,21m
46646,3,Kirk,1866,1548,98,114,212,46.2%,1h
46646,3,Dragonlord,1866,924,52,54,106,49.1%,3h
46646,3,leandro,1866,954,38,40,78,48.7%,38m
46646,2,sargento,1866,706,26,36,62,41.9%,1h
46646,2,aabike,1866,739,25,36,61,41.0%,1h
46646,2,PowerPlay,1866,662,24,31,55,43.6%,35m
46646,3,elroble,1866,536,20,16,36,55.6%,2h
46646,3,Cjkmaa,1866,419,19,11,30,63.3%,3h
46646,3,[sLuxx]matt,1866,536,18,26,44,40.9%,1h
46646,2,CADF,1866,462,16,27,43,37.2%,25m
46646,3,Kormania,1866,188,7,10,17,41.2%,1h
46646,2,ALBORYOIN,1866,219,7,13,20,35.0%,3h
46646,3,straightburn,1866,0,4,1,5,80.0%,40m
46646,3,Mullaonsusi,1866,60,3,2,5,60.0%,3h
46646,3,jamwheeler,1866,146,3,2,5,60.0%,28m
46646,3,derpindas,1866,145,3,4,7,42.9%,53m
46646,3,thechosenone,1866,58,3,10,13,23.1%,3h
46646,3,[Year06]Apparition,1866,0,1,0,1,100.0%,3h
46646,3,WhatIf,1866,0,1,1,2,50.0%,26m
46646,3,deathmage,1866,30,1,2,3,33.3%,1h
46646,3,dexxse,1866,0,0,2,2,0.0%,1h
46646,2,Ronin,1866,0,0,8,8,0.0%,12m
46669,3,facoud,1865,1132,41,54,95,43.2%,1h
46669,3,[AllyPG]Smittyblack,1865,699,27,30,57,47.4%,3h
46669,3,properruno,1865,534,19,18,37,51.4%,10m
46669,2,Ares,1865,362,12,21,33,36.4%,15m
46669,3,Andy,1865,368,12,26,38,31.6%,29m
46669,2,cringelord,1865,267,9,22,31,29.0%,1h
46669,3,[KhanZ]PRIETONEGRIN,1865,234,8,13,21,38.1%,28m
46669,3,sagitario,1865,158,6,11,17,35.3%,39m
46669,3,MrBeatbox,1865,144,4,1,5,80.0%,1h
46669,3,[IROT]IAmSin,1865,174,4,4,8,50.0%,1h
46669,3,Sidthesloth,1865,94,4,6,10,40.0%,16m
46669,3,Vlad,1865,30,2,8,10,20.0%,38m
46669,3,NorthStar,1865,113,2,9,11,18.2%,39m
46669,2,Hirgon,1865,38,1,2,3,33.3%,1h
46669,2,JimDawd,1865,93,1,4,5,20.0%,3h
46669,2,kaseiicy,1865,0,1,7,8,12.5%,1h
46669,3,Oxime,1865,0,0,2,2,0.0%,3h
46669,3,MrSilvaJ,1865,0,0,5,5,0.0%,3h
46669,3,[CATY]Feta,1865,0,0,6,6,0.0%,1h
46669,2,Greyslayer,1865,0,0,7,7,0.0%,3h
46689,2,Charls,1864,1540,144,163,307,46.9%,3h
46689,2,caramaldita,1864,729,71,91,162,43.8%,40m
46689,3,Steffn,1864,1589,67,78,145,46.2%,28m
46689,2,[NoEnMi]DoorStuck,1864,696,23,40,63,36.5%,46m
46689,3,Cephiroth,1864,450,14,26,40,35.0%,1h
46689,3,SpartanOne,1864,180,7,10,17,41.2%,23m
46689,3,TheToadLord,1864,200,6,5,11,54.5%,59m
46689,3,bunny,1864,189,5,5,10,50.0%,2h
46689,3,Benificent,1864,196,5,15,20,25.0%,1h
46689,3,aliscape,1864,36,2,5,7,28.6%,20m
46689,1,redskintwin,1864,34,2,10,12,16.7%,41m
46689,3,Pylon,1864,0,1,2,3,33.3%,1h
46689,2,ryan,1864,46,1,10,11,9.1%,34m
46689,3,HelbentFive,1864,0,0,1,1,0.0%,25m
46689,3,Jose,1864,0,0,1,1,0.0%,1h
46689,3,CoachBob,1864,0,0,2,2,0.0%,10m
46705,2,Koto,1863,1315,48,58,106,45.3%,1h
46705,3,Bleeder,1863,1165,44,43,87,50.6%,3h
46705,3,diehard,1863,519,33,37,70,47.1%,1h
46705,1,adamdude,1863,888,31,41,72,43.1%,4m
46705,3,TKT,1863,524,21,25,46,45.7%,3h
46705,3,SergioXd,1863,529,19,19,38,50.0%,3h
46705,3,Tevans,1863,415,14,25,39,35.9%,3h
46705,3,KittyCatJoe,1863,346,13,22,35,37.1%,29m
46705,2,FosterFever,1863,310,10,22,32,31.2%,1h
46705,3,Octavio,1863,269,8,9,17,47.1%,10m
46705,3,KDP,1863,188,6,9,15,40.0%,1h
46705,3,Wallach,1863,124,4,11,15,26.7%,31m
46705,2,Aquilesbk,1863,121,3,12,15,20.0%,28m
46705,3,Uraniborg,1863,30,1,4,5,20.0%,3h
46705,1,StkyWytCreep,1863,0,1,8,9,11.1%,1h
46720,3,Prism,1862,1006,41,54,95,43.2%,1h
46720,3,Hormigón,1862,583,20,22,42,47.6%,39m
46720,2,[pSC20]IronClaD,1862,256,8,24,32,25.0%,4m
46720,2,TheMajor,1862,216,7,16,23,30.4%,3h
46720,3,Hoegaarden,1862,218,7,17,24,29.2%,3h
46720,3,lunojara,1862,192,6,10,16,37.5%,39m
46720,3,sebastian,1862,60,3,3,6,50.0%,1h
46720,1,protntopramo,1862,95,2,3,5,40.0%,19m
46720,3,Tommy,1862,60,2,6,8,25.0%,3h
46720,3,mivieejo,1862,30,1,4,5,20.0%,1h
46720,3,[nieBla]ElSemental,1862,0,0,2,2,0.0%,2h
46720,3,mikian,1862,0,0,4,4,0.0%,7m
46732,3,Nickfire,1861,442,15,23,38,39.5%,39m
46732,3,[WOBERT]EXPLOSIONS,1861,100,6,7,13,46.2%,29m
46732,3,[HOTDAM]Kira,1861,171,4,4,8,50.0%,39m
46732,2,[pl4boy]goldielocks,1861,122,4,11,15,26.7%,25m
46732,3,Vio,1861,102,3,8,11,27.3%,32m
46732,3,Jesuus,1861,135,2,3,5,40.0%,29m
46732,3,Rebootmagi,1861,0,2,4,6,33.3%,29m
46732,3,NigromanteMx,1861,58,2,6,8,25.0%,40m
46732,3,DarknDirty,1861,0,1,5,6,16.7%,1h
46732,3,tux,1861,0,0,1,1,0.0%,10m
46732,3,efdddd,1861,0,0,1,1,0.0%,1h
46732,2,[prise]Drako,1861,0,0,3,3,0.0%,1h
46732,3,Esther,1861,0,0,5,5,0.0%,3h
46745,3,RAPTORYTGG,1860,1570,58,65,123,47.2%,10m
46745,3,HAVISH,1860,1112,44,46,90,48.9%,28m
46745,2,[lnCo]MathHatBrad,1860,1024,43,55,98,43.9%,27m
46745,3,Pendejohn,1860,1101,39,54,93,41.9%,3h
46745,2,DukE,1860,414,24,22,46,52.2%,58m
46745,3,cbelan,1860,420,19,12,31,61.3%,18m
46745,3,MCC,1860,514,19,13,32,59.4%,56m
46745,3,batatatxt,1860,406,14,17,31,45.2%,3h
46745,3,[FFAA]BERSERKER,1860,267,9,11,20,45.0%,32m
46745,3,Michey,1860,190,7,10,17,41.2%,1h
46745,3,[GGsss]sniperkill,1860,173,5,6,11,45.5%,1h
46745,2,viral,1860,46,4,7,11,36.4%,3h
46745,3,datchuoi,1860,60,3,4,7,42.9%,39m
46745,3,cal,1860,90,3,4,7,42.9%,29m
46745,3,Veda,1860,58,3,10,13,23.1%,42m
46745,3,TerrorTurtle,1860,146,3,10,13,23.1%,53m
46745,2,Cris,1860,126,2,9,11,18.2%,1h
46745,3,KingJocko,1860,0,1,0,1,100.0%,1h
46745,3,kylooter,1860,0,1,1,2,50.0%,3h
46745,3,MarioJesuus,1860,0,1,1,2,50.0%,1h
46745,3,Watson,1860,88,1,2,3,33.3%,28m
46745,3,[Aiur23]DarkGamer,1860,0,1,3,4,25.0%,1h
46745,3,[HooX]Hooks,1860,30,1,8,9,11.1%,7m
46745,2,farizbjxrn,1860,96,1,8,9,11.1%,1h
46745,2,SilDur,1860,0,0,2,2,0.0%,1h
46745,2,VOIKA,1860,0,0,3,3,0.0%,1h
46745,2,DeathRed,1860,0,0,7,7,0.0%,1h
46772,2,PepeSilvia,1859,761,109,111,220,49.5%,4m
46772,3,[GCCx2]figureground,1859,1465,75,74,149,50.3%,1h
46772,3,GongGangsta,1859,1266,73,104,177,41.2%,10m
46772,2,Zeta,1859,1418,55,64,119,46.2%,1h
46772,3,Megulito,1859,589,31,31,62,50.0%,48m
46772,2,ahfei,1859,892,28,46,74,37.8%,3h
46772,3,BaSyl,1859,315,11,21,32,34.4%,1h
46772,3,JOE,1859,300,10,15,25,40.0%,14m
46772,1,MacZyy,1859,323,9,15,24,37.5%,9m
46772,3,ricP,1859,208,8,10,18,44.4%,1h
46772,3,yoyossjdios,1859,84,7,8,15,46.7%,3h
46772,3,ThatPZT,1859,233,7,9,16,43.8%,38m
46772,3,Aneustart,1859,145,6,11,17,35.3%,53m
46772,2,SBX,1859,166,5,2,7,71.4%,3h
46772,3,Vicky,1859,172,5,5,10,50.0%,1h
46772,3,[VGH]ZAMZ,1859,120,5,7,12,41.7%,53m
46772,2,SemaJesseJ,1859,132,4,5,9,44.4%,12m
46772,1,NavyDoc,1859,216,4,13,17,23.5%,55m
46772,3,[1Fenix]bolgamary,1859,0,2,2,4,50.0%,23m
46772,3,Shmebulock,1859,0,1,0,1,100.0%,3h
46772,3,Daniel,1859,0,1,1,2,50.0%,3m
46772,2,Test,1859,48,1,2,3,33.3%,1h
46772,3,SUCIODAN,1859,0,0,1,1,0.0%,1h
46772,3,Micfetzer,1859,0,0,1,1,0.0%,1h
46772,3,tigrerojo,1859,0,0,2,2,0.0%,3h
46772,3,RAYNOR,1859,0,0,2,2,0.0%,1h
46772,2,Shisna,1859,0,0,4,4,0.0%,38m
46772,2,Elmo,1859,0,0,7,7,0.0%,12m
46800,2,JPZeppelin,1858,1525,102,140,242,42.1%,1h
46800,3,Olie,1858,1376,100,130,230,43.5%,1h
46800,3,KAOTICTIGGER,1858,1554,77,95,172,44.8%,52m
46800,3,sanchoplus,1858,1316,48,61,109,44.0%,1h
46800,3,Gopher,1858,1192,43,54,97,44.3%,1h
46800,1,xmen,1858,746,42,51,93,45.2%,59m
46800,3,Domador,1858,499,19,23,42,45.2%,1h
46800,3,EarthShake,1858,531,18,22,40,45.0%,10m
46800,3,BROWSBB,1858,176,16,15,31,51.6%,1h
46800,3,jayels,1858,342,12,20,32,37.5%,14m
46800,3,[GOPERÚ]suimask,1858,332,11,15,26,42.3%,1h
46800,3,Nightmare,1858,72,7,3,10,70.0%,25m
46800,3,RafaelMongol,1858,118,4,4,8,50.0%,1h
46800,2,TheOne,1858,46,2,10,12,16.7%,29m
46800,2,[ATLsOs]bossmode,1858,0,0,7,7,0.0%,12m
46815,3,[ForMG]PQDT,1857,1461,87,106,193,45.1%,1h
46815,3,ErikGur,1857,1508,84,97,181,46.4%,1h
46815,3,xavixc,1857,418,14,19,33,42.4%,10m
46815,3,marcutroll,1857,251,7,18,25,28.0%,29m
46815,3,ALUKAR,1857,179,6,12,18,33.3%,47m
46815,1,[ZTemp]phillgill,1857,256,5,10,15,33.3%,7m
46815,3,roxuko,1857,209,5,13,18,27.8%,26m
46815,3,lostzmyway,1857,92,4,5,9,44.4%,29m
46815,3,Seba,1857,132,4,6,10,40.0%,14m
46815,2,Myst,1857,120,4,13,17,23.5%,35m
46815,3,DKPROFANO,1857,60,3,3,6,50.0%,31m
46815,3,Lowsheitz,1857,119,2,1,3,66.7%,39m
46815,3,Juakinosky,1857,0,1,5,6,16.7%,40m
46815,1,SaburNahur,1857,0,1,10,11,9.1%,3h
46815,3,[420th]Hellkitten,1857,0,0,1,1,0.0%,29m
46815,3,Gahzi,1857,0,0,7,7,0.0%,3h
46831,3,Dolpher,1856,1407,124,162,286,43.4%,16m
46831,3,zach,1856,764,30,24,54,55.6%,1h
46831,3,TonyWebMX,1856,675,30,44,74,40.5%,14m
46831,1,Raziel,1856,414,12,31,43,27.9%,1h
46831,2,[PoUd]mastterblack,1856,222,7,17,24,29.2%,1h
46831,2,FenFox,1856,116,6,5,11,54.5%,36m
46831,3,Larrybob,1856,173,5,8,13,38.5%,38m
46831,2,CrazyDave,1856,142,3,12,15,20.0%,1h
46831,2,MemphisEoN,1856,80,2,10,12,16.7%,1h
46831,2,Hanzo,1856,60,2,10,12,16.7%,1h
46831,3,[HOT69]Devastor,1856,0,1,4,5,20.0%,31m
46831,3,Leviskz,1856,0,0,4,4,0.0%,16m
46843,3,DarkFBP,1855,1523,62,66,128,48.4%,18m
46843,3,[N0BLE]Archer,1855,1156,43,45,88,48.9%,31m
46843,2,[HOT69]IZR,1855,472,42,62,104,40.4%,1h
46843,3,ShockanAwe,1855,497,31,30,61,50.8%,56m
46843,3,joemer,1855,421,14,31,45,31.1%,7m
46843,3,NOCHo,1855,140,4,4,8,50.0%,1h
46843,3,Despik,1855,94,3,5,8,37.5%,32m
46843,3,BlueBerryX,1855,30,1,4,5,20.0%,12m
46843,3,SweetNSalty,1855,0,0,2,2,0.0%,39m
46843,2,Spetrius,1855,0,0,2,2,0.0%,3h
46843,2,vipercinq,1855,0,0,7,7,0.0%,28m
46843,3,paintface,1855,0,0,7,7,0.0%,37m
46843,2,Rogue,1855,0,0,9,9,0.0%,1h
46856,2,Asashoryu,1854,1510,198,239,437,45.3%,10m
46856,3,Letholdus,1854,1208,51,59,110,46.4%,32m
46856,3,STELLARTOIS,1854,606,31,36,67,46.3%,1h
46856,3,Jamz,1854,786,30,29,59,50.8%,1h
46856,3,turdfurgison,1854,415,27,32,59,45.8%,3h
46856,3,Pojar,1854,556,20,25,45,44.4%,42m
46856,3,[forma]jumpingjacks,1854,414,14,23,37,37.8%,25m
46856,2,Phailist,1854,240,13,23,36,36.1%,3h
46856,2,kopas,1854,268,8,20,28,28.6%,3h
46856,3,algreen,1854,250,7,11,18,38.9%,3h
46856,3,Radu,1854,210,6,5,11,54.5%,3h
46856,3,ARLEQUIN,1854,125,3,2,5,60.0%,12m
46856,3,cuervofatal,1854,97,2,2,4,50.0%,3h
46856,3,tazadar,1854,60,2,5,7,28.6%,1h
46856,3,Juicebox,1854,0,1,0,1,100.0%,1h
46856,3,[Sondas]Rogueshadow,1854,97,1,1,2,50.0%,25m
46856,3,DustRolly,1854,30,1,3,4,25.0%,29m
46856,1,Vance,1854,0,1,9,10,10.0%,11m
46856,3,rayofueguino,1854,0,0,1,1,0.0%,3h
46856,3,CYPH,1854,0,0,5,5,0.0%,29m
46876,3,eming,1853,1031,62,63,125,49.6%,3h
46876,3,DrXanax,1853,725,30,43,73,41.1%,3h
46876,3,MayorRAM,1853,633,23,33,56,41.1%,29m
46876,3,funkmastrflx,1853,138,21,32,53,39.6%,1h
46876,2,Zapp,1853,514,18,26,44,40.9%,1h
46876,2,ArtOfWar,1853,480,17,28,45,37.8%,1h
46876,3,radman,1853,170,6,11,17,35.3%,1h
46876,3,TheChosenOne,1853,222,6,15,21,28.6%,1h
46876,3,ninga,1853,30,2,5,7,28.6%,26m
46876,3,ani,1853,121,2,9,11,18.2%,52m
46876,3,Indo,1853,0,1,1,2,50.0%,45m
46876,3,Jose,1853,0,1,2,3,33.3%,48m
46876,3,[VETS]LIBERTADOR,1853,0,0,1,1,0.0%,16m
46889,1,Bane,1852,1028,41,49,90,45.6%,1h
46889,3,Tiffany,1852,794,38,14,52,73.1%,7m
46889,3,Lilfoot,1852,332,12,7,19,63.2%,18m
46889,3,DisasterDog,1852,110,10,10,20,50.0%,28m
46889,1,Gabo,1852,264,10,18,28,35.7%,2m
46889,3,Jukumari,1852,236,8,4,12,66.7%,45m
46889,1,jimmmy,1852,64,3,8,11,27.3%,1h
46889,2,Emindur,1852,48,1,9,10,10.0%,1h
46889,3,Cszinke,1852,0,0,3,3,0.0%,29m
46889,3,[hekn]Jret,1852,0,0,5,5,0.0%,47m
46899,3,OneMore,1851,1546,130,150,280,46.4%,1h
46899,3,dasimpso,1851,1214,84,90,174,48.3%,31m
46899,3,LoOt,1851,277,14,13,27,51.9%,14m
46899,2,[IIDX]Sargentlewis,1851,315,10,22,32,31.2%,3h
46899,3,Eagleeye,1851,262,9,7,16,56.2%,3h
46899,3,[Huffs]ProbeZilla,1851,262,8,14,22,36.4%,25m
46899,3,[KhanZ]Cositorico,1851,180,6,8,14,42.9%,53m
46899,2,meme,1851,193,6,11,17,35.3%,3h
46899,3,[TLoA]OreMiner,1851,128,5,16,21,23.8%,1h
46899,3,NatOSK,1851,58,3,5,8,37.5%,29m
46899,2,JulioCezar,1851,60,2,10,12,16.7%,1h
46899,3,COLO,1851,0,1,0,1,100.0%,10m
46899,3,JPEsp,1851,0,0,1,1,0.0%,1h
46899,2,SickFlow,1851,0,0,5,5,0.0%,1h
46899,3,Proteus,1851,0,0,6,6,0.0%,17m
46914,3,Goooeyfarts,1850,1147,108,116,224,48.2%,3h
46914,3,SunTsun,1850,1574,103,124,227,45.4%,37m
46914,1,Bender,1850,1559,99,110,209,47.4%,3h
46914,3,DarkProbe,1850,1470,68,79,147,46.3%,1h
46914,3,Ryrus,1850,989,36,38,74,48.6%,1h
46914,3,FeRex,1850,855,31,32,63,49.2%,25m
46914,3,koopatroopa,1850,712,25,41,66,37.9%,52m
46914,3,hobakill,1850,374,22,25,47,46.8%,14m
46914,3,TheBestDad,1850,448,18,15,33,54.5%,3h
46914,3,dexter,1850,432,16,26,42,38.1%,29m
46914,3,RickyBobby,1850,374,14,14,28,50.0%,52m
46914,3,ShadowCast,1850,324,11,16,27,40.7%,1h
46914,3,MORENAZO,1850,224,8,13,21,38.1%,1h
46914,1,ESQUILO,1850,144,6,9,15,40.0%,9m
46914,3,[ALTF04]Rorro,1850,218,6,12,18,33.3%,39m
46914,1,Precision,1850,211,5,9,14,35.7%,3h
46914,2,TalkDooDoTom,1850,116,3,4,7,42.9%,3m
46914,3,Hecatonquiro,1850,30,2,2,4,50.0%,1h
46914,3,[S0Y]JotaeRe,1850,0,1,0,1,100.0%,3h
46914,3,Gandalfete,1850,30,1,3,4,25.0%,53m
46914,3,Mrmidget,1850,0,0,1,1,0.0%,1h
46914,3,ThaiNaVy,1850,0,0,1,1,0.0%,1h
46914,3,[BLAQC]BLACK,1850,0,0,2,2,0.0%,40m
46914,3,alvinuub,1850,0,0,5,5,0.0%,53m
46938,3,[GKDM]Nightmare,1849,1358,60,68,128,46.9%,14m
46938,3,warmech,1849,1001,40,45,85,47.1%,29m
46938,2,Chaka,1849,538,26,29,55,47.3%,17m
46938,3,downtiowntra,1849,382,16,6,22,72.7%,48m
46938,2,NSeymourCash,1849,348,13,19,32,40.6%,58m
46938,3,Jae,1849,105,8,16,24,33.3%,1h
46938,2,SRTez,1849,193,5,6,11,45.5%,1h
46938,3,Merkulation,1849,150,5,12,17,29.4%,1h
46938,3,[Games2]kuzure,1849,114,5,12,17,29.4%,12m
46938,2,blueshell,1849,58,3,10,13,23.1%,51m
46938,3,[ZMBELT]darksaladsho,1849,0,1,3,4,25.0%,1h
46938,3,DavidVigoya,1849,30,1,5,6,16.7%,1h
46938,3,DudeComeOn,1849,0,1,8,9,11.1%,1h
46938,2,Marvel,1849,0,0,1,1,0.0%,1h
46952,2,Metalator,1848,1559,126,149,275,45.8%,3h
46952,3,Donald,1848,764,34,37,71,47.9%,14m
46952,3,Robert,1848,887,32,34,66,48.5%,3h
46952,3,andrei,1848,331,27,37,64,42.2%,1h
46952,3,shunhiusha,1848,263,8,15,23,34.8%,3h
46952,3,PatFinger,1848,30,2,1,3,66.7%,3h
46952,3,Bacon,1848,96,2,4,6,33.3%,56m
46952,3,airbhong,1848,95,2,4,6,33.3%,1h
46952,3,shinjiuchiha,1848,118,2,7,9,22.2%,1h
46952,3,HunabKuZamna,1848,0,1,0,1,100.0%,3h
46952,3,HennydaHouse,1848,97,1,3,4,25.0%,29m
46952,2,rjtheriot,1848,0,0,1,1,0.0%,1h
46964,3,CumGroyper,1847,1543,151,174,325,46.5%,1h
46964,3,TerryDane,1847,1395,70,79,149,47.0%,3h
46964,3,TonE,1847,1217,64,70,134,47.8%,28m
46964,3,gatopro,1847,376,12,19,31,38.7%,29m
46964,3,KRAMPHUS,1847,159,5,5,10,50.0%,32m
46964,3,Cluitarhero,1847,122,4,7,11,36.4%,37m
46964,3,Thierryus,1847,86,3,5,8,37.5%,12m
46964,2,Soullike,1847,136,3,8,11,27.3%,12m
46964,2,autumn,1847,130,3,12,15,20.0%,52m
46964,3,KakarotoX,1847,66,2,3,5,40.0%,37m
46964,2,AthTomb,1847,88,2,12,14,14.3%,1h
46964,3,achilles,1847,0,0,1,1,0.0%,1h
46964,2,ralphw,1847,0,0,8,8,0.0%,35m
46977,3,Crev,1846,1079,38,48,86,44.2%,28m
46977,3,JillThompson,1846,521,21,20,41,51.2%,25m
46977,2,PretorIvan,1846,411,21,31,52,40.4%,1h
46977,1,Papasmurf,1846,660,21,41,62,33.9%,4m
46977,3,Agustin,1846,303,14,27,41,34.1%,1h
46977,3,Verds,1846,164,5,2,7,71.4%,39m
46977,2,Segatex,1846,0,4,4,8,50.0%,3h
46977,3,OnEKinG,1846,90,4,5,9,44.4%,12m
46977,3,Eratóstenes,1846,94,4,10,14,28.6%,3h
46977,3,Merick,1846,30,1,3,4,25.0%,34m
46977,3,Leemin,1846,0,0,2,2,0.0%,29m
46977,3,JYJYJY,1846,0,0,2,2,0.0%,1h
46989,3,delta,1845,687,29,26,55,52.7%,29m
46989,3,sBocchio,1845,673,26,25,51,51.0%,3h
46989,3,HellSurfer,1845,463,15,22,37,40.5%,10m
46989,3,guiandguz,1845,398,14,12,26,53.8%,32m
46989,2,tutorselda,1845,375,11,28,39,28.2%,1h
46989,3,squadout,1845,242,10,19,29,34.5%,3h
46989,3,[GTHS]eddy,1845,180,6,13,19,31.6%,1h
46989,2,bizmofunyun,1845,138,4,14,18,22.2%,12m
46989,3,[PANDAF]AudioSlave,1845,119,3,1,4,75.0%,29m
46989,3,[Calx]enanoGigante,1845,145,3,4,7,42.9%,28m
46989,3,SentryJason,1845,96,3,4,7,42.9%,28m
46989,3,jugame,1845,115,2,2,4,50.0%,5m
46989,3,dimondsoul,1845,0,1,0,1,100.0%,1h
46989,3,Tonatihu,1845,0,1,0,1,100.0%,39m
46989,3,Crock,1845,30,1,2,3,33.3%,48m
46989,2,ComeOutSwing,1845,0,1,3,4,25.0%,1h
46989,3,destructor,1845,0,0,2,2,0.0%,29m
46989,3,Noobie,1845,0,0,2,2,0.0%,1h
46989,2,TripleAAA,1845,0,0,7,7,0.0%,1h
47008,3,tecomatador,1844,1446,57,66,123,46.3%,39m
47008,3,Voly,1844,833,31,38,69,44.9%,23m
47008,3,Gord,1844,696,29,27,56,51.8%,5m
47008,3,Anibal,1844,615,24,33,57,42.1%,3h
47008,2,[FatMom]CONEX,1844,398,13,27,40,32.5%,3h
47008,3,XuZhiling,1844,248,9,23,32,28.1%,6m
47008,3,DrJonWatson,1844,144,8,9,17,47.1%,2h
47008,3,[NastyB]joseluis,1844,178,5,5,10,50.0%,40m
47008,3,Los,1844,188,5,5,10,50.0%,28m
47008,2,void,1844,58,5,9,14,35.7%,16m
47008,3,AlexanderR,1844,120,3,0,3,100.0%,18m
47008,3,Tork,1844,119,3,1,4,75.0%,3h
47008,3,NerdGuy,1844,0,3,3,6,50.0%,1h
47008,3,Pablo,1844,30,3,5,8,37.5%,16m
47008,3,pablobeer,1844,60,3,5,8,37.5%,45m
47008,3,Darknight,1844,0,0,2,2,0.0%,1h
47008,2,Bakedpotato,1844,0,0,5,5,0.0%,1h
47025,2,rickardo,1843,695,47,55,102,46.1%,1h
47025,3,AVSA,1843,1074,37,50,87,42.5%,48m
47025,3,guy,1843,623,30,34,64,46.9%,52m
47025,3,Largest,1843,352,14,15,29,48.3%,48m
47025,2,Pitchme,1843,308,10,20,30,33.3%,14m
47025,2,KTitanium,1843,136,6,12,18,33.3%,3h
47025,2,lithium,1843,164,5,18,23,21.7%,3h
47025,1,prosor,1843,142,4,12,16,25.0%,1h
47025,3,kobonaut,1843,115,2,2,4,50.0%,39m
47025,1,Trichome,1843,36,2,12,14,14.3%,6m
47025,1,CDavis,1843,30,2,12,14,14.3%,3h
47025,3,[PL0TE]HappyGilmore,1843,0,1,4,5,20.0%,28m
47025,3,DNM,1843,0,0,1,1,0.0%,1h
47025,3,kira,1843,0,0,2,2,0.0%,3h
47025,2,Luck,1843,0,0,8,8,0.0%,4m
47040,3,Bones,1842,1257,47,57,104,45.2%,48m
47040,3,Waly,1842,1158,41,48,89,46.1%,28m
47040,3,yinyeret,1842,619,25,18,43,58.1%,10m
47040,3,ped,1842,385,24,26,50,48.0%,3h
47040,3,[LPrusa]Xforcex,1842,142,5,5,10,50.0%,13m
47040,1,BBGreenRoom,1842,48,4,8,12,33.3%,3h
47040,3,Wojo,1842,92,3,7,10,30.0%,25m
47040,3,Trujyaya,1842,30,2,3,5,40.0%,42m
47040,3,TheKingBeck,1842,0,2,4,6,33.3%,21m
47040,2,[xLCx]Shuru,1842,135,2,6,8,25.0%,12m
47040,2,WalkingDude,1842,94,2,8,10,20.0%,1h
47040,3,Cgal,1842,30,1,3,4,25.0%,3h
47040,3,[xXGDXx]azcat,1842,30,1,4,5,20.0%,18m
47040,2,[PVP3RS]Spencer,1842,0,1,7,8,12.5%,3h
47040,3,Icecruncher,1842,0,0,2,2,0.0%,42m
47040,3,Fishdisco,1842,0,0,5,5,0.0%,3h
47056,3,Zen,1841,1355,140,157,297,47.1%,3h
47056,3,Ian,1841,1556,136,173,309,44.0%,1h
47056,3,Darklicht,1841,1518,89,92,181,49.2%,1h
47056,3,Roberto,1841,1501,57,70,127,44.9%,10m
47056,3,[4bronz]Skeetztoohrd,1841,836,29,37,66,43.9%,2h
47056,3,jefe,1841,656,27,37,64,42.2%,10m
47056,3,DantePH,1841,171,7,8,15,46.7%,1h
47056,3,Achilles,1841,169,4,5,9,44.4%,13m
47056,3,Connor,1841,165,4,12,16,25.0%,8m
47056,3,Tony,1841,120,3,1,4,75.0%,3h
47056,3,SecoPeteco,1841,100,3,5,8,37.5%,14m
47056,2,Audiochild,1841,58,3,6,9,33.3%,18m
47056,2,iselldank,1841,60,3,9,12,25.0%,13m
47056,3,[Vtta]juan,1841,30,2,1,3,66.7%,56m
47056,3,Akdariio,1841,30,2,7,9,22.2%,2h
47056,3,AriTheLog,1841,0,1,0,1,100.0%,1h
47056,3,BIizzard,1841,0,1,2,3,33.3%,3h
47056,3,HolyKnight,1841,0,1,4,5,20.0%,49m
47056,3,MarkStrong,1841,0,0,1,1,0.0%,53m
47056,3,Pinoo,1841,0,0,2,2,0.0%,1h
47076,3,karen,1840,1501,209,267,476,43.9%,53m
47076,3,salty,1840,1240,45,53,98,45.9%,14m
47076,2,Terror,1840,181,16,32,48,33.3%,34m
47076,2,Leftconsin,1840,178,6,15,21,28.6%,1h
47076,2,lilas,1840,152,5,12,17,29.4%,51m
47076,3,malekey,1840,120,4,6,10,40.0%,25m
47076,1,AoiDoragon,1840,48,2,12,14,14.3%,1h
47076,3,friendlyfrog,1840,30,1,2,3,33.3%,1h
47076,2,Constructor,1840,93,1,9,10,10.0%,1h
47076,2,Qman,1840,0,0,6,6,0.0%,3h
47076,3,Tootall,1840,0,0,7,7,0.0%,21m
47087,3,[PNGcl]egbdf,1839,1490,132,151,283,46.6%,23m
47087,2,amACE,1839,1182,68,83,151,45.0%,52m
47087,2,MavericK,1839,943,63,70,133,47.4%,46m
47087,2,zatorflaboos,1839,1417,55,72,127,43.3%,3h
47087,1,Biceps,1839,1154,37,57,94,39.4%,3h
47087,2,Springs,1839,857,28,38,66,42.4%,1h
47087,3,Whasagoo,1839,528,19,20,39,48.7%,3h
47087,3,Lilswampton,1839,342,15,15,30,50.0%,1h
47087,2,jakethesnake,1839,293,15,22,37,40.5%,43m
47087,3,Eledhwen,1839,403,13,23,36,36.1%,3h
47087,2,PylonsMaybe,1839,451,13,28,41,31.7%,14m
47087,2,WARHOGG,1839,368,12,28,40,30.0%,39m
47087,3,Axton,1839,212,8,12,20,40.0%,14m
47087,2,Gohda,1839,226,7,15,22,31.8%,18m
47087,1,supremo,1839,211,5,8,13,38.5%,1h
47087,3,OoOVVOoO,1839,122,5,13,18,27.8%,1h
47087,2,Parasite,1839,94,2,5,7,28.6%,1h
47087,3,Thanatos,1839,30,2,7,9,22.2%,1h
47087,3,[UG15]MichaelUG,1839,0,1,1,2,50.0%,48m
47087,3,Alcey,1839,0,1,4,5,20.0%,49m
47087,2,PlagatH,1839,0,0,2,2,0.0%,4m
47087,1,[BSTCEV]jovypro,1839,0,0,3,3,0.0%,24m
47087,3,SirDabsAlot,1839,0,0,6,6,0.0%,29m
47087,2,MetalStorm,1839,0,0,8,8,0.0%,1h
47087,2,enkidu,1839,0,0,9,9,0.0%,1h
47112,3,TheScott,1838,1369,111,125,236,47.0%,3h
47112,3,[NEXSC2]Smartacus,1838,845,44,47,91,48.4%,1h
47112,2,FluffyOps,1838,791,28,44,72,38.9%,36m
47112,3,TDduckman,1838,710,27,30,57,47.4%,23m
47112,2,VosiBop,1838,725,26,32,58,44.8%,3h
47112,2,Skortiz,1838,146,5,13,18,27.8%,3h
47112,1,desertracer,1838,144,5,16,21,23.8%,3h
47112,1,Emilll,1838,86,3,3,6,50.0%,1h
47112,3,mightyown,1838,30,2,2,4,50.0%,10m
47112,3,SlentStorm,1838,58,2,7,9,22.2%,1h
47112,3,coolguy,1838,30,2,7,9,22.2%,1h
47112,3,Tuna,1838,0,0,2,2,0.0%,1h
47112,2,Johesco,1838,0,0,3,3,0.0%,52m
47125,3,Tarttalo,1837,1564,155,196,351,44.2%,1h
47125,3,Curt,1837,1197,54,61,115,47.0%,28m
47125,3,SPECTRUM,1837,728,31,38,69,44.9%,1h
47125,3,JOHNSNOWED,1837,299,30,23,53,56.6%,1h
47125,2,NukeU,1837,335,24,35,59,40.7%,16m
47125,3,tiagoout,1837,595,23,24,47,48.9%,1h
47125,3,LeonCatsky,1837,316,19,13,32,59.4%,3h
47125,1,Sssandro,1837,548,13,13,26,50.0%,3m
47125,3,LeeroyJonson,1837,384,12,22,34,35.3%,1h
47125,3,Angus,1837,208,9,21,30,30.0%,1h
47125,3,[TGosuD]Peacewind,1837,169,4,14,18,22.2%,3h
47125,1,SKorn,1837,130,3,13,16,18.8%,1h
47125,3,[SPAC3R]BlitzHammer,1837,42,2,5,7,28.6%,1h
47125,1,THEPRO,1837,101,2,8,10,20.0%,10m
47125,2,ANoobXD,1837,0,1,0,1,100.0%,29m
47125,2,[Ixen]crazydoc,1837,0,1,0,1,100.0%,43m
47125,1,Samujo,1837,0,1,0,1,100.0%,1h
47125,3,Daniel,1837,0,1,1,2,50.0%,3h
47125,1,okaymom,1837,0,0,1,1,0.0%,1h
47125,1,TrumpYeezy,1837,0,0,1,1,0.0%,1h
47125,3,Radamantis,1837,0,0,1,1,0.0%,1h
47125,3,Dantopia,1837,0,0,3,3,0.0%,3h
47125,1,WizerKilhelm,1837,0,0,5,5,0.0%,9m
47148,2,SpartanKing,1836,870,87,100,187,46.5%,40m
47148,3,Sleigher,1836,963,64,64,128,50.0%,1h
47148,3,[SLKNM]LOngaX,1836,767,28,38,66,42.4%,1h
47148,3,ALFHAR,1836,494,17,25,42,40.5%,47m
47148,3,SANGETSU,1836,204,7,9,16,43.8%,13m
47148,2,rXycenobita,1836,271,7,11,18,38.9%,1h
47148,3,[LBanda]nachosmc,1836,192,6,10,16,37.5%,28m
47148,3,Pdoggity,1836,58,4,6,10,40.0%,14m
47148,2,Livramento,1836,118,3,12,15,20.0%,1h
47148,3,VIPER,1836,0,1,9,10,10.0%,51m
47148,1,zergatoss,1836,0,0,1,1,0.0%,14m
47148,2,[DriveC]DeadlySpear,1836,0,0,1,1,0.0%,1h
47148,3,Smaenblack,1836,0,0,1,1,0.0%,42m
47161,2,CapeCod,1835,1428,167,194,361,46.3%,1h
47161,1,lidervill,1835,310,11,18,29,37.9%,1h
47161,3,Xurisso,1835,141,3,3,6,50.0%,1h
47161,1,[lmLx]lobicop,1835,40,3,3,6,50.0%,3h
47161,1,xanth,1835,0,1,0,1,100.0%,10m
47161,3,[UltraX]CombatWombat,1835,30,1,4,5,20.0%,27m
47161,3,RSEAGLE,1835,0,0,1,1,0.0%,1h
47161,1,[4fun4]Matt,1835,0,0,1,1,0.0%,3h
47161,1,PeanutButter,1835,0,0,1,1,0.0%,18m
47161,3,samurobot,1835,0,0,1,1,0.0%,37m
47171,3,chango,1834,1571,63,95,158,39.9%,3h
47171,2,Azarath,1834,503,18,30,48,37.5%,25m
47171,3,igncar,1834,266,10,30,40,25.0%,29m
47171,3,Kropotkin,1834,229,7,13,20,35.0%,10m
47171,1,CAFFELATTE,1834,175,5,5,10,50.0%,1h
47171,3,ZodiakSC,1834,114,4,6,10,40.0%,1h
47171,1,PenguinKing,1834,58,3,11,14,21.4%,3h
47171,3,Dyingwish,1834,153,3,13,16,18.8%,16m
47171,1,[pelima]CHACHO,1834,73,2,5,7,28.6%,10m
47171,1,ThatsSoRetro,1834,129,2,11,13,15.4%,1h
47171,2,CymK,1834,36,1,8,9,11.1%,14m
47171,2,red,1834,0,0,5,5,0.0%,1h
47183,3,[RSC2]Zerathul,1833,529,27,33,60,45.0%,39m
47183,3,Eduardo,1833,644,21,32,53,39.6%,27m
47183,2,GARDIAN,1833,419,14,27,41,34.1%,3h
47183,3,SideSlip,1833,307,11,16,27,40.7%,3h
47183,1,ashrigo,1833,160,5,16,21,23.8%,11m
47183,3,BlueBeast,1833,126,4,5,9,44.4%,3h
47183,3,Kai,1833,120,4,8,12,33.3%,40m
47183,2,Zenpa,1833,150,4,10,14,28.6%,1h
47183,3,IseeU,1833,171,4,13,17,23.5%,8m
47183,1,PapaBehr,1833,208,4,13,17,23.5%,3m
47183,2,zaps,1833,84,2,10,12,16.7%,1h
47183,3,ShawnJS,1833,0,1,0,1,100.0%,29m
47183,3,AxelRCV,1833,30,1,8,9,11.1%,39m
47183,2,jarg,1833,0,0,1,1,0.0%,4m
47183,3,Albinogrinch,1833,0,0,3,3,0.0%,47m
47198,3,Nova,1832,1588,73,79,152,48.0%,1h
47198,2,tarkIV,1832,1000,40,45,85,47.1%,3h
47198,3,HoustonGmp,1832,444,25,27,52,48.1%,28m
47198,3,SpaceLemming,1832,549,20,21,41,48.8%,25m
47198,3,BuseMorose,1832,546,19,35,54,35.2%,10m
47198,3,destructor,1832,336,14,20,34,41.2%,25m
47198,2,[maru02]MARU,1832,166,5,9,14,35.7%,1h
47198,3,TsaeBLerraF,1832,6,3,5,8,37.5%,32m
47198,3,Vitamin,1832,76,2,1,3,66.7%,1h
47198,1,thoch,1832,116,2,3,5,40.0%,39m
47198,3,Jinto,1832,30,1,4,5,20.0%,29m
47198,3,INGFERNUS,1832,96,1,7,8,12.5%,25m
47210,2,[MaxWin]MrAnimot,1831,1533,153,168,321,47.7%,3h
47210,3,Pure,1831,1565,75,95,170,44.1%,53m
47210,3,Spud,1831,1209,74,91,165,44.8%,28m
47210,2,Steamroller,1831,730,49,61,110,44.5%,4m
47210,3,cesar,1831,378,26,31,57,45.6%,28m
47210,2,Ebjustnew,1831,610,19,33,52,36.5%,4m
47210,3,Spirit,1831,270,9,20,29,31.0%,23m
47210,1,Wraydar,1831,315,8,7,15,53.3%,1h
47210,2,Tuefel,1831,202,5,10,15,33.3%,3h
47210,3,Dogzen,1831,189,5,20,25,20.0%,39m
47210,3,Cyrus,1831,58,3,7,10,30.0%,39m
47210,3,Ignacio,1831,0,0,2,2,0.0%,38m
47210,2,CoolDude,1831,0,0,8,8,0.0%,3h
47210,2,GarryWolf,1831,0,0,9,9,0.0%,3h
47224,2,Ranma,1830,560,23,39,62,37.1%,1h
47224,2,[DRKRYL]Goo,1830,372,12,22,34,35.3%,3m
47224,1,Shockwave,1830,349,12,25,37,32.4%,6m
47224,2,FladKing,1830,291,11,10,21,52.4%,9m
47224,3,foruolord,1830,166,5,2,7,71.4%,1h
47224,3,Player,1830,166,4,10,14,28.6%,10m
47224,3,PredatorKan,1830,120,3,1,4,75.0%,3h
47224,3,BenMoxie,1830,36,1,2,3,33.3%,1h
47224,1,Eljin,1830,0,1,10,11,9.1%,9m
47224,3,rompeimenz,1830,0,0,2,2,0.0%,37m
47224,2,cronos,1830,0,0,9,9,0.0%,12m
47235,3,Weslley,1829,366,14,18,32,43.8%,3h
47235,3,Marshall,1829,184,6,11,17,35.3%,48m
47235,2,kuba,1829,0,4,7,11,36.4%,58m
47235,3,REALIZOR,1829,118,3,1,4,75.0%,53m
47235,1,KHOUSE,1829,92,2,1,3,66.7%,1h
47235,1,xXNOproXx,1829,74,2,3,5,40.0%,3h
47235,1,ThatGuy,1829,0,1,0,1,100.0%,1h
47235,2,Nail,1829,44,1,4,5,20.0%,9m
47235,1,SteveCraft,1829,0,1,4,5,20.0%,24m
47235,2,Thatguy,1829,46,1,9,10,10.0%,3h
47235,1,Cid,1829,0,0,1,1,0.0%,1h
47235,3,Tmplario,1829,0,0,1,1,0.0%,22m
47235,3,Paclord,1829,0,0,3,3,0.0%,1h
47248,3,JLBSC,1828,1547,155,188,343,45.2%,3h
47248,3,QuixotePrime,1828,1480,87,102,189,46.0%,1h
47248,3,AlekBlue,1828,1204,46,71,117,39.3%,3h
47248,3,MadMaxxx,1828,1262,42,65,107,39.3%,1h
47248,1,Heretic,1828,1178,41,52,93,44.1%,3h
47248,3,[CHAMAN]ORION,1828,540,19,27,46,41.3%,38m
47248,3,LaMar,1828,287,8,24,32,25.0%,1h
47248,2,ianm,1828,170,4,11,15,26.7%,1h
47248,3,Ninstromos,1828,0,1,0,1,100.0%,36m
47248,1,neisaf,1828,0,1,9,10,10.0%,3h
47248,3,ThePiglet,1828,0,0,1,1,0.0%,1h
47248,1,Khanemahz,1828,0,0,1,1,0.0%,3m
47260,3,BenDover,1827,1549,421,557,978,43.0%,34m
47260,2,LeonRojo,1827,1524,133,156,289,46.0%,1h
47260,1,Mariotto,1827,1338,47,67,114,41.2%,3h
47260,3,kfurmkos,1827,1127,40,56,96,41.7%,53m
47260,3,AKellen,1827,359,15,25,40,37.5%,27m
47260,3,KelZac,1827,297,10,8,18,55.6%,3h
47260,3,[LHDSC]bembaza,1827,177,10,8,18,55.6%,25m
47260,3,Taboo,1827,296,9,20,29,31.0%,1h
47260,3,crazyivan,1827,265,8,8,16,50.0%,47m
47260,3,Blizzsaw,1827,188,6,3,9,66.7%,8m
47260,1,Irresponsibl,1827,90,3,12,15,20.0%,3h
47260,3,ROBERTO,1827,60,2,6,8,25.0%,3h
47260,1,xOhxSleeperx,1827,105,2,11,13,15.4%,10m
47260,2,ZENOMARC,1827,0,1,0,1,100.0%,1h
47260,3,kingroy,1827,0,1,1,2,50.0%,39m
47260,2,willi,1827,0,0,4,4,0.0%,52m
47276,3,LuisZambrano,1826,1582,304,404,708,42.9%,38m
47276,1,Amrak,1826,1389,41,71,112,36.6%,19m
47276,3,Whimsey,1826,850,29,42,71,40.8%,1h
47276,3,hegutierrezv,1826,277,24,41,65,36.9%,1h
47276,3,Thorn,1826,657,22,30,52,42.3%,1h
47276,3,RLX,1826,588,20,26,46,43.5%,1h
47276,3,Destructor,1826,527,19,30,49,38.8%,27m
47276,3,Doom,1826,516,17,25,42,40.5%,4m
47276,3,[lab317]goodoldman,1826,234,10,15,25,40.0%,1h
47276,3,gsmetz,1826,90,5,14,19,26.3%,57m
47276,3,josafat,1826,60,2,5,7,28.6%,1h
47276,3,[8MGG]Devillance,1826,88,2,7,9,22.2%,1h
47276,3,LeeNR,1826,0,1,1,2,50.0%,16m
47276,3,Tuuracyyy,1826,0,1,2,3,33.3%,37m
47276,3,TeamDom,1826,30,1,5,6,16.7%,1h
47276,2,GrumpBump,1826,48,1,10,11,9.1%,14m
47276,2,[Pharoh]Innkeeper,1826,0,0,1,1,0.0%,1h
47276,3,[NEW]DavidPessoa,1826,0,0,3,3,0.0%,1h
47294,2,Smiley,1825,1531,70,81,151,46.4%,18m
47294,2,bonedoc,1825,1114,46,55,101,45.5%,16m
47294,3,princefaroe,1825,1050,37,42,79,46.8%,45m
47294,3,Obito,1825,705,26,30,56,46.4%,1h
47294,3,Nordy,1825,527,19,29,48,39.6%,37m
47294,3,Rasta,1825,424,15,19,34,44.1%,39m
47294,3,Dannydorito,1825,418,14,24,38,36.8%,3h
47294,1,TheNickles,1825,230,9,22,31,29.0%,52m
47294,3,Carbon,1825,190,6,15,21,28.6%,1h
47294,3,[nieBla]DanUchiha,1825,30,4,4,8,50.0%,1h
47294,3,souldx,1825,0,2,4,6,33.3%,3h
47294,3,bob,1825,0,1,6,7,14.3%,1h
47294,3,Gemeaux,1825,34,1,6,7,14.3%,36m
47294,3,NeumaticFaun,1825,0,0,1,1,0.0%,1h
47294,2,fate,1825,0,0,1,1,0.0%,1h
47294,3,SebastianYT,1825,0,0,1,1,0.0%,37m
47310,3,tomasu,1824,1041,46,47,93,49.5%,39m
47310,3,YASHA,1824,891,35,35,70,50.0%,42m
47310,1,TheJangler,1824,958,26,20,46,56.5%,10m
47310,2,TheDova,1824,469,23,26,49,46.9%,1h
47310,3,LeFouFurieux,1824,292,11,12,23,47.8%,1h
47310,3,Mikey,1824,204,8,8,16,50.0%,3h
47310,1,Chewy,1824,258,6,7,13,46.2%,1h
47310,3,Name,1824,92,6,7,13,46.2%,2h
47310,1,SKARIZARD,1824,0,2,3,5,40.0%,3h
47310,3,ohnoterrans,1824,30,2,6,8,25.0%,42m
47310,2,LUISEAL,1824,44,2,9,11,18.2%,3h
47310,1,Dude,1824,0,2,11,13,15.4%,1h
47310,3,adrianriosL,1824,59,1,7,8,12.5%,29m
47310,1,MrsLeMonsPE,1824,73,1,9,10,10.0%,9m
47310,3,CowPeg,1824,0,0,2,2,0.0%,47m
47325,3,Hunt,1823,942,35,43,78,44.9%,2h
47325,3,Frank,1823,572,19,26,45,42.2%,53m
47325,2,[LBMG]Daddy,1823,550,19,31,50,38.0%,10m
47325,3,Exilus,1823,432,17,18,35,48.6%,60m
47325,3,[2RAW]Samsterix,1823,358,12,23,35,34.3%,1h
47325,3,GoldRoyerD,1823,290,11,16,27,40.7%,1h
47325,3,Inevitable,1823,150,5,8,13,38.5%,1h
47325,3,sans,1823,199,5,13,18,27.8%,3h
47325,2,KungFlu,1823,210,5,16,21,23.8%,1h
47325,1,zzyzx,1823,94,3,0,3,100.0%,3h
47325,3,loser,1823,114,2,7,9,22.2%,3h
47325,1,FootBallon,1823,0,1,0,1,100.0%,13m
47325,2,andres,1823,0,1,1,2,50.0%,14m
47325,2,PREACMUONS,1823,44,1,9,10,10.0%,1h
47325,2,RAFFAST,1823,44,1,10,11,9.1%,1h
47325,1,BIGGIE,1823,0,0,1,1,0.0%,3m
47325,1,[BruC]UncleSam,1823,0,0,1,1,0.0%,1h
47325,3,LiberAsh,1823,0,0,4,4,0.0%,2h
47325,2,[nieBla]Theguardian,1823,0,0,8,8,0.0%,9m
47344,3,Endless,1822,1434,94,116,210,44.8%,1h
47344,3,JAREK,1822,1268,52,53,105,49.5%,5m
47344,3,Ricko,1822,1090,42,53,95,44.2%,42m
47344,2,EmTown,1822,1044,36,53,89,40.4%,3h
47344,3,JorgeMS,1822,943,34,55,89,38.2%,1h
47344,3,ggf,1822,458,16,20,36,44.4%,47m
47344,3,Pyraid,1822,379,13,21,34,38.2%,40m
47344,3,Neptune,1822,312,12,15,27,44.4%,1h
47344,3,Bozo,1822,299,10,12,22,45.5%,1h
47344,3,[kØ]Srpankeke,1822,230,7,8,15,46.7%,56m
47344,2,MAZ,1822,166,7,15,22,31.8%,35m
47344,3,Blade,1822,133,5,4,9,55.6%,47m
47344,2,KodokunaUwU,1822,184,5,13,18,27.8%,31m
47344,3,hondureño,1822,88,3,6,9,33.3%,3h
47344,1,[Curry]DFCooks,1822,0,1,1,2,50.0%,9m
47344,3,Khat,1822,15,1,7,8,12.5%,1h
47344,3,IDK,1822,30,1,7,8,12.5%,14m
47344,3,dekian,1822,30,1,9,10,10.0%,37m
47344,1,[BNK48]zzzawoyzzz,1822,0,0,1,1,0.0%,43m
47344,1,MEGADEATH,1822,0,0,1,1,0.0%,3h
47344,3,BoBoFraggles,1822,0,0,2,2,0.0%,1h
47344,3,educatedelk,1822,0,0,2,2,0.0%,39m
47366,3,Nomu,1821,1506,96,136,232,41.4%,5m
47366,2,lasereyes,1821,1235,66,79,145,45.5%,1h
47366,3,[CADIVI]mardizzio,1821,812,31,34,65,47.7%,3h
47366,2,mad,1821,610,21,38,59,35.6%,35m
47366,3,miguel,1821,289,9,19,28,32.1%,1h
47366,3,Zaxz,1821,137,7,14,21,33.3%,1h
47366,3,Shazza,1821,106,4,9,13,30.8%,13m
47366,3,Sean,1821,105,4,10,14,28.6%,1h
47366,3,[TY4GG]MATHEW,1821,0,2,11,13,15.4%,3h
47366,3,Ves,1821,0,1,1,2,50.0%,28m
47366,3,AstrorianoV,1821,96,1,2,3,33.3%,8m
47366,3,Kilani,1821,0,1,5,6,16.7%,18m
47366,3,Kanaan,1821,0,0,5,5,0.0%,28m
47366,3,Ajdzis,1821,0,0,7,7,0.0%,1h
47366,2,PanaMiguel,1821,0,0,7,7,0.0%,43m
47366,2,TheConnIsOn,1821,0,0,8,8,0.0%,9m
47382,3,VEE,1820,900,33,39,72,45.8%,3h
47382,2,GuacamoleBoi,1820,337,14,27,41,34.1%,3h
47382,2,runitmammal,1820,309,10,23,33,30.3%,31m
47382,2,Helioguy,1820,250,7,18,25,28.0%,3h
47382,2,Neocr,1820,153,3,10,13,23.1%,3h
47382,2,[TPVZ]Braxis,1820,0,1,0,1,100.0%,43m
47382,1,leonardo,1820,0,1,0,1,100.0%,45m
47382,3,andony,1820,96,1,2,3,33.3%,1h
47382,1,bigbear,1820,73,0,5,5,0.0%,39m
47382,3,oRcim,1820,0,0,7,7,0.0%,1h
47382,3,iceman,1820,0,0,8,8,0.0%,21m
47393,3,MASTERIBM,1819,1491,76,88,164,46.3%,1h
47393,3,popote,1819,457,38,43,81,46.9%,1h
47393,3,Cordeiro,1819,742,31,32,63,49.2%,1h
47393,3,[GNSMK]Muckmaker,1819,737,31,37,68,45.6%,1h
47393,2,barcode,1819,709,26,43,69,37.7%,3h
47393,1,tatertheslyr,1819,379,12,9,21,57.1%,3h
47393,3,RobinyoDream,1819,287,10,16,26,38.5%,5m
47393,1,Renfield,1819,419,10,29,39,25.6%,3h
47393,3,Hobbes,1819,266,8,9,17,47.1%,1h
47393,1,Stankalank,1819,138,4,16,20,20.0%,9m
47393,3,Yves,1819,60,2,9,11,18.2%,1h
47393,3,Carmaxian,1819,62,2,10,12,16.7%,13m
47393,1,LastNavySeal,1819,0,1,1,2,50.0%,35m
47393,2,Kragor,1819,0,1,1,2,50.0%,53m
47393,3,[HD7K]KNicolas,1819,95,1,3,4,25.0%,32m
47393,3,BRAYAN,1819,42,1,4,5,20.0%,1h
47393,2,Febreeze,1819,30,1,8,9,11.1%,4m
47393,3,Ultimo,1819,0,0,4,4,0.0%,18m
47393,1,Trevenant,1819,73,0,7,7,0.0%,3h
47393,2,Zim,1819,0,0,8,8,0.0%,1h
47413,2,Advance,1818,1525,186,229,415,44.8%,3h
47413,1,barboza,1818,1298,46,61,107,43.0%,3h
47413,2,juancalito,1818,642,24,31,55,43.6%,39m
47413,1,ANDYVD,1818,642,19,37,56,33.9%,21m
47413,1,Aku,1818,550,15,11,26,57.7%,3h
47413,3,RuberNash,1818,362,13,17,30,43.3%,42m
47413,3,Darksoul,1818,343,12,18,30,40.0%,5m
47413,3,[tCo9]Jeremy,1818,122,4,9,13,30.8%,28m
47413,1,Bishop,1818,0,1,0,1,100.0%,1h
47413,1,Brohannon,1818,0,0,1,1,0.0%,3h
47413,3,[Eklpse]viral,1818,0,0,5,5,0.0%,1h
47424,2,ISAAC,1817,801,174,192,366,47.5%,1h
47424,1,Gravity,1817,1918,66,77,143,46.2%,1h
47424,1,saile,1817,1504,47,56,103,45.6%,34m
47424,3,BRAYAN,1817,678,25,30,55,45.5%,39m
47424,3,PONPEYO,1817,680,24,28,52,46.2%,28m
47424,1,BlanK,1817,906,24,30,54,44.4%,43m
47424,1,Shinobi,1817,807,22,27,49,44.9%,3h
47424,1,Anatolé,1817,610,20,31,51,39.2%,1h
47424,3,CesarJu,1817,200,6,16,22,27.3%,45m
47424,2,[KJ]LittleReaper,1817,102,3,2,5,60.0%,1h
47424,2,darklordhill,1817,140,3,12,15,20.0%,53m
47424,3,LayoverS,1817,62,2,1,3,66.7%,1h
47424,1,Noezu,1817,46,2,1,3,66.7%,48m
47424,1,Oatmeal,1817,42,2,11,13,15.4%,1h
47424,1,mirza,1817,30,1,23,24,4.2%,7m
47424,1,LuisJr,1817,0,0,1,1,0.0%,23m
47424,1,splayhades,1817,0,0,1,1,0.0%,1h
47424,1,Bonitela,1817,0,0,1,1,0.0%,1h
47424,3,VoidxReaper,1817,0,0,2,2,0.0%,1h
47424,3,Archon,1817,0,0,6,6,0.0%,22m
47444,2,[6023]Defiancejr,1816,814,28,43,71,39.4%,3h
47444,3,Clark,1816,713,26,31,57,45.6%,1h
47444,2,Tryns,1816,564,19,26,45,42.2%,36m
47444,3,Tinman,1816,418,17,21,38,44.7%,10m
47444,2,isaactf,1816,502,16,28,44,36.4%,3h
47444,3,KingOfClouds,1816,380,14,22,36,38.9%,16m
47444,1,GreenCat,1816,317,10,7,17,58.8%,3h
47444,3,FSG,1816,311,10,14,24,41.7%,13m
47444,3,juanqv,1816,218,7,5,12,58.3%,1h
47444,1,[ANFA]HyperBeast,1816,186,5,3,8,62.5%,9m
47444,1,ShanTzu,1816,190,5,16,21,23.8%,3h
47444,1,enperador,1816,48,2,1,3,66.7%,24m
47444,1,Dougstyles,1816,0,1,10,11,9.1%,1h
47457,3,tutito,1815,588,19,34,53,35.8%,25m
47457,3,theagency,1815,256,9,15,24,37.5%,47m
47457,3,MannyFresh,1815,238,7,14,21,33.3%,10m
47457,3,[GØ]Rick,1815,121,2,3,5,40.0%,1h
47457,3,bucles,1815,0,1,2,3,33.3%,39m
47457,1,Gerald,1815,44,1,3,4,25.0%,19m
47457,2,rodrigo,1815,0,1,8,9,11.1%,1h
47457,2,shrillimpala,1815,46,1,11,12,8.3%,52m
47457,3,[QCSC]Molly,1815,0,0,2,2,0.0%,1h
47457,3,worm,1815,0,0,7,7,0.0%,1h
47467,3,[diaman]davA,1814,1302,67,62,129,51.9%,1h
47467,3,THEPIPE,1814,530,64,85,149,43.0%,31m
47467,2,Firewall,1814,1033,39,53,92,42.4%,58m
47467,3,spokenbubba,1814,568,20,28,48,41.7%,39m
47467,3,[TSBr2]ShangTsung,1814,383,13,17,30,43.3%,5m
47467,1,Manwe,1814,333,9,9,18,50.0%,1h
47467,3,Daellex,1814,236,8,11,19,42.1%,23m
47467,3,Zook,1814,180,6,12,18,33.3%,27m
47467,3,bubba,1814,74,5,7,12,41.7%,32m
47467,3,Blue,1814,86,3,6,9,33.3%,1h
47467,3,Mycelium,1814,30,2,5,7,28.6%,1h
47467,1,SlowJedi,1814,48,2,12,14,14.3%,13m
47467,3,Haltzman,1814,0,1,0,1,100.0%,49m
47467,2,CatWhisperer,1814,97,1,3,4,25.0%,1h
47467,3,LoHForce,1814,30,1,4,5,20.0%,1h
47467,2,ShaiHulud,1814,30,1,9,10,10.0%,1h
47467,2,Tanker,1814,30,1,9,10,10.0%,3h
47467,2,ugarmig,1814,0,0,10,10,0.0%,1h
47485,3,Prowlus,1813,578,29,32,61,47.5%,14m
47485,1,Nemesis,1813,982,29,40,69,42.0%,48m
47485,3,electrokoto,1813,465,20,29,49,40.8%,56m
47485,1,Tex,1813,306,11,24,35,31.4%,26m
47485,3,Yoda,1813,307,10,13,23,43.5%,8m
47485,3,Tristan,1813,188,7,12,19,36.8%,60m
47485,3,BenRossJC,1813,206,6,5,11,54.5%,16m
47485,1,SweetyLove,1813,126,4,1,5,80.0%,1h
47485,3,Rebelspy,1813,90,3,11,14,21.4%,36m
47485,3,dizzy,1813,60,2,5,7,28.6%,1h
47485,1,[mentir]metrallan,1813,0,1,0,1,100.0%,3h
47485,1,ROGUITE,1813,0,0,2,2,0.0%,3h
47485,1,theimmortal,1813,0,0,5,5,0.0%,1h
47498,1,Bleasus,1812,1590,113,128,241,46.9%,17m
47498,3,skellyp,1812,1516,86,93,179,48.0%,1h
47498,3,KONG,1812,853,68,82,150,45.3%,1h
47498,1,[ETSs]tigro,1812,1130,28,36,64,43.8%,1h
47498,3,LemonEric,1812,710,25,34,59,42.4%,37m
47498,3,fish,1812,324,12,15,27,44.4%,18m
47498,2,hiddenpylon,1812,236,10,7,17,58.8%,3h
47498,1,kuro,1812,254,6,7,13,46.2%,3h
47498,1,Mikert,1812,134,3,4,7,42.9%,13m
47498,3,Fabi,1812,94,3,10,13,23.1%,39m
47498,1,Greed,1812,96,3,13,16,18.8%,1h
47498,3,[XchiX]DarianMarcus,1812,30,2,5,7,28.6%,47m
47498,3,memejr,1812,0,1,1,2,50.0%,29m
47498,2,Hawkeye,1812,88,1,5,6,16.7%,3m
47498,3,OffWhiteOut,1812,30,1,8,9,11.1%,28m
47498,2,gustavmahler,1812,44,1,11,12,8.3%,14m
47498,2,Guinns,1812,0,0,8,8,0.0%,1h
47498,3,Wizzard,1812,0,0,8,8,0.0%,1h
47516,3,LeonHard,1811,766,34,33,67,50.7%,39m
47516,1,mryokanzu,1811,234,8,20,28,28.6%,3h
47516,3,AZNABLE,1811,42,2,7,9,22.2%,1h
47516,2,JOHANSON,1811,30,1,16,17,5.9%,1h
47516,1,Noom,1811,0,0,1,1,0.0%,9m
47516,3,Fatebringer,1811,0,0,2,2,0.0%,22m
47516,3,Rutger,1811,0,0,7,7,0.0%,21m
47523,3,xray,1810,1340,46,57,103,44.7%,3h
47523,3,Kenny,1810,848,45,55,100,45.0%,1h
47523,3,ingarcia,1810,258,21,32,53,39.6%,1h
47523,3,depredador,1810,522,17,22,39,43.6%,1h
47523,3,wolfshadow,1810,444,14,24,38,36.8%,29m
47523,1,HumanButter,1810,497,13,21,34,38.2%,33m
47523,3,PythIllum,1810,124,11,12,23,47.8%,1h
47523,3,[69boyz]billybobBJ,1810,307,9,17,26,34.6%,1h
47523,1,Bowman,1810,158,6,17,23,26.1%,1h
47523,2,llllllllllll,1810,134,4,9,13,30.8%,1h
47523,1,RETROPRO,1810,154,3,9,12,25.0%,9m
47523,3,FrankBob,1810,34,1,7,8,12.5%,48m
47523,1,Bogs,1810,0,0,1,1,0.0%,18m
47523,1,Pipo,1810,0,0,1,1,0.0%,10m
47523,1,Adama,1810,0,0,6,6,0.0%,23m
47538,2,TeNTen,1809,1132,48,72,120,40.0%,1h
47538,3,TAURUS,1809,378,13,14,27,48.1%,1h
47538,1,[Core]Blissfulfeed,1809,492,12,11,23,52.2%,34m
47538,1,AwesomSparky,1809,170,6,3,9,66.7%,3h
47538,3,amazingsax,1809,156,6,7,13,46.2%,1h
47538,3,[DOGT]AlexK,1809,176,4,6,10,40.0%,29m
47538,2,EXORSISTA,1809,0,1,0,1,100.0%,14m
47538,1,Thatguy,1809,46,1,1,2,50.0%,10m
47538,1,[Mstks]JonaxEiki,1809,36,1,13,14,7.1%,3h
47538,3,Victorion,1809,0,0,1,1,0.0%,36m
47538,3,Punisscher,1809,0,0,1,1,0.0%,28m
47538,1,[SCLK]SpiderCap,1809,0,0,2,2,0.0%,1h
47538,2,Kerrigan,1809,0,0,9,9,0.0%,28m
47551,2,insightdata,1808,1443,168,228,396,42.4%,3m
47551,3,[BS1]Augusto,1808,1334,160,220,380,42.1%,1h
47551,3,[EpicG]anakonda,1808,1545,124,151,275,45.1%,8m
47551,3,BigSwede,1808,1439,73,92,165,44.2%,42m
47551,3,ferrer,1808,789,44,59,103,42.7%,1h
47551,3,[4ZKN]BOOT,1808,527,25,29,54,46.3%,1h
47551,3,[GiLLs]Dalton,1808,369,13,12,25,52.0%,3h
47551,1,GusVonCea,1808,324,7,9,16,43.8%,30m
47551,1,Perseus,1808,86,3,3,6,50.0%,11m
47551,3,Squeak,1808,116,2,8,10,20.0%,3h
47551,1,Rock,1808,0,0,1,1,0.0%,9m
47551,1,CHRONOSMAGNU,1808,0,0,1,1,0.0%,1h
47551,1,messiasheres,1808,0,0,1,1,0.0%,9m
47551,1,deliDavid,1808,0,0,2,2,0.0%,1h
47551,3,[sjw]WaterSpirit,1808,0,0,2,2,0.0%,39m
47551,3,DoctorBubble,1808,0,0,3,3,0.0%,3h
47551,3,ElChingon,1808,0,0,4,4,0.0%,1h
47551,2,CappMod,1808,0,0,8,8,0.0%,3h
47551,2,Zniker,1808,0,0,8,8,0.0%,19m
47551,1,Farris,1808,73,0,9,9,0.0%,3h
47571,2,BULGORITE,1807,1433,91,103,194,46.9%,3h
47571,1,carl,1807,1750,70,91,161,43.5%,7m
47571,3,Neminis,1807,1528,62,78,140,44.3%,1h
47571,2,Ajax,1807,1241,44,57,101,43.6%,1h
47571,1,[No0Bs]GDI,1807,325,27,5,32,84.4%,35m
47571,3,cgh,1807,622,24,37,61,39.3%,45m
47571,3,PALERMO,1807,592,23,33,56,41.1%,1h
47571,3,sirorp,1807,568,22,29,51,43.1%,1h
47571,3,ALEXANDR,1807,277,9,7,16,56.2%,3h
47571,3,Joshicus,1807,281,9,19,28,32.1%,39m
47571,1,Hcollas,1807,136,3,2,5,60.0%,10m
47571,3,craneoroto,1807,90,3,10,13,23.1%,3h
47571,3,LUCIFERVONGG,1807,0,0,1,1,0.0%,28m
47571,3,rufus,1807,0,0,4,4,0.0%,39m
47585,3,Draygon,1806,1568,256,310,566,45.2%,3h
47585,3,oseznoraudo,1806,1533,103,132,235,43.8%,1h
47585,3,[CooL10]lemonsfly,1806,1311,78,94,172,45.3%,1h
47585,3,Kuate,1806,593,19,33,52,36.5%,1h
47585,3,Zetruc,1806,417,15,23,38,39.5%,37m
47585,2,SUPREME,1806,380,12,34,46,26.1%,27m
47585,1,UziCaballz,1806,239,9,17,26,34.6%,49m
47585,3,FizzyElf,1806,0,6,23,29,20.7%,1h
47585,3,TheDeliverer,1806,146,5,11,16,31.2%,25m
47585,3,Alchi,1806,94,4,10,14,28.6%,10m
47585,3,Exuminator,1806,90,3,7,10,30.0%,3h
47585,2,Riptorz,1806,48,1,10,11,9.1%,13m
47585,2,JerichoD,1806,0,0,8,8,0.0%,29m
47598,3,CRAFTLIBERTY,1805,1339,92,109,201,45.8%,13m
47598,1,Aleface,1805,1584,84,109,193,43.5%,1h
47598,3,Pilixil,1805,959,58,83,141,41.1%,29m
47598,3,anonimus,1805,541,19,36,55,34.5%,10m
47598,3,GOOMBA,1805,265,15,27,42,35.7%,8m
47598,3,Hersher,1805,238,11,20,31,35.5%,4m
47598,1,ELZERG,1805,293,8,14,22,36.4%,14m
47598,1,[451st]IronGunBlade,1805,276,7,16,23,30.4%,1h
47598,3,monotoplero,1805,120,5,10,15,33.3%,1h
47598,3,DavidofEU,1805,30,3,5,8,37.5%,3h
47598,3,ODIE,1805,32,2,1,3,66.7%,1h
47598,2,esteban,1805,88,2,10,12,16.7%,1h
47598,1,[SCVM]shane,1805,0,1,1,2,50.0%,10m
47598,2,Hunterball,1805,0,0,1,1,0.0%,1h
47612,3,Iejezkel,1804,1131,91,124,215,42.3%,1h
47612,3,orlandonz,1804,1239,54,70,124,43.5%,53m
47612,1,zachary,1804,1099,35,34,69,50.7%,24m
47612,3,[DhZAc1]iGunnyn,1804,375,28,44,72,38.9%,60m
47612,3,Jonrix,1804,442,17,23,40,42.5%,29m
47612,2,arvtor,1804,466,15,32,47,31.9%,25m
47612,2,Harvest,1804,330,11,28,39,28.2%,1h
47612,3,Artery,1804,88,3,6,9,33.3%,1h
47612,3,GNZL,1804,58,3,8,11,27.3%,42m
47612,3,Mantis,1804,90,3,9,12,25.0%,29m
47612,3,Zant,1804,30,2,4,6,33.3%,3m
47612,1,baltex,1804,0,1,0,1,100.0%,34m
47612,1,[ROA1]Steven,1804,0,1,1,2,50.0%,1h
47612,3,STARK,1804,34,1,3,4,25.0%,48m
47612,3,[DomFor]BMWMFLY,1804,0,1,4,5,20.0%,1h
47612,1,ghostdragon,1804,0,0,1,1,0.0%,1h
47612,1,TheKyinKyan,1804,0,0,1,1,0.0%,1h
47612,1,Cabronazo,1804,0,0,2,2,0.0%,3m
47612,1,SaintReagan,1804,73,0,3,3,0.0%,10m
47631,3,UncleDave,1803,1484,129,145,274,47.1%,57m
47631,3,XxmedicxX,1803,1161,87,100,187,46.5%,25m
47631,3,seashepherd,1803,951,39,50,89,43.8%,1h
47631,3,Graff,1803,1134,39,60,99,39.4%,55m
47631,1,[ForgeX]Perseo,1803,639,17,16,33,51.5%,12m
47631,3,bigamer,1803,169,11,14,25,44.0%,3h
47631,3,chris,1803,84,10,19,29,34.5%,1h
47631,3,Loadedfist,1803,120,5,5,10,50.0%,39m
47631,1,Luxemburgo,1803,182,5,5,10,50.0%,39m
47631,1,paolex,1803,235,5,10,15,33.3%,1h
47631,2,ilpumaxd,1803,155,3,9,12,25.0%,1h
47631,2,Necropool,1803,145,3,12,15,20.0%,28m
47631,1,caligreen,1803,46,2,1,3,66.7%,3m
47631,1,Nebulus,1803,46,2,1,3,66.7%,12m
47631,1,[CLTrox]Diaboli,1803,0,1,0,1,100.0%,1h
47631,3,ZazBlack,1803,0,0,4,4,0.0%,3h
47631,3,Clef,1803,0,0,5,5,0.0%,1h
47631,3,Baldur,1803,0,0,6,6,0.0%,3m
47649,3,MisterZed,1802,650,23,31,54,42.6%,1h
47649,1,NUTUMUM,1802,637,17,10,27,63.0%,3h
47649,2,Eziow,1802,333,11,18,29,37.9%,1h
47649,1,Grimra,1802,48,2,2,4,50.0%,34m
47649,2,Loki,1802,94,2,11,13,15.4%,1h
47649,2,[Caza]Seven,1802,0,0,1,1,0.0%,1h
47655,3,iker,1801,1489,116,152,268,43.3%,8m
47655,3,BOTIS,1801,617,115,132,247,46.6%,1h
47655,2,Elíptica,1801,1072,36,55,91,39.6%,36m
47655,3,YaMi,1801,671,28,36,64,43.8%,1h
47655,3,JimBean,1801,109,16,13,29,55.2%,14m
47655,3,Nico,1801,86,7,7,14,50.0%,32m
47655,3,STRAKER,1801,196,6,8,14,42.9%,48m
47655,1,Rich,1801,226,5,5,10,50.0%,59m
47655,3,xAutoX,1801,170,5,8,13,38.5%,29m
47655,1,Reichjanz,1801,193,5,14,19,26.3%,3h
47655,2,CrabJuice,1801,212,5,14,19,26.3%,43m
47655,2,Chief,1801,128,4,7,11,36.4%,9m
47655,2,swootton,1801,92,4,12,16,25.0%,1h
47655,2,JCapa,1801,90,3,13,16,18.8%,1h
47655,3,zergxsiempre,1801,117,2,11,13,15.4%,1h
47655,2,samuelkiller,1801,78,2,12,14,14.3%,5m
47655,1,jeffthekille,1801,0,1,2,3,33.3%,23m
47655,1,FRANCOCALA,1801,102,1,6,7,14.3%,1h
47655,1,sherman,1801,0,0,1,1,0.0%,34m
47655,3,GuiGuiTo,1801,0,0,1,1,0.0%,29m
47655,2,Mark,1801,0,0,9,9,0.0%,3h
47676,2,[BlGDlK]Rolvag,1800,1547,242,268,510,47.5%,51m
47676,3,Sneil,1800,1581,240,264,504,47.6%,13m
47676,3,Gendero,1800,1531,159,205,364,43.7%,3h
47676,1,Xordon,1800,1546,114,133,247,46.2%,21m
47676,3,Cowfarm,1800,1567,109,128,237,46.0%,25m
47676,3,ViZZER,1800,873,35,41,76,46.1%,10m
47676,1,MarcoPNLoco,1800,821,34,32,66,51.5%,49m
47676,3,seru,1800,497,18,21,39,46.2%,6m
47676,1,CHUD,1800,170,7,5,12,58.3%,1h
47676,3,Dell,1800,174,6,11,17,35.3%,8m
47676,1,[PickMe]MOvEJIN,1800,151,4,17,21,19.0%,1h
47676,1,Hussle,1800,130,3,5,8,37.5%,9m
47676,2,Ghost,1800,42,2,4,6,33.3%,1h
47676,1,Spideybih,1800,128,2,5,7,28.6%,1h
47676,2,Norckos,1800,34,2,11,13,15.4%,38m
47676,1,cuervo,1800,44,1,2,3,33.3%,1h
47676,1,[LTlord]Airius,1800,46,1,3,4,25.0%,1h
47676,3,PHI,1800,30,1,4,5,20.0%,3h
47676,1,[VINGAD]cerrado,1800,0,0,1,1,0.0%,10m
47676,3,ishoveling,1800,0,0,3,3,0.0%,3h
47676,2,Artimus,1800,0,0,9,9,0.0%,1m
47697,2,THORAX,1799,1448,130,154,284,45.8%,1h
47697,2,LowDavey,1799,1544,80,100,180,44.4%,3h
47697,3,popperking,1799,1041,61,60,121,50.4%,3h
47697,2,yonga,1799,592,34,58,92,37.0%,35m
47697,3,Petamai,1799,637,24,33,57,42.1%,1h
47697,3,Misa,1799,204,16,23,39,41.0%,3h
47697,3,Fracas,1799,388,14,23,37,37.8%,47m
47697,3,Leandro,1799,406,13,15,28,46.4%,18m
47697,3,Sehguh,1799,249,13,27,40,32.5%,25m
47697,3,AllVoice,1799,330,12,16,28,42.9%,3h
47697,1,Muppet,1799,270,7,6,13,53.8%,1h
47697,1,max,1799,230,7,19,26,26.9%,3h
47697,3,Webbshot,1799,149,5,6,11,45.5%,1h
47697,3,pviktors,1799,203,5,10,15,33.3%,1h
47697,3,OscarOrtiz,1799,60,2,8,10,20.0%,1h
47697,1,Torin,1799,0,1,1,2,50.0%,9m
47697,1,LazaZemun,1799,0,0,1,1,0.0%,1h
47697,3,PirateRoy,1799,0,0,6,6,0.0%,21m
47697,3,LilMexx,1799,0,0,6,6,0.0%,3h
47716,3,OPERATOR,1798,845,31,40,71,43.7%,1h
47716,3,barrstone,1798,484,18,22,40,45.0%,1h
47716,3,PainKiller,1798,367,13,14,27,48.1%,1h
47716,1,Minime,1798,306,8,5,13,61.5%,1h
47716,1,Illlllllllll,1798,180,4,3,7,57.1%,1h
47716,2,mitke,1798,96,2,11,13,15.4%,1h
47716,1,[THDT]ErmaMamaria,1798,42,2,12,14,14.3%,2m
47716,1,JorgeSV,1798,121,1,2,3,33.3%,3h
47716,3,Topgunner,1798,0,1,5,6,16.7%,28m
47716,1,rricolas,1798,0,0,1,1,0.0%,48m
47716,3,MrClarkson,1798,0,0,4,4,0.0%,1h
47716,1,SuperQ,1798,73,0,4,4,0.0%,3h
47716,2,kenMp,1798,0,0,9,9,0.0%,1h
47729,2,Patriot,1797,1482,159,188,347,45.8%,1h
47729,1,TomCat,1797,1792,59,71,130,45.4%,24m
47729,1,Cayde,1797,1539,51,52,103,49.5%,3h
47729,1,[BOUND]Futere,1797,849,22,25,47,46.8%,43m
47729,1,sumandatta,1797,435,17,12,29,58.6%,1h
47729,2,TheXpider,1797,46,1,6,7,14.3%,5m
47729,3,hitoshura,1797,38,1,9,10,10.0%,48m
47729,2,Tempest,1797,48,1,11,12,8.3%,29m
47729,1,[Manci]Manci,1797,0,0,1,1,0.0%,9m
47729,2,angel,1797,0,0,8,8,0.0%,1h
47729,2,Dãturno,1797,0,0,8,8,0.0%,35m
47740,2,Edu,1796,1527,183,216,399,45.9%,1h
47740,2,Jorge,1796,1466,140,162,302,46.4%,35m
47740,3,HughMan,1796,1003,37,46,83,44.6%,1h
47740,1,[TR0L]Virus,1796,48,3,18,21,14.3%,43m
47740,1,Scragglez,1796,94,2,3,5,40.0%,1h
47740,3,MrSparkly,1796,32,2,4,6,33.3%,1h
47740,3,Soysauce,1796,120,2,6,8,25.0%,32m
47740,1,bravojuliet,1796,0,1,0,1,100.0%,1h
47740,3,GalacticKush,1796,0,1,5,6,16.7%,29m
47740,1,MishiMiauu,1796,73,0,2,2,0.0%,34m
47740,3,DeadLive,1796,0,0,8,8,0.0%,1h
47751,1,[AIRBAG]FunglJuggler,1795,1840,55,66,121,45.5%,1h
47751,3,STARPOMP,1795,1132,39,50,89,43.8%,3h
47751,3,pipewelder,1795,836,28,42,70,40.0%,1h
47751,3,HUMBER,1795,502,20,20,40,50.0%,2h
47751,1,SirManolo,1795,678,16,20,36,44.4%,3h
47751,2,JackSolace,1795,206,6,13,19,31.6%,3h
47751,2,Rouphnex,1795,132,4,9,13,30.8%,19m
47751,2,Dyllan,1795,111,3,3,6,50.0%,1h
47751,3,Shiznips,1795,122,2,5,7,28.6%,1h
47751,3,ancientone,1795,30,2,7,9,22.2%,8m
47751,2,jmichel,1795,133,2,10,12,16.7%,60m
47751,3,phoskitos,1795,0,1,3,4,25.0%,37m
47751,3,Frankfoo,1795,30,1,6,7,14.3%,10m
47751,2,Alvaten,1795,0,0,8,8,0.0%,3h
47765,3,CAGY,1794,493,71,84,155,45.8%,3h
47765,2,SDAVJA,1794,400,15,20,35,42.9%,19m
47765,1,Axe,1794,392,10,10,20,50.0%,1h
47765,3,Vandungctqd,1794,220,8,11,19,42.1%,39m
47765,1,rompecolas,1794,188,5,8,13,38.5%,35m
47765,1,Balderdash,1794,36,3,12,15,20.0%,53m
47765,3,Embolizer,1794,128,3,15,18,16.7%,39m
47765,3,Xeerok,1794,66,2,8,10,20.0%,48m
47765,2,MPT,1794,32,2,8,10,20.0%,3h
47765,2,[RSHB]JenkinsIPM,1794,44,1,4,5,20.0%,13m
47765,1,Jang,1794,46,1,9,10,10.0%,1h
47776,2,[Kodos]OttO,1793,1540,106,135,241,44.0%,1h
47776,3,jjelbueno,1793,1043,38,51,89,42.7%,10m
47776,2,Oxvn,1793,57,3,4,7,42.9%,29m
47776,1,Robert,1793,94,2,2,4,50.0%,45m
47776,1,zellencrak,1793,46,1,3,4,25.0%,1h
47776,2,Ejackulate,1793,0,0,7,7,0.0%,19m
47782,3,FERDEFX,1792,826,113,140,253,44.7%,28m
47782,2,Linobel,1792,500,63,80,143,44.1%,35m
47782,3,yonatan,1792,1482,49,75,124,39.5%,45m
47782,3,Jesster,1792,246,12,19,31,38.7%,3h
47782,1,Hignazio,1792,190,5,1,6,83.3%,1h
47782,3,INUYASHA,1792,90,3,9,12,25.0%,53m
47782,1,Luge,1792,86,2,2,4,50.0%,23m
47782,2,SOXENATOR,1792,84,2,5,7,28.6%,3h
47782,2,iRex,1792,58,2,10,12,16.7%,19m
47782,1,kiker,1792,40,1,4,5,20.0%,24m
47782,1,BLVKJAQ,1792,0,1,9,10,10.0%,3h
47782,1,elieio,1792,0,0,1,1,0.0%,3m
47794,3,ricilon,1791,1572,134,175,309,43.4%,1h
47794,3,Boethius,1791,1471,120,147,267,44.9%,3h
47794,3,[DETER]JackOfSpades,1791,570,23,25,48,47.9%,1h
47794,2,StinkyPuddum,1791,371,22,31,53,41.5%,1h
47794,3,CAZADOR,1791,641,21,28,49,42.9%,1h
47794,1,GhostDragon,1791,376,13,24,37,35.1%,1h
47794,1,DramyBABY,1791,44,4,3,7,57.1%,1h
47794,1,Branstyle,1791,122,3,3,6,50.0%,1h
47794,2,Rakem,1791,0,3,6,9,33.3%,51m
47794,3,ACIDImhiv,1791,119,2,3,5,40.0%,1h
47794,1,HAZ,1791,0,1,9,10,10.0%,3h
47794,2,Highmazikeen,1791,0,0,1,1,0.0%,29m
47794,2,Boomerang,1791,0,0,2,2,0.0%,60m
47794,1,[Origns]janpaolo,1791,0,0,2,2,0.0%,3m
47794,1,MasterOfBull,1791,0,0,2,2,0.0%,12m
47794,2,MikeHoncho,1791,0,0,5,5,0.0%,13m
47794,2,DoomCashew,1791,0,0,8,8,0.0%,52m
47794,1,LTGOMEZ,1791,0,0,10,10,0.0%,1h
47812,3,Bonesby,1790,1547,122,143,265,46.0%,1h
47812,2,[MMSTAR]Luke,1790,397,20,38,58,34.5%,44m
47812,2,RansomNote,1790,402,15,42,57,26.3%,27m
47812,2,Drakethos,1790,202,8,17,25,32.0%,3h
47812,2,Heavysitter,1790,252,6,15,21,28.6%,1h
47812,2,Swindler,1790,159,4,5,9,44.4%,1m
47812,1,CesarKing,1790,90,3,2,5,60.0%,3h
47812,3,Sleepy,1790,86,3,10,13,23.1%,3h
47812,3,marshmellow,1790,30,2,6,8,25.0%,1h
47812,1,Cowboy,1790,0,1,2,3,33.3%,1h
47812,3,Mbarete,1790,0,1,2,3,33.3%,37m
47812,1,lightorais,1790,0,0,1,1,0.0%,9m
47812,1,Who,1790,0,0,1,1,0.0%,10m
47812,1,bambam,1790,0,0,2,2,0.0%,55m
47812,3,lucho,1790,0,0,2,2,0.0%,1h
47827,3,zakiro,1789,1037,157,187,344,45.6%,1h
47827,3,luis,1789,1439,72,80,152,47.4%,3h
47827,1,Kocaine,1789,1389,43,47,90,47.8%,3h
47827,3,Javier,1789,384,13,25,38,34.2%,10m
47827,1,Blackflash,1789,126,6,2,8,75.0%,3h
47827,3,Whitey,1789,171,5,6,11,45.5%,14m
47827,1,helinder,1789,72,4,11,15,26.7%,19m
47827,2,MasterKai,1789,92,3,13,16,18.8%,19m
47827,3,ElYorsh,1789,0,1,0,1,100.0%,48m
47827,1,peloto,1789,0,1,0,1,100.0%,9m
47837,3,necronomicon,1788,1268,178,214,392,45.4%,3h
47837,3,Demolidor,1788,1064,74,88,162,45.7%,49m
47837,3,noobmaster,1788,549,29,26,55,52.7%,3h
47837,3,Fher,1788,446,15,29,44,34.1%,28m
47837,1,Eyedea,1788,277,8,19,27,29.6%,12m
47837,1,Daver,1788,278,7,20,27,25.9%,1h
47837,2,Proverbios,1788,236,7,20,27,25.9%,40m
47837,3,Darandomness,1788,0,3,5,8,37.5%,2h
47837,1,miluX,1788,88,2,1,3,66.7%,10m
47837,1,DarkVandal,1788,92,2,2,4,50.0%,9m
47837,3,Geeq,1788,97,2,5,7,28.6%,60m
47837,2,Daddy,1788,62,2,11,13,15.4%,35m
47837,2,elcachero,1788,88,1,1,2,50.0%,1h
47837,3,MIkachuuuu,1788,30,1,6,7,14.3%,3h
47837,2,lobo,1788,88,1,8,9,11.1%,13m
47837,1,[C57640]EvolvedMatt,1788,0,0,1,1,0.0%,48m
47837,1,RaynorII,1788,0,0,2,2,0.0%,48m
47854,3,Caine,1787,1530,112,128,240,46.7%,3h
47854,3,[GTHS]Ramveji,1787,1375,53,62,115,46.1%,1h
47854,3,michymonster,1787,894,31,34,65,47.7%,1h
47854,1,Pufly,1787,916,26,26,52,50.0%,30m
47854,3,AhPuch,1787,552,20,25,45,44.4%,3h
47854,1,[dtwist]DarkVoice,1787,514,17,1,18,94.4%,3h
47854,3,VictorBaez,1787,378,12,20,32,37.5%,10m
47854,2,SEDANIX,1787,403,12,25,37,32.4%,43m
47854,1,bruto,1787,142,3,9,12,25.0%,1h
47854,3,BigBear,1787,97,2,5,7,28.6%,32m
47854,2,[DeeCeS]Tywolf,1787,78,2,12,14,14.3%,1h
47854,3,francescusco,1787,18,1,4,5,20.0%,29m
47854,2,DARSINYIS,1787,46,1,10,11,9.1%,1h
47854,1,[DSGoku]Scream,1787,0,0,1,1,0.0%,14m
47854,3,[RDTN]Robson,1787,0,0,3,3,0.0%,1h
47854,3,[MKQLEA]Hulk,1787,0,0,6,6,0.0%,3h
47870,3,[1944]JazzMan,1786,1532,120,141,261,46.0%,3h
47870,1,WILLOWSERG,1786,1540,44,57,101,43.6%,9m
47870,3,MetalDeamon,1786,802,29,37,66,43.9%,1h
47870,3,TheJossi,1786,599,23,31,54,42.6%,25m
47870,1,kevclang,1786,626,19,15,34,55.9%,43m
47870,1,Naykyd,1786,566,19,41,60,31.7%,1h
47870,1,OLDFattyPC,1786,656,18,14,32,56.2%,1h
47870,1,GoliattDaved,1786,552,14,10,24,58.3%,3h
47870,3,BeckemKong,1786,307,9,17,26,34.6%,1h
47870,1,zeylON,1786,218,5,11,16,31.2%,35m
47870,1,Garm,1786,138,3,8,11,27.3%,43m
47870,3,GeorgeHarris,1786,30,3,8,11,27.3%,1h
47870,1,[XZL]Mantequilla,1786,34,2,1,3,66.7%,1h
47870,1,Kenoi,1786,0,2,3,5,40.0%,48m
47870,3,JoeBurlyBoy,1786,120,2,4,6,33.3%,1h
47870,3,Gabbo,1786,30,2,7,9,22.2%,28m
47870,1,ISSAC,1786,94,1,4,5,20.0%,12m
47870,1,valerio,1786,0,0,1,1,0.0%,1h
47870,2,AlmiranteNC,1786,0,0,3,3,0.0%,38m
47870,2,SYR,1786,0,0,7,7,0.0%,38m
47890,3,koko,1785,223,9,11,20,45.0%,3h
47890,3,uWilwin,1785,251,8,15,23,34.8%,3h
47890,3,[catcat]Matthew,1785,172,5,6,11,45.5%,28m
47890,1,rex,1785,157,5,8,13,38.5%,3h
47890,2,MABA,1785,90,5,9,14,35.7%,3h
47890,2,NachoZ,1785,160,5,13,18,27.8%,33m
47890,3,gothboy,1785,119,3,5,8,37.5%,39m
47890,2,Dipsy,1785,38,2,2,4,50.0%,1h
47890,3,AlbyG,1785,0,0,1,1,0.0%,42m
47899,3,RyLo,1784,1498,86,144,230,37.4%,25m
47899,3,desordures,1784,527,21,24,45,46.7%,28m
47899,3,redPsychosis,1784,376,14,21,35,40.0%,45m
47899,2,ion,1784,336,12,18,30,40.0%,28m
47899,3,Booiby,1784,243,8,12,20,40.0%,28m
47899,3,Tempestß,1784,295,8,18,26,30.8%,29m
47899,3,swederik,1784,160,5,10,15,33.3%,1h
47899,1,Mani,1784,134,3,3,6,50.0%,48m
47899,2,LuckyDucky,1784,140,3,5,8,37.5%,43m
47899,1,arturito,1784,48,2,11,13,15.4%,3h
47899,2,masti,1784,40,1,7,8,12.5%,38m
47910,2,Raynor,1783,1546,159,192,351,45.3%,3h
47910,3,Ruthlesskill,1783,1433,130,153,283,45.9%,30m
47910,3,[JUGOS2]Jahkin,1783,1371,75,89,164,45.7%,1h
47910,3,Ticklemonstr,1783,961,35,55,90,38.9%,57m
47910,3,LilWissykins,1783,596,22,31,53,41.5%,2h
47910,1,Camakazi,1783,446,11,13,24,45.8%,3h
47910,3,spacefrog,1783,290,10,31,41,24.4%,35m
47910,3,SwarmN,1783,199,6,9,15,40.0%,1h
47910,3,seanpiadoso,1783,96,5,5,10,50.0%,49m
47910,1,JOSE,1783,184,5,18,23,21.7%,3h
47910,3,TriAnGle,1783,114,4,9,13,30.8%,1h
47910,3,[Noods]FASTKILLER,1783,60,3,5,8,37.5%,39m
47910,3,[simp34]Mashall,1783,58,2,8,10,20.0%,1h
47910,2,GrimChipmunk,1783,0,1,1,2,50.0%,28m
47910,3,Omnikron,1783,0,1,4,5,20.0%,39m
47910,1,kokidd,1783,0,0,1,1,0.0%,34m
47910,3,Tiago,1783,0,0,7,7,0.0%,3h
47927,3,Ladvrain,1782,1545,202,252,454,44.5%,45m
47927,3,Blumpkin,1782,1481,64,74,138,46.4%,1h
47927,3,vityaz,1782,1393,49,64,113,43.4%,1h
47927,3,Labowski,1782,310,10,12,22,45.5%,1h
47927,3,Sandino,1782,152,5,14,19,26.3%,3h
47927,2,Voidwalker,1782,170,4,14,18,22.2%,1h
47927,1,DeusxD,1782,94,3,4,7,42.9%,3h
47927,2,Impey,1782,132,3,12,15,20.0%,13m
47927,1,DrZ,1782,44,2,3,5,40.0%,30m
47927,3,joelalistar,1782,30,1,2,3,33.3%,42m
47927,3,Wizengamot,1782,30,1,4,5,20.0%,21m
47927,1,gilrum,1782,97,1,6,7,14.3%,4m
47927,1,[ThSky]Scooter,1782,0,0,1,1,0.0%,1h
47940,3,BullitSpeed,1781,1170,234,307,541,43.3%,39m
47940,3,BRAINDRAIN,1781,1539,73,99,172,42.4%,1h
47940,3,SirHugh,1781,794,39,56,95,41.1%,10m
47940,3,Hunter,1781,392,14,26,40,35.0%,16m
47940,1,Oliviam,1781,193,6,17,23,26.1%,18m
47940,1,[ROSC2]DIHmaster,1781,220,5,7,12,41.7%,3h
47940,3,Artorias,1781,30,2,3,5,40.0%,29m
47940,3,JoBeast,1781,30,1,3,4,25.0%,60m
47940,3,Allen,1781,0,0,1,1,0.0%,29m
47940,1,Bigdaddy,1781,0,0,3,3,0.0%,1h
47950,3,Aron,1780,1557,77,87,164,47.0%,48m
47950,1,jaheljan,1780,1471,68,96,164,41.5%,39m
47950,3,iash,1780,911,62,66,128,48.4%,8m
47950,1,MiniNinja,1780,521,27,26,53,50.9%,12m
47950,2,Dragon,1780,621,22,32,54,40.7%,3h
47950,1,hockeyman,1780,704,19,23,42,45.2%,4m
47950,3,Taako,1780,374,14,17,31,45.2%,1h
47950,3,spiboace,1780,233,13,19,32,40.6%,49m
47950,3,Mason,1780,302,10,20,30,33.3%,1h
47950,3,Rideout,1780,284,9,20,29,31.0%,1h
47950,1,adam,1780,405,8,14,22,36.4%,10m
47950,3,[ExcIgN]Lerius,1780,36,1,2,3,33.3%,1h
47950,3,Guilherme,1780,0,0,8,8,0.0%,37m
47963,3,Tristan,1779,1304,50,73,123,40.7%,14m
47963,3,fkill,1779,1200,49,67,116,42.2%,39m
47963,3,[XTLGX]kenshinx,1779,484,22,31,53,41.5%,3h
47963,3,dragon,1779,112,8,12,20,40.0%,57m
47963,3,blackdead,1779,127,3,14,17,17.6%,52m
47963,1,Lego,1779,88,2,3,5,40.0%,1h
47963,1,[TGF456]TonyferLove,1779,113,2,5,7,28.6%,3h
47963,3,euminkong,1779,0,0,5,5,0.0%,1h
47971,3,Galatasaray,1778,504,73,104,177,41.2%,25m
47971,2,[iar]sevenends,1778,1511,71,93,164,43.3%,4m
47971,3,Dragon,1778,1096,60,67,127,47.2%,3h
47971,3,Max,1778,1319,50,68,118,42.4%,29m
47971,3,edchot,1778,735,25,32,57,43.9%,1h
47971,2,[DSTN]entropy,1778,228,8,11,19,42.1%,43m
47971,1,otter,1778,140,6,14,20,30.0%,3h
47971,3,brokenswing,1778,30,1,2,3,33.3%,21m
47971,2,Achild,1778,97,1,10,11,9.1%,1h
47971,2,RedPanda,1778,30,1,11,12,8.3%,3h
47971,3,Eduardo,1778,0,0,1,1,0.0%,1h
47971,1,bobyfarts,1778,73,0,3,3,0.0%,23m
47971,3,Ken,1778,0,0,8,8,0.0%,19m
47984,2,jotaspp,1777,1228,158,188,346,45.7%,28m
47984,1,rAX,1777,1362,94,120,214,43.9%,25m
47984,3,Sulaco,1777,1067,39,52,91,42.9%,39m
47984,3,leewaa,1777,293,9,12,21,42.9%,1h
47984,1,Xander,1777,226,6,6,12,50.0%,1h
47984,1,Autolycus,1777,124,4,3,7,57.1%,18m
47984,3,snaileye,1777,30,2,0,2,100.0%,3h
47984,1,darkkiller,1777,46,2,1,3,66.7%,9m
47984,2,Serath,1777,102,2,3,5,40.0%,43m
47984,1,RanjiroYT,1777,101,2,3,5,40.0%,10m
47984,1,[lLiTl]Paco,1777,46,1,2,3,33.3%,1h
47984,2,[KOSC]KnightHawk,1777,30,1,10,11,9.1%,10m
47984,1,Eclipse,1777,0,0,1,1,0.0%,1h
47984,2,[HERD]PHZ,1777,0,0,2,2,0.0%,1h
47984,3,DJWizard,1777,0,0,2,2,0.0%,3h
47984,3,JACKBLACK,1777,0,0,5,5,0.0%,28m
48000,1,LaRepublica,1776,1788,55,80,135,40.7%,34m
48000,1,macroKing,1776,459,12,10,22,54.5%,35m
48000,1,Bestiaautoma,1776,390,12,17,29,41.4%,3h
48000,2,Nawook,1776,104,2,2,4,50.0%,28m
48000,3,daniel,1776,0,1,0,1,100.0%,17m
48000,3,StyleZ,1776,0,1,6,7,14.3%,1h
48000,1,jibba,1776,108,1,8,9,11.1%,9m
48000,3,Battlesaurus,1776,0,0,3,3,0.0%,3h
48000,2,[Garden]Zevith,1776,0,0,3,3,0.0%,53m
48000,1,FONZ,1776,0,0,5,5,0.0%,48m
48000,2,RIDERACELIVE,1776,0,0,9,9,0.0%,1h
48011,3,[CapP]YZFspeed,1775,1521,116,133,249,46.6%,41m
48011,1,FoxDARK,1775,791,22,23,45,48.9%,23m
48011,3,Isamumu,1775,428,14,25,39,35.9%,48m
48011,2,Maxun,1775,154,5,14,19,26.3%,13m
48011,1,LouCash,1775,96,5,26,31,16.1%,27m
48011,1,[PINGON]zlAlexisGarc,1775,94,3,3,6,50.0%,1h
48011,2,Gamz,1775,126,3,7,10,30.0%,1h
48011,1,BooMSelectA,1775,148,3,13,16,18.8%,1h
48011,3,dilicate,1775,0,1,0,1,100.0%,21m
48011,1,wicho,1775,0,1,2,3,33.3%,23m
48011,2,Geminis,1775,0,0,3,3,0.0%,1h
48022,3,[LOHs]Sleepingiant,1774,1268,55,63,118,46.6%,13m
48022,3,AltunHa,1774,1200,47,53,100,47.0%,18m
48022,1,anonX,1774,870,32,34,66,48.5%,1h
48022,1,[STQ]Bonin,1774,1070,30,46,76,39.5%,1h
48022,1,mbelancon,1774,647,17,32,49,34.7%,1h
48022,1,dantir,1774,216,6,7,13,46.2%,1h
48022,2,Berola,1774,40,4,8,12,33.3%,1h
48022,3,Prometheon,1774,171,4,10,14,28.6%,1h
48022,1,SoftwareMonk,1774,138,3,2,5,60.0%,1h
48022,1,nathyboy,1774,34,1,6,7,14.3%,45m
48022,3,Badger,1774,30,1,8,9,11.1%,45m
48022,1,pickpick,1774,0,0,1,1,0.0%,3h
48022,1,carlosSL,1774,0,0,1,1,0.0%,1h
48022,3,Baldrick,1774,0,0,1,1,0.0%,29m
48022,2,[SPQ]CrisstobalZX,1774,0,0,2,2,0.0%,1h
48022,2,Constantine,1774,0,0,6,6,0.0%,1h
48038,3,MartinSón,1773,745,107,122,229,46.7%,30m
48038,3,Thanh,1773,1481,97,132,229,42.4%,60m
48038,2,Wrathchild,1773,1518,59,64,123,48.0%,52m
48038,3,master,1773,507,36,44,80,45.0%,19m
48038,3,Zeratul,1773,115,9,16,25,36.0%,1h
48038,3,Darkness,1773,276,8,20,28,28.6%,1h
48038,3,pipoclimatic,1773,0,4,9,13,30.8%,3h
48038,3,THEONE,1773,68,3,9,12,25.0%,1h
48038,2,jimpossible,1773,0,2,9,11,18.2%,13m
48038,3,diegoldios,1773,0,1,0,1,100.0%,3h
48038,1,FireballTwin,1773,0,0,1,1,0.0%,49m
48038,1,[IowAPM]Kyle,1773,0,0,1,1,0.0%,34m
48038,1,George,1773,0,0,2,2,0.0%,40m
48038,3,dungflinger,1773,0,0,7,7,0.0%,1h
48052,1,[LifeF]BJR,1772,908,69,82,151,45.7%,27m
48052,3,pergimampus,1772,653,29,50,79,36.7%,57m
48052,2,[57717]Soccontact,1772,353,11,24,35,31.4%,3h
48052,3,luquitas,1772,188,6,12,18,33.3%,45m
48052,2,RaGe,1772,0,2,9,11,18.2%,1h
48052,3,CHAKRASFLOW,1772,0,0,2,2,0.0%,1h
48052,1,[LLDN]Max,1772,0,0,3,3,0.0%,3h
48059,1,DeRamz,1771,1400,38,52,90,42.2%,9m
48059,3,Picard,1771,755,29,33,62,46.8%,3h
48059,1,Ladybug,1771,272,12,21,33,36.4%,3h
48059,3,TheOnes,1771,174,8,20,28,28.6%,1h
48059,1,scynnful,1771,0,1,4,5,20.0%,1h
48059,3,LosBeatsProd,1771,30,1,7,8,12.5%,10m
48059,3,RogueTReese,1771,30,1,7,8,12.5%,1h
48059,1,JacoDaMaco,1771,0,0,1,1,0.0%,19m
48059,3,[SyLx]Ikon,1771,0,0,1,1,0.0%,29m
48059,3,[cluez]wildran,1771,0,0,6,6,0.0%,30m
48059,2,Urgus,1771,0,0,8,8,0.0%,3h
48070,3,Tuanxipo,1770,1499,413,588,1001,41.3%,1h
48070,3,Nelram,1770,1560,189,209,398,47.5%,25m
48070,2,Skeletor,1770,1308,49,77,126,38.9%,25m
48070,3,Booobooobear,1770,730,27,40,67,40.3%,42m
48070,3,Draco,1770,422,14,20,34,41.2%,1h
48070,3,[WoFire]Ttwin,1770,374,13,19,32,40.6%,18m
48070,3,DrCheeks,1770,142,5,5,10,50.0%,22m
48070,2,DontCheeseMe,1770,144,5,7,12,41.7%,1h
48070,1,KuoToa,1770,138,4,8,12,33.3%,34m
48070,1,Colin,1770,88,2,2,4,50.0%,1h
48070,1,SpeyederFang,1770,46,1,2,3,33.3%,1h
48070,3,killaz,1770,30,1,4,5,20.0%,2h
48070,2,[Rataz]Tiranus,1770,0,1,4,5,20.0%,1h
48070,3,SgtMajorBuzz,1770,0,1,12,13,7.7%,26m
48070,1,Comander,1770,0,0,2,2,0.0%,18m
48070,3,xeon,1770,0,0,2,2,0.0%,1h
48070,3,urrax,1770,0,0,5,5,0.0%,21m
48070,1,Pyrowarden,1770,73,0,9,9,0.0%,3h
48088,3,JOACO,1769,1264,54,70,124,43.5%,53m
48088,2,Neo,1769,671,20,39,59,33.9%,35m
48088,1,Capella,1769,376,9,11,20,45.0%,3h
48088,1,nico,1769,382,9,14,23,39.1%,9m
48088,3,[ADM3]ZeroXXI,1769,259,8,19,27,29.6%,10m
48088,1,ZeSimonsen,1769,46,6,1,7,85.7%,1h
48088,3,TJL,1769,30,3,13,16,18.8%,1h
48088,2,crampysito,1769,90,2,4,6,33.3%,1h
48088,2,Rodd,1769,62,2,15,17,11.8%,3h
48088,3,NateDog,1769,0,1,13,14,7.1%,39m
48088,1,felipex,1769,0,0,1,1,0.0%,1h
48088,1,MilanoStar,1769,0,0,2,2,0.0%,3h
48088,1,BrunoCarvs,1769,73,0,8,8,0.0%,3h
48101,3,WarofGodd,1768,1526,67,83,150,44.7%,48m
48101,1,Grifor,1768,1373,39,38,77,50.6%,1h
48101,3,aman,1768,777,25,39,64,39.1%,1h
48101,3,OhRob,1768,362,12,14,26,46.2%,1h
48101,1,edifoo,1768,172,4,5,9,44.4%,48m
48101,1,Midas,1768,0,1,0,1,100.0%,3h
48101,3,rokston,1768,30,1,2,3,33.3%,3h
48101,3,[WLHM]LUCASARR,1768,30,1,3,4,25.0%,1h
48101,1,SilentSword,1768,0,1,11,12,8.3%,1h
48101,1,Justin,1768,0,0,12,12,0.0%,50m
48111,1,gnewby,1767,1825,58,68,126,46.0%,12m
48111,3,KeyMan,1767,641,30,51,81,37.0%,29m
48111,3,Buriel,1767,294,9,23,32,28.1%,6m
48111,1,manin,1767,213,4,6,10,40.0%,1h
48111,3,FIREBIRDMAN,1767,68,4,18,22,18.2%,10m
48111,2,Zoe,1767,60,3,7,10,30.0%,3h
48111,3,SonicBoom,1767,0,1,0,1,100.0%,29m
48111,2,Diesius,1767,0,1,1,2,50.0%,43m
48111,1,Aramil,1767,0,1,1,2,50.0%,1h
48111,1,NumberOne,1767,0,1,1,2,50.0%,1h
48111,1,Zorgonigaain,1767,0,1,1,2,50.0%,35m
48111,3,Thunder,1767,36,1,3,4,25.0%,37m
48111,3,Acid,1767,0,1,5,6,16.7%,49m
48111,1,CardWizz,1767,0,0,1,1,0.0%,10m
48111,1,mayu,1767,0,0,4,4,0.0%,8m
48111,3,Shakuras,1767,0,0,6,6,0.0%,1h
48111,3,alexxxx,1767,0,0,6,6,0.0%,6m
48128,3,alex,1766,1039,106,141,247,42.9%,47m
48128,1,bekele,1766,1961,93,119,212,43.9%,3h
48128,2,happyrogue,1766,1451,85,106,191,44.5%,1h
48128,3,COLoSO,1766,553,51,73,124,41.1%,3h
48128,2,HECtorxd,1766,236,8,13,21,38.1%,3h
48128,3,Temmie,1766,142,4,5,9,44.4%,1h
48128,3,CaptainLuke,1766,0,2,7,9,22.2%,3h
48128,1,darkterran,1766,0,1,0,1,100.0%,10m
48128,3,dillon,1766,0,0,1,1,0.0%,17m
48128,1,CoodGrind,1766,0,0,2,2,0.0%,9m
48138,2,parzival,1765,220,8,13,21,38.1%,28m
48138,1,charr,1765,0,1,4,5,20.0%,9m
48138,3,choibacca,1765,100,1,8,9,11.1%,34m
48138,3,SuperSantos,1765,0,0,4,4,0.0%,29m
48138,1,kyaw,1765,73,0,8,8,0.0%,10m
48143,1,stormbreaker,1764,1303,128,182,310,41.3%,3m
48143,1,llllll,1764,1504,68,74,142,47.9%,1h
48143,3,SolinMarin,1764,434,19,32,51,37.3%,1h
48143,3,Sneezy,1764,347,12,18,30,40.0%,37m
48143,1,[CC34]LuckyOwl,1764,354,8,8,16,50.0%,10m
48143,1,blue,1764,224,7,13,20,35.0%,3h
48143,3,[PAGN]NightStorm,1764,74,2,7,9,22.2%,1h
48143,3,yubario,1764,0,1,0,1,100.0%,49m
48143,3,ZeusEx,1764,72,1,6,7,14.3%,3h
48143,1,ryecatcher,1764,0,0,3,3,0.0%,1h
48153,3,Qaphsiel,1763,1530,61,73,134,45.5%,48m
48153,3,ColForbin,1763,1357,52,54,106,49.1%,30m
48153,1,Maverick,1763,738,22,32,54,40.7%,18m
48153,3,[Apixel]gabriel,1763,309,12,14,26,46.2%,39m
48153,3,nicojamesh,1763,378,12,20,32,37.5%,39m
48153,1,[clow]Guerrero,1763,265,11,15,26,42.3%,9m
48153,3,Zeuries,1763,229,9,11,20,45.0%,53m
48153,2,Max,1763,119,4,14,18,22.2%,14m
48153,1,[DRKESP]Nitro,1763,94,3,4,7,42.9%,10m
48153,1,Mordor,1763,109,2,8,10,20.0%,8m
48153,2,AnoMiA,1763,0,1,0,1,100.0%,1h
48153,2,storms,1763,0,0,8,8,0.0%,13m
48165,2,[Girlll]prettythanU,1762,1382,64,86,150,42.7%,35m
48165,3,ELREX,1762,991,48,51,99,48.5%,1h
48165,3,David,1762,311,11,11,22,50.0%,1h
48165,2,MachoOpresor,1762,176,5,14,19,26.3%,38m
48165,1,NENE,1762,136,4,3,7,57.1%,1h
48165,1,ZARGO,1762,66,4,21,25,16.0%,3h
48165,1,sup,1762,90,2,3,5,40.0%,1h
48165,1,TwEeKs,1762,88,2,4,6,33.3%,1h
48165,1,petergreg,1762,0,1,0,1,100.0%,1h
48165,3,[CBGz]HaPilyInSiDe,1762,0,0,8,8,0.0%,3h
48175,1,itisi,1761,1295,43,46,89,48.3%,9m
48175,1,narra,1761,44,2,4,6,33.3%,12m
48175,1,Supa,1761,0,1,1,2,50.0%,3h
48175,2,Skeksis,1761,0,0,10,10,0.0%,35m
48179,1,Landorus,1760,1261,38,42,80,47.5%,10m
48179,3,marvin,1760,493,23,21,44,52.3%,25m
48179,1,Gérard,1760,640,16,19,35,45.7%,3h
48179,3,tsjjm,1760,290,13,16,29,44.8%,10m
48179,1,josepepe,1760,356,11,24,35,31.4%,38m
48179,1,Gladiator,1760,161,4,4,8,50.0%,3h
48179,2,Bulgogi,1760,46,2,0,2,100.0%,1h
48179,1,[rusmer]adielzamudio,1760,30,2,1,3,66.7%,35m
48179,3,dawgsheit,1760,62,2,7,9,22.2%,3h
48179,2,Gorillamusha,1760,0,1,0,1,100.0%,1h
48179,2,cobrakai,1760,38,1,2,3,33.3%,1h
48179,2,skidipapap,1760,42,1,9,10,10.0%,1h
48179,3,cazor,1760,0,0,1,1,0.0%,43m
48192,3,GoToSleep,1759,1139,76,88,164,46.3%,3h
48192,3,rams,1759,494,21,24,45,46.7%,3h
48192,1,RedQuill,1759,298,7,9,16,43.8%,1h
48192,2,ballin,1759,216,7,18,25,28.0%,22m
48192,1,FLASH,1759,228,5,7,12,41.7%,1h
48192,3,Spytalons,1759,134,5,19,24,20.8%,3h
48192,1,Arahgon,1759,168,4,7,11,36.4%,1h
48192,1,Schlanko,1759,142,2,6,8,25.0%,1h
48192,1,BigMitch,1759,147,2,12,14,14.3%,9m
48192,1,Shadowdragon,1759,0,0,1,1,0.0%,13m
48192,3,Yossarian,1759,0,0,6,6,0.0%,2h
48192,2,zergator,1759,0,0,12,12,0.0%,1h
48204,3,Niebieski,1758,1485,108,117,225,48.0%,1h
48204,1,RoyalBeast,1758,1534,42,56,98,42.9%,12m
48204,1,jules,1758,1402,42,61,103,40.8%,25m
48204,1,Romlunar,1758,770,20,28,48,41.7%,1h
48204,2,Turbulent,1758,457,13,24,37,35.1%,3h
48204,1,DEADLY,1758,374,10,14,24,41.7%,8m
48204,1,Mauruxu,1758,226,6,6,12,50.0%,45m
48204,1,[BlTEL]ElColoro,1758,46,2,1,3,66.7%,10m
48204,2,keanarritos,1758,0,1,2,3,33.3%,9m
48204,1,ShoeBomb,1758,0,1,4,5,20.0%,1h
48204,2,TheSaltLord,1758,30,1,9,10,10.0%,1h
48204,1,[Mony]Kimjiye,1758,0,0,1,1,0.0%,10m
48204,1,BanGzinO,1758,0,0,1,1,0.0%,10m
48204,1,SinkMagician,1758,0,0,2,2,0.0%,10m
48204,2,itzimperial,1758,0,0,3,3,0.0%,1h
48219,1,RICK,1757,1486,42,57,99,42.4%,34m
48219,3,Slavoj,1757,515,17,26,43,39.5%,1h
48219,3,FelipeXos,1757,190,6,7,13,46.2%,1h
48219,1,BlueDream,1757,171,3,11,14,21.4%,1h
48219,1,MarcSanty,1757,44,2,13,15,13.3%,3h
48219,3,jeremiaz,1757,0,1,2,3,33.3%,38m
48219,2,suparedman,1757,0,0,1,1,0.0%,1h
48219,1,soga,1757,0,0,1,1,0.0%,49m
48219,3,Fargus,1757,0,0,1,1,0.0%,50m
48219,3,IgnitedSun,1757,0,0,9,9,0.0%,1h
48219,2,maddogjj,1757,0,0,9,9,0.0%,3h
48219,2,DarkRevan,1757,0,0,10,10,0.0%,1h
48231,3,CITRIXKILLER,1756,1548,147,172,319,46.1%,10m
48231,3,Mono,1756,1326,76,120,196,38.8%,29m
48231,2,Heisenberg,1756,1355,50,76,126,39.7%,1h
48231,2,Azlorn,1756,1266,43,62,105,41.0%,3h
48231,2,twoxa,1756,456,15,34,49,30.6%,3h
48231,1,Dookcase,1756,502,12,22,34,35.3%,1h
48231,3,oldmanpain,1756,221,6,8,14,42.9%,3h
48231,3,BlackBird,1756,120,4,12,16,25.0%,1h
48231,1,NoPulse,1756,46,2,0,2,100.0%,3h
48231,3,Skatobetho,1756,58,2,8,10,20.0%,10m
48231,1,Cowfarm,1756,0,1,1,2,50.0%,1h
48231,1,[ProA]IIIIIIIIIIII,1756,48,1,2,3,33.3%,1h
48231,1,subwaytrain,1756,0,0,1,1,0.0%,9m
48231,3,APMM,1756,0,0,3,3,0.0%,1h
48245,3,Dawsonias,1755,1417,61,88,149,40.9%,3h
48245,1,VladDRACULA,1755,1118,41,59,100,41.0%,3h
48245,3,BooM,1755,275,22,31,53,41.5%,14m
48245,3,Highgluten,1755,240,8,20,28,28.6%,3h
48245,1,[Edwin]embekhocnhe,1755,310,7,9,16,43.8%,11m
48245,1,ARMIN,1755,220,6,6,12,50.0%,1h
48245,3,XaRdOz,1755,0,0,1,1,0.0%,3h
48245,1,Mimoso,1755,0,0,2,2,0.0%,56m
48245,2,beaulasse,1755,0,0,4,4,0.0%,1h
48254,2,liquidmex,1754,358,12,24,36,33.3%,1h
48254,3,Gozems,1754,140,7,17,24,29.2%,1h
48254,3,cannabrito,1754,197,6,7,13,46.2%,8m
48254,2,Wendigo,1754,154,5,14,19,26.3%,36m
48254,2,ImaKILLyoAZZ,1754,140,4,15,19,21.1%,3m
48254,1,zbot,1754,0,1,2,3,33.3%,1h
48254,1,AzureNight,1754,46,1,4,5,20.0%,40m
48254,1,edwinrockq,1754,105,1,9,10,10.0%,9m
48254,3,Ferenz,1754,0,0,7,7,0.0%,28m
48263,3,[DRKDMN]bangranjait,1753,905,37,49,86,43.0%,3h
48263,3,[DogFYR]Olympians,1753,246,8,23,31,25.8%,1h
48263,2,RAGNAR,1753,0,1,6,7,14.3%,13m
48263,3,bababoey,1753,0,0,5,5,0.0%,1h
48263,2,XCENTINELX,1753,0,0,8,8,0.0%,1h
48263,2,DARIOIVAN,1753,0,0,16,16,0.0%,5m
48269,3,Shissou,1752,1181,89,125,214,41.6%,1h
48269,1,kannonc,1752,1774,61,78,139,43.9%,3h
48269,1,Whodaz,1752,1204,41,70,111,36.9%,21m
48269,1,Wasa,1752,590,15,15,30,50.0%,8m
48269,3,[KBL]abcmax,1752,381,14,18,32,43.8%,10m
48269,1,Tajin,1752,324,8,8,16,50.0%,9m
48269,3,KirkSkylark,1752,250,7,13,20,35.0%,25m
48269,1,kobewizard,1752,182,5,18,23,21.7%,13m
48269,3,DOMI,1752,123,4,7,11,36.4%,29m
48269,1,[LaWeaV]MatrixYT,1752,40,1,1,2,50.0%,1h
48269,1,brunao,1752,0,1,1,2,50.0%,3h
48269,1,thorek,1752,46,1,4,5,20.0%,3h
48281,1,Cmd,1751,804,31,40,71,43.7%,20m
48281,3,Nehtur,1751,489,16,24,40,40.0%,14m
48281,3,kodiak,1751,228,8,13,21,38.1%,39m
48281,3,Basilone,1751,152,4,10,14,28.6%,10m
48281,1,VladCanada,1751,88,3,6,9,33.3%,3h
48281,1,Shed,1751,86,2,2,4,50.0%,3h
48281,3,maykel,1751,30,1,6,7,14.3%,13m
48288,1,strikedown,1750,857,25,26,51,49.0%,35m
48288,3,Vanillaheat,1750,414,17,20,37,45.9%,34m
48288,3,WillxWallace,1750,178,6,8,14,42.9%,49m
48288,1,turdmuscular,1750,97,4,8,12,33.3%,59m
48288,3,Cyber,1750,0,2,3,5,40.0%,3h
48288,1,[RisRev]Bisharp,1750,0,1,0,1,100.0%,1h
48288,3,Nesvig,1750,0,0,1,1,0.0%,17m
48288,1,[RwtM]TheReaper,1750,0,0,1,1,0.0%,4m
48288,1,WarAndSin,1750,0,0,1,1,0.0%,1h
48297,1,fluffybanana,1749,706,18,18,36,50.0%,49m
48297,1,shadow,1749,530,12,18,30,40.0%,9m
48297,1,Jusseff,1749,252,7,2,9,77.8%,3h
48297,3,elchuno,1749,116,4,10,14,28.6%,48m
48297,2,FlashCry,1749,110,3,14,17,17.6%,3h
48297,3,Lowride,1749,62,2,8,10,20.0%,38m
48297,2,[EZYtgt]PhotoOp,1749,62,2,13,15,13.3%,3h
48297,1,couchman,1749,0,1,1,2,50.0%,10m
48297,1,FortunerGS,1749,48,1,4,5,20.0%,3h
48297,2,jhimy,1749,30,1,10,11,9.1%,5m
48297,1,christianlee,1749,0,0,1,1,0.0%,3h
48297,1,Sarang,1749,0,0,1,1,0.0%,49m
48297,3,MushroomCake,1749,0,0,3,3,0.0%,1h
48297,3,[Sahk]OutTheWazoo,1749,0,0,9,9,0.0%,1h
48311,2,Brutus,1748,1502,382,538,920,41.5%,16m
48311,3,Bebusfutard,1748,1150,43,56,99,43.4%,13m
48311,3,[GGWolf]Murphy,1748,577,32,44,76,42.1%,1h
48311,1,MightyOwl,1748,436,19,33,52,36.5%,4m
48311,2,Promac,1748,513,19,41,60,31.7%,37m
48311,2,HIKARU,1748,336,18,38,56,32.1%,3h
48311,1,TypeRjunkie,1748,335,10,13,23,43.5%,11m
48311,2,GLHF,1748,226,6,13,19,31.6%,3h
48311,1,GeneralMaxim,1748,136,4,4,8,50.0%,1h
48311,1,gentzger,1748,140,4,5,9,44.4%,1h
48311,3,luis,1748,175,4,13,17,23.5%,1h
48311,2,ThreliSand,1748,60,2,11,13,15.4%,3h
48311,2,Zetiiitah,1748,60,2,12,14,14.3%,1h
48311,1,Abram,1748,0,1,3,4,25.0%,48m
48311,1,Alec,1748,46,1,5,6,16.7%,10m
48311,3,Hellsuponus,1748,0,0,7,7,0.0%,39m
48327,2,MURPHDIZZLE,1747,243,9,8,17,52.9%,1h
48327,1,Ragnar,1747,138,5,4,9,55.6%,11m
48327,2,Legacyplays,1747,202,5,14,19,26.3%,9m
48327,1,[jamon]Merovingian,1747,124,3,7,10,30.0%,3h
48327,1,MrWirds,1747,34,2,15,17,11.8%,34m
48327,3,Justin,1747,0,0,7,7,0.0%,1h
48327,2,Limon,1747,0,0,9,9,0.0%,3h
48334,2,StarCars,1746,1168,555,600,1155,48.1%,1h
48334,1,LilPlanet,1746,1224,58,82,140,41.4%,3h
48334,1,Xavity,1746,409,10,13,23,43.5%,44m
48334,1,[CBAS3]THEDUDE,1746,0,1,0,1,100.0%,59m
48334,1,Tarcman,1746,0,0,3,3,0.0%,3h
48339,1,Sam,1745,1308,64,116,180,35.6%,59m
48339,3,dan,1745,801,38,29,67,56.7%,47m
48339,1,Happynec,1745,737,19,25,44,43.2%,1h
48339,3,GingerSlime,1745,474,16,27,43,37.2%,16m
48339,1,maxterran,1745,516,14,9,23,60.9%,40m
48339,3,Defrag,1745,72,3,3,6,50.0%,1h
48339,1,Warfs,1745,90,3,7,10,30.0%,59m
48339,1,Christmas,1745,0,1,2,3,33.3%,3h
48339,2,Krink,1745,18,1,10,11,9.1%,1h
48339,1,NOSTROMO,1745,0,1,12,13,7.7%,3h
48339,3,toro,1745,0,0,7,7,0.0%,14m
48350,1,enrriquePavo,1744,1600,49,57,106,46.2%,3h
48350,1,DiegoRZ,1744,1221,34,51,85,40.0%,1h
48350,3,Mdbcash,1744,707,27,34,61,44.3%,32m
48350,3,MAKABA,1744,451,20,31,51,39.2%,45m
48350,1,Deaspora,1744,353,8,18,26,30.8%,34m
48350,3,[FatMom]KAMUS,1744,156,6,11,17,35.3%,5m
48350,2,Tabarnakers,1744,212,5,16,21,23.8%,1h
48350,3,Ekelly,1744,102,4,8,12,33.3%,49m
48350,3,aehu,1744,102,3,11,14,21.4%,3h
48350,1,BenjaminJk,1744,145,2,11,13,15.4%,1h
48350,1,MMarshmallow,1744,0,0,1,1,0.0%,14m
48350,1,WildCard,1744,73,0,3,3,0.0%,1h
48350,1,PATROCLO,1744,0,0,4,4,0.0%,48m
48363,1,asdf,1743,1526,419,484,903,46.4%,3h
48363,2,[RomPK3]PACHOXS,1743,612,21,30,51,41.2%,1h
48363,1,ASSASSIN,1743,522,12,22,34,35.3%,12m
48363,2,cafecomleite,1743,281,11,2,13,84.6%,3h
48363,1,Neo,1743,418,11,22,33,33.3%,34m
48363,3,alvaromalca,1743,134,4,9,13,30.8%,47m
48363,1,milieu,1743,46,3,15,18,16.7%,10m
48363,1,Vladi,1743,38,2,0,2,100.0%,1h
48363,3,Ethan,1743,32,2,3,5,40.0%,43m
48363,1,TonyStark,1743,0,1,0,1,100.0%,1h
48363,2,Abaddon,1743,0,1,4,5,20.0%,1h
48363,1,JORgeUZQ,1743,0,0,1,1,0.0%,56m
48363,3,mikrosss,1743,0,0,6,6,0.0%,1h
48376,3,gno,1742,1419,66,74,140,47.1%,1h
48376,3,DOOMZDAY,1742,746,55,58,113,48.7%,1h
48376,3,Nesopun,1742,546,48,52,100,48.0%,1h
48376,1,CHAUCER,1742,784,22,25,47,46.8%,25m
48376,3,xaxisdix,1742,393,13,21,34,38.2%,1h
48376,2,beginner,1742,36,2,1,3,66.7%,1h
48376,1,MiGeneral,1742,0,1,13,14,7.1%,3h
48376,1,[bsnss]Dominus,1742,0,0,2,2,0.0%,1h
48384,2,DRIGO,1741,1414,166,212,378,43.9%,1h
48384,1,SAM,1741,1583,80,133,213,37.6%,48m
48384,3,Neek,1741,618,46,44,90,51.1%,41m
48384,1,Shield,1741,908,25,39,64,39.1%,3h
48384,1,Zepol,1741,664,16,18,34,47.1%,44m
48384,1,Fasco,1741,301,7,8,15,46.7%,1h
48384,3,DGEAR,1741,244,7,10,17,41.2%,1h
48384,1,Husky,1741,164,7,19,26,26.9%,1h
48384,1,buggy,1741,138,3,4,7,42.9%,3m
48384,1,spruce,1741,134,3,7,10,30.0%,1h
48384,3,Riley,1741,15,2,6,8,25.0%,3h
48384,1,bigazer,1741,40,1,3,4,25.0%,14m
48384,2,[zergs5]banit,1741,0,0,1,1,0.0%,3h
48384,2,Pokedes,1741,0,0,1,1,0.0%,1h
48384,2,frumpy,1741,0,0,1,1,0.0%,9m
48384,1,Macc,1741,0,0,2,2,0.0%,1h
48384,1,CALC,1741,0,0,5,5,0.0%,9m
48401,2,mariomaster,1740,1391,95,116,211,45.0%,44m
48401,3,SPARTA,1740,911,37,32,69,53.6%,3h
48401,2,Zerg,1740,405,16,32,48,33.3%,10m
48401,1,debajyoti,1740,428,11,16,27,40.7%,23m
48401,1,Skato,1740,357,11,21,32,34.4%,48m
48401,3,[UAK]Win,1740,322,11,23,34,32.4%,1h
48401,1,DJDSvoodoo,1740,414,10,12,22,45.5%,1h
48401,2,bluedbody,1740,331,10,21,31,32.3%,1h
48401,1,[LcH]DeePShadow,1740,276,6,10,16,37.5%,49m
48401,1,Leon,1740,134,4,11,15,26.7%,1h
48401,3,XxPhoenixX,1740,0,1,1,2,50.0%,37m
48401,1,JERRIK,1740,117,1,3,4,25.0%,9m
48401,1,FritoLay,1740,0,0,1,1,0.0%,23m
48401,1,TheClone,1740,73,0,3,3,0.0%,10m
48415,3,ThrowinRopes,1739,1520,99,129,228,43.4%,18m
48415,3,[KRAFTT]XvXChronoXvX,1739,1421,58,74,132,43.9%,1h
48415,1,TeDeScO,1739,928,30,40,70,42.9%,1h
48415,2,asdaichunli,1739,795,28,52,80,35.0%,1h
48415,1,ZAMBOOIE,1739,829,21,25,46,45.7%,34m
48415,3,ELKANEL,1739,463,20,22,42,47.6%,39m
48415,1,[TRPSC]Crid,1739,292,7,12,19,36.8%,1h
48415,3,TLALOC,1739,42,3,6,9,33.3%,1h
48415,3,Tom,1739,92,3,12,15,20.0%,1h
48415,3,Cavalry,1739,0,1,2,3,33.3%,1h
48415,2,BalderJiri,1739,40,1,11,12,8.3%,3h
48415,3,RoboPooper,1739,0,0,1,1,0.0%,1h
48415,3,Syrel,1739,0,0,1,1,0.0%,1h
48415,1,NguyenAnh,1739,0,0,1,1,0.0%,3h
48415,1,OSO,1739,0,0,2,2,0.0%,9m
48415,3,Gatmandew,1739,0,0,9,9,0.0%,17m
48431,3,MUMark,1738,1523,162,194,356,45.5%,3h
48431,1,Mura,1738,1942,105,133,238,44.1%,1h
48431,3,lobo,1738,1496,96,105,201,47.8%,1h
48431,3,Juve,1738,1484,53,74,127,41.7%,3h
48431,1,qdog,1738,1482,45,48,93,48.4%,1h
48431,3,Gary,1738,901,40,53,93,43.0%,42m
48431,1,Aetroe,1738,736,25,21,46,54.3%,15m
48431,1,Jackster,1738,580,14,16,30,46.7%,45m
48431,1,MisticGame,1738,280,9,19,28,32.1%,4m
48431,3,mmM,1738,58,4,9,13,30.8%,49m
48431,3,Rhin,1738,68,2,9,11,18.2%,3h
48431,1,DigitalCrazy,1738,30,2,14,16,12.5%,1h
48431,3,NSixFour,1738,0,0,1,1,0.0%,1h
48444,1,marioibanez,1737,1720,54,67,121,44.6%,1h
48444,1,Meeqs,1737,663,21,28,49,42.9%,10m
48444,3,TComander,1737,641,20,27,47,42.6%,5m
48444,1,cide,1737,245,7,19,26,26.9%,1h
48444,1,Juno,1737,186,5,5,10,50.0%,3h
48444,3,Nano,1737,30,2,5,7,28.6%,1h
48444,3,DredSero,1737,0,0,7,7,0.0%,3h
48451,3,Bohica,1736,509,65,75,140,46.4%,6m
48451,1,smashen,1736,1890,57,69,126,45.2%,1h
48451,3,Onemanband,1736,637,32,44,76,42.1%,60m
48451,3,InfanteBR,1736,514,18,30,48,37.5%,3h
48451,1,NoMadWolf,1736,170,6,5,11,54.5%,1h
48451,1,[HI3rd]Paimon,1736,177,3,1,4,75.0%,10m
48451,1,JoãoMatador,1736,128,3,3,6,50.0%,60m
48451,1,MOSHE,1736,44,2,2,4,50.0%,10m
48451,3,tortugooo,1736,34,1,3,4,25.0%,1h
48451,1,[028]daviobg,1736,0,0,1,1,0.0%,19m
48451,1,Kirvo,1736,0,0,5,5,0.0%,1h
48462,1,[CHOJON]LaTuWo,1735,761,56,62,118,47.5%,1h
48462,3,Elxim,1735,661,22,30,52,42.3%,5m
48462,1,Atomsck,1735,640,18,22,40,45.0%,3h
48462,1,Highiron,1735,210,10,23,33,30.3%,7m
48462,1,asendedkerri,1735,312,7,11,18,38.9%,3h
48462,3,ColdGlory,1735,192,6,14,20,30.0%,29m
48462,2,DIXTROYER,1735,162,5,18,23,21.7%,1h
48462,1,DAVEDBN,1735,105,3,20,23,13.0%,3h
48462,2,SukMyCrit,1735,0,0,6,6,0.0%,52m
48471,1,TwoPunchMan,1734,1577,49,65,114,43.0%,1h
48471,3,TinyHands,1734,273,29,40,69,42.0%,1h
48471,1,Acem,1734,778,25,21,46,54.3%,1h
48471,3,[Grim3]Sychronolai,1734,222,7,15,22,31.8%,3h
48471,3,mhatys,1734,60,5,9,14,35.7%,32m
48471,3,Manuel,1734,121,3,14,17,17.6%,3h
48471,1,DudeGuy,1734,90,2,7,9,22.2%,44m
48471,1,Taras,1734,92,2,10,12,16.7%,48m
48471,2,kippykip,1734,48,1,1,2,50.0%,52m
48471,3,Rico,1734,0,1,7,8,12.5%,2h
48471,1,indy,1734,88,1,8,9,11.1%,3h
48471,2,BDJD,1734,0,0,1,1,0.0%,1h
48471,1,skate,1734,0,0,1,1,0.0%,48m
48471,1,Capon,1734,73,0,4,4,0.0%,40m
48485,3,sakuragi,1733,748,168,212,380,44.2%,1h
48485,1,Tokydo,1733,361,11,21,32,34.4%,19m
48485,1,Polythemus,1733,466,10,17,27,37.0%,3h
48485,3,BIGDIESEL,1733,365,10,18,28,35.7%,19m
48485,1,Euromix,1733,333,8,14,22,36.4%,19m
48485,1,Kernel,1733,130,4,8,12,33.3%,8m
48485,2,Sergio,1733,0,1,0,1,100.0%,1h
48485,3,[CDO]ibeestalkin,1733,0,0,1,1,0.0%,23m
48485,1,Typhoon,1733,0,0,2,2,0.0%,1h
48485,1,RedMarine,1733,0,0,3,3,0.0%,1h
48495,2,Lobo,1732,1543,196,220,416,47.1%,1h
48495,3,Tito,1732,1478,102,120,222,45.9%,29m
48495,3,Likapichu,1732,470,16,28,44,36.4%,42m
48495,1,Immortelle,1732,399,10,23,33,30.3%,10m
48495,1,Jonas,1732,384,9,17,26,34.6%,60m
48495,2,[MaxWin]livebait,1732,232,7,22,29,24.1%,25m
48495,1,Lcassic,1732,99,2,1,3,66.7%,14m
48495,3,[raaa]UrThysis,1732,0,2,3,5,40.0%,1h
48495,3,Nakon,1732,58,2,10,12,16.7%,23m
48495,2,FaGEight,1732,40,2,11,13,15.4%,1h
48495,1,galvatron,1732,0,1,0,1,100.0%,15m
48495,3,jlmh,1732,0,0,7,7,0.0%,1h
48507,2,Luckner,1731,222,6,15,21,28.6%,1h
48507,1,JonathanGRV,1731,189,5,13,18,27.8%,1h
48507,2,Anas,1731,184,5,13,18,27.8%,1h
48507,3,[nieBla]JECS,1731,86,4,9,13,30.8%,29m
48507,2,Vuljin,1731,30,1,2,3,33.3%,1h
48507,3,hambubger,1731,0,0,1,1,0.0%,1h
48507,2,Maltaman,1731,0,0,2,2,0.0%,1h
48514,3,[0425]geromesteel,1730,1287,100,125,225,44.4%,1h
48514,1,dancer,1730,399,11,15,26,42.3%,23m
48514,3,xFistedHobox,1730,180,5,17,22,22.7%,48m
48514,2,WDGaster,1730,162,3,8,11,27.3%,13m
48514,1,[Bommmm]ProtossStap,1730,94,2,3,5,40.0%,1h
48514,1,HumptyDumpty,1730,0,0,1,1,0.0%,1h
48514,2,CALACUERDA,1730,0,0,2,2,0.0%,1h
48514,3,yazico,1730,0,0,4,4,0.0%,1h
48514,2,Brody,1730,0,0,9,9,0.0%,3h
48523,3,NachosRFrEvr,1729,1531,78,98,176,44.3%,29m
48523,1,Ron,1729,874,24,37,61,39.3%,10m
48523,3,Pit,1729,408,14,24,38,36.8%,11m
48523,3,Mark,1729,273,9,13,22,40.9%,1h
48523,1,DrunkenFoolz,1729,176,4,3,7,57.1%,23m
48523,3,Gemo,1729,60,4,6,10,40.0%,38m
48523,3,BPGLON,1729,128,4,12,16,25.0%,30m
48523,2,gator,1729,116,3,10,13,23.1%,24m
48523,3,solidk,1729,76,2,10,12,16.7%,21m
48523,1,Tomka,1729,96,2,11,13,15.4%,1h
48523,1,ChuckleBean,1729,0,1,1,2,50.0%,3h
48523,1,JORGESANT,1729,0,0,2,2,0.0%,1h
48535,2,Nate,1728,1533,169,194,363,46.6%,36m
48535,3,Sam,1728,1404,76,83,159,47.8%,1h
48535,1,Desolate,1728,1132,30,33,63,47.6%,49m
48535,1,nballs,1728,740,19,21,40,47.5%,10m
48535,1,Bearclaw,1728,416,11,9,20,55.0%,1h
48535,1,Ranchu,1728,153,4,1,5,80.0%,3h
48535,1,CplRock,1728,172,4,3,7,57.1%,10m
48535,1,AlexExecutor,1728,154,4,14,18,22.2%,9m
48535,1,Saiken,1728,94,2,2,4,50.0%,45m
48535,1,SCARFACE,1728,0,0,1,1,0.0%,10m
48545,1,lijil,1727,1317,44,41,85,51.8%,19m
48545,1,JOHN,1727,1322,40,53,93,43.0%,1h
48545,1,Caesss,1727,678,18,22,40,45.0%,31m
48545,3,WiseOne,1727,302,10,20,30,33.3%,5m
48545,1,adrianpro,1727,379,8,18,26,30.8%,3h
48545,1,Superninja,1727,159,5,5,10,50.0%,3h
48545,3,[FASTR]Bio,1727,160,5,6,11,45.5%,1h
48545,1,Stormtrooper,1727,90,2,3,5,40.0%,10m
48545,3,KINGOFNOOBS,1727,122,2,12,14,14.3%,1h
48545,1,poonstank,1727,0,1,4,5,20.0%,4m
48545,2,Foxlain,1727,30,1,10,11,9.1%,1h
48545,2,MarkMactEat,1727,0,0,1,1,0.0%,1h
48545,2,Haxula,1727,0,0,10,10,0.0%,19m
48558,1,dboy,1726,1120,41,41,82,50.0%,4m
48558,1,Zykrus,1726,244,8,10,18,44.4%,1h
48558,3,[papayo]Rod,1726,200,8,18,26,30.8%,3h
48558,3,ryanENDLESS,1726,97,4,5,9,44.4%,29m
48558,1,WhiteAngelNs,1726,143,4,5,9,44.4%,10m
48558,2,[GFUEL]HandiiMan,1726,42,1,4,5,20.0%,1h
48558,1,Danimal,1726,73,0,8,8,0.0%,9m
48565,3,LugerPekman,1725,1008,38,47,85,44.7%,3h
48565,3,CONQUISTADOR,1725,495,20,25,45,44.4%,8m
48565,1,Goose,1725,572,14,21,35,40.0%,10m
48565,1,[CPL7]Andreyiti,1725,351,7,4,11,63.6%,1h
48565,3,ElZorro,1725,60,2,11,13,15.4%,17m
48570,1,XxNAYRxX,1724,910,26,42,68,38.2%,3h
48570,2,Herve,1724,460,14,31,45,31.1%,23m
48570,3,SonMatheus,1724,336,11,24,35,31.4%,16m
48570,1,bigdadtripp,1724,90,3,2,5,60.0%,10m
48570,3,Zach,1724,129,3,17,20,15.0%,1h
48570,1,Zero,1724,40,1,1,2,50.0%,31m
48570,3,ARLO,1724,30,1,4,5,20.0%,40m
48570,1,monkemaster,1724,0,0,1,1,0.0%,1h
48570,1,elpaja,1724,0,0,1,1,0.0%,1h
48579,3,DyLuger,1723,303,48,56,104,46.2%,1h
48579,3,StarLord,1723,418,13,19,32,40.6%,23m
48579,1,Drrobert,1723,278,10,14,24,41.7%,1h
48579,1,Cralos,1723,128,3,10,13,23.1%,48m
48579,3,WhiskeySage,1723,0,0,7,7,0.0%,37m
48579,1,ImDaBoogyman,1723,73,0,10,10,0.0%,10m
48585,2,Inyoka,1722,134,2,12,14,14.3%,44m
48585,1,Candide,1722,48,1,2,3,33.3%,9m
48585,1,AllPlayer,1722,0,0,2,2,0.0%,25m
48588,1,calv,1721,609,19,30,49,38.8%,56m
48588,3,lowma,1721,226,10,18,28,35.7%,49m
48588,1,kingofblades,1721,241,6,9,15,40.0%,12m
48588,3,carbot,1721,163,4,12,16,25.0%,33m
48588,1,CrAzYwAsP,1721,163,3,9,12,25.0%,10m
48588,1,BigBlueFox,1721,73,1,2,3,33.3%,12m
48588,1,WeaponTwo,1721,42,1,2,3,33.3%,9m
48588,3,Flint,1721,30,1,15,16,6.2%,14m
48588,3,Punti,1721,0,0,1,1,0.0%,50m
48588,2,RKPalmerJr,1721,0,0,1,1,0.0%,1h
48598,2,Vincent,1720,574,19,28,47,40.4%,43m
48598,1,Killianpb,1720,632,17,23,40,42.5%,1h
48598,1,Stratex,1720,348,16,10,26,61.5%,1h
48598,1,Xolonot,1720,204,7,6,13,53.8%,15m
48598,3,RunamokMV,1720,98,4,12,16,25.0%,1h
48598,1,BouncyBear,1720,126,4,18,22,18.2%,57m
48598,3,Sirante,1720,58,3,7,10,30.0%,28m
48598,2,Prothatweigh,1720,161,3,12,15,20.0%,1h
48598,1,Poonjz,1720,0,2,4,6,33.3%,1h
48598,3,sdayac,1720,0,0,1,1,0.0%,3h
48598,3,HighestDrumr,1720,0,0,2,2,0.0%,3m
48609,1,ANTONIOGL,1719,1551,51,59,110,46.4%,1h
48609,3,Wolfee,1719,876,27,47,74,36.5%,1h
48609,1,Chilepodrido,1719,770,20,32,52,38.5%,60m
48609,3,DoOrBeDid,1719,580,19,33,52,36.5%,3h
48609,1,Markdat,1719,398,14,11,25,56.0%,36m
48609,1,silent,1719,442,11,15,26,42.3%,1h
48609,3,BenOneWeek,1719,236,9,17,26,34.6%,45m
48609,2,[AnUB]CIRILOPAWER,1719,149,4,4,8,50.0%,1h
48609,1,MetalSlugX,1719,178,4,5,9,44.4%,36m
48609,1,LOBOKAEL,1719,42,2,2,4,50.0%,44m
48609,2,MoMo,1719,60,2,10,12,16.7%,1h
48609,1,bluntmaster,1719,0,0,1,1,0.0%,10m
48609,1,CAM,1719,0,0,5,5,0.0%,1h
48622,3,jockerchef,1718,1068,131,162,293,44.7%,1h
48622,1,Dinamicy,1718,1970,97,130,227,42.7%,31m
48622,3,Mackie,1718,640,21,36,57,36.8%,1h
48622,1,BigBadAzza,1718,304,12,2,14,85.7%,35m
48622,1,MAGICLEGS,1718,310,11,16,27,40.7%,4m
48622,1,soto,1718,0,3,1,4,75.0%,3m
48622,1,Rose,1718,86,2,6,8,25.0%,1h
48622,2,HoodeKing,1718,78,2,11,13,15.4%,1h
48622,1,werrewolf,1718,0,1,0,1,100.0%,1h
48622,3,Leshka,1718,94,1,5,6,16.7%,1h
48622,1,[ELSWOR]TripleAAA,1718,0,0,1,1,0.0%,10m
48633,1,[UAK]FinkHendrick,1717,1902,136,168,304,44.7%,3h
48633,3,[DM1]BAMF,1717,1002,55,68,123,44.7%,13m
48633,1,CrisóTriger,1717,666,20,17,37,54.1%,56m
48633,1,EVILSKY,1717,424,13,28,41,31.7%,1h
48633,3,znarf,1717,404,12,21,33,36.4%,1h
48633,2,[Ohboy]pakiGANG,1717,90,3,10,13,23.1%,35m
48633,2,FaLgXIII,1717,88,3,13,16,18.8%,3h
48633,2,TacoMan,1717,78,2,12,14,14.3%,5m
48633,1,SNOTTY,1717,48,1,8,9,11.1%,1h
48633,1,Jettem,1717,0,0,1,1,0.0%,48m
48633,1,CraftzUwU,1717,0,0,3,3,0.0%,10m
48633,2,Kraull,1717,0,0,9,9,0.0%,3h
48645,1,SpaceKowboy,1716,438,10,21,31,32.3%,14m
48645,3,Edgar,1716,179,7,16,23,30.4%,8m
48645,1,FIH,1716,122,4,15,19,21.1%,1h
48645,1,Shovon,1716,130,3,9,12,25.0%,1h
48645,2,razer,1716,116,3,16,19,15.8%,3h
48645,1,RayBomb,1716,0,1,1,2,50.0%,10m
48645,3,Kevin,1716,0,0,1,1,0.0%,38m
48645,3,[ESRA]Silas,1716,0,0,1,1,0.0%,1h
48653,1,Gini,1715,552,14,16,30,46.7%,3h
48653,1,candycekae,1715,407,10,7,17,58.8%,35m
48653,1,PENDERGRAFT,1715,298,7,10,17,41.2%,1h
48653,1,LSaber,1715,178,4,7,11,36.4%,45m
48653,3,Ursss,1715,0,1,0,1,100.0%,37m
48653,1,[chwing]Rarhkoi,1715,0,1,1,2,50.0%,20m
48653,2,gabowslo,1715,30,1,9,10,10.0%,3h
48653,3,DarkstarX,1715,0,0,9,9,0.0%,21m
48661,3,ELIX,1714,1262,153,188,341,44.9%,3h
48661,1,indomito,1714,1524,56,79,135,41.5%,56m
48661,3,OOOOOOOOOOOO,1714,442,28,61,89,31.5%,29m
48661,3,diggingdirt,1714,307,20,23,43,46.5%,1h
48661,3,apachiheli,1714,420,13,25,38,34.2%,3h
48661,2,Soupy,1714,320,10,22,32,31.2%,3h
48661,1,chris,1714,258,7,10,17,41.2%,1h
48661,3,seatwo,1714,120,2,10,12,16.7%,37m
48661,2,HazeOne,1714,84,2,12,14,14.3%,1h
48670,3,[QSW]Trident,1713,1515,107,144,251,42.6%,1h
48670,3,DevAstor,1713,919,35,44,79,44.3%,30m
48670,3,brentjay,1713,416,14,20,34,41.2%,1h
48670,1,Jaquael,1713,232,12,14,26,46.2%,25m
48670,2,FoeHammer,1713,227,9,10,19,47.4%,1h
48670,1,PlsStop,1713,248,7,9,16,43.8%,10m
48670,3,ArycrackYT,1713,92,6,10,16,37.5%,3h
48670,1,SteelPKO,1713,166,6,19,25,24.0%,1h
48670,2,Oleg,1713,88,3,12,15,20.0%,1h
48670,3,BlackAdder,1713,82,2,11,13,15.4%,1h
48670,1,Anthonito,1713,0,0,5,5,0.0%,10m
48681,3,Beerman,1712,952,74,100,174,42.5%,10m
48681,1,Licanoalfa,1712,1423,44,54,98,44.9%,3h
48681,3,RaithWrath,1712,348,13,27,40,32.5%,1h
48681,1,Plume,1712,350,8,19,27,29.6%,1h
48681,1,Smashum,1712,44,1,1,2,50.0%,14m
48681,1,Black,1712,0,1,6,7,14.3%,1h
48681,3,LorBenja,1712,95,1,11,12,8.3%,2h
48681,3,yeah,1712,0,0,1,1,0.0%,1h
48681,2,Brinate,1712,0,0,7,7,0.0%,1h
48681,2,Capypharaoh,1712,0,0,9,9,0.0%,41m
48691,1,Horridum,1711,474,14,13,27,51.9%,10m
48691,1,zahpkielart,1711,398,9,13,22,40.9%,3h
48691,1,JASTAN,1711,124,3,9,12,25.0%,1h
48691,2,sombra,1711,73,0,2,2,0.0%,1h
48695,3,ChopperDoug,1710,1534,156,187,343,45.5%,1h
48695,3,Alex,1710,1360,71,84,155,45.8%,1h
48695,1,Macdaddy,1710,519,15,30,45,33.3%,48m
48695,3,fhingin,1710,352,13,20,33,39.4%,40m
48695,1,iflykites,1710,479,12,12,24,50.0%,3h
48695,1,[ICTH]lol,1710,260,7,6,13,53.8%,10m
48695,2,[TLABL]Aerisky,1710,228,6,15,21,28.6%,43m
48695,3,KingDerpulus,1710,0,4,2,6,66.7%,21m
48695,1,Warllo,1710,122,4,6,10,40.0%,1h
48695,3,[Eagle1]WhiteEagle,1710,0,1,4,5,20.0%,1h
48695,3,castiel,1710,0,1,4,5,20.0%,3h
48695,2,RADATA,1710,18,1,10,11,9.1%,3h
48707,3,CHUCKNUGGETS,1709,1235,138,151,289,47.8%,34m
48707,3,Jokesonyou,1709,762,29,32,61,47.5%,1h
48707,1,DaPranksta,1709,160,4,5,9,44.4%,49m
48707,1,goku,1709,114,4,8,12,33.3%,3h
48707,1,Wuffkin,1709,168,4,12,16,25.0%,40m
48707,3,adrians,1709,0,1,1,2,50.0%,43m
48707,1,luismencov,1709,0,0,1,1,0.0%,12m
48707,1,BichoMalo,1709,0,0,1,1,0.0%,1h
48707,3,loidster,1709,0,0,2,2,0.0%,1h
48707,1,KingNubious,1709,0,0,3,3,0.0%,1h
48717,2,[4bronz]JJtony,1708,1337,140,187,327,42.8%,5m
48717,3,Sid,1708,1288,71,149,220,32.3%,47m
48717,1,SAGA,1708,1674,67,78,145,46.2%,10m
48717,1,yavaa,1708,1038,30,38,68,44.1%,15m
48717,1,Lisrod,1708,180,6,7,13,46.2%,10m
48717,1,[666ale]alejandro,1708,140,3,9,12,25.0%,1h
48717,1,jerrym,1708,73,1,10,11,9.1%,3h
48724,3,[xDYEx]konkie,1707,1537,360,470,830,43.4%,23m
48724,1,ICEMAN,1707,1931,103,117,220,46.8%,3h
48724,1,Leeness,1707,1049,55,70,125,44.0%,3h
48724,1,MephistoXT,1707,1101,50,53,103,48.5%,1h
48724,1,LEINAD,1707,880,29,31,60,48.3%,3h
48724,1,[HLSPWN]UreDaGrunt,1707,568,20,30,50,40.0%,8m
48724,1,Obleek,1707,604,18,15,33,54.5%,1h
48724,1,renex,1707,549,16,24,40,40.0%,10m
48724,1,scaboo,1707,204,6,5,11,54.5%,23m
48724,1,Leod,1707,0,3,3,6,50.0%,10m
48724,1,Leviathann,1707,84,3,3,6,50.0%,1h
48724,1,Nicolasso,1707,42,2,3,5,40.0%,8m
48724,1,unclefinger,1707,46,1,2,3,33.3%,3m
48724,1,dragonbad,1707,48,1,2,3,33.3%,10m
48724,2,RichNix,1707,42,1,7,8,12.5%,1h
48739,1,frog,1706,1074,31,33,64,48.4%,1h
48739,1,Victor,1706,456,14,15,29,48.3%,12m
48739,3,ArtiC,1706,370,11,24,35,31.4%,34m
48739,3,Voldemort,1706,280,9,20,29,31.0%,45m
48739,1,callmedaddy,1706,248,6,9,15,40.0%,31m
48739,1,Rymond,1706,144,4,2,6,66.7%,34m
48739,1,[INCoI]Kazi,1706,120,4,7,11,36.4%,10m
48739,2,TigerKing,1706,140,4,16,20,20.0%,35m
48739,1,KYonil,1706,44,2,0,2,100.0%,3h
48739,1,Xurating,1706,48,2,1,3,66.7%,1h
48749,1,GerConquista,1705,1793,77,104,181,42.5%,1h
48749,1,glenn,1705,1280,39,54,93,41.9%,10m
48749,2,Kyle,1705,583,29,45,74,39.2%,59m
48749,3,CommanderIan,1705,389,11,18,29,37.9%,3h
48749,1,Gabriel,1705,266,6,20,26,23.1%,1h
48749,1,Javier,1705,124,4,16,20,20.0%,20m
48749,1,TWEELAD,1705,76,2,13,15,13.3%,12m
48749,1,Deatheater,1705,48,1,1,2,50.0%,10m
48749,2,Nino,1705,30,1,9,10,10.0%,11m
48749,1,Nate,1705,0,0,1,1,0.0%,3h
48749,3,MarBear,1705,0,0,1,1,0.0%,49m
48749,3,Alexandros,1705,0,0,5,5,0.0%,1h
48761,1,LastOne,1704,1920,91,104,195,46.7%,3m
48761,1,Rebelpa,1704,1130,36,43,79,45.6%,10m
48761,1,PANDAIUR,1704,1022,30,65,95,31.6%,16m
48761,1,broccolistem,1704,340,12,29,41,29.3%,3h
48761,1,LanesOP,1704,362,9,8,17,52.9%,60m
48761,1,Yoshua,1704,130,7,3,10,70.0%,1h
48761,1,JAQUIVA,1704,182,5,16,21,23.8%,10m
48761,1,kor,1704,187,3,10,13,23.1%,10m
48761,1,Raul,1704,44,1,5,6,16.7%,1h
48761,1,[SkAL]Furfur,1704,0,0,4,4,0.0%,1h
48761,2,tracaja,1704,0,0,13,13,0.0%,3h
48772,3,MiAstErDoOm,1703,158,27,113,140,19.3%,2m
48772,3,DArtaelasesi,1703,219,12,17,29,41.4%,31m
48772,3,fatfucck,1703,186,6,9,15,40.0%,1h
48772,2,MurKy,1703,46,2,19,21,9.5%,3h
48772,1,Darknesshell,1703,46,1,6,7,14.3%,40m
48772,1,hova,1703,73,0,2,2,0.0%,1h
48778,2,DrDoom,1702,1489,152,177,329,46.2%,1h
48778,3,Tim,1702,1100,40,51,91,44.0%,34m
48778,1,whally,1702,622,15,36,51,29.4%,56m
48778,3,Ross,1702,250,9,14,23,39.1%,1h
48778,1,paulomenega,1702,333,8,6,14,57.1%,10m
48778,1,Enea,1702,256,6,15,21,28.6%,48m
48778,1,Pelao,1702,80,2,2,4,50.0%,1h
48778,3,BriterDays,1702,0,1,4,5,20.0%,23m
48786,1,PwrRngr,1701,1945,214,264,478,44.8%,14m
48786,1,baronvonklem,1701,1947,101,127,228,44.3%,1h
48786,3,karlosebenjp,1701,403,11,21,32,34.4%,28m
48786,1,Kuriruna,1701,386,9,17,26,34.6%,15m
48786,1,WILLOW,1701,240,6,8,14,42.9%,10m
48786,1,bubba,1701,226,5,16,21,23.8%,10m
48786,1,[BLT666]wil,1701,118,4,7,11,36.4%,10m
48786,2,boshjurt,1701,91,3,10,13,23.1%,1h
48786,2,ZanyDruid,1701,108,3,13,16,18.8%,1h
48786,3,zappbranigan,1701,0,2,5,7,28.6%,23m
48786,1,[DROM]Espectro,1701,117,1,2,3,33.3%,15m
48786,1,UnlimitedxIQ,1701,0,1,6,7,14.3%,14m
48786,1,EREUSSS,1701,0,0,6,6,0.0%,35m
48799,1,Sundeep,1700,872,41,48,89,46.1%,1h
48799,3,Protoss,1700,449,19,28,47,40.4%,1h
48799,1,Burnett,1700,140,4,18,22,18.2%,3h
48799,1,WHITEBUNNY,1700,78,3,3,6,50.0%,10m
48799,1,[GyD]AsTro,1700,109,2,2,4,50.0%,48m
48799,1,pokota,1700,78,2,5,7,28.6%,1h
48805,1,[PTSF]LouTenantDan,1699,1045,29,37,66,43.9%,3h
48805,1,[PreBc]BCSlug,1699,990,28,37,65,43.1%,10m
48805,1,Player,1699,768,22,26,48,45.8%,36m
48805,2,Erroneous,1699,152,5,13,18,27.8%,60m
48805,1,Abathur,1699,72,3,1,4,75.0%,3h
48805,1,KRIEGER,1699,48,2,0,2,100.0%,40m
48805,1,MurderChapel,1699,44,2,4,6,33.3%,45m
48805,3,DeadlyKitten,1699,30,1,6,7,14.3%,1h
48805,1,[MaxWin]Hardlock,1699,0,0,1,1,0.0%,15m
48814,1,thatguy,1698,1453,69,107,176,39.2%,10m
48814,1,luckywizzard,1698,884,38,53,91,41.8%,3h
48814,1,uncleiroh,1698,568,13,17,30,43.3%,48m
48814,2,[EZDUNK]SMGsFiftyFo,1698,297,9,24,33,27.3%,3h
48814,1,danheb,1698,80,2,8,10,20.0%,23m
48814,1,Dyakrox,1698,36,1,7,8,12.5%,1h
48814,1,SombraMurlo,1698,0,0,2,2,0.0%,15m
48814,3,AkkeSmash,1698,0,0,4,4,0.0%,3h
48822,3,serial,1697,1490,192,241,433,44.3%,1h
48822,1,PapiMario,1697,1932,119,147,266,44.7%,1h
48822,1,[NEDLOG]RobOkhaN,1697,985,26,32,58,44.8%,1h
48822,1,TheKipper,1697,720,19,39,58,32.8%,49m
48822,1,FLORENS,1697,364,8,13,21,38.1%,10m
48822,1,PeePoo,1697,286,7,7,14,50.0%,56m
48822,3,audiochef,1697,92,3,12,15,20.0%,28m
48822,2,Shade,1697,42,1,1,2,50.0%,1h
48822,3,LJBH,1697,30,1,1,2,50.0%,23m
48822,1,[SC2DG]YouTubeEyes,1697,36,1,2,3,33.3%,1h
48822,3,joystic,1697,0,1,7,8,12.5%,15m
48822,1,SpeedyRogue,1697,0,0,2,2,0.0%,1h
48834,1,DIDAK,1696,603,19,26,45,42.2%,3h
48834,1,draxerel,1696,688,17,19,36,47.2%,12m
48834,1,carlosgrosas,1696,446,12,16,28,42.9%,25m
48834,3,Secmantec,1696,47,8,23,31,25.8%,28m
48834,1,Gaston,1696,234,6,10,16,37.5%,1h
48834,3,SODIMIAN,1696,64,4,5,9,44.4%,3m
48834,3,IMkoreanNoob,1696,108,4,12,16,25.0%,3h
48834,1,[SANGRE]bichox,1696,115,3,3,6,50.0%,10m
48834,1,TripleAA,1696,88,2,2,4,50.0%,1h
48834,3,nancho,1696,0,0,1,1,0.0%,43m
48834,3,mattdrums,1696,0,0,2,2,0.0%,1h
48845,3,weiaruyafew,1695,1528,181,315,496,36.5%,10m
48845,3,FrankieChoo,1695,1247,133,236,369,36.0%,10m
48845,3,NDubbz,1695,382,81,97,178,45.5%,1h
48845,1,LdiabloMgMan,1695,222,7,8,15,46.7%,1h
48845,1,Derser,1695,215,6,9,15,40.0%,10m
48845,1,miktasse,1695,132,4,7,11,36.4%,10m
48845,3,Rainbow,1695,0,3,3,6,50.0%,50m
48845,3,Silentstorm,1695,62,3,13,16,18.8%,45m
48845,1,GHOST,1695,46,2,9,11,18.2%,12m
48845,2,[BoBSti]mend,1695,30,1,10,11,9.1%,1h
48845,2,Darklord,1695,0,0,3,3,0.0%,2m
48856,1,Sebastian,1694,1378,52,66,118,44.1%,48m
48856,3,Just,1694,251,18,33,51,35.3%,1h
48856,1,[ORUS]ancesur,1694,470,12,23,35,34.3%,1h
48856,1,strider,1694,94,3,7,10,30.0%,1h
48856,3,yugoo,1694,30,3,17,20,15.0%,41m
48856,1,PhenixGo,1694,34,2,1,3,66.7%,1h
48862,3,WESTFEST,1693,1485,73,89,162,45.1%,3h
48862,1,Xandros,1693,1347,44,51,95,46.3%,49m
48862,2,[TNTCR]relj,1693,340,11,25,36,30.6%,1h
48862,1,[LMI42]huenex,1693,286,7,9,16,43.8%,1h
48862,3,walgrenz,1693,227,6,11,17,35.3%,53m
48862,2,[TMCP]Xavy,1693,148,4,11,15,26.7%,13m
48862,3,Elenril,1693,62,3,4,7,42.9%,3h
48862,1,MAICLAN,1693,140,2,1,3,66.7%,8m
48862,3,Grimbo,1693,0,1,2,3,33.3%,17m
48862,1,angel,1693,30,1,5,6,16.7%,3h
48862,1,Mark,1693,0,1,6,7,14.3%,25m
48873,3,LESTERMAN,1692,1463,181,212,393,46.1%,27m
48873,1,Arturus,1692,120,3,1,4,75.0%,3m
48873,1,noobyMcNoob,1692,88,2,2,4,50.0%,10m
48873,2,Ashkiebear,1692,0,1,0,1,100.0%,13m
48873,3,XxBlxdezxX,1692,0,1,8,9,11.1%,1h
48873,1,ThePrince,1692,0,0,1,1,0.0%,56m
48873,1,crusher,1692,0,0,1,1,0.0%,3h
48873,2,Darkon,1692,0,0,10,10,0.0%,1h
48881,1,Spaceman,1691,485,16,16,32,50.0%,23m
48881,1,lucascraft,1691,428,13,13,26,50.0%,12m
48881,1,maqo,1691,166,4,3,7,57.1%,56m
48881,1,AnonyShrimp,1691,129,4,3,7,57.1%,3h
48881,1,BattleOoze,1691,114,2,7,9,22.2%,10m
48881,3,Fearsum,1691,0,1,4,5,20.0%,1h
48881,1,JersonPQ,1691,0,0,2,2,0.0%,10m
48881,1,supermente,1691,0,0,9,9,0.0%,1h
48889,1,ThaOperator,1690,696,17,26,43,39.5%,1h
48889,1,Alexei,1690,498,13,20,33,39.4%,60m
48889,1,jona,1690,468,11,17,28,39.3%,1h
48889,1,Ragnar,1690,170,5,4,9,55.6%,1h
48889,1,krabman,1690,48,1,3,4,25.0%,10m
48889,1,andrew,1690,0,0,1,1,0.0%,48m
48889,1,[WEWO]WarGhost,1690,0,0,1,1,0.0%,1h
48889,2,Maxpowerz,1690,0,0,1,1,0.0%,1h
48897,2,BaMG,1689,1510,55,82,137,40.1%,3h
48897,1,Zylo,1689,270,7,6,13,53.8%,10m
48897,3,TheBiasPious,1689,97,4,6,10,40.0%,1h
48897,1,Diego,1689,161,3,15,18,16.7%,10m
48897,2,Tobinator,1689,137,2,13,15,13.3%,1h
48897,2,Destructor,1689,42,1,3,4,25.0%,13m
48897,1,Alan,1689,0,0,1,1,0.0%,1h
48897,1,Rezelie,1689,0,0,1,1,0.0%,10m
48897,3,Frostpyrite,1689,0,0,2,2,0.0%,50m
48897,3,BillySlick,1689,0,0,3,3,0.0%,29m
48897,1,JAX,1689,0,0,4,4,0.0%,3h
48908,1,mongo,1688,616,17,17,34,50.0%,49m
48908,1,Cheefa,1688,322,9,12,21,42.9%,12m
48908,1,nublado,1688,248,6,10,16,37.5%,3h
48908,1,KimTaeHyun,1688,0,1,3,4,25.0%,1h
48908,1,ALQUEG,1688,0,1,4,5,20.0%,3h
48913,3,shin,1687,380,36,55,91,39.6%,1h
48913,1,sobrevivient,1687,962,27,43,70,38.6%,3h
48913,3,Sparticus,1687,668,25,41,66,37.9%,1h
48913,1,JonasDeLuna,1687,466,17,32,49,34.7%,3h
48913,1,zmud,1687,549,16,25,41,39.0%,60m
48913,1,ultravox,1687,316,7,15,22,31.8%,31m
48913,1,pppppppppppp,1687,188,3,8,11,27.3%,1h
48913,3,SnOw,1687,0,2,7,9,22.2%,1h
48913,3,whalen,1687,0,0,4,4,0.0%,1h
48922,2,DITO,1686,482,62,96,158,39.2%,1h
48922,1,[LprtsK]Direwolf,1686,1267,43,53,96,44.8%,4m
48922,1,JediKnight,1686,575,14,15,29,48.3%,3h
48922,1,Rossdale,1686,206,6,10,16,37.5%,10m
48922,1,logikk,1686,88,3,2,5,60.0%,3h
48922,1,donald,1686,138,2,6,8,25.0%,10m
48922,1,[lttdh]elhoward,1686,38,1,1,2,50.0%,48m
48922,3,MacunnLive,1686,0,0,3,3,0.0%,1h
48930,3,bhat,1685,586,41,48,89,46.1%,1h
48930,1,leadroga,1685,1309,40,62,102,39.2%,12m
48930,1,crashdiasw,1685,954,26,30,56,46.4%,1h
48930,1,lunatiko,1685,968,24,38,62,38.7%,3h
48930,3,Batman,1685,605,18,42,60,30.0%,1h
48930,1,Nefilim,1685,489,13,17,30,43.3%,4m
48930,1,JBoth,1685,319,8,18,26,30.8%,1h
48930,2,dabir,1685,258,8,18,26,30.8%,11m
48930,1,Jessica,1685,225,7,20,27,25.9%,35m
48930,1,Vaast,1685,0,0,1,1,0.0%,8m
48940,1,Rone,1684,1323,52,68,120,43.3%,25m
48940,1,[Cra2y]rayzerray,1684,798,21,24,45,46.7%,49m
48940,1,SebassiV,1684,394,14,9,23,60.9%,3m
48940,1,digydog,1684,464,12,12,24,50.0%,10m
48940,1,zeratul,1684,274,7,16,23,30.4%,10m
48940,1,Dinocuez,1684,196,6,3,9,66.7%,12m
48940,1,NamedTempo,1684,157,3,4,7,42.9%,3h
48940,1,Aleliv,1684,90,2,2,4,50.0%,12m
48940,1,jerle,1684,42,1,5,6,16.7%,1h
48940,1,[Habil]CARLOS,1684,0,0,2,2,0.0%,3h
48940,1,[TDrkR]Christo,1684,0,0,7,7,0.0%,1h
48951,3,PINOCHET,1683,1194,45,55,100,45.0%,30m
48951,1,raftol,1683,1012,31,31,62,50.0%,1h
48951,1,LaRedPanda,1683,242,7,11,18,38.9%,4m
48951,2,ZERO,1683,140,5,14,19,26.3%,3h
48951,2,dookie,1683,166,4,15,19,21.1%,5m
48951,1,Bubba,1683,48,2,1,3,66.7%,10m
48951,1,Bwomp,1683,0,1,0,1,100.0%,8m
48951,1,Anju,1683,0,0,1,1,0.0%,1h
48951,1,chechon,1683,0,0,7,7,0.0%,10m
48960,1,[PAICHE]DREICO,1682,264,6,13,19,31.6%,1h
48960,2,cambiaformas,1682,114,3,11,14,21.4%,1h
48960,1,Drewski,1682,73,1,2,3,33.3%,10m
48960,1,FACADE,1682,36,1,4,5,20.0%,10m
48960,3,simon,1682,0,1,4,5,20.0%,50m
48960,1,Doodlelini,1682,0,0,6,6,0.0%,1h
48960,2,Survivorr,1682,0,0,9,9,0.0%,3h
48960,2,Ghost,1682,0,0,10,10,0.0%,36m
48968,1,Kane,1681,1436,97,160,257,37.7%,12m
48968,1,MrCrowley,1681,1322,41,51,92,44.6%,1h
48968,1,darkgus,1681,707,18,31,49,36.7%,4m
48968,1,Moops,1681,299,12,13,25,48.0%,12m
48968,1,Ciciri,1681,220,6,5,11,54.5%,3h
48968,1,rainon,1681,158,5,19,24,20.8%,1h
48968,1,wooba,1681,0,0,1,1,0.0%,1h
48968,1,Meluc,1681,0,0,1,1,0.0%,8m
48968,3,[AbcCo]kloctk,1681,0,0,3,3,0.0%,50m
48977,1,breakass,1680,1392,52,66,118,44.1%,3h
48977,3,Acidos,1680,480,17,30,47,36.2%,1h
48977,1,ChaseInvader,1680,477,11,24,35,31.4%,49m
48977,1,Exostryker,1680,253,5,13,18,27.8%,1h
48977,2,Fitz,1680,42,2,11,13,15.4%,15m
48977,3,JOTA,1680,0,0,4,4,0.0%,1h
48977,2,[NOLAN]waffqui,1680,0,0,9,9,0.0%,1h
48984,1,gelato,1679,1767,96,143,239,40.2%,3h
48984,1,AzulXIII,1679,1077,32,40,72,44.4%,10m
48984,3,TheDog,1679,638,31,49,80,38.8%,1h
48984,1,hrdcoregmr,1679,916,23,32,55,41.8%,19m
48984,1,Starlord,1679,336,9,10,19,47.4%,31m
48984,1,KwebekRipper,1679,270,8,10,18,44.4%,40m
48984,1,DRXZblue,1679,226,6,13,19,31.6%,23m
48984,2,slickerd,1679,0,0,7,7,0.0%,3h
48992,1,TheWoz,1678,512,13,22,35,37.1%,3h
48992,1,rodemarck,1678,254,7,8,15,46.7%,36m
48992,1,EnviDRiiFT,1678,180,5,6,11,45.5%,10m
48992,1,BomberMan,1678,136,3,5,8,37.5%,20m
48992,1,[Zil]blanket,1678,0,1,0,1,100.0%,1h
48992,1,Mateus,1678,0,1,6,7,14.3%,10m
48992,2,Verani,1678,0,0,10,10,0.0%,39m
48999,1,cotedivoire,1677,1927,110,147,257,42.8%,34m
48999,1,ghostdragon,1677,1844,103,140,243,42.4%,1h
48999,1,TwelveBravo,1677,957,28,34,62,45.2%,45m
48999,1,orcowarrior,1677,725,26,28,54,48.1%,1h
48999,2,Demo,1677,322,10,20,30,33.3%,3h
48999,1,Aeon,1677,236,9,16,25,36.0%,3h
48999,2,DeathKnight,1677,130,3,14,17,17.6%,1h
48999,1,ski,1677,48,2,0,2,100.0%,15m
48999,2,Duchess,1677,40,2,8,10,20.0%,39m
49008,1,CQC,1676,1869,134,176,310,43.2%,44m
49008,1,SnoopWason,1676,240,7,18,25,28.0%,1h
49008,1,sparkie,1676,268,5,10,15,33.3%,48m
49008,3,Efdron,1676,0,1,1,2,50.0%,28m
49008,1,AurumPred,1676,0,1,4,5,20.0%,45m
49008,1,Seet,1676,0,1,5,6,16.7%,3h
49014,1,BaronVonEvil,1675,1623,79,117,196,40.3%,12m
49014,1,aha,1675,1886,78,138,216,36.1%,1h
49014,3,Albertpia,1675,1351,64,101,165,38.8%,1h
49014,3,Masacre,1675,1423,62,77,139,44.6%,1h
49014,1,jzzz,1675,160,3,3,6,50.0%,15m
49014,2,sico,1675,76,2,12,14,14.3%,1h
49014,1,[Epokhé]Mauro,1675,0,1,0,1,100.0%,1h
49014,1,Alcatrazloco,1675,0,1,1,2,50.0%,1h
49014,1,Qeye,1675,0,1,4,5,20.0%,1h
49014,1,[HALLZ]killhall,1675,0,0,1,1,0.0%,15m
49014,1,YoHindOh,1675,0,0,6,6,0.0%,3h
49025,1,Odachi,1674,527,21,39,60,35.0%,48m
49025,1,DiegoTV,1674,210,5,8,13,38.5%,1h
49025,3,vvv,1674,102,3,1,4,75.0%,1h
49025,2,Anaya,1674,30,3,17,20,15.0%,13m
49025,1,sergio,1674,89,1,3,4,25.0%,35m
49025,1,Xibalt,1674,0,1,5,6,16.7%,3h
49025,3,ghostpants,1674,0,0,2,2,0.0%,1h
49032,3,FRFLPPSmurf,1673,1348,51,66,117,43.6%,3h
49032,2,kirek,1673,1154,39,57,96,40.6%,1h
49032,1,REAPER,1673,1230,35,53,88,39.8%,1h
49032,1,AldoRain,1673,216,8,22,30,26.7%,1h
49032,2,[TPGZ]JakTheRipper,1673,158,5,17,22,22.7%,1h
49032,1,Charybdis,1673,183,3,18,21,14.3%,10m
49032,1,Gfranko,1673,141,2,7,9,22.2%,1h
49032,1,drmoleza,1673,0,0,1,1,0.0%,1h
49032,1,SSSS,1673,0,0,2,2,0.0%,36m
49032,1,SergioSalas,1673,0,0,4,4,0.0%,1h
49032,1,CELJORGE,1673,73,0,10,10,0.0%,1h
49043,1,EpicEric,1672,732,27,30,57,47.4%,10m
49043,1,[HYGame]Harster,1672,914,25,41,66,37.9%,1h
49043,1,QUACK,1672,115,2,5,7,28.6%,40m
49043,2,nolandcc,1672,88,1,5,6,16.7%,52m
49043,2,EDUARDOBL,1672,48,1,14,15,6.7%,5m
49043,1,[SANGRE]elfodayan,1672,0,0,2,2,0.0%,14m
49043,3,Walkinzxz,1672,0,0,6,6,0.0%,1h
49043,1,lui,1672,0,0,6,6,0.0%,35m
49051,1,BurntorangeX,1671,1759,58,70,128,45.3%,3m
49051,1,evertdan,1671,1839,57,73,130,43.8%,10m
49051,3,SouthpawShaw,1671,472,15,40,55,27.3%,30m
49051,1,StarBright,1671,366,9,27,36,25.0%,10m
49051,2,Dodo,1671,167,4,7,11,36.4%,5m
49051,1,Devon,1671,86,3,6,9,33.3%,1h
49051,1,thefrobo,1671,46,1,4,5,20.0%,1h
49051,1,felix,1671,0,0,1,1,0.0%,1h
49051,2,Anders,1671,0,0,4,4,0.0%,52m
49051,3,Brayden,1671,0,0,5,5,0.0%,1h
49061,3,uncleguts,1670,1434,92,122,214,43.0%,19m
49061,1,DIEGOVILLCA,1670,688,19,26,45,42.2%,1h
49061,1,Maverick,1670,247,9,11,20,45.0%,1h
49061,3,Metalpunx,1670,186,6,19,25,24.0%,1h
49061,3,SSjewburner,1670,140,5,6,11,45.5%,37m
49061,1,kaldro,1670,130,4,7,11,36.4%,1h
49061,1,favianovich,1670,168,4,7,11,36.4%,1h
49061,1,Glyphx,1670,150,3,9,12,25.0%,10m
49061,1,Maxpower,1670,32,1,1,2,50.0%,3m
49061,3,[0cool]Leetsteele,1670,0,0,5,5,0.0%,1h
49071,3,itachiuchiha,1669,1431,90,110,200,45.0%,1h
49071,1,CHICOTENATOR,1669,1120,34,44,78,43.6%,3h
49071,1,eldermagic,1669,246,10,8,18,55.6%,12m
49071,1,Cackus,1669,225,4,8,12,33.3%,1h
49071,1,[BBR]RAPHAEL,1669,94,3,4,7,42.9%,44m
49071,2,[Monrom]Fighter,1669,84,2,9,11,18.2%,52m
49071,2,Masterlaval,1669,66,2,13,15,13.3%,8m
49071,1,FlapMagneto,1669,99,1,3,4,25.0%,4m
49071,3,ENIGMAT,1669,0,0,1,1,0.0%,50m
49071,2,xombie,1669,0,0,11,11,0.0%,44m
49081,3,shieksharief,1668,816,37,49,86,43.0%,1h
49081,1,Griff,1668,570,14,15,29,48.3%,8m
49081,1,LION,1668,334,9,16,25,36.0%,48m
49081,1,BUNNsEEDz,1668,260,6,8,14,42.9%,40m
49081,3,paperman,1668,205,5,17,22,22.7%,1h
49081,1,Xonic,1668,73,1,12,13,7.7%,10m
49081,3,MAXTER,1668,0,0,1,1,0.0%,50m
49081,1,Dacapo,1668,0,0,2,2,0.0%,1h
49089,3,PrimeQueef,1667,1518,188,256,444,42.3%,3h
49089,1,Blackout,1667,494,22,28,50,44.0%,12m
49089,1,joxquin,1667,0,0,2,2,0.0%,23m
49092,1,MarineKing,1666,628,17,24,41,41.5%,25m
49092,1,StellarNYT,1666,186,3,3,6,50.0%,1h
49092,1,Roderick,1666,44,1,1,2,50.0%,3m
49092,3,Xander,1666,0,0,4,4,0.0%,1h
49096,3,Deckard,1665,1463,129,160,289,44.6%,16m
49096,1,cheetah,1665,1917,93,112,205,45.4%,48m
49096,1,CreamMyPeter,1665,1332,41,63,104,39.4%,10m
49096,1,Monseki,1665,982,29,43,72,40.3%,10m
49096,1,TERRACOTA,1665,595,24,25,49,49.0%,1h
49096,1,Randy,1665,516,13,25,38,34.2%,10m
49096,1,[ZWUT]Venom,1665,46,2,6,8,25.0%,1h
49096,1,metalslug,1665,0,1,4,5,20.0%,3h
49096,3,Lickpipps,1665,0,0,2,2,0.0%,3m
49096,1,Destroyer,1665,0,0,12,12,0.0%,48m
49106,3,DrRansom,1664,1558,193,236,429,45.0%,6m
49106,1,MaximoDecimo,1664,1554,81,108,189,42.9%,50m
49106,2,ohhhgeez,1664,316,9,22,31,29.0%,11m
49106,2,Eikichi,1664,238,8,14,22,36.4%,1h
49106,1,Lxxso,1664,219,8,15,23,34.8%,1h
49106,1,GasHouseG,1664,263,8,16,24,33.3%,23m
49106,1,JoseResurect,1664,46,2,2,4,50.0%,12m
49106,1,jnpascua,1664,120,2,8,10,20.0%,10m
49106,3,Garnish,1664,30,1,12,13,7.7%,17m
49106,1,juancho,1664,0,0,1,1,0.0%,44m
49106,1,TheErikW,1664,0,0,3,3,0.0%,56m
49117,3,Alphareaver,1663,402,14,27,41,34.1%,3h
49117,3,Curlyoyster,1663,271,8,18,26,30.8%,13m
49117,3,Dankhole,1663,30,3,7,10,30.0%,34m
49117,3,Wheezie,1663,58,2,13,15,13.3%,1h
49117,3,cytoxan,1663,30,1,2,3,33.3%,43m
49117,3,LGsus,1663,0,0,1,1,0.0%,1h
49117,1,Unagi,1663,0,0,5,5,0.0%,10m
49124,2,Fleachi,1662,994,37,72,109,33.9%,15m
49124,1,Victory,1662,46,1,4,5,20.0%,1h
49124,3,NetherendsSC,1662,97,1,8,9,11.1%,3h
49124,1,Tamashi,1662,0,0,1,1,0.0%,10m
49124,3,Juan,1662,0,0,1,1,0.0%,3m
49124,2,Ubbah,1662,0,0,9,9,0.0%,60m
49130,1,SpicedLatte,1661,1076,34,64,98,34.7%,1h
49130,1,duendeverde,1661,210,8,6,14,57.1%,15m
49130,1,DijasFalcon,1661,0,1,0,1,100.0%,1h
49130,1,Strider,1661,0,1,0,1,100.0%,48m
49130,1,xyruo,1661,48,1,2,3,33.3%,48m
49130,1,Gameknight,1661,93,1,8,9,11.1%,3h
49130,2,CALIMBO,1661,46,1,12,13,7.7%,5m
49130,1,DarthAndrexs,1661,0,0,4,4,0.0%,1h
49130,2,Deathstar,1661,0,0,7,7,0.0%,32m
49139,3,[BlTEL]Akasnacker,1660,928,33,46,79,41.8%,32m
49139,1,[RnRFTP]FENDER,1660,321,8,8,16,50.0%,8m
49139,3,[TAW]Major,1660,130,4,3,7,57.1%,1h
49139,1,Alex,1660,172,4,8,12,33.3%,23m
49139,1,Deathstroke,1660,44,2,0,2,100.0%,1h
49139,1,necrodragon,1660,44,1,1,2,50.0%,10m
49139,3,juanyolo,1660,0,0,3,3,0.0%,43m
49139,3,danteTHEfox,1660,0,0,4,4,0.0%,49m
49147,1,IntiRyu,1659,934,26,37,63,41.3%,1h
49147,2,ccc,1659,88,1,3,4,25.0%,44m
49147,2,Juanma,1659,0,0,11,11,0.0%,1h
49150,1,terror,1658,564,17,15,32,53.1%,15m
49150,1,CmteKarma,1658,502,13,20,33,39.4%,10m
49150,1,[MITO22]Mourão,1658,268,6,9,15,40.0%,45m
49150,3,Mrdope,1658,0,0,8,8,0.0%,33m
49150,2,ChopinBlock,1658,0,0,9,9,0.0%,32m
49155,1,mico,1657,1226,52,68,120,43.3%,1h
49155,1,Cyborg,1657,586,14,29,43,32.6%,3h
49155,1,gemini,1657,412,11,8,19,57.9%,1h
49155,1,BackBlaze,1657,214,6,21,27,22.2%,10m
49155,1,[Ccum]Asgall,1657,214,5,11,16,31.2%,1h
49155,1,[KTN]kojiki,1657,191,4,1,5,80.0%,31m
49155,1,VitoSpade,1657,159,2,7,9,22.2%,31m
49155,1,KingTerran,1657,88,1,5,6,16.7%,1h
49155,3,CubanGuy,1657,0,0,7,7,0.0%,6m
49155,2,MELLISO,1657,0,0,9,9,0.0%,1h
49165,1,ELCHAMAN,1656,1020,35,42,77,45.5%,4m
49165,1,WidowMaker,1656,1051,34,52,86,39.5%,25m
49165,1,MichaelMeyer,1656,445,14,18,32,43.8%,4m
49165,1,TreeFiddy,1656,252,8,2,10,80.0%,20m
49165,1,abe,1656,251,6,26,32,18.8%,10m
49165,1,NeonTiger,1656,94,3,4,7,42.9%,3m
49165,1,Enrique,1656,0,1,1,2,50.0%,1h
49165,1,ALEKSANDER,1656,44,1,9,10,10.0%,20m
49173,1,weztozjean,1655,1501,104,134,238,43.7%,44m
49173,1,Momo,1655,1606,52,72,124,41.9%,12m
49173,1,AlexRoVe,1655,1242,45,55,100,45.0%,1h
49173,1,kenshin,1655,556,18,25,43,41.9%,3h
49173,1,Lotus,1655,597,14,22,36,38.9%,1h
49173,1,Paradiso,1655,434,11,18,29,37.9%,34m
49173,2,barista,1655,202,6,18,24,25.0%,30m
49173,3,return,1655,38,1,2,3,33.3%,43m
49181,3,Warrior,1654,1505,202,248,450,44.9%,29m
49181,3,dyif,1654,408,12,39,51,23.5%,19m
49181,1,[GoldPo]TRUEJUSTICE,1654,386,10,15,25,40.0%,1h
49181,1,Xayid,1654,268,6,3,9,66.7%,3h
49181,3,Impact,1654,30,1,6,7,14.3%,34m
49181,1,hotjoetato,1654,44,1,6,7,14.3%,11m
49181,3,Noble,1654,0,0,8,8,0.0%,1h
49188,3,AngusChen,1653,812,30,35,65,46.2%,1h
49188,1,Cienciano,1653,670,18,38,56,32.1%,31m
49188,3,moose,1653,106,16,78,94,17.0%,51m
49188,2,[CRaPaN]IIIIIIIIIIII,1653,156,7,10,17,41.2%,1h
49188,2,Molotov,1653,30,2,11,13,15.4%,3h
49188,1,onecrackpot,1653,0,1,1,2,50.0%,3h
49188,3,sacelloco,1653,0,1,2,3,33.3%,50m
49195,1,jpparra,1652,1114,104,130,234,44.4%,1h
49195,1,zele,1652,573,27,48,75,36.0%,1h
49195,1,Izzy,1652,724,23,26,49,46.9%,10m
49195,1,Jeri,1652,447,10,21,31,32.3%,1h
49195,1,WaterAtTwoAM,1652,226,6,22,28,21.4%,14m
49195,1,paper,1652,182,4,6,10,40.0%,3h
49195,2,warcar,1652,154,4,15,19,21.1%,3h
49195,1,SMP,1652,44,1,3,4,25.0%,23m
49195,1,Destiny,1652,46,1,7,8,12.5%,10m
49195,3,KISACO,1652,0,0,8,8,0.0%,3h
49205,1,[NwAs]MaelG,1651,631,18,21,39,46.2%,44m
49205,1,Nova,1651,233,8,6,14,57.1%,1h
49205,1,codejocky,1651,0,2,3,5,40.0%,36m
49205,1,bblackbeast,1651,44,1,6,7,14.3%,10m
49205,3,Kirt,1651,0,1,8,9,11.1%,50m
49205,1,Freebird,1651,73,0,4,4,0.0%,3h
49205,1,maxijroro,1651,73,0,9,9,0.0%,10m
49212,1,Najoh,1650,1540,62,104,166,37.3%,1h
49212,1,[Bommmm]Freddykawai,1650,1193,37,51,88,42.0%,1h
49212,1,Chum,1650,124,4,4,8,50.0%,1h
49212,1,krywaj,1650,0,0,5,5,0.0%,10m
49216,1,Redialmx,1649,496,12,18,30,40.0%,44m
49216,1,[Batmn]kratoz,1649,0,1,0,1,100.0%,19m
49216,1,Astor,1649,0,0,4,4,0.0%,1h
49216,1,TRESKELION,1649,0,0,5,5,0.0%,31m
49220,3,vegeta,1648,1185,51,63,114,44.7%,3h
49220,1,SilentStorm,1648,972,42,49,91,46.2%,3h
49220,1,PotatoTerran,1648,424,18,10,28,64.3%,3h
49220,1,Frank,1648,550,16,19,35,45.7%,3h
49220,3,PEDRO,1648,456,16,20,36,44.4%,54m
49220,1,carlosfeel,1648,545,14,16,30,46.7%,3h
49220,1,Gustavex,1648,333,7,10,17,41.2%,1h
49220,1,Leo,1648,212,6,4,10,60.0%,45m
49220,1,[Mota12]JCARLON,1648,244,6,11,17,35.3%,1h
49220,3,Boodor,1648,0,1,4,5,20.0%,17m
49220,1,IBLITOXIC,1648,0,0,1,1,0.0%,3h
49231,1,wolfnica,1647,1470,79,116,195,40.5%,23m
49231,1,gonzalo,1647,1843,72,89,161,44.7%,1h
49231,1,Sinbadtravel,1647,832,25,29,54,46.3%,36m
49231,3,coto,1647,208,7,19,26,26.9%,1h
49231,1,[877142]Freefrag,1647,183,6,10,16,37.5%,19m
49231,1,Rances,1647,128,3,10,13,23.1%,1h
49231,3,Vipek,1647,0,1,0,1,100.0%,21m
49231,1,RIPPER,1647,0,0,2,2,0.0%,8m
49239,1,CaptainJack,1646,1237,37,49,86,43.0%,1h
49239,3,NardDog,1646,782,28,43,71,39.4%,1h
49239,1,Next,1646,711,19,24,43,44.2%,3h
49239,3,samuel,1646,94,5,21,26,19.2%,1h
49239,3,LeoTheLich,1646,64,3,9,12,25.0%,3m
49239,1,Bernardo,1646,58,3,17,20,15.0%,1h
49239,3,MatoCinza,1646,64,2,12,14,14.3%,17m
49239,1,Darkninja,1646,0,1,1,2,50.0%,10m
49239,1,[xDYEx]Darkmaster,1646,0,0,1,1,0.0%,15m
49239,1,CapMegatron,1646,0,0,3,3,0.0%,1h
49239,1,MazterMel,1646,0,0,3,3,0.0%,3h
49239,3,Feyling,1646,0,0,10,10,0.0%,1h
49251,1,IIIIIIIIIIII,1645,1200,46,54,100,46.0%,34m
49251,1,Fabius,1645,473,21,27,48,43.8%,1h
49251,1,bobalva,1645,463,14,17,31,45.2%,14m
49251,1,Roma,1645,450,11,24,35,31.4%,1h
49251,3,TheBranman,1645,381,11,30,41,26.8%,30m
49251,1,Zephyr,1645,244,8,24,32,25.0%,3h
49251,2,estargos,1645,218,5,16,21,23.8%,5m
49251,1,silentstorm,1645,153,4,3,7,57.1%,10m
49251,1,Avoye,1645,168,4,6,10,40.0%,1h
49251,1,[ManleT]Aretos,1645,0,1,0,1,100.0%,36m
49251,3,ZALADIN,1645,0,1,3,4,25.0%,50m
49251,3,[MEP]Zoomami,1645,30,1,4,5,20.0%,1h
49251,2,Axiom,1645,0,0,10,10,0.0%,30m
49264,1,Juddthejuice,1644,1410,44,42,86,51.2%,10m
49264,1,jklaguana,1644,590,14,24,38,36.8%,12m
49264,1,cpalominoc,1644,468,12,27,39,30.8%,3h
49264,1,[NePe]Tatascan,1644,144,4,3,7,57.1%,10m
49264,3,Highdro,1644,30,1,3,4,25.0%,23m
49269,1,Dante,1643,1865,62,93,155,40.0%,10m
49269,3,Ariano,1643,459,16,35,51,31.4%,5m
49269,1,SantiagoG,1643,490,12,13,25,48.0%,1h
49269,1,SAIXONE,1643,239,5,15,20,25.0%,10m
49269,3,Snurffe,1643,96,3,6,9,33.3%,46m
49269,1,[MSLF]Skarner,1643,48,1,11,12,8.3%,8m
49269,2,NICK,1643,0,0,10,10,0.0%,15m
49269,1,Mrbehe,1643,0,0,11,11,0.0%,12m
49277,3,Jackgammon,1642,1494,128,155,283,45.2%,3h
49277,3,soulless,1642,755,29,50,79,36.7%,39m
49277,1,Bitkruked,1642,857,28,48,76,36.8%,10m
49277,2,eMaL,1642,490,14,45,59,23.7%,1h
49277,1,Whittaker,1642,451,10,26,36,27.8%,10m
49277,1,Harry,1642,92,3,4,7,42.9%,4m
49277,1,Keifer,1642,147,2,6,8,25.0%,1h
49277,1,ALI,1642,48,2,6,8,25.0%,1h
49277,1,Adonis,1642,44,1,7,8,12.5%,1h
49286,1,hafthedamday,1641,1516,71,88,159,44.7%,1h
49286,3,JohnIrish,1641,853,28,43,71,39.4%,17m
49286,1,Kilgore,1641,666,17,29,46,37.0%,34m
49286,1,BossJacob,1641,92,4,18,22,18.2%,19m
49286,1,DaitanFuteki,1641,44,1,2,3,33.3%,31m
49286,3,Nukeinyrarea,1641,0,0,1,1,0.0%,49m
49286,2,TNT,1641,0,0,10,10,0.0%,52m
49293,3,Thor,1640,1536,127,178,305,41.6%,1h
49293,1,CMAE,1640,412,12,10,22,54.5%,1h
49293,1,CommanderK,1640,0,3,5,8,37.5%,10m
49293,1,Link,1640,32,1,5,6,16.7%,10m
49293,3,TomG,1640,0,0,2,2,0.0%,30m
49293,2,GORGONA,1640,0,0,3,3,0.0%,1h
49299,3,WickyWoo,1639,1440,74,96,170,43.5%,1h
49299,1,BREAKBOY,1639,1017,31,41,72,43.1%,1h
49299,1,yeahmonkay,1639,782,20,26,46,43.5%,3h
49299,1,EsCuDeRo,1639,571,16,25,41,39.0%,10m
49299,1,Dom,1639,198,5,6,11,45.5%,10m
49299,2,Admiral,1639,62,2,12,14,14.3%,10m
49299,1,Javierpincay,1639,46,1,1,2,50.0%,50m
49299,3,Zephyr,1639,0,0,5,5,0.0%,29m
49307,3,Phoenix,1638,1430,80,99,179,44.7%,1h
49307,1,BrianO,1638,657,32,38,70,45.7%,1h
49307,1,Kai,1638,428,12,28,40,30.0%,12m
49307,2,Richnicka,1638,94,3,14,17,17.6%,37m
49307,3,JoylessAphid,1638,0,0,9,9,0.0%,33m
49312,1,NorthNomad,1637,304,7,15,22,31.8%,1h
49312,1,[TheCum]WpgLego,1637,112,2,12,14,14.3%,3h
49312,1,Monsieur,1637,0,0,1,1,0.0%,45m
49315,1,PREDATOR,1636,1884,109,139,248,44.0%,1h
49315,1,[6o4]fertilewalru,1636,222,5,11,16,31.2%,4m
49315,2,Richard,1636,128,4,17,21,19.0%,1h
49315,2,kyaw,1636,92,3,21,24,12.5%,1h
49315,1,Cptmoonfish,1636,42,1,4,5,20.0%,1h
49320,1,[LAT18]Artaris,1635,1816,68,99,167,40.7%,20m
49320,3,Lostpunisher,1635,92,5,11,16,31.2%,37m
49320,1,Krieger,1635,175,4,6,10,40.0%,1h
49320,1,[DEVXGG]Ðevx,1635,73,3,6,9,33.3%,14m
49320,3,Kowalski,1635,0,1,6,7,14.3%,4m
49320,3,[PoolEx]Mestrie,1635,0,0,2,2,0.0%,1h
49326,3,GardianBravo,1634,568,19,36,55,34.5%,3h
49326,1,DeeperCookie,1634,183,4,7,11,36.4%,10m
49326,1,Joshskater,1634,182,4,15,19,21.1%,1h
49326,2,Belle,1634,86,3,18,21,14.3%,1h
49326,1,Magus,1634,88,2,3,5,40.0%,1h
49326,3,Redz,1634,62,2,5,7,28.6%,49m
49326,3,[AIURxT]Luisekas,1634,97,2,9,11,18.2%,33m
49326,2,Frams,1634,44,1,12,13,7.7%,1h
49326,1,CanisLupus,1634,0,0,1,1,0.0%,10m
49326,1,starlord,1634,0,0,1,1,0.0%,1h
49326,3,NachtDoom,1634,0,0,1,1,0.0%,23m
49326,1,ZackAttack,1634,0,0,5,5,0.0%,10m
49338,3,Manuel,1633,650,68,99,167,40.7%,1h
49338,1,wandidarxx,1633,724,25,33,58,43.1%,1h
49338,1,Archangel,1633,450,15,19,34,44.1%,1h
49338,1,Dreekuz,1633,343,13,24,37,35.1%,36m
49338,1,Sleepy,1633,256,12,14,26,46.2%,1h
49338,1,Chizen,1633,290,9,31,40,22.5%,58m
49338,1,Dante,1633,337,7,9,16,43.8%,1h
49338,3,ZeruX,1633,181,7,11,18,38.9%,1h
49338,1,yerdad,1633,236,6,20,26,23.1%,12m
49338,1,Hecken,1633,118,5,17,22,22.7%,12m
49338,1,Blakey,1633,0,1,1,2,50.0%,3h
49338,1,bernman,1633,46,1,2,3,33.3%,19m
49338,3,RawStick,1633,0,0,4,4,0.0%,50m
49351,3,[SalvA]geo,1632,882,32,45,77,41.6%,26m
49351,1,[space3]Fantasma,1632,460,14,9,23,60.9%,3h
49351,1,Maynard,1632,256,6,9,15,40.0%,48m
49351,1,James,1632,254,6,10,16,37.5%,1h
49351,1,Guns,1632,164,3,14,17,17.6%,3h
49351,3,Qiqe,1632,72,2,6,8,25.0%,30m
49351,3,ImperialWGmr,1632,30,2,6,8,25.0%,38m
49351,2,turdherder,1632,76,2,14,16,12.5%,1h
49351,1,AlastorHdz,1632,38,1,3,4,25.0%,31m
49351,1,BadAss,1632,46,1,5,6,16.7%,10m
49361,1,[hz21]KARL,1631,1883,125,168,293,42.7%,34m
49361,1,SwankyOrc,1631,1461,43,56,99,43.4%,40m
49361,1,Spunupfool,1631,1080,29,55,84,34.5%,1h
49361,1,memecanon,1631,632,20,28,48,41.7%,44m
49361,1,JONGSOO,1631,544,15,14,29,51.7%,1h
49361,1,OgamiItto,1631,125,5,7,12,41.7%,34m
49361,2,SenatorBry,1631,96,3,14,17,17.6%,60m
49368,1,[KhanZ]Omarstar,1630,472,14,22,36,38.9%,3h
49368,1,[YUCK]Bogey,1630,38,1,2,3,33.3%,1h
49368,1,[UxL]KingTJ,1630,0,0,1,1,0.0%,4m
49368,1,LeoCWBr,1630,73,0,10,10,0.0%,10m
49372,1,Diego,1629,1862,106,148,254,41.7%,1h
49372,1,sweetloo,1629,706,18,32,50,36.0%,10m
49372,1,mike,1629,316,9,14,23,39.1%,4m
49372,1,Gaucher,1629,164,6,10,16,37.5%,10m
49372,2,Karen,1629,137,4,2,6,66.7%,3h
49372,3,modigadi,1629,0,2,6,8,25.0%,3h
49372,3,pagoda,1629,0,1,5,6,16.7%,1h
49372,3,sariel,1629,0,0,2,2,0.0%,37m
49372,1,lugge,1629,73,0,5,5,0.0%,10m
49381,1,Reaver,1628,1170,47,62,109,43.1%,14m
49381,1,roan,1628,712,21,23,44,47.7%,10m
49381,1,Lucky,1628,0,1,7,8,12.5%,56m
49384,2,arduino,1627,1060,35,58,93,37.6%,44m
49384,1,DonComedia,1627,645,17,41,58,29.3%,1h
49384,1,cristianproX,1627,385,13,16,29,44.8%,10m
49384,1,DaghoBrazil,1627,494,12,28,40,30.0%,1h
49384,3,DoSomething,1627,230,8,25,33,24.2%,3h
49384,1,[3pro5u]Andresaurio,1627,297,7,12,19,36.8%,1h
49384,1,SnakEyes,1627,286,6,20,26,23.1%,1h
49384,1,gapsk,1627,90,3,5,8,37.5%,1h
49384,1,[FALF]Kabeer,1627,0,1,2,3,33.3%,3h
49384,3,chillhop,1627,0,1,5,6,16.7%,23m
49384,1,Monteclinto,1627,0,1,5,6,16.7%,10m
49384,1,BLazyRah,1627,109,1,6,7,14.3%,3h
49384,1,Bunchypanic,1627,0,0,2,2,0.0%,3m
49384,2,TheJester,1627,0,0,6,6,0.0%,5m
49398,1,WarLeiff,1626,562,14,25,39,35.9%,3h
49398,1,predalien,1626,422,10,16,26,38.5%,1h
49398,1,RAUL,1626,233,5,7,12,41.7%,3h
49398,1,jorgepro,1626,0,1,1,2,50.0%,1h
49398,1,ALEXANDER,1626,0,1,1,2,50.0%,50m
49403,1,DONEMILIO,1625,875,31,42,73,42.5%,25m
49403,2,LILBITS,1625,424,13,25,38,34.2%,44m
49403,1,ShadowStorm,1625,97,1,9,10,10.0%,1h
49403,3,Crackback,1625,0,0,1,1,0.0%,23m
49403,1,manalishi,1625,0,0,2,2,0.0%,11m
49403,1,Nomad,1625,73,0,7,7,0.0%,60m
49403,1,Martin,1625,73,0,12,12,0.0%,10m
49410,1,[BRARSC]BrownCyborg,1624,600,15,28,43,34.9%,40m
49410,1,Legbone,1624,32,2,1,3,66.7%,1h
49410,2,invacion,1624,0,0,5,5,0.0%,1h
49410,2,Holliday,1624,0,0,11,11,0.0%,1h
49414,1,WARLEY,1623,734,20,26,46,43.5%,10m
49414,1,Raflitz,1623,179,8,1,9,88.9%,3h
49414,1,arajo,1623,128,3,11,14,21.4%,20m
49414,1,DCrabb,1623,86,2,4,6,33.3%,34m
49414,1,Stremenx,1623,167,2,14,16,12.5%,10m
49414,1,bomba,1623,0,1,3,4,25.0%,12m
49414,3,tothemax,1623,30,1,9,10,10.0%,1h
49414,3,Yuriz,1623,0,0,4,4,0.0%,1h
49422,1,papagoico,1622,1828,129,155,284,45.4%,10m
49422,3,DaARC,1622,1203,48,59,107,44.9%,1h
49422,1,mrstoner,1622,234,6,12,18,33.3%,1h
49422,3,[TRUMPP]Farrox,1622,130,6,24,30,20.0%,3h
49422,3,Gilgamesh,1622,58,3,6,9,33.3%,50m
49422,1,[4SG]Avalon,1622,0,0,1,1,0.0%,10m
49422,3,[SCARIO]LowClee,1622,0,0,1,1,0.0%,21m
49422,2,oscar,1622,0,0,3,3,0.0%,30m
49422,3,dablackbeast,1622,0,0,5,5,0.0%,3h
49431,1,DonnieX,1621,1896,163,219,382,42.7%,1h
49431,1,DeezKnutz,1621,1594,89,133,222,40.1%,10m
49431,1,Atex,1621,1400,55,75,130,42.3%,45m
49431,3,DerekZoger,1621,923,47,93,140,33.6%,1h
49431,3,John,1621,1382,44,79,123,35.8%,3h
49431,1,Wramm,1621,318,12,20,32,37.5%,3h
49431,3,[Wehavu]Satanicora,1621,286,9,23,32,28.1%,43m
49431,1,Vash,1621,207,7,7,14,50.0%,8m
49431,1,Raptor,1621,286,6,8,14,42.9%,1h
49431,1,Nordmark,1621,90,3,7,10,30.0%,1h
49431,3,Galindo,1621,25,1,2,3,33.3%,37m
49431,3,rjdec,1621,0,1,6,7,14.3%,43m
49431,3,GLOBEE,1621,0,0,6,6,0.0%,38m
49444,3,charlyblack,1620,456,15,34,49,30.6%,1h
49444,3,RedBaron,1620,329,9,28,37,24.3%,1h
49444,1,stotle,1620,237,7,10,17,41.2%,10m
49444,1,Danielle,1620,46,4,5,9,44.4%,11m
49444,3,goofy,1620,92,3,8,11,27.3%,1h
49444,2,[C57640]SwordFight,1620,0,1,0,1,100.0%,1h
49444,1,Crighton,1620,36,1,5,6,16.7%,1h
49444,1,VenomTerror,1620,0,0,1,1,0.0%,1h
49444,1,JORAK,1620,0,0,2,2,0.0%,31m
49453,3,Daddyman,1619,1510,163,200,363,44.9%,17m
49453,2,FOBUS,1619,152,8,13,21,38.1%,36m
49453,1,KILLAxJAKE,1619,254,7,7,14,50.0%,10m
49453,3,SleyeR,1619,180,6,8,14,42.9%,21m
49453,3,FelipeZano,1619,239,6,12,18,33.3%,1h
49453,1,Oracle,1619,133,3,7,10,30.0%,36m
49459,2,KOzmo,1618,632,19,42,61,31.1%,29m
49459,1,BRYANT,1618,362,15,6,21,71.4%,15m
49459,1,Infestado,1618,534,14,18,32,43.8%,3m
49459,1,Neopactech,1618,233,5,6,11,45.5%,1h
49459,1,nero,1618,170,4,8,12,33.3%,3h
49459,2,[301182]evette,1618,143,3,7,10,30.0%,3h
49459,3,zurdo,1618,66,2,6,8,25.0%,23m
49459,1,BlackNoCrack,1618,46,1,16,17,5.9%,3h
49459,1,Sagittario,1618,0,0,1,1,0.0%,1h
49459,1,[Epokhé]Kodiac,1618,0,0,2,2,0.0%,10m
49469,1,GatoLoco,1617,472,13,22,35,37.1%,1h
49469,1,marcos,1617,265,10,17,27,37.0%,3h
49469,1,Kaifas,1617,88,3,8,11,27.3%,36m
49469,1,Genericname,1617,0,0,2,2,0.0%,1h
49473,3,bombbomb,1616,376,12,27,39,30.8%,41m
49473,3,Charles,1616,47,2,7,9,22.2%,1h
49473,1,ZeroPoint,1616,94,2,9,11,18.2%,3h
49476,1,Coldf,1615,1096,32,46,78,41.0%,1h
49476,1,FiveMagicS,1615,864,26,32,58,44.8%,1h
49476,1,[Over1]nikolo,1615,844,24,42,66,36.4%,40m
49476,1,Belverdere,1615,806,21,37,58,36.2%,3m
49476,1,tealsea,1615,607,19,20,39,48.7%,10m
49476,1,TORETO,1615,681,19,30,49,38.8%,34m
49476,1,[TY4GG]curlyfry,1615,224,6,26,32,18.8%,4m
49476,1,shake,1615,146,4,1,5,80.0%,10m
49476,3,[ZTempz]ElvenGamer,1615,30,1,3,4,25.0%,49m
49476,3,BIMBO,1615,30,1,10,11,9.1%,23m
49476,1,BuckNasty,1615,0,0,1,1,0.0%,36m
49476,1,franckgoods,1615,0,0,8,8,0.0%,12m
49488,1,lima,1614,1765,81,108,189,42.9%,1h
49488,1,benjt,1614,677,19,32,51,37.3%,20m
49488,1,Frency,1614,357,10,24,34,29.4%,14m
49488,1,LocusQS,1614,313,8,21,29,27.6%,3h
49488,1,Fury,1614,132,5,9,14,35.7%,1h
49488,1,EDADH,1614,0,2,3,5,40.0%,14m
49494,3,kazeee,1613,196,20,41,61,32.8%,1h
49494,2,fatlink,1613,86,3,16,19,15.8%,36m
49496,3,TheOne,1612,1091,102,143,245,41.6%,1h
49496,1,Phoenixdeath,1612,68,3,5,8,37.5%,10m
49496,1,lazyturtle,1612,0,1,3,4,25.0%,1h
49496,1,Greed,1612,0,0,1,1,0.0%,10m
49496,1,[TDRGN]Aramis,1612,0,0,2,2,0.0%,3h
49501,1,[Bommmm]Benjamin,1611,170,5,14,19,26.3%,4m
49501,1,Tartamudo,1611,126,4,11,15,26.7%,31m
49501,1,aveno,1611,132,3,3,6,50.0%,10m
49504,1,ABUELO,1610,1568,57,72,129,44.2%,3m
49504,2,ANGUELNEGRO,1610,1018,37,51,88,42.0%,3h
49504,1,Ironhammer,1610,403,20,12,32,62.5%,1h
49504,1,TrIpLeOsEvEn,1610,462,12,21,33,36.4%,40m
49504,2,heliet,1610,58,2,11,13,15.4%,29m
49504,1,Rodigoli,1610,0,1,0,1,100.0%,1h
49504,1,THH,1610,94,1,3,4,25.0%,3h
49504,1,MAGIC,1610,48,1,4,5,20.0%,1h
49504,1,vonpolus,1610,86,1,5,6,16.7%,50m
49504,3,Pook,1610,0,0,8,8,0.0%,40m
49514,2,bangzyomama,1609,635,21,38,59,35.6%,19m
49514,1,Connor,1609,648,20,31,51,39.2%,1h
49514,1,Mawster,1609,294,13,13,26,50.0%,3h
49514,3,[4bronz]InspektahDek,1609,30,4,6,10,40.0%,3h
49514,2,skunk,1609,0,0,1,1,0.0%,1h
49514,2,[ZTemp]Detale,1609,0,0,1,1,0.0%,1h
49520,1,Overkill,1608,1710,60,85,145,41.4%,1h
49520,1,CooCooClock,1608,666,24,37,61,39.3%,50m
49520,1,dotaku,1608,480,13,22,35,37.1%,48m
49520,3,ChipDouglas,1608,268,9,20,29,31.0%,40m
49520,1,Max,1608,262,6,14,20,30.0%,48m
49520,2,alexz,1608,0,0,1,1,0.0%,30m
49526,1,Shysiwi,1607,205,7,8,15,46.7%,1h
49526,1,ARrazorback,1607,42,2,5,7,28.6%,10m
49526,1,carlos,1607,0,0,2,2,0.0%,31m
49529,1,UShouldQuit,1606,526,14,26,40,35.0%,10m
49529,1,Eldar,1606,218,7,6,13,53.8%,1h
49529,1,BullRider,1606,80,2,3,5,40.0%,3h
49529,1,Baco,1606,84,2,7,9,22.2%,11m
49529,3,salladboy,1606,0,1,5,6,16.7%,30m
49534,1,gladiator,1605,1523,57,78,135,42.2%,25m
49534,3,Budowski,1605,224,7,22,29,24.1%,3h
49534,1,leximoli,1605,130,3,6,9,33.3%,11m
49534,1,[slow01]snail,1605,30,2,13,15,13.3%,20m
49534,2,TheHobGobler,1605,34,1,2,3,33.3%,1h
49539,2,TheiLLtype,1604,76,5,12,17,29.4%,3h
49539,3,luis,1604,0,2,4,6,33.3%,38m
49539,2,cole,1604,78,2,13,15,13.3%,29m
49539,2,Baby,1604,0,0,1,1,0.0%,39m
49539,2,MikeNY,1604,0,0,1,1,0.0%,10m
49539,2,GABALMEIDA,1604,0,0,1,1,0.0%,44m
49539,3,highsaac,1604,0,0,2,2,0.0%,30m
49539,3,elshonis,1604,0,0,3,3,0.0%,50m
49539,3,TERRRESTRE,1604,0,0,8,8,0.0%,1h
49548,1,ericK,1603,1555,52,79,131,39.7%,11m
49548,2,puroano,1603,483,20,26,46,43.5%,1h
49548,3,AtariFalcon,1603,589,20,42,62,32.3%,49m
49548,1,cesar,1603,396,14,17,31,45.2%,3h
49548,2,FFabbriMAO,1603,176,6,19,25,24.0%,3h
49548,1,Max,1603,284,6,19,25,24.0%,56m
49548,3,[RSGXXX]SpaceEmperor,1603,90,4,11,15,26.7%,1h
49548,1,ancelantu,1603,211,4,20,24,16.7%,3h
49548,2,Jdot,1603,0,0,1,1,0.0%,1h
49557,1,OBIONE,1602,934,37,41,78,47.4%,11m
49557,1,DreddSavage,1602,609,21,38,59,35.6%,1h
49557,1,Niine,1602,297,10,23,33,30.3%,1h
49557,3,Banishalol,1602,277,9,20,29,31.0%,24m
49557,2,yAGO,1602,152,6,15,21,28.6%,29m
49557,2,Johnstacks,1602,189,5,12,17,29.4%,1h
49563,1,ClifHangers,1601,1880,125,188,313,39.9%,1h
49563,3,IANKSAUT,1601,184,11,6,17,64.7%,50m
49563,1,CalviNstyle,1601,359,10,13,23,43.5%,3h
49563,3,BloodHands,1601,30,2,4,6,33.3%,50m
49563,2,Bee,1601,0,0,1,1,0.0%,53m
49563,1,SenorCat,1601,0,0,3,3,0.0%,1h
49569,1,Fame,1600,1271,65,105,170,38.2%,1h
49569,3,Aubrey,1600,733,29,41,70,41.4%,1h
49569,1,AllyAngel,1600,552,15,23,38,39.5%,3h
49569,1,Midnightjac,1600,578,14,35,49,28.6%,3h
49569,1,Colikar,1600,136,4,7,11,36.4%,1h
49569,2,RushCraft,1600,0,0,1,1,0.0%,3h
49569,3,[Psluts]ColDMustard,1600,0,0,1,1,0.0%,43m
49576,1,Phuhque,1599,434,12,25,37,32.4%,3h
49576,1,Diego,1599,174,5,10,15,33.3%,1h
49576,1,blubberblat,1599,131,4,2,6,66.7%,3h
49576,2,diosdelsexo,1599,90,4,13,17,23.5%,47m
49576,1,IACOMPUTER,1599,0,0,3,3,0.0%,13m
49576,3,MrLonely,1599,0,0,10,10,0.0%,1h
49582,3,Abraxxazz,1598,0,0,1,1,0.0%,22m
49582,3,JrlLive,1598,0,0,2,2,0.0%,3h
49584,1,antunXDpoder,1597,176,4,13,17,23.5%,3h
49584,1,[KS2PRO]Barney,1597,78,3,7,10,30.0%,1h
49584,1,DarkAngel,1597,42,2,8,10,20.0%,36m
49584,3,Sandmaggot,1597,64,2,12,14,14.3%,37m
49584,2,NytVulf,1597,48,1,15,16,6.2%,1h
49589,2,[ZTempz]Liberty,1596,586,20,35,55,36.4%,41m
49589,1,Joey,1596,0,1,2,3,33.3%,1h
49589,2,SummerPrince,1596,90,1,5,6,16.7%,1h
49592,1,jim,1595,838,25,33,58,43.1%,1h
49592,1,Houlder,1595,396,13,34,47,27.7%,3m
49592,1,thatnoobisme,1595,137,4,5,9,44.4%,48m
49592,3,Fujin,1595,0,2,3,5,40.0%,1h
49592,3,Denson,1595,0,1,7,8,12.5%,3h
49592,1,ESTEBAN,1595,92,1,7,8,12.5%,10m
49598,1,ElGreñas,1594,446,11,26,37,29.7%,12m
49598,1,MARXALB,1594,382,10,11,21,47.6%,20m
49598,1,murdamo,1594,214,6,16,22,27.3%,13m
49598,2,[culeao]Warrior,1594,78,2,16,18,11.1%,1h
49598,3,narito,1594,30,1,6,7,14.3%,1h
49598,2,GhostPants,1594,0,0,1,1,0.0%,1h
49598,3,meDaBoss,1594,0,0,1,1,0.0%,49m
49605,1,lionel,1593,226,10,9,19,52.6%,10m
49605,2,Shadow,1593,132,4,3,7,57.1%,1h
49605,2,sasoluis,1593,109,3,5,8,37.5%,1h
49605,2,MedicatedOne,1593,0,0,1,1,0.0%,1h
49605,2,krosfyre,1593,0,0,2,2,0.0%,1h
49610,1,[xSDBx]valhalla,1592,1174,40,75,115,34.8%,1h
49610,1,haydean,1592,1253,37,50,87,42.5%,3h
49610,1,GrumpyMonk,1592,585,23,37,60,38.3%,34m
49610,1,limberg,1592,660,17,30,47,36.2%,4m
49610,1,LeKickAccMan,1592,0,2,4,6,33.3%,1h
49610,3,Baileydabomb,1592,0,1,0,1,100.0%,1h
49610,2,TechTophia,1592,0,0,3,3,0.0%,3h
49617,1,Gnatyzi,1591,1871,388,468,856,45.3%,4m
49617,3,iamhalo,1591,0,0,2,2,0.0%,1h
49617,3,Ares,1591,0,0,3,3,0.0%,23m
49620,1,Fergersen,1590,516,13,27,40,32.5%,1h
49620,2,brashiloko,1590,330,11,28,39,28.2%,3h
49620,1,[UAK]PcklonSRT,1590,226,5,14,19,26.3%,1h
49620,1,DIAMANTE,1590,0,0,9,9,0.0%,10m
49624,1,hasudrone,1589,1503,163,222,385,42.3%,1h
49624,1,kronick,1589,1828,99,151,250,39.6%,3h
49624,1,Dirtydino,1589,134,3,5,8,37.5%,44m
49624,2,Masterchalo,1589,48,1,2,3,33.3%,10m
49624,1,XAVIERCJ,1589,44,1,9,10,10.0%,45m
49629,1,tobesgamer,1588,948,33,50,83,39.8%,11m
49629,2,Pertinax,1588,653,24,27,51,47.1%,10m
49629,1,[NM4E]REPLICATOR,1588,120,3,6,9,33.3%,1h
49629,1,jansasu,1588,0,2,4,6,33.3%,11m
49629,2,Fez,1588,0,1,5,6,16.7%,13m
49629,3,Avrose,1588,0,1,8,9,11.1%,30m
49635,1,matadamas,1587,1823,92,132,224,41.1%,1h
49635,1,CEAH,1587,567,15,19,34,44.1%,1h
49635,1,TROY,1587,209,12,7,19,63.2%,1h
49635,2,[Wonger]Adam,1587,0,0,1,1,0.0%,1h
49635,1,vadoosk,1587,0,0,3,3,0.0%,20m
49635,1,raulacedo,1587,73,0,11,11,0.0%,11m
49641,3,SneakyTurtle,1586,609,74,113,187,39.6%,3h
49641,1,BMG,1586,894,25,32,57,43.9%,10m
49641,2,[Antss]tURD,1586,174,5,5,10,50.0%,1h
49641,1,GINGERMAXTAR,1586,137,2,4,6,33.3%,4m
49641,1,Twolings,1586,42,1,8,9,11.1%,31m
49641,2,luap,1586,0,0,1,1,0.0%,10m
49641,1,anndyyomar,1586,0,0,4,4,0.0%,3h
49648,1,MrFancyHat,1585,818,21,36,57,36.8%,19m
49648,2,pelaocifu,1585,344,9,12,21,42.9%,1h
49648,2,Shadowmage,1585,192,5,19,24,20.8%,5m
49648,3,Easyrider,1585,30,3,18,21,14.3%,40m
49648,2,Demian,1585,30,2,1,3,66.7%,1h
49653,1,Thorgrim,1584,250,5,8,13,38.5%,1h
49653,1,IonNick,1584,151,4,3,7,57.1%,19m
49655,1,HulaHoop,1583,1206,38,52,90,42.2%,1h
49655,1,[DXPCA]artanis,1583,791,24,32,56,42.9%,19m
49655,3,mick,1583,30,3,11,14,21.4%,5m
49655,3,Fenixgamer,1583,78,2,1,3,66.7%,37m
49655,3,Nusenthea,1583,0,0,1,1,0.0%,1h
49660,1,Jackkhusky,1582,1872,176,240,416,42.3%,44m
49660,3,RyBo,1582,1188,36,69,105,34.3%,19m
49660,1,JBsOverAces,1582,504,17,28,45,37.8%,1h
49660,1,MetroKnome,1582,84,3,5,8,37.5%,60m
49660,3,yellowjack,1582,30,2,3,5,40.0%,23m
49660,1,GoldenGoose,1582,122,2,4,6,33.3%,11m
49660,2,[Over1]gerardo,1582,38,1,1,2,50.0%,1h
49660,3,sebastian,1582,0,1,4,5,20.0%,49m
49660,3,SmokeyCat,1582,0,0,1,1,0.0%,1h
49660,3,franktwinzle,1582,0,0,3,3,0.0%,43m
49670,1,papayo,1581,1736,62,117,179,34.6%,25m
49670,2,nochecuervo,1581,1096,35,60,95,36.8%,10m
49670,1,Jonsnow,1581,320,8,17,25,32.0%,36m
49670,1,METTATRON,1581,139,2,6,8,25.0%,10m
49670,2,ElBuenChico,1581,0,1,4,5,20.0%,5m
49670,2,richin,1581,0,0,2,2,0.0%,2m
49670,1,StarFire,1581,0,0,4,4,0.0%,19m
49677,1,Nion,1580,816,26,45,71,36.6%,1h
49677,1,VAMPIREXIII,1580,782,22,40,62,35.5%,40m
49677,1,Blzbubba,1580,552,14,24,38,36.8%,1h
49677,1,RioTokio,1580,479,12,26,38,31.6%,1h
49677,1,HPJack,1580,140,4,10,14,28.6%,1h
49677,2,KCASI,1580,0,1,0,1,100.0%,13m
49677,2,TicketyBoo,1580,0,1,0,1,100.0%,10m
49677,2,alpha,1580,42,1,1,2,50.0%,1h
49685,1,kiory,1579,814,23,37,60,38.3%,44m
49685,1,juanxoman,1579,572,18,30,48,37.5%,23m
49685,1,JTrain,1579,635,16,28,44,36.4%,1h
49685,2,chez,1579,0,1,0,1,100.0%,39m
49689,1,Mattrix,1578,566,14,25,39,35.9%,1h
49689,1,Cazador,1578,556,13,22,35,37.1%,3h
49689,1,crepygamer,1578,274,12,7,19,63.2%,35m
49689,2,[TFTG]GoMarine,1578,0,0,1,1,0.0%,30m
49689,2,Mulligans,1578,0,0,2,2,0.0%,15m
49689,1,skimbo,1578,0,0,4,4,0.0%,3h
49689,2,Kruadel,1578,0,0,11,11,0.0%,37m
49696,3,INGRICHARD,1577,936,31,46,77,40.3%,3h
49696,1,papitwo,1577,343,9,15,24,37.5%,1h
49696,3,FreakyFrank,1577,70,3,7,10,30.0%,38m
49696,1,MENDEZ,1577,73,1,2,3,33.3%,10m
49696,2,gonzalom,1577,0,0,5,5,0.0%,1h
49701,1,solidsnake,1576,633,26,25,51,51.0%,4m
49701,1,Derpatron,1576,396,10,19,29,34.5%,3h
49701,2,Darklordkaan,1576,244,7,19,26,26.9%,1h
49701,1,GhostWolf,1576,0,1,1,2,50.0%,10m
49701,2,PlutonicLime,1576,0,0,1,1,0.0%,53m
49706,1,Joe,1575,1845,94,121,215,43.7%,23m
49706,3,Odin,1575,386,12,29,41,29.3%,3h
49706,2,Explosivo,1575,88,3,12,15,20.0%,5m
49706,2,Jcwarrior,1575,48,1,8,9,11.1%,1h
49706,3,monty,1575,0,0,1,1,0.0%,23m
49711,1,[xDYEx]BOLODON,1574,1845,173,230,403,42.9%,1h
49711,1,zeratul,1574,958,30,51,81,37.0%,11m
49711,1,JKryptic,1574,738,22,29,51,43.1%,3h
49711,2,zeulb,1574,116,3,6,9,33.3%,1h
49711,1,wilson,1574,0,1,4,5,20.0%,1h
49711,3,TVT,1574,0,1,9,10,10.0%,3h
49717,1,spartan,1573,407,17,13,30,56.7%,14m
49717,2,Cellesteel,1573,240,11,7,18,61.1%,1h
49717,3,Prowler,1573,30,2,0,2,100.0%,30m
49720,3,OberKammando,1572,146,9,9,18,50.0%,3h
49720,1,Cory,1572,260,7,12,19,36.8%,3h
49720,2,Quadena,1572,140,4,18,22,18.2%,3h
49720,3,Stremenx,1572,0,3,5,8,37.5%,22m
49720,2,HYH,1572,176,3,6,9,33.3%,10m
49720,3,Sisyphus,1572,0,0,5,5,0.0%,49m
49720,3,Atelk,1572,0,0,5,5,0.0%,1h
49727,3,PEN,1571,367,12,27,39,30.8%,1h
49727,2,KevinUchiha,1571,369,10,28,38,26.3%,1h
49727,1,Rally,1571,216,6,12,18,33.3%,10m
49727,1,Sasha,1571,188,5,10,15,33.3%,3h
49727,1,jhonarct,1571,164,5,17,22,22.7%,44m
49727,1,Atarani,1571,82,3,4,7,42.9%,48m
49727,1,Chokealot,1571,44,2,19,21,9.5%,50m
49727,3,Pizza,1571,0,0,1,1,0.0%,50m
49727,2,netcat,1571,0,0,5,5,0.0%,1h
49736,2,Daniel,1570,398,12,29,41,29.3%,1h
49736,3,PalitoEB,1570,260,11,9,20,55.0%,38m
49736,3,Wiracocha,1570,371,10,29,39,25.6%,1h
49736,1,DecoyPrime,1570,132,4,9,13,30.8%,4m
49736,3,Mahrynn,1570,0,1,0,1,100.0%,30m
49741,1,stardvin,1569,1361,47,72,119,39.5%,15m
49741,2,STARRJUNN,1569,690,20,35,55,36.4%,10m
49741,1,willian,1569,759,20,38,58,34.5%,10m
49741,1,ktastrofe,1569,348,9,22,31,29.0%,1h
49741,1,Zex,1569,229,6,17,23,26.1%,23m
49741,2,[Cholm]Warmachine,1569,0,0,1,1,0.0%,10m
49747,2,DredKnot,1568,286,11,11,22,50.0%,1h
49748,1,FrostBite,1567,329,10,13,23,43.5%,31m
49748,2,Zebith,1567,109,4,8,12,33.3%,10m
49750,1,CrazyHorseXI,1566,1830,135,201,336,40.2%,25m
49750,1,ChappyGamer,1566,614,16,35,51,31.4%,1h
49750,2,Kemamaplanta,1566,192,5,10,15,33.3%,1h
49750,2,Viper,1566,120,2,5,7,28.6%,1h
49750,3,TechnoWizROK,1566,66,2,6,8,25.0%,50m
49750,3,matasanos,1566,0,0,3,3,0.0%,43m
49750,3,AJA,1566,0,0,10,10,0.0%,23m
49757,1,Alec,1565,1549,56,62,118,47.5%,11m
49757,1,Psyko,1565,417,10,25,35,28.6%,35m
49757,2,AshbySan,1565,36,2,2,4,50.0%,3h
49757,3,Ccth,1565,0,2,6,8,25.0%,3h
49757,1,Cybersick,1565,92,2,10,12,16.7%,10m
49757,1,Folley,1565,139,2,14,16,12.5%,11m
49757,2,IkmanTresk,1565,76,2,14,16,12.5%,15m
49757,2,PizzaBob,1565,0,1,1,2,50.0%,53m
49757,3,[PERUII]Chase,1565,30,1,6,7,14.3%,18m
49766,1,oldtown,1564,802,20,36,56,35.7%,3h
49766,2,[Emi12]Emiros,1564,148,5,5,10,50.0%,1h
49766,1,Cavewert,1564,118,5,18,23,21.7%,1h
49766,2,AceOne,1564,0,1,1,2,50.0%,44m
49766,3,naicocraftYT,1564,30,1,3,4,25.0%,38m
49766,2,gerarfa,1564,0,0,1,1,0.0%,3h
49772,1,boomer,1563,571,35,52,87,40.2%,1h
49772,1,[TGCrew]ThisIsOof,1563,221,5,7,12,41.7%,34m
49772,3,Tamara,1563,55,2,6,8,25.0%,37m
49772,2,schneids,1563,0,1,1,2,50.0%,1h
49772,2,[ifm]Zomb,1563,0,0,5,5,0.0%,3h
49777,2,ureta,1562,495,38,59,97,39.2%,1h
49777,3,OhadiNacnud,1562,183,4,18,22,18.2%,40m
49777,3,BiliamsWrath,1562,58,2,2,4,50.0%,1h
49777,2,ROY,1562,0,1,2,3,33.3%,3h
49777,3,joshua,1562,0,1,5,6,16.7%,3h
49777,2,MarkHero,1562,0,0,5,5,0.0%,1h
49777,2,llllllllllll,1562,0,0,10,10,0.0%,3h
49784,1,silentstorm,1561,1840,82,110,192,42.7%,34m
49784,2,Marean,1561,1540,64,110,174,36.8%,1h
49784,1,toreto,1561,1435,44,79,123,35.8%,1h
49784,1,ShikaraST,1561,932,35,42,77,45.5%,4m
49784,2,LEESUNGJAE,1561,928,31,46,77,40.3%,1h
49784,1,SuperTroy,1561,342,9,18,27,33.3%,1h
49784,3,freddbliz,1561,106,3,6,9,33.3%,30m
49784,2,Jayjay,1561,0,0,1,1,0.0%,1h
49784,2,Fireburner,1561,0,0,10,10,0.0%,1h
49793,1,Diegovch,1560,1517,111,147,258,43.0%,1h
49793,1,Tuckus,1560,640,19,28,47,40.4%,1h
49793,1,lukas,1560,60,4,13,17,23.5%,53m
49793,1,JABC,1560,143,2,8,10,20.0%,3h
49793,2,woz,1560,82,2,16,18,11.1%,2m
49798,1,DArtagnan,1559,1171,66,117,183,36.1%,60m
49798,3,THZRodCoco,1559,716,24,41,65,36.9%,33m
49798,1,Raul,1559,494,20,35,55,36.4%,1h
49798,2,Potocow,1559,274,8,12,20,40.0%,10m
49798,3,icemanll,1559,248,8,20,28,28.6%,1h
49798,2,[NM8]Askywarrior,1559,160,5,4,9,55.6%,1h
49798,1,Vav,1559,30,4,7,11,36.4%,44m
49798,1,deathrow,1559,120,3,5,8,37.5%,1h
49798,2,Buddpudge,1559,44,3,11,14,21.4%,13m
49798,3,Panquiaco,1559,0,2,3,5,40.0%,3h
49798,2,davesnow,1559,30,1,2,3,33.3%,3h
49798,3,LazyTurtle,1559,0,1,3,4,25.0%,37m
49798,2,[Kusshh]Dondiablo,1559,30,1,11,12,8.3%,1h
49798,2,Onur,1559,0,0,3,3,0.0%,5m
49812,1,Russo,1558,1025,58,80,138,42.0%,3h
49812,3,FatesEnd,1558,1232,42,68,110,38.2%,49m
49812,2,TWatson,1558,214,6,5,11,54.5%,1h
49812,2,Psicco,1558,0,0,1,1,0.0%,54m
49812,3,[Sax]LoveBobaGuys,1558,0,0,3,3,0.0%,30m
49817,2,borise,1557,1046,59,89,148,39.9%,1h
49817,1,Hunter,1557,618,15,26,41,36.6%,40m
49817,2,SANTANDER,1557,60,2,14,16,12.5%,19m
49817,2,DragonFly,1557,0,1,2,3,33.3%,10m
49817,1,danrafalmeid,1557,0,0,2,2,0.0%,25m
49822,3,BuzzCauldrin,1556,1504,71,105,176,40.3%,11m
49822,3,LafaMash,1556,216,7,32,39,17.9%,48m
49822,1,SunTzu,1556,136,4,5,9,44.4%,1h
49822,2,SiMutada,1556,108,3,17,20,15.0%,15m
49822,1,GunFire,1556,99,2,13,15,13.3%,11m
49822,1,Insaniac,1556,0,1,5,6,16.7%,1h
49828,1,ANIMAL,1555,390,15,22,37,40.5%,31m
49828,3,MEGAROB,1555,285,8,29,37,21.6%,40m
49828,1,BruGT,1555,87,2,7,9,22.2%,24m
49831,1,EeDobarganes,1554,1117,37,58,95,38.9%,1h
49831,1,grayco,1554,437,28,30,58,48.3%,8m
49831,1,TsukasaGamin,1554,863,24,37,61,39.3%,44m
49831,1,Samael,1554,821,23,45,68,33.8%,10m
49831,3,OSCARO,1554,0,0,2,2,0.0%,38m
49836,2,Omegagemo,1553,106,5,5,10,50.0%,1h
49836,1,micmcw,1553,97,1,7,8,12.5%,11m
49838,1,kilo,1552,1836,84,140,224,37.5%,12m
49838,1,insurgent,1552,1830,74,104,178,41.6%,1h
49838,1,Ameasy,1552,1229,39,51,90,43.3%,12m
49838,2,AnnieLeonhar,1552,260,11,22,33,33.3%,22m
49838,3,destructor,1552,212,9,16,25,36.0%,1h
49838,2,conmandante,1552,84,4,5,9,44.4%,1h
49838,2,Set,1552,134,4,16,20,20.0%,1h
49838,2,[VTSC]Stargarbage,1552,104,3,8,11,27.3%,10m
49838,3,GoBirdKR,1552,92,3,16,19,15.8%,40m
49838,2,PREDATOR,1552,64,2,2,4,50.0%,10m
49838,1,Nicoli,1552,94,2,9,11,18.2%,1h
49838,3,Tommy,1552,0,1,4,5,20.0%,1h
49838,2,CXZXPUTXS,1552,0,1,4,5,20.0%,5m
49851,3,PJZX,1551,141,5,9,14,35.7%,54m
49851,3,RONALD,1551,88,4,9,13,30.8%,23m
49851,1,House,1551,48,2,8,10,20.0%,11m
49851,2,Yuki,1551,72,2,10,12,16.7%,10m
49851,2,Evolution,1551,0,0,1,1,0.0%,2m
49856,1,Itachi,1550,1847,86,161,247,34.8%,1h
49856,1,gladiator,1550,502,13,31,44,29.5%,14m
49856,1,AvanzinKK,1550,185,6,8,14,42.9%,1h
49856,3,Belén,1550,74,2,16,18,11.1%,1h
49856,3,Balupooonyou,1550,0,1,5,6,16.7%,1h
49856,2,hugoxdragon,1550,0,0,1,1,0.0%,39m
49862,1,CONEJO,1549,300,8,17,25,32.0%,20m
49862,2,Cesar,1549,0,2,3,5,40.0%,10m
49862,3,franco,1549,32,2,8,10,20.0%,3h
49862,2,Melanie,1549,0,0,2,2,0.0%,1h
49862,2,battlepants,1549,73,0,11,11,0.0%,1h
49867,2,leee,1548,482,18,28,46,39.1%,3h
49867,2,ateus,1548,100,4,3,7,57.1%,30m
49867,2,elmape,1548,0,1,0,1,100.0%,1h
49870,1,[ECX]Brassuns,1547,1595,97,132,229,42.4%,10m
49870,1,Jimsky,1547,1835,72,124,196,36.7%,8m
49870,2,batlecruiser,1547,342,15,15,30,50.0%,1h
49870,2,battleaxe,1547,344,11,16,27,40.7%,1h
49870,1,[xDYEx]manu,1547,169,3,8,11,27.3%,11m
49870,3,Grenadier,1547,58,2,13,15,13.3%,1h
49876,1,EricFX,1546,142,4,20,24,16.7%,1h
49876,3,Grandizer,1546,0,0,1,1,0.0%,18m
49878,1,baron,1545,357,11,17,28,39.3%,3h
49878,2,ChineseFox,1545,164,5,9,14,35.7%,5m
49878,2,Fenix,1545,122,3,5,8,37.5%,44m
49878,3,Daniel,1545,30,2,4,6,33.3%,1h
49882,3,Spock,1544,419,12,24,36,33.3%,3h
49882,2,Greatheart,1544,302,7,14,21,33.3%,1h
49882,1,Pirézdeath,1544,0,3,4,7,42.9%,10m
49882,2,NomHok,1544,97,3,9,12,25.0%,1h
49882,2,[DKWSKR]toasterlvr,1544,0,0,2,2,0.0%,3h
49887,1,Reelople,1543,326,24,41,65,36.9%,1h
49888,1,Stargazer,1542,1156,53,73,126,42.1%,1h
49888,1,starkiller,1542,1034,28,45,73,38.4%,50m
49888,1,cubo,1542,275,8,19,27,29.6%,1h
49888,2,Oneida,1542,0,0,1,1,0.0%,3h
49892,1,[LifeF]JMaximus,1541,1351,40,53,93,43.0%,35m
49892,1,Inane,1541,1089,38,86,124,30.6%,1h
49892,3,[franci]francis,1541,102,4,13,17,23.5%,18m
49892,2,LazerDILLIGA,1541,165,4,14,18,22.2%,1h
49896,1,BobZero,1540,348,9,24,33,27.3%,36m
49896,1,dylan,1540,239,7,15,22,31.8%,3h
49896,2,jade,1540,228,7,18,25,28.0%,1h
49896,2,Rization,1540,198,5,11,16,31.2%,1h
49896,2,xhareman,1540,0,0,1,1,0.0%,10m
49901,2,Manny,1539,870,30,42,72,41.7%,1h
49901,2,Jakeypoo,1539,409,26,40,66,39.4%,1h
49901,1,[Justis]AresPrime,1539,276,7,16,23,30.4%,1h
49901,2,Luiis,1539,84,3,15,18,16.7%,4m
49901,3,Rokxbot,1539,42,1,1,2,50.0%,30m
49906,1,[POWOW]LievreGarou,1538,1799,216,298,514,42.0%,3h
49906,1,Zaine,1538,576,14,33,47,29.8%,10m
49906,3,sami,1538,188,4,15,19,21.1%,1h
49909,1,love,1537,1853,92,133,225,40.9%,1h
49909,1,[OD]Xeros,1537,426,12,23,35,34.3%,13m
49911,1,skittles,1536,1422,89,135,224,39.7%,3h
49911,1,hokagesiete,1536,1178,32,63,95,33.7%,15m
49911,1,[KKG]Yabi,1536,281,8,16,24,33.3%,3h
49911,3,notzwifting,1536,30,1,11,12,8.3%,1h
49911,3,xRivalry,1536,0,0,1,1,0.0%,1h
49916,1,Satoshi,1535,1256,37,76,113,32.7%,3h
49916,1,Grapes,1535,130,5,9,14,35.7%,4m
49916,1,Ender,1535,230,5,17,22,22.7%,11m
49916,2,fepus,1535,124,4,19,23,17.4%,1h
49916,2,XxNoobxX,1535,32,2,5,7,28.6%,1h
49916,1,SLIPPERUP,1535,42,2,8,10,20.0%,3h
49916,3,Rediscool,1535,0,1,12,13,7.7%,1h
49923,1,MARAMBIONIKO,1534,762,25,44,69,36.2%,10m
49923,1,Puracañaña,1534,430,15,18,33,45.5%,1h
49923,2,ALiENS,1534,438,11,26,37,29.7%,5m
49923,3,Arcangel,1534,234,10,14,24,41.7%,18m
49923,3,mikinot,1534,58,2,11,13,15.4%,37m
49923,2,RUSH,1534,30,1,6,7,14.3%,10m
49929,1,FRENC,1533,1812,138,222,360,38.3%,1h
49929,1,DANYESCOBAR,1533,626,20,33,53,37.7%,56m
49929,2,kingred,1533,204,10,3,13,76.9%,1h
49929,2,taquito,1533,40,1,1,2,50.0%,10m
49929,3,TheMcPeanut,1533,42,1,8,9,11.1%,49m
49929,3,lightcloud,1533,0,0,1,1,0.0%,29m
49929,2,Khan,1533,0,0,2,2,0.0%,6m
49929,1,sauron,1533,0,0,3,3,0.0%,60m
49929,2,[XTLGX]Prophetzx,1533,0,0,4,4,0.0%,10m
49938,2,sircombo,1532,1591,59,103,162,36.4%,5m
49938,1,[Pharoh]XxrasiixX,1532,827,21,33,54,38.9%,56m
49938,2,syncmasterr,1532,246,7,7,14,50.0%,3h
49938,1,Kynn,1532,46,2,16,18,11.1%,20m
49938,1,yuckeymoney,1532,0,1,3,4,25.0%,60m
49943,2,Slayer,1531,44,2,5,7,28.6%,6m
49943,2,DerpDevil,1531,106,1,4,5,20.0%,53m
49945,2,ostran,1530,46,1,16,17,5.9%,1h
49945,3,Kravitz,1530,0,0,1,1,0.0%,49m
49947,1,mjottii,1529,233,5,12,17,29.4%,1h
49947,2,waffles,1529,60,2,17,19,10.5%,1h
49949,2,Pheonix,1528,198,6,19,25,24.0%,1h
49950,2,DarkWolf,1527,92,5,4,9,55.6%,10m
49950,2,Ash,1527,96,3,18,21,14.3%,15m
49950,1,[QCHFLT]FREZCO,1527,44,2,5,7,28.6%,1h
49950,2,Elephante,1527,74,2,7,9,22.2%,1h
49950,2,Rain,1527,66,2,18,20,10.0%,1h
49950,2,ALQUIMISTA,1527,0,1,2,3,33.3%,10m
49950,2,[EmberR]TwistedTemp,1527,104,1,5,6,16.7%,10m
49957,1,kingcobra,1526,980,29,40,69,42.0%,40m
49957,1,Reno,1526,775,23,33,56,41.1%,11m
49957,1,Yomero,1526,413,20,22,42,47.6%,1h
49957,2,Tulkasbr,1526,116,2,4,6,33.3%,6m
49957,2,POMBEROpy,1526,0,0,1,1,0.0%,1h
49962,1,BigDaddy,1525,1344,39,67,106,36.8%,31m
49962,1,Aníbal,1525,642,17,30,47,36.2%,56m
49962,1,Sloug,1525,216,7,12,19,36.8%,31m
49962,2,war,1525,216,4,17,21,19.0%,1h
49962,1,[XpKAc]leoalfa,1525,86,3,8,11,27.3%,1h
49962,2,JKaido,1525,0,0,3,3,0.0%,54m
49968,1,Computer,1524,1118,37,57,94,39.4%,34m
49968,2,AdeSan,1524,358,12,13,25,48.0%,1h
49968,2,dominatorSC,1524,58,3,1,4,75.0%,13m
49968,2,dencus,1524,0,1,0,1,100.0%,29m
49972,2,kikeone,1523,1432,51,114,165,30.9%,30m
49972,2,Echo,1523,667,22,32,54,40.7%,1h
49972,2,GUOS,1523,472,12,20,32,37.5%,3h
49972,1,capcastelo,1523,143,4,8,12,33.3%,34m
49972,1,Dino,1523,164,4,22,26,15.4%,60m
49972,2,foxzygranma,1523,0,0,1,1,0.0%,10m
49972,2,joseph,1523,0,0,3,3,0.0%,1h
49979,2,Bogey,1522,226,7,26,33,21.2%,1h
49979,2,urbie,1522,188,6,21,27,22.2%,1h
49979,2,perropatata,1522,58,3,1,4,75.0%,1h
49979,2,Clagolas,1522,62,3,5,8,37.5%,1h
49979,2,PLATAHALCON,1522,0,0,3,3,0.0%,14m
49984,3,mhneri,1521,0,1,1,2,50.0%,1h
49984,3,HeadyBarber,1521,30,1,13,14,7.1%,3h
49986,3,Buldog,1520,1483,190,252,442,43.0%,40m
49986,2,knightwing,1520,1652,69,108,177,39.0%,1h
49986,2,willyshaulin,1520,296,6,24,30,20.0%,10m
49986,2,danyphanton,1520,126,3,3,6,50.0%,29m
49986,2,PitaBread,1520,30,1,3,4,25.0%,1h
49991,1,Bancocoman,1519,825,29,42,71,40.8%,3h
49991,1,Orindafarmer,1519,44,2,15,17,11.8%,11m
49991,2,KingRedneck,1519,0,0,1,1,0.0%,2m
49994,1,Adventhur,1518,1052,37,59,96,38.5%,1h
49994,3,Head,1518,470,17,39,56,30.4%,43m
49994,2,CHEESE,1518,250,5,21,26,19.2%,54m
49994,2,marxs,1518,18,4,6,10,40.0%,53m
49994,2,CptSparrow,1518,154,4,19,23,17.4%,1h
49994,2,Slyfer,1518,58,2,17,19,10.5%,3h
49994,2,Superduke,1518,0,0,1,1,0.0%,3h
49994,2,Desertdawg,1518,0,0,2,2,0.0%,1h
49994,3,Ohma,1518,0,0,6,6,0.0%,1h
49994,3,XiniuX,1518,0,0,10,10,0.0%,29m
50004,1,xaxu,1517,384,14,23,37,37.8%,3h
50004,2,Rooster,1517,312,13,14,27,48.1%,1h
50004,3,Galarog,1517,118,4,9,13,30.8%,3h
50004,3,orvilper,1517,30,1,13,14,7.1%,3h
50004,2,Tonio,1517,0,0,5,5,0.0%,1h
50009,1,RaynorNorth,1516,672,18,33,51,35.3%,49m
50009,2,ApexPredator,1516,0,1,1,2,50.0%,1h
50009,2,LealAranda,1516,0,0,5,5,0.0%,15m
50012,1,ken,1515,0,0,9,9,0.0%,1h
50013,2,GanzoCarboni,1514,1606,55,85,140,39.3%,10m
50013,2,Historian,1514,978,33,54,87,37.9%,1h
50013,2,Analog,1514,746,22,32,54,40.7%,1h
50013,1,ALEXKIRKY,1514,198,6,17,23,26.1%,3h
50013,2,[Wyvrn9]MarineVet,1514,86,4,1,5,80.0%,3h
50013,1,VIZCARRA,1514,44,3,12,15,20.0%,1h
50013,2,BigTerran,1514,0,1,1,2,50.0%,6m
50013,3,lava,1514,0,1,13,14,7.1%,25m
50013,2,harryhardout,1514,0,0,4,4,0.0%,1h
50022,1,ZethAndJames,1513,745,25,59,84,29.8%,3h
50022,1,DrrD,1513,312,7,23,30,23.3%,24m
50022,2,Malcanuo,1513,30,1,5,6,16.7%,10m
50022,2,PrisonLips,1513,0,0,1,1,0.0%,3h
50026,1,shortdavix,1512,782,31,37,68,45.6%,49m
50026,3,GhostPants,1512,168,5,9,14,35.7%,1h
50026,2,[OPMs]ZamuraiKing,1512,78,2,11,13,15.4%,10m
50029,2,Reckoner,1511,1642,73,95,168,43.5%,1h
50029,1,JeanThiago,1511,192,5,16,21,23.8%,1h
50029,3,gatolino,1511,199,5,16,21,23.8%,1h
50029,1,LightsOut,1511,112,3,13,16,18.8%,10m
50029,2,Joaquin,1511,66,2,5,7,28.6%,44m
50029,1,Garusix,1511,0,0,10,10,0.0%,3h
50035,2,Noctis,1510,638,52,82,134,38.8%,1h
50035,1,Kiwinese,1510,436,11,25,36,30.6%,4m
50035,2,Hermosa,1510,86,3,4,7,42.9%,1h
50035,3,Lukem,1510,30,3,7,10,30.0%,30m
50035,1,Maverick,1510,137,2,9,11,18.2%,34m
50035,3,Wholelttaluv,1510,30,1,15,16,6.2%,1h
50041,2,screedle,1509,995,37,44,81,45.7%,1h
50041,2,obverse,1509,74,5,5,10,50.0%,1h
50041,2,CapRazo,1509,164,4,7,11,36.4%,1h
50041,3,ZERGslayer,1509,164,4,20,24,16.7%,3h
50041,2,KingJames,1509,0,0,5,5,0.0%,1h
50046,3,Ignatvs,1508,0,0,1,1,0.0%,1h
50046,2,LITIO,1508,0,0,2,2,0.0%,3h
50048,1,Vince,1507,610,16,36,52,30.8%,3h
50048,1,[BSGC]YankeeDan,1507,542,15,25,40,37.5%,3h
50048,2,TuckTuck,1507,0,0,1,1,0.0%,1h
50048,2,yakuza,1507,0,0,2,2,0.0%,1h
50048,3,Ryan,1507,0,0,2,2,0.0%,43m
50053,1,bonecrusher,1506,1345,56,70,126,44.4%,1h
50053,1,stevenz,1506,266,8,16,24,33.3%,3h
50053,1,Ortale,1506,254,7,29,36,19.4%,1h
50056,1,Masher,1505,1810,321,489,810,39.6%,3h
50056,1,noc,1505,1180,36,61,97,37.1%,4m
50056,3,Lebowski,1505,184,6,19,25,24.0%,1h
50056,3,hades,1505,94,5,8,13,38.5%,1h
50056,1,Bradshaw,1505,18,3,15,18,16.7%,32m
50056,1,FallenAngel,1505,34,1,6,7,14.3%,11m
50062,1,murider,1504,1814,120,218,338,35.5%,3h
50062,2,Miunick,1504,926,33,46,79,41.8%,54m
50062,2,TuPinchePapá,1504,74,3,19,22,13.6%,5m
50062,2,littleguy,1504,0,1,4,5,20.0%,14m
50066,1,DreamsNvEnd,1503,889,43,74,117,36.8%,15m
50066,3,Avalanch,1503,564,18,41,59,30.5%,3h
50066,1,darrell,1503,306,8,21,29,27.6%,24m
50066,2,odinthegreat,1503,76,3,6,9,33.3%,10m
50066,1,Hayden,1503,0,0,5,5,0.0%,49m
50071,2,Omiafe,1502,0,2,3,5,40.0%,6m
50071,2,Jedi,1502,38,2,4,6,33.3%,15m
50073,3,Prettyyuja,1501,1435,108,144,252,42.9%,30m
50073,1,KRISTOFF,1501,1750,73,117,190,38.4%,40m
50073,1,Dangit,1501,1435,51,108,159,32.1%,10m
50076,2,avery,1500,1563,64,98,162,39.5%,1h
50076,1,ZeDan,1500,162,4,13,17,23.5%,1h
50078,2,BanditFTW,1499,522,16,24,40,40.0%,1h
50078,2,nicolas,1499,190,6,13,19,31.6%,2m
50078,2,icarus,1499,76,5,5,10,50.0%,30m
50078,3,FAVIO,1499,0,0,4,4,0.0%,22m
50082,2,AllMighty,1498,353,10,21,31,32.3%,1h
50083,1,chairborne,1497,166,11,15,26,42.3%,1h
50083,3,[AxL]SeaFoam,1497,0,1,6,7,14.3%,4m
50085,2,[GGqpEZ]terron,1496,0,1,0,1,100.0%,1h
50085,3,[SyLx]Slayer,1496,0,0,11,11,0.0%,43m
50087,1,[Bk3aa]RAM,1495,403,38,49,87,43.7%,3h
50087,1,Kaul,1495,834,20,43,63,31.7%,40m
50087,2,Stonecrusher,1495,128,4,8,12,33.3%,10m
50087,2,PorscheGTS,1495,90,2,20,22,9.1%,3h
50087,1,dalbertomtz,1495,0,0,9,9,0.0%,1h
50092,1,[3pro5u]Florid,1494,1495,89,130,219,40.6%,12m
50092,1,victorSpain,1494,942,26,49,75,34.7%,3h
50092,2,Jurgen,1494,71,2,2,4,50.0%,39m
50092,2,[JUGOSC]SrPiccoro,1494,76,2,4,6,33.3%,39m
50096,1,swagmeng,1493,633,17,40,57,29.8%,60m
50096,1,[THC419]Blazemore,1493,341,10,20,30,33.3%,10m
50096,1,ELISEO,1493,0,0,6,6,0.0%,3h
50099,1,Fortexodus,1492,278,8,16,24,33.3%,44m
50099,2,Tarik,1492,150,4,9,13,30.8%,6m
50099,3,Hitman,1492,62,3,9,12,25.0%,1h
50099,2,Cakeboss,1492,181,3,18,21,14.3%,1h
50099,2,DeadlyKitten,1492,0,2,5,7,28.6%,3h
50099,3,RepliedHydra,1492,40,2,8,10,20.0%,4m
50099,2,Cerberus,1492,0,0,1,1,0.0%,1h
50099,2,[LMI42]ROROMAGNO,1492,0,0,2,2,0.0%,1h
50107,2,smatheson,1491,1000,46,70,116,39.7%,1h
50107,2,Tom,1491,654,40,77,117,34.2%,1h
50109,2,AirBrowNc,1490,992,33,57,90,36.7%,5m
50109,3,raynor,1490,193,4,21,25,16.0%,1h
50111,1,JEAN,1489,166,5,24,29,17.2%,10m
50111,2,Ardum,1489,154,4,7,11,36.4%,1h
50111,2,BobZeeCommy,1489,40,1,3,4,25.0%,1h
50111,1,Oliver,1489,0,1,13,14,7.1%,1h
50115,1,starkid,1488,490,14,28,42,33.3%,1h
50115,2,captpicard,1488,60,3,5,8,37.5%,1h
50117,1,DannyeloT,1487,1188,37,69,106,34.9%,1h
50117,2,[ZTemps]Aegis,1487,442,14,23,37,37.8%,3h
50117,2,Angelito,1487,384,12,33,45,26.7%,1h
50117,2,JuanVicky,1487,30,1,1,2,50.0%,1h
50117,2,JKotex,1487,0,0,5,5,0.0%,39m
50122,2,SHAKU,1486,987,52,107,159,32.7%,1h
50122,2,deltaNueve,1486,1116,32,63,95,33.7%,1h
50122,2,Ripster,1486,628,21,31,52,40.4%,30m
50122,1,Khayla,1486,591,14,34,48,29.2%,1h
50126,2,Callahan,1484,340,9,19,28,32.1%,10m
50126,2,MrJakas,1484,66,3,7,10,30.0%,2m
50128,1,RalphCramden,1483,1666,73,109,182,40.1%,35m
50128,1,kin,1483,782,56,83,139,40.3%,13m
50128,2,[R4YN0R]Wackywookie,1483,266,8,4,12,66.7%,3h
50128,2,lnchbx,1483,289,7,10,17,41.2%,53m
50128,2,Boson,1483,64,2,3,5,40.0%,44m
50133,2,Macaron,1482,346,12,23,35,34.3%,10m
50133,2,Wyman,1482,192,5,14,19,26.3%,1h
50135,2,Coronohoax,1481,88,2,2,4,50.0%,1h
50136,1,[TWSV]Tramlareneg,1480,1316,36,62,98,36.7%,3h
50136,2,alexisfarias,1480,674,19,35,54,35.2%,1h
50136,2,[INKA5]leambrito,1480,168,7,13,20,35.0%,10m
50136,2,HIGADO,1480,0,1,0,1,100.0%,1h
50136,3,AssMint,1480,0,0,2,2,0.0%,38m
50141,2,Gunnerguy,1479,1402,81,133,214,37.9%,1h
50141,2,Eldarion,1479,121,5,11,16,31.2%,6m
50141,2,[SyLx]MAXBRASIL,1479,177,4,9,13,30.8%,6m
50141,1,BORREGO,1479,0,3,4,7,42.9%,35m
50145,3,MonoTool,1477,30,3,8,11,27.3%,1h
50145,2,[Doko]DarkAlejo,1477,0,0,1,1,0.0%,1h
50147,3,ONEGREENMAN,1476,0,0,3,3,0.0%,1h
50148,1,XsockooX,1475,376,15,30,45,33.3%,10m
50148,1,Vanic,1475,336,9,21,30,30.0%,10m
50148,3,kennedyfried,1475,117,5,7,12,41.7%,30m
50151,1,Azalynn,1474,1208,84,119,203,41.4%,3h
50151,1,Angello,1474,1736,65,96,161,40.4%,35m
50151,1,Chaoz,1474,1148,34,76,110,30.9%,1h
50151,1,shoes,1474,95,1,9,10,10.0%,49m
50155,1,IROD,1473,473,13,22,35,37.1%,1h
50155,2,Ruski,1473,244,7,19,26,26.9%,1h
50155,2,COATL,1473,94,3,5,8,37.5%,53m
50155,3,Anderson,1473,30,2,2,4,50.0%,49m
50155,3,JUANDAVID,1473,30,2,3,5,40.0%,1h
50155,2,GGman,1473,46,1,1,2,50.0%,1h
50155,2,[LOSCTM]Alejo,1473,30,1,9,10,10.0%,1h
50162,2,ProjectBolt,1472,988,32,56,88,36.4%,1h
50162,3,Ravage,1472,30,2,7,9,22.2%,1h
50164,2,Motlee,1471,0,1,2,3,33.3%,1h
50164,2,Daniel,1471,121,1,10,11,9.1%,10m
50164,3,Wellington,1471,0,0,7,7,0.0%,50m
50167,1,maseroan,1470,374,10,17,27,37.0%,3h
50167,2,Franklin,1470,130,5,11,16,31.2%,30m
50167,1,Mrrefgp,1470,118,4,14,18,22.2%,49m
50167,2,Lifeline,1470,30,2,7,9,22.2%,1h
50167,2,anonimogamer,1470,0,1,0,1,100.0%,1h
50172,1,MATHYAX,1469,1230,41,68,109,37.6%,11m
50172,1,FazoC,1469,197,5,9,14,35.7%,10m
50172,3,Kiwi,1469,0,0,2,2,0.0%,1h
50175,1,SarSanbir,1468,949,30,53,83,36.1%,10m
50175,2,AXELPRO,1468,36,1,8,9,11.1%,14m
50177,1,Sierra,1467,734,20,35,55,36.4%,14m
50177,3,Dubs,1467,194,6,17,23,26.1%,22m
50179,2,Rae,1466,46,2,0,2,100.0%,6m
50180,2,AliShaheed,1465,224,9,13,22,40.9%,1h
50180,2,Titan,1465,53,5,10,15,33.3%,1h
50180,3,dno,1465,0,1,6,7,14.3%,4m
50180,2,Zornhau,1465,0,0,1,1,0.0%,1h
50184,2,Bok,1464,118,4,12,16,25.0%,14m
50184,3,[SBlock]nabhi,1464,0,2,2,4,50.0%,30m
50184,2,VoicedNose,1464,0,1,2,3,33.3%,10m
50187,2,AVSTHTC,1463,1330,52,75,127,40.9%,1h
50187,3,[Ir0n]zach,1463,126,5,21,26,19.2%,1h
50187,2,forseeus,1463,0,0,1,1,0.0%,1h
50190,2,ThorHanson,1461,0,1,4,5,20.0%,1h
50191,1,LazyTitan,1459,527,16,36,52,30.8%,11m
50191,2,BRANDOM,1459,262,8,15,23,34.8%,1h
50191,3,shaokhan,1459,30,1,2,3,33.3%,30m
50194,3,kratoss,1458,748,26,55,81,32.1%,3h
50194,2,luizgoro,1458,0,1,0,1,100.0%,1h
50194,3,Nanislayer,1458,0,0,4,4,0.0%,1h
50197,3,DaveDaGreat,1457,419,13,40,53,24.5%,29m
50197,1,BergBR,1457,294,8,28,36,22.2%,1h
50197,2,kbuck,1457,144,3,4,7,42.9%,3h
50197,3,[BDEA]frdsfrds,1457,0,0,2,2,0.0%,3h
50197,2,Lautaro,1457,73,0,2,2,0.0%,3h
50202,2,nabz,1456,1407,58,107,165,35.2%,1h
50202,2,mchap,1456,476,17,44,61,27.9%,36m
50202,1,ARTANHYS,1456,394,12,23,35,34.3%,35m
50202,3,Xod,1456,154,6,13,19,31.6%,22m
50202,1,[TY4GG]Grandma,1456,34,1,11,12,8.3%,10m
50207,1,MarvelousOne,1455,1672,69,110,179,38.5%,49m
50207,1,SEBA,1455,0,1,15,16,6.2%,1h
50209,3,Elusive,1454,82,4,11,15,26.7%,3h
50209,3,[FL0H]Sapopeta,1454,0,0,2,2,0.0%,3h
50211,1,Bodad,1452,386,10,30,40,25.0%,1h
50211,2,HJODQWEHGEDW,1452,242,8,16,24,33.3%,39m
50211,3,TeddyBear,1452,170,6,6,12,50.0%,49m
50211,2,Darthblaze,1452,165,5,5,10,50.0%,1h
50211,2,IceCube,1452,73,2,12,14,14.3%,1h
50211,2,Nimbus,1452,0,0,1,1,0.0%,53m
50217,1,Thorin,1451,1706,97,147,244,39.8%,1h
50218,2,Killercat,1450,444,14,24,38,36.8%,3h
50218,2,Tronorious,1450,140,4,12,16,25.0%,1h
50218,3,maestor,1450,0,0,2,2,0.0%,1h
50221,2,ManuelChiw,1449,1221,47,79,126,37.3%,1h
50221,2,marduk,1449,680,20,44,64,31.2%,3h
50221,1,TGH,1449,392,9,23,32,28.1%,60m
50221,3,TheBestAtSC,1449,166,5,9,14,35.7%,1h
50221,2,[MEG]rana,1449,0,1,5,6,16.7%,39m
50226,2,dagee,1447,201,16,22,38,42.1%,1h
50226,3,Tonyschreib,1447,70,4,8,12,33.3%,30m
50226,2,Ravenwolf,1447,121,3,2,5,60.0%,10m
50229,2,BBLuis,1446,119,3,6,9,33.3%,1h
50229,3,FreeBelarus,1446,0,0,1,1,0.0%,1h
50231,1,GaryBoyK,1445,346,9,34,43,20.9%,3h
50231,2,DankMeme,1445,222,8,7,15,53.3%,10m
50231,3,ERIK,1445,130,4,6,10,40.0%,49m
50231,3,nrhythmic,1445,0,0,1,1,0.0%,1h
50231,3,Saphric,1445,0,0,6,6,0.0%,1h
50236,1,[Pyroz]DARKMATTER,1444,580,17,35,52,32.7%,1h
50236,3,Alimaña,1444,46,2,9,11,18.2%,22m
50236,2,DaWest,1444,0,0,1,1,0.0%,10m
50236,3,QuillWarrior,1444,0,0,5,5,0.0%,1h
50240,2,Benito,1443,680,20,40,60,33.3%,1h
50240,1,TIGRILLO,1443,498,13,36,49,26.5%,3h
50240,2,goldspoon,1443,104,3,11,14,21.4%,10m
50240,2,Tristen,1443,30,1,2,3,33.3%,10m
50240,3,Marr,1443,0,0,1,1,0.0%,1h
50245,1,Watyr,1442,46,2,16,18,11.1%,3h
50245,2,[LOFP]CAVERÃO,1442,0,0,11,11,0.0%,39m
50247,1,ROROMAGNO,1441,1452,44,81,125,35.2%,19m
50247,2,MrRobot,1441,86,3,8,11,27.3%,6m
50247,2,Garuda,1441,30,1,5,6,16.7%,53m
50250,2,CrowJoe,1440,60,4,6,10,40.0%,10m
50250,2,sableye,1440,104,2,7,9,22.2%,10m
50252,3,quoteunquote,1439,1494,129,186,315,41.0%,49m
50252,1,Mexica,1439,1771,115,178,293,39.2%,10m
50252,2,Jeev,1439,1425,49,92,141,34.8%,29m
50252,2,ELJOÃObrKS,1439,58,7,1,8,87.5%,2m
50252,1,TonyStark,1439,230,6,32,38,15.8%,13m
50252,2,STARLORD,1439,154,4,20,24,16.7%,14m
50252,3,MeinTeil,1439,72,2,7,9,22.2%,50m
50259,2,ELFO,1438,658,22,36,58,37.9%,10m
50259,2,MystFasti,1438,216,6,11,17,35.3%,39m
50259,2,Deerx,1438,73,0,11,11,0.0%,10m
50262,2,Eison,1437,248,9,15,24,37.5%,53m
50262,2,NickNack,1437,286,9,16,25,36.0%,3h
50262,2,BORGATO,1437,0,2,3,5,40.0%,10m
50262,2,kheoomega,1437,0,0,6,6,0.0%,1h
50266,2,Protosspro,1435,114,4,7,11,36.4%,10m
50266,2,Hellboy,1435,74,3,7,10,30.0%,30m
50268,1,crazymagg,1434,210,5,27,32,15.6%,13m
50268,2,DAHV,1434,78,2,4,6,33.3%,1h
50270,2,roger,1433,257,8,4,12,66.7%,14m
50270,3,[cluez]jair,1433,0,0,1,1,0.0%,30m
50270,3,Setmasked,1433,0,0,5,5,0.0%,1h
50273,2,chuckster,1432,732,23,36,59,39.0%,30m
50273,2,xavier,1432,168,8,13,21,38.1%,3h
50273,2,Saltman,1432,0,0,5,5,0.0%,6m
50276,1,TakeDown,1430,1093,120,211,331,36.3%,3h
50276,2,jandar,1430,398,12,24,36,33.3%,1h
50276,1,JCrack,1430,82,2,12,14,14.3%,35m
50279,2,Nogiigiiiii,1429,76,2,20,22,9.1%,14m
50280,2,king,1428,436,13,38,51,25.5%,15m
50280,2,Rico,1428,136,2,3,5,40.0%,6m
50280,3,greenlee,1428,0,0,4,4,0.0%,3h
50283,1,[dodgy]KOLOBOK,1427,248,8,21,29,27.6%,11m
50284,2,nko,1426,1556,49,98,147,33.3%,10m
50284,1,leonidas,1426,490,14,40,54,25.9%,56m
50284,2,MADMAX,1426,276,8,29,37,21.6%,29m
50284,2,jhonytest,1426,0,0,1,1,0.0%,1h
50288,2,Stukov,1425,236,8,15,23,34.8%,30m
50289,1,VICTORY,1423,1669,51,92,143,35.7%,4m
50289,2,EVM,1423,1112,37,67,104,35.6%,15m
50291,2,[Weac]ConFuSed,1422,296,11,14,25,44.0%,10m
50291,3,jhudihangel,1422,291,9,24,33,27.3%,11m
50293,1,Ghostface,1421,1378,64,94,158,40.5%,1h
50293,2,KimJongTrill,1421,210,7,28,35,20.0%,1h
50293,3,sgtmalone,1421,148,6,21,27,22.2%,11m
50293,2,Owl,1421,60,3,8,11,27.3%,10m
50297,3,Decreed,1420,1552,110,172,282,39.0%,25m
50297,1,Sporticus,1420,897,54,92,146,37.0%,49m
50297,2,Tex,1420,108,3,19,22,13.6%,1h
50300,3,PeenerPopper,1419,46,1,6,7,14.3%,1h
50301,2,rolygo,1417,1262,42,78,120,35.0%,54m
50301,2,Javert,1417,763,22,52,74,29.7%,1h
50301,2,Hagar,1417,437,13,22,35,37.1%,3m
50301,3,keithtan,1417,0,0,1,1,0.0%,38m
50301,2,kevin,1417,0,0,4,4,0.0%,44m
50301,2,TurkeyCheese,1417,73,0,11,11,0.0%,10m
50307,2,Mvdreno,1416,112,4,11,15,26.7%,15m
50307,1,shamgar,1416,0,1,8,9,11.1%,1h
50309,2,[DMONlC]jhjhggj,1415,356,10,18,28,35.7%,1h
50309,2,DinoKiller,1415,0,1,0,1,100.0%,54m
50311,2,ivann,1414,284,16,30,46,34.8%,1h
50311,2,Mathieu,1414,0,0,15,15,0.0%,6m
50313,2,ZeratuL,1413,249,5,22,27,18.5%,10m
50313,1,Dragonlord,1413,60,3,18,21,14.3%,4m
50313,3,[KABOOM]DALMATiaN,1413,0,1,4,5,20.0%,1h
50316,2,[SCow]SickCowPie,1412,141,5,10,15,33.3%,1h
50317,1,JimmyRaynor,1411,724,24,44,68,35.3%,1h
50317,2,Blanka,1411,300,8,29,37,21.6%,10m
50317,2,hahahay,1411,0,0,1,1,0.0%,1h
50320,2,LionHeart,1410,195,4,11,15,26.7%,29m
50320,3,Reinoso,1410,42,1,6,7,14.3%,3h
50322,2,ssotorp,1409,459,14,22,36,38.9%,1h
50323,1,freddyman,1408,844,22,45,67,32.8%,1h
50323,2,Reeper,1408,476,14,19,33,42.4%,1h
50325,1,HORUS,1407,378,9,38,47,19.1%,11m
50326,2,MrBugYT,1406,107,1,4,5,20.0%,3m
50326,2,Zexonith,1406,30,1,7,8,12.5%,6m
50326,2,KarlMagnus,1406,73,0,7,7,0.0%,10m
50326,3,Keyjo,1406,0,0,7,7,0.0%,3h
50330,2,[xDYEx]GerardoG,1405,132,4,8,12,33.3%,53m
50331,1,Truedrew,1404,1568,52,89,141,36.9%,35m
50331,3,[420th]HighArcMage,1404,0,0,1,1,0.0%,30m
50333,2,Edgar,1403,1024,33,61,94,35.1%,44m
50333,2,lee,1403,886,28,53,81,34.6%,1h
50335,2,DontTouchMe,1402,0,1,0,1,100.0%,3h
50336,2,Mercenary,1401,228,8,15,23,34.8%,3h
50336,3,TaeKa,1401,92,3,19,22,13.6%,1h
50338,1,[TRVMPD]Terrannuker,1400,1083,34,68,102,33.3%,1h
50338,2,EmperorCarne,1400,112,2,6,8,25.0%,6m
50338,2,[EMV]Dizzy,1400,30,1,5,6,16.7%,6m
50338,3,Katabatic,1400,0,0,1,1,0.0%,1h
50342,3,Raphael,1399,0,0,1,1,0.0%,1h
50343,2,Wolfman,1398,90,4,12,16,25.0%,6m
50343,3,VegetaZerG,1398,0,1,2,3,33.3%,29m
50343,2,Depredador,1398,0,0,2,2,0.0%,6m
50346,2,Shalon,1397,0,1,4,5,20.0%,10m
50347,2,FunkyMonkey,1396,710,34,51,85,40.0%,30m
50347,1,[DarkPG]Ignaciocapo,1396,348,10,26,36,27.8%,35m
50349,2,modelo,1394,534,15,26,41,36.6%,3h
50349,3,[C38108]RazzleDazzle,1394,0,0,2,2,0.0%,1h
50351,2,concon,1393,825,37,69,106,34.9%,1h
50352,1,nome,1392,46,2,10,12,16.7%,25m
50353,1,Naofumi,1391,412,11,28,39,28.2%,56m
50353,3,ElyasToor,1391,74,2,9,11,18.2%,30m
50355,2,Forkey,1390,750,26,73,99,26.3%,3h
50355,2,YanisDagobah,1390,93,1,2,3,33.3%,54m
50357,2,BAMBAM,1387,228,14,36,50,28.0%,1h
50357,2,MeBadNoMad,1387,0,0,5,5,0.0%,10m
50359,2,Davi,1385,788,23,48,71,32.4%,3h
50360,2,Kille,1384,0,3,8,11,27.3%,1h
50360,2,Maryjane,1384,70,2,8,10,20.0%,3h
50362,1,Executor,1383,1382,63,120,183,34.4%,1h
50362,2,Shadowmaster,1383,141,5,4,9,55.6%,1h
50364,2,nico,1382,1595,67,162,229,29.3%,3h
50364,2,Roberto,1382,265,5,25,30,16.7%,3h
50364,2,Xavier,1382,102,4,10,14,28.6%,10m
50367,2,Hugo,1381,88,1,6,7,14.3%,10m
50368,2,JJLew,1380,1405,76,163,239,31.8%,1h
50368,2,Destroyer,1380,677,23,31,54,42.6%,1h
50368,2,Toshi,1380,141,6,7,13,46.2%,14m
50368,3,Showtime,1380,88,3,17,20,15.0%,1h
50368,2,Egoneronomo,1380,30,2,18,20,10.0%,29m
50373,3,BLOWTHEMUP,1379,0,0,3,3,0.0%,38m
50374,2,WolfSoldner,1376,626,21,40,61,34.4%,3h
50374,2,[C96741]Burgernose,1376,490,15,27,42,35.7%,3h
50374,3,gama,1376,196,7,33,40,17.5%,57m
50374,3,[Blacer]alleycat,1376,260,7,47,54,13.0%,1h
50374,2,shard,1376,0,0,2,2,0.0%,6m
50374,3,sam,1376,0,0,7,7,0.0%,49m
50380,2,kiwimaori,1375,86,3,7,10,30.0%,1h
50381,2,TheLoneWolfe,1374,416,13,33,46,28.3%,44m
50381,3,Mark,1374,76,4,17,21,19.0%,1h
50381,3,angryblkbear,1374,0,0,1,1,0.0%,3h
50384,2,[SYNDCT]frankenstein,1372,36,1,7,8,12.5%,1h
50385,1,mlangley,1371,362,12,38,50,24.0%,3h
50385,3,TemplarDT,1371,116,5,29,34,14.7%,38m
50387,3,juiceling,1370,0,0,1,1,0.0%,1h
50388,1,Erpe,1369,458,15,38,53,28.3%,4m
50388,2,Lyghtning,1369,178,6,11,17,35.3%,1h
50390,2,osva,1367,158,4,24,28,14.3%,3h
50390,2,KennyLR,1367,0,1,5,6,16.7%,10m
50390,2,BUSHIDO,1367,0,0,4,4,0.0%,10m
50390,3,motz,1367,0,0,5,5,0.0%,43m
50394,1,PaddyQ,1365,1690,47,106,153,30.7%,24m
50394,2,gralTIZIANO,1365,618,18,42,60,30.0%,1h
50394,1,BBattleBott,1365,358,12,32,44,27.3%,1h
50394,2,WBUSH,1365,408,12,32,44,27.3%,10m
50394,2,corral,1365,252,9,19,28,32.1%,10m
50394,2,Spekna,1365,68,2,9,11,18.2%,1h
50394,3,Leandrus,1365,30,1,10,11,9.1%,4m
50401,2,karwave,1364,1516,53,84,137,38.7%,54m
50401,2,Player,1364,0,0,4,4,0.0%,1h
50403,1,[ERFT]Mayor,1363,597,40,70,110,36.4%,50m
50403,2,patadaenlos,1363,326,12,20,32,37.5%,10m
50403,3,Sam,1363,64,2,16,18,11.1%,2h
50406,2,Crowley,1362,786,27,45,72,37.5%,54m
50406,2,silver,1362,682,25,28,53,47.2%,15m
50406,2,MateoVR,1362,68,2,17,19,10.5%,1h
50409,3,Tom,1361,36,1,2,3,33.3%,1h
50410,2,Fenixdeath,1360,200,5,29,34,14.7%,44m
50411,2,Lotran,1358,834,27,51,78,34.6%,1h
50411,3,[FltBat]JOEY,1358,0,0,7,7,0.0%,3h
50413,2,kingkooler,1357,950,27,64,91,29.7%,10m
50414,2,Ibrahim,1356,0,1,1,2,50.0%,54m
50415,3,celticsBR,1355,158,5,18,23,21.7%,1h
50415,3,XzX,1355,0,0,1,1,0.0%,1h
50415,2,jayden,1355,0,0,2,2,0.0%,53m
50415,3,jayoda,1355,0,0,4,4,0.0%,50m
50419,2,Luckysam,1354,0,1,7,8,12.5%,1h
50420,2,Mark,1353,366,9,28,37,24.3%,14m
50421,3,[BraziI]Ramjet,1352,0,0,1,1,0.0%,43m
50422,2,Werdwolf,1351,302,9,22,31,29.0%,10m
50423,2,raulin,1349,88,1,3,4,25.0%,1h
50424,2,DFSketch,1348,114,2,3,5,40.0%,1h
50424,2,[Z1a]Ziamonkey,1348,117,2,7,9,22.2%,10m
50424,3,[K0D]deathnite,1348,0,0,5,5,0.0%,1h
50424,3,Orion,1348,0,0,5,5,0.0%,1h
50428,1,oblete,1347,824,25,63,88,28.4%,4m
50429,1,ompa,1346,1712,163,258,421,38.7%,3h
50430,3,[KhanZ]terran,1345,152,6,13,19,31.6%,1h
50431,2,ColdSweat,1344,144,4,4,8,50.0%,1h
50431,3,brsafado,1344,0,2,4,6,33.3%,1h
50433,2,[Atena]wickywoo,1343,90,1,9,10,10.0%,3h
50433,2,danielnnina,1343,107,1,10,11,9.1%,10m
50435,3,detpackz,1342,30,1,5,6,16.7%,1h
50436,2,Shadieeeeeee,1341,427,15,33,48,31.2%,30m
50437,3,holacomoewsk,1336,132,5,4,9,55.6%,1h
50438,2,Lucia,1334,1543,59,104,163,36.2%,6m
50439,3,GhostDragon,1333,86,5,8,13,38.5%,50m
50439,3,[BirosK]Nerd,1333,0,0,18,18,0.0%,1h
50441,3,Tomcat,1332,30,2,5,7,28.6%,22m
50442,2,SugarBoi,1331,170,3,12,15,20.0%,10m
50442,2,botplayer,1331,30,1,7,8,12.5%,6m
50444,1,PPersia,1329,1685,70,117,187,37.4%,20m
50444,3,JUKEIIEY,1329,58,3,0,3,100.0%,50m
50446,2,runner,1328,678,19,48,67,28.4%,3h
50446,3,colo,1328,286,11,15,26,42.3%,38m
50446,2,StretchSC,1328,221,5,13,18,27.8%,54m
50446,3,Cornelius,1328,0,0,3,3,0.0%,50m
50450,1,[YEETRZ]yeetman,1327,946,29,71,100,29.0%,35m
50450,1,[Eat314]CubaNuke,1327,688,22,47,69,31.9%,13m
50450,3,[xToGx]Mystery,1327,0,1,0,1,100.0%,50m
50453,2,Blankey,1325,66,3,14,17,17.6%,1h
50453,3,ofodao,1325,0,0,6,6,0.0%,23m
50455,3,[BS1]BATTLEO,1323,30,1,7,8,12.5%,50m
50456,2,ALLENCHILE,1322,68,2,14,16,12.5%,53m
50457,3,Odin,1321,230,8,36,44,18.2%,1h
50458,3,Jyveks,1320,168,10,1,11,90.9%,30m
50458,2,[HR4]Nelkhael,1320,62,2,14,16,12.5%,1h
50458,3,JTJ,1320,0,1,9,10,10.0%,3h
50461,1,SDMeridian,1319,237,7,34,41,17.1%,20m
50461,2,battlefist,1319,158,5,15,20,25.0%,1h
50463,2,GUZULO,1317,651,19,64,83,22.9%,30m
50464,1,Psignosys,1316,1680,195,317,512,38.1%,13m
50464,3,CHUGGY,1316,0,1,4,5,20.0%,38m
50466,3,sonic,1314,192,6,13,19,31.6%,1h
50467,2,[NAGGR5]Cirrus,1311,385,11,21,32,34.4%,29m
50468,3,tupacamaruII,1310,568,20,34,54,37.0%,1h
50469,3,grizz,1309,0,0,4,4,0.0%,1h
50469,3,chimpandolfo,1309,0,0,7,7,0.0%,29m
50471,2,Billy,1307,292,9,32,41,22.0%,3h
50471,2,ficcio,1307,254,5,24,29,17.2%,1h
50471,2,[DOOM10]masterchief,1307,134,3,12,15,20.0%,1h
50471,3,Notejogo,1307,60,2,10,12,16.7%,50m
50475,3,ttt,1306,88,3,11,14,21.4%,38m
50475,3,RAUL,1306,0,0,1,1,0.0%,4m
50477,1,erikthered,1303,536,16,51,67,23.9%,49m
50478,1,Extortionist,1302,1370,48,84,132,36.4%,3h
50478,3,Basthyan,1302,58,2,3,5,40.0%,1h
50480,2,Andrewweber,1301,233,6,26,32,18.8%,10m
50480,3,stargui,1301,30,1,4,5,20.0%,30m
50482,2,freewheeler,1299,138,4,25,29,13.8%,37m
50482,3,bruno,1299,0,0,3,3,0.0%,3h
50484,3,uwu,1298,0,2,7,9,22.2%,1h
50485,3,AtilaElHuno,1295,822,24,64,88,27.3%,3h
50485,3,zGhosty,1295,76,3,12,15,20.0%,1h
50487,2,Elias,1294,336,13,38,51,25.5%,1h
50487,3,hydesy,1294,177,7,10,17,41.2%,50m
50487,3,[2009]DaveX,1294,46,2,6,8,25.0%,1h
50487,1,ZisupaS,1294,0,0,11,11,0.0%,12m
50491,3,paposky,1293,90,3,6,9,33.3%,1h
50492,3,Crow,1289,0,0,1,1,0.0%,38m
50493,3,Mistblade,1288,60,4,11,15,26.7%,1h
50494,3,spike,1287,98,3,13,16,18.8%,50m
50495,2,BOoM,1286,1486,78,148,226,34.5%,1h
50496,2,Deo,1284,1406,68,158,226,30.1%,1h
50496,2,TaguatoHovy,1284,849,49,110,159,30.8%,1h
50496,3,Hunter,1284,104,3,7,10,30.0%,50m
50499,2,xdelpro,1281,302,9,40,49,18.4%,3h
50499,3,LeetPuff,1281,134,4,11,15,26.7%,43m
50501,2,sectionist,1275,191,10,25,35,28.6%,1h
50501,2,ShadowDragon,1275,290,8,34,42,19.0%,1h
50503,1,Dohja,1270,0,1,10,11,9.1%,11m
50503,3,masterjx,1270,0,0,4,4,0.0%,38m
50505,2,GLAZ,1269,90,5,12,17,29.4%,1h
50506,3,ElPepo,1268,0,0,8,8,0.0%,1h
50507,3,walteparaiso,1265,316,10,26,36,27.8%,1h
50508,2,ViddyD,1261,840,75,168,243,30.9%,1h
50509,2,MISTERJORDAN,1257,196,6,33,39,15.4%,3h
50510,1,Cardano,1252,154,5,28,33,15.2%,1h
50511,3,comando,1251,0,2,6,8,25.0%,1h
50512,3,egk,1250,60,4,17,21,19.0%,1h
50513,3,Maverick,1247,60,2,6,8,25.0%,38m
50514,3,[LETAL]javito,1243,58,4,9,13,30.8%,50m
50515,2,ROGER,1238,118,2,10,12,16.7%,3h
50515,3,acenizasYT,1238,0,0,2,2,0.0%,44m
50517,2,RULES,1236,232,6,29,35,17.1%,3h
50517,1,SpyteSoulmat,1236,120,5,60,65,7.7%,3h
50519,2,ReMaCHeZ,1233,1480,61,126,187,32.6%,1h
50520,3,trioptikos,1232,70,2,21,23,8.7%,23m
50521,3,lllllllllll,1221,0,0,2,2,0.0%,1h
50522,3,jefemaestro,1220,58,2,2,4,50.0%,4m
50522,3,Agamemnon,1220,0,0,3,3,0.0%,23m
50524,3,Bola,1218,46,1,10,11,9.1%,18m
50525,2,hyperia,1214,521,14,42,56,25.0%,1h
50526,3,kob,1211,30,1,8,9,11.1%,1h
50527,3,DavisIsrael,1210,316,12,23,35,34.3%,44m
50528,3,gambito,1209,27,6,22,28,21.4%,1h
50529,3,NENGOFLOW,1207,1088,37,102,139,26.6%,30m
50529,3,Summoner,1207,0,0,1,1,0.0%,1h
50531,3,raistlin,1202,36,2,6,8,25.0%,38m
50531,3,Hurricane,1202,0,0,1,1,0.0%,38m
50533,1,Camelfarmer,1201,300,10,39,49,20.4%,5m
50534,3,battleborn,1200,30,1,1,2,50.0%,50m
50535,2,Chess,1199,30,3,11,14,21.4%,10m
50536,3,pity,1196,892,30,86,116,25.9%,38m
50537,3,Cayto,1195,0,0,1,1,0.0%,22m
50538,2,Jabrevski,1191,555,13,53,66,19.7%,10m
50538,3,Detpack,1191,0,0,9,9,0.0%,50m
50540,3,weeedman,1189,0,0,5,5,0.0%,44m
50541,3,[MTZCC]Lexel,1183,0,0,8,8,0.0%,44m
50542,3,Foodle,1176,44,2,22,24,8.3%,1h
50543,2,Ryan,1174,212,6,17,23,26.1%,1h
50543,3,[foxsay]Fantasy,1174,0,0,6,6,0.0%,38m
50545,3,dogman,1159,416,15,27,42,35.7%,1h
50545,3,Velius,1159,130,4,24,28,14.3%,23m
50547,3,lyon,1158,0,0,3,3,0.0%,3h
50548,3,ruben,1157,216,7,10,17,41.2%,3h
50549,2,Murdock,1153,506,14,52,66,21.2%,10m
50550,3,Naurto,1152,30,2,12,14,14.3%,1h
50550,3,Craftystar,1152,0,1,10,11,9.1%,1h
50552,3,DinDjarin,1148,64,2,16,18,11.1%,1h
50553,3,darkcy,1145,0,1,2,3,33.3%,44m
50554,3,BronzeHero,1138,0,0,2,2,0.0%,1h
50555,3,mct,1128,100,4,14,18,22.2%,1h
50556,3,Britolex,1126,0,1,6,7,14.3%,3h
50557,3,WONGFEHUNG,1116,30,1,13,14,7.1%,4m
50558,3,globlwarming,1112,30,1,10,11,9.1%,50m
50559,2,Overwatch,1105,600,18,66,84,21.4%,15m
50560,3,Bob,1094,240,7,40,47,14.9%,23m
50561,3,green,1089,244,8,18,26,30.8%,44m
50562,3,Fairy,1085,240,7,28,35,20.0%,1h
50563,3,JamminJohn,1083,216,9,19,28,32.1%,1h
50564,3,JumpinJames,1074,364,12,30,42,28.6%,1h
50565,3,hazemaker,1052,36,1,8,9,11.1%,1h
50566,3,Asellus,1050,285,23,83,106,21.7%,30m
50567,2,[BNJWA]Blinkatl,1047,97,10,58,68,14.7%,1h
50568,3,LittleFat,1044,60,2,3,5,40.0%,1h
50569,3,glhf,953,30,2,22,24,8.3%,1h
50570,1,agjil,908,1190,442,643,1085,40.7%,45m
50571,3,miguelh,876,90,3,7,10,30.0%,38m
50572,3,Ceorl,863,636,19,57,76,25.0%,1h
50573,3,[4bronz]starlove,688,1191,97,378,475,20.4%,38m
50574,2,[coI]AboveTheLaw,639,1056,500,593,1093,45.7%,10m
50575,3,Cusigma,522,0,0,6,6,0.0%,1h
50576,3,WorstplyrNA,519,0,0,5,5,0.0%,1h
50577,3,[EZDUNK]nishidiaosi,336,102,3,79,82,3.7%,3h
50578,2,TheShadows,176,264,7,148,155,4.5%,33m
50579,1,Attikus,0,1706,91,103,194,46.9%,45m
