rank,tier,name,mmr,points,wins,losses,played,winrate,age
1,1,[BJWD]MaBaoGuo,6601,1104,50,26,76,65.8%,34m
2,1,Scarlett,6584,48,2,0,2,100.0%,42m
3,1,Denver,6348,0,0,1,1,0.0%,31m
4,1,[PSISTM]Namshar,6317,1848,113,41,154,73.4%,29m
5,1,[ArGNA]SortOf,6298,48,1,5,6,16.7%,24m
6,1,[PSISTM]Namshar,6267,192,5,1,6,83.3%,42m
7,1,Dark,6243,192,4,2,6,66.7%,28m
8,1,llllllllllll,6171,526,12,3,15,80.0%,41m
9,1,LeGoatJames,6162,415,22,8,30,73.3%,15m
10,1,[Ex0n]Cham,6138,3689,370,120,490,75.5%,3m
11,1,[ArGNA]McMonroe,6125,0,1,0,1,100.0%,28m
12,1,[JIGLY]MèoMáiKà,6119,3666,1381,436,1817,76.0%,3m
13,1,Reaper,6114,0,1,0,1,100.0%,26m
14,1,TLO,6077,803,26,19,45,57.8%,15m
15,1,[PSISTM]JonSnow,6063,1075,55,34,89,61.8%,41m
16,1,IIIIIIIIIIII,6027,0,1,0,1,100.0%,23m
17,1,Zulrah,6008,411,68,29,97,70.1%,42m
18,1,IIIIIIIIIIII,5935,0,1,0,1,100.0%,32m
19,1,[xRtG]Zohar,5929,693,26,5,31,83.9%,9m
20,1,Computer,5890,0,0,1,1,0.0%,41m
21,1,[αB]Instinct,5888,1585,46,25,71,64.8%,42m
22,1,[IDFI]Demi,5851,844,18,14,32,56.2%,26m
23,1,Three,5845,613,24,6,30,80.0%,9m
24,1,SwagSurgeon,5844,710,16,8,24,66.7%,41m
25,1,Zerg,5826,48,1,3,4,25.0%,41m
26,1,IIIIIIIIIIII,5806,273,77,23,100,77.0%,42m
27,1,[l4dd3r]Elazer,5795,240,6,0,6,100.0%,24m
28,1,[Ex0n]Bioice,5779,3393,438,306,744,58.9%,3m
29,1,Five,5773,454,16,14,30,53.3%,3m
30,1,Lurker,5749,48,2,1,3,66.7%,23m
31,1,IlIlIlIlIlIl,5748,1616,43,23,66,65.2%,34m
32,1,[RnGpro]Flood,5747,0,0,1,1,0.0%,32m
33,1,[RnGpro]ScribbleS,5746,48,2,0,2,100.0%,29m
34,1,Tabarnak,5745,1051,50,24,74,67.6%,15m
34,1,IlIlIlIlIlIl,5745,0,0,1,1,0.0%,38m
36,1,[ROOT]NoRegreT,5738,430,10,6,16,62.5%,26m
37,1,IIIIIIIIIIII,5722,286,7,2,9,77.8%,37m
38,1,lIlIllIllIll,5720,288,7,4,11,63.6%,23m
39,1,[αX]FireFoX,5710,0,0,1,1,0.0%,42m
40,1,[IDFI]MeomaikaFan,5678,764,54,25,79,68.4%,42m
41,1,[YMTT]ScrubbleS,5677,0,0,1,1,0.0%,42m
42,1,[αXLa]eGGz,5667,1932,77,34,111,69.4%,41m
42,1,[RnGpro]scrobl,5667,48,2,8,10,20.0%,42m
44,1,[ArGNA]Jig,5661,2458,91,77,168,54.2%,3m
45,1,[RGAN]Railgan,5659,240,6,7,13,46.2%,9m
46,1,[PiGPan]PiG,5654,2703,97,99,196,49.5%,3m
47,1,[IDFI]MeomaikaFan,5646,0,0,1,1,0.0%,9m
48,1,Thirteen,5644,547,21,14,35,60.0%,3m
49,1,Fourteen,5643,380,8,13,21,38.1%,29m
50,1,CaydeSix,5640,562,24,15,39,61.5%,24m
51,1,[ArGNA]PandaBearMe,5636,3268,178,143,321,55.5%,3m
52,1,Golden,5626,3361,326,289,615,53.0%,3m
53,1,[AeonTK]llllllllllll,5621,0,1,0,1,100.0%,23m
54,1,Fifteen,5616,238,6,0,6,100.0%,28m
55,1,[afterM]Voltz,5614,2418,94,48,142,66.2%,3m
56,1,[Th3Bad]TheZergLord,5613,1279,62,37,99,62.6%,42m
56,1,llllllllllll,5613,514,12,7,19,63.2%,34m
58,1,llllllllllll,5612,1180,29,17,46,63.0%,39m
59,1,Nanika,5605,0,1,0,1,100.0%,15m
60,1,IIIIIIIIIIII,5601,0,0,5,5,0.0%,9m
61,1,[αX]starkiller,5600,1858,140,100,240,58.3%,29m
62,1,Ten,5598,434,15,15,30,50.0%,3m
63,1,[αX]MaSa,5594,0,0,2,2,0.0%,15m
64,1,CàPhêSuaDá,5589,48,2,3,5,40.0%,34m
65,1,IIIIIIIIIIII,5586,3279,323,224,547,59.0%,3m
66,1,Marines,5585,0,1,9,10,10.0%,9m
67,1,Two,5580,462,18,14,32,56.2%,29m
68,1,[dastan]selacome,5577,560,12,10,22,54.5%,28m
69,1,[Ex0n]Burninator,5576,48,1,1,2,50.0%,42m
70,1,[Macac0]JimRising,5570,3024,104,90,194,53.6%,3m
71,1,Six,5559,499,19,12,31,61.3%,3m
72,1,Eleven,5555,491,18,16,34,52.9%,3m
72,1,[αX]Relapse,5555,648,14,6,20,70.0%,42m
74,1,[RnGpro]Prototype,5544,1961,89,62,151,58.9%,37m
75,1,llllllllllll,5536,798,19,11,30,63.3%,26m
76,1,Eight,5534,486,17,13,30,56.7%,3m
76,1,Four,5534,417,15,16,31,48.4%,3m
78,1,[HSPAS]SHAH,5533,2065,107,53,160,66.9%,3m
79,1,CptButtBeard,5532,96,2,4,6,33.3%,41m
80,1,llllllllllll,5530,601,25,14,39,64.1%,28m
81,1,Scientist,5524,558,21,15,36,58.3%,10m
82,1,[hTx]Donnyboy,5518,1115,37,23,60,61.7%,9m
83,1,IIIIIIIIIIII,5513,1133,230,128,358,64.2%,28m
83,1,[ROOT]Mackintac,5513,1337,71,49,120,59.2%,23m
85,1,Zerglings,5510,220,8,8,16,50.0%,31m
86,1,Duck,5502,2002,306,231,537,57.0%,15m
87,1,IIIIIIIIIIII,5501,528,12,13,25,48.0%,28m
88,1,Starlord,5487,448,10,13,23,43.5%,26m
89,1,[RnGpro]Flood,5479,267,8,5,13,61.5%,3m
89,1,IIIIIIIIIIII,5479,0,0,9,9,0.0%,42m
91,1,Oreo,5477,832,21,14,35,60.0%,28m
91,1,NightSky,5477,144,4,1,5,80.0%,24m
91,1,owL,5477,0,0,1,1,0.0%,28m
94,1,IIllIIIllIlI,5475,34,2,1,3,66.7%,41m
95,1,One,5473,391,15,15,30,50.0%,23m
96,1,IIIIIIIIIIII,5472,666,35,23,58,60.3%,24m
97,1,Twelve,5470,433,16,14,30,53.3%,3m
98,1,[MFSC2]Chase,5467,0,1,0,1,100.0%,28m
99,1,CHiPZ,5465,587,25,25,50,50.0%,3m
100,1,[lCY]CalebAracous,5464,1005,31,29,60,51.7%,24m
101,1,memOryfreak,5460,1740,77,54,131,58.8%,41m
102,1,Prometheus,5453,1453,79,60,139,56.8%,41m
103,1,[Ex0n]fullheart,5445,46,3,1,4,75.0%,28m
104,1,ShihYat,5441,992,23,20,43,53.5%,26m
105,1,[JIGLY]uWu,5439,48,1,3,4,25.0%,32m
105,1,[VlRGlN]Nicole,5439,0,0,3,3,0.0%,42m
107,1,[BRAAAP]GuruFan,5428,820,28,22,50,56.0%,3m
107,1,[LGCANZ]NXZ,5428,94,3,7,10,30.0%,41m
109,1,[Ris3n]fshhsdhf,5427,3164,571,453,1024,55.8%,3m
110,1,[Scyth]wAesoph,5425,0,0,1,1,0.0%,29m
111,1,[RnGpro]ScrubbleS,5420,1742,79,56,135,58.5%,15m
112,1,[Gainss]Weight,5417,94,2,1,3,66.7%,28m
113,1,FoxeRFaN,5416,164,4,1,5,80.0%,42m
114,1,Nine,5414,401,14,17,31,45.2%,3m
115,1,Meditail,5411,44,1,1,2,50.0%,15m
116,1,everett,5410,48,1,3,4,25.0%,37m
117,1,[ScSwrm]MeomaikaFan,5406,1757,148,120,268,55.2%,23m
118,1,[Ari]eSsXiV,5400,611,29,32,61,47.5%,9m
119,1,Seven,5398,480,18,21,39,46.2%,3m
120,1,[prOxi]NovaX,5397,0,1,0,1,100.0%,42m
121,1,aeontech,5376,1327,41,41,82,50.0%,3m
122,1,KingkOng,5374,260,6,12,18,33.3%,41m
123,1,IIIIIIIIIIII,5369,286,6,8,14,42.9%,41m
124,1,[VlRGlN]Pastry,5357,228,5,8,13,38.5%,37m
125,1,StuartLittle,5356,314,8,3,11,72.7%,41m
126,1,Jardozer,5355,1168,57,52,109,52.3%,9m
126,1,[VlRGlN]kinger,5355,190,4,3,7,57.1%,10m
128,1,[NM8]LilRocketMan,5350,3070,227,188,415,54.7%,3m
129,1,Snake,5347,657,18,11,29,62.1%,3m
129,1,[KingSC]BattoSai,5347,0,0,1,1,0.0%,23m
131,1,FixZerg,5345,841,32,34,66,48.5%,42m
132,1,[VlRGlN]llllllllllll,5343,120,3,4,7,42.9%,24m
132,1,[Gainss]SaltDZNuts,5343,0,1,0,1,100.0%,38m
134,1,[ROOT]ViBE,5342,2401,129,113,242,53.3%,3m
135,1,llllllllllll,5335,641,41,3,44,93.2%,24m
136,1,llllllllllll,5334,3086,446,369,815,54.7%,3m
136,1,llllllllllll,5334,0,0,1,1,0.0%,39m
138,1,[BearMe]Yours,5333,36,2,1,3,66.7%,32m
139,1,llllllllllll,5332,2948,144,98,242,59.5%,3m
140,1,[Slayor]glow,5331,0,0,1,1,0.0%,28m
141,1,VibesKYJelly,5330,0,0,1,1,0.0%,28m
142,1,Nimra,5329,0,1,0,1,100.0%,34m
143,1,llllllllllll,5327,144,4,1,5,80.0%,39m
144,1,Honeybear,5322,96,2,1,3,66.7%,39m
144,1,RainbowDash,5322,0,1,0,1,100.0%,15m
144,1,IIIIIIIIIIII,5322,0,0,1,1,0.0%,37m
147,1,[GlRTH]BigDikEnergy,5318,174,5,4,9,55.6%,41m
148,1,[GdAT]Vaisravana,5317,190,5,6,11,45.5%,24m
149,1,[LTK]Spit,5315,1629,263,210,473,55.6%,3m
149,1,[NOPVP]pHSPUq,5315,1124,51,28,79,64.6%,15m
151,1,llllllllllll,5314,1332,61,53,114,53.5%,9m
151,1,[TSØP]EON,5314,1516,59,59,118,50.0%,29m
151,1,Oessy,5314,262,7,4,11,63.6%,34m
154,1,[sn1p3d]Wade,5309,332,8,4,12,66.7%,9m
155,1,[TSØP]Chuerk,5306,474,14,25,39,35.9%,9m
155,1,[AMZN]Liqht,5306,0,1,0,1,100.0%,39m
157,1,Sunrise,5305,1505,87,39,126,69.0%,41m
157,1,WhineFarmer,5305,744,24,11,35,68.6%,15m
157,1,GAMETlME,5305,48,2,1,3,66.7%,31m
160,1,IIIIIIIIIIII,5303,84,2,1,3,66.7%,9m
160,1,[QcScT]LeErOy,5303,0,0,1,1,0.0%,31m
162,1,Hunta,5302,136,3,2,5,60.0%,15m
163,1,IIIIIIIIIIII,5301,722,33,25,58,56.9%,24m
164,1,Dunno,5294,360,9,4,13,69.2%,42m
165,1,[SsaYnS]Genie,5293,665,97,50,147,66.0%,41m
166,1,Watcho,5289,0,1,0,1,100.0%,9m
167,1,spectre,5287,0,0,3,3,0.0%,23m
168,1,iaguz,5286,996,158,98,256,61.7%,28m
169,1,[MadK]Rescue,5285,2674,222,91,313,70.9%,3m
170,1,Player,5284,985,33,38,71,46.5%,38m
170,1,[lCY]Jardozer,5284,130,3,3,6,50.0%,37m
172,1,[VFam2]ViBE,5280,1375,142,129,271,52.4%,38m
173,1,[Maplez]BAAAAAAAAANG,5277,995,43,32,75,57.3%,42m
173,1,[CYG]Alpha,5277,490,23,7,30,76.7%,32m
175,1,RifleCaster,5276,48,2,2,4,50.0%,38m
176,1,[beatem]IIIIIIIIIIII,5274,184,4,3,7,57.1%,41m
177,1,[uWu69]MackDaddy,5272,2620,103,89,192,53.6%,3m
178,1,[AIlin]TheWagon,5271,0,0,1,1,0.0%,37m
179,1,[0ooooo]RedViper,5266,3075,534,428,962,55.5%,3m
179,1,[FG]EGG,5266,2913,218,164,382,57.1%,3m
179,1,llllllll,5266,0,0,1,1,0.0%,23m
182,1,Solar,5265,905,34,3,37,91.9%,37m
183,1,[aGiNA]aGiLo,5262,102,9,16,25,36.0%,26m
184,1,[αB]Hyren,5259,1752,493,409,902,54.7%,29m
184,1,[Ex0n]Drikett,5259,0,1,2,3,33.3%,9m
186,1,[Lp]BrEnDaN,5257,1666,109,72,181,60.2%,28m
187,1,[DAVFAN]David,5254,774,43,19,62,69.4%,37m
188,1,DasDuelon,5253,44,1,1,2,50.0%,42m
189,1,[Ex0n]Spy,5252,1738,289,231,520,55.6%,10m
190,1,[FxB]Blodir,5248,0,0,1,1,0.0%,26m
191,1,[GnR]circle,5240,505,21,13,34,61.8%,26m
192,1,Bairdo,5239,174,4,2,6,66.7%,34m
193,1,[NPhase]DarkImpure,5238,2729,252,187,439,57.4%,3m
193,1,[ACSS]Pixel,5238,1438,55,44,99,55.6%,15m
195,1,[HRBNGR]SeOuLStEaL,5236,0,0,1,1,0.0%,9m
196,1,kyle,5234,1090,70,51,121,57.9%,41m
196,1,[RnGpro]Thor,5234,48,1,3,4,25.0%,28m
198,1,[2faded]Lostisland,5232,648,66,12,78,84.6%,9m
198,1,[cl0udM]ScrubbLord,5232,832,32,33,65,49.2%,9m
198,1,[MFSC2]pezzaperry,5232,446,12,15,27,44.4%,23m
201,1,llllllllllll,5226,0,0,1,1,0.0%,28m
202,1,[Ex0n]SpeCial,5224,0,1,1,2,50.0%,38m
203,1,[afterM]Albino,5223,741,22,25,47,46.8%,9m
204,1,[lLgNl]Benjadeath,5221,1557,56,51,107,52.3%,39m
205,1,[UpeV]BLord,5215,92,3,1,4,75.0%,10m
205,1,DscntDblChck,5215,96,3,4,7,42.9%,41m
207,1,[Micr0]Kimchi,5208,0,0,1,1,0.0%,39m
208,1,[KiMBR]ReMy,5206,537,30,13,43,69.8%,10m
209,1,[TGCF]GOTRUMPGO,5205,0,0,1,1,0.0%,10m
210,1,[Slayor]Noomi,5204,2951,481,407,888,54.2%,3m
210,1,[gromp]yuzuru,5204,164,5,4,9,55.6%,10m
212,1,[HOKUSA]TedCruzumaki,5203,871,51,13,64,79.7%,3m
212,1,OiWatson,5203,597,23,17,40,57.5%,10m
214,1,[ArGNA]Warren,5201,578,14,21,35,40.0%,39m
215,1,[ValidG]sadsadsad,5200,48,1,1,2,50.0%,23m
216,1,EterNaL,5199,0,0,3,3,0.0%,10m
217,1,[cl0udM]GANSTA,5197,0,0,2,2,0.0%,42m
218,1,[MSFT]SeibasAhoge,5196,2685,169,145,314,53.8%,3m
219,1,[LFClan]LAChef,5195,882,27,12,39,69.2%,10m
219,1,Whistler,5195,0,1,4,5,20.0%,38m
221,1,[WNTRLY]Kittystalker,5193,0,1,0,1,100.0%,32m
222,1,Calamitas,5192,464,17,13,30,56.7%,23m
222,1,[WNTR]WinterSC,5192,0,1,0,1,100.0%,10m
224,1,[SsaYnS]Hyuna,5189,999,45,36,81,55.6%,15m
224,1,[cl0udM]OldLadyNov,5189,48,2,3,5,40.0%,24m
226,1,[Zmash]JaKeN,5188,144,4,4,8,50.0%,10m
227,1,[GdAT]Nuks,5185,322,8,10,18,44.4%,28m
228,1,[ROOT]Neuro,5182,2587,116,101,217,53.5%,3m
228,1,IIIIIIIIIIII,5182,135,4,8,12,33.3%,26m
230,1,AssToAss,5181,96,3,5,8,37.5%,37m
231,1,PowerDrift,5180,48,2,0,2,100.0%,15m
231,1,Newsh,5180,0,0,1,1,0.0%,37m
233,1,lllIIIlllIII,5178,384,10,7,17,58.8%,38m
234,1,[NerfMe]Starelf,5177,594,23,30,53,43.4%,41m
235,1,[αB]Melody,5176,2651,317,302,619,51.2%,3m
235,1,[BearMe]Waldo,5176,48,1,1,2,50.0%,29m
237,1,MadLife,5175,0,0,4,4,0.0%,42m
238,1,[AMZN]MrNovember,5174,2224,153,124,277,55.2%,15m
239,1,[TApro]Thecoolman,5172,1576,110,68,178,61.8%,29m
240,1,llllllllllll,5170,478,20,13,33,60.6%,39m
241,1,[Ris3n]Oessy,5169,474,12,20,32,37.5%,42m
242,1,[Úplná]Deprese,5168,218,6,1,7,85.7%,10m
243,1,[αX]hiohu,5167,38,1,2,3,33.3%,42m
244,1,[KOVA]Mixu,5164,0,1,0,1,100.0%,34m
245,1,[SABO]Saboteur,5162,38,1,3,4,25.0%,31m
246,1,[UpeV]Lapadula,5159,256,10,6,16,62.5%,24m
247,1,[SttE]wam,5158,0,0,4,4,0.0%,37m
248,1,[cl0udM]RogerDoger,5157,2389,303,203,506,59.9%,3m
248,1,RuFF,5157,0,2,3,5,40.0%,15m
248,1,HuzKar,5157,0,0,1,1,0.0%,24m
251,1,[gt0]CarmenTums,5154,773,45,7,52,86.5%,29m
252,1,[NwAs]BlackWing,5153,2263,164,126,290,56.6%,3m
252,1,KingHoe,5153,1324,74,27,101,73.3%,29m
252,1,[DarkAG]MichaelScott,5153,500,23,17,40,57.5%,29m
255,1,[Pig2]stephen,5151,1263,146,96,242,60.3%,15m
255,1,SnakeMarine,5151,2399,145,87,232,62.5%,3m
255,1,[MBRFN]Amy,5151,638,46,29,75,61.3%,39m
258,2,IIIIIIIIIIII,5147,0,1,0,1,100.0%,34m
259,1,[xRtG]Graphix,5146,1307,69,63,132,52.3%,41m
260,1,[ValidG]Thor,5145,1589,72,58,130,55.4%,3m
261,1,MeomaikaSimp,5138,268,6,5,11,54.5%,39m
262,1,[αX]Ravage,5133,186,6,4,10,60.0%,31m
263,1,zerg,5132,1835,104,86,190,54.7%,23m
264,1,[LTK]Redeye,5130,322,22,18,40,55.0%,23m
265,1,IIIIIIIIIIII,5124,432,11,17,28,39.3%,15m
266,1,[X17]Green,5123,212,5,14,19,26.3%,39m
266,1,IIIllIIllIIl,5123,0,4,1,5,80.0%,15m
268,1,IIIIIIIIIIII,5122,910,23,23,46,50.0%,41m
269,1,[DTokes]SmokeWeed,5121,0,1,0,1,100.0%,32m
270,1,[D3P0RT]Degenerate,5120,0,0,1,1,0.0%,24m
271,1,WinD,5116,2098,199,174,373,53.4%,34m
272,1,[nG]ZenedøR,5115,0,1,0,1,100.0%,24m
273,1,RedJohn,5114,734,27,17,44,61.4%,37m
274,1,[DikBoy]Light,5113,0,1,0,1,100.0%,26m
275,1,Fingerer,5109,234,6,1,7,85.7%,28m
275,1,Cereal,5109,18,1,6,7,14.3%,28m
277,1,[JOSUN]dkfofjcndjs,5107,0,0,1,1,0.0%,41m
278,1,HaZen,5106,3139,154,119,273,56.4%,9m
279,1,lIlIlIlIlIlI,5104,224,9,9,18,50.0%,15m
280,1,[GANSTA]tripletext,5101,3106,317,276,593,53.5%,23m
280,1,JackONeill,5101,0,0,1,1,0.0%,15m
282,1,Naya,5100,1766,78,67,145,53.8%,15m
283,1,Vincristine,5099,0,0,1,1,0.0%,29m
284,1,[Ex0n]Zen,5098,708,18,22,40,45.0%,34m
285,1,DaLittlePot,5097,0,0,1,1,0.0%,23m
286,1,[αX]OozamaT,5092,2674,217,161,378,57.4%,37m
287,1,hendralisk,5089,46,2,0,2,100.0%,37m
288,1,PekinWoof,5088,0,0,1,1,0.0%,9m
289,1,WINTER,5087,1264,67,24,91,73.6%,38m
289,1,DrDog,5087,0,0,3,3,0.0%,9m
291,1,robotikov,5084,832,27,12,39,69.2%,31m
291,1,[Ex0n]ETpwnHome,5084,314,8,14,22,36.4%,42m
293,1,BarnyYu,5083,1252,41,31,72,56.9%,28m
293,1,Dark,5083,319,14,12,26,53.8%,28m
295,1,[realUW]Kudralisk,5082,386,10,15,25,40.0%,39m
296,1,Parallax,5081,186,4,7,11,36.4%,28m
297,1,NoSkillZ,5080,280,23,9,32,71.9%,41m
298,1,[SCxPH]SiFu,5079,92,3,0,3,100.0%,28m
299,1,[xGenGx]PiLiPiLi,5077,1058,33,21,54,61.1%,32m
300,1,[Bvilo]Romeo,5076,796,26,10,36,72.2%,29m
301,1,ripcodebarre,5074,1500,56,41,97,57.7%,41m
301,1,[xRtG]BettyWhite,5074,298,8,2,10,80.0%,15m
303,1,[BJWD]llllllllllll,5072,46,2,0,2,100.0%,38m
304,1,[xRtG]WarlockX,5070,2499,114,105,219,52.1%,15m
304,1,Chromatic,5070,302,23,13,36,63.9%,23m
304,1,Bedsmell,5070,394,12,1,13,92.3%,42m
307,2,MillForGG,5068,88,4,8,12,33.3%,5m
308,1,[OSCE]Vivid,5065,2677,150,125,275,54.5%,23m
309,1,[Scyth]WaEsOpH,5064,2748,147,137,284,51.8%,15m
309,3,Legolas,5064,0,0,1,1,0.0%,30m
311,1,Life,5058,626,20,9,29,69.0%,23m
311,3,OpTiMiStC,5058,0,0,1,1,0.0%,35m
313,1,ScaryHours,5056,0,1,0,1,100.0%,15m
314,1,llllllllllll,5055,536,14,5,19,73.7%,32m
314,1,SkiRoO,5055,38,1,1,2,50.0%,9m
316,1,FullOfFlaw,5054,356,9,11,20,45.0%,38m
317,1,Zanjero,5052,0,1,0,1,100.0%,15m
318,1,[sc2rep]Breath,5051,3069,237,209,446,53.1%,9m
319,1,[NovaX]Ember,5050,583,52,32,84,61.9%,28m
319,1,[ScSwrm]tso,5050,296,8,11,19,42.1%,31m
321,2,EGOR,5048,255,10,3,13,76.9%,42m
322,1,llllllllllll,5047,0,1,4,5,20.0%,29m
323,1,Yoyo,5045,1756,70,37,107,65.4%,26m
324,1,[DKBUTT]Destiny,5044,1297,220,162,382,57.6%,26m
325,1,[AlIin]Yoyo,5043,1234,37,27,64,57.8%,38m
325,1,[Black0]Galeno,5043,0,1,0,1,100.0%,41m
327,1,ToallaMojada,5041,1574,71,47,118,60.2%,9m
328,1,[αXLa]GutyECUADOR,5039,1655,81,67,148,54.7%,10m
328,1,[CG]Bop,5039,290,16,15,31,51.6%,32m
330,1,[cl0udM]ZESTYZERATUL,5038,0,0,1,1,0.0%,37m
331,1,[MBRFN]PaCTom,5036,1379,131,109,240,54.6%,32m
331,1,[AlIin]Worldisdoom,5036,0,1,0,1,100.0%,26m
333,1,SacredCoco,5035,0,0,1,1,0.0%,37m
334,1,IIIIIIIIIIII,5033,0,0,1,1,0.0%,32m
335,1,newtoRTS,5032,164,7,8,15,46.7%,23m
336,1,[JaMiT]BigBoyLing,5030,532,15,8,23,65.2%,9m
337,1,Pengy,5026,751,32,7,39,82.1%,15m
338,1,Killerrj,5025,1427,64,22,86,74.4%,37m
339,1,[UpxV]llllllllll,5023,1236,36,30,66,54.5%,9m
339,1,IIIIIIIIII,5023,828,23,16,39,59.0%,28m
341,1,Arrtitek,5021,0,0,2,2,0.0%,37m
342,1,KravMaGa,5019,586,18,8,26,69.2%,23m
343,1,Sammyuel,5018,246,6,11,17,35.3%,41m
344,1,[αXLa]ByRada,5017,1836,59,58,117,50.4%,34m
344,1,[INextI]RoTtiN,5017,94,2,3,5,40.0%,24m
346,1,SnapCryptic,5016,1493,96,75,171,56.1%,31m
346,1,Magikagus,5016,1472,89,71,160,55.6%,24m
348,1,PrOzErO,5015,1212,44,24,68,64.7%,42m
348,1,[EEJ]hodenkobold,5015,0,0,1,1,0.0%,28m
350,1,[eX]ReMy,5014,541,26,26,52,50.0%,42m
351,1,[TGosuA]Pyra,5011,1509,126,125,251,50.2%,26m
352,1,[WarpDT]Crow,5010,968,32,29,61,52.5%,29m
353,1,[FabIed]Integral,5009,1439,90,68,158,57.0%,28m
353,1,ChaosEngine,5009,923,39,24,63,61.9%,26m
355,1,revenge,5007,440,13,12,25,52.0%,38m
355,1,[RnGpro]Perilous,5007,200,6,6,12,50.0%,32m
357,1,[xRtG]Haffey,5006,508,15,10,25,60.0%,41m
358,1,[EvilGC]SkrOs,5003,0,0,1,1,0.0%,9m
359,1,[FDAVID]Pox,5002,2137,140,97,237,59.1%,9m
359,1,Papaours,5002,417,15,6,21,71.4%,39m
359,1,[lLiTl]Badproxy,5002,0,0,1,1,0.0%,23m
362,1,[Expand]EnlistedReb,5001,2138,135,94,229,59.0%,24m
363,1,[GdAT]OldManSlum,4996,2864,275,246,521,52.8%,23m
363,1,[ArGNA]SHlTMAPS,4996,2945,128,105,233,54.9%,34m
365,1,[Exalt]Redmagic,4995,0,0,2,2,0.0%,42m
366,1,Tenacity,4994,1487,59,33,92,64.1%,38m
367,1,[ACSS]HeavyFresh,4992,394,10,9,19,52.6%,10m
368,1,NotTempO,4991,2801,220,142,362,60.8%,38m
369,1,TheEggMan,4990,581,23,24,47,48.9%,23m
370,1,Zavix,4986,3049,182,143,325,56.0%,38m
371,1,[Maegis]MoonRise,4985,692,40,5,45,88.9%,28m
372,1,[Dizz]opos,4984,3095,324,280,604,53.6%,26m
373,1,Powerhouse,4982,390,11,9,20,55.0%,34m
374,1,SLAMMER,4981,2672,265,246,511,51.9%,15m
375,1,Revolution,4980,283,22,8,30,73.3%,32m
375,1,Nikich,4980,48,2,1,3,66.7%,23m
375,1,SuperIMBA,4980,0,1,0,1,100.0%,28m
378,1,[TPGGXD]MiguelitoPro,4978,0,0,1,1,0.0%,28m
379,1,[RnGpro]Jamary,4977,2353,382,330,712,53.7%,31m
380,1,[PSISTM]EndOfLine,4976,950,33,32,65,50.8%,26m
381,1,IIIIIIIIIIII,4975,2389,98,93,191,51.3%,28m
382,1,[X17]EarthBoyTroy,4973,1529,193,154,347,55.6%,39m
383,1,DOUBLETIME,4970,224,9,5,14,64.3%,31m
383,1,mOOKASHADE,4970,302,7,10,17,41.2%,32m
385,1,Groovyman,4969,690,19,15,34,55.9%,23m
385,1,[bc0de]barcode,4969,0,0,1,1,0.0%,37m
387,1,[Cryptc]SlooTh,4968,963,34,27,61,55.7%,39m
387,1,[BYU]DelisDaily,4968,1152,33,31,64,51.6%,28m
387,1,[GnR]Asturias,4968,718,22,20,42,52.4%,31m
390,1,[VIXIII]Browntown,4964,901,146,150,296,49.3%,32m
391,1,shakal,4963,146,5,1,6,83.3%,10m
392,1,what,4960,311,64,49,113,56.6%,32m
392,1,Axios,4960,412,10,10,20,50.0%,15m
394,1,BlackMEsa,4959,170,4,5,9,44.4%,42m
395,1,[ArGNA]TempoJezus,4957,3023,713,607,1320,54.0%,23m
395,1,[Bee]LiviRAWR,4957,2973,240,198,438,54.8%,26m
395,1,llllllllllll,4957,0,1,0,1,100.0%,28m
395,1,IllllllllllI,4957,0,0,1,1,0.0%,9m
399,1,IlIIlllIIIII,4955,0,0,1,1,0.0%,32m
399,1,IIIIIIIII,4955,0,0,1,1,0.0%,42m
401,1,[NwAs]BeIieve,4954,94,3,4,7,42.9%,15m
402,1,Icebear,4952,2933,164,147,311,52.7%,34m
402,3,[omgBBC]GucciCoochie,4952,0,0,1,1,0.0%,35m
404,1,Nistic,4951,2994,209,193,402,52.0%,15m
405,1,LicoZhou,4949,3077,1536,1266,2802,54.8%,9m
406,1,Vitross,4947,1052,34,28,62,54.8%,32m
407,1,Bonjwa,4946,780,26,16,42,61.9%,42m
407,1,[αX]Dinkleswerve,4946,44,2,1,3,66.7%,39m
409,1,[Perfec]Zero,4944,410,11,14,25,44.0%,42m
409,1,LeThEbAtZ,4944,0,1,0,1,100.0%,23m
409,1,Pluto,4944,0,0,1,1,0.0%,32m
412,1,[KRPark]WaVe,4943,0,0,1,1,0.0%,10m
413,1,[TLAF]grepStar,4942,735,29,25,54,53.7%,10m
413,1,[eX]Dorminhoco,4942,46,1,2,3,33.3%,29m
415,1,IIIIIIIIIIII,4941,946,25,28,53,47.2%,42m
416,1,llllllllllll,4940,154,8,0,8,100.0%,42m
417,1,Caboose,4939,2052,103,61,164,62.8%,41m
417,1,[NovaX]LingKing,4939,216,6,7,13,46.2%,9m
419,1,[DhZCom]DakkoN,4936,2034,81,63,144,56.2%,41m
420,1,smoothbrain,4935,2913,225,202,427,52.7%,29m
420,1,Garouuuuu,4935,136,4,7,11,36.4%,23m
422,1,MeomaikaFan,4929,2726,210,157,367,57.2%,42m
423,1,[eX]NeNu,4928,2468,101,86,187,54.0%,42m
423,1,[ROOT]Robbie,4928,86,2,1,3,66.7%,38m
425,1,Prime,4927,902,39,32,71,54.9%,23m
425,3,IsUcK,4927,0,2,2,4,50.0%,27m
425,1,[SNlPR]MMRmugger,4927,0,0,1,1,0.0%,42m
428,1,NoobCake,4925,392,12,5,17,70.6%,34m
429,1,TheIronJudge,4923,494,14,12,26,53.8%,32m
430,1,Petrify,4922,1340,156,115,271,57.6%,41m
430,1,GeniouS,4922,2161,81,65,146,55.5%,39m
432,1,[xRtG]TheSizzler,4920,2995,361,318,679,53.2%,31m
433,1,[UpeV]PicudoCDMX,4919,1619,77,61,138,55.8%,15m
434,1,ChilledChaos,4918,132,4,3,7,57.1%,24m
435,1,[GUCCl]BOOOOOOOOOoM,4917,104,3,1,4,75.0%,27m
436,1,[RBTH]LokiSaurioEs,4916,3017,578,477,1055,54.8%,23m
436,1,PewpSokk,4916,399,31,31,62,50.0%,32m
438,1,InTA,4913,1361,186,149,335,55.5%,9m
439,1,[lLiTl]Pazzy,4912,0,0,1,1,0.0%,23m
440,1,[αX]ViruS,4911,1273,42,38,80,52.5%,28m
440,1,IIVIVIIVIVII,4911,0,1,2,3,33.3%,37m
442,1,[Micr0]Bogwandi,4909,0,0,1,1,0.0%,32m
442,1,Tendentious,4909,0,0,1,1,0.0%,23m
444,1,[xRtG]PhierzUSN,4908,1531,67,59,126,53.2%,9m
445,1,[Ris3n]Stephen,4904,2730,150,136,286,52.4%,41m
445,1,anioki,4904,772,27,19,46,58.7%,37m
447,1,MOON,4903,0,0,1,1,0.0%,28m
448,1,Firsttime,4902,0,1,0,1,100.0%,15m
449,1,vhvhvhvhvhvh,4901,654,17,18,35,48.6%,34m
449,3,rive,4901,0,0,1,1,0.0%,6m
449,1,ezGamEezLife,4901,0,0,2,2,0.0%,39m
452,1,Paparoni,4899,757,70,32,102,68.6%,41m
453,1,[neuroS]ALLMIGHT,4898,2664,330,291,621,53.1%,9m
453,1,[GanGan]NostrA,4898,1406,145,125,270,53.7%,10m
453,1,[LREM]MrCastaner,4898,1395,86,49,135,63.7%,32m
456,1,Faras,4895,1764,75,62,137,54.7%,38m
456,1,Najzmajs,4895,34,2,3,5,40.0%,9m
456,1,Duke,4895,0,1,0,1,100.0%,24m
459,1,[DROWN]lethe,4892,2194,91,83,174,52.3%,32m
459,1,JuLoSoLo,4892,265,25,13,38,65.8%,10m
459,1,IIIIIIIIIIII,4892,0,0,1,1,0.0%,9m
462,1,Sephiroth,4891,0,3,2,5,60.0%,11m
463,1,[αX]Kyboi,4889,2847,161,148,309,52.1%,39m
463,1,[SsaYnS]Demiurge,4889,1139,59,36,95,62.1%,41m
463,1,[TheInv]Raddow,4889,0,1,1,2,50.0%,15m
466,1,llllllllllll,4888,343,10,2,12,83.3%,34m
466,1,hello,4888,0,1,0,1,100.0%,29m
468,1,Goobey,4886,2105,116,92,208,55.8%,31m
468,1,Tsirku,4886,1043,42,32,74,56.8%,28m
468,1,proxyimba,4886,173,7,3,10,70.0%,15m
468,1,[YIKERS]pleb,4886,144,4,0,4,100.0%,25m
468,1,bab,4886,44,2,2,4,50.0%,34m
468,1,llllllllllll,4886,90,2,4,6,33.3%,38m
474,1,[PSISTM]ZeRgWaVe,4885,709,32,33,65,49.2%,9m
474,1,IlIIIllIlIIl,4885,280,7,9,16,43.8%,31m
474,1,llllllllllll,4885,162,6,0,6,100.0%,32m
474,1,[cloudM]Ferrari,4885,0,0,1,1,0.0%,31m
478,1,[SPACEX]Quantum,4884,833,139,103,242,57.4%,15m
478,1,[xRtG]TeKniQ,4884,1639,85,80,165,51.5%,39m
478,1,[DarkAG]ZergAcademy,4884,223,24,14,38,63.2%,27m
481,1,KFCBlackMan,4882,166,5,5,10,50.0%,41m
482,1,[MDPKR]Walujie,4880,2827,545,474,1019,53.5%,42m
482,1,[PwT]CesarRB,4880,2984,329,291,620,53.1%,37m
482,1,Saiph,4880,2989,211,181,392,53.8%,32m
482,1,MrShaibel,4880,2883,126,108,234,53.8%,24m
486,1,[KJI]FAPPEENNIISS,4878,242,7,6,13,53.8%,42m
487,1,Memeling,4877,446,13,9,22,59.1%,39m
487,1,[dLife]Ascarecroww,4877,0,0,1,1,0.0%,28m
489,1,[CaptA]Sentinel,4876,665,32,5,37,86.5%,42m
490,1,[Ex0n]Steadfast,4874,2993,145,129,274,52.9%,32m
490,1,Shades,4874,1134,54,35,89,60.7%,23m
492,1,[GLAZ]Darroweven,4873,40,1,4,5,20.0%,42m
493,1,jimmymicro,4872,426,13,13,26,50.0%,10m
493,1,llllllllllll,4872,0,3,2,5,60.0%,15m
495,2,chilax,4871,0,1,0,1,100.0%,38m
495,1,IIIIIIIIIIII,4871,0,1,3,4,25.0%,23m
497,1,[αX]Anansi,4865,134,4,0,4,100.0%,34m
497,1,[cLsSC]FirsToDie,4865,28,1,5,6,16.7%,28m
499,1,MoMaN,4863,0,1,4,5,20.0%,38m
500,1,what,4862,1059,61,32,93,65.6%,15m
500,1,BamBam,4862,352,9,14,23,39.1%,29m
502,1,IIIIIIIIIIII,4861,125,3,2,5,60.0%,24m
503,1,[Ex0n]Nina,4860,310,8,8,16,50.0%,10m
503,1,[TGosuB]MewMewDewm,4860,28,2,4,6,33.3%,23m
505,1,ProtossOP,4859,1426,97,51,148,65.5%,42m
506,1,Hammer,4858,1459,58,48,106,54.7%,15m
506,1,llllllllllll,4858,1164,42,51,93,45.2%,35m
506,1,Sottorks,4858,88,4,1,5,80.0%,32m
506,1,Peddy,4858,0,0,1,1,0.0%,41m
510,1,HuaCheng,4856,48,1,1,2,50.0%,32m
511,1,[Ato2]EJEJ,4854,80,3,0,3,100.0%,32m
511,1,HydraulixXD,4854,80,2,3,5,40.0%,29m
511,1,[GnR]JongleBolls,4854,0,1,0,1,100.0%,42m
514,1,[SABO]Saboteur,4852,268,8,3,11,72.7%,41m
515,1,DataMiner,4850,616,37,9,46,80.4%,15m
516,1,[GUCCl]BAAZOOOMINEE,4849,2903,558,546,1104,50.5%,9m
516,1,Darkrai,4849,374,9,11,20,45.0%,28m
518,1,llllllllllll,4848,46,1,1,2,50.0%,32m
519,1,[DhZCom]perhark,4847,3000,405,386,791,51.2%,9m
520,1,buLLetTrain,4846,1751,93,82,175,53.1%,41m
521,1,[Kaii]DoM,4843,397,17,13,30,56.7%,41m
521,1,llllllllllll,4843,0,1,0,1,100.0%,37m
523,1,DaviCmpBln,4842,1620,121,83,204,59.3%,24m
524,1,IIIIIIIIIIII,4841,71,2,1,3,66.7%,27m
525,1,ScouT,4839,1152,56,66,122,45.9%,9m
526,1,hmmdq,4838,2956,161,151,312,51.6%,41m
527,1,IIIIIIIIIIII,4837,2515,101,93,194,52.1%,32m
528,1,DuSt,4835,192,6,0,6,100.0%,40m
529,1,tGNoStrA,4834,1018,35,36,71,49.3%,42m
529,1,KimiK,4834,714,34,8,42,81.0%,15m
529,1,[ZTemp]Mariuslol,4834,189,5,0,5,100.0%,27m
532,1,ppgBubbles,4833,410,12,17,29,41.4%,37m
532,1,[GnR]Java,4833,400,10,15,25,40.0%,28m
534,1,[Expand]precambrian,4832,1389,63,33,96,65.6%,15m
534,1,BackFromDead,4832,352,11,13,24,45.8%,9m
536,1,Oresama,4830,137,6,0,6,100.0%,27m
536,1,llllllllllll,4830,0,1,1,2,50.0%,32m
538,1,AwfullChrono,4829,0,0,1,1,0.0%,9m
539,1,[lNI]Scried,4828,0,0,1,1,0.0%,41m
540,1,Russkiy,4827,0,1,0,1,100.0%,10m
541,1,Joe,4825,1520,80,70,150,53.3%,31m
542,1,SpecialOne,4823,2600,271,218,489,55.4%,15m
543,1,llIIllIIIlll,4820,354,26,2,28,92.9%,15m
543,1,FrostyCat,4820,286,8,15,23,34.8%,9m
543,1,llllllllllll,4820,0,1,0,1,100.0%,39m
546,1,Alopex,4819,1382,66,44,110,60.0%,42m
547,1,MyoungFlow,4818,214,7,3,10,70.0%,15m
547,1,llllllllll,4818,0,1,0,1,100.0%,31m
549,1,[Ris3n]Death,4816,858,30,29,59,50.8%,9m
549,1,[lLiTl]LiquidFluid,4816,648,24,14,38,63.2%,23m
549,1,[OGbros]Vicarious,4816,58,2,1,3,66.7%,24m
552,1,[sc2rep]ReplayStats,4814,1190,65,27,92,70.7%,38m
552,1,KrAsh,4814,192,5,3,8,62.5%,24m
552,1,ice,4814,0,0,1,1,0.0%,38m
555,1,llllllllllll,4813,0,1,0,1,100.0%,15m
556,1,[DhZPro]Terranosaur,4809,2,2,0,2,100.0%,27m
557,1,[X17]iSjEcho,4808,1832,143,119,262,54.6%,31m
557,1,MikeRoss,4808,131,4,2,6,66.7%,28m
557,1,[Sune]Smash,4808,0,1,0,1,100.0%,37m
557,1,NamelesS,4808,0,0,1,1,0.0%,15m
561,1,Spur,4807,2940,266,241,507,52.5%,9m
562,1,ToT,4806,0,1,0,1,100.0%,41m
562,1,Sham,4806,48,1,2,3,33.3%,41m
562,1,[TheB4d]Tunico,4806,0,0,1,1,0.0%,41m
565,1,Neox,4805,2932,425,395,820,51.8%,32m
565,1,Timeh,4805,0,0,1,1,0.0%,42m
567,1,[CaptA]CrimsonChaos,4804,183,7,1,8,87.5%,23m
567,1,[NovaX]Imagine,4804,96,1,1,2,50.0%,42m
567,1,[PSISTM]intense,4804,0,0,3,3,0.0%,9m
570,1,[ValidG]Two,4802,0,1,0,1,100.0%,15m
571,1,[FRNAVY]Beltalowda,4800,111,5,3,8,62.5%,15m
572,1,[cl0udM]Days,4799,2394,252,214,466,54.1%,35m
572,2,IIIIIIIIIIII,4799,175,6,5,11,54.5%,34m
574,1,llllllllllll,4798,611,96,21,117,82.1%,32m
574,1,LaVallière,4798,420,20,20,40,50.0%,39m
576,1,piliTrash,4797,262,8,5,13,61.5%,42m
577,1,[xRtG]TheGiantNome,4795,2605,108,96,204,52.9%,35m
577,1,[inCo]Ryerye,4795,156,4,3,7,57.1%,32m
579,1,Tyler,4794,93,1,1,2,50.0%,28m
580,1,Caelestis,4793,2905,262,275,537,48.8%,9m
580,1,RobBedstain,4793,26,2,1,3,66.7%,10m
582,1,llllllllllll,4792,455,14,13,27,51.9%,35m
582,1,[HoSeeB]SaitoAsuka,4792,0,0,2,2,0.0%,15m
584,1,Cereal,4791,98,3,0,3,100.0%,29m
584,1,[NovaX]Buzzbin,4791,0,0,1,1,0.0%,42m
586,1,zarmanpg,4790,882,27,36,63,42.9%,42m
586,1,Life,4790,528,20,20,40,50.0%,29m
588,1,llllllllllll,4789,1660,83,73,156,53.2%,38m
588,1,[SsaYnS]Caloreen,4789,1281,64,48,112,57.1%,23m
588,1,[Cryptc]ElNiño,4789,292,7,13,20,35.0%,23m
588,1,Jaystar,4789,111,3,2,5,60.0%,37m
592,1,JmaC,4787,2519,280,257,537,52.1%,23m
592,1,FreedomEagle,4787,756,22,21,43,51.2%,9m
594,1,BROFESTOR,4786,528,35,7,42,83.3%,15m
594,1,wTinte,4786,245,12,6,18,66.7%,37m
596,1,[GOPERÚ]OdiNTaBaCK,4785,276,11,11,22,50.0%,27m
597,1,[SftVgn]ELEcom,4784,736,40,19,59,67.8%,9m
598,1,NosNadir,4783,2532,294,245,539,54.5%,15m
598,1,[DNKCFT]iveseensmolr,4783,160,4,6,10,40.0%,9m
598,1,Moron,4783,0,1,1,2,50.0%,28m
601,1,[KiMBR]Wizard,4782,1462,63,51,114,55.3%,27m
602,1,Bellatrix,4781,104,2,1,3,66.7%,29m
602,2,Bolívar,4781,0,1,0,1,100.0%,38m
604,1,[CMU]Qoo,4780,1685,168,115,283,59.4%,15m
604,1,SofaKingAlfa,4780,1654,88,77,165,53.3%,32m
604,1,WilMaDiCFit,4780,624,21,19,40,52.5%,28m
607,2,ambient,4778,0,0,1,1,0.0%,5m
608,1,lIlIlIIIIlIl,4775,1281,112,98,210,53.3%,41m
608,1,[Ex0n]Ryan,4775,1548,68,55,123,55.3%,23m
610,1,ByeonGgEo,4773,2240,491,446,937,52.4%,28m
610,1,[lNI]Eldrid,4773,2809,385,338,723,53.3%,32m
610,1,[MSFT]danceparty,4773,318,9,13,22,40.9%,42m
610,2,Gerbil,4773,0,1,0,1,100.0%,18m
610,2,Grisgris,4773,0,1,0,1,100.0%,34m
615,1,Bango,4772,900,41,28,69,59.4%,28m
616,2,IIIIIIIIIIII,4770,1375,84,25,109,77.1%,38m
616,2,JoelVanesco,4770,198,8,6,14,57.1%,34m
618,2,[SftVgn]Overmind,4767,865,155,156,311,49.8%,5m
618,1,[51JTM]DrinkSmokeFk,4767,56,2,5,7,28.6%,35m
618,2,[EMORY]FatGoose,4767,0,0,1,1,0.0%,38m
618,1,Makaidos,4767,0,0,2,2,0.0%,41m
622,1,llllllllllll,4766,362,11,11,22,50.0%,28m
622,1,Epinephrine,4766,164,3,3,6,50.0%,27m
624,2,[12step]Dutes,4765,0,0,1,1,0.0%,23m
624,2,[PTHero]Cheoklate,4765,0,0,1,1,0.0%,19m
626,1,Rome,4764,1908,131,118,249,52.6%,41m
626,1,IllIlIIIllIl,4764,2476,112,117,229,48.9%,39m
626,1,[TØXIC]mtk,4764,2107,81,81,162,50.0%,27m
629,1,ElstPizarro,4763,802,46,14,60,76.7%,38m
630,1,[GdAT]Nameless,4761,1066,41,36,77,53.2%,39m
630,2,PrimeLime,4761,522,19,19,38,50.0%,10m
630,1,DaFungus,4761,251,6,6,12,50.0%,23m
630,1,jheffe,4761,0,1,4,5,20.0%,24m
634,2,[KiMBR]Brucutu,4760,0,0,1,1,0.0%,34m
634,2,ObiwanKenobi,4760,0,0,1,1,0.0%,38m
636,2,Oripe,4759,944,45,22,67,67.2%,23m
636,2,[DhZCom]Filho,4759,728,31,25,56,55.4%,15m
638,2,[PTHero]Cheoklate,4758,56,3,1,4,75.0%,42m
639,1,[ANIMOO]BANGBANG,4757,2882,389,373,762,51.0%,31m
639,1,llllllllllll,4757,2096,75,85,160,46.9%,9m
639,2,[BRSKR]Amnesia,4757,0,1,0,1,100.0%,5m
639,2,BirdOfHermes,4757,46,1,1,2,50.0%,41m
639,1,llllllllllll,4757,0,0,5,5,0.0%,42m
644,1,LoveKing,4756,725,28,19,47,59.6%,27m
644,1,mrtea,4756,104,4,8,12,33.3%,15m
644,2,Jeremy,4756,0,1,0,1,100.0%,38m
647,2,Rapier,4755,622,33,25,58,56.9%,38m
647,1,TCaldwell,4755,217,8,4,12,66.7%,41m
647,2,Gargamel,4755,0,1,0,1,100.0%,19m
650,1,Ratimus,4754,382,19,12,31,61.3%,41m
651,1,[TGCrew]Carter,4753,64,2,5,7,28.6%,29m
651,2,[MAYN]Frequency,4753,0,1,0,1,100.0%,38m
653,1,[1L1R]LambNRice,4752,2716,118,107,225,52.4%,31m
653,1,IIIIIIIIIIII,4752,368,12,9,21,57.1%,29m
653,1,[MSFT]leandoer,4752,0,0,4,4,0.0%,39m
656,1,TwitchMaster,4750,877,33,27,60,55.0%,9m
656,1,Wontstop,4750,539,24,17,41,58.5%,37m
656,1,[INextI]ztkumm,4750,272,8,9,17,47.1%,27m
656,2,[PSISTM]Freeedom,4750,0,1,0,1,100.0%,34m
660,1,TigersMilk,4749,681,32,32,64,50.0%,23m
661,1,Sherlock,4747,2220,360,368,728,49.5%,39m
661,1,[TXOP]Nishi,4747,855,41,38,79,51.9%,32m
663,2,Felvo,4745,0,1,0,1,100.0%,23m
664,1,FoolOfaTooK,4744,0,0,4,4,0.0%,15m
665,2,[FFAA]Batash,4743,0,0,1,1,0.0%,38m
666,1,Newplayer,4742,1123,98,64,162,60.5%,32m
666,2,[GnR]Cactusman,4742,174,7,6,13,53.8%,38m
668,2,[IMDSI]SanMarquino,4739,68,5,1,6,83.3%,3m
668,1,llllllllllll,4739,28,2,6,8,25.0%,15m
670,1,[FxB]Hibiki,4738,515,50,51,101,49.5%,41m
670,2,SoyMcDaddy,4738,202,8,3,11,72.7%,38m
672,2,fortheswarm,4736,2680,243,253,496,49.0%,10m
673,1,[DETER]Infinite,4735,1261,113,100,213,53.1%,39m
673,1,[xRtG]Cyfa,4735,537,21,19,40,52.5%,31m
675,1,pocker,4734,454,112,95,207,54.1%,39m
675,1,FatGoku,4734,1055,41,36,77,53.2%,27m
675,2,BenchPress,4734,837,39,32,71,54.9%,18m
675,2,iHateYou,4734,0,1,0,1,100.0%,5m
679,1,[TGCF]Lonosphere,4733,2782,422,410,832,50.7%,10m
679,1,[LgnTDS]gtCheticus,4733,2867,292,261,553,52.8%,29m
679,1,[Shrek5]Ryuga,4733,1418,56,86,142,39.4%,15m
679,1,[GØSU]Miro,4733,728,24,25,49,49.0%,42m
679,2,Vengeance,4733,472,21,11,32,65.6%,36m
684,1,[AlIin]Worldisdoom,4732,334,11,10,21,52.4%,29m
684,2,TimeBones,4732,0,1,0,1,100.0%,38m
684,2,lIlIlIlIlIlI,4732,40,1,1,2,50.0%,10m
684,2,Pursuit,4732,40,1,3,4,25.0%,34m
688,2,PkBLUE,4730,0,0,1,1,0.0%,5m
689,2,soO,4726,38,4,4,8,50.0%,34m
690,2,KEY,4725,0,1,0,1,100.0%,34m
691,2,freeSCsmurf,4724,639,33,17,50,66.0%,18m
692,2,Stephen,4722,521,30,5,35,85.7%,5m
692,2,[GoLTV]Legend,4722,0,0,1,1,0.0%,38m
694,2,Sacrilege,4720,42,1,2,3,33.3%,15m
694,2,PoT,4720,0,0,1,1,0.0%,20m
696,2,KAI,4719,0,1,0,1,100.0%,3m
696,2,[DGiT]Paperboat,4719,0,0,1,1,0.0%,15m
698,2,IronmanBTW,4718,1590,109,92,201,54.2%,36m
699,2,Tezuka,4717,864,59,30,89,66.3%,18m
700,1,RyoGin,4716,2892,512,487,999,51.3%,42m
700,2,[TheJaM]Htw,4716,136,4,6,10,40.0%,38m
700,2,[EMcl]Yizus,4716,0,0,1,1,0.0%,41m
703,2,mogwai,4715,56,2,2,4,50.0%,3m
704,2,[UpeV]Snizy,4714,136,6,1,7,85.7%,15m
704,2,JYan,4714,0,1,2,3,33.3%,36m
704,2,OMEGALUL,4714,0,0,1,1,0.0%,38m
707,2,RandomName,4713,0,0,1,1,0.0%,41m
707,2,[5EX]Killz,4713,0,0,1,1,0.0%,34m
709,2,llllllllllll,4711,0,0,1,1,0.0%,42m
710,2,[CWKz]Maker,4710,214,6,6,12,50.0%,5m
710,2,Neighbor,4710,122,4,4,8,50.0%,15m
710,2,[MSFT]ZergGirl,4710,92,3,2,5,60.0%,34m
713,2,unRefiNed,4709,186,6,7,13,46.2%,5m
713,1,[Cryptc]Mayhem,4709,108,4,7,11,36.4%,9m
713,2,[αXi]Blisk,4709,34,1,2,3,33.3%,18m
716,2,Max,4707,140,6,3,9,66.7%,41m
716,2,[lLiTl]Houzi,4707,0,0,1,1,0.0%,5m
718,2,Carl,4706,14,1,2,3,33.3%,23m
718,2,[αX]TriGGeR,4706,73,1,3,4,25.0%,36m
720,2,[LPlebs]BigChief,4705,596,27,12,39,69.2%,41m
720,1,ScioN,4705,48,3,1,4,75.0%,40m
722,2,FifthRom,4704,311,14,6,20,70.0%,36m
722,1,MatchaLatte,4704,294,10,9,19,52.6%,38m
722,2,[AlIin]WyScion,4704,0,0,2,2,0.0%,15m
725,1,[cl0udM]OiLTowN,4702,2853,192,206,398,48.2%,27m
725,1,IIIIIIIIIIII,4702,1791,143,139,282,50.7%,28m
725,1,[Shang]HuShang,4702,744,24,28,52,46.2%,9m
728,1,[NovaX]TwoMeows,4701,2900,289,256,545,53.0%,31m
728,2,[NYY]Icarus,4701,0,1,0,1,100.0%,18m
728,2,sONxGi,4701,0,0,1,1,0.0%,10m
731,2,Duda,4700,357,46,45,91,50.5%,15m
732,2,Cyllene,4699,843,35,41,76,46.1%,19m
733,1,juno,4698,2677,234,218,452,51.8%,27m
734,2,[DaPlug]BigPharma,4697,0,0,1,1,0.0%,34m
735,1,[f0ad]foad,4696,657,30,13,43,69.8%,15m
735,2,[hTx]Soap,4696,64,3,4,7,42.9%,38m
737,1,IIIIIIIIIIII,4694,309,29,7,36,80.6%,28m
737,2,Pouch,4694,238,9,15,24,37.5%,15m
737,2,[9999ss]LiviBeeFanS,4694,219,7,3,10,70.0%,38m
740,2,[Perfec]ThreeInches,4692,2702,147,142,289,50.9%,41m
740,2,Huh,4692,1186,57,55,112,50.9%,5m
740,1,llllllllllll,4692,144,4,4,8,50.0%,37m
743,2,llllllllllll,4691,417,22,9,31,71.0%,38m
743,2,[LYBF91]PetRiChOr,4691,184,8,6,14,57.1%,36m
743,2,EduLis,4691,0,1,1,2,50.0%,19m
743,2,[KingSC]BattoSai,4691,0,0,1,1,0.0%,18m
747,2,[VFam2]VanOoijen,4690,519,26,11,37,70.3%,38m
747,2,[FMX]SaLiTre,4690,0,0,1,1,0.0%,3m
749,1,LilyRiri,4689,836,39,28,67,58.2%,42m
750,2,Pheliaz,4687,192,10,8,18,55.6%,10m
751,2,TerranEz,4686,703,104,86,190,54.7%,3m
751,2,[UVUSC2]Timmy,4686,0,0,1,1,0.0%,36m
753,2,Alyosha,4685,0,1,2,3,33.3%,34m
754,2,[Ris3n]Heisenzerg,4681,1967,168,190,358,46.9%,10m
754,2,[Enron]AskWhy,4681,0,0,1,1,0.0%,34m
754,2,[SNlPED]EZcheezy,4681,0,0,1,1,0.0%,18m
757,1,ForevaADrone,4680,1679,119,106,225,52.9%,28m
757,1,[Ris3n]SacDeFromage,4680,650,21,26,47,44.7%,32m
759,2,[INextI]Itzcoatl,4679,294,18,12,30,60.0%,5m
759,2,quAnx,4679,100,5,0,5,100.0%,5m
761,2,TeKniQ,4678,358,16,11,27,59.3%,38m
761,1,llllllllllll,4678,0,0,1,1,0.0%,40m
761,2,IIIIIIIIIIII,4678,0,0,1,1,0.0%,15m
764,1,[INextI]Bogue,4676,0,1,0,1,100.0%,9m
765,2,Heacy,4675,0,1,0,1,100.0%,10m
766,2,StopActingUp,4674,0,0,1,1,0.0%,10m
767,2,[VFam]DarkMinions,4673,0,1,0,1,100.0%,5m
768,2,LifeForAiur,4671,2447,180,145,325,55.4%,3m
769,2,[GRNSKN]Apoptosis,4669,2623,483,539,1022,47.3%,38m
769,2,[TGosuA]BooToYou,4669,26,1,3,4,25.0%,20m
771,2,[SsaYnS]Shane,4668,1469,120,113,233,51.5%,10m
771,2,[AMZN]tuna,4668,466,22,18,40,55.0%,5m
771,2,MDD,4668,60,3,6,9,33.3%,5m
774,1,[αB]oCRaM,4665,2438,87,99,186,46.8%,9m
775,1,llllllllllll,4664,784,26,30,56,46.4%,28m
776,2,theFISH,4663,1345,107,100,207,51.7%,3m
776,2,AJQunderskor,4663,1665,77,77,154,50.0%,5m
776,1,ForAiur,4663,1730,65,71,136,47.8%,33m
776,2,[SydTT]Rui,4663,0,0,1,1,0.0%,19m
780,2,[Lowko]Valentine,4662,0,0,2,2,0.0%,18m
781,2,DaEMoN,4661,1166,59,30,89,66.3%,15m
782,2,Envy,4660,0,0,6,6,0.0%,38m
783,2,ezBoys,4659,726,30,27,57,52.6%,10m
783,2,[WarpDT]brueda,4659,44,5,6,11,45.5%,34m
785,1,IIIIIIIIIIII,4658,952,31,41,72,43.1%,35m
785,1,JKap,4658,319,17,9,26,65.4%,32m
785,2,[RMPG]Crunk,4658,122,5,7,12,41.7%,19m
785,2,Alien,4658,48,3,2,5,60.0%,42m
789,2,[SftVgn]ELEcom,4657,198,6,10,16,37.5%,38m
790,2,Raivotar,4656,330,10,16,26,38.5%,5m
790,2,[Twitch]WhiteRa,4656,0,2,4,6,33.3%,18m
792,2,[UpeV]LaniaKea,4655,84,2,10,12,16.7%,36m
793,2,[F0D]Spizella,4654,2555,149,143,292,51.0%,20m
793,1,MushroomGas,4654,150,4,11,15,26.7%,9m
793,2,Cloudy,4654,26,1,2,3,33.3%,23m
796,2,Katsu,4652,0,0,1,1,0.0%,19m
796,2,[SHPony]lIlIlIlIlIlI,4652,0,0,3,3,0.0%,3m
798,2,IIIIIIIIIIII,4651,329,19,6,25,76.0%,15m
799,2,IIIIIIIIIIII,4650,1371,119,58,177,67.2%,42m
799,1,Greatpark,4650,294,10,17,27,37.0%,28m
801,2,[αX]Pacomike,4649,422,15,19,34,44.1%,15m
802,2,[Kaaas]OgolCromgog,4648,325,11,12,23,47.8%,23m
802,2,Relinquish,4648,0,0,1,1,0.0%,36m
802,2,llllllllllll,4648,0,0,1,1,0.0%,23m
805,2,[uWu69]CollinCobra,4647,341,13,7,20,65.0%,20m
806,2,[toXsiC]sAviOr,4645,0,0,1,1,0.0%,42m
807,2,DarkWingDuck,4644,1428,78,59,137,56.9%,36m
807,2,Trolencio,4644,434,22,15,37,59.5%,18m
807,2,Android,4644,34,2,8,10,20.0%,23m
810,1,friedpork,4642,2296,302,321,623,48.5%,28m
810,2,[BIacer]MogarFNSMASH,4642,22,2,0,2,100.0%,39m
812,2,[xRtG]LEXCHAKRA,4641,442,22,21,43,51.2%,34m
812,1,[EUonNA]PlayerFromEu,4641,96,3,1,4,75.0%,12m
812,2,[SNlPED]SHINeePrinCe,4641,0,0,1,1,0.0%,34m
815,1,[RBTH]ShotnVelt,4638,2809,267,286,553,48.3%,39m
815,2,Brom,4638,0,1,0,1,100.0%,15m
815,2,[PSC]Mokomi,4638,0,0,4,4,0.0%,34m
818,1,XLIMIT,4635,0,1,1,2,50.0%,3m
818,2,FreeMelee,4635,0,0,1,1,0.0%,42m
820,2,[Micr0]Tiger,4632,0,1,0,1,100.0%,5m
821,2,Iris,4631,386,17,13,30,56.7%,5m
822,2,[AvsA]PsYche,4630,643,30,35,65,46.2%,15m
822,2,[TGCF]deep,4630,38,2,3,5,40.0%,36m
824,2,[TXOP]ChevChelios,4629,2212,213,210,423,50.4%,5m
824,2,[ASWZ]phrontis,4629,201,9,4,13,69.2%,42m
824,2,[BAKUGO]Katsuki,4629,70,3,4,7,42.9%,15m
824,2,ImmortaL,4629,0,0,1,1,0.0%,23m
828,2,[BRSKR]Epitaph,4628,84,4,4,8,50.0%,34m
828,1,Failer,4628,95,2,0,2,100.0%,4m
830,1,[UpeV]UwUSaurio,4627,846,38,38,76,50.0%,37m
830,2,[Kaii]BabyDriver,4627,0,1,0,1,100.0%,15m
832,2,SlipperyFart,4626,307,11,2,13,84.6%,34m
832,2,Imagine,4626,84,4,4,8,50.0%,18m
834,2,marmeladka,4624,295,20,0,20,100.0%,41m
835,2,IIIIIIIIIIII,4623,644,36,14,50,72.0%,39m
836,2,[αB]eXiled,4622,0,0,1,1,0.0%,5m
837,2,[Kingx]Cye,4621,2552,244,235,479,50.9%,36m
837,1,[GIBE]Jason,4621,1147,133,140,273,48.7%,42m
837,1,Boomer,4621,165,8,16,24,33.3%,27m
837,1,[NeAs]MaelG,4621,0,1,0,1,100.0%,12m
837,2,ScaR,4621,0,0,1,1,0.0%,23m
842,2,[Agros]TheZohan,4620,0,1,0,1,100.0%,34m
842,2,ConfusioN,4620,0,1,0,1,100.0%,18m
844,3,Phenom,4619,405,21,0,21,100.0%,10m
844,2,NightFalllll,4619,0,3,2,5,60.0%,42m
844,2,Yankee,4619,0,1,0,1,100.0%,5m
844,2,[RUMB]Relinquish,4619,20,1,2,3,33.3%,38m
848,2,[TURBOs]Stinker,4618,34,1,8,9,11.1%,4m
849,2,[inCo]BabyNeffy,4617,933,50,46,96,52.1%,39m
849,2,Jack,4617,356,15,21,36,41.7%,15m
849,2,SacredCocos,4617,28,1,1,2,50.0%,20m
849,1,ppeomega,4617,48,1,2,3,33.3%,8m
853,3,Zenith,4616,145,6,1,7,85.7%,6m
853,2,llllllllllll,4616,110,6,10,16,37.5%,15m
855,1,[hOpp]Bathtub,4615,1786,87,98,185,47.0%,33m
855,2,[KingSC]BattoSai,4615,503,27,19,46,58.7%,15m
855,2,[xESGx]StrObe,4615,0,0,1,1,0.0%,36m
858,2,IIIIIIIIIIII,4614,1378,82,78,160,51.2%,5m
858,2,[WDY]PaniC,4614,42,3,1,4,75.0%,39m
858,2,[r3k7]DrBojengles,4614,0,2,2,4,50.0%,4m
861,2,[CMU]ropicophop,4613,458,16,22,38,42.1%,19m
862,2,Mellow,4612,2473,159,177,336,47.3%,4m
862,1,[INextI]JuGa,4612,1687,73,85,158,46.2%,42m
862,1,inspekteur,4612,287,22,21,43,51.2%,28m
862,2,Azazel,4612,92,9,8,17,52.9%,34m
862,2,[Probuu]grub,4612,147,4,3,7,57.1%,34m
862,2,[FDSJ]Stormburn,4612,14,2,4,6,33.3%,4m
868,2,[AthSun]FreedomTH,4609,147,8,9,17,47.1%,5m
868,2,llllllllllll,4609,0,2,3,5,40.0%,30m
870,2,[DIGNO]Rebellious,4607,0,1,0,1,100.0%,19m
870,2,feisto,4607,0,0,1,1,0.0%,15m
872,2,WagonMafia,4606,102,5,0,5,100.0%,42m
872,2,[PiGPan]HyperSova,4606,34,3,4,7,42.9%,19m
872,2,grandmomSC,4606,0,0,1,1,0.0%,15m
875,1,[UpeV]ZUNZET,4605,2500,585,622,1207,48.5%,33m
875,2,[GTs]Lunchador,4605,0,1,0,1,100.0%,19m
877,1,Rampagiman,4604,2771,547,555,1102,49.6%,23m
877,2,IIIIIIIIIIII,4604,442,74,15,89,83.1%,20m
879,2,[eSun]Ciel,4603,2176,102,115,217,47.0%,15m
879,2,Starfish,4603,467,24,4,28,85.7%,5m
879,2,llllllllllll,4603,190,11,10,21,52.4%,19m
879,2,[pwrIX]DOOMHURT,4603,26,1,2,3,33.3%,34m
883,2,[G0G0G0]DamACinzentA,4602,648,36,28,64,56.2%,42m
884,2,InMoLaTionS,4601,969,57,28,85,67.1%,34m
884,1,[SkFIm]FenixLizard,4601,0,1,0,1,100.0%,27m
886,1,[αX]JermStudDog,4599,2790,676,652,1328,50.9%,37m
886,2,[AdaptG]JoySynthetic,4599,0,0,1,1,0.0%,19m
888,2,[ARTY]cookiejar,4598,406,18,25,43,41.9%,42m
888,2,Dystopia,4598,22,1,4,5,20.0%,10m
890,2,IIIIIIIIIIII,4597,433,30,5,35,85.7%,41m
890,2,[RnGpro]Goomba,4597,364,13,19,32,40.6%,19m
890,2,oMFgiMbA,4597,86,3,4,7,42.9%,38m
890,2,lIIIIIIIIIIl,4597,0,1,1,2,50.0%,4m
894,1,[I3mF]BeardedOne,4596,2671,633,654,1287,49.2%,23m
894,2,Zergling,4596,210,7,7,14,50.0%,34m
896,2,Kangaroosack,4595,1617,107,95,202,53.0%,10m
896,2,TangleDahee,4595,96,2,5,7,28.6%,10m
898,2,[DETER]SOL,4593,0,1,0,1,100.0%,10m
898,2,[VERUM]Enigma,4593,0,0,1,1,0.0%,38m
900,1,[eX]Wizard,4592,1544,83,81,164,50.6%,27m
900,2,[N0FKz]iDrone,4592,1716,81,78,159,50.9%,19m
900,2,TypeyBoy,4592,815,46,37,83,55.4%,18m
900,2,[xRtG]loafingbread,4592,314,17,10,27,63.0%,34m
900,1,[TGCF]TRUNKS,4592,508,15,35,50,30.0%,9m
900,2,[Ris3n]CollegeWings,4592,0,0,1,1,0.0%,34m
906,2,Peddy,4591,1351,130,57,187,69.5%,36m
906,2,PillowFight,4591,1249,72,35,107,67.3%,39m
908,2,[Kaii]DoM,4590,1615,212,242,454,46.7%,15m
908,2,Pride,4590,304,16,9,25,64.0%,19m
908,2,Nebula,4590,99,3,0,3,100.0%,15m
911,2,[xRtG]Shampagne,4589,2592,193,201,394,49.0%,39m
911,2,[WNTRCO]Brenda,4589,290,12,9,21,57.1%,18m
913,1,[ConFed]RuNei,4588,217,4,4,8,50.0%,10m
913,2,FatAmy,4588,0,1,0,1,100.0%,34m
913,2,[NPhase]DlCKpicKING,4588,0,1,0,1,100.0%,38m
916,2,quail,4587,688,32,26,58,55.2%,36m
916,2,Coffice,4587,162,5,2,7,71.4%,18m
918,2,[OIGE]Swarm,4586,2300,195,188,383,50.9%,38m
919,2,[P00P2]Sandman,4585,0,1,0,1,100.0%,36m
920,2,Scisyhp,4584,719,30,34,64,46.9%,18m
920,2,[CS0]TeaAge,4584,46,3,1,4,75.0%,18m
922,2,[Perfec]Priest,4583,381,28,24,52,53.8%,34m
922,2,[Lp]BelenKvitko,4583,69,4,4,8,50.0%,19m
922,2,TerraN,4583,0,0,2,2,0.0%,18m
925,2,[PCAKE]Jimmy,4582,0,0,2,2,0.0%,15m
926,2,[BoT]PokajiChura,4580,120,6,10,16,37.5%,42m
926,1,llllllllllll,4580,97,2,0,2,100.0%,10m
926,2,IronmanDies,4580,0,0,1,1,0.0%,10m
929,2,Duke,4578,1350,60,60,120,50.0%,42m
930,1,[TPGGXD]PINGAFLACIDA,4577,2756,167,161,328,50.9%,24m
930,2,[inCo]EmPirE,4577,86,1,1,2,50.0%,10m
930,2,[QTp2T]PicKles,4577,0,0,1,1,0.0%,34m
933,1,[GdAT]oPZesty,4576,2164,89,99,188,47.3%,24m
933,1,[CornZ]Primal,4576,0,0,1,1,0.0%,10m
935,2,[EZGGGG]MasterKato,4575,584,56,41,97,57.7%,42m
935,2,[FRMAGE]ColWombaT,4575,281,19,17,36,52.8%,5m
935,2,llllllllll,4575,80,5,2,7,71.4%,42m
938,2,[Ris3n]NewBreed,4574,2175,101,104,205,49.3%,10m
938,2,[NZER0]Draddition,4574,220,12,7,19,63.2%,4m
938,2,SleepyDronE,4574,77,1,1,2,50.0%,36m
941,2,[NwAs]PEKORA,4573,0,1,2,3,33.3%,36m
942,1,[αX]Pensai,4572,1633,117,118,235,49.8%,42m
942,2,IronJan,4572,957,53,31,84,63.1%,36m
944,2,[Gainss]Rufus,4571,0,1,0,1,100.0%,42m
944,2,FreeKooda,4571,0,1,0,1,100.0%,36m
944,2,bluewolf,4571,0,1,0,1,100.0%,18m
947,1,[xRtG]vØlüMë,4570,584,24,36,60,40.0%,39m
947,2,Webster,4570,254,8,16,24,33.3%,5m
947,2,[ArGNA]Rhizer,4570,46,3,7,10,30.0%,5m
947,2,[OGbros]OGmicah,4570,0,1,0,1,100.0%,34m
947,2,[pimbab]piercashuang,4570,0,1,0,1,100.0%,39m
947,2,llllllllllll,4570,0,0,2,2,0.0%,10m
953,2,[REPORT]captainboys,4569,26,1,2,3,33.3%,15m
954,2,IIIIIIIIIIII,4568,484,31,10,41,75.6%,39m
955,2,IIIIIIIIIIII,4567,411,24,5,29,82.8%,36m
955,2,ghostface,4567,114,4,8,12,33.3%,34m
957,2,Pilipinas,4565,2413,162,165,327,49.5%,39m
957,2,MutaPrinter,4565,1079,56,55,111,50.5%,18m
957,2,[prim8s]KFC,4565,347,17,11,28,60.7%,39m
957,2,hmm,4565,87,3,1,4,75.0%,38m
957,2,TibetOP,4565,0,1,0,1,100.0%,20m
962,1,FLawLesS,4564,1381,68,77,145,46.9%,31m
962,2,atom,4564,85,4,4,8,50.0%,23m
962,2,Sora,4564,0,0,1,1,0.0%,20m
965,1,[AD3C]YOYI,4563,1638,135,138,273,49.5%,42m
966,2,Fabz,4562,890,41,28,69,59.4%,5m
966,2,[TheUSS]Enterprise,4562,294,15,10,25,60.0%,39m
966,2,captainfail,4562,0,1,0,1,100.0%,34m
969,1,IllIIllllIIl,4561,121,2,2,4,50.0%,40m
969,2,Vahs,4561,0,0,1,1,0.0%,39m
971,2,[TSØP]chorocarlo,4560,2585,305,310,615,49.6%,19m
971,2,[AlIin]NineK,4560,44,4,5,9,44.4%,18m
971,2,[cl0udM]Eurystheus,4560,112,4,11,15,26.7%,18m
974,2,Vurtne,4559,1307,81,72,153,52.9%,18m
974,2,[Lp]JerrodSwag,4559,1111,56,53,109,51.4%,4m
976,2,Requiem,4558,1030,73,11,84,86.9%,20m
976,2,DUKnowKimchi,4558,123,6,3,9,66.7%,39m
978,2,[SR3]ProtectSR,4557,1506,78,57,135,57.8%,5m
979,2,[ZTempz]Majista,4556,1524,68,56,124,54.8%,20m
979,2,[αX]taedaj,4556,66,4,6,10,40.0%,19m
979,2,[GEEKED]BúnbòHue,4556,22,2,1,3,66.7%,41m
979,2,FrizzleFry,4556,0,0,4,4,0.0%,36m
983,2,RafaPhysio,4555,1335,65,44,109,59.6%,4m
983,2,[FMX]SHARK,4555,400,21,18,39,53.8%,39m
983,2,crBox,4555,332,12,20,32,37.5%,5m
983,2,[IDark]Minions,4555,78,2,0,2,100.0%,10m
983,2,[TMMM]Achilles,4555,93,2,3,5,40.0%,18m
983,2,[TTS1]KeTaMiNe,4555,0,0,1,1,0.0%,34m
989,2,IHOneB,4554,1501,73,48,121,60.3%,23m
989,2,Mykal,4554,125,10,4,14,71.4%,15m
989,2,[GØSU]Baneling,4554,0,0,1,1,0.0%,42m
992,1,[cl0udM]Nagaeiku,4553,2416,106,106,212,50.0%,15m
992,2,[XCPT]RoachPrinter,4553,62,4,8,12,33.3%,5m
992,2,Evolution,4553,118,2,4,6,33.3%,34m
992,2,[GØSU]zyclon,4553,0,1,0,1,100.0%,19m
996,2,[G0G0G0]QueeN,4552,690,38,15,53,71.7%,36m
996,2,Hellsgate,4552,353,14,12,26,53.8%,4m
998,2,Chummers,4551,1123,48,48,96,50.0%,42m
998,2,SON,4551,170,12,4,16,75.0%,5m
998,2,planetninex,4551,158,8,9,17,47.1%,38m
998,2,SORCERER,4551,0,0,1,1,0.0%,5m
1002,2,[SftVgn]DoTcom,4550,708,24,32,56,42.9%,5m
1003,1,Vin,4549,1074,46,52,98,46.9%,28m
1004,2,GonnaGo,4548,245,13,6,19,68.4%,10m
1004,3,[OIGE]Raffa,4548,0,0,1,1,0.0%,41m
1004,2,[fneSin]VapouR,4548,0,0,2,2,0.0%,4m
1007,2,Tenken,4547,2071,119,122,241,49.4%,18m
1007,2,Nezi,4547,166,9,7,16,56.2%,15m
1007,2,Ascendead,4547,72,4,4,8,50.0%,4m
1010,3,LiquidSouL,4546,1787,251,252,503,49.9%,18m
1010,3,TBoNe,4546,118,12,7,19,63.2%,4m
1012,2,[RVluv]RedVelvet,4544,256,15,7,22,68.2%,41m
1012,2,[JIGLY]AlphaDrone,4544,10,4,1,5,80.0%,19m
1014,3,[lTKl]LittleFishey,4543,0,0,1,1,0.0%,18m
1015,2,ghostface,4542,1761,159,175,334,47.6%,34m
1015,2,[SsaYnS]Caloreen,4542,1512,70,71,141,49.6%,6m
1015,2,[αB]bScherm,4542,527,26,29,55,47.3%,10m
1018,2,llllllllllll,4541,492,22,29,51,43.1%,34m
1018,3,MasterFred,4541,0,1,0,1,100.0%,33m
1020,2,Ayteha,4539,434,18,26,44,40.9%,42m
1020,3,IIIIIIIIIIII,4539,161,6,4,10,60.0%,6m
1020,3,[OGbros]Xephos,4539,48,4,2,6,66.7%,10m
1023,2,Chimp,4538,192,11,13,24,45.8%,23m
1023,3,[LoF]mNotABarCode,4538,0,0,1,1,0.0%,6m
1025,3,Triceratops,4537,0,1,0,1,100.0%,29m
1026,2,LhornyTorynK,4536,1740,145,100,245,59.2%,42m
1026,3,SDGSDGSDG,4536,399,16,2,18,88.9%,25m
1026,3,[xNtG]FlawlessPim,4536,0,0,1,1,0.0%,5m
1026,3,QQQ,4536,0,0,1,1,0.0%,33m
1026,3,[AthSun]Aysymer,4536,0,0,1,1,0.0%,11m
1031,3,[SM1L3]SmartWong,4535,535,30,9,39,76.9%,42m
1031,2,Realone,4535,0,1,6,7,14.3%,18m
1033,2,IlIlIlIlIlIl,4534,198,11,3,14,78.6%,36m
1034,2,llllllllllll,4533,2534,199,215,414,48.1%,10m
1034,2,[PSU]shlood,4533,1355,63,59,122,51.6%,41m
1034,2,Vdek,4533,754,60,51,111,54.1%,5m
1037,3,[OIGE]VIPER,4532,260,23,14,37,62.2%,15m
1037,2,[AMisEZ]PiKaChu,4532,14,2,5,7,28.6%,19m
1039,2,Roboroadkill,4531,2515,120,115,235,51.1%,39m
1039,2,[NLC]Blackout,4531,187,8,8,16,50.0%,19m
1039,2,Ponder,4531,178,6,15,21,28.6%,19m
1039,3,[ROYALS]SocialOutkas,4531,0,1,0,1,100.0%,18m
1039,3,CarsonSteve,4531,0,0,1,1,0.0%,36m
1044,3,Serenity,4530,791,66,58,124,53.2%,20m
1044,3,TelecoM,4530,14,3,2,5,60.0%,4m
1044,3,[Ash3s]MetalSwarm,4530,0,0,1,1,0.0%,11m
1047,2,IIIIIIIIIIII,4529,131,4,6,10,40.0%,34m
1048,2,SunRise,4528,2469,147,167,314,46.8%,6m
1048,2,IIIIIIIIIIII,4528,354,16,17,33,48.5%,19m
1050,2,Ignignokt,4527,2472,197,179,376,52.4%,42m
1050,2,Tyler,4527,1891,85,108,193,44.0%,19m
1050,3,Akuji,4527,6,1,2,3,33.3%,27m
1053,1,[WildAF]WildCard,4526,2743,312,287,599,52.1%,9m
1053,2,CookieBytes,4526,2521,128,123,251,51.0%,19m
1053,3,[TSFs]Shrapnel,4526,0,1,1,2,50.0%,41m
1056,2,[PHAN]Phantom,4525,683,37,34,71,52.1%,19m
1056,2,Sorry,4525,257,13,4,17,76.5%,4m
1058,3,[NuHope]Ultmtfightr,4524,380,26,7,33,78.8%,31m
1058,3,[INextI]IÐrA,4524,0,1,0,1,100.0%,25m
1058,3,lllIIlllllll,4524,4,1,2,3,33.3%,33m
1061,2,Scheeze,4523,1230,51,47,98,52.0%,23m
1061,2,overlordimba,4523,40,2,6,8,25.0%,4m
1061,3,[KingSC]ShAkA,4523,0,0,1,1,0.0%,23m
1064,1,Natureboy,4522,2717,158,136,294,53.7%,24m
1064,2,[VetZCo]zorll,4522,2048,88,95,183,48.1%,19m
1064,3,[aivNA]Devichi,4522,0,0,2,2,0.0%,37m
1067,2,BubbaGump,4521,709,37,38,75,49.3%,38m
1067,3,Cross,4521,0,0,1,1,0.0%,41m
1069,3,Tachyon,4520,2342,250,252,502,49.8%,35m
1069,1,[FvR]ShOckWavE,4520,2371,100,97,197,50.8%,42m
1069,2,RivaL,4520,76,1,3,4,25.0%,39m
1072,2,Kaiman,4519,2110,127,124,251,50.6%,42m
1072,2,[G0G0G0]MazikeeN,4519,2202,98,90,188,52.1%,20m
1072,2,[DikBoy]Drakken,4519,390,17,26,43,39.5%,18m
1072,3,TastyZerg,4519,0,0,2,2,0.0%,18m
1076,1,Cullican,4517,1354,48,61,109,44.0%,24m
1076,2,Pepega,4517,462,22,9,31,71.0%,34m
1076,2,[FxB]Vedeynevin,4517,102,4,4,8,50.0%,10m
1079,3,llllllllllll,4516,0,0,1,1,0.0%,36m
1079,2,[TSØP]Gab,4516,0,0,5,5,0.0%,41m
1081,3,BanDi,4515,188,17,14,31,54.8%,6m
1081,3,SCIIDeadGame,4515,0,1,0,1,100.0%,20m
1083,1,[ShoaL]Rain,4514,0,1,0,1,100.0%,30m
1084,2,MooNLighT,4512,2528,199,223,422,47.2%,5m
1084,3,[TgAg]Friend,4512,0,1,0,1,100.0%,36m
1084,3,IMogsPrime,4512,0,0,2,2,0.0%,6m
1087,2,XIV,4511,778,34,40,74,45.9%,19m
1087,3,Nice,4511,213,29,7,36,80.6%,20m
1087,3,[LeHigh]Family,4511,0,0,2,2,0.0%,18m
1090,2,Wittgenstein,4510,36,2,9,11,18.2%,19m
1090,3,[DhZPro]Mithrandir,4510,0,0,1,1,0.0%,25m
1090,3,[NEFN]ignorant,4510,0,0,2,2,0.0%,18m
1093,2,[αB]BushZk,4509,2634,427,432,859,49.7%,41m
1093,2,[lCY]Kozan,4509,1996,141,137,278,50.7%,6m
1093,2,[Micr0]KeyRiced,4509,2555,140,133,273,51.3%,41m
1093,2,[GLAZ]Glazerbeam,4509,904,38,42,80,47.5%,34m
1093,3,[kC]onPHYRE,4509,147,21,3,24,87.5%,4m
1098,2,SwarmNFuzzy,4508,310,31,9,40,77.5%,15m
1098,3,[EtrOy]helloworld,4508,300,17,16,33,51.5%,23m
1098,3,AciD,4508,0,1,0,1,100.0%,14m
1098,3,Mojoadam,4508,4,1,1,2,50.0%,33m
1098,3,[xLs]DtUltraling,4508,0,0,1,1,0.0%,31m
1103,3,llllllllllll,4507,431,22,3,25,88.0%,27m
1103,3,ILUVPOKIMANE,4507,139,12,3,15,80.0%,5m
1103,2,[SCxPH]Cypem,4507,114,8,14,22,36.4%,42m
1103,3,MyLiTtLePwNy,4507,0,2,3,5,40.0%,33m
1107,2,[5CP]Lego,4506,1234,81,71,152,53.3%,34m
1107,1,[SsaYnS]Booly,4506,1008,43,41,84,51.2%,24m
1107,3,Toyhouze,4506,4,2,1,3,66.7%,6m
1107,3,[Neuro]Epinephrine,4506,0,1,0,1,100.0%,31m
1107,3,burrito,4506,6,1,2,3,33.3%,36m
1112,3,Bridence,4505,716,47,19,66,71.2%,6m
1112,2,[αXLa]Darkness,4505,306,22,15,37,59.5%,42m
1112,2,[F2tv]DelaHousse,4505,10,2,3,5,40.0%,36m
1112,3,Bob,4505,0,0,1,1,0.0%,33m
1112,3,xcQuence,4505,0,0,2,2,0.0%,29m
1117,3,Peregrine,4503,451,21,11,32,65.6%,6m
1117,2,ziliboba,4503,144,9,14,23,39.1%,23m
1117,1,[GR33D]katamarine,4503,48,2,1,3,66.7%,11m
1117,3,[DRONGO]bega,4503,0,1,0,1,100.0%,18m
1117,3,[inCo]Cal,4503,14,1,3,4,25.0%,29m
1117,3,MiqueeNa,4503,0,0,1,1,0.0%,18m
1123,2,[LCE]ldrunk,4502,1453,67,73,140,47.9%,5m
1123,1,Rain,4502,96,3,2,5,60.0%,26m
1123,3,Saturated,4502,16,1,1,2,50.0%,21m
1123,2,Airspade,4502,0,1,3,4,25.0%,42m
1123,3,TheSTC,4502,0,0,1,1,0.0%,18m
1128,2,[TLAF]Shahzad,4501,363,27,32,59,45.8%,4m
1129,3,ElReynorTico,4500,50,23,20,43,53.5%,29m
1129,2,[juggr]Grahan,4500,318,17,19,36,47.2%,10m
1129,3,[Bizarr]aRtH,4500,0,1,0,1,100.0%,29m
1129,3,[500mms]Paul,4500,0,1,0,1,100.0%,10m
1133,2,Bathtub,4499,1757,84,79,163,51.5%,20m
1134,2,TheGodfather,4498,86,4,8,12,33.3%,23m
1134,3,[Macac0]HaDes,4498,0,0,1,1,0.0%,14m
1134,3,spider,4498,0,0,1,1,0.0%,18m
1137,2,Tyler,4497,361,18,16,34,52.9%,23m
1137,3,lIlIlIlIlIll,4497,339,12,7,19,63.2%,14m
1137,3,[KScrub]Tryptophan,4497,0,0,1,1,0.0%,11m
1140,1,[Ris3n]Richard,4496,2716,390,414,804,48.5%,9m
1140,1,spooner,4496,2692,282,315,597,47.2%,38m
1140,3,[Gpause]UareMyToy,4496,458,23,4,27,85.2%,11m
1143,2,[VetZCo]POODLEHAT,4494,399,18,20,38,47.4%,4m
1144,1,llllllllllll,4493,1403,100,91,191,52.4%,24m
1144,3,[TSØP]Elpájaroazul,4493,505,29,27,56,51.8%,11m
1144,3,llllllllllll,4493,287,18,6,24,75.0%,10m
1147,1,ssapchobo,4492,182,8,1,9,88.9%,23m
1148,3,lVlagic,4491,0,1,0,1,100.0%,31m
1149,3,lalilulelo,4490,268,15,15,30,50.0%,11m
1149,3,[BoRnGo]Steffan,4490,12,1,1,2,50.0%,29m
1149,3,[BIacer]ClassyKru,4490,0,0,1,1,0.0%,6m
1152,2,[GRNSKN]Nordres,4489,2512,422,429,851,49.6%,6m
1152,2,[cl0udM]Thimius,4489,803,45,27,72,62.5%,36m
1152,3,EJEJ,4489,158,12,12,24,50.0%,37m
1152,3,[lNEXl]HaunteR,4489,0,0,1,1,0.0%,29m
1152,3,AronBado,4489,0,0,1,1,0.0%,27m
1152,3,KonkeyDonk,4489,0,0,1,1,0.0%,9m
1158,2,lllIIIlllIII,4488,2530,145,121,266,54.5%,10m
1158,2,UnDieAble,4488,942,104,102,206,50.5%,34m
1158,3,Relinquish,4488,698,39,45,84,46.4%,21m
1158,3,llllllllllll,4488,244,24,3,27,88.9%,29m
1158,2,AMAGAD,4488,314,19,18,37,51.4%,34m
1158,3,NiTGriT,4488,116,11,8,19,57.9%,29m
1158,3,DelhiWarrior,4488,0,0,1,1,0.0%,27m
1158,3,[EZDUNK]LeDUNKjames,4488,0,0,1,1,0.0%,29m
1166,2,[AdaptG]Ecchi,4487,2457,162,173,335,48.4%,34m
1166,3,spooder,4487,30,4,1,5,80.0%,6m
1166,3,[LDCO]Identy,4487,0,0,1,1,0.0%,9m
1169,3,Buggsy,4486,88,11,7,18,61.1%,9m
1170,3,[DTokes]TerranTears,4485,779,105,87,192,54.7%,11m
1170,2,ColiNerTiA,4485,1592,77,71,148,52.0%,20m
1170,3,[Suzuki]Airi,4485,138,12,11,23,52.2%,31m
1170,3,[SyLx]aaa,4485,0,0,1,1,0.0%,36m
1174,3,[YUNHAO]Flume,4484,90,8,10,18,44.4%,6m
1174,3,DragonLily,4484,105,2,3,5,40.0%,31m
1174,3,lllGGGXIII,4484,0,1,0,1,100.0%,6m
1174,3,[WeLike]korVALUES,4484,8,1,4,5,20.0%,18m
1178,3,Modena,4483,28,2,1,3,66.7%,6m
1179,3,OneLiberator,4482,10,1,1,2,50.0%,5m
1180,1,Brutalisk,4481,1990,87,87,174,50.0%,38m
1180,3,Sinsecticide,4481,0,0,2,2,0.0%,33m
1182,3,DrBojengles,4480,46,5,3,8,62.5%,25m
1182,3,[GTBIG]Rayden,4480,0,1,0,1,100.0%,36m
1182,3,KiLLaZ,4480,0,0,1,1,0.0%,4m
1185,2,AVE,4479,140,7,1,8,87.5%,41m
1185,3,[FxB]Dyncommon,4479,4,1,1,2,50.0%,4m
1187,3,[ModrnF]FrostyFeet,4478,453,27,21,48,56.2%,37m
1188,3,[425]dugo,4477,708,49,26,75,65.3%,6m
1188,2,YuJoon,4477,40,3,7,10,30.0%,19m
1190,3,[DhZPro]FuSioN,4476,931,86,57,143,60.1%,42m
1190,1,SicKRat,4476,1272,54,77,131,41.2%,9m
1190,3,[cLsSC]SUPERBRUNO,4476,0,1,0,1,100.0%,42m
1190,3,[ZTemps]DreaM,4476,0,1,1,2,50.0%,25m
1190,3,Ajax,4476,0,1,4,5,20.0%,18m
1195,1,ViKinG,4475,1797,107,112,219,48.9%,42m
1195,2,llllllllllll,4475,1509,76,69,145,52.4%,34m
1195,2,[BRAAAP]Timorus,4475,781,33,38,71,46.5%,34m
1195,3,[RAMEN]mladicO,4475,16,3,5,8,37.5%,23m
1199,3,ogobogo,4474,24,4,3,7,57.1%,29m
1199,1,Goldmember,4474,48,1,2,3,33.3%,7m
1199,3,[WisOP]Cephalopod,4474,0,0,1,1,0.0%,27m
1202,2,EnDer,4473,1906,104,104,208,50.0%,34m
1202,3,[PPayne]FenrisWolf,4473,500,46,48,94,48.9%,18m
1202,3,Desperado,4473,0,1,0,1,100.0%,18m
1202,3,PaniC,4473,6,1,1,2,50.0%,4m
1206,3,IIIIIIIIIIII,4472,0,1,1,2,50.0%,31m
1206,3,AGRESOR,4472,0,1,4,5,20.0%,9m
1208,3,Bebop,4471,24,2,0,2,100.0%,10m
1208,3,[DRKAPP]MAhAAdEEN,4471,0,0,2,2,0.0%,14m
1210,3,AckOop,4470,134,13,10,23,56.5%,18m
1210,3,[FANXY]llllllllllll,4470,4,3,0,3,100.0%,36m
1210,3,[RØR]RoMSHoT,4470,6,1,3,4,25.0%,29m
1213,2,[JPOW]DankMaster,4469,1030,82,82,164,50.0%,34m
1213,3,Sarigden,4469,666,38,42,80,47.5%,31m
1213,2,[M4nLUV]BaldSavage,4469,153,25,33,58,43.1%,6m
1213,3,Rei,4469,289,17,0,17,100.0%,42m
1213,3,[ADBE]WetSpot,4469,42,4,7,11,36.4%,29m
1213,3,[INextI]Buho,4469,0,0,1,1,0.0%,21m
1219,2,metamagic,4468,2511,525,573,1098,47.8%,23m
1219,3,oasis,4468,2291,227,231,458,49.6%,29m
1219,3,[LeoD]GalenoJr,4468,484,27,10,37,73.0%,29m
1219,3,[GØSU]Stardew,4468,0,1,0,1,100.0%,18m
1219,3,[LUSK]MrAlgorithm,4468,0,0,1,1,0.0%,25m
1219,3,[RUMB]Ace,4468,0,0,1,1,0.0%,23m
1225,3,[HMTeam]KoyaTeckKpv,4467,1924,235,202,437,53.8%,29m
1225,3,MeneerAart,4467,0,0,1,1,0.0%,42m
1225,3,[Bonoo]JonSnow,4467,0,0,1,1,0.0%,18m
1225,3,[FWSpec]Glade,4467,0,0,1,1,0.0%,16m
1229,2,SpineshanK,4465,2434,416,424,840,49.5%,34m
1230,3,CALLmeMaybe,4464,0,0,1,1,0.0%,36m
1230,3,[TwitcX]AminoX,4464,0,0,2,2,0.0%,25m
1232,3,xSr,4463,247,7,7,14,50.0%,29m
1233,3,Dylluna,4462,2293,178,159,337,52.8%,33m
1233,2,Knar,4462,144,6,10,16,37.5%,39m
1235,2,[Ranked]YellOw,4461,2287,111,101,212,52.4%,15m
1235,3,[LowIQ]Fergus,4461,0,1,0,1,100.0%,6m
1235,3,gag,4461,0,0,1,1,0.0%,36m
1235,3,[TIT4NS]FujMs,4461,0,0,1,1,0.0%,4m
1239,2,KiLLJoy,4460,803,39,42,81,48.1%,23m
1239,3,iStimUwin,4460,18,2,2,4,50.0%,4m
1241,3,KyleAlana,4459,1619,86,82,168,51.2%,21m
1242,3,[Bee]BerryRAWR,4458,24,1,3,4,25.0%,18m
1242,3,[Th3Bad]AllinsoN,4458,0,0,1,1,0.0%,36m
1242,3,[RnGpro]Guildelin,4458,0,0,1,1,0.0%,36m
1245,2,[FxB]Kevin,4457,274,12,20,32,37.5%,23m
1245,1,llllllllllll,4457,96,1,1,2,50.0%,26m
1247,3,WhyCamplane,4456,392,22,3,25,88.0%,42m
1247,3,Nuffy,4456,12,2,0,2,100.0%,25m
1249,2,[ßØßØMß]Jötunn,4455,259,44,49,93,47.3%,6m
1249,3,PawnPoker,4455,543,34,14,48,70.8%,11m
1249,3,[BRSKR]Rithrin,4455,0,1,2,3,33.3%,18m
1249,3,[sENaTe]beepis,4455,0,0,1,1,0.0%,29m
1253,3,[GdAT]Siowy,4454,611,45,19,64,70.3%,18m
1253,3,lllllllll,4454,94,6,10,16,37.5%,33m
1253,3,LemonDemon,4454,0,1,0,1,100.0%,16m
1256,3,llllllllllll,4452,34,6,8,14,42.9%,16m
1256,2,CreatorJEJA,4452,48,2,1,3,66.7%,26m
1258,2,XIX,4451,742,31,44,75,41.3%,38m
1258,3,LOVETRUMP,4451,431,25,10,35,71.4%,16m
1258,3,DarkSoul,4451,90,12,7,19,63.2%,25m
1258,3,Poppi,4451,0,0,1,1,0.0%,27m
1262,3,[GnR]Schmeet,4450,0,0,1,1,0.0%,25m
1262,1,[DIGITL]EndlessGG,4450,0,0,3,3,0.0%,11m
1264,1,[NAF]OldEvenBeard,4449,2605,222,218,440,50.5%,42m
1264,3,[AlIin]frugs,4449,486,31,33,64,48.4%,25m
1264,3,IIIIIIIIIIII,4449,24,5,2,7,71.4%,5m
1264,3,[SSAMZI]BTS,4449,0,0,1,1,0.0%,4m
1268,3,llllllllllll,4447,1028,83,88,171,48.5%,6m
1268,3,[M4E]Alex,4447,383,24,9,33,72.7%,6m
1270,3,Sajkczs,4445,1043,83,59,142,58.5%,29m
1270,3,Pakost,4445,0,1,0,1,100.0%,21m
1272,3,Bogus,4444,470,32,30,62,51.6%,16m
1272,3,[αX]VitamiN,4444,34,7,1,8,87.5%,29m
1272,3,[NovaX]Soda,4444,34,6,0,6,100.0%,25m
1272,3,[GRNSKN]monkaSniper,4444,32,4,3,7,57.1%,31m
1276,3,Amir,4443,900,52,51,103,50.5%,21m
1276,3,[REPORT]rxthepro,4443,0,0,1,1,0.0%,42m
1278,3,NICKFTW,4442,1982,276,300,576,47.9%,36m
1278,2,Overmind,4442,2494,215,265,480,44.8%,10m
1278,2,[WSA]spyderslayer,4442,2201,118,114,232,50.9%,19m
1278,3,Fabz,4442,1009,90,55,145,62.1%,33m
1278,2,[LVerdá]SkyNet,4442,717,34,44,78,43.6%,19m
1278,3,Gluttony,4442,76,7,8,15,46.7%,23m
1278,3,[Lp]ChoBiTo,4442,30,5,2,7,71.4%,16m
1278,3,MrGuy,4442,26,3,6,9,33.3%,37m
1286,3,BigBoiGibby,4441,440,67,21,88,76.1%,37m
1286,3,Vindicarian,4441,214,24,22,46,52.2%,18m
1286,3,[GR33D]RogueZZ,4441,54,6,9,15,40.0%,37m
1286,3,JayTeee,4441,10,1,2,3,33.3%,6m
1290,2,patnessdark,4440,788,37,46,83,44.6%,10m
1290,3,Tacita,4440,8,1,2,3,33.3%,37m
1292,3,[ValidG]Simmen,4439,841,57,49,106,53.8%,4m
1292,3,[HMTeam]Envy,4439,96,11,10,21,52.4%,36m
1292,3,FadingAces,4439,0,1,1,2,50.0%,42m
1295,2,BassHabit,4438,2342,204,229,433,47.1%,10m
1295,3,[GRNSKN]GoatSwarm,4438,770,45,20,65,69.2%,29m
1295,2,WinterComing,4438,94,2,3,5,40.0%,4m
1298,3,[ValidG]HailHydra,4437,1063,61,52,113,54.0%,29m
1298,3,[Majinn]PrinceVegeta,4437,38,6,2,8,75.0%,33m
1298,3,[CUTEST]Livibee,4437,18,4,2,6,66.7%,11m
1298,3,[HMTeam]Covenant,4437,0,0,2,2,0.0%,11m
1298,3,IIIIIIIIIII,4437,0,0,2,2,0.0%,25m
1303,2,IIIIIIIIIIII,4436,1289,77,83,160,48.1%,4m
1303,2,[Lp]NeoShaGgy,4436,458,23,31,54,42.6%,20m
1303,3,NewRun,4436,22,1,1,2,50.0%,21m
1306,3,ShadowedRadi,4435,1345,74,63,137,54.0%,31m
1306,2,JoniMitchell,4435,608,23,34,57,40.4%,34m
1306,3,[FacTat]Infestivus,4435,0,1,0,1,100.0%,36m
1309,3,[Tyber]jameszhou,4434,2230,405,408,813,49.8%,25m
1309,3,AirStrike,4434,1624,188,154,342,55.0%,5m
1311,2,llllllllllll,4433,896,91,77,168,54.2%,4m
1311,2,[HMTeam]saVio,4433,1131,53,55,108,49.1%,10m
1311,3,IIIIIIIIII,4433,18,2,4,6,33.3%,29m
1314,2,Neighbor,4432,116,5,12,17,29.4%,36m
1314,3,[AKLsc]NeedMineral,4432,0,1,3,4,25.0%,18m
1314,3,[N0FKz]Nooba,4432,0,0,1,1,0.0%,25m
1314,3,[7IP]OniiChan,4432,0,0,1,1,0.0%,31m
1314,3,[Macac0]Cannibalize,4432,0,0,2,2,0.0%,25m
1319,3,[αB]Slayer,4431,1382,68,59,127,53.5%,16m
1319,3,[UMCP]DopeLid,4431,0,0,1,1,0.0%,25m
1319,3,[ProSC]BRYAN,4431,0,0,1,1,0.0%,33m
1322,3,Linsain,4430,524,27,1,28,96.4%,9m
1322,3,[HyperX]JohnWayne,4430,46,5,5,10,50.0%,18m
1322,3,EmoTurtle,4430,26,3,8,11,27.3%,33m
1322,3,[BLPINK]JENNIE,4430,0,1,0,1,100.0%,9m
1322,3,[utua]Richard,4430,0,0,1,1,0.0%,18m
1327,3,[VaLuE]PrimeHunterZ,4429,54,8,11,19,42.1%,29m
1327,3,Lisbon,4429,0,0,1,1,0.0%,27m
1329,2,[AoH]Zelniq,4428,2078,377,351,728,51.8%,19m
1329,3,TiKoz,4428,464,29,12,41,70.7%,14m
1331,3,[αX]Prevail,4427,232,21,20,41,51.2%,30m
1331,1,IIIIIIIIIIII,4427,145,3,10,13,23.1%,22m
1331,3,xilocamp,4427,0,0,1,1,0.0%,11m
1334,3,FlashZ,4426,514,35,15,50,70.0%,42m
1334,3,Kittystalker,4426,530,25,18,43,58.1%,16m
1334,3,PapaNO,4426,0,1,0,1,100.0%,31m
1337,3,Vertigo,4425,864,173,171,344,50.3%,29m
1337,2,hahaha,4425,974,52,52,104,50.0%,19m
1337,3,[LEGROS]BIG,4425,0,0,3,3,0.0%,11m
1340,3,[BoAVN]AsuraSC,4424,70,13,12,25,52.0%,33m
1340,3,[Ekath]Ekather,4424,12,2,1,3,66.7%,6m
1342,3,meksuh,4423,12,1,1,2,50.0%,6m
1342,3,[Ash3s]Zeth,4423,0,0,1,1,0.0%,9m
1344,3,necessity,4422,285,18,0,18,100.0%,29m
1345,2,GoblinKlaws,4421,0,3,6,9,33.3%,23m
1345,1,[AoBDE]BossToss,4421,0,1,0,1,100.0%,40m
1347,3,Norae,4420,1208,133,129,262,50.8%,21m
1347,3,[RmH]Stickywick,4420,1957,120,128,248,48.4%,31m
1347,2,[EzW]ThePro,4420,540,23,37,60,38.3%,10m
1347,3,techboy,4420,0,0,2,2,0.0%,31m
1351,2,DrDronage,4419,1180,56,70,126,44.4%,19m
1351,3,[PCAKE]Involution,4419,0,0,1,1,0.0%,18m
1351,3,[CHCKEM]cLaw,4419,0,0,2,2,0.0%,6m
1354,3,Icy,4418,0,0,1,1,0.0%,18m
1355,3,ApieceOfCake,4417,38,6,4,10,60.0%,29m
1355,3,[REPORT]Malevolence,4417,26,4,7,11,36.4%,4m
1355,3,HydrO,4417,0,0,2,2,0.0%,23m
1358,3,TmchNoobToss,4416,8,5,4,9,55.6%,29m
1358,3,[SMB]pepi,4416,0,0,1,1,0.0%,42m
1360,3,pboyle,4415,510,40,38,78,51.3%,37m
1360,3,brownhemp,4415,56,7,5,12,58.3%,18m
1360,3,sprout,4415,0,0,2,2,0.0%,37m
1363,3,SOLrender,4414,443,106,46,152,69.7%,18m
1363,3,Tom,4414,348,15,7,22,68.2%,11m
1365,3,[αXLa]Supremo,4413,0,2,3,5,40.0%,14m
1365,3,HakunaMatata,4413,0,1,1,2,50.0%,6m
1367,3,[Bloody]Mary,4412,198,12,3,15,80.0%,23m
1367,3,[iDrunk]jostn,4412,10,2,1,3,66.7%,36m
1367,3,Valgar,4412,0,1,0,1,100.0%,33m
1370,3,[GRNSKN]Ashiro,4411,193,21,20,41,51.2%,4m
1370,3,Anthony,4411,0,0,1,1,0.0%,36m
1372,3,IIIIIIIIIIII,4410,628,68,65,133,51.1%,29m
1372,3,[GnR]dirtgrub,4410,1037,53,54,107,49.5%,14m
1372,3,[0iq]ZlingPrinter,4410,140,14,17,31,45.2%,16m
1372,3,Barbarella,4410,26,4,4,8,50.0%,36m
1372,2,[GaTech]Aucamazn,4410,46,2,14,16,12.5%,20m
1377,2,Hippie,4409,2379,399,396,795,50.2%,39m
1377,2,Erodius,4409,2080,193,209,402,48.0%,18m
1377,2,Zen,4409,227,10,17,27,37.0%,38m
1377,3,[KiMBR]FeraMansa,4409,56,7,5,12,58.3%,31m
1377,3,Anvil,4409,0,0,1,1,0.0%,6m
1382,3,Greed,4408,44,7,6,13,53.8%,36m
1382,3,SonOfRouge,4408,30,5,11,16,31.2%,29m
1382,3,[αX]Vindicta,4408,38,3,6,9,33.3%,23m
1385,3,Torlock,4407,257,13,12,25,52.0%,21m
1385,3,llllllllllll,4407,52,5,7,12,41.7%,29m
1385,3,[TRotti]pokimane,4407,18,2,1,3,66.7%,5m
1388,3,[Coach]Dink,4406,1526,110,98,208,52.9%,37m
1388,3,[GOPERÚ]YosHymitsu,4406,1117,76,42,118,64.4%,5m
1388,3,[M1A5]Death,4406,16,3,0,3,100.0%,4m
1388,3,Ragnar,4406,0,0,1,1,0.0%,9m
1392,2,IIIIIIIIIIII,4405,2478,370,373,743,49.8%,39m
1392,3,llllllllllll,4405,334,39,20,59,66.1%,21m
1392,3,GrandAssault,4405,637,38,5,43,88.4%,29m
1392,3,NikoBellic,4405,0,0,1,1,0.0%,6m
1392,3,SayNoToZion,4405,0,0,1,1,0.0%,29m
1397,3,[LGNxx]ivTheMazoku,4404,0,0,1,1,0.0%,36m
1398,2,[cfaftw]Pheo,4403,2457,119,119,238,50.0%,39m
1399,3,[SoulK]Thimius,4402,124,8,2,10,80.0%,36m
1399,3,Sponge,4402,0,1,0,1,100.0%,29m
1399,3,JackLo,4402,0,0,4,4,0.0%,29m
1402,2,[TGCF]Belial,4401,2478,350,362,712,49.2%,39m
1402,3,Reynox,4401,611,82,71,153,53.6%,23m
1402,3,[NwAs]fluxKoas,4401,282,26,25,51,51.0%,18m
1402,2,[Ris3n]Raz,4401,594,22,42,64,34.4%,5m
1402,3,FatBoy,4401,32,7,2,9,77.8%,37m
1402,3,[G0G0G0]JoaoPistori,4401,0,1,0,1,100.0%,18m
1402,3,Terminator,4401,0,0,1,1,0.0%,18m
1409,3,IIIIIIIIIIII,4400,560,33,18,51,64.7%,31m
1409,3,Powoo,4400,8,2,4,6,33.3%,26m
1409,3,Raider,4400,0,0,1,1,0.0%,29m
1409,3,Pheint,4400,0,0,2,2,0.0%,18m
1413,3,Stropheum,4399,553,79,64,143,55.2%,11m
1413,3,SweetChickP,4399,25,31,36,67,46.3%,36m
1413,3,[BearMe]NightOwl,4399,267,14,1,15,93.3%,5m
1413,3,Laringe,4399,0,0,1,1,0.0%,9m
1417,2,Ascendead,4398,474,24,32,56,42.9%,11m
1417,3,Fire,4398,148,4,3,7,57.1%,21m
1417,3,[ValidG]AmandaGoats,4398,10,1,1,2,50.0%,14m
1420,3,Morsa,4397,1975,97,95,192,50.5%,31m
1420,3,[DTokes]Chronic,4397,854,47,47,94,50.0%,9m
1420,3,Mindex,4397,40,5,8,13,38.5%,29m
1423,2,AiSaranG,4396,1499,72,87,159,45.3%,11m
1423,3,[Fever]Prod,4396,0,3,2,5,60.0%,29m
1423,3,GameofDrones,4396,0,1,0,1,100.0%,23m
1423,3,Saturn,4396,0,1,2,3,33.3%,10m
1423,3,[ZTempz]PasT,4396,0,0,1,1,0.0%,33m
1423,3,[FBK]Wailord,4396,0,0,2,2,0.0%,36m
1429,3,[SsaYnS]ImTwelve,4395,950,42,43,85,49.4%,31m
1429,3,IllIIIllll,4395,88,9,6,15,60.0%,16m
1429,3,LANIMIRC,4395,24,4,9,13,30.8%,6m
1429,3,llIlIIIllIlI,4395,0,0,1,1,0.0%,25m
1433,3,llllllllllll,4394,0,0,1,1,0.0%,10m
1434,2,[MTSux]AntMantis,4393,2436,501,494,995,50.4%,42m
1434,2,Cowsrule,4393,1084,153,175,328,46.6%,4m
1434,3,Eyetalian,4393,52,9,6,15,60.0%,10m
1434,3,Taimyr,4393,99,5,2,7,71.4%,37m
1438,3,Bani,4392,280,20,22,42,47.6%,18m
1438,3,IntotheZerG,4392,177,11,6,17,64.7%,29m
1438,3,[ANIMOO]Ronski,4392,60,7,7,14,50.0%,29m
1438,3,[lLiTl]Voper,4392,12,1,1,2,50.0%,29m
1442,2,SorrySerral,4391,2468,408,464,872,46.8%,34m
1442,3,[WNRZ]Flojax,4391,167,28,27,55,50.9%,25m
1442,3,BabyDeVouR,4391,0,1,0,1,100.0%,29m
1445,3,Cadenza,4390,405,42,44,86,48.8%,26m
1445,3,Bananamansc,4390,725,40,34,74,54.1%,18m
1445,3,IIIIIIIIIIII,4390,22,5,5,10,50.0%,6m
1445,3,[iS]LIMITED,4390,0,1,0,1,100.0%,6m
1449,2,Saucisse,4389,1524,102,114,216,47.2%,34m
1449,3,Grimley,4389,353,12,1,13,92.3%,14m
1449,3,llllllllllll,4389,205,6,2,8,75.0%,33m
1449,3,[αX]MaidenSlayer,4389,0,0,1,1,0.0%,31m
1453,2,RIVEN,4388,0,1,0,1,100.0%,17m
1453,3,Chronos,4388,0,0,1,1,0.0%,33m
1455,3,Caesar,4387,2063,109,118,227,48.0%,16m
1455,3,[LDPro]TikiRoss,4387,32,6,2,8,75.0%,36m
1455,3,Hollow,4387,46,5,8,13,38.5%,6m
1458,3,[TGosuA]BadHairDayX,4386,137,5,0,5,100.0%,11m
1458,3,Intelix,4386,0,0,3,3,0.0%,36m
1460,2,[ZTempz]PaRaGoNPasT,4385,2448,152,169,321,47.4%,39m
1460,1,Quonzar,4385,97,2,0,2,100.0%,37m
1462,3,PkDriloon,4384,97,5,1,6,83.3%,5m
1462,3,[DETER]SOL,4384,4,2,0,2,100.0%,18m
1462,3,[420]CuteAznGirl,4384,10,2,4,6,33.3%,31m
1462,3,Amos,4384,0,0,1,1,0.0%,16m
1466,3,Sourdough,4383,759,39,16,55,70.9%,36m
1466,3,Ignatious,4383,6,1,3,4,25.0%,11m
1466,3,Pencil,4383,0,0,1,1,0.0%,21m
1466,3,Goosejuice,4383,0,0,1,1,0.0%,23m
1466,3,[MKoC]Napoleon,4383,0,0,2,2,0.0%,37m
1471,2,[FFJUST]StarDuck,4382,1167,61,58,119,51.3%,20m
1472,2,[TGosuD]Lightborn,4381,1102,161,177,338,47.6%,19m
1472,2,Ranko,4381,496,20,30,50,40.0%,42m
1474,3,[PTHero]esReveR,4380,465,38,33,71,53.5%,29m
1474,3,Wichi,4380,34,5,3,8,62.5%,29m
1474,3,Grrrr,4380,0,1,0,1,100.0%,18m
1474,3,[M3A5]UnseenForce,4380,0,0,1,1,0.0%,23m
1478,3,Antiegoist,4379,1121,276,242,518,53.3%,42m
1478,2,Steven,4379,195,9,1,10,90.0%,17m
1480,3,Sarah,4378,272,15,1,16,93.8%,16m
1480,3,Reunion,4378,6,1,2,3,33.3%,14m
1482,1,[UpeV]InMoLaTioNs,4377,2302,123,135,258,47.7%,38m
1482,3,Vic,4377,40,6,10,16,37.5%,18m
1482,3,[UAP]TheJedi,4377,0,1,3,4,25.0%,21m
1485,3,[BRSKR]Erujan,4376,1029,145,157,302,48.0%,37m
1485,2,IIllIIllIIll,4376,1304,71,87,158,44.9%,38m
1485,3,llllllllllll,4376,432,26,31,57,45.6%,23m
1485,3,[PwT]Akroz,4376,32,4,5,9,44.4%,31m
1485,3,MaDgwool,4376,24,3,7,10,30.0%,26m
1485,3,Menyét,4376,0,1,1,2,50.0%,23m
1491,3,[WNTR]Ordin,4375,0,1,0,1,100.0%,31m
1492,3,[PENSOO]vffff,4374,433,26,7,33,78.8%,31m
1492,3,[ANTlF4]Hilldawg,4374,447,25,20,45,55.6%,14m
1492,3,Jigosep,4374,236,11,8,19,57.9%,37m
1495,3,[TGosuC]gonjareya,4373,1349,315,328,643,49.0%,6m
1495,3,[FvR]Flamyblade,4373,1242,120,92,212,56.6%,29m
1495,2,Tenda,4373,554,80,60,140,57.1%,42m
1495,3,[TeamUR]Shadow,4373,30,5,8,13,38.5%,36m
1495,3,[BlTEL]DranzerJJ,4373,0,1,0,1,100.0%,29m
1500,3,Best,4372,586,33,14,47,70.2%,33m
1500,3,IllIIllIlllI,4372,123,5,4,9,55.6%,4m
1500,3,[sc2rep]DayofDreamz,4372,8,1,1,2,50.0%,21m
1500,3,Paçoquinha,4372,0,0,1,1,0.0%,42m
1504,2,Nolan,4371,1213,121,132,253,47.8%,34m
1504,3,[TSØP]dante,4371,468,28,32,60,46.7%,23m
1506,1,giZmo,4370,2172,81,117,198,40.9%,23m
1506,3,HiWoxs,4370,60,9,14,23,39.1%,9m
1506,3,PPAP,4370,0,4,1,5,80.0%,42m
1509,3,[GdAT]iamorni,4368,896,65,73,138,47.1%,36m
1509,2,DukeofEarle,4368,961,64,81,145,44.1%,5m
1509,3,KevinBacon,4368,58,10,9,19,52.6%,7m
1509,3,IIIIIIIII,4368,54,9,6,15,60.0%,29m
1509,3,[AlIin]TechFour,4368,0,1,0,1,100.0%,31m
1509,3,[SC2AU]vEnergyDrink,4368,0,0,2,2,0.0%,42m
1515,3,nikwelik,4367,1200,88,82,170,51.8%,23m
1515,3,IIIIIIIIIIII,4367,16,2,6,8,25.0%,26m
1515,3,aaa,4367,0,1,0,1,100.0%,42m
1515,3,[Ris3n]neverwinter,4367,0,0,9,9,0.0%,9m
1519,3,Pianistickz,4366,2173,197,193,390,50.5%,37m
1519,3,[D0J0]Nihjanix,4366,1003,93,75,168,55.4%,33m
1519,3,Zahl,4366,492,34,39,73,46.6%,4m
1519,3,EJEJ,4366,137,6,1,7,85.7%,18m
1519,3,Michael,4366,0,0,1,1,0.0%,27m
1524,3,Saliroz,4365,680,58,42,100,58.0%,10m
1525,3,[ScSwrm]Edennil,4364,547,32,21,53,60.4%,37m
1525,3,kyuubi,4364,325,18,1,19,94.7%,5m
1525,3,UpInYourBum,4364,0,0,5,5,0.0%,23m
1528,3,[Ris3n]Dankilicious,4363,1057,73,77,150,48.7%,21m
1528,3,[91Fans]scboy,4363,0,1,0,1,100.0%,18m
1530,3,[UofC]Pancakes,4362,106,10,13,23,43.5%,26m
1530,3,[KingSC]Maydaz,4362,96,7,14,21,33.3%,42m
1530,3,BamgOOraY,4362,0,0,1,1,0.0%,42m
1533,3,llllllllllll,4361,36,4,5,9,44.4%,33m
1533,3,Zarathustra,4361,0,0,1,1,0.0%,21m
1535,1,[JaMiT]CareAgain,4360,1170,43,64,107,40.2%,24m
1535,3,ABCD,4360,0,1,1,2,50.0%,36m
1535,2,[FINDEX]StoicWilly,4360,0,0,1,1,0.0%,42m
1538,3,[Ex0n]DOlPH,4359,649,31,14,45,68.9%,10m
1538,3,BWNER,4359,399,22,4,26,84.6%,11m
1538,3,[PwT]Proper,4359,0,1,0,1,100.0%,25m
1541,3,llllllllllll,4358,1562,85,77,162,52.5%,42m
1541,3,Hydro,4358,274,19,16,35,54.3%,29m
1541,3,llllllllllll,4358,259,9,8,17,52.9%,23m
1541,3,[Maegis]SliTaz,4358,8,1,2,3,33.3%,18m
1545,2,[MLPog]Alfy,4357,2368,142,162,304,46.7%,34m
1545,3,JJHH,4357,42,2,7,9,22.2%,11m
1545,3,[αX]Kunamatata,4357,8,1,1,2,50.0%,27m
1548,3,IfAnyFlip,4356,429,27,8,35,77.1%,31m
1548,3,IIIIIIIIIIII,4356,280,15,1,16,93.8%,42m
1548,3,Fjant,4356,0,1,0,1,100.0%,7m
1548,2,[BmJn]Homeboy,4356,0,0,1,1,0.0%,6m
1548,3,[PwT]Christ,4356,0,0,3,3,0.0%,31m
1553,3,[FANXY]KYCHEN,4355,36,3,5,8,37.5%,18m
1554,3,[M0P]Hysteria,4354,1166,70,40,110,63.6%,23m
1554,3,Truestory,4354,343,22,5,27,81.5%,42m
1554,3,llllllllllll,4354,279,10,7,17,58.8%,6m
1554,3,[JSQD13]Bigelow,4354,0,1,0,1,100.0%,27m
1558,3,[VFam]DepthDefying,4353,1093,170,170,340,50.0%,36m
1558,3,dubbledub,4353,508,38,38,76,50.0%,29m
1558,3,ImFromWuhan,4353,151,5,4,9,55.6%,16m
1558,3,ShadowThor,4353,48,5,6,11,45.5%,18m
1558,3,[nG]PerfectPlay,4353,10,3,5,8,37.5%,4m
1558,3,Random,4353,6,2,1,3,66.7%,23m
1564,3,PotatoMuffin,4352,1512,131,113,244,53.7%,16m
1564,3,[KODO19]xDank,4352,1379,128,121,249,51.4%,33m
1564,3,Carbine,4352,179,11,9,20,55.0%,27m
1564,3,Riyoshima,4352,20,5,6,11,45.5%,31m
1564,3,IntoTheSky,4352,0,0,1,1,0.0%,27m
1569,3,PROXY,4351,1573,372,338,710,52.4%,42m
1569,3,soniCSysteM,4351,532,27,8,35,77.1%,27m
1569,3,[VFam]NdnStyl,4351,321,17,19,36,47.2%,31m
1569,3,[GlRTH]boy,4351,6,2,1,3,66.7%,21m
1569,3,[LTlord]HermeScLL,4351,0,1,0,1,100.0%,31m
1569,3,[aivNA]fig,4351,4,1,4,5,20.0%,26m
1575,3,bScherm,4350,595,148,148,296,50.0%,29m
1575,3,Nova,4350,103,2,2,4,50.0%,31m
1575,3,Hirudin,4350,0,1,0,1,100.0%,18m
1578,3,LetMeKissYou,4349,1240,62,64,126,49.2%,16m
1578,3,[MLGN]DarkenedIBug,4349,8,2,2,4,50.0%,23m
1578,3,llllllllllll,4349,0,0,1,1,0.0%,18m
1578,3,[ANED]yoboyye,4349,0,0,1,1,0.0%,37m
1582,3,[DIKOUT]Exxidae,4348,706,35,12,47,74.5%,29m
1582,3,[biigpp]BlipDoolPoon,4348,0,1,0,1,100.0%,36m
1582,3,[G0G0G0]Austin,4348,0,0,1,1,0.0%,7m
1582,3,[WuTang]stee,4348,0,0,1,1,0.0%,29m
1586,2,makoplux,4347,912,51,63,114,44.7%,19m
1586,3,Law,4347,665,41,39,80,51.2%,10m
1586,3,MarineQueen,4347,242,22,21,43,51.2%,36m
1586,3,CutiePieZerG,4347,163,18,12,30,60.0%,7m
1586,3,MonsteR,4347,0,1,0,1,100.0%,36m
1591,3,BadHorsey,4346,6,2,1,3,66.7%,6m
1591,3,DiVaD,4346,97,1,1,2,50.0%,14m
1591,3,[Th3Bad]Gauss,4346,0,0,2,2,0.0%,23m
1594,2,LoSt,4345,2021,221,219,440,50.2%,34m
1594,3,iMakeDrones,4345,125,4,1,5,80.0%,27m
1596,1,hypnotoad,4344,426,19,4,23,82.6%,22m
1596,3,IIIIIIIIIIII,4344,292,13,0,13,100.0%,5m
1596,3,[Ex0n]BeoMulf,4344,14,2,4,6,33.3%,36m
1599,3,[neuroS]spArk,4343,597,76,44,120,63.3%,27m
1599,3,iWin,4343,357,39,25,64,60.9%,42m
1599,1,BiggestNoob,4343,386,18,4,22,81.8%,36m
1599,1,llllllllllll,4343,143,3,0,3,100.0%,8m
1599,3,[8iSh]SlipJip,4343,121,2,1,3,66.7%,10m
1599,3,Tokash,4343,101,2,2,4,50.0%,21m
1605,3,[TGosuB]Parmigiano,4342,366,51,39,90,56.7%,4m
1605,3,Fenrir,4342,22,5,8,13,38.5%,7m
1605,3,Pancake,4342,0,1,3,4,25.0%,29m
1608,3,Raze,4341,428,51,50,101,50.5%,31m
1608,3,Epinephrine,4341,164,23,5,28,82.1%,25m
1608,3,[DETER]Horse,4341,0,1,0,1,100.0%,29m
1608,3,IIIIIIIIIIII,4341,97,1,1,2,50.0%,7m
1608,3,[haidua]kingut,4341,0,0,1,1,0.0%,29m
1608,3,[SFUSC]MingA,4341,0,0,2,2,0.0%,10m
1614,2,[BoRnGo]SauCeKinG,4340,1748,111,124,235,47.2%,19m
1614,2,NoHappy,4340,2049,105,119,224,46.9%,23m
1614,3,[S0Bs]KevFabrikant,4340,724,90,64,154,58.4%,10m
1614,3,IIIIIIIIIIII,4340,634,25,9,34,73.5%,31m
1614,3,Nilitsu,4340,186,17,6,23,73.9%,30m
1619,3,[neuroS]Ultrahugs,4339,1086,57,59,116,49.1%,29m
1619,3,Bane,4339,244,8,3,11,72.7%,9m
1619,3,bubbleboy,4339,40,7,9,16,43.8%,5m
1619,3,[2Pac96]monster,4339,0,1,0,1,100.0%,7m
1623,3,GenoMinion,4338,1558,222,197,419,53.0%,26m
1623,3,[ZC]Legacy,4338,931,155,128,283,54.8%,11m
1623,3,Garky,4338,818,35,27,62,56.5%,11m
1623,3,Xepto,4338,145,3,3,6,50.0%,5m
1623,3,[LimLim]Sound,4338,0,1,0,1,100.0%,21m
1628,3,[xRtG]NYC,4337,2011,125,129,254,49.2%,36m
1628,3,[cl0udM]Snulli,4337,578,31,5,36,86.1%,29m
1628,3,xelnegro,4337,0,1,0,1,100.0%,7m
1631,3,[Cryptc]Astra,4336,1066,68,57,125,54.4%,36m
1631,3,IIIIIIIIIIII,4336,647,43,31,74,58.1%,27m
1631,3,lilsnow,4336,901,39,19,58,67.2%,16m
1631,3,[cl0udM]SarsSan,4336,138,11,7,18,61.1%,7m
1631,3,Rage,4336,200,10,9,19,52.6%,29m
1636,3,Kez,4335,1683,141,113,254,55.5%,27m
1636,3,DualMonk,4335,685,25,24,49,51.0%,7m
1636,3,[ValidG]Adapt,4335,113,4,4,8,50.0%,42m
1639,3,BTG,4334,220,29,19,48,60.4%,29m
1639,3,Archile,4334,115,4,4,8,50.0%,26m
1639,3,Senpuden,4334,119,3,0,3,100.0%,16m
1642,3,abe,4333,407,42,29,71,59.2%,37m
1642,3,nudge,4333,365,15,4,19,78.9%,10m
1644,3,[Toker]SirSmokeAlot,4332,0,0,1,1,0.0%,36m
1645,1,Meridian,4331,2619,282,336,618,45.6%,23m
1645,3,[BRSKR]Pegasus,4331,847,52,35,87,59.8%,30m
1645,3,[TGosuB]SimplePickUp,4331,654,27,13,40,67.5%,14m
1645,3,TIMBA,4331,447,17,7,24,70.8%,29m
1645,3,gshuangdunai,4331,0,0,1,1,0.0%,4m
1650,3,JimJiggaman,4330,1473,239,219,458,52.2%,5m
1650,3,[FxB]Delicious,4330,1147,78,77,155,50.3%,31m
1650,3,llllllllllll,4330,169,5,3,8,62.5%,30m
1650,3,[ØFoxF2]AdLip,4330,40,5,4,9,55.6%,29m
1650,2,IIIIIIIIIIII,4330,0,1,0,1,100.0%,42m
1655,2,[BASED]Based,4329,1680,73,94,167,43.7%,18m
1656,2,Civil,4328,2385,402,401,803,50.1%,39m
1656,3,VibrantBlue,4328,872,57,70,127,44.9%,18m
1656,3,hellviper,4328,122,2,2,4,50.0%,19m
1659,3,IllllllllllI,4327,1033,52,17,69,75.4%,23m
1659,3,ILoveSimonsD,4327,164,42,32,74,56.8%,21m
1659,3,[xRtG]NamhciR,4327,0,2,3,5,40.0%,5m
1659,3,Starclone,4327,12,2,5,7,28.6%,31m
1659,3,Hayasaka,4327,0,0,2,2,0.0%,25m
1664,3,PeaKnuckles,4326,348,88,81,169,52.1%,42m
1664,3,[DarkAG]Dro,4326,505,75,57,132,56.8%,11m
1664,3,shtdisturban,4326,390,24,9,33,72.7%,37m
1664,3,jaMz,4326,418,21,7,28,75.0%,31m
1664,3,Zeke,4326,376,14,7,21,66.7%,9m
1664,3,[MirG]PuGGy,4326,167,8,2,10,80.0%,21m
1664,3,root,4326,0,1,0,1,100.0%,7m
1664,3,Kilieyn,4326,0,0,1,1,0.0%,16m
1672,3,[αX]TeaDragon,4325,305,42,24,66,63.6%,23m
1672,3,snowflake,4325,606,26,14,40,65.0%,25m
1672,1,GahnJah,4325,310,16,2,18,88.9%,12m
1672,1,bennyboy,4325,143,4,5,9,44.4%,11m
1672,3,Gladiator,4325,22,4,8,12,33.3%,21m
1677,3,GoRush,4324,466,89,72,161,55.3%,29m
1677,3,[M8cr0]MEMESnDREAMS,4324,837,39,38,77,50.6%,14m
1677,3,Mentanje,4324,60,10,17,27,37.0%,11m
1677,3,barcode,4324,250,8,13,21,38.1%,16m
1677,3,Sly,4324,217,7,1,8,87.5%,26m
1677,3,Vesper,4324,147,3,6,9,33.3%,7m
1677,3,weston,4324,0,1,3,4,25.0%,36m
1684,3,[NwAs]Ordin,4323,1448,194,190,384,50.5%,31m
1684,3,Gambeulin,4323,522,50,42,92,54.3%,11m
1684,3,[Perfec]Frontstab,4323,421,15,11,26,57.7%,26m
1684,3,[EZDUNK]DoubleEdge,4323,137,14,9,23,60.9%,25m
1688,3,kevinnleee,4322,795,70,54,124,56.5%,26m
1688,3,PocketSand,4322,558,35,47,82,42.7%,31m
1688,3,[FADo]DeadlyMouse,4322,91,2,1,3,66.7%,25m
1688,3,[NTDL]Lofty,4322,0,0,1,1,0.0%,31m
1692,3,[CASS]Cassidy,4321,1036,195,169,364,53.6%,30m
1692,3,beervirus,4321,1682,164,128,292,56.2%,9m
1692,3,defaspect,4321,1482,164,170,334,49.1%,5m
1692,3,JackLo,4321,1435,74,60,134,55.2%,42m
1692,3,Djula,4321,776,57,52,109,52.3%,10m
1692,3,[MAXIQ]FlamaBlanca,4321,597,40,37,77,51.9%,11m
1692,3,ChestCannons,4321,205,28,9,37,75.7%,29m
1692,3,BubblyFrog,4321,335,14,7,21,66.7%,14m
1700,1,TiGerG,4319,0,0,1,1,0.0%,8m
1701,3,ThePickler,4318,197,5,7,12,41.7%,25m
1701,1,gytZ,4318,0,0,1,1,0.0%,11m
1703,3,[GURKI]MrBurns,4317,206,15,21,36,41.7%,23m
1704,3,[AODSC2]NWARexius,4316,1606,108,102,210,51.4%,42m
1704,1,[CIoud9]IlllllI,4316,300,13,3,16,81.2%,33m
1704,3,mcVV,4316,0,2,4,6,33.3%,5m
1707,3,SkyNine,4315,1254,66,64,130,50.8%,7m
1707,3,Kuyzz,4315,218,16,24,40,40.0%,30m
1707,1,hoopaholik,4315,48,1,1,2,50.0%,35m
1707,3,Umar,4315,0,0,7,7,0.0%,7m
1711,3,llllllllllll,4314,2203,364,396,760,47.9%,7m
1711,2,[SC2PH]Azzin,4314,2392,126,149,275,45.8%,42m
1713,3,Neisseria,4313,2071,269,248,517,52.0%,4m
1713,1,MorganWallen,4313,0,0,1,1,0.0%,7m
1713,1,TripleXXX,4313,0,0,1,1,0.0%,8m
1713,1,Freestyler,4313,0,0,1,1,0.0%,20m
1717,3,[C0RB]Whitetiger,4312,468,26,12,38,68.4%,29m
1718,3,DoeBy,4311,579,28,23,51,54.9%,37m
1719,3,llIlIIllIIl,4310,840,49,57,106,46.2%,7m
1719,3,Boolone,4310,69,25,20,45,55.6%,36m
1719,3,[GOOGAN]GOOGAN,4310,131,10,4,14,71.4%,36m
1719,3,Life,4310,166,10,9,19,52.6%,25m
1723,2,[ToRQ]Wade,4309,1720,140,140,280,50.0%,5m
1723,3,[copain]apple,4309,864,60,52,112,53.6%,9m
1725,3,[TGosuC]Lucid,4308,1477,236,202,438,53.9%,5m
1725,3,[Lp]pzychO,4308,509,26,9,35,74.3%,11m
1725,1,[AIlin]PSosa,4308,0,1,0,1,100.0%,27m
1728,3,[APR]Megalisko,4307,705,40,33,73,54.8%,10m
1728,3,Jeeb,4307,90,13,14,27,48.1%,29m
1728,1,[IDV3]Vanarian,4307,0,0,1,1,0.0%,30m
1731,3,[SL7R]Voodoo,4306,210,19,23,42,45.2%,31m
1731,2,Hypno,4306,98,6,17,23,26.1%,38m
1731,1,BigBadBob,4306,48,1,1,2,50.0%,26m
1731,1,[TeamUR]KOali,4306,0,0,1,1,0.0%,4m
1735,1,[αX]NeRVe,4305,2596,295,295,590,50.0%,38m
1735,3,AiY,4305,0,0,6,6,0.0%,25m
1737,3,[xRtG]Timbermaw,4304,716,178,173,351,50.7%,7m
1737,3,Hodgeheg,4304,480,22,11,33,66.7%,28m
1737,1,Crisp,4304,0,0,1,1,0.0%,19m
1740,3,[NIKAA]CSC,4303,0,1,1,2,50.0%,33m
1741,1,Berzerker,4302,96,3,1,4,75.0%,30m
1741,1,llllllllllll,4302,0,0,1,1,0.0%,14m
1743,3,[xRtG]MasterMind,4299,26,9,11,20,45.0%,19m
1743,1,Sekai,4299,0,0,1,1,0.0%,8m
1745,3,[GOPERÚ]TheBest,4298,1289,99,67,166,59.6%,29m
1745,3,EcksDee,4298,376,17,6,23,73.9%,10m
1745,3,[ScSwrm]nigel,4298,158,16,8,24,66.7%,4m
1745,1,Moon,4298,0,1,0,1,100.0%,11m
1745,3,Zgredek,4298,4,1,4,5,20.0%,26m
1750,2,[DarkAG]PhleBuster,4297,2355,679,574,1253,54.2%,20m
1751,3,Voodoo,4296,630,37,42,79,46.8%,25m
1751,1,Alekhine,4296,192,4,4,8,50.0%,18m
1751,3,[prxynb]SalbeoL,4296,4,2,2,4,50.0%,33m
1751,1,[ExLa]Exclux,4296,0,0,1,1,0.0%,41m
1755,1,[xLgNx]SilentGhostt,4294,48,2,1,3,66.7%,36m
1755,2,tSunami,4294,0,0,1,1,0.0%,35m
1755,1,Dunbar,4294,0,0,1,1,0.0%,43m
1758,3,[αXLa]Dastan,4293,265,18,17,35,51.4%,42m
1758,1,Kratom,4293,0,3,2,5,60.0%,3m
1758,1,llllllllllll,4293,0,0,1,1,0.0%,28m
1758,3,SeeD,4293,0,0,5,5,0.0%,29m
1762,3,GreenCRV,4292,446,93,92,185,50.3%,29m
1762,3,UncleSlim,4292,324,30,38,68,44.1%,29m
1762,1,[Brahh]DoYuEvenLift,4292,192,4,3,7,57.1%,26m
1765,3,Fexx,4291,2171,816,829,1645,49.6%,28m
1765,2,[xRtG]Saku,4291,2068,179,208,387,46.3%,34m
1765,1,Pummeler,4291,2128,57,66,123,46.3%,14m
1765,3,[TCGsP]Iglooburner,4291,550,37,27,64,57.8%,36m
1765,3,[VOTEUS]joebiden,4291,48,11,10,21,52.4%,25m
1765,3,[LoF]TheGladiator,4291,34,8,11,19,42.1%,7m
1765,3,[xJUSTx]mLty,4291,50,7,11,18,38.9%,16m
1765,1,[TGosuB]NOMAD,4291,0,0,3,3,0.0%,38m
1773,3,aikrash,4290,1970,241,245,486,49.6%,42m
1773,3,FalseSith,4290,1538,95,103,198,48.0%,19m
1773,2,Revenant,4290,158,27,33,60,45.0%,6m
1773,3,Newton,4290,121,3,2,5,60.0%,29m
1777,3,Buff,4289,215,8,2,10,80.0%,42m
1777,1,[Njw]ProxyUpgrade,4289,48,1,1,2,50.0%,17m
1777,1,[DGiT]Rengen,4289,42,1,1,2,50.0%,42m
1777,1,[UW]EmperorZurg,4289,0,0,1,1,0.0%,41m
1781,3,mint,4288,2089,129,149,278,46.4%,37m
1781,3,Russkiy,4288,38,7,13,20,35.0%,31m
1781,1,coronavirus,4288,192,4,2,6,66.7%,37m
1784,1,[M1A5]LOBSTERBALLS,4287,1921,91,25,116,78.4%,36m
1785,1,Epinephrine,4286,706,15,5,20,75.0%,11m
1785,3,Kevin,4286,70,7,16,23,30.4%,36m
1785,1,[iMkS]SoldieR,4286,0,0,1,1,0.0%,43m
1788,3,[APTX]CyborgChina,4285,2191,169,179,348,48.6%,4m
1788,1,Terran,4285,1965,158,133,291,54.3%,37m
1788,3,MartinOne,4285,294,29,28,57,50.9%,31m
1791,3,[lCY]BoO,4284,1489,72,81,153,47.1%,25m
1791,1,[MtS]Shark,4284,958,32,12,44,72.7%,18m
1791,1,llllllllllll,4284,1122,29,21,50,58.0%,38m
1791,3,Garbage,4284,1,12,14,26,46.2%,21m
1791,1,[Astute]EfficieNcy,4284,0,0,1,1,0.0%,18m
1791,1,Watercress,4284,0,0,1,1,0.0%,7m
1791,1,[JDPWN]Concordia,4284,0,0,2,2,0.0%,41m
1791,1,[PZB9]SnoufyDuke,4284,0,0,3,3,0.0%,11m
1799,3,WGballzack,4283,1580,335,291,626,53.5%,16m
1799,3,Ancient,4283,434,60,54,114,52.6%,21m
1799,1,[Gaemer]GamerRicky,4283,524,12,8,20,60.0%,30m
1799,3,[OIGE]plopzito,4283,10,2,13,15,13.3%,29m
1799,1,RainSKT,4283,0,0,1,1,0.0%,23m
1804,2,llllllllll,4282,2004,164,163,327,50.2%,6m
1804,1,lllIllIlIllI,4282,397,19,4,23,82.6%,41m
1804,3,[LHRS]Charlie,4282,104,13,20,33,39.4%,42m
1807,3,llllllllllll,4281,385,23,9,32,71.9%,33m
1807,3,Simmen,4281,176,18,21,39,46.2%,36m
1809,3,GavinSachs,4280,1311,219,196,415,52.8%,33m
1809,3,[Flam3s]yenisimo,4280,1246,197,188,385,51.2%,9m
1809,1,Bob,4280,1726,55,58,113,48.7%,26m
1809,2,Seki,4280,0,4,1,5,80.0%,24m
1809,1,[CarLoZ]PaPiZsKi,4280,0,0,1,1,0.0%,41m
1809,1,[Morker]Mork,4280,0,0,1,1,0.0%,4m
1815,3,ToT,4279,304,20,4,24,83.3%,31m
1815,1,HanimeIsArt,4279,336,14,0,14,100.0%,14m
1815,1,Cryptos,4279,96,2,1,3,66.7%,36m
1815,1,Nova,4279,0,1,1,2,50.0%,35m
1815,3,[KiMBR]iamLazyboy,4279,0,0,3,3,0.0%,26m
1815,1,Wrath,4279,0,0,3,3,0.0%,9m
1821,3,Kaizer,4278,2159,413,422,835,49.5%,4m
1821,3,tMyers,4278,1428,132,115,247,53.4%,31m
1821,3,fotbalexpert,4278,642,38,49,87,43.7%,21m
1821,1,MacroTerran,4278,192,5,2,7,71.4%,33m
1825,3,[Lapis]Ignia,4277,170,20,19,39,51.3%,21m
1825,3,NoPressure,4277,18,4,8,12,33.3%,23m
1825,3,Schuppe,4277,4,1,5,6,16.7%,36m
1828,1,[touchy]Gumby,4276,2276,347,337,684,50.7%,18m
1828,2,[Lp]StarKS,4276,1734,101,112,213,47.4%,11m
1828,2,SolidClem,4276,0,0,2,2,0.0%,26m
1831,2,Macedon,4275,1216,50,69,119,42.0%,11m
1831,1,LingKing,4275,192,5,1,6,83.3%,16m
1831,1,ZukaLaBite,4275,0,0,2,2,0.0%,3m
1831,3,EzGameEzLife,4275,0,0,4,4,0.0%,5m
1835,1,SpamPants,4274,2239,91,63,154,59.1%,4m
1835,3,[xRtG]Ambition,4274,629,39,36,75,52.0%,42m
1835,3,[VOY3UR]RithoWkdman,4274,12,4,9,13,30.8%,31m
1838,3,[DhZPro]AndrezinhoBH,4273,66,13,15,28,46.4%,31m
1838,3,[SQB]Oblivion,4273,0,0,6,6,0.0%,31m
1840,3,[JOSUN]Silence,4272,1497,116,121,237,48.9%,18m
1840,3,Segovax,4272,92,11,13,24,45.8%,29m
1842,3,pink,4271,553,33,36,69,47.8%,14m
1842,1,KappaRoss,4271,543,22,6,28,78.6%,18m
1842,1,Enfury,4271,450,19,5,24,79.2%,41m
1845,1,Name,4270,2244,175,178,353,49.6%,13m
1845,1,Rusty,4270,0,1,0,1,100.0%,15m
1847,3,[Tasteb]Aggies,4269,254,10,10,20,50.0%,29m
1847,1,Kzo,4269,0,1,0,1,100.0%,37m
1849,1,[LCE]Kageyama,4268,1653,63,51,114,55.3%,38m
1850,3,[HBOOST]sparkling,4266,617,103,90,193,53.4%,42m
1851,3,Boon,4265,10,8,14,22,36.4%,36m
1851,3,Ralphie,4265,4,2,4,6,33.3%,30m
1851,2,YhyStanik,4265,0,1,0,1,100.0%,26m
1851,1,[500CC]lllllllll,4265,48,1,2,3,33.3%,9m
1855,3,CherryPopper,4264,1662,78,89,167,46.7%,26m
1855,1,IIIIIIIIIIII,4264,238,6,4,10,60.0%,38m
1855,1,LoQuAt,4264,0,1,0,1,100.0%,8m
1855,3,Toxicity,4264,14,1,10,11,9.1%,29m
1859,3,Snooper,4263,2122,223,251,474,47.0%,42m
1859,1,WhosSly,4263,288,6,8,14,42.9%,7m
1859,1,[Mc]PrimusDeksia,4263,0,1,1,2,50.0%,14m
1859,1,[Random]wingsOfMutas,4263,0,0,1,1,0.0%,3m
1863,3,Deathwish,4262,1485,170,163,333,51.1%,5m
1863,3,liltjay,4262,1537,130,101,231,56.3%,9m
1863,1,MiniDrogo,4262,193,7,8,15,46.7%,12m
1863,1,Teardrop,4262,190,5,1,6,83.3%,43m
1863,2,Guilty,4262,0,0,3,3,0.0%,30m
1868,1,Freeze,4261,1588,298,286,584,51.0%,15m
1868,1,PeaCH,4261,0,1,2,3,33.3%,37m
1868,1,WARLord,4261,0,0,1,1,0.0%,30m
1868,1,[SolOGS]Lorthiras,4261,0,0,3,3,0.0%,36m
1872,3,DroneKingPri,4259,2163,543,586,1129,48.1%,16m
1872,1,Valik,4259,445,20,6,26,76.9%,30m
1872,1,Flimsy,4259,612,14,11,25,56.0%,28m
1872,3,Kashmir,4259,18,5,8,13,38.5%,19m
1876,3,elevenS,4258,646,86,87,173,49.7%,19m
1876,3,IIIIIIIIIIII,4258,619,28,27,55,50.9%,31m
1876,1,[HDMS]Symphony,4258,84,3,3,6,50.0%,14m
1879,3,[BRSKR]Washikie,4257,842,119,121,240,49.6%,18m
1879,1,NoMouseSad,4257,1784,104,102,206,50.5%,38m
1879,1,MeepMeep,4257,0,0,4,4,0.0%,9m
1882,3,Boxer,4256,34,9,12,21,42.9%,16m
1883,1,[L0ne1y]PattyMac,4255,144,3,1,4,75.0%,7m
1884,3,[AD3C]yenisimo,4254,2106,263,257,520,50.6%,25m
1884,3,CryLegion,4254,852,51,59,110,46.4%,29m
1884,1,Satanas,4254,377,8,11,19,42.1%,38m
1887,1,dsn,4253,2253,259,233,492,52.6%,41m
1887,1,Mango,4253,843,45,45,90,50.0%,38m
1887,1,[cloudM]Yarters,4253,0,0,1,1,0.0%,11m
1887,1,[BRSKR]ElChefe,4253,0,0,3,3,0.0%,42m
1891,2,sLaiz,4252,289,9,1,10,90.0%,12m
1891,1,BeanBurrito,4252,182,6,2,8,75.0%,22m
1891,1,[TGCF]Pilsen,4252,0,1,0,1,100.0%,37m
1891,1,[Ris3n]SticksBender,4252,0,0,1,1,0.0%,11m
1895,3,[juggr]LunarSC,4250,1137,59,67,126,46.8%,28m
1895,1,[PapaZ]Reaper,4250,0,0,1,1,0.0%,37m
1895,1,[NYEAHH]Crimson,4250,0,0,1,1,0.0%,41m
1898,2,GamIsSecHome,4249,147,3,2,5,60.0%,36m
1899,3,Esper,4248,1874,159,178,337,47.2%,42m
1899,2,[nG]KraKen,4248,2106,105,122,227,46.3%,19m
1899,1,[αXLa]Mrdead,4248,1452,34,39,73,46.6%,23m
1899,1,[TSØP]RenesoundGB,4248,650,14,7,21,66.7%,16m
1899,1,[Amov3]Stukov,4248,434,10,9,19,52.6%,38m
1899,3,VXD,4248,10,4,6,10,40.0%,14m
1905,1,ChickenSalt,4247,1186,138,74,212,65.1%,29m
1905,1,Khorix,4247,847,48,49,97,49.5%,13m
1905,1,Aztrack,4247,1374,34,26,60,56.7%,38m
1905,1,[JustFF]Nibiru,4247,0,1,3,4,25.0%,38m
1909,1,YoYoMan,4246,883,42,16,58,72.4%,18m
1909,1,Jezza,4246,382,8,6,14,57.1%,43m
1911,2,TheBorg,4245,1784,141,141,282,50.0%,18m
1911,3,ElpiccoloMDL,4245,1251,108,104,212,50.9%,37m
1911,3,Walla,4245,244,10,8,18,55.6%,7m
1911,1,[G0G0G0]IIIIIIIIIIII,4245,144,3,2,5,60.0%,27m
1911,1,Zyzz,4245,144,3,7,10,30.0%,18m
1916,1,noimpact,4244,1764,45,48,93,48.4%,35m
1916,3,[M2A5]joepetey,4244,470,39,34,73,53.4%,29m
1916,3,Kripkenstein,4244,587,33,39,72,45.8%,9m
1916,1,Raines,4244,1064,27,18,45,60.0%,23m
1916,1,[Elda]SaftSack,4244,522,16,3,19,84.2%,29m
1916,1,Bananastar,4244,98,7,3,10,70.0%,37m
1916,1,Epinephrine,4244,48,2,3,5,40.0%,41m
1916,2,TerranUApart,4244,0,1,0,1,100.0%,26m
1924,2,MaaajorWood,4243,2344,334,326,660,50.6%,24m
1924,2,[3fps]macbook,4243,57,3,3,6,50.0%,17m
1926,1,[Tl2ON]TRON,4242,2044,185,178,363,51.0%,20m
1926,3,[AsTo]HeIdErN,4242,5,79,89,168,47.0%,25m
1928,3,pilzkeimII,4241,262,23,28,51,45.1%,31m
1928,1,Kuszu,4241,48,2,1,3,66.7%,41m
1928,1,Protoss,4241,48,1,2,3,33.3%,16m
1928,3,Antoine,4241,0,0,6,6,0.0%,10m
1932,1,[BHperu]kous,4240,96,2,5,7,28.6%,10m
1933,1,HankHill,4239,0,1,0,1,100.0%,22m
1934,3,[1E100]Xiv,4238,1296,73,77,150,48.7%,9m
1934,3,llllllllllll,4238,95,4,5,9,44.4%,25m
1936,1,[1E100]Emil,4237,240,6,0,6,100.0%,41m
1936,1,MisterDre,4237,144,4,5,9,44.4%,41m
1936,2,Victor,4237,90,2,1,3,66.7%,37m
1936,1,OOOO,4237,96,2,6,8,25.0%,11m
1936,2,EliteSapper,4237,0,1,0,1,100.0%,22m
1936,1,Kilmor,4237,0,0,1,1,0.0%,13m
1942,1,Camelot,4236,2246,339,340,679,49.9%,38m
1942,1,[PPleb]Blodzil,4236,2114,64,59,123,52.0%,9m
1942,3,Makero,4236,890,61,56,117,52.1%,7m
1942,1,Reppa,4236,0,1,0,1,100.0%,41m
1942,1,Dexter,4236,48,1,2,3,33.3%,8m
1942,1,DrPoopManMD,4236,0,1,2,3,33.3%,8m
1948,3,[TSØP]Irbogass,4235,135,43,42,85,50.6%,31m
1948,1,sfbf,4235,0,0,1,1,0.0%,5m
1950,1,Slylandro,4234,2239,115,102,217,53.0%,3m
1950,3,RockEr,4234,153,11,16,27,40.7%,42m
1950,1,zurglinz,4234,144,3,2,5,60.0%,30m
1950,1,[SwaPGC]DemonSwaP,4234,96,2,6,8,25.0%,13m
1950,2,HotS,4234,0,1,1,2,50.0%,12m
1955,3,Prophet,4233,1093,72,69,141,51.1%,10m
1955,1,Oof,4233,0,0,1,1,0.0%,7m
1957,1,Awoken,4232,587,29,6,35,82.9%,13m
1957,1,ProteinShake,4232,96,3,1,4,75.0%,41m
1957,1,IIIIIIIIIIII,4232,144,3,2,5,60.0%,30m
1960,3,Darkjestter,4231,2086,270,259,529,51.0%,28m
1960,3,ChronicBoom,4231,551,80,80,160,50.0%,23m
1960,1,FreezeTWO,4231,1476,74,61,135,54.8%,10m
1960,1,[Nu]AgentStang,4231,0,0,5,5,0.0%,30m
1964,2,kekedafofo,4230,388,26,46,72,36.1%,38m
1964,1,ohnice,4230,232,10,1,11,90.9%,5m
1964,2,llllllllllll,4230,0,1,0,1,100.0%,30m
1967,3,[LoF]RandomNick,4229,44,7,15,22,31.8%,31m
1968,1,Dexter,4227,2257,176,143,319,55.2%,38m
1968,1,IlIlIIIllllI,4227,1507,95,89,184,51.6%,13m
1968,1,[TSØP]MacroAKNI,4227,1628,47,53,100,47.0%,27m
1968,1,llllllllllll,4227,161,4,3,7,57.1%,7m
1968,1,GarmBrood,4227,0,1,1,2,50.0%,13m
1968,2,Marvel,4227,0,0,1,1,0.0%,18m
1974,3,[NPhase]Mugzy,4226,892,46,53,99,46.5%,42m
1974,1,[J2R]Crovy,4226,144,3,6,9,33.3%,16m
1974,1,Bonkarooni,4226,0,1,0,1,100.0%,18m
1974,1,Tradeoff,4226,48,1,1,2,50.0%,13m
1978,1,BigBadBill,4225,1670,51,39,90,56.7%,11m
1978,1,[RUMB]JAKETHESNAKE,4225,121,3,6,9,33.3%,27m
1980,1,Sneak,4224,1572,42,34,76,55.3%,27m
1980,3,[IMDSI]EtherNal,4224,0,1,6,7,14.3%,28m
1982,2,SurZerg,4223,1828,115,122,237,48.5%,24m
1982,1,BadPlayer,4223,513,22,7,29,75.9%,37m
1982,1,THXHXD,4223,240,5,10,15,33.3%,19m
1982,1,Lukman,4223,0,0,1,1,0.0%,10m
1986,3,sOs,4222,1189,157,139,296,53.0%,33m
1986,1,[Astute]ThaoTheSofa,4222,288,6,7,13,46.2%,33m
1986,1,spireet,4222,48,1,6,7,14.3%,12m
1989,1,[FPT]NotADragon,4221,1059,34,23,57,59.6%,17m
1989,1,Leaf,4221,238,6,3,9,66.7%,30m
1991,1,Xavier,4220,2227,276,258,534,51.7%,29m
1992,3,Danger,4219,1537,126,112,238,52.9%,31m
1992,1,[S0Bs]ParrD,4219,1290,30,31,61,49.2%,28m
1992,1,[UpeV]SMSakurazawa,4219,144,4,4,8,50.0%,12m
1992,1,BobdanSwolow,4219,0,0,1,1,0.0%,38m
1992,1,[UCSD]Piao,4219,0,0,1,1,0.0%,37m
1997,1,[αXLa]JessicaHyde,4217,2189,147,145,292,50.3%,17m
1997,1,Zeak,4217,1529,59,20,79,74.7%,16m
1997,1,ZKay,4217,97,2,2,4,50.0%,3m
1997,1,TerranUser,4217,0,0,2,2,0.0%,43m
2001,3,[M4th]juba,4216,613,114,94,208,54.8%,28m
2001,1,[Lp]TheDarkOne,4216,710,16,10,26,61.5%,17m
2001,1,llllllllllll,4216,190,5,5,10,50.0%,38m
2001,1,[FFJUST]Pookie,4216,0,0,2,2,0.0%,26m
2005,3,[ValidG]blast,4215,588,49,52,101,48.5%,31m
2005,3,BlackJakoo,4215,401,40,31,71,56.3%,37m
2005,3,[WNTRLH]barcode,4215,678,39,40,79,49.4%,28m
2008,1,Gaffle,4214,362,18,6,24,75.0%,28m
2008,1,[ezBad]rncg,4214,0,1,2,3,33.3%,16m
2010,3,[ScSwrm]Matsukawa,4213,1195,96,88,184,52.2%,10m
2010,1,Duke,4213,240,6,5,11,54.5%,38m
2010,1,DonoWall,4213,144,4,2,6,66.7%,37m
2010,1,DoorMan,4213,96,2,3,5,40.0%,11m
2014,1,[PTHero]Papapanda,4212,2202,223,213,436,51.1%,10m
2014,2,[PCAKE]darktemplar,4212,2317,198,192,390,50.8%,38m
2014,1,DanslePeteux,4212,2237,110,106,216,50.9%,38m
2014,1,CheepCheep,4212,640,20,7,27,74.1%,41m
2014,1,Diogonies,4212,784,17,20,37,45.9%,14m
2014,1,[DRFS]Merida,4212,186,5,3,8,62.5%,29m
2020,1,Freedom,4211,428,10,11,21,47.6%,38m
2021,3,llIIllIIllII,4210,610,76,59,135,56.3%,37m
2021,3,[Virgo]ZDragon,4210,240,15,18,33,45.5%,30m
2021,1,index,4210,48,2,1,3,66.7%,27m
2024,1,Echo,4208,1511,250,235,485,51.5%,30m
2024,3,RedAka,4208,38,6,25,31,19.4%,30m
2024,1,AlbusBrian,4208,0,1,0,1,100.0%,8m
2027,1,Megabearcub,4207,238,5,10,15,33.3%,33m
2027,1,Carrot,4207,0,0,1,1,0.0%,7m
2029,3,[LgnTDS]Fact,4206,549,28,27,55,50.9%,7m
2029,1,TheGoodOne,4206,1150,27,25,52,51.9%,37m
2029,3,IIIIIIIIIIII,4206,215,12,12,24,50.0%,11m
2032,1,IronCom,4205,48,2,5,7,28.6%,41m
2033,1,[Ris3n]stalixx,4204,568,12,18,30,40.0%,18m
2033,1,Shrike,4204,282,6,6,12,50.0%,30m
2033,1,[PwT]PredaGOD,4204,96,3,3,6,50.0%,8m
2033,1,hmmmm,4204,96,2,2,4,50.0%,40m
2037,1,sSniper,4203,1949,106,81,187,56.7%,26m
2037,3,IMMVP,4203,2,4,5,9,44.4%,33m
2039,3,Parasite,4202,2090,140,149,289,48.4%,42m
2039,1,[TGosuB]eliteslayer,4202,0,1,0,1,100.0%,36m
2041,3,PoZ,4201,2057,202,221,423,47.8%,30m
2041,3,[αX]SnapXD,4201,248,20,29,49,40.8%,19m
2041,2,Tamamo,4201,350,15,3,18,83.3%,5m
2041,1,[lLiTl]Broketail,4201,514,11,16,27,40.7%,18m
2041,3,Blacklisted,4201,32,5,1,6,83.3%,18m
2046,1,[Cube]Khalib,4200,2100,61,51,112,54.5%,27m
2046,1,DCmacro,4200,1289,40,39,79,50.6%,17m
2046,1,[DarkAG]Yoshi,4200,522,12,6,18,66.7%,17m
2049,3,[DhZPro]Zodte,4199,461,25,30,55,45.5%,14m
2049,1,FNX,4199,746,17,22,39,43.6%,29m
2049,1,Duke,4199,428,10,10,20,50.0%,17m
2052,1,[SsaYnS]amgine,4198,1831,263,233,496,53.0%,10m
2052,1,[KJedi]thespartan,4198,96,3,8,11,27.3%,11m
2052,3,MikiMagic,4198,0,1,4,5,20.0%,41m
2055,3,MARTINEZ,4197,1666,155,145,300,51.7%,10m
2055,3,[NPhase]ZergSucks,4197,659,32,37,69,46.4%,37m
2055,1,Gatsby,4197,0,0,1,1,0.0%,7m
2058,1,BustmyBanes,4196,1157,28,26,54,51.9%,17m
2058,1,Jaren,4196,96,3,3,6,50.0%,5m
2060,3,NoobZerg,4195,1972,97,104,201,48.3%,4m
2061,1,Harimang,4194,1807,132,129,261,50.6%,16m
2061,1,[hTx]Shrimp,4194,1489,40,40,80,50.0%,22m
2061,2,Niffy,4194,178,5,11,16,31.2%,25m
2061,1,ElPrezidente,4194,48,2,0,2,100.0%,40m
2061,2,Spotlight,4194,102,2,6,8,25.0%,13m
2066,3,BlackLipstik,4193,1425,127,125,252,50.4%,29m
2066,1,kwyjibo,4193,384,8,16,24,33.3%,30m
2066,1,[Zengi]Goat,4193,0,1,1,2,50.0%,28m
2069,1,Alandalf,4192,1180,80,68,148,54.1%,27m
2069,1,Ziekr,4192,1403,40,38,78,51.3%,11m
2069,1,[NIntN]Rhodesian,4192,48,1,3,4,25.0%,38m
2069,1,[KingSC]Diurno,4192,0,0,1,1,0.0%,14m
2073,2,[αXLa]Rare,4191,2304,379,420,799,47.4%,6m
2073,1,Ulargg,4191,1882,132,133,265,49.8%,18m
2073,1,SyndiCate,4191,390,13,4,17,76.5%,20m
2073,1,jayboc,4191,96,2,6,8,25.0%,35m
2073,1,[Feli]asdfgh,4191,0,0,2,2,0.0%,16m
2073,3,[SABO]Colourizing,4191,0,0,8,8,0.0%,9m
2079,2,Shrike,4190,2224,299,350,649,46.1%,11m
2079,3,Dream,4190,204,53,51,104,51.0%,21m
2079,2,TsogiMaster,4190,162,9,1,10,90.0%,4m
2082,3,[AngelA]Angelus,4189,1654,187,198,385,48.6%,23m
2082,3,[LAAR]ShiaLaBeouf,4189,476,109,111,220,49.5%,36m
2082,2,ImEmperor,4189,289,9,2,11,81.8%,9m
2085,1,[1l1l1l]Luna,4188,967,28,12,40,70.0%,37m
2085,1,[LowIQ]CrimsonKing,4188,474,10,13,23,43.5%,37m
2087,1,[MadK]Mavos,4187,2149,73,69,142,51.4%,26m
2087,1,Bankai,4187,1900,52,51,103,50.5%,26m
2087,3,[Unify]BadHairDayX,4187,810,50,61,111,45.0%,4m
2087,1,Sunlight,4187,1416,39,36,75,52.0%,33m
2091,3,Riot,4186,810,57,46,103,55.3%,16m
2091,1,[AIlin]EZHumidor,4186,1189,48,53,101,47.5%,30m
2091,1,LingBling,4186,620,14,15,29,48.3%,41m
2091,1,[mocat]Summer,4186,470,12,3,15,80.0%,14m
2091,2,Saint,4186,219,10,0,10,100.0%,14m
2091,1,[ROOT]AwesomeSauce,4186,0,0,1,1,0.0%,36m
2091,2,IIIIIIIIIIII,4186,0,0,7,7,0.0%,35m
2098,1,sighz,4185,2157,166,144,310,53.5%,30m
2098,1,BowHobaWitz,4185,288,18,3,21,85.7%,29m
2098,1,Zerz,4185,48,2,3,5,40.0%,30m
2098,1,llllllllllll,4185,0,0,3,3,0.0%,41m
2102,1,Ninj,4184,806,18,10,28,64.3%,33m
2102,1,PAOLO,4184,0,1,0,1,100.0%,43m
2104,1,[GumZ]NatroNix,4183,1734,54,54,108,50.0%,13m
2104,3,TuKi,4183,254,42,39,81,51.9%,26m
2104,1,[STRIDE]Stride,4183,0,0,1,1,0.0%,27m
2107,3,SnækPlatypus,4182,1972,131,139,270,48.5%,25m
2107,2,[αX]Sigil,4182,1541,67,75,142,47.2%,24m
2107,1,TheGreat,4182,1318,54,53,107,50.5%,9m
2107,1,[LgnTDS]OmniSkeptic,4182,932,20,27,47,42.6%,38m
2107,1,ReDPanDa,4182,578,16,0,16,100.0%,8m
2107,1,MIniDrogo,4182,133,5,6,11,45.5%,20m
2113,1,NazgulMX,4181,2198,227,234,461,49.2%,22m
2113,1,[GRNSKN]NeoZoom,4181,1423,170,159,329,51.7%,27m
2113,1,Zitronella,4181,848,28,12,40,70.0%,3m
2116,2,abcdefghijkl,4180,2200,355,373,728,48.8%,19m
2116,1,SuperTaco,4180,286,7,7,14,50.0%,3m
2116,1,Megumin,4180,96,4,3,7,57.1%,43m
2116,1,TardLisk,4180,192,4,7,11,36.4%,11m
2116,1,[KOYOMI]Akim,4180,0,0,1,1,0.0%,41m
2116,1,[ZzKPC]KuroMage,4180,0,0,2,2,0.0%,42m
2122,1,Nome,4179,0,1,1,2,50.0%,3m
2122,1,Nab,4179,0,0,1,1,0.0%,23m
2124,1,BomShiKi,4178,2211,166,169,335,49.6%,7m
2124,3,[ANFA]Fade,4178,789,44,46,90,48.9%,33m
2124,1,[GanGan]FairyTale,4178,778,17,13,30,56.7%,8m
2124,1,[OMGBAN]Tieng,4178,274,6,11,17,35.3%,29m
2124,3,[TgAg]Sam,4178,16,4,10,14,28.6%,36m
2124,1,[DhZAc1]LukeCage,4178,0,0,1,1,0.0%,13m
2130,3,BrutalBenjy,4177,378,24,14,38,63.2%,5m
2130,1,[GanGan]GANGANGAN,4177,694,15,18,33,45.5%,13m
2132,3,[GnR]Cruel,4176,1223,69,70,139,49.6%,14m
2132,1,Duffenzag,4176,230,7,7,14,50.0%,37m
2132,1,[GØSU]bobabomber,4176,48,1,1,2,50.0%,41m
2135,3,Blank,4175,433,54,68,122,44.3%,19m
2135,1,Logik,4175,355,17,2,19,89.5%,8m
2135,1,[sc2rep]Bowzer,4175,167,4,6,10,40.0%,14m
2138,1,[TOWL]Subspace,4174,924,44,33,77,57.1%,8m
2138,1,[xRtG]Prevention,4174,96,3,0,3,100.0%,3m
2138,1,FIGJAM,4174,96,3,1,4,75.0%,12m
2141,1,llllllllllll,4173,1455,42,35,77,54.5%,20m
2141,2,Duke,4173,308,15,2,17,88.2%,40m
2141,3,BlackRa,4173,0,2,6,8,25.0%,7m
2141,3,Emiras,4173,10,2,15,17,11.8%,42m
2141,2,NubLorD,4173,0,1,0,1,100.0%,18m
2141,1,TheMacroKing,4173,46,1,1,2,50.0%,38m
2141,1,Phive,4173,0,0,1,1,0.0%,13m
2141,1,PubGameHero,4173,0,0,5,5,0.0%,8m
2149,1,Punisher,4172,1226,37,30,67,55.2%,38m
2149,1,Zakalwe,4172,755,20,23,43,46.5%,29m
2149,1,AIFOX,4172,545,17,8,25,68.0%,13m
2152,3,[DCDC]Bombadil,4171,1470,340,330,670,50.7%,5m
2152,1,SteelHeart,4171,2196,110,101,211,52.1%,11m
2152,3,ivanwakeup,4171,1208,90,82,172,52.3%,18m
2152,1,Jaku,4171,768,33,31,64,51.6%,38m
2156,1,CandelMan,4170,334,7,8,15,46.7%,29m
2156,1,baezilisK,4170,48,1,1,2,50.0%,33m
2156,3,YouOnTilt,4170,0,0,5,5,0.0%,27m
2159,1,Leshy,4169,2146,220,241,461,47.7%,22m
2159,3,[ZTemp]Flare,4169,1284,192,194,386,49.7%,42m
2159,1,[apoca]Adeul,4169,1993,80,53,133,60.2%,18m
2159,1,TonySoprano,4169,286,6,8,14,42.9%,16m
2159,1,Cinnamon,4169,0,0,2,2,0.0%,14m
2164,1,[AMZN]Theios,4168,1887,153,130,283,54.1%,11m
2164,1,[F0cus]Fire,4168,48,4,1,5,80.0%,8m
2164,1,GamerMD,4168,88,2,2,4,50.0%,20m
2164,1,[Zprime]Crenty,4168,96,2,5,7,28.6%,17m
2168,1,[SkAL]ViewtifulJoe,4167,2122,145,131,276,52.5%,22m
2168,1,[Pharoh]Intuition,4167,1670,47,43,90,52.2%,23m
2168,1,[IMDSI]Funcky,4167,48,3,4,7,42.9%,14m
2168,1,[CSUF]Ice,4167,0,1,0,1,100.0%,7m
2168,1,Michael,4167,0,0,1,1,0.0%,30m
2173,3,Lockheed,4166,1774,262,260,522,50.2%,14m
2173,1,unorderedMap,4166,2124,92,76,168,54.8%,27m
2173,1,[GGBr0]testguy,4166,332,8,1,9,88.9%,22m
2173,1,Blazefree,4166,0,0,1,1,0.0%,14m
2177,1,IIIIIIIIIIII,4165,1646,52,30,82,63.4%,11m
2177,1,Larva,4165,1176,46,24,70,65.7%,26m
2177,1,[GRNSKN]ChiefColin,4165,1327,39,34,73,53.4%,13m
2177,1,Gelos,4165,810,19,10,29,65.5%,17m
2177,1,[SqR]zbawl,4165,0,1,2,3,33.3%,37m
2182,3,AestheTHICC,4164,1589,242,235,477,50.7%,18m
2182,1,Tethys,4164,2006,104,98,202,51.5%,28m
2182,1,[TGCF]AHAHAHAHAHAH,4164,929,31,17,48,64.6%,8m
2182,1,[TAW]Adimax,4164,330,7,10,17,41.2%,41m
2182,1,BigBang,4164,96,3,0,3,100.0%,16m
2187,1,[GrnBrd]barcode,4162,1986,69,76,145,47.6%,10m
2187,3,Asahi,4162,362,24,40,64,37.5%,9m
2187,1,Parsnip,4162,48,1,1,2,50.0%,7m
2190,1,[xLgNx]ColiNfsTrann,4161,852,19,13,32,59.4%,8m
2190,1,[scMAUI]Maxbrutus,4161,640,14,11,25,56.0%,26m
2190,1,Elosai,4161,570,12,19,31,38.7%,13m
2190,1,[420NS]CataphractZ,4161,0,0,1,1,0.0%,40m
2190,1,[Cryptc]SaYu,4161,0,0,1,1,0.0%,26m
2195,1,LynX,4160,468,10,9,19,52.6%,10m
2195,1,iNZoLitO,4160,240,6,4,10,60.0%,29m
2195,1,scubaskim,4160,0,0,1,1,0.0%,11m
2195,1,[ScSwrm]ShearFlip,4160,0,0,1,1,0.0%,23m
2199,1,[KingSC]TheWolF,4159,1106,26,32,58,44.8%,13m
2199,1,[LgnTDS]ibara,4159,48,1,6,7,14.3%,23m
2201,3,garypayton,4158,1414,151,158,309,48.9%,36m
2201,1,Cricket,4158,2178,101,87,188,53.7%,8m
2203,1,[Micr0]ThatDude,4157,0,1,0,1,100.0%,9m
2203,1,[Ris3n]MogSkynet,4157,0,1,0,1,100.0%,26m
2205,3,Hiramekarei,4156,2079,332,370,702,47.3%,31m
2205,3,Grimmy,4156,2054,330,344,674,49.0%,9m
2205,3,[GIANNI]VERSACE,4156,1499,148,126,274,54.0%,31m
2205,1,[IL1]Bdang,4156,1898,81,84,165,49.1%,16m
2209,1,antimatter,4155,1086,44,44,88,50.0%,27m
2209,1,Krieg,4155,96,3,0,3,100.0%,7m
2209,1,TheReapist,4155,0,1,0,1,100.0%,23m
2212,1,[DirtyP]Wubbey,4154,48,2,2,4,50.0%,29m
2212,1,[SuperZ]MINiUltra,4154,48,1,3,4,25.0%,7m
2212,1,[TrpleT]Jacooze,4154,0,0,1,1,0.0%,22m
2215,3,Nives,4153,2073,162,174,336,48.2%,36m
2215,3,[vG0D]FinalChapter,4153,76,27,42,69,39.1%,25m
2215,3,[Ex7rA]MiRaCle,4153,105,24,32,56,42.9%,31m
2215,1,KroNos,4153,286,6,8,14,42.9%,30m
2215,1,ZergRoadToML,4153,0,1,0,1,100.0%,11m
2215,1,llllllllllll,4153,0,1,0,1,100.0%,3m
2215,1,Baekrush,4153,0,0,1,1,0.0%,5m
2222,1,[ACSS]TheTiny,4152,2105,155,151,306,50.7%,11m
2222,1,Chicane,4152,1631,94,85,179,52.5%,20m
2222,3,RafaHungria,4152,1476,76,90,166,45.8%,26m
2222,1,Eythor,4152,135,6,3,9,66.7%,38m
2222,1,[IonG]KaboodleLXG,4152,144,3,10,13,23.1%,10m
2222,1,IIIIIIIIIIII,4152,48,1,1,2,50.0%,14m
2228,1,Ceskart,4151,1675,83,53,136,61.0%,27m
2228,1,Xilence,4151,82,2,1,3,66.7%,17m
2230,1,[Pig2]Brotoss,4150,2196,251,250,501,50.1%,13m
2230,1,[T1T5]MarineQueen,4150,2157,114,109,223,51.1%,29m
2230,1,Doohan,4150,2068,67,65,132,50.8%,37m
2230,1,Tayyy,4150,861,35,11,46,76.1%,7m
2230,1,CHL,4150,380,8,8,16,50.0%,9m
2230,1,CallMeJosh,4150,0,0,1,1,0.0%,43m
2236,3,SteelCyclone,4149,327,22,31,53,41.5%,7m
2236,3,[DhZCom]PrintSC,4149,230,20,38,58,34.5%,36m
2236,1,Slipspace,4149,358,8,6,14,57.1%,28m
2236,1,KiwiTaco,4149,190,5,2,7,71.4%,12m
2236,1,DaBi,4149,0,0,1,1,0.0%,37m
2241,3,DoeRaeMe,4148,277,11,16,27,40.7%,9m
2241,1,[lNI]AlwaysHigh,4148,238,6,4,10,60.0%,41m
2241,1,hello,4148,0,1,0,1,100.0%,13m
2244,3,[SkAL]FrostyFenix,4146,2028,160,168,328,48.8%,21m
2244,1,Smash,4146,144,3,5,8,37.5%,8m
2244,1,[TGCrew]Lithus,4146,48,2,2,4,50.0%,30m
2244,1,ivangnom,4146,0,1,0,1,100.0%,20m
2248,1,Barrel,4145,1959,219,222,441,49.7%,17m
2248,3,WoodsRanger,4145,207,25,35,60,41.7%,7m
2248,1,[OvG]Hyde,4145,383,9,6,15,60.0%,17m
2248,1,NotRicepaper,4145,48,2,3,5,40.0%,27m
2252,3,[FMX]JamesBaxter,4144,1854,315,314,629,50.1%,6m
2252,1,Alvi,4144,2055,120,121,241,49.8%,41m
2252,1,WiseWindu,4144,343,14,11,25,56.0%,12m
2252,1,llllllllllll,4144,0,1,0,1,100.0%,30m
2252,2,Ender,4144,0,0,1,1,0.0%,26m
2252,1,Hazardau,4144,0,0,1,1,0.0%,26m
2258,1,[xRtG]Armleg,4143,1138,26,28,54,48.1%,7m
2259,3,[TXOP]mcse,4142,1483,90,109,199,45.2%,42m
2259,1,CurrentFlow,4142,1099,43,43,86,50.0%,8m
2259,1,ZUHAIR,4142,740,21,24,45,46.7%,17m
2259,3,[UVUSC2]Sojourn,4142,102,14,23,37,37.8%,7m
2259,1,Påskägg,4142,0,1,0,1,100.0%,5m
2259,2,[2TETON]Lefraisacap,4142,30,1,2,3,33.3%,14m
2265,1,exercitum,4141,1836,88,53,141,62.4%,30m
2265,1,[HUSHrx]RockyyGoat,4141,48,2,0,2,100.0%,14m
2265,1,[Aveng]Avenger,4141,0,0,1,1,0.0%,18m
2265,1,Artifice,4141,0,0,2,2,0.0%,41m
2269,1,Bullsharks,4140,1955,283,272,555,51.0%,17m
2269,1,[ØØ]NerfHerder,4140,1456,91,83,174,52.3%,8m
2269,1,payback,4140,144,4,4,8,50.0%,10m
2269,1,ALBANINJA,4140,0,3,3,6,50.0%,20m
2269,1,[JUIN]Serp,4140,0,1,0,1,100.0%,30m
2269,1,diamond,4140,0,0,1,1,0.0%,40m
2275,1,Chenne,4139,2027,90,61,151,59.6%,16m
2275,1,Spiffin,4139,334,7,9,16,43.8%,27m
2275,1,Neo,4139,0,1,0,1,100.0%,28m
2278,1,[DhZAc1]New,4138,1867,177,169,346,51.2%,13m
2278,3,Tomus,4138,1205,63,70,133,47.4%,10m
2278,1,Goblin,4138,678,23,11,34,67.6%,16m
2281,1,[425]herO,4137,1927,80,74,154,51.9%,20m
2281,1,[nG]SupeRBrutE,4137,0,1,2,3,33.3%,26m
2281,1,Chill,4137,0,0,2,2,0.0%,37m
2284,1,[fucla]Michael,4136,1047,59,56,115,51.3%,18m
2284,1,Ghostcat,4136,862,53,49,102,52.0%,22m
2284,3,[NCSU]Voodoo,4136,280,20,36,56,35.7%,37m
2284,1,[2sA]Hoops,4136,0,0,1,1,0.0%,40m
2284,1,FCKU,4136,0,0,1,1,0.0%,37m
2284,1,roachan,4136,0,0,1,1,0.0%,9m
2290,1,[AthSun]Zergden,4135,508,12,11,23,52.2%,12m
2290,1,YeeHaw,4135,0,1,1,2,50.0%,22m
2292,1,[NPhase]MeronG,4134,1255,39,20,59,66.1%,28m
2292,1,ZtarTheGreat,4134,210,6,6,12,50.0%,42m
2292,1,[PwT]llllllllllll,4134,190,5,5,10,50.0%,18m
2292,1,[HankH]bobbyShmurda,4134,144,3,2,5,60.0%,10m
2292,1,Bean,4134,96,2,4,6,33.3%,30m
2292,3,[ReB]nOobO,4134,0,1,1,2,50.0%,26m
2298,3,[mvcs]biaji,4133,1431,122,128,250,48.8%,42m
2298,1,Tjure,4133,48,2,8,10,20.0%,13m
2300,3,[DIQPTE]aaaaaaaaab,4132,1656,212,216,428,49.5%,4m
2300,1,Rsterminador,4132,1976,88,70,158,55.7%,17m
2300,1,IIIIIIIIIIII,4132,249,12,0,12,100.0%,37m
2300,1,GLHF,4132,380,9,5,14,64.3%,41m
2304,1,[DETER]JellyKing,4131,48,1,1,2,50.0%,28m
2305,3,Roy,4130,1499,118,102,220,53.6%,33m
2305,1,[ZTemps]Mercenarie,4130,48,1,3,4,25.0%,20m
2305,1,[BRSKR]Rainier,4130,0,0,1,1,0.0%,20m
2305,1,Wilshire,4130,0,0,2,2,0.0%,27m
2309,3,[iStrat]Nerosus,4129,185,31,39,70,44.3%,23m
2309,3,[RMS]Mark,4129,180,15,30,45,33.3%,30m
2311,1,MacMiller,4128,288,14,10,24,58.3%,10m
2311,3,Qkdzl,4128,161,9,16,25,36.0%,29m
2311,1,[CUMBAT]koi,4128,236,5,2,7,71.4%,27m
2311,1,douevenlift,4128,48,2,0,2,100.0%,16m
2311,1,Vorck,4128,0,0,2,2,0.0%,36m
2311,1,whistletits,4128,0,0,2,2,0.0%,29m
2317,2,SarahZhang,4127,2259,320,372,692,46.2%,36m
2317,1,[neuroW]Elemyx,4127,1406,44,41,85,51.8%,11m
2317,1,[A1M]Moty,4127,0,0,1,1,0.0%,13m
2320,1,Sivade,4126,1040,25,21,46,54.3%,38m
2320,3,[LTK]Chroma,4126,200,9,15,24,37.5%,29m
2320,1,Incarnation,4126,96,3,7,10,30.0%,40m
2320,1,FluffyQT,4126,0,1,0,1,100.0%,29m
2320,1,[cl0udM]Symphony,4126,48,1,3,4,25.0%,43m
2320,1,[Inflow]PlzSendFunds,4126,0,0,1,1,0.0%,5m
2326,2,[2V2G0d]iHasTHIGHS,4125,865,80,91,171,46.8%,38m
2326,1,UYScuti,4125,48,1,5,6,16.7%,14m
2328,1,[JOOMA]Rav,4124,1242,34,35,69,49.3%,18m
2328,1,[TRTR]Deas,4124,48,1,1,2,50.0%,10m
2330,1,[Lp]gatoloco,4123,2042,104,97,201,51.7%,33m
2330,1,AlphabetLady,4123,0,1,0,1,100.0%,17m
2332,1,Vox,4122,914,21,23,44,47.7%,24m
2332,1,PaLoaLTo,4122,470,11,6,17,64.7%,41m
2332,1,[A1Star]Reborn,4122,0,0,1,1,0.0%,13m
2335,3,HandsomePig,4121,1015,571,547,1118,51.1%,10m
2335,1,[GEEKED]Oglop,4121,2152,268,278,546,49.1%,26m
2335,3,[Sune]Pistola,4121,1741,88,99,187,47.1%,29m
2335,1,ImissU,4121,1074,26,22,48,54.2%,10m
2339,3,[LoFoTr]VadehT,4120,1374,144,127,271,53.1%,31m
2339,1,ExiA,4120,0,0,1,1,0.0%,5m
2341,3,[CWAL]Changsta,4119,1760,120,116,236,50.8%,7m
2342,1,PurpleLemon,4118,2169,445,440,885,50.3%,17m
2342,3,[FARMS]claizen,4118,1123,136,142,278,48.9%,36m
2342,1,[ML]Troll,4118,2055,125,66,191,65.4%,17m
2342,1,MooStar,4118,1003,62,54,116,53.4%,20m
2342,1,DCmultitask,4118,822,18,21,39,46.2%,3m
2342,1,PartinG,4118,48,2,2,4,50.0%,40m
2342,1,[GGBr0]hihellowhihi,4118,0,0,4,4,0.0%,3m
2349,1,[LOAF]SeatLoaf,4117,1966,148,154,302,49.0%,20m
2349,3,[BoRnGo]PhysicsNoob,4117,338,29,41,70,41.4%,29m
2349,1,qnqn,4117,48,1,1,2,50.0%,33m
2352,1,Optimizer,4116,1264,30,38,68,44.1%,10m
2352,2,Yillilu,4116,177,6,6,12,50.0%,41m
2354,1,llllllllllll,4115,1843,56,58,114,49.1%,17m
2355,1,ComeAtMeBrah,4114,1043,44,37,81,54.3%,10m
2355,1,Eddie,4114,48,1,1,2,50.0%,16m
2355,2,IntotheBotto,4114,38,1,4,5,20.0%,25m
2358,1,dcare,4113,1644,81,52,133,60.9%,14m
2358,3,SyrupDeity,4113,208,26,39,65,40.0%,29m
2358,1,OFE,4113,734,17,21,38,44.7%,16m
2358,2,Mhysa,4113,380,16,5,21,76.2%,26m
2358,3,[Cryptc]SirDidymus,4113,112,14,31,45,31.1%,11m
2358,2,InSync,4113,239,6,2,8,75.0%,15m
2358,1,iBM,4113,0,1,0,1,100.0%,12m
2365,3,Edicted,4112,608,186,151,337,55.2%,23m
2365,1,[Chich1]Tatoks,4112,395,14,0,14,100.0%,24m
2365,1,UnderlineENT,4112,264,7,7,14,50.0%,22m
2365,1,[SRPM]SpartanValor,4112,142,3,4,7,42.9%,3m
2365,3,[cl0udM]putnik,4112,10,2,11,13,15.4%,28m
2365,1,Noumena,4112,0,0,1,1,0.0%,27m
2365,1,skygarden,4112,0,0,1,1,0.0%,18m
2372,1,DKeyAbuser,4111,476,19,5,24,79.2%,27m
2372,1,Arkantoss,4111,326,15,2,17,88.2%,18m
2372,1,Kittyfister,4111,0,0,1,1,0.0%,11m
2375,1,NoeCeraldor,4110,528,28,19,47,59.6%,10m
2375,1,UnDeadCrunch,4110,935,24,13,37,64.9%,8m
2375,1,[neuroW]ButterCup,4110,332,8,11,19,42.1%,8m
2378,1,llllllllllll,4109,1487,180,128,308,58.4%,43m
2378,1,[TANA]SilentNoodle,4109,923,30,15,45,66.7%,18m
2378,2,nenita,4109,230,14,1,15,93.3%,41m
2378,1,Skilgannon,4109,48,2,0,2,100.0%,11m
2382,1,[danuts]MNYODA,4108,1658,77,76,153,50.3%,42m
2383,3,Noobie,4107,2051,442,447,889,49.7%,36m
2383,1,DarkShine,4107,1216,108,92,200,54.0%,27m
2383,1,Zappadappa,4107,0,0,1,1,0.0%,10m
2383,1,Lyuganok,4107,0,0,1,1,0.0%,37m
2387,1,DRT,4106,604,14,13,27,51.9%,30m
2387,1,llllllllllll,4106,283,13,1,14,92.9%,38m
2387,1,[MYi]gladius,4106,0,0,1,1,0.0%,12m
2390,1,Absolution,4105,1611,85,80,165,51.5%,27m
2390,1,JEx,4105,648,14,12,26,53.8%,11m
2390,1,[TXOP]Licenciado,4105,0,1,1,2,50.0%,42m
2390,1,Finesse,4105,0,1,1,2,50.0%,41m
2390,1,llllllllllll,4105,46,1,5,6,16.7%,37m
2395,1,[INextI]MachinClaun,4104,1901,230,232,462,49.8%,37m
2395,1,[cl0udM]OldFashion,4104,1833,79,67,146,54.1%,42m
2395,3,IlIlIlIlIlIl,4104,1012,67,49,116,57.8%,9m
2395,1,Deadpool,4104,1579,42,49,91,46.2%,27m
2395,1,IIIIIIIIIII,4104,386,9,12,21,42.9%,10m
2400,1,[SsaYnS]Matt,4103,1547,221,219,440,50.2%,10m
2400,1,DonaldTrump,4103,642,23,10,33,69.7%,8m
2400,1,ExtraWetFart,4103,510,12,6,18,66.7%,41m
2400,1,Saul,4103,119,3,9,12,25.0%,24m
2400,1,MrG,4103,0,1,1,2,50.0%,20m
2400,1,DrProgeria,4103,46,1,2,3,33.3%,27m
2400,1,[αX]Kyno,4103,0,0,1,1,0.0%,43m
2400,1,marbles,4103,0,0,2,2,0.0%,26m
2408,3,IIIIIIIIIII,4102,0,6,4,10,60.0%,31m
2408,1,ArtOfWar,4102,48,1,1,2,50.0%,37m
2408,1,Albatross,4102,0,0,1,1,0.0%,17m
2411,1,[Fronds]DarkPRamza,4101,2163,356,356,712,50.0%,22m
2411,1,GtGsoon,4101,2149,234,229,463,50.5%,8m
2411,1,MotiveForce,4101,1927,188,158,346,54.3%,11m
2411,1,[GØSU]SkyWalkeR,4101,726,16,9,25,64.0%,11m
2411,1,Vero,4101,0,0,2,2,0.0%,29m
2416,1,MudKip,4100,2067,289,283,572,50.5%,5m
2416,1,Dumdidaj,4100,278,6,2,8,75.0%,17m
2416,1,Heziao,4100,0,0,1,1,0.0%,28m
2419,1,llllllllllll,4099,466,11,15,26,42.3%,37m
2419,1,[UpeV]Arrow,4099,382,8,11,19,42.1%,41m
2419,3,DeepOnes,4099,0,1,3,4,25.0%,17m
2419,1,[mYogum]Oppaya,4099,48,1,5,6,16.7%,13m
2419,1,[425]TRxArce,4099,0,0,1,1,0.0%,38m
2424,1,[GJIZZZ]Goosfraba,4098,1866,396,401,797,49.7%,11m
2424,1,[DarkAG]DeLi,4098,616,13,17,30,43.3%,27m
2424,2,[AMSeAL]Pope,4098,353,9,13,22,40.9%,37m
2424,1,[NwAs]Light,4098,0,1,0,1,100.0%,14m
2424,1,[AntNob]Crybaby,4098,0,0,1,1,0.0%,29m
2429,1,[ZLot]DirtMan,4097,944,22,28,50,44.0%,29m
2429,3,[DhZPro]Macaxeira,4097,293,18,30,48,37.5%,7m
2429,1,SandyRavage,4097,0,1,2,3,33.3%,14m
2432,1,[eSun]LegoKing,4096,887,40,29,69,58.0%,11m
2432,1,[FCLM]SuttOwnz,4096,282,7,6,13,53.8%,29m
2432,1,[UMCP]KINtoYou,4096,88,2,2,4,50.0%,20m
2435,1,CoCo,4095,489,15,6,21,71.4%,37m
2435,1,Painism,4095,0,1,0,1,100.0%,10m
2435,1,[EZDUNK]CHADMARINE,4095,0,0,1,1,0.0%,26m
2438,1,[DhZAc1]Caco,4094,1383,49,38,87,56.3%,27m
2438,1,mLtoni,4094,142,4,1,5,80.0%,27m
2438,1,shadowlight,4094,96,3,4,7,42.9%,38m
2438,1,[eXoPH]eXoDaSh,4094,0,0,1,1,0.0%,8m
2442,1,[xTQc]Freak,4093,373,9,7,16,56.2%,9m
2442,1,swerve,4093,142,4,6,10,40.0%,3m
2444,1,Chilibruce,4092,2114,370,362,732,50.5%,29m
2444,3,[Cryptc]Terra,4092,620,92,98,190,48.4%,19m
2444,2,YuriOrlov,4092,1364,80,110,190,42.1%,6m
2444,3,[Ris3n]renegadeX,4092,722,45,65,110,40.9%,19m
2444,2,Lithium,4092,40,2,0,2,100.0%,28m
2449,3,IIIIIIIIIIII,4091,1864,410,397,807,50.8%,7m
2449,1,Potatoking,4091,408,13,7,20,65.0%,17m
2449,1,[GNXPOP]Dragon,4091,192,5,1,6,83.3%,27m
2452,3,MindGrapes,4090,1976,320,316,636,50.3%,42m
2452,1,Peace,4090,1894,54,54,108,50.0%,29m
2452,1,Antiquity,4090,663,27,13,40,67.5%,28m
2452,3,[Imolin]wHipLaSh,4090,28,5,21,26,19.2%,10m
2452,1,Tossakun,4090,96,3,6,9,33.3%,3m
2452,1,[WOLVAR]Alvaro,4090,0,0,1,1,0.0%,41m
2452,1,[Kaii]JonWick,4090,0,0,1,1,0.0%,4m
2459,1,[DarkAG]Sleepy,4089,2140,389,383,772,50.4%,17m
2459,1,TrumpForEver,4089,534,17,16,33,51.5%,8m
2459,1,[NwAs]Judith,4089,201,7,15,22,31.8%,17m
2459,1,[Amb3rs]Michael,4089,0,1,0,1,100.0%,28m
2459,1,xLsShadow,4089,0,1,3,4,25.0%,29m
2464,3,Darknight,4088,1409,140,141,281,49.8%,16m
2464,1,[SDSC]dEadCloWn,4088,144,4,7,11,36.4%,16m
2464,2,[AMSeAL]IamBack,4088,44,1,4,5,20.0%,29m
2467,3,Kestnuts,4087,1660,122,125,247,49.4%,16m
2467,2,[αX]HyjiNx,4087,1964,97,115,212,45.8%,43m
2467,3,Strybosch,4087,1068,55,45,100,55.0%,7m
2467,1,iLUVpotatoes,4087,978,35,18,53,66.0%,4m
2467,1,bld,4087,944,21,26,47,44.7%,26m
2467,2,[αXLa]TheVirusLove,4087,57,3,1,4,75.0%,26m
2473,1,[Pton]Jellyfish,4086,2074,102,72,174,58.6%,32m
2473,2,ZapBranigan,4086,84,3,8,11,27.3%,29m
2475,3,Doomninja,4085,989,71,83,154,46.1%,4m
2475,1,MacroMantis,4085,425,21,5,26,80.8%,26m
2475,1,DameGaijin,4085,144,4,3,7,57.1%,27m
2475,1,[TAW]ZeRgBrOkEn,4085,0,1,2,3,33.3%,39m
2475,1,BravO,4085,98,1,3,4,25.0%,37m
2475,1,qOrLrp,4085,0,0,2,2,0.0%,18m
2481,1,Fruitality,4084,503,19,6,25,76.0%,37m
2481,1,[BLM4Ev]RIPGeorgeF,4084,0,2,1,3,66.7%,23m
2481,1,IIIIIIIIIIII,4084,0,1,0,1,100.0%,29m
2481,1,everNExt,4084,0,1,1,2,50.0%,36m
2485,1,marcel,4083,2156,106,99,205,51.7%,13m
2485,1,Trs,4083,926,47,42,89,52.8%,27m
2485,1,[IIDA]FRAGA,4083,1194,33,21,54,61.1%,23m
2485,1,ArriSTv,4083,730,17,16,33,51.5%,8m
2485,2,jcjc,4083,134,5,8,13,38.5%,13m
2485,1,AKIRA,4083,96,3,3,6,50.0%,37m
2485,1,Potato,4083,142,3,3,6,50.0%,7m
2485,1,[Ris3n]ReVolt,4083,0,0,1,1,0.0%,4m
2493,1,[cl0udM]KilgoreTrout,4082,1347,52,38,90,57.8%,11m
2493,1,[xLgNx]terran,4082,354,8,9,17,47.1%,22m
2493,1,[hLu]Popy,4082,48,2,2,4,50.0%,22m
2493,1,ghOst,4082,46,2,3,5,40.0%,4m
2497,1,[Macac0]xArtOffx,4081,514,11,16,27,40.7%,18m
2497,2,[Cl3f]SMB,4081,134,8,2,10,80.0%,41m
2497,1,TimingGG,4081,48,1,2,3,33.3%,8m
2497,1,FatWerm,4081,0,0,1,1,0.0%,8m
2501,2,IELTS,4080,315,15,2,17,88.2%,22m
2501,1,MakiMaki,4080,0,1,0,1,100.0%,17m
2501,3,HKN,4080,0,0,1,1,0.0%,7m
2504,1,Melbourne,4079,324,8,9,17,47.1%,10m
2505,1,[CtpSat]Dakob,4078,1735,50,51,101,49.5%,13m
2505,1,RipGeoff,4078,332,7,9,16,43.8%,3m
2505,1,lllllllllll,4078,46,6,1,7,85.7%,32m
2508,1,[VFam]ChateeZy,4077,1328,135,133,268,50.4%,24m
2508,1,Money,4077,504,30,14,44,68.2%,33m
2508,3,[LGNxx]GHOST,4077,298,22,30,52,42.3%,23m
2508,1,Squirtle,4077,585,20,18,38,52.6%,17m
2508,1,[ValidC]Havoc,4077,406,14,4,18,77.8%,3m
2508,1,sky,4077,278,6,14,20,30.0%,37m
2508,1,[Dopa]Dopa,4077,170,5,3,8,62.5%,37m
2508,3,[UFL]Jushyfruit,4077,0,0,1,1,0.0%,27m
2508,1,[Zanis]EpicLeonel,4077,0,0,1,1,0.0%,38m
2508,1,TheFallen,4077,0,0,2,2,0.0%,4m
2518,1,[NPhase]Veriox,4076,534,26,30,56,46.4%,20m
2518,1,MiScopMiHomm,4076,0,0,1,1,0.0%,28m
2520,1,[qOjOp]eurotrash,4075,1948,60,60,120,50.0%,10m
2520,1,TGNPS,4075,1410,36,40,76,47.4%,13m
2520,2,THBL,4075,339,16,4,20,80.0%,10m
2520,2,[Xpk]LeOStorM,4075,433,14,9,23,60.9%,42m
2520,2,[qingyi]nimatouqi,4075,179,11,0,11,100.0%,31m
2520,1,Nockman,4075,474,10,22,32,31.2%,23m
2520,1,[αX]ShazamPoof,4075,275,7,7,14,50.0%,42m
2520,1,Caocalral,4075,190,4,9,13,30.8%,8m
2528,1,Box,4074,2109,76,63,139,54.7%,20m
2528,1,Monster,4074,1326,32,38,70,45.7%,5m
2528,1,Scarface,4074,408,15,8,23,65.2%,38m
2528,1,KozukiYamato,4074,454,11,6,17,64.7%,27m
2528,1,Logic,4074,96,2,2,4,50.0%,3m
2528,1,[HUSHrx]LanceUpercut,4074,0,1,0,1,100.0%,17m
2528,3,[NW5]YoGoldorak,4074,30,1,6,7,14.3%,36m
2535,3,[UpeV]Kvothe,4073,1489,127,149,276,46.0%,23m
2535,1,SiDeEfFeCtZ,4073,2103,85,87,172,49.4%,10m
2537,1,Chrollo,4072,0,0,1,1,0.0%,13m
2538,1,aTWOgoTWO,4071,1267,70,73,143,49.0%,17m
2538,1,[91Fans]Ezreal,4071,554,13,12,25,52.0%,39m
2538,1,NewHighScore,4071,188,5,8,13,38.5%,8m
2538,1,[LilHo]Rcclyder,4071,96,2,8,10,20.0%,27m
2538,1,Doremi,4071,0,1,0,1,100.0%,29m
2543,1,Lumencryster,4070,2117,159,151,310,51.3%,36m
2543,1,FreeWin,4070,760,28,13,41,68.3%,11m
2543,1,Matniss,4070,1012,25,26,51,49.0%,27m
2543,1,[UCornX]AminoXX,4070,0,1,0,1,100.0%,33m
2543,1,[AEUG]HiraRen,4070,0,0,1,1,0.0%,11m
2548,1,[TSFs]Grimm,4069,2149,177,177,354,50.0%,10m
2548,1,Rolly,4069,1489,155,124,279,55.6%,14m
2548,1,[Ris3n]Barks,4069,1448,37,42,79,46.8%,14m
2548,1,ArieS,4069,916,33,16,49,67.3%,18m
2548,1,protoss,4069,644,23,7,30,76.7%,17m
2548,1,[pTee]tart,4069,94,2,3,5,40.0%,37m
2548,1,[Cometh]Nightman,4069,48,1,4,5,20.0%,8m
2555,1,Zendius,4068,2140,351,384,735,47.8%,42m
2556,1,persephone,4067,1649,217,216,433,50.1%,20m
2556,1,EnolaGay,4067,1990,201,213,414,48.6%,28m
2556,1,Thraundil,4067,1242,116,94,210,55.2%,10m
2556,1,ZaramayBaby,4067,1152,27,29,56,48.2%,26m
2556,1,UpsUapear,4067,230,6,2,8,75.0%,3m
2556,1,Treninho,4067,64,3,3,6,50.0%,13m
2562,1,Coaxial,4066,918,22,18,40,55.0%,17m
2562,1,XLordZayidX,4066,886,20,18,38,52.6%,29m
2562,2,Areff,4066,162,5,3,8,62.5%,42m
2562,1,[Export]GalManBae,4066,236,5,5,10,50.0%,38m
2562,1,FBHKreator,4066,144,4,7,11,36.4%,41m
2562,3,janeth,4066,10,3,15,18,16.7%,36m
2562,1,[Cryptc]Prince,4066,48,1,7,8,12.5%,24m
2562,1,[PiffJs]BCash,4066,0,0,1,1,0.0%,11m
2570,1,Manga,4065,2124,223,213,436,51.1%,10m
2570,1,[ExcIgN]Raiter,4065,1884,164,156,320,51.2%,30m
2570,1,Morelia,4065,202,8,0,8,100.0%,32m
2570,1,Squall,4065,48,1,1,2,50.0%,13m
2570,1,[REPORT]Fetor,4065,0,1,4,5,20.0%,4m
2570,1,Kav,4065,0,0,2,2,0.0%,27m
2576,1,derrick,4064,2157,278,261,539,51.6%,40m
2576,1,[ValidG]anfurrax,4064,1998,101,94,195,51.8%,8m
2576,1,[ScSwrm]PlayerTwo,4064,1753,79,69,148,53.4%,23m
2576,1,Babivegita,4064,1980,76,84,160,47.5%,7m
2576,1,Blume,4064,284,6,11,17,35.3%,10m
2581,1,Tydro,4063,2079,365,367,732,49.9%,42m
2581,1,BuffZerg,4063,1306,46,31,77,59.7%,30m
2581,1,MeronG,4063,903,29,23,52,55.8%,18m
2581,1,RazeriaN,4063,392,20,18,38,52.6%,17m
2581,1,[Illini]Neverland,4063,672,19,12,31,61.3%,4m
2581,1,Gonharch,4063,408,12,9,21,57.1%,37m
2581,3,Wenson,4063,0,3,2,5,60.0%,21m
2581,2,MrJack,4063,46,2,4,6,33.3%,22m
2589,1,[KingSC]GUSSMOSS,4062,0,0,3,3,0.0%,18m
2590,1,Andromeda,4061,186,6,2,8,75.0%,8m
2590,1,[TXOP]MaTaTO,4061,48,2,3,5,40.0%,28m
2590,2,GoodZerg,4061,0,0,1,1,0.0%,37m
2593,1,BadBorz,4060,427,19,5,24,79.2%,37m
2593,1,bloodbank,4060,709,19,12,31,61.3%,37m
2593,1,JUNDALUP,4060,353,12,2,14,85.7%,27m
2593,1,CookieDough,4060,472,10,4,14,71.4%,40m
2597,1,Proxi,4059,400,16,5,21,76.2%,17m
2597,1,FilthyCasual,4059,92,4,4,8,50.0%,20m
2597,1,whitebatman,4059,48,1,8,9,11.1%,37m
2597,1,Derdeutsche,4059,0,0,5,5,0.0%,29m
2601,1,Link,4058,2138,212,223,435,48.7%,39m
2601,1,[H3xPr0]Buggo,4058,1898,61,46,107,57.0%,20m
2601,1,DYNa,4058,392,11,5,16,68.8%,13m
2601,1,Pangur,4058,94,1,2,3,33.3%,16m
2605,1,Junglebird,4057,493,20,26,46,43.5%,27m
2605,1,[DarkAG]tunechi,4057,424,10,7,17,58.8%,38m
2605,1,[AKLsc]RivenLight,4057,0,1,0,1,100.0%,14m
2605,1,[αX]Sunlily,4057,48,1,2,3,33.3%,27m
2605,1,[Staraf]GoroleX,4057,0,1,6,7,14.3%,4m
2610,1,NMxMrStabby,4056,2025,69,55,124,55.6%,30m
2611,1,MortTheBort,4055,567,23,12,35,65.7%,38m
2611,1,LennyTheLing,4055,0,0,1,1,0.0%,10m
2613,1,dimarks,4054,1294,34,29,63,54.0%,17m
2613,1,SneznyMuzhik,4054,185,11,0,11,100.0%,37m
2613,1,JohnMcClane,4054,144,4,9,13,30.8%,27m
2613,1,Werm,4054,0,0,5,5,0.0%,13m
2617,1,Irv,4052,1806,95,91,186,51.1%,42m
2617,1,FatChunk,4052,0,1,0,1,100.0%,26m
2617,1,[acBrL]AiMiKiA,4052,0,0,2,2,0.0%,28m
2620,1,Malleo,4051,96,3,4,7,42.9%,13m
2620,1,BROTOSTERONE,4051,96,2,4,6,33.3%,13m
2622,1,[k2k]Fatlawrence,4050,553,14,10,24,58.3%,12m
2622,1,[PobSC]Folka,4050,234,6,7,13,46.2%,5m
2622,1,VengefulLima,4050,0,1,0,1,100.0%,33m
2622,1,Abyss,4050,48,1,1,2,50.0%,38m
2626,1,Joan,4049,2107,210,213,423,49.6%,22m
2626,1,SyntaxIru,4049,1791,96,90,186,51.6%,41m
2626,1,[KingSC]IMDaggoth,4049,1147,29,35,64,45.3%,22m
2626,1,Implying,4049,466,11,13,24,45.8%,11m
2626,1,Finnlock,4049,140,3,1,4,75.0%,37m
2626,1,Orlandini,4049,0,1,0,1,100.0%,10m
2626,1,[EZakaT]Labakan,4049,0,0,1,1,0.0%,38m
2633,3,[juggr]SojuZerg,4048,676,42,62,104,40.4%,10m
2633,1,[FnS]DiZ,4048,510,11,8,19,57.9%,4m
2633,1,NanTeSer,4048,176,7,10,17,41.2%,17m
2633,1,PinkBunny,4048,234,5,3,8,62.5%,28m
2633,1,Worrick,4048,92,3,1,4,75.0%,29m
2633,1,Flux,4048,96,2,3,5,40.0%,29m
2639,3,[X17]rabidtoaster,4047,749,388,386,774,50.1%,7m
2639,3,SamsChoice,4047,1393,139,140,279,49.8%,10m
2639,1,DyMsYm,4047,1077,31,23,54,57.4%,29m
2639,3,[IPZerg]Hail,4047,93,16,35,51,31.4%,26m
2639,1,Psyjag,4047,326,14,6,20,70.0%,13m
2639,1,SorryGTG,4047,0,5,0,5,100.0%,8m
2639,1,[EGx]RicardoMilos,4047,36,1,3,4,25.0%,18m
2646,1,FlyingWhale,4046,2077,259,249,508,51.0%,11m
2646,1,[SCNEW]Moder,4046,596,13,18,31,41.9%,27m
2646,2,Bruh,4046,207,11,3,14,78.6%,37m
2646,1,[2AhB]Omedon,4046,0,0,1,1,0.0%,31m
2646,1,[ValidG]Kwas,4046,0,0,2,2,0.0%,10m
2651,3,[ZTemp]Vandy,4045,142,11,31,42,26.2%,7m
2651,1,dragos,4045,332,7,6,13,53.8%,28m
2651,1,Driven,4045,284,7,12,19,36.8%,23m
2651,1,Meemoo,4045,240,6,12,18,33.3%,17m
2651,1,SippShip,4045,209,3,4,7,42.9%,37m
2651,1,Business,4045,46,2,1,3,66.7%,7m
2651,3,liznewtwork,4045,0,1,1,2,50.0%,32m
2651,2,Calcar,4045,0,0,3,3,0.0%,42m
2659,3,CABG,4044,1313,159,152,311,51.1%,37m
2659,1,IAmTheSenate,4044,598,17,12,29,58.6%,8m
2659,1,Atlow,4044,271,11,4,15,73.3%,18m
2659,1,Scott,4044,188,4,2,6,66.7%,20m
2659,1,wolfhead,4044,96,2,1,3,66.7%,12m
2659,1,[TGosuC]Optiknights,4044,96,2,6,8,25.0%,8m
2659,1,[Cryptc]mcbrungus,4044,48,1,1,2,50.0%,41m
2666,2,SkiRoO,4043,450,19,4,23,82.6%,10m
2666,1,Day,4043,46,2,1,3,66.7%,12m
2668,1,mfZOR,4042,2116,168,162,330,50.9%,3m
2668,1,PlanB,4042,2114,76,84,160,47.5%,28m
2668,2,MileyCyrus,4042,279,14,3,17,82.4%,39m
2668,1,Rytting,4042,278,7,1,8,87.5%,17m
2668,1,TJc,4042,48,2,7,9,22.2%,8m
2668,1,Gabagool,4042,0,0,4,4,0.0%,17m
2674,1,[CptMal]Swen,4041,328,7,11,18,38.9%,4m
2674,1,raigerBomb,4041,48,2,8,10,20.0%,24m
2674,1,Smallfry,4041,0,0,3,3,0.0%,37m
2677,3,Reyna,4040,1149,98,112,210,46.7%,21m
2677,1,[Buholl]CyberShark,4040,740,32,18,50,64.0%,10m
2677,1,Star,4040,992,30,17,47,63.8%,8m
2677,1,IlIlIlIlIlIl,4040,0,0,1,1,0.0%,7m
2681,1,[ZTemp]GameofDrones,4039,2091,464,439,903,51.4%,8m
2681,1,game,4039,96,2,9,11,18.2%,33m
2683,3,TryhardSloth,4038,1654,283,296,579,48.9%,7m
2683,1,IBeastMode,4038,1851,81,75,156,51.9%,11m
2683,1,dcare,4038,1796,65,43,108,60.2%,40m
2683,1,Nicklass,4038,46,2,1,3,66.7%,17m
2687,3,HiTboXer,4037,1110,78,90,168,46.4%,26m
2687,1,[Slugzz]Jboy,4037,0,0,1,1,0.0%,14m
2689,3,[nieBla]Woltstrider,4036,1963,279,271,550,50.7%,16m
2689,1,JovSicurella,4036,142,4,2,6,66.7%,31m
2689,1,[THEZTT]THEZT,4036,140,3,2,5,60.0%,10m
2689,1,Apolas,4036,48,1,2,3,33.3%,12m
2693,1,[DRKDMN]warrior,4035,1350,34,35,69,49.3%,11m
2693,1,jkcthesavyor,4035,740,17,18,35,48.6%,28m
2693,1,[ZTemp]TheBestGuy,4035,684,16,14,30,53.3%,11m
2693,1,Terrible,4035,325,11,3,14,78.6%,43m
2693,1,WirdNah,4035,328,7,6,13,53.8%,41m
2693,1,ZergOP,4035,48,2,6,8,25.0%,13m
2693,1,[REPORT]azorath,4035,0,1,0,1,100.0%,8m
2693,1,[SBlock]KerryKaverga,4035,0,0,1,1,0.0%,41m
2693,1,MerKuriaL,4035,0,0,3,3,0.0%,38m
2702,1,GaryTheDrone,4034,637,20,14,34,58.8%,17m
2702,1,DwightShrute,4034,92,2,0,2,100.0%,43m
2704,1,[cl0udM]Hermit,4033,2085,273,267,540,50.6%,10m
2704,1,ZergMaster,4033,1700,75,57,132,56.8%,12m
2704,1,[WNTRGG]Prohibited,4033,1487,72,72,144,50.0%,16m
2704,1,Senpuden,4033,380,9,7,16,56.2%,10m
2704,1,LUNATIC,4033,0,1,1,2,50.0%,24m
2704,1,OMardil,4033,46,1,3,4,25.0%,38m
2704,1,[FunBoi]RobergeRepor,4033,0,0,3,3,0.0%,28m
2711,1,Hunter,4032,2135,446,453,899,49.6%,38m
2711,3,chez,4032,1976,408,446,854,47.8%,31m
2711,3,KrieG,4032,1982,151,161,312,48.4%,4m
2711,1,Moevot,4032,2053,109,83,192,56.8%,17m
2711,1,Polygone,4032,430,32,21,53,60.4%,39m
2711,1,[Bloody]NotASword,4032,920,24,24,48,50.0%,27m
2711,1,ZerO,4032,0,0,2,2,0.0%,41m
2718,1,[GIJmb]PotentialCam,4031,2126,215,231,446,48.2%,17m
2718,1,Unicorn,4031,1754,202,178,380,53.2%,37m
2718,1,MarsFelix,4031,1272,156,148,304,51.3%,18m
2718,1,Iamadagger,4031,596,27,8,35,77.1%,10m
2722,1,Sjette,4030,1236,63,59,122,51.6%,11m
2722,1,SlopGoblin,4030,348,17,4,21,81.0%,8m
2724,1,Dragon,4029,287,7,4,11,63.6%,24m
2724,1,BattleCruser,4029,0,1,0,1,100.0%,7m
2726,1,Sushanth,4028,677,23,33,56,41.1%,20m
2726,3,[KiMBR]Jonathas,4028,195,12,29,41,29.3%,4m
2728,1,[Lp]AlejandroMVP,4027,1363,36,50,86,41.9%,27m
2728,2,[RiGO]PrayeR,4027,206,15,4,19,78.9%,20m
2728,1,Onion,4027,378,8,10,18,44.4%,38m
2728,1,Nunetine,4027,326,7,9,16,43.8%,10m
2728,1,SerralsDad,4027,280,6,3,9,66.7%,17m
2728,1,[BajaB]Ward,4027,0,0,2,2,0.0%,3m
2728,1,DarkWebHitMN,4027,0,0,2,2,0.0%,28m
2735,1,[HIPASS]urixop,4026,0,0,1,1,0.0%,13m
2736,3,darkReunion,4025,789,57,54,111,51.4%,10m
2736,1,Extrim,4025,1470,39,36,75,52.0%,13m
2736,1,SharpShooter,4025,588,13,8,21,61.9%,30m
2736,1,Insomniac,4025,232,5,5,10,50.0%,4m
2736,1,[TiChum]RaijiN,4025,0,1,0,1,100.0%,41m
2736,1,[TAW]TeRrAnBrOkEn,4025,0,0,2,2,0.0%,17m
2742,1,Drift,4024,1802,193,173,366,52.7%,19m
2742,1,[AlIin]Gove,4024,2124,128,126,254,50.4%,8m
2742,1,MrPeeKaBoO,4024,1889,86,88,174,49.4%,28m
2742,2,navymaru,4024,102,2,3,5,40.0%,36m
2746,3,sneezy,4023,753,169,167,336,50.3%,42m
2746,3,GooberWoober,4023,1695,155,171,326,47.5%,21m
2746,1,StormMisery,4023,1552,56,50,106,52.8%,27m
2746,1,Newt,4023,305,15,1,16,93.8%,43m
2746,1,Volundr,4023,274,6,9,15,40.0%,9m
2751,1,LewisKiniski,4022,998,100,89,189,52.9%,17m
2751,1,[ValidG]kali,4022,495,11,8,19,57.9%,3m
2751,1,TylerOkurbak,4022,279,5,8,13,38.5%,13m
2751,1,PushDaButton,4022,48,2,5,7,28.6%,33m
2755,3,Doppel,4021,1988,446,452,898,49.7%,11m
2755,1,DDASD,4021,1680,96,69,165,58.2%,37m
2755,1,mushies,4021,989,51,40,91,56.0%,39m
2755,1,[SCNS]MyNameAlice,4021,185,4,0,4,100.0%,11m
2755,1,[Fir3s]SkyfaLL,4021,48,1,3,4,25.0%,41m
2755,2,IIIIIIIIIII,4021,42,1,4,5,20.0%,26m
2761,1,GDuck,4020,2086,206,201,407,50.6%,13m
2761,1,tairyo,4020,1945,204,166,370,55.1%,41m
2761,1,[Fever]Decay,4020,880,33,24,57,57.9%,31m
2761,1,Bane,4020,668,16,16,32,50.0%,12m
2761,1,[GGIN]Sygard,4020,0,0,1,1,0.0%,20m
2766,1,Solace,4019,1693,267,259,526,50.8%,10m
2766,1,IIIIIIIIIIII,4019,862,68,42,110,61.8%,13m
2766,2,llllllllllll,4019,42,1,3,4,25.0%,37m
2769,1,urbanslayer,4018,1888,127,103,230,55.2%,30m
2769,1,[Di3N1g]Protech,4018,144,4,3,7,57.1%,14m
2769,1,Baduu,4018,0,1,1,2,50.0%,38m
2769,1,Demolex,4018,48,1,13,14,7.1%,41m
2769,1,[Flam3s]WwWwWwWwWwWw,4018,0,0,1,1,0.0%,13m
2769,3,[L4CRA]LaMamaDelron,4018,0,0,2,2,0.0%,28m
2775,3,Bum,4017,1649,147,160,307,47.9%,26m
2775,1,Benownurass,4017,500,11,16,27,40.7%,41m
2775,1,HomoPanda,4017,266,7,15,22,31.8%,29m
2775,1,mowjoe,4017,46,2,2,4,50.0%,38m
2775,1,[TH1CC]MrTickleSlap,4017,0,0,1,1,0.0%,32m
2780,1,[GEEKED]Artificial,4016,2090,142,148,290,49.0%,38m
2780,1,SanT,4016,0,0,2,2,0.0%,20m
2782,1,[Nums]omnomnom,4015,0,1,1,2,50.0%,42m
2782,1,Yar,4015,46,1,1,2,50.0%,36m
2784,1,[imperv]CaptBritain,4014,2070,254,241,495,51.3%,31m
2784,1,[Xpk]kachaviejas,4014,2101,236,221,457,51.6%,3m
2784,1,[cl0udM]Ultralisk,4014,1327,174,187,361,48.2%,17m
2784,1,Carnage,4014,0,1,2,3,33.3%,19m
2784,1,KainsBlade,4014,0,0,1,1,0.0%,29m
2789,1,IIIIIIIIIII,4013,1929,197,159,356,55.3%,7m
2789,3,WTCrossover,4013,858,48,75,123,39.0%,25m
2789,1,Shoopdawoop,4013,1491,45,44,89,50.6%,29m
2789,1,XpliziT,4013,598,32,29,61,52.5%,13m
2789,1,[KGH]pickledhen,4013,48,2,2,4,50.0%,42m
2794,1,Rinzler,4012,2054,272,267,539,50.5%,36m
2794,1,[FateTw]Soapyjeans,4012,1679,87,86,173,50.3%,38m
2794,1,AgentSquall,4012,0,1,1,2,50.0%,27m
2797,1,Hayek,4011,1999,235,223,458,51.3%,3m
2797,1,TechnoO,4011,1122,64,46,110,58.2%,37m
2797,1,ComradConnor,4011,702,51,26,77,66.2%,13m
2797,1,Garbage,4011,39,1,8,9,11.1%,13m
2801,1,IENJOYSTDS,4010,1988,98,90,188,52.1%,38m
2801,1,[AMZN]TallMonster,4010,1288,39,49,88,44.3%,33m
2801,3,MelonBar,4010,0,4,0,4,100.0%,4m
2801,1,[FBK]BilboBagins,4010,96,3,0,3,100.0%,10m
2801,1,[TgAg]Bartuc,4010,48,2,0,2,100.0%,4m
2801,2,[FINDEX]StoicWilly,4010,0,1,0,1,100.0%,4m
2801,1,[Cind3r]FightDiaper,4010,0,0,1,1,0.0%,28m
2808,1,[Deimos]Evolution,4009,48,1,7,8,12.5%,8m
2808,1,[GR33D]wert,4009,0,0,1,1,0.0%,43m
2810,1,[PINGON]elcidvlad,4008,2070,428,436,864,49.5%,31m
2810,1,Lingu,4008,1943,68,64,132,51.5%,11m
2810,1,PorkyThunder,4008,189,11,1,12,91.7%,43m
2810,1,[UofC]calomando,4008,278,6,13,19,31.6%,13m
2814,3,[DTokes]DonaldZerg,4007,1547,136,137,273,49.8%,10m
2814,1,MaRioN,4007,719,27,10,37,73.0%,17m
2814,1,[TGosuD]Palingenesis,4007,240,6,16,22,27.3%,41m
2814,1,ajax,4007,142,4,10,14,28.6%,14m
2814,1,Qwerty,4007,73,0,2,2,0.0%,28m
2819,1,BuyTheDip,4006,1928,151,147,298,50.7%,29m
2819,3,[Tcar]PUTIN,4006,32,2,5,7,28.6%,33m
2819,1,[PNIZ]sprinkles,4006,121,1,6,7,14.3%,39m
2819,2,[SMB]DyNastyPozin,4006,0,0,1,1,0.0%,28m
2823,1,[SsaYnS]Formic,4005,2026,148,150,298,49.7%,17m
2823,1,Nightstalker,4005,2050,106,121,227,46.7%,22m
2823,1,[iDrunk]Kruver,4005,720,91,82,173,52.6%,10m
2823,1,[cl0udM]ZanitY,4005,846,20,24,44,45.5%,31m
2823,1,[HYPTRN]SirSkyguy,4005,758,18,20,38,47.4%,28m
2823,1,Realstreetg,4005,0,1,1,2,50.0%,20m
2823,1,[ShoaL]Toby,4005,0,1,1,2,50.0%,41m
2823,1,[MLP]pupariuh,4005,0,0,1,1,0.0%,28m
2831,1,onemarine,4004,1409,304,292,596,51.0%,17m
2831,1,Stazs,4004,1918,204,191,395,51.6%,13m
2831,1,[TGCF]Cialis,4004,1377,166,158,324,51.2%,39m
2831,1,Slaget,4004,1955,76,71,147,51.7%,14m
2831,1,mauzel,4004,1187,35,25,60,58.3%,4m
2831,1,[Dych]Peegor,4004,483,12,7,19,63.2%,20m
2831,1,[DIDI]didi,4004,96,3,7,10,30.0%,32m
2831,1,ALLiDOisAPM,4004,0,1,0,1,100.0%,13m
2839,1,[DRFS]Minerva,4003,1154,36,35,71,50.7%,37m
2839,1,Zeke,4003,734,18,27,45,40.0%,13m
2839,1,Bito,4003,46,2,1,3,66.7%,9m
2839,1,SCVLife,4003,48,2,1,3,66.7%,28m
2843,1,Daikon,4002,762,17,19,36,47.2%,32m
2843,3,Finch,4002,88,11,30,41,26.8%,26m
2843,1,JiBaMike,4002,0,0,1,1,0.0%,4m
2846,1,cassius,4001,2078,381,396,777,49.0%,38m
2846,1,[Ris3n]PhoenixKing,4001,406,33,26,59,55.9%,10m
2846,1,SkypeGirlMic,4001,421,19,6,25,76.0%,20m
2846,1,TheNamesZero,4001,127,4,6,10,40.0%,17m
2846,1,[pilsem]Pilsen,4001,46,1,1,2,50.0%,39m
2846,1,tskarz,4001,48,1,4,5,20.0%,19m
2852,1,PastTheCrina,4000,2104,202,222,424,47.6%,13m
2852,1,Rastafury,4000,399,34,17,51,66.7%,27m
2852,1,WaterDemon,4000,932,24,19,43,55.8%,16m
2852,1,[h4tch]april,4000,253,16,9,25,64.0%,28m
2852,1,[MNG]TsogiMaster,4000,92,5,1,6,83.3%,17m
2852,1,IIIIIIIIIIII,4000,142,4,2,6,66.7%,30m
2852,1,Exquisite,4000,48,2,2,4,50.0%,10m
2852,2,[D420]Cakez,4000,0,0,1,1,0.0%,5m
2860,1,[xRtG]Altron,3999,1829,62,63,125,49.6%,31m
2860,1,Kattck,3999,1792,55,50,105,52.4%,8m
2860,1,[WSTAR]ryTown,3999,1129,30,30,60,50.0%,27m
2860,1,MaCroN,3999,345,11,8,19,57.9%,9m
2860,2,[Nanjol]Yoshino,3999,259,6,3,9,66.7%,42m
2860,1,[Atira]Akoo,3999,48,2,1,3,66.7%,31m
2860,1,Awake,3999,48,1,1,2,50.0%,37m
2860,1,RRR,3999,0,0,2,2,0.0%,12m
2860,1,SgtSater,3999,0,0,5,5,0.0%,10m
2869,1,Nults,3998,869,212,157,369,57.5%,17m
2869,1,Sareth,3998,2084,128,125,253,50.6%,13m
2869,2,llllllllllll,3998,370,18,6,24,75.0%,12m
2869,1,Love,3998,94,3,3,6,50.0%,41m
2869,1,[usis]jubjubb,3998,92,2,3,5,40.0%,10m
2869,1,Draven,3998,0,0,1,1,0.0%,42m
2869,1,Matt,3998,0,0,1,1,0.0%,27m
2876,2,Watcher,3997,328,16,5,21,76.2%,29m
2876,1,IIIIIIIIIIII,3997,232,6,5,11,54.5%,22m
2876,1,[NwAs]leshrac,3997,238,5,13,18,27.8%,10m
2876,1,asdaa,3997,125,4,4,8,50.0%,9m
2880,1,[sa1t]BigFungus,3996,1822,152,142,294,51.7%,23m
2880,1,HokusPolokus,3996,545,26,11,37,70.3%,4m
2880,1,[HOOS]mcbrungus,3996,592,14,14,28,50.0%,20m
2880,1,[DoHyun]GoBacK,3996,325,9,8,17,52.9%,37m
2880,1,SoliDGOD,3996,352,8,17,25,32.0%,33m
2880,1,SqueakyBoots,3996,46,1,2,3,33.3%,27m
2886,1,[GanGan]Rykuu,3995,760,27,14,41,65.9%,10m
2886,1,OhMyBob,3995,328,7,15,22,31.8%,15m
2886,1,IIIIIIIIIIII,3995,0,3,2,5,60.0%,11m
2886,1,[BBSC]Tidal,3995,0,1,0,1,100.0%,13m
2886,1,Megatron,3995,0,0,1,1,0.0%,43m
2891,1,Enceladus,3994,652,18,16,34,52.9%,15m
2891,1,[siska]darkdrive,3994,319,15,6,21,71.4%,32m
2891,1,[Cakius]yeskis,3994,0,2,3,5,40.0%,17m
2891,1,[TobiOP]IIIIIIIIIIII,3994,0,0,1,1,0.0%,28m
2895,1,Rudais,3993,2085,120,113,233,51.5%,41m
2895,1,[BtnBot]tyzor,3993,1128,86,89,175,49.1%,17m
2895,2,Autumn,3993,170,4,9,13,30.8%,15m
2895,1,[TVGL]Merchant,3993,0,2,3,5,40.0%,41m
2895,1,illionaire,3993,48,1,1,2,50.0%,11m
2895,1,Raszagal,3993,0,0,1,1,0.0%,15m
2901,1,Meticulous,3992,1116,95,59,154,61.7%,10m
2901,1,BanesGoBoom,3992,0,1,0,1,100.0%,10m
2901,1,[Sune]Pizzy,3992,0,0,1,1,0.0%,28m
2904,1,[αXLa]thunderfly,3991,1216,32,38,70,45.7%,36m
2904,1,kingster,3991,94,3,1,4,75.0%,37m
2904,1,[qoou]ACED,3991,94,2,4,6,33.3%,32m
2904,1,[ELIDS]QuaNTeL,3991,46,2,4,6,33.3%,41m
2908,1,FreeCoaching,3990,362,19,6,25,76.0%,13m
2908,3,BabyGotGrack,3990,215,11,1,12,91.7%,40m
2908,1,Venus,3990,234,6,4,10,60.0%,28m
2908,1,MilkBottoe,3990,0,0,5,5,0.0%,15m
2912,1,Angrydolphin,3989,1780,103,95,198,52.0%,29m
2912,1,[xLgNx]Holden,3989,559,24,8,32,75.0%,8m
2912,1,[xLgNx]Calm,3989,483,18,7,25,72.0%,29m
2912,1,ePunk,3989,167,7,8,15,46.7%,38m
2912,1,NovemberZzZ,3989,142,3,5,8,37.5%,10m
2912,1,[SDC12]Chapolin,3989,0,0,1,1,0.0%,16m
2912,1,FromTheSeoul,3989,0,0,1,1,0.0%,28m
2919,1,[BOOT]CrazyZerg,3988,870,52,53,105,49.5%,10m
2919,1,[UofC]iloveoof,3988,1185,51,55,106,48.1%,11m
2919,1,[FyHr]RakeIsSerral,3988,986,44,25,69,63.8%,20m
2919,1,IIIIIIIIIIII,3988,474,16,17,33,48.5%,38m
2919,1,Strategyzer,3988,186,5,10,15,33.3%,37m
2924,1,[FANXY]Vex,3987,1737,51,49,100,51.0%,38m
2924,1,[mpgg]mcG,3987,996,44,39,83,53.0%,10m
2924,1,IIIIIIIIIIII,3987,324,8,7,15,53.3%,4m
2924,3,[jotun]Mjolnir,3987,58,4,4,8,50.0%,35m
2924,2,[puCked]Black,3987,102,2,1,3,66.7%,37m
2929,3,NOGG,3986,1966,252,275,527,47.8%,21m
2929,1,BeuSnu,3986,961,24,18,42,57.1%,38m
2929,1,Zane,3986,262,14,3,17,82.4%,37m
2929,1,[QTp2T]AriA,3986,366,8,11,19,42.1%,15m
2929,1,Hybillisk,3986,0,0,1,1,0.0%,13m
2929,1,Westcoast,3986,0,0,1,1,0.0%,8m
2935,1,Sneaks,3985,2055,264,265,529,49.9%,38m
2935,1,SOLrender,3985,1008,111,22,133,83.5%,8m
2935,1,TiltWizard,3985,1436,43,41,84,51.2%,10m
2935,1,[CBAS2]GiantReaver,3985,1028,29,23,52,55.8%,42m
2935,1,[MiG]Covalent,3985,698,22,20,42,52.4%,36m
2935,1,[1dC]synapse,3985,416,9,13,22,40.9%,28m
2935,1,[DSFTWA]Knighthawk,3985,92,3,3,6,50.0%,20m
2942,3,BigHoss,3984,1920,447,457,904,49.4%,10m
2942,1,TurtleZerg,3984,1011,64,55,119,53.8%,19m
2942,1,laloUC,3984,234,6,7,13,46.2%,18m
2942,1,Golden,3984,48,2,3,5,40.0%,28m
2942,1,QYQY,3984,48,1,3,4,25.0%,23m
2942,1,[ZGRB]JESTJERVYN,3984,0,0,1,1,0.0%,41m
2948,1,ObelisKO,3983,1938,81,95,176,46.0%,17m
2948,1,Reina,3983,0,1,0,1,100.0%,10m
2948,1,tesked,3983,0,1,0,1,100.0%,17m
2948,1,Promyvion,3983,0,0,2,2,0.0%,10m
2952,1,[TGosuA]CiTiZiN,3982,1967,160,148,308,51.9%,12m
2952,1,buck,3982,2064,142,155,297,47.8%,38m
2952,1,Cheeryohs,3982,1002,33,36,69,47.8%,20m
2952,1,whtjrgus,3982,882,32,17,49,65.3%,19m
2952,1,[TGosuA]LeChatonNoir,3982,1296,32,49,81,39.5%,23m
2952,3,Symphony,3982,0,0,1,1,0.0%,27m
2952,1,[Flam3s]Finaldash,3982,0,0,2,2,0.0%,4m
2959,1,sabiqian,3981,1063,45,28,73,61.6%,28m
2959,1,[Yuhang]Launcelot,3981,1316,34,36,70,48.6%,16m
2959,2,Misaki,3981,0,1,1,2,50.0%,43m
2959,1,Donkeystorm,3981,0,0,1,1,0.0%,4m
2963,1,RoscoeTheDog,3980,1257,104,86,190,54.7%,39m
2963,1,TrueSith,3980,2060,65,76,141,46.1%,18m
2963,1,[Epokhé]Amiapkachape,3980,48,1,2,3,33.3%,13m
2966,1,TheUnseen,3979,1375,204,219,423,48.2%,17m
2966,1,JTTizzle,3979,2051,153,141,294,52.0%,5m
2966,1,UnaPapusa,3979,1190,31,28,59,52.5%,7m
2966,1,Nature,3979,247,7,5,12,58.3%,13m
2966,1,[NwAs]ILifeI,3979,94,3,0,3,100.0%,43m
2966,1,Sammuelmumm,3979,94,3,2,5,60.0%,30m
2966,1,Epitome,3979,0,1,0,1,100.0%,17m
2966,1,[lNI]KungFuSanta,3979,0,0,2,2,0.0%,24m
2974,1,blurr,3978,2010,322,291,613,52.5%,41m
2975,1,ShereKhan,3977,2038,98,101,199,49.2%,17m
2975,1,OtsoSIN,3977,576,18,20,38,47.4%,36m
2975,1,NdlTechNo,3977,479,17,11,28,60.7%,37m
2975,1,GeeFive,3977,305,9,9,18,50.0%,13m
2975,3,[Micr0]TEXASBOY,3977,0,1,0,1,100.0%,14m
2975,1,ZombiE,3977,48,1,1,2,50.0%,43m
2975,1,StoryTime,3977,0,1,1,2,50.0%,36m
2975,1,[ARLA]FGThjklzEX,3977,0,0,1,1,0.0%,31m
2983,1,Jin,3976,1475,141,137,278,50.7%,43m
2983,1,DiaToX,3976,1233,50,46,96,52.1%,8m
2983,3,[Mu5]UtopianF,3976,352,28,48,76,36.8%,6m
2983,1,[TAW]MarsBar,3976,586,14,13,27,51.9%,11m
2983,1,[MTMRK]HunterKiller,3976,278,10,8,18,55.6%,16m
2983,1,Apophis,3976,326,7,11,18,38.9%,41m
2983,1,JeffGoldblum,3976,0,0,1,1,0.0%,17m
2990,1,[SsaYnS]rock,3975,1054,73,70,143,51.0%,22m
2990,1,[lLiTl]Sleepy,3975,364,8,11,19,42.1%,20m
2990,1,[Ozzie]YaaBoiiAdam,3975,136,3,6,9,33.3%,13m
2990,1,[EndPro]conkero,3975,0,1,1,2,50.0%,8m
2990,1,[POPOL]OPMVPC,3975,0,0,1,1,0.0%,11m
2990,1,[UNCCH]BLACKSPACE,3975,0,0,1,1,0.0%,17m
2996,1,FuGu,3974,2054,519,515,1034,50.2%,38m
2996,1,[HÚSKÁ]III,3974,2092,143,143,286,50.0%,20m
2996,1,cLiicK,3974,962,23,30,53,43.4%,18m
2996,1,GOSKingKobe,3974,171,5,4,9,55.6%,24m
2996,1,SixAces,3974,238,5,7,12,41.7%,4m
2996,1,CaptHELLiCAN,3974,96,2,5,7,28.6%,37m
2996,1,[PENN]DisCerN,3974,0,1,0,1,100.0%,41m
3003,2,[PhxAge]FatmaN,3973,2123,435,469,904,48.1%,4m
3003,1,[zeez]Synastren,3973,1329,44,44,88,50.0%,13m
3003,1,Media,3973,655,24,27,51,47.1%,9m
3003,1,[xFear]Khaos,3973,190,4,11,15,26.7%,17m
3003,1,[swagel]BendOfTime,3973,188,4,12,16,25.0%,23m
3003,1,IIIIIIIIIIII,3973,0,1,0,1,100.0%,4m
3003,1,KJDB,3973,0,0,5,5,0.0%,16m
3010,1,Clush,3972,1686,122,111,233,52.4%,39m
3010,1,[TrckPd]vVvOxOvVv,3972,1727,54,48,102,52.9%,19m
3010,1,[8kPLUS]Moradagh,3972,602,23,13,36,63.9%,28m
3010,1,[x90]xChgRaxRax,3972,119,2,2,4,50.0%,24m
3010,3,nOobO,3972,30,2,4,6,33.3%,36m
3010,1,TheGodFather,3972,0,0,1,1,0.0%,22m
3010,1,Ruleton,3972,0,0,3,3,0.0%,13m
3017,1,bdoge,3971,1367,522,473,995,52.5%,10m
3017,1,AboveTheZero,3971,1964,207,195,402,51.5%,41m
3017,1,[FxB]Duttles,3971,1406,48,42,90,53.3%,12m
3017,1,[ZTemps]MinYee,3971,478,11,10,21,52.4%,17m
3017,1,VenaHausVien,3971,168,5,2,7,71.4%,11m
3017,1,DarkFireDT,3971,0,0,1,1,0.0%,9m
3017,1,Infallible,3971,0,0,7,7,0.0%,13m
3024,1,Rust,3970,1037,147,161,308,47.7%,10m
3024,1,Daniel,3970,1927,126,113,239,52.7%,7m
3024,1,[GnR]Nastro,3970,1777,53,61,114,46.5%,17m
3024,1,[A55555]fish,3970,140,4,4,8,50.0%,8m
3024,3,llllllllllll,3970,0,3,2,5,60.0%,41m
3029,1,aclg,3969,1621,86,78,164,52.4%,28m
3029,1,prancingazel,3969,1677,51,45,96,53.1%,31m
3029,1,Scherzo,3969,405,11,20,31,35.5%,22m
3029,1,StrawHat,3969,299,9,4,13,69.2%,28m
3029,1,[umoron]Doombats,3969,305,7,3,10,70.0%,27m
3029,1,[αXLa]Lovelychild,3969,46,1,4,5,20.0%,28m
3029,1,[FuN0oB]robotikov,3969,0,0,1,1,0.0%,37m
3036,1,iBeast,3968,1658,161,144,305,52.8%,10m
3036,1,Destiny,3968,862,40,21,61,65.6%,37m
3036,1,BaronessLeah,3968,279,32,13,45,71.1%,18m
3036,1,[PobSC]Katastrophe,3968,594,26,18,44,59.1%,33m
3036,1,Inneluki,3968,114,3,5,8,37.5%,22m
3036,1,[UpeV]DayZ,3968,0,0,1,1,0.0%,4m
3042,1,MxDrEaM,3967,1350,348,271,619,56.2%,23m
3042,1,[FataI]ReBeL,3967,188,5,4,9,55.6%,33m
3042,1,Parallax,3967,0,2,3,5,40.0%,7m
3042,1,[iMkS]KaLiD,3967,0,1,1,2,50.0%,37m
3042,1,[RedHat]Syrril,3967,34,1,3,4,25.0%,23m
3042,1,[F0cus]dozer,3967,0,0,3,3,0.0%,11m
3048,1,[ScSwrm]LAMBDA,3966,2053,491,481,972,50.5%,14m
3048,1,[Wehavu]OneIceRush,3966,1439,41,37,78,52.6%,29m
3050,1,icu,3965,1076,42,32,74,56.8%,23m
3050,1,Experiman,3965,232,5,16,21,23.8%,41m
3050,1,[KingSC]Gonsu,3965,46,1,1,2,50.0%,20m
3050,1,KoeL,3965,0,0,1,1,0.0%,38m
3054,1,Montevideo,3964,1227,272,258,530,51.3%,20m
3054,1,bhiefis,3964,1919,137,115,252,54.4%,23m
3054,1,RONE,3964,1296,33,37,70,47.1%,27m
3054,1,GeoJe,3964,140,9,0,9,100.0%,37m
3054,1,[SSJ4]GameOfDrones,3964,48,1,2,3,33.3%,13m
3059,1,StaRX,3963,1201,55,34,89,61.8%,5m
3059,1,Churlz,3963,922,27,23,50,54.0%,4m
3059,1,llllllllllll,3963,310,13,3,16,81.2%,31m
3059,1,IIIIIIIIIIII,3963,186,9,3,12,75.0%,38m
3059,3,Thenix,3963,92,3,9,12,25.0%,27m
3059,1,[PRB4SL]LivingDead,3963,48,2,6,8,25.0%,27m
3059,1,[QuenSC]LOL,3963,48,1,7,8,12.5%,10m
3066,1,Hknight,3962,1974,233,230,463,50.3%,5m
3066,1,Leviathan,3962,1911,198,213,411,48.2%,41m
3066,1,llllllllllll,3962,1836,181,156,337,53.7%,8m
3066,1,SCsnow,3962,1340,177,165,342,51.8%,17m
3066,1,[PUNiSH]Freelancer,3962,1750,89,90,179,49.7%,8m
3066,1,FURY,3962,885,25,27,52,48.1%,13m
3066,1,[GEEKED]laka,3962,228,5,8,13,38.5%,16m
3066,1,fastr,3962,138,3,8,11,27.3%,20m
3066,1,Trigger,3962,46,1,1,2,50.0%,37m
3075,1,IIIIIIIIIIII,3961,1550,45,45,90,50.0%,17m
3075,1,[fiea]WaSiD,3961,1233,34,31,65,52.3%,18m
3075,1,MicroJackson,3961,782,24,23,47,51.1%,9m
3075,2,GooDCat,3961,229,7,4,11,63.6%,33m
3075,1,RatSmacker,3961,0,1,0,1,100.0%,4m
3075,1,[PKFIRE]DiN,3961,0,0,1,1,0.0%,13m
3075,1,[UpeV]Ganjhaman,3961,0,0,1,1,0.0%,36m
3075,1,[TeamUR]Akili,3961,0,0,2,2,0.0%,8m
3083,1,KilltheVIRUS,3960,530,15,13,28,53.6%,17m
3083,1,Mimir,3960,267,13,3,16,81.2%,17m
3083,1,[DueleR]fwaaahh,3960,136,4,0,4,100.0%,31m
3083,1,[LgnTDS]ToZu,3960,94,3,6,9,33.3%,13m
3083,1,[EUGGE]Freeshirts,3960,142,3,11,14,21.4%,15m
3083,1,IlIIlIIlIIIl,3960,124,2,4,6,33.3%,12m
3083,1,Chanikus,3960,0,0,2,2,0.0%,33m
3090,3,BUIIII,3959,1558,149,174,323,46.1%,36m
3090,1,[SftVgn]TCTSavi,3959,2052,140,154,294,47.6%,17m
3090,1,Tarzan,3959,835,19,26,45,42.2%,43m
3090,1,[MadK]Marte,3959,458,11,12,23,47.8%,16m
3090,1,[BoRnGo]Msyu,3959,0,1,1,2,50.0%,10m
3095,1,Thel,3958,1993,301,326,627,48.0%,20m
3095,1,llllllllllll,3958,770,18,19,37,48.6%,29m
3095,1,[htpk]htpkChancE,3958,378,12,11,23,52.2%,29m
3095,1,Raise,3958,92,2,2,4,50.0%,17m
3095,1,iHave,3958,46,2,3,5,40.0%,14m
3100,1,[OD2019]CAPSLOCK,3957,764,17,26,43,39.5%,24m
3101,1,BalZano,3956,1505,69,44,113,61.1%,20m
3101,1,[UpeV]jOker,3956,668,22,36,58,37.9%,27m
3101,1,[neuroS]Boltan,3956,192,10,4,14,71.4%,18m
3101,1,[BNEB]xxxx,3956,186,7,8,15,46.7%,37m
3101,1,[SNSD]Zemagdnim,3956,127,3,3,6,50.0%,7m
3106,1,[aCLK]WhiteEyebrow,3955,1744,114,86,200,57.0%,28m
3106,3,[AClck]BanesBeware,3955,1107,84,88,172,48.8%,7m
3106,1,ZHZ,3955,456,11,11,22,50.0%,15m
3106,3,[NPhasA]tyc,3955,0,0,1,1,0.0%,41m
3110,1,[h4tch]april,3954,227,11,7,18,61.1%,10m
3110,1,HiboFlavin,3954,0,0,1,1,0.0%,32m
3110,1,[ZerOi]llllllllllll,3954,0,0,2,2,0.0%,32m
3113,1,[Cryptc]Yuey,3953,1517,47,47,94,50.0%,13m
3113,1,Shadowzeal,3953,1594,45,46,91,49.5%,38m
3113,1,PirulitO,3953,843,23,29,52,44.2%,13m
3113,1,Strker,3953,304,12,5,17,70.6%,27m
3113,1,TrussesSuck,3953,240,5,3,8,62.5%,29m
3113,1,[dLife]BrokenLatex,3953,223,5,4,9,55.6%,9m
3113,1,Mint,3953,0,1,1,2,50.0%,14m
3113,1,MeHerman,3953,93,1,1,2,50.0%,11m
3113,1,[PSISTM]KenjiMuyo,3953,0,1,4,5,20.0%,38m
3113,1,MaSCoTABE,3953,0,0,1,1,0.0%,8m
3123,1,Luis,3952,904,154,152,306,50.3%,43m
3123,1,llllllllllll,3952,331,14,5,19,73.7%,11m
3123,1,[KSGT]Suebee,3952,91,2,0,2,100.0%,37m
3123,1,NapoleonDynA,3952,96,2,4,6,33.3%,28m
3123,1,Kirschke,3952,92,2,8,10,20.0%,12m
3123,1,thecowb,3952,0,0,1,1,0.0%,9m
3129,1,Fjerde,3951,533,53,40,93,57.0%,18m
3129,1,[InGt]Xergxes,3951,1342,49,47,96,51.0%,39m
3129,1,kauhio,3951,656,24,38,62,38.7%,28m
3129,1,Hyperion,3951,215,16,5,21,76.2%,13m
3129,1,[FANXY]CHECK,3951,110,2,2,4,50.0%,37m
3129,1,[AbcCo]FinnyInLove,3951,0,1,0,1,100.0%,8m
3135,1,[GdAT]Phayld,3950,1713,187,181,368,50.8%,15m
3135,1,Nerevar,3950,1257,83,80,163,50.9%,39m
3135,1,[TeamLT]GunsNRoaches,3950,584,27,12,39,69.2%,28m
3135,1,[DGP]Osukaru,3950,515,19,14,33,57.6%,38m
3135,1,skipper,3950,315,13,8,21,61.9%,12m
3135,3,WeshAlors,3950,190,10,0,10,100.0%,35m
3135,1,[PiGPan]TheMooninite,3950,142,4,6,10,40.0%,13m
3135,1,[llIII]Probius,3950,113,2,2,4,50.0%,17m
3135,1,Dacalux,3950,48,1,7,8,12.5%,7m
3144,1,Estoisismo,3949,93,2,0,2,100.0%,23m
3144,1,Gatsby,3949,46,1,2,3,33.3%,23m
3146,1,[Ash3s]Eleven,3948,2035,306,312,618,49.5%,43m
3146,1,Mopho,3948,550,291,270,561,51.9%,9m
3146,1,Kiwiking,3948,832,45,31,76,59.2%,23m
3146,1,[neuroW]Thoreau,3948,576,23,15,38,60.5%,10m
3146,1,[iMkS]PeLuChiN,3948,456,11,11,22,50.0%,31m
3146,1,CupcakeSatan,3948,318,7,10,17,41.2%,10m
3146,1,iamsam,3948,0,0,1,1,0.0%,41m
3146,1,Dresden,3948,0,0,1,1,0.0%,9m
3154,1,barcode,3947,1176,149,141,290,51.4%,11m
3154,1,Hydralisk,3947,1298,79,67,146,54.1%,37m
3154,1,[OCCHO]Ocschos,3947,136,3,4,7,42.9%,41m
3154,1,IIIIIIIIIIII,3947,0,1,2,3,33.3%,28m
3158,1,[MEP]TrueLegend,3946,2022,480,489,969,49.5%,20m
3158,1,scnightfire,3946,1189,57,50,107,53.3%,12m
3158,1,[S4V4G3]zãÿØ,3946,882,21,29,50,42.0%,41m
3158,1,urixop,3946,418,15,7,22,68.2%,12m
3158,1,TheBigW,3946,110,1,4,5,20.0%,12m
3163,1,Timepiece,3945,1595,138,131,269,51.3%,9m
3163,1,lapengu,3945,814,77,87,164,47.0%,38m
3163,1,CoffeePoops,3945,458,63,44,107,58.9%,12m
3163,1,[EZDUNK]TheEvilOne,3945,652,27,20,47,57.4%,39m
3163,1,[NPhase]Wittgenstein,3945,473,18,19,37,48.6%,24m
3163,1,[neuroS]CarpeBM,3945,731,17,18,35,48.6%,41m
3163,1,[OPBAMF]Multipass,3945,142,4,6,10,40.0%,14m
3163,1,[Smegz]Elmo,3945,46,1,3,4,25.0%,9m
3163,1,[PSlSTC]MyLifeFrAiur,3945,0,0,1,1,0.0%,10m
3163,1,[cat911]SoniicMacro,3945,0,0,2,2,0.0%,11m
3173,1,[ValidG]aNerdsDen,3944,1837,163,153,316,51.6%,27m
3173,1,[LoF]Malignant,3944,1205,101,89,190,53.2%,27m
3173,1,Burger,3944,621,50,45,95,52.6%,12m
3173,1,Aitian,3944,759,35,20,55,63.6%,19m
3173,1,Mingo,3944,621,20,28,48,41.7%,10m
3173,1,House,3944,818,19,29,48,39.6%,9m
3173,1,[Ins8G]Mai,3944,0,0,1,1,0.0%,37m
3180,1,BigPapaKrap,3943,2025,293,293,586,50.0%,16m
3180,1,[IWCP]snackerS,3943,1464,108,78,186,58.1%,23m
3180,1,[EvilGC]atzin,3943,342,37,29,66,56.1%,10m
3180,1,[KSGT]EnDerrJr,3943,983,34,25,59,57.6%,19m
3180,1,Shaurma,3943,126,6,2,8,75.0%,9m
3180,1,Croissant,3943,0,1,0,1,100.0%,41m
3180,1,schuee,3943,0,1,0,1,100.0%,19m
3187,3,[αX]Rushi,3942,1907,208,232,440,47.3%,30m
3187,1,smoosh,3942,2008,179,201,380,47.1%,32m
3187,1,[lNI]QueensGambit,3942,253,10,4,14,71.4%,43m
3187,1,GengaR,3942,119,8,0,8,100.0%,32m
3187,1,Kitty,3942,46,2,1,3,66.7%,17m
3187,1,STOPWHINNING,3942,0,0,2,2,0.0%,43m
3187,1,SpRaYFartt,3942,0,0,3,3,0.0%,27m
3194,1,GrimReaperUK,3941,1863,63,53,116,54.3%,14m
3194,1,[Amb3rs]Smokey,3941,1304,44,46,90,48.9%,17m
3194,3,Epinephrine,3941,240,12,2,14,85.7%,36m
3194,1,Killstrife,3941,291,10,5,15,66.7%,37m
3194,1,Cutthroat,3941,173,6,3,9,66.7%,27m
3194,1,smokem,3941,186,5,6,11,45.5%,23m
3194,1,[s7z]CoRviX,3941,92,2,4,6,33.3%,11m
3201,1,Jocker,3940,1958,136,106,242,56.2%,38m
3201,1,[KingSC]Eddy,3940,1948,63,68,131,48.1%,12m
3201,1,Abyss,3940,1249,60,40,100,60.0%,20m
3201,1,TsogiMaster,3940,457,24,2,26,92.3%,12m
3201,1,[GRNSKN]Gabulin,3940,404,17,8,25,68.0%,8m
3201,1,Arteriuz,3940,375,15,10,25,60.0%,41m
3201,1,[ValidG]Safeword,3940,404,9,15,24,37.5%,33m
3201,1,HateTerrans,3940,144,7,3,10,70.0%,20m
3201,1,Athena,3940,138,4,4,8,50.0%,8m
3201,1,IIIlllIIllII,3940,0,1,0,1,100.0%,16m
3201,1,ORDER,3940,0,1,0,1,100.0%,10m
3201,1,[SsaYnS]Kiar,3940,89,1,1,2,50.0%,20m
3201,1,webhappy,3940,0,0,1,1,0.0%,5m
3214,1,[BIGBC]LeDerp,3939,1902,301,299,600,50.2%,12m
3214,1,Chungus,3939,1937,272,259,531,51.2%,10m
3214,1,RiKo,3939,2003,185,184,369,50.1%,43m
3214,1,NBK,3939,820,30,18,48,62.5%,32m
3214,1,llllllllllll,3939,664,25,16,41,61.0%,19m
3214,1,Vega,3939,269,17,11,28,60.7%,10m
3214,1,[QTp2T]pikott,3939,238,12,7,19,63.2%,20m
3214,3,[InSghT]JDFrosty,3939,36,8,32,40,20.0%,6m
3214,1,[AIlin]Stark,3939,94,2,6,8,25.0%,17m
3214,1,[PNS]Parafina,3939,0,1,0,1,100.0%,38m
3214,1,TROGDOR,3939,0,0,7,7,0.0%,28m
3225,1,Pulsar,3938,2018,237,227,464,51.1%,23m
3225,1,Chass,3938,802,199,152,351,56.7%,10m
3225,1,SicAchu,3938,1999,133,123,256,52.0%,27m
3225,2,IIIIIIIIIIII,3938,327,17,3,20,85.0%,22m
3225,1,Syd,3938,44,3,3,6,50.0%,8m
3225,1,[LÞ]Sesshomaru,3938,96,2,6,8,25.0%,27m
3225,1,[R4R]Jib,3938,0,1,0,1,100.0%,28m
3225,1,PvtHudson,3938,0,0,2,2,0.0%,12m
3233,2,IlIlIlIlIlIl,3937,2108,240,258,498,48.2%,19m
3233,1,[lNI]Hobe,3937,1518,92,87,179,51.4%,10m
3233,1,[SABO]ChewChilla,3937,1196,32,33,65,49.2%,14m
3233,1,toolegit,3937,1036,26,25,51,51.0%,37m
3233,1,Inject,3937,745,20,34,54,37.0%,27m
3233,1,llllllllllll,3937,295,11,9,20,55.0%,10m
3233,1,[SWD325]PrOsperity,3937,48,2,2,4,50.0%,36m
3233,1,[NSKL]Chocobo,3937,0,0,2,2,0.0%,12m
3241,1,jin,3936,2021,581,577,1158,50.2%,31m
3241,3,Quarantino,3936,1807,581,597,1178,49.3%,28m
3241,1,[AD3C]rathmA,3936,1131,78,56,134,58.2%,43m
3241,1,[BELDA]Geno,3936,746,40,37,77,51.9%,29m
3241,1,[hahaez]Nuhzadon,3936,410,20,6,26,76.9%,10m
3241,1,[Lesbos]Sappho,3936,228,6,5,11,54.5%,28m
3247,1,[IMGF]Hootie,3935,1588,162,167,329,49.2%,13m
3247,1,admiration,3935,1125,152,146,298,51.0%,10m
3247,1,Watertop,3935,922,52,40,92,56.5%,16m
3247,1,[LimaSC]vergas,3935,468,43,26,69,62.3%,18m
3247,1,[ØFoxF2]Destro,3935,670,17,16,33,51.5%,29m
3247,1,[VFam]Wookieson,3935,678,16,17,33,48.5%,31m
3247,1,XDsGrrr,3935,0,0,1,1,0.0%,5m
3254,1,BigFungus,3934,2008,227,212,439,51.7%,43m
3254,1,Bearwidme,3934,2002,105,112,217,48.4%,37m
3254,1,DireBearForm,3934,920,41,44,85,48.2%,10m
3254,1,AlejandroDav,3934,144,5,1,6,83.3%,31m
3254,1,Dan,3934,180,5,4,9,55.6%,23m
3254,1,Ozzy,3934,46,1,2,3,33.3%,7m
3260,1,[xNPGx]FULGORMORTEM,3933,1337,71,77,148,48.0%,23m
3260,1,[ArGNA]YaNaRion,3933,734,21,28,49,42.9%,27m
3260,1,[arSBel]kikiswaggg,3933,150,4,3,7,57.1%,14m
3260,1,Tizer,3933,0,1,2,3,33.3%,31m
3260,2,PathRia,3933,0,0,1,1,0.0%,5m
3265,1,KNUCKLEHEAD,3932,2004,203,214,417,48.7%,33m
3265,1,mambius,3932,569,18,24,42,42.9%,29m
3265,1,VINDICTIVE,3932,448,10,18,28,35.7%,27m
3265,3,llllllllllll,3932,213,8,1,9,88.9%,21m
3265,1,cake,3932,276,7,9,16,43.8%,32m
3265,2,CamryPower,3932,74,3,0,3,100.0%,43m
3265,1,Kainz,3932,136,3,5,8,37.5%,8m
3265,2,Nahagliiv,3932,0,0,1,1,0.0%,22m
3273,1,[BRSKR]WookieMonsta,3931,1198,38,38,76,50.0%,16m
3273,1,NameChange,3931,673,29,32,61,47.5%,20m
3273,1,[MangoM]Mangomosh,3931,0,1,1,2,50.0%,31m
3273,3,[GGK]zAndreas,3931,0,1,4,5,20.0%,34m
3277,1,[CCC]ClsClassiC,3930,1543,73,71,144,50.7%,32m
3277,1,[TILL]oTo,3930,1449,44,42,86,51.2%,43m
3277,2,iBuildWorker,3930,665,28,13,41,68.3%,26m
3277,1,zacarizac,3930,706,24,22,46,52.2%,18m
3277,2,zhuguli,3930,0,0,1,1,0.0%,28m
3282,1,[YD2K]RabbitTw,3929,1541,114,95,209,54.5%,43m
3282,1,[VFam]MostGroce,3929,536,85,64,149,57.0%,10m
3282,1,Jerome,3929,1677,67,76,143,46.9%,29m
3282,1,RuDE,3929,1852,61,55,116,52.6%,17m
3282,2,IIIIIIIIIIII,3929,227,13,2,15,86.7%,13m
3282,1,Kazuke,3929,588,13,18,31,41.9%,41m
3282,1,[FxB]caiobex,3929,228,6,4,10,60.0%,13m
3282,3,[MeyMey]Coxaflopin,3929,0,3,2,5,60.0%,32m
3282,2,Weedamins,3929,0,1,1,2,50.0%,14m
3282,1,[Tarren]Nullify,3929,46,1,4,5,20.0%,38m
3292,1,AssTier,3928,1139,79,68,147,53.7%,16m
3292,1,[SCaro]Dath,3928,598,15,16,31,48.4%,5m
3292,1,IIIIIIIIIIII,3928,228,5,8,13,38.5%,37m
3292,1,Crested,3928,0,0,2,2,0.0%,23m
3292,1,[LgnTDS]Fearful,3928,0,0,5,5,0.0%,32m
3297,1,[DarkAG]QuickBen,3927,1502,383,392,775,49.4%,33m
3297,1,[VaLuE]FatTuna,3927,2014,85,70,155,54.8%,12m
3297,1,[UoM]HailStorm,3927,959,50,54,104,48.1%,28m
3297,1,Hyde,3927,1461,43,51,94,45.7%,28m
3297,1,Heisenberg,3927,410,9,16,25,36.0%,28m
3297,1,[51JTM]inspecteur,3927,240,7,4,11,63.6%,37m
3297,2,[WiGGz]SoulPosessed,3927,114,3,1,4,75.0%,35m
3297,3,theripperr,3927,0,3,2,5,60.0%,6m
3297,3,Goofball,3927,0,1,0,1,100.0%,39m
3297,1,IlIlIlllI,3927,0,0,3,3,0.0%,19m
3307,1,Light,3926,2017,596,592,1188,50.2%,29m
3307,1,Gypsy,3926,1890,54,70,124,43.5%,17m
3307,2,rickybobby,3926,185,7,3,10,70.0%,15m
3307,1,[G0Iden]Fire,3926,268,7,10,17,41.2%,23m
3307,1,[DhZCom]Artcs,3926,294,7,12,19,36.8%,29m
3312,1,Croyd,3925,2041,458,435,893,51.3%,13m
3312,1,[DhZAc1]Uranus,3925,1891,76,72,148,51.4%,19m
3312,1,Frankenstein,3925,1682,62,63,125,49.6%,28m
3312,1,[TGosuA]BaldEagle,3925,143,6,12,18,33.3%,18m
3312,3,[C13D]LegendaryQ,3925,0,1,0,1,100.0%,15m
3312,2,FubblyBrog,3925,0,0,1,1,0.0%,35m
3318,1,[LTB666]Tidal,3924,2017,194,174,368,52.7%,12m
3318,1,DangaZone,3924,1355,110,111,221,49.8%,13m
3318,1,[Amb3rs]Rhaegar,3924,488,20,10,30,66.7%,23m
3318,1,[eX]DTWB,3924,543,18,19,37,48.6%,38m
3318,1,AttackDruid,3924,252,11,12,23,47.8%,9m
3318,2,Luck,3924,30,8,47,55,14.5%,35m
3318,1,PHB,3924,46,1,3,4,25.0%,36m
3325,1,Terran,3923,1345,258,266,524,49.2%,17m
3325,3,snidgens,3923,1047,56,74,130,43.1%,16m
3325,1,TheNow,3923,920,37,32,69,53.6%,17m
3325,1,[Msia]Animal,3923,0,0,6,6,0.0%,20m
3329,1,nOus,3922,1698,435,440,875,49.7%,20m
3329,3,Fruit,3922,357,321,317,638,50.3%,30m
3329,1,trollbert,3922,956,33,26,59,55.9%,17m
3332,1,SirCoOkie,3921,1085,105,81,186,56.5%,12m
3332,1,[UWO]Laffs,3921,836,54,28,82,65.9%,10m
3332,2,Volnay,3921,602,28,10,38,73.7%,16m
3332,1,[TGosuC]Bentobocx,3921,845,20,23,43,46.5%,37m
3332,1,[SkAL]FrostyBoi,3921,522,15,11,26,57.7%,32m
3332,2,Duck,3921,301,15,12,27,55.6%,16m
3332,3,LOOTBOX,3921,0,5,0,5,100.0%,36m
3332,1,Sorrygtg,3921,0,0,2,2,0.0%,4m
3340,1,Jamaicandude,3920,1763,124,97,221,56.1%,12m
3340,1,[EXECP]ShmubDub,3920,1111,34,29,63,54.0%,11m
3340,2,admiration,3920,362,19,6,25,76.0%,9m
3340,2,ÅBERGAHKBAR,3920,0,1,0,1,100.0%,35m
3340,1,[ggNtus]Kixantrix,3920,46,1,8,9,11.1%,39m
3340,2,[cl0udM]Kakarott,3920,0,0,1,1,0.0%,22m
3346,1,Aithic,3919,1927,315,330,645,48.8%,16m
3346,1,[Z0HR]Anarchy,3919,1891,144,145,289,49.8%,12m
3346,1,[SsaYnS]BigMac,3919,884,43,29,72,59.7%,17m
3346,2,Beater,3919,164,9,0,9,100.0%,17m
3346,2,IIIIIIIIIIII,3919,0,0,1,1,0.0%,3m
3351,1,LuvSicBubble,3918,465,38,13,51,74.5%,41m
3351,2,[THrts]MRKM,3918,70,3,0,3,100.0%,19m
3351,2,[CrnKy]Daunted,3918,42,1,1,2,50.0%,35m
3351,2,[Brober]Shard,3918,0,0,1,1,0.0%,42m
3351,2,[TgAg]CptWhoopass,3918,0,0,1,1,0.0%,14m
3351,2,Usuck,3918,0,0,1,1,0.0%,22m
3357,1,[JHU]AquAblAck,3917,1836,65,69,134,48.5%,19m
3357,1,[QTclub]niknovichkov,3917,1033,27,26,53,50.9%,11m
3357,1,imtrashCAN,3917,316,16,5,21,76.2%,37m
3357,1,[OIGE]Chris,3917,532,12,21,33,36.4%,23m
3357,1,Chad,3917,350,8,7,15,53.3%,16m
3357,1,[NPhasA]Malintor,3917,180,4,9,13,30.8%,11m
3357,1,Resistance,3917,0,0,2,2,0.0%,10m
3357,1,Doued,3917,0,0,3,3,0.0%,8m
3365,1,Mindex,3916,1068,43,37,80,53.8%,20m
3365,1,Leviatán,3916,111,26,20,46,56.5%,24m
3365,1,Yommit,3916,263,9,3,12,75.0%,9m
3365,1,[INextI]ELECTRIC,3916,366,8,11,19,42.1%,41m
3365,1,[SizZIe]SizzlinMelon,3916,370,8,19,27,29.6%,11m
3365,1,[VCF]Extinction,3916,258,6,8,14,42.9%,16m
3371,1,yam,3915,1933,83,84,167,49.7%,24m
3371,1,[BoRnGo]Finch,3915,1084,81,70,151,53.6%,11m
3371,1,[ØFoxF2]TitaniumBoss,3915,1700,51,66,117,43.6%,43m
3371,1,[TUTTER]Cubra,3915,601,20,20,40,50.0%,18m
3371,1,Felicity,3915,248,11,12,23,47.8%,13m
3371,2,Trumpanzee,3915,72,3,1,4,75.0%,14m
3371,2,mamafoca,3915,0,0,1,1,0.0%,8m
3378,1,[tanay]IHaveALife,3914,1093,124,112,236,52.5%,38m
3378,1,DirtyStreakr,3914,524,26,14,40,65.0%,27m
3378,2,DontBeSad,3914,156,5,2,7,71.4%,32m
3378,2,castelu,3914,0,1,0,1,100.0%,7m
3378,2,[NAis]Jamesvin,3914,0,0,1,1,0.0%,35m
3383,1,[TBilly]Dragarius,3913,1563,104,103,207,50.2%,23m
3383,1,Eyeless,3913,1136,78,71,149,52.3%,9m
3383,1,LittleFoot,3913,533,15,21,36,41.7%,9m
3383,1,[tTZz]InitialLiMiT,3913,135,2,3,5,40.0%,13m
3387,1,Foxtrotter,3912,1993,81,83,164,49.4%,17m
3387,2,[HUSHrx]Interstellar,3912,72,3,1,4,75.0%,27m
3387,2,[cl0udM]DaddyTugboat,3912,0,1,0,1,100.0%,9m
3387,1,[EvilGC]ChesitoPato,3912,0,1,1,2,50.0%,13m
3387,2,[HANGRY]daveburrito,3912,0,0,1,1,0.0%,8m
3387,2,ZZorange,3912,0,0,2,2,0.0%,24m
3387,1,[ValidG]Irish,3912,0,0,5,5,0.0%,11m
3394,1,Noxus,3911,1998,198,171,369,53.7%,20m
3394,2,[TSØP]AbOsX,3911,1274,155,141,296,52.4%,14m
3394,1,CTRL,3911,1648,48,59,107,44.9%,19m
3394,1,[xGenGx]MadneticsYT,3911,1266,40,35,75,53.3%,8m
3394,1,[GamCub]Jean,3911,443,15,17,32,46.9%,39m
3394,2,BarcodeZerg,3911,202,7,5,12,58.3%,17m
3394,2,COTO,3911,128,3,4,7,42.9%,9m
3394,1,[cl0udM]Meep,3911,117,2,7,9,22.2%,15m
3394,2,[PTHero]FireBird,3911,0,0,1,1,0.0%,13m
3403,1,[SBoys]Dwonker,3910,1373,228,218,446,51.1%,18m
3403,2,Bugz,3910,1706,168,138,306,54.9%,9m
3403,1,HelloWorld,3910,310,7,9,16,43.8%,20m
3403,1,IlIlIlIlIlIl,3910,88,2,2,4,50.0%,23m
3403,2,mouthfeel,3910,34,1,1,2,50.0%,40m
3403,1,[SsaYnS]Tachypsychia,3910,0,0,3,3,0.0%,12m
3409,1,[TSØP]sigma,3909,2004,504,505,1009,50.0%,38m
3409,2,GinHiima,3909,1685,355,345,700,50.7%,40m
3409,1,Rigo,3909,1579,58,69,127,45.7%,8m
3409,1,WarrenBuffet,3909,320,8,16,24,33.3%,8m
3409,2,[IMl]ELpresidente,3909,190,7,3,10,70.0%,30m
3409,1,[Goatty]walkingplant,3909,94,3,4,7,42.9%,4m
3409,1,WolfFire,3909,90,1,3,4,25.0%,32m
3409,2,ParkBoGeom,3909,0,0,2,2,0.0%,43m
3417,1,Oblivion,3908,814,89,78,167,53.3%,12m
3417,1,SurySpark,3908,305,12,8,20,60.0%,15m
3417,1,[NTDL]gopher,3908,226,6,8,14,42.9%,10m
3417,2,GANA,3908,0,0,1,1,0.0%,16m
3417,2,OjotaAsesina,3908,0,0,2,2,0.0%,39m
3422,1,MancoForLife,3907,561,16,16,32,50.0%,18m
3422,1,[shnell]glups,3907,356,9,14,23,39.1%,41m
3422,2,PrexcitedAF,3907,0,2,3,5,40.0%,25m
3422,3,[KeGeBe]VladPutin,3907,30,1,2,3,33.3%,36m
3422,2,Aizensama,3907,0,0,5,5,0.0%,42m
3427,2,[UpeV]Kelevra,3906,0,1,0,1,100.0%,7m
3427,2,llllllllllll,3906,0,1,1,2,50.0%,14m
3429,3,keyo,3905,1866,319,361,680,46.9%,30m
3429,3,[DarkAG]PKV,3905,1681,129,147,276,46.7%,12m
3429,1,Goosebump,3905,542,39,18,57,68.4%,12m
3429,3,IIIIIIIIIIII,3905,240,12,2,14,85.7%,11m
3429,2,SinCosTgCotg,3905,242,9,8,17,52.9%,10m
3434,1,odry,3904,1611,352,359,711,49.5%,23m
3434,1,[BA5B]Polokus,3904,295,30,30,60,50.0%,10m
3434,1,[αX]KOBA,3904,550,20,16,36,55.6%,10m
3434,2,[BROFLX]VADER,3904,0,1,0,1,100.0%,5m
3434,2,[NPhasA]nevermore,3904,0,0,2,2,0.0%,5m
3439,1,Delay,3903,1993,180,175,355,50.7%,27m
3439,1,Draconic,3903,1113,47,49,96,49.0%,28m
3439,1,Revelation,3903,311,11,8,19,57.9%,20m
3439,1,MasterShake,3903,383,10,12,22,45.5%,36m
3443,1,Yeezy,3902,1999,377,368,745,50.6%,33m
3443,1,[DHZ0ne]Newlied,3902,1828,123,122,245,50.2%,31m
3443,1,[Bee]Takkaryx,3902,1990,109,110,219,49.8%,13m
3443,1,AndyPandy,3902,335,13,14,27,48.1%,9m
3443,2,Terran,3902,254,9,1,10,90.0%,35m
3443,1,XsLel,3902,88,2,4,6,33.3%,38m
3443,2,[scRPI]tfang,3902,0,0,1,1,0.0%,38m
3450,1,Bean,3901,1776,462,482,944,48.9%,41m
3450,1,Ghyle,3901,1884,168,151,319,52.7%,8m
3450,1,[PLA2N]tommygun,3901,1346,35,39,74,47.3%,43m
3450,1,Frosty,3901,552,13,28,41,31.7%,16m
3450,2,[TILL]Federer,3901,0,0,1,1,0.0%,14m
3455,1,[POOKGH]daman,3900,2009,208,216,424,49.1%,10m
3455,1,[BioTek]JALNARE,3900,1870,134,125,259,51.7%,9m
3455,2,[SsaYnS]Boundless,3900,1350,104,90,194,53.6%,32m
3455,1,[Macac0]liszt,3900,1565,99,93,192,51.6%,38m
3455,1,[BALLS]Dasian,3900,1342,97,103,200,48.5%,24m
3455,2,[cl0udM]aButtPirate,3900,1002,50,43,93,53.8%,4m
3455,2,Manbrave,3900,444,14,13,27,51.9%,20m
3455,1,LongJohnJay,3900,186,3,6,9,33.3%,28m
3455,2,HuskyS,3900,36,2,0,2,100.0%,35m
3455,3,[ALevel]ShiningStars,3900,0,1,0,1,100.0%,12m
3455,2,[painHa]Clarity,3900,0,1,3,4,25.0%,25m
3455,2,Tyve,3900,0,0,1,1,0.0%,27m
3467,1,[TeamUR]Magyner,3899,1837,234,225,459,51.0%,17m
3467,1,[FOTBA]Kaien,3899,1614,85,89,174,48.9%,24m
3467,2,[ScSwrm]Apoptosis,3899,34,2,0,2,100.0%,41m
3467,2,Shou,3899,88,1,1,2,50.0%,43m
3471,1,[Xpk]Gelber,3898,1262,45,39,84,53.6%,5m
3471,1,OtecDimagi,3898,309,16,6,22,72.7%,14m
3471,2,Ghost,3898,236,10,7,17,58.8%,33m
3471,1,Cinco,3898,232,6,21,27,22.2%,13m
3471,3,Stacy,3898,30,5,4,9,55.6%,21m
3471,2,[GRNSKN]Sadist,3898,0,1,1,2,50.0%,37m
3471,2,[LoliGG]Nubiles,3898,0,0,2,2,0.0%,13m
3471,1,notBonjwa,3898,0,0,4,4,0.0%,10m
3479,3,infernoboss,3897,1483,189,209,398,47.5%,19m
3479,2,Wolfhead,3897,1503,100,44,144,69.4%,30m
3479,1,AirGoodman,3897,493,16,12,28,57.1%,9m
3479,1,RandyBeans,3897,492,15,14,29,51.7%,28m
3479,1,QWERTY,3897,138,3,10,13,23.1%,4m
3479,2,asLav,3897,0,0,1,1,0.0%,42m
3479,2,Karrindeez,3897,0,0,2,2,0.0%,9m
3486,1,Fluffy,3896,625,20,19,39,51.3%,23m
3486,1,[αB]Spartan,3896,574,15,13,28,53.6%,36m
3486,1,haShtaGmabiT,3896,142,3,7,10,30.0%,27m
3486,2,Omni,3896,0,0,1,1,0.0%,5m
3490,1,IlIlIlIlIlIl,3895,1760,90,66,156,57.7%,23m
3490,2,Scary,3895,170,7,3,10,70.0%,6m
3490,2,gordon,3895,183,5,1,6,83.3%,35m
3490,2,[MisW]Daedes,3895,0,0,1,1,0.0%,41m
3494,1,BINI,3894,1984,160,159,319,50.2%,9m
3494,2,Sulluukun,3894,1197,77,55,132,58.3%,17m
3494,2,[ANFA]Queen,3894,446,56,42,98,57.1%,17m
3494,2,[TYRNT]Yharim,3894,216,11,2,13,84.6%,6m
3494,2,Samp,3894,0,0,1,1,0.0%,8m
3494,2,Harry,3894,0,0,1,1,0.0%,41m
3494,2,Stormvill,3894,0,0,3,3,0.0%,22m
3501,3,Bega,3893,456,32,59,91,35.2%,30m
3501,1,Sica,3893,234,13,4,17,76.5%,23m
3501,1,thedude,3893,224,6,11,17,35.3%,9m
3501,2,EmailAddress,3893,34,2,0,2,100.0%,26m
3501,2,Halloween,3893,0,0,1,1,0.0%,24m
3501,2,[GGK]StfuSiriusly,3893,0,0,1,1,0.0%,32m
3507,1,Camel,3892,1815,178,194,372,47.8%,28m
3507,1,SCAChoi,3892,1282,101,107,208,48.6%,18m
3507,1,[BRSKR]SnapCast,3892,1844,60,68,128,46.9%,18m
3507,1,[bLoser]LOSE,3892,1346,44,41,85,51.8%,38m
3511,1,[CrnKy]LightVIP,3891,1951,103,127,230,44.8%,29m
3511,1,royliuboy,3891,658,57,42,99,57.6%,20m
3511,1,[chador]OctaKnife,3891,1078,55,40,95,57.9%,10m
3511,1,YongWon,3891,337,10,12,22,45.5%,28m
3511,1,Hiccup,3891,234,5,10,15,33.3%,18m
3516,1,Diggler,3890,1603,133,141,274,48.5%,29m
3516,1,swtnycboy,3890,1676,59,60,119,49.6%,23m
3516,1,[eSun]mobious,3890,778,31,29,60,51.7%,13m
3516,1,Opiee,3890,740,25,22,47,53.2%,18m
3516,1,[Ris3n]butterfly,3890,456,10,24,34,29.4%,13m
3516,2,Solaris,3890,116,4,4,8,50.0%,13m
3516,2,ALM,3890,80,3,2,5,60.0%,16m
3516,1,[Hoxy]Mymura,3890,138,3,2,5,60.0%,10m
3516,2,Krahnicz,3890,80,2,3,5,40.0%,35m
3516,3,SoLidLuiGGio,3890,0,1,0,1,100.0%,22m
3516,2,[DaNang]LinhSco,3890,0,0,1,1,0.0%,27m
3516,2,[Bee]Virus,3890,0,0,2,2,0.0%,13m
3516,1,[TOYOTA]CamryPower,3890,0,0,2,2,0.0%,28m
3529,1,Ledrash,3889,1987,381,401,782,48.7%,24m
3529,1,[Swage]Potential,3889,1484,62,58,120,51.7%,10m
3529,1,WonBaseZerg,3889,513,45,49,94,47.9%,38m
3529,1,[Th3Bad]Bondrewd,3889,729,33,23,56,58.9%,27m
3529,1,[αXLa]MooD,3889,698,16,17,33,48.5%,13m
3529,2,IIIIIIIII,3889,336,12,3,15,80.0%,29m
3529,1,MadStar,3889,324,9,12,21,42.9%,24m
3529,1,taktic,3889,182,4,7,11,36.4%,9m
3529,2,[BREA]Kenny,3889,0,1,0,1,100.0%,35m
3529,2,DJTJ,3889,0,0,1,1,0.0%,32m
3539,1,Patches,3888,1919,160,151,311,51.4%,19m
3539,2,StarFiend,3888,450,29,18,47,61.7%,42m
3539,1,LudO,3888,764,21,19,40,52.5%,13m
3539,3,DildoBaggins,3888,166,9,0,9,100.0%,26m
3539,2,Onerous,3888,178,5,8,13,38.5%,33m
3539,1,[AGFate]BrownieB,3888,140,4,9,13,30.8%,9m
3539,2,Blazeling,3888,0,1,0,1,100.0%,7m
3539,2,sagui,3888,0,0,1,1,0.0%,30m
3539,2,Destrous,3888,0,0,2,2,0.0%,24m
3548,1,AddictioN,3887,831,49,47,96,51.0%,10m
3549,1,DeR,3886,1768,184,185,369,49.9%,28m
3549,2,[Fatty]HateLoad,3886,1455,166,151,317,52.4%,40m
3549,1,Strawbs,3886,1306,130,122,252,51.6%,38m
3549,1,[TGCF]Cialis,3886,1900,85,85,170,50.0%,10m
3549,2,KitKatze,3886,354,24,19,43,55.8%,29m
3549,1,[EZDUNK]chuckdoodle,3886,768,22,26,48,45.8%,27m
3549,2,yuKo,3886,282,9,5,14,64.3%,14m
3549,1,Kainz,3886,312,7,11,18,38.9%,12m
3549,1,JDON,3886,211,5,19,24,20.8%,38m
3549,2,[Cryptc]Shangxz,3886,0,0,1,1,0.0%,43m
3549,2,Pockets,3886,0,0,3,3,0.0%,25m
3560,1,Vainiac,3885,1949,228,213,441,51.7%,41m
3560,1,Tanith,3885,1891,120,122,242,49.6%,28m
3560,2,Tag,3885,992,43,22,65,66.2%,13m
3560,1,[NSKL]Laik,3885,642,15,28,43,34.9%,8m
3560,2,Sprite,3885,0,0,1,1,0.0%,15m
3560,2,Thomas,3885,0,0,2,2,0.0%,15m
3566,1,[KoopaZ]Thumper,3884,1052,27,42,69,39.1%,33m
3566,2,[GAMRS]Bmanking,3884,68,3,0,3,100.0%,16m
3566,2,Nump,3884,36,2,0,2,100.0%,17m
3566,2,[M2A5]llllllllllll,3884,0,1,0,1,100.0%,40m
3566,2,[PTZ2]gggg,3884,124,1,5,6,16.7%,27m
3571,1,GunR,3883,1931,400,357,757,52.8%,20m
3571,1,IIlIlIIllllI,3883,1346,106,87,193,54.9%,17m
3571,2,Profisee,3883,1372,58,40,98,59.2%,6m
3571,1,PleaseNo,3883,803,56,36,92,60.9%,29m
3571,1,[FlTM]StayReal,3883,578,27,19,46,58.7%,43m
3571,2,IIIIIIIIIIII,3883,166,6,4,10,60.0%,22m
3571,2,Terran,3883,132,5,3,8,62.5%,10m
3571,2,[chEdd]Stallions,3883,60,2,5,7,28.6%,28m
3571,1,[JOSUN]IlSanNakJiIl,3883,102,1,5,6,16.7%,13m
3571,2,[Lists]Doubly,3883,0,0,1,1,0.0%,5m
3581,1,wenbin,3882,1467,222,210,432,51.4%,8m
3581,1,FrumpyStumps,3882,1752,104,105,209,49.8%,37m
3581,2,[TGosuD]Parmigiano,3882,92,4,2,6,66.7%,7m
3584,3,[cl0udM]ITACHI,3881,1495,497,489,986,50.4%,19m
3584,2,HesiHeyyyy,3881,1340,65,35,100,65.0%,8m
3584,2,AstroDroid,3881,1158,50,34,84,59.5%,4m
3584,2,goldhat,3881,818,36,14,50,72.0%,6m
3584,1,rUready,3881,495,23,11,34,67.6%,38m
3584,1,LazyTurtles,3881,194,5,6,11,45.5%,18m
3584,1,Devil,3881,158,5,14,19,26.3%,29m
3584,2,[WeX]KueTep,3881,36,1,2,3,33.3%,17m
3584,2,Rasmus,3881,30,1,2,3,33.3%,36m
3584,2,Illidan,3881,0,0,2,2,0.0%,14m
3594,1,Horde,3880,1856,104,104,208,50.0%,37m
3594,1,MVP,3880,1005,35,29,64,54.7%,10m
3594,1,stOic,3880,397,10,13,23,43.5%,13m
3594,2,[NSheer]MadaMada,3880,252,9,8,17,52.9%,42m
3594,3,LongDicStyle,3880,121,7,0,7,100.0%,32m
3594,1,[VAPE7]LuNaTiC,3880,228,5,8,13,38.5%,23m
3594,1,eYeTrIcK,3880,138,3,16,19,15.8%,36m
3594,2,[WNTRLY]jscabra,3880,0,1,1,2,50.0%,41m
3602,1,BlacKAcE,3879,1963,210,214,424,49.5%,19m
3602,1,glaxor,3879,1323,45,43,88,51.1%,37m
3602,1,[CadeGs]Ultimifier,3879,475,22,17,39,56.4%,11m
3602,2,Tetris,3879,606,20,19,39,51.3%,42m
3602,2,Iggy,3879,452,13,13,26,50.0%,38m
3602,1,IIIIIIIIIIII,3879,218,12,4,16,75.0%,11m
3602,2,Mary,3879,354,10,7,17,58.8%,29m
3602,1,SEAR,3879,366,9,12,21,42.9%,27m
3602,2,[Entro]EntropyVX,3879,34,1,1,2,50.0%,27m
3602,2,[ShRa]Tochi,3879,0,0,2,2,0.0%,24m
3612,2,jeKA,3878,38,1,1,2,50.0%,12m
3612,2,NoDaViS,3878,0,0,2,2,0.0%,26m
3612,3,[SCxPH]Reppageki,3878,0,0,3,3,0.0%,15m
3615,2,DrunkBatya,3877,1568,107,82,189,56.6%,31m
3615,1,AZUKI,3877,1482,86,94,180,47.8%,9m
3615,1,Timthehappy,3877,1700,75,87,162,46.3%,33m
3615,1,[RE1]MinterBat,3877,548,32,13,45,71.1%,12m
3615,3,Briski,3877,0,0,1,1,0.0%,39m
3615,2,[FFAA]Kdyz,3877,0,0,3,3,0.0%,22m
3621,2,Diogo,3876,494,17,13,30,56.7%,9m
3621,1,[TGosuC]ChonnieWin,3876,322,8,15,23,34.8%,14m
3621,2,JaYsPoT,3876,112,4,1,5,80.0%,35m
3621,2,Pinfi,3876,126,4,6,10,40.0%,18m
3621,1,[CLord]Hipertex,3876,92,2,3,5,40.0%,17m
3626,1,[DhZPro]TAG,3875,1463,179,184,363,49.3%,8m
3626,1,GrandPa,3875,1220,53,45,98,54.1%,13m
3626,3,Monica,3875,169,6,4,10,60.0%,41m
3626,2,[TeamLT]AoFElBean,3875,204,6,7,13,46.2%,13m
3626,1,[ezrekt]Brad,3875,180,3,6,9,33.3%,11m
3631,1,[izHere]AJax,3874,1773,428,425,853,50.2%,4m
3631,1,Rolipan,3874,1648,109,103,212,51.4%,38m
3633,1,Bathtub,3873,1991,277,276,553,50.1%,27m
3633,1,[BIF]Jahni,3873,1949,152,176,328,46.3%,20m
3633,1,Keopele,3873,1632,119,92,211,56.4%,20m
3633,1,lIlIlIlIlIlI,3873,471,60,54,114,52.6%,41m
3633,1,[LoF]AMH,3873,770,24,33,57,42.1%,10m
3633,2,Rogue,3873,232,7,7,14,50.0%,42m
3633,1,CozyBull,3873,138,6,7,13,46.2%,28m
3633,2,Thrawn,3873,40,1,2,3,33.3%,18m
3641,1,Subject,3872,769,77,59,136,56.6%,9m
3641,2,Davidcito,3872,202,6,10,16,37.5%,43m
3641,2,Vert,3872,0,0,1,1,0.0%,25m
3644,2,[FReNs]LEGENDARY,3871,1558,159,153,312,51.0%,27m
3644,1,sPaAsM,3871,1303,89,91,180,49.4%,37m
3644,1,[aIien]hightiger,3871,287,14,17,31,45.2%,9m
3644,2,Deezeegee,3871,96,4,5,9,44.4%,26m
3644,2,[DaPlug]Nagirrek,3871,36,1,1,2,50.0%,13m
3649,1,[ZTemps]OneMoreTime,3870,1264,104,98,202,51.5%,38m
3649,2,Alexslayer,3870,653,91,86,177,51.4%,26m
3649,1,Kaabbom,3870,881,44,45,89,49.4%,11m
3649,1,[Weac]FreezingRain,3870,1202,29,40,69,42.0%,19m
3649,2,Jnk,3870,395,28,13,41,68.3%,14m
3649,1,[xLgNx]Kalo,3870,544,12,17,29,41.4%,10m
3649,3,[GGu2EZ]HeReTiC,3870,30,1,1,2,50.0%,34m
3649,2,BulletMagnet,3870,0,0,1,1,0.0%,26m
3657,1,[SC2Hn]Shaggy,3869,1627,61,64,125,48.8%,43m
3657,1,llllllllllll,3869,951,42,47,89,47.2%,20m
3657,2,[BOTA]Salorah,3869,863,41,23,64,64.1%,43m
3657,2,Prost,3869,453,22,17,39,56.4%,13m
3657,1,[Flam3s]Dias,3869,393,10,10,20,50.0%,13m
3657,2,BlueLeaf,3869,0,3,2,5,60.0%,32m
3657,2,[AtL450]TaCTiK,3869,0,1,0,1,100.0%,5m
3657,2,[TGosuD]Curtiszzzz,3869,0,1,2,3,33.3%,21m
3665,1,PeasAnt,3868,843,21,23,44,47.7%,4m
3665,1,ReallyManny,3868,621,16,24,40,40.0%,14m
3665,3,[CMR]XenoLiar,3868,121,5,0,5,100.0%,16m
3665,3,[αB]AZAZEL,3868,169,5,0,5,100.0%,27m
3665,2,[iFAP]runningman,3868,0,1,0,1,100.0%,22m
3665,2,FreeHongKong,3868,42,1,4,5,20.0%,4m
3671,3,DanMaster,3867,1865,1342,1459,2801,47.9%,26m
3671,2,[TGosuA]FelCloud,3867,976,32,32,64,50.0%,24m
3671,2,PartyWater,3867,704,30,15,45,66.7%,36m
3671,2,[SCTues]ZiP,3867,182,5,5,10,50.0%,3m
3675,2,wipeOut,3866,711,36,32,68,52.9%,40m
3675,1,mateo,3866,763,19,22,41,46.3%,12m
3675,2,Colin,3866,0,0,1,1,0.0%,8m
3678,1,[M0DE]BLISSMODE,3865,1542,47,52,99,47.5%,13m
3678,1,Dudebro,3865,1174,30,36,66,45.5%,39m
3678,2,[HIPASS]urexxxx,3865,464,17,8,25,68.0%,17m
3678,2,Thrifter,3865,104,3,5,8,37.5%,40m
3678,2,[Koshka]Xenakis,3865,0,0,1,1,0.0%,22m
3683,1,[TKCT]NecrO,3864,1469,45,47,92,48.9%,12m
3684,2,BrazzaDiesel,3863,1595,309,269,578,53.5%,42m
3684,2,JacuzziSplot,3863,242,9,4,13,69.2%,28m
3684,2,Grrrrrrrrrrr,3863,202,7,6,13,53.8%,7m
3684,1,NoobZerg,3863,226,5,10,15,33.3%,20m
3684,3,[ØÛ]Apocalipthos,3863,30,3,4,7,42.9%,15m
3684,1,sAINtNsINNer,3863,48,1,6,7,14.3%,13m
3684,2,tinyhos,3863,0,0,1,1,0.0%,41m
3691,1,batrick,3862,1807,239,241,480,49.8%,41m
3691,1,Larke,3862,635,26,18,44,59.1%,12m
3691,1,Herrcombs,3862,880,22,29,51,43.1%,9m
3691,1,[MadK]Shellbee,3862,383,10,11,21,47.6%,41m
3691,2,[lNI]Yuhung,3862,184,7,3,10,70.0%,19m
3691,3,DaiRY,3862,146,3,3,6,50.0%,8m
3691,2,wisdom,3862,74,2,3,5,40.0%,27m
3691,3,[2Pac96]monster,3862,0,1,0,1,100.0%,23m
3699,1,Zandak,3861,1744,177,171,348,50.9%,41m
3699,1,[cl0udM]FruitMedley,3861,1557,112,115,227,49.3%,32m
3699,2,XVIII,3861,682,52,39,91,57.1%,28m
3699,1,[BStL]Jawhorse,3861,0,1,2,3,33.3%,38m
3699,2,General,3861,32,1,2,3,33.3%,6m
3699,2,ChadMann,3861,32,1,3,4,25.0%,24m
3699,2,wenks,3861,38,1,3,4,25.0%,8m
3699,2,Logarithm,3861,0,0,3,3,0.0%,35m
3707,1,Siisyphus,3860,1979,391,367,758,51.6%,7m
3707,1,[iQs]jin,3860,1697,83,74,157,52.9%,38m
3707,1,[RANDYZ]PickleLo,3860,1609,52,52,104,50.0%,13m
3707,2,BYBY,3860,828,37,21,58,63.8%,41m
3707,1,nAPoleonDyna,3860,646,31,19,50,62.0%,37m
3707,2,Relentless,3860,476,16,11,27,59.3%,20m
3707,2,[PNS]Tek,3860,422,16,16,32,50.0%,8m
3707,1,Wogo,3860,630,16,19,35,45.7%,17m
3707,2,Slipperz,3860,32,2,1,3,66.7%,36m
3707,2,dreamgirl,3860,0,0,2,2,0.0%,6m
3717,1,multiIn,3859,1963,315,302,617,51.1%,19m
3717,1,TacoBlaster,3859,1559,171,161,332,51.5%,19m
3717,2,Cleon,3859,324,12,7,19,63.2%,22m
3717,2,[YEOBO]milk,3859,0,1,0,1,100.0%,7m
3717,2,[lNI]PrismMike,3859,0,1,0,1,100.0%,25m
3722,1,[Gouda]Bunsen,3858,1866,345,332,677,51.0%,17m
3722,2,Radi,3858,1676,184,176,360,51.1%,5m
3722,1,Morphilator,3858,1966,178,175,353,50.4%,12m
3722,1,NoName,3858,1807,130,146,276,47.1%,37m
3722,2,Odibear,3858,138,4,6,10,40.0%,13m
3727,1,[NFLDs]TazaroX,3857,1936,71,80,151,47.0%,9m
3727,2,[FkJeff]laozi,3857,490,59,49,108,54.6%,43m
3727,2,[PiGPan]emctwo,3857,1023,51,36,87,58.6%,41m
3727,2,[VFam2]TheBigBald,3857,390,15,10,25,60.0%,40m
3727,1,[NwAs]Draconix,3857,475,10,15,25,40.0%,41m
3727,2,Luna,3857,154,6,4,10,60.0%,4m
3727,1,[nucle]Evacuate,3857,134,2,6,8,25.0%,28m
3727,2,Tasty,3857,0,1,0,1,100.0%,13m
3727,2,[SkAL]SoILLGamingg,3857,42,1,2,3,33.3%,27m
3736,1,RollTheDice,3856,1947,323,341,664,48.6%,18m
3736,1,[WNTRGC]Loma,3856,1316,101,103,204,49.5%,11m
3736,1,[SIoth]smu,3856,1369,97,94,191,50.8%,15m
3736,2,Rayno,3856,989,70,73,143,49.0%,43m
3736,2,Practice,3856,255,12,10,22,54.5%,27m
3736,2,damo,3856,262,8,9,17,47.1%,29m
3736,2,DonMClean,3856,0,1,1,2,50.0%,36m
3736,2,Tenchidada,3856,34,1,3,4,25.0%,24m
3744,2,EdibleAnimal,3855,1648,119,105,224,53.1%,9m
3744,1,DrGG,3855,1182,68,67,135,50.4%,39m
3744,1,[YD2K]GBFK,3855,1357,49,42,91,53.8%,15m
3744,2,Reaper,3855,827,32,25,57,56.1%,15m
3744,2,Stella,3855,202,6,7,13,46.2%,42m
3744,2,[TGosuA]YangGang,3855,66,3,3,6,50.0%,27m
3744,3,[CHEF]gAMe,3855,58,2,2,4,50.0%,11m
3744,2,Saltheart,3855,34,1,1,2,50.0%,27m
3752,2,stardust,3854,810,38,19,57,66.7%,17m
3752,2,[proXG]PaWn,3854,990,38,30,68,55.9%,15m
3752,1,IIIIIIIIIIII,3854,528,36,28,64,56.2%,10m
3752,1,[BoRnGo]Digit,3854,969,34,25,59,57.6%,17m
3752,2,DictatorKev,3854,182,5,7,12,41.7%,26m
3752,2,IAMHERE,3854,102,3,1,4,75.0%,30m
3752,1,Culvers,3854,88,3,7,10,30.0%,23m
3752,2,Ghostface,3854,34,2,3,5,40.0%,19m
3752,2,[LDCO]PerroLoco,3854,32,1,2,3,33.3%,35m
3761,1,Diogo,3853,743,38,36,74,51.4%,17m
3761,1,[NovaX]octomologyst,3853,1030,31,34,65,47.7%,41m
3761,2,lililililil,3853,324,16,5,21,76.2%,36m
3761,2,davidit,3853,0,4,1,5,80.0%,28m
3761,2,Lagger,3853,0,1,0,1,100.0%,41m
3761,2,noodle,3853,0,1,3,4,25.0%,11m
3761,2,[SGsc18]TROVAS,3853,0,0,1,1,0.0%,8m
3761,2,Zolon,3853,0,0,2,2,0.0%,35m
3769,2,smokem,3852,1056,41,31,72,56.9%,42m
3769,2,Woody,3852,384,35,34,69,50.7%,15m
3769,2,Atium,3852,351,34,28,62,54.8%,15m
3769,1,[AIDZZ]Startrooper,3852,564,14,24,38,36.8%,17m
3769,1,Molga,3852,330,8,15,23,34.8%,23m
3769,2,[nzC]BoneApart,3852,132,5,5,10,50.0%,13m
3769,1,llllllllllll,3852,230,5,12,17,29.4%,4m
3769,2,[JHU]pAndorA,3852,38,1,4,5,20.0%,28m
3769,2,PlanetZerus,3852,0,0,1,1,0.0%,22m
3778,1,MVVM,3851,1914,168,153,321,52.3%,11m
3778,2,MaryaReisy,3851,72,2,4,6,33.3%,13m
3778,2,pieking,3851,0,0,1,1,0.0%,31m
3781,1,DCrush,3850,1384,119,129,248,48.0%,14m
3781,1,JDAN,3850,1178,70,61,131,53.4%,20m
3781,1,lilSenpai,3850,1532,67,63,130,51.5%,17m
3781,2,Nightmare,3850,368,30,25,55,54.5%,38m
3781,2,GeTouT,3850,528,24,13,37,64.9%,21m
3781,3,Spear,3850,144,8,0,8,100.0%,5m
3781,2,Crayzn,3850,68,3,1,4,75.0%,15m
3781,2,[PaPP]TheSpacePope,3850,0,0,2,2,0.0%,36m
3789,2,Critter,3849,88,2,0,2,100.0%,41m
3789,2,Beren,3849,0,1,0,1,100.0%,43m
3791,1,town,3848,1400,48,44,92,52.2%,17m
3791,2,glumanda,3848,180,7,3,10,70.0%,38m
3791,2,SuShi,3848,192,7,5,12,58.3%,27m
3791,3,QueenDadDy,3848,86,4,2,6,66.7%,15m
3791,2,Destroyer,3848,0,2,3,5,40.0%,34m
3791,2,FriTTo,3848,0,0,1,1,0.0%,6m
3797,2,Beekz,3847,1670,260,250,510,51.0%,7m
3797,1,MTpoobear,3847,1091,35,35,70,50.0%,17m
3797,2,Temporary,3847,108,3,7,10,30.0%,40m
3797,2,Shrike,3847,0,1,0,1,100.0%,42m
3801,2,llllllllllll,3846,408,56,2,58,96.6%,21m
3801,1,[RDG]Dynamic,3846,90,3,7,10,30.0%,32m
3801,2,[C0METH]Dayman,3846,32,1,1,2,50.0%,16m
3801,2,OGPlyer,3846,30,1,1,2,50.0%,10m
3801,2,zzgodmodezz,3846,0,0,1,1,0.0%,33m
3806,1,Boba,3845,1793,198,190,388,51.0%,14m
3806,1,[PiGPan]LiterallyBis,3845,1567,78,74,152,51.3%,12m
3806,2,WhatsUP,3845,851,74,50,124,59.7%,30m
3806,1,[DarkAG]Nantrix,3845,206,6,5,11,54.5%,23m
3806,1,dmddo,3845,180,5,7,12,41.7%,37m
3806,2,gus,3845,102,3,2,5,60.0%,24m
3806,2,ACD,3845,0,1,0,1,100.0%,38m
3806,2,Formal,3845,0,1,1,2,50.0%,14m
3806,2,OhNoeS,3845,0,1,1,2,50.0%,36m
3815,1,[TSch]Trouble,3844,1266,58,58,116,50.0%,12m
3815,2,[WEEEEE]jam,3844,0,1,2,3,33.3%,6m
3815,2,[Igbt]Keris,3844,0,0,1,1,0.0%,27m
3815,2,RWBY,3844,0,0,1,1,0.0%,17m
3819,1,Nightcrawler,3843,1949,99,100,199,49.7%,28m
3819,2,loser,3843,562,21,15,36,58.3%,13m
3819,2,Mau,3843,382,15,1,16,93.8%,15m
3819,2,Delthius,3843,198,7,7,14,50.0%,43m
3819,2,[2faded]Random,3843,0,1,0,1,100.0%,42m
3819,2,[FIow]Jaxter,3843,0,1,0,1,100.0%,24m
3825,1,[SsaYnS]MiolO,3842,1146,37,32,69,53.6%,31m
3825,3,[RwtM]Arkenstone,3842,159,9,3,12,75.0%,6m
3827,1,[ZFz]AnUglyOkapi,3841,1956,132,135,267,49.4%,29m
3827,2,[Janna]CaNut,3841,1641,108,91,199,54.3%,17m
3827,1,Wildcard,3841,1329,60,55,115,52.2%,19m
3827,2,Cloudmuz,3841,261,14,6,20,70.0%,26m
3827,2,Kasatka,3841,216,6,8,14,42.9%,35m
3827,2,[TushAn]SooVation,3841,102,3,2,5,60.0%,17m
3827,2,[LTWAR]Saintdane,3841,0,2,0,2,100.0%,6m
3834,2,[5555]Zoundz,3840,1660,121,96,217,55.8%,25m
3834,1,[DJNKoo]Shako,3840,1122,31,35,66,47.0%,27m
3834,2,Kho,3840,668,26,24,50,52.0%,35m
3834,2,[αB]theepotatolo,3840,338,14,2,16,87.5%,5m
3834,2,ehdeelee,3840,188,6,3,9,66.7%,27m
3834,2,Stopcheesing,3840,98,4,3,7,57.1%,13m
3834,2,IIIIIIIIIII,3840,0,0,1,1,0.0%,8m
3841,1,[YD2K]mikeho,3839,1816,110,113,223,49.3%,12m
3841,2,Hennessey,3839,822,41,25,66,62.1%,18m
3841,2,[INextI]RagnaTuzad,3839,0,1,2,3,33.3%,8m
3841,2,FamousMChair,3839,0,0,1,1,0.0%,5m
3845,2,Deltron,3838,622,26,15,41,63.4%,35m
3845,2,IIIIIIIIIIII,3838,700,25,24,49,51.0%,21m
3845,2,Danca,3838,343,17,17,34,50.0%,9m
3845,2,[500CC]zzzawoyzzz,3838,140,5,4,9,55.6%,5m
3845,2,[DontRN]Anunnaki,3838,38,1,1,2,50.0%,43m
3850,2,[xAoDx]kkjk,3837,1658,113,90,203,55.7%,25m
3850,2,Tanagra,3837,1650,86,85,171,50.3%,16m
3850,1,huh,3837,833,31,21,52,59.6%,41m
3850,2,[Lp]SaCrOs,3837,616,21,20,41,51.2%,43m
3850,1,[VFam]lingfortyhrs,3837,721,17,36,53,32.1%,38m
3850,2,[NextDC]Sarasdrs,3837,402,13,18,31,41.9%,24m
3856,1,TakeToSky,3836,1319,461,450,911,50.6%,12m
3856,2,[DRKDMN]suhowiedooie,3836,96,4,1,5,80.0%,15m
3856,2,CtrlAltDfeat,3836,66,3,5,8,37.5%,6m
3856,2,matteo,3836,36,2,2,4,50.0%,13m
3860,1,Lockheed,3835,1629,232,225,457,50.8%,39m
3860,3,DangerNoodle,3835,574,39,66,105,37.1%,28m
3860,1,[LTlord]ZON,3835,580,31,22,53,58.5%,13m
3860,1,[ZTemp]pincher,3835,229,8,8,16,50.0%,12m
3860,2,SJSharkie,3835,176,6,1,7,85.7%,30m
3860,2,Shoegaze,3835,32,2,0,2,100.0%,41m
3860,2,Dreamer,3835,0,2,3,5,40.0%,4m
3860,1,Shibb,3835,46,1,16,17,5.9%,41m
3860,2,[ACM1TP]ZAZ,3835,0,0,1,1,0.0%,12m
3869,1,Forethought,3834,1978,236,235,471,50.1%,23m
3869,1,Problems,3834,906,63,65,128,49.2%,12m
3869,1,[pq]SaTivAs,3834,786,27,33,60,45.0%,37m
3869,2,[dLife]riflescout,3834,190,7,4,11,63.6%,22m
3869,2,Kingfisher,3834,36,2,1,3,66.7%,4m
3869,2,Vanish,3834,64,2,4,6,33.3%,3m
3869,2,[ØFoxF2]Boxco,3834,0,1,0,1,100.0%,15m
3869,2,Deezer,3834,32,1,2,3,33.3%,11m
3869,1,mgjgshxd,3834,0,1,4,5,20.0%,8m
3869,2,WeinerMcButt,3834,0,0,1,1,0.0%,5m
3869,2,Lanparty,3834,0,0,3,3,0.0%,27m
3880,1,DFTBA,3833,1902,124,124,248,50.0%,19m
3880,3,smartman,3833,239,12,4,16,75.0%,25m
3880,2,SirChristoff,3833,100,3,5,8,37.5%,26m
3880,2,TheGermster,3833,0,1,1,2,50.0%,8m
3880,2,[OOCG]xXCyClOnEXx,3833,0,0,1,1,0.0%,31m
3885,3,[FC]kale,3832,1654,256,287,543,47.1%,7m
3885,2,Tree,3832,1645,168,137,305,55.1%,38m
3885,2,Lantzuh,3832,1584,116,95,211,55.0%,27m
3885,2,[TGCrew]CholmesInk,3832,1234,52,54,106,49.1%,15m
3885,2,llllllllllll,3832,882,40,28,68,58.8%,43m
3885,2,Omer,3832,419,16,5,21,76.2%,28m
3885,1,[BiW]Illusion,3832,46,2,6,8,25.0%,14m
3885,2,Nickatak,3832,0,1,3,4,25.0%,14m
3893,1,CroNoS,3831,566,14,20,34,41.2%,31m
3893,2,[NZER0]Ghoul,3831,302,11,5,16,68.8%,27m
3893,2,Berg,3831,190,6,6,12,50.0%,30m
3893,2,[Makaze]FearLeSS,3831,0,1,0,1,100.0%,10m
3893,2,Gazedo,3831,0,0,1,1,0.0%,21m
3898,1,Herakleois,3830,1936,250,248,498,50.2%,12m
3898,1,GEFORCE,3830,1808,123,122,245,50.2%,11m
3898,3,UnoHaveMom,3830,193,6,1,7,85.7%,27m
3898,2,chelseafan,3830,125,4,4,8,50.0%,26m
3898,2,LDraGo,3830,0,0,1,1,0.0%,43m
3898,2,psychoz,3830,0,0,2,2,0.0%,28m
3904,2,Greenbob,3829,1239,48,44,92,52.2%,16m
3904,2,Syy,3829,552,20,18,38,52.6%,34m
3904,2,[inCo]Yuna,3829,32,2,1,3,66.7%,40m
3904,2,YouLoveMuta,3829,0,1,1,2,50.0%,10m
3904,1,aQu,3829,44,1,9,10,10.0%,36m
3904,3,[MIT]FAir,3829,2,1,16,17,5.9%,6m
3904,2,Somnolent,3829,0,0,1,1,0.0%,24m
3904,2,[NPhase]Parkson,3829,0,0,5,5,0.0%,41m
3912,2,llllllllll,3828,257,9,4,13,69.2%,27m
3912,2,llllllllllll,3828,170,5,2,7,71.4%,8m
3914,1,Miliaresis,3827,1966,212,207,419,50.6%,27m
3914,1,JordanJr,3827,1296,52,65,117,44.4%,9m
3914,1,TerdFerguson,3827,864,44,41,85,51.8%,11m
3914,3,PressZtoWin,3827,0,1,0,1,100.0%,5m
3914,2,Neemer,3827,0,0,1,1,0.0%,28m
3914,2,CheesWilaker,3827,0,0,1,1,0.0%,31m
3920,2,[xLgNx]ShadowLegion,3826,1648,252,245,497,50.7%,27m
3920,2,RimJaynor,3826,1659,205,198,403,50.9%,15m
3920,2,Seastream,3826,0,1,2,3,33.3%,18m
3920,3,YEEEEE,3826,0,0,1,1,0.0%,27m
3920,2,Elle,3826,0,0,2,2,0.0%,26m
3925,2,asamari,3825,344,14,10,24,58.3%,6m
3925,2,[GKat]VmC,3825,124,5,3,8,62.5%,16m
3927,2,[TGosuC]Limitless,3824,1658,450,408,858,52.4%,5m
3927,1,MiTom,3824,1391,73,61,134,54.5%,38m
3927,3,[N0ne]IIIIIIIIIIII,3824,97,2,5,7,28.6%,14m
3930,2,Pnas,3823,974,281,271,552,50.9%,41m
3930,2,Sen,3823,289,12,5,17,70.6%,18m
3930,2,Freeza,3823,214,8,4,12,66.7%,35m
3930,2,stifler,3823,72,3,6,9,33.3%,35m
3930,2,RobotWizard,3823,64,2,2,4,50.0%,3m
3930,2,MicroAngelo,3823,0,0,1,1,0.0%,19m
3936,1,woosh,3822,1950,305,298,603,50.6%,12m
3936,1,Nydhog,3822,1844,130,104,234,55.6%,11m
3936,1,[FaO]rhymestarr,3822,1940,90,96,186,48.4%,15m
3936,2,Orange,3822,1253,57,41,98,58.2%,4m
3936,2,DerFickerr,3822,335,14,11,25,56.0%,36m
3936,2,CYHwi,3822,124,4,8,12,33.3%,41m
3942,1,marmcode,3821,506,23,22,45,51.1%,27m
3942,2,Juse,3821,148,5,7,12,41.7%,7m
3942,2,MrBrightside,3821,0,0,3,3,0.0%,23m
3945,2,ALDASAM,3820,288,13,9,22,59.1%,14m
3945,2,Toasting,3820,348,12,12,24,50.0%,19m
3945,3,SIDINHO,3820,206,8,12,20,40.0%,9m
3945,1,[SSEAS]Ceicel,3820,346,8,15,23,34.8%,19m
3945,3,ArEgJiral,3820,0,1,0,1,100.0%,28m
3945,2,ArchaicForce,3820,0,0,3,3,0.0%,27m
3951,1,nonoseplace,3819,1946,164,171,335,49.0%,8m
3951,2,HighLach,3819,775,30,26,56,53.6%,16m
3951,2,SoShy,3819,594,25,15,40,62.5%,40m
3951,2,Wingless,3819,649,25,18,43,58.1%,30m
3951,1,BuzZer,3819,366,12,11,23,52.2%,41m
3951,2,sixbetfold,3819,260,9,5,14,64.3%,15m
3951,2,TRUMP,3819,72,2,5,7,28.6%,28m
3951,2,eXitiuM,3819,0,1,1,2,50.0%,26m
3951,2,Naf,3819,0,0,3,3,0.0%,27m
3960,1,Drex,3818,1887,136,134,270,50.4%,9m
3960,1,llllllllllll,3818,1552,110,115,225,48.9%,15m
3960,1,youngthug,3818,1874,66,65,131,50.4%,4m
3960,1,[GR33D]danyo,3818,775,21,26,47,44.7%,14m
3960,2,[NwAs]ESAAS,3818,446,15,16,31,48.4%,11m
3960,2,[RevAng]SHAORAN,3818,168,5,10,15,33.3%,13m
3960,1,tylerXMD,3818,182,4,14,18,22.2%,44m
3967,1,[EvilGC]MaxFire,3817,1586,93,93,186,50.0%,4m
3967,2,NUKLS,3817,1071,71,65,136,52.2%,23m
3967,2,[xRtG]HaHa,3817,1061,48,51,99,48.5%,4m
3967,2,IIIIIIIIIIII,3817,484,23,10,33,69.7%,26m
3967,2,[RUMB]TyDo,3817,396,16,5,21,76.2%,3m
3967,3,IIIIIIIIIIII,3817,223,9,6,15,60.0%,5m
3967,1,Wildmilf,3817,0,4,1,5,80.0%,5m
3967,2,[RBTH]Zura,3817,0,1,1,2,50.0%,30m
3967,3,Mawgan,3817,30,1,1,2,50.0%,5m
3967,3,[NPhase]AsIBreathe,3817,2,1,15,16,6.2%,30m
3967,2,YourDad,3817,0,0,1,1,0.0%,7m
3978,1,btang,3816,1864,321,323,644,49.8%,36m
3978,1,LAOTIAN,3816,1876,182,185,367,49.6%,12m
3978,1,Malupeyt,3816,1710,129,133,262,49.2%,17m
3978,2,llllllllllll,3816,380,18,7,25,72.0%,25m
3978,2,AglayanKek,3816,252,9,2,11,81.8%,13m
3978,2,MaMMoN,3816,147,7,4,11,63.6%,27m
3978,2,Rengard,3816,0,1,2,3,33.3%,41m
3978,2,koranskii,3816,0,0,1,1,0.0%,31m
3978,2,wabbajack,3816,0,0,1,1,0.0%,13m
3978,2,MarcouxxD,3816,0,0,1,1,0.0%,16m
3988,1,[TGosuB]AbathursOwn,3815,1963,319,328,647,49.3%,17m
3988,1,Cvidnineteen,3815,1811,66,71,137,48.2%,31m
3988,2,Wormh,3815,309,15,6,21,71.4%,43m
3988,2,yeunk,3815,130,4,7,11,36.4%,32m
3988,2,[BBBGun]Jayce,3815,66,2,1,3,66.7%,31m
3988,2,Patriarchy,3815,70,2,1,3,66.7%,3m
3988,2,[HWN]babybird,3815,0,0,1,1,0.0%,8m
3995,1,[sgnDK]angj,3814,826,31,35,66,47.0%,27m
3995,1,Yooshiii,3814,278,7,11,18,38.9%,9m
3997,2,Gaymer,3813,704,29,18,47,61.7%,12m
3997,3,giratina,3813,143,8,0,8,100.0%,32m
3997,2,ziPPie,3813,204,6,11,17,35.3%,21m
3997,2,Professor,3813,86,3,4,7,42.9%,15m
3997,2,Panchulon,3813,30,1,1,2,50.0%,36m
3997,2,[xNtG]Tasty,3813,0,0,1,1,0.0%,21m
3997,2,Nagirrek,3813,0,0,2,2,0.0%,19m
4004,2,[EZDUNK]DoubleEdge,3812,1658,485,487,972,49.9%,8m
4004,1,Sabre,3812,1336,195,207,402,48.5%,43m
4004,2,Sertorius,3812,1182,187,181,368,50.8%,21m
4004,1,[BGOK]Chickenman,3812,968,26,36,62,41.9%,34m
4004,2,[H3xPr0]Mwahaha,3812,310,11,11,22,50.0%,40m
4004,2,IIIIIIIIIIII,3812,251,9,4,13,69.2%,13m
4004,2,Force,3812,34,1,2,3,33.3%,15m
4004,2,[eX]Death,3812,0,0,1,1,0.0%,13m
4004,2,IlIlllIlIlll,3812,0,0,1,1,0.0%,19m
4004,2,[AmW]AmWDaMonkey,3812,0,0,3,3,0.0%,18m
4004,2,Zillah,3812,0,0,4,4,0.0%,18m
4015,1,XYU,3811,1867,60,76,136,44.1%,17m
4015,2,AluKarD,3811,1062,39,36,75,52.0%,6m
4015,2,Erebos,3811,260,16,5,21,76.2%,27m
4015,1,Poleman,3811,90,5,9,14,35.7%,39m
4015,2,[SoloAs]SoloNature,3811,68,2,6,8,25.0%,36m
4015,3,MadBadSad,3811,30,1,1,2,50.0%,26m
4015,2,NonGa,3811,34,1,3,4,25.0%,15m
4015,2,murK,3811,0,0,1,1,0.0%,8m
4023,1,Cocamaster,3810,1949,422,424,846,49.9%,11m
4023,1,Zerg,3810,1876,106,87,193,54.9%,4m
4023,2,Simple,3810,1186,63,52,115,54.8%,23m
4023,2,[fn1]fnicmogk,3810,686,26,17,43,60.5%,8m
4023,3,Rideout,3810,201,8,8,16,50.0%,42m
4023,2,VCERUSH,3810,158,6,1,7,85.7%,5m
4023,2,[POOiP]DarkArchon,3810,102,3,3,6,50.0%,8m
4023,2,[FFHOE]TwentyQueens,3810,0,1,0,1,100.0%,11m
4031,1,kaistar,3809,868,111,116,227,48.9%,18m
4031,2,cookieCrisp,3809,659,33,33,66,50.0%,7m
4031,2,Leviathan,3809,634,26,14,40,65.0%,7m
4031,2,[LTlord]ThePhoenix,3809,562,19,21,40,47.5%,21m
4031,2,Zilmerx,3809,0,1,0,1,100.0%,8m
4031,2,Airos,3809,0,1,0,1,100.0%,34m
4031,1,[lLiTl]Suspicious,3809,0,1,0,1,100.0%,14m
4031,2,Adapting,3809,0,0,3,3,0.0%,14m
4039,1,[Lp]GantZ,3808,1898,322,327,649,49.6%,14m
4039,1,froddparents,3808,1873,259,263,522,49.6%,27m
4039,2,[BRAP]Spyder,3808,453,22,15,37,59.5%,8m
4039,1,[cuteU]thwnqnfdkf,3808,270,7,30,37,18.9%,12m
4039,2,MelGibson,3808,200,6,12,18,33.3%,15m
4039,2,MasterChef,3808,0,0,3,3,0.0%,13m
4045,1,Badboy,3807,1462,92,90,182,50.5%,29m
4045,1,Brittany,3807,992,42,60,102,41.2%,38m
4045,2,[NeAs]ERNESTdrgn,3807,290,10,6,16,62.5%,14m
4045,2,Octane,3807,166,5,8,13,38.5%,40m
4045,2,ShrimpMoney,3807,170,5,10,15,33.3%,23m
4050,1,SmokingKiss,3806,1952,460,475,935,49.2%,14m
4050,1,[DhZPro]Rhapsody,3806,1907,119,123,242,49.2%,12m
4050,1,[NPhasA]Yaozer,3806,1240,101,97,198,51.0%,44m
4050,2,lIlIlIlIlIlI,3806,1580,76,67,143,53.1%,15m
4050,2,[iLLiad]Pockets,3806,675,37,33,70,52.9%,41m
4050,2,pookie,3806,680,23,29,52,44.2%,15m
4050,2,KevinHart,3806,494,22,12,34,64.7%,18m
4050,2,Sclera,3806,0,4,1,5,80.0%,23m
4050,2,BlueRare,3806,0,1,0,1,100.0%,32m
4050,2,[GGxC]thegreybush,3806,0,1,0,1,100.0%,35m
4050,2,[PTL]sGCross,3806,0,0,1,1,0.0%,13m
4061,2,[NPhasA]ATlien,3805,572,29,21,50,58.0%,7m
4061,2,[LgnTDS]shivi,3805,598,21,19,40,52.5%,16m
4061,1,PeraL,3805,610,15,26,41,36.6%,14m
4061,3,TylerDurden,3805,167,9,1,10,90.0%,8m
4061,2,Kinney,3805,180,6,7,13,46.2%,23m
4061,2,mayorill,3805,126,4,3,7,57.1%,16m
4061,2,[KingSC]Teio,3805,122,4,4,8,50.0%,16m
4061,2,[2TETON]akajon,3805,132,4,5,9,44.4%,16m
4061,3,[RUSHya]Kaizen,3805,0,0,2,2,0.0%,27m
4070,1,[BoRnGo]FuriouStyleS,3804,1726,115,119,234,49.1%,23m
4070,2,Papabear,3804,965,106,99,205,51.7%,38m
4070,2,chichobello,3804,1410,80,76,156,51.3%,15m
4070,3,Crossi,3804,238,12,3,15,80.0%,40m
4070,2,[NutN]Bergal,3804,198,8,3,11,72.7%,15m
4070,2,Corea,3804,147,3,1,4,75.0%,26m
4070,2,[FoAP]DancingHydra,3804,34,2,0,2,100.0%,32m
4070,2,[HIN]JetSetFive,3804,30,2,1,3,66.7%,10m
4070,2,Neutrino,3804,32,2,3,5,40.0%,24m
4070,2,Dbeast,3804,32,1,2,3,33.3%,19m
4070,2,PULSAR,3804,0,0,1,1,0.0%,16m
4070,2,[Pizzy]jarjarbinks,3804,0,0,1,1,0.0%,10m
4070,2,Talemar,3804,73,0,2,2,0.0%,19m
4083,1,Emokills,3803,1958,163,192,355,45.9%,5m
4083,2,[CATFUK]NOP,3803,362,60,55,115,52.2%,20m
4083,2,Mike,3803,987,53,42,95,55.8%,40m
4083,2,warfreak,3803,108,5,1,6,83.3%,15m
4083,2,Bartomeu,3803,68,2,5,7,28.6%,23m
4083,2,Paul,3803,0,0,2,2,0.0%,19m
4083,2,Morgano,3803,0,0,5,5,0.0%,38m
4090,2,rankggre,3802,507,34,32,66,51.5%,29m
4090,3,Yalos,3802,407,27,25,52,51.9%,5m
4090,2,Oberyn,3802,222,12,11,23,52.2%,41m
4090,3,[Kappa]Fishriot,3802,30,2,3,5,40.0%,17m
4090,2,[GxT]GreyHaven,3802,0,0,1,1,0.0%,19m
4090,2,GSound,3802,0,0,1,1,0.0%,27m
4096,2,FourKneeKate,3801,1222,952,914,1866,51.0%,8m
4096,1,FireWolf,3801,1899,128,120,248,51.6%,41m
4096,2,[LilHo]tehdoctor,3801,496,52,49,101,51.5%,40m
4096,2,Syvn,3801,424,16,11,27,59.3%,4m
4096,2,[MLPog]Astealthyko,3801,213,6,5,11,54.5%,38m
4096,2,[JaMiT]LVMatterhorn,3801,176,6,9,15,40.0%,13m
4096,2,kobe,3801,92,4,4,8,50.0%,42m
4096,2,StiflersMoms,3801,0,0,1,1,0.0%,30m
4104,1,[VanLGD]ShanaY,3800,1922,108,105,213,50.7%,19m
4104,1,Noodle,3800,502,23,13,36,63.9%,28m
4104,2,[GRDN]Rotini,3800,232,8,6,14,57.1%,8m
4104,3,IIIIIIIIIIII,3800,212,7,0,7,100.0%,26m
4104,2,[xRtG]Rainforest,3800,152,6,4,10,60.0%,42m
4104,2,icup,3800,0,1,1,2,50.0%,10m
4104,3,ANnihilatioN,3800,0,0,1,1,0.0%,22m
4104,2,freshsashimi,3800,0,0,1,1,0.0%,31m
4104,2,[SNIP]retseW,3800,0,0,3,3,0.0%,10m
4113,2,bege,3799,1601,547,528,1075,50.9%,31m
4113,1,[Xpk]DaggothC,3799,1908,127,124,251,50.6%,41m
4113,3,HarlemTron,3799,228,10,0,10,100.0%,22m
4113,2,[SmokeH]Ralfrahl,3799,150,6,5,11,54.5%,39m
4117,2,[RolIin]Clown,3798,1559,130,108,238,54.6%,37m
4117,1,[VFam]Rayvn,3798,1663,102,100,202,50.5%,30m
4117,1,[UpeV]Shadw,3798,527,18,23,41,43.9%,18m
4117,2,MechItHappen,3798,186,6,6,12,50.0%,43m
4117,2,Waawaatatata,3798,0,1,3,4,25.0%,4m
4117,2,Cloud,3798,0,0,1,1,0.0%,6m
4123,2,Vofman,3797,213,82,74,156,52.6%,32m
4123,2,MGS,3797,953,65,69,134,48.5%,24m
4123,2,[421]Tyho,3797,528,55,50,105,52.4%,16m
4123,2,GhostDog,3797,698,27,26,53,50.9%,6m
4123,2,[LoveTE]JesuRocks,3797,266,8,12,20,40.0%,21m
4123,2,[NotEQ]InEquality,3797,0,1,0,1,100.0%,26m
4123,2,[TFAsc]Tikihut,3797,0,0,2,2,0.0%,23m
4130,2,Markuspolo,3796,1130,237,222,459,51.6%,26m
4130,2,[EtrOy]synapse,3796,577,41,28,69,59.4%,24m
4130,1,Emu,3796,785,36,46,82,43.9%,43m
4130,2,[SydTT]ByuN,3796,660,26,15,41,63.4%,23m
4130,2,cricketstomp,3796,270,10,5,15,66.7%,13m
4130,2,[BLNT]TehBorg,3796,139,5,3,8,62.5%,9m
4130,2,[PForce]cooljake,3796,134,4,7,11,36.4%,10m
4130,2,[Op]Justis,3796,62,3,2,5,60.0%,8m
4130,2,[Toker]PuffSwishers,3796,60,2,4,6,33.3%,4m
4130,2,[CRMAIK]Maik,3796,0,1,0,1,100.0%,19m
4140,2,Sandman,3795,882,54,55,109,49.5%,4m
4140,2,llllllllllll,3795,666,42,43,85,49.4%,26m
4140,1,[TeamUR]Parka,3795,920,25,33,58,43.1%,12m
4140,3,[HAAAAI]MiaTheDog,3795,90,4,4,8,50.0%,8m
4140,2,[KingSC]NotABeaver,3795,106,3,8,11,27.3%,12m
4145,2,SmiffyBagels,3794,429,31,33,64,48.4%,24m
4145,2,[SMB]WEALTH,3794,424,22,23,45,48.9%,16m
4145,2,IIIIIIIIIIII,3794,474,17,15,32,53.1%,28m
4145,2,Xhris,3794,82,5,11,16,31.2%,6m
4145,2,ipxC,3794,60,3,2,5,60.0%,30m
4150,2,Vas,3793,538,21,20,41,51.2%,27m
4150,2,WESG,3793,322,14,9,23,60.9%,42m
4150,2,[TSØP]BriKc,3793,140,4,6,10,40.0%,16m
4150,3,ozoncraft,3793,86,3,2,5,60.0%,23m
4150,2,CochiPlz,3793,30,1,3,4,25.0%,34m
4150,2,[VENSC2]Husky,3793,0,0,1,1,0.0%,9m
4156,1,[neuroW]Kewlbum,3792,941,289,287,576,50.2%,13m
4156,1,[badzrg]NaN,3792,1934,250,263,513,48.7%,11m
4156,3,[SsaYnS]JiaoBaBa,3792,1770,213,212,425,50.1%,6m
4156,1,[C80585]AvilosArmy,3792,1845,144,131,275,52.4%,9m
4156,2,[Fr33ze]AodemiYuki,3792,663,36,25,61,59.0%,19m
4156,2,vicO,3792,0,1,0,1,100.0%,38m
4162,1,[KoopaZ]Maleficent,3791,1927,102,108,210,48.6%,28m
4162,2,PWLMusic,3791,1476,77,69,146,52.7%,30m
4162,2,[UCI]NaoKyan,3791,770,46,41,87,52.9%,27m
4162,2,GDOG,3791,124,5,5,10,50.0%,8m
4162,3,tokyo,3791,90,4,7,11,36.4%,30m
4162,3,RettenetOnFi,3791,0,3,3,6,50.0%,8m
4162,2,gnowelyk,3791,92,3,7,10,30.0%,15m
4162,3,Phish,3791,0,1,1,2,50.0%,16m
4162,2,[Ris3n]Koda,3791,0,0,4,4,0.0%,15m
4171,2,BTS,3790,939,119,84,203,58.6%,13m
4171,2,Soulske,3790,742,28,22,50,56.0%,43m
4171,2,[gohchu]yubang,3790,118,5,6,11,45.5%,43m
4171,2,Moonlight,3790,64,3,3,6,50.0%,28m
4171,2,[NEFN]Pollux,3790,32,1,2,3,33.3%,11m
4171,2,EkajArmstro,3790,0,0,1,1,0.0%,15m
4177,2,STEALTH,3789,1591,210,199,409,51.3%,32m
4177,2,Kylobe,3789,1090,70,57,127,55.1%,11m
4177,2,ZergWeed,3789,431,20,10,30,66.7%,42m
4177,2,[ripBW]DocHoliday,3789,158,6,5,11,54.5%,4m
4177,2,Stephano,3789,154,6,5,11,54.5%,10m
4177,2,IShoeU,3789,110,3,8,11,27.3%,14m
4183,2,[Sena]MassiveAir,3788,1050,39,37,76,51.3%,24m
4183,2,ZomBie,3788,410,16,9,25,64.0%,10m
4183,2,Putti,3788,268,11,5,16,68.8%,24m
4183,3,ForbZ,3788,60,2,5,7,28.6%,17m
4183,3,Nematocyst,3788,0,0,1,1,0.0%,25m
4183,2,Goku,3788,0,0,1,1,0.0%,36m
4189,1,[LoveMM]Slugalisk,3787,1896,435,427,862,50.5%,19m
4189,2,JayWhyThree,3787,982,405,386,791,51.2%,39m
4189,1,CyanideByte,3787,625,17,21,38,44.7%,23m
4189,2,Spinozah,3787,364,13,17,30,43.3%,35m
4189,2,[iDrunk]Benevolence,3787,243,11,9,20,55.0%,4m
4189,2,[EZDUNK]GuyInTheChat,3787,276,10,10,20,50.0%,15m
4189,1,[xNtG]GuK,3787,318,7,20,27,25.9%,15m
4189,2,Giphertius,3787,160,5,6,11,45.5%,26m
4189,2,[NLTN]MrSnugglez,3787,90,3,6,9,33.3%,15m
4189,3,Specialist,3787,0,1,0,1,100.0%,22m
4189,2,[DRKFOX]Apothenes,3787,0,1,6,7,14.3%,35m
4189,2,Dauntless,3787,0,0,1,1,0.0%,35m
4189,2,[Gudr]Danberg,3787,0,0,1,1,0.0%,29m
4189,2,[Th3Bad]matheusT,3787,0,0,2,2,0.0%,16m
4203,2,[TPL]cecilroc,3786,1157,49,37,86,57.0%,10m
4203,2,Lazy,3786,419,17,6,23,73.9%,42m
4203,2,llll,3786,32,2,0,2,100.0%,4m
4203,2,xjohtox,3786,34,2,1,3,66.7%,29m
4203,2,[InGt]Fig,3786,0,0,1,1,0.0%,35m
4208,2,[TGosuC]FuriousDroid,3785,1641,442,431,873,50.6%,18m
4208,2,[kØ]Huasozerlin,3785,1032,157,144,301,52.2%,11m
4208,1,Scribe,3785,747,58,67,125,46.4%,21m
4208,3,abcd,3785,165,5,0,5,100.0%,12m
4208,2,Dudleydino,3785,62,3,2,5,60.0%,6m
4208,2,Trapper,3785,0,1,0,1,100.0%,9m
4208,2,[5CaRy]BogaS,3785,0,1,6,7,14.3%,29m
4208,1,BuDz,3785,0,1,9,10,10.0%,43m
4208,2,[Frnzy]Silver,3785,0,0,2,2,0.0%,16m
4217,1,wurzelsepp,3784,1905,325,325,650,50.0%,10m
4217,2,Doozer,3784,636,28,15,43,65.1%,30m
4217,3,Edraxima,3784,233,12,1,13,92.3%,33m
4217,2,RiseAgainst,3784,96,3,3,6,50.0%,35m
4217,2,Kainz,3784,0,1,0,1,100.0%,5m
4217,2,[1vsM]acoolguy,3784,0,0,1,1,0.0%,34m
4217,2,killjoy,3784,0,0,2,2,0.0%,4m
4224,2,AcontGG,3783,1450,79,70,149,53.0%,12m
4224,1,TheHaars,3783,927,47,58,105,44.8%,18m
4224,2,Reformed,3783,387,23,22,45,51.1%,43m
4224,2,[WTZ]ZugZagZug,3783,374,14,14,28,50.0%,15m
4224,2,[CHEZME]DiZ,3783,216,8,4,12,66.7%,10m
4224,2,IDKWTS,3783,58,7,0,7,100.0%,6m
4224,1,[Cryptc]CyStorm,3783,182,4,12,16,25.0%,18m
4224,2,[BearMe]Siegfried,3783,94,3,2,5,60.0%,26m
4224,2,River,3783,125,2,4,6,33.3%,5m
4233,1,Darwin,3782,1897,504,478,982,51.3%,17m
4233,1,[oLCi]GoodbyeKitty,3782,1643,280,284,564,49.6%,15m
4233,2,Sai,3782,935,166,167,333,49.8%,41m
4233,2,[VetZCo]Barx,3782,1552,118,108,226,52.2%,30m
4233,1,IIIIIScanner,3782,1930,105,116,221,47.5%,21m
4233,2,[TGosuD]eggroll,3782,386,17,8,25,68.0%,25m
4233,2,fog,3782,341,16,5,21,76.2%,35m
4233,3,Aurumai,3782,150,10,6,16,62.5%,33m
4233,2,llllllllllll,3782,60,7,0,7,100.0%,10m
4242,2,[Wrs]NeoGeo,3781,1550,159,153,312,51.0%,15m
4242,2,[GPLz]genious,3781,1380,53,53,106,50.0%,43m
4242,1,[G0Iden]OmoteNashi,3781,886,27,27,54,50.0%,12m
4242,2,[Swage]Invux,3781,730,26,28,54,48.1%,34m
4242,2,StinkyBrain,3781,176,10,5,15,66.7%,18m
4242,2,[αB]noobling,3781,156,5,5,10,50.0%,25m
4242,2,RonDamon,3781,0,1,0,1,100.0%,11m
4242,2,Lmoses,3781,0,0,2,2,0.0%,24m
4242,2,Tweasy,3781,0,0,4,4,0.0%,38m
4251,1,microjr,3780,1903,260,256,516,50.4%,44m
4251,1,Ludo,3780,1543,155,165,320,48.4%,9m
4251,1,LLegacies,3780,1823,96,110,206,46.6%,39m
4251,2,[proXG]AvengedFenix,3780,893,79,73,152,52.0%,40m
4251,1,noobprime,3780,1284,50,52,102,49.0%,8m
4251,3,[ChaSux]Dozer,3780,30,2,6,8,25.0%,27m
4251,2,Rocktopus,3780,0,0,1,1,0.0%,16m
4258,1,[TXOP]TroNko,3779,1455,47,46,93,50.5%,10m
4258,2,Largo,3779,540,20,19,39,51.3%,43m
4258,2,Mad,3779,116,5,1,6,83.3%,10m
4258,2,NormCharlton,3779,0,0,1,1,0.0%,42m
4258,2,zgv,3779,0,0,2,2,0.0%,9m
4263,2,[PGoose]PurpleGoose,3778,865,68,64,132,51.5%,14m
4263,2,[ZTempz]GameofDrones,3778,821,32,26,58,55.2%,8m
4263,1,[CHAKA]Drowsy,3778,544,15,24,39,38.5%,9m
4263,1,[SsaYnS]Zealot,3778,0,4,1,5,80.0%,34m
4263,2,Recks,3778,0,0,1,1,0.0%,7m
4263,2,[BaconP]Superlemons,3778,0,0,1,1,0.0%,4m
4269,2,[Fir3s]HomeTownCrib,3777,1257,69,43,112,61.6%,10m
4269,1,SandyCheeks,3777,127,7,5,12,58.3%,44m
4269,2,[knewbe]LlLl,3777,168,6,7,13,46.2%,26m
4269,2,Reapergv,3777,0,1,0,1,100.0%,5m
4269,3,Ryan,3777,0,0,1,1,0.0%,12m
4269,2,ZChen,3777,0,0,1,1,0.0%,37m
4275,2,[ØÛ]StartinHP,3776,817,58,37,95,61.1%,23m
4275,2,IlIlIlIlIl,3776,544,22,16,38,57.9%,23m
4275,1,zxcvf,3776,913,22,28,50,44.0%,42m
4275,2,Fallenangel,3776,47,4,2,6,66.7%,18m
4275,2,[EZkill]RubyNinja,3776,126,4,2,6,66.7%,26m
4275,2,GgMaChine,3776,30,2,0,2,100.0%,15m
4275,2,[Cryptc]Silvertone,3776,0,1,0,1,100.0%,11m
4275,2,[Namzug]JRMeister,3776,0,1,0,1,100.0%,41m
4275,2,[AD3C]CuBaNo,3776,0,0,1,1,0.0%,6m
4275,2,AcerHMG,3776,0,0,1,1,0.0%,35m
4285,2,Mech,3775,1595,227,219,446,50.9%,41m
4285,2,dirtyplayer,3775,817,35,24,59,59.3%,23m
4285,2,[ArGNA]universe,3775,96,3,8,11,27.3%,6m
4285,2,[TITSQ]AprilRyanTT,3775,0,1,0,1,100.0%,27m
4285,2,Zeikoth,3775,73,1,1,2,50.0%,6m
4290,2,ipopon,3774,1092,160,153,313,51.1%,39m
4290,2,Sego,3774,268,9,12,21,42.9%,6m
4290,2,Baka,3774,64,3,1,4,75.0%,6m
4290,2,Architorture,3774,0,2,3,5,40.0%,24m
4290,2,Snake,3774,0,1,0,1,100.0%,12m
4290,2,eimang,3774,0,1,0,1,100.0%,30m
4296,2,LyriC,3773,1048,55,54,109,50.5%,27m
4296,2,MostDope,3773,744,39,26,65,60.0%,36m
4296,3,TerranStrAt,3773,122,4,4,8,50.0%,35m
4296,2,[Gh0std]KobesPilotGG,3773,38,2,1,3,66.7%,28m
4296,2,IIIIRyanIIII,3773,0,1,0,1,100.0%,24m
4296,2,Plex,3773,30,1,1,2,50.0%,38m
4296,2,[EGx]Zorg,3773,0,0,1,1,0.0%,39m
4296,2,[HØST]TaoPaiPai,3773,0,0,1,1,0.0%,34m
4296,2,[Alpaka]Nordy,3773,0,0,1,1,0.0%,41m
4305,1,[Minzy]AwkwardPanda,3772,1881,314,301,615,51.1%,44m
4305,2,Alucard,3772,1080,67,44,111,60.4%,23m
4305,2,Furnace,3772,817,45,29,74,60.8%,36m
4305,2,tutter,3772,748,34,17,51,66.7%,25m
4305,2,Lunar,3772,690,30,21,51,58.8%,18m
4305,2,Omni,3772,597,26,16,42,61.9%,43m
4305,2,NPC,3772,392,13,17,30,43.3%,13m
4305,2,lxlGlacier,3772,0,1,0,1,100.0%,34m
4305,2,Backpack,3772,38,1,2,3,33.3%,23m
4305,2,[NerfMe]BigLunch,3772,30,1,5,6,16.7%,12m
4305,2,Jestin,3772,0,0,1,1,0.0%,23m
4305,2,[NwAs]Tohara,3772,0,0,1,1,0.0%,15m
4317,1,DrRotinaj,3771,1551,171,175,346,49.4%,9m
4317,2,[VDZ]Phinix,3771,1318,73,73,146,50.0%,43m
4317,2,[TGosuD]hohner,3771,1044,40,36,76,52.6%,28m
4317,2,Hoiinks,3771,908,36,27,63,57.1%,10m
4317,1,[lNI]Soysauce,3771,986,29,42,71,40.8%,23m
4317,2,PurpleGoose,3771,488,22,13,35,62.9%,15m
4317,2,satiety,3771,274,9,10,19,47.4%,24m
4317,2,[sk3tch]MegaDancerZF,3771,36,2,3,5,40.0%,15m
4317,2,PincheTaco,3771,32,1,2,3,33.3%,18m
4317,2,Maximus,3771,0,0,1,1,0.0%,19m
4317,2,Torrent,3771,0,0,1,1,0.0%,10m
4317,2,Finrod,3771,0,0,1,1,0.0%,35m
4329,2,FatalglorY,3770,1456,162,170,332,48.8%,10m
4329,1,Rustypipe,3770,1875,147,153,300,49.0%,27m
4329,2,[TGosuA]OtterFamily,3770,1571,115,106,221,52.0%,11m
4329,2,Milotnuis,3770,846,30,30,60,50.0%,23m
4329,2,IIlllIIIlIIl,3770,296,11,9,20,55.0%,6m
4329,2,[PRB4SL]MrBooze,3770,338,10,12,22,45.5%,10m
4329,2,[UCLA]QiQi,3770,222,8,10,18,44.4%,32m
4329,3,Relax,3770,97,2,0,2,100.0%,9m
4329,2,BastionMain,3770,0,0,2,2,0.0%,32m
4338,1,[YD2K]Holyfire,3769,1901,604,601,1205,50.1%,12m
4338,2,[SsaYnS]clutchmaster,3769,958,183,168,351,52.1%,13m
4338,1,[NwAs]Focus,3769,1828,73,72,145,50.3%,33m
4338,2,Hello,3769,602,26,14,40,65.0%,26m
4338,1,YalaovanKing,3769,480,12,18,30,40.0%,10m
4338,2,[LingOP]Logarithmia,3769,34,2,2,4,50.0%,10m
4338,2,[αXi]Danotory,3769,0,0,1,1,0.0%,27m
4338,2,Lalugi,3769,0,0,2,2,0.0%,25m
4338,2,lllllllllll,3769,0,0,6,6,0.0%,15m
4347,1,[SC2IDN]tempefly,3768,1833,222,217,439,50.6%,44m
4347,2,[Pig2]Permaphrost,3768,1480,63,62,125,50.4%,8m
4347,2,vhapteR,3768,986,59,46,105,56.2%,13m
4347,1,[MSFT]Lyte,3768,1068,58,66,124,46.8%,39m
4347,2,GuiLLe,3768,834,56,55,111,50.5%,27m
4347,2,[PSlSTC]Minimoog,3768,1240,53,44,97,54.6%,23m
4347,1,Dcru,3768,560,23,20,43,53.5%,38m
4347,2,ibot,3768,202,6,9,15,40.0%,13m
4347,2,TankSinatrA,3768,60,3,3,6,50.0%,43m
4356,1,snoeklepel,3767,1564,134,102,236,56.8%,13m
4356,2,IIIIIIIIIIII,3767,476,29,27,56,51.8%,32m
4356,2,McCrazy,3767,636,22,22,44,50.0%,27m
4356,2,Quim,3767,219,20,14,34,58.8%,13m
4356,2,Kelkun,3767,298,11,7,18,61.1%,13m
4356,1,LeSorHaiChap,3767,340,8,16,24,33.3%,30m
4356,2,CppMaster,3767,119,7,0,7,100.0%,6m
4356,3,[TM]NMxTien,3767,18,1,9,10,10.0%,27m
4356,2,Buggax,3767,0,0,1,1,0.0%,24m
4365,2,DrIKEA,3766,609,97,84,181,53.6%,13m
4365,2,Bugaga,3766,1193,89,78,167,53.3%,16m
4365,2,[VFam]Hozle,3766,963,69,74,143,48.3%,32m
4365,2,Boop,3766,966,35,36,71,49.3%,13m
4365,2,BuyBitcoin,3766,214,12,1,13,92.3%,16m
4365,1,Chime,3766,344,7,16,23,30.4%,27m
4365,2,[PMT]spinnercat,3766,145,3,2,5,60.0%,20m
4372,1,Metamyth,3765,1898,160,146,306,52.3%,28m
4372,2,[XIV]RapidXIV,3765,188,7,10,17,41.2%,35m
4372,2,[Fellaz]Galigus,3765,0,1,0,1,100.0%,41m
4372,2,[MSUsc2]SpiKeYMaN,3765,0,0,2,2,0.0%,30m
4376,1,[SuperZ]HAL,3764,1912,365,426,791,46.1%,18m
4376,2,Seefour,3764,1640,261,225,486,53.7%,30m
4376,2,MasterFree,3764,1127,109,96,205,53.2%,35m
4376,2,[LCE]JuanManuel,3764,802,33,25,58,56.9%,36m
4376,2,Slade,3764,296,16,9,25,64.0%,40m
4376,3,[Kaiba]FlyingZebra,3764,193,10,2,12,83.3%,27m
4376,2,[TeamUR]Stifle,3764,206,6,12,18,33.3%,10m
4376,1,[MilkIt]Odin,3764,273,6,13,19,31.6%,28m
4376,2,grotesQue,3764,66,3,2,5,60.0%,10m
4376,2,[TGosuC]Dogfobmal,3764,0,0,1,1,0.0%,20m
4376,2,xoxoAvaay,3764,0,0,1,1,0.0%,15m
4387,2,SwarmCore,3763,1396,112,65,177,63.3%,6m
4387,2,[1E100]whoyou,3763,1514,97,80,177,54.8%,27m
4387,1,Auron,3763,770,53,73,126,42.1%,43m
4387,2,yourwifesson,3763,715,34,18,52,65.4%,13m
4387,1,Raventhirst,3763,215,8,8,16,50.0%,9m
4387,2,[BLMBLM]Justice,3763,182,7,8,15,46.7%,6m
4387,2,MightyMuffin,3763,30,1,2,3,33.3%,15m
4387,2,Sireynn,3763,0,0,1,1,0.0%,43m
4387,3,[ZTempz]Zara,3763,0,0,3,3,0.0%,42m
4396,2,NotinMKSens,3762,374,17,9,26,65.4%,35m
4396,2,[WBDS]KETHarsIs,3762,386,13,13,26,50.0%,43m
4396,3,Kalaim,3762,189,10,2,12,83.3%,30m
4396,2,[FVCKIN]EagleWarrior,3762,32,2,2,4,50.0%,14m
4396,2,Giskard,3762,62,2,4,6,33.3%,25m
4396,1,[TGosuA]Burrell,3762,0,1,0,1,100.0%,23m
4396,2,HUMMINGBIRD,3762,0,0,1,1,0.0%,42m
4396,2,[cl0udM]gRiT,3762,0,0,1,1,0.0%,43m
4404,2,nime,3761,1580,178,163,341,52.2%,23m
4404,2,[JUIN]GrapeDrank,3761,353,23,13,36,63.9%,43m
4404,2,frankonatank,3761,626,21,25,46,45.7%,4m
4404,2,[CUWisc]Brang,3761,274,9,13,22,40.9%,42m
4404,3,SHSX,3761,121,3,0,3,100.0%,25m
4404,2,Kibbelz,3761,0,0,1,1,0.0%,10m
4410,2,[DarkAG]zelkova,3760,1558,321,311,632,50.8%,43m
4410,1,Crow,3760,1334,68,78,146,46.6%,30m
4410,2,[xBoA]Gentasu,3760,1031,44,39,83,53.0%,32m
4410,2,Ramenman,3760,1042,39,37,76,51.3%,25m
4410,2,RoachReggae,3760,787,34,37,71,47.9%,12m
4410,2,[LGF]GaMeOfDrOnEs,3760,454,16,16,32,50.0%,15m
4410,1,ARCH,3760,634,15,31,46,32.6%,42m
4410,1,DeAdMau,3760,216,6,17,23,26.1%,15m
4410,2,XrayShadow,3760,116,3,10,13,23.1%,10m
4410,2,SendHelp,3760,32,1,7,8,12.5%,24m
4410,2,[oJKo]IShatMyself,3760,0,0,2,2,0.0%,29m
4410,2,Quarantine,3760,0,0,5,5,0.0%,41m
4422,2,KRzombie,3759,1621,122,120,242,50.4%,41m
4422,2,[TACTEC]awfulplayer,3759,1560,110,45,155,71.0%,7m
4422,2,[GGxC]NissanZOwner,3759,379,46,36,82,56.1%,36m
4422,1,[LgnTDS]Shrix,3759,1166,39,37,76,51.3%,29m
4422,2,Evenstar,3759,128,4,9,13,30.8%,10m
4422,2,MeemoSaan,3759,0,0,1,1,0.0%,10m
4422,2,[EndPro]BMTH,3759,0,0,1,1,0.0%,19m
4429,1,ChildPlease,3758,1935,173,180,353,49.0%,14m
4429,1,Magus,3758,1783,73,86,159,45.9%,18m
4429,1,[UpeV]Papezinhoo,3758,1467,40,60,100,40.0%,28m
4429,2,jarsoffart,3758,810,31,28,59,52.5%,13m
4429,2,[TGosuC]Maliss,3758,160,5,9,14,35.7%,6m
4429,2,fatboinbox,3758,88,4,3,7,57.1%,10m
4429,2,Droptuned,3758,62,3,3,6,50.0%,15m
4436,1,[LimaSC]bto,3757,1884,279,281,560,49.8%,41m
4436,2,Stroker,3757,1614,180,144,324,55.6%,26m
4436,1,[SsaYnS]Goku,3757,1442,113,121,234,48.3%,13m
4436,2,XenomorpH,3757,1379,101,89,190,53.2%,35m
4436,2,WiLLiAMS,3757,904,53,25,78,67.9%,28m
4436,2,ReVenGeRAG,3757,150,9,1,10,90.0%,34m
4436,2,[SsaYnS]James,3757,0,0,1,1,0.0%,6m
4436,2,SuNsEtBaLlIn,3757,0,0,3,3,0.0%,5m
4436,2,[Ok]Smedley,3757,0,0,6,6,0.0%,36m
4445,2,Kelemvor,3756,1426,122,129,251,48.6%,13m
4445,1,TheDoctor,3756,1885,102,112,214,47.7%,19m
4445,2,Derp,3756,888,36,27,63,57.1%,25m
4445,2,KorbenDallas,3756,306,10,16,26,38.5%,13m
4445,2,[UpeV]WaLas,3756,142,5,2,7,71.4%,15m
4445,2,Lavina,3756,36,2,7,9,22.2%,11m
4445,2,[COPD]YOUNGJUN,3756,0,1,0,1,100.0%,13m
4445,2,JebGetsCrunk,3756,0,0,5,5,0.0%,30m
4453,2,llllllllllll,3755,1622,134,47,181,74.0%,13m
4453,1,Cheno,3755,1746,80,76,156,51.3%,11m
4453,1,Bedsoap,3755,1186,69,79,148,46.6%,43m
4453,2,Zergdo,3755,0,1,0,1,100.0%,34m
4453,2,[F4R7Z]IIIIIIIIIIII,3755,30,1,2,3,33.3%,13m
4453,2,[Tao]BadCop,3755,0,0,1,1,0.0%,30m
4459,2,Jimothy,3754,1607,242,242,484,50.0%,8m
4459,2,sjelkjd,3754,1558,131,123,254,51.6%,27m
4459,2,Homelander,3754,1447,84,29,113,74.3%,8m
4459,1,BuyBitcoin,3754,370,17,9,26,65.4%,37m
4459,2,[SuperZ]FoCuS,3754,286,10,11,21,47.6%,25m
4459,1,[GR33D]Zonex,3754,145,4,0,4,100.0%,5m
4459,2,Sufferling,3754,0,1,2,3,33.3%,26m
4466,1,Darkloar,3753,1845,373,365,738,50.5%,44m
4466,1,[αXLa]Fox,3753,1789,171,175,346,49.4%,8m
4466,1,[XpKb]CrisderKill,3753,1442,93,80,173,53.8%,31m
4466,2,Litsville,3753,318,10,14,24,41.7%,43m
4466,2,EmTee,3753,0,0,2,2,0.0%,13m
4466,2,[RLR0]Chain,3753,0,0,3,3,0.0%,40m
4472,2,beanLing,3752,1611,243,213,456,53.3%,25m
4472,2,StarkLord,3752,1662,240,212,452,53.1%,43m
4472,2,TheFatShorts,3752,1598,200,204,404,49.5%,18m
4472,2,drunkencharm,3752,845,138,128,266,51.9%,30m
4472,2,IIIIIIIIIIII,3752,58,5,2,7,71.4%,35m
4472,2,[MSUsc2]Justy,3752,0,0,1,1,0.0%,15m
4472,2,[Flacyd]NatPort,3752,0,0,1,1,0.0%,15m
4479,1,[Ris3n]Rycerj,3751,1523,52,56,108,48.1%,6m
4479,2,Ekert,3751,512,18,17,35,51.4%,8m
4479,2,Korty,3751,277,14,4,18,77.8%,35m
4479,2,CKCK,3751,372,13,21,34,38.2%,19m
4479,2,Bobfatty,3751,0,1,0,1,100.0%,7m
4479,3,[SCTR]CapMurica,3751,0,1,1,2,50.0%,28m
4479,2,[420z]MauiWaui,3751,30,1,7,8,12.5%,30m
4479,2,[BmJn]BombJin,3751,0,0,1,1,0.0%,5m
4479,2,llllllllllll,3751,0,0,1,1,0.0%,4m
4479,2,[AUTlST]hai,3751,73,0,3,3,0.0%,42m
4489,2,[TGosuA]HandyCup,3750,394,14,12,26,53.8%,15m
4489,2,[TGCF]MarcoMan,3750,112,4,8,12,33.3%,41m
4489,2,[OEF]Carnage,3750,0,1,0,1,100.0%,10m
4489,2,[MnM]DirtyProtoss,3750,30,1,1,2,50.0%,15m
4493,2,Lennek,3749,1380,131,122,253,51.8%,8m
4493,2,[Ex7rA]Chaos,3749,1477,120,114,234,51.3%,8m
4493,2,Cloudkicker,3749,226,31,18,49,63.3%,18m
4493,2,Yoxs,3749,386,18,9,27,66.7%,35m
4493,2,Roasted,3749,142,6,1,7,85.7%,4m
4493,2,[αX]Veritas,3749,152,5,4,9,55.6%,4m
4493,2,Statiko,3749,0,1,0,1,100.0%,13m
4493,2,[theBSL]Sin,3749,30,1,6,7,14.3%,7m
4501,1,ShingDingz,3748,1890,409,415,824,49.6%,39m
4501,1,[FkJeff]morning,3748,1844,228,245,473,48.2%,43m
4501,2,VanillaLove,3748,974,52,42,94,55.3%,8m
4501,2,overmind,3748,1005,38,46,84,45.2%,11m
4501,2,[MBQ]BoukarDiouf,3748,926,35,33,68,51.5%,8m
4501,2,CovidVirus,3748,0,1,0,1,100.0%,30m
4501,2,[3XR]WardOTR,3748,0,1,2,3,33.3%,18m
4501,2,South,3748,0,0,1,1,0.0%,24m
4501,3,[Ikar0s]ExecutorFil,3748,0,0,1,1,0.0%,43m
4510,2,[C0L0R]Suitcase,3747,1309,162,148,310,52.3%,41m
4510,2,[MALCMX]OprahWinfrey,3747,1371,72,38,110,65.5%,19m
4510,2,Chamsae,3747,204,11,2,13,84.6%,8m
4510,2,[gg8778]ReAdjust,3747,108,4,7,11,36.4%,10m
4510,2,[BoRnGo]Joeypow,3747,60,3,4,7,42.9%,7m
4510,2,[TeamA1]AlcazarB,3747,0,0,2,2,0.0%,25m
4510,3,Cxteam,3747,0,0,2,2,0.0%,30m
4510,2,SovietToast,3747,0,0,3,3,0.0%,26m
4518,2,[fdtn23]westhebest,3746,322,12,11,23,52.2%,20m
4518,3,Faust,3746,145,3,2,5,60.0%,4m
4518,1,VeNGeaNcE,3746,0,1,0,1,100.0%,23m
4518,2,infamousbob,3746,30,1,1,2,50.0%,21m
4522,1,[DarkAG]Red,3745,1749,100,100,200,50.0%,10m
4522,2,PROMASTER,3745,154,6,10,16,37.5%,27m
4522,2,ProjectZero,3745,147,5,2,7,71.4%,35m
4522,2,[xTQc]WishDeath,3745,0,1,0,1,100.0%,27m
4522,2,Underfog,3745,0,0,1,1,0.0%,15m
4522,2,chef,3745,0,0,1,1,0.0%,36m
4528,2,[YE71]aYawningLion,3744,954,50,32,82,61.0%,15m
4528,2,TacoDeMuerte,3744,778,31,27,58,53.4%,27m
4528,2,Phocas,3744,36,1,5,6,16.7%,38m
4528,2,Denied,3744,0,0,1,1,0.0%,37m
4528,2,[aIien]Host,3744,0,0,1,1,0.0%,15m
4533,1,UGLY,3743,1712,261,256,517,50.5%,11m
4533,2,[EEx2]Renzo,3743,1630,127,118,245,51.8%,43m
4533,2,[Mc]Dracob,3743,859,39,32,71,54.9%,23m
4533,2,Phantoman,3743,627,37,32,69,53.6%,8m
4533,2,Kippa,3743,504,22,14,36,61.1%,35m
4533,2,[BHES]LavaDrake,3743,316,15,7,22,68.2%,6m
4533,2,[ConFed]Areon,3743,144,5,13,18,27.8%,23m
4540,2,RuseMaster,3742,1290,81,57,138,58.7%,35m
4540,1,[noAPEX]BATTLECRUISR,3742,715,19,32,51,37.3%,38m
4540,3,[GTnLB]Ryoku,3742,50,6,45,51,11.8%,38m
4540,3,RemakeOfStar,3742,0,1,0,1,100.0%,37m
4540,2,YasuoMain,3742,0,1,1,2,50.0%,10m
4540,2,[NotSry]TheAtheist,3742,0,1,2,3,33.3%,27m
4540,2,[MCCOS]Salvattore,3742,0,0,1,1,0.0%,12m
4540,2,SuperiaHands,3742,0,0,1,1,0.0%,18m
4548,1,supmax,3741,968,51,70,121,42.1%,14m
4548,3,Bohne,3741,192,5,2,7,71.4%,28m
4548,2,fastr,3741,72,2,5,7,28.6%,19m
4548,2,[cl0udM]OveR,3741,0,1,0,1,100.0%,10m
4548,2,Animality,3741,30,1,2,3,33.3%,30m
4548,2,Nosferatu,3741,0,0,1,1,0.0%,41m
4548,2,stormcloud,3741,0,0,1,1,0.0%,23m
4555,1,[ScSwrm]theprodukt,3740,1787,239,248,487,49.1%,14m
4555,2,Zerglings,3740,1617,123,87,210,58.6%,42m
4555,1,Fortitudo,3740,1699,75,87,162,46.3%,17m
4555,2,[1E100]Magni,3740,646,27,12,39,69.2%,43m
4555,2,[R3M]rokcdrigo,3740,460,22,4,26,84.6%,41m
4555,2,IIIIIIIIIIII,3740,365,14,18,32,43.8%,36m
4555,2,Darling,3740,292,12,4,16,75.0%,23m
4555,2,[Slugzz]GameFriend,3740,68,2,3,5,40.0%,36m
4555,2,Freeo,3740,0,0,2,2,0.0%,29m
4564,2,[WAN]JAYJAY,3739,1597,227,218,445,51.0%,43m
4564,2,dugastRhyno,3739,1626,170,148,318,53.5%,43m
4564,1,MickyG,3739,1853,144,154,298,48.3%,6m
4564,2,[69APM]Muminki,3739,1006,43,27,70,61.4%,43m
4564,2,ThAmznPrmKng,3739,510,17,20,37,45.9%,32m
4564,2,NeoN,3739,458,14,23,37,37.8%,25m
4564,2,Yakushi,3739,306,12,14,26,46.2%,15m
4564,2,PoonHerder,3739,98,3,4,7,42.9%,30m
4564,2,elPapuGomez,3739,0,1,0,1,100.0%,16m
4564,2,HyDrA,3739,0,1,2,3,33.3%,36m
4564,2,GOOFYGOOBER,3739,0,0,1,1,0.0%,10m
4575,1,[ValidG]Wanderer,3738,1876,241,248,489,49.3%,43m
4575,2,Nplaner,3738,1035,47,32,79,59.5%,6m
4575,2,[BLKISH]BlackishWolf,3738,308,13,5,18,72.2%,15m
4575,2,[NGInc]Gomo,3738,0,0,2,2,0.0%,14m
4575,2,[iGOSU]Flamewarrior,3738,0,0,3,3,0.0%,19m
4580,1,CheekClapper,3737,1833,312,311,623,50.1%,23m
4580,2,apcircle,3737,1405,206,191,397,51.9%,29m
4580,2,DeadClown,3737,1527,161,160,321,50.2%,11m
4580,2,TiMike,3737,536,77,70,147,52.4%,16m
4580,1,[MLC]JelQQing,3737,1454,56,55,111,50.5%,28m
4580,2,Endarkenment,3737,604,24,16,40,60.0%,35m
4580,1,Thaen,3737,533,19,21,40,47.5%,12m
4580,2,ROUGH,3737,302,14,9,23,60.9%,13m
4580,1,stef,3737,119,7,0,7,100.0%,5m
4580,2,[TGosuB]Doomby,3737,202,7,7,14,50.0%,15m
4580,1,SeaweedSoup,3737,96,2,0,2,100.0%,4m
4580,2,[EvilGC]Gravemind,3737,0,0,1,1,0.0%,29m
4580,2,Wizzard,3737,0,0,1,1,0.0%,29m
4593,2,Vader,3736,1592,260,235,495,52.5%,41m
4593,2,[eFt0ss]Zerg,3736,1576,130,124,254,51.2%,15m
4593,2,Paleblood,3736,832,43,27,70,61.4%,27m
4593,2,KEKW,3736,317,19,11,30,63.3%,23m
4593,2,TheHidraZ,3736,416,15,15,30,50.0%,5m
4593,2,[WOOP]woople,3736,151,12,18,30,40.0%,15m
4593,2,Heller,3736,142,8,1,9,88.9%,15m
4593,2,Darklife,3736,176,5,12,17,29.4%,41m
4593,2,[xLiTx]Skeptic,3736,0,3,2,5,60.0%,30m
4593,2,[KingSC]GranShAkA,3736,34,2,2,4,50.0%,36m
4593,2,[CODING]ckdarby,3736,64,2,6,8,25.0%,25m
4593,2,DerisiveOxen,3736,0,1,1,2,50.0%,43m
4593,2,[cuy]pepitocuy,3736,0,0,2,2,0.0%,23m
4606,2,[Snooot]moose,3735,1634,339,334,673,50.4%,11m
4606,2,Manimal,3735,1617,296,285,581,50.9%,41m
4606,2,PanditaYT,3735,852,38,21,59,64.4%,7m
4606,2,[DeBoyz]Sniper,3735,0,1,0,1,100.0%,5m
4610,2,Josa,3734,1349,161,160,321,50.2%,23m
4610,2,[BP8S]itsslowtime,3734,30,4,3,7,57.1%,42m
4610,2,zTCóndor,3734,0,2,2,4,50.0%,26m
4610,2,Tentative,3734,38,2,5,7,28.6%,31m
4610,2,[T3DDY]Izanagi,3734,0,1,0,1,100.0%,35m
4615,2,Widgitybear,3733,1178,49,48,97,50.5%,16m
4615,2,Kush,3733,177,27,16,43,62.8%,4m
4615,2,[wOaS]horseypistac,3733,368,12,17,29,41.4%,6m
4615,2,[Illini]Phecda,3733,142,8,1,9,88.9%,34m
4615,3,TerranHerAss,3733,97,3,5,8,37.5%,34m
4620,2,Unisane,3732,1205,127,107,234,54.3%,43m
4620,2,[SuperZ]ChuckNorris,3732,1310,59,54,113,52.2%,14m
4620,2,CREAMPIELORD,3732,586,45,37,82,54.9%,27m
4620,2,[TRETER]Splice,3732,309,27,27,54,50.0%,4m
4620,2,[Pig2]DiVizioN,3732,494,19,11,30,63.3%,27m
4620,2,[ISSC]LehAloha,3732,166,6,4,10,60.0%,4m
4620,2,Nickdogg,3732,0,1,2,3,33.3%,43m
4620,2,VoidRayOP,3732,30,1,3,4,25.0%,36m
4628,2,[InGB]BonJearNoe,3731,438,39,26,65,60.0%,24m
4628,2,hzheng,3731,32,4,4,8,50.0%,35m
4628,2,[xRtG]Rebel,3731,58,3,2,5,60.0%,16m
4628,2,[PSlSTC]Misery,3731,30,1,2,3,33.3%,20m
4628,2,[lCY]SieGe,3731,0,0,2,2,0.0%,41m
4633,2,[CqAce]AceAceAce,3730,1319,170,147,317,53.6%,25m
4633,1,WhiteSloth,3730,1694,166,192,358,46.4%,18m
4633,1,[GOURDS]APD,3730,1573,137,124,261,52.5%,17m
4633,1,[OD2019]Alberick,3730,1037,125,141,266,47.0%,21m
4633,1,[425]NoBwayno,3730,1273,65,61,126,51.6%,30m
4633,2,Pao,3730,769,30,35,65,46.2%,23m
4633,2,[AKHN]TICKMUSBILAL,3730,228,9,7,16,56.2%,15m
4633,2,QueensThief,3730,30,1,2,3,33.3%,15m
4641,1,Petee,3729,1824,173,175,348,49.7%,19m
4641,2,MechncSpecal,3729,1070,93,98,191,48.7%,38m
4641,1,ABI,3729,1186,53,58,111,47.7%,15m
4641,2,Jomskie,3729,282,11,9,20,55.0%,39m
4641,3,stärcraft,3729,195,10,3,13,76.9%,33m
4641,3,[WotM8]Kitty,3729,256,9,2,11,81.8%,29m
4641,3,IlllIlIlIlll,3729,143,8,1,9,88.9%,11m
4641,2,IIIllllIlIII,3729,114,5,4,9,55.6%,43m
4641,2,[iTLiT]Baseball,3729,88,3,2,5,60.0%,35m
4641,2,[SolOGS]assassin,3729,0,0,2,2,0.0%,30m
4641,2,[JOSUN]Sylar,3729,0,0,2,2,0.0%,27m
4652,2,[cl0udM]Unholy,3728,934,40,33,73,54.8%,7m
4652,2,CRAZYCAT,3728,362,14,4,18,77.8%,26m
4652,2,Shallow,3728,114,5,0,5,100.0%,27m
4652,2,nkl,3728,116,5,4,9,55.6%,24m
4652,3,Blue,3728,149,4,8,12,33.3%,28m
4652,2,Chronikal,3728,90,3,4,7,42.9%,31m
4652,2,PathiK,3728,72,3,8,11,27.3%,6m
4652,2,Stormlight,3728,30,2,5,7,28.6%,20m
4652,2,[Cryptc]SageFantasma,3728,34,1,3,4,25.0%,30m
4661,2,[51JTM]tassadar,3727,146,5,5,10,50.0%,43m
4661,2,[SHOKR]AfTeRsHoCk,3727,92,4,4,8,50.0%,10m
4661,2,corea,3727,0,1,0,1,100.0%,6m
4661,2,[CNCP]LostIdentity,3727,30,1,1,2,50.0%,15m
4661,2,DarkRevenant,3727,0,0,2,2,0.0%,36m
4661,2,[arisbe]FinalCut,3727,0,0,3,3,0.0%,42m
4667,2,[ZTempz]SoggyInferno,3726,787,40,44,84,47.6%,10m
4667,2,SloResponder,3726,652,23,25,48,47.9%,30m
4667,2,StantheMan,3726,273,13,15,28,46.4%,4m
4667,2,Zero,3726,197,10,1,11,90.9%,40m
4667,2,Pwninate,3726,186,6,11,17,35.3%,42m
4672,2,DraboK,3725,1409,69,68,137,50.4%,26m
4672,2,IlIlIlIlIlIl,3725,1311,57,56,113,50.4%,15m
4672,2,aliu,3725,170,11,2,13,84.6%,27m
4672,2,JaZz,3725,126,5,6,11,45.5%,15m
4672,2,TuckFrance,3725,62,3,4,7,42.9%,39m
4672,2,Ofo,3725,100,3,8,11,27.3%,10m
4672,2,[ØFoxF2]DohKo,3725,0,1,0,1,100.0%,43m
4672,2,[UFC]KrazyDago,3725,0,0,1,1,0.0%,24m
4672,2,checkmate,3725,0,0,1,1,0.0%,16m
4681,2,KrAuti,3724,1217,126,85,211,59.7%,32m
4681,2,LioN,3724,283,8,8,16,50.0%,11m
4681,2,Razi,3724,86,4,4,8,50.0%,26m
4681,1,[SkAL]Skalinas,3724,0,1,0,1,100.0%,23m
4681,2,iQue,3724,30,1,2,3,33.3%,23m
4686,2,SweatyBetty,3723,652,31,14,45,68.9%,11m
4686,2,[AlIin]Wizzer,3723,730,25,31,56,44.6%,27m
4686,2,Destroyer,3723,140,6,1,7,85.7%,25m
4686,2,[SoGo]TheJestOne,3723,139,4,2,6,66.7%,14m
4686,1,Denial,3723,0,2,3,5,40.0%,36m
4686,2,kadoeo,3723,0,1,0,1,100.0%,12m
4686,2,SmellyOnion,3723,0,0,1,1,0.0%,16m
4693,2,DiscerN,3722,410,20,13,33,60.6%,20m
4693,2,[PiGPan]alpaca,3722,378,13,8,21,61.9%,4m
4693,1,Borracho,3722,504,12,38,50,24.0%,9m
4693,3,HelloWorld,3722,169,7,4,11,63.6%,4m
4693,2,Cybergames,3722,162,5,14,19,26.3%,14m
4693,2,JoOSeon,3722,30,1,1,2,50.0%,29m
4693,2,unranked,3722,0,0,2,2,0.0%,7m
4693,3,Incens,3722,0,0,8,8,0.0%,22m
4701,1,[LDCO]Cronopio,3721,1805,297,305,602,49.3%,8m
4701,2,Smilge,3721,1516,252,252,504,50.0%,8m
4701,2,Amy,3721,1419,146,134,280,52.1%,15m
4701,2,Tyrano,3721,1616,135,109,244,55.3%,16m
4701,2,SuaveDragoon,3721,587,68,67,135,50.4%,15m
4701,2,grungus,3721,443,22,10,32,68.8%,7m
4701,2,[GGinc]DevilPanda,3721,272,12,13,25,48.0%,21m
4701,1,killbutt,3721,428,10,28,38,26.3%,10m
4701,2,[KGH]Chumbi,3721,62,2,8,10,20.0%,6m
4701,2,Vetaput,3721,0,0,1,1,0.0%,36m
4711,1,Farting,3720,785,153,148,301,50.8%,25m
4711,1,bad,3720,1845,88,115,203,43.3%,38m
4711,2,[DikBoy]Blodge,3720,824,31,26,57,54.4%,23m
4711,2,[αB]AlCaPwneD,3720,458,16,20,36,44.4%,40m
4711,2,[Bee]Lightning,3720,286,11,8,19,57.9%,26m
4711,2,Vultreus,3720,132,5,10,15,33.3%,29m
4711,2,Pele,3720,30,1,3,4,25.0%,3m
4711,2,Shrugs,3720,30,1,3,4,25.0%,24m
4711,2,[HeiHu]Tofulisk,3720,0,0,2,2,0.0%,5m
4711,2,[BroFox]Prodaki,3720,0,0,3,3,0.0%,13m
4721,2,Sean,3719,1568,91,71,162,56.2%,21m
4721,2,ioiio,3719,905,89,71,160,55.6%,23m
4721,2,[RUMB]UnitedGGK,3719,985,39,37,76,51.3%,30m
4721,2,Koooooozaan,3719,429,32,18,50,64.0%,29m
4721,2,UDontGnomeMe,3719,476,20,15,35,57.1%,10m
4721,1,Honeybadger,3719,798,19,30,49,38.8%,11m
4721,3,BPR,3719,172,6,2,8,75.0%,34m
4721,2,Newbie,3719,0,5,0,5,100.0%,3m
4721,2,Nose,3719,97,4,4,8,50.0%,3m
4721,2,[Gen54]generationcw,3719,0,1,0,1,100.0%,25m
4721,3,Encephalitic,3719,0,0,2,2,0.0%,39m
4732,2,[YEM]DogLog,3718,1631,246,233,479,51.4%,10m
4732,2,SZB,3718,361,30,32,62,48.4%,7m
4732,2,MostGroce,3718,662,23,32,55,41.8%,33m
4732,2,keit,3718,481,22,10,32,68.8%,35m
4732,1,coolwhip,3718,544,15,22,37,40.5%,38m
4732,2,Cyque,3718,167,13,12,25,52.0%,16m
4732,1,SaltyFish,3718,118,7,0,7,100.0%,19m
4732,3,kenosis,3718,219,6,5,11,54.5%,24m
4732,2,[Yuhang]Guider,3718,30,2,0,2,100.0%,5m
4732,2,math,3718,0,0,1,1,0.0%,2m
4732,2,[VetZCo]Nanos,3718,0,0,2,2,0.0%,30m
4743,2,[ExcIgN]Raúl,3717,1252,84,69,153,54.9%,3m
4743,2,Fenris,3717,616,43,30,73,58.9%,27m
4743,2,Munchkinman,3717,126,4,5,9,44.4%,3m
4743,2,PlebLife,3717,68,3,5,8,37.5%,30m
4743,2,Xyro,3717,0,0,1,1,0.0%,40m
4748,1,[SsaYnS]Anubis,3716,1876,306,325,631,48.5%,39m
4748,2,[3g0]KuVuTuNe,3716,1591,178,165,343,51.9%,35m
4748,2,Samson,3716,1578,63,60,123,51.2%,2m
4748,2,Anomaly,3716,994,45,27,72,62.5%,15m
4748,2,ciuciu,3716,616,28,20,48,58.3%,30m
4748,2,[Exehn]Topspin,3716,525,24,11,35,68.6%,20m
4748,2,[HaW]Adamondioman,3716,494,17,23,40,42.5%,21m
4748,2,llllllllllll,3716,0,1,0,1,100.0%,6m
4748,3,GDawg,3716,30,1,1,2,50.0%,18m
4748,2,Accel,3716,0,0,1,1,0.0%,2m
4748,2,OutMacroMe,3716,0,0,1,1,0.0%,6m
4748,2,Agnoletto,3716,0,0,4,4,0.0%,38m
4760,1,GuZrCn,3715,1866,678,661,1339,50.6%,28m
4760,1,Suede,3715,1858,145,148,293,49.5%,29m
4760,2,IMSleeping,3715,1176,86,73,159,54.1%,32m
4760,2,Epitaph,3715,587,52,37,89,58.4%,27m
4760,2,Isuck,3715,446,22,7,29,75.9%,35m
4760,2,Fayx,3715,236,11,12,23,47.8%,33m
4760,2,RobotWizard,3715,314,11,13,24,45.8%,36m
4760,2,[D1KS]Gido,3715,128,5,5,10,50.0%,6m
4760,2,[PSlSTC]brololo,3715,30,2,0,2,100.0%,35m
4760,2,lIllllIIIIlI,3715,66,2,4,6,33.3%,36m
4760,2,shrooooooomz,3715,0,0,1,1,0.0%,27m
4771,2,[RdLzrd]GoGators,3714,1391,245,231,476,51.5%,4m
4771,1,[b00ts]MrUnderhill,3714,658,155,161,316,49.1%,10m
4771,2,XYFans,3714,753,31,19,50,62.0%,15m
4771,2,[NeAs]exeKiAz,3714,759,31,22,53,58.5%,35m
4771,2,[CRAKS]NightWolf,3714,372,23,25,48,47.9%,33m
4771,2,Nexus,3714,402,20,16,36,55.6%,40m
4771,2,May,3714,157,7,4,11,63.6%,25m
4771,2,Konfusion,3714,60,3,2,5,60.0%,18m
4771,2,[KingSC]InFected,3714,30,2,2,4,50.0%,27m
4771,2,[SMB]SebbieMikos,3714,30,1,2,3,33.3%,24m
4781,2,[αXLa]ZerGAcTiOn,3713,918,49,50,99,49.5%,14m
4781,2,[XTCES]ZeroHero,3713,360,32,31,63,50.8%,15m
4781,2,Musashi,3713,302,10,14,24,41.7%,34m
4781,2,Michy,3713,114,4,3,7,57.1%,23m
4781,2,IIIIIIIIIIII,3713,120,4,7,11,36.4%,23m
4781,2,PumpkinKing,3713,62,3,4,7,42.9%,39m
4781,2,NONvirgin,3713,0,1,0,1,100.0%,38m
4781,2,Computer,3713,0,0,1,1,0.0%,26m
4781,2,qwertyui,3713,0,0,2,2,0.0%,19m
4790,1,[neuroS]HamsterSales,3712,1797,105,104,209,50.2%,12m
4790,2,[SsaYnS]Clairvoyance,3712,364,13,14,27,48.1%,15m
4790,2,Tysunami,3712,224,9,8,17,52.9%,29m
4790,2,[5CK]shiMnn,3712,122,4,8,12,33.3%,27m
4790,1,BustOnYou,3712,97,2,0,2,100.0%,31m
4790,2,[eX]Pindú,3712,60,2,2,4,50.0%,4m
4790,2,[Wiggin]GreatArchon,3712,0,1,0,1,100.0%,10m
4790,2,[xRtG]FeaR,3712,30,1,4,5,20.0%,33m
4790,2,[ØFoxF2]GabrielUNIMs,3712,32,1,4,5,20.0%,41m
4790,2,Noodles,3712,0,0,1,1,0.0%,1m
4800,2,[CS0]Supersquare,3711,1524,151,130,281,53.7%,15m
4800,2,[STIEMD]SYSY,3711,97,5,2,7,71.4%,23m
4800,2,BizktsNGravy,3711,90,4,8,12,33.3%,25m
4800,2,BruceBanner,3711,0,1,0,1,100.0%,40m
4800,2,[Str8SC]Martyrshot,3711,0,0,1,1,0.0%,29m
4800,2,[Pig2]krioni,3711,0,0,1,1,0.0%,3m
4806,2,[AFM]cookie,3710,340,13,10,23,56.5%,11m
4806,2,BOONGBOONG,3710,0,5,0,5,100.0%,37m
4806,2,[xRtG]Smartie,3710,118,4,5,9,44.4%,10m
4806,2,TenDer,3710,0,0,1,1,0.0%,2m
4806,2,jerryPE,3710,0,0,4,4,0.0%,6m
4806,2,[GIBE]Flowers,3710,0,0,6,6,0.0%,11m
4812,2,[LimaSC]deadmauS,3709,1642,104,107,211,49.3%,27m
4812,1,OmenGuide,3709,737,63,67,130,48.5%,37m
4812,2,Bluebury,3709,714,62,39,101,61.4%,15m
4812,2,GorkTheDork,3709,580,24,12,36,66.7%,35m
4812,2,SAKI,3709,323,13,6,19,68.4%,1m
4812,2,TZBerg,3709,262,9,11,20,45.0%,6m
4812,2,OcarinOfTime,3709,0,4,1,5,80.0%,18m
4812,2,[NGFR]JarJarDinks,3709,116,4,3,7,57.1%,14m
4812,2,MiAstErDoOm,3709,0,1,0,1,100.0%,21m
4812,2,Lulzorness,3709,0,1,5,6,16.7%,8m
4812,3,[AsukaS]llllllllllll,3709,0,0,1,1,0.0%,15m
4812,2,[d3stn3]GAMEofDRONEz,3709,0,0,8,8,0.0%,2m
4824,1,DarkStar,3708,1399,203,201,404,50.2%,21m
4824,2,rapactor,3708,454,38,40,78,48.7%,8m
4824,2,Lef,3708,222,8,13,21,38.1%,11m
4824,3,[ANIMOO]Dannie,3708,147,6,4,10,60.0%,2m
4824,3,HesiJimbo,3708,193,6,6,12,50.0%,14m
4824,2,[FnS]Tunafich,3708,234,6,11,17,35.3%,30m
4824,2,gOatspwn,3708,109,4,3,7,57.1%,30m
4824,2,Emphysema,3708,116,4,4,8,50.0%,16m
4832,1,llamasrule,3707,1863,88,84,172,51.2%,24m
4832,2,[SV]theBlues,3707,1625,83,75,158,52.5%,25m
4832,2,[DarkAG]Moto,3707,1181,60,55,115,52.2%,1m
4832,2,[SsaYnS]BirraLight,3707,268,10,6,16,62.5%,27m
4832,2,IIIIIIIIIIII,3707,214,7,11,18,38.9%,25m
4832,3,llllllllllll,3707,86,4,1,5,80.0%,36m
4832,2,[PiRapa]ParapPo,3707,102,3,7,10,30.0%,35m
4832,2,IIIIIIIIIIII,3707,92,3,10,13,23.1%,11m
4832,2,[TooEZ]DaddyBanger,3707,0,1,0,1,100.0%,24m
4841,2,[Gh0sty]insaneZTod,3706,1569,273,257,530,51.5%,13m
4841,2,Stinkfist,3706,1005,113,104,217,52.1%,8m
4841,2,Friedrich,3706,1350,97,77,174,55.7%,11m
4841,2,GotRice,3706,728,62,44,106,58.5%,2m
4841,2,Monkey,3706,138,17,10,27,63.0%,30m
4841,2,[UMCP]sunnyd,3706,0,1,0,1,100.0%,5m
4841,2,herO,3706,0,1,0,1,100.0%,27m
4841,2,llllllllllll,3706,30,1,4,5,20.0%,8m
4841,2,lllIIlIIIlll,3706,0,0,1,1,0.0%,40m
4841,2,[Exa]Omnivalent,3706,0,0,2,2,0.0%,20m
4841,2,[YIKERS]Karleb,3706,0,0,3,3,0.0%,3m
4852,2,Mermich,3705,566,60,62,122,49.2%,6m
4852,2,Eigeoh,3705,622,23,23,46,50.0%,10m
4852,2,GeardFord,3705,496,19,10,29,65.5%,38m
4852,2,ninjazerg,3705,356,13,15,28,46.4%,34m
4852,2,asdfghjkl,3705,255,9,17,26,34.6%,14m
4852,2,[Plugs]Phantom,3705,0,1,0,1,100.0%,1m
4852,2,[4RLZs]Asteroc,3705,0,0,1,1,0.0%,2m
4859,2,[PPBLS]CptClaw,3704,1083,107,107,214,50.0%,27m
4859,1,WASO,3704,1585,78,77,155,50.3%,28m
4859,2,[GnR]TitsMcgee,3704,1234,54,41,95,56.8%,26m
4859,2,Weenersaurus,3704,726,30,23,53,56.6%,27m
4859,2,moredakka,3704,238,9,13,22,40.9%,5m
4859,2,loser,3704,30,2,3,5,40.0%,25m
4859,2,hydralisk,3704,0,1,0,1,100.0%,13m
4859,2,[GAÚCHO]GUERRERO,3704,0,0,1,1,0.0%,5m
4867,2,TheSilverFox,3703,1005,137,120,257,53.3%,3m
4867,2,Kizamidal,3703,1455,90,82,172,52.3%,19m
4867,2,Paospos,3703,390,38,34,72,52.8%,8m
4867,2,[TeamLT]Jurapta,3703,273,23,25,48,47.9%,30m
4867,1,Hareru,3703,405,20,14,34,58.8%,9m
4867,2,TopferHarald,3703,526,19,22,41,46.3%,23m
4867,2,Imreallybad,3703,302,11,8,19,57.9%,12m
4867,2,[NoBads]Fast,3703,30,2,7,9,22.2%,15m
4867,2,emoPanda,3703,0,1,0,1,100.0%,40m
4867,2,kindness,3703,0,0,2,2,0.0%,10m
4877,2,Lemonescence,3702,296,50,50,100,50.0%,4m
4877,2,Foca,3702,88,3,3,6,50.0%,11m
4877,2,IIIIIIII,3702,86,3,6,9,33.3%,1m
4877,2,IIIIIIIIII,3702,0,1,0,1,100.0%,25m
4877,2,[LDCO]Carlettos,3702,0,0,1,1,0.0%,5m
4882,1,OoneO,3701,1883,290,307,597,48.6%,14m
4882,1,pepper,3701,912,24,36,60,40.0%,28m
4882,2,[ExcIgN]dafulove,3701,274,10,8,18,55.6%,21m
4882,3,ElSchamo,3701,143,8,2,10,80.0%,16m
4882,2,Moopels,3701,34,1,4,5,20.0%,29m
4882,2,SJL,3701,32,1,4,5,20.0%,13m
4882,2,SodiumBarcod,3701,0,0,1,1,0.0%,6m
4889,2,Malloy,3700,442,19,14,33,57.6%,23m
4889,2,Priism,3700,356,17,8,25,68.0%,30m
4889,2,[60Pho]Trainzor,3700,382,13,10,23,56.5%,16m
4889,2,SlimShady,3700,112,7,0,7,100.0%,19m
4889,2,Tassadar,3700,0,0,1,1,0.0%,32m
4894,2,[FnATlC]OPprotoszerg,3699,306,31,34,65,47.7%,15m
4894,2,MrBigshot,3699,680,25,28,53,47.2%,6m
4894,2,MrPotatoHead,3699,60,2,1,3,66.7%,33m
4894,2,nonFingo,3699,0,0,1,1,0.0%,15m
4894,2,KhainGonuyo,3699,0,0,1,1,0.0%,26m
4894,2,vulShark,3699,0,0,2,2,0.0%,9m
4900,2,[UpeV]Matt,3698,1471,74,76,150,49.3%,25m
4900,2,[TERROS]fraternity,3698,1588,60,64,124,48.4%,36m
4900,2,Legacy,3698,306,16,6,22,72.7%,24m
4900,2,FroggyStylez,3698,302,11,12,23,47.8%,9m
4900,2,NandoWORD,3698,170,6,2,8,75.0%,25m
4900,3,[MutasT]Horuss,3698,165,4,1,5,80.0%,24m
4900,2,SluttyMagoo,3698,90,4,5,9,44.4%,11m
4900,2,Skimmer,3698,30,2,1,3,66.7%,3m
4900,1,Beast,3698,48,2,6,8,25.0%,7m
4900,2,Youri,3698,0,0,2,2,0.0%,13m
4900,2,OptiMuS,3698,0,0,2,2,0.0%,32m
4911,2,zerick,3697,1639,436,388,824,52.9%,35m
4911,2,Karganator,3697,723,227,216,443,51.2%,15m
4911,2,RuskuL,3697,930,98,84,182,53.8%,13m
4911,2,Tecolote,3697,1114,52,38,90,57.8%,3m
4911,2,[ANGST]SideShow,3697,1336,50,53,103,48.5%,13m
4911,2,Sweet,3697,697,49,35,84,58.3%,15m
4911,2,Kiwi,3697,948,40,32,72,55.6%,2m
4911,2,ghosty,3697,862,39,26,65,60.0%,36m
4911,2,[GIBE]Oatis,3697,351,37,33,70,52.9%,41m
4911,2,[Cind3r]KillerWoC,3697,847,34,29,63,54.0%,2m
4911,2,TraGic,3697,403,17,10,27,63.0%,10m
4911,2,[xTQc]NotinMkSens,3697,170,9,6,15,60.0%,40m
4911,2,Silence,3697,161,7,5,12,58.3%,33m
4911,2,[BQB]PatoNavegado,3697,192,6,10,16,37.5%,10m
4911,2,Absynthe,3697,58,3,4,7,42.9%,39m
4911,2,[ELE]Arbitorm,3697,58,2,8,10,20.0%,3m
4911,2,KittyParlour,3697,0,1,0,1,100.0%,25m
4911,2,DisCoWinTeR,3697,0,0,1,1,0.0%,30m
4929,2,Chardonnay,3696,1383,261,252,513,50.9%,4m
4929,2,inSanity,3696,1623,97,91,188,51.6%,15m
4929,1,PoggedGourd,3696,812,51,63,114,44.7%,40m
4929,2,[ValidG]Blitz,3696,470,20,8,28,71.4%,30m
4929,2,[KoneOP]Overmind,3696,226,8,15,23,34.8%,12m
4929,3,[CH3ES3]ColonelHamm,3696,0,1,3,4,25.0%,36m
4929,2,tachisan,3696,0,0,1,1,0.0%,22m
4936,2,[Chibii]BrokenJarX,3695,1601,229,224,453,50.6%,7m
4936,2,iAmNesTea,3695,1438,170,174,344,49.4%,31m
4936,2,[L0GAN]Misery,3695,278,9,8,17,52.9%,33m
4936,2,[CHCKEM]Drooner,3695,58,3,0,3,100.0%,15m
4936,2,[cumy]Updraft,3695,64,3,3,6,50.0%,9m
4936,2,Knight,3695,58,2,7,9,22.2%,29m
4936,1,olanor,3695,97,1,1,2,50.0%,26m
4936,2,[TMKOs]Skeeper,3695,34,1,7,8,12.5%,11m
4936,2,Crystal,3695,0,0,1,1,0.0%,15m
4945,2,[Pig2]NoSavedDATA,3694,1272,89,86,175,50.9%,1m
4945,1,Elf,3694,1533,64,67,131,48.9%,38m
4945,2,[TgAg]Doom,3694,558,23,24,47,48.9%,27m
4945,2,[TLibre]prottodied,3694,572,20,24,44,45.5%,38m
4945,2,Asterius,3694,376,19,9,28,67.9%,29m
4945,2,[AZTECS]FrightNight,3694,360,14,7,21,66.7%,36m
4945,2,llllllllllll,3694,212,14,9,23,60.9%,41m
4945,2,[SHMALO]Python,3694,312,12,10,22,54.5%,26m
4945,2,TrippelM,3694,0,1,0,1,100.0%,32m
4945,2,BabyBear,3694,0,0,1,1,0.0%,4m
4955,1,[JJPOOR]ihateraymond,3693,1634,55,54,109,50.5%,28m
4955,2,[funand]Serral,3693,757,54,41,95,56.8%,3m
4955,2,[FMX]Stark,3693,204,7,10,17,41.2%,23m
4955,1,Maru,3693,0,1,0,1,100.0%,18m
4955,1,MechBiden,3693,46,1,11,12,8.3%,13m
4955,2,SilentPooper,3693,0,0,1,1,0.0%,25m
4961,2,Hangman,3692,1632,150,133,283,53.0%,29m
4961,2,[ZTemp]MaRa,3692,866,107,1,108,99.1%,11m
4961,1,HeroSlayer,3692,636,79,79,158,50.0%,40m
4961,2,[N3RD5]Lawlzer,3692,488,32,39,71,45.1%,3m
4961,2,iNFiNiTY,3692,598,24,17,41,58.5%,8m
4961,2,[Lowko]Assassin,3692,393,14,17,31,45.2%,41m
4961,2,[eX]DarkSpartan,3692,292,10,10,20,50.0%,11m
4968,2,OKOKOK,3691,1150,183,155,338,54.1%,2m
4968,2,Gerlan,3691,535,61,58,119,51.3%,36m
4968,2,Marineford,3691,244,10,5,15,66.7%,4m
4968,2,[RLSP]light,3691,30,1,2,3,33.3%,23m
4972,1,[AxW]AWEnix,3690,1835,391,387,778,50.3%,3m
4972,2,[ValidG]Chesapeake,3690,1341,65,58,123,52.8%,16m
4972,2,CivilAnarchy,3690,176,30,17,47,63.8%,4m
4972,2,llllllllllll,3690,535,28,6,34,82.4%,4m
4972,2,FeIdspar,3690,237,27,17,44,61.4%,3m
4972,2,Kikansha,3690,493,18,24,42,42.9%,3m
4972,2,DTox,3690,324,11,17,28,39.3%,11m
4972,1,Triaz,3690,118,7,0,7,100.0%,21m
4972,2,Einstein,3690,116,5,4,9,55.6%,2m
4972,2,[GuN]ekSo,3690,86,4,2,6,66.7%,10m
4972,2,Prodigy,3690,0,1,0,1,100.0%,23m
4972,1,IIIIIIIIIIII,3690,0,0,1,1,0.0%,11m
4984,2,HerO,3689,1425,189,162,351,53.8%,34m
4984,2,[SENJOU]Mitsuha,3689,1580,139,132,271,51.3%,40m
4984,2,Typhon,3689,1053,101,94,195,51.8%,3m
4984,2,[Grand]CodeOfBars,3689,1020,41,36,77,53.2%,27m
4984,2,BlueUnicorn,3689,664,30,19,49,61.2%,40m
4984,2,WooDstuck,3689,332,16,9,25,64.0%,19m
4984,2,[G0G0G0]XingLing,3689,408,15,10,25,60.0%,31m
4984,2,DAXSH,3689,324,13,8,21,61.9%,29m
4984,2,Lecheez,3689,258,11,15,26,42.3%,1m
4984,2,MichaelUdall,3689,256,9,5,14,64.3%,11m
4984,2,[Lost1s]Hopeless,3689,30,2,1,3,66.7%,2m
4984,2,[LoliGG]cDgPsychotix,3689,62,2,1,3,66.7%,26m
4984,2,IIIIIIIIIIII,3689,97,1,1,2,50.0%,29m
4997,2,[ShaSyn]Cosmos,3688,1568,115,117,232,49.6%,40m
4997,2,[UpeV]Sanguinario,3688,1598,100,102,202,49.5%,41m
4997,2,[2036]JohnTitor,3688,419,89,15,104,85.6%,30m
4997,1,BLADE,3688,951,26,36,62,41.9%,9m
4997,2,Dayman,3688,207,23,21,44,52.3%,16m
4997,3,MushoBetis,3688,92,3,6,9,33.3%,26m
4997,2,[TXOP]Artekario,3688,0,1,3,4,25.0%,18m
4997,2,Bobenrieth,3688,0,0,1,1,0.0%,26m
4997,2,You,3688,0,0,1,1,0.0%,37m
5006,2,[BZB4HZ]yourself,3687,244,9,8,17,52.9%,37m
5006,2,[Macac0]MuTaco,3687,248,9,11,20,45.0%,37m
5006,1,mACROpLAYER,3687,140,5,3,8,62.5%,33m
5006,2,Alloces,3687,6,2,3,5,40.0%,4m
5006,2,Burbn,3687,0,1,1,2,50.0%,13m
5006,2,vvoven,3687,0,1,2,3,33.3%,2m
5006,3,qqq,3687,0,0,1,1,0.0%,33m
5006,2,Yossarian,3687,0,0,3,3,0.0%,30m
5014,2,kilvan,3686,579,72,55,127,56.7%,18m
5014,1,Equinox,3686,1446,72,94,166,43.4%,40m
5014,2,GuySensei,3686,236,9,15,24,37.5%,35m
5014,3,Slowbro,3686,167,5,2,7,71.4%,1m
5014,2,DrBunhead,3686,146,5,5,10,50.0%,18m
5014,2,Rarescanner,3686,30,2,0,2,100.0%,19m
5014,1,Whirros,3686,120,2,5,7,28.6%,19m
5014,3,Samdaskod,3686,0,1,0,1,100.0%,1m
5014,2,rokgrlee,3686,30,1,1,2,50.0%,36m
5014,2,Tripod,3686,30,1,2,3,33.3%,7m
5014,2,Babagayega,3686,30,1,3,4,25.0%,29m
5025,2,Vorlax,3685,1491,221,226,447,49.4%,33m
5025,1,Lazeris,3685,1847,155,140,295,52.5%,4m
5025,2,MokChak,3685,444,16,14,30,53.3%,15m
5025,2,BernsteinD,3685,144,6,8,14,42.9%,23m
5025,2,OvniFuXy,3685,86,4,2,6,66.7%,27m
5025,2,MrYellow,3685,30,4,3,7,57.1%,34m
5025,2,[ANFA]Vivaldi,3685,86,3,4,7,42.9%,1m
5025,3,[O5HIT]bondca,3685,0,0,2,2,0.0%,9m
5033,2,RuneHopper,3684,1632,206,179,385,53.5%,14m
5033,2,[DhZAc1]Zeusgf,3684,1208,77,73,150,51.3%,4m
5033,2,AquaBadger,3684,1460,59,49,108,54.6%,8m
5033,2,meva,3684,582,24,15,39,61.5%,30m
5033,2,superdemon,3684,361,23,0,23,100.0%,29m
5033,2,[LNKDTS]Jadis,3684,495,19,16,35,54.3%,14m
5033,1,Ludo,3684,336,11,20,31,35.5%,12m
5033,2,Skinson,3684,60,3,4,7,42.9%,40m
5033,2,[Macac0]Mayhem,3684,30,2,0,2,100.0%,40m
5033,2,Ridiculous,3684,0,0,1,1,0.0%,27m
5033,2,llllllllllll,3684,0,0,2,2,0.0%,13m
5044,2,Makarot,3683,405,61,23,84,72.6%,2m
5044,2,Santana,3683,892,50,22,72,69.4%,5m
5044,2,BLACK,3683,655,44,47,91,48.4%,6m
5044,2,Majesty,3683,283,15,14,29,51.7%,3m
5044,2,[Pharoh]Rainyforest,3683,200,8,5,13,61.5%,11m
5044,2,[Impact]SushiSamurai,3683,250,8,13,21,38.1%,36m
5044,2,[TASP]Robert,3683,92,4,5,9,44.4%,37m
5044,1,[XIICDO]InQuisitoR,3683,97,2,5,7,28.6%,10m
5044,2,oGizMo,3683,30,1,4,5,20.0%,42m
5044,2,noodles,3683,34,1,7,8,12.5%,4m
5054,1,overgrow,3682,1837,617,641,1258,49.0%,12m
5054,2,[IFC]Knoll,3682,575,27,13,40,67.5%,26m
5054,2,CarpeBM,3682,443,18,10,28,64.3%,38m
5054,2,[BRSKR]Bootyslaya,3682,277,13,17,30,43.3%,39m
5054,2,Cerulean,3682,292,11,5,16,68.8%,15m
5054,2,FXmarc,3682,239,11,12,23,47.8%,37m
5054,2,[LIAO]stuffpwnz,3682,218,8,3,11,72.7%,15m
5054,2,llllllllllll,3682,86,3,2,5,60.0%,42m
5054,3,[KorWoo]woojung,3682,97,2,0,2,100.0%,28m
5054,1,Don,3682,97,2,0,2,100.0%,33m
5054,2,[VENSC2]JerVzla,3682,60,2,3,5,40.0%,15m
5054,1,[ButtFu]PurpleDrank,3682,48,1,1,2,50.0%,4m
5054,2,FighterZero,3682,30,1,5,6,16.7%,2m
5054,2,Orangie,3682,0,0,3,3,0.0%,26m
5068,1,essnov,3681,1183,341,329,670,50.9%,33m
5068,2,Rezz,3681,1612,289,288,577,50.1%,15m
5068,1,[DikBoy]Kwickfish,3681,1807,270,276,546,49.5%,18m
5068,2,Deneb,3681,784,28,33,61,45.9%,30m
5068,2,mrdoppler,3681,450,18,8,26,69.2%,37m
5068,2,[αXLa]SniperSC,3681,360,12,15,27,44.4%,30m
5068,2,[AraMaa]Hayasaka,3681,164,9,2,11,81.8%,22m
5068,2,[VFam]BaNeReigN,3681,30,2,5,7,28.6%,37m
5068,2,[RUMB]Player,3681,0,1,0,1,100.0%,33m
5068,2,[M1A5]sebas,3681,30,1,1,2,50.0%,21m
5068,2,[WaiFou]MouseMarine,3681,0,0,3,3,0.0%,16m
5079,2,[TGCrew]Zardecil,3680,1527,80,80,160,50.0%,8m
5079,2,coolskill,3680,125,28,27,55,50.9%,14m
5079,2,Stog,3680,338,14,8,22,63.6%,14m
5079,2,Resist,3680,360,13,13,26,50.0%,19m
5079,2,metropolitan,3680,0,4,1,5,80.0%,22m
5079,2,IlIIIlllIIIl,3680,30,1,1,2,50.0%,14m
5079,2,Kxrizma,3680,0,0,1,1,0.0%,30m
5079,2,ZanyCoyote,3680,0,0,1,1,0.0%,12m
5087,2,[Fir3s]RisingSun,3679,1313,118,85,203,58.1%,30m
5087,2,[FxB]PoweRThirsT,3679,1601,99,101,200,49.5%,23m
5087,2,Jinx,3679,412,41,45,86,47.7%,40m
5087,2,paddo,3679,520,25,13,38,65.8%,11m
5087,2,Termination,3679,726,24,32,56,42.9%,12m
5087,2,[TeamLT]Manoch,3679,300,10,10,20,50.0%,33m
5087,2,redbone,3679,201,6,3,9,66.7%,40m
5087,2,SorinHigh,3679,168,6,4,10,60.0%,4m
5087,2,[AiMB]hollywood,3679,86,3,2,5,60.0%,23m
5087,2,GlaceonDalek,3679,0,0,1,1,0.0%,4m
5097,1,Midge,3678,1531,61,63,124,49.2%,1m
5097,3,[ZTemps]phiL,3678,245,8,7,15,53.3%,22m
5097,3,Rottendonkey,3678,192,5,4,9,55.6%,33m
5097,2,Pancakes,3678,86,3,3,6,50.0%,7m
5097,2,Orion,3678,30,2,0,2,100.0%,22m
5097,3,PoonZ,3678,30,2,1,3,66.7%,26m
5097,2,Life,3678,0,1,0,1,100.0%,3m
5097,2,Cruncharoo,3678,0,1,1,2,50.0%,36m
5097,2,Kai,3678,30,1,1,2,50.0%,12m
5097,2,[KNDLA]Josueso,3678,30,1,2,3,33.3%,23m
5097,2,NAlowIQsoEZ,3678,0,0,1,1,0.0%,23m
5108,2,wahlflower,3677,1601,535,521,1056,50.7%,2m
5108,2,[Crazed]CrazyCritter,3677,1579,299,284,583,51.3%,40m
5108,2,Trout,3677,1583,99,67,166,59.6%,35m
5108,2,Dranzer,3677,844,40,39,79,50.6%,14m
5108,2,Hephesto,3677,163,9,1,10,90.0%,21m
5108,2,unbesiegbar,3677,0,5,0,5,100.0%,3m
5108,2,SoggyBiscuit,3677,0,1,2,3,33.3%,14m
5108,2,magbar,3677,0,0,1,1,0.0%,34m
5108,2,[InGt]Cold,3677,0,0,1,1,0.0%,25m
5108,2,PanicAttack,3677,0,0,1,1,0.0%,14m
5108,2,llllllllllll,3677,0,0,2,2,0.0%,39m
5119,1,[EtrOy]Nevik,3676,1831,982,982,1964,50.0%,12m
5119,2,grimZ,3676,1074,105,103,208,50.5%,31m
5119,2,Detour,3676,910,76,81,157,48.4%,15m
5119,2,[RSNBLD]BFSkinner,3676,1125,68,65,133,51.1%,5m
5119,1,TrauerBauer,3676,1836,62,74,136,45.6%,14m
5119,2,llllllllllll,3676,433,24,2,26,92.3%,14m
5119,2,calmoo,3676,489,23,11,34,67.6%,42m
5119,2,PKHALF,3676,256,13,6,19,68.4%,36m
5119,2,Zai,3676,226,12,3,15,80.0%,23m
5119,3,Ayyy,3676,297,11,13,24,45.8%,22m
5119,2,[InfCom]Catari,3676,30,2,1,3,66.7%,14m
5119,2,RaMM,3676,37,2,3,5,40.0%,3m
5119,2,Tyrii,3676,0,1,0,1,100.0%,23m
5119,2,[SLAPD]AscenT,3676,0,1,0,1,100.0%,25m
5119,2,TimeBones,3676,0,1,0,1,100.0%,34m
5119,2,Lslurpeek,3676,0,0,1,1,0.0%,10m
5135,2,[ValidG]EvToxic,3675,1409,69,70,139,49.6%,40m
5135,2,[Tidal]Undertow,3675,1567,66,72,138,47.8%,14m
5135,2,[TAW]DigitZ,3675,408,14,14,28,50.0%,8m
5135,2,TheGordon,3675,58,3,0,3,100.0%,4m
5135,2,[Fever]Equinox,3675,0,1,0,1,100.0%,15m
5140,3,[αB]SniperSC,3674,1721,698,709,1407,49.6%,12m
5140,2,Jaigo,3674,167,9,7,16,56.2%,6m
5140,3,CmonCmonCmon,3674,212,7,2,9,77.8%,19m
5140,2,TimeClutch,3674,57,3,1,4,75.0%,41m
5140,2,Cort,3674,58,3,8,11,27.3%,8m
5140,1,Relkin,3674,0,1,0,1,100.0%,27m
5140,2,encRoach,3674,0,0,1,1,0.0%,11m
5147,2,[QUIEEE]Craw,3673,1319,107,97,204,52.5%,23m
5147,2,heritage,3673,101,6,6,12,50.0%,24m
5147,2,RealJaraxxus,3673,0,0,6,6,0.0%,23m
5150,2,DJDickbutt,3672,1570,238,218,456,52.2%,38m
5150,2,EGIdra,3672,1019,139,84,223,62.3%,37m
5150,1,Icetemplar,3672,1795,117,121,238,49.2%,1m
5150,2,[SVY]GHOSTMARINE,3672,1133,84,69,153,54.9%,25m
5150,2,Excision,3672,1546,73,49,122,59.8%,29m
5150,1,StreetGrubby,3672,1452,46,56,102,45.1%,38m
5150,2,Cystemic,3672,456,17,23,40,42.5%,23m
5150,2,[LÞ]Matrix,3672,382,13,15,28,46.4%,24m
5150,2,AAA,3672,144,5,5,10,50.0%,15m
5150,2,Sibley,3672,0,1,0,1,100.0%,23m
5150,2,TheCreator,3672,30,1,3,4,25.0%,2m
5150,2,[HØST]Destroyer,3672,0,0,1,1,0.0%,30m
5150,2,[1vsM]flachwichser,3672,0,0,1,1,0.0%,2m
5150,2,[TeamLT]LeRocket,3672,0,0,2,2,0.0%,5m
5150,2,SpongeCake,3672,0,0,3,3,0.0%,25m
5165,1,Therapist,3671,1828,725,725,1450,50.0%,6m
5165,2,Raynor,3671,570,82,70,152,53.9%,24m
5165,2,Gazolin,3671,1181,65,66,131,49.6%,8m
5165,2,kuroneko,3671,326,28,11,39,71.8%,2m
5165,2,[SANGRE]hijodeodin,3671,265,22,3,25,88.0%,8m
5165,2,Elios,3671,230,7,17,24,29.2%,2m
5165,2,CDNLandmine,3671,144,5,4,9,55.6%,15m
5165,2,Throne,3671,50,2,4,6,33.3%,5m
5165,2,[C2N]Zergology,3671,0,0,1,1,0.0%,18m
5165,3,IIIIIIIIIIII,3671,0,0,7,7,0.0%,40m
5175,2,jdiegorc,3670,1637,268,262,530,50.6%,16m
5175,2,tuluar,3670,1616,163,155,318,51.3%,15m
5175,2,[INextI]Kinetic,3670,665,26,21,47,55.3%,11m
5175,2,Mimmoh,3670,0,0,1,1,0.0%,17m
5175,2,Coffee,3670,0,0,1,1,0.0%,36m
5180,2,GurrlPlz,3669,1165,60,61,121,49.6%,26m
5180,1,[CATFUK]NoEGirls,3669,1352,55,58,113,48.7%,8m
5180,2,Prakash,3669,348,13,12,25,52.0%,8m
5180,2,yEob,3669,86,8,2,10,80.0%,6m
5180,2,MescR,3669,220,8,6,14,57.1%,5m
5180,2,[6PooI]Cyen,3669,96,6,0,6,100.0%,33m
5180,3,IIIIIIIIIIII,3669,30,1,1,2,50.0%,13m
5180,2,[FRace]Smajdalf,3669,0,0,1,1,0.0%,7m
5188,2,Bradders,3668,1461,159,127,286,55.6%,19m
5188,2,[2sA]Zeus,3668,984,143,141,284,50.4%,3m
5188,2,Anti,3668,1177,112,119,231,48.5%,37m
5188,2,Ripley,3668,907,38,25,63,60.3%,10m
5188,2,[ZOOMOB]Clarity,3668,582,25,17,42,59.5%,36m
5188,2,[m8z]newLeaf,3668,608,24,18,42,57.1%,1m
5188,3,Tiozin,3668,191,9,3,12,75.0%,35m
5188,2,[DarkAG]BreaKer,3668,216,7,17,24,29.2%,37m
5188,2,KombatWombat,3668,94,4,8,12,33.3%,38m
5188,2,Dogjump,3668,44,2,3,5,40.0%,33m
5188,1,[akuta]Mars,3668,0,1,5,6,16.7%,31m
5188,2,[CoCoWa]TrashPanda,3668,0,0,3,3,0.0%,27m
5200,2,[SsaYnS]RustlNPeace,3667,706,34,41,75,45.3%,18m
5200,2,Cavo,3667,626,34,41,75,45.3%,8m
5200,1,[D5FTWA]NoahsBittch,3667,1136,29,46,75,38.7%,28m
5200,2,Rayden,3667,496,23,13,36,63.9%,29m
5200,2,[731]ZeRo,3667,236,9,6,15,60.0%,8m
5200,2,IIllIlIIIlll,3667,144,5,4,9,55.6%,13m
5200,2,[GldBoy]RaccoonMan,3667,0,3,2,5,60.0%,6m
5200,2,CHiPi,3667,0,1,1,2,50.0%,29m
5200,2,ReiX,3667,0,1,4,5,20.0%,15m
5200,2,Underdark,3667,0,0,2,2,0.0%,7m
5200,2,Cole,3667,0,0,4,4,0.0%,32m
5211,2,buto,3666,1613,121,112,233,51.9%,17m
5211,1,redturtle,3666,1647,93,96,189,49.2%,12m
5211,2,Kariack,3666,817,67,65,132,50.8%,16m
5211,2,Prontier,3666,1266,56,43,99,56.6%,34m
5211,2,McFazli,3666,842,55,59,114,48.2%,40m
5211,2,[KBH]WankelEngine,3666,728,34,34,68,50.0%,36m
5211,2,IJERKEVRYDAY,3666,642,32,18,50,64.0%,25m
5211,2,[FOREX]Arbitrager,3666,150,7,7,14,50.0%,39m
5211,2,SevenZera,3666,0,0,3,3,0.0%,6m
5220,1,Honsul,3665,118,9,2,11,81.8%,9m
5220,2,[urdone]Chiefpokeaho,3665,212,7,10,17,41.2%,6m
5220,2,TrumpsTan,3665,120,4,6,10,40.0%,10m
5220,2,Duffman,3665,0,1,0,1,100.0%,17m
5220,3,kayo,3665,30,1,2,3,33.3%,3m
5220,2,GBWang,3665,30,1,3,4,25.0%,41m
5220,2,Zizzle,3665,0,0,3,3,0.0%,34m
5227,2,[zecOc]LoremIpsum,3664,1547,342,327,669,51.1%,14m
5227,2,[GUCCl]fruitseller,3664,912,47,37,84,56.0%,27m
5227,2,burny,3664,581,24,18,42,57.1%,17m
5227,2,[NPhasA]saak,3664,0,0,1,1,0.0%,2m
5231,2,IceWorker,3663,671,32,23,55,58.2%,36m
5231,2,[BdeB]Aqua,3663,455,15,18,33,45.5%,26m
5231,2,Hiyori,3663,343,12,11,23,52.2%,14m
5231,2,Cheesebeard,3663,204,12,18,30,40.0%,27m
5231,1,Jaesung,3663,118,3,1,4,75.0%,10m
5231,2,Zithax,3663,0,0,1,1,0.0%,41m
5231,2,Othegreat,3663,0,0,2,2,0.0%,40m
5238,1,Guerilla,3662,1820,1726,1698,3424,50.4%,18m
5238,2,Thron,3662,178,9,8,17,52.9%,5m
5238,2,[fagz]HybridGnome,3662,88,3,2,5,60.0%,27m
5238,2,XDDX,3662,0,1,0,1,100.0%,11m
5238,2,[Frnzy]EightBall,3662,0,1,0,1,100.0%,36m
5238,2,Tango,3662,0,0,1,1,0.0%,35m
5238,2,SIIC,3662,0,0,1,1,0.0%,27m
5238,2,[FenGCN]MrMeepO,3662,0,0,1,1,0.0%,32m
5238,2,Spiraled,3662,0,0,4,4,0.0%,27m
5247,2,Gnova,3661,1430,88,65,153,57.5%,26m
5247,2,Tango,3661,1306,85,82,167,50.9%,36m
5247,2,[LÞ]Berserk,3661,726,29,23,52,55.8%,40m
5247,2,YungGohan,3661,427,21,8,29,72.4%,17m
5247,2,JiNG,3661,315,17,22,39,43.6%,24m
5247,2,rockhard,3661,259,14,4,18,77.8%,6m
5247,2,blink,3661,332,14,7,21,66.7%,30m
5247,2,AbueloDeNazy,3661,330,12,11,23,52.2%,25m
5247,2,rathala,3661,152,5,8,13,38.5%,15m
5247,2,Cerulean,3661,90,4,6,10,40.0%,23m
5247,2,[iCz]XtonE,3661,60,3,4,7,42.9%,37m
5247,2,piliaborza,3661,36,2,5,7,28.6%,15m
5247,2,DaRealDeal,3661,0,1,0,1,100.0%,23m
5247,2,Monald,3661,0,0,7,7,0.0%,2m
5261,2,Flank,3660,1573,288,294,582,49.5%,21m
5261,2,GKEY,3660,952,65,57,122,53.3%,11m
5261,2,grosstoss,3660,362,58,33,91,63.7%,2m
5261,2,Aizen,3660,1164,47,41,88,53.4%,6m
5261,2,LeoDC,3660,556,21,18,39,53.8%,25m
5261,2,Protoss,3660,448,20,8,28,71.4%,10m
5261,3,asereje,3660,360,18,6,24,75.0%,20m
5261,2,[FwithT]WOLF,3660,210,8,14,22,36.4%,2m
5261,2,Jyxz,3660,58,3,0,3,100.0%,8m
5261,2,[xRtG]HondaCivic,3660,90,3,4,7,42.9%,32m
5261,1,[THYGAP]CaptWack,3660,97,2,2,4,50.0%,21m
5261,2,KriXuS,3660,58,2,4,6,33.3%,13m
5261,2,THEBLOB,3660,0,1,0,1,100.0%,25m
5261,2,Trauma,3660,30,1,5,6,16.7%,7m
5261,2,[SCN]Stevefrench,3660,0,0,1,1,0.0%,19m
5276,2,Anders,3659,1456,229,212,441,51.9%,23m
5276,2,OnePunchMan,3659,679,85,53,138,61.6%,14m
5276,2,[VFam]Plasmid,3659,1636,84,77,161,52.2%,25m
5276,2,MikeRowe,3659,1120,60,62,122,49.2%,18m
5276,2,AMoveFTW,3659,369,30,30,60,50.0%,14m
5276,2,[MirG]HeaT,3659,362,13,14,27,48.1%,36m
5276,2,Schuman,3659,0,1,4,5,20.0%,5m
5276,1,[TSI]Aicy,3659,0,0,1,1,0.0%,6m
5276,2,TheRTSGuy,3659,0,0,1,1,0.0%,38m
5276,2,buCk,3659,0,0,3,3,0.0%,27m
5286,2,[XIE233]TTslucifer,3658,403,31,29,60,51.7%,18m
5286,2,Bumfire,3658,300,12,4,16,75.0%,38m
5286,2,[Maegis]Red,3658,168,7,5,12,58.3%,13m
5286,2,rtyuiojhkgfd,3658,172,6,5,11,54.5%,15m
5286,2,Paul,3658,148,6,7,13,46.2%,17m
5286,2,dangermule,3658,58,2,5,7,28.6%,23m
5286,2,SKS,3658,0,1,0,1,100.0%,10m
5286,2,iTeKK,3658,0,0,1,1,0.0%,14m
5294,2,SideShow,3657,1586,362,327,689,52.5%,6m
5294,2,[NPhasA]florencio,3657,1603,219,194,413,53.0%,29m
5294,2,[NPhasA]kuppo,3657,1262,104,102,206,50.5%,15m
5294,2,Oenari,3657,1405,74,63,137,54.0%,10m
5294,2,[BNG]Karnaugh,3657,1496,70,69,139,50.4%,17m
5294,2,Tjmax,3657,92,3,13,16,18.8%,40m
5294,3,Halogen,3657,30,2,2,4,50.0%,11m
5301,2,PonyBoy,3656,974,240,233,473,50.7%,33m
5301,2,sendIt,3656,1655,223,207,430,51.9%,25m
5301,2,Bigdigs,3656,1553,113,116,229,49.3%,15m
5301,2,omgitsduane,3656,1450,85,65,150,56.7%,10m
5301,2,[ISGHX]ISGkALA,3656,584,21,20,41,51.2%,23m
5301,2,[C96]LeeMongChuPa,3656,352,12,7,19,63.2%,30m
5301,2,[YEOBO]yeobo,3656,30,1,1,2,50.0%,4m
5301,1,IIIIIIIIIIII,3656,0,1,1,2,50.0%,33m
5309,2,LakeCarrot,3655,740,35,26,61,57.4%,13m
5309,2,[143s4]RKL,3655,560,22,18,40,55.0%,41m
5309,2,Wisebrah,3655,464,16,17,33,48.5%,31m
5309,2,[425]PartinGFAN,3655,462,16,21,37,43.2%,29m
5309,2,ChadBroChill,3655,226,12,6,18,66.7%,6m
5309,2,[ZeTa]PaInLeSs,3655,0,1,0,1,100.0%,16m
5309,2,iStreamCheat,3655,0,1,1,2,50.0%,14m
5309,2,[ToanTa]SoapyFerret,3655,88,1,2,3,33.3%,7m
5309,2,IceNine,3655,0,0,1,1,0.0%,1m
5309,2,BoyuanChen,3655,0,0,1,1,0.0%,27m
5309,2,[THEV]Lenny,3655,73,0,2,2,0.0%,26m
5309,2,[NoDice]Jaii,3655,0,0,2,2,0.0%,23m
5321,2,QueeN,3654,1556,202,189,391,51.7%,2m
5321,2,Topsy,3654,1639,93,92,185,50.3%,38m
5321,2,KeanuReeves,3654,627,31,10,41,75.6%,14m
5321,2,Dakku,3654,172,6,3,9,66.7%,22m
5321,2,Solidmore,3654,112,3,0,3,100.0%,36m
5321,2,[YUCK]PugFarmer,3654,58,2,5,7,28.6%,23m
5321,2,CHEMIST,3654,0,0,1,1,0.0%,32m
5321,2,[RAND0M]TheDaoist,3654,0,0,3,3,0.0%,27m
5329,2,RogueMarine,3653,1636,184,168,352,52.3%,9m
5329,2,MarkDenace,3653,986,38,33,71,53.5%,31m
5329,1,Rocklobster,3653,517,31,28,59,52.5%,28m
5329,2,abbeven,3653,676,24,30,54,44.4%,30m
5329,2,STAR,3653,566,21,21,42,50.0%,17m
5329,2,EnTaro,3653,418,15,20,35,42.9%,14m
5329,2,VinChaud,3653,177,5,1,6,83.3%,17m
5329,2,[EpicD]Hausgeist,3653,90,4,2,6,66.7%,41m
5329,3,RuneKj,3653,60,3,2,5,60.0%,40m
5329,2,Inkshades,3653,86,3,3,6,50.0%,29m
5329,2,Meteor,3653,30,2,3,5,40.0%,37m
5329,2,Drexel,3653,62,2,6,8,25.0%,11m
5329,3,Gunbunniz,3653,0,1,1,2,50.0%,29m
5329,2,[X17]antahoNy,3653,30,1,2,3,33.3%,34m
5329,2,[Boys]Legobuilder,3653,0,0,1,1,0.0%,15m
5329,2,Dione,3653,0,0,3,3,0.0%,38m
5329,2,[ProSC]toutoune,3653,0,0,4,4,0.0%,29m
5346,2,[HaMz]ebilice,3652,1133,246,208,454,54.2%,37m
5346,2,Chaldi,3652,1572,209,208,417,50.1%,15m
5346,2,jdg,3652,1631,193,196,389,49.6%,21m
5346,2,Mongoose,3652,1339,166,166,332,50.0%,41m
5346,2,llllllllllll,3652,227,65,73,138,47.1%,27m
5346,2,mulefish,3652,212,42,38,80,52.5%,4m
5346,2,[GRU]Camander,3652,347,26,37,63,41.3%,23m
5346,1,person,3652,932,25,36,61,41.0%,5m
5346,2,[BIZCUT]LuMorY,3652,708,23,37,60,38.3%,27m
5346,2,[Risque]LDOGPANKAKE,3652,0,0,1,1,0.0%,23m
5346,2,[S420S]Blindmoves,3652,0,0,1,1,0.0%,17m
5346,2,RottenFart,3652,0,0,3,3,0.0%,25m
5358,2,NPSC,3651,1570,447,430,877,51.0%,11m
5358,2,Cheebs,3651,837,36,21,57,63.2%,5m
5358,2,Meyr,3651,430,19,14,33,57.6%,14m
5358,2,[Gigity]whitePuma,3651,535,17,29,46,37.0%,18m
5358,2,LiquidSoap,3651,318,14,8,22,63.6%,8m
5358,2,Motown,3651,364,13,11,24,54.2%,3m
5358,1,[Kaii]RnGDaN,3651,226,5,24,29,17.2%,9m
5358,2,David,3651,124,4,9,13,30.8%,4m
5358,2,Extravaganza,3651,30,2,0,2,100.0%,10m
5358,1,Madkao,3651,121,2,2,4,50.0%,33m
5358,2,[PTSW]NinjaFalcon,3651,0,1,0,1,100.0%,18m
5358,2,IlIIIIlIIIIl,3651,0,1,0,1,100.0%,2m
5370,2,Algerin,3650,1341,191,189,380,50.3%,14m
5370,2,[ArGNA]kilokilo,3650,188,6,17,23,26.1%,15m
5370,2,TSMCoffeeBoy,3650,150,5,5,10,50.0%,9m
5370,2,[xBoZi]DaTwoOrda,3650,30,2,1,3,66.7%,15m
5370,2,Chris,3650,30,2,5,7,28.6%,25m
5370,2,zerGMING,3650,0,0,4,4,0.0%,10m
5370,2,Emigo,3650,0,0,5,5,0.0%,5m
5377,2,ElleWhySee,3649,1605,94,72,166,56.6%,20m
5377,2,Softcloner,3649,950,39,32,71,54.9%,26m
5377,2,[CatRG]ZergButchery,3649,358,15,13,28,53.6%,40m
5377,2,IIIIIIIIIIII,3649,297,13,5,18,72.2%,29m
5377,2,veiledforest,3649,196,7,0,7,100.0%,6m
5377,2,Huiting,3649,116,4,4,8,50.0%,28m
5377,2,Borzinator,3649,0,2,3,5,40.0%,24m
5377,2,MatrixLegend,3649,60,2,4,6,33.3%,36m
5377,3,Masa,3649,0,1,0,1,100.0%,14m
5377,2,[ProSC]ObaMarauder,3649,0,0,1,1,0.0%,15m
5377,2,[D1HURD]Curl,3649,0,0,1,1,0.0%,36m
5377,2,[UpeV]ExegoL,3649,0,0,1,1,0.0%,38m
5389,1,[cl0udM]ChubWild,3648,1558,421,408,829,50.8%,20m
5389,1,Tracker,3648,1812,268,268,536,50.0%,8m
5389,2,ShrieK,3648,1036,49,29,78,62.8%,20m
5389,2,[3g0]GoWMasteR,3648,593,33,25,58,56.9%,34m
5389,2,Xicho,3648,0,1,2,3,33.3%,25m
5389,2,[SDAASD]Ming,3648,30,1,6,7,14.3%,4m
5389,2,YucatecoSC,3648,0,0,4,4,0.0%,10m
5396,2,Squirrel,3647,1642,117,114,231,50.6%,41m
5396,1,[SsaYnS]Khaine,3647,1126,65,68,133,48.9%,13m
5396,1,lllliJDillll,3647,1713,65,82,147,44.2%,33m
5396,2,TheDoctor,3647,1390,54,52,106,50.9%,13m
5396,2,DYLue,3647,630,26,21,47,55.3%,11m
5396,2,[1E100]StagaDish,3647,406,24,9,33,72.7%,26m
5396,2,leavethegame,3647,251,10,15,25,40.0%,40m
5396,2,Stein,3647,192,7,6,13,53.8%,1m
5396,2,Zukassos,3647,119,6,1,7,85.7%,31m
5396,2,Babygotbert,3647,86,4,1,5,80.0%,16m
5396,2,Basti,3647,92,4,11,15,26.7%,13m
5396,2,[PsyNRG]whynogethigh,3647,60,3,2,5,60.0%,17m
5396,2,Chris,3647,60,2,3,5,40.0%,18m
5396,2,tipu,3647,0,1,1,2,50.0%,25m
5396,2,IlIlIlIlIlIl,3647,0,0,1,1,0.0%,10m
5396,2,Bored,3647,0,0,2,2,0.0%,14m
5412,2,Taserface,3646,1447,511,504,1015,50.3%,6m
5412,1,Rickstar,3646,1702,93,113,206,45.1%,38m
5412,2,TTZ,3646,938,41,27,68,60.3%,6m
5412,2,[Jasper]BillGates,3646,918,34,37,71,47.9%,33m
5412,2,masterGIL,3646,442,16,14,30,53.3%,15m
5412,2,GalaxyDDH,3646,284,11,6,17,64.7%,35m
5412,2,ZOrMitO,3646,88,4,4,8,50.0%,14m
5412,2,DiegoFIPA,3646,90,3,7,10,30.0%,7m
5412,2,[DyG]Maaltus,3646,96,3,9,12,25.0%,27m
5412,2,Pumky,3646,97,2,1,3,66.7%,28m
5412,2,[CTv]KNightMaRe,3646,0,1,0,1,100.0%,36m
5412,2,[neuroW]PrivateRyan,3646,0,1,0,1,100.0%,3m
5412,2,[MirG]IronY,3646,0,0,1,1,0.0%,11m
5425,2,PenguinSuit,3645,1563,178,187,365,48.8%,32m
5425,2,[iMkS]Dahlmann,3645,1566,154,81,235,65.5%,30m
5425,2,[VFam]YodaEater,3645,1569,140,138,278,50.4%,17m
5425,2,[iPn]Kooshbacca,3645,815,127,102,229,55.5%,37m
5425,2,SneakySquid,3645,1155,65,61,126,51.6%,27m
5425,3,Zergyboi,3645,235,11,3,14,78.6%,12m
5425,2,Dmutri,3645,257,10,9,19,52.6%,30m
5425,2,Beyondexx,3645,100,4,9,13,30.8%,25m
5425,2,Synergy,3645,58,3,0,3,100.0%,18m
5425,2,IlIlIlIlIlIl,3645,30,2,0,2,100.0%,39m
5425,2,JamesWade,3645,0,0,1,1,0.0%,27m
5436,1,Aspera,3644,1846,127,126,253,50.2%,9m
5436,2,[PTHero]shWall,3644,1323,52,53,105,49.5%,41m
5436,2,Loopy,3644,784,28,33,61,45.9%,16m
5436,2,[iPiff]Mike,3644,418,21,20,41,51.2%,25m
5436,2,Senakin,3644,422,19,7,26,73.1%,11m
5436,1,DreAmZyY,3644,127,9,4,13,69.2%,39m
5436,2,Daredevil,3644,30,2,0,2,100.0%,27m
5436,3,RetruL,3644,97,2,0,2,100.0%,28m
5436,2,Ayo,3644,60,2,4,6,33.3%,26m
5436,3,corea,3644,0,1,0,1,100.0%,31m
5446,2,monkeyking,3643,1568,367,357,724,50.7%,18m
5446,2,[B055]ShadowTiger,3643,1500,166,153,319,52.0%,11m
5446,2,Nitrato,3643,1401,119,120,239,49.8%,25m
5446,2,OPEORD,3643,1595,109,111,220,49.5%,30m
5446,2,Istaitsu,3643,1373,74,73,147,50.3%,40m
5446,2,[YMZT]NightWing,3643,851,42,25,67,62.7%,22m
5446,2,gonnacheese,3643,577,36,38,74,48.6%,33m
5446,2,Sylvanas,3643,355,19,31,50,38.0%,17m
5446,2,[Kappa]SMG,3643,97,6,0,6,100.0%,36m
5446,2,[M12]GasLight,3643,0,5,0,5,100.0%,41m
5446,3,Lohikäärme,3643,164,4,2,6,66.7%,29m
5446,2,Snake,3643,90,3,8,11,27.3%,18m
5446,1,[LQV]Gatsby,3643,76,2,23,25,8.0%,8m
5446,2,VElociraptor,3643,0,1,0,1,100.0%,28m
5446,2,[BYU]Lamanite,3643,0,1,1,2,50.0%,16m
5446,2,[FeverC]mwperk,3643,0,1,1,2,50.0%,30m
5462,2,Troglodyte,3642,601,165,131,296,55.7%,26m
5462,2,ThaNathos,3642,647,144,134,278,51.8%,36m
5462,2,[33rd]Mozzi,3642,1545,88,72,160,55.0%,8m
5462,2,PongRonin,3642,1324,54,58,112,48.2%,4m
5462,2,Drcesar,3642,686,44,15,59,74.6%,15m
5462,2,[NrFms]LingLeadeR,3642,996,42,31,73,57.5%,15m
5462,2,[ScSwrm]Robertoson,3642,549,37,23,60,61.7%,6m
5462,2,ALX,3642,734,28,27,55,50.9%,1m
5462,2,[APK]SAnjos,3642,740,28,28,56,50.0%,3m
5462,2,[xRtG]xobythesword,3642,666,23,30,53,43.4%,15m
5462,2,CptRespect,3642,340,16,9,25,64.0%,6m
5462,2,Eldrad,3642,366,12,16,28,42.9%,33m
5462,2,[xLgNx]Theprobe,3642,346,12,19,31,38.7%,24m
5462,2,XKG,3642,123,11,8,19,57.9%,24m
5462,3,Protossop,3642,192,10,4,14,71.4%,7m
5462,1,[Alti]Sanis,3642,167,8,2,10,80.0%,7m
5462,2,[TBPP]Setta,3642,176,7,7,14,50.0%,4m
5462,2,[DRKAPP]Beethoven,3642,114,5,0,5,100.0%,11m
5462,2,PROTOSSLORD,3642,92,3,10,13,23.1%,14m
5462,2,HalfMoon,3642,30,2,3,5,40.0%,15m
5462,2,DrPain,3642,0,0,2,2,0.0%,21m
5483,2,Broke,3641,1590,180,154,334,53.9%,11m
5483,2,Hnomma,3641,377,16,6,22,72.7%,19m
5483,2,DieOrRear,3641,491,16,30,46,34.8%,4m
5483,2,LegalizeStim,3641,376,13,16,29,44.8%,2m
5483,2,Tervaperse,3641,412,13,27,40,32.5%,7m
5483,2,Fecal,3641,58,3,1,4,75.0%,26m
5483,2,[GpsyDg]Jaeger,3641,86,3,4,7,42.9%,19m
5483,2,lIlIIllIIII,3641,30,2,0,2,100.0%,20m
5491,2,[fLc]Hollow,3640,1258,59,40,99,59.6%,17m
5491,2,AtoriX,3640,1151,51,33,84,60.7%,23m
5491,2,[DhZPro]siraniki,3640,646,24,29,53,45.3%,36m
5491,2,trivial,3640,231,12,4,16,75.0%,8m
5491,2,beefsupreme,3640,260,10,13,23,43.5%,21m
5491,2,TitaN,3640,165,5,1,6,83.3%,36m
5491,3,dBeeTz,3640,0,0,1,1,0.0%,2m
5491,2,TylerG,3640,0,0,1,1,0.0%,20m
5491,2,Xerokul,3640,0,0,3,3,0.0%,5m
5500,2,Ethirdor,3639,1600,298,292,590,50.5%,5m
5500,2,[xRS]Valo,3639,769,82,71,153,53.6%,23m
5500,2,Atlas,3639,868,81,67,148,54.7%,36m
5500,2,McPoop,3639,390,36,43,79,45.6%,36m
5500,2,Vynllios,3639,482,19,23,42,45.2%,33m
5500,2,IIIlIIlIIlll,3639,204,8,3,11,72.7%,30m
5500,2,SpecialEd,3639,128,4,1,5,80.0%,25m
5500,2,[Zatra]itzlogan,3639,30,2,1,3,66.7%,19m
5500,3,DeadGame,3639,30,2,2,4,50.0%,38m
5500,2,trouble,3639,30,2,4,6,33.3%,33m
5500,2,Jibz,3639,0,0,1,1,0.0%,16m
5500,2,Truebador,3639,0,0,2,2,0.0%,14m
5512,2,[SuperZ]zibabo,3638,1628,328,312,640,51.2%,25m
5512,2,MURDOCK,3638,1537,142,102,244,58.2%,29m
5512,1,[GØSU]SkinMilk,3638,591,127,130,257,49.4%,34m
5512,2,IvyMike,3638,1224,50,55,105,47.6%,36m
5512,2,Ecfy,3638,338,13,11,24,54.2%,37m
5512,2,KnowOne,3638,261,11,5,16,68.8%,8m
5512,2,Primming,3638,0,0,5,5,0.0%,3m
5519,2,[HF]YodeN,3637,1552,246,246,492,50.0%,14m
5519,2,DrCharles,3637,602,22,26,48,45.8%,40m
5519,2,[Fever]EquinsuOcha,3637,208,7,12,19,36.8%,15m
5519,2,protonelctrn,3637,58,3,5,8,37.5%,27m
5523,2,McSweetness,3636,860,124,125,249,49.8%,3m
5523,2,Frozzjr,3636,1003,61,33,94,64.9%,11m
5523,2,[TASWCM]Riscky,3636,1124,55,60,115,47.8%,16m
5523,2,[NDN]Hackanos,3636,576,42,43,85,49.4%,27m
5523,2,BennyLava,3636,630,33,11,44,75.0%,18m
5523,2,CarpeDiem,3636,433,26,26,52,50.0%,8m
5523,2,[m8z]ladygaga,3636,441,20,14,34,58.8%,27m
5523,2,[EtrOy]Pokemans,3636,248,8,5,13,61.5%,13m
5523,2,[eX]TuuR,3636,114,5,1,6,83.3%,38m
5523,2,Rysh,3636,58,2,2,4,50.0%,19m
5523,2,[SIClan]QuirkyOrc,3636,58,2,5,7,28.6%,27m
5523,2,[Align]RIZZTOWN,3636,30,1,1,2,50.0%,2m
5523,3,[iMkS]AdreNa,3636,30,1,1,2,50.0%,28m
5523,2,TNTelektrik,3636,0,0,1,1,0.0%,30m
5523,2,[CMU]Terry,3636,0,0,3,3,0.0%,27m
5523,2,Whitebison,3636,0,0,4,4,0.0%,15m
5539,2,fosterg,3635,659,124,105,229,54.1%,18m
5539,2,[YD2K]FirE,3635,1602,117,90,207,56.5%,34m
5539,2,Alexander,3635,981,42,34,76,55.3%,19m
5539,2,somn,3635,909,37,27,64,57.8%,2m
5539,2,[XiONN]Hunter,3635,216,16,10,26,61.5%,3m
5539,2,Algeroth,3635,185,10,11,21,47.6%,16m
5539,2,DonkeyBallz,3635,210,8,10,18,44.4%,11m
5539,2,Reaper,3635,200,6,7,13,46.2%,3m
5539,2,MaK,3635,30,2,0,2,100.0%,23m
5548,1,SirYesSir,3634,1819,99,106,205,48.3%,10m
5548,2,Photon,3634,1444,58,64,122,47.5%,10m
5548,2,ZergVillage,3634,240,9,8,17,52.9%,33m
5548,1,ZenStorm,3634,96,4,7,11,36.4%,26m
5548,2,Nathanielson,3634,30,2,0,2,100.0%,32m
5548,2,[xFaDe]HealZ,3634,30,1,1,2,50.0%,14m
5548,2,[HOBOZ]DezoForezo,3634,0,0,1,1,0.0%,25m
5555,2,Njörðr,3633,1576,167,165,332,50.3%,3m
5555,2,Zugg,3633,1178,93,101,194,47.9%,6m
5555,2,[SsaYnS]wimpyTuna,3633,1001,63,64,127,49.6%,15m
5555,2,Penicide,3633,1252,60,54,114,52.6%,10m
5555,2,[P00]MonkeyMan,3633,364,12,15,27,44.4%,27m
5555,2,[UpeV]Dijovi,3633,252,9,10,19,47.4%,37m
5555,1,gggg,3633,164,8,1,9,88.9%,35m
5555,2,Squid,3633,58,3,3,6,50.0%,22m
5555,2,zugzwang,3633,30,2,0,2,100.0%,37m
5555,2,[SBENU]AGKnight,3633,60,2,2,4,50.0%,18m
5565,2,bees,3632,1536,77,79,156,49.4%,37m
5565,2,HugeButCrack,3632,1188,44,40,84,52.4%,36m
5565,2,Keijo,3632,301,38,38,76,50.0%,2m
5565,2,SpaceSamurai,3632,478,29,24,53,54.7%,18m
5565,2,kali,3632,127,10,14,24,41.7%,10m
5565,2,[YD2K]MaSCoTZON,3632,120,4,7,11,36.4%,31m
5565,2,[CCClub]Fred,3632,58,2,8,10,20.0%,25m
5565,2,IIIIIIIIIIll,3632,0,1,0,1,100.0%,8m
5565,2,[FxB]Remain,3632,32,1,7,8,12.5%,31m
5565,2,TheMuffinMan,3632,0,0,1,1,0.0%,14m
5575,2,Renegade,3631,1584,110,107,217,50.7%,3m
5575,2,[PwT]RaZoR,3631,1376,53,51,104,51.0%,20m
5575,2,MONO,3631,615,26,14,40,65.0%,7m
5575,2,[UpxV]Ehécatl,3631,524,18,23,41,43.9%,4m
5575,2,ProxyVoidray,3631,316,15,7,22,68.2%,36m
5575,3,reeee,3631,241,12,5,17,70.6%,28m
5575,2,LivingLive,3631,202,10,4,14,71.4%,17m
5575,2,IIIIIIIIIIII,3631,298,10,23,33,30.3%,32m
5575,2,Involution,3631,216,9,2,11,81.8%,2m
5575,2,CobraKai,3631,220,8,14,22,36.4%,41m
5575,2,Cortarge,3631,111,4,2,6,66.7%,14m
5575,3,soldierguy,3631,58,2,3,5,40.0%,23m
5575,2,juiCed,3631,0,1,0,1,100.0%,11m
5575,2,Onara,3631,30,1,6,7,14.3%,10m
5575,2,carman,3631,0,0,2,2,0.0%,15m
5590,2,Lolegion,3630,636,45,39,84,53.6%,15m
5590,2,UltraRush,3630,143,5,8,13,38.5%,17m
5590,2,[l5150l]kiddle,3630,0,4,1,5,80.0%,36m
5590,2,WildCrane,3630,30,1,8,9,11.1%,36m
5590,2,Tarvek,3630,0,0,1,1,0.0%,26m
5595,2,thecrazyone,3629,1457,219,191,410,53.4%,23m
5595,2,yoyo,3629,1614,130,129,259,50.2%,17m
5595,2,Nightman,3629,1571,117,105,222,52.7%,9m
5595,2,UrbanRedNeck,3629,1300,101,101,202,50.0%,16m
5595,2,Nalle,3629,712,26,25,51,51.0%,30m
5595,2,Torment,3629,600,25,20,45,55.6%,15m
5595,2,[nieBla]GGGG,3629,517,19,13,32,59.4%,11m
5595,2,ProNoob,3629,284,9,18,27,33.3%,15m
5595,2,Antibiotics,3629,142,6,3,9,66.7%,21m
5595,2,AKASD,3629,118,6,8,14,42.9%,42m
5595,1,Cubone,3629,204,5,1,6,83.3%,36m
5595,2,Orage,3629,166,5,17,22,22.7%,2m
5595,2,Ender,3629,88,4,2,6,66.7%,5m
5595,2,Adapt,3629,58,3,4,7,42.9%,38m
5595,2,Squirt,3629,0,0,1,1,0.0%,8m
5610,1,[TXOP]Nimrod,3628,1656,257,272,529,48.6%,37m
5610,2,Taoon,3628,1114,130,121,251,51.8%,39m
5610,2,[EGx]JoseMartin,3628,64,2,15,17,11.8%,11m
5610,2,lIlIlIlIlIlI,3628,0,1,0,1,100.0%,7m
5610,2,BLuENiGhT,3628,0,1,0,1,100.0%,38m
5610,2,Chivas,3628,0,0,2,2,0.0%,23m
5610,2,[Msia]Iscariot,3628,0,0,2,2,0.0%,11m
5617,2,Lef,3627,1475,302,275,577,52.3%,4m
5617,2,spore,3627,911,125,110,235,53.2%,15m
5617,2,[xTQc]StrAnGe,3627,1597,92,94,186,49.5%,14m
5617,2,[PiGPan]ljfed,3627,30,2,2,4,50.0%,23m
5617,2,FootLaunched,3627,0,0,1,1,0.0%,8m
5617,2,SinsOfDeity,3627,0,0,2,2,0.0%,24m
5623,2,[SsaYnS]ArsisThesis,3626,1507,122,134,256,47.7%,27m
5623,2,[lLiTl]ZeKrAim,3626,338,12,16,28,42.9%,21m
5623,2,LDCyrus,3626,58,3,0,3,100.0%,37m
5623,1,BlackSaxon,3626,0,1,1,2,50.0%,5m
5623,2,meepmouse,3626,0,1,1,2,50.0%,25m
5623,2,WerzMyBackup,3626,32,1,6,7,14.3%,41m
5623,2,Flash,3626,0,0,1,1,0.0%,3m
5623,2,[FMX]FraperRush,3626,0,0,1,1,0.0%,15m
5623,1,TEMplar,3626,0,0,1,1,0.0%,25m
5632,1,[TGosuD]GhostMask,3625,1781,303,292,595,50.9%,39m
5632,2,Dkmaster,3625,604,26,14,40,65.0%,2m
5632,2,Raptor,3625,466,20,9,29,69.0%,42m
5632,2,[JMafia]Pomo,3625,58,3,4,7,42.9%,11m
5632,2,vanilla,3625,30,2,0,2,100.0%,17m
5632,2,[DJD]Sixshot,3625,30,2,0,2,100.0%,15m
5632,2,[H264]Hong,3625,30,2,0,2,100.0%,20m
5632,2,Bear,3625,0,2,3,5,40.0%,31m
5632,3,[CHlNK]InBeijing,3625,0,1,1,2,50.0%,25m
5632,2,LGNivrad,3625,30,1,6,7,14.3%,21m
5632,3,IIIIIIIIIIII,3625,0,0,1,1,0.0%,23m
5632,2,[TSan]Veniar,3625,0,0,5,5,0.0%,27m
5644,2,BillSlayer,3624,1626,543,531,1074,50.6%,6m
5644,2,BurninLegion,3624,1530,144,139,283,50.9%,17m
5644,2,FenceMaker,3624,1063,63,65,128,49.2%,18m
5644,2,GPLague,3624,1456,63,77,140,45.0%,16m
5644,2,[0dins]Paulverizer,3624,1068,44,37,81,54.3%,14m
5644,2,[bm]DukeNukem,3624,394,15,12,27,55.6%,5m
5644,2,llllllllllll,3624,262,11,2,13,84.6%,26m
5644,2,nDieJD,3624,140,8,2,10,80.0%,36m
5644,2,Aeolus,3624,206,7,10,17,41.2%,31m
5644,2,Castplay,3624,58,3,1,4,75.0%,1m
5644,2,[TJET]Bonein,3624,58,3,2,5,60.0%,30m
5644,2,[Lp]Trululu,3624,60,3,2,5,60.0%,15m
5644,2,[sk3tch]Balsafresh,3624,48,3,5,8,37.5%,36m
5644,2,Mattyd,3624,0,1,1,2,50.0%,23m
5644,2,Crossan,3624,0,1,1,2,50.0%,18m
5644,2,BrownJ,3624,0,0,4,4,0.0%,23m
5660,2,[Capt]TheBobalos,3623,729,161,160,321,50.2%,17m
5660,2,ioliolioliol,3623,1609,125,79,204,61.3%,25m
5660,2,matsuyamaMN,3623,1127,60,61,121,49.6%,11m
5660,2,Zoe,3623,256,8,5,13,61.5%,33m
5660,2,[GLG]FiNiTE,3623,188,7,0,7,100.0%,25m
5660,2,Yoshi,3623,114,4,5,9,44.4%,23m
5660,2,ddduuuddduuu,3623,0,1,0,1,100.0%,40m
5660,2,[HUSHrx]Celestiall,3623,0,1,0,1,100.0%,23m
5660,2,[eSun]DeathBringer,3623,0,1,1,2,50.0%,35m
5660,2,Ferralis,3623,30,1,2,3,33.3%,33m
5660,2,Crunch,3623,0,0,1,1,0.0%,40m
5671,2,LuckyLuciano,3622,1406,112,75,187,59.9%,7m
5671,2,OoO,3622,1621,94,48,142,66.2%,6m
5671,2,[uGG]xEnvy,3622,962,38,38,76,50.0%,8m
5671,1,supermage,3622,202,12,8,20,60.0%,38m
5671,2,[Sc2P]GROUNDPOUNDR,3622,252,9,4,13,69.2%,28m
5671,2,Fishbed,3622,142,5,9,14,35.7%,6m
5677,2,[ValidG]JIMMY,3621,620,23,26,49,46.9%,13m
5677,2,Bowchicabow,3621,242,13,5,18,72.2%,35m
5677,2,Dxros,3621,224,13,22,35,37.1%,6m
5677,3,[GRNSKN]Flare,3621,234,11,3,14,78.6%,37m
5677,2,klibrt,3621,216,7,5,12,58.3%,23m
5677,2,Mays,3621,114,7,6,13,53.8%,26m
5677,2,[lHMOl]MooOne,3621,182,6,1,7,85.7%,15m
5677,2,[Ec0s]NightFire,3621,60,2,6,8,25.0%,26m
5677,2,Tandris,3621,0,1,0,1,100.0%,9m
5677,2,[NwAs]LEINAD,3621,0,1,1,2,50.0%,36m
5677,2,David,3621,30,1,7,8,12.5%,16m
5677,2,Killerpanda,3621,0,0,1,1,0.0%,27m
5689,1,Kingantiuwan,3620,1803,327,353,680,48.1%,32m
5689,2,FrostWyrm,3620,1421,208,198,406,51.2%,2m
5689,2,HiLoSecond,3620,386,83,69,152,54.6%,36m
5689,2,DadBodLing,3620,1361,74,73,147,50.3%,36m
5689,2,llllllllllll,3620,1174,42,47,89,47.2%,37m
5689,2,AtbrrOficial,3620,587,22,22,44,50.0%,18m
5689,2,ProCyborg,3620,442,17,13,30,56.7%,37m
5689,2,Aser,3620,326,12,11,23,52.2%,1m
5689,2,eXt,3620,164,6,1,7,85.7%,2m
5689,2,chuyu,3620,117,3,0,3,100.0%,32m
5689,2,WulfBane,3620,0,1,0,1,100.0%,30m
5689,1,Cara,3620,0,1,0,1,100.0%,19m
5689,2,[ScrBnG]SCArium,3620,30,1,11,12,8.3%,26m
5689,2,IvonaOracle,3620,0,0,2,2,0.0%,25m
5689,2,Lua,3620,0,0,4,4,0.0%,27m
5704,2,[BRipt4]ihal,3619,338,12,15,27,44.4%,34m
5704,2,DeDoSo,3619,174,7,12,19,36.8%,41m
5704,2,[ChrisM]Chris,3619,30,2,1,3,66.7%,27m
5704,2,liquidcheese,3619,58,2,2,4,50.0%,35m
5704,2,[urdone]BrendaRush,3619,0,1,0,1,100.0%,10m
5704,2,ZenKraken,3619,0,1,1,2,50.0%,37m
5704,2,[dLife]robotic,3619,30,1,3,4,25.0%,31m
5704,2,[EZTAXI]GreatGoomba,3619,0,0,1,1,0.0%,16m
5704,2,[FPMR]Weisserg,3619,0,0,1,1,0.0%,2m
5713,2,pelicant,3618,1558,479,466,945,50.7%,21m
5713,2,[BVRDVR]Spartacan,3618,1359,118,118,236,50.0%,37m
5713,2,Protoss,3618,750,80,76,156,51.3%,1m
5713,2,derfnop,3618,490,19,18,37,51.4%,21m
5713,2,dingss,3618,175,5,5,10,50.0%,9m
5713,2,[UoM]Tortle,3618,90,4,2,6,66.7%,28m
5713,2,[V1RGN]Victory,3618,30,2,7,9,22.2%,6m
5713,2,Apple,3618,0,0,1,1,0.0%,15m
5713,2,llllllllllll,3618,0,0,2,2,0.0%,22m
5713,2,[EvilGC]Kafo,3618,0,0,4,4,0.0%,17m
5723,2,MaxwLSmart,3617,500,97,100,197,49.2%,5m
5723,2,Lioporto,3617,944,34,37,71,47.9%,32m
5723,2,SperatalTech,3617,552,20,24,44,45.5%,32m
5723,2,Ravenous,3617,138,8,2,10,80.0%,7m
5723,2,CalaVera,3617,232,8,8,16,50.0%,3m
5723,2,[PuffWC]Allen,3617,0,0,3,3,0.0%,11m
5723,2,spectrO,3617,0,0,12,12,0.0%,36m
5730,2,tpk,3616,1298,80,76,156,51.3%,11m
5730,2,Negligent,3616,1605,69,52,121,57.0%,8m
5730,3,[Maaate]BroodMother,3616,201,9,5,14,64.3%,2m
5730,2,adamsun,3616,258,9,10,19,47.4%,14m
5730,1,Anonymous,3616,118,2,2,4,50.0%,7m
5730,2,[13und]Pwnyo,3616,0,1,0,1,100.0%,15m
5730,2,olanor,3616,0,1,0,1,100.0%,41m
5730,2,[4866]Serobi,3616,0,1,1,2,50.0%,38m
5730,2,[NOM]PublicUnique,3616,30,1,3,4,25.0%,31m
5730,2,[CrUnK]Zergy,3616,30,1,5,6,16.7%,25m
5730,2,TadëOz,3616,0,0,1,1,0.0%,25m
5741,2,Anthracis,3615,1450,366,364,730,50.1%,27m
5741,2,Jimmy,3615,188,21,28,49,42.9%,5m
5741,2,Nemea,3615,272,9,6,15,60.0%,8m
5741,2,sniffula,3615,222,8,15,23,34.8%,14m
5741,2,Slayer,3615,30,2,0,2,100.0%,2m
5741,2,ShadowDragon,3615,0,1,0,1,100.0%,37m
5741,2,[TGosuA]ESCypher,3615,0,0,1,1,0.0%,29m
5741,2,IordOfFlies,3615,0,0,3,3,0.0%,36m
5749,2,[GnR]Miracle,3614,948,56,53,109,51.4%,13m
5749,2,OnGBaK,3614,434,17,14,31,54.8%,36m
5749,2,Uruk,3614,362,12,23,35,34.3%,8m
5749,2,Limper,3614,307,11,10,21,52.4%,8m
5749,2,Lat,3614,143,7,1,8,87.5%,40m
5749,2,applesauce,3614,90,3,10,13,23.1%,28m
5749,2,[InGt]AtomicFather,3614,58,2,4,6,33.3%,17m
5749,2,[ViViD]Legoz,3614,0,1,0,1,100.0%,36m
5749,2,[ZsDrag]DragonZeus,3614,0,1,0,1,100.0%,3m
5749,2,[FMST]ccf,3614,0,1,0,1,100.0%,17m
5749,2,Ace,3614,0,0,1,1,0.0%,16m
5760,2,NightSky,3613,973,64,59,123,52.0%,8m
5760,1,[SsaYnS]Julian,3613,803,27,38,65,41.5%,32m
5760,2,ultraZealOt,3613,128,8,2,10,80.0%,25m
5760,2,santana,3613,60,3,2,5,60.0%,38m
5760,2,[lLiTl]PuRiFieD,3613,86,3,3,6,50.0%,31m
5760,2,BabaYaga,3613,30,1,9,10,10.0%,14m
5766,2,Uncreative,3612,1597,181,174,355,51.0%,8m
5766,2,[NPhase]Swiftdaddy,3612,1323,148,152,300,49.3%,21m
5766,2,[egamer]Buddhalove,3612,1224,85,83,168,50.6%,8m
5766,2,[EoMX]artanis,3612,814,43,33,76,56.6%,15m
5766,2,Mochi,3612,852,38,24,62,61.3%,36m
5766,2,[ZTemps]ZugZug,3612,584,30,33,63,47.6%,21m
5766,1,llllllllllll,3612,202,9,3,12,75.0%,8m
5766,2,rar,3612,92,4,4,8,50.0%,17m
5766,2,[Cryptc]EviLs,3612,30,2,2,4,50.0%,10m
5766,2,Byun,3612,0,2,3,5,40.0%,40m
5766,2,Decadence,3612,0,1,0,1,100.0%,8m
5766,2,[DarkAG]OGsewerat,3612,30,1,1,2,50.0%,15m
5766,2,sheep,3612,30,1,4,5,20.0%,14m
5766,2,[ScSwrm]sandraudiga,3612,30,1,5,6,16.7%,40m
5766,2,[asaa]forzainter,3612,0,0,1,1,0.0%,28m
5766,2,[RwtM]Dman,3612,0,0,1,1,0.0%,5m
5782,2,[IMDSI]Arkoboz,3611,1591,249,240,489,50.9%,25m
5782,2,NoxyBo,3611,1607,184,183,367,50.1%,41m
5782,2,Estrong,3611,778,39,31,70,55.7%,6m
5782,1,MAC,3611,682,20,32,52,38.5%,10m
5782,2,xellowgetfuk,3611,216,11,3,14,78.6%,26m
5782,2,Varrik,3611,240,9,11,20,45.0%,23m
5782,2,sosh,3611,142,6,1,7,85.7%,10m
5782,2,[SCST]Gieve,3611,160,5,0,5,100.0%,27m
5782,2,CaptainKelly,3611,60,2,4,6,33.3%,29m
5782,2,[TGCrew]KCal,3611,60,2,6,8,25.0%,15m
5782,3,JustTheTip,3611,0,0,1,1,0.0%,29m
5782,2,EnemaGiver,3611,0,0,4,4,0.0%,26m
5794,2,BarCraft,3610,777,52,66,118,44.1%,17m
5794,2,Steven,3610,0,1,6,7,14.3%,26m
5794,2,FreshJuice,3610,0,0,1,1,0.0%,30m
5797,2,Offer,3609,1217,116,95,211,55.0%,20m
5797,2,SWARM,3609,1537,80,77,157,51.0%,23m
5797,2,[YD2K]Egglayer,3609,395,46,38,84,54.8%,14m
5797,2,Kromatikus,3609,746,31,23,54,57.4%,6m
5797,2,[αXLa]Mabels,3609,218,8,10,18,44.4%,21m
5797,2,Armani,3609,88,5,0,5,100.0%,25m
5797,2,Gregor,3609,136,3,1,4,75.0%,21m
5797,2,crazyman,3609,0,0,1,1,0.0%,9m
5797,2,HUSTLEMAN,3609,0,0,2,2,0.0%,3m
5806,2,whomper,3608,1577,207,197,404,51.2%,27m
5806,1,Riski,3608,164,8,1,9,88.9%,41m
5806,2,pipn,3608,118,4,6,10,40.0%,18m
5806,3,LowApm,3608,145,3,3,6,50.0%,19m
5806,2,[Amb3rs]UGamer,3608,0,1,0,1,100.0%,14m
5806,2,Scarlett,3608,0,1,0,1,100.0%,18m
5806,2,[LGNxx]AmAzInGFro,3608,30,1,2,3,33.3%,10m
5806,2,[Khng]KhangSlayer,3608,0,0,1,1,0.0%,2m
5806,2,tuer,3608,0,0,1,1,0.0%,37m
5815,2,ShoeLugs,3607,1016,66,66,132,50.0%,14m
5815,2,[DRKPMT]CactusJoe,3607,487,29,29,58,50.0%,41m
5815,2,MitraW,3607,685,27,22,49,55.1%,25m
5815,2,PMA,3607,460,20,18,38,52.6%,30m
5815,3,[BRSK]JYG,3607,286,15,7,22,68.2%,5m
5815,2,MMeRchant,3607,228,13,2,15,86.7%,2m
5815,2,MadeYouLook,3607,178,6,13,19,31.6%,3m
5815,2,BeltaLowda,3607,86,4,3,7,57.1%,27m
5815,3,[TeamUR]Shiftix,3607,167,4,4,8,50.0%,10m
5815,2,xBurst,3607,0,2,1,3,66.7%,14m
5815,2,MrWin,3607,60,2,4,6,33.3%,27m
5815,2,Lala,3607,0,1,5,6,16.7%,38m
5815,2,Acehigh,3607,0,0,1,1,0.0%,23m
5828,2,[ØFoxF2]Maher,3606,645,41,42,83,49.4%,33m
5828,2,Morguetron,3606,750,25,42,67,37.3%,11m
5828,2,ATLESHSOSO,3606,130,8,0,8,100.0%,9m
5828,3,[DSGang]Distrom,3606,240,7,3,10,70.0%,28m
5828,2,llllllllll,3606,140,7,3,10,70.0%,42m
5828,3,Andcast,3606,0,0,1,1,0.0%,10m
5834,2,momasbiscuit,3605,1510,124,124,248,50.0%,15m
5834,2,Fasho,3605,818,33,29,62,53.2%,25m
5834,2,Manjer,3605,289,15,10,25,60.0%,39m
5834,2,[FFAA]AiuR,3605,260,9,11,20,45.0%,7m
5834,3,[SSAMZI]Apple,3605,146,4,3,7,57.1%,40m
5834,2,Trichomonas,3605,30,2,0,2,100.0%,11m
5834,2,teioh,3605,30,2,1,3,66.7%,8m
5834,2,iGeddit,3605,0,2,3,5,40.0%,26m
5834,2,Navies,3605,0,1,0,1,100.0%,7m
5834,2,MonsteR,3605,0,0,2,2,0.0%,38m
5844,2,[EvilGC]Mero,3604,1085,63,61,124,50.8%,7m
5844,2,[INextI]JUKUMARU,3604,1080,50,42,92,54.3%,14m
5844,2,[EzyPzY]Balance,3604,546,40,25,65,61.5%,37m
5844,2,IIIIIIIIIIII,3604,490,24,15,39,61.5%,23m
5844,2,rizK,3604,590,23,20,43,53.5%,21m
5844,1,TopTurkey,3604,778,20,37,57,35.1%,10m
5844,2,Vandeemer,3604,236,12,10,22,54.5%,13m
5844,2,Babu,3604,0,1,0,1,100.0%,23m
5844,2,[Det0x]llllllllllll,3604,0,0,2,2,0.0%,15m
5853,2,SIGSEGV,3603,892,275,266,541,50.8%,27m
5853,2,Soul,3603,1161,80,85,165,48.5%,36m
5853,2,[SuperZ]FireDylan,3603,115,23,24,47,48.9%,8m
5853,3,Luko,3603,375,16,6,22,72.7%,7m
5853,2,king,3603,200,8,6,14,57.1%,7m
5853,2,FroZenOwl,3603,95,6,0,6,100.0%,33m
5853,3,THORISHERE,3603,121,2,1,3,66.7%,13m
5853,2,[ShoaL]Link,3603,30,2,3,5,40.0%,6m
5853,2,[ShoaL]KKOO,3603,30,2,4,6,33.3%,28m
5853,2,Strider,3603,0,1,0,1,100.0%,11m
5853,2,[xGenGx]Galaxy,3603,95,1,1,2,50.0%,2m
5853,2,hauhau,3603,30,1,3,4,25.0%,9m
5853,2,[UNTSC2]Osiris,3603,0,0,1,1,0.0%,36m
5866,2,[REPORT]ByaKko,3602,779,144,146,290,49.7%,36m
5866,2,Mikken,3602,1541,140,126,266,52.6%,14m
5866,2,[I738]Leffen,3602,1408,62,47,109,56.9%,25m
5866,3,Rifter,3602,259,13,3,16,81.2%,10m
5866,2,[MAGA21]ScoTT,3602,271,10,8,18,55.6%,15m
5866,2,DarkStar,3602,212,7,3,10,70.0%,14m
5866,2,Jeral,3602,86,3,2,5,60.0%,33m
5866,2,ProfessorTit,3602,30,2,0,2,100.0%,29m
5866,2,SneakySquid,3602,30,2,0,2,100.0%,6m
5866,2,smi,3602,0,2,3,5,40.0%,26m
5866,2,inLR,3602,0,1,4,5,20.0%,38m
5866,2,RynoxsQc,3602,0,0,1,1,0.0%,10m
5866,2,[RUMB]Daddy,3602,0,0,1,1,0.0%,8m
5866,2,Happy,3602,0,0,1,1,0.0%,28m
5880,2,YodaSlim,3601,1568,263,264,527,49.9%,25m
5880,2,STO,3601,505,114,95,209,54.5%,18m
5880,2,CumulusCloud,3601,798,109,90,199,54.8%,5m
5880,2,Johnson,3601,1489,99,83,182,54.4%,29m
5880,2,Homicide,3601,1386,92,97,189,48.7%,3m
5880,2,Antares,3601,663,63,57,120,52.5%,28m
5880,2,[OgreZ]Empress,3601,837,50,47,97,51.5%,2m
5880,2,Hapless,3601,450,17,18,35,48.6%,36m
5880,2,bTom,3601,290,11,9,20,55.0%,5m
5880,2,[usoda]SUSUKINO,3601,114,7,1,8,87.5%,9m
5880,2,[EnTrpY]Suicideking,3601,0,1,0,1,100.0%,36m
5880,2,[DNKCFT]OhStephy,3601,30,1,1,2,50.0%,37m
5880,2,spooky,3601,0,0,2,2,0.0%,41m
5880,2,Moros,3601,0,0,2,2,0.0%,10m
5894,2,Defroster,3600,1627,472,466,938,50.3%,18m
5894,2,TRIBUTE,3600,1517,195,162,357,54.6%,5m
5894,2,Zypher,3600,603,32,26,58,55.2%,38m
5894,2,[Zatra]zid,3600,542,23,12,35,65.7%,37m
5894,2,SorroW,3600,484,16,26,42,38.1%,4m
5894,2,rogba,3600,374,12,21,33,36.4%,28m
5894,2,Liminal,3600,298,11,7,18,61.1%,2m
5894,2,Clairvoyant,3600,280,10,10,20,50.0%,29m
5894,2,SadPanda,3600,226,8,14,22,36.4%,26m
5894,2,Cortarge,3600,83,3,2,5,60.0%,14m
5904,2,JayForJunk,3599,1009,188,166,354,53.1%,29m
5904,2,Nygma,3599,1568,109,100,209,52.2%,17m
5904,2,[αB]LiquidFate,3599,1408,96,97,193,49.7%,10m
5904,2,Bolha,3599,782,48,40,88,54.5%,23m
5904,2,Haze,3599,488,18,20,38,47.4%,9m
5904,2,[UrMove]MangoSpice,3599,414,15,20,35,42.9%,34m
5904,2,RTHabibty,3599,396,14,20,34,41.2%,26m
5904,2,foREVer,3599,138,8,2,10,80.0%,26m
5904,2,GVIA,3599,113,5,2,7,71.4%,35m
5904,2,dark,3599,86,4,1,5,80.0%,39m
5904,2,[PiGPan]Singularity,3599,30,2,1,3,66.7%,5m
5904,2,LaLa,3599,58,2,3,5,40.0%,19m
5904,2,marveL,3599,0,1,0,1,100.0%,26m
5904,2,[WWC]Skellen,3599,0,1,0,1,100.0%,27m
5904,3,TimoCore,3599,0,1,0,1,100.0%,16m
5904,2,[CDS12]dayco,3599,30,1,4,5,20.0%,37m
5904,2,Yugo,3599,0,0,4,4,0.0%,23m
5921,2,Vega,3598,324,10,24,34,29.4%,23m
5921,2,ZeroReaper,3598,106,5,7,12,41.7%,25m
5921,2,BobRoss,3598,141,4,1,5,80.0%,39m
5921,2,Otter,3598,86,4,2,6,66.7%,21m
5921,2,[BBN]Akamu,3598,0,2,3,5,40.0%,42m
5921,2,MakiMakii,3598,58,2,4,6,33.3%,25m
5921,3,[isGG]robotter,3598,30,1,1,2,50.0%,28m
5921,2,GETABETTERIQ,3598,0,1,4,5,20.0%,17m
5921,2,MrBrightside,3598,0,0,1,1,0.0%,13m
5930,2,[TPGGXD]DARONSUE,3597,1607,276,267,543,50.8%,9m
5930,2,Kevindevin,3597,1565,162,148,310,52.3%,8m
5930,2,koko,3597,1628,156,150,306,51.0%,21m
5930,2,silconick,3597,1185,52,38,90,57.8%,23m
5930,2,Barcode,3597,515,25,18,43,58.1%,14m
5930,2,storm,3597,278,11,11,22,50.0%,15m
5930,1,[12WERT]OGFindMuck,3597,166,6,14,20,30.0%,10m
5930,2,Geoth,3597,122,4,8,12,33.3%,14m
5930,2,Fear,3597,88,3,3,6,50.0%,10m
5930,2,MegaCheese,3597,60,2,8,10,20.0%,41m
5930,2,[FalPal]FalconPally,3597,0,1,0,1,100.0%,3m
5930,2,[Bee]MrMister,3597,0,1,0,1,100.0%,14m
5930,2,TejonSalvaje,3597,30,1,1,2,50.0%,33m
5930,2,BlackParade,3597,0,0,1,1,0.0%,6m
5930,2,[ReALGG]Rdytowrk,3597,0,0,4,4,0.0%,36m
5945,2,Hildarkien,3596,670,117,97,214,54.7%,18m
5945,2,[MAAGIC]CMarTZ,3596,1081,69,65,134,51.5%,8m
5945,2,PNess,3596,532,18,22,40,45.0%,9m
5945,2,JerryToT,3596,415,15,11,26,57.7%,2m
5945,2,LilWont,3596,298,10,15,25,40.0%,11m
5945,1,[Pharoh]Alexander,3596,162,7,3,10,70.0%,12m
5945,2,Khucumber,3596,90,4,3,7,57.1%,37m
5945,2,CrankyPants,3596,0,1,0,1,100.0%,11m
5945,2,[K1LLME]Armdrone,3596,0,1,0,1,100.0%,17m
5945,2,[FMMF]laakness,3596,30,1,1,2,50.0%,13m
5945,2,PurpleZebra,3596,30,1,6,7,14.3%,7m
5945,2,[IOwOl]Stephenwb,3596,30,1,6,7,14.3%,37m
5945,2,dtnox,3596,0,0,1,1,0.0%,15m
5958,2,IcUrHaLLoW,3595,858,37,31,68,54.4%,2m
5958,2,[Joseph]TheDominator,3595,329,13,6,19,68.4%,35m
5958,2,DarthNerd,3595,364,12,10,22,54.5%,14m
5958,2,[CHOOOO]Train,3595,176,7,10,17,41.2%,16m
5958,2,[TechN]Undead,3595,102,4,1,5,80.0%,17m
5958,2,[Tacos]andycap,3595,62,3,5,8,37.5%,7m
5958,1,HugeTosser,3595,142,3,5,8,37.5%,33m
5958,2,llllllllllll,3595,30,2,2,4,50.0%,13m
5958,2,[ValidG]Penguin,3595,0,1,0,1,100.0%,28m
5958,2,XDRiddler,3595,30,1,3,4,25.0%,18m
5958,2,Deometris,3595,0,0,2,2,0.0%,2m
5958,2,[BTSbr]deaD,3595,0,0,5,5,0.0%,14m
5970,2,[TGosuC]DillyWilly,3594,1411,82,75,157,52.2%,7m
5970,2,icantwin,3594,1018,65,34,99,65.7%,14m
5970,2,Deathskippy,3594,364,18,14,32,56.2%,1m
5970,2,[ITaM]SOEZ,3594,182,10,4,14,71.4%,35m
5970,2,albarn,3594,88,6,0,6,100.0%,17m
5970,2,TheFord,3594,160,4,3,7,57.1%,15m
5970,2,Adamcakez,3594,58,3,3,6,50.0%,23m
5970,2,Seenis,3594,0,0,1,1,0.0%,25m
5978,2,[neuroS]Keneme,3593,677,194,192,386,50.3%,9m
5978,2,IamWater,3593,1422,104,90,194,53.6%,10m
5978,2,Ancalagon,3593,1080,81,55,136,59.6%,10m
5978,2,Broag,3593,993,81,71,152,53.3%,16m
5978,2,SunKing,3593,1106,40,44,84,47.6%,25m
5978,2,Brainstorm,3593,770,25,39,64,39.1%,29m
5978,1,disruptorOp,3593,213,8,3,11,72.7%,7m
5978,2,Zorak,3593,80,4,7,11,36.4%,27m
5978,2,OnionHead,3593,97,2,3,5,40.0%,11m
5978,2,phil,3593,0,2,3,5,40.0%,11m
5978,2,[AxM]PositiveOne,3593,0,1,0,1,100.0%,6m
5978,2,[Cryptc]Doije,3593,30,1,2,3,33.3%,39m
5978,2,ElChivoOG,3593,30,1,2,3,33.3%,14m
5978,2,Papa,3593,0,0,1,1,0.0%,28m
5978,2,[OvrDsd]Chase,3593,0,0,1,1,0.0%,20m
5993,2,CoMET,3592,1526,202,176,378,53.4%,19m
5993,2,Papiloma,3592,1418,184,175,359,51.3%,23m
5993,2,BangDingOw,3592,1489,104,102,206,50.5%,30m
5993,2,Pikedastr,3592,647,70,75,145,48.3%,3m
5993,2,ProbeiusCorp,3592,1011,54,22,76,71.1%,22m
5993,2,revealvideos,3592,737,49,37,86,57.0%,3m
5993,2,Sorrz,3592,681,37,16,53,69.8%,22m
6000,2,CORN,3591,1529,144,104,248,58.1%,36m
6000,2,NadaPure,3591,796,123,112,235,52.3%,28m
6000,2,Snowman,3591,1571,115,108,223,51.6%,25m
6000,2,[Neow]Orca,3591,396,14,11,25,56.0%,37m
6000,3,OrcWarHero,3591,176,10,3,13,76.9%,13m
6000,2,RastaTrash,3591,0,0,1,1,0.0%,16m
6000,2,AbacusPurple,3591,0,0,1,1,0.0%,28m
6007,2,PyroNeko,3590,1364,148,132,280,52.9%,16m
6007,2,[JOOMA]moon,3590,1212,81,55,136,59.6%,36m
6007,2,MisterSir,3590,1537,60,53,113,53.1%,29m
6007,2,gurbler,3590,464,22,15,37,59.5%,2m
6007,3,[OvrDsd]Time,3590,335,13,6,19,68.4%,27m
6007,3,BummBumm,3590,143,9,9,18,50.0%,42m
6007,2,Mycatsinheat,3590,88,6,0,6,100.0%,29m
6007,2,DPGPartinG,3590,88,4,3,7,57.1%,11m
6007,2,[VENSC2]SCHOMBERG,3590,0,0,1,1,0.0%,9m
6016,2,Elbows,3589,1196,181,173,354,51.1%,2m
6016,2,maurimu,3589,921,124,115,239,51.9%,28m
6016,2,Oti,3589,916,112,95,207,54.1%,17m
6016,2,[CURLS]tKOmeed,3589,540,44,29,73,60.3%,39m
6016,2,nGenXceL,3589,316,43,45,88,48.9%,28m
6016,1,Vanquisher,3589,1220,39,57,96,40.6%,5m
6016,2,IIIIIIIIIIII,3589,538,20,27,47,42.6%,35m
6016,2,[Ash3s]OMNIPOTENT,3589,425,17,22,39,43.6%,23m
6016,2,razzle,3589,62,3,7,10,30.0%,6m
6016,2,MuffinzRage,3589,30,2,1,3,66.7%,9m
6016,2,[UberAw]Jimmy,3589,30,2,1,3,66.7%,11m
6016,2,Praetor,3589,0,0,1,1,0.0%,19m
6016,2,[GGclan]FIORAM,3589,0,0,3,3,0.0%,32m
6016,2,[WMA]Chambersiziz,3589,0,0,3,3,0.0%,39m
6030,2,fraglimb,3588,691,85,83,168,50.6%,1m
6030,2,Zerg,3588,1528,79,78,157,50.3%,14m
6030,2,[LgnTDS]Locke,3588,1214,67,66,133,50.4%,39m
6030,2,[Meadow]detour,3588,1481,65,46,111,58.6%,25m
6030,2,[NPhase]MeltedCheese,3588,1229,63,57,120,52.5%,7m
6030,1,[DRKAPP]itachti,3588,1122,54,60,114,47.4%,14m
6030,2,TheShadow,3588,916,43,38,81,53.1%,39m
6030,2,[CKI]alexphamster,3588,719,34,18,52,65.4%,32m
6030,2,[xTz]PedoG,3588,628,27,17,44,61.4%,7m
6030,2,SgtSeastand,3588,348,16,8,24,66.7%,39m
6030,2,Petrox,3588,204,8,7,15,53.3%,11m
6030,2,Tarake,3588,108,5,11,16,31.2%,14m
6030,2,culquigratte,3588,90,4,6,10,40.0%,37m
6030,2,EnTaroGeoff,3588,60,3,1,4,75.0%,17m
6030,2,[iCOKi]RedRuMPrime,3588,88,3,5,8,37.5%,11m
6030,2,llllllllllll,3588,0,0,1,1,0.0%,4m
6046,2,Apolo,3587,1581,178,169,347,51.3%,9m
6046,2,[GR33D]SilentFight,3587,1425,100,105,205,48.8%,11m
6046,2,Motor,3587,960,90,88,178,50.6%,23m
6046,2,[FlTM]Tohka,3587,589,33,23,56,58.9%,11m
6046,2,Jaesung,3587,778,30,32,62,48.4%,3m
6046,2,[αB]Duckpool,3587,196,8,8,16,50.0%,1m
6046,2,Tread,3587,156,6,9,15,40.0%,21m
6046,2,[l0l]Soko,3587,150,5,7,12,41.7%,7m
6046,2,ORaZ,3587,88,4,6,10,40.0%,21m
6046,2,[MeOwOr]Meowerdoom,3587,112,3,0,3,100.0%,23m
6046,2,Cheeseling,3587,60,2,6,8,25.0%,33m
6046,2,[neuroW]Tom,3587,10,1,9,10,10.0%,1m
6046,2,[CoNeZ]CabbageMan,3587,0,0,4,4,0.0%,28m
6059,2,layzzie,3586,120,4,6,10,40.0%,23m
6059,2,SwarmElite,3586,30,2,1,3,66.7%,18m
6059,2,Nero,3586,58,2,2,4,50.0%,11m
6062,2,Wisdom,3585,1449,76,50,126,60.3%,15m
6062,2,Manny,3585,739,60,59,119,50.4%,6m
6062,2,[xNtG]Sikhwitit,3585,994,53,34,87,60.9%,38m
6062,2,Darck,3585,967,39,44,83,47.0%,5m
6062,2,IlllllIIIIIl,3585,630,28,17,45,62.2%,17m
6062,2,[αX]CaptCanuck,3585,318,13,6,19,68.4%,25m
6062,2,[CHAT0S]xIgnizx,3585,154,5,6,11,45.5%,2m
6062,2,[OGbros]Ouroboros,3585,114,4,7,11,36.4%,2m
6062,2,monarch,3585,18,4,10,14,28.6%,4m
6062,2,BowtiE,3585,46,2,0,2,100.0%,36m
6062,2,Leaky,3585,95,2,2,4,50.0%,26m
6062,2,Leafstep,3585,30,1,1,2,50.0%,28m
6062,2,[iMkS]Dengx,3585,0,0,1,1,0.0%,25m
6062,2,[FxB]MaeFire,3585,0,0,1,1,0.0%,8m
6062,2,[UpeV]Tailon,3585,0,0,2,2,0.0%,25m
6077,2,Ectoplasm,3584,1385,155,155,310,50.0%,8m
6077,2,[PCAKE]charlie,3584,1526,58,62,120,48.3%,28m
6077,2,Creator,3584,237,31,16,47,66.0%,21m
6077,2,Alejandro,3584,353,18,9,27,66.7%,27m
6077,2,Cabertoss,3584,260,9,15,24,37.5%,11m
6077,2,[ValidG]Sujen,3584,204,8,11,19,42.1%,25m
6077,2,Superman,3584,189,7,2,9,77.8%,26m
6077,3,[Kappa8]TricoCV,3584,137,6,4,10,60.0%,7m
6077,2,KingkOng,3584,60,3,2,5,60.0%,7m
6077,2,dooz,3584,60,2,2,4,50.0%,10m
6077,2,terranstyle,3584,62,2,4,6,33.3%,5m
6077,2,[SCLA]WiperElite,3584,0,0,1,1,0.0%,23m
6077,2,[ValidG]Ins,3584,0,0,1,1,0.0%,23m
6077,2,Park,3584,0,0,1,1,0.0%,3m
6091,2,[B2]Regulator,3583,1453,116,96,212,54.7%,15m
6091,2,[MaAtMo]MooCow,3583,616,54,59,113,47.8%,11m
6091,2,Hawks,3583,376,16,4,20,80.0%,2m
6091,2,SoarTomboy,3583,222,13,3,16,81.2%,16m
6091,2,Bowil,3583,331,13,16,29,44.8%,27m
6091,2,Grannyfapple,3583,126,4,2,6,66.7%,17m
6091,2,[WroHo]Goodwin,3583,58,2,3,5,40.0%,14m
6091,3,Gypsy,3583,0,1,1,2,50.0%,5m
6091,2,[QTp2T]jackbest,3583,30,1,3,4,25.0%,2m
6091,2,Chief,3583,0,0,2,2,0.0%,33m
6101,2,[WCMC]neuroscope,3582,1543,221,218,439,50.3%,28m
6101,2,SoLo,3582,1041,38,53,91,41.8%,23m
6101,2,Vuvuzela,3582,515,23,15,38,60.5%,34m
6101,2,Jossi,3582,179,10,3,13,76.9%,2m
6101,2,Cadmium,3582,205,8,2,10,80.0%,13m
6101,2,Kanpo,3582,144,5,6,11,45.5%,26m
6101,2,stargodzilla,3582,116,4,7,11,36.4%,27m
6101,2,Shortandfat,3582,120,2,2,4,50.0%,16m
6101,2,Sean,3582,0,1,0,1,100.0%,36m
6101,2,[ROnSC]Syre,3582,0,1,3,4,25.0%,14m
6101,2,[DENINO]BestDahlia,3582,0,0,1,1,0.0%,9m
6112,2,[KoWL]Koumei,3581,1295,161,154,315,51.1%,28m
6112,2,[ValidG]Indroves,3581,1466,88,76,164,53.7%,15m
6112,2,[TGosuB]XLBeastmode,3581,1534,87,72,159,54.7%,6m
6112,2,IIIIIIIIIIII,3581,754,49,43,92,53.3%,18m
6112,2,Miaha,3581,946,45,51,96,46.9%,28m
6112,2,Zero,3581,332,33,20,53,62.3%,14m
6112,2,TheMilkMan,3581,310,15,8,23,65.2%,42m
6112,2,LeahBlo,3581,396,14,16,30,46.7%,16m
6112,2,BobStaMan,3581,139,7,1,8,87.5%,13m
6112,2,IIIIIIIIII,3581,117,6,2,8,75.0%,35m
6112,2,juiCed,3581,0,0,5,5,0.0%,11m
6123,2,[XDRAX8]RaitoKun,3580,1438,107,87,194,55.2%,9m
6123,2,nice,3580,771,80,56,136,58.8%,6m
6123,2,ShEYeNne,3580,239,37,22,59,62.7%,36m
6123,2,[NPhasA]JeChuv,3580,529,24,19,43,55.8%,5m
6123,2,[TGosuC]Kind,3580,443,20,13,33,60.6%,35m
6123,2,UrWifeMyKid,3580,350,12,17,29,41.4%,23m
6123,2,[WeBDB]ParaDoX,3580,182,6,2,8,75.0%,6m
6123,2,[LoF]Darksityl,3580,120,3,0,3,100.0%,19m
6123,2,mOOdY,3580,60,3,2,5,60.0%,25m
6123,2,Mizmaze,3580,112,2,1,3,66.7%,23m
6123,2,DARK,3580,30,1,3,4,25.0%,3m
6123,2,[InGt]eKaname,3580,73,0,3,3,0.0%,42m
6135,2,Chi,3579,1553,244,237,481,50.7%,21m
6135,2,[DhZPro]mwaltr,3579,850,105,114,219,47.9%,13m
6135,2,[ZTemps]Fibonacci,3579,955,63,65,128,49.2%,41m
6135,2,DKDK,3579,811,41,21,62,66.1%,21m
6135,3,[731]ATUM,3579,241,8,3,11,72.7%,2m
6135,2,[Igbt]LETSGOOOOOOO,3579,184,8,7,15,53.3%,11m
6135,2,Bahkura,3579,86,4,5,9,44.4%,16m
6135,2,Bigplaysjoe,3579,126,4,11,15,26.7%,37m
6135,2,Totalownage,3579,30,2,6,8,25.0%,36m
6135,2,Taydon,3579,0,1,0,1,100.0%,5m
6135,2,WorkWork,3579,0,1,0,1,100.0%,29m
6135,2,[KiTeam]Primo,3579,0,1,0,1,100.0%,33m
6135,2,awesomtie,3579,30,1,1,2,50.0%,16m
6135,2,Keino,3579,0,0,1,1,0.0%,26m
6149,2,Ginn,3578,1578,244,247,491,49.7%,11m
6149,2,MrWhiskers,3578,1578,229,226,455,50.3%,8m
6149,2,[JABW]Incense,3578,738,70,55,125,56.0%,39m
6149,2,ishi,3578,680,37,39,76,48.7%,41m
6149,2,[LSU]Bizzell,3578,634,23,28,51,45.1%,3m
6149,2,[lLiTl]ELECTRIC,3578,214,7,4,11,63.6%,28m
6149,2,Lavorre,3578,0,1,0,1,100.0%,17m
6149,2,[poe12]STERBEN,3578,30,1,3,4,25.0%,28m
6149,2,Esque,3578,0,0,1,1,0.0%,7m
6158,2,SciFoxWitch,3577,1421,357,350,707,50.5%,7m
6158,2,Tetsuro,3577,524,161,169,330,48.8%,6m
6158,2,IIIIIScanner,3577,1003,66,69,135,48.9%,6m
6158,2,[HYSC]twofiveguy,3577,1199,53,41,94,56.4%,16m
6158,2,[DaSGap]YakHunting,3577,1062,51,55,106,48.1%,18m
6158,2,Chosen,3577,1117,45,48,93,48.4%,14m
6158,2,BoolMasta,3577,906,35,35,70,50.0%,9m
6158,2,[Italis]CrimsonHalo,3577,296,11,12,23,47.8%,29m
6158,2,[500CC]CoreDefender,3577,192,8,3,11,72.7%,25m
6158,2,Hank,3577,62,7,4,11,63.6%,36m
6158,2,[Mamon]Ofen,3577,114,4,7,11,36.4%,2m
6158,2,[SoaP42]Pie,3577,0,1,0,1,100.0%,20m
6158,2,IIIIIIIIII,3577,0,1,0,1,100.0%,22m
6158,2,llllllllllll,3577,0,1,0,1,100.0%,24m
6158,2,BLTurntable,3577,30,1,2,3,33.3%,15m
6158,1,[EWM]Itzwil,3577,0,1,6,7,14.3%,21m
6174,2,Peen,3576,1446,76,65,141,53.9%,36m
6174,2,Crimson,3576,781,45,32,77,58.4%,5m
6174,2,AngryAcorn,3576,340,15,10,25,60.0%,17m
6174,3,StefanLöfven,3576,235,8,5,13,61.5%,16m
6174,2,Svyn,3576,214,8,12,20,40.0%,14m
6174,2,[TheDOH]BadBug,3576,0,1,0,1,100.0%,41m
6174,2,Cenergy,3576,30,1,1,2,50.0%,39m
6174,2,Parsect,3576,30,1,4,5,20.0%,41m
6174,2,[ShowMe]EunKyo,3576,30,1,4,5,20.0%,2m
6183,2,PHRavager,3575,785,184,149,333,55.3%,23m
6183,2,TTY,3575,1183,111,105,216,51.4%,18m
6183,2,SteezyG,3575,373,70,76,146,47.9%,17m
6183,2,[AlIin]Lenny,3575,667,27,23,50,54.0%,36m
6183,2,SuperNova,3575,650,27,34,61,44.3%,17m
6183,2,LGJeff,3575,62,3,6,9,33.3%,36m
6183,2,[TgAg]Dynamic,3575,135,2,5,7,28.6%,39m
6183,3,Sloth,3575,0,1,0,1,100.0%,40m
6183,2,LingLingRush,3575,0,0,1,1,0.0%,30m
6183,2,Roma,3575,0,0,1,1,0.0%,2m
6183,2,[Shardz]Brendon,3575,0,0,1,1,0.0%,22m
6183,2,Life,3575,0,0,1,1,0.0%,2m
6183,2,BlzSamurai,3575,0,0,2,2,0.0%,25m
6196,2,FiveVolTs,3574,1596,160,167,327,48.9%,6m
6196,2,DeathStriker,3574,1568,76,72,148,51.4%,16m
6196,2,Imperium,3574,645,28,30,58,48.3%,15m
6196,2,VicariousOne,3574,440,22,8,30,73.3%,26m
6196,2,yubba,3574,286,13,14,27,48.1%,37m
6196,2,StringCheese,3574,224,12,4,16,75.0%,9m
6196,1,[APM100]PumpkinG,3574,191,9,3,12,75.0%,27m
6196,2,ENTUCULO,3574,168,5,3,8,62.5%,39m
6196,3,Bryanliang,3574,0,0,1,1,0.0%,23m
6196,2,FallenStar,3574,0,0,1,1,0.0%,27m
6196,2,DISTURB,3574,0,0,6,6,0.0%,41m
6207,2,Willybucket,3573,1268,186,189,375,49.6%,41m
6207,2,Factal,3573,1487,74,78,152,48.7%,18m
6207,2,[SsaYnS]Rain,3573,230,7,7,14,50.0%,24m
6207,1,Kongg,3573,119,3,2,5,60.0%,22m
6207,2,CyberCM,3573,30,2,4,6,33.3%,5m
6212,2,[Lp]IrOnAnGeL,3572,1553,151,139,290,52.1%,2m
6212,2,ButtRipper,3572,716,128,126,254,50.4%,9m
6212,2,[PTHero]Subang,3572,1477,66,58,124,53.2%,17m
6212,1,weisoflife,3572,1326,52,68,120,43.3%,6m
6212,2,IIIIIIIIIIII,3572,641,31,15,46,67.4%,20m
6212,2,[VFam]PronLight,3572,300,16,7,23,69.6%,25m
6212,2,Meatpuller,3572,252,10,10,20,50.0%,6m
6212,2,heemoon,3572,192,9,5,14,64.3%,27m
6212,2,BigUzii,3572,94,4,6,10,40.0%,37m
6212,2,IIIIIIIIIIII,3572,126,3,1,4,75.0%,25m
6212,2,[TBWS]elzombra,3572,0,0,1,1,0.0%,36m
6212,2,BishopGainzz,3572,0,0,2,2,0.0%,2m
6224,2,[Dicboy]Beren,3571,983,109,105,214,50.9%,41m
6224,2,Teo,3571,1528,60,64,124,48.4%,37m
6224,2,ApeironLight,3571,1139,53,38,91,58.2%,5m
6224,2,[TxC1]TakeMyHand,3571,426,14,22,36,38.9%,2m
6224,3,[Lsland]KoFdAiMoN,3571,238,12,4,16,75.0%,17m
6224,2,IlIlIlIlIlIl,3571,116,8,1,9,88.9%,17m
6224,2,paul,3571,128,7,1,8,87.5%,24m
6224,3,llllllllllll,3571,0,5,0,5,100.0%,13m
6224,2,TheSpringer,3571,86,3,9,12,25.0%,34m
6224,2,[RIVERR]KimJongUk,3571,0,1,0,1,100.0%,28m
6224,2,Lochy,3571,0,0,1,1,0.0%,28m
6224,2,Bot,3571,0,0,3,3,0.0%,3m
6236,2,DatSauceTho,3570,1594,259,255,514,50.4%,22m
6236,2,[MBS209]Superking,3570,1568,132,127,259,51.0%,15m
6236,2,[MadK]Fenrir,3570,1443,104,85,189,55.0%,30m
6236,2,Talandar,3570,1306,92,100,192,47.9%,3m
6236,2,FreSH,3570,178,6,2,8,75.0%,2m
6236,2,SoLidLuiGGio,3570,116,5,5,10,50.0%,16m
6236,2,loit,3570,102,3,0,3,100.0%,9m
6236,2,Borg,3570,0,1,1,2,50.0%,33m
6236,2,Cubeguru,3570,0,0,1,1,0.0%,24m
6245,2,Ryougan,3569,1490,156,153,309,50.5%,33m
6245,2,DABO,3569,985,48,36,84,57.1%,24m
6245,2,[SyLx]Corkscrew,3569,460,34,31,65,52.3%,23m
6245,2,WhiskeyFish,3569,206,10,1,11,90.9%,36m
6245,2,Minarets,3569,230,9,4,13,69.2%,16m
6245,2,UNKO,3569,234,9,8,17,52.9%,39m
6245,1,[CrtCrw]CrazyCritter,3569,294,8,32,40,20.0%,2m
6245,2,Gongmyung,3569,112,5,3,8,62.5%,6m
6245,2,[FiFo]CrackFurtado,3569,156,5,9,14,35.7%,28m
6245,2,LoraX,3569,30,1,1,2,50.0%,6m
6245,2,Oddball,3569,48,1,7,8,12.5%,18m
6245,2,[DTXt]Deluxe,3569,0,0,1,1,0.0%,16m
6257,2,Blightning,3568,1534,148,152,300,49.3%,31m
6257,2,BigT,3568,1501,118,80,198,59.6%,37m
6257,2,Peixian,3568,619,34,11,45,75.6%,27m
6257,1,Helios,3568,1041,34,51,85,40.0%,14m
6257,2,[MPC]maverick,3568,342,19,12,31,61.3%,41m
6257,2,[3RECT]oGsPenus,3568,407,17,9,26,65.4%,29m
6257,2,ShowKhan,3568,378,16,10,26,61.5%,10m
6257,2,[TPGGXD]Miguelitoohh,3568,95,5,0,5,100.0%,30m
6257,2,[TNGA]Quantum,3568,30,2,1,3,66.7%,28m
6257,2,[Frzen]Lanaya,3568,58,2,5,7,28.6%,13m
6257,2,[yGook]TaiwanNoOne,3568,0,1,0,1,100.0%,16m
6257,1,[ETTyeh]ETT,3568,0,1,0,1,100.0%,6m
6257,2,[NPhase]Corsive,3568,30,1,2,3,33.3%,9m
6270,2,Hwudaman,3567,1627,361,347,708,51.0%,42m
6270,2,[SMB]GameOfDrones,3567,904,93,92,185,50.3%,15m
6270,2,[LimaSC]llOnVi,3567,1433,77,70,147,52.4%,10m
6270,2,kikimz,3567,420,15,16,31,48.4%,15m
6270,2,KeY,3567,266,9,9,18,50.0%,4m
6270,2,Hizzay,3567,102,3,0,3,100.0%,25m
6270,2,aZergPlayer,3567,126,3,2,5,60.0%,28m
6270,2,[Cryptc]IntoTheLoVeR,3567,86,3,4,7,42.9%,41m
6270,2,mobileriley,3567,30,1,3,4,25.0%,14m
6270,2,Wicle,3567,0,0,1,1,0.0%,37m
6280,2,Guigou,3566,824,200,200,400,50.0%,8m
6280,2,[TKCT]Trizztein,3566,1559,66,68,134,49.3%,4m
6280,2,[ZTemp]karen,3566,590,40,11,51,78.4%,11m
6280,2,EyeSoberbia,3566,717,40,18,58,69.0%,11m
6280,2,Reason,3566,603,27,21,48,56.2%,9m
6280,2,JanitorBil,3566,588,21,24,45,46.7%,30m
6280,2,CoffeMIX,3566,504,17,23,40,42.5%,2m
6280,2,Marzen,3566,292,11,7,18,61.1%,20m
6280,2,Cris,3566,208,7,10,17,41.2%,2m
6280,2,[XeonE]AkitsukiAiri,3566,140,3,3,6,50.0%,18m
6280,2,eVo,3566,30,2,1,3,66.7%,29m
6280,2,OddiE,3566,0,2,3,5,40.0%,5m
6280,2,[AngryB]Cheesy,3566,0,1,0,1,100.0%,6m
6280,2,[cl0udM]Doodsmack,3566,0,1,4,5,20.0%,17m
6280,2,[TAsc]ToSsGirL,3566,0,0,1,1,0.0%,22m
6280,2,Silver,3566,0,0,5,5,0.0%,25m
6296,2,Cabbage,3565,817,62,58,120,51.7%,19m
6296,2,Retsof,3565,664,45,35,80,56.2%,41m
6296,2,Omnivore,3565,339,17,21,38,44.7%,21m
6296,2,Life,3565,400,15,7,22,68.2%,29m
6296,2,Cravers,3565,158,5,14,19,26.3%,36m
6296,2,Elosai,3565,102,3,0,3,100.0%,2m
6296,2,[TGCF]Random,3565,88,2,0,2,100.0%,5m
6296,2,GeorgeKittle,3565,30,2,1,3,66.7%,19m
6296,2,Turtoise,3565,0,1,0,1,100.0%,31m
6296,2,ZEROSTAR,3565,30,1,3,4,25.0%,15m
6296,2,[xTBaGx]GOOFYGOOBER,3565,0,0,1,1,0.0%,17m
6296,2,SMILE,3565,0,0,1,1,0.0%,16m
6296,2,Greed,3565,0,0,1,1,0.0%,16m
6309,2,scrub,3564,1502,321,292,613,52.4%,31m
6309,2,JPD,3564,1583,199,214,413,48.2%,25m
6309,2,RealVelour,3564,587,102,77,179,57.0%,29m
6309,2,Shoefish,3564,1620,93,86,179,52.0%,25m
6309,2,Leviatan,3564,1146,69,48,117,59.0%,9m
6309,2,[NGRz]Fasho,3564,638,30,21,51,58.8%,6m
6309,2,OHMYGIRL,3564,460,24,9,33,72.7%,2m
6309,2,[TGULS]miko,3564,532,18,22,40,45.0%,2m
6309,2,SkOOg,3564,267,10,8,18,55.6%,11m
6309,2,trumpluvr,3564,194,8,2,10,80.0%,37m
6309,2,Grrrrrrr,3564,0,5,0,5,100.0%,9m
6309,2,[HOV]vivialdi,3564,0,1,1,2,50.0%,17m
6309,2,[F3DUp]kevlar,3564,30,1,4,5,20.0%,37m
6322,2,SeuVagem,3563,871,49,49,98,50.0%,17m
6322,2,[ggzvz]llllllllllll,3563,1205,48,47,95,50.5%,42m
6322,2,Chepi,3563,1322,48,52,100,48.0%,6m
6322,2,[TG3]learytheory,3563,602,22,23,45,48.9%,2m
6322,2,Hyo,3563,330,11,22,33,33.3%,3m
6322,2,streeD,3563,167,6,3,9,66.7%,12m
6322,2,Nergal,3563,0,5,0,5,100.0%,28m
6322,1,[F2AAA]DeadlyKilla,3563,143,5,6,11,45.5%,4m
6322,2,[G0G0G0]Kienzays,3563,0,0,1,1,0.0%,11m
6322,2,IlIlIlIlIlIl,3563,0,0,6,6,0.0%,41m
6332,2,[D0J0]Trijiro,3562,1609,222,187,409,54.3%,17m
6332,1,Librattor,3562,1726,85,82,167,50.9%,29m
6332,2,[ØÛ]gorilarosado,3562,794,70,63,133,52.6%,16m
6332,2,Squirtle,3562,479,32,22,54,59.3%,20m
6332,2,Chojin,3562,225,25,12,37,67.6%,2m
6332,2,iSkelzor,3562,368,25,19,44,56.8%,6m
6332,2,[UMCP]Sabotage,3562,228,12,6,18,66.7%,24m
6332,2,Egwene,3562,166,8,1,9,88.9%,36m
6332,2,FainRaVen,3562,252,8,18,26,30.8%,16m
6332,2,[IMeQ]bifoeQ,3562,150,6,7,13,46.2%,36m
6332,2,spankinbunkr,3562,126,4,10,14,28.6%,17m
6332,2,OpTiShMiStC,3562,30,2,1,3,66.7%,6m
6332,2,[TØXIC]crocotonhazt,3562,30,2,2,4,50.0%,2m
6332,2,[Ssjin]HellsFugitiv,3562,0,1,5,6,16.7%,8m
6332,2,[AV8]Tidgey,3562,0,0,2,2,0.0%,17m
6347,2,MicroJackson,3561,1581,112,62,174,64.4%,9m
6347,2,pahxora,3561,1324,110,98,208,52.9%,10m
6347,2,scraul,3561,1581,107,96,203,52.7%,9m
6347,2,[Cersei]MasterShake,3561,1477,79,74,153,51.6%,28m
6347,2,[XpKb]Ramzzez,3561,1255,52,51,103,50.5%,27m
6347,2,swarmCore,3561,810,41,29,70,58.6%,28m
6347,2,TNR,3561,746,35,22,57,61.4%,36m
6347,2,Appa,3561,476,19,15,34,55.9%,3m
6347,2,Climber,3561,592,19,34,53,35.8%,41m
6347,2,MARTINEZ,3561,265,10,15,25,40.0%,8m
6347,2,Animals,3561,140,9,1,10,90.0%,25m
6347,2,LiteMelody,3561,88,6,1,7,85.7%,9m
6347,2,[touchy]Robtimus,3561,130,4,1,5,80.0%,8m
6347,2,christiansto,3561,88,2,0,2,100.0%,20m
6347,2,SaMe,3561,0,1,1,2,50.0%,26m
6347,2,Toroid,3561,30,1,2,3,33.3%,39m
6347,2,[WNTR]TheCure,3561,0,0,1,1,0.0%,41m
6347,2,franklin,3561,0,0,1,1,0.0%,24m
6347,2,Clcsed,3561,0,0,1,1,0.0%,25m
6347,2,IllIllI,3561,0,0,3,3,0.0%,36m
6347,2,CTVStarFox,3561,0,0,6,6,0.0%,9m
6368,2,shifty,3560,1469,382,381,763,50.1%,37m
6368,2,[dSLAP]MrSlave,3560,1504,293,293,586,50.0%,11m
6368,2,[xLgNx]farter,3560,1457,262,246,508,51.6%,28m
6368,3,[Din0s]DinoZerg,3560,1620,255,282,537,47.5%,27m
6368,2,[TØXIC]ilovececy,3560,357,69,66,135,51.1%,9m
6368,2,Schweinsteig,3560,1398,61,46,107,57.0%,11m
6368,2,[IMPRO]Oxygen,3560,418,27,21,48,56.2%,18m
6368,2,decibel,3560,116,8,0,8,100.0%,7m
6368,2,Victor,3560,212,8,15,23,34.8%,33m
6368,2,Wright,3560,151,6,2,8,75.0%,28m
6368,2,[MikAlx]SetoKaiba,3560,90,3,5,8,37.5%,37m
6368,3,[FofS]Wolf,3560,0,1,0,1,100.0%,29m
6368,2,ErSmallTwo,3560,88,1,1,2,50.0%,28m
6368,2,[MLC]killswitch,3560,0,0,1,1,0.0%,39m
6368,2,Synrgy,3560,0,0,1,1,0.0%,37m
6368,2,[Fir3s]llxtechnoxll,3560,0,0,1,1,0.0%,32m
6368,2,kief,3560,0,0,1,1,0.0%,6m
6368,1,MarineEleven,3560,0,0,9,9,0.0%,29m
6386,2,[UTF8]morgo,3559,951,218,221,439,49.7%,36m
6386,2,IndraRinne,3559,782,54,31,85,63.5%,32m
6386,2,StorM,3559,751,49,35,84,58.3%,28m
6386,2,milkTEA,3559,590,26,16,42,61.9%,6m
6386,3,crash,3559,252,12,7,19,63.2%,34m
6386,2,[xRFR]PretendBeast,3559,240,9,6,15,60.0%,5m
6386,2,Braaap,3559,206,8,3,11,72.7%,36m
6386,2,[RBTH]CALLO,3559,143,6,0,6,100.0%,15m
6386,2,[GT301]Juice,3559,90,4,4,8,50.0%,37m
6386,2,[neuroW]Metalfenrir,3559,116,4,10,14,28.6%,21m
6396,2,Thalo,3558,1507,251,256,507,49.5%,2m
6396,2,brogue,3558,1129,69,61,130,53.1%,10m
6396,2,Gavin,3558,1220,51,42,93,54.8%,36m
6396,2,[ezrekt]Player,3558,1354,50,59,109,45.9%,7m
6396,2,[APK]MrPoPo,3558,218,9,4,13,69.2%,3m
6396,2,Aleanderxoo,3558,166,7,8,15,46.7%,14m
6396,2,GroinShark,3558,176,7,15,22,31.8%,16m
6396,2,[LCE]PartinG,3558,112,3,1,4,75.0%,42m
6396,2,sOs,3558,0,1,0,1,100.0%,22m
6396,2,Ollowain,3558,0,1,0,1,100.0%,15m
6396,2,[KmDeYb]NineVolt,3558,0,1,5,6,16.7%,37m
6396,2,[qoou]Falco,3558,0,0,1,1,0.0%,3m
6396,2,[ScSwrm]IronLung,3558,0,0,2,2,0.0%,10m
6409,2,[StarCT]ForTheSwarm,3557,1175,108,96,204,52.9%,22m
6409,2,[SBoys]sPiN,3557,1150,61,40,101,60.4%,42m
6409,2,[LASTOF]Brunot,3557,371,40,36,76,52.6%,16m
6409,2,LiquidPuK,3557,394,28,16,44,63.6%,14m
6409,2,AliZaLoT,3557,422,22,12,34,64.7%,20m
6409,3,SojuJawyi,3557,0,5,0,5,100.0%,22m
6409,2,[InfNA]hooligan,3557,30,2,3,5,40.0%,25m
6409,2,[Noo0b]KALSHNIKOV,3557,30,1,2,3,33.3%,35m
6409,2,[IL1]HMSvictory,3557,0,0,1,1,0.0%,29m
6409,2,ILetYouWin,3557,0,0,2,2,0.0%,2m
6419,2,Kam,3556,1406,272,250,522,52.1%,20m
6419,2,[NCSt]CrowbarSpine,3556,1269,217,203,420,51.7%,39m
6419,2,lurker,3556,1472,153,139,292,52.4%,41m
6419,2,OpTikZeisure,3556,1114,149,153,302,49.3%,19m
6419,2,[αXLa]Eintrag,3556,664,85,82,167,50.9%,14m
6419,2,Kaizen,3556,1232,48,51,99,48.5%,41m
6419,2,Brr,3556,803,37,25,62,59.7%,9m
6419,2,[GRU]Variance,3556,476,18,13,31,58.1%,23m
6419,2,Rat,3556,230,10,4,14,71.4%,29m
6419,2,Morro,3556,151,4,4,8,50.0%,15m
6419,1,[NLTTJ]Yue,3556,144,2,3,5,40.0%,39m
6419,2,[HØST]ManOfOneWay,3556,88,1,1,2,50.0%,11m
6431,2,Molesto,3555,1028,121,120,241,50.2%,6m
6431,2,Kakarot,3555,1556,71,77,148,48.0%,20m
6431,2,[KAGUSA]WifePWNer,3555,1269,68,47,115,59.1%,32m
6431,2,JonnyCraig,3555,1037,46,34,80,57.5%,12m
6431,2,RoKu,3555,190,10,5,15,66.7%,35m
6431,2,[LIR]TheSergeant,3555,156,5,10,15,33.3%,18m
6431,2,[FALURS]Marvel,3555,88,2,0,2,100.0%,16m
6431,2,[KingSC]Luigi,3555,30,2,1,3,66.7%,9m
6431,2,[1vsM]CrimeWave,3555,30,1,3,4,25.0%,7m
6431,2,DrPuertoRico,3555,0,0,1,1,0.0%,31m
6441,2,Rusher,3554,1558,412,407,819,50.3%,31m
6441,2,Charonn,3554,1516,106,112,218,48.6%,9m
6441,2,CandyMan,3554,916,82,74,156,52.6%,25m
6441,2,badplayer,3554,559,22,17,39,56.4%,16m
6441,2,Markle,3554,483,20,22,42,47.6%,21m
6441,2,[GnR]OmegaLSA,3554,442,17,21,38,44.7%,20m
6441,2,[Vithar]Yem,3554,116,4,0,4,100.0%,2m
6441,2,Forkey,3554,128,4,1,5,80.0%,37m
6441,2,[KingSC]Alemania,3554,118,4,8,12,33.3%,2m
6441,2,Vader,3554,102,3,1,4,75.0%,19m
6441,3,jack,3554,0,1,0,1,100.0%,7m
6441,2,[SSoSS]COLDMOON,3554,30,1,4,5,20.0%,9m
6441,2,[NastyB]Peter,3554,0,0,1,1,0.0%,34m
6441,2,deylon,3554,0,0,3,3,0.0%,33m
6455,2,[TwiLit]Berkly,3553,1626,345,326,671,51.4%,20m
6455,2,clthegoat,3553,1526,102,89,191,53.4%,6m
6455,2,Zerango,3553,901,97,94,191,50.8%,4m
6455,2,IIIIIIIIIIII,3553,1525,68,60,128,53.1%,14m
6455,2,[MaoTou]Geo,3553,1568,65,78,143,45.5%,27m
6455,2,[TmT4va]lilryu,3553,720,31,22,53,58.5%,17m
6455,2,rithosDOOM,3553,722,29,29,58,50.0%,36m
6455,2,Petrucci,3553,670,24,27,51,47.1%,14m
6455,2,Ultralisk,3553,328,13,8,21,61.9%,9m
6455,1,[Psychi]Autism,3553,188,9,3,12,75.0%,19m
6455,2,Alive,3553,212,7,5,12,58.3%,4m
6455,2,Quarms,3553,174,6,9,15,40.0%,2m
6455,3,GarsiTitan,3553,0,5,0,5,100.0%,34m
6455,3,KrulSan,3553,44,2,2,4,50.0%,18m
6455,2,Smelk,3553,102,2,2,4,50.0%,2m
6455,3,[2fps]Secret,3553,121,2,3,5,40.0%,12m
6455,2,[Khaoz]Catscratch,3553,88,1,1,2,50.0%,39m
6455,2,kappacheese,3553,88,1,1,2,50.0%,32m
6455,2,hollowberry,3553,0,0,1,1,0.0%,37m
6455,2,Shadowstorm,3553,0,0,1,1,0.0%,33m
6455,2,[aKlicK]Iordzeno,3553,0,0,6,6,0.0%,5m
6476,2,aRogueShark,3552,545,64,56,120,53.3%,22m
6476,2,[TGCF]erOsRAGE,3552,551,28,15,43,65.1%,9m
6476,2,[cl0udM]DeathByToss,3552,634,22,35,57,38.6%,31m
6476,2,FastWind,3552,460,21,16,37,56.8%,15m
6476,2,[Arcus]dwarfdudeguy,3552,180,6,8,14,42.9%,39m
6476,2,llllllllllll,3552,130,5,2,7,71.4%,31m
6476,1,Tyrant,3552,190,3,2,5,60.0%,35m
6476,2,fatboinbox,3552,60,3,3,6,50.0%,36m
6476,2,Gandalf,3552,30,2,2,4,50.0%,21m
6476,2,CptPlanet,3552,30,1,2,3,33.3%,14m
6476,2,[KGH]spargo,3552,73,1,3,4,25.0%,36m
6487,1,DarkCow,3551,1717,218,228,446,48.9%,38m
6487,1,[MOLES]Zac,3551,1759,135,162,297,45.5%,28m
6487,2,[UpxV]BEST,3551,1085,124,113,237,52.3%,37m
6487,2,[Doct]DocZed,3551,1184,67,66,133,50.4%,23m
6487,1,[YEEK]chigumnugets,3551,1018,61,52,113,54.0%,6m
6487,1,Ånemoi,3551,253,10,4,14,71.4%,27m
6487,2,Shadorunner,3551,202,8,6,14,57.1%,39m
6487,2,[iGx]kylebugg,3551,156,5,12,17,29.4%,17m
6487,3,lIlIlIIIIIll,3551,44,3,3,6,50.0%,14m
6487,2,Faiya,3551,30,2,2,4,50.0%,2m
6487,2,kkiatho,3551,0,1,0,1,100.0%,37m
6498,2,[flux]SaLT,3550,1663,77,68,145,53.1%,16m
6498,2,[Cryptc]RainbowDash,3550,420,73,72,145,50.3%,17m
6498,2,Mesina,3550,1062,49,34,83,59.0%,7m
6498,2,Moon,3550,539,31,14,45,68.9%,17m
6498,2,SirWhite,3550,457,23,11,34,67.6%,5m
6498,2,Ono,3550,396,19,9,28,67.9%,5m
6498,2,MwanPygmay,3550,287,16,7,23,69.6%,8m
6498,2,[M32]HOFF,3550,282,12,6,18,66.7%,39m
6498,2,Pdizzle,3550,229,8,5,13,61.5%,31m
6498,2,[neuroS]Reuter,3550,130,5,1,6,83.3%,2m
6498,2,IIIIIIIIII,3550,162,5,3,8,62.5%,16m
6498,2,IIIIIIIIIIII,3550,174,5,6,11,45.5%,22m
6498,2,[AbcCo]ATField,3550,130,4,1,5,80.0%,20m
6498,2,[DRFS]Sehun,3550,0,1,0,1,100.0%,33m
6498,2,nomad,3550,0,0,1,1,0.0%,12m
6498,2,Paranormal,3550,0,0,3,3,0.0%,42m
6514,2,sporei,3549,1351,148,131,279,53.0%,4m
6514,2,[BRSKR]Siumo,3549,876,69,72,141,48.9%,5m
6514,2,[GØSU]Daxon,3549,1508,66,62,128,51.6%,22m
6514,2,Metygl,3549,357,18,12,30,60.0%,11m
6514,2,Trillix,3549,208,17,19,36,47.2%,25m
6514,2,vapor,3549,165,6,4,10,60.0%,11m
6514,2,[DNKCFT]AlphaShark,3549,155,5,4,9,55.6%,31m
6514,2,Eun,3549,0,1,0,1,100.0%,2m
6514,2,[10KAC]Molonel,3549,0,1,0,1,100.0%,9m
6514,2,RastaPigg,3549,0,0,1,1,0.0%,14m
6524,2,FrostOasis,3548,1542,380,366,746,50.9%,41m
6524,2,kaymord,3548,765,56,43,99,56.6%,5m
6524,2,PuPPaBeaR,3548,1079,42,50,92,45.7%,36m
6524,2,SeriousAlex,3548,292,13,12,25,52.0%,28m
6524,2,[AZPK]Immortality,3548,153,5,3,8,62.5%,9m
6524,2,[ScSwrm]DonEladio,3548,127,3,2,5,60.0%,9m
6524,2,[tranni]SecsChanger,3548,128,3,4,7,42.9%,6m
6524,2,[X17]ShinGouki,3548,0,2,5,7,28.6%,27m
6524,1,Ahihi,3548,0,1,0,1,100.0%,12m
6524,2,Clockwork,3548,0,1,1,2,50.0%,35m
6524,2,[CNAKER]SadAndTired,3548,0,0,1,1,0.0%,15m
6524,2,[biboi]NecroN,3548,0,0,2,2,0.0%,12m
6536,2,TrOmpetA,3547,1665,225,224,449,50.1%,2m
6536,1,Koumei,3547,1681,161,174,335,48.1%,12m
6536,2,[JOOO]BaldSeagull,3547,1278,100,104,204,49.0%,41m
6536,2,Shivana,3547,575,28,21,49,57.1%,16m
6536,2,IIIIIIIIIIII,3547,496,22,16,38,57.9%,17m
6536,2,[Bee]Sharkbait,3547,279,12,5,17,70.6%,11m
6536,2,HanzoShiRon,3547,210,8,12,20,40.0%,2m
6536,2,sLeight,3547,116,4,0,4,100.0%,8m
6536,3,ARASTAFASTA,3547,0,4,1,5,80.0%,29m
6536,2,BacchusCone,3547,126,4,1,5,80.0%,7m
6536,2,StormGudUnit,3547,88,2,0,2,100.0%,39m
6536,2,yoggi,3547,88,2,1,3,66.7%,31m
6536,3,[425]DrW,3547,58,2,2,4,50.0%,40m
6536,2,[Weac]MinajestY,3547,0,1,0,1,100.0%,42m
6536,2,ClosedMyEyes,3547,0,1,0,1,100.0%,8m
6536,2,Zerg,3547,0,0,2,2,0.0%,2m
6536,2,[HECCKK]Pinxx,3547,0,0,3,3,0.0%,28m
6553,2,rNbOlicornjr,3546,1533,67,57,124,54.0%,36m
6553,2,[BRSKR]MUDABANG,3546,377,17,15,32,53.1%,31m
6553,3,Tweeter,3546,113,14,10,24,58.3%,18m
6553,2,MarineChien,3546,285,11,8,19,57.9%,39m
6553,3,Siegmar,3546,218,9,2,11,81.8%,7m
6553,2,Koringa,3546,180,6,14,20,30.0%,5m
6553,3,FrOsTy,3546,30,1,1,2,50.0%,13m
6553,2,Minerush,3546,0,0,2,2,0.0%,39m
6561,2,ShaCk,3545,1546,165,152,317,52.1%,17m
6561,2,Yang,3545,844,76,56,132,57.6%,3m
6561,2,irecu,3545,1107,67,68,135,49.6%,31m
6561,2,ggrim,3545,720,27,26,53,50.9%,32m
6561,2,porkythepig,3545,528,21,18,39,53.8%,27m
6561,3,SenpaiSugoi,3545,58,2,1,3,66.7%,28m
6561,3,[SoVA]DrBeeeeeez,3545,0,1,0,1,100.0%,24m
6561,2,Kain,3545,30,1,3,4,25.0%,37m
6561,2,[ØFoxF2]Matador,3545,30,1,5,6,16.7%,20m
6561,3,KibeXx,3545,0,0,1,1,0.0%,12m
6561,2,[HALFH]Starlet,3545,0,0,2,2,0.0%,41m
6572,2,Maplemox,3544,1190,184,166,350,52.6%,37m
6572,2,Inertia,3544,755,49,52,101,48.5%,35m
6572,2,HOUsE,3544,362,13,20,33,39.4%,17m
6572,1,[8kPLUS]KimJungNuke,3544,460,11,31,42,26.2%,39m
6572,2,[lXlXl]Crame,3544,146,8,8,16,50.0%,36m
6572,3,ELBERGALARGA,3544,0,4,1,5,80.0%,10m
6572,3,pEmBrY,3544,58,2,1,3,66.7%,40m
6572,3,snAck,3544,0,2,1,3,66.7%,27m
6572,3,Hippedfish,3544,0,1,0,1,100.0%,6m
6572,3,[Lowko]OldWhovian,3544,0,1,0,1,100.0%,40m
6572,3,Nameless,3544,0,0,1,1,0.0%,27m
6572,3,Zazu,3544,0,0,1,1,0.0%,2m
6572,2,[VDNKh]ElHenryettas,3544,0,0,2,2,0.0%,27m
6585,2,NoSkill,3543,1552,276,261,537,51.4%,24m
6585,2,brurururu,3543,1182,102,102,204,50.0%,28m
6585,2,TheRedBaron,3543,1609,89,92,181,49.2%,36m
6585,2,[JustFF]save,3543,288,11,15,26,42.3%,42m
6585,2,bnvjdmtnwqsn,3543,228,8,6,14,57.1%,7m
6585,2,Macrogasm,3543,193,7,5,12,58.3%,17m
6585,2,Punisher,3543,168,6,3,9,66.7%,2m
6585,3,[EhTeam]Duke,3543,0,3,2,5,60.0%,33m
6585,2,SOURDIESEL,3543,90,3,7,10,30.0%,2m
6585,3,[n0n1]Erebus,3543,0,1,0,1,100.0%,37m
6585,3,MrGigglez,3543,0,0,1,1,0.0%,5m
6585,3,[EtrOy]BiKeR,3543,0,0,1,1,0.0%,20m
6585,3,bRAINdeadMAN,3543,0,0,1,1,0.0%,38m
6598,1,Trickster,3542,1024,124,132,256,48.4%,11m
6598,2,[xNGx]WokeAssClown,3542,858,41,24,65,63.1%,10m
6598,2,[FlNE]Roblem,3542,307,12,11,23,52.2%,17m
6598,3,IronProtoss,3542,97,6,0,6,100.0%,23m
6598,2,NaCl,3542,58,3,4,7,42.9%,33m
6598,2,llllllllllll,3542,88,2,1,3,66.7%,2m
6598,2,Robo,3542,97,2,2,4,50.0%,41m
6598,3,[NEO]Divine,3542,0,1,0,1,100.0%,12m
6598,3,[SolOGS]iCore,3542,0,1,0,1,100.0%,5m
6598,1,SaYBoT,3542,48,1,10,11,9.1%,32m
6608,2,[kjk]ElmoKajaky,3541,1557,597,582,1179,50.6%,8m
6608,2,[GOPERÚ]zZz,3541,1571,109,106,215,50.7%,17m
6608,2,CaptainFlash,3541,460,17,20,37,45.9%,5m
6608,3,Root,3541,239,11,3,14,78.6%,32m
6608,2,Journey,3541,289,10,24,34,29.4%,28m
6608,2,[HØST]Koss,3541,120,4,6,10,40.0%,21m
6608,3,MISTERMASTER,3541,0,0,1,1,0.0%,27m
6615,3,Koloss,3540,519,130,158,288,45.1%,25m
6615,2,Dasboot,3540,1389,113,84,197,57.4%,26m
6615,2,[I3ro]Donjuancho,3540,874,39,35,74,52.7%,4m
6615,2,Nayr,3540,376,13,16,29,44.8%,39m
6615,2,FosTA,3540,286,12,12,24,50.0%,17m
6615,2,Eko,3540,96,4,10,14,28.6%,42m
6615,2,Spatzle,3540,58,2,6,8,25.0%,24m
6615,3,tugger,3540,30,1,1,2,50.0%,23m
6615,2,[CSUF]ImGMbtw,3540,0,1,1,2,50.0%,20m
6615,1,EdvanSchleck,3540,0,1,1,2,50.0%,34m
6615,2,[4eG]TheRedArmy,3540,0,0,3,3,0.0%,11m
6626,1,[GRU]christsaved,3539,1734,764,769,1533,49.8%,42m
6626,2,PenduLum,3539,1578,151,127,278,54.3%,17m
6626,2,[CRAKS]Hardwell,3539,1460,146,130,276,52.9%,28m
6626,2,ProtossOP,3539,559,86,8,94,91.5%,3m
6626,2,Happy,3539,376,17,9,26,65.4%,17m
6626,2,SnapChange,3539,320,12,13,25,48.0%,28m
6626,3,[3Drs]DocHolliday,3539,170,7,2,9,77.8%,28m
6626,2,[TØw]MrPig,3539,115,6,2,8,75.0%,30m
6626,3,[SIoth]KingDaydrA,3539,0,5,0,5,100.0%,36m
6626,3,Swayze,3539,116,4,4,8,50.0%,7m
6626,2,RoMbOsMaN,3539,0,0,2,2,0.0%,2m
6637,3,FuWeiKe,3538,435,52,40,92,56.5%,18m
6637,2,ConcepT,3538,771,34,26,60,56.7%,3m
6637,2,FrsknHarvest,3538,444,22,11,33,66.7%,9m
6637,3,cosmoton,3538,276,12,5,17,70.6%,24m
6637,2,[Worrmy]MJB,3538,198,11,16,27,40.7%,5m
6637,2,[Kappa0]Kappa,3538,164,9,11,20,45.0%,28m
6637,3,KurtBlock,3538,30,2,0,2,100.0%,40m
6637,3,[1E100]woodpanelptc,3538,30,2,0,2,100.0%,14m
6637,1,[JTAS]JTang,3538,118,2,1,3,66.7%,9m
6637,2,TigerYao,3538,102,2,2,4,50.0%,3m
6637,3,Yuugure,3538,0,1,0,1,100.0%,34m
6637,3,[DReeMZ]TheQuenster,3538,0,0,1,1,0.0%,24m
6637,3,[NAGARA]llllllllllll,3538,0,0,1,1,0.0%,39m
6637,2,[DaaBu]TedStyle,3538,0,0,3,3,0.0%,14m
6651,2,[SsaYnS]Yeena,3537,1364,168,163,331,50.8%,33m
6651,3,Raymond,3537,1460,130,120,250,52.0%,14m
6651,2,DarkTora,3537,1568,98,109,207,47.3%,41m
6651,2,[eXoPH]Coheeder,3537,1412,58,50,108,53.7%,22m
6651,2,noobprime,3537,1033,38,50,88,43.2%,5m
6651,2,Answer,3537,95,6,1,7,85.7%,5m
6651,3,bickenback,3537,114,5,1,6,83.3%,7m
6651,2,idol,3537,144,5,7,12,41.7%,29m
6651,2,PooCreator,3537,88,1,2,3,33.3%,20m
6651,2,[iMkS]WildWolf,3537,30,1,3,4,25.0%,19m
6651,3,SapperSam,3537,0,0,1,1,0.0%,4m
6662,2,Gfunk,3536,1618,207,191,398,52.0%,3m
6662,2,[GnR]GoodBoy,3536,1050,156,158,314,49.7%,28m
6662,3,Cheche,3536,357,16,9,25,64.0%,16m
6662,1,Nivek,3536,192,9,3,12,75.0%,12m
6662,1,[LoF]NeoShine,3536,302,8,42,50,16.0%,11m
6662,2,[Cryptc]KRUM,3536,219,7,6,13,53.8%,11m
6662,3,noobforever,3536,88,4,2,6,66.7%,23m
6662,3,[scMAUI]Razer,3536,0,3,2,5,60.0%,27m
6662,3,DatGuyGaming,3536,30,2,1,3,66.7%,9m
6662,3,FaceBones,3536,30,2,1,3,66.7%,15m
6662,3,Robot,3536,58,2,2,4,50.0%,25m
6662,3,Werner,3536,0,0,1,1,0.0%,40m
6662,2,trreva,3536,0,0,2,2,0.0%,28m
6675,2,Poi,3535,1523,224,234,458,48.9%,16m
6675,3,[SsaYnS]SabeRLighT,3535,682,31,14,45,68.9%,32m
6675,2,Ayona,3535,643,24,24,48,50.0%,11m
6675,2,MKultra,3535,217,21,17,38,55.3%,9m
6675,2,[iDrunk]AlexRodd,3535,574,20,22,42,47.6%,19m
6675,3,shinya,3535,290,11,6,17,64.7%,5m
6675,2,[DhZPro]MATADORSCII,3535,312,11,16,27,40.7%,25m
6675,3,ogogo,3535,0,5,0,5,100.0%,28m
6675,3,Fallout,3535,196,5,6,11,45.5%,34m
6675,3,HiO,3535,0,4,1,5,80.0%,24m
6675,2,[TGosuB]NoveaStar,3535,128,4,3,7,57.1%,5m
6675,3,[tr0n]TheZealot,3535,58,3,2,5,60.0%,16m
6675,2,[Toss]LifeforAihr,3535,0,1,1,2,50.0%,27m
6675,1,Kaeii,3535,0,0,1,1,0.0%,17m
6675,3,[xHonor]SCOOG,3535,0,0,1,1,0.0%,40m
6675,3,yukit,3535,0,0,1,1,0.0%,10m
6691,3,[NeOx1]resOrt,3534,936,74,58,132,56.1%,10m
6691,2,Netminder,3534,1560,71,69,140,50.7%,24m
6691,2,SoulLight,3534,1014,33,50,83,39.8%,32m
6691,2,Stormwing,3534,406,16,12,28,57.1%,19m
6691,2,GummyBear,3534,296,10,16,26,38.5%,27m
6691,2,LevarBurton,3534,105,3,4,7,42.9%,3m
6691,2,bigdickdan,3534,20,2,5,7,28.6%,5m
6691,3,Zombieloco,3534,0,1,0,1,100.0%,27m
6691,3,chippedstick,3534,0,0,1,1,0.0%,23m
6700,2,Dangeresque,3533,1569,250,237,487,51.3%,25m
6700,2,[2Hott]Daddy,3533,1615,215,193,408,52.7%,19m
6700,2,VoidTerror,3533,704,50,48,98,51.0%,36m
6700,2,ZerGUseR,3533,777,41,38,79,51.9%,28m
6700,2,boubou,3533,900,40,33,73,54.8%,28m
6700,2,LENOX,3533,626,28,17,45,62.2%,17m
6700,2,aaa,3533,561,22,16,38,57.9%,39m
6700,2,[αXLa]TuPadrastroG,3533,268,12,6,18,66.7%,16m
6700,2,Ray,3533,150,4,4,8,50.0%,33m
6700,2,Null,3533,28,3,7,10,30.0%,12m
6710,2,TheJhnny,3532,1588,327,301,628,52.1%,35m
6710,2,[nHm]cheeez,3532,1343,94,95,189,49.7%,33m
6710,2,[FxB]zil,3532,1107,44,39,83,53.0%,2m
6710,2,Jpat,3532,227,7,7,14,50.0%,41m
6710,3,LanKa,3532,0,1,0,1,100.0%,24m
6710,2,CanRancio,3532,0,0,3,3,0.0%,25m
6716,3,Hobnob,3531,486,23,22,45,51.1%,18m
6716,2,Microman,3531,242,8,7,15,53.3%,19m
6716,2,[Imao]KuR,3531,178,7,5,12,58.3%,31m
6716,2,TYRBOMAX,3531,95,6,1,7,85.7%,11m
6716,2,holaqhace,3531,30,1,4,5,20.0%,2m
6721,2,Brid,3530,1020,76,42,118,64.4%,42m
6721,2,ICBreaker,3530,510,25,24,49,51.0%,25m
6721,2,[DarkAG]Dath,3530,504,23,14,37,62.2%,31m
6721,3,[NwAs]Draconix,3530,620,23,19,42,54.8%,38m
6721,3,[TCool]Blinky,3530,311,13,9,22,59.1%,31m
6721,2,[Twitch]joenrv,3530,290,10,16,26,38.5%,24m
6721,2,Snuffles,3530,195,8,16,24,33.3%,36m
6721,3,[TAOKIT]Razzag,3530,0,5,0,5,100.0%,35m
6721,3,Cheeseysheep,3530,0,5,0,5,100.0%,23m
6721,2,[FIow]Synergyst,3530,116,5,10,15,33.3%,8m
6721,1,lIllllIIIlll,3530,122,4,7,11,36.4%,16m
6721,3,[Flam3s]Nuria,3530,30,1,1,2,50.0%,10m
6721,2,MyLove,3530,0,1,1,2,50.0%,30m
6721,2,barcode,3530,30,1,7,8,12.5%,28m
6735,2,Gimpy,3529,1540,233,230,463,50.3%,41m
6735,2,bofish,3529,1181,154,124,278,55.4%,35m
6735,2,[FxB]DJCylon,3529,1570,129,100,229,56.3%,9m
6735,2,Timmybob,3529,828,56,53,109,51.4%,16m
6735,2,Ghoulez,3529,587,23,19,42,54.8%,9m
6735,2,WildKitten,3529,143,7,2,9,77.8%,13m
6735,3,Zeta,3529,0,5,0,5,100.0%,26m
6735,3,Narag,3529,0,1,0,1,100.0%,5m
6743,2,[Pig2]MAsterDekoy,3528,374,39,36,75,52.0%,22m
6743,2,Genetron,3528,242,12,7,19,63.2%,26m
6743,3,PigeonWrench,3528,0,5,0,5,100.0%,30m
6743,2,gsl,3528,0,0,3,3,0.0%,14m
6747,1,SCBoyIsRich,3527,1678,427,438,865,49.4%,4m
6747,2,[Kusshh]Borg,3527,1410,306,290,596,51.3%,33m
6747,2,sleepybear,3527,1522,99,92,191,51.8%,25m
6747,2,JWei,3527,1426,86,83,169,50.9%,3m
6747,2,cooc,3527,518,19,25,44,43.2%,13m
6747,2,Keir,3527,102,6,2,8,75.0%,22m
6747,3,Paru,3527,106,5,0,5,100.0%,24m
6754,2,hero,3526,530,51,36,87,58.6%,39m
6754,2,TastyNaysty,3526,514,17,32,49,34.7%,39m
6754,3,Jameisa,3526,243,14,8,22,63.6%,23m
6754,3,SqrtOneToOne,3526,193,5,2,7,71.4%,32m
6754,1,Steeev,3526,166,5,2,7,71.4%,9m
6754,2,Topre,3526,102,2,4,6,33.3%,3m
6754,3,probeslol,3526,0,1,0,1,100.0%,15m
6754,3,[NAGARA]Nyaong,3526,0,1,0,1,100.0%,28m
6754,2,IIIIIIIIIII,3526,0,1,3,4,25.0%,20m
6754,3,[SCTues]MrSleep,3526,0,0,1,1,0.0%,5m
6754,2,reddiyx,3526,0,0,2,2,0.0%,20m
6765,2,blankman,3525,558,162,164,326,49.7%,21m
6765,2,Arcuses,3525,1475,121,122,243,49.8%,28m
6765,2,uSleepiCreep,3525,1213,47,45,92,51.1%,31m
6765,2,JungleViet,3525,544,43,34,77,55.8%,16m
6765,2,Myoos,3525,512,18,25,43,41.9%,31m
6765,2,Speight,3525,417,15,14,29,51.7%,37m
6765,2,[SWAG88]Devotee,3525,238,10,9,19,52.6%,15m
6765,1,fatjason,3525,234,7,3,10,70.0%,4m
6765,3,Gtoss,3525,102,4,3,7,57.1%,7m
6765,2,schuter,3525,45,4,11,15,26.7%,7m
6765,2,ForceMajeure,3525,68,3,6,9,33.3%,19m
6765,2,Gibs,3525,0,1,8,9,11.1%,3m
6765,3,[lLiTl]Veryrare,3525,0,0,1,1,0.0%,13m
6765,3,[Sx2]GameOfMoans,3525,0,0,2,2,0.0%,2m
6779,2,Clockwork,3524,1616,492,484,976,50.4%,31m
6779,2,IIIIIIIIIIII,3524,1472,125,120,245,51.0%,7m
6779,2,DarkMenace,3524,1087,69,70,139,49.6%,26m
6779,2,[GGBGll]SColddriver,3524,448,53,55,108,49.1%,9m
6779,2,Projectt,3524,828,41,40,81,50.6%,26m
6779,2,Fatsmurf,3524,727,35,29,64,54.7%,7m
6779,3,TwoStroke,3524,412,16,15,31,51.6%,17m
6779,3,Chamillitary,3524,362,14,7,21,66.7%,3m
6779,3,[GRNSKN]ClockWise,3524,0,5,0,5,100.0%,3m
6779,2,[6KiNGS]ForTheGlory,3524,164,4,5,9,44.4%,28m
6779,2,[Hihihi]Moranjo,3524,60,3,3,6,50.0%,3m
6779,2,Koro,3524,88,1,2,3,33.3%,22m
6779,3,Kyezer,3524,0,0,1,1,0.0%,13m
6779,3,Faust,3524,0,0,1,1,0.0%,14m
6793,2,TheLionEye,3523,1648,279,248,527,52.9%,17m
6793,2,Saga,3523,1240,71,70,141,50.4%,7m
6793,2,Gluon,3523,1566,62,57,119,52.1%,20m
6793,2,[CRAKS]Ferreira,3523,836,30,33,63,47.6%,25m
6793,3,[CHET]elnuevotio,3523,360,15,8,23,65.2%,9m
6793,2,[LGNxx]FosTA,3523,184,7,10,17,41.2%,10m
6793,3,[BRSKR]Paloma,3523,30,4,3,7,57.1%,32m
6793,2,JoshGordon,3523,120,4,8,12,33.3%,20m
6793,2,Ometeotl,3523,0,1,0,1,100.0%,24m
6793,3,[KiMBR]UhPapaiChego,3523,0,0,1,1,0.0%,29m
6803,2,[GOPERÚ]jSeA,3522,746,54,69,123,43.9%,27m
6803,2,AverageJoe,3522,692,24,31,55,43.6%,13m
6803,2,LykingsProTV,3522,227,11,7,18,61.1%,16m
6803,1,McMuffin,3522,296,10,3,13,76.9%,22m
6803,3,[Th3Bad]TarcísioXD,3522,142,6,5,11,54.5%,8m
6803,2,Kale,3522,144,5,12,17,29.4%,39m
6803,2,wham,3522,60,3,8,11,27.3%,16m
6803,3,[731]Underdog,3522,0,1,1,2,50.0%,35m
6803,3,holololol,3522,0,1,1,2,50.0%,32m
6803,3,[RØR]HankeL,3522,0,0,1,1,0.0%,2m
6813,2,MAP,3521,1489,118,105,223,52.9%,24m
6813,3,Jaysic,3521,1318,72,64,136,52.9%,24m
6813,2,[ISwPI]Yankla,3521,929,34,40,74,45.9%,40m
6813,2,[NPhase]money,3521,524,18,19,37,48.6%,39m
6813,2,Seahorse,3521,198,7,10,17,41.2%,14m
6813,3,jelen,3521,0,5,0,5,100.0%,39m
6813,3,Retsof,3521,58,3,4,7,42.9%,9m
6813,2,MannyOwnz,3521,102,2,3,5,40.0%,36m
6813,3,ThorRush,3521,0,0,1,1,0.0%,10m
6813,2,[HAVING]DejaVu,3521,0,0,3,3,0.0%,30m
6823,2,VaeVictisSC,3520,1597,324,313,637,50.9%,8m
6823,3,[ZTempz]GeneralGreat,3520,1650,310,282,592,52.4%,37m
6823,2,Dards,3520,1576,150,142,292,51.4%,36m
6823,2,Philly,3520,1504,127,128,255,49.8%,41m
6823,2,[WOTDL]zergio,3520,1447,95,93,188,50.5%,4m
6823,2,[NEVG]Cbog,3520,850,84,80,164,51.2%,41m
6823,2,darxon,3520,1596,83,88,171,48.5%,27m
6823,2,Free,3520,1338,48,55,103,46.6%,24m
6823,2,lGoDaRkMaNll,3520,618,26,20,46,56.5%,14m
6823,2,[SyLx]Valon,3520,391,18,17,35,51.4%,28m
6823,2,[AXIOS]llllllllllll,3520,324,12,17,29,41.4%,2m
6823,3,[MEP]JokeR,3520,0,5,0,5,100.0%,24m
6823,2,Zerg,3520,211,5,14,19,26.3%,9m
6823,3,[TSDSB]Bonjwa,3520,60,4,5,9,44.4%,7m
6823,3,Nfinite,3520,88,3,2,5,60.0%,6m
6823,3,[Ari0n]Iceman,3520,88,3,3,6,50.0%,3m
6839,2,McBreez,3519,1524,239,233,472,50.6%,25m
6839,2,[NFLDs]Imperator,3519,1539,236,217,453,52.1%,6m
6839,2,[GRNSKN]CottonCannon,3519,1420,144,127,271,53.1%,11m
6839,2,[cocogr]Quintus,3519,1429,130,122,252,51.6%,11m
6839,2,[CHlMP]BIGPHARMACY,3519,1552,93,100,193,48.2%,14m
6839,2,Claydoh,3519,582,26,23,49,53.1%,22m
6839,2,[FR0ZN]BBuinG,3519,489,21,15,36,58.3%,11m
6839,2,[cl0udM]CowboyDan,3519,421,20,22,42,47.6%,16m
6839,3,NoScared,3519,341,14,4,18,77.8%,28m
6839,3,FKU,3519,0,5,0,5,100.0%,10m
6839,2,[PMN]Lockdown,3519,140,3,4,7,42.9%,40m
6839,2,IIIIIIIII,3519,0,1,0,1,100.0%,39m
6839,3,killerp,3519,0,0,1,1,0.0%,23m
6852,1,[TATR]Toasty,3518,1014,152,168,320,47.5%,13m
6852,2,Zero,3518,654,26,24,50,52.0%,19m
6852,3,[SYNCg]ninja,3518,310,12,6,18,66.7%,37m
6852,3,[IlTClI]Medabee,3518,0,1,0,1,100.0%,39m
6852,3,[neuroW]omegatrox,3518,0,1,0,1,100.0%,41m
6852,2,UncleDrew,3518,30,1,4,5,20.0%,24m
6852,3,Tanthony,3518,0,0,1,1,0.0%,8m
6852,3,[DhZPro]Frazzato,3518,0,0,2,2,0.0%,27m
6860,2,mkultra,3517,1135,100,93,193,51.8%,40m
6860,2,[xnSx]SpkrFrDead,3517,1053,74,73,147,50.3%,7m
6860,2,SCHardNips,3517,707,45,52,97,46.4%,42m
6860,2,[GHS]HideYoKids,3517,231,8,9,17,47.1%,15m
6860,2,[Causha]Papuchulo,3517,206,8,16,24,33.3%,4m
6860,3,boombledoor,3517,109,5,1,6,83.3%,42m
6860,2,Forgotten,3517,118,4,12,16,25.0%,20m
6860,2,[DarkAG]Ace,3517,144,3,6,9,33.3%,30m
6860,3,[Enrika]DAGAWD,3517,60,2,2,4,50.0%,2m
6860,3,UdUwUdU,3517,60,2,4,6,33.3%,38m
6860,3,Solareon,3517,30,1,1,2,50.0%,20m
6860,3,YakuzaMan,3517,0,0,1,1,0.0%,6m
6860,1,[Mc]Ringeril,3517,0,0,3,3,0.0%,21m
6873,2,HappyNomad,3516,1529,281,272,553,50.8%,24m
6873,3,csko,3516,537,34,23,57,59.6%,36m
6873,3,[YD2K]You,3516,820,34,27,61,55.7%,14m
6873,3,add,3516,228,9,6,15,60.0%,39m
6873,3,[Necrtc]Nationalitty,3516,176,7,5,12,58.3%,23m
6873,3,avraL,3516,114,4,1,5,80.0%,23m
6873,1,VotePlease,3516,140,3,1,4,75.0%,36m
6873,2,Quaitemes,3516,114,3,3,6,50.0%,29m
6873,3,MrTadpole,3516,30,2,0,2,100.0%,13m
6873,1,[FEETww]FEETLOVER,3516,0,1,3,4,25.0%,9m
6873,3,Kevanche,3516,0,0,1,1,0.0%,23m
6873,3,[MBTV]Max,3516,0,0,1,1,0.0%,28m
6873,3,LovelyCaTTT,3516,0,0,1,1,0.0%,5m
6886,2,Glaxon,3515,1244,361,353,714,50.6%,32m
6886,2,[ZTempz]Taucer,3515,1351,173,165,338,51.2%,27m
6886,2,thestorm,3515,1548,138,131,269,51.3%,11m
6886,3,[MBRFN]KaRkhas,3515,719,33,21,54,61.1%,31m
6886,2,llllllllllll,3515,306,23,32,55,41.8%,9m
6886,3,[AbcCo]AxelGun,3515,254,10,6,16,62.5%,20m
6886,2,lemonseeds,3515,176,7,8,15,46.7%,36m
6886,3,Thorpe,3515,0,5,0,5,100.0%,12m
6886,2,chop,3515,158,5,4,9,55.6%,3m
6886,2,KiRuZ,3515,138,3,5,8,37.5%,22m
6886,3,ZIPPLE,3515,0,0,1,1,0.0%,28m
6886,3,Coleslaw,3515,0,0,2,2,0.0%,24m
6886,2,Artex,3515,0,0,4,4,0.0%,14m
6899,2,[Hayze]ARedTornadO,3514,1369,158,151,309,51.1%,39m
6899,2,DOOM,3514,1337,122,102,224,54.5%,16m
6899,2,Redfred,3514,609,41,35,76,53.9%,41m
6899,3,[FlixC]FelaFlawless,3514,350,13,13,26,50.0%,14m
6899,2,Promatic,3514,217,9,16,25,36.0%,2m
6899,3,[IMDSI]RAMEN,3514,58,3,2,5,60.0%,6m
6899,2,Cheo,3514,0,0,2,2,0.0%,6m
6906,3,[xCMx]snakeyes,3513,1646,358,332,690,51.9%,18m
6906,2,LeoMinelli,3513,1215,88,75,163,54.0%,26m
6906,2,dragoncow,3513,264,74,78,152,48.7%,7m
6906,3,MilkyWay,3513,1033,55,74,129,42.6%,13m
6906,2,Humide,3513,400,41,31,72,56.9%,14m
6906,2,Ale,3513,972,40,37,77,51.9%,33m
6906,3,[PobSC]Miracle,3513,607,27,14,41,65.9%,23m
6906,3,[LEATHR]xoultimaox,3513,460,17,17,34,50.0%,26m
6906,3,FlashPoinT,3513,194,13,13,26,50.0%,38m
6906,3,[FrnkZ]Wuler,3513,0,5,0,5,100.0%,22m
6906,2,[BETAAA]DAP,3513,154,5,4,9,55.6%,30m
6906,3,Sad,3513,30,3,1,4,75.0%,31m
6906,3,llIlIHillIl,3513,97,2,3,5,40.0%,2m
6906,3,Shadow,3513,0,1,0,1,100.0%,17m
6906,3,JubilantCows,3513,30,1,1,2,50.0%,27m
6906,3,Napoleon,3513,0,1,1,2,50.0%,39m
6906,3,[DGiT]BloodToxin,3513,0,0,2,2,0.0%,37m
6923,2,[SsaYnS]Elyk,3512,1544,217,221,438,49.5%,41m
6923,2,[CN123]LSAIsLoser,3512,570,72,83,155,46.5%,19m
6923,2,[TRETER]Wavic,3512,429,18,24,42,42.9%,26m
6923,3,Fuddard,3512,301,14,4,18,77.8%,36m
6923,2,Wolvrine,3512,397,14,25,39,35.9%,33m
6923,2,[HaCoLa]Krabator,3512,305,11,10,21,52.4%,14m
6923,3,MENAT,3512,0,1,0,1,100.0%,35m
6923,3,AAAXVIII,3512,0,0,1,1,0.0%,13m
6931,2,raVage,3511,1424,478,470,948,50.4%,15m
6931,2,MaDmAn,3511,1407,82,76,158,51.9%,29m
6931,2,[RdLzrd]LindyHopper,3511,241,38,41,79,48.1%,3m
6931,2,[xdface]Xaxziminrax,3511,599,25,19,44,56.8%,16m
6931,3,jyoung,3511,0,5,0,5,100.0%,40m
6931,3,TAChadMann,3511,0,4,0,4,100.0%,6m
6931,3,Kirsi,3511,114,4,2,6,66.7%,36m
6931,3,TaNk,3511,87,4,4,8,50.0%,35m
6931,2,[FnaTYC]LaPAJArita,3511,114,3,3,6,50.0%,36m
6931,3,MisterUp,3511,0,0,1,1,0.0%,34m
6931,3,BFBCAcid,3511,0,0,1,1,0.0%,10m
6931,3,Drew,3511,0,0,2,2,0.0%,40m
6943,2,Xerum,3510,1392,321,297,618,51.9%,3m
6943,2,[PiGPan]Draknas,3510,1627,302,289,591,51.1%,28m
6943,2,joinDSAbro,3510,1516,300,282,582,51.5%,25m
6943,2,Schism,3510,926,35,34,69,50.7%,25m
6943,2,Ronnie,3510,510,17,24,41,41.5%,24m
6943,2,[BCBZ]FRSKN,3510,318,11,13,24,45.8%,14m
6943,3,[FyH]VxKENJIxV,3510,90,3,4,7,42.9%,16m
6943,3,[bsaur]Fylypek,3510,0,0,2,2,0.0%,21m
6951,2,Neo,3509,1496,99,96,195,50.8%,22m
6951,3,[deezy]Cenanin,3509,246,24,10,34,70.6%,17m
6951,3,marman,3509,397,18,8,26,69.2%,28m
6951,2,Parsirius,3509,289,16,10,26,61.5%,14m
6951,3,HellraiserX,3509,290,11,7,18,61.1%,39m
6951,2,JUNE,3509,166,10,5,15,66.7%,20m
6951,2,Rionash,3509,208,8,10,18,44.4%,11m
6951,3,Deidara,3509,58,5,1,6,83.3%,13m
6951,2,Protocalz,3509,142,4,4,8,50.0%,4m
6951,2,Malloc,3509,122,4,8,12,33.3%,2m
6951,2,[OutNow]Savagewood,3509,163,3,11,14,21.4%,14m
6951,2,Mevangel,3509,0,1,3,4,25.0%,9m
6951,3,[ZDE20]Shrient,3509,30,1,3,4,25.0%,36m
6951,2,[PB789]PBPB,3509,0,1,5,6,16.7%,27m
6951,2,AleeM,3509,30,1,7,8,12.5%,9m
6951,3,[Rated]Jakolokol,3509,0,0,1,1,0.0%,28m
6951,3,baptistjeon,3509,0,0,1,1,0.0%,24m
6951,3,Mukaman,3509,0,0,2,2,0.0%,38m
6969,2,[Lotr1]Idonotexist,3508,601,114,96,210,54.3%,3m
6969,2,ggTOP,3508,354,17,11,28,60.7%,11m
6969,3,IIIIIIIIIIII,3508,170,6,7,13,46.2%,16m
6969,3,LuckyX,3508,0,5,0,5,100.0%,24m
6969,3,BUCROGERS,3508,118,4,3,7,57.1%,21m
6969,3,[BoRnGo]Treetop,3508,60,3,1,4,75.0%,23m
6969,3,llllllllllll,3508,97,3,3,6,50.0%,10m
6969,3,Hypsh,3508,30,2,2,4,50.0%,18m
6969,3,Laonzena,3508,58,2,4,6,33.3%,35m
6969,2,Hornuvore,3508,114,2,5,7,28.6%,24m
6969,2,Yuyeng,3508,0,1,3,4,25.0%,9m
6969,3,Serpa,3508,0,0,5,5,0.0%,14m
6981,2,ENaSSaJJaGa,3507,1505,200,206,406,49.3%,7m
6981,3,Young,3507,573,38,18,56,67.9%,23m
6981,2,[GCPlus]Floating,3507,530,33,17,50,66.0%,41m
6981,2,[FMX]SmoOkeR,3507,596,28,18,46,60.9%,7m
6981,2,[KA0S]ShadowMaster,3507,265,27,17,44,61.4%,9m
6981,2,SputniK,3507,496,19,21,40,47.5%,16m
6981,2,HornRaven,3507,238,19,24,43,44.2%,9m
6981,2,Gruyere,3507,342,17,13,30,56.7%,4m
6981,3,[Chibii]Marcy,3507,362,14,8,22,63.6%,40m
6981,2,[JUGOS]PERCYE,3507,156,5,10,15,33.3%,15m
6981,3,OfrParis,3507,0,1,0,1,100.0%,10m
6981,3,kokoro,3507,0,1,0,1,100.0%,3m
6981,3,TezzeretEX,3507,0,1,0,1,100.0%,36m
6981,3,MadDog,3507,30,1,2,3,33.3%,29m
6981,3,JoKer,3507,0,0,1,1,0.0%,8m
6981,3,[Tizy]NuKLeO,3507,0,0,2,2,0.0%,35m
6981,2,Babuined,3507,0,0,4,4,0.0%,36m
6998,2,regenttennis,3506,1654,536,515,1051,51.0%,19m
6998,2,LINGFLOOD,3506,1542,115,77,192,59.9%,20m
6998,2,Lancelot,3506,870,60,64,124,48.4%,28m
6998,3,Lasagna,3506,1168,52,34,86,60.5%,36m
6998,2,Cygnus,3506,577,51,47,98,52.0%,11m
6998,2,[neuroS]Gamesythe,3506,235,12,7,19,63.2%,37m
6998,2,[syrup]rev,3506,224,7,7,14,50.0%,35m
6998,2,[DblXB]ViNE,3506,180,6,15,21,28.6%,28m
6998,2,[MWM]miomamo,3506,151,5,9,14,35.7%,31m
6998,3,jason,3506,58,2,1,3,66.7%,31m
6998,3,[FateTw]Chance,3506,0,1,0,1,100.0%,21m
6998,2,Sosh,3506,30,1,4,5,20.0%,35m
6998,3,KingStar,3506,0,0,1,1,0.0%,5m
7011,2,Davezis,3505,1533,145,130,275,52.7%,20m
7011,2,ItachiUchiha,3505,423,120,116,236,50.8%,11m
7011,3,Alex,3505,1625,87,82,169,51.5%,11m
7011,2,[GDJ]DrunkMaster,3505,448,27,21,48,56.2%,16m
7011,3,darkks,3505,604,26,16,42,61.9%,31m
7011,3,koo,3505,485,24,22,46,52.2%,32m
7011,2,[RTN]FireFerret,3505,604,19,32,51,37.3%,16m
7011,3,MorningLappy,3505,0,3,3,6,50.0%,40m
7011,2,KuDoS,3505,128,3,4,7,42.9%,12m
7011,3,[DGKR]AngeL,3505,30,1,1,2,50.0%,38m
7011,3,[2B1S]Mercenary,3505,0,0,1,1,0.0%,37m
7022,2,TestinTerran,3504,1351,101,87,188,53.7%,5m
7022,2,GhTakahashi,3504,432,15,15,30,50.0%,19m
7022,2,Vales,3504,298,14,18,32,43.8%,14m
7022,3,Andi,3504,304,12,6,18,66.7%,12m
7022,2,[USofAY]Chan,3504,207,12,11,23,52.2%,17m
7022,3,Slim,3504,121,6,1,7,85.7%,29m
7022,3,[UpeV]Radstok,3504,88,4,3,7,57.1%,29m
7022,2,Seowal,3504,0,3,3,6,50.0%,37m
7022,3,DsgradorAnos,3504,30,1,1,2,50.0%,40m
7022,3,[flyrev]flyrev,3504,0,0,2,2,0.0%,28m
7032,2,[NrFms]schenry,3503,1355,250,219,469,53.3%,26m
7032,2,AnonymousODG,3503,1453,218,206,424,51.4%,7m
7032,2,Geo,3503,818,218,216,434,50.2%,16m
7032,2,[TWGoGo]Apple,3503,1337,88,103,191,46.1%,9m
7032,2,Player,3503,349,17,12,29,58.6%,12m
7032,2,[TheRs]LiberTea,3503,270,10,15,25,40.0%,17m
7032,2,Zannall,3503,246,8,10,18,44.4%,37m
7032,2,snotrag,3503,256,8,13,21,38.1%,16m
7032,2,CasualEyes,3503,58,7,3,10,70.0%,30m
7032,3,Bushwack,3503,30,2,1,3,66.7%,27m
7032,3,[UCI]QuickDraw,3503,0,0,1,1,0.0%,3m
7032,3,mergipe,3503,0,0,2,2,0.0%,40m
7044,1,Billy,3502,1703,440,452,892,49.3%,29m
7044,2,herozergling,3502,1511,244,230,474,51.5%,39m
7044,2,[Natty]LittleTyrant,3502,1568,112,115,227,49.3%,16m
7044,2,BananaMunkey,3502,935,66,54,120,55.0%,36m
7044,2,SaAr,3502,660,24,30,54,44.4%,33m
7044,2,IamMrV,3502,394,18,19,37,48.6%,22m
7044,3,iNpassiNg,3502,0,5,0,5,100.0%,8m
7044,3,Lock,3502,140,5,6,11,45.5%,24m
7044,3,Off,3502,60,3,4,7,42.9%,14m
7044,2,Hysteric,3502,58,2,6,8,25.0%,39m
7044,2,DuckStation,3502,60,2,8,10,20.0%,9m
7044,3,DoubleTwice,3502,0,0,1,1,0.0%,40m
7044,3,[GGBr0]starzzang,3502,0,0,1,1,0.0%,3m
7057,2,SPOON,3501,1560,194,180,374,51.9%,7m
7057,2,RyderB,3501,1088,138,141,279,49.5%,9m
7057,2,[EoMX]Goza,3501,1538,126,136,262,48.1%,28m
7057,2,retallicka,3501,1629,106,108,214,49.5%,2m
7057,2,Imbatman,3501,1493,80,74,154,51.9%,4m
7057,2,Overkill,3501,1077,58,69,127,45.7%,5m
7057,2,[ValidG]GrumpyGills,3501,975,35,48,83,42.2%,40m
7057,3,PapaSmurf,3501,30,6,1,7,85.7%,8m
7057,3,Inconsistent,3501,0,5,0,5,100.0%,20m
7057,1,Rose,3501,170,5,7,12,41.7%,40m
7057,3,Stingray,3501,30,1,2,3,33.3%,21m
7068,3,cica,3500,1601,156,131,287,54.4%,35m
7068,2,Damach,3500,1533,80,85,165,48.5%,11m
7068,2,diamondDRG,3500,669,52,52,104,50.0%,15m
7068,3,[Krimsn]nevc,3500,470,21,7,28,75.0%,6m
7068,2,Trunker,3500,127,17,17,34,50.0%,33m
7068,3,Priism,3500,358,16,14,30,53.3%,27m
7068,3,[AoBDE]Lolsawraus,3500,326,12,6,18,66.7%,3m
7068,3,DoubleOreo,3500,58,3,0,3,100.0%,18m
7068,2,boombacs,3500,30,2,4,6,33.3%,28m
7068,3,[RBBois]Oodoacer,3500,0,0,1,1,0.0%,25m
7068,2,JustAFrog,3500,0,0,3,3,0.0%,11m
7079,3,[iMkS]SpartanCL,3499,1419,97,80,177,54.8%,31m
7079,2,[TgAg]Flash,3499,340,12,11,23,52.2%,9m
7079,2,napalmEye,3499,141,8,3,11,72.7%,31m
7079,2,NachosDelQue,3499,189,5,3,8,62.5%,30m
7079,3,Chumbawamba,3499,86,3,2,5,60.0%,16m
7079,3,[Akita]CultOfCroft,3499,69,3,3,6,50.0%,17m
7079,3,glacier,3499,30,1,1,2,50.0%,31m
7079,3,Bife,3499,0,1,2,3,33.3%,20m
7079,2,Tsunami,3499,0,1,3,4,25.0%,9m
7079,3,[Profet]Millerah,3499,0,0,1,1,0.0%,28m
7079,3,[GOCHOO]SilverSide,3499,0,0,1,1,0.0%,3m
7079,3,QontroL,3499,0,0,1,1,0.0%,12m
7091,2,RedOS,3498,1563,73,67,140,52.1%,36m
7091,3,[Th3Bad]Zittus,3498,747,48,35,83,57.8%,37m
7091,3,Nebulae,3498,970,36,33,69,52.2%,29m
7091,3,[TXOP]SpaCePanTs,3498,440,17,11,28,60.7%,19m
7091,3,Kitten,3498,314,11,8,19,57.9%,28m
7091,2,BoosterGold,3498,207,7,3,10,70.0%,20m
7091,3,[Shardz]ThatOneDude,3498,118,5,5,10,50.0%,25m
7091,2,Cracks,3498,152,5,10,15,33.3%,14m
7091,3,[TDDS]dahiJa,3498,60,3,2,5,60.0%,15m
7091,3,Zlord,3498,0,1,0,1,100.0%,28m
7091,3,[DRKNS]LucaDeSupply,3498,0,1,1,2,50.0%,29m
7091,3,Thoraevin,3498,30,1,2,3,33.3%,34m
7091,3,[LoSD]KUSHmasterJ,3498,30,1,3,4,25.0%,26m
7091,3,[d1ldo]Tonkatwuck,3498,0,0,2,2,0.0%,4m
7105,2,Xop,3497,950,180,161,341,52.8%,11m
7105,2,[X17]WryWonder,3497,1555,169,167,336,50.3%,16m
7105,2,[KoML]OlorinIstari,3497,985,127,112,239,53.1%,12m
7105,3,[CTCiav]MKiller,3497,1194,99,61,160,61.9%,2m
7105,2,[Day]Nine,3497,809,34,30,64,53.1%,11m
7105,2,[Fellaz]Jaguar,3497,661,28,22,50,56.0%,24m
7105,3,[Q4Life]TheDragon,3497,226,13,5,18,72.2%,41m
7105,2,redruM,3497,214,12,15,27,44.4%,9m
7105,2,[DRL]Jojbean,3497,290,11,9,20,55.0%,24m
7105,2,[αB]LOTB,3497,0,0,3,3,0.0%,11m
7115,2,zergberg,3496,1550,583,558,1141,51.1%,11m
7115,3,[GGKs]STON,3496,458,20,12,32,62.5%,4m
7115,2,[FZ]Bagelz,3496,498,20,15,35,57.1%,13m
7115,2,idea,3496,406,17,21,38,44.7%,39m
7115,3,Daedalus,3496,211,15,2,17,88.2%,29m
7115,3,stephen,3496,356,15,8,23,65.2%,40m
7115,3,xVeltpunch,3496,335,14,9,23,60.9%,20m
7115,3,GusBus,3496,86,3,6,9,33.3%,24m
7115,3,Wizard,3496,0,0,1,1,0.0%,14m
7115,3,[Xpk]LoliHero,3496,0,0,1,1,0.0%,32m
7115,3,[MIDMX]DAVICO,3496,0,0,1,1,0.0%,36m
7126,2,[LqF]SmackDonkey,3495,1578,189,185,374,50.5%,42m
7126,2,[RUMB]CapsLock,3495,602,19,32,51,37.3%,37m
7126,3,[ctrlF]Aldrous,3495,368,16,13,29,55.2%,35m
7126,2,Nubster,3495,362,14,13,27,51.9%,20m
7126,2,Reflex,3495,207,9,4,13,69.2%,19m
7126,3,[8ALL55]Maharg,3495,118,4,4,8,50.0%,15m
7126,2,llIllIlIIIII,3495,88,3,4,7,42.9%,36m
7126,2,[HANGRY]CrankyDino,3495,30,2,7,9,22.2%,22m
7126,3,LloydAurion,3495,0,1,0,1,100.0%,35m
7126,3,Naraku,3495,0,1,0,1,100.0%,20m
7126,3,dLe,3495,0,1,1,2,50.0%,39m
7126,2,diksuckr,3495,0,1,2,3,33.3%,26m
7126,3,OvmndForPrez,3495,0,0,2,2,0.0%,33m
7126,3,[YBOR]Clever,3495,0,0,2,2,0.0%,2m
7140,3,[EliteG]EliteRetwAs,3494,790,99,70,169,58.6%,10m
7140,2,Deepo,3494,1528,95,82,177,53.7%,22m
7140,2,[YZYSZN]TREYTREYTREY,3494,741,72,67,139,51.8%,3m
7140,2,codebu,3494,1200,49,45,94,52.1%,24m
7140,3,Scorpio,3494,1104,42,40,82,51.2%,19m
7140,2,mintzilla,3494,888,38,46,84,45.2%,7m
7140,2,[JaXHaX]Tierlin,3494,334,11,27,38,28.9%,20m
7140,3,Zephyr,3494,0,5,0,5,100.0%,3m
7140,3,Shelly,3494,0,5,0,5,100.0%,33m
7140,3,IamNaeroK,3494,30,3,3,6,50.0%,7m
7140,3,MMMM,3494,30,1,1,2,50.0%,41m
7140,2,IlIlIlIIlIlI,3494,30,1,6,7,14.3%,30m
7140,3,[AAO]AAOpetrie,3494,0,0,1,1,0.0%,41m
7140,3,[Kusshh]MrSoloDolo,3494,0,0,1,1,0.0%,37m
7140,3,[Tronn]TrueBeliever,3494,0,0,1,1,0.0%,32m
7155,2,Blueline,3493,1538,289,281,570,50.7%,5m
7155,2,NWYJme,3493,1569,172,163,335,51.3%,37m
7155,2,[DarkAG]MinajestY,3493,1586,123,119,242,50.8%,5m
7155,3,Cygon,3493,527,46,26,72,63.9%,10m
7155,2,[N2B]DukeOfDangle,3493,282,10,15,25,40.0%,37m
7155,3,[IRYD]Fatherninja,3493,200,7,8,15,46.7%,6m
7155,3,Mpizzaplanet,3493,0,0,2,2,0.0%,7m
7162,3,eastcommon,3492,1618,166,131,297,55.9%,3m
7162,2,bassowl,3492,1116,110,118,228,48.2%,22m
7162,2,RealTalkRaVi,3492,719,84,70,154,54.5%,33m
7162,3,Deceleration,3492,1246,56,34,90,62.2%,18m
7162,2,[Skuma]Leiring,3492,263,44,37,81,54.3%,7m
7162,2,whitecats,3492,620,22,26,48,45.8%,14m
7162,3,GuESS,3492,114,8,2,10,80.0%,31m
7162,2,[EtrOy]patarike,3492,62,3,12,15,20.0%,24m
7162,2,soulkey,3492,0,1,0,1,100.0%,27m
7162,3,Sloom,3492,0,1,1,2,50.0%,41m
7162,3,Kerrigan,3492,0,0,1,1,0.0%,34m
7162,3,[LINY]DeltaSquad,3492,0,0,2,2,0.0%,37m
7174,2,Kobayashi,3491,1537,224,208,432,51.9%,14m
7174,3,Eros,3491,641,67,60,127,52.8%,23m
7174,1,LoOzAh,3491,1278,55,62,117,47.0%,20m
7174,3,[cHg1]kaype,3491,225,16,9,25,64.0%,24m
7174,2,Agent,3491,132,8,1,9,88.9%,7m
7174,3,ALTLSnine,3491,146,8,4,12,66.7%,8m
7174,3,Doucher,3491,114,5,0,5,100.0%,36m
7174,3,Illia,3491,0,5,0,5,100.0%,6m
7174,2,Rakushun,3491,0,1,4,5,20.0%,41m
7174,3,llllllllllll,3491,0,0,1,1,0.0%,33m
7184,2,LindaFromHR,3490,1539,280,291,571,49.0%,11m
7184,2,titan,3490,1179,132,119,251,52.6%,39m
7184,2,[NgNb]KuroYuki,3490,972,60,62,122,49.2%,11m
7184,2,NotSteve,3490,1239,57,66,123,46.3%,22m
7184,3,[Deathn]DestinyKid,3490,1411,53,51,104,51.0%,35m
7184,3,Cross,3490,590,22,18,40,55.0%,5m
7184,3,MunkE,3490,366,13,14,27,48.1%,29m
7184,2,[LowIQ]eSKo,3490,206,7,7,14,50.0%,28m
7184,3,[BGOK]JUSTICE,3490,0,3,2,5,60.0%,23m
7184,3,Vanish,3490,0,1,0,1,100.0%,34m
7184,3,[AMZN]Uroborus,3490,30,1,2,3,33.3%,29m
7195,3,[nieBla]Heinsenberg,3489,1416,68,43,111,61.3%,2m
7195,3,IlIlIlIlIlIl,3489,812,54,33,87,62.1%,41m
7195,3,BLTZBRG,3489,896,43,44,87,49.4%,23m
7195,2,Adnox,3489,840,34,31,65,52.3%,24m
7195,2,[Meeoww]BirthdayCake,3489,441,34,32,66,51.5%,36m
7195,2,bluebearsolo,3489,662,33,23,56,58.9%,8m
7195,2,IIIIIlllIIl,3489,372,18,29,47,38.3%,28m
7195,3,SnugglyBear,3489,0,1,0,1,100.0%,40m
7195,3,whoami,3489,0,1,0,1,100.0%,35m
7195,3,SixPooL,3489,0,1,0,1,100.0%,6m
7195,3,KBG,3489,30,1,1,2,50.0%,14m
7195,2,[nPnSX]Hippyjet,3489,0,1,4,5,20.0%,2m
7195,2,[MAUF]Glaxy,3489,0,1,4,5,20.0%,11m
7195,3,kass,3489,0,0,1,1,0.0%,20m
7209,2,TRex,3488,1527,75,61,136,55.1%,36m
7209,3,JAZZA,3488,1189,74,64,138,53.6%,16m
7209,2,[JChill]stickerplane,3488,1032,52,58,110,47.3%,9m
7209,3,Arara,3488,1015,42,29,71,59.2%,35m
7209,2,Crackberry,3488,200,8,10,18,44.4%,8m
7209,3,[TRSHNB]shuss,3488,90,4,4,8,50.0%,14m
7209,2,[EuEz]Bejita,3488,60,2,8,10,20.0%,31m
7209,3,[PTHero]TacticalNuke,3488,0,1,0,1,100.0%,33m
7209,3,azerty,3488,0,1,0,1,100.0%,31m
7218,2,WaDzA,3487,1557,156,145,301,51.8%,24m
7218,2,[Chill]CARNICERO,3487,611,23,21,44,52.3%,24m
7218,2,lulzury,3487,158,6,10,16,37.5%,24m
7218,2,StorM,3487,140,5,2,7,71.4%,31m
7218,2,phongfrancis,3487,116,4,3,7,57.1%,3m
7218,3,[Sliq]spoopatron,3487,58,3,2,5,60.0%,19m
7218,2,[SftVgn]bAnza,3487,88,2,3,5,40.0%,31m
7218,2,doubledragon,3487,0,1,0,1,100.0%,41m
7218,3,DeadSouL,3487,30,1,6,7,14.3%,6m
7218,3,BRAWNDOE,3487,0,0,1,1,0.0%,29m
7218,3,Neuromancer,3487,0,0,3,3,0.0%,32m
7218,2,ZuionShadow,3487,0,0,4,4,0.0%,32m
7230,2,[S2xy]ExpoExtreme,3486,1548,79,78,157,50.3%,30m
7230,3,[Macac0]MetalPower,3486,1099,45,45,90,50.0%,35m
7230,2,Quantinum,3486,1046,41,40,81,50.6%,39m
7230,3,Kale,3486,388,32,32,64,50.0%,35m
7230,3,XenoMorphKai,3486,499,19,13,32,59.4%,15m
7230,2,Nahadoth,3486,128,7,4,11,63.6%,36m
7230,3,[SNIKT]Crohnsboy,3486,146,5,6,11,45.5%,7m
7230,3,[McLorf]MCllorf,3486,58,2,3,5,40.0%,28m
7230,3,[Dicboy]BMO,3486,0,0,1,1,0.0%,16m
7239,2,GCaMP,3485,1546,194,199,393,49.4%,19m
7239,2,Gumbercules,3485,1518,67,59,126,53.2%,35m
7239,3,[lCHRGl]kool,3485,1205,52,30,82,63.4%,18m
7239,3,dRoneCraft,3485,1186,48,40,88,54.5%,13m
7239,2,[Lp]DarkChris,3485,608,27,29,56,48.2%,7m
7239,2,Pibkabu,3485,492,23,14,37,62.2%,16m
7239,3,[Hesa]flanaganapus,3485,556,21,20,41,51.2%,20m
7239,2,jume,3485,368,12,14,26,46.2%,26m
7239,3,[Cryptc]SevenLions,3485,142,6,4,10,60.0%,29m
7239,3,[InvUS]IIIIIIIIIIII,3485,0,5,0,5,100.0%,19m
7239,3,[Boaged]LeBoguleyhe,3485,58,3,1,4,75.0%,23m
7239,3,[CLONEZ]KillerKoala,3485,30,2,3,5,40.0%,26m
7239,3,kruskal,3485,30,1,3,4,25.0%,2m
7239,3,[MEP]AkicitaWaste,3485,0,0,2,2,0.0%,21m
7239,3,rooster,3485,0,0,2,2,0.0%,19m
7254,2,Csuth,3484,1429,102,98,200,51.0%,42m
7254,3,Carrotpatch,3484,1222,64,49,113,56.6%,34m
7254,2,[Fr0nt]Avv,3484,989,46,50,96,47.9%,28m
7254,3,PARALLEL,3484,298,12,13,25,48.0%,40m
7254,2,Key,3484,307,11,13,24,45.8%,41m
7254,3,NOOBER,3484,146,4,4,8,50.0%,21m
7254,3,llllllllllll,3484,16,2,2,4,50.0%,28m
7254,3,[NPhase]aWildBoar,3484,0,1,0,1,100.0%,4m
7254,3,vipeR,3484,30,1,1,2,50.0%,17m
7254,3,LiquidFusion,3484,0,0,1,1,0.0%,7m
7264,3,Meechi,3483,969,84,61,145,57.9%,31m
7264,2,Dog,3483,1417,64,78,142,45.1%,5m
7264,3,TheOtherOne,3483,632,26,18,44,59.1%,36m
7264,2,GuyintheChat,3483,524,18,22,40,45.0%,21m
7264,3,Time,3483,60,2,4,6,33.3%,16m
7264,3,NoRush,3483,0,1,0,1,100.0%,5m
7264,3,Squiggz,3483,0,1,2,3,33.3%,20m
7264,3,RufusCookie,3483,0,0,1,1,0.0%,41m
7264,3,[OmaeWa]ChiliChip,3483,0,0,1,1,0.0%,37m
7273,2,DinTaiFung,3482,1654,275,263,538,51.1%,4m
7273,2,Jax,3482,1577,147,147,294,50.0%,16m
7273,2,[iTHC]MixxMastaJrT,3482,1394,62,71,133,46.6%,32m
7273,2,TylerDurden,3482,1050,45,40,85,52.9%,33m
7273,2,Rhodes,3482,906,34,40,74,45.9%,24m
7273,2,ProToZ,3482,888,30,45,75,40.0%,11m
7273,2,Jermz,3482,247,16,20,36,44.4%,40m
7273,3,Canister,3482,30,6,1,7,85.7%,37m
7273,3,[RePlz]Fuzojix,3482,114,5,1,6,83.3%,28m
7273,3,LastLeg,3482,90,4,3,7,57.1%,22m
7273,3,[cxzczx]Knightmare,3482,0,1,0,1,100.0%,10m
7273,2,IIIIIIIIIIII,3482,94,1,1,2,50.0%,27m
7273,3,TerranOP,3482,0,0,1,1,0.0%,18m
7273,3,Nomad,3482,0,0,1,1,0.0%,21m
7273,2,[Poway]StormBringer,3482,0,0,5,5,0.0%,14m
7288,2,[RdLzrd]SinkSwim,3481,972,189,200,389,48.6%,9m
7288,2,ElZombie,3481,834,173,173,346,50.0%,5m
7288,2,[IuGaI]EffeCt,3481,1333,80,87,167,47.9%,2m
7288,2,Atom,3481,1230,45,50,95,47.4%,22m
7288,2,Grim,3481,405,32,28,60,53.3%,8m
7288,2,BlackDraft,3481,272,25,31,56,44.6%,16m
7288,3,[TheReg]Frost,3481,424,15,14,29,51.7%,3m
7288,3,[Zetha]Wero,3481,142,6,2,8,75.0%,38m
7288,3,Jakob,3481,116,4,6,10,40.0%,13m
7288,2,[KRLMRX]Palimpsest,3481,60,3,9,12,25.0%,24m
7288,3,Undertaker,3481,0,2,3,5,40.0%,41m
7288,1,Erlidd,3481,117,2,3,5,40.0%,32m
7288,3,MadMax,3481,96,1,2,3,33.3%,13m
7288,3,MoonLight,3481,0,1,2,3,33.3%,37m
7288,3,Aristides,3481,30,1,2,3,33.3%,18m
7288,3,Gin,3481,0,0,1,1,0.0%,40m
7288,3,Taoki,3481,0,0,1,1,0.0%,7m
7288,3,LørdBeverage,3481,0,0,1,1,0.0%,38m
7306,2,[PTHero]Neutralis,3480,1232,52,49,101,51.5%,27m
7306,2,Protoculture,3480,374,38,42,80,47.5%,12m
7306,2,BREGOR,3480,385,37,50,87,42.5%,16m
7306,3,Pototoes,3480,475,19,7,26,73.1%,17m
7306,3,[420whg]Avaek,3480,213,9,4,13,69.2%,39m
7306,3,Victahy,3480,0,5,0,5,100.0%,39m
7306,3,Vend,3480,58,2,6,8,25.0%,30m
7306,1,[McCr]GaTor,3480,0,1,9,10,10.0%,34m
7306,3,Vanilla,3480,0,0,1,1,0.0%,20m
7306,3,[kolkid]Fuzzy,3480,0,0,1,1,0.0%,24m
7306,3,[PSGe]Carmat,3480,0,0,1,1,0.0%,35m
7306,3,[CHAPU]pakowO,3480,0,0,2,2,0.0%,40m
7318,2,bearUSC,3479,1532,133,136,269,49.4%,16m
7318,3,[Paus3d]WhiteHope,3479,1417,104,99,203,51.2%,14m
7318,2,feebdaed,3479,1586,98,106,204,48.0%,22m
7318,2,Magus,3479,1358,86,91,177,48.6%,9m
7318,2,eyemhy,3479,1535,83,84,167,49.7%,9m
7318,2,[VMSTA]Cazz,3479,1167,79,79,158,50.0%,12m
7318,2,Grombulus,3479,1313,50,56,106,47.2%,41m
7318,3,STFU,3479,751,39,6,45,86.7%,13m
7318,2,Pseudechis,3479,432,38,38,76,50.0%,41m
7318,2,DontChzMePlz,3479,294,10,14,24,41.7%,35m
7318,3,GREMORY,3479,0,1,0,1,100.0%,33m
7318,3,XSAGITTARUSX,3479,0,1,0,1,100.0%,11m
7318,3,Emily,3479,0,1,0,1,100.0%,7m
7318,3,GoTik,3479,0,1,1,2,50.0%,19m
7318,3,[ASPIE]MuntedGoose,3479,0,0,1,1,0.0%,20m
7318,3,GhOosT,3479,0,0,2,2,0.0%,35m
7334,2,EliteDragon,3478,920,189,168,357,52.9%,39m
7334,2,HepZ,3478,1396,143,152,295,48.5%,24m
7334,3,[MacrOP]RestoRation,3478,1079,139,130,269,51.7%,34m
7334,2,[NwAs]Sariel,3478,363,102,91,193,52.8%,20m
7334,2,CAFG,3478,1388,89,64,153,58.2%,17m
7334,2,Raz,3478,1282,49,51,100,49.0%,5m
7334,2,[PsiX]PseuDnYMouS,3478,437,20,12,32,62.5%,7m
7334,3,[UpeV]blackdead,3478,308,12,6,18,66.7%,27m
7334,1,[ToastI]FCsquid,3478,234,11,3,14,78.6%,37m
7334,3,Admiral,3478,86,8,2,10,80.0%,32m
7334,3,sblingfun,3478,0,5,0,5,100.0%,8m
7334,3,ProtCantLose,3478,144,4,2,6,66.7%,6m
7334,2,[INCARD]BigRat,3478,146,4,6,10,40.0%,5m
7334,3,Froogus,3478,30,2,4,6,33.3%,36m
7334,2,[TGCrew]FedSmoker,3478,0,1,2,3,33.3%,8m
7334,3,Albus,3478,0,0,1,1,0.0%,21m
7350,2,ImhoteP,3477,1516,70,75,145,48.3%,41m
7350,2,protagonist,3477,906,52,52,104,50.0%,9m
7350,2,Kallian,3477,617,48,42,90,53.3%,31m
7350,3,[kOuT]DjPaNcHokO,3477,706,30,20,50,60.0%,39m
7350,3,Crash,3477,216,7,4,11,63.6%,15m
7350,3,HarrisonFord,3477,58,2,3,5,40.0%,3m
7350,3,adog,3477,0,1,0,1,100.0%,3m
7350,3,Oski,3477,0,0,3,3,0.0%,2m
7350,2,SChadenfreud,3477,0,0,4,4,0.0%,34m
7359,2,todd,3476,1500,341,332,673,50.7%,25m
7359,3,Beckieez,3476,1611,298,277,575,51.8%,14m
7359,2,frontbutfevr,3476,1561,213,208,421,50.6%,16m
7359,3,Mauiwowie,3476,181,12,2,14,85.7%,17m
7359,2,[Fir3s]Cobalt,3476,92,4,8,12,33.3%,34m
7359,3,EarthBender,3476,0,1,0,1,100.0%,12m
7359,3,Doucet,3476,0,1,0,1,100.0%,29m
7359,3,sdsdsdsdsdsd,3476,0,0,1,1,0.0%,11m
7359,3,BloodMagez,3476,0,0,1,1,0.0%,17m
7359,3,Davis,3476,0,0,3,3,0.0%,24m
7369,2,[DogLRD]Skoger,3475,1369,172,171,343,50.1%,35m
7369,2,Dabidusan,3475,1176,87,82,169,51.5%,34m
7369,2,[NlCER]GiMbO,3475,1230,72,67,139,51.8%,42m
7369,3,Zileas,3475,892,56,42,98,57.1%,19m
7369,2,IIIIIIIIIIII,3475,542,50,47,97,51.5%,31m
7369,2,BenJa,3475,529,43,35,78,55.1%,36m
7369,2,silver,3475,376,34,29,63,54.0%,15m
7369,3,Yagjao,3475,598,24,16,40,60.0%,34m
7369,2,Rush,3475,560,18,29,47,38.3%,21m
7369,3,Marowit,3475,86,3,3,6,50.0%,39m
7369,1,Orange,3475,0,0,1,1,0.0%,16m
7369,3,Snype,3475,0,0,2,2,0.0%,23m
7381,1,eldelicioso,3474,1681,360,379,739,48.7%,40m
7381,2,IMDrEaM,3474,1676,261,275,536,48.7%,5m
7381,2,[QTp2T]bopkid,3474,1569,90,87,177,50.8%,12m
7381,2,eroland,3474,620,24,25,49,49.0%,16m
7381,3,VOODOO,3474,389,16,16,32,50.0%,9m
7381,2,RedStorm,3474,406,14,24,38,36.8%,28m
7381,2,[NLTN]quakingrobot,3474,244,8,15,23,34.8%,36m
7381,3,Beren,3474,146,6,6,12,50.0%,8m
7381,3,myLittlePony,3474,224,6,7,13,46.2%,27m
7381,3,IAMCHEESEND,3474,0,5,0,5,100.0%,13m
7381,3,[GOPERÚ]SrSARCASMO,3474,30,2,1,3,66.7%,15m
7381,3,Phong,3474,58,2,3,5,40.0%,27m
7381,3,[Edwin]QBDOG,3474,0,1,1,2,50.0%,38m
7381,2,[Lp]dahaka,3474,96,1,7,8,12.5%,24m
7381,3,llllllllllll,3474,0,0,1,1,0.0%,33m
7396,2,ohcrocsle,3473,707,135,129,264,51.1%,4m
7396,2,Mantu,3473,1513,124,131,255,48.6%,37m
7396,3,[RaWH]Larsh,3473,856,82,75,157,52.2%,41m
7396,2,Aiyo,3473,1502,59,65,124,47.6%,16m
7396,2,RaMiThorN,3473,674,34,34,68,50.0%,28m
7396,2,Suite,3473,618,29,22,51,56.9%,17m
7396,3,ChicknSlayer,3473,806,29,29,58,50.0%,27m
7396,3,[LimaSC]Exile,3473,470,18,15,33,54.5%,36m
7396,3,[Unify]TeamCaptainX,3473,114,5,2,7,71.4%,21m
7396,3,[DUNGR]FTL,3473,73,4,5,9,44.4%,17m
7396,3,oneeyedjak,3473,60,2,4,6,33.3%,25m
7396,3,[GaRFo]Renan,3473,0,1,3,4,25.0%,35m
7396,3,[SPARK]Wulfe,3473,0,0,1,1,0.0%,8m
7396,3,[PNDub]Greg,3473,0,0,1,1,0.0%,2m
7410,3,TroUble,3472,1584,172,157,329,52.3%,14m
7410,2,[Xin]Sherlock,3472,1605,76,86,162,46.9%,31m
7410,2,Baconator,3472,323,46,34,80,57.5%,16m
7410,3,[StaRed]DarkShadeRC,3472,659,44,30,74,59.5%,19m
7410,3,[v1rgin]Zelevin,3472,616,22,25,47,46.8%,24m
7410,3,ToastProxy,3472,349,19,6,25,76.0%,13m
7410,2,Captaindry,3472,408,13,16,29,44.8%,16m
7410,2,llllllllllll,3472,185,8,2,10,80.0%,30m
7410,3,Hybrid,3472,0,4,0,4,100.0%,32m
7410,3,Maru,3472,0,3,2,5,60.0%,13m
7410,3,Wolfie,3472,0,1,0,1,100.0%,21m
7410,3,Balanced,3472,0,1,0,1,100.0%,23m
7410,3,[VENSC2]Pyro,3472,0,0,1,1,0.0%,34m
7410,2,Catarinao,3472,0,0,7,7,0.0%,28m
7424,3,FriendlyFire,3471,859,44,28,72,61.1%,14m
7424,3,xMRxGNDFx,3471,642,28,21,49,57.1%,37m
7424,2,Kublai,3471,522,25,16,41,61.0%,23m
7424,3,Augstone,3471,610,25,18,43,58.1%,40m
7424,3,[ZrO2]Isocene,3471,616,23,19,42,54.8%,8m
7424,3,[TheRMs]ChinChillax,3471,436,20,5,25,80.0%,23m
7424,2,[void44]epicvoid,3471,234,9,8,17,52.9%,12m
7424,3,[sCrubs]nOpan,3471,30,2,3,5,40.0%,28m
7432,2,[DarkAG]CoaXeD,3470,1525,123,111,234,52.6%,6m
7432,2,dannyd,3470,1355,94,99,193,48.7%,37m
7432,2,Barcode,3470,1228,93,91,184,50.5%,41m
7432,2,Starlorde,3470,1212,44,50,94,46.8%,28m
7432,3,Blackpine,3470,452,16,19,35,45.7%,9m
7432,3,Archer,3470,116,4,2,6,66.7%,6m
7432,3,DeWulfman,3470,58,3,0,3,100.0%,35m
7432,3,[3CHEEZ]Mars,3470,58,3,2,5,60.0%,28m
7432,1,Mackiavel,3470,144,3,5,8,37.5%,34m
7432,2,lotsofwind,3470,140,3,7,10,30.0%,7m
7432,3,owlrock,3470,0,2,0,2,100.0%,35m
7432,3,RtypeRex,3470,0,1,0,1,100.0%,24m
7432,2,[sOLsc]Dylan,3470,30,1,7,8,12.5%,37m
7432,3,[Macac0]EsKiaf,3470,0,0,1,1,0.0%,25m
7432,3,[TdotO]Dice,3470,0,0,2,2,0.0%,13m
7432,3,pox,3470,0,0,2,2,0.0%,34m
7448,1,[QS]Quon,3469,1687,739,735,1474,50.1%,4m
7448,3,[Slugzz]Monophonic,3469,796,124,106,230,53.9%,28m
7448,2,ValKilmer,3469,814,47,41,88,53.4%,30m
7448,3,TrueSouth,3469,795,31,29,60,51.7%,24m
7448,2,tshook,3469,751,29,27,56,51.8%,19m
7448,3,barbieJesuz,3469,612,24,18,42,57.1%,3m
7448,3,hardfire,3469,58,7,0,7,100.0%,33m
7448,3,llllllllllll,3469,60,2,3,5,40.0%,13m
7448,3,Dacat,3469,0,1,0,1,100.0%,27m
7448,3,[JABW]aRcAngel,3469,0,1,1,2,50.0%,42m
7458,2,[Legndr]Suiram,3468,1617,230,218,448,51.3%,16m
7458,2,Kassilly,3468,1520,78,82,160,48.8%,5m
7458,3,Outkast,3468,450,17,11,28,60.7%,15m
7458,3,YOLOSWAGGINS,3468,373,17,13,30,56.7%,29m
7458,3,[TGosuC]Skitter,3468,354,14,8,22,63.6%,26m
7458,3,RefsiuL,3468,172,6,4,10,60.0%,7m
7458,2,AlphaDrake,3468,96,3,7,10,30.0%,25m
7458,3,[OGbros]khirE,3468,30,2,0,2,100.0%,33m
7458,3,KillerApe,3468,0,1,1,2,50.0%,13m
7458,3,pylonfreak,3468,0,0,1,1,0.0%,3m
7458,3,[Fr0zeN]Snow,3468,0,0,2,2,0.0%,3m
7458,1,player,3468,0,0,2,2,0.0%,22m
7470,3,Allegseuh,3467,1002,44,26,70,62.9%,25m
7470,3,UHUstic,3467,372,13,13,26,50.0%,11m
7470,2,[N3RDST]BigJoeLogs,3467,120,5,12,17,29.4%,37m
7470,3,[Cheees]NickTactics,3467,0,2,3,5,40.0%,37m
7470,3,[JustFF]Toshee,3467,60,2,4,6,33.3%,33m
7470,3,Aaron,3467,30,1,3,4,25.0%,25m
7476,3,Archimedes,3466,1225,149,144,293,50.9%,35m
7476,3,Chowwnny,3466,943,70,60,130,53.8%,14m
7476,3,[PhdX]Mentat,3466,845,59,57,116,50.9%,29m
7476,2,Grumpy,3466,978,49,39,88,55.7%,31m
7476,3,Blunts,3466,714,26,28,54,48.1%,11m
7476,3,Threejax,3466,517,25,15,40,62.5%,17m
7476,2,AldousD,3466,472,16,27,43,37.2%,15m
7476,3,[SsaYnS]Javelot,3466,358,12,13,25,48.0%,26m
7476,3,Ooooops,3466,0,5,0,5,100.0%,29m
7476,3,[xTQc]Maz,3466,94,3,4,7,42.9%,8m
7476,2,Verndawg,3466,30,2,7,9,22.2%,32m
7476,3,KinguvcheeZL,3466,0,1,0,1,100.0%,42m
7476,3,[SSWARM]MoltenCube,3466,30,1,2,3,33.3%,23m
7476,3,Romeo,3466,30,1,5,6,16.7%,14m
7476,3,Tuberculosis,3466,0,0,1,1,0.0%,36m
7476,3,Exile,3466,0,0,1,1,0.0%,19m
7492,2,[xLgNx]Ein,3465,1349,142,144,286,49.7%,15m
7492,2,BoomBoomBane,3465,1314,94,108,202,46.5%,28m
7492,2,kimishish,3465,1574,90,88,178,50.6%,26m
7492,2,mac,3465,864,76,56,132,57.6%,38m
7492,2,[Len1n]Wagz,3465,1562,59,69,128,46.1%,28m
7492,2,[Cryptc]SwaY,3465,533,24,25,49,49.0%,21m
7492,3,MoistCheeser,3465,480,18,15,33,54.5%,19m
7492,3,[FOXY]Deezeegee,3465,192,9,4,13,69.2%,25m
7492,3,[Cryptc]Legendary,3465,30,2,1,3,66.7%,29m
7492,3,[Kekett]TheCleanLove,3465,0,1,0,1,100.0%,12m
7492,3,[Frash]Horus,3465,0,1,3,4,25.0%,17m
7492,3,Xeloss,3465,0,0,1,1,0.0%,33m
7492,3,TheSmallNut,3465,0,0,1,1,0.0%,39m
7492,3,[GTnLB]thegrumpy,3465,0,0,2,2,0.0%,15m
7492,3,[LimLim]ngsWarning,3465,0,0,5,5,0.0%,42m
7507,2,shadowsniper,3464,1552,368,356,724,50.8%,6m
7507,2,[eZzZzZ]VictuM,3464,1052,38,44,82,46.3%,14m
7507,3,[NeAs]fullermarcus,3464,918,35,34,69,50.7%,25m
7507,2,linkko,3464,664,26,32,58,44.8%,41m
7507,3,South,3464,242,9,5,14,64.3%,28m
7507,2,Sushi,3464,212,7,17,24,29.2%,39m
7507,3,nanoDeath,3464,146,5,3,8,62.5%,20m
7507,3,CasShernD,3464,0,4,1,5,80.0%,22m
7507,3,SeraphieI,3464,58,3,0,3,100.0%,40m
7507,3,[eMoon]Vicius,3464,58,3,2,5,60.0%,29m
7507,3,Beybars,3464,0,1,0,1,100.0%,12m
7507,3,Heemang,3464,0,1,3,4,25.0%,38m
7507,3,[kuShy]raijinkroniQ,3464,0,0,1,1,0.0%,3m
7507,3,CraftOfWar,3464,0,0,1,1,0.0%,12m
7507,3,SZEFEN,3464,0,0,2,2,0.0%,5m
7507,3,[MANDEZ]bastianpp,3464,0,0,2,2,0.0%,40m
7507,3,[NoSex4]Chocobo,3464,0,0,3,3,0.0%,33m
7507,3,depression,3464,0,0,5,5,0.0%,7m
7525,3,HainAyu,3463,1320,162,156,318,50.9%,20m
7525,3,Blitzkrieg,3463,1413,71,62,133,53.4%,35m
7525,3,[DDOINK]ShadowFenix,3463,1198,50,37,87,57.5%,28m
7525,2,[cl0udM]Boreal,3463,1304,43,65,108,39.8%,16m
7525,3,hootis,3463,751,33,20,53,62.3%,24m
7525,3,[TgAg]ItsRichieBTW,3463,617,32,21,53,60.4%,3m
7525,2,Nathan,3463,490,31,28,59,52.5%,36m
7525,3,darpai,3463,584,26,19,45,57.8%,37m
7525,3,kakaru,3463,459,23,3,26,88.5%,40m
7525,3,NEXChico,3463,410,19,9,28,67.9%,33m
7525,3,Grass,3463,239,12,6,18,66.7%,40m
7525,2,[i9]sAviOr,3463,300,12,17,29,41.4%,35m
7525,3,Queen,3463,142,6,5,11,54.5%,12m
7525,3,[SCFun]Dracnum,3463,30,2,2,4,50.0%,7m
7525,3,Leofuturo,3463,62,2,7,9,22.2%,20m
7525,3,[ILCs]Ryan,3463,0,1,0,1,100.0%,7m
7525,3,[PSlSTC]BraDaDiah,3463,30,1,1,2,50.0%,8m
7525,3,silverhawk,3463,0,1,5,6,16.7%,34m
7525,3,[VGG]Javeen,3463,0,0,1,1,0.0%,31m
7525,3,Dakillerman,3463,0,0,1,1,0.0%,38m
7525,3,[Cryptc]Tonstor,3463,0,0,3,3,0.0%,39m
7525,2,Aronzo,3463,0,0,5,5,0.0%,2m
7547,2,[CNYL]CANDYKagami,3462,1581,190,187,377,50.4%,7m
7547,3,Chipper,3462,1354,109,57,166,65.7%,40m
7547,2,[Prelud]Staple,3462,1199,76,77,153,49.7%,17m
7547,3,xuisp,3462,633,65,48,113,57.5%,14m
7547,2,[DarkAG]AeroSoap,3462,1099,50,38,88,56.8%,26m
7547,2,Jason,3462,964,47,45,92,51.1%,14m
7547,3,PlatBarcode,3462,616,27,17,44,61.4%,40m
7547,2,Malloy,3462,313,15,11,26,57.7%,7m
7547,2,NoMad,3462,114,5,8,13,38.5%,16m
7547,3,[TPLUSS]Tinichu,3462,0,1,0,1,100.0%,35m
7547,3,Cray,3462,30,1,1,2,50.0%,40m
7558,2,[TGCF]AGsilverAG,3461,1583,227,214,441,51.5%,31m
7558,3,[CoPa]sPsAPoG,3461,906,36,32,68,52.9%,8m
7558,2,BluShifT,3461,373,31,25,56,55.4%,16m
7558,2,GeneralTso,3461,419,23,32,55,41.8%,11m
7558,3,Thaadius,3461,410,19,19,38,50.0%,8m
7558,2,[ZTemps]iPnTheElder,3461,191,19,23,42,45.2%,25m
7558,3,[TgAg]Gesk,3461,120,4,6,10,40.0%,29m
7558,3,[Dadash]Ivaldi,3461,30,2,0,2,100.0%,13m
7558,3,[Pres45]TRUMP,3461,30,2,1,3,66.7%,35m
7558,3,[JaMiT]RazzleDazzle,3461,0,0,1,1,0.0%,15m
7568,2,Rokodalin,3460,1521,326,327,653,49.9%,28m
7568,2,SUPERTIM,3460,1355,282,272,554,50.9%,7m
7568,2,lsyrk,3460,1530,181,177,358,50.6%,36m
7568,3,swampdonkey,3460,1317,57,43,100,57.0%,24m
7568,2,ManAtSea,3460,1081,43,48,91,47.3%,25m
7568,3,Player,3460,639,28,16,44,63.6%,28m
7568,3,Jarra,3460,541,23,14,37,62.2%,5m
7568,3,Andrew,3460,592,22,24,46,47.8%,14m
7568,2,[HAV0C]cutegrrl,3460,638,21,29,50,42.0%,6m
7568,2,[ZTemps]ZeN,3460,350,12,25,37,32.4%,9m
7568,3,MaxiJazz,3460,166,7,3,10,70.0%,28m
7568,2,NeronX,3460,139,2,2,4,50.0%,11m
7568,3,ZeusAImighty,3460,0,0,1,1,0.0%,40m
7568,3,Fiyero,3460,0,0,1,1,0.0%,13m
7568,3,Kaltmacher,3460,0,0,2,2,0.0%,29m
7568,2,Bighentai,3460,0,0,4,4,0.0%,12m
7584,2,Hekate,3459,1453,76,71,147,51.7%,20m
7584,2,NillaWafers,3459,403,50,44,94,53.2%,4m
7584,2,[BCIub]Vision,3459,405,36,52,88,40.9%,12m
7584,3,[iDeX]ForaBolsonar,3459,388,14,10,24,58.3%,25m
7584,3,[NovaX]HJM,3459,294,12,9,21,57.1%,17m
7584,3,rodders,3459,90,4,5,9,44.4%,34m
7584,3,llllllllllll,3459,114,4,5,9,44.4%,13m
7584,2,ChobitS,3459,90,4,10,14,28.6%,28m
7584,3,[LANDB]Moosabman,3459,0,1,0,1,100.0%,33m
7584,3,Yuigahama,3459,0,0,1,1,0.0%,7m
7594,2,llllllllllll,3458,1352,137,123,260,52.7%,15m
7594,2,Hydriad,3458,1400,65,57,122,53.3%,3m
7594,3,[DETER]Coelacanth,3458,395,33,21,54,61.1%,30m
7594,2,Wizzard,3458,408,15,20,35,42.9%,15m
7594,2,OhPoo,3458,314,12,17,29,41.4%,41m
7594,3,Ikepono,3458,263,11,10,21,52.4%,31m
7594,2,[CRAKS]defiler,3458,184,9,1,10,90.0%,29m
7594,3,HeatEngine,3458,242,9,5,14,64.3%,41m
7594,3,[Spicey]SpiceyPete,3458,142,7,1,8,87.5%,7m
7594,3,suprnovaynwa,3458,0,4,1,5,80.0%,29m
7594,3,[NovaX]Etmajo,3458,58,3,1,4,75.0%,7m
7594,3,Quack,3458,88,3,5,8,37.5%,11m
7594,3,Sondaljan,3458,60,2,4,6,33.3%,39m
7594,3,[Pinoys]yehey,3458,0,1,0,1,100.0%,19m
7594,3,ricky,3458,0,0,1,1,0.0%,15m
7594,3,Xiaon,3458,0,0,1,1,0.0%,10m
7594,3,flopwinner,3458,0,0,2,2,0.0%,36m
7594,3,llllllllllll,3458,0,0,2,2,0.0%,25m
7612,3,seriosblack,3457,1508,88,69,157,56.1%,18m
7612,2,CISLORD,3457,827,30,34,64,46.9%,7m
7612,2,[TONGJI]Maru,3457,324,16,10,26,61.5%,8m
7612,2,penlsgoblin,3457,420,15,20,35,42.9%,4m
7612,2,Grodoo,3457,166,8,3,11,72.7%,34m
7612,3,[WNTRLY]Lochlan,3457,0,1,0,1,100.0%,23m
7612,3,open,3457,0,1,0,1,100.0%,17m
7612,3,TheFoo,3457,30,1,1,2,50.0%,23m
7612,3,jisoO,3457,30,1,1,2,50.0%,35m
7612,3,wooki,3457,0,0,1,1,0.0%,40m
7612,3,Gongon,3457,0,0,1,1,0.0%,8m
7612,3,llllllllllll,3457,0,0,1,1,0.0%,12m
7612,2,deuce,3457,0,0,3,3,0.0%,26m
7625,3,Juice,3456,1098,44,35,79,55.7%,9m
7625,3,Brodysseus,3456,900,38,27,65,58.5%,21m
7625,2,Eliav,3456,754,29,29,58,50.0%,12m
7625,3,Grassytiger,3456,330,13,8,21,61.9%,3m
7625,1,Freddy,3456,300,12,6,18,66.7%,11m
7625,2,wafs,3456,376,12,18,30,40.0%,7m
7625,3,Skyrim,3456,88,8,2,10,80.0%,33m
7625,2,[SsaYnS]Sleeky,3456,144,6,12,18,33.3%,12m
7625,1,Brook,3456,169,5,9,14,35.7%,7m
7625,3,sjShark,3456,86,3,2,5,60.0%,3m
7625,3,Sloth,3456,62,3,4,7,42.9%,2m
7625,3,MoscoW,3456,0,1,0,1,100.0%,39m
7625,3,zero,3456,97,1,1,2,50.0%,23m
7625,3,[QTp2T]Voden,3456,0,0,1,1,0.0%,29m
7639,2,easygoer,3455,1558,151,156,307,49.2%,17m
7639,2,SodaGrackers,3455,1312,124,108,232,53.4%,43m
7639,3,Marvin,3455,328,51,42,93,54.8%,23m
7639,2,DeadDevil,3455,205,11,6,17,64.7%,17m
7639,3,Max,3455,214,8,9,17,47.1%,21m
7639,3,ISuckS,3455,180,7,9,16,43.8%,25m
7639,1,[EpicG]elAdmin,3455,172,6,0,6,100.0%,20m
7639,3,[RlSKE]assassinXY,3455,146,6,5,11,54.5%,14m
7639,2,[HDRP]trieuvan,3455,62,3,9,12,25.0%,39m
7639,3,[TooEZ]chimaloo,3455,0,1,0,1,100.0%,10m
7639,3,mmm,3455,0,1,0,1,100.0%,32m
7639,3,superhammer,3455,0,1,2,3,33.3%,19m
7639,3,[w0rm]zaphod,3455,0,0,1,1,0.0%,32m
7652,2,Zildy,3454,1182,120,114,234,51.3%,15m
7652,2,GuRa,3454,870,34,28,62,54.8%,20m
7652,2,[InGt]Yukon,3454,550,30,34,64,46.9%,27m
7652,2,[KSCM]UltraSCV,3454,154,9,5,14,64.3%,17m
7652,1,TheGrinch,3454,193,5,1,6,83.3%,22m
7652,1,llllllllllll,3454,190,5,8,13,38.5%,22m
7652,3,Jimbo,3454,114,4,3,7,57.1%,28m
7652,3,[xRtG]Tokuchi,3454,169,4,5,9,44.4%,29m
7652,3,[BRSS]CheeseZealot,3454,58,3,3,6,50.0%,2m
7652,3,[fking]Amiba,3454,30,2,1,3,66.7%,26m
7652,3,ChanceBriggs,3454,30,2,2,4,50.0%,36m
7652,3,PanterA,3454,0,1,0,1,100.0%,42m
7652,3,BossHoGG,3454,0,0,1,1,0.0%,38m
7652,3,Kikonda,3454,0,0,1,1,0.0%,7m
7666,2,UTNHELLFIRE,3453,1554,167,172,339,49.3%,34m
7666,3,[sffssf]Skerelechuga,3453,1464,82,80,162,50.6%,30m
7666,3,[ScSwrm]Kaigem,3453,1326,55,45,100,55.0%,13m
7666,3,srcake,3453,528,22,20,42,52.4%,21m
7666,3,[TechN]Parasite,3453,543,21,15,36,58.3%,35m
7666,3,KODI,3453,317,14,5,19,73.7%,17m
7666,2,Citizenkangg,3453,142,8,2,10,80.0%,31m
7666,2,Galivan,3453,58,3,7,10,30.0%,14m
7666,3,Quentin,3453,96,2,1,3,66.7%,21m
7666,2,Colgate,3453,102,2,4,6,33.3%,37m
7666,3,VORTEX,3453,0,1,0,1,100.0%,14m
7666,3,bunkbed,3453,0,0,1,1,0.0%,3m
7666,3,Kappablanca,3453,0,0,2,2,0.0%,23m
7679,2,kkkkk,3452,1483,392,394,786,49.9%,14m
7679,2,Curupira,3452,905,136,139,275,49.5%,10m
7679,3,Testament,3452,712,34,23,57,59.6%,2m
7679,3,[Maaad]StzCraft,3452,486,18,17,35,51.4%,24m
7679,3,AlliumPorrum,3452,146,9,4,13,69.2%,13m
7679,3,Acedia,3452,258,9,10,19,47.4%,40m
7679,3,InvisibleCnt,3452,142,7,1,8,87.5%,27m
7679,3,KingBird,3452,0,1,0,1,100.0%,3m
7679,3,[KingSC]NATALI,3452,0,1,0,1,100.0%,11m
7679,3,[RUSHya]RayCharles,3452,0,1,1,2,50.0%,20m
7679,3,DirkaDirka,3452,0,1,1,2,50.0%,29m
7679,3,Stellar,3452,30,1,2,3,33.3%,40m
7679,3,PontiusPylon,3452,30,1,4,5,20.0%,15m
7679,3,lewalkingted,3452,0,0,1,1,0.0%,42m
7679,3,[JBRONI]TerranDan,3452,0,0,1,1,0.0%,3m
7679,3,[DIS]Hoobajoob,3452,0,0,2,2,0.0%,28m
7679,3,[QQoo]Achilles,3452,0,0,2,2,0.0%,6m
7696,2,Vodkatrooper,3451,1520,212,199,411,51.6%,30m
7696,2,Fluoxetine,3451,1355,90,93,183,49.2%,36m
7696,2,RedBeard,3451,720,73,65,138,52.9%,14m
7696,2,ErickX,3451,805,41,40,81,50.6%,27m
7696,3,Racres,3451,408,17,11,28,60.7%,17m
7696,1,noobstyle,3451,0,5,0,5,100.0%,2h
7696,3,llllIIIlIlll,3451,30,2,0,2,100.0%,19m
7696,3,[TTT]Aznmonstar,3451,60,2,3,5,40.0%,2m
7696,3,KryptKeeper,3451,0,1,0,1,100.0%,15m
7696,2,Zyklon,3451,30,1,7,8,12.5%,39m
7696,3,BarCode,3451,0,0,1,1,0.0%,20m
7707,2,Dking,3450,1366,161,128,289,55.7%,8m
7707,2,[Op1ate]forthemasses,3450,817,157,144,301,52.2%,15m
7707,3,[Devote]Raukar,3450,1053,127,112,239,53.1%,32m
7707,2,NNNostaliii,3450,552,22,25,47,46.8%,22m
7707,3,DildoSaggins,3450,244,10,4,14,71.4%,17m
7707,2,Cast,3450,240,8,24,32,25.0%,35m
7707,3,VoidlessRage,3450,60,7,1,8,87.5%,33m
7707,2,IIIIIIllllll,3450,138,3,3,6,50.0%,29m
7707,3,AkiraSai,3450,30,2,0,2,100.0%,32m
7707,3,yeti,3450,30,1,1,2,50.0%,16m
7707,1,zonkil,3450,96,1,1,2,50.0%,20m
7707,3,Cole,3450,0,0,1,1,0.0%,13m
7707,3,Kaz,3450,0,0,2,2,0.0%,25m
7707,3,ShenzhouV,3450,0,0,2,2,0.0%,25m
7721,1,PickUp,3449,1633,239,241,480,49.8%,38m
7721,3,Reza,3449,1647,170,158,328,51.8%,41m
7721,2,Neldoreth,3449,1208,90,93,183,49.2%,34m
7721,3,[QGG]Kaiser,3449,1618,85,82,167,50.9%,7m
7721,2,[Cind3r]Oomda,3449,384,63,59,122,51.6%,41m
7721,3,DestroyerXD,3449,540,23,16,39,59.0%,29m
7721,3,easyonme,3449,528,21,16,37,56.8%,12m
7721,3,Pink,3449,274,13,10,23,56.5%,8m
7721,3,DonaldPump,3449,272,11,6,17,64.7%,36m
7721,3,EkremAbi,3449,242,9,4,13,69.2%,9m
7721,2,Bogue,3449,163,5,0,5,100.0%,30m
7721,3,Envy,3449,30,1,1,2,50.0%,26m
7721,3,AGILAYGO,3449,0,0,1,1,0.0%,17m
7734,2,[LDCO]Shamael,3448,1442,83,86,169,49.1%,9m
7734,2,Kleenex,3448,888,40,42,82,48.8%,38m
7734,2,Majun,3448,363,33,27,60,55.0%,19m
7734,2,[GOPERÚ]RampagePks,3448,602,26,22,48,54.2%,17m
7734,3,JillyKing,3448,348,14,8,22,63.6%,21m
7734,2,enchantment,3448,116,7,3,10,70.0%,24m
7734,3,daghack,3448,58,3,0,3,100.0%,20m
7734,2,XNA,3448,60,3,7,10,30.0%,15m
7734,3,[DRKRPT]Pyx,3448,92,3,7,10,30.0%,7m
7734,3,TheDoomDonut,3448,0,1,0,1,100.0%,40m
7734,3,Endless,3448,30,1,1,2,50.0%,18m
7734,3,[GnR]Exothermic,3448,30,1,3,4,25.0%,3m
7746,1,[LVerdá]KaRnaTrix,3447,1428,102,112,214,47.7%,13m
7746,3,Flight,3447,426,25,15,40,62.5%,27m
7746,3,AlexJones,3447,325,14,5,19,73.7%,42m
7746,3,PatrioticPet,3447,132,12,14,26,46.2%,37m
7746,2,SNORLAX,3447,188,9,3,12,75.0%,31m
7746,3,Zapo,3447,58,6,1,7,85.7%,40m
7746,3,JDP,3447,166,6,4,10,60.0%,23m
7746,3,SpaceWeed,3447,114,5,9,14,35.7%,11m
7746,3,Zagreus,3447,91,3,1,4,75.0%,39m
7746,3,Niki,3447,60,3,2,5,60.0%,3m
7746,3,AliTyphooN,3447,60,3,3,6,50.0%,3m
7746,3,[PRZM]BTCHundredK,3447,30,2,1,3,66.7%,23m
7746,3,Food,3447,58,2,4,6,33.3%,37m
7746,3,DesperadoR,3447,30,1,5,6,16.7%,36m
7746,2,wcchairman,3447,32,1,17,18,5.6%,7m
7746,3,[TGosuC]Blujedi,3447,0,0,1,1,0.0%,7m
7746,3,Hoboedd,3447,0,0,1,1,0.0%,10m
7746,3,MrTwister,3447,0,0,5,5,0.0%,37m
7764,3,[lMathl]Doggy,3446,1569,94,85,179,52.5%,24m
7764,2,XXXXXXXXXX,3446,1036,71,81,152,46.7%,41m
7764,3,[Derpz]ThatsPraxis,3446,941,48,36,84,57.1%,27m
7764,3,JimmyPants,3446,906,39,25,64,60.9%,36m
7764,3,Ryo,3446,461,19,12,31,61.3%,42m
7764,3,Singularity,3446,314,15,10,25,60.0%,17m
7764,2,Hunter,3446,282,9,20,29,31.0%,4m
7764,1,ManJai,3446,0,5,0,5,100.0%,3h
7764,3,Eevak,3446,60,3,6,9,33.3%,6m
7764,3,SoulLess,3446,0,1,0,1,100.0%,26m
7764,2,[dLife]Monkey,3446,30,1,9,10,10.0%,28m
7764,3,[SbT]royksopp,3446,0,0,1,1,0.0%,14m
7776,3,JustinIsALai,3445,1497,75,62,137,54.7%,16m
7776,3,llllllllllll,3445,805,44,3,47,93.6%,21m
7776,2,BlurOMadden,3445,448,32,34,66,48.5%,24m
7776,3,[xTQc]AnzoImpact,3445,494,20,13,33,60.6%,29m
7776,2,[GØSU]TomboKai,3445,60,2,12,14,14.3%,27m
7776,3,[dikboi]skCory,3445,0,0,1,1,0.0%,2m
7782,3,Miasmata,3444,1459,302,288,590,51.2%,29m
7782,2,[NwAs]DoctorGamer,3444,1116,61,53,114,53.5%,28m
7782,3,Chrono,3444,948,45,20,65,69.2%,32m
7782,3,LexKaiba,3444,892,33,32,65,50.8%,14m
7782,2,[plannB]Ryansdad,3444,494,21,22,43,48.8%,8m
7782,2,RoachWarden,3444,590,21,28,49,42.9%,5m
7782,3,[GEEKED]CoronaMarine,3444,525,19,17,36,52.8%,39m
7782,2,[FYD]SilkyJenkins,3444,405,17,19,36,47.2%,40m
7782,3,argonkingdom,3444,340,13,12,25,52.0%,25m
7782,3,DigitaL,3444,58,3,2,5,60.0%,15m
7782,3,MasterChef,3444,30,1,1,2,50.0%,42m
7782,3,[MYOPIC]GRUNDLEOUCH,3444,30,1,5,6,16.7%,35m
7782,3,FirestarX,3444,0,0,2,2,0.0%,42m
7795,2,liu,3443,1544,185,172,357,51.8%,30m
7795,3,[SG8]horry,3443,1613,105,83,188,55.9%,40m
7795,2,[DETER]MrCallOfDuty,3443,1113,92,98,190,48.4%,16m
7795,3,Rebent,3443,231,12,7,19,63.2%,31m
7795,3,easycomputer,3443,142,5,5,10,50.0%,21m
7795,2,Leclerc,3443,88,2,4,6,33.3%,15m
7795,3,Scarrab,3443,0,1,0,1,100.0%,25m
7795,2,FrozenPizza,3443,0,0,8,8,0.0%,17m
7803,2,[LGNxx]Vulnox,3442,1374,50,56,106,47.2%,27m
7803,3,aneid,3442,1050,40,36,76,52.6%,35m
7803,2,Saek,3442,1082,36,52,88,40.9%,14m
7803,2,xenathode,3442,555,27,28,55,49.1%,22m
7803,2,[VFam]Phaymous,3442,268,9,13,22,40.9%,41m
7803,3,vini,3442,86,7,2,9,77.8%,12m
7803,3,Aynis,3442,0,1,0,1,100.0%,36m
7803,3,[LCE]Chipana,3442,30,1,1,2,50.0%,29m
7803,3,FartinG,3442,0,1,1,2,50.0%,42m
7803,3,DamageINC,3442,30,1,2,3,33.3%,26m
7803,3,[Tyber]StratosFEAR,3442,0,0,1,1,0.0%,27m
7814,2,Rocherlekula,3441,1521,393,395,788,49.9%,12m
7814,3,Magoa,3441,1380,189,179,368,51.4%,38m
7814,2,DrekHad,3441,965,149,140,289,51.6%,15m
7814,2,gTimes,3441,891,131,109,240,54.6%,24m
7814,3,Crucial,3441,622,23,22,45,51.1%,23m
7814,3,goopy,3441,547,20,19,39,51.3%,3m
7814,3,InsungMungae,3441,258,9,1,10,90.0%,17m
7814,2,THeUsEr,3441,282,9,22,31,29.0%,30m
7814,2,Narkobear,3441,166,7,11,18,38.9%,6m
7814,2,MonkeyBreath,3441,244,7,13,20,35.0%,18m
7814,2,Cytoss,3441,0,3,5,8,37.5%,25m
7814,2,skylordh,3441,0,1,1,2,50.0%,28m
7814,3,[500CC]Kaboel,3441,30,1,4,5,20.0%,35m
7827,3,[MadK]Kevin,3440,1425,78,61,139,56.1%,38m
7827,2,QcPac,3440,1183,55,59,114,48.2%,26m
7827,2,Tyler,3440,880,34,32,66,51.5%,18m
7827,2,Danger,3440,612,23,29,52,44.2%,15m
7827,3,edwinSTZ,3440,364,13,12,25,52.0%,8m
7827,1,Paka,3440,260,12,7,19,63.2%,4m
7827,3,Monster,3440,248,10,7,17,58.8%,37m
7827,3,Mako,3440,277,10,11,21,47.6%,5m
7827,3,[ExcIgN]JoSS,3440,176,6,12,18,33.3%,35m
7827,3,Teapot,3440,58,2,3,5,40.0%,11m
7827,3,DaHyun,3440,0,1,1,2,50.0%,22m
7827,3,RoMaNeT,3440,0,0,3,3,0.0%,11m
7839,2,yan,3439,793,188,204,392,48.0%,30m
7839,3,PlumpAvo,3439,1542,67,54,121,55.4%,24m
7839,2,Sin,3439,1450,61,68,129,47.3%,18m
7839,3,happystick,3439,396,15,8,23,65.2%,23m
7839,3,FriendComp,3439,272,14,8,22,63.6%,10m
7839,2,Atlas,3439,290,10,20,30,33.3%,36m
7839,3,foxdie,3439,172,7,4,11,63.6%,23m
7839,1,newLeaf,3439,0,5,0,5,100.0%,32m
7839,3,[LimaSC]IMStarker,3439,60,3,2,5,60.0%,34m
7839,3,Perfect,3439,58,3,4,7,42.9%,26m
7839,3,[Thorin]OaknShield,3439,0,0,1,1,0.0%,29m
7839,3,lllllllllll,3439,0,0,1,1,0.0%,12m
7839,3,Toto,3439,0,0,1,1,0.0%,42m
7839,3,FlickFiebeR,3439,0,0,2,2,0.0%,29m
7853,2,dslidd,3438,1534,109,96,205,53.2%,19m
7853,2,[MYDK]TankEvans,3438,1240,94,88,182,51.6%,16m
7853,2,Ansible,3438,1481,81,82,163,49.7%,28m
7853,2,QuantCheesin,3438,1414,67,50,117,57.3%,11m
7853,3,[bm]OneBadvATE,3438,948,36,29,65,55.4%,7m
7853,2,Firebatz,3438,440,21,16,37,56.8%,39m
7853,3,iGGnacious,3438,370,18,16,34,52.9%,13m
7853,3,Red,3438,231,10,10,20,50.0%,35m
7853,3,ArtourBabaev,3438,30,5,1,6,83.3%,38m
7853,3,[nubPWR]SlubberScrub,3438,0,3,2,5,60.0%,37m
7853,3,Theone,3438,0,1,0,1,100.0%,29m
7853,3,FuRy,3438,0,1,2,3,33.3%,37m
7853,3,[xJUSTx]Baxster,3438,30,1,6,7,14.3%,16m
7853,3,[ShoaL]Red,3438,0,0,1,1,0.0%,15m
7853,3,IIIlllIIIlll,3438,0,0,2,2,0.0%,8m
7853,2,Bisu,3438,0,0,6,6,0.0%,36m
7869,2,LilFingaz,3437,1436,282,297,579,48.7%,2m
7869,2,Hummus,3437,997,76,71,147,51.7%,24m
7869,2,[hTx]DroneCapone,3437,1550,72,73,145,49.7%,4m
7869,2,SirBonjwa,3437,1399,66,48,114,57.9%,9m
7869,3,Fetknol,3437,828,35,27,62,56.5%,35m
7869,3,[3ez5me]Kor,3437,356,14,10,24,58.3%,42m
7869,3,Dagashiya,3437,236,11,6,17,64.7%,8m
7869,3,MoreDrones,3437,200,8,5,13,61.5%,8m
7869,3,[1s]carltoN,3437,107,7,1,8,87.5%,30m
7869,3,WiTTy,3437,30,2,1,3,66.7%,27m
7869,3,Venrai,3437,30,2,2,4,50.0%,4m
7869,3,Youiur,3437,0,1,0,1,100.0%,39m
7869,2,DatsyuK,3437,0,1,0,1,100.0%,32m
7869,2,limitlist,3437,0,1,5,6,16.7%,36m
7869,3,Faker,3437,0,0,1,1,0.0%,28m
7884,2,Psychedelic,3436,1551,359,348,707,50.8%,39m
7884,2,[ConFed]Markuverse,3436,1488,271,275,546,49.6%,28m
7884,2,largeDog,3436,1488,128,140,268,47.8%,12m
7884,3,[YEOBO]nahcaD,3436,1246,69,66,135,51.1%,19m
7884,3,Value,3436,841,34,28,62,54.8%,15m
7884,2,[adY]awS,3436,321,31,36,67,46.3%,12m
7884,3,DicEmAnD,3436,298,23,18,41,56.1%,3m
7884,3,[PMN]WhoGotDaMumf,3436,338,15,9,24,62.5%,8m
7884,1,[Lip]datSwarm,3436,207,10,6,16,62.5%,20m
7884,3,Zombiesaurus,3436,266,10,9,19,52.6%,37m
7884,3,showIP,3436,166,7,3,10,70.0%,25m
7884,3,anonymous,3436,0,0,1,1,0.0%,20m
7884,3,FearxFight,3436,0,0,2,2,0.0%,19m
7897,3,Peaches,3435,627,82,77,159,51.6%,39m
7897,2,FATE,3435,1257,67,61,128,52.3%,6m
7897,2,[SAUNA]Dimmy,3435,1390,67,65,132,50.8%,27m
7897,3,FenixShowbiz,3435,525,34,20,54,63.0%,8m
7897,3,Zergies,3435,663,28,25,53,52.8%,8m
7897,3,[Zatra]blacklotus,3435,624,24,16,40,60.0%,24m
7897,3,[Ash3s]Khorne,3435,340,13,10,23,56.5%,10m
7897,3,GameBoy,3435,142,9,4,13,69.2%,10m
7897,3,elcom,3435,245,9,7,16,56.2%,34m
7897,3,[CaoGe]Dikhead,3435,58,6,1,7,85.7%,37m
7897,3,gwho,3435,30,2,0,2,100.0%,17m
7897,3,bluestar,3435,30,2,3,5,40.0%,8m
7897,3,[BIGPPS]Azark,3435,0,1,0,1,100.0%,23m
7897,1,IIIIIIIIIIII,3435,42,1,2,3,33.3%,16m
7897,3,terranmaster,3435,0,0,1,1,0.0%,41m
7912,3,Twasapug,3434,1237,110,88,198,55.6%,41m
7912,2,MoistToast,3434,1498,96,99,195,49.2%,33m
7912,2,ilosealot,3434,528,83,71,154,53.9%,7m
7912,3,Pogo,3434,832,46,39,85,54.1%,19m
7912,2,aSaHerBa,3434,490,24,19,43,55.8%,39m
7912,2,strelink,3434,392,15,15,30,50.0%,12m
7912,3,namseung,3434,316,14,6,20,70.0%,17m
7912,3,[CUMING]maxwelljones,3434,386,14,16,30,46.7%,37m
7912,3,[mocat]TBONE,3434,280,10,7,17,58.8%,23m
7912,3,blinkzelot,3434,114,4,3,7,57.1%,17m
7912,2,SMOOTHBRAIN,3434,62,2,8,10,20.0%,31m
7912,3,[ZTemp]Vicious,3434,0,0,1,1,0.0%,38m
7912,3,pepiti,3434,0,0,1,1,0.0%,36m
7925,3,Heliumite,3433,1556,405,399,804,50.4%,20m
7925,2,[CIMKR]ShineZerg,3433,1209,149,146,295,50.5%,11m
7925,2,Nerdsie,3433,1597,144,144,288,50.0%,17m
7925,3,gene,3433,1596,121,120,241,50.2%,40m
7925,2,DANKMEMES,3433,1551,104,107,211,49.3%,12m
7925,3,[TheDOH]ListerFiend,3433,386,14,16,30,46.7%,10m
7925,3,Outbreak,3433,376,13,16,29,44.8%,38m
7925,3,[MNFF]Northern,3433,386,13,19,32,40.6%,37m
7925,3,Protoss,3433,250,10,7,17,58.8%,9m
7925,3,zerg,3433,162,8,1,9,88.9%,20m
7925,3,LillySatou,3433,216,7,13,20,35.0%,17m
7925,3,[xRFR]SsoutheastD,3433,58,3,1,4,75.0%,17m
7925,3,Wempy,3433,0,2,3,5,40.0%,43m
7925,3,Loshi,3433,0,1,0,1,100.0%,34m
7925,3,VeryNoob,3433,0,1,0,1,100.0%,6m
7925,3,htty,3433,30,1,2,3,33.3%,29m
7925,3,Brythebeast,3433,30,1,2,3,33.3%,23m
7925,3,Shrub,3433,0,0,1,1,0.0%,19m
7943,3,Remulasce,3432,1577,147,136,283,51.9%,27m
7943,2,Parity,3432,1298,48,52,100,48.0%,21m
7943,2,[TGosuD]HalcyonDays,3432,1058,39,42,81,48.1%,5m
7943,2,jimmypoi,3432,712,25,29,54,46.3%,11m
7943,3,Hoobawapa,3432,440,15,18,33,45.5%,27m
7943,3,kjpeans,3432,258,11,1,12,91.7%,36m
7943,3,[lLiTl]Fishy,3432,145,8,6,14,57.1%,23m
7943,3,Dizz,3432,252,8,7,15,53.3%,12m
7943,2,Yaldabaoth,3432,241,7,11,18,38.9%,8m
7943,3,[BroBlo]piechjd,3432,179,6,1,7,85.7%,17m
7943,3,Spite,3432,30,5,2,7,71.4%,2m
7943,3,LOLRUSS,3432,58,3,3,6,50.0%,21m
7943,3,SerralJR,3432,0,1,1,2,50.0%,7m
7943,3,[Genera]SirWaffle,3432,0,0,1,1,0.0%,25m
7943,3,[Ozzie]AlienVVarCry,3432,0,0,2,2,0.0%,11m
7958,3,Xbar,3431,1595,336,319,655,51.3%,20m
7958,2,SMFMind,3431,1416,104,98,202,51.5%,20m
7958,3,MsPussyCat,3431,737,70,68,138,50.7%,38m
7958,2,Xenomorph,3431,1423,65,62,127,51.2%,37m
7958,1,Sweet,3431,225,10,5,15,66.7%,34m
7958,3,Gendarme,3431,58,3,7,10,30.0%,38m
7958,3,markit,3431,0,1,1,2,50.0%,28m
7958,3,[Th3Bad]Ventura,3431,30,1,1,2,50.0%,29m
7958,3,Dreekin,3431,30,1,3,4,25.0%,13m
7958,3,Akhenaton,3431,0,0,2,2,0.0%,38m
7968,2,[BoAVN]laststanding,3430,1328,59,58,117,50.4%,42m
7968,3,IGNIS,3430,769,38,22,60,63.3%,19m
7968,3,DontWoryBaby,3430,563,25,13,38,65.8%,12m
7968,2,[RINGTA]KinkajouVice,3430,208,7,10,17,41.2%,5m
7968,2,Incognito,3430,0,5,1,6,83.3%,18m
7968,3,[NeAs]Anxiety,3430,30,1,1,2,50.0%,41m
7968,3,[LAAR]Spawn,3430,0,0,1,1,0.0%,3m
7968,3,[rgeKIT]Kreator,3430,0,0,1,1,0.0%,38m
7968,3,[Hack69]ElTramposo,3430,0,0,1,1,0.0%,17m
7968,3,Tsun,3430,0,0,1,1,0.0%,10m
7978,2,Foozbond,3429,1628,337,322,659,51.1%,4m
7978,2,Nudskilld,3429,866,239,236,475,50.3%,16m
7978,3,AstroGoat,3429,1593,198,200,398,49.7%,22m
7978,2,[TPGGXD]Lancer,3429,1544,164,155,319,51.4%,26m
7978,3,[4Proft]DaddyProphit,3429,748,28,24,52,53.8%,14m
7978,3,Firexfred,3429,365,14,17,31,45.2%,29m
7978,3,Jeezee,3429,244,9,11,20,45.0%,10m
7978,2,[LQV]BeanJos,3429,200,7,10,17,41.2%,24m
7978,3,[SC2PH]Retsu,3429,140,5,1,6,83.3%,11m
7978,3,[PzC]SiNk,3429,118,4,3,7,57.1%,28m
7978,3,kewei,3429,86,3,1,4,75.0%,24m
7978,3,[eXoPH]eXoSkeletor,3429,30,2,1,3,66.7%,35m
7978,3,[TB303]Ethex,3429,60,2,4,6,33.3%,32m
7978,3,[iDrunk]Gandalf,3429,0,1,0,1,100.0%,31m
7978,3,aMFSorcerer,3429,0,1,0,1,100.0%,15m
7978,3,[028]HernanPs,3429,0,1,0,1,100.0%,22m
7978,2,frobe,3429,0,1,0,1,100.0%,42m
7995,2,[GØSU]dex,3428,1261,344,325,669,51.4%,38m
7995,2,Beeeeeeee,3428,1165,112,119,231,48.5%,41m
7995,3,Isabella,3428,504,25,10,35,71.4%,12m
7995,3,Kingnot,3428,666,25,27,52,48.1%,11m
7995,2,SkilLy,3428,131,8,4,12,66.7%,3m
7995,3,[QP]SEAhidraz,3428,210,8,9,17,47.1%,4m
7995,2,[aL1998]SuNie,3428,119,6,4,10,60.0%,34m
7995,3,Mune,3428,58,2,2,4,50.0%,5m
7995,3,Dodjyz,3428,0,1,0,1,100.0%,33m
7995,3,[GnR]Descending,3428,0,0,1,1,0.0%,3m
8005,2,Flash,3427,1407,55,66,121,45.5%,11m
8005,2,[D0M0]xXXLustXxx,3427,856,54,36,90,60.0%,35m
8005,3,[N1gs]Wildling,3427,166,6,3,9,66.7%,25m
8005,3,[HDGii]ALASTOR,3427,58,3,0,3,100.0%,24m
8005,3,WaGe,3427,88,3,3,6,50.0%,32m
8005,3,FaceLess,3427,0,1,0,1,100.0%,15m
8005,3,TheQueen,3427,0,0,1,1,0.0%,21m
8005,3,Kudohlol,3427,0,0,3,3,0.0%,22m
8013,3,[αX]Lanfear,3426,1578,83,85,168,49.4%,29m
8013,2,Zelluh,3426,1445,72,52,124,58.1%,19m
8013,2,[AiMB]ZergEra,3426,807,59,58,117,50.4%,28m
8013,3,JaneAusten,3426,411,40,41,81,49.4%,33m
8013,2,[BRUTAL]FeedtheFeet,3426,686,33,30,63,52.4%,4m
8013,2,WindTalker,3426,348,12,25,37,32.4%,19m
8013,3,[FxB]floski,3426,244,10,7,17,58.8%,29m
8013,3,[NwAs]Odinsc,3426,142,6,3,9,66.7%,13m
8013,1,Joooooooonie,3426,0,4,1,5,80.0%,55m
8013,3,[FFEODT]Crysis,3426,86,3,2,5,60.0%,29m
8013,3,[HORSE]Pariah,3426,30,2,4,6,33.3%,38m
8013,3,FusRoDahBR,3426,0,1,0,1,100.0%,19m
8013,3,[gaPe]MilkMan,3426,30,1,3,4,25.0%,32m
8013,2,Musing,3426,30,1,8,9,11.1%,24m
8027,3,[AntiNs]gwagwa,3425,1090,60,39,99,60.6%,29m
8027,2,Sosa,3425,1098,44,41,85,51.8%,4m
8027,2,[Fir3s]FloridaMan,3425,667,22,28,50,44.0%,26m
8027,3,[ConFed]Chawls,3425,528,18,23,41,43.9%,41m
8027,3,Pikklez,3425,248,10,4,14,71.4%,7m
8027,3,[Peco]Pecorine,3425,221,9,12,21,42.9%,27m
8027,2,[TGCrew]Dae,3425,242,8,18,26,30.8%,28m
8027,3,Yes,3425,140,7,4,11,63.6%,38m
8027,3,[M2A5]Well,3425,170,4,5,9,44.4%,26m
8027,2,[INextI]Gergy,3425,88,4,13,17,23.5%,28m
8027,3,DieNAGranate,3425,0,3,3,6,50.0%,22m
8027,3,COLDSMENII,3425,97,1,1,2,50.0%,40m
8039,3,Sarandia,3424,1290,58,40,98,59.2%,37m
8039,2,BigRob,3424,954,33,41,74,44.6%,24m
8039,2,MrRoadApples,3424,318,11,15,26,42.3%,39m
8039,3,[KGH]Kevii,3424,260,9,5,14,64.3%,8m
8039,2,Vetrip,3424,141,7,3,10,70.0%,35m
8039,1,Capsaicin,3424,121,6,1,7,85.7%,11m
8039,3,ScareCroW,3424,154,5,10,15,33.3%,30m
8039,3,Zupper,3424,0,4,3,7,57.1%,16m
8039,3,[BlTEL]Ryub,3424,30,1,3,4,25.0%,21m
8039,3,[BearMe]Kiddle,3424,0,0,4,4,0.0%,36m
8049,3,Lemurs,3423,1383,80,80,160,50.0%,7m
8049,3,bErNy,3423,1446,61,57,118,51.7%,38m
8049,3,IIIIIIIIII,3423,671,41,31,72,56.9%,3m
8049,2,WithNail,3423,357,35,39,74,47.3%,26m
8049,2,MontrealSYF,3423,844,31,38,69,44.9%,24m
8049,3,[SiNN]ViLe,3423,591,21,19,40,52.5%,40m
8049,3,[EtrOy]Travesty,3423,488,17,21,38,44.7%,40m
8049,3,[BLSTIX]GuMiho,3423,118,5,4,9,55.6%,41m
8049,3,winning,3423,114,5,6,11,45.5%,12m
8049,3,Pyromantic,3423,120,4,3,7,57.1%,39m
8049,2,trojanwarior,3423,114,4,11,15,26.7%,15m
8049,3,[420710]StickyIcky,3423,60,3,2,5,60.0%,12m
8049,3,cdo,3423,62,3,3,6,50.0%,37m
8049,3,DeadBabySeal,3423,90,3,3,6,50.0%,5m
8049,1,[xLgNx]MajinUub,3423,0,1,1,2,50.0%,11m
8049,3,VulpesZerda,3423,30,1,2,3,33.3%,12m
8049,2,[MEELX]Sandstorm,3423,30,1,8,9,11.1%,7m
8049,3,BFA,3423,0,0,1,1,0.0%,8m
8049,3,CondorBomber,3423,0,0,1,1,0.0%,32m
8049,3,ChrisPu,3423,0,0,1,1,0.0%,12m
8049,3,[TeamUR]Apophis,3423,0,0,2,2,0.0%,35m
8070,3,[UpeV]PLATANO,3422,1542,91,81,172,52.9%,12m
8070,3,Figurati,3422,851,90,70,160,56.2%,7m
8070,2,[XpKb]Hackmalware,3422,1227,79,66,145,54.5%,26m
8070,2,[eX]Calkines,3422,906,30,47,77,39.0%,23m
8070,2,Snikerdoodle,3422,574,26,30,56,46.4%,16m
8070,3,dockerboy,3422,220,8,4,12,66.7%,42m
8070,3,GoldLeaguer,3422,121,6,1,7,85.7%,8m
8070,3,lllllllllll,3422,141,3,6,9,33.3%,37m
8070,3,Cheka,3422,0,1,0,1,100.0%,2m
8070,3,Labonte,3422,30,1,4,5,20.0%,36m
8070,3,[Four2o]AlluahAkbar,3422,0,0,1,1,0.0%,18m
8070,3,shapoopymtg,3422,0,0,1,1,0.0%,38m
8070,2,AlKhidir,3422,0,0,2,2,0.0%,25m
8070,3,steveZissou,3422,0,0,4,4,0.0%,40m
8084,3,[BisKtz]chibitotoro,3421,1574,183,184,367,49.9%,27m
8084,3,brrrrrrr,3421,1454,60,49,109,55.0%,34m
8084,2,Moonbyul,3421,766,25,44,69,36.2%,27m
8084,2,[GanGan]PLutO,3421,290,10,11,21,47.6%,36m
8084,2,[ANlME]Chase,3421,200,6,10,16,37.5%,43m
8084,3,badassburito,3421,146,5,7,12,41.7%,35m
8084,3,ZraseC,3421,126,4,9,13,30.8%,13m
8084,2,[xFaDe]PressureTest,3421,116,4,12,16,25.0%,27m
8084,3,gogogo,3421,30,2,0,2,100.0%,23m
8084,3,[NPhasA]DanieLBee,3421,30,1,1,2,50.0%,35m
8084,3,Waltz,3421,0,1,1,2,50.0%,13m
8084,3,BUGWEEEZY,3421,0,0,1,1,0.0%,40m
8084,3,Harrysax,3421,0,0,1,1,0.0%,42m
8084,3,PRoSu,3421,0,0,2,2,0.0%,21m
8098,3,Dapper,3420,1568,284,273,557,51.0%,23m
8098,2,[NPhasA]Antares,3420,1534,216,212,428,50.5%,8m
8098,2,[DarkAG]LUDEMEISTER,3420,1552,94,93,187,50.3%,37m
8098,3,bmwAssassin,3420,1246,90,90,180,50.0%,27m
8098,2,Archon,3420,885,83,81,164,50.6%,5m
8098,2,[PHUDDU]Mano,3420,637,36,41,77,46.8%,7m
8098,3,siupizza,3420,334,32,26,58,55.2%,22m
8098,3,Jenny,3420,534,22,20,42,52.4%,26m
8098,3,[LuVz]TheThigh,3420,388,13,16,29,44.8%,15m
8098,3,[HoFoCo]spoonodoom,3420,158,7,3,10,70.0%,25m
8098,3,Zyone,3420,88,3,8,11,27.3%,8m
8098,3,[SC2IDN]Klappertaart,3420,0,1,0,1,100.0%,38m
8098,3,MBDTF,3420,0,0,1,1,0.0%,4m
8098,3,[Kappa]Wormlips,3420,0,0,3,3,0.0%,40m
8112,2,Jinx,3419,1544,281,293,574,49.0%,31m
8112,3,Galford,3419,1591,83,67,150,55.3%,12m
8112,3,[HØST]Snakespe,3419,454,23,14,37,62.2%,18m
8112,3,SomiK,3419,486,20,5,25,80.0%,20m
8112,3,PoethePug,3419,417,20,9,29,69.0%,2m
8112,3,PlzTrump,3419,222,7,4,11,63.6%,27m
8112,3,aiforvictory,3419,100,7,7,14,50.0%,33m
8112,3,[TeamUR]FireKlaw,3419,90,3,5,8,37.5%,10m
8112,3,Heisman,3419,60,2,3,5,40.0%,34m
8112,3,FiftyNinth,3419,30,2,3,5,40.0%,15m
8112,3,[DrkMnX]User,3419,30,2,6,8,25.0%,37m
8112,3,McCARNEY,3419,30,1,3,4,25.0%,24m
8124,2,treehugger,3418,1358,288,276,564,51.1%,15m
8124,3,SEMINENCE,3418,1261,78,63,141,55.3%,2m
8124,2,[Exper]Earendil,3418,1298,70,69,139,50.4%,7m
8124,2,[DNKCFT]mogue,3418,1279,67,88,155,43.2%,28m
8124,3,[MSTRD]GrImReApEr,3418,1306,56,44,100,56.0%,30m
8124,2,RoseyRed,3418,362,20,8,28,71.4%,36m
8124,3,Bizilbur,3418,413,19,11,30,63.3%,2m
8124,3,life,3418,191,6,2,8,75.0%,13m
8124,3,Hyajms,3418,0,4,1,5,80.0%,7m
8124,3,frogician,3418,30,2,2,4,50.0%,15m
8124,3,Muffinman,3418,30,2,3,5,40.0%,37m
8124,3,PossiblyMayb,3418,0,0,1,1,0.0%,29m
8136,2,neurot,3417,1595,153,147,300,51.0%,32m
8136,2,Maximus,3417,1545,82,82,164,50.0%,6m
8136,3,Galaxia,3417,1016,60,42,102,58.8%,17m
8136,2,tangled,3417,675,58,49,107,54.2%,28m
8136,3,scottimus,3417,427,26,18,44,59.1%,8m
8136,3,ExIBanker,3417,388,17,7,24,70.8%,40m
8136,2,Jacobyjones,3417,478,17,22,39,43.6%,4m
8136,2,foxdoc,3417,287,10,6,16,62.5%,3m
8136,3,Panic,3417,0,5,1,6,83.3%,39m
8136,3,Bjl,3417,88,3,2,5,60.0%,15m
8136,3,deleuzean,3417,30,1,2,3,33.3%,29m
8136,3,[OLV]Tesomas,3417,0,0,1,1,0.0%,30m
8136,3,[MystK]Gohan,3417,0,0,1,1,0.0%,28m
8136,3,gold,3417,0,0,2,2,0.0%,3m
8150,2,saken,3416,1358,88,84,172,51.2%,18m
8150,3,BoboKassidy,3416,534,22,14,36,61.1%,18m
8150,3,amb,3416,526,20,13,33,60.6%,8m
8150,2,Warbane,3416,578,19,32,51,37.3%,23m
8150,3,[EtrOy]Jingleheimer,3416,297,13,10,23,56.5%,25m
8150,2,[GGMESP]RoseewalQloO,3416,374,13,20,33,39.4%,28m
8150,3,warrior,3416,334,12,12,24,50.0%,29m
8150,3,[TPGGXD]POGERZ,3416,262,11,1,12,91.7%,38m
8150,3,DaBunkaKid,3416,103,4,10,14,28.6%,39m
8150,3,kseughkae,3416,86,3,4,7,42.9%,21m
8150,3,JANDA,3416,30,1,1,2,50.0%,20m
8150,3,llllllllllll,3416,0,1,1,2,50.0%,8m
8162,3,[MelbSc]MELBHXD,3415,1098,178,146,324,54.9%,29m
8162,3,[Zzwarm]BUCKETGEARED,3415,1677,108,87,195,55.4%,41m
8162,3,SirStichUp,3415,1272,73,64,137,53.3%,6m
8162,2,RatKinG,3415,774,32,33,65,49.2%,28m
8162,2,rlmilo,3415,476,20,16,36,55.6%,4m
8162,3,gasbreakdip,3415,209,8,5,13,61.5%,35m
8162,3,[KJDW]mastrblastr,3415,166,7,4,11,63.6%,34m
8162,3,Goobster,3415,219,6,5,11,54.5%,41m
8162,3,BestFoodTown,3415,86,4,1,5,80.0%,8m
8162,3,[GR33D]Boom,3415,92,4,7,11,36.4%,20m
8162,3,[BRAP]Xterminator,3415,0,3,2,5,60.0%,7m
8162,3,[CHGBRO]kage,3415,30,2,1,3,66.7%,40m
8162,3,xkrimzonx,3415,58,2,9,11,18.2%,10m
8162,3,Okonkwo,3415,0,1,0,1,100.0%,17m
8162,3,[3D]Melkor,3415,0,1,0,1,100.0%,34m
8162,3,Dahlmann,3415,0,0,1,1,0.0%,30m
8162,3,ThePunisher,3415,0,0,1,1,0.0%,5m
8162,3,[NOBZ]Tyrus,3415,0,0,2,2,0.0%,30m
8180,3,Apkuhi,3414,939,118,102,220,53.6%,27m
8180,2,Cools,3414,922,98,97,195,50.3%,37m
8180,3,invincinble,3414,994,43,26,69,62.3%,11m
8180,3,BLitSon,3414,271,31,25,56,55.4%,35m
8180,3,HappyDaun,3414,192,23,18,41,56.1%,25m
8180,3,Breezy,3414,297,17,16,33,51.5%,19m
8180,3,Probe,3414,146,6,6,12,50.0%,13m
8180,3,SicVitaEst,3414,62,3,5,8,37.5%,5m
8180,2,[BSFE]BackMage,3414,64,2,10,12,16.7%,39m
8180,2,[GLHFAG]Barouette,3414,60,2,12,14,14.3%,26m
8180,3,Kamikaze,3414,0,1,0,1,100.0%,29m
8180,3,[SIClan]oOZaNeOo,3414,30,1,7,8,12.5%,7m
8180,3,[LGNxx]ScubaSteve,3414,0,0,1,1,0.0%,6m
8193,3,Babyteeth,3413,1519,176,175,351,50.1%,2m
8193,3,LetmeWin,3413,1640,133,113,246,54.1%,34m
8193,3,VERSEZ,3413,1497,133,119,252,52.8%,27m
8193,2,Pogo,3413,1115,101,103,204,49.5%,15m
8193,2,KAICERATOPS,3413,938,33,46,79,41.8%,17m
8193,3,JFerris,3413,708,27,21,48,56.2%,27m
8193,3,[DhZAc1]SkyDrago,3413,596,22,18,40,55.0%,12m
8193,1,asasas,3413,242,12,5,17,70.6%,34m
8193,3,[Hilas2]BaragTotski,3413,236,10,9,19,52.6%,6m
8193,3,[prim8s]CDC,3413,58,3,2,5,60.0%,25m
8193,3,[RSGP]Elking,3413,60,2,5,7,28.6%,29m
8193,3,[Zappa]frazzle,3413,0,0,1,1,0.0%,37m
8193,3,[relord]MemeLord,3413,0,0,2,2,0.0%,40m
8206,2,[STILL]TheAlchemist,3412,1539,296,287,583,50.8%,3m
8206,3,RELLIKPIR,3412,1437,211,163,374,56.4%,29m
8206,2,katxl,3412,1143,127,118,245,51.8%,29m
8206,3,breakingwind,3412,869,97,87,184,52.7%,3m
8206,3,folke,3412,1276,87,78,165,52.7%,27m
8206,3,ImJuicin,3412,1653,68,59,127,53.5%,9m
8206,3,Deadfart,3412,632,42,35,77,54.5%,32m
8206,3,Bezerger,3412,540,30,20,50,60.0%,36m
8206,3,Jimson,3412,348,14,12,26,53.8%,38m
8206,3,thunder,3412,382,14,14,28,50.0%,26m
8206,3,jwill,3412,226,12,9,21,57.1%,20m
8206,3,LazyElm,3412,328,12,11,23,52.2%,36m
8206,2,insanekami,3412,338,12,19,31,38.7%,15m
8206,3,[WNTRCH]TableTop,3412,90,4,5,9,44.4%,34m
8206,3,[Cryptc]Balgruuf,3412,0,2,3,5,40.0%,34m
8206,3,[ROMBS]Fabiano,3412,0,1,0,1,100.0%,17m
8206,3,Mikha,3412,0,1,0,1,100.0%,7m
8206,3,[LDPro]ploofy,3412,0,1,1,2,50.0%,19m
8206,3,xRed,3412,0,1,1,2,50.0%,7m
8206,3,[GQ]Telesis,3412,0,1,2,3,33.3%,7m
8206,3,AerkH,3412,30,1,4,5,20.0%,37m
8206,3,[eSx]Broshimitsu,3412,0,0,1,1,0.0%,27m
8206,3,Adrenaline,3412,0,0,1,1,0.0%,25m
8229,3,DukeofJon,3411,1596,341,329,670,50.9%,39m
8229,2,HeadHunter,3411,576,200,182,382,52.4%,28m
8229,3,[GOPERÚ]Zerral,3411,792,31,28,59,52.5%,35m
8229,3,BammBamm,3411,500,18,18,36,50.0%,41m
8229,3,fred,3411,343,17,6,23,73.9%,9m
8229,3,ScvRdy,3411,362,15,6,21,71.4%,7m
8229,3,Brodmann,3411,210,11,7,18,61.1%,27m
8229,3,[H3ntai]Incursio,3411,270,11,8,19,57.9%,4m
8229,3,THEJUDGE,3411,144,5,11,16,31.2%,29m
8229,3,[TGosuD]Dingo,3411,92,4,5,9,44.4%,4m
8229,3,chasingMango,3411,58,3,1,4,75.0%,23m
8229,2,minop,3411,58,3,8,11,27.3%,3m
8229,2,CAVEMAN,3411,94,3,15,18,16.7%,11m
8229,3,Fulcro,3411,30,2,3,5,40.0%,33m
8229,3,Soul,3411,30,1,5,6,16.7%,21m
8229,3,[GGu2EZ]PermaFrost,3411,0,0,1,1,0.0%,17m
8229,3,SyN,3411,0,0,1,1,0.0%,17m
8229,3,[CDCUSA]Daijobu,3411,0,0,1,1,0.0%,13m
8229,3,[UpeV]LuisSanHer,3411,0,0,1,1,0.0%,10m
8229,3,[xLgNx]Dive,3411,0,0,1,1,0.0%,8m
8229,3,Shmantalope,3411,0,0,1,1,0.0%,17m
8250,2,dobe,3410,1528,134,145,279,48.0%,24m
8250,2,mrE,3410,939,91,77,168,54.2%,24m
8250,2,Sunday,3410,581,90,84,174,51.7%,37m
8250,3,TheAbhorsen,3410,1449,62,48,110,56.4%,15m
8250,2,jtwizzle,3410,835,51,54,105,48.6%,26m
8250,3,VoVo,3410,984,41,29,70,58.6%,27m
8250,3,Dietheru,3410,508,38,36,74,51.4%,39m
8250,2,[TSgB]BigYeezats,3410,654,21,32,53,39.6%,11m
8250,3,blackswarma,3410,250,14,12,26,53.8%,24m
8250,3,Dodsferd,3410,218,9,3,12,75.0%,25m
8250,3,vixolin,3410,273,9,9,18,50.0%,38m
8250,3,itsonlyspelz,3410,172,7,11,18,38.9%,27m
8250,3,PapaMisty,3410,166,6,1,7,85.7%,13m
8250,2,Cassa,3410,130,4,5,9,44.4%,9m
8250,3,JOHNCENA,3410,120,4,8,12,33.3%,26m
8250,3,[FTBALL]PapaBigBelly,3410,30,2,0,2,100.0%,33m
8250,3,Gilgameheart,3410,30,2,3,5,40.0%,21m
8250,3,Kryptic,3410,0,0,3,3,0.0%,7m
8268,3,wooky,3409,1121,337,297,634,53.2%,15m
8268,2,Statik,3409,1508,203,199,402,50.5%,26m
8268,2,Mesc,3409,1585,171,176,347,49.3%,30m
8268,2,Creager,3409,1387,134,128,262,51.1%,18m
8268,2,[LgnTDS]fatnice,3409,1040,71,76,147,48.3%,37m
8268,3,Freki,3409,942,35,38,73,47.9%,10m
8268,3,[daBBC]ItsMe,3409,699,30,22,52,57.7%,42m
8268,3,Kaiser,3409,540,25,12,37,67.6%,20m
8268,3,Saitama,3409,369,15,1,16,93.8%,17m
8268,3,CptJoo,3409,280,13,8,21,61.9%,12m
8268,3,PepgaPower,3409,0,3,3,6,50.0%,37m
8268,3,[Apprvd]Soup,3409,30,2,0,2,100.0%,31m
8268,2,Dreamboat,3409,0,2,7,9,22.2%,40m
8268,3,[FINDEX]Anelit,3409,0,1,1,2,50.0%,13m
8268,3,[HIVIZ]Vision,3409,30,1,2,3,33.3%,31m
8268,3,[SASHA1]Bunny,3409,30,1,4,5,20.0%,7m
8268,3,Hopesend,3409,0,0,1,1,0.0%,34m
8268,3,[bfBE]GEN,3409,0,0,1,1,0.0%,24m
8268,3,DIAMOND,3409,0,0,2,2,0.0%,20m
8287,3,Grimace,3408,1581,168,135,303,55.4%,3m
8287,3,LordMendigao,3408,827,84,72,156,53.8%,7m
8287,3,Tettarus,3408,912,36,28,64,56.2%,29m
8287,2,Raptor,3408,906,30,43,73,41.1%,15m
8287,3,ShattrdSoul,3408,439,22,16,38,57.9%,35m
8287,3,AllDamnDay,3408,318,17,11,28,60.7%,18m
8287,3,ares,3408,429,17,12,29,58.6%,41m
8287,3,[IvyL]Guibazeon,3408,347,13,13,26,50.0%,29m
8287,3,[αXLa]HeartBeatX,3408,330,12,13,25,48.0%,34m
8287,3,[CHEE53]BitsPlease,3408,272,10,4,14,71.4%,13m
8287,3,Pwrhouse,3408,250,9,6,15,60.0%,27m
8287,3,TheHerb,3408,0,4,1,5,80.0%,34m
8287,3,[AbcCo]Frost,3408,119,3,0,3,100.0%,11m
8287,3,Byulonder,3408,0,1,0,1,100.0%,24m
8287,3,JulioZerg,3408,0,1,0,1,100.0%,7m
8287,1,[GrnBrd]Notausername,3408,0,1,0,1,100.0%,5m
8287,3,[GOSUSA]FluffyOps,3408,30,1,2,3,33.3%,41m
8287,3,Xenomorph,3408,0,0,2,2,0.0%,40m
8287,3,[M1A5]AbsintheNova,3408,0,0,4,4,0.0%,13m
8306,2,zeig,3407,1630,168,172,340,49.4%,19m
8306,3,buru,3407,775,52,39,91,57.1%,25m
8306,2,rakshin,3407,484,17,22,39,43.6%,11m
8306,3,Abundance,3407,90,4,3,7,57.1%,3m
8306,2,PerpetualSki,3407,62,2,12,14,14.3%,2m
8306,3,Dexxin,3407,0,1,0,1,100.0%,37m
8306,3,Farttttt,3407,0,1,0,1,100.0%,18m
8306,3,KillerOB,3407,30,1,5,6,16.7%,23m
8306,3,[Snack]CRS,3407,0,0,1,1,0.0%,38m
8306,3,Siberia,3407,0,0,1,1,0.0%,27m
8306,3,MsCarriage,3407,0,0,1,1,0.0%,16m
8306,3,Beardyman,3407,0,0,2,2,0.0%,30m
8306,3,[KSTONE]AboveThunder,3407,0,0,3,3,0.0%,38m
8319,3,witch,3406,1620,289,242,531,54.4%,7m
8319,2,Gen,3406,718,232,226,458,50.7%,17m
8319,3,Karrgo,3406,1543,195,174,369,52.8%,21m
8319,3,TheFunk,3406,1604,106,105,211,50.2%,27m
8319,2,funkypolarbr,3406,1490,53,59,112,47.3%,37m
8319,2,Cupz,3406,1256,44,51,95,46.3%,38m
8319,3,annbenji,3406,757,36,26,62,58.1%,9m
8319,3,[1Fenix]AREV,3406,440,21,24,45,46.7%,23m
8319,3,MLP,3406,200,8,4,12,66.7%,39m
8319,3,[Lp]Larso,3406,98,4,7,11,36.4%,25m
8319,3,[GEEKED]MicroJackson,3406,58,3,1,4,75.0%,21m
8319,3,DUMMYTHICC,3406,30,1,2,3,33.3%,37m
8319,3,YourDemise,3406,27,1,4,5,20.0%,15m
8319,2,Poindexter,3406,0,0,3,3,0.0%,19m
8333,2,[HEWITT]ChrisJudd,3405,794,26,40,66,39.4%,40m
8333,3,Remades,3405,218,8,4,12,66.7%,23m
8333,3,Serla,3405,0,5,1,6,83.3%,30m
8333,3,Probiotic,3405,86,4,2,6,66.7%,9m
8333,3,THAlLAND,3405,30,2,0,2,100.0%,21m
8333,3,[cl0udM]Divi,3405,30,2,1,3,66.7%,37m
8333,3,Clyde,3405,30,1,4,5,20.0%,19m
8333,3,SHlTSHOW,3405,0,0,1,1,0.0%,14m
8333,2,[Z0]Stone,3405,0,0,2,2,0.0%,28m
8342,3,NeonRider,3404,1321,255,232,487,52.4%,11m
8342,2,Karma,3404,1198,241,229,470,51.3%,7m
8342,2,suprsnail,3404,1608,212,208,420,50.5%,7m
8342,2,Jhyq,3404,967,126,126,252,50.0%,26m
8342,2,Natezog,3404,1575,124,124,248,50.0%,27m
8342,3,Crusader,3404,1574,92,82,174,52.9%,10m
8342,3,[NoTeam]Density,3404,906,85,76,161,52.8%,14m
8342,2,[YCnk]mOdnar,3404,1122,43,54,97,44.3%,4m
8342,3,[S2sex]ILOVESEX,3404,478,18,15,33,54.5%,38m
8342,1,[PobSC]TommyShelby,3404,145,8,5,13,61.5%,36m
8342,3,zion,3404,174,7,4,11,63.6%,32m
8342,2,Low,3404,190,7,20,27,25.9%,15m
8342,3,Velocipablo,3404,60,3,4,7,42.9%,4m
8342,3,Gamma,3404,30,2,4,6,33.3%,18m
8342,3,[PLASM]LavaFlow,3404,30,1,6,7,14.3%,20m
8342,3,[PIMBAS]KRformers,3404,0,0,1,1,0.0%,19m
8358,2,FearzClutch,3403,1452,667,662,1329,50.2%,15m
8358,3,Hisoka,3403,1339,65,39,104,62.5%,19m
8358,3,[SPD360]Chocobo,3403,590,22,26,48,45.8%,24m
8358,3,Mandíbula,3403,86,3,5,8,37.5%,26m
8358,3,DUALITY,3403,88,3,6,9,33.3%,18m
8358,3,[VALK]CLee,3403,30,2,3,5,40.0%,37m
8358,1,[Eunha]XenefeneX,3403,0,1,3,4,25.0%,2h
8358,3,[TPGGXD]danny,3403,0,0,5,5,0.0%,27m
8366,2,ToddyMaster,3402,1551,344,303,647,53.2%,32m
8366,2,[OceanT]CHAMULECO,3402,1608,285,277,562,50.7%,27m
8366,3,Deliveryboy,3402,1361,66,63,129,51.2%,25m
8366,3,AKIDA,3402,114,8,2,10,80.0%,42m
8366,3,[REPORT]Slideways,3402,30,2,2,4,50.0%,33m
8366,3,[M2A5]BEERGUYYYY,3402,30,1,5,6,16.7%,11m
8366,3,Dan,3402,0,0,1,1,0.0%,25m
8366,3,MooSaShe,3402,0,0,1,1,0.0%,21m
8366,3,INLreactor,3402,0,0,1,1,0.0%,34m
8375,3,JacksMedula,3401,1325,54,41,95,56.8%,33m
8375,3,[WW2NA]Caffeine,3401,708,45,33,78,57.7%,15m
8375,3,balbalta,3401,660,28,14,42,66.7%,13m
8375,3,NLJH,3401,406,18,9,27,66.7%,6m
8375,3,Moonjik,3401,311,11,9,20,55.0%,14m
8375,3,Ogyusuh,3401,218,9,6,15,60.0%,24m
8375,3,RubyTopaz,3401,188,8,2,10,80.0%,40m
8375,3,[TTTCA]DuckSauce,3401,174,7,4,11,63.6%,41m
8375,1,Brutality,3401,97,5,1,6,83.3%,2h
8375,3,[trolz]Dino,3401,0,2,3,5,40.0%,20m
8375,3,DozedMenace,3401,0,1,0,1,100.0%,34m
8375,1,[13Pool]shogi,3401,0,1,4,5,20.0%,2h
8375,3,[GRU]Heelion,3401,0,0,3,3,0.0%,15m
8388,2,[Kaii]GoRush,3400,658,119,124,243,49.0%,12m
8388,3,Kalki,3400,1599,116,109,225,51.6%,38m
8388,3,BatesC,3400,666,42,39,81,51.9%,9m
8388,3,Kuro,3400,205,41,40,81,50.6%,17m
8388,2,HBOMB,3400,638,22,32,54,40.7%,35m
8388,3,rexy,3400,515,21,7,28,75.0%,11m
8388,3,jerrymiao,3400,364,15,4,19,78.9%,41m
8388,3,soniiC,3400,330,11,17,28,39.3%,28m
8388,3,SillyPufPuf,3400,120,6,1,7,85.7%,40m
8388,3,DaMan,3400,152,6,12,18,33.3%,14m
8388,3,Khepri,3400,58,3,0,3,100.0%,42m
8388,1,zenus,3400,0,3,1,4,75.0%,2h
8388,3,[Astute]Innovatable,3400,62,3,6,9,33.3%,29m
8388,3,BilichXXV,3400,58,2,3,5,40.0%,15m
8388,3,Dollynho,3400,58,2,4,6,33.3%,26m
8388,3,[VDE]Harsh,3400,0,1,1,2,50.0%,21m
8388,3,[IDFI]TTVAUSJAK,3400,30,1,1,2,50.0%,23m
8388,3,[AOTB]XxEliTeCLoWn,3400,30,1,3,4,25.0%,35m
8388,3,[Dnwlkr]taigel,3400,0,0,1,1,0.0%,27m
8388,3,Coffee,3400,0,0,2,2,0.0%,7m
8388,3,Raistlin,3400,0,0,4,4,0.0%,38m
8409,2,Esco,3399,1013,177,173,350,50.6%,15m
8409,2,Silent,3399,1090,96,104,200,48.0%,29m
8409,3,Violence,3399,1182,49,41,90,54.4%,15m
8409,3,[11001]Yggdrasil,3399,1156,48,46,94,51.1%,13m
8409,3,[SuperZ]hellfire,3399,702,29,14,43,67.4%,3m
8409,2,jrdnRabbit,3399,588,19,29,48,39.6%,27m
8409,2,Djohnas,3399,240,13,8,21,61.9%,10m
8409,1,Fengtree,3399,255,12,5,17,70.6%,6m
8409,3,[TSØP]Darkill,3399,176,7,7,14,50.0%,31m
8409,1,IIIIIIIIII,3399,0,5,0,5,100.0%,55m
8409,3,[LJTV]LazerJuice,3399,30,2,2,4,50.0%,7m
8409,3,NOBODY,3399,60,2,4,6,33.3%,32m
8409,3,[RinNya]Alice,3399,60,2,7,9,22.2%,34m
8409,3,BarackObama,3399,0,0,2,2,0.0%,13m
8423,3,[UpeV]KingNothing,3398,1506,213,207,420,50.7%,33m
8423,2,MaZZa,3398,1050,194,178,372,52.2%,26m
8423,3,GaryTheSnail,3398,568,44,47,91,48.4%,9m
8423,3,[XZL]leon,3398,560,25,6,31,80.6%,43m
8423,3,[TPGGXD]Smile,3398,370,14,13,27,51.9%,39m
8423,3,Starscream,3398,326,13,4,17,76.5%,32m
8423,3,TaZ,3398,202,10,8,18,55.6%,37m
8423,3,IndianaDrone,3398,121,7,1,8,87.5%,23m
8423,2,shroudyrowdy,3398,227,7,13,20,35.0%,17m
8423,3,IIIIIIIIII,3398,58,5,1,6,83.3%,17m
8423,2,loveandmusic,3398,95,5,4,9,55.6%,33m
8423,3,[1E100]Laybunz,3398,82,3,3,6,50.0%,18m
8423,3,Chicholito,3398,0,1,1,2,50.0%,17m
8423,3,BeautyAnd,3398,0,0,1,1,0.0%,42m
8423,3,Joeyocive,3398,0,0,2,2,0.0%,4m
8438,3,funktku,3397,552,30,9,39,76.9%,8m
8438,3,jeep,3397,566,25,25,50,50.0%,18m
8438,3,[TIMBA]MaRaUdEr,3397,536,21,17,38,55.3%,31m
8438,2,dropthebeat,3397,310,10,19,29,34.5%,8m
8438,1,Deceiver,3397,0,5,0,5,100.0%,2h
8438,3,[DoRQ]Zimphar,3397,120,4,5,9,44.4%,11m
8438,3,zekimar,3397,0,1,0,1,100.0%,24m
8438,3,[NKT1]YuiHatano,3397,30,1,4,5,20.0%,22m
8438,3,flarno,3397,0,0,1,1,0.0%,29m
8438,3,Lunchbox,3397,0,0,3,3,0.0%,26m
8448,2,[2FNC]Haste,3396,913,45,48,93,48.4%,26m
8448,3,AskYani,3396,838,35,25,60,58.3%,34m
8448,3,EThasaPC,3396,396,31,32,63,49.2%,35m
8448,3,DaveyGunface,3396,488,17,22,39,43.6%,9m
8448,3,[xRtG]Vegeta,3396,174,6,12,18,33.3%,33m
8448,3,DeathRoe,3396,30,5,2,7,71.4%,9m
8448,3,[GRNSKN]SlubberBub,3396,30,2,1,3,66.7%,38m
8448,3,PowerLock,3396,30,1,1,2,50.0%,24m
8448,3,[RePlz]HazelGreenz,3396,0,0,3,3,0.0%,30m
8457,2,StalkerMage,3395,1403,115,105,220,52.3%,38m
8457,3,[SC2BOL]RUDDY,3395,1599,111,109,220,50.5%,18m
8457,2,JeanFer,3395,874,96,93,189,50.8%,24m
8457,3,[CL3V3R]Bargangilo,3395,1213,76,66,142,53.5%,17m
8457,3,Vayne,3395,707,57,25,82,69.5%,7m
8457,2,sparkster,3395,1238,49,56,105,46.7%,28m
8457,3,Nuageux,3395,970,38,43,81,46.9%,35m
8457,3,MintRoyale,3395,288,34,28,62,54.8%,30m
8457,2,luda,3395,1016,34,55,89,38.2%,26m
8457,3,Ribbons,3395,296,11,11,22,50.0%,35m
8457,3,[FGeek]pentrexyl,3395,162,7,3,10,70.0%,13m
8457,3,tgood,3395,92,4,6,10,40.0%,3m
8457,3,[REPORT]preston,3395,30,2,2,4,50.0%,14m
8457,3,WeakAsDirt,3395,60,2,6,8,25.0%,12m
8457,3,Altair,3395,30,1,3,4,25.0%,6m
8457,3,Brookse,3395,0,1,6,7,14.3%,10m
8457,3,[αX]Nemesis,3395,0,0,1,1,0.0%,27m
8457,3,Tinash,3395,0,0,1,1,0.0%,21m
8457,3,[Conway]cosmos,3395,0,0,1,1,0.0%,35m
8476,2,apaulin,3394,1464,655,630,1285,51.0%,31m
8476,3,palmer,3394,1482,144,122,266,54.1%,20m
8476,2,DroneKing,3394,931,104,103,207,50.2%,33m
8476,3,AnthonellaMC,3394,887,89,66,155,57.4%,21m
8476,3,ToonNPZ,3394,1105,89,88,177,50.3%,11m
8476,3,janosabeee,3394,1467,86,75,161,53.4%,3m
8476,3,[OokOok]Ape,3394,490,22,15,37,59.5%,22m
8476,3,Titus,3394,336,15,8,23,65.2%,35m
8476,3,[Res1st]BigGucciSosa,3394,348,15,9,24,62.5%,32m
8476,3,[UpeV]DarkSpear,3394,361,13,13,26,50.0%,7m
8476,3,[MEvo2]Toe,3394,209,9,6,15,60.0%,35m
8476,3,PGnem,3394,58,3,1,4,75.0%,41m
8476,2,[MER]pYgmY,3394,94,2,1,3,66.7%,34m
8476,3,[TgAg]CrashNburN,3394,0,1,0,1,100.0%,29m
8476,3,[Moo0]SCvirgin,3394,30,1,1,2,50.0%,42m
8476,3,Spart,3394,30,1,5,6,16.7%,30m
8476,3,[DRKNS]RawStar,3394,0,0,1,1,0.0%,37m
8476,1,KinkyKong,3394,0,0,1,1,0.0%,59m
8494,3,[ConFed]Leviathan,3393,1513,393,354,747,52.6%,4m
8494,2,Dyabolic,3393,1573,330,329,659,50.1%,4m
8494,2,[SDC12]HeMp,3393,1493,257,257,514,50.0%,6m
8494,3,Zaur,3393,1383,103,82,185,55.7%,11m
8494,3,[TGCF]Galileo,3393,1318,90,77,167,53.9%,7m
8494,2,ELROnaldoH,3393,1015,57,60,117,48.7%,42m
8494,3,[Emb3rs]Atum,3393,1102,43,37,80,53.8%,25m
8494,3,JasperNoone,3393,537,24,19,43,55.8%,3m
8494,3,muriden,3393,420,18,11,29,62.1%,19m
8494,3,MagicPants,3393,296,13,9,22,59.1%,14m
8494,1,Stingray,3393,257,12,6,18,66.7%,23m
8494,3,Player,3393,228,9,6,15,60.0%,36m
8494,3,MetalMan,3393,145,8,7,15,53.3%,27m
8494,3,Lubacca,3393,0,5,0,5,100.0%,3m
8494,3,Plastron,3393,30,2,0,2,100.0%,38m
8494,3,[NastyB]Raihalo,3393,0,1,0,1,100.0%,18m
8494,3,[FiFo]blazedingo,3393,0,0,1,1,0.0%,30m
8494,3,[RGang]Arcades,3393,0,0,2,2,0.0%,38m
8512,3,Meow,3392,1036,38,44,82,46.3%,22m
8512,2,[EtrOy]Meatball,3392,634,26,25,51,51.0%,14m
8512,3,Kyojin,3392,373,16,8,24,66.7%,29m
8512,3,czechondeck,3392,309,14,9,23,60.9%,43m
8512,3,[UpeV]MaXiiMoO,3392,316,11,16,27,40.7%,21m
8512,3,Reap,3392,336,11,17,28,39.3%,29m
8512,3,[ML]KaaS,3392,114,9,3,12,75.0%,13m
8512,3,Landrew,3392,114,7,8,15,46.7%,35m
8512,3,ryux,3392,86,3,1,4,75.0%,24m
8512,3,Major,3392,58,3,4,7,42.9%,6m
8512,3,[SuperZ]dapple,3392,86,3,6,9,33.3%,9m
8512,2,Freaking,3392,0,2,6,8,25.0%,22m
8512,3,speaknow,3392,0,1,1,2,50.0%,22m
8512,3,Blastoise,3392,0,0,1,1,0.0%,13m
8512,3,[QTclub]Dust,3392,0,0,1,1,0.0%,39m
8512,3,elsonny,3392,0,0,2,2,0.0%,4m
8528,2,[GrnBrd]BREAKR,3391,1503,369,356,725,50.9%,12m
8528,2,Quest,3391,1536,227,229,456,49.8%,29m
8528,3,yumedoko,3391,1626,105,99,204,51.5%,13m
8528,2,[THC420]Drone,3391,1500,79,78,157,50.3%,37m
8528,2,Sylricc,3391,862,77,79,156,49.4%,9m
8528,3,wowaka,3391,570,66,47,113,58.4%,36m
8528,2,Kreeper,3391,748,49,61,110,44.5%,26m
8528,3,[UpeV]SrPipeneisho,3391,356,13,12,25,52.0%,23m
8528,2,NullPointer,3391,267,7,13,20,35.0%,37m
8528,3,[FJLAK]ddmpc,3391,0,1,0,1,100.0%,39m
8528,3,[AESCII]Javeto,3391,0,0,1,1,0.0%,4m
8528,3,wherevugo,3391,0,0,2,2,0.0%,18m
8540,3,TheMuffinMan,3390,1238,124,107,231,53.7%,35m
8540,2,[KiMBR]Sinistro,3390,1530,110,110,220,50.0%,17m
8540,2,Stinray,3390,503,44,38,82,53.7%,12m
8540,3,SolidSKD,3390,368,13,14,27,48.1%,3m
8540,3,NirvSpin,3390,168,8,3,11,72.7%,15m
8540,3,[hTx]Saiyaman,3390,179,5,2,7,71.4%,33m
8540,3,KARAKURT,3390,114,5,4,9,55.6%,35m
8540,3,HateGGONG,3390,148,5,6,11,45.5%,41m
8540,3,MohammerD,3390,0,1,0,1,100.0%,31m
8540,3,Lsebita,3390,0,1,0,1,100.0%,40m
8540,3,Sonny,3390,0,1,2,3,33.3%,31m
8540,1,[NPhase]Caquil,3390,48,1,7,8,12.5%,37m
8540,3,CptMorgan,3390,0,0,1,1,0.0%,39m
8540,3,[SBlock]Alan,3390,0,0,1,1,0.0%,38m
8540,3,EhMove,3390,0,0,2,2,0.0%,29m
8555,3,[αXLa]Nocturnal,3389,722,30,23,53,56.6%,6m
8555,3,RiceGang,3389,38,6,2,8,75.0%,21m
8555,3,[RUINPP]Innocence,3389,92,3,6,9,33.3%,25m
8555,3,tooPrime,3389,30,2,3,5,40.0%,23m
8555,3,YellowBanana,3389,0,2,3,5,40.0%,6m
8555,3,Nerchio,3389,0,0,2,2,0.0%,25m
8555,3,AinsOoalGown,3389,0,0,5,5,0.0%,32m
8562,2,[VlPeRz]SkullStew,3388,1542,162,169,331,48.9%,11m
8562,2,[SsaYnS]IIIIIIIIIIII,3388,659,108,116,224,48.2%,7m
8562,2,pyle,3388,1574,107,111,218,49.1%,21m
8562,3,[DEANIM]WhiteHorse,3388,1559,98,93,191,51.3%,16m
8562,3,Fish,3388,982,89,67,156,57.1%,42m
8562,3,Tangent,3388,1626,68,62,130,52.3%,21m
8562,3,ViLe,3388,667,30,19,49,61.2%,8m
8562,3,[BRSKR]Kuro,3388,233,13,4,17,76.5%,8m
8562,3,[Asar]SnoW,3388,196,13,5,18,72.2%,32m
8562,3,DoubleYouP,3388,230,8,12,20,40.0%,40m
8562,3,KEN,3388,194,7,6,13,53.8%,39m
8562,3,[FoTG]sGstorm,3388,42,6,2,8,75.0%,15m
8562,3,[Pharoh]MadeInCanada,3388,118,5,5,10,50.0%,38m
8562,3,Dusan,3388,60,2,5,7,28.6%,25m
8562,3,[LIR]TheGeneral,3388,0,0,1,1,0.0%,34m
8577,3,Chemyst,3387,1631,333,317,650,51.2%,24m
8577,2,[AiMB]MissMicro,3387,920,145,140,285,50.9%,14m
8577,3,Craussie,3387,1520,104,111,215,48.4%,15m
8577,3,[The248]IamUgly,3387,1646,88,60,148,59.5%,36m
8577,3,Xavante,3387,1132,42,46,88,47.7%,27m
8577,2,[Crew]RallosZek,3387,626,21,32,53,39.6%,37m
8577,3,xiON,3387,453,18,22,40,45.0%,26m
8577,3,MagicToaster,3387,89,6,12,18,33.3%,20m
8577,3,Tethys,3387,81,3,2,5,60.0%,35m
8577,3,[NBNS]Ball,3387,30,2,0,2,100.0%,17m
8577,3,KnerveD,3387,0,2,3,5,40.0%,39m
8577,3,[DRKESP]orrije,3387,0,1,0,1,100.0%,4m
8577,3,[Radial]DuckSauce,3387,0,0,1,1,0.0%,35m
8577,3,[MeXx]SpeedyG,3387,0,0,1,1,0.0%,39m
8577,3,[VFam]Varibash,3387,0,0,2,2,0.0%,15m
8592,2,BBROCKS,3386,1590,129,132,261,49.4%,3m
8592,2,name,3386,1384,80,91,171,46.8%,6m
8592,2,saview,3386,1296,70,80,150,46.7%,3m
8592,3,[Taller]TMOE,3386,1052,40,47,87,46.0%,36m
8592,3,Blake,3386,472,20,14,34,58.8%,39m
8592,3,IIIIIIIIIIII,3386,328,11,15,26,42.3%,35m
8592,3,LiquidPaper,3386,272,10,10,20,50.0%,33m
8592,3,[neuroW]Spoon,3386,240,9,15,24,37.5%,41m
8592,3,Bali,3386,0,5,1,6,83.3%,5m
8592,3,[InGt]Diomedes,3386,0,1,0,1,100.0%,36m
8592,3,[EBIZ]RedDemon,3386,0,0,1,1,0.0%,29m
8592,3,[Dbird]DancingBird,3386,0,0,1,1,0.0%,24m
8604,2,MlonEusk,3385,1580,427,426,853,50.1%,32m
8604,2,Electryc,3385,1430,209,206,415,50.4%,36m
8604,3,[OGbros]Maniac,3385,1360,98,91,189,51.9%,13m
8604,3,[LgnTDS]MmNymphaceae,3385,1560,95,80,175,54.3%,25m
8604,3,[ixM]tetec,3385,1311,76,70,146,52.1%,24m
8604,3,BelegtesBrot,3385,1351,72,69,141,51.1%,33m
8604,3,[ICE8]MCC,3385,590,21,21,42,50.0%,39m
8604,3,TheBeast,3385,428,17,5,22,77.3%,24m
8604,3,Frankzhao,3385,434,16,14,30,53.3%,24m
8604,3,[iddo]Asunder,3385,251,13,13,26,50.0%,17m
8604,3,Ironface,3385,86,4,1,5,80.0%,20m
8604,3,[SuperZ]NorthAnor,3385,0,1,0,1,100.0%,22m
8604,3,Shepard,3385,0,1,0,1,100.0%,2m
8604,3,TuSKachetes,3385,0,1,1,2,50.0%,36m
8604,3,[KOATS]ChillBot,3385,30,1,5,6,16.7%,40m
8619,2,ElemenT,3384,1296,289,256,545,53.0%,8m
8619,3,[Nfreak]Kerplunk,3384,893,65,61,126,51.6%,37m
8619,3,llllllllllll,3384,534,52,27,79,65.8%,17m
8619,3,[LGNxx]Bellephron,3384,651,40,37,77,51.9%,20m
8619,2,Soberano,3384,632,24,35,59,40.7%,34m
8619,3,Shura,3384,556,21,17,38,55.3%,27m
8619,3,[ezzzz1]FalconPawnch,3384,250,10,9,19,52.6%,3m
8619,3,[YD2K]Kabal,3384,166,7,1,8,87.5%,28m
8619,1,[3939]CatBus,3384,177,6,5,11,54.5%,7m
8619,3,[Granpa]kOrc,3384,184,6,10,16,37.5%,41m
8619,3,PhúÔngNghèo,3384,48,3,2,5,60.0%,2m
8619,3,Titanite,3384,0,1,0,1,100.0%,34m
8619,3,[RakF]BALOU,3384,0,1,1,2,50.0%,8m
8619,3,Twabiiz,3384,0,0,1,1,0.0%,19m
8619,1,IIllIlIIllII,3384,0,0,5,5,0.0%,2h
8634,2,HornyZealot,3383,1046,239,239,478,50.0%,26m
8634,3,mirvinos,3383,1561,151,146,297,50.8%,24m
8634,2,[1LPD]Darkmerlinn,3383,1076,36,49,85,42.4%,7m
8634,2,PowerOfQueen,3383,827,34,32,66,51.5%,7m
8634,3,[hX]Gatekeeper,3383,348,12,12,24,50.0%,26m
8634,3,BlackBird,3383,292,11,7,18,61.1%,12m
8634,3,Thomas,3383,97,7,13,20,35.0%,24m
8634,3,Prometheus,3383,0,5,1,6,83.3%,7m
8634,3,LionKing,3383,34,3,6,9,33.3%,27m
8634,3,dawn,3383,58,2,2,4,50.0%,19m
8634,3,[KerriS]Fatline,3383,0,0,1,1,0.0%,27m
8634,3,ZZZ,3383,0,0,2,2,0.0%,8m
8634,3,[Kaii]maX,3383,0,0,3,3,0.0%,23m
8647,2,ninkum,3382,1542,102,114,216,47.2%,4m
8647,3,ZergLord,3382,1561,86,62,148,58.1%,41m
8647,2,Envious,3382,1156,78,86,164,47.6%,17m
8647,2,Stifflers,3382,656,21,34,55,38.2%,30m
8647,2,DarkJustice,3382,318,12,4,16,75.0%,14m
8647,1,Meropenem,3382,277,12,7,19,63.2%,28m
8647,2,[FANXY]NoBrand,3382,276,10,4,14,71.4%,32m
8647,3,asdasdasd,3382,146,5,5,10,50.0%,29m
8647,2,[Exper]DYa,3382,94,3,12,15,20.0%,35m
8647,3,Error,3382,113,2,1,3,66.7%,37m
8647,3,Rocker,3382,0,0,1,1,0.0%,24m
8647,3,[5ITH]MaxPower,3382,0,0,1,1,0.0%,28m
8647,3,Mag,3382,0,0,2,2,0.0%,34m
8647,3,Cheddar,3382,0,0,3,3,0.0%,26m
8647,3,KillroyNQP,3382,0,0,5,5,0.0%,30m
8662,2,bobby,3381,1532,77,75,152,50.7%,12m
8662,3,FachoPobre,3381,692,30,18,48,62.5%,33m
8662,3,[BUMFUK]kneeinthesac,3381,388,15,10,25,60.0%,16m
8662,1,[OuOb]KotouraChan,3381,97,5,1,6,83.3%,2m
8662,3,Davefitz,3381,152,5,9,14,35.7%,30m
8662,3,[IMAC]IIIIIIIIIIII,3381,60,2,7,9,22.2%,6m
8662,3,Infrared,3381,0,1,0,1,100.0%,8m
8662,3,FugazeMasta,3381,0,1,0,1,100.0%,37m
8662,3,ILuvYuriOwO,3381,0,1,0,1,100.0%,40m
8662,3,ByakkoT,3381,0,1,0,1,100.0%,36m
8662,3,DarlingPinky,3381,0,1,0,1,100.0%,3m
8662,3,Moïra,3381,30,1,2,3,33.3%,24m
8662,3,[CHARR]Tmoy,3381,30,1,8,9,11.1%,15m
8662,3,Prince,3381,0,0,1,1,0.0%,24m
8662,3,Dakalo,3381,0,0,2,2,0.0%,6m
8677,2,[Shang]Zam,3380,1070,52,60,112,46.4%,34m
8677,3,HappyTwoBe,3380,626,24,19,43,55.8%,41m
8677,3,SpeedVolt,3380,294,13,7,20,65.0%,38m
8677,3,[KingSC]DarkDelta,3380,166,7,3,10,70.0%,4m
8677,3,Mengsk,3380,58,2,2,4,50.0%,24m
8677,3,[Slum]Uhaen,3380,62,2,8,10,20.0%,29m
8677,3,TGFOnTheRun,3380,30,1,2,3,33.3%,23m
8677,3,SEFY,3380,30,1,7,8,12.5%,7m
8677,2,Gatt,3380,30,1,9,10,10.0%,29m
8677,3,lIllllIIlIll,3380,0,0,1,1,0.0%,40m
8677,3,[FxB]Kalypso,3380,0,0,1,1,0.0%,10m
8677,3,[3TT]MarkM,3380,0,0,3,3,0.0%,34m
8677,3,RectumRavage,3380,0,0,4,4,0.0%,25m
8690,2,[WARLEY]ignoh,3379,1346,207,197,404,51.2%,29m
8690,1,gUNSHIP,3379,164,6,2,8,75.0%,26m
8690,3,kobachnoby,3379,118,5,5,10,50.0%,27m
8690,3,ilililililil,3379,30,4,3,7,57.1%,39m
8690,3,[Egos]Omega,3379,0,1,1,2,50.0%,37m
8690,3,[CH1LL]CnlSanders,3379,0,0,1,1,0.0%,19m
8690,3,fatman,3379,0,0,1,1,0.0%,14m
8690,3,DeDe,3379,0,0,1,1,0.0%,2m
8690,3,Wambs,3379,0,0,1,1,0.0%,24m
8690,3,nightknight,3379,0,0,1,1,0.0%,36m
8700,2,DrunkDwarf,3378,1280,146,148,294,49.7%,17m
8700,3,[Ch0nk]HukuYa,3378,1413,123,111,234,52.6%,40m
8700,3,[SyLx]Sam,3378,1052,50,24,74,67.6%,3m
8700,3,[xRtGac]RuneX,3378,474,17,18,35,48.6%,35m
8700,3,[TSØP]GosuGhost,3378,356,15,1,16,93.8%,15m
8700,3,Crylog,3378,414,15,16,31,48.4%,7m
8700,2,BARCHART,3378,76,13,26,39,33.3%,3m
8700,1,BlackSheep,3378,268,10,3,13,76.9%,37m
8700,3,[FalPal]FattyESQ,3378,254,9,7,16,56.2%,9m
8700,3,BestBnchBudy,3378,114,5,1,6,83.3%,14m
8700,3,ShOcKeR,3378,86,4,2,6,66.7%,30m
8700,3,[DhZPro]Novais,3378,86,4,4,8,50.0%,17m
8700,3,[PrimuS]Grande,3378,60,3,7,10,30.0%,36m
8700,3,AnimeLove,3378,0,1,6,7,14.3%,33m
8700,3,[LDPro]ZerX,3378,0,0,1,1,0.0%,34m
8700,3,[PiGPan]MensRea,3378,0,0,7,7,0.0%,21m
8716,3,BeefSirPreme,3377,892,223,219,442,50.5%,27m
8716,2,[urdone]Night,3377,1509,127,117,244,52.0%,6m
8716,3,[TAC05]iBeatAlfaStr,3377,1603,126,110,236,53.4%,2m
8716,3,[Lp]lllIlIlIIlIl,3377,658,91,85,176,51.7%,24m
8716,3,[SKyber]yoshymaro,3377,1269,82,53,135,60.7%,19m
8716,2,Yone,3377,653,50,44,94,53.2%,5m
8716,2,Degnoob,3377,915,39,52,91,42.9%,40m
8716,3,DrunkDealer,3377,1018,36,36,72,50.0%,22m
8716,3,FellHire,3377,379,16,7,23,69.6%,2m
8716,3,Swanky,3377,372,15,4,19,78.9%,41m
8716,3,IIIIIIIIIIII,3377,252,12,9,21,57.1%,10m
8716,3,SneakyTurtle,3377,145,7,1,8,87.5%,38m
8716,3,[CBGz]FrAgiLe,3377,62,2,4,6,33.3%,2m
8716,3,batty,3377,30,2,6,8,25.0%,24m
8716,3,Voyd,3377,0,1,0,1,100.0%,12m
8716,3,seVeN,3377,0,1,0,1,100.0%,39m
8716,1,Slemp,3377,0,1,0,1,100.0%,21m
8716,3,HotSoupForJD,3377,0,1,0,1,100.0%,33m
8716,2,[DogLRD]ALeNiDaS,3377,0,0,1,1,0.0%,28m
8716,2,Planter,3377,0,0,1,1,0.0%,31m
8716,3,[PvZzim]Szabo,3377,0,0,2,2,0.0%,38m
8737,3,energizer,3376,1552,275,275,550,50.0%,14m
8737,3,[TeamUR]Andacht,3376,1592,58,63,121,47.9%,8m
8737,3,[DhZPro]COSMOS,3376,935,42,36,78,53.8%,35m
8737,2,murkleston,3376,972,33,43,76,43.4%,22m
8737,3,Maurik,3376,641,30,33,63,47.6%,30m
8737,3,HelloKitty,3376,538,23,13,36,63.9%,33m
8737,3,starjoy,3376,289,21,11,32,65.6%,8m
8737,3,[LPPTSO]king,3376,600,20,25,45,44.4%,32m
8737,3,Skewmer,3376,506,18,22,40,45.0%,40m
8737,3,armada,3376,368,13,14,27,48.1%,25m
8737,3,Inchoatus,3376,210,8,9,17,47.1%,38m
8737,3,[BlHawk]josimar,3376,202,7,6,13,53.8%,22m
8737,3,tooEZ,3376,114,4,1,5,80.0%,36m
8737,3,SmokeDank,3376,116,4,5,9,44.4%,30m
8737,3,Puddlez,3376,120,4,8,12,33.3%,13m
8737,2,Roberts,3376,122,4,14,18,22.2%,24m
8737,3,[SCHack]shin,3376,58,2,2,4,50.0%,8m
8737,3,Wolf,3376,60,2,3,5,40.0%,30m
8737,3,Thomas,3376,58,2,5,7,28.6%,35m
8737,3,Supreme,3376,0,1,0,1,100.0%,24m
8737,3,[PTHero]lovegames,3376,0,1,0,1,100.0%,11m
8737,3,StarLord,3376,0,0,1,1,0.0%,13m
8737,3,IIIIllllIIlI,3376,0,0,2,2,0.0%,9m
8760,3,TheCurian,3375,1267,86,72,158,54.4%,11m
8760,2,[SsaYnS]Jdban,3375,1507,70,79,149,47.0%,4m
8760,3,lWorstGodl,3375,1122,46,38,84,54.8%,8m
8760,3,[SAUC3]OsmOse,3375,323,27,30,57,47.4%,35m
8760,3,[TgAg]phabej,3375,430,15,21,36,41.7%,2m
8760,3,[TGCrew]Sesso,3375,348,12,15,27,44.4%,8m
8760,3,Pubby,3375,292,11,10,21,52.4%,35m
8760,3,[BIacer]HiveMind,3375,192,7,3,10,70.0%,38m
8760,3,Fenrack,3375,90,4,4,8,50.0%,25m
8760,2,ErsatzGhost,3375,148,3,12,15,20.0%,32m
8760,3,Dee,3375,58,2,2,4,50.0%,32m
8760,3,[JB]modelo,3375,60,2,4,6,33.3%,29m
8760,1,ChugCafeBro,3375,0,1,0,1,100.0%,32m
8760,3,unforgivable,3375,0,1,5,6,16.7%,17m
8760,3,Applecore,3375,0,0,1,1,0.0%,22m
8760,3,Kush,3375,0,0,1,1,0.0%,25m
8760,3,[HYXJM]MGJTerran,3375,0,0,4,4,0.0%,21m
8777,3,will,3374,1665,156,144,300,52.0%,33m
8777,2,YoureHotToo,3374,1466,141,143,284,49.6%,26m
8777,3,DbBested,3374,913,129,110,239,54.0%,32m
8777,3,Bonesaw,3374,508,35,14,49,71.4%,38m
8777,3,Zaxc,3374,715,34,23,57,59.6%,30m
8777,3,[4KILL]Fcaponi,3374,721,29,23,52,55.8%,21m
8777,3,tuziko,3374,347,16,10,26,61.5%,16m
8777,2,Brogrammer,3374,147,16,24,40,40.0%,26m
8777,2,[WNTR]Liko,3374,241,16,28,44,36.4%,17m
8777,2,[TlLT]Drayhem,3374,158,5,14,19,26.3%,34m
8777,3,gamer,3374,58,3,1,4,75.0%,3m
8777,3,[ALQ]HanzoJR,3374,30,2,2,4,50.0%,15m
8777,3,Blaze,3374,30,2,2,4,50.0%,3m
8777,3,IIIIIIIIIIII,3374,0,1,0,1,100.0%,24m
8777,1,llllllllllll,3374,46,1,1,2,50.0%,28m
8777,3,[MDC]TheJester,3374,0,0,1,1,0.0%,30m
8777,3,Birdie,3374,0,0,1,1,0.0%,10m
8794,3,[PHX121]PhOeNiX,3373,811,105,89,194,54.1%,24m
8794,2,JeffCalamari,3373,1522,94,87,181,51.9%,18m
8794,2,IIIIIIIIIIII,3373,268,11,3,14,78.6%,30m
8794,3,froggo,3373,202,11,7,18,61.1%,15m
8794,3,[NwAs]PinkFloyd,3373,266,10,5,15,66.7%,14m
8794,3,GloriaEhre,3373,196,7,8,15,46.7%,4m
8794,3,IIIIIIIIIIII,3373,119,6,1,7,85.7%,20m
8794,3,OldGreyFace,3373,205,6,5,11,54.5%,25m
8794,3,DIOMEDES,3373,146,6,6,12,50.0%,3m
8794,3,CERC,3373,144,5,6,11,45.5%,36m
8794,3,MEGALOVANIA,3373,166,4,6,10,40.0%,8m
8794,3,spacecake,3373,0,3,2,5,60.0%,9m
8794,3,[240C]TheeDefiler,3373,58,2,2,4,50.0%,7m
8794,3,FreePizza,3373,0,0,1,1,0.0%,24m
8794,3,[αXLa]StrucK,3373,0,0,4,4,0.0%,38m
8794,3,[TRVMPD]skinnyM,3373,0,0,5,5,0.0%,23m
8810,3,Criewry,3372,1072,181,167,348,52.0%,27m
8810,3,Sage,3372,1029,45,29,74,60.8%,16m
8810,3,Scarlett,3372,627,37,0,37,100.0%,11m
8810,3,[NPhasA]NeoHanzo,3372,636,24,29,53,45.3%,36m
8810,3,catalyst,3372,388,15,12,27,55.6%,35m
8810,3,iLoveRaymond,3372,393,14,7,21,66.7%,22m
8810,3,Aneurysm,3372,250,9,7,16,56.2%,26m
8810,3,[B0NER]kerrigasm,3372,86,7,2,9,77.8%,13m
8810,1,OnLine,3372,120,6,1,7,85.7%,2h
8810,3,BraneloB,3372,0,5,1,6,83.3%,29m
8810,3,Khuyakoss,3372,180,5,4,9,55.6%,30m
8810,3,Jmpzisbad,3372,192,5,6,11,45.5%,38m
8810,3,Air,3372,152,5,11,16,31.2%,13m
8810,3,[Th3Bad]YanXII,3372,86,4,0,4,100.0%,10m
8810,3,Gpremier,3372,62,3,5,8,37.5%,17m
8810,3,[HUSTLA]minkus,3372,60,3,6,9,33.3%,30m
8810,3,[CRAKS]schnaider,3372,58,2,1,3,66.7%,11m
8810,3,Reynor,3372,0,2,6,8,25.0%,19m
8810,3,Chibabti,3372,0,1,0,1,100.0%,11m
8810,3,AndBorK,3372,30,1,1,2,50.0%,8m
8810,3,Sunny,3372,0,1,1,2,50.0%,11m
8810,3,FooFoo,3372,30,1,3,4,25.0%,14m
8810,3,[dLife]Bardolatry,3372,0,0,1,1,0.0%,32m
8810,3,[wanta]Fanta,3372,0,0,4,4,0.0%,11m
8834,3,Alexsarge,3371,1315,108,106,214,50.5%,25m
8834,3,KINGBLADE,3371,738,42,43,85,49.4%,38m
8834,3,[GEEKED]Amorfo,3371,541,28,5,33,84.8%,28m
8834,3,TreeFiddyZed,3371,568,21,24,45,46.7%,21m
8834,3,Mateo,3371,396,18,10,28,64.3%,37m
8834,3,[DHZ0ne]Vicarious,3371,209,10,4,14,71.4%,22m
8834,3,Biel,3371,58,7,1,8,87.5%,10m
8834,3,Mikro,3371,90,6,4,10,60.0%,14m
8834,3,ShawnGe,3371,120,4,4,8,50.0%,15m
8834,3,[ANIMOO]hurdler,3371,88,3,5,8,37.5%,25m
8834,3,[neuroW]tbobaggins,3371,62,2,6,8,25.0%,15m
8834,3,javitoh,3371,30,1,3,4,25.0%,30m
8834,3,Clearlove,3371,30,1,3,4,25.0%,35m
8847,2,JonnyB,3370,1365,282,286,568,49.6%,32m
8847,3,RaptoR,3370,1540,271,249,520,52.1%,30m
8847,2,NeutralLock,3370,1356,205,189,394,52.0%,20m
8847,3,BabyRage,3370,1439,166,162,328,50.6%,38m
8847,3,[VFam]Zaechus,3370,1332,50,54,104,48.1%,13m
8847,3,Rainbow,3370,876,34,27,61,55.7%,39m
8847,3,Mace,3370,684,26,19,45,57.8%,32m
8847,3,TheDude,3370,170,24,27,51,47.1%,18m
8847,3,Zanshin,3370,386,16,9,25,64.0%,29m
8847,3,WizKhalifa,3370,273,16,18,34,47.1%,40m
8847,3,hubs,3370,354,12,13,25,48.0%,25m
8847,3,ForSATB,3370,114,8,2,10,80.0%,37m
8847,2,Cthultist,3370,138,7,7,14,50.0%,7m
8847,1,[Atone]angrykitten,3370,120,6,1,7,85.7%,2h
8847,3,[NPhasA]BenDrummin,3370,150,6,10,16,37.5%,14m
8847,3,[Fever]Astra,3370,114,5,1,6,83.3%,26m
8847,3,kaykoose,3370,30,1,2,3,33.3%,10m
8847,3,GuiZerg,3370,30,1,5,6,16.7%,30m
8847,3,ChRoNoS,3370,0,0,1,1,0.0%,29m
8847,3,TrollingPoll,3370,0,0,1,1,0.0%,10m
8867,2,[Sune]ArcangelCR,3369,1557,236,239,475,49.7%,27m
8867,2,Vagitarian,3369,1180,84,77,161,52.2%,25m
8867,3,LYM,3369,1085,47,34,81,58.0%,15m
8867,3,Harkonnen,3369,994,40,31,71,56.3%,32m
8867,3,[CGS]Guarnere,3369,290,25,23,48,52.1%,39m
8867,3,Bombastic,3369,548,24,15,39,61.5%,25m
8867,3,Intention,3369,572,23,14,37,62.2%,11m
8867,3,Jlamar,3369,120,6,2,8,75.0%,13m
8867,3,Bulma,3369,58,2,1,3,66.7%,41m
8867,3,Turgon,3369,30,1,2,3,33.3%,38m
8867,3,fireblaze,3369,0,0,1,1,0.0%,25m
8867,3,[InstaF]Nivarana,3369,0,0,1,1,0.0%,7m
8867,3,[CtSE]lllXXlll,3369,0,0,2,2,0.0%,19m
8880,3,[MtnDwd]TnTn,3368,1557,211,192,403,52.4%,10m
8880,3,[TGCF]Acrean,3368,1352,194,170,364,53.3%,25m
8880,3,AwakinG,3368,1253,154,121,275,56.0%,3m
8880,3,Tiburon,3368,1355,134,127,261,51.3%,9m
8880,3,[iTHC]hendo,3368,386,13,14,27,48.1%,3m
8880,3,Dethyus,3368,30,2,1,3,66.7%,40m
8880,3,Wouloulou,3368,30,2,2,4,50.0%,7m
8880,3,Inchoation,3368,0,1,0,1,100.0%,41m
8880,3,[Xpk]PaTiMoViL,3368,0,1,1,2,50.0%,26m
8880,3,Vilification,3368,0,1,2,3,33.3%,32m
8880,3,[TGosuA]Akrith,3368,0,0,1,1,0.0%,37m
8880,1,Spoon,3368,0,0,2,2,0.0%,2h
8880,3,DEMONWB,3368,0,0,4,4,0.0%,21m
8893,2,Catalyst,3367,1046,89,88,177,50.3%,33m
8893,2,[BONCK]DiolaH,3367,740,77,69,146,52.7%,25m
8893,3,[DDay]Visrix,3367,895,54,43,97,55.7%,24m
8893,2,UrineTrouble,3367,951,49,47,96,51.0%,17m
8893,3,PainHex,3367,178,26,25,51,51.0%,39m
8893,3,BuShiDo,3367,516,23,13,36,63.9%,12m
8893,1,ricepaper,3367,90,7,0,7,100.0%,3h
8893,3,Papajenks,3367,172,6,6,12,50.0%,30m
8893,2,Kiwi,3367,170,5,4,9,55.6%,14m
8893,3,CoR,3367,86,3,1,4,75.0%,41m
8893,3,RandyScrandy,3367,0,0,1,1,0.0%,24m
8904,2,[BUTIFL]Zeebz,3366,1554,110,110,220,50.0%,12m
8904,3,[fatb0i]azaturi,3366,296,76,34,110,69.1%,13m
8904,3,Toad,3366,1010,40,34,74,54.1%,21m
8904,3,TethRa,3366,845,36,26,62,58.1%,26m
8904,3,fihgu,3366,205,22,11,33,66.7%,15m
8904,3,SAIKI,3366,432,19,4,23,82.6%,30m
8904,1,DevilsPants,3366,272,11,8,19,57.9%,2m
8904,3,BURN,3366,274,10,16,26,38.5%,41m
8904,3,Present,3366,235,8,2,10,80.0%,37m
8904,3,WeirdRat,3366,158,5,12,17,29.4%,21m
8904,3,BigThiccVic,3366,144,3,5,8,37.5%,39m
8904,3,Dangus,3366,64,3,7,10,30.0%,11m
8904,3,Aegis,3366,30,1,1,2,50.0%,9m
8917,2,llllllllllll,3365,1490,145,141,286,50.7%,36m
8917,3,SkynetIII,3365,1627,84,72,156,53.8%,2m
8917,2,Profit,3365,1316,79,77,156,50.6%,40m
8917,3,Radioactive,3365,1431,59,43,102,57.8%,9m
8917,2,[ZCCCFE]kaboom,3365,754,30,29,59,50.8%,10m
8917,3,Beetlejuice,3365,714,28,21,49,57.1%,7m
8917,3,[AbcCo]Endimión,3365,698,28,21,49,57.1%,14m
8917,2,[NOTHIM]Solar,3365,574,20,30,50,40.0%,13m
8917,3,[Truies]Tom,3365,484,19,18,37,51.4%,9m
8917,3,INFINITY,3365,554,19,36,55,34.5%,21m
8917,3,zaphod,3365,426,17,9,26,65.4%,32m
8917,3,NervE,3365,228,9,11,20,45.0%,24m
8917,3,Trout,3365,218,8,14,22,36.4%,30m
8917,3,Arkelus,3365,166,6,4,10,60.0%,40m
8917,3,Brothers,3365,148,6,5,11,54.5%,36m
8917,3,RandyLahey,3365,142,5,5,10,50.0%,8m
8917,1,[1TL]DrWhalePants,3365,184,4,4,8,50.0%,8m
8917,3,chloesaurus,3365,73,3,4,7,42.9%,9m
8917,3,[Toss]MountPutuo,3365,0,1,0,1,100.0%,37m
8917,3,Mayucchi,3365,0,0,1,1,0.0%,35m
8917,3,JpDestrok,3365,0,0,1,1,0.0%,35m
8917,3,[KSGT]MrLasti,3365,0,0,1,1,0.0%,20m
8917,3,[WEML]BobbyFlay,3365,0,0,2,2,0.0%,41m
8940,3,Skyfox,3364,1513,86,78,164,52.4%,15m
8940,3,PurplEmperor,3364,541,26,17,43,60.5%,23m
8940,3,toddman,3364,662,26,22,48,54.2%,25m
8940,3,DeusRekt,3364,362,15,2,17,88.2%,39m
8940,3,Rubicrack,3364,295,12,4,16,75.0%,38m
8940,3,IIIIIIIIIIII,3364,30,5,1,6,83.3%,3m
8940,3,OpJeof,3364,0,1,0,1,100.0%,11m
8940,3,[MoistB]skinnybenis,3364,30,1,4,5,20.0%,32m
8940,3,idiZa,3364,0,1,4,5,20.0%,3m
8940,3,[TB303]FinnTheHuman,3364,0,0,1,1,0.0%,2m
8940,3,IIIIIIIIIIII,3364,0,0,2,2,0.0%,3m
8940,3,LitrinAzul,3364,0,0,3,3,0.0%,2m
8940,3,[EvilCC]Death,3364,0,0,3,3,0.0%,39m
8953,2,[VFam]LoveMachine,3363,1565,470,459,929,50.6%,31m
8953,2,[LTK]CaDanGr,3363,1539,116,108,224,51.8%,6m
8953,3,YiSuS,3363,779,66,63,129,51.2%,40m
8953,3,Polymorphic,3363,434,26,23,49,53.1%,39m
8953,3,Aseos,3363,564,23,15,38,60.5%,3m
8953,2,GameOfDrones,3363,178,10,8,18,55.6%,37m
8953,3,[Mc]iCUBASICLE,3363,189,8,3,11,72.7%,35m
8953,3,pBon,3363,242,8,17,25,32.0%,30m
8953,3,[GRNSKN]Skynet,3363,58,3,6,9,33.3%,24m
8953,3,FlorencioFan,3363,0,1,3,4,25.0%,41m
8953,3,Ender,3363,0,0,1,1,0.0%,10m
8953,3,PGID,3363,0,0,1,1,0.0%,30m
8953,3,You,3363,0,0,1,1,0.0%,10m
8953,3,EinEi,3363,0,0,1,1,0.0%,10m
8953,3,Heart,3363,0,0,1,1,0.0%,19m
8968,3,[RUMB]dtgRazer,3362,793,141,130,271,52.0%,39m
8968,3,jOSH,3362,978,95,80,175,54.3%,6m
8968,3,KamalaHaRriS,3362,526,21,11,32,65.6%,30m
8968,3,Nanami,3362,520,17,25,42,40.5%,28m
8968,3,[cl0udM]theprophecy,3362,340,12,10,22,54.5%,4m
8968,3,[Cryptc]Lazorcat,3362,318,12,14,26,46.2%,10m
8968,3,Striver,3362,148,5,8,13,38.5%,29m
8968,1,aKHolic,3362,0,3,2,5,60.0%,56m
8968,3,SAC,3362,0,0,1,1,0.0%,18m
8968,3,RobinHood,3362,0,0,1,1,0.0%,37m
8978,3,Miallo,3361,1341,137,112,249,55.0%,27m
8978,3,Mike,3361,1144,44,46,90,48.9%,41m
8978,2,SonTuCnA,3361,584,19,30,49,38.8%,15m
8978,3,NotSure,3361,351,18,9,27,66.7%,9m
8978,3,ButAtWutCost,3361,205,7,4,11,63.6%,34m
8978,3,Pheonix,3361,170,6,3,9,66.7%,2m
8978,3,Iconoclast,3361,178,6,8,14,42.9%,28m
8978,1,[LSG]PastaFazool,3361,0,5,0,5,100.0%,56m
8978,3,His,3361,58,3,5,8,37.5%,27m
8987,2,SirMicksalot,3360,1355,196,195,391,50.1%,9m
8987,3,DukeOftError,3360,1392,77,66,143,53.8%,6m
8987,3,RatonMortal,3360,1540,75,69,144,52.1%,33m
8987,3,[TB0C]Death,3360,432,15,19,34,44.1%,9m
8987,3,skylong,3360,200,8,4,12,66.7%,19m
8987,3,TrueNorth,3360,232,8,11,19,42.1%,6m
8987,2,bigboss,3360,248,8,12,20,40.0%,40m
8987,3,IcexKyuubi,3360,153,7,3,10,70.0%,21m
8987,2,[Fir3s]Saviour,3360,126,6,12,18,33.3%,7m
8987,3,[AiMB]CeeDee,3360,90,3,3,6,50.0%,41m
8987,3,WhiteRabbit,3360,86,3,4,7,42.9%,19m
8987,3,[4HARM]LastEngineer,3360,0,1,0,1,100.0%,34m
8987,3,[xozT]goku,3360,0,1,2,3,33.3%,35m
8987,3,onakua,3360,0,1,4,5,20.0%,40m
8987,3,NicoResko,3360,0,0,1,1,0.0%,25m
8987,3,Nostrapi,3360,0,0,2,2,0.0%,4m
8987,3,Rupert,3360,0,0,5,5,0.0%,15m
9004,3,whitebelft,3359,951,42,29,71,59.2%,29m
9004,2,[DATTE]Papi,3359,736,29,31,60,48.3%,27m
9004,3,[TriBit]xeno,3359,380,16,14,30,53.3%,27m
9004,3,MrOliveTree,3359,266,13,11,24,54.2%,29m
9004,3,Malogen,3359,266,9,6,15,60.0%,3m
9004,3,Spring,3359,220,7,7,14,50.0%,35m
9004,3,Asento,3359,148,6,5,11,54.5%,40m
9004,3,Ttori,3359,114,5,4,9,55.6%,35m
9004,3,Abaddon,3359,114,4,2,6,66.7%,33m
9004,3,DukeRadical,3359,58,3,0,3,100.0%,19m
9004,3,[Moo0]Smuckers,3359,86,3,3,6,50.0%,37m
9004,3,Hasagi,3359,0,1,0,1,100.0%,25m
9004,3,[RBTH]CedriK,3359,30,1,7,8,12.5%,6m
9004,3,Warsta,3359,30,1,9,10,10.0%,25m
9004,3,[WotM8]Truedge,3359,0,0,1,1,0.0%,38m
9019,2,[RGAN]Brad,3358,1599,150,151,301,49.8%,34m
9019,3,[MLKMEN]saweder,3358,1583,139,131,270,51.5%,17m
9019,3,Nggtarc,3358,1080,48,37,85,56.5%,9m
9019,3,[SsaYnS]Asteroth,3358,246,10,4,14,71.4%,36m
9019,3,Deathstroke,3358,0,5,0,5,100.0%,35m
9019,3,[UpeV]PortentousTV,3358,142,5,2,7,71.4%,41m
9019,3,TheSavage,3358,58,3,0,3,100.0%,16m
9019,3,PuFF,3358,60,3,1,4,75.0%,9m
9019,3,[T4TG]evansb,3358,30,2,1,3,66.7%,29m
9019,3,Ares,3358,123,2,5,7,28.6%,32m
9019,3,cam,3358,0,1,1,2,50.0%,21m
9019,3,Chocobo,3358,0,0,1,1,0.0%,36m
9031,3,Triton,3357,1587,142,133,275,51.6%,2m
9031,3,[WONGS]Hopz,3357,670,85,68,153,55.6%,25m
9031,3,[NHSC]Adam,3357,1336,59,41,100,59.0%,16m
9031,2,[sOLsc]Zeiko,3357,556,28,31,59,47.5%,8m
9031,2,[Epic]Zeman,3357,744,28,34,62,45.2%,17m
9031,3,[FyHr]CharlyCox,3357,525,23,21,44,52.3%,18m
9031,3,Messi,3357,541,21,11,32,65.6%,16m
9031,3,ZvZzzzz,3357,560,21,20,41,51.2%,17m
9031,3,Assimilation,3357,122,6,1,7,85.7%,32m
9031,3,DollaBill,3357,88,3,6,9,33.3%,12m
9031,3,GLiTCH,3357,0,1,0,1,100.0%,17m
9031,3,[Neewbe]lingking,3357,0,0,1,1,0.0%,15m
9031,3,BoxxyBox,3357,0,0,1,1,0.0%,29m
9031,3,[LoSD]Ornel,3357,0,0,2,2,0.0%,6m
9045,3,Kmu,3356,1280,71,69,140,50.7%,2m
9045,3,[forces]DeathRaven,3356,749,67,43,110,60.9%,40m
9045,3,[Altf5]UNSCARRED,3356,786,35,23,58,60.3%,10m
9045,3,kage,3356,835,32,23,55,58.2%,39m
9045,3,Justicar,3356,304,17,12,29,58.6%,14m
9045,2,KyongHwan,3356,420,14,23,37,37.8%,41m
9045,3,BigBoss,3356,276,10,9,19,52.6%,36m
9045,3,Cloud,3356,167,6,2,8,75.0%,25m
9045,3,[VL31]OnlyFate,3356,114,5,3,8,62.5%,25m
9045,3,hesed,3356,86,3,4,7,42.9%,38m
9045,3,Enoth,3356,30,1,2,3,33.3%,34m
9045,3,[GnR]Kingbenjamin,3356,0,0,1,1,0.0%,25m
9045,3,Assronomical,3356,0,0,3,3,0.0%,27m
9058,2,kingNipple,3355,1527,341,344,685,49.8%,27m
9058,3,slallum,3355,1384,182,164,346,52.6%,39m
9058,3,SylvanNight,3355,1541,111,105,216,51.4%,10m
9058,3,Cainbazel,3355,1634,94,73,167,56.3%,21m
9058,3,[DKG]Avos,3355,611,46,27,73,63.0%,41m
9058,3,[neuroS]Sweet,3355,833,40,31,71,56.3%,5m
9058,3,[MCSC]Chasmic,3355,918,39,33,72,54.2%,33m
9058,3,[DETER]ChaosSquirre,3355,530,20,16,36,55.6%,37m
9058,3,JBaee,3355,406,16,23,39,41.0%,21m
9058,3,Niravroh,3355,293,11,5,16,68.8%,37m
9058,3,uMMRyammy,3355,214,11,9,20,55.0%,37m
9058,3,hardbasset,3355,169,7,3,10,70.0%,17m
9058,3,SirBlue,3355,86,7,3,10,70.0%,39m
9058,3,Vee,3355,30,5,1,6,83.3%,33m
9058,3,MongShell,3355,0,4,1,5,80.0%,4m
9058,3,[ACSS]soymilk,3355,114,4,4,8,50.0%,13m
9058,3,[LPZR]DangerDog,3355,30,2,0,2,100.0%,35m
9058,1,Zillo,3355,113,2,2,4,50.0%,25m
9058,3,[ELIDS]ManMallow,3355,58,2,6,8,25.0%,2m
9058,3,DubiouS,3355,0,1,0,1,100.0%,37m
9058,3,[TSS]Underoath,3355,30,1,1,2,50.0%,17m
9058,3,Duro,3355,30,1,4,5,20.0%,33m
9058,3,Yorlordship,3355,30,1,6,7,14.3%,27m
9058,3,amos,3355,0,0,1,1,0.0%,24m
9058,3,RalphMan,3355,0,0,1,1,0.0%,34m
9083,3,Arkham,3354,1349,185,178,363,51.0%,7m
9083,2,[XZEROX]VoidWolf,3354,728,44,45,89,49.4%,40m
9083,3,SinGiRu,3354,904,42,28,70,60.0%,25m
9083,3,Kevin,3354,818,33,35,68,48.5%,11m
9083,2,zljstar,3354,748,32,31,63,50.8%,3m
9083,3,Posey,3354,641,27,18,45,60.0%,35m
9083,3,Zilch,3354,605,25,13,38,65.8%,13m
9083,3,slyr,3354,636,25,23,48,52.1%,4m
9083,3,Cyanide,3354,515,24,13,37,64.9%,11m
9083,1,OoOoO,3354,253,11,5,16,68.8%,8m
9083,3,ZergBrabo,3354,230,8,11,19,42.1%,22m
9083,3,[EZVN]DucAnhdz,3354,88,4,1,5,80.0%,2m
9083,3,GañjaBonjwa,3354,90,4,4,8,50.0%,19m
9083,3,[αB]AUXdaFox,3354,0,0,1,1,0.0%,6m
9083,3,[12step]StudMuphin,3354,0,0,1,1,0.0%,7m
9083,3,[UpeV]viperKingHG,3354,0,0,1,1,0.0%,2m
9099,3,biozerg,3353,1243,134,103,237,56.5%,16m
9099,3,Chucrut,3353,1556,73,57,130,56.2%,39m
9099,3,Nilbog,3353,1559,65,73,138,47.1%,24m
9099,2,[SmokeH]Crisppyyy,3353,922,59,53,112,52.7%,15m
9099,3,NoMaD,3353,252,27,27,54,50.0%,24m
9099,3,strikehard,3353,550,24,18,42,57.1%,3m
9099,3,Fuy,3353,360,14,8,22,63.6%,35m
9099,2,[SLUDGE]voljin,3353,193,9,4,13,69.2%,40m
9099,3,upgrayedd,3353,86,4,1,5,80.0%,35m
9099,3,Mastercakes,3353,30,4,3,7,57.1%,41m
9099,3,MaengDa,3353,88,3,3,6,50.0%,24m
9099,3,doud,3353,0,2,3,5,40.0%,30m
9099,3,[APR]SpaceBeaver,3353,30,2,6,8,25.0%,2m
9099,3,[910]MechinHappen,3353,0,1,0,1,100.0%,30m
9099,3,IceFire,3353,0,1,0,1,100.0%,2m
9099,3,thebigrobo,3353,0,1,1,2,50.0%,18m
9099,3,[NovaX]MajiNCue,3353,30,1,6,7,14.3%,34m
9099,3,[LTlord]JITSAW,3353,0,0,2,2,0.0%,25m
9117,3,FilthyCasual,3352,1081,189,148,337,56.1%,8m
9117,3,Kkerseki,3352,1368,180,140,320,56.2%,30m
9117,3,UIIIIUIII,3352,1401,105,97,202,52.0%,23m
9117,3,[aCLK]Apocalypse,3352,1567,83,70,153,54.2%,6m
9117,2,[ScSwrm]FutureNights,3352,1427,75,85,160,46.9%,34m
9117,3,Ballsagna,3352,732,30,25,55,54.5%,7m
9117,3,PMA,3352,618,28,14,42,66.7%,30m
9117,3,Crux,3352,173,10,11,21,47.6%,31m
9117,3,[ssexxy]Corvus,3352,216,8,4,12,66.7%,25m
9117,3,Mordoc,3352,58,6,3,9,66.7%,36m
9117,3,[XpKb]GansitoUwU,3352,120,6,6,12,50.0%,31m
9117,3,Appletini,3352,166,4,2,6,66.7%,35m
9117,3,Obnehz,3352,58,3,3,6,50.0%,20m
9117,3,SirWebbles,3352,86,3,5,8,37.5%,40m
9117,3,BetaStar,3352,60,2,6,8,25.0%,25m
9117,3,[TCProG]MillerLee,3352,0,1,0,1,100.0%,24m
9117,3,[LCE]LastWave,3352,0,1,0,1,100.0%,4m
9117,3,Zheryu,3352,0,1,0,1,100.0%,33m
9117,3,[Mntaya]JimReaper,3352,0,1,1,2,50.0%,40m
9117,3,tbone,3352,0,0,1,1,0.0%,24m
9117,3,BestNameEver,3352,0,0,2,2,0.0%,41m
9117,3,TwoHeadedBoy,3352,0,0,4,4,0.0%,38m
9117,3,[CHZSCT]MorphingTime,3352,0,0,4,4,0.0%,17m
9140,3,[SCHK]IIIIIIIIIII,3351,429,123,114,237,51.9%,14m
9140,2,[GvSQD]GoveaKun,3351,1109,42,46,88,47.7%,4m
9140,3,avoca,3351,850,32,28,60,53.3%,28m
9140,3,UberSchlong,3351,720,31,30,61,50.8%,10m
9140,3,gunship,3351,259,9,4,13,69.2%,27m
9140,3,MGR,3351,116,5,1,6,83.3%,14m
9140,3,Jason,3351,114,4,5,9,44.4%,38m
9140,3,LudwigVMises,3351,60,2,3,5,40.0%,10m
9140,3,STATS,3351,60,2,3,5,40.0%,11m
9140,3,Edge,3351,0,1,1,2,50.0%,28m
9140,3,[cBLOC]DimLight,3351,0,0,2,2,0.0%,24m
9151,3,hordru,3350,1578,472,431,903,52.3%,24m
9151,2,RedWolf,3350,1491,170,163,333,51.1%,31m
9151,3,Leo,3350,998,170,169,339,50.1%,2m
9151,3,Hulk,3350,1245,79,79,158,50.0%,32m
9151,2,Phosphoid,3350,1247,57,56,113,50.4%,30m
9151,2,ShiraUso,3350,438,14,27,41,34.1%,29m
9151,2,FaPLiNG,3350,366,12,25,37,32.4%,34m
9151,3,[XpKb]Chiltonb,3350,310,10,18,28,35.7%,29m
9151,3,andysheri,3350,202,8,7,15,53.3%,7m
9151,3,[IH8TOS]onfireAlvaro,3350,142,6,1,7,85.7%,38m
9151,3,BARCODE,3350,78,5,3,8,62.5%,30m
9151,1,EZZ,3350,0,1,2,3,33.3%,2h
9151,2,[YD2K]Brayjunaz,3350,0,1,3,4,25.0%,36m
9151,3,HUNNYBEAR,3350,0,0,1,1,0.0%,39m
9151,3,PinoyGamer,3350,0,0,2,2,0.0%,22m
9151,3,[X17]JayD,3350,0,0,2,2,0.0%,9m
9167,2,[S4RK]Rafo,3349,1528,82,86,168,48.8%,12m
9167,2,[UpeV]MaNuHidrA,3349,1424,57,66,123,46.3%,15m
9167,3,Deckery,3349,461,55,54,109,50.5%,15m
9167,3,zim,3349,934,46,33,79,58.2%,4m
9167,3,Vlone,3349,344,40,41,81,49.4%,25m
9167,3,[SoulZo]Raiden,3349,296,12,11,23,52.2%,33m
9167,3,Stratisfied,3349,314,11,6,17,64.7%,35m
9167,3,liturtle,3349,140,6,2,8,75.0%,41m
9167,3,[Pton]MrSquirrley,3349,0,3,2,5,60.0%,14m
9167,3,[Kompas]Antanas,3349,30,2,3,5,40.0%,17m
9167,3,[PlyLoL]Fishy,3349,60,2,4,6,33.3%,2m
9167,3,Implacable,3349,0,1,0,1,100.0%,30m
9167,3,quanto,3349,0,0,1,1,0.0%,4m
9167,3,Meridius,3349,0,0,2,2,0.0%,33m
9181,3,Luke,3348,1572,301,252,553,54.4%,14m
9181,3,Spiral,3348,1462,275,277,552,49.8%,35m
9181,3,JiNyoGi,3348,997,71,61,132,53.8%,39m
9181,2,[M2A5]Jugdish,3348,1280,61,73,134,45.5%,20m
9181,3,Ketchupking,3348,363,49,44,93,52.7%,21m
9181,3,captinneeda,3348,442,26,15,41,63.4%,29m
9181,3,[TLAN]SuperZorg,3348,696,26,30,56,46.4%,41m
9181,3,[PasT1]SleepyWolfie,3348,300,12,10,22,54.5%,19m
9181,3,PartyNation,3348,284,11,3,14,78.6%,21m
9181,3,[DHZAcD]Diamonaizer,3348,191,8,5,13,61.5%,35m
9181,2,WiZecraX,3348,176,7,16,23,30.4%,41m
9181,3,ReFuGee,3348,88,4,7,11,36.4%,24m
9181,3,Swarmellohh,3348,94,4,11,15,26.7%,21m
9181,3,[qt]Mugen,3348,58,3,3,6,50.0%,4m
9181,3,[SOAF]preecher,3348,60,2,10,12,16.7%,35m
9181,3,[AoNo]Arkanthiel,3348,0,0,9,9,0.0%,39m
9197,3,Puggims,3347,514,92,77,169,54.4%,36m
9197,3,hunterRu,3347,797,62,64,126,49.2%,2m
9197,3,Apple,3347,400,47,27,74,63.5%,30m
9197,3,Cream,3347,914,35,29,64,54.7%,19m
9197,3,Larvita,3347,860,31,34,65,47.7%,18m
9197,3,Sausage,3347,690,28,25,53,52.8%,29m
9197,2,Gravezy,3347,866,28,44,72,38.9%,8m
9197,3,ChaosTheory,3347,507,21,14,35,60.0%,10m
9197,3,[Titwan]Camidian,3347,199,9,8,17,52.9%,15m
9197,3,RandyRinger,3347,216,7,13,20,35.0%,8m
9197,3,Spenouh,3347,186,6,3,9,66.7%,33m
9197,3,Mint,3347,114,5,2,7,71.4%,27m
9197,3,Reign,3347,114,5,2,7,71.4%,14m
9197,3,MyDudes,3347,97,4,3,7,57.1%,4m
9197,3,TRANquiliTY,3347,58,3,2,5,60.0%,39m
9197,3,llllllllllll,3347,139,3,4,7,42.9%,13m
9197,3,Aela,3347,30,2,0,2,100.0%,11m
9197,3,RandyMarsh,3347,30,2,2,4,50.0%,14m
9197,3,VeinStain,3347,30,2,3,5,40.0%,3m
9197,3,noslop,3347,0,2,3,5,40.0%,34m
9197,3,PapeKan,3347,0,1,1,2,50.0%,27m
9197,3,xWeedWizardx,3347,30,1,7,8,12.5%,38m
9219,2,Talbinator,3346,1111,58,60,118,49.2%,29m
9219,3,Ritchan,3346,982,51,31,82,62.2%,2m
9219,3,[MEP]Mephisto,3346,782,28,32,60,46.7%,38m
9219,3,samaitch,3346,547,19,21,40,47.5%,24m
9219,3,DonaldTrump,3346,426,18,16,34,52.9%,30m
9219,3,Skittles,3346,312,12,6,18,66.7%,23m
9219,3,[AUNI]foREVer,3346,196,9,7,16,56.2%,33m
9219,3,Sublux,3346,216,8,12,20,40.0%,2m
9219,1,DarkDragon,3346,140,7,1,8,87.5%,5m
9219,3,BreakingWind,3346,144,3,6,9,33.3%,32m
9219,3,TinJuice,3346,30,2,3,5,40.0%,8m
9219,3,Harry,3346,0,1,0,1,100.0%,15m
9219,3,MisterPotato,3346,0,1,0,1,100.0%,7m
9219,3,[GOPERÚ]Edward,3346,30,1,4,5,20.0%,3m
9219,3,toro,3346,0,0,1,1,0.0%,25m
9234,2,Epicnew,3345,1440,297,292,589,50.4%,13m
9234,2,[BRSKR]Nuke,3345,1377,269,274,543,49.5%,12m
9234,3,[Astute]BroodKingEXE,3345,1487,134,130,264,50.8%,37m
9234,3,[tCo9]Hilikus,3345,1586,126,117,243,51.9%,15m
9234,3,[SSEAS]silverking,3345,1501,72,74,146,49.3%,3m
9234,2,[NwAs]MiauMiaauuuu,3345,1418,59,82,141,41.8%,26m
9234,3,Heisenzerg,3345,1096,48,47,95,50.5%,24m
9234,3,[NLTTJ]sohot,3345,713,46,40,86,53.5%,36m
9234,3,[iMINi]Heart,3345,888,38,33,71,53.5%,29m
9234,3,pants,3345,900,35,35,70,50.0%,32m
9234,3,[COC]Gigandura,3345,394,29,26,55,52.7%,11m
9234,3,ArgonKing,3345,276,19,16,35,54.3%,2m
9234,3,[DokiSC]cmoon,3345,356,14,11,25,56.0%,18m
9234,3,Wegman,3345,198,8,4,12,66.7%,14m
9234,3,Crazymage,3345,60,6,2,8,75.0%,38m
9234,3,Lukaszosss,3345,137,6,3,9,66.7%,29m
9234,1,[Lychee]KaoticKiwi,3345,97,5,1,6,83.3%,15m
9234,3,Feideds,3345,30,5,1,6,83.3%,19m
9234,3,[BALTY]PapaCheetoh,3345,144,5,3,8,62.5%,35m
9234,1,Lucki,3345,0,4,1,5,80.0%,2h
9234,3,[YAS]Knowledge,3345,88,3,4,7,42.9%,32m
9234,3,[ZWars]DarkPrinceX,3345,60,2,5,7,28.6%,29m
9234,3,elflageador,3345,30,1,2,3,33.3%,28m
9234,3,[RoBr]Phantomspy,3345,0,0,1,1,0.0%,35m
9234,3,ZMan,3345,0,0,1,1,0.0%,38m
9234,3,Nevarion,3345,0,0,1,1,0.0%,30m
9234,3,[LMZ]MiniKor,3345,0,0,1,1,0.0%,32m
9234,2,[lIIIlI]Makaveli,3345,0,0,1,1,0.0%,41m
9234,3,[EGRIL]CoronaTime,3345,0,0,4,4,0.0%,41m
9263,3,[ZpaceX]MaxGio,3344,1452,64,62,126,50.8%,10m
9263,3,[YS850H]Sin,3344,374,46,36,82,56.1%,14m
9263,3,ggg,3344,550,24,21,45,53.3%,37m
9263,3,Nazgul,3344,520,18,22,40,45.0%,13m
9263,3,SoulAndre,3344,288,16,8,24,66.7%,7m
9263,3,clio,3344,216,10,3,13,76.9%,13m
9263,3,[xENTx]InfinitePest,3344,30,2,0,2,100.0%,33m
9263,3,[cl0udM]kenshin,3344,0,1,0,1,100.0%,25m
9263,3,python,3344,0,0,1,1,0.0%,27m
9263,3,DestroYer,3344,0,0,1,1,0.0%,41m
9263,3,[BiTeee]NANAMISENU,3344,0,0,1,1,0.0%,4m
9263,3,illfingas,3344,0,0,2,2,0.0%,21m
9263,3,Lexer,3344,0,0,3,3,0.0%,14m
9276,3,ezfranca,3343,1394,260,260,520,50.0%,39m
9276,3,IIlIIIlIlII,3343,1581,146,135,281,52.0%,40m
9276,3,Chris,3343,965,130,129,259,50.2%,27m
9276,2,Dodox,3343,1416,101,105,206,49.0%,3m
9276,3,[0u0]PiroPito,3343,1270,81,60,141,57.4%,26m
9276,3,Necro,3343,1555,63,61,124,50.8%,41m
9276,3,irreGA,3343,1009,46,25,71,64.8%,20m
9276,3,[EscJP]ELIN,3343,965,42,37,79,53.2%,25m
9276,2,PREAHLANY,3343,900,39,49,88,44.3%,2m
9276,3,[VFam2]DeadBabySeal,3343,274,19,16,35,54.3%,40m
9276,3,Smiles,3343,468,16,20,36,44.4%,25m
9276,3,[Maaate]IkeaRat,3343,304,11,8,19,57.9%,7m
9276,2,jiN,3343,318,11,23,34,32.4%,42m
9276,3,peraples,3343,318,10,11,21,47.6%,41m
9276,2,IIIIIIIIIII,3343,302,10,21,31,32.3%,25m
9276,3,[ValidG]oldparr,3343,196,8,6,14,57.1%,38m
9276,3,leavethegame,3343,114,4,6,10,40.0%,27m
9276,3,Otto,3343,30,1,1,2,50.0%,24m
9276,3,Spirithound,3343,30,1,1,2,50.0%,7m
9276,3,Lycosa,3343,30,1,10,11,9.1%,35m
9296,3,Luuuu,3342,1338,52,51,103,50.5%,3m
9296,3,PyDev,3342,207,9,4,13,69.2%,18m
9296,3,Fubar,3342,238,9,10,19,47.4%,32m
9296,3,[DRKRPT]WAFFLES,3342,158,7,10,17,41.2%,14m
9296,2,[TGosuC]xKyouma,3342,120,7,12,19,36.8%,27m
9296,3,repayment,3342,60,5,4,9,55.6%,36m
9296,3,Luchito,3342,142,3,1,4,75.0%,32m
9296,3,grim,3342,0,1,0,1,100.0%,2m
9296,3,Goliath,3342,30,1,2,3,33.3%,34m
9296,1,SSJBVEGETA,3342,0,1,2,3,33.3%,29m
9296,3,[GEEKED]KillaClown,3342,30,1,3,4,25.0%,37m
9296,3,Diglett,3342,0,1,4,5,20.0%,5m
9296,3,[EffM]Fopdoodle,3342,0,0,1,1,0.0%,26m
9296,3,RiiSK,3342,0,0,1,1,0.0%,38m
9296,3,[GLov]BLorD,3342,0,0,1,1,0.0%,9m
9311,3,rain,3341,710,292,288,580,50.3%,39m
9311,3,Andreas,3341,1573,211,187,398,53.0%,9m
9311,2,[CosEng]Bullseye,3341,1363,66,78,144,45.8%,20m
9311,3,[3nTar0]Zeratul,3341,1409,57,46,103,55.3%,24m
9311,2,Pwnasaurus,3341,1134,57,58,115,49.6%,12m
9311,3,MeatPienSce,3341,457,18,10,28,64.3%,39m
9311,3,[AIlin]Leon,3341,266,11,3,14,78.6%,25m
9311,3,kaOzReaveR,3341,238,10,8,18,55.6%,30m
9311,3,WellDone,3341,144,3,4,7,42.9%,9m
9311,3,JohnnySinz,3341,92,3,7,10,30.0%,9m
9311,3,[Pig2]Wizard,3341,30,2,2,4,50.0%,25m
9311,3,[m3x]Yuridio,3341,0,0,1,1,0.0%,25m
9311,3,CowLevelNoGG,3341,0,0,1,1,0.0%,33m
9311,3,ShroudWalker,3341,0,0,2,2,0.0%,41m
9311,3,[NoBads]pimba,3341,0,0,2,2,0.0%,34m
9326,3,[HoGVN]Cuzre,3340,1554,67,61,128,52.3%,33m
9326,3,qqq,3340,1297,58,59,117,49.6%,30m
9326,3,GalaxyBrain,3340,420,50,46,96,52.1%,35m
9326,3,FishermanBro,3340,954,42,29,71,59.2%,14m
9326,3,Exsedol,3340,954,35,37,72,48.6%,12m
9326,3,[homero]Nefarian,3340,602,28,22,50,56.0%,25m
9326,2,llllllllllll,3340,354,19,32,51,37.3%,34m
9326,3,Foxy,3340,403,17,11,28,60.7%,26m
9326,3,etxeberrik,3340,252,13,8,21,61.9%,35m
9326,2,ljuspercy,3340,207,9,4,13,69.2%,20m
9326,3,AcousticSouL,3340,104,6,6,12,50.0%,36m
9326,3,shameless,3340,76,3,7,10,30.0%,33m
9326,3,[GIBE]Enigma,3340,30,2,0,2,100.0%,36m
9326,3,Ego,3340,30,2,4,6,33.3%,9m
9326,1,Manatee,3340,96,1,4,5,20.0%,17m
9326,3,BrotherNex,3340,0,0,1,1,0.0%,4m
9326,3,bmanley,3340,0,0,1,1,0.0%,13m
9326,3,Smithsonian,3340,0,0,2,2,0.0%,41m
9326,3,[PEEEN]sewermermaid,3340,0,0,3,3,0.0%,29m
9326,3,[MndGwn]Atom,3340,0,0,3,3,0.0%,41m
9326,3,lachancla,3340,0,0,4,4,0.0%,7m
9347,2,IMCreep,3339,1590,243,244,487,49.9%,32m
9347,3,JuanBobo,3339,1453,158,94,252,62.7%,37m
9347,3,[b1azin]TEUFELHUNDEN,3339,1471,153,135,288,53.1%,3m
9347,3,Ozymandias,3339,1262,82,77,159,51.6%,7m
9347,2,TrueNorth,3339,1146,52,52,104,50.0%,12m
9347,3,TheDudeMan,3339,687,42,45,87,48.3%,15m
9347,3,[JRB]Henri,3339,938,36,35,71,50.7%,36m
9347,2,Victor,3339,462,34,40,74,45.9%,20m
9347,3,LeftStroke,3339,768,31,27,58,53.4%,37m
9347,3,[DarkAG]Zergasm,3339,534,21,20,41,51.2%,15m
9347,3,WildZetti,3339,331,14,9,23,60.9%,38m
9347,3,[WFV]freya,3339,348,12,10,22,54.5%,17m
9347,3,IIIIIIIII,3339,139,6,2,8,75.0%,29m
9347,3,[fneSin]MrAwesome,3339,168,6,10,16,37.5%,14m
9347,3,[Bee]AgentX,3339,58,3,1,4,75.0%,28m
9347,3,[TKL]SayNoToStim,3339,0,0,1,1,0.0%,36m
9363,3,TOTeM,3338,1599,217,202,419,51.8%,26m
9363,3,[GRNSKN]Lurker,3338,1561,142,111,253,56.1%,5m
9363,3,Kalefich,3338,1203,114,111,225,50.7%,11m
9363,3,[GGTOEZ]Microjackson,3338,1173,65,52,117,55.6%,13m
9363,3,StreamZZang,3338,935,60,32,92,65.2%,21m
9363,2,Tastosis,3338,1000,57,69,126,45.2%,18m
9363,3,NotVaush,3338,546,23,15,38,60.5%,28m
9363,1,[EZFEED]nDragan,3338,307,13,8,21,61.9%,25m
9363,3,Contoss,3338,168,7,3,10,70.0%,3m
9363,3,bigwaN,3338,58,5,3,8,62.5%,14m
9363,3,Player,3338,0,2,3,5,40.0%,20m
9363,3,cAsh,3338,0,0,1,1,0.0%,34m
9363,3,TheBeej,3338,0,0,2,2,0.0%,25m
9376,2,[DarkAG]GundamGabe,3337,1512,480,484,964,49.8%,10m
9376,3,Memelord,3337,1595,305,299,604,50.5%,9m
9376,3,LoneVibes,3337,1505,165,153,318,51.9%,4m
9376,3,SandKing,3337,1377,131,86,217,60.4%,39m
9376,3,Aiur,3337,1182,74,65,139,53.2%,41m
9376,3,SkynetII,3337,1631,74,69,143,51.7%,40m
9376,2,[VFam2]theDataSmith,3337,317,36,38,74,48.6%,10m
9376,3,[IMDSI]Bleasse,3337,434,34,30,64,53.1%,18m
9376,2,DavidB,3337,756,31,32,63,49.2%,40m
9376,3,ARealBoi,3337,730,27,26,53,50.9%,7m
9376,2,[PES]Silver,3337,766,25,43,68,36.8%,17m
9376,3,Jerry,3337,280,15,7,22,68.2%,36m
9376,3,aburntham,3337,286,10,12,22,45.5%,21m
9376,2,kurrtose,3337,0,1,0,1,100.0%,36m
9376,3,xiaochun,3337,0,0,1,1,0.0%,2m
9376,1,[Ash3s]ZERGNESS,3337,0,0,2,2,0.0%,2h
9376,3,Sardaukar,3337,0,0,7,7,0.0%,3m
9393,3,TJTramp,3336,1070,63,47,110,57.3%,16m
9393,3,ElLobo,3336,556,41,29,70,58.6%,28m
9393,3,Ninoslav,3336,266,31,27,58,53.4%,23m
9393,3,[LDPro]Numberthree,3336,483,22,16,38,57.9%,22m
9393,2,GarbageCan,3336,430,14,26,40,35.0%,27m
9393,1,[PCAKE]NOFLAMYBLADE,3336,0,2,0,2,100.0%,41m
9393,3,Rorschach,3336,58,2,3,5,40.0%,4m
9393,3,Pragmatist,3336,30,2,4,6,33.3%,10m
9393,3,Phsyco,3336,0,0,1,1,0.0%,26m
9393,3,Betrayed,3336,0,0,2,2,0.0%,28m
9403,3,ENGLISH,3335,1622,257,230,487,52.8%,33m
9403,3,BrownRanger,3335,757,153,141,294,52.0%,4m
9403,3,Kitfox,3335,1350,54,49,103,52.4%,32m
9403,3,Kritz,3335,868,42,30,72,58.3%,4m
9403,3,EasyKaTkA,3335,528,23,15,38,60.5%,41m
9403,3,ThereWasFire,3335,518,20,11,31,64.5%,19m
9403,3,[EZDUNK]AlexKidd,3335,265,16,18,34,47.1%,21m
9403,3,Sonny,3335,254,12,13,25,48.0%,41m
9403,3,jojo,3335,282,10,15,25,40.0%,39m
9403,3,Infinity,3335,170,6,5,11,54.5%,17m
9403,3,Dreemurr,3335,120,5,4,9,55.6%,30m
9403,3,[BoAVN]tumulu,3335,142,5,7,12,41.7%,36m
9403,1,Sanek,3335,131,3,1,4,75.0%,38m
9403,3,[BRUVV]mechanichore,3335,30,2,0,2,100.0%,14m
9403,3,[iS1MP]WinterKnight,3335,0,2,5,7,28.6%,20m
9403,3,Castillo,3335,0,1,1,2,50.0%,39m
9403,3,Calus,3335,0,1,3,4,25.0%,30m
9403,1,[TaRus]PakCha,3335,0,1,4,5,20.0%,2h
9403,2,[RealMK]PackLips,3335,0,0,11,11,0.0%,27m
9422,3,[FDK]GTNinety,3334,967,78,67,145,53.8%,20m
9422,3,TbaG,3334,443,19,15,34,55.9%,30m
9422,3,[LGNxx]goffy,3334,550,19,23,42,45.2%,39m
9422,3,[TNoS]DaBaum,3334,364,12,23,35,34.3%,39m
9422,3,Djugelkugen,3334,239,10,5,15,66.7%,28m
9422,3,Concepts,3334,218,9,2,11,81.8%,2m
9422,3,[D4DDY5]Asskicker,3334,185,9,4,13,69.2%,22m
9422,2,Fear,3334,171,6,8,14,42.9%,23m
9422,3,TKB,3334,30,5,1,6,83.3%,33m
9422,3,CakePie,3334,30,5,1,6,83.3%,22m
9422,3,IlIlIlIlIIll,3334,30,4,5,9,44.4%,25m
9422,3,Kluft,3334,6,3,5,8,37.5%,13m
9422,3,Dodgson,3334,30,3,5,8,37.5%,37m
9422,3,KoomBoom,3334,30,2,0,2,100.0%,34m
9422,3,ddduuuddduuu,3334,0,1,0,1,100.0%,20m
9422,1,Dbelzberg,3334,0,1,0,1,100.0%,2h
9422,3,Protossium,3334,0,1,1,2,50.0%,28m
9422,3,Acquati,3334,0,0,1,1,0.0%,29m
9422,3,[xRtG]KìììÂ,3334,0,0,2,2,0.0%,30m
9441,3,Bisu,3333,1559,154,154,308,50.0%,24m
9441,3,Lichking,3333,907,147,130,277,53.1%,11m
9441,3,[PoSu]Sariel,3333,867,127,110,237,53.6%,14m
9441,3,rdyspaghetti,3333,1550,55,63,118,46.6%,36m
9441,3,[GRNSKN]EMcG,3333,1120,50,34,84,59.5%,36m
9441,3,YamatoLemma,3333,573,34,33,67,50.7%,37m
9441,3,Rufio,3333,588,27,20,47,57.4%,11m
9441,3,StarLiner,3333,250,16,10,26,61.5%,18m
9441,3,[UN]Zantim,3333,362,13,16,29,44.8%,37m
9441,3,Eli,3333,343,11,8,19,57.9%,3m
9441,3,[KQN]ShetLand,3333,90,7,4,11,63.6%,39m
9441,3,sPARK,3333,86,4,0,4,100.0%,32m
9441,3,Computer,3333,58,3,0,3,100.0%,20m
9441,2,babyduckfart,3333,133,2,3,5,40.0%,13m
9441,3,Nemesis,3333,0,1,0,1,100.0%,8m
9441,3,[umoron]llllllllllll,3333,30,1,1,2,50.0%,27m
9441,3,yak,3333,30,1,5,6,16.7%,10m
9441,3,[VFam]ImaLegand,3333,0,0,1,1,0.0%,22m
9441,3,superhiero,3333,0,0,1,1,0.0%,11m
9460,2,[SsaYnS]itchyallover,3332,1542,513,500,1013,50.6%,13m
9460,2,Canis,3332,495,150,149,299,50.2%,20m
9460,2,[GBH]MonsieurZor,3332,892,134,139,273,49.1%,5m
9460,3,[868]CHICO,3332,922,41,30,71,57.7%,33m
9460,3,Zalanax,3332,698,26,33,59,44.1%,16m
9460,3,[FFAA]INFRAROJOWL,3332,540,21,20,41,51.2%,23m
9460,3,[CadeGs]Nepee,3332,291,10,10,20,50.0%,26m
9460,3,[DmEs]IIIIIIIIIIII,3332,182,8,12,20,40.0%,23m
9460,2,TheLastAMove,3332,133,7,4,11,63.6%,6m
9460,3,MechnCheese,3332,30,3,4,7,42.9%,18m
9460,3,DraKaiser,3332,98,3,10,13,23.1%,19m
9460,3,[ASFL]VBergaaa,3332,0,1,0,1,100.0%,36m
9460,2,Stroier,3332,0,1,0,1,100.0%,12m
9460,2,[WIFE]terrainbow,3332,0,0,2,2,0.0%,12m
9474,3,[ValidG]Kenshin,3331,684,24,33,57,42.1%,15m
9474,3,JackyChoon,3331,372,17,9,26,65.4%,32m
9474,3,Cheesey,3331,316,12,1,13,92.3%,6m
9474,2,Erovit,3331,182,9,4,13,69.2%,29m
9474,3,Ragnar,3331,196,7,6,13,53.8%,26m
9474,1,Nicellllllll,3331,97,5,3,8,62.5%,15m
9474,2,[Lp]JAK,3331,162,5,12,17,29.4%,13m
9474,3,KainGonuyo,3331,0,4,1,5,80.0%,9m
9474,3,CyDxS,3331,122,4,5,9,44.4%,36m
9474,3,Atopos,3331,0,3,2,5,60.0%,18m
9474,3,Dusfim,3331,60,2,8,10,20.0%,6m
9474,3,EduardoVP,3331,0,0,1,1,0.0%,32m
9486,2,BigDizlBizl,3330,1472,242,238,480,50.4%,40m
9486,3,BrmdSloop,3330,1385,148,116,264,56.1%,38m
9486,3,UWBomberman,3330,732,116,97,213,54.5%,20m
9486,3,Tricky,3330,387,85,81,166,51.2%,9m
9486,3,[AthSun]Crusader,3330,1470,84,82,166,50.6%,17m
9486,3,Babou,3330,1120,72,77,149,48.3%,26m
9486,3,[FofS]Rain,3330,854,46,35,81,56.8%,30m
9486,3,[DaeNA]will,3330,919,39,30,69,56.5%,27m
9486,3,[DTokes]Chickenhawk,3330,808,29,32,61,47.5%,10m
9486,3,PowerLock,3330,650,27,21,48,56.2%,34m
9486,3,SickFlick,3330,375,16,9,25,64.0%,39m
9486,3,Faeta,3330,432,16,20,36,44.4%,4m
9486,3,llllllllllll,3330,400,15,15,30,50.0%,3m
9486,3,PresterJohn,3330,244,10,6,16,62.5%,17m
9486,3,Hemloch,3330,217,10,15,25,40.0%,21m
9486,3,Petrucci,3330,0,4,1,5,80.0%,9m
9486,3,MariOx,3330,30,2,6,8,25.0%,35m
9486,3,Fringe,3330,0,0,1,1,0.0%,12m
9504,3,Julint,3329,1439,300,266,566,53.0%,14m
9504,3,LuisH,3329,1610,121,115,236,51.3%,3m
9504,3,TypeMoon,3329,1409,110,104,214,51.4%,36m
9504,3,[USGUI]ReaDY,3329,1295,74,49,123,60.2%,28m
9504,3,goopbi,3329,842,44,46,90,48.9%,2m
9504,1,Nautilus,3329,153,12,9,21,57.1%,20m
9504,3,[EpicG]ElPatrick,3329,224,9,6,15,60.0%,38m
9504,3,BetaStar,3329,30,1,3,4,25.0%,4m
9504,3,[xTQc]MatS,3329,0,0,1,1,0.0%,32m
9504,3,Darkhound,3329,0,0,1,1,0.0%,7m
9504,3,[EpicG]LavienRose,3329,0,0,1,1,0.0%,13m
9504,3,darkbogge,3329,0,0,3,3,0.0%,36m
9516,3,Mortisant,3328,1562,232,214,446,52.0%,15m
9516,3,ENDER,3328,1183,229,215,444,51.6%,28m
9516,3,dee,3328,1541,66,51,117,56.4%,39m
9516,3,[xSYNx]Impaler,3328,1058,39,46,85,45.9%,28m
9516,3,[NextDC]Sadko,3328,293,11,10,21,52.4%,37m
9516,3,Victory,3328,88,8,5,13,61.5%,29m
9516,3,fourSD,3328,196,8,6,14,57.1%,14m
9516,3,[escape]idleworker,3328,144,5,5,10,50.0%,17m
9516,3,[Leer]Sovietic,3328,140,5,5,10,50.0%,38m
9516,2,MapleMan,3328,169,4,1,5,80.0%,12m
9516,2,TossboySYF,3328,0,4,1,5,80.0%,40m
9516,3,Barca,3328,114,4,2,6,66.7%,30m
9516,2,Brobz,3328,114,4,16,20,20.0%,20m
9516,2,[NoR20M]Zombee,3328,60,2,14,16,12.5%,17m
9516,3,SilentNight,3328,0,1,0,1,100.0%,34m
9531,2,Space,3327,1546,168,156,324,51.9%,21m
9531,3,ThePatriot,3327,794,55,51,106,51.9%,3m
9531,3,ZeNEXJaned,3327,460,42,38,80,52.5%,19m
9531,3,statsfan,3327,705,30,23,53,56.6%,3m
9531,3,[SISR]Phasing,3327,476,20,11,31,64.5%,41m
9531,3,Rejuxst,3327,358,15,10,25,60.0%,30m
9531,3,sallgood,3327,185,13,6,19,68.4%,25m
9531,3,[iMkS]Dnzo,3327,266,9,9,18,50.0%,18m
9531,3,ziache,3327,260,9,9,18,50.0%,28m
9531,3,AlphaSepehr,3327,238,8,14,22,36.4%,37m
9531,3,Dgtl,3327,178,6,12,18,33.3%,38m
9531,3,PlayerThree,3327,75,4,6,10,40.0%,40m
9531,3,[FalPal]Somicron,3327,86,3,3,6,50.0%,3m
9531,3,kkkkken,3327,58,2,4,6,33.3%,6m
9531,3,nobutoito,3327,30,2,5,7,28.6%,24m
9531,3,OldSpace,3327,0,1,0,1,100.0%,16m
9531,3,Aspros,3327,0,1,2,3,33.3%,32m
9531,3,OlderWang,3327,0,1,4,5,20.0%,14m
9531,3,llllllllllll,3327,0,0,3,3,0.0%,24m
9550,2,[MuKy]YGodMiX,3326,1277,209,212,421,49.6%,17m
9550,3,[GOPERÚ]lllllllllll,3326,1559,118,102,220,53.6%,36m
9550,2,Cayeuf,3326,1107,90,90,180,50.0%,18m
9550,3,[TARUGZ]ryze,3326,304,54,23,77,70.1%,26m
9550,3,Pirro,3326,998,42,34,76,55.3%,25m
9550,3,[NPhasA]Paragon,3326,390,25,17,42,59.5%,2m
9550,3,[Bawwlz]BORED,3326,524,24,9,33,72.7%,39m
9550,3,[CrazyC]MXGRE,3326,624,24,20,44,54.5%,18m
9550,3,[TeamUR]Delta,3326,392,14,18,32,43.8%,24m
9550,3,Necron,3326,336,13,11,24,54.2%,30m
9550,3,Bob,3326,0,4,0,4,100.0%,36m
9550,3,[RVNSBL]BigRob,3326,164,4,4,8,50.0%,22m
9550,3,MarblObelisk,3326,30,2,7,9,22.2%,7m
9550,3,[SCTF]kaBz,3326,0,1,0,1,100.0%,17m
9550,3,Zur,3326,0,1,0,1,100.0%,29m
9550,3,[itdog]Javascript,3326,0,1,0,1,100.0%,12m
9550,3,YuyO,3326,0,1,0,1,100.0%,36m
9550,3,NiceZerg,3326,30,1,3,4,25.0%,30m
9550,3,Dinky,3326,0,0,1,1,0.0%,10m
9550,3,[DuBo]XiaoXiao,3326,0,0,1,1,0.0%,32m
9550,2,[NuMuN]AlNaw,3326,0,0,5,5,0.0%,2h
9571,3,Cotab,3325,978,44,26,70,62.9%,20m
9571,3,PhantomHawk,3325,771,34,27,61,55.7%,39m
9571,3,Rachael,3325,224,17,12,29,58.6%,35m
9571,3,[Enig]hubbifier,3325,416,17,13,30,56.7%,41m
9571,3,Hermione,3325,144,5,8,13,38.5%,30m
9571,3,teemojun,3325,53,3,7,10,30.0%,11m
9571,3,Agueroo,3325,30,2,0,2,100.0%,9m
9571,3,[NPhase]Kmerengetsum,3325,30,2,6,8,25.0%,39m
9571,3,[EZDUNK]GrannyWatta,3325,0,0,2,2,0.0%,16m
9580,3,Valkar,3324,1194,165,151,316,52.2%,13m
9580,3,HelpISuck,3324,1529,128,129,257,49.8%,18m
9580,3,BleuElephant,3324,1547,109,106,215,50.7%,7m
9580,3,LOLkid,3324,892,98,92,190,51.6%,14m
9580,3,suryc,3324,1569,79,80,159,49.7%,2m
9580,2,turbokid,3324,1044,60,72,132,45.5%,28m
9580,3,tQPingPonG,3324,961,59,48,107,55.1%,19m
9580,3,Peanut,3324,1143,44,50,94,46.8%,25m
9580,3,Silentgun,3324,366,14,21,35,40.0%,39m
9580,1,Møønight,3324,301,13,8,21,61.9%,2m
9580,3,MasterAndrew,3324,58,3,1,4,75.0%,41m
9580,3,OmegaThree,3324,60,3,2,5,60.0%,38m
9580,2,lolreally,3324,0,2,3,5,40.0%,26m
9580,3,steven,3324,0,1,0,1,100.0%,41m
9580,2,[nieBla]QQuisoteSan,3324,0,1,1,2,50.0%,4m
9580,3,[xdddxd]cocainomano,3324,30,1,2,3,33.3%,28m
9580,3,HammerQc,3324,0,0,1,1,0.0%,25m
9580,2,IIIIIIIIIIII,3324,0,0,1,1,0.0%,32m
9598,3,theshiz,3323,1557,256,260,516,49.6%,18m
9598,3,SOMEDUDER,3323,813,146,141,287,50.9%,3m
9598,3,Xaladin,3323,572,22,19,41,53.7%,33m
9598,3,CHaSE,3323,436,16,11,27,59.3%,21m
9598,3,Hellfour,3323,220,12,3,15,80.0%,14m
9598,3,Baobab,3323,304,12,9,21,57.1%,26m
9598,3,najzbajs,3323,135,6,2,8,75.0%,9m
9598,3,[TGosuA]TerranHerUp,3323,144,6,3,9,66.7%,24m
9598,3,Issac,3323,146,5,4,9,55.6%,25m
9598,3,[xAAx]Trizorg,3323,92,3,4,7,42.9%,41m
9598,3,dardo,3323,88,3,5,8,37.5%,33m
9598,3,EnTaroDHo,3323,58,2,6,8,25.0%,41m
9598,3,sciinsane,3323,30,1,7,8,12.5%,20m
9598,1,Ungiven,3323,0,0,1,1,0.0%,35m
9598,3,[NWtoke]Nuggz,3323,0,0,1,1,0.0%,39m
9598,3,ExpHunter,3323,0,0,3,3,0.0%,14m
9614,3,AndyOh,3322,774,93,71,164,56.7%,14m
9614,3,Arkawn,3322,1544,80,72,152,52.6%,9m
9614,3,SeQuenceSix,3322,688,45,41,86,52.3%,2m
9614,3,[MATTO]Milquetoast,3322,945,42,31,73,57.5%,33m
9614,3,[IMDSI]jhonatan,3322,512,19,16,35,54.3%,21m
9614,1,SpunZ,3322,181,11,8,19,57.9%,11m
9614,3,RedFm,3322,148,5,5,10,50.0%,39m
9614,3,[FTBALL]Stunning,3322,0,4,1,5,80.0%,41m
9614,3,Dinain,3322,0,4,1,5,80.0%,14m
9614,3,LionHeart,3322,58,3,1,4,75.0%,33m
9614,3,[G0RE]Apocalypso,3322,90,3,3,6,50.0%,8m
9614,3,[OPERA]MRUIJIAKING,3322,30,2,2,4,50.0%,16m
9614,3,[WuTang]Peaches,3322,0,1,0,1,100.0%,3m
9614,3,[BTRBYZ]Kinrui,3322,0,0,1,1,0.0%,9m
9614,3,IIlllIIllIlI,3322,0,0,2,2,0.0%,26m
9629,3,Geiseric,3321,1558,71,68,139,51.1%,10m
9629,2,KannOx,3321,785,51,47,98,52.0%,17m
9629,3,QLmindless,3321,891,42,36,78,53.8%,21m
9629,3,[ValidG]RabidMonkey,3321,770,29,30,59,49.2%,24m
9629,3,LifeOfDerp,3321,493,28,10,38,73.7%,24m
9629,2,QWERTY,3321,206,10,6,16,62.5%,3m
9629,3,Reza,3321,168,7,3,10,70.0%,21m
9629,3,Ayako,3321,30,5,1,6,83.3%,22m
9629,1,[WIDOWZ]Mendokusee,3321,48,3,4,7,42.9%,2h
9629,3,[SANGRE]ETERNØ,3321,0,1,0,1,100.0%,18m
9629,3,Navius,3321,30,1,2,3,33.3%,7m
9629,3,[Din0s]slowly,3321,0,0,1,1,0.0%,37m
9629,3,[SIClan]INnoVation,3321,0,0,1,1,0.0%,21m
9629,1,sanZeNeX,3321,0,0,1,1,0.0%,52m
9629,3,[WNC]Nitsuj,3321,0,0,2,2,0.0%,40m
9629,3,[GeekA]Fargos,3321,0,0,6,6,0.0%,13m
9645,1,[SJBB]MGJTerran,3320,1421,417,435,852,48.9%,19m
9645,3,NastyNugs,3320,1594,151,138,289,52.2%,39m
9645,3,[NPFR]molozilla,3320,1313,127,115,242,52.5%,11m
9645,3,[THESG]Giant,3320,851,56,58,114,49.1%,20m
9645,3,Wolfroar,3320,540,35,41,76,46.1%,33m
9645,3,[LgnTDS]Zerg,3320,634,24,26,50,48.0%,9m
9645,2,Blfrog,3320,629,23,31,54,42.6%,38m
9645,2,Reeboar,3320,352,12,26,38,31.6%,12m
9645,3,[TGosuA]Kyroh,3320,202,9,8,17,52.9%,24m
9645,3,Gaia,3320,90,5,7,12,41.7%,34m
9645,2,[GGMESP]FineEQuality,3320,0,4,1,5,80.0%,3h
9645,3,[AUSC]Darkboi,3320,58,2,3,5,40.0%,35m
9657,2,mmun,3319,1411,202,194,396,51.0%,16m
9657,3,AskMaddy,3319,1652,149,113,262,56.9%,25m
9657,2,Brutalleschi,3319,1409,92,109,201,45.8%,35m
9657,2,SinaSC,3319,1118,79,83,162,48.8%,16m
9657,3,ShadyDealer,3319,931,63,56,119,52.9%,24m
9657,3,Mextli,3319,1123,56,49,105,53.3%,41m
9657,3,Gianzex,3319,1245,55,51,106,51.9%,28m
9657,3,Skwal,3319,1205,51,44,95,53.7%,41m
9657,3,PongO,3319,1228,46,55,101,45.5%,9m
9657,3,Alenisko,3319,685,29,13,42,69.0%,36m
9657,3,brrrrrrr,3319,697,29,25,54,53.7%,13m
9657,3,[ZTemps]Shanks,3319,600,22,20,42,52.4%,33m
9657,3,abcdefghijkl,3319,365,14,9,23,60.9%,15m
9657,3,[Coccyx]Nybble,3319,360,14,10,24,58.3%,25m
9657,3,[SLAMT]Syn,3319,230,9,9,18,50.0%,24m
9657,3,ROG,3319,138,7,2,9,77.8%,33m
9657,3,TCizzle,3319,210,7,13,20,35.0%,41m
9657,3,AsuraPhil,3319,58,3,0,3,100.0%,13m
9657,3,[PerúPe]AlegriA,3319,30,2,1,3,66.7%,33m
9657,1,LingRush,3319,96,2,1,3,66.7%,13m
9657,3,hairyspadee,3319,62,2,5,7,28.6%,31m
9657,3,IKseoirse,3319,0,1,0,1,100.0%,23m
9657,3,GlenXie,3319,30,1,1,2,50.0%,12m
9657,3,[xRtG]SpiritOfDice,3319,30,1,5,6,16.7%,34m
9657,3,KBphan,3319,0,0,1,1,0.0%,40m
9682,2,[HUSHrx]mio,3318,833,128,132,260,49.2%,13m
9682,3,WesJanson,3318,1039,117,98,215,54.4%,30m
9682,3,FeeniX,3318,694,92,70,162,56.8%,9m
9682,3,Dingus,3318,459,74,62,136,54.4%,7m
9682,3,[Ex7rA]Hobbes,3318,1102,44,35,79,55.7%,26m
9682,3,[Yamaha]FATCHOOCHIE,3318,1015,44,42,86,51.2%,30m
9682,3,Sotsub,3318,794,31,28,59,52.5%,12m
9682,3,EvO,3318,514,28,28,56,50.0%,36m
9682,3,[ExcIgN]IIIIIIIIIII,3318,628,24,22,46,52.2%,22m
9682,2,[mAg]Orchestrate,3318,517,18,27,45,40.0%,29m
9682,3,Pexavi,3318,286,10,11,21,47.6%,14m
9682,1,[UFL]tianshi,3318,48,3,5,8,37.5%,2h
9682,3,scmike,3318,62,3,7,10,30.0%,20m
9682,3,starkiller,3318,30,2,0,2,100.0%,16m
9682,3,Paladin,3318,60,2,6,8,25.0%,7m
9682,3,sinLuke,3318,30,1,2,3,33.3%,26m
9682,3,[GhoB]EgonSpengler,3318,0,1,2,3,33.3%,17m
9682,3,DynamiteDave,3318,30,1,2,3,33.3%,38m
9682,3,[MEP]PuppyKing,3318,0,0,1,1,0.0%,41m
9701,3,Buddaaaay,3317,1637,390,377,767,50.8%,14m
9701,3,[KOYOMI]GivhertheD,3317,1563,151,141,292,51.7%,2m
9701,3,AllStimmedUp,3317,1453,96,71,167,57.5%,3m
9701,3,[DRFS]Dysutopia,3317,1528,77,69,146,52.7%,18m
9701,3,Samaitch,3317,1296,61,43,104,58.7%,16m
9701,3,[OhSoEz]Jamm,3317,654,51,52,103,49.5%,24m
9701,3,zim,3317,722,29,16,45,64.4%,10m
9701,3,bigBUTts,3317,465,20,15,35,57.1%,5m
9701,3,[HazIPA]Zen,3317,206,8,6,14,57.1%,10m
9701,2,Wiever,3317,134,5,16,21,23.8%,35m
9701,2,[RPLLE]RPWaniboko,3317,141,4,5,9,44.4%,2m
9701,3,Underling,3317,52,2,3,5,40.0%,24m
9701,3,PaGaNs,3317,60,2,5,7,28.6%,17m
9701,3,dcfm,3317,0,1,0,1,100.0%,34m
9701,3,CANCERBERO,3317,0,1,0,1,100.0%,4m
9701,3,mikewar,3317,0,1,0,1,100.0%,10m
9701,3,STRANGER,3317,30,1,5,6,16.7%,27m
9701,3,GeekTeaa,3317,30,1,13,14,7.1%,39m
9701,3,[XDRAX8]DraXSlave,3317,0,0,1,1,0.0%,28m
9701,3,[PTHero]Heen,3317,0,0,2,2,0.0%,34m
9721,3,Moist,3316,1534,133,121,254,52.4%,7m
9721,3,Strange,3316,732,130,101,231,56.3%,29m
9721,3,simply,3316,770,70,67,137,51.1%,21m
9721,3,ice,3316,1599,69,66,135,51.1%,9m
9721,2,[DarkAG]JKOBE,3316,672,66,79,145,45.5%,10m
9721,3,Jaicob,3316,1281,54,40,94,57.4%,33m
9721,3,AgerionDYas,3316,793,34,18,52,65.4%,13m
9721,3,[FOXB]BowsiEU,3316,650,29,17,46,63.0%,36m
9721,3,SuFu,3316,427,19,12,31,61.3%,37m
9721,3,aFterMath,3316,30,6,3,9,66.7%,41m
9721,3,Azamantes,3316,197,6,5,11,54.5%,33m
9721,3,caveman,3316,184,6,12,18,33.3%,8m
9721,3,[Zyzzzz]SwaqAttack,3316,116,5,2,7,71.4%,27m
9721,3,Quelijah,3316,86,3,1,4,75.0%,29m
9721,3,llllllllllll,3316,90,3,6,9,33.3%,25m
9721,3,[AbcCo]AlexG,3316,81,2,0,2,100.0%,33m
9721,3,[Nraged]Justified,3316,0,1,2,3,33.3%,41m
9721,3,Karizma,3316,30,1,8,9,11.1%,4m
9721,3,PixiePrince,3316,0,0,1,1,0.0%,41m
9721,3,iCon,3316,0,0,1,1,0.0%,14m
9741,3,beerVirus,3315,1562,232,212,444,52.3%,25m
9741,3,Xsist,3315,298,70,66,136,51.5%,39m
9741,3,ViciousV,3315,680,39,31,70,55.7%,15m
9741,3,protoTYP,3315,676,34,30,64,53.1%,33m
9741,3,Jlep,3315,887,34,31,65,52.3%,41m
9741,3,[scMAUI]Endymion,3315,494,23,17,40,57.5%,18m
9741,3,Barbarrick,3315,446,19,12,31,61.3%,33m
9741,3,[ScSwrm]VaeVictus,3315,374,15,9,24,62.5%,36m
9741,3,DigitalBath,3315,30,5,1,6,83.3%,36m
9741,2,Dwarda,3315,152,5,26,31,16.1%,6m
9741,3,ImYoona,3315,30,4,2,6,66.7%,4m
9741,3,KoSC,3315,120,3,0,3,100.0%,41m
9741,1,DeeDee,3315,122,2,2,4,50.0%,2h
9741,3,name,3315,0,0,1,1,0.0%,25m
9741,3,[GØSU]Typo,3315,0,0,2,2,0.0%,21m
9741,3,[GAWD]AtomicNight,3315,0,0,2,2,0.0%,18m
9741,3,Bababoui,3315,0,0,3,3,0.0%,3m
9741,3,Exoticfritos,3315,0,0,3,3,0.0%,20m
9759,3,[SmokeH]Leo,3314,1372,54,44,98,55.1%,33m
9759,3,[Xpk]Elias,3314,983,50,40,90,55.6%,17m
9759,3,meph,3314,382,22,15,37,59.5%,28m
9759,3,super,3314,366,14,11,25,56.0%,2m
9759,1,Viktor,3314,145,6,2,8,75.0%,32m
9759,2,Alucion,3314,0,4,1,5,80.0%,2h
9759,3,[IPFC]Deva,3314,88,3,7,10,30.0%,24m
9759,3,Boss,3314,97,2,4,6,33.3%,30m
9759,3,Yours,3314,0,0,1,1,0.0%,4m
9759,3,[6056]Speckledjim,3314,0,0,2,2,0.0%,30m
9769,3,LigerZero,3313,1020,52,46,98,53.1%,26m
9769,3,[LEBL]Master,3313,248,11,20,31,35.5%,38m
9769,3,Johnnay,3313,172,7,5,12,58.3%,26m
9769,3,Tear,3313,135,3,2,5,60.0%,25m
9769,3,Cazador,3313,161,3,3,6,50.0%,2m
9769,3,lamond,3313,30,1,2,3,33.3%,10m
9769,3,MrWhompWhomp,3313,30,1,5,6,16.7%,37m
9769,2,Aerials,3313,0,0,1,1,0.0%,32m
9769,3,[OGbros]Gary,3313,0,0,1,1,0.0%,36m
9769,3,Kip,3313,0,0,1,1,0.0%,34m
9779,3,[SNND]Datu,3312,723,39,33,72,54.2%,2m
9779,3,Film,3312,944,35,41,76,46.1%,36m
9779,3,[DoNai]corn,3312,331,13,9,22,59.1%,22m
9779,3,Ogre,3312,186,9,4,13,69.2%,13m
9779,1,Gunship,3312,144,2,2,4,50.0%,2h
9779,3,[0sC]moOn,3312,0,1,0,1,100.0%,30m
9779,3,[CAM]Mrwich,3312,0,1,0,1,100.0%,41m
9779,3,[MrtN]ebok,3312,30,1,3,4,25.0%,6m
9779,3,[New2it]ARabidDogg,3312,0,0,2,2,0.0%,15m
9788,3,NeMeSiS,3311,1487,119,119,238,50.0%,32m
9788,2,DemtrosWFH,3311,1119,110,106,216,50.9%,7m
9788,3,waiting,3311,622,47,35,82,57.3%,21m
9788,3,Eskae,3311,728,27,25,52,51.9%,38m
9788,3,[bLuu]bLuuViraDEAD,3311,345,17,7,24,70.8%,3m
9788,3,Mygots,3311,228,9,6,15,60.0%,26m
9788,3,LucaZ,3311,122,7,2,9,77.8%,33m
9788,3,[X17]Thor,3311,157,6,12,18,33.3%,25m
9788,3,PsychMajor,3311,114,5,3,8,62.5%,19m
9788,3,OnlyLoveYou,3311,118,4,10,14,28.6%,34m
9788,3,Laserpatty,3311,58,3,1,4,75.0%,37m
9788,3,[SUNBRA]Solaire,3311,62,3,6,9,33.3%,25m
9788,3,[TGCrew]Cognite,3311,60,2,2,4,50.0%,28m
9788,3,noobbz,3311,0,1,0,1,100.0%,39m
9788,3,chnge,3311,0,1,2,3,33.3%,30m
9803,3,Null,3310,1574,296,293,589,50.3%,15m
9803,3,CanCauser,3310,1403,128,119,247,51.8%,40m
9803,3,Fernandolisk,3310,1420,63,69,132,47.7%,17m
9803,3,Berkoff,3310,398,15,9,24,62.5%,28m
9803,3,[REIKI]NonMeltIce,3310,118,5,3,8,62.5%,33m
9803,3,MXMEXICAN,3310,60,5,5,10,50.0%,41m
9803,3,[lLiTl]Acey,3310,30,2,3,5,40.0%,9m
9803,3,Risible,3310,0,1,0,1,100.0%,29m
9803,3,[GRNSKN]Ebondawn,3310,0,1,0,1,100.0%,39m
9803,3,MoonSun,3310,30,1,1,2,50.0%,34m
9803,3,WearATopHat,3310,30,1,3,4,25.0%,27m
9803,3,IBCloaked,3310,0,0,1,1,0.0%,2m
9803,3,[SWOLJ]zero,3310,0,0,1,1,0.0%,36m
9803,3,Antiks,3310,0,0,1,1,0.0%,22m
9803,3,[WNTR]PatZeCake,3310,0,0,1,1,0.0%,13m
9803,3,IIIIIIIIIIII,3310,0,0,1,1,0.0%,32m
9803,3,llllllllllll,3310,0,0,5,5,0.0%,8m
9820,3,PronLight,3309,1593,130,96,226,57.5%,2m
9820,3,EaseFrThSoul,3309,1537,83,88,171,48.5%,18m
9820,2,[ORTSS]VeganDragon,3309,891,38,51,89,42.7%,18m
9820,3,Gamuda,3309,675,30,21,51,58.8%,13m
9820,3,Cytrone,3309,626,26,20,46,56.5%,16m
9820,3,[Cryptc]Krispee,3309,490,17,22,39,43.6%,14m
9820,3,Tyler,3309,422,16,15,31,51.6%,41m
9820,3,[SsaYnS]HappyHippo,3309,206,8,7,15,53.3%,39m
9820,3,ninepool,3309,164,7,6,13,53.8%,12m
9820,2,Trista,3309,0,4,1,5,80.0%,57m
9820,2,LimSongEun,3309,0,4,1,5,80.0%,28m
9820,3,[HLYYLH]Yusei,3309,0,3,2,5,60.0%,14m
9820,3,Gyire,3309,90,3,3,6,50.0%,29m
9820,3,[TGCF]WolffStreet,3309,0,2,6,8,25.0%,2m
9820,3,[SRJC]NameHaver,3309,0,1,0,1,100.0%,25m
9820,3,CaptinMitt,3309,0,1,0,1,100.0%,25m
9820,2,Caleb,3309,0,0,1,1,0.0%,10m
9820,3,mrSedda,3309,0,0,1,1,0.0%,20m
9820,3,savior,3309,0,0,1,1,0.0%,22m
9820,3,IAmShu,3309,0,0,2,2,0.0%,30m
9820,3,Kneeper,3309,0,0,5,5,0.0%,39m
9841,3,Rorschach,3308,1547,163,151,314,51.9%,8m
9841,3,firsttimer,3308,670,71,59,130,54.6%,11m
9841,3,mmrp,3308,428,66,67,133,49.6%,40m
9841,3,ZeRaTuL,3308,1010,38,41,79,48.1%,13m
9841,3,[ZCCCFE]neildegrassi,3308,663,31,15,46,67.4%,29m
9841,2,Pacific,3308,672,26,31,57,45.6%,31m
9841,3,Jackson,3308,569,24,30,54,44.4%,9m
9841,1,really,3308,315,13,10,23,56.5%,13m
9841,3,xXNoOneXx,3308,238,9,12,21,42.9%,30m
9841,1,IIIIIIIIIIII,3308,164,6,2,8,75.0%,2h
9841,1,[NwAs]Kimba,3308,102,4,0,4,100.0%,53m
9841,3,StealGiant,3308,90,3,5,8,37.5%,18m
9841,3,Sluipen,3308,0,1,2,3,33.3%,41m
9841,3,KingofATL,3308,0,0,1,1,0.0%,33m
9855,3,Rizo,3307,1327,101,102,203,49.8%,7m
9855,3,PeachFuzz,3307,446,17,14,31,54.8%,25m
9855,1,Ryukku,3307,317,14,6,20,70.0%,23m
9855,3,[BfLaD]Bazar,3307,136,6,4,10,60.0%,24m
9855,3,[D3fend]Zeratal,3307,166,6,6,12,50.0%,35m
9855,3,Gidgetiize,3307,140,5,5,10,50.0%,21m
9855,3,[xO]DukeSilver,3307,122,5,8,13,38.5%,39m
9855,3,Petra,3307,169,4,7,11,36.4%,13m
9855,3,[NPhasA]TTTGGG,3307,0,2,0,2,100.0%,17m
9855,3,[MIT]radon,3307,58,2,5,7,28.6%,29m
9855,3,EliteDestroy,3307,0,1,0,1,100.0%,33m
9855,3,[DFYII]oIo,3307,0,1,0,1,100.0%,17m
9855,3,Rykune,3307,30,1,1,2,50.0%,24m
9855,3,[KJedi]Roger,3307,0,1,4,5,20.0%,18m
9855,3,[TNKG]Zerwekh,3307,36,1,4,5,20.0%,24m
9855,3,[H2Oplz]Quiv,3307,0,0,3,3,0.0%,24m
9871,3,Nothing,3306,1568,102,87,189,54.0%,25m
9871,3,Bullmamma,3306,1544,72,72,144,50.0%,15m
9871,3,Maulicious,3306,769,44,28,72,61.1%,22m
9871,3,[FalPal]ZeroDashZero,3306,1226,42,54,96,43.8%,18m
9871,3,PARCH,3306,780,29,27,56,51.8%,18m
9871,3,lllIIIlllIII,3306,514,19,18,37,51.4%,2m
9871,3,Jampackedeon,3306,194,8,14,22,36.4%,38m
9871,3,Miller,3306,142,6,2,8,75.0%,28m
9871,3,Andrew,3306,60,3,3,6,50.0%,14m
9871,3,MaK,3306,58,3,4,7,42.9%,4m
9871,3,ReGuluS,3306,0,0,1,1,0.0%,36m
9882,3,carlos,3305,1118,216,185,401,53.9%,30m
9882,3,ricolocotito,3305,1217,89,94,183,48.6%,24m
9882,3,[αXLa]KvrvTrewa,3305,312,57,51,108,52.8%,18m
9882,3,[25ZAIS]BaronTilt,3305,636,29,11,40,72.5%,29m
9882,3,WebCorno,3305,704,29,18,47,61.7%,31m
9882,3,LucasCoelho,3305,398,14,17,31,45.2%,25m
9882,3,Chaeyoung,3305,86,7,2,9,77.8%,33m
9882,3,Ellena,3305,0,4,1,5,80.0%,8m
9882,3,Ichigo,3305,86,4,2,6,66.7%,35m
9882,3,eKKo,3305,88,4,2,6,66.7%,34m
9882,3,Doberman,3305,0,1,0,1,100.0%,27m
9882,3,WheatThins,3305,30,1,2,3,33.3%,28m
9882,3,GKS,3305,30,1,2,3,33.3%,4m
9882,1,[ProSC]ElTioDer,3305,0,0,3,3,0.0%,20m
9882,3,llllllllllll,3305,0,0,3,3,0.0%,32m
9882,3,Phananda,3305,0,0,5,5,0.0%,14m
9898,3,Gutrip,3304,1293,282,279,561,50.3%,31m
9898,3,Seth,3304,1571,236,200,436,54.1%,20m
9898,3,[CFSMY]KrystaL,3304,1526,124,115,239,51.9%,25m
9898,3,Arkoudaki,3304,1270,118,97,215,54.9%,26m
9898,3,Buttface,3304,1393,115,98,213,54.0%,41m
9898,3,Haley,3304,1213,57,38,95,60.0%,4m
9898,3,[KingSC]Chapu,3304,122,45,42,87,51.7%,21m
9898,3,SirBlahDBlah,3304,744,44,40,84,52.4%,28m
9898,3,BlackStar,3304,687,31,20,51,60.8%,19m
9898,3,[REPORT]Daredevil,3304,492,16,25,41,39.0%,19m
9898,3,[DHaLL]SirAenys,3304,232,9,9,18,50.0%,41m
9898,3,[GOPERÚ]Force,3304,230,8,12,20,40.0%,15m
9898,3,YoshiCity,3304,215,7,4,11,63.6%,26m
9898,1,Vroxky,3304,139,6,2,8,75.0%,5m
9898,3,[PTHero]Vampire,3304,143,4,2,6,66.7%,34m
9898,1,TER,3304,97,3,1,4,75.0%,49m
9898,3,jdsarge,3304,60,2,3,5,40.0%,14m
9898,3,OpWaNaGeThY,3304,0,1,0,1,100.0%,21m
9898,3,Morrek,3304,0,1,2,3,33.3%,13m
9898,3,[Dlphns]Ironslug,3304,30,1,2,3,33.3%,37m
9898,3,[nfr]Santander,3304,0,0,1,1,0.0%,32m
9898,3,xKhaosx,3304,0,0,2,2,0.0%,24m
9920,3,[HØST]Vitorino,3303,1586,357,298,655,54.5%,38m
9920,3,[ZTemp]DujekOnearm,3303,1072,113,104,217,52.1%,18m
9920,3,EXARKUN,3303,1171,64,50,114,56.1%,4m
9920,3,Squid,3303,711,38,11,49,77.6%,36m
9920,3,Benchuu,3303,507,34,29,63,54.0%,20m
9920,3,Aiden,3303,560,23,22,45,51.1%,29m
9920,3,unbourne,3303,540,19,19,38,50.0%,2m
9920,3,Hugeballs,3303,246,13,8,21,61.9%,41m
9920,3,Propofol,3303,320,11,19,30,36.7%,19m
9920,3,Zorander,3303,280,10,13,23,43.5%,13m
9920,3,Zeothul,3303,142,5,4,9,55.6%,25m
9920,3,[Exper]oOSenchi,3303,114,5,7,12,41.7%,24m
9920,3,XxGamearayxX,3303,60,3,2,5,60.0%,20m
9920,3,[TheRs]Rynomasher,3303,72,3,7,10,30.0%,40m
9920,3,TReXXX,3303,60,2,3,5,40.0%,36m
9920,3,soonsiri,3303,0,1,0,1,100.0%,4m
9920,3,NYCnosukja,3303,0,0,1,1,0.0%,25m
9920,3,uNdefined,3303,0,0,1,1,0.0%,9m
9920,3,manodemo,3303,0,0,1,1,0.0%,24m
9939,2,manowar,3302,1534,111,112,223,49.8%,27m
9939,3,Triumph,3302,1538,105,90,195,53.8%,2m
9939,3,Sven,3302,1132,68,53,121,56.2%,4m
9939,3,[ZTemp]MrMaryJane,3302,455,23,7,30,76.7%,35m
9939,3,tonycolors,3302,590,23,15,38,60.5%,34m
9939,3,[OwOÈXÉ]zWolfie,3302,453,16,13,29,55.2%,11m
9939,3,YeePs,3302,286,11,12,23,47.8%,9m
9939,3,Earendil,3302,224,10,6,16,62.5%,41m
9939,3,[BRSKR]Ferral,3302,228,9,8,17,52.9%,14m
9939,3,Meko,3302,243,8,7,15,53.3%,7m
9939,3,ImAnUmbrella,3302,140,6,6,12,50.0%,29m
9939,3,ProbiusSC,3302,86,4,2,6,66.7%,11m
9939,3,eric,3302,49,3,0,3,100.0%,36m
9939,3,Hercules,3302,0,2,3,5,40.0%,18m
9939,3,RonSwanson,3302,58,2,3,5,40.0%,38m
9939,3,[TGosuD]swister,3302,62,2,9,11,18.2%,36m
9939,3,Icarus,3302,0,1,0,1,100.0%,34m
9939,3,[OD2019]DrWeasel,3302,30,1,4,5,20.0%,24m
9939,3,StardLord,3302,0,0,1,1,0.0%,15m
9939,3,OtakuKawaii,3302,0,0,1,1,0.0%,6m
9939,3,[xVIPx]MrWhite,3302,0,0,2,2,0.0%,7m
9939,3,[LATERs]HokkaiShime,3302,0,0,2,2,0.0%,24m
9939,3,Stasis,3302,0,0,4,4,0.0%,32m
9939,3,MaDeLene,3302,0,0,7,7,0.0%,35m
9963,3,HiThere,3301,1052,44,40,84,52.4%,10m
9963,3,Sidd,3301,137,16,17,33,48.5%,9m
9963,3,optomus,3301,176,13,8,21,61.9%,38m
9963,3,Hoovie,3301,200,11,4,15,73.3%,28m
9963,3,Reeeee,3301,183,8,4,12,66.7%,28m
9963,1,[Cakius]Tavo,3301,184,5,5,10,50.0%,11m
9963,2,Dawiz,3301,0,4,1,5,80.0%,2h
9963,3,[H4KN1]Tovarish,3301,86,4,3,7,57.1%,23m
9963,3,barcode,3301,0,1,1,2,50.0%,5m
9963,3,DEADPOOL,3301,0,0,2,2,0.0%,18m
9963,3,[HHSS]MeRKabatH,3301,0,0,2,2,0.0%,38m
9963,3,Jutia,3301,0,0,2,2,0.0%,8m
9963,2,CptProtoss,3301,0,0,5,5,0.0%,57m
9963,3,[KRlSPY]DaveLam,3301,0,0,12,12,0.0%,40m
9977,2,Armah,3300,1209,217,185,402,54.0%,32m
9977,3,AnastasiaRU,3300,873,168,112,280,60.0%,6m
9977,3,Maganopolis,3300,722,125,120,245,51.0%,3m
9977,2,[ClemA]DerpySquid,3300,1219,88,96,184,47.8%,21m
9977,3,shroomz,3300,1163,74,74,148,50.0%,24m
9977,3,WaterHungry,3300,726,46,26,72,63.9%,35m
9977,3,MaNiA,3300,366,46,40,86,53.5%,9m
9977,3,[BIGSTD]Syphilis,3300,597,23,20,43,53.5%,36m
9977,3,MilkNCookies,3300,413,15,11,26,57.7%,38m
9977,1,YUMC,3300,274,11,10,21,52.4%,5m
9977,3,[TMSG]JubJub,3300,217,8,4,12,66.7%,13m
9977,3,Synergy,3300,116,5,3,8,62.5%,35m
9977,2,Snow,3300,0,4,1,5,80.0%,2h
9977,3,Pyromancer,3300,0,2,2,4,50.0%,33m
9977,3,[SABO]Zig,3300,60,2,4,6,33.3%,6m
9977,3,cityboom,3300,30,1,1,2,50.0%,41m
9977,3,SticksLD,3300,30,1,2,3,33.3%,24m
9994,2,[SC2BOL]Edward,3299,1551,175,175,350,50.0%,14m
9994,3,[GoatC]Dolan,3299,1379,127,125,252,50.4%,21m
9994,3,[GØSU]VonBiggCatt,3299,1592,86,79,165,52.1%,28m
9994,3,NKBK,3299,780,42,45,87,48.3%,38m
9994,3,Pantoufle,3299,938,39,31,70,55.7%,32m
9994,2,Sand,3299,928,32,52,84,38.1%,38m
9994,2,RedJOSH,3299,670,22,30,52,42.3%,15m
9994,3,ThirdGathers,3299,360,15,9,24,62.5%,29m
9994,3,SquishMitten,3299,345,14,19,33,42.4%,22m
9994,3,Hazzy,3299,159,12,10,22,54.5%,40m
9994,3,[BoRnGo]MooCowThon,3299,142,7,8,15,46.7%,36m
9994,2,[Dnwlkr]RyZeN,3299,0,4,1,5,80.0%,20m
9994,3,Pheonix,3299,58,3,0,3,100.0%,14m
9994,2,Mistro,3299,0,3,1,4,75.0%,42m
9994,3,[Lp]MiniDaRkneSS,3299,0,3,2,5,60.0%,36m
9994,1,ArdVark,3299,46,2,0,2,100.0%,6m
9994,3,Four,3299,0,1,0,1,100.0%,27m
9994,2,[LUE]OctopusBlues,3299,0,1,5,6,16.7%,8m
9994,3,EliteGhost,3299,0,0,1,1,0.0%,27m
10013,3,Jude,3298,1277,100,96,196,51.0%,39m
10013,3,UrineTrouble,3298,917,45,42,87,51.7%,31m
10013,3,MrRasenGetsu,3298,458,37,30,67,55.2%,40m
10013,3,GoatSpoon,3298,373,28,25,53,52.8%,17m
10013,3,pidgey,3298,658,26,22,48,54.2%,42m
10013,3,briznokovic,3298,270,12,13,25,48.0%,13m
10013,3,[4Karl]Nebula,3298,270,10,6,16,62.5%,6m
10013,3,DoctorGonzo,3298,172,7,6,13,53.8%,15m
10013,3,[VetZCo]torky,3298,146,6,4,10,60.0%,36m
10013,2,BigDiggaNick,3298,97,3,3,6,50.0%,2h
10013,3,dookie,3298,0,2,3,5,40.0%,4m
10013,3,squi,3298,30,2,8,10,20.0%,6m
10013,3,[HoX]StaticX,3298,0,0,1,1,0.0%,21m
10013,3,[NM8]Devils,3298,0,0,1,1,0.0%,18m
10013,3,SarNosoO,3298,0,0,1,1,0.0%,20m
10013,3,XPBoost,3298,0,0,2,2,0.0%,5m
10013,3,Elmatapollos,3298,0,0,3,3,0.0%,26m
10030,3,canajam,3297,1628,123,105,228,53.9%,14m
10030,3,obeyHim,3297,1647,112,111,223,50.2%,25m
10030,3,ThinkTwice,3297,1519,97,76,173,56.1%,19m
10030,3,Failboat,3297,1369,75,58,133,56.4%,19m
10030,2,Eggster,3297,1527,64,70,134,47.8%,27m
10030,3,SwarmStorm,3297,744,58,57,115,50.4%,36m
10030,3,QStorm,3297,809,47,32,79,59.5%,7m
10030,3,[143s4]Andacon,3297,912,41,41,82,50.0%,40m
10030,3,Thoros,3297,619,24,26,50,48.0%,30m
10030,3,[TPGGXD]LUFFy,3297,536,21,16,37,56.8%,33m
10030,3,Hellcife,3297,485,20,21,41,48.8%,24m
10030,3,[RwtM]TheReaper,3297,344,15,8,23,65.2%,16m
10030,3,Kratos,3297,244,13,22,35,37.1%,4m
10030,3,MASSUKKAMURA,3297,238,11,4,15,73.3%,8m
10030,3,darKman,3297,288,11,8,19,57.9%,30m
10030,2,[iDrunk]Zach,3297,220,7,23,30,23.3%,41m
10030,2,Barrin,3297,0,4,1,5,80.0%,3h
10030,3,StarMaster,3297,58,3,1,4,75.0%,24m
10030,3,[Igbt]FlyinHealBus,3297,97,3,3,6,50.0%,14m
10030,3,[B0N3]ONIONBOUND,3297,88,3,5,8,37.5%,26m
10030,3,LuizPaulo,3297,0,1,0,1,100.0%,26m
10030,2,DRoxxy,3297,94,1,3,4,25.0%,15m
10030,3,MaxerWaxer,3297,0,0,1,1,0.0%,24m
10030,3,Frag,3297,0,0,5,5,0.0%,32m
10054,3,Foltest,3296,912,41,23,64,64.1%,35m
10054,2,HUASCAR,3296,909,35,42,77,45.5%,5m
10054,3,[DIQPTE]Miz,3296,495,25,23,48,52.1%,38m
10054,3,[LMI42]OverlordRush,3296,646,23,23,46,50.0%,15m
10054,3,Gnash,3296,430,16,26,42,38.1%,9m
10054,3,iamni,3296,394,14,22,36,38.9%,22m
10054,3,StingraySam,3296,328,12,16,28,42.9%,6m
10054,3,[BuFam]EpicArcher,3296,168,7,9,16,43.8%,8m
10054,3,[GOPERÚ]Dialestro,3296,144,6,3,9,66.7%,16m
10054,3,[EZTZPZ]Blank,3296,172,6,5,11,54.5%,2m
10054,3,[CNorth]nachoman,3296,118,5,5,10,50.0%,13m
10054,2,Mousline,3296,156,5,17,22,22.7%,17m
10054,2,Craesi,3296,0,4,1,5,80.0%,2h
10054,3,Diplomacy,3296,86,4,1,5,80.0%,40m
10054,3,MicroJackson,3296,86,3,3,6,50.0%,33m
10054,3,OhMyZeRo,3296,86,3,8,11,27.3%,11m
10054,3,JeffWahlsten,3296,0,1,0,1,100.0%,7m
10054,3,[ZAVC]PitaPanic,3296,0,1,0,1,100.0%,27m
10054,3,Necromancer,3296,30,1,1,2,50.0%,18m
10054,3,ymisofine,3296,30,1,4,5,20.0%,15m
10054,3,[Epic]Cauchy,3296,0,0,1,1,0.0%,26m
10054,3,Jaximus,3296,0,0,5,5,0.0%,2m
10076,3,Maritime,3295,1611,326,303,629,51.8%,20m
10076,2,[WW1]shahin,3295,1449,153,141,294,52.0%,17m
10076,3,[VAMPR]ahegalisk,3295,1138,45,38,83,54.2%,14m
10076,3,RobotNinja,3295,389,22,16,38,57.9%,3m
10076,3,[AoBDE]Gooby,3295,442,16,11,27,59.3%,12m
10076,3,StayxShifty,3295,315,11,6,17,64.7%,2m
10076,3,[C96741]Shaftasaur,3295,254,9,19,28,32.1%,41m
10076,3,[BrHero]jumplnjac,3295,121,8,4,12,66.7%,32m
10076,3,alieN,3295,144,5,11,16,31.2%,30m
10076,3,[ZTemps]Gorillas,3295,104,4,1,5,80.0%,2m
10076,3,Rush,3295,30,4,2,6,66.7%,18m
10076,3,Snoky,3295,86,3,3,6,50.0%,39m
10076,3,[NLTN]Ultralisk,3295,0,1,0,1,100.0%,29m
10076,3,sacred,3295,0,1,0,1,100.0%,33m
10076,3,[SPV]Taiken,3295,0,0,1,1,0.0%,32m
10076,3,Hydra,3295,0,0,1,1,0.0%,22m
10092,3,[BruhBT]HOMES,3294,1283,136,129,265,51.3%,15m
10092,3,matyunya,3294,1212,121,109,230,52.6%,22m
10092,3,[TPGGXD]PassatV,3294,1419,89,80,169,52.7%,38m
10092,2,MoreLife,3294,1483,52,68,120,43.3%,18m
10092,3,PickACard,3294,1218,46,44,90,51.1%,32m
10092,2,Ether,3294,522,36,44,80,45.0%,21m
10092,3,maxQ,3294,458,19,15,34,55.9%,24m
10092,2,imanoobie,3294,428,18,16,34,52.9%,25m
10092,2,[eFight]dudebro,3294,524,18,32,50,36.0%,4m
10092,3,RageD,3294,134,17,15,32,53.1%,38m
10092,3,Roach,3294,254,8,2,10,80.0%,37m
10092,3,ChinaTheBest,3294,228,8,7,15,53.3%,6m
10092,3,tgLthpLsrIV,3294,168,7,2,9,77.8%,3m
10092,3,Gnutty,3294,144,7,5,12,58.3%,33m
10092,3,[SSEAS]Magikarp,3294,120,6,3,9,66.7%,24m
10092,3,[Pizzy]Bot,3294,142,6,4,10,60.0%,42m
10092,2,Jang,3294,162,5,19,24,20.8%,18m
10092,3,Xenon,3294,86,4,0,4,100.0%,12m
10092,3,DNBAH,3294,0,4,1,5,80.0%,18m
10092,3,[SlPt]Proston,3294,120,4,9,13,30.8%,41m
10092,3,Maz,3294,0,3,2,5,60.0%,37m
10092,3,[GGMESP]Mexidios,3294,92,3,6,9,33.3%,17m
10092,3,[IMDSI]OrnsteinCR,3294,30,2,0,2,100.0%,7m
10092,3,Solumn,3294,30,2,2,4,50.0%,27m
10092,3,bLiNd,3294,96,2,3,5,40.0%,24m
10092,3,[LGRW]Stuke,3294,0,1,0,1,100.0%,15m
10092,1,Manifest,3294,0,1,0,1,100.0%,15m
10092,3,Midas,3294,0,1,0,1,100.0%,21m
10092,3,RYAN,3294,0,1,0,1,100.0%,2m
10092,3,[ZTemp]BombSquad,3294,30,1,1,2,50.0%,36m
10092,3,savvy,3294,0,1,2,3,33.3%,42m
10092,3,Eternal,3294,0,0,1,1,0.0%,25m
10092,3,[TGosuB]Snailbait,3294,0,0,1,1,0.0%,16m
10092,3,jangens,3294,0,0,2,2,0.0%,36m
10126,3,Yggdrasil,3293,1133,89,68,157,56.7%,3m
10126,3,Flocka,3293,1501,68,50,118,57.6%,28m
10126,3,MaceMason,3293,1193,46,42,88,52.3%,27m
10126,3,[HtgC]guren,3293,662,25,25,50,50.0%,8m
10126,3,JayMunger,3293,552,18,28,46,39.1%,25m
10126,3,[YSHI]Aibi,3293,358,14,13,27,51.9%,27m
10126,3,kevinghstz,3293,209,10,15,25,40.0%,3m
10126,3,[SANGRE]ALICE,3293,111,3,2,5,60.0%,26m
10126,3,Rohan,3293,58,3,4,7,42.9%,24m
10126,3,Tommy,3293,62,2,4,6,33.3%,4m
10126,3,Doryuzu,3293,62,2,6,8,25.0%,36m
10126,3,[spa3c]stonecoat,3293,0,0,1,1,0.0%,36m
10126,3,Noctisxiii,3293,0,0,1,1,0.0%,30m
10126,3,Oatmeal,3293,0,0,2,2,0.0%,22m
10126,3,Alessfenix,3293,0,0,3,3,0.0%,6m
10141,3,evokanivo,3292,1606,358,338,696,51.4%,34m
10141,3,[CV0101]AmonRA,3292,1631,133,120,253,52.6%,37m
10141,3,Haggard,3292,1055,130,137,267,48.7%,11m
10141,2,[AD3C]CuBaNrEaPeR,3292,967,101,107,208,48.6%,29m
10141,2,AllIn,3292,1017,56,64,120,46.7%,32m
10141,3,AirTiao,3292,772,31,21,52,59.6%,35m
10141,3,[GdAT]WithoutAclue,3292,716,30,26,56,53.6%,25m
10141,3,KirihaKaisei,3292,314,12,5,17,70.6%,42m
10141,1,kaisere,3292,213,11,9,20,55.0%,35m
10141,3,Eastone,3292,88,7,3,10,70.0%,22m
10141,1,llllllllllll,3292,166,5,2,7,71.4%,2h
10141,3,ZipperLine,3292,86,4,0,4,100.0%,42m
10141,3,AnKrehax,3292,60,3,3,6,50.0%,38m
10141,3,llllllllll,3292,58,2,1,3,66.7%,39m
10141,3,aztek,3292,58,2,3,5,40.0%,41m
10141,3,Yici,3292,0,1,0,1,100.0%,38m
10141,3,PeterPiper,3292,30,1,1,2,50.0%,3m
10158,3,HeisenZerg,3291,1569,180,168,348,51.7%,9m
10158,2,HaiImKyle,3291,1195,142,141,283,50.2%,2m
10158,3,ChuttMcBugg,3291,1562,103,82,185,55.7%,33m
10158,3,Deluzio,3291,1498,60,54,114,52.6%,2m
10158,3,dude,3291,1012,36,39,75,48.0%,34m
10158,3,Demure,3291,754,30,39,69,43.5%,36m
10158,3,GHOST,3291,591,24,14,38,63.2%,7m
10158,3,Apple,3291,503,21,13,34,61.8%,8m
10158,3,Rostik,3291,273,12,7,19,63.2%,35m
10158,3,Stevieboydap,3291,354,12,15,27,44.4%,19m
10158,3,Bakaretsu,3291,277,11,11,22,50.0%,24m
10158,3,EyeSpy,3291,145,7,3,10,70.0%,17m
10158,3,[guud]Tigos,3291,223,7,5,12,58.3%,21m
10158,1,myum,3291,165,4,4,8,50.0%,31m
10158,3,Foundering,3291,62,3,5,8,37.5%,28m
10158,3,[αB]Quark,3291,0,0,2,2,0.0%,40m
10158,3,PIMBA,3291,0,0,2,2,0.0%,30m
10158,3,[Rustla]iDrone,3291,0,0,7,7,0.0%,40m
10176,3,Bomberri,3290,1445,169,169,338,50.0%,6m
10176,3,[ZGZGZG]ultralisc,3290,1390,95,87,182,52.2%,28m
10176,3,deZ,3290,1575,92,76,168,54.8%,22m
10176,3,Nachtigallen,3290,1170,90,85,175,51.4%,5m
10176,3,MonkeyKing,3290,1101,50,45,95,52.6%,35m
10176,3,NellaAriel,3290,1136,49,40,89,55.1%,35m
10176,3,Supreme,3290,1226,47,50,97,48.5%,10m
10176,3,XANDER,3290,279,44,31,75,58.7%,16m
10176,3,[H00T]Ryle,3290,718,30,19,49,61.2%,24m
10176,3,VeganDeity,3290,378,26,25,51,51.0%,39m
10176,3,Smokahontuss,3290,209,8,8,16,50.0%,24m
10176,3,[Halofk]YeahOkNoob,3290,174,6,8,14,42.9%,4m
10176,3,[M4Ge]aCanofCoke,3290,122,4,6,10,40.0%,20m
10176,3,hhhhhhhhhhhh,3290,88,3,5,8,37.5%,17m
10176,3,[JURT]Baalie,3290,0,1,0,1,100.0%,3m
10176,3,[EZkill]SpaceJanitor,3290,0,1,0,1,100.0%,38m
10176,3,[Cind3r]Hayes,3290,0,1,0,1,100.0%,25m
10176,3,[xLgNx]BillyUdders,3290,0,1,0,1,100.0%,30m
10176,3,[DTBLNK]WhaleSpark,3290,0,1,1,2,50.0%,20m
10176,3,[FotM]Lotus,3290,30,1,4,5,20.0%,6m
10176,3,DarkShazam,3290,30,1,9,10,10.0%,15m
10176,3,dasha,3290,0,0,1,1,0.0%,16m
10176,3,RoBoT,3290,0,0,5,5,0.0%,10m
10199,3,BCkiller,3289,1583,114,103,217,52.5%,12m
10199,3,WiseKoala,3289,532,20,17,37,54.1%,36m
10199,3,Avenger,3289,247,8,6,14,57.1%,34m
10199,3,[YD2K]BlueDucky,3289,216,7,10,17,41.2%,16m
10199,3,[AVSC]Cortex,3289,0,4,1,5,80.0%,34m
10199,1,Ewells,3289,165,4,4,8,50.0%,2m
10199,3,[CUBAAA]MrAPM,3289,88,3,5,8,37.5%,17m
10199,3,ItimKIllah,3289,40,3,7,10,30.0%,29m
10199,3,[ZTemps]PSYCH,3289,48,2,2,4,50.0%,19m
10199,3,Rune,3289,97,2,6,8,25.0%,29m
10199,1,cuiza,3289,0,1,0,1,100.0%,2h
10199,3,[E04]GhOsT,3289,0,1,0,1,100.0%,14m
10199,3,Tediathan,3289,30,1,1,2,50.0%,30m
10199,3,JusticeBunny,3289,0,0,1,1,0.0%,30m
10199,2,Spaghetto,3289,0,0,2,2,0.0%,12m
10199,3,lateralus,3289,0,0,2,2,0.0%,26m
10199,3,[MPC]IIIIIIIIIIII,3289,0,0,4,4,0.0%,34m
10216,2,albertkwan,3288,1421,129,141,270,47.8%,35m
10216,3,Kraulenth,3288,492,22,19,41,53.7%,24m
10216,3,[SsaYnS]Eggnog,3288,370,15,9,24,62.5%,30m
10216,2,[Fubby]Fubby,3288,140,7,4,11,63.6%,12m
10216,3,Quicksilver,3288,181,5,2,7,71.4%,37m
10216,2,Randomized,3288,0,4,1,5,80.0%,2h
10216,3,WaRMaChINe,3288,86,4,1,5,80.0%,31m
10216,3,[MRCYLS]Human,3288,62,2,9,11,18.2%,37m
10216,3,DoneDoKnow,3288,0,0,2,2,0.0%,14m
10225,3,Sheik,3287,1622,166,175,341,48.7%,37m
10225,3,Chislic,3287,1305,90,85,175,51.4%,34m
10225,3,Dextrocity,3287,892,42,29,71,59.2%,11m
10225,3,[MSotU]Mustang,3287,846,34,30,64,53.1%,15m
10225,3,EvMaN,3287,820,30,29,59,50.8%,6m
10225,3,brachyspira,3287,232,17,14,31,54.8%,34m
10225,1,[ValidG]Mac,3287,97,2,0,2,100.0%,2h
10225,3,[Wat3rs]Insomniac,3287,0,1,0,1,100.0%,33m
10225,3,[Wc3GGL]NatureBoy,3287,0,1,0,1,100.0%,11m
10225,3,MrSnuggles,3287,30,1,2,3,33.3%,23m
10225,3,[Tbnote]Funck,3287,0,1,3,4,25.0%,23m
10225,3,[Lp]GatoTapia,3287,0,0,1,1,0.0%,4m
10225,3,Cazador,3287,0,0,1,1,0.0%,12m
10238,3,[BoAVN]ProPK,3286,1543,157,143,300,52.3%,3m
10238,3,Ponch,3286,1046,79,70,149,53.0%,42m
10238,2,Voluntarist,3286,1212,70,83,153,45.8%,35m
10238,3,[GGMESP]Aireal,3286,955,48,36,84,57.1%,14m
10238,3,Anti,3286,988,36,36,72,50.0%,21m
10238,3,Galleon,3286,438,15,19,34,44.1%,21m
10238,3,Primo,3286,210,7,2,9,77.8%,15m
10238,3,[trolz]Hakase,3286,30,2,7,9,22.2%,19m
10238,3,TudorE,3286,0,1,0,1,100.0%,19m
10238,3,NfestdLawyer,3286,0,1,1,2,50.0%,30m
10238,3,[Wutzu]sOuLsUrGe,3286,0,0,1,1,0.0%,33m
10238,3,darkkiss,3286,0,0,1,1,0.0%,35m
10238,3,Brenda,3286,0,0,1,1,0.0%,10m
10238,3,Infy,3286,0,0,2,2,0.0%,5m
10252,3,dfd,3285,1619,293,301,594,49.3%,24m
10252,3,NaturalLaws,3285,1561,223,221,444,50.2%,15m
10252,3,Nash,3285,1561,159,163,322,49.4%,18m
10252,3,Nuclear,3285,952,143,107,250,57.2%,6m
10252,3,[NatiBN]BMovieFan,3285,1350,51,55,106,48.1%,26m
10252,3,RotRokki,3285,843,37,20,57,64.9%,21m
10252,3,[421]REnder,3285,965,37,37,74,50.0%,3m
10252,2,[UpxV]ramper,3285,479,37,50,87,42.5%,2m
10252,3,Anaklusmos,3285,238,35,30,65,53.8%,9m
10252,3,Soxxii,3285,511,33,31,64,51.6%,31m
10252,3,BadGuru,3285,569,27,17,44,61.4%,34m
10252,3,Synthis,3285,554,21,15,36,58.3%,22m
10252,3,Danimus,3285,187,11,6,17,64.7%,31m
10252,2,Joegypsi,3285,232,10,5,15,66.7%,33m
10252,3,maurice,3285,58,3,2,5,60.0%,13m
10252,3,BboySmilez,3285,0,2,4,6,33.3%,33m
10252,3,[LFUT]Alexis,3285,46,2,4,6,33.3%,36m
10252,3,MangoGreg,3285,0,1,0,1,100.0%,16m
10252,1,Orion,3285,0,1,1,2,50.0%,2h
10252,2,[3OS]Dreki,3285,0,1,4,5,20.0%,44m
10272,3,Okaka,3284,1494,168,160,328,51.2%,36m
10272,3,elitenoob,3284,1599,132,120,252,52.4%,24m
10272,3,[CRAKS]LaGaRTo,3284,1454,61,68,129,47.3%,31m
10272,3,PingPOngne,3284,671,58,48,106,54.7%,24m
10272,3,undertone,3284,871,52,51,103,50.5%,9m
10272,3,jimjoejack,3284,602,23,27,50,46.0%,16m
10272,3,COVIDSUXX,3284,332,14,7,21,66.7%,31m
10272,3,Ralicious,3284,92,2,1,3,66.7%,33m
10272,2,Pants,3284,0,2,3,5,40.0%,2h
10272,3,MrMidnight,3284,58,2,6,8,25.0%,18m
10272,3,[TGosuB]Dream,3284,0,1,0,1,100.0%,30m
10272,3,[FuFu]KnickKnack,3284,97,1,1,2,50.0%,9m
10272,3,PidgeonLips,3284,30,1,6,7,14.3%,9m
10272,3,Love,3284,0,0,1,1,0.0%,28m
10272,3,Alicc,3284,0,0,1,1,0.0%,33m
10272,3,[Flam3s]InTuitioN,3284,0,0,3,3,0.0%,5m
10272,3,[UTK]RZGRZ,3284,0,0,3,3,0.0%,28m
10289,2,gigabeast,3283,1450,142,137,279,50.9%,23m
10289,3,QuestionMonk,3283,1175,73,66,139,52.5%,30m
10289,2,[TPL]MagicLegume,3283,1154,50,58,108,46.3%,27m
10289,2,[RacAtk]woof,3283,781,38,49,87,43.7%,32m
10289,3,Kenyu,3283,805,35,28,63,55.6%,16m
10289,3,Simplified,3283,683,25,19,44,56.8%,8m
10289,3,[KiMBR]FatalisK,3283,631,24,23,47,51.1%,25m
10289,2,[ACSS]Lanthus,3283,206,6,6,12,50.0%,28m
10289,3,Videl,3283,116,5,2,7,71.4%,34m
10289,3,AgitatedLing,3283,114,5,5,10,50.0%,20m
10289,2,DukeJukem,3283,0,4,1,5,80.0%,54m
10289,3,[XHB]Ayuooo,3283,30,2,0,2,100.0%,38m
10289,3,Nik,3283,97,2,1,3,66.7%,5m
10289,3,LasCoL,3283,0,1,0,1,100.0%,9m
10289,3,[DarkPG]ELMANCO,3283,0,1,1,2,50.0%,31m
10289,3,fohz,3283,0,0,1,1,0.0%,4m
10289,3,[NubVZ]Stampede,3283,0,0,1,1,0.0%,25m
10289,3,AlmostNoodle,3283,0,0,1,1,0.0%,2m
10289,2,[PoTWaF]Waffnub,3283,0,0,3,3,0.0%,31m
10308,2,[Nine25]xoxoxo,3282,1099,194,186,380,51.1%,20m
10308,3,dolphiknight,3282,1531,159,135,294,54.1%,30m
10308,3,[YK4vr]CuddleBunny,3282,1564,107,100,207,51.7%,13m
10308,3,CANCERBERO,3282,1659,92,90,182,50.5%,22m
10308,3,Argos,3282,1141,48,36,84,57.1%,4m
10308,3,[60Pho]coolguy,3282,621,24,16,40,60.0%,7m
10308,3,Lurker,3282,650,24,17,41,58.5%,14m
10308,3,lampshade,3282,546,20,13,33,60.6%,32m
10308,3,protozerg,3282,330,14,12,26,53.8%,38m
10308,3,[BallX]OralDishWash,3282,292,11,11,22,50.0%,4m
10308,3,MissingNo,3282,192,7,5,12,58.3%,37m
10308,3,SailBoat,3282,148,7,6,13,53.8%,16m
10308,3,[EZDUNK]Drift,3282,142,6,2,8,75.0%,12m
10308,1,[DHZ0ne]matcos,3282,97,5,3,8,62.5%,18m
10308,1,[TELMO]Mason,3282,142,4,5,9,44.4%,15m
10308,3,zTadictionz,3282,120,4,6,10,40.0%,16m
10308,3,[NLnF]Gilmarneo,3282,122,4,9,13,30.8%,37m
10308,3,Spriggly,3282,30,2,0,2,100.0%,8m
10308,3,PreZ,3282,0,0,1,1,0.0%,36m
10308,3,[BoAVN]SirTriPixz,3282,0,0,1,1,0.0%,40m
10308,1,CHELLY,3282,0,0,1,1,0.0%,37m
10308,3,Nalby,3282,0,0,2,2,0.0%,26m
10330,3,[Osh1tZ]Unholyclown,3281,1639,233,203,436,53.4%,11m
10330,3,ViejoDivino,3281,1216,106,81,187,56.7%,28m
10330,2,[scvffs]Hepzibah,3281,1465,83,87,170,48.8%,27m
10330,3,Hyrue,3281,674,56,41,97,57.7%,6m
10330,3,ilCieloRosso,3281,407,16,9,25,64.0%,39m
10330,3,pineapples,3281,368,15,8,23,65.2%,35m
10330,3,NKGabrielBR,3281,343,15,10,25,60.0%,23m
10330,2,[LVARW]Oomi,3281,363,15,23,38,39.5%,27m
10330,3,Zil,3281,352,13,14,27,48.1%,22m
10330,3,Dadzarg,3281,332,11,10,21,52.4%,21m
10330,3,Ares,3281,204,8,10,18,44.4%,36m
10330,3,GeneralChaos,3281,0,5,0,5,100.0%,37m
10330,1,[TPGGXD]Infected,3281,122,4,5,9,44.4%,9m
10330,3,Ares,3281,60,3,4,7,42.9%,38m
10330,3,Ragnar,3281,30,2,1,3,66.7%,41m
10330,3,[Bet0]TRASHBOAT,3281,30,2,4,6,33.3%,24m
10330,3,[NZER0]OBLIVION,3281,0,0,1,1,0.0%,12m
10330,3,haan,3281,0,0,1,1,0.0%,28m
10330,1,InigoMontoya,3281,0,0,2,2,0.0%,53m
10330,3,Drin,3281,0,0,8,8,0.0%,4m
10350,3,seifer,3280,1258,149,138,287,51.9%,3m
10350,3,slipslip,3280,979,115,106,221,52.0%,32m
10350,3,Ordeith,3280,701,84,80,164,51.2%,40m
10350,3,TheMuffinMan,3280,1376,55,47,102,53.9%,2m
10350,2,[CrTr]HarryPooter,3280,859,35,37,72,48.6%,8m
10350,3,[MSet]tomzZor,3280,720,27,24,51,52.9%,35m
10350,3,bbcparty,3280,513,22,15,37,59.5%,14m
10350,3,BrokenLatex,3280,434,17,16,33,51.5%,25m
10350,3,Sascreama,3280,227,9,8,17,52.9%,37m
10350,3,DecayDikc,3280,197,5,6,11,45.5%,3m
10350,2,trash,3280,0,4,1,5,80.0%,30m
10350,3,Skoda,3280,0,2,3,5,40.0%,14m
10350,3,Unclenoob,3280,58,2,5,7,28.6%,41m
10350,3,[3RECT]Fezel,3280,0,1,0,1,100.0%,6m
10350,3,[Sensei]Hybrid,3280,30,1,2,3,33.3%,6m
10365,3,Randolph,3279,1495,267,266,533,50.1%,19m
10365,3,therat,3279,1151,132,127,259,51.0%,28m
10365,3,Tonder,3279,1431,86,84,170,50.6%,36m
10365,2,Dvine,3279,765,39,62,101,38.6%,18m
10365,3,Sakato,3279,588,29,18,47,61.7%,30m
10365,3,[Pokmon]BingSH,3279,732,29,22,51,56.9%,3m
10365,3,Savubaloo,3279,500,17,21,38,44.7%,5m
10365,3,QLmindless,3279,448,15,22,37,40.5%,25m
10365,2,Corvo,3279,96,3,3,6,50.0%,2h
10365,1,InitiumNovu,3279,143,2,1,3,66.7%,2h
10365,3,MunAh,3279,119,2,3,5,40.0%,30m
10365,3,Dorime,3279,30,2,5,7,28.6%,7m
10365,3,WellFedSyco,3279,0,1,0,1,100.0%,30m
10365,1,[GgARMY]TaitaCáceres,3279,0,1,4,5,20.0%,57m
10365,3,[WO0K]WhiteClaw,3279,30,1,4,5,20.0%,30m
10365,3,[Lolers]Imchinese,3279,0,0,1,1,0.0%,35m
10365,3,AptivaAngel,3279,0,0,2,2,0.0%,31m
10382,2,[FUETGC]Swarmer,3278,1176,48,49,97,49.5%,9m
10382,3,Foxis,3278,468,17,15,32,53.1%,25m
10382,3,[Peeepz]rocky,3278,236,8,13,21,38.1%,3m
10382,3,PrieAnder,3278,86,4,2,6,66.7%,22m
10382,3,HunterBiden,3278,122,4,12,16,25.0%,39m
10382,3,[xENTx]Simo,3278,0,1,0,1,100.0%,32m
10382,3,[Dev]AmrasBerilyn,3278,0,1,0,1,100.0%,4m
10382,3,IDless,3278,0,1,0,1,100.0%,25m
10382,3,cocff,3278,30,1,1,2,50.0%,40m
10382,3,[Mnard]BOO,3278,30,1,2,3,33.3%,42m
10382,3,[NPhasA]Cutepants,3278,30,1,2,3,33.3%,4m
10382,3,[FSlug]Takkunen,3278,0,0,1,1,0.0%,6m
10382,3,[Xpk]ReNzO,3278,0,0,1,1,0.0%,8m
10382,3,[Zno]mengdada,3278,0,0,1,1,0.0%,20m
10382,3,[TGCrew]Darkblade,3278,0,0,1,1,0.0%,3m
10382,3,TRUMP,3278,0,0,2,2,0.0%,30m
10382,1,Logan,3278,0,0,2,2,0.0%,26m
10382,3,[I3ear]PrettyBear,3278,0,0,10,10,0.0%,3m
10400,3,wurlitzer,3277,1571,134,133,267,50.2%,39m
10400,3,RabbiDefiler,3277,1464,115,110,225,51.1%,14m
10400,3,Tresh,3277,593,104,89,193,53.9%,14m
10400,3,Gever,3277,1110,89,81,170,52.4%,34m
10400,3,Infection,3277,514,31,17,48,64.6%,8m
10400,3,IllllIllll,3277,577,25,16,41,61.0%,39m
10400,3,DfjKcaka,3277,422,16,16,32,50.0%,30m
10400,3,BigB,3277,316,12,16,28,42.9%,27m
10400,3,[TGosuB]Yeezus,3277,176,11,11,22,50.0%,36m
10400,3,AreYouCereal,3277,140,7,8,15,46.7%,36m
10400,3,Dekmers,3277,60,3,3,6,50.0%,38m
10400,3,IEatNukes,3277,86,3,4,7,42.9%,35m
10400,3,Maestro,3277,30,2,1,3,66.7%,30m
10400,3,YouKnow,3277,0,1,0,1,100.0%,42m
10400,1,AngryThomap,3277,0,1,0,1,100.0%,2h
10400,2,ReventaCulos,3277,92,1,1,2,50.0%,30m
10400,3,Jeddey,3277,0,1,2,3,33.3%,12m
10400,3,Murdarin,3277,30,1,3,4,25.0%,27m
10400,3,[hTx]EyesRSquared,3277,0,0,1,1,0.0%,36m
10400,3,Serdit,3277,0,0,3,3,0.0%,35m
10400,3,dejii,3277,0,0,6,6,0.0%,24m
10421,3,Bargmr,3276,1555,204,197,401,50.9%,20m
10421,3,[200G]etniopal,3276,1440,56,56,112,50.0%,5m
10421,3,kaboosH,3276,1156,45,37,82,54.9%,4m
10421,2,Stat,3276,838,28,41,69,40.6%,37m
10421,3,twink,3276,512,23,5,28,82.1%,22m
10421,3,jordygigs,3276,440,16,15,31,51.6%,25m
10421,3,LonCho,3276,376,12,18,30,40.0%,31m
10421,3,[123Shh]DougSluggins,3276,284,11,10,21,52.4%,26m
10421,3,[420NS]Ratatat,3276,242,10,5,15,66.7%,35m
10421,3,savage,3276,154,7,3,10,70.0%,36m
10421,3,PeekaChi,3276,146,6,5,11,54.5%,18m
10421,3,NukeOnFire,3276,145,6,7,13,46.2%,31m
10421,3,[SCVM]FlySlendyGG,3276,88,4,2,6,66.7%,14m
10421,3,Reinx,3276,0,1,0,1,100.0%,21m
10421,3,SoupCatcher,3276,0,1,0,1,100.0%,5m
10421,3,[1E100]Tapirus,3276,30,1,2,3,33.3%,38m
10421,3,Cynical,3276,0,0,1,1,0.0%,8m
10421,3,Wrac,3276,0,0,2,2,0.0%,34m
10421,3,Kellin,3276,0,0,2,2,0.0%,31m
10440,3,Nightman,3275,1587,262,229,491,53.4%,19m
10440,3,[PTHero]Heart,3275,1491,111,77,188,59.0%,33m
10440,3,Cro,3275,1285,86,81,167,51.5%,28m
10440,3,DaarkHeart,3275,917,44,37,81,54.3%,17m
10440,3,yaguami,3275,341,16,8,24,66.7%,39m
10440,3,Drake,3275,255,11,2,13,84.6%,20m
10440,3,BronzeBarcod,3275,232,11,5,16,68.8%,23m
10440,3,bent,3275,146,6,4,10,60.0%,21m
10440,3,Japor,3275,95,5,1,6,83.3%,36m
10440,3,[b2the]Rye,3275,118,4,5,9,44.4%,39m
10440,3,[XDWW]oGsHukk,3275,58,3,1,4,75.0%,8m
10440,3,IIIIIIIIII,3275,86,3,2,5,60.0%,5m
10440,1,QtoWE,3275,46,2,5,7,28.6%,21m
10440,3,pooooooooooo,3275,64,2,8,10,20.0%,23m
10440,3,[UIE]Henry,3275,0,1,0,1,100.0%,5m
10440,3,[BobBrz]Trufflebase,3275,0,0,1,1,0.0%,38m
10456,3,Fracture,3274,702,68,45,113,60.2%,6m
10456,3,TheRustic,3274,1368,64,60,124,51.6%,23m
10456,3,Probability,3274,932,50,31,81,61.7%,11m
10456,3,Bob,3274,928,36,28,64,56.2%,8m
10456,3,NeoStorm,3274,308,11,10,21,52.4%,18m
10456,3,SteelyPhil,3274,0,4,1,5,80.0%,14m
10456,2,ColonelW,3274,0,4,1,5,80.0%,2h
10456,3,Olddirty,3274,30,2,0,2,100.0%,29m
10456,3,Nutrage,3274,30,2,3,5,40.0%,3m
10456,3,[EODL]PlaidPancake,3274,60,2,5,7,28.6%,11m
10456,3,FohShizzle,3274,0,1,0,1,100.0%,22m
10456,3,WreCkerD,3274,30,1,2,3,33.3%,13m
10456,3,DiReWOLF,3274,0,0,1,1,0.0%,38m
10456,3,Skiinz,3274,0,0,1,1,0.0%,6m
10456,3,RoyXD,3274,0,0,1,1,0.0%,26m
10456,3,[ValidG]Astra,3274,0,0,1,1,0.0%,27m
10472,3,CNCR,3273,1084,184,163,347,53.0%,13m
10472,3,xSvDGen,3273,1569,93,94,187,49.7%,25m
10472,2,mouse,3273,248,80,73,153,52.3%,41m
10472,3,papapapapa,3273,260,9,6,15,60.0%,26m
10472,3,SoEasy,3273,147,9,8,17,52.9%,12m
10472,3,Mozart,3273,118,5,6,11,45.5%,26m
10472,3,Ruth,3273,0,4,1,5,80.0%,12m
10472,3,Adam,3273,92,4,5,9,44.4%,35m
10472,3,[P51]EmpHappyZerg,3273,58,2,2,4,50.0%,29m
10472,3,[CBA]SgtRock,3273,60,2,2,4,50.0%,24m
10472,3,valasco,3273,0,1,0,1,100.0%,7m
10472,3,Pokeish,3273,0,1,0,1,100.0%,27m
10472,3,Probiotic,3273,0,1,0,1,100.0%,11m
10472,3,Farhao,3273,30,1,1,2,50.0%,15m
10472,3,SnAfU,3273,0,1,2,3,33.3%,37m
10472,3,[RathFr]Raws,3273,30,1,6,7,14.3%,16m
10472,3,[SyL]BlueEyes,3273,0,0,1,1,0.0%,28m
10472,3,[2AhB]MikeZane,3273,0,0,3,3,0.0%,30m
10490,3,stoker,3272,794,34,19,53,64.2%,42m
10490,3,[AlIin]zumpy,3272,592,22,28,50,44.0%,8m
10490,3,[DE]Ashlyn,3272,281,11,3,14,78.6%,20m
10490,3,Sonic,3272,122,4,10,14,28.6%,24m
10490,3,[INextI]Fenix,3272,30,1,6,7,14.3%,36m
10490,3,Amer,3272,30,1,8,9,11.1%,11m
10490,3,[2ENGNS]BZwithWAR,3272,0,0,1,1,0.0%,38m
10497,3,MaSoN,3271,651,25,18,43,58.1%,12m
10497,3,[CMGC]Pholus,3271,444,17,13,30,56.7%,41m
10497,3,GLYDE,3271,332,12,15,27,44.4%,11m
10497,3,FellHire,3271,129,10,4,14,71.4%,33m
10497,3,KrustyKarak,3271,166,7,4,11,63.6%,9m
10497,3,BellyJelly,3271,251,7,12,19,36.8%,8m
10497,1,Renstar,3271,193,6,4,10,60.0%,23m
10497,3,xXxAStarxXx,3271,114,5,3,8,62.5%,8m
10497,3,Junior,3271,148,5,6,11,45.5%,4m
10497,3,ProfessorPhi,3271,122,5,6,11,45.5%,6m
10497,2,MrNeedle,3271,0,4,1,5,80.0%,2h
10497,3,Swift,3271,0,4,1,5,80.0%,38m
10497,3,spook,3271,58,2,2,4,50.0%,31m
10497,3,Bigchunk,3271,0,1,0,1,100.0%,25m
10497,3,YEETMAS,3271,30,1,1,2,50.0%,28m
10497,2,HowAreYou,3271,0,0,1,1,0.0%,2h
10497,3,bzzzzzzzzzzz,3271,0,0,1,1,0.0%,39m
10497,3,[Drakes]SRpugo,3271,0,0,1,1,0.0%,35m
10515,3,Maklatar,3270,963,174,151,325,53.5%,6m
10515,3,[neuroS]GooberJelly,3270,860,64,71,135,47.4%,15m
10515,3,[PTHero]Janpol,3270,983,38,30,68,55.9%,25m
10515,3,RagnaroK,3270,544,20,20,40,50.0%,39m
10515,3,zuLaD,3270,414,17,12,29,58.6%,3m
10515,3,EaZy,3270,464,17,21,38,44.7%,3m
10515,3,BromoSapien,3270,258,13,10,23,56.5%,34m
10515,3,pawel,3270,366,12,18,30,40.0%,14m
10515,3,humbug,3270,154,7,3,10,70.0%,39m
10515,2,[SSEAS]Azobactor,3270,0,4,1,5,80.0%,18m
10515,2,ForTheSwarm,3270,0,4,1,5,80.0%,24m
10515,2,[Mario]ObSy,3270,42,2,0,2,100.0%,26m
10515,3,[One1]ZiNRa,3270,0,1,0,1,100.0%,7m
10515,3,[CD4G]Bastorus,3270,30,1,3,4,25.0%,24m
10529,2,[icon]Galaga,3269,1533,588,602,1190,49.4%,5m
10529,3,Blindogre,3269,1541,159,162,321,49.5%,23m
10529,3,defn,3269,1346,131,127,258,50.8%,42m
10529,3,LingZerg,3269,1441,92,86,178,51.7%,27m
10529,3,[Xth]SpYrOphAgE,3269,1592,90,76,166,54.2%,34m
10529,3,VersE,3269,1213,64,59,123,52.0%,3m
10529,3,[woot]Dshark,3269,874,50,51,101,49.5%,30m
10529,2,DistantDeath,3269,1263,43,53,96,44.8%,8m
10529,3,BeachQueen,3269,1130,42,40,82,51.2%,13m
10529,3,Dart,3269,334,18,12,30,60.0%,22m
10529,3,[Kappæ]ABadAssName,3269,327,16,11,27,59.3%,5m
10529,3,llllllllll,3269,205,10,4,14,71.4%,5m
10529,3,[GOPERÚ]ELGRANn,3269,211,10,5,15,66.7%,11m
10529,3,eScala,3269,208,10,10,20,50.0%,13m
10529,3,leothelion,3269,200,9,4,13,69.2%,16m
10529,3,Ernie,3269,192,8,2,10,80.0%,38m
10529,2,[BERTA]NfinITE,3269,46,5,2,7,71.4%,57m
10529,2,Krex,3269,0,3,1,4,75.0%,9m
10529,3,Broodweiser,3269,0,1,0,1,100.0%,31m
10529,3,Wurk,3269,30,1,2,3,33.3%,36m
10529,3,[cDg]Exhale,3269,0,0,1,1,0.0%,9m
10529,3,YYLM,3269,0,0,2,2,0.0%,22m
10529,1,xXxHyperXssX,3269,0,0,2,2,0.0%,2h
10552,3,Lemoty,3268,1163,166,157,323,51.4%,21m
10552,3,zergzies,3268,996,41,37,78,52.6%,11m
10552,3,tsing,3268,986,39,41,80,48.8%,9m
10552,3,DANKMEMES,3268,607,26,24,50,52.0%,8m
10552,3,iRoNiK,3268,587,22,16,38,57.9%,15m
10552,3,fraffmantis,3268,578,22,27,49,44.9%,4m
10552,3,[Virtus]Myth,3268,392,15,10,25,60.0%,41m
10552,3,surreal,3268,283,13,13,26,50.0%,25m
10552,2,leDaniels,3268,147,7,6,13,53.8%,20m
10552,2,[PHNTMS]Dabthulhu,3268,96,5,1,6,83.3%,16m
10552,3,Abduol,3268,118,4,0,4,100.0%,41m
10552,3,Podge,3268,0,4,2,6,66.7%,29m
10552,3,Clancy,3268,59,4,6,10,40.0%,25m
10552,3,Fussellino,3268,152,3,3,6,50.0%,20m
10552,3,EFlo,3268,62,3,14,17,17.6%,11m
10552,3,System,3268,58,2,3,5,40.0%,21m
10552,3,[OvG]Ares,3268,0,1,2,3,33.3%,16m
10552,3,PublicUnique,3268,0,0,1,1,0.0%,30m
10552,3,[MooSha]regulator,3268,0,0,2,2,0.0%,36m
10571,3,Silence,3267,1436,205,199,404,50.7%,31m
10571,2,thebigzit,3267,1490,169,174,343,49.3%,8m
10571,3,ShardZ,3267,1594,166,160,326,50.9%,15m
10571,3,IlIlllllIIll,3267,1570,128,115,243,52.7%,13m
10571,3,Revmiren,3267,881,66,52,118,55.9%,28m
10571,3,SoWhat,3267,421,28,25,53,52.8%,12m
10571,3,iTsJuStAfLu,3267,481,23,36,59,39.0%,15m
10571,3,Shimane,3267,211,14,10,24,58.3%,40m
10571,3,[DNKCFT]Aerialace,3267,310,12,14,26,46.2%,36m
10571,3,[ZTemps]Jiguz,3267,230,9,8,17,52.9%,19m
10571,3,OppenGita,3267,144,7,3,10,70.0%,28m
10571,3,[WuTang]Thunderstorm,3267,94,3,9,12,25.0%,11m
10571,3,Shadow,3267,60,2,2,4,50.0%,28m
10571,3,[PuStLe]tugfa,3267,30,2,3,5,40.0%,14m
10571,3,Bread,3267,0,1,0,1,100.0%,11m
10571,3,DrewShow,3267,0,1,0,1,100.0%,31m
10571,3,LaidToRest,3267,0,1,2,3,33.3%,18m
10571,1,TuTuBrasil,3267,97,1,2,3,33.3%,29m
10571,3,powerhouse,3267,0,1,4,5,20.0%,30m
10571,3,Wangus,3267,23,1,4,5,20.0%,33m
10571,3,[ConFed]Leshrac,3267,97,1,9,10,10.0%,16m
10571,3,Granddad,3267,0,0,1,1,0.0%,4m
10593,3,[AD3C]kmslaifer,3266,1604,451,426,877,51.4%,41m
10593,3,rolo,3266,1493,129,110,239,54.0%,22m
10593,3,ColBuendia,3266,1565,107,105,212,50.5%,41m
10593,3,BigD,3266,958,87,66,153,56.9%,34m
10593,3,[KGH3]BlackHydra,3266,1260,50,45,95,52.6%,30m
10593,3,[BoRnGo]ACuteSnek,3266,611,37,27,64,57.8%,14m
10593,3,atom,3266,794,31,19,50,62.0%,3m
10593,3,Ckalvin,3266,654,28,22,50,56.0%,36m
10593,3,Voulskin,3266,218,22,16,38,57.9%,18m
10593,3,CanCel,3266,417,18,13,31,58.1%,28m
10593,3,Brill,3266,219,16,14,30,53.3%,20m
10593,3,goffy,3266,326,11,20,31,35.5%,31m
10593,3,StillBye,3266,205,8,4,12,66.7%,8m
10593,3,[VtBoot]DaZerganator,3266,168,6,3,9,66.7%,19m
10593,3,[NPA]Phump,3266,40,5,3,8,62.5%,15m
10593,3,[HØST]MeThOd,3266,94,4,9,13,30.8%,30m
10593,3,roflmfao,3266,122,3,2,5,60.0%,16m
10593,3,[Ruined]GenghisKhan,3266,94,3,11,14,21.4%,18m
10593,3,Toni,3266,30,2,3,5,40.0%,42m
10593,3,kami,3266,60,2,5,7,28.6%,37m
10593,3,SgtRatlaGOD,3266,60,2,12,14,14.3%,39m
10593,3,SSSR,3266,0,1,0,1,100.0%,3m
10593,2,SlowzerK,3266,0,1,0,1,100.0%,31m
10593,3,PWizard,3266,30,1,2,3,33.3%,14m
10593,3,LexLuthor,3266,0,0,1,1,0.0%,25m
10593,3,[scMAUI]mbarde,3266,0,0,1,1,0.0%,4m
10593,3,ALuCARD,3266,0,0,2,2,0.0%,27m
10620,2,[ValidG]Avtar,3265,1557,475,487,962,49.4%,8m
10620,3,waiido,3265,1623,181,188,369,49.1%,28m
10620,3,Khas,3265,830,77,72,149,51.7%,7m
10620,3,Nachdenklich,3265,685,43,35,78,55.1%,5m
10620,3,Spotyus,3265,760,29,24,53,54.7%,14m
10620,3,[JTDPRK]kimilsong,3265,580,21,24,45,46.7%,40m
10620,2,McGyver,3265,644,21,35,56,37.5%,9m
10620,3,Arno,3265,538,20,18,38,52.6%,42m
10620,3,TheBestfOu,3265,198,7,8,15,46.7%,25m
10620,3,ShurimaWaifu,3265,140,6,3,9,66.7%,16m
10620,3,quise,3265,0,1,0,1,100.0%,5m
10620,3,Crystal,3265,0,0,2,2,0.0%,39m
10632,3,KingLing,3264,1642,161,155,316,50.9%,5m
10632,3,[IRP]Salamander,3264,1615,143,138,281,50.9%,3m
10632,3,[OD2019]Horus,3264,395,30,22,52,57.7%,27m
10632,3,[SuperZ]RodeoClown,3264,511,20,15,35,57.1%,25m
10632,3,[NODANE]boofberry,3264,494,18,16,34,52.9%,11m
10632,3,BIDENBOI,3264,257,14,15,29,48.3%,4m
10632,3,pupperoni,3264,295,13,7,20,65.0%,5m
10632,3,lolololol,3264,114,8,5,13,61.5%,42m
10632,3,DoJja,3264,205,6,5,11,54.5%,9m
10632,3,add,3264,0,4,1,5,80.0%,10m
10632,3,Prophetofmem,3264,126,4,10,14,28.6%,40m
10632,3,Ictus,3264,58,3,2,5,60.0%,12m
10632,2,PatatoBRAINS,3264,0,3,2,5,60.0%,16m
10632,3,Gatsby,3264,30,2,1,3,66.7%,3m
10632,3,Andrew,3264,30,2,3,5,40.0%,13m
10632,3,[αB]Mercy,3264,0,1,0,1,100.0%,25m
10632,2,[Macac0]Selxtop,3264,0,1,0,1,100.0%,2h
10632,3,[LQV]starwarex,3264,0,1,2,3,33.3%,30m
10650,3,Andromedus,3263,1538,76,62,138,55.1%,41m
10650,3,DavO,3263,872,64,45,109,58.7%,11m
10650,3,HornySCV,3263,1128,46,39,85,54.1%,24m
10650,3,DontHaselHof,3263,1108,40,46,86,46.5%,30m
10650,3,PBnJ,3263,768,34,17,51,66.7%,24m
10650,3,FilthyOnion,3263,790,32,25,57,56.1%,39m
10650,3,[Riichi]NotoriousBOB,3263,799,32,26,58,55.2%,42m
10650,3,[bands]aznnoob,3263,763,28,34,62,45.2%,2m
10650,1,llllllllllll,3263,144,7,3,10,70.0%,18m
10650,3,[ICBA]Younglin,3263,209,6,4,10,60.0%,2m
10650,3,[PHUDDU]SteelCutOatz,3263,165,5,0,5,100.0%,25m
10650,3,FloridaFox,3263,94,5,1,6,83.3%,39m
10650,3,Historicus,3263,140,5,5,10,50.0%,3m
10650,3,iseebugs,3263,86,4,2,6,66.7%,35m
10650,3,[SYNDCT]AngelofSc,3263,114,4,6,10,40.0%,14m
10650,3,SgtWuddel,3263,122,4,8,12,33.3%,39m
10650,3,mradam,3263,30,2,1,3,66.7%,29m
10650,3,[CaG]ParkSangYul,3263,30,1,1,2,50.0%,36m
10650,3,Omega,3263,30,1,2,3,33.3%,25m
10650,3,possession,3263,0,0,2,2,0.0%,4m
10650,3,Luminox,3263,0,0,2,2,0.0%,26m
10671,3,[zrtard]Victim,3262,794,103,106,209,49.3%,40m
10671,3,Krat,3262,869,97,67,164,59.1%,23m
10671,3,Xanistar,3262,1361,84,81,165,50.9%,30m
10671,3,[TGosuB]Nukemaster,3262,1077,72,50,122,59.0%,4m
10671,3,ThirdEchelon,3262,381,42,33,75,56.0%,4m
10671,3,IlllIIIlllII,3262,962,42,37,79,53.2%,30m
10671,3,LegitPoptart,3262,823,36,21,57,63.2%,13m
10671,3,[QRTINE]XXIIVIII,3262,438,16,15,31,51.6%,18m
10671,3,[VKC]CampiH,3262,334,13,8,21,61.9%,20m
10671,3,[SUNBRA]thatsjustice,3262,178,6,10,16,37.5%,30m
10671,3,Luonidas,3262,90,4,4,8,50.0%,34m
10671,3,[ShB]Blayum,3262,131,3,8,11,27.3%,29m
10671,3,BigWalkDeezy,3262,0,0,1,1,0.0%,4m
10671,3,hoop,3262,0,0,1,1,0.0%,38m
10685,3,TitleTheme,3261,1270,183,167,350,52.3%,19m
10685,3,[ILYSI]AsceNsioN,3261,1449,72,66,138,52.2%,12m
10685,3,[Italis]ttime,3261,979,43,49,92,46.7%,33m
10685,3,Humanyoyo,3261,774,28,35,63,44.4%,8m
10685,3,[RAAS]GoHUnThAr,3261,648,23,22,45,51.1%,8m
10685,3,CubeCow,3261,459,19,6,25,76.0%,39m
10685,3,[SV]Favorecido,3261,516,19,17,36,52.8%,35m
10685,3,Rin,3261,379,16,10,26,61.5%,15m
10685,3,[eX]Toledo,3261,241,15,14,29,51.7%,39m
10685,3,[BEARTM]BearArmed,3261,328,12,14,26,46.2%,27m
10685,3,sointoyou,3261,204,9,3,12,75.0%,21m
10685,3,MarcosM,3261,202,8,5,13,61.5%,27m
10685,3,Manwe,3261,66,7,7,14,50.0%,15m
10685,3,ShriekinGeek,3261,182,7,8,15,46.7%,22m
10685,3,iNguyen,3261,132,4,6,10,40.0%,26m
10685,3,Janice,3261,0,1,0,1,100.0%,31m
10685,3,[NerfZg]Aguero,3261,0,1,0,1,100.0%,41m
10685,3,[TnS]mEioBR,3261,30,1,1,2,50.0%,31m
10685,3,[Stale]Swerve,3261,0,1,1,2,50.0%,4m
10685,3,[BVR]cuts,3261,0,0,1,1,0.0%,14m
10685,3,[ANFA]Derrik,3261,0,0,1,1,0.0%,11m
10685,2,ScrubRandall,3261,0,0,2,2,0.0%,32m
10685,3,Boonartlu,3261,0,0,3,3,0.0%,19m
10685,3,[MIT]flyingtaco,3261,0,0,3,3,0.0%,5m
10709,3,Savage,3260,1602,124,104,228,54.4%,4m
10709,3,[gGgO]SummerZerg,3260,253,32,29,61,52.5%,33m
10709,3,[Macac0]NANDO,3260,597,20,22,42,47.6%,7m
10709,3,swords,3260,386,16,6,22,72.7%,7m
10709,3,Jubub,3260,420,15,17,32,46.9%,37m
10709,3,Eliptic,3260,348,12,10,22,54.5%,25m
10709,3,CoinFlip,3260,215,9,6,15,60.0%,11m
10709,3,[GR33D]Ritho,3260,244,9,7,16,56.2%,36m
10709,3,MrTerribad,3260,202,8,8,16,50.0%,16m
10709,3,Caluber,3260,150,6,1,7,85.7%,9m
10709,3,JamesBond,3260,174,6,7,13,46.2%,14m
10709,3,erel,3260,95,5,1,6,83.3%,40m
10709,3,Unusual,3260,86,3,3,6,50.0%,13m
10709,3,[HQ]Hyerquality,3260,30,2,1,3,66.7%,34m
10709,3,IIIIIIIIIIII,3260,58,2,1,3,66.7%,27m
10709,3,Kaw,3260,97,2,2,4,50.0%,19m
10709,2,WinHouse,3260,0,1,0,1,100.0%,45m
10709,3,[ESCEE]Koi,3260,0,1,0,1,100.0%,24m
10709,3,[glgghf]Illidan,3260,0,1,0,1,100.0%,3m
10709,2,Hocotate,3260,40,1,1,2,50.0%,41m
10709,3,eazyono,3260,5,1,6,7,14.3%,41m
10709,3,PaPaHH,3260,0,0,1,1,0.0%,35m
10731,3,IMSorryManGG,3259,1571,142,129,271,52.4%,29m
10731,3,Bertxi,3259,1343,69,66,135,51.1%,36m
10731,3,Mitch,3259,573,56,48,104,53.8%,4m
10731,3,jimmyrustle,3259,954,53,38,91,58.2%,16m
10731,2,Random,3259,801,42,67,109,38.5%,31m
10731,3,[FLO]BiggestFoot,3259,434,22,21,43,51.2%,28m
10731,3,[WuTang]Hurky,3259,331,17,14,31,54.8%,3m
10731,3,[k2k]Coffee,3259,186,7,12,19,36.8%,18m
10731,3,Mercer,3259,186,7,12,19,36.8%,23m
10731,2,lllIIIlllIII,3259,0,4,1,5,80.0%,2m
10731,3,[Primig]Kvothe,3259,60,2,7,9,22.2%,30m
10731,3,IronZywiec,3259,0,1,0,1,100.0%,22m
10731,3,BrightViSion,3259,0,1,0,1,100.0%,18m
10731,3,[KGC]slyp,3259,0,0,5,5,0.0%,16m
10745,2,grrrrrrrrrrr,3258,1558,179,186,365,49.0%,21m
10745,2,Jim,3258,836,114,125,239,47.7%,25m
10745,3,silentstorm,3258,1591,106,105,211,50.2%,18m
10745,3,[neuroS]Glephnir,3258,1090,99,105,204,48.5%,33m
10745,3,[cl0udM]MrChaCha,3258,1466,86,77,163,52.8%,30m
10745,3,PedoTroll,3258,951,71,65,136,52.2%,32m
10745,3,TheGibbon,3258,1283,62,68,130,47.7%,19m
10745,3,crazycamel,3258,724,43,32,75,57.3%,16m
10745,2,IreBaguette,3258,471,31,60,91,34.1%,8m
10745,3,[Trevon]DLPanda,3258,515,18,15,33,54.5%,16m
10745,3,Sillyfoxy,3258,331,12,13,25,48.0%,37m
10745,3,TovA,3258,304,11,5,16,68.8%,7m
10745,3,brunoleuco,3258,198,11,8,19,57.9%,14m
10745,2,[UAK]DragonLord,3258,291,10,6,16,62.5%,42m
10745,3,[pow0w]ShadowDragon,3258,267,9,6,15,60.0%,41m
10745,3,GaijinSan,3258,0,4,1,5,80.0%,18m
10745,3,seba,3258,88,3,6,9,33.3%,30m
10745,3,[22IQ]Blitzer,3258,0,1,0,1,100.0%,29m
10745,3,[EtrOy]lightwolf,3258,0,1,2,3,33.3%,18m
10745,3,xYz,3258,0,0,1,1,0.0%,22m
10765,3,CallMeHendo,3257,1479,313,302,615,50.9%,12m
10765,3,ProXL,3257,1551,253,253,506,50.0%,21m
10765,3,[LADIES]KidDynamite,3257,1484,141,120,261,54.0%,39m
10765,3,vunconker,3257,906,131,119,250,52.4%,8m
10765,3,DirtySecret,3257,1635,74,71,145,51.0%,4m
10765,3,smokingdoink,3257,726,36,26,62,58.1%,29m
10765,3,[NSTYBO]TurdCutter,3257,417,16,9,25,64.0%,36m
10765,3,[YD2K]winning,3257,336,10,15,25,40.0%,11m
10765,3,smellypickle,3257,316,10,18,28,35.7%,31m
10765,3,Lazlo,3257,241,8,4,12,66.7%,29m
10765,3,PoppaSmurph,3257,112,7,3,10,70.0%,37m
10765,3,[Yoga1]MbaliZulu,3257,93,6,0,6,100.0%,9m
10765,1,HaruHaru,3257,141,6,3,9,66.7%,56m
10765,3,BOBO,3257,30,6,4,10,60.0%,8m
10765,3,[ATLsOs]Aquinas,3257,191,6,7,13,46.2%,19m
10765,3,Adverse,3257,176,6,8,14,42.9%,3m
10765,3,bradosia,3257,88,4,2,6,66.7%,34m
10765,3,[SydTT]CNmarineking,3257,60,3,2,5,60.0%,4m
10765,3,[ValidG]Sleep,3257,30,2,0,2,100.0%,19m
10765,3,[Lp]anakinflor,3257,62,2,15,17,11.8%,24m
10765,3,MtaWrldPc,3257,0,1,0,1,100.0%,42m
10765,3,[HØST]StormShadow,3257,0,0,1,1,0.0%,24m
10765,3,Vanillawho,3257,0,0,1,1,0.0%,33m
10765,3,HipsterPotat,3257,0,0,1,1,0.0%,29m
10789,3,YutreXTron,3256,1484,55,59,114,48.2%,40m
10789,3,Griot,3256,1026,46,40,86,53.5%,36m
10789,3,PrincessKate,3256,603,42,4,46,91.3%,22m
10789,3,Wawa,3256,400,15,14,29,51.7%,37m
10789,3,xboxsignout,3256,280,9,4,13,69.2%,24m
10789,3,UFman,3256,86,8,3,11,72.7%,33m
10789,2,Panic,3256,262,8,6,14,57.1%,41m
10789,3,[TAW]Malco,3256,240,8,13,21,38.1%,8m
10789,3,llllllllllll,3256,58,7,3,10,70.0%,29m
10789,3,SwonkSwoonk,3256,198,7,7,14,50.0%,22m
10789,1,meca,3256,139,3,3,6,50.0%,21m
10789,3,[ZC]Ksuen,3256,0,1,0,1,100.0%,11m
10789,3,Zergivor,3256,0,1,0,1,100.0%,8m
10789,2,Holy,3256,0,1,0,1,100.0%,34m
10789,3,[Baraka]DjDannyTV,3256,0,0,1,1,0.0%,14m
10789,3,Shadow,3256,0,0,1,1,0.0%,9m
10805,3,Irrusive,3255,797,156,136,292,53.4%,37m
10805,3,Deasy,3255,1570,145,141,286,50.7%,27m
10805,3,Klint,3255,1578,127,108,235,54.0%,5m
10805,3,Jepoy,3255,1589,121,102,223,54.3%,38m
10805,3,[peepoC]Cascade,3255,1694,65,59,124,52.4%,9m
10805,3,littlebrubby,3255,1380,63,57,120,52.5%,22m
10805,3,[KING3]greg,3255,1051,39,41,80,48.8%,26m
10805,3,Silentremark,3255,789,33,20,53,62.3%,42m
10805,3,[GREAN]ahamuay,3255,766,29,32,61,47.5%,37m
10805,3,ivSeenBigger,3255,653,28,11,39,71.8%,36m
10805,3,EmbryoBeater,3255,397,15,14,29,51.7%,12m
10805,3,SOCCIA,3255,264,11,16,27,40.7%,27m
10805,3,Serbasian,3255,203,8,11,19,42.1%,31m
10805,3,Led,3255,194,7,7,14,50.0%,38m
10805,3,ElaumofGarth,3255,170,6,13,19,31.6%,28m
10805,3,FoxRooney,3255,30,2,0,2,100.0%,15m
10805,3,[RetroW]Scytale,3255,30,2,1,3,66.7%,31m
10805,3,Feddas,3255,0,1,0,1,100.0%,31m
10805,3,Dozer,3255,0,0,1,1,0.0%,42m
10805,3,NEGATIVEXP,3255,0,0,3,3,0.0%,22m
10825,3,christia,3254,1558,418,382,800,52.2%,8m
10825,3,[LMBD]Lambda,3254,1540,266,274,540,49.3%,25m
10825,3,[LunchZ]Lunchbox,3254,879,155,129,284,54.6%,28m
10825,3,juampi,3254,1544,112,105,217,51.6%,30m
10825,3,[SAS]comeatmebro,3254,479,57,64,121,47.1%,33m
10825,3,[ffaake]SazzyBazzy,3254,342,32,38,70,45.7%,3m
10825,3,Nightmare,3254,274,24,24,48,50.0%,14m
10825,3,Fluidmotion,3254,668,24,29,53,45.3%,42m
10825,3,[pzv]superpants,3254,470,19,10,29,65.5%,38m
10825,3,CrackRocks,3254,506,19,22,41,46.3%,36m
10825,3,SirWhite,3254,431,18,13,31,58.1%,12m
10825,1,Sekkey,3254,328,14,7,21,66.7%,37m
10825,3,bananas,3254,172,6,5,11,54.5%,12m
10825,3,[NPhasA]Massari,3254,150,6,7,13,46.2%,27m
10825,3,[Dchk]Kestal,3254,148,6,10,16,37.5%,29m
10825,2,GoodMorning,3254,95,5,1,6,83.3%,5m
10825,3,shinchan,3254,116,5,8,13,38.5%,19m
10825,2,FruitPeeler,3254,0,4,1,5,80.0%,15m
10825,3,Ernie,3254,58,3,0,3,100.0%,18m
10825,3,[BOR8iz]Alpha,3254,30,2,3,5,40.0%,31m
10825,3,Pichael,3254,60,2,4,6,33.3%,39m
10825,3,StroWilD,3254,0,1,4,5,20.0%,23m
10825,3,[OGbros]weinerdog,3254,0,0,1,1,0.0%,38m
10825,3,[Ottas]AznKing,3254,0,0,1,1,0.0%,14m
10825,3,Slayer,3254,0,0,1,1,0.0%,23m
10825,3,IRateALot,3254,0,0,1,1,0.0%,33m
10825,3,Jimmiefan,3254,0,0,2,2,0.0%,27m
10852,3,[Ex7rA]jin,3253,1439,71,63,134,53.0%,19m
10852,3,Chaos,3253,871,61,66,127,48.0%,19m
10852,3,Perfectsus,3253,530,46,50,96,47.9%,25m
10852,2,GuyInChat,3253,1212,45,58,103,43.7%,27m
10852,3,Frank,3253,1035,44,29,73,60.3%,19m
10852,3,Cixy,3253,834,31,30,61,50.8%,5m
10852,3,Squanch,3253,699,28,19,47,59.6%,30m
10852,3,bub,3253,730,27,27,54,50.0%,33m
10852,3,Serral,3253,610,25,13,38,65.8%,34m
10852,3,oDiNe,3253,508,22,16,38,57.9%,11m
10852,3,[FU2]MrJack,3253,518,20,13,33,60.6%,9m
10852,3,Aiushtha,3253,305,13,13,26,50.0%,22m
10852,3,Smegmma,3253,300,11,6,17,64.7%,27m
10852,3,[GAlNZ]TRUST,3253,336,11,16,27,40.7%,26m
10852,3,PrimeAqasix,3253,165,9,5,14,64.3%,35m
10852,3,[CfnDgr]ceczar,3253,150,9,6,15,60.0%,18m
10852,2,Omnipotent,3253,284,9,24,33,27.3%,17m
10852,3,Numerocat,3253,244,8,22,30,26.7%,31m
10852,3,Matfoxbidule,3253,146,6,4,10,60.0%,39m
10852,3,Cyress,3253,180,6,10,16,37.5%,21m
10852,3,Solarc,3253,158,6,10,16,37.5%,30m
10852,2,[LCE]Miki,3253,96,5,1,6,83.3%,2h
10852,3,[XpKb]WhiteVoid,3253,0,4,1,5,80.0%,25m
10852,1,KinRyu,3253,0,1,0,1,100.0%,2h
10852,3,Floor,3253,0,1,0,1,100.0%,42m
10852,3,nobuild,3253,30,1,1,2,50.0%,24m
10852,3,EuroPanda,3253,0,0,1,1,0.0%,23m
10879,2,Topanaris,3252,1326,226,227,453,49.9%,7m
10879,3,mik,3252,1495,225,208,433,52.0%,41m
10879,3,Simonsaysz,3252,1024,41,33,74,55.4%,22m
10879,3,Ferrinus,3252,652,29,20,49,59.2%,23m
10879,3,Bob,3252,509,29,30,59,49.2%,31m
10879,2,BananaLegs,3252,745,26,45,71,36.6%,19m
10879,3,[xRtGac]DrWidowMine,3252,588,22,23,45,48.9%,4m
10879,3,[6KiNGS]NoGGnoSkill,3252,485,22,25,47,46.8%,18m
10879,3,Drago,3252,381,22,25,47,46.8%,22m
10879,3,Metatron,3252,353,19,17,36,52.8%,33m
10879,3,Pokiki,3252,466,17,19,36,47.2%,39m
10879,3,CrabPulsar,3252,372,14,13,27,51.9%,29m
10879,3,delvur,3252,172,6,10,16,37.5%,25m
10879,3,[IWC]Microstash,3252,0,2,4,6,33.3%,3m
10879,3,[xGenGx]LeRuJ,3252,62,2,6,8,25.0%,31m
10879,3,[UpeV]Garule,3252,0,1,0,1,100.0%,27m
10879,3,gkaasd,3252,0,1,0,1,100.0%,26m
10879,3,NitkiN,3252,30,1,5,6,16.7%,2m
10879,3,DMDyne,3252,0,0,1,1,0.0%,13m
10879,3,[A5]JunLong,3252,0,0,1,1,0.0%,29m
10879,3,fourEyebrows,3252,0,0,1,1,0.0%,27m
10879,3,LDYZnGENTLMN,3252,0,0,1,1,0.0%,38m
10879,3,Xenopsylla,3252,0,0,1,1,0.0%,4m
10879,3,Okta,3252,0,0,1,1,0.0%,3m
10903,3,Genji,3251,1572,121,108,229,52.8%,28m
10903,3,Skynet,3251,887,96,84,180,53.3%,25m
10903,3,Spaz,3251,537,51,45,96,53.1%,3m
10903,3,ThorKen,3251,667,39,37,76,51.3%,4m
10903,3,Chaos,3251,944,36,34,70,51.4%,40m
10903,3,[CNAKER]nacho,3251,472,17,23,40,42.5%,16m
10903,3,Cucaracha,3251,212,12,10,22,54.5%,30m
10903,3,MstrJinbo,3251,240,8,14,22,36.4%,35m
10903,1,Pyro,3251,118,4,4,8,50.0%,2h
10903,3,[zHUNTz]LingLing,3251,58,3,2,5,60.0%,17m
10903,3,[Ainus]smoo,3251,62,3,5,8,37.5%,22m
10903,3,[0ct0]MeatSandwich,3251,30,2,1,3,66.7%,35m
10903,3,Poiskail,3251,60,2,4,6,33.3%,29m
10903,3,[catcat]Aragorn,3251,0,1,0,1,100.0%,17m
10903,3,[Gainss]BonerForest,3251,0,1,0,1,100.0%,38m
10903,3,[sg24]MGChingstah,3251,0,0,1,1,0.0%,36m
10903,3,dotsrcool,3251,0,0,2,2,0.0%,8m
10920,3,DirtyWeasel,3250,1118,106,85,191,55.5%,5m
10920,3,EddieSimeon,3250,1018,99,73,172,57.6%,38m
10920,3,ZeroRequiem,3250,691,81,76,157,51.6%,9m
10920,3,Alexandros,3250,1085,73,71,144,50.7%,18m
10920,3,Cadrigar,3250,1216,53,41,94,56.4%,22m
10920,3,frog,3250,798,30,28,58,51.7%,40m
10920,3,IIIIIIIIIIII,3250,574,19,28,47,40.4%,39m
10920,3,March,3250,479,18,12,30,60.0%,10m
10920,3,[C3PO]Saladrael,3250,371,15,21,36,41.7%,25m
10920,3,calisthenics,3250,366,12,19,31,38.7%,31m
10920,3,[dLife]Odin,3250,126,5,7,12,41.7%,4m
10920,3,[tRP]Sepro,3250,86,3,2,5,60.0%,8m
10920,3,Craving,3250,60,3,3,6,50.0%,37m
10920,3,[NoiZ]TongXinLian,3250,30,2,1,3,66.7%,22m
10920,3,[FMX]Jackblaster,3250,0,1,0,1,100.0%,24m
10920,3,TiltED,3250,0,1,0,1,100.0%,5m
10920,3,Jehee,3250,0,1,5,6,16.7%,26m
10920,3,RobinsonHuso,3250,0,0,1,1,0.0%,22m
10938,3,Klaymo,3249,1324,106,100,206,51.5%,39m
10938,2,Mullin,3249,1464,80,95,175,45.7%,2m
10938,2,[Y3Y3Y3]DroGon,3249,1042,75,80,155,48.4%,20m
10938,3,[MMQ]SpOn,3249,1120,46,51,97,47.4%,16m
10938,3,[YD2K]Blood,3249,342,14,21,35,40.0%,6m
10938,3,GhostZero,3249,248,9,4,13,69.2%,36m
10938,3,Eternal,3249,252,9,16,25,36.0%,36m
10938,3,alberttttttt,3249,172,7,6,13,53.8%,19m
10938,3,Riot,3249,0,5,0,5,100.0%,16m
10938,1,Nagisa,3249,175,4,6,10,40.0%,33m
10938,3,pigernator,3249,58,2,3,5,40.0%,2m
10938,3,OldLady,3249,91,2,3,5,40.0%,19m
10938,3,[Flar3s]LrdCraniaL,3249,30,1,1,2,50.0%,9m
10938,3,Astu,3249,30,1,1,2,50.0%,18m
10938,3,[Di0s]Jhin,3249,0,0,1,1,0.0%,13m
10938,3,[VGL]Mordechi,3249,0,0,4,4,0.0%,16m
10954,3,[VFam]Andrew,3248,1424,148,138,286,51.7%,39m
10954,3,SaintSaucy,3248,1588,97,95,192,50.5%,12m
10954,3,[CRAKS]JULZERG,3248,1087,80,82,162,49.4%,4m
10954,2,[Gakki]ShiroKami,3248,1339,67,79,146,45.9%,32m
10954,3,[LCE]GaToo,3248,836,40,40,80,50.0%,25m
10954,3,nico,3248,1077,39,46,85,45.9%,30m
10954,3,[hTx]microjackson,3248,466,17,20,37,45.9%,42m
10954,3,[Nua]pattaya,3248,394,15,14,29,51.7%,22m
10954,3,Bearhug,3248,320,12,6,18,66.7%,33m
10954,3,[LQV]Socrator,3248,304,12,10,22,54.5%,20m
10954,2,mrGame,3248,253,10,8,18,55.6%,3m
10954,3,MicroJackson,3248,152,6,9,15,40.0%,28m
10954,3,[14U14M]LustHadez,3248,0,4,2,6,66.7%,35m
10954,3,[MACBOI]pexlen,3248,88,4,4,8,50.0%,11m
10954,3,[K0CK]SnowRabbit,3248,96,4,8,12,33.3%,30m
10954,3,Sedca,3248,120,4,16,20,20.0%,11m
10954,3,[MKoB]LongStroke,3248,30,3,3,6,50.0%,35m
10954,3,[Tflaps]Oatzor,3248,86,3,3,6,50.0%,38m
10954,3,[SCVM]Artemis,3248,58,2,1,3,66.7%,37m
10954,3,Quinten,3248,30,2,4,6,33.3%,29m
10954,3,Daehan,3248,0,1,0,1,100.0%,42m
10954,3,IIIIIIIIIII,3248,30,1,2,3,33.3%,22m
10954,3,flaccidlips,3248,0,1,4,5,20.0%,40m
10954,3,[F4GG]Fresco,3248,0,1,4,5,20.0%,25m
10954,3,YoungWyxX,3248,0,0,1,1,0.0%,27m
10954,3,[TMSG]Slickis,3248,0,0,7,7,0.0%,8m
10980,3,wavey,3247,1347,392,354,746,52.5%,22m
10980,3,[cl0udM]Luca,3247,1588,176,153,329,53.5%,5m
10980,3,[BPC]Belligerentr,3247,1412,64,48,112,57.1%,30m
10980,3,[Colrs]Isaac,3247,670,26,19,45,57.8%,22m
10980,3,[jCp]Billiardwolf,3247,528,24,12,36,66.7%,18m
10980,3,[KurWa]StupidMike,3247,478,20,14,34,58.8%,36m
10980,3,arkeus,3247,319,16,8,24,66.7%,38m
10980,3,Shadow,3247,351,15,8,23,65.2%,9m
10980,3,DeHivemind,3247,327,15,11,26,57.7%,28m
10980,3,[PwT]Curupira,3247,312,10,19,29,34.5%,39m
10980,3,AsherBro,3247,114,5,1,6,83.3%,16m
10980,2,[INI]benny,3247,119,5,2,7,71.4%,2h
10980,3,[PMSSS]ComboBreaker,3247,0,4,1,5,80.0%,29m
10980,1,Aiur,3247,0,4,2,6,66.7%,2h
10980,3,Rapsoda,3247,114,4,3,7,57.1%,15m
10980,2,thindodobird,3247,106,3,1,4,75.0%,5m
10980,3,ugilad,3247,60,3,3,6,50.0%,20m
10980,1,Traktorist,3247,96,2,0,2,100.0%,56m
10980,3,[Ar4]Miyeon,3247,58,2,1,3,66.7%,40m
10980,3,[Zohner]DrHapi,3247,0,1,0,1,100.0%,5m
10980,3,Matt,3247,0,1,0,1,100.0%,36m
10980,3,Barcode,3247,30,1,1,2,50.0%,4m
10980,3,[Bxop]ian,3247,30,1,3,4,25.0%,4m
10980,3,MarcosR,3247,0,0,9,9,0.0%,16m
11004,2,Graham,3246,1545,398,391,789,50.4%,8m
11004,3,[HBNC]hbdisfoo,3246,771,47,40,87,54.0%,37m
11004,3,Jeremylin,3246,469,33,22,55,60.0%,42m
11004,3,[TAW]Mstaken,3246,545,29,27,56,51.8%,24m
11004,3,Superman,3246,218,9,5,14,64.3%,37m
11004,3,[EXTC]Arthur,3246,254,9,9,18,50.0%,31m
11004,3,buffzerg,3246,90,4,3,7,57.1%,31m
11004,3,PureWaterA,3246,60,3,1,4,75.0%,30m
11004,3,[BYOD]GWkey,3246,86,3,7,10,30.0%,19m
11004,3,CptPunition,3246,30,2,1,3,66.7%,26m
11004,3,Boonie,3246,60,2,2,4,50.0%,18m
11004,3,[PINGON]pavipollo,3246,60,2,4,6,33.3%,10m
11004,3,HukMKPKIssin,3246,30,2,4,6,33.3%,35m
11004,3,borderlands,3246,58,2,5,7,28.6%,8m
11004,3,FatherDrift,3246,0,1,0,1,100.0%,5m
11004,3,Legato,3246,30,1,2,3,33.3%,8m
11004,1,DepthCharge,3246,0,1,6,7,14.3%,45m
11004,3,[evilo]Titich,3246,38,1,9,10,10.0%,19m
11004,3,CplHicks,3246,0,0,1,1,0.0%,40m
11004,3,[TGCrew]Bendo,3246,0,0,1,1,0.0%,22m
11004,3,PeeWeeSprmin,3246,0,0,2,2,0.0%,20m
11004,2,[saIvo]SomeGuy,3246,0,0,2,2,0.0%,10m
11004,3,CerroAzul,3246,0,0,4,4,0.0%,5m
11027,3,[tay]MooGoo,3245,867,50,60,110,45.5%,30m
11027,3,[cl0udM]shiptor,3245,762,34,19,53,64.2%,8m
11027,3,BIBI,3245,96,17,10,27,63.0%,39m
11027,3,ZergVSAny,3245,308,13,15,28,46.4%,20m
11027,2,TheKeystone,3245,232,9,10,19,47.4%,38m
11027,3,RayByDuhBay,3245,186,7,12,19,36.8%,40m
11027,3,OmeletteLE,3245,111,5,2,7,71.4%,40m
11027,3,llllllllllll,3245,90,4,5,9,44.4%,17m
11027,1,Nemruth,3245,118,2,1,3,66.7%,56m
11027,3,RxBorG,3245,17,2,7,9,22.2%,34m
11027,3,[ElYeet]herroherro,3245,60,2,7,9,22.2%,6m
11027,3,[MkyBnz]Beaker,3245,0,1,0,1,100.0%,22m
11027,3,[GBeans]SummiX,3245,30,1,5,6,16.7%,39m
11027,3,RicharParker,3245,0,0,1,1,0.0%,31m
11027,3,Yzguy,3245,0,0,7,7,0.0%,9m
11042,3,JJeezy,3244,1488,127,123,250,50.8%,12m
11042,2,WIN,3244,971,111,103,214,51.9%,30m
11042,3,[PTHero]NOObius,3244,1397,96,85,181,53.0%,22m
11042,3,Gorpse,3244,1490,91,87,178,51.1%,31m
11042,3,[NOllll]IIIIIIIIIIII,3244,1447,57,50,107,53.3%,15m
11042,3,Dngercarrot,3244,1344,56,47,103,54.4%,22m
11042,3,OldWolf,3244,495,35,44,79,44.3%,24m
11042,3,MasterGuide,3244,480,17,20,37,45.9%,22m
11042,3,DirtySecret,3244,244,8,17,25,32.0%,12m
11042,3,weenuk,3244,116,5,1,6,83.3%,12m
11042,2,IlIlIlIlIlIl,3244,44,2,0,2,100.0%,47m
11042,3,NeedlesKane,3244,58,2,1,3,66.7%,25m
11042,3,[Rocket]Vishalisk,3244,58,2,2,4,50.0%,39m
11042,3,KitcoMeSCBr,3244,0,1,0,1,100.0%,35m
11042,3,Qwel,3244,30,1,3,4,25.0%,23m
11042,3,[VFam]Isosceles,3244,0,0,1,1,0.0%,2m
11042,3,[Macac0]Armisael,3244,0,0,2,2,0.0%,24m
11059,3,[GGMR]MRwhite,3243,1561,196,189,385,50.9%,37m
11059,2,Blue,3243,1434,180,195,375,48.0%,11m
11059,3,[JRT]Nando,3243,1358,113,110,223,50.7%,10m
11059,3,Gravy,3243,883,88,89,177,49.7%,15m
11059,3,SmallFry,3243,1418,78,74,152,51.3%,20m
11059,3,Mike,3243,1449,76,56,132,57.6%,35m
11059,3,TheRats,3243,607,63,51,114,55.3%,4m
11059,3,[JUIN]weechard,3243,1398,52,54,106,49.1%,4m
11059,3,Cox,3243,311,32,26,58,55.2%,38m
11059,3,EVAG,3243,556,22,16,38,57.9%,26m
11059,3,TheJangler,3243,566,21,18,39,53.8%,8m
11059,3,[OHS]Kojol,3243,330,13,12,25,52.0%,19m
11059,3,[HURSES]Bengi,3243,304,12,4,16,75.0%,26m
11059,3,[TeaPI]Mandafaca,3243,106,8,6,14,57.1%,26m
11059,3,ahhhelp,3243,176,7,12,19,36.8%,41m
11059,3,osa,3243,0,4,1,5,80.0%,25m
11059,3,Dendariis,3243,60,3,4,7,42.9%,38m
11059,3,[NlCE]Skokie,3243,30,2,2,4,50.0%,9m
11059,3,SilentSword,3243,58,2,5,7,28.6%,16m
11059,3,DaemonVirus,3243,0,1,0,1,100.0%,39m
11059,1,PanSowa,3243,48,1,2,3,33.3%,2h
11059,3,Wicholmaster,3243,0,1,3,4,25.0%,39m
11059,3,[OnLIOn]Specter,3243,30,1,3,4,25.0%,18m
11059,3,[JaMiT]Overmind,3243,30,1,6,7,14.3%,36m
11059,3,Squiggleyy,3243,0,0,1,1,0.0%,34m
11059,3,[BRWIN]Jurupinga,3243,0,0,1,1,0.0%,31m
11085,3,[ASPGG]ArguedOyster,3242,733,186,170,356,52.2%,4m
11085,3,[Pig2]Utlagi,3242,1575,151,137,288,52.4%,8m
11085,3,MrTadpole,3242,1370,148,155,303,48.8%,8m
11085,3,Herringbone,3242,1593,114,101,215,53.0%,18m
11085,3,JoeGreene,3242,1261,79,73,152,52.0%,30m
11085,3,TurdFurgusen,3242,1213,73,67,140,52.1%,25m
11085,3,[iIoveU]Aphroditeve,3242,1548,66,44,110,60.0%,36m
11085,3,Shroots,3242,908,36,43,79,45.6%,26m
11085,3,Zimtstern,3242,870,35,33,68,51.5%,35m
11085,3,Aoxoct,3242,841,34,32,66,51.5%,31m
11085,3,SecretPoo,3242,674,32,22,54,59.3%,9m
11085,3,dogjlao,3242,742,32,26,58,55.2%,4m
11085,3,[TVV]TWSolar,3242,592,23,22,45,51.1%,4m
11085,3,[PSlSTC]reaper,3242,456,17,15,32,53.1%,31m
11085,3,llIIlIIlIllI,3242,486,17,18,35,48.6%,4m
11085,3,Chris,3242,245,10,7,17,58.8%,35m
11085,3,NewWaves,3242,126,7,1,8,87.5%,4m
11085,3,IllIIIllllII,3242,148,6,11,17,35.3%,31m
11085,3,[LCKY]Lucky,3242,122,5,8,13,38.5%,33m
11085,3,BrolyLG,3242,30,2,1,3,66.7%,25m
11085,3,[lKoDl]Choreza,3242,0,1,0,1,100.0%,35m
11085,3,misterbasic,3242,0,1,0,1,100.0%,41m
11085,3,[ELITZ]Juaquin,3242,30,1,1,2,50.0%,14m
11085,3,rem,3242,0,1,4,5,20.0%,36m
11085,3,[AIN]Mike,3242,0,0,1,1,0.0%,33m
11085,3,[Seinfd]George,3242,0,0,3,3,0.0%,26m
11085,2,[TgAg]ExoYimmY,3242,0,0,5,5,0.0%,32m
11112,3,jasonrich,3241,1515,150,145,295,50.8%,33m
11112,3,ChunkyHugger,3241,1543,144,134,278,51.8%,24m
11112,3,GothicWave,3241,1414,121,105,226,53.5%,41m
11112,3,[BCSz]SilentK,3241,1575,100,91,191,52.4%,16m
11112,3,CeberousMan,3241,1039,60,48,108,55.6%,24m
11112,3,Snb,3241,545,44,23,67,65.7%,29m
11112,3,nOnsa,3241,1000,39,31,70,55.7%,42m
11112,3,[NATI]LambSauce,3241,687,36,32,68,52.9%,9m
11112,3,Yeahr,3241,500,22,17,39,56.4%,11m
11112,3,Finality,3241,422,18,13,31,58.1%,36m
11112,3,Zero,3241,368,14,4,18,77.8%,23m
11112,3,Walruslisk,3241,296,11,11,22,50.0%,35m
11112,3,SmirPio,3241,252,10,10,20,50.0%,4m
11112,3,[FvR]eLim,3241,161,7,1,8,87.5%,37m
11112,2,Boom,3241,0,3,2,5,60.0%,47m
11112,3,[eexp]runemarauder,3241,0,2,3,5,40.0%,36m
11112,3,Waffles,3241,0,1,0,1,100.0%,25m
11112,2,BigPP,3241,0,1,0,1,100.0%,32m
11112,3,Nagios,3241,0,1,0,1,100.0%,35m
11112,3,JayJay,3241,30,1,5,6,16.7%,38m
11112,3,Hades,3241,0,0,1,1,0.0%,32m
11133,2,tmt,3240,1520,589,596,1185,49.7%,12m
11133,3,[9C]FoxySocks,3240,1290,144,144,288,50.0%,40m
11133,3,[GØSU]Ketsu,3240,1619,98,99,197,49.7%,7m
11133,3,TrashPanda,3240,813,57,60,117,48.7%,25m
11133,3,MaximusBlock,3240,1094,40,44,84,47.6%,39m
11133,3,DefundCops,3240,592,25,18,43,58.1%,30m
11133,3,VlaykovBG,3240,420,16,13,29,55.2%,28m
11133,3,poorboy,3240,148,5,8,13,38.5%,10m
11133,3,Magikarp,3240,0,4,1,5,80.0%,34m
11133,1,TePe,3240,48,3,6,9,33.3%,37m
11133,3,Radamantis,3240,58,2,3,5,40.0%,39m
11133,3,[ROYALz]mrjakk,3240,60,2,12,14,14.3%,3m
11133,3,[CGJB]JeanBart,3240,0,1,0,1,100.0%,21m
11133,3,Pajamasftw,3240,30,1,2,3,33.3%,29m
11133,3,avatar,3240,0,0,1,1,0.0%,40m
11133,3,[Tooken]Biscottie,3240,0,0,1,1,0.0%,25m
11149,3,Inka,3239,1589,428,404,832,51.4%,19m
11149,3,CookieTime,3239,1555,141,137,278,50.7%,22m
11149,2,[GWU]Talrane,3239,653,81,93,174,46.6%,27m
11149,3,[GaC]toj,3239,320,15,7,22,68.2%,30m
11149,3,CronJ,3239,428,15,16,31,48.4%,4m
11149,3,BlueSmurf,3239,274,10,17,27,37.0%,21m
11149,3,Cyprezs,3239,176,7,11,18,38.9%,31m
11149,3,lejlot,3239,94,5,1,6,83.3%,19m
11149,3,Keepo,3239,0,4,2,6,66.7%,14m
11149,2,MikuOkazaki,3239,201,4,20,24,16.7%,26m
11149,3,[WHSc]navenitram,3239,88,3,3,6,50.0%,39m
11149,3,[1for2]dtwo,3239,30,2,2,4,50.0%,37m
11149,3,Adapt,3239,30,1,2,3,33.3%,16m
11149,3,Helloladys,3239,0,0,1,1,0.0%,15m
11163,3,Deadbolt,3238,847,467,443,910,51.3%,28m
11163,3,ShootSpeed,3238,1573,160,151,311,51.4%,30m
11163,3,[Svin]Prodigy,3238,860,39,30,69,56.5%,9m
11163,3,Zuv,3238,556,22,17,39,56.4%,28m
11163,3,Auto,3238,479,19,14,33,57.6%,40m
11163,3,Baxtor,3238,368,13,18,31,41.9%,12m
11163,1,Griefed,3238,143,6,3,9,66.7%,8m
11163,3,[Savæge]SirReal,3238,90,3,6,9,33.3%,27m
11163,3,[LgnTDS]Yeti,3238,86,3,8,11,27.3%,19m
11163,3,TheOneRing,3238,30,2,1,3,66.7%,34m
11163,3,pato,3238,0,1,0,1,100.0%,7m
11163,3,shyguy,3238,0,1,0,1,100.0%,36m
11163,3,SpaceJustice,3238,0,1,0,1,100.0%,5m
11163,3,[StS]Sigardius,3238,0,1,0,1,100.0%,4m
11163,3,YAMEROOOOOOO,3238,0,1,0,1,100.0%,37m
11163,3,ToastProtocl,3238,0,1,0,1,100.0%,26m
11163,3,[SV]FErNanDo,3238,0,1,1,2,50.0%,28m
11163,3,Rousetical,3238,0,1,6,7,14.3%,15m
11163,3,[GGDA]Swarm,3238,0,0,1,1,0.0%,30m
11182,3,Misery,3237,592,143,126,269,53.2%,40m
11182,3,ArticCheetah,3237,576,80,59,139,57.6%,36m
11182,3,Crixus,3237,428,70,63,133,52.6%,32m
11182,3,[IVB]Mookie,3237,782,66,52,118,55.9%,30m
11182,3,Arrhythmia,3237,974,56,44,100,56.0%,22m
11182,3,Geezer,3237,941,53,51,104,51.0%,15m
11182,3,Easley,3237,860,38,42,80,47.5%,28m
11182,3,[OvrDsd]MikeU,3237,697,36,22,58,62.1%,42m
11182,3,[OvrDsd]bigdaddy,3237,550,19,26,45,42.2%,15m
11182,3,Sandstorm,3237,294,11,12,23,47.8%,9m
11182,3,Requiem,3237,211,9,4,13,69.2%,9m
11182,3,Hashmeister,3237,197,9,5,14,64.3%,14m
11182,3,Turmoil,3237,289,9,7,16,56.2%,42m
11182,3,SneakyTurtle,3237,160,9,16,25,36.0%,31m
11182,3,[FMO]Cybad,3237,180,8,6,14,57.1%,8m
11182,1,Dougal,3237,208,7,0,7,100.0%,6m
11182,2,carLa,3237,162,5,1,6,83.3%,12m
11182,3,[WLSC]SchachSG,3237,148,5,9,14,35.7%,14m
11182,3,[MPE]Calamardo,3237,62,3,9,12,25.0%,31m
11182,3,Harold,3237,84,3,14,17,17.6%,5m
11182,3,[AD3C]MonsterKreep,3237,30,2,0,2,100.0%,36m
11182,3,[JaMiT]TrinalG,3237,30,2,1,3,66.7%,20m
11182,3,EternallySD,3237,88,2,2,4,50.0%,14m
11182,1,DrNoob,3237,97,2,2,4,50.0%,28m
11182,3,Kipo,3237,0,1,0,1,100.0%,25m
11182,3,[LEATHR]Hideinbush,3237,30,1,1,2,50.0%,22m
11182,3,FUNK,3237,30,1,2,3,33.3%,35m
11182,3,[SRiC]Obsidian,3237,0,0,2,2,0.0%,35m
11182,3,Avocadeado,3237,0,0,2,2,0.0%,38m
11182,3,XXXBlumpkin,3237,0,0,4,4,0.0%,31m
11212,3,xRdyx,3236,1064,101,102,203,49.8%,25m
11212,3,ConquestAce,3236,316,34,28,62,54.8%,5m
11212,3,Squigglo,3236,730,30,23,53,56.6%,7m
11212,3,Panic,3236,382,16,17,33,48.5%,19m
11212,3,Dargon,3236,399,14,11,25,56.0%,42m
11212,3,Moo,3236,349,13,6,19,68.4%,28m
11212,3,shiaonan,3236,329,11,6,17,64.7%,5m
11212,3,danner,3236,250,10,11,21,47.6%,41m
11212,3,Brave,3236,200,8,6,14,57.1%,16m
11212,3,BrodiaQ,3236,139,7,2,9,77.8%,7m
11212,3,fuyifuy,3236,0,4,1,5,80.0%,39m
11212,3,QueenBrenda,3236,90,3,4,7,42.9%,41m
11212,3,[BNATA]Cheelin,3236,0,1,0,1,100.0%,25m
11212,3,Maraboli,3236,30,1,1,2,50.0%,5m
11212,3,[PoSSuM]drewwid,3236,30,1,1,2,50.0%,11m
11212,3,OxdeadcOde,3236,0,0,1,1,0.0%,5m
11212,3,Zhangfei,3236,0,0,3,3,0.0%,25m
11212,3,Davastator,3236,0,0,4,4,0.0%,19m
11230,3,[Mstks]JonaxEiki,3235,1543,310,267,577,53.7%,39m
11230,3,Liefless,3235,1593,217,203,420,51.7%,9m
11230,3,[XpKAc]Stive,3235,1240,140,136,276,50.7%,23m
11230,3,[DETER]Nom,3235,1238,56,55,111,50.5%,26m
11230,3,[HAWD]hulksmash,3235,455,33,28,61,54.1%,5m
11230,3,StinkyLeaf,3235,560,20,16,36,55.6%,30m
11230,3,baduserna,3235,325,13,3,16,81.2%,35m
11230,3,cuBe,3235,302,11,13,24,45.8%,23m
11230,3,quaitom,3235,248,9,8,17,52.9%,38m
11230,3,Morphosis,3235,120,4,7,11,36.4%,12m
11230,3,[DETER]Mirko,3235,58,3,2,5,60.0%,11m
11230,3,[CHEEKS]Efficacy,3235,86,3,8,11,27.3%,28m
11230,3,[Cryptc]Tiger,3235,30,2,1,3,66.7%,5m
11230,3,[cloudM]BennyBoy,3235,58,2,1,3,66.7%,16m
11230,3,[H264]Illusione,3235,58,2,1,3,66.7%,8m
11230,3,RafalexF,3235,58,2,3,5,40.0%,12m
11230,3,[Th3Bad]Ítalo,3235,30,2,3,5,40.0%,27m
11230,3,eZpZ,3235,0,1,0,1,100.0%,35m
11230,2,salty,3235,0,1,0,1,100.0%,60m
11230,3,[YLG]ADR,3235,0,0,1,1,0.0%,40m
11250,3,Red,3234,802,114,116,230,49.6%,31m
11250,3,MKultralisk,3234,949,66,58,124,53.2%,27m
11250,2,Ginger,3234,634,58,60,118,49.2%,15m
11250,3,poltergeist,3234,183,18,25,43,41.9%,19m
11250,3,Ragnarok,3234,336,12,7,19,63.2%,12m
11250,3,[jCp]sTandUhmAn,3234,324,12,14,26,46.2%,36m
11250,3,Megaschnell,3234,240,11,5,16,68.8%,39m
11250,3,Rozoke,3234,234,8,14,22,36.4%,39m
11250,3,[UpxV]Hybrid,3234,210,7,12,19,36.8%,4m
11250,3,DaTooth,3234,146,6,6,12,50.0%,26m
11250,2,Zingy,3234,0,4,1,5,80.0%,55m
11250,3,[UpeV]Sweader,3234,97,2,1,3,66.7%,25m
11250,3,mybad,3234,58,2,2,4,50.0%,11m
11250,3,[NDEAHH]Desperado,3234,0,1,0,1,100.0%,28m
11250,2,Shinch,3234,96,1,1,2,50.0%,3m
11250,3,[Nut69]Ike,3234,0,0,1,1,0.0%,15m
11250,3,skywar,3234,0,0,4,4,0.0%,36m
11267,3,Kamyu,3233,1544,143,141,284,50.4%,31m
11267,3,Akipi,3233,285,35,33,68,51.5%,9m
11267,3,[xTn]Tsunami,3233,262,26,21,47,55.3%,27m
11267,3,[αXLa]CEMAFATHI,3233,728,26,31,57,45.6%,31m
11267,3,cheeseterran,3233,502,17,24,41,41.5%,4m
11267,3,SignumMortis,3233,288,16,6,22,72.7%,31m
11267,3,UrekMazino,3233,439,16,11,27,59.3%,36m
11267,3,ddest,3233,315,13,10,23,56.5%,16m
11267,3,rookywu,3233,301,11,10,21,52.4%,42m
11267,3,ZergLord,3233,237,10,6,16,62.5%,19m
11267,3,[KGC]LvLOneNinja,3233,320,10,14,24,41.7%,36m
11267,3,bigDaddy,3233,206,8,6,14,57.1%,8m
11267,3,CowsGoMoo,3233,237,8,7,15,53.3%,10m
11267,1,Silver,3233,162,7,2,9,77.8%,48m
11267,3,SuperCyan,3233,0,4,1,5,80.0%,25m
11267,3,Ekhor,3233,38,3,2,5,60.0%,3m
11267,3,SidewaySeven,3233,30,1,6,7,14.3%,40m
11267,3,Beeraxxx,3233,0,0,1,1,0.0%,42m
11267,3,Toenails,3233,0,0,1,1,0.0%,34m
11267,3,Finbane,3233,0,0,1,1,0.0%,38m
11267,3,[C43]Ecksor,3233,0,0,1,1,0.0%,37m
11288,3,theandy,3232,1626,293,282,575,51.0%,16m
11288,3,[xLgNx]MushyMigushy,3232,1582,238,233,471,50.5%,16m
11288,3,[B2TF]Lox,3232,1469,142,139,281,50.5%,18m
11288,3,Voltarez,3232,1541,141,138,279,50.5%,15m
11288,3,William,3232,1568,122,121,243,50.2%,26m
11288,3,Verum,3232,931,101,96,197,51.3%,21m
11288,3,ApeGrindeR,3232,725,60,56,116,51.7%,14m
11288,3,XXVariation,3232,576,25,13,38,65.8%,9m
11288,1,[REPORT]Wack,3232,365,14,11,25,56.0%,30m
11288,3,Gold,3232,169,7,4,11,63.6%,35m
11288,3,[PwnSta]Rocco,3232,86,4,1,5,80.0%,26m
11288,1,[JoyofP]BobRoss,3232,145,3,2,5,60.0%,2h
11288,3,BlinkyBill,3232,87,3,3,6,50.0%,7m
11288,1,[RUTG]xSuruga,3232,97,2,1,3,66.7%,28m
11288,3,Jedi,3232,30,2,1,3,66.7%,4m
11288,3,WalrusFangs,3232,60,2,2,4,50.0%,4m
11288,3,KyZer,3232,0,1,1,2,50.0%,24m
11288,3,[COPC]Jizrat,3232,0,1,2,3,33.3%,5m
11288,3,[SOLNEM]SolNemesis,3232,0,0,1,1,0.0%,38m
11288,3,[EADM8]Stevos,3232,0,0,1,1,0.0%,37m
11288,3,NoToastFoU,3232,0,0,1,1,0.0%,38m
11288,3,deffno,3232,0,0,1,1,0.0%,9m
11288,3,sOmErAnDoM,3232,0,0,2,2,0.0%,31m
11311,3,BlackyChan,3231,1479,196,197,393,49.9%,4m
11311,2,Aztk,3231,1490,142,146,288,49.3%,11m
11311,3,Heisenberg,3231,644,65,41,106,61.3%,4m
11311,3,CthulhUwU,3231,892,54,57,111,48.6%,24m
11311,3,VDkF,3231,906,39,28,67,58.2%,14m
11311,3,Neechay,3231,91,16,25,41,39.0%,20m
11311,3,[PTHero]CharactR,3231,284,11,15,26,42.3%,31m
11311,3,joshua,3231,256,9,11,20,45.0%,42m
11311,3,StMichael,3231,230,8,10,18,44.4%,26m
11311,3,Centropyge,3231,192,7,11,18,38.9%,19m
11311,3,[runnn]GenBuboniC,3231,182,5,3,8,62.5%,3m
11311,3,mattfus,3231,146,5,6,11,45.5%,25m
11311,3,Predator,3231,0,4,1,5,80.0%,35m
11311,1,[YD2K]Ark,3231,144,4,6,10,40.0%,18m
11311,3,[NLTN]Innerself,3231,0,1,0,1,100.0%,41m
11311,3,[FCreW]Synoptic,3231,0,1,0,1,100.0%,26m
11311,3,Forestaurora,3231,0,1,0,1,100.0%,24m
11311,3,BrianWobbles,3231,0,1,1,2,50.0%,8m
11311,3,alphonzo,3231,30,1,1,2,50.0%,41m
11311,3,sweethreedog,3231,0,1,4,5,20.0%,31m
11331,3,[xNPGx]Jhandro,3230,1447,165,164,329,50.2%,36m
11331,3,Nom,3230,1520,108,63,171,63.2%,8m
11331,3,KimJongun,3230,1126,55,28,83,66.3%,42m
11331,3,nick,3230,277,51,55,106,48.1%,22m
11331,3,[HODE]xploD,3230,903,39,29,68,57.4%,38m
11331,3,PeterelPanda,3230,821,33,29,62,53.2%,33m
11331,3,Aaronhusssy,3230,743,29,21,50,58.0%,20m
11331,3,awker,3230,113,17,16,33,51.5%,18m
11331,3,Sigmakiavel,3230,470,16,19,35,45.7%,14m
11331,3,[urdone]Andariel,3230,440,15,22,37,40.5%,4m
11331,3,[0825]GTYthomas,3230,294,12,12,24,50.0%,14m
11331,3,mkpo,3230,113,6,2,8,75.0%,29m
11331,3,Stoys,3230,58,2,2,4,50.0%,16m
11331,3,Awol,3230,30,2,4,6,33.3%,4m
11331,3,[FxB]Visser,3230,62,2,7,9,22.2%,39m
11331,3,DarkReaper,3230,0,1,0,1,100.0%,33m
11331,3,Mortalitor,3230,30,1,3,4,25.0%,38m
11331,3,[ROCKSC]TroubleMaker,3230,30,1,5,6,16.7%,42m
11331,2,GrimLock,3230,0,0,1,1,0.0%,45m
11331,3,Neotheriom,3230,0,0,4,4,0.0%,10m
11351,3,Gangstar,3229,1033,70,70,140,50.0%,26m
11351,3,monk,3229,1465,61,58,119,51.3%,8m
11351,3,SixOeufs,3229,1007,42,41,83,50.6%,41m
11351,3,jaydubzsc,3229,659,35,25,60,58.3%,22m
11351,3,KanyeEast,3229,577,25,13,38,65.8%,6m
11351,3,[Sune]Demereo,3229,700,23,37,60,38.3%,18m
11351,3,SisNab,3229,498,20,18,38,52.6%,29m
11351,3,Saito,3229,604,20,32,52,38.5%,21m
11351,3,niki,3229,312,12,17,29,41.4%,37m
11351,3,eschelon,3229,338,11,16,27,40.7%,20m
11351,3,BBAKA,3229,214,10,2,12,83.3%,15m
11351,1,[LZR]Pile,3229,237,8,5,13,61.5%,9m
11351,3,DeDeDeDerp,3229,0,4,1,5,80.0%,15m
11351,3,KillaKang,3229,58,2,6,8,25.0%,11m
11351,3,willyj,3229,30,1,2,3,33.3%,18m
11351,3,MrAlpaca,3229,0,0,1,1,0.0%,27m
11351,3,[BoRnGo]DougieBoy,3229,0,0,6,6,0.0%,39m
11368,3,tuffluck,3228,1351,71,50,121,58.7%,34m
11368,3,mGaHypocrite,3228,746,68,21,89,76.4%,42m
11368,3,LustedSmurf,3228,1242,47,43,90,52.2%,31m
11368,3,DrG,3228,822,33,28,61,54.1%,19m
11368,3,[LifeF]DarkPlayer,3228,276,28,22,50,56.0%,19m
11368,3,Sonoso,3228,602,25,14,39,64.1%,15m
11368,3,[TGOTA]Osaka,3228,361,12,9,21,57.1%,38m
11368,3,Cyondor,3228,216,6,3,9,66.7%,31m
11368,3,RUSHBANSHEE,3228,0,4,1,5,80.0%,37m
11368,3,[66]Binary,3228,88,4,9,13,30.8%,38m
11368,3,DimSum,3228,153,4,10,14,28.6%,4m
11368,3,[SuperZ]Mixnot,3228,30,2,0,2,100.0%,29m
11368,3,[0EEL0]Destiny,3228,58,2,1,3,66.7%,22m
11368,3,LEET,3228,58,2,1,3,66.7%,4m
11368,3,chapa,3228,30,1,2,3,33.3%,3m
11383,3,[DarkAG]Awesomesauce,3227,1052,217,206,423,51.3%,4m
11383,3,PrpaneDreams,3227,1612,159,129,288,55.2%,34m
11383,3,anewplayer,3227,1576,75,57,132,56.8%,3m
11383,3,[BraziI]Baikal,3227,630,46,56,102,45.1%,20m
11383,3,Katanary,3227,922,39,32,71,54.9%,30m
11383,3,ThePhoBros,3227,470,18,19,37,48.6%,37m
11383,3,zilc,3227,351,16,13,29,55.2%,35m
11383,3,[FINDEX]icyCow,3227,170,10,4,14,71.4%,19m
11383,3,Grabgesänge,3227,240,8,3,11,72.7%,33m
11383,3,BLEST,3227,234,8,11,19,42.1%,8m
11383,3,Shazbot,3227,142,6,3,9,66.7%,4m
11383,3,[Wrekrs]Sparky,3227,146,6,6,12,50.0%,33m
11383,3,Jass,3227,148,6,7,13,46.2%,15m
11383,2,Colombo,3227,0,5,0,5,100.0%,2h
11383,3,[YngGng]MarkyMark,3227,184,5,2,7,71.4%,40m
11383,3,Rorak,3227,144,5,3,8,62.5%,3m
11383,1,IIIIIIIIIIII,3227,97,5,3,8,62.5%,2h
11383,3,[PwnCat]MrMcJiggens,3227,0,4,1,5,80.0%,37m
11383,2,Illlllllllll,3227,0,4,1,5,80.0%,31m
11383,3,android,3227,171,4,5,9,44.4%,9m
11383,3,calypso,3227,86,4,6,10,40.0%,22m
11383,2,[TGP2]Kuvin,3227,0,3,2,5,60.0%,2h
11383,3,RaynorsRaid,3227,94,2,4,6,33.3%,42m
11383,3,destroyeric,3227,0,1,0,1,100.0%,25m
11383,3,[Kayoz]BullDestro,3227,30,1,1,2,50.0%,36m
11383,3,[CHAPU]BadDrony,3227,30,1,2,3,33.3%,10m
11383,3,Zwiback,3227,30,1,3,4,25.0%,42m
11383,3,MindWalkerX,3227,0,0,2,2,0.0%,31m
11411,2,Keith,3226,1390,181,156,337,53.7%,19m
11411,3,Anhedonic,3226,1519,102,92,194,52.6%,38m
11411,3,DeepNet,3226,1288,92,70,162,56.8%,21m
11411,3,[KiMBR]TyroneDark,3226,1399,87,89,176,49.4%,20m
11411,3,ICEMAN,3226,1596,82,67,149,55.0%,5m
11411,3,DazKeledia,3226,1449,61,53,114,53.5%,17m
11411,3,homosexaul,3226,1056,43,37,80,53.8%,8m
11411,3,Papprittar,3226,1067,43,38,81,53.1%,19m
11411,2,scumbag,3226,905,38,47,85,44.7%,30m
11411,3,MuDrone,3226,634,31,16,47,66.0%,42m
11411,3,Whomp,3226,870,30,38,68,44.1%,29m
11411,3,soft,3226,558,25,32,57,43.9%,37m
11411,3,SodaWater,3226,584,23,28,51,45.1%,37m
11411,3,[PacheK]thedickdans,3226,588,22,18,40,55.0%,28m
11411,2,Kohinoor,3226,562,19,37,56,33.9%,34m
11411,3,[HPOT]barcode,3226,254,9,8,17,52.9%,39m
11411,3,[Subaru]Nardii,3226,168,7,5,12,58.3%,25m
11411,3,KHAOZ,3226,114,4,8,12,33.3%,13m
11411,3,Gohan,3226,0,2,6,8,25.0%,12m
11411,1,Willkillson,3226,0,1,0,1,100.0%,2h
11411,3,DrGamer,3226,0,1,1,2,50.0%,16m
11411,3,TheFast,3226,30,1,1,2,50.0%,27m
11411,3,Owaka,3226,30,1,4,5,20.0%,28m
11411,3,Amvoh,3226,0,0,1,1,0.0%,25m
11411,3,[proDS]davidmaster,3226,0,0,1,1,0.0%,25m
11436,3,[xRtG]Firewalker,3225,1525,256,239,495,51.7%,8m
11436,3,StriderSeven,3225,1368,56,57,113,49.6%,36m
11436,3,nYm,3225,723,38,28,66,57.6%,15m
11436,3,goblin,3225,658,29,26,55,52.7%,38m
11436,3,luvReynor,3225,557,22,13,35,62.9%,25m
11436,3,Newbie,3225,390,13,20,33,39.4%,37m
11436,3,ABCDEFGHIJKL,3225,288,11,7,18,61.1%,34m
11436,3,vyvienne,3225,240,7,4,11,63.6%,20m
11436,3,Hydrogen,3225,176,7,6,13,53.8%,23m
11436,2,Saimont,3225,0,4,1,5,80.0%,27m
11436,3,IIIIIIII,3225,143,4,2,6,66.7%,21m
11436,3,[Bee]Greeempire,3225,86,4,8,12,33.3%,25m
11436,3,BigIsland,3225,62,3,6,9,33.3%,5m
11436,3,toshy,3225,0,1,0,1,100.0%,31m
11436,3,Tortilla,3225,0,1,0,1,100.0%,8m
11436,3,Newstar,3225,0,1,2,3,33.3%,10m
11436,3,Dunadan,3225,0,0,1,1,0.0%,12m
11453,3,Dehaviours,3224,1581,251,228,479,52.4%,38m
11453,3,noobinater,3224,1328,131,111,242,54.1%,34m
11453,3,jpn,3224,1604,120,108,228,52.6%,14m
11453,2,[LTK]bakla,3224,1189,86,105,191,45.0%,7m
11453,3,Blade,3224,1296,76,72,148,51.4%,36m
11453,3,Frankelton,3224,1275,60,58,118,50.8%,9m
11453,3,[EpicG]Miguel,3224,1113,46,35,81,56.8%,14m
11453,3,[SIClan]morulis,3224,310,34,19,53,64.2%,42m
11453,3,Emselar,3224,689,29,22,51,56.9%,22m
11453,3,Valin,3224,618,24,28,52,46.2%,23m
11453,3,JohnGalt,3224,458,22,18,40,55.0%,41m
11453,2,[UpeV]BrazzerCs,3224,692,20,46,66,30.3%,15m
11453,3,[RathFr]Nick,3224,436,18,17,35,51.4%,26m
11453,3,[Aprica]MaGicTeRRan,3224,212,7,7,14,50.0%,29m
11453,3,laotie,3224,124,4,6,10,40.0%,3m
11453,3,qnzp,3224,30,3,7,10,30.0%,42m
11453,3,KeyBlader,3224,58,2,2,4,50.0%,37m
11453,3,[TaRus]SpeedPlay,3224,105,2,3,5,40.0%,3m
11453,3,[Chizu]Innovaciones,3224,0,1,0,1,100.0%,25m
11453,3,eulerssxD,3224,30,1,1,2,50.0%,4m
11453,3,erbol,3224,30,1,3,4,25.0%,34m
11453,3,BERRISWEET,3224,0,0,1,1,0.0%,38m
11475,3,Robbybats,3223,1615,322,313,635,50.7%,4m
11475,2,LtDanNewLegs,3223,1519,282,286,568,49.6%,30m
11475,2,Chester,3223,1537,186,189,375,49.6%,38m
11475,3,SpiderMonkey,3223,1174,152,127,279,54.5%,14m
11475,3,[neuroW]Greenwyrm,3223,1588,133,123,256,52.0%,24m
11475,3,Moogle,3223,1501,132,112,244,54.1%,36m
11475,3,[HBCHK]BrianAwesome,3223,1583,110,91,201,54.7%,33m
11475,3,XjesseX,3223,1060,65,53,118,55.1%,29m
11475,3,[PreRip]RetinaBurner,3223,681,64,50,114,56.1%,22m
11475,3,RyGuyChiGuy,3223,1350,52,65,117,44.4%,41m
11475,3,Krazzus,3223,1129,51,38,89,57.3%,22m
11475,3,Valkyrie,3223,405,40,41,81,49.4%,25m
11475,3,Gargamel,3223,668,39,40,79,49.4%,15m
11475,3,Yao,3223,821,30,42,72,41.7%,3m
11475,3,[NTPeru]ZoideX,3223,439,16,11,27,59.3%,20m
11475,3,[PsiX]JediStalker,3223,410,16,14,30,53.3%,3m
11475,3,Tailon,3223,446,16,16,32,50.0%,15m
11475,3,Eggiman,3223,316,12,5,17,70.6%,8m
11475,3,Weep,3223,258,10,11,21,47.6%,3m
11475,3,[HØST]DarthSnape,3223,234,9,15,24,37.5%,37m
11475,1,XenoMorphinG,3223,97,5,3,8,62.5%,57m
11475,3,[WNTRLH]Lecherous,3223,0,4,1,5,80.0%,17m
11475,3,Elouan,3223,0,4,1,5,80.0%,15m
11475,3,[ALD]IvanG,3223,118,4,6,10,40.0%,19m
11475,3,Ajax,3223,58,3,0,3,100.0%,19m
11475,1,IIIIIIIIIIIK,3223,48,2,2,4,50.0%,53m
11501,3,LovkiZerg,3222,532,70,60,130,53.8%,37m
11501,3,[BoAVN]Ice,3222,824,58,37,95,61.1%,23m
11501,3,[CS0]Samwise,3222,357,12,9,21,57.1%,14m
11501,3,MacCactus,3222,251,9,5,14,64.3%,15m
11501,3,FrozenIce,3222,264,9,13,22,40.9%,12m
11501,1,Titan,3222,203,7,5,12,58.3%,2h
11501,3,Shadow,3222,210,6,2,8,75.0%,26m
11501,2,[BeSuzy]ARAGONK,3222,234,6,5,11,54.5%,32m
11501,3,RayShades,3222,145,4,6,10,40.0%,26m
11501,3,[WRuniv]STRENTWILL,3222,64,3,7,10,30.0%,3m
11501,3,[Gasai]Yuno,3222,30,2,1,3,66.7%,19m
11501,3,RiceNoodles,3222,48,2,5,7,28.6%,9m
11501,3,[Nag]Josher,3222,0,1,0,1,100.0%,40m
11501,3,[DuKi]Osiris,3222,0,1,2,3,33.3%,25m
11501,3,wAcUoLe,3222,0,1,2,3,33.3%,10m
11501,1,killkillkill,3222,84,1,2,3,33.3%,16m
11501,3,SMKmurk,3222,0,0,1,1,0.0%,33m
11501,3,Finalme,3222,0,0,3,3,0.0%,20m
11501,3,[ZpaceX]KingGuacamol,3222,0,0,3,3,0.0%,20m
11501,3,Shmaga,3222,0,0,3,3,0.0%,35m
11521,3,IcyFather,3221,237,25,8,33,75.8%,31m
11521,3,iZergYou,3221,572,23,17,40,57.5%,42m
11521,3,[BfLaD]DensitY,3221,405,20,11,31,64.5%,34m
11521,3,[aplol]ThirtyDay,3221,319,10,7,17,58.8%,31m
11521,3,Threedster,3221,300,10,14,24,41.7%,34m
11521,3,Kurare,3221,193,10,14,24,41.7%,14m
11521,3,Monastie,3221,94,5,1,6,83.3%,10m
11521,2,Fortunato,3221,0,4,1,5,80.0%,21m
11521,3,[MCSC]KingMike,3221,0,1,1,2,50.0%,10m
11521,3,[UIE]Lockdown,3221,30,1,9,10,10.0%,36m
11521,3,Mistaclean,3221,0,0,1,1,0.0%,22m
11521,3,[Xpk]mxpandrax,3221,0,0,1,1,0.0%,30m
11533,3,Legion,3220,1441,105,106,211,49.8%,39m
11533,3,Harry,3220,1331,75,64,139,54.0%,7m
11533,3,ChapSlop,3220,733,38,24,62,61.3%,17m
11533,3,dead,3220,682,30,21,51,58.8%,20m
11533,3,Ashugo,3220,365,26,26,52,50.0%,18m
11533,3,ErlantZ,3220,588,20,23,43,46.5%,29m
11533,3,[XBLP]Nightsback,3220,436,18,11,29,62.1%,39m
11533,3,Throwback,3220,367,16,12,28,57.1%,29m
11533,3,StackDuckets,3220,252,12,6,18,66.7%,17m
11533,3,WaffleCouch,3220,310,12,20,32,37.5%,35m
11533,3,MiniNinja,3220,206,9,8,17,52.9%,5m
11533,3,Mindtaker,3220,186,8,5,13,61.5%,30m
11533,3,IlIlIlIlIlIl,3220,134,6,3,9,66.7%,9m
11533,3,iStock,3220,198,6,18,24,25.0%,22m
11533,3,[vNc]Redsus,3220,114,5,1,6,83.3%,31m
11533,3,Howland,3220,0,4,1,5,80.0%,5m
11533,3,Plubz,3220,126,4,15,19,21.1%,23m
11533,3,Crlspy,3220,0,3,2,5,60.0%,22m
11533,3,[Bipin]Varmina,3220,58,3,6,9,33.3%,26m
11533,3,whynot,3220,30,2,0,2,100.0%,10m
11533,3,[ZWars]Tta,3220,118,2,2,4,50.0%,39m
11533,3,FunnyUndies,3220,62,2,7,9,22.2%,9m
11533,3,PoCkEtS,3220,0,1,0,1,100.0%,40m
11533,3,[micro]SUNG,3220,30,1,1,2,50.0%,6m
11533,3,Jazzyjay,3220,0,0,1,1,0.0%,20m
11533,3,[FyHr]Raúl,3220,0,0,8,8,0.0%,22m
11559,3,kurt,3219,1263,207,190,397,52.1%,24m
11559,3,Reptar,3219,757,91,91,182,50.0%,30m
11559,2,[DhZPro]MevaUm,3219,241,11,6,17,64.7%,11m
11559,3,freya,3219,209,6,3,9,66.7%,9m
11559,3,Falz,3219,108,6,6,12,50.0%,19m
11559,3,Tastybiscuit,3219,60,2,3,5,40.0%,23m
11559,3,[iMECH]KolosS,3219,0,1,2,3,33.3%,7m
11559,3,thuNder,3219,30,1,2,3,33.3%,20m
11559,3,JDConan,3219,0,1,2,3,33.3%,15m
11559,3,max,3219,0,0,1,1,0.0%,24m
11559,3,[AIlin]Ballod,3219,0,0,1,1,0.0%,34m
11559,2,Noise,3219,0,0,1,1,0.0%,37m
11559,3,Venuzord,3219,0,0,2,2,0.0%,39m
11559,2,TYTY,3219,0,0,2,2,0.0%,41m
11573,3,[DhZAc1]TheMarine,3218,1631,388,369,757,51.3%,33m
11573,3,CompanyII,3218,1643,198,174,372,53.2%,36m
11573,3,BiOZeRg,3218,846,35,33,68,51.5%,22m
11573,3,Matheo,3218,555,24,16,40,60.0%,40m
11573,3,[tired]Winter,3218,259,9,2,11,81.8%,42m
11573,1,[xEZx]Fecalfeast,3218,155,8,3,11,72.7%,31m
11573,3,[HDYW]RandAlThor,3218,191,6,5,11,54.5%,26m
11573,3,[LES]Padierfind,3218,0,4,1,5,80.0%,33m
11573,3,[TGosuD]ChaOtic,3218,60,3,4,7,42.9%,23m
11573,1,Plott,3218,119,2,2,4,50.0%,2h
11573,3,TexasTuxedo,3218,0,1,1,2,50.0%,36m
11573,3,[Foosed]ZeusBruce,3218,30,1,2,3,33.3%,19m
11573,3,Nemesis,3218,30,1,2,3,33.3%,14m
11573,3,GenericGoat,3218,30,1,2,3,33.3%,15m
11573,3,[BTSbr]Chicarelli,3218,30,1,3,4,25.0%,37m
11573,3,[LimaSC]TBDayMasacre,3218,0,0,1,1,0.0%,31m
11573,3,Kerrigun,3218,0,0,1,1,0.0%,40m
11573,3,ButterSkates,3218,0,0,1,1,0.0%,8m
11591,3,Lettuce,3217,1573,302,279,581,52.0%,40m
11591,3,revamp,3217,1571,235,235,470,50.0%,34m
11591,3,[YD2K]TheMIHM,3217,1288,65,53,118,55.1%,3m
11591,2,[PGTLGL]Pochi,3217,1386,54,64,118,45.8%,3m
11591,3,juzamjon,3217,623,47,35,82,57.3%,25m
11591,3,Deathkillerz,3217,578,23,19,42,54.8%,38m
11591,3,[YD2K]oldschool,3217,458,21,12,33,63.6%,17m
11591,3,Eidolon,3217,530,20,25,45,44.4%,31m
11591,3,Random,3217,343,15,3,18,83.3%,3m
11591,3,[SYF]ZerekOner,3217,249,10,7,17,58.8%,35m
11591,3,JimBoogie,3217,284,9,4,13,69.2%,26m
11591,3,[SFP]GroundZero,3217,252,9,15,24,37.5%,25m
11591,3,[Xtre]Skailen,3217,216,8,1,9,88.9%,37m
11591,3,Royal,3217,170,8,7,15,53.3%,41m
11591,3,therialumon,3217,48,6,3,9,66.7%,14m
11591,3,[SKGP]XCore,3217,169,5,2,7,71.4%,15m
11591,3,Dacklol,3217,74,4,1,5,80.0%,38m
11591,3,[PNboyz]PiNNacleDMG,3217,86,4,6,10,40.0%,25m
11591,3,ChiLeNo,3217,90,3,5,8,37.5%,30m
11591,3,[WNTRLY]DeadCenter,3217,60,3,6,9,33.3%,41m
11591,1,EyeHoles,3217,119,2,2,4,50.0%,3h
11591,3,DaPorpoise,3217,30,1,1,2,50.0%,4m
11591,3,Reptail,3217,30,1,2,3,33.3%,22m
11591,3,[ToonFy]HowL,3217,30,1,2,3,33.3%,8m
11591,3,IlIllllIII,3217,30,1,3,4,25.0%,15m
11591,2,TacoBell,3217,40,1,3,4,25.0%,26m
11591,3,[AtoSis]cyberoptix,3217,0,1,4,5,20.0%,38m
11591,3,snow,3217,0,0,1,1,0.0%,15m
11591,3,MERINOXD,3217,0,0,1,1,0.0%,26m
11591,3,[NwAs]Gonzalo,3217,0,0,2,2,0.0%,14m
11621,3,jack,3216,1437,306,286,592,51.7%,42m
11621,3,[KiTeam]DjRew,3216,1149,163,164,327,49.8%,40m
11621,3,sorocknroll,3216,1543,138,139,277,49.8%,19m
11621,3,MeowMaster,3216,1111,51,42,93,54.8%,41m
11621,2,[SsaYnS]Kujuddify,3216,651,47,60,107,43.9%,16m
11621,3,commanderh,3216,766,32,28,60,53.3%,34m
11621,3,[SLATT]bignastybert,3216,617,26,16,42,61.9%,34m
11621,3,[Possay]Grossemolle,3216,223,20,30,50,40.0%,33m
11621,3,aners,3216,215,12,9,21,57.1%,12m
11621,3,Classic,3216,320,12,13,25,48.0%,37m
11621,3,KingBobVII,3216,272,11,9,20,55.0%,31m
11621,3,Hugbleem,3216,248,10,12,22,45.5%,8m
11621,3,ZerglingMan,3216,281,8,10,18,44.4%,9m
11621,3,[MooLA]MaGic,3216,254,7,10,17,41.2%,8m
11621,3,InDIGo,3216,170,6,4,10,60.0%,42m
11621,3,Kinnslayor,3216,150,6,6,12,50.0%,22m
11621,3,Leo,3216,107,5,2,7,71.4%,8m
11621,3,wolverine,3216,30,5,3,8,62.5%,26m
11621,3,WillyBombBay,3216,140,5,4,9,55.6%,26m
11621,3,megazord,3216,116,5,4,9,55.6%,20m
11621,3,Shawry,3216,126,5,7,12,41.7%,31m
11621,1,Shademinion,3216,96,2,1,3,66.7%,53m
11621,2,Donkey,3216,93,2,4,6,33.3%,2h
11621,3,Mint,3216,30,1,5,6,16.7%,42m
11621,3,Sunevztlow,3216,0,0,1,1,0.0%,23m
11646,3,ScubaSteve,3215,976,83,42,125,66.4%,9m
11646,3,Jeuce,3215,851,53,29,82,64.6%,36m
11646,3,Boubz,3215,861,53,62,115,46.1%,25m
11646,3,HotTamal,3215,839,39,23,62,62.9%,31m
11646,3,Prodigy,3215,781,33,26,59,55.9%,4m
11646,3,PaRTeaLMaS,3215,822,32,32,64,50.0%,12m
11646,3,Spartanpoet,3215,483,29,22,51,56.9%,18m
11646,3,Sterth,3215,408,21,20,41,51.2%,20m
11646,3,Phoenix,3215,318,12,14,26,46.2%,36m
11646,3,AncientBrain,3215,308,11,4,15,73.3%,39m
11646,3,Kilgrow,3215,285,9,6,15,60.0%,40m
11646,3,llllllllllll,3215,164,5,0,5,100.0%,3m
11646,3,djcg,3215,142,5,7,12,41.7%,11m
11646,2,Meatballz,3215,0,4,1,5,80.0%,2h
11646,3,Heart,3215,0,4,1,5,80.0%,38m
11646,3,Enigma,3215,167,4,2,6,66.7%,29m
11646,3,[ZDE20]ShaneLiang,3215,0,1,5,6,16.7%,20m
11646,3,[TiWo]Ellipsis,3215,0,0,1,1,0.0%,4m
11646,3,daBromartian,3215,0,0,1,1,0.0%,3m
11646,3,RedHaro,3215,0,0,1,1,0.0%,10m
11646,3,Giddy,3215,0,0,2,2,0.0%,22m
11646,3,TheBrokenOne,3215,0,0,5,5,0.0%,30m
11668,3,squid,3214,1547,261,243,504,51.8%,41m
11668,3,Oldeegreeegg,3214,835,128,116,244,52.5%,12m
11668,3,DomnGG,3214,1120,101,70,171,59.1%,22m
11668,3,jpence,3214,1395,71,61,132,53.8%,29m
11668,3,HomeWorlds,3214,806,49,41,90,54.4%,5m
11668,3,BUGLIFE,3214,537,30,26,56,53.6%,25m
11668,3,[iHCE]nova,3214,249,21,18,39,53.8%,14m
11668,3,[neuroS]Carnifex,3214,523,21,26,47,44.7%,8m
11668,3,[DKM]Barick,3214,288,14,11,25,56.0%,15m
11668,3,GareBear,3214,372,13,15,28,46.4%,8m
11668,3,Ardin,3214,272,10,6,16,62.5%,37m
11668,3,Antipants,3214,294,10,18,28,35.7%,3m
11668,3,Ditcha,3214,115,6,2,8,75.0%,39m
11668,3,[IAku]Squiggly,3214,36,3,7,10,30.0%,23m
11668,3,EGrackulate,3214,123,2,5,7,28.6%,34m
11668,3,Nikky,3214,0,1,0,1,100.0%,42m
11668,3,[Æsir]HeiMDaLL,3214,30,1,2,3,33.3%,12m
11668,2,DukeSilver,3214,0,1,4,5,20.0%,3h
11668,3,[GØSU]bobthunicorn,3214,0,0,1,1,0.0%,22m
11687,3,SwarmStorm,3213,1570,407,376,783,52.0%,4m
11687,3,DAF,3213,1571,400,379,779,51.3%,6m
11687,3,MastrOfOrion,3213,1361,139,136,275,50.5%,38m
11687,3,Necio,3213,796,51,49,100,51.0%,15m
11687,3,[500CC]Natum,3213,894,40,28,68,58.8%,17m
11687,3,[CDAL]LeoCoelho,3213,912,39,27,66,59.1%,39m
11687,3,SaltyCrapBag,3213,929,36,32,68,52.9%,14m
11687,3,[JaMiT]Greenknight,3213,792,27,36,63,42.9%,19m
11687,3,Qikaiyao,3213,584,19,29,48,39.6%,26m
11687,3,[IMDSI]Mojyo,3213,296,9,7,16,56.2%,16m
11687,3,krcknbrg,3213,136,4,2,6,66.7%,40m
11687,3,[GGBr0]ACNS,3213,90,3,4,7,42.9%,14m
11687,3,[notCo]Yaddle,3213,30,2,2,4,50.0%,42m
11687,2,gameboy,3213,0,1,0,1,100.0%,2h
11687,3,[TB303]inFOCUS,3213,0,0,1,1,0.0%,31m
11687,3,LeTrollSam,3213,0,0,1,1,0.0%,42m
11687,3,SnesleyWipes,3213,0,0,1,1,0.0%,23m
11704,3,SimpleJack,3212,798,61,31,92,66.3%,22m
11704,3,Bowen,3212,1356,58,50,108,53.7%,21m
11704,3,Srgsickdog,3212,1401,54,57,111,48.6%,41m
11704,3,wbckulty,3212,530,24,15,39,61.5%,37m
11704,3,JGRABES,3212,608,23,20,43,53.5%,34m
11704,3,Deylinia,3212,471,20,14,34,58.8%,4m
11704,3,Drake,3212,267,9,7,16,56.2%,22m
11704,1,nvision,3212,161,7,3,10,70.0%,22m
11704,3,[DGNBFT]ThorsWrath,3212,146,5,8,13,38.5%,39m
11704,3,[TMKOs]CauseoKoF,3212,116,4,4,8,50.0%,8m
11704,3,[Cind3r]Amotokai,3212,58,3,1,4,75.0%,4m
11704,3,Intangible,3212,86,3,2,5,60.0%,27m
11704,3,[TGosuB]Darkbutdie,3212,58,3,6,9,33.3%,32m
11704,3,[Young]Savage,3212,0,1,0,1,100.0%,39m
11704,3,[TeriS]rollinondubs,3212,30,1,9,10,10.0%,42m
11704,3,Legato,3212,0,0,2,2,0.0%,25m
11704,3,Lanz,3212,0,0,2,2,0.0%,22m
11721,1,[iCz]AsFBrolly,3211,564,255,260,515,49.5%,30m
11721,3,Jumpy,3211,1625,214,190,404,53.0%,40m
11721,3,speedyss,3211,1408,148,150,298,49.7%,10m
11721,3,CptRelish,3211,1276,49,47,96,51.0%,25m
11721,3,Altecman,3211,703,38,30,68,55.9%,26m
11721,3,schmeat,3211,683,38,35,73,52.1%,26m
11721,3,PnP,3211,679,25,27,52,48.1%,37m
11721,3,Jeramaya,3211,548,21,27,48,43.8%,40m
11721,3,razE,3211,346,15,9,24,62.5%,13m
11721,3,IceDart,3211,280,12,10,22,54.5%,40m
11721,3,Guru,3211,131,7,2,9,77.8%,9m
11721,3,[FkJeff]Lynwert,3211,152,6,9,15,40.0%,14m
11721,3,[DHZAcD]Xayide,3211,186,6,14,20,30.0%,39m
11721,3,OnEWiPe,3211,155,5,10,15,33.3%,26m
11721,3,[Maat]TheOther,3211,86,3,2,5,60.0%,19m
11721,3,[Ex0n]NetBio,3211,60,3,3,6,50.0%,36m
11721,3,[JAZ]SKIKS,3211,30,1,2,3,33.3%,30m
11721,3,ink,3211,30,1,10,11,9.1%,15m
11721,3,[PJz]Lucifarious,3211,0,0,1,1,0.0%,42m
11740,3,Brenda,3210,770,117,115,232,50.4%,37m
11740,3,IIIlllllIlIl,3210,776,100,91,191,52.4%,22m
11740,3,Axyl,3210,1120,52,34,86,60.5%,39m
11740,3,HBK,3210,582,33,30,63,52.4%,41m
11740,3,StishFicks,3210,653,28,28,56,50.0%,19m
11740,3,BobGraham,3210,556,22,18,40,55.0%,31m
11740,3,PelicanWhomp,3210,271,10,2,12,83.3%,12m
11740,3,Zergling,3210,196,7,3,10,70.0%,30m
11740,3,EastSea,3210,151,7,3,10,70.0%,37m
11740,3,[Despi]Oxymoron,3210,207,7,7,14,50.0%,42m
11740,3,[UofA]HyperBolic,3210,148,6,8,14,42.9%,36m
11740,1,RGDFO,3210,145,5,6,11,45.5%,37m
11740,3,Face,3210,129,2,4,6,33.3%,16m
11740,3,Pekorekt,3210,60,2,5,7,28.6%,9m
11740,2,DarkFate,3210,0,1,0,1,100.0%,28m
11740,3,TmG,3210,0,1,0,1,100.0%,8m
11740,3,Xecuter,3210,30,1,2,3,33.3%,25m
11740,3,Ghost,3210,0,0,1,1,0.0%,17m
11740,2,[UpeV]AfterHours,3210,0,0,1,1,0.0%,29m
11740,3,Tangy,3210,0,0,1,1,0.0%,25m
11740,3,skrtskrrrrt,3210,0,0,1,1,0.0%,16m
11761,3,NeO,3209,1499,128,128,256,50.0%,27m
11761,3,chatoulle,3209,756,51,38,89,57.3%,21m
11761,3,diopet,3209,836,39,24,63,61.9%,14m
11761,3,ateus,3209,404,39,31,70,55.7%,38m
11761,3,Derpo,3209,524,37,24,61,60.7%,40m
11761,3,WingDangFu,3209,371,13,8,21,61.9%,42m
11761,3,[DRKESP]Bas,3209,340,13,21,34,38.2%,20m
11761,3,IIIIIIIIIIII,3209,206,11,8,19,57.9%,40m
11761,3,GeneralJefe,3209,302,11,14,25,44.0%,12m
11761,3,[SHART]SHARTYPANTS,3209,259,9,4,13,69.2%,35m
11761,3,sanguine,3209,232,9,9,18,50.0%,25m
11761,1,ChandlerYan,3209,167,8,3,11,72.7%,2h
11761,3,Persona,3209,249,8,4,12,66.7%,15m
11761,1,[IPOI3]ImDewey,3209,118,4,3,7,57.1%,49m
11761,3,[eX]KillerBR,3209,118,4,12,16,25.0%,31m
11761,3,Professional,3209,90,3,4,7,42.9%,25m
11761,3,[DarkAG]Pentor,3209,58,2,1,3,66.7%,34m
11761,3,Realphil,3209,60,2,3,5,40.0%,37m
11761,3,StukovStevo,3209,0,1,0,1,100.0%,8m
11761,3,Aadlez,3209,0,0,1,1,0.0%,10m
11761,3,Ahmayzhing,3209,0,0,2,2,0.0%,7m
11782,3,AznPak,3208,1629,254,247,501,50.7%,18m
11782,3,[AOTDF]alain,3208,1374,78,71,149,52.3%,5m
11782,3,Senpai,3208,888,66,49,115,57.4%,30m
11782,3,DontCheese,3208,741,32,22,54,59.3%,7m
11782,3,[DANATE]QKachoo,3208,501,21,17,38,55.3%,23m
11782,3,Chen,3208,495,19,16,35,54.3%,5m
11782,3,stepie,3208,406,17,13,30,56.7%,38m
11782,3,smallPP,3208,202,7,8,15,46.7%,9m
11782,3,DaSupervisor,3208,30,6,4,10,60.0%,3m
11782,3,DueSs,3208,90,4,7,11,36.4%,31m
11782,3,Skad,3208,114,4,7,11,36.4%,25m
11782,3,TrapCardLife,3208,60,3,1,4,75.0%,19m
11782,3,riipper,3208,58,2,2,4,50.0%,20m
11782,3,panda,3208,0,1,1,2,50.0%,34m
11782,3,[NOCULO]Flahss,3208,0,0,1,1,0.0%,27m
11782,3,[Flar3s]Psionic,3208,0,0,2,2,0.0%,33m
11798,2,[BALLS]Cynicusme,3207,1549,509,495,1004,50.7%,22m
11798,3,[UpxV]MiGueL,3207,1604,179,164,343,52.2%,22m
11798,3,[cl0udM]BeefSupreme,3207,1197,107,91,198,54.0%,19m
11798,3,Devourer,3207,1476,86,69,155,55.5%,4m
11798,3,[SCTF]Yijie,3207,466,73,58,131,55.7%,39m
11798,3,CCAdv,3207,1350,56,44,100,56.0%,10m
11798,3,cheeseman,3207,360,41,30,71,57.7%,22m
11798,3,Puppy,3207,572,24,24,48,50.0%,29m
11798,3,Arostegui,3207,373,17,4,21,81.0%,6m
11798,3,[2TETON]MySteez,3207,327,17,16,33,51.5%,40m
11798,1,jonry,3207,312,13,11,24,54.2%,8m
11798,3,VinlingSaga,3207,148,11,4,15,73.3%,37m
11798,3,isdifil,3207,199,10,6,16,62.5%,8m
11798,1,Aryis,3207,166,8,4,12,66.7%,26m
11798,3,Paradox,3207,204,8,6,14,57.1%,18m
11798,3,[PTZop]Gebirgsflak,3207,92,5,0,5,100.0%,33m
11798,3,[REPORT]Bloodbath,3207,118,5,9,14,35.7%,8m
11798,3,skretsch,3207,0,4,1,5,80.0%,2h
11798,3,OZOZozozzzZZ,3207,86,4,5,9,44.4%,17m
11798,3,CompasionTdT,3207,73,4,5,9,44.4%,40m
11798,3,KingNothing,3207,88,4,11,15,26.7%,4m
11798,3,[Zulu]King,3207,30,2,0,2,100.0%,5m
11798,3,DarkTemplar,3207,30,1,1,2,50.0%,9m
11798,3,DAVIS,3207,0,1,1,2,50.0%,3m
11798,3,[ExceI]SPYDER,3207,0,1,5,6,16.7%,8m
11798,2,Ethan,3207,0,0,1,1,0.0%,2h
11798,3,blululululu,3207,0,0,2,2,0.0%,26m
11798,3,[DHE]infestedMous,3207,0,0,2,2,0.0%,26m
11798,3,[RIPOU]Matroide,3207,0,0,3,3,0.0%,8m
11827,3,[MadK]heymikey,3206,1535,256,233,489,52.4%,36m
11827,3,Drdumais,3206,1514,243,213,456,53.3%,8m
11827,3,Entropy,3206,1581,163,139,302,54.0%,17m
11827,3,TaeKwonDOH,3206,1209,127,125,252,50.4%,33m
11827,3,[SFx]Iporazzam,3206,515,123,130,253,48.6%,30m
11827,3,YESS,3206,1551,111,106,217,51.2%,42m
11827,3,GrandpaJoe,3206,1514,87,64,151,57.6%,25m
11827,3,AlmondMilk,3206,854,78,92,170,45.9%,37m
11827,3,Jerian,3206,1544,73,67,140,52.1%,8m
11827,3,Ace,3206,1086,40,43,83,48.2%,15m
11827,3,[LgnTDS]Loke,3206,866,33,41,74,44.6%,33m
11827,3,Zenvoid,3206,247,10,6,16,62.5%,5m
11827,3,Eco,3206,220,8,7,15,53.3%,19m
11827,3,Cobrafour,3206,148,5,8,13,38.5%,25m
11827,3,[XHB]SSB,3206,0,4,1,5,80.0%,15m
11827,3,Max,3206,145,4,1,5,80.0%,16m
11827,3,AllTran,3206,58,3,3,6,50.0%,4m
11827,3,PhoenixSD,3206,0,1,1,2,50.0%,39m
11827,2,[sk3tch]Music,3206,0,0,1,1,0.0%,15m
11827,3,CizCO,3206,0,0,1,1,0.0%,39m
11827,3,[fagz]HarstemPupil,3206,0,0,1,1,0.0%,40m
11827,3,LGIMMVP,3206,0,0,2,2,0.0%,42m
11849,3,BudgetSteak,3205,1436,54,55,109,49.5%,31m
11849,3,Breeze,3205,791,49,42,91,53.8%,10m
11849,3,hitch,3205,841,36,34,70,51.4%,38m
11849,3,BlueSol,3205,559,32,22,54,59.3%,26m
11849,3,[KGH]smoOthster,3205,666,26,26,52,50.0%,42m
11849,3,Twiggy,3205,284,11,10,21,52.4%,19m
11849,3,Horbehutet,3205,244,9,16,25,36.0%,40m
11849,1,Pewber,3205,164,7,3,10,70.0%,2h
11849,3,PlinPlinPlon,3205,0,3,2,5,60.0%,33m
11849,3,IIIIIIIIIIII,3205,0,1,5,6,16.7%,31m
11849,3,Sieg,3205,0,0,4,4,0.0%,8m
11849,3,kommandoh,3205,0,0,6,6,0.0%,28m
11861,3,spatiager,3204,953,114,88,202,56.4%,9m
11861,3,[UpxV]HarDan,3204,1559,99,84,183,54.1%,22m
11861,3,Scaomin,3204,1587,72,68,140,51.4%,26m
11861,3,[Erbe]Unclerod,3204,1438,55,51,106,51.9%,24m
11861,3,TamBerry,3204,1089,48,36,84,57.1%,10m
11861,3,[TlLT]gollahon,3204,782,30,28,58,51.7%,21m
11861,3,[SLOP]Dangermouse,3204,203,8,6,14,57.1%,33m
11861,1,Icebreaker,3204,120,6,4,10,60.0%,33m
11861,3,Insomnia,3204,30,5,2,7,71.4%,4m
11861,3,glhf,3204,112,5,2,7,71.4%,9m
11861,2,[JBiden]Zanpah,3204,46,5,3,8,62.5%,29m
11861,3,jadO,3204,90,3,7,10,30.0%,18m
11861,3,Teslatic,3204,30,1,3,4,25.0%,13m
11861,3,SmoothWalter,3204,30,1,4,5,20.0%,4m
11861,3,[Abncay]Aedys,3204,0,1,4,5,20.0%,39m
11861,3,[FCTR]cole,3204,0,0,1,1,0.0%,22m
11877,3,[UpxV]RennerHalley,3203,1578,105,91,196,53.6%,35m
11877,3,Sickness,3203,362,69,67,136,50.7%,10m
11877,3,Bagelstein,3203,1369,58,48,106,54.7%,37m
11877,3,Blindvizion,3203,559,46,35,81,56.8%,32m
11877,3,LeopoldSkank,3203,1048,40,39,79,50.6%,4m
11877,3,[B1GNut]Puscijuice,3203,364,15,17,32,46.9%,21m
11877,3,Emily,3203,309,12,5,17,70.6%,31m
11877,3,ZoFer,3203,146,7,8,15,46.7%,16m
11877,3,UrineTrouble,3203,155,7,12,19,36.8%,40m
11877,3,[dBASED]Rahxus,3203,116,5,2,7,71.4%,29m
11877,2,GameTheorist,3203,118,5,2,7,71.4%,22m
11877,3,FrOst,3203,150,5,9,14,35.7%,26m
11877,3,EclipSe,3203,60,3,2,5,60.0%,15m
11877,3,Hellcammy,3203,0,2,3,5,40.0%,46m
11877,3,Sneakz,3203,60,2,6,8,25.0%,16m
11877,3,PierO,3203,0,1,0,1,100.0%,6m
11877,3,Snoogaloo,3203,0,0,1,1,0.0%,27m
11877,3,[DHZAcD]UpSideDown,3203,0,0,1,1,0.0%,38m
11877,3,twicetherice,3203,0,0,1,1,0.0%,10m
11877,3,Toadish,3203,0,0,1,1,0.0%,9m
11877,3,pajoondies,3203,0,0,5,5,0.0%,12m
11898,3,ZergOP,3202,1500,287,236,523,54.9%,42m
11898,3,[4GH]thepatchman,3202,1424,91,86,177,51.4%,15m
11898,3,JugiBoy,3202,1093,90,96,186,48.4%,12m
11898,3,[FdUrB]Shopvac,3202,1583,66,63,129,51.2%,14m
11898,3,Dambi,3202,593,27,18,45,60.0%,10m
11898,3,[DhZAc1]QueriaSerBom,3202,286,21,16,37,56.8%,16m
11898,3,[HDY]Hoody,3202,598,21,29,50,42.0%,42m
11898,3,[ValidG]Sebosaurus,3202,513,20,12,32,62.5%,30m
11898,3,[GOPERÚ]Alan,3202,378,17,6,23,73.9%,11m
11898,3,[TPN3]ZergVegano,3202,383,17,18,35,48.6%,5m
11898,3,DrunkMonk,3202,386,14,17,31,45.2%,12m
11898,3,TheMagiBum,3202,222,10,7,17,58.8%,5m
11898,3,Branlouis,3202,203,7,8,15,46.7%,33m
11898,3,[Razor]Pierrot,3202,162,6,11,17,35.3%,36m
11898,1,WeaselKing,3202,194,5,4,9,55.6%,10m
11898,3,[Sr420]GaMBiTz,3202,142,5,5,10,50.0%,39m
11898,3,[Prison]REV,3202,170,4,5,9,44.4%,42m
11898,3,[CatRG]Harambe,3202,120,4,6,10,40.0%,25m
11898,3,Sveet,3202,0,3,2,5,60.0%,2h
11898,3,WizardOfTime,3202,60,3,3,6,50.0%,12m
11898,3,VasalloJack,3202,60,2,3,5,40.0%,35m
11898,3,black,3202,93,2,5,7,28.6%,25m
11898,3,[DynDuo]TheMutalator,3202,97,1,1,2,50.0%,3m
11898,3,[KiTeam]KiTScarleTT,3202,30,1,1,2,50.0%,32m
11898,3,SwampDonkey,3202,0,1,4,5,20.0%,39m
11898,3,OHDADDY,3202,0,0,1,1,0.0%,9m
11898,3,[SANGRE]BERSERKER,3202,0,0,1,1,0.0%,38m
11898,3,[DMADG]Elpelado,3202,0,0,1,1,0.0%,26m
11898,3,Synin,3202,0,0,4,4,0.0%,29m
11927,3,[VFam]DaZergGuyrls,3201,394,102,89,191,53.4%,29m
11927,3,MicrO,3201,816,38,24,62,61.3%,5m
11927,3,JeanMic,3201,844,34,32,66,51.5%,26m
11927,3,Beybars,3201,590,33,23,56,58.9%,30m
11927,3,HiveGaming,3201,565,24,17,41,58.5%,14m
11927,3,Ryahri,3201,187,22,27,49,44.9%,19m
11927,3,SmilesB,3201,530,19,24,43,44.2%,40m
11927,3,[UrBX]Callnoway,3201,280,10,13,23,43.5%,4m
11927,3,Zero,3201,166,6,6,12,50.0%,18m
11927,3,Galoonga,3201,150,6,8,14,42.9%,27m
11927,3,[INER]lortuxim,3201,182,6,9,15,40.0%,38m
11927,3,Nyk,3201,180,6,20,26,23.1%,6m
11927,3,[SLAMT]Enclave,3201,93,5,1,6,83.3%,39m
11927,3,[TeamUR]noiZe,3201,118,5,9,14,35.7%,8m
11927,3,GlobalWarmin,3201,0,3,0,3,100.0%,25m
11927,3,[JFeedZ]MouzShin,3201,122,3,2,5,60.0%,15m
11927,3,[Pig2]jahkra,3201,30,2,0,2,100.0%,42m
11927,3,[xSNSDx]Taeny,3201,119,2,1,3,66.7%,10m
11927,3,Arrakis,3201,30,1,1,2,50.0%,37m
11927,3,Easley,3201,30,1,1,2,50.0%,8m
11927,3,CAGS,3201,30,1,2,3,33.3%,29m
11927,3,[OPOUI]themadnoah,3201,30,1,13,14,7.1%,25m
11927,3,Snicksferme,3201,0,0,1,1,0.0%,7m
11927,3,[DASUL]LaloAssassin,3201,0,0,1,1,0.0%,22m
11927,3,[STAS]Apex,3201,0,0,2,2,0.0%,33m
11927,3,RickSanchez,3201,0,0,2,2,0.0%,39m
11953,3,NorbanSentha,3200,1606,179,171,350,51.1%,22m
11953,3,Thanatos,3200,978,156,136,292,53.4%,9m
11953,3,[DarkAG]Jaicir,3200,981,71,62,133,53.4%,7m
11953,3,LoneWolf,3200,767,46,42,88,52.3%,18m
11953,3,Smexi,3200,1266,45,54,99,45.5%,31m
11953,3,[Chizu]SixtyNeinAPM,3200,735,44,36,80,55.0%,19m
11953,3,[diaman]SIODOS,3200,414,17,11,28,60.7%,23m
11953,3,senpaicream,3200,338,13,19,32,40.6%,26m
11953,3,Zoran,3200,182,10,8,18,55.6%,25m
11953,3,[xTn]Deviant,3200,248,9,2,11,81.8%,7m
11953,3,Jhakrem,3200,198,8,7,15,53.3%,19m
11953,3,[XLNT]Unilectual,3200,122,7,8,15,46.7%,19m
11953,3,JellyNeck,3200,150,6,7,13,46.2%,5m
11953,3,IIIIIIIII,3200,30,2,0,2,100.0%,17m
11953,3,Rhodoknight,3200,0,2,3,5,40.0%,56m
11953,3,ghoul,3200,60,2,8,10,20.0%,40m
11953,3,Shep,3200,0,1,1,2,50.0%,12m
11953,3,[NGFG]Elijah,3200,30,1,2,3,33.3%,30m
11953,3,[kaisen]retlaw,3200,30,1,2,3,33.3%,16m
11953,3,talentless,3200,30,1,2,3,33.3%,10m
11953,3,[kØ]GhOuL,3200,0,0,1,1,0.0%,8m
11953,2,[200IQ]ArmLeg,3200,0,0,2,2,0.0%,21m
11953,3,[OndaVT]ICAROH,3200,0,0,3,3,0.0%,24m
11976,3,bartlln,3199,1479,340,346,686,49.6%,3m
11976,3,[DarkAG]FullyTorqued,3199,1409,192,176,368,52.2%,42m
11976,3,Slab,3199,1472,191,180,371,51.5%,27m
11976,3,[C3PO]Chulius,3199,1564,109,108,217,50.2%,11m
11976,3,[IMDSI]DonFiDeoS,3199,1540,102,97,199,51.3%,42m
11976,3,[TACOST]Grande,3199,1166,101,101,202,50.0%,40m
11976,3,Paragon,3199,833,70,64,134,52.2%,42m
11976,3,[YD2K]BerserkED,3199,495,60,53,113,53.1%,28m
11976,3,jeorge,3199,1080,57,44,101,56.4%,18m
11976,3,YorkHawk,3199,586,51,25,76,67.1%,30m
11976,3,neOO,3199,503,41,22,63,65.1%,41m
11976,3,[VFam2]DerSchoggant,3199,782,35,24,59,59.3%,15m
11976,3,[FAECES]Uriel,3199,648,34,28,62,54.8%,29m
11976,3,[AD3C]Maruel,3199,723,32,23,55,58.2%,42m
11976,3,[αXLa]SlaveGael,3199,178,30,33,63,47.6%,34m
11976,3,[gromp]Ragnarokette,3199,685,28,27,55,50.9%,3m
11976,3,[RustLg]XxkilljoyxX,3199,496,21,14,35,60.0%,37m
11976,3,[VMSTA]PanchoGSW,3199,488,18,18,36,50.0%,26m
11976,3,Scruffy,3199,378,14,9,23,60.9%,6m
11976,3,[Pvvny]Bashton,3199,279,10,5,15,66.7%,31m
11976,3,Eroica,3199,182,9,6,15,60.0%,32m
11976,3,Zippri,3199,251,8,5,13,61.5%,4m
11976,3,BioWarfare,3199,195,8,6,14,57.1%,31m
11976,3,HandOfMidas,3199,243,8,11,19,42.1%,14m
11976,3,[ExcIgN]matiascba,3199,30,5,2,7,71.4%,38m
11976,3,FroGGyStyLe,3199,135,5,4,9,55.6%,10m
11976,3,Smith,3199,30,3,9,12,25.0%,25m
11976,3,YourMotherXD,3199,0,2,3,5,40.0%,40m
11976,3,[WNTRLY]Corn,3199,62,2,12,14,14.3%,40m
11976,3,SuperSann,3199,0,1,1,2,50.0%,41m
11976,3,Seifer,3199,0,1,2,3,33.3%,35m
11976,3,[MAYN]twitchChat,3199,0,1,2,3,33.3%,31m
11976,3,[LRND1S]Novic,3199,30,1,4,5,20.0%,3m
11976,3,ZeroHedge,3199,30,1,5,6,16.7%,25m
11976,1,[COWi]Wronchi,3199,0,0,1,1,0.0%,2h
11976,1,bricep,3199,0,0,1,1,0.0%,1m
11976,3,[RSNBLD]monkeypaw,3199,0,0,2,2,0.0%,31m
12013,3,[xPROx]WIZARD,3198,1569,382,388,770,49.6%,25m
12013,3,[vGCo]BlackBolt,3198,1560,201,203,404,49.8%,31m
12013,3,leo,3198,712,116,123,239,48.5%,34m
12013,3,[Gibbe]itsonlyfat,3198,1214,75,66,141,53.2%,4m
12013,3,BusiGoose,3198,1503,69,61,130,53.1%,6m
12013,3,SpaceDude,3198,1255,64,54,118,54.2%,23m
12013,3,FlashEighty,3198,1129,48,49,97,49.5%,19m
12013,3,Khaleesi,3198,151,19,17,36,52.8%,11m
12013,3,Bman,3198,390,13,11,24,54.2%,34m
12013,3,ethyl,3198,226,9,8,17,52.9%,10m
12013,3,[FateTw]VOIDRAYS,3198,164,5,1,6,83.3%,13m
12013,3,Kimsterz,3198,86,4,2,6,66.7%,5m
12013,3,[F2AAA]pvalue,3198,62,3,3,6,50.0%,4m
12013,3,[hTx]Osiris,3198,58,3,4,7,42.9%,38m
12013,3,TurdGolem,3198,57,3,4,7,42.9%,10m
12013,3,[ScSwrm]ElectrPlumbr,3198,30,1,1,2,50.0%,7m
12013,3,IIIIIIIIIIII,3198,0,0,1,1,0.0%,1h
12013,3,[D3m0N]Shadow,3198,0,0,1,1,0.0%,40m
12013,3,PITTIPIT,3198,0,0,3,3,0.0%,8m
12032,2,[SV]Peñate,3197,1506,315,314,629,50.1%,30m
12032,3,[SCIIS]Tubesock,3197,1393,158,157,315,50.2%,25m
12032,3,Caul,3197,1482,92,94,186,49.5%,3m
12032,3,Tilena,3197,789,65,61,126,51.6%,23m
12032,3,ZynKa,3197,1195,53,43,96,55.2%,25m
12032,3,UnnamedPlayr,3197,941,39,28,67,58.2%,31m
12032,3,Deathifier,3197,309,27,11,38,71.1%,41m
12032,3,Enable,3197,623,26,13,39,66.7%,34m
12032,3,chedarface,3197,590,22,23,45,48.9%,32m
12032,3,[TGCF]Paimon,3197,490,17,21,38,44.7%,14m
12032,3,Tulkdan,3197,448,16,11,27,59.3%,28m
12032,3,LoneWolfSF,3197,261,16,16,32,50.0%,38m
12032,3,palamarys,3197,294,13,10,23,56.5%,2m
12032,3,BFF,3197,380,13,14,27,48.1%,29m
12032,3,Fantasy,3197,280,9,15,24,37.5%,21m
12032,3,[iNJC]Sproll,3197,236,7,5,12,58.3%,23m
12032,3,[xLgNx]LigerMaNN,3197,182,7,11,18,38.9%,19m
12032,3,[ixM]mIddle,3197,168,6,9,15,40.0%,10m
12032,2,boombel,3197,96,5,2,7,71.4%,15m
12032,3,pat,3197,122,5,5,10,50.0%,5m
12032,3,Testube,3197,0,4,1,5,80.0%,29m
12032,3,Presso,3197,30,4,3,7,57.1%,35m
12032,3,Undermind,3197,73,3,7,10,30.0%,36m
12032,3,Shard,3197,60,2,3,5,40.0%,12m
12032,3,Diabolical,3197,62,2,5,7,28.6%,22m
12032,3,elegance,3197,0,0,1,1,0.0%,17m
12032,3,[dBASED]BigFloppa,3197,0,0,1,1,0.0%,19m
12032,3,Solimar,3197,0,0,2,2,0.0%,15m
12060,3,[eX]HiraTadaki,3196,1596,151,116,267,56.6%,17m
12060,3,Orangutantrm,3196,858,129,115,244,52.9%,1m
12060,3,lllllllllIll,3196,1514,118,118,236,50.0%,37m
12060,3,campbel,3196,992,51,66,117,43.6%,25m
12060,3,ced,3196,1358,50,61,111,45.0%,34m
12060,3,Samael,3196,679,31,21,52,59.6%,29m
12060,3,Saulo,3196,594,23,20,43,53.5%,5m
12060,3,[AD3C]Asth,3196,457,22,22,44,50.0%,18m
12060,3,maximus,3196,459,20,13,33,60.6%,31m
12060,3,[PBois]Prevega,3196,368,17,14,31,54.8%,27m
12060,3,[HAV0C]Jimmyfalcon,3196,39,9,13,22,40.9%,40m
12060,3,Shield,3196,226,8,5,13,61.5%,30m
12060,3,Bitspud,3196,214,7,5,12,58.3%,34m
12060,3,Jeff,3196,146,7,5,12,58.3%,18m
12060,3,Mounti,3196,130,7,8,15,46.7%,29m
12060,3,kobe,3196,113,6,2,8,75.0%,14m
12060,3,iLLxisT,3196,86,4,2,6,66.7%,22m
12060,2,Rain,3196,153,4,6,10,40.0%,26m
12060,3,Bainz,3196,118,2,1,3,66.7%,32m
12060,3,TokyoHot,3196,30,2,1,3,66.7%,11m
12060,3,[FSid3]Finch,3196,60,2,2,4,50.0%,10m
12060,3,xoxoDaddy,3196,0,2,3,5,40.0%,9m
12060,3,TheGreyFox,3196,0,1,1,2,50.0%,40m
12060,3,[JaMiT]Trethris,3196,30,1,5,6,16.7%,7m
12060,3,StimPackHapy,3196,0,0,1,1,0.0%,13m
12060,3,[YSP]Shiro,3196,0,0,1,1,0.0%,25m
12060,3,MadKappa,3196,0,0,2,2,0.0%,9m
12060,3,Trips,3196,0,0,4,4,0.0%,7m
12088,2,Chaos,3195,1450,113,106,219,51.6%,26m
12088,3,Icarus,3195,506,54,43,97,55.7%,29m
12088,3,circle,3195,1166,51,33,84,60.7%,13m
12088,3,blackjack,3195,723,30,19,49,61.2%,12m
12088,3,Edge,3195,563,30,19,49,61.2%,18m
12088,3,janwawa,3195,493,25,12,37,67.6%,2m
12088,1,Mauve,3195,169,8,5,13,61.5%,42m
12088,2,[NIntN]ElPres,3195,0,4,2,6,66.7%,18m
12088,3,daFisherman,3195,58,3,5,8,37.5%,11m
12088,3,TitaniumNuts,3195,30,2,0,2,100.0%,31m
12088,3,[J2R]Stormfire,3195,0,1,0,1,100.0%,18m
12088,3,Agreda,3195,30,1,1,2,50.0%,37m
12088,3,Chae,3195,30,1,1,2,50.0%,8m
12101,3,TwoFaces,3194,1458,163,131,294,55.4%,3m
12101,3,[cl0udM]Whataboutme,3194,1547,111,116,227,48.9%,41m
12101,3,[TTKOPF]GrajoSombrío,3194,669,60,47,107,56.1%,22m
12101,3,Yikan,3194,1036,39,39,78,50.0%,2m
12101,3,Megalectium,3194,394,35,12,47,74.5%,7m
12101,3,beh,3194,503,30,20,50,60.0%,26m
12101,3,[SPSN]NoSun,3194,448,18,12,30,60.0%,30m
12101,3,Cochon,3194,329,11,8,19,57.9%,5m
12101,3,[SCAAB]Duke,3194,229,9,8,17,52.9%,24m
12101,3,Paperskin,3194,258,8,24,32,25.0%,29m
12101,1,[nieBla]DarkLucifer,3194,138,7,3,10,70.0%,2h
12101,3,Zudapiggy,3194,222,7,9,16,43.8%,31m
12101,3,Terran,3194,172,6,6,12,50.0%,36m
12101,2,BattleOOZE,3194,0,4,2,6,66.7%,2h
12101,3,Potato,3194,113,4,3,7,57.1%,35m
12101,3,OneUp,3194,168,4,3,7,57.1%,40m
12101,3,[Toss]Caw,3194,122,4,5,9,44.4%,31m
12101,3,Adapt,3194,117,3,0,3,100.0%,1m
12101,3,[CuBTaK]llllllllllll,3194,115,3,0,3,100.0%,26m
12101,3,BatInWuhan,3194,138,3,2,5,60.0%,2m
12101,3,SKTIBANKY,3194,60,3,2,5,60.0%,25m
12101,3,[OhSnap]ItSOnRaNDoM,3194,62,3,11,14,21.4%,41m
12101,3,[cl0udM]Chrono,3194,92,3,11,14,21.4%,15m
12101,3,llllllllllll,3194,0,2,3,5,40.0%,39m
12101,3,[GnR]happybythree,3194,58,2,6,8,25.0%,25m
12101,3,PLAyDoCaize,3194,58,2,7,9,22.2%,30m
12101,3,[4Grush]zalek,3194,30,1,1,2,50.0%,16m
12101,3,[p4j4]khairos,3194,0,1,2,3,33.3%,19m
12129,3,[8ALL55]Deadlylemmin,3193,1549,232,220,452,51.3%,1m
12129,3,XiaoJie,3193,803,132,133,265,49.8%,40m
12129,3,[GGK]Pillowpants,3193,625,42,37,79,53.2%,36m
12129,3,KXMoon,3193,488,28,23,51,54.9%,29m
12129,3,DrSpaceman,3193,679,27,24,51,52.9%,11m
12129,3,[Pig2]MaelStorm,3193,212,19,16,35,54.3%,12m
12129,3,[PPBRA]Vectrom,3193,364,15,10,25,60.0%,14m
12129,3,[PHY2PE]CKT,3193,305,10,8,18,55.6%,27m
12129,3,[8read]Bhutthead,3193,271,8,6,14,57.1%,31m
12129,2,fauxtoe,3193,115,6,2,8,75.0%,2h
12129,3,storm,3193,0,4,1,5,80.0%,13m
12129,3,[GangR]MattMac,3193,118,2,1,3,66.7%,4m
12129,3,aQpJuanJo,3193,125,2,4,6,33.3%,33m
12129,3,Bideo,3193,0,0,1,1,0.0%,29m
12129,3,[VFam2]Kaladin,3193,0,0,1,1,0.0%,14m
12144,3,[OD2019]EthexC,3192,500,64,45,109,58.7%,19m
12144,3,sundaybrunch,3192,1056,38,42,80,47.5%,29m
12144,3,lWorstGodl,3192,748,27,31,58,46.6%,29m
12144,3,[gaPe]Siv,3192,568,21,17,38,55.3%,35m
12144,3,kobetj,3192,432,18,12,30,60.0%,25m
12144,3,llllllllllll,3192,464,17,17,34,50.0%,37m
12144,3,PinkFrog,3192,301,16,18,34,47.1%,25m
12144,3,TreeMeister,3192,331,11,8,19,57.9%,4m
12144,3,[QOSQO]HarrYTM,3192,224,8,14,22,36.4%,11m
12144,3,CheeseComing,3192,78,4,2,6,66.7%,38m
12144,3,flowers,3192,0,3,2,5,60.0%,38m
12144,3,[Jerkz]freshkeeper,3192,58,3,3,6,50.0%,30m
12144,3,eXoroVaNdYy,3192,94,3,6,9,33.3%,40m
12144,3,[SigmaV]GegMopak,3192,0,1,0,1,100.0%,23m
12144,3,Mckay,3192,0,1,0,1,100.0%,30m
12144,2,[Wehavu]SpGEroS,3192,0,1,3,4,25.0%,10m
12144,3,[BRWIN]Heavens,3192,0,0,1,1,0.0%,23m
12144,3,Naga,3192,0,0,1,1,0.0%,10m
12144,3,OnlyMarines,3192,0,0,2,2,0.0%,37m
12144,1,llllllllllll,3192,0,0,8,8,0.0%,46m
12164,3,Castlevania,3191,1565,213,189,402,53.0%,40m
12164,3,[CFCoV]HeavyPie,3191,1536,207,189,396,52.3%,10m
12164,3,mack,3191,1592,156,126,282,55.3%,14m
12164,3,[MoSun]Myhyori,3191,825,37,46,83,44.6%,41m
12164,3,Snow,3191,697,29,30,59,49.2%,37m
12164,3,Obvi,3191,704,24,39,63,38.1%,20m
12164,3,LAWLeIkt,3191,512,21,19,40,52.5%,31m
12164,3,Envy,3191,492,19,19,38,50.0%,37m
12164,3,floatingbase,3191,331,11,10,21,52.4%,31m
12164,2,Morgasm,3191,272,10,13,23,43.5%,34m
12164,1,nevah,3191,162,7,2,9,77.8%,20m
12164,3,FotH,3191,97,6,3,9,66.7%,5m
12164,3,[oTc]BakeR,3191,118,5,6,11,45.5%,39m
12164,3,[GFZ]KeIZeR,3191,133,4,1,5,80.0%,30m
12164,3,KelThuzad,3191,86,3,4,7,42.9%,9m
12164,3,[SBoys]Franco,3191,92,3,5,8,37.5%,39m
12164,3,LuckyOwl,3191,30,2,3,5,40.0%,21m
12164,3,Virus,3191,58,2,9,11,18.2%,18m
12164,3,EliteJG,3191,0,1,0,1,100.0%,31m
12164,3,panico,3191,30,1,2,3,33.3%,37m
12164,3,[LOHs]BrOkEn,3191,0,0,1,1,0.0%,19m
12164,3,Umi,3191,0,0,1,1,0.0%,27m
12164,2,phraud,3191,0,0,4,4,0.0%,37m
12187,3,[DRGNS]PeruvnSwarm,3190,1517,221,207,428,51.6%,21m
12187,2,[YD2K]UnlovedPuppy,3190,994,135,136,271,49.8%,16m
12187,3,Johannes,3190,1171,119,126,245,48.6%,3m
12187,3,[KingSC]LRT,3190,1015,93,92,185,50.3%,10m
12187,3,[EFFELQ]Falbo,3190,1255,74,52,126,58.7%,1m
12187,3,Pacman,3190,937,45,28,73,61.6%,27m
12187,3,SoulessSide,3190,1150,44,42,86,51.2%,19m
12187,3,UrineTrouble,3190,613,33,13,46,71.7%,22m
12187,3,ThepblOll,3190,533,23,16,39,59.0%,29m
12187,3,[ICL]Karthdaddy,3190,427,16,12,28,57.1%,25m
12187,3,[CHATO]PedroHBD,3190,300,12,10,22,54.5%,26m
12187,2,TheSadLing,3190,304,12,24,36,33.3%,30m
12187,3,[LTK]Rakanishu,3190,168,8,4,12,66.7%,30m
12187,3,DaWackness,3190,161,6,0,6,100.0%,1m
12187,3,EGIdraRC,3190,0,4,1,5,80.0%,8m
12187,3,Xenocide,3190,30,4,3,7,57.1%,18m
12187,2,CaptH,3190,133,4,11,15,26.7%,2m
12187,3,gakads,3190,114,3,1,4,75.0%,17m
12187,2,GrassMud,3190,92,2,2,4,50.0%,33m
12187,3,[TGosuA]Patata,3190,0,1,0,1,100.0%,16m
12187,3,toothfairy,3190,0,1,0,1,100.0%,3m
12187,3,[ROCKSC]Levi,3190,0,0,1,1,0.0%,4m
12187,3,Destiny,3190,0,0,1,1,0.0%,1m
12187,2,AssandTits,3190,0,0,1,1,0.0%,58m
12187,3,Tychus,3190,0,0,1,1,0.0%,37m
12212,2,[FyHr]Sagg,3189,1483,447,457,904,49.4%,2m
12212,3,cerebralZ,3189,1560,221,212,433,51.0%,8m
12212,3,amorin,3189,689,146,114,260,56.2%,38m
12212,3,kekkers,3189,1566,138,141,279,49.5%,21m
12212,3,[N1C3]HotSaltyLoad,3189,1429,82,82,164,50.0%,23m
12212,3,LuckyOwl,3189,606,61,69,130,46.9%,39m
12212,3,[DRKFOX]XUPAK,3189,1208,60,71,131,45.8%,35m
12212,3,SKYTOSS,3189,1206,44,50,94,46.8%,29m
12212,3,unlimtdjuice,3189,973,35,34,69,50.7%,8m
12212,3,Demolition,3189,109,6,2,8,75.0%,10m
12212,3,KrisMiz,3189,179,6,3,9,66.7%,38m
12212,3,SprinG,3189,176,6,9,15,40.0%,5m
12212,1,lmunkey,3189,48,5,5,10,50.0%,28m
12212,3,Camlost,3189,90,3,9,12,25.0%,21m
12212,3,[Ash3s]MasterWonton,3189,0,1,0,1,100.0%,37m
12212,2,[pineC]DankMemes,3189,90,1,1,2,50.0%,1m
12212,3,Breakfast,3189,0,1,3,4,25.0%,30m
12212,2,[1Cat1]StingrayVoid,3189,0,0,1,1,0.0%,5m
12212,3,FrNk,3189,0,0,1,1,0.0%,33m
12212,2,Pyrol,3189,0,0,1,1,0.0%,2h
12212,3,Loris,3189,0,0,1,1,0.0%,40m
12212,3,[PFO]whosnext,3189,0,0,2,2,0.0%,32m
12234,3,[AD3C]Bronzzo,3188,1615,766,718,1484,51.6%,25m
12234,3,DvzDark,3188,1548,377,373,750,50.3%,23m
12234,3,trabs,3188,1307,159,144,303,52.5%,38m
12234,3,[An1me1]YouAreClown,3188,1266,83,52,135,61.5%,14m
12234,3,[SsaYnS]lawl,3188,1043,77,76,153,50.3%,35m
12234,3,[CNG]Umbris,3188,568,47,39,86,54.7%,38m
12234,3,Vaala,3188,526,39,26,65,60.0%,10m
12234,3,vanilla,3188,897,37,44,81,45.7%,25m
12234,3,[8kPLUS]Freddiy,3188,598,22,20,42,52.4%,5m
12234,3,JCDus,3188,267,10,3,13,76.9%,37m
12234,3,BabyZergling,3188,238,10,7,17,58.8%,37m
12234,3,[8kPLUS]Mirage,3188,203,6,4,10,60.0%,15m
12234,3,johnjohn,3188,0,5,0,5,100.0%,2h
12234,2,Gettlucky,3188,118,5,2,7,71.4%,23m
12234,3,Aurora,3188,111,5,2,7,71.4%,17m
12234,3,iAmZero,3188,120,4,6,10,40.0%,5m
12234,3,[AWSHlT]GamingPanda,3188,90,4,8,12,33.3%,30m
12234,3,killerXD,3188,58,3,3,6,50.0%,2m
12234,3,cccccccccccc,3188,30,2,1,3,66.7%,41m
12234,3,LOBITO,3188,60,2,3,5,40.0%,8m
12234,3,RubeGamer,3188,30,1,2,3,33.3%,29m
12234,1,Tyrus,3188,0,1,6,7,14.3%,1m
12234,3,Dan,3188,0,0,1,1,0.0%,3m
12234,3,SpaceWolf,3188,0,0,1,1,0.0%,29m
12234,3,[KGH2]darius,3188,0,0,1,1,0.0%,10m
12234,3,[PiG69]ShamanIvan,3188,0,0,2,2,0.0%,7m
12260,3,Gilthis,3187,1611,115,102,217,53.0%,42m
12260,3,DANGpaynus,3187,1067,83,72,155,53.5%,5m
12260,3,[DEoC]CkOwnage,3187,1553,81,88,169,47.9%,30m
12260,2,HENRYHOBO,3187,1369,78,93,171,45.6%,6m
12260,3,Aguaruchimba,3187,1216,73,61,134,54.5%,1m
12260,3,SinTwister,3187,935,56,66,122,45.9%,25m
12260,3,[EtrOy]dougt,3187,1158,43,48,91,47.3%,2m
12260,3,[RUMB]bigjod,3187,805,34,42,76,44.7%,3m
12260,3,RRRMMM,3187,632,27,15,42,64.3%,23m
12260,3,Volley,3187,150,20,6,26,76.9%,41m
12260,3,XxPerverzoxX,3187,380,16,7,23,69.6%,14m
12260,3,[SC2BOL]HadesSacred,3187,428,15,17,32,46.9%,16m
12260,3,gladshane,3187,233,11,7,18,61.1%,14m
12260,3,[FMX]KAKAROTO,3187,235,9,7,16,56.2%,8m
12260,3,[nieBla]Kukulza,3187,206,7,8,15,46.7%,31m
12260,3,xkai,3187,215,6,4,10,60.0%,1m
12260,3,Yeet,3187,30,5,3,8,62.5%,35m
12260,3,[LeChat]LCFlapjack,3187,0,4,1,5,80.0%,2h
12260,3,[LAMDA]MexiknBooM,3187,86,4,5,9,44.4%,16m
12260,1,Castrator,3187,121,3,5,8,37.5%,18m
12260,3,[FORCE9]Dyst,3187,30,2,1,3,66.7%,12m
12260,3,Veda,3187,30,2,2,4,50.0%,41m
12260,3,[1Fenix]Terabite,3187,30,2,3,5,40.0%,21m
12260,3,[PTHero]RoguePianist,3187,30,2,4,6,33.3%,26m
12260,3,SkittleNutZ,3187,47,2,12,14,14.3%,29m
12260,3,DarkFrossT,3187,0,1,0,1,100.0%,18m
12260,3,MunchyMan,3187,30,1,2,3,33.3%,41m
12260,3,[dreamG]Ryun,3187,0,1,4,5,20.0%,20m
12260,3,SaVVs,3187,0,0,1,1,0.0%,30m
12260,3,[hX]Ano,3187,0,0,1,1,0.0%,37m
12290,3,[LOHs]pablo,3186,1563,286,286,572,50.0%,32m
12290,3,KrayZKat,3186,1001,89,71,160,55.6%,1m
12290,3,alberttt,3186,1144,53,37,90,58.9%,35m
12290,3,[NPhasA]lvkeat,3186,865,36,29,65,55.4%,20m
12290,3,Rapage,3186,330,12,13,25,48.0%,26m
12290,3,Seveso,3186,230,8,14,22,36.4%,3m
12290,3,[FVCES]lolmattlol,3186,193,7,7,14,50.0%,14m
12290,3,FranZ,3186,198,6,5,11,54.5%,34m
12290,3,Murderotica,3186,162,6,13,19,31.6%,7m
12290,3,[DarkAG]Terranitup,3186,144,5,5,10,50.0%,21m
12290,3,Homunculus,3186,0,4,1,5,80.0%,58m
12290,3,DefNotMario,3186,0,3,1,4,75.0%,2h
12290,3,[GOBBLE]Salo,3186,62,3,7,10,30.0%,24m
12290,3,llllllllllll,3186,0,1,0,1,100.0%,3m
12290,3,[FkJeff]INnoVation,3186,0,0,1,1,0.0%,12m
12305,3,[Lp]Blessmen,3185,1136,82,74,156,52.6%,37m
12305,3,OrangeDragon,3185,1569,72,50,122,59.0%,17m
12305,3,BadManner,3185,894,34,45,79,43.0%,40m
12305,3,IsTheShadow,3185,529,29,17,46,63.0%,25m
12305,3,[BnBros]STEINBURG,3185,650,25,22,47,53.2%,29m
12305,3,glhf,3185,480,21,24,45,46.7%,38m
12305,3,[ZTemps]Oloyii,3185,572,21,25,46,45.7%,31m
12305,3,Kantachat,3185,207,14,14,28,50.0%,19m
12305,3,[NwAs]Chero,3185,373,13,26,39,33.3%,10m
12305,3,[kØ]Agronor,3185,280,12,3,15,80.0%,41m
12305,3,haoxianghe,3185,172,7,5,12,58.3%,20m
12305,3,sherlock,3185,132,6,3,9,66.7%,42m
12305,3,[FPlot]AppleBabble,3185,122,5,1,6,83.3%,25m
12305,1,[iAnc]HKVS,3185,187,5,2,7,71.4%,2h
12305,3,[WNTRGG]Wolf,3185,0,4,1,5,80.0%,1h
12305,3,Garrr,3185,0,4,1,5,80.0%,60m
12305,3,PrincePlaya,3185,0,4,1,5,80.0%,1m
12305,3,Firepop,3185,30,2,0,2,100.0%,10m
12305,3,Vivien,3185,127,2,3,5,40.0%,22m
12305,3,HangOver,3185,0,1,0,1,100.0%,27m
12305,3,KIRK,3185,0,1,1,2,50.0%,32m
12305,3,MirrrRr,3185,0,1,1,2,50.0%,2m
12305,3,[FyHr]Andy,3185,30,1,5,6,16.7%,12m
12305,3,Sputnik,3185,0,0,1,1,0.0%,36m
12305,3,Emialis,3185,0,0,1,1,0.0%,7m
12305,3,UniTy,3185,0,0,1,1,0.0%,41m
12305,3,FreeHat,3185,0,0,1,1,0.0%,14m
12305,3,NPK,3185,0,0,1,1,0.0%,37m
12305,3,swarmleader,3185,0,0,1,1,0.0%,9m
12334,3,Krono,3184,708,109,106,215,50.7%,7m
12334,3,[eX]Belle,3184,958,47,41,88,53.4%,35m
12334,3,[TkQ]BeauFlex,3184,639,36,30,66,54.5%,6m
12334,3,Rapture,3184,888,36,34,70,51.4%,25m
12334,3,[RUMB]jayman,3184,687,32,22,54,59.3%,37m
12334,3,Fengriz,3184,689,30,29,59,50.8%,16m
12334,3,GCD,3184,420,22,7,29,75.9%,7m
12334,3,Anmdra,3184,452,21,15,36,58.3%,17m
12334,3,[SKARO]AzorAhai,3184,324,16,16,32,50.0%,13m
12334,3,Nightshade,3184,380,14,12,26,53.8%,7m
12334,3,Bjornbrandr,3184,240,9,5,14,64.3%,7m
12334,3,Hammer,3184,223,8,8,16,50.0%,27m
12334,3,[AMBP]HotAmbush,3184,272,8,11,19,42.1%,37m
12334,3,JaBc,3184,174,7,6,13,53.8%,19m
12334,1,meechi,3184,121,6,4,10,60.0%,1m
12334,3,ATMACS,3184,146,6,11,17,35.3%,21m
12334,3,[BRSSS]LickyJim,3184,0,1,1,2,50.0%,9m
12334,3,[TAW]Bixol,3184,0,1,2,3,33.3%,22m
12334,3,BruceWu,3184,0,1,4,5,20.0%,42m
12334,3,jack,3184,0,0,1,1,0.0%,39m
12334,3,Hellterror,3184,0,0,1,1,0.0%,21m
12334,3,mom,3184,0,0,1,1,0.0%,30m
12334,1,Kratoss,3184,0,0,3,3,0.0%,18m
12357,3,luis,3183,1554,312,272,584,53.4%,36m
12357,3,[LETAL]ZEUS,3183,1618,242,216,458,52.8%,23m
12357,3,NANDOX,3183,1076,138,121,259,53.3%,36m
12357,3,[TOYOTA]CamryPower,3183,466,93,79,172,54.1%,16m
12357,3,[SKTT1]SGTxMookie,3183,1501,93,99,192,48.4%,25m
12357,3,Fischi,3183,1117,51,39,90,56.7%,7m
12357,3,DeeX,3183,1135,50,47,97,51.5%,29m
12357,3,FfSnOw,3183,327,33,30,63,52.4%,11m
12357,3,Phantera,3183,713,31,38,69,44.9%,16m
12357,3,Plas,3183,587,23,16,39,59.0%,8m
12357,3,Vexus,3183,482,21,18,39,53.8%,11m
12357,3,[IPOI]Rythym,3183,420,19,17,36,52.8%,23m
12357,3,Gratcher,3183,344,17,11,28,60.7%,7m
12357,3,[Fum3s]BassInYoFace,3183,244,9,14,23,39.1%,40m
12357,3,[TSØP]Denexuz,3183,176,7,4,11,63.6%,36m
12357,3,TITAN,3183,227,7,9,16,43.8%,38m
12357,3,[TBAMFs]HONEYBadger,3183,170,6,8,14,42.9%,37m
12357,3,Piglet,3183,144,4,1,5,80.0%,26m
12357,3,AngLeon,3183,0,1,0,1,100.0%,40m
12357,3,SixtyNein,3183,0,1,0,1,100.0%,31m
12357,3,[HCAZ]HCAZ,3183,95,1,1,2,50.0%,31m
12357,3,Chimba,3183,30,1,3,4,25.0%,1m
12357,3,[QP]Mrfarfadet,3183,0,1,4,5,20.0%,31m
12357,3,[Jaffa]Jaffa,3183,95,1,5,6,16.7%,31m
12357,3,Kurisu,3183,30,1,7,8,12.5%,2m
12357,3,icecolb,3183,0,0,1,1,0.0%,19m
12357,3,FoRtHeSwArM,3183,0,0,1,1,0.0%,30m
12357,2,MagicJohnson,3183,0,0,1,1,0.0%,38m
12357,3,Rhapsody,3183,0,0,1,1,0.0%,26m
12386,3,Yue,3182,1581,339,334,673,50.4%,12m
12386,3,[TOG]Jaymo,3182,1319,230,228,458,50.2%,25m
12386,3,[QcScT]BilL,3182,728,83,75,158,52.5%,37m
12386,3,GooseWillis,3182,875,64,45,109,58.7%,37m
12386,3,daisy,3182,783,50,38,88,56.8%,37m
12386,3,Spartan,3182,591,42,18,60,70.0%,23m
12386,3,Viator,3182,289,38,35,73,52.1%,40m
12386,3,[BlSc]GLHF,3182,437,21,11,32,65.6%,22m
12386,3,[SadCat]CountCrispy,3182,279,11,4,15,73.3%,31m
12386,1,Zambonia,3182,204,9,5,14,64.3%,10m
12386,3,HomerovCv,3182,88,4,2,6,66.7%,40m
12386,3,[ZrO2]Cuckoo,3182,118,4,6,10,40.0%,15m
12386,3,Brim,3182,58,3,3,6,50.0%,7m
12386,3,PinkHippo,3182,30,2,3,5,40.0%,40m
12386,3,[CLoob]ptslammer,3182,60,2,5,7,28.6%,20m
12386,3,NibbleZits,3182,30,1,3,4,25.0%,30m
12386,3,[Black0]xXDaganonXx,3182,0,0,1,1,0.0%,37m
12386,3,BigShrewd,3182,0,0,1,1,0.0%,1m
12386,3,meepcity,3182,0,0,1,1,0.0%,16m
12386,3,Esen,3182,0,0,1,1,0.0%,38m
12386,3,[aviNA]BurstCommand,3182,0,0,2,2,0.0%,38m
12407,3,[AlIin]Sétan,3181,1578,217,183,400,54.2%,41m
12407,3,Ddpskizzle,3181,1301,165,143,308,53.6%,8m
12407,3,HowSad,3181,1274,108,77,185,58.4%,34m
12407,3,sYn,3181,1211,67,69,136,49.3%,25m
12407,3,GHaMaRo,3181,1513,66,51,117,56.4%,39m
12407,3,[JaMiT]Machete,3181,981,62,62,124,50.0%,41m
12407,3,Div,3181,1282,57,58,115,49.6%,27m
12407,3,[HBDO]UBEREATS,3181,878,44,19,63,69.8%,20m
12407,3,milk,3181,393,30,23,53,56.6%,26m
12407,3,PNUTBTRFLCN,3181,399,29,25,54,53.7%,37m
12407,3,ztek,3181,672,25,26,51,49.0%,41m
12407,3,Shade,3181,447,19,10,29,65.5%,14m
12407,3,fobek,3181,269,14,5,19,73.7%,33m
12407,3,Daxin,3181,107,12,2,14,85.7%,23m
12407,3,VeinDrainage,3181,208,8,8,16,50.0%,10m
12407,3,SIRCOL,3181,190,6,3,9,66.7%,33m
12407,3,studge,3181,60,5,2,7,71.4%,17m
12407,3,bucketcart,3181,118,5,4,9,55.6%,25m
12407,3,[ZrG]Azeotrope,3181,132,4,0,4,100.0%,1m
12407,3,ikonik,3181,86,4,2,6,66.7%,12m
12407,3,[HPLUG]Sephix,3181,60,3,9,12,25.0%,32m
12407,3,YenYeri,3181,120,2,6,8,25.0%,5m
12407,3,Newby,3181,128,2,6,8,25.0%,41m
12407,3,HungryWolf,3181,0,1,0,1,100.0%,31m
12407,3,Messaiga,3181,0,1,1,2,50.0%,31m
12407,3,[LGNxx]macdwest,3181,30,1,3,4,25.0%,16m
12407,3,Oddsbodikins,3181,30,1,7,8,12.5%,38m
12407,3,[INextI]Ozzy,3181,0,0,1,1,0.0%,21m
12407,2,[S1MPZ]SavageOne,3181,0,0,1,1,0.0%,2h
12407,3,[Macac0]FasUwU,3181,0,0,1,1,0.0%,14m
12437,3,Xenios,3180,1352,371,356,727,51.0%,23m
12437,3,ForlornOne,3180,1579,197,173,370,53.2%,4m
12437,3,Kestrel,3180,1597,119,107,226,52.7%,29m
12437,3,BigCatMeow,3180,1132,66,10,76,86.8%,14m
12437,3,kasteriris,3180,438,53,39,92,57.6%,25m
12437,3,meliosem,3180,1148,42,48,90,46.7%,37m
12437,3,[WNTRLY]aRsony,3180,569,31,10,41,75.6%,35m
12437,3,[CiMP]longbick,3180,653,28,18,46,60.9%,17m
12437,3,[Curse]chugachuga,3180,563,24,12,36,66.7%,3m
12437,3,captainsaute,3180,415,20,3,23,87.0%,25m
12437,3,BuffettGamer,3180,486,20,15,35,57.1%,37m
12437,3,Jmac,3180,57,12,18,30,40.0%,32m
12437,3,[PuStLe]infestorOP,3180,103,8,5,13,61.5%,24m
12437,3,[ZTemp]Whiskers,3180,248,8,19,27,29.6%,23m
12437,3,Mayday,3180,197,7,1,8,87.5%,34m
12437,2,[GDClan]GameDouble,3180,137,5,4,9,55.6%,42m
12437,3,[NeOx1]Reaper,3180,126,4,14,18,22.2%,5m
12437,3,[xRtGac]Zippy,3180,95,2,0,2,100.0%,27m
12437,3,[D5FTWA]Quell,3180,100,2,1,3,66.7%,14m
12437,3,Migrate,3180,50,2,6,8,25.0%,29m
12437,3,[EvilGC]Manolo,3180,94,1,1,2,50.0%,38m
12437,3,[GOPERÚ]PXS,3180,0,0,1,1,0.0%,39m
12437,3,JMG,3180,0,0,2,2,0.0%,26m
12437,3,[NSTYBZ]matus,3180,0,0,2,2,0.0%,12m
12437,3,[ValidG]Creature,3180,0,0,2,2,0.0%,12m
12462,3,[GFP]Valhanis,3179,1582,172,154,326,52.8%,9m
12462,3,MrSherlock,3179,1417,139,126,265,52.5%,25m
12462,3,Qzalik,3179,1463,129,101,230,56.1%,25m
12462,3,zarsy,3179,1548,112,109,221,50.7%,29m
12462,3,crater,3179,766,85,84,169,50.3%,41m
12462,3,Jose,3179,973,72,71,143,50.3%,13m
12462,3,Honeka,3179,611,36,28,64,56.2%,25m
12462,3,[Flar3s]NaGaN,3179,662,27,23,50,54.0%,27m
12462,3,SWATZINATOR,3179,618,26,17,43,60.5%,30m
12462,3,IIlIllIlIllI,3179,395,17,11,28,60.7%,39m
12462,3,[PSISTM]MDFrostbite,3179,343,15,11,26,57.7%,8m
12462,3,[WTSH]Luffman,3179,378,15,16,31,48.4%,31m
12462,3,[αXLa]Faesbuca,3179,376,14,9,23,60.9%,13m
12462,3,Puscifer,3179,300,12,9,21,57.1%,19m
12462,3,[LQV]kfcnhl,3179,338,12,15,27,44.4%,37m
12462,3,[ENL]FedReserve,3179,134,6,3,9,66.7%,36m
12462,3,Nockman,3179,58,6,4,10,60.0%,2m
12462,2,IIIIIIIIIIII,3179,96,5,2,7,71.4%,2h
12462,3,[UpeV]BlackPhillip,3179,133,4,0,4,100.0%,30m
12462,3,aTaN,3179,124,4,1,5,80.0%,15m
12462,3,Yoonbron,3179,0,4,1,5,80.0%,4m
12462,2,Cowboybebop,3179,152,3,4,7,42.9%,30m
12462,3,Drust,3179,114,2,1,3,66.7%,26m
12462,3,[DBLCHZ]Culpfiction,3179,62,2,6,8,25.0%,30m
12462,2,[AssSZN]AvatarReynor,3179,0,1,0,1,100.0%,29m
12462,3,[VOLKDS]imanta,3179,30,1,2,3,33.3%,5m
12462,3,sOk,3179,30,1,2,3,33.3%,2m
12462,3,[G0R3]lala,3179,0,0,1,1,0.0%,19m
12462,3,ladilla,3179,0,0,1,1,0.0%,31m
12462,3,[HVPC]Anakin,3179,0,0,1,1,0.0%,41m
12462,3,Dynokriziz,3179,0,0,2,2,0.0%,27m
12462,3,Mordenkainen,3179,0,0,2,2,0.0%,10m
12494,3,[VFam]badzergling,3178,1046,129,122,251,51.4%,4m
12494,3,sausey,3178,1368,121,115,236,51.3%,3m
12494,3,Popols,3178,860,113,96,209,54.1%,31m
12494,3,[FatMom]BigChungus,3178,733,73,72,145,50.3%,9m
12494,3,[DICBOI]Oniichan,3178,1399,62,57,119,52.1%,37m
12494,3,LuckyLarry,3178,434,46,14,60,76.7%,39m
12494,3,BigWolf,3178,427,44,33,77,57.1%,31m
12494,3,[HØST]hugobw,3178,989,40,45,85,47.1%,5m
12494,3,Timmy,3178,945,39,38,77,50.6%,4m
12494,3,[FkHost]Altectech,3178,256,35,25,60,58.3%,29m
12494,3,GeneralZ,3178,741,31,24,55,56.4%,14m
12494,3,[DtoH]MasterZi,3178,211,20,9,29,69.0%,31m
12494,3,[Iridan]loliscythe,3178,369,16,8,24,66.7%,6m
12494,3,TdTNomad,3178,310,13,13,26,50.0%,10m
12494,3,BAYACETO,3178,287,12,3,15,80.0%,1m
12494,3,Fralala,3178,128,10,3,13,76.9%,12m
12494,3,[PTHero]Ganondorf,3178,270,10,10,20,50.0%,30m
12494,3,Oofsmoofs,3178,122,8,5,13,61.5%,25m
12494,3,[Wat3rs]Scalawagon,3178,238,8,6,14,57.1%,7m
12494,3,morningstar,3178,88,7,6,13,53.8%,32m
12494,3,[Gr33zy]BlitzZerg,3178,139,6,3,9,66.7%,3m
12494,3,AnubisKing,3178,238,6,15,21,28.6%,14m
12494,3,[SAUCEo]MicroWizard,3178,174,5,3,8,62.5%,16m
12494,2,[Fried]Dalmatian,3178,183,5,5,10,50.0%,2h
12494,3,igoairok,3178,86,4,8,12,33.3%,28m
12494,3,wendi,3178,113,3,0,3,100.0%,7m
12494,3,Eureka,3178,97,2,1,3,66.7%,19m
12494,3,Jatlantis,3178,0,2,3,5,40.0%,15m
12494,3,encguitarist,3178,58,2,3,5,40.0%,31m
12494,3,Urano,3178,30,2,4,6,33.3%,36m
12494,3,[KICT]Klondike,3178,30,1,2,3,33.3%,31m
12494,3,JuhwanJeong,3178,0,1,4,5,20.0%,39m
12494,3,Griff,3178,0,0,1,1,0.0%,37m
12527,3,Hugo,3177,1511,485,456,941,51.5%,28m
12527,3,Purple,3177,1549,264,262,526,50.2%,28m
12527,3,Madrock,3177,1427,138,135,273,50.5%,26m
12527,3,Ressun,3177,1575,137,130,267,51.3%,41m
12527,3,Koast,3177,1509,121,114,235,51.5%,16m
12527,3,[ShTiLe]sludgeminer,3177,1537,118,111,229,51.5%,36m
12527,3,RaithSensei,3177,257,103,51,154,66.9%,15m
12527,3,[Mayku]Atreyu,3177,1186,102,105,207,49.3%,37m
12527,3,IIIIIIIIIIII,3177,845,90,24,114,78.9%,37m
12527,3,[EFENI]Entheas,3177,1092,48,41,89,53.9%,6m
12527,3,[CodeA]Beatme,3177,643,44,1,45,97.8%,5m
12527,3,[ScSwrm]Vesper,3177,732,37,16,53,69.8%,9m
12527,3,Conotor,3177,802,30,26,56,53.6%,15m
12527,3,[dg3n]sicks,3177,635,28,28,56,50.0%,26m
12527,3,Real,3177,271,14,13,27,51.9%,37m
12527,3,MarCraft,3177,330,12,16,28,42.9%,27m
12527,3,Slew,3177,284,11,10,21,52.4%,38m
12527,3,OutCold,3177,258,11,10,21,52.4%,15m
12527,3,Renegade,3177,220,10,7,17,58.8%,3m
12527,3,[SC2IDN]Jangbingo,3177,221,8,5,13,61.5%,20m
12527,3,[NOMMM]rofltarts,3177,111,5,2,7,71.4%,36m
12527,3,poums,3177,88,5,7,12,41.7%,4m
12527,3,yeetermeiste,3177,0,4,1,5,80.0%,31m
12527,3,Wizard,3177,112,4,3,7,57.1%,30m
12527,3,Anthonee,3177,134,3,1,4,75.0%,16m
12527,3,[NextDC]GAMEL,3177,144,3,3,6,50.0%,37m
12527,3,Wyse,3177,0,1,0,1,100.0%,4m
12527,3,Soulkey,3177,0,1,0,1,100.0%,25m
12527,3,chuhbaby,3177,0,1,0,1,100.0%,28m
12527,3,Zergcraft,3177,0,1,0,1,100.0%,40m
12527,3,Aenima,3177,95,1,1,2,50.0%,15m
12527,3,ecksdee,3177,0,1,1,2,50.0%,28m
12527,3,ZeTH,3177,89,1,1,2,50.0%,25m
12527,3,[N1GO]SloppyMayor,3177,0,0,1,1,0.0%,21m
12527,3,CupidStunt,3177,0,0,2,2,0.0%,2m
12562,3,Somasae,3176,1504,183,167,350,52.3%,23m
12562,3,LukeSkywalkr,3176,1332,155,127,282,55.0%,31m
12562,3,DeliriuM,3176,1150,148,133,281,52.7%,30m
12562,3,YinYang,3176,1187,123,125,248,49.6%,29m
12562,3,LTH,3176,1591,119,110,229,52.0%,8m
12562,2,TheZVirus,3176,1469,115,118,233,49.4%,17m
12562,3,Ikaros,3176,1225,105,105,210,50.0%,22m
12562,3,[5252]Starstriker,3176,1297,88,64,152,57.9%,36m
12562,3,[DRKPMT]BtwoHOTTIE,3176,1657,84,81,165,50.9%,17m
12562,3,[fUUL]ChUcKDiEsEl,3176,922,82,66,148,55.4%,39m
12562,3,azure,3176,945,60,33,93,64.5%,17m
12562,3,Statix,3176,927,56,34,90,62.2%,32m
12562,3,[8kPLUS]CrackLing,3176,814,44,33,77,57.1%,22m
12562,3,Smykea,3176,673,33,21,54,61.1%,13m
12562,3,Iseefor,3176,627,27,25,52,51.9%,26m
12562,3,[HØST]RuiterD,3176,688,24,28,52,46.2%,4m
12562,3,Shuriken,3176,181,11,5,16,68.8%,27m
12562,3,[Nuggin]PaZuzUu,3176,314,11,8,19,57.9%,40m
12562,3,[MEP]sao,3176,218,7,14,21,33.3%,9m
12562,3,[SRBA]SilenceRiver,3176,0,4,1,5,80.0%,14m
12562,3,Shaddap,3176,0,3,0,3,100.0%,8m
12562,3,Rokman,3176,118,3,1,4,75.0%,3m
12562,3,[HaZaR]Infinity,3176,60,3,3,6,50.0%,27m
12562,3,BiPolarBear,3176,30,2,4,6,33.3%,26m
12562,2,[Sger]Singularity,3176,96,2,5,7,28.6%,27m
12562,3,[Molt3n]GeoHeWz,3176,0,0,1,1,0.0%,3m
12562,3,[PwT]ZergUltimate,3176,0,0,1,1,0.0%,22m
12589,3,[SQUEE]Castaway,3175,1506,295,271,566,52.1%,11m
12589,3,AlwaysSunny,3175,1572,221,221,442,50.0%,41m
12589,3,TiredDrone,3175,588,114,105,219,52.1%,13m
12589,3,[LyDoge]Plap,3175,571,69,60,129,53.5%,20m
12589,3,[hahahe]EliteCowdung,3175,472,64,47,111,57.7%,1m
12589,3,Wooli,3175,472,49,9,58,84.5%,31m
12589,3,CuteHusky,3175,703,35,45,80,43.8%,37m
12589,3,MrBobby,3175,649,25,22,47,53.2%,36m
12589,3,Fido,3175,494,22,16,38,57.9%,38m
12589,3,crazypenguin,3175,621,21,34,55,38.2%,39m
12589,3,ZBestTalonNA,3175,197,20,13,33,60.6%,35m
12589,2,Jerry,3175,418,16,7,23,69.6%,39m
12589,3,CorsR,3175,351,15,12,27,55.6%,15m
12589,3,Nycrande,3175,344,13,9,22,59.1%,39m
12589,3,KingofBlades,3175,373,13,13,26,50.0%,22m
12589,3,DESTROglhf,3175,362,13,17,30,43.3%,16m
12589,3,[DLe]TheDominator,3175,284,12,8,20,60.0%,38m
12589,3,ronsampson,3175,264,10,12,22,45.5%,31m
12589,3,zxxxx,3175,202,9,5,14,64.3%,15m
12589,3,DJD,3175,133,4,0,4,100.0%,37m
12589,3,Azepro,3175,0,4,1,5,80.0%,27m
12589,3,koros,3175,0,4,1,5,80.0%,30m
12589,3,Doublelift,3175,121,3,1,4,75.0%,39m
12589,3,Jean,3175,86,3,5,8,37.5%,13m
12589,3,[Z0HR]MacroZerg,3175,30,2,2,4,50.0%,37m
12589,3,feierlaune,3175,0,1,0,1,100.0%,17m
12589,3,[BRUVV]billy,3175,0,0,1,1,0.0%,13m
12616,2,javascript,3174,1559,509,515,1024,49.7%,39m
12616,3,[MARV3L]dreddllama,3174,1553,423,420,843,50.2%,16m
12616,2,[UpeV]DarkZero,3174,1520,123,147,270,45.6%,19m
12616,3,Jellybeenzz,3174,750,87,61,148,58.8%,16m
12616,3,thicclet,3174,852,84,82,166,50.6%,37m
12616,3,RussianVodka,3174,1527,75,71,146,51.4%,23m
12616,3,[MPPA]PuduOnanista,3174,1252,71,64,135,52.6%,37m
12616,3,Lobão,3174,1044,63,61,124,50.8%,20m
12616,3,[ZTemp]painNgain,3174,139,58,43,101,57.4%,31m
12616,3,[CCBB]TrainXII,3174,552,40,19,59,67.8%,9m
12616,3,Manipulatore,3174,886,36,32,68,52.9%,34m
12616,3,[B1N4RY]Eternal,3174,746,30,26,56,53.6%,13m
12616,3,[EvilGC]Quetzalcóatl,3174,794,30,31,61,49.2%,1m
12616,3,Somebody,3174,341,22,16,38,57.9%,36m
12616,3,SrCrow,3174,254,13,10,23,56.5%,20m
12616,3,[chair]confucious,3174,334,12,14,26,46.2%,37m
12616,3,Waaaaaaaaaaa,3174,186,9,4,13,69.2%,42m
12616,3,[st0bs]CupCokeYum,3174,225,7,3,10,70.0%,31m
12616,3,[UgK]Rupe,3174,30,5,2,7,71.4%,26m
12616,3,Repow,3174,116,5,8,13,38.5%,15m
12616,3,Kimjungun,3174,0,4,2,6,66.7%,22m
12616,3,Csirac,3174,114,4,5,9,44.4%,16m
12616,3,Sai,3174,30,2,4,6,33.3%,26m
12616,1,Melon,3174,0,1,0,1,100.0%,3h
12616,3,HamChoi,3174,0,0,1,1,0.0%,25m
12641,3,Mycelium,3173,1615,258,254,512,50.4%,32m
12641,2,[GGMESP]THEINIUQ,3173,1223,174,137,311,55.9%,32m
12641,3,[Cincy]Cryo,3173,1378,131,117,248,52.8%,19m
12641,3,[LgnTDS]Rhasta,3173,986,80,71,151,53.0%,23m
12641,3,BennyBlanco,3173,1537,70,55,125,56.0%,38m
12641,3,[Howce]Twink,3173,1303,60,49,109,55.0%,19m
12641,3,[Onnor]colonelxc,3173,1159,51,50,101,50.5%,23m
12641,3,Hemophage,3173,983,51,56,107,47.7%,28m
12641,3,SkullCapVR,3173,842,38,31,69,55.1%,31m
12641,3,mikmonk,3173,492,19,14,33,57.6%,10m
12641,2,Latspread,3173,373,15,8,23,65.2%,34m
12641,3,lumpzz,3173,164,15,15,30,50.0%,15m
12641,3,JPX,3173,319,13,11,24,54.2%,4m
12641,3,DMZ,3173,251,11,17,28,39.3%,4m
12641,3,EIO,3173,114,9,13,22,40.9%,24m
12641,3,ChipS,3173,254,9,15,24,37.5%,38m
12641,3,Ascendancy,3173,251,8,7,15,53.3%,6m
12641,1,Rho,3173,141,7,3,10,70.0%,2h
12641,3,[LCE]Wizard,3173,199,7,4,11,63.6%,12m
12641,3,froooooog,3173,174,6,13,19,31.6%,25m
12641,1,MechItHappen,3173,0,3,3,6,50.0%,2h
12641,3,[Moneey]Gryzm,3173,115,2,1,3,66.7%,38m
12641,3,Ellie,3173,120,2,2,4,50.0%,39m
12641,3,[SOB24]MYxdu,3173,30,2,4,6,33.3%,30m
12641,3,DoYouScout,3173,0,1,0,1,100.0%,38m
12641,3,Brightly,3173,0,1,1,2,50.0%,29m
12641,2,FoBuLouS,3173,38,1,2,3,33.3%,37m
12641,3,esotericg,3173,0,0,1,1,0.0%,25m
12641,3,Jipithebest,3173,0,0,1,1,0.0%,39m
12641,3,[xLgNx]GunnerBlade,3173,0,0,1,1,0.0%,18m
12671,3,Rogue,3172,1533,484,460,944,51.3%,25m
12671,3,INNOVA,3172,1090,122,101,223,54.7%,9m
12671,3,ironblade,3172,881,73,59,132,55.3%,6m
12671,3,monkeyfeces,3172,1026,49,38,87,56.3%,34m
12671,3,TossOP,3172,436,26,3,29,89.7%,17m
12671,3,siGEn,3172,577,23,22,45,51.1%,31m
12671,3,BobTheLob,3172,510,20,14,34,58.8%,4m
12671,3,Rexraynor,3172,310,16,7,23,69.6%,40m
12671,3,beelzebub,3172,362,15,18,33,45.5%,32m
12671,3,[DhZAc1]OlavinhoXD,3172,314,13,4,17,76.5%,6m
12671,3,MrZergisky,3172,378,13,13,26,50.0%,2m
12671,3,Primavera,3172,205,9,5,14,64.3%,31m
12671,3,WolfGang,3172,184,7,3,10,70.0%,29m
12671,3,box,3172,189,6,4,10,60.0%,37m
12671,3,olanubnor,3172,123,4,1,5,80.0%,28m
12671,3,[CHEEKS]Voods,3172,116,4,11,15,26.7%,5m
12671,3,Kappa,3172,0,3,2,5,60.0%,14m
12671,3,[YouNo]Killingangel,3172,58,3,4,7,42.9%,7m
12671,3,[tlwby]damianffg,3172,0,1,0,1,100.0%,30m
12671,1,Twowycked,3172,0,1,1,2,50.0%,26m
12671,1,lei,3172,48,1,1,2,50.0%,2h
12671,3,[NBI]MahnaMahna,3172,0,0,1,1,0.0%,30m
12671,3,dani,3172,0,0,1,1,0.0%,29m
12671,3,Caution,3172,0,0,1,1,0.0%,10m
12671,3,ENaZty,3172,0,0,1,1,0.0%,37m
12671,3,[MaxWin]VidarTheisen,3172,0,0,1,1,0.0%,10m
12671,3,Kaboel,3172,0,0,1,1,0.0%,34m
12698,3,SmileeFace,3171,1130,293,252,545,53.8%,39m
12698,3,[PeePz]border,3171,991,285,262,547,52.1%,19m
12698,3,MomSpaghetti,3171,1544,140,130,270,51.9%,12m
12698,3,[AD3C]togetherAll,3171,1569,84,65,149,56.4%,4m
12698,3,Runninwoof,3171,1388,57,67,124,46.0%,20m
12698,3,CafeDeSade,3171,1209,56,52,108,51.9%,26m
12698,3,[AZPK]KDIGGITYDIZZ,3171,755,46,43,89,51.7%,9m
12698,3,[ZrO2]Aeya,3171,1140,42,41,83,50.6%,8m
12698,3,[VINGAD]XxAsFarCxX,3171,863,40,31,71,56.3%,35m
12698,3,[VFam2]EZDeschanel,3171,523,38,32,70,54.3%,13m
12698,3,[pTFBq]Brennan,3171,275,30,17,47,63.8%,2m
12698,3,Barkcode,3171,416,23,7,30,76.7%,1m
12698,3,NoGLNoHFNoGG,3171,503,22,9,31,71.0%,35m
12698,3,Stiffnights,3171,402,18,13,31,58.1%,9m
12698,3,remainders,3171,302,13,9,22,59.1%,13m
12698,3,RiskyVenture,3171,226,10,7,17,58.8%,32m
12698,2,Ripper,3171,175,6,5,11,54.5%,27m
12698,2,[OPP]alpinefpOPP,3171,121,5,2,7,71.4%,58m
12698,2,swh,3171,96,5,2,7,71.4%,46m
12698,3,Neckky,3171,0,4,1,5,80.0%,39m
12698,3,FlooD,3171,123,4,2,6,66.7%,35m
12698,3,KarLThEPhaT,3171,169,4,3,7,57.1%,13m
12698,3,shatterrook,3171,90,4,4,8,50.0%,29m
12698,2,Moose,3171,161,4,4,8,50.0%,11m
12698,3,[N5G]JettAlyx,3171,116,4,5,9,44.4%,2m
12698,3,IlIlIlIlIlIl,3171,30,2,2,4,50.0%,37m
12698,3,[UpeV]BarCode,3171,0,1,0,1,100.0%,39m
12698,3,Blyatzerg,3171,0,1,0,1,100.0%,1m
12698,3,[LXG]DocFletchLXG,3171,94,1,1,2,50.0%,34m
12698,3,renata,3171,0,0,1,1,0.0%,15m
12698,3,iSixPool,3171,0,0,3,3,0.0%,39m
12729,3,[TGosuB]Spawtan,3170,1538,191,194,385,49.6%,22m
12729,3,[CowLif]MaDCoWDizesE,3170,1234,172,182,354,48.6%,39m
12729,3,Worst,3170,1044,45,42,87,51.7%,25m
12729,3,Saxosmium,3170,527,33,20,53,62.3%,38m
12729,3,[3kIQ]Scurvy,3170,482,32,20,52,61.5%,1m
12729,3,sMoke,3170,341,31,27,58,53.4%,17m
12729,3,IIIIIIIIIIII,3170,665,30,16,46,65.2%,3m
12729,3,Xam,3170,572,27,20,47,57.4%,25m
12729,3,[RnM4EV]MortestMorty,3170,692,26,23,49,53.1%,4m
12729,3,Randarserous,3170,407,17,12,29,58.6%,31m
12729,3,[zeez]Freezer,3170,180,15,10,25,60.0%,5m
12729,3,ThatMouse,3170,296,13,12,25,52.0%,31m
12729,3,Shepard,3170,199,12,7,19,63.2%,3m
12729,3,[Enig]Tyjay,3170,338,12,14,26,46.2%,42m
12729,3,lappen,3170,222,9,6,15,60.0%,40m
12729,3,[ZNsc]Nationwide,3170,220,7,5,12,58.3%,25m
12729,3,Abyss,3170,204,7,10,17,41.2%,15m
12729,3,[R4NDUM]Wyatt,3170,188,6,13,19,31.6%,18m
12729,3,EZarMaDa,3170,169,5,3,8,62.5%,7m
12729,3,[AbcCo]peqaso,3170,60,5,5,10,50.0%,2m
12729,3,SCUMPROPHET,3170,112,3,1,4,75.0%,40m
12729,3,JLouis,3170,30,2,3,5,40.0%,37m
12729,3,ZerG,3170,30,1,2,3,33.3%,33m
12729,1,Massta,3170,0,1,2,3,33.3%,31m
12729,3,[ZGZGZG]Ravage,3170,0,1,4,5,20.0%,40m
12729,3,[EtrOy]CoorsLight,3170,30,1,10,11,9.1%,9m
12729,3,[iiSuk]CaliDreaming,3170,0,0,1,1,0.0%,19m
12729,3,[SenraC]Mag,3170,0,0,1,1,0.0%,31m
12729,3,[CRAKS]John,3170,0,0,1,1,0.0%,4m
12729,3,Rebas,3170,0,0,2,2,0.0%,23m
12729,3,Xiao,3170,0,0,5,5,0.0%,26m
12760,3,MrRoschar,3169,1650,394,365,759,51.9%,5m
12760,3,[GØSU]Prohoops,3169,1377,221,215,436,50.7%,15m
12760,3,Sciolist,3169,1582,167,157,324,51.5%,10m
12760,3,Nacho,3169,1211,74,72,146,50.7%,34m
12760,3,[KingSC]DANIELROCK,3169,1526,69,69,138,50.0%,19m
12760,3,Noobling,3169,1503,64,53,117,54.7%,41m
12760,3,Tamashi,3169,967,64,56,120,53.3%,7m
12760,3,iiiiiiiiiiii,3169,1437,57,51,108,52.8%,13m
12760,3,[OWLsc2]NightOWL,3169,1101,49,31,80,61.2%,34m
12760,3,[AiMB]LingKing,3169,406,42,35,77,54.5%,37m
12760,3,[CatRG]llllllllllll,3169,612,29,23,52,55.8%,36m
12760,3,[GTY]GTYbaboon,3169,749,29,25,54,53.7%,31m
12760,3,DooZeyy,3169,655,27,18,45,60.0%,16m
12760,3,[PMN]LibYourLife,3169,720,27,40,67,40.3%,6m
12760,3,iMPRo,3169,557,25,18,43,58.1%,2m
12760,3,Tinker,3169,187,25,18,43,58.1%,40m
12760,3,DeFogo,3169,694,25,30,55,45.5%,23m
12760,3,Frosty,3169,423,23,16,39,59.0%,25m
12760,3,[VKNG5]RedHorse,3169,537,22,14,36,61.1%,40m
12760,3,LatexhotOO,3169,488,21,13,34,61.8%,6m
12760,3,GuiltyCrown,3169,445,19,14,33,57.6%,39m
12760,3,sykeasaurus,3169,329,16,12,28,57.1%,16m
12760,3,SandBoXx,3169,234,11,6,17,64.7%,27m
12760,3,Ryan,3169,258,11,17,28,39.3%,33m
12760,3,TryTryTry,3169,287,10,7,17,58.8%,36m
12760,3,NaCl,3169,115,9,5,14,64.3%,17m
12760,3,PLPLlama,3169,282,9,9,18,50.0%,3m
12760,3,[VIXIII]Nostrocker,3169,98,6,9,15,40.0%,20m
12760,2,Packs,3169,121,5,2,7,71.4%,2h
12760,3,[Macac0]pungthewolf,3169,116,5,4,9,55.6%,40m
12760,3,SamHouston,3169,114,5,6,11,45.5%,23m
12760,2,DEAFXROBOT,3169,183,5,6,11,45.5%,34m
12760,3,[sMi]sMiLucky,3169,114,5,13,18,27.8%,3m
12760,3,drkpng,3169,0,4,1,5,80.0%,35m
12760,3,FraGor,3169,143,4,2,6,66.7%,26m
12760,3,desty,3169,120,3,1,4,75.0%,1m
12760,3,[BNKRZ]Jeffy,3169,0,3,2,5,60.0%,6m
12760,3,BurrowedThor,3169,147,3,3,6,50.0%,23m
12760,3,UrbanRedNeck,3169,30,3,17,20,15.0%,14m
12760,3,[DEGS]Switch,3169,0,1,0,1,100.0%,17m
12760,1,Twang,3169,96,1,1,2,50.0%,9m
12760,3,[CopiaX]TheParra,3169,0,0,1,1,0.0%,39m
12802,3,[TGCF]Shouse,3168,993,244,236,480,50.8%,32m
12802,3,Tazerface,3168,1417,69,40,109,63.3%,10m
12802,3,Rahwinia,3168,1391,64,69,133,48.1%,24m
12802,3,ChillPenguin,3168,951,41,31,72,56.9%,27m
12802,3,[NwAs]Kche,3168,975,41,34,75,54.7%,39m
12802,3,Foehammer,3168,174,32,23,55,58.2%,16m
12802,3,Frodoteebag,3168,807,32,32,64,50.0%,22m
12802,3,[RlSKE]Slamy,3168,490,22,16,38,57.9%,18m
12802,3,JayemmO,3168,498,21,18,39,53.8%,37m
12802,3,wingwanglo,3168,622,21,21,42,50.0%,37m
12802,3,Jyten,3168,237,9,5,14,64.3%,15m
12802,3,TheD,3168,261,9,7,16,56.2%,40m
12802,3,[cl0udM]GetSome,3168,175,8,6,14,57.1%,4m
12802,3,[ScSwrm]hunter,3168,212,7,2,9,77.8%,39m
12802,3,SilverFenyx,3168,188,7,9,16,43.8%,31m
12802,3,[DLP]Dupy,3168,170,7,10,17,41.2%,35m
12802,3,DesertFox,3168,202,7,14,21,33.3%,28m
12802,3,hazLo,3168,96,5,1,6,83.3%,23m
12802,3,DeMiZeD,3168,177,5,4,9,55.6%,30m
12802,3,slinky,3168,162,4,3,7,57.1%,37m
12802,3,[GR33D]ShoTwiRe,3168,112,3,0,3,100.0%,8m
12802,3,[TheFB]BrauR,3168,62,2,4,6,33.3%,28m
12802,3,uncleling,3168,0,0,1,1,0.0%,6m
12825,3,maslerchef,3167,923,143,134,277,51.6%,37m
12825,3,CeaselessSky,3167,1580,126,118,244,51.6%,23m
12825,3,Ace,3167,1392,96,93,189,50.8%,18m
12825,2,[YD2K]thewetlegend,3167,807,96,121,217,44.2%,33m
12825,3,alphabet,3167,585,82,82,164,50.0%,10m
12825,3,[VGOsc2]Vertigo,3167,783,45,25,70,64.3%,27m
12825,3,hani,3167,1064,41,42,83,49.4%,12m
12825,3,circle,3167,843,38,25,63,60.3%,35m
12825,3,[SBXX]SteelVoynich,3167,689,34,23,57,59.6%,25m
12825,3,Wehrmacht,3167,710,30,18,48,62.5%,36m
12825,3,[frAgz]Lufe,3167,398,19,12,31,61.3%,2m
12825,3,[HJBE]JJmoore,3167,158,14,25,39,35.9%,39m
12825,3,DVE,3167,313,11,9,20,55.0%,31m
12825,3,TradewindBBb,3167,214,8,18,26,30.8%,3m
12825,3,Prabhdas,3167,184,7,9,16,43.8%,19m
12825,3,YUM,3167,204,6,5,11,54.5%,20m
12825,3,Slim,3167,0,4,1,5,80.0%,34m
12825,3,[EtrOy]NorseGoat,3167,146,4,2,6,66.7%,21m
12825,3,[IiUiI]Antisaint,3167,110,3,0,3,100.0%,29m
12825,3,DamonCha,3167,156,3,4,7,42.9%,9m
12825,3,[Wat3rs]Colder,3167,60,2,4,6,33.3%,31m
12825,3,Sulk,3167,117,2,10,12,16.7%,15m
12825,3,Milkdrop,3167,0,1,0,1,100.0%,37m
12825,3,[DC420]DanCLan,3167,0,1,0,1,100.0%,23m
12825,3,[ZTemp]ananth,3167,0,1,0,1,100.0%,42m
12825,3,JukeLuke,3167,0,1,1,2,50.0%,37m
12825,3,KingChaos,3167,0,0,1,1,0.0%,31m
12825,3,Norbert,3167,0,0,1,1,0.0%,40m
12825,3,dracoKnights,3167,0,0,1,1,0.0%,8m
12825,3,VeniVidiVici,3167,0,0,2,2,0.0%,4m
12825,3,blahsank,3167,0,0,2,2,0.0%,4m
12825,3,JamB,3167,0,0,3,3,0.0%,2m
12857,3,[PTHero]Effay,3166,1368,159,153,312,51.0%,40m
12857,3,Tele,3166,1556,151,133,284,53.2%,34m
12857,3,Knowva,3166,574,92,76,168,54.8%,30m
12857,3,Pistallion,3166,1591,92,95,187,49.2%,23m
12857,3,Lock,3166,917,43,26,69,62.3%,42m
12857,3,lap,3166,834,37,28,65,56.9%,8m
12857,3,SpiritSnake,3166,748,33,29,62,53.2%,16m
12857,3,[420SMO]Fishman,3166,466,16,20,36,44.4%,8m
12857,3,Dre,3166,340,13,8,21,61.9%,8m
12857,3,[eSun]maVerick,3166,305,12,6,18,66.7%,38m
12857,3,JaxOff,3166,239,12,7,19,63.2%,40m
12857,3,Obama,3166,354,12,18,30,40.0%,28m
12857,3,[ExcIgN]SweetPain,3166,246,10,2,12,83.3%,4m
12857,3,AnimalOZZ,3166,257,9,4,13,69.2%,25m
12857,3,[ShNK]DeathGun,3166,244,9,10,19,47.4%,24m
12857,3,kennygerms,3166,206,8,2,10,80.0%,28m
12857,3,OmNi,3166,208,6,4,10,60.0%,19m
12857,3,Wersema,3166,114,5,3,8,62.5%,12m
12857,3,medic,3166,0,5,3,8,62.5%,26m
12857,3,DuxDucis,3166,140,4,1,5,80.0%,2m
12857,3,bdstrategist,3166,157,4,5,9,44.4%,31m
12857,3,[Cryptc]hotdogSherif,3166,60,3,2,5,60.0%,10m
12857,3,marmelloh,3166,127,3,2,5,60.0%,22m
12857,3,Venom,3166,0,2,3,5,40.0%,16m
12857,3,[TM7]CptTripps,3166,95,1,1,2,50.0%,5m
12857,3,elbato,3166,0,1,1,2,50.0%,13m
12857,3,Karizma,3166,0,1,4,5,20.0%,36m
12884,3,FaceTheSun,3165,1166,140,135,275,50.9%,35m
12884,3,Wirenut,3165,1518,136,130,266,51.1%,12m
12884,3,WallaWalla,3165,1025,98,103,201,48.8%,33m
12884,3,[n3wk1d]shishkaberb,3165,377,86,70,156,55.1%,37m
12884,3,[AoS2]blackwoltz,3165,1384,83,82,165,50.3%,20m
12884,3,IIIIII,3165,1211,79,84,163,48.5%,12m
12884,3,[ShB]thiccdiccboy,3165,1146,62,66,128,48.4%,19m
12884,3,Dragon,3165,1395,55,51,106,51.9%,38m
12884,3,guts,3165,1073,46,43,89,51.7%,37m
12884,3,IIIIIIIIIIII,3165,427,34,26,60,56.7%,25m
12884,3,[FriGD]Always,3165,694,26,31,57,45.6%,37m
12884,3,Creative,3165,275,24,14,38,63.2%,2m
12884,3,[C2N]McCain,3165,551,24,18,42,57.1%,13m
12884,3,Phalynx,3165,430,20,13,33,60.6%,7m
12884,3,NumberSix,3165,454,19,16,35,54.3%,34m
12884,3,qGhee,3165,307,10,9,19,52.6%,26m
12884,3,[B1teMe]Somehobo,3165,0,5,3,8,62.5%,37m
12884,3,Blutegel,3165,0,4,1,5,80.0%,40m
12884,3,[TaKGaM]taKMashido,3165,115,3,0,3,100.0%,10m
12884,3,McFly,3165,90,3,8,11,27.3%,32m
12884,3,minimean,3165,30,2,1,3,66.7%,5m
12884,3,lllIIIIlllll,3165,0,1,0,1,100.0%,16m
12884,3,Detiner,3165,0,0,3,3,0.0%,37m
12907,3,[FlynHI]BIGbudz,3164,1245,138,119,257,53.7%,15m
12907,3,Inquisitor,3164,333,63,57,120,52.5%,22m
12907,3,Matt,3164,970,61,51,112,54.5%,34m
12907,3,DrKavorkian,3164,516,46,13,59,78.0%,32m
12907,3,Waimea,3164,821,34,25,59,57.6%,4m
12907,3,[GRNSKN]tehbigdirty,3164,709,31,23,54,57.4%,23m
12907,3,[neuroS]Lezalyt,3164,155,22,11,33,66.7%,15m
12907,3,Genos,3164,264,22,14,36,61.1%,38m
12907,3,davrostheIV,3164,487,21,14,35,60.0%,25m
12907,3,[Jokn]Pippin,3164,438,18,10,28,64.3%,36m
12907,3,Quackers,3164,424,15,16,31,48.4%,35m
12907,3,[EndPro]YeIBoRG,3164,276,12,2,14,85.7%,39m
12907,3,[eX]Efemeridade,3164,251,11,2,13,84.6%,36m
12907,3,JRJ,3164,311,11,8,19,57.9%,9m
12907,3,PETTER,3164,209,8,2,10,80.0%,39m
12907,3,zylia,3164,227,8,5,13,61.5%,4m
12907,3,[zling1]stabs,3164,240,8,6,14,57.1%,2m
12907,3,Kinpatsu,3164,172,6,9,15,40.0%,2m
12907,3,AIphaStar,3164,153,5,0,5,100.0%,13m
12907,3,BCBudz,3164,142,5,7,12,41.7%,9m
12907,2,[GRNSKN]Oferon,3164,95,4,2,6,66.7%,3h
12907,3,SirCharles,3164,90,3,11,14,21.4%,29m
12907,2,MiKa,3164,92,2,2,4,50.0%,6m
12907,3,SuiKA,3164,60,2,4,6,33.3%,21m
12907,3,KaiGreene,3164,0,1,0,1,100.0%,27m
12907,3,[Dokkdo]sibalnomAzzz,3164,0,1,0,1,100.0%,29m
12907,3,Notfatmatt,3164,30,1,2,3,33.3%,38m
12907,3,bigGoch,3164,0,0,1,1,0.0%,8m
12907,3,GeneralHuynh,3164,0,0,2,2,0.0%,4m
12907,3,[Xpk]Allegseu,3164,0,0,3,3,0.0%,2m
12937,3,[xLgNx]flapjack,3163,1298,162,150,312,51.9%,29m
12937,3,Brasileiro,3163,595,155,122,277,56.0%,32m
12937,3,BigDaddyPump,3163,1148,139,131,270,51.5%,39m
12937,3,[LGNxx]BigTuna,3163,995,45,31,76,59.2%,39m
12937,3,kouziwada,3163,885,44,27,71,62.0%,21m
12937,3,Tekrebel,3163,318,41,35,76,53.9%,15m
12937,3,Adrenaline,3163,691,40,6,46,87.0%,31m
12937,3,Metternich,3163,905,38,30,68,55.9%,35m
12937,3,Zenxus,3163,750,31,27,58,53.4%,7m
12937,3,IIIIIIIIIIII,3163,262,30,26,56,53.6%,5m
12937,3,Vahl,3163,630,28,19,47,59.6%,8m
12937,3,PhaF,3163,211,28,19,47,59.6%,40m
12937,3,[TgAg]Ghosted,3163,323,23,16,39,59.0%,13m
12937,3,[Ntshls]Schwaz,3163,519,22,24,46,47.8%,40m
12937,3,BATMAN,3163,402,20,22,42,47.6%,16m
12937,3,Titanflash,3163,398,15,18,33,45.5%,40m
12937,1,HockeyManiac,3163,317,14,8,22,63.6%,36m
12937,3,Walty,3163,163,14,18,32,43.8%,41m
12937,3,[ZCAce]Neves,3163,351,12,13,25,48.0%,5m
12937,3,[LOHd]Sketchers,3163,217,9,0,9,100.0%,35m
12937,3,fatdodobird,3163,257,8,5,13,61.5%,39m
12937,3,[AiMB]Rudolpho,3163,151,5,0,5,100.0%,20m
12937,3,Reeek,3163,106,5,2,7,71.4%,34m
12937,3,Azurric,3163,166,4,3,7,57.1%,12m
12937,3,WebbyCombo,3163,167,4,5,9,44.4%,9m
12937,3,laracraft,3163,114,3,1,4,75.0%,26m
12937,3,[PD2D]Killakure,3163,0,1,1,2,50.0%,4m
12937,3,wetfartosis,3163,94,1,1,2,50.0%,32m
12937,3,[runnn]lllllllllll,3163,97,1,1,2,50.0%,8m
12937,3,[SCTues]BotD,3163,0,1,2,3,33.3%,35m
12937,3,[αB]Ifiwereasoup,3163,30,1,4,5,20.0%,32m
12937,3,BigG,3163,0,0,1,1,0.0%,35m
12969,3,TheSenate,3162,1520,256,191,447,57.3%,25m
12969,3,virus,3162,1150,190,191,381,49.9%,12m
12969,3,mclusky,3162,1589,156,152,308,50.6%,27m
12969,3,KRH,3162,807,106,96,202,52.5%,5m
12969,3,[pigs]GetGot,3162,1506,95,94,189,50.3%,14m
12969,3,Hoshi,3162,1487,66,54,120,55.0%,39m
12969,3,[MFE]ISuckS,3162,1511,64,58,122,52.5%,11m
12969,3,Mew,3162,1065,45,28,73,61.6%,37m
12969,3,RougeEnt,3162,350,43,32,75,57.3%,10m
12969,3,adgjliop,3162,1006,43,32,75,57.3%,17m
12969,3,SmallTwo,3162,620,24,29,53,45.3%,32m
12969,3,OnlyTwoD,3162,419,20,12,32,62.5%,13m
12969,3,recursion,3162,213,8,7,15,53.3%,7m
12969,3,Reddington,3162,82,7,8,15,46.7%,42m
12969,3,Grimreaper,3162,150,6,0,6,100.0%,32m
12969,3,AlienWare,3162,139,6,3,9,66.7%,36m
12969,3,Napkin,3162,42,6,5,11,54.5%,24m
12969,3,MiguelPérez,3162,0,5,0,5,100.0%,5m
12969,3,MikeRøss,3162,104,5,2,7,71.4%,17m
12969,3,StingRing,3162,187,5,5,10,50.0%,35m
12969,3,[MadK]ChikeN,3162,145,4,2,6,66.7%,2m
12969,3,[BLOML]CygnusXone,3162,160,4,3,7,57.1%,10m
12969,3,lanzerotlarw,3162,0,3,2,5,60.0%,1h
12969,3,Jungaphitus,3162,62,3,7,10,30.0%,32m
12969,3,[st4rb]Datrags,3162,30,2,5,7,28.6%,14m
12969,3,Booger,3162,30,2,5,7,28.6%,4m
12969,3,[RDQ]Agony,3162,0,0,3,3,0.0%,25m
12996,3,[NextDC]IceDRothen,3161,1539,119,96,215,55.3%,17m
12996,3,[GOPERÚ]Eral,3161,1428,94,66,160,58.8%,33m
12996,3,Souup,3161,804,92,92,184,50.0%,42m
12996,3,Volgarr,3161,1507,84,51,135,62.2%,14m
12996,3,spraynard,3161,1110,82,61,143,57.3%,6m
12996,3,[LQV]BOTOvermind,3161,1316,60,48,108,55.6%,19m
12996,3,[GRNSKN]DLCForcesTTV,3161,628,35,21,56,62.5%,39m
12996,3,MoltKe,3161,832,34,34,68,50.0%,36m
12996,3,Spooge,3161,416,28,16,44,63.6%,37m
12996,3,Omnipotent,3161,398,25,20,45,55.6%,12m
12996,3,tetelestai,3161,361,16,9,25,64.0%,32m
12996,3,Matheus,3161,334,16,9,25,64.0%,14m
12996,3,AmbseyBamsey,3161,326,14,8,22,63.6%,2m
12996,3,[Z4TS]Evanator,3161,325,11,9,20,55.0%,13m
12996,3,barcode,3161,224,9,3,12,75.0%,35m
12996,1,PolskaPro,3161,298,8,13,21,38.1%,34m
12996,3,Whom,3161,96,5,1,6,83.3%,8m
12996,1,PrinterGoBrr,3161,119,5,3,8,62.5%,22m
12996,3,kickstand,3161,181,5,5,10,50.0%,17m
12996,2,iLiOS,3161,119,3,0,3,100.0%,44m
12996,3,[SANA78]SMlife,3161,119,3,1,4,75.0%,25m
12996,1,shadowfist,3161,119,3,2,5,60.0%,49m
12996,3,Greenknight,3161,94,3,7,10,30.0%,2m
12996,3,Shahaka,3161,30,2,1,3,66.7%,32m
12996,3,SupplySide,3161,0,2,3,5,40.0%,33m
12996,2,[kØ]SurFF,3161,0,1,0,1,100.0%,2h
12996,3,[CAV6]MicroJackson,3161,0,1,0,1,100.0%,3m
12996,3,[1213]ADNm,3161,0,1,0,1,100.0%,26m
12996,3,[MNGOMN]JAS,3161,0,0,1,1,0.0%,12m
13025,3,Rabbi,3160,1496,170,143,313,54.3%,9m
13025,3,[KHANS]osirisKhan,3160,1396,155,151,306,50.7%,38m
13025,3,CHW,3160,1577,124,114,238,52.1%,25m
13025,3,Gorpdork,3160,941,123,116,239,51.5%,40m
13025,3,GwaiLo,3160,1408,85,15,100,85.0%,30m
13025,3,ImbaCyL,3160,1409,81,73,154,52.6%,9m
13025,3,Petrichor,3160,1061,66,52,118,55.9%,5m
13025,3,[GAMDAI]KurtNiaboc,3160,507,55,36,91,60.4%,5m
13025,3,[sa1t]AlphaDog,3160,668,53,45,98,54.1%,7m
13025,3,[Lp]Azthael,3160,950,43,29,72,59.7%,10m
13025,3,[TSØP]RoBoT,3160,770,41,50,91,45.1%,16m
13025,3,CaptainHook,3160,371,40,12,52,76.9%,21m
13025,3,Slade,3160,463,33,40,73,45.2%,12m
13025,3,BPSOO,3160,411,20,13,33,60.6%,38m
13025,2,Apple,3160,542,18,41,59,30.5%,22m
13025,3,Lucky,3160,332,17,10,27,63.0%,37m
13025,2,Ryuushutsu,3160,245,15,8,23,65.2%,35m
13025,2,Copenhagen,3160,258,13,9,22,59.1%,27m
13025,3,Shintara,3160,262,11,6,17,64.7%,27m
13025,3,Miko,3160,251,9,5,14,64.3%,23m
13025,3,Rageetas,3160,249,9,5,14,64.3%,40m
13025,3,Doughboy,3160,282,9,16,25,36.0%,36m
13025,3,GLHF,3160,173,7,2,9,77.8%,34m
13025,3,Jota,3160,129,7,2,9,77.8%,38m
13025,3,SebagG,3160,138,6,4,10,60.0%,32m
13025,2,CalmDownBro,3160,0,4,2,6,66.7%,28m
13025,3,FlyingZipper,3160,88,4,7,11,36.4%,29m
13025,3,Celestial,3160,0,3,2,5,60.0%,31m
13025,3,Imply,3160,0,1,1,2,50.0%,26m
13025,3,WHTVRTTKS,3160,0,1,1,2,50.0%,24m
13055,3,[DntWin]BuffZerg,3159,1337,442,410,852,51.9%,34m
13055,3,[TPGGXD]MelonConVino,3159,1669,202,193,395,51.1%,15m
13055,3,Titus,3159,943,43,23,66,65.2%,7m
13055,3,DaveDavidson,3159,739,35,18,53,66.0%,26m
13055,3,FerrumAnima,3159,543,25,29,54,46.3%,37m
13055,3,xOff,3159,400,19,14,33,57.6%,9m
13055,2,Keletian,3159,0,4,2,6,66.7%,58m
13055,3,Zincoontrin,3159,145,3,3,6,50.0%,7m
13055,3,[Xotiic]FaTe,3159,30,2,1,3,66.7%,37m
13055,1,Haven,3159,80,2,3,5,40.0%,3m
13055,2,[theBSL]Horizon,3159,46,2,7,9,22.2%,3h
13055,3,SilentKnight,3159,0,2,7,9,22.2%,6m
13055,1,KIWIBSC,3159,0,0,1,1,0.0%,25m
13055,1,ARTXFAT,3159,0,0,1,1,0.0%,9m
13069,3,PonziScheme,3158,1624,663,649,1312,50.5%,38m
13069,2,[Flar3s]Quantum,3158,1531,181,196,377,48.0%,29m
13069,3,lianregnif,3158,1391,105,98,203,51.7%,4m
13069,3,[Msia]HaCkintoss,3158,1040,54,49,103,52.4%,4m
13069,3,[SkAL]watapinoy,3158,635,30,21,51,58.8%,17m
13069,3,BoyFresh,3158,369,29,34,63,46.0%,37m
13069,1,keno,3158,821,28,22,50,56.0%,30m
13069,3,[SsaYnS]GoldenGooch,3158,379,22,29,51,43.1%,39m
13069,3,LonelyEmu,3158,550,19,18,37,51.4%,5m
13069,3,hunter,3158,388,17,14,31,54.8%,32m
13069,3,FlyingHorse,3158,354,12,14,26,46.2%,33m
13069,2,OldGeroTook,3158,229,8,6,14,57.1%,30m
13069,3,Hajkie,3158,278,8,8,16,50.0%,9m
13069,3,NUKEYA,3158,186,5,6,11,45.5%,12m
13069,3,[STM]Blickter,3158,120,2,2,4,50.0%,24m
13069,3,[PRZM]Catarax,3158,30,2,4,6,33.3%,12m
13069,3,[WINDD]slyTiger,3158,30,1,13,14,7.1%,37m
13069,1,Fetcher,3158,0,0,1,1,0.0%,8m
13069,1,Iko,3158,0,0,1,1,0.0%,41m
13069,2,joker,3158,0,0,1,1,0.0%,2h
13069,3,BIGJUICY,3158,0,0,2,2,0.0%,25m
13090,3,[REXB]Submunition,3157,1504,104,103,207,50.2%,10m
13090,3,Esice,3157,593,59,63,122,48.4%,32m
13090,3,rty,3157,784,39,25,64,60.9%,6m
13090,3,[Exist]Finnholio,3157,653,34,31,65,52.3%,6m
13090,3,[TPGGXD]MaLeR,3157,571,33,37,70,47.1%,37m
13090,3,[NPhase]Gaviola,3157,715,28,26,54,51.9%,23m
13090,3,OooOoO,3157,352,15,10,25,60.0%,6m
13090,3,CaptTrips,3157,302,13,10,23,56.5%,38m
13090,3,stonedcrab,3157,192,9,5,14,64.3%,30m
13090,1,[KTCC]Eldrak,3157,140,5,3,8,62.5%,7m
13090,2,ButtSlayer,3157,139,4,4,8,50.0%,22m
13090,3,BadBeatBrad,3157,40,3,3,6,50.0%,42m
13090,1,DocHolliday,3157,0,0,1,1,0.0%,38m
13090,1,ExpressImba,3157,0,0,1,1,0.0%,35m
13104,3,[ZTempz]Zerg,3156,1559,511,493,1004,50.9%,2m
13104,3,hanns,3156,1543,403,408,811,49.7%,15m
13104,3,LemmingFury,3156,881,56,59,115,48.7%,11m
13104,3,[ZTemp]Observer,3156,1022,47,29,76,61.8%,6m
13104,3,BadWolf,3156,350,46,36,82,56.1%,29m
13104,3,MFDOOM,3156,802,42,42,84,50.0%,30m
13104,3,kidEth,3156,839,33,33,66,50.0%,2m
13104,3,[DuJour]CelebiPZ,3156,682,26,23,49,53.1%,8m
13104,3,StrangeOne,3156,712,26,29,55,47.3%,38m
13104,3,GarbalageMan,3156,686,25,27,52,48.1%,8m
13104,1,[gotBTC]Revenant,3156,725,24,16,40,60.0%,24m
13104,3,SONNY,3156,202,8,9,17,47.1%,15m
13104,3,TMcorvo,3156,164,7,4,11,63.6%,26m
13104,2,[xLUPAx]Tonso,3156,0,4,2,6,66.7%,33m
13104,1,Blitzkrieg,3156,96,3,4,7,42.9%,54m
13104,3,Dopen,3156,30,2,2,4,50.0%,3m
13104,3,NOOBSMASHER,3156,30,2,3,5,40.0%,7m
13104,1,Flash,3156,0,1,0,1,100.0%,27m
13104,1,yeeyoo,3156,0,0,1,1,0.0%,40m
13123,2,[1PA]Maisua,3155,1455,95,105,200,47.5%,18m
13123,3,Heliopath,3155,578,59,49,108,54.6%,15m
13123,3,Blacknight,3155,1355,56,51,107,52.3%,11m
13123,3,Spork,3155,450,22,31,53,41.5%,24m
13123,3,Duality,3155,468,20,13,33,60.6%,24m
13123,3,[BuGang]FullySick,3155,533,18,18,36,50.0%,34m
13123,3,[Mamers]ROBERTCYBY,3155,392,14,13,27,51.9%,11m
13123,3,tjshen,3155,291,11,7,18,61.1%,2m
13123,2,[Chrev]Tahnks,3155,251,6,10,16,37.5%,21m
13123,3,Ecclebert,3155,0,4,1,5,80.0%,3h
13123,3,[VOY3UR]JimNiteBlade,3155,116,3,2,5,60.0%,2m
13123,3,[VFam]WarHammer,3155,30,3,4,7,42.9%,36m
13123,3,[Zulu]ReiGn,3155,58,3,5,8,37.5%,39m
13123,3,[TDXb]Breeze,3155,62,2,7,9,22.2%,7m
13123,1,Mrcursed,3155,0,1,0,1,100.0%,9m
13123,3,Sundown,3155,0,1,2,3,33.3%,19m
13123,3,[aham]Salheb,3155,30,1,3,4,25.0%,28m
13123,3,AwwUrDead,3155,30,1,4,5,20.0%,8m
13123,3,Cannibal,3155,30,1,5,6,16.7%,36m
13142,3,[No1v1]MindMatter,3154,1347,116,106,222,52.3%,29m
13142,3,MysticGx,3154,832,38,30,68,55.9%,6m
13142,3,Fire,3154,602,29,35,64,45.3%,17m
13142,3,KimJongIl,3154,568,24,22,46,52.2%,5m
13142,1,MeusPesames,3154,274,8,5,13,61.5%,9m
13142,3,WilliAM,3154,0,3,1,4,75.0%,3h
13142,3,NikraL,3154,0,2,2,4,50.0%,16m
13142,3,KingEmre,3154,120,2,3,5,40.0%,4m
13142,3,[FyHr]Samael,3154,60,2,6,8,25.0%,5m
13142,1,TheOuchMouse,3154,40,1,1,2,50.0%,38m
13142,3,[NPhasA]Zothoverlord,3154,0,1,1,2,50.0%,11m
13142,3,xxxQuebecxxx,3154,0,1,2,3,33.3%,41m
13142,3,sydek,3154,30,1,3,4,25.0%,38m
13142,3,Cado,3154,30,1,3,4,25.0%,29m
13142,2,Matomic,3154,0,0,1,1,0.0%,35m
13157,3,whyme,3153,1520,143,120,263,54.4%,31m
13157,3,Cromulent,3153,589,117,107,224,52.2%,20m
13157,1,twostripe,3153,1162,72,62,134,53.7%,31m
13157,3,InLusT,3153,607,68,77,145,46.9%,9m
13157,3,Generalnug,3153,1318,65,65,130,50.0%,12m
13157,3,[TekNiQ]TekNiQhazard,3153,782,54,54,108,50.0%,32m
13157,3,[MGKe]FrnchTiklr,3153,1043,50,46,96,52.1%,30m
13157,3,Mechulus,3153,1207,49,51,100,49.0%,34m
13157,3,[RTREES]barcode,3153,1003,45,49,94,47.9%,13m
13157,3,Seawolf,3153,1087,43,42,85,50.6%,36m
13157,3,RockEnRolla,3153,503,23,19,42,54.8%,30m
13157,3,Shinyang,3153,445,20,12,32,62.5%,26m
13157,3,baabaa,3153,414,18,15,33,54.5%,11m
13157,1,DKMG,3153,337,12,13,25,48.0%,7m
13157,3,[REALYY]Minet,3153,338,12,16,28,42.9%,6m
13157,1,IIIIIIIII,3153,84,3,0,3,100.0%,18m
13157,1,[FURBS]Mal,3153,44,2,0,2,100.0%,36m
13157,3,[IPCSI]JuamPI,3153,30,2,2,4,50.0%,35m
13157,1,Simca,3153,97,2,2,4,50.0%,3m
13157,3,Spazzifier,3153,30,2,8,10,20.0%,36m
13157,2,[Fir3s]xtreme,3153,0,1,0,1,100.0%,2h
13157,3,Youaresmelly,3153,0,1,3,4,25.0%,26m
13157,1,Zergalicious,3153,0,0,1,1,0.0%,20m
13157,1,[Borgas]Berio,3153,73,0,2,2,0.0%,10m
13157,3,Doomsday,3153,0,0,2,2,0.0%,29m
13157,3,[Dicboy]DrEvil,3153,0,0,5,5,0.0%,25m
13183,3,TwentyFoSevn,3152,491,64,73,137,46.7%,2m
13183,3,[Pnoys]Sausage,3152,548,33,19,52,63.5%,19m
13183,3,MasterPanda,3152,208,23,21,44,52.3%,29m
13183,3,Niveky,3152,123,21,20,41,51.2%,25m
13183,3,[DB420]SPF,3152,214,16,8,24,66.7%,10m
13183,3,Goooey,3152,241,13,9,22,59.1%,5m
13183,3,Madiryas,3152,238,9,9,18,50.0%,39m
13183,3,masterchief,3152,167,8,11,19,42.1%,16m
13183,3,[KGH]Xinflames,3152,88,4,5,9,44.4%,37m
13183,3,RiP,3152,30,4,5,9,44.4%,26m
13183,3,[BA0]FeSTiVaL,3152,86,4,6,10,40.0%,16m
13183,3,WangChungFu,3152,48,3,4,7,42.9%,35m
13183,1,Bonjwa,3152,97,3,6,9,33.3%,2h
13183,3,juansemr,3152,30,2,3,5,40.0%,22m
13183,2,Mycatsinheat,3152,40,1,13,14,7.1%,37m
13183,1,[vGDM]santy,3152,0,0,1,1,0.0%,37m
13183,3,Timhan,3152,0,0,3,3,0.0%,11m
13183,3,[2JZ]PheNiX,3152,0,0,3,3,0.0%,14m
13183,3,[Ins8G]Emiki,3152,0,0,4,4,0.0%,30m
13202,3,thebeowulf,3151,1511,78,82,160,48.8%,10m
13202,3,[DIQPTE]KSteez,3151,840,60,42,102,58.8%,37m
13202,3,MartR,3151,848,54,46,100,54.0%,37m
13202,3,[DarkAG]Solas,3151,757,29,27,56,51.8%,36m
13202,3,CBIII,3151,462,16,23,39,41.0%,19m
13202,3,Kakaroach,3151,319,14,12,26,53.8%,42m
13202,1,LoLWuTBrO,3151,300,13,12,25,52.0%,4m
13202,3,KingDice,3151,253,8,7,15,53.3%,19m
13202,1,JarekK,3151,74,6,2,8,75.0%,36m
13202,3,iliketerran,3151,30,5,3,8,62.5%,34m
13202,3,Beez,3151,91,4,3,7,57.1%,25m
13202,1,sickviscious,3151,117,3,3,6,50.0%,10m
13202,1,Tempestor,3151,84,2,2,4,50.0%,27m
13202,1,[LCE]LION,3151,86,2,2,4,50.0%,24m
13202,3,ricjamesbtch,3151,120,2,3,5,40.0%,25m
13202,3,QDN,3151,0,1,1,2,50.0%,6m
13202,3,BillNydus,3151,0,0,2,2,0.0%,2m
13219,3,Drego,3150,1585,342,338,680,50.3%,20m
13219,3,[minorK]Ketsky,3150,1531,275,264,539,51.0%,9m
13219,3,Zorg,3150,1582,182,174,356,51.1%,26m
13219,3,[AbcCo]Blanka,3150,479,150,139,289,51.9%,33m
13219,3,Knowledge,3150,1562,80,79,159,50.3%,2m
13219,3,VRman,3150,795,38,20,58,65.5%,14m
13219,3,BroastGarlic,3150,933,33,34,67,49.3%,29m
13219,3,SKLLKRSH,3150,624,22,28,50,44.0%,40m
13219,3,Tropiczz,3150,454,17,23,40,42.5%,26m
13219,3,BEELZ,3150,342,12,11,23,52.2%,17m
13219,3,Frosty,3150,290,10,19,29,34.5%,34m
13219,3,Zombix,3150,292,9,18,27,33.3%,21m
13219,2,[ØÛ]Skoll,3150,207,6,6,12,50.0%,7m
13219,3,Vildar,3150,36,5,8,13,38.5%,16m
13219,3,[TPI]Isabelle,3150,152,5,8,13,38.5%,29m
13234,1,ResgarLouie,3149,1796,289,256,545,53.0%,22m
13234,3,Naza,3149,1569,135,115,250,54.0%,36m
13234,3,[CNBNZ]Doraleix,3149,1313,70,74,144,48.6%,20m
13234,3,[ch33z3]Wyatt,3149,456,24,19,43,55.8%,5m
13234,3,[PneqNP]xSUPERGLUEx,3149,411,15,11,26,57.7%,37m
13234,3,Lubros,3149,286,11,14,25,44.0%,41m
13234,3,BoholWu,3149,274,10,6,16,62.5%,25m
13234,2,Zergling,3149,189,10,7,17,58.8%,20m
13234,3,Grim,3149,260,10,13,23,43.5%,26m
13234,3,phudding,3149,92,3,6,9,33.3%,37m
13234,3,ManaToHealth,3149,62,3,15,18,16.7%,2m
13234,1,PhilDzNutz,3149,84,2,1,3,66.7%,26m
13234,3,Squigs,3149,94,2,1,3,66.7%,31m
13234,1,Cobalt,3149,51,2,2,4,50.0%,31m
13234,1,Tatsuya,3149,0,1,0,1,100.0%,27m
13234,3,PatrickStar,3149,93,1,2,3,33.3%,16m
13234,1,Daneurysm,3149,0,0,1,1,0.0%,10m
13234,3,khaldun,3149,0,0,4,4,0.0%,30m
13252,3,llllllllllll,3148,1591,230,222,452,50.9%,14m
13252,3,[Over1]Manuel,3148,1195,82,70,152,53.9%,39m
13252,3,Nobody,3148,862,81,76,157,51.6%,14m
13252,3,Alex,3148,1542,71,79,150,47.3%,2m
13252,3,Tubes,3148,1601,68,68,136,50.0%,37m
13252,3,Fang,3148,456,33,28,61,54.1%,14m
13252,3,[SMB]Rainstorm,3148,826,30,37,67,44.8%,25m
13252,3,[FEFA]Flormph,3148,526,29,21,50,58.0%,19m
13252,1,[5TEN]FictoR,3148,668,24,11,35,68.6%,22m
13252,3,LazerEyes,3148,545,24,32,56,42.9%,42m
13252,3,nameless,3148,467,20,13,33,60.6%,20m
13252,3,[SOP]Ders,3148,184,17,18,35,48.6%,26m
13252,3,SUPREME,3148,380,15,7,22,68.2%,35m
13252,3,Arkrez,3148,330,12,17,29,41.4%,4m
13252,3,CORVIDSUX,3148,122,2,5,7,28.6%,36m
13252,3,SouthKeeble,3148,97,1,1,2,50.0%,18m
13252,3,pcptwo,3148,95,1,2,3,33.3%,9m
13252,1,ENDER,3148,0,0,1,1,0.0%,17m
13252,3,[l3l3l]SpaceSteak,3148,0,0,2,2,0.0%,29m
13252,2,[FOXY]Twothirteen,3148,0,0,2,2,0.0%,29m
13272,3,[ACCF]DPDP,3147,1621,416,413,829,50.2%,27m
13272,3,Luvistras,3147,1659,256,234,490,52.2%,28m
13272,3,HelloWorld,3147,1113,139,127,266,52.3%,32m
13272,3,[kØ]NAIRTENS,3147,940,52,44,96,54.2%,33m
13272,3,shadow,3147,480,39,31,70,55.7%,15m
13272,3,[TamuSC]StatiKkhaos,3147,850,35,29,64,54.7%,6m
13272,3,Arthur,3147,469,29,31,60,48.3%,36m
13272,1,[Verley]Zaclotzin,3147,719,23,19,42,54.8%,19m
13272,3,Tamer,3147,437,21,15,36,58.3%,19m
13272,3,[CU1T]DaTa,3147,184,15,23,38,39.5%,37m
13272,3,tehtriz,3147,362,12,16,28,42.9%,15m
13272,1,Chork,3147,0,4,1,5,80.0%,16m
13272,3,Germe,3147,140,4,2,6,66.7%,15m
13272,3,madprince,3147,113,3,1,4,75.0%,15m
13272,3,ReideN,3147,113,3,2,5,60.0%,39m
13272,3,eninyaD,3147,62,3,5,8,37.5%,23m
13272,3,HellMuffin,3147,30,2,1,3,66.7%,8m
13272,3,Euco,3147,30,2,2,4,50.0%,28m
13272,1,Pandom,3147,0,1,0,1,100.0%,34m
13272,2,[SHAFT]ProToAsT,3147,0,0,1,1,0.0%,44m
13272,3,MrHunk,3147,0,0,2,2,0.0%,5m
13272,1,[ZNsc]Nanozstorm,3147,0,0,2,2,0.0%,36m
13272,3,[FCUSA]Homestar,3147,0,0,3,3,0.0%,39m
13295,3,IIIIIIIIIIII,3146,383,133,136,269,49.4%,16m
13295,3,[UpxV]RealSC,3146,1582,103,103,206,50.0%,32m
13295,3,FryTimE,3146,467,82,65,147,55.8%,40m
13295,3,[Kixeye]hungkodak,3146,715,57,42,99,57.6%,3m
13295,1,[AiMB]Bob,3146,1212,42,38,80,52.5%,12m
13295,1,Cadnium,3146,475,23,6,29,79.3%,38m
13295,3,MeatyClaws,3146,552,22,15,37,59.5%,12m
13295,3,PewPewPew,3146,290,11,13,24,45.8%,26m
13295,1,Jot,3146,378,10,7,17,58.8%,18m
13295,3,[DRKDNA]Shilowind,3146,270,9,14,23,39.1%,12m
13295,2,FentonMeeks,3146,202,6,8,14,42.9%,35m
13295,1,Mthunderlaw,3146,74,2,1,3,66.7%,40m
13295,1,[DDragB]Ceeeeeeee,3146,78,2,1,3,66.7%,14m
13295,1,SuperPlayer,3146,0,1,2,3,33.3%,2h
13295,1,Sinister,3146,0,0,1,1,0.0%,40m
13295,1,Alser,3146,0,0,1,1,0.0%,22m
13295,2,Phreak,3146,0,0,2,2,0.0%,43m
13312,3,[Xpk]cerodjcero,3145,1595,316,307,623,50.7%,19m
13312,3,[HOMOF]ShankABee,3145,1271,153,129,282,54.3%,32m
13312,3,Kroeker,3145,1492,150,124,274,54.7%,2m
13312,3,SpeedySloth,3145,1393,111,106,217,51.2%,15m
13312,3,[SMRT]OoObernOOb,3145,1317,59,54,113,52.2%,16m
13312,1,MgMgMg,3145,658,41,31,72,56.9%,19m
13312,1,Armamani,3145,804,30,24,54,55.6%,29m
13312,3,Vidneus,3145,420,30,27,57,52.6%,29m
13312,3,RedRum,3145,675,28,27,55,50.9%,11m
13312,3,Veto,3145,215,11,9,20,55.0%,16m
13312,1,[XpKAc]MotapoD,3145,75,4,1,5,80.0%,28m
13312,3,echorising,3145,166,4,4,8,50.0%,27m
13312,3,ballsoHARD,3145,62,3,8,11,27.3%,42m
13312,3,PopitGht,3145,0,0,3,3,0.0%,19m
13326,3,Logic,3144,1314,167,165,332,50.3%,4m
13326,3,[HugGMC]DeCoRe,3144,1594,151,146,297,50.8%,26m
13326,3,CheesePizza,3144,923,120,85,205,58.5%,27m
13326,3,[4L0k0]NightCrawler,3144,1324,92,48,140,65.7%,34m
13326,3,[GTFO]Hyperon,3144,676,65,61,126,51.6%,40m
13326,3,skarloey,3144,1037,47,38,85,55.3%,32m
13326,3,[AkaZki]IIIIIIIIIIII,3144,557,23,22,45,51.1%,23m
13326,3,[ØÛ]Vendettavic,3144,385,21,14,35,60.0%,15m
13326,3,[LimaSC]Yuyu,3144,384,20,17,37,54.1%,40m
13326,3,[GRU]FapperDupley,3144,560,20,25,45,44.4%,28m
13326,3,lucifroom,3144,397,16,18,34,47.1%,41m
13326,3,[AbcCo]Eivici,3144,436,16,21,37,43.2%,38m
13326,3,LawdAzuras,3144,208,15,10,25,60.0%,38m
13326,3,Zumarraga,3144,194,10,6,16,62.5%,27m
13326,2,Labby,3144,269,10,11,21,47.6%,14m
13326,1,Demarr,3144,213,7,9,16,43.8%,38m
13326,3,xJugGernautx,3144,145,3,4,7,42.9%,4m
13326,1,Paradox,3144,40,2,0,2,100.0%,34m
13326,1,Busby,3144,0,1,0,1,100.0%,25m
13326,1,SlappY,3144,97,1,1,2,50.0%,13m
13326,3,Smooth,3144,0,1,2,3,33.3%,3h
13326,3,[dLife]Crisper,3144,0,1,3,4,25.0%,25m
13326,3,dreff,3144,0,0,2,2,0.0%,32m
13349,3,crazybear,3143,1563,200,192,392,51.0%,9m
13349,3,[UpxV]DarkSoul,3143,1562,122,114,236,51.7%,23m
13349,3,Marroc,3143,1395,113,98,211,53.6%,40m
13349,3,oze,3143,653,111,91,202,55.0%,7m
13349,3,[rollup]STEN,3143,1064,62,72,134,46.3%,34m
13349,3,Ramatuscus,3143,1157,59,41,100,59.0%,2m
13349,1,polololo,3143,958,35,27,62,56.5%,41m
13349,3,Shadow,3143,638,21,34,55,38.2%,37m
13349,3,iToxic,3143,293,14,10,24,58.3%,31m
13349,2,[DcypL]SnUggLeS,3143,179,9,7,16,56.2%,20m
13349,3,Bargosk,3143,270,9,10,19,47.4%,16m
13349,3,Dolmatt,3143,231,6,8,14,42.9%,8m
13349,2,[MSFT]CrimsonLlama,3143,93,2,0,2,100.0%,3h
13349,1,Veritas,3143,40,2,0,2,100.0%,42m
13349,3,Boomstick,3143,114,2,2,4,50.0%,10m
13349,3,Ace,3143,0,0,2,2,0.0%,3m
13349,3,IceCold,3143,0,0,5,5,0.0%,32m
13366,3,[ZTemp]Quas,3142,1194,225,186,411,54.7%,37m
13366,3,Bagdot,3142,1559,157,155,312,50.3%,40m
13366,3,[Th3Bad]maua,3142,1497,128,119,247,51.8%,30m
13366,3,Terranasaur,3142,527,105,99,204,51.5%,16m
13366,3,Loverboy,3142,913,75,63,138,54.3%,19m
13366,3,iRysimTTV,3142,919,70,54,124,56.5%,38m
13366,3,DidntGoGreat,3142,930,62,57,119,52.1%,15m
13366,3,Toaster,3142,681,52,53,105,49.5%,32m
13366,3,[LHA]shimoshan,3142,1052,38,42,80,47.5%,3m
13366,3,Esaliine,3142,841,38,43,81,46.9%,5m
13366,3,[TvagP]Dender,3142,519,30,18,48,62.5%,6m
13366,3,[BOLVIA]ricksanchez,3142,699,28,34,62,45.2%,17m
13366,3,Pandemic,3142,616,26,19,45,57.8%,9m
13366,1,[GOPERÚ]Dynamo,3142,266,8,3,11,72.7%,30m
13366,3,Freckles,3142,202,7,10,17,41.2%,30m
13366,3,DVicious,3142,180,6,9,15,40.0%,16m
13366,3,[Tomato]Turtle,3142,0,3,2,5,60.0%,3h
13366,3,Horrible,3142,143,3,4,7,42.9%,13m
13366,3,Brocciu,3142,94,3,7,10,30.0%,23m
13366,1,Lambda,3142,80,2,2,4,50.0%,18m
13366,3,FrenzyMaster,3142,58,2,4,6,33.3%,26m
13366,1,Fallen,3142,0,1,1,2,50.0%,2m
13366,3,TiltProofXD,3142,0,1,5,6,16.7%,20m
13366,1,flawlessZ,3142,0,0,1,1,0.0%,9m
13366,3,[SSCB24]HeluvaBosnia,3142,0,0,4,4,0.0%,23m
13366,3,axel,3142,0,0,4,4,0.0%,22m
13392,3,Tenko,3141,1250,146,134,280,52.1%,15m
13392,3,Jaffar,3141,1559,132,108,240,55.0%,5m
13392,3,[L3]chiubaka,3141,1057,43,38,81,53.1%,36m
13392,1,Setzer,3141,476,43,38,81,53.1%,21m
13392,3,TripleTe,3141,900,42,35,77,54.5%,2m
13392,1,[LgnTDS]Lifesavor,3141,789,27,30,57,47.4%,24m
13392,1,[HDL]Raklann,3141,721,26,14,40,65.0%,33m
13392,3,ArtieShaw,3141,543,24,15,39,61.5%,37m
13392,3,squid,3141,336,18,15,33,54.5%,32m
13392,3,[MoBaW]BigBud,3141,228,12,14,26,46.2%,21m
13392,3,SoNice,3141,248,10,1,11,90.9%,38m
13392,3,asaun,3141,90,7,5,12,58.3%,2m
13392,3,BaliHai,3141,166,7,8,15,46.7%,24m
13392,3,WineDude,3141,142,4,0,4,100.0%,11m
13392,3,Zarbider,3141,120,4,6,10,40.0%,12m
13392,1,Troy,3141,0,3,0,3,100.0%,7m
13392,1,SamyBoy,3141,82,3,3,6,50.0%,39m
13392,1,Tossim,3141,126,3,4,7,42.9%,24m
13392,1,tekron,3141,42,2,0,2,100.0%,6m
13392,3,IIIIIIIIIIII,3141,34,2,7,9,22.2%,10m
13392,3,[DSKapa]MIke,3141,0,1,1,2,50.0%,10m
13392,1,[TPGGXD]GeekRaynor,3141,42,1,2,3,33.3%,18m
13392,1,Oblivion,3141,96,1,2,3,33.3%,2h
13392,1,[HID3]TheRest,3141,0,1,4,5,20.0%,8m
13416,3,[Dusky]mexorcist,3140,547,116,107,223,52.0%,29m
13416,3,taenorn,3140,787,85,60,145,58.6%,13m
13416,3,Abernasty,3140,400,65,58,123,52.8%,30m
13416,3,zealk,3140,1212,56,52,108,51.9%,5m
13416,3,oiL,3140,324,13,14,27,48.1%,34m
13416,3,TerminusMCR,3140,272,12,11,23,52.2%,36m
13416,3,Veloce,3140,289,10,7,17,58.8%,24m
13416,1,LongJohnson,3140,238,6,5,11,54.5%,10m
13416,2,Mesobeshe,3140,142,5,2,7,71.4%,6m
13416,2,ResConsumer,3140,46,5,3,8,62.5%,2h
13416,2,Disruptr,3140,0,4,2,6,66.7%,25m
13416,2,MarineFeign,3140,96,3,1,4,75.0%,3h
13416,1,killerwhaler,3140,84,2,2,4,50.0%,7m
13416,3,Danton,3140,0,1,0,1,100.0%,2h
13416,3,[xwx]Autumn,3140,30,1,3,4,25.0%,15m
13416,3,[Th3Bad]firebat,3140,30,1,4,5,20.0%,17m
13416,1,gaborocks,3140,0,0,1,1,0.0%,1m
13433,1,snowreturn,3139,1232,121,113,234,51.7%,19m
13433,3,[EFNQ]SKLaz,3139,1517,91,92,183,49.7%,25m
13433,3,RhYno,3139,1095,40,40,80,50.0%,10m
13433,3,kingpin,3139,800,33,30,63,52.4%,34m
13433,3,Hamandburger,3139,738,31,22,53,58.5%,36m
13433,3,goudon,3139,472,19,13,32,59.4%,30m
13433,3,Nergal,3139,451,18,12,30,60.0%,4m
13433,3,Ozy,3139,428,16,17,33,48.5%,42m
13433,1,[IMDSI]Sarrel,3139,269,11,7,18,61.1%,7m
13433,2,chucknorris,3139,200,10,5,15,66.7%,32m
13433,3,ANDRENCIO,3139,88,6,7,13,46.2%,40m
13433,3,[MADps]iacexp,3139,139,3,4,7,42.9%,29m
13433,3,Waysamah,3139,94,3,4,7,42.9%,10m
13433,3,delay,3139,0,2,1,3,66.7%,32m
13433,3,lMercuryl,3139,0,2,3,5,40.0%,51m
13433,1,SimonCLimon,3139,0,1,0,1,100.0%,7m
13433,3,Osvi,3139,0,1,4,5,20.0%,60m
13450,3,Thunder,3138,1413,216,210,426,50.7%,5m
13450,1,[GOPERÚ]Jamj,3138,356,22,19,41,53.7%,31m
13450,3,XENORACE,3138,554,22,29,51,43.1%,13m
13450,3,norzing,3138,183,10,5,15,66.7%,19m
13450,1,[AnUB]MEGATRON,3138,247,7,0,7,100.0%,28m
13450,3,[Sune]StarGhost,3138,90,3,6,9,33.3%,35m
13450,3,[KGH3]Sunris,3138,93,2,1,3,66.7%,27m
13450,1,[WNDF]Gfunkhouse,3138,82,2,1,3,66.7%,20m
13450,1,FerriteCore,3138,0,2,3,5,40.0%,10m
13450,1,[Mlnz]LvXii,3138,0,1,0,1,100.0%,31m
13450,1,NullVoid,3138,0,1,0,1,100.0%,28m
13450,1,[xTCFx]Thalinden,3138,42,1,6,7,14.3%,7m
13450,2,[HUNDO]Hundo,3138,0,0,1,1,0.0%,55m
13450,1,[YD2K]AoNxWookie,3138,0,0,1,1,0.0%,24m
13450,3,Battletide,3138,0,0,5,5,0.0%,37m
13465,3,LestweForget,3137,1572,209,201,410,51.0%,32m
13465,1,ycomb,3137,1158,45,35,80,56.2%,28m
13465,3,Krackhead,3137,866,35,43,78,44.9%,36m
13465,3,seraphim,3137,866,30,39,69,43.5%,41m
13465,3,Stickmanjoe,3137,278,12,26,38,31.6%,27m
13465,3,Luffle,3137,168,7,7,14,50.0%,12m
13465,3,[RUMB]BASHER,3137,118,5,7,12,41.7%,13m
13465,3,Ramza,3137,97,4,2,6,66.7%,54m
13465,1,ghydsg,3137,97,4,3,7,57.1%,35m
13465,3,[Exper]KALEL,3137,90,4,5,9,44.4%,36m
13465,1,Shorti,3137,82,2,3,5,40.0%,31m
13465,3,Dylsta,3137,30,1,6,7,14.3%,31m
13477,2,Roig,3136,1032,230,183,413,55.7%,19m
13477,1,Polkg,3136,746,85,77,162,52.5%,11m
13477,3,Joaoarara,3136,613,32,16,48,66.7%,27m
13477,3,[CCG]Shadow,3136,625,27,17,44,61.4%,34m
13477,3,Beluga,3136,632,22,25,47,46.8%,37m
13477,3,[IMDSI]ArkMico,3136,500,19,17,36,52.8%,31m
13477,1,[iDrunk]Trumpi,3136,284,14,8,22,63.6%,22m
13477,3,masamune,3136,270,14,11,25,56.0%,6m
13477,1,Kaladin,3136,272,6,2,8,75.0%,19m
13477,1,Rezo,3136,200,6,4,10,60.0%,25m
13477,3,unknown,3136,185,6,4,10,60.0%,10m
13477,3,Tampii,3136,140,5,7,12,41.7%,23m
13477,3,BruceWarn,3136,97,4,2,6,66.7%,40m
13477,2,BoCaRdO,3136,116,4,5,9,44.4%,2h
13477,3,[Broxit]SeansFriend,3136,92,3,11,14,21.4%,10m
13477,1,SpAzTiC,3136,0,1,1,2,50.0%,8m
13477,3,[Maaad]SatoRi,3136,0,1,4,5,20.0%,2h
13477,3,nightscall,3136,0,1,4,5,20.0%,40m
13477,3,AresXIII,3136,30,1,6,7,14.3%,37m
13496,3,TestDouble,3135,797,129,143,272,47.4%,28m
13496,3,[Subaru]tixop,3135,1226,85,73,158,53.8%,9m
13496,3,BedroomLick,3135,412,69,59,128,53.9%,35m
13496,3,[MCRmy]CutMESilly,3135,545,52,47,99,52.5%,27m
13496,3,Fading,3135,595,25,22,47,53.2%,37m
13496,3,[LowIQ]EvolFighter,3135,346,18,20,38,47.4%,42m
13496,3,ChefBacon,3135,283,18,25,43,41.9%,16m
13496,3,[ANFA]Martinox,3135,350,14,13,27,51.9%,26m
13496,3,[V501st]MaulerX,3135,299,10,9,19,52.6%,5m
13496,3,[SOP]SOPikenasty,3135,99,8,11,19,42.1%,4m
13496,3,[muGGer]Littleboy,3135,209,8,16,24,33.3%,38m
13496,1,TimTam,3135,138,3,2,5,60.0%,36m
13496,1,Peugeot,3135,0,1,0,1,100.0%,9m
13496,1,[TAILED]LordKitsune,3135,0,1,1,2,50.0%,9m
13496,1,Deane,3135,40,1,2,3,33.3%,40m
13496,3,willjog,3135,0,0,2,2,0.0%,37m
13496,3,llllllllllll,3135,0,0,2,2,0.0%,16m
13496,3,[Efil]IlIlIlIlIIII,3135,0,0,12,12,0.0%,17m
13514,3,Aris,3134,1532,281,247,528,53.2%,2m
13514,3,Kvothe,3134,1523,176,172,348,50.6%,26m
13514,3,[LOHd]Fireflame,3134,1509,164,160,324,50.6%,10m
13514,3,Pinkerton,3134,1101,47,41,88,53.4%,5m
13514,1,[CLan12]PiJiRoNy,3134,815,35,25,60,58.3%,34m
13514,3,jvnDIGITAL,3134,445,16,15,31,51.6%,39m
13514,1,IPLObserver,3134,374,11,9,20,55.0%,9m
13514,1,[Radial]FerSrs,3134,208,8,5,13,61.5%,16m
13514,2,Bernmann,3134,164,6,4,10,60.0%,2m
13514,1,[TeHM]shawnebaby,3134,208,6,7,13,46.2%,10m
13514,3,[StmBrk]GeckO,3134,186,5,6,11,45.5%,32m
13514,3,YourLiver,3134,118,5,7,12,41.7%,29m
13514,2,[TrpleT]Croaker,3134,136,4,2,6,66.7%,30m
13514,1,[KxH]Oathkeeper,3134,82,3,1,4,75.0%,30m
13514,2,TostadaLoca,3134,0,0,1,1,0.0%,2h
13514,3,Skedoinker,3134,0,0,3,3,0.0%,12m
13530,3,Campte,3133,1517,64,54,118,54.2%,8m
13530,3,IsaacNewton,3133,1002,47,53,100,47.0%,26m
13530,3,Hexidecible,3133,1225,46,51,97,47.4%,23m
13530,3,[LUNKER]Bmart,3133,774,28,33,61,45.9%,38m
13530,3,GEANTOR,3133,705,26,27,53,49.1%,40m
13530,3,beto,3133,385,16,13,29,55.2%,10m
13530,1,Drasher,3133,366,14,12,26,53.8%,16m
13530,2,Raccoon,3133,348,13,10,23,56.5%,22m
13530,3,Vision,3133,228,8,13,21,38.1%,16m
13530,3,[ML]Papacnmanjar,3133,212,7,11,18,38.9%,27m
13530,3,Notasmurf,3133,121,5,2,7,71.4%,1h
13530,3,llllllllllll,3133,150,5,9,14,35.7%,31m
13530,3,Einzelganger,3133,88,3,16,19,15.8%,24m
13530,1,Raindog,3133,0,1,1,2,50.0%,16m
13530,1,[LifeF]Buttcakes,3133,40,1,3,4,25.0%,27m
13530,1,Rock,3133,0,0,1,1,0.0%,9m
13530,2,OPKutty,3133,0,0,1,1,0.0%,26m
13547,2,thorsen,3132,1583,645,630,1275,50.6%,30m
13547,3,Tunamelt,3132,1330,311,311,622,50.0%,9m
13547,3,[αB]Arioch,3132,1308,80,81,161,49.7%,23m
13547,3,thePimpoyo,3132,1531,63,67,130,48.5%,27m
13547,3,Dinokaiz,3132,949,42,33,75,56.0%,39m
13547,3,Nicon,3132,740,32,35,67,47.8%,4m
13547,1,Cap,3132,660,23,15,38,60.5%,22m
13547,1,sjkim,3132,676,20,18,38,52.6%,2m
13547,3,Locrian,3132,415,15,14,29,51.7%,39m
13547,3,Daskper,3132,270,12,10,22,54.5%,32m
13547,3,Dante,3132,236,9,10,19,47.4%,37m
13547,3,JDaWgYDaWg,3132,0,4,0,4,100.0%,45m
13547,1,[OD2019]SwissCheese,3132,42,2,1,3,66.7%,27m
13547,3,Arkuss,3132,94,2,1,3,66.7%,36m
13547,1,[AiMB]InsertName,3132,0,0,1,1,0.0%,24m
13547,1,Androide,3132,0,0,1,1,0.0%,9m
13547,1,[WanDD]Jmollica,3132,0,0,2,2,0.0%,22m
13547,1,FreNuLuM,3132,0,0,2,2,0.0%,24m
13547,3,Roadrunner,3132,0,0,2,2,0.0%,33m
13566,3,Dectro,3131,1250,122,99,221,55.2%,2m
13566,2,[NLTN]Soverange,3131,783,119,124,243,49.0%,5m
13566,3,Irie,3131,791,86,79,165,52.1%,39m
13566,3,gus,3131,714,56,37,93,60.2%,27m
13566,3,improvise,3131,1018,56,43,99,56.6%,36m
13566,3,Thory,3131,1007,42,35,77,54.5%,37m
13566,3,[GGMESP]llllllllllll,3131,863,41,40,81,50.6%,16m
13566,3,[Peruvi]NELO,3131,366,40,36,76,52.6%,16m
13566,3,basic,3131,791,35,25,60,58.3%,8m
13566,3,Pandadeath,3131,344,12,22,34,35.3%,40m
13566,3,[HCat]Ocelmot,3131,260,11,8,19,57.9%,9m
13566,1,alejandro,3131,218,9,4,13,69.2%,19m
13566,1,Creeper,3131,189,8,5,13,61.5%,2h
13566,3,[CHUSK]Chen,3131,266,8,10,18,44.4%,2m
13566,2,[EC4F]FloorWax,3131,165,7,5,12,58.3%,56m
13566,3,Nunnner,3131,170,6,9,15,40.0%,26m
13566,3,diego,3131,121,5,2,7,71.4%,1h
13566,3,WebFreaK,3131,30,5,3,8,62.5%,39m
13566,1,[Weac]SOFTANDWET,3131,104,4,0,4,100.0%,39m
13566,3,UwUPimpollo,3131,141,4,8,12,33.3%,9m
13566,2,Mixta,3131,0,3,3,6,50.0%,2h
13566,1,datoneguy,3131,38,2,0,2,100.0%,35m
13566,1,nikemanvc,3131,42,2,2,4,50.0%,32m
13566,3,Vlsqz,3131,120,2,4,6,33.3%,36m
13566,1,[r1Wood]orange,3131,0,1,0,1,100.0%,10m
13566,1,Chiriwe,3131,40,1,1,2,50.0%,3m
13566,3,cope,3131,30,1,8,9,11.1%,34m
13566,1,[Zambo]lCrowl,3131,0,0,1,1,0.0%,34m
13566,1,Blead,3131,0,0,1,1,0.0%,9m
13566,1,Calafalas,3131,0,0,1,1,0.0%,16m
13596,3,[UpeV]Wallgap,3130,1557,318,304,622,51.1%,16m
13596,3,SteeleTrap,3130,1294,123,96,219,56.2%,24m
13596,3,GeorgeSoros,3130,1381,101,105,206,49.0%,39m
13596,3,Sherpad,3130,835,75,76,151,49.7%,42m
13596,3,[cl0udM]INject,3130,1099,48,44,92,52.2%,22m
13596,3,Already,3130,927,38,31,69,55.1%,38m
13596,3,Ironhearts,3130,1018,37,41,78,47.4%,20m
13596,3,LongShortsGu,3130,541,32,33,65,49.2%,28m
13596,3,zillasoaruss,3130,376,31,30,61,50.8%,16m
13596,3,[ZTempz]WestNileVori,3130,657,24,24,48,50.0%,36m
13596,3,[DarkAG]LvlTwoNinja,3130,524,23,20,43,53.5%,2m
13596,1,Scv,3130,178,7,4,11,63.6%,36m
13596,1,Hawkwing,3130,226,6,3,9,66.7%,12m
13596,3,muckluck,3130,208,6,14,20,30.0%,21m
13596,1,[TS]Bydrock,3130,146,4,6,10,40.0%,31m
13596,3,[TgAg]TernUrBraOff,3130,92,4,7,11,36.4%,9m
13596,1,[teamCO]BlindsideLFE,3130,143,3,2,5,60.0%,31m
13596,3,DarkKnight,3130,62,3,9,12,25.0%,31m
13596,1,opo,3130,96,2,1,3,66.7%,57m
13596,1,[AlIin]Hamish,3130,0,0,1,1,0.0%,17m
13596,1,[TLibre]XélHáYáotl,3130,0,0,1,1,0.0%,32m
13596,1,[JS5]MicroJackson,3130,0,0,1,1,0.0%,16m
13596,1,Kweek,3130,0,0,1,1,0.0%,31m
13596,3,[danuts]BBox,3130,0,0,2,2,0.0%,21m
13620,3,Jtekill,3129,1186,176,169,345,51.0%,6m
13620,3,wickedftw,3129,1420,153,144,297,51.5%,29m
13620,3,Redlevi,3129,1515,97,80,177,54.8%,13m
13620,1,[Mammy]Tomhumfree,3129,1403,79,58,137,57.7%,25m
13620,3,IllllIIllIIl,3129,588,64,59,123,52.0%,19m
13620,3,StinkFart,3129,504,18,23,41,43.9%,16m
13620,1,[BGGBOI]PinkiePie,3129,418,14,11,25,56.0%,22m
13620,1,[IM3]Soldierboy,3129,406,12,10,22,54.5%,5m
13620,1,DrakeDog,3129,344,9,6,15,60.0%,40m
13620,3,Junga,3129,291,9,11,20,45.0%,24m
13620,3,Pegasso,3129,213,7,7,14,50.0%,13m
13620,3,wetsis,3129,186,6,17,23,26.1%,14m
13620,1,[TGosuC]Kloof,3129,80,2,2,4,50.0%,39m
13620,1,Lithane,3129,82,2,4,6,33.3%,12m
13620,1,[EZDUNK]Hornet,3129,0,1,0,1,100.0%,31m
13620,1,Drewsy,3129,42,1,2,3,33.3%,38m
13620,1,viagraeater,3129,44,1,3,4,25.0%,31m
13620,2,[MeLFtw]MaverickOca,3129,91,1,5,6,16.7%,35m
13620,1,DizzyOG,3129,0,0,1,1,0.0%,41m
13620,1,mrSSeda,3129,0,0,1,1,0.0%,23m
13620,1,[NotB]AJX,3129,0,0,1,1,0.0%,17m
13620,1,[SyLx]Legacy,3129,0,0,1,1,0.0%,40m
13642,3,[VAPD]Pipsonator,3128,1313,230,198,428,53.7%,23m
13642,3,zetu,3128,1484,177,160,337,52.5%,4m
13642,3,Computer,3128,1320,59,51,110,53.6%,2m
13642,3,drydius,3128,1118,46,48,94,48.9%,6m
13642,3,Daystar,3128,316,34,27,61,55.7%,26m
13642,3,Boogaloo,3128,499,31,33,64,48.4%,9m
13642,3,HeirApparent,3128,603,24,23,47,51.1%,15m
13642,1,YUMC,3128,348,15,12,27,55.6%,20m
13642,1,LewsTherin,3128,502,14,12,26,53.8%,8m
13642,1,MiranaPotm,3128,417,13,12,25,52.0%,7m
13642,3,[Sky]KsH,3128,201,9,10,19,47.4%,22m
13642,3,Anarchy,3128,174,8,5,13,61.5%,36m
13642,2,FiretoBlaze,3128,119,6,2,8,75.0%,22m
13642,1,Indecisive,3128,0,5,0,5,100.0%,17m
13642,2,Quaznal,3128,0,4,3,7,57.1%,2h
13642,1,TheSpiderBro,3128,0,3,2,5,60.0%,7m
13642,1,nirvash,3128,0,2,3,5,40.0%,16m
13642,2,Sebastis,3128,0,2,3,5,40.0%,43m
13642,1,[CCCT]RadarPrince,3128,0,1,0,1,100.0%,27m
13642,2,Ashlyn,3128,0,1,0,1,100.0%,28m
13642,1,[SENZU]JOO,3128,42,1,2,3,33.3%,18m
13642,1,[xDYEx]Spectre,3128,0,0,1,1,0.0%,11m
13664,3,Austere,3127,1518,249,247,496,50.2%,42m
13664,3,SingaporeSMU,3127,1605,243,237,480,50.6%,10m
13664,3,OGhupeng,3127,1585,150,152,302,49.7%,13m
13664,1,cupcake,3127,1577,76,58,134,56.7%,17m
13664,3,Eurotrix,3127,1149,47,37,84,56.0%,2m
13664,3,TheMilkman,3127,295,31,24,55,56.4%,39m
13664,3,TheDrone,3127,657,29,26,55,52.7%,4m
13664,3,vanilla,3127,687,28,24,52,53.8%,6m
13664,3,[SALTDY]inEVItabLe,3127,381,24,23,47,51.1%,23m
13664,3,Tempo,3127,283,22,19,41,53.7%,40m
13664,3,KawaiiMane,3127,363,16,12,28,57.1%,27m
13664,3,[Nashe]DogFilters,3127,378,12,14,26,46.2%,36m
13664,3,[NoMilk]TheFuzz,3127,342,12,23,35,34.3%,29m
13664,3,[C71188]LeatherChrEO,3127,252,10,13,23,43.5%,40m
13664,1,GutsyGusty,3127,241,6,4,10,60.0%,22m
13664,3,[UMCP]leopluradon,3127,146,6,5,11,54.5%,39m
13664,3,[LGNxx]klanosk,3127,148,5,8,13,38.5%,36m
13664,1,Zen,3127,166,4,5,9,44.4%,35m
13664,3,GamerGirl,3127,128,4,11,15,26.7%,5m
13664,1,[FMX]Restaurador,3127,117,3,3,6,50.0%,35m
13664,1,Karlec,3127,0,2,3,5,40.0%,36m
13664,1,User,3127,0,1,0,1,100.0%,7m
13664,1,INIGORUS,3127,0,1,0,1,100.0%,18m
13664,1,Locoster,3127,0,1,1,2,50.0%,36m
13664,1,[KVR]SINA,3127,0,0,1,1,0.0%,7m
13664,1,pasco,3127,0,0,1,1,0.0%,7m
13690,3,Wiggin,3126,1576,115,103,218,52.8%,9m
13690,3,StyliAnT,3126,1532,82,72,154,53.2%,38m
13690,3,Kurtimus,3126,466,36,27,63,57.1%,19m
13690,3,BarneyLover,3126,380,29,22,51,56.9%,41m
13690,3,LuckyPants,3126,442,14,16,30,46.7%,32m
13690,3,MasterMind,3126,221,14,21,35,40.0%,27m
13690,3,Squishy,3126,312,11,10,21,52.4%,28m
13690,3,[GOPERÚ]Panzer,3126,251,8,10,18,44.4%,18m
13690,3,Eveelor,3126,161,7,8,15,46.7%,31m
13690,1,Hellteck,3126,226,6,3,9,66.7%,12m
13690,1,[NLTN]Yoshimitsu,3126,156,5,2,7,71.4%,13m
13690,3,Tenetri,3126,98,5,9,14,35.7%,21m
13690,1,KiloOmega,3126,97,4,2,6,66.7%,2h
13690,1,AkanuWolf,3126,76,3,2,5,60.0%,26m
13690,1,Andrew,3126,42,2,0,2,100.0%,35m
13690,1,TSQN,3126,40,1,1,2,50.0%,38m
13690,3,Zander,3126,0,1,2,3,33.3%,21m
13690,3,UglySweater,3126,30,1,5,6,16.7%,40m
13690,2,MajorSparkle,3126,0,0,2,2,0.0%,32m
13709,3,BaacChoy,3125,1563,299,285,584,51.2%,21m
13709,1,[0825]Joeschmo,3125,1772,270,242,512,52.7%,17m
13709,1,Haste,3125,1480,62,57,119,52.1%,3m
13709,1,Elbuen,3125,1325,56,38,94,59.6%,8m
13709,1,Decade,3125,1002,34,33,67,50.7%,19m
13709,3,gnome,3125,962,33,44,77,42.9%,34m
13709,3,NvrGoFurther,3125,716,24,41,65,36.9%,12m
13709,3,Slawsh,3125,450,19,18,37,51.4%,26m
13709,1,[PF2KXX]GLENTRON,3125,616,18,15,33,54.5%,2m
13709,3,DPOD,3125,308,16,11,27,59.3%,40m
13709,1,Pancry,3125,340,15,10,25,60.0%,22m
13709,3,[Unfad]Demise,3125,157,10,9,19,52.6%,5m
13709,3,Hoody,3125,262,10,14,24,41.7%,19m
13709,1,IMaximus,3125,154,7,5,12,58.3%,20m
13709,1,TONYMOLY,3125,78,2,2,4,50.0%,34m
13709,1,yeeyoo,3125,0,1,0,1,100.0%,7m
13709,1,Shootz,3125,0,1,0,1,100.0%,13m
13709,1,[iCumz]JerkInHoff,3125,0,1,0,1,100.0%,5m
13709,3,[SPCTAC]PullTheBOYS,3125,30,1,4,5,20.0%,13m
13709,1,[QcScT]WestSpirit,3125,0,0,1,1,0.0%,8m
13709,1,cruellawman,3125,0,0,1,1,0.0%,9m
13709,1,[αB]CaptainClub,3125,0,0,2,2,0.0%,22m
13731,3,Marles,3124,1315,173,141,314,55.1%,31m
13731,3,Tinyturtles,3124,969,102,98,200,51.0%,29m
13731,3,[GOPERÚ]Angeluz,3124,1528,68,73,141,48.2%,41m
13731,1,[GOPERÚ]iProblem,3124,1281,46,40,86,53.5%,26m
13731,3,[CRAKS]Hector,3124,788,41,36,77,53.2%,39m
13731,3,NinjaMonster,3124,796,28,33,61,45.9%,8m
13731,3,twitchBILICH,3124,621,26,25,51,51.0%,4m
13731,1,[TF66]NataS,3124,598,23,14,37,62.2%,20m
13731,3,Jillian,3124,487,19,15,34,55.9%,5m
13731,1,Forkster,3124,371,15,5,20,75.0%,18m
13731,3,Jonik,3124,440,15,22,37,40.5%,11m
13731,1,[FFAA]KINGWAR,3124,436,12,11,23,52.2%,17m
13731,1,BoganArmy,3124,270,8,2,10,80.0%,9m
13731,3,BananaBoyZ,3124,187,8,6,14,57.1%,42m
13731,3,[RdLzrd]MadRaccoon,3124,155,7,4,11,63.6%,14m
13731,1,Erdbeerblau,3124,42,4,2,6,66.7%,22m
13731,1,HOPE,3124,0,3,2,5,60.0%,9m
13731,1,[BUMFUK]CptInsano,3124,116,3,5,8,37.5%,14m
13731,1,Wagabooga,3124,42,2,1,3,66.7%,42m
13731,1,BumRush,3124,0,0,1,1,0.0%,17m
13731,1,Insulate,3124,0,0,1,1,0.0%,11m
13731,1,CRITTERMAN,3124,0,0,1,1,0.0%,2h
13731,1,HardTime,3124,0,0,2,2,0.0%,36m
13731,3,[Baitin]JAB,3124,0,0,3,3,0.0%,30m
13755,3,Michael,3123,1505,73,72,145,50.3%,38m
13755,3,xJPx,3123,1224,62,53,115,53.9%,39m
13755,3,HELPMEDECIDE,3123,895,38,34,72,52.8%,19m
13755,3,GreenFrog,3123,368,34,25,59,57.6%,23m
13755,3,[TITC]Hamburgler,3123,358,14,14,28,50.0%,35m
13755,3,folkero,3123,304,12,8,20,60.0%,10m
13755,3,[dMdC]PaulAtreides,3123,295,11,15,26,42.3%,21m
13755,1,[Ash3s]ZERGisOP,3123,205,8,4,12,66.7%,9m
13755,3,[KGH2]Typhon,3123,189,7,8,15,46.7%,40m
13755,1,[gam30n]Coldmilk,3123,184,6,1,7,85.7%,39m
13755,3,CapricorN,3123,30,5,3,8,62.5%,39m
13755,1,punto,3123,139,4,2,6,66.7%,27m
13755,1,Ryan,3123,40,2,2,4,50.0%,36m
13755,3,jubadubwub,3123,0,2,3,5,40.0%,3h
13755,1,FakeBisu,3123,0,1,0,1,100.0%,11m
13755,1,[Casidi]Ziel,3123,0,0,2,2,0.0%,17m
13755,1,Ethan,3123,0,0,2,2,0.0%,7m
13755,3,Sink,3123,0,0,6,6,0.0%,31m
13773,3,Tlaloc,3122,1582,192,193,385,49.9%,42m
13773,3,[HrdBdy]VanBuren,3122,1336,155,160,315,49.2%,32m
13773,3,TuTata,3122,1622,133,131,264,50.4%,4m
13773,3,Sitruc,3122,647,93,82,175,53.1%,13m
13773,1,SmoknCaliBud,3122,465,18,20,38,47.4%,18m
13773,3,Truco,3122,329,12,17,29,41.4%,24m
13773,3,Keks,3122,215,10,7,17,58.8%,15m
13773,3,FunkyPants,3122,191,8,7,15,53.3%,2m
13773,3,MechanismX,3122,121,5,2,7,71.4%,2h
13773,3,iDrunk,3122,30,5,3,8,62.5%,34m
13773,3,Martito,3122,120,5,24,29,17.2%,39m
13773,1,Bonjwa,3122,82,2,2,4,50.0%,38m
13773,1,[WicWac]stever,3122,96,2,2,4,50.0%,8m
13773,1,[BaIIz]almightyalf,3122,0,2,3,5,40.0%,21m
13773,3,Mayj,3122,16,2,4,6,33.3%,42m
13773,1,[GMBRs]GANK,3122,147,2,6,8,25.0%,28m
13773,1,[ODBs]KokaneeBeer,3122,0,1,0,1,100.0%,19m
13773,1,[GORF]Holaman,3122,97,1,5,6,16.7%,35m
13773,1,[Kaii]DavidMunra,3122,0,0,1,1,0.0%,28m
13773,3,eCakes,3122,0,0,4,4,0.0%,22m
13773,1,[Ever]TinkerJoe,3122,73,0,10,10,0.0%,28m
13794,1,simichon,3121,1778,236,223,459,51.4%,35m
13794,3,Waverr,3121,1366,187,181,368,50.8%,6m
13794,1,LuCkSs,3121,1489,132,116,248,53.2%,34m
13794,3,[ACSS]Dadams,3121,1241,52,46,98,53.1%,2m
13794,3,poon,3121,843,47,39,86,54.7%,5m
13794,1,Exo,3121,711,28,18,46,60.9%,19m
13794,3,[UTX]Azulidon,3121,694,24,30,54,44.4%,11m
13794,3,BOSSPROPHET,3121,555,22,17,39,56.4%,2m
13794,3,ButterSnapps,3121,334,13,11,24,54.2%,30m
13794,3,ZdRk,3121,288,13,22,35,37.1%,4m
13794,3,BadTouch,3121,291,12,8,20,60.0%,26m
13794,1,[1030]TEMPLAR,3121,260,8,2,10,80.0%,27m
13794,2,dandan,3121,166,7,3,10,70.0%,2h
13794,1,Athreos,3121,97,5,3,8,62.5%,29m
13794,1,Strider,3121,0,4,1,5,80.0%,31m
13794,3,bigblackbot,3121,94,4,3,7,57.1%,40m
13794,1,TheAxe,3121,78,3,0,3,100.0%,15m
13794,3,Summer,3121,90,3,6,9,33.3%,18m
13794,1,[TimTom]Zzoram,3121,42,2,0,2,100.0%,20m
13794,3,IdealBronze,3121,0,2,3,5,40.0%,2h
13794,1,[GØSU]badnickton,3121,0,0,1,1,0.0%,38m
13794,1,[jneltn]Joshua,3121,0,0,1,1,0.0%,27m
13794,2,GyroZeppeli,3121,0,0,2,2,0.0%,34m
13794,1,COFFE,3121,73,0,2,2,0.0%,3m
13818,3,GlassCannon,3120,1506,333,320,653,51.0%,16m
13818,3,[FNDog]FNDAlTheLiar,3120,1561,184,181,365,50.4%,23m
13818,3,[Macac0]sakura,3120,1586,133,136,269,49.4%,26m
13818,3,[ValidG]hdmark,3120,1335,131,111,242,54.1%,26m
13818,3,Incognita,3120,1381,120,111,231,51.9%,38m
13818,3,NesbanoOs,3120,1240,105,106,211,49.8%,27m
13818,3,[Pig2]Kranlor,3120,460,65,51,116,56.0%,12m
13818,1,[WWP2]BeTheSun,3120,569,25,15,40,62.5%,9m
13818,3,[HKvT]Frag,3120,582,23,23,46,50.0%,4m
13818,1,Light,3120,617,20,16,36,55.6%,19m
13818,1,Sweet,3120,438,16,12,28,57.1%,34m
13818,3,[Madn3s]MeatXD,3120,152,6,13,19,31.6%,13m
13818,1,[HoFoCo]Dom,3120,164,5,3,8,62.5%,8m
13818,2,killerReong,3120,141,5,5,10,50.0%,22m
13818,3,jpl,3120,146,5,10,15,33.3%,2m
13818,3,Illidor,3120,0,4,1,5,80.0%,29m
13818,1,Rouman,3120,89,4,2,6,66.7%,3m
13818,3,Kiryu,3120,88,4,5,9,44.4%,12m
13818,3,[FzyDG]BLaZe,3120,120,4,8,12,33.3%,19m
13818,3,Knicks,3120,88,4,9,13,30.8%,37m
13818,1,Flyingmonkey,3120,124,3,4,7,42.9%,28m
13818,1,[DeRugz]Shade,3120,0,1,0,1,100.0%,15m
13818,1,Mantecrise,3120,0,0,1,1,0.0%,36m
13841,1,Sorrow,3119,707,63,55,118,53.4%,19m
13841,1,[sbboys]geoluo,3119,1128,39,37,76,51.3%,26m
13841,1,ArchonToilet,3119,420,38,24,62,61.3%,18m
13841,3,Racoon,3119,1028,37,41,78,47.4%,4m
13841,3,Wolf,3119,583,24,22,46,52.2%,2m
13841,1,fireAtWill,3119,520,20,13,33,60.6%,36m
13841,1,[WOTDL]ALUCARD,3119,306,9,6,15,60.0%,10m
13841,3,TugginJugs,3119,240,8,17,25,32.0%,31m
13841,1,ILikeTrains,3119,0,5,0,5,100.0%,31m
13841,1,scaflowking,3119,114,4,0,4,100.0%,20m
13841,1,Hal,3119,157,3,3,6,50.0%,36m
13841,3,[NPhasA]Sketch,3119,90,3,20,23,13.0%,26m
13841,1,Alyatasy,3119,82,2,1,3,66.7%,8m
13841,1,zokj,3119,0,0,1,1,0.0%,7m
13841,3,LoremIpsum,3119,0,0,1,1,0.0%,25m
13841,1,[SBXX]Yeloow,3119,0,0,1,1,0.0%,9m
13841,1,DlCKFEET,3119,0,0,5,5,0.0%,5m
13858,3,[DRKRIS]Darkstar,3118,1525,500,486,986,50.7%,25m
13858,3,Dadbod,3118,1487,199,178,377,52.8%,35m
13858,3,Pistol,3118,692,196,179,375,52.3%,8m
13858,3,[LCE]Draco,3118,1243,94,92,186,50.5%,36m
13858,3,Hirako,3118,1412,90,72,162,55.6%,19m
13858,3,[AD3C]Draco,3118,728,83,73,156,53.2%,37m
13858,1,Azhrei,3118,1242,67,32,99,67.7%,27m
13858,3,Fragments,3118,836,64,53,117,54.7%,26m
13858,1,Mike,3118,834,37,31,68,54.4%,15m
13858,3,SCJunkie,3118,389,28,29,57,49.1%,31m
13858,3,Zulu,3118,533,24,25,49,49.0%,42m
13858,1,Cervezerg,3118,666,21,17,38,55.3%,27m
13858,1,CatchingZs,3118,440,17,9,26,65.4%,23m
13858,3,Pejelargarto,3118,410,17,11,28,60.7%,31m
13858,1,Herod,3118,566,16,19,35,45.7%,23m
13858,3,SnarkyLing,3118,112,15,12,27,55.6%,35m
13858,3,Robit,3118,354,13,16,29,44.8%,32m
13858,1,vincee,3118,360,11,7,18,61.1%,39m
13858,3,Saskuk,3118,340,11,20,31,35.5%,9m
13858,1,TheVoid,3118,286,9,9,18,50.0%,15m
13858,1,Nico,3118,322,9,9,18,50.0%,22m
13858,3,Demtros,3118,246,9,12,21,42.9%,15m
13858,1,Rezalina,3118,190,8,6,14,57.1%,2h
13858,3,[VENSC2]WolfitO,3118,172,6,10,16,37.5%,12m
13858,3,Mark,3118,136,5,17,22,22.7%,17m
13858,3,FFXIVqueue,3118,0,3,3,6,50.0%,2h
13858,1,MaMaMuse,3118,124,3,4,7,42.9%,9m
13858,3,[TURD5]Mosh,3118,60,3,6,9,33.3%,22m
13858,1,[GnR]dangerzone,3118,38,2,1,3,66.7%,28m
13858,1,[nieBla]BERNAMTY,3118,0,0,1,1,0.0%,36m
13858,1,[LDCO]skaterdark,3118,0,0,1,1,0.0%,7m
13858,1,[BGYR]JaceLith,3118,0,0,2,2,0.0%,41m
13890,3,Juanquinte,3117,1575,216,200,416,51.9%,32m
13890,1,MOJ,3117,1255,66,66,132,50.0%,11m
13890,1,Rhines,3117,734,26,19,45,57.8%,37m
13890,1,nothavephone,3117,730,25,17,42,59.5%,22m
13890,3,King,3117,428,25,20,45,55.6%,12m
13890,3,[Shota]Lakshmi,3117,198,20,31,51,39.2%,37m
13890,3,[SC2DD]MadSon,3117,444,18,14,32,56.2%,39m
13890,3,StupidProbe,3117,396,18,14,32,56.2%,2m
13890,2,Basketcase,3117,117,6,1,7,85.7%,26m
13890,2,[kØ]Drayden,3117,119,5,4,9,55.6%,1h
13890,1,PanTo,3117,195,5,5,10,50.0%,21m
13890,1,Ushijima,3117,0,4,1,5,80.0%,9m
13890,1,tHcsMoKeR,3117,120,3,2,5,60.0%,7m
13890,1,ShoryuKen,3117,40,3,4,7,42.9%,26m
13890,3,Zakarumae,3117,62,2,5,7,28.6%,19m
13890,1,Ace,3117,0,1,0,1,100.0%,43m
13890,1,[Cind3r]Mannercat,3117,0,1,0,1,100.0%,12m
13890,3,ItzKrupp,3117,0,1,2,3,33.3%,13m
13890,3,StixZadinia,3117,0,0,4,4,0.0%,23m
13909,3,[M3A5]DrawBlee,3116,1581,178,165,343,51.9%,40m
13909,3,Sparhawk,3116,1459,114,116,230,49.6%,40m
13909,1,[GEEKED]Freelance,3116,1773,86,80,166,51.8%,32m
13909,1,[iCrapp]MrPooped,3116,1712,83,79,162,51.2%,41m
13909,1,Estuardo,3116,1266,71,66,137,51.8%,18m
13909,1,mfbih,3116,585,22,16,38,57.9%,11m
13909,1,Fonte,3116,554,19,15,34,55.9%,28m
13909,3,[JD]Reminis,3116,304,13,11,24,54.2%,35m
13909,1,Shinta,3116,323,9,4,13,69.2%,41m
13909,1,WhiteMonster,3116,159,7,3,10,70.0%,5m
13909,1,Spooked,3116,260,6,3,9,66.7%,26m
13909,1,HotCarl,3116,186,5,4,9,55.6%,41m
13909,3,bee,3116,126,4,13,17,23.5%,21m
13909,1,Giggles,3116,80,2,1,3,66.7%,24m
13909,1,[Quackk]Ames,3116,82,2,2,4,50.0%,28m
13909,1,[SHMT]JSLAY,3116,0,1,1,2,50.0%,40m
13909,1,Solorak,3116,0,0,1,1,0.0%,18m
13926,3,JkayLumpur,3115,1543,180,155,335,53.7%,38m
13926,3,[LOLski]SugarGene,3115,1181,75,70,145,51.7%,10m
13926,1,[tCo9]thor,3115,1499,72,52,124,58.1%,10m
13926,3,Zergi,3115,663,51,49,100,51.0%,12m
13926,3,[CS0]ShadowWil,3115,934,35,32,67,52.2%,27m
13926,3,TheSnake,3115,512,22,23,45,48.9%,2m
13926,3,Screwface,3115,471,21,20,41,51.2%,17m
13926,1,OldPork,3115,534,15,14,29,51.7%,10m
13926,3,begone,3115,206,14,13,27,51.9%,41m
13926,3,Kerrigan,3115,262,12,8,20,60.0%,42m
13926,1,[KUMS]Monsters,3115,394,11,8,19,57.9%,30m
13926,3,[DSKLRS]Slove,3115,300,11,15,26,42.3%,32m
13926,3,[HARLET]SENJUxMIGUEL,3115,279,10,12,22,45.5%,31m
13926,1,PinkPanther,3115,188,6,3,9,66.7%,19m
13926,2,JamJitsu,3115,140,5,3,8,62.5%,2h
13926,3,DrunkDoozins,3115,120,4,4,8,50.0%,21m
13926,1,[sk3tch]Calm,3115,118,3,4,7,42.9%,42m
13926,1,[MAGA1]deadpool,3115,124,3,6,9,33.3%,39m
13926,3,JACKJAS,3115,85,3,12,15,20.0%,26m
13926,3,DeepThot,3115,58,2,6,8,25.0%,30m
13926,1,darckfenix,3115,40,1,1,2,50.0%,37m
13926,2,toyorom,3115,0,0,1,1,0.0%,42m
13926,1,[crpwr]gamecreator,3115,0,0,1,1,0.0%,11m
13926,1,ProTerrZer,3115,0,0,1,1,0.0%,32m
13926,1,Sheldor,3115,0,0,1,1,0.0%,36m
13926,1,[PTHero]Juvator,3115,0,0,1,1,0.0%,2m
13926,3,MaoShiSi,3115,0,0,1,1,0.0%,57m
13926,1,Wimmy,3115,0,0,2,2,0.0%,3m
13954,3,[CHEE53]MOSFET,3114,1338,201,188,389,51.7%,28m
13954,3,DMT,3114,1583,134,129,263,51.0%,35m
13954,3,Fiddlefiend,3114,1215,87,80,167,52.1%,11m
13954,3,CodeAka,3114,1039,77,56,133,57.9%,31m
13954,3,IryS,3114,305,65,66,131,49.6%,26m
13954,1,[GrnBrd]Reiky,3114,926,48,8,56,85.7%,41m
13954,3,all,3114,766,47,52,99,47.5%,5m
13954,1,[r4mp4g]Bokonon,3114,977,44,36,80,55.0%,25m
13954,1,MagicEarth,3114,876,39,23,62,62.9%,21m
13954,3,Izanagi,3114,783,38,36,74,51.4%,34m
13954,1,NoStaples,3114,920,37,24,61,60.7%,7m
13954,3,[TNBII]wzqwzq,3114,650,33,39,72,45.8%,26m
13954,3,Demi,3114,623,26,23,49,53.1%,2m
13954,3,[1408]Infection,3114,582,19,21,40,47.5%,27m
13954,3,[PSF]Matik,3114,381,16,10,26,61.5%,31m
13954,3,helloworld,3114,219,11,6,17,64.7%,42m
13954,2,IIIIIIIIIIII,3114,204,8,4,12,66.7%,2h
13954,3,MAERI,3114,229,8,6,14,57.1%,32m
13954,1,[HDL]Zareth,3114,204,6,5,11,54.5%,23m
13954,1,Lechuga,3114,121,5,3,8,62.5%,31m
13954,3,BigSexxy,3114,171,5,6,11,45.5%,20m
13954,1,Outsider,3114,194,5,6,11,45.5%,27m
13954,1,Mike,3114,141,3,2,5,60.0%,2h
13954,1,Zrevryr,3114,0,3,2,5,60.0%,9m
13954,3,Anticlimaxic,3114,49,3,8,11,27.3%,20m
13954,1,[Axioms]Goldstein,3114,0,1,1,2,50.0%,3m
13954,2,[StepUp]DirtyFlamer,3114,0,0,1,1,0.0%,31m
13954,1,elviolatumba,3114,0,0,1,1,0.0%,26m
13954,1,ASD,3114,0,0,3,3,0.0%,27m
13983,3,BlueIbaneZac,3113,1033,221,203,424,52.1%,30m
13983,3,Dulvalius,3113,702,202,196,398,50.8%,39m
13983,1,Maruhachi,3113,1203,71,65,136,52.2%,37m
13983,1,TheBoomer,3113,1043,51,17,68,75.0%,9m
13983,3,BigChedda,3113,842,37,26,63,58.7%,40m
13983,3,Draconum,3113,103,30,20,50,60.0%,10m
13983,3,Lilzerglin,3113,615,29,18,47,61.7%,34m
13983,1,[MluvK]MyBFMadeMe,3113,878,28,23,51,54.9%,36m
13983,3,[AKAY47]TigOlBitties,3113,281,26,22,48,54.2%,8m
13983,3,Nightmare,3113,760,26,27,53,49.1%,31m
13983,1,[lnCo]Wukong,3113,402,20,14,34,58.8%,2m
13983,3,LquidCourage,3113,481,17,19,36,47.2%,12m
13983,3,SYLAR,3113,330,11,21,32,34.4%,31m
13983,3,FearNot,3113,248,8,14,22,36.4%,7m
13983,2,YoanSingSong,3113,142,6,3,9,66.7%,56m
13983,3,IIIIIIIIIIII,3113,150,5,2,7,71.4%,42m
13983,2,[KING3]mightemacs,3113,116,5,3,8,62.5%,48m
13983,3,valithor,3113,0,4,1,5,80.0%,9m
13983,3,ILoveChina,3113,0,4,2,6,66.7%,2m
13983,1,nameless,3113,113,3,7,10,30.0%,39m
13983,1,Thusnani,3113,0,1,0,1,100.0%,40m
13983,3,Swell,3113,96,1,1,2,50.0%,16m
13983,3,Gazgmr,3113,97,1,1,2,50.0%,25m
13983,3,graf,3113,0,1,3,4,25.0%,19m
13983,1,burperfire,3113,0,0,2,2,0.0%,42m
13983,1,[EGx]baphomet,3113,0,0,2,2,0.0%,39m
13983,3,[SWMX]Poethi,3113,0,0,5,5,0.0%,31m
14010,3,[TACTEC]FlyingFuq,3112,1629,341,323,664,51.4%,9m
14010,2,KingOfRage,3112,1583,223,238,461,48.4%,28m
14010,3,[CUKES]Reaver,3112,1613,192,187,379,50.7%,29m
14010,1,superkyler,3112,796,53,29,82,64.6%,9m
14010,1,drip,3112,1157,40,34,74,54.1%,29m
14010,3,Varthlokkur,3112,597,29,35,64,45.3%,15m
14010,3,BadPro,3112,230,19,21,40,47.5%,20m
14010,3,Schnitzel,3112,419,16,11,27,59.3%,22m
14010,2,[NCI]DocHoliday,3112,142,5,2,7,71.4%,30m
14010,1,Omegaryu,3112,89,4,2,6,66.7%,17m
14010,3,MaJLioN,3112,0,4,3,7,57.1%,9m
14010,1,SmurfDaddy,3112,80,3,0,3,100.0%,2m
14010,1,SpiriT,3112,80,3,2,5,60.0%,40m
14010,1,[ChDe]Lechuga,3112,0,1,0,1,100.0%,3m
14010,3,MacTassadar,3112,0,1,3,4,25.0%,2m
14025,3,[IiUiI]CRIXuS,3111,1585,298,285,583,51.1%,37m
14025,3,Nathan,3111,1194,75,74,149,50.3%,20m
14025,1,Wernah,3111,1783,72,72,144,50.0%,29m
14025,1,alfonzo,3111,942,63,52,115,54.8%,42m
14025,3,[Aztc]xXGafeXx,3111,477,45,40,85,52.9%,5m
14025,1,[iPunK]Vancey,3111,713,32,15,47,68.1%,9m
14025,3,[SINSTR]emmanuelgx,3111,441,32,46,78,41.0%,20m
14025,1,[Quetza]Warsong,3111,814,29,20,49,59.2%,23m
14025,3,Wiper,3111,854,28,40,68,41.2%,5m
14025,3,[2faded]Roger,3111,522,27,17,44,61.4%,21m
14025,3,Epidemic,3111,559,20,19,39,51.3%,9m
14025,2,MMK,3111,250,12,10,22,54.5%,22m
14025,1,WoodLeague,3111,363,11,7,18,61.1%,12m
14025,3,[ISTime]Max,3111,320,10,25,35,28.6%,24m
14025,1,orion,3111,222,7,3,10,70.0%,10m
14025,3,joth,3111,225,7,7,14,50.0%,26m
14025,2,[XMX]Fehnryr,3111,92,6,5,11,54.5%,46m
14025,3,[ØFoxF2]Moxterr,3111,150,6,8,14,42.9%,10m
14025,2,singlemom,3111,222,6,8,14,42.9%,23m
14025,3,malahaas,3111,80,4,8,12,33.3%,32m
14025,3,[LQV]Vexon,3111,122,3,3,6,50.0%,34m
14025,1,IIIIIIIIIIIl,3111,143,3,4,7,42.9%,2h
14025,1,OmegaOdin,3111,0,0,1,1,0.0%,2h
14025,1,Stoyer,3111,0,0,1,1,0.0%,27m
14025,2,[Cind3r]ZeDuctTape,3111,0,0,2,2,0.0%,6m
14025,1,Anything,3111,0,0,2,2,0.0%,30m
14025,1,Shivyk,3111,0,0,2,2,0.0%,3m
14052,3,[QUIEEE]martinburgos,3110,1346,107,88,195,54.9%,40m
14052,3,YaMajesty,3110,1423,79,75,154,51.3%,34m
14052,3,[ValidG]kityoverlord,3110,1268,76,71,147,51.7%,25m
14052,3,[UpeV]Saggy,3110,774,29,35,64,45.3%,9m
14052,3,Towhom,3110,588,24,25,49,49.0%,32m
14052,3,[PEINF]SirFrancO,3110,346,15,9,24,62.5%,7m
14052,1,Inferno,3110,395,13,13,26,50.0%,11m
14052,3,TechGuyZach,3110,366,11,27,38,28.9%,37m
14052,1,PQPE,3110,342,9,11,20,45.0%,19m
14052,3,[CCA]BlazerUAB,3110,129,4,2,6,66.7%,13m
14052,1,DNguy,3110,120,4,4,8,50.0%,10m
14052,1,nofratos,3110,44,2,0,2,100.0%,36m
14052,3,Sisifo,3110,30,2,3,5,40.0%,39m
14052,3,Algorondrugz,3110,30,1,7,8,12.5%,5m
14052,1,wstick,3110,0,0,1,1,0.0%,36m
14052,1,[4g63]talntid,3110,0,0,1,1,0.0%,42m
14052,1,KorruptMind,3110,0,0,1,1,0.0%,11m
14052,3,KumaKamui,3110,0,0,1,1,0.0%,4m
14052,1,skylis,3110,0,0,3,3,0.0%,21m
14071,3,[EZkill]AgentVX,3109,1522,886,869,1755,50.5%,37m
14071,3,Tenderoni,3109,1542,139,135,274,50.7%,19m
14071,3,Playmakr,3109,1367,68,59,127,53.5%,31m
14071,3,[BT44]Mako,3109,1093,49,52,101,48.5%,4m
14071,1,Sei,3109,984,37,29,66,56.1%,7m
14071,1,proxicon,3109,732,36,32,68,52.9%,2m
14071,3,Angelofdeath,3109,690,28,24,52,53.8%,15m
14071,1,locost,3109,508,15,12,27,55.6%,35m
14071,3,CROSS,3109,350,15,16,31,48.4%,27m
14071,1,CHOEzilla,3109,254,8,4,12,66.7%,20m
14071,3,[BLEED]Blade,3109,121,5,2,7,71.4%,57m
14071,1,Min,3109,186,5,2,7,71.4%,39m
14071,1,ISITBUTTADOE,3109,185,5,2,7,71.4%,31m
14071,3,[nieBla]nightmarionn,3109,150,4,5,9,44.4%,22m
14071,3,SpaceCadet,3109,119,3,1,4,75.0%,22m
14071,3,ilovetamayo,3109,0,3,2,5,60.0%,32m
14071,1,Shockzone,3109,0,1,0,1,100.0%,7m
14071,1,Leev,3109,0,0,1,1,0.0%,31m
14089,3,StarMaster,3108,1568,357,301,658,54.3%,15m
14089,3,SpaceSquid,3108,933,182,145,327,55.7%,39m
14089,3,SchnittBrot,3108,1531,169,171,340,49.7%,41m
14089,3,Froissart,3108,614,64,56,120,53.3%,7m
14089,3,TheeMaTyLoko,3108,480,39,31,70,55.7%,7m
14089,1,[SsaYnS]DarkPrelate,3108,1028,35,31,66,53.0%,41m
14089,1,Lithium,3108,489,14,17,31,45.2%,35m
14089,3,[TLAN]Timbits,3108,294,11,13,24,45.8%,9m
14089,1,IIIIIIIIIIII,3108,232,7,2,9,77.8%,27m
14089,1,Gnome,3108,117,6,3,9,66.7%,16m
14089,1,suripat,3108,214,5,3,8,62.5%,31m
14089,3,Nice,3108,30,5,3,8,62.5%,42m
14089,3,Tenko,3108,154,5,8,13,38.5%,41m
14089,1,[LycanZ]WolfWarriorZ,3108,177,4,1,5,80.0%,25m
14089,1,Frazer,3108,76,2,3,5,40.0%,26m
14089,3,WhiteWhaleLo,3108,0,1,0,1,100.0%,28m
14089,1,[12AM]Thebigboss,3108,42,1,1,2,50.0%,7m
14089,1,Pooooooo,3108,0,0,1,1,0.0%,13m
14089,1,KiryuCoCo,3108,0,0,1,1,0.0%,31m
14108,3,[CHAOSV]Griffin,3107,1238,113,104,217,52.1%,30m
14108,3,[PuC]Cain,3107,481,34,23,57,59.6%,26m
14108,3,[Snooot]meRhNa,3107,656,25,26,51,49.0%,36m
14108,1,Pincho,3107,528,23,11,34,67.6%,7m
14108,1,Coulomb,3107,614,19,16,35,54.3%,8m
14108,3,Nag,3107,437,17,26,43,39.5%,30m
14108,1,[DASJ3W]Hodorbig,3107,162,8,5,13,61.5%,19m
14108,2,[CARNES]Inquisidor,3107,96,6,2,8,75.0%,2h
14108,2,Qartar,3107,141,6,3,9,66.7%,2h
14108,3,Mattzke,3107,134,4,3,7,57.1%,15m
14108,1,LinK,3107,114,4,4,8,50.0%,10m
14108,1,Spiff,3107,118,3,2,5,60.0%,2m
14108,1,WingDangus,3107,80,3,2,5,60.0%,15m
14108,1,[SppDk]mrsuperduck,3107,114,3,3,6,50.0%,4m
14108,1,DingusKhan,3107,128,3,4,7,42.9%,19m
14108,3,ElChup,3107,134,3,5,8,37.5%,23m
14108,1,TheGingasian,3107,38,2,0,2,100.0%,23m
14108,1,DemonSlayer,3107,42,2,3,5,40.0%,34m
14108,1,AnanZero,3107,0,1,0,1,100.0%,9m
14108,1,MarCraft,3107,0,1,0,1,100.0%,7m
14108,1,llllllllllll,3107,0,0,1,1,0.0%,38m
14108,1,BRoWNSHaDoW,3107,0,0,2,2,0.0%,2h
14130,3,[MLC]TIGHTEEEST,3106,978,109,97,206,52.9%,37m
14130,3,kronos,3106,696,107,104,211,50.7%,26m
14130,3,RaMz,3106,1575,90,77,167,53.9%,9m
14130,1,Kale,3106,1093,70,68,138,50.7%,34m
14130,1,eKHoli,3106,1152,48,35,83,57.8%,27m
14130,3,[PobSC]VocaloidBot,3106,843,40,32,72,55.6%,23m
14130,3,Remz,3106,975,38,40,78,48.7%,22m
14130,3,baabaa,3106,784,31,27,58,53.4%,31m
14130,3,Boudichon,3106,318,21,17,38,55.3%,23m
14130,3,IIIIIIIIIIII,3106,487,19,17,36,52.8%,20m
14130,3,Sareth,3106,382,17,11,28,60.7%,4m
14130,3,RaccoonFive,3106,120,8,7,15,53.3%,36m
14130,1,[LØGIA]FateRider,3106,244,7,4,11,63.6%,17m
14130,1,MDPhD,3106,148,4,4,8,50.0%,19m
14130,3,RailBunnysMA,3106,0,3,1,4,75.0%,59m
14130,3,[ZTemp]HydralisK,3106,149,3,6,9,33.3%,24m
14130,3,[LHRS]MBF,3106,30,1,10,11,9.1%,23m
14130,1,Ragnarok,3106,0,0,1,1,0.0%,17m
14130,1,PLeAsure,3106,0,0,1,1,0.0%,19m
14130,1,[FU2]Skull,3106,0,0,1,1,0.0%,9m
14150,3,Hodor,3105,1250,284,247,531,53.5%,41m
14150,3,Billsters,3105,1651,207,190,397,52.1%,26m
14150,3,LBD,3105,1168,141,135,276,51.1%,18m
14150,1,[USA100]SixNine,3105,1389,114,85,199,57.3%,31m
14150,3,[LOHd]Liam,3105,1578,89,86,175,50.9%,13m
14150,3,SideshoweBob,3105,875,68,62,130,52.3%,26m
14150,1,[MoLaMa]PoofyRhino,3105,991,64,45,109,58.7%,39m
14150,3,Sauer,3105,1338,50,61,111,45.0%,34m
14150,1,[SULFER]steventoast,3105,583,31,24,55,56.4%,27m
14150,1,Kitofxs,3105,788,30,22,52,57.7%,34m
14150,1,[FLU5H]ArchonToilet,3105,553,21,24,45,46.7%,23m
14150,1,[YDRA]Güts,3105,624,20,17,37,54.1%,12m
14150,3,Mincho,3105,402,17,19,36,47.2%,18m
14150,3,[dLife]CDNshepard,3105,373,12,12,24,50.0%,4m
14150,1,South,3105,306,10,2,12,83.3%,40m
14150,1,Fractal,3105,306,9,7,16,56.2%,3m
14150,1,Mefistófeles,3105,242,7,4,11,63.6%,2h
14150,1,kfcnhl,3105,166,7,6,13,53.8%,2h
14150,1,FatKid,3105,188,5,5,10,50.0%,39m
14150,1,[ASSWIP]smuggins,3105,40,1,1,2,50.0%,19m
14150,1,BigRick,3105,46,1,2,3,33.3%,3h
14150,2,[iDrunk]xplicity,3105,46,1,4,5,20.0%,33m
14150,3,Blitz,3105,0,1,4,5,20.0%,2m
14150,1,rmortz,3105,0,0,1,1,0.0%,31m
14174,1,[TGosuA]Shadowmantle,3104,1769,142,101,243,58.4%,4m
14174,1,Brianteo,3104,888,87,32,119,73.1%,35m
14174,3,[AbcCo]FleshMan,3104,987,64,59,123,52.0%,10m
14174,3,Raynor,3104,1072,46,40,86,53.5%,31m
14174,1,[TGosuA]Rolch,3104,1112,45,43,88,51.1%,12m
14174,1,[MacMic]AngelOfGod,3104,688,40,1,41,97.6%,31m
14174,3,[Exper]Tanus,3104,555,30,20,50,60.0%,16m
14174,3,Rixxon,3104,724,26,29,55,47.3%,32m
14174,1,Anandamide,3104,656,20,19,39,51.3%,35m
14174,1,SpyteSoulmat,3104,330,14,11,25,56.0%,30m
14174,1,Pmoney,3104,194,8,5,13,61.5%,18m
14174,3,SRK,3104,234,8,7,15,53.3%,16m
14174,1,[XTGZ]Zhubouchi,3104,188,6,4,10,60.0%,9m
14174,3,[NAROKO]NAROKO,3104,109,6,5,11,54.5%,4m
14174,1,unuuna,3104,114,3,2,5,60.0%,21m
14174,1,zealot,3104,80,2,5,7,28.6%,29m
14174,1,llllllllllll,3104,0,1,0,1,100.0%,7m
14174,1,DaniBranigan,3104,38,1,1,2,50.0%,9m
14174,1,[isVIP]redPac,3104,0,0,1,1,0.0%,41m
14174,1,Nam,3104,0,0,2,2,0.0%,38m
14174,3,[KRAFTT]EluSivE,3104,0,0,6,6,0.0%,2m
14195,3,[NPhasA]Chen,3103,1576,451,428,879,51.3%,25m
14195,3,JoJo,3103,1627,151,154,305,49.5%,27m
14195,3,Kazr,3103,1425,85,70,155,54.8%,27m
14195,3,Nero,3103,1060,72,66,138,52.2%,39m
14195,3,[KITG]subtleclown,3103,475,21,17,38,55.3%,7m
14195,3,yahu,3103,320,11,13,24,45.8%,8m
14195,3,think,3103,215,10,9,19,52.6%,38m
14195,1,Tiger,3103,360,10,9,19,52.6%,3m
14195,3,[TxPain]IIcptII,3103,307,10,11,21,47.6%,19m
14195,1,[LQV]IJGI,3103,188,6,2,8,75.0%,29m
14195,1,Sigma,3103,120,6,2,8,75.0%,11m
14195,1,[TLibre]DasTier,3103,192,5,6,11,45.5%,23m
14195,2,[EZClep]Madsniper,3103,185,3,9,12,25.0%,2h
14195,1,[SGSPP]Sushiagogo,3103,40,2,1,3,66.7%,31m
14195,1,[SCVM]nightkiller,3103,0,1,0,1,100.0%,13m
14195,1,Killjoy,3103,42,1,1,2,50.0%,42m
14195,1,[ValidG]PoisonTrail,3103,44,1,2,3,33.3%,20m
14195,1,bobinski,3103,0,1,4,5,20.0%,41m
14195,2,Miroku,3103,0,0,1,1,0.0%,35m
14195,1,toastking,3103,0,0,2,2,0.0%,19m
14215,3,Mustacracken,3102,1108,356,358,714,49.9%,4m
14215,3,[xTWx]Dustar,3102,1317,159,165,324,49.1%,17m
14215,1,Tekniques,3102,1774,102,102,204,50.0%,7m
14215,1,XiitOnXi,3102,724,23,42,65,35.4%,34m
14215,1,FourTwentyXD,3102,341,15,6,21,71.4%,36m
14215,1,BoGrIM,3102,156,5,3,8,62.5%,19m
14215,1,PremierBush,3102,207,5,9,14,35.7%,19m
14215,1,Striker,3102,97,4,2,6,66.7%,3h
14215,3,mmmmm,3102,120,2,1,3,66.7%,9m
14215,3,DoubleZee,3102,0,2,3,5,40.0%,42m
14215,1,[H3xPr0]snowditer,3102,0,1,0,1,100.0%,23m
14215,1,ROB,3102,0,1,0,1,100.0%,35m
14215,1,KIN,3102,0,1,0,1,100.0%,30m
14215,1,piry,3102,0,0,1,1,0.0%,19m
14215,1,amoresvida,3102,0,0,1,1,0.0%,15m
14215,3,[CDC51]Lampião,3102,0,0,4,4,0.0%,18m
14231,3,Bibulus,3101,403,29,23,52,55.8%,39m
14231,3,[Sobro]Raynor,3101,606,26,19,45,57.8%,17m
14231,2,Sidewinder,3101,302,13,10,23,56.5%,28m
14231,3,Wallens,3101,160,7,5,12,58.3%,41m
14231,1,Igor,3101,148,7,7,14,50.0%,36m
14231,3,hatsunemiku,3101,30,5,3,8,62.5%,36m
14231,1,GayMaster,3101,123,4,4,8,50.0%,39m
14231,3,LukeSargent,3101,120,4,10,14,28.6%,31m
14231,1,NeoSecond,3101,0,1,0,1,100.0%,12m
14231,1,FrozenCloud,3101,0,1,0,1,100.0%,14m
14231,3,MangoKim,3101,0,0,1,1,0.0%,28m
14242,3,ForThebugs,3100,1569,247,229,476,51.9%,23m
14242,3,RockThePlank,3100,1227,158,140,298,53.0%,18m
14242,3,Raptor,3100,1508,145,129,274,52.9%,27m
14242,3,Peirce,3100,1481,88,89,177,49.7%,19m
14242,1,Omega,3100,943,39,23,62,62.9%,16m
14242,3,Jeremy,3100,492,21,24,45,46.7%,27m
14242,1,[OceanT]LowLinK,3100,337,12,4,16,75.0%,36m
14242,3,CSharpGuy,3100,234,10,7,17,58.8%,8m
14242,3,SpartanCL,3100,248,8,11,19,42.1%,37m
14242,1,AwesomeSauce,3100,88,5,1,6,83.3%,39m
14242,3,JimRaynor,3100,97,5,1,6,83.3%,2h
14242,2,DaDrunkTinMa,3100,96,5,3,8,62.5%,2h
14242,3,Profet,3100,97,4,2,6,66.7%,1h
14242,3,Nox,3100,92,4,5,9,44.4%,4m
14242,3,ramsay,3100,122,4,9,13,30.8%,2m
14242,1,Simphiwe,3100,0,3,4,7,42.9%,17m
14242,1,[Zcythe]Talathoin,3100,36,1,1,2,50.0%,23m
14242,1,Gromdown,3100,40,1,2,3,33.3%,31m
14242,1,[HDZB]ccrich,3100,0,1,4,5,20.0%,22m
14242,1,RavenStrike,3100,0,0,1,1,0.0%,12m
14242,1,KIPPER,3100,0,0,1,1,0.0%,35m
14242,1,[αB]WarbuffII,3100,0,0,1,1,0.0%,23m
14242,1,Nematic,3100,0,0,1,1,0.0%,25m
14242,3,Duffman,3100,0,0,5,5,0.0%,26m
14266,3,LastMohican,3099,1562,297,283,580,51.2%,8m
14266,3,[EvilCC]Magnifico,3099,1468,158,168,326,48.5%,12m
14266,3,Mimic,3099,1518,92,107,199,46.2%,22m
14266,3,Lucky,3099,794,72,62,134,53.7%,28m
14266,1,Alazon,3099,1671,65,58,123,52.8%,9m
14266,1,Enter,3099,483,17,17,34,50.0%,12m
14266,3,Kuntzy,3099,293,16,17,33,48.5%,27m
14266,1,[MCSWG]wetdog,3099,463,15,12,27,55.6%,9m
14266,3,SadKingBilly,3099,247,12,8,20,60.0%,6m
14266,1,LifABaThur,3099,204,5,8,13,38.5%,38m
14266,3,luffy,3099,40,2,7,9,22.2%,4m
14266,3,Jake,3099,30,2,7,9,22.2%,12m
14266,1,[SocDis]IlIlllIlllII,3099,40,1,2,3,33.3%,21m
14266,3,SuperMage,3099,30,1,3,4,25.0%,6m
14266,1,naband,3099,0,0,1,1,0.0%,10m
14266,1,[ZCProL]Shigotoshiro,3099,0,0,3,3,0.0%,35m
14282,3,DeadPool,3098,1508,334,326,660,50.6%,39m
14282,3,Qhuengi,3098,1566,262,258,520,50.4%,7m
14282,3,dragonslayer,3098,1034,248,220,468,53.0%,19m
14282,3,TheVade,3098,1546,197,157,354,55.6%,40m
14282,3,[Flam3s]Mumbles,3098,1565,101,107,208,48.6%,34m
14282,1,SBSSkazzo,3098,644,46,44,90,51.1%,20m
14282,1,Treher,3098,1031,37,29,66,56.1%,10m
14282,3,VeN,3098,794,37,37,74,50.0%,29m
14282,1,indometh,3098,315,13,14,27,48.1%,16m
14282,3,ace,3098,281,9,10,19,47.4%,7m
14282,1,[Helsm]llDriverning,3098,164,5,2,7,71.4%,21m
14282,3,Lovesare,3098,121,5,2,7,71.4%,1h
14282,2,[Wafflz]Waffelz,3098,46,3,6,9,33.3%,46m
14282,1,Tadpole,3098,0,1,0,1,100.0%,3m
14282,1,ChairBird,3098,0,1,1,2,50.0%,7m
14282,1,[KiMBR]KURUMIN,3098,0,0,1,1,0.0%,7m
14282,1,Tdevil,3098,0,0,1,1,0.0%,9m
14299,3,Bigdickbison,3097,1427,187,179,366,51.1%,28m
14299,3,Greymin,3097,1637,109,111,220,49.5%,37m
14299,3,RORONOA,3097,1507,99,92,191,51.8%,43m
14299,3,Mage,3097,1071,95,79,174,54.6%,23m
14299,3,Toaster,3097,942,61,45,106,57.5%,22m
14299,3,Prax,3097,823,40,45,85,47.1%,41m
14299,3,[WtFOXs]AJMcSpiffy,3097,539,20,19,39,51.3%,38m
14299,3,Pzkp,3097,518,18,19,37,48.6%,7m
14299,1,MyThOs,3097,472,16,15,31,51.6%,25m
14299,1,[RUMB]Gouron,3097,388,14,11,25,56.0%,35m
14299,3,[UZD4S]ghost,3097,320,12,13,25,48.0%,16m
14299,1,Infetrix,3097,316,11,10,21,52.4%,11m
14299,1,Cancel,3097,139,6,4,10,60.0%,17m
14299,1,[SwH]Motiva,3097,223,6,6,12,50.0%,43m
14299,3,[αB]Mythikdawn,3097,196,6,13,19,31.6%,39m
14299,1,Frelinghuyse,3097,0,2,1,3,66.7%,8m
14299,1,Turtle,3097,42,2,4,6,33.3%,9m
14299,1,[Macac0]Nirvanero,3097,0,1,0,1,100.0%,31m
14299,3,[RAID5]zergerking,3097,30,1,6,7,14.3%,6m
14299,1,Thechef,3097,0,0,1,1,0.0%,17m
14299,1,[RED3Y3]apocalipt,3097,0,0,2,2,0.0%,15m
14299,1,Quiroz,3097,0,0,2,2,0.0%,14m
14321,1,[BoAVN]MrVietcong,3096,1759,173,134,307,56.4%,35m
14321,3,Primordial,3096,1277,120,104,224,53.6%,4m
14321,3,[InGt]NoxCaelum,3096,1348,118,120,238,49.6%,16m
14321,1,[TGosuA]belly,3096,1728,79,76,155,51.0%,20m
14321,3,Carnifex,3096,1166,69,67,136,50.7%,12m
14321,3,SuperNinja,3096,786,31,28,59,52.5%,35m
14321,3,AntiNeutral,3096,528,25,20,45,55.6%,35m
14321,3,Ghost,3096,584,23,20,43,53.5%,10m
14321,3,[LMDS]Tony,3096,532,22,18,40,55.0%,6m
14321,3,VLADEX,3096,433,19,29,48,39.6%,23m
14321,1,Malygos,3096,184,6,2,8,75.0%,2m
14321,1,sleeper,3096,213,6,4,10,60.0%,39m
14321,2,higl,3096,143,6,4,10,60.0%,48m
14321,3,DanixPulent,3096,220,6,8,14,42.9%,10m
14321,3,[ValidG]Willwillwin,3096,123,3,4,7,42.9%,11m
14321,3,CarlFGauss,3096,0,1,0,1,100.0%,2h
14321,1,[QcScT]wtfkaliss,3096,0,0,1,1,0.0%,15m
14338,3,trie,3095,1556,151,132,283,53.4%,20m
14338,3,LemonVillain,3095,1583,142,129,271,52.4%,21m
14338,3,[GrnBrd]TheCeLL,3095,1567,84,88,172,48.8%,23m
14338,3,[GZRx]Bardock,3095,1381,78,78,156,50.0%,37m
14338,3,Zannzen,3095,927,57,63,120,47.5%,31m
14338,1,Blessthefall,3095,1012,46,21,67,68.7%,34m
14338,1,BattleDotNut,3095,1035,45,28,73,61.6%,37m
14338,2,[OdC]Zeus,3095,911,40,58,98,40.8%,36m
14338,1,ReTuNe,3095,290,13,12,25,52.0%,21m
14338,1,BigBang,3095,352,10,11,21,47.6%,29m
14338,1,Barcode,3095,192,5,5,10,50.0%,3m
14338,1,BobbyShaftoe,3095,122,4,5,9,44.4%,29m
14338,3,[AVSC]CoRex,3095,0,3,1,4,75.0%,25m
14338,1,Phoney,3095,121,3,3,6,50.0%,26m
14338,3,zoflo,3095,90,3,9,12,25.0%,37m
14338,1,Duffman,3095,0,2,3,5,40.0%,7m
14338,1,llllllllllll,3095,80,2,5,7,28.6%,27m
14338,1,[LDCO]Temok,3095,0,1,1,2,50.0%,21m
14338,3,FonzOverwach,3095,0,1,5,6,16.7%,12m
14338,1,Ragginet,3095,0,0,1,1,0.0%,37m
14338,1,notzkie,3095,0,0,1,1,0.0%,38m
14338,1,DealerBrad,3095,0,0,1,1,0.0%,27m
14338,1,Jaguaticrazy,3095,0,0,1,1,0.0%,42m
14361,3,Sarbanes,3094,1407,104,98,202,51.5%,19m
14361,1,[Frolik]WestMort,3094,773,70,56,126,55.6%,22m
14361,3,[MHLAPM]HomemPassaro,3094,1508,66,63,129,51.2%,26m
14361,3,MULOY,3094,914,65,66,131,49.6%,42m
14361,3,Top,3094,876,31,37,68,45.6%,41m
14361,3,Lumon,3094,655,24,23,47,51.1%,17m
14361,3,MauroCL,3094,666,24,25,49,49.0%,4m
14361,3,[Fir3s]DeadlyShadow,3094,640,22,30,52,42.3%,26m
14361,3,DEMOLIDOR,3094,475,18,17,35,51.4%,37m
14361,1,[THlNG]SHODAN,3094,363,16,3,19,84.2%,11m
14361,3,Tallmountain,3094,420,15,21,36,41.7%,11m
14361,3,Talento,3094,226,10,7,17,58.8%,8m
14361,1,MikeM,3094,261,10,7,17,58.8%,2h
14361,1,IIIIIIIIIIII,3094,136,3,13,16,18.8%,27m
14361,3,Kilo,3094,30,1,5,6,16.7%,13m
14361,1,[Cavalo]Lee,3094,0,0,1,1,0.0%,39m
14361,3,gggggggg,3094,0,0,1,1,0.0%,3m
14361,1,soniiC,3094,0,0,2,2,0.0%,25m
14379,3,TrumpFTW,3093,791,264,256,520,50.8%,12m
14379,3,[RSTCL]CLow,3093,618,87,73,160,54.4%,23m
14379,1,lidAcero,3093,1319,66,59,125,52.8%,19m
14379,3,suka,3093,1261,62,53,115,53.9%,27m
14379,3,BMTenoch,3093,993,52,51,103,50.5%,13m
14379,3,Defection,3093,854,40,43,83,48.2%,11m
14379,1,[QTp2T]ARc,3093,915,32,24,56,57.1%,14m
14379,3,MacGruber,3093,896,32,36,68,47.1%,6m
14379,3,SweetSilence,3093,747,27,30,57,47.4%,35m
14379,3,Teekz,3093,573,22,18,40,55.0%,21m
14379,3,Chocolate,3093,489,19,19,38,50.0%,34m
14379,2,BpKimchi,3093,285,14,8,22,63.6%,23m
14379,3,[oxen]WarrPig,3093,334,14,12,26,53.8%,40m
14379,1,John,3093,314,13,7,20,65.0%,3m
14379,3,[Italis]Slor,3093,233,12,10,22,54.5%,27m
14379,1,[PSU]Guillermoman,3093,414,11,12,23,47.8%,9m
14379,3,QWERTY,3093,273,10,3,13,76.9%,8m
14379,3,SuperZerg,3093,247,10,11,21,47.6%,17m
14379,1,THOTWHIPPER,3093,308,9,4,13,69.2%,27m
14379,3,Tonby,3093,185,8,8,16,50.0%,11m
14379,3,Lkeskic,3093,178,7,8,15,46.7%,37m
14379,2,Danking,3093,0,5,2,7,71.4%,2h
14379,1,billyb,3093,116,3,3,6,50.0%,15m
14379,1,Quadro,3093,0,1,0,1,100.0%,17m
14379,1,hellrazer,3093,0,1,1,2,50.0%,12m
14379,1,BenC,3093,89,1,1,2,50.0%,15m
14379,3,Kruzorf,3093,97,1,2,3,33.3%,2h
14379,1,LtBurnside,3093,0,0,2,2,0.0%,23m
14407,3,Malzahar,3092,1561,202,178,380,53.2%,20m
14407,3,Padraic,3092,1559,162,155,317,51.1%,34m
14407,3,Riddle,3092,1648,161,151,312,51.6%,26m
14407,3,Tyler,3092,1488,111,109,220,50.5%,32m
14407,3,IDUNNOMYID,3092,1543,96,90,186,51.6%,21m
14407,3,Camysae,3092,1431,69,69,138,50.0%,6m
14407,3,epidemix,3092,824,31,37,68,45.6%,20m
14407,1,[OPMs]galayS,3092,579,28,30,58,48.3%,12m
14407,1,Khas,3092,488,17,12,29,58.6%,38m
14407,1,queenzerg,3092,472,14,14,28,50.0%,14m
14407,1,Starchild,3092,282,11,1,12,91.7%,21m
14407,1,surefire,3092,256,8,2,10,80.0%,9m
14407,3,Dangernoodle,3092,152,8,11,19,42.1%,4m
14407,1,StrangeMD,3092,246,7,3,10,70.0%,25m
14407,1,avhaha,3092,159,6,2,8,75.0%,8m
14407,1,[Inseto]Conatus,3092,186,6,4,10,60.0%,4m
14407,1,[xLgNx]MrsAhrim,3092,158,5,4,9,55.6%,10m
14407,3,wellness,3092,144,5,6,11,45.5%,20m
14407,1,Neems,3092,176,5,8,13,38.5%,8m
14407,1,[TACOST]Balthier,3092,185,4,7,11,36.4%,38m
14407,1,[NSKL]Peril,3092,0,3,2,5,60.0%,22m
14407,1,[SftVgn]Savi,3092,136,3,7,10,30.0%,19m
14407,1,[Myriad]DaRedPaladin,3092,40,2,3,5,40.0%,41m
14407,1,jed,3092,0,1,0,1,100.0%,18m
14407,3,TinyChoppah,3092,96,1,1,2,50.0%,37m
14407,1,Mahiron,3092,44,1,3,4,25.0%,37m
14407,1,JohnJiang,3092,0,0,1,1,0.0%,11m
14407,1,JFurtive,3092,0,0,1,1,0.0%,41m
14407,1,dragonfly,3092,0,0,1,1,0.0%,40m
14436,3,Younglarnyx,3091,1435,143,137,280,51.1%,31m
14436,3,FarSeer,3091,1022,108,100,208,51.9%,10m
14436,3,GECKOGORDON,3091,1041,68,73,141,48.2%,10m
14436,3,Poisonlolz,3091,1485,65,54,119,54.6%,40m
14436,3,LUCIFER,3091,1375,57,48,105,54.3%,35m
14436,3,[KoYoTe]Nuke,3091,883,43,44,87,49.4%,41m
14436,3,WolfJohnson,3091,918,42,60,102,41.2%,17m
14436,3,[LOHe]DEMNTE,3091,896,40,37,77,51.9%,18m
14436,2,Ruby,3091,320,15,7,22,68.2%,12m
14436,1,baricool,3091,488,15,11,26,57.7%,35m
14436,3,QuanticPsych,3091,443,14,18,32,43.8%,5m
14436,1,Parasite,3091,383,12,5,17,70.6%,20m
14436,1,Kirin,3091,245,9,9,18,50.0%,19m
14436,3,DUKE,3091,151,9,11,20,45.0%,17m
14436,3,CallMeMike,3091,248,8,13,21,38.1%,10m
14436,1,ZEUS,3091,173,6,6,12,50.0%,38m
14436,1,[FateTw]Neroc,3091,118,4,1,5,80.0%,19m
14436,1,Skynet,3091,114,4,1,5,80.0%,4m
14436,2,RealCow,3091,163,4,1,5,80.0%,2h
14436,3,Krespy,3091,90,4,8,12,33.3%,35m
14436,1,[GnR]boombardo,3091,84,3,3,6,50.0%,7m
14436,3,[NZER0]Ghost,3091,32,2,0,2,100.0%,24m
14436,3,dryson,3091,62,2,12,14,14.3%,27m
14436,2,[zelniq]Cobain,3091,0,1,0,1,100.0%,2m
14436,3,MrGoliath,3091,0,1,8,9,11.1%,24m
14436,1,[BONES]KingSage,3091,0,0,1,1,0.0%,31m
14436,1,JackBlackvCv,3091,0,0,1,1,0.0%,50m
14436,1,llllllllllll,3091,0,0,5,5,0.0%,8m
14464,3,xtphty,3090,1510,219,192,411,53.3%,37m
14464,3,WAKE,3090,1574,137,134,271,50.6%,20m
14464,3,Kantek,3090,1438,85,85,170,50.0%,42m
14464,3,[TRKPAD]Dwarfe,3090,1076,78,77,155,50.3%,12m
14464,3,Felix,3090,996,67,71,138,48.6%,19m
14464,3,Hitchslap,3090,761,51,51,102,50.0%,22m
14464,3,[ALTF04]Alastor,3090,494,16,26,42,38.1%,39m
14464,3,rustlejimmys,3090,352,12,15,27,44.4%,36m
14464,1,[ValidG]ProPangolin,3090,282,10,4,14,71.4%,37m
14464,3,Python,3090,90,7,6,13,53.8%,6m
14464,3,SkeViHuE,3090,60,5,7,12,41.7%,36m
14464,1,RussTheBus,3090,192,5,9,14,35.7%,19m
14464,3,Jams,3090,204,5,9,14,35.7%,34m
14464,1,thePRINCE,3090,104,4,2,6,66.7%,8m
14464,3,NoC,3090,0,4,3,7,57.1%,18m
14464,3,[4HARM]Allochthon,3090,153,4,6,10,40.0%,34m
14464,3,Metagenesis,3090,122,4,13,17,23.5%,2m
14464,2,FeedDaMonkey,3090,185,3,4,7,42.9%,19m
14464,1,[MEATT]zBreezy,3090,42,2,1,3,66.7%,17m
14464,1,Fern,3090,82,2,1,3,66.7%,37m
14464,3,Twistedchaos,3090,121,2,6,8,25.0%,8m
14464,1,Meiji,3090,0,1,0,1,100.0%,10m
14464,3,FateZero,3090,0,1,0,1,100.0%,31m
14464,1,wendyskitty,3090,0,1,0,1,100.0%,23m
14464,1,Bruce,3090,42,1,1,2,50.0%,28m
14464,1,[Nutr]Wolfstep,3090,95,1,4,5,20.0%,25m
14464,1,KimJongUn,3090,0,0,1,1,0.0%,39m
14464,1,[C32G]DonHogen,3090,0,0,3,3,0.0%,9m
14492,3,SomeCuck,3089,1360,152,127,279,54.5%,39m
14492,3,[xLgNx]Jornada,3089,1434,93,81,174,53.4%,20m
14492,1,[P07470]waterhog,3089,1674,86,58,144,59.7%,22m
14492,3,Nelson,3089,1141,75,63,138,54.3%,32m
14492,3,Sumsar,3089,1342,62,64,126,49.2%,34m
14492,3,Astral,3089,695,48,47,95,50.5%,33m
14492,3,shadowwull,3089,581,28,27,55,50.9%,39m
14492,1,Skoalll,3089,346,13,8,21,61.9%,19m
14492,1,Future,3089,345,11,7,18,61.1%,18m
14492,1,Adery,3089,209,10,3,13,76.9%,19m
14492,1,[CBAS]chessiiimate,3089,280,9,5,14,64.3%,26m
14492,1,[copain]tipro,3089,262,8,3,11,72.7%,20m
14492,1,josse,3089,250,7,7,14,50.0%,31m
14492,3,Zerg,3089,97,4,2,6,66.7%,9m
14492,1,[C96]KevinBotffff,3089,120,3,4,7,42.9%,9m
14492,1,QvAnawari,3089,116,3,6,9,33.3%,34m
14492,1,WarriorCat,3089,40,2,1,3,66.7%,8m
14492,1,Artanis,3089,40,2,3,5,40.0%,21m
14492,3,Rantallin,3089,0,1,0,1,100.0%,30m
14492,1,Walrus,3089,0,0,1,1,0.0%,21m
14512,1,DMZCRAZY,3088,1700,112,82,194,57.7%,39m
14512,3,HypoConDreAc,3088,1469,86,97,183,47.0%,9m
14512,1,Attila,3088,918,57,52,109,52.3%,8m
14512,1,Hattman,3088,1086,40,33,73,54.8%,29m
14512,3,[CRAKS]RaOnFire,3088,579,28,14,42,66.7%,38m
14512,3,MindGrape,3088,524,20,18,38,52.6%,5m
14512,1,AstroBlaster,3088,480,15,14,29,51.7%,38m
14512,1,Kebnekaise,3088,322,13,5,18,72.2%,13m
14512,1,Shattered,3088,328,9,8,17,52.9%,7m
14512,1,[Potate]Bob,3088,266,8,7,15,53.3%,34m
14512,1,PooStinkyHAH,3088,232,7,3,10,70.0%,50m
14512,3,Flawless,3088,30,6,2,8,75.0%,32m
14512,1,IIIIIIIIIIII,3088,36,4,2,6,66.7%,22m
14512,1,Master,3088,0,3,2,5,60.0%,22m
14512,1,StyliAnt,3088,88,3,3,6,50.0%,7m
14512,3,[CJ1]Difficult,3088,138,3,9,12,25.0%,2m
14512,1,ReviVaL,3088,128,2,1,3,66.7%,35m
14512,1,MineBoo,3088,44,2,3,5,40.0%,7m
14512,1,Nemesis,3088,40,1,1,2,50.0%,19m
14512,1,reddragon,3088,0,1,2,3,33.3%,31m
14512,1,vástago,3088,0,0,1,1,0.0%,11m
14512,1,Soij,3088,0,0,4,4,0.0%,34m
14512,2,Creature,3088,0,0,4,4,0.0%,55m
14535,3,kingnoob,3087,1489,191,164,355,53.8%,40m
14535,1,[ScrD7]Zykeo,3087,1617,76,58,134,56.7%,4m
14535,3,Craxz,3087,1511,75,77,152,49.3%,27m
14535,1,Adrios,3087,754,29,22,51,56.9%,35m
14535,3,joakc,3087,814,28,33,61,45.9%,41m
14535,3,[izzzy]ismael,3087,220,13,20,33,39.4%,31m
14535,1,Zilch,3087,226,8,4,12,66.7%,37m
14535,3,GLHF,3087,208,8,6,14,57.1%,8m
14535,3,aleatoriox,3087,117,3,4,7,42.9%,8m
14535,2,[LAW]Drewbie,3087,93,2,1,3,66.7%,7m
14535,3,raiji,3087,97,2,2,4,50.0%,10m
14535,2,Neon,3087,117,2,3,5,40.0%,4m
14535,1,mrclark,3087,0,1,0,1,100.0%,31m
14535,1,[KiTeam]KitZoa,3087,42,1,1,2,50.0%,16m
14535,1,lala,3087,0,0,1,1,0.0%,13m
14535,2,Dolt,3087,0,0,1,1,0.0%,8m
14535,1,imarogue,3087,0,0,2,2,0.0%,39m
14552,1,Office,3086,1577,69,54,123,56.1%,7m
14552,1,[TY4GG]BlessedG,3086,1219,58,37,95,61.1%,27m
14552,3,treemanp,3086,1221,56,52,108,51.9%,22m
14552,1,MediOgre,3086,1274,51,37,88,58.0%,7m
14552,1,[ConFed]SunGodEffect,3086,977,37,31,68,54.4%,34m
14552,3,HakuG,3086,1007,36,38,74,48.6%,15m
14552,1,AttackTurtle,3086,860,34,26,60,56.7%,23m
14552,3,Inspirit,3086,810,30,31,61,49.2%,42m
14552,1,AVF,3086,691,28,22,50,56.0%,29m
14552,1,Victor,3086,685,26,14,40,65.0%,15m
14552,1,[DRKRPT]TJjoRis,3086,680,21,21,42,50.0%,27m
14552,3,ErnestoV,3086,208,7,13,20,35.0%,24m
14552,1,Shipa,3086,158,5,5,10,50.0%,35m
14552,1,StevenR,3086,0,4,1,5,80.0%,5m
14552,1,frowns,3086,0,4,1,5,80.0%,2h
14552,3,BigBadWolf,3086,38,4,3,7,57.1%,59m
14552,1,Pablo,3086,72,3,0,3,100.0%,18m
14552,2,Chicom,3086,116,3,1,4,75.0%,2h
14552,1,[95O]ArthurKing,3086,34,2,0,2,100.0%,11m
14552,1,[FDK]Saaammmmo,3086,42,2,1,3,66.7%,13m
14552,1,Maduin,3086,0,2,3,5,40.0%,41m
14552,1,Shanman,3086,0,1,0,1,100.0%,37m
14552,3,Eitchen,3086,30,1,5,6,16.7%,42m
14552,1,fartburn,3086,0,0,1,1,0.0%,11m
14552,2,SarahKerigan,3086,0,0,1,1,0.0%,34m
14552,3,SilentSwordX,3086,0,0,1,1,0.0%,37m
14578,1,MrEMan,3085,1051,102,96,198,51.5%,15m
14578,1,NudeDude,3085,1474,67,60,127,52.8%,7m
14578,1,Nopal,3085,1230,43,41,84,51.2%,19m
14578,3,[TGosuB]ArcticKinger,3085,932,43,50,93,46.2%,26m
14578,3,BLaZN,3085,1032,42,36,78,53.8%,10m
14578,1,ºAQUILESGANO,3085,867,34,22,56,60.7%,36m
14578,3,SilverWings,3085,680,27,24,51,52.9%,15m
14578,1,iKILLuHAHA,3085,610,25,12,37,67.6%,31m
14578,3,[No0Bs]DrWhat,3085,442,15,16,31,48.4%,18m
14578,1,[LoSD]NewBB,3085,280,13,9,22,59.1%,20m
14578,2,Jotakof,3085,286,13,10,23,56.5%,40m
14578,3,[SdwGmg]Sonic,3085,362,13,20,33,39.4%,17m
14578,3,[ProSC]skaiper,3085,150,6,12,18,33.3%,36m
14578,1,HASHTAGBLM,3085,119,4,2,6,66.7%,7m
14578,3,Mackky,3085,159,4,10,14,28.6%,25m
14578,3,IIIIIIIIIIII,3085,0,3,3,6,50.0%,2h
14578,1,nGsDangerous,3085,120,3,5,8,37.5%,41m
14578,1,JaZi,3085,32,2,0,2,100.0%,8m
14578,1,MethodMan,3085,0,1,0,1,100.0%,7m
14578,1,LightDays,3085,40,1,1,2,50.0%,26m
14578,3,hOoLiGaN,3085,94,1,4,5,20.0%,28m
14578,1,[DEFUP]Aummadour,3085,0,0,1,1,0.0%,13m
14578,1,POEtheCAT,3085,0,0,1,1,0.0%,22m
14578,1,ULTIMATE,3085,0,0,1,1,0.0%,23m
14578,1,CHILONGQUA,3085,0,0,2,2,0.0%,29m
14578,1,pphotsauce,3085,0,0,2,2,0.0%,9m
14578,1,[PlsDie]NateXSkills,3085,0,0,3,3,0.0%,39m
14605,1,Takuto,3084,1007,103,96,199,51.8%,23m
14605,3,[TMTFH]Trigun,3084,1139,103,103,206,50.0%,26m
14605,1,GoonBlast,3084,1677,85,70,155,54.8%,7m
14605,1,xMrNoobTardx,3084,853,44,33,77,57.1%,10m
14605,3,Tumu,3084,946,38,37,75,50.7%,39m
14605,1,[INextI]Angel,3084,843,30,25,55,54.5%,37m
14605,3,[OD2019]Raise,3084,686,24,30,54,44.4%,20m
14605,3,SensatioN,3084,443,18,13,31,58.1%,18m
14605,3,KissKiss,3084,241,9,10,19,47.4%,16m
14605,1,[pepis]BwahGamer,3084,294,8,7,15,53.3%,27m
14605,2,[ZTemp]WTFork,3084,215,7,2,9,77.8%,22m
14605,1,SoloXman,3084,187,7,4,11,63.6%,11m
14605,1,SlayerToshi,3084,166,7,6,13,53.8%,2h
14605,3,[PRDUE]Steelman,3084,112,6,4,10,60.0%,36m
14605,2,Plush,3084,182,6,4,10,60.0%,8m
14605,1,Smileyfase,3084,0,5,0,5,100.0%,2h
14605,1,Ganjalf,3084,113,3,0,3,100.0%,5m
14605,3,[UpxV]tonylechuga,3084,0,3,3,6,50.0%,16m
14605,1,KWRJRTYI,3084,0,1,2,3,33.3%,31m
14605,3,SacredSelf,3084,30,1,5,6,16.7%,26m
14605,1,Anomolis,3084,0,0,1,1,0.0%,27m
14605,1,Hiemal,3084,0,0,1,1,0.0%,8m
14605,1,Red,3084,0,0,1,1,0.0%,41m
14628,3,Chicolz,3083,1443,218,203,421,51.8%,13m
14628,3,KushUps,3083,988,48,34,82,58.5%,21m
14628,3,Dolmatt,3083,268,13,12,25,52.0%,36m
14628,3,Haifisch,3083,171,7,6,13,53.8%,15m
14628,1,DarkIce,3083,188,5,5,10,50.0%,2m
14628,2,Stormbringer,3083,142,5,13,18,27.8%,4m
14628,1,BattleFreak,3083,88,3,1,4,75.0%,8m
14628,1,[NLTN]Jaco,3083,42,2,1,3,66.7%,23m
14628,1,[MCOS]Frutilloso,3083,0,1,4,5,20.0%,20m
14628,1,Guile,3083,0,0,1,1,0.0%,17m
14628,1,yobuggzy,3083,0,0,1,1,0.0%,34m
14628,1,[StgNig]Brassballs,3083,0,0,2,2,0.0%,25m
14628,1,[YEETED]Damien,3083,0,0,2,2,0.0%,32m
14641,3,TurdBurglar,3082,964,202,212,414,48.8%,41m
14641,1,[ScSwrm]jaydik,3082,1658,116,116,232,50.0%,29m
14641,3,Thomasblue,3082,1287,68,59,127,53.5%,35m
14641,3,Heisenberg,3082,1397,59,58,117,50.4%,16m
14641,1,[Yuko]Chiristinayo,3082,480,18,9,27,66.7%,7m
14641,3,ZerothHelix,3082,141,6,8,14,42.9%,39m
14641,2,Twizzy,3082,96,5,3,8,62.5%,2h
14641,3,COOLBB,3082,0,5,3,8,62.5%,15m
14641,1,[QuAzar]pinguchingu,3082,82,2,3,5,40.0%,27m
14641,1,Mandible,3082,82,2,6,8,25.0%,21m
14641,3,Tainted,3082,58,2,8,10,20.0%,40m
14641,1,TurboPotato,3082,0,0,1,1,0.0%,15m
14641,1,SteEZySteve,3082,0,0,1,1,0.0%,34m
14641,1,THEKILLERGUY,3082,0,0,1,1,0.0%,18m
14641,1,JuanitoOoO,3082,0,0,4,4,0.0%,29m
14656,3,[Hyrule]airpolgas,3081,1569,390,383,773,50.5%,30m
14656,1,[WNTRCH]Broomhill,3081,1649,265,254,519,51.1%,37m
14656,3,Stinger,3081,1504,260,244,504,51.6%,32m
14656,1,chicles,3081,1728,91,78,169,53.8%,4m
14656,3,AngryPegouin,3081,1474,72,76,148,48.6%,32m
14656,1,Zelda,3081,955,67,60,127,52.8%,38m
14656,3,Microangelo,3081,1131,56,41,97,57.7%,7m
14656,3,TheKMan,3081,773,33,28,61,54.1%,36m
14656,1,Maru,3081,485,27,11,38,71.1%,13m
14656,1,LifeIsBard,3081,750,26,17,43,60.5%,21m
14656,1,NoGGNoSkill,3081,694,22,22,44,50.0%,31m
14656,1,[fkwhip]WHIPPY,3081,458,13,14,27,48.1%,42m
14656,1,Schneider,3081,100,6,1,7,85.7%,10m
14656,1,eXeHarmony,3081,0,5,0,5,100.0%,10m
14656,3,Boubounito,3081,186,5,7,12,41.7%,38m
14656,1,[777Z]chobo,3081,0,4,1,5,80.0%,35m
14656,1,Johnjohn,3081,116,4,4,8,50.0%,35m
14656,3,[TpLn]JackedX,3081,97,2,0,2,100.0%,57m
14656,1,Mindgamer,3081,80,2,1,3,66.7%,36m
14656,1,SanT,3081,40,1,1,2,50.0%,17m
14656,1,TopDogPro,3081,0,0,1,1,0.0%,8m
14656,1,UberNoober,3081,0,0,1,1,0.0%,39m
14678,3,OberKatze,3080,1005,234,214,448,52.2%,12m
14678,3,UltraMafia,3080,1419,157,154,311,50.5%,34m
14678,3,analfissure,3080,1404,93,75,168,55.4%,38m
14678,3,Matteus,3080,1382,71,76,147,48.3%,38m
14678,3,Ricodius,3080,1199,66,53,119,55.5%,6m
14678,3,Raynor,3080,864,56,50,106,52.8%,5m
14678,1,Ghostwriter,3080,1258,50,54,104,48.1%,31m
14678,1,AceAceAceAce,3080,832,45,6,51,88.2%,11m
14678,1,[EpicG]PedroCarlos,3080,374,12,7,19,63.2%,39m
14678,3,DaHaKa,3080,322,12,22,34,35.3%,42m
14678,3,HappyPants,3080,274,10,4,14,71.4%,4m
14678,1,TheWiseFox,3080,184,5,6,11,45.5%,37m
14678,1,disisgay,3080,92,2,0,2,100.0%,9m
14678,3,[MEELX]DuffBeer,3080,0,1,0,1,100.0%,22m
14678,2,Hansen,3080,0,1,0,1,100.0%,34m
14678,1,ErKaNiOn,3080,0,1,4,5,20.0%,4m
14678,1,[l3H]LuRKeR,3080,0,0,1,1,0.0%,15m
14678,1,makatito,3080,0,0,1,1,0.0%,7m
14678,1,Mechromatt,3080,0,0,1,1,0.0%,39m
14678,1,Cosmoz,3080,0,0,1,1,0.0%,39m
14678,2,IdgitGaloot,3080,0,0,1,1,0.0%,30m
14678,1,[delTRN]SwarmyBoi,3080,0,0,1,1,0.0%,21m
14678,1,[CFSM]Kanaya,3080,0,0,1,1,0.0%,19m
14678,1,krumz,3080,0,0,2,2,0.0%,26m
14702,1,Akuro,3079,1463,57,55,112,50.9%,25m
14702,1,MungTheKing,3079,931,56,25,81,69.1%,21m
14702,1,Elpatas,3079,989,42,34,76,55.3%,34m
14702,1,Gary,3079,452,27,19,46,58.7%,41m
14702,3,[LTlord]GokuLeGana,3079,571,27,23,50,54.0%,23m
14702,3,[GRYRE]BilboBaggins,3079,676,23,33,56,41.1%,12m
14702,1,[Btata1]NightMare,3079,604,19,19,38,50.0%,25m
14702,3,[ScSwrm]Sisyphus,3079,384,17,17,34,50.0%,9m
14702,3,minidaddy,3079,264,10,12,22,45.5%,12m
14702,1,LuNa,3079,42,2,0,2,100.0%,34m
14702,1,Sinergize,3079,76,2,4,6,33.3%,15m
14702,1,Haven,3079,0,1,0,1,100.0%,8m
14702,1,[CCUO]BirchTree,3079,0,1,0,1,100.0%,8m
14702,1,LylYahiko,3079,44,1,3,4,25.0%,7m
14702,2,DeadGuy,3079,0,0,1,1,0.0%,1h
14702,1,llllllllllll,3079,0,0,1,1,0.0%,23m
14702,3,flOwer,3079,0,0,6,6,0.0%,22m
14719,1,robdog,3078,1759,247,232,479,51.6%,10m
14719,3,Sentizzle,3078,1353,138,134,272,50.7%,2m
14719,3,VILE,3078,1153,116,113,229,50.7%,24m
14719,3,Angel,3078,283,48,47,95,50.5%,41m
14719,3,DBHated,3078,221,10,7,17,58.8%,2m
14719,2,PuppetMaster,3078,163,8,4,12,66.7%,44m
14719,1,Turtlepants,3078,120,4,5,9,44.4%,21m
14719,2,weaselboi,3078,0,1,0,1,100.0%,17m
14727,3,Doug,3077,1491,291,285,576,50.5%,10m
14727,3,ZMBMN,3077,1437,112,111,223,50.2%,14m
14727,3,Blank,3077,552,54,39,93,58.1%,10m
14727,1,Val,3077,1217,54,41,95,56.8%,41m
14727,1,[XTGZ]XtremeNubi,3077,912,28,31,59,47.5%,39m
14727,3,[Fir3s]StporA,3077,608,25,32,57,43.9%,39m
14727,1,littleblack,3077,287,21,14,35,60.0%,8m
14727,3,Sky,3077,543,21,20,41,51.2%,39m
14727,1,[VENSC2]Wasabi,3077,482,15,9,24,62.5%,13m
14727,3,baabaa,3077,330,15,14,29,51.7%,38m
14727,1,PuChi,3077,368,11,11,22,50.0%,27m
14727,1,hangs,3077,165,7,4,11,63.6%,21m
14727,3,Genghiskhan,3077,97,5,1,6,83.3%,42m
14727,1,DarkZebra,3077,169,5,7,12,41.7%,21m
14727,1,Netfreakk,3077,201,5,7,12,41.7%,17m
14727,3,[TNWT]Kitakami,3077,169,4,6,10,40.0%,25m
14727,1,killafrog,3077,78,3,3,6,50.0%,41m
14727,2,Rivallie,3077,116,2,1,3,66.7%,22m
14727,1,Brandon,3077,44,1,4,5,20.0%,27m
14727,3,Mochnathal,3077,30,1,6,7,14.3%,31m
14727,3,[CCCMF]testicana,3077,0,0,2,2,0.0%,11m
14748,3,Hua,3076,1542,227,217,444,51.1%,5m
14748,3,llllllllllll,3076,1456,121,105,226,53.5%,22m
14748,3,xXBehemothXx,3076,1550,107,91,198,54.0%,40m
14748,1,[20Deen]rooster,3076,818,39,36,75,52.0%,31m
14748,3,MATHEMATIK,3076,347,35,30,65,53.8%,39m
14748,1,nissin,3076,826,26,28,54,48.1%,30m
14748,1,Reformed,3076,652,25,17,42,59.5%,29m
14748,1,StarBaby,3076,721,25,24,49,51.0%,14m
14748,3,Waterbear,3076,542,18,25,43,41.9%,20m
14748,2,Cannicus,3076,358,16,8,24,66.7%,22m
14748,1,Kyo,3076,249,10,7,17,58.8%,13m
14748,1,Ragnar,3076,350,10,11,21,47.6%,25m
14748,3,[Macac0]STulum,3076,266,10,14,24,41.7%,42m
14748,1,sirfluffkin,3076,254,8,6,14,57.1%,37m
14748,1,Damitus,3076,213,6,2,8,75.0%,2h
14748,1,DPBCombininG,3076,110,4,2,6,66.7%,9m
14748,1,Wildcide,3076,114,4,4,8,50.0%,7m
14748,1,[TAMUG]seaag,3076,0,3,2,5,60.0%,35m
14748,1,BartelRuneax,3076,104,3,2,5,60.0%,11m
14748,1,GergeR,3076,114,3,3,6,50.0%,19m
14748,3,Meteor,3076,97,2,1,3,66.7%,57m
14748,1,[TANn]PlairE,3076,40,2,4,6,33.3%,4m
14748,1,Katanroach,3076,0,1,0,1,100.0%,35m
14748,1,ChiMeRa,3076,38,1,2,3,33.3%,34m
14748,1,Legion,3076,0,0,1,1,0.0%,19m
14748,1,[FALURS]Psionic,3076,0,0,1,1,0.0%,2h
14748,1,batzi,3076,0,0,1,1,0.0%,10m
14748,1,Monstrosity,3076,0,0,1,1,0.0%,27m
14776,3,Shwindy,3075,1553,146,143,289,50.5%,26m
14776,1,KernelPanic,3075,557,63,48,111,56.8%,4m
14776,3,DarkPingDuck,3075,478,56,39,95,58.9%,30m
14776,1,JRadKS,3075,1357,52,41,93,55.9%,16m
14776,3,[uSuck]Freddeh,3075,682,50,27,77,64.9%,10m
14776,1,CastraSilex,3075,1205,46,40,86,53.5%,16m
14776,3,Azathoth,3075,899,34,32,66,51.5%,15m
14776,2,[BRSKR]SnowEMeadowS,3075,956,33,57,90,36.7%,22m
14776,1,NOUB,3075,764,32,31,63,50.8%,2m
14776,1,Jiska,3075,688,23,17,40,57.5%,4m
14776,3,[TR0L]Eskrop,3075,441,21,13,34,61.8%,10m
14776,1,MagicTerran,3075,624,21,16,37,56.8%,38m
14776,1,ScvLivesMttr,3075,372,17,5,22,77.3%,4m
14776,1,Xexo,3075,461,16,10,26,61.5%,25m
14776,3,KdxA,3075,450,16,27,43,37.2%,41m
14776,1,uhh,3075,357,12,7,19,63.2%,4m
14776,1,MiGo,3075,115,4,0,4,100.0%,35m
14776,1,[MilkPi]DrLiberty,3075,198,4,2,6,66.7%,17m
14776,3,payne,3075,0,4,2,6,66.7%,51m
14776,3,Psychedelic,3075,0,4,2,6,66.7%,36m
14776,1,Dranos,3075,0,3,2,5,60.0%,8m
14776,3,Sertorius,3075,145,3,2,5,60.0%,2h
14776,1,Avoreon,3075,44,2,1,3,66.7%,19m
14776,1,[COLD1]FictionFive,3075,40,2,1,3,66.7%,21m
14776,1,IIIIIIIIIIII,3075,40,2,2,4,50.0%,18m
14776,1,TheBOMB,3075,76,2,3,5,40.0%,34m
14776,1,Dondol,3075,142,2,4,6,33.3%,31m
14776,1,eZZeCuTeR,3075,74,2,5,7,28.6%,40m
14776,3,jnpzc,3075,0,1,0,1,100.0%,30m
14776,1,Edjo,3075,0,1,0,1,100.0%,19m
14776,3,[TgAg]Hyperlight,3075,0,0,3,3,0.0%,4m
14776,3,mike,3075,0,0,9,9,0.0%,32m
14808,1,BlessedG,3074,899,110,70,180,61.1%,18m
14808,3,[AFKPLZ]DBDB,3074,1453,95,85,180,52.8%,12m
14808,1,GuiGas,3074,1520,75,59,134,56.0%,37m
14808,1,beyondlucky,3074,1008,39,31,70,55.7%,18m
14808,3,Landfill,3074,627,38,28,66,57.6%,32m
14808,1,Meals,3074,471,21,15,36,58.3%,35m
14808,1,RealJohnCena,3074,504,20,15,35,57.1%,17m
14808,1,dozzen,3074,610,20,20,40,50.0%,38m
14808,1,Cosmicraider,3074,496,17,11,28,60.7%,19m
14808,1,Halcyon,3074,297,7,5,12,58.3%,34m
14808,1,RoboAB,3074,225,6,3,9,66.7%,29m
14808,3,IIIIIIIIII,3074,119,5,4,9,55.6%,43m
14808,1,[TITFRT]Dinosauron,3074,154,5,7,12,41.7%,9m
14808,1,[JaMiT]Achilles,3074,104,3,3,6,50.0%,18m
14808,1,OhMacBoot,3074,38,2,2,4,50.0%,35m
14808,1,medusa,3074,129,2,2,4,50.0%,30m
14808,1,kbigz,3074,0,1,1,2,50.0%,10m
14808,2,Argixx,3074,0,1,6,7,14.3%,7m
14808,1,UnReaL,3074,0,0,1,1,0.0%,41m
14808,1,Dan,3074,0,0,1,1,0.0%,39m
14808,1,Gladosposxd,3074,0,0,1,1,0.0%,39m
14829,3,zealofwar,3073,1425,240,231,471,51.0%,19m
14829,3,[GG1]SNSD,3073,1363,145,143,288,50.3%,13m
14829,3,[SmugB]walrocity,3073,1496,74,68,142,52.1%,36m
14829,3,SlowMan,3073,423,61,57,118,51.7%,41m
14829,1,Cheese,3073,455,47,21,68,69.1%,17m
14829,1,Epiwinetics,3073,724,44,33,77,57.1%,13m
14829,3,ddduuuddduuu,3073,881,42,38,80,52.5%,24m
14829,3,Andrew,3073,488,20,19,39,51.3%,31m
14829,3,herO,3073,338,14,8,22,63.6%,14m
14829,3,Goliath,3073,289,12,10,22,54.5%,5m
14829,1,Gnetophyte,3073,410,12,12,24,50.0%,26m
14829,1,TungValley,3073,206,9,6,15,60.0%,2h
14829,1,[GnR]Hatchery,3073,284,8,7,15,53.3%,15m
14829,1,[CBAS2]PerhapsToast,3073,155,7,4,11,63.6%,15m
14829,1,Dubtron,3073,269,7,5,12,58.3%,19m
14829,3,[Lo9]AlexTheGreat,3073,223,7,8,15,46.7%,38m
14829,1,Abridenal,3073,260,7,11,18,38.9%,21m
14829,2,[Erik]ZtingeR,3073,184,6,1,7,85.7%,41m
14829,1,[MTiger]ZERGLING,3073,135,6,3,9,66.7%,25m
14829,3,MastaFappa,3073,134,6,4,10,60.0%,11m
14829,1,BLOODCLOT,3073,226,6,7,13,46.2%,26m
14829,2,tankeewah,3073,159,5,1,6,83.3%,2h
14829,3,Kipo,3073,108,5,3,8,62.5%,36m
14829,2,[ZTempz]EmpressLumi,3073,117,3,1,4,75.0%,24m
14829,1,gippa,3073,40,2,1,3,66.7%,39m
14829,1,phi,3073,0,1,0,1,100.0%,7m
14829,1,MollyWater,3073,0,1,2,3,33.3%,8m
14829,1,Misael,3073,42,1,4,5,20.0%,13m
14829,3,llllllllllll,3073,30,1,8,9,11.1%,38m
14829,1,icLAGPEOPLE,3073,0,0,1,1,0.0%,27m
14829,1,[FFAA]hyperion,3073,0,0,1,1,0.0%,2m
14829,1,AlaniaLDS,3073,0,0,1,1,0.0%,10m
14829,1,MioFx,3073,0,0,1,1,0.0%,11m
14829,1,ChrisPark,3073,0,0,2,2,0.0%,27m
14863,1,zuel,3072,1723,214,200,414,51.7%,25m
14863,3,EDWARSACE,3072,1370,101,91,192,52.6%,40m
14863,1,Kazolas,3072,1240,86,75,161,53.4%,37m
14863,1,TwistedTea,3072,678,65,55,120,54.2%,30m
14863,1,[HBNC]puddlez,3072,1311,52,49,101,51.5%,21m
14863,3,samsonites,3072,743,45,53,98,45.9%,26m
14863,3,Zeitgeist,3072,620,22,29,51,43.1%,43m
14863,3,Solrac,3072,442,19,17,36,52.8%,10m
14863,1,[PNS]Ziguela,3072,115,5,3,8,62.5%,7m
14863,3,Champ,3072,151,5,11,16,31.2%,36m
14863,3,FourRax,3072,121,4,4,8,50.0%,59m
14863,1,curlz,3072,120,4,5,9,44.4%,19m
14863,2,OpticParadox,3072,131,4,7,11,36.4%,2h
14863,1,antiperras,3072,80,3,1,4,75.0%,11m
14863,1,rafa,3072,124,3,6,9,33.3%,10m
14863,3,Catroa,3072,0,2,1,3,66.7%,2h
14863,1,Heisenberg,3072,76,2,2,4,50.0%,27m
14863,2,CHUTASevil,3072,118,2,2,4,50.0%,7m
14863,1,hyulch,3072,0,2,3,5,40.0%,2h
14863,1,DunnyDiva,3072,0,1,0,1,100.0%,33m
14863,2,pasta,3072,0,1,1,2,50.0%,2h
14863,3,[Kaiba]BenAffleck,3072,0,0,1,1,0.0%,40m
14863,1,[MureoW]Kellbor,3072,0,0,1,1,0.0%,38m
14886,3,Sujay,3071,1459,241,234,475,50.7%,43m
14886,1,GrandCaravan,3071,1460,64,56,120,53.3%,25m
14886,3,AUDjjang,3071,1139,47,47,94,50.0%,36m
14886,3,Cocoa,3071,1180,45,50,95,47.4%,14m
14886,3,Burcx,3071,1198,43,57,100,43.0%,34m
14886,1,gynecologist,3071,710,40,35,75,53.3%,19m
14886,1,[MyButt]Rutty,3071,798,26,20,46,56.5%,21m
14886,3,LazyTitan,3071,205,18,20,38,47.4%,28m
14886,3,Nihs,3071,422,16,18,34,47.1%,38m
14886,1,KaYaK,3071,402,13,8,21,61.9%,35m
14886,3,nightknight,3071,269,10,10,20,50.0%,14m
14886,1,johnjacab,3071,276,9,9,18,50.0%,20m
14886,1,[xEx]STREETPIRATE,3071,324,9,12,21,42.9%,19m
14886,1,ExtraCrispy,3071,158,5,3,8,62.5%,35m
14886,1,ANewOvermind,3071,0,4,1,5,80.0%,5m
14886,1,LTGunta,3071,94,3,4,7,42.9%,29m
14886,1,[Ash3s]StarsFallDim,3071,76,3,5,8,37.5%,10m
14886,3,Sylar,3071,121,3,5,8,37.5%,3m
14886,1,[DiaOrg]Stormer,3071,82,2,4,6,33.3%,42m
14886,1,Justified,3071,42,1,4,5,20.0%,42m
14886,1,[HvnDvl]Ekho,3071,0,0,1,1,0.0%,27m
14886,1,[DmEs]Narberal,3071,0,0,1,1,0.0%,4m
14886,1,[ZFVet]megatron,3071,0,0,1,1,0.0%,27m
14886,1,FrostyDog,3071,0,0,1,1,0.0%,26m
14886,1,[MLGB]AOldDustShoe,3071,0,0,5,5,0.0%,11m
14911,3,[ÆON]Qcbouchard,3070,1198,175,163,338,51.8%,38m
14911,3,SnZgt,3070,1192,142,140,282,50.4%,37m
14911,1,[cl0udM]EnGiNeErPeoN,3070,1623,73,58,131,55.7%,35m
14911,1,Pumpkinpod,3070,1426,63,38,101,62.4%,35m
14911,1,CptRandom,3070,1353,55,44,99,55.6%,35m
14911,3,dyto,3070,803,48,26,74,64.9%,8m
14911,1,WHAAAA,3070,827,31,28,59,52.5%,21m
14911,3,Domo,3070,610,26,22,48,54.2%,2m
14911,1,TsothaLanti,3070,358,17,10,27,63.0%,33m
14911,3,Detoxerous,3070,410,15,19,34,44.1%,15m
14911,3,DaSwarm,3070,369,13,6,19,68.4%,34m
14911,1,[ISotFI]manumanXD,3070,360,11,6,17,64.7%,42m
14911,3,FYODOR,3070,245,9,12,21,42.9%,17m
14911,3,[CoolLC]Tenyasha,3070,151,8,6,14,57.1%,20m
14911,3,Deeew,3070,115,7,2,9,77.8%,11m
14911,1,EUisbetter,3070,118,5,2,7,71.4%,7m
14911,1,llllllllllll,3070,36,4,3,7,57.1%,21m
14911,3,[LimaSC]KaMui,3070,126,4,10,14,28.6%,26m
14911,1,IOI,3070,30,2,0,2,100.0%,10m
14911,1,Joliyit,3070,0,1,0,1,100.0%,22m
14911,1,[TXOP]CorvoIIV,3070,0,1,1,2,50.0%,11m
14911,1,Isaac,3070,40,1,2,3,33.3%,42m
14911,1,[Over1]skrfff,3070,40,1,2,3,33.3%,13m
14911,1,Gigi,3070,0,0,1,1,0.0%,10m
14911,1,Mack,3070,0,0,1,1,0.0%,37m
14911,1,LennyTheLing,3070,0,0,3,3,0.0%,40m
14911,3,socksoff,3070,0,0,6,6,0.0%,23m
14938,3,[I6I9I]CoughTots,3069,1531,56,62,118,47.5%,20m
14938,3,GentlemanSam,3069,1088,40,45,85,47.1%,22m
14938,1,gongor,3069,643,29,15,44,65.9%,16m
14938,1,[NextDC]SnOw,3069,458,23,16,39,59.0%,2m
14938,1,[DarkAG]cbearfresh,3069,578,21,19,40,52.5%,19m
14938,1,[Nuutzz]ToxicJackal,3069,504,15,11,26,57.7%,34m
14938,3,Dinosaur,3069,308,10,12,22,45.5%,37m
14938,1,SoulMatt,3069,252,9,2,11,81.8%,25m
14938,2,[Smort]Liquor,3069,199,8,5,13,61.5%,1h
14938,3,Phantastic,3069,192,8,13,21,38.1%,26m
14938,2,ShieldReaver,3069,183,7,4,11,63.6%,28m
14938,1,IIIIIIII,3069,218,6,8,14,42.9%,29m
14938,3,[CHOPIN]Janszilla,3069,168,5,6,11,45.5%,5m
14938,3,Shelf,3069,97,4,2,6,66.7%,51m
14938,3,Skinnypete,3069,97,2,5,7,28.6%,41m
14938,1,Daljones,3069,0,1,0,1,100.0%,10m
14938,1,IIIIIOoIIIII,3069,0,1,0,1,100.0%,20m
14938,1,Doubt,3069,0,1,0,1,100.0%,11m
14938,1,[lNno]Obzidion,3069,0,0,3,3,0.0%,27m
14957,1,[TGosuD]Fullmetal,3068,1721,206,184,390,52.8%,41m
14957,1,Piwo,3068,1607,168,144,312,53.8%,41m
14957,3,chainfire,3068,1511,124,109,233,53.2%,20m
14957,1,Gamerdevotee,3068,1024,49,41,90,54.4%,22m
14957,1,ash,3068,922,34,29,63,54.0%,27m
14957,3,jhon,3068,411,28,31,59,47.5%,19m
14957,1,NSkowyra,3068,676,21,19,40,52.5%,42m
14957,1,Fishbed,3068,546,18,15,33,54.5%,10m
14957,1,Paradox,3068,223,10,6,16,62.5%,18m
14957,3,BadDecision,3068,318,10,21,31,32.3%,16m
14957,1,Palitox,3068,145,5,5,10,50.0%,10m
14957,2,EcoFresh,3068,120,4,3,7,57.1%,16m
14957,1,KingEagle,3068,0,3,2,5,60.0%,41m
14957,1,KATAHA,3068,0,3,2,5,60.0%,7m
14957,3,TMALsem,3068,30,2,5,7,28.6%,6m
14957,1,Solidham,3068,0,1,0,1,100.0%,25m
14957,1,[HAV0C]HighCommand,3068,0,1,0,1,100.0%,36m
14957,1,abe,3068,88,1,1,2,50.0%,10m
14957,1,RoastedDango,3068,44,1,2,3,33.3%,34m
14957,1,Sourmintz,3068,38,1,2,3,33.3%,19m
14957,1,[Drki]EpyoN,3068,42,1,4,5,20.0%,27m
14957,1,BrooksyX,3068,0,0,1,1,0.0%,5m
14957,1,Prey,3068,0,0,1,1,0.0%,21m
14957,1,lacreatura,3068,0,0,1,1,0.0%,37m
14957,3,Shifttabguy,3068,0,0,6,6,0.0%,33m
14982,1,Zargalose,3067,1571,124,92,216,57.4%,33m
14982,3,Satoshi,3067,1491,89,84,173,51.4%,16m
14982,1,Yammz,3067,1243,66,54,120,55.0%,42m
14982,1,[RndNgr]WhimsOfFate,3067,923,37,21,58,63.8%,11m
14982,3,[CHEASE]Cheezelord,3067,876,33,40,73,45.2%,38m
14982,1,TarMinyatur,3067,139,16,13,29,55.2%,19m
14982,3,[LuTu]xPinny,3067,402,14,20,34,41.2%,38m
14982,3,RGLuckedOutt,3067,128,7,10,17,41.2%,35m
14982,1,johnpark,3067,136,4,1,5,80.0%,10m
14982,1,[ValidG]Happyklans,3067,78,3,1,4,75.0%,2m
14982,1,NastyFart,3067,125,3,1,4,75.0%,8m
14982,1,tenK,3067,0,3,2,5,60.0%,2h
14982,1,TheUndermind,3067,110,3,3,6,50.0%,27m
14982,3,Lers,3067,62,3,6,9,33.3%,41m
14982,1,forgetone,3067,129,2,5,7,28.6%,23m
14982,1,CANNONS,3067,0,1,0,1,100.0%,19m
14982,1,dandan,3067,38,1,1,2,50.0%,26m
14982,3,Shredling,3067,30,1,3,4,25.0%,42m
14982,3,Ouranon,3067,30,1,3,4,25.0%,21m
14982,1,[MATUTO]Unklejapes,3067,0,0,1,1,0.0%,20m
14982,1,HAMSTERZ,3067,0,0,1,1,0.0%,34m
14982,2,Magnificent,3067,0,0,1,1,0.0%,26m
14982,1,[1Kun]KonoDioDa,3067,0,0,1,1,0.0%,27m
14982,1,[WaIl]HukKilledEG,3067,0,0,2,2,0.0%,8m
15006,3,Serral,3066,1245,201,184,385,52.2%,40m
15006,3,TheUndermind,3066,1220,93,92,185,50.3%,9m
15006,1,[neuroW]FeAr,3066,561,92,74,166,55.4%,33m
15006,3,LoneStar,3066,1215,44,48,92,47.8%,9m
15006,3,Stcalde,3066,992,34,45,79,43.0%,42m
15006,3,Phoenix,3066,690,22,37,59,37.3%,36m
15006,3,MicroJackson,3066,476,19,21,40,47.5%,27m
15006,1,Gurrpah,3066,600,17,17,34,50.0%,42m
15006,1,vulak,3066,308,13,8,21,61.9%,19m
15006,3,Dashbinator,3066,118,7,2,9,77.8%,8m
15006,1,TheMexicanKi,3066,218,7,7,14,50.0%,25m
15006,3,Vicious,3066,147,6,4,10,60.0%,54m
15006,1,[pntoCL]jjXploittCL,3066,224,6,10,16,37.5%,14m
15006,1,[RLR2]valithor,3066,157,5,0,5,100.0%,21m
15006,1,Heofon,3066,169,5,2,7,71.4%,23m
15006,1,[Th3Bad]LadyDasCasta,3066,143,4,0,4,100.0%,8m
15006,3,[MLtH]PPrKut,3066,132,4,5,9,44.4%,7m
15006,3,[BlHawk]BOneSixSixER,3066,88,4,7,11,36.4%,28m
15006,2,NoahTerve,3066,102,3,1,4,75.0%,36m
15006,1,UltimaFlares,3066,80,3,2,5,60.0%,2m
15006,3,leviathan,3066,122,3,6,9,33.3%,2m
15006,1,Tojik,3066,0,0,1,1,0.0%,17m
15006,1,Platypux,3066,0,0,4,4,0.0%,23m
15006,3,[L3gion]Panda,3066,0,0,6,6,0.0%,28m
15030,3,SaltLakers,3065,1330,369,336,705,52.3%,28m
15030,1,Vulkan,3065,1747,72,61,133,54.1%,20m
15030,3,Whiss,3065,823,36,44,80,45.0%,36m
15030,1,Vaporflare,3065,369,16,10,26,61.5%,25m
15030,3,KINGPINCHINO,3065,289,14,9,23,60.9%,4m
15030,3,Apollo,3065,236,12,8,20,60.0%,38m
15030,1,[Pharoh]snowdrop,3065,207,7,1,8,87.5%,22m
15030,3,lalomon,3065,216,7,13,20,35.0%,5m
15030,1,Randy,3065,238,6,6,12,50.0%,33m
15030,1,vector,3065,124,3,7,10,30.0%,15m
15030,1,reflection,3065,117,2,2,4,50.0%,18m
15030,1,Link,3065,46,2,3,5,40.0%,2h
15030,1,Keennuts,3065,0,1,1,2,50.0%,13m
15030,1,Beatnikb,3065,42,1,3,4,25.0%,15m
15030,1,[ZMBELT]FrzStar,3065,0,0,1,1,0.0%,13m
15030,3,[TgAg]Macaroonies,3065,0,0,4,4,0.0%,6m
15046,3,DaddyCupcake,3064,1551,336,344,680,49.4%,16m
15046,3,[GOPES]LtKije,3064,1452,217,208,425,51.1%,11m
15046,1,Mondragon,3064,1524,149,133,282,52.8%,27m
15046,3,[BOR8iz]ojinchung,3064,603,39,38,77,50.6%,41m
15046,1,JaeD,3064,522,16,15,31,51.6%,14m
15046,3,[GnR]Chim,3064,378,13,21,34,38.2%,33m
15046,3,Shifty,3064,196,9,8,17,52.9%,28m
15046,1,Rithia,3064,210,6,7,13,46.2%,7m
15046,1,[Astute]Anomalist,3064,211,5,5,10,50.0%,8m
15046,3,Nigeeeeeeeer,3064,0,4,2,6,66.7%,3h
15046,3,adsadadada,3064,97,4,2,6,66.7%,2h
15046,1,[UFC]BenCor,3064,70,3,1,4,75.0%,11m
15046,1,[TGCrew]FGiamteuton,3064,84,3,4,7,42.9%,17m
15046,1,DasCeasar,3064,116,3,6,9,33.3%,27m
15046,1,DaNoob,3064,0,2,3,5,40.0%,11m
15046,1,Hutch,3064,0,1,0,1,100.0%,12m
15046,3,Damage,3064,0,1,0,1,100.0%,14m
15046,1,Krazyquakers,3064,0,1,0,1,100.0%,21m
15046,1,BMZerg,3064,40,1,2,3,33.3%,18m
15046,3,biggelwelp,3064,42,1,2,3,33.3%,15m
15046,1,[HODE]TCB,3064,0,0,1,1,0.0%,23m
15067,3,JupiterOM,3063,1492,119,118,237,50.2%,8m
15067,3,NaCo,3063,1324,97,81,178,54.5%,29m
15067,1,[fLotz]ohad,3063,935,59,58,117,50.4%,14m
15067,1,Zaggat,3063,1317,53,45,98,54.1%,41m
15067,3,SpaceDaD,3063,355,38,31,69,55.1%,38m
15067,1,[GSS]Who,3063,257,15,8,23,65.2%,19m
15067,1,Dasbooty,3063,281,13,6,19,68.4%,16m
15067,1,[FTLT]SuperJonas,3063,442,12,12,24,50.0%,35m
15067,3,Rodion,3063,334,12,18,30,40.0%,17m
15067,1,[Frolik]jykknti,3063,253,9,7,16,56.2%,27m
15067,1,Gavin,3063,237,7,4,11,63.6%,31m
15067,1,Commando,3063,231,7,4,11,63.6%,41m
15067,1,[Wh0]MaxPower,3063,166,7,5,12,58.3%,7m
15067,3,sixfour,3063,121,5,3,8,62.5%,2h
15067,3,TTRM,3063,0,4,2,6,66.7%,28m
15067,1,Nezz,3063,0,3,2,5,60.0%,37m
15067,1,Wafflez,3063,0,1,1,2,50.0%,22m
15067,1,[LiPy]waxccino,3063,0,1,1,2,50.0%,13m
15067,1,DrDiabolicon,3063,42,1,1,2,50.0%,18m
15067,1,Tycho,3063,0,0,2,2,0.0%,10m
15067,2,lIlIlI,3063,0,0,2,2,0.0%,46m
15067,1,Jack,3063,0,0,2,2,0.0%,10m
15089,1,Mace,3062,797,91,52,143,63.6%,31m
15089,3,Geoff,3062,1405,64,60,124,51.6%,32m
15089,3,Goldtean,3062,1233,43,50,93,46.2%,40m
15089,3,[IPCSI]BARBOL,3062,522,18,23,41,43.9%,38m
15089,1,[DNEdge]Nagasaki,3062,353,16,12,28,57.1%,18m
15089,3,[ZTemp]akamrchubs,3062,216,8,13,21,38.1%,36m
15089,1,Trident,3062,314,8,13,21,38.1%,22m
15089,3,[cl0udM]DaCooGa,3062,188,6,13,19,31.6%,28m
15089,1,[GaMTaK]TaKMashido,3062,110,4,5,9,44.4%,26m
15089,1,[CToL]FractalSky,3062,146,4,9,13,30.8%,13m
15089,1,Mevans,3062,157,3,2,5,60.0%,39m
15089,1,[MAGA1]MorningStar,3062,119,3,2,5,60.0%,19m
15089,3,kaiboy,3062,140,3,3,6,50.0%,22m
15089,1,[MIT]Occam,3062,40,1,4,5,20.0%,37m
15089,1,BertD,3062,0,0,2,2,0.0%,10m
15104,3,TimboSlice,3061,1519,127,121,248,51.2%,18m
15104,3,sJerome,3061,1593,119,114,233,51.1%,9m
15104,3,BannanaBean,3061,1053,42,43,85,49.4%,12m
15104,1,Kureiton,3061,677,34,18,52,65.4%,4m
15104,1,[SCMK]Viaos,3061,708,28,23,51,54.9%,27m
15104,3,[GGMESP]Gipsy,3061,712,26,34,60,43.3%,32m
15104,1,Starnet,3061,446,21,13,34,61.8%,11m
15104,1,tongomalote,3061,458,20,18,38,52.6%,7m
15104,1,MARINEKING,3061,403,15,11,26,57.7%,31m
15104,1,Strahd,3061,267,14,15,29,48.3%,37m
15104,1,[NLTN]Defeater,3061,428,13,13,26,50.0%,15m
15104,3,Brynxi,3061,281,8,13,21,38.1%,28m
15104,1,[HA1TI]Kaleuk,3061,272,7,8,15,46.7%,11m
15104,1,Kankedort,3061,236,7,9,16,43.8%,8m
15104,3,ZeTuP,3061,218,7,10,17,41.2%,2m
15104,1,[Bobjr]bobjr,3061,183,6,1,7,85.7%,39m
15104,1,Etherion,3061,190,6,4,10,60.0%,22m
15104,1,[Lima]donuvan,3061,232,6,10,16,37.5%,10m
15104,1,Azgalor,3061,171,5,1,6,83.3%,34m
15104,1,StStephen,3061,152,4,4,8,50.0%,9m
15104,1,[NorthW]CassiuS,3061,0,3,2,5,60.0%,37m
15104,1,absolut,3061,0,3,2,5,60.0%,8m
15104,1,nanogeo,3061,40,2,2,4,50.0%,31m
15104,1,pizza,3061,40,2,3,5,40.0%,39m
15104,1,Gilgamesh,3061,42,2,4,6,33.3%,36m
15104,1,[hikari]lilystar,3061,74,2,4,6,33.3%,9m
15104,1,Qualcomm,3061,0,0,1,1,0.0%,43m
15131,3,[HBNC]QuipsQuaff,3060,1503,168,169,337,49.9%,6m
15131,3,MJR,3060,975,145,126,271,53.5%,2m
15131,3,[LuxVI]Faust,3060,1549,114,115,229,49.8%,5m
15131,3,Bells,3060,1173,91,83,174,52.3%,39m
15131,3,[Pizzy]George,3060,1338,68,65,133,51.1%,29m
15131,3,Vex,3060,1481,57,58,115,49.6%,2m
15131,3,Ghostly,3060,1230,49,44,93,52.7%,16m
15131,1,[ChfSho]chef,3060,1264,45,38,83,54.2%,8m
15131,3,JackFrost,3060,901,43,48,91,47.3%,22m
15131,1,Manic,3060,763,34,28,62,54.8%,23m
15131,1,YUCK,3060,438,16,10,26,61.5%,16m
15131,1,CZK,3060,336,15,12,27,55.6%,33m
15131,1,spartan,3060,235,8,3,11,72.7%,10m
15131,1,GaMeFrEaK,3060,238,7,8,15,46.7%,27m
15131,1,Michilover,3060,226,7,9,16,43.8%,8m
15131,1,smokedleader,3060,211,6,4,10,60.0%,7m
15131,1,[iDrunk]Artanis,3060,141,5,1,6,83.3%,17m
15131,3,Redbaron,3060,94,5,11,16,31.2%,29m
15131,3,Chirp,3060,56,5,12,17,29.4%,17m
15131,1,Metric,3060,0,4,1,5,80.0%,37m
15131,3,[NPhasA]HASPEL,3060,163,4,8,12,33.3%,13m
15131,1,[HPing]Armadesdons,3060,0,2,3,5,40.0%,7m
15131,3,DaBeast,3060,97,2,5,7,28.6%,1h
15131,1,Jinsus,3060,42,1,2,3,33.3%,8m
15131,1,DrunkenDonke,3060,0,0,1,1,0.0%,8m
15131,1,Myelin,3060,0,0,1,1,0.0%,19m
15157,1,HamesJarden,3059,1593,184,150,334,55.1%,5m
15157,3,[Thepik]Scars,3059,1107,91,92,183,49.7%,17m
15157,3,Battousai,3059,525,37,37,74,50.0%,16m
15157,2,soojung,3059,1006,33,57,90,36.7%,22m
15157,3,[EzWinn]NoobSAUCE,3059,779,26,31,57,45.6%,13m
15157,1,baabaa,3059,517,21,16,37,56.8%,7m
15157,3,[OXYDOR]AKHAN,3059,429,18,16,34,52.9%,32m
15157,3,bustercat,3059,448,16,22,38,42.1%,38m
15157,1,AKC,3059,372,14,10,24,58.3%,17m
15157,1,sagaro,3059,279,10,7,17,58.8%,2h
15157,1,[720p]Snapperkai,3059,236,7,3,10,70.0%,35m
15157,1,Ryzier,3059,213,7,8,15,46.7%,7m
15157,1,[TAILED]Noobsprinter,3059,0,5,0,5,100.0%,21m
15157,1,NanoPixel,3059,0,4,2,6,66.7%,25m
15157,2,FookMi,3059,135,4,2,6,66.7%,2h
15157,3,ThatOneDude,3059,90,4,5,9,44.4%,35m
15157,1,SteeL,3059,0,3,2,5,60.0%,17m
15157,1,KiRiTo,3059,113,2,4,6,33.3%,17m
15157,1,JaKe,3059,0,1,4,5,20.0%,35m
15157,1,Wootfish,3059,0,0,1,1,0.0%,4m
15157,1,Topher,3059,0,0,2,2,0.0%,37m
15157,1,ashfear,3059,0,0,2,2,0.0%,17m
15157,1,Clarky,3059,0,0,5,5,0.0%,2h
15180,3,GeoRed,3058,1546,202,193,395,51.1%,39m
15180,1,Nova,3058,1071,197,150,347,56.8%,11m
15180,1,Woody,3058,1433,171,145,316,54.1%,25m
15180,1,[UpxV]TYTY,3058,1389,112,95,207,54.1%,10m
15180,3,kOnpaker,3058,1497,76,88,164,46.3%,6m
15180,3,[ZCCCFE]mas,3058,1339,67,64,131,51.1%,3m
15180,1,Aqua,3058,1121,48,32,80,60.0%,8m
15180,1,[RdRC]TcoR,3058,1013,44,26,70,62.9%,22m
15180,1,Zeratul,3058,1154,43,46,89,48.3%,14m
15180,1,Ryz,3058,1118,39,36,75,52.0%,17m
15180,3,[GnR]Syblix,3058,912,39,45,84,46.4%,26m
15180,2,TheEntertain,3058,737,39,59,98,39.8%,29m
15180,1,Fluxation,3058,510,35,26,61,57.4%,34m
15180,1,[RUINPP]BugsBunny,3058,682,29,13,42,69.0%,20m
15180,1,DarkLaw,3058,289,9,10,19,47.4%,7m
15180,1,alex,3058,86,6,8,14,42.9%,38m
15180,2,IIIIIIIIIIII,3058,92,5,2,7,71.4%,26m
15180,1,[dIabR0]Zeus,3058,140,5,3,8,62.5%,39m
15180,1,Waggy,3058,0,3,2,5,60.0%,10m
15180,2,[CeGeCe]TayYay,3058,113,2,1,3,66.7%,4m
15180,1,Reckless,3058,76,2,2,4,50.0%,37m
15180,1,liquidlucck,3058,42,2,3,5,40.0%,39m
15180,1,Rorschach,3058,80,2,6,8,25.0%,11m
15180,1,FrameBonjwa,3058,0,1,0,1,100.0%,21m
15180,3,theWizard,3058,0,1,0,1,100.0%,4m
15180,3,Scamander,3058,0,1,1,2,50.0%,1h
15180,1,[AUSTIG]TIGER,3058,0,0,1,1,0.0%,43m
15180,1,MGUH,3058,0,0,1,1,0.0%,13m
15180,2,[BLSR]Izzerik,3058,0,0,1,1,0.0%,59m
15180,1,llililliilil,3058,0,0,2,2,0.0%,7m
15180,1,SpiritnBlack,3058,0,0,3,3,0.0%,8m
15211,1,[phew]Hipocampo,3057,1745,170,159,329,51.7%,9m
15211,3,BerZerkEr,3057,1486,151,154,305,49.5%,38m
15211,3,Jon,3057,1469,113,103,216,52.3%,5m
15211,1,[HØST]Agiota,3057,1040,110,94,204,53.9%,9m
15211,1,ALLZERG,3057,1329,105,85,190,55.3%,39m
15211,1,madumlao,3057,1482,80,77,157,51.0%,19m
15211,3,JesteR,3057,844,54,45,99,54.5%,14m
15211,1,[FxB]dere,3057,1102,46,38,84,54.8%,7m
15211,3,[LimaSC]ZATOX,3057,774,41,43,84,48.8%,40m
15211,3,CANCEL,3057,965,41,47,88,46.6%,11m
15211,1,Bean,3057,745,28,24,52,53.8%,41m
15211,1,BoomBabyBoom,3057,377,27,26,53,50.9%,11m
15211,1,Antonio,3057,607,22,15,37,59.5%,17m
15211,1,lllllllllllI,3057,517,16,17,33,48.5%,17m
15211,1,FuNdaMentaL,3057,381,14,13,27,51.9%,19m
15211,1,SIRCOL,3057,406,13,11,24,54.2%,30m
15211,3,Eyedea,3057,121,5,3,8,62.5%,53m
15211,3,SpicySmegma,3057,145,4,1,5,80.0%,1h
15211,1,[NoMate]IIIIIIIIIIII,3057,118,4,2,6,66.7%,9m
15211,1,zackman,3057,158,4,7,11,36.4%,19m
15211,1,Botiz,3057,156,4,7,11,36.4%,19m
15211,1,[ProSC]queuez,3057,171,4,7,11,36.4%,17m
15211,1,Wolfbach,3057,36,2,0,2,100.0%,23m
15211,3,LupercioCWY,3057,32,2,0,2,100.0%,2m
15211,1,Gutofoo,3057,80,2,3,5,40.0%,39m
15211,1,[proChi]Demonios,3057,0,1,0,1,100.0%,10m
15211,1,PatataPwel,3057,0,1,0,1,100.0%,5m
15211,1,Loc,3057,0,1,0,1,100.0%,23m
15211,1,WeaselFace,3057,40,1,1,2,50.0%,19m
15211,1,[TONIC]Sketchaphone,3057,0,1,1,2,50.0%,17m
15211,1,miamilow,3057,0,1,1,2,50.0%,33m
15211,1,Pio,3057,32,1,2,3,33.3%,28m
15211,1,Masterchief,3057,0,1,3,4,25.0%,11m
15211,2,llllllllllll,3057,0,0,3,3,0.0%,46m
15245,3,Shade,3056,1502,234,215,449,52.1%,36m
15245,1,Elmister,3056,1726,132,107,239,55.2%,9m
15245,3,[cbox]Aronator,3056,1309,61,58,119,51.3%,2m
15245,1,[NaNiii]TurtleMoans,3056,1085,50,46,96,52.1%,19m
15245,3,[LgnTDS]DirtyGG,3056,714,30,32,62,48.4%,35m
15245,3,HaroldBluTth,3056,380,23,18,41,56.1%,29m
15245,1,GagamelsRage,3056,426,18,8,26,69.2%,17m
15245,1,klye,3056,394,15,11,26,57.7%,21m
15245,2,[NPhasA]wicky,3056,386,11,36,47,23.4%,22m
15245,1,BePositive,3056,358,10,12,22,45.5%,28m
15245,1,Skyre,3056,150,6,2,8,75.0%,14m
15245,2,[Po0pY]Omniwaffle,3056,189,6,4,10,60.0%,1h
15245,1,[CDAL]Otávio,3056,88,4,2,6,66.7%,41m
15245,1,[PlMP]Jaimetamere,3056,103,3,1,4,75.0%,16m
15245,1,kingkasual,3056,114,3,3,6,50.0%,28m
15245,1,Hydrago,3056,76,2,2,4,50.0%,41m
15245,1,plooty,3056,0,0,1,1,0.0%,2h
15245,2,GraySleet,3056,0,0,1,1,0.0%,29m
15245,1,[YBOR]Goliath,3056,0,0,1,1,0.0%,25m
15245,1,BlackSanta,3056,0,0,5,5,0.0%,8m
15265,3,[UpxV]MATSUMOTO,3055,1478,135,129,264,51.1%,22m
15265,1,Julz,3055,1191,50,39,89,56.2%,8m
15265,1,[DRKAPP]Teufelhunden,3055,878,50,40,90,55.6%,25m
15265,3,[No0Bs]FluffyZling,3055,920,31,43,74,41.9%,6m
15265,1,psicoloco,3055,426,18,15,33,54.5%,10m
15265,1,[FtSn]NaThan,3055,566,17,17,34,50.0%,17m
15265,1,Jinn,3055,292,14,12,26,53.8%,37m
15265,1,HaveFun,3055,408,13,14,27,48.1%,40m
15265,3,[MiMs]gamsi,3055,386,13,21,34,38.2%,38m
15265,1,Xian,3055,219,9,6,15,60.0%,18m
15265,1,Golddagger,3055,148,8,5,13,61.5%,17m
15265,1,RIP,3055,165,7,5,12,58.3%,32m
15265,1,IIIIIIIIIIII,3055,258,7,10,17,41.2%,35m
15265,2,FyreFly,3055,140,6,5,11,54.5%,2h
15265,1,[SYNDCT]DarthZerg,3055,159,4,1,5,80.0%,14m
15265,3,madrebirth,3055,0,4,2,6,66.7%,3m
15265,1,[PTHero]Jenger,3055,0,1,0,1,100.0%,29m
15265,1,FrostedTuna,3055,38,1,1,2,50.0%,35m
15265,1,[TMWar]ZaikO,3055,40,1,3,4,25.0%,23m
15265,3,IIIIIIIIIIII,3055,0,0,1,1,0.0%,17m
15265,1,flhas,3055,0,0,1,1,0.0%,29m
15265,1,KindScumbag,3055,0,0,1,1,0.0%,36m
15265,3,maus,3055,0,0,8,8,0.0%,4m
15288,3,FreeWinGiver,3054,1560,185,194,379,48.8%,35m
15288,3,Kingelman,3054,859,114,134,248,46.0%,11m
15288,1,Jayzus,3054,1119,83,72,155,53.5%,25m
15288,3,FartBox,3054,1462,80,90,170,47.1%,31m
15288,3,yolkyasian,3054,1030,50,44,94,53.2%,24m
15288,1,pixel,3054,1335,46,41,87,52.9%,8m
15288,3,Marquinhos,3054,902,42,31,73,57.5%,8m
15288,1,[TGosuC]Siren,3054,690,27,19,46,58.7%,5m
15288,3,MushroomMan,3054,592,27,29,56,48.2%,40m
15288,1,Wrath,3054,538,21,21,42,50.0%,28m
15288,1,[RT]voltageRt,3054,311,11,6,17,64.7%,35m
15288,1,RhubarbIIOI,3054,311,11,11,22,50.0%,13m
15288,1,Gibkram,3054,262,8,6,14,57.1%,20m
15288,1,Legendary,3054,154,7,0,7,100.0%,7m
15288,2,[ValidG]SpoOky,3054,183,5,2,7,71.4%,28m
15288,1,[Lp]FIERAX,3054,74,3,1,4,75.0%,21m
15288,1,IPower,3054,116,3,5,8,37.5%,28m
15288,3,Spectre,3054,30,2,4,6,33.3%,39m
15288,1,TitoPayToo,3054,36,1,2,3,33.3%,3m
15288,1,[GOPERÚ]dennyslll,3054,0,0,1,1,0.0%,9m
15288,3,litfaßsäule,3054,0,0,1,1,0.0%,3h
15309,3,ShiverTwitch,3053,1181,251,245,496,50.6%,7m
15309,3,CopiCaT,3053,1429,114,117,231,49.4%,11m
15309,3,Damon,3053,521,103,70,173,59.5%,3m
15309,1,Frostwhisper,3053,562,80,54,134,59.7%,23m
15309,1,SuedePritch,3053,701,25,21,46,54.3%,7m
15309,1,xZTzl,3053,370,15,9,24,62.5%,7m
15309,1,Gaijin,3053,437,14,17,31,45.2%,23m
15309,1,YaaR,3053,222,9,3,12,75.0%,17m
15309,1,nosfer,3053,254,8,6,14,57.1%,35m
15309,3,PulloutKing,3053,239,7,6,13,53.8%,42m
15309,1,QuimicaLoca,3053,0,4,1,5,80.0%,7m
15309,1,FridayFury,3053,146,4,4,8,50.0%,29m
15309,1,Salem,3053,38,2,0,2,100.0%,7m
15309,1,AmarisRed,3053,38,2,1,3,66.7%,37m
15309,1,Ragelot,3053,102,2,4,6,33.3%,29m
15309,3,Vaknazz,3053,0,1,1,2,50.0%,24m
15309,1,[KanZan]KanSanZio,3053,0,0,2,2,0.0%,9m
15309,1,haker,3053,0,0,2,2,0.0%,13m
15327,3,Andy,3052,1558,432,428,860,50.2%,21m
15327,3,Star,3052,1583,314,302,616,51.0%,38m
15327,3,[RS69]Toxin,3052,1425,60,64,124,48.4%,38m
15327,1,Indy,3052,756,38,26,64,59.4%,10m
15327,1,Kubrickr,3052,830,36,20,56,64.3%,23m
15327,1,[NrFms]Matriarchy,3052,938,33,32,65,50.8%,37m
15327,1,[ASC1]USSR,3052,413,15,8,23,65.2%,8m
15327,3,[TCD]Neferio,3052,422,14,17,31,45.2%,32m
15327,1,zookeeper,3052,392,12,11,23,52.2%,22m
15327,1,TheEND,3052,233,9,3,12,75.0%,10m
15327,1,JotaDe,3052,332,9,12,21,42.9%,11m
15327,3,GankedByLam,3052,30,6,5,11,54.5%,7m
15327,1,Zicova,3052,134,4,1,5,80.0%,28m
15327,1,GLHF,3052,48,4,2,6,66.7%,46m
15327,3,Devlish,3052,90,4,13,17,23.5%,2m
15327,1,Suigetsu,3052,0,3,2,5,60.0%,11m
15327,1,Take,3052,76,3,3,6,50.0%,16m
15327,1,WayTooSlick,3052,82,2,6,8,25.0%,37m
15327,1,[EasyOn]Smile,3052,72,2,7,9,22.2%,40m
15327,1,IIIIIIIIIIII,3052,48,1,1,2,50.0%,3h
15327,3,[VEEJAY]Railgun,3052,97,1,2,3,33.3%,3h
15327,1,Technojelly,3052,0,1,3,4,25.0%,15m
15327,3,Tezul,3052,0,0,1,1,0.0%,41m
15327,1,[OpTiCx]FKNTempo,3052,0,0,3,3,0.0%,39m
15351,3,[TAWP69]GaryJohnston,3051,675,176,164,340,51.8%,27m
15351,3,Preowned,3051,1505,159,119,278,57.2%,20m
15351,3,TheAx,3051,1474,132,115,247,53.4%,40m
15351,3,[uy]iluso,3051,1350,127,118,245,51.8%,16m
15351,1,Surfjpn,3051,1618,123,71,194,63.4%,23m
15351,3,RABBIToCOM,3051,1305,110,86,196,56.1%,40m
15351,1,[WLP]Spankypants,3051,1585,64,61,125,51.2%,19m
15351,3,[BioTek]kill,3051,412,43,49,92,46.7%,24m
15351,3,TheDude,3051,926,32,38,70,45.7%,26m
15351,1,Teej,3051,538,16,19,35,45.7%,33m
15351,3,EldritcH,3051,331,10,14,24,41.7%,13m
15351,3,BauerDSN,3051,306,10,24,34,29.4%,30m
15351,1,Genadi,3051,211,9,4,13,69.2%,8m
15351,1,[OPLADR]Axe,3051,155,7,3,10,70.0%,21m
15351,3,RatWithAHat,3051,120,6,1,7,85.7%,28m
15351,3,Muffnz,3051,153,6,3,9,66.7%,53m
15351,1,James,3051,192,6,5,11,54.5%,40m
15351,3,WaterDrop,3051,93,6,6,12,50.0%,36m
15351,1,[Fletzr]SoundsofRain,3051,146,5,6,11,45.5%,19m
15351,1,Friend,3051,0,4,1,5,80.0%,23m
15351,1,Targetdummy,3051,114,4,7,11,36.4%,8m
15351,1,[BadAss]Dtermination,3051,0,3,2,5,60.0%,2h
15351,1,LaQuiCa,3051,92,3,4,7,42.9%,39m
15351,1,[PNET]Shirikun,3051,93,2,0,2,100.0%,42m
15351,1,August,3051,0,2,3,5,40.0%,20m
15351,2,[CUMFRT]Nokturnal,3051,0,1,1,2,50.0%,2h
15351,1,LisaSCToo,3051,0,0,1,1,0.0%,3m
15351,1,Crabby,3051,0,0,1,1,0.0%,29m
15351,1,Shadowbee,3051,0,0,1,1,0.0%,51m
15351,1,dekciw,3051,0,0,2,2,0.0%,42m
15351,1,[JaMiT]andrei,3051,0,0,2,2,0.0%,13m
15382,3,[InGt]Maximus,3050,1630,985,914,1899,51.9%,25m
15382,3,[EtrOy]TheG,3050,1433,486,490,976,49.8%,17m
15382,3,Wiked,3050,1123,142,142,284,50.0%,20m
15382,3,Pskdos,3050,755,106,105,211,50.2%,7m
15382,1,TMASSS,3050,1608,87,77,164,53.0%,37m
15382,3,Ratchet,3050,1487,70,68,138,50.7%,41m
15382,3,[DXPCA]FJgg,3050,1403,57,54,111,51.4%,42m
15382,3,[worlf]hkl,3050,458,56,54,110,50.9%,40m
15382,3,NxrFesdac,3050,732,26,33,59,44.1%,8m
15382,1,brinky,3050,550,23,13,36,63.9%,8m
15382,1,GuZZZiOQ,3050,309,14,5,19,73.7%,25m
15382,1,QueAsco,3050,243,12,10,22,54.5%,39m
15382,2,Jello,3050,185,8,5,13,61.5%,46m
15382,2,QplantiumP,3050,165,7,4,11,63.6%,2h
15382,3,[BOvLs]Athire,3050,203,7,7,14,50.0%,36m
15382,1,dmoo,3050,279,7,7,14,50.0%,21m
15382,3,Privet,3050,161,6,3,9,66.7%,1h
15382,1,[kkj]Sneakyhippo,3050,223,6,12,18,33.3%,28m
15382,1,Manik,3050,172,5,3,8,62.5%,19m
15382,1,GameStrength,3050,120,5,3,8,62.5%,39m
15382,3,KalVentis,3050,116,5,10,15,33.3%,6m
15382,1,November,3050,125,3,1,4,75.0%,26m
15382,2,YanYan,3050,44,2,2,4,50.0%,2h
15382,1,[Mammal]MeowMeow,3050,0,2,3,5,40.0%,23m
15382,1,[xdbx]Blade,3050,78,2,4,6,33.3%,37m
15382,1,Death,3050,0,1,0,1,100.0%,25m
15382,1,Ratóncito,3050,0,1,0,1,100.0%,36m
15382,1,[LBHS]Luis,3050,97,1,2,3,33.3%,11m
15382,1,[CrnKy]Yakuzaku,3050,0,0,1,1,0.0%,39m
15382,1,JUAN,3050,0,0,1,1,0.0%,19m
15382,1,Randomer,3050,0,0,1,1,0.0%,29m
15382,1,TheSwarm,3050,0,0,2,2,0.0%,9m
15382,1,SelFelatio,3050,0,0,5,5,0.0%,23m
15382,3,[Knoob]XVIII,3050,0,0,9,9,0.0%,41m
15416,3,[SAAM]GreenGuy,3049,1599,318,325,643,49.5%,43m
15416,3,[LYBF91]zzz,3049,1526,294,283,577,51.0%,27m
15416,3,SWARM,3049,813,81,80,161,50.3%,30m
15416,3,ChtiReg,3049,1053,41,40,81,50.6%,13m
15416,3,[EndPro]MrRogers,3049,625,39,34,73,53.4%,9m
15416,3,Vesper,3049,821,37,36,73,50.7%,28m
15416,1,[GlRTH]Oniontears,3049,749,29,19,48,60.4%,23m
15416,3,[XHB]TaibaiXu,3049,566,25,28,53,47.2%,17m
15416,1,[FuNg]Mushroom,3049,474,17,17,34,50.0%,22m
15416,1,[cl0udM]AIphaStar,3049,453,15,15,30,50.0%,10m
15416,1,[pogga]JJD,3049,324,13,8,21,61.9%,8m
15416,1,CAD,3049,256,9,8,17,52.9%,2m
15416,1,YeoSK,3049,207,8,3,11,72.7%,11m
15416,3,streetdr,3049,90,6,8,14,42.9%,13m
15416,2,okboyok,3049,182,5,1,6,83.3%,2h
15416,3,[DhZAc1]Sulphuratus,3049,122,5,12,17,29.4%,16m
15416,1,Dan,3049,0,3,2,5,60.0%,9m
15416,1,[ToixcH]handsome,3049,38,2,1,3,66.7%,20m
15416,1,Slurp,3049,78,2,3,5,40.0%,19m
15416,1,[cl0udM]sparkart,3049,65,2,4,6,33.3%,3m
15416,3,WhiteUprise,3049,60,2,8,10,20.0%,40m
15416,1,ctwo,3049,0,1,0,1,100.0%,17m
15416,2,[MenMae]TORRES,3049,40,1,2,3,33.3%,1h
15416,1,WHATISLOVE,3049,32,1,3,4,25.0%,41m
15416,1,Jenkins,3049,39,1,3,4,25.0%,10m
15416,1,BadOmen,3049,0,0,1,1,0.0%,35m
15416,1,[PWNDya]Rlat,3049,0,0,1,1,0.0%,5m
15416,1,[HPJL]KalEl,3049,0,0,3,3,0.0%,37m
15416,1,xlyeysonlx,3049,0,0,6,6,0.0%,21m
15445,3,Caribou,3048,1476,504,471,975,51.7%,2m
15445,3,[PnF]Aristophanes,3048,657,129,127,256,50.4%,26m
15445,3,SirSwiss,3048,1422,127,122,249,51.0%,31m
15445,1,Target,3048,1724,112,99,211,53.1%,23m
15445,3,Greengimp,3048,1402,50,65,115,43.5%,41m
15445,1,RIPidra,3048,1332,49,45,94,52.1%,11m
15445,1,AmUnknown,3048,1038,43,33,76,56.6%,5m
15445,1,[MEEGS]Pathogen,3048,471,26,18,44,59.1%,7m
15445,3,MidnightzZ,3048,478,18,19,37,48.6%,13m
15445,2,[ChfSho]Cork,3048,549,17,44,61,27.9%,18m
15445,1,[KoneOP]Konecthor,3048,386,16,12,28,57.1%,8m
15445,1,NinjaBorn,3048,582,16,18,34,47.1%,37m
15445,1,CoolHandLuc,3048,400,11,15,26,42.3%,39m
15445,1,Brachydios,3048,332,9,14,23,39.1%,22m
15445,3,Watcher,3048,276,9,15,24,37.5%,6m
15445,3,[UoM]PandaKing,3048,247,8,13,21,38.1%,32m
15445,3,LuCiD,3048,182,5,3,8,62.5%,28m
15445,1,[Binge]Meist,3048,38,2,1,3,66.7%,19m
15445,1,[PzC]submit,3048,40,2,1,3,66.7%,29m
15445,1,[SAMBO]solidangle,3048,142,2,3,5,40.0%,58m
15445,1,Fromagerie,3048,0,1,2,3,33.3%,23m
15445,1,SirGrowlAlot,3048,0,1,2,3,33.3%,11m
15467,3,XxBigbossxX,3047,1438,320,290,610,52.5%,36m
15467,1,Killmachine,3047,951,199,190,389,51.2%,39m
15467,1,[E2E]PABON,3047,1535,139,128,267,52.1%,8m
15467,1,[GT2020]Estiven,3047,1238,135,125,260,51.9%,9m
15467,1,[KiMBR]TASSADAR,3047,1233,108,95,203,53.2%,16m
15467,1,Kizzal,3047,955,99,73,172,57.6%,28m
15467,1,Geezer,3047,909,79,72,151,52.3%,41m
15467,3,Faust,3047,1153,66,71,137,48.2%,22m
15467,1,[Pizzy]smooveAlv,3047,819,49,36,85,57.6%,27m
15467,1,Slippi,3047,835,45,26,71,63.4%,34m
15467,3,mOt,3047,883,36,33,69,52.2%,10m
15467,3,Sadboys,3047,810,34,37,71,47.9%,14m
15467,3,Apparat,3047,595,31,41,72,43.1%,11m
15467,1,AWOO,3047,204,12,2,14,85.7%,39m
15467,1,Pubbbb,3047,309,12,9,21,57.1%,38m
15467,1,RoyaleWChees,3047,404,12,12,24,50.0%,35m
15467,1,Peter,3047,298,10,7,17,58.8%,41m
15467,1,[FUGGLY]COL,3047,281,10,11,21,47.6%,22m
15467,3,Padraic,3047,278,9,20,29,31.0%,36m
15467,3,[WDPK]House,3047,170,8,6,14,57.1%,31m
15467,1,Dave,3047,234,8,10,18,44.4%,58m
15467,1,MRHOBBS,3047,202,5,5,10,50.0%,18m
15467,1,Inho,3047,130,4,3,7,57.1%,10m
15467,1,ManU,3047,112,4,3,7,57.1%,35m
15467,1,MrSunrise,3047,124,4,5,9,44.4%,19m
15467,1,Atmosfear,3047,116,3,7,10,30.0%,25m
15467,1,draconian,3047,147,3,9,12,25.0%,22m
15467,1,ScrotemPole,3047,89,2,1,3,66.7%,23m
15467,1,TwoDblDbls,3047,0,2,3,5,40.0%,23m
15467,1,BadgerMole,3047,74,2,3,5,40.0%,13m
15467,1,SigmaMu,3047,40,2,3,5,40.0%,23m
15467,1,[GCells]PsYoNiK,3047,0,1,0,1,100.0%,8m
15467,1,SkelNine,3047,0,1,0,1,100.0%,32m
15467,1,[NOZO]JimBrainer,3047,0,1,1,2,50.0%,20m
15467,1,Notes,3047,0,1,3,4,25.0%,18m
15467,1,[YouGet]vagin,3047,40,1,4,5,20.0%,13m
15467,1,[Heroe]Justice,3047,0,0,1,1,0.0%,2h
15467,1,[NDK]SemMana,3047,0,0,1,1,0.0%,41m
15467,2,[CASR]WarsVengence,3047,0,0,3,3,0.0%,20m
15506,3,Drago,3046,1559,85,83,168,50.6%,24m
15506,1,jdb,3046,1091,80,71,151,53.0%,32m
15506,3,MaximusRTC,3046,492,70,76,146,47.9%,22m
15506,1,LazyGoat,3046,1308,68,19,87,78.2%,41m
15506,1,Stryfe,3046,1121,41,38,79,51.9%,19m
15506,1,oromeo,3046,677,30,30,60,50.0%,2m
15506,1,Husband,3046,577,22,17,39,56.4%,42m
15506,3,ZDoritoSan,3046,283,13,9,22,59.1%,35m
15506,3,Alstreim,3046,154,13,11,24,54.2%,14m
15506,1,RICKY,3046,307,11,5,16,68.8%,31m
15506,1,Clayton,3046,286,11,7,18,61.1%,35m
15506,1,Tachibana,3046,203,8,4,12,66.7%,5m
15506,1,IIIIIIIIIIII,3046,194,8,6,14,57.1%,37m
15506,1,IIIIIIIIIIII,3046,170,6,7,13,46.2%,11m
15506,3,[VALK]Xefro,3046,134,4,6,10,40.0%,26m
15506,1,bewm,3046,118,3,0,3,100.0%,35m
15506,2,[tripL]GaryOak,3046,138,2,3,5,40.0%,7m
15506,1,[FVHS03]Helix,3046,30,1,3,4,25.0%,21m
15506,1,Euphoria,3046,0,0,1,1,0.0%,25m
15506,1,[GClan]Focus,3046,0,0,1,1,0.0%,13m
15506,1,[xNDGxx]olanor,3046,0,0,1,1,0.0%,39m
15527,1,Kesselkill,3045,1718,125,116,241,51.9%,26m
15527,1,Benjamin,3045,1149,98,97,195,50.3%,11m
15527,3,Zoltek,3045,1528,72,68,140,51.4%,11m
15527,3,[DSGoku]ArgentSouL,3045,1222,53,52,105,50.5%,3m
15527,1,[IsIt]Krava,3045,873,42,35,77,54.5%,11m
15527,1,[XTV]Xanoros,3045,480,20,11,31,64.5%,28m
15527,1,[AlIin]killakcin,3045,494,17,11,28,60.7%,37m
15527,1,DREWPICKLES,3045,490,17,20,37,45.9%,29m
15527,1,SoapNShampoo,3045,325,11,6,17,64.7%,12m
15527,1,biiiiiiird,3045,305,10,6,16,62.5%,21m
15527,1,Trapnasty,3045,360,10,16,26,38.5%,39m
15527,1,Reynor,3045,298,9,5,14,64.3%,14m
15527,1,Phantom,3045,214,8,6,14,57.1%,23m
15527,3,Zack,3045,178,8,6,14,57.1%,3m
15527,3,KnoxKing,3045,242,8,20,28,28.6%,41m
15527,1,[GRNSKN]ImmMeta,3045,185,6,9,15,40.0%,38m
15527,1,[CRPCO]HappyDrone,3045,164,4,2,6,66.7%,38m
15527,1,DrBratwurst,3045,0,3,2,5,60.0%,8m
15527,1,[NLTN]Tarkor,3045,138,3,9,12,25.0%,55m
15527,1,Flee,3045,0,1,0,1,100.0%,10m
15527,1,[BestB]MrDiggles,3045,0,1,0,1,100.0%,15m
15527,1,herOS,3045,0,1,0,1,100.0%,25m
15527,1,BrooklynTala,3045,90,1,1,2,50.0%,11m
15527,1,[Unlike]Shinigamy,3045,0,0,1,1,0.0%,36m
15527,1,Threegnomes,3045,0,0,1,1,0.0%,12m
15527,2,shromsdaburd,3045,0,0,1,1,0.0%,20m
15553,3,Justice,3044,1288,320,311,631,50.7%,28m
15553,3,TreyDiesel,3044,1300,254,253,507,50.1%,13m
15553,1,XLFIRE,3044,603,34,18,52,65.4%,37m
15553,1,TheKnightOwl,3044,547,25,17,42,59.5%,13m
15553,1,Bad,3044,473,18,10,28,64.3%,23m
15553,1,HugoNorth,3044,373,15,16,31,48.4%,14m
15553,1,Munic,3044,469,15,17,32,46.9%,9m
15553,1,DoDawn,3044,119,7,2,9,77.8%,13m
15553,1,Tiroir,3044,185,7,6,13,53.8%,2h
15553,1,ObamaOnCRACK,3044,258,6,5,11,54.5%,27m
15553,3,IIIIIIIIIII,3044,58,6,5,11,54.5%,40m
15553,1,MauRuS,3044,236,6,8,14,42.9%,15m
15553,2,WhiteWolf,3044,188,5,9,14,35.7%,36m
15553,3,[TPGGXD]DarKar,3044,121,4,0,4,100.0%,40m
15553,1,BABAYAGA,3044,0,3,2,5,60.0%,41m
15553,1,sixpoolinc,3044,0,1,0,1,100.0%,32m
15553,1,BigSteve,3044,36,1,2,3,33.3%,11m
15553,1,[AutoT]Hefesto,3044,42,1,4,5,20.0%,8m
15553,1,[ML]Kronox,3044,0,1,4,5,20.0%,8m
15553,1,Garal,3044,0,0,1,1,0.0%,23m
15553,1,ChristianAM,3044,0,0,1,1,0.0%,37m
15553,1,[SBlock]SEBASTIAN,3044,0,0,1,1,0.0%,26m
15553,1,SwarmsofZerg,3044,0,0,2,2,0.0%,20m
15576,1,[Clan11]Falkz,3043,865,202,172,374,54.0%,25m
15576,1,[nieBla]Vindicator,3043,709,67,53,120,55.8%,29m
15576,1,Helloperson,3043,851,57,47,104,54.8%,23m
15576,3,Eddatta,3043,748,33,32,65,50.8%,5m
15576,1,owldamage,3043,708,32,23,55,58.2%,41m
15576,1,Arise,3043,541,26,15,41,63.4%,37m
15576,2,GromiT,3043,414,16,23,39,41.0%,18m
15576,3,Cuttttie,3043,305,12,12,24,50.0%,3m
15576,1,Oblique,3043,228,7,6,13,53.8%,23m
15576,1,[iMmsV]Prov,3043,124,6,2,8,75.0%,4m
15576,1,Freidenberg,3043,188,5,6,11,45.5%,20m
15576,1,FEDERER,3043,196,5,8,13,38.5%,7m
15576,1,[s1s]Khadgar,3043,0,3,2,5,60.0%,38m
15576,1,Gonzopov,3043,68,2,6,8,25.0%,35m
15576,1,Drooner,3043,0,1,0,1,100.0%,36m
15576,1,BolinhoFofo,3043,0,0,1,1,0.0%,37m
15576,1,fish,3043,0,0,1,1,0.0%,2m
15576,1,HAL,3043,0,0,1,1,0.0%,11m
15576,1,Geoffreyplz,3043,0,0,2,2,0.0%,8m
15595,1,Killszky,3042,1602,277,263,540,51.3%,23m
15595,3,dan,3042,1503,211,180,391,54.0%,37m
15595,3,[MPC]Jesterhat,3042,1154,175,173,348,50.3%,6m
15595,3,[dress]anthrophobe,3042,539,86,91,177,48.6%,2m
15595,1,Riley,3042,1113,39,34,73,53.4%,37m
15595,3,[Utter]Slivers,3042,661,30,36,66,45.5%,38m
15595,3,Xulassu,3042,291,12,10,22,54.5%,33m
15595,2,Brigadeer,3042,176,9,4,13,69.2%,3h
15595,1,[XxITxX]Joker,3042,210,8,4,12,66.7%,18m
15595,1,[AiMB]RaTe,3042,196,4,4,8,50.0%,41m
15595,3,Sirrus,3042,58,4,8,12,33.3%,25m
15595,1,ViperStraw,3042,88,3,3,6,50.0%,36m
15595,1,David,3042,114,3,4,7,42.9%,15m
15595,1,wokeManlet,3042,0,1,0,1,100.0%,5m
15595,1,[FxB]JJSCPM,3042,73,1,1,2,50.0%,25m
15595,3,adfshsjhds,3042,0,0,1,1,0.0%,9m
15595,1,Cados,3042,0,0,1,1,0.0%,29m
15595,1,[ShTiLe]Goatsie,3042,0,0,1,1,0.0%,27m
15595,1,DilanB,3042,0,0,3,3,0.0%,35m
15614,3,Harken,3041,1563,257,242,499,51.5%,36m
15614,1,SunzofMan,3041,1727,243,238,481,50.5%,34m
15614,3,[sk3tch]Hobbes,3041,1390,235,204,439,53.5%,28m
15614,1,IllIlIlIlIll,3041,1168,74,61,135,54.8%,21m
15614,1,ILLSLAYER,3041,1247,61,39,100,61.0%,41m
15614,1,TôTranquilo,3041,289,16,12,28,57.1%,18m
15614,1,SharkBait,3041,303,15,7,22,68.2%,11m
15614,1,Stardu,3041,341,13,10,23,56.5%,32m
15614,2,Drakthull,3041,348,11,34,45,24.4%,29m
15614,1,[WeDry]Snakebyte,3041,216,7,9,16,43.8%,23m
15614,1,jamstAR,3041,270,6,6,12,50.0%,43m
15614,2,[RAND0M]Juxtapolemic,3041,182,4,3,7,57.1%,45m
15614,1,Geanthor,3041,0,3,3,6,50.0%,23m
15614,1,Xxpandaking,3041,124,3,8,11,27.3%,33m
15614,1,darkmage,3041,76,2,5,7,28.6%,18m
15614,1,isaacrc,3041,0,1,0,1,100.0%,20m
15614,1,Giovanna,3041,0,1,1,2,50.0%,23m
15614,3,Zoooony,3041,97,1,2,3,33.3%,3h
15614,1,SuWhoop,3041,0,0,1,1,0.0%,4m
15633,3,TripleA,3040,1554,189,188,377,50.1%,24m
15633,3,maru,3040,852,158,150,308,51.3%,25m
15633,1,Stardog,3040,1639,130,101,231,56.3%,8m
15633,1,[PY]Uil,3040,1686,113,88,201,56.2%,31m
15633,1,Pyrilus,3040,1485,92,80,172,53.5%,13m
15633,3,jacob,3040,612,49,38,87,56.3%,6m
15633,1,cacalo,3040,745,37,11,48,77.1%,41m
15633,1,Schmickle,3040,532,26,19,45,57.8%,14m
15633,1,mikahel,3040,591,26,22,48,54.2%,18m
15633,1,[AbcCo]ZDoritoSan,3040,493,23,15,38,60.5%,23m
15633,1,StellerShime,3040,530,21,16,37,56.8%,8m
15633,1,[Shardz]Nosneros,3040,506,17,20,37,45.9%,11m
15633,1,CRIOLLO,3040,187,9,5,14,64.3%,17m
15633,2,Jakaldeen,3040,91,6,2,8,75.0%,3h
15633,2,[40T]Kataomoi,3040,186,6,2,8,75.0%,47m
15633,1,[NOKARL]GralCaTTo,3040,135,4,1,5,80.0%,25m
15633,1,Epitometric,3040,88,4,1,5,80.0%,25m
15633,1,VeilUS,3040,116,4,8,12,33.3%,14m
15633,1,Wusch,3040,110,3,4,7,42.9%,28m
15633,3,Spar,3040,129,3,4,7,42.9%,33m
15633,1,ULTRA,3040,125,2,2,4,50.0%,3m
15633,1,ZurieL,3040,0,1,0,1,100.0%,41m
15633,1,akaAVK,3040,0,1,3,4,25.0%,36m
15633,1,Collectibles,3040,0,0,1,1,0.0%,32m
15633,1,Gabriel,3040,0,0,2,2,0.0%,32m
15633,1,Maya,3040,0,0,3,3,0.0%,35m
15659,3,JohnSonOfJon,3039,1558,133,139,272,48.9%,32m
15659,3,Nice,3039,1526,87,77,164,53.0%,36m
15659,3,[BUCK3T]beowulf,3039,1468,85,94,179,47.5%,29m
15659,1,[DiuRex]Sakashima,3039,974,43,35,78,55.1%,10m
15659,1,[SRBA]YAWARA,3039,994,39,30,69,56.5%,17m
15659,3,[TGosuC]RecoH,3039,384,33,34,67,49.3%,33m
15659,3,GYD,3039,676,24,36,60,40.0%,5m
15659,1,Whoknows,3039,266,20,18,38,52.6%,19m
15659,1,wayhara,3039,464,17,14,31,54.8%,10m
15659,1,Sadie,3039,402,16,11,27,59.3%,11m
15659,1,PoKwan,3039,125,14,6,20,70.0%,9m
15659,3,DMFH,3039,212,12,13,25,48.0%,16m
15659,1,sUPerSMuRf,3039,364,11,8,19,57.9%,5m
15659,3,[HYK]Newbie,3039,317,10,12,22,45.5%,12m
15659,1,UHCHU,3039,200,8,3,11,72.7%,37m
15659,1,[GOPERÚ]chupas,3039,146,7,0,7,100.0%,28m
15659,3,Sprinx,3039,157,7,6,13,53.8%,36m
15659,1,[MACBO]DonPatrón,3039,203,6,3,9,66.7%,43m
15659,3,DarkMatter,3039,165,6,4,10,60.0%,30m
15659,2,LifeForAiur,3039,95,5,3,8,62.5%,20m
15659,1,Makken,3039,97,5,4,9,55.6%,55m
15659,1,ATunaOnWhite,3039,181,5,9,14,35.7%,28m
15659,1,multani,3039,133,4,2,6,66.7%,2h
15659,1,[Trons1]Fefel,3039,91,2,0,2,100.0%,39m
15659,1,hsinyofu,3039,108,2,2,4,50.0%,32m
15659,2,Epicktroll,3039,92,2,6,8,25.0%,59m
15659,1,davidjsw,3039,0,1,0,1,100.0%,32m
15659,1,PinkZebra,3039,0,1,0,1,100.0%,39m
15659,2,Hector,3039,44,1,2,3,33.3%,2h
15659,1,Senpai,3039,34,1,6,7,14.3%,29m
15659,1,dareOfficer,3039,0,0,1,1,0.0%,25m
15690,3,[cluez]Neeb,3038,1406,318,309,627,50.7%,11m
15690,1,[SKEL]ROOT,3038,1443,78,65,143,54.5%,13m
15690,3,[FEST]Darwin,3038,864,60,66,126,47.6%,16m
15690,1,[35of35]CRezent,3038,910,29,29,58,50.0%,41m
15690,1,Karl,3038,465,22,13,35,62.9%,37m
15690,1,DreWRanger,3038,456,17,9,26,65.4%,9m
15690,3,CrucibleFour,3038,441,17,17,34,50.0%,5m
15690,1,AaronWilliam,3038,234,13,4,17,76.5%,4m
15690,1,TheArchitect,3038,474,13,13,26,50.0%,26m
15690,1,SpinW,3038,408,13,13,26,50.0%,9m
15690,1,llllllllllll,3038,202,8,5,13,61.5%,10m
15690,1,Limitlessss,3038,118,5,3,8,62.5%,20m
15690,1,Smellycouger,3038,182,4,4,8,50.0%,37m
15690,1,Macromyers,3038,88,3,2,5,60.0%,10m
15690,1,[IICWYD]Battlecroft,3038,80,2,4,6,33.3%,10m
15690,1,aje,3038,89,1,1,2,50.0%,35m
15690,1,BlueFox,3038,0,0,1,1,0.0%,25m
15690,1,ImNakedATM,3038,0,0,2,2,0.0%,23m
15708,3,AaronAWOL,3037,964,94,83,177,53.1%,40m
15708,1,Skywalker,3037,979,76,74,150,50.7%,19m
15708,1,Oggi,3037,1071,66,45,111,59.5%,9m
15708,1,[TRE4]Xade,3037,1333,65,59,124,52.4%,37m
15708,1,Probius,3037,671,50,37,87,57.5%,29m
15708,3,getinnocuous,3037,703,35,37,72,48.6%,13m
15708,1,brotato,3037,716,34,29,63,54.0%,23m
15708,3,DeezNutz,3037,856,34,35,69,49.3%,31m
15708,1,Tony,3037,545,28,23,51,54.9%,10m
15708,1,Bearoo,3037,727,28,23,51,54.9%,26m
15708,3,artfin,3037,796,28,35,63,44.4%,32m
15708,1,[NOLA1]McNazty,3037,255,10,7,17,58.8%,41m
15708,1,WolfGang,3037,112,9,3,12,75.0%,16m
15708,1,DieBorg,3037,236,9,6,15,60.0%,29m
15708,1,Beck,3037,224,8,4,12,66.7%,4m
15708,1,Rafterman,3037,261,7,8,15,46.7%,9m
15708,1,bnz,3037,206,5,4,9,55.6%,30m
15708,1,Wiplash,3037,194,5,5,10,50.0%,28m
15708,1,[ESL]Sinistro,3037,0,3,2,5,60.0%,38m
15708,3,raigomaru,3037,97,2,0,2,100.0%,9m
15708,1,[GOPERÚ]ShadowBoy,3037,0,2,3,5,40.0%,25m
15708,1,America,3037,38,1,2,3,33.3%,23m
15708,1,RoadCrew,3037,38,1,3,4,25.0%,27m
15708,1,[Scoop]FunkyMonke,3037,0,0,1,1,0.0%,29m
15732,1,[4NGLVS]Angelvs,3036,1687,236,232,468,50.4%,10m
15732,1,[LOHs]CANNIBAL,3036,1315,214,199,413,51.8%,26m
15732,1,Oghma,3036,1546,112,107,219,51.1%,20m
15732,1,geigeriffic,3036,1270,106,87,193,54.9%,10m
15732,3,mindspike,3036,735,47,71,118,39.8%,20m
15732,1,IIIIIIIIIIII,3036,1083,43,33,76,56.6%,23m
15732,1,[P07470]staticfloat,3036,838,42,35,77,54.5%,30m
15732,3,Gabriel,3036,793,30,32,62,48.4%,40m
15732,1,quizz,3036,463,24,8,32,75.0%,27m
15732,1,[IMDSI]Hiroshima,3036,505,19,15,34,55.9%,13m
15732,1,Slats,3036,375,16,11,27,59.3%,34m
15732,3,JellyCholt,3036,460,15,26,41,36.6%,33m
15732,1,Orangatan,3036,245,14,6,20,70.0%,39m
15732,3,[LgnTDS]Hawking,3036,307,11,10,21,52.4%,25m
15732,3,yabuyabu,3036,215,11,11,22,50.0%,37m
15732,1,David,3036,251,9,3,12,75.0%,13m
15732,2,Salaberri,3036,213,8,5,13,61.5%,17m
15732,1,Dacz,3036,264,8,7,15,53.3%,9m
15732,1,[KaGaN]lwlwllwl,3036,150,7,0,7,100.0%,30m
15732,1,[WarLT]DrDre,3036,147,5,3,8,62.5%,6m
15732,3,Daemon,3036,166,5,3,8,62.5%,58m
15732,1,Squid,3036,164,5,6,11,45.5%,4m
15732,1,shadynasty,3036,118,4,6,10,40.0%,10m
15732,1,dante,3036,119,4,8,12,33.3%,39m
15732,1,BluEdash,3036,102,3,4,7,42.9%,23m
15732,1,Helig,3036,116,2,1,3,66.7%,33m
15732,1,[SBLAC]IIIIIII,3036,0,1,0,1,100.0%,10m
15732,1,KatanaTrunks,3036,0,1,0,1,100.0%,29m
15732,3,VashtaNerada,3036,0,1,0,1,100.0%,39m
15732,3,PerronenDrgo,3036,97,1,1,2,50.0%,9m
15732,1,mfox,3036,0,1,1,2,50.0%,39m
15732,1,Alvaro,3036,90,1,1,2,50.0%,10m
15732,1,Kamikaze,3036,0,1,2,3,33.3%,15m
15732,1,Rdzm,3036,0,1,4,5,20.0%,12m
15732,1,BabyShoes,3036,0,0,1,1,0.0%,10m
15732,2,Sammysamsam,3036,0,0,1,1,0.0%,4m
15732,1,johnnyboyo,3036,0,0,2,2,0.0%,20m
15769,3,TheOldGuy,3035,1558,191,171,362,52.8%,24m
15769,1,Bigpoops,3035,1750,123,127,250,49.2%,10m
15769,3,crxman,3035,780,78,81,159,49.1%,32m
15769,1,ITBYY,3035,981,46,32,78,59.0%,14m
15769,3,[Sune]Galactus,3035,920,41,38,79,51.9%,38m
15769,1,Ace,3035,664,39,42,81,48.1%,10m
15769,1,Diocletian,3035,389,36,21,57,63.2%,17m
15769,1,JohnWoods,3035,1008,36,34,70,51.4%,10m
15769,1,[FL4]PoCoYo,3035,589,19,16,35,54.3%,28m
15769,1,NORTHKOR,3035,293,14,5,19,73.7%,6m
15769,1,Toxicsneeze,3035,201,14,9,23,60.9%,20m
15769,2,DönerKing,3035,166,7,4,11,63.6%,2h
15769,1,MegaMonster,3035,171,6,2,8,75.0%,32m
15769,1,[GLSD]KDizzle,3035,166,4,4,8,50.0%,7m
15769,1,[RAND0M]AEONMozilla,3035,88,2,0,2,100.0%,36m
15769,1,[N9]SoupAtHand,3035,0,1,0,1,100.0%,18m
15769,1,[ValidG]SafteScizors,3035,0,1,1,2,50.0%,8m
15769,2,[X17]SCV,3035,90,1,8,9,11.1%,2h
15769,1,green,3035,0,0,1,1,0.0%,58m
15769,1,[GFFN]Unthinkable,3035,0,0,2,2,0.0%,2h
15789,1,[ZTempz]eastman,3034,1386,184,147,331,55.6%,19m
15789,3,Rank,3034,1157,165,170,335,49.3%,27m
15789,3,Kroner,3034,1562,90,84,174,51.7%,28m
15789,3,yellowjellow,3034,1162,54,55,109,49.5%,41m
15789,1,TumerzuKING,3034,991,42,40,82,51.2%,8m
15789,1,DJD,3034,676,34,30,64,53.1%,23m
15789,3,ElectricEye,3034,352,15,8,23,65.2%,25m
15789,3,Blatz,3034,201,15,28,43,34.9%,33m
15789,1,[Exper]Shadedark,3034,439,13,11,24,54.2%,13m
15789,1,Dllewx,3034,358,12,11,23,52.2%,32m
15789,1,ManuxS,3034,178,7,2,9,77.8%,11m
15789,3,aznaznazn,3034,240,7,7,14,50.0%,3m
15789,1,[KUNUKU]FranzXaver,3034,0,5,0,5,100.0%,29m
15789,1,[SANGRE]sergio,3034,165,5,1,6,83.3%,10m
15789,1,Maverick,3034,74,3,4,7,42.9%,9m
15789,1,Reinhart,3034,40,1,2,3,33.3%,23m
15789,1,[CHEK]Maluu,3034,36,1,4,5,20.0%,14m
15789,1,Krustenkaese,3034,0,0,1,1,0.0%,22m
15789,1,Nicodemus,3034,0,0,2,2,0.0%,17m
15789,1,[2MZ]IceNineOcean,3034,0,0,5,5,0.0%,14m
15809,2,eltotustus,3033,1368,591,567,1158,51.0%,27m
15809,3,sLaViC,3033,1631,442,443,885,49.9%,37m
15809,3,LIGHT,3033,1535,276,267,543,50.8%,12m
15809,3,MegaByte,3033,1413,169,171,340,49.7%,20m
15809,3,Ferb,3033,848,153,122,275,55.6%,37m
15809,1,WannaBeSteve,3033,1705,105,105,210,50.0%,39m
15809,1,Kaphis,3033,1511,91,77,168,54.2%,14m
15809,1,[MCHG]Snake,3033,1323,76,75,151,50.3%,42m
15809,1,Leo,3033,1293,64,50,114,56.1%,4m
15809,1,Wolverine,3033,874,38,29,67,56.7%,37m
15809,1,CKArakawa,3033,861,37,29,66,56.1%,36m
15809,1,Noonan,3033,748,36,16,52,69.2%,39m
15809,1,Kilani,3033,766,33,24,57,57.9%,9m
15809,1,Totoro,3033,332,32,31,63,50.8%,19m
15809,1,SKCamgirl,3033,356,27,21,48,56.2%,28m
15809,1,[IHHHI]Chrono,3033,734,25,25,50,50.0%,29m
15809,1,Gigeno,3033,183,23,10,33,69.7%,13m
15809,1,[MSFT]Galaxy,3033,464,14,20,34,41.2%,28m
15809,1,[JaMiT]FourHorsemen,3033,290,12,7,19,63.2%,35m
15809,1,exile,3033,349,12,10,22,54.5%,23m
15809,1,Zhanito,3033,280,10,8,18,55.6%,3m
15809,1,Jayzilla,3033,177,5,4,9,55.6%,17m
15809,1,[DDoDD]DirtyJ,3033,53,2,5,7,28.6%,29m
15809,1,Soloism,3033,0,1,0,1,100.0%,36m
15809,3,Calcifer,3033,0,1,1,2,50.0%,27m
15834,1,datmanametom,3032,1697,192,157,349,55.0%,8m
15834,3,OingoBango,3032,1590,97,103,200,48.5%,21m
15834,1,[Undone]UndoneXP,3032,1621,88,79,167,52.7%,37m
15834,1,Escher,3032,1576,71,54,125,56.8%,17m
15834,3,SmurfysLaw,3032,1268,69,71,140,49.3%,32m
15834,1,[UKNOME]QuiRepublic,3032,679,67,42,109,61.5%,15m
15834,3,Kanky,3032,1079,54,55,109,49.5%,24m
15834,3,Skullz,3032,665,34,40,74,45.9%,22m
15834,1,systemd,3032,871,33,25,58,56.9%,10m
15834,1,ethos,3032,395,23,16,39,59.0%,11m
15834,1,[ValidG]Druidic,3032,660,20,22,42,47.6%,13m
15834,3,Fade,3032,426,15,22,37,40.5%,35m
15834,3,EspionagE,3032,280,12,9,21,57.1%,37m
15834,3,MrChow,3032,376,12,23,35,34.3%,4m
15834,1,[TOCUBA]Maximus,3032,190,10,6,16,62.5%,39m
15834,1,[LMen]trenchshot,3032,297,8,6,14,57.1%,35m
15834,1,[Emb3rs]thisisfine,3032,254,6,6,12,50.0%,23m
15834,3,[WCKIT]ArkhamArchon,3032,120,5,17,22,22.7%,2m
15834,1,NeroDeath,3032,184,4,5,9,44.4%,2h
15834,1,Sanctuary,3032,0,1,0,1,100.0%,17m
15834,1,SewerSquirel,3032,0,1,0,1,100.0%,20m
15834,1,[220ms]Mightily,3032,0,1,2,3,33.3%,18m
15834,1,[BoAVN]LaOcH,3032,40,1,4,5,20.0%,22m
15834,1,[DRKESP]Fade,3032,0,0,1,1,0.0%,41m
15858,1,[Yeite]Youya,3031,1713,108,104,212,50.9%,4m
15858,1,PIPELON,3031,1477,82,70,152,53.9%,28m
15858,1,[Foton]Pulsar,3031,1110,47,42,89,52.8%,27m
15858,1,onoT,3031,977,34,29,63,54.0%,41m
15858,1,Atomos,3031,691,30,24,54,55.6%,4m
15858,3,Joel,3031,650,25,35,60,41.7%,28m
15858,3,BioH,3031,458,21,14,35,60.0%,3m
15858,1,jujubeez,3031,469,17,20,37,45.9%,28m
15858,1,[LGSSP]sumeto,3031,132,5,5,10,50.0%,2h
15858,2,Bankai,3031,172,4,3,7,57.1%,3m
15858,3,[cPoG]JaBEER,3031,88,2,1,3,66.7%,28m
15858,1,kenzington,3031,78,2,3,5,40.0%,29m
15858,3,Ghost,3031,30,2,8,10,20.0%,31m
15858,3,[DRS]Kraze,3031,0,1,1,2,50.0%,5m
15858,1,viggo,3031,0,1,1,2,50.0%,25m
15858,1,stravisc,3031,88,1,1,2,50.0%,10m
15858,3,Insayne,3031,0,0,1,1,0.0%,37m
15858,1,JayJones,3031,0,0,1,1,0.0%,38m
15858,1,Rarity,3031,0,0,3,3,0.0%,28m
15877,1,LegitBrit,3030,1648,175,148,323,54.2%,37m
15877,3,BaconNEggs,3030,1537,145,148,293,49.5%,24m
15877,1,[AIAV]yeehaw,3030,1469,61,58,119,51.3%,17m
15877,3,[UpeV]pegasus,3030,1306,46,57,103,44.7%,42m
15877,3,SarthorioFgR,3030,205,37,35,72,51.4%,15m
15877,1,WhiteKey,3030,692,28,22,50,56.0%,28m
15877,3,DKO,3030,584,27,37,64,42.2%,16m
15877,1,[Desani]MummRaaa,3030,337,15,8,23,65.2%,8m
15877,1,DuhCaveMan,3030,283,13,8,21,61.9%,8m
15877,3,Shirne,3030,331,13,10,23,56.5%,23m
15877,3,Howl,3030,314,11,15,26,42.3%,22m
15877,1,Phantasm,3030,251,10,3,13,76.9%,25m
15877,1,[DRAKE7]FosterGIZMO,3030,235,9,5,14,64.3%,10m
15877,1,[bMILO]Cheiffa,3030,300,8,13,21,38.1%,18m
15877,2,alastor,3030,196,7,2,9,77.8%,7m
15877,1,unholykid,3030,164,7,4,11,63.6%,41m
15877,1,[TYBROS]Yalmic,3030,233,6,5,11,54.5%,23m
15877,1,[GGMESP]Thitaniums,3030,147,5,2,7,71.4%,8m
15877,3,RandAlThor,3030,97,5,2,7,71.4%,31m
15877,1,LUNi,3030,148,4,6,10,40.0%,40m
15877,1,LostCause,3030,90,2,0,2,100.0%,23m
15877,1,Kevlar,3030,0,1,0,1,100.0%,17m
15877,1,Facemelta,3030,0,0,1,1,0.0%,4m
15877,3,Yellow,3030,0,0,1,1,0.0%,58m
15877,1,ExpliciTMinD,3030,0,0,3,3,0.0%,9m
15902,1,Zoba,3029,1518,254,228,482,52.7%,33m
15902,3,Tubesssbm,3029,1532,237,230,467,50.7%,18m
15902,1,Khalu,3029,1660,204,187,391,52.2%,23m
15902,1,viruz,3029,1731,169,158,327,51.7%,36m
15902,1,Kreutz,3029,1463,150,140,290,51.7%,8m
15902,3,Chaos,3029,1482,147,141,288,51.0%,40m
15902,3,Griffith,3029,1063,133,132,265,50.2%,42m
15902,1,veenE,3029,1555,107,72,179,59.8%,20m
15902,1,HauerPower,3029,1127,107,92,199,53.8%,35m
15902,3,slipperymess,3029,701,104,92,196,53.1%,21m
15902,1,Redstorm,3029,1006,96,86,182,52.7%,18m
15902,3,DarkstonEr,3029,1560,95,101,196,48.5%,21m
15902,1,[CITIOS]nazart,3029,859,61,45,106,57.5%,9m
15902,1,[GØSU]PickleWeed,3029,943,32,28,60,53.3%,26m
15902,1,loliSlayer,3029,659,28,19,47,59.6%,20m
15902,1,bamboosheet,3029,494,28,22,50,56.0%,8m
15902,1,Vaeleran,3029,475,22,17,39,56.4%,14m
15902,3,ElPajas,3029,490,18,20,38,47.4%,38m
15902,3,RobotNinja,3029,355,12,17,29,41.4%,35m
15902,1,YourHighness,3029,295,11,11,22,50.0%,35m
15902,1,hussey,3029,223,10,2,12,83.3%,37m
15902,1,XeNon,3029,313,10,6,16,62.5%,37m
15902,1,BiHiTRiLL,3029,189,9,6,15,60.0%,24m
15902,1,[Accel]Albert,3029,316,9,8,17,52.9%,37m
15902,1,Mongose,3029,220,8,7,15,53.3%,13m
15902,3,RogerRoger,3029,159,7,6,13,53.8%,14m
15902,1,[WANGZZ]HUMBOLDT,3029,100,6,1,7,85.7%,10m
15902,2,FaDe,3029,120,6,4,10,60.0%,2h
15902,1,fuquer,3029,182,6,5,11,54.5%,8m
15902,3,RyuuShiBaRi,3029,198,6,10,16,37.5%,28m
15902,1,[BLuRJr]BLuRJr,3029,128,4,3,7,57.1%,37m
15902,1,[AnT101]destyni,3029,128,4,3,7,57.1%,2h
15902,1,Quarantined,3029,148,4,5,9,44.4%,19m
15902,1,[UpxV]batimanias,3029,122,4,5,9,44.4%,25m
15902,1,[3shade]Wings,3029,130,3,2,5,60.0%,19m
15902,1,Stokeine,3029,72,3,2,5,60.0%,15m
15902,1,Najten,3029,0,3,2,5,60.0%,8m
15902,2,Shyloch,3029,116,2,1,3,66.7%,20m
15902,1,[NnT]GatoOox,3029,46,2,3,5,40.0%,47m
15902,1,Rigzer,3029,30,2,3,5,40.0%,2m
15902,1,IIIIIIIIIIII,3029,82,2,4,6,33.3%,9m
15902,3,Urza,3029,91,1,2,3,33.3%,2h
15902,3,[WASM]Buster,3029,0,0,1,1,0.0%,3h
15902,1,[HighKo]TheBlank,3029,0,0,1,1,0.0%,3m
15946,1,darklyt,3028,1147,165,161,326,50.6%,35m
15946,1,StabStar,3028,1373,157,130,287,54.7%,10m
15946,1,[TFGID]Dreknal,3028,1709,128,131,259,49.4%,29m
15946,1,PulseStream,3028,1683,80,72,152,52.6%,21m
15946,3,[zzzzz]Zur,3028,832,76,96,172,44.2%,24m
15946,1,PopPop,3028,1523,70,76,146,47.9%,22m
15946,1,littlezerg,3028,1121,45,41,86,52.3%,5m
15946,1,Saamoz,3028,1232,44,38,82,53.7%,4m
15946,1,Datedorck,3028,734,42,34,76,55.3%,25m
15946,1,[HBDO]DELIVEROO,3028,705,32,21,53,60.4%,22m
15946,1,ASAPZerg,3028,603,22,18,40,55.0%,10m
15946,1,[BOOT]Goldo,3028,286,11,7,18,61.1%,22m
15946,1,Ragnar,3028,304,9,10,19,47.4%,13m
15946,3,[clanSD]Sataman,3028,60,7,5,12,58.3%,41m
15946,2,bigbeau,3028,0,5,2,7,71.4%,11m
15946,1,TerryBang,3028,104,5,3,8,62.5%,18m
15946,1,ClpHewitt,3028,194,5,11,16,31.2%,23m
15946,1,Vástago,3028,88,4,2,6,66.7%,6m
15946,1,Nateshack,3028,90,4,3,7,57.1%,6m
15946,3,Mac,3028,60,4,7,11,36.4%,32m
15946,1,ethanwu,3028,0,3,2,5,60.0%,18m
15946,1,[UpeV]Maverick,3028,80,3,3,6,50.0%,32m
15946,1,pride,3028,130,2,3,5,40.0%,26m
15946,2,llllllllllll,3028,0,1,0,1,100.0%,17m
15946,1,Jackvlad,3028,38,1,3,4,25.0%,19m
15946,1,TaX,3028,40,1,4,5,20.0%,10m
15946,3,[PTHero]JTgalactica,3028,0,0,1,1,0.0%,2h
15946,1,xKyo,3028,0,0,2,2,0.0%,23m
15974,1,niknar,3027,1633,150,145,295,50.8%,10m
15974,1,Spacechimps,3027,1169,134,100,234,57.3%,8m
15974,1,ssjchuck,3027,1181,71,72,143,49.7%,21m
15974,3,voodoo,3027,1181,44,49,93,47.3%,8m
15974,1,Ender,3027,354,16,9,25,64.0%,16m
15974,1,SubShoT,3027,220,11,7,18,61.1%,11m
15974,1,IlIlIlIlIlIl,3027,176,10,3,13,76.9%,42m
15974,3,Aldwin,3027,218,9,10,19,47.4%,10m
15974,1,LetGoOnmyoji,3027,211,8,3,11,72.7%,9m
15974,3,Boomboomba,3027,194,7,3,10,70.0%,17m
15974,1,Talon,3027,152,7,4,11,63.6%,8m
15974,2,Jangxhi,3027,184,7,5,12,58.3%,7m
15974,1,[LIEF]Panquesito,3027,152,6,1,7,85.7%,8m
15974,3,JoeMama,3027,0,4,2,6,66.7%,2h
15974,1,Vengeful,3027,48,4,2,6,66.7%,2h
15974,1,Effort,3027,156,4,3,7,57.1%,17m
15974,1,Soldat,3027,108,3,6,9,33.3%,28m
15974,1,[nieBla]daniov,3027,40,2,2,4,50.0%,10m
15974,1,KOUZIimbaOP,3027,0,2,3,5,40.0%,14m
15974,1,[SC2IDN]FireKing,3027,40,2,4,6,33.3%,35m
15974,1,TheRiddler,3027,42,2,5,7,28.6%,28m
15974,1,dgibbs,3027,82,2,8,10,20.0%,4m
15974,1,JBJB,3027,0,1,1,2,50.0%,3h
15974,1,[EzE]Nyma,3027,0,0,1,1,0.0%,2m
15974,1,Ender,3027,0,0,1,1,0.0%,18m
15999,1,ELMEJORPVP,3026,800,191,171,362,52.8%,31m
15999,3,SprProPlayer,3026,1585,165,163,328,50.3%,16m
15999,3,[YD2K]BlaqSasQuach,3026,1141,161,138,299,53.8%,37m
15999,3,Dream,3026,1449,121,123,244,49.6%,33m
15999,2,Deku,3026,1636,92,77,169,54.4%,15m
15999,2,ROLEX,3026,1489,81,107,188,43.1%,21m
15999,1,SquidVicious,3026,1622,73,56,129,56.6%,18m
15999,1,Therapist,3026,1617,62,59,121,51.2%,28m
15999,1,[BoRnGo]Ootheca,3026,946,34,29,63,54.0%,21m
15999,3,WOLFCV,3026,890,32,44,76,42.1%,38m
15999,1,[TPGGXD]adrian,3026,787,28,24,52,53.8%,10m
15999,1,Socratestes,3026,761,28,27,55,50.9%,21m
15999,1,CSantder,3026,541,18,15,33,54.5%,14m
15999,1,Dridbox,3026,385,13,12,25,52.0%,19m
15999,1,hommeabeil,3026,410,13,12,25,52.0%,13m
15999,1,thotleader,3026,326,10,9,19,52.6%,32m
15999,3,[TSFC]biznit,3026,122,8,7,15,53.3%,40m
15999,2,[SSJs11]ScWraith,3026,88,4,0,4,100.0%,6m
15999,3,[C62]HoDa,3026,120,3,2,5,60.0%,28m
15999,1,Farva,3026,119,3,3,6,50.0%,2h
15999,1,LoadaCrap,3026,48,2,0,2,100.0%,9m
15999,2,VenoM,3026,38,2,1,3,66.7%,13m
15999,2,tankeewah,3026,68,2,2,4,50.0%,38m
15999,2,hatethisgame,3026,0,1,0,1,100.0%,25m
15999,1,Ndras,3026,0,1,3,4,25.0%,11m
15999,1,FruitGG,3026,38,1,4,5,20.0%,10m
15999,3,BoosterFlame,3026,30,1,7,8,12.5%,38m
15999,1,JungleFever,3026,0,0,3,3,0.0%,28m
16027,1,DubFx,3025,1407,124,103,227,54.6%,10m
16027,1,[4aRaza]EntaroAdun,3025,1704,115,92,207,55.6%,18m
16027,1,[LPlay]winsc,3025,1466,53,58,111,47.7%,32m
16027,3,MadDog,3025,739,37,40,77,48.1%,11m
16027,1,[Petsen]Shaky,3025,770,25,23,48,52.1%,13m
16027,1,rozerzero,3025,400,24,11,35,68.6%,21m
16027,1,Maxximus,3025,581,23,22,45,51.1%,42m
16027,1,[YE3T]ForrestGump,3025,461,21,17,38,55.3%,13m
16027,1,Qaholom,3025,478,18,12,30,60.0%,43m
16027,1,BulldozedAU,3025,532,18,17,35,51.4%,36m
16027,1,Jzaan,3025,546,16,19,35,45.7%,43m
16027,1,[DZNUT5]ULOVEMYNUTZ,3025,357,14,11,25,56.0%,18m
16027,3,EodNhoj,3025,153,13,10,23,56.5%,22m
16027,1,Invisiblesim,3025,382,13,15,28,46.4%,24m
16027,1,VERGONON,3025,266,8,10,18,44.4%,17m
16027,1,swarmLord,3025,238,7,6,13,53.8%,5m
16027,2,llllllllllll,3025,42,6,3,9,66.7%,20m
16027,1,rushdu,3025,192,5,11,16,31.2%,18m
16027,1,madmax,3025,48,4,2,6,66.7%,38m
16027,1,Freakiller,3025,154,4,10,14,28.6%,23m
16027,3,TargetMe,3025,121,3,2,5,60.0%,37m
16027,2,Noodleling,3025,0,3,2,5,60.0%,8m
16027,1,[TGCF]Matt,3025,158,3,3,6,50.0%,14m
16027,1,MaskedPsycho,3025,84,3,4,7,42.9%,37m
16027,1,[WNTRG]BtheDUB,3025,156,3,5,8,37.5%,25m
16027,1,DAW,3025,124,3,9,12,25.0%,20m
16027,1,ork,3025,42,2,5,7,28.6%,19m
16027,2,Lawlderp,3025,0,1,0,1,100.0%,41m
16027,3,Hushpuppy,3025,0,0,1,1,0.0%,10m
16027,2,MangoOfDeath,3025,0,0,1,1,0.0%,24m
16027,1,Addamere,3025,0,0,2,2,0.0%,39m
16058,1,[ZTempz]shabbaranks,3024,1721,338,313,651,51.9%,29m
16058,1,JordanCarter,3024,1680,179,163,342,52.3%,6m
16058,3,eldottore,3024,1330,162,163,325,49.8%,3m
16058,3,Crazylama,3024,1454,70,64,134,52.2%,6m
16058,1,[Merkd]Lerolim,3024,770,32,24,56,57.1%,11m
16058,1,Napalm,3024,592,30,3,33,90.9%,41m
16058,3,RickyAJS,3024,822,30,35,65,46.2%,6m
16058,3,[KerriS]SuSu,3024,514,22,23,45,48.9%,6m
16058,1,diablosssss,3024,448,17,21,38,44.7%,11m
16058,3,[1Fenix]mackigamer,3024,310,13,10,23,56.5%,27m
16058,2,DrNovember,3024,238,12,7,19,63.2%,8m
16058,1,[neuroS]global,3024,190,7,4,11,63.6%,40m
16058,2,Rotten,3024,58,5,3,8,62.5%,25m
16058,1,TheFlamme,3024,132,5,4,9,55.6%,27m
16058,2,Versace,3024,86,4,0,4,100.0%,30m
16058,2,[LNOA]adamcbr,3024,66,3,1,4,75.0%,15m
16058,1,[ZTempz]ElvisFreshly,3024,130,3,2,5,60.0%,29m
16058,3,Neaplo,3024,96,3,23,26,11.5%,27m
16058,3,pusydestroer,3024,97,2,1,3,66.7%,2h
16058,1,Tiffin,3024,46,2,3,5,40.0%,59m
16058,2,Regis,3024,0,1,0,1,100.0%,38m
16058,1,coronabird,3024,0,1,1,2,50.0%,28m
16058,1,[SUCA]Maverick,3024,0,0,1,1,0.0%,34m
16058,2,megathunder,3024,0,0,1,1,0.0%,36m
16058,2,Anoman,3024,0,0,1,1,0.0%,36m
16058,1,xSilencedRPG,3024,0,0,4,4,0.0%,23m
16084,3,Burow,3023,1596,455,413,868,52.4%,7m
16084,3,[JB420]Nopi,3023,1239,253,244,497,50.9%,40m
16084,3,Ninja,3023,1518,241,232,473,51.0%,7m
16084,1,Yetzuu,3023,1579,186,172,358,52.0%,29m
16084,1,Jay,3023,1343,175,154,329,53.2%,9m
16084,1,Supernova,3023,1615,131,104,235,55.7%,39m
16084,1,sunshine,3023,1309,119,94,213,55.9%,36m
16084,3,SilentSword,3023,1288,79,81,160,49.4%,38m
16084,1,Okor,3023,837,73,64,137,53.3%,10m
16084,1,[PCAKE]InFaMouS,3023,841,49,35,84,58.3%,37m
16084,1,poodoo,3023,965,38,30,68,55.9%,36m
16084,1,[868]Ardin,3023,901,34,31,65,52.3%,25m
16084,1,Bossman,3023,590,19,19,38,50.0%,25m
16084,1,Mantis,3023,417,16,11,27,59.3%,28m
16084,1,Jangus,3023,472,14,16,30,46.7%,3m
16084,1,KillerSocks,3023,252,10,7,17,58.8%,3m
16084,2,Teatime,3023,226,9,4,13,69.2%,32m
16084,1,ChopperDave,3023,225,8,6,14,57.1%,13m
16084,2,Shanerb,3023,217,8,7,15,53.3%,45m
16084,2,Kumagawa,3023,136,7,5,12,58.3%,2h
16084,2,[UAK]Dextrus,3023,0,3,2,5,60.0%,20m
16084,1,Lucianonafi,3023,74,3,3,6,50.0%,42m
16084,2,[WNTRCO]AColonyOfAnt,3023,30,2,0,2,100.0%,42m
16084,1,[Derb20]Nyxebus,3023,38,2,2,4,50.0%,43m
16084,1,[LY]LionHeart,3023,46,2,6,8,25.0%,8m
16084,2,Faustus,3023,0,1,0,1,100.0%,13m
16084,1,[LPEM]kanabis,3023,0,1,0,1,100.0%,3h
16084,1,Hereticus,3023,0,1,2,3,33.3%,15m
16084,3,Radamanthis,3023,40,1,8,9,11.1%,1h
16084,2,Niten,3023,0,0,1,1,0.0%,28m
16084,1,[cluez]RazerNaga,3023,0,0,2,2,0.0%,10m
16115,3,Ohms,3022,1576,354,356,710,49.9%,20m
16115,2,JoeyHands,3022,1082,258,274,532,48.5%,30m
16115,3,Killix,3022,1564,104,116,220,47.3%,40m
16115,1,Cliff,3022,1660,80,84,164,48.8%,21m
16115,1,AlCrotz,3022,1129,41,41,82,50.0%,40m
16115,1,[GreeDy]JteCreme,3022,811,30,30,60,50.0%,13m
16115,3,[CrnKy]MeoMaikasCat,3022,780,28,34,62,45.2%,16m
16115,1,Xnova,3022,606,26,25,51,51.0%,9m
16115,1,Enculpius,3022,412,25,13,38,65.8%,28m
16115,3,[SuperZ]JoHidding,3022,430,23,23,46,50.0%,33m
16115,1,[Toxity]liberty,3022,331,22,19,41,53.7%,40m
16115,1,Velzix,3022,465,17,15,32,53.1%,24m
16115,1,NEXChico,3022,271,14,7,21,66.7%,20m
16115,2,[ppgang]DrFuzzBottom,3022,278,11,6,17,64.7%,13m
16115,3,Life,3022,195,8,7,15,53.3%,41m
16115,3,Hyunookie,3022,170,7,7,14,50.0%,6m
16115,2,JigSaw,3022,186,6,2,8,75.0%,2h
16115,1,Jaguar,3022,158,5,5,10,50.0%,37m
16115,1,bakspace,3022,0,4,2,6,66.7%,4m
16115,1,[D00M]SeventhSin,3022,123,4,3,7,57.1%,8m
16115,1,wthlol,3022,144,3,2,5,60.0%,8m
16115,2,Matte,3022,0,1,0,1,100.0%,23m
16115,2,Welpy,3022,73,1,2,3,33.3%,43m
16115,2,Ladranix,3022,32,1,2,3,33.3%,17m
16115,2,Ðarknight,3022,0,0,1,1,0.0%,36m
16140,3,[2Z1MTV]Tempesta,3021,1552,176,170,346,50.9%,9m
16140,3,KaZ,3021,1035,162,152,314,51.6%,17m
16140,3,LOBITO,3021,1541,155,159,314,49.4%,33m
16140,2,[Wahya]TaxiSpill,3021,1622,143,116,259,55.2%,14m
16140,3,Kjubaran,3021,1295,54,54,108,50.0%,43m
16140,3,Red,3021,1247,51,58,109,46.8%,5m
16140,1,Marine,3021,959,37,32,69,53.6%,40m
16140,1,[TGosuD]Coffey,3021,510,21,17,38,55.3%,20m
16140,3,Jinora,3021,410,17,25,42,40.5%,33m
16140,1,PeregrINe,3021,303,11,8,19,57.9%,5m
16140,1,[MEvo2]NunExecutor,3021,359,11,9,20,55.0%,14m
16140,3,Aruiz,3021,294,10,22,32,31.2%,37m
16140,3,CatheaD,3021,116,7,9,16,43.8%,33m
16140,2,Rebok,3021,114,4,1,5,80.0%,43m
16140,2,Empedocles,3021,30,4,2,6,66.7%,16m
16140,1,[TheRs]Jackal,3021,110,3,5,8,37.5%,42m
16140,1,[INextI]Shadow,3021,0,0,2,2,0.0%,18m
16140,1,Kaisher,3021,0,0,3,3,0.0%,36m
16158,1,apris,3020,1330,137,140,277,49.5%,40m
16158,3,NordicMoose,3020,1518,97,97,194,50.0%,13m
16158,3,Funeralheart,3020,530,82,74,156,52.6%,32m
16158,3,AMDG,3020,1189,72,62,134,53.7%,26m
16158,1,Fingolfin,3020,655,70,64,134,52.2%,23m
16158,3,Razul,3020,1000,56,49,105,53.3%,7m
16158,1,GeneralJM,3020,525,52,41,93,55.9%,32m
16158,3,Murica,3020,1188,52,64,116,44.8%,41m
16158,1,WaveyApex,3020,1236,50,39,89,56.2%,20m
16158,3,Spaceboss,3020,414,42,50,92,45.7%,28m
16158,1,Lemons,3020,850,36,36,72,50.0%,10m
16158,3,zMuffinManZz,3020,747,35,46,81,43.2%,39m
16158,1,iMPRo,3020,546,20,16,36,55.6%,37m
16158,1,[lab317]kaapsingle,3020,585,19,16,35,54.3%,35m
16158,2,Mercy,3020,481,19,16,35,54.3%,25m
16158,2,Bonkers,3020,280,16,6,22,72.7%,3m
16158,1,[RiftSS]Shawnee,3020,330,15,12,27,55.6%,14m
16158,2,[TITSQ]Xuron,3020,130,5,2,7,71.4%,42m
16158,1,[KiMBR]StoneRage,3020,114,5,3,8,62.5%,23m
16158,1,salchi,3020,156,4,3,7,57.1%,8m
16158,3,FFforGG,3020,145,4,6,10,40.0%,31m
16158,1,SaltySandJr,3020,122,3,2,5,60.0%,41m
16158,1,[BHOG]Malkintosh,3020,80,3,6,9,33.3%,8m
16158,2,[TheRs]vis,3020,46,2,1,3,66.7%,30m
16158,2,Vibb,3020,62,2,2,4,50.0%,36m
16158,2,[GpsyDg]Malimo,3020,68,2,3,5,40.0%,3m
16158,1,signroyal,3020,126,2,10,12,16.7%,16m
16158,3,ryankrk,3020,0,1,0,1,100.0%,58m
16158,2,Shark,3020,0,1,0,1,100.0%,2h
16158,1,ohana,3020,0,1,1,2,50.0%,10m
16158,3,Veracity,3020,0,1,1,2,50.0%,10m
16158,1,PASSWORD,3020,42,1,4,5,20.0%,10m
16158,2,head,3020,0,1,4,5,20.0%,9m
16158,3,Lemon,3020,30,1,9,10,10.0%,19m
16158,1,DjRubenP,3020,0,0,3,3,0.0%,27m
16158,1,[SRA]DeZrog,3020,0,0,3,3,0.0%,27m
16158,1,TacticalJazz,3020,0,0,4,4,0.0%,4m
16195,1,SillyOldBear,3019,1707,476,459,935,50.9%,35m
16195,1,[lLiTl]Bugsplatter,3019,1174,119,111,230,51.7%,26m
16195,1,Zap,3019,704,30,17,47,63.8%,40m
16195,1,[iDrunk]Vaccine,3019,808,27,24,51,52.9%,13m
16195,1,Taconinja,3019,366,25,23,48,52.1%,13m
16195,3,SayMyName,3019,633,25,35,60,41.7%,25m
16195,1,[HndriX]Lolfran,3019,183,22,17,39,56.4%,20m
16195,1,BatCountry,3019,374,15,10,25,60.0%,8m
16195,1,Kryll,3019,216,6,9,15,40.0%,37m
16195,1,DrQuinnnnnnn,3019,97,4,2,6,66.7%,2h
16195,2,Dimelow,3019,0,4,3,7,57.1%,45m
16195,1,Dont,3019,97,4,3,7,57.1%,2h
16195,1,[PINGON]portaco,3019,85,4,3,7,57.1%,37m
16195,2,cherasor,3019,112,4,3,7,57.1%,23m
16195,1,NinjaFoxx,3019,146,4,4,8,50.0%,21m
16195,1,MinG,3019,120,3,2,5,60.0%,8m
16195,2,gerardo,3019,0,3,2,5,60.0%,30m
16195,1,Nutmegg,3019,68,3,3,6,50.0%,20m
16195,2,[IDumb]meeees,3019,32,2,0,2,100.0%,41m
16195,3,Topochanclas,3019,97,2,1,3,66.7%,47m
16195,1,HKRob,3019,38,2,5,7,28.6%,29m
16195,2,Anoxia,3019,30,1,1,2,50.0%,23m
16195,1,Clopsicle,3019,36,1,4,5,20.0%,11m
16195,2,Angel,3019,0,1,13,14,7.1%,36m
16195,2,REDlips,3019,0,0,1,1,0.0%,24m
16195,2,LotsaLings,3019,0,0,1,1,0.0%,36m
16195,2,Multispawn,3019,0,0,1,1,0.0%,33m
16195,2,KacperG,3019,0,0,1,1,0.0%,25m
16195,1,[BANAA]Youyou,3019,0,0,2,2,0.0%,24m
16224,3,Rogue,3018,953,58,62,120,48.3%,39m
16224,1,suertudo,3018,493,44,32,76,57.9%,43m
16224,3,[AD3C]Dead,3018,879,40,36,76,52.6%,38m
16224,3,[PEINF]Jounez,3018,712,31,32,63,49.2%,7m
16224,1,komodowagon,3018,548,16,18,34,47.1%,11m
16224,3,[LWSS]Domynator,3018,316,15,11,26,57.7%,7m
16224,1,[FyHr]RyukOmg,3018,456,14,13,27,51.9%,20m
16224,1,[DRKAPP]Ferocious,3018,293,13,7,20,65.0%,10m
16224,1,[Big117]theprobelem,3018,288,8,14,22,36.4%,17m
16224,2,[INextI]OnefOXPrime,3018,158,5,6,11,45.5%,11m
16224,1,WarroCraft,3018,0,4,1,5,80.0%,2h
16224,3,Adre,3018,97,2,2,4,50.0%,41m
16224,2,Sparky,3018,30,1,1,2,50.0%,3m
16224,1,[110011]Doomraven,3018,36,1,3,4,25.0%,16m
16224,2,Kal,3018,0,0,1,1,0.0%,34m
16239,1,WashNMachine,3017,1724,101,84,185,54.6%,18m
16239,1,Tamamo,3017,1365,80,74,154,51.9%,39m
16239,3,[420PH]ALPHACHINO,3017,1083,52,41,93,55.9%,9m
16239,3,Munger,3017,1022,45,38,83,54.2%,3m
16239,1,[TWAS]ChopSuey,3017,967,42,34,76,55.3%,5m
16239,3,Syringed,3017,937,34,38,72,47.2%,3m
16239,1,Herpaherm,3017,745,32,23,55,58.2%,37m
16239,3,dreq,3017,320,14,11,25,56.0%,40m
16239,3,Stnicholas,3017,452,14,32,46,30.4%,28m
16239,2,Fanthys,3017,208,8,2,10,80.0%,10m
16239,2,Chasmic,3017,146,8,5,13,61.5%,39m
16239,2,www,3017,184,7,5,12,58.3%,33m
16239,2,Bowser,3017,168,7,6,13,53.8%,36m
16239,2,[KiMBR]FeniX,3017,144,5,2,7,71.4%,10m
16239,1,[HOMOF]PurpleYoshi,3017,135,4,2,6,66.7%,8m
16239,1,SoySauce,3017,0,3,2,5,60.0%,49m
16239,1,[vvjjvv]VictorChern,3017,122,3,4,7,42.9%,35m
16239,2,[Stigma]BouncyBear,3017,30,2,1,3,66.7%,41m
16239,1,Groove,3017,80,2,4,6,33.3%,32m
16239,3,partkyle,3017,0,1,0,1,100.0%,2h
16259,3,[GoOoO]AReyes,3016,1454,342,333,675,50.7%,38m
16259,1,[pl4boy]goldielocks,3016,1359,163,142,305,53.4%,18m
16259,3,Burnicus,3016,1509,151,149,300,50.3%,24m
16259,3,danike,3016,1430,84,96,180,46.7%,22m
16259,1,[ValidG]Goosiliak,3016,1356,70,63,133,52.6%,25m
16259,2,DonTKnowPlay,3016,827,69,46,115,60.0%,17m
16259,1,[SOWOW]Enniete,3016,1175,66,64,130,50.8%,40m
16259,3,xublauzinho,3016,851,44,46,90,48.9%,36m
16259,1,Topen,3016,713,30,25,55,54.5%,4m
16259,1,SpeedRacer,3016,326,9,13,22,40.9%,28m
16259,3,Garett,3016,254,9,30,39,23.1%,24m
16259,2,Zepe,3016,60,6,2,8,75.0%,8m
16259,1,Liam,3016,66,4,4,8,50.0%,22m
16259,2,[IlAGll]datmandan,3016,64,3,0,3,100.0%,34m
16259,2,Lancefer,3016,0,3,2,5,60.0%,36m
16259,1,MoSalah,3016,80,3,3,6,50.0%,33m
16259,1,IsaacAsimov,3016,122,3,5,8,37.5%,25m
16259,1,Pricard,3016,48,1,1,2,50.0%,2h
16259,1,[lHMNGl]SCmenace,3016,42,1,4,5,20.0%,10m
16259,2,ZergBurgler,3016,0,0,1,1,0.0%,32m
16259,2,CHRONO,3016,0,0,1,1,0.0%,12m
16259,1,Seajay,3016,0,0,2,2,0.0%,39m
16281,3,Harvorax,3015,1533,349,331,680,51.3%,7m
16281,3,LOGAN,3015,1345,152,146,298,51.0%,41m
16281,1,Rampage,3015,1715,125,99,224,55.8%,4m
16281,3,Lego,3015,1495,99,98,197,50.3%,5m
16281,1,[xARGx]MataPros,3015,1640,88,68,156,56.4%,22m
16281,1,[Sketti]Grains,3015,983,66,58,124,53.2%,9m
16281,1,XiitOnXi,3015,1236,65,47,112,58.0%,11m
16281,1,Headkick,3015,806,63,55,118,53.4%,21m
16281,3,Schlunker,3015,300,57,47,104,54.8%,28m
16281,3,foxinsocks,3015,940,51,52,103,49.5%,29m
16281,2,ninecorpses,3015,996,47,33,80,58.8%,13m
16281,1,dasdorovia,3015,761,30,26,56,53.6%,18m
16281,1,[iMkS]Dax,3015,580,20,20,40,50.0%,36m
16281,2,Aldo,3015,155,7,4,11,63.6%,30m
16281,3,OverLoadinG,3015,180,7,15,22,31.8%,27m
16281,1,Espectro,3015,230,6,7,13,46.2%,36m
16281,1,[CPU1]SubSonic,3015,198,6,10,16,37.5%,9m
16281,2,Lazslow,3015,116,5,1,6,83.3%,30m
16281,1,LeCpo,3015,134,4,6,10,40.0%,36m
16281,2,GreetingLady,3015,58,3,2,5,60.0%,7m
16281,2,Hak,3015,0,3,2,5,60.0%,13m
16281,1,[VLQL]Quebexico,3015,84,3,5,8,37.5%,27m
16281,2,gunshipss,3015,60,2,1,3,66.7%,30m
16281,1,[CBK]Goldie,3015,40,2,3,5,40.0%,25m
16281,1,Dexicus,3015,0,2,3,5,40.0%,44m
16281,3,CreepDead,3015,0,2,4,6,33.3%,2h
16281,1,[TCook]TopCheddar,3015,38,2,6,8,25.0%,18m
16281,2,NateBlatz,3015,0,1,0,1,100.0%,13m
16281,1,[DHZAcD]Dave,3015,38,1,6,7,14.3%,17m
16281,2,[GnR]Moss,3015,0,0,1,1,0.0%,4m
16281,2,ALQuinder,3015,0,0,1,1,0.0%,14m
16312,3,[Kixeye]Kukuro,3014,943,159,148,307,51.8%,42m
16312,1,tolatylia,3014,1487,107,99,206,51.9%,8m
16312,1,jmudukes,3014,1192,75,65,140,53.6%,10m
16312,3,enterprise,3014,640,40,57,97,41.2%,36m
16312,1,GunnerStahl,3014,636,23,22,45,51.1%,25m
16312,1,ElurGerz,3014,696,22,25,47,46.8%,10m
16312,3,MagicTurtle,3014,579,19,30,49,38.8%,32m
16312,3,Getafix,3014,465,17,25,42,40.5%,14m
16312,2,[PobSC]latineltunas,3014,334,13,6,19,68.4%,21m
16312,2,moist,3014,314,13,11,24,54.2%,23m
16312,3,Fire,3014,278,10,6,16,62.5%,4m
16312,1,Rajms,3014,255,10,9,19,52.6%,20m
16312,2,[Silvio]Sardaukar,3014,136,7,6,13,53.8%,28m
16312,2,silverhawk,3014,194,5,7,12,41.7%,2h
16312,3,Harry,3014,97,4,3,7,57.1%,42m
16312,2,Paradus,3014,143,4,4,8,50.0%,35m
16312,1,[NGFR]CapedBaldy,3014,150,4,7,11,36.4%,37m
16312,3,KangSM,3014,121,3,1,4,75.0%,40m
16312,3,luda,3014,0,3,3,6,50.0%,2h
16312,2,Zac,3014,91,2,0,2,100.0%,2h
16312,2,TWICE,3014,0,2,1,3,66.7%,41m
16312,2,[navis]ADRIANOYT,3014,32,2,1,3,66.7%,28m
16312,2,LIAF,3014,64,2,3,5,40.0%,24m
16312,3,Snowskol,3014,0,1,1,2,50.0%,42m
16312,2,[1EOM]Nikolias,3014,32,1,2,3,33.3%,13m
16312,1,[PUMPZ]Vidra,3014,0,1,2,3,33.3%,4m
16312,2,[GLit]LiquidNature,3014,0,0,1,1,0.0%,14m
16312,1,varciasz,3014,0,0,4,4,0.0%,22m
16340,3,nomnomnom,3013,1164,257,254,511,50.3%,32m
16340,1,[OhYaaa]Dragan,3013,1710,212,198,410,51.7%,27m
16340,1,GeeImAScrub,3013,564,70,69,139,50.4%,9m
16340,3,anbrewk,3013,999,43,42,85,50.6%,24m
16340,2,Serral,3013,866,34,26,60,56.7%,24m
16340,2,BrandoFritzo,3013,228,12,6,18,66.7%,36m
16340,1,Shadow,3013,249,10,5,15,66.7%,16m
16340,3,Martinator,3013,203,7,3,10,70.0%,43m
16340,2,[4Force]ImONe,3013,148,6,5,11,54.5%,41m
16340,3,[lefuk]CharleStone,3013,194,6,15,21,28.6%,5m
16340,2,Everost,3013,126,5,2,7,71.4%,13m
16340,1,ziriguidum,3013,144,3,0,3,100.0%,2h
16340,1,[cxzczx]needsleep,3013,103,3,1,4,75.0%,10m
16340,2,Toasty,3013,36,2,0,2,100.0%,34m
16340,1,[Yuko]Nanamichiaki,3013,0,2,4,6,33.3%,32m
16340,2,MrPylon,3013,32,1,1,2,50.0%,20m
16340,1,FragOnly,3013,40,1,3,4,25.0%,6m
16340,1,NDKyouknow,3013,42,1,3,4,25.0%,18m
16340,2,[GURIAS]Zalara,3013,0,0,1,1,0.0%,30m
16340,2,[1vsM]Anubis,3013,0,0,1,1,0.0%,13m
16340,2,Butternuts,3013,0,0,1,1,0.0%,36m
16361,3,Buttslinger,3012,672,50,45,95,52.6%,33m
16361,1,ArAgOoX,3012,580,28,27,55,50.9%,13m
16361,2,Magi,3012,474,18,16,34,52.9%,37m
16361,1,[DETER]Ender,3012,410,13,16,29,44.8%,19m
16361,1,Battleground,3012,370,12,11,23,52.2%,28m
16361,2,Catlubber,3012,257,10,7,17,58.8%,30m
16361,1,megacheese,3012,340,9,13,22,40.9%,9m
16361,3,NoMads,3012,278,9,19,28,32.1%,38m
16361,2,FuzzyLogic,3012,202,8,9,17,47.1%,30m
16361,3,Herbmann,3012,121,5,4,9,55.6%,2h
16361,3,Stormtrooper,3012,144,5,4,9,55.6%,42m
16361,2,KingKenChen,3012,92,4,0,4,100.0%,29m
16361,2,xhutrx,3012,120,4,1,5,80.0%,33m
16361,2,Wask,3012,94,4,2,6,66.7%,30m
16361,1,Dog,3012,48,4,2,6,66.7%,2h
16361,1,[EvilCC]EDUARS,3012,70,3,4,7,42.9%,32m
16361,2,[SCR0TE]WrathOfBong,3012,60,2,3,5,40.0%,30m
16361,1,TheOx,3012,80,2,9,11,18.2%,38m
16361,2,TubbyKoala,3012,0,0,1,1,0.0%,14m
16380,1,[097]XXXanin,3011,1719,141,133,274,51.5%,19m
16380,3,Grelex,3011,963,101,99,200,50.5%,26m
16380,2,NeSfiVe,3011,368,26,12,38,68.4%,39m
16380,3,Secur,3011,294,23,17,40,57.5%,22m
16380,3,[KmN]Boliver,3011,571,20,23,43,46.5%,14m
16380,1,SpicyCrab,3011,347,18,20,38,47.4%,39m
16380,1,plate,3011,320,14,16,30,46.7%,18m
16380,1,[SBlock]Omar,3011,438,12,17,29,41.4%,35m
16380,1,evilcupcakes,3011,216,8,4,12,66.7%,8m
16380,1,lol,3011,121,5,2,7,71.4%,28m
16380,1,Antho,3011,114,5,3,8,62.5%,39m
16380,2,[nStars]StarSpirit,3011,30,2,0,2,100.0%,17m
16380,1,[XerQ]ribsters,3011,40,2,2,4,50.0%,39m
16380,1,fenix,3011,123,2,3,5,40.0%,10m
16380,1,MagicProtoss,3011,0,1,1,2,50.0%,21m
16380,3,chickenkid,3011,0,1,7,8,12.5%,8m
16380,2,[PYAAAH]Sliss,3011,0,0,1,1,0.0%,3m
16380,3,sagskvdjk,3011,0,0,1,1,0.0%,58m
16380,2,DrDrivingXD,3011,0,0,2,2,0.0%,30m
16399,1,FearDeath,3010,624,68,60,128,53.1%,23m
16399,2,SevenODrew,3010,1148,59,35,94,62.8%,36m
16399,1,WrathBringer,3010,841,55,57,112,49.1%,30m
16399,1,mirnuri,3010,1343,54,52,106,50.9%,8m
16399,1,Poondigga,3010,1279,47,44,91,51.6%,18m
16399,1,briarwoods,3010,624,39,32,71,54.9%,18m
16399,1,Qube,3010,612,19,20,39,48.7%,42m
16399,1,yomama,3010,469,18,11,29,62.1%,12m
16399,1,OverLord,3010,490,18,12,30,60.0%,39m
16399,2,Cixelsyd,3010,180,12,5,17,70.6%,29m
16399,2,[TEKN]Blakevill,3010,213,7,7,14,50.0%,15m
16399,3,Salchipapa,3010,182,7,9,16,43.8%,22m
16399,1,Marlith,3010,266,6,8,14,42.9%,37m
16399,1,Romulus,3010,32,5,2,7,71.4%,18m
16399,2,[HØST]Gyako,3010,124,5,3,8,62.5%,36m
16399,2,signalfel,3010,118,5,4,9,55.6%,59m
16399,3,Fistantilist,3010,0,4,3,7,57.1%,12m
16399,3,SHARK,3010,97,4,3,7,57.1%,3h
16399,1,VanNasty,3010,191,4,5,9,44.4%,19m
16399,1,CoGPacifist,3010,108,3,5,8,37.5%,42m
16399,1,liberty,3010,38,2,3,5,40.0%,40m
16399,1,redshift,3010,32,2,3,5,40.0%,8m
16399,2,Destroyer,3010,30,2,3,5,40.0%,23m
16399,1,[REPORT]ERAU,3010,145,2,7,9,22.2%,3h
16399,2,nonamekill,3010,0,1,0,1,100.0%,41m
16399,2,iWind,3010,0,1,0,1,100.0%,41m
16399,1,Kui,3010,40,1,9,10,10.0%,21m
16399,2,SabO,3010,0,0,1,1,0.0%,43m
16399,2,MacMac,3010,0,0,1,1,0.0%,15m
16428,3,[DPGame]sturmovik,3009,1493,162,173,335,48.4%,31m
16428,1,funsizek,3009,1717,127,122,249,51.0%,10m
16428,1,Urmum,3009,1205,51,39,90,56.7%,8m
16428,1,byfar,3009,712,51,53,104,49.0%,30m
16428,1,MiGrAiNe,3009,188,35,23,58,60.3%,15m
16428,1,[RePlz]CedrictheDog,3009,666,29,22,51,56.9%,41m
16428,3,[ggnow]lolipantsu,3009,513,17,20,37,45.9%,3m
16428,1,ddddd,3009,434,16,11,27,59.3%,8m
16428,1,Boss,3009,379,16,12,28,57.1%,31m
16428,1,Kenfucious,3009,337,13,7,20,65.0%,18m
16428,1,morecowbell,3009,263,10,9,19,52.6%,1h
16428,1,Soultaker,3009,314,10,10,20,50.0%,28m
16428,1,FatherZeus,3009,178,9,1,10,90.0%,10m
16428,2,GhostDog,3009,252,9,4,13,69.2%,13m
16428,2,SteeL,3009,206,8,5,13,61.5%,57m
16428,1,Rixer,3009,175,6,3,9,66.7%,20m
16428,3,Erdedy,3009,121,5,4,9,55.6%,2h
16428,1,ZERGBEAST,3009,130,5,6,11,45.5%,28m
16428,2,sebas,3009,58,3,1,4,75.0%,13m
16428,1,Casorus,3009,122,3,10,13,23.1%,10m
16428,1,Carina,3009,72,2,6,8,25.0%,4m
16428,2,dynamics,3009,94,1,3,4,25.0%,14m
16428,3,doublespace,3009,40,1,4,5,20.0%,24m
16428,2,[FFAA]Akopian,3009,0,0,1,1,0.0%,29m
16428,2,RobinsonHuso,3009,0,0,1,1,0.0%,14m
16428,1,Stunts,3009,0,0,5,5,0.0%,10m
16454,1,SmellyButt,3008,1589,638,621,1259,50.7%,8m
16454,1,Ghost,3008,1570,125,120,245,51.0%,41m
16454,2,nougats,3008,1624,76,64,140,54.3%,41m
16454,1,Fusion,3008,758,26,25,51,51.0%,41m
16454,3,Rubicrack,3008,526,21,23,44,47.7%,39m
16454,1,Jimy,3008,419,17,11,28,60.7%,26m
16454,1,[BeyBl]essej,3008,446,17,14,31,54.8%,4m
16454,1,MrSmith,3008,356,10,9,19,52.6%,40m
16454,2,SireLeon,3008,280,9,6,15,60.0%,31m
16454,2,Deadeye,3008,143,6,2,8,75.0%,23m
16454,1,Orthodox,3008,209,6,7,13,46.2%,23m
16454,3,dlwlrma,3008,30,5,4,9,55.6%,21m
16454,1,swiffer,3008,194,5,8,13,38.5%,38m
16454,1,Matches,3008,100,4,9,13,30.8%,22m
16454,1,[GGMR]MRgrey,3008,104,3,2,5,60.0%,12m
16454,2,dwj,3008,0,3,2,5,60.0%,23m
16454,1,TobyTheRobot,3008,78,2,5,7,28.6%,20m
16454,2,Annalleakage,3008,0,0,1,1,0.0%,43m
16454,1,ZeitsAdes,3008,0,0,4,4,0.0%,21m
16454,2,Who,3008,0,0,5,5,0.0%,14m
16474,3,Topgun,3007,1479,382,385,767,49.8%,32m
16474,3,[OhhGG]ACEsch,3007,1420,199,169,368,54.1%,39m
16474,3,Afourteen,3007,1568,148,142,290,51.0%,19m
16474,1,Saaomi,3007,1532,88,78,166,53.0%,36m
16474,2,ReLU,3007,1585,82,72,154,53.2%,43m
16474,3,[TPGGXD]ULIGJ,3007,1524,75,76,151,49.7%,21m
16474,3,[cl0udM]TaggedOnce,3007,1524,62,68,130,47.7%,27m
16474,1,zeratul,3007,731,29,25,54,53.7%,35m
16474,2,Veux,3007,466,17,13,30,56.7%,40m
16474,2,Cartz,3007,379,15,10,25,60.0%,43m
16474,1,NoeL,3007,311,11,7,18,61.1%,16m
16474,2,Cheezburger,3007,204,7,5,12,58.3%,31m
16474,1,[tSn]getkilled,3007,264,7,13,20,35.0%,40m
16474,1,[GRNSKN]Taurus,3007,178,6,6,12,50.0%,23m
16474,2,CreamPie,3007,108,6,7,13,46.2%,31m
16474,2,Infested,3007,122,5,2,7,71.4%,30m
16474,1,Arcadia,3007,184,5,8,13,38.5%,37m
16474,1,Clobby,3007,162,4,3,7,57.1%,20m
16474,2,Beef,3007,140,3,2,5,60.0%,34m
16474,1,doomhand,3007,0,3,2,5,60.0%,2h
16474,2,OveThRainbow,3007,30,3,4,7,42.9%,34m
16474,1,SnowSoup,3007,36,3,5,8,37.5%,19m
16474,1,spencedawg,3007,141,2,3,5,40.0%,32m
16474,1,SorryAloe,3007,50,2,7,9,22.2%,22m
16474,2,Aere,3007,32,1,2,3,33.3%,12m
16474,1,koyo,3007,0,1,2,3,33.3%,27m
16474,1,Colmillo,3007,44,1,8,9,11.1%,37m
16474,2,UpGrade,3007,0,0,1,1,0.0%,41m
16474,2,Scorpion,3007,0,0,1,1,0.0%,36m
16474,2,LiamFC,3007,0,0,1,1,0.0%,23m
16474,2,Zyp,3007,0,0,1,1,0.0%,35m
16505,2,[CMU]DitoDon,3006,1633,255,228,483,52.8%,4m
16505,1,[qbit]Hoist,3006,1669,107,98,205,52.2%,11m
16505,2,HowToPlayr,3006,949,94,80,174,54.0%,17m
16505,3,haru,3006,1464,67,64,131,51.1%,36m
16505,3,mEDiocrLemur,3006,1037,60,56,116,51.7%,6m
16505,1,JokerStatus,3006,1081,51,40,91,56.0%,21m
16505,1,CptRandom,3006,902,49,42,91,53.8%,16m
16505,3,Pawee,3006,834,30,34,64,46.9%,3m
16505,2,DumDum,3006,336,15,2,17,88.2%,22m
16505,1,Afflicion,3006,237,13,15,28,46.4%,29m
16505,1,[8iSh]TheKazootie,3006,258,7,6,13,53.8%,14m
16505,1,[Xpk]Antarez,3006,150,4,8,12,33.3%,28m
16505,1,[No0Bs]Poiza,3006,146,4,9,13,30.8%,17m
16505,2,NothingtoSay,3006,90,3,1,4,75.0%,19m
16505,1,[Dnwlkr]Frey,3006,105,3,2,5,60.0%,42m
16505,2,Genesis,3006,93,2,0,2,100.0%,3m
16505,1,Alucard,3006,91,2,1,3,66.7%,4m
16505,1,IceKing,3006,0,2,2,4,50.0%,16m
16505,2,Karrlore,3006,0,1,0,1,100.0%,7m
16505,2,Faust,3006,0,1,0,1,100.0%,29m
16505,1,cottonball,3006,0,1,0,1,100.0%,1h
16505,1,[LED]Jayski,3006,48,1,1,2,50.0%,15m
16505,2,[NIGT]Noradud,3006,30,1,1,2,50.0%,29m
16505,2,Gustavo,3006,30,1,1,2,50.0%,17m
16505,1,xerxes,3006,0,1,2,3,33.3%,28m
16505,2,[BODIED]JROHara,3006,0,0,1,1,0.0%,19m
16505,2,FinTheOne,3006,0,0,1,1,0.0%,31m
16505,2,[hTx]DiOrcus,3006,0,0,2,2,0.0%,2h
16505,3,SaYe,3006,0,0,2,2,0.0%,43m
16534,3,fluufy,3005,1582,259,241,500,51.8%,42m
16534,3,batata,3005,1195,216,214,430,50.2%,28m
16534,3,Portnoy,3005,1543,198,192,390,50.8%,8m
16534,3,MikeDawley,3005,1489,143,139,282,50.7%,42m
16534,1,bobbyC,3005,1372,137,129,266,51.5%,33m
16534,1,owen,3005,1711,108,108,216,50.0%,16m
16534,1,anastamoses,3005,860,88,86,174,50.6%,8m
16534,1,[DhZAc1]Blatta,3005,1263,85,70,155,54.8%,20m
16534,3,[Swanky]anticitizen,3005,1401,70,73,143,49.0%,13m
16534,3,Willum,3005,1561,69,64,133,51.9%,41m
16534,3,BiggerBag,3005,726,29,36,65,44.6%,27m
16534,2,altkiller,3005,496,22,14,36,61.1%,19m
16534,1,[iDrunk]TheSacred,3005,596,19,22,41,46.3%,14m
16534,2,WhoRlyCares,3005,299,13,12,25,52.0%,40m
16534,1,ZroXD,3005,308,12,11,23,52.2%,4m
16534,1,[Vtta]MadaraUchiha,3005,328,11,8,19,57.9%,10m
16534,3,MolarBear,3005,284,10,19,29,34.5%,30m
16534,1,Kevlar,3005,164,7,11,18,38.9%,37m
16534,1,RagnarrNA,3005,164,5,4,9,55.6%,8m
16534,2,cookymonster,3005,92,4,2,6,66.7%,35m
16534,2,[xLiTx]Delusion,3005,30,4,2,6,66.7%,41m
16534,2,DEADSCORPION,3005,138,3,1,4,75.0%,36m
16534,2,Daggoth,3005,100,3,4,7,42.9%,7m
16534,1,[TxT]Cynich,3005,34,3,5,8,37.5%,13m
16534,1,[LQV]Fliparto,3005,121,3,6,9,33.3%,20m
16534,1,MadDogLasha,3005,74,3,7,10,30.0%,4m
16534,1,Boomschein,3005,48,2,1,3,66.7%,38m
16534,2,Ninsoma,3005,62,2,4,6,33.3%,43m
16534,1,lllIIIIlllll,3005,30,2,5,7,28.6%,39m
16534,2,Dan,3005,0,0,1,1,0.0%,5m
16534,2,Asnofyx,3005,0,0,1,1,0.0%,39m
16565,3,Tazel,3004,1289,104,100,204,51.0%,29m
16565,1,[N00Bi]TRacKPaD,3004,1444,83,75,158,52.5%,8m
16565,1,[KingSC]Adjime,3004,828,65,65,130,50.0%,29m
16565,1,AHanes,3004,940,58,55,113,51.3%,24m
16565,1,PhatChaeks,3004,1119,47,36,83,56.6%,20m
16565,3,[Cryptc]Kazooie,3004,1094,39,51,90,43.3%,9m
16565,1,GregoryMrMan,3004,826,34,28,62,54.8%,8m
16565,1,Fatty,3004,475,29,32,61,47.5%,3m
16565,2,Fergy,3004,594,27,22,49,55.1%,7m
16565,1,[SoKo]EnvyXavier,3004,511,26,22,48,54.2%,13m
16565,3,Grimkz,3004,444,23,22,45,51.1%,35m
16565,2,llllllllllll,3004,516,22,13,35,62.9%,40m
16565,1,SonoChoni,3004,415,22,18,40,55.0%,20m
16565,2,Stammis,3004,463,19,16,35,54.3%,7m
16565,3,[ZTemp]idomoms,3004,499,17,21,38,44.7%,28m
16565,3,[SLYS]DRaX,3004,208,7,19,26,26.9%,14m
16565,1,PapayaNuts,3004,144,6,1,7,85.7%,14m
16565,1,[22D]VLOHV,3004,195,6,10,16,37.5%,3m
16565,1,KamiKazae,3004,132,5,4,9,55.6%,20m
16565,1,[RatZx]hentaidesu,3004,88,5,7,12,41.7%,39m
16565,1,BrentheGreat,3004,97,2,1,3,66.7%,2h
16565,2,[DRONGO]FirSTBloOD,3004,0,1,0,1,100.0%,37m
16565,1,[neuroW]LambDuhh,3004,0,1,2,3,33.3%,40m
16565,1,[p90z]alexpoopers,3004,0,0,2,2,0.0%,16m
16589,1,DeadlyMouse,3003,1071,47,32,79,59.5%,8m
16589,1,NUGGETHEAD,3003,1010,41,34,75,54.7%,37m
16589,2,jimdownside,3003,740,27,25,52,51.9%,25m
16589,2,[ØÛ]Skull,3003,414,18,5,23,78.3%,13m
16589,1,[GRNSKN]LenweTurtle,3003,390,18,20,38,47.4%,39m
16589,1,UsainBama,3003,455,17,13,30,56.7%,6m
16589,3,xlx,3003,455,17,17,34,50.0%,38m
16589,3,oxynutz,3003,490,17,32,49,34.7%,24m
16589,1,FecalTxn,3003,254,10,9,19,52.6%,20m
16589,1,[UpeV]LegendHero,3003,222,7,5,12,58.3%,28m
16589,1,Vendetta,3003,154,7,5,12,58.3%,37m
16589,2,[UW]Exultix,3003,134,5,9,14,35.7%,29m
16589,1,[VTClan]DaBigKevocho,3003,160,4,4,8,50.0%,22m
16589,2,[WWP2]Bunsenburner,3003,122,3,2,5,60.0%,37m
16589,1,Grogu,3003,80,3,5,8,37.5%,15m
16589,1,[FODAC]Hito,3003,125,3,6,9,33.3%,9m
16589,1,superkiller,3003,0,1,1,2,50.0%,12m
16589,2,[Vtta]tadicles,3003,32,1,1,2,50.0%,13m
16589,2,Ssamm,3003,30,1,3,4,25.0%,34m
16589,2,CaM,3003,0,0,1,1,0.0%,33m
16589,2,[BoAVN]Ashura,3003,0,0,1,1,0.0%,9m
16589,2,David,3003,0,0,2,2,0.0%,39m
16589,2,holyaioli,3003,0,0,2,2,0.0%,31m
16589,2,Tsuvani,3003,0,0,2,2,0.0%,8m
16613,3,OctoberHive,3002,669,365,359,724,50.4%,13m
16613,3,RandomWasabi,3002,1535,139,135,274,50.7%,25m
16613,1,MrMayhem,3002,1472,122,108,230,53.0%,8m
16613,1,Saerodor,3002,809,71,60,131,54.2%,22m
16613,3,matcha,3002,547,51,54,105,48.6%,31m
16613,1,BboySlug,3002,1309,49,45,94,52.1%,8m
16613,3,FizzBuzz,3002,1133,41,49,90,45.6%,26m
16613,3,AurA,3002,648,25,26,51,49.0%,12m
16613,1,sosuke,3002,754,24,28,52,46.2%,32m
16613,1,[Zzone]Arth,3002,588,23,18,41,56.1%,28m
16613,2,[UpeV]LBlanc,3002,574,21,16,37,56.8%,15m
16613,3,[AhhSil]Cyano,3002,576,21,30,51,41.2%,23m
16613,1,Virus,3002,439,17,14,31,54.8%,8m
16613,1,Foe,3002,348,16,9,25,64.0%,20m
16613,2,[UNCC]AMR,3002,340,14,4,18,77.8%,34m
16613,1,Kayz,3002,89,4,3,7,57.1%,6m
16613,2,PaltryNewt,3002,30,4,3,7,57.1%,6m
16613,1,BlueFlame,3002,191,4,5,9,44.4%,20m
16613,2,[CRAKS]KAUR,3002,58,3,2,5,60.0%,40m
16613,1,BrightCHaMa,3002,89,3,4,7,42.9%,37m
16613,2,Bear,3002,0,1,0,1,100.0%,29m
16613,1,Gouda,3002,0,1,0,1,100.0%,26m
16613,2,[NwAs]ArfenixGamer,3002,30,1,1,2,50.0%,30m
16613,2,Majic,3002,36,1,3,4,25.0%,42m
16613,3,Parry,3002,0,0,1,1,0.0%,2h
16613,2,DrIncomptent,3002,0,0,1,1,0.0%,41m
16639,3,Volkhan,3001,1387,116,118,234,49.6%,27m
16639,3,Vrael,3001,745,66,66,132,50.0%,32m
16639,3,Countersmell,3001,1298,59,65,124,47.6%,42m
16639,2,WeGrowBeans,3001,472,26,22,48,54.2%,31m
16639,1,Broodfinger,3001,530,16,19,35,45.7%,22m
16639,1,Thinking,3001,434,13,16,29,44.8%,32m
16639,1,Socks,3001,488,13,18,31,41.9%,42m
16639,2,[Fir3s]Immortality,3001,251,10,3,13,76.9%,35m
16639,2,[IVANKA]burghburgh,3001,142,8,5,13,61.5%,39m
16639,2,Endless,3001,212,8,8,16,50.0%,37m
16639,1,PussiDstryer,3001,148,8,10,18,44.4%,40m
16639,1,Xtian,3001,240,8,13,21,38.1%,40m
16639,1,Moss,3001,96,7,1,8,87.5%,2h
16639,1,Kilby,3001,220,6,12,18,33.3%,36m
16639,2,[FGGTS]palis,3001,120,5,4,9,55.6%,37m
16639,1,Jakked,3001,200,4,7,11,36.4%,10m
16639,2,[Hymir]aWoodenFence,3001,62,3,1,4,75.0%,36m
16639,2,RavenousOne,3001,47,2,3,5,40.0%,30m
16639,1,Diaw,3001,40,2,3,5,40.0%,37m
16639,2,[OpT1cZ]Potato,3001,0,1,0,1,100.0%,33m
16639,1,[SoAC]TheOblivious,3001,0,1,3,4,25.0%,17m
16639,3,[ACRE]Keniow,3001,0,1,3,4,25.0%,29m
16639,2,Pumah,3001,0,0,1,1,0.0%,24m
16639,2,[Cryptc]Stealth,3001,0,0,2,2,0.0%,19m
16639,2,Roku,3001,0,0,4,4,0.0%,59m
16664,3,AudiencefONE,3000,1603,720,654,1374,52.4%,9m
16664,3,hnrcbx,3000,962,262,258,520,50.4%,29m
16664,1,AshY,3000,1362,157,146,303,51.8%,37m
16664,3,[SPMAF]CitizenSnips,3000,857,129,137,266,48.5%,20m
16664,2,Atreides,3000,1535,117,102,219,53.4%,23m
16664,1,[NA7]Swoon,3000,1309,50,42,92,54.3%,11m
16664,3,IAMCANADIAN,3000,909,44,42,86,51.2%,6m
16664,1,AverageJoe,3000,767,42,34,76,55.3%,11m
16664,2,sassr,3000,471,25,20,45,55.6%,42m
16664,2,PRPL,3000,604,23,20,43,53.5%,34m
16664,2,sniperrobotz,3000,554,21,19,40,52.5%,16m
16664,1,TangoWhiskey,3000,495,16,16,32,50.0%,20m
16664,1,Chalon,3000,221,9,6,15,60.0%,18m
16664,1,Adabuu,3000,228,7,6,13,53.8%,39m
16664,1,Legendling,3000,154,5,2,7,71.4%,37m
16664,2,Whizzy,3000,150,5,4,9,55.6%,23m
16664,2,IliIliIliIl,3000,30,4,2,6,66.7%,16m
16664,2,Crumpet,3000,121,4,4,8,50.0%,2h
16664,1,Furious,3000,154,4,9,13,30.8%,8m
16664,1,Dylhero,3000,150,4,11,15,26.7%,18m
16664,1,Skippy,3000,160,4,11,15,26.7%,37m
16664,2,Kuwabara,3000,0,2,1,3,66.7%,28m
16664,2,[ZTemps]Sonder,3000,0,1,0,1,100.0%,44m
16664,2,[Pharoh]Erikor,3000,0,1,0,1,100.0%,30m
16664,1,[Slippy]Julie,3000,0,1,2,3,33.3%,23m
16664,3,wtsgoodtime,3000,0,0,1,1,0.0%,2h
16690,3,Orical,2999,1486,325,330,655,49.6%,27m
16690,3,[SZGG]BigCat,2999,1188,153,149,302,50.7%,24m
16690,3,BChillman,2999,341,133,138,271,49.1%,27m
16690,2,Nubcakes,2999,837,73,58,131,55.7%,11m
16690,1,rudolfmdlt,2999,1502,66,49,115,57.4%,41m
16690,3,Zaklee,2999,1238,52,54,106,49.1%,36m
16690,3,OGguapoh,2999,682,49,46,95,51.6%,40m
16690,1,[TWI]Taeze,2999,1111,41,42,83,49.4%,40m
16690,1,Samstar,2999,816,37,32,69,53.6%,27m
16690,3,[lesb]ian,2999,705,28,31,59,47.5%,13m
16690,1,[BR33D]Nlghok,2999,531,18,18,36,50.0%,22m
16690,1,[NLTTJ]ParadOx,2999,317,13,9,22,59.1%,32m
16690,2,NoBrainTrump,2999,260,9,6,15,60.0%,7m
16690,1,KRiLLaH,2999,280,9,9,18,50.0%,22m
16690,1,melville,2999,206,6,10,16,37.5%,20m
16690,1,Tengo,2999,148,5,6,11,45.5%,43m
16690,1,joviusjune,2999,106,4,7,11,36.4%,20m
16690,3,minimin,2999,120,4,7,11,36.4%,8m
16690,2,Poelie,2999,0,3,2,5,60.0%,13m
16690,1,cows,2999,104,3,2,5,60.0%,22m
16690,2,Rambuglian,2999,68,2,2,4,50.0%,29m
16690,2,JUICE,2999,0,2,3,5,40.0%,43m
16690,2,CurTeSyFluSh,2999,0,2,3,5,40.0%,19m
16690,2,[HaMz]Parm,2999,46,2,4,6,33.3%,2h
16690,3,Alvin,2999,64,2,21,23,8.7%,28m
16690,2,zelinhhh,2999,0,1,1,2,50.0%,25m
16690,2,huntermc,2999,30,1,2,3,33.3%,13m
16690,1,Knowing,2999,42,1,6,7,14.3%,3m
16690,1,hype,2999,0,0,1,1,0.0%,33m
16690,2,dolfin,2999,0,0,1,1,0.0%,43m
16720,1,kprix,2998,1534,206,195,401,51.4%,23m
16720,2,[BFS]Bstard,2998,771,34,15,49,69.4%,15m
16720,1,[Dulux]Turkeyslap,2998,816,30,27,57,52.6%,20m
16720,1,kyushkn,2998,758,29,27,56,51.8%,9m
16720,1,Sailax,2998,742,28,27,55,50.9%,9m
16720,1,[SMCE]ShadowHunter,2998,277,9,10,19,47.4%,12m
16720,1,TheImpJesse,2998,162,8,2,10,80.0%,32m
16720,1,KuntmalaHarr,2998,228,7,12,19,36.8%,24m
16720,3,IvoHolanda,2998,159,6,4,10,60.0%,2h
16720,3,[GiLLs]FDSBosox,2998,197,6,7,13,46.2%,21m
16720,2,Kaz,2998,96,5,4,9,55.6%,7m
16720,1,Mitt,2998,135,5,4,9,55.6%,28m
16720,3,[vFp]Kwazie,2998,0,4,2,6,66.7%,43m
16720,2,[MGKe]TestBoost,2998,98,4,3,7,57.1%,43m
16720,2,[M1A5]ita,2998,88,3,3,6,50.0%,5m
16720,3,Morgan,2998,97,2,0,2,100.0%,2h
16720,2,Xithe,2998,34,2,1,3,66.7%,13m
16720,1,Piry,2998,36,2,2,4,50.0%,11m
16720,2,[Abstra]Haraldo,2998,0,1,0,1,100.0%,2h
16720,2,[iNsTin]frankiz,2998,0,1,0,1,100.0%,39m
16720,2,[AGHS]heby,2998,0,1,0,1,100.0%,36m
16720,2,[REALG4]yaguarii,2998,0,1,0,1,100.0%,40m
16720,2,Menace,2998,0,1,2,3,33.3%,33m
16720,2,Jonny,2998,0,0,1,1,0.0%,36m
16720,2,Visceroid,2998,0,0,1,1,0.0%,15m
16720,2,KingOfKings,2998,0,0,1,1,0.0%,13m
16720,2,CascadeBoom,2998,0,0,2,2,0.0%,17m
16720,2,[KYM]Hanset,2998,0,0,2,2,0.0%,2h
16748,3,SeaSword,2997,1151,188,184,372,50.5%,27m
16748,1,[YWings]Boomz,2997,1631,149,149,298,50.0%,31m
16748,2,Fizzy,2997,1627,137,107,244,56.1%,17m
16748,1,mrboggles,2997,1660,133,139,272,48.9%,3m
16748,3,[xENTx]SIRCOL,2997,1525,131,136,267,49.1%,30m
16748,3,[LaOr]BABYMARIACHI,2997,1262,124,121,245,50.6%,5m
16748,1,Earth,2997,1304,109,100,209,52.2%,18m
16748,3,Shaboo,2997,1572,90,93,183,49.2%,12m
16748,1,gba,2997,1103,89,81,170,52.4%,12m
16748,3,saraevans,2997,1558,81,98,179,45.3%,9m
16748,3,fenor,2997,1360,66,49,115,57.4%,42m
16748,2,[Lp]JTRG,2997,1050,58,43,101,57.4%,34m
16748,1,[GILLY]Kyean,2997,1079,49,45,94,52.1%,28m
16748,1,DrNeptune,2997,887,33,30,63,52.4%,38m
16748,1,[SDC12]BlackSoul,2997,603,22,19,41,53.7%,4m
16748,1,nemo,2997,408,16,14,30,53.3%,20m
16748,1,radapan,2997,373,12,12,24,50.0%,18m
16748,1,IIiiIIiiII,2997,374,12,15,27,44.4%,32m
16748,1,NodeN,2997,344,10,15,25,40.0%,38m
16748,1,[VFam]Legit,2997,380,10,17,27,37.0%,16m
16748,1,[LCE]MrAleSs,2997,322,9,12,21,42.9%,42m
16748,3,Arare,2997,201,7,4,11,63.6%,2h
16748,3,kingspadeopm,2997,202,6,25,31,19.4%,33m
16748,3,LegitMidget,2997,121,5,4,9,55.6%,2h
16748,1,Isaiah,2997,88,4,3,7,57.1%,6m
16748,2,hennerox,2997,0,3,2,5,60.0%,26m
16748,2,DookieDookie,2997,0,3,2,5,60.0%,14m
16748,2,Psyborrg,2997,88,3,3,6,50.0%,17m
16748,2,MasterTrull,2997,60,3,5,8,37.5%,13m
16748,1,cRude,2997,96,3,5,8,37.5%,1h
16748,1,BenZed,2997,76,3,6,9,33.3%,20m
16748,2,Smores,2997,30,2,0,2,100.0%,11m
16748,2,BadModafuker,2997,114,2,4,6,33.3%,36m
16748,3,Miggy,2997,30,2,9,11,18.2%,25m
16748,2,PADADAPO,2997,32,1,3,4,25.0%,29m
16748,2,kleinsman,2997,0,0,1,1,0.0%,22m
16748,2,PhoTheWin,2997,0,0,1,1,0.0%,9m
16748,2,GhostMatterz,2997,0,0,2,2,0.0%,15m
16748,3,[RakF]kakoki,2997,0,0,5,5,0.0%,33m
16787,1,MJS,2996,1015,90,91,181,49.7%,4m
16787,1,[TFBE]brion,2996,775,83,63,146,56.8%,36m
16787,3,[GOPERÚ]Ashiran,2996,801,68,59,127,53.5%,17m
16787,1,[MCY]JpBlacker,2996,1110,57,47,104,54.8%,35m
16787,3,[PobSC]Softrotx,2996,1120,51,55,106,48.1%,12m
16787,1,CakeFart,2996,926,42,42,84,50.0%,23m
16787,1,[CUCKSS]TheWebba,2996,704,22,24,46,47.8%,15m
16787,1,ScaryMcLarry,2996,499,17,16,33,51.5%,20m
16787,1,Matark,2996,328,10,9,19,52.6%,16m
16787,1,[RVSV]Rocha,2996,338,10,9,19,52.6%,5m
16787,1,qamrul,2996,207,6,9,15,40.0%,37m
16787,2,SulkingCrow,2996,86,4,0,4,100.0%,26m
16787,2,rainingblood,2996,116,4,1,5,80.0%,37m
16787,2,snowfaster,2996,152,4,2,6,66.7%,39m
16787,2,[BJohns]Sonicfire,2996,0,3,2,5,60.0%,8m
16787,2,Jasper,2996,94,3,3,6,50.0%,30m
16787,3,[ScSwrm]Aldric,2996,62,3,11,14,21.4%,33m
16787,2,Danielrapz,2996,64,2,2,4,50.0%,10m
16787,1,Scott,2996,124,2,4,6,33.3%,5m
16787,3,Stress,2996,121,2,7,9,22.2%,6m
16787,1,[X17]TraP,2996,0,1,3,4,25.0%,21m
16787,1,[Xpk]Mapazhe,2996,95,1,3,4,25.0%,30m
16787,2,VaPa,2996,0,0,1,1,0.0%,31m
16810,3,corbinator,2995,1254,80,71,151,53.0%,25m
16810,3,Drewbear,2995,1324,72,86,158,45.6%,33m
16810,1,[AbcCo]CaritaFeliz,2995,1501,61,52,113,54.0%,26m
16810,1,WhiteTiger,2995,1353,58,52,110,52.7%,8m
16810,3,Cobra,2995,1043,39,41,80,48.8%,17m
16810,2,Juggernaut,2995,884,38,28,66,57.6%,40m
16810,3,heyguy,2995,730,34,30,64,53.1%,12m
16810,1,Razmataz,2995,838,31,36,67,46.3%,15m
16810,1,[GGKs]TelFiRE,2995,418,27,28,55,49.1%,8m
16810,1,Jayden,2995,750,24,27,51,47.1%,20m
16810,3,Rolendubs,2995,430,15,24,39,38.5%,23m
16810,2,[ThW]CaioRavi,2995,318,12,10,22,54.5%,25m
16810,1,Kenshii,2995,290,11,8,19,57.9%,28m
16810,1,Hiponano,2995,289,10,9,19,52.6%,27m
16810,2,fleshblade,2995,244,9,7,16,56.2%,7m
16810,2,[909090]MrDavJux,2995,191,6,3,9,66.7%,12m
16810,3,fromSouthKOR,2995,135,6,3,9,66.7%,40m
16810,1,CricK,2995,182,5,8,13,38.5%,26m
16810,3,diogenes,2995,0,4,2,6,66.7%,3h
16810,2,Feleure,2995,0,3,2,5,60.0%,13m
16810,1,Alberico,2995,156,3,5,8,37.5%,20m
16810,3,IIIIIIIIIIII,2995,113,2,1,3,66.7%,16m
16810,2,Neddard,2995,0,1,0,1,100.0%,15m
16810,2,Taeyang,2995,0,1,1,2,50.0%,3m
16810,1,SwigLee,2995,0,1,3,4,25.0%,28m
16810,1,Spooky,2995,0,0,4,4,0.0%,5m
16836,1,MRWTF,2994,1499,159,127,286,55.6%,10m
16836,1,vicccccccccc,2994,1627,132,122,254,52.0%,11m
16836,3,Reagan,2994,1526,127,90,217,58.5%,17m
16836,1,Maurice,2994,1342,127,126,253,50.2%,22m
16836,3,hydra,2994,1010,87,83,170,51.2%,25m
16836,3,aSgNitzer,2994,935,61,60,121,50.4%,39m
16836,3,VoteByMail,2994,725,60,35,95,63.2%,28m
16836,2,BADD,2994,1256,49,38,87,56.3%,43m
16836,1,Shroud,2994,1058,39,37,76,51.3%,20m
16836,1,[SiG7]Chiffins,2994,720,36,30,66,54.5%,37m
16836,1,[MD420]Grievous,2994,791,35,29,64,54.7%,16m
16836,1,SpikedTea,2994,972,31,36,67,46.3%,4m
16836,1,Troll,2994,777,30,31,61,49.2%,36m
16836,2,IIIIIIIIIIII,2994,372,17,12,29,58.6%,39m
16836,1,[CoOpy]SavageDragon,2994,390,14,18,32,43.8%,21m
16836,1,blessdtoflex,2994,353,13,10,23,56.5%,38m
16836,3,Troutjerky,2994,225,11,6,17,64.7%,25m
16836,1,NicoCAP,2994,297,10,9,19,52.6%,40m
16836,2,[ChoCo]Chaos,2994,269,9,12,21,42.9%,9m
16836,2,conqueso,2994,94,4,2,6,66.7%,13m
16836,1,Logan,2994,88,4,3,7,57.1%,17m
16836,3,FlipHero,2994,137,4,7,11,36.4%,54m
16836,2,Riceballs,2994,0,3,2,5,60.0%,34m
16836,1,Frey,2994,129,3,8,11,27.3%,36m
16836,2,Casualty,2994,58,2,2,4,50.0%,12m
16836,2,FULLNA,2994,60,2,2,4,50.0%,5m
16836,1,SumTingWong,2994,118,2,4,6,33.3%,24m
16836,1,[1025]HyperVirus,2994,76,2,8,10,20.0%,20m
16836,3,ktra,2994,0,1,0,1,100.0%,2h
16836,2,[juggr]Gandalf,2994,0,1,1,2,50.0%,33m
16836,1,[BoXLyF]GloopGlorp,2994,38,1,7,8,12.5%,14m
16836,2,[PiGPan]Cardnal,2994,0,0,1,1,0.0%,40m
16868,1,[LOHd]Willian,2993,771,108,98,206,52.4%,24m
16868,1,Ato,2993,918,43,44,87,49.4%,9m
16868,2,Muffins,2993,628,35,29,64,54.7%,36m
16868,2,ahfatlee,2993,617,34,10,44,77.3%,20m
16868,1,McLeavage,2993,388,33,26,59,55.9%,43m
16868,2,[cluez]BoV,2993,730,30,21,51,58.8%,23m
16868,2,Motivz,2993,391,29,21,50,58.0%,33m
16868,2,MetalHorse,2993,418,27,15,42,64.3%,34m
16868,1,trailsbest,2993,828,26,30,56,46.4%,11m
16868,1,SevenTenths,2993,261,19,17,36,52.8%,9m
16868,2,[STGGC]Coersion,2993,296,11,10,21,52.4%,29m
16868,1,foolishhh,2993,256,10,8,18,55.6%,39m
16868,1,THRILLHOUSE,2993,311,10,8,18,55.6%,26m
16868,1,ABIMAEL,2993,358,10,13,23,43.5%,38m
16868,1,[SWorld]FuZzyCat,2993,276,10,14,24,41.7%,36m
16868,1,[TuMom]NoonRising,2993,244,9,8,17,52.9%,20m
16868,3,DadiBlanki,2993,0,5,1,6,83.3%,2h
16868,2,TwoFtNYoChst,2993,112,5,2,7,71.4%,32m
16868,1,CAPSBRO,2993,102,5,3,8,62.5%,22m
16868,2,Fate,2993,0,3,2,5,60.0%,41m
16868,1,KRW,2993,0,3,2,5,60.0%,32m
16868,1,Euyo,2993,38,1,6,7,14.3%,16m
16868,2,[bm4Fun]bluntzilla,2993,0,0,1,1,0.0%,37m
16868,2,KGKoala,2993,0,0,1,1,0.0%,32m
16868,2,SpaceCakes,2993,0,0,1,1,0.0%,25m
16868,2,[QTp2T]GGAllin,2993,0,0,1,1,0.0%,37m
16894,3,[Th3Bad]oceifador,2992,1240,282,266,548,51.5%,28m
16894,1,heckersbewar,2992,1531,223,207,430,51.9%,35m
16894,3,Hairyzerglin,2992,1502,201,198,399,50.4%,24m
16894,1,Trench,2992,479,26,32,58,44.8%,32m
16894,1,[WAAB]TradeMark,2992,779,25,28,53,47.2%,13m
16894,1,Haste,2992,482,18,16,34,52.9%,14m
16894,3,[EtrOy]Magneto,2992,522,18,28,46,39.1%,23m
16894,1,SupremeZiv,2992,426,16,13,29,55.2%,12m
16894,1,[SM7]Attila,2992,226,7,12,19,36.8%,22m
16894,2,[PTHero]Kurowasun,2992,122,5,2,7,71.4%,13m
16894,1,HybridXZ,2992,0,3,2,5,60.0%,2h
16894,1,[SdPM]Fouty,2992,113,2,3,5,40.0%,22m
16894,3,Jake,2992,64,2,15,17,11.8%,31m
16894,2,GGBREH,2992,0,1,0,1,100.0%,23m
16894,2,GoodTarget,2992,30,1,1,2,50.0%,29m
16894,3,[AIRBAG]Ourion,2992,0,1,8,9,11.1%,24m
16910,1,ThaHeadbussa,2991,1703,258,240,498,51.8%,17m
16910,1,demosthenes,2991,1013,140,130,270,51.9%,10m
16910,2,[WBCM]GlassJoe,2991,979,54,9,63,85.7%,39m
16910,1,[Sn50]evilhologram,2991,1090,42,49,91,46.2%,24m
16910,3,Fury,2991,830,39,44,83,47.0%,11m
16910,1,Barros,2991,823,34,28,62,54.8%,18m
16910,1,Jive,2991,838,32,23,55,58.2%,24m
16910,1,INSETO,2991,716,31,24,55,56.4%,6m
16910,1,TJosh,2991,728,23,28,51,45.1%,14m
16910,1,[hBNA]Virentes,2991,412,19,12,31,61.3%,42m
16910,2,[COLNSR]Mustang,2991,460,16,15,31,51.6%,41m
16910,3,Syriax,2991,322,13,10,23,56.5%,43m
16910,2,[gorneg]ALVAROS,2991,226,9,4,13,69.2%,37m
16910,2,AlBundy,2991,196,8,4,12,66.7%,20m
16910,1,Race,2991,194,7,5,12,58.3%,28m
16910,2,DeMindcast,2991,198,6,2,8,75.0%,15m
16910,3,tigre,2991,62,6,9,15,40.0%,13m
16910,2,[PhC]PhilCollins,2991,172,5,3,8,62.5%,15m
16910,2,Shinoobi,2991,120,4,6,10,40.0%,4m
16910,2,[Suriv]RideorDie,2991,0,3,2,5,60.0%,16m
16910,1,[KiMBR]JBCARMO,2991,110,3,8,11,27.3%,18m
16910,2,[RGQTbr]DoomDrop,2991,0,1,1,2,50.0%,16m
16910,2,dirty,2991,0,1,1,2,50.0%,13m
16910,2,AndrewJakson,2991,30,1,2,3,33.3%,31m
16910,2,Vitals,2991,0,0,1,1,0.0%,33m
16910,1,[HGG]DontMakeMe,2991,0,0,2,2,0.0%,18m
16910,2,Cameron,2991,0,0,2,2,0.0%,13m
16937,1,[Rngede]Raiyn,2990,1708,120,120,240,50.0%,9m
16937,1,SebisaLiar,2990,1082,76,62,138,55.1%,20m
16937,1,BolivianSan,2990,1144,44,41,85,51.8%,39m
16937,1,btbwood,2990,713,31,27,58,53.4%,37m
16937,3,AverageMan,2990,619,24,30,54,44.4%,27m
16937,1,kakaname,2990,489,22,20,42,52.4%,5m
16937,2,[DSFTWA]ShadowStorm,2990,467,19,11,30,63.3%,9m
16937,1,Taylorswift,2990,300,18,6,24,75.0%,12m
16937,1,IllIIlIIllII,2990,436,17,13,30,56.7%,6m
16937,3,Neato,2990,447,17,25,42,40.5%,13m
16937,2,[DNKCFT]HoRNET,2990,232,9,5,14,64.3%,12m
16937,3,baby,2990,206,8,5,13,61.5%,26m
16937,1,Bronx,2990,170,7,6,13,53.8%,24m
16937,1,BitinG,2990,96,5,3,8,62.5%,51m
16937,1,[CH3ES3]FluffyKitten,2990,158,5,7,12,41.7%,5m
16937,2,[Cheees]Daniel,2990,86,4,0,4,100.0%,30m
16937,2,HUNTER,2990,0,4,1,5,80.0%,9m
16937,1,WithNail,2990,88,4,3,7,57.1%,24m
16937,3,Yaga,2990,0,4,3,7,57.1%,2h
16937,1,majoraLoL,2990,0,3,2,5,60.0%,2h
16937,1,wonder,2990,130,3,4,7,42.9%,17m
16937,2,[PaC]DendroAspiS,2990,60,2,2,4,50.0%,6m
16937,2,VTrider,2990,42,2,2,4,50.0%,38m
16937,1,[Timor]Pheardom,2990,34,2,3,5,40.0%,30m
16937,2,[asdf12]cau,2990,0,1,0,1,100.0%,6m
16937,1,[Tyber]FlynnyBlues,2990,0,1,1,2,50.0%,19m
16937,3,lostranger,2990,0,1,3,4,25.0%,41m
16937,2,[POBLHA]reptilLcoste,2990,0,0,1,1,0.0%,36m
16937,2,[FatMom]Grillz,2990,0,0,1,1,0.0%,16m
16966,3,LIlIIiil,2989,666,203,188,391,51.9%,6m
16966,2,OldOneEye,2989,1539,85,82,167,50.9%,23m
16966,1,[SHle]Sergio,2989,1602,76,65,141,53.9%,15m
16966,1,[GnR]Redgunnerguy,2989,1094,42,36,78,53.8%,10m
16966,1,[copain]Automne,2989,416,24,29,53,45.3%,30m
16966,1,BigDead,2989,536,20,20,40,50.0%,26m
16966,3,[GoBrrr]Shockwave,2989,464,16,19,35,45.7%,3m
16966,1,[ssexxy]Covaena,2989,283,13,6,19,68.4%,14m
16966,1,xxxolegrampy,2989,354,11,14,25,44.0%,24m
16966,1,KrakenSlayer,2989,215,9,5,14,64.3%,24m
16966,2,[SyLx]jack,2989,210,8,5,13,61.5%,13m
16966,2,Ace,2989,143,6,5,11,54.5%,18m
16966,2,[rshDIE]Baconidas,2989,164,6,5,11,54.5%,23m
16966,3,Atos,2989,146,6,5,11,54.5%,2h
16966,1,[SFUSC]Countryroads,2989,148,5,1,6,83.3%,2h
16966,2,Saturnine,2989,136,4,5,9,44.4%,36m
16966,2,[TGosuB]PROMETHIUM,2989,30,2,1,3,66.7%,13m
16966,2,[xDBZx]AlfredoCruz,2989,88,2,5,7,28.6%,49m
16966,2,StackingKing,2989,0,1,0,1,100.0%,43m
16966,2,MeatyMuffin,2989,0,1,0,1,100.0%,26m
16966,2,Balkiriaz,2989,30,1,3,4,25.0%,9m
16966,1,Water,2989,40,1,8,9,11.1%,18m
16966,2,[viwar]Megaroth,2989,0,0,2,2,0.0%,40m
16966,1,[Blacer]element,2989,0,0,6,6,0.0%,22m
16990,3,Necris,2988,1062,180,170,350,51.4%,42m
16990,3,TAZ,2988,962,131,117,248,52.8%,38m
16990,2,IIlllIIllIII,2988,428,130,109,239,54.4%,30m
16990,1,edrtsmda,2988,233,77,70,147,52.4%,13m
16990,3,Solilonarova,2988,1528,73,78,151,48.3%,33m
16990,2,Zero,2988,849,41,18,59,69.5%,10m
16990,2,BAPHOMET,2988,470,40,31,71,56.3%,34m
16990,1,ERWINplateni,2988,820,35,25,60,58.3%,23m
16990,2,Gnatally,2988,867,34,26,60,56.7%,5m
16990,1,tkFuzzy,2988,762,29,26,55,52.7%,18m
16990,1,Koop,2988,326,23,20,43,53.5%,35m
16990,2,codeChimp,2988,487,22,19,41,53.7%,33m
16990,2,ShadowStorm,2988,315,19,9,28,67.9%,31m
16990,2,WireKibe,2988,462,16,16,32,50.0%,14m
16990,1,ainu,2988,424,15,10,25,60.0%,24m
16990,1,LaMuta,2988,167,15,13,28,53.6%,20m
16990,2,Meow,2988,152,8,7,15,53.3%,35m
16990,2,[ZTempz]WeaponX,2988,146,6,3,9,66.7%,39m
16990,2,Brianzolo,2988,116,4,3,7,57.1%,39m
16990,2,ImOnlyEight,2988,0,3,2,5,60.0%,24m
16990,2,[TMKOs]DMMWarrior,2988,0,2,3,5,40.0%,16m
16990,1,BlazingNinja,2988,82,2,5,7,28.6%,24m
16990,1,bigzig,2988,74,2,5,7,28.6%,19m
16990,1,Bast,2988,0,1,2,3,33.3%,2h
16990,3,[RumG]Vynillia,2988,96,1,3,4,25.0%,38m
16990,1,Neilex,2988,88,1,3,4,25.0%,26m
16990,2,Samusin,2988,30,1,3,4,25.0%,25m
16990,2,HULKAMANIA,2988,0,0,1,1,0.0%,3m
17018,1,Chuckles,2987,934,126,112,238,52.9%,28m
17018,1,Cecil,2987,1327,88,70,158,55.7%,14m
17018,2,Downfall,2987,1123,80,58,138,58.0%,36m
17018,1,BetterThanU,2987,1444,75,73,148,50.7%,32m
17018,1,[UFC]Phillip,2987,772,61,60,121,50.4%,15m
17018,3,angel,2987,284,40,45,85,47.1%,21m
17018,2,[KurWa]NefariouS,2987,677,25,24,49,51.0%,29m
17018,2,DPod,2987,435,21,8,29,72.4%,31m
17018,3,[NPhasA]tiggerwang,2987,578,21,26,47,44.7%,29m
17018,1,[NPFR]rollos,2987,506,17,21,38,44.7%,14m
17018,1,[RAIVAX]Raivax,2987,305,11,11,22,50.0%,13m
17018,1,marmelloh,2987,263,8,11,19,42.1%,21m
17018,2,Vorphalck,2987,173,7,6,13,53.8%,45m
17018,3,[LOLm]Renicito,2987,0,5,2,7,71.4%,41m
17018,1,doctafizz,2987,198,5,11,16,31.2%,15m
17018,2,Lyon,2987,0,3,2,5,60.0%,6m
17018,2,Jadch,2987,30,1,1,2,50.0%,43m
17018,2,Hurryheathen,2987,30,1,1,2,50.0%,30m
17018,2,Vayeate,2987,30,1,1,2,50.0%,19m
17018,3,SadMcFatBack,2987,97,1,2,3,33.3%,2h
17018,2,UnrealRobin,2987,0,0,1,1,0.0%,35m
17039,1,OliverPomier,2986,1136,155,140,295,52.5%,33m
17039,2,Grandpa,2986,1112,44,37,81,54.3%,41m
17039,1,[SWOLJ]NinjafOx,2986,651,22,23,45,48.9%,40m
17039,2,InsaneArtist,2986,529,20,14,34,58.8%,32m
17039,3,JoMisfit,2986,140,16,26,42,38.1%,28m
17039,2,Airusj,2986,217,10,6,16,62.5%,2h
17039,2,Seventh,2986,177,8,4,12,66.7%,6m
17039,1,GamerTorture,2986,248,7,13,20,35.0%,16m
17039,3,WTF,2986,247,7,15,22,31.8%,26m
17039,2,Kraxor,2986,124,5,5,10,50.0%,12m
17039,1,KAMEDAKI,2986,0,4,1,5,80.0%,9m
17039,1,IgotoHarvard,2986,118,4,8,12,33.3%,12m
17039,2,cplusplus,2986,0,1,0,1,100.0%,33m
17039,1,[TheDOH]JCDenmark,2986,0,1,3,4,25.0%,28m
17039,1,[GEEKED]MicroPhelps,2986,0,0,1,1,0.0%,2h
17039,2,shibe,2986,0,0,2,2,0.0%,12m
17055,1,MrFcKingNsty,2985,1705,253,239,492,51.4%,4m
17055,3,VaJoNGas,2985,1503,155,153,308,50.3%,28m
17055,2,NoOne,2985,831,124,106,230,53.9%,9m
17055,1,Olmeca,2985,807,78,79,157,49.7%,12m
17055,2,KerrigansBoy,2985,1365,73,46,119,61.3%,34m
17055,2,SanVyrish,2985,1528,67,47,114,58.8%,10m
17055,1,SwankyOrc,2985,1255,54,46,100,54.0%,20m
17055,3,Mohican,2985,498,52,57,109,47.7%,16m
17055,1,[TEAMOD]WarBell,2985,1051,51,38,89,57.3%,16m
17055,1,postmortem,2985,1033,44,42,86,51.2%,10m
17055,3,[IIIY]ColdFear,2985,769,41,41,82,50.0%,24m
17055,1,Primetime,2985,648,40,28,68,58.8%,29m
17055,1,[GFP]Priapos,2985,1025,40,35,75,53.3%,8m
17055,1,WorldCrusher,2985,559,31,30,61,50.8%,14m
17055,2,[110213]Corvin,2985,746,29,24,53,54.7%,16m
17055,3,[BUTIFL]Daoh,2985,828,28,37,65,43.1%,27m
17055,2,Gallagugar,2985,553,23,18,41,56.1%,33m
17055,1,SuperShark,2985,218,9,6,15,60.0%,22m
17055,1,RiTTz,2985,244,7,15,22,31.8%,39m
17055,1,Terranasaur,2985,187,6,5,11,54.5%,15m
17055,1,Rave,2985,168,5,12,17,29.4%,17m
17055,2,Jangkrikmuda,2985,0,4,1,5,80.0%,20m
17055,2,RedWolf,2985,88,3,0,3,100.0%,13m
17055,2,LeeEziO,2985,0,3,2,5,60.0%,4m
17055,2,Fhurer,2985,88,2,1,3,66.7%,30m
17055,1,Harmony,2985,44,2,5,7,28.6%,31m
17055,2,JOSEWAN,2985,0,1,0,1,100.0%,23m
17055,1,Jellychews,2985,38,1,4,5,20.0%,10m
17055,1,[Cuunts]Tassadar,2985,38,1,6,7,14.3%,24m
17055,2,[Moist]dragoonking,2985,0,0,1,1,0.0%,7m
17055,2,[xACABx]swaggyboi,2985,0,0,1,1,0.0%,37m
17086,1,[FLNWRD]Panzerfaust,2984,1702,182,153,335,54.3%,18m
17086,1,LOLGTROMG,2984,1696,167,164,331,50.5%,27m
17086,2,[MexTab]Melchaha,2984,1526,132,123,255,51.8%,34m
17086,3,[QP]Hastrax,2984,1565,127,133,260,48.8%,12m
17086,2,exMachina,2984,1056,113,93,206,54.9%,15m
17086,3,[VanY]ProxyNChill,2984,1527,86,95,181,47.5%,23m
17086,1,[XpKAc]bleephk,2984,1311,50,45,95,52.6%,21m
17086,1,Sorlac,2984,615,49,34,83,59.0%,14m
17086,3,HowtheHare,2984,1136,39,51,90,43.3%,43m
17086,1,Hammer,2984,385,16,12,28,57.1%,20m
17086,2,[SHLA]PartinG,2984,208,8,3,11,72.7%,9m
17086,3,[6ixS]Carbon,2984,197,8,9,17,47.1%,5m
17086,1,HiddenAgenda,2984,238,7,12,19,36.8%,12m
17086,1,CaSuLo,2984,220,6,10,16,37.5%,12m
17086,2,SaltyClam,2984,142,5,3,8,62.5%,5m
17086,1,RushBb,2984,187,5,6,11,45.5%,14m
17086,3,PlayRisk,2984,30,3,9,12,25.0%,35m
17086,3,Malziekam,2984,98,3,17,20,15.0%,13m
17086,2,PurpleHaze,2984,34,2,1,3,66.7%,30m
17086,2,light,2984,30,2,2,4,50.0%,41m
17086,2,SpicyMimis,2984,0,1,1,2,50.0%,36m
17086,3,Immortal,2984,44,1,7,8,12.5%,2h
17086,2,Midnight,2984,0,0,2,2,0.0%,15m
17109,3,rawska,2983,1556,340,309,649,52.4%,38m
17109,3,[SyLx]Odiseo,2983,1601,280,272,552,50.7%,5m
17109,3,Aurumai,2983,1529,223,217,440,50.7%,27m
17109,2,gusstu,2983,573,60,55,115,52.2%,29m
17109,3,Garol,2983,1319,56,58,114,49.1%,18m
17109,1,SHIBA,2983,1226,44,43,87,50.6%,36m
17109,3,Azula,2983,943,39,41,80,48.8%,38m
17109,1,gooselinG,2983,779,38,34,72,52.8%,35m
17109,1,[URSC]Checho,2983,281,15,14,29,51.7%,28m
17109,1,Bick,2983,518,15,20,35,42.9%,3m
17109,1,Stibbs,2983,281,13,10,23,56.5%,24m
17109,2,[VAMP2]Epiphany,2983,338,12,6,18,66.7%,41m
17109,2,connor,2983,184,12,14,26,46.2%,7m
17109,2,Adam,2983,220,8,5,13,61.5%,33m
17109,3,chirpchirp,2983,144,4,3,7,57.1%,30m
17109,1,GoSuGumiho,2983,88,4,3,7,57.1%,27m
17109,2,Rainbow,2983,92,3,1,4,75.0%,31m
17109,2,jarrett,2983,0,3,2,5,60.0%,34m
17109,1,[UpeV]Prometeo,2983,138,3,4,7,42.9%,28m
17109,2,[killpp]Bloodinface,2983,0,1,0,1,100.0%,38m
17109,1,Gimmicking,2983,0,1,0,1,100.0%,16m
17109,2,DennyDeniro,2983,0,1,0,1,100.0%,29m
17109,2,BroToss,2983,0,1,0,1,100.0%,37m
17109,2,Nautilus,2983,30,1,1,2,50.0%,41m
17109,2,[tdrs]MyNeighbor,2983,0,1,1,2,50.0%,2h
17109,1,[GdAT]ScarlettUK,2983,96,1,3,4,25.0%,20m
17109,1,[POKE]Pikachu,2983,0,1,6,7,14.3%,27m
17109,2,Kazanski,2983,0,0,1,1,0.0%,20m
17109,2,[BanSex]Loit,2983,0,0,1,1,0.0%,25m
17109,2,Hamu,2983,0,0,2,2,0.0%,31m
17109,1,Fluoxetine,2983,0,0,4,4,0.0%,9m
17140,3,Bean,2982,1537,214,212,426,50.2%,38m
17140,1,SaulHudson,2982,1258,115,112,227,50.7%,3m
17140,1,Rickster,2982,1154,70,66,136,51.5%,12m
17140,1,TequilaMan,2982,591,54,43,97,55.7%,37m
17140,3,coldhand,2982,900,54,51,105,51.4%,23m
17140,2,MrGeg,2982,462,20,17,37,54.1%,41m
17140,1,Cokodudodu,2982,590,19,22,41,46.3%,15m
17140,3,[ramrod]Newman,2982,422,15,25,40,37.5%,6m
17140,2,Raistlin,2982,245,10,8,18,55.6%,6m
17140,1,Pokketz,2982,221,10,9,19,52.6%,27m
17140,3,Thanatos,2982,212,6,5,11,54.5%,28m
17140,2,ForTheHorde,2982,158,6,6,12,50.0%,2h
17140,1,[wyd420]Omar,2982,112,4,7,11,36.4%,30m
17140,2,[αXLa]HASSEBOSSE,2982,86,3,2,5,60.0%,25m
17140,1,stigy,2982,0,3,2,5,60.0%,2h
17140,1,Jorge,2982,108,3,7,10,30.0%,15m
17140,2,Victorules,2982,95,2,2,4,50.0%,35m
17140,2,[Cind3r]gobow,2982,70,2,4,6,33.3%,31m
17140,1,[DoRQ]GaseousDeath,2982,107,2,4,6,33.3%,42m
17140,1,[GSC2P]LilBlu,2982,97,2,4,6,33.3%,3h
17140,2,[N07A]Rockstar,2982,0,1,0,1,100.0%,19m
17140,2,vikinghammer,2982,30,1,1,2,50.0%,43m
17140,1,[Serene]Serenity,2982,0,1,4,5,20.0%,26m
17140,1,[VDRFST]AdmiralNoOne,2982,0,0,1,1,0.0%,25m
17164,3,[420kil]CoronaVirus,2981,1534,264,268,532,49.6%,6m
17164,1,Goose,2981,1370,63,61,124,50.8%,39m
17164,1,Phi,2981,618,49,53,102,48.0%,18m
17164,1,xray,2981,607,35,39,74,47.3%,10m
17164,3,Dobwynn,2981,951,35,43,78,44.9%,43m
17164,1,IIIIIIIIIIII,2981,494,25,15,40,62.5%,14m
17164,2,Tosylate,2981,465,19,11,30,63.3%,25m
17164,1,[LFC]MamMoTH,2981,488,17,16,33,51.5%,32m
17164,3,CobraLin,2981,388,16,21,37,43.2%,31m
17164,2,neon,2981,328,11,7,18,61.1%,34m
17164,1,NoX,2981,301,10,9,19,52.6%,22m
17164,2,UNoriginal,2981,102,5,2,7,71.4%,20m
17164,1,Minimin,2981,114,5,4,9,55.6%,23m
17164,1,SappyCakez,2981,179,5,7,12,41.7%,10m
17164,1,Verjo,2981,126,3,4,7,42.9%,19m
17164,3,[ESBU]Chaos,2981,97,3,5,8,37.5%,27m
17164,2,[LTlord]daryl,2981,62,2,2,4,50.0%,35m
17164,1,USAmonkey,2981,0,1,0,1,100.0%,2h
17164,2,HeavyHittaz,2981,0,1,1,2,50.0%,3m
17164,2,[WofA]Theads,2981,30,1,1,2,50.0%,31m
17164,2,drako,2981,0,1,1,2,50.0%,37m
17164,2,HenriCÃO,2981,34,1,2,3,33.3%,13m
17164,2,NerdGamer,2981,95,1,2,3,33.3%,18m
17164,1,Dstrange,2981,0,0,2,2,0.0%,8m
17164,2,llllllllllll,2981,0,0,2,2,0.0%,36m
17189,3,IMSORRYLOLGG,2980,1495,92,89,181,50.8%,11m
17189,1,[FaceVN]Lionheart,2980,1496,63,52,115,54.8%,10m
17189,3,TheOneking,2980,1081,51,57,108,47.2%,31m
17189,1,BlueMarble,2980,859,44,44,88,50.0%,9m
17189,1,Thrascall,2980,1015,42,42,84,50.0%,13m
17189,1,CrazyGhost,2980,596,38,33,71,53.5%,12m
17189,1,[EpiK7]Genesis,2980,726,28,26,54,51.9%,26m
17189,1,Metradime,2980,681,26,22,48,54.2%,18m
17189,2,iLoveCrack,2980,460,23,13,36,63.9%,35m
17189,1,[JLBang]NotGoodSon,2980,613,22,20,42,52.4%,19m
17189,1,MrGrndnblst,2980,475,16,15,31,51.6%,30m
17189,3,RonArtest,2980,295,9,9,18,50.0%,29m
17189,1,Krrrrratos,2980,165,8,7,15,53.3%,59m
17189,2,Warboy,2980,236,8,10,18,44.4%,37m
17189,3,LoveYou,2980,180,7,4,11,63.6%,2h
17189,1,Lumer,2980,188,7,10,17,41.2%,8m
17189,2,ASlowLoris,2980,148,6,5,11,54.5%,31m
17189,1,Hiddenhat,2980,198,6,11,17,35.3%,28m
17189,2,MassBlood,2980,88,4,1,5,80.0%,26m
17189,2,vronsky,2980,92,3,3,6,50.0%,38m
17189,1,JoeSoul,2980,0,3,3,6,50.0%,15m
17189,1,Zorrm,2980,58,2,6,8,25.0%,39m
17189,2,ZoVaNaK,2980,0,1,0,1,100.0%,17m
17189,1,Negativity,2980,0,1,0,1,100.0%,2h
17189,2,KombatKarl,2980,0,1,2,3,33.3%,42m
17189,2,Armin,2980,0,0,1,1,0.0%,43m
17189,1,[R2x]LuBB,2980,0,0,2,2,0.0%,2h
17216,2,Ostrich,2979,1548,184,151,335,54.9%,41m
17216,3,[EtrOy]BroodGuard,2979,1338,174,180,354,49.2%,15m
17216,1,Harambe,2979,1482,74,73,147,50.3%,14m
17216,2,CaptZapp,2979,1290,73,56,129,56.6%,30m
17216,3,Shrimp,2979,512,73,74,147,49.7%,4m
17216,2,[MTMRK]Chocman,2979,1014,39,34,73,53.4%,19m
17216,1,PepeSilva,2979,894,29,34,63,46.0%,16m
17216,2,ScholarsMate,2979,617,25,15,40,62.5%,19m
17216,3,[NutsR]Khopax,2979,314,14,9,23,60.9%,25m
17216,1,Voice,2979,330,10,12,22,45.5%,32m
17216,1,klamberry,2979,210,8,7,15,53.3%,5m
17216,2,[Xpk]kairos,2979,186,7,5,12,58.3%,30m
17216,2,YeeeeOuO,2979,216,6,4,10,60.0%,14m
17216,2,Lestibournes,2979,0,3,2,5,60.0%,20m
17216,2,lloyd,2979,0,0,1,1,0.0%,39m
17216,3,Kaleius,2979,0,0,12,12,0.0%,25m
17232,3,Elax,2978,1530,208,204,412,50.5%,14m
17232,2,hostghöööt,2978,1499,85,68,153,55.6%,20m
17232,2,[XTCES]Vaioqoo,2978,1350,51,47,98,52.0%,37m
17232,1,Wylde,2978,1075,48,36,84,57.1%,5m
17232,1,Jorz,2978,283,39,37,76,51.3%,39m
17232,1,Mapaf,2978,894,36,31,67,53.7%,22m
17232,1,[Vithar]VAEVICTUSPR,2978,673,24,21,45,53.3%,18m
17232,1,Dye,2978,536,22,13,35,62.9%,10m
17232,3,SilverHawk,2978,160,9,5,14,64.3%,29m
17232,1,richardesu,2978,137,8,3,11,72.7%,18m
17232,2,Skerpie,2978,223,8,8,16,50.0%,38m
17232,1,xxxxxxxxxxxx,2978,264,8,11,19,42.1%,27m
17232,2,Vozzie,2978,161,7,2,9,77.8%,29m
17232,3,Nugg,2978,169,6,5,11,54.5%,2h
17232,3,IamBog,2978,120,6,9,15,40.0%,4m
17232,1,SixFir,2978,177,5,4,9,55.6%,16m
17232,3,dochex,2978,130,4,19,23,17.4%,44m
17232,3,GolDaniels,2978,122,3,1,4,75.0%,25m
17232,2,Flow,2978,0,1,0,1,100.0%,13m
17232,2,BrownCow,2978,0,1,2,3,33.3%,37m
17232,2,ShiftyPeachz,2978,0,0,1,1,0.0%,7m
17232,2,Manabu,2978,0,0,1,1,0.0%,7m
17232,2,Schiggy,2978,0,0,1,1,0.0%,10m
17232,1,Reckless,2978,0,0,3,3,0.0%,27m
17232,1,[GCs]Speshul,2978,0,0,3,3,0.0%,27m
17257,3,character,2977,1503,146,145,291,50.2%,14m
17257,2,ThatGuyy,2977,1190,60,52,112,53.6%,35m
17257,1,Hinekan,2977,1577,59,61,120,49.2%,21m
17257,3,herakles,2977,984,41,39,80,51.2%,33m
17257,2,IamRuss,2977,428,18,16,34,52.9%,34m
17257,2,Firechess,2977,390,15,8,23,65.2%,18m
17257,2,Hateme,2977,346,13,14,27,48.1%,29m
17257,1,mitchyu,2977,418,13,16,29,44.8%,14m
17257,1,Alyross,2977,352,12,17,29,41.4%,31m
17257,2,madao,2977,326,11,11,22,50.0%,31m
17257,2,[LBF]Hawkeye,2977,256,8,5,13,61.5%,25m
17257,2,saMe,2977,189,5,6,11,45.5%,58m
17257,2,BluRay,2977,202,5,9,14,35.7%,23m
17257,1,Kermy,2977,138,5,10,15,33.3%,20m
17257,1,[daI3]CatDaddy,2977,0,4,1,5,80.0%,36m
17257,1,TroudBâl,2977,0,2,3,5,40.0%,46m
17257,2,[BoNX]Andwhatnot,2977,64,2,5,7,28.6%,39m
17257,2,[NLTN]Icebrand,2977,30,1,1,2,50.0%,40m
17257,2,TrevorSeeth,2977,0,0,1,1,0.0%,35m
17257,2,[A225]Ecnunn,2977,0,0,1,1,0.0%,35m
17257,2,[YONIP]jamdizzle,2977,0,0,1,1,0.0%,30m
17278,1,[LOSCTM]Dolan,2976,1036,93,77,170,54.7%,27m
17278,3,TTT,2976,1567,92,78,170,54.1%,32m
17278,1,[Calx]Vortexxx,2976,975,72,72,144,50.0%,39m
17278,1,Xeronami,2976,1092,44,40,84,52.4%,8m
17278,2,[Bommmm]Pepitochan,2976,701,35,29,64,54.7%,44m
17278,1,EuraRa,2976,720,25,25,50,50.0%,22m
17278,2,[GsWCH]RRLithium,2976,450,17,10,27,63.0%,35m
17278,1,nuttysquirel,2976,428,17,16,33,51.5%,11m
17278,1,Oxyblackbird,2976,277,11,10,21,52.4%,59m
17278,1,[neuroW]Seperthar,2976,186,9,8,17,52.9%,30m
17278,1,[FBE]CorranHorn,2976,204,9,9,18,50.0%,12m
17278,2,Aesthetics,2976,184,8,6,14,57.1%,2h
17278,2,SpaceFarse,2976,204,8,7,15,53.3%,34m
17278,3,[GGZZ]Kallisti,2976,240,8,19,27,29.6%,16m
17278,2,Ponzu,2976,58,5,3,8,62.5%,35m
17278,1,xSPHxChill,2976,104,4,8,12,33.3%,17m
17278,1,Sorthe,2976,0,3,2,5,60.0%,12m
17278,2,[VINGAD]Detonador,2976,60,3,3,6,50.0%,13m
17278,2,SirFlea,2976,96,3,5,8,37.5%,36m
17278,2,[OR2016]ÉzioAlditore,2976,30,2,0,2,100.0%,10m
17278,2,trpvOne,2976,0,2,3,5,40.0%,22m
17278,2,JohnERicoJr,2976,0,2,3,5,40.0%,6m
17278,2,Spinoza,2976,0,1,0,1,100.0%,18m
17278,2,[FaseS]SAIKI,2976,0,1,1,2,50.0%,26m
17278,2,DKdandan,2976,0,0,1,1,0.0%,31m
17278,1,Swiserral,2976,0,0,2,2,0.0%,36m
17304,1,[Lpaz]XaviiH,2975,1541,80,64,144,55.6%,20m
17304,1,[NFRM]VeNoMkHeD,2975,1471,71,64,135,52.6%,14m
17304,1,Josu,2975,1527,60,55,115,52.2%,8m
17304,2,WickedWebby,2975,1303,58,47,105,55.2%,31m
17304,1,pistolon,2975,575,33,29,62,53.2%,18m
17304,2,[NZER0]Trogdar,2975,616,28,13,41,68.3%,13m
17304,2,Falco,2975,699,27,27,54,50.0%,25m
17304,1,Brooks,2975,776,25,27,52,48.1%,5m
17304,3,EagleKnight,2975,572,19,32,51,37.3%,35m
17304,2,TerrZo,2975,216,11,10,21,52.4%,19m
17304,2,[0kyun0]SpyShadow,2975,186,6,6,12,50.0%,35m
17304,1,UnicroN,2975,181,6,9,15,40.0%,20m
17304,2,Drep,2975,152,5,4,9,55.6%,8m
17304,1,Hammurabi,2975,93,5,9,14,35.7%,32m
17304,2,Obama,2975,86,3,1,4,75.0%,37m
17304,1,Zaktorra,2975,160,3,6,9,33.3%,20m
17304,2,[TAP1]Twistedmetal,2975,30,2,2,4,50.0%,12m
17304,2,KamratK,2975,0,1,0,1,100.0%,16m
17304,2,[MTMRK]kuckysour,2975,0,1,0,1,100.0%,4m
17304,1,[SlipZ]ALBAMAGUSH,2975,0,1,1,2,50.0%,36m
17304,2,DARBOLIS,2975,0,1,1,2,50.0%,33m
17304,2,AznAquaPanda,2975,0,1,1,2,50.0%,28m
17304,3,[PiGPan]MaruAmoriani,2975,0,1,4,5,20.0%,2h
17304,2,[CAT9]AKIRA,2975,0,0,1,1,0.0%,20m
17304,1,arcantoz,2975,0,0,4,4,0.0%,31m
17329,3,lostmarbles,2974,1482,168,160,328,51.2%,6m
17329,3,Hersheez,2974,1491,160,159,319,50.2%,39m
17329,1,Rubicon,2974,1534,130,135,265,49.1%,10m
17329,2,[CRBK]Vriel,2974,1577,103,77,180,57.2%,42m
17329,2,Scorpion,2974,1589,67,62,129,51.9%,27m
17329,1,MikeMin,2974,1369,57,40,97,58.8%,19m
17329,1,[BrknPp]DaCookie,2974,885,52,37,89,58.4%,28m
17329,1,Thezdin,2974,563,48,44,92,52.2%,28m
17329,1,LdsRevelaton,2974,1098,43,36,79,54.4%,11m
17329,3,mostal,2974,685,36,42,78,46.2%,26m
17329,1,SORROW,2974,958,35,38,73,47.9%,14m
17329,2,Kuroyuki,2974,670,25,24,49,51.0%,13m
17329,1,TaiMaiShu,2974,493,17,16,33,51.5%,20m
17329,2,[2JZ]Darkblade,2974,240,12,10,22,54.5%,37m
17329,1,Saitake,2974,378,11,13,24,45.8%,31m
17329,2,Xobot,2974,224,9,8,17,52.9%,41m
17329,1,SaucyNarwhal,2974,169,8,0,8,100.0%,2h
17329,2,[LHdH]EdEvans,2974,247,8,4,12,66.7%,9m
17329,2,Chipsy,2974,190,6,3,9,66.7%,19m
17329,2,[DKVELO]InsanityPK,2974,144,6,4,10,60.0%,18m
17329,1,Geolife,2974,122,5,3,8,62.5%,38m
17329,2,Sweetdice,2974,118,5,4,9,55.6%,25m
17329,1,LoliComunist,2974,144,4,3,7,57.1%,3h
17329,1,Riaz,2974,108,4,8,12,33.3%,19m
17329,2,DJDespawn,2974,58,3,1,4,75.0%,20m
17329,2,MutaLordX,2974,60,3,1,4,75.0%,16m
17329,1,Heviin,2974,0,3,2,5,60.0%,3h
17329,2,Jickars,2974,72,2,3,5,40.0%,41m
17329,1,[SDC12]PÉnaBOSTA,2974,0,2,4,6,33.3%,24m
17329,1,Interceptor,2974,32,2,5,7,28.6%,28m
17329,1,EpicMD,2974,36,1,6,7,14.3%,40m
17329,2,OnlyHuman,2974,0,0,1,1,0.0%,12m
17329,2,[SCboys]Coopernana,2974,0,0,1,1,0.0%,18m
17329,2,DRAGUN,2974,0,0,1,1,0.0%,5m
17363,1,Justicary,2973,1661,373,359,732,51.0%,36m
17363,1,Mino,2973,1489,222,214,436,50.9%,27m
17363,1,EvolutionZ,2973,914,187,169,356,52.5%,23m
17363,1,DackMack,2973,1638,162,163,325,49.8%,3m
17363,3,skillsboy,2973,1562,135,141,276,48.9%,41m
17363,1,Terminus,2973,1619,96,90,186,51.6%,18m
17363,1,Polvorita,2973,1593,74,48,122,60.7%,43m
17363,3,arawan,2973,841,74,90,164,45.1%,6m
17363,2,Broham,2973,631,57,39,96,59.4%,25m
17363,1,[NoSlep]PsyDefective,2973,937,43,40,83,51.8%,42m
17363,3,[Bee]Drockster,2973,992,42,48,90,46.7%,18m
17363,2,IntoTheCloud,2973,654,34,28,62,54.8%,39m
17363,2,[vNc]BTSS,2973,188,9,5,14,64.3%,2h
17363,3,Zeplar,2973,36,5,4,9,55.6%,2h
17363,3,Mutation,2973,139,4,2,6,66.7%,11m
17363,2,[PaE]Earth,2973,122,4,5,9,44.4%,35m
17363,1,Sharky,2973,146,4,8,12,33.3%,12m
17363,2,Tekla,2973,0,3,2,5,60.0%,16m
17363,1,Charliebug,2973,97,2,0,2,100.0%,2h
17363,2,[Lepraa]PersaMaldito,2973,34,2,1,3,66.7%,35m
17363,3,Stemm,2973,0,2,2,4,50.0%,39m
17363,1,Demael,2973,34,1,5,6,16.7%,14m
17363,1,Grape,2973,0,0,4,4,0.0%,43m
17386,1,chemical,2972,1567,138,113,251,55.0%,8m
17386,1,[TuTuxC]MiT,2972,1018,137,127,264,51.9%,27m
17386,1,Peter,2972,1080,43,49,92,46.7%,10m
17386,2,[Flar3s]MaximuS,2972,785,38,23,61,62.3%,42m
17386,1,[NPhasA]alex,2972,700,22,30,52,42.3%,11m
17386,2,[FoxBR]ZéRuela,2972,494,18,12,30,60.0%,13m
17386,2,Multen,2972,418,16,14,30,53.3%,40m
17386,1,[RaR]RadiantCross,2972,321,11,12,23,47.8%,10m
17386,2,[iMpB]Armarus,2972,207,10,4,14,71.4%,30m
17386,1,Zinehsheneh,2972,306,10,15,25,40.0%,31m
17386,2,MadMahler,2972,210,7,10,17,41.2%,13m
17386,2,SKYHIGH,2972,0,5,6,11,45.5%,34m
17386,3,wArbEAst,2972,152,5,18,23,21.7%,31m
17386,2,[Raytar]Everett,2972,90,4,3,7,57.1%,13m
17386,1,Tyliusson,2972,0,3,2,5,60.0%,2h
17386,1,nezash,2972,0,3,2,5,60.0%,19m
17386,2,RhymeMime,2972,88,3,4,7,42.9%,15m
17386,2,Nochest,2972,30,2,0,2,100.0%,7m
17386,1,[TPI]GuiLermeTell,2972,88,2,2,4,50.0%,24m
17386,2,PabloTico,2972,30,2,2,4,50.0%,20m
17386,2,[CDW]Grecelis,2972,30,2,2,4,50.0%,7m
17386,1,[Viola]neotheone,2972,0,2,3,5,40.0%,35m
17386,2,Nilithel,2972,64,2,4,6,33.3%,23m
17386,2,StarLight,2972,0,1,0,1,100.0%,34m
17386,2,AgentHippo,2972,0,1,0,1,100.0%,7m
17386,2,Randy,2972,0,0,1,1,0.0%,7m
17386,2,Dugiker,2972,0,0,1,1,0.0%,34m
17386,1,[7C]Steve,2972,0,0,7,7,0.0%,20m
17414,3,[500CC]PedPedTV,2971,1580,75,88,163,46.0%,28m
17414,2,ThatGuy,2971,864,54,40,94,57.4%,9m
17414,1,[KBH]Parrywinkle,2971,588,19,21,40,47.5%,15m
17414,1,DonaldTrump,2971,510,18,18,36,50.0%,24m
17414,1,MixedNuts,2971,408,15,12,27,55.6%,21m
17414,2,HumbleCat,2971,321,13,11,24,54.2%,23m
17414,2,Indianadrone,2971,204,12,8,20,60.0%,31m
17414,2,[LGNxx]RobStark,2971,194,6,9,15,40.0%,29m
17414,2,Reno,2971,60,4,3,7,57.1%,24m
17414,2,[LTK]Medix,2971,62,3,1,4,75.0%,37m
17414,2,HIHIHI,2971,0,3,2,5,60.0%,16m
17414,2,Choukaki,2971,90,3,3,6,50.0%,7m
17414,2,Gladiator,2971,117,3,5,8,37.5%,42m
17414,2,Faesroll,2971,0,1,0,1,100.0%,3m
17414,2,[SsaYnS]mrflamingo,2971,0,1,0,1,100.0%,47m
17414,2,PRiestC,2971,95,1,1,2,50.0%,39m
17414,2,OriginalNerd,2971,30,1,1,2,50.0%,34m
17414,2,groverian,2971,0,0,1,1,0.0%,14m
17414,2,Pfelgar,2971,0,0,1,1,0.0%,4m
17414,2,elwell,2971,0,0,1,1,0.0%,35m
17414,2,mike,2971,0,0,1,1,0.0%,29m
17414,2,[ripusa]monkeylard,2971,0,0,2,2,0.0%,25m
17414,2,[PwT]DougSa,2971,0,0,3,3,0.0%,29m
17414,3,Bassell,2971,0,0,3,3,0.0%,18m
17438,2,ATtheROOT,2970,1553,67,65,132,50.8%,43m
17438,2,MaximIQ,2970,305,28,14,42,66.7%,9m
17438,2,thatlettuce,2970,578,26,16,42,61.9%,18m
17438,2,CurseOfLono,2970,456,21,15,36,58.3%,35m
17438,1,[XpKAc]BulucChabtan,2970,413,18,14,32,56.2%,12m
17438,1,ParAruia,2970,393,15,17,32,46.9%,11m
17438,1,ANIZCKN,2970,299,13,8,21,61.9%,8m
17438,1,Zeya,2970,212,8,9,17,47.1%,5m
17438,3,Limitless,2970,155,6,19,25,24.0%,17m
17438,2,oops,2970,142,5,4,9,55.6%,42m
17438,2,[PoBS]Zarutheus,2970,146,5,8,13,38.5%,18m
17438,2,[USplan]Delicious,2970,136,4,0,4,100.0%,41m
17438,1,[MNR75]mrmetal,2970,110,4,6,10,40.0%,10m
17438,2,SCVREADYTOGO,2970,0,3,2,5,60.0%,19m
17438,1,NastyNoor,2970,112,3,10,13,23.1%,40m
17438,1,sincerebnana,2970,36,2,4,6,33.3%,31m
17438,2,[NrdB]Benvincible,2970,0,1,0,1,100.0%,10m
17438,2,[Light1]ToastyGaming,2970,0,1,0,1,100.0%,32m
17438,2,llllllllllll,2970,0,1,0,1,100.0%,42m
17438,2,Psychopomp,2970,30,1,3,4,25.0%,29m
17438,2,[LOOPY]ThexbigxJ,2970,0,1,4,5,20.0%,42m
17438,2,[GC2042]Tank,2970,0,0,1,1,0.0%,29m
17460,3,bigtime,2969,1604,477,461,938,50.9%,41m
17460,2,Fishyjam,2969,1512,111,90,201,55.2%,15m
17460,1,DEathkNIghtS,2969,895,100,91,191,52.4%,31m
17460,2,[TGosuB]DeadDumble,2969,1613,67,64,131,51.1%,23m
17460,1,[Waggie]Zrouth,2969,1282,50,48,98,51.0%,26m
17460,1,Hakuho,2969,1024,43,33,76,56.6%,12m
17460,2,PinkFlicker,2969,825,41,15,56,73.2%,37m
17460,3,EggR,2969,825,38,44,82,46.3%,23m
17460,1,HURM,2969,513,34,27,61,55.7%,32m
17460,1,Peej,2969,585,19,19,38,50.0%,38m
17460,2,Grimfaith,2969,209,12,7,19,63.2%,5m
17460,2,Mineralthief,2969,282,11,10,21,52.4%,4m
17460,1,Garnett,2969,222,8,8,16,50.0%,26m
17460,2,[CMBP]ZackalJackal,2969,146,6,4,10,60.0%,26m
17460,3,Min,2969,188,6,15,21,28.6%,6m
17460,2,Erotes,2969,129,4,0,4,100.0%,38m
17460,1,[StheW]Moon,2969,159,3,6,9,33.3%,20m
17460,2,[syKer]Banzai,2969,58,2,1,3,66.7%,7m
17460,3,Bland,2969,121,2,3,5,40.0%,41m
17460,3,HowlandReed,2969,30,1,11,12,8.3%,28m
17460,2,[JUIN]avp,2969,0,0,1,1,0.0%,18m
17481,1,[DeltaC]Jondarawr,2968,1666,217,217,434,50.0%,17m
17481,2,mizFku,2968,1508,173,185,358,48.3%,8m
17481,3,ickyDoody,2968,213,143,143,286,50.0%,31m
17481,1,[DXPCA]FMCBotGamer,2968,1529,137,134,271,50.6%,20m
17481,1,Duckworth,2968,1676,136,110,246,55.3%,26m
17481,1,FlJoe,2968,833,71,57,128,55.5%,16m
17481,2,YinYang,2968,577,51,35,86,59.3%,43m
17481,1,[clanSD]HorsePower,2968,815,30,27,57,52.6%,19m
17481,2,xgooberx,2968,169,22,52,74,29.7%,25m
17481,1,TheChillyMan,2968,577,20,20,40,50.0%,28m
17481,2,Gaia,2968,494,18,16,34,52.9%,37m
17481,2,Teutonic,2968,267,12,5,17,70.6%,4m
17481,1,honk,2968,275,10,8,18,55.6%,18m
17481,3,memhooz,2968,204,8,13,21,38.1%,28m
17481,2,Rokkahn,2968,204,7,9,16,43.8%,3m
17481,2,Goom,2968,42,5,5,10,50.0%,2h
17481,1,Humongous,2968,88,4,3,7,57.1%,12m
17481,2,oJo,2968,57,3,2,5,60.0%,13m
17481,1,ZeQuRo,2968,78,3,5,8,37.5%,9m
17481,2,Pezcore,2968,93,2,0,2,100.0%,15m
17481,2,[DivIGR]MRAWESOMEIGR,2968,0,1,0,1,100.0%,18m
17481,2,TheSickness,2968,0,1,0,1,100.0%,29m
17481,2,[BaT]Thyralas,2968,0,1,2,3,33.3%,36m
17481,1,ForReal,2968,0,0,3,3,0.0%,26m
17505,1,Rookie,2967,1437,111,89,200,55.5%,9m
17505,1,[MNSc2]ATC,2967,1620,77,78,155,49.7%,43m
17505,1,[BANZ]Kinufix,2967,1651,76,74,150,50.7%,20m
17505,1,StreetFIend,2967,1166,43,41,84,51.2%,30m
17505,1,Ariel,2967,885,31,31,62,50.0%,11m
17505,1,Doubleone,2967,464,27,17,44,61.4%,26m
17505,2,Corsair,2967,510,21,21,42,50.0%,29m
17505,1,Slayer,2967,597,18,25,43,41.9%,10m
17505,2,MajinCroix,2967,390,15,8,23,65.2%,12m
17505,3,[LAFFY]LXZ,2967,232,11,14,25,44.0%,17m
17505,2,[LowIQ]GetSmacked,2967,264,10,4,14,71.4%,13m
17505,3,Caffeine,2967,177,8,2,10,80.0%,54m
17505,2,Raoul,2967,219,8,9,17,47.1%,31m
17505,2,Hex,2967,94,3,2,5,60.0%,29m
17505,2,Stormdancer,2967,148,3,4,7,42.9%,24m
17505,2,GerGly,2967,90,3,4,7,42.9%,31m
17505,2,[LPOCS]shadowleon,2967,34,2,0,2,100.0%,13m
17505,1,[BrEEd]Nightbreed,2967,44,2,4,6,33.3%,18m
17505,3,Kafu,2967,0,1,0,1,100.0%,1h
17505,2,Greatesgta,2967,0,1,1,2,50.0%,37m
17505,2,WarsKIng,2967,40,1,2,3,33.3%,39m
17505,1,[Iwagak]BabaYaga,2967,36,1,5,6,16.7%,28m
17505,2,dko,2967,0,0,1,1,0.0%,40m
17505,2,[Bee]holepercent,2967,0,0,1,1,0.0%,16m
17505,2,Balisongman,2967,0,0,2,2,0.0%,13m
17530,3,fallofpride,2966,1481,113,104,217,52.1%,12m
17530,2,Pipaldo,2966,1241,65,52,117,55.6%,36m
17530,3,dtmseventen,2966,822,65,71,136,47.8%,10m
17530,1,Tovarish,2966,879,59,50,109,54.1%,26m
17530,1,llllllllllll,2966,1387,56,61,117,47.9%,36m
17530,2,brogrimfall,2966,705,35,22,57,61.4%,9m
17530,1,[hKs]Jinxx,2966,376,32,30,62,51.6%,42m
17530,1,XxDurielxX,2966,780,25,30,55,45.5%,15m
17530,2,heeyupchung,2966,351,18,11,29,62.1%,29m
17530,1,PenRose,2966,349,13,9,22,59.1%,27m
17530,1,[JBiden]Ogremonger,2966,256,11,8,19,57.9%,29m
17530,2,[PvZm]Dekaron,2966,266,11,8,19,57.9%,33m
17530,1,[NMPro]Megatron,2966,302,10,11,21,47.6%,18m
17530,1,KiRa,2966,280,9,12,21,42.9%,15m
17530,1,TheCodFather,2966,304,9,13,22,40.9%,15m
17530,2,[FLGGN]highcommandr,2966,180,7,3,10,70.0%,36m
17530,1,Aclik,2966,140,6,5,11,54.5%,38m
17530,2,IIIllllllIII,2966,119,5,3,8,62.5%,4m
17530,1,IIInnovation,2966,160,5,8,13,38.5%,38m
17530,1,niggesaurus,2966,0,4,1,5,80.0%,16m
17530,3,IIIIIIIIIIII,2966,97,4,3,7,57.1%,55m
17530,2,KiL,2966,128,4,5,9,44.4%,9m
17530,1,[tehbut]Voketo,2966,162,4,9,13,30.8%,11m
17530,2,xPurpleReign,2966,0,3,2,5,60.0%,30m
17530,1,Zeratul,2966,0,3,2,5,60.0%,21m
17530,1,Banana,2966,0,3,3,6,50.0%,2h
17530,1,[MOMRF]flamingcheto,2966,0,2,5,7,28.6%,12m
17530,2,[VoF]ZealotRQ,2966,30,2,5,7,28.6%,7m
17530,2,[CLEM]Soul,2966,0,1,0,1,100.0%,4m
17530,2,Omnibus,2966,92,1,1,2,50.0%,58m
17530,2,coorsllte,2966,30,1,1,2,50.0%,41m
17530,2,Nicomant,2966,30,1,2,3,33.3%,13m
17530,2,[DugNut]PrisonMike,2966,34,1,2,3,33.3%,37m
17530,2,ZebraZ,2966,0,0,1,1,0.0%,33m
17530,2,[lLiTl]Paco,2966,0,0,1,1,0.0%,18m
17530,2,aldezerg,2966,0,0,2,2,0.0%,32m
17530,2,Kirito,2966,0,0,3,3,0.0%,37m
17567,1,lamborghini,2965,1606,211,197,408,51.7%,37m
17567,3,Nemesis,2965,1503,119,122,241,49.4%,15m
17567,3,Clue,2965,1477,87,87,174,50.0%,5m
17567,1,Protege,2965,499,62,42,104,59.6%,5m
17567,2,Violentllama,2965,1101,53,30,83,63.9%,10m
17567,3,LandSquirrel,2965,1216,44,48,92,47.8%,4m
17567,3,[D4KSDE]Mauri,2965,1106,42,51,93,45.2%,35m
17567,2,WGFURY,2965,625,41,27,68,60.3%,33m
17567,2,[PooNys]Chuncocoo,2965,845,36,28,64,56.2%,35m
17567,2,Arcane,2965,421,20,15,35,57.1%,25m
17567,1,TheKingMelon,2965,465,20,15,35,57.1%,18m
17567,2,rogueNightV,2965,142,20,21,41,48.8%,35m
17567,2,SkullCrater,2965,247,10,6,16,62.5%,35m
17567,2,sCiNmD,2965,0,4,1,5,80.0%,16m
17567,1,IIIIIIIIIIII,2965,0,4,1,5,80.0%,2h
17567,2,[Cind3r]SenpaiDom,2965,112,3,0,3,100.0%,42m
17567,2,Moenghus,2965,0,1,0,1,100.0%,18m
17567,2,misterpipol,2965,0,1,1,2,50.0%,5m
17567,2,[SLAX]Demonshadow,2965,0,0,1,1,0.0%,34m
17567,2,SleeperAgent,2965,0,0,1,1,0.0%,13m
17567,2,LICERAS,2965,0,0,1,1,0.0%,36m
17567,1,[LTWAR]krazykid,2965,0,0,1,1,0.0%,6m
17567,2,Blood,2965,0,0,1,1,0.0%,5m
17567,2,Neow,2965,0,0,2,2,0.0%,36m
17567,1,WhalterWhite,2965,0,0,3,3,0.0%,2h
17567,1,Komodo,2965,0,0,4,4,0.0%,10m
17567,1,[Paus3d]GrundleLickr,2965,0,0,7,7,0.0%,20m
17594,1,[SIClan]bushido,2964,1016,36,43,79,45.6%,15m
17594,2,[ZUCCED]TheBrownOne,2964,617,24,18,42,57.1%,26m
17594,2,YLsIntoTanks,2964,520,23,8,31,74.2%,13m
17594,2,pulse,2964,508,23,9,32,71.9%,36m
17594,2,aps,2964,411,19,14,33,57.6%,44m
17594,1,[MoSun]YellowLarva,2964,507,17,24,41,41.5%,16m
17594,1,[wejuoy]xXtheCreedXx,2964,385,16,12,28,57.1%,3m
17594,2,[GDTS]Plasmius,2964,412,15,9,24,62.5%,36m
17594,2,IIIIIIIIIIII,2964,298,12,6,18,66.7%,2h
17594,2,bEkAchI,2964,348,11,8,19,57.9%,40m
17594,1,Maverik,2964,270,11,17,28,39.3%,28m
17594,2,FezWhatley,2964,218,9,5,14,64.3%,34m
17594,2,Newb,2964,196,8,5,13,61.5%,41m
17594,1,Nicee,2964,282,8,13,21,38.1%,11m
17594,2,[RwtM]Machaube,2964,164,5,0,5,100.0%,26m
17594,2,[icekin]greghatch,2964,90,4,1,5,80.0%,40m
17594,1,[Bullys]AWorryRock,2964,94,3,6,9,33.3%,2h
17594,2,CAPA,2964,30,2,1,3,66.7%,42m
17594,1,dogdickdaddy,2964,114,2,2,4,50.0%,2h
17594,1,[Snarty]SnartHero,2964,80,2,7,9,22.2%,12m
17594,1,[HEZUS]DietProtoss,2964,0,1,1,2,50.0%,21m
17594,2,Chocodog,2964,0,1,2,3,33.3%,10m
17594,3,phloX,2964,0,1,2,3,33.3%,26m
17594,1,Krombopolous,2964,0,0,2,2,0.0%,23m
17594,2,Oreos,2964,0,0,3,3,0.0%,29m
17619,1,Soultraverse,2963,1550,152,142,294,51.7%,8m
17619,3,[sk3tch]theman,2963,1517,112,115,227,49.3%,11m
17619,3,Jaedonq,2963,1530,111,114,225,49.3%,8m
17619,1,chaosphere,2963,1559,80,71,151,53.0%,35m
17619,2,loosecannon,2963,765,35,39,74,47.3%,36m
17619,2,IlIlIlIlIlIl,2963,697,30,20,50,60.0%,23m
17619,1,TheGC,2963,770,28,27,55,50.9%,28m
17619,1,Fenix,2963,503,22,18,40,55.0%,38m
17619,2,ZeroBlade,2963,436,16,15,31,51.6%,36m
17619,1,donefor,2963,259,10,9,19,52.6%,3h
17619,2,[HatOWO]Fennecfox,2963,144,6,6,12,50.0%,13m
17619,1,Kami,2963,206,5,4,9,55.6%,31m
17619,1,MEFQSQ,2963,96,5,4,9,55.6%,24m
17619,2,linow,2963,88,4,3,7,57.1%,23m
17619,3,[Pharoh]JoMaC,2963,127,4,3,7,57.1%,2h
17619,1,juanan,2963,143,4,6,10,40.0%,39m
17619,1,StrkeTotem,2963,0,3,2,5,60.0%,26m
17619,2,CUBANICHI,2963,0,3,2,5,60.0%,43m
17619,1,[FxB]Wabbits,2963,119,3,6,9,33.3%,42m
17619,1,Stasiser,2963,122,3,8,11,27.3%,5m
17619,2,Venks,2963,0,1,0,1,100.0%,41m
17619,2,pumba,2963,0,1,0,1,100.0%,15m
17619,2,kvothee,2963,0,1,0,1,100.0%,25m
17619,1,[LOLASO]hansiro,2963,94,1,1,2,50.0%,2h
17619,2,OkraArmband,2963,30,1,4,5,20.0%,23m
17619,2,[ARKR]MilanesaNapo,2963,0,0,3,3,0.0%,34m
17645,3,Rust,2962,1539,278,262,540,51.5%,40m
17645,1,[Ichnac]Fideox,2962,1587,174,157,331,52.6%,40m
17645,1,[Apan]gspike,2962,1612,150,152,302,49.7%,32m
17645,1,PandaNinja,2962,1395,112,89,201,55.7%,24m
17645,2,[Gooons]lumberjack,2962,1580,101,78,179,56.4%,20m
17645,3,[BooKng]FeliX,2962,554,90,89,179,50.3%,31m
17645,2,DarkRaven,2962,1273,58,34,92,63.0%,38m
17645,1,[nieBla]JacksonFive,2962,1394,57,58,115,49.6%,17m
17645,2,Zergling,2962,759,36,20,56,64.3%,34m
17645,2,[Ba1t]ranger,2962,801,33,23,56,58.9%,37m
17645,1,greatzebu,2962,210,30,27,57,52.6%,10m
17645,1,Downfall,2962,510,22,22,44,50.0%,21m
17645,1,komugi,2962,615,21,20,41,51.2%,26m
17645,1,ZergRush,2962,636,21,23,44,47.7%,18m
17645,1,Raul,2962,548,17,23,40,42.5%,17m
17645,3,BasketballQC,2962,146,5,4,9,55.6%,1h
17645,2,Eckart,2962,90,4,3,7,57.1%,38m
17645,2,LingLingBlng,2962,118,4,5,9,44.4%,31m
17645,1,[DhZAc1]sterbs,2962,120,4,9,13,30.8%,10m
17645,2,Nosneb,2962,30,2,0,2,100.0%,39m
17645,2,Wisp,2962,60,2,1,3,66.7%,31m
17645,3,Nalisha,2962,97,2,1,3,66.7%,6m
17645,2,[OndaVT]Jorm,2962,60,2,3,5,40.0%,14m
17645,2,Kardell,2962,0,1,0,1,100.0%,14m
17645,2,Crepuscular,2962,36,1,1,2,50.0%,44m
17645,2,[TGCrew]MoTea,2962,0,1,1,2,50.0%,8m
17645,2,FapOnLoli,2962,0,1,1,2,50.0%,60m
17645,3,Quantum,2962,96,1,2,3,33.3%,9m
17645,2,Slaughma,2962,34,1,4,5,20.0%,28m
17645,2,[lefuk]LePeq,2962,0,0,1,1,0.0%,13m
17645,2,Dusk,2962,0,0,3,3,0.0%,19m
17676,3,[TWTV]Autopsee,2961,1617,337,310,647,52.1%,24m
17676,3,Sam,2961,1312,127,146,273,46.5%,43m
17676,2,ImaDiffBreed,2961,516,28,24,52,53.8%,31m
17676,1,lennytheboi,2961,669,26,24,50,52.0%,9m
17676,2,FarmingNoob,2961,358,12,9,21,57.1%,25m
17676,2,[HJSDS]Danielx,2961,290,11,5,16,68.8%,38m
17676,2,Vempyre,2961,264,9,11,20,45.0%,39m
17676,2,[FGMP]KILLBOT,2961,204,7,3,10,70.0%,23m
17676,3,[FCFT]Moraes,2961,159,6,1,7,85.7%,33m
17676,2,[Mc]Fenrir,2961,64,2,3,5,40.0%,12m
17676,1,[DarkAG]Prometheus,2961,64,2,6,8,25.0%,10m
17676,2,SCghost,2961,0,1,0,1,100.0%,21m
17676,2,Frosty,2961,0,1,0,1,100.0%,40m
17676,2,[NVFV]RConflict,2961,0,1,1,2,50.0%,29m
17676,3,Colonel,2961,40,1,1,2,50.0%,3h
17676,2,MeatDealer,2961,30,1,2,3,33.3%,40m
17676,2,Inguichess,2961,0,0,1,1,0.0%,30m
17676,1,[Sune]yermi,2961,0,0,1,1,0.0%,3m
17676,2,Sazor,2961,0,0,2,2,0.0%,33m
17676,1,Rimctto,2961,0,0,4,4,0.0%,28m
17676,1,Relayer,2961,0,0,5,5,0.0%,24m
17697,2,Helpme,2960,1468,133,115,248,53.6%,23m
17697,2,[ETSs]MrFercho,2960,1533,74,62,136,54.4%,15m
17697,2,Niru,2960,1289,70,31,101,69.3%,34m
17697,2,[ExcIgN]sebastis,2960,684,30,16,46,65.2%,7m
17697,2,[KofW]TheSandman,2960,705,27,25,52,51.9%,35m
17697,2,[SU4C]mmm,2960,610,25,16,41,61.0%,23m
17697,1,[detres]minyaron,2960,550,22,21,43,51.2%,8m
17697,1,[FAOS]Alewizard,2960,389,21,23,44,47.7%,12m
17697,3,buggang,2960,296,15,10,25,60.0%,36m
17697,1,Kalrock,2960,318,12,12,24,50.0%,34m
17697,2,Novorosi,2960,344,11,12,23,47.8%,16m
17697,2,meshuggah,2960,249,10,7,17,58.8%,13m
17697,1,powpow,2960,281,7,14,21,33.3%,21m
17697,2,JegenjaN,2960,102,5,2,7,71.4%,23m
17697,1,Starmungo,2960,110,4,7,11,36.4%,10m
17697,2,Archer,2960,0,3,2,5,60.0%,38m
17697,2,moe,2960,30,2,2,4,50.0%,30m
17697,2,Edu,2960,0,1,0,1,100.0%,37m
17697,2,Sendies,2960,0,1,0,1,100.0%,37m
17697,2,[XxWoot]holyknight,2960,95,1,4,5,20.0%,37m
17697,2,Breem,2960,34,1,5,6,16.7%,10m
17697,2,[REPORT]Fearless,2960,0,0,1,1,0.0%,9m
17697,2,Kurrupted,2960,0,0,1,1,0.0%,34m
17720,1,HeltrSkeltr,2959,1311,107,103,210,51.0%,18m
17720,3,TriadRipper,2959,800,52,60,112,46.4%,6m
17720,2,ElevenTimes,2959,1224,48,43,91,52.7%,37m
17720,2,[Titti]CodeScreds,2959,998,42,37,79,53.2%,18m
17720,2,Nyphang,2959,655,29,10,39,74.4%,23m
17720,2,ONEmoreTIME,2959,389,16,10,26,61.5%,4m
17720,2,capslocking,2959,344,15,10,25,60.0%,21m
17720,2,dreambeing,2959,342,14,6,20,70.0%,41m
17720,1,[HEZUS]Boff,2959,240,12,6,18,66.7%,23m
17720,2,SuSy,2959,244,10,8,18,55.6%,23m
17720,2,HighDied,2959,228,9,7,16,56.2%,30m
17720,1,MorningWood,2959,253,8,4,12,66.7%,59m
17720,2,[MRHAND]GreenTea,2959,208,8,8,16,50.0%,26m
17720,2,llllllllllll,2959,228,7,4,11,63.6%,23m
17720,1,Honor,2959,148,5,2,7,71.4%,2h
17720,1,[OVPR]ztxthekiller,2959,0,4,1,5,80.0%,37m
17720,2,[NIntN]Crazysane,2959,0,3,2,5,60.0%,21m
17720,1,STeven,2959,0,2,3,5,40.0%,19m
17720,2,GosuGuru,2959,114,2,8,10,20.0%,47m
17720,1,pesy,2959,0,1,0,1,100.0%,2h
17720,2,Yertle,2959,30,1,1,2,50.0%,43m
17720,2,epicbanana,2959,0,1,2,3,33.3%,37m
17720,2,[NorCal]MasterChoi,2959,30,1,2,3,33.3%,38m
17720,2,HgMerK,2959,0,1,2,3,33.3%,13m
17720,2,[OPSC]mobius,2959,0,0,1,1,0.0%,4m
17720,2,[Puppey]ZRGInfection,2959,0,0,2,2,0.0%,31m
17720,2,Blksheepwall,2959,0,0,3,3,0.0%,38m
17747,1,NoJaDGreat,2958,1688,404,399,803,50.3%,8m
17747,3,[LETAL]Rasthak,2958,1317,83,86,169,49.1%,33m
17747,1,AbsoluteNoob,2958,1189,60,49,109,55.0%,38m
17747,1,[RH]DrG,2958,723,26,38,64,40.6%,28m
17747,2,Simon,2958,542,20,15,35,57.1%,19m
17747,1,StoneyBalony,2958,504,16,21,37,43.2%,12m
17747,1,xXENx,2958,278,8,13,21,38.1%,8m
17747,3,Synchro,2958,172,7,5,12,58.3%,3h
17747,2,Fatal,2958,0,3,2,5,60.0%,18m
17747,2,VaiS,2958,0,3,2,5,60.0%,24m
17747,2,eddyus,2958,0,3,2,5,60.0%,24m
17747,2,Elijah,2958,0,3,2,5,60.0%,31m
17747,2,[BUKÉ]Korax,2958,60,3,3,6,50.0%,43m
17747,2,ForRaisins,2958,128,3,6,9,33.3%,2h
17747,1,fulmicoton,2958,92,3,8,11,27.3%,8m
17747,1,Nala,2958,72,2,8,10,20.0%,24m
17747,2,[EoG]GateKeeper,2958,0,1,0,1,100.0%,43m
17747,2,Ruiner,2958,30,1,1,2,50.0%,34m
17747,3,Silverpoopoo,2958,0,1,1,2,50.0%,2h
17747,1,[DXPCA]Sebastian,2958,97,1,3,4,25.0%,28m
17747,2,[WOBERT]TBoyd,2958,0,0,2,2,0.0%,31m
17768,3,[EtrOy]Fonzy,2957,1562,271,272,543,49.9%,21m
17768,3,PorcoRei,2957,1296,68,62,130,52.3%,9m
17768,1,ArthurDent,2957,1532,68,64,132,51.5%,36m
17768,2,NEsmha,2957,645,65,59,124,52.4%,39m
17768,1,IWillRushU,2957,1353,50,51,101,49.5%,18m
17768,2,gudynator,2957,579,39,27,66,59.1%,23m
17768,1,Postikana,2957,460,18,19,37,48.6%,30m
17768,1,FireFall,2957,463,17,25,42,40.5%,43m
17768,2,[PugATK]locococo,2957,436,16,11,27,59.3%,18m
17768,3,FishAndChips,2957,349,15,8,23,65.2%,9m
17768,2,[LLSC2]EchoEchoEcho,2957,310,13,10,23,56.5%,42m
17768,1,WTF,2957,306,12,10,22,54.5%,2h
17768,1,jevons,2957,362,11,13,24,45.8%,23m
17768,2,[1Rine]konichiwa,2957,256,9,9,18,50.0%,7m
17768,3,Biane,2957,207,7,5,12,58.3%,2h
17768,2,Grox,2957,148,7,7,14,50.0%,23m
17768,2,MasterSquid,2957,193,7,9,16,43.8%,42m
17768,1,USCTerrapin,2957,140,4,4,8,50.0%,2h
17768,2,DadGumit,2957,124,4,5,9,44.4%,8m
17768,2,[SVLx]Sevela,2957,0,3,2,5,60.0%,12m
17768,1,Aboutblank,2957,0,3,2,5,60.0%,2h
17768,2,[TheRT]LaVeyan,2957,147,3,3,6,50.0%,14m
17768,3,[Klukun]Zacek,2957,97,2,3,5,40.0%,2h
17768,2,[CSK]Blakey,2957,0,1,0,1,100.0%,12m
17768,1,Forsaken,2957,40,1,3,4,25.0%,33m
17793,2,[SWOU]XxXFlashXxX,2956,1615,152,148,300,50.7%,8m
17793,3,ExinJealousy,2956,1253,119,121,240,49.6%,16m
17793,3,Krypts,2956,1558,117,113,230,50.9%,5m
17793,1,Xenomir,2956,923,100,80,180,55.6%,22m
17793,3,Megaman,2956,1464,98,111,209,46.9%,34m
17793,1,johannesLV,2956,1548,75,83,158,47.5%,24m
17793,1,Dutchy,2956,1144,71,68,139,51.1%,35m
17793,2,Spankk,2956,1164,67,45,112,59.8%,18m
17793,2,ghostsafari,2956,888,66,48,114,57.9%,26m
17793,2,[RSoBS]Ilich,2956,1462,66,69,135,48.9%,42m
17793,1,[BCO]Cypher,2956,1476,63,57,120,52.5%,26m
17793,3,[ZTemps]Staples,2956,749,63,76,139,45.3%,6m
17793,3,[Ch0nk]TofuSpoon,2956,960,62,67,129,48.1%,40m
17793,1,[63slas]Sivart,2956,877,44,43,87,50.6%,26m
17793,1,[Jok3r]Banksy,2956,959,36,32,68,52.9%,18m
17793,1,blandboss,2956,596,19,24,43,44.2%,30m
17793,1,trebyoyoyoyo,2956,492,16,22,38,42.1%,38m
17793,2,[JUIC3Y]Jango,2956,366,12,14,26,46.2%,16m
17793,3,jagpanther,2956,210,9,5,14,64.3%,2h
17793,2,BloodReaver,2956,266,9,6,15,60.0%,9m
17793,1,Txrroskiiy,2956,323,8,15,23,34.8%,32m
17793,1,NewHotKeys,2956,235,7,7,14,50.0%,36m
17793,2,Zeuhl,2956,208,7,8,15,46.7%,42m
17793,3,DebugCode,2956,120,6,5,11,54.5%,36m
17793,3,DanielShulla,2956,0,4,4,8,50.0%,16m
17793,2,AskMe,2956,0,3,2,5,60.0%,9m
17793,1,MurlocTenso,2956,48,3,3,6,50.0%,19m
17793,1,kimcheese,2956,158,3,6,9,33.3%,19m
17793,1,ZenZen,2956,97,2,0,2,100.0%,21m
17793,2,[cun7]Budmaster,2956,0,2,3,5,40.0%,26m
17793,1,[zeez]elegans,2956,32,2,7,9,22.2%,8m
17793,2,BondiolaKing,2956,0,1,0,1,100.0%,35m
17793,2,[SWRV]Kai,2956,0,1,0,1,100.0%,33m
17793,1,Ghostmus,2956,0,1,2,3,33.3%,6m
17793,2,[Frendz]Rebobert,2956,0,1,2,3,33.3%,4m
17793,2,WolfieRa,2956,0,1,2,3,33.3%,9m
17793,3,Masterchief,2956,0,0,1,1,0.0%,59m
17793,2,Chillaxing,2956,0,0,2,2,0.0%,26m
17793,2,LifeLinG,2956,0,0,2,2,0.0%,21m
17793,2,[2City]CYLON,2956,0,0,3,3,0.0%,23m
17793,2,tubUrOnZin,2956,0,0,3,3,0.0%,37m
17834,1,[PRT]Tavo,2955,1682,208,207,415,50.1%,41m
17834,1,[Canela]Phoenix,2955,748,48,31,79,60.8%,30m
17834,3,kirally,2955,734,48,45,93,51.6%,6m
17834,3,GrEaSeMuNkY,2955,567,44,36,80,55.0%,11m
17834,2,Zwingli,2955,885,35,28,63,55.6%,39m
17834,2,Bopmaster,2955,366,34,11,45,75.6%,13m
17834,2,PrevJames,2955,803,33,22,55,60.0%,29m
17834,1,MacroVsMicro,2955,807,33,27,60,55.0%,20m
17834,1,OVM,2955,252,10,14,24,41.7%,10m
17834,2,ZeroEX,2955,102,5,2,7,71.4%,28m
17834,2,Alsike,2955,174,5,2,7,71.4%,34m
17834,1,Davester,2955,130,5,6,11,45.5%,5m
17834,2,[KREAP]SwARM,2955,199,4,11,15,26.7%,43m
17834,3,guguizg,2955,121,3,6,9,33.3%,2h
17834,1,watdoink,2955,90,3,7,10,30.0%,22m
17834,3,[F00K]Modulus,2955,0,1,0,1,100.0%,47m
17834,2,zoochotic,2955,0,1,1,2,50.0%,31m
17834,2,manwithplan,2955,0,0,1,1,0.0%,37m
17834,3,ken,2955,0,0,1,1,0.0%,12m
17834,2,[GuN]HyDrO,2955,0,0,2,2,0.0%,31m
17854,3,Ronsterz,2954,1482,255,260,515,49.5%,39m
17854,2,CoronaSucks,2954,1617,117,91,208,56.2%,20m
17854,2,[BLZN]Omnivium,2954,841,85,72,157,54.1%,25m
17854,1,Sporkredfox,2954,1352,80,75,155,51.6%,5m
17854,1,dacker,2954,369,58,49,107,54.2%,10m
17854,1,[XWIS]FOodLiOn,2954,707,33,28,61,54.1%,24m
17854,3,Titus,2954,804,32,44,76,42.1%,31m
17854,1,[NLTN]FIVETHESWARM,2954,733,30,26,56,53.6%,41m
17854,1,[PiGPan]MonsterMash,2954,623,23,27,50,46.0%,8m
17854,1,[nwBEAR]bear,2954,714,23,29,52,44.2%,10m
17854,2,[Atoq]Meryiko,2954,496,17,20,37,45.9%,35m
17854,1,[F2AAA]coco,2954,296,15,11,26,57.7%,17m
17854,2,[LTlord]JUSTaGAME,2954,366,14,10,24,58.3%,21m
17854,2,[Chummp]DALEG,2954,245,13,12,25,52.0%,5m
17854,2,[Lp]rayo,2954,222,8,2,10,80.0%,39m
17854,1,Injection,2954,276,8,13,21,38.1%,10m
17854,2,NRF,2954,140,6,4,10,60.0%,42m
17854,1,Shahra,2954,101,4,4,8,50.0%,38m
17854,1,Tommed,2954,119,3,2,5,60.0%,26m
17854,1,[HPOT]blood,2954,116,3,2,5,60.0%,19m
17854,2,Talisker,2954,112,3,4,7,42.9%,21m
17854,2,[Emb3rs]Mania,2954,64,2,2,4,50.0%,12m
17854,2,xdlgxtrgop,2954,30,2,2,4,50.0%,29m
17854,2,Dingles,2954,62,2,4,6,33.3%,35m
17854,1,MaRaS,2954,36,2,8,10,20.0%,5m
17854,2,[ConFed]DARKBLOOD,2954,30,1,1,2,50.0%,36m
17854,2,[SGA]AsymtotiqueC,2954,0,0,1,1,0.0%,40m
17854,2,Vagabondyjx,2954,0,0,1,1,0.0%,23m
17854,2,DNO,2954,0,0,2,2,0.0%,41m
17883,1,ronin,2953,1016,184,183,367,50.1%,16m
17883,1,Decay,2953,1327,74,59,133,55.6%,10m
17883,2,[ACSS]Petrocules,2953,734,41,38,79,51.9%,4m
17883,2,Pogipinoy,2953,663,26,21,47,55.3%,4m
17883,1,[ITCx]rixenz,2953,680,21,31,52,40.4%,26m
17883,3,Gkterp,2953,592,19,33,52,36.5%,17m
17883,2,Trevor,2953,391,15,13,28,53.6%,25m
17883,2,Anonymous,2953,338,13,7,20,65.0%,34m
17883,2,Scatsby,2953,300,11,6,17,64.7%,37m
17883,2,[AlIin]wocks,2953,240,8,11,19,42.1%,14m
17883,2,[Wehavu]Frizzle,2953,172,6,5,11,54.5%,31m
17883,1,FarmerJon,2953,190,6,6,12,50.0%,26m
17883,1,Maeata,2953,134,4,3,7,57.1%,21m
17883,2,[LOOPY]Scheyla,2953,120,4,5,9,44.4%,34m
17883,2,Kera,2953,0,3,2,5,60.0%,24m
17883,2,TheGame,2953,132,3,3,6,50.0%,23m
17883,2,Slicy,2953,62,2,5,7,28.6%,43m
17883,1,DamonYu,2953,118,2,6,8,25.0%,21m
17883,1,ImPrettyOP,2953,70,2,9,11,18.2%,32m
17883,2,macro,2953,0,1,0,1,100.0%,39m
17883,3,[Forsa]claudg,2953,94,1,1,2,50.0%,31m
17883,2,Uppercut,2953,30,1,2,3,33.3%,21m
17883,2,MojoJoGio,2953,0,0,1,1,0.0%,41m
17883,2,greenVomit,2953,0,0,3,3,0.0%,40m
17907,1,doomsday,2952,1474,168,158,326,51.5%,10m
17907,3,Kataoka,2952,1236,83,82,165,50.3%,39m
17907,2,SwankThetos,2952,930,34,36,70,48.6%,43m
17907,1,Syyrup,2952,791,29,32,61,47.5%,29m
17907,3,[Lp]Anonimo,2952,593,23,28,51,45.1%,29m
17907,1,[RONM]Dexter,2952,530,19,17,36,52.8%,15m
17907,3,Gurgel,2952,474,16,29,45,35.6%,37m
17907,2,MaSaCRe,2952,344,13,9,22,59.1%,43m
17907,1,[ZAVC]Echo,2952,277,13,14,27,48.1%,20m
17907,2,Boomboom,2952,169,8,5,13,61.5%,42m
17907,2,Captainsalt,2952,170,7,3,10,70.0%,29m
17907,2,Dagan,2952,174,6,6,12,50.0%,42m
17907,1,chevypride,2952,78,5,6,11,45.5%,37m
17907,3,michealean,2952,146,5,6,11,45.5%,53m
17907,1,XYZ,2952,141,4,0,4,100.0%,47m
17907,2,daxolesa,2952,88,4,2,6,66.7%,42m
17907,2,Sedlackian,2952,88,4,3,7,57.1%,34m
17907,2,[CNAKER]boccy,2952,30,1,1,2,50.0%,39m
17907,2,Jeff,2952,30,1,2,3,33.3%,14m
17907,1,LionS,2952,89,1,3,4,25.0%,36m
17907,2,[oNEAL]MaDXecocide,2952,0,0,1,1,0.0%,13m
17907,2,Nooby,2952,0,0,2,2,0.0%,15m
17929,2,[STARBP]Firebird,2951,393,65,59,124,52.4%,35m
17929,1,AngelCaido,2951,912,62,59,121,51.2%,36m
17929,1,Kami,2951,586,60,56,116,51.7%,29m
17929,2,Surreal,2951,1208,55,43,98,56.1%,28m
17929,2,MugrosoCarl,2951,955,43,26,69,62.3%,28m
17929,1,[RONPAP]Kief,2951,348,36,32,68,52.9%,38m
17929,2,axis,2951,794,29,29,58,50.0%,31m
17929,1,[KiMBR]Leonardo,2951,717,28,21,49,57.1%,24m
17929,1,mindgames,2951,820,28,31,59,47.5%,39m
17929,2,[Th3Bad]ralphwbms,2951,574,24,19,43,55.8%,41m
17929,2,MCnookies,2951,577,23,14,37,62.2%,36m
17929,1,[LUSK]Skeetz,2951,475,14,23,37,37.8%,12m
17929,1,[Lp]Iniwalker,2951,315,12,9,21,57.1%,26m
17929,1,Lando,2951,248,7,10,17,41.2%,18m
17929,3,RedSteel,2951,187,7,11,18,38.9%,37m
17929,1,[hoKST]Yaguz,2951,254,6,10,16,37.5%,31m
17929,1,ChefRojo,2951,148,5,9,14,35.7%,5m
17929,3,CSEddieEdit,2951,44,4,6,10,40.0%,43m
17929,2,[TheDOH]hersh,2951,90,3,4,7,42.9%,44m
17929,2,TaskForce,2951,30,2,0,2,100.0%,13m
17929,1,SherifofAiur,2951,48,2,0,2,100.0%,1h
17929,2,Bonerz,2951,58,2,2,4,50.0%,16m
17929,2,Mango,2951,30,2,2,4,50.0%,10m
17929,2,xiboloxd,2951,66,2,2,4,50.0%,37m
17929,2,SuperShreddr,2951,119,2,4,6,33.3%,29m
17929,2,aeggin,2951,0,1,0,1,100.0%,42m
17955,1,IImmortal,2950,1678,423,407,830,51.0%,18m
17955,2,[SARGÇ]Dagur,2950,1595,229,205,434,52.8%,36m
17955,1,DonutEater,2950,1530,136,120,256,53.1%,42m
17955,1,Kaori,2950,778,115,67,182,63.2%,24m
17955,2,PeteNice,2950,1371,60,46,106,56.6%,21m
17955,1,Moskito,2950,1053,52,50,102,51.0%,26m
17955,2,Fellows,2950,674,27,24,51,52.9%,15m
17955,2,Malicious,2950,672,26,23,49,53.1%,31m
17955,2,Bandit,2950,569,25,17,42,59.5%,16m
17955,2,[FuTD]Mouse,2950,424,19,10,29,65.5%,26m
17955,3,[cl0udM]jjoolo,2950,522,18,25,43,41.9%,40m
17955,2,[AKUNDE]sasori,2950,334,13,6,19,68.4%,23m
17955,3,[GRBP]bkao,2950,329,12,23,35,34.3%,28m
17955,2,Spoon,2950,280,11,7,18,61.1%,29m
17955,1,AJugOrNot,2950,384,11,16,27,40.7%,5m
17955,3,supertulon,2950,199,8,3,11,72.7%,27m
17955,2,Dibzter,2950,210,8,8,16,50.0%,37m
17955,2,UnxplndBacon,2950,135,6,4,10,60.0%,23m
17955,1,[90RN]Hess,2950,218,6,13,19,31.6%,29m
17955,2,David,2950,0,5,2,7,71.4%,21m
17955,1,Lowghost,2950,90,4,4,8,50.0%,10m
17955,2,SeaBacon,2950,0,3,2,5,60.0%,7m
17955,1,GGCornbread,2950,97,3,3,6,50.0%,3h
17955,2,ScvAssassin,2950,60,3,3,6,50.0%,39m
17955,2,JakeTripplJ,2950,62,3,4,7,42.9%,29m
17955,2,[ÆON]Zerg,2950,30,2,0,2,100.0%,13m
17955,3,Slid,2950,97,2,1,3,66.7%,3h
17955,1,IceFox,2950,76,2,7,9,22.2%,44m
17955,2,greengrass,2950,0,0,1,1,0.0%,40m
17955,1,Impalpable,2950,0,0,1,1,0.0%,3h
17955,2,Gunner,2950,0,0,1,1,0.0%,25m
17955,1,Chummpa,2950,0,0,1,1,0.0%,2h
17955,2,LGBTandBLM,2950,0,0,1,1,0.0%,19m
17955,1,Nathaniel,2950,0,0,1,1,0.0%,55m
17955,2,[Mine]PainfulGamer,2950,0,0,2,2,0.0%,43m
17990,3,[neuroS]Wizard,2949,1609,345,339,684,50.4%,19m
17990,2,Skrilapulim,2949,1199,174,145,319,54.5%,41m
17990,3,[αB]ChefBoyArdy,2949,1529,153,157,310,49.4%,27m
17990,2,Spectactix,2949,1548,143,141,284,50.4%,30m
17990,1,[JaMiT]Tixt,2949,1570,62,64,126,49.2%,24m
17990,1,Zeolite,2949,1158,59,62,121,48.8%,14m
17990,1,Fluffy,2949,1072,42,38,80,52.5%,26m
17990,1,SoftCatM,2949,780,29,28,57,50.9%,38m
17990,2,[INFG]Randy,2949,595,26,18,44,59.1%,42m
17990,3,shjOoR,2949,335,13,11,24,54.2%,39m
17990,1,omabeachboy,2949,219,8,8,16,50.0%,29m
17990,2,Fartnoise,2949,240,8,10,18,44.4%,43m
17990,2,gabavelpo,2949,140,6,4,10,60.0%,38m
17990,2,SorryBud,2949,131,5,4,9,55.6%,20m
17990,2,QcFreerun,2949,242,5,9,14,35.7%,2h
17990,2,invisiblesim,2949,104,4,2,6,66.7%,13m
17990,1,AznPanda,2949,145,4,3,7,57.1%,3h
17990,2,Janik,2949,137,3,3,6,50.0%,8m
17990,2,Shasta,2949,140,3,7,10,30.0%,40m
17990,1,Hannah,2949,40,2,6,8,25.0%,14m
17990,1,Fennigan,2949,0,1,0,1,100.0%,2h
17990,2,[IDROPS]Banshee,2949,0,0,1,1,0.0%,32m
17990,2,HanDSomeP,2949,0,0,1,1,0.0%,38m
17990,1,Taldan,2949,0,0,5,5,0.0%,35m
18014,3,sephiroth,2948,832,162,161,323,50.2%,5m
18014,1,ProblemChild,2948,880,156,151,307,50.8%,14m
18014,1,PumaSphere,2948,1518,139,121,260,53.5%,38m
18014,1,[LOHs]vastolord,2948,1677,109,92,201,54.2%,44m
18014,2,WhiskyNWaves,2948,1612,92,81,173,53.2%,40m
18014,2,GuideBot,2948,925,92,89,181,50.8%,12m
18014,2,[AUSMAN]trichinopoly,2948,867,90,77,167,53.9%,31m
18014,2,captainjack,2948,605,86,70,156,55.1%,4m
18014,2,WrectEmSects,2948,1636,72,53,125,57.6%,4m
18014,2,WildCat,2948,1111,48,36,84,57.1%,19m
18014,2,UKILLEDBAMBI,2948,1040,47,27,74,63.5%,41m
18014,2,[Shardz]nhduia,2948,976,41,32,73,56.2%,42m
18014,2,sherm,2948,953,39,29,68,57.4%,31m
18014,2,[Exist]DroneRush,2948,488,22,17,39,56.4%,15m
18014,2,IcomefromEU,2948,423,19,13,32,59.4%,15m
18014,1,Zeph,2948,444,18,15,33,54.5%,18m
18014,2,Ada,2948,488,17,19,36,47.2%,9m
18014,1,MacleiN,2948,396,14,20,34,41.2%,16m
18014,2,AsIWasSaying,2948,276,10,5,15,66.7%,37m
18014,2,Bountie,2948,224,10,6,16,62.5%,23m
18014,1,[ffaaak]bigdaddy,2948,324,10,12,22,45.5%,21m
18014,1,Boanthropy,2948,240,9,8,17,52.9%,38m
18014,2,DaneelOlivaw,2948,242,8,5,13,61.5%,31m
18014,2,SLakiv,2948,139,7,5,12,58.3%,38m
18014,1,[GYEA]HoneyPops,2948,189,6,1,7,85.7%,3h
18014,1,[425]Buymyrice,2948,220,6,12,18,33.3%,9m
18014,3,Octavian,2948,189,5,2,7,71.4%,7m
18014,1,[TXOP]Aquox,2948,158,5,13,18,27.8%,3m
18014,2,Skydiver,2948,88,4,2,6,66.7%,26m
18014,2,Foxboy,2948,128,4,4,8,50.0%,4m
18014,2,[GTWITM]MrKwan,2948,60,3,1,4,75.0%,43m
18014,2,ZERG,2948,0,3,2,5,60.0%,41m
18014,1,SaviorKai,2948,105,3,3,6,50.0%,21m
18014,2,MxMonster,2948,30,2,0,2,100.0%,22m
18014,2,THEFALLENONE,2948,30,2,2,4,50.0%,26m
18014,2,[RectEm]TriP,2948,116,2,3,5,40.0%,27m
18014,2,Ricardo,2948,0,1,0,1,100.0%,23m
18014,2,Kachinsky,2948,0,1,0,1,100.0%,42m
18014,2,Renegade,2948,0,1,1,2,50.0%,42m
18014,2,YDD,2948,0,0,1,1,0.0%,26m
18014,2,[GaiLo]Nero,2948,0,0,1,1,0.0%,9m
18014,2,[Th3Bad]LLegollas,2948,0,0,1,1,0.0%,23m
18014,2,SEzC,2948,0,0,1,1,0.0%,14m
18014,1,[YD2K]MISTERLATE,2948,0,0,5,5,0.0%,5m
18058,3,GauchoBagual,2947,1491,249,229,478,52.1%,4m
18058,3,[WNTRLY]leadtech,2947,1552,157,164,321,48.9%,17m
18058,2,Vincent,2947,1363,80,60,140,57.1%,28m
18058,2,Sol,2947,331,62,61,123,50.4%,37m
18058,2,Solanin,2947,1334,56,46,102,54.9%,38m
18058,3,CloudBoi,2947,1210,56,61,117,47.9%,11m
18058,2,whitezombie,2947,643,26,19,45,57.8%,26m
18058,1,EmpVang,2947,559,21,20,41,51.2%,38m
18058,2,xtremeplayer,2947,507,19,15,34,55.9%,44m
18058,1,blinkSCV,2947,403,16,16,32,50.0%,40m
18058,2,Abdel,2947,228,15,9,24,62.5%,13m
18058,1,sleepybear,2947,219,12,6,18,66.7%,19m
18058,2,FullHalfie,2947,250,9,4,13,69.2%,26m
18058,1,[NTrio]Zandel,2947,292,9,12,21,42.9%,38m
18058,1,popikciu,2947,265,8,7,15,53.3%,2h
18058,2,Fleegs,2947,162,8,9,17,47.1%,8m
18058,3,MrGameCocks,2947,140,6,7,13,46.2%,28m
18058,2,[REPORT]Cicada,2947,30,4,3,7,57.1%,38m
18058,2,Horatius,2947,116,4,5,9,44.4%,43m
18058,1,[xTQc]sam,2947,112,4,7,11,36.4%,42m
18058,2,[IMDSI]huach,2947,30,2,0,2,100.0%,12m
18058,3,[Neewbe]Boxer,2947,0,1,0,1,100.0%,47m
18058,2,Shmash,2947,0,1,2,3,33.3%,31m
18058,2,LukaMagnotta,2947,0,0,1,1,0.0%,8m
18058,1,[RGBDR]Lynwood,2947,0,0,1,1,0.0%,1h
18058,2,aimLegs,2947,0,0,4,4,0.0%,43m
18084,3,latecomer,2946,1516,175,172,347,50.4%,38m
18084,1,[e1337z]Shado,2946,1437,97,92,189,51.3%,24m
18084,2,DrFauchiMD,2946,797,59,49,108,54.6%,25m
18084,1,[BfLaD]AdmiralKwan,2946,757,49,35,84,58.3%,36m
18084,2,izuru,2946,1132,45,38,83,54.2%,37m
18084,1,Aardvark,2946,887,30,29,59,50.8%,21m
18084,1,tacozaregood,2946,477,22,16,38,57.9%,23m
18084,1,Twinsen,2946,541,18,29,47,38.3%,39m
18084,1,Qwibble,2946,433,15,18,33,45.5%,23m
18084,1,BallsMcKenzy,2946,426,12,19,31,38.7%,15m
18084,2,HwiiyiG,2946,268,11,7,18,61.1%,27m
18084,3,Kolbert,2946,244,11,9,20,55.0%,37m
18084,1,Yinzknow,2946,298,9,14,23,39.1%,14m
18084,2,MicroMarine,2946,221,6,15,21,28.6%,34m
18084,3,Valkyrie,2946,120,3,1,4,75.0%,6m
18084,2,DrSeuss,2946,0,3,2,5,60.0%,10m
18084,2,carrion,2946,0,3,2,5,60.0%,31m
18084,2,Grambo,2946,94,3,5,8,37.5%,26m
18084,1,[QCGz]MrLePatron,2946,132,3,8,11,27.3%,2h
18084,2,[sLuxx]SpyroÐragon,2946,30,2,1,3,66.7%,4m
18084,2,[AngelA]PinkTako,2946,62,2,2,4,50.0%,22m
18084,2,[Maaad]zeLL,2946,62,2,4,6,33.3%,10m
18084,1,AngryChobo,2946,0,2,4,6,33.3%,18m
18084,2,spirit,2946,0,1,0,1,100.0%,43m
18084,2,[BooKng]Onda,2946,0,1,2,3,33.3%,30m
18084,2,LemonPotatoe,2946,0,0,3,3,0.0%,34m
18084,2,Ranaax,2946,0,0,3,3,0.0%,1h
18111,1,Chojin,2945,1694,409,381,790,51.8%,17m
18111,3,QuatzalInca,2945,1478,170,171,341,49.9%,12m
18111,1,Umiale,2945,1631,105,93,198,53.0%,11m
18111,3,[bfBE]dmautz,2945,831,97,79,176,55.1%,35m
18111,2,zaiken,2945,1183,66,55,121,54.5%,16m
18111,1,muninn,2945,863,54,42,96,56.2%,17m
18111,1,[JUGOS]MIAU,2945,996,51,41,92,55.4%,22m
18111,2,FuzzyWazzi,2945,969,48,41,89,53.9%,4m
18111,2,GINTOKI,2945,1108,41,42,83,49.4%,39m
18111,1,[M4G4]MoreThor,2945,916,31,35,66,47.0%,8m
18111,2,[LMBW]Brewster,2945,301,11,11,22,50.0%,23m
18111,2,CatleBruiser,2945,278,9,7,16,56.2%,13m
18111,1,Tocque,2945,148,9,11,20,45.0%,27m
18111,2,ArkKnight,2945,226,8,3,11,72.7%,34m
18111,2,Gein,2945,163,8,7,15,53.3%,12m
18111,1,GilbertSicot,2945,246,8,9,17,47.1%,29m
18111,2,bdawgsterr,2945,237,8,10,18,44.4%,39m
18111,2,Drake,2945,60,4,5,9,44.4%,41m
18111,2,server,2945,68,3,1,4,75.0%,34m
18111,1,McLaughlin,2945,0,3,2,5,60.0%,39m
18111,2,FatalAD,2945,58,3,3,6,50.0%,31m
18111,1,WaynaTakiri,2945,72,3,7,10,30.0%,10m
18111,2,Reddington,2945,30,2,2,4,50.0%,19m
18111,2,TeaSki,2945,0,1,0,1,100.0%,37m
18111,2,Hisoka,2945,0,1,1,2,50.0%,7m
18111,2,[Elder]pieguy,2945,0,0,2,2,0.0%,42m
18111,2,[EoMX]Korax,2945,0,0,2,2,0.0%,31m
18138,1,[Fthdwn]Breaker,2944,1454,151,134,285,53.0%,21m
18138,3,Shreekz,2944,500,80,92,172,46.5%,24m
18138,2,xKevinox,2944,1160,78,56,134,58.2%,36m
18138,2,[EViLE]tbworld,2944,1624,78,68,146,53.4%,23m
18138,1,Havok,2944,1224,49,43,92,53.3%,19m
18138,2,nokin,2944,572,25,18,43,58.1%,38m
18138,2,CENTURION,2944,556,24,13,37,64.9%,4m
18138,1,Metrobius,2944,518,21,19,40,52.5%,16m
18138,2,NoitNoit,2944,544,19,19,38,50.0%,13m
18138,2,VaaZerg,2944,378,14,12,26,53.8%,18m
18138,1,Alex,2944,284,11,14,25,44.0%,22m
18138,2,[ZTemps]Tasty,2944,120,9,6,15,60.0%,42m
18138,2,[TCProG]dejeve,2944,186,6,2,8,75.0%,42m
18138,2,BrownKing,2944,193,6,7,13,46.2%,2h
18138,2,[MooSha]Coach,2944,88,4,1,5,80.0%,37m
18138,2,eamonn,2944,62,3,2,5,60.0%,35m
18138,2,Davoh,2944,86,3,2,5,60.0%,42m
18138,2,WooriJib,2944,30,2,2,4,50.0%,18m
18138,3,[DoRQ]TheLordGersh,2944,0,2,7,9,22.2%,17m
18138,3,Misterpink,2944,0,1,1,2,50.0%,32m
18138,2,aldeon,2944,30,1,2,3,33.3%,41m
18138,2,uuuuuuuuuuuu,2944,0,1,3,4,25.0%,2h
18138,1,[GFS]handsomewang,2944,0,1,5,6,16.7%,2h
18138,1,[Starky]JonSnow,2944,0,0,1,1,0.0%,2h
18138,2,illuSiOn,2944,0,0,1,1,0.0%,10m
18138,1,Turtle,2944,0,0,3,3,0.0%,12m
18138,1,ZPM,2944,0,0,4,4,0.0%,10m
18165,3,zerbear,2943,1535,283,271,554,51.1%,6m
18165,1,[ecdn]Shaynk,2943,1680,177,149,326,54.3%,20m
18165,1,KamiSama,2943,967,174,153,327,53.2%,42m
18165,1,JoKerD,2943,787,126,111,237,53.2%,19m
18165,2,[FRWOW]PAPACULO,2943,1556,60,59,119,50.4%,8m
18165,1,Boohyah,2943,579,58,58,116,50.0%,33m
18165,2,DontEvenTrip,2943,708,30,22,52,57.7%,32m
18165,1,Wantoch,2943,523,26,27,53,49.1%,20m
18165,2,[AlIin]Ewendolus,2943,508,21,15,36,58.3%,34m
18165,3,HugaZerg,2943,273,15,23,38,39.5%,12m
18165,2,EuReKa,2943,268,10,6,16,62.5%,9m
18165,2,SoManySmurf,2943,130,5,3,8,62.5%,25m
18165,1,Cthulhu,2943,121,5,4,9,55.6%,15m
18165,2,Punisher,2943,148,5,5,10,50.0%,40m
18165,1,[M0KR3W]DoorTree,2943,196,5,6,11,45.5%,17m
18165,2,Deathhunt,2943,142,5,6,11,45.5%,2h
18165,2,MelGibson,2943,162,4,2,6,66.7%,17m
18165,1,iSiege,2943,116,4,9,13,30.8%,19m
18165,1,[SC2MOO]Mishrac,2943,0,3,2,5,60.0%,2h
18165,1,FHR,2943,0,3,2,5,60.0%,55m
18165,1,Ðemon,2943,48,3,4,7,42.9%,7m
18165,1,Ewanda,2943,145,3,5,8,37.5%,2h
18165,1,[Epokhé]JeanPier,2943,93,2,0,2,100.0%,9m
18165,2,[Yuju]Novel,2943,30,2,1,3,66.7%,38m
18165,2,[WNTRLY]Elec,2943,60,2,2,4,50.0%,17m
18165,2,kaokao,2943,58,2,3,5,40.0%,28m
18165,2,LineTwist,2943,0,1,1,2,50.0%,8m
18165,2,TheLordNukem,2943,30,1,3,4,25.0%,30m
18165,2,Crash,2943,0,0,1,1,0.0%,7m
18165,2,AbMaLord,2943,0,0,1,1,0.0%,29m
18195,1,Cynkar,2942,1612,146,135,281,52.0%,11m
18195,1,Corrision,2942,1291,114,93,207,55.1%,10m
18195,2,AirKing,2942,1599,107,88,195,54.9%,15m
18195,1,RET,2942,1214,67,59,126,53.2%,34m
18195,1,dayton,2942,1080,59,54,113,52.2%,40m
18195,2,Telvare,2942,928,45,41,86,52.3%,15m
18195,2,[RlSE]Sanity,2942,886,38,28,66,57.6%,24m
18195,3,[FFAA]EFRAIN,2942,435,33,27,60,55.0%,11m
18195,1,moki,2942,669,25,27,52,48.1%,11m
18195,2,SUUPERSONIC,2942,342,14,6,20,70.0%,18m
18195,2,Scottdecat,2942,348,14,11,25,56.0%,7m
18195,1,[LdS]ZEROS,2942,380,11,21,32,34.4%,13m
18195,1,[KTAUD1]nemownz,2942,148,5,11,16,31.2%,16m
18195,2,HHpotatoes,2942,73,4,6,10,40.0%,8m
18195,2,BLUEDEVIL,2942,94,4,8,12,33.3%,30m
18195,2,Zaun,2942,116,3,1,4,75.0%,19m
18195,2,Ratcult,2942,60,3,3,6,50.0%,31m
18195,2,[OBMACR]Balamaninov,2942,36,2,1,3,66.7%,15m
18195,2,[PFartz]Retwep,2942,44,2,5,7,28.6%,3m
18195,2,Amcore,2942,30,1,1,2,50.0%,41m
18195,2,Raynor,2942,30,1,3,4,25.0%,9m
18195,2,SansFace,2942,0,0,1,1,0.0%,19m
18195,2,Kisses,2942,0,0,1,1,0.0%,31m
18195,2,Bobysanchez,2942,0,0,2,2,0.0%,4m
18195,2,steve,2942,0,0,2,2,0.0%,37m
18220,2,Argem,2941,1607,195,171,366,53.3%,9m
18220,2,Oslemin,2941,616,62,55,117,53.0%,34m
18220,1,[OndaVT]MeGaChicKeN,2941,1187,50,45,95,52.6%,24m
18220,2,NeoBlade,2941,1037,48,29,77,62.3%,22m
18220,1,[WNTRCO]Kiljaden,2941,887,31,32,63,49.2%,16m
18220,3,Anubis,2941,748,26,33,59,44.1%,13m
18220,2,[H0D0R]chris,2941,494,23,17,40,57.5%,39m
18220,1,USSYamatoJPN,2941,402,12,15,27,44.4%,11m
18220,1,JSheppard,2941,218,9,9,18,50.0%,18m
18220,1,[DaPlug]DrJoseVM,2941,161,6,13,19,31.6%,15m
18220,2,Yesauir,2941,0,4,1,5,80.0%,42m
18220,1,[MLWtr]Mayoimasu,2941,173,4,7,11,36.4%,41m
18220,1,Echgoo,2941,0,2,1,3,66.7%,3h
18220,2,[SoCh1]thecurl,2941,30,1,1,2,50.0%,30m
18220,2,Blink,2941,30,1,1,2,50.0%,38m
18220,2,ANDYBLACK,2941,30,1,1,2,50.0%,44m
18220,2,gonza,2941,0,0,2,2,0.0%,17m
18237,1,RatSlayer,2940,1469,178,167,345,51.6%,20m
18237,2,Dephe,2940,1313,95,84,179,53.1%,38m
18237,1,stupidanimal,2940,1174,72,67,139,51.8%,26m
18237,3,Chris,2940,796,51,62,113,45.1%,43m
18237,3,jimraynor,2940,840,34,35,69,49.3%,11m
18237,1,Jonahag,2940,1010,34,41,75,45.3%,23m
18237,2,Virtue,2940,693,29,22,51,56.9%,16m
18237,2,Trofimowen,2940,438,17,16,33,51.5%,39m
18237,2,Tycicle,2940,270,14,14,28,50.0%,9m
18237,1,[Lil]VeryCuteGirl,2940,248,12,7,19,63.2%,8m
18237,2,Quacktastic,2940,249,11,11,22,50.0%,44m
18237,2,Glaurung,2940,187,9,7,16,56.2%,39m
18237,1,Sevan,2940,297,9,11,20,45.0%,2h
18237,2,[FBCD]MAC,2940,178,7,6,13,53.8%,9m
18237,1,LtQuattro,2940,254,7,13,20,35.0%,27m
18237,2,Steffen,2940,112,5,7,12,41.7%,24m
18237,1,Bacchus,2940,172,5,12,17,29.4%,36m
18237,3,Trululu,2940,0,4,3,7,57.1%,27m
18237,1,Legit,2940,0,3,2,5,60.0%,7m
18237,2,[SOPII]DudeManGuy,2940,30,2,0,2,100.0%,22m
18237,2,[jetpk]iDidntAsk,2940,30,1,1,2,50.0%,38m
18237,2,MrSoloDolo,2940,0,0,3,3,0.0%,13m
18237,2,[QTp2T]Felicity,2940,0,0,4,4,0.0%,41m
18237,2,iAMDEJOUR,2940,0,0,6,6,0.0%,23m
18261,1,[RBP3]ScorpionFire,2939,1634,89,90,179,49.7%,21m
18261,1,[PPQQ]Rump,2939,812,86,83,169,50.9%,11m
18261,2,DankCrank,2939,1579,73,57,130,56.2%,34m
18261,2,Heretic,2939,803,38,31,69,55.1%,15m
18261,1,Snoopyy,2939,539,27,31,58,46.6%,24m
18261,2,[Koshka]SureShot,2939,264,10,7,17,58.8%,33m
18261,3,salugies,2939,195,8,4,12,66.7%,2h
18261,2,[DISC]hfd,2939,192,8,6,14,57.1%,35m
18261,2,Caspurr,2939,118,5,4,9,55.6%,12m
18261,2,qqqqqq,2939,90,4,6,10,40.0%,35m
18261,1,Vesper,2939,0,3,2,5,60.0%,2h
18261,2,[LPrusa]Choripan,2939,60,3,2,5,60.0%,14m
18261,1,Grantae,2939,0,3,2,5,60.0%,3h
18261,2,[Vtta]tustaca,2939,30,2,0,2,100.0%,6m
18261,2,IIIIIIIIIIII,2939,30,2,0,2,100.0%,25m
18261,2,Phizzler,2939,30,2,3,5,40.0%,31m
18261,1,[OR2016]DRACUL,2939,0,0,1,1,0.0%,2h
18261,2,[TGosuC]KandiSAI,2939,0,0,1,1,0.0%,15m
18261,2,KINGoFCK,2939,0,0,2,2,0.0%,29m
18280,1,LiquidSky,2938,1596,290,267,557,52.1%,5m
18280,2,Somewhat,2938,1228,108,95,203,53.2%,23m
18280,3,KlickAir,2938,592,104,100,204,51.0%,12m
18280,1,[Juneau]Uder,2938,1257,81,78,159,50.9%,17m
18280,1,baikun,2938,955,52,49,101,51.5%,32m
18280,2,Monty,2938,973,48,49,97,49.5%,8m
18280,2,[4KILL]ToxicTreta,2938,664,40,25,65,61.5%,37m
18280,1,Ztee,2938,861,33,31,64,51.6%,38m
18280,1,prttygrlrock,2938,788,30,30,60,50.0%,20m
18280,2,[Jamin]SbCarrisai,2938,403,29,12,41,70.7%,34m
18280,2,SnorlaxJizz,2938,752,26,28,54,48.1%,15m
18280,2,DOA,2938,472,17,16,33,51.5%,37m
18280,1,[TGCF]BlindSide,2938,501,16,18,34,47.1%,38m
18280,2,GoW,2938,316,13,10,23,56.5%,38m
18280,2,[DHZ0ne]xSpiNx,2938,248,13,13,26,50.0%,26m
18280,2,Matt,2938,304,11,8,19,57.9%,9m
18280,3,Twenty,2938,70,7,4,11,63.6%,2h
18280,2,Ragnarok,2938,180,6,10,16,37.5%,12m
18280,1,shadowlord,2938,0,4,1,5,80.0%,22m
18280,1,ViTimm,2938,114,4,7,11,36.4%,20m
18280,1,[GSHXD6]GSHXD,2938,0,3,2,5,60.0%,56m
18280,2,Prog,2938,0,3,2,5,60.0%,20m
18280,3,[GudC]Lightworker,2938,145,3,3,6,50.0%,59m
18280,2,SilentStork,2938,30,2,0,2,100.0%,43m
18280,2,[DHZ0ne]Pedra,2938,30,2,0,2,100.0%,43m
18280,2,Ender,2938,30,2,0,2,100.0%,34m
18280,2,Zinc,2938,0,1,0,1,100.0%,15m
18280,2,CheezWhiz,2938,30,1,5,6,16.7%,26m
18280,2,Chinosky,2938,30,1,5,6,16.7%,18m
18280,2,SikWitiT,2938,0,0,1,1,0.0%,15m
18280,2,StayHydrated,2938,0,0,1,1,0.0%,35m
18280,1,[HRLOCA]DeiAurea,2938,0,0,2,2,0.0%,1h
18280,1,inujoshua,2938,0,0,2,2,0.0%,40m
18313,3,BrunoMiner,2937,1585,435,404,839,51.8%,33m
18313,1,[PeePz]MadeInChina,2937,1673,191,167,358,53.4%,9m
18313,3,[EvilGC]NoorbaK,2937,1493,165,155,320,51.6%,29m
18313,2,Atreides,2937,1215,50,43,93,53.8%,33m
18313,2,[BrknPp]lankylad,2937,402,24,11,35,68.6%,32m
18313,2,[Bocax]ArBocaTy,2937,150,5,7,12,41.7%,35m
18313,2,Display,2937,0,4,1,5,80.0%,9m
18313,2,[KREAP]FlamingPie,2937,0,3,2,5,60.0%,4m
18313,2,BeAsTlY,2937,0,3,2,5,60.0%,8m
18313,3,Barcode,2937,133,3,2,5,60.0%,2h
18313,2,FlatEarthTRU,2937,88,3,3,6,50.0%,28m
18313,2,[UpeV]KevinBcX,2937,30,2,1,3,66.7%,14m
18313,2,jbroscII,2937,58,2,2,4,50.0%,40m
18313,3,[Poway]uwu,2937,121,2,2,4,50.0%,1h
18313,2,Brainherpes,2937,0,1,0,1,100.0%,7m
18313,1,Birdman,2937,0,1,1,2,50.0%,24m
18313,2,Vaw,2937,0,1,2,3,33.3%,35m
18313,2,MadeinQuebec,2937,0,0,1,1,0.0%,39m
18313,2,[INextI]sirlorddavid,2937,0,0,1,1,0.0%,4m
18313,2,CruelBigDog,2937,0,0,1,1,0.0%,33m
18313,2,[JAR]TheNightKing,2937,0,0,2,2,0.0%,5m
18313,2,[TRR]ventfan,2937,0,0,4,4,0.0%,22m
18335,1,[SWOU]DarthOzz,2936,1573,135,121,256,52.7%,24m
18335,2,dead,2936,1620,95,87,182,52.2%,28m
18335,1,Seratul,2936,1563,63,57,120,52.5%,38m
18335,1,[SRCHA]KrisKon,2936,886,49,50,99,49.5%,4m
18335,2,[Niche]Tyrannus,2936,656,29,22,51,56.9%,19m
18335,1,[DoCh]QWERTYUIOPS,2936,177,14,15,29,48.3%,3m
18335,2,zeitgeist,2936,342,12,7,19,63.2%,30m
18335,2,[FyHr]vermilionxd,2936,277,11,10,21,52.4%,42m
18335,2,Maicol,2936,233,9,2,11,81.8%,26m
18335,3,Bullgom,2936,192,8,18,26,30.8%,39m
18335,1,TROLLCOOKIE,2936,164,6,6,12,50.0%,24m
18335,2,[xLgNx]BOMBER,2936,122,4,7,11,36.4%,39m
18335,1,atomatom,2936,0,3,2,5,60.0%,55m
18335,2,Nostalie,2936,0,3,2,5,60.0%,41m
18335,2,[USplan]kachinski,2936,86,3,5,8,37.5%,21m
18335,2,Chimaera,2936,112,2,1,3,66.7%,17m
18335,1,TonyDanza,2936,97,1,1,2,50.0%,3m
18335,2,Azazel,2936,0,0,1,1,0.0%,34m
18353,3,Kaiserschlag,2935,1546,300,289,589,50.9%,23m
18353,1,evolsteve,2935,1666,190,199,389,48.8%,37m
18353,2,brokenblind,2935,1623,90,76,166,54.2%,30m
18353,2,[InGt]Hursty,2935,1430,87,80,167,52.1%,38m
18353,2,[neuroW]jompy,2935,972,72,64,136,52.9%,13m
18353,2,[TruDAT]sgtcrayzee,2935,1580,68,58,126,54.0%,26m
18353,1,vamak,2935,1656,63,71,134,47.0%,14m
18353,2,[cluez]AbGolfing,2935,887,39,31,70,55.7%,13m
18353,2,NickAtKnight,2935,637,33,12,45,73.3%,42m
18353,2,[TB0C]CheeseCount,2935,587,26,15,41,63.4%,20m
18353,1,[LNTM]SpartanTy,2935,636,26,21,47,55.3%,21m
18353,2,[Gabe]TheAlamo,2935,326,25,18,43,58.1%,41m
18353,2,[GEKO]lizardguy,2935,544,24,12,36,66.7%,12m
18353,3,jbotah,2935,684,23,35,58,39.7%,13m
18353,2,Zivana,2935,553,22,23,45,48.9%,39m
18353,2,Grim,2935,347,18,10,28,64.3%,14m
18353,2,llllllllllll,2935,403,16,11,27,59.3%,15m
18353,2,Enzo,2935,275,11,10,21,52.4%,14m
18353,1,[Efflux]MuFFinMaN,2935,304,10,17,27,37.0%,15m
18353,2,Apple,2935,126,7,7,14,50.0%,16m
18353,1,[SCGA]AGMiaoB,2935,215,7,12,19,36.8%,9m
18353,3,FAraptero,2935,58,6,7,13,46.2%,41m
18353,2,noflo,2935,62,3,2,5,60.0%,30m
18353,1,llllllllllll,2935,0,3,2,5,60.0%,1h
18353,2,DoctorGentle,2935,30,2,1,3,66.7%,16m
18353,2,[Softy]LILULZANGVRT,2935,30,2,1,3,66.7%,9m
18353,1,[REPORT]multiplyAU,2935,0,1,0,1,100.0%,52m
18353,2,JeongMinLee,2935,30,1,1,2,50.0%,40m
18353,2,[TLMx]Notorious,2935,0,0,1,1,0.0%,37m
18353,2,[ITH]StratoKsteR,2935,0,0,4,4,0.0%,44m
18383,2,ANGEEE,2934,1609,244,229,473,51.6%,9m
18383,2,NOPE,2934,1573,185,179,364,50.8%,31m
18383,3,Malak,2934,724,122,119,241,50.6%,42m
18383,2,Barrin,2934,1430,95,86,181,52.5%,4m
18383,1,Almver,2934,1673,87,82,169,51.5%,41m
18383,3,Dread,2934,1505,84,96,180,46.7%,32m
18383,1,DarKo,2934,1112,57,57,114,50.0%,21m
18383,2,voidraygobrr,2934,901,41,24,65,63.1%,38m
18383,1,astigflip,2934,921,37,30,67,55.2%,23m
18383,2,[AbcCo]NITRAM,2934,815,36,25,61,59.0%,15m
18383,1,[urdone]Artist,2934,872,34,32,66,51.5%,37m
18383,1,Pain,2934,400,17,13,30,56.7%,24m
18383,2,JoeMama,2934,453,16,13,29,55.2%,37m
18383,3,Krycek,2934,350,12,27,39,30.8%,18m
18383,3,JokerFate,2934,261,11,4,15,73.3%,41m
18383,1,[DCS420]Qwerx,2934,97,5,1,6,83.3%,12m
18383,2,Bemo,2934,90,4,3,7,57.1%,43m
18383,2,[B4Str2]Flyppy,2934,116,4,4,8,50.0%,37m
18383,2,[Wulrus]mrDsamps,2934,142,3,1,4,75.0%,25m
18383,2,RanGOo,2934,60,2,4,6,33.3%,40m
18383,2,[GRUN]Ballast,2934,0,1,0,1,100.0%,39m
18383,2,[dtcfdp]Travis,2934,30,1,5,6,16.7%,43m
18383,2,MAP,2934,0,0,1,1,0.0%,44m
18383,2,Hatz,2934,0,0,2,2,0.0%,4m
18383,2,Shade,2934,0,0,3,3,0.0%,42m
18408,1,Tearbath,2933,919,118,91,209,56.5%,29m
18408,2,[poons]hamburglar,2933,1558,99,60,159,62.3%,41m
18408,3,Mengano,2933,1392,48,61,109,44.0%,7m
18408,2,[MD]Raedium,2933,751,42,38,80,52.5%,12m
18408,2,SKULLTAKER,2933,518,32,29,61,52.5%,35m
18408,1,GrumpyNoob,2933,499,26,23,49,53.1%,6m
18408,2,[LprtsK]DarkArchon,2933,516,23,16,39,59.0%,19m
18408,2,CraZyKaun,2933,544,22,18,40,55.0%,30m
18408,2,[RUSHya]Hybrid,2933,291,13,4,17,76.5%,38m
18408,2,DarkZirius,2933,339,13,9,22,59.1%,20m
18408,2,FLYSON,2933,270,11,3,14,78.6%,25m
18408,2,Macchus,2933,180,11,3,14,78.6%,31m
18408,1,[SFMC]TYitsJason,2933,226,11,10,21,52.4%,22m
18408,2,Qwickie,2933,265,7,8,15,46.7%,35m
18408,2,[MexSex]Psycho,2933,167,6,2,8,75.0%,42m
18408,2,[AlIin]Mannix,2933,176,6,3,9,66.7%,26m
18408,1,[sOLsc]Gajeel,2933,147,5,4,9,55.6%,29m
18408,2,Leonidas,2933,30,2,0,2,100.0%,42m
18408,1,Buhn,2933,48,2,4,6,33.3%,18m
18408,2,[UpeV]Mugiwara,2933,0,1,0,1,100.0%,12m
18408,2,cooking,2933,30,1,1,2,50.0%,29m
18408,3,[NatiBN]Riggy,2933,97,1,2,3,33.3%,2h
18408,2,beers,2933,30,1,4,5,20.0%,30m
18408,3,[765]Bakon,2933,30,1,9,10,10.0%,43m
18408,2,[Freema]MorganFreema,2933,0,0,1,1,0.0%,32m
18408,2,wowcrazy,2933,0,0,2,2,0.0%,30m
18408,2,[PINGON]TUMAMA,2933,0,0,3,3,0.0%,42m
18435,1,JHawK,2932,1362,121,120,241,50.2%,35m
18435,3,AnubiS,2932,1516,117,115,232,50.4%,28m
18435,3,fridor,2932,1118,102,104,206,49.5%,14m
18435,2,[cl0udM]XDkellan,2932,1339,74,59,133,55.6%,42m
18435,3,dobyboy,2932,487,44,54,98,44.9%,13m
18435,2,chester,2932,646,28,20,48,58.3%,4m
18435,3,Krabbugz,2932,639,21,30,51,41.2%,28m
18435,2,ShameOnYou,2932,503,18,15,33,54.5%,4m
18435,1,WilliaM,2932,545,18,19,37,48.6%,16m
18435,2,keretapir,2932,362,14,10,24,58.3%,32m
18435,1,SnakesAgain,2932,211,8,5,13,61.5%,8m
18435,2,zojefski,2932,148,6,6,12,50.0%,31m
18435,1,Cheerios,2932,164,5,3,8,62.5%,2h
18435,3,Flomax,2932,122,5,5,10,50.0%,56m
18435,2,Hylian,2932,144,5,6,11,45.5%,29m
18435,2,pool,2932,120,5,6,11,45.5%,31m
18435,2,[THICCQ]PsijicSoap,2932,0,4,1,5,80.0%,24m
18435,2,[CRFun]AminoAcid,2932,90,4,2,6,66.7%,4m
18435,2,Eleazar,2932,187,4,7,11,36.4%,30m
18435,1,TimTvPlease,2932,114,4,12,16,25.0%,9m
18435,1,FailSquad,2932,0,3,2,5,60.0%,57m
18435,1,XXOO,2932,0,3,2,5,60.0%,2h
18435,2,GoldenKing,2932,0,3,2,5,60.0%,20m
18435,2,Lance,2932,30,2,0,2,100.0%,28m
18435,1,Kreize,2932,48,2,6,8,25.0%,2h
18435,2,IIIIIIIIIIII,2932,0,1,1,2,50.0%,30m
18435,2,KangarooJacK,2932,0,0,1,1,0.0%,15m
18435,2,Kraen,2932,0,0,1,1,0.0%,4m
18435,2,suhpreme,2932,0,0,1,1,0.0%,17m
18435,2,Aurom,2932,0,0,2,2,0.0%,43m
18465,1,xWillZ,2931,1578,104,89,193,53.9%,21m
18465,2,Mancini,2931,1109,44,38,82,53.7%,40m
18465,1,[FxB]munchies,2931,1130,39,45,84,46.4%,38m
18465,1,Sol,2931,357,28,31,59,47.5%,29m
18465,2,Swankypants,2931,721,27,28,55,49.1%,22m
18465,1,nata,2931,358,19,17,36,52.8%,10m
18465,2,Leorio,2931,413,15,11,26,57.7%,15m
18465,1,kees,2931,330,15,13,28,53.6%,23m
18465,2,ratonpoeta,2931,328,14,12,26,53.8%,44m
18465,1,WooWoo,2931,253,10,9,19,52.6%,2h
18465,2,Dom,2931,204,7,7,14,50.0%,31m
18465,3,nitcaN,2931,155,6,6,12,50.0%,48m
18465,2,EvilHR,2931,182,6,10,16,37.5%,14m
18465,1,Calvary,2931,149,5,1,6,83.3%,2h
18465,2,[PELO]Argyle,2931,120,5,3,8,62.5%,43m
18465,2,NoMoreAngels,2931,30,4,3,7,57.1%,34m
18465,2,MasterMind,2931,120,4,5,9,44.4%,39m
18465,3,Cucrapock,2931,152,4,7,11,36.4%,34m
18465,1,[DYM]Nel,2931,116,4,9,13,30.8%,33m
18465,2,PubliSac,2931,0,3,2,5,60.0%,14m
18465,2,Argon,2931,60,3,2,5,60.0%,24m
18465,2,hobbles,2931,137,3,3,6,50.0%,32m
18465,2,Hope,2931,30,2,1,3,66.7%,19m
18465,2,SilverWings,2931,0,2,3,5,40.0%,18m
18465,2,You,2931,0,1,0,1,100.0%,44m
18465,3,[GGDA]invictor,2931,0,1,2,3,33.3%,2h
18465,3,MistRblistR,2931,30,1,13,14,7.1%,39m
18465,2,[TGCrew]TheLimester,2931,0,0,1,1,0.0%,12m
18465,2,[S3nshi]Gizmu,2931,0,0,2,2,0.0%,14m
18465,1,Xazki,2931,0,0,6,6,0.0%,15m
18495,3,Dooby,2930,1580,429,391,820,52.3%,27m
18495,1,MrEarl,2930,1517,213,194,407,52.3%,38m
18495,1,GameOfDrones,2930,1622,115,106,221,52.0%,10m
18495,1,Prime,2930,464,110,100,210,52.4%,22m
18495,2,MARINASILVA,2930,1579,79,57,136,58.1%,21m
18495,2,TimmyB,2930,1430,77,62,139,55.4%,42m
18495,2,[Apan]HHHPapa,2930,976,54,34,88,61.4%,42m
18495,2,kayne,2930,996,37,37,74,50.0%,9m
18495,1,Phaedrus,2930,619,27,23,50,54.0%,9m
18495,1,ESQuick,2930,280,13,8,21,61.9%,51m
18495,1,Warrior,2930,319,9,12,21,42.9%,16m
18495,1,Najdorf,2930,310,8,13,21,38.1%,42m
18495,2,AAAAAAAAA,2930,196,7,11,18,38.9%,30m
18495,1,OlI,2930,188,6,12,18,33.3%,9m
18495,2,kuribo,2930,86,4,2,6,66.7%,19m
18495,1,SevenEfFive,2930,97,4,2,6,66.7%,2h
18495,2,IveritasMC,2930,117,3,1,4,75.0%,14m
18495,2,Natsuaga,2930,0,3,2,5,60.0%,14m
18495,2,Smuel,2930,0,3,2,5,60.0%,9m
18495,2,Murakami,2930,58,2,2,4,50.0%,31m
18495,2,Epoch,2930,108,2,5,7,28.6%,20m
18495,2,[AK48]ChAvAChAvA,2930,30,1,1,2,50.0%,6m
18495,2,LeBronzeAims,2930,0,0,1,1,0.0%,34m
18495,2,[DhZAc1]Angeo,2930,0,0,1,1,0.0%,40m
18495,2,Mustafa,2930,0,0,1,1,0.0%,4m
18495,1,Shuriken,2930,0,0,1,1,0.0%,46m
18495,2,GstyLE,2930,0,0,1,1,0.0%,41m
18522,3,[cl0udM]Hansolo,2929,1535,152,158,310,49.0%,31m
18522,2,Kronoss,2929,1424,151,133,284,53.2%,14m
18522,3,Døyhar,2929,1628,123,117,240,51.2%,12m
18522,2,CerTaiN,2929,823,49,33,82,59.8%,22m
18522,2,Thrall,2929,1186,45,40,85,52.9%,13m
18522,2,DarkSlug,2929,668,34,17,51,66.7%,22m
18522,1,NMsinse,2929,896,32,39,71,45.1%,33m
18522,1,Muppers,2929,761,30,31,61,49.2%,40m
18522,1,Cyrali,2929,622,26,27,53,49.1%,29m
18522,2,sdf,2929,422,14,12,26,53.8%,25m
18522,2,[plsno]Azure,2929,346,14,13,27,51.9%,26m
18522,2,Squnky,2929,390,14,16,30,46.7%,38m
18522,1,Blake,2929,406,13,17,30,43.3%,13m
18522,1,Golden,2929,391,12,15,27,44.4%,15m
18522,1,ShrekBaggins,2929,202,6,9,15,40.0%,25m
18522,2,VSEPR,2929,162,4,3,7,57.1%,37m
18522,3,Helicon,2929,97,4,4,8,50.0%,3h
18522,3,lunchbox,2929,139,4,4,8,50.0%,26m
18522,2,[GIM]WHTMORPHEUS,2929,90,4,6,10,40.0%,9m
18522,1,AMADEUS,2929,0,3,2,5,60.0%,2h
18522,2,[HJBE]Blackfire,2929,58,3,5,8,37.5%,31m
18522,2,VonKilla,2929,94,3,5,8,37.5%,12m
18522,1,Pikkle,2929,102,3,7,10,30.0%,40m
18522,2,PhaseLethal,2929,141,3,7,10,30.0%,48m
18522,2,PsyViL,2929,0,2,1,3,66.7%,42m
18522,2,ForAiur,2929,30,2,5,7,28.6%,33m
18522,1,[4Grush]Scodelario,2929,122,2,7,9,22.2%,49m
18522,2,Ronin,2929,32,1,3,4,25.0%,42m
18522,2,kasparok,2929,0,0,1,1,0.0%,12m
18551,3,BenArnold,2928,1566,301,290,591,50.9%,34m
18551,3,CEROCUATRO,2928,1400,151,156,307,49.2%,43m
18551,3,Rikyu,2928,1155,100,114,214,46.7%,43m
18551,2,Kabraxis,2928,1211,91,83,174,52.3%,18m
18551,2,SonOfMorning,2928,923,45,39,84,53.6%,41m
18551,2,SuperSonic,2928,697,45,40,85,52.9%,14m
18551,2,[APM999]Mark,2928,987,44,27,71,62.0%,18m
18551,2,[3Drs]rObOdOg,2928,911,42,25,67,62.7%,7m
18551,2,Psuedo,2928,1030,39,36,75,52.0%,42m
18551,2,vvvscs,2928,1060,38,39,77,49.4%,9m
18551,2,alienbaby,2928,220,37,30,67,55.2%,35m
18551,1,[UpxV]Coronavirus,2928,941,32,34,66,48.5%,24m
18551,2,[FalPal]Olozzalap,2928,664,26,22,48,54.2%,13m
18551,2,GreGo,2928,585,25,22,47,53.2%,14m
18551,2,ParanoidMan,2928,253,25,26,51,49.0%,6m
18551,2,otk,2928,610,23,20,43,53.5%,15m
18551,2,Sharky,2928,492,21,12,33,63.6%,23m
18551,2,Bob,2928,396,14,14,28,50.0%,19m
18551,1,[EtrOy]hairyewok,2928,378,13,15,28,46.4%,12m
18551,1,GoldenFalls,2928,266,11,10,21,52.4%,40m
18551,2,James,2928,256,11,11,22,50.0%,41m
18551,2,DestroyHats,2928,262,9,6,15,60.0%,32m
18551,2,[UpeV]TyrJose,2928,183,8,2,10,80.0%,18m
18551,2,PCGamer,2928,252,8,11,19,42.1%,32m
18551,2,Twohey,2928,198,7,7,14,50.0%,42m
18551,1,Moose,2928,184,5,11,16,31.2%,8m
18551,2,BouncyBall,2928,30,4,3,7,57.1%,18m
18551,2,TaeKo,2928,60,3,2,5,60.0%,26m
18551,1,Semiw,2928,0,3,2,5,60.0%,3h
18551,2,sunjay,2928,30,2,0,2,100.0%,26m
18551,2,Kaizen,2928,30,2,0,2,100.0%,32m
18551,2,Tomaccio,2928,64,2,2,4,50.0%,31m
18551,3,[BFLY]JustSayin,2928,121,2,2,4,50.0%,29m
18551,2,[iTK]DyNaMiiC,2928,0,2,3,5,40.0%,24m
18551,2,[xLgNx]SandboxBird,2928,0,0,1,1,0.0%,14m
18551,1,bobobo,2928,0,0,4,4,0.0%,40m
18587,1,[PoSu]breadedtoast,2927,1552,129,126,255,50.6%,36m
18587,1,BigKeithNRG,2927,1441,128,124,252,50.8%,26m
18587,1,WARMACHINE,2927,1510,78,81,159,49.1%,11m
18587,1,[5MG]Zapozz,2927,979,43,41,84,51.2%,27m
18587,1,ANDRESVCR,2927,1006,41,37,78,52.6%,28m
18587,2,FatTony,2927,910,34,34,68,50.0%,42m
18587,2,Barnee,2927,372,25,17,42,59.5%,32m
18587,1,Pain,2927,597,24,29,53,45.3%,4m
18587,1,CaptBigBoss,2927,408,18,24,42,42.9%,39m
18587,1,BoomChild,2927,564,17,24,41,41.5%,14m
18587,2,campier,2927,277,10,9,19,52.6%,2h
18587,2,Chosen,2927,203,8,2,10,80.0%,26m
18587,1,SONGBIRD,2927,103,5,4,9,55.6%,37m
18587,3,WhiteBronco,2927,107,5,5,10,50.0%,17m
18587,2,Apex,2927,122,5,7,12,41.7%,32m
18587,2,[UVUSC2]Trae,2927,150,5,7,12,41.7%,36m
18587,2,Kaiser,2927,104,4,1,5,80.0%,29m
18587,2,alex,2927,136,4,8,12,33.3%,37m
18587,1,VaPox,2927,0,3,2,5,60.0%,7m
18587,3,Asberic,2927,123,3,2,5,60.0%,42m
18587,2,winli,2927,60,3,3,6,50.0%,43m
18587,1,Thugnificent,2927,48,3,4,7,42.9%,2h
18587,1,Xaaran,2927,0,2,1,3,66.7%,52m
18587,2,rinnafojn,2927,62,2,2,4,50.0%,31m
18587,1,buubuu,2927,0,2,3,5,40.0%,6m
18587,2,Oceanuss,2927,0,1,0,1,100.0%,44m
18587,2,AnnaBananaBR,2927,91,1,2,3,33.3%,2h
18587,2,Eruption,2927,0,0,1,1,0.0%,15m
18615,1,Mars,2926,1659,220,209,429,51.3%,36m
18615,1,[LACRAS]RATAMASTA,2926,1630,155,146,301,51.5%,42m
18615,2,[VCat]Geno,2926,1537,86,66,152,56.6%,10m
18615,1,Doctore,2926,1060,67,66,133,50.4%,5m
18615,2,[x98]SevenOfNine,2926,979,61,49,110,55.5%,39m
18615,2,[neuroS]FRZBRN,2926,874,32,32,64,50.0%,15m
18615,1,[SD760]MacAttack,2926,763,29,23,52,55.8%,40m
18615,2,Altros,2926,334,14,14,28,50.0%,12m
18615,2,[10cm]Gunnar,2926,292,12,8,20,60.0%,36m
18615,2,[THC2]Cyrus,2926,270,10,11,21,47.6%,34m
18615,2,LazyPanda,2926,182,7,6,13,53.8%,30m
18615,2,FatCatSwiss,2926,204,7,7,14,50.0%,39m
18615,1,SolidSwagz,2926,119,6,3,9,66.7%,19m
18615,2,[hOpp]TYRANT,2926,112,3,0,3,100.0%,42m
18615,2,dementors,2926,30,2,2,4,50.0%,16m
18615,1,[JM2]Hatformation,2926,38,2,4,6,33.3%,7m
18615,2,Intuition,2926,0,1,2,3,33.3%,11m
18615,2,[3ms]JACOBIS,2926,30,1,2,3,33.3%,9m
18615,2,[TGosuB]PureVoltage,2926,30,1,5,6,16.7%,14m
18615,2,JCS,2926,0,0,1,1,0.0%,26m
18615,2,PurpleViking,2926,0,0,1,1,0.0%,43m
18615,2,TheVelorFog,2926,0,0,1,1,0.0%,31m
18615,2,Yangkai,2926,0,0,1,1,0.0%,42m
18615,2,lagent,2926,0,0,1,1,0.0%,44m
18615,2,CrackRock,2926,0,0,3,3,0.0%,35m
18640,3,bang,2925,1465,277,269,546,50.7%,20m
18640,2,AlKaPwn,2925,1333,207,195,402,51.5%,14m
18640,2,Cyo,2925,867,39,35,74,52.7%,42m
18640,2,[ProCol]CAMPOGUERRA,2925,715,28,21,49,57.1%,6m
18640,2,SHIAMYR,2925,652,25,22,47,53.2%,30m
18640,2,Platinum,2925,556,24,14,38,63.2%,20m
18640,2,FromParis,2925,538,19,21,40,47.5%,24m
18640,2,NoBushido,2925,407,18,10,28,64.3%,7m
18640,1,Pengin,2925,339,17,14,31,54.8%,12m
18640,1,Robespierre,2925,286,9,8,17,52.9%,34m
18640,1,modcrac,2925,278,8,8,16,50.0%,6m
18640,3,dguy,2925,82,6,5,11,54.5%,2h
18640,3,RacialTurbo,2925,151,4,2,6,66.7%,2h
18640,1,deathcube,2925,72,3,8,11,27.3%,37m
18640,2,billythekid,2925,58,2,4,6,33.3%,38m
18640,2,Nanology,2925,0,1,0,1,100.0%,28m
18640,2,MMudZ,2925,30,1,3,4,25.0%,25m
18640,2,GuineaPig,2925,0,0,1,1,0.0%,39m
18640,2,Seven,2925,0,0,1,1,0.0%,42m
18640,2,moriscode,2925,0,0,1,1,0.0%,7m
18660,1,[DarkAG]llllllllllll,2924,1337,249,250,499,49.9%,32m
18660,3,DrGhostman,2924,607,220,223,443,49.7%,40m
18660,2,nick,2924,1619,206,208,414,49.8%,37m
18660,1,Nicros,2924,1623,121,117,238,50.8%,38m
18660,2,[Sabo0]Ethical,2924,1481,88,81,169,52.1%,12m
18660,3,Maniack,2924,324,68,64,132,51.5%,33m
18660,2,Darboux,2924,613,64,32,96,66.7%,9m
18660,1,kcpeders,2924,1501,63,63,126,50.0%,38m
18660,2,hidedragon,2924,1383,55,47,102,53.9%,24m
18660,2,Samurai,2924,682,40,19,59,67.8%,15m
18660,1,NAGYSAM,2924,1011,39,36,75,52.0%,5m
18660,2,Raka,2924,964,35,36,71,49.3%,37m
18660,3,[diaman]takuH,2924,269,27,30,57,47.4%,39m
18660,2,HaruDrawcia,2924,623,26,16,42,61.9%,32m
18660,2,Tabcaps,2924,436,19,11,30,63.3%,36m
18660,2,Alyeva,2924,232,8,9,17,47.1%,44m
18660,2,MentatRadnor,2924,156,6,5,11,54.5%,18m
18660,2,Walrai,2924,186,5,3,8,62.5%,8m
18660,2,SightHound,2924,148,5,9,14,35.7%,15m
18660,3,[AwaR]Fenix,2924,133,4,1,5,80.0%,7m
18660,2,NearShiro,2924,162,4,3,7,57.1%,32m
18660,2,MATIMAN,2924,88,3,1,4,75.0%,17m
18660,2,RedAsh,2924,58,3,4,7,42.9%,31m
18660,2,Oddy,2924,62,3,4,7,42.9%,16m
18660,2,Songoku,2924,90,3,5,8,37.5%,35m
18660,1,dasadsadsa,2924,48,2,0,2,100.0%,31m
18660,2,JORDI,2924,0,1,0,1,100.0%,35m
18660,2,[SS6]Vozan,2924,0,0,2,2,0.0%,35m
18660,2,Ironside,2924,0,0,2,2,0.0%,42m
18689,1,luber,2923,1552,250,225,475,52.6%,22m
18689,1,Wolla,2923,1571,195,182,377,51.7%,27m
18689,3,Wrestler,2923,1519,155,144,299,51.8%,25m
18689,1,llllllllllll,2923,1362,104,71,175,59.4%,22m
18689,2,snoopdawg,2923,1578,75,61,136,55.1%,35m
18689,3,Psionic,2923,574,66,66,132,50.0%,4m
18689,1,Bosatsu,2923,1134,61,61,122,50.0%,40m
18689,1,Gryphon,2923,986,58,56,114,50.9%,11m
18689,1,Insomniac,2923,1066,56,51,107,52.3%,24m
18689,1,Rhaely,2923,523,27,27,54,50.0%,25m
18689,2,Daigle,2923,448,17,13,30,56.7%,34m
18689,1,lIlIIlIlIIll,2923,460,16,16,32,50.0%,28m
18689,2,cJoker,2923,311,15,7,22,68.2%,40m
18689,1,Manicdemon,2923,426,14,19,33,42.4%,22m
18689,2,MoueRock,2923,330,12,8,20,60.0%,16m
18689,1,[DRKRPT]LOLwhat,2923,298,9,15,24,37.5%,23m
18689,2,[Broxit]Riley,2923,191,8,2,10,80.0%,30m
18689,2,plop,2923,119,7,9,16,43.8%,35m
18689,2,Slowpoke,2923,0,4,1,5,80.0%,32m
18689,2,OrangeRebel,2923,0,3,2,5,60.0%,14m
18689,2,Thalthalas,2923,92,3,5,8,37.5%,37m
18689,2,[FROMOZ]Nitro,2923,34,2,1,3,66.7%,43m
18689,1,Ragiano,2923,48,2,1,3,66.7%,54m
18689,2,[NLTTJ]onemolroach,2923,30,2,3,5,40.0%,29m
18689,2,[tCo9]Archcamus,2923,0,1,1,2,50.0%,7m
18689,2,IntruderAB,2923,30,1,4,5,20.0%,43m
18715,1,Exothermic,2922,1659,209,199,408,51.2%,25m
18715,2,[JAY]AggieCoolGuy,2922,1477,206,202,408,50.5%,36m
18715,1,[TnKn]arturator,2922,1628,140,138,278,50.4%,21m
18715,1,drkknight,2922,1656,110,117,227,48.5%,42m
18715,1,lIlIlIlIlI,2922,1500,72,62,134,53.7%,9m
18715,1,Momanon,2922,1598,66,67,133,49.6%,11m
18715,2,Frank,2922,1262,55,35,90,61.1%,14m
18715,2,Demononics,2922,1218,50,40,90,55.6%,33m
18715,2,[tanay]SaintofDoom,2922,282,48,27,75,64.0%,32m
18715,2,[OGbros]POSIDEN,2922,991,46,38,84,54.8%,24m
18715,1,Loser,2922,1195,45,51,96,46.9%,38m
18715,2,DeadRemus,2922,823,39,22,61,63.9%,31m
18715,1,Leinhart,2922,377,38,37,75,50.7%,14m
18715,2,unbesiegt,2922,606,27,24,51,52.9%,14m
18715,1,ohfasho,2922,295,24,23,47,51.1%,11m
18715,1,sebekku,2922,690,23,34,57,40.4%,37m
18715,2,crash,2922,344,14,11,25,56.0%,18m
18715,2,Harusame,2922,229,12,9,21,57.1%,35m
18715,2,tumbling,2922,242,11,2,13,84.6%,6m
18715,1,IIIIllllIII,2922,379,11,16,27,40.7%,17m
18715,1,TRAPSOUL,2922,240,10,8,18,55.6%,21m
18715,2,Vegeta,2922,211,9,7,16,56.2%,2h
18715,2,Mazin,2922,148,8,6,14,57.1%,25m
18715,2,[RRArmy]Hades,2922,141,7,4,11,63.6%,24m
18715,2,Tokaio,2922,58,5,4,9,55.6%,9m
18715,1,CheeseLovers,2922,138,4,1,5,80.0%,2h
18715,1,NoSSteF,2922,0,4,2,6,66.7%,2h
18715,2,[TDirT]Critical,2922,88,4,2,6,66.7%,35m
18715,2,Blizzaro,2922,120,4,6,10,40.0%,22m
18715,2,[RwtM]Blaze,2922,60,3,1,4,75.0%,4m
18715,2,JuneZerg,2922,0,3,2,5,60.0%,38m
18715,1,Joxikor,2922,0,3,3,6,50.0%,2h
18715,2,[Msia]CaiCaiLun,2922,0,1,0,1,100.0%,22m
18715,1,Salamandar,2922,0,1,1,2,50.0%,38m
18715,2,MagicTerran,2922,0,1,1,2,50.0%,31m
18715,1,RANDOM,2922,30,1,9,10,10.0%,44m
18715,2,[IAmUSA]gnarwallman,2922,0,0,1,1,0.0%,43m
18715,2,Slothking,2922,0,0,1,1,0.0%,14m
18715,2,[CLnBOi]Nebuchadnrzr,2922,0,0,2,2,0.0%,35m
18715,3,GetSome,2922,0,0,3,3,0.0%,59m
18755,1,Maestro,2921,1679,316,293,609,51.9%,38m
18755,1,NeMo,2921,970,253,245,498,50.8%,24m
18755,1,rehti,2921,1432,102,99,201,50.7%,43m
18755,1,[MadK]zdamaro,2921,1281,52,45,97,53.6%,11m
18755,1,Witty,2921,846,45,37,82,54.9%,42m
18755,1,[a99]Bloodbyte,2921,770,33,29,62,53.2%,26m
18755,1,GuruGuju,2921,577,24,27,51,47.1%,41m
18755,1,[t3k]Lep,2921,436,23,21,44,52.3%,37m
18755,2,jerzyn,2921,501,21,15,36,58.3%,12m
18755,1,BlastgU,2921,340,15,13,28,53.6%,19m
18755,1,Maitoparta,2921,311,9,12,21,42.9%,24m
18755,2,[WuTang]Tofu,2921,204,7,3,10,70.0%,36m
18755,2,Insaniac,2921,209,7,3,10,70.0%,14m
18755,2,Drakien,2921,167,7,6,13,53.8%,45m
18755,2,xXCrudeXx,2921,178,5,3,8,62.5%,37m
18755,2,CoconutCrab,2921,90,4,4,8,50.0%,13m
18755,2,Joshytime,2921,36,4,4,8,50.0%,31m
18755,1,Bruja,2921,123,3,7,10,30.0%,5m
18755,2,chain,2921,60,2,4,6,33.3%,37m
18755,2,Outoforder,2921,0,1,0,1,100.0%,6m
18755,2,[IMDSI]caroblues,2921,0,1,0,1,100.0%,32m
18755,2,[cutes]Valentine,2921,88,1,1,2,50.0%,15m
18755,2,terrapin,2921,0,1,1,2,50.0%,30m
18755,2,grubb,2921,30,1,4,5,20.0%,41m
18779,1,[440]Kitten,2920,1467,132,114,246,53.7%,41m
18779,1,Jamthenam,2920,1275,110,97,207,53.1%,5m
18779,1,Mister,2920,1388,93,90,183,50.8%,28m
18779,1,papaping,2920,736,63,65,128,49.2%,20m
18779,1,[Brohan]MaoMao,2920,1383,60,63,123,48.8%,40m
18779,2,[DNKCFT]warseeker,2920,455,33,28,61,54.1%,30m
18779,2,Serdio,2920,538,30,6,36,83.3%,22m
18779,1,[MHI]Bjornfort,2920,768,24,33,57,42.1%,37m
18779,1,Nighthawk,2920,772,24,34,58,41.4%,13m
18779,1,[GAA20]daniangel,2920,408,22,14,36,61.1%,44m
18779,1,CapnCook,2920,642,21,25,46,45.7%,27m
18779,2,Cheddar,2920,443,20,19,39,51.3%,18m
18779,2,defeponatltq,2920,480,18,16,34,52.9%,34m
18779,2,[DDLT]Searinoxco,2920,314,14,9,23,60.9%,41m
18779,2,Salo,2920,341,13,8,21,61.9%,42m
18779,2,PnC,2920,230,8,4,12,66.7%,33m
18779,2,xEcsharp,2920,218,8,5,13,61.5%,44m
18779,2,[LimaSC]Steimers,2920,191,7,4,11,63.6%,9m
18779,1,[YD2K]GQbed,2920,238,7,8,15,46.7%,19m
18779,1,noba,2920,259,7,9,16,43.8%,4m
18779,2,[FxTF]potpie,2920,179,5,5,10,50.0%,24m
18779,2,TheGuard,2920,0,4,1,5,80.0%,11m
18779,2,SilverEllo,2920,0,4,1,5,80.0%,7m
18779,2,[B1GDic]MajorLazer,2920,30,2,3,5,40.0%,44m
18779,2,Gravix,2920,102,2,6,8,25.0%,16m
18779,2,Irfrit,2920,0,1,0,1,100.0%,33m
18779,2,[T1AM]andrews,2920,30,1,4,5,20.0%,38m
18779,2,[Cyto]MrHungry,2920,0,1,4,5,20.0%,41m
18779,2,zigbey,2920,0,0,1,1,0.0%,11m
18779,2,snapcall,2920,0,0,5,5,0.0%,40m
18809,1,[Pirobo]CareGuama,2919,1228,264,253,517,51.1%,28m
18809,2,Darkshot,2919,1169,108,102,210,51.4%,38m
18809,2,Sindwarf,2919,1042,102,103,205,49.8%,32m
18809,2,BlackBart,2919,632,27,16,43,62.8%,41m
18809,1,Doozins,2919,299,24,28,52,46.2%,37m
18809,2,Salmonman,2919,644,23,26,49,46.9%,36m
18809,2,ZenZen,2919,307,14,13,27,51.9%,30m
18809,1,Gigawatts,2919,115,6,1,7,85.7%,2h
18809,1,Ray,2919,120,4,3,7,57.1%,2h
18809,1,Kira,2919,48,4,4,8,50.0%,3h
18809,2,Indigos,2919,0,2,3,5,40.0%,43m
18809,1,davidm,2919,34,2,10,12,16.7%,16m
18809,2,Hybrid,2919,0,1,0,1,100.0%,18m
18809,2,TimTamSlam,2919,0,1,1,2,50.0%,14m
18809,2,morblade,2919,0,1,1,2,50.0%,30m
18809,2,NASTIS,2919,0,0,1,1,0.0%,41m
18809,2,JustRene,2919,0,0,2,2,0.0%,15m
18826,1,[PobSC]NiKoGoYo,2918,1628,381,357,738,51.6%,38m
18826,1,[LGNxx]Outlawz,2918,1643,202,202,404,50.0%,19m
18826,3,deyver,2918,1480,158,169,327,48.3%,25m
18826,2,TyrellCorp,2918,1250,71,60,131,54.2%,37m
18826,1,[ALaCR]Drunko,2918,960,70,71,141,49.6%,29m
18826,2,PotatoMan,2918,1228,55,44,99,55.6%,17m
18826,2,RyanKoeh,2918,937,46,29,75,61.3%,25m
18826,1,KGBeast,2918,863,38,34,72,52.8%,42m
18826,2,[RIPWoL]gravytrain,2918,612,26,24,50,52.0%,37m
18826,2,[420SMO]Shadowrr,2918,622,22,21,43,51.2%,19m
18826,1,DreamRax,2918,347,15,7,22,68.2%,18m
18826,3,FlockOfBeans,2918,219,9,10,19,47.4%,36m
18826,2,THCodb,2918,202,7,7,14,50.0%,35m
18826,2,[Dim]Teufel,2918,58,5,4,9,55.6%,30m
18826,2,Maultasche,2918,114,3,0,3,100.0%,36m
18826,2,Source,2918,0,3,2,5,60.0%,24m
18826,2,VictORIGINAL,2918,0,3,2,5,60.0%,24m
18826,2,FreelancerBe,2918,0,3,2,5,60.0%,22m
18826,2,chrisugru,2918,122,3,7,10,30.0%,38m
18826,2,Stanky,2918,30,2,0,2,100.0%,32m
18826,1,Jowshieee,2918,48,2,1,3,66.7%,2h
18826,1,ScoobiesPhD,2918,74,2,8,10,20.0%,26m
18826,2,raiseitup,2918,0,1,5,6,16.7%,6m
18826,2,bobgoatfrog,2918,0,0,1,1,0.0%,18m
18826,2,Spartann,2918,0,0,2,2,0.0%,33m
18826,2,[sk3tch]DarkVil,2918,0,0,5,5,0.0%,11m
18852,1,[MadK]Valkyrie,2917,1657,236,206,442,53.4%,32m
18852,2,odaesu,2917,885,159,143,302,52.6%,30m
18852,2,SuperPants,2917,1131,80,77,157,51.0%,38m
18852,3,Joguel,2917,533,46,43,89,51.7%,18m
18852,1,[CatDad]FancyFetus,2917,856,30,35,65,46.2%,4m
18852,1,wzq,2917,580,29,30,59,49.2%,22m
18852,1,germ,2917,480,18,18,36,50.0%,9m
18852,1,[1GP]IronShadow,2917,264,15,17,32,46.9%,41m
18852,2,Dawserg,2917,250,14,16,30,46.7%,30m
18852,2,squeeeeeb,2917,260,11,8,19,57.9%,31m
18852,1,Hadouken,2917,328,10,12,22,45.5%,23m
18852,1,Elfuego,2917,273,9,11,20,45.0%,6m
18852,1,Nirviil,2917,310,9,13,22,40.9%,28m
18852,2,Vague,2917,170,7,6,13,53.8%,18m
18852,2,Quixorotica,2917,168,7,7,14,50.0%,46m
18852,2,harryman,2917,190,6,10,16,37.5%,13m
18852,2,Jashin,2917,122,5,4,9,55.6%,32m
18852,2,MrScruff,2917,88,4,2,6,66.7%,24m
18852,1,blux,2917,164,3,1,4,75.0%,36m
18852,2,CoreyJJ,2917,90,3,4,7,42.9%,16m
18852,2,[iDrunk]Oddiescell,2917,0,1,0,1,100.0%,32m
18852,2,BOMBOMJUNIOR,2917,0,1,0,1,100.0%,42m
18852,2,nitepeak,2917,0,1,1,2,50.0%,24m
18852,2,IIIIIIIIIIII,2917,88,1,1,2,50.0%,44m
18852,1,Harfang,2917,48,1,2,3,33.3%,3h
18852,2,beasy,2917,0,1,3,4,25.0%,16m
18852,2,[Dadash]ARMIN,2917,30,1,4,5,20.0%,35m
18852,2,Mezmo,2917,0,0,1,1,0.0%,42m
18852,1,[ºgXñº]Ðøxxëñ,2917,0,0,1,1,0.0%,36m
18852,2,[CCAV]Madeincn,2917,0,0,2,2,0.0%,16m
18882,2,PANDAyoFACE,2916,1048,120,113,233,51.5%,4m
18882,2,Guwoka,2916,1062,104,88,192,54.2%,42m
18882,1,SSSH,2916,959,92,82,174,52.9%,38m
18882,1,[FIow]madSCIeNTiSt,2916,1112,89,75,164,54.3%,13m
18882,1,[XpKAc]Santyboongy,2916,1446,71,61,132,53.8%,11m
18882,3,llllllll,2916,506,29,42,71,40.8%,41m
18882,2,japahh,2916,461,21,13,34,61.8%,9m
18882,2,HappyPanda,2916,144,12,6,18,66.7%,33m
18882,2,[SBXX]Permahost,2916,330,12,8,20,60.0%,14m
18882,2,[KNO]McKRAYS,2916,237,9,9,18,50.0%,4m
18882,2,Mystic,2916,164,7,5,12,58.3%,14m
18882,1,MrVietcong,2916,186,6,4,10,60.0%,16m
18882,1,SyIVThETiC,2916,202,5,10,15,33.3%,42m
18882,2,Izimonster,2916,86,4,2,6,66.7%,37m
18882,2,NavinJohnson,2916,30,4,3,7,57.1%,37m
18882,2,Maxaroni,2916,0,3,1,4,75.0%,42m
18882,2,RedLips,2916,0,3,2,5,60.0%,24m
18882,2,omegawarhog,2916,0,3,2,5,60.0%,26m
18882,2,[SADBOI]Ooze,2916,30,2,0,2,100.0%,5m
18882,2,TioCoFFee,2916,130,2,1,3,66.7%,2h
18882,1,ptero,2916,122,2,2,4,50.0%,16m
18882,2,[NwAs]Riverian,2916,62,2,8,10,20.0%,14m
18882,2,Wombat,2916,0,1,0,1,100.0%,18m
18882,1,NFAkira,2916,0,1,0,1,100.0%,38m
18882,2,[SsaYnS]johnrodjohn,2916,0,1,1,2,50.0%,24m
18882,1,opie,2916,0,0,1,1,0.0%,2h
18882,2,vyra,2916,0,0,1,1,0.0%,36m
18882,3,Salazar,2916,0,0,2,2,0.0%,41m
18882,2,MINIWING,2916,0,0,2,2,0.0%,2m
18911,3,Terror,2915,1301,218,224,442,49.3%,26m
18911,2,nemui,2915,1466,179,170,349,51.3%,12m
18911,1,Tetsuo,2915,1579,126,115,241,52.3%,21m
18911,2,Killerdoof,2915,367,66,49,115,57.4%,1m
18911,2,Remi,2915,677,28,21,49,57.1%,33m
18911,2,CHUPAELPICO,2915,573,27,26,53,50.9%,6m
18911,1,OGDerJager,2915,527,22,25,47,46.8%,41m
18911,2,IronMario,2915,454,18,18,36,50.0%,3m
18911,1,Thegreathz,2915,375,15,18,33,45.5%,24m
18911,2,Belzedar,2915,332,13,12,25,52.0%,24m
18911,2,Papachin,2915,173,8,14,22,36.4%,22m
18911,2,Rabbit,2915,88,6,5,11,54.5%,14m
18911,1,Tyluk,2915,184,5,8,13,38.5%,25m
18911,1,CptDesultory,2915,48,4,3,7,57.1%,37m
18911,1,Kobusuuu,2915,48,4,4,8,50.0%,2h
18911,2,TheThrone,2915,60,3,1,4,75.0%,14m
18911,2,Gio,2915,0,3,2,5,60.0%,40m
18911,2,GunzBlazing,2915,62,3,4,7,42.9%,31m
18911,2,DukeStyle,2915,30,2,0,2,100.0%,41m
18911,2,[RMW]MetalDeath,2915,0,1,0,1,100.0%,1m
18911,3,Brodato,2915,0,1,2,3,33.3%,53m
18911,2,EvilOlive,2915,0,0,1,1,0.0%,15m
18911,2,[RedQi]DreadKi,2915,0,0,1,1,0.0%,20m
18911,2,[NDAC]Jared,2915,0,0,2,2,0.0%,15m
18911,2,pretender,2915,0,0,4,4,0.0%,16m
18936,2,[felpa]CuunooPlay,2914,1410,316,281,597,52.9%,12m
18936,1,ogPrawn,2914,873,224,219,443,50.6%,19m
18936,2,[LgnTDS]Uncensored,2914,1128,133,105,238,55.9%,13m
18936,3,[HØST]Darushimu,2914,1385,125,117,242,51.7%,7m
18936,2,[Lp]DarkMTZI,2914,1497,80,50,130,61.5%,34m
18936,1,Coochiekins,2914,1177,56,57,113,49.6%,22m
18936,2,[ZTempz]Biggie,2914,912,53,33,86,61.6%,39m
18936,2,Cal,2914,1088,53,42,95,55.8%,31m
18936,1,KopperZerg,2914,773,53,54,107,49.5%,12m
18936,1,MaxFan,2914,1122,51,48,99,51.5%,15m
18936,2,TyphoonKIM,2914,1053,41,38,79,51.9%,9m
18936,1,ElSapo,2914,1028,40,44,84,47.6%,23m
18936,2,DaddyBoi,2914,691,28,23,51,54.9%,29m
18936,1,SamuraiNinja,2914,737,28,27,55,50.9%,31m
18936,2,bronado,2914,538,20,17,37,54.1%,25m
18936,1,[Maths]Steven,2914,618,20,24,44,45.5%,23m
18936,2,fooliodoolio,2914,509,19,20,39,48.7%,37m
18936,2,DoubleD,2914,327,15,7,22,68.2%,16m
18936,2,HowieStar,2914,410,15,15,30,50.0%,30m
18936,1,Krakens,2914,256,7,1,8,87.5%,24m
18936,2,YMzBenG,2914,184,6,5,11,54.5%,9m
18936,2,fooliodoolio,2914,152,5,2,7,71.4%,40m
18936,2,[CallMe]Jake,2914,105,4,3,7,57.1%,24m
18936,1,idkhowtoplay,2914,136,3,1,4,75.0%,2h
18936,2,MacroNutrien,2914,58,3,2,5,60.0%,29m
18936,2,BluHamsterz,2914,0,3,2,5,60.0%,35m
18936,1,alego,2914,96,3,3,6,50.0%,36m
18936,2,Nyarla,2914,60,3,5,8,37.5%,1m
18936,2,Turff,2914,30,2,0,2,100.0%,13m
18936,2,Coldferret,2914,0,1,0,1,100.0%,37m
18936,2,[PPega]PheelsBad,2914,0,0,1,1,0.0%,14m
18936,1,BigWish,2914,0,0,1,1,0.0%,2h
18936,2,Valoseu,2914,0,0,3,3,0.0%,24m
18969,1,RubenRS,2913,1552,116,121,237,48.9%,36m
18969,2,[Newbi3]Seba,2913,1285,75,69,144,52.1%,40m
18969,1,Skulltwist,2913,1639,73,76,149,49.0%,33m
18969,2,Greedy,2913,1271,67,59,126,53.2%,15m
18969,1,[TgJc]Spectralvox,2913,944,34,38,72,47.2%,28m
18969,2,CapTryhard,2913,541,24,25,49,49.0%,31m
18969,2,CptBlamo,2913,464,17,16,33,51.5%,38m
18969,2,mustigmust,2913,352,12,7,19,63.2%,36m
18969,1,ShoShinSha,2913,268,8,12,20,40.0%,14m
18969,2,HUGE,2913,178,7,9,16,43.8%,7m
18969,3,[QGR]TICADK,2913,231,6,9,15,40.0%,17m
18969,2,[ZvP]Grendel,2913,147,5,2,7,71.4%,32m
18969,2,[YngGng]TurtleGang,2913,80,5,7,12,41.7%,14m
18969,1,superarde,2913,97,4,2,6,66.7%,50m
18969,2,Ngru,2913,114,4,4,8,50.0%,14m
18969,2,ggpapasito,2913,126,3,2,5,60.0%,40m
18969,1,CatalyzT,2913,102,3,11,14,21.4%,7m
18969,2,Karandras,2913,126,2,4,6,33.3%,29m
18969,2,[oXoXo]JEAxXI,2913,0,1,0,1,100.0%,35m
18969,2,giraffe,2913,0,1,0,1,100.0%,31m
18969,2,YellowWorm,2913,0,1,0,1,100.0%,1m
18969,2,Jobin,2913,0,1,0,1,100.0%,37m
18969,2,[tBITOK]PAOBENG,2913,95,1,2,3,33.3%,25m
18969,2,untold,2913,30,1,5,6,16.7%,30m
18969,2,[T0PK3K]fuzzyBUNNY,2913,0,0,1,1,0.0%,40m
18969,2,Matt,2913,0,0,1,1,0.0%,39m
18969,2,sebastian,2913,0,0,1,1,0.0%,14m
18969,2,wtf,2913,0,0,1,1,0.0%,25m
18969,1,ecruzol,2913,0,0,1,1,0.0%,1h
18969,1,xingzai,2913,0,0,2,2,0.0%,2h
18969,2,Kinesin,2913,0,0,5,5,0.0%,4m
19000,2,TheEpicOne,2912,1553,181,156,337,53.7%,40m
19000,1,Valius,2912,1024,137,118,255,53.7%,19m
19000,2,Lidz,2912,1493,113,105,218,51.8%,21m
19000,2,Kyoumadess,2912,1090,67,56,123,54.5%,26m
19000,1,PooHerder,2912,1094,55,27,82,67.1%,37m
19000,2,[BBB420]Elfabio,2912,939,39,31,70,55.7%,24m
19000,2,ManyFeathers,2912,1054,37,41,78,47.4%,4m
19000,1,oscar,2912,818,33,32,65,50.8%,34m
19000,2,kimdoun,2912,780,31,27,58,53.4%,15m
19000,1,Jenisd,2912,679,28,23,51,54.9%,2m
19000,1,[pq]BlackRob,2912,770,27,29,56,48.2%,2m
19000,2,Scoub,2912,780,27,32,59,45.8%,14m
19000,1,Onelegchris,2912,684,26,24,50,52.0%,28m
19000,2,theplen,2912,178,24,21,45,53.3%,36m
19000,2,Dethan,2912,620,22,24,46,47.8%,2m
19000,1,[NPhasA]Chow,2912,558,19,25,44,43.2%,27m
19000,2,Galvarino,2912,341,13,9,22,59.1%,35m
19000,2,Harrison,2912,239,10,3,13,76.9%,32m
19000,1,[TGosuB]NotVanilla,2912,209,9,8,17,52.9%,10m
19000,2,Mesmerize,2912,240,9,9,18,50.0%,6m
19000,2,Starssong,2912,232,9,11,20,45.0%,35m
19000,2,Electric,2912,202,7,9,16,43.8%,37m
19000,2,CaracazNA,2912,0,3,2,5,60.0%,20m
19000,1,sidekick,2912,0,2,3,5,40.0%,2h
19000,2,[YeRlN]Gfriends,2912,32,1,3,4,25.0%,18m
19000,2,CHECHOCROS,2912,0,1,3,4,25.0%,14m
19000,3,blatt,2912,97,1,4,5,20.0%,2h
19000,2,[Alpha8]Uniquebpm,2912,0,0,1,1,0.0%,36m
19000,2,Koro,2912,0,0,1,1,0.0%,30m
19029,1,szpebl,2911,1627,231,217,448,51.6%,5m
19029,2,INTERESTELAR,2911,1329,102,72,174,58.6%,23m
19029,2,chunchunmaru,2911,831,40,23,63,63.5%,40m
19029,1,Zygonn,2911,848,37,31,68,54.4%,12m
19029,1,Flurry,2911,1007,33,39,72,45.8%,12m
19029,2,[ADDU]MangKated,2911,766,30,24,54,55.6%,41m
19029,2,SniperRaynor,2911,605,27,14,41,65.9%,37m
19029,1,Gesama,2911,625,23,22,45,51.1%,23m
19029,1,Maclaren,2911,190,14,21,35,40.0%,40m
19029,2,LumDiDum,2911,310,10,9,19,52.6%,18m
19029,2,Jackson,2911,281,10,10,20,50.0%,32m
19029,2,Tekk,2911,210,8,9,17,47.1%,28m
19029,2,[A1A1]CaptainAsh,2911,93,6,3,9,66.7%,30m
19029,2,supertool,2911,152,6,6,12,50.0%,14m
19029,1,RioRiot,2911,0,5,2,7,71.4%,1m
19029,2,[AbcCo]slenderman,2911,180,5,4,9,55.6%,36m
19029,2,chqistopher,2911,129,4,5,9,44.4%,28m
19029,2,azarusCaitus,2911,114,3,1,4,75.0%,27m
19029,1,BobbyDolbo,2911,0,3,2,5,60.0%,17m
19029,1,akira,2911,0,1,0,1,100.0%,1h
19029,2,[DRP44]Kquyz,2911,88,1,1,2,50.0%,18m
19029,2,qrtpasdca,2911,0,0,1,1,0.0%,16m
19029,2,null,2911,0,0,1,1,0.0%,37m
19029,2,abtek,2911,0,0,1,1,0.0%,13m
19029,2,Biscuit,2911,0,0,3,3,0.0%,1m
19029,2,[DCGA]TheSpot,2911,0,0,4,4,0.0%,12m
19029,2,[OGbros]Redhere,2911,0,0,4,4,0.0%,42m
19029,2,[Xpk]yourdead,2911,0,0,5,5,0.0%,37m
19057,2,Padge,2910,1080,132,107,239,55.2%,34m
19057,2,[TY4GG]Katarina,2910,1522,125,104,229,54.6%,36m
19057,2,VPom,2910,1210,112,86,198,56.6%,12m
19057,2,Kekster,2910,1519,81,61,142,57.0%,4m
19057,1,tool,2910,888,75,76,151,49.7%,25m
19057,2,Bear,2910,715,51,53,104,49.0%,31m
19057,2,[xTMGx]nik,2910,1266,45,52,97,46.4%,27m
19057,2,Apolum,2910,882,40,33,73,54.8%,41m
19057,1,BEAR,2910,1005,39,39,78,50.0%,23m
19057,2,DrDelete,2910,548,25,13,38,65.8%,10m
19057,1,Astroboy,2910,429,25,14,39,64.1%,1m
19057,2,Crabapple,2910,270,23,18,41,56.1%,30m
19057,2,[xUGRx]Bean,2910,470,23,20,43,53.5%,16m
19057,2,[ValidG]StepSister,2910,488,17,20,37,45.9%,36m
19057,2,[SURUPA]VaLeskA,2910,343,16,5,21,76.2%,25m
19057,1,Shooter,2910,280,10,10,20,50.0%,2h
19057,2,Jeoker,2910,309,10,12,22,45.5%,24m
19057,2,[Mldr]stefanova,2910,220,7,4,11,63.6%,41m
19057,2,[EnTrpY]Jack,2910,180,6,10,16,37.5%,32m
19057,2,[LIR]TheCaptain,2910,152,5,9,14,35.7%,42m
19057,2,MASSHOLE,2910,126,4,1,5,80.0%,8m
19057,1,[ProWea]Mindblaster,2910,112,4,9,13,30.8%,27m
19057,1,[Mirkk]SwanT,2910,0,3,2,5,60.0%,3h
19057,2,briz,2910,138,3,3,6,50.0%,8m
19057,2,younoob,2910,88,2,0,2,100.0%,25m
19057,2,[QPEE]Raven,2910,30,2,1,3,66.7%,15m
19057,2,rob,2910,88,1,1,2,50.0%,36m
19057,1,PatBateman,2910,0,0,1,1,0.0%,2h
19057,2,RaJo,2910,0,0,1,1,0.0%,37m
19057,2,Qrsmith,2910,0,0,2,2,0.0%,30m
19057,2,Rabid,2910,0,0,3,3,0.0%,36m
19088,2,Uzi,2909,968,186,178,364,51.1%,28m
19088,2,Skyline,2909,1619,111,102,213,52.1%,3m
19088,2,theunknown,2909,1290,95,21,116,81.9%,7m
19088,3,systemSHK,2909,1447,81,87,168,48.2%,14m
19088,2,[BnZi]Winfestor,2909,1619,74,72,146,50.7%,28m
19088,1,billiards,2909,256,70,64,134,52.2%,4m
19088,2,Candalistic,2909,1453,67,53,120,55.8%,36m
19088,3,Chris,2909,1156,59,71,130,45.4%,6m
19088,2,[LGNxx]LePotter,2909,880,34,37,71,47.9%,3m
19088,2,jamestkirk,2909,774,30,26,56,53.6%,30m
19088,2,[PpK69]Fozi,2909,665,29,19,48,60.4%,14m
19088,2,Kudi,2909,727,29,26,55,52.7%,41m
19088,2,BigÐickRick,2909,471,26,14,40,65.0%,9m
19088,2,KoopaTroopa,2909,456,18,16,34,52.9%,18m
19088,2,DevitcaRed,2909,160,16,1,17,94.1%,32m
19088,1,Nino,2909,427,14,17,31,45.2%,11m
19088,2,[ITruel]Mathaiser,2909,323,12,7,19,63.2%,37m
19088,2,[DETER]winberries,2909,243,11,7,18,61.1%,24m
19088,2,TERRAN,2909,357,11,24,35,31.4%,14m
19088,2,VcSProphet,2909,290,10,8,18,55.6%,38m
19088,3,BEELZ,2909,146,9,9,18,50.0%,40m
19088,1,GrumpyMonk,2909,191,7,3,10,70.0%,2h
19088,2,Propolis,2909,142,7,5,12,58.3%,34m
19088,1,JakeCoDonuts,2909,121,5,3,8,62.5%,18m
19088,2,[ZNsc]FANGWOLF,2909,118,4,7,11,36.4%,15m
19088,2,[CasulA]NuroMonx,2909,0,3,2,5,60.0%,24m
19088,2,[SNeS]peaches,2909,88,2,0,2,100.0%,41m
19088,2,viktar,2909,88,2,0,2,100.0%,33m
19088,2,Asimov,2909,32,2,1,3,66.7%,35m
19088,1,[PvZMa]BlueBob,2909,119,2,4,6,33.3%,23m
19088,1,[FUU]DLClever,2909,40,2,5,7,28.6%,39m
19088,2,ShiftyHP,2909,0,1,0,1,100.0%,13m
19088,2,[QA]Shenpa,2909,30,1,2,3,33.3%,14m
19088,1,[Active]Laserbam,2909,0,0,1,1,0.0%,2h
19088,2,Crocop,2909,0,0,1,1,0.0%,10m
19088,2,LovAge,2909,0,0,1,1,0.0%,18m
19088,2,Sigma,2909,0,0,1,1,0.0%,30m
19088,2,Apulsive,2909,0,0,1,1,0.0%,38m
19126,3,[GOPERÚ]Nagato,2908,1472,115,119,234,49.1%,41m
19126,2,PieAddict,2908,1134,82,71,153,53.6%,15m
19126,2,GrumpyPants,2908,1064,45,35,80,56.2%,5m
19126,2,Talox,2908,830,31,31,62,50.0%,6m
19126,3,[ShoaL]CHIN,2908,608,28,34,62,45.2%,29m
19126,1,[DhZAc1]NiNo,2908,779,27,30,57,47.4%,29m
19126,2,SassBlaster,2908,507,25,9,34,73.5%,38m
19126,3,Diemon,2908,416,18,22,40,45.0%,33m
19126,2,KnightMares,2908,336,14,9,23,60.9%,2m
19126,1,CLaUs,2908,331,13,10,23,56.5%,2h
19126,2,zeidrich,2908,246,13,11,24,54.2%,37m
19126,2,Vember,2908,233,12,2,14,85.7%,18m
19126,1,bigsmoke,2908,343,9,15,24,37.5%,30m
19126,1,Gaba,2908,306,9,18,27,33.3%,38m
19126,1,PHX,2908,196,8,8,16,50.0%,21m
19126,2,Dillon,2908,166,7,5,12,58.3%,23m
19126,1,Gallatin,2908,143,7,5,12,58.3%,31m
19126,2,[PTHero]NikMan,2908,162,6,5,11,54.5%,1m
19126,3,MrPaul,2908,149,6,9,15,40.0%,30m
19126,2,itachi,2908,0,4,1,5,80.0%,21m
19126,1,[RoBr]Khalareborn,2908,0,4,2,6,66.7%,54m
19126,2,[ExceI]Zechs,2908,102,3,0,3,100.0%,3m
19126,2,[LiViN]iRage,2908,0,2,3,5,40.0%,5m
19126,2,mayaAngelou,2908,0,1,0,1,100.0%,14m
19126,2,davargon,2908,0,1,1,2,50.0%,42m
19126,2,Spiky,2908,30,1,2,3,33.3%,4m
19126,2,[MxSC]Reaper,2908,30,1,8,9,11.1%,31m
19126,2,DroneOn,2908,0,0,1,1,0.0%,28m
19126,2,Tin,2908,0,0,1,1,0.0%,35m
19126,2,remi,2908,0,0,1,1,0.0%,36m
19126,2,Ghostera,2908,0,0,2,2,0.0%,33m
19126,1,Chubba,2908,0,0,5,5,0.0%,9m
19158,1,imhigh,2907,1656,232,221,453,51.2%,2m
19158,1,Jtown,2907,1640,126,110,236,53.4%,38m
19158,2,[RchChn]oberststen,2907,1382,117,105,222,52.7%,21m
19158,2,TTalgoa,2907,1173,48,42,90,53.3%,34m
19158,1,nunu,2907,411,29,28,57,50.9%,13m
19158,1,[NovaX]Realone,2907,834,26,33,59,44.1%,16m
19158,1,SoopNoodles,2907,692,24,30,54,44.4%,33m
19158,2,[TeamEz]ABlancoKid,2907,430,18,13,31,58.1%,36m
19158,2,MaximumZ,2907,429,16,20,36,44.4%,39m
19158,2,Elleshar,2907,221,13,9,22,59.1%,31m
19158,2,EnigmaTome,2907,306,11,12,23,47.8%,32m
19158,2,KiLtRiLlO,2907,233,9,5,14,64.3%,7m
19158,2,[X1]DarksmokeX,2907,204,9,7,16,56.2%,35m
19158,3,Kara,2907,191,7,5,12,58.3%,2h
19158,1,Diger,2907,121,5,2,7,71.4%,3h
19158,2,[STB]Boros,2907,116,4,1,5,80.0%,24m
19158,1,[GRM]Apheko,2907,48,4,3,7,57.1%,45m
19158,1,[Sfight]Phaluche,2907,113,3,8,11,27.3%,4m
19158,2,NobodyGreat,2907,0,1,2,3,33.3%,2m
19158,2,Lemon,2907,108,1,4,5,20.0%,14m
19158,2,[goodis]TheOldKanye,2907,0,0,1,1,0.0%,42m
19158,2,[OSOHT]EScape,2907,0,0,1,1,0.0%,22m
19158,2,FOX,2907,0,0,2,2,0.0%,24m
19158,2,lIlIlIlIlIlI,2907,0,0,3,3,0.0%,15m
19182,1,DNEtetRiS,2906,1505,133,139,272,48.9%,10m
19182,1,GamerShezma,2906,1298,88,82,170,51.8%,11m
19182,1,[ZTemp]Unknown,2906,747,83,89,172,48.3%,13m
19182,2,gege,2906,1498,71,36,107,66.4%,26m
19182,2,Peligroso,2906,1011,57,56,113,50.4%,40m
19182,2,Dare,2906,1126,51,36,87,58.6%,42m
19182,2,[AdapTs]Sleepwalker,2906,836,39,24,63,61.9%,14m
19182,3,TheWondrous,2906,618,26,30,56,46.4%,41m
19182,2,Condo,2906,514,19,18,37,51.4%,34m
19182,2,DangerousDan,2906,540,19,22,41,46.3%,24m
19182,1,BloodOfDeath,2906,379,16,16,32,50.0%,4m
19182,2,[FEARZ]eigen,2906,315,14,13,27,51.9%,35m
19182,1,IIIIIIIIIIII,2906,298,12,11,23,52.2%,11m
19182,2,[hTx]MCBunnyPants,2906,272,11,10,21,52.4%,31m
19182,2,joeblow,2906,221,10,7,17,58.8%,23m
19182,1,MoonPhostin,2906,324,10,20,30,33.3%,19m
19182,2,LATAR,2906,166,8,5,13,61.5%,30m
19182,2,Tweak,2906,181,6,3,9,66.7%,24m
19182,2,Concealment,2906,128,5,4,9,55.6%,37m
19182,2,[gGgO]AntBoot,2906,116,5,5,10,50.0%,2h
19182,2,[MJ23]VooDoo,2906,110,5,8,13,38.5%,22m
19182,2,XSoulReeverX,2906,0,4,2,6,66.7%,7m
19182,2,MatixPL,2906,30,4,4,8,50.0%,20m
19182,2,pLEITE,2906,0,3,2,5,60.0%,15m
19182,2,TakeN,2906,95,2,0,2,100.0%,35m
19182,1,ketherio,2906,0,1,0,1,100.0%,32m
19182,1,Leonardi,2906,0,1,0,1,100.0%,45m
19182,2,[VRGA]radiohead,2906,88,1,1,2,50.0%,21m
19182,3,thespark,2906,0,1,2,3,33.3%,38m
19182,2,Parim,2906,30,1,2,3,33.3%,31m
19182,2,Woz,2906,0,0,1,1,0.0%,14m
19182,2,Kell,2906,0,0,1,1,0.0%,40m
19214,2,DarkRed,2905,1150,97,79,176,55.1%,3m
19214,2,AkiraExe,2905,930,89,77,166,53.6%,8m
19214,3,[notBAD]antihero,2905,704,81,95,176,46.0%,19m
19214,3,[BoRnGo]Lance,2905,898,34,40,74,45.9%,26m
19214,2,GunMetaL,2905,519,25,17,42,59.5%,35m
19214,1,GhostofTajek,2905,660,21,29,50,42.0%,21m
19214,2,Dave,2905,249,17,18,35,48.6%,31m
19214,2,Lemon,2905,345,14,12,26,53.8%,39m
19214,2,ETermin,2905,232,8,8,16,50.0%,37m
19214,2,OnYourFence,2905,235,8,11,19,42.1%,37m
19214,2,SouNik,2905,182,7,7,14,50.0%,30m
19214,2,[TY4GG]Mugen,2905,180,5,3,8,62.5%,24m
19214,2,IIlllIIlllIl,2905,100,5,17,22,22.7%,14m
19214,2,[1318]IndyMan,2905,126,3,2,5,60.0%,36m
19214,2,[Fir3s]GOON,2905,0,3,2,5,60.0%,23m
19214,2,[142]Pico,2905,90,3,5,8,37.5%,2m
19214,2,Lothan,2905,114,2,2,4,50.0%,15m
19214,2,BerserK,2905,30,2,2,4,50.0%,35m
19214,1,BWG,2905,95,2,3,5,40.0%,2h
19214,2,HillaryDuff,2905,62,2,4,6,33.3%,3m
19214,2,StuKov,2905,30,2,4,6,33.3%,38m
19214,2,Pepe,2905,0,1,0,1,100.0%,32m
19214,2,eli,2905,0,1,0,1,100.0%,2h
19214,2,IAmTheTeam,2905,0,1,0,1,100.0%,24m
19214,2,DDA,2905,0,1,0,1,100.0%,36m
19214,2,Chewfreedomf,2905,0,1,2,3,33.3%,26m
19214,2,IIIIIIIIIIII,2905,0,0,3,3,0.0%,26m
19241,2,HastyHorse,2904,1330,122,102,224,54.5%,1m
19241,1,fecalfamine,2904,952,107,101,208,51.4%,34m
19241,1,pdz,2904,927,76,61,137,55.5%,29m
19241,2,shlanga,2904,1431,64,52,116,55.2%,1m
19241,2,Squanchy,2904,686,47,32,79,59.5%,16m
19241,1,Reshion,2904,619,42,43,85,49.4%,23m
19241,1,YasserKim,2904,758,25,28,53,47.2%,40m
19241,2,[gr4nd3]OsoPandoMx,2904,559,24,16,40,60.0%,33m
19241,1,[813ice]AntxTen,2904,522,16,23,39,41.0%,31m
19241,1,HISSEN,2904,297,13,12,25,52.0%,1m
19241,2,Kioelf,2904,297,12,8,20,60.0%,21m
19241,2,[0bam4]beefbelly,2904,319,11,9,20,55.0%,27m
19241,2,IdiotRusher,2904,246,7,6,13,53.8%,30m
19241,1,Smamm,2904,219,7,8,15,46.7%,10m
19241,2,Devil,2904,122,5,4,9,55.6%,14m
19241,3,Luca,2904,135,5,5,10,50.0%,2h
19241,1,[HEZUS]Exeler,2904,139,4,0,4,100.0%,3h
19241,2,Fruckt,2904,30,4,3,7,57.1%,12m
19241,2,BeachedWhale,2904,162,4,4,8,50.0%,35m
19241,2,[BRAP]Overdriven,2904,94,4,8,12,33.3%,33m
19241,2,Ninjamonkey,2904,60,3,2,5,60.0%,14m
19241,3,[FofS]AwesomeWill,2904,94,3,16,19,15.8%,25m
19241,2,BattlePants,2904,0,2,3,5,40.0%,34m
19241,1,mashiro,2904,48,2,4,6,33.3%,2h
19241,2,AudreyAva,2904,0,1,1,2,50.0%,31m
19241,2,[FEEDS]vaccjr,2904,30,1,3,4,25.0%,17m
19241,2,Krozther,2904,93,1,4,5,20.0%,46m
19241,2,[Acidik]Zazzles,2904,30,1,5,6,16.7%,6m
19241,2,Bracho,2904,30,1,5,6,16.7%,39m
19241,2,[burg3r]Astrydax,2904,0,0,1,1,0.0%,18m
19241,2,ABC,2904,0,0,1,1,0.0%,11m
19241,2,DungBo,2904,0,0,3,3,0.0%,21m
19241,3,SilentSword,2904,0,0,4,4,0.0%,27m
19274,2,Wilsoncooks,2903,1556,306,265,571,53.6%,21m
19274,2,Advaita,2903,635,83,77,160,51.9%,32m
19274,2,Battousai,2903,1096,79,68,147,53.7%,24m
19274,2,Haaa,2903,1320,70,66,136,51.5%,37m
19274,3,sentinal,2903,661,60,69,129,46.5%,28m
19274,2,Mist,2903,869,54,48,102,52.9%,41m
19274,2,Nope,2903,660,47,27,74,63.5%,16m
19274,2,StarDude,2903,505,45,35,80,56.2%,31m
19274,2,[PISCO]CAPITAN,2903,435,31,21,52,59.6%,25m
19274,2,[TnT]Nathson,2903,726,26,25,51,51.0%,30m
19274,2,warhead,2903,522,20,20,40,50.0%,40m
19274,2,[G501st]IIIIIIIIIIII,2903,306,13,6,19,68.4%,24m
19274,2,[JJPOOR]UzziDarwesh,2903,280,10,11,21,47.6%,37m
19274,1,IconicHail,2903,151,8,4,12,66.7%,9m
19274,2,Creepo,2903,52,6,5,11,54.5%,6m
19274,1,Benjanator,2903,194,6,14,20,30.0%,29m
19274,1,TyFy,2903,97,5,1,6,83.3%,51m
19274,2,Ticonderoga,2903,135,5,3,8,62.5%,26m
19274,1,Mathispell,2903,145,5,4,9,55.6%,2h
19274,1,[TnyDck]Random,2903,153,5,8,13,38.5%,30m
19274,1,DeSender,2903,97,4,3,7,57.1%,40m
19274,2,vkram,2903,90,4,4,8,50.0%,10m
19274,3,Nywai,2903,155,4,6,10,40.0%,5m
19274,2,Sundevil,2903,122,4,7,11,36.4%,31m
19274,2,sirfluffy,2903,0,3,3,6,50.0%,24m
19274,2,HowlingElf,2903,30,2,5,7,28.6%,38m
19274,2,destroyer,2903,60,2,6,8,25.0%,22m
19274,3,Tersius,2903,0,1,0,1,100.0%,5m
19274,2,[Gangas]Nuitaris,2903,0,1,1,2,50.0%,60m
19274,2,[josee]DonaldTrump,2903,88,1,1,2,50.0%,1m
19274,2,[DenSC2]Bear,2903,0,0,1,1,0.0%,34m
19274,2,Raptor,2903,0,0,3,3,0.0%,32m
19274,2,Takú,2903,0,0,3,3,0.0%,3m
19307,2,[AIRBAG]BinkleWorths,2902,1624,190,182,372,51.1%,36m
19307,3,[TaRus]SmiLe,2902,1249,117,118,235,49.8%,34m
19307,2,PipeN,2902,1106,67,52,119,56.3%,3m
19307,1,[Vrmin]Blau,2902,1019,53,52,105,50.5%,19m
19307,2,Mike,2902,1145,53,54,107,49.5%,32m
19307,1,QuoVadis,2902,364,38,33,71,53.5%,15m
19307,2,Sorrow,2902,495,24,14,38,63.2%,3m
19307,1,kurtox,2902,530,20,21,41,48.8%,11m
19307,2,[GOPERÚ]DarkOtaku,2902,380,14,14,28,50.0%,34m
19307,1,KALLIAN,2902,349,13,11,24,54.2%,40m
19307,2,petitefleure,2902,334,13,12,25,52.0%,32m
19307,3,Pederneras,2902,193,7,6,13,53.8%,11m
19307,2,SuperGrim,2902,185,6,3,9,66.7%,37m
19307,2,Silverdro,2902,187,6,4,10,60.0%,14m
19307,2,ClownFiesta,2902,146,6,6,12,50.0%,32m
19307,1,Valios,2902,208,6,12,18,33.3%,28m
19307,2,HoneyFire,2902,126,4,4,8,50.0%,2m
19307,3,Steelman,2902,0,4,4,8,50.0%,5m
19307,1,Rapture,2902,134,4,11,15,26.7%,17m
19307,2,[O6ama]Phoenix,2902,102,3,0,3,100.0%,16m
19307,2,Cow,2902,122,3,2,5,60.0%,17m
19307,2,bordrhoppr,2902,0,3,2,5,60.0%,1m
19307,3,NotKorean,2902,97,2,1,3,66.7%,5m
19307,2,[TPGGXD]ELRICK,2902,30,2,1,3,66.7%,17m
19307,2,swagman,2902,58,2,3,5,40.0%,32m
19307,2,xela,2902,30,2,3,5,40.0%,6m
19307,2,coalWater,2902,60,2,6,8,25.0%,32m
19307,3,[H0OD]Brotherhood,2902,0,1,0,1,100.0%,39m
19307,2,Billybob,2902,0,1,1,2,50.0%,24m
19307,2,Abiza,2902,30,1,5,6,16.7%,31m
19307,2,Alex,2902,30,1,5,6,16.7%,41m
19307,1,ShadowFox,2902,32,1,10,11,9.1%,39m
19339,2,Contagion,2901,1520,415,400,815,50.9%,11m
19339,3,Anathema,2901,1365,242,239,481,50.3%,39m
19339,3,[TeamSC]CptPaquin,2901,466,49,45,94,52.1%,7m
19339,2,[Nipnum]Xpew,2901,792,30,30,60,50.0%,32m
19339,1,today,2901,670,26,27,53,49.1%,21m
19339,3,MaeRa,2901,565,25,26,51,49.0%,34m
19339,2,Cyrus,2901,487,24,15,39,61.5%,38m
19339,2,JimyTBG,2901,488,21,15,36,58.3%,14m
19339,2,[Pharoh]bksc,2901,505,20,19,39,51.3%,10m
19339,3,DarkkAngelz,2901,471,20,22,42,47.6%,1m
19339,2,Ryfighter,2901,487,18,17,35,51.4%,32m
19339,2,Anakin,2901,368,14,11,25,56.0%,14m
19339,2,zealous,2901,400,14,16,30,46.7%,33m
19339,1,Shade,2901,174,8,9,17,47.1%,17m
19339,1,Summersisle,2901,272,8,15,23,34.8%,11m
19339,2,Konig,2901,175,7,2,9,77.8%,20m
19339,3,Rummy,2901,86,7,8,15,46.7%,18m
19339,1,[Ricc]ForTheBoys,2901,206,7,12,19,36.8%,14m
19339,1,[TMMen]CptObvious,2901,190,6,4,10,60.0%,45m
19339,2,TheBlackLion,2901,144,6,6,12,50.0%,8m
19339,2,TangChu,2901,0,4,1,5,80.0%,3h
19339,1,Sero,2901,97,4,3,7,57.1%,56m
19339,2,Envy,2901,85,4,7,11,36.4%,29m
19339,1,IIIIIIIIIIII,2901,97,3,1,4,75.0%,54m
19339,3,MacSalad,2901,121,3,3,6,50.0%,41m
19339,2,Lars,2901,55,2,4,6,33.3%,31m
19339,2,rAkEn,2901,62,2,8,10,20.0%,13m
19339,2,kvd,2901,0,1,0,1,100.0%,10m
19339,2,mrspinach,2901,0,1,0,1,100.0%,7m
19339,2,[cl0udM]NinjaDoggy,2901,30,1,2,3,33.3%,23m
19339,2,[ENL16]Brizzow,2901,0,0,1,1,0.0%,2h
19339,2,[LMI42]Zambezi,2901,0,0,2,2,0.0%,38m
19339,2,[Fir3s]NikodemusIII,2901,0,0,2,2,0.0%,20m
19372,1,embo,2900,1615,309,293,602,51.3%,13m
19372,2,Redwar,2900,1613,198,196,394,50.3%,14m
19372,2,Steok,2900,1475,166,147,313,53.0%,25m
19372,2,Shikamaru,2900,1574,98,75,173,56.6%,34m
19372,1,[StrMed]Janochan,2900,785,96,90,186,51.6%,36m
19372,2,Palo,2900,1603,73,65,138,52.9%,1m
19372,1,Poins,2900,983,65,67,132,49.2%,34m
19372,2,[P1ZZ4]CptnCouch,2900,939,54,43,97,55.7%,40m
19372,2,[GGMESP]AberamaGold,2900,1247,52,41,93,55.9%,41m
19372,2,SkrSkrSkr,2900,872,39,25,64,60.9%,24m
19372,2,Charcoal,2900,399,35,33,68,51.5%,34m
19372,2,wire,2900,534,22,19,41,53.7%,32m
19372,2,AndOne,2900,435,18,16,34,52.9%,37m
19372,2,Biceps,2900,334,14,11,25,56.0%,14m
19372,2,JimRaynor,2900,257,11,9,20,55.0%,40m
19372,2,[SFP]Danellos,2900,284,11,11,22,50.0%,31m
19372,3,[SydTT]wulala,2900,313,9,22,31,29.0%,10m
19372,1,mango,2900,127,6,5,11,54.5%,23m
19372,2,thisisboo,2900,0,3,2,5,60.0%,3h
19372,1,Solarbird,2900,0,3,3,6,50.0%,24m
19372,2,Titin,2900,0,2,3,5,40.0%,35m
19372,2,Elite,2900,0,1,0,1,100.0%,32m
19372,2,Alatriste,2900,0,1,0,1,100.0%,15m
19372,1,FusioNMudkip,2900,0,1,1,2,50.0%,54m
19372,2,KINGLICH,2900,30,1,2,3,33.3%,39m
19372,2,duzit,2900,0,0,1,1,0.0%,30m
19398,1,axx,2899,1445,253,230,483,52.4%,2m
19398,1,WoLfRahM,2899,1647,161,117,278,57.9%,15m
19398,2,dirtygoat,2899,346,108,85,193,56.0%,2m
19398,1,DeLaVega,2899,1024,103,112,215,47.9%,37m
19398,2,[TGosuB]AlbusNoxLuna,2899,1507,78,58,136,57.4%,39m
19398,1,Kratos,2899,1366,56,52,108,51.9%,39m
19398,1,DontSneezeMe,2899,920,52,56,108,48.1%,36m
19398,1,ClashOfLings,2899,627,30,33,63,47.6%,25m
19398,2,TurdFerguson,2899,642,29,16,45,64.4%,1m
19398,2,[GDKND]DeathLotus,2899,347,26,19,45,57.8%,36m
19398,2,Hesus,2899,355,15,8,23,65.2%,41m
19398,2,[ZTemp]Xtremegulp,2899,430,15,19,34,44.1%,31m
19398,2,llIIIllIIIll,2899,336,13,9,22,59.1%,27m
19398,2,dirk,2899,337,12,8,20,60.0%,1m
19398,2,orca,2899,305,12,10,22,54.5%,6m
19398,2,[NYOOM]JoyFired,2899,209,10,11,21,47.6%,30m
19398,2,[notRa]dimitri,2899,196,8,5,13,61.5%,10m
19398,2,DarkZalgo,2899,190,6,4,10,60.0%,21m
19398,2,Glebowsky,2899,174,6,12,18,33.3%,36m
19398,3,salzani,2899,235,6,15,21,28.6%,37m
19398,2,GoldenGoose,2899,0,3,2,5,60.0%,11m
19398,1,Bizix,2899,96,3,2,5,60.0%,56m
19398,2,SlaYer,2899,0,3,2,5,60.0%,36m
19398,2,blue,2899,0,3,2,5,60.0%,6m
19398,1,Clarity,2899,92,2,2,4,50.0%,32m
19398,2,Senya,2899,88,1,1,2,50.0%,40m
19398,2,[GTWITM]YourMama,2899,30,1,3,4,25.0%,3m
19398,2,[Sune]Pilaf,2899,30,1,3,4,25.0%,3m
19398,2,binthiccen,2899,0,0,1,1,0.0%,8m
19398,2,Vincent,2899,0,0,1,1,0.0%,30m
19398,1,Twiz,2899,0,0,2,2,0.0%,1h
19398,2,Intricate,2899,0,0,4,4,0.0%,20m
19430,1,[αX]XenoDactyl,2898,1473,87,84,171,50.9%,5m
19430,1,swish,2898,674,63,52,115,54.8%,13m
19430,2,[CHYW]Sentiliforme,2898,1046,51,31,82,62.2%,34m
19430,2,Pingumon,2898,948,35,30,65,53.8%,38m
19430,2,[MXEmp]Bountyhunter,2898,774,31,30,61,50.8%,30m
19430,2,neutron,2898,534,24,15,39,61.5%,7m
19430,2,Jasian,2898,485,21,11,32,65.6%,35m
19430,2,[Dicboy]INeedHelp,2898,478,19,16,35,54.3%,10m
19430,2,Rafax,2898,495,19,18,37,51.4%,11m
19430,2,[AXeS]Sprolix,2898,228,11,5,16,68.8%,25m
19430,1,McGruff,2898,273,10,12,22,45.5%,13m
19430,1,[R37R0]Eleazerg,2898,236,8,10,18,44.4%,36m
19430,2,[xLgNx]Timmy,2898,158,7,6,13,53.8%,32m
19430,2,Jeniba,2898,174,6,7,13,46.2%,41m
19430,3,Brady,2898,160,5,19,24,20.8%,11m
19430,2,CWCHW,2898,128,4,1,5,80.0%,14m
19430,3,ERichtofen,2898,145,4,1,5,80.0%,6m
19430,2,[A2Rats]Raine,2898,88,3,2,5,60.0%,7m
19430,2,[ANDYy]Hwaang,2898,30,3,4,7,42.9%,34m
19430,2,DarkVhyll,2898,69,3,8,11,27.3%,3m
19430,2,BlackBox,2898,88,2,0,2,100.0%,23m
19430,2,liquidsnake,2898,94,2,0,2,100.0%,15m
19430,1,[GSF91]bonxiakalaka,2898,96,2,3,5,40.0%,18m
19430,2,Koop,2898,0,2,3,5,40.0%,2h
19430,2,[xNSGx]CptainCurlyQ,2898,0,1,0,1,100.0%,26m
19430,1,NEO,2898,0,1,0,1,100.0%,27m
19430,2,Manipulator,2898,88,1,1,2,50.0%,16m
19430,1,ttdffhbb,2898,48,1,7,8,12.5%,52m
19430,2,Venom,2898,0,0,1,1,0.0%,31m
19430,2,[TeKk9]Kobrettie,2898,0,0,1,1,0.0%,6m
19460,1,[gRgL]Zerg,2897,1492,194,182,376,51.6%,39m
19460,2,aoxomoxoa,2897,1468,155,151,306,50.7%,14m
19460,2,[GRNSKN]Deathsbane,2897,960,117,99,216,54.2%,25m
19460,2,LatinoBlast,2897,1341,67,45,112,59.8%,26m
19460,1,WormRot,2897,1635,62,67,129,48.1%,25m
19460,2,sleepybear,2897,465,29,28,57,50.9%,42m
19460,2,[VRGM]spacecowboy,2897,303,23,25,48,47.9%,31m
19460,1,Phantom,2897,629,22,29,51,43.1%,23m
19460,2,BlindRabbit,2897,396,19,15,34,55.9%,42m
19460,2,Tesla,2897,238,13,11,24,54.2%,31m
19460,2,Blackheart,2897,338,11,11,22,50.0%,3m
19460,2,Tuor,2897,253,9,6,15,60.0%,36m
19460,2,DarkWingDuck,2897,132,7,2,9,77.8%,38m
19460,2,JQuX,2897,172,7,5,12,58.3%,35m
19460,2,[CBF]NinjaBird,2897,30,4,4,8,50.0%,30m
19460,1,IxooxI,2897,30,4,5,9,44.4%,39m
19460,2,Boom,2897,60,3,4,7,42.9%,35m
19460,2,zerg,2897,0,1,0,1,100.0%,28m
19460,2,[biboi]Gushee,2897,0,1,0,1,100.0%,49m
19460,2,DarwinsBite,2897,88,1,1,2,50.0%,34m
19460,2,Arayo,2897,30,1,2,3,33.3%,8m
19460,1,[Dnwlkr]Chris,2897,0,1,6,7,14.3%,11m
19460,1,pennywise,2897,0,0,1,1,0.0%,50m
19460,2,iGauU,2897,0,0,1,1,0.0%,10m
19460,2,[SITW]RobAvali,2897,0,0,2,2,0.0%,18m
19485,1,Alex,2896,1640,609,600,1209,50.4%,5m
19485,1,Elements,2896,912,196,196,392,50.0%,28m
19485,1,Lucho,2896,1548,132,125,257,51.4%,3m
19485,2,[bReD]mitchellm,2896,548,79,53,132,59.8%,32m
19485,1,Derb,2896,1362,64,56,120,53.3%,17m
19485,1,TheFestival,2896,1582,62,65,127,48.8%,11m
19485,1,[Rustla]Knuxer,2896,869,54,53,107,50.5%,38m
19485,3,[EvStar]Galactica,2896,212,38,45,83,45.8%,38m
19485,2,[DXPCA]Pogi,2896,469,24,7,31,77.4%,22m
19485,3,[WSBBC]Ebbitten,2896,599,22,23,45,48.9%,33m
19485,2,[TGosuB]BisDaQ,2896,524,19,19,38,50.0%,14m
19485,2,Grouna,2896,362,18,14,32,56.2%,35m
19485,1,Wilks,2896,395,17,15,32,53.1%,23m
19485,2,[ScScUr]DDD,2896,366,13,16,29,44.8%,14m
19485,2,[MacJu]Beginner,2896,254,10,7,17,58.8%,46m
19485,2,[NBSC]TeslaCoil,2896,182,6,3,9,66.7%,24m
19485,2,Funhole,2896,142,6,5,11,54.5%,15m
19485,2,Yeayer,2896,88,2,0,2,100.0%,18m
19485,2,ChickenBoi,2896,25,2,1,3,66.7%,38m
19485,2,OpticalPunch,2896,32,2,2,4,50.0%,7m
19485,2,[NHT]Aniond,2896,30,2,2,4,50.0%,15m
19485,1,Kyrown,2896,48,2,4,6,33.3%,51m
19485,2,tbonehmb,2896,0,1,4,5,20.0%,13m
19485,2,SaGaZinho,2896,0,0,1,1,0.0%,34m
19485,2,Never,2896,0,0,1,1,0.0%,28m
19510,3,mimori,2895,797,135,157,292,46.2%,18m
19510,1,skeith,2895,1513,134,123,257,52.1%,21m
19510,2,PeaceKeeper,2895,1577,72,60,132,54.5%,19m
19510,2,[PvZAll]Hope,2895,538,46,32,78,59.0%,11m
19510,1,tolss,2895,647,31,25,56,55.4%,15m
19510,2,[QcSuB]Grimmjow,2895,457,20,13,33,60.6%,35m
19510,2,[SSVG]Ozmerg,2895,364,16,10,26,61.5%,38m
19510,1,[RS69]Dudemeister,2895,473,14,21,35,40.0%,4m
19510,2,iArePJ,2895,290,13,12,25,52.0%,17m
19510,2,[308]OneSize,2895,234,10,3,13,76.9%,1m
19510,2,Keamon,2895,223,10,4,14,71.4%,14m
19510,2,StrikeH,2895,148,5,6,11,45.5%,40m
19510,2,jayim,2895,148,5,6,11,45.5%,5m
19510,2,Bjenjamin,2895,118,4,7,11,36.4%,14m
19510,2,Mateocos,2895,102,3,0,3,100.0%,26m
19510,2,KnowPain,2895,0,3,3,6,50.0%,34m
19510,2,JokeRz,2895,0,3,3,6,50.0%,35m
19510,2,MEXshredder,2895,132,3,4,7,42.9%,46m
19510,2,moneybagz,2895,0,2,0,2,100.0%,16m
19510,2,[EvilGC]RodKA,2895,30,2,1,3,66.7%,26m
19510,2,Shoneroc,2895,0,1,1,2,50.0%,32m
19510,2,HighPeaks,2895,0,1,4,5,20.0%,42m
19510,2,Lastresort,2895,0,0,1,1,0.0%,15m
19510,2,KimJongLi,2895,0,0,1,1,0.0%,2m
19510,2,FartOfDaSwrm,2895,0,0,2,2,0.0%,24m
19510,2,[x519]EndGame,2895,0,0,2,2,0.0%,21m
19510,2,elvena,2895,0,0,3,3,0.0%,37m
19537,3,[QuAzar]Tibearius,2894,1484,502,482,984,51.0%,4m
19537,2,mariob,2894,1440,166,136,302,55.0%,32m
19537,2,Stygian,2894,1544,98,85,183,53.6%,26m
19537,2,[UpxV]CondorAlfa,2894,1309,53,50,103,51.5%,31m
19537,2,Zatrux,2894,1232,51,44,95,53.7%,11m
19537,2,Biggut,2894,1045,48,40,88,54.5%,14m
19537,1,lol,2894,410,13,17,30,43.3%,17m
19537,2,[MTLG]Noah,2894,245,11,3,14,78.6%,11m
19537,2,GhostKing,2894,204,7,10,17,41.2%,29m
19537,2,[HTP450]angel,2894,154,6,9,15,40.0%,42m
19537,2,Boson,2894,142,4,2,6,66.7%,26m
19537,1,[AlCo]RENO,2894,97,4,4,8,50.0%,42m
19537,2,thangMAN,2894,0,3,2,5,60.0%,15m
19537,2,Broheim,2894,0,3,2,5,60.0%,37m
19537,2,Carl,2894,130,3,4,7,42.9%,5m
19537,2,KiryuCPR,2894,62,3,6,9,33.3%,19m
19537,1,Rartusman,2894,106,3,11,14,21.4%,38m
19537,3,Zerum,2894,97,2,1,3,66.7%,11m
19537,2,[G9PM]Tonalbunk,2894,88,2,4,6,33.3%,24m
19537,1,[HSS]madgunner,2894,36,2,8,10,20.0%,14m
19537,3,QuaitGonJin,2894,0,1,0,1,100.0%,56m
19537,2,Dullstar,2894,88,1,2,3,33.3%,37m
19537,2,[ALSB]Andaya,2894,0,0,1,1,0.0%,10m
19537,2,GoldenEagles,2894,0,0,3,3,0.0%,32m
19561,2,[alabfa]Zane,2893,1554,143,136,279,51.3%,3m
19561,2,Donzercl,2893,1353,129,101,230,56.1%,10m
19561,1,DopeyKoala,2893,1589,109,94,203,53.7%,10m
19561,2,Zamii,2893,1627,63,58,121,52.1%,26m
19561,1,Rizla,2893,1237,56,61,117,47.9%,28m
19561,2,DuMa,2893,975,49,26,75,65.3%,38m
19561,1,[NSMR]acdcrulz,2893,939,46,46,92,50.0%,21m
19561,2,BoHateTerran,2893,886,42,25,67,62.7%,18m
19561,2,FoxyAvida,2893,959,37,33,70,52.9%,40m
19561,1,Serpentine,2893,517,28,28,56,50.0%,21m
19561,3,Drip,2893,518,22,15,37,59.5%,15m
19561,1,[FTLTX]DemonCanival,2893,367,11,17,28,39.3%,21m
19561,2,Warren,2893,236,10,9,19,52.6%,16m
19561,3,Barcode,2893,0,4,1,5,80.0%,22m
19561,3,[TITSSS]Dalgalak,2893,30,4,3,7,57.1%,40m
19561,3,iTzXxxLimp,2893,58,4,4,8,50.0%,21m
19561,2,VanKiwi,2893,166,4,5,9,44.4%,1m
19561,2,SiegfrieD,2893,60,3,2,5,60.0%,31m
19561,2,NameDeFault,2893,0,3,3,6,50.0%,14m
19561,3,[RStarP]Royjones,2893,30,2,0,2,100.0%,17m
19561,3,BDZavian,2893,30,2,0,2,100.0%,10m
19561,2,[SMHC]BoxerYK,2893,30,2,4,6,33.3%,34m
19561,3,[sk3tch]CptDanK,2893,0,1,0,1,100.0%,17m
19561,3,drewdearing,2893,0,1,0,1,100.0%,33m
19561,2,[xOGz]Acheron,2893,0,1,1,2,50.0%,40m
19561,2,[Atone]Base,2893,0,1,4,5,20.0%,36m
19561,3,[2fTz]fixerjj,2893,0,0,1,1,0.0%,6m
19561,2,ButWait,2893,0,0,1,1,0.0%,31m
19561,2,Serral,2893,0,0,1,1,0.0%,7m
19561,2,TuffMuff,2893,0,0,2,2,0.0%,41m
19561,3,[69Rx69]Assprin,2893,0,0,2,2,0.0%,2h
19561,2,[iCz]MoonBiscuits,2893,0,0,3,3,0.0%,15m
19561,2,roflcopter,2893,0,0,3,3,0.0%,4m
19594,2,miston,2892,1628,162,141,303,53.5%,15m
19594,1,jeanuxi,2892,805,67,62,129,51.9%,33m
19594,2,Kome,2892,958,58,36,94,61.7%,6m
19594,2,[ØÛ]Arepakun,2892,942,34,35,69,49.3%,32m
19594,3,[BAUS]farQ,2892,681,27,16,43,62.8%,28m
19594,2,CapTuralion,2892,535,27,19,46,58.7%,22m
19594,1,Kosmos,2892,406,21,16,37,56.8%,15m
19594,2,LeArturo,2892,515,20,15,35,57.1%,20m
19594,1,soreloser,2892,435,18,16,34,52.9%,38m
19594,3,gaete,2892,271,17,12,29,58.6%,24m
19594,2,Chupacabra,2892,293,14,14,28,50.0%,36m
19594,2,Wildcat,2892,292,10,13,23,43.5%,38m
19594,2,biggaj,2892,284,9,12,21,42.9%,13m
19594,2,[INRVDG]Boogieboon,2892,202,7,9,16,43.8%,2m
19594,2,Pavalovanof,2892,117,6,5,11,54.5%,36m
19594,3,usucha,2892,154,6,5,11,54.5%,17m
19594,3,honker,2892,118,5,2,7,71.4%,36m
19594,1,Shinigami,2892,193,5,5,10,50.0%,34m
19594,2,polo,2892,142,5,6,11,45.5%,14m
19594,2,dæmon,2892,30,4,3,7,57.1%,36m
19594,2,[N008]Raptorteam,2892,0,2,3,5,40.0%,51m
19594,2,Altervise,2892,30,2,3,5,40.0%,5m
19594,2,Aimee,2892,102,2,6,8,25.0%,42m
19594,3,RocketMan,2892,30,1,1,2,50.0%,30m
19594,2,ShtStain,2892,88,1,2,3,33.3%,6m
19594,2,Shallazzarr,2892,30,1,3,4,25.0%,10m
19594,3,Brotoss,2892,0,0,1,1,0.0%,7m
19594,3,LSAR,2892,0,0,1,1,0.0%,24m
19594,3,Annatar,2892,0,0,1,1,0.0%,4m
19623,1,Alderan,2891,1612,326,316,642,50.8%,12m
19623,1,Alien,2891,1618,243,219,462,52.6%,22m
19623,2,Zergg,2891,1168,126,81,207,60.9%,27m
19623,3,Arfarathon,2891,1518,115,107,222,51.8%,39m
19623,1,[Macac0]Kurita,2891,1178,97,77,174,55.7%,27m
19623,2,Volo,2891,580,70,46,116,60.3%,16m
19623,1,[TWNNO1]Master,2891,1629,62,65,127,48.8%,9m
19623,2,TedMosby,2891,1058,61,10,71,85.9%,32m
19623,2,DooR,2891,1036,38,39,77,49.4%,40m
19623,2,[TGF]Hez,2891,436,33,20,53,62.3%,4m
19623,1,Leo,2891,261,33,35,68,48.5%,9m
19623,2,[xiuer]Tiger,2891,645,30,21,51,58.8%,14m
19623,1,Fox,2891,604,18,29,47,38.3%,25m
19623,2,[EDLSSA]TheFalcon,2891,401,17,15,32,53.1%,30m
19623,2,[LoFAc]Drizent,2891,326,11,11,22,50.0%,39m
19623,2,[DJJ]JAMER,2891,206,8,8,16,50.0%,30m
19623,2,ShrimpsRBugs,2891,118,6,4,10,60.0%,36m
19623,2,Sovereign,2891,150,6,6,12,50.0%,38m
19623,1,jazz,2891,120,5,6,11,45.5%,6m
19623,2,Teslon,2891,0,4,1,5,80.0%,2h
19623,1,Comrade,2891,97,4,3,7,57.1%,3h
19623,2,[TLDZ]Snarejay,2891,88,2,1,3,66.7%,10m
19623,2,threesmall,2891,33,2,4,6,33.3%,5m
19623,1,Amphipoda,2891,0,1,0,1,100.0%,17m
19623,3,Paradox,2891,0,1,0,1,100.0%,26m
19623,3,Pwnzzor,2891,96,1,5,6,16.7%,24m
19623,2,SilverSurfer,2891,0,0,2,2,0.0%,36m
19623,2,[MEP]JAhLove,2891,0,0,2,2,0.0%,37m
19651,1,RedBeard,2890,1453,155,150,305,50.8%,37m
19651,2,[2ES]JayD,2890,1398,88,72,160,55.0%,24m
19651,2,[Kusshh]Braga,2890,1296,50,51,101,49.5%,37m
19651,1,AlphaGG,2890,1416,50,59,109,45.9%,10m
19651,2,Storma,2890,753,32,25,57,56.1%,42m
19651,2,[BATMF]Putinsky,2890,668,27,21,48,56.2%,30m
19651,2,[SNOW1]EBeast,2890,455,22,15,37,59.5%,6m
19651,2,Mtheory,2890,388,16,17,33,48.5%,30m
19651,2,Franklin,2890,194,7,4,11,63.6%,2h
19651,2,MegatonSlab,2890,120,7,6,13,53.8%,10m
19651,3,seansc,2890,171,6,7,13,46.2%,10m
19651,2,CheeseImmune,2890,203,6,7,13,46.2%,6m
19651,3,Trevisan,2890,58,5,3,8,62.5%,8m
19651,2,[Yoga1]Kundalini,2890,30,5,3,8,62.5%,38m
19651,2,TortoiseMan,2890,181,5,5,10,50.0%,24m
19651,2,[2AND80]rustface,2890,137,4,2,6,66.7%,2h
19651,2,Damagekill,2890,90,4,3,7,57.1%,38m
19651,2,KalmanAvngr,2890,118,4,6,10,40.0%,32m
19651,2,Focsi,2890,0,3,3,6,50.0%,9m
19651,3,Nex,2890,0,1,0,1,100.0%,10m
19651,2,Trikon,2890,0,1,5,6,16.7%,5m
19651,3,Ouros,2890,0,0,1,1,0.0%,41m
19651,3,pUGg,2890,0,0,1,1,0.0%,36m
19651,3,[TheSho]StimzCapone,2890,0,0,1,1,0.0%,21m
19651,3,thetrueone,2890,0,0,1,1,0.0%,24m
19651,3,BOB,2890,0,0,1,1,0.0%,19m
19651,3,SneakyTurtle,2890,0,0,1,1,0.0%,57m
19651,2,TheBigWeed,2890,0,0,5,5,0.0%,14m
19679,3,FUTECH,2889,1456,235,231,466,50.4%,39m
19679,2,[DhZAc1]Morg,2889,1534,186,178,364,51.1%,37m
19679,1,Shane,2889,1643,127,124,251,50.6%,23m
19679,2,LEETHELIVER,2889,731,49,36,85,57.6%,24m
19679,2,Biccboii,2889,577,44,38,82,53.7%,38m
19679,2,Vanity,2889,1028,40,36,76,52.6%,24m
19679,2,[KerriS]Beyongsong,2889,886,39,26,65,60.0%,36m
19679,2,[ValidG]ilikefurnitu,2889,645,36,28,64,56.2%,42m
19679,2,Giggs,2889,772,35,30,65,53.8%,19m
19679,2,[TY4GG]Intentional,2889,808,34,27,61,55.7%,30m
19679,2,bakihanma,2889,565,25,21,46,54.3%,4m
19679,2,DestrO,2889,600,24,18,42,57.1%,1m
19679,3,saladbar,2889,303,13,7,20,65.0%,34m
19679,2,mckan,2889,372,13,17,30,43.3%,35m
19679,2,Paracelsus,2889,352,12,14,26,46.2%,38m
19679,2,BENTANCUR,2889,245,8,8,16,50.0%,14m
19679,2,[Micr0]ChaBoiRimmys,2889,189,7,7,14,50.0%,32m
19679,2,Heisenzerg,2889,165,6,2,8,75.0%,10m
19679,3,wooey,2889,147,6,4,10,60.0%,53m
19679,1,[Rollin]Supreme,2889,236,6,8,14,42.9%,4m
19679,3,[ZMERCY]ECKill,2889,136,5,4,9,55.6%,32m
19679,2,[PROG]GuruInfernal,2889,156,3,1,4,75.0%,43m
19679,2,BailaPikachu,2889,112,3,2,5,60.0%,26m
19679,2,MittRomney,2889,88,3,7,10,30.0%,3m
19679,1,IIIIIIIIIIII,2889,96,2,2,4,50.0%,2h
19679,2,[CLTrox]nomedigas,2889,0,1,1,2,50.0%,37m
19679,1,dng,2889,38,1,6,7,14.3%,37m
19679,1,FTwoLess,2889,107,1,9,10,10.0%,29m
19679,3,[NPhasA]asheZ,2889,0,0,1,1,0.0%,37m
19679,3,Ace,2889,0,0,5,5,0.0%,7m
19709,2,Antirage,2888,1452,89,76,165,53.9%,37m
19709,2,Templario,2888,985,55,49,104,52.9%,37m
19709,2,Jano,2888,1238,51,46,97,52.6%,1m
19709,2,Static,2888,1044,44,36,80,55.0%,10m
19709,2,PremisseS,2888,913,35,32,67,52.2%,40m
19709,2,Sam,2888,432,23,18,41,56.1%,31m
19709,3,[sk3tch]BillDipperly,2888,517,19,13,32,59.4%,26m
19709,1,[LTWAR]Polarity,2888,261,16,17,33,48.5%,3m
19709,2,RollWave,2888,375,15,12,27,55.6%,7m
19709,2,NotSaitama,2888,334,14,8,22,63.6%,37m
19709,1,speedghOst,2888,271,14,16,30,46.7%,28m
19709,1,Protrayal,2888,180,7,7,14,50.0%,27m
19709,2,Effectery,2888,114,6,2,8,75.0%,41m
19709,3,[CaveR]vitaminTuna,2888,171,4,3,7,57.1%,59m
19709,2,[CPiece]Bill,2888,126,4,9,13,30.8%,14m
19709,2,Kdogma,2888,0,3,2,5,60.0%,53m
19709,3,[PAPSUM]ricericebaby,2888,0,3,2,5,60.0%,41m
19709,2,zerglord,2888,30,2,4,6,33.3%,2m
19709,3,dazcros,2888,0,1,0,1,100.0%,11m
19709,2,[Kusshh]Chiu,2888,0,1,6,7,14.3%,38m
19709,2,[XpKb]Laraku,2888,30,1,6,7,14.3%,40m
19730,2,TrunkMonkey,2887,1592,210,202,412,51.0%,25m
19730,2,[xBLx]Spo,2887,1489,165,159,324,50.9%,38m
19730,3,ROC,2887,1521,160,167,327,48.9%,21m
19730,2,Slarck,2887,1216,85,78,163,52.1%,38m
19730,2,[uDuh]XpermentorX,2887,1444,80,50,130,61.5%,42m
19730,2,Flay,2887,513,69,58,127,54.3%,31m
19730,2,bronchmaster,2887,1089,45,40,85,52.9%,35m
19730,2,Lakis,2887,1109,41,41,82,50.0%,10m
19730,2,bigboyblue,2887,220,11,9,20,55.0%,38m
19730,2,BulkyToast,2887,210,8,12,20,40.0%,17m
19730,2,ImbaSimba,2887,168,7,7,14,50.0%,32m
19730,3,Mars,2887,218,7,7,14,50.0%,2h
19730,2,Fenriir,2887,204,7,9,16,43.8%,31m
19730,2,Lightingwar,2887,120,4,5,9,44.4%,8m
19730,2,Rayn,2887,118,4,6,10,40.0%,38m
19730,3,Wukong,2887,58,3,0,3,100.0%,38m
19730,3,Anniemouse,2887,58,3,1,4,75.0%,9m
19730,3,Brykon,2887,0,3,2,5,60.0%,6m
19730,2,[SMTH]JackHerer,2887,30,2,3,5,40.0%,14m
19730,2,FroGOFKaoS,2887,51,2,4,6,33.3%,6m
19730,3,[VietCo]Gaubeo,2887,30,1,2,3,33.3%,30m
19730,2,Frain,2887,30,1,3,4,25.0%,33m
19730,2,llllllllllll,2887,27,1,3,4,25.0%,8m
19730,3,Hardstem,2887,30,1,5,6,16.7%,28m
19730,3,Sovereign,2887,0,0,1,1,0.0%,18m
19730,2,[Lowko]SuperSloth,2887,0,0,2,2,0.0%,15m
19730,2,iksseiii,2887,0,0,3,3,0.0%,16m
19757,3,Roko,2886,1570,244,236,480,50.8%,17m
19757,1,SerahSylv,2886,1284,137,126,263,52.1%,18m
19757,2,RookieWookie,2886,1624,126,111,237,53.2%,20m
19757,1,[xRtGac]Achillies,2886,1603,102,99,201,50.7%,19m
19757,1,[xLgNx]Jules,2886,769,67,65,132,50.8%,40m
19757,1,Borogrove,2886,638,52,46,98,53.1%,10m
19757,2,ToganX,2886,1074,41,41,82,50.0%,24m
19757,2,SewerWizard,2886,383,38,36,74,51.4%,15m
19757,3,[KING3]tehpenix,2886,934,37,36,73,50.7%,10m
19757,2,[SSV]BiHiTRiLL,2886,528,23,17,40,57.5%,35m
19757,3,Ylk,2886,517,22,15,37,59.5%,3m
19757,2,KMo,2886,506,21,19,40,52.5%,33m
19757,1,[xLiTx]HoboMcGavs,2886,416,17,23,40,42.5%,4m
19757,1,[CNG]Job,2886,368,14,16,30,46.7%,9m
19757,3,bloodybird,2886,292,14,19,33,42.4%,32m
19757,1,Panthre,2886,233,8,3,11,72.7%,2h
19757,3,Blardin,2886,234,8,6,14,57.1%,1h
19757,2,BrightSkull,2886,172,7,7,14,50.0%,27m
19757,3,PolyPslinger,2886,146,6,4,10,60.0%,24m
19757,2,Charstuky,2886,178,6,4,10,60.0%,32m
19757,2,[Pr0h4x]Anarchy,2886,142,5,3,8,62.5%,41m
19757,2,[xRtGac]Goob,2886,90,4,4,8,50.0%,37m
19757,2,BigMike,2886,0,3,2,5,60.0%,2h
19757,3,JohanTnt,2886,121,2,3,5,40.0%,23m
19757,3,Kootercrook,2886,0,2,3,5,40.0%,18m
19757,1,[sblxs]Jigsaw,2886,48,2,5,7,28.6%,11m
19757,2,[REPORT]RaNdOmIzE,2886,0,1,1,2,50.0%,16m
19757,1,demonyuspunk,2886,0,1,7,8,12.5%,32m
19757,3,[PaNZR]Fwutter,2886,0,0,1,1,0.0%,18m
19757,2,Trips,2886,0,0,2,2,0.0%,18m
19787,2,Pint,2885,1321,287,263,550,52.2%,16m
19787,3,Benis,2885,1008,60,75,135,44.4%,28m
19787,2,TheHunterB,2885,1273,49,45,94,52.1%,22m
19787,2,[EWM]Blueboy,2885,823,35,37,72,48.6%,32m
19787,3,YoungTrotsky,2885,849,35,54,89,39.3%,42m
19787,2,MicroThis,2885,394,34,28,62,54.8%,36m
19787,2,MachineOsaur,2885,928,34,34,68,50.0%,24m
19787,2,[0825]fittneszerg,2885,814,30,33,63,47.6%,2m
19787,1,[AEUG]kazuki,2885,768,28,28,56,50.0%,25m
19787,1,Uploadersoul,2885,624,23,29,52,44.2%,33m
19787,2,Futuristic,2885,612,21,26,47,44.7%,40m
19787,2,[crispr]Clark,2885,446,20,12,32,62.5%,16m
19787,2,ChookUS,2885,326,20,24,44,45.5%,6m
19787,1,[LARM]Beregonds,2885,330,19,20,39,48.7%,13m
19787,2,makkuro,2885,480,17,16,33,51.5%,14m
19787,2,[SHTR]vailence,2885,387,15,16,31,48.4%,41m
19787,2,NiNJa,2885,263,11,7,18,61.1%,26m
19787,2,Tyler,2885,268,11,8,19,57.9%,1m
19787,2,[QMS]lazaruslong,2885,237,11,12,23,47.8%,4m
19787,2,SuperBug,2885,215,7,4,11,63.6%,18m
19787,2,RatsInACoat,2885,169,7,6,13,53.8%,41m
19787,1,MacroJackson,2885,181,6,4,10,60.0%,1h
19787,3,Rimlare,2885,90,4,2,6,66.7%,32m
19787,2,Green,2885,102,3,1,4,75.0%,35m
19787,1,Enderer,2885,0,3,3,6,50.0%,2h
19787,3,bingus,2885,142,3,4,7,42.9%,28m
19787,1,Michael,2885,140,2,5,7,28.6%,2h
19787,1,[TGosuA]DookieButter,2885,34,2,9,11,18.2%,24m
19787,3,[DarkLS]SLimE,2885,0,1,0,1,100.0%,24m
19787,2,[pntoCL]ParappleX,2885,30,1,6,7,14.3%,16m
19787,1,[sNinja]kraVox,2885,32,1,13,14,7.1%,10m
19787,3,OCAÑA,2885,0,0,1,1,0.0%,41m
19787,2,sleep,2885,0,0,3,3,0.0%,10m
19787,3,[313DET]Papatokes,2885,0,0,4,4,0.0%,27m
19787,2,voidlogic,2885,0,0,4,4,0.0%,37m
19822,1,trackball,2884,1449,241,225,466,51.7%,2m
19822,2,[tCo9]Boosie,2884,862,105,77,182,57.7%,3m
19822,2,[ConFed]gerdel,2884,944,77,67,144,53.5%,42m
19822,2,mayaltika,2884,1384,72,68,140,51.4%,35m
19822,2,Maxz,2884,1248,48,47,95,50.5%,20m
19822,3,Twolings,2884,637,41,22,63,65.1%,29m
19822,2,SilkyChicken,2884,448,35,37,72,48.6%,14m
19822,1,Parthanon,2884,746,27,39,66,40.9%,37m
19822,1,itzQQNaix,2884,308,22,30,52,42.3%,16m
19822,2,[QUIEEE]JoteN,2884,397,19,17,36,52.8%,26m
19822,2,Chronosapien,2884,361,15,9,24,62.5%,42m
19822,1,CptKreep,2884,425,15,17,32,46.9%,11m
19822,2,chppr,2884,227,12,11,23,52.2%,2m
19822,3,[4SDaD]WolverLing,2884,144,5,3,8,62.5%,18m
19822,3,Bubu,2884,122,5,6,11,45.5%,17m
19822,2,Smikens,2884,116,4,2,6,66.7%,32m
19822,2,[CosB]Queven,2884,90,4,5,9,44.4%,10m
19822,2,[TILM]guatamallama,2884,0,3,3,6,50.0%,11m
19822,3,FaKaWath,2884,86,3,3,6,50.0%,10m
19822,1,llllllllllll,2884,0,3,4,7,42.9%,3h
19822,2,BakkaBot,2884,60,2,8,10,20.0%,3m
19822,3,Mtt,2884,0,1,0,1,100.0%,39m
19822,3,InternetDave,2884,0,0,1,1,0.0%,24m
19822,3,[GOPERÚ]TRAX,2884,0,0,1,1,0.0%,17m
19822,3,BlackBloc,2884,0,0,2,2,0.0%,23m
19822,3,PlasmaWaffle,2884,0,0,5,5,0.0%,20m
19848,1,Drballin,2883,1632,414,371,785,52.7%,25m
19848,2,[YD2K]BabiWobi,2883,1552,198,164,362,54.7%,33m
19848,3,[SHOOTU]foogoo,2883,1447,197,194,391,50.4%,17m
19848,2,Hilka,2883,793,106,101,207,51.2%,10m
19848,1,ODS,2883,1035,86,89,175,49.1%,16m
19848,2,paulex,2883,1235,71,67,138,51.4%,41m
19848,2,Mysterious,2883,522,45,30,75,60.0%,39m
19848,2,[JTRUMP]MilesCru,2883,725,42,32,74,56.8%,20m
19848,3,BarnyStinson,2883,360,41,31,72,56.9%,20m
19848,3,DrPootytang,2883,667,34,11,45,75.6%,12m
19848,1,[LgnTDS]IIIITesta,2883,922,33,40,73,45.2%,16m
19848,2,Elitesko,2883,417,30,25,55,54.5%,42m
19848,2,Loleverywher,2883,613,26,17,43,60.5%,15m
19848,2,YawningPoet,2883,647,26,25,51,51.0%,21m
19848,2,[AbcCo]yozerg,2883,332,23,15,38,60.5%,8m
19848,2,[xLgNx]walker,2883,546,20,19,39,51.3%,16m
19848,2,Whatsittoya,2883,562,20,20,40,50.0%,34m
19848,2,[HØST]VicBansemer,2883,339,13,9,22,59.1%,32m
19848,1,[PUlink]Unknown,2883,314,12,9,21,57.1%,2h
19848,3,[Grayon]CPCHOWDER,2883,303,11,5,16,68.8%,27m
19848,2,lacontraseña,2883,320,10,16,26,38.5%,40m
19848,2,BURUJU,2883,250,9,15,24,37.5%,32m
19848,2,BLITZ,2883,143,5,3,8,62.5%,6m
19848,2,DANZH,2883,128,4,2,6,66.7%,14m
19848,3,Nibelz,2883,136,4,3,7,57.1%,2h
19848,3,Fyrbolg,2883,114,4,3,7,57.1%,39m
19848,1,Cintronology,2883,151,4,4,8,50.0%,2h
19848,2,[BNKRZ]Tyler,2883,60,4,6,10,40.0%,20m
19848,2,[eX]EFFECT,2883,120,4,7,11,36.4%,32m
19848,2,NivixParadox,2883,112,4,11,15,26.7%,30m
19848,3,gouda,2883,0,1,0,1,100.0%,18m
19848,3,DanyeEast,2883,0,1,0,1,100.0%,12m
19848,3,[iFree]FreeAcctGood,2883,30,1,1,2,50.0%,6m
19848,2,Tinister,2883,93,1,2,3,33.3%,37m
19848,3,anxiety,2883,0,0,1,1,0.0%,15m
19883,2,Zaine,2882,1465,306,293,599,51.1%,21m
19883,1,[Macac0]virusst,2882,937,100,107,207,48.3%,10m
19883,2,[FxB]Brosek,2882,1561,76,66,142,53.5%,40m
19883,2,chaosal,2882,1610,68,71,139,48.9%,36m
19883,3,DeathReaper,2882,1260,50,58,108,46.3%,17m
19883,2,[Elys]RatlerX,2882,821,45,41,86,52.3%,39m
19883,1,Apoocalypse,2882,882,37,34,71,52.1%,10m
19883,3,RicHunter,2882,825,31,38,69,44.9%,17m
19883,3,zad,2882,646,24,19,43,55.8%,42m
19883,2,BeautifulCow,2882,523,23,21,44,52.3%,40m
19883,1,JCookie,2882,588,20,24,44,45.5%,25m
19883,1,FacePuncher,2882,405,16,18,34,47.1%,17m
19883,1,NumbNutz,2882,368,14,11,25,56.0%,2h
19883,3,Balbausaurus,2882,127,9,7,16,56.2%,20m
19883,2,KHALTHEBOLD,2882,197,9,9,18,50.0%,8m
19883,2,ThunderDemon,2882,204,7,12,19,36.8%,32m
19883,1,Propain,2882,188,6,5,11,54.5%,22m
19883,2,Hervedgerse,2882,164,5,4,9,55.6%,32m
19883,3,Shinugure,2882,30,5,5,10,50.0%,24m
19883,1,Nox,2882,173,5,7,12,41.7%,2h
19883,1,NoName,2882,0,3,5,8,37.5%,2h
19883,2,Rankfield,2882,0,2,3,5,40.0%,2h
19883,3,cirE,2882,0,1,0,1,100.0%,33m
19883,3,opprotoss,2882,0,1,0,1,100.0%,16m
19883,2,ALUCARD,2882,0,1,1,2,50.0%,17m
19908,3,DivineDust,2881,656,84,94,178,47.2%,24m
19908,1,TheBaron,2881,1424,70,60,130,53.8%,11m
19908,2,[DarkAG]Meta,2881,907,43,25,68,63.2%,16m
19908,1,[Ldybys]Almaviva,2881,898,43,44,87,49.4%,32m
19908,2,Soar,2881,803,40,36,76,52.6%,41m
19908,2,DrDope,2881,559,27,22,49,55.1%,40m
19908,2,LLLLLLLLLLl,2881,571,20,23,43,46.5%,1m
19908,2,Unorthodox,2881,444,17,13,30,56.7%,38m
19908,2,Jimmaye,2881,301,15,17,32,46.9%,13m
19908,2,Techko,2881,335,12,14,26,46.2%,8m
19908,2,NiceGuyJr,2881,230,10,5,15,66.7%,21m
19908,3,Tsias,2881,192,8,4,12,66.7%,3m
19908,2,ProtossOP,2881,268,8,14,22,36.4%,4m
19908,3,Lauroman,2881,202,7,6,13,53.8%,13m
19908,2,Lostname,2881,198,7,8,15,46.7%,24m
19908,3,DiamondSutra,2881,222,6,12,18,33.3%,30m
19908,2,Wrecker,2881,144,5,7,12,41.7%,30m
19908,1,[CARO]AfterNoonD,2881,94,4,10,14,28.6%,16m
19908,1,danny,2881,136,4,13,17,23.5%,29m
19908,2,[matar]Player,2881,0,3,3,6,50.0%,11m
19908,2,VooDooJuju,2881,128,3,4,7,42.9%,5m
19908,1,Thal,2881,30,3,6,9,33.3%,39m
19908,1,Knightmare,2881,0,1,0,1,100.0%,13m
19908,3,JaHa,2881,0,1,2,3,33.3%,60m
19908,2,Zinloos,2881,30,1,2,3,33.3%,36m
19908,2,Lunick,2881,30,1,5,6,16.7%,24m
19908,3,huntdog,2881,0,0,1,1,0.0%,17m
19908,2,[SC2MOO]Butnuckle,2881,0,0,2,2,0.0%,10m
19908,2,[TGosuA]LTkowie,2881,0,0,3,3,0.0%,6m
19937,1,youGotEeezzd,2880,1650,399,372,771,51.8%,6m
19937,1,hobbs,2880,1375,297,264,561,52.9%,27m
19937,1,Vietoronto,2880,903,68,66,134,50.7%,29m
19937,2,Spondylo,2880,1365,62,50,112,55.4%,17m
19937,2,kurby,2880,658,41,41,82,50.0%,29m
19937,2,ShiaLaBeouf,2880,293,34,24,58,58.6%,15m
19937,3,[GØSU]Tracker,2880,854,28,43,71,39.4%,3m
19937,2,donut,2880,579,26,22,48,54.2%,40m
19937,3,BoonesZoomie,2880,392,17,10,27,63.0%,20m
19937,2,zeckal,2880,379,15,14,29,51.7%,14m
19937,3,[GOPERÚ]MACHERFL,2880,360,13,11,24,54.2%,3m
19937,2,[xRtGac]Medivac,2880,256,10,15,25,40.0%,42m
19937,2,[BScard]BossHogg,2880,174,7,6,13,53.8%,32m
19937,3,Eden,2880,204,7,6,13,53.8%,24m
19937,3,AMan,2880,190,6,3,9,66.7%,22m
19937,3,Sckrottymous,2880,0,5,2,7,71.4%,3h
19937,3,[GGMESP]zZslenyerZz,2880,129,5,2,7,71.4%,3m
19937,3,khu,2880,114,5,4,9,55.6%,13m
19937,2,sanv,2880,154,5,9,14,35.7%,23m
19937,1,[PasT1]Bigshots,2880,182,5,11,16,31.2%,31m
19937,2,[Kappa]FeedMe,2880,0,3,2,5,60.0%,2h
19937,3,[CoCoa]Brojoe,2880,0,3,2,5,60.0%,22m
19937,3,WildPants,2880,0,3,2,5,60.0%,3m
19937,2,Babytosser,2880,90,3,6,9,33.3%,34m
19937,3,PQPSzWIFFFFF,2880,125,2,1,3,66.7%,2h
19937,1,Ethical,2880,85,2,1,3,66.7%,34m
19937,3,[H1]Truth,2880,30,1,2,3,33.3%,8m
19937,3,Joey,2880,0,0,1,1,0.0%,40m
19937,1,[TRedT]VooDooDoll,2880,0,0,1,1,0.0%,2h
19937,3,[Dac]LozanoDAC,2880,0,0,1,1,0.0%,24m
19937,3,tluongMD,2880,0,0,1,1,0.0%,6m
19968,2,Ronin,2879,1574,225,200,425,52.9%,14m
19968,1,Rampage,2879,1526,184,186,370,49.7%,21m
19968,2,Wooden,2879,1057,149,136,285,52.3%,17m
19968,2,RYJIU,2879,1469,85,72,157,54.1%,42m
19968,2,FanTom,2879,1545,75,72,147,51.0%,27m
19968,2,QuiDx,2879,812,42,39,81,51.9%,39m
19968,2,UntouchableJ,2879,747,41,27,68,60.3%,26m
19968,1,[FxB]Coast,2879,1119,38,47,85,44.7%,33m
19968,2,[WuTang]BobLoblaw,2879,816,28,33,61,45.9%,3m
19968,2,[INHNJA]Thewarhammer,2879,134,24,21,45,53.3%,3m
19968,1,CragHack,2879,428,18,17,35,51.4%,19m
19968,2,RoughDayTeam,2879,347,12,12,24,50.0%,24m
19968,2,Pikachu,2879,260,10,8,18,55.6%,26m
19968,2,[KerriS]Llamallab,2879,206,8,4,12,66.7%,14m
19968,3,backspace,2879,227,7,1,8,87.5%,3m
19968,2,[TOFF]Nonbinary,2879,196,7,5,12,58.3%,4m
19968,2,Ken,2879,90,6,6,12,50.0%,16m
19968,1,EVOkrogan,2879,170,6,8,14,42.9%,24m
19968,2,[Danilo]Anjo,2879,176,6,10,16,37.5%,32m
19968,2,[CTsix]RoboBoogie,2879,154,4,4,8,50.0%,26m
19968,2,freddyjezzy,2879,0,3,2,5,60.0%,32m
19968,2,itsatrap,2879,173,3,6,9,33.3%,44m
19968,1,[Lp]FORoMIZ,2879,48,2,1,3,66.7%,2h
19968,3,Caribou,2879,0,2,1,3,66.7%,27m
19968,3,Tzuyu,2879,96,2,2,4,50.0%,8m
19968,2,AnonymousGuy,2879,0,2,2,4,50.0%,57m
19968,2,EpicJawa,2879,0,1,1,2,50.0%,24m
19968,2,Stevo,2879,0,1,1,2,50.0%,26m
19968,3,BabyPants,2879,0,0,1,1,0.0%,35m
19968,3,UDeadYeah,2879,0,0,1,1,0.0%,19m
19968,2,Peonmyhall,2879,0,0,2,2,0.0%,24m
19999,2,PlayerTwo,2878,1435,131,98,229,57.2%,20m
19999,1,[LAT18]Jalza,2878,1485,78,70,148,52.7%,12m
19999,2,kconekrap,2878,1024,45,37,82,54.9%,27m
19999,2,PlasticNuts,2878,712,27,32,59,45.8%,6m
19999,2,letsgosmokes,2878,486,22,19,41,53.7%,34m
19999,1,Leulz,2878,624,20,28,48,41.7%,15m
19999,2,Nolith,2878,318,14,5,19,73.7%,2h
19999,2,Zait,2878,191,14,15,29,48.3%,41m
19999,2,Ksni,2878,356,14,15,29,48.3%,11m
19999,2,Odysseus,2878,329,12,11,23,52.2%,6m
19999,2,[ctrs]Naki,2878,320,12,13,25,48.0%,36m
19999,1,bluemonday,2878,330,11,19,30,36.7%,39m
19999,1,RestlessAPI,2878,48,6,3,9,66.7%,53m
19999,2,starveliz,2878,138,5,7,12,41.7%,34m
19999,1,Slagsdale,2878,182,5,14,19,26.3%,25m
19999,1,[iDrunk]eric,2878,97,4,3,7,57.1%,2h
19999,1,Clausewitz,2878,134,4,16,20,20.0%,39m
19999,3,Huevito,2878,58,3,1,4,75.0%,26m
19999,3,DrinkingNow,2878,0,3,2,5,60.0%,10m
19999,1,Pato,2878,0,3,3,6,50.0%,36m
19999,2,[FNDog]TIMBE,2878,44,2,2,4,50.0%,24m
19999,1,Kapowy,2878,30,2,7,9,22.2%,35m
19999,3,Escendo,2878,0,1,0,1,100.0%,8m
19999,1,[GGMESP]roge,2878,0,1,0,1,100.0%,20m
19999,3,LeoS,2878,0,1,0,1,100.0%,16m
19999,2,OverMined,2878,0,1,1,2,50.0%,2m
19999,2,Thane,2878,88,1,2,3,33.3%,33m
19999,1,[RUMB]Moustro,2878,97,1,6,7,14.3%,2h
19999,3,[TOSSd]HardLemonade,2878,0,0,1,1,0.0%,44m
19999,2,ByZem,2878,0,0,2,2,0.0%,36m
19999,2,OBPagan,2878,0,0,3,3,0.0%,34m
19999,2,[ZERRO]jurias,2878,0,0,3,3,0.0%,36m
20031,1,Galveston,2877,1618,374,363,737,50.7%,18m
20031,2,TheProfeSSor,2877,1550,106,99,205,51.7%,41m
20031,2,PandaExpress,2877,1341,55,44,99,55.6%,17m
20031,2,[Bee]JohnnyBee,2877,853,48,42,90,53.3%,5m
20031,2,TROLLMAN,2877,755,31,26,57,54.4%,10m
20031,2,[BNNN]Mystery,2877,533,23,16,39,59.0%,10m
20031,2,Sleep,2877,378,17,7,24,70.8%,19m
20031,2,smoking,2877,448,17,15,32,53.1%,3m
20031,2,[IDDS]InNoVaTiOn,2877,345,15,9,24,62.5%,8m
20031,3,AreUTheCops,2877,320,13,12,25,52.0%,6m
20031,3,Kuriad,2877,152,13,28,41,31.7%,20m
20031,2,Ryry,2877,345,12,11,23,52.2%,32m
20031,2,Nightwolf,2877,232,9,10,19,47.4%,2m
20031,2,llllllllllll,2877,114,6,2,8,75.0%,36m
20031,3,Yamato,2877,0,4,1,5,80.0%,6m
20031,1,Thetarbolof,2877,118,4,9,13,30.8%,29m
20031,1,lIlIlIlIlIl,2877,48,2,0,2,100.0%,3h
20031,1,NightWalker,2877,0,2,2,4,50.0%,34m
20031,3,Poligney,2877,58,2,3,5,40.0%,39m
20031,2,TheDoctor,2877,62,2,5,7,28.6%,8m
20031,3,[IGeass]KnightOfZero,2877,0,1,0,1,100.0%,8m
20031,1,CashBot,2877,0,1,2,3,33.3%,2h
20031,3,[xCHFx]herndiggle,2877,0,0,1,1,0.0%,20m
20031,3,Wreqz,2877,0,0,1,1,0.0%,6m
20055,1,Pure,2876,1600,365,345,710,51.4%,25m
20055,3,Kheylos,2876,1308,58,44,102,56.9%,6m
20055,2,[CoPa]Lexicon,2876,356,51,49,100,51.0%,36m
20055,2,Brutus,2876,823,46,41,87,52.9%,26m
20055,3,[Uruha]Rushia,2876,593,28,17,45,62.2%,10m
20055,1,Jonk,2876,610,27,34,61,44.3%,12m
20055,2,[GoPctm]Bari,2876,530,24,14,38,63.2%,27m
20055,3,Skynet,2876,418,17,17,34,50.0%,20m
20055,2,Wyler,2876,230,14,19,33,42.4%,32m
20055,2,[DMONlC]SonofMan,2876,256,10,8,18,55.6%,29m
20055,3,Flitcraft,2876,211,8,5,13,61.5%,42m
20055,2,stu,2876,227,7,8,15,46.7%,15m
20055,2,Tyler,2876,206,7,9,16,43.8%,25m
20055,2,[AlIin]Warlord,2876,212,6,8,14,42.9%,5m
20055,2,Tinathellama,2876,143,4,3,7,57.1%,31m
20055,2,LPA,2876,0,3,2,5,60.0%,60m
20055,3,[gumba]THEreaper,2876,121,2,1,3,66.7%,12m
20055,2,newtonelpro,2876,58,2,4,6,33.3%,14m
20055,2,supermech,2876,0,1,0,1,100.0%,2h
20055,3,[SCST]gerrer,2876,30,1,1,2,50.0%,4m
20055,3,emondpph,2876,0,0,1,1,0.0%,40m
20055,2,[DMT1]bigcHENDO,2876,0,0,2,2,0.0%,42m
20055,2,Gattuso,2876,0,0,2,2,0.0%,31m
20078,2,MrPig,2875,1608,117,107,224,52.2%,29m
20078,1,saw,2875,1599,112,106,218,51.4%,12m
20078,2,SilverBack,2875,467,103,97,200,51.5%,32m
20078,2,[AD4C]GripAndRip,2875,314,93,92,185,50.3%,32m
20078,2,[FyHr]MacKayA,2875,660,93,94,187,49.7%,37m
20078,2,HebrewHammer,2875,1606,91,84,175,52.0%,17m
20078,2,spawn,2875,1432,85,79,164,51.8%,36m
20078,1,fluff,2875,1553,82,75,157,52.2%,28m
20078,2,Herzog,2875,541,80,78,158,50.6%,41m
20078,2,DoubleDown,2875,1057,53,54,107,49.5%,29m
20078,2,[AlIin]DaBoss,2875,662,34,18,52,65.4%,39m
20078,2,RebelChara,2875,335,14,9,23,60.9%,11m
20078,2,Vector,2875,390,14,12,26,53.8%,24m
20078,2,PANETAS,2875,244,7,4,11,63.6%,32m
20078,2,freeporter,2875,188,6,5,11,54.5%,9m
20078,3,Darkman,2875,114,5,0,5,100.0%,8m
20078,2,Cthulhu,2875,188,5,6,11,45.5%,39m
20078,1,[PForce]TNTurbo,2875,153,4,7,11,36.4%,29m
20078,3,issue,2875,86,3,3,6,50.0%,23m
20078,1,ScaptainSky,2875,157,3,3,6,50.0%,2h
20078,1,ETERNY,2875,147,3,3,6,50.0%,30m
20078,2,[Epokhé]Sylar,2875,88,3,7,10,30.0%,16m
20078,3,[f0G]DigDillenger,2875,58,3,12,15,20.0%,2m
20078,3,Olgoth,2875,30,2,0,2,100.0%,16m
20078,3,Foolish,2875,30,2,1,3,66.7%,27m
20078,3,[TDirT]BigBowser,2875,30,2,1,3,66.7%,20m
20078,2,Zenith,2875,0,2,2,4,50.0%,3h
20078,3,Foxtrot,2875,60,2,2,4,50.0%,17m
20078,1,[CNSC]Aleire,2875,0,0,1,1,0.0%,34m
20078,3,Zanarkand,2875,0,0,1,1,0.0%,42m
20078,2,Slydra,2875,0,0,1,1,0.0%,2h
20078,2,[9thAve]ShoeBaD,2875,0,0,4,4,0.0%,17m
20110,2,MikeHawk,2874,1256,231,214,445,51.9%,32m
20110,2,Dmoney,2874,1562,150,123,273,54.9%,13m
20110,1,Squids,2874,434,114,95,209,54.5%,32m
20110,3,RealNeato,2874,1459,88,75,163,54.0%,11m
20110,2,Kasparov,2874,1293,79,61,140,56.4%,27m
20110,1,Viktortio,2874,262,78,76,154,50.6%,15m
20110,3,FishTaco,2874,1355,59,44,103,57.3%,6m
20110,2,Python,2874,1243,48,50,98,49.0%,2m
20110,2,Crayak,2874,1032,42,35,77,54.5%,7m
20110,2,Umnums,2874,788,35,33,68,51.5%,38m
20110,3,[NPhase]Droneicus,2874,407,15,8,23,65.2%,25m
20110,3,Nuclear,2874,330,14,11,25,56.0%,15m
20110,2,Mizu,2874,369,14,12,26,53.8%,14m
20110,2,[CHAOSV]EntropyDF,2874,344,13,10,23,56.5%,37m
20110,3,[IPFC]VUWO,2874,254,9,6,15,60.0%,20m
20110,2,Mika,2874,207,7,11,18,38.9%,36m
20110,3,zero,2874,140,6,1,7,85.7%,28m
20110,2,Dune,2874,86,6,6,12,50.0%,29m
20110,2,Sodon,2874,197,5,6,11,45.5%,2h
20110,1,Ivellios,2874,48,2,1,3,66.7%,1h
20110,2,iDrone,2874,60,2,7,9,22.2%,14m
20110,1,Zimbru,2874,0,1,0,1,100.0%,22m
20110,2,FallenOne,2874,0,1,2,3,33.3%,34m
20110,2,[Chrisp]Jdog,2874,93,1,4,5,20.0%,49m
20110,1,[VatiCL]Robocop,2874,40,1,12,13,7.7%,35m
20110,3,LeWildWolf,2874,0,0,1,1,0.0%,2h
20110,2,[xLgNx]Seth,2874,0,0,2,2,0.0%,30m
20110,2,nukess,2874,0,0,4,4,0.0%,16m
20138,3,Panashe,2873,1295,87,71,158,55.1%,19m
20138,3,[420SMO]beefus,2873,1320,52,41,93,55.9%,3m
20138,2,[INextI]MechaMarine,2873,1143,51,51,102,50.0%,16m
20138,2,SoloSepuku,2873,436,17,15,32,53.1%,14m
20138,2,[TR1912]rasputin,2873,341,15,15,30,50.0%,35m
20138,1,Malkavian,2873,403,15,16,31,48.4%,19m
20138,2,ColdBeer,2873,373,14,11,25,56.0%,42m
20138,2,Grandzero,2873,332,13,8,21,61.9%,2m
20138,3,[InGt]Otaylig,2873,384,13,27,40,32.5%,26m
20138,2,Cheens,2873,281,11,8,19,57.9%,4m
20138,1,Hillel,2873,306,11,14,25,44.0%,25m
20138,3,[NAUG3]CrazyJezuz,2873,260,10,6,16,62.5%,31m
20138,2,follaboyos,2873,264,10,12,22,45.5%,42m
20138,3,risto,2873,217,8,6,14,57.1%,3h
20138,2,Ohanamontana,2873,230,8,13,21,38.1%,41m
20138,3,[LgnTDS]CORNIJA,2873,166,7,1,8,87.5%,5m
20138,3,Niels,2873,233,7,4,11,63.6%,11m
20138,2,[CBAS3]Omega,2873,214,7,10,17,41.2%,31m
20138,3,lyesacks,2873,30,6,4,10,60.0%,36m
20138,3,Teadip,2873,93,6,6,12,50.0%,2h
20138,3,OPpotatoes,2873,129,3,3,6,50.0%,2h
20138,2,[Zosha]tOmOrrOw,2873,78,3,4,7,42.9%,24m
20138,1,Xenot,2873,90,3,6,9,33.3%,56m
20138,2,Alexstrasza,2873,90,3,6,9,33.3%,32m
20138,2,sharp,2873,40,3,9,12,25.0%,30m
20138,1,Cobalt,2873,48,2,7,9,22.2%,2h
20138,2,Scage,2873,88,1,2,3,33.3%,10m
20138,3,[FESSES]KillEmAlll,2873,0,0,1,1,0.0%,7m
20138,3,Mrdragontits,2873,0,0,2,2,0.0%,12m
20138,2,Chad,2873,0,0,2,2,0.0%,6m
20138,2,life,2873,0,0,3,3,0.0%,17m
20138,2,Kickeruno,2873,0,0,8,8,0.0%,21m
20170,3,IntrinsiC,2872,1611,345,324,669,51.6%,30m
20170,2,[HØST]Namo,2872,1616,182,168,350,52.0%,19m
20170,2,viral,2872,1369,119,88,207,57.5%,34m
20170,2,Silverdeer,2872,1579,84,67,151,55.6%,35m
20170,1,Winna,2872,716,84,83,167,50.3%,25m
20170,3,choasong,2872,1533,77,59,136,56.6%,15m
20170,3,Solagnas,2872,1373,61,43,104,58.7%,23m
20170,2,russo,2872,590,61,56,117,52.1%,34m
20170,3,armindroid,2872,1100,47,36,83,56.6%,18m
20170,2,CherryLeaf,2872,927,40,29,69,58.0%,20m
20170,2,Gracchi,2872,1140,40,47,87,46.0%,19m
20170,2,Jibathy,2872,610,39,40,79,49.4%,16m
20170,1,MACro,2872,714,23,29,52,44.2%,41m
20170,2,[FATwS]FatIsaac,2872,426,20,14,34,58.8%,40m
20170,1,[Epic1]Shock,2872,431,14,17,31,45.2%,25m
20170,3,[LATERs]EAGames,2872,240,12,9,21,57.1%,6m
20170,3,Null,2872,184,7,5,12,58.3%,40m
20170,2,Jawmare,2872,131,6,6,12,50.0%,2h
20170,2,Trot,2872,132,5,4,9,55.6%,27m
20170,1,Calvin,2872,193,5,6,11,45.5%,2h
20170,1,heynevets,2872,48,4,4,8,50.0%,38m
20170,2,MrMad,2872,92,3,6,9,33.3%,16m
20170,2,[iJab]iGimperial,2872,90,3,6,9,33.3%,36m
20170,3,[SDW]Merodiador,2872,97,2,0,2,100.0%,3m
20170,3,MurdereR,2872,60,2,2,4,50.0%,6m
20170,2,MasonisHiga,2872,30,2,3,5,40.0%,20m
20170,3,walnut,2872,58,2,3,5,40.0%,10m
20170,1,zakguo,2872,95,2,5,7,28.6%,8m
20170,2,[GGMESP]NERISEND,2872,30,2,6,8,25.0%,14m
20170,3,wolfn,2872,0,1,0,1,100.0%,13m
20170,2,ThroatPunchr,2872,0,1,0,1,100.0%,2h
20170,3,DarkWolfdog,2872,0,1,1,2,50.0%,23m
20170,3,[woL0Lo]Flayer,2872,0,0,1,1,0.0%,20m
20170,3,Sean,2872,0,0,1,1,0.0%,28m
20170,3,Wookiee,2872,0,0,1,1,0.0%,40m
20170,2,Snowman,2872,0,0,2,2,0.0%,38m
20206,2,Reflauta,2871,1587,198,182,380,52.1%,15m
20206,1,xKonic,2871,1507,115,109,224,51.3%,21m
20206,2,WILY,2871,892,78,61,139,56.1%,16m
20206,1,IIIIIIIII,2871,1006,57,39,96,59.4%,15m
20206,2,Wolf,2871,923,36,34,70,51.4%,16m
20206,2,Cocomoco,2871,781,33,28,61,54.1%,11m
20206,1,tvu,2871,165,25,26,51,49.0%,37m
20206,3,[Hrtbkn]Shogunx,2871,586,24,21,45,53.3%,34m
20206,2,MUnGkEy,2871,460,18,18,36,50.0%,32m
20206,3,[Rodd]MintWizard,2871,462,17,10,27,63.0%,40m
20206,2,Lombardo,2871,418,16,17,33,48.5%,38m
20206,2,Greedo,2871,316,12,14,26,46.2%,8m
20206,2,eruza,2871,243,10,9,19,52.6%,42m
20206,3,Advncd,2871,197,8,7,15,53.3%,5m
20206,3,[Life8D]Cyclone,2871,146,7,4,11,63.6%,48m
20206,3,Prometheus,2871,110,6,4,10,60.0%,39m
20206,2,Olka,2871,157,6,5,11,54.5%,9m
20206,1,orion,2871,246,6,13,19,31.6%,25m
20206,1,Greek,2871,0,5,2,7,71.4%,31m
20206,1,Resilience,2871,96,5,5,10,50.0%,20m
20206,3,[YNEZ]THCExtract,2871,114,4,4,8,50.0%,10m
20206,1,Shaolinsnake,2871,119,3,1,4,75.0%,39m
20206,1,AeIOwnedU,2871,72,2,11,13,15.4%,17m
20206,2,Mist,2871,0,1,1,2,50.0%,24m
20206,3,TheJuice,2871,0,0,1,1,0.0%,11m
20206,2,[PELO]Iceman,2871,0,0,3,3,0.0%,36m
20206,2,[Algrus]Algrus,2871,0,0,4,4,0.0%,35m
20233,3,KrispyKreme,2870,432,65,46,111,58.6%,12m
20233,1,[samnx]samurayx,2870,1077,42,47,89,47.2%,39m
20233,3,MeowMeowKat,2870,1013,41,35,76,53.9%,20m
20233,1,[cl0udM]Hunter,2870,775,37,38,75,49.3%,2m
20233,3,[DNKCFT]PrEaTure,2870,596,22,20,42,52.4%,28m
20233,2,Rajinazn,2870,574,21,23,44,47.7%,10m
20233,3,[AiMB]fiziokrat,2870,424,19,5,24,79.2%,8m
20233,1,[StmBrk]Salamander,2870,383,15,17,32,46.9%,25m
20233,2,AnorLondo,2870,378,14,15,29,48.3%,39m
20233,2,IIIIIIIIIIII,2870,324,13,10,23,56.5%,4m
20233,2,Runslow,2870,238,13,14,27,48.1%,9m
20233,2,Caessar,2870,338,13,14,27,48.1%,15m
20233,2,Xtra,2870,319,12,3,15,80.0%,2h
20233,3,[Onixx]BeepNerf,2870,232,9,7,16,56.2%,13m
20233,1,[kØ]Nicoo,2870,266,8,18,26,30.8%,5m
20233,2,RickeyBobby,2870,178,7,9,16,43.8%,14m
20233,2,Dawse,2870,134,6,7,13,46.2%,37m
20233,3,AlcatraZ,2870,0,3,2,5,60.0%,38m
20233,3,CrowOfLight,2870,0,2,3,5,40.0%,40m
20233,3,Deto,2870,0,1,0,1,100.0%,36m
20233,3,PotatoPc,2870,0,1,4,5,20.0%,16m
20233,2,compoCision,2870,30,1,5,6,16.7%,19m
20233,1,[FdSw]DeSquid,2870,0,1,7,8,12.5%,50m
20233,3,[EZDUNK]Mindgames,2870,0,0,2,2,0.0%,12m
20233,1,BucketMan,2870,0,0,2,2,0.0%,2h
20258,2,Eccentrix,2869,1448,64,68,132,48.5%,10m
20258,2,krey,2869,292,51,44,95,53.7%,37m
20258,2,[Xsplsn]Nine,2869,932,42,32,74,56.8%,24m
20258,2,Preston,2869,860,31,33,64,48.4%,30m
20258,3,Antonio,2869,620,27,26,53,50.9%,20m
20258,2,cchyung,2869,341,23,23,46,50.0%,32m
20258,2,IIIIIIIIIIII,2869,556,22,23,45,48.9%,16m
20258,2,AMON,2869,436,16,21,37,43.2%,16m
20258,2,Aresmar,2869,370,14,14,28,50.0%,38m
20258,3,Ollraaaa,2869,350,13,11,24,54.2%,31m
20258,2,NameWasTaken,2869,320,12,9,21,57.1%,2m
20258,2,[TTHHCC]exhale,2869,310,11,12,23,47.8%,41m
20258,2,BadWolf,2869,284,10,9,19,52.6%,36m
20258,2,[m4hire]BeetrootBro,2869,252,10,13,23,43.5%,16m
20258,2,Sopor,2869,216,9,5,14,64.3%,14m
20258,2,ItsGamePlsHf,2869,201,9,8,17,52.9%,16m
20258,2,Ender,2869,191,8,8,16,50.0%,11m
20258,2,AspieTravLr,2869,146,8,9,17,47.1%,9m
20258,3,[MPPA]Ichijo,2869,166,6,2,8,75.0%,8m
20258,1,KingDragon,2869,209,6,14,20,30.0%,23m
20258,1,TheKingMoose,2869,97,4,6,10,40.0%,2h
20258,2,Audioslave,2869,114,2,3,5,40.0%,41m
20258,3,AMERKING,2869,0,1,0,1,100.0%,27m
20258,3,Makio,2869,0,1,0,1,100.0%,41m
20258,3,MpK,2869,30,1,1,2,50.0%,19m
20258,2,Psyblade,2869,88,1,3,4,25.0%,10m
20258,3,Bubby,2869,0,0,1,1,0.0%,17m
20258,3,OmniKai,2869,0,0,1,1,0.0%,24m
20258,3,[TCBT]LSPLeoNydus,2869,0,0,2,2,0.0%,31m
20287,3,SoHotSoFly,2868,1025,214,204,418,51.2%,3m
20287,1,Johny,2868,1626,144,143,287,50.2%,4m
20287,2,Xipetotek,2868,1604,97,98,195,49.7%,30m
20287,3,Clossius,2868,606,60,41,101,59.4%,13m
20287,3,McBlanc,2868,487,21,8,29,72.4%,27m
20287,2,LaBonte,2868,392,18,14,32,56.2%,24m
20287,2,[Pineap]PineapleLord,2868,467,16,17,33,48.5%,2m
20287,3,[nomame]minifig,2868,378,15,9,24,62.5%,15m
20287,2,[Mlol]Nane,2868,419,15,19,34,44.1%,30m
20287,2,HellSorC,2868,292,12,8,20,60.0%,19m
20287,2,bulakenyo,2868,302,11,16,27,40.7%,39m
20287,2,CMGtml,2868,252,9,8,17,52.9%,19m
20287,2,[VFam]GamerGrimm,2868,180,7,11,18,38.9%,32m
20287,1,[DhZPro]Dan,2868,234,7,17,24,29.2%,15m
20287,3,[MIGAN]CMustard,2868,223,6,4,10,60.0%,17m
20287,2,MCPhoenix,2868,101,6,6,12,50.0%,39m
20287,2,[JM2]crzydrgn,2868,122,5,9,14,35.7%,13m
20287,1,IlIlIlIlIlIl,2868,0,4,2,6,66.7%,7m
20287,2,Trockson,2868,30,4,4,8,50.0%,36m
20287,2,[BChick]raynorlou,2868,102,3,1,4,75.0%,14m
20287,3,Lugotech,2868,0,3,2,5,60.0%,18m
20287,2,Omega,2868,64,3,8,11,27.3%,32m
20287,3,OrcPeon,2868,0,1,1,2,50.0%,26m
20287,2,KingBonobo,2868,88,1,2,3,33.3%,37m
20287,3,MinscBoo,2868,0,0,2,2,0.0%,39m
20287,1,Ghost,2868,0,0,6,6,0.0%,24m
20313,1,Colt,2867,1615,359,340,699,51.4%,6m
20313,1,FrutillitA,2867,1124,190,171,361,52.6%,15m
20313,3,BlueGrimReap,2867,1511,102,92,194,52.6%,6m
20313,2,Splorgh,2867,1581,83,57,140,59.3%,29m
20313,2,ViciousBlade,2867,1439,60,53,113,53.1%,35m
20313,2,[Exper]darkmatterr,2867,1267,51,49,100,51.0%,39m
20313,3,partyMatt,2867,793,40,25,65,61.5%,7m
20313,2,SpiderMind,2867,818,37,28,65,56.9%,11m
20313,3,[f0rfun]DeadlyKitten,2867,850,33,27,60,55.0%,36m
20313,3,[DETER]Crustaoy,2867,728,32,19,51,62.7%,14m
20313,2,zergkiller,2867,683,26,26,52,50.0%,31m
20313,1,intrepidmonk,2867,708,24,28,52,46.2%,32m
20313,2,Zanti,2867,368,16,14,30,53.3%,2m
20313,3,JhoeTron,2867,334,13,3,16,81.2%,40m
20313,1,[ANZ]KermitoniT,2867,245,12,8,20,60.0%,24m
20313,3,potatohead,2867,332,11,21,32,34.4%,29m
20313,3,Jasonion,2867,200,7,6,13,53.8%,13m
20313,3,Moose,2867,90,7,9,16,43.8%,9m
20313,3,Kerrigan,2867,166,6,3,9,66.7%,30m
20313,2,Zile,2867,117,5,3,8,62.5%,23m
20313,3,LucianogGSG,2867,0,4,1,5,80.0%,6m
20313,2,[ThEps]Dread,2867,159,4,3,7,57.1%,2m
20313,3,skEdwArd,2867,0,3,2,5,60.0%,6m
20313,2,[Tyber]Jettn,2867,133,3,3,6,50.0%,5m
20313,3,CyberCarlos,2867,30,2,0,2,100.0%,20m
20313,3,Haise,2867,58,2,2,4,50.0%,30m
20313,3,[YLG]NuTz,2867,0,0,1,1,0.0%,15m
20313,3,[3DLANS]Shinigami,2867,0,0,1,1,0.0%,37m
20313,3,Rebel,2867,0,0,2,2,0.0%,13m
20342,1,yOkai,2866,1264,48,54,102,47.1%,5m
20342,3,[SHWFTR]Stinson,2866,864,45,24,69,65.2%,11m
20342,2,[FALURS]Jingles,2866,417,24,5,29,82.8%,9m
20342,3,[BRUHHV]bbnose,2866,476,19,14,33,57.6%,40m
20342,2,[lighti]Ironsquire,2866,248,16,13,29,55.2%,41m
20342,2,ANTZ,2866,317,11,11,22,50.0%,32m
20342,2,ItsmeChaz,2866,243,10,11,21,47.6%,27m
20342,2,DJRWizard,2866,128,8,11,19,42.1%,37m
20342,2,[LBHS]Tebas,2866,140,5,3,8,62.5%,5m
20342,2,darkfelon,2866,114,5,4,9,55.6%,6m
20342,2,[ÒwÓb]Zero,2866,0,4,2,6,66.7%,11m
20342,2,[400s]NeFeRoX,2866,0,3,2,5,60.0%,5m
20342,3,Armand,2866,0,3,2,5,60.0%,34m
20342,3,khaeron,2866,58,2,3,5,40.0%,30m
20342,3,rubrapter,2866,0,1,0,1,100.0%,22m
20342,3,[lsGl]AngryOsprey,2866,30,1,2,3,33.3%,41m
20342,3,BANDIDON,2866,0,0,1,1,0.0%,10m
20342,2,AcHiLLeS,2866,0,0,2,2,0.0%,9m
20360,2,Dockavok,2865,1356,100,88,188,53.2%,17m
20360,2,StarCat,2865,1574,87,86,173,50.3%,27m
20360,1,[OIGE]Amras,2865,693,78,75,153,51.0%,41m
20360,2,[x5MeOx]Rezlin,2865,719,73,72,145,50.3%,32m
20360,1,[GoDk]oPKingTroy,2865,1224,43,52,95,45.3%,11m
20360,2,RocketJ,2865,843,32,32,64,50.0%,35m
20360,2,Hydra,2865,358,21,15,36,58.3%,9m
20360,3,Gabagool,2865,275,18,12,30,60.0%,11m
20360,2,[SBFS]Zread,2865,476,16,16,32,50.0%,36m
20360,2,Hallahan,2865,317,13,12,25,52.0%,35m
20360,1,[PPC]Thomas,2865,298,10,17,27,37.0%,41m
20360,2,[ATSMOI]KarlMacks,2865,220,9,9,18,50.0%,15m
20360,3,Xiep,2865,108,6,2,8,75.0%,6m
20360,3,Carlitos,2865,120,5,4,9,55.6%,27m
20360,3,Xero,2865,170,5,4,9,55.6%,27m
20360,3,[Raynor]Zindar,2865,196,5,5,10,50.0%,60m
20360,3,[Fever]llllllllllll,2865,114,4,4,8,50.0%,39m
20360,3,ogSaber,2865,116,4,4,8,50.0%,30m
20360,3,soupcan,2865,0,4,4,8,50.0%,34m
20360,2,Predictable,2865,116,2,4,6,33.3%,27m
20360,1,Triscut,2865,0,1,0,1,100.0%,1h
20360,3,Gandalf,2865,30,1,2,3,33.3%,35m
20360,2,FernandoAncc,2865,0,1,2,3,33.3%,2m
20360,2,gaibsiv,2865,88,1,3,4,25.0%,13m
20360,1,PHT,2865,0,1,6,7,14.3%,38m
20360,2,REXX,2865,30,1,8,9,11.1%,6m
20360,3,Viscosity,2865,0,0,1,1,0.0%,38m
20360,2,[ZES]Louis,2865,0,0,5,5,0.0%,2h
20388,2,BOgus,2864,1564,108,97,205,52.7%,26m
20388,1,[dMdC]SuperHella,2864,587,65,58,123,52.8%,41m
20388,1,[SWlNE]Depre,2864,1584,58,65,123,47.2%,33m
20388,3,[BLKOPS]Mellomike,2864,896,55,38,93,59.1%,7m
20388,2,FLu,2864,849,49,28,77,63.6%,35m
20388,2,Velken,2864,1169,48,44,92,52.2%,22m
20388,3,ZerViaRz,2864,1006,38,35,73,52.1%,3m
20388,2,Holz,2864,309,15,7,22,68.2%,24m
20388,2,Darwin,2864,374,14,12,26,53.8%,29m
20388,2,Crazylegs,2864,313,13,5,18,72.2%,42m
20388,1,Clocking,2864,294,12,11,23,52.2%,2h
20388,3,[FODAC]UndeaD,2864,310,11,12,23,47.8%,17m
20388,2,verjox,2864,244,8,7,15,53.3%,4m
20388,2,Cyberboss,2864,179,6,6,12,50.0%,36m
20388,1,[FnC]Chips,2864,97,5,2,7,71.4%,2h
20388,1,Navius,2864,96,2,0,2,100.0%,2h
20388,2,creAtive,2864,30,2,2,4,50.0%,24m
20388,3,PKKovacs,2864,48,2,3,5,40.0%,20m
20388,3,Dragon,2864,30,1,1,2,50.0%,27m
20388,3,lcsulla,2864,0,0,1,1,0.0%,20m
20388,3,theubl,2864,0,0,2,2,0.0%,37m
20388,2,Stanna,2864,0,0,3,3,0.0%,39m
20410,1,[FromLA]Berty,2863,1625,357,345,702,50.9%,7m
20410,2,IdunPlayFayr,2863,1555,209,211,420,49.8%,31m
20410,2,Relax,2863,1443,71,72,143,49.7%,37m
20410,2,Wolverine,2863,716,69,51,120,57.5%,3m
20410,2,[GFT]EndOfSeattle,2863,1448,64,60,124,51.6%,36m
20410,2,Sejaay,2863,590,24,20,44,54.5%,24m
20410,2,jerry,2863,587,22,20,42,52.4%,38m
20410,2,yerinbaek,2863,446,18,16,34,52.9%,39m
20410,2,[VM]shiro,2863,494,17,21,38,44.7%,4m
20410,2,ricci,2863,410,15,15,30,50.0%,14m
20410,2,[BYOD]grass,2863,346,12,16,28,42.9%,32m
20410,2,Xenomorph,2863,156,11,14,25,44.0%,9m
20410,2,IIllIlIlIIl,2863,267,9,3,12,75.0%,3h
20410,2,Entropy,2863,146,8,8,16,50.0%,26m
20410,2,Estalone,2863,176,7,9,16,43.8%,15m
20410,2,Sobrado,2863,114,5,4,9,55.6%,14m
20410,2,VichoLabra,2863,48,4,2,6,66.7%,2h
20410,3,zoidburrrrrg,2863,58,3,0,3,100.0%,37m
20410,2,EmMenTal,2863,46,3,3,6,50.0%,1h
20410,3,[Cullen]Alcatranz,2863,30,2,1,3,66.7%,27m
20410,3,shadowhand,2863,30,1,1,2,50.0%,28m
20410,1,[PTHero]zax,2863,97,1,2,3,33.3%,9m
20410,2,[Bee]Seedsy,2863,0,1,4,5,20.0%,5m
20410,3,[PwT]NoWaY,2863,0,0,1,1,0.0%,13m
20410,3,Schorn,2863,0,0,1,1,0.0%,27m
20410,3,glacierfresh,2863,0,0,1,1,0.0%,28m
20410,2,[Lowko]PartyTrain,2863,0,0,3,3,0.0%,42m
20410,1,Thrillhouse,2863,0,0,8,8,0.0%,11m
20438,3,idacrap,2862,1600,100,87,187,53.5%,6m
20438,1,IsmaTerr,2862,1126,63,66,129,48.8%,11m
20438,2,Rifshadow,2862,809,54,39,93,58.1%,14m
20438,1,CatPaw,2862,407,32,33,65,49.2%,15m
20438,1,[EThugz]WiZecraX,2862,254,12,12,24,50.0%,25m
20438,2,Byte,2862,302,10,10,20,50.0%,39m
20438,3,[NeAs]Asteur,2862,140,5,3,8,62.5%,27m
20438,2,MarineThots,2862,105,3,2,5,60.0%,19m
20438,1,KasM,2862,0,3,3,6,50.0%,3h
20438,3,madskittles,2862,30,2,0,2,100.0%,26m
20438,3,RyTCD,2862,30,2,0,2,100.0%,24m
20438,3,[pepis]ClownGamer,2862,97,2,0,2,100.0%,49m
20438,3,HÿÐÐEN,2862,58,2,2,4,50.0%,20m
20438,2,ifakeram,2862,120,2,2,4,50.0%,1h
20438,3,selym,2862,0,1,0,1,100.0%,42m
20438,1,MedivhWu,2862,0,1,3,4,25.0%,2m
20438,3,LazyTitan,2862,0,0,1,1,0.0%,40m
20438,3,Roofus,2862,0,0,1,1,0.0%,13m
20438,3,IEsouL,2862,0,0,1,1,0.0%,32m
20438,2,deviho,2862,0,0,2,2,0.0%,16m
20438,3,FreeMyPizza,2862,0,0,2,2,0.0%,11m
20459,2,Xenorf,2861,1085,89,69,158,56.3%,3m
20459,2,[PTHero]Strygwyr,2861,1472,80,69,149,53.7%,18m
20459,2,RoGr,2861,602,37,30,67,55.2%,8m
20459,1,PatBateman,2861,799,30,38,68,44.1%,15m
20459,3,Ampere,2861,328,24,8,32,75.0%,20m
20459,2,BloodyHunter,2861,570,21,23,44,47.7%,2m
20459,3,Nerdking,2861,406,17,8,25,68.0%,5m
20459,2,[HØST]Hotfy,2861,338,14,9,23,60.9%,19m
20459,2,Vladio,2861,348,13,17,30,43.3%,14m
20459,2,Tong,2861,227,10,8,18,55.6%,2h
20459,2,ogzxro,2861,195,9,12,21,42.9%,6m
20459,2,[PERU20]Kira,2861,126,8,3,11,72.7%,30m
20459,3,[PiGPan]Brain,2861,218,8,8,16,50.0%,7m
20459,3,Shivers,2861,242,8,8,16,50.0%,35m
20459,2,[MtnDwd]MuchosPylons,2861,182,7,5,12,58.3%,32m
20459,2,[UNCO]CrystalBank,2861,165,7,8,15,46.7%,34m
20459,2,Udaflecha,2861,142,5,3,8,62.5%,27m
20459,3,Jehudda,2861,104,5,4,9,55.6%,40m
20459,1,Gerg,2861,96,5,5,10,50.0%,2h
20459,3,SwagMan,2861,88,4,1,5,80.0%,26m
20459,2,Disable,2861,88,4,8,12,33.3%,32m
20459,1,LittleChan,2861,0,3,3,6,50.0%,2h
20459,1,KarmaAgent,2861,0,3,4,7,42.9%,18m
20459,3,FaceToucher,2861,0,2,3,5,40.0%,17m
20459,3,Loritolord,2861,0,1,0,1,100.0%,15m
20459,1,[69420]TitsMcgee,2861,0,1,1,2,50.0%,2h
20459,3,McSkarff,2861,30,1,2,3,33.3%,20m
20459,3,Kerry,2861,30,1,2,3,33.3%,10m
20459,3,[xBCx]TerrencePick,2861,30,1,2,3,33.3%,18m
20459,3,APTry,2861,0,0,1,1,0.0%,28m
20459,3,Greek,2861,0,0,1,1,0.0%,2m
20490,1,[IiUiI]hunter,2860,1620,208,207,415,50.1%,29m
20490,1,MeatSalad,2860,780,151,148,299,50.5%,30m
20490,2,BoilerXVI,2860,1557,95,83,178,53.4%,11m
20490,1,[Th3Bad]ToadPoa,2860,1305,85,82,167,50.9%,7m
20490,2,Aperot,2860,409,63,56,119,52.9%,39m
20490,2,[xBFMx]CheckURsix,2860,845,62,64,126,49.2%,16m
20490,3,[0DWD0]CarAxadent,2860,618,52,44,96,54.2%,24m
20490,3,PumperNickel,2860,1106,48,40,88,54.5%,5m
20490,3,LeTurkeh,2860,798,37,24,61,60.7%,6m
20490,2,MarcoStukov,2860,870,35,33,68,51.5%,24m
20490,2,[BDnrgy]SmokedGouda,2860,835,33,36,69,47.8%,5m
20490,2,[HBad]Chonkadee,2860,485,22,19,41,53.7%,31m
20490,1,YungTykune,2860,492,17,17,34,50.0%,20m
20490,2,spYke,2860,306,11,10,21,52.4%,39m
20490,3,Camo,2860,285,10,6,16,62.5%,13m
20490,3,FunkyPants,2860,262,8,3,11,72.7%,60m
20490,2,Jake,2860,211,8,9,17,47.1%,49m
20490,3,[ADDU]ZEuS,2860,196,6,4,10,60.0%,3h
20490,2,[LMT]GleargBang,2860,214,6,6,12,50.0%,42m
20490,3,ARTHUR,2860,148,6,6,12,50.0%,29m
20490,2,Discord,2860,167,5,6,11,45.5%,35m
20490,3,Kryptake,2860,0,3,2,5,60.0%,17m
20490,2,Ervey,2860,0,3,3,6,50.0%,37m
20490,3,grim,2860,90,3,4,7,42.9%,6m
20490,2,ffffffffffff,2860,60,3,5,8,37.5%,4m
20490,3,Dutra,2860,122,3,8,11,27.3%,33m
20490,1,Saywa,2860,48,2,2,4,50.0%,3h
20490,3,[Sw3aTy]GeneralTso,2860,60,2,4,6,33.3%,20m
20490,2,sAnDmAn,2860,48,2,6,8,25.0%,23m
20490,3,HotDryNoodle,2860,0,1,0,1,100.0%,27m
20490,3,JoKeR,2860,0,1,0,1,100.0%,6m
20490,3,[0825]Lex,2860,0,1,0,1,100.0%,16m
20490,3,[cipote]Spettro,2860,0,1,0,1,100.0%,18m
20490,3,Planchet,2860,0,1,1,2,50.0%,27m
20490,3,DaBae,2860,0,0,1,1,0.0%,38m
20490,1,[Cabana]EvilSteel,2860,0,0,2,2,0.0%,19m
20526,2,Leefunnn,2859,1576,155,144,299,51.8%,32m
20526,1,sausage,2859,1609,139,120,259,53.7%,28m
20526,3,chamberpunk,2859,1364,134,133,267,50.2%,42m
20526,3,Beckatron,2859,1147,116,109,225,51.6%,41m
20526,1,Ryuunosuke,2859,1486,92,99,191,48.2%,5m
20526,1,Entropian,2859,1000,78,84,162,48.1%,27m
20526,3,Phoenix,2859,475,51,41,92,55.4%,20m
20526,2,[PobSC]FifLelfun,2859,629,28,23,51,54.9%,37m
20526,1,[OPbois]PassiveFist,2859,639,21,27,48,43.8%,21m
20526,3,NeeR,2859,172,13,12,25,52.0%,5m
20526,2,[Z1O1]SwagggyMcD,2859,382,13,15,28,46.4%,16m
20526,3,Mekstor,2859,309,10,10,20,50.0%,11m
20526,1,BigNishy,2859,320,10,18,28,35.7%,30m
20526,3,beardontcare,2859,220,8,6,14,57.1%,60m
20526,2,Maxlin,2859,144,8,7,15,53.3%,32m
20526,1,Freedom,2859,142,8,9,17,47.1%,22m
20526,3,ANORMAL,2859,165,7,4,11,63.6%,27m
20526,3,SurfinCow,2859,195,7,8,15,46.7%,27m
20526,2,sCDecadent,2859,234,7,8,15,46.7%,13m
20526,3,Caliswag,2859,89,5,2,7,71.4%,24m
20526,3,Date,2859,0,4,1,5,80.0%,3m
20526,3,Singularity,2859,86,4,3,7,57.1%,23m
20526,3,aaaa,2859,0,3,2,5,60.0%,3m
20526,1,Cocaa,2859,0,3,3,6,50.0%,53m
20526,3,ApocalLipsis,2859,30,2,0,2,100.0%,24m
20526,2,Gymnopedie,2859,92,2,4,6,33.3%,31m
20526,3,Trogsucks,2859,30,1,2,3,33.3%,14m
20526,3,[TrfBut]Mastergayper,2859,30,1,3,4,25.0%,37m
20526,1,Frogpad,2859,0,0,1,1,0.0%,19m
20526,3,Mugen,2859,0,0,1,1,0.0%,41m
20526,1,DontRunNow,2859,0,0,1,1,0.0%,53m
20526,3,gJaxx,2859,0,0,2,2,0.0%,13m
20558,1,SonicBoom,2858,1628,186,187,373,49.9%,7m
20558,2,BAXTER,2858,1416,164,129,293,56.0%,20m
20558,1,inoscopedJFK,2858,1553,131,119,250,52.4%,31m
20558,2,[CUUMX]Masterblade,2858,925,78,75,153,51.0%,31m
20558,1,AstroB,2858,1491,73,81,154,47.4%,32m
20558,1,Entresto,2858,1158,72,69,141,51.1%,34m
20558,1,Groo,2858,847,30,43,73,41.1%,31m
20558,2,Shehyn,2858,628,27,21,48,56.2%,27m
20558,2,[GBBK]KØLLIAS,2858,644,27,23,50,54.0%,2m
20558,2,Cerberus,2858,560,24,17,41,58.5%,16m
20558,2,Meebly,2858,552,20,22,42,47.6%,2m
20558,2,eternal,2858,356,15,11,26,57.7%,38m
20558,3,[1PA]liuthebeast,2858,214,12,6,18,66.7%,26m
20558,1,veggiedealer,2858,207,9,9,18,50.0%,18m
20558,1,[ConFed]scilla,2858,122,5,3,8,62.5%,3h
20558,3,TrashCan,2858,144,3,1,4,75.0%,3m
20558,3,IllIlIllI,2858,34,2,2,4,50.0%,5m
20558,3,DeHampster,2858,32,2,2,4,50.0%,2h
20558,3,Syntropy,2858,0,1,0,1,100.0%,16m
20558,1,Lllllluke,2858,97,1,1,2,50.0%,13m
20558,2,pwndy,2858,48,1,2,3,33.3%,13m
20558,2,Streiks,2858,30,1,5,6,16.7%,42m
20558,3,[GDP]Voan,2858,0,0,1,1,0.0%,9m
20558,1,killerfatz,2858,0,0,1,1,0.0%,2h
20558,3,valaka,2858,0,0,1,1,0.0%,16m
20558,3,[OxEx]StoneDawg,2858,0,0,2,2,0.0%,30m
20558,3,[ScSwrm]Prxmetheus,2858,0,0,2,2,0.0%,23m
20585,1,Kyle,2857,915,181,161,342,52.9%,29m
20585,1,pajengo,2857,1133,172,176,348,49.4%,31m
20585,1,Hologram,2857,1512,125,114,239,52.3%,25m
20585,3,badbunny,2857,1179,109,93,202,54.0%,12m
20585,1,Hotdog,2857,1384,90,59,149,60.4%,11m
20585,2,Studmeyer,2857,1140,55,46,101,54.5%,14m
20585,3,CrediNation,2857,1268,53,49,102,52.0%,11m
20585,2,KIBAGAMI,2857,344,44,39,83,53.0%,30m
20585,3,TeeVanA,2857,1010,41,33,74,55.4%,8m
20585,1,Amorcen,2857,1053,38,47,85,44.7%,5m
20585,2,Saolun,2857,655,29,22,51,56.9%,23m
20585,2,PrimerOneQc,2857,622,23,21,44,52.3%,19m
20585,2,FULLGROWNMAN,2857,496,21,18,39,53.8%,11m
20585,2,[XCPT]You,2857,436,18,13,31,58.1%,7m
20585,3,TaeTae,2857,394,15,8,23,65.2%,32m
20585,3,Rimogard,2857,422,15,13,28,53.6%,19m
20585,2,Siythe,2857,354,14,12,26,53.8%,19m
20585,1,Blundt,2857,443,14,20,34,41.2%,22m
20585,1,ØnGØ,2857,372,13,14,27,48.1%,25m
20585,2,overpowerd,2857,321,11,8,19,57.9%,49m
20585,2,[rNbS]elfuego,2857,200,8,9,17,47.1%,36m
20585,2,Bossballoon,2857,244,8,12,20,40.0%,17m
20585,1,kimshotgun,2857,148,7,6,13,53.8%,10m
20585,1,Wildfire,2857,141,5,4,9,55.6%,2h
20585,1,[1E100]ProTeenModel,2857,174,5,15,20,25.0%,21m
20585,3,SlowSlippy,2857,100,4,4,8,50.0%,20m
20585,3,Schmidtwerd,2857,117,4,10,14,28.6%,60m
20585,2,[InfNt]Infestedgeek,2857,62,3,9,12,25.0%,32m
20585,3,Halestorm,2857,60,2,3,5,40.0%,27m
20585,2,Ghreen,2857,30,2,3,5,40.0%,15m
20585,2,Oreki,2857,0,2,3,5,40.0%,2h
20585,3,[RedSup]GDraggy,2857,0,1,0,1,100.0%,22m
20585,3,Willdabosses,2857,30,1,1,2,50.0%,16m
20585,2,MeeestaKeeem,2857,0,1,3,4,25.0%,10m
20585,2,Lunix,2857,34,1,7,8,12.5%,32m
20585,1,VladImpaler,2857,0,0,2,2,0.0%,1h
20621,1,theDreamKing,2856,1393,132,119,251,52.6%,25m
20621,3,zdexor,2856,945,62,47,109,56.9%,15m
20621,3,ArkannoSol,2856,854,56,49,105,53.3%,2m
20621,1,JFGan,2856,806,56,52,108,51.9%,37m
20621,2,Romanrat,2856,1276,50,47,97,51.5%,15m
20621,2,AtoTheK,2856,519,40,32,72,55.6%,43m
20621,2,[xXxVxX]FirstBorn,2856,682,28,26,54,51.9%,35m
20621,2,Shuann,2856,651,23,26,49,46.9%,2m
20621,3,[monin]Yaxhiro,2856,313,11,8,19,57.9%,28m
20621,2,[ssexxy]LightningJ,2856,236,10,5,15,66.7%,17m
20621,2,Franklinniii,2856,289,10,10,20,50.0%,33m
20621,2,Xerxes,2856,246,9,7,16,56.2%,32m
20621,3,Filirican,2856,190,7,4,11,63.6%,29m
20621,2,[LOHs]Diogenes,2856,205,7,6,13,53.8%,23m
20621,3,Julio,2856,124,5,3,8,62.5%,5m
20621,3,[6Stone]Jasper,2856,58,3,0,3,100.0%,24m
20621,3,TrAnCe,2856,86,3,3,6,50.0%,23m
20621,3,[SvgApe]TipCap,2856,88,3,4,7,42.9%,28m
20621,3,Skylight,2856,30,2,0,2,100.0%,16m
20621,3,[KaOz]Taurus,2856,0,2,1,3,66.7%,21m
20621,1,llllllllllll,2856,94,2,2,4,50.0%,2h
20621,1,thegurney,2856,0,2,3,5,40.0%,2h
20621,3,wwwOWNEDcom,2856,0,1,0,1,100.0%,17m
20621,3,asdfasdf,2856,0,1,0,1,100.0%,6m
20621,3,[TLD]Vicious,2856,30,1,2,3,33.3%,38m
20621,3,Pwnography,2856,0,1,4,5,20.0%,7m
20621,2,[WaiFou]SarDonYx,2856,40,1,6,7,14.3%,4m
20621,3,SithMyPants,2856,0,0,1,1,0.0%,7m
20621,3,[AntiC]Deltashock,2856,0,0,1,1,0.0%,40m
20621,3,Daniel,2856,0,0,1,1,0.0%,36m
20621,3,DARKSENSAZN,2856,0,0,1,1,0.0%,41m
20621,3,[LOHc]www,2856,0,0,1,1,0.0%,21m
20653,1,BaKed,2855,1609,325,322,647,50.2%,11m
20653,2,red,2855,815,263,262,525,50.1%,2m
20653,3,[Rakau]Dubz,2855,1446,60,60,120,50.0%,42m
20653,2,CropDrop,2855,979,46,43,89,51.7%,31m
20653,1,LlibGnos,2855,340,42,43,85,49.4%,17m
20653,2,[CUL3R0]KDot,2855,722,38,34,72,52.8%,35m
20653,2,[WfbtV]RedFox,2855,645,28,22,50,56.0%,37m
20653,3,Waffle,2855,648,25,17,42,59.5%,20m
20653,2,gringoslayer,2855,564,22,22,44,50.0%,14m
20653,3,[Shntrz]Rooh,2855,312,12,12,24,50.0%,39m
20653,1,[LBHS]Ignoti,2855,176,12,21,33,36.4%,9m
20653,3,DollarBuffet,2855,284,10,7,17,58.8%,2h
20653,3,[MFH]Rocker,2855,166,6,3,9,66.7%,11m
20653,1,[SABRE6]Pseudophanes,2855,208,6,4,10,60.0%,17m
20653,1,ReggaeShark,2855,180,6,15,21,28.6%,37m
20653,3,Cucumber,2855,115,4,3,7,57.1%,34m
20653,3,Radix,2855,0,1,0,1,100.0%,38m
20653,3,[DRKPMT]RaPtUrE,2855,30,1,1,2,50.0%,32m
20653,3,[Peww]icecoldjuice,2855,0,1,1,2,50.0%,27m
20653,2,Legnacra,2855,30,1,7,8,12.5%,4m
20653,1,Silvus,2855,0,0,1,1,0.0%,2h
20653,3,ALMANEGRA,2855,0,0,1,1,0.0%,33m
20675,1,MacDaddy,2854,1603,445,422,867,51.3%,38m
20675,1,Jea,2854,1623,366,340,706,51.8%,3m
20675,3,[Cyto]mrcord,2854,1338,154,164,318,48.4%,27m
20675,3,Libertalia,2854,1534,100,78,178,56.2%,21m
20675,3,EDonKillah,2854,1535,60,55,115,52.2%,10m
20675,2,cmyr,2854,660,53,45,98,54.1%,32m
20675,1,[BHT]Gerwal,2854,990,33,47,80,41.2%,25m
20675,3,Aprendiz,2854,514,19,17,36,52.8%,34m
20675,2,Snij,2854,418,16,18,34,47.1%,40m
20675,1,ptero,2854,303,9,16,25,36.0%,4m
20675,2,HughMungus,2854,153,7,11,18,38.9%,10m
20675,3,[VikE]IZZievil,2854,166,6,3,9,66.7%,21m
20675,3,Spoonhead,2854,171,5,2,7,71.4%,3h
20675,2,[DROM]BichoMena,2854,150,5,10,15,33.3%,35m
20675,1,AdultShoes,2854,121,4,4,8,50.0%,2m
20675,3,Pashton,2854,0,3,2,5,60.0%,2m
20675,2,Kikkelitikku,2854,142,3,4,7,42.9%,5m
20675,3,oscid,2854,30,2,0,2,100.0%,17m
20675,2,[LDUwU]resident,2854,30,2,4,6,33.3%,14m
20675,3,Jobby,2854,0,1,0,1,100.0%,35m
20675,1,BANEEXPLODE,2854,0,1,0,1,100.0%,57m
20675,3,Aleksvela,2854,0,1,1,2,50.0%,32m
20675,3,[EvilGC]yarley,2854,0,1,1,2,50.0%,8m
20675,3,Alicia,2854,0,1,4,5,20.0%,16m
20675,3,Raziel,2854,0,0,1,1,0.0%,28m
20700,1,Overfloater,2853,1611,283,284,567,49.9%,14m
20700,1,fongg,2853,1633,211,204,415,50.8%,4m
20700,2,QuyñeChibcha,2853,1550,176,179,355,49.6%,31m
20700,1,Koffy,2853,579,49,56,105,46.7%,39m
20700,2,Longinator,2853,454,21,20,41,51.2%,4m
20700,2,[shd0w]ShadowWalker,2853,471,19,15,34,55.9%,17m
20700,2,[BCBZ]NoPainNoGain,2853,438,17,15,32,53.1%,7m
20700,1,LaxBro,2853,496,16,23,39,41.0%,27m
20700,2,emjaypeepee,2853,179,14,19,33,42.4%,31m
20700,2,[Mites]Chuggz,2853,388,13,15,28,46.4%,34m
20700,2,pinguchingu,2853,292,8,12,20,40.0%,35m
20700,3,Anson,2853,165,6,4,10,60.0%,11m
20700,2,SlamBlasta,2853,88,6,5,11,54.5%,3m
20700,2,[fouuu]mathestbeau,2853,143,6,6,12,50.0%,32m
20700,2,[isEpic]AshtonDaDuck,2853,191,5,7,12,41.7%,32m
20700,1,cobraz,2853,169,5,8,13,38.5%,30m
20700,1,[FFAA]MxMauricio,2853,121,3,0,3,100.0%,25m
20700,1,laturcou,2853,0,3,3,6,50.0%,2h
20700,3,[WLP]Tony,2853,30,2,0,2,100.0%,31m
20700,3,[TPGGXD]LinKras,2853,0,1,0,1,100.0%,3m
20700,3,Sócrates,2853,30,1,1,2,50.0%,5m
20700,1,FadedTerran,2853,48,1,2,3,33.3%,3h
20700,3,[XpKAc]ARHAT,2853,0,0,1,1,0.0%,11m
20700,3,ekksdeelmao,2853,0,0,1,1,0.0%,5m
20700,2,[xLgNx]shinobkia,2853,0,0,3,3,0.0%,10m
20725,1,Darkness,2852,1622,128,127,255,50.2%,10m
20725,2,Roanapur,2852,767,81,62,143,56.6%,33m
20725,2,masochist,2852,779,51,42,93,54.8%,31m
20725,2,Regent,2852,1022,39,44,83,47.0%,36m
20725,3,[TxC1]IIIIIIIIIIII,2852,731,30,19,49,61.2%,10m
20725,2,SCVKing,2852,441,26,30,56,46.4%,41m
20725,2,ShaggyLlama,2852,541,23,25,48,47.9%,14m
20725,2,[LMS69]Bane,2852,600,22,23,45,48.9%,15m
20725,3,OmegaChris,2852,523,21,19,40,52.5%,39m
20725,2,Uzjis,2852,326,14,11,25,56.0%,25m
20725,2,Anton,2852,334,13,20,33,39.4%,9m
20725,2,Nert,2852,285,12,11,23,52.2%,35m
20725,3,FinngerMeDan,2852,314,12,12,24,50.0%,27m
20725,3,Matric,2852,212,11,5,16,68.8%,4m
20725,3,Romerales,2852,179,8,6,14,57.1%,53m
20725,3,zerloc,2852,58,5,3,8,62.5%,34m
20725,2,Juneau,2852,166,5,5,10,50.0%,2m
20725,2,Slay,2852,194,5,5,10,50.0%,19m
20725,2,Meannus,2852,30,4,4,8,50.0%,15m
20725,3,[PDP4L]Kit,2852,111,4,5,9,44.4%,33m
20725,3,[TØXIC]DragonEnemy,2852,86,3,3,6,50.0%,38m
20725,2,Abbas,2852,102,3,3,6,50.0%,24m
20725,3,BigBoss,2852,0,1,0,1,100.0%,7m
20725,3,Raincliff,2852,0,1,0,1,100.0%,26m
20725,1,Spddin,2852,0,0,1,1,0.0%,2h
20725,3,SupBoy,2852,0,0,1,1,0.0%,38m
20725,3,[GoonSq]WikiTiki,2852,0,0,1,1,0.0%,35m
20725,3,[cl0udM]WyzWun,2852,0,0,2,2,0.0%,2m
20725,2,wrier,2852,0,0,3,3,0.0%,18m
20725,2,[AbcCo]JävlyatNej,2852,0,0,4,4,0.0%,2m
20755,2,PITAPOCH,2851,1578,214,202,416,51.4%,19m
20755,1,Traveler,2851,1002,132,130,262,50.4%,23m
20755,2,DancingRod,2851,1288,87,78,165,52.7%,26m
20755,2,Boondoggle,2851,1522,80,74,154,51.9%,38m
20755,3,Yarko,2851,943,41,26,67,61.2%,25m
20755,2,Joobian,2851,672,25,25,50,50.0%,33m
20755,2,Mojojoe,2851,542,19,22,41,46.3%,19m
20755,2,Duong,2851,422,16,14,30,53.3%,32m
20755,3,uglykid,2851,277,13,15,28,46.4%,40m
20755,3,[SuperZ]KillerCraft,2851,88,4,1,5,80.0%,39m
20755,1,BrainySmurf,2851,97,4,3,7,57.1%,27m
20755,3,justinweaver,2851,58,2,2,4,50.0%,5m
20755,3,[ruchca]Flippo,2851,0,1,0,1,100.0%,8m
20755,1,Conker,2851,48,1,2,3,33.3%,2h
20755,2,spamdini,2851,30,1,7,8,12.5%,2m
20755,2,Kush,2851,0,0,1,1,0.0%,2h
20755,3,Barbaro,2851,0,0,1,1,0.0%,31m
20755,3,Fenixbiskit,2851,0,0,1,1,0.0%,16m
20755,3,[C4RB0N]Leif,2851,0,0,2,2,0.0%,21m
20774,3,[wlnt]Phonon,2850,1546,463,464,927,49.9%,34m
20774,2,FrozenTundra,2850,1599,193,184,377,51.2%,14m
20774,3,MrSlayer,2850,1246,84,63,147,57.1%,16m
20774,3,missingno,2850,1448,80,64,144,55.6%,5m
20774,1,Cheesehole,2850,1284,49,52,101,48.5%,37m
20774,2,Metric,2850,1081,44,52,96,45.8%,35m
20774,3,[UncrNa]Pegge,2850,774,29,25,54,53.7%,4m
20774,2,Gujupike,2850,632,23,24,47,48.9%,38m
20774,3,[LgnTDS]slingMob,2850,524,19,17,36,52.8%,2m
20774,2,IIIIIIIII,2850,486,19,23,42,45.2%,32m
20774,2,oscarluq,2850,508,18,25,43,41.9%,32m
20774,1,Callthewind,2850,310,16,13,29,55.2%,19m
20774,2,[YBDBD]LastRebel,2850,430,16,19,35,45.7%,35m
20774,3,RoadWarrior,2850,362,13,11,24,54.2%,5m
20774,2,problems,2850,270,8,11,19,42.1%,2m
20774,3,[FMX]Archivo,2850,237,7,12,19,36.8%,32m
20774,1,handofyesu,2850,211,5,3,8,62.5%,57m
20774,1,LAKUISHA,2850,48,5,4,9,55.6%,53m
20774,1,Normalisk,2850,96,4,6,10,40.0%,4m
20774,2,NegativeZero,2850,120,4,8,12,33.3%,17m
20774,2,[Taasty]Cocothunda,2850,124,4,11,15,26.7%,5m
20774,2,[squad1]Monke,2850,0,3,2,5,60.0%,2h
20774,2,KorocNA,2850,0,3,2,5,60.0%,3h
20774,1,[FAMFAM]VanDarkholme,2850,97,2,2,4,50.0%,20m
20774,2,Darksu,2850,30,2,7,9,22.2%,41m
20774,3,[WlFl]BuLLdOg,2850,0,1,0,1,100.0%,18m
20774,3,[HaV]RazorTheHack,2850,0,1,0,1,100.0%,3m
20774,2,Hairbear,2850,0,1,1,2,50.0%,27m
20774,1,[Chikki]Cantankerous,2850,0,0,1,1,0.0%,2h
20774,3,Desamunt,2850,0,0,1,1,0.0%,35m
20774,3,WORSHIPSATAN,2850,0,0,1,1,0.0%,2m
20774,3,CHUNKY,2850,0,0,1,1,0.0%,11m
20806,2,[xf3]nApAlm,2849,1589,115,114,229,50.2%,8m
20806,2,AHHHHHHHHH,2849,1520,83,80,163,50.9%,41m
20806,2,[kaptor]Legoshi,2849,565,79,66,145,54.5%,16m
20806,3,BLANDIN,2849,1079,59,40,99,59.6%,30m
20806,2,Kuso,2849,1084,46,39,85,54.1%,41m
20806,3,Bobo,2849,711,44,32,76,57.9%,12m
20806,2,[lMathl]Blue,2849,920,34,34,68,50.0%,40m
20806,2,[Astute]ajamscott,2849,830,32,33,65,49.2%,39m
20806,2,thelastsith,2849,438,16,16,32,50.0%,27m
20806,2,Sovereign,2849,344,16,18,34,47.1%,35m
20806,2,[IOgI]OgJanos,2849,243,13,8,21,61.9%,8m
20806,3,WuTang,2849,367,13,11,24,54.2%,42m
20806,1,UleakRed,2849,410,13,24,37,35.1%,34m
20806,2,Ricky,2849,256,12,12,24,50.0%,26m
20806,2,[nGeKv]KeLeVraN,2849,146,9,7,16,56.2%,25m
20806,3,diNoDoT,2849,256,9,24,33,27.3%,29m
20806,3,[13und]Yoinkie,2849,257,8,4,12,66.7%,20m
20806,3,Mahambah,2849,168,7,5,12,58.3%,27m
20806,3,Rick,2849,114,5,1,6,83.3%,24m
20806,3,Mayhem,2849,86,4,2,6,66.7%,35m
20806,3,Depredador,2849,88,4,4,8,50.0%,11m
20806,1,Brandon,2849,48,4,4,8,50.0%,2m
20806,2,FaRtSnIfErS,2849,219,4,11,15,26.7%,17m
20806,1,[QoG]Lexington,2849,97,3,2,5,60.0%,24m
20806,2,Chaoster,2849,0,2,3,5,40.0%,58m
20806,2,Kris,2849,114,2,5,7,28.6%,3h
20806,3,Defadog,2849,0,1,0,1,100.0%,12m
20806,3,cAKEs,2849,30,1,3,4,25.0%,38m
20806,1,[TATR]StreetSharx,2849,0,1,5,6,16.7%,57m
20806,3,Neo,2849,0,0,1,1,0.0%,23m
20806,3,Sal,2849,0,0,1,1,0.0%,26m
20806,2,[HOGU]Ryu,2849,0,0,1,1,0.0%,2h
20838,1,Pyrowarden,2848,1520,545,521,1066,51.1%,13m
20838,2,BigRic,2848,1618,312,283,595,52.4%,2m
20838,2,Kyle,2848,1635,289,280,569,50.8%,35m
20838,2,jonbwhy,2848,813,141,137,278,50.7%,32m
20838,3,MinoruGay,2848,998,47,32,79,59.5%,9m
20838,3,met,2848,596,45,36,81,55.6%,6m
20838,2,Bostinu,2848,439,34,35,69,49.3%,15m
20838,2,Zapata,2848,394,33,31,64,51.6%,36m
20838,2,Sammuelsson,2848,656,28,24,52,53.8%,39m
20838,2,hughy,2848,616,24,20,44,54.5%,32m
20838,3,[Meuh]SillyWilly,2848,564,23,19,42,54.8%,42m
20838,2,hasudrone,2848,569,23,20,43,53.5%,4m
20838,3,BadManner,2848,546,22,15,37,59.5%,17m
20838,2,[EWTF]EvilToaster,2848,187,8,7,15,53.3%,32m
20838,2,Boneyards,2848,238,8,8,16,50.0%,27m
20838,3,Soufi,2848,201,6,5,11,54.5%,3h
20838,3,[Blacer]alleycat,2848,191,5,2,7,71.4%,34m
20838,2,TayFox,2848,30,5,3,8,62.5%,26m
20838,1,filoulam,2848,48,5,3,8,62.5%,27m
20838,1,BunnyDragon,2848,48,5,4,9,55.6%,1h
20838,2,acidplayer,2848,90,4,7,11,36.4%,18m
20838,3,Dewman,2848,0,3,2,5,60.0%,21m
20838,2,Xapalambos,2848,102,3,3,6,50.0%,32m
20838,3,Dofoos,2848,88,3,5,8,37.5%,6m
20838,3,[DRGNS]CrookedLlama,2848,95,1,2,3,33.3%,17m
20838,3,EzMelon,2848,0,1,4,5,20.0%,17m
20838,3,[LOHs]ArMada,2848,30,1,4,5,20.0%,22m
20838,3,[jacasb]VELKAN,2848,0,0,1,1,0.0%,13m
20866,3,Phrygian,2847,1134,106,93,199,53.3%,27m
20866,3,ghOstface,2847,508,53,38,91,58.2%,24m
20866,2,FancyHippo,2847,771,33,29,62,53.2%,24m
20866,3,Hrvatska,2847,704,29,16,45,64.4%,24m
20866,2,[Flex]FlipSide,2847,679,27,28,55,49.1%,15m
20866,3,RonaldoJr,2847,635,26,16,42,61.9%,29m
20866,2,joelmx,2847,379,17,15,32,53.1%,31m
20866,2,[USOMAD]NameHere,2847,367,15,16,31,48.4%,31m
20866,2,[RdmS]ManuxDDD,2847,305,13,13,26,50.0%,36m
20866,2,GenKenobi,2847,308,11,12,23,47.8%,33m
20866,3,defcon,2847,233,10,8,18,55.6%,9m
20866,2,ImKorean,2847,168,8,13,21,38.1%,31m
20866,2,[Msia]nornia,2847,186,6,5,11,54.5%,5m
20866,1,TwoD,2847,114,6,5,11,54.5%,19m
20866,3,[fancyb]Myconography,2847,140,6,6,12,50.0%,59m
20866,3,Frosty,2847,142,5,4,9,55.6%,22m
20866,3,CAMELLUO,2847,60,3,2,5,60.0%,20m
20866,2,stellar,2847,64,3,9,12,25.0%,15m
20866,2,Hsiaoboy,2847,94,3,9,12,25.0%,17m
20866,3,jeibox,2847,30,2,2,4,50.0%,18m
20866,3,Amaryllis,2847,60,2,3,5,40.0%,2m
20866,2,Volius,2847,60,2,6,8,25.0%,31m
20866,3,CheeseLord,2847,0,1,0,1,100.0%,26m
20866,3,[Ier]Bosh,2847,0,1,2,3,33.3%,7m
20866,1,LiquidGrass,2847,97,1,2,3,33.3%,56m
20866,2,[OceanT]Havokk,2847,30,1,5,6,16.7%,17m
20866,3,amVaquero,2847,0,0,1,1,0.0%,12m
20866,3,lazrCat,2847,0,0,1,1,0.0%,10m
20866,3,krgreene,2847,0,0,1,1,0.0%,5m
20895,3,pungkow,2846,1620,328,319,647,50.7%,10m
20895,2,ptaamdree,2846,347,46,43,89,51.7%,38m
20895,2,darthawsome,2846,621,44,44,88,50.0%,32m
20895,3,ury,2846,980,39,34,73,53.4%,16m
20895,2,MadMax,2846,921,38,35,73,52.1%,22m
20895,3,Staggz,2846,1046,35,52,87,40.2%,35m
20895,3,DeadlyKitten,2846,572,26,6,32,81.2%,42m
20895,2,SrZombie,2846,666,26,27,53,49.1%,7m
20895,1,Evenride,2846,547,24,25,49,49.0%,27m
20895,2,idaniel,2846,616,24,31,55,43.6%,2m
20895,3,PonySoprano,2846,398,15,13,28,53.6%,41m
20895,3,[HID3]YoKids,2846,318,13,1,14,92.9%,13m
20895,2,[Rela]JamirL,2846,350,13,13,26,50.0%,42m
20895,2,MrSmiley,2846,298,13,14,27,48.1%,40m
20895,3,BigSeth,2846,324,12,10,22,54.5%,38m
20895,2,[CANN0N]TeraAtlantis,2846,139,11,7,18,61.1%,45m
20895,1,FENIX,2846,192,7,4,11,63.6%,2h
20895,3,[XCoast]Cornelius,2846,180,7,7,14,50.0%,42m
20895,3,[ggUNlT]BlackMesaINC,2846,197,6,3,9,66.7%,10m
20895,3,[1E100]Majak,2846,86,4,1,5,80.0%,10m
20895,3,[Canela]ToribioGamer,2846,109,4,3,7,57.1%,17m
20895,2,chiimon,2846,0,4,3,7,57.1%,21m
20895,3,LtDan,2846,101,4,4,8,50.0%,27m
20895,2,ELTORITO,2846,120,4,10,14,28.6%,13m
20895,2,Governor,2846,0,3,2,5,60.0%,3h
20895,2,Vebb,2846,0,3,3,6,50.0%,42m
20895,2,Artanis,2846,60,3,6,9,33.3%,41m
20895,3,[flexed]AIDAN,2846,30,1,1,2,50.0%,12m
20895,3,[TGosuA]Ramshack,2846,0,0,1,1,0.0%,21m
20895,2,brotoss,2846,0,0,1,1,0.0%,2h
20895,3,GiZMO,2846,0,0,1,1,0.0%,30m
20895,3,head,2846,0,0,2,2,0.0%,27m
20927,2,Metatron,2845,1568,161,147,308,52.3%,2m
20927,1,ArchDruid,2845,1066,80,68,148,54.1%,28m
20927,2,ThePunisher,2845,783,36,23,59,61.0%,36m
20927,1,KillerChickn,2845,670,35,37,72,48.6%,34m
20927,2,Flame,2845,764,28,30,58,48.3%,3m
20927,3,RødGrødFløde,2845,505,21,8,29,72.4%,3m
20927,3,Perisma,2845,398,16,12,28,57.1%,6m
20927,2,[PJAH]Kurah,2845,382,13,14,27,48.1%,16m
20927,2,vscAloha,2845,271,11,16,27,40.7%,16m
20927,3,llLUMINOTHll,2845,289,9,6,15,60.0%,5m
20927,2,[EvilGC]SkillHunter,2845,200,8,10,18,44.4%,34m
20927,3,[KerriS]Smallz,2845,148,6,3,9,66.7%,28m
20927,2,Shadowsun,2845,188,6,11,17,35.3%,42m
20927,3,Signicher,2845,114,5,3,8,62.5%,9m
20927,2,Warcheese,2845,120,5,6,11,45.5%,38m
20927,3,JollyGren,2845,144,5,7,12,41.7%,40m
20927,3,tiloupbine,2845,30,2,0,2,100.0%,35m
20927,2,[FVHS03]SiR,2845,0,2,2,4,50.0%,2h
20927,3,Anubis,2845,30,2,2,4,50.0%,14m
20927,3,[TamuSC]IAmRadon,2845,0,2,3,5,40.0%,18m
20927,1,[DOOM]Fox,2845,0,1,0,1,100.0%,34m
20927,3,Xenocide,2845,0,1,0,1,100.0%,5m
20927,3,xblackood,2845,0,1,0,1,100.0%,18m
20927,3,[cerbrs]OuterSpace,2845,0,1,1,2,50.0%,4m
20927,3,turtlemech,2845,30,1,2,3,33.3%,20m
20927,3,SweetOnion,2845,0,0,1,1,0.0%,32m
20927,3,[Ntshls]Kramer,2845,0,0,1,1,0.0%,27m
20954,2,ryojavi,2844,1518,177,143,320,55.3%,27m
20954,2,[UpxV]Rebel,2844,1509,174,154,328,53.0%,19m
20954,2,Sirius,2844,1571,143,141,284,50.4%,11m
20954,3,Nuckoholic,2844,1603,113,97,210,53.8%,5m
20954,1,Jimisugi,2844,843,105,100,205,51.2%,37m
20954,1,[KingSC]Pxnditx,2844,1328,70,73,143,49.0%,30m
20954,2,mark,2844,1250,49,48,97,50.5%,8m
20954,2,BarnDog,2844,927,43,34,77,55.8%,14m
20954,2,[GrnBrd]Jeremy,2844,656,33,30,63,52.4%,42m
20954,2,MasterGelo,2844,754,29,28,57,50.9%,8m
20954,2,AuguSosa,2844,561,21,28,49,42.9%,16m
20954,3,Karmaeleon,2844,356,13,14,27,48.1%,27m
20954,1,[DbLStK]peek,2844,232,7,17,24,29.2%,21m
20954,1,Imbanessy,2844,142,6,6,12,50.0%,22m
20954,2,[NeAs]Smart,2844,0,4,1,5,80.0%,51m
20954,3,[inHell]TheSirFM,2844,114,4,2,6,66.7%,35m
20954,3,[papayo]frandux,2844,147,4,3,7,57.1%,2h
20954,3,TheDrizzle,2844,93,3,3,6,50.0%,7m
20954,3,[CLogic]Triplekill,2844,90,3,4,7,42.9%,21m
20954,3,Mlepnos,2844,97,2,1,3,66.7%,2h
20954,2,[SorMik]BDBlaffy,2844,88,2,4,6,33.3%,3m
20954,3,[Squidy]RavinBailiff,2844,0,1,0,1,100.0%,42m
20954,3,[LBxX]Imortalyon,2844,0,1,2,3,33.3%,3m
20954,3,Kryoschdr,2844,0,0,1,1,0.0%,38m
20954,3,devilmachine,2844,0,0,2,2,0.0%,27m
20979,2,[PobSC]Apare,2843,1593,226,208,434,52.1%,29m
20979,2,Korhonen,2843,1558,174,167,341,51.0%,42m
20979,3,vash,2843,1503,97,86,183,53.0%,5m
20979,3,Geminus,2843,999,53,43,96,55.2%,5m
20979,3,SKG,2843,1089,41,38,79,51.9%,31m
20979,2,Unchips,2843,899,37,31,68,54.4%,36m
20979,2,[SSSWAG]damanjoe,2843,816,29,33,62,46.8%,16m
20979,2,Broach,2843,355,26,27,53,49.1%,3m
20979,3,EarthEssance,2843,471,20,7,27,74.1%,5m
20979,2,AMURICA,2843,395,15,13,28,53.6%,18m
20979,3,Coffee,2843,331,11,9,20,55.0%,8m
20979,2,Okcidento,2843,284,10,15,25,40.0%,33m
20979,3,normanoid,2843,210,8,7,15,53.3%,10m
20979,2,[WlLLYS]FirstToDie,2843,179,7,5,12,58.3%,42m
20979,1,ProudMongol,2843,48,5,3,8,62.5%,2h
20979,2,sant,2843,0,3,3,6,50.0%,26m
20979,2,chechme,2843,88,3,4,7,42.9%,7m
20979,2,WaquaPictdom,2843,128,3,5,8,37.5%,3m
20979,3,[FMX]KmpaOne,2843,30,2,2,4,50.0%,25m
20979,3,Klubs,2843,0,1,1,2,50.0%,14m
20979,3,Asesinonino,2843,0,1,2,3,33.3%,18m
20979,3,[PiGPan]Mediocre,2843,30,1,4,5,20.0%,8m
20979,3,[Emb3rs]CarpeNoctem,2843,0,0,1,1,0.0%,23m
20979,3,Paradoxical,2843,0,0,1,1,0.0%,11m
20979,1,ArcticReign,2843,0,0,2,2,0.0%,52m
20979,3,POSEIDON,2843,0,0,4,4,0.0%,3h
21005,1,futuredroid,2842,1594,350,335,685,51.1%,31m
21005,1,HurleyReyes,2842,1571,194,197,391,49.6%,11m
21005,3,[xAK7x]Carlangas,2842,1293,138,123,261,52.9%,24m
21005,3,kokeruto,2842,422,24,14,38,63.2%,35m
21005,2,Ziggza,2842,265,21,22,43,48.8%,20m
21005,2,[TGosuD]Rexxcon,2842,508,19,18,37,51.4%,39m
21005,3,DANO,2842,495,18,13,31,58.1%,33m
21005,2,[AciDD]IIIIIIIIIIII,2842,360,14,13,27,51.9%,35m
21005,2,[vNAM]picklez,2842,282,11,14,25,44.0%,15m
21005,2,xXxAriesxXx,2842,310,11,16,27,40.7%,30m
21005,2,Telari,2842,243,10,11,21,47.6%,19m
21005,1,zerohora,2842,265,9,7,16,56.2%,60m
21005,3,IKE,2842,270,9,11,20,45.0%,26m
21005,3,Porygon,2842,217,7,4,11,63.6%,60m
21005,2,MistaXYZ,2842,166,6,4,10,60.0%,33m
21005,3,Silentstash,2842,159,6,7,13,46.2%,2h
21005,3,Fishcakes,2842,168,5,7,12,41.7%,6m
21005,1,[HOTCC]CheekClapper,2842,0,4,2,6,66.7%,2h
21005,1,Melegnis,2842,48,4,4,8,50.0%,3h
21005,2,ALLAHUAKVAR,2842,124,4,10,14,28.6%,2m
21005,1,Ion,2842,96,3,3,6,50.0%,35m
21005,2,Vandarcae,2842,44,3,3,6,50.0%,1h
21005,1,Edammer,2842,97,3,4,7,42.9%,8m
21005,2,[FuTD]Rockfenix,2842,0,2,3,5,40.0%,1h
21005,3,dotrawr,2842,0,1,0,1,100.0%,8m
21005,3,MorcY,2842,0,1,0,1,100.0%,5m
21005,1,Chungusisyum,2842,48,1,1,2,50.0%,2h
21005,3,IDontPlayRTS,2842,30,1,2,3,33.3%,16m
21005,3,xalalaô,2842,0,1,4,5,20.0%,6m
21005,2,Brubbolini,2842,0,1,4,5,20.0%,29m
21005,2,DallFace,2842,30,1,8,9,11.1%,15m
21005,3,SuperJohn,2842,0,0,1,1,0.0%,34m
21005,3,secilian,2842,0,0,2,2,0.0%,24m
21005,3,monstermutt,2842,0,0,2,2,0.0%,26m
21039,3,WangHangLow,2841,1453,151,149,300,50.3%,5m
21039,2,Kero,2841,754,61,64,125,48.8%,33m
21039,3,Tstone,2841,450,55,44,99,55.6%,38m
21039,3,[ExcIgN]Yanzo,2841,616,25,19,44,56.8%,12m
21039,2,AsTiGmaT,2841,583,22,22,44,50.0%,15m
21039,2,FoSure,2841,441,17,18,35,48.6%,16m
21039,1,WhiskeyMic,2841,474,14,20,34,41.2%,13m
21039,3,[Bajos]Jheyson,2841,357,13,8,21,61.9%,2m
21039,2,TBZ,2841,382,12,15,27,44.4%,15m
21039,2,Frosé,2841,203,10,6,16,62.5%,10m
21039,3,[TTMLK]Sleeper,2841,152,9,6,15,60.0%,22m
21039,2,IronCurtain,2841,306,8,13,21,38.1%,34m
21039,3,Animoxin,2841,146,6,4,10,60.0%,32m
21039,2,NotTheFBI,2841,146,6,13,19,31.6%,37m
21039,3,[FSTM]steez,2841,120,5,3,8,62.5%,30m
21039,2,[Colrs]VeryCool,2841,166,5,4,9,55.6%,10m
21039,1,Mallgar,2841,189,4,2,6,66.7%,40m
21039,1,Ckl,2841,145,4,6,10,40.0%,2h
21039,2,UltraPreso,2841,0,3,2,5,60.0%,48m
21039,3,[dLife]prycebenney,2841,58,2,1,3,66.7%,7m
21039,1,[NT4]MaxCola,2841,0,1,0,1,100.0%,56m
21039,3,Freks,2841,0,1,0,1,100.0%,14m
21039,3,MedioToss,2841,0,0,2,2,0.0%,27m
21062,2,LillyWap,2840,1628,211,180,391,54.0%,19m
21062,1,ORIN,2840,940,60,66,126,47.6%,21m
21062,3,SaulGoodman,2840,1270,39,70,109,35.8%,27m
21062,1,Evilblade,2840,503,32,43,75,42.7%,21m
21062,2,DeRail,2840,491,24,19,43,55.8%,38m
21062,2,LexMcGlock,2840,514,21,27,48,43.8%,10m
21062,3,[SLACK]ZombieDenden,2840,345,15,10,25,60.0%,2m
21062,2,Rook,2840,338,13,12,25,52.0%,41m
21062,1,Skydiver,2840,334,11,24,35,31.4%,18m
21062,3,Loloyolo,2840,280,10,11,21,47.6%,6m
21062,2,BonerGuideMe,2840,216,9,8,17,52.9%,27m
21062,2,[Beee]JimRaynor,2840,190,8,7,15,53.3%,30m
21062,3,Omgilyuwu,2840,209,6,3,9,66.7%,29m
21062,1,CHAOS,2840,193,6,4,10,60.0%,3h
21062,3,Polachek,2840,166,6,4,10,60.0%,5m
21062,1,Adrieltuf,2840,96,5,5,10,50.0%,13m
21062,3,Cajual,2840,95,4,2,6,66.7%,12m
21062,1,Dylan,2840,34,4,6,10,40.0%,39m
21062,2,Kelm,2840,86,4,7,11,36.4%,33m
21062,2,Yuengling,2840,0,3,2,5,60.0%,2h
21062,3,Matt,2840,90,3,5,8,37.5%,8m
21062,3,nicco,2840,0,2,3,5,40.0%,18m
21062,3,Darp,2840,0,2,3,5,40.0%,16m
21062,2,JKGRainX,2840,0,1,0,1,100.0%,47m
21062,3,Hellscythe,2840,0,1,0,1,100.0%,30m
21062,3,GAAV,2840,0,1,1,2,50.0%,28m
21062,3,[SDTL]Ian,2840,0,1,4,5,20.0%,6m
21062,3,Lobachevski,2840,0,1,4,5,20.0%,9m
21062,3,RaitO,2840,0,0,1,1,0.0%,37m
21062,3,[ImbTos]DontRushMe,2840,0,0,1,1,0.0%,18m
21062,3,Snake,2840,0,0,1,1,0.0%,5m
21062,3,[MIT]vEnhance,2840,0,0,2,2,0.0%,30m
21094,1,ergo,2839,1211,240,233,473,50.7%,28m
21094,1,[sk3tch]Nomoreeliot,2839,1546,86,92,178,48.3%,38m
21094,2,Ekchuah,2839,958,82,87,169,48.5%,27m
21094,2,JDetective,2839,1019,51,33,84,60.7%,36m
21094,3,[VH]Trintlex,2839,1079,46,35,81,56.8%,39m
21094,3,BedTyme,2839,636,24,19,43,55.8%,33m
21094,3,lIlIlIlIlI,2839,325,14,13,27,51.9%,31m
21094,3,johnnymac,2839,148,9,9,18,50.0%,57m
21094,3,[UpxV]Marrows,2839,209,6,3,9,66.7%,19m
21094,2,[TMS]BrokNbonez,2839,60,5,5,10,50.0%,34m
21094,2,DarkWarrior,2839,149,3,8,11,27.3%,17m
21094,1,[DrNost]PatrickSwayz,2839,97,2,0,2,100.0%,53m
21094,3,LeGrif,2839,30,2,1,3,66.7%,28m
21094,3,Thermidor,2839,30,2,2,4,50.0%,19m
21094,3,Houndog,2839,20,2,2,4,50.0%,7m
21094,3,tumarido,2839,30,2,3,5,40.0%,30m
21094,1,[GBrdge]FatPanda,2839,0,1,1,2,50.0%,51m
21094,2,[CtO]Fritz,2839,0,1,1,2,50.0%,12m
21094,3,hobonomo,2839,0,1,1,2,50.0%,27m
21094,2,Khashoggi,2839,0,1,2,3,33.3%,30m
21094,3,apocalypse,2839,0,0,1,1,0.0%,17m
21094,3,RichardButte,2839,0,0,1,1,0.0%,20m
21094,3,LrdThumbTcks,2839,0,0,2,2,0.0%,41m
21094,2,Loscolo,2839,0,0,6,6,0.0%,15m
21118,1,[InstaF]AtNano,2838,1511,117,100,217,53.9%,10m
21118,3,ikros,2838,1563,108,93,201,53.7%,23m
21118,2,penumbra,2838,1407,105,104,209,50.2%,33m
21118,3,peeps,2838,1144,93,74,167,55.7%,22m
21118,2,llllllllll,2838,1312,56,53,109,51.4%,12m
21118,2,Bravehydra,2838,1023,40,41,81,49.4%,27m
21118,1,voagyn,2838,884,35,35,70,50.0%,30m
21118,2,VDvicios,2838,780,30,27,57,52.6%,39m
21118,3,Deathcell,2838,582,27,14,41,65.9%,28m
21118,3,Ravelcan,2838,629,27,21,48,56.2%,23m
21118,2,BLuBOniC,2838,281,26,26,52,50.0%,36m
21118,2,chickeneater,2838,684,25,25,50,50.0%,13m
21118,3,Katox,2838,467,20,24,44,45.5%,14m
21118,2,[Pig2]Nimor,2838,472,19,17,36,52.8%,12m
21118,2,Benjy,2838,166,16,15,31,51.6%,36m
21118,3,AaronZ,2838,397,15,9,24,62.5%,41m
21118,3,Dares,2838,301,14,1,15,93.3%,33m
21118,2,Zanderax,2838,282,11,9,20,55.0%,4m
21118,2,[TGosuB]ShinyDialga,2838,176,7,9,16,43.8%,39m
21118,2,[QCriss]ElvisPresley,2838,0,4,1,5,80.0%,43m
21118,3,CTMxTuRu,2838,86,4,1,5,80.0%,17m
21118,2,[GaaaSQ]marcelocheXD,2838,168,4,7,11,36.4%,36m
21118,2,Paton,2838,0,3,3,6,50.0%,8m
21118,2,Ryuzaki,2838,96,3,7,10,30.0%,6m
21118,2,shahim,2838,48,2,1,3,66.7%,7m
21118,3,EpicBioHacks,2838,0,1,0,1,100.0%,27m
21118,3,UNSLAUGHT,2838,30,1,4,5,20.0%,42m
21118,3,psimonkey,2838,0,0,1,1,0.0%,2m
21118,3,Trinity,2838,0,0,1,1,0.0%,11m
21118,3,ZeProzin,2838,0,0,1,1,0.0%,14m
21118,3,[GGxRE]Zuko,2838,0,0,2,2,0.0%,11m
21149,2,VELENGUER,2837,1561,218,223,441,49.4%,32m
21149,2,AquaRage,2837,1615,72,69,141,51.1%,27m
21149,3,Cindy,2837,1487,63,50,113,55.8%,30m
21149,2,MachBambino,2837,860,40,28,68,58.8%,8m
21149,2,[UpxV]CRRR,2837,779,32,28,60,53.3%,25m
21149,1,[haut]grep,2837,640,28,26,54,51.9%,38m
21149,3,[HOUNDS]PlainCake,2837,666,25,18,43,58.1%,27m
21149,3,[NM8]JAIMELEPROX,2837,415,17,10,27,63.0%,10m
21149,3,npp,2837,243,14,12,26,53.8%,38m
21149,3,ZammyBanger,2837,273,12,6,18,66.7%,5m
21149,2,Polar,2837,294,12,14,26,46.2%,2m
21149,2,BaneTime,2837,259,10,10,20,50.0%,23m
21149,1,loel,2837,184,8,10,18,44.4%,13m
21149,1,Kchavas,2837,168,6,5,11,54.5%,56m
21149,3,WarMagi,2837,216,6,5,11,54.5%,2h
21149,3,[200107]SunnyJM,2837,114,5,2,7,71.4%,25m
21149,1,Phyume,2837,167,5,5,10,50.0%,3h
21149,2,BroodRiven,2837,116,4,3,7,57.1%,32m
21149,3,Benjamin,2837,168,4,3,7,57.1%,38m
21149,3,RoachsRUs,2837,30,4,3,7,57.1%,23m
21149,3,Sancheez,2837,86,3,1,4,75.0%,29m
21149,2,[BWLL]Marusvineyrd,2837,0,3,2,5,60.0%,2h
21149,2,MrBubbles,2837,48,3,3,6,50.0%,48m
21149,3,LeoMessiFan,2837,62,3,3,6,50.0%,13m
21149,2,PreToriaN,2837,90,3,7,10,30.0%,33m
21149,1,RustyVenture,2837,97,2,1,3,66.7%,3h
21149,3,MAL,2837,0,1,0,1,100.0%,8m
21149,3,eftexem,2837,30,1,1,2,50.0%,20m
21149,2,[gooby]Sightless,2837,0,1,1,2,50.0%,2h
21149,3,[OvG]THERA,2837,30,1,3,4,25.0%,22m
21149,1,ObiWanKanoli,2837,38,1,15,16,6.2%,39m
21149,1,[beef69]Chodemuffin,2837,0,0,1,1,0.0%,2h
21149,3,Takra,2837,0,0,1,1,0.0%,12m
21182,2,Lazartes,2836,1033,104,88,192,54.2%,14m
21182,3,ShotgunB,2836,1420,92,63,155,59.4%,11m
21182,2,Mirka,2836,680,65,60,125,52.0%,6m
21182,2,CptnSwizzelz,2836,932,42,32,74,56.8%,16m
21182,2,[OPGame]SoFX,2836,880,40,26,66,60.6%,23m
21182,2,Zargom,2836,597,34,24,58,58.6%,13m
21182,3,BEEEEJ,2836,560,24,21,45,53.3%,21m
21182,3,WarPig,2836,540,22,14,36,61.1%,31m
21182,3,[ILAGI]Tragic,2836,427,17,14,31,54.8%,41m
21182,3,Cardinali,2836,302,15,3,18,83.3%,38m
21182,2,max,2836,107,13,9,22,59.1%,4m
21182,2,Jozzemma,2836,290,11,12,23,47.8%,22m
21182,1,MingyGorp,2836,197,11,14,25,44.0%,20m
21182,3,Tryphe,2836,257,8,20,28,28.6%,28m
21182,1,XenderDark,2836,146,6,4,10,60.0%,24m
21182,3,[KJND]Haushinka,2836,140,5,3,8,62.5%,8m
21182,3,llEDll,2836,130,5,4,9,55.6%,24m
21182,3,[HGDO]ColdHands,2836,151,4,4,8,50.0%,54m
21182,3,Wintergrasp,2836,88,3,4,7,42.9%,19m
21182,2,Hobbes,2836,90,3,5,8,37.5%,16m
21182,3,[ECrush]ShiniGami,2836,30,2,1,3,66.7%,20m
21182,3,Lippstadt,2836,30,2,2,4,50.0%,3m
21182,2,TheDark,2836,30,2,4,6,33.3%,36m
21182,3,MotownHero,2836,62,2,4,6,33.3%,20m
21182,3,ConcealedCap,2836,0,1,0,1,100.0%,13m
21182,3,Bubba,2836,0,1,0,1,100.0%,24m
21182,1,[P3T3S]Avicknash,2836,0,1,0,1,100.0%,20m
21182,3,JawnDeep,2836,0,1,0,1,100.0%,14m
21182,2,[cLoBoS]Metal,2836,0,1,1,2,50.0%,36m
21182,3,[FalPal]Alchemy,2836,0,1,4,5,20.0%,27m
21182,1,[hTx]Joker,2836,0,1,5,6,16.7%,3h
21182,3,Kaneda,2836,0,0,1,1,0.0%,26m
21182,3,TinLeague,2836,0,0,1,1,0.0%,25m
21182,3,DeanoRino,2836,0,0,1,1,0.0%,9m
21182,3,HierbaSanta,2836,0,0,1,1,0.0%,13m
21217,2,chickenjoy,2835,733,100,96,196,51.0%,4m
21217,2,Jahrobokahn,2835,1460,59,53,112,52.7%,35m
21217,3,[ScScUr]Donald,2835,720,45,53,98,45.9%,19m
21217,1,Silverleysh,2835,1253,44,51,95,46.3%,21m
21217,2,CamoKat,2835,585,37,37,74,50.0%,38m
21217,3,Luiso,2835,328,16,2,18,88.9%,38m
21217,2,Alien,2835,332,13,14,27,48.1%,16m
21217,3,FUNKYFUNTIME,2835,325,10,34,44,22.7%,14m
21217,1,Awkwerdturtl,2835,226,7,14,21,33.3%,2m
21217,2,[ktkzs]HSM,2835,175,6,5,11,54.5%,15m
21217,3,[WMEQ]Ictinike,2835,181,6,7,13,46.2%,2h
21217,3,[SYNDCT]Jongsongs,2835,88,4,2,6,66.7%,3m
21217,3,AzaSMtt,2835,114,4,5,9,44.4%,29m
21217,2,Sampro,2835,88,4,7,11,36.4%,41m
21217,3,ººº,2835,86,3,1,4,75.0%,26m
21217,2,PiGCommander,2835,30,2,5,7,28.6%,21m
21217,2,[CCrush]ionICVag,2835,30,2,7,9,22.2%,37m
21217,3,Escape,2835,0,1,0,1,100.0%,4m
21217,1,MooseTurtle,2835,0,1,0,1,100.0%,2h
21217,3,Barada,2835,30,1,1,2,50.0%,6m
21217,3,deathwolf,2835,0,0,1,1,0.0%,29m
21217,3,[prIK]Cbear,2835,0,0,3,3,0.0%,41m
21217,3,XIII,2835,0,0,5,5,0.0%,42m
21217,2,Aed,2835,0,0,5,5,0.0%,5m
21217,2,[Black0]CHELOMANO,2835,0,0,5,5,0.0%,15m
21242,1,Ynkara,2834,1110,170,163,333,51.1%,23m
21242,2,[FFAA]titopsk,2834,974,64,41,105,61.0%,35m
21242,3,[XpKAc]Lorsond,2834,1131,60,44,104,57.7%,7m
21242,3,Usernemo,2834,814,36,29,65,55.4%,11m
21242,2,superpraw,2834,736,26,34,60,43.3%,6m
21242,2,[GgARMY]Boxheas,2834,353,15,11,26,57.7%,21m
21242,3,Cyberfire,2834,384,14,13,27,51.9%,6m
21242,2,Terran,2834,359,12,12,24,50.0%,17m
21242,1,[BlGD]ghost,2834,201,9,10,19,47.4%,26m
21242,3,TBD,2834,160,7,6,13,53.8%,16m
21242,2,xiL,2834,226,7,8,15,46.7%,34m
21242,3,whackadronie,2834,198,7,8,15,46.7%,5m
21242,1,Normal,2834,96,6,4,10,60.0%,2h
21242,3,ZardBrood,2834,147,6,6,12,50.0%,2h
21242,3,Blackbird,2834,182,6,7,13,46.2%,31m
21242,1,Drekn,2834,150,5,8,13,38.5%,2h
21242,2,[Weac]diSoriEntEd,2834,138,4,5,9,44.4%,8m
21242,3,ItsJustWoody,2834,0,3,2,5,60.0%,8m
21242,2,MrFrodo,2834,0,3,2,5,60.0%,1h
21242,2,DOTAFOREVER,2834,102,3,3,6,50.0%,15m
21242,3,chorebot,2834,32,2,2,4,50.0%,24m
21242,3,[TPLUSS]marsman,2834,0,1,0,1,100.0%,33m
21242,3,Fitznasty,2834,0,1,0,1,100.0%,20m
21242,3,Hazfun,2834,30,1,3,4,25.0%,23m
21242,2,AbdarRahman,2834,30,1,5,6,16.7%,10m
21242,1,[Celts]Dargon,2834,0,0,1,1,0.0%,4m
21242,3,BTKBolt,2834,0,0,1,1,0.0%,7m
21242,1,CountAlucard,2834,0,0,1,1,0.0%,38m
21242,3,talon,2834,0,0,1,1,0.0%,19m
21271,1,Naviester,2833,1584,66,54,120,55.0%,18m
21271,2,[INVADS]Mandalorian,2833,882,50,40,90,55.6%,37m
21271,2,Zerox,2833,507,38,38,76,50.0%,27m
21271,2,TheBetterLai,2833,1002,36,36,72,50.0%,43m
21271,2,Aliform,2833,405,32,30,62,51.6%,36m
21271,3,daddykisser,2833,640,28,14,42,66.7%,40m
21271,3,asparagus,2833,322,21,20,41,51.2%,38m
21271,3,Skyguy,2833,346,13,12,25,52.0%,38m
21271,2,Jesua,2833,258,9,9,18,50.0%,16m
21271,2,yoo,2833,134,6,4,10,60.0%,39m
21271,3,Anka,2833,148,6,6,12,50.0%,38m
21271,1,mike,2833,210,6,15,21,28.6%,2h
21271,3,Strife,2833,0,4,1,5,80.0%,32m
21271,3,[PPTr]SpruceTurtle,2833,58,3,0,3,100.0%,5m
21271,1,Leinad,2833,94,2,1,3,66.7%,13m
21271,2,LetsMacro,2833,88,2,1,3,66.7%,36m
21271,3,[KOYOMI]PROBER,2833,58,2,2,4,50.0%,25m
21271,3,EnNemMy,2833,30,2,3,5,40.0%,6m
21271,2,XeNo,2833,66,2,8,10,20.0%,36m
21271,1,SovietUnion,2833,0,1,0,1,100.0%,2h
21271,1,[tDwbh]Arma,2833,0,1,0,1,100.0%,3h
21271,3,Ormuz,2833,0,1,0,1,100.0%,41m
21271,3,[NTrio]DirigoX,2833,0,1,1,2,50.0%,21m
21271,3,PORCINO,2833,0,1,1,2,50.0%,35m
21271,1,Pyromaniac,2833,0,1,1,2,50.0%,53m
21271,3,[L3gion]Abortionist,2833,0,1,2,3,33.3%,28m
21271,3,Multigun,2833,30,1,4,5,20.0%,30m
21271,3,paelmer,2833,0,0,1,1,0.0%,42m
21271,3,[ZTemp]BroodWar,2833,0,0,1,1,0.0%,19m
21300,2,bearvasquez,2832,1510,114,108,222,51.4%,32m
21300,2,Karltomwaffe,2832,1524,108,110,218,49.5%,25m
21300,2,Love,2832,676,82,77,159,51.6%,37m
21300,2,Thanos,2832,1047,82,77,159,51.6%,39m
21300,3,thefatninja,2832,706,70,58,128,54.7%,41m
21300,2,Nitehawk,2832,528,18,22,40,45.0%,17m
21300,3,Alex,2832,440,16,13,29,55.2%,24m
21300,3,[QcP]Torvic,2832,321,13,3,16,81.2%,38m
21300,3,shadow,2832,334,12,5,17,70.6%,42m
21300,3,[TPGGXD]elTipo,2832,307,10,10,20,50.0%,7m
21300,2,[McFIy]Caronte,2832,288,10,12,22,45.5%,34m
21300,2,Skyler,2832,240,9,9,18,50.0%,14m
21300,1,[YMW]Waffles,2832,230,9,12,21,42.9%,42m
21300,1,Graphic,2832,76,6,7,13,46.2%,18m
21300,3,[0l0l0]TERKANO,2832,178,6,8,14,42.9%,22m
21300,2,iamnoob,2832,30,4,3,7,57.1%,10m
21300,1,Darakay,2832,122,4,4,8,50.0%,3h
21300,2,Kaczynski,2832,0,3,2,5,60.0%,2h
21300,3,[LOYAPÚ]Atilas,2832,30,2,0,2,100.0%,22m
21300,3,[LimaSC]KamoTee,2832,58,2,1,3,66.7%,26m
21300,3,SneakyTurtle,2832,30,2,3,5,40.0%,19m
21300,2,Bee,2832,0,2,3,5,40.0%,2h
21300,3,Ubereem,2832,60,2,3,5,40.0%,13m
21300,2,OdinAllFawda,2832,30,2,5,7,28.6%,31m
21300,2,pieces,2832,32,2,5,7,28.6%,2m
21300,3,GGAllin,2832,0,1,0,1,100.0%,15m
21300,3,[Noubs]Yaoung,2832,0,0,1,1,0.0%,6m
21300,3,[BA5B]onetime,2832,0,0,2,2,0.0%,20m
21300,1,[TaeGG]Silent,2832,0,0,2,2,0.0%,2h
21329,3,contrademonx,2831,1593,282,251,533,52.9%,31m
21329,1,[DLe]chatoworld,2831,1373,161,163,324,49.7%,30m
21329,1,[αB]JBJB,2831,1102,150,126,276,54.3%,34m
21329,2,Mark,2831,1383,96,99,195,49.2%,42m
21329,3,comunista,2831,949,46,27,73,63.0%,33m
21329,2,Moist,2831,434,45,32,77,58.4%,15m
21329,2,[FiFo]Verblazo,2831,637,42,39,81,51.9%,5m
21329,2,TiLTED,2831,816,30,31,61,49.2%,15m
21329,3,trashPanda,2831,736,26,25,51,51.0%,9m
21329,3,Fourlan,2831,479,25,14,39,64.1%,27m
21329,3,Meja,2831,446,16,16,32,50.0%,14m
21329,3,tom,2831,369,15,5,20,75.0%,16m
21329,2,BeanslyJones,2831,257,13,19,32,40.6%,9m
21329,3,Anexful,2831,232,12,1,13,92.3%,2h
21329,3,Axe,2831,213,11,3,14,78.6%,28m
21329,3,[TGosuA]Halcyonic,2831,233,11,26,37,29.7%,30m
21329,3,[Wonna]Ghostbusters,2831,263,10,2,12,83.3%,35m
21329,2,Dment,2831,279,9,5,14,64.3%,49m
21329,3,[ARCsc2]Wrynn,2831,235,7,5,12,58.3%,4m
21329,1,Venom,2831,141,6,2,8,75.0%,3h
21329,3,Vicum,2831,0,4,1,5,80.0%,40m
21329,1,Xicararnn,2831,0,4,3,7,57.1%,15m
21329,2,noobling,2831,88,4,3,7,57.1%,8m
21329,3,[xEx]Addeour,2831,58,3,0,3,100.0%,28m
21329,2,Ehie,2831,0,3,3,6,50.0%,29m
21329,3,[Kusshh]taux,2831,60,2,6,8,25.0%,5m
21329,3,Deathcaptain,2831,0,1,0,1,100.0%,12m
21329,3,Noodlelisk,2831,0,1,1,2,50.0%,25m
21329,3,[wrynn]rebeatle,2831,30,1,6,7,14.3%,9m
21329,3,LaStDraGoon,2831,0,0,1,1,0.0%,9m
21329,1,Patagonia,2831,0,0,1,1,0.0%,3h
21329,3,AndroniusMax,2831,0,0,1,1,0.0%,27m
21329,1,[LIVER]Wuxy,2831,0,0,1,1,0.0%,2h
21362,1,Kermit,2830,1590,350,353,703,49.8%,3m
21362,2,EJequalsLast,2830,1096,179,161,340,52.6%,25m
21362,1,ManBearPig,2830,1572,140,127,267,52.4%,38m
21362,3,Sabbath,2830,1216,124,108,232,53.4%,41m
21362,3,Bartimaeus,2830,1273,72,59,131,55.0%,25m
21362,3,ZodiAc,2830,1203,62,35,97,63.9%,40m
21362,2,SHICE,2830,999,43,39,82,52.4%,36m
21362,3,Colossus,2830,582,31,13,44,70.5%,17m
21362,3,Mybaran,2830,485,30,21,51,58.8%,20m
21362,1,[Flar3s]OneSpeed,2830,608,21,27,48,43.8%,10m
21362,3,tallest,2830,442,18,14,32,56.2%,38m
21362,3,ElLameBotas,2830,368,16,7,23,69.6%,27m
21362,1,Shakira,2830,440,15,29,44,34.1%,32m
21362,3,Chupin,2830,337,14,14,28,50.0%,35m
21362,3,bennyr,2830,308,12,12,24,50.0%,9m
21362,2,Rabito,2830,300,11,12,23,47.8%,32m
21362,1,Faesvi,2830,142,7,8,15,46.7%,11m
21362,2,[VRGA]doctorcien,2830,210,7,12,19,36.8%,37m
21362,3,[TPAZ]Ben,2830,172,6,4,10,60.0%,6m
21362,3,[AbcCo]xXMelvinGVXx,2830,174,6,9,15,40.0%,39m
21362,3,LilDirt,2830,114,5,4,9,55.6%,23m
21362,3,Hades,2830,144,4,0,4,100.0%,33m
21362,2,Striker,2830,144,4,6,10,40.0%,9m
21362,3,phanSkee,2830,118,4,6,10,40.0%,32m
21362,2,Pie,2830,122,4,9,13,30.8%,32m
21362,3,[mtcL]zerg,2830,54,3,3,6,50.0%,21m
21362,3,Killerfridge,2830,60,3,4,7,42.9%,36m
21362,2,Vandertoss,2830,90,3,7,10,30.0%,6m
21362,1,[RaR]DEUCEBAG,2830,96,2,4,6,33.3%,3h
21362,3,Machiavelli,2830,94,2,4,6,33.3%,23m
21362,3,Typhooey,2830,0,1,0,1,100.0%,22m
21362,3,MeriKrizmaz,2830,0,1,1,2,50.0%,5m
21362,3,[RINGTA]CrimeLemur,2830,0,1,2,3,33.3%,13m
21362,3,[B4M]ghost,2830,30,1,4,5,20.0%,2m
21362,3,[NLTN]Duff,2830,30,1,4,5,20.0%,3m
21362,2,rockhead,2830,88,1,7,8,12.5%,21m
21362,2,[APSCL]MaRiOREM,2830,0,1,7,8,12.5%,42m
21362,2,Shawn,2830,0,0,1,1,0.0%,3h
21362,3,ElPolloLoco,2830,0,0,3,3,0.0%,19m
21362,2,[Discor]MrPowerpalm,2830,0,0,4,4,0.0%,4m
21402,2,Chaotic,2829,827,76,69,145,52.4%,38m
21402,3,Binzl,2829,869,64,49,113,56.6%,9m
21402,2,Alibaba,2829,952,58,51,109,53.2%,42m
21402,2,ELMichi,2829,1214,48,47,95,50.5%,21m
21402,2,[boeuf]Gateaux,2829,905,46,42,88,52.3%,24m
21402,3,[Test42]dbrophy,2829,1115,45,36,81,55.6%,5m
21402,2,ZergOP,2829,442,19,19,38,50.0%,25m
21402,3,Ghost,2829,425,16,12,28,57.1%,17m
21402,3,BearSlayer,2829,380,13,14,27,48.1%,40m
21402,2,[L2P4L]EpicD,2829,338,12,10,22,54.5%,2h
21402,3,Monkey,2829,218,7,3,10,70.0%,12m
21402,1,VampLestat,2829,30,6,3,9,66.7%,10m
21402,3,Dreadnaught,2829,168,6,4,10,60.0%,16m
21402,2,Fluffy,2829,30,4,4,8,50.0%,8m
21402,3,LooneyToon,2829,114,4,6,10,40.0%,11m
21402,3,Taxoakumi,2829,58,3,2,5,60.0%,28m
21402,3,Tzimisce,2829,30,2,3,5,40.0%,11m
21402,3,[UofC]Oldman,2829,30,1,2,3,33.3%,23m
21402,3,zongeruge,2829,30,1,3,4,25.0%,38m
21421,2,[ZTemps]shathai,2828,1307,156,129,285,54.7%,36m
21421,2,tattlebag,2828,1621,123,97,220,55.9%,36m
21421,2,GrayFox,2828,1370,86,76,162,53.1%,36m
21421,1,HighGround,2828,1096,54,56,110,49.1%,20m
21421,3,[Shout]Extreme,2828,972,51,42,93,54.8%,19m
21421,1,Krustofski,2828,1341,50,52,102,49.0%,6m
21421,2,EvilEd,2828,1102,43,41,84,51.2%,7m
21421,2,TrafcoRaviol,2828,648,27,27,54,50.0%,32m
21421,3,Miyranda,2828,399,24,15,39,61.5%,27m
21421,2,Toastmaster,2828,412,22,25,47,46.8%,35m
21421,2,[SKyber]vitor,2828,299,21,18,39,53.8%,32m
21421,3,Reflex,2828,359,20,19,39,51.3%,35m
21421,1,llllllllllll,2828,512,17,26,43,39.5%,13m
21421,1,Krattoss,2828,446,13,26,39,33.3%,12m
21421,3,TiGuai,2828,269,9,4,13,69.2%,12m
21421,3,eldiablorojo,2828,256,9,10,19,47.4%,7m
21421,3,GroundHawk,2828,226,8,6,14,57.1%,23m
21421,3,Demora,2828,118,5,7,12,41.7%,29m
21421,3,NoScared,2828,127,4,0,4,100.0%,7m
21421,3,BarCode,2828,0,4,1,5,80.0%,11m
21421,3,mattluke,2828,88,4,3,7,57.1%,11m
21421,3,LOLKFC,2828,58,3,0,3,100.0%,25m
21421,2,howdoizerg,2828,48,3,2,5,60.0%,2h
21421,2,Boxer,2828,0,3,2,5,60.0%,2h
21421,3,[LUE]yorick,2828,0,2,3,5,40.0%,20m
21421,3,LazyTurtle,2828,0,2,3,5,40.0%,34m
21421,3,shadowmonk,2828,0,1,0,1,100.0%,8m
21421,2,HerblinG,2828,30,1,7,8,12.5%,6m
21421,3,JagoShadow,2828,0,0,1,1,0.0%,16m
21421,3,[US]theFuzzyNeck,2828,0,0,1,1,0.0%,13m
21421,3,[VECT]seanzor,2828,0,0,1,1,0.0%,8m
21421,3,Baiter,2828,0,0,1,1,0.0%,16m
21453,3,NicolitasNB,2827,1447,286,232,518,55.2%,39m
21453,3,GOLPEOAMAMA,2827,452,95,79,174,54.6%,27m
21453,3,AugustoMW,2827,1627,90,87,177,50.8%,19m
21453,2,Darvein,2827,1440,75,66,141,53.2%,22m
21453,2,Zeddicus,2827,1230,62,57,119,52.1%,27m
21453,3,Stelina,2827,628,30,10,40,75.0%,26m
21453,3,Toffee,2827,263,29,14,43,67.4%,20m
21453,1,Ezeerhp,2827,165,17,29,46,37.0%,5m
21453,2,GreasyJoe,2827,452,15,21,36,41.7%,37m
21453,3,LaBlague,2827,195,9,4,13,69.2%,28m
21453,2,[DontRN]GerarldH,2827,110,5,8,13,38.5%,32m
21453,1,HolyTemplar,2827,0,4,3,7,57.1%,11m
21453,3,TinyLittlDot,2827,86,3,2,5,60.0%,28m
21453,3,[EGx]Kliveran,2827,58,3,3,6,50.0%,14m
21453,3,AusarKun,2827,89,3,3,6,50.0%,31m
21453,1,Dalton,2827,0,3,4,7,42.9%,53m
21453,3,killonater,2827,30,2,0,2,100.0%,20m
21453,1,itsneverogre,2827,82,2,10,12,16.7%,2h
21453,3,Erion,2827,0,1,0,1,100.0%,36m
21453,3,grEEngLade,2827,0,1,1,2,50.0%,7m
21453,2,[LowIQ]Tar,2827,0,1,2,3,33.3%,35m
21453,3,Heatseeker,2827,30,1,3,4,25.0%,33m
21453,3,[FDV]Squirtlizer,2827,0,0,1,1,0.0%,4m
21453,3,Brotoss,2827,0,0,1,1,0.0%,13m
21477,2,Folstag,2826,1542,99,79,178,55.6%,33m
21477,3,Kaabu,2826,802,69,45,114,60.5%,5m
21477,2,UnJust,2826,906,39,30,69,56.5%,13m
21477,3,YogurtEater,2826,510,20,16,36,55.6%,7m
21477,2,Gibson,2826,267,9,5,14,64.3%,20m
21477,3,Liam,2826,216,8,7,15,53.3%,2h
21477,1,Tanster,2826,146,6,6,12,50.0%,30m
21477,1,GainersNCash,2826,96,4,1,5,80.0%,38m
21477,2,angelperdido,2826,124,4,8,12,33.3%,38m
21477,2,[Kats]Pushigoh,2826,120,4,11,15,26.7%,33m
21477,3,schmidty,2826,30,3,4,7,42.9%,11m
21477,2,Decreed,2826,0,2,5,7,28.6%,21m
21477,3,[PNKN]Peadan,2826,0,1,0,1,100.0%,3m
21477,3,ChugaJS,2826,0,1,0,1,100.0%,29m
21477,3,EmilyFox,2826,0,1,2,3,33.3%,40m
21477,3,[sc2rep]Crabalanche,2826,0,0,1,1,0.0%,7m
21477,3,changhavv,2826,0,0,1,1,0.0%,37m
21494,2,cemt,2825,1544,331,328,659,50.2%,32m
21494,1,RAZGUT,2825,1586,157,146,303,51.8%,42m
21494,2,[αXLa]UnRepollo,2825,885,91,68,159,57.2%,7m
21494,3,Sippycup,2825,1205,80,67,147,54.4%,25m
21494,2,CerealKiller,2825,1566,71,50,121,58.7%,8m
21494,3,Jerkie,2825,1266,56,50,106,52.8%,7m
21494,3,xDurillo,2825,584,47,22,69,68.1%,27m
21494,2,[illers]Westend,2825,850,40,43,83,48.2%,32m
21494,3,ShishTaouk,2825,942,38,32,70,54.3%,3m
21494,1,JORGE,2825,944,37,38,75,49.3%,14m
21494,3,jesuwolf,2825,315,14,1,15,93.3%,16m
21494,1,rootantz,2825,215,8,6,14,57.1%,3h
21494,3,Oswarners,2825,240,8,7,15,53.3%,26m
21494,3,Megatron,2825,176,7,9,16,43.8%,17m
21494,3,DarkSlayer,2825,0,4,1,5,80.0%,31m
21494,2,WrAiTh,2825,96,4,2,6,66.7%,2h
21494,3,LilPinkyToe,2825,0,3,2,5,60.0%,36m
21494,3,iron,2825,88,3,4,7,42.9%,16m
21494,3,StarProz,2825,60,3,4,7,42.9%,22m
21494,1,CorporalSky,2825,104,3,16,19,15.8%,38m
21494,3,Zephyrn,2825,30,2,2,4,50.0%,21m
21494,3,[Pinc]cloD,2825,58,2,6,8,25.0%,12m
21494,2,babai,2825,58,2,6,8,25.0%,12m
21494,3,ForevrADrone,2825,0,1,0,1,100.0%,5m
21494,3,KingSKorpion,2825,0,1,0,1,100.0%,8m
21494,2,[cell5]KongShlong,2825,0,1,3,4,25.0%,43m
21494,3,[MRCYLS]Nightmare,2825,30,1,5,6,16.7%,4m
21521,2,DonOso,2824,1429,135,108,243,55.6%,29m
21521,2,bardock,2824,1564,133,116,249,53.4%,40m
21521,1,EoS,2824,488,48,49,97,49.5%,24m
21521,2,McSpankyyy,2824,855,43,37,80,53.8%,33m
21521,2,Glazed,2824,263,19,16,35,54.3%,38m
21521,2,[TOOTS]eighteenyet,2824,400,17,16,33,51.5%,6m
21521,2,Nitruo,2824,299,13,8,21,61.9%,2h
21521,2,KLH,2824,176,12,17,29,41.4%,14m
21521,2,ARES,2824,222,10,8,18,55.6%,22m
21521,3,[TScrub]BrianJenkins,2824,237,8,6,14,57.1%,16m
21521,3,[QUDS]Kerberus,2824,208,8,6,14,57.1%,11m
21521,3,ronaldras,2824,219,8,8,16,50.0%,27m
21521,3,[BONCK]Nizuto,2824,172,5,5,10,50.0%,3h
21521,3,Raernian,2824,86,4,2,6,66.7%,33m
21521,3,DontSquirt,2824,80,4,3,7,57.1%,42m
21521,2,Laharl,2824,46,3,3,6,50.0%,46m
21521,3,JSMaster,2824,143,3,4,7,42.9%,35m
21521,3,[SL3ePY]Rampart,2824,30,2,2,4,50.0%,5m
21521,3,Hawk,2824,0,1,0,1,100.0%,24m
21521,3,[MNSV]hotgamerth,2824,30,1,1,2,50.0%,26m
21521,3,[TheRs]Warfield,2824,0,0,1,1,0.0%,18m
21521,3,Billingsley,2824,0,0,1,1,0.0%,28m
21543,3,willyam,2823,1578,144,102,246,58.5%,9m
21543,3,[HSI]slcdt,2823,1550,117,107,224,52.2%,36m
21543,2,Squirrly,2823,1445,115,92,207,55.6%,26m
21543,2,[GRNSKN]Ironic,2823,1334,105,98,203,51.7%,15m
21543,3,INTRUDER,2823,920,104,120,224,46.4%,7m
21543,2,Ecliptic,2823,1214,47,47,94,50.0%,19m
21543,2,Slapfunk,2823,962,43,32,75,57.3%,35m
21543,1,Accel,2823,354,39,46,85,45.9%,25m
21543,2,[T1G]ThatOneGuy,2823,954,36,39,75,48.0%,17m
21543,2,OilyMan,2823,711,29,23,52,55.8%,6m
21543,3,Sgtmajorlee,2823,536,26,27,53,49.1%,24m
21543,2,DaddyFocus,2823,627,24,21,45,53.3%,25m
21543,3,Primo,2823,523,21,13,34,61.8%,32m
21543,2,[Gaemer]IIIIIIIIIIII,2823,314,18,11,29,62.1%,15m
21543,2,HiddenPants,2823,406,17,16,33,51.5%,32m
21543,2,TheCarry,2823,197,15,11,26,57.7%,36m
21543,3,Zenith,2823,418,15,11,26,57.7%,35m
21543,3,knight,2823,309,13,31,44,29.5%,26m
21543,3,claudioexter,2823,280,11,10,21,52.4%,11m
21543,2,Matt,2823,324,11,16,27,40.7%,28m
21543,3,biRtH,2823,200,7,9,16,43.8%,26m
21543,2,JDMorgan,2823,146,6,5,11,54.5%,22m
21543,2,ThirdyM,2823,182,6,8,14,42.9%,25m
21543,3,YourMomsBoss,2823,114,4,4,8,50.0%,14m
21543,1,Mertaugh,2823,145,3,6,9,33.3%,2h
21543,3,lNiClK,2823,97,2,0,2,100.0%,54m
21543,2,Warchief,2823,48,2,0,2,100.0%,46m
21543,2,NobleGenesis,2823,0,2,3,5,40.0%,52m
21543,2,Yggdrasil,2823,62,2,8,10,20.0%,12m
21543,3,Neat,2823,0,1,1,2,50.0%,21m
21543,3,coffeeNcan,2823,30,1,2,3,33.3%,30m
21543,3,Erowid,2823,30,1,2,3,33.3%,5m
21543,3,[WLFSPK]WolfsButcher,2823,0,0,1,1,0.0%,19m
21543,3,[FETT]LuBu,2823,0,0,1,1,0.0%,27m
21543,3,troll,2823,0,0,1,1,0.0%,29m
21578,1,Vengeance,2822,1368,188,183,371,50.7%,20m
21578,2,Ggornostog,2822,923,141,133,274,51.5%,36m
21578,3,[EpicG]survivor,2822,758,58,47,105,55.2%,38m
21578,2,PokerHuang,2822,1176,57,60,117,48.7%,36m
21578,3,[Ex0n]iveseenbiggr,2822,616,28,13,41,68.3%,23m
21578,2,[DRKSDS]Ender,2822,401,24,22,46,52.2%,35m
21578,3,MilkyDad,2822,519,23,17,40,57.5%,29m
21578,3,[ZTemp]ShadowZero,2822,340,15,7,22,68.2%,12m
21578,3,[IDoom]Harbinger,2822,426,14,16,30,46.7%,14m
21578,2,OceaN,2822,432,14,24,38,36.8%,42m
21578,1,[Flares]Soldier,2822,352,10,17,27,37.0%,32m
21578,2,AMANGBS,2822,252,8,9,17,47.1%,15m
21578,2,[LOHd]IIIIIIIIIIII,2822,252,8,10,18,44.4%,26m
21578,1,[GØSU]Virtual,2822,240,8,18,26,30.8%,27m
21578,1,Alexander,2822,183,7,8,15,46.7%,24m
21578,1,Marvin,2822,160,7,12,19,36.8%,30m
21578,3,LFxDyablo,2822,114,5,2,7,71.4%,41m
21578,2,[DASUL]cuapantecatl,2822,143,5,6,11,45.5%,38m
21578,2,[N0uBz]Hero,2822,30,4,4,8,50.0%,37m
21578,2,SDMX,2822,3,4,11,15,26.7%,31m
21578,3,KilluaZoldiK,2822,58,3,2,5,60.0%,31m
21578,2,[TTSP]Nonlaggygamr,2822,0,3,2,5,60.0%,2h
21578,3,[bm4Fun]TerranKaren,2822,90,3,4,7,42.9%,23m
21578,3,Faker,2822,88,3,4,7,42.9%,29m
21578,3,PaleAle,2822,90,3,7,10,30.0%,11m
21578,3,Dudemeister,2822,0,2,4,6,33.3%,41m
21578,3,TerrMan,2822,0,1,0,1,100.0%,12m
21578,3,[Kinkie]Whaddhack,2822,0,1,0,1,100.0%,20m
21578,3,[TYNXT]DoubleCat,2822,0,1,1,2,50.0%,30m
21578,2,MPT,2822,88,1,3,4,25.0%,16m
21608,1,Hanibal,2821,1533,246,243,489,50.3%,20m
21608,3,Zacknetic,2821,1466,234,221,455,51.4%,34m
21608,3,Betelgeuse,2821,912,92,77,169,54.4%,25m
21608,2,[NeAs]Zippo,2821,1245,70,60,130,53.8%,36m
21608,2,TheDefiler,2821,649,59,50,109,54.1%,41m
21608,3,[MSTEIN]Eeyore,2821,600,54,38,92,58.7%,11m
21608,2,KingSimp,2821,920,43,31,74,58.1%,8m
21608,3,Amish,2821,991,41,33,74,55.4%,4m
21608,1,blackbriar,2821,597,28,31,59,47.5%,20m
21608,2,[TPGGXD]BallsDeep,2821,710,26,29,55,47.3%,7m
21608,3,Payyne,2821,543,25,27,52,48.1%,25m
21608,3,[NSJ]LoGiC,2821,550,24,21,45,53.3%,32m
21608,2,[ScSwrm]Proboarder,2821,573,24,26,50,48.0%,30m
21608,2,[Utter]opiejab,2821,583,21,21,42,50.0%,38m
21608,2,Clemens,2821,482,20,15,35,57.1%,23m
21608,1,JustMike,2821,598,20,30,50,40.0%,15m
21608,2,[KGH2]nando,2821,278,17,20,37,45.9%,30m
21608,3,[CRAKS]johnnyflores,2821,468,16,20,36,44.4%,11m
21608,3,proph,2821,241,14,5,19,73.7%,42m
21608,3,[0bam4]GUMGUZZLERRR,2821,310,13,11,24,54.2%,4m
21608,2,ChesterNoob,2821,208,7,14,21,33.3%,28m
21608,3,WannaCry,2821,137,5,4,9,55.6%,33m
21608,1,reggie,2821,145,4,5,9,44.4%,2h
21608,3,Inkogniggro,2821,0,3,2,5,60.0%,31m
21608,3,BooldHoot,2821,92,3,6,9,33.3%,29m
21608,2,majorleague,2821,90,3,9,12,25.0%,29m
21608,2,Bren,2821,96,3,12,15,20.0%,43m
21608,3,[DSGoku]JovietUnion,2821,30,2,2,4,50.0%,12m
21608,2,Soapy,2821,122,2,5,7,28.6%,15m
21608,2,Korcholata,2821,0,1,0,1,100.0%,43m
21608,3,[Pena]Toni,2821,0,1,2,3,33.3%,4m
21608,3,[Dimand]MenYmaN,2821,0,0,1,1,0.0%,29m
21608,2,CodadMasters,2821,0,0,1,1,0.0%,2h
21608,3,kroeger,2821,0,0,1,1,0.0%,34m
21608,2,Indaw,2821,0,0,2,2,0.0%,11m
21608,3,IIIIIIIIIIII,2821,0,0,5,5,0.0%,30m
21644,2,[DhZAc1]NightFour,2820,1355,116,100,216,53.7%,31m
21644,2,Terano,2820,1010,95,82,177,53.7%,11m
21644,3,celtictree,2820,671,86,76,162,53.1%,14m
21644,1,SnakeholeRON,2820,1540,83,86,169,49.1%,32m
21644,2,specialed,2820,872,29,36,65,44.6%,32m
21644,2,Ridemacack,2820,539,25,19,44,56.8%,32m
21644,2,OFFLANE,2820,554,23,22,45,51.1%,28m
21644,2,lucifer,2820,563,22,24,46,47.8%,10m
21644,3,[MP1]CODEX,2820,334,13,11,24,54.2%,29m
21644,3,Devastator,2820,268,10,14,24,41.7%,27m
21644,3,BigJAsia,2820,260,8,5,13,61.5%,11m
21644,1,Grockpot,2820,232,8,7,15,53.3%,31m
21644,3,BoKoR,2820,226,6,7,13,46.2%,2h
21644,3,Meeqs,2820,0,5,0,5,100.0%,15m
21644,3,PlanckTime,2820,77,5,7,12,41.7%,5m
21644,2,yarashkirk,2820,182,5,8,13,38.5%,36m
21644,3,Lingo,2820,148,5,9,14,35.7%,19m
21644,1,Pridurok,2820,119,4,4,8,50.0%,23m
21644,2,CnaiurSkioth,2820,0,3,2,5,60.0%,2h
21644,1,Blablabla,2820,0,3,4,7,42.9%,51m
21644,3,[G79]imzesok,2820,86,3,5,8,37.5%,25m
21644,3,Alex,2820,30,2,2,4,50.0%,27m
21644,3,TheLegiOn,2820,60,2,4,6,33.3%,33m
21644,3,Slowpoke,2820,0,1,0,1,100.0%,11m
21644,3,InGODItrUST,2820,0,1,1,2,50.0%,38m
21644,2,ShasO,2820,0,1,2,3,33.3%,3h
21644,3,[8DSH8]TrashProtoss,2820,30,1,2,3,33.3%,5m
21644,3,HashSythe,2820,30,1,2,3,33.3%,28m
21644,3,CountExile,2820,0,0,1,1,0.0%,26m
21644,3,Dobban,2820,0,0,1,1,0.0%,29m
21644,3,JoelFromIowa,2820,0,0,1,1,0.0%,18m
21644,2,[WNTRCO]Jrblood,2820,0,0,1,1,0.0%,2h
21644,3,[4dpu]SirGoatQuad,2820,0,0,1,1,0.0%,18m
21677,2,KoA,2819,1554,144,150,294,49.0%,37m
21677,2,[No0Bs]ProKaoS,2819,1256,51,52,103,49.5%,15m
21677,2,[LGL]Siul,2819,1303,48,51,99,48.5%,31m
21677,3,Stormtrooper,2819,660,45,38,83,54.2%,3m
21677,2,Kho,2819,1027,39,38,77,50.6%,40m
21677,3,Venoma,2819,710,34,24,58,58.6%,7m
21677,3,Kioal,2819,408,14,19,33,42.4%,42m
21677,3,Icarus,2819,351,13,14,27,48.1%,40m
21677,2,HenRays,2819,274,10,11,21,47.6%,39m
21677,3,James,2819,226,8,4,12,66.7%,25m
21677,3,BlueBird,2819,177,8,10,18,44.4%,12m
21677,3,esKILL,2819,161,7,4,11,63.6%,39m
21677,3,[GOPERÚ]BichitoXD,2819,137,7,7,14,50.0%,11m
21677,1,MostPeople,2819,145,6,3,9,66.7%,19m
21677,1,[Takagi]meow,2819,97,6,3,9,66.7%,30m
21677,2,[grity]Acerbic,2819,259,6,18,24,25.0%,25m
21677,2,Serrif,2819,153,5,0,5,100.0%,2h
21677,2,bassface,2819,160,5,4,9,55.6%,19m
21677,3,Nintendo,2819,110,5,5,10,50.0%,12m
21677,3,fritzonator,2819,56,4,3,7,57.1%,41m
21677,3,DIEGO,2819,120,3,3,6,50.0%,33m
21677,3,MrSparkle,2819,62,3,3,6,50.0%,11m
21677,3,Hxpert,2819,30,2,0,2,100.0%,14m
21677,2,[TmT4va]Nick,2819,30,2,2,4,50.0%,39m
21677,3,COPA,2819,48,2,2,4,50.0%,24m
21677,3,Orange,2819,0,2,3,5,40.0%,33m
21677,3,CanYouSee,2819,30,2,5,7,28.6%,11m
21677,1,Zergpower,2819,72,2,10,12,16.7%,33m
21677,3,NoMurrcy,2819,0,1,0,1,100.0%,14m
21677,2,EndOfTheory,2819,0,0,1,1,0.0%,2h
21677,3,Zerg,2819,0,0,1,1,0.0%,42m
21677,3,tuGFA,2819,0,0,2,2,0.0%,40m
21677,3,FUBUKI,2819,0,0,5,5,0.0%,33m
21710,3,Mastacheff,2818,1551,171,179,350,48.9%,38m
21710,3,Morphy,2818,1615,158,154,312,50.6%,17m
21710,2,AgrarianMaik,2818,899,104,86,190,54.7%,2m
21710,3,[DevilF]FatBong,2818,868,65,54,119,54.6%,39m
21710,2,sirpuma,2818,1201,62,40,102,60.8%,29m
21710,3,[tsmph]Spencer,2818,788,44,40,84,52.4%,26m
21710,3,CheezleDez,2818,968,40,30,70,57.1%,28m
21710,3,Hebe,2818,870,35,27,62,56.5%,18m
21710,2,[DefNot]Lacrimah,2818,293,12,4,16,75.0%,2h
21710,2,QuaK,2818,234,10,10,20,50.0%,2h
21710,1,mazzy,2818,234,10,14,24,41.7%,4m
21710,2,IIIIIIIIIIII,2818,252,7,9,16,43.8%,2m
21710,3,IronPaw,2818,169,5,3,8,62.5%,11m
21710,3,[YD2K]Crino,2818,111,5,5,10,50.0%,41m
21710,3,Biocide,2818,30,4,3,7,57.1%,41m
21710,3,GolDaniels,2818,152,4,4,8,50.0%,4m
21710,3,PROPHET,2818,90,4,5,9,44.4%,27m
21710,1,IlIIllIIllII,2818,0,3,3,6,50.0%,56m
21710,2,Thaddeus,2818,91,3,4,7,42.9%,16m
21710,2,Ironspine,2818,62,3,6,9,33.3%,11m
21710,2,[IIlIll]BARTOLOLEO,2818,139,2,1,3,66.7%,35m
21710,1,BigHamu,2818,34,2,3,5,40.0%,2h
21710,2,Rendings,2818,60,2,6,8,25.0%,43m
21710,3,Tekoshii,2818,0,1,0,1,100.0%,27m
21710,3,AryEsWRxX,2818,0,1,1,2,50.0%,22m
21710,3,Sudyn,2818,30,1,3,4,25.0%,26m
21710,3,[Jrkz]Jrkz,2818,0,0,1,1,0.0%,28m
21710,3,[DEoC]MolsonH,2818,0,0,1,1,0.0%,18m
21710,3,ByeUkanlos,2818,0,0,1,1,0.0%,36m
21710,3,[ISDP]Taco,2818,0,0,2,2,0.0%,4m
21710,1,[Coknut]bobcao,2818,0,0,2,2,0.0%,2h
21710,2,fartbutt,2818,0,0,6,6,0.0%,8m
21742,2,[ViP3Rs]Kushkillz,2817,1613,347,337,684,50.7%,32m
21742,2,apotheosis,2817,1439,109,76,185,58.9%,39m
21742,3,Trystero,2817,1553,91,68,159,57.2%,40m
21742,3,Ragna,2817,1235,48,47,95,50.5%,7m
21742,2,Kronus,2817,1236,47,52,99,47.5%,35m
21742,2,[TPGGXD]NoseJugar,2817,1156,43,50,93,46.2%,39m
21742,3,[WNTRLH]Futaci,2817,755,37,39,76,48.7%,36m
21742,3,BobLeo,2817,868,33,32,65,50.8%,11m
21742,2,CAREPERRO,2817,854,31,35,66,47.0%,32m
21742,3,[JUIC3Y]WangerBanger,2817,347,14,12,26,53.8%,7m
21742,2,Fruit,2817,414,14,21,35,40.0%,4m
21742,3,[Huntin]AlexSoFast,2817,284,13,5,18,72.2%,20m
21742,3,funney,2817,292,12,5,17,70.6%,33m
21742,2,Draconian,2817,330,11,19,30,36.7%,22m
21742,3,[PiGPan]conn,2817,200,8,6,14,57.1%,7m
21742,3,gsonerdxoxo,2817,244,8,7,15,53.3%,30m
21742,3,ChadPasta,2817,213,6,4,10,60.0%,11m
21742,1,DesertRider,2817,193,5,6,11,45.5%,3m
21742,1,Gambit,2817,48,4,4,8,50.0%,17m
21742,3,[kins]Tonnto,2817,92,4,5,9,44.4%,35m
21742,2,ggg,2817,0,3,2,5,60.0%,17m
21742,1,llBalanaRll,2817,93,2,1,3,66.7%,30m
21742,1,Vezon,2817,48,2,2,4,50.0%,18m
21742,3,[MBQ]Mattymat,2817,0,1,0,1,100.0%,5m
21742,3,Anonymous,2817,0,1,0,1,100.0%,28m
21742,1,Troy,2817,0,1,0,1,100.0%,2h
21742,3,[GR33D]ShooteR,2817,0,1,0,1,100.0%,23m
21742,3,Derrick,2817,97,1,1,2,50.0%,44m
21742,3,Ghoti,2817,0,1,1,2,50.0%,56m
21742,2,ryurich,2817,0,1,5,6,16.7%,2h
21742,3,Jarjarx,2817,0,0,1,1,0.0%,2h
21742,3,TartWolf,2817,0,0,1,1,0.0%,11m
21742,3,Robert,2817,0,0,2,2,0.0%,16m
21775,2,[Obake]Junior,2816,1398,233,221,454,51.3%,32m
21775,2,Soraldin,2816,1557,111,110,221,50.2%,25m
21775,1,JSJS,2816,641,59,58,117,50.4%,34m
21775,2,wimpywilly,2816,797,54,58,112,48.2%,33m
21775,1,Redfalcon,2816,1233,45,50,95,47.4%,20m
21775,3,Gus,2816,713,31,20,51,60.8%,3m
21775,3,[Shang]Killa,2816,437,28,16,44,63.6%,4m
21775,2,Solindar,2816,668,27,23,50,54.0%,34m
21775,2,Troofle,2816,549,25,23,48,52.1%,37m
21775,3,[Mooky]Patrick,2816,317,20,10,30,66.7%,25m
21775,2,Aicer,2816,430,16,19,35,45.7%,42m
21775,2,ShipWreack,2816,341,13,16,29,44.8%,41m
21775,3,Felixtingyh,2816,234,12,4,16,75.0%,41m
21775,3,AngelAlado,2816,299,11,10,21,52.4%,29m
21775,3,Magdalenita,2816,212,10,7,17,58.8%,44m
21775,1,Kaiju,2816,233,7,4,11,63.6%,4m
21775,2,[Makia]ChuckNorris,2816,210,7,14,21,33.3%,42m
21775,3,PajamaSam,2816,187,6,2,8,75.0%,36m
21775,3,EnErgo,2816,129,4,1,5,80.0%,11m
21775,3,KORllllll,2816,86,4,2,6,66.7%,11m
21775,1,AlexTheCruel,2816,48,4,4,8,50.0%,2h
21775,3,[chzbyz]IAmTheDrewth,2816,86,4,5,9,44.4%,30m
21775,2,[SPICE]Juggernaut,2816,95,4,7,11,36.4%,11m
21775,2,hmhm,2816,0,3,3,6,50.0%,4m
21775,3,[B0oZ3]AleaIactaEst,2816,58,2,3,5,40.0%,12m
21775,3,[HardCo]Wompas,2816,30,2,3,5,40.0%,40m
21775,2,WhatIsHoodTV,2816,0,2,3,5,40.0%,2h
21775,3,speedy,2816,0,1,0,1,100.0%,36m
21775,2,Kindmeteor,2816,0,1,1,2,50.0%,5m
21775,3,[D2Fam]NewbieV,2816,30,1,2,3,33.3%,24m
21775,3,[krz]vanjo,2816,32,1,2,3,33.3%,12m
21775,3,Mry,2816,0,1,3,4,25.0%,45m
21775,3,[13thG]BlazeRider,2816,0,0,1,1,0.0%,7m
21775,3,FilthyBeaver,2816,0,0,1,1,0.0%,42m
21809,2,SlicenDice,2815,1600,206,184,390,52.8%,24m
21809,2,[nieBla]Supre,2815,1555,196,182,378,51.9%,32m
21809,2,freedom,2815,1618,160,144,304,52.6%,27m
21809,1,[Macac0]belmont,2815,1594,104,103,207,50.2%,41m
21809,3,[SizZIe]RaynorsRaper,2815,1458,93,62,155,60.0%,28m
21809,3,KillSwitch,2815,1476,65,65,130,50.0%,41m
21809,3,GeTrEkT,2815,1329,58,54,112,51.8%,17m
21809,1,TheBoxeR,2815,1315,47,54,101,46.5%,18m
21809,3,[Maaaan]trigrhappy,2815,674,29,23,52,55.8%,7m
21809,2,[dLife]DarkTRUMPlar,2815,353,13,18,31,41.9%,32m
21809,3,macrolord,2815,323,11,11,22,50.0%,39m
21809,3,[ccbi]Miklul,2815,303,10,8,18,55.6%,27m
21809,3,SugMyDic,2815,203,9,12,21,42.9%,35m
21809,3,Qwizerd,2815,137,6,4,10,60.0%,33m
21809,2,[MAGA2]Stealrain,2815,58,5,5,10,50.0%,24m
21809,2,AndreiZBoss,2815,119,5,5,10,50.0%,27m
21809,3,[PAJERO]Marceloide,2815,88,3,2,5,60.0%,35m
21809,3,AzNfLiPmOdE,2815,86,3,3,6,50.0%,26m
21809,2,[nietos]fantome,2815,60,3,7,10,30.0%,7m
21809,3,YouCanWin,2815,58,2,1,3,66.7%,41m
21809,3,ARES,2815,0,2,2,4,50.0%,9m
21809,2,Gewalt,2815,88,2,3,5,40.0%,6m
21809,3,Sal,2815,88,2,4,6,33.3%,40m
21809,1,Fields,2815,48,1,2,3,33.3%,2h
21809,2,Zooko,2815,0,0,1,1,0.0%,54m
21809,3,Dom,2815,0,0,1,1,0.0%,34m
21809,3,iamcomma,2815,0,0,1,1,0.0%,8m
21809,2,thanes,2815,0,0,5,5,0.0%,40m
21837,1,Allan,2814,1568,356,345,701,50.8%,15m
21837,2,[VEoC]Bemnar,2814,1606,153,158,311,49.2%,18m
21837,1,SkyHawk,2814,642,109,79,188,58.0%,6m
21837,3,HeadHunter,2814,1509,96,80,176,54.5%,3m
21837,1,apotema,2814,687,45,47,92,48.9%,5m
21837,3,Kezzerdrix,2814,540,32,26,58,55.2%,16m
21837,2,Quizic,2814,708,29,24,53,54.7%,41m
21837,3,THELEX,2814,530,25,16,41,61.0%,9m
21837,3,Alaric,2814,560,21,22,43,48.8%,34m
21837,3,zerg,2814,386,15,13,28,53.6%,33m
21837,1,Clockwurk,2814,338,13,10,23,56.5%,2h
21837,3,Huarg,2814,298,12,9,21,57.1%,23m
21837,3,origamiponey,2814,322,12,13,25,48.0%,36m
21837,1,Mathon,2814,332,11,13,24,45.8%,2h
21837,2,Tfile,2814,352,11,14,25,44.0%,17m
21837,2,diNg,2814,265,10,11,21,47.6%,31m
21837,3,[UpxV]Centurion,2814,230,10,12,22,45.5%,27m
21837,2,Ebenn,2814,260,9,13,22,40.9%,31m
21837,3,[sk3tch]Richarddaddy,2814,84,6,1,7,85.7%,5m
21837,2,[BlTEL]Lurp,2814,0,4,1,5,80.0%,2h
21837,2,[XCPT]TheJuicer,2814,0,4,2,6,66.7%,10m
21837,1,massive,2814,97,4,3,7,57.1%,3h
21837,1,[DSTFWA]iGotFive,2814,48,4,4,8,50.0%,2h
21837,3,Shadows,2814,120,4,4,8,50.0%,7m
21837,1,Durtt,2814,48,4,5,9,44.4%,52m
21837,2,Phil,2814,156,4,7,11,36.4%,17m
21837,2,baKZ,2814,38,2,4,6,33.3%,2h
21837,3,Shallz,2814,60,2,5,7,28.6%,14m
21837,3,Chetzio,2814,0,1,0,1,100.0%,3m
21837,3,[LoZC]Hero,2814,0,1,1,2,50.0%,20m
21837,3,JokerFace,2814,30,1,1,2,50.0%,40m
21837,3,Ecs,2814,30,1,1,2,50.0%,38m
21837,3,Yakab,2814,0,0,1,1,0.0%,17m
21837,3,fabioutamam,2814,0,0,1,1,0.0%,18m
21837,3,Nighthawk,2814,0,0,2,2,0.0%,5m
21837,3,[BolloX]IronsideRIAW,2814,0,0,2,2,0.0%,10m
21837,2,[X0F]ToTiN,2814,0,0,4,4,0.0%,22m
21874,3,[G79]NeoRemnant,2813,1617,180,167,347,51.9%,12m
21874,2,[Batmn]smileyy,2813,1578,179,179,358,50.0%,15m
21874,1,[Bee]Lankonos,2813,1605,162,168,330,49.1%,20m
21874,2,redbaron,2813,1344,63,39,102,61.8%,2m
21874,2,Crolex,2813,1082,54,34,88,61.4%,8m
21874,3,Raziel,2813,866,50,27,77,64.9%,9m
21874,2,[Bunge]Roadkill,2813,417,32,34,66,48.5%,6m
21874,3,Superkewl,2813,713,31,21,52,59.6%,22m
21874,3,ParanoidMarv,2813,750,28,25,53,52.8%,42m
21874,3,Purity,2813,579,25,14,39,64.1%,38m
21874,3,LowTemplar,2813,529,22,18,40,55.0%,13m
21874,2,KAZUo,2813,493,20,18,38,52.6%,2m
21874,2,Streit,2813,399,17,16,33,51.5%,14m
21874,2,Pamir,2813,402,17,17,34,50.0%,11m
21874,2,RickVF,2813,486,17,21,38,44.7%,33m
21874,2,Mikiiii,2813,304,11,15,26,42.3%,31m
21874,3,TigerAwesome,2813,187,8,6,14,57.1%,33m
21874,3,[FFAA]Santorio,2813,174,7,5,12,58.3%,19m
21874,3,Castiel,2813,144,6,3,9,66.7%,4m
21874,1,DeadlyDave,2813,144,6,6,12,50.0%,57m
21874,2,Tweek,2813,60,5,5,10,50.0%,8m
21874,2,iiiiiiiiiiii,2813,156,5,14,19,26.3%,39m
21874,2,JackdaRipper,2813,131,4,6,10,40.0%,17m
21874,2,[xATx]Fanboyftw,2813,124,4,9,13,30.8%,25m
21874,2,EnderElderU,2813,46,3,3,6,50.0%,32m
21874,3,liquidbox,2813,118,2,1,3,66.7%,38m
21874,3,Dusty,2813,30,2,2,4,50.0%,11m
21874,2,Brocklobsta,2813,30,2,5,7,28.6%,19m
21874,3,ARES,2813,0,1,0,1,100.0%,34m
21874,2,GreyOcelot,2813,0,0,1,1,0.0%,2h
21874,3,[KnOSh]LazyFrost,2813,0,0,1,1,0.0%,19m
21874,3,[Calx]Migue,2813,0,0,1,1,0.0%,22m
21874,1,[SxTxS]Shad,2813,0,0,2,2,0.0%,2h
21874,3,[NPhasA]Khaospenguin,2813,0,0,3,3,0.0%,19m
21908,1,[Habil]Sky,2812,1583,168,158,326,51.5%,38m
21908,2,llllllllllll,2812,816,51,19,70,72.9%,17m
21908,2,MaiPai,2812,911,40,36,76,52.6%,16m
21908,1,SHOCk,2812,561,38,40,78,48.7%,5m
21908,2,[LGSSP]rakkam,2812,361,36,29,65,55.4%,27m
21908,3,zealis,2812,874,34,27,61,55.7%,11m
21908,3,[KI00]Noble,2812,630,25,19,44,56.8%,13m
21908,2,[l998]Doubt,2812,156,17,17,34,50.0%,39m
21908,1,Arael,2812,368,15,19,34,44.1%,8m
21908,2,[DTML]Polyknikes,2812,425,14,15,29,48.3%,38m
21908,3,Apothecera,2812,364,13,9,22,59.1%,8m
21908,2,[NVYTE]SmokingShot,2812,270,10,13,23,43.5%,9m
21908,3,[Ch1nky]ErrOr,2812,230,9,7,16,56.2%,10m
21908,3,kiraqueen,2812,202,7,6,13,53.8%,22m
21908,3,gnostic,2812,149,6,4,10,60.0%,42m
21908,3,theColossus,2812,114,5,4,9,55.6%,7m
21908,2,DaftTank,2812,146,5,13,18,27.8%,31m
21908,3,Angel,2812,95,2,4,6,33.3%,29m
21908,3,OtakuSlave,2812,0,1,0,1,100.0%,29m
21908,3,[FALURS]Squeeky,2812,95,1,1,2,50.0%,10m
21908,3,XxMatadorxX,2812,0,1,1,2,50.0%,20m
21908,3,Project,2812,30,1,4,5,20.0%,6m
21908,2,[DarkAG]MicroJackson,2812,90,1,4,5,20.0%,2h
21908,3,Lobo,2812,97,1,5,6,16.7%,2h
21908,3,NightHawk,2812,0,0,1,1,0.0%,40m
21908,3,Arathorn,2812,0,0,1,1,0.0%,2h
21908,3,WalfranSena,2812,0,0,1,1,0.0%,22m
21908,3,ArAgOrN,2812,0,0,1,1,0.0%,7m
21908,3,GOLEZ,2812,0,0,1,1,0.0%,31m
21937,2,SuperiorX,2811,1446,76,62,138,55.1%,26m
21937,2,[SWOU]Cuper,2811,1138,55,42,97,56.7%,42m
21937,3,MrOvo,2811,410,40,27,67,59.7%,36m
21937,3,Shazmo,2811,957,40,29,69,58.0%,7m
21937,2,Demonizer,2811,726,35,24,59,59.3%,18m
21937,2,ACERTIJO,2811,368,31,26,57,54.4%,32m
21937,3,Ilúvatar,2811,551,25,21,46,54.3%,7m
21937,3,Nerds,2811,328,23,13,36,63.9%,14m
21937,2,[D4Bros]ChaosTheory,2811,437,17,17,34,50.0%,39m
21937,3,Isabella,2811,260,9,9,18,50.0%,43m
21937,3,[ARGENT]Tutsinator,2811,240,8,4,12,66.7%,22m
21937,1,robotikov,2811,167,6,0,6,100.0%,19m
21937,3,Greedo,2811,215,6,7,13,46.2%,43m
21937,3,Therad,2811,180,6,9,15,40.0%,40m
21937,2,[HeBu]Jim,2811,159,5,5,10,50.0%,18m
21937,3,[MWR]tetou,2811,172,5,10,15,33.3%,2h
21937,3,[SPMM]MarshKallow,2811,0,4,1,5,80.0%,35m
21937,3,[VINGAD]Danilão,2811,120,4,7,11,36.4%,25m
21937,2,[SLan]BlueSteel,2811,172,4,8,12,33.3%,7m
21937,3,RickSanchez,2811,0,3,2,5,60.0%,5m
21937,1,ShameBoy,2811,0,3,3,6,50.0%,9m
21937,3,[Pharoh]JDM,2811,30,2,1,3,66.7%,22m
21937,3,Seztren,2811,60,2,4,6,33.3%,16m
21937,3,Scotty,2811,0,1,0,1,100.0%,3m
21937,1,[ESJO]Inukshuk,2811,0,1,1,2,50.0%,2h
21937,3,[LKS69]CORONAVIRUS,2811,0,1,1,2,50.0%,2h
21937,3,KingsnO,2811,0,1,3,4,25.0%,7m
21937,1,[RUSTY]NoFatChicks,2811,0,0,1,1,0.0%,33m
21937,3,Sandman,2811,0,0,1,1,0.0%,18m
21937,3,ZIDHARD,2811,0,0,1,1,0.0%,37m
21967,2,booga,2810,1585,281,282,563,49.9%,40m
21967,2,[PvZMa]toastyface,2810,1538,177,172,349,50.7%,15m
21967,3,Fritzmeister,2810,502,69,54,123,56.1%,34m
21967,3,warchile,2810,1479,64,61,125,51.2%,30m
21967,2,Zeke,2810,1414,64,69,133,48.1%,27m
21967,2,Mark,2810,990,61,62,123,49.6%,6m
21967,2,paracetamor,2810,1446,55,53,108,50.9%,18m
21967,1,SogeKing,2810,1186,54,59,113,47.8%,17m
21967,3,Lifeforce,2810,600,53,43,96,55.2%,8m
21967,2,amanster,2810,1093,48,49,97,49.5%,4m
21967,3,Dyckgoezinya,2810,962,47,38,85,55.3%,29m
21967,3,starwoosey,2810,562,43,16,59,72.9%,30m
21967,2,Brandon,2810,1154,42,45,87,48.3%,23m
21967,2,[ZTemp]burn,2810,806,42,45,87,48.3%,42m
21967,3,Losphoenix,2810,262,24,24,48,50.0%,5m
21967,2,lllllIIIllll,2810,630,24,25,49,49.0%,8m
21967,2,Darkfoxy,2810,415,21,10,31,67.7%,17m
21967,2,Puffinboi,2810,441,21,11,32,65.6%,38m
21967,1,Kilo,2810,544,20,26,46,43.5%,28m
21967,3,[XiledS]ogmlc,2810,339,14,12,26,53.8%,36m
21967,2,Ireniicus,2810,379,12,15,27,44.4%,18m
21967,2,Straatos,2810,324,11,14,25,44.0%,33m
21967,2,JuicyKlumps,2810,300,10,9,19,52.6%,10m
21967,3,Kademor,2810,290,10,11,21,47.6%,19m
21967,3,Lippy,2810,192,5,4,9,55.6%,15m
21967,2,[Alphaa]DBOSS,2810,142,5,5,10,50.0%,36m
21967,2,abortionpnch,2810,115,5,5,10,50.0%,10m
21967,2,[TYA]FazZ,2810,141,4,1,5,80.0%,27m
21967,3,OrangeSOda,2810,30,3,4,7,42.9%,28m
21967,2,Crackity,2810,30,2,3,5,40.0%,19m
21967,2,melefante,2810,30,2,5,7,28.6%,27m
21967,3,[KHIM]DiNapoClit,2810,0,1,1,2,50.0%,18m
21967,3,[Devout]CountAlias,2810,0,1,5,6,16.7%,17m
21967,2,Brian,2810,30,1,6,7,14.3%,4m
21967,3,Kakuseisha,2810,0,0,1,1,0.0%,14m
21967,1,[Bstnut]SpawningBoa,2810,0,0,2,2,0.0%,7m
22003,3,CaptainMorgn,2809,1209,79,65,144,54.9%,19m
22003,3,[FyHr]cheche,2809,1245,69,53,122,56.6%,17m
22003,3,[APM9k]ChipotleSan,2809,1394,66,53,119,55.5%,12m
22003,2,IIIIIIIIIIII,2809,1007,57,54,111,51.4%,25m
22003,2,Vaswano,2809,302,43,41,84,51.2%,4m
22003,3,AsaZiN,2809,553,25,13,38,65.8%,13m
22003,3,DKPROFANO,2809,513,19,13,32,59.4%,3m
22003,1,Buttpuppet,2809,537,18,28,46,39.1%,22m
22003,3,vector,2809,254,9,10,19,47.4%,18m
22003,3,[SJB]DroneTMX,2809,181,7,4,11,63.6%,28m
22003,1,NoticeRL,2809,182,7,4,11,63.6%,28m
22003,1,JElite,2809,144,6,6,12,50.0%,2h
22003,1,pezizzle,2809,97,5,3,8,62.5%,9m
22003,3,Kyun,2809,72,5,5,10,50.0%,22m
22003,1,[SCBIA]deathtoyou,2809,97,4,3,7,57.1%,5m
22003,3,BuffaloKilla,2809,170,4,3,7,57.1%,31m
22003,2,[FKAHTK]Omgmewmewcat,2809,97,3,3,6,50.0%,13m
22003,2,Disqobandit,2809,112,3,3,6,50.0%,2h
22003,1,FrostyDog,2809,0,3,3,6,50.0%,3h
22003,2,Glem,2809,48,3,3,6,50.0%,14m
22003,3,ItalianSmurf,2809,97,2,0,2,100.0%,2h
22003,3,[SSNNCC]ghost,2809,62,2,6,8,25.0%,36m
22003,2,SpaceCaptain,2809,58,2,13,15,13.3%,7m
22003,3,Mijongles,2809,0,1,0,1,100.0%,19m
22003,2,lucky,2809,0,1,0,1,100.0%,57m
22003,1,[1vsM]homer,2809,0,1,1,2,50.0%,2h
22003,1,Mathsru,2809,97,1,3,4,25.0%,20m
22003,2,danny,2809,0,0,1,1,0.0%,46m
22003,3,SonicAlarm,2809,0,0,1,1,0.0%,7m
22003,3,ThEWaFfLe,2809,0,0,1,1,0.0%,19m
22003,2,Gary,2809,0,0,1,1,0.0%,2h
22003,3,[anti5z]Osoman,2809,0,0,1,1,0.0%,7m
22003,1,Theseus,2809,0,0,2,2,0.0%,28m
22003,3,DJEzDikk,2809,0,0,3,3,0.0%,28m
22037,3,AndrewVega,2808,1559,127,111,238,53.4%,14m
22037,1,[OGBLAK]oldbambo,2808,1583,124,124,248,50.0%,28m
22037,2,never,2808,1582,118,105,223,52.9%,8m
22037,1,SilentStorm,2808,1078,77,79,156,49.4%,20m
22037,3,Natesurf,2808,453,45,30,75,60.0%,36m
22037,2,Balance,2808,794,29,33,62,46.8%,15m
22037,2,Ghostshadow,2808,573,20,21,41,48.8%,11m
22037,2,Littlerob,2808,422,15,22,37,40.5%,33m
22037,3,MrCaballvs,2808,368,13,15,28,46.4%,37m
22037,2,Jaraxxus,2808,366,13,16,29,44.8%,5m
22037,3,HydraLord,2808,253,11,9,20,55.0%,25m
22037,2,[FoxBR]Charlinnn,2808,220,9,7,16,56.2%,32m
22037,2,Lckestinkt,2808,256,9,10,19,47.4%,1h
22037,2,SxyBoi,2808,148,8,8,16,50.0%,25m
22037,2,fyog,2808,138,7,4,11,63.6%,12m
22037,2,Djmines,2808,144,6,6,12,50.0%,36m
22037,3,[LimaSC]Javipapache,2808,140,6,8,14,42.9%,24m
22037,3,Julian,2808,118,5,3,8,62.5%,28m
22037,1,GCDrake,2808,142,3,1,4,75.0%,34m
22037,2,TMcSpitfire,2808,96,3,3,6,50.0%,3h
22037,1,siclon,2808,0,1,0,1,100.0%,2h
22037,3,KDF,2808,0,1,1,2,50.0%,7m
22037,3,BagOfLettuce,2808,30,1,1,2,50.0%,28m
22037,3,laxvega,2808,30,1,1,2,50.0%,6m
22037,3,Cazbius,2808,0,0,1,1,0.0%,19m
22037,3,Olaf,2808,0,0,1,1,0.0%,28m
22037,3,[EDF420]combatfetus,2808,0,0,3,3,0.0%,8m
22037,2,Static,2808,0,0,5,5,0.0%,22m
22065,1,Rodrihunter,2807,1472,81,86,167,48.5%,24m
22065,3,TrenchMaster,2807,1496,66,63,129,51.2%,8m
22065,3,ZARD,2807,1303,57,43,100,57.0%,28m
22065,3,[DRKACE]Hayden,2807,551,51,52,103,49.5%,22m
22065,3,Ericthered,2807,944,37,31,68,54.4%,31m
22065,3,Warsnake,2807,878,32,32,64,50.0%,28m
22065,2,Crybaby,2807,199,22,14,36,61.1%,37m
22065,3,oer,2807,364,20,14,34,58.8%,20m
22065,3,[BSauce]Oshan,2807,278,16,9,25,64.0%,33m
22065,2,Raddazza,2807,315,15,17,32,46.9%,32m
22065,3,Destruction,2807,394,14,10,24,58.3%,29m
22065,1,KTang,2807,101,5,5,10,50.0%,13m
22065,3,maçã,2807,142,4,0,4,100.0%,32m
22065,3,Pariseau,2807,165,4,3,7,57.1%,4m
22065,3,Daroude,2807,97,4,5,9,44.4%,18m
22065,3,Orphindale,2807,121,3,1,4,75.0%,18m
22065,2,MikeRoxx,2807,0,2,0,2,100.0%,2h
22065,3,Pingu,2807,60,2,6,8,25.0%,34m
22065,2,dotafershota,2807,30,2,6,8,25.0%,33m
22065,2,seb,2807,60,2,10,12,16.7%,31m
22065,3,NOFrIenDs,2807,0,1,0,1,100.0%,20m
22065,3,Kiva,2807,30,1,2,3,33.3%,22m
22065,3,TornadoJay,2807,30,1,2,3,33.3%,5m
22065,3,jabs,2807,0,0,1,1,0.0%,26m
22065,3,[CAMOTE]Pimmpernel,2807,0,0,1,1,0.0%,17m
22090,1,Jebusaurio,2806,1579,155,149,304,51.0%,20m
22090,2,Tyler,2806,928,78,76,154,50.6%,31m
22090,2,Blutarsky,2806,450,57,59,116,49.1%,14m
22090,2,EuraRa,2806,480,17,21,38,44.7%,43m
22090,3,[zernex]STETMANN,2806,358,13,8,21,61.9%,24m
22090,2,crispymm,2806,150,10,15,25,40.0%,6m
22090,3,Zockerbabba,2806,239,6,7,13,46.2%,34m
22090,2,[SFP]Kolcrc,2806,194,6,9,15,40.0%,39m
22090,2,Ishmael,2806,90,4,8,12,33.3%,27m
22090,2,AnArKyA,2806,48,3,3,6,50.0%,32m
22090,1,Bropoe,2806,0,3,3,6,50.0%,2h
22090,3,[LBGF]anslod,2806,90,3,5,8,37.5%,31m
22090,3,Caldir,2806,60,2,2,4,50.0%,16m
22090,3,[EtrOy]Hawkeye,2806,0,1,0,1,100.0%,15m
22090,3,Vortei,2806,0,1,0,1,100.0%,11m
22090,3,[Macac0]juangoil,2806,0,1,0,1,100.0%,11m
22090,3,[ethicc]Yackob,2806,0,1,0,1,100.0%,7m
22090,3,Cheesus,2806,0,1,0,1,100.0%,5m
22090,3,[SBoys]DangerMarine,2806,0,1,1,2,50.0%,34m
22090,1,Momin,2806,96,1,2,3,33.3%,11m
22090,3,MundoPc,2806,0,0,1,1,0.0%,41m
22090,2,[LRF]Wise,2806,0,0,2,2,0.0%,37m
22090,3,Awdiowave,2806,0,0,2,2,0.0%,7m
22090,3,CookieCraker,2806,0,0,3,3,0.0%,23m
22114,2,Gygy,2805,1423,95,91,186,51.1%,43m
22114,2,mimo,2805,1171,85,67,152,55.9%,29m
22114,2,Raka,2805,525,48,45,93,51.6%,27m
22114,3,Stark,2805,1177,47,44,91,51.6%,38m
22114,3,[NSGWP]CarrotFuton,2805,824,33,23,56,58.9%,42m
22114,3,asdfjkl,2805,389,30,17,47,63.8%,15m
22114,3,Stasis,2805,357,13,8,21,61.9%,7m
22114,2,[ChiFan]Armorkin,2805,300,10,17,27,37.0%,6m
22114,3,[eCTg]Jonathan,2805,287,9,7,16,56.2%,16m
22114,3,Musou,2805,253,9,7,16,56.2%,1h
22114,3,FridCR,2805,222,8,9,17,47.1%,2h
22114,3,JARDINEIRO,2805,162,7,5,12,58.3%,33m
22114,3,Karthal,2805,178,7,7,14,50.0%,25m
22114,3,Riven,2805,180,6,2,8,75.0%,33m
22114,2,Triathlete,2805,224,6,11,17,35.3%,5m
22114,3,[XxPwnX]LLShadowsX,2805,88,4,3,7,57.1%,37m
22114,2,Tushinux,2805,88,4,8,12,33.3%,43m
22114,3,prosorsmash,2805,122,4,9,13,30.8%,35m
22114,1,ExistentialC,2805,96,3,3,6,50.0%,2h
22114,3,[iGOSU]KennyRogers,2805,0,2,2,4,50.0%,39m
22114,3,NERCUS,2805,60,2,2,4,50.0%,28m
22114,3,lllIIIllllII,2805,30,2,2,4,50.0%,20m
22114,1,dehet,2805,96,2,4,6,33.3%,2h
22114,3,[zoolog]GaggleOGeese,2805,30,1,1,2,50.0%,18m
22114,3,Bareleon,2805,0,0,1,1,0.0%,31m
22114,3,Shed,2805,0,0,1,1,0.0%,16m
22114,2,SpawN,2805,0,0,6,6,0.0%,16m
22141,2,Cotton,2804,913,129,111,240,53.8%,15m
22141,2,Olimac,2804,1589,117,101,218,53.7%,26m
22141,3,OptimusPrime,2804,1161,104,95,199,52.3%,19m
22141,3,KTrooper,2804,1114,55,49,104,52.9%,25m
22141,3,calculus,2804,1095,51,46,97,52.6%,29m
22141,2,Plusaq,2804,737,28,32,60,46.7%,29m
22141,2,Deefour,2804,423,28,34,62,45.2%,35m
22141,2,Intermittent,2804,352,11,18,29,37.9%,25m
22141,1,SEVENEY,2804,281,8,5,13,61.5%,28m
22141,3,[G0LD]OhM,2804,164,8,6,14,57.1%,22m
22141,3,[shttrz]lolgg,2804,206,8,10,18,44.4%,7m
22141,3,WWolf,2804,230,8,11,19,42.1%,28m
22141,2,Neboluz,2804,48,4,3,7,57.1%,2h
22141,3,Obstruction,2804,119,3,0,3,100.0%,14m
22141,3,[NXLsc]Strayder,2804,58,3,1,4,75.0%,3m
22141,3,JacenSolo,2804,0,3,2,5,60.0%,24m
22141,1,[HEZUS]BottledDJinn,2804,0,3,4,7,42.9%,2h
22141,1,[NLK]Wormsign,2804,140,3,6,9,33.3%,41m
22141,3,[SBlock]conejo,2804,88,3,6,9,33.3%,12m
22141,3,TheShy,2804,58,2,4,6,33.3%,8m
22141,3,[Cind3r]Takir,2804,0,1,1,2,50.0%,28m
22141,2,Crazed,2804,48,1,2,3,33.3%,57m
22141,3,Bloodychaos,2804,30,1,3,4,25.0%,3m
22141,3,FLUFFYBOGART,2804,30,1,5,6,16.7%,4m
22141,3,[CORON4]vIrUS,2804,0,0,1,1,0.0%,12m
22141,3,xcanonbox,2804,0,0,1,1,0.0%,13m
22141,3,CostaER,2804,0,0,2,2,0.0%,22m
22168,3,Mcp,2803,1567,98,92,190,51.6%,33m
22168,1,[OMNV]Discere,2803,1069,84,60,144,58.3%,12m
22168,1,kevo,2803,1135,65,72,137,47.4%,7m
22168,2,Cyanide,2803,1266,63,39,102,61.8%,11m
22168,2,[T600]Ankiud,2803,1085,45,41,86,52.3%,38m
22168,3,SgtMac,2803,375,40,37,77,51.9%,34m
22168,3,[Alarak]Nurrdeer,2803,700,32,21,53,60.4%,26m
22168,3,WokinWokout,2803,854,31,33,64,48.4%,33m
22168,2,[SuBro]Skillzmatics,2803,637,27,21,48,56.2%,34m
22168,3,Long,2803,410,16,13,29,55.2%,16m
22168,2,Zoku,2803,302,12,11,23,52.2%,22m
22168,3,AByCyy,2803,174,9,3,12,75.0%,7m
22168,1,RSPOL,2803,158,9,8,17,52.9%,33m
22168,3,Larva,2803,161,6,4,10,60.0%,17m
22168,3,lllllllgllll,2803,131,5,4,9,55.6%,7m
22168,1,[dGG]ChiliPepperS,2803,121,5,5,10,50.0%,2h
22168,3,[ExceI]Dris,2803,86,4,2,6,66.7%,14m
22168,2,DIO,2803,0,3,2,5,60.0%,2h
22168,3,[111TTV]RataInmunda,2803,30,1,1,2,50.0%,41m
22168,3,[anti5z]Aldaris,2803,0,1,4,5,20.0%,11m
22168,3,[TheDOH]MartinMese,2803,0,0,1,1,0.0%,29m
22168,1,[Ikar0s]ShaoFeiLon,2803,0,0,1,1,0.0%,2h
22168,3,Noram,2803,0,0,2,2,0.0%,17m
22191,2,mackG,2802,1508,310,297,607,51.1%,28m
22191,3,Dre,2802,1069,74,62,136,54.4%,14m
22191,3,Rocket,2802,1532,72,44,116,62.1%,31m
22191,2,Thang,2802,296,47,33,80,58.8%,38m
22191,3,[LQV]MasterYoda,2802,1006,37,39,76,48.7%,27m
22191,2,AirG,2802,708,28,27,55,50.9%,32m
22191,2,[Mldr]Reminex,2802,322,16,17,33,48.5%,7m
22191,3,[NSushi]nighthawk,2802,392,14,9,23,60.9%,25m
22191,2,TheCheapo,2802,321,12,9,21,57.1%,3h
22191,2,[FKYA]ShTouR,2802,52,12,19,31,38.7%,9m
22191,3,Ashes,2802,198,9,8,17,52.9%,27m
22191,2,eEkOoK,2802,195,5,6,11,45.5%,41m
22191,3,AngeluS,2802,93,3,3,6,50.0%,11m
22191,3,Lacedaemus,2802,90,3,4,7,42.9%,24m
22191,3,Kazaud,2802,30,2,3,5,40.0%,14m
22191,3,CondePatula,2802,30,2,4,6,33.3%,13m
22191,3,[AbcCo]UnknownStorm,2802,0,1,0,1,100.0%,16m
22191,2,Evan,2802,0,1,0,1,100.0%,35m
22191,3,Jinzul,2802,0,1,3,4,25.0%,31m
22191,1,RogueSaint,2802,0,1,7,8,12.5%,36m
22191,3,Kairos,2802,0,0,1,1,0.0%,36m
22191,3,Barcode,2802,0,0,1,1,0.0%,4m
22213,2,[xLCx]Shuru,2801,813,196,181,377,52.0%,36m
22213,2,[yito]JJay,2801,1205,137,113,250,54.8%,25m
22213,2,galaxygal,2801,1440,122,105,227,53.7%,33m
22213,2,[daLake]Indi,2801,1581,102,105,207,49.3%,35m
22213,3,Wutsherface,2801,1327,101,85,186,54.3%,41m
22213,3,Garbanzo,2801,1440,61,61,122,50.0%,13m
22213,3,[xEx]TheDude,2801,857,54,45,99,54.5%,27m
22213,3,PsychoMantis,2801,1020,39,38,77,50.6%,4m
22213,3,TomTheBoom,2801,697,28,21,49,57.1%,29m
22213,3,RatRodder,2801,509,22,19,41,53.7%,27m
22213,2,CapScarface,2801,609,22,21,43,51.2%,4m
22213,3,LockedWalrus,2801,279,11,3,14,78.6%,15m
22213,3,[ScTZPR]Creation,2801,285,11,4,15,73.3%,21m
22213,1,Gcorcorann,2801,251,11,12,23,47.8%,7m
22213,3,Jabooobooo,2801,286,10,14,24,41.7%,21m
22213,3,[JDG]rammlied,2801,278,9,15,24,37.5%,27m
22213,3,Yuudachi,2801,60,6,4,10,60.0%,43m
22213,3,[LimaSC]blood,2801,58,3,1,4,75.0%,28m
22213,3,[CHTs]Helios,2801,30,2,1,3,66.7%,31m
22213,3,IIIIIIIIIIII,2801,30,2,1,3,66.7%,32m
22213,3,[BlTEL]ALEX,2801,30,2,2,4,50.0%,4m
22213,3,BillyJohnson,2801,58,2,3,5,40.0%,5m
22213,3,[FyHr]kronos,2801,0,1,0,1,100.0%,25m
22213,3,[GUERHT]Josh,2801,0,1,1,2,50.0%,28m
22213,2,Drozsky,2801,0,1,2,3,33.3%,11m
22213,3,[4xDRG]VEFxii,2801,34,1,4,5,20.0%,2h
22213,3,Player,2801,30,1,4,5,20.0%,29m
22213,3,Pinche,2801,0,0,5,5,0.0%,21m
22241,2,Stevius,2800,1535,333,310,643,51.8%,12m
22241,3,Skunk,2800,1020,238,218,456,52.2%,41m
22241,2,[Meadow]thruxton,2800,1349,72,71,143,50.3%,36m
22241,3,[UpxV]Erennor,2800,1560,71,65,136,52.2%,16m
22241,3,IIIIIIII,2800,1141,52,31,83,62.7%,35m
22241,2,[UWCSC]GetElfBread,2800,1083,49,37,86,57.0%,17m
22241,3,Solo,2800,909,40,24,64,62.5%,25m
22241,3,Rusted,2800,1064,40,40,80,50.0%,24m
22241,3,Marcus,2800,592,28,12,40,70.0%,11m
22241,3,Alex,2800,308,13,13,26,50.0%,23m
22241,2,Miguel,2800,298,10,16,26,38.5%,36m
22241,3,trinket,2800,261,8,6,14,57.1%,17m
22241,3,[WHlTES]Chimp,2800,265,8,9,17,47.1%,7m
22241,3,Muse,2800,196,7,3,10,70.0%,29m
22241,3,FaTaBa,2800,120,5,3,8,62.5%,28m
22241,1,Faintear,2800,155,5,4,9,55.6%,55m
22241,3,Fishy,2800,144,5,7,12,41.7%,25m
22241,3,fragile,2800,86,4,2,6,66.7%,26m
22241,3,gdmsob,2800,116,4,6,10,40.0%,31m
22241,3,Fran,2800,0,3,3,6,50.0%,10m
22241,3,Renaissance,2800,92,3,5,8,37.5%,11m
22241,3,CaptainJP,2800,30,2,1,3,66.7%,42m
22241,2,tajik,2800,0,2,3,5,40.0%,10m
22241,3,[TheVD]Spish,2800,132,2,5,7,28.6%,17m
22241,3,Solaris,2800,30,1,1,2,50.0%,13m
22241,3,gabicho,2800,0,1,1,2,50.0%,35m
22241,3,Shock,2800,30,1,3,4,25.0%,28m
22241,3,HORIZONTH,2800,30,1,4,5,20.0%,42m
22241,3,[YetiFC]DrkYeti,2800,0,0,1,1,0.0%,42m
22241,3,Kashar,2800,0,0,1,1,0.0%,34m
22241,3,[FHoLG]Korhal,2800,0,0,1,1,0.0%,40m
22241,3,Fly,2800,0,0,1,1,0.0%,31m
22273,3,busfullonuns,2799,1284,53,46,99,53.5%,28m
22273,3,TuPapi,2799,811,38,29,67,56.7%,24m
22273,3,PeterPenor,2799,512,24,15,39,61.5%,18m
22273,2,ispirit,2799,432,17,17,34,50.0%,14m
22273,3,jujuksri,2799,281,13,6,19,68.4%,9m
22273,3,NightCrawler,2799,290,11,5,16,68.8%,7m
22273,2,runinmonkey,2799,254,11,11,22,50.0%,60m
22273,3,IsaacQT,2799,300,11,14,25,44.0%,5m
22273,3,Domin,2799,215,10,5,15,66.7%,6m
22273,3,Deadlock,2799,280,9,9,18,50.0%,4m
22273,3,Leeshinobi,2799,174,7,5,12,58.3%,28m
22273,2,GasMerchant,2799,149,6,5,11,54.5%,22m
22273,3,Silentdead,2799,176,6,7,13,46.2%,25m
22273,3,Aitan,2799,139,4,0,4,100.0%,18m
22273,3,WareZ,2799,112,4,4,8,50.0%,35m
22273,1,Zero,2799,97,4,4,8,50.0%,25m
22273,3,MoGhatNxPx,2799,0,3,2,5,60.0%,33m
22273,2,Kreamz,2799,0,3,4,7,42.9%,38m
22273,3,[P4NDAS]Hammerhead,2799,116,2,1,3,66.7%,6m
22273,3,Pertinacious,2799,30,2,2,4,50.0%,35m
22273,1,Zyzemo,2799,48,2,2,4,50.0%,2h
22273,3,CJwireD,2799,0,1,1,2,50.0%,4m
22273,3,SubZero,2799,0,1,1,2,50.0%,9m
22273,3,Supe,2799,30,1,5,6,16.7%,28m
22273,2,valentino,2799,0,0,1,1,0.0%,2h
22273,3,Saazer,2799,0,0,2,2,0.0%,10m
22273,3,Stylo,2799,0,0,2,2,0.0%,14m
22273,3,gabriel,2799,0,0,2,2,0.0%,24m
22301,3,BattleFrog,2798,1541,96,79,175,54.9%,17m
22301,2,DerpVader,2798,637,55,51,106,51.9%,2m
22301,3,[Faucet]Bathroom,2798,1197,51,44,95,53.7%,6m
22301,3,[CHEASE]McGregor,2798,1219,47,40,87,54.0%,25m
22301,2,Khufu,2798,1199,47,49,96,49.0%,2m
22301,2,Vysedomo,2798,390,44,38,82,53.7%,32m
22301,1,dionysos,2798,694,44,50,94,46.8%,29m
22301,3,Frost,2798,489,20,14,34,58.8%,7m
22301,3,GOÐ,2798,275,18,9,27,66.7%,25m
22301,2,[Larvax]Golgothad,2798,415,17,16,33,51.5%,38m
22301,3,Shless,2798,415,17,16,33,51.5%,22m
22301,3,Bluepill,2798,348,14,14,28,50.0%,17m
22301,3,BigDaddyUwU,2798,223,13,2,15,86.7%,31m
22301,3,DripDry,2798,239,10,5,15,66.7%,5m
22301,3,[Khalta]ARCANGEL,2798,256,10,7,17,58.8%,27m
22301,3,CEthaNoob,2798,118,6,2,8,75.0%,31m
22301,3,Vison,2798,205,6,5,11,54.5%,15m
22301,1,Ceder,2798,214,6,6,12,50.0%,1h
22301,3,geozdiegoXD,2798,166,5,1,6,83.3%,16m
22301,1,RatMuscle,2798,145,4,5,9,44.4%,2h
22301,2,[RedHat]TheDoctor,2798,119,3,0,3,100.0%,2h
22301,1,ACe,2798,134,3,1,4,75.0%,2h
22301,1,[xXGDXx]bruno,2798,124,3,3,6,50.0%,2h
22301,3,GruntyChief,2798,30,2,2,4,50.0%,25m
22301,3,Ren,2798,0,2,3,5,40.0%,24m
22301,2,Anekdotin,2798,95,2,4,6,33.3%,2h
22301,2,[TGosuC]dillydickles,2798,30,2,7,9,22.2%,11m
22301,2,PORONGOSAURI,2798,0,1,0,1,100.0%,32m
22301,3,UncLeToBy,2798,0,1,3,4,25.0%,2h
22301,3,argument,2798,30,1,4,5,20.0%,4m
22301,3,RazorTodd,2798,0,0,1,1,0.0%,19m
22301,3,tuhermana,2798,0,0,2,2,0.0%,11m
22301,3,oibr,2798,0,0,2,2,0.0%,41m
22301,3,kulaDELUXE,2798,0,0,3,3,0.0%,39m
22301,3,ShmeeShaw,2798,0,0,3,3,0.0%,34m
22336,1,Chau,2797,1579,563,520,1083,52.0%,14m
22336,2,Childmuncher,2797,949,201,209,410,49.0%,42m
22336,3,KiraKari,2797,1137,148,146,294,50.3%,17m
22336,3,NightRaven,2797,1555,104,85,189,55.0%,12m
22336,2,kingfight,2797,1501,78,78,156,50.0%,36m
22336,3,CPTSmAcKaHo,2797,1298,53,53,106,50.0%,36m
22336,3,Sqigy,2797,937,48,28,76,63.2%,31m
22336,2,[Mecha]Ukkonen,2797,602,24,24,48,50.0%,17m
22336,3,Noblefire,2797,373,23,21,44,52.3%,4m
22336,3,fmonkey,2797,560,20,23,43,46.5%,14m
22336,3,[GOPERÚ]Rohan,2797,455,17,12,29,58.6%,29m
22336,2,[Submr]MrSir,2797,532,17,23,40,42.5%,41m
22336,3,[ZFMs]healthyeater,2797,413,16,8,24,66.7%,18m
22336,2,[ZTempz]SilentReaver,2797,343,14,12,26,53.8%,18m
22336,3,MelIris,2797,220,9,7,16,56.2%,2h
22336,1,Samhir,2797,62,5,5,10,50.0%,26m
22336,3,DiamondKill,2797,86,4,2,6,66.7%,42m
22336,1,Klemon,2797,96,4,2,6,66.7%,17m
22336,3,[JetPAC]BouncyKnight,2797,119,4,4,8,50.0%,17m
22336,3,OMGBill,2797,124,2,9,11,18.2%,19m
22336,3,GrosMalin,2797,0,1,0,1,100.0%,25m
22336,3,[ADB]Leviathan,2797,96,1,1,2,50.0%,19m
22336,2,Lissander,2797,0,1,1,2,50.0%,3h
22336,3,NoSkills,2797,30,1,2,3,33.3%,36m
22336,3,ThirdPlace,2797,0,0,1,1,0.0%,29m
22336,3,CrackJac,2797,0,0,1,1,0.0%,11m
22362,1,Zorata,2796,1461,79,76,155,51.0%,26m
22362,1,Donavan,2796,1357,63,71,134,47.0%,11m
22362,3,TheOvenMitt,2796,1149,48,41,89,53.9%,5m
22362,2,Season,2796,916,38,37,75,50.7%,41m
22362,3,valentino,2796,448,19,9,28,67.9%,4m
22362,2,Computer,2796,248,11,9,20,55.0%,12m
22362,3,GongJoo,2796,292,11,10,21,52.4%,14m
22362,3,ReturnZero,2796,265,10,9,19,52.6%,37m
22362,3,[MxDNut]Zathanic,2796,232,9,7,16,56.2%,25m
22362,3,Daresay,2796,176,7,5,12,58.3%,42m
22362,2,Aesix,2796,156,7,7,14,50.0%,12m
22362,3,LiversLovers,2796,40,5,6,11,45.5%,56m
22362,3,acdales,2796,116,4,4,8,50.0%,17m
22362,1,GALAXYBRIAN,2796,97,4,4,8,50.0%,41m
22362,3,[GDOx]Koalabear,2796,0,3,2,5,60.0%,17m
22362,3,DinoMyte,2796,60,3,6,9,33.3%,30m
22362,1,[Mammy]FaDeMuss,2796,97,3,6,9,33.3%,51m
22362,1,aesthetics,2796,92,3,8,11,27.3%,1h
22362,2,Ibakecookies,2796,95,2,2,4,50.0%,19m
22362,2,[Lp]RapSolo,2796,0,2,5,7,28.6%,31m
22362,3,[KTBOSS]xShadowx,2796,0,1,0,1,100.0%,29m
22362,2,Serceasule,2796,34,1,1,2,50.0%,32m
22362,3,[NoSlep]ProtossDeity,2796,30,1,2,3,33.3%,9m
22362,3,BumbbleBTuna,2796,0,0,1,1,0.0%,16m
22362,3,[P07470]Conquistador,2796,0,0,1,1,0.0%,12m
22387,1,ProfessorX,2795,1585,470,476,946,49.7%,42m
22387,2,mvelli,2795,1187,102,73,175,58.3%,28m
22387,3,Hudson,2795,1232,48,48,96,50.0%,28m
22387,2,blay,2795,1227,47,51,98,48.0%,5m
22387,1,carrydacarro,2795,1201,46,56,102,45.1%,17m
22387,3,[HØST]EliasParrini,2795,555,23,23,46,50.0%,38m
22387,2,Dudemeister,2795,491,22,26,48,45.8%,35m
22387,3,ScottAbrams,2795,315,21,17,38,55.3%,29m
22387,1,Mazzichist,2795,572,18,28,46,39.1%,25m
22387,1,Pajegetc,2795,430,16,30,46,34.8%,14m
22387,3,[HENT4l]GoingPostal,2795,234,9,9,18,50.0%,9m
22387,2,Gino,2795,140,7,6,13,53.8%,20m
22387,3,Himsky,2795,187,7,8,15,46.7%,2h
22387,3,BeezleBoss,2795,201,6,3,9,66.7%,29m
22387,1,xxardacoxx,2795,70,3,10,13,23.1%,26m
22387,3,YamPoolGamer,2795,30,2,2,4,50.0%,31m
22387,3,DuskTower,2795,30,2,3,5,40.0%,14m
22387,2,[FAECES]TypicalGenra,2795,116,2,6,8,25.0%,18m
22387,2,NECRODRAGON,2795,0,1,0,1,100.0%,3h
22387,3,Humberto,2795,30,1,4,5,20.0%,10m
22387,3,Kvothe,2795,0,0,1,1,0.0%,25m
22387,3,VIP,2795,0,0,1,1,0.0%,11m
22387,3,TerHan,2795,0,0,3,3,0.0%,16m
22410,2,Axyless,2794,1259,318,295,613,51.9%,25m
22410,2,Cutuvelo,2794,1571,294,270,564,52.1%,33m
22410,2,[Flam3s]Salt,2794,1491,244,241,485,50.3%,37m
22410,2,[PMgaf]GoodUsopp,2794,1567,154,143,297,51.9%,14m
22410,3,Ranc,2794,1212,126,99,225,56.0%,40m
22410,3,[SOAF]ZobelPrize,2794,1070,91,87,178,51.1%,22m
22410,3,Null,2794,1011,51,49,100,51.0%,3m
22410,2,ThePvK,2794,646,49,44,93,52.7%,30m
22410,2,[EvilGC]Fenrir,2794,471,42,39,81,51.9%,3m
22410,1,[EZTZPZ]ArchSyntropy,2794,802,42,45,87,48.3%,30m
22410,3,EpicNinjaFTW,2794,972,39,35,74,52.7%,6m
22410,2,Slark,2794,667,30,38,68,44.1%,33m
22410,3,Zarathustra,2794,347,14,14,28,50.0%,25m
22410,2,Hated,2794,342,12,17,29,41.4%,26m
22410,3,Nikelaos,2794,176,6,11,17,35.3%,23m
22410,3,danray,2794,0,3,2,5,60.0%,23m
22410,3,[FoxBR]Foxtrot,2794,58,3,2,5,60.0%,31m
22410,2,[SMBBD]zergberger,2794,0,3,3,6,50.0%,43m
22410,3,ETOVE,2794,0,3,3,6,50.0%,19m
22410,3,Talkmix,2794,0,1,1,2,50.0%,24m
22410,2,sarLey,2794,0,1,2,3,33.3%,2h
22410,3,PANICMODE,2794,0,0,1,1,0.0%,4m
22410,3,RoyaLotus,2794,0,0,1,1,0.0%,35m
22410,3,Sunbro,2794,0,0,1,1,0.0%,37m
22410,3,[MURI0C]dragon,2794,0,0,4,4,0.0%,33m
22435,2,Lolomgwtf,2793,1000,139,137,276,50.4%,43m
22435,3,Cinco,2793,1507,117,83,200,58.5%,10m
22435,3,OvrHAUL,2793,1447,87,72,159,54.7%,5m
22435,3,slevin,2793,1162,50,35,85,58.8%,11m
22435,3,Nirvash,2793,301,45,35,80,56.2%,5m
22435,3,PariahJun,2793,804,31,30,61,50.8%,6m
22435,2,[Zergki]ZergKi,2793,348,27,20,47,57.4%,17m
22435,3,[Howny]Erfat,2793,522,24,16,40,60.0%,39m
22435,3,bEkAchI,2793,407,24,20,44,54.5%,29m
22435,2,GhostEnema,2793,596,21,28,49,42.9%,38m
22435,3,GRNplanet,2793,448,18,13,31,58.1%,41m
22435,3,Cuong,2793,350,13,8,21,61.9%,29m
22435,1,[prim8s]CCP,2793,372,13,23,36,36.1%,17m
22435,3,Nevrambaiel,2793,307,12,11,23,52.2%,4m
22435,2,Sirmagicman,2793,259,10,11,21,47.6%,43m
22435,3,NoInnovation,2793,232,8,11,19,42.1%,17m
22435,2,[SttE]CMF,2793,238,8,14,22,36.4%,18m
22435,1,ThrasheR,2793,160,7,8,15,46.7%,19m
22435,2,[1623]Juanfer,2793,118,5,6,11,45.5%,15m
22435,1,Rukaz,2793,193,4,3,7,57.1%,18m
22435,2,[Skids]TerryRatfuk,2793,92,4,6,10,40.0%,24m
22435,3,[TGCrew]Cronosphere,2793,58,3,2,5,60.0%,16m
22435,3,SlickChicken,2793,90,3,3,6,50.0%,18m
22435,2,Patched,2793,119,3,3,6,50.0%,31m
22435,3,ThyPower,2793,30,2,2,4,50.0%,33m
22435,3,[SINSTR]SoloWing,2793,60,2,7,9,22.2%,26m
22435,3,IlIlllIlIIIl,2793,0,0,1,1,0.0%,20m
22435,3,[PaC]PaNoRaMiX,2793,0,0,1,1,0.0%,24m
22435,3,[lKoDl]DevilDog,2793,0,0,1,1,0.0%,4m
22464,2,Berezovsky,2792,1491,277,277,554,50.0%,35m
22464,3,Toucan,2792,1600,109,101,210,51.9%,6m
22464,2,Apagon,2792,1359,59,55,114,51.8%,22m
22464,2,[Fltboi]Nagula,2792,517,49,41,90,54.4%,15m
22464,3,IlIIIIlIllII,2792,561,45,28,73,61.6%,20m
22464,3,DrBigPP,2792,615,28,16,44,63.6%,3m
22464,3,YoungGunz,2792,620,28,20,48,58.3%,43m
22464,1,ThugWaffle,2792,615,25,29,54,46.3%,38m
22464,3,Vinyl,2792,254,21,10,31,67.7%,27m
22464,2,DuMaYouOK,2792,610,20,27,47,42.6%,15m
22464,3,Cannon,2792,526,18,16,34,52.9%,25m
22464,3,Xuron,2792,269,11,8,19,57.9%,39m
22464,2,YourErection,2792,243,10,11,21,47.6%,28m
22464,3,SSJTimotay,2792,202,8,7,15,53.3%,13m
22464,3,Whippersnap,2792,155,7,4,11,63.6%,12m
22464,1,[BOYG]MadShiro,2792,145,6,3,9,66.7%,2h
22464,2,HeyBlake,2792,172,6,13,19,31.6%,38m
22464,1,[C4]Furytek,2792,184,5,1,6,83.3%,19m
22464,3,[LGNxx]DarkBlood,2792,142,3,2,5,60.0%,21m
22464,2,yesjuice,2792,114,3,3,6,50.0%,52m
22464,2,[PuffWC]Paopan,2792,0,3,3,6,50.0%,3m
22464,3,QuelpoHelpo,2792,92,3,5,8,37.5%,19m
22464,3,kzhk,2792,30,2,1,3,66.7%,27m
22464,2,SenorKhan,2792,0,1,3,4,25.0%,33m
22464,3,Farsgull,2792,0,1,4,5,20.0%,33m
22464,3,[HD7K]SkueruolJ,2792,0,0,1,1,0.0%,42m
22464,3,Audacity,2792,0,0,3,3,0.0%,4m
22491,2,Dblacksanta,2791,1124,163,141,304,53.6%,11m
22491,3,JACOBY,2791,1586,123,103,226,54.4%,30m
22491,2,[WlNGS]RoCho,2791,1164,84,72,156,53.8%,14m
22491,3,MaxPayne,2791,240,19,15,34,55.9%,41m
22491,1,Szczech,2791,422,18,27,45,40.0%,3m
22491,3,Magic,2791,474,16,25,41,39.0%,18m
22491,3,Stacks,2791,292,10,10,20,50.0%,18m
22491,3,[crispr]SantaClaus,2791,181,8,5,13,61.5%,9m
22491,2,Dench,2791,164,5,2,7,71.4%,1h
22491,3,[hdg]Tiberian,2791,54,4,6,10,40.0%,34m
22491,3,[AiMB]ASH,2791,86,4,6,10,40.0%,9m
22491,3,[P1SS]TiPeEliCiOuS,2791,58,3,2,5,60.0%,13m
22491,3,Lucid,2791,92,3,3,6,50.0%,4m
22491,3,[RPL]cLinto,2791,94,3,3,6,50.0%,35m
22491,3,[WRFs87]Soriano,2791,60,3,3,6,50.0%,33m
22491,3,MasterQueef,2791,60,2,3,5,40.0%,31m
22491,3,Nowah,2791,0,1,0,1,100.0%,38m
22491,3,kentan,2791,0,1,2,3,33.3%,3h
22491,3,Gtc,2791,30,1,5,6,16.7%,34m
22491,3,[T1TC]Ribeiro,2791,0,0,1,1,0.0%,34m
22491,3,[Weac]bananaman,2791,0,0,6,6,0.0%,14m
22512,3,boyroy,2790,1151,100,93,193,51.8%,33m
22512,3,PoopLord,2790,702,42,26,68,61.8%,12m
22512,3,[NAisOK]WEEBRATOR,2790,872,36,30,66,54.5%,28m
22512,2,[PTHero]SoberLaaku,2790,926,36,39,75,48.0%,11m
22512,2,MCHamster,2790,802,28,35,63,44.4%,33m
22512,3,SkyBison,2790,558,20,21,41,48.8%,25m
22512,3,KiYOZO,2790,392,17,14,31,54.8%,29m
22512,3,Wonder,2790,336,13,11,24,54.2%,12m
22512,3,FatTony,2790,78,8,8,16,50.0%,42m
22512,2,MahKill,2790,182,7,11,18,38.9%,42m
22512,3,BIOLITE,2790,60,6,3,9,66.7%,20m
22512,3,[CoCo19]Broxigar,2790,117,6,6,12,50.0%,25m
22512,1,[nbgPH]Napster,2790,0,4,3,7,57.1%,51m
22512,3,Dentcat,2790,114,3,0,3,100.0%,19m
22512,2,KookA,2790,0,3,3,6,50.0%,10m
22512,1,[BTBGG]Scornstar,2790,0,3,3,6,50.0%,58m
22512,3,Yani,2790,0,1,1,2,50.0%,31m
22512,3,Bytori,2790,30,1,1,2,50.0%,9m
22512,3,[Dmonik]Belial,2790,0,0,1,1,0.0%,16m
22512,3,chem,2790,0,0,1,1,0.0%,30m
22512,3,Eimin,2790,0,0,2,2,0.0%,16m
22512,3,Einarin,2790,0,0,4,4,0.0%,16m
22534,3,JeremyJC,2789,1592,132,98,230,57.4%,33m
22534,3,Gusto,2789,1283,119,120,239,49.8%,11m
22534,3,Beast,2789,1590,108,93,201,53.7%,12m
22534,1,[POPJAW]JawPoper,2789,743,96,104,200,48.0%,42m
22534,2,MPA,2789,1575,91,90,181,50.3%,36m
22534,3,Lennox,2789,1412,87,71,158,55.1%,14m
22534,3,Littlebee,2789,422,65,26,91,71.4%,16m
22534,2,HeLLBoY,2789,679,32,25,57,56.1%,11m
22534,3,dantron,2789,527,19,20,39,48.7%,13m
22534,3,Ribz,2789,209,12,5,17,70.6%,31m
22534,3,Blaqmail,2789,316,11,13,24,45.8%,42m
22534,3,QuietMind,2789,292,10,12,22,45.5%,43m
22534,2,vuoseck,2789,176,9,10,19,47.4%,22m
22534,2,mhoffy,2789,196,8,13,21,38.1%,15m
22534,3,[ALBA]ImaSnaake,2789,215,7,4,11,63.6%,16m
22534,3,SkenZ,2789,222,7,4,11,63.6%,34m
22534,3,MRPOPO,2789,163,7,5,12,58.3%,29m
22534,3,Hamsters,2789,112,7,5,12,58.3%,11m
22534,3,Corporate,2789,137,5,4,9,55.6%,4m
22534,2,Ethann,2789,182,5,5,10,50.0%,52m
22534,3,IIIIIIIIIIII,2789,30,5,7,12,41.7%,10m
22534,3,SiNtEcLaDo,2789,134,4,0,4,100.0%,35m
22534,3,LudwigVonMis,2789,140,4,2,6,66.7%,3m
22534,3,elmosabe,2789,118,4,6,10,40.0%,40m
22534,2,Sebas,2789,90,4,12,16,25.0%,39m
22534,3,BobLoblah,2789,144,3,2,5,60.0%,7m
22534,3,[Antss]DazedConfuse,2789,88,3,3,6,50.0%,25m
22534,2,SUNSCREAMMMM,2789,0,3,3,6,50.0%,50m
22534,3,Smashblade,2789,147,3,3,6,50.0%,1h
22534,2,Ironbull,2789,95,3,3,6,50.0%,2h
22534,2,ronian,2789,88,3,5,8,37.5%,15m
22534,3,Izraador,2789,30,2,0,2,100.0%,3m
22534,3,Sadist,2789,62,2,7,9,22.2%,22m
22534,3,FattPenguin,2789,0,1,1,2,50.0%,7m
22534,3,[DETER]implehshun,2789,0,1,4,5,20.0%,12m
22534,1,traps,2789,0,0,1,1,0.0%,30m
22570,2,PadanFain,2788,1569,143,134,277,51.6%,36m
22570,3,ZergWorm,2788,917,63,51,114,55.3%,31m
22570,2,Fogobro,2788,466,30,29,59,50.8%,38m
22570,2,[HBOYZ]Banelings,2788,592,24,21,45,53.3%,36m
22570,2,Battlemaster,2788,452,16,24,40,40.0%,33m
22570,2,william,2788,266,10,16,26,38.5%,37m
22570,2,Nozual,2788,295,9,15,24,37.5%,7m
22570,3,TrustChrist,2788,235,7,6,13,53.8%,33m
22570,3,alexspach,2788,178,7,8,15,46.7%,7m
22570,2,lumps,2788,220,7,10,17,41.2%,4m
22570,2,Wymiatacz,2788,95,5,1,6,83.3%,43m
22570,3,Tryharddie,2788,135,5,4,9,55.6%,21m
22570,3,murfee,2788,120,4,6,10,40.0%,10m
22570,3,[Ballz]Kaisad,2788,143,3,3,6,50.0%,39m
22570,1,Fliegen,2788,93,3,3,6,50.0%,30m
22570,2,robotninja,2788,0,2,3,5,40.0%,2h
22570,3,NamWasFake,2788,60,2,4,6,33.3%,11m
22570,3,Betoso,2788,88,2,4,6,33.3%,31m
22570,3,Shadowstorm,2788,0,1,0,1,100.0%,7m
22570,3,doublespace,2788,0,1,4,5,20.0%,25m
22570,2,germn,2788,30,1,7,8,12.5%,39m
22570,3,jjordann,2788,0,0,1,1,0.0%,7m
22570,3,FrozenSabre,2788,0,0,1,1,0.0%,13m
22570,3,Wittelman,2788,0,0,1,1,0.0%,41m
22570,2,pure,2788,0,0,1,1,0.0%,2h
22595,3,Ada,2787,1581,188,157,345,54.5%,33m
22595,3,[SGR409]CaptnObvious,2787,1524,133,105,238,55.9%,7m
22595,3,Oozi,2787,623,117,97,214,54.7%,13m
22595,3,GokGok,2787,1531,68,62,130,52.3%,12m
22595,3,Fiesta,2787,1106,45,40,85,52.9%,11m
22595,3,Drazul,2787,953,37,39,76,48.7%,35m
22595,2,gabrieleitor,2787,463,37,44,81,45.7%,33m
22595,3,[VRGM]Kaitos,2787,329,32,25,57,56.1%,12m
22595,2,TheDarkLord,2787,740,30,30,60,50.0%,11m
22595,2,Kurhizma,2787,721,29,29,58,50.0%,38m
22595,3,[Test42]CodyB,2787,610,27,17,44,61.4%,14m
22595,2,Sirxch,2787,568,19,25,44,43.2%,31m
22595,3,[MADDD]Crazyify,2787,484,17,17,34,50.0%,23m
22595,3,cRYZ,2787,350,15,4,19,78.9%,17m
22595,3,Tafirol,2787,245,15,12,27,55.6%,25m
22595,3,[UpxV]marusero,2787,368,12,10,22,54.5%,20m
22595,3,OllllillllO,2787,267,11,5,16,68.8%,5m
22595,3,IIIIIIIIIIII,2787,270,10,4,14,71.4%,26m
22595,3,mastertiger,2787,144,6,4,10,60.0%,26m
22595,3,Busty,2787,176,6,9,15,40.0%,8m
22595,3,Camith,2787,57,4,3,7,57.1%,21m
22595,2,ZerglinToast,2787,0,3,3,6,50.0%,13m
22595,1,xOxO,2787,113,3,5,8,37.5%,10m
22595,1,[GRNSKN]Zryw,2787,48,1,3,4,25.0%,9m
22595,3,[bOvOd]VIOLstar,2787,30,1,4,5,20.0%,21m
22595,3,sherminatorr,2787,0,0,1,1,0.0%,19m
22595,3,yOOK,2787,0,0,1,1,0.0%,28m
22595,3,Bling,2787,0,0,1,1,0.0%,12m
22595,1,clampKK,2787,0,0,3,3,0.0%,2h
22595,3,[TGosuA]TheRomanian,2787,0,0,5,5,0.0%,41m
22625,3,Txking,2786,615,90,91,181,49.7%,10m
22625,2,Dan,2786,1469,83,89,172,48.3%,28m
22625,2,Asderel,2786,1308,78,73,151,51.7%,17m
22625,2,Duncan,2786,1216,49,43,92,53.3%,28m
22625,2,jhmaka,2786,708,27,28,55,49.1%,11m
22625,2,Dallas,2786,503,20,23,43,46.5%,6m
22625,3,Taroro,2786,416,18,15,33,54.5%,19m
22625,3,GeertFR,2786,244,15,11,26,57.7%,40m
22625,3,lllllllllll,2786,434,15,17,32,46.9%,17m
22625,2,NousDefions,2786,214,12,4,16,75.0%,36m
22625,3,StaticVoid,2786,294,11,11,22,50.0%,12m
22625,3,nuYOmaYO,2786,245,8,5,13,61.5%,27m
22625,2,Danny,2786,90,6,7,13,46.2%,42m
22625,3,ProtosMangas,2786,148,5,7,12,41.7%,19m
22625,1,levenpeven,2786,192,5,9,14,35.7%,2h
22625,2,StorK,2786,0,4,1,5,80.0%,2h
22625,1,Wraithlord,2786,97,4,4,8,50.0%,39m
22625,3,[TAW]Nightowl,2786,112,3,0,3,100.0%,17m
22625,3,xBATTLEx,2786,0,3,2,5,60.0%,7m
22625,3,quicklyspent,2786,0,3,2,5,60.0%,26m
22625,3,Jake,2786,60,3,3,6,50.0%,31m
22625,3,Labarca,2786,60,3,3,6,50.0%,17m
22625,3,Mangala,2786,92,3,4,7,42.9%,33m
22625,3,squigwig,2786,30,2,1,3,66.7%,9m
22625,3,[ELTEMW]Nyquist,2786,0,1,0,1,100.0%,7m
22625,3,[nieBla]DonkomanTHC,2786,0,1,0,1,100.0%,6m
22625,2,[Cryptc]Soul,2786,0,1,1,2,50.0%,2h
22625,3,[IMDSI]Murillox,2786,93,1,1,2,50.0%,32m
22625,1,buru,2786,48,1,3,4,25.0%,2h
22625,1,TimGriz,2786,30,1,16,17,5.9%,12m
22625,1,FANTADUDE,2786,0,0,2,2,0.0%,55m
22656,2,Disobedience,2785,1585,837,781,1618,51.7%,37m
22656,3,ElementrX,2785,1506,122,88,210,58.1%,39m
22656,2,Delha,2785,893,118,113,231,51.1%,7m
22656,3,Blind,2785,455,109,92,201,54.2%,5m
22656,2,Ookifat,2785,924,97,85,182,53.3%,14m
22656,3,caek,2785,1148,81,53,134,60.4%,3m
22656,2,[HØST]LeoWalker,2785,301,52,29,81,64.2%,33m
22656,3,itchyrear,2785,728,47,38,85,55.3%,7m
22656,3,chemlab,2785,1089,47,38,85,55.3%,40m
22656,3,Byrd,2785,912,42,36,78,53.8%,40m
22656,3,[OGbros]Roda,2785,743,26,26,52,50.0%,14m
22656,3,KMAGyoyo,2785,600,24,28,52,46.2%,29m
22656,3,StimToWin,2785,506,20,14,34,58.8%,12m
22656,3,FartGoblin,2785,426,19,21,40,47.5%,23m
22656,2,Zeddricon,2785,402,17,17,34,50.0%,6m
22656,2,[UW]Bizl,2785,512,17,26,43,39.5%,33m
22656,3,Gooseater,2785,293,16,7,23,69.6%,28m
22656,3,ILLIDAN,2785,300,14,14,28,50.0%,31m
22656,3,Angelmaker,2785,277,10,5,15,66.7%,7m
22656,3,Sonice,2785,249,9,7,16,56.2%,42m
22656,3,DankPlatypus,2785,225,7,3,10,70.0%,29m
22656,3,DankSaVaGe,2785,155,6,5,11,54.5%,28m
22656,2,Grike,2785,83,6,11,17,35.3%,5m
22656,2,BESTPLAYER,2785,242,6,12,18,33.3%,10m
22656,2,WILLFULL,2785,164,6,16,22,27.3%,16m
22656,2,CovidSlayer,2785,0,4,1,5,80.0%,25m
22656,3,OwarD,2785,105,4,3,7,57.1%,8m
22656,1,[eCKo]Zenabi,2785,48,2,1,3,66.7%,2h
22656,3,[xTQc]Choco,2785,0,1,0,1,100.0%,19m
22656,2,BIGrunt,2785,0,1,1,2,50.0%,2h
22656,3,Dweloren,2785,30,1,2,3,33.3%,7m
22656,3,BananaMan,2785,30,1,3,4,25.0%,39m
22656,2,owen,2785,0,1,4,5,20.0%,25m
22656,3,jonnybrah,2785,0,0,2,2,0.0%,25m
22690,3,Earendil,2784,1612,119,113,232,51.3%,28m
22690,3,[ValidG]MysterEWisp,2784,1056,63,50,113,55.8%,40m
22690,2,Thanatopsis,2784,1217,55,54,109,50.5%,40m
22690,3,[ChfSho]WhrTheAnyKey,2784,792,31,26,57,54.4%,15m
22690,3,thekiller,2784,541,26,13,39,66.7%,24m
22690,3,dotablaze,2784,535,26,15,41,63.4%,26m
22690,2,[ALQ]ReAdosS,2784,622,23,27,50,46.0%,39m
22690,3,Lancelot,2784,368,17,5,22,77.3%,23m
22690,3,UwU,2784,326,15,4,19,78.9%,35m
22690,3,Fino,2784,370,14,7,21,66.7%,7m
22690,3,Epsilon,2784,316,13,12,25,52.0%,26m
22690,3,TecFenix,2784,233,10,8,18,55.6%,24m
22690,2,AdmiralAcorn,2784,324,10,18,28,35.7%,43m
22690,3,RamBowzDeep,2784,176,7,7,14,50.0%,4m
22690,2,ThVium,2784,218,7,15,22,31.8%,36m
22690,3,Cezi,2784,192,6,3,9,66.7%,41m
22690,3,benjamin,2784,111,5,2,7,71.4%,28m
22690,2,TheSecrety,2784,90,5,3,8,62.5%,2h
22690,1,Ghost,2784,141,5,5,10,50.0%,3h
22690,1,nika,2784,138,5,5,10,50.0%,2h
22690,3,[ZCCCFE]KoCho,2784,168,4,4,8,50.0%,31m
22690,2,[aIien]JohnnyDepp,2784,0,3,2,5,60.0%,2h
22690,3,WAJUNG,2784,30,3,4,7,42.9%,41m
22690,2,Fergotronic,2784,0,3,4,7,42.9%,11m
22690,2,NeoSecondSEA,2784,92,3,10,13,23.1%,25m
22690,3,Baymin,2784,58,2,3,5,40.0%,18m
22690,2,[Toliet]Jackowacko,2784,30,2,8,10,20.0%,17m
22690,3,Shampsky,2784,0,1,0,1,100.0%,34m
22690,3,[LAMMS]Lammy,2784,0,1,0,1,100.0%,3m
22690,3,Deathcall,2784,30,1,3,4,25.0%,21m
22690,1,RRWrestlr,2784,0,1,3,4,25.0%,14m
22690,3,Busters,2784,0,0,1,1,0.0%,6m
22722,3,Retro,2783,1580,141,115,256,55.1%,28m
22722,2,[Cambas]Edwinosky,2783,1185,127,126,253,50.2%,30m
22722,1,Incubus,2783,1072,74,79,153,48.4%,16m
22722,3,Jamin,2783,1529,72,65,137,52.6%,4m
22722,3,aliN,2783,1397,61,45,106,57.5%,28m
22722,2,grimey,2783,654,27,24,51,52.9%,15m
22722,2,manutatu,2783,674,24,29,53,45.3%,42m
22722,3,Hyzerflip,2783,404,16,16,32,50.0%,7m
22722,3,[ZTemp]FuzzNut,2783,246,9,4,13,69.2%,16m
22722,3,Edelen,2783,165,8,4,12,66.7%,20m
22722,1,BrooMz,2783,258,8,7,15,53.3%,51m
22722,3,RoorinRyan,2783,214,7,7,14,50.0%,29m
22722,3,[TDT]Gaerith,2783,123,5,4,9,55.6%,40m
22722,2,Maureencita,2783,147,4,4,8,50.0%,15m
22722,2,NudeTayne,2783,88,4,8,12,33.3%,28m
22722,1,[LOHs]VashTzP,2783,143,3,2,5,60.0%,3h
22722,2,Wolfe,2783,0,3,2,5,60.0%,1h
22722,3,TinyBigfoot,2783,92,3,3,6,50.0%,7m
22722,2,[iljill]KiltheWabit,2783,138,3,4,7,42.9%,2h
22722,1,IIIIIIIIIIII,2783,0,3,4,7,42.9%,2h
22722,3,Sanjuro,2783,30,2,2,4,50.0%,13m
22722,3,Balanar,2783,30,2,2,4,50.0%,12m
22722,3,Solarity,2783,30,2,3,5,40.0%,25m
22722,3,sizedlyric,2783,0,1,0,1,100.0%,42m
22722,3,Zegabe,2783,30,1,2,3,33.3%,28m
22722,1,PoisonJam,2783,97,1,3,4,25.0%,2h
22722,3,Polar,2783,0,1,3,4,25.0%,18m
22722,1,Vendetta,2783,42,1,8,9,11.1%,2h
22722,3,[WNTRLY]Ryuzaki,2783,0,0,1,1,0.0%,20m
22722,3,[TGosuD]Heyday,2783,0,0,1,1,0.0%,9m
22752,3,[GBANG]Conqueso,2782,756,111,102,213,52.1%,37m
22752,3,Mikinie,2782,1538,87,73,160,54.4%,41m
22752,3,ProuDleming,2782,1099,59,45,104,56.7%,17m
22752,3,Crabman,2782,1150,47,38,85,55.3%,23m
22752,3,ALVAROPEREZ,2782,577,30,19,49,61.2%,8m
22752,3,OddboD,2782,515,21,9,30,70.0%,29m
22752,3,SirPoopins,2782,266,16,5,21,76.2%,9m
22752,3,IIIIIIIIII,2782,416,14,12,26,53.8%,28m
22752,2,IIIlIlIIIIII,2782,366,13,11,24,54.2%,29m
22752,3,oJeDo,2782,186,9,8,17,52.9%,27m
22752,3,carbogens,2782,178,6,8,14,42.9%,30m
22752,3,MissQuiet,2782,30,4,3,7,57.1%,7m
22752,2,[WMWIYB]abuseislove,2782,130,4,14,18,22.2%,15m
22752,3,Ginger,2782,95,3,3,6,50.0%,16m
22752,2,oneyedling,2782,145,3,3,6,50.0%,2h
22752,3,Rain,2782,58,3,4,7,42.9%,20m
22752,3,[KJedi]BigDuke,2782,93,2,0,2,100.0%,25m
22752,3,[kdUb]INcrypted,2782,0,1,0,1,100.0%,21m
22752,3,[HKC]waffles,2782,0,0,1,1,0.0%,2h
22752,1,rainyday,2782,0,0,1,1,0.0%,2h
22752,3,StarRider,2782,0,0,1,1,0.0%,12m
22752,3,LetsGoParty,2782,0,0,2,2,0.0%,13m
22752,3,Nickarb,2782,0,0,3,3,0.0%,5m
22752,2,[FFAA]Sico,2782,0,0,4,4,0.0%,2h
22776,2,[DACKS]silkyjohnson,2781,1514,67,65,132,50.8%,9m
22776,3,rookie,2781,1292,65,54,119,54.6%,31m
22776,3,Pavel,2781,899,46,23,69,66.7%,34m
22776,3,Holyness,2781,435,40,24,64,62.5%,21m
22776,3,[SNSC]Geezer,2781,702,27,25,52,51.9%,25m
22776,2,HawkEye,2781,566,21,19,40,52.5%,38m
22776,3,[ZTemps]crobby,2781,470,19,8,27,70.4%,9m
22776,2,SelendisOWO,2781,410,17,17,34,50.0%,20m
22776,1,oldcuttrae,2781,444,17,19,36,47.2%,32m
22776,3,DaggerRPM,2781,345,15,13,28,53.6%,20m
22776,3,RySen,2781,327,14,9,23,60.9%,8m
22776,3,Klappertaart,2781,260,10,8,18,55.6%,7m
22776,2,oiuytu,2781,276,10,13,23,43.5%,37m
22776,3,Topotamdr,2781,230,9,3,12,75.0%,27m
22776,3,Tatanow,2781,267,8,8,16,50.0%,40m
22776,2,lIIIIIlll,2781,206,8,13,21,38.1%,27m
22776,3,Nullspeaker,2781,186,7,0,7,100.0%,30m
22776,3,Fireball,2781,226,7,7,14,50.0%,12m
22776,3,Biorex,2781,173,5,4,9,55.6%,44m
22776,1,WoodenShed,2781,144,5,9,14,35.7%,2h
22776,2,VoodooChild,2781,150,5,13,18,27.8%,17m
22776,3,FXmarc,2781,141,4,5,9,44.4%,20m
22776,1,Rainbows,2781,48,4,5,9,44.4%,15m
22776,1,DasNoob,2781,96,3,1,4,75.0%,51m
22776,2,Teemo,2781,96,3,3,6,50.0%,13m
22776,3,Fiirst,2781,60,3,3,6,50.0%,20m
22776,3,[2m4irl]Unjust,2781,60,3,3,6,50.0%,33m
22776,2,Braden,2781,96,3,3,6,50.0%,2h
22776,3,Stormfury,2781,30,2,1,3,66.7%,12m
22776,3,juulfiend,2781,30,2,2,4,50.0%,9m
22776,3,Knero,2781,0,1,0,1,100.0%,16m
22776,3,Hircine,2781,0,1,0,1,100.0%,33m
22776,2,TROLOLOLO,2781,0,1,0,1,100.0%,2h
22776,2,[EMP451]Winter,2781,0,1,1,2,50.0%,2h
22776,1,[FMX]Dremora,2781,0,1,1,2,50.0%,54m
22776,1,Zero,2781,97,1,2,3,33.3%,53m
22776,3,ItsReRay,2781,0,0,1,1,0.0%,42m
22776,3,firsttimesc,2781,0,0,1,1,0.0%,14m
22776,2,Peterbilt,2781,0,0,5,5,0.0%,39m
22815,2,FORTYtilFIVE,2780,1542,461,454,915,50.4%,35m
22815,2,[1vsM]Jmy,2780,1424,77,77,154,50.0%,24m
22815,3,StoneSoldier,2780,1400,68,54,122,55.7%,34m
22815,2,[FL0H]BurdaEloco,2780,1331,62,60,122,50.8%,25m
22815,3,Lokenki,2780,1430,54,55,109,49.5%,25m
22815,3,[FalPal]Kyaralonus,2780,1184,53,36,89,59.6%,16m
22815,3,JeffFix,2780,993,46,35,81,56.8%,7m
22815,3,Xeno,2780,830,36,31,67,53.7%,42m
22815,2,Rye,2780,758,28,34,62,45.2%,33m
22815,3,BOYAR,2780,444,19,11,30,63.3%,6m
22815,3,TheBaga,2780,336,15,12,27,55.6%,28m
22815,3,teawrecks,2780,324,12,13,25,48.0%,25m
22815,2,Kajika,2780,153,10,5,15,66.7%,9m
22815,2,DonkeyRunner,2780,326,10,13,23,43.5%,41m
22815,3,Evaneslink,2780,199,7,3,10,70.0%,21m
22815,2,WiseBigDaddy,2780,182,7,8,15,46.7%,15m
22815,3,UpsiDupsi,2780,161,6,2,8,75.0%,29m
22815,1,LeeTbEEr,2780,165,6,4,10,60.0%,2h
22815,2,[OndaVT]Chato,2780,164,5,4,9,55.6%,59m
22815,2,[xNPGx]AnThoN,2780,141,4,4,8,50.0%,14m
22815,3,[MEX501]Matingas,2780,86,4,4,8,50.0%,38m
22815,3,[FreeZi]ColdPenguin,2780,112,3,1,4,75.0%,17m
22815,3,[KrAce]Shushukara,2780,115,3,1,4,75.0%,9m
22815,3,[Batmn]XxLLxX,2780,0,1,0,1,100.0%,11m
22815,3,Vuk,2780,0,1,1,2,50.0%,12m
22815,3,[tCo9]Ace,2780,95,1,1,2,50.0%,40m
22815,3,isak,2780,93,1,1,2,50.0%,29m
22815,3,ZergRush,2780,0,0,1,1,0.0%,42m
22815,3,KamalaHarris,2780,0,0,1,1,0.0%,11m
22815,3,[TGosuA]Natdaddy,2780,0,0,1,1,0.0%,4m
22815,3,Drakms,2780,0,0,1,1,0.0%,5m
22815,3,AngryDonut,2780,0,0,1,1,0.0%,9m
22815,3,winterfell,2780,0,0,2,2,0.0%,12m
22815,3,[dLife]Nemesis,2780,0,0,3,3,0.0%,12m
22815,2,[Robo]Tehinferno,2780,0,0,7,7,0.0%,35m
22850,3,Jibzip,2779,1501,88,76,164,53.7%,18m
22850,3,[SCGals]Karen,2779,442,70,64,134,52.2%,15m
22850,3,KillerQueen,2779,405,58,48,106,54.7%,21m
22850,2,Lactulose,2779,1132,50,42,92,54.3%,42m
22850,3,kindred,2779,500,46,44,90,51.1%,28m
22850,2,BEERTIME,2779,887,35,47,82,42.7%,43m
22850,3,[C49]Sleepless,2779,392,24,22,46,52.2%,26m
22850,3,BreezyDonkey,2779,158,18,14,32,56.2%,6m
22850,3,[OceanT]Hikui,2779,530,18,20,38,47.4%,43m
22850,3,HereItComes,2779,326,14,7,21,66.7%,33m
22850,3,Drahas,2779,261,10,9,19,52.6%,41m
22850,2,Ham,2779,266,9,16,25,36.0%,33m
22850,3,Dethwater,2779,183,7,2,9,77.8%,37m
22850,2,Bennacide,2779,60,6,5,11,54.5%,25m
22850,3,Chamuco,2779,156,6,7,13,46.2%,36m
22850,2,[N1C3]Liberspartan,2779,156,6,11,17,35.3%,18m
22850,3,RainingBlood,2779,114,5,3,8,62.5%,9m
22850,3,WilsonPlay,2779,132,4,0,4,100.0%,33m
22850,3,[SMB]Maverick,2779,116,3,0,3,100.0%,28m
22850,3,RoGuejt,2779,90,3,3,6,50.0%,16m
22850,3,WordofBob,2779,60,2,3,5,40.0%,27m
22850,2,What,2779,0,2,3,5,40.0%,55m
22850,2,MrBojangles,2779,0,1,0,1,100.0%,34m
22850,3,[BroBlo]Axumi,2779,30,1,2,3,33.3%,11m
22850,3,aris,2779,0,1,2,3,33.3%,21m
22850,3,KindSir,2779,0,0,1,1,0.0%,21m
22850,2,Zenphoenix,2779,0,0,1,1,0.0%,59m
22850,2,imNoob,2779,0,0,1,1,0.0%,49m
22850,3,Vince,2779,0,0,2,2,0.0%,35m
22850,3,[zxczx]Remdeex,2779,0,0,2,2,0.0%,8m
22880,3,GoliathOnlin,2778,1218,164,144,308,53.2%,14m
22880,3,Nelsonsxs,2778,1552,124,117,241,51.5%,12m
22880,3,Trent,2778,263,73,60,133,54.9%,40m
22880,3,Elsolapa,2778,772,67,42,109,61.5%,21m
22880,3,dartelaryon,2778,1183,58,41,99,58.6%,6m
22880,3,Shizamo,2778,226,43,31,74,58.1%,28m
22880,2,DuckLuck,2778,412,27,29,56,48.2%,4m
22880,3,[Worrmy]RuFrigerator,2778,282,23,17,40,57.5%,26m
22880,3,Minibboy,2778,382,15,8,23,65.2%,21m
22880,2,[NLTN]Aztecpears,2778,380,14,18,32,43.8%,39m
22880,3,[FWWAB]CFALCON,2778,236,8,3,11,72.7%,9m
22880,3,berryboy,2778,162,6,5,11,54.5%,23m
22880,3,AvrilLavigne,2778,90,6,5,11,54.5%,11m
22880,3,Spudbud,2778,120,5,5,10,50.0%,7m
22880,2,[WAAL]Masturbazn,2778,159,4,0,4,100.0%,48m
22880,3,Lalolink,2778,0,3,2,5,60.0%,18m
22880,2,Kohu,2778,0,3,4,7,42.9%,11m
22880,3,ScndAForever,2778,156,3,11,14,21.4%,36m
22880,3,PNP,2778,94,2,0,2,100.0%,14m
22880,3,PISSsmoker,2778,0,2,3,5,40.0%,24m
22880,3,Chuckkyy,2778,0,1,0,1,100.0%,33m
22880,3,IIIIIIIIIIII,2778,30,1,5,6,16.7%,35m
22880,2,[Crafty]Davaac,2778,30,1,7,8,12.5%,5m
22880,3,Nick,2778,0,0,1,1,0.0%,27m
22880,2,[TGosuA]Boots,2778,0,0,1,1,0.0%,2h
22880,3,YourmateMilo,2778,0,0,3,3,0.0%,4m
22880,3,DukeNukem,2778,0,0,5,5,0.0%,31m
22907,3,[qoou]Dean,2777,1602,111,110,221,50.2%,41m
22907,2,YapSoSolid,2777,936,84,79,163,51.5%,31m
22907,3,chong,2777,1579,71,64,135,52.6%,9m
22907,3,Aerodactyl,2777,888,69,57,126,54.8%,14m
22907,3,FiftyCal,2777,1378,63,53,116,54.3%,29m
22907,3,Edril,2777,847,59,54,113,52.2%,40m
22907,3,[ThEps]Demianosaur,2777,893,56,47,103,54.4%,42m
22907,3,Joe,2777,550,52,43,95,54.7%,26m
22907,3,SBX,2777,1253,50,48,98,51.0%,42m
22907,3,Kimitori,2777,751,42,9,51,82.4%,4m
22907,3,BenT,2777,904,39,32,71,54.9%,4m
22907,2,Baines,2777,484,29,33,62,46.8%,32m
22907,3,Amelin,2777,432,21,8,29,72.4%,25m
22907,3,Bobblehead,2777,542,21,14,35,60.0%,28m
22907,3,MotherRussia,2777,361,21,20,41,51.2%,25m
22907,3,MrChimmie,2777,339,16,6,22,72.7%,9m
22907,3,KostoF,2777,340,15,13,28,53.6%,42m
22907,3,Archina,2777,357,13,13,26,50.0%,29m
22907,3,Ether,2777,298,11,12,23,47.8%,28m
22907,3,FROSST,2777,177,8,6,14,57.1%,4m
22907,3,FredB,2777,182,7,8,15,46.7%,42m
22907,3,LTSmash,2777,202,6,2,8,75.0%,27m
22907,1,toopytants,2777,96,5,2,7,71.4%,33m
22907,3,[INextI]WackO,2777,108,5,8,13,38.5%,23m
22907,3,FXmarc,2777,121,4,4,8,50.0%,33m
22907,3,Colossus,2777,62,3,6,9,33.3%,32m
22907,1,pantsparty,2777,48,2,9,11,18.2%,35m
22907,1,[SCTR]OpaGandalf,2777,48,1,2,3,33.3%,3m
22907,3,MTRLRX,2777,30,1,3,4,25.0%,36m
22907,3,Banana,2777,0,0,1,1,0.0%,7m
22907,3,FelixTheCat,2777,0,0,1,1,0.0%,23m
22907,3,Borzinator,2777,0,0,1,1,0.0%,25m
22907,3,[JUGOS]tuto,2777,0,0,1,1,0.0%,7m
22907,2,Tiny,2777,0,0,2,2,0.0%,2h
22907,3,Panzer,2777,0,0,2,2,0.0%,6m
22942,3,[zort]PeaceMaker,2776,1506,94,90,184,51.1%,35m
22942,3,[B4RCD3]IIIIIIIIII,2776,1100,66,10,76,86.8%,16m
22942,2,sindiet,2776,676,43,35,78,55.1%,36m
22942,3,[PPR34]Deltax,2776,746,36,17,53,67.9%,40m
22942,3,Loser,2776,852,35,26,61,57.4%,21m
22942,2,ForTheSwarm,2776,595,29,35,64,45.3%,5m
22942,3,FeelgoodMD,2776,566,27,9,36,75.0%,15m
22942,3,Toonie,2776,634,25,25,50,50.0%,16m
22942,3,ThepaphuzZ,2776,372,24,8,32,75.0%,16m
22942,3,Alexis,2776,578,23,16,39,59.0%,31m
22942,3,Pop,2776,446,21,10,31,67.7%,40m
22942,2,BillClitton,2776,252,17,17,34,50.0%,34m
22942,3,SyNaps,2776,218,15,9,24,62.5%,8m
22942,3,IILUMINOTHII,2776,433,15,13,28,53.6%,25m
22942,3,marcula,2776,331,14,13,27,51.9%,41m
22942,3,Tauiris,2776,324,13,12,25,52.0%,24m
22942,3,Mematon,2776,292,9,9,18,50.0%,28m
22942,3,BigJohnson,2776,247,8,12,20,40.0%,43m
22942,3,[LgnTDS]yumRiCExP,2776,136,7,1,8,87.5%,17m
22942,3,KaiserND,2776,166,7,6,13,53.8%,42m
22942,3,FourSkeen,2776,198,6,5,11,54.5%,21m
22942,3,SAINT,2776,0,4,1,5,80.0%,29m
22942,3,[xARESx]GratSpike,2776,127,3,1,4,75.0%,18m
22942,3,Reminisce,2776,113,2,2,4,50.0%,22m
22942,3,TwinLlamas,2776,116,2,2,4,50.0%,33m
22942,3,Guyles,2776,60,2,3,5,40.0%,22m
22942,3,LarvaLing,2776,0,1,0,1,100.0%,43m
22942,3,leanml,2776,0,0,1,1,0.0%,35m
22970,3,[Lp]Lucho,2775,1564,157,126,283,55.5%,6m
22970,2,ComradeLeadR,2775,757,131,116,247,53.0%,8m
22970,1,[lDEATH]Nicotina,2775,1535,82,80,162,50.6%,20m
22970,1,[YALL]skate,2775,994,78,82,160,48.8%,19m
22970,3,XtwinX,2775,981,53,39,92,57.6%,23m
22970,3,WallFlamingo,2775,814,38,33,71,53.5%,4m
22970,3,[DBG]Dragosani,2775,803,36,28,64,56.2%,35m
22970,2,[vD2Dv]stolen,2775,232,21,24,45,46.7%,39m
22970,3,PapuGuapu,2775,270,16,13,29,55.2%,28m
22970,3,[DFDub]conkermaster,2775,368,14,12,26,53.8%,36m
22970,2,Gregor,2775,342,14,18,32,43.8%,42m
22970,2,Winddrop,2775,240,10,17,27,37.0%,31m
22970,3,Clear,2775,238,9,10,19,47.4%,7m
22970,3,Julius,2775,133,7,3,10,70.0%,23m
22970,3,fizzfizz,2775,144,5,8,13,38.5%,29m
22970,1,deathnight,2775,142,4,1,5,80.0%,33m
22970,1,GOSICK,2775,144,4,6,10,40.0%,2h
22970,3,Abahiah,2775,62,3,4,7,42.9%,14m
22970,3,[NBGuts]CodeNameV,2775,90,3,5,8,37.5%,42m
22970,3,kimjubo,2775,30,2,1,3,66.7%,19m
22970,3,Alastor,2775,0,2,3,5,40.0%,3m
22970,3,squarebush,2775,46,2,3,5,40.0%,36m
22970,3,Kitten,2775,0,1,0,1,100.0%,11m
22970,1,[Lepraa]JHOSS,2775,0,1,0,1,100.0%,26m
22970,3,MightyThundr,2775,30,1,3,4,25.0%,7m
22970,3,[TGCF]CrEEpYCLoWn,2775,0,0,1,1,0.0%,34m
22970,2,minispender,2775,0,0,1,1,0.0%,3h
22997,3,cholo,2774,1011,71,57,128,55.5%,29m
22997,3,Preemo,2774,544,31,24,55,56.4%,24m
22997,2,TLMhelux,2774,854,31,37,68,45.6%,32m
22997,3,[ØÛ]matiBTC,2774,641,29,23,52,55.8%,7m
22997,3,scraft,2774,271,24,15,39,61.5%,25m
22997,3,MilkBoyTeo,2774,564,23,22,45,51.1%,31m
22997,3,Jonnyquest,2774,230,8,10,18,44.4%,40m
22997,3,adricskoll,2774,199,6,4,10,60.0%,28m
22997,3,GreenMachine,2774,150,5,8,13,38.5%,34m
22997,3,FriendlyPunk,2774,136,4,0,4,100.0%,40m
22997,3,Kitana,2774,101,4,3,7,57.1%,24m
22997,2,dragontiger,2774,130,4,3,7,57.1%,57m
22997,1,Zooxanthella,2774,135,4,5,9,44.4%,18m
22997,3,Tardigrade,2774,140,3,2,5,60.0%,24m
22997,2,PSB,2774,96,3,3,6,50.0%,2h
22997,1,boomerfreak,2774,97,3,5,8,37.5%,24m
22997,3,Schmason,2774,62,3,6,9,33.3%,32m
22997,3,AlanarKo,2774,93,2,0,2,100.0%,18m
22997,2,[RaZerz]SteveSleaver,2774,96,2,3,5,40.0%,20m
22997,3,[TCProG]KyGuy,2774,0,1,0,1,100.0%,20m
22997,3,OuRenjie,2774,0,1,0,1,100.0%,7m
22997,3,Dinomyte,2774,30,1,5,6,16.7%,29m
22997,3,[CHAPU]JulinkG,2774,0,0,1,1,0.0%,1h
22997,3,[JRT]NsRoux,2774,0,0,1,1,0.0%,42m
23021,3,[BP8S]OzoPerezozo,2773,1543,268,269,537,49.9%,40m
23021,1,TeamRocket,2773,1212,95,98,193,49.2%,8m
23021,2,MagicTurtle,2773,1458,94,94,188,50.0%,43m
23021,3,RaithWrath,2773,685,71,58,129,55.0%,4m
23021,3,roshboy,2773,1570,65,64,129,50.4%,25m
23021,3,WuhanPeople,2773,925,46,31,77,59.7%,30m
23021,3,Calmdown,2773,892,32,52,84,38.1%,27m
23021,3,SilverKoffee,2773,388,27,24,51,52.9%,21m
23021,3,Seismic,2773,549,25,12,37,67.6%,42m
23021,3,Netslayer,2773,523,24,12,36,66.7%,24m
23021,2,Charbaken,2773,489,20,21,41,48.8%,39m
23021,2,[1PA]PWNerOfSouls,2773,508,19,23,42,45.2%,36m
23021,3,nerdwad,2773,306,18,8,26,69.2%,29m
23021,3,Brool,2773,352,18,20,38,47.4%,4m
23021,3,Kinetic,2773,352,15,15,30,50.0%,22m
23021,3,Jose,2773,358,14,8,22,63.6%,12m
23021,3,[Epokhé]Fachindor,2773,262,12,3,15,80.0%,29m
23021,3,Romehtom,2773,248,8,12,20,40.0%,11m
23021,2,Monty,2773,208,8,13,21,38.1%,21m
23021,2,llllllllllll,2773,169,7,7,14,50.0%,36m
23021,3,Ilusion,2773,178,6,2,8,75.0%,28m
23021,2,thongda,2773,60,6,5,11,54.5%,9m
23021,3,[vcool]Jokema,2773,145,5,5,10,50.0%,4m
23021,3,sxtycat,2773,148,5,8,13,38.5%,23m
23021,3,[EBAGmn]GrandBK,2773,121,4,6,10,40.0%,8m
23021,2,[HMLESS]TeddyBear,2773,0,3,2,5,60.0%,3h
23021,2,Wiverno,2773,0,3,2,5,60.0%,32m
23021,2,Dordido,2773,0,1,0,1,100.0%,14m
23021,3,ToastDragon,2773,0,1,0,1,100.0%,14m
23021,3,[VFam]Ziion,2773,95,1,1,2,50.0%,25m
23021,1,[ValidG]radio,2773,97,1,2,3,33.3%,31m
23021,3,[FALE]Phoenix,2773,30,1,4,5,20.0%,29m
23021,3,Lee,2773,0,1,4,5,20.0%,16m
23021,3,[HØST]hOREIA,2773,95,1,5,6,16.7%,26m
23021,3,[CTLJ]LiquidWater,2773,0,0,1,1,0.0%,22m
23056,3,elleTee,2772,1634,167,153,320,52.2%,42m
23056,3,Bump,2772,1557,97,101,198,49.0%,21m
23056,3,ProteusKel,2772,1209,58,51,109,53.2%,26m
23056,3,RedCart,2772,731,45,30,75,60.0%,23m
23056,3,gotenks,2772,968,44,32,76,57.9%,35m
23056,2,EdSHero,2772,941,38,34,72,52.8%,34m
23056,3,Illlllllllll,2772,736,37,29,66,56.1%,22m
23056,3,[WolfGT]abnerPF,2772,697,30,23,53,56.6%,28m
23056,2,Radiation,2772,652,20,35,55,36.4%,18m
23056,3,[C99964]Aurias,2772,520,19,16,35,54.3%,12m
23056,3,NachoZG,2772,310,14,6,20,70.0%,10m
23056,2,GuapDaddy,2772,338,11,21,32,34.4%,34m
23056,3,WarPanda,2772,304,10,3,13,76.9%,4m
23056,3,Gonzo,2772,255,8,9,17,47.1%,28m
23056,2,aceplaya,2772,212,8,12,20,40.0%,17m
23056,3,wimbley,2772,127,5,4,9,55.6%,11m
23056,2,[BAcrft]Matt,2772,141,4,4,8,50.0%,28m
23056,1,[NWOver]HellsWinter,2772,48,4,5,9,44.4%,55m
23056,3,[lnj3ct]PfizerBrood,2772,103,3,0,3,100.0%,17m
23056,3,[SD760]Flarer,2772,60,3,3,6,50.0%,28m
23056,3,tanksauce,2772,0,3,3,6,50.0%,13m
23056,3,[JRT]DrCacho,2772,0,1,0,1,100.0%,29m
23056,3,Leined,2772,0,1,1,2,50.0%,3m
23056,3,LemonCake,2772,93,1,1,2,50.0%,9m
23056,3,Engrenado,2772,30,1,2,3,33.3%,4m
23056,3,[SoVA]StimAddict,2772,0,1,4,5,20.0%,18m
23056,3,catukun,2772,0,0,1,1,0.0%,22m
23056,1,Yamakaki,2772,0,0,2,2,0.0%,2h
23084,2,[TY4GG]DukeY,2771,1510,162,150,312,51.9%,20m
23084,1,NuclearCore,2771,1244,95,98,193,49.2%,17m
23084,3,terminator,2771,894,40,29,69,58.0%,28m
23084,3,lowkei,2771,847,37,26,63,58.7%,39m
23084,3,[NYMZ]Kohaku,2771,871,36,29,65,55.4%,23m
23084,3,VonBergen,2771,779,34,32,66,51.5%,9m
23084,3,REDSILENCEX,2771,732,27,29,56,48.2%,17m
23084,2,[XTULAX]NowhereMan,2771,363,15,10,25,60.0%,3m
23084,2,lime,2771,448,15,21,36,41.7%,40m
23084,3,YouDoUBoo,2771,212,11,11,22,50.0%,21m
23084,3,wolajacy,2771,182,8,6,14,57.1%,29m
23084,3,Ratnik,2771,122,5,1,6,83.3%,2h
23084,1,Xill,2771,193,4,4,8,50.0%,54m
23084,3,SeDiva,2771,114,3,0,3,100.0%,28m
23084,3,cavalier,2771,114,3,1,4,75.0%,36m
23084,2,veryNiuBi,2771,0,3,2,5,60.0%,2h
23084,3,Design,2771,145,3,3,6,50.0%,12m
23084,3,Draven,2771,94,2,0,2,100.0%,28m
23084,1,RiceNinja,2771,96,2,2,4,50.0%,15m
23084,3,Xtra,2771,0,1,0,1,100.0%,32m
23084,2,MPowley,2771,30,1,4,5,20.0%,15m
23084,3,FunkyMonk,2771,87,1,5,6,16.7%,2h
23084,3,WaLao,2771,92,1,5,6,16.7%,18m
23084,3,ollamh,2771,0,0,1,1,0.0%,23m
23084,3,[ZCL]Anudex,2771,0,0,1,1,0.0%,41m
23084,3,[dreamG]lorienGA,2771,0,0,2,2,0.0%,14m
23110,3,MidnightXxX,2770,1571,191,166,357,53.5%,35m
23110,3,BreathOfLife,2770,1528,168,170,338,49.7%,9m
23110,3,Benjaimer,2770,1464,121,97,218,55.5%,42m
23110,3,Nate,2770,1440,98,76,174,56.3%,7m
23110,3,[AbcCo]JorgeReyy,2770,996,76,49,125,60.8%,18m
23110,2,Gomer,2770,661,76,78,154,49.4%,9m
23110,2,Kent,2770,1538,71,66,137,51.8%,34m
23110,3,KinkyKong,2770,812,42,31,73,57.5%,5m
23110,3,Coronachina,2770,881,36,28,64,56.2%,31m
23110,3,[WILFRE]Bub,2770,873,35,30,65,53.8%,7m
23110,3,NateDogg,2770,454,26,20,46,56.5%,40m
23110,2,[COYOTE]ZerGento,2770,706,26,27,53,49.1%,32m
23110,3,Crossette,2770,592,21,25,46,45.7%,8m
23110,3,[V1RGN]lionelllama,2770,495,20,11,31,64.5%,9m
23110,3,[TPGGXD]supermancito,2770,461,19,11,30,63.3%,12m
23110,3,Ringee,2770,393,18,5,23,78.3%,3m
23110,1,Attwell,2770,290,12,14,26,46.2%,1h
23110,3,NEWT,2770,258,8,7,15,53.3%,6m
23110,3,[FAAAAP]FUUUuuudge,2770,186,7,7,14,50.0%,17m
23110,3,[MSVC]javalol,2770,164,6,0,6,100.0%,8m
23110,3,[DubDom]EDub,2770,200,6,5,11,54.5%,9m
23110,3,[NextDC]BlindSword,2770,84,5,3,8,62.5%,58m
23110,3,kris,2770,178,5,3,8,62.5%,14m
23110,3,[ExcIgN]nandocv,2770,70,5,8,13,38.5%,22m
23110,3,[TaPX]EqUiLlIbRiUm,2770,0,4,1,5,80.0%,18m
23110,2,KENJI,2770,0,4,2,6,66.7%,5m
23110,1,Rylandorr,2770,122,4,3,7,57.1%,2h
23110,1,PizzaCat,2770,126,4,4,8,50.0%,8m
23110,3,TheGoldenKey,2770,80,4,5,9,44.4%,40m
23110,3,aXBoulanger,2770,0,3,2,5,60.0%,28m
23110,2,tbf,2770,114,3,3,6,50.0%,12m
23110,3,[MexTec]neogeo,2770,86,3,4,7,42.9%,16m
23110,3,Solarian,2770,96,1,1,2,50.0%,41m
23110,1,TANKnelson,2770,97,1,3,4,25.0%,2h
23110,2,[AD3C]KKiLL,2770,0,0,1,1,0.0%,25m
23110,2,[Squidy]NotThisTime,2770,0,0,1,1,0.0%,38m
23110,3,[QTclub]humblman,2770,0,0,3,3,0.0%,41m
23147,3,Pancake,2769,1557,204,191,395,51.6%,18m
23147,2,[RUMB]Marcus,2769,1451,145,130,275,52.7%,42m
23147,2,Ryu,2769,1502,71,63,134,53.0%,40m
23147,3,nazn,2769,889,37,31,68,54.4%,7m
23147,3,KingDaso,2769,994,35,36,71,49.3%,13m
23147,3,CreepnDeath,2769,689,27,25,52,51.9%,21m
23147,2,Bryan,2769,716,24,31,55,43.6%,40m
23147,3,ZéRinite,2769,435,18,10,28,64.3%,40m
23147,3,Lio,2769,391,17,14,31,54.8%,17m
23147,3,Eric,2769,356,15,14,29,51.7%,42m
23147,3,[LOOPY]BigSam,2769,320,12,10,22,54.5%,13m
23147,3,[SkAL]BeefPiston,2769,360,12,11,23,52.2%,40m
23147,3,LeeHarvey,2769,215,9,3,12,75.0%,29m
23147,3,[JUGOSH]brianxd,2769,206,8,9,17,47.1%,26m
23147,3,Rolls,2769,247,6,7,13,46.2%,9m
23147,3,Rapper,2769,168,5,3,8,62.5%,7m
23147,3,[Macac0]KillerViods,2769,140,5,9,14,35.7%,42m
23147,3,Kriss,2769,88,4,2,6,66.7%,11m
23147,3,qqn,2769,92,4,5,9,44.4%,6m
23147,2,HYPEHAM,2769,95,3,3,6,50.0%,3h
23147,3,LyghtForge,2769,94,2,0,2,100.0%,40m
23147,3,[NerdTC]lilKdoggie,2769,62,2,5,7,28.6%,25m
23147,3,Nemesis,2769,58,2,8,10,20.0%,16m
23147,3,[Rach]PoisonUrMom,2769,93,1,1,2,50.0%,25m
23147,1,KalxViper,2769,97,1,2,3,33.3%,2h
23147,3,[STG]ElTrujas,2769,0,0,1,1,0.0%,14m
23147,3,[BlTEL]Dio,2769,0,0,1,1,0.0%,3m
23147,2,[Colrs]Fluffy,2769,0,0,1,1,0.0%,2h
23147,3,wiggles,2769,0,0,2,2,0.0%,33m
23147,3,WalrusCow,2769,0,0,4,4,0.0%,40m
23177,2,DeadRabbits,2768,1571,297,293,590,50.3%,38m
23177,3,PlatypuS,2768,1288,165,138,303,54.5%,26m
23177,2,Tulkas,2768,1591,126,115,241,52.3%,36m
23177,1,FilthyPigDog,2768,720,62,66,128,48.4%,26m
23177,3,Tickle,2768,1320,51,47,98,52.0%,25m
23177,3,[TT]Typhoon,2768,1112,44,43,87,50.6%,26m
23177,3,SerguezNO,2768,653,31,19,50,62.0%,4m
23177,2,[iUm]LimitSEA,2768,362,17,19,36,47.2%,4m
23177,2,[xTQc]Katamundi,2768,372,15,17,32,46.9%,36m
23177,2,MagicHeart,2768,337,12,19,31,38.7%,6m
23177,3,Blader,2768,230,11,5,16,68.8%,28m
23177,3,itos,2768,156,7,12,19,36.8%,40m
23177,3,Satori,2768,112,5,6,11,45.5%,8m
23177,3,ghhggyvvdx,2768,154,4,2,6,66.7%,21m
23177,3,[THORK]Toe,2768,90,4,7,11,36.4%,12m
23177,2,[mtrays]new,2768,60,2,9,11,18.2%,10m
23177,3,Gladeous,2768,0,1,0,1,100.0%,20m
23177,3,Neezy,2768,30,1,2,3,33.3%,6m
23177,3,[6ixS]ChunkOfLove,2768,0,1,2,3,33.3%,43m
23177,3,[Whaaaa]Mathurin,2768,0,1,5,6,16.7%,29m
23177,2,KushBreakfst,2768,0,0,2,2,0.0%,33m
23198,3,SmolDumby,2767,560,87,73,160,54.4%,19m
23198,2,Mabrox,2767,1540,78,76,154,50.6%,32m
23198,3,[Saludo]BRAD,2767,1594,76,59,135,56.3%,17m
23198,3,MetalMonkey,2767,976,64,55,119,53.8%,23m
23198,3,PlzDntHurtMe,2767,817,53,35,88,60.2%,41m
23198,3,LoseImprove,2767,792,37,22,59,62.7%,24m
23198,3,rage,2767,583,28,13,41,68.3%,31m
23198,2,Voltron,2767,220,20,15,35,57.1%,32m
23198,3,Drix,2767,402,19,16,35,54.3%,36m
23198,2,ZeroLegacyZX,2767,457,18,19,37,48.6%,41m
23198,3,[VFam]YoungMawt,2767,399,15,13,28,53.6%,22m
23198,3,LeeManChild,2767,446,15,20,35,42.9%,31m
23198,2,[TERRI]Jahovarasta,2767,278,13,13,26,50.0%,12m
23198,3,Solorn,2767,248,11,3,14,78.6%,4m
23198,1,[DARKLP]MuffinTop,2767,223,10,12,22,45.5%,24m
23198,3,mauro,2767,148,8,7,15,53.3%,8m
23198,2,bilboswagins,2767,220,7,15,22,31.8%,34m
23198,1,Latale,2767,138,5,5,10,50.0%,1h
23198,2,SirSpiffy,2767,141,4,4,8,50.0%,25m
23198,3,AnthonyPo,2767,82,4,5,9,44.4%,28m
23198,3,IsBenji,2767,0,3,2,5,60.0%,22m
23198,2,WarriorZero,2767,0,3,2,5,60.0%,10m
23198,1,xmikiesx,2767,96,2,1,3,66.7%,54m
23198,3,yourleftball,2767,30,2,3,5,40.0%,43m
23198,3,Drumkillz,2767,0,2,4,6,33.3%,8m
23198,3,blood,2767,0,1,0,1,100.0%,30m
23198,3,[YngKng]EarthKing,2767,30,1,2,3,33.3%,4m
23198,3,Dokdo,2767,0,1,4,5,20.0%,9m
23198,3,Bibleman,2767,0,0,2,2,0.0%,25m
23227,2,[LQV]lor,2766,1539,206,198,404,51.0%,6m
23227,3,[STUART]DJKg,2766,1538,185,173,358,51.7%,19m
23227,3,Ares,2766,1538,119,104,223,53.4%,43m
23227,2,Johan,2766,968,46,33,79,58.2%,9m
23227,2,GINECOMASTER,2766,511,46,51,97,47.4%,5m
23227,3,SiLVeRBaCk,2766,677,26,29,55,47.3%,18m
23227,3,[PTHero]HyperTurtle,2766,550,23,14,37,62.2%,31m
23227,2,ArchAngel,2766,618,21,28,49,42.9%,3m
23227,3,Herculiano,2766,538,20,19,39,51.3%,12m
23227,3,[RushA]SuperKingdom,2766,450,19,12,31,61.3%,29m
23227,3,Tooters,2766,354,13,16,29,44.8%,37m
23227,2,BBQ,2766,298,12,13,25,48.0%,33m
23227,3,sayhi,2766,107,11,2,13,84.6%,9m
23227,3,[OCTA]Phoenix,2766,268,11,4,15,73.3%,28m
23227,3,MajorlyGamin,2766,256,9,13,22,40.9%,15m
23227,3,chedca,2766,208,8,10,18,44.4%,7m
23227,3,[PKMSSS]SUNHEE,2766,93,7,3,10,70.0%,34m
23227,1,XxDago,2766,167,7,5,12,58.3%,2h
23227,3,[aIMIa]Cebuano,2766,194,7,8,15,46.7%,18m
23227,3,Cyno,2766,184,6,1,7,85.7%,2h
23227,3,SynaX,2766,30,5,3,8,62.5%,33m
23227,3,[IMDSI]nachobros,2766,183,5,3,8,62.5%,30m
23227,3,Shine,2766,122,5,4,9,55.6%,40m
23227,1,Patrick,2766,119,5,6,11,45.5%,29m
23227,3,Sanity,2766,132,4,1,5,80.0%,39m
23227,3,[No0Bs]Championite,2766,0,4,2,6,66.7%,14m
23227,3,Couse,2766,160,4,3,7,57.1%,31m
23227,3,barcode,2766,160,4,3,7,57.1%,41m
23227,2,SparkleFart,2766,44,4,3,7,57.1%,2h
23227,1,Franko,2766,0,1,2,3,33.3%,2h
23227,1,Mosckvin,2766,0,0,1,1,0.0%,48m
23227,3,eeboxer,2766,0,0,1,1,0.0%,40m
23227,1,JSX,2766,0,0,2,2,0.0%,2h
23227,3,tko,2766,0,0,3,3,0.0%,31m
23261,3,zergator,2765,678,158,148,306,51.6%,34m
23261,3,[PobSC]SakuyaKnives,2765,1589,76,57,133,57.1%,43m
23261,3,Radiotrench,2765,795,65,51,116,56.0%,39m
23261,3,Schlumkatze,2765,436,60,60,120,50.0%,12m
23261,3,OptimusRhyme,2765,1259,57,52,109,52.3%,34m
23261,2,ShadowStorm,2765,1070,44,47,91,48.4%,36m
23261,3,Chhou,2765,546,37,19,56,66.1%,10m
23261,3,Altayas,2765,666,34,9,43,79.1%,43m
23261,3,Qoo,2765,418,20,9,29,69.0%,35m
23261,2,Gabba,2765,334,12,14,26,46.2%,17m
23261,3,NihilDaste,2765,253,10,5,15,66.7%,29m
23261,3,roronoazorro,2765,240,9,6,15,60.0%,32m
23261,3,[VDZT]AmoSupremo,2765,253,9,13,22,40.9%,29m
23261,2,Skobe,2765,218,8,1,9,88.9%,26m
23261,3,[SKSR]FukdUpBack,2765,232,7,8,15,46.7%,33m
23261,3,[ÆON]DarkRost,2765,144,6,5,11,54.5%,42m
23261,3,[SORSC]CooLpeepito,2765,213,6,6,12,50.0%,4m
23261,1,Coinflip,2765,215,5,3,8,62.5%,2h
23261,3,Xero,2765,0,4,2,6,66.7%,12m
23261,2,[PO0]PoOcH,2765,0,4,2,6,66.7%,2h
23261,2,Surian,2765,88,4,4,8,50.0%,3m
23261,3,Brightside,2765,179,4,9,13,30.8%,42m
23261,3,Lantoka,2765,135,3,2,5,60.0%,26m
23261,3,frnkjr,2765,0,3,2,5,60.0%,23m
23261,2,Derek,2765,0,3,3,6,50.0%,2h
23261,3,JKPW,2765,95,2,0,2,100.0%,39m
23261,3,doingurmom,2765,94,2,0,2,100.0%,40m
23261,3,MatuNv,2765,83,2,0,2,100.0%,11m
23261,3,[SCX2]Rooncardo,2765,58,2,3,5,40.0%,34m
23261,3,sNaiL,2765,0,2,3,5,40.0%,31m
23261,3,Roche,2765,0,1,0,1,100.0%,12m
23261,3,[FACKER]truffles,2765,30,1,4,5,20.0%,21m
23261,3,HanSolo,2765,0,0,1,1,0.0%,13m
23261,3,[PUCP]Snow,2765,0,0,1,1,0.0%,22m
23261,2,[BWSC]Guerrilla,2765,0,0,1,1,0.0%,3h
23261,3,IsaacsPERU,2765,0,0,1,1,0.0%,28m
23261,2,[Watame]ReinerBraun,2765,0,0,1,1,0.0%,2h
23261,3,Ankhor,2765,0,0,3,3,0.0%,19m
23299,3,JYoung,2764,1478,155,144,299,51.8%,22m
23299,2,pfemano,2764,1606,113,119,232,48.7%,18m
23299,3,Zeigfreid,2764,1463,74,72,146,50.7%,41m
23299,3,[nieBla]DarkioN,2764,1123,72,56,128,56.2%,42m
23299,3,RemSpanish,2764,1120,50,42,92,54.3%,12m
23299,3,Donzer,2764,795,37,24,61,60.7%,4m
23299,3,Galaxy,2764,863,35,30,65,53.8%,9m
23299,3,WoodenSpoon,2764,643,29,24,53,54.7%,30m
23299,3,[GoldPo]TheCold,2764,501,21,18,39,53.8%,29m
23299,2,[Nitmar]FishCrab,2764,224,20,20,40,50.0%,40m
23299,3,XenoKai,2764,411,16,12,28,57.1%,4m
23299,3,Albi,2764,349,15,12,27,55.6%,7m
23299,3,Rio,2764,292,12,12,24,50.0%,13m
23299,3,IMPERIO,2764,248,10,4,14,71.4%,7m
23299,3,Turbulent,2764,276,10,4,14,71.4%,3h
23299,2,frank,2764,212,10,8,18,55.6%,25m
23299,3,MoodyBrizo,2764,226,9,10,19,47.4%,6m
23299,3,Nutwagon,2764,150,8,3,11,72.7%,21m
23299,3,badatzerg,2764,217,7,6,13,53.8%,13m
23299,3,Sophistar,2764,190,6,10,16,37.5%,18m
23299,3,scv,2764,145,5,8,13,38.5%,1h
23299,1,Eugenie,2764,144,4,4,8,50.0%,49m
23299,2,Cameron,2764,48,3,4,7,42.9%,3h
23299,3,Knoxville,2764,92,2,0,2,100.0%,7m
23299,3,[Lp]ElNoob,2764,93,2,0,2,100.0%,29m
23299,2,mcxlee,2764,48,2,1,3,66.7%,2h
23299,3,[Ssip]YUuKi,2764,0,2,3,5,40.0%,22m
23299,3,xAtUk,2764,30,2,4,6,33.3%,25m
23299,1,Rosson,2764,0,2,5,7,28.6%,2h
23299,3,Kraken,2764,60,2,5,7,28.6%,28m
23299,3,Noetherian,2764,0,1,1,2,50.0%,15m
23299,3,[Trlvla]ULayYeMyat,2764,0,1,1,2,50.0%,39m
23299,3,[ABSLT]Vira,2764,30,1,3,4,25.0%,11m
23299,2,[Macac0]Malthael,2764,88,1,7,8,12.5%,33m
23299,3,Kyouki,2764,0,0,1,1,0.0%,12m
23299,3,IAmAScone,2764,0,0,1,1,0.0%,17m
23299,3,[TGosuD]Warchief,2764,0,0,2,2,0.0%,9m
23336,3,Dektol,2763,914,183,171,354,51.7%,31m
23336,3,Quinte,2763,1576,125,112,237,52.7%,28m
23336,3,creyesk,2763,703,40,28,68,58.8%,21m
23336,3,DKingLinch,2763,573,36,22,58,62.1%,22m
23336,2,Nept,2763,756,33,36,69,47.8%,43m
23336,3,noobynewbs,2763,404,32,26,58,55.2%,12m
23336,3,[LQV]IlIlIlIlIl,2763,693,28,16,44,63.6%,13m
23336,2,DVD,2763,351,26,21,47,55.3%,33m
23336,3,BlazeAngel,2763,421,17,15,32,53.1%,11m
23336,3,[40oztF]Viciousblow,2763,406,15,16,31,48.4%,20m
23336,3,BARCODE,2763,268,12,7,19,63.2%,34m
23336,3,Euber,2763,312,11,10,21,52.4%,34m
23336,2,SpaceCaesar,2763,120,11,15,26,42.3%,5m
23336,1,LupiLupa,2763,188,7,7,14,50.0%,18m
23336,3,[cl0udM]Hellfire,2763,200,6,3,9,66.7%,25m
23336,3,NehoyMinoy,2763,194,6,4,10,60.0%,40m
23336,3,xSpanki,2763,93,5,1,6,83.3%,21m
23336,3,iloveketamin,2763,58,3,6,9,33.3%,28m
23336,3,RookTheWhite,2763,94,2,1,3,66.7%,32m
23336,3,aleksey,2763,58,2,3,5,40.0%,25m
23336,3,[Antss]Zawaz,2763,113,2,3,5,40.0%,5m
23336,3,Captagear,2763,0,2,3,5,40.0%,18m
23336,3,IIIIIIIIIII,2763,32,2,4,6,33.3%,40m
23336,1,[XpKAc]DragonKnight,2763,0,1,0,1,100.0%,2h
23336,3,Kharnage,2763,0,0,1,1,0.0%,3m
23361,3,[4aRaza]Koagulo,2762,1590,208,174,382,54.5%,12m
23361,3,SomeLink,2762,957,43,36,79,54.4%,11m
23361,3,XIAOHU,2762,489,32,23,55,58.2%,15m
23361,3,SoftwareMonk,2762,568,30,18,48,62.5%,34m
23361,3,Chirp,2762,443,18,15,33,54.5%,43m
23361,3,Zergon,2762,400,16,12,28,57.1%,24m
23361,3,[LOLITO]Lumpitaz,2762,313,14,14,28,50.0%,20m
23361,3,Raymon,2762,346,13,9,22,59.1%,13m
23361,3,[SP1622]SuperPenguin,2762,370,13,10,23,56.5%,8m
23361,3,FluffyRSA,2762,284,11,3,14,78.6%,12m
23361,2,AssyMcgee,2762,257,10,13,23,43.5%,2h
23361,3,Stilgar,2762,252,9,10,19,47.4%,18m
23361,3,Cesra,2762,123,6,10,16,37.5%,46m
23361,3,SauceSage,2762,174,5,1,6,83.3%,16m
23361,1,StarRaft,2762,96,5,7,12,41.7%,59m
23361,2,reefes,2762,142,5,14,19,26.3%,33m
23361,3,Nogards,2762,152,4,1,5,80.0%,21m
23361,1,[ELNENE]Furan,2762,145,4,4,8,50.0%,3h
23361,2,JilkerWow,2762,136,4,4,8,50.0%,2h
23361,3,[4Glory]SvnDeadlySnz,2762,58,3,4,7,42.9%,25m
23361,3,Feyd,2762,121,2,1,3,66.7%,6m
23361,3,[MGC]Hank,2762,93,2,2,4,50.0%,13m
23361,2,[NOLAN]Dlo,2762,0,2,3,5,40.0%,2h
23361,2,Kiuren,2762,0,2,3,5,40.0%,2h
23361,3,[AbcCo]ELWACHIN,2762,0,1,0,1,100.0%,19m
23361,3,Bonescar,2762,30,1,3,4,25.0%,43m
23361,3,[uhZ]Frenzylishus,2762,0,0,1,1,0.0%,18m
23361,3,GOLDENEAGLE,2762,0,0,2,2,0.0%,38m
23361,3,[SANGRE]Orue,2762,0,0,3,3,0.0%,22m
23390,3,Kaladin,2761,1495,80,56,136,58.8%,24m
23390,3,Nas,2761,1170,53,48,101,52.5%,39m
23390,3,BurntheWitch,2761,782,52,31,83,62.7%,20m
23390,3,Heero,2761,978,42,36,78,53.8%,31m
23390,2,Qrou,2761,482,32,32,64,50.0%,40m
23390,3,Zswazzy,2761,826,32,34,66,48.5%,12m
23390,3,Speedart,2761,384,17,14,31,54.8%,24m
23390,1,contramundi,2761,340,15,15,30,50.0%,40m
23390,3,peruvian,2761,324,13,9,22,59.1%,12m
23390,3,[NCC170]noBiscuit,2761,300,11,6,17,64.7%,4m
23390,3,Gianca,2761,221,9,3,12,75.0%,31m
23390,3,Topher,2761,191,7,9,16,43.8%,9m
23390,2,Symphony,2761,254,7,17,24,29.2%,42m
23390,3,Walseop,2761,151,6,5,11,54.5%,29m
23390,3,InkSplat,2761,203,6,6,12,50.0%,29m
23390,1,[aIien]Enevitable,2761,192,6,7,13,46.2%,2h
23390,3,NoScope,2761,30,5,3,8,62.5%,12m
23390,1,Simmons,2761,167,5,5,10,50.0%,19m
23390,3,ArqLeO,2761,152,4,2,6,66.7%,18m
23390,2,Befall,2761,46,4,3,7,57.1%,2h
23390,1,[TScrub]rolyat,2761,97,4,4,8,50.0%,2h
23390,3,[BSAA1]NeostormX,2761,92,4,5,9,44.4%,25m
23390,3,[XDRAX8]crist,2761,88,4,6,10,40.0%,10m
23390,3,Mygraine,2761,114,3,1,4,75.0%,8m
23390,3,Orami,2761,94,2,0,2,100.0%,27m
23390,3,soN,2761,121,2,3,5,40.0%,8m
23390,2,[TBPC]Bacchus,2761,60,2,9,11,18.2%,9m
23390,3,[Pls]Feanor,2761,0,1,0,1,100.0%,8m
23390,2,Krush,2761,0,1,0,1,100.0%,14m
23390,3,Acheron,2761,0,1,0,1,100.0%,14m
23390,3,[O6ama]DanSiri,2761,0,1,1,2,50.0%,28m
23390,3,Skalar,2761,0,0,1,1,0.0%,15m
23422,2,Barin,2760,1491,86,78,164,52.4%,27m
23422,3,Alexsomer,2760,1575,78,75,153,51.0%,39m
23422,2,Assypod,2760,1151,72,66,138,52.2%,38m
23422,2,Austor,2760,385,66,59,125,52.8%,43m
23422,3,KiraLA,2760,661,62,50,112,55.4%,10m
23422,3,[LOHd]ITFANS,2760,1016,51,29,80,63.8%,39m
23422,3,DeutschMark,2760,1041,48,34,82,58.5%,13m
23422,3,[Wizerd]Jafar,2760,754,34,27,61,55.7%,17m
23422,3,LtSaitO,2760,666,29,20,49,59.2%,8m
23422,3,Hank,2760,632,26,20,46,56.5%,36m
23422,2,jlo,2760,772,26,34,60,43.3%,32m
23422,3,[LoZOoT]new,2760,458,20,15,35,57.1%,6m
23422,1,wiblyspceman,2760,478,19,18,37,51.4%,3h
23422,3,Durian,2760,384,16,13,29,55.2%,29m
23422,1,SJBOnlyShoe,2760,411,15,14,29,51.7%,38m
23422,3,Rysofly,2760,300,10,8,18,55.6%,17m
23422,3,TheWizard,2760,192,7,2,9,77.8%,33m
23422,2,Vyrthala,2760,200,6,5,11,54.5%,32m
23422,3,SuKuShaing,2760,172,6,6,12,50.0%,27m
23422,1,LavaHorse,2760,96,5,6,11,45.5%,2h
23422,3,[Pig2]Snelly,2760,193,5,6,11,45.5%,40m
23422,1,Shilvahfang,2760,158,5,7,12,41.7%,19m
23422,3,Sev,2760,134,4,1,5,80.0%,4m
23422,3,Enrique,2760,86,4,4,8,50.0%,24m
23422,2,AlphaWolf,2760,0,3,2,5,60.0%,2h
23422,1,Rexx,2760,94,3,3,6,50.0%,37m
23422,3,[RTQC]shadowthron,2760,92,3,3,6,50.0%,31m
23422,3,Noolzis,2760,144,3,4,7,42.9%,33m
23422,1,kuhntucker,2760,88,2,0,2,100.0%,57m
23422,2,PUN,2760,0,2,3,5,40.0%,44m
23422,3,ratz,2760,123,2,4,6,33.3%,36m
23422,3,Xavi,2760,0,1,0,1,100.0%,4m
23422,3,Ghost,2760,0,1,1,2,50.0%,13m
23422,1,HomeDepot,2760,0,1,2,3,33.3%,2h
23422,2,bagofsalt,2760,0,0,1,1,0.0%,3h
23457,1,LazzyApe,2759,1577,247,245,492,50.2%,7m
23457,3,[WarAnt]MDoulos,2759,1266,90,76,166,54.2%,10m
23457,3,optimuschwdr,2759,1117,45,45,90,50.0%,7m
23457,2,[NOBDGR]QBLA,2759,1020,45,48,93,48.4%,28m
23457,3,Squirrelioz,2759,647,27,25,52,51.9%,4m
23457,3,Tisdog,2759,595,26,26,52,50.0%,21m
23457,1,Ilzalid,2759,542,20,17,37,54.1%,21m
23457,2,Vic,2759,168,7,4,11,63.6%,7m
23457,3,[NOSTV]Marcman,2759,245,7,8,15,46.7%,15m
23457,2,[CHGGS]WillyThePimp,2759,149,6,6,12,50.0%,26m
23457,3,Zealot,2759,118,5,6,11,45.5%,24m
23457,2,oreo,2759,70,4,5,9,44.4%,11m
23457,2,Jared,2759,0,3,2,5,60.0%,25m
23457,2,Eskate,2759,90,3,13,16,18.8%,27m
23457,3,Rawksarz,2759,30,2,2,4,50.0%,28m
23457,2,[EGx]Butterdarck,2759,62,2,12,14,14.3%,42m
23457,3,yehosua,2759,0,1,5,6,16.7%,6m
23457,1,KINGofF,2759,0,0,1,1,0.0%,3h
23457,2,[HIBOYZ]Pueo,2759,0,0,1,1,0.0%,44m
23457,3,[R0tA]Willybeast,2759,0,0,2,2,0.0%,33m
23477,2,[MNDC]Chobal,2758,1495,119,115,234,50.9%,3m
23477,2,Flash,2758,1247,78,76,154,50.6%,39m
23477,1,[DCDC]JohnnyRehab,2758,979,61,70,131,46.6%,32m
23477,3,Mudge,2758,897,42,33,75,56.0%,3m
23477,3,[nieBla]ELJAJAS,2758,1001,42,37,79,53.2%,28m
23477,3,NewMetaOrder,2758,419,39,36,75,52.0%,41m
23477,3,DroneGoBrr,2758,537,23,12,35,65.7%,22m
23477,2,TerryCrews,2758,397,19,21,40,47.5%,43m
23477,3,[WHYYYY]WEEBRIOSIS,2758,250,11,2,13,84.6%,41m
23477,3,Deymar,2758,235,9,4,13,69.2%,7m
23477,2,Centaurus,2758,274,9,18,27,33.3%,32m
23477,1,Barbut,2758,282,8,8,16,50.0%,3h
23477,3,illmatic,2758,220,8,9,17,47.1%,55m
23477,2,UtgardLoki,2758,168,8,9,17,47.1%,36m
23477,1,Manimal,2758,193,4,5,9,44.4%,40m
23477,1,ChKOW,2758,116,3,1,4,75.0%,32m
23477,1,Kree,2758,132,3,4,7,42.9%,17m
23477,3,[JUGOS]sahid,2758,30,1,3,4,25.0%,32m
23477,3,[5Svrt]BoilerUp,2758,30,1,5,6,16.7%,17m
23477,1,Vudoo,2758,0,0,1,1,0.0%,31m
23477,2,Crucio,2758,0,0,1,1,0.0%,1h
23477,3,[KU]RockKnight,2758,0,0,2,2,0.0%,12m
23499,2,Pigdestroyer,2757,1305,169,160,329,51.4%,35m
23499,2,Trilaksana,2757,1464,57,66,123,46.3%,26m
23499,3,[BoAVN]Tuan,2757,488,51,37,88,58.0%,25m
23499,2,Mavekashi,2757,743,51,49,100,51.0%,41m
23499,2,[0825]Shadow,2757,1162,46,48,94,48.9%,28m
23499,2,Sef,2757,647,43,39,82,52.4%,39m
23499,3,[R33D]INVENCIBLE,2757,935,42,32,74,56.8%,13m
23499,2,[Exper]llllllllll,2757,508,39,38,77,50.6%,17m
23499,3,Cyro,2757,777,36,26,62,58.1%,40m
23499,3,Heinsenzerg,2757,772,33,28,61,54.1%,4m
23499,3,Solar,2757,709,27,30,57,47.4%,13m
23499,2,LudachrisVT,2757,537,21,25,46,45.7%,39m
23499,3,ShadowHunter,2757,420,18,10,28,64.3%,22m
23499,2,hacklink,2757,323,12,18,30,40.0%,24m
23499,2,swurm,2757,294,11,12,23,47.8%,2h
23499,3,Polarity,2757,247,9,6,15,60.0%,7m
23499,3,xfire,2757,258,9,13,22,40.9%,29m
23499,3,Anguskhan,2757,206,7,9,16,43.8%,20m
23499,2,Arckus,2757,182,7,17,24,29.2%,32m
23499,1,[UofC]Maladroit,2757,188,6,1,7,85.7%,43m
23499,3,blueshirts,2757,146,6,6,12,50.0%,6m
23499,3,ZebraHoedown,2757,174,6,7,13,46.2%,34m
23499,1,Smurf,2757,144,6,8,14,42.9%,18m
23499,2,Resol,2757,122,6,9,15,40.0%,21m
23499,2,leCube,2757,160,5,4,9,55.6%,3h
23499,1,Nephira,2757,158,4,1,5,80.0%,57m
23499,3,Rmao,2757,144,4,3,7,57.1%,17m
23499,3,serenitynow,2757,88,4,7,11,36.4%,29m
23499,2,abril,2757,98,4,10,14,28.6%,33m
23499,3,[nieBla]ZERUEL,2757,30,3,5,8,37.5%,41m
23499,3,captainG,2757,30,2,1,3,66.7%,20m
23499,3,AKA,2757,97,1,1,2,50.0%,36m
23499,1,[Gigga]Hornyak,2757,42,1,1,2,50.0%,50m
23499,3,wilddragons,2757,0,1,1,2,50.0%,22m
23499,1,[CLOWNF]FreeArtsakh,2757,0,0,1,1,0.0%,53m
23499,3,churchillwin,2757,0,0,2,2,0.0%,34m
23535,2,extrapills,2756,1472,283,259,542,52.2%,19m
23535,2,HumbiliT,2756,1500,216,205,421,51.3%,11m
23535,2,zeralk,2756,1294,121,113,234,51.7%,41m
23535,1,eigenvec,2756,1437,64,52,116,55.2%,43m
23535,3,SinfulBread,2756,317,58,41,99,58.6%,12m
23535,2,[AD3C]Anarchy,2756,694,44,37,81,54.3%,8m
23535,3,BinLaden,2756,411,15,11,26,57.7%,30m
23535,3,[mCtrl]PassingGas,2756,373,13,13,26,50.0%,40m
23535,1,Loveman,2756,442,13,15,28,46.4%,2h
23535,3,mariano,2756,312,10,10,20,50.0%,3m
23535,1,BonkDoon,2756,205,8,9,17,47.1%,3h
23535,3,GLHF,2756,232,8,13,21,38.1%,12m
23535,1,[BucBim]Qwerty,2756,190,6,0,6,100.0%,2h
23535,3,ProtoType,2756,187,6,5,11,54.5%,31m
23535,1,Whatever,2756,184,6,5,11,54.5%,2h
23535,1,HunteR,2756,144,5,5,10,50.0%,28m
23535,1,Kenion,2756,0,3,2,5,60.0%,59m
23535,3,[AnimaS]StarkeRath,2756,90,3,5,8,37.5%,25m
23535,3,[1vsM]Prometheus,2756,146,3,6,9,33.3%,46m
23535,3,[SVWs]TeRRaNMeX,2756,94,3,9,12,25.0%,13m
23535,3,[RuS98]UberNOobster,2756,0,1,1,2,50.0%,8m
23535,3,[Year1]SheriffSethy,2756,0,1,2,3,33.3%,25m
23535,3,Sblancotx,2756,30,1,4,5,20.0%,4m
23558,2,Ghost,2755,838,98,95,193,50.8%,17m
23558,3,wratht,2755,1473,93,91,184,50.5%,24m
23558,2,Korfuffle,2755,1334,52,55,107,48.6%,9m
23558,2,Mike,2755,107,44,45,89,49.4%,33m
23558,2,FatMachine,2755,724,26,32,58,44.8%,37m
23558,3,Makta,2755,563,24,16,40,60.0%,34m
23558,1,olmustache,2755,337,12,9,21,57.1%,36m
23558,3,SneakySylvie,2755,256,10,8,18,55.6%,3h
23558,3,Lildilberri,2755,241,8,8,16,50.0%,41m
23558,1,panda,2755,165,4,0,4,100.0%,11m
23558,3,Pieaces,2755,0,4,6,10,40.0%,1h
23558,3,Savage,2755,139,3,3,6,50.0%,29m
23558,3,Braxus,2755,88,3,5,8,37.5%,15m
23558,2,[MLPog]TastyBacon,2755,156,3,15,18,16.7%,33m
23558,2,Bingo,2755,0,2,3,5,40.0%,2h
23558,1,SpeedySonic,2755,0,2,3,5,40.0%,57m
23558,3,Edo,2755,60,2,4,6,33.3%,7m
23558,1,VkS,2755,0,0,1,1,0.0%,19m
23558,1,BoxCrab,2755,0,0,1,1,0.0%,2h
23558,3,[CMVP]Tunkon,2755,0,0,2,2,0.0%,40m
23578,2,Zheen,2754,1513,176,157,333,52.9%,40m
23578,2,Luddite,2754,1346,132,127,259,51.0%,9m
23578,3,Anihortes,2754,1560,88,69,157,56.1%,33m
23578,3,AZergTY,2754,1510,69,51,120,57.5%,35m
23578,2,Slug,2754,901,57,53,110,51.8%,26m
23578,3,FoolishDogs,2754,1030,51,51,102,50.0%,17m
23578,3,[bader]mac,2754,868,30,33,63,47.6%,7m
23578,1,[XpKb]Rterrakion,2754,651,23,12,35,65.7%,2h
23578,1,iony,2754,542,18,13,31,58.1%,2h
23578,3,[RAINBO]Touchoflove,2754,300,15,13,28,53.6%,3m
23578,2,[WarCom]Yarev,2754,424,15,19,34,44.1%,40m
23578,2,toofattotype,2754,406,14,19,33,42.4%,4m
23578,3,BLHero,2754,313,13,16,29,44.8%,22m
23578,3,[JUGOS]Gauchitogil,2754,202,12,11,23,52.2%,28m
23578,1,Qtleily,2754,304,12,15,27,44.4%,11m
23578,3,[PHUK]Cole,2754,254,11,10,21,52.4%,33m
23578,3,Remorseless,2754,226,9,9,18,50.0%,21m
23578,3,Sasha,2754,266,8,8,16,50.0%,14m
23578,3,Cackwell,2754,194,8,10,18,44.4%,19m
23578,3,Npc,2754,114,5,5,10,50.0%,22m
23578,2,Spammed,2754,117,4,3,7,57.1%,3h
23578,1,Pyruvat,2754,212,4,6,10,40.0%,2h
23578,2,[ATEA]GayAngel,2754,0,3,2,5,60.0%,3h
23578,1,Snocone,2754,114,3,2,5,60.0%,2h
23578,1,Broman,2754,169,3,4,7,42.9%,1h
23578,3,SWallace,2754,120,2,3,5,40.0%,29m
23578,2,succme,2754,0,2,4,6,33.3%,16m
23578,3,Dragon,2754,6,2,5,7,28.6%,4m
23578,1,GarouxZx,2754,0,1,0,1,100.0%,2h
23607,2,Devastador,2753,1567,209,191,400,52.2%,17m
23607,2,Thelerk,2753,1511,155,135,290,53.4%,17m
23607,3,OneKickTenKX,2753,696,87,79,166,52.4%,34m
23607,3,slappy,2753,864,44,33,77,57.1%,25m
23607,3,[zeez]Carnivorous,2753,975,36,38,74,48.6%,35m
23607,3,FLOPPA,2753,386,31,20,51,60.8%,31m
23607,2,dvdseller,2753,427,28,32,60,46.7%,41m
23607,3,ReadyDewy,2753,684,26,25,51,51.0%,37m
23607,3,Sildenafil,2753,591,22,19,41,53.7%,25m
23607,1,bluenoodle,2753,592,20,18,38,52.6%,15m
23607,3,MasterCraked,2753,529,19,19,38,50.0%,34m
23607,3,[SELFY]Akirakai,2753,323,13,4,17,76.5%,41m
23607,3,[NOLA1]RockyRacoon,2753,278,12,5,17,70.6%,23m
23607,3,[waRp1]DMPlay,2753,260,11,10,21,52.4%,29m
23607,3,Sarimas,2753,187,10,7,17,58.8%,21m
23607,3,[MmtMri]Sugarsmasher,2753,271,9,12,21,42.9%,41m
23607,1,incog,2753,70,9,16,25,36.0%,15m
23607,1,jqn,2753,301,8,7,15,53.3%,43m
23607,3,[FREECO]gallonsmash,2753,214,7,8,15,46.7%,8m
23607,1,DjBoBo,2753,222,6,4,10,60.0%,25m
23607,3,Isaku,2753,113,5,4,9,55.6%,32m
23607,3,[ENGMG]Jaffarz,2753,118,5,5,10,50.0%,25m
23607,3,GiaCátLuong,2753,170,4,4,8,50.0%,40m
23607,2,Eric,2753,141,3,2,5,60.0%,17m
23607,3,[CRAKS]Locuszx,2753,58,3,3,6,50.0%,29m
23607,3,AgentSmith,2753,60,3,3,6,50.0%,20m
23607,1,Vilsmay,2753,0,2,3,5,40.0%,2h
23607,3,gggggggggggg,2753,122,2,5,7,28.6%,9m
23607,1,MrSpine,2753,0,0,1,1,0.0%,36m
23607,1,VoidSeeker,2753,0,0,2,2,0.0%,1h
23607,3,[BlTEL]Dasani,2753,0,0,3,3,0.0%,43m
23638,1,[NineT3]Novae,2752,1413,114,118,232,49.1%,34m
23638,2,Embarko,2752,1525,89,93,182,48.9%,6m
23638,1,Aborym,2752,712,40,4,44,90.9%,2h
23638,2,[THBG]FunnyLoo,2752,754,34,33,67,50.7%,14m
23638,3,Crafty,2752,606,27,16,43,62.8%,8m
23638,3,[EpicG]Fantom,2752,608,26,27,53,49.1%,8m
23638,2,[PTHero]Lucid,2752,524,22,23,45,48.9%,20m
23638,3,COMIC,2752,86,11,8,19,57.9%,2h
23638,1,Spud,2752,190,9,3,12,75.0%,3h
23638,1,Spectre,2752,40,6,5,11,54.5%,3m
23638,1,Feroxiraptor,2752,48,4,5,9,44.4%,58m
23638,1,Aries,2752,94,3,0,3,100.0%,2h
23638,2,llllllllllll,2752,88,3,3,6,50.0%,52m
23638,2,Rho,2752,92,3,9,12,25.0%,17m
23638,3,Fenix,2752,0,1,1,2,50.0%,14m
23638,1,TreeFiddy,2752,38,1,1,2,50.0%,37m
23638,3,lolsithlord,2752,30,1,4,5,20.0%,8m
23638,3,[Sune]shadowMist,2752,0,0,2,2,0.0%,30m
23656,3,Zeramus,2751,693,189,171,360,52.5%,32m
23656,3,GBC,2751,1596,145,133,278,52.2%,21m
23656,1,PyroRyan,2751,1629,127,118,245,51.8%,2h
23656,3,Coochtang,2751,543,84,62,146,57.5%,30m
23656,2,[SQUEE]izanokaynamé,2751,889,41,43,84,48.8%,42m
23656,1,LeoHunter,2751,590,32,21,53,60.4%,2h
23656,2,aegis,2751,455,19,22,41,46.3%,41m
23656,3,undeadfotr,2751,396,13,14,27,48.1%,5m
23656,3,Alexis,2751,233,12,8,20,60.0%,27m
23656,1,TParr,2751,358,11,6,17,64.7%,58m
23656,3,Sebbie,2751,321,11,10,21,52.4%,36m
23656,3,zuperc,2751,30,6,4,10,60.0%,45m
23656,3,Zilk,2751,62,3,5,8,37.5%,12m
23656,1,mèoméomeomèo,2751,76,2,1,3,66.7%,2h
23656,1,McLaren,2751,0,2,3,5,40.0%,3h
23656,3,gostking,2751,121,2,3,5,40.0%,41m
23656,1,LolofLegends,2751,0,2,3,5,40.0%,2h
23656,3,Ícaro,2751,30,2,5,7,28.6%,7m
23656,2,Eliiitz,2751,0,0,1,1,0.0%,3h
23656,1,Derpfestor,2751,0,0,1,1,0.0%,25m
23656,2,Stryker,2751,0,0,3,3,0.0%,2h
23656,3,echuson,2751,0,0,3,3,0.0%,43m
23678,2,[Tyber]ATJ,2750,1561,176,173,349,50.4%,6m
23678,3,Mansy,2750,798,89,76,165,53.9%,27m
23678,3,[XpKAc]kempachy,2750,1401,62,81,143,43.4%,32m
23678,1,Bakka,2750,630,61,52,113,54.0%,36m
23678,2,malibu,2750,872,32,41,73,43.8%,38m
23678,1,LarryHolmes,2750,583,20,14,34,58.8%,2h
23678,3,[VENSC2]WALCER,2750,444,15,17,32,46.9%,29m
23678,3,Thunderthwat,2750,231,8,8,16,50.0%,45m
23678,1,Pencil,2750,212,7,11,18,38.9%,42m
23678,1,PezMussolini,2750,189,6,4,10,60.0%,2h
23678,2,lambda,2750,188,6,15,21,28.6%,33m
23678,1,Nyrus,2750,145,5,5,10,50.0%,1h
23678,2,DrChuChung,2750,94,2,0,2,100.0%,32m
23678,2,[SPQ]Scorpion,2750,0,2,1,3,66.7%,52m
23678,1,[GOFY]Nox,2750,0,2,3,5,40.0%,2h
23678,3,[AkNi]NicKracken,2750,30,2,3,5,40.0%,41m
23678,1,[BRSKR]ToxicChicken,2750,0,2,3,5,40.0%,2h
23678,1,CarrierImba,2750,0,1,0,1,100.0%,35m
23678,1,stgeorge,2750,0,1,2,3,33.3%,20m
23678,1,Xanaphior,2750,0,0,1,1,0.0%,31m
23678,2,MeerKatRealm,2750,0,0,1,1,0.0%,2h
23699,2,Pez,2749,1596,532,528,1060,50.2%,32m
23699,3,NetSadness,2749,1608,217,208,425,51.1%,25m
23699,2,MartelAxe,2749,1519,195,184,379,51.5%,9m
23699,2,Poque,2749,387,95,91,186,51.1%,16m
23699,3,[Pibo3]SwarmINC,2749,1221,76,63,139,54.7%,8m
23699,3,[PASTY]rootbeer,2749,1510,75,77,152,49.3%,25m
23699,3,betosS,2749,1248,69,52,121,57.0%,23m
23699,3,Majandra,2749,1260,55,41,96,57.3%,10m
23699,3,Varen,2749,1076,53,34,87,60.9%,12m
23699,3,darcharchon,2749,973,41,37,78,52.6%,8m
23699,3,sasson,2749,780,32,28,60,53.3%,7m
23699,3,Darkgent,2749,390,26,14,40,65.0%,9m
23699,1,TitaN,2749,391,22,1,23,95.7%,20m
23699,3,MacrodrniNcz,2749,412,14,18,32,43.8%,32m
23699,2,[SHlTTY]Player,2749,295,13,14,27,48.1%,16m
23699,3,[lLiTl]Nimetron,2749,226,11,10,21,52.4%,18m
23699,3,RedFalcon,2749,211,9,7,16,56.2%,2h
23699,3,Eternum,2749,232,9,11,20,45.0%,28m
23699,3,JackHindell,2749,240,8,8,16,50.0%,2h
23699,3,SeRgiio,2749,225,7,5,12,58.3%,55m
23699,3,Long,2749,223,7,6,13,53.8%,17m
23699,3,[xLgNx]Emzyrose,2749,90,4,4,8,50.0%,25m
23699,1,[hTx]COOP,2749,38,3,3,6,50.0%,50m
23699,2,Ciju,2749,94,3,3,6,50.0%,14m
23699,1,crayfish,2749,0,3,4,7,42.9%,59m
23699,1,Prophet,2749,95,3,4,7,42.9%,3h
23699,3,Echelon,2749,62,3,7,10,30.0%,24m
23699,3,nebbeth,2749,97,2,0,2,100.0%,1h
23699,3,matracas,2749,30,2,2,4,50.0%,34m
23699,3,Lemonmazing,2749,30,2,4,6,33.3%,20m
23699,3,[JdV]Edarcox,2749,95,1,2,3,33.3%,7m
23699,1,gohanngasusu,2749,0,0,1,1,0.0%,50m
23699,1,[GnR]Baratheon,2749,0,0,1,1,0.0%,15m
23699,1,[Wehavu]Zerg,2749,0,0,1,1,0.0%,1h
23699,3,[MaLiZ]Tangobsesion,2749,0,0,1,1,0.0%,2h
23734,1,[Illll]deShii,2748,1451,158,165,323,48.9%,40m
23734,2,HEXLET,2748,1285,118,96,214,55.1%,17m
23734,3,kyrie,2748,1291,114,98,212,53.8%,20m
23734,3,mArineEs,2748,1015,48,45,93,51.6%,34m
23734,3,DCake,2748,1252,46,49,95,48.4%,21m
23734,2,Comstock,2748,724,25,38,63,39.7%,28m
23734,2,gambitmonk,2748,533,20,22,42,47.6%,33m
23734,1,[TGCF]grandmaster,2748,314,15,9,24,62.5%,36m
23734,2,hasuprobe,2748,278,11,19,30,36.7%,33m
23734,2,Bors,2748,244,9,13,22,40.9%,27m
23734,3,Entreri,2748,219,8,5,13,61.5%,41m
23734,3,Golferjim,2748,181,8,12,20,40.0%,23m
23734,2,HuberLord,2748,193,6,8,14,42.9%,36m
23734,2,[NotZ]NakedPancake,2748,185,5,4,9,55.6%,3h
23734,1,Lee,2748,132,5,6,11,45.5%,2h
23734,1,MattyMoo,2748,164,4,2,6,66.7%,2h
23734,2,Nicolas,2748,114,4,4,8,50.0%,9m
23734,1,Lawiet,2748,86,3,1,4,75.0%,3h
23734,2,JMC,2748,0,2,3,5,40.0%,43m
23734,1,Wolf,2748,0,2,3,5,40.0%,31m
23734,3,Minoshiro,2748,60,2,4,6,33.3%,18m
23734,3,Zealos,2748,131,2,6,8,25.0%,43m
23734,1,[VACAXD]MeiMisakiNyu,2748,0,1,0,1,100.0%,50m
23734,3,[PWNDya]Pinkiemind,2748,0,1,1,2,50.0%,16m
23734,3,Misaka,2748,91,1,2,3,33.3%,24m
23734,1,Bloodbraid,2748,0,0,1,1,0.0%,3h
23734,3,lol,2748,0,0,1,1,0.0%,44m
23734,1,[LUVMOM]DUDEWHOA,2748,0,0,2,2,0.0%,3h
23734,3,UltimaDeath,2748,0,0,2,2,0.0%,6m
23734,3,echarlesss,2748,0,0,2,2,0.0%,28m
23764,2,mpeddle,2747,399,98,100,198,49.5%,37m
23764,3,hotstone,2747,738,33,26,59,55.9%,33m
23764,3,XXDONOBANXX,2747,434,16,19,35,45.7%,19m
23764,3,redrumble,2747,396,15,17,32,46.9%,5m
23764,1,Fish,2747,286,10,11,21,47.6%,42m
23764,1,SiCKO,2747,224,8,4,12,66.7%,41m
23764,2,[RH42]Gerar,2747,246,8,12,20,40.0%,18m
23764,2,MWFriesen,2747,180,7,7,14,50.0%,28m
23764,1,[FORCE9]Rhazz,2747,216,6,3,9,66.7%,19m
23764,3,ChenCho,2747,131,5,7,12,41.7%,40m
23764,2,rumple,2747,0,3,3,6,50.0%,10m
23764,1,Shadowdancin,2747,72,2,2,4,50.0%,36m
23764,2,darkdan,2747,0,2,4,6,33.3%,52m
23764,1,dilondon,2747,0,0,1,1,0.0%,50m
23764,1,Killface,2747,0,0,2,2,0.0%,21m
23779,1,[Hayze]RONALDO,2746,1577,369,373,742,49.7%,31m
23779,2,UkWildcat,2746,1571,182,178,360,50.6%,17m
23779,3,ItsMe,2746,1453,150,141,291,51.5%,36m
23779,3,[DETER]Ohbey,2746,663,124,119,243,51.0%,43m
23779,2,DeKu,2746,1074,67,67,134,50.0%,26m
23779,1,JustDance,2746,969,53,59,112,47.3%,16m
23779,3,Incognito,2746,913,50,18,68,73.5%,23m
23779,3,[dMdC]NuggDuster,2746,877,47,44,91,51.6%,7m
23779,3,Gamma,2746,894,36,31,67,53.7%,12m
23779,2,Charmander,2746,798,29,37,66,43.9%,39m
23779,1,Nide,2746,744,28,20,48,58.3%,2h
23779,3,Bjergsen,2746,135,25,19,44,56.8%,28m
23779,3,ShemJohnson,2746,636,24,21,45,53.3%,28m
23779,3,Heliocrat,2746,518,20,22,42,47.6%,20m
23779,3,[CriHE]GetRage,2746,384,15,16,31,48.4%,21m
23779,3,NIUHURRU,2746,410,15,17,32,46.9%,39m
23779,1,TMoney,2746,304,12,13,25,48.0%,2h
23779,3,[WSMERC]SvenBitchen,2746,262,10,5,15,66.7%,16m
23779,3,[FF7RM]Niceguy,2746,275,9,8,17,52.9%,29m
23779,3,FranknBeri,2746,275,9,8,17,52.9%,8m
23779,3,GummiFrog,2746,277,9,11,20,45.0%,15m
23779,1,[LMI42]DyE,2746,248,8,5,13,61.5%,51m
23779,3,Apotheosis,2746,204,7,9,16,43.8%,22m
23779,2,flatboy,2746,177,7,9,16,43.8%,10m
23779,1,Studley,2746,179,6,2,8,75.0%,15m
23779,1,Burnside,2746,184,5,4,9,55.6%,32m
23779,1,Rehmoved,2746,48,4,5,9,44.4%,2h
23779,3,[ChiFan]Quetzal,2746,124,4,5,9,44.4%,24m
23779,3,[ValidG]RapidDuck,2746,156,3,7,10,30.0%,17m
23779,1,HelixOxford,2746,38,2,1,3,66.7%,1h
23779,3,Masong,2746,30,2,2,4,50.0%,31m
23779,2,kronk,2746,40,2,4,6,33.3%,20m
23779,3,Isu,2746,30,2,11,13,15.4%,1h
23779,2,Happydrones,2746,0,1,0,1,100.0%,38m
23779,1,Alebris,2746,0,1,0,1,100.0%,34m
23779,3,[lssa77]Planart,2746,0,1,1,2,50.0%,38m
23779,2,Raymand,2746,46,1,1,2,50.0%,48m
23779,3,[CWAL]RufiO,2746,30,1,3,4,25.0%,4m
23779,3,[SGull]Ryder,2746,30,1,4,5,20.0%,12m
23779,3,produkt,2746,30,1,5,6,16.7%,32m
23779,2,[GOPERÚ]Fox,2746,48,1,5,6,16.7%,52m
23779,3,Skeletor,2746,0,0,4,4,0.0%,43m
23779,3,[MFNS]PiKe,2746,0,0,5,5,0.0%,28m
23822,3,Leugim,2745,1566,231,202,433,53.3%,35m
23822,2,[SA2SE]Aron,2745,1525,165,152,317,52.1%,10m
23822,1,milckie,2745,1580,104,89,193,53.9%,54m
23822,2,rageX,2745,1446,98,96,194,50.5%,3m
23822,1,flypeach,2745,1365,52,37,89,58.4%,31m
23822,3,BobBonheur,2745,870,50,37,87,57.5%,3m
23822,3,cOmpleX,2745,734,30,29,59,50.8%,43m
23822,2,[Ne0x1]AARON,2745,494,18,22,40,45.0%,11m
23822,3,Chiz,2745,416,17,18,35,48.6%,41m
23822,3,Barrikade,2745,375,16,13,29,55.2%,17m
23822,3,KILLER,2745,295,11,16,27,40.7%,29m
23822,3,[navis]GZgatos,2745,260,9,5,14,64.3%,29m
23822,3,ZergXR,2745,210,8,8,16,50.0%,7m
23822,3,Baron,2745,86,4,4,8,50.0%,25m
23822,2,NGSerenity,2745,0,3,0,3,100.0%,2h
23822,1,McNancy,2745,144,3,2,5,60.0%,54m
23822,3,[Hayze]GuideTheBoss,2745,50,3,7,10,30.0%,12m
23822,3,[STEWRT]Swag,2745,62,2,6,8,25.0%,31m
23822,1,Creep,2745,42,1,1,2,50.0%,2h
23822,2,Chimo,2745,0,1,4,5,20.0%,32m
23822,1,InManEx,2745,0,0,1,1,0.0%,3h
23822,1,[Galley]Atticade,2745,0,0,1,1,0.0%,3h
23822,3,CosmicCodiac,2745,0,0,2,2,0.0%,8m
23822,3,crymorenow,2745,0,0,3,3,0.0%,23m
23822,3,[LoF]MyMomIsAlive,2745,0,0,8,8,0.0%,23m
23847,1,Replicode,2744,471,89,95,184,48.4%,24m
23847,2,Arganova,2744,1020,43,40,83,51.8%,20m
23847,1,John,2744,1070,39,27,66,59.1%,42m
23847,2,[Boooiz]SourDough,2744,349,32,33,65,49.2%,34m
23847,2,[OGbros]GypsyQueen,2744,866,31,48,79,39.2%,40m
23847,3,TalkDooDoTom,2744,794,30,31,61,49.2%,32m
23847,1,BestCloud,2744,674,27,33,60,45.0%,42m
23847,3,Twiinz,2744,318,12,16,28,42.9%,8m
23847,1,[SoBros]Crazyspaz,2744,367,10,5,15,66.7%,37m
23847,3,Zipper,2744,262,9,11,20,45.0%,34m
23847,3,iananass,2744,134,7,8,15,46.7%,46m
23847,3,[BRG]mcHasnoeyes,2744,116,5,5,10,50.0%,25m
23847,1,MSTY,2744,137,4,4,8,50.0%,15m
23847,2,AgentSmith,2744,48,4,4,8,50.0%,2h
23847,3,[LPrD]Tri,2744,0,3,3,6,50.0%,21m
23847,3,ZeroAF,2744,62,3,6,9,33.3%,27m
23847,3,[dicest]Xuri,2744,92,2,1,3,66.7%,17m
23847,3,MajorMichael,2744,58,2,6,8,25.0%,11m
23847,3,[YAOII]Tunk,2744,97,1,2,3,33.3%,44m
23847,3,Key,2744,30,1,4,5,20.0%,17m
23847,3,Huggernaut,2744,0,1,5,6,16.7%,37m
23847,1,iommy,2744,0,0,1,1,0.0%,42m
23847,1,Quickhitta,2744,0,0,1,1,0.0%,19m
23847,1,Chaosportal,2744,0,0,1,1,0.0%,33m
23871,2,[JaMiT]Masktchi,2743,1554,163,161,324,50.3%,32m
23871,1,Bradman,2743,1608,129,150,279,46.2%,23m
23871,2,vvtrcc,2743,1588,127,124,251,50.6%,17m
23871,3,shnauu,2743,1350,72,55,127,56.7%,9m
23871,3,[DmnTz]Samura,2743,1140,68,64,132,51.5%,5m
23871,3,Random,2743,631,28,20,48,58.3%,10m
23871,3,Atamu,2743,526,23,24,47,48.9%,43m
23871,3,deceptive,2743,528,22,21,43,51.2%,5m
23871,3,[DayJ]Omegatron,2743,128,5,3,8,62.5%,7m
23871,3,[0PGC0]Marat,2743,154,5,3,8,62.5%,29m
23871,1,Cupofpie,2743,116,3,4,7,42.9%,3h
23871,1,TurtleKing,2743,0,2,3,5,40.0%,37m
23871,3,Kalon,2743,30,2,5,7,28.6%,13m
23871,2,[RIT]Icarus,2743,0,1,0,1,100.0%,14m
23871,1,[AlIin]Raikkles,2743,0,1,0,1,100.0%,2h
23871,1,Apeist,2743,0,1,0,1,100.0%,23m
23871,1,[APR]Seamour,2743,0,1,1,2,50.0%,2h
23871,1,Silariandi,2743,0,0,1,1,0.0%,9m
23871,3,Casuals,2743,0,0,2,2,0.0%,21m
23890,2,Audacissime,2742,1286,169,164,333,50.8%,4m
23890,2,Wherewolf,2742,1272,128,125,253,50.6%,16m
23890,2,[oRuRo]ERICKSON,2742,382,63,43,106,59.4%,43m
23890,3,Hexar,2742,1234,54,46,100,54.0%,24m
23890,3,sudo,2742,669,27,20,47,57.4%,43m
23890,3,Honhe,2742,615,24,23,47,51.1%,29m
23890,3,[Dnwlkr]Kano,2742,424,15,19,34,44.1%,28m
23890,2,Probetoss,2742,353,14,13,27,51.9%,15m
23890,2,ReadingIsFun,2742,411,14,21,35,40.0%,41m
23890,3,Nano,2742,250,11,9,20,55.0%,29m
23890,3,xXBIONICXx,2742,223,10,9,19,52.6%,36m
23890,3,Fish,2742,244,9,9,18,50.0%,1h
23890,3,Denom,2742,231,7,12,19,36.8%,41m
23890,1,Aaron,2742,190,5,3,8,62.5%,9m
23890,1,Joker,2742,125,5,5,10,50.0%,31m
23890,2,Fracture,2742,165,4,3,7,57.1%,5m
23890,1,winterishere,2742,168,3,2,5,60.0%,2h
23890,3,[Patas]FuNNY,2742,134,3,2,5,60.0%,5m
23890,2,Blümchen,2742,0,3,4,7,42.9%,13m
23890,3,[MKting]Colossus,2742,30,2,1,3,66.7%,43m
23890,1,TheAznOne,2742,121,2,2,4,50.0%,18m
23890,1,Lycalopex,2742,0,1,0,1,100.0%,2h
23890,3,Feral,2742,0,1,2,3,33.3%,25m
23890,2,ZDubs,2742,0,1,6,7,14.3%,33m
23890,2,zerg,2742,0,0,1,1,0.0%,2h
23915,3,xiongmaohehe,2741,1120,90,84,174,51.7%,8m
23915,3,OBlackO,2741,1608,82,78,160,51.2%,6m
23915,3,MasterChief,2741,1456,68,64,132,51.5%,13m
23915,3,GiftFrmKevin,2741,1297,61,36,97,62.9%,18m
23915,3,[ZMERCY]GunManDark,2741,933,51,37,88,58.0%,41m
23915,3,[teemop]foxius,2741,800,30,28,58,51.7%,17m
23915,3,Dagade,2741,274,13,12,25,52.0%,29m
23915,1,ArtStyle,2741,288,11,10,21,52.4%,1h
23915,1,angil,2741,258,9,6,15,60.0%,18m
23915,3,VoidCugar,2741,171,6,1,7,85.7%,23m
23915,3,Starman,2741,30,5,3,8,62.5%,17m
23915,1,Delthorin,2741,134,4,0,4,100.0%,29m
23915,1,[PTHero]Cybertron,2741,150,4,2,6,66.7%,2h
23915,1,TheMalard,2741,160,4,3,7,57.1%,1h
23915,1,rednelB,2741,97,4,3,7,57.1%,5m
23915,2,wlp,2741,119,4,4,8,50.0%,2h
23915,1,[ZiB]Starflown,2741,96,4,6,10,40.0%,16m
23915,1,MacroNCheese,2741,82,3,0,3,100.0%,2h
23915,1,Gronkmen,2741,32,2,0,2,100.0%,59m
23915,2,StutteryG,2741,94,2,3,5,40.0%,3h
23915,2,Zambowskie,2741,0,1,0,1,100.0%,3h
23915,1,AshenTray,2741,0,0,1,1,0.0%,3h
23915,3,Samiam,2741,0,0,2,2,0.0%,3h
23915,3,WaffleFry,2741,0,0,3,3,0.0%,34m
23939,2,cesarua,2740,1538,189,182,371,50.9%,16m
23939,2,Majaax,2740,1468,84,94,178,47.2%,16m
23939,3,Conan,2740,1187,55,39,94,58.5%,9m
23939,2,johnradiv,2740,976,55,51,106,51.9%,39m
23939,1,[STBA]Mojo,2740,894,32,44,76,42.1%,11m
23939,2,Grummsh,2740,660,26,25,51,51.0%,16m
23939,1,Spartz,2740,611,24,16,40,60.0%,2h
23939,3,Reformist,2740,529,21,16,37,56.8%,33m
23939,3,EndingLife,2740,287,20,20,40,50.0%,28m
23939,3,DeadlyAnne,2740,142,5,5,10,50.0%,32m
23939,3,[FIFON]Filou,2740,92,4,4,8,50.0%,28m
23939,3,FiReWorlD,2740,88,4,6,10,40.0%,6m
23939,1,CROIX,2740,70,2,3,5,40.0%,31m
23939,2,[VDA]viatical,2740,0,2,4,6,33.3%,2h
23939,1,JoshOohAh,2740,0,1,0,1,100.0%,3h
23939,1,HentaiLover,2740,0,1,0,1,100.0%,41m
23939,2,poepike,2740,46,1,1,2,50.0%,53m
23939,3,NotGoodAI,2740,0,1,1,2,50.0%,6m
23939,2,CraftyGuy,2740,0,0,1,1,0.0%,1h
23939,1,Wubachu,2740,0,0,3,3,0.0%,31m
23959,1,[LMI42]ham,2739,887,125,122,247,50.6%,13m
23959,1,BeckNasty,2739,1499,61,42,103,59.2%,19m
23959,1,[Pizzy]DrongoSnart,2739,847,60,78,138,43.5%,40m
23959,3,Hydro,2739,617,39,33,72,54.2%,6m
23959,1,Papijoe,2739,799,37,16,53,69.8%,21m
23959,3,[OceanT]Arnaldex,2739,763,32,30,62,51.6%,29m
23959,3,Charito,2739,400,15,18,33,45.5%,17m
23959,3,Vescovo,2739,203,7,4,11,63.6%,11m
23959,1,jrMILLERS,2739,202,7,6,13,53.8%,41m
23959,1,ianqwert,2739,192,7,9,16,43.8%,3h
23959,1,OniOn,2739,144,7,11,18,38.9%,30m
23959,3,UncleVelvet,2739,146,6,7,13,46.2%,21m
23959,1,Packfire,2739,139,5,5,10,50.0%,5m
23959,1,MrMcNasty,2739,187,4,3,7,57.1%,29m
23959,3,fingerlegs,2739,119,4,5,9,44.4%,43m
23959,3,[DeCan]DeLiverShot,2739,118,4,6,10,40.0%,29m
23959,3,Mike,2739,84,4,10,14,28.6%,35m
23959,1,Igor,2739,82,2,3,5,40.0%,1h
23959,1,monteeun,2739,86,2,4,6,33.3%,2h
23959,3,vladi,2739,58,2,4,6,33.3%,16m
23959,1,Ant,2739,0,0,4,4,0.0%,2h
23980,3,Goku,2738,1570,332,309,641,51.8%,43m
23980,2,[FyHr]yopity,2738,1296,158,148,306,51.6%,33m
23980,3,xCoNtReRaSx,2738,1434,122,117,239,51.0%,21m
23980,3,Arctes,2738,1186,110,91,201,54.7%,13m
23980,3,BuffTerran,2738,1203,70,69,139,50.4%,6m
23980,3,Huntemall,2738,1282,61,45,106,57.5%,6m
23980,3,CHYslo,2738,107,22,20,42,52.4%,14m
23980,3,stu,2738,507,21,15,36,58.3%,26m
23980,3,IIIIIIIIIIII,2738,555,21,20,41,51.2%,28m
23980,2,Focus,2738,534,19,23,42,45.2%,28m
23980,3,[SGxx]sly,2738,317,18,23,41,43.9%,25m
23980,3,TataPinochet,2738,437,17,13,30,56.7%,4m
23980,3,chunkybaby,2738,352,13,8,21,61.9%,13m
23980,3,Joxs,2738,388,13,18,31,41.9%,16m
23980,1,asyouwish,2738,230,8,5,13,61.5%,3h
23980,1,Spiralout,2738,227,6,2,8,75.0%,1h
23980,1,Okinos,2738,195,6,6,12,50.0%,59m
23980,3,SARS,2738,138,6,6,12,50.0%,42m
23980,2,[souple]Bagel,2738,0,4,1,5,80.0%,3h
23980,3,Lars,2738,140,4,2,6,66.7%,25m
23980,1,Granmaluco,2738,74,4,4,8,50.0%,39m
23980,3,piggy,2738,168,4,9,13,30.8%,32m
23980,3,NsKay,2738,138,3,3,6,50.0%,12m
23980,3,Magistrate,2738,60,3,5,8,37.5%,8m
23980,1,Bashkim,2738,42,2,4,6,33.3%,20m
23980,3,parkinlotpop,2738,58,2,6,8,25.0%,12m
23980,3,[ExcIgN]ShadowDragon,2738,60,2,6,8,25.0%,7m
23980,3,SincerSatire,2738,30,1,3,4,25.0%,5m
23980,2,DarkAngel,2738,0,1,5,6,16.7%,53m
23980,3,[Astute]Mago,2738,30,1,8,9,11.1%,25m
23980,3,Ray,2738,0,0,7,7,0.0%,15m
24011,2,[buttts]DJStinkyButt,2737,1093,124,106,230,53.9%,35m
24011,3,Shupaman,2737,1572,98,96,194,50.5%,39m
24011,3,LingCheese,2737,1276,58,47,105,55.2%,28m
24011,1,[NeMOP]vdmai,2737,1198,51,37,88,58.0%,3h
24011,3,hypothermal,2737,477,37,37,74,50.0%,21m
24011,3,DogChasnTail,2737,828,35,30,65,53.8%,35m
24011,2,TheChosenOne,2737,800,30,38,68,44.1%,26m
24011,3,Drale,2737,570,21,15,36,58.3%,29m
24011,3,simple,2737,214,21,22,43,48.8%,35m
24011,3,BraiN,2737,433,19,17,36,52.8%,13m
24011,1,[Aprica]Richardo,2737,328,11,13,24,45.8%,48m
24011,3,SneakyPigeon,2737,244,8,8,16,50.0%,32m
24011,3,[GDJ]ThelOniouS,2737,180,8,11,19,42.1%,33m
24011,3,Mars,2737,66,6,8,14,42.9%,2h
24011,3,Boudreau,2737,92,4,5,9,44.4%,26m
24011,3,[TFFF]LIT,2737,0,3,3,6,50.0%,29m
24011,3,DMDM,2737,60,2,6,8,25.0%,40m
24011,3,FluffyBunny,2737,62,2,6,8,25.0%,28m
24011,1,[InDoGa]BakBak,2737,0,1,0,1,100.0%,2h
24011,1,[xVIPx]Stomped,2737,42,1,1,2,50.0%,2h
24011,1,BadNeighbour,2737,0,1,1,2,50.0%,2h
24011,1,[HGL]IMMvp,2737,48,1,3,4,25.0%,52m
24011,1,[420CC]UncleDrew,2737,0,0,1,1,0.0%,3h
24011,1,[UpeV]elwither,2737,0,0,1,1,0.0%,59m
24011,1,SantiagoZR,2737,0,0,1,1,0.0%,2h
24011,2,[Nyaan]Tamagatchi,2737,0,0,3,3,0.0%,2h
24037,2,Genii,2736,493,162,150,312,51.9%,12m
24037,3,Arfan,2736,1024,63,52,115,54.8%,32m
24037,3,Megatron,2736,1519,62,60,122,50.8%,7m
24037,2,Onezergling,2736,660,54,61,115,47.0%,32m
24037,3,[YPIKÏ]nicolqs,2736,527,19,17,36,52.8%,7m
24037,3,SleepyJoe,2736,283,12,11,23,52.2%,12m
24037,3,King,2736,264,8,9,17,47.1%,12m
24037,3,hoverkid,2736,202,7,9,16,43.8%,12m
24037,1,Fuinha,2736,156,5,4,9,55.6%,41m
24037,1,Tresdi,2736,239,5,6,11,45.5%,2h
24037,1,SIXTHOUSAND,2736,96,5,6,11,45.5%,3h
24037,3,[SCNnja]Tassadar,2736,147,5,6,11,45.5%,28m
24037,3,Crescendo,2736,148,4,4,8,50.0%,19m
24037,1,maujimsal,2736,118,3,3,6,50.0%,2h
24037,2,PolarBear,2736,94,3,3,6,50.0%,60m
24037,2,Vientofrio,2736,0,2,3,5,40.0%,2h
24037,2,Vinnie,2736,0,2,4,6,33.3%,3h
24037,1,Casey,2736,36,1,1,2,50.0%,21m
24037,2,[2faded]ToxicRexha,2736,0,1,5,6,16.7%,36m
24037,1,[Dre4mT]Loyalflush,2736,0,0,1,1,0.0%,21m
24037,2,HellFat,2736,0,0,2,2,0.0%,2h
24058,3,[wrrd]Raptor,2735,1489,123,110,233,52.8%,20m
24058,3,vaivod,2735,1549,90,65,155,58.1%,20m
24058,2,XicooriA,2735,678,82,79,161,50.9%,39m
24058,3,SENICH,2735,903,61,43,104,58.7%,26m
24058,1,[XpKAc]leoalfa,2735,1041,45,26,71,63.4%,2h
24058,3,Phoebe,2735,1030,39,39,78,50.0%,25m
24058,3,[eX]Koébro,2735,574,37,36,73,50.7%,35m
24058,2,[Macac0]Oturanx,2735,757,31,35,66,47.0%,26m
24058,3,[NEIGER]cheedynasty,2735,697,28,25,53,52.8%,9m
24058,3,MechOne,2735,612,22,24,46,47.8%,43m
24058,3,ChilenoSinga,2735,186,7,6,13,53.8%,36m
24058,3,chibs,2735,251,7,8,15,46.7%,60m
24058,1,Strategic,2735,116,4,2,6,66.7%,2h
24058,2,Joe,2735,0,4,2,6,66.7%,2h
24058,3,Ronaldo,2735,137,4,3,7,57.1%,20m
24058,1,[Lp]Slayertoss,2735,0,4,4,8,50.0%,33m
24058,1,[TGCrew]koszonom,2735,108,3,4,7,42.9%,2h
24058,1,Daniel,2735,84,2,3,5,40.0%,3h
24058,2,Snes,2735,0,2,4,6,33.3%,2h
24058,2,BlueIce,2735,0,1,0,1,100.0%,3h
24058,3,hasushi,2735,97,1,2,3,33.3%,46m
24058,2,Ochre,2735,0,1,4,5,20.0%,2h
24058,3,DarkLord,2735,30,1,6,7,14.3%,18m
24058,3,Faulty,2735,0,0,1,1,0.0%,1h
24058,3,vomitkittens,2735,0,0,1,1,0.0%,2h
24058,1,Magua,2735,0,0,1,1,0.0%,15m
24058,3,dareonion,2735,0,0,1,1,0.0%,3h
24058,3,[AtoSis]Bal,2735,0,0,3,3,0.0%,18m
24058,3,[SCX2]CRIAGarm,2735,0,0,4,4,0.0%,4m
24087,3,Toker,2734,1522,175,157,332,52.7%,39m
24087,3,Hapo,2734,1514,134,113,247,54.3%,29m
24087,3,CajuKnight,2734,877,50,48,98,51.0%,6m
24087,3,MalGaniS,2734,1029,45,44,89,50.6%,29m
24087,3,[Dnwlkr]Mackle,2734,308,23,16,39,59.0%,28m
24087,2,SkeeZeL,2734,450,18,21,39,46.2%,35m
24087,3,HeroGT,2734,412,16,10,26,61.5%,12m
24087,1,[TPGGXD]juka,2734,419,13,8,21,61.9%,2h
24087,1,Crazyhobo,2734,467,13,9,22,59.1%,15m
24087,3,[THBF]Kawaii,2734,356,12,10,22,54.5%,8m
24087,3,TheMutt,2734,272,9,12,21,42.9%,13m
24087,1,[LOHd]Survivor,2734,304,8,7,15,53.3%,3h
24087,2,Alsvinder,2734,187,7,8,15,46.7%,37m
24087,2,VMSmith,2734,116,5,3,8,62.5%,2h
24087,3,OrbitalPanda,2734,130,4,1,5,80.0%,35m
24087,2,[SoD]SoDZymM,2734,0,3,2,5,60.0%,15m
24087,2,BobbaJoe,2734,97,3,4,7,42.9%,2h
24087,3,Sinick,2734,122,2,4,6,33.3%,43m
24087,2,[nbgPH]dyetdyet,2734,48,2,4,6,33.3%,2h
24087,3,mree,2734,0,1,2,3,33.3%,12m
24087,1,OTThriller,2734,0,0,1,1,0.0%,58m
24087,1,Hassan,2734,0,0,1,1,0.0%,2h
24087,1,HikeGhost,2734,0,0,1,1,0.0%,3h
24087,2,REAPER,2734,0,0,2,2,0.0%,10m
24111,3,GrandSiul,2733,1565,183,174,357,51.3%,24m
24111,3,Zero,2733,1210,60,69,129,46.5%,9m
24111,3,GILL,2733,1254,54,47,101,53.5%,9m
24111,3,Sickboy,2733,957,49,41,90,54.4%,25m
24111,3,santigold,2733,822,36,37,73,49.3%,27m
24111,2,BigMath,2733,324,13,15,28,46.4%,11m
24111,1,[BScard]Phattso,2733,340,8,11,19,42.1%,41m
24111,3,[NPhasA]MarinePrince,2733,92,4,7,11,36.4%,23m
24111,2,Mickyller,2733,0,3,2,5,60.0%,3h
24111,1,sealius,2733,0,3,2,5,60.0%,2h
24111,1,Budz,2733,88,3,3,6,50.0%,8m
24111,3,JBWarren,2733,60,3,8,11,27.3%,4m
24111,3,[DAGYO]Shunsin,2733,34,1,3,4,25.0%,2h
24111,3,YungWhispers,2733,30,1,6,7,14.3%,40m
24111,1,Keppoch,2733,0,0,1,1,0.0%,2h
24111,1,Turbo,2733,0,0,1,1,0.0%,54m
24111,1,[AZ7]Masec,2733,0,0,1,1,0.0%,2h
24111,3,Laughingman,2733,0,0,3,3,0.0%,8m
24129,2,Boyle,2732,1543,335,325,660,50.8%,40m
24129,3,Artgael,2732,1446,116,106,222,52.3%,34m
24129,3,Blaster,2732,954,77,69,146,52.7%,10m
24129,3,Secro,2732,1529,75,58,133,56.4%,24m
24129,1,[iljili]HungLikeOrc,2732,1166,48,38,86,55.8%,2h
24129,3,XxSensuixX,2732,641,33,34,67,49.3%,15m
24129,2,[DGotO]Grizzslays,2732,796,31,27,58,53.4%,16m
24129,2,[The248]LTon,2732,718,31,38,69,44.9%,6m
24129,1,[Mlnz]Panander,2732,611,25,15,40,62.5%,2h
24129,3,madmanAA,2732,482,18,18,36,50.0%,25m
24129,3,[AIURxT]Pazuzu,2732,402,17,17,34,50.0%,5m
24129,2,Cenarii,2732,308,16,18,34,47.1%,39m
24129,2,[ShFate]coldpheasant,2732,450,16,26,42,38.1%,32m
24129,3,BoogieMan,2732,420,15,17,32,46.9%,26m
24129,2,SoccerMom,2732,67,14,19,33,42.4%,34m
24129,1,Squirrellpoo,2732,318,13,13,26,50.0%,31m
24129,3,BlondForce,2732,196,6,6,12,50.0%,28m
24129,1,[2Pac96]Nosslar,2732,157,4,1,5,80.0%,2h
24129,2,ertex,2732,133,4,4,8,50.0%,15m
24129,2,CopperKid,2732,130,4,4,8,50.0%,57m
24129,3,lowtone,2732,86,4,8,12,33.3%,5m
24129,2,Insanity,2732,95,3,3,6,50.0%,60m
24129,2,UrbanitesAR,2732,0,3,3,6,50.0%,2h
24129,1,Twiddlestorm,2732,104,3,3,6,50.0%,2h
24129,1,[GLP]NancyBoyK,2732,97,3,4,7,42.9%,2h
24129,1,BoisLikeFood,2732,133,2,1,3,66.7%,2h
24129,1,alexorlando,2732,34,2,1,3,66.7%,41m
24129,3,[Cryptc]Syngularity,2732,58,2,5,7,28.6%,29m
24129,3,chakattakk,2732,116,2,6,8,25.0%,10m
24129,1,ProLikeTrav,2732,0,1,0,1,100.0%,2h
24129,1,birby,2732,0,1,1,2,50.0%,42m
24129,2,BadReg,2732,0,0,1,1,0.0%,2h
24129,1,Mclovin,2732,0,0,1,1,0.0%,37m
24129,1,Insanity,2732,0,0,1,1,0.0%,54m
24129,1,Wright,2732,0,0,1,1,0.0%,2h
24129,1,AlexTrebek,2732,0,0,1,1,0.0%,43m
24165,1,Tfunk,2731,457,83,84,167,49.7%,4m
24165,3,Shensin,2731,1331,65,54,119,54.6%,8m
24165,2,Drhashimoto,2731,922,49,50,99,49.5%,42m
24165,3,Loscolo,2731,822,29,35,64,45.3%,31m
24165,1,HERO,2731,728,26,15,41,63.4%,39m
24165,3,[FTTD]DirtyBird,2731,494,23,22,45,51.1%,21m
24165,3,mutou,2731,432,17,9,26,65.4%,6m
24165,3,HuntUDown,2731,274,17,18,35,48.6%,28m
24165,2,Greg,2731,433,16,19,35,45.7%,32m
24165,3,potato,2731,386,13,19,32,40.6%,17m
24165,3,[N0BLE]Astrostrike,2731,314,12,9,21,57.1%,25m
24165,2,ajavisk,2731,264,12,12,24,50.0%,17m
24165,3,marcelo,2731,211,8,8,16,50.0%,13m
24165,3,[TNiNJA]Dukey,2731,182,7,9,16,43.8%,22m
24165,1,joe,2731,188,6,1,7,85.7%,50m
24165,1,wasd,2731,104,5,5,10,50.0%,1h
24165,1,[DMC]frontflip,2731,120,4,4,8,50.0%,1h
24165,3,fersen,2731,155,4,5,9,44.4%,24m
24165,1,omgapenguin,2731,96,4,8,12,33.3%,39m
24165,3,Reptar,2731,58,3,4,7,42.9%,9m
24165,1,[anti5z]Angelous,2731,38,2,1,3,66.7%,32m
24165,2,bizmofunyun,2731,0,2,3,5,40.0%,15m
24165,3,[Micr0]BullPerm,2731,30,2,4,6,33.3%,9m
24165,1,[Noon]kerntastic,2731,40,1,1,2,50.0%,11m
24165,3,[4IUR]Marcello,2731,30,1,6,7,14.3%,15m
24165,1,[Lowko]Deccypher,2731,0,0,1,1,0.0%,2h
24165,1,inting,2731,0,0,1,1,0.0%,31m
24165,2,[Rkkla]Jack,2731,0,0,1,1,0.0%,53m
24165,1,FullMetal,2731,0,0,2,2,0.0%,11m
24165,1,Mentgovern,2731,0,0,2,2,0.0%,2h
24165,3,HorridMr,2731,0,0,2,2,0.0%,5m
24196,3,[GeM]Balefire,2730,1035,150,128,278,54.0%,29m
24196,3,Mike,2730,1032,43,44,87,49.4%,10m
24196,2,Plauge,2730,1112,40,48,88,45.5%,16m
24196,1,MuurMuur,2730,508,31,20,51,60.8%,58m
24196,1,aLTicus,2730,320,10,6,16,62.5%,41m
24196,3,BloodTitan,2730,225,6,8,14,42.9%,28m
24196,2,TheMadBug,2730,184,6,13,19,31.6%,31m
24196,3,lei,2730,118,5,6,11,45.5%,13m
24196,2,malixious,2730,140,5,6,11,45.5%,43m
24196,3,YarHarHar,2730,122,5,7,12,41.7%,22m
24196,1,InfernEx,2730,116,3,3,6,50.0%,41m
24196,1,[cl0udM]Celestial,2730,116,3,5,8,37.5%,2h
24196,1,ISFTT,2730,44,2,2,4,50.0%,60m
24196,3,RaGinGFoX,2730,30,2,4,6,33.3%,25m
24196,3,[Mota]goodweed,2730,62,2,7,9,22.2%,8m
24196,3,Sajt,2730,0,1,0,1,100.0%,3h
24196,1,Dorgis,2730,0,1,0,1,100.0%,48m
24196,3,Kaz,2730,0,1,2,3,33.3%,29m
24196,1,LingLing,2730,42,1,3,4,25.0%,2h
24196,2,amumu,2730,88,1,8,9,11.1%,19m
24196,1,Martlebetuna,2730,0,0,1,1,0.0%,3h
24196,1,[DSFTWA]TheGodfather,2730,0,0,2,2,0.0%,1h
24196,3,Anezthetik,2730,0,0,3,3,0.0%,15m
24219,3,NoMirrorGame,2729,1523,232,219,451,51.4%,8m
24219,1,[0825]blackjezus,2729,1290,185,177,362,51.1%,12m
24219,3,zuander,2729,1205,61,56,117,52.1%,17m
24219,3,[MutasT]Zodak,2729,708,48,40,88,54.5%,7m
24219,2,KuJambrE,2729,991,45,51,96,46.9%,3m
24219,3,TECHNOBEAT,2729,724,32,25,57,56.1%,10m
24219,1,RRC,2729,411,24,18,42,57.1%,34m
24219,3,Rajj,2729,592,23,23,46,50.0%,26m
24219,3,Kwiatek,2729,501,21,15,36,58.3%,34m
24219,3,Pita,2729,216,9,9,18,50.0%,17m
24219,1,SpykeAK,2729,237,8,3,11,72.7%,9m
24219,2,MeatwoodFlac,2729,116,8,7,15,53.3%,38m
24219,3,gouken,2729,191,8,7,15,53.3%,41m
24219,1,[Magic3]DEADSNAKE,2729,252,7,5,12,58.3%,54m
24219,1,shadow,2729,141,5,4,9,55.6%,3h
24219,3,ElVato,2729,145,4,4,8,50.0%,32m
24219,3,[YBoys]batman,2729,120,4,7,11,36.4%,43m
24219,2,Eyþór,2729,96,3,4,7,42.9%,1h
24219,1,cyreli,2729,0,3,5,8,37.5%,39m
24219,1,SoiBoi,2729,0,1,0,1,100.0%,8m
24219,1,TreeFiddy,2729,0,1,1,2,50.0%,2h
24219,1,Death,2729,0,0,1,1,0.0%,2h
24219,1,Cash,2729,0,0,1,1,0.0%,3h
24219,1,Lightspectre,2729,0,0,2,2,0.0%,2h
24243,3,Melon,2728,1531,376,373,749,50.2%,27m
24243,1,LasagneWest,2728,1671,131,105,236,55.5%,2h
24243,1,DingDingDing,2728,684,58,56,114,50.9%,5m
24243,2,Cerro,2728,1268,45,55,100,45.0%,38m
24243,2,Taconutz,2728,612,38,39,77,49.4%,18m
24243,1,Antiharry,2728,809,32,19,51,62.7%,2h
24243,2,Ssnorlax,2728,222,24,29,53,45.3%,32m
24243,2,BigLunatic,2728,245,14,20,34,41.2%,24m
24243,2,ShantiBaba,2728,296,13,16,29,44.8%,40m
24243,3,[PASSER]Oldsix,2728,275,11,9,20,55.0%,19m
24243,2,SchruteFarms,2728,251,10,10,20,50.0%,26m
24243,3,Pmzch,2728,212,8,12,20,40.0%,21m
24243,1,bleus,2728,0,5,0,5,100.0%,1h
24243,1,[Xotiic]Wongsta,2728,124,4,0,4,100.0%,2h
24243,3,Andy,2728,118,4,10,14,28.6%,12m
24243,3,JulioSimple,2728,112,3,2,5,60.0%,13m
24243,2,[lLiTl]Maykoto,2728,48,3,2,5,60.0%,3h
24243,3,snaileye,2728,95,3,3,6,50.0%,18m
24243,2,Kimochiii,2728,0,2,3,5,40.0%,8m
24243,1,[12stps]SAIZT,2728,0,1,0,1,100.0%,2h
24243,1,firefighterm,2728,0,1,0,1,100.0%,48m
24243,1,alucard,2728,0,1,1,2,50.0%,59m
24243,1,Keba,2728,30,1,2,3,33.3%,9m
24243,1,Meddlfranke,2728,0,0,1,1,0.0%,23m
24243,1,Seozim,2728,0,0,2,2,0.0%,59m
24243,3,Ryon,2728,0,0,3,3,0.0%,6m
24269,2,[NDEAHH]Tosho,2727,1557,188,183,371,50.7%,20m
24269,3,bergstrome,2727,1447,106,109,215,49.3%,31m
24269,2,Fuino,2727,450,80,67,147,54.4%,34m
24269,3,Alryeth,2727,364,26,17,43,60.5%,28m
24269,3,cacktissmire,2727,508,19,24,43,44.2%,17m
24269,1,UncleRoger,2727,254,8,5,13,61.5%,19m
24269,3,FirceShadow,2727,96,5,3,8,62.5%,10m
24269,3,[MOBILE]Chuckdiesel,2727,196,5,7,12,41.7%,30m
24269,1,AnthonioRC,2727,95,3,3,6,50.0%,51m
24269,1,[II4WI]mcdoogs,2727,0,2,3,5,40.0%,38m
24269,1,Honestlyzerg,2727,46,2,4,6,33.3%,41m
24269,3,[Divity]longkilling,2727,30,2,8,10,20.0%,34m
24269,1,PklfFdFwwfQd,2727,0,1,0,1,100.0%,2h
24269,3,dag,2727,30,1,4,5,20.0%,5m
24269,1,MaterLord,2727,0,0,1,1,0.0%,3h
24269,2,LtTankArmor,2727,0,0,1,1,0.0%,48m
24269,1,[TeamUR]SirVilder,2727,0,0,1,1,0.0%,36m
24269,1,Dishen,2727,0,0,1,1,0.0%,3h
24269,1,Hopps,2727,0,0,2,2,0.0%,15m
24269,1,SrEnderplay,2727,0,0,2,2,0.0%,51m
24269,3,MindSherpa,2727,0,0,4,4,0.0%,23m
24269,3,DeathHammer,2727,0,0,4,4,0.0%,25m
24291,3,melquiades,2726,1584,216,194,410,52.7%,22m
24291,3,LittleBoats,2726,1371,149,142,291,51.2%,29m
24291,3,Limbo,2726,1250,85,69,154,55.2%,36m
24291,1,tehepicwin,2726,1604,80,58,138,58.0%,16m
24291,2,UnseenEnigma,2726,1098,53,45,98,54.1%,35m
24291,3,EMP,2726,656,28,19,47,59.6%,6m
24291,2,puppycat,2726,672,23,33,56,41.1%,38m
24291,1,SSRSnake,2726,732,21,28,49,42.9%,1h
24291,3,[KRAFTT]Chamelio,2726,234,9,6,15,60.0%,30m
24291,1,[HBB]PoundTown,2726,273,9,6,15,60.0%,2h
24291,2,PaperProf,2726,212,9,9,18,50.0%,42m
24291,3,PAPANEGRA,2726,188,6,6,12,50.0%,28m
24291,3,htiffirg,2726,122,5,8,13,38.5%,37m
24291,3,[H0DORS]bkf,2726,150,5,11,16,31.2%,23m
24291,1,sog,2726,38,2,1,3,66.7%,36m
24291,1,Syringe,2726,40,1,1,2,50.0%,37m
24291,1,Threenil,2726,0,1,1,2,50.0%,2h
24291,1,Monstermash,2726,0,0,1,1,0.0%,33m
24291,1,satoshi,2726,0,0,1,1,0.0%,2h
24291,1,mirageC,2726,0,0,1,1,0.0%,31m
24291,1,Convict,2726,0,0,2,2,0.0%,51m
24291,1,Onicalls,2726,0,0,2,2,0.0%,2h
24291,3,[WOTG]LomoSaltado,2726,0,0,3,3,0.0%,20m
24314,3,XeroKuhl,2725,1550,187,185,372,50.3%,9m
24314,3,JTruth,2725,1331,184,163,347,53.0%,19m
24314,1,MelGibson,2725,1186,77,57,134,57.5%,43m
24314,1,[xFUNx]HomeWrecker,2725,1320,68,60,128,53.1%,2h
24314,3,chqis,2725,1147,59,44,103,57.3%,34m
24314,1,Indio,2725,564,49,42,91,53.8%,2h
24314,3,Goliath,2725,690,32,24,56,57.1%,32m
24314,3,dvelz,2725,710,28,23,51,54.9%,15m
24314,1,Mree,2725,544,19,17,36,52.8%,3h
24314,1,Butter,2725,441,17,8,25,68.0%,15m
24314,1,PROCEPTOR,2725,532,17,13,30,56.7%,32m
24314,1,Besser,2725,347,14,15,29,48.3%,2h
24314,2,KimchiKiller,2725,348,14,17,31,45.2%,29m
24314,3,[osR]Belius,2725,185,8,8,16,50.0%,29m
24314,2,shiroki,2725,146,8,9,17,47.1%,43m
24314,3,RoboRoberto,2725,238,8,13,21,38.1%,8m
24314,1,[ChiFan]MindSpiritG,2725,254,7,1,8,87.5%,32m
24314,1,moyeedoll,2725,256,7,6,13,53.8%,2h
24314,3,[BigBrd]hazelnut,2725,192,6,5,11,54.5%,18m
24314,1,Tokyo,2725,176,6,5,11,54.5%,2h
24314,1,YdOOm,2725,196,5,6,11,45.5%,3h
24314,2,Nomadius,2725,135,4,4,8,50.0%,2h
24314,3,SassBlaster,2725,120,4,11,15,26.7%,10m
24314,3,[zmbe]Street,2725,60,3,4,7,42.9%,38m
24314,2,[Falzt]Commander,2725,0,3,4,7,42.9%,22m
24314,3,[P0PO]Saunders,2725,60,3,7,10,30.0%,23m
24314,1,Schaf,2725,96,2,3,5,40.0%,2h
24314,3,bobtubba,2725,62,2,4,6,33.3%,27m
24314,2,CELL,2725,0,1,2,3,33.3%,9m
24314,1,jaxx,2725,0,0,1,1,0.0%,18m
24314,3,[LMI42]reivax,2725,0,0,6,6,0.0%,6m
24314,3,[LTlord]Airius,2725,0,0,7,7,0.0%,31m
24346,3,Hymx,2724,303,85,71,156,54.5%,27m
24346,3,NakuChannnn,2724,1052,44,39,83,53.0%,6m
24346,3,GKL,2724,775,30,34,64,46.9%,23m
24346,3,Instability,2724,556,24,18,42,57.1%,28m
24346,3,Biggie,2724,592,23,24,47,48.9%,38m
24346,1,DragosO,2724,452,14,12,26,53.8%,3h
24346,1,[AmaSua]Stefano,2724,300,9,8,17,52.9%,6m
24346,3,Mokee,2724,228,8,7,15,53.3%,26m
24346,1,shysheng,2724,252,8,8,16,50.0%,2h
24346,3,CrazyXcoN,2724,246,8,13,21,38.1%,34m
24346,3,theColourC,2724,175,7,9,16,43.8%,1h
24346,1,HighPlayer,2724,200,6,3,9,66.7%,6m
24346,1,Yamawalkie,2724,215,5,5,10,50.0%,3h
24346,1,[ZTempz]belhieg,2724,74,4,5,9,44.4%,20m
24346,1,[lwhy]RealLeader,2724,112,3,3,6,50.0%,2h
24346,2,Michael,2724,124,2,1,3,66.7%,49m
24346,3,Cravenmore,2724,30,2,2,4,50.0%,2h
24346,1,Edlofodraziw,2724,0,2,3,5,40.0%,58m
24346,3,Drizl,2724,0,2,4,6,33.3%,30m
24346,2,sneetch,2724,0,2,4,6,33.3%,1h
24346,1,[CCUO]BIRDofDESIRE,2724,0,1,0,1,100.0%,14m
24346,3,[BnZi]Notoriious,2724,0,1,2,3,33.3%,42m
24346,2,Gordelli,2724,96,1,4,5,20.0%,3h
24346,1,TesseracT,2724,0,0,1,1,0.0%,14m
24346,1,Exole,2724,0,0,1,1,0.0%,58m
24346,1,[m8z]Clips,2724,0,0,1,1,0.0%,51m
24346,1,[Milkyy]decurion,2724,0,0,1,1,0.0%,15m
24373,3,reaper,2723,687,80,71,151,53.0%,31m
24373,1,EDDY,2723,1274,53,37,90,58.9%,58m
24373,3,SirZechs,2723,1108,44,42,86,51.2%,42m
24373,3,[MDeS]CmPltLyShT,2723,265,41,40,81,50.6%,42m
24373,3,[FCTR]Mawgamoth,2723,809,33,33,66,50.0%,42m
24373,3,mindles,2723,705,25,29,54,46.3%,26m
24373,1,Davestator,2723,519,20,14,34,58.8%,3h
24373,3,Xerses,2723,235,20,22,42,47.6%,8m
24373,3,InigoMontoya,2723,389,16,12,28,57.1%,9m
24373,3,[GOPERÚ]RonalFlores,2723,376,14,16,30,46.7%,31m
24373,2,shadow,2723,356,12,6,18,66.7%,3h
24373,1,JohnyUtah,2723,397,12,14,26,46.2%,2h
24373,1,[FuZ]renchan,2723,392,11,11,22,50.0%,2h
24373,2,Slappy,2723,159,5,4,9,55.6%,2h
24373,3,Mogly,2723,107,4,4,8,50.0%,42m
24373,3,TLKdaz,2723,92,4,7,11,36.4%,5m
24373,1,OneTrickPony,2723,0,2,3,5,40.0%,31m
24373,2,Dean,2723,46,2,5,7,28.6%,2h
24373,3,SirK,2723,30,2,5,7,28.6%,17m
24373,1,SirNathaniel,2723,0,1,0,1,100.0%,2h
24373,3,scooby,2723,0,1,3,4,25.0%,9m
24373,3,Flail,2723,30,1,4,5,20.0%,25m
24373,1,Hades,2723,0,0,1,1,0.0%,59m
24373,3,mamut,2723,0,0,1,1,0.0%,44m
24397,2,DireWolf,2722,1614,445,443,888,50.1%,16m
24397,2,[THATCH]SolidSnek,2722,1447,142,128,270,52.6%,32m
24397,3,[AIN]jaimenak,2722,1355,77,78,155,49.7%,29m
24397,2,MrBrunelle,2722,1225,66,62,128,51.6%,37m
24397,3,[phofu]tht,2722,425,46,23,69,66.7%,43m
24397,3,HammerFist,2722,1046,45,44,89,50.6%,12m
24397,1,[AVSC]Artucraft,2722,1025,39,30,69,56.5%,6m
24397,1,Shwing,2722,944,37,51,88,42.0%,35m
24397,3,Juan,2722,882,32,35,67,47.8%,19m
24397,1,[BLZN]JORDANJ,2722,465,18,8,26,69.2%,1h
24397,2,LafaMash,2722,329,12,12,24,50.0%,2h
24397,1,Casino,2722,156,6,3,9,66.7%,2h
24397,3,[SkAL]Khiva,2722,208,6,6,12,50.0%,29m
24397,1,Lois,2722,46,4,5,9,44.4%,2h
24397,1,Nessie,2722,84,2,2,4,50.0%,39m
24397,1,NobaQuakee,2722,0,2,3,5,40.0%,43m
24397,2,Rocky,2722,0,2,3,5,40.0%,2h
24397,2,Sanya,2722,0,2,3,5,40.0%,44m
24397,2,[PAJERO]jesuuuus,2722,0,2,4,6,33.3%,2h
24397,1,PhotophilouS,2722,0,1,0,1,100.0%,2h
24397,2,Proxy,2722,0,1,2,3,33.3%,2h
24397,1,eXtremeFTW,2722,0,1,4,5,20.0%,3h
24397,3,[DETER]Alsadair,2722,30,1,7,8,12.5%,4m
24420,1,[PTHero]Zerglysk,2721,1484,60,53,113,53.1%,2h
24420,3,[HRAlt]Zaphod,2721,1121,45,44,89,50.6%,27m
24420,3,Shakyamuni,2721,452,41,37,78,52.6%,18m
24420,3,[uKnR]Fullmetal,2721,631,36,31,67,53.7%,6m
24420,2,Nubig,2721,840,32,44,76,42.1%,41m
24420,3,YumYums,2721,224,9,6,15,60.0%,20m
24420,1,Eros,2721,209,7,3,10,70.0%,54m
24420,1,Archangelmoo,2721,274,7,4,11,63.6%,38m
24420,3,GypsyDanger,2721,122,5,7,12,41.7%,18m
24420,1,SeeNoEvill,2721,156,4,3,7,57.1%,31m
24420,1,[AiMY0N]JoSeonHurJun,2721,162,4,4,8,50.0%,2h
24420,3,[SC2BOL]MONO,2721,116,4,8,12,33.3%,35m
24420,1,ConnorDotCom,2721,145,3,4,7,42.9%,3h
24420,3,Michael,2721,121,2,1,3,66.7%,43m
24420,1,[KOTZ]Dawson,2721,78,2,2,4,50.0%,2h
24420,1,[UAK]nalgaloca,2721,44,1,1,2,50.0%,51m
24420,3,secrets,2721,93,1,3,4,25.0%,12m
24420,3,WearYMAN,2721,30,1,4,5,20.0%,21m
24420,1,Jovious,2721,0,0,1,1,0.0%,2h
24420,1,[ZrtlDT]Shinizord,2721,0,0,1,1,0.0%,2h
24440,3,priest,2720,1566,273,256,529,51.6%,35m
24440,3,Yoda,2720,1587,244,230,474,51.5%,10m
24440,2,[53h]Awelo,2720,1082,163,172,335,48.7%,38m
24440,1,Reorx,2720,1592,100,82,182,54.9%,32m
24440,3,DrSwarm,2720,804,40,32,72,55.6%,26m
24440,1,Zeratul,2720,762,35,22,57,61.4%,31m
24440,2,DvjNayko,2720,748,32,32,64,50.0%,26m
24440,1,Brandon,2720,894,29,26,55,52.7%,3h
24440,3,Vudolf,2720,681,26,28,54,48.1%,10m
24440,2,[UGDC]convictioN,2720,409,23,29,52,44.2%,34m
24440,3,garde,2720,378,16,12,28,57.1%,35m
24440,1,[TheDOH]murcoff,2720,264,11,10,21,52.4%,1h
24440,3,BukuMan,2720,286,10,13,23,43.5%,15m
24440,1,Loon,2720,329,9,5,14,64.3%,3h
24440,3,realone,2720,247,8,14,22,36.4%,29m
24440,3,[ATMMA]Navi,2720,222,6,8,14,42.9%,43m
24440,2,HOUSE,2720,184,5,5,10,50.0%,2h
24440,1,marton,2720,92,5,5,10,50.0%,42m
24440,1,Diego,2720,158,4,3,7,57.1%,60m
24440,2,kalmahwar,2720,107,4,5,9,44.4%,51m
24440,1,[CoKill]IceFang,2720,170,4,15,19,21.1%,6m
24440,1,DRex,2720,126,3,1,4,75.0%,3h
24440,1,ChesDale,2720,0,3,2,5,60.0%,3h
24440,1,TeChNo,2720,142,3,2,5,60.0%,59m
24440,3,CrossCarrier,2720,140,3,5,8,37.5%,15m
24440,3,BluTxtOvrGrn,2720,58,3,6,9,33.3%,43m
24440,1,Baylo,2720,103,2,1,3,66.7%,3h
24440,2,Jaiba,2720,46,2,2,4,50.0%,60m
24440,1,Butler,2720,40,2,2,4,50.0%,48m
24440,1,JTwoTheGrr,2720,0,2,3,5,40.0%,16m
24440,1,Kronos,2720,0,1,0,1,100.0%,3h
24440,1,jedicouncil,2720,0,1,0,1,100.0%,2h
24440,3,induXun,2720,0,0,4,4,0.0%,10m
24440,3,Ssibal,2720,0,0,6,6,0.0%,21m
24474,3,Sebatyne,2719,1067,82,67,149,55.0%,29m
24474,2,FullShow,2719,640,48,56,104,46.2%,28m
24474,1,arrayzer,2719,784,30,25,55,54.5%,23m
24474,3,Xpo,2719,533,20,24,44,45.5%,24m
24474,3,derron,2719,404,17,13,30,56.7%,43m
24474,2,Kendman,2719,170,8,8,16,50.0%,3h
24474,1,Spartacus,2719,154,5,2,7,71.4%,31m
24474,2,SeniorKills,2719,134,5,4,9,55.6%,2h
24474,1,Krzy,2719,82,3,2,5,60.0%,2h
24474,3,Ironside,2719,122,3,8,11,27.3%,29m
24474,2,[SC2TH]Nines,2719,93,2,0,2,100.0%,2h
24474,1,beavis,2719,0,2,0,2,100.0%,31m
24474,1,[d0ngs]CRUNCHYBLUE,2719,48,2,2,4,50.0%,2h
24474,1,[PDBR]xck,2719,0,2,3,5,40.0%,2h
24474,1,spacecakes,2719,40,2,3,5,40.0%,1h
24474,2,NewKID,2719,0,2,3,5,40.0%,3h
24474,1,xxxxchristan,2719,0,2,3,5,40.0%,51m
24474,2,DaNoobinator,2719,0,1,2,3,33.3%,2h
24474,1,RandySavage,2719,0,0,1,1,0.0%,60m
24474,1,[0PGC0]Betho,2719,0,0,1,1,0.0%,1h
24474,3,Ventricosa,2719,0,0,6,6,0.0%,37m
24495,1,SirEbrawl,2718,1398,186,188,374,49.7%,21m
24495,3,[RPinc]LILMAN,2718,1595,130,127,257,50.6%,42m
24495,3,CoronaVirus,2718,888,74,61,135,54.8%,14m
24495,1,[Aiuur]GillesDeRais,2718,1469,70,46,116,60.3%,38m
24495,1,[sk3tch]Jensen,2718,827,30,20,50,60.0%,15m
24495,3,nitechaos,2718,257,28,26,54,51.9%,12m
24495,3,Matches,2718,590,22,27,49,44.9%,29m
24495,3,UltraKael,2718,338,21,15,36,58.3%,28m
24495,1,Notabot,2718,366,11,12,23,47.8%,2h
24495,3,Lorena,2718,146,7,9,16,43.8%,32m
24495,1,Dolodiar,2718,264,7,14,21,33.3%,2h
24495,1,Roach,2718,168,4,6,10,40.0%,2h
24495,2,silverback,2718,0,3,3,6,50.0%,7m
24495,2,Virus,2718,0,3,4,7,42.9%,25m
24495,3,[QCGz]MrRakanishu,2718,92,3,9,12,25.0%,30m
24495,1,SChit,2718,32,2,1,3,66.7%,11m
24495,1,[DSFTWA]Onions,2718,121,2,2,4,50.0%,48m
24495,1,[SSPU]bubble,2718,0,2,3,5,40.0%,2h
24495,3,Cherry,2718,0,2,3,5,40.0%,2h
24495,1,CrovanDan,2718,0,2,3,5,40.0%,36m
24495,3,CronoOne,2718,30,1,5,6,16.7%,36m
24495,1,[GpsyDg]Jetjames,2718,0,0,1,1,0.0%,32m
24495,1,SEQUEL,2718,0,0,1,1,0.0%,59m
24518,2,Kawkaro,2717,1207,78,73,151,51.7%,16m
24518,3,JAM,2717,1496,65,53,118,55.1%,5m
24518,1,[DETER]BananaPants,2717,1021,34,33,67,50.7%,12m
24518,2,[VFam]Creep,2717,203,24,27,51,47.1%,34m
24518,2,PizzaPete,2717,470,20,20,40,50.0%,30m
24518,3,Dunsidian,2717,544,20,22,42,47.6%,25m
24518,1,Converge,2717,465,19,7,26,73.1%,32m
24518,1,NinjaTurtle,2717,320,10,6,16,62.5%,55m
24518,3,BenJAMMIN,2717,270,10,9,19,52.6%,21m
24518,3,[OD2019]Rochon,2717,217,6,6,12,50.0%,17m
24518,1,babyboy,2717,0,4,1,5,80.0%,36m
24518,1,drizz,2717,0,4,4,8,50.0%,2h
24518,1,SmartMunion,2717,156,4,5,9,44.4%,58m
24518,3,[CHNboy]hanbing,2717,116,4,6,10,40.0%,42m
24518,1,Lestat,2717,30,1,1,2,50.0%,2h
24518,3,WarinDgN,2717,0,1,2,3,33.3%,32m
24518,1,AmunRa,2717,48,1,3,4,25.0%,2h
24518,3,[AP5]Joshua,2717,92,1,3,4,25.0%,30m
24518,3,Chaospheres,2717,0,0,3,3,0.0%,51m
24518,3,Ironhide,2717,0,0,3,3,0.0%,26m
24518,1,[C2N]GeneralGnome,2717,0,0,3,3,0.0%,2h
24539,3,Blacksheep,2716,1484,134,117,251,53.4%,34m
24539,1,ryse,2716,1571,74,84,158,46.8%,35m
24539,2,KevKidFtw,2716,825,73,78,151,48.3%,41m
24539,3,[4L0k0]Visi,2716,485,21,15,36,58.3%,16m
24539,1,Narcolepsy,2716,318,10,6,16,62.5%,3h
24539,1,[gksrnr]Class,2716,179,9,3,12,75.0%,24m
24539,1,Yami,2716,0,5,0,5,100.0%,38m
24539,3,aaa,2716,120,5,6,11,45.5%,39m
24539,3,[Cind3r]Sly,2716,150,5,9,14,35.7%,6m
24539,3,Meeha,2716,90,4,6,10,40.0%,25m
24539,3,[B33R]Aviendha,2716,119,3,3,6,50.0%,12m
24539,3,NSwarrior,2716,0,3,4,7,42.9%,29m
24539,2,POWER,2716,91,2,0,2,100.0%,2h
24539,1,DarckMaster,2716,95,2,2,4,50.0%,44m
24539,3,[BeerLH]Zohdin,2716,0,2,3,5,40.0%,21m
24539,3,Ragde,2716,0,2,3,5,40.0%,16m
24539,1,[w0rm]Freelo,2716,0,2,3,5,40.0%,11m
24539,1,DeathDragon,2716,0,1,0,1,100.0%,2h
24539,1,[L4Life]Threeppholes,2716,48,1,2,3,33.3%,24m
24539,3,boogeh,2716,30,1,4,5,20.0%,40m
24539,3,[YS420]Shaffty,2716,30,1,5,6,16.7%,12m
24539,1,Player,2716,0,0,1,1,0.0%,2h
24539,1,MiniThor,2716,0,0,3,3,0.0%,1h
24539,3,[B2TW]angelblade,2716,0,0,4,4,0.0%,7m
24563,3,chuck,2715,1526,73,71,144,50.7%,28m
24563,3,HulkBuster,2715,1044,73,77,150,48.7%,31m
24563,3,Tisartktw,2715,1149,46,43,89,51.7%,25m
24563,3,RickJames,2715,423,39,38,77,50.6%,5m
24563,3,[FUBAR1]FreeMunny,2715,756,26,32,58,44.8%,5m
24563,1,FionaHippo,2715,268,22,15,37,59.5%,2h
24563,3,moistchip,2715,466,18,21,39,46.2%,6m
24563,1,IIIIIIIIIIII,2715,466,15,10,25,60.0%,16m
24563,3,franzbeets,2715,312,13,8,21,61.9%,42m
24563,3,EricRV,2715,322,11,14,25,44.0%,12m
24563,3,EVØLVE,2715,262,9,11,20,45.0%,37m
24563,3,PPdripz,2715,211,7,12,19,36.8%,2h
24563,1,[Ch0nk]Tofucake,2715,132,5,1,6,83.3%,3h
24563,3,Iceberg,2715,119,5,5,10,50.0%,34m
24563,2,Dajooka,2715,58,5,6,11,45.5%,30m
24563,3,Birthday,2715,158,4,5,9,44.4%,12m
24563,3,OldGravyLeg,2715,122,3,4,7,42.9%,25m
24563,1,Drip,2715,118,3,6,9,33.3%,31m
24563,2,[porbe]woooooober,2715,0,2,4,6,33.3%,3h
24563,2,Psymon,2715,0,1,0,1,100.0%,57m
24563,1,DeX,2715,0,1,0,1,100.0%,38m
24563,1,[LMI42]Jweaves,2715,38,1,1,2,50.0%,42m
24563,2,[Dandy]Navik,2715,48,1,2,3,33.3%,36m
24563,1,[mayky]mayky,2715,0,1,2,3,33.3%,2h
24563,1,Joktan,2715,0,1,2,3,33.3%,2h
24563,1,Uruseh,2715,0,0,2,2,0.0%,31m
24563,1,[DADrUS]Dax,2715,0,0,2,2,0.0%,16m
24563,2,XMDL,2715,0,0,2,2,0.0%,14m
24563,3,[Wat3rs]DevilDuck,2715,0,0,3,3,0.0%,2h
24592,2,GhostPants,2714,1523,370,363,733,50.5%,39m
24592,2,MonkeyButt,2714,777,99,97,196,50.5%,6m
24592,3,Canopus,2714,1236,93,97,190,48.9%,17m
24592,3,Suttsy,2714,254,38,30,68,55.9%,8m
24592,3,[ZTemp]Chesshire,2714,970,36,35,71,50.7%,9m
24592,1,Arkos,2714,738,26,20,46,56.5%,32m
24592,3,PygmyShrew,2714,180,7,8,15,46.7%,17m
24592,3,[Jok3r]Dan,2714,171,5,8,13,38.5%,45m
24592,2,Snare,2714,0,4,3,7,57.1%,27m
24592,1,HarunA,2714,82,2,3,5,40.0%,2h
24592,1,jmb,2714,0,1,0,1,100.0%,2h
24592,1,[2BrOs]TheTrojan,2714,44,1,2,3,33.3%,43m
24592,1,Pikapal,2714,0,0,1,1,0.0%,42m
24592,1,Chontoglires,2714,0,0,1,1,0.0%,9m
24592,3,Ziigs,2714,0,0,1,1,0.0%,2h
24592,3,Slayname,2714,0,0,2,2,0.0%,46m
24608,2,KingMidas,2713,1568,238,225,463,51.4%,35m
24608,1,ThatGuy,2713,463,116,116,232,50.0%,39m
24608,3,MaxNoob,2713,1458,102,97,199,51.3%,12m
24608,3,[GOPERÚ]AZOPOTAMO,2713,1233,46,51,97,47.4%,34m
24608,3,[DMADG]Eduardo,2713,911,45,27,72,62.5%,19m
24608,3,[tCo9]chaos,2713,585,26,29,55,47.3%,9m
24608,1,celendis,2713,422,15,14,29,51.7%,2h
24608,3,Primus,2713,383,15,15,30,50.0%,12m
24608,1,Megatronis,2713,280,8,6,14,57.1%,36m
24608,2,[EoC]Dechain,2713,184,5,5,10,50.0%,2h
24608,3,Mahdinia,2713,94,4,8,12,33.3%,5m
24608,1,TeknoBabble,2713,196,4,9,13,30.8%,42m
24608,2,Jonathan,2713,94,3,3,6,50.0%,2h
24608,1,vryvel,2713,36,2,0,2,100.0%,32m
24608,1,[GoldPo]Panda,2713,42,1,1,2,50.0%,1h
24608,1,Ricky,2713,40,1,3,4,25.0%,3h
24608,1,[PAR7Y]dasjuden,2713,0,0,2,2,0.0%,55m
24608,1,SPARROW,2713,0,0,2,2,0.0%,2h
24608,3,gen,2713,0,0,4,4,0.0%,31m
24627,1,danielix,2712,668,182,160,342,53.2%,51m
24627,3,SgtPigeon,2712,1361,83,81,164,50.6%,8m
24627,3,[LTlord]Sombra,2712,931,56,44,100,56.0%,4m
24627,2,CommandC,2712,683,56,61,117,47.9%,7m
24627,1,LuciusRV,2712,438,32,14,46,69.6%,32m
24627,1,[SPCs]ReVoluTion,2712,688,25,16,41,61.0%,12m
24627,3,[FUU]Durantien,2712,483,21,16,37,56.8%,37m
24627,3,[AlIin]Eckky,2712,526,21,21,42,50.0%,14m
24627,1,[MWaves]Jimbro,2712,628,19,21,40,47.5%,42m
24627,2,Inkleth,2712,454,18,19,37,48.6%,20m
24627,3,[MaxWin]BRODOZING,2712,287,12,9,21,57.1%,28m
24627,3,[DarkAG]WHOSFIRST,2712,340,12,17,29,41.4%,31m
24627,3,[SuSA]Solias,2712,305,11,8,19,57.9%,43m
24627,1,Wildarmed,2712,170,6,7,13,46.2%,2h
24627,1,Curious,2712,117,4,4,8,50.0%,19m
24627,1,Zirgud,2712,64,3,2,5,60.0%,3h
24627,3,PathosEthos,2712,98,3,3,6,50.0%,6m
24627,1,Repoman,2712,48,3,5,8,37.5%,47m
24627,1,Shifter,2712,40,2,1,3,66.7%,3h
24627,1,[BLSHD]Vangaaard,2712,48,2,4,6,33.3%,2h
24627,2,GomitaPro,2712,0,2,4,6,33.3%,23m
24627,1,IntiSinchi,2712,0,1,4,5,20.0%,48m
24627,3,gagag,2712,0,0,4,4,0.0%,28m
24627,3,ElGringoAlto,2712,0,0,6,6,0.0%,5m
24651,3,Gamerving,2711,828,59,64,123,48.0%,41m
24651,2,[JaMiT]SyFy,2711,1014,46,54,100,46.0%,16m
24651,3,MadeofStars,2711,745,45,34,79,57.0%,36m
24651,1,erunky,2711,706,32,10,42,76.2%,31m
24651,3,DarthRevan,2711,572,23,25,48,47.9%,12m
24651,3,Heffe,2711,339,22,22,44,50.0%,6m
24651,3,Brandon,2711,572,21,21,42,50.0%,10m
24651,2,Visionz,2711,554,20,29,49,40.8%,28m
24651,2,Option,2711,484,16,27,43,37.2%,36m
24651,3,candyrandy,2711,143,13,15,28,46.4%,6m
24651,1,Cam,2711,338,10,11,21,47.6%,5m
24651,1,awjeezerick,2711,230,6,6,12,50.0%,36m
24651,3,[Syphil]juanchepe,2711,150,6,10,16,37.5%,25m
24651,3,[SWORD7]Bill,2711,195,6,11,17,35.3%,3h
24651,3,CoconutBrah,2711,192,5,3,8,62.5%,3h
24651,1,Noodlemon,2711,0,4,1,5,80.0%,19m
24651,2,Easy,2711,30,4,5,9,44.4%,3m
24651,1,[BBBTC]MarineKondo,2711,192,4,5,9,44.4%,3h
24651,1,[XpKAc]alberto,2711,78,3,1,4,75.0%,26m
24651,3,Flomotion,2711,113,2,2,4,50.0%,44m
24651,1,Bosam,2711,0,2,3,5,40.0%,2h
24651,1,Serenaall,2711,0,2,3,5,40.0%,2h
24651,1,Metronomes,2711,0,1,0,1,100.0%,9m
24651,1,[GyB]urielcarlos,2711,97,1,2,3,33.3%,4m
24651,1,[DSNY]SrMoon,2711,0,0,1,1,0.0%,2h
24651,1,botoxman,2711,0,0,1,1,0.0%,11m
24651,1,youngRoach,2711,0,0,1,1,0.0%,51m
24651,1,TawxikJuepo,2711,0,0,1,1,0.0%,16m
24651,1,DrunkCat,2711,0,0,2,2,0.0%,9m
24651,1,VoM,2711,0,0,3,3,0.0%,3h
24681,2,CHRISCO,2710,1122,261,250,511,51.1%,37m
24681,1,Fahed,2710,1077,72,53,125,57.6%,47m
24681,1,Badgerling,2710,1191,57,45,102,55.9%,2h
24681,1,Darryn,2710,1151,45,36,81,55.6%,2h
24681,1,cryonics,2710,817,40,31,71,56.3%,2h
24681,3,Dynamic,2710,652,30,22,52,57.7%,34m
24681,1,[GRNDMA]SpudTitan,2710,676,24,22,46,52.2%,11m
24681,3,Noobs,2710,428,22,25,47,46.8%,37m
24681,3,[iPG]jackiechiles,2710,246,8,17,25,32.0%,26m
24681,1,Skitzoshift,2710,216,6,2,8,75.0%,34m
24681,3,Pagnotta,2710,182,6,6,12,50.0%,35m
24681,1,PenguinsRflu,2710,0,5,0,5,100.0%,2h
24681,3,[LCE]ansioso,2710,163,5,6,11,45.5%,11m
24681,1,papalo,2710,72,3,0,3,100.0%,1h
24681,1,Kiom,2710,40,2,1,3,66.7%,12m
24681,1,seaworm,2710,0,2,3,5,40.0%,1h
24681,2,LeNic,2710,30,2,3,5,40.0%,2h
24681,1,Nikkomander,2710,78,2,4,6,33.3%,2h
24681,1,DeepWeb,2710,0,1,0,1,100.0%,38m
24681,1,IlIIIlllIlIl,2710,30,1,3,4,25.0%,31m
24681,2,ForcedField,2710,0,0,1,1,0.0%,2h
24702,1,[BL]Kevingalls,2709,1493,325,327,652,49.8%,42m
24702,1,Spartan,2709,1388,151,154,305,49.5%,17m
24702,2,FlashGame,2709,1537,140,134,274,51.1%,4m
24702,1,DrPancho,2709,1633,113,103,216,52.3%,2h
24702,1,Penusling,2709,723,45,51,96,46.9%,15m
24702,3,[H0D0R]NannerBeanz,2709,770,40,29,69,58.0%,25m
24702,3,catman,2709,580,36,29,65,55.4%,44m
24702,3,LeoNydus,2709,986,36,39,75,48.0%,41m
24702,3,FriskyTango,2709,431,20,15,35,57.1%,15m
24702,3,Naypolian,2709,484,20,18,38,52.6%,7m
24702,3,MaRiNe,2709,347,14,16,30,46.7%,17m
24702,1,Kbzon,2709,378,11,9,20,55.0%,2h
24702,3,Deevuz,2709,284,11,10,21,52.4%,1h
24702,1,Aizen,2709,274,8,6,14,57.1%,43m
24702,1,[JaMiT]Tricky,2709,140,7,4,11,63.6%,2h
24702,1,TheGoodLife,2709,228,6,7,13,46.2%,3h
24702,1,Silas,2709,204,5,2,7,71.4%,23m
24702,1,[smpbz]detflef,2709,200,5,2,7,71.4%,48m
24702,3,Zerat,2709,131,5,5,10,50.0%,29m
24702,2,MasterChief,2709,46,4,3,7,57.1%,2h
24702,3,FeelinSalty,2709,0,3,2,5,60.0%,27m
24702,2,Edgex,2709,30,3,7,10,30.0%,9m
24702,1,Ashwin,2709,72,2,2,4,50.0%,44m
24702,1,rob,2709,76,2,5,7,28.6%,3h
24702,1,Bork,2709,46,1,2,3,33.3%,2h
24702,1,LoneWolf,2709,73,1,2,3,33.3%,3h
24702,1,superhuman,2709,48,1,3,4,25.0%,3h
24702,3,KeitokuCR,2709,30,1,3,4,25.0%,29m
24702,2,SleepyBear,2709,0,0,2,2,0.0%,49m
24702,3,DrPhoton,2709,0,0,7,7,0.0%,37m
24732,1,[4WG]Monkey,2708,1516,60,53,113,53.1%,48m
24732,3,ArmoredBus,2708,958,51,39,90,56.7%,5m
24732,1,[GC2042]sooopersonic,2708,1050,36,36,72,50.0%,1h
24732,3,Skepticism,2708,742,27,32,59,45.8%,15m
24732,1,Boulderdash,2708,561,25,9,34,73.5%,54m
24732,3,[Xpk]Pepe,2708,655,25,23,48,52.1%,28m
24732,1,[InGt]LogiK,2708,417,23,41,64,35.9%,5m
24732,2,llllllllllll,2708,518,17,23,40,42.5%,31m
24732,3,Pank,2708,366,13,13,26,50.0%,26m
24732,3,Moridin,2708,117,12,8,20,60.0%,7m
24732,1,[TGP]chadbrochill,2708,252,11,17,28,39.3%,31m
24732,2,DarkForce,2708,328,11,19,30,36.7%,23m
24732,3,[HDSS]EjktanToruk,2708,260,9,8,17,52.9%,14m
24732,1,jermdog,2708,288,8,7,15,53.3%,38m
24732,3,WuttaRichard,2708,251,8,8,16,50.0%,20m
24732,3,Starcaustic,2708,202,8,10,18,44.4%,16m
24732,2,GildedR,2708,137,7,4,11,63.6%,41m
24732,1,Littleman,2708,161,6,6,12,50.0%,16m
24732,3,[ZTemp]Carnage,2708,154,5,7,12,41.7%,17m
24732,1,Luxury,2708,118,4,2,6,66.7%,35m
24732,2,[PAROLE]Shaft,2708,150,4,12,16,25.0%,5m
24732,1,[notman]johnrambo,2708,78,3,1,4,75.0%,39m
24732,3,Shakuras,2708,58,3,7,10,30.0%,34m
24732,1,Venom,2708,40,2,2,4,50.0%,23m
24732,1,[GRUMEC]Hades,2708,82,2,2,4,50.0%,2h
24732,1,Felys,2708,0,2,3,5,40.0%,3h
24732,1,kornhouser,2708,44,2,3,5,40.0%,33m
24732,3,TangoRocker,2708,0,1,4,5,20.0%,47m
24732,1,skinflute,2708,0,0,1,1,0.0%,38m
24732,1,NATAS,2708,0,0,2,2,0.0%,2h
24732,3,[LMFA]Thunder,2708,0,0,4,4,0.0%,6m
24732,3,BigFeet,2708,0,0,5,5,0.0%,30m
24764,1,MonoDSL,2707,1563,103,91,194,53.1%,1h
24764,3,Kezerg,2707,949,38,36,74,51.4%,12m
24764,3,KINGGAN,2707,436,18,18,36,50.0%,19m
24764,1,WoDaBhily,2707,348,15,10,25,60.0%,2h
24764,1,Zero,2707,224,8,8,16,50.0%,58m
24764,1,vongroa,2707,182,6,4,10,60.0%,5m
24764,1,Cristianlizc,2707,188,6,4,10,60.0%,2h
24764,1,vol,2707,231,6,10,16,37.5%,2h
24764,1,TheBestAtSC,2707,0,3,4,7,42.9%,2h
24764,1,Aldeadhoja,2707,114,3,5,8,37.5%,2h
24764,1,Ravynor,2707,0,2,3,5,40.0%,33m
24764,3,blackgendro,2707,30,2,6,8,25.0%,32m
24764,3,Pug,2707,30,2,8,10,20.0%,20m
24764,1,boris,2707,40,1,1,2,50.0%,3h
24764,1,masav,2707,0,1,2,3,33.3%,3h
24764,3,Joel,2707,91,1,2,3,33.3%,32m
24764,3,Kotirik,2707,93,1,4,5,20.0%,33m
24764,1,Sniper,2707,0,1,4,5,20.0%,2h
24764,3,lother,2707,30,1,6,7,14.3%,13m
24764,1,Bae,2707,0,0,1,1,0.0%,6m
24764,1,Meraxes,2707,0,0,1,1,0.0%,3h
24764,1,FoxSpark,2707,0,0,1,1,0.0%,59m
24786,3,ezidan,2706,1539,140,133,273,51.3%,5m
24786,3,GrubHerder,2706,481,76,63,139,54.7%,18m
24786,2,[UFIS]IMAGINATION,2706,984,67,60,127,52.8%,16m
24786,1,Napalm,2706,1266,45,57,102,44.1%,31m
24786,1,Cream,2706,1118,42,33,75,56.0%,41m
24786,3,[NEGF]Jinx,2706,817,31,35,66,47.0%,43m
24786,3,ALSdjkas,2706,522,18,23,41,43.9%,12m
24786,3,SmellCheese,2706,433,16,16,32,50.0%,30m
24786,2,cooX,2706,450,14,26,40,35.0%,40m
24786,3,[SPNa]Tallis,2706,202,9,7,16,56.2%,5m
24786,3,SLMaccabee,2706,247,9,10,19,47.4%,1h
24786,1,xXAroldXx,2706,309,8,10,18,44.4%,38m
24786,1,Nathan,2706,262,7,9,16,43.8%,41m
24786,1,Jonerys,2706,162,6,2,8,75.0%,2h
24786,1,JEGABAHU,2706,193,6,2,8,75.0%,6m
24786,2,LittlePi,2706,114,4,4,8,50.0%,43m
24786,3,Castle,2706,0,3,2,5,60.0%,5m
24786,1,[PRTOS]CaptainLevi,2706,97,3,5,8,37.5%,21m
24786,3,pech,2706,0,2,3,5,40.0%,4m
24786,1,gravyBEAM,2706,48,2,5,7,28.6%,36m
24786,1,SROpressor,2706,0,1,0,1,100.0%,3h
24786,1,Divinejas,2706,42,1,1,2,50.0%,54m
24786,1,[TheZX]tomass,2706,0,1,3,4,25.0%,2h
24786,1,fatReeG,2706,0,0,1,1,0.0%,2h
24786,3,JCCE,2706,0,0,4,4,0.0%,51m
24811,1,[Girlll]prettythanU,2705,1611,64,56,120,53.3%,16m
24811,3,[TBBM]ahhdestroy,2705,913,47,49,96,49.0%,15m
24811,3,Fivelidz,2705,235,30,20,50,60.0%,27m
24811,3,Voyd,2705,512,19,18,37,51.4%,17m
24811,1,KUPI,2705,317,12,13,25,48.0%,2h
24811,1,OverLord,2705,339,10,5,15,66.7%,2h
24811,1,kingslayer,2705,294,9,4,13,69.2%,38m
24811,2,Forisspecial,2705,242,8,14,22,36.4%,34m
24811,3,NAVE,2705,238,7,9,16,43.8%,9m
24811,2,Vastolord,2705,202,7,14,21,33.3%,18m
24811,3,ShibaInu,2705,182,6,11,17,35.3%,18m
24811,1,[ARCA]USuck,2705,0,4,1,5,80.0%,49m
24811,2,[FGMP]Construct,2705,0,4,2,6,66.7%,49m
24811,1,[SUVCE]DavidFlCr,2705,138,4,2,6,66.7%,2h
24811,3,[ISYTP]TheNamek,2705,151,4,2,6,66.7%,36m
24811,3,Don,2705,107,4,4,8,50.0%,17m
24811,2,Ichiban,2705,96,3,3,6,50.0%,3h
24811,3,Goordo,2705,0,3,3,6,50.0%,20m
24811,1,winking,2705,46,2,1,3,66.7%,2h
24811,3,DAV,2705,60,2,5,7,28.6%,19m
24811,1,[OGbudz]YumShots,2705,0,1,0,1,100.0%,3h
24811,1,YOLOTEAM,2705,0,1,1,2,50.0%,34m
24811,2,Terran,2705,46,1,3,4,25.0%,2h
24811,1,Halcyon,2705,0,0,1,1,0.0%,34m
24811,1,[AIURxT]DragonSlayer,2705,0,0,1,1,0.0%,32m
24811,2,mcthepro,2705,0,0,5,5,0.0%,55m
24837,3,Clyp,2704,1574,175,162,337,51.9%,8m
24837,1,[bsDg]DatNuNu,2704,1269,72,56,128,56.2%,11m
24837,1,[Pig2]GGCowabunga,2704,1524,69,63,132,52.3%,34m
24837,3,Hellprince,2704,1254,68,65,133,51.1%,8m
24837,3,[BCBZ]Newton,2704,985,66,53,119,55.5%,38m
24837,3,llllIIIllIlI,2704,942,39,32,71,54.9%,8m
24837,1,drogon,2704,862,37,34,71,52.1%,2h
24837,3,AuntSally,2704,445,20,25,45,44.4%,20m
24837,3,uforgottodie,2704,426,15,18,33,45.5%,25m
24837,2,fizzwiththiz,2704,407,15,18,33,45.5%,7m
24837,3,NikoN,2704,237,12,6,18,66.7%,29m
24837,1,prometheus,2704,145,3,9,12,25.0%,2h
24837,1,Feelsbad,2704,0,2,3,5,40.0%,31m
24837,3,[FurNT]WildFire,2704,0,1,3,4,25.0%,28m
24837,1,GonLock,2704,0,1,3,4,25.0%,2h
24837,1,Rossco,2704,89,1,10,11,9.1%,33m
24837,1,[NATJ4]SHWKEPJ,2704,0,0,1,1,0.0%,1h
24837,1,AlexCambyMAC,2704,0,0,1,1,0.0%,2h
24837,3,DrakeLE,2704,0,0,7,7,0.0%,42m
24856,3,RoadDoc,2703,1167,48,52,100,48.0%,32m
24856,3,Volkai,2703,1268,46,53,99,46.5%,34m
24856,1,criscito,2703,797,35,11,46,76.1%,38m
24856,3,[FZ]MisterE,2703,921,34,35,69,49.3%,26m
24856,2,[FU2]zopilotech,2703,332,11,21,32,34.4%,43m
24856,1,pansy,2703,258,9,8,17,52.9%,49m
24856,1,Archebellum,2703,264,9,10,19,47.4%,52m
24856,1,headshot,2703,262,7,9,16,43.8%,3h
24856,2,Jamesegnac,2703,197,7,11,18,38.9%,18m
24856,1,AuuuughYeeah,2703,192,4,3,7,57.1%,26m
24856,3,CowMold,2703,0,2,3,5,40.0%,14m
24856,2,Nightmare,2703,0,1,0,1,100.0%,1h
24856,1,Courier,2703,0,1,0,1,100.0%,2h
24856,1,[HourBy]Popoviche,2703,0,1,1,2,50.0%,31m
24856,1,Lurker,2703,44,1,3,4,25.0%,2h
24856,1,Incorrigible,2703,0,0,1,1,0.0%,19m
24856,1,[ITF]ITFpeeps,2703,0,0,1,1,0.0%,2h
24856,1,[MechE]Engineer,2703,0,0,1,1,0.0%,3h
24856,1,Fuji,2703,0,0,1,1,0.0%,3h
24856,1,[LGNxx]Gouda,2703,0,0,1,1,0.0%,6m
24856,1,TranQ,2703,0,0,3,3,0.0%,2h
24877,1,Archdevil,2702,1743,163,132,295,55.3%,31m
24877,3,orz,2702,1532,97,95,192,50.5%,10m
24877,3,Arkham,2702,1518,66,60,126,52.4%,7m
24877,3,Achilles,2702,1380,54,50,104,51.9%,9m
24877,3,Squishi,2702,840,36,31,67,53.7%,29m
24877,2,fortninja,2702,556,19,26,45,42.2%,42m
24877,3,InkReverse,2702,339,17,15,32,53.1%,12m
24877,1,caesura,2702,363,14,8,22,63.6%,42m
24877,3,ThePainTrain,2702,281,11,11,22,50.0%,32m
24877,3,[SyLx]Bomber,2702,228,9,12,21,42.9%,8m
24877,1,[LifeF]LilEnchilada,2702,194,5,1,6,83.3%,2h
24877,1,paRaDe,2702,130,4,4,8,50.0%,41m
24877,2,Krain,2702,183,3,5,8,37.5%,3h
24877,1,[FuZ]marumo,2702,48,2,2,4,50.0%,2h
24877,1,Shikikan,2702,80,2,5,7,28.6%,59m
24877,1,Swarmhost,2702,0,1,0,1,100.0%,15m
24877,2,Schumie,2702,0,1,0,1,100.0%,60m
24877,1,DeBurd,2702,0,1,0,1,100.0%,32m
24877,1,[kitty1]ShadowPigz,2702,0,1,0,1,100.0%,47m
24877,3,wacko,2702,0,1,1,2,50.0%,40m
24877,1,[AlWolf]Schhiffe,2702,0,1,3,4,25.0%,42m
24877,1,Vault,2702,117,1,4,5,20.0%,2h
24877,1,[nochee]Wolfe,2702,0,0,1,1,0.0%,2h
24877,1,[OceanT]Zamb,2702,0,0,2,2,0.0%,2h
24877,3,[Sithis]Dragonborn,2702,0,0,4,4,0.0%,32m
24902,2,Jawbreaker,2701,1372,97,88,185,52.4%,38m
24902,3,BeesNSkis,2701,1560,60,63,123,48.8%,30m
24902,1,[85F]rainy,2701,960,56,53,109,51.4%,34m
24902,2,Poozy,2701,354,14,20,34,41.2%,6m
24902,1,chilldeath,2701,294,12,7,19,63.2%,50m
24902,3,WarriorMk,2701,220,8,13,21,38.1%,18m
24902,1,APOLO,2701,220,7,3,10,70.0%,9m
24902,1,Unicron,2701,212,7,7,14,50.0%,3h
24902,3,nicematt,2701,228,7,12,19,36.8%,40m
24902,1,HomeSlice,2701,134,5,2,7,71.4%,2h
24902,3,shorty,2701,93,3,4,7,42.9%,34m
24902,1,Meatballer,2701,122,2,1,3,66.7%,32m
24902,3,Marodox,2701,0,2,3,5,40.0%,52m
24902,3,YaoGuan,2701,0,2,4,6,33.3%,24m
24902,3,[OLDPPL]Kayslay,2701,30,2,5,7,28.6%,11m
24902,3,UvIm,2701,0,1,0,1,100.0%,34m
24902,3,Dune,2701,0,1,0,1,100.0%,44m
24902,3,WolfsLunar,2701,0,1,1,2,50.0%,31m
24902,1,roger,2701,44,1,1,2,50.0%,2h
24902,1,[MLKMEN]Milkman,2701,42,1,1,2,50.0%,8m
24902,1,[lVl]CheEsMaN,2701,0,1,2,3,33.3%,3h
24902,1,Wasabisword,2701,38,1,2,3,33.3%,2h
24902,3,[EZkill]shawnjr,2701,30,1,8,9,11.1%,37m
24902,1,Kash,2701,0,0,1,1,0.0%,2h
24902,1,DayDose,2701,0,0,3,3,0.0%,16m
24927,1,[BrVoS]GuZzOd,2700,1175,85,73,158,53.8%,2h
24927,1,Harambe,2700,729,56,44,100,56.0%,2h
24927,1,Saicess,2700,523,22,13,35,62.9%,51m
24927,3,[RSpctr]Tychlo,2700,452,20,18,38,52.6%,21m
24927,3,HunterIV,2700,414,15,19,34,44.1%,35m
24927,1,Antonf,2700,306,11,4,15,73.3%,32m
24927,1,SNAGA,2700,223,8,5,13,61.5%,2h
24927,3,Zookeeper,2700,83,8,8,16,50.0%,34m
24927,3,deadlift,2700,119,6,9,15,40.0%,7m
24927,1,[CIAD]XeJiK,2700,98,4,1,5,80.0%,1h
24927,1,TheeImmortal,2700,71,3,0,3,100.0%,2h
24927,2,Keem,2700,96,3,2,5,60.0%,2h
24927,1,Pikashu,2700,90,2,2,4,50.0%,1h
24927,1,[MoreGG]KateWissen,2700,32,2,3,5,40.0%,33m
24927,1,tommy,2700,0,2,3,5,40.0%,5m
24927,1,UnleashedAzn,2700,0,2,3,5,40.0%,52m
24927,3,Domthegrate,2700,0,2,3,5,40.0%,27m
24927,1,[SHPK]BigAristotle,2700,0,1,0,1,100.0%,3h
24927,1,Celesarn,2700,0,1,0,1,100.0%,51m
24927,2,[DigiSG]Chlorya,2700,0,1,0,1,100.0%,1h
24927,1,Stoop,2700,0,1,1,2,50.0%,36m
24927,1,[WOBA]Mira,2700,0,0,1,1,0.0%,2h
24927,1,Toughlove,2700,0,0,3,3,0.0%,2h
24950,3,Wilfredo,2699,1153,78,65,143,54.5%,11m
24950,1,MemesterOPs,2699,867,52,38,90,57.8%,2h
24950,2,MechOne,2699,513,22,29,51,43.1%,34m
24950,3,sassysquatch,2699,213,11,11,22,50.0%,27m
24950,1,GGevenifUMAD,2699,303,8,8,16,50.0%,2h
24950,1,Azure,2699,130,7,2,9,77.8%,2h
24950,1,JonnyBoy,2699,222,7,4,11,63.6%,55m
24950,3,LostWorld,2699,147,6,8,14,42.9%,43m
24950,2,Helljumper,2699,196,6,16,22,27.3%,40m
24950,1,Guez,2699,134,5,5,10,50.0%,1h
24950,3,Artac,2699,146,4,1,5,80.0%,1h
24950,1,Rykes,2699,118,4,2,6,66.7%,16m
24950,1,[CWF]JeangamerXD,2699,95,4,3,7,57.1%,16m
24950,1,[AFLG]Govenator,2699,120,3,6,9,33.3%,2h
24950,1,[UpxV]goher,2699,40,2,0,2,100.0%,2h
24950,1,Bluehaze,2699,0,2,3,5,40.0%,33m
24950,1,Seanti,2699,0,2,3,5,40.0%,58m
24950,1,WaLnUt,2699,0,1,0,1,100.0%,19m
24950,1,Slayun,2699,30,1,3,4,25.0%,1h
24950,1,[GØSU]Dread,2699,44,1,4,5,20.0%,34m
24950,1,thighgang,2699,0,0,1,1,0.0%,3h
24950,3,GareBear,2699,0,0,3,3,0.0%,14m
24950,1,Coronavirus,2699,0,0,3,3,0.0%,1h
24950,1,KayeA,2699,0,0,5,5,0.0%,13m
24974,1,comba,2698,731,106,74,180,58.9%,23m
24974,3,[4gone]Shardak,2698,1279,70,74,144,48.6%,26m
24974,1,TheClown,2698,1019,63,37,100,63.0%,31m
24974,3,MKDuFreeBird,2698,604,58,48,106,54.7%,15m
24974,1,OrdinaryNot,2698,521,36,16,52,69.2%,3h
24974,1,Magic,2698,671,25,20,45,55.6%,2h
24974,3,Najex,2698,682,25,29,54,46.3%,21m
24974,3,KeyLock,2698,418,18,14,32,56.2%,18m
24974,3,Lentex,2698,332,16,21,37,43.2%,25m
24974,3,Sicarius,2698,251,12,9,21,57.1%,19m
24974,1,Torontard,2698,32,6,5,11,54.5%,9m
24974,1,[MGQC]RacoonRider,2698,197,4,4,8,50.0%,2h
24974,1,Amescua,2698,116,4,5,9,44.4%,8m
24974,3,StevieJay,2698,176,4,7,11,36.4%,1h
24974,1,Wendigo,2698,74,3,0,3,100.0%,36m
24974,1,Destiny,2698,38,2,0,2,100.0%,52m
24974,2,Drilly,2698,96,2,3,5,40.0%,3h
24974,1,Leo,2698,0,1,0,1,100.0%,2h
24992,1,Cthulhu,2697,1631,175,134,309,56.6%,31m
24992,3,BoZz,2697,1344,156,145,301,51.8%,26m
24992,1,pppppppppppp,2697,1584,140,125,265,52.8%,1h
24992,3,[TB0C]Rufio,2697,1468,94,103,197,47.7%,8m
24992,1,[SWOU]Motomoto,2697,1668,90,76,166,54.2%,2h
24992,1,[AssSZN]SpankMaster,2697,1661,70,66,136,51.5%,42m
24992,2,zhombra,2697,724,66,70,136,48.5%,4m
24992,2,Bis,2697,506,23,20,43,53.5%,13m
24992,3,KasSadaR,2697,452,16,19,35,45.7%,8m
24992,1,[VEEV]Chef,2697,405,13,14,27,48.1%,14m
24992,1,IIIIIIIIIIII,2697,250,10,12,22,45.5%,22m
24992,1,battestar,2697,316,10,12,22,45.5%,32m
24992,3,locowarpro,2697,301,9,11,20,45.0%,15m
24992,1,senjo,2697,237,7,8,15,46.7%,24m
24992,3,MacroMaster,2697,198,7,8,15,46.7%,24m
24992,3,[WWOL]EugEnE,2697,148,6,6,12,50.0%,4m
24992,1,Sulfur,2697,110,4,4,8,50.0%,2h
24992,1,Destroyer,2697,97,4,5,9,44.4%,34m
24992,1,ThorsPewPeew,2697,96,4,7,11,36.4%,3h
24992,1,Boboski,2697,40,2,3,5,40.0%,50m
24992,1,SentaoDePana,2697,80,2,3,5,40.0%,2h
24992,3,bobnelson,2697,0,1,8,9,11.1%,26m
25014,3,SUNTZU,2696,1303,188,166,354,53.1%,40m
25014,1,Havok,2696,797,32,27,59,54.2%,3h
25014,1,dtb,2696,556,22,17,39,56.4%,51m
25014,1,Evolved,2696,350,21,20,41,51.2%,39m
25014,3,KonSpiral,2696,437,15,15,30,50.0%,26m
25014,3,SwarmySteve,2696,252,10,11,21,47.6%,34m
25014,2,Orgnash,2696,255,10,12,22,45.5%,19m
25014,3,Zoupskim,2696,199,5,8,13,38.5%,22m
25014,3,Raynorisback,2696,102,5,12,17,29.4%,32m
25014,3,[Verley]Duncan,2696,102,4,4,8,50.0%,25m
25014,3,[PvvN]okamoto,2696,60,2,6,8,25.0%,15m
25014,2,Draks,2696,0,1,0,1,100.0%,51m
25014,2,Haymitch,2696,0,1,1,2,50.0%,2h
25014,3,SgtSlaughter,2696,0,1,4,5,20.0%,15m
25014,3,MrNiceGaius,2696,30,1,8,9,11.1%,26m
25014,1,[APR]GLaaaghhLL,2696,0,0,1,1,0.0%,16m
25014,2,[KhanZ]radaguest,2696,0,0,1,1,0.0%,14m
25014,2,Darkbubbles,2696,0,0,1,1,0.0%,2h
25014,1,Zblegomaster,2696,0,0,2,2,0.0%,1h
25033,2,Andy,2695,1591,105,107,212,49.5%,35m
25033,2,[PaE]euRad,2695,893,97,94,191,50.8%,5m
25033,2,tarita,2695,445,59,56,115,51.3%,34m
25033,1,SquealinHog,2695,973,53,59,112,47.3%,27m
25033,1,Chonoon,2695,816,32,24,56,57.1%,2h
25033,1,Lenin,2695,501,20,12,32,62.5%,55m
25033,1,[CHAKA]Pizza,2695,483,18,10,28,64.3%,50m
25033,2,Mark,2695,546,18,27,45,40.0%,12m
25033,3,DJR,2695,373,17,12,29,58.6%,13m
25033,1,Arakstar,2695,412,15,10,25,60.0%,2h
25033,3,kingkilla,2695,330,13,10,23,56.5%,42m
25033,2,Zonaballer,2695,268,12,12,24,50.0%,2h
25033,1,Pepe,2695,300,9,12,21,42.9%,51m
25033,1,MineShaft,2695,188,8,2,10,80.0%,2h
25033,3,WorraLL,2695,215,8,8,16,50.0%,29m
25033,3,Tyler,2695,222,8,8,16,50.0%,9m
25033,3,loida,2695,226,7,8,15,46.7%,42m
25033,1,Tachyon,2695,99,6,7,13,46.2%,59m
25033,1,Blooha,2695,166,6,8,14,42.9%,2h
25033,3,Grumpus,2695,30,5,3,8,62.5%,24m
25033,1,WAAAHG,2695,156,5,3,8,62.5%,14m
25033,1,[AD3C]RoCkEt,2695,198,5,9,14,35.7%,6m
25033,1,maallz,2695,164,4,3,7,57.1%,2h
25033,1,[Ostie]PooterMD,2695,154,4,7,11,36.4%,15m
25033,2,Gelidbeans,2695,0,3,4,7,42.9%,12m
25033,3,Shicky,2695,0,2,3,5,40.0%,2h
25033,1,Assasin,2695,0,2,3,5,40.0%,1h
25033,1,Sloth,2695,59,2,5,7,28.6%,59m
25033,1,[1E100]Maarfon,2695,0,1,0,1,100.0%,3h
25033,1,[ClanCT]Jzerglings,2695,0,1,0,1,100.0%,50m
25033,3,fishcakeman,2695,30,1,7,8,12.5%,6m
25033,2,Kalium,2695,0,0,1,1,0.0%,10m
25033,1,[NSNTP]AngelWolf,2695,0,0,3,3,0.0%,44m
25033,3,NoGas,2695,0,0,5,5,0.0%,29m
25067,3,[char14]lilJoci,2694,1399,146,120,266,54.9%,30m
25067,3,Invictus,2694,1538,92,82,174,52.9%,37m
25067,1,SuperKing,2694,1025,69,61,130,53.1%,2h
25067,2,NeighbourJoe,2694,1030,69,67,136,50.7%,37m
25067,1,King,2694,1089,42,33,75,56.0%,1h
25067,3,Soup,2694,442,18,18,36,50.0%,10m
25067,1,GRAVES,2694,333,14,14,28,50.0%,51m
25067,3,Jroosta,2694,368,13,18,31,41.9%,32m
25067,1,[WZLN]DrMopper,2694,290,12,8,20,60.0%,48m
25067,3,DreadLordBob,2694,242,11,13,24,45.8%,30m
25067,3,Pau,2694,238,9,10,19,47.4%,29m
25067,1,[TTKOPF]Arrow,2694,188,6,5,11,54.5%,2h
25067,3,DarkHades,2694,152,6,10,16,37.5%,40m
25067,2,[CPN]ThurQuan,2694,137,4,1,5,80.0%,1h
25067,2,LemonYuYu,2694,38,4,4,8,50.0%,2h
25067,2,Sasaki,2694,139,4,5,9,44.4%,2h
25067,1,Shanwker,2694,88,3,3,6,50.0%,43m
25067,3,Challenger,2694,0,2,3,5,40.0%,52m
25067,1,Oliver,2694,0,2,3,5,40.0%,32m
25067,1,ghosttemplar,2694,0,1,0,1,100.0%,2h
25067,3,[EvilGC]MAREK,2694,30,1,6,7,14.3%,5m
25067,1,[Msia]MiEHV,2694,0,0,1,1,0.0%,6m
25067,1,lDarkSlayerl,2694,0,0,2,2,0.0%,42m
25067,1,Solostar,2694,0,0,2,2,0.0%,2h
25067,1,buDa,2694,0,0,3,3,0.0%,2h
25092,3,Tubby,2693,1072,125,135,260,48.1%,42m
25092,2,[C38108]Erick,2693,429,69,71,140,49.3%,10m
25092,3,Bash,2693,1350,54,46,100,54.0%,5m
25092,1,hayes,2693,812,30,24,54,55.6%,3h
25092,1,MANHAMMER,2693,431,16,12,28,57.1%,3h
25092,3,[TisOP]Pickles,2693,376,13,19,32,40.6%,30m
25092,3,MagicofPlaye,2693,279,9,6,15,60.0%,35m
25092,3,SageWolf,2693,276,9,8,17,52.9%,12m
25092,2,Hunting,2693,172,7,8,15,46.7%,15m
25092,1,OrdianRethos,2693,169,6,7,13,46.2%,42m
25092,1,[LQV]Asebkuo,2693,186,6,7,13,46.2%,58m
25092,1,RideSix,2693,177,5,3,8,62.5%,44m
25092,3,[868]Vishal,2693,120,4,13,17,23.5%,32m
25092,1,ferror,2693,154,3,1,4,75.0%,3h
25092,1,LarvaTopZerg,2693,138,3,3,6,50.0%,18m
25092,1,[PiN0YS]NoisyBoy,2693,94,3,3,6,50.0%,51m
25092,1,Rad,2693,144,3,4,7,42.9%,59m
25092,2,Calidine,2693,60,2,10,12,16.7%,32m
25092,1,Enigma,2693,0,1,3,4,25.0%,3h
25092,1,TTVYTSTREAM,2693,40,1,4,5,20.0%,2h
25092,3,FearDaReaper,2693,0,1,5,6,16.7%,34m
25092,1,Lukazod,2693,0,0,1,1,0.0%,2h
25092,3,SgtPepper,2693,0,0,2,2,0.0%,29m
25115,1,Edelweiss,2692,1197,90,82,172,52.3%,1h
25115,1,sdqpds,2692,1530,79,76,155,51.0%,32m
25115,1,coundukki,2692,1569,74,66,140,52.9%,3h
25115,1,ZenSha,2692,1340,54,40,94,57.4%,20m
25115,3,ColFox,2692,1117,48,39,87,55.2%,32m
25115,3,Siecje,2692,682,24,26,50,48.0%,29m
25115,1,Crowling,2692,584,23,16,39,59.0%,32m
25115,3,Wildfire,2692,502,18,21,39,46.2%,6m
25115,3,[WinD]Gis,2692,297,12,10,22,54.5%,6m
25115,3,[NLTN]outlawhaws,2692,260,9,15,24,37.5%,30m
25115,1,UBIQUE,2692,273,8,4,12,66.7%,2h
25115,1,[Leengz]Cerdoth,2692,284,8,7,15,53.3%,51m
25115,1,[AL10]KlughoRn,2692,0,1,3,4,25.0%,2h
25115,1,Computer,2692,38,1,5,6,16.7%,2h
25115,1,[Z1O1]MLordSkyler,2692,0,0,1,1,0.0%,2h
25115,1,Alzales,2692,0,0,2,2,0.0%,2h
25131,1,Barn,2691,747,24,21,45,53.3%,2h
25131,3,KillerOnline,2691,350,12,18,30,40.0%,39m
25131,3,[OceanT]Rgarrido,2691,186,6,14,20,30.0%,10m
25131,1,MisakiCat,2691,142,5,4,9,55.6%,2h
25131,3,BritishMelon,2691,73,5,6,11,45.5%,5m
25131,3,DizzyWizz,2691,148,5,11,16,31.2%,13m
25131,2,[TOCUBA]Scorpion,2691,128,4,4,8,50.0%,20m
25131,1,[GAYFUK]PUNG,2691,154,3,1,4,75.0%,50m
25131,1,Zmoneyyyyyyy,2691,0,2,3,5,40.0%,16m
25131,2,Scooterpie,2691,48,2,3,5,40.0%,3h
25131,1,AsherB,2691,0,1,1,2,50.0%,2h
25131,1,kungpowjeff,2691,0,0,1,1,0.0%,2h
25131,1,[notCo]HerOTimE,2691,0,0,1,1,0.0%,2h
25131,1,TJPD,2691,0,0,1,1,0.0%,2h
25131,1,OhmyGOAT,2691,0,0,2,2,0.0%,16m
25131,3,Bug,2691,0,0,6,6,0.0%,31m
25147,3,Tiesto,2690,1219,298,293,591,50.4%,7m
25147,1,[SWOU]ShadowMoon,2690,1101,157,135,292,53.8%,14m
25147,3,Crabe,2690,1352,80,75,155,51.6%,6m
25147,3,[NextDC]Adrián,2690,810,62,61,123,50.4%,38m
25147,1,Mariman,2690,824,29,26,55,52.7%,2h
25147,3,Warantino,2690,540,18,28,46,39.1%,15m
25147,3,Kyle,2690,347,14,12,26,53.8%,40m
25147,2,namaste,2690,334,11,17,28,39.3%,28m
25147,1,[LastKT]Ridley,2690,358,9,8,17,52.9%,51m
25147,1,blade,2690,216,7,6,13,53.8%,2h
25147,2,[Igbt]FlyinHealBus,2690,179,7,9,16,43.8%,3h
25147,1,hassassin,2690,160,6,3,9,66.7%,2h
25147,3,[RVNSBL]PakJungHe,2690,179,5,14,19,26.3%,37m
25147,2,YeshuaIsKing,2690,0,4,2,6,66.7%,57m
25147,2,[Garbg]Dreamknight,2690,138,4,5,9,44.4%,2h
25147,1,ArT,2690,66,3,2,5,60.0%,50m
25147,2,[INFSTD]Infestedpee,2690,94,3,4,7,42.9%,2h
25147,1,[LoF]Time,2690,38,2,0,2,100.0%,1h
25147,1,ShadowDemon,2690,38,2,0,2,100.0%,55m
25147,1,Precision,2690,0,2,3,5,40.0%,1h
25147,3,Redemption,2690,0,2,3,5,40.0%,42m
25147,3,Hobbes,2690,0,2,3,5,40.0%,15m
25147,1,Gabito,2690,0,2,3,5,40.0%,39m
25147,1,Coolwhip,2690,0,1,0,1,100.0%,2h
25147,1,[RTHcL]Ruud,2690,42,1,1,2,50.0%,32m
25147,1,Yellydarb,2690,0,0,1,1,0.0%,2h
25173,2,thyme,2689,1498,319,309,628,50.8%,16m
25173,3,[Chotus]Hope,2689,730,144,131,275,52.4%,8m
25173,1,Ottogi,2689,1657,107,86,193,55.4%,6m
25173,3,Siege,2689,1274,98,95,193,50.8%,32m
25173,2,[valhal]Zeroneica,2689,1108,79,81,160,49.4%,40m
25173,3,Hydrox,2689,1224,53,50,103,51.5%,23m
25173,1,JohnHughes,2689,805,42,25,67,62.7%,2h
25173,1,Vincini,2689,1070,36,37,73,49.3%,42m
25173,2,[PKMSSS]RAICHU,2689,1008,36,45,81,44.4%,10m
25173,3,EnDgAme,2689,526,19,23,42,45.2%,38m
25173,1,Sinh,2689,388,13,13,26,50.0%,15m
25173,1,SamFaRien,2689,380,11,9,20,55.0%,1h
25173,1,[P3AC3]Reflection,2689,327,11,12,23,47.8%,19m
25173,3,Ineffectual,2689,298,10,15,25,40.0%,12m
25173,3,PapelVegetal,2689,268,9,9,18,50.0%,30m
25173,3,BloodRayne,2689,202,8,8,16,50.0%,57m
25173,1,EnTaroDEHAKA,2689,188,5,6,11,45.5%,2h
25173,1,Kerostasis,2689,102,4,4,8,50.0%,38m
25173,1,JeMini,2689,92,3,5,8,37.5%,2h
25173,2,NAs,2689,0,3,5,8,37.5%,29m
25173,1,LeoMelbourne,2689,72,2,2,4,50.0%,36m
25173,1,luisito,2689,0,1,1,2,50.0%,43m
25173,1,Bad,2689,0,1,2,3,33.3%,20m
25173,1,keedwin,2689,0,1,2,3,33.3%,6m
25173,2,Shinokami,2689,46,1,2,3,33.3%,2h
25173,1,[MS1]MrMike,2689,0,0,1,1,0.0%,14m
25173,1,disciple,2689,0,0,1,1,0.0%,2h
25173,1,[VIVA]Dutch,2689,0,0,1,1,0.0%,3h
25173,1,aaaargh,2689,0,0,2,2,0.0%,2h
25173,1,[ZFC]Seb,2689,0,0,2,2,0.0%,32m
25203,3,[LOPELU]Masis,2688,1396,117,109,226,51.8%,8m
25203,3,TrainWreck,2688,506,84,82,166,50.6%,31m
25203,2,ZECTBynmo,2688,612,80,88,168,47.6%,8m
25203,1,KingZ,2688,477,54,27,81,66.7%,34m
25203,3,CorbinDallas,2688,942,34,38,72,47.2%,6m
25203,1,[ORUS]Simple,2688,878,31,28,59,52.5%,48m
25203,2,ken,2688,785,29,34,63,46.0%,19m
25203,1,[PHclan]Joy,2688,572,19,14,33,57.6%,3h
25203,3,[TLibre]patal,2688,353,11,14,25,44.0%,26m
25203,1,Haldric,2688,294,8,8,16,50.0%,51m
25203,1,[Kusshh]DeathConn,2688,240,7,7,14,50.0%,1h
25203,1,Zoe,2688,228,7,7,14,50.0%,2h
25203,1,[WSGC]LMJZerus,2688,190,5,2,7,71.4%,40m
25203,3,Tjbrown,2688,90,4,7,11,36.4%,27m
25203,3,KeyserSoze,2688,112,3,3,6,50.0%,8m
25203,1,Wildwolf,2688,124,3,5,8,37.5%,2h
25203,1,[SV]mOrpH,2688,38,2,0,2,100.0%,36m
25203,1,PonnySalvaje,2688,0,2,3,5,40.0%,52m
25203,3,Madness,2688,0,2,3,5,40.0%,2h
25203,2,LKG,2688,42,1,1,2,50.0%,26m
25203,1,Caifas,2688,34,1,5,6,16.7%,2h
25203,2,[WNTRLY]Athol,2688,0,0,1,1,0.0%,1h
25203,1,[PrA26]Levftraru,2688,0,0,1,1,0.0%,11m
25203,1,Helio,2688,0,0,2,2,0.0%,10m
25203,3,Beto,2688,0,0,5,5,0.0%,2h
25228,2,spaceman,2687,1499,226,203,429,52.7%,18m
25228,3,LengeLenge,2687,980,112,95,207,54.1%,11m
25228,2,MuadDib,2687,781,49,57,106,46.2%,34m
25228,3,hamazing,2687,354,48,30,78,61.5%,5m
25228,3,MadDog,2687,608,38,31,69,55.1%,22m
25228,3,AdunxZeratul,2687,330,15,15,30,50.0%,22m
25228,1,Snide,2687,385,13,11,24,54.2%,49m
25228,1,raspberrySC,2687,390,12,7,19,63.2%,23m
25228,1,sunnyscrambl,2687,239,12,12,24,50.0%,2h
25228,3,[Chrev]Chriskler,2687,315,11,10,21,52.4%,3h
25228,1,[TYFTRS]GrymmSundar,2687,374,10,14,24,41.7%,2h
25228,1,TSWIFT,2687,154,9,0,9,100.0%,23m
25228,1,[OlNA]Olimpos,2687,292,8,5,13,61.5%,36m
25228,3,Adimus,2687,234,8,14,22,36.4%,42m
25228,2,RiverNylon,2687,201,6,10,16,37.5%,21m
25228,1,QuaiGonJinn,2687,188,5,1,6,83.3%,32m
25228,1,Føx,2687,197,5,8,13,38.5%,44m
25228,2,BirbyBoi,2687,119,4,6,10,40.0%,31m
25228,1,joselewis,2687,115,3,0,3,100.0%,3h
25228,1,Fisher,2687,112,3,5,8,37.5%,2h
25228,1,hated,2687,0,2,3,5,40.0%,2h
25228,3,HawkeyeG,2687,0,2,4,6,33.3%,9m
25228,1,Adobo,2687,0,1,0,1,100.0%,36m
25228,2,[LIONES]PerroRabioso,2687,94,1,1,2,50.0%,9m
25228,1,betotto,2687,0,0,1,1,0.0%,3h
25228,1,Lee,2687,0,0,1,1,0.0%,6m
25228,1,TerraNova,2687,0,0,4,4,0.0%,2h
25255,1,joel,2686,1629,138,129,267,51.7%,38m
25255,3,[IDEC]starter,2686,453,73,55,128,57.0%,10m
25255,3,ZergIsBae,2686,269,58,65,123,47.2%,39m
25255,1,Popeye,2686,1427,50,45,95,52.6%,2h
25255,1,NeroX,2686,1211,46,42,88,52.3%,19m
25255,1,Enigma,2686,374,14,4,18,77.8%,11m
25255,1,GoochGobbler,2686,423,14,15,29,48.3%,26m
25255,3,KRISTALLNACH,2686,292,11,14,25,44.0%,5m
25255,1,IntriGan,2686,348,10,11,21,47.6%,23m
25255,2,ZoZo,2686,197,7,5,12,58.3%,33m
25255,3,Troddler,2686,60,6,5,11,54.5%,8m
25255,1,[sLuxx]Joon,2686,94,3,2,5,60.0%,34m
25255,2,theplumsauce,2686,0,3,3,6,50.0%,60m
25255,3,TheBrown,2686,0,2,3,5,40.0%,2h
25255,3,Venny,2686,0,2,3,5,40.0%,2h
25255,1,BlackMamba,2686,0,2,3,5,40.0%,41m
25255,1,StonedGnome,2686,0,1,2,3,33.3%,11m
25255,1,happykid,2686,32,1,3,4,25.0%,58m
25255,1,Roakin,2686,0,1,4,5,20.0%,2h
25255,1,JONO,2686,0,0,2,2,0.0%,2h
25255,1,DrJohn,2686,0,0,3,3,0.0%,16m
25255,3,gatoletal,2686,0,0,3,3,0.0%,13m
25277,1,JLDesign,2685,1548,426,431,857,49.7%,17m
25277,3,yerp,2685,1510,119,103,222,53.6%,19m
25277,3,REPORT,2685,444,116,104,220,52.7%,4m
25277,3,Zivak,2685,1479,87,84,171,50.9%,29m
25277,3,Greenstar,2685,1118,41,41,82,50.0%,17m
25277,3,Yogurt,2685,482,30,26,56,53.6%,12m
25277,3,Waddles,2685,594,24,19,43,55.8%,27m
25277,1,Gimli,2685,455,16,15,31,51.6%,2h
25277,1,Asembler,2685,421,14,15,29,48.3%,32m
25277,1,Dreadz,2685,388,12,8,20,60.0%,2h
25277,3,FoxPThree,2685,325,12,10,22,54.5%,1h
25277,2,[MKII]MACKamandag,2685,143,7,7,14,50.0%,40m
25277,1,[glhfSC]rafayel,2685,176,5,4,9,55.6%,1h
25277,2,[SFire]DemonPunk,2685,60,5,7,12,41.7%,4m
25277,1,Caymanmew,2685,96,5,8,13,38.5%,34m
25277,1,Sean,2685,160,4,6,10,40.0%,2h
25277,1,leito,2685,148,4,6,10,40.0%,59m
25277,2,pac,2685,113,3,1,4,75.0%,15m
25277,1,NSTrixXzZ,2685,96,2,1,3,66.7%,3h
25277,2,FireGoose,2685,113,2,2,4,50.0%,60m
25277,3,[NO0OBZ]MAKO,2685,0,2,3,5,40.0%,2h
25277,3,McGiblets,2685,0,2,3,5,40.0%,2h
25277,3,DeceiT,2685,0,2,4,6,33.3%,18m
25277,1,Panic,2685,0,1,1,2,50.0%,20m
25277,3,silverbullet,2685,0,1,4,5,20.0%,21m
25277,1,[GxS]Ghost,2685,0,0,1,1,0.0%,48m
25277,3,Boris,2685,0,0,4,4,0.0%,11m
25304,1,Drinkwater,2684,1746,209,211,420,49.8%,3h
25304,3,Plumage,2684,611,65,47,112,58.0%,5m
25304,2,Regal,2684,380,33,38,71,46.5%,33m
25304,1,llllllllllll,2684,128,9,9,18,50.0%,8m
25304,1,Denzille,2684,263,6,5,11,54.5%,2h
25304,1,Phanale,2684,137,6,8,14,42.9%,11m
25304,1,DaBuDing,2684,204,5,8,13,38.5%,2h
25304,2,Itokawa,2684,0,4,2,6,66.7%,33m
25304,1,Farit,2684,138,4,7,11,36.4%,2h
25304,1,[Groovy]eryo,2684,93,3,1,4,75.0%,32m
25304,1,CantTouchMe,2684,72,3,2,5,60.0%,9m
25304,1,[JINGO]Bluecat,2684,115,3,3,6,50.0%,2h
25304,3,Warmtrooper,2684,145,3,7,10,30.0%,8m
25304,2,SwarthyMcTit,2684,94,2,0,2,100.0%,2h
25304,3,Creepybard,2684,0,2,3,5,40.0%,17m
25304,3,krahuz,2684,0,1,0,1,100.0%,44m
25304,2,somniferous,2684,0,1,0,1,100.0%,2h
25304,1,[SvrKer]FKonFSRTdate,2684,40,1,1,2,50.0%,1h
25304,1,FrankPZT,2684,0,1,4,5,20.0%,3h
25304,1,[AoBDE]Oppenheimer,2684,0,0,1,1,0.0%,35m
25304,1,[Weeeeb]Starkoss,2684,0,0,1,1,0.0%,41m
25304,1,liluk,2684,0,0,1,1,0.0%,2h
25304,1,[TGCrew]Oebrun,2684,0,0,2,2,0.0%,2h
25327,1,PileDriver,2683,1055,218,205,423,51.5%,2h
25327,3,cguajardo,2683,1500,139,109,248,56.0%,10m
25327,3,Daraku,2683,1422,72,50,122,59.0%,29m
25327,1,[SUDAKA]TERRANCITY,2683,1145,72,55,127,56.7%,48m
25327,1,[TENO]CrazySC,2683,1009,72,56,128,56.2%,34m
25327,1,[PiN0YS]Grey,2683,1254,54,37,91,59.3%,3h
25327,1,Kohel,2683,595,28,11,39,71.8%,2h
25327,3,MaStAcOuNaS,2683,511,23,17,40,57.5%,10m
25327,3,Dulcet,2683,580,22,21,43,51.2%,25m
25327,1,Wolf,2683,302,11,11,22,50.0%,35m
25327,3,Yobo,2683,272,10,12,22,45.5%,29m
25327,1,[BlTEL]masterlol,2683,302,9,8,17,52.9%,38m
25327,3,CriscoDisco,2683,264,9,16,25,36.0%,32m
25327,3,TicklemeFat,2683,244,9,16,25,36.0%,33m
25327,1,[MadLin]Olego,2683,276,8,8,16,50.0%,2h
25327,3,Aerren,2683,0,4,2,6,66.7%,8m
25327,2,Struggler,2683,140,4,4,8,50.0%,18m
25327,2,[QBQB]JOJOSTAR,2683,0,4,4,8,50.0%,4m
25327,2,Natezy,2683,0,3,3,6,50.0%,2h
25327,1,Funkernaut,2683,108,3,4,7,42.9%,2h
25327,3,BicoPreto,2683,30,3,6,9,33.3%,19m
25327,2,YunoGasai,2683,94,2,0,2,100.0%,2h
25327,1,CMTCaptain,2683,84,2,2,4,50.0%,42m
25327,1,[ZGs]Syao,2683,0,2,3,5,40.0%,3h
25327,3,[UNCO]carrsdoom,2683,42,2,4,6,33.3%,2h
25327,3,[10TKL]Titan,2683,30,2,8,10,20.0%,31m
25327,1,Adezx,2683,0,1,0,1,100.0%,1h
25327,1,Senart,2683,0,1,3,4,25.0%,3h
25327,3,[Ch3ck]SeMaGdNiM,2683,0,0,1,1,0.0%,2h
25327,1,HeroStyle,2683,0,0,1,1,0.0%,58m
25327,1,MrTaco,2683,0,0,1,1,0.0%,12m
25327,1,[EvilGC]Leonidas,2683,0,0,2,2,0.0%,3h
25327,1,torquestomp,2683,0,0,3,3,0.0%,2h
25360,2,Vinnykai,2682,1298,232,215,447,51.9%,37m
25360,3,Tales,2682,1543,170,158,328,51.8%,7m
25360,1,BadLadurette,2682,1207,157,135,292,53.8%,55m
25360,3,Grandis,2682,1659,94,93,187,50.3%,6m
25360,2,GANGHAPS,2682,912,54,56,110,49.1%,6m
25360,3,iloveoov,2682,792,31,30,61,50.8%,20m
25360,2,[CRAKS]CeifeiroSD,2682,174,23,35,58,39.7%,40m
25360,3,Gamble,2682,314,15,12,27,55.6%,25m
25360,3,longjon,2682,349,14,13,27,51.9%,8m
25360,1,Sonic,2682,325,12,14,26,46.2%,55m
25360,3,[Pizzy]kadesh,2682,205,7,3,10,70.0%,1h
25360,1,BIizzard,2682,171,7,7,14,50.0%,58m
25360,1,[xEAx]DeadlyKitten,2682,164,6,2,8,75.0%,10m
25360,3,KEONS,2682,222,6,9,15,40.0%,28m
25360,1,TomCruiser,2682,180,5,5,10,50.0%,3h
25360,3,[Macac0]Adarel,2682,148,5,10,15,33.3%,18m
25360,2,Yololxd,2682,46,2,1,3,66.7%,26m
25360,3,Lalonde,2682,46,2,4,6,33.3%,2h
25360,1,Stevano,2682,120,2,6,8,25.0%,59m
25360,1,[TgAg]erddle,2682,0,1,0,1,100.0%,38m
25360,1,Impulse,2682,34,1,2,3,33.3%,36m
25360,1,[Vales]Kalthazard,2682,0,1,4,5,20.0%,1h
25360,1,Neovoodu,2682,0,0,1,1,0.0%,26m
25383,1,StormFarron,2681,1749,142,140,282,50.4%,12m
25383,3,[cluez]Titimi,2681,1141,43,44,87,49.4%,37m
25383,3,[TGCF]Yuki,2681,516,21,24,45,46.7%,8m
25383,1,AnnaMolli,2681,451,17,15,32,53.1%,2h
25383,3,BibendUm,2681,348,13,14,27,48.1%,41m
25383,1,Ymit,2681,218,9,7,16,56.2%,2h
25383,1,Xymox,2681,230,7,5,12,58.3%,39m
25383,3,Iwould,2681,146,7,10,17,41.2%,57m
25383,3,aayeung,2681,194,6,7,13,46.2%,2h
25383,1,GnosGnis,2681,161,5,5,10,50.0%,20m
25383,1,Mysterio,2681,140,4,4,8,50.0%,36m
25383,1,Missingno,2681,128,4,10,14,28.6%,35m
25383,1,[XNANIX]juanpax,2681,146,3,1,4,75.0%,58m
25383,3,[KKKKK]iBeetle,2681,0,2,3,5,40.0%,2h
25383,1,Swan,2681,0,2,3,5,40.0%,1h
25383,1,[XpKAc]Hoperrs,2681,88,2,4,6,33.3%,3h
25383,1,Kilope,2681,74,2,7,9,22.2%,58m
25383,3,santisgamer,2681,0,1,0,1,100.0%,15m
25383,1,zalamobi,2681,0,0,2,2,0.0%,2h
25383,1,[Heer]DOBLEV,2681,0,0,4,4,0.0%,3h
25403,3,PROTHORMAN,2680,1583,168,166,334,50.3%,32m
25403,3,TigerRock,2680,1533,122,104,226,54.0%,32m
25403,3,[GL1ES]creeed,2680,904,61,66,127,48.0%,38m
25403,1,[cl0udM]burmel,2680,918,32,32,64,50.0%,41m
25403,1,[UDHR]UnderFt,2680,434,17,13,30,56.7%,2h
25403,1,Morianer,2680,304,13,11,24,54.2%,16m
25403,1,ATLien,2680,442,13,15,28,46.4%,3h
25403,1,JLR,2680,380,11,13,24,45.8%,37m
25403,3,Cyrus,2680,30,5,3,8,62.5%,19m
25403,1,Bullshooter,2680,135,5,4,9,55.6%,54m
25403,2,exL,2680,0,3,3,6,50.0%,48m
25403,1,barcOde,2680,114,3,3,6,50.0%,2h
25403,1,[MNSV]Traum,2680,0,2,3,5,40.0%,44m
25403,1,Dewbie,2680,78,2,5,7,28.6%,32m
25403,1,artanis,2680,42,1,1,2,50.0%,48m
25403,3,skynet,2680,0,1,1,2,50.0%,47m
25403,1,Milagros,2680,0,0,1,1,0.0%,2h
25420,3,HeartofOhio,2679,1525,127,114,241,52.7%,29m
25420,1,EngelM,2679,1081,58,46,104,55.8%,13m
25420,1,Kristineator,2679,947,31,30,61,50.8%,2h
25420,1,KingDabs,2679,893,29,25,54,53.7%,2h
25420,1,JohnyDaMylla,2679,548,25,15,40,62.5%,2h
25420,1,McFreaK,2679,529,21,15,36,58.3%,32m
25420,2,OfficerNasty,2679,516,21,27,48,43.8%,34m
25420,3,[mmKay]MntBryCrunch,2679,352,14,14,28,50.0%,19m
25420,1,SamSpade,2679,305,11,6,17,64.7%,14m
25420,1,Ironside,2679,294,8,11,19,42.1%,2h
25420,1,Logeeker,2679,0,5,4,9,55.6%,2h
25420,1,adotout,2679,48,5,6,11,45.5%,2h
25420,1,[SC2BOL]jhessy,2679,162,5,6,11,45.5%,2h
25420,1,Stefou,2679,151,4,0,4,100.0%,20m
25420,1,[BBDB]Zalathor,2679,116,4,5,9,44.4%,58m
25420,2,Unity,2679,0,3,5,8,37.5%,21m
25420,3,[TacoCQ]Matthius,2679,0,2,3,5,40.0%,2h
25420,1,Bombah,2679,68,2,4,6,33.3%,13m
25420,3,IHATEGAMES,2679,0,2,5,7,28.6%,19m
25420,1,Falmeer,2679,0,1,0,1,100.0%,20m
25420,1,Rez,2679,0,1,0,1,100.0%,58m
25420,1,[Over1]joel,2679,36,1,3,4,25.0%,42m
25420,1,IlIlIlIl,2679,97,1,5,6,16.7%,1h
25420,1,LightGoneBad,2679,42,1,6,7,14.3%,1h
25420,1,TwiceDahyun,2679,0,0,1,1,0.0%,1h
25420,3,CaptainSisko,2679,0,0,2,2,0.0%,19m
25420,1,Hirron,2679,0,0,4,4,0.0%,50m
25420,1,Pardave,2679,0,0,5,5,0.0%,7m
25448,2,RonZergondy,2678,1481,87,86,173,50.3%,12m
25448,1,[WCSOil]SpanishAsian,2678,574,19,18,37,51.4%,2h
25448,2,OffaLion,2678,391,17,18,35,48.6%,21m
25448,3,Hoople,2678,377,14,14,28,50.0%,12m
25448,3,DrChed,2678,347,12,12,24,50.0%,14m
25448,1,HeatoN,2678,157,4,1,5,80.0%,2h
25448,1,[VNZ]squidy,2678,102,4,4,8,50.0%,34m
25448,2,[MMSTAR]JohnWulgaru,2678,46,4,5,9,44.4%,44m
25448,3,Zereal,2678,118,4,9,13,30.8%,29m
25448,3,Xenon,2678,0,3,2,5,60.0%,2h
25448,1,[EtVoy]GGboy,2678,44,1,1,2,50.0%,3h
25448,3,pewp,2678,0,1,6,7,14.3%,43m
25448,3,FLIP,2678,91,1,9,10,10.0%,18m
25448,3,[GARD3N]BobTheTomato,2678,0,0,1,1,0.0%,47m
25448,1,Noobsk,2678,0,0,1,1,0.0%,2h
25448,1,Freeman,2678,0,0,3,3,0.0%,2h
25448,1,Murphy,2678,0,0,6,6,0.0%,2h
25465,1,[GOPERÚ]killadiction,2677,1413,54,53,107,50.5%,55m
25465,3,BattlePants,2677,1374,50,57,107,46.7%,24m
25465,1,Caspuhh,2677,425,47,40,87,54.0%,36m
25465,3,Kane,2677,1032,41,46,87,47.1%,26m
25465,3,logix,2677,346,33,27,60,55.0%,14m
25465,3,efincranes,2677,478,19,30,49,38.8%,23m
25465,3,[iMOAN]Necroxion,2677,488,18,21,39,46.2%,30m
25465,3,[GOOBUE]TheWalrus,2677,354,15,13,28,53.6%,8m
25465,1,Maximus,2677,446,12,13,25,48.0%,39m
25465,1,[SCVM]Meat,2677,284,9,8,17,52.9%,3h
25465,3,Bane,2677,171,8,5,13,61.5%,41m
25465,1,[lHAPl]OlwGyeuz,2677,218,7,6,13,53.8%,26m
25465,3,ASTROMIC,2677,242,7,8,15,46.7%,12m
25465,1,Malditoleo,2677,124,7,8,15,46.7%,2h
25465,1,CorpseTrench,2677,48,5,4,9,55.6%,58m
25465,1,TheSituation,2677,134,4,3,7,57.1%,41m
25465,1,Josseth,2677,134,4,5,9,44.4%,3h
25465,1,HmLee,2677,32,3,4,7,42.9%,6m
25465,3,BlackBurn,2677,0,2,3,5,40.0%,53m
25465,1,IsThisReal,2677,0,2,4,6,33.3%,6m
25465,1,[Ventr2]Suagalishes,2677,0,1,0,1,100.0%,15m
25465,2,BlueDream,2677,0,1,1,2,50.0%,14m
25465,1,[GRNSKN]MasterJames,2677,38,1,3,4,25.0%,32m
25465,1,[WNTRCH]Kache,2677,0,0,2,2,0.0%,26m
25465,1,Javo,2677,0,0,2,2,0.0%,2h
25465,2,Triggered,2677,0,0,2,2,0.0%,2h
25491,1,Jesse,2676,1735,157,144,301,52.2%,2h
25491,1,JUANTOPO,2676,1674,88,78,166,53.0%,49m
25491,2,Joe,2676,866,31,38,69,44.9%,21m
25491,3,jazzneel,2676,452,17,20,37,45.9%,26m
25491,3,Chaotic,2676,441,16,15,31,51.6%,22m
25491,1,[lLiTl]megabob,2676,318,10,18,28,35.7%,41m
25491,2,ybyb,2676,258,9,12,21,42.9%,2h
25491,3,Pwnr,2676,208,7,11,18,38.9%,29m
25491,1,mjm,2676,177,6,1,7,85.7%,38m
25491,1,RavenLord,2676,76,6,3,9,66.7%,13m
25491,1,Raize,2676,237,6,8,14,42.9%,52m
25491,3,Garrett,2676,194,6,11,17,35.3%,40m
25491,1,[LifeF]SharkTooth,2676,134,5,2,7,71.4%,27m
25491,2,Remo,2676,107,4,3,7,57.1%,21m
25491,2,Guren,2676,0,3,4,7,42.9%,37m
25491,1,Decreed,2676,110,3,6,9,33.3%,2h
25491,1,[mocat]FAPZILLA,2676,36,2,2,4,50.0%,39m
25491,3,FrieDaddy,2676,0,2,3,5,40.0%,4m
25491,1,ComeGatos,2676,28,2,3,5,40.0%,32m
25491,3,[PHUB]DoNoHoes,2676,60,2,9,11,18.2%,21m
25491,1,[OceanT]BLACK,2676,42,1,1,2,50.0%,37m
25491,1,Sorrow,2676,36,1,2,3,33.3%,2h
25491,2,[TRFC]Penguin,2676,0,0,1,1,0.0%,2h
25491,1,Bakuh,2676,0,0,2,2,0.0%,35m
25491,1,KingKarma,2676,0,0,2,2,0.0%,2h
25516,1,SwankyOrc,2675,1242,47,43,90,52.2%,34m
25516,1,[usbr]Broformist,2675,1034,42,30,72,58.3%,16m
25516,3,[GOPERÚ]JorgeMA,2675,824,34,31,65,52.3%,4m
25516,1,alekays,2675,549,30,18,48,62.5%,1h
25516,1,[mewth]Catman,2675,520,17,17,34,50.0%,37m
25516,3,pdizzy,2675,424,14,17,31,45.2%,18m
25516,1,DatOlDerp,2675,324,12,13,25,48.0%,2h
25516,1,PoGGeRs,2675,168,9,11,20,45.0%,2h
25516,1,ABAR,2675,236,7,7,14,50.0%,50m
25516,3,Bloodrider,2675,240,7,11,18,38.9%,17m
25516,1,[GDKND]xSkyFirex,2675,192,6,2,8,75.0%,20m
25516,1,[SaltyJ]NoodleMASTA,2675,0,4,2,6,66.7%,3h
25516,3,[iiTz]UnKnowN,2675,158,4,8,12,33.3%,37m
25516,1,[Over1]Andrexet,2675,121,3,2,5,60.0%,1h
25516,2,TaylorSwift,2675,0,3,4,7,42.9%,2h
25516,1,Oliverk,2675,40,3,4,7,42.9%,58m
25516,3,Zodd,2675,62,3,10,13,23.1%,29m
25516,3,[MTMGG]MasonOR,2675,30,2,5,7,28.6%,5m
25516,1,[TRK96]CrizzAlex,2675,0,0,1,1,0.0%,3h
25535,2,ramthed,2674,1423,174,165,339,51.3%,43m
25535,1,squid,2674,1732,152,134,286,53.1%,58m
25535,1,GeovannySTV,2674,1599,92,66,158,58.2%,2h
25535,1,DrPoo,2674,744,84,65,149,56.4%,3h
25535,3,Guilherme,2674,834,47,48,95,49.5%,36m
25535,3,[4g63]Anomaly,2674,876,38,35,73,52.1%,41m
25535,1,awwdamnit,2674,690,26,21,47,55.3%,2h
25535,1,Spartacus,2674,437,24,16,40,60.0%,34m
25535,1,lazyllama,2674,589,22,18,40,55.0%,2h
25535,3,WarHeart,2674,538,21,21,42,50.0%,21m
25535,3,DRSS,2674,538,21,25,46,45.7%,21m
25535,1,[BrzLH]Samsite,2674,535,17,19,36,47.2%,1h
25535,1,SCVlivesMatr,2674,420,12,13,25,48.0%,2h
25535,1,Klank,2674,324,11,10,21,52.4%,2h
25535,3,csut,2674,274,10,7,17,58.8%,51m
25535,1,StarCruiser,2674,196,6,5,11,54.5%,32m
25535,1,[Sbr2th]Matius,2674,114,2,1,3,66.7%,2h
25535,1,RED,2674,0,2,2,4,50.0%,32m
25535,3,CorgiElvis,2674,0,2,4,6,33.3%,43m
25535,1,Chunky,2674,38,2,4,6,33.3%,32m
25535,1,Minato,2674,0,1,0,1,100.0%,59m
25535,3,MarkReactor,2674,0,0,1,1,0.0%,50m
25535,1,BlackSwarm,2674,0,0,1,1,0.0%,16m
25535,1,[121GW]SCHMIDT,2674,0,0,2,2,0.0%,2h
25559,3,Purpura,2673,1407,203,198,401,50.6%,24m
25559,1,GranBajoPode,2673,861,30,28,58,51.7%,19m
25559,3,Goldsound,2673,207,28,26,54,51.9%,27m
25559,1,Quintus,2673,802,27,25,52,51.9%,49m
25559,3,NightVizion,2673,467,25,10,35,71.4%,40m
25559,3,[SKSR]zephyr,2673,301,19,23,42,45.2%,9m
25559,1,Teshnuburr,2673,380,18,13,31,58.1%,1h
25559,1,ivantheblue,2673,275,13,11,24,54.2%,3h
25559,3,Ninjasheep,2673,305,10,13,23,43.5%,25m
25559,1,WolfOfMibu,2673,336,9,10,19,47.4%,51m
25559,1,llllllllllll,2673,270,8,10,18,44.4%,32m
25559,1,[INXS]ThievingHobo,2673,178,6,3,9,66.7%,44m
25559,1,AlejoPepintu,2673,108,5,4,9,55.6%,44m
25559,2,DaaaamnGirl,2673,176,5,5,10,50.0%,2h
25559,2,[SbT]Hast,2673,139,4,4,8,50.0%,2h
25559,1,[TeamKL]Enrique,2673,126,4,5,9,44.4%,3h
25559,2,[Sooner]Chanh,2673,0,3,3,6,50.0%,2h
25559,2,BohnJailey,2673,92,2,0,2,100.0%,9m
25559,1,playshigh,2673,36,2,5,7,28.6%,6m
25559,1,Eberk,2673,0,1,0,1,100.0%,37m
25559,1,TPNS,2673,0,1,1,2,50.0%,2h
25559,1,[EvilGC]richie,2673,97,1,4,5,20.0%,7m
25559,3,[WAYV]billsthedog,2673,0,0,7,7,0.0%,10m
25582,2,Fledezma,2672,1473,296,304,600,49.3%,38m
25582,1,CristaGoga,2672,1692,133,98,231,57.6%,3h
25582,1,DaLord,2672,1638,87,77,164,53.0%,3h
25582,1,howflyboys,2672,1660,87,77,164,53.0%,1h
25582,1,[DubDom]LithicLeafy,2672,1116,78,80,158,49.4%,10m
25582,2,falconlm,2672,1315,77,81,158,48.7%,17m
25582,2,[ZTempz]Everest,2672,1200,51,53,104,49.0%,44m
25582,1,LoneDrone,2672,943,48,36,84,57.1%,32m
25582,3,LDQ,2672,1040,37,40,77,48.1%,29m
25582,1,DRoyalArmy,2672,519,27,13,40,67.5%,3h
25582,1,[Fever]TotalChaos,2672,413,21,6,27,77.8%,36m
25582,1,BladeRunner,2672,533,21,19,40,52.5%,51m
25582,1,[SRank]EvilOreoCake,2672,547,19,20,39,48.7%,1h
25582,3,auRElIiuz,2672,461,19,20,39,48.7%,21m
25582,1,Quero,2672,387,16,17,33,48.5%,44m
25582,1,Smierc,2672,281,10,14,24,41.7%,44m
25582,3,Verserk,2672,190,6,7,13,46.2%,8m
25582,3,[JA]Jaminator,2672,189,6,9,15,40.0%,30m
25582,2,[Kunz]MElegend,2672,182,6,21,27,22.2%,37m
25582,1,Erod,2672,224,5,4,9,55.6%,3h
25582,1,chuushi,2672,70,3,2,5,60.0%,37m
25582,1,zdyx,2672,112,3,4,7,42.9%,18m
25582,1,OhMyDayum,2672,0,3,5,8,37.5%,2h
25582,2,HelloWorld,2672,0,1,0,1,100.0%,2h
25582,3,[Uzu]MaestroSol,2672,0,1,2,3,33.3%,8m
25582,1,Telekino,2672,0,1,2,3,33.3%,2h
25582,1,Kidtoy,2672,0,0,1,1,0.0%,44m
25582,1,Mini,2672,0,0,1,1,0.0%,2h
25582,1,fate,2672,0,0,3,3,0.0%,2h
25582,3,CollaredPika,2672,0,0,6,6,0.0%,37m
25612,3,Klaus,2671,1571,570,543,1113,51.2%,36m
25612,3,Seanyjoon,2671,1302,93,96,189,49.2%,21m
25612,1,Greatniz,2671,1097,61,53,114,53.5%,43m
25612,3,[b3n]brandog,2671,803,52,33,85,61.2%,10m
25612,1,Spatula,2671,450,48,44,92,52.2%,3h
25612,1,Nick,2671,621,34,28,62,54.8%,32m
25612,1,Sirpacsalot,2671,583,21,14,35,60.0%,9m
25612,1,igotdembombs,2671,392,15,9,24,62.5%,54m
25612,1,LeTaLMaChinE,2671,348,11,10,21,52.4%,2h
25612,2,[GOPERÚ]deathwork,2671,256,9,10,19,47.4%,39m
25612,1,Vipek,2671,206,8,2,10,80.0%,2h
25612,3,Cookiller,2671,182,6,12,18,33.3%,9m
25612,1,SirZepre,2671,203,5,5,10,50.0%,3h
25612,1,[RedHat]juliuspark,2671,125,5,7,12,41.7%,3h
25612,1,Thunderking,2671,74,3,3,6,50.0%,32m
25612,3,MadSaint,2671,36,3,3,6,50.0%,56m
25612,1,Gear,2671,38,2,0,2,100.0%,2h
25612,1,[ZTJ]mobuis,2671,97,2,2,4,50.0%,12m
25612,1,Pablo,2671,0,2,3,5,40.0%,16m
25612,3,Acizzle,2671,0,2,3,5,40.0%,23m
25612,1,KimTaeHyung,2671,0,2,4,6,33.3%,2h
25612,1,[CADES]EightBaLL,2671,0,1,3,4,25.0%,2h
25612,1,thinktank,2671,0,1,5,6,16.7%,1h
25612,1,Science,2671,38,1,6,7,14.3%,13m
25612,3,ManOnFire,2671,0,0,1,1,0.0%,17m
25612,1,NPCmajor,2671,0,0,1,1,0.0%,40m
25612,1,Ghost,2671,0,0,1,1,0.0%,2h
25612,2,DEATH,2671,0,0,1,1,0.0%,1h
25612,2,VascoFJV,2671,0,0,1,1,0.0%,3h
25612,1,[DarkW]king,2671,0,0,2,2,0.0%,2h
25642,2,IlllllIlllll,2670,1009,161,154,315,51.1%,33m
25642,3,Inferno,2670,602,80,77,157,51.0%,27m
25642,1,Alucard,2670,318,40,26,66,60.6%,2h
25642,1,GrimSlm,2670,627,40,36,76,52.6%,54m
25642,3,Tassader,2670,908,32,37,69,46.4%,41m
25642,1,[LifeF]COMMANDER,2670,698,23,25,48,47.9%,43m
25642,1,[YomYom]ButterNugget,2670,541,18,24,42,42.9%,2h
25642,1,Tata,2670,550,17,21,38,44.7%,20m
25642,2,Conrad,2670,386,12,25,37,32.4%,7m
25642,3,hERO,2670,244,11,6,17,64.7%,23m
25642,1,[ALaCR]pleeniweeni,2670,238,10,9,19,52.6%,44m
25642,3,Scharf,2670,250,9,10,19,47.4%,31m
25642,3,[TeaTym]TeVGrumpyCat,2670,186,7,11,18,38.9%,18m
25642,2,PorGeXiong,2670,30,5,5,10,50.0%,42m
25642,1,[JAC9]ProtossBeast,2670,186,4,7,11,36.4%,15m
25642,2,Panzer,2670,83,3,4,7,42.9%,1h
25642,2,[L4P]Nettius,2670,48,3,5,8,37.5%,2h
25642,3,[XpKAc]Mak,2670,58,3,5,8,37.5%,13m
25642,1,[xARGx]FallpaESP,2670,0,2,3,5,40.0%,36m
25642,1,ChaosTheory,2670,80,2,4,6,33.3%,3h
25642,1,[AbcCo]PecesitoUwU,2670,0,1,1,2,50.0%,3h
25663,2,NOMOOKOON,2669,1580,142,137,279,50.9%,31m
25663,3,MaUkTaY,2669,1108,89,72,161,55.3%,30m
25663,1,Yoma,2669,1324,59,65,124,47.6%,22m
25663,3,[KuZu]Katsushika,2669,1303,56,46,102,54.9%,29m
25663,3,KingZaZz,2669,1043,50,48,98,51.0%,23m
25663,2,Shinobubo,2669,514,32,32,64,50.0%,15m
25663,3,IIIIIIIIIlII,2669,914,32,41,73,43.8%,40m
25663,1,[Cojudo]Fozz,2669,353,30,17,47,63.8%,2h
25663,2,[UnkHD]KingSC,2669,616,29,31,60,48.3%,15m
25663,1,TheBoyz,2669,256,8,7,15,53.3%,36m
25663,2,Table,2669,139,4,4,8,50.0%,2h
25663,1,KaGe,2669,0,3,2,5,60.0%,38m
25663,3,[xTQc]PokeToss,2669,90,3,3,6,50.0%,19m
25663,1,bebangzkie,2669,91,3,3,6,50.0%,20m
25663,1,FearlessTaco,2669,0,2,3,5,40.0%,42m
25663,1,BusupYaHead,2669,0,2,3,5,40.0%,19m
25663,1,Protoman,2669,0,2,3,5,40.0%,54m
25663,2,[Flar3s]xyler,2669,0,1,0,1,100.0%,2h
25663,2,[Diro]xpfighter,2669,0,0,1,1,0.0%,34m
25663,1,EvilKing,2669,0,0,1,1,0.0%,2h
25683,1,bigz,2668,1724,300,283,583,51.5%,48m
25683,3,[otacus]lvAnKiRitO,2668,1258,150,142,292,51.4%,2m
25683,3,boat,2668,1545,143,125,268,53.4%,23m
25683,3,Chinchitos,2668,1545,78,74,152,51.3%,29m
25683,3,Marusya,2668,1355,63,60,123,51.2%,41m
25683,1,Priapizm,2668,713,55,43,98,56.1%,2h
25683,1,Gustavus,2668,700,28,26,54,51.9%,40m
25683,1,[FtT]MonstrO,2668,321,26,20,46,56.5%,3h
25683,1,[TR1912]syncSugarman,2668,563,23,19,42,54.8%,2h
25683,3,Ireniicus,2668,516,19,27,46,41.3%,7m
25683,1,Daigon,2668,370,17,15,32,53.1%,2h
25683,2,[asldkf]Rigel,2668,376,17,21,38,44.7%,2m
25683,3,BlackWorm,2668,325,13,15,28,46.4%,12m
25683,1,KalBert,2668,234,11,7,18,61.1%,42m
25683,1,StarPeluche,2668,198,10,0,10,100.0%,32m
25683,1,passerby,2668,192,9,10,19,47.4%,2h
25683,3,Jerematic,2668,124,5,5,10,50.0%,18m
25683,1,nuCLEAR,2668,148,4,8,12,33.3%,36m
25683,3,[We5uck]Homeboy,2668,144,3,5,8,37.5%,37m
25683,1,iyc,2668,62,3,6,9,33.3%,44m
25683,2,sugarchicken,2668,0,2,4,6,33.3%,11m
25683,1,CareBear,2668,0,2,4,6,33.3%,1h
25683,3,Fattylumpkin,2668,0,2,4,6,33.3%,9m
25683,3,[DarkPG]fabianfabian,2668,119,2,6,8,25.0%,3m
25683,3,TheGreekGuy,2668,0,0,1,1,0.0%,2h
25683,1,Fazootle,2668,0,0,2,2,0.0%,16m
25709,1,Jaeger,2667,719,112,89,201,55.7%,22m
25709,1,[G79]Crayton,2667,1558,111,105,216,51.4%,59m
25709,1,[IGeaL]repanpan,2667,1023,49,38,87,56.3%,58m
25709,1,TWU,2667,893,47,41,88,53.4%,2h
25709,1,Belbrose,2667,1171,47,47,94,50.0%,3h
25709,3,[ILikeU]YOUNgLUCKy,2667,871,34,33,67,50.7%,31m
25709,3,[OOCG]DOA,2667,633,32,32,64,50.0%,31m
25709,1,amirhamzah,2667,339,28,20,48,58.3%,3h
25709,1,[ExcIgN]InsertText,2667,611,24,13,37,64.9%,21m
25709,1,Ellusion,2667,756,24,25,49,49.0%,2h
25709,3,[Calx]Gravity,2667,404,22,24,46,47.8%,8m
25709,1,Kikiom,2667,301,12,7,19,63.2%,2h
25709,1,BrUnObr,2667,109,6,3,9,66.7%,3h
25709,1,Robbri,2667,112,6,6,12,50.0%,19m
25709,1,youGotREKT,2667,95,3,0,3,100.0%,2h
25709,1,[TNatCo]birdflu,2667,0,2,3,5,40.0%,6m
25709,1,[0d1N5]Anubis,2667,101,2,3,5,40.0%,15m
25709,3,Clarity,2667,0,1,0,1,100.0%,4m
25709,1,Gooz,2667,0,1,0,1,100.0%,24m
25709,3,Amityville,2667,0,1,2,3,33.3%,14m
25709,1,[Weac]BroodScum,2667,0,1,2,3,33.3%,2h
25709,1,MrBamboO,2667,30,1,2,3,33.3%,2h
25709,1,Darkfuzion,2667,0,0,1,1,0.0%,43m
25709,1,LtJoshlamar,2667,0,0,3,3,0.0%,1h
25733,3,WorseThanYou,2666,1031,180,170,350,51.4%,22m
25733,2,SpaceGuacho,2666,1105,68,75,143,47.6%,15m
25733,1,RadVik,2666,1068,60,47,107,56.1%,2h
25733,1,lugia,2666,1096,46,33,79,58.2%,44m
25733,3,Ninja,2666,288,34,34,68,50.0%,26m
25733,1,squirrel,2666,537,24,12,36,66.7%,2h
25733,3,Choco,2666,520,20,26,46,43.5%,8m
25733,1,Doooobie,2666,465,19,9,28,67.9%,37m
25733,1,LOCOTAKU,2666,502,18,16,34,52.9%,1h
25733,3,[FxL]Abberion,2666,359,14,17,31,45.2%,8m
25733,3,[Zeiv]katsuo,2666,209,13,21,34,38.2%,15m
25733,1,Mato,2666,286,10,9,19,52.6%,2h
25733,1,Gregh,2666,284,9,8,17,52.9%,26m
25733,1,IXTROISY,2666,316,9,11,20,45.0%,1h
25733,1,[LgnTDS]Timmy,2666,245,8,4,12,66.7%,33m
25733,1,Ragamuffin,2666,170,7,7,14,50.0%,32m
25733,3,MjrWilson,2666,89,5,8,13,38.5%,1m
25733,1,KillerClown,2666,122,3,0,3,100.0%,2h
25733,2,Ariadust,2666,185,3,3,6,50.0%,49m
25733,3,blank,2666,0,3,3,6,50.0%,5m
25733,1,therealsumme,2666,0,2,2,4,50.0%,3h
25733,3,Kadahji,2666,0,2,3,5,40.0%,17m
25733,1,[LGNxx]Shadow,2666,0,1,0,1,100.0%,3h
25733,1,You,2666,0,1,1,2,50.0%,2h
25733,1,[BUNY]Brian,2666,0,1,4,5,20.0%,3h
25733,1,manlynyancat,2666,42,1,6,7,14.3%,52m
25733,1,[NextDC]dalilachan,2666,0,0,1,1,0.0%,2h
25760,1,DrHyde,2665,1517,185,180,365,50.7%,14m
25760,3,Able,2665,1521,123,117,240,51.2%,29m
25760,3,barononeway,2665,1562,102,91,193,52.8%,12m
25760,3,[UpxV]MrLimn,2665,1301,56,42,98,57.1%,8m
25760,1,Tegent,2665,1151,45,38,83,54.2%,32m
25760,3,DBCoot,2665,485,31,31,62,50.0%,21m
25760,1,ftJinJow,2665,298,18,14,32,56.2%,34m
25760,3,solis,2665,285,11,11,22,50.0%,2h
25760,1,bananamon,2665,240,8,6,14,57.1%,6m
25760,1,Kurakding,2665,122,5,4,9,55.6%,21m
25760,1,Oumuamua,2665,88,3,3,6,50.0%,11m
25760,2,[StBs]Opt,2665,97,3,4,7,42.9%,15m
25760,2,Frood,2665,0,3,5,8,37.5%,2m
25760,3,Humble,2665,92,3,5,8,37.5%,40m
25760,1,[ScScUr]LCD,2665,38,2,1,3,66.7%,48m
25760,1,[ouin]Wyck,2665,36,2,2,4,50.0%,43m
25760,1,Osprey,2665,36,2,2,4,50.0%,3h
25760,1,AEsir,2665,0,2,3,5,40.0%,38m
25760,2,Zeratul,2665,0,2,4,6,33.3%,2h
25760,1,lodgoro,2665,68,2,5,7,28.6%,34m
25760,2,[daFtm]MueKiK,2665,30,2,8,10,20.0%,3m
25760,1,PlacentaStew,2665,36,1,4,5,20.0%,2h
25760,1,Vegas,2665,0,0,1,1,0.0%,2h
25760,1,Esarel,2665,0,0,2,2,0.0%,58m
25760,1,Flankturner,2665,0,0,4,4,0.0%,34m
25785,1,Solevita,2664,1732,119,114,233,51.1%,2h
25785,1,CountZero,2664,1426,95,91,186,51.1%,2h
25785,3,Hagendaz,2664,1376,91,87,178,51.1%,29m
25785,3,[3210]countzero,2664,1480,88,85,173,50.9%,41m
25785,1,Schweder,2664,1076,44,29,73,60.3%,12m
25785,1,ToxicIVdrip,2664,866,39,18,57,68.4%,44m
25785,1,ZergaLerg,2664,766,37,31,68,54.4%,2h
25785,2,seamorn,2664,508,18,27,45,40.0%,34m
25785,3,sloc,2664,283,16,21,37,43.2%,37m
25785,1,Mscooky,2664,294,9,6,15,60.0%,50m
25785,3,hawkowl,2664,204,7,3,10,70.0%,13m
25785,1,[GDJ]Akuma,2664,192,7,9,16,43.8%,58m
25785,3,[FGHER]Ben,2664,193,5,4,9,55.6%,27m
25785,2,SniperElGato,2664,143,5,6,11,45.5%,8m
25785,3,RAF,2664,94,4,6,10,40.0%,5m
25785,1,FUNDAYMONDAY,2664,110,3,4,7,42.9%,2h
25785,1,Vanguard,2664,95,2,0,2,100.0%,42m
25785,1,Madhin,2664,42,2,1,3,66.7%,1h
25785,3,Bolas,2664,0,2,3,5,40.0%,52m
25785,1,Viper,2664,0,1,5,6,16.7%,2h
25785,1,eMDeGie,2664,38,1,5,6,16.7%,16m
25785,1,Nitromech,2664,40,1,6,7,14.3%,40m
25785,1,Boneless,2664,0,0,2,2,0.0%,24m
25785,1,[NLTN]spoofwiddle,2664,0,0,5,5,0.0%,33m
25809,3,KidOnALeash,2663,1599,151,153,304,49.7%,27m
25809,3,Tbang,2663,1075,85,81,166,51.2%,16m
25809,2,Frost,2663,962,34,48,82,41.5%,2m
25809,1,[RawBBC]Mittens,2663,643,29,18,47,61.7%,50m
25809,3,[LTK]SaltyDad,2663,460,19,16,35,54.3%,22m
25809,1,[SyLx]JulioTche,2663,536,17,17,34,50.0%,2h
25809,1,SaladToss,2663,371,15,7,22,68.2%,1h
25809,1,KeibetsuBoSs,2663,416,13,8,21,61.9%,16m
25809,3,noobfiveever,2663,295,11,14,25,44.0%,16m
25809,1,cash,2663,344,10,10,20,50.0%,2h
25809,3,Imangry,2663,177,8,8,16,50.0%,14m
25809,3,[SLIKDX]COLDONE,2663,229,8,10,18,44.4%,13m
25809,1,KetamineYoda,2663,140,5,5,10,50.0%,2h
25809,2,fabian,2663,207,5,7,12,41.7%,1h
25809,1,Vato,2663,72,3,1,4,75.0%,51m
25809,1,computer,2663,107,3,1,4,75.0%,54m
25809,1,[4kek]Goat,2663,80,2,5,7,28.6%,48m
25809,1,[UpeV]ARTANIS,2663,0,1,0,1,100.0%,6m
25809,1,[MncsGG]Dinkelberg,2663,0,1,0,1,100.0%,2h
25809,3,paoloarriola,2663,0,1,0,1,100.0%,2h
25809,1,[Ash3s]Astroidflame,2663,0,0,1,1,0.0%,2h
25830,3,JazZzoN,2662,1545,113,110,223,50.7%,29m
25830,3,SWAGpocalyps,2662,1274,50,44,94,53.2%,8m
25830,2,[TeamUR]DrEuclidean,2662,1158,39,52,91,42.9%,39m
25830,1,FarkQue,2662,799,36,18,54,66.7%,33m
25830,3,[N2F]sludge,2662,543,30,29,59,50.8%,26m
25830,3,[JCN]ACDCLIVE,2662,539,30,30,60,50.0%,10m
25830,3,Odin,2662,771,27,32,59,45.8%,4m
25830,3,IamTayBob,2662,546,21,23,44,47.7%,19m
25830,1,GlobalAsax,2662,339,14,12,26,53.8%,52m
25830,1,MintyFresh,2662,286,9,5,14,64.3%,7m
25830,1,[Nraged]Order,2662,230,7,8,15,46.7%,2h
25830,1,Akio,2662,167,6,5,11,54.5%,3h
25830,1,Bjorn,2662,134,5,3,8,62.5%,39m
25830,1,[LJCL45]SaTo,2662,144,5,8,13,38.5%,2h
25830,1,dchen,2662,112,4,7,11,36.4%,16m
25830,3,[PBFlcn]PurplPassion,2662,0,3,1,4,75.0%,3m
25830,1,DeZoo,2662,106,3,5,8,37.5%,26m
25830,1,[Cakius]lsound,2662,78,3,8,11,27.3%,42m
25830,2,Webhead,2662,46,2,0,2,100.0%,9m
25830,1,cholesss,2662,82,2,3,5,40.0%,2h
25830,1,IceBreaKeR,2662,0,2,3,5,40.0%,2h
25830,1,asfd,2662,78,2,4,6,33.3%,3h
25830,3,MexnWallBldr,2662,0,2,5,7,28.6%,11m
25830,1,LoneDrone,2662,0,1,1,2,50.0%,59m
25830,1,Daniel,2662,0,0,2,2,0.0%,11m
25830,1,Glitched,2662,0,0,3,3,0.0%,43m
25856,2,MiguelBAM,2661,1544,980,959,1939,50.5%,25m
25856,1,BlazzinMonk,2661,1430,114,95,209,54.5%,21m
25856,3,plateau,2661,153,50,46,96,52.1%,19m
25856,1,mikestar,2661,588,18,36,54,33.3%,13m
25856,1,Savel,2661,540,16,19,35,45.7%,50m
25856,2,[57717]SolemnWookie,2661,236,8,20,28,28.6%,9m
25856,3,custardPuff,2661,205,7,8,15,46.7%,29m
25856,1,[MEP]pakalolo,2661,236,6,9,15,40.0%,59m
25856,1,notmaster,2661,211,6,9,15,40.0%,3h
25856,2,[BHBD]Hank,2661,114,4,1,5,80.0%,2h
25856,3,Lucifer,2661,42,4,3,7,57.1%,22m
25856,3,[M3AT]CliffxCore,2661,117,4,5,9,44.4%,20m
25856,1,[BruC]RSyfer,2661,128,3,3,6,50.0%,38m
25856,2,Tactictime,2661,98,3,20,23,13.0%,3m
25856,1,THungryChoir,2661,96,2,5,7,28.6%,2h
25856,1,Lukelberry,2661,0,1,0,1,100.0%,38m
25856,1,ocGuRsoSmart,2661,0,0,2,2,0.0%,10m
25856,1,Syndicate,2661,0,0,3,3,0.0%,2h
25874,2,[TFIX]LavaGalaxy,2660,1354,128,105,233,54.9%,27m
25874,3,[PPTr]Panterra,2660,1145,73,60,133,54.9%,41m
25874,1,AwesomeShot,2660,1476,53,57,110,48.2%,2h
25874,1,Enolariv,2660,1033,48,30,78,61.5%,2h
25874,3,joelsuo,2660,1122,43,46,89,48.3%,10m
25874,3,Jtimm,2660,868,40,39,79,50.6%,22m
25874,1,[TGosuD]tik,2660,684,24,24,48,50.0%,1h
25874,3,[SN3KS]meansssnake,2660,492,18,24,42,42.9%,20m
25874,1,YacodeKUNst,2660,296,14,11,25,56.0%,37m
25874,1,Matix,2660,388,12,7,19,63.2%,55m
25874,1,shagy,2660,266,11,11,22,50.0%,59m
25874,1,Trooper,2660,214,7,5,12,58.3%,1h
25874,3,Ninja,2660,30,5,3,8,62.5%,2m
25874,1,Power,2660,183,4,4,8,50.0%,36m
25874,2,Jod,2660,111,4,4,8,50.0%,2h
25874,1,Skatedivona,2660,150,4,5,9,44.4%,48m
25874,1,Peachwa,2660,60,4,5,9,44.4%,52m
25874,3,ElFipe,2660,0,2,3,5,40.0%,2h
25874,1,chileverde,2660,88,2,4,6,33.3%,1h
25874,1,ravenhound,2660,76,2,5,7,28.6%,20m
25874,1,Wooter,2660,36,1,1,2,50.0%,2h
25874,2,kankangtiger,2660,94,1,2,3,33.3%,3h
25874,1,[SWOU]FIDALGO,2660,36,1,3,4,25.0%,37m
25874,1,Grizz,2660,0,0,1,1,0.0%,44m
25874,1,maryball,2660,0,0,1,1,0.0%,13m
25899,2,Nanook,2659,1620,377,375,752,50.1%,12m
25899,1,oopsoops,2659,1740,84,78,162,51.9%,12m
25899,1,Chilby,2659,1674,75,65,140,53.6%,2h
25899,1,[KOCy]Apolo,2659,1303,50,45,95,52.6%,35m
25899,3,Master,2659,1032,47,32,79,59.5%,1m
25899,3,OrganEyes,2659,668,25,28,53,47.2%,16m
25899,1,stimdad,2659,611,19,21,40,47.5%,2h
25899,1,DotCD,2659,331,15,8,23,65.2%,2h
25899,1,Fenrir,2659,263,9,7,16,56.2%,21m
25899,2,[TeamKL]rodrygo,2659,92,5,9,14,35.7%,13m
25899,1,[GEI]FFiGhTeR,2659,72,3,1,4,75.0%,36m
25899,3,[BPunch]plusmental,2659,94,3,9,12,25.0%,27m
25899,3,[YKJK]thunderman,2659,120,2,6,8,25.0%,26m
25899,3,SmrtyCakes,2659,58,2,13,15,13.3%,26m
25899,2,[SMB]SMBbronzino,2659,0,1,0,1,100.0%,11m
25899,1,[BKaG]Drguau,2659,0,1,1,2,50.0%,2h
25899,3,asomraze,2659,0,1,1,2,50.0%,59m
25899,1,Gruntex,2659,0,1,4,5,20.0%,38m
25899,1,JacobWolves,2659,0,0,1,1,0.0%,18m
25899,1,jupi,2659,0,0,1,1,0.0%,59m
25899,1,Betelgeuse,2659,0,0,1,1,0.0%,2h
25899,2,erosleda,2659,0,0,1,1,0.0%,59m
25899,2,Brickashaw,2659,0,0,2,2,0.0%,2h
25922,1,Rickydicky,2658,1660,120,97,217,55.3%,54m
25922,3,Kavalan,2658,1436,79,85,164,48.2%,16m
25922,1,Volucian,2658,1571,71,62,133,53.4%,2h
25922,1,nappyJ,2658,1272,59,37,96,61.5%,2h
25922,1,thepublix,2658,990,50,30,80,62.5%,3h
25922,2,VietKong,2658,816,34,43,77,44.2%,4m
25922,3,[TY4GG]Crisps,2658,534,28,24,52,53.8%,28m
25922,1,ibooga,2658,538,23,13,36,63.9%,38m
25922,2,Balazs,2658,532,22,25,47,46.8%,17m
25922,1,naem,2658,478,18,10,28,64.3%,19m
25922,3,Maverik,2658,378,13,22,35,37.1%,32m
25922,3,Josh,2658,266,10,15,25,40.0%,35m
25922,3,Scapien,2658,117,10,18,28,35.7%,6m
25922,1,MrBones,2658,357,9,11,20,45.0%,19m
25922,1,Badass,2658,239,8,8,16,50.0%,3h
25922,3,Jabebs,2658,186,6,14,20,30.0%,14m
25922,1,[AbcCo]BlackScorpio,2658,155,5,1,6,83.3%,49m
25922,1,[DvaRKA]Blikman,2658,133,4,1,5,80.0%,12m
25922,1,AzComBaT,2658,0,4,1,5,80.0%,19m
25922,2,[4z04z0]Stickmen,2658,46,4,5,9,44.4%,48m
25922,3,Aguita,2658,66,4,8,12,33.3%,26m
25922,1,Terran,2658,192,3,5,8,37.5%,1h
25922,1,WombRaider,2658,72,2,5,7,28.6%,2h
25922,1,ELZergNovato,2658,0,1,0,1,100.0%,12m
25922,2,[Jnsten]Blaze,2658,89,1,1,2,50.0%,2h
25922,1,[Se7eN]SonicTHH,2658,0,0,1,1,0.0%,2h
25948,3,idrinkmyownp,2657,1616,275,272,547,50.3%,21m
25948,3,[ÆON]XPrime,2657,1618,258,258,516,50.0%,25m
25948,1,PetitFromage,2657,1703,75,64,139,54.0%,58m
25948,1,Melloh,2657,1004,37,30,67,55.2%,2h
25948,1,Paul,2657,612,28,19,47,59.6%,38m
25948,3,ElocinEvol,2657,642,24,24,48,50.0%,30m
25948,1,[Ace]fortheswarm,2657,441,19,14,33,57.6%,2h
25948,3,Rasolisk,2657,198,14,14,28,50.0%,35m
25948,3,seunghwan,2657,303,13,12,25,52.0%,9m
25948,1,DaveyCooCoo,2657,196,12,8,20,60.0%,2h
25948,3,ThunderGodZ,2657,221,9,10,19,47.4%,27m
25948,3,[NUTTT]Steel,2657,93,8,5,13,61.5%,2h
25948,1,Hilario,2657,112,3,4,7,42.9%,3h
25948,1,invader,2657,103,2,1,3,66.7%,2h
25948,1,ckzkal,2657,46,2,3,5,40.0%,1m
25948,1,[DoRQ]RionSnow,2657,0,0,1,1,0.0%,2h
25964,3,MegaHertz,2656,1614,112,106,218,51.4%,5m
25964,3,LISTERINE,2656,540,88,63,151,58.3%,10m
25964,3,SirWinsAlot,2656,1431,79,91,170,46.5%,37m
25964,1,FionaTheHipO,2656,582,42,39,81,51.9%,2h
25964,2,DEADLYPANTS,2656,750,28,32,60,46.7%,17m
25964,1,holobi,2656,308,23,22,45,51.1%,20m
25964,1,AgentVenom,2656,372,15,11,26,57.7%,7m
25964,1,RaphaelGa,2656,396,14,15,29,48.3%,44m
25964,1,Kyerion,2656,357,13,10,23,56.5%,2h
25964,3,Beast,2656,206,8,12,20,40.0%,13m
25964,1,Zlayer,2656,217,7,6,13,53.8%,44m
25964,1,Warhawk,2656,40,4,3,7,57.1%,38m
25964,1,Nivektis,2656,122,2,2,4,50.0%,2h
25964,3,rki,2656,0,2,3,5,40.0%,2h
25964,3,LastTyphin,2656,0,2,3,5,40.0%,3h
25964,1,Slater,2656,0,2,3,5,40.0%,2h
25964,3,lloopy,2656,0,2,3,5,40.0%,50m
25964,3,[D4]RIOT,2656,0,2,3,5,40.0%,31m
25964,1,amipooping,2656,34,1,3,4,25.0%,1h
25964,2,Aessa,2656,0,0,1,1,0.0%,3h
25964,1,NYK,2656,0,0,1,1,0.0%,39m
25964,2,COD,2656,0,0,1,1,0.0%,58m
25986,2,IronGear,2655,1562,83,88,171,48.5%,37m
25986,1,spottmc,2655,1434,68,58,126,54.0%,3h
25986,3,SilentStrom,2655,971,44,44,88,50.0%,18m
25986,1,[HmlsMx]Markku,2655,467,26,14,40,65.0%,40m
25986,3,Agrodotus,2655,583,24,24,48,50.0%,30m
25986,1,ElCatorce,2655,362,19,17,36,52.8%,10m
25986,3,Sihv,2655,482,17,22,39,43.6%,32m
25986,1,DrSmoothie,2655,389,14,11,25,56.0%,3h
25986,1,PersonNight,2655,286,13,6,19,68.4%,19m
25986,1,LeFern,2655,336,13,8,21,61.9%,1h
25986,2,[tCo9]OhNoDave,2655,240,9,21,30,30.0%,26m
25986,3,Noches,2655,209,6,8,14,42.9%,22m
25986,1,[αB]ZAWGURN,2655,116,4,5,9,44.4%,59m
25986,1,[1vsM]apazapt,2655,38,3,8,11,27.3%,12m
25986,1,[Det0x]Hyro,2655,88,2,0,2,100.0%,37m
25986,1,MilLerTiMe,2655,102,2,2,4,50.0%,16m
25986,1,[BICDIX]Amnesia,2655,104,2,2,4,50.0%,2h
25986,2,PennyRoyal,2655,96,2,3,5,40.0%,7m
25986,3,karatekid,2655,0,2,4,6,33.3%,8m
25986,1,[DRKLRD]Jin,2655,44,1,3,4,25.0%,2h
25986,2,resueman,2655,0,1,4,5,20.0%,51m
25986,1,[IQ30]bmoreawesome,2655,48,1,4,5,20.0%,27m
25986,3,Snum,2655,0,1,4,5,20.0%,54m
25986,1,xlorm,2655,0,0,2,2,0.0%,55m
26010,1,Radres,2654,1733,389,376,765,50.8%,2h
26010,1,Eclipse,2654,942,85,94,179,47.5%,2h
26010,2,[TY4GG]FROSTY,2654,1510,81,77,158,51.3%,7m
26010,3,lllIllIllIIl,2654,1292,76,81,157,48.4%,4m
26010,2,DimiGodd,2654,952,52,61,113,46.0%,18m
26010,3,[8OO8S]mrpaintrain,2654,1233,49,47,96,51.0%,10m
26010,1,pichou,2654,387,15,15,30,50.0%,2h
26010,1,DpakoH,2654,383,14,16,30,46.7%,14m
26010,1,STALKER,2654,369,12,11,23,52.2%,2h
26010,3,SirBeaker,2654,309,12,12,24,50.0%,35m
26010,1,Zerocross,2654,264,9,4,13,69.2%,52m
26010,3,SOFIA,2654,219,9,10,19,47.4%,2m
26010,1,[STAN]Athena,2654,147,5,7,12,41.7%,6m
26010,1,[scMAUI]Jayden,2654,120,4,3,7,57.1%,2h
26010,1,InNovAtiOn,2654,195,4,6,10,40.0%,26m
26010,2,Kaizerxg,2654,106,4,6,10,40.0%,36m
26010,1,Sakel,2654,72,3,3,6,50.0%,21m
26010,1,Sheathe,2654,32,2,1,3,66.7%,2h
26010,1,killa,2654,91,1,1,2,50.0%,9m
26010,1,[LegSC]Retros,2654,89,1,1,2,50.0%,26m
26010,2,Iqbal,2654,44,1,1,2,50.0%,49m
26010,1,RND,2654,38,1,2,3,33.3%,19m
26010,1,Probinho,2654,0,0,1,1,0.0%,2h
26033,3,DubySIXNINE,2653,1207,73,59,132,55.3%,22m
26033,3,Raiden,2653,1080,61,47,108,56.5%,7m
26033,2,Fenixfallen,2653,1363,53,56,109,48.6%,27m
26033,3,Tiger,2653,696,29,25,54,53.7%,7m
26033,2,CraftyGoblin,2653,512,19,25,44,43.2%,36m
26033,3,EARFQUAKE,2653,266,10,8,18,55.6%,18m
26033,1,whodayasays,2653,278,8,9,17,47.1%,2h
26033,3,RingMaster,2653,183,6,9,15,40.0%,35m
26033,3,Frae,2653,154,6,10,16,37.5%,10m
26033,1,WildPants,2653,0,4,1,5,80.0%,2h
26033,1,PotatoOnTray,2653,138,4,2,6,66.7%,32m
26033,2,DAVEDBN,2653,48,4,5,9,44.4%,15m
26033,3,Warlord,2653,174,4,9,13,30.8%,23m
26033,3,[TROLL]DarkWnd,2653,42,3,4,7,42.9%,37m
26033,3,BillyTheKid,2653,0,2,3,5,40.0%,51m
26033,1,[GO0NS]REVELATIONS,2653,0,1,0,1,100.0%,2h
26033,1,Atrius,2653,0,1,0,1,100.0%,7m
26033,1,[Awo0o]Gnarbone,2653,0,0,1,1,0.0%,16m
26033,1,Darkone,2653,0,0,1,1,0.0%,2h
26052,1,DarkRain,2652,1721,181,153,334,54.2%,3h
26052,3,WreakHavoc,2652,543,104,107,211,49.3%,26m
26052,3,[ZTempz]Phonexia,2652,1477,96,78,174,55.2%,29m
26052,2,[LOHs]Spanky,2652,1362,84,85,169,49.7%,3m
26052,3,Daddy,2652,1347,81,86,167,48.5%,42m
26052,3,AleaIactaEst,2652,1338,76,75,151,50.3%,34m
26052,3,[Fr0nt]Midnitegyro,2652,1500,71,83,154,46.1%,28m
26052,1,[pandem]oggrr,2652,1417,66,46,112,58.9%,38m
26052,2,MatMeister,2652,309,53,36,89,59.6%,35m
26052,1,[SLI55]sullivan,2652,1386,53,51,104,51.0%,3h
26052,1,[MBPS]Squidlor,2652,1068,36,38,74,48.6%,2h
26052,1,Tenov,2652,678,35,17,52,67.3%,3h
26052,1,Hobbit,2652,771,32,30,62,51.6%,6m
26052,3,Jackspeed,2652,191,32,31,63,50.8%,27m
26052,3,KutrePunk,2652,715,29,33,62,46.8%,35m
26052,1,RageForger,2652,474,22,17,39,56.4%,2h
26052,1,PlasmaUnit,2652,478,17,19,36,47.2%,32m
26052,2,TryNewBuilds,2652,352,13,27,40,32.5%,16m
26052,3,LoliconBlank,2652,223,8,11,19,42.1%,56m
26052,1,jimmy,2652,228,6,8,14,42.9%,22m
26052,1,CoS,2652,0,3,3,6,50.0%,2h
26052,3,Maffarazoi,2652,0,2,2,4,50.0%,2h
26052,1,[N0S2F]DomTorreto,2652,0,2,3,5,40.0%,32m
26052,1,Echo,2652,0,1,2,3,33.3%,1h
26052,1,[XpKAc]marinexd,2652,0,1,4,5,20.0%,3h
26052,2,[iMkS]Stimpack,2652,0,0,5,5,0.0%,2h
26078,1,DroppedBaby,2651,1369,112,107,219,51.1%,3h
26078,1,Caikera,2651,1235,79,64,143,55.2%,2h
26078,1,[AbcCo]JorgeGamer,2651,841,35,26,61,57.4%,34m
26078,2,Dunkel,2651,677,28,42,70,40.0%,40m
26078,3,Grim,2651,612,22,26,48,45.8%,27m
26078,1,Crash,2651,545,20,17,37,54.1%,1h
26078,3,HakkMaster,2651,448,19,18,37,51.4%,2m
26078,1,kaka,2651,416,18,19,37,48.6%,48m
26078,1,[WEENIS]cbacon,2651,542,16,18,34,47.1%,51m
26078,1,xxKINGREKTxx,2651,344,10,10,20,50.0%,3h
26078,1,[Nicer]NoobyDoo,2651,205,9,5,14,64.3%,26m
26078,1,BigPapa,2651,197,8,6,14,57.1%,18m
26078,1,xSkyEater,2651,184,6,9,15,40.0%,2h
26078,1,[Th3Bad]Phzin,2651,176,5,8,13,38.5%,1h
26078,1,fryzee,2651,168,5,8,13,38.5%,2h
26078,1,FettKass,2651,135,4,5,9,44.4%,2h
26078,1,ApplePants,2651,109,3,2,5,60.0%,60m
26078,1,[AXIOS]TeRRoR,2651,138,3,3,6,50.0%,38m
26078,2,MajorDad,2651,94,3,4,7,42.9%,10m
26078,1,GochuGirl,2651,30,3,4,7,42.9%,1h
26078,1,SwankyPants,2651,0,2,3,5,40.0%,1h
26078,3,[WNTR]IMFTW,2651,0,1,0,1,100.0%,2h
26078,1,Humbled,2651,0,1,0,1,100.0%,1h
26078,1,[Derpz]MrMikBakunin,2651,0,1,2,3,33.3%,2h
26078,1,MrCheese,2651,40,1,4,5,20.0%,2h
26078,1,Chrono,2651,0,0,1,1,0.0%,2h
26078,1,exzplosive,2651,0,0,3,3,0.0%,19m
26105,3,StashJuice,2650,1101,61,56,117,52.1%,27m
26105,3,Doctare,2650,725,51,54,105,48.6%,7m
26105,1,Kalkas,2650,776,46,34,80,57.5%,33m
26105,3,[bigFan]FruitDealer,2650,616,30,15,45,66.7%,6m
26105,1,Telozipazim,2650,346,17,14,31,54.8%,2h
26105,3,Firefrizzle,2650,324,13,10,23,56.5%,2h
26105,1,[jobjap]Japsap,2650,302,8,8,16,50.0%,7m
26105,2,Barracks,2650,183,6,7,13,46.2%,2h
26105,1,[XLsDsX]DocMan,2650,183,6,8,14,42.9%,2h
26105,1,EnergyRyu,2650,102,3,0,3,100.0%,2h
26105,1,Taco,2650,0,3,2,5,60.0%,2h
26105,1,hugo,2650,78,3,2,5,60.0%,2h
26105,2,commandant,2650,92,3,8,11,27.3%,1h
26105,2,[Lowko]Artanis,2650,0,2,2,4,50.0%,9m
26105,1,OucHI,2650,38,2,2,4,50.0%,54m
26105,1,wingsofheart,2650,140,2,3,5,40.0%,13m
26105,1,Rob,2650,0,1,0,1,100.0%,1h
26105,1,Azedenkae,2650,0,1,1,2,50.0%,1h
26105,1,[OvG]Corgoth,2650,40,1,2,3,33.3%,42m
26105,1,DarkDragon,2650,0,1,2,3,33.3%,3h
26105,1,Plotty,2650,32,1,2,3,33.3%,33m
26105,2,randomHAHAHA,2650,0,1,2,3,33.3%,3h
26105,1,Batman,2650,0,1,3,4,25.0%,2h
26105,1,Dan,2650,0,1,4,5,20.0%,2h
26105,1,[Macac0]osomaduro,2650,0,0,2,2,0.0%,13m
26130,3,Deletor,2649,545,86,76,162,53.1%,29m
26130,3,Lariz,2649,749,54,54,108,50.0%,27m
26130,1,panda,2649,496,45,29,74,60.8%,52m
26130,1,Lucifer,2649,865,39,29,68,57.4%,19m
26130,3,[KSRP]JackiePwnAss,2649,498,17,25,42,40.5%,31m
26130,1,[HPOT]Renaissance,2649,321,12,9,21,57.1%,43m
26130,2,Tincho,2649,273,12,13,25,48.0%,17m
26130,1,Bouncimonkie,2649,266,9,9,18,50.0%,2h
26130,3,BeastMode,2649,242,9,10,19,47.4%,9m
26130,1,Guduarte,2649,252,7,4,11,63.6%,3h
26130,1,[HypE]ElvenRogue,2649,188,6,9,15,40.0%,2h
26130,2,Jambiya,2649,240,6,19,25,24.0%,6m
26130,1,LrZl,2649,161,5,3,8,62.5%,3h
26130,3,Miihr,2649,154,5,11,16,31.2%,41m
26130,2,[Toliet]Rickstar,2649,146,5,11,16,31.2%,1m
26130,1,[Nwebs]HappySalami,2649,119,3,1,4,75.0%,7m
26130,2,cdacuya,2649,94,3,4,7,42.9%,2h
26130,2,[TFMG]Roma,2649,112,3,5,8,37.5%,11m
26130,1,Catalyst,2649,38,2,1,3,66.7%,2h
26130,3,[SsaYnS]SiLVeRLeAF,2649,30,2,3,5,40.0%,1h
26130,1,Erdnussfred,2649,0,1,0,1,100.0%,3h
26130,1,Cobruhz,2649,40,1,2,3,33.3%,24m
26152,1,Twelve,2648,1657,118,103,221,53.4%,3h
26152,3,Scarby,2648,1533,82,75,157,52.2%,1m
26152,1,AirOrange,2648,1310,54,61,115,47.0%,51m
26152,3,[SLKNM]Sebaceo,2648,767,40,38,78,51.3%,34m
26152,1,Miqhtyy,2648,864,39,28,67,58.2%,32m
26152,1,matjet,2648,433,21,22,43,48.8%,2h
26152,1,djt,2648,497,20,14,34,58.8%,1h
26152,1,FloppyMcNuts,2648,311,13,11,24,54.2%,16m
26152,1,Beetlejuice,2648,270,10,13,23,43.5%,21m
26152,3,Complete,2648,163,8,5,13,61.5%,8m
26152,1,[tets]Sangeky,2648,249,8,6,14,57.1%,13m
26152,1,RokmanRegen,2648,219,8,8,16,50.0%,13m
26152,1,sampai,2648,286,8,13,21,38.1%,2h
26152,3,[7536]shaddoll,2648,262,8,14,22,36.4%,17m
26152,3,JudisBreed,2648,171,7,8,15,46.7%,30m
26152,1,Tasulian,2648,232,6,9,15,40.0%,19m
26152,2,nitram,2648,102,5,6,11,45.5%,11m
26152,1,asdf,2648,168,5,6,11,45.5%,35m
26152,1,[JQuad]OLeee,2648,174,5,7,12,41.7%,39m
26152,3,lilililliili,2648,0,3,4,7,42.9%,9m
26152,1,Kerra,2648,32,2,2,4,50.0%,3h
26152,3,Luca,2648,0,2,5,7,28.6%,13m
26152,1,ElvoidPlay,2648,0,0,3,3,0.0%,13m
26175,3,Alamode,2647,1527,125,117,242,51.7%,30m
26175,2,Jazzer,2647,1560,92,99,191,48.2%,38m
26175,1,SrSQUANCHYdc,2647,1660,73,49,122,59.8%,2h
26175,3,[SEEXEE]Aisthesis,2647,766,28,32,60,46.7%,18m
26175,3,Dufrense,2647,745,27,31,58,46.6%,8m
26175,1,TeaSnack,2647,658,23,19,42,54.8%,43m
26175,1,Anrick,2647,486,21,10,31,67.7%,2h
26175,1,Gery,2647,369,21,21,42,50.0%,60m
26175,3,coco,2647,502,20,27,47,42.6%,35m
26175,1,joemeister,2647,631,19,18,37,51.4%,52m
26175,1,ZeroTheFool,2647,314,15,10,25,60.0%,7m
26175,1,[Upsala]Grishnak,2647,302,9,15,24,37.5%,22m
26175,2,Cyclone,2647,208,8,16,24,33.3%,12m
26175,3,Buurduurhuur,2647,134,7,5,12,58.3%,7m
26175,1,llScorPionll,2647,143,5,3,8,62.5%,19m
26175,1,TheWizard,2647,140,4,1,5,80.0%,2h
26175,1,CarriersRop,2647,142,3,2,5,60.0%,37m
26175,3,XBlackDracoX,2647,30,2,0,2,100.0%,2h
26175,1,dingo,2647,145,2,3,5,40.0%,53m
26175,1,Shanix,2647,0,2,3,5,40.0%,2h
26175,1,TheCheeseIT,2647,0,1,2,3,33.3%,40m
26175,1,[Khalta]jose,2647,38,1,2,3,33.3%,16m
26175,1,SUPETEN,2647,46,1,3,4,25.0%,1h
26175,1,Darkknight,2647,42,1,5,6,16.7%,37m
26175,1,bmackillaz,2647,42,1,6,7,14.3%,35m
26175,1,ammash,2647,0,0,1,1,0.0%,2h
26175,2,johntitor,2647,0,0,3,3,0.0%,52m
26202,2,careta,2646,1510,344,335,679,50.7%,18m
26202,3,MrHerrada,2646,1519,306,304,610,50.2%,26m
26202,1,Tildin,2646,1344,120,111,231,51.9%,24m
26202,1,dizzy,2646,1518,101,76,177,57.1%,2h
26202,1,[WiNgSS]kopperking,2646,1541,77,62,139,55.4%,44m
26202,1,[Sune]HavelTheRock,2646,683,23,20,43,53.5%,20m
26202,1,[FyHr]Cazador,2646,409,20,6,26,76.9%,16m
26202,1,NightstarAce,2646,388,18,11,29,62.1%,2h
26202,1,fox,2646,422,17,16,33,51.5%,32m
26202,1,LeatherySock,2646,204,9,2,11,81.8%,15m
26202,1,penguino,2646,250,7,5,12,58.3%,2h
26202,1,[Quotes]Aruka,2646,222,7,6,13,53.8%,10m
26202,1,DarkArcher,2646,138,5,0,5,100.0%,2h
26202,1,[DXPCA]PAULOMF,2646,140,5,1,6,83.3%,2h
26202,1,Hathyar,2646,154,5,5,10,50.0%,49m
26202,1,Rhythmviper,2646,114,4,6,10,40.0%,59m
26202,1,Lachy,2646,134,3,3,6,50.0%,32m
26202,1,PittbullVzla,2646,137,3,7,10,30.0%,42m
26202,2,[TKingz]MasterLxPt,2646,138,2,3,5,40.0%,2h
26202,3,DemonMaster,2646,0,2,3,5,40.0%,43m
26202,1,[LCE]FranciscoG,2646,142,2,4,6,33.3%,51m
26202,3,[Silly1]SpaceMarmot,2646,0,1,0,1,100.0%,54m
26202,1,Noodle,2646,0,1,0,1,100.0%,3h
26202,1,Spartan,2646,0,1,1,2,50.0%,60m
26202,1,Assjob,2646,0,0,1,1,0.0%,48m
26202,1,Noobpoleone,2646,0,0,2,2,0.0%,2h
26202,1,lukastro,2646,73,0,2,2,0.0%,12m
26229,3,mermer,2645,1474,122,103,225,54.2%,11m
26229,1,Minkintosh,2645,1302,80,64,144,55.6%,13m
26229,1,Ghost,2645,324,15,10,25,60.0%,21m
26229,3,Orion,2645,343,14,18,32,43.8%,17m
26229,1,Dom,2645,331,12,9,21,57.1%,2h
26229,1,ZDamned,2645,346,10,10,20,50.0%,36m
26229,1,[SSquad]SubtleStone,2645,296,8,7,15,53.3%,13m
26229,1,Hauntedmist,2645,192,6,10,16,37.5%,16m
26229,3,hideyokitty,2645,0,3,4,7,42.9%,18m
26229,1,[DNKCFT]ePHeCt,2645,89,2,0,2,100.0%,2h
26229,1,[SmartD]Monster,2645,58,2,3,5,40.0%,12m
26229,1,thetreecat,2645,40,2,3,5,40.0%,51m
26229,1,Ricky,2645,0,2,3,5,40.0%,10m
26229,1,KingKenny,2645,0,0,1,1,0.0%,33m
26243,3,NiffTea,2644,1407,54,55,109,49.5%,25m
26243,1,[DMONlC]DroneZilla,2644,1404,52,51,103,50.5%,2h
26243,1,Cipher,2644,592,50,47,97,51.5%,2h
26243,1,Cahuide,2644,622,28,20,48,58.3%,38m
26243,1,Element,2644,630,20,19,39,51.3%,54m
26243,2,Noja,2644,444,15,24,39,38.5%,37m
26243,3,Tethgret,2644,200,6,3,9,66.7%,3h
26243,1,Sqwa,2644,160,4,6,10,40.0%,2h
26243,1,OpenBorders,2644,134,3,2,5,60.0%,32m
26243,1,DawgyDawg,2644,94,3,4,7,42.9%,2h
26243,1,trumpGGG,2644,0,3,5,8,37.5%,2h
26243,3,joshua,2644,0,2,3,5,40.0%,53m
26243,1,StupidMcPoop,2644,0,1,0,1,100.0%,2h
26243,1,[TF11]Raider,2644,0,1,1,2,50.0%,37m
26243,1,Singularity,2644,0,1,1,2,50.0%,10m
26243,1,[KoAv]Rökkur,2644,40,1,4,5,20.0%,3h
26243,1,qwerty,2644,0,1,4,5,20.0%,52m
26243,1,[GenF]Wolfie,2644,0,0,2,2,0.0%,3h
26243,1,Huascar,2644,0,0,2,2,0.0%,2h
26243,1,DarkSoul,2644,0,0,4,4,0.0%,3h
26263,1,autompne,2643,1000,52,67,119,43.7%,13m
26263,3,RawTunaBoy,2643,988,44,42,86,51.2%,30m
26263,1,ArtofGinge,2643,920,42,30,72,58.3%,44m
26263,1,[TGosuC]necrotik,2643,857,39,33,72,54.2%,34m
26263,1,Rangi,2643,448,19,39,58,32.8%,25m
26263,3,heyya,2643,394,13,16,29,44.8%,8m
26263,1,[cluez]zerotwo,2643,167,8,0,8,100.0%,2h
26263,2,parka,2643,222,6,7,13,46.2%,11m
26263,2,AdjutantCore,2643,80,3,2,5,60.0%,2m
26263,2,[MMSTAR]Luke,2643,96,3,4,7,42.9%,2h
26263,1,[kvac]Kremer,2643,118,3,5,8,37.5%,2h
26263,1,DsD,2643,0,1,0,1,100.0%,2h
26263,1,Instanbul,2643,0,0,1,1,0.0%,2h
26263,1,[Th3Bad]Rayvits,2643,0,0,1,1,0.0%,16m
26277,3,Badcatito,2642,1567,246,235,481,51.1%,28m
26277,1,IIIIIIIIIIII,2642,1463,219,211,430,50.9%,10m
26277,3,MangyCarl,2642,1518,146,147,293,49.8%,29m
26277,3,BigCuz,2642,799,140,122,262,53.4%,29m
26277,1,Xsaviour,2642,1668,133,124,257,51.8%,58m
26277,1,Shinji,2642,698,130,132,262,49.6%,3h
26277,3,Vilepredator,2642,874,101,92,193,52.3%,33m
26277,3,Neurotic,2642,1159,70,60,130,53.8%,15m
26277,3,[LTCent]slydemon,2642,1138,55,57,112,49.1%,5m
26277,1,TitanTolkien,2642,1181,51,46,97,52.6%,38m
26277,1,stepbro,2642,1144,50,43,93,53.8%,38m
26277,1,Dohhhnuts,2642,696,40,29,69,58.0%,2h
26277,2,gagk,2642,324,14,18,32,43.8%,25m
26277,1,Leglump,2642,292,8,10,18,44.4%,2h
26277,1,Aurigins,2642,238,7,10,17,41.2%,2h
26277,1,[ExcIgN]Charlie,2642,94,5,1,6,83.3%,3h
26277,2,Crippen,2642,133,3,1,4,75.0%,48m
26277,2,Gummybeer,2642,0,3,3,6,50.0%,26m
26277,1,Fermiman,2642,68,3,3,6,50.0%,2h
26277,1,Beef,2642,48,2,5,7,28.6%,3h
26277,1,[MSHS09]OSIRIS,2642,0,1,0,1,100.0%,16m
26277,1,[sk3tch]hydra,2642,0,1,0,1,100.0%,49m
26277,1,Pivcles,2642,46,1,1,2,50.0%,24m
26277,1,Arlian,2642,38,1,3,4,25.0%,2h
26277,1,Solace,2642,0,1,4,5,20.0%,2h
26277,1,[PwT]Crazy,2642,88,1,5,6,16.7%,19m
26277,2,[UFroze]Samrock,2642,0,0,1,1,0.0%,26m
26277,1,Emandarx,2642,0,0,1,1,0.0%,37m
26277,1,OIIIIIIIO,2642,0,0,5,5,0.0%,2h
26306,3,Kotaztrafee,2641,1097,44,46,90,48.9%,26m
26306,1,[VARIAN]Angelus,2641,732,32,23,55,58.2%,32m
26306,3,[JEUB]AmbitionsEnd,2641,475,20,17,37,54.1%,3m
26306,1,Ceteris,2641,276,19,10,29,65.5%,22m
26306,1,GARED,2641,437,16,15,31,51.6%,7m
26306,1,Physix,2641,452,14,16,30,46.7%,55m
26306,1,waves,2641,343,12,12,24,50.0%,32m
26306,1,[ooPLoo]QuBuS,2641,167,6,2,8,75.0%,10m
26306,1,[MRKZV]Rajinus,2641,134,5,3,8,62.5%,2h
26306,1,RoteZora,2641,36,4,7,11,36.4%,3h
26306,3,fernando,2641,0,3,2,5,60.0%,48m
26306,1,iliminator,2641,80,3,3,6,50.0%,3h
26306,2,[LEZZ]Delta,2641,89,3,4,7,42.9%,9m
26306,3,necro,2641,0,3,4,7,42.9%,25m
26306,1,[D00M]DARKZZII,2641,122,2,3,5,40.0%,39m
26306,1,[cloudM]HiddenAngles,2641,0,1,0,1,100.0%,38m
26306,1,Inertia,2641,0,0,1,1,0.0%,13m
26306,1,Richo,2641,0,0,1,1,0.0%,7m
26306,1,kingpenguin,2641,0,0,1,1,0.0%,2h
26306,1,MRoso,2641,73,0,4,4,0.0%,15m
26326,3,MyHiveonAiur,2640,1127,108,90,198,54.5%,1m
26326,3,[Ziggy]Killerqueen,2640,1507,103,90,193,53.4%,18m
26326,1,andrewsebass,2640,461,77,85,162,47.5%,32m
26326,2,Sundog,2640,732,31,19,50,62.0%,2h
26326,1,guerokno,2640,723,26,23,49,53.1%,2h
26326,3,[519mob]xAmImacroOox,2640,452,23,23,46,50.0%,35m
26326,2,ATHandBanana,2640,655,22,31,53,41.5%,34m
26326,3,[BOXNET]Dieuguerre,2640,382,22,40,62,35.5%,37m
26326,2,SaitoRijikou,2640,591,21,16,37,56.8%,35m
26326,3,FancySloth,2640,469,17,18,35,48.6%,35m
26326,3,[TSM88]JOHNANDBUDDY,2640,394,14,16,30,46.7%,12m
26326,3,Trakker,2640,407,13,17,30,43.3%,28m
26326,1,purecode,2640,227,8,10,18,44.4%,44m
26326,1,[8kPLUS]RadarBoy,2640,150,5,8,13,38.5%,16m
26326,1,compatible,2640,136,4,2,6,66.7%,34m
26326,2,Rheese,2640,30,3,3,6,50.0%,33m
26326,1,[tCo9]CoryWell,2640,104,3,5,8,37.5%,2h
26326,1,Hawkeye,2640,110,3,5,8,37.5%,2h
26326,3,Zeran,2640,0,2,3,5,40.0%,2h
26326,3,Dolan,2640,0,2,3,5,40.0%,2h
26326,2,Mazer,2640,0,2,3,5,40.0%,31m
26326,2,[Lowko]Cubbei,2640,0,2,4,6,33.3%,2h
26326,1,MrPopo,2640,0,1,0,1,100.0%,44m
26326,1,Lobo,2640,0,1,2,3,33.3%,2h
26326,2,[DRKAPP]Wish,2640,38,1,2,3,33.3%,2h
26326,1,Catire,2640,38,1,3,4,25.0%,2h
26326,1,OlieWilliams,2640,0,1,3,4,25.0%,16m
26326,1,Monkeybutt,2640,0,1,3,4,25.0%,3h
26326,2,zUnOriginalz,2640,0,0,1,1,0.0%,2h
26326,2,[Kray]FleX,2640,0,0,1,1,0.0%,3h
26326,1,Mandy,2640,0,0,3,3,0.0%,2m
26357,3,Schnetz,2639,1548,331,330,661,50.1%,5m
26357,3,stones,2639,1479,87,94,181,48.1%,24m
26357,1,[3DLANS]joyo,2639,599,60,59,119,50.4%,51m
26357,1,VctorCass,2639,1015,39,31,70,55.7%,3h
26357,1,NukeForce,2639,1000,38,40,78,48.7%,3h
26357,2,crackcocain,2639,930,34,41,75,45.3%,18m
26357,3,[TB0C]ExcuseMaker,2639,774,26,35,61,42.6%,6m
26357,1,[JOE7]Wagwil,2639,523,19,19,38,50.0%,1h
26357,1,LebronJames,2639,340,11,16,27,40.7%,54m
26357,2,[G2H]Crabarms,2639,312,10,16,26,38.5%,27m
26357,3,Alphabetsoup,2639,240,9,10,19,47.4%,24m
26357,1,FreezingZone,2639,234,8,7,15,53.3%,37m
26357,1,Austin,2639,146,8,10,18,44.4%,20m
26357,1,Smoki,2639,232,7,5,12,58.3%,37m
26357,2,Savageinhell,2639,176,7,9,16,43.8%,3h
26357,1,FiftyBliss,2639,188,5,2,7,71.4%,2m
26357,1,RasslabuhaUS,2639,227,5,5,10,50.0%,2h
26357,3,FreindLess,2639,192,5,5,10,50.0%,2h
26357,3,ComposedJam,2639,60,3,4,7,42.9%,10m
26357,2,SpaceTurd,2639,0,2,3,5,40.0%,2h
26357,2,JanKz,2639,0,2,5,7,28.6%,2h
26357,2,[KnKHxx]abrostor,2639,40,1,1,2,50.0%,48m
26357,1,[SsaYnS]LilPetit,2639,0,1,1,2,50.0%,2h
26357,1,Danny,2639,0,1,3,4,25.0%,60m
26357,3,Servz,2639,0,1,3,4,25.0%,42m
26382,2,Amec,2638,1021,47,26,73,64.4%,2h
26382,1,BOB,2638,587,40,29,69,58.0%,3h
26382,3,Angel,2638,601,28,32,60,46.7%,31m
26382,1,Semore,2638,473,18,16,34,52.9%,2h
26382,1,DralaFi,2638,420,14,11,25,56.0%,32m
26382,1,SrCoagulo,2638,115,4,6,10,40.0%,24m
26382,2,skytum,2638,0,3,4,7,42.9%,2h
26382,3,Straika,2638,36,3,4,7,42.9%,2h
26382,1,[OiLMe]Maximus,2638,48,2,1,3,66.7%,3h
26382,1,Phantasma,2638,72,2,5,7,28.6%,2h
26382,2,Yuma,2638,0,1,0,1,100.0%,2h
26382,3,mijaelo,2638,0,1,0,1,100.0%,36m
26382,2,ButterflyFX,2638,0,1,0,1,100.0%,12m
26382,1,Nhyko,2638,0,1,2,3,33.3%,20m
26382,1,Nikolas,2638,32,1,3,4,25.0%,2h
26382,3,[LOHs]Bortolindo,2638,0,0,1,1,0.0%,41m
26398,1,Blaster,2637,1700,148,133,281,52.7%,37m
26398,1,alvinuub,2637,1306,130,100,230,56.5%,3h
26398,1,Darksifo,2637,1477,109,92,201,54.2%,2h
26398,3,[BIKBOY]Sqwinee,2637,505,39,44,83,47.0%,13m
26398,2,[1vsM]MadKunzie,2637,582,22,14,36,61.1%,24m
26398,1,mandalf,2637,567,19,16,35,54.3%,2h
26398,2,Manicx,2637,474,18,27,45,40.0%,19m
26398,1,Mugwump,2637,326,13,7,20,65.0%,3h
26398,2,Mycolium,2637,306,11,10,21,52.4%,42m
26398,1,ChineseFries,2637,246,9,11,20,45.0%,39m
26398,1,BizLeZ,2637,300,8,8,16,50.0%,48m
26398,1,nivlaq,2637,168,6,4,10,60.0%,3h
26398,3,[llKSll]ExTiNcT,2637,160,5,5,10,50.0%,30m
26398,1,SiNine,2637,159,4,3,7,57.1%,2h
26398,2,Phoenix,2637,112,3,4,7,42.9%,18m
26398,1,Shawntana,2637,48,2,2,4,50.0%,2m
26398,1,[ZTemps]greese,2637,66,2,3,5,40.0%,2h
26398,3,Fenixmar,2637,0,2,3,5,40.0%,2h
26398,3,BananaLisk,2637,44,2,4,6,33.3%,35m
26398,2,YoloSwagtron,2637,0,1,0,1,100.0%,12m
26398,2,TheJesoph,2637,0,1,0,1,100.0%,2h
26398,1,DarkFantom,2637,0,1,3,4,25.0%,2h
26398,3,BattleElf,2637,0,0,1,1,0.0%,14m
26398,1,LoneWolf,2637,0,0,2,2,0.0%,2h
26398,1,[ohithr]Nate,2637,0,0,2,2,0.0%,13m
26398,1,Diego,2637,0,0,2,2,0.0%,2h
26398,1,Synergy,2637,0,0,5,5,0.0%,57m
26425,1,SmRTneZ,2636,1597,88,73,161,54.7%,32m
26425,3,FlimFlam,2636,1440,67,62,129,51.9%,40m
26425,2,Quovatis,2636,815,36,25,61,59.0%,36m
26425,1,sleazypnut,2636,812,36,41,77,46.8%,3h
26425,1,[iTrolI]Badgerfc,2636,488,18,17,35,51.4%,2h
26425,2,[xNPGx]PaPu,2636,524,17,29,46,37.0%,17m
26425,1,[JUGOS2]Miltoniuss,2636,458,15,17,32,46.9%,37m
26425,1,turttleship,2636,163,5,4,9,55.6%,49m
26425,1,Agnus,2636,144,5,6,11,45.5%,59m
26425,1,[M0lST]MeatyFlaps,2636,104,4,4,8,50.0%,2h
26425,2,[vinte2]DandaMan,2636,0,3,2,5,60.0%,17m
26425,1,STAN,2636,68,2,3,5,40.0%,2h
26425,3,Keins,2636,0,2,3,5,40.0%,44m
26425,3,river,2636,0,2,3,5,40.0%,2h
26425,1,[Msia]Firedamage,2636,78,2,5,7,28.6%,2h
26425,2,BloodLust,2636,0,2,6,8,25.0%,3h
26425,1,ÐixieRëkt,2636,0,1,4,5,20.0%,2h
26425,2,[xLgNx]SageKing,2636,0,0,1,1,0.0%,16m
26425,2,Xanthor,2636,0,0,1,1,0.0%,2h
26425,1,[AOdA]Kuatih,2636,0,0,3,3,0.0%,1h
26445,1,Morgan,2635,1078,57,52,109,52.3%,2h
26445,1,[NPhase]SlayerX,2635,1193,44,40,84,52.4%,44m
26445,1,cRoNus,2635,854,30,46,76,39.5%,40m
26445,3,Asuka,2635,556,20,28,48,41.7%,27m
26445,3,PixelLaird,2635,431,18,20,38,47.4%,20m
26445,2,AlexDanilo,2635,434,16,17,33,48.5%,10m
26445,1,proximate,2635,199,10,5,15,66.7%,2h
26445,1,drsilver,2635,192,8,5,13,61.5%,32m
26445,1,[OGDRTY]FrankyMerman,2635,271,8,7,15,53.3%,52m
26445,1,whistle,2635,196,7,2,9,77.8%,2h
26445,1,IWILLWIN,2635,258,6,6,12,50.0%,1h
26445,1,MadCat,2635,183,5,3,8,62.5%,42m
26445,2,[WTFNEL]AngeloPiasZ,2635,88,4,3,7,57.1%,39m
26445,2,Kmicic,2635,95,3,4,7,42.9%,1h
26445,2,theking,2635,30,3,4,7,42.9%,22m
26445,3,Whitless,2635,0,2,2,4,50.0%,4m
26445,1,Webear,2635,122,2,3,5,40.0%,2h
26445,1,KhalDrog,2635,119,2,4,6,33.3%,2h
26445,1,EXPERTISE,2635,46,1,1,2,50.0%,2h
26445,1,BlanQ,2635,0,1,5,6,16.7%,54m
26445,2,Littleman,2635,94,1,7,8,12.5%,2h
26445,2,[TSFD]JollyJohn,2635,0,0,1,1,0.0%,47m
26445,1,Async,2635,0,0,5,5,0.0%,19m
26468,1,Dak,2634,1553,137,125,262,52.3%,2h
26468,2,KoC,2634,770,129,129,258,50.0%,6m
26468,2,[VRSA]Penguin,2634,1144,88,63,151,58.3%,49m
26468,3,[cl0udM]Deftruptor,2634,186,49,30,79,62.0%,42m
26468,3,nemesis,2634,347,24,35,59,40.7%,15m
26468,3,BlackZe,2634,572,20,29,49,40.8%,29m
26468,2,DevilD,2634,419,16,12,28,57.1%,6m
26468,1,[AD3C]Legola,2634,357,14,10,24,58.3%,1h
26468,1,SirRobinDD,2634,224,7,8,15,46.7%,39m
26468,3,finalOPUS,2634,137,5,7,12,41.7%,18m
26468,3,DrAbusive,2634,0,3,2,5,60.0%,14m
26468,1,shockodelmar,2634,140,3,2,5,60.0%,1h
26468,1,Barthim,2634,106,3,5,8,37.5%,3h
26468,1,[OPGame]Karkas,2634,75,3,6,9,33.3%,3h
26468,1,Ingis,2634,0,2,4,6,33.3%,16m
26468,1,Ben,2634,0,1,1,2,50.0%,48m
26468,2,[6CCL]Ghost,2634,0,1,4,5,20.0%,18m
26468,1,[BPT]Monkoc,2634,97,1,5,6,16.7%,3h
26468,3,[SASHA1]Arrx,2634,94,1,6,7,14.3%,25m
26468,2,Sun,2634,0,0,1,1,0.0%,45m
26468,3,[SEY]HellSpawn,2634,0,0,1,1,0.0%,7m
26468,1,[SPMAF]Scheibsas,2634,0,0,1,1,0.0%,54m
26468,1,AMLO,2634,0,0,3,3,0.0%,52m
26468,1,CandyBrain,2634,0,0,3,3,0.0%,35m
26492,1,Iheartcarbot,2633,1600,243,240,483,50.3%,2h
26492,3,davedumas,2633,1572,187,181,368,50.8%,13m
26492,1,XanthraXus,2633,739,173,171,344,50.3%,34m
26492,1,[Ricers]PatrickB,2633,1366,85,62,147,57.8%,26m
26492,3,Oxygenium,2633,969,84,88,172,48.8%,18m
26492,2,Rondi,2633,1372,59,43,102,57.8%,2h
26492,3,ohnolookout,2633,631,37,37,74,50.0%,28m
26492,1,[AnWVS]Ivan,2633,527,18,16,34,52.9%,6m
26492,3,Diogenes,2633,356,12,20,32,37.5%,30m
26492,3,Rahn,2633,328,12,25,37,32.4%,39m
26492,3,Marklongwide,2633,90,6,7,13,46.2%,24m
26492,1,[TG0]DANGO,2633,182,5,4,9,55.6%,2h
26492,1,BlackLite,2633,163,4,1,5,80.0%,2h
26492,2,GergtheGreat,2633,92,3,4,7,42.9%,9m
26492,2,WaitForIt,2633,44,3,5,8,37.5%,2h
26492,2,ninjabrett,2633,0,2,3,5,40.0%,60m
26492,3,Ghost,2633,0,2,3,5,40.0%,2h
26492,2,Vintrex,2633,0,2,3,5,40.0%,15m
26492,3,Smooky,2633,123,2,4,6,33.3%,20m
26492,2,mikesshh,2633,0,0,1,1,0.0%,3h
26492,1,[FFoNE]FallenAdz,2633,0,0,1,1,0.0%,2h
26492,2,Murl,2633,0,0,2,2,0.0%,2m
26492,2,Leonitis,2633,0,0,2,2,0.0%,2h
26492,3,MordinSullis,2633,0,0,3,3,0.0%,7m
26516,1,nemc,2632,1343,91,77,168,54.2%,1h
26516,1,YoSnipe,2632,1593,64,58,122,52.5%,2h
26516,1,MagicBlade,2632,943,54,53,107,50.5%,2h
26516,1,[NXLsc]Diaval,2632,732,27,19,46,58.7%,1h
26516,1,[AbcCo]LaMorza,2632,496,25,20,45,55.6%,2h
26516,1,CaptWilliamL,2632,383,21,14,35,60.0%,35m
26516,3,Widdershin,2632,487,20,22,42,47.6%,18m
26516,1,BigTarek,2632,442,19,17,36,52.8%,20m
26516,1,PotatoJoe,2632,342,12,11,23,52.2%,3h
26516,1,Mrartanis,2632,266,7,14,21,33.3%,2h
26516,1,Sklaper,2632,180,6,8,14,42.9%,3h
26516,1,Smiley,2632,132,4,6,10,40.0%,1h
26516,1,Madness,2632,48,4,7,11,36.4%,29m
26516,1,PlayboiCarti,2632,138,4,9,13,30.8%,2h
26516,2,Estimated,2632,30,2,0,2,100.0%,3h
26516,1,YoungTiger,2632,40,2,4,6,33.3%,2h
26516,1,TotalyUnique,2632,78,2,7,9,22.2%,60m
26516,1,Garrett,2632,0,1,1,2,50.0%,2h
26516,1,IlIlIlIlIlIl,2632,38,1,4,5,20.0%,2h
26516,2,dantebd,2632,0,0,1,1,0.0%,2h
26536,3,Nikestar,2631,1527,104,98,202,51.5%,31m
26536,1,Notlim,2631,1441,70,61,131,53.4%,33m
26536,1,TheBoxeR,2631,1224,40,63,103,38.8%,24m
26536,2,[GGdogs]Postre,2631,832,32,27,59,54.2%,2h
26536,1,deeluk,2631,427,26,24,50,52.0%,3h
26536,1,benderpatrol,2631,388,14,15,29,48.3%,2h
26536,1,MedicsUp,2631,314,11,10,21,52.4%,2h
26536,1,[Meower]Bootycat,2631,350,10,10,20,50.0%,39m
26536,1,Quasimotron,2631,244,7,8,15,46.7%,2h
26536,1,Zozo,2631,237,7,8,15,46.7%,2h
26536,1,Kontroll,2631,121,5,6,11,45.5%,36m
26536,2,DanLou,2631,108,4,0,4,100.0%,24m
26536,1,Sensii,2631,133,4,2,6,66.7%,2h
26536,3,[PN]Gillkin,2631,107,4,5,9,44.4%,8m
26536,1,maQ,2631,120,4,5,9,44.4%,2h
26536,1,BruceLeChang,2631,152,4,8,12,33.3%,51m
26536,2,[ThDead]SoNdrKoMaNdO,2631,46,3,6,9,33.3%,3h
26536,2,MasterDiablo,2631,0,2,3,5,40.0%,2h
26536,2,MEGABYTS,2631,0,1,0,1,100.0%,3h
26536,3,Destroya,2631,0,1,0,1,100.0%,5m
26536,1,[PUSA]ILoveMariahC,2631,36,1,5,6,16.7%,34m
26536,3,DocLobster,2631,0,0,1,1,0.0%,2h
26536,2,[IvD]GosuAppa,2631,0,0,1,1,0.0%,2h
26536,2,MAYROMuwu,2631,0,0,1,1,0.0%,2h
26536,1,flipper,2631,0,0,3,3,0.0%,1h
26561,2,Mambolisk,2630,1547,209,211,420,49.8%,3m
26561,1,STARPIG,2630,1668,135,122,257,52.5%,17m
26561,3,Cylon,2630,889,89,89,178,50.0%,26m
26561,3,Vandaen,2630,743,64,71,135,47.4%,24m
26561,3,Dud,2630,514,59,66,125,47.2%,42m
26561,3,OGnerdballer,2630,952,44,45,89,49.4%,14m
26561,1,[TGosuD]jakeadoo,2630,495,22,17,39,56.4%,43m
26561,3,Swarmlinger,2630,624,21,32,53,39.6%,27m
26561,1,Ortegius,2630,369,12,14,26,46.2%,2h
26561,3,Yikeys,2630,279,11,11,22,50.0%,30m
26561,3,baba,2630,157,7,7,14,50.0%,41m
26561,1,[HRZCOK]sPiKe,2630,177,6,7,13,46.2%,2h
26561,1,[GG117]BAMF,2630,137,5,3,8,62.5%,3h
26561,2,Broski,2630,153,5,5,10,50.0%,1h
26561,1,Danielldc,2630,188,5,7,12,41.7%,2h
26561,1,acesino,2630,123,3,12,15,20.0%,39m
26561,1,Tyrone,2630,78,2,4,6,33.3%,32m
26561,1,[GURKI]blowfishfugu,2630,70,2,6,8,25.0%,2h
26561,2,[Soulm8]MyBride,2630,0,1,0,1,100.0%,31m
26561,1,thereaper,2630,0,1,1,2,50.0%,51m
26561,1,Terrano,2630,32,1,6,7,14.3%,2h
26561,2,Fyrbolg,2630,0,0,1,1,0.0%,16m
26583,2,[XOLDX]Dragon,2629,1549,364,368,732,49.7%,25m
26583,2,[Parry]FeedAndLeave,2629,327,30,16,46,65.2%,24m
26583,1,Kukuri,2629,623,26,20,46,56.5%,1h
26583,1,ChiMartian,2629,712,24,20,44,54.5%,32m
26583,2,octotaco,2629,206,9,6,15,60.0%,7m
26583,1,teatime,2629,172,6,6,12,50.0%,2h
26583,1,[ZTemp]Outlaw,2629,218,6,6,12,50.0%,2h
26583,3,WONDERBOY,2629,224,6,13,19,31.6%,14m
26583,1,[BrNzUP]Tiny,2629,88,5,2,7,71.4%,13m
26583,2,Eaugh,2629,154,5,5,10,50.0%,2h
26583,3,Lionblaze,2629,0,4,1,5,80.0%,55m
26583,2,TrickyKnight,2629,30,4,2,6,66.7%,21m
26583,2,Phanxy,2629,88,3,1,4,75.0%,49m
26583,3,JustinBieber,2629,0,2,3,5,40.0%,14m
26583,1,Dowsky,2629,0,1,3,4,25.0%,6m
26583,2,TrinityH,2629,0,0,1,1,0.0%,2h
26583,3,Paladin,2629,0,0,1,1,0.0%,57m
26600,3,[OceanT]Fabusnardo,2628,1549,98,88,186,52.7%,21m
26600,1,Nihilum,2628,1040,78,56,134,58.2%,36m
26600,3,[copain]Pingu,2628,1207,55,46,101,54.5%,13m
26600,1,Layan,2628,827,35,29,64,54.7%,1h
26600,2,Darkseid,2628,672,23,37,60,38.3%,38m
26600,2,Noaob,2628,374,15,7,22,68.2%,35m
26600,1,Benaiah,2628,453,15,16,31,48.4%,34m
26600,1,[4L0k0]PRESO,2628,438,14,15,29,48.3%,60m
26600,3,boomba,2628,305,9,13,22,40.9%,6m
26600,1,zergxsiempre,2628,270,9,16,25,36.0%,35m
26600,2,Moridin,2628,224,7,6,13,53.8%,2h
26600,3,Dani,2628,191,7,9,16,43.8%,25m
26600,3,Vermillion,2628,132,6,6,12,50.0%,34m
26600,1,Stovant,2628,124,6,7,13,46.2%,2h
26600,2,pls,2628,118,5,1,6,83.3%,6m
26600,1,Shazamo,2628,164,5,6,11,45.5%,3h
26600,2,WayneNewton,2628,66,3,0,3,100.0%,1h
26600,3,Toxicity,2628,0,3,2,5,60.0%,59m
26600,1,[FDSC]WkCof,2628,119,3,6,9,33.3%,24m
26600,2,medmed,2628,48,3,6,9,33.3%,3h
26600,2,baker,2628,34,2,1,3,66.7%,28m
26600,1,iNcontrol,2628,90,2,1,3,66.7%,19m
26600,1,Guttenzerg,2628,38,2,2,4,50.0%,22m
26600,3,Zeroflare,2628,0,2,3,5,40.0%,6m
26600,2,EliTON,2628,91,1,2,3,33.3%,2h
26600,1,killerbee,2628,0,1,3,4,25.0%,3h
26600,2,DripZ,2628,0,0,1,1,0.0%,35m
26627,1,Zenpa,2627,726,92,89,181,50.8%,2h
26627,1,Diego,2627,1683,73,60,133,54.9%,2h
26627,1,Phil,2627,1068,67,53,120,55.8%,35m
26627,3,Diablolbaid,2627,575,23,27,50,46.0%,8m
26627,2,RevlutionMan,2627,536,22,18,40,55.0%,2h
26627,1,BIANCHIROCK,2627,512,17,18,35,48.6%,2h
26627,1,SrChoripan,2627,419,15,15,30,50.0%,21m
26627,1,[Dogee]biznatch,2627,344,10,13,23,43.5%,48m
26627,1,[REEFR]purplekush,2627,179,5,4,9,55.6%,1h
26627,1,GUEVARA,2627,196,5,9,14,35.7%,34m
26627,2,WildRage,2627,137,4,5,9,44.4%,34m
26627,2,TutoBD,2627,88,3,3,6,50.0%,51m
26627,2,[JUGOS]juanchasOWO,2627,93,3,3,6,50.0%,49m
26627,3,[sdBP]lock,2627,137,3,4,7,42.9%,3h
26627,3,[IH8TOS]waltiostias,2627,121,3,7,10,30.0%,36m
26627,3,[Ohyo]Momobad,2627,0,2,3,5,40.0%,20m
26627,1,[Deeeez]Swiss,2627,0,1,2,3,33.3%,2h
26627,2,Moemoney,2627,0,0,1,1,0.0%,2h
26627,2,[DRKDMN]romeo,2627,0,0,1,1,0.0%,51m
26627,3,McFly,2627,0,0,2,2,0.0%,54m
26627,1,Bobby,2627,0,0,2,2,0.0%,38m
26627,1,PicklePrime,2627,0,0,4,4,0.0%,35m
26649,2,[C42]GreedyFool,2626,1551,268,278,546,49.1%,27m
26649,1,Luffy,2626,572,24,18,42,57.1%,2h
26649,2,WRATH,2626,444,15,14,29,51.7%,2h
26649,2,MikeChicken,2626,387,13,8,21,61.9%,2h
26649,2,Raiderp,2626,356,13,15,28,46.4%,3h
26649,3,Ransom,2626,291,11,16,27,40.7%,30m
26649,3,ENGEL,2626,168,6,15,21,28.6%,24m
26649,1,[ZvP]Bushidoninja,2626,193,5,1,6,83.3%,2h
26649,1,[LDDM]Khayn,2626,152,5,6,11,45.5%,2h
26649,2,Snakegreen,2626,58,5,6,11,45.5%,19m
26649,1,kirigashiran,2626,156,5,7,12,41.7%,6m
26649,1,Dietwater,2626,182,5,9,14,35.7%,51m
26649,2,[LcH]DeePShadow,2626,0,4,1,5,80.0%,35m
26649,2,felon,2626,86,4,1,5,80.0%,49m
26649,2,Studiedgnome,2626,46,4,6,10,40.0%,2h
26649,2,miNi,2626,62,3,0,3,100.0%,3h
26649,2,Venum,2626,95,3,4,7,42.9%,18m
26649,2,Amordrel,2626,94,2,0,2,100.0%,43m
26649,3,[PiN0YS]Mithraic,2626,30,2,4,6,33.3%,20m
26649,1,Flank,2626,76,2,6,8,25.0%,1h
26649,2,[Akeno]GOTMEGAMILK,2626,0,1,0,1,100.0%,2h
26649,2,[DGCIM]torto,2626,0,1,1,2,50.0%,27m
26649,1,Klendathu,2626,30,1,3,4,25.0%,10m
26649,1,[GRU]Trippleblack,2626,34,1,6,7,14.3%,40m
26649,2,Spu,2626,0,0,1,1,0.0%,34m
26649,1,Cassyfat,2626,0,0,2,2,0.0%,3h
26649,1,HumYaiTH,2626,0,0,2,2,0.0%,3h
26676,2,jelsomino,2625,1462,168,166,334,50.3%,2m
26676,2,Beefey,2625,1487,121,125,246,49.2%,39m
26676,3,Gamezoid,2625,626,49,60,109,45.0%,16m
26676,1,Monster,2625,889,36,30,66,54.5%,13m
26676,3,GhettoYouf,2625,849,32,33,65,49.2%,30m
26676,2,Zerglingini,2625,438,28,17,45,62.2%,2h
26676,1,RamseySkyFly,2625,477,17,17,34,50.0%,2h
26676,1,ClowNeko,2625,493,17,21,38,44.7%,37m
26676,1,Satica,2625,220,14,15,29,48.3%,51m
26676,1,[TGCrew]Blankestz,2625,274,13,8,21,61.9%,36m
26676,2,Stairs,2625,284,10,3,13,76.9%,2h
26676,1,Ramses,2625,294,9,10,19,47.4%,2h
26676,3,Unsu,2625,171,7,11,18,38.9%,2h
26676,1,HeyDoc,2625,262,7,13,20,35.0%,3h
26676,3,ThatGuy,2625,248,7,18,25,28.0%,34m
26676,1,MicroJordanX,2625,165,5,3,8,62.5%,2h
26676,2,TheCanadian,2625,116,5,7,12,41.7%,12m
26676,2,Stumpy,2625,60,3,0,3,100.0%,2h
26676,1,koi,2625,72,3,4,7,42.9%,39m
26676,1,Alejandro,2625,78,3,5,8,37.5%,34m
26676,1,DRMANOLO,2625,48,2,2,4,50.0%,2h
26676,3,DoctorElkay,2625,0,2,3,5,40.0%,2h
26676,3,[NDC1]TheSiuG,2625,30,2,3,5,40.0%,56m
26676,2,BakeEyes,2625,0,0,1,1,0.0%,2h
26700,1,Rescue,2624,1507,118,84,202,58.4%,2h
26700,3,RADICAL,2624,1546,80,80,160,50.0%,18m
26700,1,Greg,2624,1591,74,75,149,49.7%,3h
26700,2,LockHard,2624,1013,42,36,78,53.8%,3h
26700,1,What,2624,788,31,28,59,52.5%,3h
26700,2,[10Z010]You,2624,105,25,35,60,41.7%,40m
26700,3,Viral,2624,477,19,23,42,45.2%,33m
26700,3,Hazard,2624,209,14,23,37,37.8%,8m
26700,3,RashTarMinya,2624,109,14,24,38,36.8%,39m
26700,1,[HSCT]SquashedDuck,2624,249,13,8,21,61.9%,16m
26700,2,[CREYE]InterNova,2624,331,10,8,18,55.6%,2h
26700,1,Malitof,2624,261,10,11,21,47.6%,19m
26700,2,kaishakunin,2624,246,9,5,14,64.3%,2h
26700,1,GainsGoblin,2624,317,9,11,20,45.0%,22m
26700,2,Charmancer,2624,114,5,2,7,71.4%,2h
26700,2,Garth,2624,92,5,6,11,45.5%,2h
26700,2,joaco,2624,0,3,0,3,100.0%,50m
26700,3,[CT5555]Berci,2624,40,2,0,2,100.0%,4m
26700,1,Valerie,2624,117,2,3,5,40.0%,1h
26700,3,[TROLL]SoupBone,2624,0,2,3,5,40.0%,60m
26700,1,daniel,2624,0,1,2,3,33.3%,2h
26700,3,Sven,2624,0,1,3,4,25.0%,2h
26700,1,[second]Ganymede,2624,0,1,4,5,20.0%,55m
26700,1,[tCo9]Kindred,2624,0,0,2,2,0.0%,32m
26724,3,Schism,2623,1534,99,102,201,49.3%,14m
26724,2,HATETERRAN,2623,521,24,11,35,68.6%,1h
26724,1,terrykof,2623,639,24,21,45,53.3%,3h
26724,2,Coolja,2623,375,16,5,21,76.2%,11m
26724,3,[Severe]StormCluster,2623,250,12,10,22,54.5%,3h
26724,1,UchihaJoel,2623,295,12,19,31,38.7%,48m
26724,1,KawaiiKY,2623,282,11,13,24,45.8%,19m
26724,1,IIIIIIIIIIII,2623,261,8,4,12,66.7%,3h
26724,2,[ANFA]SIXTIUM,2623,108,5,1,6,83.3%,21m
26724,1,BlothimGor,2623,148,4,7,11,36.4%,2h
26724,1,Killer,2623,150,4,8,12,33.3%,10m
26724,2,Sanxuandope,2623,90,3,2,5,60.0%,2h
26724,1,[PCNTE]Jambalaya,2623,40,2,2,4,50.0%,13m
26724,3,Nakhti,2623,0,2,3,5,40.0%,2h
26724,2,[danima]ryry,2623,0,2,3,5,40.0%,3h
26724,2,TheDumbOx,2623,0,1,0,1,100.0%,2h
26724,2,SkepticSloth,2623,0,1,4,5,20.0%,12m
26724,2,[Ash3s]General,2623,0,0,1,1,0.0%,17m
26724,3,Abel,2623,0,0,1,1,0.0%,48m
26724,1,[Fish]Carlfish,2623,0,0,3,3,0.0%,3h
26724,1,[EZYtgt]Torn,2623,0,0,4,4,0.0%,59m
26724,2,parasitezero,2623,0,0,5,5,0.0%,2m
26746,3,david,2622,1482,93,90,183,50.8%,9m
26746,3,[M0D]Vhaegar,2622,1385,71,70,141,50.4%,9m
26746,1,[BNITOS]Beto,2622,483,55,42,97,56.7%,43m
26746,1,Aura,2622,1210,54,53,107,50.5%,3h
26746,1,WhiteShadow,2622,1215,51,45,96,53.1%,13m
26746,1,Trottskydm,2622,1217,49,41,90,54.4%,33m
26746,3,TaylorGang,2622,511,41,43,84,48.8%,29m
26746,1,leinans,2622,582,20,18,38,52.6%,2h
26746,1,[IMDSI]RUBARAH,2622,399,16,11,27,59.3%,7m
26746,3,Karby,2622,239,14,17,31,45.2%,27m
26746,2,Huntfalow,2622,204,8,3,11,72.7%,27m
26746,1,leo,2622,306,7,11,18,38.9%,33m
26746,1,Cameron,2622,139,5,7,12,41.7%,37m
26746,1,[Murk]Windseeker,2622,193,5,11,16,31.2%,3h
26746,3,Nattura,2622,112,4,1,5,80.0%,2h
26746,2,MegaMariner,2622,120,4,3,7,57.1%,2h
26746,2,gabriel,2622,116,4,4,8,50.0%,2h
26746,2,RaccoonV,2622,0,2,3,5,40.0%,21m
26746,1,starboy,2622,38,2,5,7,28.6%,32m
26746,1,[Soy]BILLYMAYS,2622,0,1,1,2,50.0%,2h
26746,2,FarmerGiles,2622,0,0,1,1,0.0%,1h
26746,3,cOs,2622,0,0,1,1,0.0%,35m
26746,1,Heracles,2622,0,0,1,1,0.0%,3h
26769,1,WaldoTheBird,2621,1536,274,258,532,51.5%,44m
26769,3,Osheqriko,2621,1464,115,102,217,53.0%,35m
26769,3,Accumuladder,2621,967,91,86,177,51.4%,6m
26769,3,Henipah,2621,1342,63,59,122,51.6%,36m
26769,1,Darker,2621,1042,62,38,100,62.0%,33m
26769,1,Fax,2621,1496,56,53,109,51.4%,43m
26769,1,PollSed,2621,989,54,51,105,51.4%,2h
26769,1,Andersong,2621,686,24,20,44,54.5%,44m
26769,1,razerking,2621,443,17,20,37,45.9%,35m
26769,1,Rayko,2621,487,15,14,29,51.7%,1h
26769,3,[GnR]Hawkmoon,2621,362,13,20,33,39.4%,37m
26769,2,DemonMonkey,2621,291,11,28,39,28.2%,39m
26769,2,SloWFeel,2621,217,9,14,23,39.1%,2h
26769,2,DrInsanity,2621,86,7,4,11,63.6%,2h
26769,1,Kenshi,2621,243,7,11,18,38.9%,2m
26769,3,DKR,2621,94,4,8,12,33.3%,23m
26769,3,dasdsaf,2621,149,3,5,8,37.5%,44m
26769,3,[MARV3L]ChipperT,2621,0,2,1,3,66.7%,2h
26769,1,[PvZMa]xsaberdragon,2621,32,2,3,5,40.0%,59m
26769,2,Darksun,2621,0,2,3,5,40.0%,50m
26769,2,WhyNnot,2621,30,1,1,2,50.0%,7m
26769,1,andiro,2621,0,1,1,2,50.0%,3h
26769,3,emPty,2621,40,1,5,6,16.7%,3h
26769,1,genextrio,2621,0,0,2,2,0.0%,2h
26769,1,[XTGZ]Basaka,2621,0,0,3,3,0.0%,2h
26794,1,higgy,2620,986,47,45,92,51.1%,1h
26794,1,KillerAZ,2620,928,43,24,67,64.2%,2h
26794,3,CommandCentr,2620,720,42,26,68,61.8%,35m
26794,1,minikatz,2620,615,21,24,45,46.7%,2h
26794,1,enshow,2620,589,17,19,36,47.2%,2h
26794,3,SlikNdSneaky,2620,346,15,18,33,45.5%,22m
26794,2,MOYQUECO,2620,252,13,5,18,72.2%,33m
26794,2,ShadowMe,2620,359,12,13,25,48.0%,35m
26794,1,[JoroSC]Viruz,2620,288,12,18,30,40.0%,42m
26794,1,Dfour,2620,211,7,3,10,70.0%,44m
26794,1,KaizzerVanAs,2620,236,6,10,16,37.5%,39m
26794,1,Wessex,2620,76,4,5,9,44.4%,42m
26794,2,Tonko,2620,58,3,0,3,100.0%,24m
26794,2,OmarCa,2620,130,3,2,5,60.0%,24m
26794,3,Strajack,2620,97,3,3,6,50.0%,3m
26794,2,rafasnake,2620,64,2,1,3,66.7%,3h
26794,3,MrGreen,2620,0,2,3,5,40.0%,2h
26794,2,[C3R3AL]Fudgeeyenuh,2620,0,1,0,1,100.0%,51m
26794,2,[GZC]zgjsb,2620,0,1,0,1,100.0%,57m
26794,2,jsrl,2620,0,1,0,1,100.0%,35m
26794,2,bladeslicer,2620,0,1,0,1,100.0%,37m
26794,2,Rypc,2620,0,1,0,1,100.0%,47m
26794,1,TouchMyBelly,2620,44,1,3,4,25.0%,3h
26794,2,OscarGon,2620,0,0,2,2,0.0%,45m
26818,1,DutCh,2619,1056,138,150,288,47.9%,24m
26818,1,Grpyhn,2619,1284,77,58,135,57.0%,3h
26818,1,Azadorn,2619,1052,72,70,142,50.7%,2h
26818,3,[steel]Aion,2619,447,64,67,131,48.9%,30m
26818,2,RoxyFoxy,2619,1072,46,31,77,59.7%,3h
26818,3,[blacLM]SOS,2619,750,39,32,71,54.9%,6m
26818,2,Rebbix,2619,771,32,22,54,59.3%,2h
26818,1,[ØÛ]Skide,2619,599,26,16,42,61.9%,24m
26818,3,LowTax,2619,578,23,22,45,51.1%,25m
26818,1,ARTANIS,2619,479,22,15,37,59.5%,17m
26818,1,Brando,2619,291,17,18,35,48.6%,34m
26818,3,[Spain]frankk,2619,222,8,15,23,34.8%,6m
26818,3,cyrriusblack,2619,178,6,15,21,28.6%,7m
26818,2,TYMYOTUL,2619,159,4,3,7,57.1%,2h
26818,2,Kenay,2619,68,3,1,4,75.0%,17m
26818,2,Etheros,2619,94,3,2,5,60.0%,47m
26818,1,KaptinBadruk,2619,90,2,1,3,66.7%,7m
26818,1,Alexis,2619,110,2,3,5,40.0%,3h
26818,2,luxus,2619,0,2,4,6,33.3%,15m
26818,1,deadboltz,2619,84,2,6,8,25.0%,2h
26818,2,RoseGoldKen,2619,34,1,1,2,50.0%,3h
26818,1,[SOLOC]Shazaam,2619,0,0,2,2,0.0%,21m
26818,2,EasyCheeks,2619,0,0,3,3,0.0%,3h
26841,1,Beowulf,2618,1571,191,162,353,54.1%,13m
26841,3,Bert,2618,1524,120,103,223,53.8%,26m
26841,2,drJetSki,2618,1018,87,80,167,52.1%,60m
26841,3,Bowdenoli,2618,729,30,31,61,49.2%,3m
26841,1,walker,2618,354,17,8,25,68.0%,37m
26841,1,Brownchemist,2618,382,16,17,33,48.5%,2h
26841,2,Pridominus,2618,246,8,4,12,66.7%,2h
26841,3,Asmodean,2618,146,8,10,18,44.4%,25m
26841,2,Zyxven,2618,88,5,5,10,50.0%,18m
26841,2,Bio,2618,0,4,1,5,80.0%,50m
26841,1,[GUARA1]Leaffarr,2618,118,3,3,6,50.0%,2m
26841,1,Killdrjavier,2618,135,3,4,7,42.9%,13m
26841,2,Vinild,2618,119,2,3,5,40.0%,3h
26841,3,bairdos,2618,0,2,3,5,40.0%,2h
26841,3,Trhyt,2618,0,2,3,5,40.0%,23m
26841,2,Chikoro,2618,0,1,0,1,100.0%,3h
26841,2,[PATOE]JOHNNYDEPP,2618,0,1,1,2,50.0%,47m
26841,2,Bateman,2618,34,1,2,3,33.3%,49m
26841,3,Grayskull,2618,30,1,4,5,20.0%,2h
26841,1,[CRTico]Raz,2618,0,1,4,5,20.0%,25m
26841,2,Jacegman,2618,0,0,1,1,0.0%,2h
26841,2,[LHRS]Kanji,2618,0,0,1,1,0.0%,48m
26841,1,[tSC2LP]Nieuw,2618,0,0,1,1,0.0%,2h
26841,3,GARRUS,2618,0,0,2,2,0.0%,43m
26841,2,WNTRALEX,2618,0,0,5,5,0.0%,2h
26866,2,Broly,2617,1351,172,153,325,52.9%,28m
26866,2,Possum,2617,1267,136,135,271,50.2%,33m
26866,1,Manntra,2617,976,110,90,200,55.0%,24m
26866,1,madnëSs,2617,1567,76,60,136,55.9%,2h
26866,1,Ajom,2617,917,59,50,109,54.1%,15m
26866,1,BurnMD,2617,684,29,24,53,54.7%,39m
26866,1,RomanticHero,2617,252,16,17,33,48.5%,2h
26866,1,ALDEBARAN,2617,422,16,20,36,44.4%,2h
26866,1,XardasZ,2617,202,9,5,14,64.3%,2h
26866,1,[Zion]CaskStrength,2617,211,7,9,16,43.8%,43m
26866,2,DnaSegment,2617,117,4,3,7,57.1%,2h
26866,2,[F0cus]AgaveTeq,2617,139,4,6,10,40.0%,2h
26866,1,Renrag,2617,122,3,2,5,60.0%,2h
26866,1,DoNotForget,2617,78,3,5,8,37.5%,3h
26866,2,[WW1]Vrashley,2617,34,2,0,2,100.0%,7m
26866,3,Clonemaster,2617,36,2,1,3,66.7%,3h
26866,2,TeaLeafGreen,2617,92,2,8,10,20.0%,15m
26866,2,[UpeV]Aioria,2617,0,1,0,1,100.0%,3h
26866,2,razrivploti,2617,0,1,4,5,20.0%,2h
26866,2,Chiral,2617,0,0,1,1,0.0%,7m
26886,1,Infowars,2616,925,48,40,88,54.5%,33m
26886,2,[NgtKnt]healthycell,2616,601,28,16,44,63.6%,2h
26886,1,Pickle,2616,830,28,32,60,46.7%,3h
26886,2,Kingson,2616,407,19,13,32,59.4%,11m
26886,2,[SN3KS]RedViper,2616,224,9,4,13,69.2%,12m
26886,1,Zalxander,2616,234,8,8,16,50.0%,2h
26886,2,asd,2616,112,3,4,7,42.9%,3h
26886,2,[imN0ob]Kevo,2616,30,2,0,2,100.0%,43m
26886,2,Jawbreaker,2616,0,2,3,5,40.0%,2h
26886,2,[AUSBH]Kingpanday,2616,34,2,3,5,40.0%,18m
26886,2,luas,2616,0,2,3,5,40.0%,10m
26886,2,[tact1c]Killer,2616,0,2,3,5,40.0%,34m
26886,2,CryMeARiver,2616,62,2,4,6,33.3%,52m
26886,3,Ungermax,2616,114,2,4,6,33.3%,1m
26886,3,Mev,2616,0,1,1,2,50.0%,44m
26886,1,IIIIIIIIIIII,2616,42,1,7,8,12.5%,2h
26886,1,[cFG]Bock,2616,0,0,2,2,0.0%,20m
26903,2,KillaKat,2615,1599,255,253,508,50.2%,21m
26903,3,marius,2615,1159,116,90,206,56.3%,11m
26903,2,Lariat,2615,1608,101,77,178,56.7%,3h
26903,1,RainbowFruit,2615,1337,84,81,165,50.9%,2h
26903,3,eddie,2615,1238,79,88,167,47.3%,7m
26903,3,akoolbreeze,2615,489,64,65,129,49.6%,9m
26903,1,[iS1MP]FlaminWraith,2615,686,40,35,75,53.3%,7m
26903,2,Nice,2615,746,26,37,63,41.3%,34m
26903,1,Fantasma,2615,343,16,11,27,59.3%,43m
26903,3,Matt,2615,247,16,18,34,47.1%,29m
26903,1,yeahitisfu,2615,140,10,8,18,55.6%,43m
26903,2,jrealtor,2615,175,7,4,11,63.6%,51m
26903,1,[TOXx]Poton,2615,242,7,10,17,41.2%,48m
26903,1,Robles,2615,216,7,11,18,38.9%,2h
26903,1,Khornagaunt,2615,176,5,4,9,55.6%,55m
26903,3,ttorrrr,2615,40,3,1,4,75.0%,2h
26903,2,Zurg,2615,133,2,2,4,50.0%,51m
26903,1,hustlermind,2615,30,2,3,5,40.0%,34m
26903,2,BearHunter,2615,95,2,3,5,40.0%,1h
26903,3,NEMESIS,2615,0,2,3,5,40.0%,2h
26903,2,Luisito,2615,46,1,4,5,20.0%,2h
26924,3,jpnd,2614,1406,82,71,153,53.6%,3m
26924,3,[GGMESP]SNELX,2614,783,72,78,150,48.0%,30m
26924,1,Easty,2614,892,51,51,102,50.0%,36m
26924,1,SebastianCN,2614,1149,44,41,85,51.8%,3h
26924,1,DanWolfgang,2614,680,31,27,58,53.4%,56m
26924,1,[GCK]Pizzaslave,2614,509,22,21,43,51.2%,33m
26924,1,AdmusSaint,2614,484,19,19,38,50.0%,2h
26924,1,KING,2614,496,18,14,32,56.2%,1h
26924,1,SilentSword,2614,344,13,7,20,65.0%,42m
26924,2,Protoszoario,2614,298,13,18,31,41.9%,39m
26924,1,fvelmntnja,2614,262,9,10,19,47.4%,51m
26924,1,BzKTab,2614,128,8,13,21,38.1%,36m
26924,2,Sparklepaint,2614,206,6,2,8,75.0%,7m
26924,2,Jake,2614,110,6,3,9,66.7%,2h
26924,1,[DPatRR]bBduongBb,2614,174,5,7,12,41.7%,3h
26924,2,Next,2614,120,4,2,6,66.7%,3h
26924,2,lolpio,2614,112,3,4,7,42.9%,35m
26924,1,Bilbo,2614,0,3,5,8,37.5%,3h
26924,3,Rymon,2614,34,2,1,3,66.7%,14m
26924,2,SteveJack,2614,66,2,3,5,40.0%,3h
26924,1,mizu,2614,30,2,3,5,40.0%,56m
26924,3,[copain]HImaNs,2614,0,2,3,5,40.0%,48m
26924,1,BeefyZeaLoT,2614,0,2,4,6,33.3%,40m
26924,3,DirtyTWillis,2614,58,2,12,14,14.3%,30m
26924,2,Xargon,2614,30,1,2,3,33.3%,2h
26924,2,[RUMB]steeziak,2614,0,0,1,1,0.0%,24m
26924,2,[xOwOx]Elbier,2614,0,0,1,1,0.0%,17m
26924,2,morgs,2614,0,0,1,1,0.0%,2h
26924,1,SomiSomi,2614,0,0,3,3,0.0%,2h
26953,3,Zethar,2613,429,225,200,425,52.9%,19m
26953,1,TDAVIS,2613,988,96,78,174,55.2%,12m
26953,2,Garnet,2613,917,42,24,66,63.6%,47m
26953,1,[GRNSKN]zenden,2613,937,35,31,66,53.0%,21m
26953,2,TitaN,2613,296,13,1,14,92.9%,2h
26953,1,NOISYBOY,2613,316,10,8,18,55.6%,3h
26953,1,yervx,2613,306,9,8,17,52.9%,12m
26953,1,Bonus,2613,105,6,7,13,46.2%,3h
26953,1,Stinger,2613,132,4,2,6,66.7%,2h
26953,2,Caedus,2613,140,4,5,9,44.4%,17m
26953,2,Sandtrap,2613,88,3,0,3,100.0%,15m
26953,2,vicente,2613,90,3,3,6,50.0%,3h
26953,2,[LeeMon]Maurosky,2613,46,2,1,3,66.7%,15m
26953,3,beno,2613,0,2,1,3,66.7%,48m
26953,3,Inkling,2613,0,2,3,5,40.0%,14m
26953,3,ArloTron,2613,0,2,3,5,40.0%,55m
26953,2,JIMBO,2613,0,1,0,1,100.0%,54m
26953,3,Fenelov,2613,0,1,1,2,50.0%,2h
26953,2,InsaneCat,2613,0,0,1,1,0.0%,45m
26972,3,Kratos,2612,1506,185,164,349,53.0%,29m
26972,2,terranmaster,2612,1569,152,163,315,48.3%,6m
26972,2,Draco,2612,1319,132,131,263,50.2%,1h
26972,2,MATO,2612,1100,97,96,193,50.3%,27m
26972,3,Mcatnip,2612,1234,52,54,106,49.1%,24m
26972,2,novo,2612,1105,46,49,95,48.4%,6m
26972,3,FindingMyslf,2612,486,24,18,42,57.1%,26m
26972,1,Zeuz,2612,216,21,24,45,46.7%,3h
26972,1,FRONT,2612,456,20,20,40,50.0%,23m
26972,1,[ReZipE]CremeBrulee,2612,636,19,24,43,44.2%,48m
26972,1,[arum]SubparMar,2612,434,17,11,28,60.7%,40m
26972,1,EHOT,2612,332,13,10,23,56.5%,33m
26972,1,Aalleyway,2612,314,12,10,22,54.5%,16m
26972,3,tacitus,2612,318,11,20,31,35.5%,5m
26972,1,[EW3]IvoryParrot,2612,160,6,7,13,46.2%,32m
26972,1,Skivil,2612,156,5,6,11,45.5%,1h
26972,2,Simonlemu,2612,0,4,2,6,66.7%,2h
26972,2,[TGosuC]TheLichKing,2612,116,4,4,8,50.0%,2h
26972,1,NyaaaGrill,2612,182,4,4,8,50.0%,59m
26972,1,Camilito,2612,68,3,3,6,50.0%,56m
26972,3,Ragnus,2612,74,3,15,18,16.7%,29m
26972,3,Lycade,2612,0,2,3,5,40.0%,2h
26972,2,trixiee,2612,0,2,3,5,40.0%,22m
26972,2,Marie,2612,0,2,3,5,40.0%,60m
26972,2,KimIlSung,2612,0,1,0,1,100.0%,37m
26972,2,banjo,2612,0,1,0,1,100.0%,3h
26972,2,[Epokhé]RaZoR,2612,0,1,0,1,100.0%,1h
26972,2,ratasky,2612,0,1,0,1,100.0%,1h
26972,2,[BlTEL]rasalghul,2612,0,1,1,2,50.0%,36m
26972,3,[PobSC]Isfergoler,2612,0,1,1,2,50.0%,52m
26972,1,EZZZ,2612,0,1,1,2,50.0%,3h
26972,3,[iTriP]ShroomSensei,2612,0,1,2,3,33.3%,2m
26972,3,traverse,2612,0,1,2,3,33.3%,35m
26972,1,JRyujin,2612,0,1,2,3,33.3%,2h
26972,2,[UMCP]Iskoldo,2612,0,0,1,1,0.0%,2h
27007,3,django,2611,966,51,42,93,54.8%,1m
27007,3,gertsfert,2611,648,34,31,65,52.3%,23m
27007,2,[XWM]Rend,2611,772,30,38,68,44.1%,35m
27007,1,Macro,2611,668,29,28,57,50.9%,1h
27007,2,xLordxDeathx,2611,643,28,17,45,62.2%,50m
27007,2,[EYELID]KoupJa,2611,548,23,11,34,67.6%,4m
27007,2,JustDoIt,2611,278,9,21,30,30.0%,10m
27007,1,Chandl,2611,224,7,13,20,35.0%,3h
27007,1,assaro,2611,193,5,5,10,50.0%,12m
27007,1,George,2611,191,5,6,11,45.5%,2h
27007,1,AgentOfChaos,2611,112,4,8,12,33.3%,1h
27007,2,Oracle,2611,58,3,1,4,75.0%,1h
27007,1,somuch,2611,68,3,5,8,37.5%,7m
27007,1,KungFooPanDa,2611,34,2,5,7,28.6%,23m
27007,1,gustducin,2611,74,2,6,8,25.0%,43m
27007,2,Chokaku,2611,42,1,1,2,50.0%,1h
27007,1,SplDimension,2611,0,1,3,4,25.0%,55m
27007,2,NicaGizmody,2611,0,1,4,5,20.0%,2h
27007,1,TheWitch,2611,36,1,5,6,16.7%,60m
27007,1,Vince,2611,0,1,5,6,16.7%,2h
27007,1,[DMONlC]DEMONIC,2611,0,0,3,3,0.0%,33m
27007,1,CMart,2611,0,0,6,6,0.0%,2h
27029,1,KepaleBANAR,2610,1551,287,285,572,50.2%,37m
27029,1,LLama,2610,1722,207,214,421,49.2%,2h
27029,2,yayo,2610,502,110,122,232,47.4%,39m
27029,2,Thegubester,2610,1567,74,67,141,52.5%,43m
27029,1,fangel,2610,1006,39,38,77,50.6%,33m
27029,1,DiccCheney,2610,907,37,42,79,46.8%,42m
27029,3,AcidWulf,2610,704,28,32,60,46.7%,14m
27029,2,CiroDiMarzio,2610,601,24,21,45,53.3%,2h
27029,2,MasomY,2610,232,8,2,10,80.0%,49m
27029,2,Weezer,2610,208,5,8,13,38.5%,28m
27029,2,[mamm]theOWENER,2610,68,3,2,5,60.0%,34m
27029,1,Curry,2610,141,3,2,5,60.0%,2m
27029,1,wester,2610,189,3,3,6,50.0%,25m
27029,2,HARMICHAEL,2610,105,2,2,4,50.0%,9m
27029,2,TrickKing,2610,0,2,3,5,40.0%,17m
27029,2,hcteks,2610,0,2,3,5,40.0%,57m
27029,2,Thrang,2610,0,1,1,2,50.0%,3h
27029,3,[ExcIgN]eloy,2610,92,1,7,8,12.5%,27m
27029,3,Swindyy,2610,30,1,10,11,9.1%,39m
27029,3,[Fgtron]Noah,2610,0,0,1,1,0.0%,52m
27049,1,brahamnp,2609,1602,158,144,302,52.3%,45m
27049,1,auzilla,2609,866,119,110,229,52.0%,2h
27049,3,Peachez,2609,1353,79,70,149,53.0%,26m
27049,2,TonyPOPONY,2609,1098,43,40,83,51.8%,2h
27049,3,DioBrando,2609,468,40,40,80,50.0%,13m
27049,1,Beastmode,2609,461,19,14,33,57.6%,3h
27049,1,JOD,2609,541,19,19,38,50.0%,2h
27049,3,VARTIX,2609,508,19,20,39,48.7%,19m
27049,2,[H2ERO]Weeaboo,2609,450,18,10,28,64.3%,12m
27049,1,[QPEDO]Oscari,2609,386,13,16,29,44.8%,7m
27049,1,Vegita,2609,240,10,6,16,62.5%,17m
27049,1,Wepycraft,2609,176,7,10,17,41.2%,3h
27049,2,ineke,2609,177,5,1,6,83.3%,16m
27049,1,[uT4]Overkill,2609,176,5,7,12,41.7%,2h
27049,2,Capitalist,2609,0,4,3,7,57.1%,1h
27049,3,[GpsyDg]Shadow,2609,97,3,3,6,50.0%,2h
27049,2,[Kyush0]vsky,2609,34,2,0,2,100.0%,2h
27049,3,cncace,2609,0,2,4,6,33.3%,53m
27049,2,ambient,2609,0,1,0,1,100.0%,1h
27049,2,Xanthus,2609,0,1,0,1,100.0%,49m
27049,1,[FALURS]wolfheart,2609,0,1,1,2,50.0%,39m
27049,2,[DNKCFT]KneckandNeck,2609,30,1,2,3,33.3%,53m
27049,2,Nova,2609,13,1,2,3,33.3%,36m
27049,3,AmazingBob,2609,0,1,3,4,25.0%,50m
27049,2,[BoAVN]Legosii,2609,96,1,3,4,25.0%,2h
27049,2,[JAEGER]Arminius,2609,96,1,4,5,20.0%,2h
27049,1,kesbie,2609,40,1,8,9,11.1%,33m
27049,1,[EaWorm]DemonLeoZ,2609,0,0,1,1,0.0%,2h
27049,2,POLLO,2609,0,0,1,1,0.0%,39m
27049,2,[MAQTAS]Nando,2609,0,0,1,1,0.0%,12m
27049,1,[KCDah]qazwec,2609,0,0,2,2,0.0%,3h
27080,1,llllllllllll,2608,1540,246,256,502,49.0%,8m
27080,2,Blueskull,2608,1443,93,103,196,47.4%,27m
27080,2,[JaMiT]Appoloin,2608,1240,53,65,118,44.9%,17m
27080,1,[FBC]Ethan,2608,552,21,20,41,51.2%,33m
27080,3,[RawDog]DrPoopyHands,2608,360,19,33,52,36.5%,9m
27080,2,HairyProbe,2608,254,10,4,14,71.4%,24m
27080,1,[ExcIgN]LeCake,2608,96,5,6,11,45.5%,2h
27080,2,[kite]masontmusso,2608,116,4,1,5,80.0%,2h
27080,1,InmerseNight,2608,184,4,1,5,80.0%,59m
27080,2,Lurenman,2608,124,4,2,6,66.7%,21m
27080,3,[ZTemps]Vayne,2608,147,4,8,12,33.3%,20m
27080,2,RID,2608,58,3,1,4,75.0%,48m
27080,2,DuderMcGuder,2608,88,3,3,6,50.0%,17m
27080,1,Dilo,2608,136,3,4,7,42.9%,6m
27080,2,LGNoth,2608,30,2,0,2,100.0%,1h
27080,3,AkkeSmash,2608,0,2,1,3,66.7%,2h
27080,2,overkill,2608,46,2,2,4,50.0%,56m
27080,2,SuperDee,2608,0,2,3,5,40.0%,17m
27080,2,Jacob,2608,0,1,1,2,50.0%,15m
27080,2,[FTLTX]nivelk,2608,0,0,1,1,0.0%,2h
27080,2,Loimos,2608,0,0,1,1,0.0%,27m
27080,1,FenLore,2608,0,0,4,4,0.0%,39m
27102,3,Emperor,2607,1405,108,89,197,54.8%,24m
27102,3,[DoRQ]Ripley,2607,1310,55,60,115,47.8%,6m
27102,1,Brasides,2607,1037,44,47,91,48.4%,1h
27102,3,Allusive,2607,411,44,49,93,47.3%,17m
27102,1,naqua,2607,620,23,27,50,46.0%,1h
27102,3,[NPA]RAGNAR,2607,406,14,19,33,42.4%,22m
27102,3,iAlan,2607,168,7,12,19,36.8%,47m
27102,1,Arkinos,2607,188,6,5,11,54.5%,2h
27102,2,Stars,2607,94,4,2,6,66.7%,1h
27102,1,Kiritokun,2607,148,4,9,13,30.8%,7m
27102,2,Charly,2607,30,3,4,7,42.9%,60m
27102,2,Alex,2607,66,3,5,8,37.5%,2h
27102,1,KonArtifex,2607,0,3,6,9,33.3%,3h
27102,1,[SyL]Kmannamk,2607,95,2,2,4,50.0%,3h
27102,1,[ValidG]Aberic,2607,40,2,4,6,33.3%,55m
27102,3,Griesy,2607,62,2,6,8,25.0%,8m
27102,2,[TGCrew]GIZZMO,2607,0,1,0,1,100.0%,2h
27102,2,mono,2607,32,1,1,2,50.0%,2h
27102,2,CombatEX,2607,30,1,1,2,50.0%,4m
27102,2,blaznbaby,2607,30,1,3,4,25.0%,27m
27102,2,ShiftySquats,2607,0,0,1,1,0.0%,2h
27102,2,EffeCt,2607,0,0,1,1,0.0%,35m
27102,1,Platypus,2607,0,0,3,3,0.0%,37m
27125,2,Hero,2606,1438,68,69,137,49.6%,1h
27125,1,[SDWWF]Alvarron,2606,597,56,48,104,53.8%,52m
27125,2,[SyncFr]FrankStrong,2606,1218,42,56,98,42.9%,9m
27125,1,UltimateNoob,2606,876,39,29,68,57.4%,48m
27125,2,TheSchafes,2606,615,19,26,45,42.2%,31m
27125,2,[MTFKEZ]danyDark,2606,356,15,9,24,62.5%,2h
27125,3,Killpretty,2606,355,12,16,28,42.9%,24m
27125,3,RACSO,2606,281,9,17,26,34.6%,40m
27125,2,Hunter,2606,248,8,10,18,44.4%,37m
27125,2,SILVANO,2606,252,8,13,21,38.1%,1h
27125,3,MincheRrat,2606,210,8,14,22,36.4%,7m
27125,2,Proteinovich,2606,116,5,3,8,62.5%,16m
27125,2,[SkAL]Ozlord,2606,32,4,3,7,57.1%,1h
27125,1,StarKiller,2606,139,3,4,7,42.9%,43m
27125,1,JuzamDJ,2606,117,3,4,7,42.9%,2h
27125,1,Kapis,2606,121,3,6,9,33.3%,2h
27125,2,vaquitov,2606,30,1,1,2,50.0%,1h
27125,2,[SAKT1]HomeloChino,2606,30,1,2,3,33.3%,2h
27125,1,GrimPommeler,2606,0,1,3,4,25.0%,2h
27125,1,Chip,2606,0,1,5,6,16.7%,20m
27145,1,dpdunn,2605,1420,59,52,111,53.2%,2h
27145,1,[MUTX]WaltD,2605,748,28,27,55,50.9%,15m
27145,1,Legosi,2605,668,25,25,50,50.0%,33m
27145,1,Gingko,2605,652,22,21,43,51.2%,16m
27145,3,Gyro,2605,271,13,10,23,56.5%,35m
27145,2,Llama,2605,233,8,3,11,72.7%,3h
27145,1,wOsHiCaSiNo,2605,168,7,5,12,58.3%,59m
27145,2,[iMkS]Sebastián,2605,163,5,3,8,62.5%,60m
27145,2,LetzHevFun,2605,166,5,4,9,55.6%,51m
27145,2,DroppingBB,2605,178,5,6,11,45.5%,56m
27145,1,ArtVandelay,2605,112,4,7,11,36.4%,2h
27145,2,Atu,2605,88,3,3,6,50.0%,24m
27145,3,[IBIB]juggernaut,2605,44,3,4,7,42.9%,48m
27145,2,TopherVexel,2605,94,3,5,8,37.5%,3h
27145,2,PulchraMors,2605,60,2,2,4,50.0%,51m
27145,3,CGS,2605,30,2,2,4,50.0%,2h
27145,2,Mortivore,2605,0,2,3,5,40.0%,3h
27145,2,Cory,2605,0,2,3,5,40.0%,22m
27145,2,JSOCHArt,2605,0,0,1,1,0.0%,2m
27145,2,Gilbert,2605,0,0,1,1,0.0%,2h
27145,2,RAR,2605,0,0,2,2,0.0%,27m
27166,3,EndlessOne,2604,936,51,58,109,46.8%,39m
27166,2,[PTHero]beekeeper,2604,564,23,15,38,60.5%,2h
27166,3,cosmicmuffin,2604,404,16,21,37,43.2%,27m
27166,1,Reblochon,2604,369,15,13,28,53.6%,9m
27166,1,[sanwch]DividedSky,2604,403,13,11,24,54.2%,3h
27166,1,[cluez]Mutago,2604,211,8,7,15,53.3%,3h
27166,1,Kreos,2604,127,7,4,11,63.6%,39m
27166,1,FunkyMonkey,2604,130,7,5,12,58.3%,32m
27166,1,JoshMan,2604,169,7,9,16,43.8%,3h
27166,2,Selrahc,2604,58,3,0,3,100.0%,2h
27166,2,tmathe,2604,88,3,4,7,42.9%,19m
27166,2,Mikeldigra,2604,30,2,0,2,100.0%,17m
27166,2,NotToGood,2604,30,2,2,4,50.0%,9m
27166,1,[RAP]MrTWrecks,2604,96,2,3,5,40.0%,40m
27166,3,LeThaL,2604,0,2,4,6,33.3%,43m
27166,1,Jellymage,2604,97,2,4,6,33.3%,3h
27166,2,HavelTheRock,2604,0,1,1,2,50.0%,8m
27166,2,jBones,2604,94,1,1,2,50.0%,2h
27166,2,James,2604,0,0,1,1,0.0%,1h
27185,1,ntr,2603,1558,110,100,210,52.4%,2h
27185,1,ChuckNorrisX,2603,1545,73,79,152,48.0%,2h
27185,1,PPHI,2603,528,44,27,71,62.0%,13m
27185,1,YhonMc,2603,494,40,30,70,57.1%,1h
27185,1,Luffy,2603,246,37,37,74,50.0%,3h
27185,1,stefano,2603,808,36,34,70,51.4%,3h
27185,2,Benji,2603,296,11,11,22,50.0%,22m
27185,1,[Albino]ItsHappening,2603,222,8,6,14,57.1%,2h
27185,2,Hamburglar,2603,240,7,5,12,58.3%,3h
27185,1,delpolloloko,2603,183,6,8,14,42.9%,20m
27185,1,Dabiuteef,2603,252,6,11,17,35.3%,59m
27185,2,kballeroblnc,2603,0,4,4,8,50.0%,2m
27185,3,GeShenli,2603,120,4,15,19,21.1%,9m
27185,1,Orange,2603,131,2,6,8,25.0%,2h
27185,2,Andythenerd,2603,0,1,0,1,100.0%,24m
27185,2,TMSxKhoSa,2603,30,1,1,2,50.0%,27m
27185,2,[SID]Loki,2603,30,1,1,2,50.0%,3h
27185,1,Rodri,2603,0,1,1,2,50.0%,21m
27185,3,schterlo,2603,0,1,5,6,16.7%,2h
27185,2,Weeny,2603,0,0,1,1,0.0%,2h
27185,3,Ephixa,2603,0,0,1,1,0.0%,4m
27185,3,[kayi]Sallahudin,2603,0,0,1,1,0.0%,15m
27185,1,[HDOG]Ephaestus,2603,0,0,3,3,0.0%,1h
27208,2,morlokito,2602,1664,409,416,825,49.6%,29m
27208,3,zachyg,2602,1200,204,218,422,48.3%,24m
27208,2,ObiTrice,2602,1402,73,94,167,43.7%,35m
27208,2,TheAmerican,2602,1531,55,66,121,45.5%,19m
27208,1,SHMC,2602,1118,47,41,88,53.4%,52m
27208,3,Shippy,2602,867,37,37,74,50.0%,2m
27208,1,Darwin,2602,863,32,31,63,50.8%,34m
27208,2,[EpicG]HellRaiser,2602,497,30,16,46,65.2%,12m
27208,2,[PY]TerransKids,2602,571,26,14,40,65.0%,2h
27208,3,Ceezy,2602,156,6,10,16,37.5%,22m
27208,2,Rowenne,2602,180,5,6,11,45.5%,2h
27208,2,Revenge,2602,96,3,3,6,50.0%,2h
27208,2,Dan,2602,30,2,0,2,100.0%,51m
27208,1,hotniX,2602,93,2,3,5,40.0%,2m
27208,3,[Zynist]Rage,2602,0,2,3,5,40.0%,43m
27208,3,austinpo,2602,0,2,3,5,40.0%,24m
27208,2,Tarzul,2602,0,1,0,1,100.0%,2h
27208,2,huhu,2602,0,1,0,1,100.0%,43m
27208,2,HuntingFox,2602,0,1,4,5,20.0%,50m
27208,2,[URQ]McPupu,2602,0,0,1,1,0.0%,3h
27208,2,InfamousTRTL,2602,0,0,1,1,0.0%,19m
27208,1,SirWiggles,2602,0,0,4,4,0.0%,2h
27208,1,Laidyn,2602,0,0,7,7,0.0%,2h
27231,1,Jebaited,2601,1682,128,115,243,52.7%,53m
27231,2,Deneol,2601,951,113,101,214,52.8%,2h
27231,1,Rini,2601,1544,105,98,203,51.7%,1h
27231,3,Killz,2601,462,15,26,41,36.6%,2m
27231,2,garthims,2601,309,11,4,15,73.3%,3h
27231,2,[ItsOkI]Storm,2601,207,7,7,14,50.0%,19m
27231,2,Breadmaster,2601,142,6,7,13,46.2%,1h
27231,1,[Blacer]Darkmatter,2601,140,4,8,12,33.3%,20m
27231,2,BubbaInSpace,2601,58,3,2,5,60.0%,35m
27231,2,TheKAJG,2601,94,3,4,7,42.9%,34m
27231,2,youngrichc,2601,30,3,4,7,42.9%,2h
27231,2,kes,2601,30,2,0,2,100.0%,1h
27231,2,[preggo]pwnseidon,2601,30,2,0,2,100.0%,35m
27231,1,Mike,2601,90,2,1,3,66.7%,20m
27231,1,Jundie,2601,123,2,4,6,33.3%,52m
27231,3,Chindt,2601,0,2,4,6,33.3%,2h
27231,2,KEKW,2601,0,1,0,1,100.0%,1h
27231,2,[PCQ]BeastLight,2601,0,1,1,2,50.0%,3h
27231,1,[N0BLE]Freak,2601,0,1,2,3,33.3%,2h
27231,1,Wizzleli,2601,34,1,4,5,20.0%,35m
27231,2,[RlSK]Zenith,2601,0,0,1,1,0.0%,3h
27231,2,Bart,2601,0,0,1,1,0.0%,34m
27231,3,Lelouch,2601,0,0,1,1,0.0%,4m
27231,1,Confluence,2601,0,0,1,1,0.0%,2h
27231,3,AlbertoZD,2601,0,0,9,9,0.0%,34m
27256,2,Doraste,2600,1158,53,33,86,61.6%,49m
27256,2,[DarkAG]Ocelot,2600,732,32,16,48,66.7%,23m
27256,2,snakeson,2600,758,30,22,52,57.7%,50m
27256,1,WrongSwanson,2600,673,28,21,49,57.1%,45m
27256,1,Delta,2600,310,15,12,27,55.6%,2h
27256,2,Latino,2600,206,8,2,10,80.0%,39m
27256,1,Adonis,2600,148,5,6,11,45.5%,59m
27256,2,JimDogMeyer,2600,120,4,5,9,44.4%,1h
27256,2,BakpoPtaKsup,2600,118,4,6,10,40.0%,22m
27256,2,yelmagicman,2600,92,3,4,7,42.9%,3h
27256,3,INFESTED,2600,121,2,1,3,66.7%,30m
27256,2,demon,2600,99,2,2,4,50.0%,7m
27256,1,SoapEater,2600,38,2,4,6,33.3%,2h
27256,2,Alister,2600,0,1,0,1,100.0%,22m
27256,2,CynicalPub,2600,30,1,2,3,33.3%,36m
27256,3,anustearer,2600,0,1,3,4,25.0%,3h
27256,2,Dant,2600,30,1,5,6,16.7%,39m
27256,2,ScorpioQc,2600,0,0,1,1,0.0%,2h
27274,2,BigLobster,2599,1198,226,229,455,49.7%,38m
27274,3,Alandri,2599,1460,122,130,252,48.4%,2m
27274,1,[Yamet]PerroHúmedo,2599,1163,51,41,92,55.4%,2h
27274,2,Jauvil,2599,701,30,23,53,56.6%,24m
27274,2,[ZHK]wayo,2599,220,29,23,52,55.8%,3h
27274,2,FrostPhoenix,2599,644,29,25,54,53.7%,2h
27274,2,Chatiko,2599,526,20,19,39,51.3%,48m
27274,2,Auditor,2599,356,15,10,25,60.0%,31m
27274,3,Phi,2599,352,12,21,33,36.4%,23m
27274,1,[KIRIOS]ARTIMUL,2599,271,7,12,19,36.8%,2h
27274,2,[Lac10]brujochilote,2599,30,5,0,5,100.0%,22m
27274,2,[Boboyz]SteveCherry,2599,154,5,3,8,62.5%,34m
27274,2,Jezzalenko,2599,84,3,6,9,33.3%,19m
27274,2,MaximilianGA,2599,0,2,3,5,40.0%,1h
27274,3,joelraynor,2599,0,2,3,5,40.0%,52m
27274,3,Juy,2599,30,2,8,10,20.0%,4m
27274,3,husty,2599,0,1,0,1,100.0%,2h
27274,2,[N2F]greazer,2599,0,1,1,2,50.0%,33m
27274,2,Ceven,2599,44,1,1,2,50.0%,1h
27274,1,evilbrood,2599,34,1,3,4,25.0%,2h
27274,1,Schwardix,2599,0,1,3,4,25.0%,44m
27274,3,Marian,2599,97,1,5,6,16.7%,2h
27296,3,Endrows,2598,1562,227,226,453,50.1%,40m
27296,1,dandab,2598,1691,176,166,342,51.5%,2h
27296,1,TheMajor,2598,1635,108,91,199,54.3%,2h
27296,2,Mike,2598,1627,103,103,206,50.0%,7m
27296,1,hahacool,2598,593,34,29,63,54.0%,2h
27296,2,ChewChow,2598,632,23,22,45,51.1%,48m
27296,2,Varimatas,2598,528,19,18,37,51.4%,35m
27296,3,[1488HH]Player,2598,328,19,26,45,42.2%,29m
27296,1,SpaceMonkey,2598,289,14,18,32,43.8%,2h
27296,1,Primetime,2598,242,7,12,19,36.8%,2h
27296,1,Talieson,2598,120,5,6,11,45.5%,3h
27296,2,ferrazo,2598,117,4,4,8,50.0%,1h
27296,2,Gucci,2598,138,3,1,4,75.0%,11m
27296,2,WhaToDo,2598,32,2,0,2,100.0%,2m
27296,3,pripiat,2598,0,2,2,4,50.0%,48m
27296,2,SuperWok,2598,0,2,3,5,40.0%,23m
27296,2,katana,2598,0,2,3,5,40.0%,3h
27296,1,TxPoonTappa,2598,72,2,5,7,28.6%,1h
27296,1,Muenster,2598,60,2,12,14,14.3%,40m
27296,3,GORILAX,2598,62,2,12,14,14.3%,21m
27296,1,honeynut,2598,48,1,2,3,33.3%,2h
27296,2,PhoKing,2598,0,0,1,1,0.0%,22m
27296,3,[Topper]WeaponOfWar,2598,0,0,1,1,0.0%,16m
27296,3,TheComander,2598,0,0,1,1,0.0%,5m
27296,2,houlieman,2598,0,0,2,2,0.0%,2h
27321,1,joshishoard,2597,1540,397,367,764,52.0%,50m
27321,3,applewant,2597,1356,146,148,294,49.7%,9m
27321,1,Dante,2597,574,42,34,76,55.3%,36m
27321,2,[THD]LtOcelot,2597,245,23,12,35,65.7%,22m
27321,1,Daruk,2597,254,19,13,32,59.4%,2h
27321,1,Rupphire,2597,386,13,18,31,41.9%,24m
27321,2,[TGosuB]GGnoRe,2597,328,10,22,32,31.2%,34m
27321,1,[MMSTAR]Legend,2597,96,7,7,14,50.0%,3h
27321,2,LingPie,2597,184,4,2,6,66.7%,52m
27321,2,Meklor,2597,46,4,6,10,40.0%,3h
27321,3,Kastle,2597,0,3,2,5,60.0%,2h
27321,3,[RBRoll]Tane,2597,36,3,4,7,42.9%,2h
27321,1,DonOmarPbScY,2597,130,3,4,7,42.9%,15m
27321,3,Winger,2597,72,3,13,16,18.8%,8m
27321,2,MarcosEdo,2597,89,2,4,6,33.3%,3h
27321,3,legacy,2597,60,2,14,16,12.5%,13m
27321,2,DARKERG,2597,30,1,1,2,50.0%,48m
27321,2,Goodie,2597,0,0,1,1,0.0%,34m
27321,2,Dildow,2597,0,0,1,1,0.0%,35m
27340,2,[1BSBC]RatZSifury,2596,1575,210,186,396,53.0%,12m
27340,1,IggyAPK,2596,1634,151,131,282,53.5%,33m
27340,1,Mars,2596,1303,91,73,164,55.5%,32m
27340,2,Abdunm,2596,821,31,29,60,51.7%,2h
27340,3,SingeVolant,2596,273,22,29,51,43.1%,3m
27340,3,Monica,2596,275,10,14,24,41.7%,14m
27340,2,[Grayon]Alak,2596,199,9,3,12,75.0%,1h
27340,3,[S0O]FIREGROUND,2596,235,7,7,14,50.0%,1h
27340,1,myles,2596,144,7,9,16,43.8%,3h
27340,2,MILKshoot,2596,134,4,3,7,57.1%,33m
27340,2,SpaceFrog,2596,104,4,5,9,44.4%,54m
27340,1,[FROMOZ]TheKing,2596,96,2,0,2,100.0%,3h
27340,2,TentacleMom,2596,36,2,1,3,66.7%,2h
27340,2,sgt,2596,88,2,3,5,40.0%,1h
27340,2,Han,2596,0,2,3,5,40.0%,2h
27340,2,[No0Bs]Talerin,2596,0,0,1,1,0.0%,2h
27340,2,HalFdan,2596,0,0,1,1,0.0%,1h
27340,2,cookie,2596,0,0,1,1,0.0%,2h
27340,2,BigJay,2596,0,0,2,2,0.0%,49m
27359,1,yomamasass,2595,1665,126,116,242,52.1%,2h
27359,3,[MSLF]Skarner,2595,940,58,63,121,47.9%,33m
27359,2,Sswagh,2595,514,18,20,38,47.4%,3h
27359,1,CoolGuy,2595,398,16,11,27,59.3%,2h
27359,2,[UpxV]tuclavo,2595,393,15,8,23,65.2%,49m
27359,3,Arthuro,2595,359,13,10,23,56.5%,59m
27359,1,KIRITO,2595,309,10,17,27,37.0%,2h
27359,1,VigilantGoat,2595,213,8,8,16,50.0%,50m
27359,1,JackDupp,2595,146,6,9,15,40.0%,26m
27359,1,Grootosfull,2595,96,5,4,9,55.6%,48m
27359,2,[TgJc]ThatGuyJorge,2595,122,4,2,6,66.7%,34m
27359,2,CapmCrunch,2595,119,3,1,4,75.0%,3h
27359,3,CachoSnacks,2595,115,3,7,10,30.0%,4m
27359,3,[SunTzu]FSGCastiel,2595,95,2,0,2,100.0%,1h
27359,2,[5Svrt]Nyctor,2595,32,2,1,3,66.7%,27m
27359,2,StupidPig,2595,58,2,1,3,66.7%,1h
27359,2,Tempest,2595,30,2,1,3,66.7%,51m
27359,1,MataMuta,2595,0,2,4,6,33.3%,1h
27359,1,Will,2595,78,2,7,9,22.2%,6m
27359,2,kell,2595,0,1,0,1,100.0%,3h
27359,2,zosimos,2595,46,1,1,2,50.0%,52m
27359,2,hay,2595,30,1,1,2,50.0%,3h
27359,2,TrickyHunter,2595,0,0,1,1,0.0%,49m
27382,1,[DN3]KaAbIt,2594,1648,129,126,255,50.6%,32m
27382,1,Puckslife,2594,1155,73,62,135,54.1%,1h
27382,1,slackTOSS,2594,1087,44,45,89,49.4%,2h
27382,2,[WarQC]IDrakor,2594,409,19,17,36,52.8%,2h
27382,1,SilkyJohnson,2594,396,17,12,29,58.6%,2h
27382,2,IIIDieGoIII,2594,222,7,7,14,50.0%,16m
27382,2,Losteffect,2594,200,7,8,15,46.7%,4m
27382,2,KURSED,2594,118,5,4,9,55.6%,37m
27382,1,DirtyHarry,2594,177,5,6,11,45.5%,2h
27382,2,[TEBOW]BigThirst,2594,30,4,6,10,40.0%,17m
27382,2,[STRunK]Italian,2594,140,3,2,5,60.0%,37m
27382,2,Nightstaar,2594,88,3,2,5,60.0%,36m
27382,3,sarily,2594,0,3,4,7,42.9%,33m
27382,2,Cody,2594,64,2,1,3,66.7%,51m
27382,3,CosmicCuck,2594,0,2,4,6,33.3%,2h
27382,1,jeanfranco,2594,0,2,5,7,28.6%,2h
27382,2,[BlTEL]DYNaMo,2594,0,0,1,1,0.0%,52m
27382,1,[1030]nestor,2594,0,0,1,1,0.0%,3h
27382,3,JorgeRG,2594,0,0,1,1,0.0%,1h
27382,2,ironbum,2594,0,0,2,2,0.0%,2h
27382,2,RandyTerros,2594,0,0,2,2,0.0%,60m
27403,1,jojulien,2593,1419,88,72,160,55.0%,33m
27403,1,RevoltngBlob,2593,1305,68,73,141,48.2%,51m
27403,2,NKGrimn,2593,1284,53,43,96,55.2%,1h
27403,1,BenML,2593,938,32,35,67,47.8%,23m
27403,1,kevin,2593,685,25,25,50,50.0%,44m
27403,1,Timuh,2593,717,22,30,52,42.3%,2h
27403,1,kondakpez,2593,278,11,9,20,55.0%,48m
27403,3,Zizou,2593,279,10,12,22,45.5%,2h
27403,2,SCVling,2593,302,10,15,25,40.0%,49m
27403,2,Varum,2593,184,6,6,12,50.0%,34m
27403,2,VoteForTrump,2593,244,5,8,13,38.5%,54m
27403,1,miguel,2593,56,4,6,10,40.0%,44m
27403,1,dakokonatman,2593,0,2,4,6,33.3%,39m
27403,1,Alvaro,2593,40,2,5,7,28.6%,3h
27403,3,JoeMufferaw,2593,58,2,6,8,25.0%,31m
27403,2,[HaYn]Cario,2593,0,1,0,1,100.0%,2h
27403,2,Faldarith,2593,0,0,1,1,0.0%,1h
27403,1,DraxThDstryr,2593,0,0,6,6,0.0%,39m
27421,3,Alpha,2592,1488,215,208,423,50.8%,9m
27421,1,[SC2IDN]Chuncunmaru,2592,1647,103,104,207,49.8%,33m
27421,1,Kraka,2592,1549,80,88,168,47.6%,10m
27421,1,DiegoZE,2592,1047,40,33,73,54.8%,43m
27421,2,[Leorra]Megatank,2592,794,31,23,54,57.4%,43m
27421,1,BelowAvg,2592,666,29,26,55,52.7%,16m
27421,1,Lynkeus,2592,687,26,25,51,51.0%,52m
27421,3,goldfire,2592,736,25,36,61,41.0%,9m
27421,2,[YOSHII]GomichiX,2592,461,21,6,27,77.8%,2m
27421,2,[MITO22]Stepbrother,2592,503,20,15,35,57.1%,2h
27421,1,Choseph,2592,528,19,21,40,47.5%,2h
27421,2,[Loops]Bubby,2592,326,15,15,30,50.0%,36m
27421,2,[MexTab]Chelozskyy,2592,353,12,9,21,57.1%,2m
27421,2,GuamBum,2592,338,11,10,21,52.4%,34m
27421,1,sparkss,2592,221,8,10,18,44.4%,3h
27421,1,UncleNuggie,2592,97,4,6,10,40.0%,2h
27421,1,XanDeezy,2592,133,2,7,9,22.2%,35m
27421,2,Lymited,2592,0,0,1,1,0.0%,2h
27421,2,Sterben,2592,0,0,1,1,0.0%,3h
27421,1,Rogue,2592,0,0,1,1,0.0%,1h
27421,2,[NSLB]DeadlyFeet,2592,0,0,1,1,0.0%,22m
27421,2,Kole,2592,0,0,2,2,0.0%,49m
27443,2,[Ash3s]LiTuS,2591,1607,98,79,177,55.4%,3h
27443,2,Minusc,2591,592,23,19,42,54.8%,7m
27443,1,[DDM]Sinicio,2591,530,16,21,37,43.2%,2h
27443,2,DarkMastaLeo,2591,368,14,20,34,41.2%,39m
27443,2,Alexangel,2591,278,12,5,17,70.6%,50m
27443,2,[boooT]joker,2591,288,9,9,18,50.0%,11m
27443,1,JarrettP,2591,263,8,13,21,38.1%,3h
27443,1,SushiK,2591,144,5,8,13,38.5%,48m
27443,2,Shade,2591,92,4,3,7,57.1%,3h
27443,2,[BAAF]wargazmz,2591,122,4,4,8,50.0%,1h
27443,2,phonex,2591,107,3,4,7,42.9%,2h
27443,2,[RevL]Chubs,2591,94,3,5,8,37.5%,3h
27443,1,Eiger,2591,74,3,7,10,30.0%,2h
27443,3,MarineCorps,2591,0,2,3,5,40.0%,23m
27443,3,[luchis]luchisGG,2591,0,2,3,5,40.0%,16m
27443,2,kirlionik,2591,0,2,3,5,40.0%,2h
27443,1,isythebeast,2591,0,1,1,2,50.0%,56m
27443,2,HANS,2591,0,0,1,1,0.0%,1h
27443,3,Leli,2591,0,0,3,3,0.0%,12m
27443,1,Malaack,2591,0,0,6,6,0.0%,59m
27463,2,SilkyMcNasty,2590,1331,292,281,573,51.0%,19m
27463,1,Cyrex,2590,1584,141,115,256,55.1%,52m
27463,2,[FUSlON]Friedtoast,2590,1326,88,58,146,60.3%,16m
27463,3,Zergology,2590,1475,70,62,132,53.0%,10m
27463,1,spacecowboy,2590,1469,56,60,116,48.3%,3h
27463,2,MissMicro,2590,721,38,25,63,60.3%,2h
27463,1,mendieta,2590,576,26,15,41,63.4%,23m
27463,2,Conspiration,2590,556,20,18,38,52.6%,39m
27463,1,TheZickness,2590,672,20,28,48,41.7%,36m
27463,3,[x0311x]Coolio,2590,455,19,22,41,46.3%,10m
27463,1,Protogram,2590,559,18,21,39,46.2%,2h
27463,1,[Tyber]Badgingworth,2590,426,13,18,31,41.9%,9m
27463,1,Warthog,2590,407,13,18,31,41.9%,33m
27463,2,[C31081]LingKing,2590,354,12,9,21,57.1%,51m
27463,1,Apparat,2590,241,9,14,23,39.1%,18m
27463,3,[SkAL]Manafiend,2590,199,8,11,19,42.1%,28m
27463,3,Monkey,2590,244,7,15,22,31.8%,2h
27463,2,[WeGoon]hiig,2590,204,6,3,9,66.7%,34m
27463,3,HUNTHEBEAR,2590,181,6,8,14,42.9%,20m
27463,2,CakeThief,2590,118,4,6,10,40.0%,39m
27463,1,Ynotpa,2590,30,3,5,8,37.5%,3h
27463,2,[1Lord]MarthVader,2590,0,1,1,2,50.0%,11m
27463,2,Geos,2590,0,0,2,2,0.0%,2h
27486,3,[BlueBr]Viniparapa,2589,1543,377,373,750,50.3%,5m
27486,2,Fonzo,2589,891,98,98,196,50.0%,17m
27486,1,[SAH]yossil,2589,1376,46,68,114,40.4%,32m
27486,2,MCMLXXIX,2589,1042,45,44,89,50.6%,1h
27486,2,SnapKing,2589,911,38,32,70,54.3%,3h
27486,2,Peter,2589,1030,38,51,89,42.7%,39m
27486,2,Dunnyslice,2589,662,23,24,47,48.9%,2h
27486,2,JaymesReady,2589,375,20,10,30,66.7%,2h
27486,2,Pigboil,2589,418,18,16,34,52.9%,51m
27486,2,gui,2589,447,18,19,37,48.6%,3h
27486,1,gem,2589,288,12,11,23,52.2%,3h
27486,1,Squid,2589,360,12,13,25,48.0%,48m
27486,1,BUMMYBUMMY,2589,212,9,11,20,45.0%,32m
27486,2,BrainMachine,2589,232,8,2,10,80.0%,39m
27486,2,glp,2589,244,8,4,12,66.7%,2h
27486,1,SLOSHED,2589,218,8,8,16,50.0%,2h
27486,3,vax,2589,210,7,17,24,29.2%,31m
27486,1,MrTiNi,2589,186,6,3,9,66.7%,32m
27486,2,Burntwilight,2589,96,4,7,11,36.4%,37m
27486,1,[QMS]TRILL,2589,139,3,6,9,33.3%,22m
27486,2,[cnboys]Xlonen,2589,134,2,4,6,33.3%,3h
27486,3,Shift,2589,0,2,4,6,33.3%,43m
27486,1,IronMonkey,2589,48,1,3,4,25.0%,59m
27486,2,barcode,2589,0,0,1,1,0.0%,34m
27486,2,floortile,2589,0,0,3,3,0.0%,29m
27511,1,dragozerg,2588,1659,104,100,204,51.0%,2h
27511,1,BrandomizeD,2588,959,36,36,72,50.0%,42m
27511,2,Facker,2588,457,19,13,32,59.4%,9m
27511,3,eheroedog,2588,428,17,18,35,48.6%,5m
27511,2,Pissdamn,2588,378,12,23,35,34.3%,20m
27511,1,CommandoBdog,2588,212,7,9,16,43.8%,2h
27511,2,[nieBla]GhostKiller,2588,58,3,0,3,100.0%,2h
27511,2,StMonKey,2588,0,3,4,7,42.9%,3h
27511,2,Fredis,2588,30,3,4,7,42.9%,51m
27511,3,[ZTempz]ElTaita,2588,121,2,1,3,66.7%,5m
27511,2,matrix,2588,66,2,3,5,40.0%,2h
27511,3,BostonBILL,2588,0,2,3,5,40.0%,2h
27511,2,Setz,2588,105,2,4,6,33.3%,2h
27511,3,kelly,2588,0,2,4,6,33.3%,15m
27511,2,[IR77]broodwar,2588,30,1,1,2,50.0%,60m
27511,2,evilpem,2588,30,1,1,2,50.0%,2h
27511,3,Beli,2588,0,1,2,3,33.3%,2h
27511,2,HDkillerz,2588,0,0,3,3,0.0%,40m
27529,1,RickyTang,2587,916,37,35,72,51.4%,2h
27529,1,JDiesel,2587,448,34,36,70,48.6%,51m
27529,1,GUNGNIR,2587,640,27,20,47,57.4%,2h
27529,1,Ocios,2587,731,25,27,52,48.1%,2h
27529,1,Nybs,2587,734,24,28,52,46.2%,1h
27529,2,Zeint,2587,586,22,17,39,56.4%,35m
27529,2,RawDigs,2587,360,16,12,28,57.1%,2h
27529,2,Sully,2587,174,7,3,10,70.0%,49m
27529,2,[GgARMY]hanazumi,2587,181,3,4,7,42.9%,12m
27529,2,ZerraM,2587,30,2,0,2,100.0%,22m
27529,2,MartínVizcar,2587,0,1,0,1,100.0%,51m
27529,2,ScarleTFever,2587,36,1,2,3,33.3%,21m
27529,1,sponsorable,2587,32,1,4,5,20.0%,37m
27529,2,HAILSTATE,2587,0,0,1,1,0.0%,51m
27529,2,MCmaniacman,2587,0,0,1,1,0.0%,2h
27529,2,Rilexeon,2587,0,0,2,2,0.0%,2h
27545,3,TryHard,2586,930,82,72,154,53.2%,32m
27545,2,Brazzers,2586,830,44,26,70,62.9%,60m
27545,2,ShadowWolf,2586,719,38,27,65,58.5%,3h
27545,2,huskiesaver,2586,888,34,39,73,46.6%,27m
27545,2,[KiDo]agodeli,2586,680,32,27,59,54.2%,50m
27545,1,FunkyMonk,2586,726,28,32,60,46.7%,50m
27545,3,ManBra,2586,660,27,36,63,42.9%,18m
27545,3,oldmanthinke,2586,660,24,36,60,40.0%,30m
27545,2,Han,2586,328,11,13,24,45.8%,51m
27545,1,[SDTe]vichoCAD,2586,313,10,12,22,45.5%,35m
27545,1,Beamz,2586,238,8,7,15,53.3%,27m
27545,2,HiAmNoob,2586,281,8,9,17,47.1%,3h
27545,3,Steve,2586,202,6,11,17,35.3%,28m
27545,1,KSKteamQC,2586,96,5,7,12,41.7%,3h
27545,3,BigD,2586,157,4,4,8,50.0%,18m
27545,2,BdubzThaG,2586,112,3,0,3,100.0%,6m
27545,2,[GoatC]Gooby,2586,0,3,2,5,60.0%,2m
27545,1,[SGHQ]Tusker,2586,0,3,3,6,50.0%,3h
27545,2,Fake,2586,109,3,4,7,42.9%,16m
27545,1,Dominator,2586,153,3,6,9,33.3%,60m
27545,1,Redjac,2586,108,3,9,12,25.0%,2h
27545,2,shagito,2586,30,2,1,3,66.7%,3h
27545,2,TreefurHighe,2586,70,2,2,4,50.0%,50m
27545,2,BRUJORDXD,2586,44,2,2,4,50.0%,2h
27545,2,tedboyaa,2586,30,1,1,2,50.0%,34m
27545,2,Speltz,2586,0,1,1,2,50.0%,2h
27545,1,[FTLTX]loliabentura,2586,0,1,1,2,50.0%,2m
27545,2,[WDS]Winfield,2586,0,0,1,1,0.0%,46m
27545,3,Moistanator,2586,0,0,1,1,0.0%,2h
27574,1,PoisonMiST,2585,1504,370,374,744,49.7%,12m
27574,2,SunYa,2585,1627,82,77,159,51.6%,47m
27574,2,KyosukeKiryu,2585,1198,77,41,118,65.3%,52m
27574,2,UpstaTriton,2585,1193,77,62,139,55.4%,3h
27574,2,QORIBOY,2585,1320,63,58,121,52.1%,2m
27574,2,[UAK]bondzin,2585,820,60,73,133,45.1%,13m
27574,2,tomatobasil,2585,518,29,2,31,93.5%,23m
27574,1,[TGCrew]Trapezoider,2585,338,16,18,34,47.1%,37m
27574,3,Driel,2585,90,7,7,14,50.0%,25m
27574,2,[CLord]VilugArZa,2585,188,5,3,8,62.5%,2h
27574,2,Roxon,2585,190,5,14,19,26.3%,1h
27574,2,TopHatRhino,2585,58,3,2,5,60.0%,22m
27574,1,[GrwnUp]TeddyRugby,2585,68,3,8,11,27.3%,40m
27574,2,dewdrop,2585,30,1,2,3,33.3%,7m
27574,1,jish,2585,42,1,6,7,14.3%,2h
27574,1,darkkelbek,2585,0,0,3,3,0.0%,2h
27574,1,SparkyStar,2585,73,0,6,6,0.0%,2h
27591,1,Hideonbarrel,2584,659,27,18,45,60.0%,33m
27591,2,Albatraoz,2584,338,12,14,26,46.2%,6m
27591,1,bubblez,2584,386,12,17,29,41.4%,2h
27591,1,[XpKAc]OsoMaloso,2584,187,11,5,16,68.8%,53m
27591,1,tabledepoire,2584,339,10,11,21,47.6%,48m
27591,2,CoffeeBlack,2584,182,9,13,22,40.9%,11m
27591,1,Donovan,2584,253,8,10,18,44.4%,3h
27591,1,HeavyMetal,2584,226,6,14,20,30.0%,15m
27591,1,[StimP]Gymrancio,2584,96,4,8,12,33.3%,33m
27591,1,MattyKnacker,2584,119,3,2,5,60.0%,3h
27591,3,Racetrack,2584,0,3,3,6,50.0%,50m
27591,3,lIlIIIlI,2584,0,2,1,3,66.7%,54m
27591,3,Jeff,2584,0,2,3,5,40.0%,2h
27591,3,Murazor,2584,0,2,4,6,33.3%,4m
27591,1,Guackamo,2584,0,2,4,6,33.3%,2h
27591,2,Chempo,2584,0,1,1,2,50.0%,2h
27591,2,[ºEGUº]deleigox,2584,0,1,2,3,33.3%,22m
27591,3,[KoAv]Aleschyr,2584,0,0,1,1,0.0%,14m
27591,1,[GOPERÚ]Josero,2584,0,0,2,2,0.0%,2h
27610,2,ZeekeTheGeek,2583,1515,75,65,140,53.6%,2h
27610,1,Broski,2583,1287,64,58,122,52.5%,2h
27610,2,Costilla,2583,1034,45,35,80,56.2%,2h
27610,3,[DRKDNA]Lythander,2583,614,26,27,53,49.1%,9m
27610,2,Kappa,2583,465,20,6,26,76.9%,5m
27610,1,TheDarkLord,2583,494,17,19,36,47.2%,2h
27610,1,[LgcG]ElonMusk,2583,385,12,15,27,44.4%,56m
27610,2,Gunmiles,2583,116,6,6,12,50.0%,2h
27610,2,[1717]xFrenchBread,2583,182,6,7,13,46.2%,31m
27610,2,Muzman,2583,141,4,5,9,44.4%,2h
27610,3,PHATzorPANDA,2583,157,4,5,9,44.4%,28m
27610,2,SUICIDIO,2583,0,2,3,5,40.0%,17m
27610,1,Table,2583,0,1,2,3,33.3%,13m
27610,2,[EoC]Luxsong,2583,0,0,1,1,0.0%,3h
27610,2,TheTrentster,2583,0,0,1,1,0.0%,15m
27610,2,weiweipoopoo,2583,0,0,2,2,0.0%,27m
27626,2,jiminlee,2582,1597,93,93,186,50.0%,2h
27626,2,JupiterJazz,2582,1601,65,73,138,47.1%,2h
27626,1,Vicebacker,2582,935,60,63,123,48.8%,3h
27626,1,uni,2582,474,59,54,113,52.2%,2h
27626,1,[JRT]Hikikomori,2582,1441,59,60,119,49.6%,38m
27626,2,Gorrik,2582,733,28,24,52,53.8%,51m
27626,1,llllIIIllII,2582,403,18,19,37,48.6%,39m
27626,2,Trumptard,2582,328,13,10,23,56.5%,35m
27626,1,Royalsengr,2582,346,10,18,28,35.7%,3h
27626,1,SofaKing,2582,277,9,10,19,47.4%,3h
27626,1,Bones,2582,302,9,14,23,39.1%,35m
27626,2,Armada,2582,238,8,7,15,53.3%,51m
27626,2,ChaosEater,2582,170,7,9,16,43.8%,50m
27626,2,[Pharoh]Dalamar,2582,187,6,2,8,75.0%,35m
27626,2,[SWOU]Zera,2582,116,4,2,6,66.7%,50m
27626,2,[DKGLL]Gabtaro,2582,135,3,3,6,50.0%,16m
27626,2,[DETER]Bluestar,2582,60,2,1,3,66.7%,51m
27626,2,[IMDSI]Ciceron,2582,30,2,1,3,66.7%,3h
27626,2,RedLabelL,2582,0,2,3,5,40.0%,12m
27626,3,Saint,2582,0,2,3,5,40.0%,52m
27626,3,ARC,2582,0,2,3,5,40.0%,16m
27626,1,[Bovice]Bacca,2582,64,2,6,8,25.0%,32m
27626,2,TCTC,2582,0,1,0,1,100.0%,25m
27626,3,wingsofdeath,2582,0,1,4,5,20.0%,52m
27626,1,tntcows,2582,0,1,5,6,16.7%,59m
27626,2,Xenome,2582,0,0,1,1,0.0%,2h
27626,1,AdictoAlSc,2582,0,0,1,1,0.0%,59m
27626,1,TOFFEPANDERO,2582,0,0,4,4,0.0%,33m
27654,1,Kürüf,2581,1655,224,199,423,53.0%,11m
27654,3,gamesta,2581,1378,95,101,196,48.5%,32m
27654,1,MiyanoShiho,2581,751,81,68,149,54.4%,2h
27654,2,[6661]ELFURROTAKU,2581,1480,67,58,125,53.6%,46m
27654,2,Fridge,2581,676,28,19,47,59.6%,2h
27654,1,BeNJoW,2581,515,23,17,40,57.5%,53m
27654,3,RBG,2581,370,14,18,32,43.8%,31m
27654,1,Fanthem,2581,390,13,15,28,46.4%,3h
27654,2,Daptar,2581,283,11,10,21,52.4%,3h
27654,1,Thortugo,2581,257,9,13,22,40.9%,3h
27654,2,Creepy,2581,198,6,6,12,50.0%,38m
27654,1,DarkLocust,2581,246,6,7,13,46.2%,2m
27654,3,THECURSE,2581,147,6,7,13,46.2%,30m
27654,2,Doobwaa,2581,160,5,6,11,45.5%,1h
27654,2,justapawn,2581,136,5,7,12,41.7%,7m
27654,3,Xhock,2581,0,2,2,4,50.0%,14m
27654,2,Roflha,2581,0,1,0,1,100.0%,2h
27654,3,JuicyJakeLew,2581,0,0,1,1,0.0%,5m
27654,1,[CUMBAT]Gumpo,2581,0,0,1,1,0.0%,3h
27654,2,[TGosuC]urlag,2581,0,0,3,3,0.0%,7m
27654,1,Cocosaurio,2581,0,0,10,10,0.0%,3h
27675,2,Benedict,2580,1605,211,200,411,51.3%,18m
27675,1,AceWing,2580,735,46,36,82,56.1%,33m
27675,3,Zmordron,2580,1035,41,51,92,44.6%,6m
27675,1,Renouf,2580,1044,39,40,79,49.4%,40m
27675,1,Sgrnobi,2580,1024,35,45,80,43.8%,12m
27675,3,Killa,2580,547,24,25,49,49.0%,11m
27675,3,[69rs]Infintium,2580,586,21,28,49,42.9%,36m
27675,3,killbasa,2580,404,16,19,35,45.7%,16m
27675,2,elextermina,2580,398,14,13,27,51.9%,1h
27675,1,Tripp,2580,249,9,8,17,52.9%,2h
27675,1,[SN4CKS]kancerbero,2580,185,6,6,12,50.0%,51m
27675,1,kouko,2580,240,6,9,15,40.0%,43m
27675,3,YadnoMYadnuF,2580,146,5,8,13,38.5%,19m
27675,1,Brotus,2580,104,4,6,10,40.0%,2h
27675,1,[raa]Nautorious,2580,36,3,5,8,37.5%,2h
27675,2,scboy,2580,58,2,1,3,66.7%,33m
27675,2,Neeb,2580,30,2,2,4,50.0%,16m
27675,1,Hoss,2580,91,2,3,5,40.0%,33m
27675,3,Rug,2580,0,2,4,6,33.3%,52m
27675,2,JORGE,2580,62,2,5,7,28.6%,2h
27675,3,bdfg,2580,97,1,1,2,50.0%,55m
27675,2,krooth,2580,0,0,1,1,0.0%,17m
27675,2,Pandora,2580,0,0,2,2,0.0%,3h
27698,1,Otto,2579,1172,130,114,244,53.3%,40m
27698,2,[Psluts]ScarlitosWay,2579,998,92,80,172,53.5%,51m
27698,2,Knives,2579,1268,86,80,166,51.8%,34m
27698,1,[101001]Archetype,2579,1575,84,79,163,51.5%,33m
27698,2,senorred,2579,1589,78,76,154,50.6%,2h
27698,1,[iEats]KiX,2579,858,73,74,147,49.7%,2h
27698,2,PsYcHoTiC,2579,767,61,12,73,83.6%,54m
27698,3,DeGen,2579,676,27,30,57,47.4%,37m
27698,1,[Fir3s]CapnpwnZr,2579,351,11,12,23,47.8%,2h
27698,1,Shadow,2579,230,8,11,19,42.1%,59m
27698,2,[neuroS]PonyBoy,2579,190,7,7,14,50.0%,33m
27698,2,CRISKING,2579,144,6,4,10,60.0%,25m
27698,3,DittyDonuts,2579,0,4,2,6,66.7%,23m
27698,2,[OEG]Pain,2579,32,2,1,3,66.7%,39m
27698,2,DarthBalls,2579,103,2,2,4,50.0%,2h
27698,3,[SHPK]OPticSQuare,2579,0,2,3,5,40.0%,3h
27698,3,[FAECES]MrZog,2579,0,2,3,5,40.0%,53m
27698,2,PSi,2579,0,1,0,1,100.0%,29m
27698,1,spazzook,2579,30,1,2,3,33.3%,2h
27698,1,Govinda,2579,48,1,4,5,20.0%,3h
27698,2,Otakudon,2579,0,0,1,1,0.0%,2h
27698,2,Azure,2579,0,0,2,2,0.0%,2h
27698,2,lee,2579,0,0,2,2,0.0%,1h
27721,2,Bassics,2578,968,101,107,208,48.6%,17m
27721,1,Mark,2578,1604,83,73,156,53.2%,2h
27721,1,MannyFresh,2578,770,56,55,111,50.5%,43m
27721,1,mrRAGER,2578,945,44,38,82,53.7%,36m
27721,1,Betoplays,2578,405,34,20,54,63.0%,9m
27721,2,[DarkPG]ZCDZX,2578,551,25,15,40,62.5%,2h
27721,1,skyblue,2578,509,22,14,36,61.1%,21m
27721,2,LittleFinBoy,2578,287,13,3,16,81.2%,2h
27721,2,[Weac]zare,2578,315,12,7,19,63.2%,22m
27721,2,[ZTemp]Chesshire,2578,336,12,9,21,57.1%,1h
27721,2,Mikey,2578,308,10,11,21,47.6%,2h
27721,2,[K3oudy]Koudy,2578,236,9,3,12,75.0%,2h
27721,1,Guildenstern,2578,273,8,10,18,44.4%,30m
27721,2,Predator,2578,256,7,11,18,38.9%,22m
27721,2,[500CC]LittlePoppy,2578,220,6,4,10,60.0%,35m
27721,2,Crash,2578,212,6,4,10,60.0%,22m
27721,2,LonelySumo,2578,168,6,5,11,54.5%,2h
27721,2,SpaceRanger,2578,130,5,6,11,45.5%,57m
27721,2,Crazy,2578,88,3,4,7,42.9%,22m
27721,2,Lexxi,2578,0,1,0,1,100.0%,1h
27741,1,CHaLo,2577,1683,69,70,139,49.6%,2h
27741,2,HelpfulNavi,2577,662,25,23,48,52.1%,3h
27741,3,[C0rona]Virus,2577,717,24,38,62,38.7%,3m
27741,2,JMo,2577,429,17,16,33,51.5%,37m
27741,2,Pastor,2577,326,12,7,19,63.2%,12m
27741,2,Kelfer,2577,210,10,16,26,38.5%,17m
27741,1,Dylon,2577,180,9,4,13,69.2%,1h
27741,2,theBuilder,2577,186,9,6,15,60.0%,35m
27741,2,Nightmare,2577,180,7,7,14,50.0%,25m
27741,1,[TCBH]EtHoSZG,2577,149,5,6,11,45.5%,45m
27741,3,Jormungand,2577,72,4,5,9,44.4%,59m
27741,1,GeneralJJ,2577,102,4,8,12,33.3%,2h
27741,1,Ragna,2577,183,4,8,12,33.3%,2h
27741,1,CosplayFit,2577,0,2,4,6,33.3%,3h
27741,1,SOMETHING,2577,68,2,9,11,18.2%,37m
27741,2,Klogg,2577,0,1,1,2,50.0%,35m
27741,2,Infamous,2577,0,1,1,2,50.0%,1h
27741,1,xFragoutx,2577,38,1,5,6,16.7%,2h
27741,2,[Fecker]Ronster,2577,0,0,1,1,0.0%,2h
27741,2,[Freema]mesadumb,2577,0,0,1,1,0.0%,2h
27741,2,Drago,2577,0,0,2,2,0.0%,3h
27741,3,[Flam3s]TheShadowzXx,2577,0,0,2,2,0.0%,41m
27741,1,MYSOXISASOCK,2577,0,0,4,4,0.0%,1h
27764,1,xOhxSleeperx,2576,907,35,34,69,50.7%,2h
27764,2,Pjohson,2576,497,26,19,45,57.8%,12m
27764,2,SmoteurGoat,2576,673,25,19,44,56.8%,3h
27764,2,MisterStain,2576,587,23,17,40,57.5%,52m
27764,2,[4xDRG]Jelleton,2576,640,23,21,44,52.3%,39m
27764,2,TUMATAYO,2576,564,21,18,39,53.8%,2h
27764,2,Illidan,2576,351,17,8,25,68.0%,25m
27764,1,ram,2576,411,16,18,34,47.1%,3h
27764,1,Leik,2576,530,16,20,36,44.4%,3h
27764,3,[tCo9]icecream,2576,402,14,24,38,36.8%,25m
27764,2,[FxB]Orlandi,2576,356,13,12,25,52.0%,16m
27764,2,Snow,2576,290,10,7,17,58.8%,16m
27764,2,Crahture,2576,235,8,9,17,47.1%,2m
27764,1,VLIXES,2576,204,5,5,10,50.0%,2h
27764,1,[GGLMNX]Lancastrater,2576,152,5,9,14,35.7%,16m
27764,2,[HH8]CAshmere,2576,139,4,6,10,40.0%,45m
27764,1,Mesias,2576,106,4,10,14,28.6%,3h
27764,2,[trash0]BlueScorpion,2576,69,3,2,5,60.0%,35m
27764,3,[ZOMO]ermoon,2576,0,3,2,5,60.0%,60m
27764,2,Namei,2576,92,3,9,12,25.0%,2h
27764,2,[ZEXT]Jorath,2576,0,2,3,5,40.0%,2h
27764,2,SunTzu,2576,94,2,5,7,28.6%,3h
27764,2,PhatCat,2576,0,1,2,3,33.3%,25m
27764,2,[TAKT]Lostprophet,2576,0,0,1,1,0.0%,16m
27764,3,Michael,2576,0,0,1,1,0.0%,2h
27764,2,[DrgLrd]Cyber,2576,0,0,1,1,0.0%,2h
27764,2,Shortndeadly,2576,0,0,1,1,0.0%,8m
27764,1,[ssexxy]Fireboard,2576,0,0,2,2,0.0%,2m
27764,2,[Vulk]TeMPO,2576,0,0,3,3,0.0%,5m
27764,2,ratwesi,2576,0,0,4,4,0.0%,38m
27764,3,drose,2576,0,0,5,5,0.0%,9m
27795,1,michealaa,2575,1333,82,83,165,49.7%,2h
27795,2,Lucius,2575,1179,48,47,95,50.5%,1h
27795,1,Mafiaagent,2575,1312,48,52,100,48.0%,3h
27795,1,TheGhostOne,2575,434,18,18,36,50.0%,2h
27795,2,Hideo,2575,451,17,14,31,54.8%,1h
27795,2,CptFalcon,2575,426,15,14,29,51.7%,12m
27795,2,MadCow,2575,291,12,13,25,48.0%,2h
27795,2,Slinky,2575,158,8,3,11,72.7%,34m
27795,2,[Dolan4]wartime,2575,252,8,6,14,57.1%,43m
27795,1,warmbraw,2575,185,8,12,20,40.0%,2h
27795,2,Turbo,2575,156,5,6,11,45.5%,1h
27795,3,DrBOFA,2575,40,4,3,7,57.1%,44m
27795,1,[CRABBR]DVDA,2575,137,4,5,9,44.4%,21m
27795,1,Nemix,2575,72,3,4,7,42.9%,2h
27795,3,Pyron,2575,32,3,4,7,42.9%,55m
27795,2,[Primig]SuperFe,2575,0,2,2,4,50.0%,43m
27795,3,Prometheus,2575,0,2,6,8,25.0%,9m
27795,3,SpIN,2575,0,1,0,1,100.0%,2h
27795,2,RuCan,2575,0,1,0,1,100.0%,2h
27795,2,[SUMER]semperfi,2575,0,1,0,1,100.0%,50m
27795,2,[PEQL]Hysteria,2575,30,1,1,2,50.0%,1h
27795,2,[Zooka]DankTemplar,2575,30,1,3,4,25.0%,12m
27795,2,HonestDevil,2575,0,0,2,2,0.0%,3h
27795,2,Guido,2575,0,0,3,3,0.0%,3h
27819,2,emllen,2574,1559,137,127,264,51.9%,35m
27819,3,MAI,2574,1571,118,117,235,50.2%,21m
27819,3,knobby,2574,1356,88,86,174,50.6%,16m
27819,1,gLadE,2574,275,59,32,91,64.8%,43m
27819,2,[LGNxx]AiDz,2574,915,35,33,68,51.5%,3h
27819,1,DeathMagnet,2574,885,31,36,67,46.3%,56m
27819,3,[HØST]McNel,2574,644,24,32,56,42.9%,25m
27819,1,Moistifani,2574,603,21,18,39,53.8%,2h
27819,1,LOLcarlitros,2574,641,19,21,40,47.5%,2h
27819,1,[TRETER]zyc,2574,414,18,22,40,45.0%,15m
27819,2,[OreBad]MiniNinja,2574,244,14,14,28,50.0%,1h
27819,1,[xCRUSH]dadrian,2574,358,10,17,27,37.0%,2h
27819,1,xpurerated,2574,208,8,9,17,47.1%,39m
27819,1,[FE595]howtoplaySc,2574,268,8,11,19,42.1%,7m
27819,2,toro,2574,154,7,4,11,63.6%,54m
27819,1,MorningStar,2574,48,4,7,11,36.4%,2h
27819,2,TunerBlack,2574,122,3,4,7,42.9%,3h
27819,3,[LhL]ComanderVolt,2574,0,2,0,2,100.0%,60m
27819,2,KingofBlades,2574,0,2,6,8,25.0%,2h
27819,2,ozkar,2574,30,1,4,5,20.0%,39m
27819,2,[UNCNSF]sadsadw,2574,0,0,1,1,0.0%,39m
27840,1,[CANN]rolaids,2573,1189,109,105,214,50.9%,12m
27840,1,McFuss,2573,1172,91,82,173,52.6%,2h
27840,2,qimufev,2573,1325,65,79,144,45.1%,39m
27840,2,[MRDPOT]DeathOmen,2573,997,38,37,75,50.7%,2h
27840,1,[JeNiX]Cochecho,2573,830,28,29,57,49.1%,9m
27840,3,[ohG]Beachbum,2573,674,26,26,52,50.0%,16m
27840,2,SuperNinja,2573,501,20,13,33,60.6%,2h
27840,1,Orion,2573,420,18,12,30,60.0%,44m
27840,2,loqoman,2573,376,16,10,26,61.5%,3h
27840,2,SCLBIOHAZARD,2573,200,7,9,16,43.8%,51m
27840,1,ProbingTime,2573,198,6,5,11,54.5%,11m
27840,1,docstrange,2573,138,6,9,15,40.0%,3m
27840,2,[BrLc]Age,2573,166,6,16,22,27.3%,17m
27840,2,Fischer,2573,88,3,4,7,42.9%,7m
27840,2,KIRITOYK,2573,60,2,2,4,50.0%,49m
27840,2,Elmugroso,2573,62,2,4,6,33.3%,1h
27840,1,[cFG]Six,2573,0,2,5,7,28.6%,43m
27840,3,Aname,2573,30,2,7,9,22.2%,18m
27840,2,[TMSyN]bobs,2573,0,1,0,1,100.0%,22m
27840,2,Eido,2573,0,1,0,1,100.0%,43m
27840,2,Paradax,2573,0,1,0,1,100.0%,16m
27840,1,Treefiddy,2573,0,1,5,6,16.7%,2h
27840,2,[1vsM]Setadoon,2573,0,0,1,1,0.0%,35m
27840,2,Konvex,2573,0,0,1,1,0.0%,3h
27840,2,kupal,2573,0,0,1,1,0.0%,2h
27865,3,Hope,2572,1408,164,144,308,53.2%,7m
27865,1,[Peez]OlovMETAL,2572,912,80,79,159,50.3%,2h
27865,1,FurryTime,2572,1184,60,41,101,59.4%,44m
27865,3,Lombomombo,2572,1305,57,56,113,50.4%,17m
27865,1,ACoNaTic,2572,857,32,32,64,50.0%,2h
27865,3,StormzBG,2572,213,28,36,64,43.8%,36m
27865,2,[xRtG]Freedomflyer,2572,435,18,6,24,75.0%,2h
27865,2,JpBruiser,2572,120,17,18,35,48.6%,12m
27865,1,[GaiLo]Everest,2572,425,14,13,27,51.9%,16m
27865,3,[R3]FreeziePop,2572,352,11,25,36,30.6%,8m
27865,1,Toxygen,2572,291,10,12,22,45.5%,45m
27865,2,[MLWK]Vepeerre,2572,198,7,12,19,36.8%,2m
27865,1,OUOU,2572,205,6,10,16,37.5%,30m
27865,2,Craigo,2572,118,4,3,7,57.1%,33m
27865,1,[Shrek2]Kalderasha,2572,182,4,10,14,28.6%,41m
27865,2,POLLUXcastor,2572,60,3,3,6,50.0%,39m
27865,2,myo,2572,114,2,4,6,33.3%,3h
27865,1,emayrolol,2572,0,2,4,6,33.3%,2h
27865,1,FGDFG,2572,0,2,5,7,28.6%,16m
27865,2,ToastedSpoon,2572,34,1,4,5,20.0%,35m
27865,2,[sDADs]DemiLovato,2572,44,1,4,5,20.0%,1h
27865,1,GrimRipper,2572,38,1,6,7,14.3%,3h
27865,2,daniel,2572,0,0,1,1,0.0%,23m
27865,2,[GeekA]DarthJulius,2572,0,0,3,3,0.0%,49m
27889,2,[xMSx]GENERALZON,2571,1579,506,515,1021,49.6%,27m
27889,1,Maladroit,2571,576,66,64,130,50.8%,1h
27889,2,stone,2571,234,50,62,112,44.6%,7m
27889,2,basticle,2571,1157,47,41,88,53.4%,3h
27889,2,[zxczx]Eclipse,2571,721,28,20,48,58.3%,51m
27889,2,Fortress,2571,579,25,15,40,62.5%,1h
27889,1,PejiPug,2571,320,20,20,40,50.0%,2h
27889,3,NinjaOscuro,2571,445,17,20,37,45.9%,2m
27889,2,SinNeR,2571,315,11,15,26,42.3%,39m
27889,1,mahayana,2571,300,10,12,22,45.5%,19m
27889,2,Eigma,2571,266,9,11,20,45.0%,1h
27889,1,maldypants,2571,159,7,12,19,36.8%,3h
27889,2,gucci,2571,168,5,8,13,38.5%,2h
27889,2,Shadowentity,2571,102,4,4,8,50.0%,2h
27889,2,[Wufei]Ancanis,2571,108,4,5,9,44.4%,3h
27889,2,bossdawg,2571,240,4,9,13,30.8%,3h
27889,1,Tbar,2571,96,3,4,7,42.9%,59m
27889,2,DarkShrine,2571,30,3,5,8,37.5%,2h
27889,2,Happendy,2571,0,2,3,5,40.0%,57m
27889,2,Minos,2571,0,2,3,5,40.0%,19m
27889,3,TitaniteSlab,2571,0,2,3,5,40.0%,16m
27889,2,[Jungy]ShallowMind,2571,0,1,0,1,100.0%,2h
27911,1,[nOOOO]conemar,2570,1729,414,402,816,50.7%,45m
27911,2,WelderDude,2570,1557,120,98,218,55.0%,3h
27911,1,XenaWarrior,2570,1451,66,74,140,47.1%,37m
27911,2,[UpxV]UcanPedro,2570,1163,44,50,94,46.8%,38m
27911,2,codehead,2570,756,31,37,68,45.6%,33m
27911,2,[RogueW]DarkTemplar,2570,587,23,21,44,52.3%,2h
27911,1,Charmander,2570,602,22,20,42,52.4%,33m
27911,2,rMjDC,2570,456,19,9,28,67.9%,2h
27911,2,[BO1Z]landoskape,2570,292,10,11,21,47.6%,7m
27911,2,StoneBridge,2570,259,9,6,15,60.0%,57m
27911,2,yutaileox,2570,205,7,8,15,46.7%,2h
27911,3,Moridin,2570,196,5,5,10,50.0%,2h
27911,2,Sacari,2570,0,4,1,5,80.0%,2h
27911,1,Fifi,2570,101,4,4,8,50.0%,2h
27911,3,Daplrth,2570,30,4,5,9,44.4%,13m
27911,3,iDrasTwo,2570,62,4,8,12,33.3%,20m
27911,2,MacK,2570,90,3,3,6,50.0%,3h
27911,3,[THCrew]leonuribe,2570,0,2,3,5,40.0%,3h
27911,2,StarWolf,2570,0,2,6,8,25.0%,52m
27911,1,lolostar,2570,0,1,0,1,100.0%,2h
27911,2,acquisitionr,2570,0,0,1,1,0.0%,5m
27911,3,RockstarBaby,2570,0,0,4,4,0.0%,56m
27933,1,ChacoBear,2569,1031,93,85,178,52.2%,55m
27933,1,GameTruck,2569,783,29,24,53,54.7%,1h
27933,1,Survival,2569,579,26,23,49,53.1%,37m
27933,2,Fancy,2569,523,23,17,40,57.5%,49m
27933,1,Waracle,2569,700,23,28,51,45.1%,2h
27933,3,Babyoldman,2569,456,20,24,44,45.5%,33m
27933,3,Ryno,2569,466,17,28,45,37.8%,24m
27933,2,Yossarian,2569,354,14,17,31,45.2%,4m
27933,2,ShadowZGhost,2569,402,13,10,23,56.5%,2h
27933,2,[Saltye]DragL,2569,303,11,14,25,44.0%,2h
27933,2,applejuice,2569,211,10,8,18,55.6%,31m
27933,1,[ZFC]daewongtse,2569,322,10,12,22,45.5%,49m
27933,1,Evocide,2569,258,8,11,19,42.1%,56m
27933,3,Ways,2569,179,6,7,13,46.2%,3h
27933,1,Maurtus,2569,96,5,9,14,35.7%,3h
27933,2,animX,2569,118,4,5,9,44.4%,7m
27933,2,[DhZone]Guima,2569,60,3,3,6,50.0%,2h
27933,2,Powerbuster,2569,90,3,3,6,50.0%,1h
27933,2,Raven,2569,48,2,1,3,66.7%,39m
27933,2,OKY,2569,0,2,3,5,40.0%,1h
27933,3,Etzu,2569,0,2,4,6,33.3%,43m
27933,2,MrShackly,2569,38,1,1,2,50.0%,2h
27933,1,[KerriS]NeroKaijin,2569,30,1,6,7,14.3%,27m
27933,2,Vim,2569,0,0,1,1,0.0%,1h
27933,2,[T4TG]kurbo,2569,0,0,2,2,0.0%,3h
27958,1,Heinz,2568,1209,78,75,153,51.0%,33m
27958,1,Fate,2568,570,54,41,95,56.8%,40m
27958,2,Vandersmuth,2568,901,49,51,100,49.0%,37m
27958,2,SpetsnazHero,2568,999,40,36,76,52.6%,16m
27958,2,Toast,2568,365,38,8,46,82.6%,3h
27958,1,Tacogramps,2568,489,37,31,68,54.4%,2h
27958,2,scuba,2568,159,33,29,62,53.2%,39m
27958,2,[LMI42]strangelove,2568,807,32,27,59,54.2%,7m
27958,2,Kevin,2568,667,25,22,47,53.2%,2h
27958,2,warfare,2568,561,22,15,37,59.5%,1h
27958,1,Mophideus,2568,247,21,25,46,45.7%,2h
27958,2,Beardo,2568,486,17,15,32,53.1%,2h
27958,1,[Exper]JuanPlatanit,2568,270,11,7,18,61.1%,3h
27958,2,[Yoga1]Perfectus,2568,234,10,14,24,41.7%,25m
27958,2,SunTzu,2568,203,8,5,13,61.5%,52m
27958,1,Polodo,2568,139,8,9,17,47.1%,3h
27958,2,XTHUNDERX,2568,120,5,3,8,62.5%,12m
27958,3,[PQP]TroyPb,2568,0,4,2,6,66.7%,1h
27958,2,BENDER,2568,107,4,3,7,57.1%,2h
27958,2,SpectreNinja,2568,119,3,2,5,60.0%,23m
27958,3,MrowdnaS,2568,0,3,6,9,33.3%,37m
27958,3,[4IUR]Ruzonfar,2568,62,3,11,14,21.4%,30m
27958,2,justhavefunn,2568,0,1,0,1,100.0%,10m
27958,2,SMN,2568,30,1,3,4,25.0%,12m
27958,1,AdTheLazy,2568,32,1,4,5,20.0%,2h
27958,2,Pierosimple,2568,0,0,1,1,0.0%,2h
27958,2,Subwaymaker,2568,0,0,1,1,0.0%,3h
27985,2,Alchi,2567,1528,131,125,256,51.2%,35m
27985,1,ENCORE,2567,1513,99,86,185,53.5%,37m
27985,2,phlanic,2567,1152,85,72,157,54.1%,2h
27985,1,RatTail,2567,1517,76,79,155,49.0%,3h
27985,2,CrottyChop,2567,1343,57,44,101,56.4%,2h
27985,1,Jeb,2567,602,50,46,96,52.1%,2h
27985,2,Newool,2567,1035,48,41,89,53.9%,7m
27985,3,Elinquisitor,2567,706,23,30,53,43.4%,27m
27985,2,Pseudo,2567,257,14,12,26,53.8%,6m
27985,1,SimpleGiant,2567,251,12,8,20,60.0%,2h
27985,1,[Axioms]Knapp,2567,360,11,17,28,39.3%,3h
27985,1,donutLORD,2567,260,9,12,21,42.9%,49m
27985,1,Vegetable,2567,286,9,13,22,40.9%,1h
27985,3,Trigs,2567,226,8,7,15,53.3%,2h
27985,2,[INVADS]VManuel,2567,216,8,9,17,47.1%,3h
27985,2,[UpxV]iXplode,2567,178,7,1,8,87.5%,6m
27985,1,InvazorPer,2567,178,5,8,13,38.5%,3h
27985,2,lyubisebya,2567,176,4,3,7,57.1%,1h
27985,2,Balinn,2567,64,3,1,4,75.0%,25m
27985,1,eldesk,2567,148,3,5,8,37.5%,16m
27985,2,Voltic,2567,0,2,3,5,40.0%,43m
27985,3,AZUMILIAN,2567,0,2,4,6,33.3%,48m
27985,2,[PPLean]BnTsO,2567,68,2,5,7,28.6%,2h
27985,2,blink,2567,0,1,1,2,50.0%,50m
27985,2,PaXiN,2567,30,1,2,3,33.3%,1h
27985,2,tertian,2567,0,1,4,5,20.0%,57m
27985,2,[SGxx]Eville,2567,0,0,1,1,0.0%,2h
27985,2,Spawner,2567,0,0,1,1,0.0%,49m
27985,2,workwork,2567,0,0,1,1,0.0%,10m
28014,2,Sandwichpak,2566,738,70,77,147,47.6%,35m
28014,1,Ferret,2566,1206,67,69,136,49.3%,35m
28014,3,Pasta,2566,1145,61,59,120,50.8%,13m
28014,3,GreyBoy,2566,810,28,43,71,39.4%,20m
28014,2,[SCVM]NightKnight,2566,742,23,38,61,37.7%,7m
28014,2,apathy,2566,374,20,15,35,57.1%,37m
28014,1,Stepper,2566,588,18,23,41,43.9%,27m
28014,2,[SP4M]Santo,2566,378,14,11,25,56.0%,2h
28014,2,Khaman,2566,186,6,2,8,75.0%,1h
28014,2,[GRNSKN]Shepherd,2566,58,3,2,5,60.0%,34m
28014,3,ALARM,2566,0,2,3,5,40.0%,2h
28014,3,[nGx]TotalWar,2566,0,2,4,6,33.3%,44m
28014,1,Quiz,2566,100,2,5,7,28.6%,44m
28014,2,[CRAKS]GoliatKing,2566,0,0,1,1,0.0%,7m
28014,2,xlex,2566,0,0,1,1,0.0%,25m
28029,2,DeeLow,2565,1355,162,167,329,49.2%,3m
28029,1,coocakes,2565,771,107,89,196,54.6%,33m
28029,1,swiss,2565,1464,52,57,109,47.7%,50m
28029,2,TonellTone,2565,581,40,22,62,64.5%,2h
28029,1,grappa,2565,614,40,36,76,52.6%,16m
28029,2,Chewe,2565,230,11,4,15,73.3%,12m
28029,2,TeaRex,2565,310,10,8,18,55.6%,2h
28029,2,[WuTang]BlackNova,2565,30,2,0,2,100.0%,36m
28029,2,RichChap,2565,30,2,1,3,66.7%,1h
28029,2,Hindrance,2565,137,2,1,3,66.7%,2h
28029,2,Hydralatic,2565,0,2,3,5,40.0%,3h
28029,2,Ali,2565,0,2,3,5,40.0%,2m
28029,2,Renlothar,2565,0,0,1,1,0.0%,2m
28029,2,Ragnaroth,2565,0,0,1,1,0.0%,1h
28029,2,RyanSL,2565,0,0,2,2,0.0%,3h
28044,2,Fenrir,2564,912,53,50,103,51.5%,23m
28044,1,Mainxenocide,2564,1396,52,53,105,49.5%,21m
28044,2,lDIABLOl,2564,1168,47,41,88,53.4%,43m
28044,2,[GRNSKN]Neroxas,2564,679,31,27,58,53.4%,2h
28044,2,lIIIlIIIlIII,2564,658,27,20,47,57.4%,3h
28044,2,WixeS,2564,328,25,21,46,54.3%,54m
28044,1,ALLBLACKS,2564,374,12,19,31,38.7%,2h
28044,2,SLEEPLESS,2564,243,7,3,10,70.0%,15m
28044,3,GetBONKED,2564,66,6,9,15,40.0%,2m
28044,2,Priest,2564,167,5,4,9,55.6%,3h
28044,3,Cefo,2564,145,4,4,8,50.0%,60m
28044,2,Hunter,2564,88,3,2,5,60.0%,22m
28044,2,Wukey,2564,62,3,3,6,50.0%,38m
28044,3,xprincesax,2564,42,3,5,8,37.5%,3h
28044,1,Riflescout,2564,0,1,0,1,100.0%,39m
28044,2,[SivD]Hellscythe,2564,0,1,1,2,50.0%,46m
28044,2,ReubenD,2564,30,1,1,2,50.0%,51m
28044,2,Blade,2564,0,0,1,1,0.0%,2h
28044,2,[10TKL]naturesherb,2564,0,0,2,2,0.0%,2h
28044,3,Goose,2564,0,0,5,5,0.0%,43m
28064,1,MAC,2563,1579,210,212,422,49.8%,44m
28064,1,Superduck,2563,1207,100,85,185,54.1%,2h
28064,1,chris,2563,587,79,92,171,46.2%,31m
28064,2,Josh,2563,979,38,32,70,54.3%,16m
28064,1,Jacky,2563,154,28,14,42,66.7%,2h
28064,1,Souvenyr,2563,731,26,24,50,52.0%,1h
28064,1,[CoCo19]AlpacaKiller,2563,556,20,21,41,48.8%,23m
28064,2,Visittor,2563,164,17,8,25,68.0%,12m
28064,2,Octave,2563,154,15,16,31,48.4%,12m
28064,1,Crowat,2563,335,12,13,25,48.0%,24m
28064,1,HappY,2563,277,8,10,18,44.4%,16m
28064,2,Seb,2563,180,7,10,17,41.2%,35m
28064,3,dagio,2563,159,5,4,9,55.6%,51m
28064,2,[TKU101]mbeezy,2563,184,4,2,6,66.7%,10m
28064,2,KPEBED,2563,90,4,3,7,57.1%,34m
28064,1,ribo,2563,48,4,7,11,36.4%,3h
28064,2,HappyRonny,2563,197,4,9,13,30.8%,29m
28064,2,mariah,2563,68,3,3,6,50.0%,2h
28064,2,HOTGIRLMEG,2563,62,2,3,5,40.0%,3h
28064,1,[ReVamp]Caronte,2563,97,2,4,6,33.3%,28m
28064,2,BabyGun,2563,30,2,4,6,33.3%,2h
28064,2,[iDrunk]Redkotz,2563,0,1,0,1,100.0%,2h
28064,2,boboGene,2563,0,1,0,1,100.0%,33m
28064,2,Kara,2563,30,1,1,2,50.0%,38m
28064,2,Marshin,2563,30,1,1,2,50.0%,18m
28064,2,[DR4G]PwndaBear,2563,0,0,1,1,0.0%,3h
28064,2,[ALTF04]Alexander,2563,0,0,3,3,0.0%,7m
28091,3,DaClap,2562,833,93,96,189,49.2%,17m
28091,1,[CmrK]ficaball,2562,1472,81,82,163,49.7%,35m
28091,2,[LKA]Abadon,2562,1372,64,55,119,53.8%,25m
28091,1,ImJepp,2562,1326,52,51,103,50.5%,3h
28091,2,AcidRAIN,2562,626,35,11,46,76.1%,2h
28091,1,MPL,2562,336,22,48,70,31.4%,37m
28091,3,Pells,2562,436,16,25,41,39.0%,31m
28091,2,[UFroze]DspNONSENSE,2562,372,11,16,27,40.7%,29m
28091,2,bubbletwubbl,2562,210,8,8,16,50.0%,38m
28091,3,crapidied,2562,176,6,16,22,27.3%,32m
28091,2,[HNPro]Wolfy,2562,146,5,6,11,45.5%,3h
28091,1,LOFUEN,2562,184,4,5,9,44.4%,2h
28091,2,OLDirtyAUS,2562,139,3,2,5,60.0%,19m
28091,3,TimeBomb,2562,0,2,3,5,40.0%,15m
28091,2,[CaMt]CADAMILE,2562,58,2,4,6,33.3%,48m
28091,2,Febreeze,2562,0,1,0,1,100.0%,2h
28091,2,Doruru,2562,0,1,0,1,100.0%,2h
28091,2,[sBOI]Takhilin,2562,0,0,1,1,0.0%,35m
28091,2,[VTOG]Wizard,2562,0,0,1,1,0.0%,35m
28091,2,wvwvwvwvwvw,2562,0,0,1,1,0.0%,52m
28091,3,Mursaat,2562,0,0,1,1,0.0%,2h
28112,2,Rhett,2561,568,95,94,189,50.3%,3h
28112,1,[gRaNNy]MiLLiCnT,2561,644,42,39,81,51.9%,2h
28112,2,Shaboo,2561,826,32,31,63,50.8%,2h
28112,2,[Panc8k]RestingPanda,2561,558,25,14,39,64.1%,2h
28112,2,Lane,2561,670,25,22,47,53.2%,34m
28112,1,[CADIVI]AlvaroVzla,2561,410,20,26,46,43.5%,35m
28112,2,[4LOBOS]xXTheLionXx,2561,424,18,6,24,75.0%,58m
28112,1,SmurfPidor,2561,367,15,11,26,57.7%,2h
28112,1,Swagdaddy,2561,453,15,17,32,46.9%,3h
28112,2,WildHawk,2561,283,10,7,17,58.8%,8m
28112,3,mythex,2561,248,9,14,23,39.1%,9m
28112,2,electronkid,2561,245,8,7,15,53.3%,34m
28112,2,Blind,2561,221,8,8,16,50.0%,58m
28112,1,[Clicks]StarvingWolf,2561,276,8,11,19,42.1%,2h
28112,2,[AUSBH]Kingpanday,2561,96,4,5,9,44.4%,23m
28112,2,JJJ,2561,96,4,7,11,36.4%,34m
28112,1,Piccoro,2561,30,2,8,10,20.0%,3h
28112,2,tibit,2561,0,1,0,1,100.0%,8m
28112,2,Aviator,2561,0,0,1,1,0.0%,5m
28112,2,FuzzyD,2561,0,0,1,1,0.0%,2h
28112,1,Hectoraldo,2561,0,0,5,5,0.0%,2h
28133,2,Stinker,2560,1352,56,43,99,56.6%,34m
28133,2,phoobahr,2560,632,26,18,44,59.1%,2h
28133,1,Toughlove,2560,604,23,23,46,50.0%,53m
28133,3,[CH0DE]MidgetBooty,2560,343,16,16,32,50.0%,31m
28133,2,[TNRA]Ephex,2560,402,14,13,27,51.9%,9m
28133,2,ZCE,2560,170,7,5,12,58.3%,1h
28133,2,ItzHighNoon,2560,124,7,10,17,41.2%,26m
28133,2,[VFam2]Sirgamermore,2560,159,7,10,17,41.2%,2h
28133,3,Roblin,2560,0,5,0,5,100.0%,48m
28133,1,JuGGernauT,2560,189,5,6,11,45.5%,35m
28133,2,saint,2560,114,4,5,9,44.4%,23m
28133,1,Tentacruel,2560,48,4,7,11,36.4%,2h
28133,2,Datacore,2560,46,3,5,8,37.5%,2h
28133,2,Barricade,2560,88,3,6,9,33.3%,1h
28133,2,bilenin,2560,0,1,3,4,25.0%,34m
28133,2,Xizors,2560,0,0,2,2,0.0%,12m
28133,2,Akolatroink,2560,0,0,2,2,0.0%,2h
28150,1,Heartseeker,2559,1128,94,94,188,50.0%,45m
28150,2,Emet,2559,942,66,60,126,52.4%,2h
28150,1,KIMPACHI,2559,1103,43,47,90,47.8%,52m
28150,2,[Lp]DarkShadooW,2559,737,28,27,55,50.9%,34m
28150,2,[Chibii]USER,2559,525,22,18,40,55.0%,3h
28150,1,JackMurphy,2559,454,22,27,49,44.9%,2h
28150,1,Fawny,2559,542,19,21,40,47.5%,45m
28150,3,TommyGun,2559,466,15,33,48,31.2%,14m
28150,3,fungk,2559,321,12,12,24,50.0%,9m
28150,1,Zythe,2559,280,10,10,20,50.0%,14m
28150,1,WatterMelons,2559,126,7,7,14,50.0%,40m
28150,1,[ShNK]MEGUITA,2559,204,6,10,16,37.5%,13m
28150,1,lace,2559,98,5,7,12,41.7%,13m
28150,1,PooopDollar,2559,191,5,8,13,38.5%,1h
28150,1,AlphaWhiskey,2559,178,5,14,19,26.3%,1h
28150,2,alx,2559,88,4,2,6,66.7%,29m
28150,2,cuNAHH,2559,62,3,2,5,60.0%,3h
28150,2,BIANG,2559,60,3,7,10,30.0%,52m
28150,2,BouncyBear,2559,34,2,3,5,40.0%,37m
28150,3,[LTBV]Analgrapez,2559,0,1,1,2,50.0%,58m
28150,2,jamesfurlano,2559,0,0,1,1,0.0%,2h
28150,2,FrostyDog,2559,0,0,1,1,0.0%,2h
28172,2,KingOfPop,2558,1568,265,272,537,49.3%,13m
28172,1,WWMB,2558,1355,148,135,283,52.3%,3h
28172,2,Method,2558,961,42,33,75,56.0%,9m
28172,1,Wreckursive,2558,1060,40,44,84,47.6%,12m
28172,3,RalcoBlaze,2558,909,36,38,74,48.6%,9m
28172,3,[ZTempz]Psyvv,2558,547,20,22,42,47.6%,25m
28172,2,Xaph,2558,314,11,13,24,45.8%,23m
28172,2,[Drider]Ramcj,2558,280,10,7,17,58.8%,46m
28172,2,BananasMcGee,2558,228,9,4,13,69.2%,25m
28172,1,[Kaii]Yaguar,2558,268,8,16,24,33.3%,37m
28172,1,BulletEyes,2558,169,7,6,13,53.8%,37m
28172,2,Ghost,2558,202,6,4,10,60.0%,35m
28172,2,[Ppode]Tripode,2558,179,5,5,10,50.0%,16m
28172,2,Amatus,2558,191,4,4,8,50.0%,52m
28172,2,[GTWITM]Ecneb,2558,109,3,1,4,75.0%,2h
28172,1,LingsIncomng,2558,32,3,5,8,37.5%,20m
28172,1,CaptainBurn,2558,96,3,6,9,33.3%,2h
28172,1,Malavious,2558,32,1,3,4,25.0%,2h
28172,2,[Lp]RaidBudao,2558,30,1,3,4,25.0%,3h
28191,1,Draynan,2557,1579,166,151,317,52.4%,2h
28191,2,[LY0]grovar,2557,1283,70,59,129,54.3%,2h
28191,1,RaphaelPavan,2557,322,31,29,60,51.7%,16m
28191,2,zzurg,2557,362,16,6,22,72.7%,52m
28191,2,Optimystic,2557,222,14,5,19,73.7%,2h
28191,2,pancho,2557,322,14,8,22,63.6%,1h
28191,2,[DDPPSS]Pipegrep,2557,340,13,10,23,56.5%,3h
28191,2,[TMSyN]Zirou,2557,296,11,8,19,57.9%,12m
28191,1,Noobforreal,2557,312,11,8,19,57.9%,39m
28191,1,KillerRa,2557,280,10,14,24,41.7%,2h
28191,2,Azeta,2557,226,8,8,16,50.0%,2h
28191,1,[TnyDix]MedinaSod,2557,129,8,14,22,36.4%,2h
28191,2,LOoOLI,2557,257,7,9,16,43.8%,10m
28191,2,SimpleJACK,2557,182,6,5,11,54.5%,3h
28191,2,MoreBo,2557,30,4,3,7,57.1%,22m
28191,2,Reesepup,2557,104,4,5,9,44.4%,2h
28191,3,Crunchy,2557,36,2,1,3,66.7%,60m
28191,2,[AbcCo]genjiro,2557,118,2,2,4,50.0%,50m
28191,2,Roken,2557,0,2,4,6,33.3%,2h
28191,2,Incenstious,2557,44,2,7,9,22.2%,45m
28191,2,Gloomy,2557,0,1,1,2,50.0%,18m
28191,2,[aIiens]plasma,2557,0,0,3,3,0.0%,2h
28213,1,JelloSaint,2556,1593,368,355,723,50.9%,2h
28213,2,castortroy,2556,1502,258,252,510,50.6%,9m
28213,2,Near,2556,1554,64,57,121,52.9%,2h
28213,2,Shoku,2556,938,49,25,74,66.2%,2h
28213,2,TotalPenguin,2556,851,38,30,68,55.9%,3h
28213,3,Darkcorsair,2556,696,35,41,76,46.1%,42m
28213,2,PanConHuevo,2556,364,19,16,35,54.3%,54m
28213,1,Cursedgamer,2556,401,19,22,41,46.3%,40m
28213,2,[Nose02]Djokovic,2556,446,16,15,31,51.6%,49m
28213,2,[MVJ]MVJToRy,2556,334,13,15,28,46.4%,12m
28213,1,Theokiedoke,2556,387,12,13,25,48.0%,33m
28213,2,[dengue]WillisMeat,2556,163,8,4,12,66.7%,35m
28213,3,Potato,2556,175,6,10,16,37.5%,9m
28213,2,newbie,2556,128,4,1,5,80.0%,2h
28213,2,Swishaa,2556,100,3,2,5,60.0%,2m
28213,2,[Osexc]Tezzeret,2556,96,3,4,7,42.9%,22m
28213,3,wakanda,2556,42,3,4,7,42.9%,2h
28213,3,DIDDLERDAVE,2556,0,2,3,5,40.0%,2h
28213,3,ZERG,2556,0,2,3,5,40.0%,48m
28213,2,somethingsho,2556,0,2,3,5,40.0%,3h
28213,3,Xinoftruden,2556,30,2,5,7,28.6%,33m
28213,2,[iFish]TheJizmo,2556,124,2,7,9,22.2%,34m
28213,1,Txexs,2556,48,1,3,4,25.0%,59m
28213,1,Napoleon,2556,90,1,5,6,16.7%,2h
28213,2,Ällyson,2556,0,0,2,2,0.0%,2h
28213,1,RavenGloodus,2556,0,0,2,2,0.0%,60m
28239,3,Garfias,2555,1596,99,107,206,48.1%,19m
28239,2,ares,2555,1360,91,76,167,54.5%,50m
28239,2,Dravidian,2555,1306,76,77,153,49.7%,5m
28239,1,glenelg,2555,1034,68,48,116,58.6%,14m
28239,2,Rmarq,2555,681,33,22,55,60.0%,1h
28239,1,lkzr,2555,371,13,15,28,46.4%,2h
28239,2,[MANCOr]Glacius,2555,330,12,12,24,50.0%,2h
28239,2,[Sune]Cabutt,2555,310,10,15,25,40.0%,12m
28239,2,[LTlord]Nevada,2555,250,8,9,17,47.1%,2h
28239,1,[Mines]Leavage,2555,210,7,13,20,35.0%,52m
28239,2,Symmetry,2555,162,5,7,12,41.7%,2h
28239,1,DragonSlayer,2555,148,4,11,15,26.7%,39m
28239,2,[KDST]Grappler,2555,30,2,1,3,66.7%,2h
28239,3,Neo,2555,0,2,5,7,28.6%,31m
28239,2,[DarkC]BigCharles,2555,0,1,0,1,100.0%,39m
28239,2,[ffaaak]iqui,2555,0,1,0,1,100.0%,12m
28239,2,UNCrulez,2555,32,1,4,5,20.0%,50m
28239,2,[Clan9]Nine,2555,0,0,1,1,0.0%,2h
28239,3,CountDooku,2555,0,0,1,1,0.0%,4m
28258,1,[UrMove]gumbychef,2554,1671,134,116,250,53.6%,33m
28258,2,[KANELO]angelcaido,2554,1608,105,83,188,55.9%,19m
28258,2,galactical,2554,1606,98,66,164,59.8%,49m
28258,3,[GTHS]BoMbErSC,2554,1435,87,91,178,48.9%,42m
28258,2,CptBagels,2554,593,27,17,44,61.4%,29m
28258,1,LFNIGHTMARE,2554,373,20,21,41,48.8%,60m
28258,2,BICEPS,2554,495,19,18,37,51.4%,2h
28258,2,wudi,2554,194,7,6,13,53.8%,23m
28258,2,Crocop,2554,183,6,6,12,50.0%,3h
28258,2,HOUSE,2554,113,4,6,10,40.0%,1h
28258,2,XSuzumiyaX,2554,60,3,4,7,42.9%,1h
28258,2,[3pro5u]Florid,2554,62,2,2,4,50.0%,54m
28258,3,Wafflelisk,2554,0,2,3,5,40.0%,28m
28258,2,Triplexxx,2554,68,2,5,7,28.6%,29m
28258,2,Amaro,2554,0,1,0,1,100.0%,3h
28258,2,starclash,2554,0,1,0,1,100.0%,39m
28258,1,CnelSheppard,2554,96,1,4,5,20.0%,2h
28258,2,[GPOC]MoOnS,2554,30,1,4,5,20.0%,2h
28258,2,[Snoopy]Arkling,2554,0,0,1,1,0.0%,3h
28258,2,JaggerJack,2554,0,0,1,1,0.0%,2h
28258,3,Bigcahones,2554,0,0,1,1,0.0%,49m
28258,2,DEATH,2554,0,0,2,2,0.0%,2h
28280,3,[SWOU]SnoopyCat,2553,1529,215,223,438,49.1%,12m
28280,1,Floof,2553,1664,204,203,407,50.1%,51m
28280,1,[ZTemps]dayodave,2553,1590,143,137,280,51.1%,2h
28280,1,morgal,2553,1514,63,65,128,49.2%,33m
28280,1,glhfImTroll,2553,341,23,48,71,32.4%,19m
28280,2,Habaxrolxd,2553,438,18,7,25,72.0%,11m
28280,2,Raia,2553,431,17,18,35,48.6%,2h
28280,1,[PRI]Jminaya,2553,352,11,18,29,37.9%,3h
28280,2,[ThxN]Smoke,2553,170,6,4,10,60.0%,2h
28280,2,Wifeyloves,2553,158,4,7,11,36.4%,52m
28280,3,Liminator,2553,0,2,4,6,33.3%,55m
28280,3,rexchancho,2553,0,0,1,1,0.0%,3h
28280,2,Yoshiyahoo,2553,0,0,2,2,0.0%,1h
28293,2,birdman,2552,1589,113,91,204,55.4%,12m
28293,2,benbenben,2552,1225,103,122,225,45.8%,40m
28293,2,Van,2552,778,94,84,178,52.8%,38m
28293,1,[GESC2]GenCarnage,2552,1118,72,57,129,55.8%,2h
28293,2,Apolkalypse,2552,306,37,32,69,53.6%,12m
28293,2,[PAWPAT]Chihuahua,2552,814,31,28,59,52.5%,39m
28293,1,Pride,2552,770,26,29,55,47.3%,11m
28293,1,maaloufixe,2552,555,19,24,43,44.2%,3h
28293,2,Angel,2552,354,11,11,22,50.0%,5m
28293,2,[ggongg]wazoza,2552,248,10,4,14,71.4%,21m
28293,3,[GoPctm]Chemere,2552,228,7,11,18,38.9%,12m
28293,1,Litorat,2552,212,6,13,19,31.6%,36m
28293,2,HeroicCookie,2552,150,5,1,6,83.3%,2h
28293,3,Asela,2552,112,5,6,11,45.5%,2h
28293,2,Rex,2552,147,4,4,8,50.0%,2h
28293,2,Winter,2552,44,4,7,11,36.4%,52m
28293,1,IllIllIlI,2552,67,3,3,6,50.0%,2h
28293,2,LazyTurtle,2552,86,3,3,6,50.0%,3h
28293,2,[TryA]AnthonyHF,2552,0,2,3,5,40.0%,2m
28293,3,CuteNoobT,2552,0,2,4,6,33.3%,2h
28293,2,Kentachi,2552,30,1,3,4,25.0%,2h
28293,2,YUser,2552,0,0,1,1,0.0%,19m
28315,1,Dentex,2551,1232,110,103,213,51.6%,36m
28315,2,[PTHero]MvonLipwig,2551,884,34,32,66,51.5%,50m
28315,1,[SpJm]TowerRenaldo,2551,796,30,30,60,50.0%,15m
28315,1,[En0L]CadR,2551,667,25,30,55,45.5%,40m
28315,2,AwakenToGrey,2551,459,20,13,33,60.6%,3h
28315,2,Shadowdog,2551,409,16,14,30,53.3%,7m
28315,2,[US]YouAssassin,2551,355,15,19,34,44.1%,1h
28315,2,mizaki,2551,391,14,8,22,63.6%,50m
28315,2,Warped,2551,314,11,17,28,39.3%,50m
28315,2,[scMAUI]DeathByShagg,2551,118,5,6,11,45.5%,52m
28315,1,Dweller,2551,135,5,6,11,45.5%,41m
28315,1,YouBryant,2551,239,5,14,19,26.3%,59m
28315,1,[sk3tch]TokesMcGanja,2551,192,3,7,10,30.0%,60m
28315,2,Cristian,2551,112,2,1,3,66.7%,2h
28315,3,[ExecUt]Alienshark,2551,48,2,6,8,25.0%,10m
28315,2,ImBatman,2551,0,1,0,1,100.0%,3h
28315,2,[iTard]OverlordSpce,2551,0,1,0,1,100.0%,3h
28315,1,Jason,2551,0,1,3,4,25.0%,33m
28315,2,[Daimyo]Draconis,2551,0,0,1,1,0.0%,2h
28315,1,CptTyinKnots,2551,0,0,1,1,0.0%,2m
28315,3,QUECOSAII,2551,0,0,1,1,0.0%,59m
28315,1,[AFI]arceus,2551,0,0,4,4,0.0%,38m
28337,2,saltnsnow,2550,1355,103,90,193,53.4%,34m
28337,2,crysys,2550,727,30,23,53,56.6%,3h
28337,2,[AKNewb]Twiner,2550,611,29,28,57,50.9%,7m
28337,1,maite,2550,874,28,34,62,45.2%,33m
28337,2,sccattter,2550,539,26,18,44,59.1%,22m
28337,2,[OTEL]ROOMMAA,2550,327,14,7,21,66.7%,2h
28337,2,MirroRcoLE,2550,126,9,3,12,75.0%,12m
28337,1,Daicho,2550,221,8,10,18,44.4%,2m
28337,2,Jameson,2550,176,6,3,9,66.7%,1h
28337,2,Bitterant,2550,217,6,9,15,40.0%,2h
28337,2,[Normie]Nathan,2550,142,5,5,10,50.0%,2h
28337,2,AnimaSolis,2550,155,5,5,10,50.0%,16m
28337,2,Bermang,2550,0,3,3,6,50.0%,38m
28337,3,lance,2550,0,2,3,5,40.0%,58m
28337,2,PAX,2550,30,1,2,3,33.3%,34m
28337,2,Bradyn,2550,0,0,1,1,0.0%,35m
28353,2,Carbonite,2549,1634,328,304,632,51.9%,2h
28353,2,AironEddie,2549,1524,81,77,158,51.3%,1h
28353,1,[PwPS2]Irosh,2549,739,31,28,59,52.5%,3h
28353,2,Goroum,2549,353,30,22,52,57.7%,1h
28353,2,[rictum]ButtAnus,2549,556,21,18,39,53.8%,21m
28353,1,JkFrmStFrm,2549,525,20,21,41,48.8%,3h
28353,2,Achilles,2549,320,11,12,23,47.8%,23m
28353,1,Trajalisk,2549,326,10,15,25,40.0%,2h
28353,2,Norgath,2549,254,9,5,14,64.3%,34m
28353,1,EDmkhildegla,2549,247,9,7,16,56.2%,5m
28353,2,[ph0t0n]MinuteHand,2549,220,9,7,16,56.2%,19m
28353,2,omar,2549,111,4,0,4,100.0%,3h
28353,3,Trump,2549,168,4,5,9,44.4%,54m
28353,2,Heisenberg,2549,120,4,8,12,33.3%,5m
28353,2,SombraLetal,2549,30,3,4,7,42.9%,35m
28353,1,Crea,2549,32,3,5,8,37.5%,3h
28353,3,AsFLegion,2549,0,2,4,6,33.3%,3h
28353,2,Lucid,2549,0,0,1,1,0.0%,53m
28353,2,[RaWH]Thefollower,2549,0,0,1,1,0.0%,12m
28353,2,ToXic,2549,0,0,1,1,0.0%,50m
28353,2,[CryTek]ILLUMINATED,2549,0,0,5,5,0.0%,48m
28353,1,EyeWeaver,2549,0,0,8,8,0.0%,53m
28375,2,[SCMW]JCDJ,2548,1474,101,86,187,54.0%,37m
28375,2,Joel,2548,1565,98,96,194,50.5%,2h
28375,3,DarkSeraphX,2548,674,81,69,150,54.0%,40m
28375,2,[neuroS]Brewster,2548,1404,54,53,107,50.5%,2h
28375,1,OrigamiKID,2548,1013,38,37,75,50.7%,25m
28375,2,Rainmaker,2548,609,25,23,48,52.1%,54m
28375,2,ZergBJsFTL,2548,612,24,20,44,54.5%,2h
28375,1,[CADIVI]Okarin,2548,479,18,17,35,51.4%,3h
28375,2,Ratu,2548,424,17,10,27,63.0%,1h
28375,2,Xólotl,2548,397,17,15,32,53.1%,2h
28375,1,Bulbasir,2548,514,17,23,40,42.5%,27m
28375,3,DrKiller,2548,530,17,29,46,37.0%,13m
28375,2,JonasBrink,2548,389,15,12,27,55.6%,38m
28375,2,Littlewho,2548,339,14,17,31,45.2%,3h
28375,1,AlienXBR,2548,404,13,17,30,43.3%,38m
28375,2,FUTZ,2548,195,11,6,17,64.7%,9m
28375,2,Dotero,2548,228,9,7,16,56.2%,2h
28375,2,Frippy,2548,215,8,1,9,88.9%,3h
28375,2,Nikochan,2548,140,5,0,5,100.0%,7m
28375,1,Chacal,2548,96,4,6,10,40.0%,41m
28375,2,snail,2548,62,3,2,5,60.0%,52m
28375,2,Testarossa,2548,0,3,2,5,60.0%,17m
28375,1,Pidgelocke,2548,0,2,4,6,33.3%,1h
28375,3,Doran,2548,40,1,2,3,33.3%,23m
28375,2,[NA7]beXcellent,2548,30,1,3,4,25.0%,12m
28375,1,IIIIIIIII,2548,0,1,5,6,16.7%,2h
28375,2,ActualDeath,2548,0,0,1,1,0.0%,2h
28375,3,[Pro999]gabox,2548,0,0,1,1,0.0%,18m
28375,2,FntstcMrFox,2548,0,0,1,1,0.0%,2m
28404,1,Macicao,2547,1478,95,95,190,50.0%,3h
28404,1,Mark,2547,1568,86,86,172,50.0%,2h
28404,2,nowwissonn,2547,1578,80,82,162,49.4%,2h
28404,1,goblinflesh,2547,1242,66,56,122,54.1%,55m
28404,2,Deproone,2547,1195,47,43,90,52.2%,43m
28404,2,Juul,2547,929,35,49,84,41.7%,34m
28404,1,Idontknow,2547,614,21,27,48,43.8%,44m
28404,2,[Law11]biggyshwartz,2547,500,18,23,41,43.9%,50m
28404,1,ebonypron,2547,371,15,22,37,40.5%,30m
28404,1,Trump,2547,365,12,11,23,52.2%,2h
28404,2,OmegaTuf,2547,147,5,3,8,62.5%,22m
28404,1,Keola,2547,103,4,5,9,44.4%,2h
28404,1,Enigma,2547,94,3,3,6,50.0%,2h
28404,2,SoulRaeb,2547,60,3,3,6,50.0%,23m
28404,3,BDJones,2547,0,2,3,5,40.0%,1h
28404,3,Galaschi,2547,0,2,4,6,33.3%,3m
28404,3,TheProbe,2547,42,1,3,4,25.0%,43m
28404,2,Mathword,2547,93,1,4,5,20.0%,2h
28404,1,Loriam,2547,36,1,6,7,14.3%,35m
28404,3,martius,2547,0,0,1,1,0.0%,44m
28404,2,Killercroc,2547,0,0,2,2,0.0%,39m
28404,2,RandomGaming,2547,0,0,2,2,0.0%,50m
28426,3,[DETER]JackOfSpades,2546,1539,170,168,338,50.3%,19m
28426,2,[ZTemp]Dufresne,2546,730,54,43,97,55.7%,2h
28426,1,kam,2546,995,39,43,82,47.6%,2h
28426,1,Nigredo,2546,968,37,42,79,46.8%,8m
28426,1,TheamazingG,2546,621,21,22,43,48.8%,2h
28426,2,[FFBP]Stirfryed,2546,528,20,17,37,54.1%,7m
28426,2,Dimitro,2546,412,15,12,27,55.6%,12m
28426,2,[KGH7]ColeMichael,2546,324,11,12,23,47.8%,3h
28426,2,saulsl,2546,282,10,6,16,62.5%,3h
28426,1,buzzlow,2546,284,9,14,23,39.1%,41m
28426,2,KidCuervo,2546,228,7,5,12,58.3%,7m
28426,1,lOstMoo,2546,176,6,7,13,46.2%,17m
28426,2,[TOYK]BallzDeep,2546,88,4,4,8,50.0%,9m
28426,1,hithazel,2546,0,3,4,7,42.9%,7m
28426,2,SmagMarr,2546,58,2,2,4,50.0%,22m
28426,2,agent,2546,0,1,0,1,100.0%,1h
28426,3,JoseCHIP,2546,0,1,1,2,50.0%,2h
28426,2,Herpderk,2546,30,1,4,5,20.0%,46m
28426,2,[Asmbly]Smith,2546,0,0,1,1,0.0%,2h
28426,2,KikeMorande,2546,0,0,1,1,0.0%,2h
28426,2,TPSmjames,2546,0,0,1,1,0.0%,9m
28426,2,Brogand,2546,0,0,1,1,0.0%,2h
28426,2,Typhon,2546,0,0,3,3,0.0%,2h
28449,3,zingyou,2545,1636,362,366,728,49.7%,17m
28449,1,Zhuge,2545,821,84,80,164,51.2%,21m
28449,2,Zergtitude,2545,1604,79,71,150,52.7%,52m
28449,1,McBlack,2545,700,65,68,133,48.9%,52m
28449,2,[Mataco]Yorick,2545,690,38,24,62,61.3%,36m
28449,1,[LMI42]fatbaldoldma,2545,978,34,40,74,45.9%,11m
28449,2,Nürburgring,2545,646,29,18,47,61.7%,33m
28449,2,[FFAA]EthanR,2545,519,25,7,32,78.1%,2h
28449,2,Bready,2545,420,18,10,28,64.3%,2h
28449,2,PooShipMcGee,2545,342,14,11,25,56.0%,52m
28449,2,Clarity,2545,343,13,7,20,65.0%,3h
28449,1,WarDaddy,2545,249,12,10,22,54.5%,3h
28449,2,NeaPawn,2545,192,10,10,20,50.0%,5m
28449,1,WINTERGREEN,2545,91,7,6,13,53.8%,8m
28449,2,CiroGames,2545,178,7,6,13,53.8%,1h
28449,2,Obed,2545,148,6,6,12,50.0%,38m
28449,2,Marto,2545,152,5,3,8,62.5%,25m
28449,2,NOBODY,2545,151,5,5,10,50.0%,50m
28449,2,Zimzl,2545,82,5,7,12,41.7%,2h
28449,2,CateDraL,2545,92,4,2,6,66.7%,3h
28449,2,[DHZAcD]TubarãoBR,2545,92,4,5,9,44.4%,21m
28449,2,loquengamer,2545,24,2,1,3,66.7%,38m
28449,1,Precision,2545,96,2,1,3,66.7%,3m
28449,3,[xIG]Dake,2545,0,2,3,5,40.0%,3h
28449,2,Ataraxia,2545,0,2,3,5,40.0%,52m
28449,2,CLOUD,2545,0,2,3,5,40.0%,58m
28449,3,[75ARR]allfon,2545,0,2,4,6,33.3%,23m
28449,2,Dax,2545,0,0,1,1,0.0%,34m
28449,2,[SWOU]Solitorio,2545,0,0,1,1,0.0%,35m
28449,2,riben,2545,0,0,5,5,0.0%,2h
28479,1,SpartanFTJ,2544,1646,400,396,796,50.3%,41m
28479,3,[b1azin]NukeDaddy,2544,1479,160,138,298,53.7%,10m
28479,3,Joshena,2544,1475,110,104,214,51.4%,9m
28479,1,BroCareToLax,2544,1538,63,64,127,49.6%,3h
28479,1,EJOA,2544,1276,58,50,108,53.7%,34m
28479,1,Boxxxx,2544,632,48,44,92,52.2%,23m
28479,2,[HazIPA]UchihaJoel,2544,860,36,29,65,55.4%,2h
28479,2,Sauron,2544,754,35,26,61,57.4%,7m
28479,3,random,2544,953,35,44,79,44.3%,31m
28479,2,[fatb0i]Jacaranda,2544,408,34,17,51,66.7%,48m
28479,1,[PobSC]Spaceman,2544,751,28,29,57,49.1%,1h
28479,2,[TACTEC]kyama,2544,332,11,10,21,52.4%,18m
28479,2,Viom,2544,243,9,4,13,69.2%,52m
28479,2,basher,2544,220,8,9,17,47.1%,25m
28479,1,zach,2544,132,6,6,12,50.0%,34m
28479,2,Morph,2544,146,5,0,5,100.0%,3h
28479,1,[Mgoose]monotron,2544,190,5,8,13,38.5%,3h
28479,2,[RLRC]BreaktheSky,2544,148,3,5,8,37.5%,2h
28479,2,Jwhit,2544,117,2,2,4,50.0%,19m
28479,2,[MojoYo]mojojojo,2544,30,2,2,4,50.0%,2h
28479,3,Portishead,2544,0,2,3,5,40.0%,2h
28479,3,crash,2544,0,2,3,5,40.0%,48m
28479,2,Salieri,2544,0,2,5,7,28.6%,2h
28479,3,Swarm,2544,0,1,0,1,100.0%,4m
28479,3,Jim,2544,0,1,1,2,50.0%,55m
28479,1,SnowPython,2544,0,1,2,3,33.3%,3h
28479,2,PratorusAM,2544,88,1,8,9,11.1%,42m
28479,2,MsC,2544,0,0,1,1,0.0%,3h
28479,2,TLife,2544,0,0,1,1,0.0%,3h
28479,2,LANDA,2544,0,0,2,2,0.0%,2h
28479,2,[EGiD]Braxton,2544,0,0,3,3,0.0%,3h
28479,3,Colonelc,2544,0,0,4,4,0.0%,55m
28511,1,Nocturne,2543,1654,73,70,143,51.0%,36m
28511,2,[MIKES]Mike,2543,885,46,40,86,53.5%,11m
28511,1,XelNaga,2543,547,25,22,47,53.2%,60m
28511,2,[Lb7u7]BloodyClaw,2543,450,15,20,35,42.9%,38m
28511,2,[TgAg]NinoDrugz,2543,192,8,6,14,57.1%,12m
28511,2,ChocoShadowx,2543,177,6,7,13,46.2%,54m
28511,2,VaGmastRson,2543,184,5,4,9,55.6%,34m
28511,2,FlexCubes,2543,95,4,5,9,44.4%,3m
28511,3,Slayer,2543,147,3,2,5,60.0%,53m
28511,2,DarkSoul,2543,0,2,3,5,40.0%,2h
28511,3,nectar,2543,0,0,2,2,0.0%,45m
28511,2,[NuTFuW]KayElBee,2543,0,0,2,2,0.0%,7m
28511,2,aGAMEnc,2543,0,0,2,2,0.0%,3h
28524,1,KRTizzle,2542,1652,72,75,147,49.0%,2h
28524,1,Tatsuya,2542,1542,65,61,126,51.6%,33m
28524,1,[HRDep]giantbighuge,2542,946,32,36,68,47.1%,43m
28524,1,Fantas,2542,296,11,14,25,44.0%,21m
28524,2,Sandbag,2542,193,8,6,14,57.1%,1h
28524,1,Dink,2542,102,8,14,22,36.4%,56m
28524,1,Etileyeti,2542,219,7,10,17,41.2%,45m
28524,1,yoshmin,2542,232,7,17,24,29.2%,8m
28524,1,bRUCe,2542,194,6,9,15,40.0%,33m
28524,2,Deathangel,2542,116,5,4,9,55.6%,39m
28524,1,gibby,2542,86,4,5,9,44.4%,2h
28524,2,ohdoylerules,2542,109,4,6,10,40.0%,2h
28524,2,Stuey,2542,141,4,6,10,40.0%,54m
28524,2,[ValidG]daveyboy,2542,60,3,4,7,42.9%,2m
28524,3,sapito,2542,0,2,2,4,50.0%,2h
28524,3,Tláatl,2542,0,2,3,5,40.0%,49m
28524,1,TSquared,2542,32,2,10,12,16.7%,3h
28524,2,Sasha,2542,0,1,0,1,100.0%,17m
28524,2,[WhitG]TooGritty,2542,30,1,1,2,50.0%,1h
28524,2,Vrixen,2542,97,1,2,3,33.3%,2h
28524,3,Krater,2542,0,1,3,4,25.0%,55m
28524,2,HolyPohTayTe,2542,88,1,5,6,16.7%,50m
28524,2,DannyM,2542,0,0,1,1,0.0%,2h
28524,2,Jeffry,2542,0,0,3,3,0.0%,49m
28548,2,IkeSkywalker,2541,904,38,29,67,56.7%,52m
28548,1,[CPTA]KetZaCoal,2541,722,30,26,56,53.6%,45m
28548,2,jsrao,2541,488,20,17,37,54.1%,43m
28548,2,Genidoxian,2541,393,19,17,36,52.8%,39m
28548,2,shadowdragon,2541,484,19,20,39,48.7%,2h
28548,2,JtheCool,2541,444,16,15,31,51.6%,2h
28548,1,lso,2541,316,11,11,22,50.0%,30m
28548,2,mmeowth,2541,275,11,15,26,42.3%,46m
28548,2,DaveBarry,2541,202,7,11,18,38.9%,2h
28548,2,[SyLx]desbro,2541,184,6,5,11,54.5%,2h
28548,2,steven,2541,202,6,5,11,54.5%,34m
28548,2,guevarodrigo,2541,130,5,0,5,100.0%,2h
28548,2,[Dagr]Jimbo,2541,44,4,6,10,40.0%,11m
28548,2,[US1776]ezone,2541,112,3,0,3,100.0%,3h
28548,1,MakaveLi,2541,38,3,5,8,37.5%,2h
28548,2,Canfer,2541,0,3,6,9,33.3%,30m
28548,2,Shadefang,2541,88,2,0,2,100.0%,25m
28548,2,[ANZAC]BigWill,2541,30,2,2,4,50.0%,39m
28548,2,nomad,2541,0,2,3,5,40.0%,23m
28548,3,Anithira,2541,97,2,4,6,33.3%,60m
28548,1,NuroThunz,2541,34,2,10,12,16.7%,3h
28548,1,StarRage,2541,143,2,11,13,15.4%,52m
28548,2,PeruVaARusia,2541,0,1,4,5,20.0%,18m
28548,2,[mumy]epic,2541,0,0,1,1,0.0%,2h
28548,2,brian,2541,0,0,1,1,0.0%,3h
28548,2,Immure,2541,0,0,2,2,0.0%,52m
28574,3,[Shang]Penamat,2540,1561,379,356,735,51.6%,11m
28574,2,DrDiminutive,2540,1415,67,51,118,56.8%,58m
28574,2,[GTHS]oswill,2540,972,38,35,73,52.1%,35m
28574,2,Reedyseth,2540,734,37,32,69,53.6%,7m
28574,3,Blobmob,2540,916,35,42,77,45.5%,38m
28574,2,[PobSC]ChicoCuagulo,2540,629,23,22,45,51.1%,16m
28574,1,SlavojZizek,2540,367,16,13,29,55.2%,2h
28574,2,[gumba]nlgerianscam,2540,353,13,10,23,56.5%,37m
28574,1,NoMames,2540,180,6,9,15,40.0%,3h
28574,1,[BURNIN]VulvaTronics,2540,40,4,5,9,44.4%,33m
28574,1,Deimos,2540,0,4,7,11,36.4%,2h
28574,2,[UFC]Hope,2540,60,2,2,4,50.0%,46m
28574,2,Litware,2540,0,2,3,5,40.0%,2h
28574,3,kinoks,2540,0,1,0,1,100.0%,53m
28574,2,RogueFixer,2540,88,1,1,2,50.0%,1h
28574,2,Warantino,2540,0,1,1,2,50.0%,5m
28574,2,bott,2540,0,1,2,3,33.3%,2h
28574,2,FrugalMoogle,2540,30,1,2,3,33.3%,50m
28574,2,[SCTF]Zen,2540,48,1,5,6,16.7%,2h
28574,2,ddd,2540,0,0,3,3,0.0%,12m
28574,2,Minecraft,2540,0,0,4,4,0.0%,2h
28574,1,DawnHorizon,2540,0,0,6,6,0.0%,2h
28596,3,Buzzkilla,2539,1394,318,316,634,50.2%,30m
28596,2,MinecraftPro,2539,1061,42,37,79,53.2%,3h
28596,2,[FyHr]Takaro,2539,853,37,27,64,57.8%,17m
28596,1,Ghostman,2539,703,25,26,51,49.0%,3h
28596,1,[TTKOPF]ANTIBOTS,2539,486,19,14,33,57.6%,2h
28596,1,Vongola,2539,467,18,18,36,50.0%,2h
28596,2,Roquinn,2539,121,14,14,28,50.0%,40m
28596,2,thedecider,2539,322,12,11,23,52.2%,36m
28596,2,ThiefOfEden,2539,312,11,14,25,44.0%,2h
28596,2,Weimarauder,2539,218,10,11,21,47.6%,34m
28596,1,projectdp,2539,154,5,9,14,35.7%,2h
28596,2,Greedy,2539,30,2,0,2,100.0%,2h
28596,2,Dreadjester,2539,102,2,1,3,66.7%,2h
28596,3,ILikeTurtles,2539,0,2,3,5,40.0%,52m
28596,2,Juice,2539,0,1,1,2,50.0%,2h
28596,1,Baratheon,2539,48,1,1,2,50.0%,28m
28596,2,Sysout,2539,30,1,3,4,25.0%,25m
28596,2,lparanoico,2539,0,0,1,1,0.0%,2h
28614,1,CommunistAK,2538,1647,113,90,203,55.7%,3h
28614,1,BillyShakes,2538,919,55,62,117,47.0%,35m
28614,2,Space,2538,876,33,34,67,49.3%,3h
28614,2,[OndaVT]Frank,2538,361,25,15,40,62.5%,12m
28614,2,CLlTORlSLSD,2538,530,21,16,37,56.8%,3h
28614,1,Ben,2538,312,10,16,26,38.5%,27m
28614,1,[Twitch]GarMan,2538,170,7,10,17,41.2%,2h
28614,1,Markp,2538,91,3,5,8,37.5%,2h
28614,2,gaolirandu,2538,100,3,7,10,30.0%,38m
28614,2,SpaceRanger,2538,30,2,2,4,50.0%,3h
28614,2,[GrpHug]Odaniv,2538,0,1,0,1,100.0%,1h
28614,2,Pineapple,2538,0,0,1,1,0.0%,3h
28614,3,[UpxV]PapaDopulos,2538,0,0,1,1,0.0%,2h
28627,3,mocksol,2537,1228,109,116,225,48.4%,17m
28627,3,ToddFitts,2537,1463,88,95,183,48.1%,14m
28627,3,SkunkBeard,2537,1510,76,80,156,48.7%,8m
28627,2,Krota,2537,1593,73,63,136,53.7%,2h
28627,2,[ExcIgN]Chikio,2537,1360,53,54,107,49.5%,37m
28627,2,Roberth,2537,450,23,16,39,59.0%,2h
28627,2,ducksgoquook,2537,502,19,17,36,52.8%,39m
28627,2,wolfdon,2537,350,16,17,33,48.5%,46m
28627,2,[Ec0s]Veken,2537,139,15,8,23,65.2%,48m
28627,2,Garchador,2537,266,11,11,22,50.0%,2h
28627,1,Derek,2537,286,10,11,21,47.6%,43m
28627,2,Bloodpack,2537,142,8,3,11,72.7%,16m
28627,2,SANGUINIUZ,2537,171,6,4,10,60.0%,3h
28627,2,PartyPolice,2537,30,5,2,7,71.4%,46m
28627,2,food,2537,140,4,2,6,66.7%,38m
28627,2,[TGosuD]Beetlejuice,2537,145,4,4,8,50.0%,3h
28627,3,Chadders,2537,97,3,2,5,60.0%,3h
28627,3,[TPGGXD]Oxxoman,2537,60,3,6,9,33.3%,9m
28627,2,Carlos,2537,58,2,4,6,33.3%,8m
28627,2,[Roblox]Nexzuz,2537,38,1,3,4,25.0%,16m
28627,2,SMH,2537,0,0,1,1,0.0%,25m
28627,2,[IVVVI]Zoboomafoo,2537,0,0,2,2,0.0%,2h
28627,1,ScarletYNEZ,2537,0,0,2,2,0.0%,41m
28627,3,Steve,2537,0,0,2,2,0.0%,5m
28627,1,mangeboule,2537,0,0,3,3,0.0%,2h
28652,2,RedKnight,2536,1620,224,209,433,51.7%,1h
28652,2,RtwoDtwo,2536,1012,66,57,123,53.7%,5m
28652,1,Chiasmus,2536,1180,66,72,138,47.8%,2h
28652,2,Aurelicus,2536,681,29,20,49,59.2%,3h
28652,1,Protosopic,2536,674,26,26,52,50.0%,45m
28652,1,[ÆON]Maraudier,2536,658,22,34,56,39.3%,8m
28652,2,FANTASMA,2536,358,18,12,30,60.0%,1h
28652,2,[RiftSS]Lamps,2536,323,16,12,28,57.1%,12m
28652,1,[NM8]Maximilian,2536,354,13,13,26,50.0%,1h
28652,2,cal,2536,308,13,14,27,48.1%,58m
28652,2,NickArrow,2536,174,8,12,20,40.0%,28m
28652,1,balantay,2536,142,5,9,14,35.7%,4m
28652,2,Alank,2536,138,4,2,6,66.7%,2h
28652,1,Naethon,2536,42,4,5,9,44.4%,44m
28652,1,mrkisawsome,2536,122,4,7,11,36.4%,20m
28652,2,[GRNSKN]Qfuzz,2536,60,3,3,6,50.0%,28m
28652,2,MrWasteland,2536,30,2,1,3,66.7%,22m
28652,3,[MCLRSN]MichaelRosen,2536,34,2,2,4,50.0%,23m
28652,1,AcidBear,2536,0,1,0,1,100.0%,2h
28652,1,[ValidG]SimplyYellow,2536,36,1,4,5,20.0%,17m
28652,2,Kaiimi,2536,0,1,4,5,20.0%,11m
28673,2,[nieBla]Skull,2535,1612,233,203,436,53.4%,2h
28673,1,nrhythmic,2535,1579,96,93,189,50.8%,39m
28673,1,Dominus,2535,1599,75,49,124,60.5%,2h
28673,2,Conscious,2535,1538,73,85,158,46.2%,41m
28673,1,Nite,2535,779,55,53,108,50.9%,35m
28673,2,MrHacker,2535,602,41,29,70,58.6%,8m
28673,2,[PiGPan]knightguard,2535,231,16,10,26,61.5%,12m
28673,2,Joannaho,2535,271,8,8,16,50.0%,38m
28673,2,[FxB]Mudflap,2535,168,6,4,10,60.0%,3h
28673,2,Wubb,2535,200,6,7,13,46.2%,18m
28673,2,[GrnBrd]Minimal,2535,132,4,1,5,80.0%,52m
28673,3,[DarkLS]alexg,2535,97,4,2,6,66.7%,56m
28673,2,bLEECH,2535,167,3,3,6,50.0%,16m
28673,3,joseticona,2535,0,3,5,8,37.5%,11m
28673,2,AvocadoJay,2535,90,3,7,10,30.0%,43m
28673,2,IVDenisovich,2535,88,2,0,2,100.0%,2h
28673,3,Leon,2535,0,0,1,1,0.0%,32m
28690,2,[RAVE]ohaibbq,2534,896,51,39,90,56.7%,3h
28690,2,Demexo,2534,936,37,38,75,49.3%,16m
28690,2,Blastark,2534,407,29,22,51,56.9%,35m
28690,2,EthanVCP,2534,653,28,21,49,57.1%,2h
28690,2,[OtakMs]RicardoMS,2534,498,23,12,35,65.7%,11m
28690,3,[ZTempz]Mike,2534,543,23,34,57,40.4%,30m
28690,2,lAraeLl,2534,425,19,13,32,59.4%,39m
28690,2,Rodolfinho,2534,468,16,18,34,47.1%,12m
28690,1,CasualFlex,2534,467,15,19,34,44.1%,1h
28690,2,PhilOsophy,2534,297,13,4,17,76.5%,34m
28690,2,SomeHobo,2534,344,13,9,22,59.1%,1h
28690,1,Naysayer,2534,403,12,13,25,48.0%,17m
28690,2,[aqocea]Shadow,2534,286,11,9,20,55.0%,12m
28690,1,xblitzx,2534,242,9,12,21,42.9%,2h
28690,2,Zvezda,2534,180,7,2,9,77.8%,3h
28690,2,carlos,2534,223,7,5,12,58.3%,22m
28690,2,bruh,2534,119,6,3,9,66.7%,2h
28690,1,Gynko,2534,207,6,8,14,42.9%,1h
28690,1,Religare,2534,167,6,13,19,31.6%,1h
28690,1,[FUFXx]IIIIIIIIIIII,2534,146,5,12,17,29.4%,2h
28690,1,Skeleton,2534,97,4,6,10,40.0%,7m
28690,2,[DURRR]OCHOA,2534,46,2,2,4,50.0%,27m
28690,3,NinjaGurl,2534,0,2,4,6,33.3%,23m
28690,2,okra,2534,0,1,0,1,100.0%,52m
28690,2,NiceBoulder,2534,30,1,3,4,25.0%,25m
28690,3,sebby,2534,0,1,3,4,25.0%,18m
28690,2,bao,2534,0,1,6,7,14.3%,12m
28690,3,[PQH]Danauck,2534,0,0,1,1,0.0%,57m
28690,2,Bert,2534,0,0,1,1,0.0%,2h
28719,1,sleepdep,2533,1471,144,148,292,49.3%,8m
28719,2,meanie,2533,1553,103,96,199,51.8%,2h
28719,2,Mikman,2533,721,42,33,75,56.0%,17m
28719,2,Germz,2533,703,29,26,55,52.7%,29m
28719,3,Mafilux,2533,540,28,41,69,40.6%,33m
28719,2,[αXLa]MarinDeHELAD,2533,555,22,17,39,56.4%,2h
28719,1,GoingTharn,2533,557,22,28,50,44.0%,33m
28719,2,RevlutionMan,2533,409,20,4,24,83.3%,2h
28719,2,AshyLarry,2533,319,13,9,22,59.1%,19m
28719,2,Siloxane,2533,412,13,31,44,29.5%,34m
28719,1,Thoben,2533,134,12,19,31,38.7%,36m
28719,2,[McFIy]CharlieDangr,2533,330,11,15,26,42.3%,1h
28719,2,pabolmortis,2533,150,6,6,12,50.0%,37m
28719,1,CrimsonChin,2533,30,5,4,9,55.6%,3h
28719,1,CHANT,2533,188,3,6,9,33.3%,11m
28719,2,lammpy,2533,135,2,4,6,33.3%,34m
28719,2,[NO0OBZ]Jbreezy,2533,0,1,0,1,100.0%,1h
28719,2,BATTLEMASTER,2533,0,0,1,1,0.0%,2m
28719,3,[G4M3R5]Jaydogs,2533,0,0,1,1,0.0%,2h
28719,2,Sethius,2533,0,0,2,2,0.0%,35m
28739,2,SmokeyBonez,2532,1522,96,92,188,51.1%,51m
28739,1,jds,2532,554,54,50,104,51.9%,35m
28739,2,Fenix,2532,904,53,41,94,56.4%,3h
28739,1,TKUYU,2532,387,13,16,29,44.8%,3h
28739,2,ADRyan,2532,349,13,16,29,44.8%,2h
28739,2,SoulStinger,2532,280,11,6,17,64.7%,3h
28739,1,GameOverAdv,2532,229,10,10,20,50.0%,2h
28739,2,BUJIGANOMEMI,2532,182,5,4,9,55.6%,54m
28739,2,Sthefano,2532,187,5,5,10,50.0%,2h
28739,2,Sevi,2532,138,4,2,6,66.7%,48m
28739,3,theheartless,2532,0,4,3,7,57.1%,37m
28739,2,JHOELORD,2532,114,4,5,9,44.4%,3h
28739,3,[AntRuS]Raistlin,2532,70,4,6,10,40.0%,42m
28739,2,NightKnight,2532,118,4,6,10,40.0%,49m
28739,2,OhNo,2532,116,3,5,8,37.5%,23m
28739,3,Asphaltdream,2532,0,2,3,5,40.0%,36m
28739,3,Wilser,2532,0,2,4,6,33.3%,2h
28739,2,Strut,2532,0,1,0,1,100.0%,1h
28739,2,dlx,2532,0,1,0,1,100.0%,10m
28739,2,[YG0D]Charmzz,2532,0,0,1,1,0.0%,2h
28739,2,[KA1S]ShadowSharkD,2532,0,0,1,1,0.0%,48m
28760,2,SERMINARO,2531,1631,180,166,346,52.0%,1h
28760,2,Slime,2531,1006,37,39,76,48.7%,2h
28760,2,Panda,2531,788,32,31,63,50.8%,1h
28760,3,[mbLoWn]Syringe,2531,922,30,44,74,40.5%,30m
28760,1,butteryheat,2531,737,27,33,60,45.0%,44m
28760,2,[NA7]maddoxxl,2531,730,26,26,52,50.0%,2h
28760,2,efrain,2531,496,19,20,39,48.7%,3h
28760,3,Dab,2531,328,17,24,41,41.5%,23m
28760,1,nullType,2531,178,7,10,17,41.2%,3h
28760,1,SamuelioX,2531,92,5,7,12,41.7%,33m
28760,2,aMan,2531,111,4,6,10,40.0%,52m
28760,3,[GEMC]Faithless,2531,121,3,0,3,100.0%,2h
28760,2,TesteServer,2531,66,3,3,6,50.0%,37m
28760,2,[LOHs]hero,2531,30,2,1,3,66.7%,3h
28760,2,Kobukai,2531,118,2,2,4,50.0%,12m
28760,2,[ººDKºº]VelvetJester,2531,0,2,3,5,40.0%,2h
28760,2,[PyTi]Kyzester,2531,0,2,3,5,40.0%,25m
28760,3,JackFlash,2531,62,2,6,8,25.0%,20m
28760,3,ZacAiur,2531,72,2,7,9,22.2%,38m
28760,2,NARSONER,2531,0,1,0,1,100.0%,50m
28760,2,[Pharoh]GorillaPug,2531,0,1,0,1,100.0%,5m
28760,3,[Impact]ninjadog,2531,97,1,6,7,14.3%,2h
28760,2,[DefCry]shady,2531,0,0,1,1,0.0%,2h
28760,2,[Venudo]Kots,2531,0,0,2,2,0.0%,52m
28760,2,noble,2531,0,0,5,5,0.0%,18m
28785,2,IRInjinr,2530,1523,91,95,186,48.9%,1h
28785,1,Italo,2530,809,33,38,71,46.5%,3h
28785,1,xmbie,2530,719,30,21,51,58.8%,2h
28785,2,Federicbi,2530,455,22,9,31,71.0%,2h
28785,2,[KWG]hewhoatepie,2530,527,20,18,38,52.6%,17m
28785,2,Chris,2530,590,20,24,44,45.5%,1h
28785,2,[CaC4s]alejandro,2530,450,17,20,37,45.9%,1h
28785,2,[ProKRS]Smittbrah,2530,215,7,6,13,53.8%,39m
28785,2,[R4GN]sMoKEHhh,2530,151,4,2,6,66.7%,33m
28785,3,Impaler,2530,30,3,4,7,42.9%,2h
28785,3,QuBuS,2530,145,3,5,8,37.5%,2h
28785,2,FrostHorneth,2530,88,2,0,2,100.0%,2h
28785,2,dravid,2530,88,2,0,2,100.0%,1h
28785,3,Nerito,2530,38,2,0,2,100.0%,29m
28785,2,Morisawa,2530,0,1,1,2,50.0%,36m
28785,2,Gameknight,2530,0,1,2,3,33.3%,1h
28785,2,[all123]Kilua,2530,30,1,4,5,20.0%,2h
28785,2,[EZTAXI]cwez,2530,0,0,1,1,0.0%,2h
28785,2,QCwariror,2530,0,0,1,1,0.0%,50m
28785,2,[LMI42]DookieToe,2530,0,0,1,1,0.0%,36m
28785,2,PABLOKX,2530,0,0,1,1,0.0%,1h
28785,2,DarkRavager,2530,0,0,2,2,0.0%,8m
28807,2,[maSC]Verdura,2529,1584,899,893,1792,50.2%,2h
28807,2,sgg,2529,988,50,47,97,51.5%,50m
28807,2,Clarus,2529,855,44,46,90,48.9%,35m
28807,2,Mickdedley,2529,749,38,27,65,58.5%,52m
28807,2,HerrKamerad,2529,830,34,29,63,54.0%,25m
28807,3,Blodepker,2529,340,13,29,42,31.0%,19m
28807,2,swaycer,2529,192,8,7,15,53.3%,1h
28807,2,DoCShuMaJer,2529,144,7,7,14,50.0%,19m
28807,2,AndresLoor,2529,162,6,3,9,66.7%,40m
28807,1,lucasmm,2529,211,6,9,15,40.0%,2h
28807,2,Coágulo,2529,146,5,3,8,62.5%,2h
28807,2,[ZTemp]GrimKeeper,2529,154,5,3,8,62.5%,18m
28807,2,intelliJ,2529,182,5,5,10,50.0%,2h
28807,3,[112222]Amonymous,2529,165,5,6,11,45.5%,15m
28807,3,Jackstraw,2529,145,4,3,7,57.1%,55m
28807,2,JoJo,2529,142,4,7,11,36.4%,3m
28807,1,moosewala,2529,97,4,7,11,36.4%,3m
28807,2,Aqua,2529,62,2,3,5,40.0%,3h
28807,2,pijaman,2529,0,1,0,1,100.0%,1h
28807,2,MelechiZedek,2529,0,1,1,2,50.0%,2h
28807,2,Skynet,2529,30,1,6,7,14.3%,3h
28807,3,[KoT]Zava,2529,0,0,1,1,0.0%,2h
28807,2,Jodric,2529,0,0,3,3,0.0%,2h
28807,1,DrgnSlayer,2529,0,0,7,7,0.0%,2h
28831,2,InstaQuasar,2528,937,101,97,198,51.0%,38m
28831,1,DjDanj,2528,1593,73,70,143,51.0%,2h
28831,2,MrBushido,2528,391,69,56,125,55.2%,34m
28831,1,Kayzerg,2528,791,49,40,89,55.1%,25m
28831,2,rafaMEN,2528,951,41,45,86,47.7%,1h
28831,2,[Huffs]Imposter,2528,694,28,22,50,56.0%,50m
28831,1,[Manics]AAABattery,2528,659,28,32,60,46.7%,1h
28831,2,[MARV3L]Heliocrat,2528,542,19,20,39,48.7%,50m
28831,2,CoralBeans,2528,251,12,0,12,100.0%,2h
28831,1,bruiserB,2528,134,8,7,15,53.3%,55m
28831,2,[Ch33s]TimtheLucky,2528,230,7,6,13,53.8%,2h
28831,2,TopazPumpkin,2528,206,7,10,17,41.2%,34m
28831,1,[Xpl0d3]Dario,2528,97,5,6,11,45.5%,55m
28831,1,OsokSistek,2528,48,5,7,12,41.7%,11m
28831,1,[CMGC]Darkrein,2528,166,5,10,15,33.3%,40m
28831,1,[VFam]Louvrissa,2528,152,5,12,17,29.4%,52m
28831,2,OuDatSpell,2528,140,4,1,5,80.0%,50m
28831,2,[CS0]BloodRayne,2528,92,4,3,7,57.1%,25m
28831,2,captainhjy,2528,90,4,4,8,50.0%,40m
28831,2,ECLIPSAUN,2528,102,2,1,3,66.7%,2h
28831,1,[KEILZ]Whitezero,2528,48,2,3,5,40.0%,35m
28831,2,Rylos,2528,0,0,1,1,0.0%,52m
28831,2,RDawg,2528,0,0,1,1,0.0%,2h
28831,2,Gorgoron,2528,0,0,1,1,0.0%,46m
28831,2,Jebbizy,2528,0,0,1,1,0.0%,2h
28831,3,Star,2528,0,0,1,1,0.0%,23m
28831,1,[DNKCET]KloacaHarris,2528,0,0,8,8,0.0%,14m
28858,2,ElZergoMasto,2527,1191,149,123,272,54.8%,35m
28858,2,PeterRun,2527,1497,108,110,218,49.5%,1h
28858,3,Snapdragon,2527,518,84,90,174,48.3%,27m
28858,2,MOhawk,2527,1217,66,59,125,52.8%,3h
28858,2,[NoL1fe]changed,2527,756,52,32,84,61.9%,2h
28858,2,Blue,2527,356,29,21,50,58.0%,1h
28858,2,Sanitizer,2527,532,20,19,39,51.3%,8m
28858,2,SepulvedaBlv,2527,486,18,15,33,54.5%,2h
28858,2,Taemin,2527,459,17,17,34,50.0%,2h
28858,2,[xHC]Sone,2527,353,16,10,26,61.5%,2h
28858,2,nomanchezbol,2527,354,14,13,27,51.9%,8m
28858,2,yoloswager,2527,113,6,1,7,85.7%,35m
28858,2,[CV0101]memo,2527,165,4,5,9,44.4%,3h
28858,2,Sunshine,2527,0,2,3,5,40.0%,2h
28858,3,DarkErkon,2527,97,2,4,6,33.3%,2h
28858,3,Hvalsey,2527,0,2,5,7,28.6%,52m
28858,2,Foyser,2527,30,1,2,3,33.3%,2h
28858,2,[0825]StubbyCore,2527,97,1,3,4,25.0%,3h
28858,2,MadaxOlimpus,2527,0,0,1,1,0.0%,35m
28877,1,coffee,2526,1117,109,99,208,52.4%,41m
28877,1,[25ml]Csheef,2526,1190,54,59,113,47.8%,2h
28877,2,SethSorenson,2526,1281,47,56,103,45.6%,1h
28877,2,Telomin,2526,1140,42,43,85,49.4%,23m
28877,2,[diaman]milo,2526,812,37,31,68,54.4%,1h
28877,2,[FiFF]RickMold,2526,746,35,25,60,58.3%,18m
28877,1,SlayersReign,2526,687,27,29,56,48.2%,44m
28877,2,fivedrone,2526,677,25,28,53,47.2%,29m
28877,1,Cranberry,2526,585,19,22,41,46.3%,3h
28877,2,faketaxi,2526,264,12,10,22,54.5%,3h
28877,1,DemoZ,2526,305,11,12,23,47.8%,37m
28877,2,Daveytickler,2526,90,6,10,16,37.5%,42m
28877,2,Barn,2526,0,2,3,5,40.0%,1h
28877,2,Regri,2526,0,2,4,6,33.3%,3h
28877,2,raMonster,2526,0,1,0,1,100.0%,58m
28877,2,[SKyber]sirfelipe,2526,0,1,0,1,100.0%,3h
28877,2,Tablefloor,2526,0,1,0,1,100.0%,2h
28877,2,vaider,2526,0,1,0,1,100.0%,34m
28877,2,Mycroft,2526,0,1,1,2,50.0%,1h
28877,2,Loboman,2526,44,1,1,2,50.0%,3h
28877,2,EmperorZerg,2526,30,1,3,4,25.0%,2h
28877,2,[GG4]SOVIETKOTGG,2526,0,1,4,5,20.0%,39m
28899,2,IMSS,2525,1442,180,182,362,49.7%,41m
28899,2,Christxpher,2525,862,42,30,72,58.3%,2h
28899,2,[VODK]POROTOTITO,2525,744,32,28,60,53.3%,51m
28899,3,Gfunk,2525,763,26,34,60,43.3%,19m
28899,2,Britney,2525,432,17,15,32,53.1%,2h
28899,1,aperient,2525,580,17,28,45,37.8%,2h
28899,2,HotShotBen,2525,266,10,11,21,47.6%,22m
28899,2,Drock,2525,225,9,10,19,47.4%,32m
28899,2,MetalX,2525,246,8,10,18,44.4%,2h
28899,2,[KrAce]cris,2525,167,6,2,8,75.0%,2h
28899,2,[NGFR]MrKrabs,2525,130,5,0,5,100.0%,2h
28899,2,BoshyTime,2525,92,5,7,12,41.7%,45m
28899,2,AJaweed,2525,133,5,9,14,35.7%,52m
28899,1,[Ditxiz]Ditxiz,2525,90,3,1,4,75.0%,30m
28899,3,[TMP99]SolidSnake,2525,119,3,9,12,25.0%,10m
28899,2,JonathanD,2525,30,2,1,3,66.7%,3h
28899,2,SsjÑoga,2525,60,2,6,8,25.0%,50m
28899,2,Murtage,2525,0,1,0,1,100.0%,52m
28899,2,[AbcCo]elvilca,2525,0,1,0,1,100.0%,52m
28899,2,alaracpro,2525,0,1,0,1,100.0%,59m
28899,3,DisturbedMat,2525,97,1,1,2,50.0%,45m
28899,2,TheWarlord,2525,0,0,2,2,0.0%,3h
28899,2,Fordorth,2525,0,0,3,3,0.0%,28m
28899,2,Ocs,2525,0,0,4,4,0.0%,50m
28923,2,[BOLF]RETROSATAN,2524,1634,101,101,202,50.0%,1h
28923,1,[Astute]Earlyreraise,2524,1168,46,42,88,52.3%,2h
28923,2,[XpKAc]AxelWolf,2524,589,38,31,69,55.1%,35m
28923,2,[SdwGmg]RazerJay,2524,626,25,23,48,52.1%,3h
28923,2,BROdysseus,2524,614,24,25,49,49.0%,36m
28923,2,Nero,2524,627,23,26,49,46.9%,8m
28923,2,Cendrars,2524,487,22,18,40,55.0%,22m
28923,2,Leon,2524,415,16,7,23,69.6%,17m
28923,2,Anchuinse,2524,379,16,16,32,50.0%,2h
28923,1,Saldanha,2524,394,14,16,30,46.7%,27m
28923,2,[CFHfh]mvanucci,2524,279,10,8,18,55.6%,48m
28923,2,TheSpiritFox,2524,228,9,4,13,69.2%,23m
28923,2,Xugo,2524,218,9,7,16,56.2%,2h
28923,3,Bobazoide,2524,235,7,13,20,35.0%,11m
28923,2,franktankboi,2524,180,6,4,10,60.0%,3h
28923,2,[cuak64]ChichaMorada,2524,130,6,4,10,60.0%,1h
28923,2,NexusKing,2524,219,6,8,14,42.9%,52m
28923,2,[LCE]RicardoMilos,2524,143,5,1,6,83.3%,1h
28923,2,dabers,2524,134,5,3,8,62.5%,2h
28923,1,ESPmodern,2524,178,5,9,14,35.7%,50m
28923,2,Dezmond,2524,30,2,1,3,66.7%,2h
28923,3,[J1ZZ]JizzBond,2524,0,2,4,6,33.3%,49m
28923,3,Huppelimummo,2524,0,2,5,7,28.6%,15m
28923,1,nightman,2524,104,2,6,8,25.0%,2h
28923,2,[GEI]HackLord,2524,0,1,0,1,100.0%,52m
28923,1,AntiChroma,2524,0,1,1,2,50.0%,2h
28923,2,CobraFist,2524,0,0,1,1,0.0%,43m
28923,2,Jimmyb,2524,0,0,1,1,0.0%,23m
28951,3,Armagnac,2523,1522,697,690,1387,50.3%,24m
28951,1,Mithrandir,2523,1649,214,212,426,50.2%,2h
28951,2,TUBESTEAK,2523,1346,68,60,128,53.1%,34m
28951,2,wuhanjiayou,2523,1015,66,54,120,55.0%,2h
28951,1,Hagen,2523,534,55,58,113,48.7%,2h
28951,2,yolkedballer,2523,1260,54,42,96,56.2%,52m
28951,2,theviper,2523,1186,50,39,89,56.2%,2h
28951,2,Whytho,2523,791,41,11,52,78.8%,36m
28951,1,ThePylonHoe,2523,1014,39,42,81,48.1%,3h
28951,2,ToxicBacon,2523,511,34,31,65,52.3%,40m
28951,2,[TPGGXD]sebmati,2523,672,33,14,47,70.2%,7m
28951,1,UrsUs,2523,702,28,33,61,45.9%,2h
28951,2,BigBoss,2523,615,27,26,53,50.9%,35m
28951,1,Past,2523,459,18,25,43,41.9%,16m
28951,2,Deeznutz,2523,327,13,8,21,61.9%,46m
28951,2,arturito,2523,380,13,19,32,40.6%,1h
28951,2,ChefDez,2523,299,11,9,20,55.0%,2h
28951,2,SDMatrix,2523,271,10,11,21,47.6%,18m
28951,2,River,2523,276,9,8,17,52.9%,3h
28951,2,[MCPWN]Vindicator,2523,182,8,2,10,80.0%,1h
28951,2,Sedmin,2523,230,8,8,16,50.0%,2h
28951,1,GamenDeaD,2523,203,6,5,11,54.5%,3h
28951,2,italicy,2523,200,6,8,14,42.9%,51m
28951,3,[LunarV]Leastsum,2523,90,6,9,15,40.0%,14m
28951,1,Sound,2523,162,6,9,15,40.0%,2h
28951,1,BlazeFenix,2523,168,4,6,10,40.0%,43m
28951,2,[werf]Otori,2523,108,3,4,7,42.9%,11m
28951,2,LazyTurtle,2523,88,2,0,2,100.0%,36m
28951,2,[STBs54]GuillermoIV,2523,62,2,4,6,33.3%,2h
28951,2,VelvetViper,2523,58,2,5,7,28.6%,37m
28951,1,Amrod,2523,48,2,7,9,22.2%,2h
28951,2,DeathRabbit,2523,0,1,1,2,50.0%,38m
28951,2,FiatLux,2523,0,1,1,2,50.0%,2h
28951,2,JheyssonVII,2523,0,0,1,1,0.0%,2h
28985,2,MFGATRUMP,2522,1430,153,146,299,51.2%,3h
28985,2,[BlTEL]Samdungoy,2522,1578,136,126,262,51.9%,2h
28985,2,[FyHr]Shiomy,2522,842,31,31,62,50.0%,25m
28985,1,InfiniteOdin,2522,712,26,32,58,44.8%,1h
28985,2,DadJoke,2522,423,24,19,43,55.8%,40m
28985,1,Bulby,2522,606,21,29,50,42.0%,7m
28985,2,Mook,2522,492,19,23,42,45.2%,51m
28985,2,[UCF]TitanWarrior,2522,528,18,20,38,47.4%,3m
28985,1,Kawney,2522,367,13,11,24,54.2%,20m
28985,2,[246810]CatThingy,2522,295,13,12,25,52.0%,28m
28985,3,Hudson,2522,312,12,22,34,35.3%,3m
28985,2,FinnLockwood,2522,195,7,4,11,63.6%,22m
28985,2,ZxTArpeTxZ,2522,232,5,6,11,45.5%,35m
28985,2,ColdFire,2522,149,5,7,12,41.7%,11m
28985,1,GoodBanana,2522,0,4,3,7,57.1%,2h
28985,2,Masares,2522,194,4,5,9,44.4%,12m
28985,3,ZerglingRush,2522,34,3,5,8,37.5%,18m
28985,2,Manolito,2522,114,3,5,8,37.5%,2h
28985,2,Fluffhead,2522,90,3,7,10,30.0%,29m
28985,2,Jabbernaut,2522,106,2,1,3,66.7%,2h
28985,1,mgoo,2522,46,2,2,4,50.0%,28m
28985,3,Asheylarry,2522,0,2,4,6,33.3%,2h
28985,3,[cKngz]DarthChase,2522,0,1,0,1,100.0%,2h
28985,2,[77over]ROMANO,2522,0,1,1,2,50.0%,2h
28985,2,skyclad,2522,0,1,1,2,50.0%,3h
28985,2,BANGBANG,2522,88,1,1,2,50.0%,8m
28985,2,[chzbrg]Kaunn,2522,30,1,3,4,25.0%,3h
28985,3,Phronesis,2522,0,1,5,6,16.7%,2h
28985,2,Blinded,2522,0,1,5,6,16.7%,51m
29014,3,KimHill,2521,1514,96,92,188,51.1%,26m
29014,2,HoCeye,2521,1076,69,59,128,53.9%,2h
29014,2,Jockling,2521,1190,62,46,108,57.4%,52m
29014,2,[TrK]Corruptor,2521,1251,56,50,106,52.8%,19m
29014,2,[oRuRo]elboliviano,2521,1175,55,41,96,57.3%,2h
29014,2,[EpicG]ADRURUS,2521,1078,52,34,86,60.5%,2h
29014,2,LachitoKyu,2521,1097,44,37,81,54.3%,1h
29014,3,MirolhoTTS,2521,978,37,41,78,47.4%,3m
29014,2,Braynztorm,2521,898,33,39,72,45.8%,1h
29014,2,INnoJing,2521,724,24,31,55,43.6%,44m
29014,3,Halion,2521,606,21,35,56,37.5%,26m
29014,2,EarthIsACube,2521,443,20,8,28,71.4%,52m
29014,2,Jaihen,2521,443,19,15,34,55.9%,7m
29014,2,[Erik]Lanexoss,2521,232,8,5,13,61.5%,38m
29014,2,Ruckus,2521,244,8,6,14,57.1%,2h
29014,1,[ABorn]BlackSnow,2521,194,7,10,17,41.2%,2h
29014,2,[GOPERÚ]pandafloo,2521,152,5,2,7,71.4%,12m
29014,2,whocanhebe,2521,94,5,3,8,62.5%,2h
29014,2,BlurredLyons,2521,147,5,4,9,55.6%,2h
29014,2,Hawke,2521,172,5,7,12,41.7%,41m
29014,3,HUEngineer,2521,145,4,2,6,66.7%,29m
29014,2,Nerd,2521,162,4,4,8,50.0%,28m
29014,3,Dark,2521,0,3,4,7,42.9%,53m
29014,2,[mator]Lycronos,2521,97,2,4,6,33.3%,16m
29014,2,kyrSpeeder,2521,0,1,0,1,100.0%,2h
29014,3,Nic,2521,0,1,3,4,25.0%,18m
29014,1,JJSpacer,2521,46,1,6,7,14.3%,30m
29014,2,[XpKAc]REVENGE,2521,0,0,3,3,0.0%,3h
29042,2,[NPFR]Lickitac,2520,1423,132,127,259,51.0%,2h
29042,2,Lurker,2520,1535,122,117,239,51.0%,53m
29042,1,Haliaxx,2520,1623,106,102,208,51.0%,3h
29042,2,[AKNewb]camduto,2520,802,67,52,119,56.3%,32m
29042,3,[SICPe]axsnake,2520,201,28,42,70,40.0%,3m
29042,3,LaineyLoses,2520,748,27,40,67,40.3%,6m
29042,2,DirtyBeanz,2520,177,26,25,51,51.0%,7m
29042,1,loko,2520,427,19,15,34,55.9%,2h
29042,1,Druggy,2520,488,18,27,45,40.0%,38m
29042,1,SilenceRiver,2520,285,13,13,26,50.0%,40m
29042,2,eric,2520,275,11,14,25,44.0%,2h
29042,2,NEDDY,2520,344,11,14,25,44.0%,2h
29042,1,Barricade,2520,314,10,10,20,50.0%,52m
29042,2,Lolis,2520,237,9,6,15,60.0%,28m
29042,2,elmems,2520,250,9,6,15,60.0%,3h
29042,2,Adelante,2520,228,8,9,17,47.1%,3h
29042,1,KnightZ,2520,226,8,13,21,38.1%,52m
29042,2,[blmp]gitgudkid,2520,163,5,3,8,62.5%,2h
29042,2,Kaligula,2520,88,4,4,8,50.0%,25m
29042,3,HorizoN,2520,58,3,0,3,100.0%,60m
29042,2,Gabito,2520,58,3,2,5,60.0%,1h
29042,3,ahtahrim,2520,0,3,3,6,50.0%,21m
29042,2,Ryuichimaru,2520,154,3,3,6,50.0%,1m
29042,3,[SmoreO]Ardrith,2520,0,2,3,5,40.0%,31m
29042,3,pier,2520,0,1,0,1,100.0%,2h
29042,2,Tangun,2520,88,1,1,2,50.0%,46m
29042,3,[CRAKS]RaYo,2520,0,1,4,5,20.0%,18m
29042,2,Bacher,2520,0,0,1,1,0.0%,22m
29042,3,ltdizzo,2520,0,0,1,1,0.0%,1m
29042,2,Bustarhymes,2520,0,0,1,1,0.0%,35m
29042,2,[DhZAc1]GoldBR,2520,0,0,1,1,0.0%,34m
29042,2,llllllllllll,2520,0,0,2,2,0.0%,2h
29042,1,[Macac0]xLoro,2520,0,0,5,5,0.0%,2h
29075,2,bigmarv,2519,1616,363,368,731,49.7%,3h
29075,3,Doobz,2519,1401,145,146,291,49.8%,7m
29075,2,OneAndOnlyAB,2519,1068,78,61,139,56.1%,2h
29075,1,Boggs,2519,1653,77,73,150,51.3%,8m
29075,2,Zerkerk,2519,935,76,71,147,51.7%,1h
29075,2,LucasVallles,2519,804,51,51,102,50.0%,2h
29075,2,Kratthul,2519,1108,43,42,85,50.6%,1h
29075,3,TeKkieMastEr,2519,1076,39,49,88,44.3%,30m
29075,1,Lobo,2519,593,20,23,43,46.5%,21m
29075,1,[SBCG]Judson,2519,452,17,23,40,42.5%,3h
29075,2,Rabscuttle,2519,252,8,8,16,50.0%,41m
29075,3,Joputa,2519,211,7,5,12,58.3%,1h
29075,2,KaoticKronos,2519,150,4,3,7,57.1%,48m
29075,2,Roach,2519,100,4,6,10,40.0%,13m
29075,3,LegacyOfVoid,2519,58,3,0,3,100.0%,60m
29075,3,kane,2519,76,3,1,4,75.0%,21m
29075,2,Armando,2519,88,3,4,7,42.9%,2h
29075,2,CptComeback,2519,0,1,0,1,100.0%,12m
29075,3,Kemosabe,2519,30,1,1,2,50.0%,2h
29075,3,[ONG]SuperMico,2519,30,1,1,2,50.0%,2h
29075,2,NakedPsycho,2519,0,0,1,1,0.0%,53m
29075,2,gnolen,2519,0,0,1,1,0.0%,2h
29075,2,hauntedham,2519,0,0,3,3,0.0%,8m
29098,2,[BraziI]Darking,2518,1564,81,69,150,54.0%,3h
29098,3,Khumbu,2518,1383,59,59,118,50.0%,25m
29098,2,gnt,2518,988,36,41,77,46.8%,37m
29098,2,[GØSU]ULIKEIT,2518,414,15,13,28,53.6%,8m
29098,2,[C70]Avisuara,2518,275,14,8,22,63.6%,52m
29098,2,Scootydooter,2518,295,11,7,18,61.1%,10m
29098,1,[DATM]kirito,2518,330,10,17,27,37.0%,2h
29098,1,Barra,2518,266,9,16,25,36.0%,23m
29098,2,Element,2518,180,6,3,9,66.7%,2h
29098,2,iUzername,2518,58,4,5,9,44.4%,2h
29098,1,GhostRippa,2518,0,3,2,5,60.0%,1h
29098,2,AtTheCorner,2518,117,3,2,5,60.0%,16m
29098,2,CROSSFIRE,2518,142,3,3,6,50.0%,3h
29098,2,[GaNaR]hanzu,2518,58,3,3,6,50.0%,12m
29098,3,Vinsico,2518,30,2,0,2,100.0%,2h
29098,2,[asco]Ekrinoch,2518,30,2,2,4,50.0%,3h
29098,2,johnyb,2518,40,1,3,4,25.0%,11m
29098,3,Medulum,2518,0,0,1,1,0.0%,2h
29116,1,Phos,2517,1607,80,80,160,50.0%,41m
29116,3,ElTrapito,2517,970,38,44,82,46.3%,38m
29116,2,[NODANE]Danal,2517,396,14,12,26,53.8%,25m
29116,3,BuCookie,2517,342,13,10,23,56.5%,2h
29116,3,Mayday,2517,194,6,3,9,66.7%,15m
29116,2,astralwraith,2517,141,5,8,13,38.5%,2h
29116,3,ICDx,2517,169,4,4,8,50.0%,37m
29116,2,Destroyer,2517,158,4,5,9,44.4%,1h
29116,2,Crissto,2517,107,4,8,12,33.3%,28m
29116,1,jaiprime,2517,142,4,12,16,25.0%,37m
29116,1,Theboss,2517,0,2,3,5,40.0%,2h
29116,2,NiZmO,2517,0,1,3,4,25.0%,22m
29116,3,ClevrNameSuk,2517,0,0,1,1,0.0%,1h
29129,1,TerminateU,2516,1710,1038,1019,2057,50.5%,1h
29129,1,Wyred,2516,1210,128,119,247,51.8%,2h
29129,3,Keet,2516,1142,76,80,156,48.7%,24m
29129,2,Kyle,2516,1220,56,39,95,58.9%,51m
29129,2,[CULTPi]Darth,2516,739,32,20,52,61.5%,50m
29129,2,afterfpv,2516,200,25,29,54,46.3%,36m
29129,2,[TMU500]MFRax,2516,324,14,15,29,48.3%,54m
29129,2,handsomeeeee,2516,298,11,9,20,55.0%,2h
29129,3,NWI,2516,282,10,8,18,55.6%,2h
29129,2,Killer,2516,274,9,7,16,56.2%,1h
29129,1,Fishnew,2516,100,6,7,13,46.2%,45m
29129,2,profalseidol,2516,208,6,7,13,46.2%,38m
29129,2,[1GFY]TheSnake,2516,140,4,7,11,36.4%,2h
29129,3,Zorn,2516,0,3,2,5,60.0%,28m
29129,3,Tederton,2516,0,3,3,6,50.0%,2h
29129,2,Malthael,2516,92,3,6,9,33.3%,51m
29129,2,ThanosSnap,2516,60,3,6,9,33.3%,3h
29129,3,Matt,2516,97,2,3,5,40.0%,1h
29129,1,Stigma,2516,0,2,3,5,40.0%,2h
29129,2,Borealis,2516,95,2,4,6,33.3%,2h
29129,3,Run,2516,0,1,0,1,100.0%,31m
29129,3,JZforYA,2516,38,1,2,3,33.3%,2h
29129,2,DukeNukem,2516,0,1,5,6,16.7%,3h
29129,3,[CCoRee]CoreSenpai,2516,0,0,1,1,0.0%,10m
29129,2,Anubis,2516,0,0,2,2,0.0%,2h
29129,2,ozuwarudo,2516,0,0,2,2,0.0%,22m
29129,3,zram,2516,0,0,2,2,0.0%,1h
29156,1,datsun,2515,1637,204,203,407,50.1%,1h
29156,1,[REPORT]PwROvRwLmNg,2515,1399,53,55,108,49.1%,33m
29156,3,GAM,2515,830,34,28,62,54.8%,31m
29156,2,SuperNova,2515,627,24,25,49,49.0%,2h
29156,2,Dreed,2515,609,24,25,49,49.0%,25m
29156,1,MiMarido,2515,536,20,18,38,52.6%,33m
29156,3,PoloPAC,2515,526,19,17,36,52.8%,53m
29156,2,Prime,2515,276,14,12,26,53.8%,18m
29156,2,Gravish,2515,324,13,13,26,50.0%,25m
29156,1,Nutek,2515,339,10,14,24,41.7%,2h
29156,3,Cyonent,2515,246,10,16,26,38.5%,7m
29156,2,HappyFeet,2515,298,9,14,23,39.1%,3h
29156,2,[XpKAc]Torosc,2515,216,7,6,13,53.8%,22m
29156,2,[LosWea]Cerok,2515,0,3,3,6,50.0%,2h
29156,2,BigBertho,2515,30,3,5,8,37.5%,3h
29156,3,Crimson,2515,0,1,0,1,100.0%,5m
29156,3,SiRen,2515,0,1,0,1,100.0%,28m
29156,2,KarrinGan,2515,0,1,1,2,50.0%,2h
29156,3,[Xpk]YELSIN,2515,0,0,1,1,0.0%,2h
29156,3,Frostbyrne,2515,0,0,1,1,0.0%,22m
29156,2,nåthan,2515,0,0,1,1,0.0%,1h
29156,3,cinderlord,2515,0,0,5,5,0.0%,2h
29156,2,Boom,2515,0,0,6,6,0.0%,5m
29179,1,[kitflb]lawpoop,2514,1604,121,132,253,47.8%,2h
29179,1,Deldaxer,2514,1447,113,116,229,49.3%,40m
29179,2,Feldspar,2514,1025,45,49,94,47.9%,5m
29179,1,MiloLissn,2514,263,43,44,87,49.4%,2h
29179,2,OMNIPEPPER,2514,830,31,32,63,49.2%,49m
29179,2,FakeAsian,2514,366,15,12,27,55.6%,16m
29179,2,ShameOnYou,2514,243,8,8,16,50.0%,35m
29179,1,WidowMaker,2514,206,8,13,21,38.1%,28m
29179,1,dango,2514,234,5,8,13,38.5%,3h
29179,3,Lucian,2514,114,4,2,6,66.7%,1h
29179,1,Who,2514,48,4,8,12,33.3%,59m
29179,3,[BPM]basketcase,2514,139,4,10,14,28.6%,22m
29179,3,Sydirian,2514,58,3,0,3,100.0%,44m
29179,3,Cutipo,2514,0,0,1,1,0.0%,28m
29179,3,ElvesLie,2514,0,0,1,1,0.0%,2h
29194,3,johhnybill,2513,707,32,12,44,72.7%,31m
29194,3,[CRABBR]MthaFkaJones,2513,737,29,25,54,53.7%,60m
29194,2,[SsaYnS]rin,2513,496,19,17,36,52.8%,22m
29194,2,[Nose02]MrPotato,2513,429,18,12,30,60.0%,2h
29194,3,CCubed,2513,546,18,26,44,40.9%,13m
29194,2,Xeras,2513,402,16,15,31,51.6%,1h
29194,3,[CatImp]Iconicion,2513,349,14,8,22,63.6%,15m
29194,2,Kiostrip,2513,364,13,13,26,50.0%,3h
29194,2,[Rohiov]Rohiov,2513,291,11,7,18,61.1%,1h
29194,3,[OBE]SirCharles,2513,321,11,10,21,52.4%,2h
29194,2,Butlera,2513,243,6,5,11,54.5%,3h
29194,2,[xLDSx]GoodChild,2513,212,6,6,12,50.0%,3h
29194,2,[SDC12]Polêmico,2513,0,4,3,7,57.1%,17m
29194,1,[tCo9]DreamyBudder,2513,68,4,8,12,33.3%,14m
29194,3,Alkaia,2513,60,3,1,4,75.0%,2h
29194,2,Gigabyte,2513,102,3,2,5,60.0%,10m
29194,3,TRUMPWIN,2513,30,3,3,6,50.0%,52m
29194,1,dragojaco,2513,72,3,9,12,25.0%,34m
29194,2,Seifer,2513,46,2,1,3,66.7%,2h
29194,3,NKHIGHLIFE,2513,0,1,0,1,100.0%,15m
29194,2,marceloco,2513,0,1,2,3,33.3%,2h
29194,2,[diaman]DjembZone,2513,0,0,1,1,0.0%,2h
29216,1,Blazemaze,2512,1448,118,126,244,48.4%,10m
29216,2,LayoverS,2512,1564,73,79,152,48.0%,40m
29216,2,TheWill,2512,1093,42,43,85,49.4%,58m
29216,2,Miurem,2512,802,34,35,69,49.3%,2h
29216,2,PeterPan,2512,577,21,20,41,51.2%,3h
29216,2,whiskeyjam,2512,210,16,4,20,80.0%,2h
29216,2,Darkdaley,2512,222,10,8,18,55.6%,38m
29216,2,Solnang,2512,226,9,10,19,47.4%,25m
29216,2,sagnew,2512,244,7,6,13,53.8%,2h
29216,2,Phyberosis,2512,34,6,11,17,35.3%,3h
29216,2,Rydra,2512,125,5,6,11,45.5%,2h
29216,3,bob,2512,94,3,7,10,30.0%,1h
29216,3,Cephiro,2512,30,2,4,6,33.3%,4m
29216,2,Raiback,2512,0,2,4,6,33.3%,3h
29216,3,Kirisey,2512,38,2,6,8,25.0%,25m
29216,3,UrdnotMark,2512,0,1,0,1,100.0%,45m
29216,3,LTCage,2512,30,1,1,2,50.0%,1h
29216,1,Chrizzo,2512,0,1,4,5,20.0%,1h
29216,3,enhancedpain,2512,0,0,1,1,0.0%,46m
29216,3,RandomMan,2512,0,0,1,1,0.0%,2h
29216,3,[JNX]WIZARD,2512,0,0,1,1,0.0%,2h
29216,2,[UpxV]DaeR,2512,0,0,3,3,0.0%,19m
29238,2,Sooperdork,2511,1076,61,43,104,58.7%,18m
29238,2,[SN3KS]andLadders,2511,1046,42,41,83,50.6%,2h
29238,3,caseymuggs,2511,791,32,25,57,56.1%,46m
29238,2,flema,2511,384,13,13,26,50.0%,10m
29238,1,Cronos,2511,255,9,10,19,47.4%,8m
29238,3,UltraLing,2511,205,7,10,17,41.2%,46m
29238,3,Maicke,2511,148,5,5,10,50.0%,15m
29238,2,[CRAKS]DeadHeart,2511,108,5,7,12,41.7%,35m
29238,3,Crazyspx,2511,164,5,7,12,41.7%,54m
29238,1,terz,2511,144,5,7,12,41.7%,2h
29238,3,MarcusVader,2511,93,4,3,7,57.1%,54m
29238,3,[DERRP]jimmychopps,2511,70,4,7,11,36.4%,23m
29238,3,chuchubaba,2511,0,2,4,6,33.3%,1m
29238,2,Aster,2511,30,2,5,7,28.6%,7m
29238,2,CDIO,2511,48,2,8,10,20.0%,1h
29238,2,iSmAeL,2511,30,1,3,4,25.0%,3h
29238,2,GangstrChimp,2511,30,1,5,6,16.7%,2h
29238,2,[YePeS]Hellslol,2511,0,0,2,2,0.0%,10m
29256,2,DanyBhoy,2510,1589,325,333,658,49.4%,16m
29256,2,[PRATAZ]Dengue,2510,802,31,31,62,50.0%,2h
29256,2,AllenIverson,2510,685,27,27,54,50.0%,40m
29256,2,SanAlex,2510,414,17,19,36,47.2%,29m
29256,1,PotatoSalad,2510,268,9,10,19,47.4%,14m
29256,3,GoTime,2510,148,5,4,9,55.6%,2h
29256,3,Koshei,2510,30,5,10,15,33.3%,2h
29256,2,EvilMorty,2510,88,4,3,7,57.1%,2h
29256,1,SkolViking,2510,0,3,2,5,60.0%,2h
29256,3,Bracket,2510,0,3,4,7,42.9%,2h
29256,3,Carmesi,2510,30,2,0,2,100.0%,25m
29256,3,Soul,2510,0,2,2,4,50.0%,3m
29256,3,[Atone]Clothes,2510,0,2,3,5,40.0%,28m
29256,3,Sthebomb,2510,0,2,3,5,40.0%,4m
29256,2,Sour,2510,30,2,3,5,40.0%,49m
29256,2,Catfish,2510,0,2,4,6,33.3%,11m
29256,2,DanielPower,2510,0,2,6,8,25.0%,2h
29256,1,Kronos,2510,0,1,3,4,25.0%,24m
29256,2,[cuak64]Max,2510,93,1,3,4,25.0%,2h
29275,2,YIN,2509,1627,141,138,279,50.5%,35m
29275,3,ErenJay,2509,1468,132,128,260,50.8%,34m
29275,2,swy,2509,1469,73,66,139,52.5%,2h
29275,3,Snaatch,2509,929,73,73,146,50.0%,30m
29275,3,[BNKRZ]TuxedoAnimal,2509,1485,65,47,112,58.0%,52m
29275,2,[859]Burner,2509,308,38,29,67,56.7%,28m
29275,2,Bekrom,2509,747,35,25,60,58.3%,2h
29275,1,Skyline,2509,552,22,25,47,46.8%,35m
29275,2,HatchBack,2509,416,18,20,38,47.4%,36m
29275,1,[Th3Bad]Kyuura,2509,310,17,14,31,54.8%,2h
29275,2,Pragmatist,2509,341,17,22,39,43.6%,8m
29275,2,isocubed,2509,318,11,10,21,52.4%,18m
29275,3,DRACO,2509,207,6,6,12,50.0%,36m
29275,3,paulflan,2509,58,5,3,8,62.5%,21m
29275,2,Zamyk,2509,88,4,5,9,44.4%,2h
29275,2,Pswift,2509,114,2,2,4,50.0%,19m
29275,3,Freezingsoul,2509,0,2,3,5,40.0%,1h
29275,1,Ghostfrog,2509,0,2,3,5,40.0%,1h
29275,3,Eon,2509,0,2,4,6,33.3%,13m
29275,3,Max,2509,0,1,0,1,100.0%,1h
29275,3,HiDef,2509,0,0,1,1,0.0%,9m
29275,3,Neduls,2509,0,0,1,1,0.0%,53m
29275,2,PEPINWARS,2509,0,0,3,3,0.0%,2h
29298,2,uSeTheForce,2508,606,23,27,50,46.0%,28m
29298,2,wolfy,2508,334,19,21,40,47.5%,2h
29298,3,dunkedon,2508,496,19,23,42,45.2%,16m
29298,2,Majic,2508,395,14,8,22,63.6%,2h
29298,1,ETloNfaiRoM,2508,264,11,10,21,52.4%,2h
29298,3,[ctrlF]BalphEubank,2508,260,8,4,12,66.7%,52m
29298,2,MintyFresh,2508,169,4,6,10,40.0%,22m
29298,3,Abdel,2508,0,3,5,8,37.5%,9m
29298,2,BullDragon,2508,30,2,4,6,33.3%,53m
29298,3,primehat,2508,40,1,1,2,50.0%,2h
29298,2,Joebetta,2508,0,1,1,2,50.0%,2h
29298,2,[HoB0]reaperchilli,2508,30,1,3,4,25.0%,34m
29298,2,MrsThrax,2508,30,1,4,5,20.0%,1h
29298,3,CrashCourse,2508,30,1,5,6,16.7%,42m
29298,2,Flickshot,2508,30,1,6,7,14.3%,25m
29298,2,FirmCheeks,2508,0,0,2,2,0.0%,1h
29298,2,[Cryptc]Joba,2508,0,0,2,2,0.0%,34m
29298,2,Kevincap,2508,0,0,2,2,0.0%,46m
29298,2,Phil,2508,0,0,3,3,0.0%,53m
29298,3,RoCkeT,2508,0,0,3,3,0.0%,58m
29318,3,HippieCom,2507,1418,65,42,107,60.7%,2h
29318,2,[neuroS]Duro,2507,956,44,49,93,47.3%,3h
29318,2,ataklos,2507,679,32,15,47,68.1%,58m
29318,2,Pouding,2507,533,18,21,39,46.2%,19m
29318,1,FlutterDank,2507,351,12,10,22,54.5%,2h
29318,2,jnKIN,2507,334,12,16,28,42.9%,7m
29318,1,[xBOZOx]PISSJUGS,2507,319,11,13,24,45.8%,60m
29318,3,LunchBox,2507,232,10,13,23,43.5%,20m
29318,2,Charito,2507,266,10,16,26,38.5%,23m
29318,3,Ankur,2507,189,6,4,10,60.0%,15m
29318,3,Remalaz,2507,145,5,4,9,55.6%,5m
29318,1,[Di0s]spaceHero,2507,0,3,4,7,42.9%,45m
29318,3,BRod,2507,143,3,5,8,37.5%,2h
29318,3,EbkSharkk,2507,96,2,4,6,33.3%,48m
29318,2,[BBE]DukeAres,2507,62,2,6,8,25.0%,2h
29333,1,Ram,2506,1642,160,152,312,51.3%,2h
29333,2,Kashim,2506,1444,55,63,118,46.6%,50m
29333,2,Bakuro,2506,1303,54,50,104,51.9%,18m
29333,2,Gingerbaker,2506,478,44,44,88,50.0%,38m
29333,2,YOLOSWAGTRON,2506,681,28,25,53,52.8%,2h
29333,2,[SWOU]maxpoint,2506,494,20,16,36,55.6%,35m
29333,3,Oberon,2506,250,10,4,14,71.4%,29m
29333,2,ROst,2506,250,8,9,17,47.1%,46m
29333,2,CoolFace,2506,236,8,10,18,44.4%,22m
29333,2,[sBOI]timthebear,2506,168,6,7,13,46.2%,2h
29333,3,breezybeezy,2506,62,4,6,10,40.0%,2h
29333,1,Cous,2506,0,2,3,5,40.0%,1h
29333,3,[OKC]dArchon,2506,0,1,0,1,100.0%,29m
29333,1,laint,2506,0,1,1,2,50.0%,2h
29333,3,Karlthuzad,2506,0,1,3,4,25.0%,21m
29333,1,blackmojo,2506,0,1,4,5,20.0%,2h
29333,3,[DlN0]BANAM,2506,0,0,1,1,0.0%,2h
29333,2,Balzahairius,2506,0,0,2,2,0.0%,3h
29333,3,bumbrundo,2506,0,0,2,2,0.0%,2h
29333,2,PMAMODE,2506,0,0,2,2,0.0%,13m
29353,2,[BzT]NeoDeltaBrun,2505,1192,126,111,237,53.2%,50m
29353,2,Paralax,2505,1586,82,82,164,50.0%,40m
29353,2,YoloDemShots,2505,1562,70,60,130,53.8%,2h
29353,2,RhoCentauri,2505,953,70,70,140,50.0%,2h
29353,3,DpakoN,2505,411,21,9,30,70.0%,38m
29353,3,MysterE,2505,452,18,14,32,56.2%,2h
29353,1,[XpKAc]Eurotruck,2505,102,10,11,21,47.6%,57m
29353,2,Vizzee,2505,141,5,2,7,71.4%,2h
29353,2,[Mrows1]AlienCats,2505,124,4,4,8,50.0%,2h
29353,1,Zaqsaw,2505,141,3,5,8,37.5%,3h
29353,2,Shockolate,2505,34,3,6,9,33.3%,2h
29353,1,Anthony,2505,0,2,2,4,50.0%,2h
29353,3,[AbcCo]RatStyle,2505,60,2,2,4,50.0%,11m
29353,2,Pnuemonia,2505,32,1,6,7,14.3%,50m
29353,3,Barrier,2505,0,0,1,1,0.0%,28m
29353,2,[Efflux]Zergatory,2505,0,0,2,2,0.0%,28m
29353,2,Skynniman,2505,0,0,2,2,0.0%,1h
29370,3,melturBRAIN,2504,746,34,23,57,59.6%,21m
29370,3,toopytants,2504,615,28,37,65,43.1%,40m
29370,2,[Answer]Jameson,2504,486,20,25,45,44.4%,25m
29370,3,BlackOp,2504,389,16,11,27,59.3%,2h
29370,2,BadxMannered,2504,400,14,13,27,51.9%,49m
29370,2,hung,2504,320,11,12,23,47.8%,1h
29370,2,SolDuncan,2504,166,7,5,12,58.3%,23m
29370,2,Scourge,2504,206,7,9,16,43.8%,49m
29370,3,IamCowFearMe,2504,199,7,16,23,30.4%,2h
29370,1,tito,2504,144,5,8,13,38.5%,2h
29370,1,Nozid,2504,90,3,2,5,60.0%,2h
29370,3,Grizzly,2504,30,2,1,3,66.7%,2h
29370,3,[UMCP]Sprintspeed,2504,97,2,2,4,50.0%,28m
29370,2,Muriatic,2504,0,0,2,2,0.0%,51m
29384,2,wafermaker,2503,1514,62,60,122,50.8%,18m
29384,2,GenIrony,2503,1398,53,61,114,46.5%,2m
29384,2,HakaiKousen,2503,479,21,16,37,56.8%,2h
29384,3,ÞøsTScript,2503,535,21,22,43,48.8%,31m
29384,3,CramDigger,2503,444,18,16,34,52.9%,15m
29384,1,[AEVA]Vithar,2503,428,16,14,30,53.3%,2h
29384,2,Parra,2503,352,12,14,26,46.2%,53m
29384,1,[ArmyO2]FenderMan,2503,333,9,17,26,34.6%,1h
29384,3,[BPT]BrokeMonkey,2503,155,6,3,9,66.7%,4m
29384,2,LazerGun,2503,159,5,7,12,41.7%,2h
29384,3,semyon,2503,58,3,1,4,75.0%,36m
29384,2,GeorgeWKush,2503,60,3,3,6,50.0%,1h
29384,3,tofumonster,2503,36,3,4,7,42.9%,6m
29384,2,KernelPanic,2503,88,2,1,3,66.7%,1h
29384,2,Hallelujah,2503,0,1,0,1,100.0%,2h
29384,1,yes,2503,95,1,1,2,50.0%,60m
29384,2,Kit,2503,0,1,1,2,50.0%,2h
29384,1,HerHuchu,2503,0,1,4,5,20.0%,2h
29384,1,Monte,2503,0,1,6,7,14.3%,2h
29384,2,[xMEGAx]AllahIsALie,2503,30,1,14,15,6.7%,49m
29404,3,TARTA,2502,1639,241,235,476,50.6%,2h
29404,2,thatbroc,2502,1542,140,135,275,50.9%,34m
29404,3,Ethan,2502,1029,77,60,137,56.2%,2h
29404,2,especialista,2502,1396,73,70,143,51.0%,3h
29404,1,MasterGallo,2502,877,56,64,120,46.7%,11m
29404,2,SolarCharge,2502,1106,46,41,87,52.9%,50m
29404,3,zinicstorm,2502,201,14,15,29,48.3%,2h
29404,1,Beautone,2502,259,10,12,22,45.5%,2h
29404,2,[ELLOCO]Mayota,2502,244,9,7,16,56.2%,3h
29404,2,JJbiggles,2502,118,5,7,12,41.7%,2h
29404,3,BurritoBaron,2502,0,4,4,8,50.0%,13m
29404,2,AQPDESTROYER,2502,90,4,5,9,44.4%,13m
29404,2,TheChosenOne,2502,90,4,6,10,40.0%,44m
29404,2,Demoniac,2502,62,3,6,9,33.3%,52m
29404,2,RumNCoke,2502,114,2,3,5,40.0%,35m
29404,1,elchucho,2502,0,2,3,5,40.0%,3h
29404,2,FROZENGRAVY,2502,0,1,1,2,50.0%,45m
29404,3,Kow,2502,0,1,1,2,50.0%,2h
29404,1,Enthusedsock,2502,0,1,3,4,25.0%,2h
29404,2,MrLingLing,2502,0,1,5,6,16.7%,2h
29404,1,uFFo,2502,0,0,1,1,0.0%,3h
29404,2,ZEUS,2502,0,0,2,2,0.0%,35m
29404,2,UncleJeff,2502,0,0,3,3,0.0%,13m
29427,3,Darklordkaan,2501,1610,141,116,257,54.9%,2h
29427,1,Enriquheun,2501,1339,88,88,176,50.0%,2h
29427,1,Champs,2501,400,49,50,99,49.5%,3h
29427,3,[SI4yeR]xxxZHITZUxxx,2501,460,17,16,33,51.5%,1h
29427,3,[DASUL]SOLITARIO,2501,266,10,6,16,62.5%,15m
29427,3,astrovan,2501,146,9,4,13,69.2%,2h
29427,2,[SJT]Tristan,2501,204,9,6,15,60.0%,36m
29427,1,ipeepeepoop,2501,213,8,11,19,42.1%,2h
29427,3,Laxdragon,2501,97,4,3,7,57.1%,2h
29427,2,[ExcIgN]piñuflonter,2501,103,3,0,3,100.0%,1h
29427,3,FILHODELOKE,2501,86,3,1,4,75.0%,29m
29427,3,[towor]egrot,2501,60,3,1,4,75.0%,37m
29427,2,SyKoYoshi,2501,70,3,3,6,50.0%,34m
29427,2,usr,2501,77,3,6,9,33.3%,40m
29427,2,DarKudo,2501,96,3,8,11,27.3%,2h
29427,1,Fuze,2501,0,2,3,5,40.0%,2h
29427,2,[NKWY]ThNotkreatur,2501,0,1,1,2,50.0%,35m
29427,2,yourface,2501,0,1,5,6,16.7%,29m
29427,2,[KrAnK]hitmen,2501,0,0,1,1,0.0%,28m
29427,3,Archeantus,2501,0,0,1,1,0.0%,2h
29427,3,[Crip1]furiousfire,2501,0,0,1,1,0.0%,10m
29427,1,Alewpzy,2501,0,0,5,5,0.0%,42m
29449,3,RaumArron,2500,1448,83,85,168,49.4%,32m
29449,2,GARDS,2500,656,24,26,50,48.0%,1h
29449,2,Skwid,2500,346,13,20,33,39.4%,5m
29449,2,Panda,2500,314,12,13,25,48.0%,3h
29449,2,MartyMcFly,2500,248,9,11,20,45.0%,52m
29449,1,Jabrevski,2500,240,9,13,22,40.9%,7m
29449,3,alexinXD,2500,244,6,16,22,27.3%,17m
29449,2,[KingSC]DarkSoul,2500,190,5,6,11,45.5%,5m
29449,3,SoapSum,2500,86,4,1,5,80.0%,1h
29449,3,Rhino,2500,97,2,0,2,100.0%,7m
29449,1,Overkiller,2500,0,2,5,7,28.6%,18m
29449,2,LowPotato,2500,58,2,7,9,22.2%,35m
29449,2,Halfius,2500,0,0,1,1,0.0%,3h
29449,3,Lokrin,2500,0,0,1,1,0.0%,2h
29463,2,KhorneZealot,2499,1595,131,136,267,49.1%,8m
29463,2,Balrog,2499,1597,122,125,247,49.4%,52m
29463,1,UltimoSpagto,2499,1049,38,37,75,50.7%,2h
29463,2,Badger,2499,394,28,20,48,58.3%,7m
29463,2,Delza,2499,415,24,19,43,55.8%,40m
29463,1,arisilvetty,2499,582,20,25,45,44.4%,57m
29463,3,LEX,2499,485,18,8,26,69.2%,1h
29463,2,[gkmode]Mixolidian,2499,370,15,16,31,48.4%,38m
29463,2,muhboi,2499,306,12,16,28,42.9%,37m
29463,2,Raybird,2499,181,10,13,23,43.5%,38m
29463,1,moximo,2499,156,4,2,6,66.7%,3h
29463,3,FireBat,2499,114,4,5,9,44.4%,21m
29463,1,urlose,2499,60,3,8,11,27.3%,37m
29463,2,Sopro,2499,38,2,4,6,33.3%,1h
29463,3,Domminator,2499,30,2,8,10,20.0%,15m
29463,2,ChrisDonDada,2499,0,1,2,3,33.3%,3h
29463,2,[Dazed]Blaznbluntz,2499,30,1,4,5,20.0%,34m
29463,3,XeraphShadow,2499,0,1,4,5,20.0%,25m
29463,3,flame,2499,0,0,1,1,0.0%,28m
29482,2,[TRUIE]JayBoy,2498,1249,47,48,95,49.5%,2h
29482,1,liquidpain,2498,848,32,31,63,50.8%,33m
29482,2,SoaringQuail,2498,392,25,19,44,56.8%,2h
29482,2,proper,2498,508,20,20,40,50.0%,50m
29482,2,Atreides,2498,401,17,9,26,65.4%,5m
29482,2,ThoughtForms,2498,344,14,14,28,50.0%,18m
29482,2,Dropbear,2498,90,6,6,12,50.0%,2h
29482,2,[XpKAc]Diaguita,2498,188,5,6,11,45.5%,52m
29482,2,CrisScience,2498,0,4,2,6,66.7%,23m
29482,3,[jajas]NAIRDA,2498,160,4,3,7,57.1%,52m
29482,2,Scythy,2498,90,3,4,7,42.9%,2h
29482,3,[OndaVT]Xeco,2498,60,2,2,4,50.0%,14m
29482,2,[RLR]Panda,2498,0,2,4,6,33.3%,18m
29482,3,StOnedas,2498,0,1,0,1,100.0%,4m
29482,3,tossomesalad,2498,30,1,2,3,33.3%,29m
29482,2,[Re4Ze]CooLzerO,2498,88,1,2,3,33.3%,3h
29482,3,Nelver,2498,40,1,2,3,33.3%,2h
29482,3,[BeDilf]ComeInHerEye,2498,0,1,4,5,20.0%,2h
29482,2,GeneralPain,2498,0,1,5,6,16.7%,18m
29482,1,Taedict,2498,0,0,1,1,0.0%,58m
29502,1,nexus,2497,837,151,145,296,51.0%,2h
29502,2,jamwheeler,2497,1535,95,82,177,53.7%,24m
29502,2,Cheiseo,2497,1359,74,62,136,54.4%,2h
29502,2,[ØÛ]DarkBeast,2497,374,34,18,52,65.4%,52m
29502,2,Ryan,2497,490,29,26,55,52.7%,49m
29502,1,Jacones,2497,513,20,17,37,54.1%,1h
29502,2,Labryth,2497,536,20,18,38,52.6%,2h
29502,2,Paul,2497,490,18,18,36,50.0%,2h
29502,1,MisterTwinky,2497,477,18,20,38,47.4%,3h
29502,3,Yeshua,2497,453,17,18,35,48.6%,41m
29502,2,Drivionx,2497,101,12,14,26,46.2%,37m
29502,1,silentdeath,2497,243,10,13,23,43.5%,11m
29502,1,CamachoVaca,2497,290,9,18,27,33.3%,3h
29502,2,Jereko,2497,171,7,6,13,53.8%,49m
29502,3,RabidRat,2497,182,7,14,21,33.3%,36m
29502,2,BoeJangles,2497,176,6,8,14,42.9%,38m
29502,3,[MLG69]Peperino,2497,120,4,5,9,44.4%,21m
29502,1,[SC2PH]Akira,2497,46,4,7,11,36.4%,54m
29502,3,PapitasLays,2497,155,3,3,6,50.0%,33m
29502,1,Merfert,2497,100,3,6,9,33.3%,46m
29502,2,[Apug]Rockassist,2497,0,1,0,1,100.0%,2h
29502,2,SgtLazerfox,2497,91,1,3,4,25.0%,51m
29502,2,ryou,2497,0,0,2,2,0.0%,23m
29525,1,[CrUnK]EveNFloW,2496,1511,79,76,155,51.0%,38m
29525,2,[cluez]halfE,2496,822,74,50,124,59.7%,2h
29525,1,Inocensse,2496,671,27,27,54,50.0%,20m
29525,3,Fathertime,2496,465,23,10,33,69.7%,46m
29525,2,Bejned,2496,379,19,9,28,67.9%,54m
29525,1,Entropy,2496,432,14,22,36,38.9%,2h
29525,2,ReJoyce,2496,282,12,5,17,70.6%,11m
29525,1,Sebas,2496,232,10,10,20,50.0%,2h
29525,1,TheSauce,2496,363,10,17,27,37.0%,2h
29525,1,BoBnarley,2496,253,8,13,21,38.1%,3h
29525,3,[SyLx]drmich,2496,250,8,24,32,25.0%,27m
29525,3,Paused,2496,184,7,3,10,70.0%,1m
29525,1,TooniMalo,2496,190,6,16,22,27.3%,40m
29525,3,WALALA,2496,192,5,3,8,62.5%,32m
29525,2,Chris,2496,103,5,7,12,41.7%,2h
29525,1,Lothbrok,2496,154,4,15,19,21.1%,2h
29525,3,JHAZZO,2496,30,2,0,2,100.0%,15m
29525,3,sakura,2496,58,2,2,4,50.0%,2h
29525,1,lolzebra,2496,0,2,3,5,40.0%,56m
29525,3,[DRL]Alitis,2496,0,2,3,5,40.0%,2h
29525,2,CoffeeTurtle,2496,20,2,3,5,40.0%,38m
29525,3,voodoogoats,2496,62,2,11,13,15.4%,31m
29525,3,SgtButtPatch,2496,0,1,0,1,100.0%,47m
29525,2,CaptainRuka,2496,0,1,2,3,33.3%,50m
29525,3,SSdank,2496,0,1,4,5,20.0%,13m
29525,2,soldier,2496,30,1,5,6,16.7%,34m
29525,3,onn,2496,0,0,1,1,0.0%,1h
29552,2,CAPTAINblack,2495,746,26,33,59,44.1%,2h
29552,2,jonrocks,2495,475,21,15,36,58.3%,58m
29552,3,Devils,2495,416,16,12,28,57.1%,2h
29552,3,IrishJohn,2495,370,14,12,26,53.8%,2h
29552,2,Wolfshade,2495,160,5,10,15,33.3%,2h
29552,3,Moridin,2495,138,3,5,8,37.5%,2h
29552,2,RPepez,2495,92,3,8,11,27.3%,17m
29552,1,amom,2495,0,2,3,5,40.0%,3h
29552,1,Rollback,2495,0,2,3,5,40.0%,1h
29552,1,[SCxRH]Dminotaur,2495,0,1,1,2,50.0%,58m
29552,2,iAteUout,2495,34,1,8,9,11.1%,36m
29552,2,[GEI]Rommel,2495,0,0,3,3,0.0%,13m
29552,1,[NCEs]Raycu,2495,0,0,5,5,0.0%,2h
29552,2,ZhuTou,2495,0,0,7,7,0.0%,17m
29566,2,Pablosko,2494,1544,201,173,374,53.7%,35m
29566,2,TNAK,2494,1613,142,135,277,51.3%,2h
29566,3,xzrz,2494,932,40,27,67,59.7%,45m
29566,1,[PY]shpshp,2494,812,39,38,77,50.6%,52m
29566,1,Kaiser,2494,748,32,34,66,48.5%,2h
29566,3,[HSCT]LoafOfStoaf,2494,689,25,27,52,48.1%,60m
29566,1,Jumnag,2494,413,21,15,36,58.3%,53m
29566,2,Alaskanteror,2494,386,15,15,30,50.0%,58m
29566,2,CornrowedCat,2494,424,14,23,37,37.8%,2h
29566,1,Zantiago,2494,246,10,13,23,43.5%,18m
29566,3,saucy,2494,223,9,5,14,64.3%,11m
29566,3,ZERO,2494,194,7,5,12,58.3%,60m
29566,3,Drakkae,2494,178,6,6,12,50.0%,32m
29566,2,matachefcits,2494,88,5,6,11,45.5%,3h
29566,3,KrYpToNiTe,2494,158,4,6,10,40.0%,23m
29566,3,Morpheus,2494,0,3,2,5,60.0%,2h
29566,1,Belthasar,2494,0,2,5,7,28.6%,3h
29566,3,[J3W5]WpkKILLAH,2494,0,1,0,1,100.0%,48m
29566,2,Vile,2494,88,1,3,4,25.0%,50m
29566,2,Coffeecup,2494,30,1,3,4,25.0%,10m
29566,1,Larip,2494,0,0,1,1,0.0%,3h
29566,3,[cluez]coronavirus,2494,0,0,1,1,0.0%,29m
29588,2,Brent,2493,1582,153,144,297,51.5%,30m
29588,1,GrassTree,2493,1602,78,85,163,47.9%,10m
29588,2,[scvpog]Pann,2493,871,35,32,67,52.2%,2h
29588,2,TheLostSoul,2493,581,24,16,40,60.0%,2h
29588,2,[C49]BioCrossX,2493,656,23,28,51,45.1%,25m
29588,1,Crawford,2493,293,12,10,22,54.5%,2h
29588,1,[Cov818]EracDrone,2493,349,10,12,22,45.5%,3h
29588,2,Dang,2493,194,9,17,26,34.6%,28m
29588,1,JoYkiLLaH,2493,189,7,10,17,41.2%,15m
29588,3,[ClanPH]Foxhunter,2493,123,3,5,8,37.5%,1m
29588,1,scare,2493,30,3,5,8,37.5%,3h
29588,3,[Wienie]MrLoaf,2493,0,2,3,5,40.0%,2h
29588,3,ProbablyHyde,2493,95,2,4,6,33.3%,3h
29588,2,CapRato,2493,133,2,4,6,33.3%,2h
29588,3,lIlllIIIll,2493,64,2,13,15,13.3%,1h
29588,2,[QKGC]sezmonsta,2493,0,1,0,1,100.0%,2h
29588,3,Leghtion,2493,0,1,4,5,20.0%,22m
29588,3,Deceptichron,2493,0,0,1,1,0.0%,1h
29588,3,AggroBearHug,2493,0,0,2,2,0.0%,1h
29607,2,Mafiameower,2492,536,50,48,98,51.0%,2h
29607,2,[DE]NoobiusMaxim,2492,1066,42,42,84,50.0%,51m
29607,3,citizensnips,2492,889,38,29,67,56.7%,51m
29607,2,chaos,2492,854,32,32,64,50.0%,25m
29607,3,Trubble,2492,548,26,10,36,72.2%,25m
29607,2,Profesitor,2492,511,19,16,35,54.3%,50m
29607,2,DonTony,2492,394,17,13,30,56.7%,47m
29607,2,[VVPPGG]Fanatic,2492,310,12,11,23,52.2%,28m
29607,1,Nopalium,2492,62,6,4,10,60.0%,50m
29607,2,Empire,2492,133,4,3,7,57.1%,2h
29607,3,[RUD3]Hydropotamus,2492,177,4,7,11,36.4%,3m
29607,2,[d0ngs]InitialR,2492,108,3,5,8,37.5%,1h
29607,3,bobi,2492,121,2,2,4,50.0%,29m
29607,3,Jooniper,2492,0,2,3,5,40.0%,3h
29607,2,Zeratul,2492,0,1,0,1,100.0%,2h
29607,3,Carouj,2492,30,1,1,2,50.0%,2h
29607,3,Hammy,2492,0,1,4,5,20.0%,48m
29607,3,Unrod,2492,0,1,5,6,16.7%,18m
29607,3,Daios,2492,0,0,1,1,0.0%,36m
29607,2,Earthquake,2492,0,0,2,2,0.0%,2h
29607,3,vooz,2492,0,0,2,2,0.0%,10m
29607,1,ARCHSS,2492,0,0,5,5,0.0%,7m
29607,3,SecretSora,2492,0,0,5,5,0.0%,3h
29630,2,Perceptron,2491,714,74,81,155,47.7%,12m
29630,3,Slime,2491,344,44,40,84,52.4%,1h
29630,3,BaldyCron,2491,653,27,16,43,62.8%,51m
29630,3,xxxKIRAxxx,2491,454,17,12,29,58.6%,31m
29630,2,[LY0]ELSULTAN,2491,337,14,10,24,58.3%,2h
29630,3,Rodent,2491,350,14,11,25,56.0%,2h
29630,2,Starking,2491,302,13,10,23,56.5%,2h
29630,3,GameOverAdv,2491,352,13,14,27,48.1%,59m
29630,2,[HMC]StormChaser,2491,220,10,12,22,45.5%,2h
29630,2,WayOfDragon,2491,217,7,8,15,46.7%,3h
29630,2,Tony,2491,222,6,9,15,40.0%,12m
29630,2,[JkSKS]Arcaik,2491,110,5,9,14,35.7%,38m
29630,3,PyroMeerkat,2491,86,4,1,5,80.0%,21m
29630,2,Inaskii,2491,116,4,6,10,40.0%,36m
29630,3,Blank,2491,58,3,1,4,75.0%,3h
29630,3,REVENGE,2491,0,3,2,5,60.0%,2h
29630,3,Diosneed,2491,0,2,5,7,28.6%,53m
29630,2,rammingspeed,2491,70,2,6,8,25.0%,13m
29630,1,[KrAce]Resolve,2491,78,2,11,13,15.4%,1h
29630,3,Stephanus,2491,0,1,0,1,100.0%,46m
29630,2,riskman,2491,0,0,1,1,0.0%,60m
29630,3,PinoyPlayer,2491,0,0,1,1,0.0%,2h
29652,1,Geronimo,2490,1149,111,108,219,50.7%,2h
29652,2,[PaKAr]LocoTetrico,2490,1536,73,50,123,59.3%,2h
29652,1,[Xe1nal]SkyWalker,2490,678,23,31,54,42.6%,35m
29652,1,ChikenNuggy,2490,408,14,15,29,48.3%,2m
29652,2,Prospero,2490,234,8,8,16,50.0%,3h
29652,3,Obsidian,2490,247,8,10,18,44.4%,53m
29652,1,[GEMC]Zongle,2490,225,8,12,20,40.0%,2h
29652,2,[zerg39]DXG,2490,106,5,7,12,41.7%,54m
29652,3,ezkill,2490,144,5,14,19,26.3%,21m
29652,3,[OOCG]sycoticjason,2490,125,3,6,9,33.3%,3m
29652,3,Schwiebs,2490,0,2,4,6,33.3%,18m
29652,3,ERGHEIZ,2490,121,2,4,6,33.3%,13m
29652,3,PhilowPillow,2490,0,2,5,7,28.6%,2h
29652,3,shacuras,2490,0,1,0,1,100.0%,46m
29652,3,[BacBut]BaconMuncher,2490,0,1,1,2,50.0%,1h
29652,3,Zyfer,2490,0,1,4,5,20.0%,2h
29652,1,[0825]Stanley,2490,0,1,4,5,20.0%,1h
29652,2,Arvizo,2490,30,1,5,6,16.7%,58m
29652,3,Cup,2490,0,0,1,1,0.0%,42m
29652,3,Nukem,2490,0,0,1,1,0.0%,3h
29652,3,ZKiller,2490,0,0,1,1,0.0%,53m
29652,3,StarLord,2490,0,0,1,1,0.0%,2h
29652,2,Veggies,2490,0,0,2,2,0.0%,3h
29652,2,[500CC]panmasga,2490,0,0,3,3,0.0%,2h
29676,1,Watchdogs,2489,859,138,128,266,51.9%,2h
29676,2,EpikFrost,2489,1489,78,71,149,52.3%,23m
29676,3,[VFam2]Chieto,2489,912,67,43,110,60.9%,2h
29676,3,[UpeV]Googlebot,2489,1273,52,48,100,52.0%,12m
29676,3,KellyMilkis,2489,775,34,26,60,56.7%,32m
29676,1,BrookzDERP,2489,564,31,31,62,50.0%,21m
29676,3,hds,2489,668,25,25,50,50.0%,45m
29676,2,[Pyr3s]Studley,2489,542,18,19,37,48.6%,11m
29676,2,Chevyman,2489,516,18,20,38,47.4%,50m
29676,2,DAVIDEDU,2489,390,17,11,28,60.7%,13m
29676,2,Rett,2489,332,13,11,24,54.2%,51m
29676,3,[MeS0]MeSoSleepy,2489,191,6,2,8,75.0%,52m
29676,3,NeuroGhost,2489,86,4,1,5,80.0%,16m
29676,2,Basic,2489,138,3,5,8,37.5%,4m
29676,2,[UltraX]CombatWombat,2489,58,2,4,6,33.3%,2h
29676,2,Aiolia,2489,88,1,2,3,33.3%,1h
29676,3,Madenlee,2489,0,0,1,1,0.0%,48m
29676,3,EadG,2489,0,0,2,2,0.0%,2h
29676,2,Dor,2489,0,0,3,3,0.0%,2h
29695,3,TonyStark,2488,1541,104,112,216,48.1%,25m
29695,2,yukiforia,2488,965,74,77,151,49.0%,8m
29695,2,BildoDabbins,2488,600,33,28,61,54.1%,50m
29695,2,[ffaaak]oicfey,2488,774,30,35,65,46.2%,18m
29695,3,Colin,2488,531,24,19,43,55.8%,7m
29695,3,ELCAB,2488,586,22,21,43,51.2%,46m
29695,2,neo,2488,516,20,18,38,52.6%,3h
29695,1,Dragon,2488,327,15,6,21,71.4%,2h
29695,2,hatchet,2488,308,12,17,29,41.4%,3h
29695,1,Veigas,2488,210,7,19,26,26.9%,8m
29695,1,McMogus,2488,148,6,6,12,50.0%,2h
29695,2,ncfalcon,2488,200,6,10,16,37.5%,1h
29695,1,[BnKers]Candlesmith,2488,143,5,8,13,38.5%,8m
29695,2,hashtagFour,2488,152,4,5,9,44.4%,3h
29695,3,MRaynor,2488,86,3,2,5,60.0%,36m
29695,2,Aidenjai,2488,0,3,6,9,33.3%,3h
29695,3,paladindk,2488,97,2,0,2,100.0%,24m
29695,3,gandolf,2488,58,2,2,4,50.0%,2h
29695,2,Dementor,2488,0,2,4,6,33.3%,2h
29695,1,bomberman,2488,48,2,4,6,33.3%,1h
29695,2,[WTNRCL]DomZack,2488,0,2,4,6,33.3%,23m
29695,3,[WEABS]Sans,2488,0,1,0,1,100.0%,1h
29695,2,Saucymuffin,2488,0,1,1,2,50.0%,2h
29695,2,ByunsUncle,2488,32,1,6,7,14.3%,2h
29695,3,Shalerson,2488,0,0,2,2,0.0%,1h
29695,2,[cluez]DMAN,2488,0,0,3,3,0.0%,60m
29695,3,[eX]FnX,2488,0,0,5,5,0.0%,52m
29722,1,[Dibbz]Soundwave,2487,1609,158,148,306,51.6%,44m
29722,2,Heisenberg,2487,1182,51,39,90,56.7%,52m
29722,2,[LETAL]Amón,2487,769,39,33,72,54.2%,55m
29722,1,Zerovelocity,2487,948,36,39,75,48.0%,2h
29722,1,fattyloser,2487,849,33,32,65,50.8%,33m
29722,2,[xSzn]EILIGH,2487,248,31,26,57,54.4%,3h
29722,3,VIPER,2487,486,20,9,29,69.0%,1h
29722,3,JoeBlow,2487,390,14,10,24,58.3%,2h
29722,2,[R15E]judgment,2487,368,13,12,25,52.0%,55m
29722,2,[SC2B]FunkiDunki,2487,330,12,16,28,42.9%,53m
29722,2,[Key]Key,2487,204,8,6,14,57.1%,2h
29722,2,Dogman,2487,216,7,11,18,38.9%,25m
29722,3,georden,2487,213,6,2,8,75.0%,1m
29722,2,AlreadyDead,2487,190,6,8,14,42.9%,2h
29722,3,Thaimin,2487,0,3,2,5,60.0%,2h
29722,2,MrChipmunk,2487,30,3,5,8,37.5%,1h
29722,2,RandALthor,2487,30,2,2,4,50.0%,2h
29722,3,Gunslinger,2487,0,2,4,6,33.3%,2h
29722,1,Guacusio,2487,48,2,4,6,33.3%,2h
29722,2,MicroJackson,2487,30,2,6,8,25.0%,3h
29722,3,tarkoravman,2487,0,1,3,4,25.0%,2h
29722,2,ArthurDent,2487,30,1,6,7,14.3%,8m
29722,1,TEKmaster,2487,0,0,2,2,0.0%,1h
29722,2,ChingonX,2487,0,0,4,4,0.0%,1h
29746,2,seaone,2486,1579,216,200,416,51.9%,51m
29746,2,Allagash,2486,964,115,109,224,51.3%,3h
29746,1,zeppelink,2486,1514,113,123,236,47.9%,2h
29746,3,[5up3r]Mario,2486,1544,87,105,192,45.3%,28m
29746,1,Splattz,2486,1438,66,69,135,48.9%,28m
29746,2,[2ht2hl]tohottohandl,2486,809,62,60,122,50.8%,2h
29746,3,stallion,2486,1198,58,51,109,53.2%,53m
29746,2,Onlihuman,2486,781,55,42,97,56.7%,36m
29746,3,Wang,2486,1054,51,46,97,52.6%,46m
29746,2,Frostytatas,2486,544,18,26,44,40.9%,1h
29746,3,Speco,2486,390,17,9,26,65.4%,9m
29746,3,PiterFuentes,2486,380,15,10,25,60.0%,2h
29746,2,Jenclode,2486,278,15,20,35,42.9%,37m
29746,2,Blahsmack,2486,116,4,4,8,50.0%,40m
29746,3,ToweringHrzn,2486,0,3,2,5,60.0%,36m
29746,3,MagistratePH,2486,0,1,0,1,100.0%,22m
29746,2,[Atira]Nutrino,2486,88,1,3,4,25.0%,2h
29746,3,Jayizzles,2486,34,1,3,4,25.0%,2h
29746,3,Kytsug,2486,90,1,4,5,20.0%,46m
29746,1,Azazel,2486,0,1,4,5,20.0%,25m
29746,2,Whocares,2486,46,1,6,7,14.3%,11m
29746,3,Cornholio,2486,0,0,1,1,0.0%,3h
29768,3,alvarock,2485,1288,77,63,140,55.0%,2h
29768,2,Tommy,2485,500,45,46,91,49.5%,47m
29768,3,ScrewDriver,2485,742,36,26,62,58.1%,48m
29768,2,nono,2485,878,31,34,65,47.7%,40m
29768,3,[AZPK]Swankypants,2485,568,23,15,38,60.5%,53m
29768,3,Starkiller,2485,464,18,28,46,39.1%,1m
29768,2,[hz21]hectorcito,2485,262,11,13,24,45.8%,51m
29768,2,Clutch,2485,141,10,9,19,52.6%,2h
29768,1,icyrail,2485,234,9,12,21,42.9%,2h
29768,2,[IPCSI]Carmesino,2485,218,5,8,13,38.5%,50m
29768,3,HeavenBlue,2485,147,4,1,5,80.0%,2h
29768,3,Amanita,2485,146,4,6,10,40.0%,2h
29768,3,CrapAss,2485,58,3,1,4,75.0%,44m
29768,2,[EzyPzY]raydo,2485,88,3,4,7,42.9%,3h
29768,1,[SCxRH]TylerJohnson,2485,90,3,5,8,37.5%,60m
29768,2,HuiTaiLang,2485,122,3,6,9,33.3%,51m
29768,3,monku,2485,0,2,3,5,40.0%,2m
29768,2,[BoAVN]CCnight,2485,0,1,0,1,100.0%,1h
29768,3,[Boboyz]spacerandy,2485,0,1,0,1,100.0%,3h
29768,3,CannonRushed,2485,30,1,1,2,50.0%,3h
29768,2,Karen,2485,0,1,2,3,33.3%,20m
29768,2,Bowser,2485,38,1,4,5,20.0%,49m
29790,1,Sherman,2484,1174,112,104,216,51.9%,40m
29790,3,BIGBUDZ,2484,1541,86,73,159,54.1%,22m
29790,2,LikeAToss,2484,973,44,37,81,54.3%,2h
29790,3,LowKee,2484,606,26,22,48,54.2%,37m
29790,3,[LwF]Phylactery,2484,282,13,10,23,56.5%,2h
29790,2,xLilHotGirlx,2484,334,13,14,27,48.1%,18m
29790,2,LuckyPhoenix,2484,204,10,14,24,41.7%,26m
29790,1,Averie,2484,149,6,9,15,40.0%,40m
29790,1,StuffedGuy,2484,88,4,5,9,44.4%,18m
29790,2,sidmeier,2484,140,4,5,9,44.4%,3h
29790,2,Weedwick,2484,162,4,8,12,33.3%,1h
29790,3,Prieserk,2484,145,3,2,5,60.0%,2h
29790,3,lukeepewpew,2484,86,3,2,5,60.0%,2h
29790,2,[LolN]MrLongLeng,2484,90,3,8,11,27.3%,37m
29790,3,ryywhit,2484,121,2,2,4,50.0%,3m
29790,1,[DOSR]Oneil,2484,32,2,3,5,40.0%,46m
29790,1,Kerrigan,2484,0,2,3,5,40.0%,2h
29790,3,Stankalank,2484,0,2,5,7,28.6%,16m
29790,3,[GDPx]oPkongasaur,2484,0,1,0,1,100.0%,53m
29790,3,OrbitalSun,2484,0,1,0,1,100.0%,3h
29790,3,[SCboys]Flyinghorse,2484,0,1,0,1,100.0%,1m
29790,3,EmsteR,2484,0,1,0,1,100.0%,1h
29790,2,[BQSS]Abuj,2484,0,0,3,3,0.0%,11m
29813,2,zhaizhouzhou,2483,1543,195,190,385,50.6%,55m
29813,1,Konan,2483,1483,189,195,384,49.2%,3h
29813,2,gamergirl,2483,1565,92,74,166,55.4%,18m
29813,1,MRSUN,2483,872,37,37,74,50.0%,35m
29813,2,[DToS]spcmonk,2483,716,31,31,62,50.0%,2h
29813,1,pmbpanther,2483,392,14,19,33,42.4%,3h
29813,2,Jenga,2483,330,11,21,32,34.4%,2h
29813,3,SATURNOvO,2483,223,9,4,13,69.2%,32m
29813,3,Nzeee,2483,30,6,1,7,85.7%,46m
29813,3,[DSGs]Roquefort,2483,171,5,6,11,45.5%,45m
29813,2,[Carton]elmamao,2483,76,4,5,9,44.4%,2h
29813,2,Sleepbringer,2483,88,3,3,6,50.0%,10m
29813,2,HoboBagless,2483,60,3,4,7,42.9%,18m
29813,3,MDLuffy,2483,30,2,2,4,50.0%,9m
29813,1,ImmaGhost,2483,0,2,5,7,28.6%,17m
29813,2,IkarosRT,2483,30,1,7,8,12.5%,51m
29813,3,weedlock,2483,0,0,1,1,0.0%,1h
29813,2,JOHANrc,2483,0,0,5,5,0.0%,8m
29831,2,KMU,2482,1543,175,162,337,51.9%,2h
29831,1,SenArrow,2482,1522,92,86,178,51.7%,2h
29831,2,MorningStar,2482,1259,80,76,156,51.3%,3h
29831,2,GABO,2482,1434,67,65,132,50.8%,1h
29831,3,Angryjek,2482,722,49,38,87,56.3%,21m
29831,2,Drosras,2482,563,39,35,74,52.7%,8m
29831,3,ArmorPortal,2482,887,36,54,90,40.0%,24m
29831,2,[NDEAHH]JeanPiero,2482,611,35,24,59,59.3%,2h
29831,2,blackparade,2482,610,25,27,52,48.1%,18m
29831,3,Soap,2482,448,15,15,30,50.0%,2h
29831,3,starkilla,2482,352,14,7,21,66.7%,48m
29831,1,theprobe,2482,382,14,17,31,45.2%,2h
29831,2,DaftGemini,2482,332,11,11,22,50.0%,3h
29831,3,[TheRs]powerful,2482,118,8,9,17,47.1%,31m
29831,1,IIllIlIIlIII,2482,171,5,8,13,38.5%,60m
29831,3,Doxal,2482,58,3,2,5,60.0%,1m
29831,2,supnice,2482,120,2,4,6,33.3%,2h
29831,2,SuperMan,2482,62,2,5,7,28.6%,36m
29831,3,FFlareon,2482,0,1,1,2,50.0%,2h
29831,2,[TPGGXD]OMEGA,2482,0,1,2,3,33.3%,2h
29831,3,sco,2482,0,0,1,1,0.0%,39m
29852,2,Profyt,2481,1282,246,251,497,49.5%,23m
29852,1,[Drakes]fturpin,2481,1054,94,81,175,53.7%,25m
29852,1,coldischarge,2481,1608,79,82,161,49.1%,20m
29852,3,svlum,2481,1560,63,57,120,52.5%,3h
29852,1,ROGUITE,2481,1170,61,57,118,51.7%,13m
29852,2,Cirquee,2481,311,40,34,74,54.1%,13m
29852,2,jaf,2481,810,35,37,72,48.6%,50m
29852,2,SudsNBubbles,2481,482,16,17,33,48.5%,12m
29852,3,Cashicoi,2481,428,14,26,40,35.0%,28m
29852,3,Brannigan,2481,342,13,10,23,56.5%,10m
29852,3,roupstrer,2481,178,7,5,12,58.3%,1h
29852,1,[AIRBAG]speedplay,2481,156,6,12,18,33.3%,2h
29852,3,TheDogman,2481,0,3,3,6,50.0%,1h
29852,3,Purple,2481,0,2,2,4,50.0%,52m
29852,3,Deuterium,2481,0,2,4,6,33.3%,2h
29852,3,PewPewPew,2481,0,2,4,6,33.3%,3h
29852,2,GoldK,2481,0,1,4,5,20.0%,3h
29852,3,[xDYEx]raynger,2481,0,0,1,1,0.0%,15m
29852,2,MorbiLudio,2481,0,0,1,1,0.0%,2h
29871,3,Yves,2480,1271,281,271,552,50.9%,17m
29871,1,Bous,2480,1363,260,265,525,49.5%,3h
29871,2,Zillah,2480,857,207,183,390,53.1%,8m
29871,2,Vetis,2480,994,35,41,76,46.1%,38m
29871,3,Nythe,2480,788,30,34,64,46.9%,4m
29871,2,Espoir,2480,760,29,27,56,51.8%,20m
29871,2,Shub,2480,86,5,7,12,41.7%,1h
29871,3,night,2480,119,3,1,4,75.0%,2h
29871,3,PandaStorm,2480,0,2,4,6,33.3%,18m
29871,2,THEBoNeCrAcK,2480,60,2,8,10,20.0%,10m
29871,2,Tempest,2480,92,1,4,5,20.0%,3h
29871,3,[C4NN0N]JeffBob,2480,0,1,4,5,20.0%,46m
29871,3,Tvtyrant,2480,0,0,1,1,0.0%,2h
29871,3,DonnieNarko,2480,0,0,1,1,0.0%,2h
29885,2,boodybandit,2479,1195,52,47,99,52.5%,2h
29885,2,CDONE,2479,1326,51,56,107,47.7%,8m
29885,2,peluche,2479,463,28,23,51,54.9%,36m
29885,3,[VRGA]RamonShatter,2479,605,24,14,38,63.2%,2h
29885,1,RaZeD,2479,498,23,34,57,40.4%,1h
29885,1,[PWands]Dusa,2479,324,15,12,27,55.6%,34m
29885,2,Mike,2479,335,14,7,21,66.7%,52m
29885,3,BestiaNegra,2479,248,8,8,16,50.0%,2h
29885,3,[ProW]AtomicWaffle,2479,116,5,4,9,55.6%,3h
29885,3,Sand,2479,86,3,1,4,75.0%,1h
29885,3,william,2479,58,3,1,4,75.0%,15m
29885,3,LuGnUtSC,2479,0,3,3,6,50.0%,2h
29885,3,Guts,2479,113,3,4,7,42.9%,25m
29885,2,Brad,2479,30,3,6,9,33.3%,1h
29885,3,Ednato,2479,123,3,6,9,33.3%,15m
29885,3,Qwerty,2479,96,2,4,6,33.3%,2h
29885,3,CALLmePiECE,2479,0,2,5,7,28.6%,2h
29885,3,Quemarco,2479,30,1,2,3,33.3%,46m
29885,3,[Chro]moralda,2479,0,1,4,5,20.0%,4m
29885,3,WarsToComeII,2479,0,0,1,1,0.0%,1h
29885,2,RobTenken,2479,0,0,3,3,0.0%,2h
29906,2,Heist,2478,817,35,36,71,49.3%,40m
29906,2,Sputnick,2478,575,23,21,44,52.3%,8m
29906,2,NemV,2478,432,17,17,34,50.0%,1h
29906,3,Lozark,2478,211,7,1,8,87.5%,36m
29906,3,bobcat,2478,145,7,3,10,70.0%,2h
29906,2,zebidy,2478,202,7,10,17,41.2%,52m
29906,2,thregg,2478,227,6,7,13,46.2%,60m
29906,1,DanielR,2478,185,6,11,17,35.3%,1h
29906,3,Minato,2478,113,4,8,12,33.3%,16m
29906,2,PittbullVzla,2478,122,4,9,13,30.8%,1h
29906,1,DBullet,2478,88,3,6,9,33.3%,2h
29906,2,Delta,2478,0,3,6,9,33.3%,2h
29906,2,fonetic,2478,42,2,1,3,66.7%,28m
29906,3,SERRALNO,2478,0,2,4,6,33.3%,2h
29906,3,[Azocur]Louhyzt,2478,0,1,0,1,100.0%,28m
29906,3,[NM8]AJHammock,2478,0,1,0,1,100.0%,2h
29906,3,Who,2478,0,0,1,1,0.0%,5m
29906,2,DoughbEE,2478,0,0,2,2,0.0%,18m
29906,3,[CeNori]Ultima,2478,0,0,5,5,0.0%,2h
29925,1,eggmalone,2477,1676,244,235,479,50.9%,50m
29925,2,tazadar,2477,1503,93,74,167,55.7%,2h
29925,1,[MaxWin]tychoon,2477,1261,48,55,103,46.6%,38m
29925,2,[MJT]Kerberos,2477,933,41,35,76,53.9%,3h
29925,2,RIDZ,2477,877,36,34,70,51.4%,3h
29925,3,Nutpot,2477,826,35,27,62,56.5%,2h
29925,3,NegativeZero,2477,865,33,31,64,51.6%,2h
29925,2,tshot,2477,546,19,24,43,44.2%,34m
29925,3,glhf,2477,482,18,14,32,56.2%,11m
29925,3,[DarkAG]Blitzed,2477,266,12,18,30,40.0%,21m
29925,2,verge,2477,232,8,14,22,36.4%,52m
29925,3,DireRaven,2477,170,7,3,10,70.0%,46m
29925,3,[Cyc8]taterthot,2477,170,7,4,11,63.6%,2h
29925,1,Rose,2477,108,7,8,15,46.7%,3h
29925,3,DanielBoon,2477,114,5,1,6,83.3%,1h
29925,3,Kishkumen,2477,121,5,3,8,62.5%,2h
29925,3,LethargicLan,2477,140,5,4,9,55.6%,2h
29925,2,TheCarlosMan,2477,144,4,4,8,50.0%,1h
29925,2,[IiUiI]demon,2477,114,2,1,3,66.7%,39m
29925,3,[FENC]DrgonCN,2477,0,1,0,1,100.0%,1h
29925,3,Yukes,2477,0,1,1,2,50.0%,2h
29925,3,[XFCE]Sebarine,2477,0,1,4,5,20.0%,1h
29925,1,Lazypanda,2477,0,1,4,5,20.0%,1h
29925,3,ThufirHawat,2477,0,0,1,1,0.0%,36m
29925,3,[KhanZ]Helios,2477,0,0,1,1,0.0%,2h
29950,3,Zombietronic,2476,912,37,28,65,56.9%,16m
29950,3,[JUGOS]Mangas,2476,598,34,31,65,52.3%,2h
29950,2,ACUARIO,2476,777,30,34,64,46.9%,40m
29950,3,pasapam,2476,377,16,15,31,51.6%,2h
29950,2,[mtrsdg]Smakweiler,2476,120,10,15,25,40.0%,48m
29950,1,Alouette,2476,311,10,16,26,38.5%,1h
29950,3,Toten,2476,212,7,9,16,43.8%,14m
29950,3,VoyagerZ,2476,178,6,1,7,85.7%,2h
29950,3,INFINITYPAIN,2476,106,6,6,12,50.0%,2h
29950,3,SGTbOBsAGeT,2476,150,4,6,10,40.0%,2h
29950,1,Fletcher,2476,146,3,6,9,33.3%,20m
29950,1,Blade,2476,80,3,12,15,20.0%,53m
29950,3,JJJ,2476,60,2,3,5,40.0%,2h
29950,2,PSyCongroo,2476,0,2,4,6,33.3%,2h
29950,3,Spiraling,2476,0,1,0,1,100.0%,2h
29950,3,Zeah,2476,0,1,5,6,16.7%,3h
29950,2,[JM2]Jin,2476,0,0,1,1,0.0%,53m
29967,1,[syrup]DarkSkon,2475,1305,123,123,246,50.0%,33m
29967,2,HandsomeMonk,2475,813,78,67,145,53.8%,34m
29967,1,ElWeirdo,2475,775,50,55,105,47.6%,38m
29967,3,[Damasc]Azulito,2475,1043,45,45,90,50.0%,1h
29967,2,IIIIIIIIIIII,2475,691,30,26,56,53.6%,6m
29967,3,ropzfan,2475,477,20,14,34,58.8%,2h
29967,3,Motavenger,2475,395,15,8,23,65.2%,1h
29967,2,soHigh,2475,383,14,18,32,43.8%,2h
29967,2,[Atone]Dadbod,2475,334,13,13,26,50.0%,50m
29967,3,LabToast,2475,224,12,11,23,52.2%,46m
29967,3,Tommo,2475,80,5,6,11,45.5%,53m
29967,3,Stig,2475,0,2,3,5,40.0%,12m
29967,3,Dandord,2475,97,2,5,7,28.6%,2h
29967,1,Braulini,2475,0,2,5,7,28.6%,3h
29967,1,[NANIMO]Sasha,2475,0,1,0,1,100.0%,2h
29967,3,[RNGsus]Rdino,2475,0,1,3,4,25.0%,2m
29967,1,KingMarine,2475,48,1,6,7,14.3%,3h
29967,3,[DXPCA]Grraywarrior,2475,0,0,1,1,0.0%,2h
29967,3,Lwang,2475,0,0,1,1,0.0%,3h
29986,2,Marcana,2474,1578,116,114,230,50.4%,2h
29986,2,bungus,2474,995,57,61,118,48.3%,50m
29986,2,Fodder,2474,1100,54,55,109,49.5%,2h
29986,1,DELETED,2474,469,29,33,62,46.8%,1h
29986,2,FlynHwn,2474,514,26,27,53,49.1%,8m
29986,2,Omelette,2474,526,20,21,41,48.8%,34m
29986,3,VisibleIvan,2474,461,19,14,33,57.6%,52m
29986,2,PAVE,2474,426,17,20,37,45.9%,8m
29986,3,Draghuun,2474,256,7,11,18,38.9%,21m
29986,2,blueballed,2474,184,6,13,19,31.6%,3m
29986,3,[MBS209]TheRealMvP,2474,58,3,1,4,75.0%,15m
29986,2,xBiznitch,2474,88,3,6,9,33.3%,3h
29986,3,veglia,2474,30,2,0,2,100.0%,1h
29986,1,KillaCajun,2474,0,2,3,5,40.0%,1h
29986,1,Meow,2474,84,2,3,5,40.0%,1h
29986,3,[Fum3s]SevenOut,2474,96,2,4,6,33.3%,2h
29986,2,Heresy,2474,26,2,6,8,25.0%,2h
29986,2,MolEMan,2474,0,1,2,3,33.3%,2h
29986,3,Peebers,2474,0,1,4,5,20.0%,2h
29986,3,TURBOJUSTICE,2474,0,0,1,1,0.0%,36m
29986,3,[FAKUU]Molicopter,2474,0,0,1,1,0.0%,28m
29986,3,Zep,2474,0,0,3,3,0.0%,3h
30008,2,TenaC,2473,1463,149,145,294,50.7%,2h
30008,1,PROTOSAURUS,2473,1367,103,101,204,50.5%,38m
30008,2,baddude,2473,1358,53,50,103,51.5%,2h
30008,1,ZarbAzb,2473,336,29,36,65,44.6%,44m
30008,2,JIM,2473,467,18,15,33,54.5%,22m
30008,1,Marty,2473,446,16,17,33,48.5%,14m
30008,1,yangyang,2473,369,15,19,34,44.1%,3h
30008,2,Cenar,2473,324,10,18,28,35.7%,2h
30008,2,oli,2473,206,9,10,19,47.4%,52m
30008,2,DNR,2473,280,8,11,19,42.1%,53m
30008,1,[ffaaak]raven,2473,156,8,17,25,32.0%,2h
30008,2,DragonShadow,2473,134,5,9,14,35.7%,53m
30008,2,Resonance,2473,131,4,6,10,40.0%,3h
30008,3,GhostSmoke,2473,139,3,4,7,42.9%,1h
30008,3,Zebra,2473,93,3,6,9,33.3%,13m
30008,3,balduvian,2473,126,3,6,9,33.3%,2h
30008,2,[WEABS]darkdeimos,2473,43,3,7,10,30.0%,8m
30008,3,Joasab,2473,96,2,2,4,50.0%,2h
30008,3,moadib,2473,58,2,3,5,40.0%,3h
30008,1,iParnRequiem,2473,0,2,3,5,40.0%,2h
30008,1,Joshie,2473,48,2,4,6,33.3%,1h
30008,1,Demonwings,2473,0,2,5,7,28.6%,41m
30008,2,Lambshaker,2473,0,1,0,1,100.0%,53m
30008,2,[Vxi]Omni,2473,0,1,2,3,33.3%,20m
30008,3,Fabrebel,2473,0,1,2,3,33.3%,2h
30008,2,Jezus,2473,95,1,3,4,25.0%,24m
30008,3,NotPostal,2473,0,0,1,1,0.0%,2h
30008,3,MRDRMUFN,2473,0,0,2,2,0.0%,3m
30008,3,[Altf5]WolfBlack,2473,0,0,2,2,0.0%,1h
30037,2,Mordent,2472,1436,77,76,153,50.3%,37m
30037,1,[BUM69]JimiPump,2472,730,65,71,136,47.8%,8m
30037,2,AstroWizard,2472,831,46,36,82,56.1%,50m
30037,2,PeePeePooPoo,2472,578,38,39,77,49.4%,1h
30037,3,[LOHs]RdmFlyingCow,2472,597,29,26,55,52.7%,16m
30037,2,[ACreed]Sidodah,2472,445,25,29,54,46.3%,1h
30037,3,DaveyJoans,2472,605,24,14,38,63.2%,2h
30037,3,[ValidG]SeVeN,2472,522,18,23,41,43.9%,37m
30037,2,[WW1]BattleByrn,2472,415,17,14,31,54.8%,2h
30037,3,SuperMamani,2472,336,16,6,22,72.7%,2h
30037,3,[4poc]Evincar,2472,366,15,12,27,55.6%,36m
30037,1,swtch,2472,284,10,12,22,45.5%,4m
30037,3,Chocolate,2472,121,6,2,8,75.0%,2h
30037,2,Spleer,2472,142,5,9,14,35.7%,2h
30037,3,Lunatic,2472,159,4,6,10,40.0%,45m
30037,1,illwin,2472,97,4,8,12,33.3%,17m
30037,2,[TTSP]UrLastSight,2472,90,4,8,12,33.3%,40m
30037,2,[TeamEz]WarriorBoy,2472,30,3,5,8,37.5%,3h
30037,2,iota,2472,60,3,7,10,30.0%,2h
30037,3,Shinyy,2472,0,2,3,5,40.0%,2h
30037,3,[NwAs]SandiaYLimon,2472,0,1,0,1,100.0%,1h
30037,2,ChunkyBroc,2472,0,1,2,3,33.3%,2h
30037,3,ZERG,2472,0,1,4,5,20.0%,3h
30037,3,Boyka,2472,0,0,1,1,0.0%,16m
30037,3,[RDQ]Rambo,2472,0,0,2,2,0.0%,1h
30037,3,DOG,2472,0,0,2,2,0.0%,29m
30037,3,[S1MPZ]Gin,2472,0,0,2,2,0.0%,3h
30064,2,[CumKz]Mars,2471,930,40,36,76,52.6%,52m
30064,2,Josh,2471,908,33,35,68,48.5%,1h
30064,3,rudejohn,2471,830,31,32,63,49.2%,16m
30064,2,Darkshados,2471,626,25,22,47,53.2%,20m
30064,3,richyqtqt,2471,464,20,13,33,60.6%,1h
30064,3,[Onixx]ICU,2471,385,15,7,22,68.2%,2h
30064,3,Ghost,2471,354,15,12,27,55.6%,2h
30064,1,[Nitho]TheThisTroye,2471,197,7,4,11,63.6%,3h
30064,2,noone,2471,181,6,8,14,42.9%,1h
30064,2,[PHAX]KalasuTengu,2471,151,5,6,11,45.5%,32m
30064,2,[ExiSto]Viago,2471,157,5,6,11,45.5%,8m
30064,2,[SPLUJE]stick,2471,120,5,7,12,41.7%,52m
30064,2,[FL1P]GeneralTedd,2471,182,5,7,12,41.7%,2h
30064,2,Othurion,2471,0,1,0,1,100.0%,3h
30064,2,TylerP,2471,0,1,0,1,100.0%,2h
30064,2,Ryanest,2471,0,1,2,3,33.3%,11m
30064,1,DaftMind,2471,0,1,4,5,20.0%,1h
30064,1,[FSCN]JUMATTO,2471,0,0,1,1,0.0%,31m
30064,3,Kimchiman,2471,0,0,2,2,0.0%,2h
30083,1,augmetal,2470,1470,307,288,595,51.6%,43m
30083,3,[5TEN]Hannah,2470,1626,255,226,481,53.0%,12m
30083,2,VladTepes,2470,818,37,57,94,39.4%,35m
30083,2,kam,2470,757,32,34,66,48.5%,39m
30083,2,TuéTué,2470,795,30,34,64,46.9%,40m
30083,2,[3ADC]DOM,2470,552,19,19,38,50.0%,34m
30083,2,[CoNeZ]theboke,2470,188,10,16,26,38.5%,13m
30083,3,Babyface,2470,213,7,1,8,87.5%,45m
30083,2,cell,2470,143,6,6,12,50.0%,3h
30083,3,shtdik,2470,162,5,1,6,83.3%,1h
30083,3,BTSJimin,2470,0,4,2,6,66.7%,53m
30083,2,Enderfox,2470,38,2,1,3,66.7%,2h
30083,3,makcre,2470,60,2,4,6,33.3%,1h
30083,3,[SANGRE]Arcangel,2470,0,1,0,1,100.0%,2h
30083,2,Jlpk,2470,93,1,2,3,33.3%,1m
30083,2,ZergZong,2470,0,1,3,4,25.0%,3h
30083,3,BigTiddieElf,2470,30,1,4,5,20.0%,2h
30083,1,Audyappy,2470,0,1,4,5,20.0%,2h
30083,3,Eldegoss,2470,0,1,4,5,20.0%,3h
30083,3,[XHM]Vanquish,2470,0,0,1,1,0.0%,2h
30083,2,Freezing,2470,0,0,1,1,0.0%,2h
30104,2,[DSFTWA]WARPIG,2469,1518,313,310,623,50.2%,18m
30104,3,Diadectes,2469,991,101,93,194,52.1%,2h
30104,3,dalmata,2469,1285,57,46,103,55.3%,2h
30104,3,[AGAMES]Lakerboy,2469,462,32,29,61,52.5%,15m
30104,3,imabeast,2469,699,31,29,60,51.7%,2h
30104,2,Tiermark,2469,453,16,18,34,47.1%,1h
30104,2,[IBIAl]wesmantooth,2469,378,12,15,27,44.4%,51m
30104,3,[xFsNxx]sPeCtRuM,2469,265,11,16,27,40.7%,10m
30104,3,Meat,2469,188,8,4,12,66.7%,48m
30104,2,[SANGRE]Yamil,2469,248,8,8,16,50.0%,17m
30104,2,KSCZAFYP,2469,210,7,9,16,43.8%,2h
30104,3,Husker,2469,172,6,5,11,54.5%,46m
30104,2,[Furio5]lilaznplayer,2469,64,4,7,11,36.4%,50m
30104,3,[FyHr]DarkFenix,2469,30,2,1,3,66.7%,2h
30104,3,Shabadoo,2469,0,2,3,5,40.0%,1h
30104,3,Shade,2469,0,2,5,7,28.6%,1h
30104,3,Bohrealis,2469,0,1,0,1,100.0%,30m
30104,3,wyre,2469,0,0,1,1,0.0%,11m
30104,2,BigPapaPimp,2469,0,0,4,4,0.0%,13m
30123,1,mogunz,2468,1475,75,77,152,49.3%,2h
30123,3,element,2468,1616,74,64,138,53.6%,36m
30123,3,[GiLLs]Tuktuk,2468,1446,74,67,141,52.5%,3h
30123,1,DokBane,2468,217,31,30,61,50.8%,44m
30123,1,zarchon,2468,379,24,17,41,58.5%,17m
30123,2,[LSA80]Fenomenoide,2468,630,22,26,48,45.8%,40m
30123,2,Pyttmann,2468,482,20,26,46,43.5%,2h
30123,3,ZergPower,2468,382,16,11,27,59.3%,34m
30123,1,[DarkAG]Duffy,2468,177,6,11,17,35.3%,16m
30123,3,SamXtreme,2468,116,4,6,10,40.0%,36m
30123,3,rtroyans,2468,88,3,3,6,50.0%,2h
30123,3,Brenda,2468,125,3,5,8,37.5%,51m
30123,1,MasterShake,2468,101,3,6,9,33.3%,21m
30123,3,KaloAgo,2468,0,1,0,1,100.0%,2h
30123,1,Powers,2468,0,1,4,5,20.0%,39m
30123,3,Performapal,2468,93,1,5,6,16.7%,1h
30139,2,bladewang,2467,1569,223,220,443,50.3%,18m
30139,2,LameDuck,2467,1350,62,55,117,53.0%,2h
30139,3,Rikachet,2467,1076,50,35,85,58.8%,31m
30139,2,StormChaser,2467,883,35,30,65,53.8%,3m
30139,3,devastator,2467,784,31,21,52,59.6%,1h
30139,2,Biotechjones,2467,362,30,33,63,47.6%,1h
30139,2,Mostro,2467,626,24,28,52,46.2%,2h
30139,2,[TFTG]carlitos,2467,575,23,22,45,51.1%,2h
30139,1,[Aquad]LiviBeeSimp,2467,517,22,26,48,45.8%,8m
30139,1,BigStank,2467,571,19,29,48,39.6%,22m
30139,1,[FRMG]EnTrepreneur,2467,508,16,25,41,39.0%,1h
30139,2,ZugZug,2467,173,7,6,13,53.8%,35m
30139,3,Woe,2467,202,7,9,16,43.8%,2h
30139,2,NightKnight,2467,255,7,12,19,36.8%,1h
30139,3,JOSUECURRY,2467,192,6,10,16,37.5%,52m
30139,2,kajev,2467,114,4,6,10,40.0%,34m
30139,3,rapscallion,2467,96,4,7,11,36.4%,26m
30139,2,Azreal,2467,0,3,6,9,33.3%,59m
30139,2,Nick,2467,116,2,5,7,28.6%,1h
30139,3,[gRaNNy]Francine,2467,0,1,0,1,100.0%,36m
30139,3,XxdragonxX,2467,0,1,2,3,33.3%,2h
30139,3,CheeuZ,2467,0,0,1,1,0.0%,2h
30139,3,[eroko]Duke,2467,0,0,1,1,0.0%,3h
30162,1,DarthKan,2466,1604,117,118,235,49.8%,33m
30162,1,TemperFire,2466,875,89,100,189,47.1%,8m
30162,1,wasoski,2466,686,63,67,130,48.5%,36m
30162,2,Chey,2466,1393,52,51,103,50.5%,2h
30162,3,inombrableDD,2466,611,25,16,41,61.0%,2h
30162,2,illy,2466,343,11,9,20,55.0%,2h
30162,1,[PoSu]pROPHiT,2466,345,10,15,25,40.0%,60m
30162,3,Phugsy,2466,180,7,4,11,63.6%,46m
30162,1,Andrew,2466,156,5,7,12,41.7%,43m
30162,2,Agares,2466,94,5,8,13,38.5%,2h
30162,3,[Awiiir]EsseMemento,2466,90,4,2,6,66.7%,1h
30162,2,[CASUL]carlitos,2466,68,4,6,10,40.0%,51m
30162,2,GusPer,2466,105,3,3,6,50.0%,26m
30162,2,BrYaLeXander,2466,173,3,4,7,42.9%,17m
30162,3,[MalddB]Danomight,2466,93,3,8,11,27.3%,12m
30162,3,Mattrix,2466,36,2,0,2,100.0%,2h
30162,3,Stiuie,2466,0,1,4,5,20.0%,2h
30162,3,grouch,2466,0,0,1,1,0.0%,2h
30162,3,Hotrod,2466,0,0,2,2,0.0%,49m
30181,2,tranviquyen,2465,739,271,269,540,50.2%,13m
30181,1,Entertainer,2465,1598,151,159,310,48.7%,3h
30181,2,Deathbringer,2465,1018,78,66,144,54.2%,17m
30181,2,[HNSC2]AllanLISP,2465,919,70,75,145,48.3%,38m
30181,2,SurvivorMan,2465,476,23,27,50,46.0%,2h
30181,3,FENIX,2465,575,21,17,38,55.3%,48m
30181,1,DrMortis,2465,350,9,15,24,37.5%,8m
30181,1,Pacox,2465,285,8,15,23,34.8%,44m
30181,2,heorhe,2465,264,7,8,15,46.7%,53m
30181,1,iEatGlue,2465,94,7,12,19,36.8%,14m
30181,3,[Bovice]Malthael,2465,114,4,3,7,57.1%,3h
30181,3,milkaholic,2465,84,4,4,8,50.0%,2h
30181,3,FunkyMonk,2465,30,2,0,2,100.0%,48m
30181,3,[ExcIgN]Fernanda,2465,97,2,0,2,100.0%,6m
30181,2,GICR,2465,94,2,1,3,66.7%,2h
30181,2,ProteccSnek,2465,96,2,3,5,40.0%,60m
30181,3,Muffn,2465,30,1,2,3,33.3%,39m
30181,2,kimjiye,2465,30,1,3,4,25.0%,3m
30181,2,RLH,2465,0,1,4,5,20.0%,51m
30200,2,darong,2464,1326,84,81,165,50.9%,52m
30200,2,trollen,2464,1025,69,61,130,53.1%,55m
30200,1,[MBurns]killazerg,2464,1524,54,65,119,45.4%,36m
30200,3,PrideEscanor,2464,527,40,37,77,51.9%,59m
30200,2,MADKING,2464,323,23,28,51,45.1%,2h
30200,3,TifaTelui,2464,326,14,7,21,66.7%,2h
30200,1,[BRUVV]Nesquik,2464,343,13,12,25,52.0%,2h
30200,1,ABabyKoala,2464,338,12,15,27,44.4%,25m
30200,1,Adapt,2464,222,9,12,21,42.9%,2h
30200,3,Nigthmare,2464,190,6,1,7,85.7%,4m
30200,2,MasterNothin,2464,153,6,7,13,46.2%,36m
30200,2,agamenon,2464,170,6,10,16,37.5%,13m
30200,3,[SthEst]Wunna,2464,144,4,0,4,100.0%,5m
30200,2,Quasar,2464,183,4,6,10,40.0%,2h
30200,3,Zeekee,2464,78,4,7,11,36.4%,15m
30200,2,Jonny,2464,168,4,7,11,36.4%,52m
30200,3,[Z3R10]rulli,2464,53,3,2,5,60.0%,36m
30200,3,LockDaBadmon,2464,30,2,1,3,66.7%,46m
30200,2,DeadDingo,2464,0,2,4,6,33.3%,1h
30200,2,Cryogenix,2464,88,2,5,7,28.6%,52m
30200,3,Souzin,2464,0,0,1,1,0.0%,26m
30200,3,[oRaC]Vivid,2464,0,0,2,2,0.0%,2h
30200,3,chris,2464,0,0,3,3,0.0%,2h
30223,2,Joeski,2463,958,64,61,125,51.2%,2h
30223,3,YummyVeggies,2463,679,43,36,79,54.4%,2h
30223,3,Loki,2463,706,27,20,47,57.4%,43m
30223,2,RATmcbilly,2463,698,25,27,52,48.1%,2h
30223,3,Farid,2463,633,23,23,46,50.0%,1h
30223,3,Sinn,2463,505,21,11,32,65.6%,52m
30223,2,PuroFuego,2463,340,14,14,28,50.0%,40m
30223,1,[CraCan]Holysheva,2463,210,13,9,22,59.1%,54m
30223,3,[BOLVIA]VICTUM,2463,258,10,8,18,55.6%,9m
30223,3,[MLKMEN]SaTeRaN,2463,272,10,10,20,50.0%,44m
30223,2,wellardia,2463,124,7,9,16,43.8%,3h
30223,2,ElPizzero,2463,30,2,4,6,33.3%,3h
30223,2,Sicario,2463,0,1,3,4,25.0%,40m
30223,3,[DRKRIS]Ntraveler,2463,0,1,7,8,12.5%,19m
30223,3,Greygore,2463,0,0,1,1,0.0%,1h
30223,3,Raziel,2463,0,0,1,1,0.0%,19m
30223,3,ProjectDanSh,2463,0,0,1,1,0.0%,1h
30223,3,BagOfChip,2463,0,0,2,2,0.0%,53m
30241,2,Cavanagh,2462,1172,64,58,122,52.5%,8m
30241,2,Executor,2462,802,33,29,62,53.2%,32m
30241,3,Stza,2462,730,30,25,55,54.5%,16m
30241,1,Arjsker,2462,828,30,34,64,46.9%,2h
30241,3,Neuman,2462,608,23,17,40,57.5%,52m
30241,1,[REPORT]Starzergian,2462,414,14,24,38,36.8%,8m
30241,3,rcontrol,2462,205,7,10,17,41.2%,52m
30241,3,Ivory,2462,0,4,3,7,57.1%,55m
30241,3,ROOTDestiny,2462,121,3,6,9,33.3%,16m
30241,3,[pineC]Mocha,2462,0,2,4,6,33.3%,19m
30241,3,LittleJoe,2462,97,1,1,2,50.0%,19m
30241,2,Ban,2462,30,1,6,7,14.3%,2h
30241,3,GrimFate,2462,0,0,1,1,0.0%,2h
30241,1,[JAHB]Gldntz,2462,0,0,1,1,0.0%,3h
30241,2,BingoBango,2462,0,0,2,2,0.0%,1h
30241,2,PapaGerm,2462,0,0,3,3,0.0%,23m
30257,3,[FalPal]Eidolon,2461,1265,81,65,146,55.5%,1m
30257,2,[Fever]sethgene,2461,462,18,20,38,47.4%,2h
30257,2,Corripio,2461,300,11,12,23,47.8%,1h
30257,3,GucChiMayne,2461,262,9,9,18,50.0%,9m
30257,3,eyekiller,2461,105,5,3,8,62.5%,30m
30257,3,Lusankya,2461,88,4,2,6,66.7%,15m
30257,2,berserker,2461,58,4,6,10,40.0%,51m
30257,3,[Broske]DeadLock,2461,30,2,0,2,100.0%,46m
30257,3,WoweeZowee,2461,0,2,2,4,50.0%,56m
30257,3,CENP,2461,0,2,4,6,33.3%,3h
30257,3,Ssquad,2461,33,2,5,7,28.6%,15m
30257,2,SuperPulse,2461,0,2,5,7,28.6%,20m
30257,3,starlord,2461,0,1,1,2,50.0%,54m
30257,3,[FyHr]Elven,2461,30,1,3,4,25.0%,54m
30257,3,Zarathustra,2461,0,0,1,1,0.0%,57m
30257,3,joseandresvf,2461,0,0,2,2,0.0%,19m
30257,1,KERRIGANPRO,2461,0,0,2,2,0.0%,2h
30274,3,LibraLucifer,2460,1608,103,103,206,50.0%,2h
30274,3,ichigo,2460,1446,65,50,115,56.5%,2h
30274,3,HiroProt,2460,490,55,44,99,55.6%,3h
30274,2,[MirG]TheYoungBo,2460,600,23,26,49,46.9%,13m
30274,2,yander,2460,596,22,27,49,44.9%,2h
30274,3,Arley,2460,384,17,18,35,48.6%,12m
30274,3,Starlord,2460,354,15,9,24,62.5%,2h
30274,3,[FK0USA]OMGROWAN,2460,321,15,14,29,51.7%,15m
30274,3,Ganunu,2460,380,14,14,28,50.0%,32m
30274,1,Geek,2460,305,13,12,25,52.0%,31m
30274,2,Kozuka,2460,270,12,19,31,38.7%,51m
30274,2,Ozyman,2460,229,11,5,16,68.8%,53m
30274,3,valladolid,2460,338,11,8,19,57.9%,15m
30274,3,JulioRR,2460,279,9,17,26,34.6%,39m
30274,2,XDCesarDX,2460,251,8,10,18,44.4%,52m
30274,2,[CCUUCC]BenJue,2460,180,6,5,11,54.5%,2h
30274,1,[NBHI]Seter,2460,114,2,2,4,50.0%,12m
30274,2,PainTrain,2460,30,2,6,8,25.0%,22m
30274,3,[XpKAc]MegasXLR,2460,0,1,1,2,50.0%,9m
30274,3,[4fun4]Matt,2460,0,0,1,1,0.0%,3h
30274,2,[AFJC]SilentKnight,2460,0,0,2,2,0.0%,2h
30295,3,McMoo,2459,633,60,62,122,49.2%,10m
30295,3,DaBi,2459,1236,58,51,109,53.2%,2h
30295,2,ultralaser,2459,655,57,52,109,52.3%,2h
30295,2,jhonn,2459,1055,48,57,105,45.7%,26m
30295,2,MarketForces,2459,148,27,29,56,48.2%,7m
30295,3,[2sA]Kippe,2459,620,25,38,63,39.7%,24m
30295,1,ThorGore,2459,438,19,25,44,43.2%,38m
30295,3,ZENAKU,2459,353,16,8,24,66.7%,22m
30295,3,Men,2459,428,16,14,30,53.3%,15m
30295,3,Snaketail,2459,301,11,15,26,42.3%,52m
30295,3,AlexShu,2459,235,9,7,16,56.2%,2h
30295,3,Centipedes,2459,197,5,7,12,41.7%,54m
30295,2,TheAlchemist,2459,166,5,8,13,38.5%,2h
30295,2,Yodabeast,2459,132,4,6,10,40.0%,2h
30295,3,[EBAGmn]QuechoPulga,2459,107,3,0,3,100.0%,4m
30295,3,Cain,2459,88,3,2,5,60.0%,32m
30295,2,Adiepd,2459,0,3,3,6,50.0%,53m
30295,3,Bhageera,2459,60,2,5,7,28.6%,2h
30295,3,Gromnor,2459,0,1,1,2,50.0%,1h
30295,2,Yellowb,2459,88,1,4,5,20.0%,1h
30295,3,Daniel,2459,0,0,2,2,0.0%,2h
30316,2,Killer,2458,1507,287,290,577,49.7%,25m
30316,2,DanniMC,2458,1554,159,160,319,49.8%,35m
30316,1,FerBo,2458,1157,61,59,120,50.8%,36m
30316,2,TreePainter,2458,1256,60,63,123,48.8%,47m
30316,3,Samu,2458,1144,52,42,94,55.3%,2h
30316,2,[PERGT]WilliaM,2458,811,32,23,55,58.2%,53m
30316,3,Jukes,2458,626,24,21,45,53.3%,1h
30316,1,Samsung,2458,599,24,34,58,41.4%,24m
30316,1,Hatel,2458,215,11,9,20,55.0%,3h
30316,3,[DarkLS]LycanTheEvil,2458,242,9,6,15,60.0%,22m
30316,3,TacticalCorn,2458,232,7,7,14,50.0%,2h
30316,2,GOLDENS,2458,192,7,8,15,46.7%,58m
30316,2,angelblack,2458,255,7,12,19,36.8%,26m
30316,3,SwankyPants,2458,145,5,4,9,55.6%,2h
30316,1,poluloqq,2458,48,2,4,6,33.3%,21m
30316,2,gukjoon,2458,0,2,4,6,33.3%,44m
30316,2,korndog,2458,40,2,7,9,22.2%,3h
30316,3,joon,2458,30,1,3,4,25.0%,2h
30316,2,[ELCTR]TheKing,2458,0,1,4,5,20.0%,40m
30316,3,FullTLight,2458,97,1,6,7,14.3%,54m
30316,2,Beardo,2458,30,1,9,10,10.0%,1h
30316,3,[BRKD]KKCBalmonte,2458,0,0,1,1,0.0%,12m
30316,2,[DayJ]Darkozzy,2458,0,0,2,2,0.0%,2h
30316,2,Polymorph,2458,0,0,2,2,0.0%,19m
30316,3,[LevelR]Razorbane,2458,0,0,2,2,0.0%,32m
30341,1,[Kusshh]VeNoM,2457,975,65,69,134,48.5%,2h
30341,2,kanenine,2457,1061,62,49,111,55.9%,8m
30341,2,josefa,2457,1534,61,60,121,50.4%,36m
30341,2,Gold,2457,1413,57,62,119,47.9%,2h
30341,3,CALC,2457,1104,44,41,85,51.8%,22m
30341,1,styxian,2457,563,26,23,49,53.1%,34m
30341,3,[Astrus]Kobaian,2457,201,19,14,33,57.6%,2h
30341,2,JagdMech,2457,455,17,16,33,51.5%,40m
30341,3,KenSpliffyJr,2457,431,15,15,30,50.0%,47m
30341,2,AmERICan,2457,332,14,14,28,50.0%,2h
30341,2,CARL,2457,250,9,11,20,45.0%,13m
30341,3,[ZTemp]akotea,2457,192,9,12,21,42.9%,20m
30341,3,Cassidy,2457,226,8,6,14,57.1%,2h
30341,3,KorbenDallas,2457,218,8,7,15,53.3%,36m
30341,3,NeatoBurrito,2457,145,6,3,9,66.7%,29m
30341,3,Draybengame,2457,166,5,1,6,83.3%,2h
30341,3,Stratosfury,2457,89,5,3,8,62.5%,36m
30341,3,[R4NK3D]LastHomeless,2457,151,5,3,8,62.5%,2h
30341,3,[tTZz]FallenPiano,2457,114,4,4,8,50.0%,52m
30341,1,GARM,2457,48,4,8,12,33.3%,1h
30341,3,[notBAD]TheDesertFox,2457,58,2,2,4,50.0%,1h
30341,2,CosmicLegend,2457,60,2,6,8,25.0%,2h
30341,3,Sebastian,2457,0,1,0,1,100.0%,48m
30341,3,Azamat,2457,0,1,0,1,100.0%,3h
30341,3,[MENGO]Buggy,2457,0,1,0,1,100.0%,48m
30341,3,danielvdotco,2457,0,1,1,2,50.0%,2h
30341,3,Quinardium,2457,0,1,1,2,50.0%,3h
30341,3,Willy,2457,30,1,1,2,50.0%,32m
30341,3,gian,2457,30,1,2,3,33.3%,22m
30341,3,inerTiA,2457,0,1,4,5,20.0%,28m
30341,2,bkuze,2457,95,1,5,6,16.7%,1h
30341,2,TwentyEight,2457,46,1,7,8,12.5%,2h
30341,3,Vorbeck,2457,0,0,1,1,0.0%,2h
30341,3,RAYMANKAPEEN,2457,0,0,2,2,0.0%,13m
30341,3,GeauxFast,2457,0,0,2,2,0.0%,48m
30376,3,BiZeBoYz,2456,1614,370,363,733,50.5%,5m
30376,2,Analog,2456,1583,223,226,449,49.7%,3h
30376,1,Lithinos,2456,1487,135,136,271,49.8%,1h
30376,2,[AbcCo]Loko,2456,543,21,24,45,46.7%,44m
30376,3,NemeSi,2456,200,20,12,32,62.5%,2h
30376,2,panic,2456,305,11,12,23,47.8%,3m
30376,3,llllllllllll,2456,97,5,2,7,71.4%,49m
30376,3,CutieAngels,2456,142,5,3,8,62.5%,16m
30376,1,NotsoImba,2456,0,3,2,5,60.0%,1h
30376,1,OmegaRed,2456,0,1,2,3,33.3%,36m
30376,2,hungryboi,2456,0,1,3,4,25.0%,7m
30376,2,[HBDO]MENULOG,2456,0,1,4,5,20.0%,2h
30376,3,Gunter,2456,0,1,4,5,20.0%,28m
30376,2,Harrar,2456,99,1,7,8,12.5%,40m
30376,2,Zodiac,2456,0,0,6,6,0.0%,2h
30391,1,[ZTemp]phillgill,2455,1431,224,221,445,50.3%,2h
30391,2,[SwaPGC]jNr,2455,1574,198,201,399,49.6%,6m
30391,2,TheChode,2455,1614,115,100,215,53.5%,3h
30391,2,[ÆON]gammullus,2455,1545,71,73,144,49.3%,1h
30391,2,Sensei,2455,553,23,22,45,51.1%,51m
30391,3,[Shang]Neo,2455,243,8,3,11,72.7%,15m
30391,3,[qoou]Gijibabe,2455,218,8,3,11,72.7%,3h
30391,3,Skandyr,2455,174,6,4,10,60.0%,3h
30391,2,Avatar,2455,96,4,7,11,36.4%,28m
30391,3,DANTESINFER,2455,90,3,6,9,33.3%,2h
30391,2,Jovic,2455,34,3,6,9,33.3%,44m
30391,2,[SUDAKA]SrInmortal,2455,66,3,9,12,25.0%,2h
30391,1,Zeus,2455,0,1,0,1,100.0%,3h
30391,3,[xVT]BlueBot,2455,0,1,0,1,100.0%,49m
30391,3,[1Ec0n1]gunner,2455,0,1,1,2,50.0%,8m
30391,3,Flama,2455,0,1,4,5,20.0%,2h
30391,3,[xDPx]Visceral,2455,0,0,1,1,0.0%,2h
30391,3,Dire,2455,0,0,1,1,0.0%,15m
30391,3,elsebo,2455,0,0,1,1,0.0%,48m
30391,3,nadonia,2455,0,0,2,2,0.0%,37m
30411,1,[m0ney]Beavis,2454,916,54,55,109,49.5%,16m
30411,2,[WOTDL]xiozone,2454,366,41,37,78,52.6%,1h
30411,2,Jakamungo,2454,763,30,33,63,47.6%,53m
30411,2,[BYU]Andystan,2454,687,28,27,55,50.9%,52m
30411,2,SaltMaster,2454,535,27,25,52,51.9%,3h
30411,3,Sleepy,2454,525,21,21,42,50.0%,37m
30411,3,Edgar,2454,262,13,13,26,50.0%,15m
30411,1,IcyHotCocoa,2454,307,12,14,26,46.2%,2h
30411,2,KingOfBlades,2454,266,9,9,18,50.0%,3h
30411,3,[dede]Mueksi,2454,228,9,12,21,42.9%,37m
30411,3,TheBomba,2454,182,7,12,19,36.8%,12m
30411,1,Gom,2454,176,7,12,19,36.8%,45m
30411,3,iLikeLunch,2454,219,6,3,9,66.7%,45m
30411,2,[OPGame]FlyingVixen,2454,216,6,10,16,37.5%,32m
30411,2,torro,2454,130,4,11,15,26.7%,2h
30411,2,Luacar,2454,30,2,3,5,40.0%,52m
30411,3,[Newbi3]Arkahas,2454,95,2,5,7,28.6%,2h
30411,2,BESTPLAYER,2454,42,1,3,4,25.0%,12m
30411,3,Lidoh,2454,30,1,4,5,20.0%,2m
30411,1,[umoron]StopShot,2454,0,0,1,1,0.0%,36m
30411,3,PaintedBlue,2454,0,0,2,2,0.0%,46m
30432,1,PathogeNºVII,2453,1543,256,266,522,49.0%,8m
30432,2,Alphabet,2453,686,63,45,108,58.3%,34m
30432,2,[TBBS]floamfun,2453,1106,43,40,83,51.8%,2h
30432,1,Belisarius,2453,616,20,29,49,40.8%,13m
30432,3,wrandas,2453,267,9,5,14,64.3%,3m
30432,1,Xasdex,2453,302,9,17,26,34.6%,2h
30432,2,PandaPoh,2453,200,6,10,16,37.5%,2h
30432,3,Aristo,2453,169,5,0,5,100.0%,3h
30432,2,Fiiishy,2453,125,5,10,15,33.3%,2h
30432,3,[xRI]Moazzam,2453,60,3,1,4,75.0%,9m
30432,2,MARCHELOOOOO,2453,87,3,1,4,75.0%,2h
30432,3,BigDo,2453,0,3,2,5,60.0%,26m
30432,2,SittingDuck,2453,0,3,3,6,50.0%,34m
30432,3,[TRETER]Sueltox,2453,88,3,7,10,30.0%,3h
30432,3,whip,2453,0,2,5,7,28.6%,2h
30432,2,legolas,2453,0,1,1,2,50.0%,2h
30432,1,pabloT,2453,0,1,2,3,33.3%,8m
30432,3,animosity,2453,0,0,1,1,0.0%,3h
30432,3,CoronaBoost,2453,0,0,1,1,0.0%,1h
30432,3,pkuwu,2453,0,0,1,1,0.0%,46m
30432,1,Mathrodoc,2453,0,0,6,6,0.0%,2h
30453,3,CaptainCap,2452,1326,118,120,238,49.6%,34m
30453,2,Goobie,2452,429,65,54,119,54.6%,26m
30453,2,Anarchy,2452,1200,57,53,110,51.8%,40m
30453,3,Snorkel,2452,749,32,29,61,52.5%,46m
30453,2,Bonesetter,2452,762,27,30,57,47.4%,2h
30453,3,Viper,2452,473,20,14,34,58.8%,31m
30453,3,Jolin,2452,328,19,21,40,47.5%,29m
30453,3,Miittcchhzz,2452,268,8,10,18,44.4%,46m
30453,3,DonaldTrump,2452,181,6,4,10,60.0%,2h
30453,1,Germ,2452,175,6,8,14,42.9%,43m
30453,3,[SSC]DeepWade,2452,137,4,5,9,44.4%,28m
30453,3,TheShadows,2452,121,3,6,9,33.3%,54m
30453,1,[myLORT]Cogii,2452,121,2,4,6,33.3%,2h
30453,1,Funky,2452,48,2,4,6,33.3%,3h
30453,1,[APP]Bryson,2452,0,1,0,1,100.0%,21m
30453,2,tjwhyme,2452,0,1,0,1,100.0%,2h
30453,3,[MEvo]GoldenThorn,2452,30,1,1,2,50.0%,2h
30453,3,MIGUEL,2452,0,0,2,2,0.0%,15m
30453,3,soegy,2452,0,0,5,5,0.0%,31m
30472,2,Pillán,2451,1570,388,401,789,49.2%,2h
30472,1,[LDTJC]JcCharly,2451,1589,101,101,202,50.0%,2h
30472,3,[zRGG]zOrlaG,2451,858,86,86,172,50.0%,2h
30472,3,[Wizerd]KingStupid,2451,531,23,17,40,57.5%,46m
30472,3,Sum,2451,386,13,13,26,50.0%,46m
30472,2,geffer,2451,245,11,16,27,40.7%,8m
30472,1,DReaMe,2451,189,6,8,14,42.9%,34m
30472,3,TheGambler,2451,174,6,12,18,33.3%,24m
30472,3,Cidragon,2451,154,4,5,9,44.4%,2h
30472,3,loOool,2451,148,4,7,11,36.4%,25m
30472,2,Nigzilla,2451,118,4,7,11,36.4%,2h
30472,3,Nomad,2451,97,3,2,5,60.0%,8m
30472,1,OdiNn,2451,0,3,2,5,60.0%,2h
30472,2,BigCheese,2451,135,3,3,6,50.0%,13m
30472,2,[Maaad]forlorn,2451,0,3,3,6,50.0%,11m
30472,3,boodragon,2451,58,3,3,6,50.0%,15m
30472,3,IIIIIIIIIIII,2451,121,3,5,8,37.5%,24m
30472,1,[HODE]lich,2451,36,3,7,10,30.0%,60m
30472,2,tieso,2451,88,3,8,11,27.3%,1h
30472,1,Anialater,2451,0,2,3,5,40.0%,2h
30472,2,kai,2451,32,2,5,7,28.6%,39m
30472,3,Yoshi,2451,60,2,6,8,25.0%,46m
30472,1,[2faded]koadyawn,2451,34,2,8,10,20.0%,52m
30472,1,NebulaDesign,2451,48,1,1,2,50.0%,21m
30472,2,Skyaie,2451,42,1,3,4,25.0%,20m
30472,1,Macdaddy,2451,0,1,5,6,16.7%,56m
30472,2,Nostalgic,2451,30,1,6,7,14.3%,2h
30472,3,Washington,2451,0,0,1,1,0.0%,1h
30472,3,GenderBender,2451,0,0,3,3,0.0%,3h
30501,2,Iro,2450,1270,112,101,213,52.6%,1h
30501,3,GreassyGamer,2450,627,77,60,137,56.2%,29m
30501,1,[FEEDS]Erick,2450,1315,62,64,126,49.2%,41m
30501,3,[SJT]Billybob,2450,651,27,22,49,55.1%,53m
30501,3,[Altari]SebaXsss,2450,660,26,24,50,52.0%,52m
30501,2,neoncokein,2450,442,21,16,37,56.8%,2h
30501,3,Loadedfist,2450,497,18,14,32,56.2%,9m
30501,3,Ceptx,2450,386,15,17,32,46.9%,1h
30501,3,TolietSkunk,2450,360,13,11,24,54.2%,3h
30501,3,Halaphad,2450,273,9,7,16,56.2%,46m
30501,3,red,2450,166,6,7,13,46.2%,1h
30501,2,[SHKLS]Yerrrrrrrrr,2450,158,6,11,17,35.3%,2h
30501,2,Leviathan,2450,58,5,5,10,50.0%,1h
30501,2,LiberatorWOG,2450,146,5,8,13,38.5%,1h
30501,3,[GOPERÚ]LORKAOS,2450,165,4,2,6,66.7%,2h
30501,2,KBack,2450,88,4,6,10,40.0%,36m
30501,3,[lLiTl]Swift,2450,119,3,0,3,100.0%,2h
30501,3,Rotary,2450,122,3,0,3,100.0%,3h
30501,3,Ezzy,2450,60,2,3,5,40.0%,2h
30501,3,Wolf,2450,0,1,1,2,50.0%,2h
30501,3,BliZzWiZz,2450,0,1,4,5,20.0%,2h
30501,3,Abuhn,2450,0,0,1,1,0.0%,48m
30501,3,GatitaGolosa,2450,0,0,1,1,0.0%,2h
30524,2,mrFRESH,2449,1581,327,314,641,51.0%,2h
30524,1,customs,2449,1611,141,149,290,48.6%,2h
30524,2,Sunkist,2449,1085,45,43,88,51.1%,1h
30524,2,skithrix,2449,891,40,35,75,53.3%,1h
30524,1,Toyochan,2449,360,13,17,30,43.3%,2h
30524,3,CostaRica,2449,244,9,10,19,47.4%,2h
30524,2,WilFromEarth,2449,280,9,11,20,45.0%,13m
30524,3,Prygames,2449,154,6,5,11,54.5%,52m
30524,3,ScaryToaster,2449,137,6,8,14,42.9%,13m
30524,3,PerfectDay,2449,78,5,6,11,45.5%,55m
30524,2,Moscadx,2449,46,5,6,11,45.5%,13m
30524,3,VonCheeto,2449,58,3,1,4,75.0%,2h
30524,2,Etna,2449,0,2,2,4,50.0%,17m
30524,3,Abram,2449,0,1,1,2,50.0%,16m
30524,1,Splashback,2449,0,1,4,5,20.0%,24m
30524,3,Pseudolife,2449,0,0,1,1,0.0%,2h
30524,3,jjsky,2449,0,0,1,1,0.0%,7m
30524,2,Mazer,2449,0,0,4,4,0.0%,26m
30542,2,[ExcIgN]JAVICHIDO,2448,1325,174,155,329,52.9%,2h
30542,1,Reign,2448,1163,72,81,153,47.1%,3h
30542,2,Jay,2448,682,25,25,50,50.0%,2h
30542,3,jelipe,2448,357,21,14,35,60.0%,11m
30542,3,SixPcMcBooty,2448,494,18,17,35,51.4%,3m
30542,2,Deathgear,2448,470,16,20,36,44.4%,2h
30542,3,[Kodos]Nicofersar,2448,377,15,17,32,46.9%,2h
30542,1,WayTooRippt,2448,282,10,14,24,41.7%,2h
30542,2,[IFH]Kittenpower,2448,248,7,9,16,43.8%,3h
30542,2,[UpxV]astana,2448,176,6,13,19,31.6%,39m
30542,1,Yosh,2448,148,5,8,13,38.5%,3h
30542,3,Angeo,2448,158,4,7,11,36.4%,25m
30542,2,ProbeRush,2448,125,3,3,6,50.0%,11m
30542,3,iuouoi,2448,0,1,0,1,100.0%,15m
30542,3,GapsMcD,2448,30,1,1,2,50.0%,45m
30542,3,zzxb,2448,30,1,2,3,33.3%,16m
30542,1,Beavismcgurb,2448,0,1,4,5,20.0%,1h
30542,3,Nacho,2448,0,0,1,1,0.0%,2h
30542,3,[GOTG1]THUNDER,2448,0,0,1,1,0.0%,1h
30542,3,Hedzu,2448,0,0,1,1,0.0%,2h
30542,3,Hydralicious,2448,0,0,1,1,0.0%,2h
30563,1,Pandragon,2447,1613,162,160,322,50.3%,38m
30563,1,ShadowBlade,2447,1507,139,140,279,49.8%,3h
30563,1,Idunidas,2447,1137,107,94,201,53.2%,2h
30563,3,Optim,2447,1634,82,77,159,51.6%,53m
30563,2,[Pig2]Lillia,2447,547,70,63,133,52.6%,34m
30563,3,Hekamiah,2447,1108,42,42,84,50.0%,2h
30563,3,ThePolice,2447,565,23,21,44,52.3%,23m
30563,2,Chewy,2447,532,21,19,40,52.5%,1h
30563,2,angelcaido,2447,508,19,22,41,46.3%,39m
30563,3,OwLL,2447,166,7,4,11,63.6%,45m
30563,1,BIOS,2447,120,7,8,15,46.7%,17m
30563,1,Double,2447,215,7,12,19,36.8%,56m
30563,3,FBSUPER,2447,114,5,2,7,71.4%,3h
30563,1,McSmashup,2447,129,4,8,12,33.3%,20m
30563,3,SeBoM,2447,153,3,2,5,60.0%,36m
30563,3,dallinraynor,2447,0,1,0,1,100.0%,60m
30563,3,ELTERRAN,2447,0,1,1,2,50.0%,32m
30563,2,[nieBla]ZoneZero,2447,132,1,6,7,14.3%,2h
30581,2,blarg,2446,1543,81,76,157,51.6%,51m
30581,3,Todynho,2446,657,28,24,52,53.8%,36m
30581,3,Alejandro,2446,555,23,22,45,51.1%,2h
30581,3,[Outset]Repo,2446,471,17,17,34,50.0%,3m
30581,3,VayVillein,2446,328,17,24,41,41.5%,38m
30581,2,Billberto,2446,424,16,16,32,50.0%,3h
30581,2,Valounours,2446,466,16,22,38,42.1%,52m
30581,2,ForeverHers,2446,256,8,6,14,57.1%,2h
30581,2,qBaseGodp,2446,208,8,12,20,40.0%,2h
30581,3,NewNate,2446,190,6,3,9,66.7%,43m
30581,2,MrTlatoani,2446,143,5,8,13,38.5%,13m
30581,2,[PIZZAA]AbusmentPark,2446,158,5,12,17,29.4%,3h
30581,3,superior,2446,114,4,3,7,57.1%,9m
30581,3,[RNSF]Ricen,2446,145,4,6,10,40.0%,3h
30581,2,[ALI3N3]KYKA,2446,86,4,6,10,40.0%,9m
30581,2,[RvN]Naughtydog,2446,40,3,7,10,30.0%,28m
30581,3,KnightOfHell,2446,30,2,2,4,50.0%,15m
30581,3,[OlVera]Edaliz,2446,119,2,2,4,50.0%,2h
30581,3,AimBotHacker,2446,30,2,4,6,33.3%,46m
30581,3,[pinoy]EightySixJun,2446,18,1,3,4,25.0%,2h
30581,3,aaronkupen,2446,0,1,4,5,20.0%,16m
30581,3,Phalanxo,2446,0,1,4,5,20.0%,2h
30581,3,Tom,2446,0,0,1,1,0.0%,3h
30581,3,JehuOni,2446,0,0,5,5,0.0%,2h
30581,1,Itman,2446,0,0,6,6,0.0%,34m
30606,3,Griffin,2445,1611,124,97,221,56.1%,2h
30606,2,Powerslave,2445,1568,61,68,129,47.3%,2h
30606,2,botswai,2445,403,44,42,86,51.2%,1h
30606,2,Babbus,2445,800,27,33,60,45.0%,26m
30606,2,Viper,2445,496,21,20,41,51.2%,3h
30606,3,DerekVinyard,2445,343,13,6,19,68.4%,2h
30606,2,[CSLltd]holysaber,2445,267,11,12,23,47.8%,29m
30606,3,[Umizoo]BloodSparrow,2445,252,10,8,18,55.6%,2h
30606,2,endlessroe,2445,254,10,11,21,47.6%,23m
30606,3,Alvaro,2445,196,7,7,14,50.0%,45m
30606,3,Vassili,2445,116,4,4,8,50.0%,2h
30606,2,VonKerS,2445,140,4,6,10,40.0%,2h
30606,1,Sbeek,2445,60,4,7,11,36.4%,51m
30606,2,SsAaDdIiCc,2445,92,4,9,13,30.8%,17m
30606,3,BigDaddy,2445,60,3,2,5,60.0%,2h
30606,3,Burntrice,2445,121,3,3,6,50.0%,16m
30606,3,GgamNol,2445,110,2,1,3,66.7%,30m
30606,1,lesdeuxmagot,2445,0,2,4,6,33.3%,2h
30606,3,Ragnar,2445,95,2,4,6,33.3%,13m
30606,3,[HvnDvl]DROOF,2445,0,1,0,1,100.0%,2h
30606,3,DeadchordTV,2445,30,1,2,3,33.3%,59m
30606,3,Pilainar,2445,0,0,1,1,0.0%,2h
30606,3,[SLACK]CaptainSmack,2445,0,0,1,1,0.0%,3h
30606,3,EricL,2445,0,0,1,1,0.0%,50m
30606,3,Doomx,2445,0,0,1,1,0.0%,11m
30606,3,[Pig2]pajerson,2445,0,0,1,1,0.0%,39m
30606,2,TigOlBitties,2445,0,0,2,2,0.0%,60m
30606,3,spartin,2445,0,0,2,2,0.0%,3h
30606,3,Pelacats,2445,0,0,4,4,0.0%,39m
30606,2,Junkdog,2445,0,0,5,5,0.0%,2h
30636,3,YAKUZAPANDA,2444,1550,178,190,368,48.4%,26m
30636,3,[cluez]NolaSaints,2444,1596,116,107,223,52.0%,2h
30636,3,Mastercraft,2444,1224,61,68,129,47.3%,31m
30636,3,WesMakowski,2444,1153,52,37,89,58.4%,53m
30636,2,[XOLDX]Panzor,2444,733,27,29,56,48.2%,2h
30636,3,KikAssMullet,2444,319,26,23,49,53.1%,1h
30636,2,PSM,2444,229,10,17,27,37.0%,13m
30636,3,RabbidLesbo,2444,158,7,2,9,77.8%,2h
30636,2,Rolooo,2444,200,7,14,21,33.3%,2h
30636,2,TBL,2444,116,5,6,11,45.5%,39m
30636,1,CommieClapp,2444,253,5,8,13,38.5%,2h
30636,1,[RSGP]Aristoteles,2444,102,4,10,14,28.6%,54m
30636,3,[CaC4s]BobEsponja,2444,0,3,2,5,60.0%,28m
30636,3,LETHAL,2444,0,3,2,5,60.0%,46m
30636,3,Clutch,2444,121,3,6,9,33.3%,50m
30636,3,StickFigure,2444,30,1,3,4,25.0%,26m
30636,3,youcar,2444,0,1,4,5,20.0%,53m
30636,3,yazico,2444,0,1,5,6,16.7%,29m
30636,3,JHHC,2444,0,0,1,1,0.0%,1h
30636,3,[dioses]ZannyDreamer,2444,0,0,2,2,0.0%,30m
30656,3,PantherX,2443,1585,136,121,257,52.9%,2h
30656,3,ChiQuay,2443,1537,71,74,145,49.0%,1h
30656,2,Arjet,2443,931,50,53,103,48.5%,40m
30656,3,GoeD,2443,890,37,29,66,56.1%,26m
30656,2,daddydom,2443,617,27,20,47,57.4%,2h
30656,3,DROOPNASTY,2443,148,18,36,54,33.3%,16m
30656,3,Deado,2443,396,16,7,23,69.6%,3h
30656,3,LargeFungus,2443,289,9,8,17,52.9%,2h
30656,2,RedBaron,2443,160,8,7,15,53.3%,24m
30656,1,[JaMiT]madscientist,2443,170,6,14,20,30.0%,42m
30656,3,SteveBob,2443,30,3,5,8,37.5%,60m
30656,3,Wileykyoti,2443,58,2,3,5,40.0%,1h
30656,2,kukuro,2443,46,2,4,6,33.3%,60m
30656,3,Deaffin,2443,0,1,0,1,100.0%,2h
30656,1,Wifflum,2443,0,1,1,2,50.0%,2h
30656,3,SchifeR,2443,0,0,2,2,0.0%,12m
30656,1,Articuno,2443,0,0,3,3,0.0%,32m
30673,3,craftypixels,2442,1550,114,95,209,54.5%,2h
30673,2,GameGenie,2442,1197,79,85,164,48.2%,23m
30673,3,[DRKFOX]NaTaS,2442,1553,64,59,123,52.0%,12m
30673,2,GoodKnight,2442,745,58,61,119,48.7%,13m
30673,3,Fhalette,2442,727,30,23,53,56.6%,2h
30673,2,SuperTets,2442,551,22,24,46,47.8%,32m
30673,3,ShdowNight,2442,346,13,12,25,52.0%,2h
30673,3,MessierONE,2442,254,12,17,29,41.4%,48m
30673,1,Therevidae,2442,185,10,19,29,34.5%,3h
30673,3,Jetz,2442,256,9,9,18,50.0%,46m
30673,3,[EZClep]Jaterei,2442,170,5,6,11,45.5%,8m
30673,3,dga,2442,60,3,2,5,60.0%,2h
30673,3,MakeUWin,2442,58,2,4,6,33.3%,21m
30673,1,Reptar,2442,0,1,4,5,20.0%,2h
30687,3,Mattax,2441,862,70,60,130,53.8%,53m
30687,3,Danny,2441,702,42,30,72,58.3%,48m
30687,3,[ZTemp]Sirbeares,2441,580,27,24,51,52.9%,15m
30687,2,MenloverPoop,2441,472,21,14,35,60.0%,39m
30687,2,OldManWillow,2441,444,15,20,35,42.9%,2h
30687,2,RPG,2441,442,15,21,36,41.7%,38m
30687,3,AlphaRosa,2441,267,8,6,14,57.1%,29m
30687,3,TLA,2441,244,8,14,22,36.4%,9m
30687,3,Acelegendary,2441,198,7,6,13,53.8%,34m
30687,3,mkashimoto,2441,202,7,10,17,41.2%,2h
30687,3,mazoozoo,2441,162,6,6,12,50.0%,4m
30687,2,PlayForFun,2441,146,4,6,10,40.0%,1h
30687,3,ManongJed,2441,138,3,1,4,75.0%,49m
30687,3,[wwoww]JoshSS,2441,60,3,4,7,42.9%,2h
30687,3,TheExecutor,2441,30,2,2,4,50.0%,48m
30687,3,marco,2441,58,2,2,4,50.0%,2h
30687,2,Trelack,2441,30,2,3,5,40.0%,3h
30687,2,Lem,2441,62,2,7,9,22.2%,3h
30687,2,[Pharoh]Innkeeper,2441,83,2,7,9,22.2%,2h
30687,3,Ares,2441,0,1,0,1,100.0%,30m
30687,3,Tonka,2441,0,1,0,1,100.0%,2h
30687,2,Deathpenguin,2441,30,1,4,5,20.0%,2h
30687,3,SchwarzSturm,2441,0,1,4,5,20.0%,54m
30687,2,[Cadete]RuralLeech,2441,30,1,6,7,14.3%,2h
30687,1,[newAQP]BboyPeru,2441,0,0,1,1,0.0%,1h
30687,3,Scoltick,2441,0,0,1,1,0.0%,2h
30687,3,SnipeRouse,2441,0,0,2,2,0.0%,2h
30687,3,[FOXMC]omarlink,2441,0,0,3,3,0.0%,2h
30715,2,Ðnoch,2440,280,90,82,172,52.3%,34m
30715,1,[X1]ChevyNova,2440,728,27,34,61,44.3%,35m
30715,3,Zahpoko,2440,302,11,9,20,55.0%,2h
30715,2,Lapyboy,2440,189,7,10,17,41.2%,3h
30715,3,Dreadsiete,2440,154,6,8,14,42.9%,15m
30715,3,Ferris,2440,114,5,5,10,50.0%,3h
30715,3,[TsrcT]Deliqnt,2440,167,4,5,9,44.4%,1h
30715,1,Rayborg,2440,96,4,7,11,36.4%,20m
30715,3,almost,2440,121,2,2,4,50.0%,2h
30715,3,Tysinsu,2440,0,2,3,5,40.0%,2h
30715,3,Blaik,2440,97,2,5,7,28.6%,50m
30715,3,alexandru,2440,30,1,3,4,25.0%,53m
30715,3,symic,2440,0,1,4,5,20.0%,12m
30728,1,LuciusFlame,2439,1597,237,240,477,49.7%,2h
30728,3,[VENSC2]wbv,2439,1447,151,136,287,52.6%,32m
30728,3,TICO,2439,1333,83,82,165,50.3%,43m
30728,1,DarthWeiner,2439,1304,54,51,105,51.4%,2h
30728,2,Kalel,2439,1398,50,59,109,45.9%,1h
30728,3,brendenator,2439,719,29,22,51,56.9%,2h
30728,3,EcSaGa,2439,275,15,19,34,44.1%,12m
30728,3,ApexPredator,2439,242,11,13,24,45.8%,46m
30728,3,EpicSchiPhy,2439,240,7,6,13,53.8%,7m
30728,3,RJrulesSF,2439,160,6,7,13,46.2%,26m
30728,2,VEGYTO,2439,204,5,6,11,45.5%,1h
30728,2,TNT,2439,124,5,7,12,41.7%,3h
30728,3,Favhos,2439,168,4,4,8,50.0%,2h
30728,2,[TgAg2]Razzler,2439,146,4,8,12,33.3%,34m
30728,3,Diff,2439,62,3,4,7,42.9%,1h
30728,2,lukhat,2439,88,2,2,4,50.0%,53m
30728,2,KoolAidsman,2439,117,2,3,5,40.0%,2h
30728,1,MurderMage,2439,0,2,6,8,25.0%,2h
30728,3,Vamp,2439,30,1,1,2,50.0%,12m
30728,3,[0o]Toganas,2439,0,1,4,5,20.0%,1h
30728,2,fang,2439,0,1,5,6,16.7%,2h
30728,3,DjJazzyGeoff,2439,30,1,6,7,14.3%,2h
30728,3,[Wesye]Wesye,2439,0,0,5,5,0.0%,37m
30751,3,PrizeFighter,2438,1202,263,261,524,50.2%,10m
30751,2,Lushbunny,2438,1608,124,125,249,49.8%,34m
30751,3,[TRTHS]DrPhilGood,2438,497,71,71,142,50.0%,1h
30751,2,ELCAZADORZ,2438,1284,48,56,104,46.2%,2h
30751,3,Matt,2438,871,34,37,71,47.9%,54m
30751,3,ADFACE,2438,851,33,28,61,54.1%,1h
30751,3,[nieBla]SOLDADOP,2438,533,23,10,33,69.7%,2h
30751,3,Mooncake,2438,572,22,19,41,53.7%,2h
30751,3,Mapache,2438,540,20,17,37,54.1%,1h
30751,3,giansa,2438,442,17,14,31,54.8%,15m
30751,3,ArmD,2438,228,10,9,19,52.6%,30m
30751,3,Eviran,2438,111,6,2,8,75.0%,58m
30751,3,guilherme,2438,182,6,8,14,42.9%,49m
30751,3,Nether,2438,86,3,4,7,42.9%,1h
30751,2,Vaiolis,2438,30,3,6,9,33.3%,2h
30751,2,[PTHero]Unrefined,2438,106,3,12,15,20.0%,52m
30751,1,Thyrrenus,2438,145,2,2,4,50.0%,56m
30751,3,[4Vic]AllAmKorean,2438,95,2,4,6,33.3%,12m
30751,1,[OPSQ]Alpha,2438,0,1,4,5,20.0%,10m
30751,3,ggyo,2438,0,0,1,1,0.0%,2h
30751,3,AFK,2438,0,0,1,1,0.0%,1h
30772,3,Porny,2437,1581,160,156,316,50.6%,53m
30772,2,Wizang,2437,1368,155,159,314,49.4%,1h
30772,3,neobula,2437,1615,112,107,219,51.1%,36m
30772,3,marduk,2437,915,34,38,72,47.2%,13m
30772,2,Didgeridoo,2437,291,27,28,55,49.1%,2h
30772,1,DredSero,2437,328,14,10,24,58.3%,41m
30772,3,Buck,2437,176,7,5,12,58.3%,2h
30772,2,Ramso,2437,223,7,10,17,41.2%,2h
30772,3,Intrepid,2437,148,5,5,10,50.0%,22m
30772,3,RickHarrison,2437,90,5,6,11,45.5%,2h
30772,3,jhonny,2437,114,4,4,8,50.0%,2m
30772,2,[WOTG]Guingon,2437,197,4,7,11,36.4%,2h
30772,3,[AoBDE]itsyimsanity,2437,141,3,1,4,75.0%,1h
30772,3,DanTheMan,2437,0,3,2,5,60.0%,2h
30772,3,[BadBoi]Nebula,2437,58,3,2,5,60.0%,2h
30772,3,ThegodFather,2437,30,2,1,3,66.7%,49m
30772,3,Lore,2437,0,1,0,1,100.0%,16m
30772,1,[MPO]bubbaturps,2437,0,1,4,5,20.0%,2h
30772,3,HaPeniss,2437,0,0,1,1,0.0%,3h
30772,3,Velderax,2437,0,0,1,1,0.0%,13m
30792,2,antagomiR,2436,1177,49,51,100,49.0%,59m
30792,2,destroyeric,2436,425,33,37,70,47.1%,13m
30792,1,[BOOF22]Sirfire,2436,728,27,37,64,42.2%,22m
30792,3,Master,2436,536,26,27,53,49.1%,2h
30792,3,NoJokeMstDpe,2436,595,24,22,46,52.2%,2h
30792,3,Zoom,2436,578,22,18,40,55.0%,47m
30792,3,João,2436,392,17,16,33,51.5%,30m
30792,1,whyalwaysme,2436,528,17,31,48,35.4%,1h
30792,3,Sakthepro,2436,443,16,13,29,55.2%,13m
30792,3,MomoT,2436,356,16,17,33,48.5%,59m
30792,3,phreddyboy,2436,64,4,6,10,40.0%,39m
30792,1,Deadmund,2436,9,4,11,15,26.7%,2h
30792,3,twoers,2436,86,3,4,7,42.9%,1h
30792,1,apilliancj,2436,30,3,6,9,33.3%,1h
30792,3,Southpaw,2436,0,2,5,7,28.6%,39m
30792,1,Anulot,2436,0,1,4,5,20.0%,2h
30792,3,[Reveus]Mortred,2436,0,0,1,1,0.0%,44m
30792,1,ricosuave,2436,0,0,3,3,0.0%,60m
30810,2,deeto,2435,1608,150,143,293,51.2%,52m
30810,2,INGRAM,2435,1169,55,61,116,47.4%,24m
30810,3,AustiN,2435,998,47,37,84,56.0%,3h
30810,3,netcat,2435,305,12,6,18,66.7%,2h
30810,3,Aegon,2435,293,11,6,17,64.7%,2h
30810,2,DeathWeed,2435,258,11,14,25,44.0%,2h
30810,2,DonMoses,2435,280,11,17,28,39.3%,34m
30810,3,[LTWAR]Boogieman,2435,207,9,14,23,39.1%,9m
30810,2,JuJuJuice,2435,160,6,8,14,42.9%,2h
30810,3,ThizzFace,2435,118,5,4,9,55.6%,1h
30810,2,Steeledmite,2435,132,5,6,11,45.5%,1h
30810,3,GenPurge,2435,96,4,0,4,100.0%,53m
30810,3,DMC,2435,170,4,3,7,57.1%,56m
30810,3,Ziggy,2435,97,4,3,7,57.1%,2h
30810,1,kamisarada,2435,0,3,2,5,60.0%,3h
30810,3,[cluez]kramos,2435,86,3,3,6,50.0%,43m
30810,3,QuBuS,2435,129,3,5,8,37.5%,11m
30810,1,Harmoxio,2435,0,3,7,10,30.0%,1h
30810,3,Overlord,2435,60,2,2,4,50.0%,2h
30810,1,DarkStar,2435,0,2,3,5,40.0%,26m
30810,3,Fluffykitti,2435,0,2,6,8,25.0%,37m
30810,3,karupika,2435,0,1,0,1,100.0%,58m
30810,3,Aidion,2435,0,1,4,5,20.0%,53m
30810,2,TimmyTurner,2435,96,1,5,6,16.7%,2h
30810,3,Publius,2435,0,0,1,1,0.0%,2h
30810,3,ShadowNinja,2435,0,0,2,2,0.0%,53m
30810,3,[ThCz]DeathBringer,2435,0,0,3,3,0.0%,53m
30810,3,yoyo,2435,0,0,3,3,0.0%,3h
30810,2,[TOYOTA]CelicaPower,2435,0,0,5,5,0.0%,51m
30839,1,Chipermix,2434,322,41,44,85,48.2%,3h
30839,2,sabalj,2434,470,16,17,33,48.5%,3h
30839,3,[Vibing]AntiAntiChad,2434,392,16,21,37,43.2%,32m
30839,2,[D5FTWA]Zander,2434,388,15,11,26,57.7%,44m
30839,3,Skinny,2434,333,14,15,29,48.3%,2h
30839,3,[Jimson]Thehightimes,2434,266,10,10,20,50.0%,2h
30839,3,GTCRAFTER,2434,216,8,14,22,36.4%,1h
30839,3,Diaz,2434,210,7,2,9,77.8%,2h
30839,3,[DNKCFT]FappyToad,2434,199,5,6,11,45.5%,47m
30839,3,samanticz,2434,0,4,1,5,80.0%,3h
30839,3,DoctorTaco,2434,123,4,6,10,40.0%,3h
30839,2,[D4NG1T]Napkins,2434,90,3,3,6,50.0%,2h
30839,3,whatever,2434,90,3,6,9,33.3%,47m
30839,3,Nojuanlikesu,2434,0,2,3,5,40.0%,53m
30839,3,Inukai,2434,0,2,4,6,33.3%,2h
30839,3,Garbageday,2434,0,1,4,5,20.0%,2h
30839,3,Hakujin,2434,0,1,4,5,20.0%,2h
30839,3,StAkeouT,2434,0,1,4,5,20.0%,1h
30839,3,STARLORD,2434,0,0,1,1,0.0%,31m
30839,3,BokalLotku,2434,0,0,1,1,0.0%,15m
30859,2,admiral,2433,1444,237,234,471,50.3%,3h
30859,2,[Dnwlkr]Moad,2433,1571,97,97,194,50.0%,1h
30859,2,GuerrillaCkn,2433,470,41,40,81,50.6%,2h
30859,3,Leade,2433,825,40,30,70,57.1%,7m
30859,2,Vicious,2433,999,39,35,74,52.7%,2h
30859,3,MemeMachine,2433,563,22,17,39,56.4%,1h
30859,3,[RePts]Everton,2433,294,11,9,20,55.0%,9m
30859,3,TyCoAvenger,2433,277,10,10,20,50.0%,47m
30859,2,LocoCoconut,2433,231,9,10,19,47.4%,2h
30859,3,[GDJ]Raikomantis,2433,218,6,5,11,54.5%,2h
30859,3,uFFoZ,2433,90,3,4,7,42.9%,47m
30859,3,wreckinball,2433,151,3,4,7,42.9%,11m
30859,1,BlizzyB,2433,0,2,3,5,40.0%,2h
30859,3,BoolinBoiler,2433,0,2,4,6,33.3%,2h
30859,1,UNDERTAKER,2433,0,2,5,7,28.6%,34m
30859,3,[SPQ]RMJ,2433,30,1,3,4,25.0%,3m
30859,3,IlPablolI,2433,30,1,3,4,25.0%,2h
30859,3,darkstrar,2433,0,0,5,5,0.0%,4m
30877,3,NoobOnTour,2432,1022,116,120,236,49.2%,2h
30877,3,Girotzu,2432,532,21,17,38,55.3%,22m
30877,2,gOcAtFiSh,2432,454,17,16,33,51.5%,53m
30877,3,RawbDoggy,2432,362,16,13,29,55.2%,39m
30877,3,FIRB,2432,351,15,13,28,53.6%,1h
30877,2,Jeed,2432,284,13,21,34,38.2%,33m
30877,3,[xXGDXx]Zero,2432,314,12,11,23,52.2%,2h
30877,2,[TNAC]NinjaPigeon,2432,330,12,14,26,46.2%,2h
30877,3,[Cagon]ElNeGro,2432,308,11,8,19,57.9%,7m
30877,2,Gois,2432,222,10,7,17,58.8%,1h
30877,3,Siege,2432,318,10,10,20,50.0%,54m
30877,3,[kins]Joskin,2432,237,9,11,20,45.0%,2h
30877,3,RBKeys,2432,154,8,14,22,36.4%,4m
30877,3,Karma,2432,193,7,5,12,58.3%,49m
30877,2,ProtectorCur,2432,132,6,9,15,40.0%,53m
30877,1,seeingdouble,2432,143,5,9,14,35.7%,42m
30877,1,Hurtcules,2432,0,3,2,5,60.0%,1h
30877,3,[lulzzz]IIIIIIIIIIII,2432,139,3,3,6,50.0%,46m
30877,3,[DHZAcD]Elcabesion,2432,79,3,5,8,37.5%,48m
30877,3,Pamelo,2432,117,3,5,8,37.5%,12m
30877,3,Cuckophany,2432,147,3,7,10,30.0%,2h
30877,3,Swagikarp,2432,32,3,7,10,30.0%,2m
30877,1,henessyXO,2432,0,2,3,5,40.0%,3h
30877,1,VINCE,2432,0,1,4,5,20.0%,2h
30877,3,Simplicity,2432,0,0,1,1,0.0%,46m
30877,3,[Bignoz]dlauzon,2432,0,0,1,1,0.0%,16m
30877,3,FRLrandom,2432,0,0,1,1,0.0%,2h
30877,2,harbinger,2432,0,0,6,6,0.0%,2h
30905,2,[C4Max]Jovani,2431,1451,124,118,242,51.2%,3h
30905,3,Batizerg,2431,1521,62,53,115,53.9%,53m
30905,2,fiyarburst,2431,1229,58,60,118,49.2%,2h
30905,3,[VFam2]TecCa,2431,1174,55,25,80,68.8%,2h
30905,1,Kow,2431,762,53,57,110,48.2%,36m
30905,3,alex,2431,1150,48,42,90,53.3%,43m
30905,3,Rurikari,2431,826,36,23,59,61.0%,23m
30905,3,FrostyFlakes,2431,750,31,22,53,58.5%,32m
30905,3,NohVarr,2431,675,28,25,53,52.8%,2h
30905,3,[TGCrew]Krakpot,2431,637,27,20,47,57.4%,3h
30905,3,Gibsuuun,2431,704,25,22,47,53.2%,34m
30905,3,CptObvious,2431,246,12,7,19,63.2%,36m
30905,3,[JusfFF]SoPlayNet,2431,274,11,9,20,55.0%,29m
30905,3,[PO342]Toxic,2431,288,10,6,16,62.5%,2h
30905,2,LomitoMiau,2431,275,9,8,17,52.9%,2h
30905,2,Permatrago,2431,286,9,11,20,45.0%,3h
30905,3,Crisco,2431,208,6,4,10,60.0%,2h
30905,2,[Giorg]Sergiojj,2431,151,4,6,10,40.0%,3m
30905,3,JediKnight,2431,145,4,6,10,40.0%,56m
30905,3,[NLTN]GamiinYager,2431,47,3,3,6,50.0%,2h
30905,3,NeKrosis,2431,120,3,5,8,37.5%,32m
30905,3,Fiery,2431,88,3,6,9,33.3%,2h
30905,2,SnickersII,2431,130,2,3,5,40.0%,2h
30905,3,shadow,2431,30,2,6,8,25.0%,53m
30905,2,[BQB]BaleiaDumba,2431,0,1,6,7,14.3%,1h
30905,3,ProMyToss,2431,0,0,1,1,0.0%,2h
30931,2,snake,2430,989,117,101,218,53.7%,24m
30931,3,MrC,2430,1269,59,30,89,66.3%,1h
30931,3,[TuBE]Woltube,2430,376,14,12,26,53.8%,52m
30931,3,Doce,2430,323,13,4,17,76.5%,4m
30931,2,[99A123]ªªXTaperXªª,2430,300,10,12,22,45.5%,17m
30931,2,NoManNo,2430,328,9,8,17,52.9%,2h
30931,3,DiabloSUCKIT,2430,136,5,3,8,62.5%,2h
30931,2,StarSim,2430,191,5,12,17,29.4%,34m
30931,3,HeroGhots,2430,167,4,1,5,80.0%,5m
30931,3,TDS,2430,118,4,3,7,57.1%,12m
30931,3,Kala,2430,140,4,5,9,44.4%,2h
30931,2,baS,2430,46,4,7,11,36.4%,1h
30931,3,[SH1BA]Alice,2430,72,2,4,6,33.3%,2h
30931,2,Cyclone,2430,0,1,5,6,16.7%,2h
30931,3,Rolimao,2430,0,0,4,4,0.0%,1h
30946,2,Continentals,2429,526,40,38,78,51.3%,2h
30946,2,Mystic,2429,531,24,26,50,48.0%,35m
30946,2,[SPARK3]sincroknight,2429,490,22,22,44,50.0%,52m
30946,1,Neah,2429,517,17,24,41,41.5%,9m
30946,3,Givvix,2429,342,13,11,24,54.2%,2h
30946,3,Slartibart,2429,274,11,10,21,52.4%,2h
30946,2,DrCrappy,2429,149,9,12,21,42.9%,23m
30946,2,GoodSir,2429,189,7,10,17,41.2%,13m
30946,2,tbirdxi,2429,188,7,12,19,36.8%,39m
30946,1,[UWISH]GrewalB,2429,172,5,3,8,62.5%,2h
30946,3,wubwub,2429,131,3,1,4,75.0%,47m
30946,2,AlredyTaken,2429,122,3,5,8,37.5%,2h
30946,3,Irving,2429,97,3,5,8,37.5%,56m
30946,3,brainsrgood,2429,97,2,0,2,100.0%,44m
30946,3,artnquest,2429,40,2,1,3,66.7%,1h
30946,1,killer,2429,0,2,3,5,40.0%,2h
30946,3,[B3H0LD]ZerathianPie,2429,30,1,1,2,50.0%,2h
30946,3,Cananball,2429,0,0,1,1,0.0%,2h
30946,3,GuineaPiglet,2429,0,0,2,2,0.0%,11m
30946,1,Vapour,2429,0,0,3,3,0.0%,1h
30966,1,[Lp]Mutalisk,2428,1603,97,103,200,48.5%,12m
30966,2,DarkProdigy,2428,1589,95,97,192,49.5%,3m
30966,2,Kira,2428,848,69,72,141,48.9%,51m
30966,3,ComeInYourEy,2428,1162,47,44,91,51.6%,1h
30966,3,[ØÛ]Montagordas,2428,595,34,14,48,70.8%,2h
30966,1,[iDrunk]Optimus,2428,713,28,32,60,46.7%,2h
30966,2,[PobSC]Tenebrio,2428,592,20,28,48,41.7%,40m
30966,2,[Rastah]Xerxes,2428,432,15,23,38,39.5%,51m
30966,1,CubeBrick,2428,80,14,25,39,35.9%,3h
30966,3,BaldFiveHead,2428,260,9,9,18,50.0%,1h
30966,3,JIMBO,2428,257,8,4,12,66.7%,12m
30966,2,Perseverance,2428,152,6,11,17,35.3%,35m
30966,3,bdfg,2428,172,5,8,13,38.5%,29m
30966,2,sanghyunhan,2428,88,4,10,14,28.6%,19m
30966,3,TassadarX,2428,62,3,4,7,42.9%,36m
30966,3,Shiho,2428,129,3,5,8,37.5%,2h
30966,2,xHAx,2428,0,2,5,7,28.6%,30m
30966,3,Demon,2428,0,2,5,7,28.6%,53m
30966,3,Starlord,2428,0,1,0,1,100.0%,3h
30966,3,abc,2428,30,1,2,3,33.3%,2h
30966,1,scanorsss,2428,0,1,4,5,20.0%,18m
30966,1,ElSanti,2428,0,1,4,5,20.0%,3h
30966,3,Cuauhtli,2428,0,1,4,5,20.0%,2h
30966,3,Dayobi,2428,30,1,5,6,16.7%,53m
30966,3,GilGaWech,2428,30,1,5,6,16.7%,2h
30966,3,[POL]WildRage,2428,0,0,1,1,0.0%,2h
30966,3,crackervirus,2428,0,0,2,2,0.0%,29m
30966,3,mazer,2428,0,0,3,3,0.0%,2h
30994,3,SilentSword,2427,814,75,54,129,58.1%,12m
30994,3,atrydes,2427,1099,51,35,86,59.3%,2h
30994,2,Ownification,2427,1134,45,55,100,45.0%,47m
30994,1,[OceanT]DiegoS,2427,429,30,35,65,46.2%,2h
30994,3,[ApexZ]XenoMorphS,2427,390,17,6,23,73.9%,2h
30994,1,[Sacs]Cousin,2427,260,9,12,21,42.9%,3h
30994,3,Shadownata,2427,143,8,10,18,44.4%,45m
30994,2,HTFovermind,2427,182,7,11,18,38.9%,2h
30994,3,WrathofScott,2427,151,6,10,16,37.5%,17m
30994,3,Seductive,2427,189,5,4,9,55.6%,2h
30994,3,[Best01]MaverickPerú,2427,120,3,0,3,100.0%,59m
30994,3,[Lp]CoNcE,2427,145,3,2,5,60.0%,37m
30994,1,FirstBorn,2427,48,2,1,3,66.7%,59m
30994,1,Rembertje,2427,0,2,3,5,40.0%,3h
30994,1,Noobtastic,2427,48,2,4,6,33.3%,1h
30994,3,MaRiNe,2427,115,2,6,8,25.0%,53m
30994,3,DavyRex,2427,0,1,0,1,100.0%,2h
30994,1,FelicityRae,2427,0,1,4,5,20.0%,2h
30994,3,Zeratulgost,2427,0,1,5,6,16.7%,26m
30994,3,liveordie,2427,0,0,1,1,0.0%,2m
30994,1,Axeman,2427,0,0,1,1,0.0%,3h
30994,3,Pixel,2427,0,0,1,1,0.0%,58m
30994,3,[Chubak]GeceTuTerror,2427,0,0,1,1,0.0%,12m
30994,1,Mike,2427,0,0,7,7,0.0%,1h
31018,1,[GuN]Duke,2426,1627,258,267,525,49.1%,38m
31018,3,FrogMan,2426,410,39,24,63,61.9%,16m
31018,3,[AbcCo]Zgiro,2426,693,30,15,45,66.7%,37m
31018,2,Abasu,2426,805,30,30,60,50.0%,3h
31018,3,HandiQuacked,2426,567,25,10,35,71.4%,2h
31018,1,[KGH4]SirJohny,2426,404,15,19,34,44.1%,34m
31018,1,catmonkey,2426,264,11,12,23,47.8%,12m
31018,1,FavorTheBold,2426,211,9,10,19,47.4%,37m
31018,3,[FCKRS]Jshen,2426,238,8,7,15,53.3%,2h
31018,3,acoolalien,2426,264,8,10,18,44.4%,32m
31018,3,KingTong,2426,188,5,2,7,71.4%,55m
31018,1,Shikezi,2426,48,3,1,4,75.0%,2h
31018,2,PRES,2426,116,3,6,9,33.3%,40m
31018,3,[ZergPE]Atherionte,2426,30,1,2,3,33.3%,49m
31018,1,Hondoh,2426,0,1,4,5,20.0%,3h
31018,3,JustSaiyan,2426,0,1,4,5,20.0%,53m
31018,1,chinloko,2426,0,1,4,5,20.0%,3h
31018,2,moridinamael,2426,30,1,8,9,11.1%,13m
31018,3,Voodoochild,2426,0,0,1,1,0.0%,1h
31018,3,Deadwing,2426,0,0,1,1,0.0%,2h
31038,3,Srovid,2425,1590,124,120,244,50.8%,1h
31038,3,kobalt,2425,1324,97,82,179,54.2%,3h
31038,3,[TxPain]Leopardeye,2425,863,53,19,72,73.6%,47m
31038,3,acsimpson,2425,1228,52,41,93,55.9%,2h
31038,3,Zephyr,2425,493,23,20,43,53.5%,2h
31038,3,Mrowsudyn,2425,480,19,18,37,51.4%,1h
31038,3,Nyoei,2425,373,15,12,27,55.6%,2h
31038,2,[Mstyck]Zire,2425,412,14,16,30,46.7%,1h
31038,3,snaddladd,2425,286,10,9,19,52.6%,37m
31038,3,Sebastian,2425,174,7,8,15,46.7%,59m
31038,2,pipo,2425,228,6,4,10,60.0%,3h
31038,3,[Fellaz]BigHeadTTV,2425,165,6,7,13,46.2%,23m
31038,2,Randir,2425,92,6,8,14,42.9%,34m
31038,3,vanillashake,2425,125,3,0,3,100.0%,19m
31038,3,Bryan,2425,136,3,1,4,75.0%,2h
31038,3,Yiffrey,2425,121,2,3,5,40.0%,6m
31038,3,[Lp]Nyker,2425,0,2,6,8,25.0%,3h
31038,3,Doomkiin,2425,0,0,1,1,0.0%,26m
31038,3,josseb,2425,0,0,1,1,0.0%,2h
31038,3,Hernan,2425,0,0,3,3,0.0%,2h
31058,3,luigfire,2424,1515,70,72,142,49.3%,2h
31058,2,loljinsung,2424,1398,56,56,112,50.0%,24m
31058,3,Touchme,2424,993,41,31,72,56.9%,13m
31058,3,monstergog,2424,684,38,36,74,51.4%,29m
31058,3,CYPH,2424,606,26,19,45,57.8%,46m
31058,3,[DKGLL]KALDALIZ,2424,368,13,8,21,61.9%,2h
31058,3,brett,2424,247,12,13,25,48.0%,7m
31058,2,[WoLv3S]Knightghost,2424,222,9,9,18,50.0%,44m
31058,2,stickineye,2424,326,9,17,26,34.6%,34m
31058,1,Trogdor,2424,212,6,18,24,25.0%,18m
31058,1,CoughDrop,2424,0,2,3,5,40.0%,3h
31058,3,Autistaqliao,2424,0,2,5,7,28.6%,56m
31058,1,Chaos,2424,0,2,6,8,25.0%,2m
31058,3,[CzdT]neurOKiller,2424,0,1,0,1,100.0%,32m
31058,3,beto,2424,0,1,1,2,50.0%,2h
31058,2,Warrior,2424,0,0,1,1,0.0%,60m
31058,3,zorgon,2424,0,0,1,1,0.0%,2m
31058,3,carbot,2424,0,0,1,1,0.0%,2h
31076,3,BunnyRabbit,2423,1619,136,125,261,52.1%,9m
31076,2,blinx,2423,1444,78,69,147,53.1%,53m
31076,3,rmtsukuru,2423,1469,73,75,148,49.3%,2h
31076,2,Fogline,2423,830,41,43,84,48.8%,1h
31076,2,[Wehavu]Qetzc,2423,353,19,16,35,54.3%,3h
31076,3,SHARK,2423,425,16,17,33,48.5%,2h
31076,3,RDK,2423,406,14,13,27,51.9%,45m
31076,3,Jos,2423,324,12,13,25,48.0%,32m
31076,3,[LOHs]Pertado,2423,252,10,10,20,50.0%,15m
31076,2,macros,2423,296,10,12,22,45.5%,9m
31076,3,Draco,2423,224,9,8,17,52.9%,12m
31076,3,[Msia]ChangTian,2423,252,9,11,20,45.0%,12m
31076,3,asd,2423,221,8,8,16,50.0%,2h
31076,2,Toast,2423,124,7,8,15,46.7%,3h
31076,3,Apis,2423,118,5,3,8,62.5%,29m
31076,2,NINJAJOOSH,2423,0,4,2,6,66.7%,2h
31076,1,[FyHr]IronIc,2423,97,4,6,10,40.0%,57m
31076,2,xValhallax,2423,60,3,8,11,27.3%,3h
31076,3,Allenon,2423,30,2,4,6,33.3%,1h
31076,1,AyaseXKirino,2423,97,2,4,6,33.3%,3h
31076,3,Dicer,2423,30,1,1,2,50.0%,9m
31076,1,Xsendbobs,2423,0,1,2,3,33.3%,16m
31076,1,Sol,2423,0,1,4,5,20.0%,1h
31076,3,JortrixHD,2423,0,1,4,5,20.0%,2h
31076,2,[ConFed]StephanCF,2423,32,1,7,8,12.5%,2h
31076,3,pikiwini,2423,0,0,1,1,0.0%,53m
31076,3,jack,2423,0,0,3,3,0.0%,2h
31076,3,JohnFortune,2423,0,0,5,5,0.0%,1h
31104,2,hobosexual,2422,1265,99,102,201,49.3%,53m
31104,3,[copain]HerMod,2422,1069,50,37,87,57.5%,2h
31104,2,Lieriant,2422,636,47,44,91,51.6%,51m
31104,3,Pulz,2422,1011,41,37,78,52.6%,2h
31104,1,BattleDruxs,2422,629,25,38,63,39.7%,39m
31104,2,tuxcart,2422,560,22,26,48,45.8%,35m
31104,2,[kisay]Relover,2422,496,20,16,36,55.6%,3h
31104,3,Quezendogger,2422,210,19,14,33,57.6%,32m
31104,3,christopher,2422,309,19,22,41,46.3%,1h
31104,3,monkemaster,2422,280,18,2,20,90.0%,52m
31104,3,[EOKA]Spartacus,2422,358,13,13,26,50.0%,2h
31104,1,butcher,2422,218,7,20,27,25.9%,45m
31104,3,Speltpsyco,2422,102,5,6,11,45.5%,45m
31104,3,Grif,2422,100,3,5,8,37.5%,32m
31104,3,MapHacksTM,2422,145,3,6,9,33.3%,2m
31104,1,PineSol,2422,0,2,3,5,40.0%,3h
31104,3,WifeWhereYou,2422,123,2,4,6,33.3%,2h
31104,3,[TAKAX2]ReturN,2422,64,2,5,7,28.6%,1h
31104,2,Barcode,2422,30,2,6,8,25.0%,33m
31104,3,SavageOpress,2422,96,1,1,2,50.0%,53m
31104,3,PortMortGort,2422,0,1,4,5,20.0%,1h
31104,3,Syf,2422,0,0,1,1,0.0%,47m
31104,3,[DIANE]Videowaffles,2422,0,0,1,1,0.0%,58m
31104,1,TheDankyYoyo,2422,0,0,1,1,0.0%,2h
31104,3,Geryon,2422,0,0,1,1,0.0%,2h
31129,2,LeroyBobby,2421,741,71,74,145,49.0%,9m
31129,3,jpeter,2421,634,62,60,122,50.8%,16m
31129,2,Bofo,2421,558,18,23,41,43.9%,38m
31129,3,[PapaG]GOFER,2421,340,12,12,24,50.0%,22m
31129,1,Billeygaming,2421,267,11,11,22,50.0%,3h
31129,3,[Haze4z]Bluedreamz,2421,256,9,11,20,45.0%,16m
31129,3,[SBlock]edsonQ,2421,204,8,6,14,57.1%,9m
31129,1,Vaginelle,2421,171,6,9,15,40.0%,3h
31129,3,mehmehmeh,2421,168,5,3,8,62.5%,45m
31129,3,[pogga]GreenPenguin,2421,142,5,4,9,55.6%,2h
31129,3,[CLCH]WintersFury,2421,119,4,4,8,50.0%,5m
31129,2,Bakingchad,2421,129,4,6,10,40.0%,3h
31129,2,[Cannel]KelayrChanel,2421,129,4,8,12,33.3%,3h
31129,3,SoftBanana,2421,122,4,9,13,30.8%,3h
31129,3,MrFufu,2421,58,3,4,7,42.9%,22m
31129,3,Therion,2421,60,3,5,8,37.5%,2h
31129,3,MontanaLogan,2421,0,1,1,2,50.0%,23m
31129,1,Hivemind,2421,0,1,4,5,20.0%,43m
31129,1,Zeraphiel,2421,0,0,1,1,0.0%,1h
31129,3,billy,2421,0,0,5,5,0.0%,11m
31149,3,Ghost,2420,1443,67,68,135,49.6%,3h
31149,3,Pagonas,2420,561,35,33,68,51.5%,1h
31149,2,[LMI42]DaBoss,2420,728,27,30,57,47.4%,3h
31149,2,FalconSmash,2420,463,16,20,36,44.4%,3h
31149,2,Scud,2420,439,15,22,37,40.5%,36m
31149,3,Listerin,2420,317,11,16,27,40.7%,3h
31149,1,EveOnline,2420,219,9,11,20,45.0%,2h
31149,3,bradjohns,2420,245,7,7,14,50.0%,2h
31149,3,FinnMB,2420,139,4,4,8,50.0%,3h
31149,2,Satanos,2420,113,3,2,5,60.0%,2h
31149,2,juneyi,2420,139,3,5,8,37.5%,60m
31149,3,Coda,2420,30,2,1,3,66.7%,45m
31149,3,Hrunting,2420,60,2,6,8,25.0%,2h
31149,3,[owOOwo]Birdy,2420,30,1,5,6,16.7%,9m
31149,3,TTVMathew,2420,0,0,1,1,0.0%,2h
31149,2,[LibTec]MERUPRIME,2420,0,0,2,2,0.0%,2h
31149,2,ELPRESIDENTE,2420,0,0,9,9,0.0%,2h
31166,3,wounded,2419,1547,131,125,256,51.2%,2h
31166,3,sosa,2419,1564,125,118,243,51.4%,2h
31166,3,[Mc]Jupiter,2419,1525,68,62,130,52.3%,1h
31166,2,Nooze,2419,570,59,59,118,50.0%,51m
31166,3,Ninilin,2419,706,31,20,51,60.8%,29m
31166,3,Stza,2419,652,27,16,43,62.8%,49m
31166,3,SuperSoaker,2419,206,18,10,28,64.3%,45m
31166,3,Deadlyremi,2419,304,14,20,34,41.2%,15m
31166,3,[ConFed]Python,2419,219,13,12,25,52.0%,2h
31166,1,[GLHFJJ]Caleb,2419,304,11,13,24,45.8%,2h
31166,3,proggleyes,2419,264,10,3,13,76.9%,1h
31166,3,beerbelly,2419,178,7,9,16,43.8%,12m
31166,2,FreshGordon,2419,168,6,9,15,40.0%,19m
31166,3,SolarManatee,2419,160,6,9,15,40.0%,44m
31166,2,[seattl]Arock,2419,196,6,9,15,40.0%,29m
31166,3,[PUPUS]Gabo,2419,88,4,4,8,50.0%,2h
31166,3,DQN,2419,118,3,5,8,37.5%,2h
31166,2,[DGr8]GreyFox,2419,88,2,2,4,50.0%,2h
31166,3,SkyTyman,2419,90,2,2,4,50.0%,5m
31166,1,OmgItsVlad,2419,122,2,3,5,40.0%,3h
31166,3,Hank,2419,97,2,5,7,28.6%,19m
31166,2,[Pro999]Ischraelfurr,2419,0,1,1,2,50.0%,39m
31166,3,kevinm,2419,36,1,3,4,25.0%,5m
31166,1,Nandikin,2419,0,1,4,5,20.0%,2h
31166,1,WzLang,2419,0,1,5,6,16.7%,57m
31166,3,kgadon,2419,0,0,1,1,0.0%,30m
31166,3,[CCPcl]Crafter,2419,0,0,1,1,0.0%,7m
31166,2,Kit,2419,0,0,2,2,0.0%,60m
31166,1,Scantron,2419,0,0,2,2,0.0%,60m
31195,1,Callipygian,2418,1030,206,214,420,49.0%,53m
31195,2,CyberTiger,2418,1370,119,117,236,50.4%,2h
31195,3,AIBYL,2418,1077,91,88,179,50.8%,34m
31195,2,Somnus,2418,1357,60,60,120,50.0%,12m
31195,2,[ISNULL]MajorOwnage,2418,655,23,29,52,44.2%,3h
31195,1,Zauberer,2418,274,19,24,43,44.2%,39m
31195,3,[JGG]ishatmypants,2418,464,17,16,33,51.5%,2h
31195,3,[RustLg]sctwosuxcoc,2418,434,17,16,33,51.5%,13m
31195,1,slimjim,2418,228,11,13,24,45.8%,40m
31195,1,TheMustard,2418,232,10,15,25,40.0%,46m
31195,3,[DRU1DS]aaldwyn,2418,238,8,9,17,47.1%,12m
31195,2,akirakato,2418,212,8,15,23,34.8%,50m
31195,3,danielobao,2418,213,7,3,10,70.0%,2h
31195,2,LGdakine,2418,200,7,11,18,38.9%,20m
31195,3,ELPAPAS,2418,174,6,7,13,46.2%,16m
31195,3,Northside,2418,131,5,4,9,55.6%,53m
31195,3,MaiLyf,2418,136,4,6,10,40.0%,2h
31195,3,[AntCC]Hunter,2418,121,3,0,3,100.0%,2h
31195,1,[BlakMa]ATAT,2418,88,3,6,9,33.3%,60m
31195,3,sixxtynein,2418,92,3,6,9,33.3%,3h
31195,3,Juakinosky,2418,0,2,3,5,40.0%,12m
31195,3,Ted,2418,0,2,4,6,33.3%,55m
31195,3,[Aethus]BreakerFist,2418,30,2,5,7,28.6%,16m
31195,3,RippIN,2418,0,1,2,3,33.3%,1h
31195,1,umboday,2418,0,1,4,5,20.0%,2h
31195,3,MrHanky,2418,0,1,4,5,20.0%,2h
31195,1,Saske,2418,0,1,4,5,20.0%,45m
31195,3,Elementre,2418,0,0,1,1,0.0%,1h
31223,2,[EXPANT]Xog,2417,1426,324,332,656,49.4%,35m
31223,2,[PaO2]corncob,2417,1518,113,109,222,50.9%,2h
31223,3,ELBOTINO,2417,1265,57,44,101,56.4%,2h
31223,1,[LGDI]Arenium,2417,996,34,40,74,45.9%,46m
31223,3,cheekywanker,2417,515,21,19,40,52.5%,1h
31223,1,HuySunVin,2417,516,18,24,42,42.9%,21m
31223,1,Chaddington,2417,342,13,12,25,52.0%,41m
31223,3,dcfobreezy,2417,213,6,4,10,60.0%,49m
31223,3,Grumion,2417,140,6,5,11,54.5%,36m
31223,3,[Grackn]HypnoBimbo,2417,184,5,4,9,55.6%,54m
31223,3,[3JELLY]GeneralCobra,2417,90,4,4,8,50.0%,3h
31223,2,[LCE]zeth,2417,162,4,8,12,33.3%,17m
31223,3,Angel,2417,95,2,0,2,100.0%,9m
31223,3,yaboiii,2417,0,2,3,5,40.0%,2m
31223,3,nactoe,2417,58,2,4,6,33.3%,52m
31223,3,Levent,2417,30,2,5,7,28.6%,1h
31223,3,[xRtGac]Beardedragon,2417,58,2,5,7,28.6%,32m
31223,3,Watanuki,2417,0,1,0,1,100.0%,4m
31223,3,Demosthenes,2417,0,1,4,5,20.0%,43m
31223,3,BronzeHero,2417,0,0,1,1,0.0%,1h
31223,3,BabyMeat,2417,0,0,1,1,0.0%,16m
31244,3,Sive,2416,647,53,46,99,53.5%,3h
31244,3,josepler,2416,1240,53,47,100,53.0%,46m
31244,3,[PTHero]Gaddict,2416,919,48,36,84,57.1%,30m
31244,1,neosn,2416,597,22,31,53,41.5%,2h
31244,3,[Utes]craftedmare,2416,294,11,8,19,57.9%,16m
31244,1,[LOHd]FreyasGuard,2416,330,9,18,27,33.3%,45m
31244,3,[lIRoIl]esKILL,2416,149,4,6,10,40.0%,2h
31244,1,CHUNCHUNMARU,2416,97,2,5,7,28.6%,55m
31244,3,Robbie,2416,0,2,6,8,25.0%,2h
31244,3,[THlCC]Leavy,2416,0,1,0,1,100.0%,39m
31244,3,StimPackFury,2416,0,1,1,2,50.0%,3h
31244,3,Amorphous,2416,0,1,2,3,33.3%,7m
31244,1,SABYSALAS,2416,0,1,2,3,33.3%,40m
31244,3,SKYLEADER,2416,0,1,4,5,20.0%,37m
31244,3,Guywithgun,2416,0,0,1,1,0.0%,16m
31244,3,Kirael,2416,0,0,2,2,0.0%,2h
31260,3,[gnosis]tomasdpaz,2415,1356,95,95,190,50.0%,2h
31260,2,[AllyPG]Smittyblack,2415,1146,78,67,145,53.8%,2h
31260,2,[LOHs]kinabr,2415,637,34,30,64,53.1%,3h
31260,3,[zeita1]SOYTUCACHERO,2415,576,29,9,38,76.3%,36m
31260,3,[Silica]Hadez,2415,719,29,20,49,59.2%,53m
31260,3,[NGFR]Kacchan,2415,635,28,14,42,66.7%,3h
31260,3,[kGreen]Nate,2415,677,28,24,52,53.8%,1h
31260,3,dogis,2415,510,19,15,34,55.9%,2h
31260,3,dragonssez,2415,353,13,17,30,43.3%,44m
31260,3,Rane,2415,139,12,14,26,46.2%,49m
31260,3,BESTWINNER,2415,231,6,10,16,37.5%,47m
31260,3,Lennonizer,2415,165,5,2,7,71.4%,2h
31260,2,Higgins,2415,152,5,8,13,38.5%,19m
31260,3,ElectronChik,2415,111,4,8,12,33.3%,27m
31260,3,[1kbt8]Manu,2415,95,2,0,2,100.0%,2h
31260,3,Thanatos,2415,0,2,4,6,33.3%,1h
31260,1,ToRKennen,2415,97,2,4,6,33.3%,3h
31260,3,[VRC]ChunchuMaru,2415,60,2,4,6,33.3%,32m
31260,2,Yarg,2415,0,2,5,7,28.6%,59m
31260,3,[iMPG]LOCO,2415,0,1,1,2,50.0%,1h
31260,3,[DMONlC]nwo,2415,30,1,4,5,20.0%,22m
31260,3,Apollozaz,2415,0,0,1,1,0.0%,2h
31260,1,raether,2415,0,0,1,1,0.0%,3h
31283,2,enzo,2414,1514,256,257,513,49.9%,31m
31283,2,[LBanda]Cris,2414,567,22,24,46,47.8%,13m
31283,3,silveR,2414,301,13,10,23,56.5%,2h
31283,2,Bones,2414,290,10,19,29,34.5%,34m
31283,3,Micront,2414,237,8,9,17,47.1%,2h
31283,2,GWIZZ,2414,245,8,12,20,40.0%,3h
31283,3,binho,2414,183,6,3,9,66.7%,3h
31283,3,[OGB]YungSwagLord,2414,213,6,6,12,50.0%,2h
31283,3,[BW4EVA]ChowderBro,2414,139,4,2,6,66.7%,3h
31283,3,[TRUUMP]JaTinkles,2414,32,3,5,8,37.5%,19m
31283,3,MakkO,2414,148,3,5,8,37.5%,16m
31283,3,Sandman,2414,121,3,5,8,37.5%,2h
31283,1,Supremode,2414,0,2,3,5,40.0%,2h
31283,1,Guesz,2414,0,1,3,4,25.0%,2h
31283,1,[GRU]sinbad,2414,30,1,14,15,6.7%,51m
31283,1,Gabriel,2414,0,0,1,1,0.0%,12m
31283,2,[PRTSAP]MrMacGun,2414,0,0,6,6,0.0%,6m
31300,3,paluka,2413,579,75,68,143,52.4%,7m
31300,3,aaa,2413,331,35,29,64,54.7%,32m
31300,3,Lunchtime,2413,608,34,27,61,55.7%,2h
31300,1,Fckerator,2413,934,34,47,81,42.0%,24m
31300,3,TannedAlbino,2413,697,26,25,51,51.0%,5m
31300,3,[tCo9]steelgrim,2413,596,23,23,46,50.0%,3m
31300,3,nachomenxl,2413,439,18,18,36,50.0%,1h
31300,3,CptWaffles,2413,465,16,17,33,48.5%,49m
31300,3,Effortless,2413,322,13,6,19,68.4%,2h
31300,3,sellingmoms,2413,276,10,7,17,58.8%,59m
31300,1,MasterShake,2413,212,9,12,21,42.9%,46m
31300,3,MRHAZZARD,2413,170,7,4,11,63.6%,2m
31300,3,[MC40]KaveBlack,2413,168,4,4,8,50.0%,49m
31300,3,[MKING]ZERO,2413,0,2,3,5,40.0%,2h
31300,2,[Blawuk]Cohagen,2413,80,2,4,6,33.3%,60m
31300,3,ELVECTOR,2413,116,2,4,6,33.3%,2h
31300,3,[Atena]Gerarca,2413,60,2,7,9,22.2%,29m
31300,1,[RNSF]PaineTrain,2413,0,1,4,5,20.0%,11m
31300,1,Zarmathas,2413,0,1,4,5,20.0%,3h
31300,3,VODKANCRAN,2413,30,1,5,6,16.7%,2h
31320,2,Tubbs,2412,1387,108,101,209,51.7%,39m
31320,3,Nondual,2412,1432,64,58,122,52.5%,2h
31320,3,Malmgrenade,2412,647,24,23,47,51.1%,3h
31320,3,[neverb]SoloOp,2412,397,21,16,37,56.8%,2h
31320,3,Balvenie,2412,421,18,17,35,51.4%,43m
31320,3,FrozenFear,2412,496,17,21,38,44.7%,38m
31320,1,[Au4evr]Crocopotkine,2412,247,10,13,23,43.5%,3h
31320,3,Tim,2412,203,7,12,19,36.8%,3h
31320,2,John,2412,184,6,8,14,42.9%,47m
31320,3,AshMang,2412,129,4,6,10,40.0%,14m
31320,1,PieGuy,2412,89,3,6,9,33.3%,2h
31320,3,[XVar]Xcaliber,2412,30,2,2,4,50.0%,2h
31320,3,[nomame]Jyrolin,2412,30,2,3,5,40.0%,46m
31320,2,Doombringer,2412,44,2,3,5,40.0%,13m
31320,1,holocanth,2412,100,2,4,6,33.3%,1h
31320,2,Avalon,2412,0,2,5,7,28.6%,20m
31320,3,Dust,2412,96,1,1,2,50.0%,2h
31320,3,elroy,2412,0,1,1,2,50.0%,2h
31320,3,darkseekerx,2412,95,1,1,2,50.0%,1h
31320,2,Sleet,2412,0,1,6,7,14.3%,2h
31320,2,Manny,2412,0,0,2,2,0.0%,50m
31320,2,[CODER]Josef,2412,0,0,3,3,0.0%,60m
31342,3,[n1zzle]Ethan,2411,1493,93,81,174,53.4%,3h
31342,2,Constantine,2411,1401,92,88,180,51.1%,3h
31342,2,Grateful,2411,744,32,27,59,54.2%,3h
31342,3,Annyeong,2411,664,26,21,47,55.3%,1h
31342,3,Vermlin,2411,407,16,8,24,66.7%,2h
31342,1,minum,2411,431,15,25,40,37.5%,1h
31342,3,Mashico,2411,348,14,6,20,70.0%,2h
31342,3,Timezap,2411,277,13,14,27,48.1%,34m
31342,3,HandyAndy,2411,262,9,11,20,45.0%,16m
31342,3,Clam,2411,194,8,10,18,44.4%,55m
31342,3,DeathFog,2411,150,6,6,12,50.0%,55m
31342,2,[GINO]joshasaurus,2411,154,6,8,14,42.9%,13m
31342,3,NombreBacán,2411,144,3,1,4,75.0%,58m
31342,3,dvgamers,2411,30,2,1,3,66.7%,2h
31342,2,LionOfJudea,2411,30,2,7,9,22.2%,6m
31342,3,Bobert,2411,0,1,0,1,100.0%,2h
31342,3,TheEndDragon,2411,0,1,0,1,100.0%,54m
31342,3,[AOeOP]Bob,2411,0,1,0,1,100.0%,36m
31342,3,[PotPwn]Couchpotato,2411,95,1,1,2,50.0%,47m
31342,1,BlueSun,2411,0,0,1,1,0.0%,10m
31342,3,[PiGPan]NCJake,2411,0,0,1,1,0.0%,2h
31363,1,lui,2410,1495,165,149,314,52.5%,2h
31363,3,[D0NGL]skyoctopi,2410,1213,125,128,253,49.4%,16m
31363,3,[URINE]RamMan,2410,1318,120,101,221,54.3%,48m
31363,3,EricTheRed,2410,1582,77,63,140,55.0%,2h
31363,2,hayabusa,2410,769,32,28,60,53.3%,37m
31363,2,[BoAVN]Metablade,2410,676,25,21,46,54.3%,22m
31363,3,BARCODE,2410,478,22,9,31,71.0%,32m
31363,2,Jadwick,2410,412,15,19,34,44.1%,2h
31363,3,texugão,2410,287,10,6,16,62.5%,52m
31363,3,Tranzer,2410,114,4,5,9,44.4%,16m
31363,3,[TKRP]LoganBr,2410,0,3,2,5,60.0%,2h
31363,3,[GpoABX]Avikla,2410,119,2,2,4,50.0%,16m
31363,1,[KFA]WildMongoose,2410,48,2,4,6,33.3%,45m
31363,3,BetaMsg,2410,0,1,0,1,100.0%,1h
31363,3,donkey,2410,0,1,2,3,33.3%,3h
31378,3,AmberAlert,2409,1574,109,101,210,51.9%,23m
31378,2,Dafin,2409,1324,50,57,107,46.7%,2h
31378,3,booyagranny,2409,888,39,31,70,55.7%,3h
31378,3,Felfoce,2409,447,30,29,59,50.8%,22m
31378,3,Zanzibar,2409,661,27,25,52,51.9%,49m
31378,3,Roscoe,2409,403,24,13,37,64.9%,2h
31378,2,Samiell,2409,434,16,20,36,44.4%,44m
31378,2,RodolfoGuti,2409,413,16,20,36,44.4%,17m
31378,3,ENDZ,2409,355,13,14,27,48.1%,2m
31378,3,ablaze,2409,318,12,28,40,30.0%,15m
31378,2,Stash,2409,182,7,9,16,43.8%,60m
31378,3,[TFTG]Heven,2409,121,6,2,8,75.0%,53m
31378,3,[PMN]aKaGCurse,2409,175,6,5,11,54.5%,55m
31378,3,SuperStrats,2409,144,6,5,11,54.5%,38m
31378,3,ESPsparky,2409,160,4,3,7,57.1%,38m
31378,3,mna,2409,162,4,4,8,50.0%,1h
31378,2,FladKing,2409,164,4,8,12,33.3%,2h
31378,3,alizhiyu,2409,90,3,5,8,37.5%,2h
31378,1,Cortcyber,2409,100,3,9,12,25.0%,3h
31378,3,Darkmorbid,2409,30,2,1,3,66.7%,36m
31378,3,TrippleSix,2409,97,2,6,8,25.0%,2h
31378,3,[IQ30]CheezyMufins,2409,0,1,4,5,20.0%,2h
31378,3,Icculus,2409,0,1,4,5,20.0%,2h
31378,3,demolisher,2409,0,1,5,6,16.7%,30m
31378,3,KariTraa,2409,30,1,6,7,14.3%,53m
31378,3,Vcat,2409,0,0,3,3,0.0%,2h
31404,3,ohmeingott,2408,441,30,23,53,56.6%,32m
31404,3,Azuna,2408,542,25,19,44,56.8%,17m
31404,3,JambpX,2408,383,21,19,40,52.5%,47m
31404,2,[Sqwsh]HyperNova,2408,520,19,26,45,42.2%,2h
31404,3,PizzaZubuzo,2408,427,16,10,26,61.5%,53m
31404,3,entusnalgas,2408,384,15,7,22,68.2%,16m
31404,1,[PAJ]Snake,2408,434,15,26,41,36.6%,3h
31404,3,DISTROYER,2408,247,9,3,12,75.0%,32m
31404,3,[DRKDMN]GROV,2408,121,5,5,10,50.0%,12m
31404,3,[bergh]ShionShuu,2408,90,4,6,10,40.0%,13m
31404,3,Xyrus,2408,116,3,0,3,100.0%,46m
31404,3,MrNoodles,2408,96,2,1,3,66.7%,43m
31404,1,SrOrigami,2408,0,2,6,8,25.0%,1h
31404,3,NBLOmama,2408,0,1,0,1,100.0%,2h
31404,3,Gizmo,2408,0,0,1,1,0.0%,53m
31404,1,HappyFeet,2408,0,0,1,1,0.0%,2h
31420,3,SteveS,2407,686,56,41,97,57.7%,32m
31420,2,[SECT4]EltioZeratul,2407,1262,53,41,94,56.4%,1h
31420,2,SaltyDave,2407,1077,42,43,85,49.4%,2h
31420,2,Mikezknight,2407,1088,41,46,87,47.1%,2h
31420,3,Joseph,2407,870,36,32,68,52.9%,2h
31420,3,LakersPanda,2407,528,29,23,52,55.8%,3h
31420,3,[IC4evr]zergerking,2407,692,27,56,83,32.5%,9m
31420,2,Gravity,2407,675,25,27,52,48.1%,53m
31420,3,BigStick,2407,277,18,21,39,46.2%,37m
31420,3,Shade,2407,489,18,21,39,46.2%,11m
31420,3,neklacaille,2407,282,11,11,22,50.0%,16m
31420,3,Kyannon,2407,128,6,9,15,40.0%,19m
31420,2,Aries,2407,152,5,11,16,31.2%,2h
31420,3,Wrex,2407,151,4,7,11,36.4%,3h
31420,3,Overmind,2407,96,2,0,2,100.0%,29m
31420,3,[LOHd]NeOJbenz,2407,0,1,0,1,100.0%,2h
31420,3,VNCS,2407,0,1,0,1,100.0%,37m
31420,3,LazySCV,2407,97,1,2,3,33.3%,5m
31420,3,Dabs,2407,0,0,1,1,0.0%,53m
31420,3,OctHokague,2407,0,0,1,1,0.0%,37m
31420,3,Kwop,2407,0,0,2,2,0.0%,2h
31420,3,iffysolution,2407,0,0,3,3,0.0%,37m
31442,3,Skuxx,2406,408,63,64,127,49.6%,2h
31442,3,Lukicies,2406,863,50,44,94,53.2%,1h
31442,3,[ZTempz]ElvenGamer,2406,432,34,30,64,53.1%,1h
31442,3,Acechador,2406,545,24,16,40,60.0%,1h
31442,2,Yaz,2406,608,24,23,47,51.1%,2h
31442,2,XvaT,2406,559,21,24,45,46.7%,1h
31442,1,InfstrGadget,2406,512,16,28,44,36.4%,35m
31442,3,[BigBrd]ApuZ,2406,351,12,11,23,52.2%,22m
31442,2,eliteboyer,2406,150,9,8,17,52.9%,51m
31442,2,PizzaSlayer,2406,277,7,14,21,33.3%,50m
31442,3,[JAAM]JAAM,2406,0,1,0,1,100.0%,3m
31442,1,bnbarkas,2406,0,1,4,5,20.0%,3h
31442,3,Jonbot,2406,0,1,4,5,20.0%,2h
31442,3,RodrigoMu,2406,0,1,5,6,16.7%,13m
31442,1,Fuse,2406,0,0,2,2,0.0%,2h
31457,2,Nomad,2405,1586,399,403,802,49.8%,2h
31457,1,Tronik,2405,1565,278,282,560,49.6%,1h
31457,3,[P1N0Ys]PIKOY,2405,1512,194,207,401,48.4%,26m
31457,3,Adama,2405,1341,93,77,170,54.7%,2h
31457,2,Enlightend,2405,1069,54,56,110,49.1%,8m
31457,3,[TSDeu]smile,2405,894,35,52,87,40.2%,26m
31457,3,druidlad,2405,694,28,29,57,49.1%,2h
31457,3,SKING,2405,650,24,29,53,45.3%,12m
31457,3,Dillwinn,2405,491,23,17,40,57.5%,2h
31457,1,ElWaloXD,2405,674,22,37,59,37.3%,3h
31457,3,farry,2405,391,18,12,30,60.0%,1h
31457,3,cyril,2405,392,15,11,26,57.7%,1h
31457,2,JWJW,2405,430,15,21,36,41.7%,34m
31457,3,ColeBurns,2405,326,14,17,31,45.2%,2h
31457,3,Frokiller,2405,338,12,11,23,52.2%,2h
31457,3,HIDE,2405,116,4,5,9,44.4%,53m
31457,2,mOjo,2405,116,4,12,16,25.0%,53m
31457,3,Saber,2405,0,3,4,7,42.9%,23m
31457,2,various,2405,0,3,5,8,37.5%,36m
31457,1,bunk,2405,48,2,5,7,28.6%,44m
31457,1,Shamoa,2405,0,1,0,1,100.0%,16m
31457,1,SAOBestAnime,2405,0,1,0,1,100.0%,3h
31457,3,ZzzZz,2405,0,1,1,2,50.0%,23m
31457,3,MONEYMANEx,2405,0,1,4,5,20.0%,38m
31457,1,DEZINGUER,2405,0,1,4,5,20.0%,2h
31457,3,MagnusDeyker,2405,0,0,1,1,0.0%,5m
31457,1,Shadams,2405,0,0,1,1,0.0%,2h
31457,3,[ÆON]DollyNazBol,2405,0,0,1,1,0.0%,32m
31457,1,Tristen,2405,0,0,2,2,0.0%,36m
31457,3,DiabloFive,2405,0,0,6,6,0.0%,2h
31487,2,[cluez]DesdaNova,2404,1497,201,203,404,49.8%,1h
31487,3,spook,2404,1587,123,109,232,53.0%,1h
31487,1,jarobyte,2404,1471,113,121,234,48.3%,50m
31487,3,Connor,2404,1279,99,96,195,50.8%,58m
31487,3,MMarshmallow,2404,1504,76,62,138,55.1%,2h
31487,2,Maybe,2404,1056,58,65,123,47.2%,2h
31487,3,wolfing,2404,1462,54,56,110,49.1%,45m
31487,3,[CUMMYs]BigDaddy,2404,959,36,34,70,51.4%,30m
31487,3,pointbrake,2404,746,33,27,60,55.0%,2h
31487,2,[LeMeil]RaiyanK,2404,853,33,37,70,47.1%,52m
31487,3,BlueBeast,2404,533,21,15,36,58.3%,53m
31487,2,[KRY]Huesley,2404,378,15,9,24,62.5%,2h
31487,2,PlackTUM,2404,385,13,13,26,50.0%,17m
31487,2,Bitwig,2404,307,11,15,26,42.3%,52m
31487,3,whelm,2404,246,9,14,23,39.1%,13m
31487,3,ThumpCaptain,2404,218,7,10,17,41.2%,3h
31487,3,Halffro,2404,183,7,12,19,36.8%,10m
31487,3,[FMX]VicThOr,2404,256,7,14,21,33.3%,2h
31487,1,[G0BBLE]imtucker,2404,185,6,3,9,66.7%,3h
31487,3,BadClone,2404,147,6,4,10,60.0%,15m
31487,3,iEatAss,2404,136,6,4,10,60.0%,26m
31487,2,waterboy,2404,205,5,5,10,50.0%,35m
31487,2,Azulkilllme,2404,114,3,2,5,60.0%,3h
31487,3,[Xpk]KoMachine,2404,90,3,4,7,42.9%,1h
31487,1,kelonge,2404,145,3,5,8,37.5%,51m
31487,3,ROROROX,2404,129,3,7,10,30.0%,26m
31487,3,AJPC,2404,122,2,3,5,40.0%,2h
31487,1,INVASOR,2404,0,2,3,5,40.0%,2h
31487,3,[MoR]Destruction,2404,62,2,5,7,28.6%,2h
31487,3,teem,2404,30,1,3,4,25.0%,1h
31487,3,matt,2404,0,1,4,5,20.0%,49m
31487,3,GViper,2404,0,0,1,1,0.0%,2h
31487,3,[xDYEx]Portfirebird,2404,0,0,1,1,0.0%,1h
31487,3,ImAdams,2404,0,0,1,1,0.0%,33m
31487,3,[XZL]Mantequilla,2404,0,0,1,1,0.0%,26m
31522,2,Marzhin,2403,529,216,215,431,50.1%,9m
31522,2,coaliz,2403,751,178,172,350,50.9%,51m
31522,3,Darkmatter,2403,1111,142,133,275,51.6%,1h
31522,3,gvccimane,2403,1060,51,59,110,46.4%,1h
31522,3,Ptboon,2403,1013,36,38,74,48.6%,47m
31522,3,[ZKGame]SupremacySC,2403,784,29,31,60,48.3%,10m
31522,3,audibledevil,2403,619,24,20,44,54.5%,2h
31522,3,Sizzlee,2403,253,19,19,38,50.0%,60m
31522,3,HigherPower,2403,551,18,30,48,37.5%,32m
31522,3,Brucey,2403,441,16,12,28,57.1%,8m
31522,3,[smpbz]broverlord,2403,399,15,16,31,48.4%,23m
31522,3,sharknado,2403,277,8,8,16,50.0%,9m
31522,2,brickwall,2403,196,6,11,17,35.3%,54m
31522,3,Bezznark,2403,181,5,8,13,38.5%,4m
31522,3,SubThreeHour,2403,157,4,2,6,66.7%,2h
31522,3,Tichoundrius,2403,90,4,6,10,40.0%,47m
31522,3,Wookie,2403,115,3,1,4,75.0%,1h
31522,3,assalto,2403,120,3,3,6,50.0%,3h
31522,3,DrTooth,2403,92,3,8,11,27.3%,2h
31522,1,AlCaPOONE,2403,0,2,3,5,40.0%,1h
31522,3,Scalaburn,2403,30,2,4,6,33.3%,1h
31522,3,CDman,2403,0,1,0,1,100.0%,53m
31522,3,[ZWars]SeekanDstroy,2403,0,1,1,2,50.0%,2m
31522,3,[SOCOMD]Johno,2403,97,1,2,3,33.3%,52m
31522,3,maahhhm,2403,34,1,3,4,25.0%,4m
31522,3,Haxula,2403,0,1,5,6,16.7%,2h
31522,3,Adimralcody,2403,0,0,1,1,0.0%,34m
31522,3,Droski,2403,0,0,3,3,0.0%,2h
31550,2,TieDyeT,2402,964,124,112,236,52.5%,33m
31550,3,LIWEILICAO,2402,381,78,73,151,51.7%,1h
31550,2,cherypoppins,2402,1517,78,84,162,48.1%,18m
31550,3,ZzZz,2402,716,33,22,55,60.0%,33m
31550,3,[LETAL]pap,2402,621,24,29,53,45.3%,49m
31550,3,Wizzour,2402,374,15,8,23,65.2%,2h
31550,3,chimpanzee,2402,240,13,4,17,76.5%,29m
31550,2,Golden,2402,257,8,10,18,44.4%,2h
31550,2,[Putys]Wonchi,2402,261,8,13,21,38.1%,2h
31550,3,KINGDANK,2402,231,6,10,16,37.5%,33m
31550,1,Yulyeong,2402,129,6,12,18,33.3%,36m
31550,3,TheONC,2402,149,5,5,10,50.0%,5m
31550,3,[TAoG]Bstrange,2402,0,3,3,6,50.0%,23m
31550,3,Adam,2402,142,3,3,6,50.0%,2h
31550,2,Torbaz,2402,89,2,2,4,50.0%,12m
31550,3,SoftMist,2402,114,2,5,7,28.6%,60m
31550,2,Hiei,2402,30,2,7,9,22.2%,2h
31550,3,Robrunner,2402,0,1,4,5,20.0%,2h
31550,3,[TRETER]MIGUEL,2402,0,0,3,3,0.0%,1h
31569,2,PJLO,2401,426,92,105,197,46.7%,36m
31569,3,CosmicTurtle,2401,1377,76,65,141,53.9%,30m
31569,3,gae,2401,684,29,27,56,51.8%,3h
31569,3,SovietParrot,2401,667,26,22,48,54.2%,47m
31569,3,Chrizzuu,2401,494,19,16,35,54.3%,55m
31569,2,StormCRacK,2401,223,8,10,18,44.4%,2h
31569,3,[NfE]Alohi,2401,172,6,10,16,37.5%,2h
31569,3,MasterOogway,2401,121,3,1,4,75.0%,46m
31569,3,[BrawI]Bell,2401,60,3,3,6,50.0%,3h
31569,3,UZCON,2401,95,2,0,2,100.0%,2h
31569,3,shortcutz,2401,30,2,5,7,28.6%,1h
31569,2,Trust,2401,131,2,7,9,22.2%,23m
31569,3,zergforever,2401,0,1,0,1,100.0%,3h
31569,3,[CRAKS]osocafe,2401,95,1,1,2,50.0%,34m
31569,3,Chingy,2401,30,1,2,3,33.3%,22m
31569,1,Deazea,2401,0,1,4,5,20.0%,1h
31569,3,StankFrank,2401,0,0,1,1,0.0%,2h
31569,3,echo,2401,0,0,1,1,0.0%,13m
31569,3,Barkao,2401,0,0,1,1,0.0%,17m
31588,2,roboticFunk,2400,665,72,77,149,48.3%,29m
31588,2,Nightfire,2400,381,25,19,44,56.8%,50m
31588,3,[LaOr]CacoAdodo,2400,639,25,22,47,53.2%,3h
31588,3,JeezisShiva,2400,601,24,16,40,60.0%,47m
31588,2,goldspee,2400,665,23,29,52,44.2%,2h
31588,1,IGO,2400,289,13,10,23,56.5%,2h
31588,1,[KGB]kushinator,2400,274,11,12,23,47.8%,2h
31588,1,RioDeJaneiro,2400,178,11,17,28,39.3%,21m
31588,3,EyeCan,2400,308,10,8,18,55.6%,44m
31588,1,IlIlIlIlIlIl,2400,210,9,27,36,25.0%,2h
31588,3,[OdVark]Winterine,2400,253,8,6,14,57.1%,36m
31588,3,Nando,2400,193,5,5,10,50.0%,2h
31588,3,RareLNO,2400,206,5,8,13,38.5%,1h
31588,3,Artos,2400,92,4,7,11,36.4%,2h
31588,2,[PCAKE]billythekid,2400,146,4,9,13,30.8%,3h
31588,2,Mavryck,2400,30,3,6,9,33.3%,3h
31588,1,[DarkAG]drolkrad,2400,102,3,13,16,18.8%,2h
31588,3,Mark,2400,30,2,3,5,40.0%,44m
31588,3,Dreak,2400,60,2,4,6,33.3%,47m
31588,2,Josh,2400,0,2,5,7,28.6%,2h
31588,1,Glynnball,2400,48,2,6,8,25.0%,2h
31588,3,[eSx]Rave,2400,0,1,0,1,100.0%,2h
31588,1,[A4172]ReapinReaper,2400,44,1,1,2,50.0%,1h
31588,3,AutoAutomate,2400,95,1,1,2,50.0%,2h
31588,3,BLATENET,2400,0,1,2,3,33.3%,2h
31588,1,MDC,2400,0,1,4,5,20.0%,39m
31588,3,PFDry,2400,30,1,5,6,16.7%,58m
31588,3,[LOHs]radio,2400,0,0,1,1,0.0%,2h
31616,2,Flicker,2399,1565,174,174,348,50.0%,3h
31616,3,Areusal,2399,1351,171,173,344,49.7%,13m
31616,2,BLON,2399,1526,136,123,259,52.5%,24m
31616,3,[SOya]narky,2399,1441,102,102,204,50.0%,3m
31616,3,peaceplacid,2399,695,63,81,144,43.8%,23m
31616,3,[NwAs]KKaIZeR,2399,1166,50,44,94,53.2%,2h
31616,3,HOPE,2399,874,43,34,77,55.8%,3h
31616,3,[suprtG]redvision,2399,760,27,31,58,46.6%,2h
31616,3,Snakeballz,2399,472,19,22,41,46.3%,3h
31616,2,pSlycho,2399,552,19,29,48,39.6%,3h
31616,1,Rheks,2399,420,13,13,26,50.0%,3h
31616,2,[3Drs]Saphira,2399,285,10,13,23,43.5%,39m
31616,3,Innerlight,2399,213,7,5,12,58.3%,6m
31616,1,[Fclx]kaito,2399,206,6,1,7,85.7%,3h
31616,3,[OSS]Nite,2399,195,5,8,13,38.5%,2h
31616,3,[RanD]Prototrix,2399,90,4,3,7,57.1%,16m
31616,3,Kaelthalaz,2399,143,3,3,6,50.0%,16m
31616,2,[TuxG]Philts,2399,116,3,7,10,30.0%,2h
31616,1,Zeddybear,2399,66,2,1,3,66.7%,1h
31616,1,MooseMan,2399,48,2,5,7,28.6%,2h
31616,1,Frek,2399,48,2,5,7,28.6%,3h
31616,1,molty,2399,152,2,13,15,13.3%,46m
31616,1,LWD,2399,0,1,4,5,20.0%,3h
31616,1,annaKIN,2399,0,0,1,1,0.0%,39m
31616,1,Boiikikurass,2399,0,0,1,1,0.0%,18m
31616,3,DrVague,2399,0,0,2,2,0.0%,45m
31642,3,naquos,2398,1139,59,49,108,54.6%,3h
31642,3,Agustin,2398,314,52,46,98,53.1%,34m
31642,2,Dartoy,2398,784,34,27,61,55.7%,23m
31642,3,Vanden,2398,886,32,38,70,45.7%,1h
31642,3,STORM,2398,270,9,6,15,60.0%,3h
31642,3,[ZTempz]Desyni,2398,236,8,6,14,57.1%,2h
31642,3,OTb,2398,141,8,10,18,44.4%,37m
31642,2,Hannibal,2398,200,7,10,17,41.2%,24m
31642,1,SGoodman,2398,214,6,0,6,100.0%,2h
31642,3,Recoil,2398,92,4,4,8,50.0%,16m
31642,2,Malbis,2398,142,3,5,8,37.5%,51m
31642,3,TupaC,2398,30,2,2,4,50.0%,8m
31642,1,[ARGENT]Khamus,2398,94,2,10,12,16.7%,60m
31642,1,Tyler,2398,0,1,0,1,100.0%,2h
31642,1,KmikzI,2398,0,1,4,5,20.0%,2h
31642,1,slurpeeking,2398,0,1,5,6,16.7%,3h
31642,1,[OYZS]Charangation,2398,0,0,1,1,0.0%,1h
31642,3,[BooKng]RAYNORT,2398,0,0,3,3,0.0%,1h
31642,3,Apocalipsis,2398,0,0,3,3,0.0%,49m
31661,2,Rhombus,2397,1064,99,91,190,52.1%,1h
31661,3,JSAA,2397,998,52,48,100,52.0%,47m
31661,1,cheezyBTCHIE,2397,1025,52,61,113,46.0%,2h
31661,2,[TLSS]XALUQUSE,2397,510,21,25,46,45.7%,35m
31661,1,arthur,2397,702,20,12,32,62.5%,31m
31661,1,trickyhunter,2397,680,18,12,30,60.0%,2h
31661,3,[KSgoat]wheelz,2397,293,10,11,21,47.6%,55m
31661,3,Seyo,2397,283,8,16,24,33.3%,2h
31661,1,robotikov,2397,260,7,0,7,100.0%,1h
31661,3,BOB,2397,147,4,3,7,57.1%,2h
31661,2,Tylenita,2397,60,4,4,8,50.0%,2h
31661,1,bentpickle,2397,182,4,6,10,40.0%,36m
31661,1,SITHRAGE,2397,130,3,5,8,37.5%,3h
31661,3,HughJanus,2397,95,3,7,10,30.0%,8m
31661,1,Solace,2397,116,3,8,11,27.3%,60m
31661,1,Nihilus,2397,0,3,8,11,27.3%,2h
31661,3,[CHUNK]reddotsniper,2397,30,2,1,3,66.7%,52m
31661,1,Corripio,2397,48,2,4,6,33.3%,44m
31661,3,KREATOR,2397,127,2,4,6,33.3%,26m
31661,3,xENZOx,2397,0,1,0,1,100.0%,2h
31661,3,[Th3Bad]MName,2397,30,1,4,5,20.0%,37m
31661,2,LemonHead,2397,0,0,2,2,0.0%,17m
31661,2,INVICTUS,2397,0,0,8,8,0.0%,3h
31684,2,Rollins,2396,1170,93,95,188,49.5%,2h
31684,2,chafanet,2396,1521,88,86,174,50.6%,55m
31684,1,Nykidemus,2396,1301,48,34,82,58.5%,25m
31684,3,Mino,2396,548,42,30,72,58.3%,16m
31684,3,FireFOX,2396,485,37,37,74,50.0%,2h
31684,3,DAK,2396,564,24,20,44,54.5%,2h
31684,2,Keriggan,2396,278,23,24,47,48.9%,41m
31684,1,DDan,2396,589,23,30,53,43.4%,14m
31684,2,Exoreath,2396,533,22,26,48,45.8%,2h
31684,2,WETxMooppy,2396,263,11,10,21,52.4%,2h
31684,3,BlackSoul,2396,271,9,8,17,52.9%,2h
31684,1,Keuper,2396,90,2,2,4,50.0%,21m
31684,3,shaggi,2396,0,1,1,2,50.0%,2h
31684,1,Nosnoob,2396,0,1,4,5,20.0%,8m
31684,1,Tactics,2396,0,1,4,5,20.0%,1h
31684,1,[CnnRsh]Durkrin,2396,48,1,5,6,16.7%,3h
31684,1,Spinsurgeon,2396,0,0,1,1,0.0%,3h
31684,3,[ZURAh]ChaOS,2396,0,0,2,2,0.0%,2h
31684,3,[BroCo]TheDozz,2396,0,0,2,2,0.0%,2h
31684,3,[Hakir0]Razzell,2396,0,0,3,3,0.0%,46m
31684,3,Abaddon,2396,0,0,5,5,0.0%,2h
31705,2,Edimaker,2395,610,40,39,79,50.6%,2h
31705,3,murciegalo,2395,805,32,34,66,48.5%,47m
31705,1,Red,2395,479,17,18,35,48.6%,3h
31705,3,[DNC]YOINKYMAN,2395,409,16,10,26,61.5%,55m
31705,1,kupsman,2395,300,10,9,19,52.6%,4m
31705,3,RealMrChat,2395,274,9,14,23,39.1%,3h
31705,3,Mythianor,2395,256,8,9,17,47.1%,58m
31705,2,MongmanMark,2395,206,7,10,17,41.2%,3h
31705,3,LeMoucheur,2395,88,4,2,6,66.7%,1h
31705,3,Copernicus,2395,86,4,6,10,40.0%,22m
31705,1,Skyronz,2395,0,3,2,5,60.0%,3h
31705,2,protozerg,2395,125,2,4,6,33.3%,1h
31705,3,Beerserkr,2395,60,2,4,6,33.3%,2m
31705,3,CptPharaoh,2395,97,2,5,7,28.6%,57m
31705,1,thechosenone,2395,48,1,1,2,50.0%,42m
31705,3,DirePants,2395,0,1,1,2,50.0%,16m
31705,2,FullTDark,2395,44,1,3,4,25.0%,60m
31705,1,Doomllama,2395,0,1,4,5,20.0%,2h
31705,1,Hamburgers,2395,0,1,4,5,20.0%,2h
31705,1,jclee,2395,0,1,4,5,20.0%,2h
31705,1,Bargosk,2395,0,0,1,1,0.0%,2h
31705,1,FowlPlays,2395,0,0,1,1,0.0%,3h
31705,3,XelDarim,2395,0,0,2,2,0.0%,3h
31728,1,orange,2394,1554,402,391,793,50.7%,2h
31728,3,[SBoys]Elterranazul,2394,649,26,23,49,53.1%,2h
31728,2,poozipotti,2394,578,20,27,47,42.6%,3h
31728,2,BlackBeard,2394,326,10,16,26,38.5%,1h
31728,3,TheZergling,2394,289,9,15,24,37.5%,1h
31728,3,[QIX]BOINKASAURUS,2394,209,7,4,11,63.6%,47m
31728,3,[SLST]xeno,2394,243,7,9,16,43.8%,2m
31728,2,Bluetrinket,2394,192,6,13,19,31.6%,3h
31728,1,[SUDAKA]ILAN,2394,174,5,2,7,71.4%,2h
31728,3,Mango,2394,145,5,6,11,45.5%,2h
31728,2,Kittenz,2394,189,4,7,11,36.4%,3h
31728,3,[carnal]Morfox,2394,97,3,5,8,37.5%,2h
31728,1,ChickVanCluk,2394,96,3,5,8,37.5%,2h
31728,3,Yamanashi,2394,30,2,2,4,50.0%,1h
31728,1,KillerBee,2394,48,2,4,6,33.3%,2h
31728,2,DsDs,2394,0,1,0,1,100.0%,35m
31728,1,Nicodemous,2394,0,1,1,2,50.0%,41m
31728,3,TimTan,2394,0,1,2,3,33.3%,2h
31728,3,[3939]kennyllama,2394,0,1,4,5,20.0%,47m
31728,2,Indomie,2394,0,0,1,1,0.0%,54m
31728,1,Steven,2394,0,0,3,3,0.0%,1h
31749,3,Benificent,2393,1379,195,197,392,49.7%,48m
31749,1,Happily,2393,1442,191,191,382,50.0%,2h
31749,2,Tpum,2393,772,113,104,217,52.1%,23m
31749,3,Tosh,2393,1595,92,88,180,51.1%,2h
31749,3,DeiMos,2393,1548,72,71,143,50.3%,47m
31749,3,[UcanWn]DayDream,2393,517,33,24,57,57.9%,29m
31749,3,Legendary,2393,486,20,12,32,62.5%,2h
31749,2,TerranMaster,2393,478,20,26,46,43.5%,6m
31749,1,DJRagu,2393,390,16,21,37,43.2%,1h
31749,3,isellpiff,2393,332,12,12,24,50.0%,46m
31749,1,BablieMikel,2393,264,11,15,26,42.3%,8m
31749,2,rise,2393,202,7,10,17,41.2%,23m
31749,3,ARot,2393,60,3,6,9,33.3%,2h
31749,2,[AdVic]Fenix,2393,88,2,2,4,50.0%,36m
31749,3,Ian,2393,30,2,2,4,50.0%,2h
31749,1,horhen,2393,0,2,2,4,50.0%,2h
31749,3,TheOtherGuy,2393,60,2,3,5,40.0%,15m
31749,1,OmaeWaMo,2393,90,2,3,5,40.0%,55m
31749,1,Falcone,2393,141,2,6,8,25.0%,2h
31749,1,[InYoAz]sam,2393,0,1,4,5,20.0%,1h
31749,1,SuperQ,2393,73,1,4,5,20.0%,52m
31749,1,Dew,2393,0,0,1,1,0.0%,32m
31749,1,Blaster,2393,0,0,1,1,0.0%,3h
31772,3,AFlyingHo,2392,1027,69,61,130,53.1%,3m
31772,1,DustyDusters,2392,657,23,31,54,42.6%,34m
31772,2,[SCLA]PKzaid,2392,488,17,24,41,41.5%,1h
31772,1,DandeBoy,2392,493,16,9,25,64.0%,3h
31772,3,Squanto,2392,30,5,3,8,62.5%,14m
31772,1,Bicboooi,2392,30,3,7,10,30.0%,2h
31772,1,Prodigious,2392,134,2,1,3,66.7%,1h
31772,3,Leonarth,2392,30,2,3,5,40.0%,58m
31772,3,[817911]DukeOfSwords,2392,30,2,5,7,28.6%,2h
31772,3,Thebraintame,2392,96,2,5,7,28.6%,2h
31772,3,[VFam2]rabe,2392,0,2,6,8,25.0%,2h
31772,1,Ioseph,2392,0,1,0,1,100.0%,3h
31772,1,FoeHammer,2392,0,1,3,4,25.0%,2h
31772,1,ShadowStorm,2392,0,0,7,7,0.0%,2h
31786,3,xxKAZUNARIxx,2391,985,48,25,73,65.8%,3h
31786,2,KittyRoo,2391,512,18,21,39,46.2%,51m
31786,2,PiscatorJosh,2391,264,11,15,26,42.3%,20m
31786,3,[ARCHIE]AleeSxander,2391,304,11,15,26,42.3%,1h
31786,3,Jygallag,2391,288,11,16,27,40.7%,2h
31786,3,[EpicG]MasterMold,2391,301,10,13,23,43.5%,54m
31786,3,Joel,2391,268,9,12,21,42.9%,53m
31786,3,Epiphany,2391,146,5,7,12,41.7%,2h
31786,3,DINOMAUSS,2391,115,4,7,11,36.4%,13m
31786,1,MilkAndMoney,2391,166,4,17,21,19.0%,31m
31786,1,Bastahoobi,2391,97,2,1,3,66.7%,2h
31786,1,callmedaddy,2391,0,1,0,1,100.0%,18m
31786,1,Wildcat,2391,43,1,1,2,50.0%,1h
31786,3,midge,2391,0,1,1,2,50.0%,53m
31786,1,Irtanib,2391,0,1,4,5,20.0%,22m
31786,1,josephnando,2391,0,1,4,5,20.0%,2h
31786,1,CBRahn,2391,0,1,4,5,20.0%,39m
31786,1,[KCCO99]scruffynerd,2391,0,0,1,1,0.0%,12m
31786,3,[OGbros]XxuprightxX,2391,0,0,2,2,0.0%,46m
31786,3,Jindo,2391,0,0,3,3,0.0%,2h
31806,3,VillanFarT,2390,1504,57,100,157,36.3%,30m
31806,3,Narrorisar,2390,1173,46,47,93,49.5%,2h
31806,1,Bear,2390,862,45,36,81,55.6%,3h
31806,3,okiller,2390,848,32,38,70,45.7%,3h
31806,3,SPICY,2390,306,31,29,60,51.7%,37m
31806,3,[platos]GigaTom,2390,757,30,22,52,57.7%,52m
31806,2,Prizior,2390,688,29,38,67,43.3%,39m
31806,3,FreaKAZoid,2390,542,20,22,42,47.6%,46m
31806,3,Prawnstar,2390,314,14,14,28,50.0%,2h
31806,2,KelionS,2390,305,12,15,27,44.4%,20m
31806,2,[JGDIFF]masaru,2390,341,12,15,27,44.4%,1h
31806,3,Galilchan,2390,210,10,16,26,38.5%,20m
31806,2,cyzzle,2390,204,8,15,23,34.8%,23m
31806,3,ZERG,2390,243,7,6,13,53.8%,16m
31806,3,Universalink,2390,145,4,2,6,66.7%,3m
31806,3,Ozzy,2390,145,4,2,6,66.7%,55m
31806,2,Bahlzaq,2390,166,4,6,10,40.0%,52m
31806,3,RIALTRAPSDS,2390,138,4,6,10,40.0%,3m
31806,3,Powpoper,2390,0,2,4,6,33.3%,1h
31806,2,[Mexxco]thebebo,2390,107,2,5,7,28.6%,3h
31806,3,ratt,2390,30,1,3,4,25.0%,1h
31806,1,irishkid,2390,48,1,5,6,16.7%,2h
31806,3,Tiggerlen,2390,30,1,7,8,12.5%,2m
31806,1,king,2390,0,0,1,1,0.0%,32m
31806,1,[7FP]YEETdaWHEAT,2390,0,0,1,1,0.0%,2h
31806,3,Alphawolf,2390,0,0,2,2,0.0%,4m
31806,3,FoNCHo,2390,0,0,6,6,0.0%,22m
31833,3,Coolhand,2389,322,14,13,27,51.9%,16m
31833,2,Blar,2389,317,12,4,16,75.0%,50m
31833,2,poon,2389,243,10,11,21,47.6%,3h
31833,2,Alejosaurio,2389,141,10,12,22,45.5%,9m
31833,3,[krz]mafereto,2389,234,8,10,18,44.4%,33m
31833,3,chileIbeetle,2389,205,7,5,12,58.3%,2h
31833,3,SSS,2389,146,5,10,15,33.3%,23m
31833,2,BDeezy,2389,72,3,3,6,50.0%,12m
31833,3,Sicarii,2389,34,3,6,9,33.3%,1h
31833,3,GrilledJamu,2389,0,2,5,7,28.6%,16m
31833,2,Orcclan,2389,0,2,5,7,28.6%,3h
31833,1,Hammer,2389,97,1,1,2,50.0%,28m
31833,1,Alpha,2389,0,0,1,1,0.0%,22m
31846,1,khuaikhema,2388,1442,72,79,151,47.7%,3h
31846,3,[mterds]TheFlush,2388,1113,57,53,110,51.8%,22m
31846,2,[Z4RA]YoucefM,2388,532,21,28,49,42.9%,20m
31846,3,PixelNinja,2388,390,15,14,29,51.7%,30m
31846,1,NighTslayeR,2388,478,15,18,33,45.5%,39m
31846,1,jeffrey,2388,226,7,14,21,33.3%,18m
31846,2,[PtheG]Snake,2388,38,5,6,11,45.5%,1h
31846,1,james,2388,145,4,5,9,44.4%,2h
31846,1,MuddyNutts,2388,0,3,2,5,60.0%,1h
31846,1,Wheelchamps,2388,0,3,2,5,60.0%,4m
31846,1,SaSauceNet,2388,62,3,5,8,37.5%,18m
31846,2,Elflako,2388,30,3,6,9,33.3%,2h
31846,1,Scage,2388,0,1,0,1,100.0%,3h
31846,1,[M4ND4]malaspulgas,2388,0,1,4,5,20.0%,27m
31846,1,Trigne,2388,0,0,1,1,0.0%,40m
31846,1,KingIggy,2388,0,0,1,1,0.0%,3h
31846,1,Wimwardius,2388,0,0,1,1,0.0%,1h
31846,3,Aries,2388,0,0,2,2,0.0%,2h
31864,1,Shadow,2387,1578,97,96,193,50.3%,39m
31864,3,[trash0]Ellisonetic,2387,848,46,35,81,56.8%,1h
31864,2,Deeznuttz,2387,117,10,17,27,37.0%,14m
31864,3,[M4N]Backslash,2387,164,4,4,8,50.0%,30m
31864,3,MortyHot,2387,90,3,6,9,33.3%,1h
31864,1,[Vithar]Dracoil,2387,0,1,0,1,100.0%,34m
31864,2,[tagg]Retromojo,2387,0,1,1,2,50.0%,2h
31864,3,FLAPFLAP,2387,0,1,5,6,16.7%,2h
31864,1,LIR,2387,0,0,1,1,0.0%,32m
31873,3,RentIsDue,2386,1207,52,39,91,57.1%,49m
31873,2,Cosadog,2386,855,35,32,67,52.2%,37m
31873,3,FelipeII,2386,647,26,21,47,55.3%,2h
31873,3,Zakaan,2386,533,23,19,42,54.8%,39m
31873,1,NoLifeMatter,2386,686,19,11,30,63.3%,3h
31873,1,Spudnuts,2386,353,19,34,53,35.8%,3h
31873,1,Phoenix,2386,302,9,9,18,50.0%,52m
31873,2,[WebOS]Tlacoyito,2386,276,9,20,29,31.0%,1h
31873,1,[CobraE]Kenpachi,2386,254,8,5,13,61.5%,24m
31873,2,jDabZ,2386,223,6,9,15,40.0%,30m
31873,1,DaSTRAYxDEGT,2386,142,5,8,13,38.5%,3h
31873,1,AeonicStrife,2386,144,4,7,11,36.4%,2h
31873,1,KamerDeep,2386,46,2,1,3,66.7%,2h
31873,2,MotorMax,2386,0,2,5,7,28.6%,13m
31873,1,maicra,2386,0,1,0,1,100.0%,57m
31873,1,nomatex,2386,0,1,1,2,50.0%,3h
31873,3,Ryan,2386,30,1,7,8,12.5%,4m
31873,3,LichKiller,2386,0,0,3,3,0.0%,44m
31891,2,PepeSilvia,2385,1520,223,207,430,51.9%,19m
31891,1,[DXPCA]FMCsantos,2385,1342,171,166,337,50.7%,2h
31891,2,McSnappy,2385,1414,157,157,314,50.0%,2h
31891,2,Neo,2385,1470,146,139,285,51.2%,2h
31891,3,Saphron,2385,1493,143,134,277,51.6%,3h
31891,3,[GOPERÚ]acechador,2385,1206,64,47,111,57.7%,2h
31891,1,[ExcIgN]Psychology,2385,1820,64,59,123,52.0%,32m
31891,1,Tigger,2385,984,39,40,79,49.4%,3m
31891,3,ChuckleBean,2385,437,38,27,65,58.5%,10m
31891,3,copito,2385,876,38,28,66,57.6%,2h
31891,3,Makkiworth,2385,315,11,10,21,52.4%,2h
31891,2,Suunnn,2385,313,10,11,21,47.6%,3h
31891,3,CodyOneKenoB,2385,171,8,1,9,88.9%,2h
31891,3,KushalTag,2385,124,5,5,10,50.0%,2h
31891,3,[ICTH]JohnWilliams,2385,144,5,6,11,45.5%,34m
31891,2,Diablos,2385,0,4,3,7,57.1%,3h
31891,3,[gr8S]LikeAKnife,2385,151,4,8,12,33.3%,19m
31891,1,jajaja,2385,0,1,0,1,100.0%,3h
31891,3,ABYSS,2385,0,1,2,3,33.3%,1h
31891,3,Kendor,2385,30,1,3,4,25.0%,2m
31891,1,[WWP2]eYeSpY,2385,0,1,4,5,20.0%,3h
31891,1,ODION,2385,0,1,4,5,20.0%,4m
31891,1,MataPasitas,2385,0,0,1,1,0.0%,3h
31914,3,LegyPlegy,2384,683,27,25,52,51.9%,55m
31914,3,[STaINd]BritzkyStain,2384,452,22,18,40,55.0%,16m
31914,3,Rosharchk,2384,482,21,15,36,58.3%,2h
31914,3,NOOBBBB,2384,389,15,14,29,51.7%,1h
31914,3,cain,2384,185,9,5,14,64.3%,30m
31914,2,BRZhadouken,2384,180,6,16,22,27.3%,35m
31914,3,Facebanger,2384,158,5,11,16,31.2%,12m
31914,3,[HEREOS]alltocrazy,2384,119,3,1,4,75.0%,22m
31914,3,Darvelain,2384,122,3,2,5,60.0%,33m
31914,3,Ragulus,2384,74,3,5,8,37.5%,22m
31914,2,vlork,2384,0,0,2,2,0.0%,3h
31925,3,Spezi,2383,742,157,137,294,53.4%,1h
31925,3,Malcontent,2383,1338,72,72,144,50.0%,3h
31925,3,Templar,2383,1115,41,42,83,49.4%,2h
31925,3,Arme,2383,898,32,33,65,49.2%,10m
31925,3,MESC,2383,819,29,28,57,50.9%,10m
31925,3,[SCVM]NightTrain,2383,447,18,10,28,64.3%,2h
31925,1,Grabthroat,2383,651,16,15,31,51.6%,2h
31925,2,[SCUnal]Kathartes,2383,484,16,26,42,38.1%,2h
31925,1,CaPTnRERE,2383,482,14,8,22,63.6%,3h
31925,2,ggbro,2383,384,13,18,31,41.9%,3h
31925,1,henrique,2383,468,12,11,23,52.2%,29m
31925,3,yabish,2383,172,9,4,13,69.2%,45m
31925,1,beginner,2383,202,8,14,22,36.4%,3h
31925,1,Nevermind,2383,192,6,5,11,54.5%,3h
31925,1,REDRUM,2383,152,4,3,7,57.1%,2h
31925,1,Bittenflame,2383,30,3,7,10,30.0%,1h
31925,3,EMKalexis,2383,0,2,2,4,50.0%,44m
31925,3,piggycat,2383,30,2,5,7,28.6%,2h
31925,3,neeatstere,2383,0,1,0,1,100.0%,56m
31925,3,syncmasterr,2383,0,1,1,2,50.0%,2h
31925,1,GoyimPatrol,2383,0,0,2,2,0.0%,25m
31925,1,JulioPonce,2383,0,0,3,3,0.0%,43m
31947,3,Marley,2382,1493,201,209,410,49.0%,25m
31947,3,MagicTurtle,2382,1228,49,49,98,50.0%,3h
31947,3,loker,2382,1130,48,46,94,51.1%,2h
31947,3,Tebanv,2382,391,13,10,23,56.5%,1h
31947,3,[Jamal]ExPhoenix,2382,311,12,16,28,42.9%,48m
31947,1,ZachariEl,2382,334,8,5,13,61.5%,2h
31947,3,Overmind,2382,226,7,6,13,53.8%,1h
31947,2,Pathogen,2382,207,5,7,12,41.7%,1h
31947,1,Gothex,2382,176,4,3,7,57.1%,1h
31947,1,Tesla,2382,0,3,9,12,25.0%,50m
31947,2,Jacopod,2382,115,2,7,9,22.2%,29m
31947,1,ggf,2382,0,0,1,1,0.0%,3h
31947,3,Glitersverse,2382,0,0,2,2,0.0%,37m
31947,1,PlanetXpress,2382,0,0,2,2,0.0%,1h
31961,3,BRYANT,2381,1563,72,54,126,57.1%,2h
31961,3,Ringer,2381,989,69,69,138,50.0%,1h
31961,3,Noah,2381,903,64,60,124,51.6%,48m
31961,3,elise,2381,909,34,40,74,45.9%,1h
31961,1,Ondomiel,2381,637,18,13,31,58.1%,1h
31961,1,Lonestar,2381,637,17,12,29,58.6%,1h
31961,3,[GGMESP]SilverHawk,2381,336,13,9,22,59.1%,2h
31961,2,[OCBO]chickenlota,2381,226,13,17,30,43.3%,41m
31961,1,Ostrogodo,2381,410,10,1,11,90.9%,44m
31961,1,WatWatInDaBu,2381,233,8,4,12,66.7%,57m
31961,3,Baltazar,2381,247,8,6,14,57.1%,53m
31961,3,tonycabj,2381,174,7,8,15,46.7%,39m
31961,3,ZergYunior,2381,218,7,10,17,41.2%,49m
31961,3,[Pirobo]Mayher,2381,152,5,2,7,71.4%,49m
31961,1,Lemonparty,2381,0,1,0,1,100.0%,2h
31961,1,Cruss,2381,0,1,0,1,100.0%,23m
31961,1,AyeeTriplx,2381,0,1,0,1,100.0%,3h
31961,1,SirJellybean,2381,73,1,3,4,25.0%,2h
31961,1,Aladdin,2381,0,1,4,5,20.0%,2h
31961,1,[DABOYS]fournstar,2381,0,1,4,5,20.0%,57m
31961,1,EHD,2381,0,1,4,5,20.0%,2h
31961,1,[toXsiC]Toxicpanda,2381,0,0,1,1,0.0%,3h
31961,1,OphieKitty,2381,0,0,1,1,0.0%,2h
31984,3,Kaddish,2380,1513,121,120,241,50.2%,46m
31984,2,MinersCorp,2380,1499,91,83,174,52.3%,54m
31984,1,Multi,2380,1170,75,72,147,51.0%,55m
31984,1,Snicker,2380,334,73,73,146,50.0%,2h
31984,3,Sean,2380,990,37,36,73,50.7%,47m
31984,3,[PbFtCb]Kertic,2380,428,19,11,30,63.3%,2h
31984,1,Juuzou,2380,164,5,0,5,100.0%,4m
31984,3,FoRAiuR,2380,205,5,5,10,50.0%,2h
31984,2,DarthFellow,2380,90,5,8,13,38.5%,12m
31984,1,Diagoras,2380,130,4,1,5,80.0%,47m
31984,1,Nick,2380,80,3,5,8,37.5%,2h
31984,1,Wonka,2380,48,2,0,2,100.0%,2h
31984,3,Syilon,2380,30,2,5,7,28.6%,3h
31984,1,[xSPH3x]Azuri,2380,0,1,0,1,100.0%,2h
31984,3,[Litez]Shadowslayer,2380,0,1,1,2,50.0%,19m
31984,3,lluckyday,2380,0,1,2,3,33.3%,16m
31984,3,CESARJCC,2380,0,1,2,3,33.3%,2h
31984,1,KBear,2380,0,1,4,5,20.0%,51m
31984,1,ForthEorling,2380,0,1,4,5,20.0%,3h
31984,1,Ruu,2380,95,1,5,6,16.7%,2m
31984,2,[XpKAc]lenin,2380,0,0,1,1,0.0%,2h
32005,2,ZehWallace,2379,678,59,57,116,50.9%,14m
32005,2,SpaceManSpif,2379,932,37,36,73,50.7%,24m
32005,3,IIIIIIIIIIII,2379,897,37,57,94,39.4%,23m
32005,3,[UWCSC]DrugsNotHugs,2379,792,30,32,62,48.4%,47m
32005,3,Kaavar,2379,397,13,16,29,44.8%,2h
32005,1,KUMA,2379,256,9,11,20,45.0%,51m
32005,2,xigency,2379,102,9,18,27,33.3%,39m
32005,3,[Atira]Atira,2379,170,7,7,14,50.0%,3h
32005,3,Jossué,2379,203,7,7,14,50.0%,2m
32005,3,[Elit3C]SwankyPants,2379,178,7,11,18,38.9%,2h
32005,3,Ghost,2379,166,5,3,8,62.5%,1h
32005,1,[SiXiS]TinyHippo,2379,0,4,1,5,80.0%,32m
32005,1,SmartAsp,2379,0,3,2,5,60.0%,5m
32005,3,Zeiram,2379,40,3,7,10,30.0%,14m
32005,1,[AbcCo]Kaminav,2379,42,2,0,2,100.0%,2h
32005,1,[lHxHl]Xizma,2379,0,1,4,5,20.0%,2h
32005,1,SureCheese,2379,0,1,5,6,16.7%,3h
32005,1,GiftedBlade,2379,0,0,1,1,0.0%,1h
32005,1,gransz,2379,0,0,1,1,0.0%,13m
32024,2,[XDRAX8]toraijin,2378,1587,364,365,729,49.9%,9m
32024,1,Gloat,2378,1379,78,76,154,50.6%,1h
32024,2,OviposiMe,2378,612,58,43,101,57.4%,37m
32024,2,GreenPunch,2378,151,35,30,65,53.8%,9m
32024,1,AlexiGenesys,2378,340,9,6,15,60.0%,60m
32024,1,BitRider,2378,320,9,12,21,42.9%,28m
32024,1,[Chinsk]EnDSolstice,2378,178,7,13,20,35.0%,3h
32024,3,NoobieAdrian,2378,121,3,1,4,75.0%,47m
32024,3,Samishine,2378,60,3,7,10,30.0%,2h
32024,1,[JEC1]Executor,2378,0,1,0,1,100.0%,21m
32024,2,Pugdy,2378,88,1,3,4,25.0%,53m
32024,1,Dezmon,2378,73,1,3,4,25.0%,2h
32024,1,TAG,2378,0,1,4,5,20.0%,2h
32024,1,Prodigy,2378,0,0,1,1,0.0%,2h
32024,1,BIGBOIJAY,2378,0,0,1,1,0.0%,3h
32024,1,[TPGGXD]Dark,2378,0,0,1,1,0.0%,2h
32024,1,rumit,2378,0,0,1,1,0.0%,3h
32041,2,deathbringer,2377,1526,240,234,474,50.6%,24m
32041,3,llllllllllll,2377,1578,113,107,220,51.4%,3h
32041,2,Mehkael,2377,850,75,77,152,49.3%,14m
32041,1,Notagonist,2377,1220,44,39,83,53.0%,21m
32041,2,Bhai,2377,456,18,17,35,51.4%,23m
32041,2,zTerranova,2377,454,17,28,45,37.8%,1h
32041,1,LGSN,2377,600,15,9,24,62.5%,2h
32041,3,COOLFACE,2377,289,10,11,21,47.6%,47m
32041,1,Downy,2377,220,7,21,28,25.0%,3h
32041,1,Makawy,2377,132,4,3,7,57.1%,2h
32041,3,[SaWu]Real,2377,130,4,6,10,40.0%,2h
32041,1,tigre,2377,97,2,2,4,50.0%,2h
32041,1,Dahn,2377,41,1,2,3,33.3%,3h
32041,1,[ANSTRT]DrWicket,2377,0,1,4,5,20.0%,57m
32041,3,sunnyD,2377,0,1,13,14,7.1%,22m
32041,1,hydra,2377,0,0,1,1,0.0%,4m
32041,1,Chirag,2377,0,0,1,1,0.0%,2h
32058,3,jerico,2376,238,17,14,31,54.8%,43m
32058,1,SaucyMeatMan,2376,579,16,12,28,57.1%,3h
32058,3,SeniorCronic,2376,392,14,16,30,46.7%,44m
32058,1,Abstract,2376,360,9,4,13,69.2%,1h
32058,3,Fasto,2376,289,9,8,17,52.9%,58m
32058,3,Chris,2376,242,9,13,22,40.9%,2h
32058,3,Gelo,2376,195,6,5,11,54.5%,49m
32058,3,Exciel,2376,181,6,6,12,50.0%,18m
32058,1,BlinkGosu,2376,193,4,5,9,44.4%,1h
32058,3,dipo,2376,182,4,6,10,40.0%,54m
32058,1,Brgrthemeaty,2376,86,3,0,3,100.0%,40m
32058,1,Strider,2376,79,3,1,4,75.0%,52m
32058,3,jconnors,2376,122,3,1,4,75.0%,57m
32058,1,tugfa,2376,92,2,2,4,50.0%,32m
32058,1,alfredo,2376,80,2,3,5,40.0%,2h
32058,1,IllIlIIllIll,2376,0,1,4,5,20.0%,57m
32058,1,Drone,2376,0,1,6,7,14.3%,44m
32058,1,NerdyGammer,2376,0,0,1,1,0.0%,47m
32058,1,preSENT,2376,0,0,1,1,0.0%,34m
32058,3,[PiN0YS]Vannetixcz,2376,0,0,2,2,0.0%,23m
32078,2,Asuh,2375,456,60,54,114,52.6%,2h
32078,2,MasterTravis,2375,736,42,36,78,53.8%,2h
32078,1,[paipai]PAIPAI,2375,1026,41,45,86,47.7%,15m
32078,1,[OSKL]Zeushn,2375,455,17,26,43,39.5%,1h
32078,1,Crow,2375,394,13,6,19,68.4%,1h
32078,3,DocGear,2375,312,12,16,28,42.9%,58m
32078,3,[WP]bewhyou,2375,229,9,7,16,56.2%,30m
32078,3,genghiscat,2375,184,7,11,18,38.9%,2h
32078,3,Benthic,2375,199,6,6,12,50.0%,1h
32078,2,SuppliedWing,2375,0,4,4,8,50.0%,49m
32078,3,OIOOOBit,2375,92,4,5,9,44.4%,14m
32078,3,JuanchoIV,2375,94,3,4,7,42.9%,54m
32078,3,DrDacosta,2375,58,3,4,7,42.9%,17m
32078,1,[SABO]Alditux,2375,121,3,6,9,33.3%,3h
32078,3,Wolf,2375,36,3,6,9,33.3%,5m
32078,1,Cavewert,2375,140,3,7,10,30.0%,2h
32078,1,[BAKIN]Etdaen,2375,97,2,6,8,25.0%,28m
32078,2,Bambuco,2375,57,2,11,13,15.4%,14m
32078,1,hiroshijag,2375,0,1,0,1,100.0%,2h
32078,1,Schmuel,2375,0,1,0,1,100.0%,2h
32078,1,[ZTempz]Microvawe,2375,0,1,0,1,100.0%,21m
32078,1,BonHaus,2375,48,1,2,3,33.3%,2h
32078,3,[WNTRG]luckymansogo,2375,32,1,4,5,20.0%,59m
32078,1,Beeker,2375,0,1,4,5,20.0%,3h
32078,1,gumpo,2375,0,1,4,5,20.0%,3h
32078,1,Erik,2375,0,1,4,5,20.0%,2h
32078,3,DarkCloud,2375,0,1,5,6,16.7%,47m
32078,1,chull,2375,0,0,1,1,0.0%,53m
32078,3,[D3MON]Jestorick,2375,0,0,3,3,0.0%,29m
32107,3,nescaltoddy,2374,1060,76,61,137,55.5%,2h
32107,1,Wolfe,2374,1211,60,65,125,48.0%,2h
32107,2,yiseyi,2374,1003,41,40,81,50.6%,2h
32107,3,PipoVzla,2374,481,17,17,34,50.0%,1h
32107,3,thanatos,2374,372,15,20,35,42.9%,1h
32107,2,EpicGamer,2374,248,8,13,21,38.1%,3h
32107,3,goose,2374,280,8,13,21,38.1%,1h
32107,3,Icks,2374,222,6,7,13,46.2%,2h
32107,1,parazitu,2374,156,5,2,7,71.4%,3h
32107,1,PublicEnemy,2374,44,4,3,7,57.1%,2h
32107,1,Johan,2374,97,4,3,7,57.1%,59m
32107,1,[XNANIX]Angel,2374,172,4,4,8,50.0%,45m
32107,1,[Lp]ziusudhra,2374,0,3,2,5,60.0%,25m
32107,1,Jat,2374,45,2,2,4,50.0%,41m
32107,3,CapitãoElite,2374,0,2,6,8,25.0%,8m
32107,1,[LSDlol]Raekwon,2374,46,1,2,3,33.3%,1h
32107,1,DontEven,2374,48,1,5,6,16.7%,28m
32107,1,[BEEDS]MarkySparky,2374,0,0,2,2,0.0%,11m
32125,1,[DLe]SnakeEater,2373,1271,180,194,374,48.1%,2h
32125,1,Tom,2373,579,32,39,71,45.1%,2h
32125,3,[xGDIsx]BlingKing,2373,506,18,21,39,46.2%,5m
32125,3,Snowdrift,2373,392,15,11,26,57.7%,1h
32125,1,monSTEARCK,2373,239,9,7,16,56.2%,3h
32125,1,Jamgasm,2373,274,8,4,12,66.7%,2h
32125,3,nicemonkey,2373,256,7,12,19,36.8%,55m
32125,3,dounut,2373,219,7,21,28,25.0%,32m
32125,3,[Docs]RagTagMonstR,2373,92,4,3,7,57.1%,3h
32125,1,Riddim,2373,97,4,9,13,30.8%,5m
32125,2,ImTheAzzman,2373,0,3,4,7,42.9%,24m
32125,2,fattyattyo,2373,0,2,5,7,28.6%,3h
32125,1,Blight,2373,42,2,5,7,28.6%,3h
32125,2,Raulin,2373,88,2,6,8,25.0%,50m
32125,1,[BUKÉ]CHOROEPUENTE,2373,0,1,0,1,100.0%,44m
32125,1,Yossarian,2373,0,1,4,5,20.0%,1h
32125,1,Kelevra,2373,0,1,4,5,20.0%,3h
32125,1,HulkVomit,2373,0,0,1,1,0.0%,13m
32125,1,SAVMASTER,2373,0,0,2,2,0.0%,58m
32144,3,SaltyTBH,2372,1509,62,60,122,50.8%,32m
32144,1,Scarmiglione,2372,1749,58,58,116,50.0%,29m
32144,3,[CGB]TOSSIngEmUp,2372,494,19,18,37,51.4%,14m
32144,3,Chibus,2372,86,14,17,31,45.2%,34m
32144,2,SeguinINC,2372,366,12,16,28,42.9%,13m
32144,2,lightpure,2372,241,9,12,21,42.9%,3h
32144,1,[NTPeru]Buchoweed,2372,240,7,22,29,24.1%,36m
32144,1,valkiryion,2372,139,4,8,12,33.3%,3h
32144,1,DRTYDOUGHNUT,2372,136,4,9,13,30.8%,2h
32144,3,Maximus,2372,141,3,4,7,42.9%,2h
32144,1,Arte,2372,0,3,6,9,33.3%,32m
32144,2,[tCo9]RnchroCsmico,2372,42,2,1,3,66.7%,2h
32144,3,Britney,2372,0,2,6,8,25.0%,25m
32144,3,Aarodynamix,2372,30,1,1,2,50.0%,3h
32144,1,Giafar,2372,0,1,3,4,25.0%,41m
32144,1,SgtStraken,2372,0,1,4,5,20.0%,27m
32160,1,Alect,2371,1044,34,28,62,54.8%,13m
32160,3,METRIKAL,2371,518,21,16,37,56.8%,17m
32160,3,DiMarco,2371,487,19,24,43,44.2%,1h
32160,1,MrOrange,2371,189,10,13,23,43.5%,31m
32160,3,Kratos,2371,244,8,12,20,40.0%,48m
32160,2,redcomshell,2371,62,3,11,14,21.4%,38m
32160,3,IUNJUSTI,2371,58,2,4,6,33.3%,11m
32160,3,DoNNemeSiS,2371,30,1,2,3,33.3%,2h
32160,1,Hajweeida,2371,0,1,4,5,20.0%,60m
32160,3,lLuisdwtl,2371,0,1,5,6,16.7%,57m
32160,1,MrThirtyAPM,2371,0,0,1,1,0.0%,58m
32160,1,xMrBronx,2371,0,0,1,1,0.0%,32m
32160,3,silverkurse,2371,0,0,1,1,0.0%,40m
32160,1,Apita,2371,0,0,2,2,0.0%,2h
32160,3,qrtz,2371,0,0,3,3,0.0%,2h
32175,3,SuperDubbs,2370,1402,78,63,141,55.3%,13m
32175,1,Pazuzu,2370,544,14,13,27,51.9%,3h
32175,3,Zamligan,2370,358,14,18,32,43.8%,49m
32175,2,DirtySlides,2370,146,7,11,18,38.9%,2h
32175,2,Pantera,2370,194,5,12,17,29.4%,1h
32175,2,Exaltia,2370,58,4,7,11,36.4%,2h
32175,1,[SloBum]jtwojbeast,2370,132,3,2,5,60.0%,1h
32175,3,AndraxxBR,2370,122,3,6,9,33.3%,23m
32175,1,[SMLDRS]WaspZala,2370,0,2,3,5,40.0%,2h
32175,3,[QMM]CHICOBIZARRO,2370,30,2,4,6,33.3%,3h
32175,3,Zeeaan,2370,0,1,0,1,100.0%,2h
32175,3,doublestars,2370,94,1,3,4,25.0%,40m
32175,1,DadInSheet,2370,0,1,4,5,20.0%,58m
32175,1,Arkont,2370,0,1,4,5,20.0%,52m
32175,1,ragequit,2370,0,0,2,2,0.0%,2h
32175,2,SpaceProject,2370,0,0,3,3,0.0%,2h
32191,2,dvsn,2369,1512,130,124,254,51.2%,41m
32191,1,Mao,2369,1045,45,39,84,53.6%,1h
32191,1,darkwarrior,2369,1284,43,36,79,54.4%,1h
32191,3,Gabrael,2369,743,43,40,83,51.8%,49m
32191,2,MemesToAnEnd,2369,744,30,28,58,51.7%,59m
32191,3,[AngryB]Butcher,2369,381,21,17,38,55.3%,60m
32191,3,sadvilliany,2369,398,16,18,34,47.1%,17m
32191,3,Edeorac,2369,179,10,10,20,50.0%,12m
32191,3,Garavou,2369,272,10,11,21,47.6%,4m
32191,3,Finest,2369,226,9,13,22,40.9%,37m
32191,2,[FLUFFS]KCHU,2369,167,6,6,12,50.0%,3h
32191,1,JCL,2369,144,5,5,10,50.0%,3h
32191,3,CowboyVittlz,2369,202,5,8,13,38.5%,25m
32191,3,Mym,2369,60,4,7,11,36.4%,37m
32191,1,Xavier,2369,44,4,8,12,33.3%,45m
32191,1,IIIIIIIIIIII,2369,128,3,8,11,27.3%,21m
32191,1,Pedro,2369,90,2,1,3,66.7%,2h
32191,1,Sieve,2369,42,2,5,7,28.6%,9m
32191,1,[JKTAP]LettaRaye,2369,0,1,0,1,100.0%,16m
32191,3,Chacha,2369,97,1,1,2,50.0%,2h
32191,1,[WuTang]METHODman,2369,48,1,2,3,33.3%,3h
32191,1,[RLFA]DuePlayer,2369,0,1,3,4,25.0%,2h
32191,3,SHOARENA,2369,0,0,3,3,0.0%,54m
32214,3,KissShot,2368,419,16,20,36,44.4%,1h
32214,1,ZergMastrAce,2368,372,9,7,16,56.2%,1h
32214,1,AnthonyQ,2368,378,9,12,21,42.9%,56m
32214,2,Vorazi,2368,224,8,15,23,34.8%,3h
32214,2,zedd,2368,236,8,16,24,33.3%,51m
32214,1,[ELLOCO]Starscream,2368,202,7,4,11,63.6%,2h
32214,3,frankydat,2368,103,4,11,15,26.7%,22m
32214,3,SortaOkay,2368,141,3,4,7,42.9%,59m
32214,1,Milton,2368,0,3,9,12,25.0%,39m
32214,1,MRMGRMATT,2368,46,2,0,2,100.0%,2h
32214,3,NathanPeter,2368,96,2,1,3,66.7%,2h
32214,1,Newboys,2368,46,2,1,3,66.7%,58m
32214,3,[FidSC]LittleZerg,2368,62,2,5,7,28.6%,45m
32214,3,midnitesnack,2368,62,2,5,7,28.6%,2h
32214,3,zzzz,2368,121,2,7,9,22.2%,57m
32214,1,Erucian,2368,46,1,2,3,33.3%,39m
32230,3,BraveUlysses,2367,1080,44,46,90,48.9%,2h
32230,3,rusty,2367,478,18,25,43,41.9%,59m
32230,2,Zarel,2367,198,11,10,21,52.4%,52m
32230,2,WattledSnail,2367,266,10,17,27,37.0%,19m
32230,2,SoLidSir,2367,230,8,12,20,40.0%,2h
32230,3,GoingJamon,2367,174,7,9,16,43.8%,2h
32230,1,wolf,2367,218,6,2,8,75.0%,2h
32230,3,Bethechange,2367,184,6,4,10,60.0%,1h
32230,3,[Zno]Jammer,2367,118,5,3,8,62.5%,15m
32230,3,[0clã]Pwz,2367,172,5,4,9,55.6%,2h
32230,2,Zerling,2367,177,5,4,9,55.6%,5m
32230,3,Namwob,2367,177,4,4,8,50.0%,2h
32230,1,Maigawd,2367,136,3,5,8,37.5%,1h
32230,1,bingu,2367,0,2,0,2,100.0%,2h
32230,2,Brancor,2367,0,1,2,3,33.3%,3h
32230,1,Green,2367,46,1,3,4,25.0%,2h
32230,1,Toreas,2367,0,1,4,5,20.0%,3h
32230,1,Penguins,2367,0,0,1,1,0.0%,3h
32230,1,Cerix,2367,0,0,1,1,0.0%,38m
32249,2,Auxiliarybow,2366,916,148,137,285,51.9%,41m
32249,3,zion,2366,1290,66,60,126,52.4%,59m
32249,3,MrSparta,2366,1182,66,66,132,50.0%,3h
32249,3,JDRants,2366,1012,46,42,88,52.3%,2h
32249,2,Kenji,2366,180,7,14,21,33.3%,39m
32249,2,Deviousdonut,2366,170,5,10,15,33.3%,3m
32249,1,Nikkolodian,2366,44,2,1,3,66.7%,1h
32249,3,Ominous,2366,0,2,4,6,33.3%,2h
32249,3,dinin,2366,129,2,4,6,33.3%,1h
32249,1,LaidbackJ,2366,0,2,6,8,25.0%,39m
32249,1,happyfeet,2366,0,1,0,1,100.0%,58m
32249,2,FOKINI,2366,0,1,6,7,14.3%,54m
32249,3,[ODESSA]MaxemOut,2366,0,0,1,1,0.0%,7m
32249,2,[SC2PH]Kircheis,2366,0,0,1,1,0.0%,2h
32263,2,cdrie,2365,1513,325,306,631,51.5%,2h
32263,1,thebreaker,2365,1794,91,85,176,51.7%,1h
32263,3,[ExcIgN]ferand,2365,1209,86,71,157,54.8%,3m
32263,3,garbology,2365,560,66,61,127,52.0%,8m
32263,1,YERINOTH,2365,1102,59,64,123,48.0%,54m
32263,2,dhuangal,2365,353,46,41,87,52.9%,37m
32263,3,TedBear,2365,1001,43,45,88,48.9%,1h
32263,3,[LitllR]LitlleRabbit,2365,500,19,21,40,47.5%,34m
32263,1,[JOSKYS]osky,2365,434,13,6,19,68.4%,3h
32263,1,[WeRaD]BillyMagnum,2365,264,13,14,27,48.1%,47m
32263,3,daveeeed,2365,315,12,11,23,52.2%,5m
32263,1,TrumpFanMAGA,2365,304,8,9,17,47.1%,1h
32263,2,[xMETAx]GavaBoo,2365,118,6,10,16,37.5%,37m
32263,1,Rostafari,2365,298,6,14,20,30.0%,3h
32263,1,dcmallo,2365,44,4,2,6,66.7%,18m
32263,2,[TeamKa]FerNanDo,2365,86,3,6,9,33.3%,28m
32263,1,Probelims,2365,46,2,2,4,50.0%,2h
32263,2,Agahron,2365,0,2,5,7,28.6%,2h
32263,1,GarbageMan,2365,38,1,3,4,25.0%,45m
32263,1,Gredran,2365,0,1,4,5,20.0%,43m
32263,3,BokoDeBoko,2365,0,1,5,6,16.7%,2h
32263,1,DeadPhones,2365,0,0,1,1,0.0%,60m
32263,3,naive,2365,0,0,2,2,0.0%,47m
32263,1,[Sc2F]ToaFolks,2365,0,0,2,2,0.0%,45m
32263,3,[FWS]Sora,2365,0,0,3,3,0.0%,3h
32288,1,MOJO,2364,1510,53,42,95,55.8%,2h
32288,2,[URF]Silhouette,2364,612,22,29,51,43.1%,2h
32288,3,Gammoning,2364,400,20,19,39,51.3%,10m
32288,2,Eduarever,2364,310,10,6,16,62.5%,60m
32288,2,Qngus,2364,278,9,10,19,47.4%,36m
32288,1,elchocoo,2364,164,5,1,6,83.3%,1h
32288,1,sombra,2364,123,5,5,10,50.0%,2h
32288,1,TheDevouring,2364,145,5,11,16,31.2%,45m
32288,3,[TnKn]Dolodiar,2364,104,3,7,10,30.0%,2h
32288,1,Marasy,2364,43,2,5,7,28.6%,41m
32288,1,unerth,2364,0,1,1,2,50.0%,29m
32288,3,Chimu,2364,0,1,1,2,50.0%,2h
32288,3,[ØÛ]PepeElpollo,2364,30,1,5,6,16.7%,2h
32288,2,BigParma,2364,0,0,1,1,0.0%,52m
32288,1,demth,2364,0,0,1,1,0.0%,18m
32288,1,[Chubb]BALDERDASHH,2364,0,0,1,1,0.0%,41m
32288,1,chixxdigit,2364,0,0,2,2,0.0%,53m
32305,1,DocColBot,2363,937,90,99,189,47.6%,41m
32305,2,DreamChaser,2363,324,32,31,63,50.8%,53m
32305,3,Unknown,2363,553,21,28,49,42.9%,37m
32305,3,FallenMechX,2363,453,17,23,40,42.5%,1h
32305,1,Maxwoodhouse,2363,528,13,14,27,48.1%,3h
32305,3,Craigjohn,2363,185,5,9,14,35.7%,2h
32305,3,Axeelboyd,2363,149,4,7,11,36.4%,2h
32305,1,PACAVO,2363,126,4,7,11,36.4%,2h
32305,1,Grack,2363,42,2,0,2,100.0%,24m
32305,1,KingBloBlob,2363,0,1,1,2,50.0%,2h
32305,1,[PDPGS]swordfish,2363,46,1,3,4,25.0%,2h
32305,3,ThisbeKline,2363,30,1,5,6,16.7%,1h
32305,1,Dante,2363,0,1,5,6,16.7%,51m
32305,3,Septraverse,2363,0,1,6,7,14.3%,57m
32305,1,HiredGoons,2363,0,0,1,1,0.0%,39m
32305,1,Doubted,2363,0,0,1,1,0.0%,48m
32305,3,Capaneus,2363,0,0,2,2,0.0%,35m
32305,3,GrandManco,2363,0,0,2,2,0.0%,50m
32323,1,glOpP,2362,1523,110,126,236,46.6%,3h
32323,2,RantZ,2362,1458,82,81,163,50.3%,2h
32323,3,[LOHd]fatherearth,2362,1566,82,84,166,49.4%,1h
32323,3,[Wienie]Holmes,2362,1208,47,47,94,50.0%,1h
32323,2,Church,2362,792,44,51,95,46.3%,2h
32323,1,keyps,2362,581,36,33,69,52.2%,58m
32323,3,[LY]Corrupter,2362,316,10,12,22,45.5%,16m
32323,3,WhatIf,2362,255,9,16,25,36.0%,3h
32323,2,[Metal]DayMan,2362,237,9,19,28,32.1%,3h
32323,1,Thumbtack,2362,212,8,14,22,36.4%,1h
32323,3,Estiblet,2362,216,7,26,33,21.2%,17m
32323,1,grappa,2362,212,5,5,10,50.0%,2h
32323,1,[TCHNO]Octopuss,2362,161,5,6,11,45.5%,13m
32323,3,AbsoluteZero,2362,155,3,6,9,33.3%,55m
32323,2,SpacePanda,2362,102,3,9,12,25.0%,1h
32323,1,Mindmaster,2362,42,2,4,6,33.3%,27m
32323,1,[TBBG]HaiLegacy,2362,48,2,5,7,28.6%,2h
32323,1,Angel,2362,44,1,2,3,33.3%,22m
32323,3,[EvilGC]Roach,2362,95,1,3,4,25.0%,47m
32323,3,oetamodel,2362,30,1,5,6,16.7%,2h
32323,1,zeltor,2362,0,0,1,1,0.0%,1h
32344,2,Charly,2361,1280,80,73,153,52.3%,2h
32344,3,fred,2361,930,51,42,93,54.8%,1h
32344,1,[DOSC2]Nelsonite,2361,784,23,20,43,53.5%,2h
32344,1,SolArgenti,2361,472,17,2,19,89.5%,21m
32344,3,VVWVWWWVWWV,2361,444,16,14,30,53.3%,2h
32344,1,charmquark,2361,297,10,8,18,55.6%,27m
32344,1,Hayjak,2361,244,10,14,24,41.7%,3h
32344,1,[OldGun]RustyBlade,2361,188,8,2,10,80.0%,2h
32344,1,[GGWolf]FittyGoHard,2361,218,5,5,10,50.0%,3h
32344,1,NovaStar,2361,92,4,3,7,57.1%,2h
32344,1,VALGUNA,2361,48,3,5,8,37.5%,2h
32344,2,Dalelicious,2361,0,3,8,11,27.3%,29m
32344,3,Bagual,2361,0,2,6,8,25.0%,52m
32357,3,MsIgorGarcia,2360,438,71,57,128,55.5%,10m
32357,1,dude,2360,1765,68,65,133,51.1%,8m
32357,2,[NARF]Euler,2360,511,65,66,131,49.6%,39m
32357,3,WamBamTYCam,2360,929,37,34,71,52.1%,32m
32357,3,Hellig,2360,558,21,24,45,46.7%,8m
32357,1,Tegridad,2360,631,20,14,34,58.8%,3h
32357,2,[867]ROKURSOXOFF,2360,427,16,20,36,44.4%,51m
32357,1,Sheeb,2360,336,9,8,17,52.9%,1h
32357,1,[UMCP]Shrek,2360,360,9,58,67,13.4%,35m
32357,3,Rabanoide,2360,116,6,8,14,42.9%,32m
32357,3,blksheepwall,2360,137,5,8,13,38.5%,32m
32357,2,thatguy,2360,76,4,4,8,50.0%,2h
32357,3,[KuShQc]Aurak,2360,60,3,4,7,42.9%,2m
32357,3,Stefuk,2360,35,2,6,8,25.0%,47m
32357,3,SpiderMan,2360,0,1,2,3,33.3%,48m
32357,1,Kushiel,2360,0,1,4,5,20.0%,25m
32357,3,billy,2360,30,1,4,5,20.0%,2h
32357,1,takiteasy,2360,0,1,4,5,20.0%,2h
32357,1,[SCVM]DespritLoon,2360,0,0,1,1,0.0%,43m
32357,1,[NMKs]LightHouse,2360,0,0,1,1,0.0%,2h
32377,2,kvleb,2359,1249,168,148,316,53.2%,45m
32377,1,Canas,2359,863,108,100,208,51.9%,2h
32377,2,gongskie,2359,1586,107,125,232,46.1%,9m
32377,3,BuketOfTruth,2359,1444,53,59,112,47.3%,2h
32377,1,llllllllllll,2359,589,24,3,27,88.9%,4m
32377,2,Animalstatus,2359,350,12,16,28,42.9%,24m
32377,1,iboostyou,2359,299,9,1,10,90.0%,32m
32377,1,cRam,2359,255,5,4,9,55.6%,48m
32377,3,Emau,2359,86,4,4,8,50.0%,2h
32377,1,[BNUwU]Grogu,2359,179,4,6,10,40.0%,4m
32377,2,Keyzx,2359,130,3,9,12,25.0%,2h
32377,1,[D4Bros]AeroEchelon,2359,0,2,3,5,40.0%,8m
32377,3,AmishRabbi,2359,0,2,6,8,25.0%,54m
32377,2,canion,2359,88,1,4,5,20.0%,2h
32377,3,[Subb]masaru,2359,0,0,3,3,0.0%,10m
32392,3,Icecruncher,2358,427,88,78,166,53.0%,39m
32392,2,Adventurer,2358,1182,69,64,133,51.9%,37m
32392,3,[isXM]Peyper,2358,287,49,41,90,54.4%,39m
32392,3,ColdHands,2358,850,36,32,68,52.9%,53m
32392,3,[PROG]chaplin,2358,729,31,27,58,53.4%,2h
32392,3,[FalPal]Zanwaan,2358,328,12,16,28,42.9%,54m
32392,3,[TNTW]Xevicon,2358,183,7,6,13,53.8%,1h
32392,1,KingOfWar,2358,206,7,10,17,41.2%,2h
32392,3,Zebgoraj,2358,138,5,9,14,35.7%,1h
32392,3,[ViHa]Lag,2358,172,4,8,12,33.3%,7m
32392,1,SoMLic,2358,130,3,1,4,75.0%,1h
32392,3,lulagax,2358,30,3,5,8,37.5%,31m
32392,1,fmiranda,2358,124,3,7,10,30.0%,41m
32392,1,mtraceur,2358,0,1,0,1,100.0%,52m
32392,1,SrPapafrita,2358,0,1,2,3,33.3%,2h
32392,1,[isoptr]node,2358,0,1,4,5,20.0%,52m
32392,1,ULTRAZERG,2358,0,0,3,3,0.0%,43m
32409,1,Evilworld,2357,1578,102,101,203,50.2%,2h
32409,2,Wiccan,2357,1066,75,77,152,49.3%,1h
32409,1,Zaheer,2357,1310,47,39,86,54.7%,58m
32409,2,Bawkser,2357,1181,46,46,92,50.0%,21m
32409,3,dan,2357,439,30,30,60,50.0%,58m
32409,3,Fox,2357,253,26,27,53,49.1%,2m
32409,3,Avitus,2357,538,22,19,41,53.7%,1h
32409,3,Swanzokills,2357,482,21,13,34,61.8%,1h
32409,2,[HØST]Krovak,2357,532,20,23,43,46.5%,11m
32409,3,Spikeroo,2357,210,8,8,16,50.0%,53m
32409,3,[Mgumin]IventHalcon,2357,202,8,10,18,44.4%,40m
32409,2,Imagination,2357,156,4,0,4,100.0%,2h
32409,1,[BCRUSE]Phil,2357,164,4,3,7,57.1%,44m
32409,3,Rupicols,2357,86,4,5,9,44.4%,1h
32409,2,MANCHILD,2357,108,3,5,8,37.5%,53m
32409,3,holdmyD,2357,0,2,4,6,33.3%,2h
32409,3,Mike,2357,30,2,5,7,28.6%,1h
32409,1,SirDox,2357,92,1,1,2,50.0%,8m
32409,1,Stark,2357,44,1,1,2,50.0%,24m
32409,1,kittycatchat,2357,0,1,5,6,16.7%,2h
32409,1,Xious,2357,0,1,6,7,14.3%,40m
32409,1,JaggerTerran,2357,0,0,1,1,0.0%,2h
32431,3,ChewyCheese,2356,1220,50,49,99,50.5%,3h
32431,3,[IMDSI]sebastian,2356,747,38,41,79,48.1%,12m
32431,3,[SC2IDN]JackSparroww,2356,938,34,34,68,50.0%,31m
32431,3,Waru,2356,452,19,10,29,65.5%,1h
32431,3,Atreides,2356,479,19,21,40,47.5%,12m
32431,3,LagMan,2356,445,18,16,34,52.9%,47m
32431,3,Rioku,2356,376,13,17,30,43.3%,2h
32431,3,juanthekill,2356,252,10,10,20,50.0%,1h
32431,3,TheCrudMan,2356,226,9,6,15,60.0%,1h
32431,1,DrClona,2356,245,6,4,10,60.0%,30m
32431,2,[Buge]Shag,2356,151,5,2,7,71.4%,51m
32431,3,LastWish,2356,0,4,2,6,66.7%,2h
32431,3,DeaDbYDawN,2356,97,4,4,8,50.0%,16m
32431,3,sarge,2356,30,2,5,7,28.6%,2h
32431,1,RandyLahey,2356,44,1,2,3,33.3%,3h
32431,1,IrisAtari,2356,46,1,3,4,25.0%,2h
32431,1,MoonCheese,2356,0,1,4,5,20.0%,41m
32431,1,grr,2356,0,1,5,6,16.7%,3h
32431,1,Pisnug,2356,0,0,1,1,0.0%,2h
32431,1,TooMuchLeaf,2356,0,0,1,1,0.0%,3h
32431,1,Arawra,2356,0,0,1,1,0.0%,28m
32431,1,Abathur,2356,0,0,2,2,0.0%,3h
32431,1,NathDevin,2356,0,0,3,3,0.0%,3h
32454,2,Church,2355,1223,171,183,354,48.3%,51m
32454,1,dabdabsmokes,2355,1890,76,76,152,50.0%,43m
32454,3,JustVictor,2355,886,74,71,145,51.0%,45m
32454,3,encpirate,2355,1468,69,71,140,49.3%,2h
32454,1,xanatos,2355,680,23,31,54,42.6%,55m
32454,3,Sinfully,2355,424,14,15,29,48.3%,48m
32454,3,Radeon,2355,376,13,17,30,43.3%,2h
32454,3,noobathon,2355,305,12,15,27,44.4%,2h
32454,3,ColdCultist,2355,104,6,9,15,40.0%,1h
32454,1,glhf,2355,187,5,17,22,22.7%,3h
32454,1,Swagneto,2355,88,2,4,6,33.3%,3h
32454,1,Spetsnaz,2355,0,2,4,6,33.3%,3h
32454,1,XxcoryxX,2355,0,1,1,2,50.0%,2h
32454,1,efuixench,2355,0,1,4,5,20.0%,3h
32454,1,Morgoth,2355,0,0,1,1,0.0%,37m
32454,3,zatinador,2355,0,0,1,1,0.0%,45m
32470,3,OwnerShip,2354,1505,162,169,331,48.9%,18m
32470,1,Stainer,2354,1769,103,81,184,56.0%,48m
32470,3,OLROWDY,2354,611,24,25,49,49.0%,53m
32470,3,GuacamoleBoi,2354,588,20,27,47,42.6%,2h
32470,3,lilbaby,2354,466,19,24,43,44.2%,1h
32470,1,heWULF,2354,382,15,15,30,50.0%,2h
32470,3,DOOMmidget,2354,298,11,14,25,44.0%,35m
32470,2,RES,2354,230,9,12,21,42.9%,48m
32470,1,Sfero,2354,361,9,14,23,39.1%,3h
32470,3,Whatever,2354,262,8,9,17,47.1%,2h
32470,1,Desquarius,2354,80,3,1,4,75.0%,2h
32470,3,tiojofa,2354,58,3,6,9,33.3%,37m
32470,1,randompoop,2354,105,2,3,5,40.0%,8m
32470,1,Erick,2354,0,2,3,5,40.0%,2h
32470,1,Zenthr,2354,0,2,4,6,33.3%,2h
32470,1,OolongTea,2354,46,1,1,2,50.0%,32m
32470,1,Marvas,2354,40,1,2,3,33.3%,3h
32470,3,Hedgewig,2354,0,1,3,4,25.0%,54m
32470,2,farid,2354,0,0,1,1,0.0%,2m
32470,3,[CCGN]shrekie,2354,0,0,4,4,0.0%,46m
32490,3,[FMX]DarthVader,2353,1205,61,49,110,55.5%,2h
32490,3,PanchoVilla,2353,1247,56,59,115,48.7%,2h
32490,3,brseiye,2353,978,38,39,77,49.4%,59m
32490,3,GARY,2353,436,19,21,40,47.5%,1h
32490,3,zucoF,2353,252,17,17,34,50.0%,16m
32490,1,Thorn,2353,337,12,8,20,60.0%,1h
32490,2,Shinkiro,2353,312,11,10,21,52.4%,2h
32490,1,ushiocham,2353,358,9,10,19,47.4%,3h
32490,1,soldadosdejp,2353,0,3,2,5,60.0%,1h
32490,3,[exPFC]Jenckes,2353,34,3,7,10,30.0%,19m
32490,1,BrIGht,2353,44,2,2,4,50.0%,27m
32490,1,Keylogram,2353,0,2,3,5,40.0%,2h
32490,1,DrTran,2353,48,2,5,7,28.6%,1h
32490,3,LightOG,2353,94,2,5,7,28.6%,2h
32490,1,MagmaShark,2353,86,2,6,8,25.0%,2h
32490,2,FrgtOmar,2353,88,2,6,8,25.0%,2h
32490,3,[SCOT]AriLEft,2353,30,1,3,4,25.0%,16m
32490,1,Dantor,2353,0,1,8,9,11.1%,9m
32490,1,Leftyman,2353,0,0,1,1,0.0%,26m
32490,1,Cleaner,2353,0,0,4,4,0.0%,2h
32510,3,[TheBig]Indy,2352,1411,112,120,232,48.3%,10m
32510,1,WaveRider,2352,1678,78,73,151,51.7%,4m
32510,3,Mxikinx,2352,894,70,67,137,51.1%,2h
32510,1,eggsaisle,2352,1198,38,33,71,53.5%,3h
32510,1,UNOCHEESE,2352,687,25,15,40,62.5%,19m
32510,3,samoa,2352,321,11,8,19,57.9%,16m
32510,3,DiegoXD,2352,284,9,11,20,45.0%,54m
32510,3,dabi,2352,154,5,9,14,35.7%,10m
32510,1,Scorpio,2352,132,4,3,7,57.1%,37m
32510,1,cdubbz,2352,86,3,3,6,50.0%,1h
32510,3,RICK,2352,0,3,3,6,50.0%,29m
32510,1,ferdbold,2352,73,3,7,10,30.0%,2h
32510,3,Chef,2352,97,2,0,2,100.0%,2h
32510,3,leanderHCCA,2352,0,2,4,6,33.3%,17m
32510,3,likwidshtuff,2352,0,2,5,7,28.6%,43m
32510,1,TbotGG,2352,0,1,0,1,100.0%,3h
32510,1,Currybomb,2352,44,1,2,3,33.3%,53m
32527,1,coffeestim,2351,1832,96,91,187,51.3%,2h
32527,1,glenson,2351,1770,71,62,133,53.4%,2h
32527,3,Longclaw,2351,798,43,35,78,55.1%,47m
32527,1,MJB,2351,1119,40,36,76,52.6%,4m
32527,3,scimp,2351,292,10,16,26,38.5%,28m
32527,3,[GnR]GrinchMaster,2351,295,9,14,23,39.1%,23m
32527,3,Streb,2351,150,4,3,7,57.1%,2h
32527,3,Wilder,2351,171,4,7,11,36.4%,2h
32527,2,Trucker,2351,135,4,7,11,36.4%,41m
32527,1,fodder,2351,84,2,4,6,33.3%,2h
32527,1,EnBatti,2351,96,2,4,6,33.3%,3h
32527,3,[D3MON]DarkZombie,2351,60,2,6,8,25.0%,48m
32527,1,Yugoslavia,2351,97,2,6,8,25.0%,2h
32527,1,Verkverk,2351,0,1,0,1,100.0%,1h
32527,1,Ray,2351,0,1,1,2,50.0%,19m
32527,1,[EZDUNK]Monkie,2351,103,1,2,3,33.3%,16m
32527,2,USBcord,2351,0,0,1,1,0.0%,3h
32527,1,xluisitox,2351,0,0,2,2,0.0%,3h
32527,2,MochiKitty,2351,0,0,9,9,0.0%,39m
32546,3,INVESTEDT,2350,1396,232,214,446,52.0%,47m
32546,3,Yalain,2350,846,31,34,65,47.7%,53m
32546,1,PasFromage,2350,791,29,20,49,59.2%,2h
32546,3,George,2350,735,27,26,53,50.9%,3h
32546,3,LiveLaughLuv,2350,571,26,19,45,57.8%,3h
32546,3,GridLocK,2350,583,25,20,45,55.6%,2h
32546,1,[Dooski]Dunc,2350,666,19,24,43,44.2%,30m
32546,1,Abigail,2350,490,15,19,34,44.1%,2h
32546,2,[Taco4u]DocBolox,2350,172,8,10,18,44.4%,35m
32546,2,FishFry,2350,240,7,6,13,53.8%,14m
32546,3,Scarface,2350,116,5,7,12,41.7%,3h
32546,1,RETROPRO,2350,168,4,2,6,66.7%,28m
32546,1,Blue,2350,168,4,4,8,50.0%,2h
32546,1,[1NTAMA]yusepe,2350,88,3,3,6,50.0%,3h
32546,3,Dominator,2350,60,3,4,7,42.9%,2h
32546,1,iRex,2350,73,2,6,8,25.0%,2h
32546,3,Angzt,2350,0,1,0,1,100.0%,18m
32546,1,Potpot,2350,0,1,1,2,50.0%,27m
32546,1,Kindor,2350,46,1,3,4,25.0%,3h
32546,3,MenschJager,2350,0,0,2,2,0.0%,1h
32546,3,Frenjyboi,2350,0,0,2,2,0.0%,2h
32546,3,Nero,2350,0,0,3,3,0.0%,47m
32568,1,LanceyLance,2349,968,33,28,61,54.1%,2h
32568,1,peec,2349,570,16,15,31,51.6%,2h
32568,2,NerzhulKeltu,2349,489,16,24,40,40.0%,2h
32568,2,KARAX,2349,234,8,15,23,34.8%,3h
32568,3,Carder,2349,200,5,10,15,33.3%,44m
32568,1,Jason,2349,97,4,8,12,33.3%,23m
32568,1,[SC2PH]rei,2349,181,3,5,8,37.5%,13m
32568,1,InFamous,2349,48,3,5,8,37.5%,60m
32568,1,[SaltyR]nOgeegee,2349,44,2,0,2,100.0%,19m
32568,1,krung,2349,84,2,4,6,33.3%,38m
32568,1,SloppySecond,2349,0,1,0,1,100.0%,2h
32568,1,kbobdcthree,2349,44,1,2,3,33.3%,2h
32568,1,[KTS]Hvo,2349,0,1,4,5,20.0%,3h
32568,3,RaptorII,2349,30,1,6,7,14.3%,11m
32568,1,Natibo,2349,0,0,1,1,0.0%,3h
32568,1,[DKMC]Mercy,2349,0,0,2,2,0.0%,31m
32568,1,Obadiah,2349,0,0,3,3,0.0%,27m
32568,3,gabrielhuebl,2349,0,0,3,3,0.0%,6m
32568,3,HollowShade,2349,0,0,5,5,0.0%,38m
32587,3,Megumin,2348,487,32,37,69,46.4%,2m
32587,1,ZergioFreire,2348,704,28,14,42,66.7%,2h
32587,1,GlazMain,2348,580,17,9,26,65.4%,3m
32587,1,[JeZ]russelkiller,2348,289,10,10,20,50.0%,40m
32587,1,methodL,2348,202,9,13,22,40.9%,2h
32587,3,TenInchMitch,2348,131,7,4,11,63.6%,2h
32587,3,Sauceror,2348,149,4,5,9,44.4%,1h
32587,1,skanks,2348,48,3,4,7,42.9%,45m
32587,3,Baker,2348,30,2,4,6,33.3%,3m
32587,1,anoob,2348,0,1,0,1,100.0%,34m
32587,1,Coneylake,2348,0,1,4,5,20.0%,1h
32587,1,[HURSES]Santasfe,2348,0,1,4,5,20.0%,2h
32587,1,goatkid,2348,0,1,4,5,20.0%,32m
32587,1,CaNaNaDa,2348,0,0,1,1,0.0%,25m
32587,1,[ValidG]MetriC,2348,0,0,4,4,0.0%,13m
32587,3,INTI,2348,0,0,4,4,0.0%,47m
32603,3,[Hilas2]Kramolous,2347,1475,148,155,303,48.8%,23m
32603,3,aha,2347,1484,112,118,230,48.7%,1h
32603,3,hylia,2347,473,18,28,46,39.1%,10m
32603,3,Grixis,2347,444,15,22,37,40.5%,3h
32603,1,KuroNekoII,2347,521,14,7,21,66.7%,50m
32603,1,[SCN]BigPoppaPump,2347,264,11,10,21,52.4%,57m
32603,3,AssassinLeg,2347,166,8,4,12,66.7%,2h
32603,3,BarcodeBill,2347,247,7,3,10,70.0%,4m
32603,1,[DRKDMN]CupCakeBaby,2347,147,6,3,9,66.7%,2h
32603,1,Pieroagw,2347,142,4,2,6,66.7%,3h
32603,1,Tonn,2347,0,3,2,5,60.0%,43m
32603,1,Elíptica,2347,70,3,5,8,37.5%,5m
32603,1,MrCat,2347,0,1,1,2,50.0%,25m
32603,3,Devon,2347,30,1,3,4,25.0%,45m
32603,1,[CRABBR]GPowell,2347,0,1,3,4,25.0%,1h
32603,3,Andoni,2347,0,1,5,6,16.7%,59m
32603,2,Syrel,2347,0,0,1,1,0.0%,1h
32620,3,Splash,2346,872,59,44,103,57.3%,2h
32620,1,Finger,2346,825,29,30,59,49.2%,3h
32620,3,[812]RedREAPER,2346,516,23,24,47,48.9%,1h
32620,1,[ANKL]mackycheese,2346,546,18,18,36,50.0%,3h
32620,3,BigBlackGun,2346,320,12,34,46,26.1%,27m
32620,3,ProddyBootch,2346,248,7,9,16,43.8%,23m
32620,1,juxingxing,2346,214,6,4,10,60.0%,2h
32620,3,Short,2346,114,6,8,14,42.9%,32m
32620,3,Relto,2346,136,5,7,12,41.7%,1h
32620,3,AshyLarry,2346,151,4,5,9,44.4%,32m
32620,1,ManiManitoXD,2346,44,3,3,6,50.0%,2h
32620,1,lostincreati,2346,0,1,0,1,100.0%,30m
32620,1,[DXPCA]KaZiel,2346,0,1,2,3,33.3%,1h
32620,1,YoHindOh,2346,0,1,4,5,20.0%,2h
32620,3,Vas,2346,0,0,1,1,0.0%,34m
32620,1,[EpicG]TheEduGame,2346,0,0,2,2,0.0%,23m
32636,3,GnarFury,2345,912,41,34,75,54.7%,37m
32636,2,Winihutjr,2345,1064,38,50,88,43.2%,41m
32636,3,Malik,2345,579,31,27,58,53.4%,49m
32636,3,YOSHI,2345,450,16,22,38,42.1%,49m
32636,3,LNugget,2345,367,15,15,30,50.0%,2h
32636,3,Farsight,2345,210,7,12,19,36.8%,3h
32636,2,LAD,2345,150,7,12,19,36.8%,48m
32636,3,flipypants,2345,148,5,12,17,29.4%,1h
32636,3,chad,2345,146,5,13,18,27.8%,1h
32636,1,VIPERJ,2345,176,4,5,9,44.4%,3h
32636,1,Smiley,2345,96,3,2,5,60.0%,44m
32636,3,PrincipeZerg,2345,60,2,6,8,25.0%,14m
32636,2,Murphy,2345,38,1,1,2,50.0%,40m
32636,3,Windy,2345,0,1,2,3,33.3%,31m
32636,1,Funkyding,2345,44,1,2,3,33.3%,4m
32636,1,Maxxy,2345,0,1,4,5,20.0%,2h
32636,1,TheWarDuck,2345,0,0,1,1,0.0%,2h
32636,1,DeathChaser,2345,0,0,1,1,0.0%,1h
32636,1,Tehufn,2345,0,0,2,2,0.0%,57m
32636,1,DarkXtm,2345,0,0,3,3,0.0%,3h
32636,2,Rocketman,2345,0,0,4,4,0.0%,3h
32657,1,TryAgain,2344,1879,110,98,208,52.9%,58m
32657,2,stritlybinis,2344,1450,63,62,125,50.4%,2h
32657,1,[oRuRo]NISHINOYA,2344,772,25,20,45,55.6%,55m
32657,3,[NLTN]TITANICO,2344,375,23,24,47,48.9%,8m
32657,1,SurpriseMF,2344,656,21,19,40,52.5%,55m
32657,3,[Comedo]BigPiPi,2344,447,20,19,39,51.3%,2h
32657,1,Sauricks,2344,380,13,15,28,46.4%,3h
32657,1,Grondotter,2344,341,11,15,26,42.3%,58m
32657,3,[1dC]dunkthetrunk,2344,316,11,18,29,37.9%,37m
32657,3,[IPFC]GordoRancio,2344,334,11,19,30,36.7%,47m
32657,1,PAINGZ,2344,203,11,25,36,30.6%,23m
32657,3,Ctykob,2344,281,9,11,20,45.0%,2h
32657,1,poisonrush,2344,271,8,6,14,57.1%,1h
32657,1,chelitax,2344,230,7,3,10,70.0%,43m
32657,3,Malfore,2344,204,7,14,21,33.3%,11m
32657,1,MrCrockett,2344,278,6,1,7,85.7%,2h
32657,1,Panzer,2344,0,4,1,5,80.0%,53m
32657,2,[xBlowy]IlIllIIlllII,2344,226,4,8,12,33.3%,2h
32657,1,Ailill,2344,34,4,9,13,30.8%,58m
32657,3,[Bommmm]klaken,2344,95,2,1,3,66.7%,2h
32657,3,[sjw]WaterSpirit,2344,30,2,4,6,33.3%,47m
32657,1,ASSASSINS,2344,0,1,0,1,100.0%,2h
32657,1,grockey,2344,0,1,4,5,20.0%,1h
32657,1,TheHunter,2344,0,1,4,5,20.0%,22m
32657,1,[NM8]ZeroAPM,2344,0,0,1,1,0.0%,2h
32657,1,MrLeading,2344,0,0,1,1,0.0%,34m
32657,1,[EvnKrg]Aigis,2344,0,0,1,1,0.0%,41m
32657,3,LoboSalvaje,2344,0,0,1,1,0.0%,2h
32657,1,REDENTOR,2344,0,0,2,2,0.0%,3h
32657,1,BOSS,2344,0,0,3,3,0.0%,2h
32687,2,[69MOM]pownednewb,2343,1418,133,136,269,49.4%,3h
32687,3,Wukong,2343,657,29,17,46,63.0%,17m
32687,2,Eclipse,2343,503,21,19,40,52.5%,3h
32687,1,BiruWilds,2343,724,20,18,38,52.6%,30m
32687,3,[0825]cptsparrow,2343,511,18,19,37,48.6%,11m
32687,1,[eTc]Voodoo,2343,606,16,24,40,40.0%,3h
32687,2,clifford,2343,377,14,23,37,37.8%,31m
32687,3,Qyxyr,2343,38,3,8,11,27.3%,16m
32687,1,MrGrim,2343,46,2,3,5,40.0%,3h
32687,2,Jon,2343,88,2,6,8,25.0%,59m
32687,1,luiyox,2343,0,1,0,1,100.0%,1h
32687,3,botch,2343,30,1,3,4,25.0%,53m
32687,1,keni,2343,0,1,4,5,20.0%,58m
32687,1,Kaiser,2343,0,0,1,1,0.0%,2h
32687,1,Muskrap,2343,0,0,2,2,0.0%,2h
32687,1,Gendo,2343,0,0,3,3,0.0%,19m
32687,3,KodanArmada,2343,0,0,4,4,0.0%,49m
32687,1,lililililili,2343,0,0,5,5,0.0%,1h
32705,3,Eternal,2342,1543,162,149,311,52.1%,2h
32705,3,Tomas,2342,1418,72,69,141,51.1%,2h
32705,1,[LOHs]NEMESIS,2342,951,58,70,128,45.3%,54m
32705,1,BeeRed,2342,402,44,34,78,56.4%,2h
32705,3,PotCommander,2342,844,31,36,67,46.3%,5m
32705,1,dragon,2342,831,27,21,48,56.2%,57m
32705,2,Noobalisk,2342,535,21,26,47,44.7%,9m
32705,1,eeertyu,2342,390,14,3,17,82.4%,58m
32705,2,Borealis,2342,318,13,9,22,59.1%,2h
32705,3,Micfetzer,2342,326,12,18,30,40.0%,2h
32705,3,dudeitsdan,2342,252,9,13,22,40.9%,1h
32705,3,Tonno,2342,90,7,6,13,53.8%,2h
32705,3,[PLUNG]Mindwave,2342,142,6,11,17,35.3%,17m
32705,3,Ruska,2342,155,5,9,14,35.7%,3h
32705,1,WWCC,2342,36,4,5,9,44.4%,3h
32705,3,Matthew,2342,146,3,2,5,60.0%,1h
32705,2,Virus,2342,162,3,4,7,42.9%,55m
32705,3,rangertot,2342,88,3,8,11,27.3%,23m
32705,2,eden,2342,0,2,5,7,28.6%,23m
32705,1,[m0ld]ADHD,2342,46,1,2,3,33.3%,5m
32705,1,Kiba,2342,0,1,4,5,20.0%,3h
32705,2,DaBoss,2342,0,1,4,5,20.0%,3h
32705,1,TOOswEEt,2342,0,0,1,1,0.0%,22m
32705,1,NilsFJJR,2342,0,0,2,2,0.0%,3h
32705,1,xdiegosan,2342,0,0,2,2,0.0%,37m
32705,2,ANUBIS,2342,0,0,9,9,0.0%,3h
32731,3,Gaskike,2341,1308,189,206,395,47.8%,2h
32731,2,inota,2341,416,56,46,102,54.9%,50m
32731,2,nightblood,2341,710,38,43,81,46.9%,36m
32731,3,[TuRtel]Wreckful,2341,374,37,37,74,50.0%,16m
32731,3,[NE1469]Diktril,2341,600,35,17,52,67.3%,2h
32731,1,[B8T]dankpizzaxD,2341,986,30,25,55,54.5%,4m
32731,1,Melifire,2341,840,28,22,50,56.0%,1h
32731,3,Alpacacide,2341,397,20,18,38,52.6%,1h
32731,3,Titan,2341,235,8,6,14,57.1%,2h
32731,3,Brutalisk,2341,271,8,9,17,47.1%,2h
32731,2,cake,2341,233,8,10,18,44.4%,2h
32731,3,PlagatH,2341,170,7,12,19,36.8%,2h
32731,1,[OTWAG]RectSqG,2341,130,4,2,6,66.7%,3h
32731,1,DingusKhan,2341,0,3,2,5,60.0%,3h
32731,2,JonasDeLuna,2341,38,3,7,10,30.0%,9m
32731,3,[859]Drizzle,2341,121,2,2,4,50.0%,3h
32731,3,[kØ]FireBaTH,2341,123,2,3,5,40.0%,2h
32731,3,glögg,2341,0,1,3,4,25.0%,17m
32731,1,RJB,2341,0,1,4,5,20.0%,13m
32731,1,[PobSC]AngelNegro,2341,0,1,4,5,20.0%,2h
32731,1,[BRRR]depth,2341,44,1,5,6,16.7%,3h
32731,1,Axe,2341,0,0,1,1,0.0%,3h
32731,3,[Dvier]Cruiser,2341,0,0,2,2,0.0%,44m
32731,1,Rotors,2341,0,0,4,4,0.0%,17m
32755,3,DexMarcos,2340,1499,124,129,253,49.0%,23m
32755,1,Pavel,2340,1809,75,76,151,49.7%,2h
32755,3,iTrauma,2340,856,36,34,70,51.4%,2h
32755,3,IrishZiggy,2340,511,22,22,44,50.0%,44m
32755,1,Daggerhand,2340,457,19,19,38,50.0%,1h
32755,2,Gruul,2340,316,12,17,29,41.4%,39m
32755,1,itsstebo,2340,316,9,11,20,45.0%,42m
32755,3,haHA,2340,204,8,11,19,42.1%,2h
32755,3,Clumsyninja,2340,198,6,10,16,37.5%,40m
32755,1,mollejita,2340,121,3,4,7,42.9%,1h
32755,1,ADGN,2340,0,2,2,4,50.0%,2h
32755,1,reteP,2340,78,2,3,5,40.0%,34m
32755,1,[PTHero]oSeabass,2340,0,2,3,5,40.0%,22m
32755,3,MegaFlare,2340,121,2,6,8,25.0%,46m
32755,1,Fireteam,2340,44,1,1,2,50.0%,22m
32755,1,GroceryBoyTV,2340,0,1,1,2,50.0%,3h
32755,1,NumbersMason,2340,0,1,4,5,20.0%,2h
32755,1,IIIIALEXIIII,2340,0,1,4,5,20.0%,7m
32755,3,[SkAL]Munchies,2340,0,1,5,6,16.7%,3h
32755,1,magicahn,2340,0,0,2,2,0.0%,41m
32775,3,[Xital2]headwinds,2339,1566,185,193,378,48.9%,1h
32775,1,Maru,2339,1430,52,47,99,52.5%,3h
32775,2,Wydwen,2339,628,41,34,75,54.7%,35m
32775,1,GOLDENBOY,2339,541,22,21,43,51.2%,22m
32775,1,Rafonius,2339,536,16,9,25,64.0%,3h
32775,1,Shoegazi,2339,244,10,1,11,90.9%,40m
32775,1,inviscarrot,2339,189,7,4,11,63.6%,3h
32775,3,Leroy,2339,249,7,9,16,43.8%,3h
32775,1,Ulzok,2339,0,1,4,5,20.0%,21m
32775,1,DrWaky,2339,0,1,4,5,20.0%,3h
32775,1,[H1dra]Demonoids,2339,0,0,1,1,0.0%,2h
32775,1,Dex,2339,0,0,1,1,0.0%,22m
32775,2,[ffaaak]POKEMONMEN,2339,0,0,3,3,0.0%,3h
32788,3,BunkerWolf,2338,1453,57,53,110,51.8%,3h
32788,1,YeahItsPanda,2338,601,21,11,32,65.6%,9m
32788,3,[Krush]DoUgZ,2338,484,16,22,38,42.1%,1h
32788,2,[TE0]truth,2338,445,16,23,39,41.0%,1h
32788,1,RNS,2338,461,11,7,18,61.1%,1h
32788,1,GERTY,2338,374,11,19,30,36.7%,3h
32788,3,iceman,2338,171,7,13,20,35.0%,46m
32788,1,techuosuelo,2338,194,6,2,8,75.0%,22m
32788,2,Spacemonkey,2338,163,6,11,17,35.3%,2h
32788,1,[AbcCo]papibatman,2338,188,5,4,9,55.6%,2h
32788,1,iTK,2338,212,5,7,12,41.7%,3h
32788,3,[PiN0YS]TantanPH,2338,107,4,6,10,40.0%,1h
32788,3,Brahms,2338,169,4,6,10,40.0%,10m
32788,1,poLycromatic,2338,169,3,1,4,75.0%,1h
32788,3,XNur,2338,121,2,6,8,25.0%,2h
32788,1,Zaga,2338,96,2,7,9,22.2%,2h
32788,1,[UtPowr]TopTap,2338,0,1,0,1,100.0%,2h
32788,1,XxxManatexxX,2338,0,1,0,1,100.0%,3h
32788,1,Starboy,2338,44,1,1,2,50.0%,52m
32788,1,Lawgiver,2338,0,1,4,5,20.0%,2h
32788,1,[FoxBR]ButterHead,2338,0,1,4,5,20.0%,21m
32788,3,jacob,2338,0,1,5,6,16.7%,23m
32810,1,jello,2337,1404,51,51,102,50.0%,28m
32810,1,Xeerok,2337,810,46,54,100,46.0%,42m
32810,1,Brou,2337,375,36,26,62,58.1%,58m
32810,1,Appexx,2337,642,16,18,34,47.1%,3h
32810,1,[FO76FL]Aeonaxx,2337,496,14,14,28,50.0%,3h
32810,2,aliasr,2337,188,9,9,18,50.0%,2h
32810,3,Duo,2337,286,9,12,21,42.9%,14m
32810,3,Gheed,2337,267,8,9,17,47.1%,20m
32810,3,DaemonYu,2337,165,8,10,18,44.4%,2h
32810,3,Asic,2337,266,8,12,20,40.0%,13m
32810,1,Danimoth,2337,237,8,15,23,34.8%,52m
32810,3,Justin,2337,133,4,5,9,44.4%,29m
32810,1,[wERNb]ColdC,2337,96,3,0,3,100.0%,37m
32810,1,covcg,2337,0,3,2,5,60.0%,2h
32810,3,CraftyJStar,2337,0,3,3,6,50.0%,31m
32810,1,RjBa,2337,0,2,4,6,33.3%,2h
32810,1,Glyphx,2337,109,2,4,6,33.3%,30m
32810,1,Grimra,2337,0,1,0,1,100.0%,11m
32810,1,agustingamer,2337,0,1,1,2,50.0%,2h
32810,1,[HOT69]Moosgoo,2337,44,1,3,4,25.0%,22m
32810,1,TheReptile,2337,44,1,3,4,25.0%,32m
32810,1,[SIMgg]IIlIIIlIIlll,2337,0,1,4,5,20.0%,19m
32810,1,jizzzstain,2337,30,1,12,13,7.7%,35m
32810,1,EpicWaffle,2337,0,0,1,1,0.0%,2h
32810,1,Eonth,2337,0,0,1,1,0.0%,2h
32810,1,HomerHotshot,2337,0,0,2,2,0.0%,57m
32810,1,phoenix,2337,73,0,4,4,0.0%,2h
32837,1,moose,2336,1636,258,263,521,49.5%,17m
32837,1,WtSucks,2336,1371,45,41,86,52.3%,44m
32837,3,[Kodos]OttO,2336,786,41,32,73,56.2%,46m
32837,1,Wantan,2336,839,32,29,61,52.5%,32m
32837,1,[Macac0]MoisesOtaku,2336,318,14,8,22,63.6%,1h
32837,3,Badger,2336,362,13,17,30,43.3%,40m
32837,1,jader,2336,390,11,7,18,61.1%,22m
32837,1,Chuck,2336,222,10,4,14,71.4%,8m
32837,1,mangekyu,2336,152,6,0,6,100.0%,2h
32837,1,[IiUiI]chuckSpear,2336,241,6,6,12,50.0%,1h
32837,3,[Th3Bad]Alexandre,2336,188,6,6,12,50.0%,3h
32837,1,IIIIIIIIIII,2336,211,6,9,15,40.0%,57m
32837,2,CitizenDildo,2336,224,6,15,21,28.6%,56m
32837,1,Hexamir,2336,80,3,6,9,33.3%,2h
32837,1,WallyDaPleco,2336,41,2,1,3,66.7%,41m
32837,1,[MªnCºs]HHMM,2336,86,2,3,5,40.0%,30m
32837,1,rEAPER,2336,131,2,4,6,33.3%,3h
32837,3,DogeLord,2336,0,1,0,1,100.0%,50m
32837,1,[SEMPAY]Marcus,2336,0,1,3,4,25.0%,2h
32837,3,Skygurner,2336,30,1,4,5,20.0%,10m
32857,3,tygur,2335,1563,193,189,382,50.5%,2h
32857,1,Lyss,2335,722,61,54,115,53.0%,30m
32857,3,[FatMom]Jason,2335,1221,46,49,95,48.4%,17m
32857,1,Cluitarhero,2335,436,12,9,21,57.1%,58m
32857,2,shamam,2335,220,8,12,20,40.0%,14m
32857,1,James,2335,208,5,8,13,38.5%,1h
32857,1,Jex,2335,0,4,1,5,80.0%,41m
32857,1,Moonkhalifa,2335,145,4,5,9,44.4%,1h
32857,1,Thunor,2335,88,3,3,6,50.0%,2h
32857,1,IlIIlIlIllIl,2335,0,1,0,1,100.0%,3h
32857,1,Masocara,2335,0,1,1,2,50.0%,2h
32857,1,DarkVisnz,2335,0,1,2,3,33.3%,39m
32857,3,gpsugy,2335,0,1,8,9,11.1%,55m
32857,1,BuckleSmuglr,2335,0,0,1,1,0.0%,1h
32857,1,Deller,2335,0,0,1,1,0.0%,43m
32857,2,ChristianOnt,2335,0,0,2,2,0.0%,29m
32873,1,TarkustheTan,2334,1079,46,28,74,62.2%,37m
32873,2,EnragedEwok,2334,767,27,38,65,41.5%,37m
32873,3,Carrascal,2334,454,18,19,37,48.6%,40m
32873,1,kaan,2334,600,17,16,33,51.5%,25m
32873,1,Unagi,2334,278,16,1,17,94.1%,1h
32873,3,[BlTEL]MAIKWIZARD,2334,308,11,15,26,42.3%,29m
32873,3,Zerg,2334,140,4,3,7,57.1%,2h
32873,1,Dapalner,2334,130,4,4,8,50.0%,58m
32873,1,CosmicWolf,2334,44,2,0,2,100.0%,1h
32873,1,Creplord,2334,0,1,0,1,100.0%,43m
32873,3,MaxPower,2334,0,1,5,6,16.7%,2h
32873,1,[UKNOME]xsickBoy,2334,0,0,3,3,0.0%,2h
32873,1,[502nd]Burnley,2334,0,0,3,3,0.0%,24m
32886,1,goofypoop,2333,1542,53,54,107,49.5%,2h
32886,3,Battlesteak,2333,687,28,30,58,48.3%,14m
32886,3,Nick,2333,336,12,16,28,42.9%,38m
32886,2,Mysticlemon,2333,303,11,13,24,45.8%,3h
32886,1,Roger,2333,214,11,13,24,45.8%,3h
32886,3,Caligula,2333,120,5,8,13,38.5%,8m
32886,1,invoker,2333,0,3,2,5,60.0%,43m
32886,3,OverMind,2333,0,1,3,4,25.0%,49m
32886,1,TheChicken,2333,0,1,4,5,20.0%,1h
32886,1,Booger,2333,0,1,5,6,16.7%,33m
32886,1,toxichof,2333,0,1,5,6,16.7%,2h
32886,1,Lilith,2333,0,0,1,1,0.0%,21m
32886,3,Coraje,2333,0,0,2,2,0.0%,37m
32886,1,Broodlord,2333,0,0,2,2,0.0%,2h
32886,3,DragonSlayer,2333,0,0,5,5,0.0%,2h
32886,1,PillageNBurn,2333,0,0,5,5,0.0%,1h
32902,1,Mini,2332,1882,83,83,166,50.0%,2h
32902,1,xInmortalx,2332,1112,35,38,73,47.9%,2h
32902,1,Grim,2332,726,23,23,46,50.0%,3h
32902,3,llllllllllll,2332,548,21,21,42,50.0%,2h
32902,2,Lawdawg,2332,372,14,21,35,40.0%,52m
32902,3,[HitBox]ToeKnee,2332,266,10,11,21,47.6%,27m
32902,1,biwie,2332,299,10,12,22,45.5%,2h
32902,3,PurpReynolds,2332,256,9,14,23,39.1%,2h
32902,2,Zmyth,2332,152,9,15,24,37.5%,23m
32902,1,[TY4GG]Dominator,2332,318,7,2,9,77.8%,2h
32902,1,tjander,2332,137,5,4,9,55.6%,2h
32902,3,outlaw,2332,122,5,5,10,50.0%,37m
32902,1,[3xS]suikoden,2332,0,3,2,5,60.0%,2h
32902,1,[ELITZ]Kero,2332,128,3,4,7,42.9%,2h
32902,1,[SCPuno]CriZtorm,2332,96,2,0,2,100.0%,8m
32902,1,AlexB,2332,46,2,3,5,40.0%,3h
32902,1,SilentStorm,2332,0,1,2,3,33.3%,39m
32902,1,[MSganG]Shazrock,2332,0,0,2,2,0.0%,28m
32902,1,Suffocation,2332,0,0,4,4,0.0%,21m
32921,2,MatoCinza,2331,1015,113,101,214,52.8%,35m
32921,3,RenAir,2331,711,48,48,96,50.0%,2h
32921,2,Nemesis,2331,777,33,34,67,49.3%,2h
32921,3,Flecktarn,2331,665,24,25,49,49.0%,24m
32921,1,EchoShib,2331,537,16,20,36,44.4%,40m
32921,3,Ling,2331,313,14,18,32,43.8%,17m
32921,3,electric,2331,277,10,7,17,58.8%,47m
32921,1,[JamRoc]falcon,2331,317,7,9,16,43.8%,3h
32921,1,Segatex,2331,42,4,2,6,66.7%,3h
32921,3,mule,2331,162,4,8,12,33.3%,2h
32921,3,Vorta,2331,131,3,7,10,30.0%,2h
32921,1,[DRKPMT]Gamble,2331,40,2,6,8,25.0%,2h
32921,3,Vince,2331,62,2,7,9,22.2%,2h
32921,1,ChefCharles,2331,0,1,5,6,16.7%,2h
32921,1,FlippedBacon,2331,0,0,1,1,0.0%,5m
32921,1,xupulo,2331,0,0,1,1,0.0%,21m
32937,1,Deiva,2330,686,28,17,45,62.2%,3h
32937,1,Trogdor,2330,676,22,20,42,52.4%,9m
32937,3,brainbug,2330,444,15,22,37,40.5%,16m
32937,3,KilgoreTrout,2330,438,14,23,37,37.8%,2h
32937,3,[OAFAF]ViChO,2330,265,11,12,23,47.8%,3h
32937,1,ketch,2330,242,6,4,10,60.0%,1h
32937,2,[PIN]Davo,2330,177,6,11,17,35.3%,12m
32937,1,SOK,2330,88,3,2,5,60.0%,22m
32937,1,SpeedOfDark,2330,145,3,5,8,37.5%,3h
32937,1,Rinzler,2330,0,2,4,6,33.3%,60m
32937,1,PretoGanso,2330,133,2,5,7,28.6%,2h
32937,1,Cutesnuggles,2330,44,1,1,2,50.0%,3h
32937,1,ZergIsPiiimp,2330,0,1,5,6,16.7%,1h
32937,1,Cronos,2330,73,0,2,2,0.0%,1h
32937,3,Pmz,2330,0,0,5,5,0.0%,1h
32952,1,BGERO,2329,1144,49,32,81,60.5%,3h
32952,2,[FTLTX]Cesare,2329,843,42,45,87,48.3%,37m
32952,3,change,2329,768,26,36,62,41.9%,13m
32952,3,[JUGOS2]RobDy,2329,54,9,17,26,34.6%,17m
32952,3,Kcajakon,2329,30,3,5,8,37.5%,44m
32952,1,VerySweet,2329,42,2,0,2,100.0%,43m
32952,3,kaos,2329,0,1,1,2,50.0%,46m
32952,3,SunTzu,2329,0,0,2,2,0.0%,1h
32960,3,NIceAss,2328,1468,65,56,121,53.7%,2h
32960,3,Suamãe,2328,846,54,56,110,49.1%,1h
32960,1,Justinius,2328,1450,51,47,98,52.0%,19m
32960,1,sbmc,2328,838,48,58,106,45.3%,2h
32960,3,Ivan,2328,879,45,39,84,53.6%,3m
32960,1,Mosquito,2328,1024,33,27,60,55.0%,16m
32960,1,RiCe,2328,901,29,26,55,52.7%,28m
32960,3,Todd,2328,179,17,17,34,50.0%,2h
32960,3,potdark,2328,451,16,14,30,53.3%,1h
32960,1,fleuph,2328,308,13,18,31,41.9%,2h
32960,1,Hew,2328,371,12,15,27,44.4%,3h
32960,1,Lycan,2328,277,9,4,13,69.2%,2h
32960,2,handres,2328,250,7,12,19,36.8%,2h
32960,1,builder,2328,249,7,13,20,35.0%,2h
32960,3,Dibs,2328,216,6,9,15,40.0%,2h
32960,3,PinillaZtick,2328,146,4,2,6,66.7%,2h
32960,3,cherrypiepod,2328,149,4,11,15,26.7%,15m
32960,1,LonePorpoise,2328,135,3,0,3,100.0%,2h
32960,1,HaxBagoosh,2328,146,3,6,9,33.3%,3h
32960,1,starz,2328,145,2,2,4,50.0%,2h
32960,1,Viktor,2328,40,2,5,7,28.6%,2h
32960,3,WholeWheat,2328,0,2,6,8,25.0%,17m
32960,2,[i2ush]Syí,2328,0,2,8,10,20.0%,42m
32960,2,Marrow,2328,38,1,1,2,50.0%,29m
32960,3,DoomBanana,2328,30,1,4,5,20.0%,24m
32960,1,mouse,2328,0,1,5,6,16.7%,8m
32960,1,Spartanis,2328,0,1,6,7,14.3%,2h
32960,3,Painwake,2328,0,0,2,2,0.0%,45m
32960,1,Zerglings,2328,0,0,2,2,0.0%,21m
32989,2,AonecreAtion,2327,1510,230,267,497,46.3%,2h
32989,1,[MARIO6]magolunatico,2327,1247,60,53,113,53.1%,53m
32989,3,Darkside,2327,1194,48,40,88,54.5%,32m
32989,3,Bladimir,2327,574,31,35,66,47.0%,1h
32989,1,UggaSmash,2327,507,18,14,32,56.2%,2h
32989,1,INVADERVIN,2327,508,18,15,33,54.5%,1h
32989,2,Adam,2327,461,17,24,41,41.5%,27m
32989,3,XxVenusXx,2327,365,14,16,30,46.7%,2h
32989,2,HrouMA,2327,88,5,9,14,35.7%,53m
32989,3,Reevo,2327,104,5,10,15,33.3%,2h
32989,3,[Oopsy]ZeeWes,2327,88,4,8,12,33.3%,14m
32989,1,peyton,2327,0,3,2,5,60.0%,7m
32989,3,Vares,2327,0,3,4,7,42.9%,2h
32989,1,Mindful,2327,48,3,5,8,37.5%,12m
32989,3,lobsterboy,2327,0,2,6,8,25.0%,2h
32989,1,Raddellee,2327,48,2,6,8,25.0%,37m
32989,1,iiNGloriouS,2327,0,1,0,1,100.0%,57m
32989,3,[ABIO12]JefDahmrsKid,2327,0,1,1,2,50.0%,44m
32989,1,[BEUG]Bradinator,2327,0,1,4,5,20.0%,41m
32989,1,Virus,2327,0,1,4,5,20.0%,28m
32989,1,Mixalot,2327,0,0,5,5,0.0%,25m
33010,2,[NEW]MORTE,2326,1386,56,60,116,48.3%,24m
33010,1,OrangeJuice,2326,730,24,21,45,53.3%,53m
33010,1,KYcompton,2326,606,21,35,56,37.5%,3h
33010,1,[Kixeye]Seek,2326,652,19,18,37,51.4%,39m
33010,3,[XDRAX8]Jake,2326,388,18,15,33,54.5%,46m
33010,1,Shuriken,2326,462,11,16,27,40.7%,56m
33010,2,rebel,2326,230,8,12,20,40.0%,3h
33010,1,[pajaro]ELE,2326,204,6,3,9,66.7%,3h
33010,1,Nyx,2326,216,6,6,12,50.0%,25m
33010,3,[NKW]Crosen,2326,106,4,6,10,40.0%,46m
33010,3,NightMare,2326,158,4,6,10,40.0%,3h
33010,1,pwavvy,2326,44,2,1,3,66.7%,56m
33010,1,[CaroKa]StarWrsLoser,2326,46,2,2,4,50.0%,1h
33010,1,jose,2326,46,2,3,5,40.0%,1h
33010,1,Noa,2326,44,2,4,6,33.3%,2h
33010,1,[sW4Rmz]NoobCakes,2326,40,2,5,7,28.6%,2h
33010,1,[TheReg]Cornelius,2326,0,1,0,1,100.0%,3h
33010,3,[Dads]Changdesu,2326,30,1,5,6,16.7%,1h
33010,1,champ,2326,0,1,5,6,16.7%,3h
33010,3,Rmenne,2326,30,1,6,7,14.3%,2h
33010,3,WarGodOdin,2326,0,0,1,1,0.0%,25m
33010,1,[STOGIE]SwtPoontang,2326,0,0,2,2,0.0%,37m
33032,3,Thunderthigh,2325,929,57,58,115,49.6%,2h
33032,3,AShadyBadger,2325,904,40,35,75,53.3%,37m
33032,3,HumanShield,2325,647,22,27,49,44.9%,17m
33032,3,[TOPUA]MaDDoG,2325,434,18,21,39,46.2%,3h
33032,1,Cokedajoke,2325,215,7,5,12,58.3%,3h
33032,1,unphased,2325,156,5,5,10,50.0%,55m
33032,1,QueenCheese,2325,123,4,9,13,30.8%,55m
33032,1,EverForever,2325,48,3,7,10,30.0%,2h
33032,1,ViolentFlame,2325,119,2,1,3,66.7%,11m
33032,2,JordyJoesta,2325,0,2,5,7,28.6%,60m
33032,1,MrTaco,2325,96,2,7,9,22.2%,2h
33032,1,[Huffs]Imposter,2325,0,1,4,5,20.0%,17m
33032,3,KesaGatame,2325,0,1,5,6,16.7%,2h
33032,1,Younge,2325,0,0,2,2,0.0%,3h
33032,1,[Aw00ga]ITZOrCaZ,2325,0,0,2,2,0.0%,2h
33032,1,Jarsoft,2325,0,0,2,2,0.0%,1h
33048,1,Murdura,2324,1829,89,93,182,48.9%,3h
33048,1,tygus,2324,940,26,26,52,50.0%,13m
33048,3,PieroCV,2324,231,7,11,18,38.9%,17m
33048,3,[CNCOM]Frost,2324,0,3,3,6,50.0%,3h
33048,1,trunlmnmprzr,2324,144,3,8,11,27.3%,2h
33048,1,Hank,2324,0,1,0,1,100.0%,3h
33048,1,Noruken,2324,0,1,2,3,33.3%,3m
33048,1,Bill,2324,0,0,1,1,0.0%,3h
33048,1,Hydrojager,2324,0,0,1,1,0.0%,53m
33057,3,jiqinowo,2323,1303,116,113,229,50.7%,2h
33057,3,baleeet,2323,674,24,27,51,47.1%,1h
33057,2,Ferco,2323,644,24,32,56,42.9%,37m
33057,3,soto,2323,465,17,19,36,47.2%,2h
33057,1,Higgles,2323,582,16,16,32,50.0%,1h
33057,3,BrickWiggles,2323,426,15,20,35,42.9%,58m
33057,3,Chronos,2323,427,14,21,35,40.0%,47m
33057,3,[M4nLUV]FillMeUpDadd,2323,110,7,12,19,36.8%,38m
33057,1,ArtiC,2323,176,5,4,9,55.6%,31m
33057,3,Kev,2323,145,3,2,5,60.0%,34m
33057,1,FutureKarma,2323,44,1,1,2,50.0%,3h
33057,1,[SNACH]Lucifermadis,2323,44,1,5,6,16.7%,37m
33057,1,Amalada,2323,0,0,1,1,0.0%,30m
33057,1,madek,2323,0,0,3,3,0.0%,2h
33071,1,[WSCON]Styles,2322,859,38,38,76,50.0%,3h
33071,3,TAZADAR,2322,388,14,14,28,50.0%,16m
33071,1,[Pig2]Kybrit,2322,403,11,4,15,73.3%,19m
33071,1,Supaplex,2322,305,10,2,12,83.3%,3h
33071,1,GasMaskGhost,2322,392,10,10,20,50.0%,25m
33071,3,langostino,2322,240,9,13,22,40.9%,1h
33071,3,Murlock,2322,151,6,7,13,46.2%,40m
33071,1,veqgooff,2322,292,6,7,13,46.2%,1h
33071,1,[PUNDR]TritochHuntr,2322,130,4,1,5,80.0%,1h
33071,3,matrixman,2322,0,1,0,1,100.0%,2h
33071,1,Captian,2322,48,1,2,3,33.3%,1h
33071,3,TIDUS,2322,95,1,3,4,25.0%,47m
33071,1,SnowySmurf,2322,0,1,4,5,20.0%,2h
33071,3,[SWOU]Capone,2322,0,1,5,6,16.7%,54m
33071,1,AlpHaWolf,2322,0,0,1,1,0.0%,2h
33071,1,EyyyBert,2322,0,0,1,1,0.0%,55m
33071,3,trevol,2322,0,0,2,2,0.0%,16m
33088,3,Qbos,2321,1198,920,991,1911,48.1%,47m
33088,2,Jude,2321,1507,113,113,226,50.0%,3h
33088,2,[FUPAzz]DrPhil,2321,1566,98,98,196,50.0%,3h
33088,1,raccoon,2321,1688,74,45,119,62.2%,2h
33088,1,[SLPDKY]Onslaught,2321,1520,50,50,100,50.0%,27m
33088,1,Tuckahoe,2321,397,34,44,78,43.6%,37m
33088,1,TotalNoobie,2321,973,32,27,59,54.2%,1h
33088,2,Talifax,2321,303,10,13,23,43.5%,2h
33088,3,[NASIS]MARCUZ,2321,245,9,12,21,42.9%,2h
33088,1,Genji,2321,91,6,5,11,54.5%,47m
33088,3,skyG,2321,171,4,3,7,57.1%,12m
33088,2,ElConejito,2321,159,4,3,7,57.1%,2h
33088,1,OSI,2321,48,4,3,7,57.1%,2h
33088,1,DAsHieeTTT,2321,145,3,1,4,75.0%,2h
33088,3,[DoVOID]madkorean,2321,38,3,9,12,25.0%,17m
33088,1,TooDownMan,2321,97,1,1,2,50.0%,25m
33088,3,CabCaramelo,2321,97,1,1,2,50.0%,3h
33088,3,[catcat]Anubis,2321,0,1,6,7,14.3%,2h
33088,1,Sheep,2321,0,0,1,1,0.0%,48m
33088,1,Shazza,2321,0,0,2,2,0.0%,59m
33108,3,Brandon,2320,1417,120,108,228,52.6%,46m
33108,2,Hizamaru,2320,1401,83,79,162,51.2%,3h
33108,2,nanawo,2320,812,32,37,69,46.4%,24m
33108,3,Toxon,2320,400,13,20,33,39.4%,47m
33108,2,Mutamishi,2320,252,10,15,25,40.0%,45m
33108,2,Citadel,2320,266,8,14,22,36.4%,47m
33108,3,faredon,2320,0,4,3,7,57.1%,2h
33108,3,[mi5hKa]TarO,2320,92,3,10,13,23.1%,1h
33108,3,Sicarius,2320,0,2,4,6,33.3%,5m
33108,3,chekkie,2320,97,2,6,8,25.0%,20m
33108,3,[SKGS]Elydan,2320,60,2,7,9,22.2%,3h
33108,3,DocNun,2320,0,1,5,6,16.7%,2h
33108,1,Zergalicious,2320,0,0,1,1,0.0%,1h
33108,1,baaluu,2320,0,0,1,1,0.0%,3h
33122,3,Edge,2319,510,110,109,219,50.2%,46m
33122,1,jeremiaz,2319,923,32,23,55,58.2%,53m
33122,3,TheProphet,2319,519,18,20,38,47.4%,48m
33122,1,jeanfes,2319,562,14,11,25,56.0%,1h
33122,1,[WW2LA]NinjaRobot,2319,307,9,3,12,75.0%,3h
33122,1,[LCE]rosedo,2319,356,9,10,19,47.4%,1h
33122,1,TotalNoob,2319,252,8,8,16,50.0%,2h
33122,1,Erick,2319,287,8,11,19,42.1%,3h
33122,3,[Cheees]sweetsalad,2319,170,6,7,13,46.2%,16m
33122,1,pippuru,2319,48,6,9,15,40.0%,2h
33122,2,BLAZE,2319,226,6,17,23,26.1%,2h
33122,1,Sazzer,2319,103,4,1,5,80.0%,44m
33122,1,MRjason,2319,124,4,3,7,57.1%,1h
33122,1,[DhZAc1]Santoliver,2319,90,3,2,5,60.0%,2h
33122,3,HurpDaDerp,2319,121,3,6,9,33.3%,24m
33122,3,CannonFiesta,2319,86,3,8,11,27.3%,23m
33122,1,kihun,2319,88,2,2,4,50.0%,42m
33122,1,KingJulek,2319,0,2,7,9,22.2%,2h
33122,1,jottoman,2319,0,1,1,2,50.0%,43m
33122,1,Milotook,2319,0,1,4,5,20.0%,2h
33142,1,JRQ,2318,1649,56,51,107,52.3%,19m
33142,1,boofmeister,2318,783,35,28,63,55.6%,44m
33142,1,marius,2318,352,14,22,36,38.9%,52m
33142,2,Donk,2318,168,6,9,15,40.0%,36m
33142,3,[latrom]Exothermic,2318,182,6,9,15,40.0%,54m
33142,1,MVH,2318,140,4,5,9,44.4%,1h
33142,3,NanashiSama,2318,30,2,1,3,66.7%,59m
33142,1,[SC2PL]Bleak,2318,0,1,0,1,100.0%,41m
33142,1,SHoodaB,2318,0,1,1,2,50.0%,3h
33142,1,Dedalus,2318,0,1,4,5,20.0%,1h
33142,1,FRANClS,2318,44,1,4,5,20.0%,7m
33142,1,aleksro,2318,0,1,4,5,20.0%,53m
33142,1,Doom,2318,0,0,1,1,0.0%,4m
33155,1,gothboy,2317,1690,64,59,123,52.0%,41m
33155,1,Zerglicious,2317,1735,57,60,117,48.7%,3h
33155,3,clock,2317,585,24,23,47,51.1%,1h
33155,1,Slaughter,2317,402,14,13,27,51.9%,3h
33155,3,HOLYGOST,2317,286,13,14,27,48.1%,2h
33155,1,Anpaul,2317,321,7,3,10,70.0%,4m
33155,2,SpLiCe,2317,227,7,7,14,50.0%,2h
33155,3,KILLABLADE,2317,183,6,7,13,46.2%,60m
33155,3,Death,2317,92,6,8,14,42.9%,54m
33155,1,[GAWDz]KingOfWinnin,2317,218,6,9,15,40.0%,22m
33155,3,SuicidalFrog,2317,203,6,10,16,37.5%,3m
33155,1,logikk,2317,130,3,4,7,42.9%,32m
33155,3,Yomobrojoe,2317,98,3,8,11,27.3%,6m
33155,3,Malevolent,2317,90,3,8,11,27.3%,1h
33155,3,DrBowMan,2317,66,3,9,12,25.0%,1h
33155,1,Kloverki,2317,0,1,0,1,100.0%,39m
33155,1,Kirk,2317,0,1,1,2,50.0%,3h
33155,1,legnar,2317,44,1,3,4,25.0%,2h
33155,2,Manuelito,2317,0,1,7,8,12.5%,37m
33155,1,Shiroku,2317,0,0,1,1,0.0%,35m
33155,1,RolloTomassi,2317,0,0,1,1,0.0%,55m
33155,1,Urax,2317,0,0,1,1,0.0%,25m
33155,1,DaTastyNinja,2317,0,0,2,2,0.0%,2h
33155,1,Cebures,2317,0,0,2,2,0.0%,3h
33179,2,[NLTN]GGdarius,2316,1546,84,84,168,50.0%,60m
33179,1,[FTTD]SUHAIRE,2316,1765,63,66,129,48.8%,1h
33179,3,jagrjagr,2316,901,52,50,102,51.0%,1h
33179,1,Drumpus,2316,862,28,27,55,50.9%,2h
33179,3,[GRNSKN]Vagus,2316,513,28,34,62,45.2%,3h
33179,1,Erwin,2316,800,23,20,43,53.5%,3h
33179,1,Thrawn,2316,178,12,3,15,80.0%,60m
33179,1,METTAK,2316,156,4,0,4,100.0%,3h
33179,3,[n3wk1d]clashvalian,2316,128,4,8,12,33.3%,53m
33179,3,mikoohij,2316,60,3,6,9,33.3%,14m
33179,1,nuckfut,2316,0,1,5,6,16.7%,1h
33179,1,creeperzerg,2316,0,0,1,1,0.0%,3h
33191,1,RazAlGhul,2315,1854,111,105,216,51.4%,13m
33191,1,Kevyncito,2315,1851,84,80,164,51.2%,3h
33191,1,[Noobys]Tyler,2315,1302,46,39,85,54.1%,37m
33191,1,BonesThGhost,2315,1198,40,41,81,49.4%,2h
33191,3,[KEKKK]Inquits,2315,259,38,31,69,55.1%,1h
33191,1,Salchipapu,2315,742,22,17,39,56.4%,4m
33191,1,Ravenbery,2315,321,16,18,34,47.1%,3h
33191,2,PDXIRON,2315,360,14,17,31,45.2%,7m
33191,3,IvanEmerson,2315,333,12,16,28,42.9%,1h
33191,2,[SCLA]clareee,2315,209,8,8,16,50.0%,52m
33191,1,Hyperion,2315,258,7,11,18,38.9%,42m
33191,3,Sickspinda,2315,0,4,2,6,66.7%,2h
33191,1,StarKiller,2315,172,4,6,10,40.0%,3h
33191,2,JackRo,2315,90,4,7,11,36.4%,45m
33191,1,Pourya,2315,86,3,0,3,100.0%,37m
33191,1,Pskosquatch,2315,82,3,1,4,75.0%,2h
33191,1,BTPaladin,2315,88,3,2,5,60.0%,39m
33191,1,[FOQ]WinReaper,2315,145,2,6,8,25.0%,2h
33191,1,Corend,2315,138,2,8,10,20.0%,37m
33191,1,matiusfoca,2315,0,1,0,1,100.0%,43m
33191,1,[Nfreak]OCDwolfman,2315,90,1,1,2,50.0%,53m
33191,1,BigBalloni,2315,48,1,1,2,50.0%,40m
33191,1,[AbcCo]GianMarco,2315,0,1,1,2,50.0%,1h
33191,1,[IRC]ChaoticL,2315,0,1,5,6,16.7%,2h
33215,1,[TAW]Major,2314,570,86,64,150,57.3%,1h
33215,1,[SGK1]HineyKin,2314,1544,77,72,149,51.7%,2h
33215,1,CheetoPuffs,2314,1689,61,52,113,54.0%,3h
33215,1,VanKwisH,2314,728,32,36,68,47.1%,3h
33215,1,AndrossTrue,2314,848,24,19,43,55.8%,3h
33215,3,GhostBlaze,2314,542,20,19,39,51.3%,13m
33215,1,Zaraki,2314,613,20,27,47,42.6%,43m
33215,3,[PTHero]Drizzt,2314,283,10,12,22,45.5%,13m
33215,3,Kross,2314,121,2,1,3,66.7%,58m
33215,3,SWIFTjustice,2314,0,2,6,8,25.0%,2h
33215,1,coaltrain,2314,73,2,7,9,22.2%,40m
33215,1,Dirty,2314,44,1,5,6,16.7%,30m
33215,1,cjsme,2314,0,1,5,6,16.7%,37m
33215,1,Protoss,2314,48,1,13,14,7.1%,1h
33229,1,Malock,2313,1620,75,68,143,52.4%,32m
33229,2,ZombieMaster,2313,677,44,48,92,47.8%,1h
33229,1,LuckyPig,2313,474,23,17,40,57.5%,3h
33229,1,Talnorosh,2313,653,22,18,40,55.0%,22m
33229,1,BlueSeraph,2313,497,15,19,34,44.1%,1h
33229,1,SwarM,2313,606,15,19,34,44.1%,2h
33229,1,awe,2313,417,14,19,33,42.4%,2h
33229,1,[XpKAc]Evilwings,2313,518,13,12,25,52.0%,13m
33229,1,ArchAngelz,2313,444,11,11,22,50.0%,2h
33229,1,Ketzeri,2313,341,10,7,17,58.8%,1h
33229,3,Chad,2313,90,4,7,11,36.4%,16m
33229,3,wilber,2313,121,3,0,3,100.0%,6m
33229,1,KoRnMLC,2313,179,3,3,6,50.0%,30m
33229,1,Moose,2313,89,2,4,6,33.3%,44m
33229,3,Dice,2313,30,2,6,8,25.0%,46m
33229,1,WeirdFishes,2313,0,1,0,1,100.0%,1h
33229,1,SNAKEBYTE,2313,0,1,1,2,50.0%,35m
33229,1,BOBOBOBOBOBO,2313,0,1,1,2,50.0%,30m
33229,1,Jooce,2313,30,1,4,5,20.0%,32m
33229,1,OdinsBeard,2313,0,1,4,5,20.0%,2h
33229,3,NhBLetMeBE,2313,0,1,5,6,16.7%,46m
33229,1,Arimus,2313,0,1,5,6,16.7%,40m
33229,1,ACERIDE,2313,0,0,1,1,0.0%,57m
33229,1,GideonKing,2313,0,0,1,1,0.0%,39m
33229,1,lapu,2313,0,0,1,1,0.0%,19m
33229,1,[DANKEM]Cæsarius,2313,0,0,4,4,0.0%,32m
33255,1,Washburn,2312,1857,313,313,626,50.0%,45m
33255,1,Bonhomme,2312,1550,111,113,224,49.6%,15m
33255,1,toucanpete,2312,1811,110,99,209,52.6%,44m
33255,3,Isotopes,2312,1276,77,77,154,50.0%,44m
33255,1,tosmysalad,2312,1535,57,46,103,55.3%,22m
33255,1,rabitcoffet,2312,1439,54,43,97,55.7%,3h
33255,1,lucifer,2312,1100,38,32,70,54.3%,3h
33255,1,AmeBabad,2312,1000,30,31,61,49.2%,3h
33255,3,TheSpangler,2312,643,23,28,51,45.1%,50m
33255,2,DearDeath,2312,662,21,38,59,35.6%,36m
33255,3,FyrECatZ,2312,294,11,0,11,100.0%,2h
33255,3,Keruba,2312,226,9,13,22,40.9%,28m
33255,3,SERGIOCHO,2312,216,8,12,20,40.0%,47m
33255,1,Weezer,2312,210,6,6,12,50.0%,2h
33255,1,BronYrAur,2312,66,4,10,14,28.6%,55m
33255,1,[Metric]saY,2312,82,3,2,5,60.0%,3h
33255,1,pseudo,2312,0,3,2,5,60.0%,3h
33255,1,[ROUGES]Alamo,2312,0,0,1,1,0.0%,3h
33273,3,[ELLOCO]Slugok,2311,703,28,29,57,49.1%,2h
33273,1,SauceBoss,2311,200,7,17,24,29.2%,35m
33273,1,Trey,2311,0,3,2,5,60.0%,3h
33273,2,cody,2311,40,3,9,12,25.0%,2h
33273,1,MindofMimir,2311,48,2,6,8,25.0%,1h
33273,1,SeriousSenpa,2311,0,1,2,3,33.3%,60m
33273,1,muDD,2311,0,1,4,5,20.0%,52m
33273,1,BigmanJ,2311,0,1,4,5,20.0%,3h
33273,2,Andelaisi,2311,30,1,8,9,11.1%,35m
33273,1,[CLOGG]CloggedAss,2311,0,0,2,2,0.0%,1h
33273,1,Brandonious,2311,0,0,2,2,0.0%,22m
33284,1,Poobah,2310,1097,95,85,180,52.8%,2h
33284,1,[1Q12]CRISMOR,2310,829,33,32,65,50.8%,58m
33284,3,Pheniox,2310,670,29,21,50,58.0%,2h
33284,3,[H4VOC]Okami,2310,705,27,34,61,44.3%,54m
33284,3,tzpr,2310,508,24,11,35,68.6%,3h
33284,1,[goodho]ajam,2310,796,21,23,44,47.7%,27m
33284,1,Pingalicious,2310,470,15,10,25,60.0%,3m
33284,1,[SWRBVR]CheezyPutin,2310,448,13,10,23,56.5%,28m
33284,1,[bobet]GunMan,2310,465,13,12,25,52.0%,1h
33284,1,Destroyer,2310,366,12,3,15,80.0%,13m
33284,3,ElAlcalde,2310,288,11,19,30,36.7%,27m
33284,1,Juice,2310,280,8,4,12,66.7%,24m
33284,1,clauknot,2310,286,7,7,14,50.0%,51m
33284,1,MADAFAKER,2310,195,5,7,12,41.7%,2h
33284,3,UOENO,2310,176,4,9,13,30.8%,2h
33284,1,Hadrian,2310,44,2,0,2,100.0%,31m
33284,1,Aggross,2310,144,2,2,4,50.0%,43m
33284,1,Nakon,2310,88,2,4,6,33.3%,3h
33284,1,Freeman,2310,48,2,5,7,28.6%,3h
33284,1,josue,2310,73,1,10,11,9.1%,54m
33284,1,toediesay,2310,0,0,1,1,0.0%,19m
33284,1,[NLTN]lazvar,2310,0,0,1,1,0.0%,1h
33284,1,Skryre,2310,0,0,1,1,0.0%,37m
33307,1,RoastSalmon,2309,1405,69,59,128,53.9%,9m
33307,3,MumenRider,2309,1080,68,64,132,51.5%,1h
33307,3,Zaife,2309,993,38,40,78,48.7%,2h
33307,3,[PUPUS]Doom,2309,250,35,37,72,48.6%,2h
33307,2,[CROUCH]Jake,2309,523,32,36,68,47.1%,36m
33307,2,Revoke,2309,374,12,21,33,36.4%,3h
33307,3,Nrfonten,2309,221,10,10,20,50.0%,2h
33307,3,Paladi,2309,226,8,17,25,32.0%,17m
33307,1,CaptainSiek,2309,99,3,7,10,30.0%,2h
33307,1,YourAnimeGF,2309,124,3,8,11,27.3%,19m
33307,1,WhatFun,2309,97,2,0,2,100.0%,3h
33307,1,[iElite]poptarts,2309,88,2,3,5,40.0%,37m
33307,1,SubZeroMotor,2309,110,2,5,7,28.6%,28m
33307,3,Ghouley,2309,30,2,6,8,25.0%,2h
33307,3,SpadeWilson,2309,0,2,6,8,25.0%,55m
33307,3,[OSDHL]FALLEN,2309,0,0,1,1,0.0%,44m
33307,1,DesTroY,2309,0,0,1,1,0.0%,32m
33307,1,[8kPLUS]Hemroid,2309,0,0,5,5,0.0%,23m
33325,1,[MotW]Happybuttons,2308,1417,68,66,134,50.7%,1h
33325,2,Skapari,2308,632,23,28,51,45.1%,30m
33325,1,godasBrMG,2308,431,12,16,28,42.9%,58m
33325,3,[maSC]Igneel,2308,224,6,6,12,50.0%,2h
33325,3,Krondizlkork,2308,0,3,5,8,37.5%,58m
33325,1,runner,2308,38,2,2,4,50.0%,3h
33325,2,DINGLEHOPPER,2308,0,2,7,9,22.2%,39m
33325,1,[R3Ds]REdDeViL,2308,0,1,0,1,100.0%,3h
33325,1,Boandlgramer,2308,0,1,0,1,100.0%,2h
33325,1,Hathors,2308,0,1,0,1,100.0%,2h
33325,1,Cohek,2308,0,1,5,6,16.7%,1h
33325,1,Billman,2308,0,0,1,1,0.0%,56m
33325,1,dunny,2308,0,0,2,2,0.0%,28m
33325,1,Espani,2308,0,0,3,3,0.0%,52m
33339,3,dopehat,2307,1528,123,135,258,47.7%,1h
33339,3,nyuriks,2307,1021,42,46,88,47.7%,5m
33339,1,Lelk,2307,751,28,14,42,66.7%,3h
33339,1,iniquitous,2307,976,28,33,61,45.9%,6m
33339,1,Alarcondor,2307,672,19,16,35,54.3%,2h
33339,2,JohnKimYaY,2307,322,11,14,25,44.0%,54m
33339,2,[5W4RM]ScriptKing,2307,209,6,12,18,33.3%,2h
33339,3,tansiul,2307,100,5,8,13,38.5%,2h
33339,1,SoülOfSwarm,2307,134,4,2,6,66.7%,2h
33339,1,chubbylove,2307,38,2,0,2,100.0%,2h
33339,1,KuKulKan,2307,44,2,0,2,100.0%,3h
33339,1,Xarth,2307,42,1,1,2,50.0%,3h
33339,1,SirMarc,2307,0,0,1,1,0.0%,9m
33339,1,Monkon,2307,0,0,1,1,0.0%,2h
33339,2,Phrack,2307,0,0,1,1,0.0%,3h
33339,1,IIIIIIIIIIII,2307,0,0,5,5,0.0%,3h
33339,3,mAsOn,2307,0,0,9,9,0.0%,50m
33356,2,[MuSaFi]sayoonara,2306,659,51,50,101,50.5%,9m
33356,2,Shredder,2306,1072,42,48,90,46.7%,41m
33356,1,[StarC2]Bendembender,2306,928,35,22,57,61.4%,9m
33356,1,[WAGWAN]mungo,2306,851,27,33,60,45.0%,19m
33356,1,SerDerpIV,2306,358,18,12,30,60.0%,51m
33356,1,Woplick,2306,487,17,15,32,53.1%,32m
33356,1,lonerogue,2306,342,10,11,21,47.6%,23m
33356,1,Juice,2306,290,7,10,17,41.2%,39m
33356,1,kenboxxer,2306,132,4,3,7,57.1%,3h
33356,1,edman,2306,184,4,3,7,57.1%,3h
33356,1,casH,2306,86,2,2,4,50.0%,2h
33356,1,Bronzes,2306,48,2,5,7,28.6%,2h
33356,3,[EGG]confuzed,2306,30,2,7,9,22.2%,46m
33356,3,[ISSA]Snack,2306,0,1,2,3,33.3%,44m
33356,3,Karr,2306,0,1,5,6,16.7%,3h
33356,1,wwr,2306,0,0,1,1,0.0%,3h
33356,1,Decoy,2306,0,0,2,2,0.0%,1h
33373,3,jaqchan,2305,1531,325,324,649,50.1%,54m
33373,1,Tirex,2305,1743,60,62,122,49.2%,58m
33373,2,Xacolyte,2305,1081,44,50,94,46.8%,2h
33373,1,DeeProdigy,2305,1212,43,34,77,55.8%,13m
33373,3,Heathcliff,2305,445,38,32,70,54.3%,17m
33373,1,Rhino,2305,770,28,33,61,45.9%,22m
33373,3,Devv,2305,500,27,22,49,55.1%,33m
33373,3,[CRA]ElmerHomero,2305,582,26,25,51,51.0%,1h
33373,1,Skaya,2305,740,23,24,47,48.9%,1h
33373,1,namBoi,2305,620,20,19,39,51.3%,27m
33373,1,[Dindon]UnClassique,2305,524,17,12,29,58.6%,27m
33373,1,[Mugre]termolar,2305,339,11,6,17,64.7%,1h
33373,1,AMragley,2305,179,7,2,9,77.8%,1h
33373,3,[S3M3N]skankipede,2305,212,7,7,14,50.0%,2h
33373,1,MasteroDeath,2305,256,7,8,15,46.7%,1h
33373,3,kwelback,2305,140,7,13,20,35.0%,33m
33373,1,Avefenix,2305,149,4,2,6,66.7%,2h
33373,3,Razorsedge,2305,0,3,6,9,33.3%,3h
33373,1,pac,2305,48,2,5,7,28.6%,3h
33373,1,swoohn,2305,82,2,5,7,28.6%,1h
33373,3,[Repahs]alithia,2305,0,1,1,2,50.0%,54m
33373,1,Life,2305,0,1,4,5,20.0%,59m
33373,1,DarthNemisis,2305,0,1,5,6,16.7%,3h
33396,2,Dalexohn,2304,1471,121,120,241,50.2%,35m
33396,3,kakovega,2304,1554,88,95,183,48.1%,46m
33396,3,Yashiro,2304,761,35,30,65,53.8%,2h
33396,1,[MutasT]Mac,2304,157,5,2,7,71.4%,2h
33396,1,Rayok,2304,84,3,0,3,100.0%,3h
33396,1,CarlosObo,2304,0,2,3,5,40.0%,3h
33396,1,Biz,2304,0,2,3,5,40.0%,57m
33396,1,Akraptor,2304,48,2,3,5,40.0%,3h
33396,1,[LDCO]starrkss,2304,44,1,1,2,50.0%,1h
33396,2,KITON,2304,0,1,1,2,50.0%,52m
33396,1,drak,2304,97,1,1,2,50.0%,60m
33396,1,Chasers,2304,0,1,4,5,20.0%,58m
33396,1,Darkevil,2304,0,1,5,6,16.7%,23m
33396,3,Shinigami,2304,0,1,6,7,14.3%,54m
33396,3,[MEXsc]Elchicogato,2304,42,1,9,10,10.0%,38m
33396,1,Gasser,2304,0,0,1,1,0.0%,58m
33396,1,[CN1212]Silky,2304,0,0,1,1,0.0%,2h
33396,1,grc,2304,0,0,1,1,0.0%,45m
33396,1,[AHPUCH]lion,2304,0,0,3,3,0.0%,3h
33396,1,SOURKUSHOG,2304,0,0,5,5,0.0%,2h
33416,1,Sshionn,2303,1535,99,100,199,49.7%,9m
33416,1,WaveringEyes,2303,573,32,48,80,40.0%,2h
33416,1,PolarPolice,2303,804,24,26,50,48.0%,2h
33416,2,michael,2303,515,19,33,52,36.5%,1h
33416,1,ElCanelas,2303,394,15,6,21,71.4%,57m
33416,3,NerfedClipxz,2303,410,15,18,33,45.5%,13m
33416,1,[UpxV]escaver,2303,268,10,3,13,76.9%,2h
33416,1,Mythos,2303,222,7,10,17,41.2%,2h
33416,2,[Yeite]Matomato,2303,116,7,14,21,33.3%,21m
33416,1,IIIIIIIIIIII,2303,42,6,0,6,100.0%,2h
33416,3,Evolution,2303,198,6,1,7,85.7%,6m
33416,3,[SMSC]Nightbane,2303,201,6,9,15,40.0%,3h
33416,1,[WayOut]Trenner,2303,96,3,6,9,33.3%,2h
33416,1,JKGODYT,2303,44,1,3,4,25.0%,2h
33416,1,Creampie,2303,97,1,5,6,16.7%,2h
33416,3,[MMINGU]Mrwarp,2303,0,0,1,1,0.0%,1h
33432,1,Shiznips,2302,1281,43,39,82,52.4%,33m
33432,3,Chip,2302,922,35,38,73,47.9%,1h
33432,1,TheWorstAtSc,2302,776,22,19,41,53.7%,32m
33432,1,Zurkseas,2302,358,9,5,14,64.3%,54m
33432,1,neda,2302,254,7,5,12,58.3%,2h
33432,2,DarkKnight,2302,194,6,18,24,25.0%,14m
33432,1,ForLANMaozna,2302,147,4,7,11,36.4%,3h
33432,3,ChristianRG,2302,122,3,2,5,60.0%,2h
33432,1,[steel]shinigamik,2302,0,1,0,1,100.0%,57m
33432,1,Zombie,2302,0,0,1,1,0.0%,43m
33432,3,dumbledork,2302,0,0,2,2,0.0%,51m
33443,1,Absel,2301,1369,55,46,101,54.5%,22m
33443,3,NeonWhite,2301,605,21,30,51,41.2%,16m
33443,3,unfgtn,2301,398,15,22,37,40.5%,1h
33443,1,xenophobe,2301,235,11,11,22,50.0%,27m
33443,1,karankoron,2301,286,8,10,18,44.4%,2h
33443,1,Swiftty,2301,165,5,4,9,55.6%,4m
33443,3,[WyScMe]dtrain,2301,183,5,10,15,33.3%,2h
33443,3,aiz,2301,0,4,4,8,50.0%,2h
33443,1,[MGosu]Ldemetri,2301,136,3,4,7,42.9%,1h
33443,1,Mike,2301,84,3,5,8,37.5%,57m
33443,3,Greattales,2301,0,1,2,3,33.3%,48m
33443,1,[OkT3am]GeeXp,2301,48,1,2,3,33.3%,2h
33443,1,[BR3]elsubash,2301,0,1,3,4,25.0%,2h
33443,1,NaitHanter,2301,93,1,5,6,16.7%,1h
33443,1,coregame,2301,0,0,2,2,0.0%,3h
33443,1,Loganjones,2301,0,0,5,5,0.0%,1h
33443,2,[TWL20]hoaZg,2301,0,0,6,6,0.0%,30m
33460,3,Antyga,2300,1475,64,62,126,50.8%,55m
33460,3,strangel,2300,811,32,29,61,52.5%,1h
33460,2,Beau,2300,842,29,40,69,42.0%,51m
33460,3,Jooosh,2300,312,19,20,39,48.7%,17m
33460,1,[420SC2]Towel,2300,243,15,10,25,60.0%,54m
33460,1,[0BS]Brain,2300,346,9,8,17,52.9%,3h
33460,1,[fromQc]matraka,2300,265,9,13,22,40.9%,13m
33460,3,Saphyron,2300,152,5,11,16,31.2%,1h
33460,1,Skoorb,2300,121,4,8,12,33.3%,3h
33460,3,bas,2300,30,4,10,14,28.6%,33m
33460,1,[L82Die]KingSSM,2300,88,3,4,7,42.9%,39m
33460,1,lol,2300,48,3,6,9,33.3%,23m
33460,3,BoomerTown,2300,90,3,10,13,23.1%,1h
33460,1,VooDoo,2300,42,2,1,3,66.7%,3h
33460,2,[DlVlNE]JoshJutsu,2300,0,2,2,4,50.0%,49m
33460,1,Nnine,2300,48,2,2,4,50.0%,2h
33460,1,Calzer,2300,122,2,3,5,40.0%,1h
33460,1,Buthramter,2300,0,2,4,6,33.3%,2h
33460,2,Neyen,2300,0,1,4,5,20.0%,46m
33460,1,bobsaget,2300,0,1,4,5,20.0%,2h
33460,3,BigNatas,2300,0,1,4,5,20.0%,54m
33460,2,[DT50]Thrembode,2300,0,0,5,5,0.0%,45m
33482,3,Brian,2299,1517,129,125,254,50.8%,31m
33482,1,shreeve,2299,492,18,14,32,56.2%,43m
33482,1,kyrralse,2299,549,16,15,31,51.6%,58m
33482,1,Luru,2299,417,12,9,21,57.1%,19m
33482,3,DanSemi,2299,284,9,13,22,40.9%,1h
33482,1,Influenzahah,2299,217,7,5,12,58.3%,43m
33482,1,Naofumisama,2299,182,6,2,8,75.0%,3h
33482,1,Silidus,2299,193,4,7,11,36.4%,1h
33482,1,Kharn,2299,193,4,7,11,36.4%,41m
33482,1,may,2299,169,3,2,5,60.0%,3h
33482,3,NieL,2299,146,3,4,7,42.9%,2h
33482,1,[Atone]fukthisgame,2299,120,3,7,10,30.0%,1h
33482,1,QuEWeZz,2299,145,2,1,3,66.7%,2h
33482,1,StopSleep,2299,44,2,2,4,50.0%,3h
33482,1,Murk,2299,0,1,0,1,100.0%,16m
33482,1,Ison,2299,0,1,5,6,16.7%,2h
33482,1,[VHRVNG]blarg,2299,0,0,1,1,0.0%,2h
33482,3,GeoSonis,2299,0,0,1,1,0.0%,17m
33482,1,lxrdjuni,2299,0,0,2,2,0.0%,2h
33482,1,Honguito,2299,0,0,3,3,0.0%,2h
33482,3,DarkHunter,2299,0,0,7,7,0.0%,53m
33503,3,Worawit,2298,1278,1026,1132,2158,47.5%,10m
33503,3,YoMama,2298,1528,156,156,312,50.0%,2h
33503,1,[n0s3x]ciderphex,2298,1878,150,166,316,47.5%,22m
33503,1,[MMatF]Giberishpilz,2298,830,110,100,210,52.4%,3h
33503,1,[PobSC]litrox,2298,636,18,18,36,50.0%,28m
33503,1,Nyrus,2298,501,17,18,35,48.6%,3h
33503,2,DubbaJubba,2298,497,17,22,39,43.6%,52m
33503,3,[1WAR8]WhiteChad,2298,425,16,25,41,39.0%,27m
33503,1,[cl0udM]KindOf,2298,374,12,8,20,60.0%,2h
33503,1,Delusion,2298,218,8,10,18,44.4%,60m
33503,3,JFCD,2298,233,7,8,15,46.7%,37m
33503,3,[deegg]Carrot,2298,247,7,13,20,35.0%,12m
33503,1,Incision,2298,184,7,16,23,30.4%,3h
33503,1,Eraser,2298,154,6,7,13,46.2%,3h
33503,3,Mich,2298,150,5,11,16,31.2%,45m
33503,1,Mintwight,2298,92,4,2,6,66.7%,42m
33503,2,General,2298,0,1,4,5,20.0%,2h
33503,1,Nuke,2298,0,1,4,5,20.0%,3h
33503,1,StormGoesBZZ,2298,97,1,5,6,16.7%,1h
33503,1,Spaztastic,2298,73,0,3,3,0.0%,42m
33503,1,AIACOS,2298,0,0,4,4,0.0%,1h
33524,1,Jackfrost,2297,1537,264,282,546,48.4%,2h
33524,3,Alexi,2297,565,77,81,158,48.7%,2h
33524,3,Denjamin,2297,1035,52,49,101,51.5%,2h
33524,1,Ace,2297,775,48,47,95,50.5%,57m
33524,3,Thisguy,2297,774,33,32,65,50.8%,37m
33524,1,[WOW2EZ]Pug,2297,497,17,17,34,50.0%,60m
33524,1,Aquila,2297,434,16,10,26,61.5%,2h
33524,1,DrCYH,2297,428,14,25,39,35.9%,2h
33524,2,XamaElRage,2297,280,12,12,24,50.0%,56m
33524,3,Trucktup,2297,250,8,13,21,38.1%,56m
33524,1,OuTLaw,2297,172,4,9,13,30.8%,2h
33524,2,warmandbumpy,2297,30,3,7,10,30.0%,20m
33524,3,[GRMN]PapaGil,2297,60,3,8,11,27.3%,2h
33524,3,mittons,2297,30,1,3,4,25.0%,2h
33524,1,ClapinCheekz,2297,0,1,4,5,20.0%,33m
33524,1,Greg,2297,0,0,1,1,0.0%,2h
33524,1,[N0FKz]EviLxSToNeR,2297,0,0,1,1,0.0%,3h
33524,1,Jym,2297,0,0,1,1,0.0%,58m
33524,1,Riot,2297,0,0,2,2,0.0%,46m
33524,1,VINCENZO,2297,0,0,2,2,0.0%,41m
33524,1,Elwaifu,2297,0,0,3,3,0.0%,2h
33545,2,Doy,2296,471,47,55,102,46.1%,2h
33545,2,SoloDominaty,2296,260,29,36,65,44.6%,53m
33545,1,womp,2296,622,20,18,38,52.6%,2h
33545,2,Sloth,2296,466,17,21,38,44.7%,36m
33545,1,VIETSOUL,2296,304,12,18,30,40.0%,1h
33545,1,Nuggets,2296,326,9,6,15,60.0%,6m
33545,1,Madness,2296,248,6,6,12,50.0%,2h
33545,3,Deftspider,2296,149,4,9,13,30.8%,3h
33545,2,Shadow,2296,130,4,17,21,19.0%,2h
33545,1,MataLLama,2296,92,2,3,5,40.0%,1h
33545,1,[R3K]ZhangFei,2296,0,0,1,1,0.0%,2h
33545,1,kirito,2296,0,0,1,1,0.0%,2h
33545,1,Dopsmon,2296,0,0,3,3,0.0%,51m
33545,2,AeaMan,2296,0,0,4,4,0.0%,6m
33559,1,awdawd,2295,1844,187,178,365,51.2%,33m
33559,1,MongolKhan,2295,848,25,27,52,48.1%,2h
33559,1,FiredArtist,2295,681,20,23,43,46.5%,7m
33559,1,luisenano,2295,347,12,9,21,57.1%,2h
33559,3,TeraWattçÇ,2295,328,11,14,25,44.0%,3h
33559,1,MXDANIEL,2295,274,10,4,14,71.4%,2h
33559,1,Ryuichi,2295,210,9,4,13,69.2%,54m
33559,3,Mostat,2295,276,9,5,14,64.3%,7m
33559,1,Sinister,2295,32,4,1,5,80.0%,3h
33559,1,[FFAA]Matt,2295,0,4,1,5,80.0%,1h
33559,1,Galaxy,2295,48,4,4,8,50.0%,1h
33559,1,WolfSavage,2295,48,4,5,9,44.4%,46m
33559,1,Gonzalo,2295,80,3,4,7,42.9%,16m
33559,1,zerging,2295,74,3,5,8,37.5%,24m
33559,1,MrBx,2295,130,3,7,10,30.0%,1h
33559,1,Lucifer,2295,44,2,1,3,66.7%,2h
33559,3,Jenesis,2295,30,2,7,9,22.2%,55m
33559,2,Landorama,2295,0,1,3,4,25.0%,2h
33559,1,DrZ,2295,44,1,5,6,16.7%,2h
33559,1,LilNig,2295,0,0,1,1,0.0%,2h
33559,1,Losche,2295,0,0,1,1,0.0%,1h
33580,3,[NAC2]IBeetle,2294,992,88,74,162,54.3%,31m
33580,1,Seven,2294,1554,70,74,144,48.6%,28m
33580,1,JonL,2294,1384,63,56,119,52.9%,2h
33580,1,TyraelG,2294,1096,58,54,112,51.8%,1h
33580,3,NaCljerky,2294,338,11,17,28,39.3%,35m
33580,3,yizuzzz,2294,273,9,13,22,40.9%,3h
33580,1,VictoryGin,2294,158,7,13,20,35.0%,35m
33580,3,BamBam,2294,48,3,8,11,27.3%,38m
33580,1,EasyMode,2294,0,1,4,5,20.0%,56m
33580,1,Groo,2294,0,1,5,6,16.7%,1h
33580,1,[HiNRG]BzKTatir,2294,40,1,6,7,14.3%,43m
33580,1,PinguGamer,2294,0,0,1,1,0.0%,2h
33580,2,Mhao,2294,0,0,1,1,0.0%,57m
33580,1,[cerbrs]coin,2294,0,0,1,1,0.0%,11m
33580,1,MADDOGG,2294,0,0,3,3,0.0%,3h
33595,1,adnsaitama,2293,1223,48,37,85,56.5%,2h
33595,1,khoatong,2293,1011,39,34,73,53.4%,7m
33595,1,HATE,2293,840,31,25,56,55.4%,22m
33595,1,kingtyranias,2293,974,29,33,62,46.8%,2h
33595,3,Zerox,2293,604,22,23,45,48.9%,2h
33595,1,JackSolace,2293,457,15,18,33,45.5%,45m
33595,1,AnPirate,2293,404,13,12,25,52.0%,56m
33595,1,deadshot,2293,316,8,10,18,44.4%,56m
33595,1,iThreeX,2293,319,8,11,19,42.1%,22m
33595,3,[USofAY]GeorgieEff,2293,138,4,4,8,50.0%,2h
33595,1,Cincinnatus,2293,192,4,7,11,36.4%,1h
33595,1,WOMBAT,2293,88,3,2,5,60.0%,19m
33595,1,Vesser,2293,96,2,2,4,50.0%,23m
33595,3,[Pig2]ACGeneral,2293,0,1,0,1,100.0%,20m
33595,1,[LDCO]darkjulio,2293,30,1,1,2,50.0%,1h
33595,2,Sqoyd,2293,0,1,4,5,20.0%,3h
33595,1,XxDarEVILXx,2293,0,1,4,5,20.0%,3h
33595,1,Balcefon,2293,0,1,6,7,14.3%,2h
33595,1,HardyHeron,2293,0,0,1,1,0.0%,28m
33614,2,Phantomwar,2292,1125,176,171,347,50.7%,52m
33614,1,cratos,2292,874,32,30,62,51.6%,32m
33614,1,Raizuh,2292,364,31,19,50,62.0%,1h
33614,1,[KBL]AdaLine,2292,686,25,20,45,55.6%,3h
33614,1,aline,2292,516,13,17,30,43.3%,19m
33614,1,Zeratul,2292,324,11,9,20,55.0%,3h
33614,1,XZIST,2292,248,10,15,25,40.0%,3h
33614,3,playergone,2292,310,9,19,28,32.1%,13m
33614,1,Kabayan,2292,202,5,5,10,50.0%,33m
33614,2,llllIIIIllII,2292,146,4,10,14,28.6%,51m
33614,1,Blush,2292,48,3,6,9,33.3%,2h
33614,2,SoilWalker,2292,0,2,8,10,20.0%,5m
33614,2,Roadkill,2292,0,1,4,5,20.0%,3h
33614,1,Ereinon,2292,97,1,5,6,16.7%,35m
33628,2,Stellarman,2291,840,34,38,72,47.2%,9m
33628,1,PiPe,2291,865,32,20,52,61.5%,2h
33628,1,[FatMom]Player,2291,501,26,21,47,55.3%,3h
33628,1,LambKebab,2291,702,20,19,39,51.3%,5m
33628,3,OldSock,2291,351,13,10,23,56.5%,59m
33628,2,GamingShane,2291,280,9,7,16,56.2%,2h
33628,3,mhaley,2291,256,9,18,27,33.3%,48m
33628,1,bestofdonkey,2291,145,6,8,14,42.9%,3h
33628,3,Exo,2291,201,6,11,17,35.3%,2h
33628,1,snakeiiis,2291,176,5,7,12,41.7%,3h
33628,2,ZethAndJames,2291,60,5,13,18,27.8%,7m
33628,1,BladeRunner,2291,44,2,0,2,100.0%,3h
33628,1,AlexAdept,2291,90,2,5,7,28.6%,13m
33628,1,Straker,2291,0,0,1,1,0.0%,2h
33642,1,Duster,2290,1328,203,203,406,50.0%,27m
33642,3,Britney,2290,947,36,41,77,46.8%,33m
33642,3,ElCanijo,2290,301,20,24,44,45.5%,3h
33642,1,TrueCatalyst,2290,595,20,35,55,36.4%,2h
33642,3,LoTuSsSs,2290,372,14,21,35,40.0%,14m
33642,3,TwoStep,2290,232,8,17,25,32.0%,59m
33642,1,Nidhogg,2290,0,4,1,5,80.0%,3h
33642,1,SonarPTZ,2290,89,2,0,2,100.0%,1h
33642,3,BigD,2290,0,1,0,1,100.0%,55m
33642,1,PUCK,2290,0,1,2,3,33.3%,2h
33642,2,Jua,2290,0,1,4,5,20.0%,3h
33642,1,Broccoli,2290,0,1,5,6,16.7%,1h
33642,1,DivineGigas,2290,0,1,7,8,12.5%,2h
33655,3,Litigator,2289,1579,149,147,296,50.3%,2h
33655,3,KingXvPvX,2289,693,60,65,125,48.0%,13m
33655,1,spookybadger,2289,539,26,32,58,44.8%,13m
33655,1,[Beans2]BugidYAiba,2289,340,16,10,26,61.5%,1h
33655,3,ToasterBomb,2289,306,14,20,34,41.2%,46m
33655,3,TOLER,2289,305,12,13,25,48.0%,48m
33655,1,Banishalol,2289,384,11,9,20,55.0%,2h
33655,2,Haindall,2289,336,11,23,34,32.4%,27m
33655,2,[LOHs]SerHei,2289,300,9,24,33,27.3%,50m
33655,1,pablinflow,2289,290,8,4,12,66.7%,2h
33655,1,[LPG2]GABRIELPEREZ,2289,147,4,1,5,80.0%,2h
33655,1,Kalstormblsd,2289,96,4,2,6,66.7%,2h
33655,2,Sackerman,2289,154,4,6,10,40.0%,3h
33655,1,Sherzza,2289,126,3,4,7,42.9%,2h
33655,1,Iplayfalcon,2289,122,3,6,9,33.3%,2h
33655,1,supirionxD,2289,96,3,8,11,27.3%,1h
33655,1,Strzer,2289,0,1,2,3,33.3%,3h
33655,1,[10JQKA]Baller,2289,0,1,5,6,16.7%,22m
33655,1,Jay,2289,0,0,1,1,0.0%,3h
33655,1,thewolf,2289,0,0,1,1,0.0%,2h
33675,1,clouddxv,2288,1620,117,103,220,53.2%,2h
33675,1,sabrewolve,2288,823,40,37,77,51.9%,43m
33675,1,Khanivore,2288,728,30,15,45,66.7%,56m
33675,1,Wargian,2288,390,10,6,16,62.5%,56m
33675,2,Giles,2288,142,9,14,23,39.1%,1h
33675,2,[MotriN]kyphisto,2288,220,8,15,23,34.8%,3h
33675,1,SnoopyRed,2288,232,7,7,14,50.0%,37m
33675,1,SummerRiver,2288,198,6,5,11,54.5%,56m
33675,3,DarkSkies,2288,173,5,10,15,33.3%,45m
33675,3,damarderer,2288,93,4,5,9,44.4%,3h
33675,3,Drizztette,2288,0,3,3,6,50.0%,2h
33675,3,Kerrigan,2288,92,3,9,12,25.0%,13m
33675,3,NightAngel,2288,95,2,6,8,25.0%,2h
33675,1,ChappyGamer,2288,0,1,5,6,16.7%,26m
33675,1,IchimaruGin,2288,96,1,6,7,14.3%,13m
33690,1,Meepey,2287,1410,56,42,98,57.1%,42m
33690,1,xjuner,2287,1489,55,54,109,50.5%,1h
33690,3,[b8]Zerick,2287,1221,51,45,96,53.1%,1h
33690,1,LuanOwnedz,2287,566,19,23,42,45.2%,3h
33690,1,[INKA5]abathur,2287,500,18,14,32,56.2%,2h
33690,1,maro,2287,215,7,8,15,46.7%,32m
33690,2,[VMW3]Octans,2287,30,4,7,11,36.4%,39m
33690,1,TTH,2287,97,2,1,3,66.7%,43m
33690,3,MoeMoe,2287,0,1,0,1,100.0%,6m
33690,1,[AN4I]MartinSsempa,2287,0,1,5,6,16.7%,33m
33690,2,[XpKAc]Pendulum,2287,36,1,5,6,16.7%,11m
33690,1,[VENSC2]RobertRath,2287,0,0,2,2,0.0%,30m
33702,3,WAFFLES,2286,1095,109,103,212,51.4%,54m
33702,1,ToneOSarcasm,2286,959,30,30,60,50.0%,1h
33702,1,[iar]THEBUTLER,2286,582,18,11,29,62.1%,1h
33702,2,Raizera,2286,360,12,26,38,31.6%,3h
33702,1,sakatoma,2286,334,9,9,18,50.0%,58m
33702,3,seerfax,2286,248,9,17,26,34.6%,2h
33702,3,[pigs]PELANTARO,2286,255,7,14,21,33.3%,2h
33702,1,Mmg,2286,188,5,3,8,62.5%,22m
33702,1,flibber,2286,237,5,5,10,50.0%,13m
33702,1,notenufmnrls,2286,126,4,4,8,50.0%,1h
33702,1,Static,2286,122,4,8,12,33.3%,1h
33702,1,cardtoon,2286,86,2,5,7,28.6%,3h
33702,2,NoMore,2286,0,2,6,8,25.0%,13m
33702,1,Weesan,2286,0,1,1,2,50.0%,3h
33702,1,Scorne,2286,0,1,5,6,16.7%,2h
33702,1,Freeman,2286,0,0,1,1,0.0%,13m
33718,2,jabali,2285,1480,179,184,363,49.3%,37m
33718,3,Whodaz,2285,1226,57,68,125,45.6%,16m
33718,1,OtherWay,2285,797,31,14,45,68.9%,2h
33718,2,Caotic,2285,88,5,10,15,33.3%,2h
33718,1,RootsyBoi,2285,96,3,6,9,33.3%,2h
33718,1,Xonix,2285,143,3,6,9,33.3%,2h
33718,3,SweetCheesus,2285,167,3,8,11,27.3%,2h
33718,1,[VIRGII]jennie,2285,130,3,9,12,25.0%,37m
33718,1,iNsomNiac,2285,78,2,7,9,22.2%,3h
33718,1,[xHtsx]AioEvans,2285,42,1,1,2,50.0%,3h
33718,1,[Roshan]hacktaff,2285,0,1,5,6,16.7%,2h
33718,3,McCarthy,2285,0,1,5,6,16.7%,2h
33718,1,Truquero,2285,0,0,2,2,0.0%,2h
33718,3,[DCSK]Benji,2285,0,0,3,3,0.0%,20m
33732,1,XIAN,2284,1837,98,85,183,53.6%,3h
33732,1,Elpepe,2284,1313,72,63,135,53.3%,3m
33732,1,corvo,2284,1246,53,51,104,51.0%,24m
33732,1,[CUMBAT]diz,2284,503,38,26,64,59.4%,2h
33732,3,BreathUnseen,2284,1087,38,45,83,45.8%,1h
33732,1,[TPGGXD]Arima,2284,394,13,13,26,50.0%,1h
33732,1,[KDF2]tanker,2284,272,7,13,20,35.0%,3h
33732,3,Dynamo,2284,182,6,2,8,75.0%,6m
33732,2,piter,2284,92,6,8,14,42.9%,53m
33732,1,[KLLR5]CGPACIFIST,2284,206,5,11,16,31.2%,2h
33732,1,KeiranLee,2284,0,1,0,1,100.0%,1h
33732,1,Isaac,2284,48,1,3,4,25.0%,26m
33732,2,StrafeBoy,2284,0,1,6,7,14.3%,52m
33732,3,ancelantu,2284,0,1,6,7,14.3%,1h
33732,1,BeyondGone,2284,0,0,1,1,0.0%,45m
33732,1,relay,2284,0,0,1,1,0.0%,2h
33732,1,Shelby,2284,0,0,1,1,0.0%,3h
33732,1,TheMammoth,2284,0,0,1,1,0.0%,24m
33732,1,pbfrank,2284,0,0,1,1,0.0%,2h
33732,1,MLKCUBA,2284,0,0,1,1,0.0%,2h
33752,1,Atlasstone,2283,1690,72,71,143,50.3%,19m
33752,1,Awesomeo,2283,997,41,31,72,56.9%,9m
33752,3,DirkDirkler,2283,1202,39,65,104,37.5%,8m
33752,3,[Wat3rs]TheEnforcer,2283,900,31,38,69,44.9%,48m
33752,1,pootietang,2283,558,18,19,37,48.6%,1h
33752,1,bomberice,2283,396,14,17,31,45.2%,54m
33752,1,Cornbread,2283,496,13,14,27,48.1%,57m
33752,2,[Lion]JakDom,2283,209,7,5,12,58.3%,56m
33752,1,PriestPDX,2283,214,6,3,9,66.7%,25m
33752,3,[MA50N]crispcheese,2283,75,6,6,12,50.0%,53m
33752,1,Sociopath,2283,142,4,7,11,36.4%,2h
33752,1,Algorithm,2283,109,4,9,13,30.8%,3h
33752,1,BABAchan,2283,144,3,4,7,42.9%,1h
33752,1,Joe,2283,92,2,6,8,25.0%,3h
33752,3,nerdyXnature,2283,97,2,7,9,22.2%,56m
33752,1,[soypro]cangre,2283,0,1,0,1,100.0%,25m
33752,1,[LapisL]Elaina,2283,0,1,3,4,25.0%,2h
33752,2,JimReinor,2283,0,1,4,5,20.0%,59m
33752,1,Firelord,2283,0,0,1,1,0.0%,1h
33752,1,[110213]Steelcrow,2283,0,0,1,1,0.0%,22m
33752,3,DimebagOz,2283,0,0,1,1,0.0%,15m
33752,1,Mincingnote,2283,0,0,1,1,0.0%,11m
33774,3,xiaomiredmi,2282,1447,76,73,149,51.0%,2h
33774,1,Kedgann,2282,528,16,9,25,64.0%,2h
33774,1,Beanstar,2282,515,16,15,31,51.6%,1h
33774,1,Rabugento,2282,522,14,14,28,50.0%,1h
33774,1,[RCSM]dapperboxer,2282,405,13,12,25,52.0%,2h
33774,1,Kstein,2282,277,8,10,18,44.4%,13m
33774,3,main,2282,202,7,11,18,38.9%,7m
33774,1,bapolex,2282,214,6,9,15,40.0%,22m
33774,1,[UpxV]angel,2282,158,5,6,11,45.5%,35m
33774,1,Cameron,2282,168,4,4,8,50.0%,9m
33774,1,shinaldo,2282,145,3,2,5,60.0%,2h
33774,1,pazzo,2282,130,3,7,10,30.0%,2h
33774,2,[bergh]deyl,2282,0,2,3,5,40.0%,1h
33774,1,LarsMarine,2282,0,1,1,2,50.0%,1h
33774,1,Taterson,2282,0,1,5,6,16.7%,13m
33774,1,INacho,2282,0,0,1,1,0.0%,13m
33774,3,Kitt,2282,0,0,3,3,0.0%,3h
33791,3,[ScSwrm]RiskLife,2281,1271,105,97,202,52.0%,3h
33791,3,WhiteDragon,2281,942,42,52,94,44.7%,3h
33791,1,[DFWU]HateGames,2281,728,27,38,65,41.5%,3h
33791,3,ovo,2281,306,17,22,39,43.6%,16m
33791,1,Ramil,2281,327,15,17,32,46.9%,58m
33791,1,NARGAROTH,2281,200,5,5,10,50.0%,35m
33791,1,Doombringer,2281,148,5,10,15,33.3%,9m
33791,1,Kraytin,2281,141,3,4,7,42.9%,2h
33791,1,[G4M3R5]Fini,2281,86,3,5,8,37.5%,22m
33791,1,ZADOKmPRIEST,2281,82,3,9,12,25.0%,39m
33791,1,[WHSKY]Ares,2281,82,2,3,5,40.0%,1h
33791,1,NiserXhell,2281,0,1,5,6,16.7%,2h
33791,1,slash,2281,0,0,1,1,0.0%,1h
33791,2,ZombieCG,2281,0,0,2,2,0.0%,1h
33805,2,caole,2280,998,128,132,260,49.2%,2h
33805,3,[VgnChz]SASQUATCH,2280,967,63,57,120,52.5%,33m
33805,1,SirWilliam,2280,537,24,33,57,42.1%,1h
33805,1,Scatlord,2280,422,19,23,42,45.2%,59m
33805,1,[TATR]Freddy,2280,546,17,19,36,47.2%,2h
33805,1,LiveSockets,2280,294,10,12,22,45.5%,1h
33805,1,Hype,2280,266,8,5,13,61.5%,45m
33805,1,BigFap,2280,287,7,11,18,38.9%,2h
33805,3,COVID,2280,144,5,6,11,45.5%,2h
33805,1,HotCargo,2280,137,4,7,11,36.4%,2h
33805,1,[ChiFan]dahx,2280,78,3,0,3,100.0%,43m
33805,3,Johnhamond,2280,28,2,2,4,50.0%,59m
33805,1,AntiThunder,2280,79,2,5,7,28.6%,57m
33805,3,Wick,2280,97,2,6,8,25.0%,5m
33805,1,WeirdZ,2280,0,1,0,1,100.0%,3h
33805,1,BLANK,2280,0,0,1,1,0.0%,2h
33805,1,[OnlyFF]ThreeKinGs,2280,0,0,2,2,0.0%,3h
33822,3,[VrNice]Perix,2279,1448,172,172,344,50.0%,27m
33822,2,Spud,2279,1456,68,79,147,46.3%,2h
33822,1,dreico,2279,1760,62,61,123,50.4%,3h
33822,1,TrumpLost,2279,1270,50,71,121,41.3%,2h
33822,1,Raiya,2279,952,31,36,67,46.3%,2h
33822,1,KPak,2279,753,29,27,56,51.8%,3h
33822,1,HennydaHouse,2279,640,26,9,35,74.3%,42m
33822,1,Adrian,2279,673,22,18,40,55.0%,5m
33822,3,Ozmo,2279,572,19,33,52,36.5%,47m
33822,1,Jm,2279,438,17,6,23,73.9%,31m
33822,1,Ozs,2279,418,14,18,32,43.8%,9m
33822,1,Jul,2279,311,8,4,12,66.7%,33m
33822,1,Timmyr,2279,288,8,8,16,50.0%,2h
33822,1,VitaminaC,2279,252,7,5,12,58.3%,2h
33822,3,annuler,2279,122,7,8,15,46.7%,33m
33822,3,IIIIIIIIIII,2279,177,4,13,17,23.5%,45m
33822,1,InfestedAbe,2279,122,3,2,5,60.0%,2h
33822,1,Somniadolor,2279,0,2,3,5,40.0%,3h
33822,1,ZNecromancer,2279,86,2,5,7,28.6%,2h
33822,1,MadMedic,2279,0,1,4,5,20.0%,2h
33822,1,[TheRs]Potatd,2279,0,0,2,2,0.0%,1h
33822,3,Acmé,2279,0,0,3,3,0.0%,2h
33844,3,[3M2]Zodiac,2278,730,28,28,56,50.0%,48m
33844,1,aDOm,2278,804,25,22,47,53.2%,52m
33844,1,rubenLm,2278,621,22,18,40,55.0%,33m
33844,1,Grandee,2278,294,8,9,17,47.1%,3h
33844,1,LuckThirteen,2278,202,6,13,19,31.6%,3h
33844,1,Megabit,2278,155,5,4,9,55.6%,44m
33844,1,[UpxV]gufuhack,2278,169,5,8,13,38.5%,2h
33844,3,MrMisterMan,2278,126,5,10,15,33.3%,17m
33844,1,ROCKlord,2278,121,3,1,4,75.0%,2h
33844,1,Skrilp,2278,0,2,4,6,33.3%,2h
33844,1,Serfio,2278,32,1,2,3,33.3%,3h
33844,3,MadHigH,2278,0,0,1,1,0.0%,3h
33844,1,Fredinkins,2278,0,0,1,1,0.0%,2h
33844,1,Thrawn,2278,0,0,1,1,0.0%,2h
33844,1,Riski,2278,0,0,1,1,0.0%,3m
33844,1,[TVtwit]CheeseTroll,2278,0,0,1,1,0.0%,58m
33844,1,DitchPig,2278,0,0,1,1,0.0%,2h
33844,1,Ascalon,2278,0,0,4,4,0.0%,40m
33862,3,zhuzhu,2277,1156,221,214,435,50.8%,1h
33862,1,[XpKAc]SeraGraM,2277,1701,81,89,170,47.6%,2h
33862,3,HighestDrumr,2277,1008,44,47,91,48.4%,12m
33862,3,SwarmHost,2277,888,42,45,87,48.3%,17m
33862,1,mojorito,2277,934,27,28,55,49.1%,24m
33862,1,NoobHere,2277,349,9,8,17,52.9%,52m
33862,1,SquireCD,2277,189,6,3,9,66.7%,1h
33862,3,DuhJuiceBox,2277,126,6,11,17,35.3%,54m
33862,1,Terminology,2277,38,2,5,7,28.6%,3h
33862,1,lookout,2277,0,1,4,5,20.0%,9m
33862,1,JDlove,2277,0,0,1,1,0.0%,27m
33873,3,Emialis,2276,1129,61,72,133,45.9%,4m
33873,1,ovkskull,2276,1079,57,60,117,48.7%,37m
33873,3,SilentStorm,2276,666,25,30,55,45.5%,55m
33873,1,Fex,2276,701,23,17,40,57.5%,3h
33873,1,Merodomax,2276,353,15,12,27,55.6%,1h
33873,1,BattleMaraux,2276,354,10,8,18,55.6%,1h
33873,1,[DaFew]ThulsaDoom,2276,264,8,4,12,66.7%,23m
33873,1,GarouZ,2276,240,8,8,16,50.0%,21m
33873,1,[IMl]Cruise,2276,272,7,13,20,35.0%,6m
33873,3,Ema,2276,210,6,4,10,60.0%,53m
33873,1,Darkkingt,2276,112,5,4,9,55.6%,2h
33873,1,[Tyber]Testyklees,2276,152,5,8,13,38.5%,2h
33873,1,[TGosuD]Peacewind,2276,179,5,9,14,35.7%,60m
33873,1,EndersisxEW,2276,44,2,3,5,40.0%,5m
33873,3,Furby,2276,30,1,1,2,50.0%,46m
33888,1,[ASPIE]BananaKing,2275,1496,51,58,109,46.8%,1h
33888,1,Tunechi,2275,1250,42,43,85,49.4%,2h
33888,1,OnePool,2275,534,15,14,29,51.7%,2h
33888,1,presHobbes,2275,470,14,10,24,58.3%,3h
33888,1,FRFLPPSmurf,2275,0,3,2,5,60.0%,2h
33888,1,[KJ]LittleReaper,2275,128,3,3,6,50.0%,39m
33888,1,DaBlackMac,2275,130,3,6,9,33.3%,35m
33888,2,Kwargs,2275,0,1,0,1,100.0%,1h
33888,3,Xerx,2275,30,1,1,2,50.0%,3h
33888,1,Dragan,2275,92,1,1,2,50.0%,56m
33888,1,[EvilCC]Dragonaid,2275,119,1,4,5,20.0%,2h
33888,1,Kmill,2275,0,1,6,7,14.3%,3h
33888,1,WaffleMoff,2275,0,0,1,1,0.0%,3h
33888,1,Battlestar,2275,0,0,2,2,0.0%,5m
33888,1,edudarkes,2275,0,0,3,3,0.0%,45m
33888,1,BlackieChan,2275,73,0,5,5,0.0%,19m
33904,1,ChickenPoxGC,2274,1674,142,148,290,49.0%,2h
33904,1,airton,2274,1707,105,96,201,52.2%,3h
33904,1,SEAN,2274,687,61,53,114,53.5%,2h
33904,3,Wikidlotus,2274,1188,46,46,92,50.0%,2h
33904,1,JohnnyDERP,2274,1219,45,39,84,53.6%,2h
33904,1,ConBen,2274,794,27,26,53,50.9%,37m
33904,1,Kaa,2274,315,16,14,30,53.3%,21m
33904,1,Jinyu,2274,280,16,20,36,44.4%,3h
33904,3,[SCHack]Parrot,2274,170,7,6,13,53.8%,3h
33904,1,Spectre,2274,228,6,5,11,54.5%,35m
33904,1,hellbent,2274,131,5,3,8,62.5%,48m
33904,1,[xKATx]Ragnar,2274,206,5,4,9,55.6%,2h
33904,1,[12YD]Skrumpf,2274,208,5,7,12,41.7%,1h
33904,1,SpeedKills,2274,186,5,8,13,38.5%,3h
33904,3,DVH,2274,157,5,8,13,38.5%,45m
33904,1,VictoriuzPRD,2274,164,4,8,12,33.3%,52m
33904,3,superdan,2274,120,4,12,16,25.0%,2h
33904,1,Demon,2274,86,2,1,3,66.7%,2h
33904,1,iPax,2274,96,2,2,4,50.0%,3h
33904,1,Sariel,2274,0,0,1,1,0.0%,1h
33904,1,Posh,2274,0,0,1,1,0.0%,3h
33925,1,esteban,2273,1833,126,117,243,51.9%,32m
33925,2,TigerWoo,2273,1519,55,63,118,46.6%,2h
33925,1,spiderman,2273,1270,47,37,84,56.0%,33m
33925,2,PEEpee,2273,1135,44,49,93,47.3%,40m
33925,3,Lear,2273,1203,43,49,92,46.7%,1h
33925,1,MkKrokett,2273,932,31,33,64,48.4%,33m
33925,1,Sean,2273,329,30,24,54,55.6%,32m
33925,1,[PchBgs]Makt,2273,721,28,25,53,52.8%,1h
33925,1,[MrSolo]BOOMKING,2273,689,25,34,59,42.4%,15m
33925,1,Larrybob,2273,508,23,26,49,46.9%,2h
33925,1,[FAPFAP]JJBarea,2273,426,19,17,36,52.8%,30m
33925,2,albanyamal,2273,82,6,8,14,42.9%,3m
33925,1,MaJin,2273,48,3,6,9,33.3%,2h
33925,1,[DarkAG]Rinez,2273,117,2,6,8,25.0%,2h
33925,1,MelloGator,2273,0,1,1,2,50.0%,6m
33925,2,[Axony]Mayerstrick,2273,0,1,4,5,20.0%,30m
33925,3,Noodle,2273,0,1,6,7,14.3%,54m
33925,1,[GOPERÚ]Bledyar,2273,0,0,2,2,0.0%,3h
33943,3,Caleb,2272,588,21,26,47,44.7%,48m
33943,2,[LOHc]touchpadmous,2272,435,18,29,47,38.3%,2h
33943,1,doge,2272,252,7,6,13,53.8%,17m
33943,1,[f331]Grimlock,2272,252,6,19,25,24.0%,27m
33943,1,kristybb,2272,96,5,7,12,41.7%,52m
33943,3,Biaggio,2272,30,4,5,9,44.4%,56m
33943,1,xKillerGODx,2272,40,2,2,4,50.0%,2h
33943,2,[LONSTR]veboswa,2272,0,1,1,2,50.0%,1h
33943,1,leysempai,2272,0,1,5,6,16.7%,45m
33943,1,Jopam,2272,0,1,5,6,16.7%,2h
33953,3,[udcOKI]JimmyJimmy,2271,1517,184,190,374,49.2%,39m
33953,1,elElegido,2271,1650,65,55,120,54.2%,2h
33953,1,EphraimOtter,2271,928,27,29,56,48.2%,2h
33953,3,AnotherGonzo,2271,714,24,31,55,43.6%,1h
33953,1,Zergrral,2271,584,21,17,38,55.3%,3h
33953,1,NoseTypist,2271,320,9,5,14,64.3%,13m
33953,1,Petri,2271,238,7,8,15,46.7%,2h
33953,2,[OlVera]SAREL,2271,105,4,2,6,66.7%,3h
33953,1,Cynner,2271,134,4,6,10,40.0%,37m
33953,1,[MBPS]manbearpig,2271,168,3,5,8,37.5%,31m
33953,2,Shoda,2271,0,1,1,2,50.0%,31m
33953,1,Totoyap,2271,46,1,3,4,25.0%,1h
33953,3,[M4SS1V]ITURTLEI,2271,0,1,10,11,9.1%,33m
33953,1,Classy,2271,0,0,1,1,0.0%,3h
33953,2,TsukasaGamin,2271,0,0,1,1,0.0%,48m
33953,1,Tomás,2271,0,0,1,1,0.0%,31m
33969,3,[W1C]Haulass,2270,1342,90,88,178,50.6%,12m
33969,3,Soysauce,2270,1481,75,76,151,49.7%,48m
33969,1,[ProCol]Andres,2270,1213,43,39,82,52.4%,56m
33969,1,Obsidian,2270,1070,35,39,74,47.3%,42m
33969,1,[ecdn]zzzZZZ,2270,1000,30,37,67,44.8%,3h
33969,1,Floodslayer,2270,656,23,14,37,62.2%,45m
33969,1,[oziozi]COLL,2270,495,20,10,30,66.7%,3h
33969,1,[iS1MP]DJNeko,2270,556,16,14,30,53.3%,3h
33969,1,sjnin,2270,449,15,21,36,41.7%,3h
33969,2,[LMJ]SumusX,2270,400,13,46,59,22.0%,31m
33969,1,ZZZ,2270,260,12,8,20,60.0%,24m
33969,1,Darkkagefox,2270,379,12,17,29,41.4%,33m
33969,3,blanchdd,2270,233,9,13,22,40.9%,2h
33969,1,David,2270,198,6,6,12,50.0%,2h
33969,2,IIIIIIIIIIII,2270,207,6,13,19,31.6%,24m
33969,1,Wasin,2270,76,3,5,8,37.5%,2h
33969,1,Quickdeath,2270,48,3,5,8,37.5%,2h
33969,1,PigNewton,2270,118,3,7,10,30.0%,26m
33969,1,STRANGEE,2270,38,2,1,3,66.7%,3h
33969,1,[GAWDz]LTSBArachnid,2270,0,2,4,6,33.3%,44m
33969,1,Parrellao,2270,44,2,5,7,28.6%,51m
33969,1,Fleed,2270,48,2,6,8,25.0%,2h
33969,1,RebelDragon,2270,80,2,7,9,22.2%,2h
33969,1,[DaPeep]DarkBullet,2270,0,1,1,2,50.0%,54m
33969,1,KingBowza,2270,0,1,2,3,33.3%,25m
33969,1,Rodrikenobi,2270,0,1,5,6,16.7%,3h
33969,1,[WRK]CallMeMaster,2270,0,0,1,1,0.0%,17m
33969,1,Shogunte,2270,0,0,1,1,0.0%,22m
33969,1,[DSAL]coresc,2270,0,0,1,1,0.0%,22m
33969,2,fubarya,2270,0,0,1,1,0.0%,2h
33969,1,slickerd,2270,0,0,5,5,0.0%,28m
34000,3,kuboox,2269,1459,102,107,209,48.8%,56m
34000,1,ElAjenjo,2269,1792,98,91,189,51.9%,3h
34000,3,Herve,2269,896,33,37,70,47.1%,15m
34000,1,Trumpinator,2269,462,23,4,27,85.2%,3h
34000,1,rckShow,2269,738,23,24,47,48.9%,16m
34000,1,HumptyDumpty,2269,764,21,22,43,48.8%,58m
34000,1,PopeLeo,2269,567,18,32,50,36.0%,38m
34000,1,Tarvanis,2269,434,14,15,29,48.3%,3h
34000,1,SpyCMeatBall,2269,294,8,9,17,47.1%,29m
34000,1,getshreked,2269,292,8,12,20,40.0%,42m
34000,1,Phobos,2269,84,3,1,4,75.0%,32m
34000,1,steveostop,2269,120,3,4,7,42.9%,9m
34000,1,DrTrisco,2269,96,3,5,8,37.5%,33m
34000,1,[QcP]TheBARTO,2269,0,1,0,1,100.0%,3h
34014,1,fernotheone,2268,1800,79,77,156,50.6%,33m
34014,1,bigv,2268,699,30,19,49,61.2%,2h
34014,1,[F4MILY]Rash,2268,810,30,19,49,61.2%,3h
34014,1,RevJeff,2268,445,20,10,30,66.7%,3h
34014,1,[AbcCo]Nicolass,2268,571,19,14,33,57.6%,2h
34014,2,[FltBat]Snagaltooth,2268,526,19,25,44,43.2%,60m
34014,1,BlandBuzzard,2268,644,18,20,38,47.4%,5m
34014,3,Weh,2268,443,16,20,36,44.4%,45m
34014,1,Killerfish,2268,434,12,15,27,44.4%,57m
34014,1,[QQQ]Saxi,2268,269,11,14,25,44.0%,53m
34014,3,Class,2268,237,8,12,20,40.0%,2h
34014,3,[Cind3r]Chain,2268,207,8,14,22,36.4%,38m
34014,1,Highriser,2268,222,6,7,13,46.2%,2h
34014,2,DEuxkat,2268,142,6,12,18,33.3%,43m
34014,1,EazyPeazy,2268,120,5,6,11,45.5%,3h
34014,1,Blaszak,2268,163,5,7,12,41.7%,3h
34014,1,Verus,2268,112,4,7,11,36.4%,3h
34014,1,luojiexun,2268,97,2,5,7,28.6%,46m
34014,1,[Po0pY]Assadar,2268,40,2,6,8,25.0%,26m
34014,1,bastywar,2268,0,1,0,1,100.0%,2h
34014,1,OhNO,2268,0,1,0,1,100.0%,3h
34014,1,Larrius,2268,0,1,4,5,20.0%,22m
34014,1,SKillZ,2268,0,1,5,6,16.7%,1h
34014,1,MAIPE,2268,0,0,2,2,0.0%,5m
34038,1,[ETClan]conchimxanh,2267,1380,54,53,107,50.5%,23m
34038,1,AurumPred,2267,1032,46,31,77,59.7%,3h
34038,3,DemonSqrl,2267,318,22,27,49,44.9%,47m
34038,2,JACHAURU,2267,444,18,23,41,43.9%,5m
34038,1,RattMoth,2267,408,11,16,27,40.7%,3h
34038,1,pippuru,2267,248,7,11,18,38.9%,2h
34038,1,MOON,2267,218,6,5,11,54.5%,3h
34038,1,[MIIIKE]Garrett,2267,182,6,6,12,50.0%,56m
34038,1,TriAngles,2267,0,4,1,5,80.0%,28m
34038,2,Hezar,2267,124,4,10,14,28.6%,24m
34038,1,RachniThane,2267,0,3,4,7,42.9%,3h
34038,1,[QcScT]Totoja,2267,46,3,5,8,37.5%,3h
34038,2,Weston,2267,0,2,3,5,40.0%,6m
34038,1,Zero,2267,0,1,4,5,20.0%,42m
34038,3,TurkeyCheese,2267,0,1,6,7,14.3%,3h
34038,2,egurren,2267,0,0,1,1,0.0%,48m
34038,1,[TECPLA]wilder,2267,0,0,2,2,0.0%,2h
34038,1,Solace,2267,0,0,2,2,0.0%,1h
34038,1,Goibniu,2267,0,0,4,4,0.0%,56m
34057,1,[NoH2O]Tynamo,2266,1183,64,83,147,43.5%,1h
34057,1,CramitDeFrog,2266,730,30,34,64,46.9%,16m
34057,1,[No0Bs]ProStyle,2266,356,18,14,32,56.2%,3m
34057,1,Porky,2266,683,18,25,43,41.9%,2h
34057,1,Byte,2266,431,15,14,29,51.7%,39m
34057,3,[SLUMMS]Ethan,2266,310,10,10,20,50.0%,12m
34057,2,Tokedyamama,2266,270,9,15,24,37.5%,59m
34057,2,BattleBalls,2266,222,7,15,22,31.8%,2h
34057,1,IIIIIIIIIIII,2266,145,4,3,7,57.1%,1h
34057,1,Kevizet,2266,48,2,6,8,25.0%,2h
34057,1,Natron,2266,73,2,7,9,22.2%,33m
34057,1,[SACLyf]Cameinsecond,2266,0,1,0,1,100.0%,58m
34057,3,Bugachug,2266,0,1,0,1,100.0%,2h
34057,1,[HENT4l]Rambo,2266,0,1,0,1,100.0%,1h
34057,1,[pSC20]ZERO,2266,0,1,0,1,100.0%,33m
34057,2,JakeRyan,2266,34,1,2,3,33.3%,21m
34057,1,Hovermind,2266,48,1,5,6,16.7%,3h
34057,1,[Pig2]guardgirl,2266,0,1,5,6,16.7%,19m
34057,1,Kisliy,2266,0,0,2,2,0.0%,1h
34057,1,MARIEKORBEL,2266,0,0,3,3,0.0%,17m
34077,1,Zeratulsfart,2265,770,30,23,53,56.6%,1h
34077,2,ailime,2265,439,25,37,62,40.3%,1h
34077,1,[xSiRx]SiRImpacts,2265,619,23,13,36,63.9%,1h
34077,1,therealjerry,2265,395,23,23,46,50.0%,3h
34077,3,ZERGZERGZERG,2265,543,21,21,42,50.0%,47m
34077,3,[TX210]sixpacjak,2265,576,19,31,50,38.0%,2h
34077,1,Chalomello,2265,414,12,17,29,41.4%,3h
34077,1,TSandwich,2265,404,11,9,20,55.0%,1h
34077,3,Patters,2265,336,11,22,33,33.3%,2h
34077,3,Reivax,2265,61,6,10,16,37.5%,44m
34077,1,egk,2265,97,2,6,8,25.0%,2h
34077,1,[TGosuD]XIACOM,2265,0,1,0,1,100.0%,5m
34077,1,Dalore,2265,0,1,1,2,50.0%,1h
34090,1,Jalex,2264,1720,95,100,195,48.7%,51m
34090,1,[turds1]Guill,2264,1670,57,58,115,49.6%,2h
34090,1,derpindas,2264,1180,47,34,81,58.0%,37m
34090,1,[QQQ]doc,2264,954,33,31,64,51.6%,30m
34090,1,REEactive,2264,698,31,23,54,57.4%,2h
34090,1,volitic,2264,749,28,25,53,52.8%,2h
34090,1,Snowman,2264,686,20,20,40,50.0%,56m
34090,1,[ExcIgN]ElBerlini,2264,420,15,18,33,45.5%,20m
34090,1,BadWolf,2264,489,14,25,39,35.9%,3h
34090,1,AKILAE,2264,392,12,13,25,48.0%,2h
34090,3,macroNcheese,2264,120,6,9,15,40.0%,2h
34090,3,Architeuthis,2264,114,4,8,12,33.3%,2h
34090,2,arthur,2264,114,4,8,12,33.3%,3h
34090,3,WAARGH,2264,145,3,4,7,42.9%,46m
34090,3,JAIVA,2264,92,3,15,18,16.7%,2h
34090,1,Qwartres,2264,121,2,1,3,66.7%,58m
34090,1,RequiemRust,2264,86,2,5,7,28.6%,5m
34090,1,[ZBK]Ares,2264,0,2,7,9,22.2%,29m
34090,1,duhmee,2264,0,1,4,5,20.0%,25m
34090,3,cragrent,2264,38,1,6,7,14.3%,51m
34090,2,GoBirdKR,2264,0,1,12,13,7.7%,3h
34090,1,droppingload,2264,0,0,1,1,0.0%,1h
34112,1,Priolith,2263,1819,135,135,270,50.0%,22m
34112,3,Underscore,2263,1481,54,64,118,45.8%,17m
34112,3,Morgram,2263,863,48,48,96,50.0%,3m
34112,1,[DRKDMN]GreenDeath,2263,766,22,25,47,46.8%,2h
34112,1,mana,2263,594,16,16,32,50.0%,1h
34112,2,Revan,2263,176,10,13,23,43.5%,18m
34112,1,IUhead,2263,200,7,3,10,70.0%,22m
34112,1,Kozac,2263,283,7,6,13,53.8%,2h
34112,1,Tusky,2263,126,4,3,7,57.1%,2h
34112,2,gichan,2263,58,4,7,11,36.4%,42m
34112,3,[oPu]lCharizardl,2263,121,2,4,6,33.3%,2h
34112,1,meisNEWqaq,2263,81,2,4,6,33.3%,1h
34112,2,AsuraRage,2263,48,1,5,6,16.7%,16m
34112,1,rev,2263,0,0,1,1,0.0%,33m
34126,1,Vulture,2262,1350,135,113,248,54.4%,1h
34126,1,Titan,2262,1668,85,79,164,51.8%,48m
34126,1,Onerb,2262,1577,79,64,143,55.2%,2h
34126,3,LEXAR,2262,1480,79,74,153,51.6%,6m
34126,1,DrewIQ,2262,1100,77,81,158,48.7%,28m
34126,2,fingerbowl,2262,1546,58,59,117,49.6%,3h
34126,1,Shipeo,2262,1301,52,62,114,45.6%,59m
34126,3,Scharfff,2262,1341,51,56,107,47.7%,48m
34126,1,Psyco,2262,760,30,20,50,60.0%,33m
34126,1,Jester,2262,818,24,25,49,49.0%,2h
34126,1,Pappas,2262,632,22,20,42,52.4%,3h
34126,1,ENERVO,2262,523,15,12,27,55.6%,3h
34126,3,Bert,2262,224,7,11,18,38.9%,3h
34126,1,Trax,2262,160,5,2,7,71.4%,5m
34126,1,DoNaN,2262,186,4,2,6,66.7%,2h
34126,1,Nooblet,2262,118,4,3,7,57.1%,3h
34126,1,[VFam2]ElArquiMx,2262,121,3,8,11,27.3%,43m
34126,1,dreamdybala,2262,0,2,4,6,33.3%,33m
34126,1,maticus,2262,0,1,0,1,100.0%,2h
34126,1,DarkHorse,2262,38,1,5,6,16.7%,2h
34126,1,[SMV]NullPointer,2262,0,0,1,1,0.0%,3h
34126,1,[rIybad]Chip,2262,0,0,1,1,0.0%,19m
34126,2,PotterxD,2262,0,0,1,1,0.0%,48m
34126,1,Bengence,2262,0,0,1,1,0.0%,48m
34126,3,KRATOS,2262,0,0,4,4,0.0%,12m
34151,1,CmdrSlayer,2261,786,55,51,106,51.9%,3h
34151,1,Spoke,2261,1124,41,38,79,51.9%,2h
34151,1,SugarWater,2261,531,23,12,35,65.7%,17m
34151,1,Myselflicius,2261,166,6,9,15,40.0%,2h
34151,1,Guduranis,2261,159,4,1,5,80.0%,3h
34151,2,Ambrosia,2261,0,0,1,1,0.0%,2h
34151,2,[btf]Icem,2261,0,0,1,1,0.0%,59m
34151,1,[BEEBOY]vitototote,2261,0,0,2,2,0.0%,58m
34159,1,HunterXD,2260,1310,110,95,205,53.7%,3h
34159,1,Skeksis,2260,1604,81,78,159,50.9%,1h
34159,1,Diablomnky,2260,954,39,39,78,50.0%,2h
34159,3,NastyFarts,2260,345,14,14,28,50.0%,14m
34159,3,MrToodles,2260,373,13,22,35,37.1%,54m
34159,1,Nine,2260,198,8,7,15,53.3%,3h
34159,1,ISIS,2260,257,8,8,16,50.0%,2h
34159,2,[MKIV]oKGoogle,2260,162,6,10,16,37.5%,3h
34159,1,PeachPanda,2260,0,2,3,5,40.0%,3h
34159,1,Porkchops,2260,0,2,5,7,28.6%,1h
34159,1,Pulsar,2260,38,2,5,7,28.6%,3h
34159,3,CarnZarooks,2260,0,2,6,8,25.0%,54m
34159,1,LegendKiller,2260,73,0,3,3,0.0%,2h
34172,3,KittyCatJoe,2259,1330,93,92,185,50.3%,17m
34172,3,aKaMaikol,2259,751,42,44,86,48.8%,12m
34172,1,Zeo,2259,429,14,23,37,37.8%,28m
34172,2,tarzan,2259,217,7,13,20,35.0%,3h
34172,3,MEDIC,2259,128,6,14,20,30.0%,20m
34172,1,Nofear,2259,0,4,4,8,50.0%,42m
34172,1,[pelima]CHACHO,2259,88,3,3,6,50.0%,43m
34172,1,Alex,2259,82,3,6,9,33.3%,3h
34172,1,Roderick,2259,123,2,3,5,40.0%,2h
34172,1,Demented,2259,97,2,5,7,28.6%,42m
34172,2,OldTriforce,2259,0,2,6,8,25.0%,54m
34172,1,Dancraft,2259,32,1,3,4,25.0%,25m
34172,1,JibTech,2259,0,0,2,2,0.0%,2h
34172,1,ROMARIO,2259,0,0,2,2,0.0%,52m
34186,1,Quixote,2258,740,61,63,124,49.2%,3m
34186,1,souldnerd,2258,1348,54,56,110,49.1%,45m
34186,1,Dart,2258,1102,34,37,71,47.9%,5m
34186,1,[soypro]Craneoces,2258,548,24,17,41,58.5%,3h
34186,1,YouNeedLube,2258,272,11,8,19,57.9%,9m
34186,1,Greasy,2258,336,9,13,22,40.9%,22m
34186,1,MegaNerrd,2258,76,3,1,4,75.0%,2h
34186,1,Borat,2258,125,2,1,3,66.7%,3h
34186,1,Flai,2258,48,2,4,6,33.3%,26m
34186,3,Slim,2258,58,2,11,13,15.4%,49m
34186,1,stephany,2258,0,1,0,1,100.0%,26m
34186,1,Aweskill,2258,0,1,2,3,33.3%,3h
34186,1,[ASPIE]UncleBigBoi,2258,0,0,1,1,0.0%,1h
34186,1,ricktard,2258,0,0,2,2,0.0%,5m
34186,1,CrackxPipe,2258,0,0,3,3,0.0%,22m
34186,1,tomax,2258,0,0,5,5,0.0%,29m
34202,1,[TITODO]MrCoyote,2257,1775,94,99,193,48.7%,2h
34202,1,KJil,2257,846,27,31,58,46.6%,1h
34202,1,Philip,2257,551,21,14,35,60.0%,26m
34202,1,Ferg,2257,506,14,19,33,42.4%,44m
34202,2,[xTQc]Moulehumide,2257,276,12,24,36,33.3%,51m
34202,1,Thermo,2257,161,9,5,14,64.3%,2h
34202,1,[BChick]HUNTER,2257,250,7,10,17,41.2%,5m
34202,1,CHERVU,2257,121,5,4,9,55.6%,3h
34202,1,Bootstraps,2257,144,4,8,12,33.3%,2h
34202,3,TitanNose,2257,180,4,9,13,30.8%,48m
34202,3,Jacques,2257,0,1,3,4,25.0%,7m
34202,1,NegraVidaImp,2257,97,1,6,7,14.3%,41m
34202,1,IkutoHyuga,2257,0,0,1,1,0.0%,3h
34202,1,KHAN,2257,0,0,1,1,0.0%,52m
34202,1,darinel,2257,0,0,2,2,0.0%,3h
34217,1,Cmon,2256,938,26,34,60,43.3%,46m
34217,1,zogger,2256,548,17,20,37,45.9%,5m
34217,1,themaestro,2256,239,8,6,14,57.1%,48m
34217,1,zEUZ,2256,280,6,5,11,54.5%,24m
34217,1,Naegleria,2256,129,5,2,7,71.4%,24m
34217,1,[SQHX]Sockqinta,2256,165,5,5,10,50.0%,13m
34217,1,Zerg,2256,0,1,0,1,100.0%,44m
34217,1,rasdel,2256,46,1,3,4,25.0%,3m
34217,1,senier,2256,0,0,3,3,0.0%,2h
34226,1,Idiot,2255,1461,131,125,256,51.2%,40m
34226,1,Kataclist,2255,979,55,45,100,55.0%,40m
34226,3,FourJuBu,2255,538,55,57,112,49.1%,1h
34226,1,Warpilot,2255,1294,53,40,93,57.0%,2h
34226,1,Bully,2255,1005,51,35,86,59.3%,3h
34226,3,Topher,2255,597,38,47,85,44.7%,2h
34226,1,Ballz,2255,497,28,28,56,50.0%,58m
34226,1,JoJotaro,2255,371,22,25,47,46.8%,23m
34226,1,Ripley,2255,465,14,8,22,63.6%,1h
34226,1,[The304]DaKhang,2255,458,13,10,23,56.5%,3h
34226,3,fistindead,2255,362,12,20,32,37.5%,49m
34226,1,notmetrussme,2255,408,11,22,33,33.3%,2h
34226,3,Arngrim,2255,307,10,13,23,43.5%,3h
34226,2,Steven,2255,135,6,12,18,33.3%,2h
34226,1,Dravenxxl,2255,241,5,9,14,35.7%,60m
34226,3,MOTHER,2255,187,5,10,15,33.3%,20m
34226,3,RobsonVESS,2255,174,5,11,16,31.2%,56m
34226,1,EricCartman,2255,139,4,8,12,33.3%,3h
34226,1,Admiral,2255,88,3,5,8,37.5%,8m
34226,1,pog,2255,66,3,6,9,33.3%,3h
34226,1,DxRxIxZxY,2255,0,1,0,1,100.0%,5m
34226,1,JEDI,2255,48,1,1,2,50.0%,2h
34226,1,Rick,2255,0,1,6,7,14.3%,26m
34226,1,chungus,2255,0,1,6,7,14.3%,58m
34226,1,[CS0]UndeadPants,2255,0,0,2,2,0.0%,1h
34226,1,[atrox]ZimbobwayOrp,2255,0,0,5,5,0.0%,2h
34252,1,overhuman,2254,1833,175,168,343,51.0%,42m
34252,1,RORRISFUZZ,2254,1825,71,61,132,53.8%,58m
34252,1,XBlackOmega,2254,791,69,81,150,46.0%,1h
34252,1,GUS,2254,1381,60,51,111,54.1%,3h
34252,1,[Clappy]SandyRavage,2254,617,26,26,52,50.0%,40m
34252,1,ehehron,2254,642,19,15,34,55.9%,17m
34252,1,Rockserty,2254,320,16,6,22,72.7%,3h
34252,1,McsTarget,2254,337,10,15,25,40.0%,2h
34252,1,stellaris,2254,354,9,14,23,39.1%,45m
34252,1,Nascar,2254,111,5,5,10,50.0%,1h
34252,2,Aanokint,2254,160,5,12,17,29.4%,3h
34252,1,[CS0]Krytos,2254,208,4,3,7,57.1%,3h
34252,1,Spectrelight,2254,48,4,6,10,40.0%,1h
34252,3,llIIIIllllI,2254,122,4,8,12,33.3%,17m
34252,1,pyros,2254,118,3,3,6,50.0%,2h
34252,1,Joel,2254,132,2,2,4,50.0%,31m
34252,3,Snake,2254,0,2,8,10,20.0%,46m
34252,1,Cannedhodge,2254,0,1,0,1,100.0%,1h
34252,2,Dolling,2254,0,1,1,2,50.0%,1h
34252,1,JIM,2254,0,1,2,3,33.3%,1h
34252,1,Majestic,2254,48,1,2,3,33.3%,1h
34252,2,GeeGee,2254,0,1,3,4,25.0%,2h
34252,1,MrWhite,2254,0,0,1,1,0.0%,2h
34252,1,Falcondrak,2254,0,0,1,1,0.0%,60m
34252,1,Nephilim,2254,0,0,2,2,0.0%,3h
34277,3,Bonenator,2253,1572,541,537,1078,50.2%,2h
34277,3,PRFcted,2253,1565,85,90,175,48.6%,53m
34277,1,HumbleTiger,2253,696,37,33,70,52.9%,26m
34277,3,[Atomix]nirvana,2253,599,26,37,63,41.3%,2h
34277,1,Fluffywuffy,2253,142,6,7,13,46.2%,3h
34277,1,kanuk,2253,166,4,6,10,40.0%,28m
34277,1,MelekTaus,2253,165,4,11,15,26.7%,25m
34277,3,Drakos,2253,90,3,7,10,30.0%,2h
34277,1,Stevenwar,2253,26,2,1,3,66.7%,2h
34277,1,TUMACHO,2253,84,2,4,6,33.3%,51m
34277,1,CRiMiNaL,2253,97,2,5,7,28.6%,3h
34277,1,MetaneX,2253,73,2,7,9,22.2%,56m
34277,1,[MERICA]SirPsychoSxy,2253,73,1,3,4,25.0%,28m
34277,1,Kerbello,2253,0,0,2,2,0.0%,30m
34277,1,IGORIGORIGOR,2253,0,0,2,2,0.0%,32m
34277,1,[TGosuD]DeathDome,2253,0,0,3,3,0.0%,2h
34277,2,SiMutada,2253,0,0,5,5,0.0%,49m
34277,1,[FyHr]RicardinniZ,2253,0,0,6,6,0.0%,2h
34295,2,Conz,2252,1509,296,296,592,50.0%,1h
34295,1,WeirdEyeKing,2252,932,29,23,52,55.8%,58m
34295,1,Specter,2252,655,24,22,46,52.2%,58m
34295,3,[LMI42]Sadik,2252,291,21,22,43,48.8%,23m
34295,3,Ascended,2252,270,8,10,18,44.4%,2h
34295,1,[lolzzz]Kikiriskiaga,2252,221,5,4,9,55.6%,60m
34295,3,trickyrick,2252,125,2,6,8,25.0%,2h
34295,1,Krakovsk,2252,0,1,0,1,100.0%,42m
34295,1,Probezilla,2252,36,1,1,2,50.0%,32m
34295,1,BruceMFbruce,2252,0,1,2,3,33.3%,13m
34295,3,ETERNITY,2252,30,1,4,5,20.0%,33m
34295,1,AraAra,2252,0,1,4,5,20.0%,2h
34295,1,vichomalo,2252,0,1,5,6,16.7%,45m
34295,3,ClamComunity,2252,0,1,7,8,12.5%,2h
34295,1,LeBossDeDieu,2252,0,0,1,1,0.0%,3h
34310,1,DarkSteel,2251,1529,56,54,110,50.9%,3h
34310,1,FlyFresno,2251,609,19,23,42,45.2%,24m
34310,1,McVillaLobos,2251,473,15,21,36,41.7%,3h
34310,1,computer,2251,255,7,12,19,36.8%,40m
34310,1,[Brosss]Radagnir,2251,158,5,3,8,62.5%,28m
34310,1,[UoN]Tarsonis,2251,117,4,5,9,44.4%,2h
34310,1,Pumpkin,2251,66,4,10,14,28.6%,27m
34310,1,Gameneededme,2251,78,2,4,6,33.3%,30m
34310,1,[Z00]Gabagool,2251,0,1,1,2,50.0%,53m
34310,1,[DhZAc1]Sadhak,2251,34,1,3,4,25.0%,3h
34310,3,WadaGZ,2251,0,0,1,1,0.0%,46m
34310,1,HunabKuZamna,2251,0,0,3,3,0.0%,51m
34322,1,JuJu,2250,455,33,31,64,51.6%,2h
34322,1,OneMind,2250,573,25,24,49,51.0%,56m
34322,1,[clow]jeffestive,2250,716,25,26,51,49.0%,28m
34322,3,SPICH,2250,644,25,34,59,42.4%,13m
34322,3,OldSkuLL,2250,580,20,29,49,40.8%,2h
34322,1,Tutogames,2250,429,16,15,31,51.6%,58m
34322,1,Sandéconné,2250,220,8,3,11,72.7%,2h
34322,1,Mazoy,2250,264,8,12,20,40.0%,3h
34322,1,Heaven,2250,204,5,8,13,38.5%,1h
34322,1,IzJusTree,2250,84,2,2,4,50.0%,42m
34322,1,Sodapopinsky,2250,122,2,5,7,28.6%,1h
34322,1,Alazay,2250,0,1,0,1,100.0%,58m
34322,3,[ESP0RT]Maru,2250,30,1,7,8,12.5%,2h
34335,1,Hunted,2249,1338,93,80,173,53.8%,33m
34335,2,Omnistair,2249,816,80,98,178,44.9%,30m
34335,1,Keyalot,2249,771,37,29,66,56.1%,25m
34335,3,BigPrez,2249,942,34,50,84,40.5%,15m
34335,1,MARTE,2249,452,14,17,31,45.2%,2h
34335,2,Zathara,2249,393,14,21,35,40.0%,46m
34335,1,DirtyWatah,2249,417,12,9,21,57.1%,2h
34335,1,Bekkaician,2249,350,11,17,28,39.3%,17m
34335,1,[SpcBar]Xari,2249,340,9,6,15,60.0%,2h
34335,1,dominikskyce,2249,236,6,11,17,35.3%,3h
34335,3,Roy,2249,117,3,5,8,37.5%,48m
34335,3,TopGlitch,2249,0,3,8,11,27.3%,15m
34335,1,MoonTwilight,2249,38,2,2,4,50.0%,13m
34335,3,Shadieeeeeee,2249,97,2,8,10,20.0%,17m
34335,1,JLaff,2249,93,1,2,3,33.3%,44m
34335,1,PAGF,2249,42,1,3,4,25.0%,30m
34335,1,OTHERSIDE,2249,46,1,5,6,16.7%,13m
34335,1,memerweiner,2249,0,1,6,7,14.3%,1h
34335,3,Drakhan,2249,0,1,6,7,14.3%,18m
34335,1,[LOHs]ErwOfHedeby,2249,0,0,1,1,0.0%,22m
34355,2,[TeamUR]Ghyslyn,2248,1488,144,163,307,46.9%,3h
34355,2,[GrnBrd]Aboutalib,2248,1231,60,71,131,45.8%,46m
34355,3,Stoltis,2248,780,41,34,75,54.7%,1h
34355,1,[FyHr]leonidas,2248,836,35,23,58,60.3%,3h
34355,1,NoobForLife,2248,778,28,28,56,50.0%,2h
34355,1,likewhite,2248,631,24,25,49,49.0%,3h
34355,1,Izanagi,2248,676,20,16,36,55.6%,17m
34355,1,Goya,2248,532,17,18,35,48.6%,2h
34355,3,SamPPsmol,2248,379,14,25,39,35.9%,2h
34355,1,[LBDeA]BDJoaq,2248,121,5,2,7,71.4%,45m
34355,3,Syaz,2248,155,4,5,9,44.4%,3m
34355,1,xuniverseIVG,2248,146,4,9,13,30.8%,9m
34355,1,zaius,2248,42,2,2,4,50.0%,22m
34355,1,Arphios,2248,0,2,3,5,40.0%,5m
34355,1,[UpxV]CRIPTO,2248,36,2,4,6,33.3%,21m
34355,1,bregan,2248,40,1,5,6,16.7%,33m
34355,1,[PBS]Potatomasta,2248,0,0,3,3,0.0%,45m
34372,1,Semi,2247,1683,75,69,144,52.1%,3h
34372,1,CoolStoryBro,2247,961,48,39,87,55.2%,3h
34372,3,black,2247,523,20,30,50,40.0%,18m
34372,3,[VGRiD]Heatwave,2247,340,12,22,34,35.3%,31m
34372,1,TREVORIANO,2247,274,8,13,21,38.1%,3h
34372,2,[AbcCo]Megab,2247,258,7,13,20,35.0%,4m
34372,2,Medakian,2247,315,7,25,32,21.9%,2h
34372,1,Allunak,2247,140,5,3,8,62.5%,2h
34372,2,Nebz,2247,120,4,10,14,28.6%,59m
34372,1,Naxavar,2247,40,2,1,3,66.7%,2h
34372,1,oktahpus,2247,91,2,1,3,66.7%,48m
34372,3,gapple,2247,0,1,0,1,100.0%,2h
34372,1,BBYAmuB,2247,0,1,1,2,50.0%,59m
34372,1,dubstepsnipe,2247,0,1,3,4,25.0%,1h
34372,1,Fanatic,2247,0,1,6,7,14.3%,1h
34372,1,RazoltFg,2247,0,0,1,1,0.0%,1h
34372,1,BlackBull,2247,0,0,6,6,0.0%,2h
34389,1,Rez,2246,1496,62,59,121,51.2%,33m
34389,1,heromelon,2246,614,18,16,34,52.9%,22m
34389,3,Paralax,2246,466,17,28,45,37.8%,1h
34389,1,Rakaro,2246,322,12,18,30,40.0%,32m
34389,1,FireInTheSky,2246,448,11,16,27,40.7%,2h
34389,3,Lithium,2246,365,11,23,34,32.4%,3h
34389,1,[LCE]InnoVation,2246,130,5,1,6,83.3%,40m
34389,1,Homewood,2246,208,5,8,13,38.5%,33m
34389,1,PandaKudux,2246,192,5,9,14,35.7%,3h
34389,3,youngbouzin,2246,0,4,4,8,50.0%,2h
34389,1,Zeratul,2246,170,4,7,11,36.4%,22m
34389,3,plusio,2246,86,3,3,6,50.0%,59m
34389,3,ICE,2246,145,3,5,8,37.5%,2h
34389,1,Zay,2246,48,2,6,8,25.0%,1h
34389,1,[PREGG]Gecuero,2246,0,1,0,1,100.0%,2h
34389,1,Bheasty,2246,36,1,1,2,50.0%,1h
34389,1,Zerallamvuut,2246,0,1,4,5,20.0%,40m
34389,1,Dad,2246,0,0,4,4,0.0%,2h
34407,1,belayzee,2245,1591,379,392,771,49.2%,3h
34407,3,[NLTN]Mike,2245,1580,300,319,619,48.5%,40m
34407,1,Bean,2245,1541,60,58,118,50.8%,28m
34407,1,Krakorum,2245,1222,58,67,125,46.4%,12m
34407,1,OspreyPanzer,2245,1420,48,44,92,52.2%,59m
34407,1,ayymar,2245,1182,39,39,78,50.0%,9m
34407,1,LeoRIos,2245,1052,33,40,73,45.2%,2h
34407,1,Otocani,2245,798,26,21,47,55.3%,1h
34407,2,Shweddynuts,2245,553,22,29,51,43.1%,1h
34407,1,[E8]Kelvinator,2245,398,17,12,29,58.6%,3h
34407,1,ALBORYOIN,2245,287,11,4,15,73.3%,10m
34407,3,Flophead,2245,162,6,22,28,21.4%,24m
34407,2,[Ayhur]SuperBlazer,2245,130,5,8,13,38.5%,4m
34407,1,[FLEXXX]Yoomee,2245,73,2,7,9,22.2%,2h
34407,1,HANSITO,2245,32,1,4,5,20.0%,3h
34407,1,yChewy,2245,0,1,4,5,20.0%,2h
34407,2,HoneyBadger,2245,48,1,5,6,16.7%,2h
34407,1,EthanBF,2245,0,1,5,6,16.7%,49m
34407,2,Gamalas,2245,0,0,1,1,0.0%,47m
34407,1,Betrayer,2245,0,0,2,2,0.0%,3h
34407,1,Tomination,2245,0,0,6,6,0.0%,3h
34428,3,TGCid,2244,1094,81,88,169,47.9%,23m
34428,1,fnord,2244,1812,79,77,156,50.6%,3h
34428,3,demotionINC,2244,907,40,51,91,44.0%,2h
34428,1,MrSuspicious,2244,552,21,24,45,46.7%,2h
34428,1,WeeSnaw,2244,619,17,15,32,53.1%,3m
34428,1,poapleader,2244,530,16,14,30,53.3%,3h
34428,3,presidentefs,2244,243,13,18,31,41.9%,11m
34428,1,Order,2244,416,12,13,25,48.0%,3h
34428,3,kraken,2244,223,7,11,18,38.9%,2h
34428,1,SeekNDestroy,2244,169,4,1,5,80.0%,3h
34428,1,[ADDU]VanHoenheim,2244,167,4,7,11,36.4%,42m
34428,1,lonecraft,2244,164,3,2,5,60.0%,2h
34428,1,[suny42]SunnyD,2244,139,3,4,7,42.9%,3h
34428,1,JAMES,2244,88,3,4,7,42.9%,22m
34428,1,Storm,2244,94,3,6,9,33.3%,3h
34428,1,ESLAyed,2244,108,2,4,6,33.3%,42m
34428,1,Mengano,2244,102,2,5,7,28.6%,33m
34428,1,[nieBla]TastosisLova,2244,0,1,5,6,16.7%,2h
34428,1,YUKIHIRA,2244,0,1,5,6,16.7%,3h
34447,1,Grif,2243,1258,43,43,86,50.0%,3h
34447,3,RIPPEDABS,2243,694,25,35,60,41.7%,3h
34447,1,Osiris,2243,638,19,23,42,45.2%,42m
34447,1,AndresOmy,2243,354,9,12,21,42.9%,2h
34447,3,Marty,2243,272,9,14,23,39.1%,30m
34447,1,Echo,2243,135,5,5,10,50.0%,54m
34447,1,[STDnbs]Cooleo,2243,76,3,6,9,33.3%,40m
34447,1,crazylegz,2243,145,2,1,3,66.7%,46m
34447,1,yoisan,2243,0,1,0,1,100.0%,2h
34447,1,[TGFU]ToXicVolk,2243,0,1,0,1,100.0%,2h
34447,1,[DarkLS]BlueNait,2243,88,1,1,2,50.0%,53m
34447,1,Skoc,2243,0,0,3,3,0.0%,1h
34459,2,volatile,2242,1248,49,56,105,46.7%,46m
34459,1,PsichoFox,2242,1077,40,28,68,58.8%,42m
34459,1,Axarraekji,2242,662,17,22,39,43.6%,40m
34459,1,Kragor,2242,405,13,9,22,59.1%,23m
34459,1,[NoBads]Halcyon,2242,396,13,12,25,52.0%,2h
34459,1,Gufaza,2242,406,12,14,26,46.2%,1h
34459,1,[PBGx]Thelen,2242,305,10,5,15,66.7%,56m
34459,1,[FFAA]CHIKIMASTER,2242,205,6,10,16,37.5%,41m
34459,3,[IRWT]Hairyman,2242,196,6,17,23,26.1%,2h
34459,1,ElVoliCL,2242,80,5,4,9,55.6%,2h
34459,1,SpeedRacerX,2242,174,4,2,6,66.7%,56m
34459,1,jacksong,2242,42,2,4,6,33.3%,56m
34459,1,youmslinky,2242,48,2,6,8,25.0%,2h
34459,1,Evelyn,2242,0,1,1,2,50.0%,2h
34459,2,[Y4NG20]natedoggg,2242,0,1,2,3,33.3%,3h
34459,1,Hambo,2242,42,1,3,4,25.0%,2h
34459,1,KHYRIOS,2242,0,1,5,6,16.7%,2h
34459,3,KimJongSkill,2242,30,1,9,10,10.0%,49m
34459,1,finishblack,2242,0,0,4,4,0.0%,3h
34478,1,RyzeerDC,2241,518,16,14,30,53.3%,22m
34478,1,LaserTime,2241,123,3,1,4,75.0%,2h
34478,1,Migbon,2241,0,3,2,5,60.0%,42m
34478,1,FDen,2241,121,3,3,6,50.0%,1h
34478,1,ahahahhahaha,2241,144,3,4,7,42.9%,44m
34478,1,Pnzzle,2241,111,3,6,9,33.3%,19m
34478,1,Awper,2241,97,2,1,3,66.7%,13m
34478,1,Jester,2241,0,2,5,7,28.6%,3h
34478,1,MrPikles,2241,128,2,6,8,25.0%,22m
34478,1,[ROS8th]Butter,2241,73,1,1,2,50.0%,3h
34478,1,SilentSword,2241,0,1,6,7,14.3%,2h
34489,1,DayKnight,2240,944,34,34,68,50.0%,3h
34489,1,[TRTU]Chiefy,2240,477,15,20,35,42.9%,5m
34489,1,Jesalo,2240,311,13,19,32,40.6%,2h
34489,1,llllllllllll,2240,342,12,5,17,70.6%,59m
34489,1,Stars,2240,371,12,14,26,46.2%,1h
34489,2,KnickerNoob,2240,142,10,24,34,29.4%,36m
34489,1,Hellstorm,2240,156,6,7,13,46.2%,2h
34489,1,SeoulReaper,2240,221,5,10,15,33.3%,2h
34489,1,chuckforest,2240,122,4,7,11,36.4%,3h
34489,1,BeevusReevus,2240,121,3,1,4,75.0%,1h
34489,1,Bobbus,2240,112,3,4,7,42.9%,25m
34489,3,Legoboy,2240,36,1,5,6,16.7%,44m
34489,3,WampaStompa,2240,30,1,5,6,16.7%,7m
34489,1,Theory,2240,0,0,3,3,0.0%,1h
34503,1,QQQ,2239,534,28,30,58,48.3%,2h
34503,1,DocHojo,2239,736,20,27,47,42.6%,51m
34503,1,Gnkku,2239,413,17,16,33,51.5%,3h
34503,1,Wince,2239,362,16,12,28,57.1%,2h
34503,2,Velociraptor,2239,384,11,47,58,19.0%,41m
34503,2,CaptinDartoy,2239,170,5,10,15,33.3%,22m
34503,1,Jerd,2239,88,2,4,6,33.3%,21m
34503,1,[USM]Rondiablo,2239,0,1,2,3,33.3%,2h
34503,1,GzombieMAN,2239,0,1,5,6,16.7%,1h
34503,1,ViktorSalEm,2239,0,1,5,6,16.7%,3h
34503,2,DOUG,2239,34,1,12,13,7.7%,2h
34503,1,cobkillacali,2239,0,0,1,1,0.0%,58m
34515,3,Ulgrim,2238,1593,65,68,133,48.9%,38m
34515,1,Archimedes,2238,957,32,30,62,51.6%,1h
34515,3,COFRAN,2238,737,24,30,54,44.4%,48m
34515,1,[dtwist]SwampyTaint,2238,273,19,0,19,100.0%,42m
34515,1,LucasCrack,2238,625,19,31,50,38.0%,45m
34515,2,ichich,2238,306,10,20,30,33.3%,1h
34515,1,[CqmB]SpaceRunner,2238,232,6,13,19,31.6%,1h
34515,1,neno,2238,138,4,8,12,33.3%,5m
34515,3,saulgudman,2238,78,4,10,14,28.6%,2h
34515,1,BlindstuckGG,2238,40,3,6,9,33.3%,3h
34515,2,PCW,2238,0,2,3,5,40.0%,2h
34515,2,ZergEatsYou,2238,0,1,4,5,20.0%,3h
34515,1,AnviD,2238,0,1,5,6,16.7%,14m
34515,2,Maurinaz,2238,0,0,1,1,0.0%,15m
34515,1,menace,2238,0,0,6,6,0.0%,2h
34530,1,KingSET,2237,1802,117,113,230,50.9%,17m
34530,1,VolcanoMaN,2237,500,14,16,30,46.7%,5m
34530,1,Anaboth,2237,338,13,12,25,52.0%,58m
34530,3,PatrickR,2237,244,7,11,18,38.9%,18m
34530,1,IcyKiwi,2237,243,5,9,14,35.7%,2h
34530,1,Leekorean,2237,0,4,2,6,66.7%,2h
34530,1,[Wc3GGL]bredrer,2237,38,4,3,7,57.1%,3h
34530,3,SnowToss,2237,0,4,4,8,50.0%,54m
34530,3,Invictus,2237,175,4,9,13,30.8%,2h
34530,1,GKman,2237,140,3,6,9,33.3%,2h
34530,1,[sanwch]IgnatiusJR,2237,42,2,4,6,33.3%,41m
34530,1,Nernie,2237,97,2,6,8,25.0%,2h
34530,1,Namluck,2237,48,2,6,8,25.0%,3h
34530,1,Veinhu,2237,42,2,7,9,22.2%,53m
34530,3,Donnadiee,2237,0,1,3,4,25.0%,3h
34530,1,EmantheMan,2237,48,1,3,4,25.0%,1h
34530,1,MetriK,2237,0,1,4,5,20.0%,40m
34530,2,CastedDreams,2237,0,1,4,5,20.0%,2h
34530,1,[aq]Dankrupt,2237,0,0,5,5,0.0%,31m
34549,3,Hoosierboi,2236,1318,70,67,137,51.1%,27m
34549,1,Allen,2236,1026,31,42,73,42.5%,3h
34549,1,sawer,2236,727,24,29,53,45.3%,3h
34549,1,[2Z1MTV]Lockotul,2236,686,18,22,40,45.0%,3h
34549,3,Funkypants,2236,412,17,20,37,45.9%,2h
34549,1,[DrnkTm]Angel,2236,555,15,14,29,51.7%,2h
34549,1,kuhhhnn,2236,323,14,14,28,50.0%,38m
34549,1,Qbaca,2236,435,14,19,33,42.4%,1h
34549,1,Jon,2236,208,12,15,27,44.4%,3h
34549,1,[DhZAc1]Seven,2236,232,6,7,13,46.2%,2h
34549,1,Bigexcel,2236,118,4,8,12,33.3%,1h
34549,3,Midel,2236,60,4,9,13,30.8%,26m
34549,1,omgPVO,2236,119,2,6,8,25.0%,3h
34549,2,ramkerd,2236,0,2,9,11,18.2%,1h
34549,1,Srslol,2236,0,1,4,5,20.0%,33m
34549,1,Sardonyx,2236,0,1,5,6,16.7%,2h
34549,1,ElHombre,2236,0,0,1,1,0.0%,59m
34549,1,Fenix,2236,0,0,2,2,0.0%,2h
34549,2,[ZTemp]Drkstar,2236,0,0,2,2,0.0%,30m
34549,1,Stiffmeister,2236,0,0,6,6,0.0%,1h
34549,1,Spiderman,2236,0,0,6,6,0.0%,2h
34570,1,newcommand,2235,1383,143,152,295,48.5%,1h
34570,1,KhanGharad,2235,1208,45,43,88,51.1%,56m
34570,1,disregard,2235,646,28,16,44,63.6%,25m
34570,1,carlotto,2235,463,15,14,29,51.7%,2h
34570,1,[CHONK]BobulusPrime,2235,205,5,4,9,55.6%,1h
34570,1,CrackRock,2235,174,4,10,14,28.6%,14m
34570,1,PersonKiller,2235,148,3,1,4,75.0%,51m
34570,1,ScrappyCocco,2235,97,2,1,3,66.7%,56m
34570,1,[PSUMHA]HydeShepard,2235,0,2,4,6,33.3%,54m
34570,1,[Eggers]Larfleeze,2235,82,2,6,8,25.0%,2h
34570,1,[BlTEL]glaurung,2235,0,0,1,1,0.0%,2h
34570,1,William,2235,0,0,1,1,0.0%,30m
34570,1,Scarbruh,2235,0,0,2,2,0.0%,3h
34570,1,charles,2235,0,0,2,2,0.0%,2h
34584,1,Minzy,2234,509,45,45,90,50.0%,56m
34584,1,darkpenguin,2234,1034,42,34,76,55.3%,2h
34584,1,KingCharles,2234,961,30,28,58,51.7%,22m
34584,1,[BlTEL]Bru,2234,116,4,3,7,57.1%,2h
34584,1,Shoggoth,2234,139,3,6,9,33.3%,29m
34584,1,lolathon,2234,78,2,4,6,33.3%,1h
34584,1,postpunk,2234,40,1,5,6,16.7%,42m
34584,1,[HBDC]bugspray,2234,0,1,6,7,14.3%,2h
34584,1,[TGosuA]Silverfox,2234,42,1,6,7,14.3%,2h
34584,1,[Hellal]hellalhuya,2234,46,1,7,8,12.5%,2h
34584,3,Havok,2234,0,0,1,1,0.0%,3h
34584,2,Axton,2234,0,0,1,1,0.0%,1h
34584,1,TheBadTouch,2234,0,0,2,2,0.0%,3h
34597,1,[DMONlC]movp,2233,1438,129,128,257,50.2%,3m
34597,2,Vigil,2233,1365,90,92,182,49.5%,3h
34597,1,Melphite,2233,511,20,17,37,54.1%,3h
34597,1,SoSaltySoFU,2233,292,8,14,22,36.4%,39m
34597,3,areesu,2233,114,5,13,18,27.8%,1h
34597,1,Iruam,2233,0,3,4,7,42.9%,2h
34597,3,Exercise,2233,30,2,1,3,66.7%,19m
34597,1,Fussel,2233,84,2,4,6,33.3%,22m
34597,3,Soulghast,2233,0,1,0,1,100.0%,56m
34597,1,[NM8]Stanler,2233,0,1,2,3,33.3%,20m
34597,1,Qrinn,2233,36,1,5,6,16.7%,26m
34597,1,GstZero,2233,0,1,5,6,16.7%,44m
34597,1,[asdfjh]FishBoy,2233,0,0,3,3,0.0%,3h
34610,1,Gonzo,2232,1811,123,125,248,49.6%,22m
34610,1,[SL0PPY]KingJon,2232,1564,108,99,207,52.2%,2h
34610,1,JEANDY,2232,1698,91,79,170,53.5%,9m
34610,1,KOSH,2232,1129,47,40,87,54.0%,3h
34610,1,[LCE]LexJauregui,2232,959,31,28,59,52.5%,3h
34610,1,escanor,2232,609,28,20,48,58.3%,22m
34610,1,Axse,2232,849,28,31,59,47.5%,41m
34610,1,Oeyx,2232,641,25,21,46,54.3%,10m
34610,3,pissface,2232,317,12,16,28,42.9%,2h
34610,1,xerito,2232,253,11,8,19,57.9%,2h
34610,1,[Bros]Matt,2232,309,9,11,20,45.0%,3h
34610,3,albatoss,2232,183,5,5,10,50.0%,2h
34610,1,[FyHr]ComandoRojo,2232,192,5,9,14,35.7%,56m
34610,3,SnowCake,2232,168,4,1,5,80.0%,1h
34610,1,Whitess,2232,177,4,9,13,30.8%,1h
34610,2,[0825]Bubblez,2232,48,2,0,2,100.0%,1h
34610,1,Archaeus,2232,0,2,3,5,40.0%,6m
34610,1,[CodSag]Sage,2232,121,2,6,8,25.0%,3h
34610,1,[Dorkz]DemoMan,2232,0,1,0,1,100.0%,1h
34610,1,[ZITAB1]thorset,2232,0,1,1,2,50.0%,52m
34610,1,Stephen,2232,88,1,5,6,16.7%,2h
34610,2,Whipface,2232,0,0,1,1,0.0%,17m
34610,1,[VRC]ChuquiMaster,2232,0,0,1,1,0.0%,3h
34610,1,SugarPlum,2232,0,0,2,2,0.0%,2h
34610,1,IlllIllIllII,2232,0,0,2,2,0.0%,2h
34610,1,liriconz,2232,0,0,5,5,0.0%,2h
34636,1,who,2231,1785,372,389,761,48.9%,2h
34636,1,FriendlyChem,2231,1468,78,66,144,54.2%,17m
34636,2,sallypark,2231,1533,68,86,154,44.2%,40m
34636,1,jose,2231,1222,39,41,80,48.8%,5m
34636,1,[5252]Jokertrue,2231,212,7,7,14,50.0%,3h
34636,1,GarganticPNS,2231,106,3,1,4,75.0%,3h
34636,1,Ptronx,2231,55,3,7,10,30.0%,44m
34636,1,molito,2231,96,3,7,10,30.0%,1h
34636,1,Mijals,2231,0,2,4,6,33.3%,2h
34636,1,jackJR,2231,44,2,5,7,28.6%,1h
34636,1,JohnMarik,2231,121,2,6,8,25.0%,2h
34636,3,DieBorg,2231,95,2,7,9,22.2%,40m
34636,3,Tuuracyyy,2231,0,1,0,1,100.0%,2h
34636,1,configsys,2231,88,1,1,2,50.0%,2h
34636,1,CHALLENGER,2231,0,0,1,1,0.0%,3h
34636,2,Yesselm,2231,0,0,1,1,0.0%,48m
34636,1,Abstrakt,2231,0,0,3,3,0.0%,3h
34636,1,luxide,2231,0,0,3,3,0.0%,2h
34636,2,RocKs,2231,0,0,5,5,0.0%,2h
34655,1,Leeloo,2230,715,30,23,53,56.6%,6m
34655,1,TerranLima,2230,664,19,24,43,44.2%,3h
34655,3,[YEGG]Kasnio,2230,240,12,8,20,60.0%,24m
34655,1,JazZz,2230,373,11,23,34,32.4%,3h
34655,1,GhostMarine,2230,236,5,8,13,38.5%,3h
34655,1,AnneNonymous,2230,104,4,3,7,57.1%,22m
34655,1,SIDESWIPE,2230,120,4,4,8,50.0%,32m
34655,3,SopaPowa,2230,76,4,9,13,30.8%,44m
34655,1,LaPerra,2230,116,2,1,3,66.7%,3m
34655,1,[Zno]CaptainTuna,2230,86,2,7,9,22.2%,3h
34655,1,BKHero,2230,0,2,8,10,20.0%,35m
34655,1,FENIX,2230,0,1,0,1,100.0%,3h
34655,1,Jiamin,2230,42,1,2,3,33.3%,46m
34655,1,HylianHero,2230,89,1,5,6,16.7%,53m
34655,1,pipoop,2230,0,0,1,1,0.0%,2h
34670,3,Devenwalsh,2229,1071,197,194,391,50.4%,3h
34670,1,MENGSK,2229,1274,79,82,161,49.1%,2h
34670,1,Void,2229,1062,49,44,93,52.7%,59m
34670,1,shinigami,2229,662,25,33,58,43.1%,3h
34670,2,bloodhound,2229,480,19,26,45,42.2%,19m
34670,2,Rex,2229,443,15,22,37,40.5%,40m
34670,1,vIzZ,2229,330,14,13,27,51.9%,3h
34670,1,[WCH69]DMAX,2229,349,10,12,22,45.5%,1h
34670,1,[WuTang]Aphex,2229,236,6,6,12,50.0%,33m
34670,1,Mandrew,2229,124,3,6,9,33.3%,1h
34670,3,RiZuU,2229,97,2,7,9,22.2%,59m
34670,1,Fader,2229,0,1,2,3,33.3%,2h
34682,2,Riku,2228,626,25,27,52,48.1%,1h
34682,1,[NSushi]APalestino,2228,709,21,19,40,52.5%,17m
34682,3,Asenvill,2228,569,20,26,46,43.5%,2h
34682,1,[char14]dark,2228,317,17,13,30,56.7%,3h
34682,1,SMOG,2228,482,15,16,31,48.4%,3m
34682,1,ademare,2228,387,13,15,28,46.4%,57m
34682,1,Frosty,2228,356,13,17,30,43.3%,14m
34682,1,banana,2228,303,9,14,23,39.1%,3h
34682,1,NoFeedPLZ,2228,172,6,0,6,100.0%,42m
34682,1,[xABQx]Lukas,2228,141,4,2,6,66.7%,26m
34682,1,luiqs,2228,109,3,1,4,75.0%,23m
34682,1,alien,2228,44,3,3,6,50.0%,49m
34682,1,ElChingon,2228,30,3,9,12,25.0%,3h
34682,1,emersed,2228,0,1,0,1,100.0%,20m
34682,1,Battle,2228,0,1,3,4,25.0%,2h
34682,1,snake,2228,0,0,1,1,0.0%,3h
34698,1,[ABzNT]amp,2227,852,36,36,72,50.0%,2h
34698,1,[GRUDGE]KraMBCooL,2227,544,25,17,42,59.5%,2h
34698,1,Serials,2227,380,14,11,25,56.0%,42m
34698,1,[HotRod]Silverscorp,2227,307,9,13,22,40.9%,5m
34698,3,calijoe,2227,97,2,0,2,100.0%,2h
34698,1,clownkey,2227,107,2,1,3,66.7%,49m
34698,1,Mayday,2227,126,2,2,4,50.0%,35m
34698,2,Xende,2227,40,2,14,16,12.5%,2h
34698,1,Dreadzed,2227,90,1,1,2,50.0%,3h
34698,1,[Pro999]GhostMen,2227,0,1,1,2,50.0%,3h
34698,3,[iFox]Mikkdahh,2227,97,1,1,2,50.0%,46m
34698,1,Showrider,2227,0,1,2,3,33.3%,20m
34698,1,milklizard,2227,0,1,5,6,16.7%,58m
34698,1,MASTERED,2227,0,0,4,4,0.0%,31m
34698,1,TuToyerLCiel,2227,0,0,5,5,0.0%,39m
34713,3,swerve,2226,1507,131,120,251,52.2%,33m
34713,3,will,2226,1309,58,55,113,51.3%,2h
34713,1,GaryTamang,2226,815,33,29,62,53.2%,29m
34713,1,KHYRIOS,2226,661,21,30,51,41.2%,2h
34713,2,KeepitDown,2226,470,18,23,41,43.9%,3h
34713,3,Deckboy,2226,193,6,4,10,60.0%,3h
34713,1,Ralifaz,2226,170,6,11,17,35.3%,3h
34713,2,[LoF]KaRioN,2226,104,5,13,18,27.8%,25m
34713,1,Gato,2226,168,4,3,7,57.1%,14m
34713,1,Mumble,2226,88,2,3,5,40.0%,9m
34713,1,AbyssWalker,2226,121,2,4,6,33.3%,29m
34713,3,Kathari,2226,0,2,5,7,28.6%,33m
34713,1,BlackNOVA,2226,97,2,6,8,25.0%,3h
34713,1,[Povo]KevKaze,2226,0,1,5,6,16.7%,2h
34713,1,notoriousBIG,2226,0,1,5,6,16.7%,1h
34713,1,Pepov,2226,0,0,1,1,0.0%,56m
34713,1,Dinkleberg,2226,0,0,1,1,0.0%,5m
34713,1,Asoloso,2226,0,0,1,1,0.0%,6m
34713,1,CaptainKyrk,2226,0,0,2,2,0.0%,38m
34732,1,Artemis,2225,1058,75,82,157,47.8%,43m
34732,3,Vicuña,2225,1514,72,76,148,48.6%,1h
34732,1,[VDA]chansec,2225,1083,67,73,140,47.9%,2h
34732,1,Spaceghost,2225,419,20,15,35,57.1%,2h
34732,1,Roxic,2225,463,18,15,33,54.5%,2h
34732,1,[ChzBal]Gum,2225,545,17,15,32,53.1%,3h
34732,1,Actual,2225,514,17,19,36,47.2%,2h
34732,1,Toxic,2225,412,16,9,25,64.0%,20m
34732,1,yeral,2225,190,7,3,10,70.0%,25m
34732,1,CrispyGT,2225,226,6,3,9,66.7%,2h
34732,3,TillsterRulz,2225,118,5,10,15,33.3%,2h
34732,2,jppmang,2225,0,2,3,5,40.0%,57m
34732,1,Jitano,2225,76,2,5,7,28.6%,60m
34732,3,[LQV]Blackwing,2225,0,1,0,1,100.0%,3h
34732,1,Rastaboy,2225,0,1,1,2,50.0%,46m
34732,1,XxNoobxX,2225,97,1,6,7,14.3%,27m
34732,1,JTheSparrow,2225,0,0,1,1,0.0%,34m
34732,1,SALT,2225,0,0,2,2,0.0%,2h
34732,1,Mrbehe,2225,0,0,2,2,0.0%,2h
34751,3,[FTLT]angelo,2224,1236,69,72,141,48.9%,50m
34751,1,nemostar,2224,1169,66,67,133,49.6%,2h
34751,1,Hero,2224,1053,53,47,100,53.0%,3h
34751,1,Yomama,2224,672,29,19,48,60.4%,59m
34751,1,WhippingKids,2224,626,28,18,46,60.9%,3h
34751,1,chiefdankiez,2224,487,20,10,30,66.7%,2h
34751,1,Conan,2224,337,15,9,24,62.5%,3h
34751,1,Mystyk,2224,521,15,14,29,51.7%,2h
34751,1,ChowderSnake,2224,396,11,15,26,42.3%,60m
34751,1,TuxedoMask,2224,225,7,6,13,53.8%,39m
34751,3,[CHPLKS]Guswar,2224,195,6,6,12,50.0%,53m
34751,1,Gunkanjima,2224,144,4,8,12,33.3%,26m
34751,1,[DSAL]GOLIAT,2224,104,3,0,3,100.0%,2h
34751,3,Dorian,2224,117,3,7,10,30.0%,2h
34751,1,TCC,2224,72,3,7,10,30.0%,2h
34751,3,malthael,2224,38,3,8,11,27.3%,58m
34751,1,[DYM]DTBGHOST,2224,90,2,0,2,100.0%,2h
34751,1,TheOne,2224,37,2,2,4,50.0%,39m
34751,2,LunarNemesis,2224,0,2,7,9,22.2%,2h
34751,1,Greygoo,2224,0,1,1,2,50.0%,2h
34751,1,NabOmen,2224,48,1,1,2,50.0%,22m
34751,1,[NPhase]RektTrashEZ,2224,0,0,1,1,0.0%,1h
34751,1,Littlepeach,2224,0,0,1,1,0.0%,1h
34774,1,blackclover,2223,1734,159,169,328,48.5%,14m
34774,1,MickeyRoyal,2223,1214,44,38,82,53.7%,1h
34774,1,kebabfoof,2223,622,26,24,50,52.0%,21m
34774,1,StyleBender,2223,523,20,18,38,52.6%,3h
34774,1,[GDJ]Hanamichi,2223,511,19,16,35,54.3%,56m
34774,1,ELSpartano,2223,472,18,18,36,50.0%,60m
34774,1,ghi,2223,416,17,15,32,53.1%,1h
34774,1,EMath,2223,414,14,21,35,40.0%,3h
34774,1,[FofS]Pops,2223,332,10,12,22,45.5%,1h
34774,1,JupitersAura,2223,274,9,13,22,40.9%,1h
34774,1,[SNICKL]WATERmouth,2223,275,7,9,16,43.8%,28m
34774,1,[USWAG]Tenkinoko,2223,158,4,5,9,44.4%,30m
34774,1,joefckyrslf,2223,82,3,5,8,37.5%,3h
34774,1,Squid,2223,86,3,8,11,27.3%,1h
34774,1,[GOPERÚ]Danatextraño,2223,97,2,3,5,40.0%,56m
34774,1,[S0Y]Chascudo,2223,0,1,1,2,50.0%,23m
34774,2,MagistradoAM,2223,0,1,4,5,20.0%,48m
34774,1,KingOverlord,2223,0,0,1,1,0.0%,2h
34774,2,[Trixie]VladxD,2223,0,0,1,1,0.0%,2h
34774,1,moreb,2223,0,0,2,2,0.0%,18m
34774,1,gaborocks,2223,0,0,3,3,0.0%,1h
34795,1,[AbcCo]Lionx,2222,1463,66,64,130,50.8%,23m
34795,3,WanghisKhan,2222,906,35,36,71,49.3%,40m
34795,3,dee,2222,532,17,28,45,37.8%,2h
34795,1,mightyQueef,2222,497,16,17,33,48.5%,59m
34795,1,DJHausman,2222,446,15,14,29,51.7%,43m
34795,1,BigDaddy,2222,510,14,18,32,43.8%,59m
34795,1,[Fir3s]Glaskar,2222,438,12,14,26,46.2%,2h
34795,1,tee,2222,351,11,12,23,47.8%,3h
34795,3,micha,2222,326,11,25,36,30.6%,24m
34795,1,ZergyHasLove,2222,334,9,12,21,42.9%,6m
34795,1,known,2222,264,5,10,15,33.3%,23m
34795,1,Bravethommas,2222,0,3,4,7,42.9%,3h
34795,1,Alex,2222,128,3,7,10,30.0%,5m
34795,1,ALPHA,2222,42,2,6,8,25.0%,3h
34795,3,Marco,2222,30,2,7,9,22.2%,46m
34795,1,Mabel,2222,48,1,1,2,50.0%,3h
34795,2,PENlSjuice,2222,0,1,1,2,50.0%,55m
34795,3,[Apinks]Apink,2222,0,0,1,1,0.0%,35m
34795,1,Valdomero,2222,0,0,2,2,0.0%,44m
34795,3,evilwasp,2222,0,0,3,3,0.0%,3h
34815,1,Iveria,2221,1284,39,41,80,48.8%,59m
34815,1,MASTERSUPLI,2221,642,18,22,40,45.0%,3h
34815,1,[ThSky]saiDaFrente,2221,353,10,15,25,40.0%,29m
34815,2,Achilles,2221,222,7,12,19,36.8%,3h
34815,3,[SC2BOL]danimatas,2221,149,5,8,13,38.5%,46m
34815,1,YogSothoth,2221,97,3,4,7,42.9%,52m
34815,3,Balatubzz,2221,134,3,7,10,30.0%,5m
34815,1,[EAbad]BetaSoyboy,2221,68,3,11,14,21.4%,4m
34815,1,NIHAOKAILAN,2221,42,2,4,6,33.3%,2h
34815,1,TouhouExpert,2221,124,2,6,8,25.0%,2h
34815,1,RAULITRO,2221,48,2,7,9,22.2%,1h
34815,1,Zero,2221,0,1,1,2,50.0%,31m
34815,2,Mecas,2221,0,1,2,3,33.3%,3h
34815,1,Tiberius,2221,90,1,2,3,33.3%,60m
34815,1,DontRushMe,2221,0,1,2,3,33.3%,18m
34815,2,YOSVAN,2221,0,1,6,7,14.3%,26m
34815,2,bobyfarts,2221,0,0,1,1,0.0%,22m
34832,3,[Gr33zy]Venshion,2220,862,88,89,177,49.7%,46m
34832,1,uchihasenpai,2220,932,44,32,76,57.9%,19m
34832,1,Sirante,2220,544,22,17,39,56.4%,2h
34832,1,Death,2220,549,21,22,43,48.8%,2h
34832,1,LeoSchilling,2220,133,16,11,27,59.3%,2h
34832,1,GLNoobHF,2220,333,14,11,25,56.0%,3h
34832,1,TheElder,2220,444,12,14,26,46.2%,2h
34832,1,iPotatoes,2220,121,4,5,9,44.4%,1h
34832,1,Luna,2220,82,4,7,11,36.4%,19m
34832,1,RikAxe,2220,0,2,4,6,33.3%,30m
34832,2,Jaitor,2220,0,2,6,8,25.0%,37m
34832,1,CLaYDoH,2220,0,1,0,1,100.0%,25m
34832,1,sqerela,2220,0,1,0,1,100.0%,1h
34832,1,Magic,2220,40,1,3,4,25.0%,3h
34846,1,ZombieNinja,2219,919,53,59,112,47.3%,1h
34846,1,OmnNoMBomB,2219,585,17,19,36,47.2%,3h
34846,1,Destructor,2219,601,16,22,38,42.1%,1h
34846,1,Treze,2219,360,13,13,26,50.0%,2h
34846,3,Antoni,2219,394,13,28,41,31.7%,38m
34846,1,SpiritFriend,2219,317,9,10,19,47.4%,3h
34846,1,Deadlykitten,2219,288,6,12,18,33.3%,56m
34846,1,Cthulu,2219,144,5,8,13,38.5%,41m
34846,1,IZZAK,2219,204,4,11,15,26.7%,3h
34846,2,[MexTab]Santiago,2219,48,3,2,5,60.0%,3h
34846,1,[TAW1]Subrat,2219,72,2,6,8,25.0%,2h
34846,1,MisterMoo,2219,0,1,0,1,100.0%,3h
34846,1,ButAidsNoPlz,2219,0,1,4,5,20.0%,53m
34846,2,XxBlxdezxX,2219,0,1,5,6,16.7%,31m
34846,1,Negamaku,2219,0,1,6,7,14.3%,2h
34846,1,Killstatic,2219,0,0,1,1,0.0%,3h
34846,1,ViruS,2219,0,0,1,1,0.0%,3h
34846,1,Norik,2219,0,0,2,2,0.0%,2h
34846,1,locojuhi,2219,0,0,3,3,0.0%,59m
34865,1,crazystone,2218,1539,160,168,328,48.8%,1h
34865,1,edcoochiecoo,2218,1203,80,72,152,52.6%,51m
34865,1,Eagle,2218,498,14,19,33,42.4%,13m
34865,1,[SxyMxN]Sants,2218,200,9,6,15,60.0%,29m
34865,1,Arkanok,2218,270,8,7,15,53.3%,41m
34865,1,[EDLSSA]ShoyuCube,2218,254,6,10,16,37.5%,53m
34865,1,wheel,2218,170,5,7,12,41.7%,3h
34865,3,sebas,2218,189,5,12,17,29.4%,7m
34865,1,[Epokhé]Samdoxx,2218,118,4,3,7,57.1%,20m
34865,1,GenteFina,2218,168,4,5,9,44.4%,5m
34865,1,[DUT1]diegox,2218,120,3,7,10,30.0%,44m
34865,1,cannydohen,2218,82,2,5,7,28.6%,1h
34865,1,[raike]IIIIIIIIIIII,2218,0,1,0,1,100.0%,9m
34865,1,[NM8]TwinCain,2218,0,1,1,2,50.0%,1h
34865,1,gladiator,2218,97,1,2,3,33.3%,9m
34865,3,[Vtta]NIEHLK,2218,30,1,2,3,33.3%,17m
34865,2,sad,2218,44,1,2,3,33.3%,59m
34865,1,Chiggs,2218,0,1,4,5,20.0%,32m
34865,1,RAWR,2218,0,0,1,1,0.0%,1h
34865,1,Belisarius,2218,0,0,5,5,0.0%,2h
34865,2,FlokY,2218,0,0,5,5,0.0%,48m
34886,1,shootakaydo,2217,418,32,15,47,68.1%,2h
34886,1,Who,2217,781,30,31,61,49.2%,2h
34886,1,ArgentiSol,2217,419,17,13,30,56.7%,2h
34886,1,starliberty,2217,230,12,8,20,60.0%,2h
34886,3,spade,2217,314,12,18,30,40.0%,55m
34886,1,Scaden,2217,186,7,4,11,63.6%,2h
34886,3,RonaldRaygun,2217,198,6,12,18,33.3%,2h
34886,1,Vio,2217,78,2,2,4,50.0%,2h
34886,1,[DhZAc1]NTnikc,2217,44,2,5,7,28.6%,56m
34886,1,KillerJPG,2217,34,1,2,3,33.3%,2h
34886,1,TsZAR,2217,0,0,1,1,0.0%,2h
34886,1,Jaek,2217,0,0,3,3,0.0%,29m
34898,3,[xlTWlx]GeneraalBigD,2216,1332,66,71,137,48.2%,47m
34898,1,TymaHHbIj,2216,210,9,17,26,34.6%,2h
34898,1,Zephyr,2216,231,7,3,10,70.0%,2h
34898,1,Sausage,2216,204,5,9,14,35.7%,2h
34898,1,joefission,2216,89,3,3,6,50.0%,2h
34898,1,TequilaSam,2216,48,2,3,5,40.0%,1h
34898,1,ZachChristie,2216,97,1,1,2,50.0%,26m
34898,1,maku,2216,97,1,3,4,25.0%,1h
34898,1,[RIDE]joker,2216,0,1,3,4,25.0%,2h
34898,1,RAFF,2216,48,1,4,5,20.0%,2h
34898,1,xombie,2216,0,1,5,6,16.7%,2h
34898,1,trickooo,2216,0,0,1,1,0.0%,2h
34910,1,[char14]RASTAPASTA,2215,198,6,4,10,60.0%,2h
34910,1,Dexsting,2215,159,5,4,9,55.6%,39m
34910,1,Hurricane,2215,48,2,2,4,50.0%,41m
34910,1,manh,2215,86,2,7,9,22.2%,2h
34910,1,BossHog,2215,48,2,7,9,22.2%,3h
34910,1,Snake,2215,0,0,1,1,0.0%,42m
34916,3,DOOMZDAY,2214,1624,297,288,585,50.8%,46m
34916,2,Sprinter,2214,1485,145,137,282,51.4%,10m
34916,3,[jugoso]THENAME,2214,1033,138,141,279,49.5%,55m
34916,1,[ZTempz]Lucien,2214,1264,49,57,106,46.2%,3h
34916,1,Xerdo,2214,986,33,28,61,54.1%,31m
34916,1,Mccheese,2214,634,30,19,49,61.2%,3h
34916,1,Lunaris,2214,514,27,33,60,45.0%,2h
34916,1,DiscountBurp,2214,339,11,19,30,36.7%,28m
34916,1,[llII]kaysik,2214,362,10,10,20,50.0%,30m
34916,1,[CobraC]Destro,2214,198,5,9,14,35.7%,2h
34916,3,[GrHoSq]darkorder,2214,143,4,2,6,66.7%,38m
34916,1,PFCoNaNPF,2214,88,2,0,2,100.0%,56m
34916,1,Ptosis,2214,40,2,1,3,66.7%,1h
34916,1,Corum,2214,0,1,0,1,100.0%,2h
34916,3,[RITSC]Intemperiae,2214,0,1,0,1,100.0%,51m
34916,1,[Mildly]Inebriated,2214,0,1,4,5,20.0%,5m
34916,1,SAGA,2214,0,1,6,7,14.3%,44m
34916,3,joseminchola,2214,0,1,11,12,8.3%,1h
34916,1,Jwalk,2214,0,0,1,1,0.0%,2h
34916,1,dragonofend,2214,0,0,1,1,0.0%,42m
34936,1,Crumbs,2213,1442,134,116,250,53.6%,3h
34936,2,Arche,2213,1421,81,86,167,48.5%,14m
34936,1,MacZyy,2213,931,58,55,113,51.3%,3h
34936,3,BobbyTrick,2213,299,11,14,25,44.0%,24m
34936,2,Mattio,2213,128,4,2,6,66.7%,2h
34936,1,[ZTemp]corealing,2213,161,4,8,12,33.3%,57m
34936,1,Scoopdiwoop,2213,106,3,1,4,75.0%,59m
34936,1,[Colomb]Fabrizio,2213,80,2,4,6,33.3%,3h
34936,2,[NoPlan]boxerboynine,2213,0,1,4,5,20.0%,2h
34936,1,GoofyGoober,2213,0,1,5,6,16.7%,1h
34936,1,Hopefulveil,2213,0,1,5,6,16.7%,23m
34936,1,AukinaUrden,2213,0,1,6,7,14.3%,19m
34936,1,yyy,2213,0,1,6,7,14.3%,60m
34936,1,PanTH,2213,0,0,3,3,0.0%,1h
34950,1,aNoNyMoUs,2212,407,16,8,24,66.7%,1h
34950,3,daddypalps,2212,367,14,14,28,50.0%,34m
34950,1,BlkMrRogers,2212,306,10,10,20,50.0%,14m
34950,1,xWarmHeartx,2212,366,10,12,22,45.5%,59m
34950,2,QuickNDirtY,2212,266,9,14,23,39.1%,3h
34950,1,ThunderWolf,2212,227,5,7,12,41.7%,2h
34950,2,[FQA]bomizu,2212,98,4,1,5,80.0%,43m
34950,2,REFICUL,2212,32,3,3,6,50.0%,40m
34950,2,[NSB01]Caprisun,2212,0,2,3,5,40.0%,1h
34950,1,[LPEP]Kainangot,2212,40,2,4,6,33.3%,3h
34950,2,Sarpedon,2212,0,1,0,1,100.0%,1h
34950,2,jollyrancher,2212,0,1,1,2,50.0%,2h
34950,1,purginspaget,2212,44,1,3,4,25.0%,2h
34963,2,Ontologist,2211,1555,79,76,155,51.0%,38m
34963,1,Tym,2211,942,47,49,96,49.0%,38m
34963,1,[CHUNCH]ItsBill,2211,1120,44,40,84,52.4%,2h
34963,1,RaNdU,2211,963,34,41,75,45.3%,2h
34963,3,[DXPCA]Chuleton,2211,717,24,30,54,44.4%,9m
34963,1,Ian,2211,451,16,15,31,51.6%,3h
34963,1,Glyko,2211,478,13,16,29,44.8%,2h
34963,1,Niceman,2211,516,13,20,33,39.4%,59m
34963,3,[LY0]TheCareCuy,2211,214,6,5,11,54.5%,19m
34963,2,DragIt,2211,124,5,13,18,27.8%,18m
34963,1,ThatOneGuy,2211,104,3,1,4,75.0%,2h
34963,1,Nish,2211,105,3,4,7,42.9%,1h
34963,2,[WWI]Drewpy,2211,0,2,3,5,40.0%,3h
34963,1,Groovyguy,2211,0,2,5,7,28.6%,2h
34963,1,NSampson,2211,42,1,3,4,25.0%,3h
34963,2,[Apink1]Apink,2211,0,0,1,1,0.0%,15m
34963,2,Falcon,2211,0,0,2,2,0.0%,1h
34980,3,[Wat3rs]Assassino,2210,1474,208,206,414,50.2%,14m
34980,1,ATLAS,2210,1012,54,59,113,47.8%,59m
34980,1,Zaro,2210,1213,47,43,90,52.2%,31m
34980,3,[ZTemps]MystixW,2210,455,21,23,44,47.7%,1h
34980,1,UNREAL,2210,384,12,12,24,50.0%,53m
34980,3,CASHFLOW,2210,317,12,16,28,42.9%,6m
34980,1,Donut,2210,316,9,11,20,45.0%,3h
34980,2,Lavan,2210,166,6,4,10,60.0%,14m
34980,1,Sinder,2210,149,4,10,14,28.6%,44m
34980,1,Jethreetwo,2210,0,3,3,6,50.0%,43m
34980,3,swarmx,2210,38,3,8,11,27.3%,24m
34980,2,Diao,2210,30,3,9,12,25.0%,42m
34980,1,HeavensCloud,2210,90,2,1,3,66.7%,3h
34980,1,[DeCan]DeRedTigeris,2210,96,2,3,5,40.0%,2h
34980,1,eltikastik,2210,42,2,4,6,33.3%,59m
34980,2,Spaceman,2210,0,1,0,1,100.0%,21m
34980,2,acesepher,2210,48,1,5,6,16.7%,1h
34980,3,logyko,2210,0,1,6,7,14.3%,15m
34998,1,queenSOFIA,2209,1575,88,108,196,44.9%,44m
34998,1,Sinaps,2209,844,40,27,67,59.7%,21m
34998,1,DonEzzy,2209,824,38,30,68,55.9%,44m
34998,1,Venom,2209,494,15,15,30,50.0%,3h
34998,3,Given,2209,420,15,16,31,48.4%,28m
34998,1,Sparkzey,2209,292,10,12,22,45.5%,41m
34998,1,Dankino,2209,184,5,9,14,35.7%,44m
34998,3,[TH0T5]Greenkid,2209,58,4,9,13,30.8%,28m
34998,3,Alucard,2209,60,3,8,11,27.3%,12m
34998,2,AlEltz,2209,0,1,0,1,100.0%,2h
34998,2,KayserSoze,2209,0,1,0,1,100.0%,31m
34998,2,Telemachus,2209,32,1,1,2,50.0%,3h
34998,1,[JackMe]noitanimi,2209,42,1,3,4,25.0%,3h
34998,1,Fatman,2209,0,1,5,6,16.7%,2h
35012,1,airbhong,2208,1369,243,261,504,48.2%,5m
35012,1,grim,2208,377,16,17,33,48.5%,59m
35012,3,Hooligan,2208,241,9,8,17,52.9%,1h
35012,1,kevin,2208,284,9,12,21,42.9%,3h
35012,3,Taylord,2208,280,9,14,23,39.1%,15m
35012,3,SrChan,2208,216,8,15,23,34.8%,49m
35012,1,XENOACOLYTE,2208,96,2,4,6,33.3%,1h
35012,1,win,2208,48,2,5,7,28.6%,26m
35012,1,DarkLord,2208,0,0,1,1,0.0%,2h
35021,1,perezamar,2207,1614,197,206,403,48.9%,29m
35021,1,Joe,2207,1096,45,41,86,52.3%,1h
35021,3,Definitely,2207,392,13,21,34,38.2%,2h
35021,1,DaMilfhunta,2207,254,7,10,17,41.2%,33m
35021,2,[xrikox]IIIIIIIIIIII,2207,81,4,0,4,100.0%,17m
35021,1,[M1A5]War,2207,171,3,8,11,27.3%,3h
35021,1,turdface,2207,90,2,2,4,50.0%,31m
35021,1,AleUwU,2207,97,2,5,7,28.6%,33m
35021,3,XxKuantixX,2207,0,2,8,10,20.0%,19m
35021,1,[KGH4]Faxanadude,2207,93,1,2,3,33.3%,3h
35021,2,brad,2207,0,1,4,5,20.0%,59m
35021,2,DEREC,2207,0,0,1,1,0.0%,2h
35021,3,Kaiizen,2207,0,0,5,5,0.0%,51m
35034,1,HastyEnt,2206,737,47,51,98,48.0%,3h
35034,1,gerar,2206,1104,42,38,80,52.5%,2h
35034,3,LGgaming,2206,706,40,50,90,44.4%,2h
35034,2,SeanFox,2206,631,25,34,59,42.4%,50m
35034,1,[raaa]pucho,2206,607,19,16,35,54.3%,4m
35034,1,Redking,2206,539,17,22,39,43.6%,1h
35034,1,Forkbomb,2206,107,12,17,29,41.4%,1h
35034,1,[CoopVN]akabavuong,2206,354,10,18,28,35.7%,26m
35034,2,SteroiD,2206,210,7,5,12,58.3%,1h
35034,2,WildThang,2206,128,7,14,21,33.3%,3h
35034,1,DoomTune,2206,84,3,7,10,30.0%,1h
35034,3,HegelsGhost,2206,30,2,2,4,50.0%,1h
35034,1,Diegol,2206,73,1,2,3,33.3%,38m
35034,2,[PL347]QuBuS,2206,30,1,5,6,16.7%,2h
35034,1,[xLgNx]skullyboii,2206,0,0,1,1,0.0%,38m
35034,1,[sk3tch]scribbles,2206,0,0,3,3,0.0%,14m
35034,1,GLaDOS,2206,0,0,3,3,0.0%,3h
35051,3,CSARIN,2205,483,22,29,51,43.1%,9m
35051,1,Pookie,2205,647,21,29,50,42.0%,44m
35051,3,CptSacTap,2205,533,19,26,45,42.2%,56m
35051,1,JaVa,2205,266,9,10,19,47.4%,39m
35051,2,[BFCLUV]SteveFmAccnt,2205,210,7,3,10,70.0%,2h
35051,1,TukiTukiLuLu,2205,159,4,4,8,50.0%,1h
35051,3,aleMillo,2205,97,2,1,3,66.7%,18m
35051,2,OwlGifter,2205,46,2,4,6,33.3%,10m
35051,1,openset,2205,0,1,2,3,33.3%,28m
35051,2,gustavo,2205,0,1,3,4,25.0%,2h
35051,1,TheRevenant,2205,73,0,4,4,0.0%,3h
35062,2,Veterano,2204,1068,41,35,76,53.9%,1h
35062,1,makoy,2204,1107,39,38,77,50.6%,44m
35062,2,ETdeVarginha,2204,1047,39,50,89,43.8%,25m
35062,1,Vystyk,2204,735,24,26,50,48.0%,33m
35062,3,Chief,2204,376,21,25,46,45.7%,50m
35062,1,Dvorak,2204,431,14,13,27,51.9%,46m
35062,1,[Hmgous]SrPiky,2204,406,12,17,29,41.4%,2h
35062,1,prometeo,2204,182,4,4,8,50.0%,46m
35062,1,Lunnaticcos,2204,139,4,7,11,36.4%,3h
35062,3,ZaGaRa,2204,30,4,7,11,36.4%,2h
35062,1,MitakoXx,2204,120,2,9,11,18.2%,1h
35062,1,notorouis,2204,88,2,10,12,16.7%,32m
35062,1,GlizzyGobler,2204,38,1,2,3,33.3%,3h
35062,1,[DarkAZ]Jtags,2204,0,1,5,6,16.7%,1h
35062,2,Sung,2204,46,1,5,6,16.7%,50m
35077,1,[GxP]MinDControL,2203,469,13,22,35,37.1%,3h
35077,1,fascist,2203,401,11,11,22,50.0%,58m
35077,1,Fernando,2203,72,3,4,7,42.9%,2h
35077,2,Royaltomato,2203,0,2,2,4,50.0%,14m
35077,2,BluddFlagg,2203,0,2,4,6,33.3%,17m
35077,1,[FORCE9]MARINER,2203,147,2,8,10,20.0%,2h
35077,2,JoeBiden,2203,0,1,0,1,100.0%,1h
35077,1,TheArtist,2203,97,1,1,2,50.0%,2h
35077,1,Akhundelar,2203,0,1,2,3,33.3%,1h
35077,1,SoulReviver,2203,0,1,5,6,16.7%,3h
35077,2,bonal,2203,0,0,1,1,0.0%,7m
35088,3,Yumpa,2202,1444,172,175,347,49.6%,1h
35088,1,Ckai,2202,696,53,60,113,46.9%,31m
35088,1,JerryJones,2202,890,26,35,61,42.6%,3h
35088,1,Ramírez,2202,390,12,19,31,38.7%,60m
35088,1,[M1D]Relevant,2202,390,10,21,31,32.3%,2h
35088,1,kong,2202,314,8,8,16,50.0%,3h
35088,3,PoCoYo,2202,154,7,6,13,53.8%,51m
35088,2,MastrMind,2202,152,5,8,13,38.5%,55m
35088,1,Okaycontinue,2202,160,5,10,15,33.3%,2h
35088,2,Colin,2202,46,3,2,5,60.0%,50m
35088,2,[Riggs]Aleks,2202,171,3,9,12,25.0%,2h
35088,1,lileiva,2202,143,2,2,4,50.0%,23m
35088,1,RooWattsBalí,2202,40,1,3,4,25.0%,23m
35088,2,Breau,2202,0,0,1,1,0.0%,15m
35088,1,MrFiZZLe,2202,0,0,2,2,0.0%,1h
35103,2,easypeasy,2201,676,57,76,133,42.9%,1h
35103,1,Kthulhu,2201,1063,48,42,90,53.3%,1h
35103,2,Alt,2201,586,21,20,41,51.2%,3h
35103,1,Sanabria,2201,513,17,23,40,42.5%,3h
35103,2,Crimith,2201,102,4,1,5,80.0%,3h
35103,1,[TriFP]VicThor,2201,42,2,2,4,50.0%,4m
35103,1,Assimilator,2201,0,1,1,2,50.0%,23m
35103,1,HarthBringer,2201,97,1,2,3,33.3%,1h
35103,2,WreckCenter,2201,0,1,4,5,20.0%,11m
35103,3,BernieSander,2201,0,1,7,8,12.5%,54m
35103,2,SneakyTurtle,2201,0,0,1,1,0.0%,21m
35103,1,DinoDome,2201,0,0,3,3,0.0%,33m
35103,1,Ashtec,2201,0,0,3,3,0.0%,59m
35103,1,RedZ,2201,0,0,4,4,0.0%,1h
35117,2,Danny,2200,1006,39,33,72,54.2%,30m
35117,2,VariusFace,2200,662,30,16,46,65.2%,2h
35117,1,zachvac,2200,668,19,22,41,46.3%,3h
35117,1,angeliris,2200,329,9,9,18,50.0%,58m
35117,1,Heny,2200,214,8,11,19,42.1%,6m
35117,1,ZoeticSoul,2200,230,5,8,13,38.5%,1h
35117,1,Kaiquejf,2200,238,5,8,13,38.5%,42m
35117,1,uncleDumDum,2200,194,5,10,15,33.3%,3h
35117,1,Caelosum,2200,145,3,8,11,27.3%,2h
35117,2,zxuGx,2200,119,3,11,14,21.4%,22m
35117,3,Scratt,2200,0,2,4,6,33.3%,58m
35117,3,TheSaltLord,2200,0,2,6,8,25.0%,38m
35117,1,PuzzyLickn,2200,84,2,8,10,20.0%,2h
35117,2,Desdecardo,2200,34,2,9,11,18.2%,5m
35117,2,TheTirstan,2200,88,1,1,2,50.0%,13m
35117,2,FrostyTurtle,2200,0,0,1,1,0.0%,2h
35133,1,TheStriker,2199,876,32,33,65,49.2%,3h
35133,1,mija,2199,669,29,19,48,60.4%,24m
35133,1,wolfcan,2199,354,26,22,48,54.2%,2h
35133,1,George,2199,480,13,16,29,44.8%,59m
35133,1,Fallen,2199,350,13,17,30,43.3%,2h
35133,3,Joerjavi,2199,287,9,6,15,60.0%,5m
35133,2,MermElhada,2199,96,3,2,5,60.0%,3h
35133,1,Satin,2199,127,3,2,5,60.0%,33m
35133,1,napleon,2199,40,2,4,6,33.3%,1h
35133,1,Monkapotamus,2199,88,2,6,8,25.0%,56m
35133,1,Rebor,2199,86,2,7,9,22.2%,1h
35133,1,KaKaY,2199,0,2,8,10,20.0%,3h
35133,2,jennie,2199,0,1,0,1,100.0%,10m
35133,3,[HeLiuM]Creefter,2199,0,1,1,2,50.0%,7m
35133,2,ImSingle,2199,32,1,1,2,50.0%,22m
35133,1,Soundsplosin,2199,0,0,4,4,0.0%,46m
35149,1,Naaarf,2198,1793,268,272,540,49.6%,3h
35149,3,Antinomy,2198,812,79,164,243,32.5%,36m
35149,2,katuki,2198,1337,49,47,96,51.0%,56m
35149,1,Candyman,2198,443,39,34,73,53.4%,29m
35149,1,Wild,2198,662,23,26,49,46.9%,3h
35149,1,MikeTyson,2198,700,21,28,49,42.9%,2h
35149,1,Hon,2198,462,15,18,33,45.5%,9m
35149,1,enzo,2198,448,14,18,32,43.8%,1h
35149,3,Koruptings,2198,334,13,15,28,46.4%,48m
35149,2,MrSuck,2198,258,11,19,30,36.7%,26m
35149,2,Mrlurker,2198,258,9,6,15,60.0%,54m
35149,1,mochitaJP,2198,231,7,6,13,53.8%,2h
35149,2,Marshadrin,2198,180,6,7,13,46.2%,19m
35149,1,[C0VID]Hossini,2198,192,5,10,15,33.3%,3h
35149,1,[Tert69]Neuron,2198,196,4,5,9,44.4%,23m
35149,1,UncleSot,2198,0,1,7,8,12.5%,3h
35149,1,Hearnoevil,2198,0,0,4,4,0.0%,14m
35166,1,roger,2197,1477,241,251,492,49.0%,40m
35166,1,[VFam2]GeneralTazz,2197,849,32,33,65,49.2%,3h
35166,1,ImHere,2197,406,13,19,32,40.6%,23m
35166,1,Milk,2197,379,13,24,37,35.1%,45m
35166,1,caracas,2197,432,12,20,32,37.5%,42m
35166,1,Tehuti,2197,220,10,8,18,55.6%,2h
35166,2,Centurion,2197,148,7,14,21,33.3%,1h
35166,2,[d0ngZi]chaosjon,2197,30,4,8,12,33.3%,25m
35166,2,zerlan,2197,0,1,0,1,100.0%,1h
35166,1,Coumadin,2197,0,1,2,3,33.3%,39m
35166,2,PerroGelido,2197,32,1,2,3,33.3%,4m
35166,2,MadVolf,2197,0,0,1,1,0.0%,1h
35178,1,TomCharly,2196,1584,54,66,120,45.0%,3h
35178,1,FakeCaptain,2196,663,30,23,53,56.6%,25m
35178,1,Montecristo,2196,491,19,14,33,57.6%,3h
35178,1,[NYMZ]IwAsAki,2196,127,8,3,11,72.7%,2h
35178,1,stams,2196,253,7,7,14,50.0%,46m
35178,1,[DRKDMN]Sequetela,2196,122,5,4,9,55.6%,33m
35178,1,ForTheHorde,2196,88,2,1,3,66.7%,3h
35178,2,Hiashi,2196,0,2,3,5,40.0%,2h
35178,2,Ginonino,2196,0,1,0,1,100.0%,43m
35178,1,Chuck,2196,90,1,2,3,33.3%,31m
35178,1,[Glizzy]JnautJake,2196,34,1,4,5,20.0%,32m
35178,2,AromaticOoze,2196,48,1,5,6,16.7%,3h
35178,1,DissyQc,2196,0,1,6,7,14.3%,2h
35191,2,[Shad0w]TRACYDEAN,2195,1554,324,342,666,48.6%,2h
35191,1,joery,2195,845,37,28,65,56.9%,2h
35191,2,Zentrix,2195,107,27,32,59,45.8%,28m
35191,1,MPHamilton,2195,235,21,21,42,50.0%,54m
35191,1,spiritx,2195,229,9,10,19,47.4%,26m
35191,1,breistar,2195,96,4,9,13,30.8%,3h
35191,1,Snakob,2195,96,2,2,4,50.0%,3h
35191,2,Yuri,2195,0,2,3,5,40.0%,21m
35191,2,thegankster,2195,0,0,1,1,0.0%,1h
35191,2,Ravs,2195,0,0,1,1,0.0%,3h
35191,1,Nocalex,2195,0,0,2,2,0.0%,3h
35202,1,VenusDeMilo,2194,1058,44,50,94,46.8%,3h
35202,2,Tovarisch,2194,206,8,0,8,100.0%,3h
35202,2,Naesid,2194,202,6,7,13,46.2%,37m
35202,1,[NoVa3]NoVa,2194,133,5,1,6,83.3%,31m
35202,3,Lucho,2194,96,5,12,17,29.4%,47m
35202,1,KiritoGames,2194,153,4,3,7,57.1%,2h
35202,2,Arrilious,2194,94,4,4,8,50.0%,53m
35202,3,Kravitz,2194,171,4,4,8,50.0%,1h
35202,1,PARKER,2194,118,4,7,11,36.4%,5m
35202,1,barto,2194,149,3,4,7,42.9%,3h
35202,2,DuneRunner,2194,119,3,5,8,37.5%,2h
35202,3,[sLuxx]Mrgoodcat,2194,96,2,7,9,22.2%,56m
35202,1,Crypthammer,2194,48,2,8,10,20.0%,14m
35202,2,Destroid,2194,0,1,0,1,100.0%,7m
35202,2,Stick,2194,0,0,1,1,0.0%,51m
35202,2,RSINIK,2194,0,0,1,1,0.0%,3h
35202,3,[TCFE]poolman,2194,0,0,2,2,0.0%,31m
35219,1,Horu,2193,1180,111,121,232,47.8%,1h
35219,3,elephantBug,2193,1517,67,73,140,47.9%,15m
35219,1,Cfster,2193,1701,65,71,136,47.8%,3h
35219,1,General,2193,670,22,22,44,50.0%,41m
35219,3,Jmd,2193,473,16,22,38,42.1%,39m
35219,1,Pele,2193,448,13,20,33,39.4%,1h
35219,1,amenodorime,2193,399,12,12,24,50.0%,2h
35219,1,BlueSea,2193,137,7,18,25,28.0%,2h
35219,2,WhitePhantom,2193,96,4,4,8,50.0%,2h
35219,1,Matt,2193,166,4,15,19,21.1%,1h
35219,1,Yoda,2193,90,3,4,7,42.9%,3h
35219,2,Cremedawg,2193,90,3,4,7,42.9%,57m
35219,1,aerknard,2193,96,2,1,3,66.7%,18m
35219,1,Yogg,2193,0,2,6,8,25.0%,52m
35219,2,[Lasur]Ovryk,2193,0,1,0,1,100.0%,22m
35219,2,JokingForYou,2193,0,1,0,1,100.0%,38m
35219,2,AlmaDeDragon,2193,0,1,0,1,100.0%,3h
35219,1,CamoKeeper,2193,0,1,5,6,16.7%,3h
35219,1,Mis,2193,97,1,6,7,14.3%,3h
35219,2,[JaMiT]Voskof,2193,0,0,1,1,0.0%,2h
35219,2,Kazeshini,2193,0,0,2,2,0.0%,8m
35219,2,AlSiqueira,2193,0,0,2,2,0.0%,2h
35219,3,BofoKun,2193,0,0,3,3,0.0%,21m
35242,1,dlo,2192,1477,52,52,104,50.0%,1h
35242,1,[E10G]Bannanfage,2192,666,24,26,50,48.0%,51m
35242,1,sonar,2192,466,20,16,36,55.6%,3h
35242,1,TheRealMcCoy,2192,526,16,23,39,41.0%,29m
35242,1,Rodryx,2192,449,14,18,32,43.8%,3h
35242,3,Hugeguy,2192,312,13,23,36,36.1%,6m
35242,2,[Ayynus]Lebeauner,2192,348,12,27,39,30.8%,10m
35242,1,ZAMBRANOCTMR,2192,192,5,10,15,33.3%,3h
35242,2,Speedy,2192,128,4,12,16,25.0%,22m
35242,1,Neraxis,2192,151,3,8,11,27.3%,2h
35242,2,ELeader,2192,148,3,13,16,18.8%,46m
35242,2,blea,2192,0,1,0,1,100.0%,24m
35242,1,Mikaldx,2192,0,1,2,3,33.3%,42m
35242,1,[qWTFp]Krinque,2192,0,1,3,4,25.0%,58m
35242,1,NinjaStatten,2192,0,1,6,7,14.3%,3h
35242,2,GUB,2192,0,0,1,1,0.0%,2h
35242,2,kalimba,2192,0,0,1,1,0.0%,8m
35242,1,NoMad,2192,0,0,2,2,0.0%,3h
35260,2,WarLard,2191,1530,146,160,306,47.7%,2h
35260,1,SaintSteele,2191,442,23,17,40,57.5%,2h
35260,2,Haudriel,2191,462,16,13,29,55.2%,55m
35260,3,howrutoday,2191,348,14,22,36,38.9%,48m
35260,1,Aneustart,2191,253,8,7,15,53.3%,2h
35260,2,Monsoon,2191,32,3,3,6,50.0%,2h
35260,1,deapoolx,2191,120,3,9,12,25.0%,4m
35260,2,[VTV]Kraepelin,2191,122,2,4,6,33.3%,1h
35260,2,nottheliving,2191,0,1,1,2,50.0%,2h
35260,3,AlexGrady,2191,30,1,1,2,50.0%,2h
35260,1,Agro,2191,0,1,2,3,33.3%,2h
35260,1,KxChrck,2191,0,1,3,4,25.0%,3h
35260,1,Ziglar,2191,0,0,2,2,0.0%,1h
35273,1,Spacelord,2190,1697,119,112,231,51.5%,2h
35273,1,Ajax,2190,825,64,65,129,49.6%,14m
35273,1,[HVHI]STVR,2190,1311,44,48,92,47.8%,1h
35273,3,[UxL]Flash,2190,956,33,41,74,44.6%,11m
35273,1,Synyster,2190,778,23,27,50,46.0%,56m
35273,1,[uchi]RushThanos,2190,670,23,29,52,44.2%,2h
35273,1,MoonSaint,2190,491,17,18,35,48.6%,33m
35273,1,bumberbelly,2190,470,15,23,38,39.5%,26m
35273,3,[bergh]Raven,2190,0,5,4,9,55.6%,3h
35273,1,reyalsreggin,2190,154,5,10,15,33.3%,1h
35273,2,Diessel,2190,120,3,7,10,30.0%,4m
35273,1,hotsaki,2190,146,3,7,10,30.0%,2h
35273,3,Arnold,2190,0,2,5,7,28.6%,47m
35273,2,[MadMON]MELEKAIJOE,2190,0,1,0,1,100.0%,17m
35273,2,SrGatuso,2190,0,0,2,2,0.0%,3h
35273,1,Sonlir,2190,0,0,3,3,0.0%,2h
35273,1,[cluez]merchman,2190,0,0,4,4,0.0%,44m
35273,1,Ratmil,2190,0,0,4,4,0.0%,3h
35291,1,[Apathy]Islandman,2189,1788,619,644,1263,49.0%,3h
35291,2,AUNIM,2189,1500,212,208,420,50.5%,3h
35291,1,WildApache,2189,588,50,55,105,47.6%,2h
35291,1,shadowstorm,2189,897,43,30,73,58.9%,14m
35291,1,Ronin,2189,844,26,28,54,48.1%,1h
35291,2,FDfall,2189,400,15,10,25,60.0%,30m
35291,1,MedmanX,2189,395,13,11,24,54.2%,32m
35291,2,Subsonic,2189,152,6,7,13,46.2%,13m
35291,1,Arkyom,2189,241,6,9,15,40.0%,3h
35291,2,Maverick,2189,164,4,5,9,44.4%,2h
35291,3,fudzilla,2189,30,4,5,9,44.4%,54m
35291,1,[SPQ]CrisstobalZX,2189,113,4,5,9,44.4%,44m
35291,1,MicroVillain,2189,116,4,8,12,33.3%,3h
35291,2,[Wizzy]Mongoose,2189,0,2,3,5,40.0%,3h
35291,2,TearBear,2189,46,2,5,7,28.6%,31m
35291,3,Zaylin,2189,0,2,6,8,25.0%,2h
35291,2,PEGUACHY,2189,0,1,4,5,20.0%,2h
35291,1,DukeAndy,2189,0,1,5,6,16.7%,3h
35291,2,Hsamp,2189,0,0,1,1,0.0%,60m
35310,1,CatEmoji,2188,1567,97,96,193,50.3%,58m
35310,2,BigBOOtyMEAT,2188,639,28,11,39,71.8%,1h
35310,3,mooze,2188,537,20,25,45,44.4%,3h
35310,1,[TGOOD]Serral,2188,694,20,28,48,41.7%,3h
35310,3,Sorthe,2188,241,9,9,18,50.0%,2h
35310,1,[NukeZ]Insentum,2188,178,5,7,12,41.7%,45m
35310,2,Vancharekke,2188,46,5,8,13,38.5%,3h
35310,1,doggood,2188,179,5,10,15,33.3%,22m
35310,2,leogamer,2188,84,3,2,5,60.0%,46m
35310,1,depredador,2188,0,1,3,4,25.0%,2h
35310,1,chicharrito,2188,48,1,4,5,20.0%,1h
35310,2,Dago,2188,0,1,4,5,20.0%,19m
35310,1,[MXICAN]ItzyJatzy,2188,0,1,6,7,14.3%,2h
35310,3,JuneBug,2188,0,0,1,1,0.0%,1h
35324,1,Efdron,2187,1234,41,48,89,46.1%,3h
35324,1,TeadyBear,2187,575,21,18,39,53.8%,3h
35324,1,Schnitzel,2187,198,11,17,28,39.3%,1h
35324,2,Bingles,2187,348,11,31,42,26.2%,41m
35324,1,Rumbo,2187,265,9,17,26,34.6%,3h
35324,3,ctiulhu,2187,247,7,8,15,46.7%,8m
35324,3,Hored,2187,157,5,9,14,35.7%,2h
35324,2,Sanchis,2187,36,2,0,2,100.0%,1h
35324,2,Rugbydude,2187,0,2,2,4,50.0%,2h
35324,2,kiMAREa,2187,95,2,2,4,50.0%,19m
35324,2,[GCCLAN]ItsFrankYz,2187,0,1,0,1,100.0%,3h
35324,2,DonCDXX,2187,0,0,1,1,0.0%,55m
35324,2,Boomheadshot,2187,0,0,3,3,0.0%,8m
35337,1,DarkHunter,2186,1399,66,65,131,50.4%,28m
35337,1,MathFerret,2186,1419,55,51,106,51.9%,1h
35337,2,Kudzu,2186,964,35,31,66,53.0%,38m
35337,1,RedCliffe,2186,449,18,17,35,51.4%,3h
35337,1,diegoelcrack,2186,302,12,9,21,57.1%,3h
35337,1,Chilakiller,2186,368,11,10,21,52.4%,59m
35337,2,RMSEA,2186,225,9,8,17,52.9%,30m
35337,2,Help,2186,226,6,1,7,85.7%,41m
35337,2,GaeL,2186,188,6,7,13,46.2%,3h
35337,2,[Topos]Frijolito,2186,0,4,6,10,40.0%,3h
35337,1,eltunche,2186,156,4,7,11,36.4%,1h
35337,1,Stabathor,2186,158,3,10,13,23.1%,2h
35337,2,Fies,2186,0,1,1,2,50.0%,1h
35337,1,RODRIG,2186,0,1,6,7,14.3%,1h
35337,1,Hypershadow,2186,0,1,6,7,14.3%,2h
35337,1,JRCoyote,2186,0,0,13,13,0.0%,10m
35353,2,Chungus,2185,950,38,30,68,55.9%,3h
35353,1,Shlongo,2185,692,28,24,52,53.8%,29m
35353,1,gingerAl,2185,656,24,18,42,57.1%,25m
35353,2,twopancakes,2185,396,24,25,49,49.0%,54m
35353,1,ZOCALEBZRG,2185,646,24,25,49,49.0%,17m
35353,3,MartiReyes,2185,593,21,29,50,42.0%,1h
35353,2,[waRp1]Octopuskeepe,2185,248,11,14,25,44.0%,3h
35353,2,EmmayVe,2185,244,9,5,14,64.3%,2h
35353,2,aladepollo,2185,168,5,2,7,71.4%,10m
35353,3,BloodNight,2185,60,4,15,19,21.1%,19m
35353,2,DTMaster,2185,68,3,1,4,75.0%,57m
35353,2,oXEJECUTORXo,2185,70,2,2,4,50.0%,41m
35353,3,[RAX14]XxReimsSC,2185,125,2,4,6,33.3%,2h
35353,2,red,2185,48,1,2,3,33.3%,2h
35353,2,DoJo,2185,0,0,2,2,0.0%,2h
35368,3,lazygamer,2184,1438,102,116,218,46.8%,2h
35368,1,[NCC20]Modulo,2184,768,49,45,94,52.1%,1h
35368,1,Santos,2184,852,41,46,87,47.1%,17m
35368,2,Bean,2184,504,36,30,66,54.5%,2h
35368,1,[9thAve]cheese,2184,899,30,33,63,47.6%,3h
35368,2,ZpClick,2184,290,10,8,18,55.6%,1h
35368,2,Trump,2184,197,6,5,11,54.5%,51m
35368,2,Zergologist,2184,120,4,2,6,66.7%,3h
35368,1,ilikeladies,2184,116,4,5,9,44.4%,1h
35368,3,Rickheeeghs,2184,90,4,9,13,30.8%,27m
35368,1,[AbcCo]alpaco,2184,144,3,7,10,30.0%,12m
35368,1,Atrro,2184,108,2,4,6,33.3%,2h
35368,1,[TDMT]TotoX,2184,103,2,6,8,25.0%,23m
35368,1,[LPG2]santiago,2184,44,2,7,9,22.2%,6m
35368,2,JRod,2184,88,1,2,3,33.3%,2h
35368,1,ShuckMaster,2184,0,1,5,6,16.7%,3h
35368,1,BlackIce,2184,0,1,5,6,16.7%,41m
35368,1,kreestoff,2184,0,1,6,7,14.3%,52m
35368,2,tjitji,2184,0,0,1,1,0.0%,1h
35368,1,Adderall,2184,0,0,3,3,0.0%,14m
35368,1,celinaaarem,2184,0,0,8,8,0.0%,32m
35389,3,[CLRTBS]Acerth,2183,1197,89,92,181,49.2%,1h
35389,1,[Ex7rA]YKS,2183,714,24,25,49,49.0%,1h
35389,1,[LMI42]Hoehammer,2183,156,4,12,16,25.0%,44m
35389,1,Kiddfragger,2183,91,3,5,8,37.5%,2h
35389,2,OzzyValkyriE,2183,34,2,0,2,100.0%,1h
35389,2,SilentOwl,2183,0,2,4,6,33.3%,2h
35389,1,Tuena,2183,0,1,1,2,50.0%,2h
35389,2,improv,2183,0,0,1,1,0.0%,52m
35397,2,DimethlyTrip,2182,1645,102,88,190,53.7%,14m
35397,1,moot,2182,671,25,25,50,50.0%,54m
35397,1,gunty,2182,537,22,22,44,50.0%,2h
35397,2,EllenRipley,2182,314,11,10,21,52.4%,11m
35397,1,Terran,2182,284,9,17,26,34.6%,3h
35397,3,rush,2182,216,8,14,22,36.4%,21m
35397,1,StVibrator,2182,208,8,17,25,32.0%,2h
35397,3,Erimmyu,2182,236,7,13,20,35.0%,59m
35397,1,superman,2182,42,4,5,9,44.4%,35m
35397,1,[PY]DarkMatu,2182,48,2,6,8,25.0%,38m
35397,2,[dengue]cthulhu,2182,0,1,0,1,100.0%,48m
35397,1,ZTARCRAFT,2182,26,1,6,7,14.3%,58m
35409,1,DarcStar,2181,1268,38,51,89,42.7%,53m
35409,1,Destructor,2181,594,19,18,37,51.4%,58m
35409,2,Peppone,2181,258,11,4,15,73.3%,43m
35409,2,onikage,2181,285,9,16,25,36.0%,18m
35409,1,SwagDuck,2181,201,6,7,13,46.2%,57m
35409,2,damianhommie,2181,186,6,8,14,42.9%,13m
35409,2,[UpxV]Reeaper,2181,122,5,4,9,55.6%,19m
35409,1,enkidu,2181,183,5,9,14,35.7%,17m
35409,2,kksjfkl,2181,116,3,6,9,33.3%,30m
35409,1,LickMcStick,2181,38,2,7,9,22.2%,3h
35409,1,Zord,2181,0,1,2,3,33.3%,8m
35409,1,Leonard,2181,0,1,6,7,14.3%,3h
35409,2,Risuvirus,2181,73,0,2,2,0.0%,2h
35409,1,madafaka,2181,0,0,4,4,0.0%,26m
35409,2,Psycho,2181,0,0,5,5,0.0%,1h
35424,1,Juice,2180,1750,211,250,461,45.8%,3h
35424,3,TIGERDAVID,2180,1465,118,118,236,50.0%,25m
35424,2,[Macbre]Virtue,2180,596,20,24,44,45.5%,3h
35424,1,[pandax]peluchin,2180,640,19,21,40,47.5%,2h
35424,1,Iamtheman,2180,270,10,8,18,55.6%,2h
35424,2,[pobhla]Ironkong,2180,208,8,3,11,72.7%,3h
35424,2,Monsta,2180,130,7,3,10,70.0%,15m
35424,3,[TM1S]IfPower,2180,166,7,11,18,38.9%,10m
35424,1,Ivan,2180,249,6,11,17,35.3%,56m
35424,1,[HE7I]Maverick,2180,86,3,8,11,27.3%,2h
35424,1,[4332]ghost,2180,40,2,2,4,50.0%,3h
35424,2,leoonell,2180,62,2,3,5,40.0%,2h
35424,1,steelydan,2180,0,2,5,7,28.6%,2h
35424,2,Jarclock,2180,0,1,0,1,100.0%,3h
35424,1,[xGGTx]llllllllllll,2180,0,1,6,7,14.3%,2h
35439,1,QUINOAAIR,2179,1775,171,166,337,50.7%,3h
35439,1,[tPROt]Salieri,2179,1347,83,78,161,51.6%,59m
35439,2,Foxy,2179,974,62,44,106,58.5%,2h
35439,1,VDPtas,2179,448,14,19,33,42.4%,46m
35439,2,[AbcCo]Washovietic,2179,380,12,7,19,63.2%,1h
35439,3,KINGJO,2179,296,12,16,28,42.9%,55m
35439,3,Ulfrid,2179,58,3,9,12,25.0%,3h
35439,2,RABS,2179,30,2,2,4,50.0%,3h
35439,2,mcgaming,2179,0,1,0,1,100.0%,15m
35439,2,Nashor,2179,46,1,1,2,50.0%,2h
35439,2,OldSovietDog,2179,0,1,4,5,20.0%,3h
35439,2,[DBZ]PatriBatman,2179,0,1,5,6,16.7%,22m
35439,1,[WAGWAN]NYAAEHHH,2179,0,1,5,6,16.7%,5m
35439,2,Crilanselo,2179,95,1,5,6,16.7%,2h
35439,1,martruta,2179,0,1,6,7,14.3%,1h
35439,3,PureSlab,2179,0,0,1,1,0.0%,26m
35439,3,Koroshi,2179,0,0,31,31,0.0%,40m
35456,1,Iván,2178,1676,60,63,123,48.8%,8m
35456,2,Dolothion,2178,863,41,42,83,49.4%,37m
35456,1,DMPatod,2178,714,28,24,52,53.8%,1h
35456,1,poodragon,2178,314,10,13,23,43.5%,1h
35456,2,MisticGame,2178,163,3,9,12,25.0%,2h
35456,2,IIIIIIII,2178,36,2,1,3,66.7%,3h
35456,3,thecatdragon,2178,73,1,5,6,16.7%,52m
35456,3,Griz,2178,0,0,6,6,0.0%,41m
35456,1,[GINW]LoganTheValk,2178,0,0,6,6,0.0%,41m
35456,2,WizerKilhelm,2178,0,0,6,6,0.0%,2h
35466,3,SkUnCh,2177,434,65,75,140,46.4%,11m
35466,1,TLOislife,2177,1431,48,56,104,46.2%,4m
35466,1,Vitojuice,2177,903,30,32,62,48.4%,17m
35466,2,rucope,2177,528,19,22,41,46.3%,3h
35466,1,eddy,2177,135,7,5,12,58.3%,1h
35466,2,terran,2177,231,6,5,11,54.5%,2h
35466,1,Tapstructor,2177,224,5,11,16,31.2%,25m
35466,1,INSOLID,2177,134,4,4,8,50.0%,45m
35466,1,[Softy]AttackMan,2177,177,4,4,8,50.0%,19m
35466,1,Craftdory,2177,42,3,5,8,37.5%,44m
35466,2,ProBronzPlay,2177,0,1,1,2,50.0%,2h
35466,3,WolfGuiter,2177,30,1,1,2,50.0%,47m
35466,2,TrizBoy,2177,0,1,2,3,33.3%,38m
35466,1,[F4MILY]cesar,2177,0,1,5,6,16.7%,2h
35466,2,Kyanide,2177,0,0,1,1,0.0%,18m
35466,2,KgZNachos,2177,0,0,1,1,0.0%,3h
35482,3,protrosser,2176,1491,142,158,300,47.3%,2h
35482,1,JKevinMI,2176,1303,49,47,96,51.0%,1h
35482,1,Khal,2176,701,48,37,85,56.5%,2h
35482,1,TORZAN,2176,870,27,29,56,48.2%,5m
35482,1,Polly,2176,492,16,20,36,44.4%,3h
35482,1,ZOMBIEDRILL,2176,385,10,11,21,47.6%,32m
35482,2,[Pyl0nZ]porkey,2176,196,7,11,18,38.9%,3h
35482,1,Acthnici,2176,169,3,5,8,37.5%,5m
35482,1,DrLuis,2176,48,3,6,9,33.3%,3h
35482,1,Wildernsmike,2176,0,3,6,9,33.3%,2h
35482,1,Existance,2176,116,3,8,11,27.3%,1h
35482,1,[Pharoh]Vamp,2176,90,1,3,4,25.0%,58m
35482,2,TANKSHOW,2176,0,0,1,1,0.0%,2h
35495,1,Dragonic,2175,1074,59,66,125,47.2%,2h
35495,1,kyle,2175,448,19,19,38,50.0%,2h
35495,1,TGX,2175,255,15,13,28,53.6%,13m
35495,2,[YEET42]Wrathor,2175,244,9,7,16,56.2%,53m
35495,2,Chaos,2175,186,6,5,11,54.5%,3h
35495,2,Supermarmota,2175,128,4,24,28,14.3%,35m
35495,1,Ranger,2175,48,2,7,9,22.2%,3h
35495,1,PvtPile,2175,0,1,7,8,12.5%,1h
35495,2,Morpheous,2175,0,0,1,1,0.0%,1h
35495,2,LiLFunNy,2175,0,0,5,5,0.0%,58m
35505,2,Zelph,2174,1275,67,82,149,45.0%,57m
35505,1,MaysLanding,2174,831,41,40,81,50.6%,24m
35505,1,Pebbo,2174,453,17,11,28,60.7%,2h
35505,1,[MNG]Deuxiz,2174,198,6,9,15,40.0%,5m
35505,1,[SECT4]BLAZEibaktxe,2174,66,5,6,11,45.5%,3h
35505,1,Shatturd,2174,96,4,8,12,33.3%,38m
35505,3,snyder,2174,143,4,11,15,26.7%,2h
35505,1,Dirtstick,2174,97,3,5,8,37.5%,3h
35505,2,Pie,2174,127,2,5,7,28.6%,2h
35505,1,GoDy,2174,44,2,7,9,22.2%,2h
35505,1,[LeMono]PillanTheWte,2174,0,1,0,1,100.0%,3h
35505,2,JXMP,2174,0,1,0,1,100.0%,22m
35505,1,AbsoliuT,2174,0,1,6,7,14.3%,3h
35505,1,cambiaformas,2174,0,1,6,7,14.3%,57m
35505,3,Jagz,2174,0,0,1,1,0.0%,16m
35505,2,[Amend]Connerbot,2174,0,0,2,2,0.0%,13m
35505,1,fatal,2174,0,0,3,3,0.0%,33m
35522,1,myNINJAjoe,2173,1773,101,113,214,47.2%,2h
35522,1,Zalem,2173,370,12,12,24,50.0%,5m
35522,1,Xyz,2173,245,11,11,22,50.0%,29m
35522,2,[SqH]marzix,2173,298,9,5,14,64.3%,11m
35522,1,TSG,2173,160,9,6,15,60.0%,3h
35522,3,[Maton]Ralf,2173,267,8,13,21,38.1%,3h
35522,1,Dallaran,2173,242,6,8,14,42.9%,1h
35522,2,Jspike,2173,0,2,4,6,33.3%,47m
35522,2,IIIIIIIIIIII,2173,0,1,0,1,100.0%,30m
35522,2,LeadsPerfect,2173,0,1,0,1,100.0%,30m
35522,2,Ryu,2173,34,1,1,2,50.0%,3h
35533,2,Joseph,2172,480,17,13,30,56.7%,2h
35533,1,FrenziedMonk,2172,425,13,19,32,40.6%,24m
35533,2,AcidBoom,2172,366,12,7,19,63.2%,3h
35533,1,Razo,2172,176,5,5,10,50.0%,2h
35533,3,Venetor,2172,153,4,10,14,28.6%,57m
35533,2,yaco,2172,100,3,3,6,50.0%,2h
35533,1,Grabsack,2172,74,3,4,7,42.9%,1h
35533,2,[INVADS]DyEcr,2172,94,3,4,7,42.9%,55m
35533,1,Fiorex,2172,46,1,4,5,20.0%,10m
35533,2,Goat,2172,0,0,2,2,0.0%,2h
35533,1,LazyTurtle,2172,0,0,5,5,0.0%,2h
35533,1,mili,2172,0,0,5,5,0.0%,3h
35545,2,OaSiSpringBy,2171,1422,56,50,106,52.8%,14m
35545,1,[KuroS]Hungri,2171,884,44,43,87,50.6%,4m
35545,2,rrasengano,2171,1018,41,33,74,55.4%,1h
35545,1,MadClown,2171,804,34,28,62,54.8%,1h
35545,1,[PERJPN]KINEY,2171,754,23,28,51,45.1%,3h
35545,1,Potato,2171,444,14,21,35,40.0%,3h
35545,1,[ShiPal]DrNexium,2171,364,12,16,28,42.9%,3h
35545,2,dininabo,2171,285,9,7,16,56.2%,1h
35545,2,Boonanabob,2171,218,9,14,23,39.1%,3h
35545,2,beastmode,2171,210,8,4,12,66.7%,3h
35545,2,Carnelianous,2171,307,8,9,17,47.1%,52m
35545,3,[ph0t0n]dtal,2171,257,8,12,20,40.0%,2h
35545,1,Arie,2171,122,7,8,15,46.7%,2h
35545,2,mommymilkers,2171,116,5,0,5,100.0%,56m
35545,1,EARL,2171,135,5,5,10,50.0%,57m
35545,1,EagleEII,2171,165,4,9,13,30.8%,47m
35545,2,chabelin,2171,62,3,2,5,60.0%,19m
35545,1,Jehielbv,2171,189,3,8,11,27.3%,49m
35545,2,Villager,2171,58,2,1,3,66.7%,2h
35545,1,BlonderEngel,2171,118,2,6,8,25.0%,9m
35545,2,Zaneakye,2171,30,1,2,3,33.3%,1h
35545,3,[NubBR]KADU,2171,0,1,7,8,12.5%,2h
35545,1,Estefano,2171,0,1,7,8,12.5%,1h
35545,2,Yazerg,2171,0,0,2,2,0.0%,3h
35545,1,Blazing,2171,0,0,4,4,0.0%,23m
35570,1,[DTML]Woundwort,2170,1752,496,510,1006,49.3%,35m
35570,1,TOTTY,2170,1739,263,267,530,49.6%,2h
35570,1,Wolf,2170,1039,55,75,130,42.3%,2h
35570,2,ProblemChild,2170,711,36,26,62,58.1%,2h
35570,3,Reckder,2170,602,21,33,54,38.9%,51m
35570,1,ColCluster,2170,300,14,17,31,45.2%,56m
35570,3,Chinchu,2170,244,10,12,22,45.5%,18m
35570,1,KoolAid,2170,253,7,9,16,43.8%,2h
35570,1,BoostedRex,2170,184,6,8,14,42.9%,26m
35570,1,Sheogorath,2170,208,6,10,16,37.5%,33m
35570,1,WarpigxxxL,2170,201,5,12,17,29.4%,3h
35570,2,LuchoYh,2170,62,3,1,4,75.0%,2h
35570,1,Prometheus,2170,169,3,8,11,27.3%,2h
35570,1,DarkShroud,2170,40,2,4,6,33.3%,5m
35570,3,[XDarK]Barbarian,2170,123,2,15,17,11.8%,18m
35570,2,[SAFNC]Joe,2170,0,1,3,4,25.0%,17m
35570,3,AbyssiousTV,2170,0,1,3,4,25.0%,52m
35570,2,maxent,2170,0,1,4,5,20.0%,31m
35570,1,DrFesterpus,2170,0,1,6,7,14.3%,28m
35570,1,MacAttack,2170,97,1,7,8,12.5%,1h
35570,3,Toique,2170,0,0,1,1,0.0%,46m
35570,2,InsaneThots,2170,0,0,2,2,0.0%,3h
35592,2,wacko,2169,482,17,16,33,51.5%,3h
35592,3,WiseMagic,2169,371,11,13,24,45.8%,54m
35592,1,[whalez]Galorn,2169,48,2,1,3,66.7%,2h
35592,2,TheFireBro,2169,0,2,3,5,40.0%,1h
35592,1,Zeus,2169,0,2,5,7,28.6%,1h
35592,2,stotle,2169,0,1,4,5,20.0%,3h
35592,2,VINCENTVLOGS,2169,44,1,5,6,16.7%,15m
35592,2,Stunning,2169,0,0,1,1,0.0%,6m
35592,1,legendofslay,2169,0,0,1,1,0.0%,1h
35592,2,bettcomander,2169,0,0,2,2,0.0%,60m
35592,2,DragoR,2169,0,0,2,2,0.0%,19m
35603,1,Steve,2168,1184,47,45,92,51.1%,36m
35603,1,BrotoResolve,2168,731,23,25,48,47.9%,1h
35603,1,BouncyKnight,2168,256,11,11,22,50.0%,20m
35603,3,Kellen,2168,198,7,11,18,38.9%,2h
35603,2,EscherichiaC,2168,241,7,12,19,36.8%,53m
35603,2,WARCHARLES,2168,152,5,9,14,35.7%,3h
35603,1,[BLHL]Iamcute,2168,169,4,0,4,100.0%,44m
35603,2,Israel,2168,90,3,5,8,37.5%,53m
35603,1,superparrot,2168,141,3,7,10,30.0%,3h
35603,2,Adol,2168,30,1,1,2,50.0%,52m
35603,2,Biznich,2168,46,1,5,6,16.7%,3h
35603,1,Deadpool,2168,0,1,5,6,16.7%,3h
35603,1,Andromeda,2168,97,1,6,7,14.3%,13m
35616,1,Golirot,2167,1433,101,98,199,50.8%,24m
35616,3,KaiSonWon,2167,280,48,45,93,51.6%,24m
35616,1,Patrick,2167,880,30,36,66,45.5%,59m
35616,2,HiveTyrant,2167,422,15,9,24,62.5%,3h
35616,1,Jerroo,2167,377,15,17,32,46.9%,14m
35616,2,Enao,2167,427,14,17,31,45.2%,3h
35616,1,WHYerenWHY,2167,277,9,9,18,50.0%,25m
35616,2,Therion,2167,150,8,6,14,57.1%,3h
35616,1,hypermunkee,2167,235,5,9,14,35.7%,3h
35616,1,KillaTO,2167,42,4,4,8,50.0%,29m
35616,1,Alex,2167,0,3,3,6,50.0%,1h
35616,1,Nicko,2167,48,2,0,2,100.0%,3h
35616,1,[Æsir]FORSETI,2167,84,2,8,10,20.0%,5m
35616,1,[CrLine]benja,2167,0,1,5,6,16.7%,3h
35616,1,[RONM]Janico,2167,0,0,2,2,0.0%,26m
35616,2,Diegoishyan,2167,0,0,2,2,0.0%,3h
35616,3,GogoAinur,2167,0,0,3,3,0.0%,3h
35633,1,PenguinODoom,2166,929,32,31,63,50.8%,1h
35633,2,Hero,2166,452,20,18,38,52.6%,13m
35633,1,colinmoretti,2166,426,16,16,32,50.0%,2h
35633,2,BODOQUE,2166,378,16,21,37,43.2%,6m
35633,2,brnuno,2166,286,11,8,19,57.9%,1h
35633,1,Pinksalmon,2166,330,11,15,26,42.3%,2h
35633,2,[SYNDCT]bigbandicoot,2166,288,10,7,17,58.8%,1h
35633,3,PhantomOne,2166,94,7,7,14,50.0%,2h
35633,2,CleverName,2166,150,6,3,9,66.7%,2h
35633,1,AapixX,2166,185,5,8,13,38.5%,2h
35633,2,CORONEL,2166,0,2,2,4,50.0%,3h
35633,3,JayParadox,2166,123,2,3,5,40.0%,41m
35633,1,Aideus,2166,0,1,1,2,50.0%,2h
35633,1,SrHuerta,2166,0,0,4,4,0.0%,22m
35647,1,chaps,2165,1423,49,51,100,49.0%,2h
35647,2,quien,2165,676,26,25,51,51.0%,2h
35647,1,Rotula,2165,480,18,14,32,56.2%,3h
35647,3,Angel,2165,384,16,22,38,42.1%,55m
35647,1,Grimmjow,2165,276,8,12,20,40.0%,1h
35647,2,HardOffender,2165,271,7,8,15,46.7%,3h
35647,1,ACEBOOKER,2165,146,4,8,12,33.3%,10m
35647,1,Switchy,2165,128,3,4,7,42.9%,2h
35647,1,destroyer,2165,145,3,4,7,42.9%,3h
35647,3,DVO,2165,60,3,9,12,25.0%,2h
35647,2,sploosh,2165,64,2,1,3,66.7%,2h
35647,2,KloudNine,2165,0,2,10,12,16.7%,1h
35647,2,Dave,2165,0,1,0,1,100.0%,2h
35647,1,pep,2165,38,1,9,10,10.0%,14m
35647,2,VISARII,2165,0,0,1,1,0.0%,40m
35647,1,HeatGuyJ,2165,0,0,2,2,0.0%,2h
35647,1,DaNuSkA,2165,0,0,2,2,0.0%,2h
35664,1,ALLMID,2164,1641,87,106,193,45.1%,2h
35664,2,smsam,2164,1383,73,76,149,49.0%,55m
35664,1,[Mlol]Telle,2164,1358,72,81,153,47.1%,3h
35664,2,Acid,2164,494,19,19,38,50.0%,2h
35664,2,PauloXD,2164,520,18,21,39,46.2%,48m
35664,1,[roilty]ChefRoilty,2164,350,18,26,44,40.9%,1h
35664,2,ogil,2164,426,13,10,23,56.5%,14m
35664,1,jessto,2164,278,10,10,20,50.0%,1h
35664,2,Ednar,2164,206,8,4,12,66.7%,1h
35664,1,RimmJob,2164,204,8,7,15,53.3%,22m
35664,2,CGxFatal,2164,308,8,9,17,47.1%,2h
35664,3,FORTHEKILL,2164,219,6,6,12,50.0%,2h
35664,2,Bron,2164,104,3,5,8,37.5%,2h
35664,1,Keegan,2164,96,3,9,12,25.0%,3h
35664,2,[RMPNEN]Rolex,2164,93,2,1,3,66.7%,22m
35664,2,SilverHawk,2164,32,2,3,5,40.0%,4m
35664,1,LaVoluntad,2164,127,2,4,6,33.3%,59m
35664,1,ThinkEleven,2164,48,2,8,10,20.0%,28m
35664,2,HyperHylian,2164,0,1,4,5,20.0%,15m
35664,1,Keizer,2164,39,1,5,6,16.7%,3h
35664,1,Soucy,2164,0,1,6,7,14.3%,2h
35664,2,JackPatata,2164,0,0,1,1,0.0%,54m
35664,2,Lobstafish,2164,0,0,1,1,0.0%,49m
35687,1,Garm,2163,1214,92,95,187,49.2%,10m
35687,1,stelloxx,2163,1050,31,34,65,47.7%,2h
35687,2,Shinji,2163,260,10,5,15,66.7%,2h
35687,1,[FuQc]blodos,2163,260,9,10,19,47.4%,1h
35687,3,[1NG]atworknow,2163,173,6,11,17,35.3%,55m
35687,2,Harveynz,2163,0,4,1,5,80.0%,1h
35687,2,radman,2163,118,4,4,8,50.0%,22m
35687,1,ElonTusk,2163,70,3,7,10,30.0%,26m
35687,1,Tanari,2163,30,3,9,12,25.0%,2h
35687,2,FaulTY,2163,40,2,3,5,40.0%,2h
35687,3,TemZeratul,2163,97,2,4,6,33.3%,4m
35687,1,JavierAlfaOP,2163,48,2,6,8,25.0%,14m
35687,1,[LATINX]FrancoVolta,2163,44,2,8,10,20.0%,22m
35687,1,Lestat,2163,0,1,2,3,33.3%,2h
35687,2,mewthree,2163,0,1,4,5,20.0%,1h
35702,1,Balance,2162,1475,55,52,107,51.4%,8m
35702,2,Benjy,2162,630,23,18,41,56.1%,41m
35702,3,Pocxi,2162,498,19,22,41,46.3%,2h
35702,1,MongooseLupe,2162,458,13,19,32,40.6%,41m
35702,1,Turner,2162,239,7,11,18,38.9%,3h
35702,1,KimJongil,2162,214,6,13,19,31.6%,46m
35702,1,NambuPower,2162,152,5,10,15,33.3%,46m
35702,2,Wiley,2162,62,2,4,6,33.3%,53m
35702,2,BLACKSMITH,2162,0,1,5,6,16.7%,2h
35702,1,TwentySeven,2162,0,1,5,6,16.7%,41m
35702,2,Pwnz,2162,0,1,5,6,16.7%,2h
35702,2,Behemot,2162,0,0,1,1,0.0%,2h
35702,2,TheKingXx,2162,0,0,1,1,0.0%,22m
35702,3,Kaitabch,2162,0,0,1,1,0.0%,10m
35702,1,willix,2162,0,0,4,4,0.0%,60m
35702,2,Boffin,2162,0,0,5,5,0.0%,22m
35718,3,KingofCheese,2161,1549,435,452,887,49.0%,2h
35718,2,FraudBiden,2161,648,25,14,39,64.1%,44m
35718,2,junstice,2161,361,18,6,24,75.0%,58m
35718,1,Ivan,2161,430,14,24,38,36.8%,2h
35718,3,SeaHam,2161,310,10,16,26,38.5%,18m
35718,2,Squarehmmr,2161,174,4,10,14,28.6%,22m
35718,2,Jeffz,2161,72,2,4,6,33.3%,48m
35718,2,BigBear,2161,44,2,6,8,25.0%,2h
35718,1,[CePPs]Yisus,2161,40,2,7,9,22.2%,2h
35718,2,[BS1]Gargolos,2161,0,1,0,1,100.0%,2h
35718,3,DagiPls,2161,30,1,3,4,25.0%,2h
35718,1,drake,2161,103,1,7,8,12.5%,1h
35718,2,Thitão,2161,0,0,1,1,0.0%,3h
35718,2,Socks,2161,0,0,2,2,0.0%,2h
35732,1,ChikiPuki,2160,1650,68,70,138,49.3%,29m
35732,1,niko,2160,1321,57,55,112,50.9%,23m
35732,2,nako,2160,907,34,34,68,50.0%,1h
35732,2,JLDTVIROC,2160,688,25,29,54,46.3%,3h
35732,1,Espectrodos,2160,376,15,14,29,51.7%,2h
35732,2,DirtyDude,2160,334,12,11,23,52.2%,30m
35732,1,AlissYourQn,2160,383,12,15,27,44.4%,3h
35732,2,lmcfirst,2160,208,7,4,11,63.6%,1h
35732,2,cyrius,2160,156,5,7,12,41.7%,11m
35732,3,ReaListic,2160,169,4,4,8,50.0%,59m
35732,1,Stebandido,2160,96,3,8,11,27.3%,2h
35732,1,DarkLap,2160,90,2,5,7,28.6%,2h
35732,2,deej,2160,0,1,4,5,20.0%,2h
35732,1,oioi,2160,0,1,4,5,20.0%,54m
35732,2,kjwDV,2160,30,1,5,6,16.7%,2h
35732,1,ColtronHamer,2160,0,1,8,9,11.1%,41m
35732,1,dukelarg,2160,40,1,8,9,11.1%,57m
35732,2,Panax,2160,0,0,1,1,0.0%,3h
35732,2,Mamba,2160,0,0,2,2,0.0%,56m
35751,1,doyle,2159,1138,73,74,147,49.7%,2h
35751,1,elwalale,2159,922,31,30,61,50.8%,1h
35751,2,Kristennn,2159,376,14,18,32,43.8%,46m
35751,2,Pouncer,2159,350,12,11,23,52.2%,1h
35751,1,KAELY,2159,346,12,20,32,37.5%,1h
35751,2,redman,2159,271,11,5,16,68.8%,2h
35751,3,Bebop,2159,260,8,14,22,36.4%,10m
35751,2,SushiiTCTTV,2159,60,3,0,3,100.0%,3h
35751,1,[KGH6]lingsauce,2159,82,3,8,11,27.3%,1h
35751,2,Rustmuggins,2159,64,2,4,6,33.3%,4m
35751,1,Johnny,2159,0,2,6,8,25.0%,2h
35751,1,[CoCoa]CireT,2159,0,1,3,4,25.0%,12m
35751,1,mambalamba,2159,48,1,4,5,20.0%,1h
35751,2,Tinyimps,2159,94,1,5,6,16.7%,2h
35751,2,palmtree,2159,0,0,2,2,0.0%,53m
35766,1,MightyZergs,2158,1485,94,108,202,46.5%,1h
35766,1,ZLog,2158,579,20,17,37,54.1%,17m
35766,1,ProtossFS,2158,367,14,15,29,48.3%,3h
35766,2,Helya,2158,326,13,11,24,54.2%,22m
35766,1,RonBuan,2158,330,13,13,26,50.0%,57m
35766,1,[char14]DeviantDenzn,2158,248,12,18,30,40.0%,14m
35766,2,[Bommmm]NXI,2158,204,9,18,27,33.3%,25m
35766,3,Maduros,2158,242,9,21,30,30.0%,23m
35766,1,Bulloch,2158,232,7,9,16,43.8%,2h
35766,1,IIIIIIIIIIII,2158,238,7,14,21,33.3%,2h
35766,3,Stoneman,2158,125,4,11,15,26.7%,2h
35766,3,[INextI]SevenCr,2158,44,3,9,12,25.0%,8m
35766,2,Stuntguy,2158,60,2,3,5,40.0%,3h
35766,3,OneShot,2158,0,1,0,1,100.0%,41m
35766,2,juggala,2158,0,1,4,5,20.0%,2h
35766,2,Mortumnus,2158,0,1,5,6,16.7%,2h
35766,2,[BSMT]DaveBabe,2158,0,0,1,1,0.0%,3h
35766,2,Specker,2158,0,0,2,2,0.0%,13m
35784,1,[Kappa8]Mmbrillo,2157,559,25,24,49,51.0%,46m
35784,2,ubertyce,2157,516,18,21,39,46.2%,41m
35784,2,PhamNuwen,2157,346,13,21,34,38.2%,2h
35784,2,ehlixer,2157,392,12,17,29,41.4%,3h
35784,2,ROY,2157,302,10,13,23,43.5%,7m
35784,3,Turba,2157,267,8,12,20,40.0%,45m
35784,2,Wolverine,2157,165,7,7,14,50.0%,2h
35784,3,Leopk,2157,203,7,11,18,38.9%,2h
35784,1,XxDrAigNorXx,2157,0,2,6,8,25.0%,1h
35784,2,NickNate,2157,0,1,0,1,100.0%,55m
35784,2,Foky,2157,0,1,0,1,100.0%,38m
35784,2,wolfrick,2157,30,1,1,2,50.0%,55m
35784,2,Zavin,2157,30,1,3,4,25.0%,18m
35784,2,[ProSC]Angelo,2157,0,0,1,1,0.0%,3h
35784,2,Wesito,2157,0,0,2,2,0.0%,2h
35799,2,Rino,2156,1633,93,92,185,50.3%,2h
35799,1,[6013O9]Jgemcarmesí,2156,1587,60,60,120,50.0%,45m
35799,1,themadmonk,2156,848,27,30,57,47.4%,1h
35799,2,NoisE,2156,574,23,20,43,53.5%,56m
35799,1,[GOOOSE]mooplet,2156,549,17,23,40,42.5%,46m
35799,2,jamiro,2156,149,6,5,11,54.5%,22m
35799,1,StickyGreens,2156,228,6,9,15,40.0%,24m
35799,1,botsmasher,2156,214,6,10,16,37.5%,3h
35799,2,Skninja,2156,74,5,3,8,62.5%,4m
35799,2,Ticus,2156,116,3,3,6,50.0%,2h
35799,2,BatFastard,2156,68,2,3,5,40.0%,1h
35799,1,Zuthanatos,2156,44,2,3,5,40.0%,3h
35799,2,Skato,2156,97,2,7,9,22.2%,1h
35799,1,HeLa,2156,44,2,7,9,22.2%,2h
35799,2,Alekzx,2156,30,1,1,2,50.0%,2h
35799,1,HentaiJessus,2156,0,1,2,3,33.3%,2h
35799,2,Heroxilies,2156,34,1,3,4,25.0%,41m
35799,1,Wolf,2156,48,1,3,4,25.0%,1h
35799,2,TinyDinoMite,2156,0,1,5,6,16.7%,2h
35799,1,[BCKt]mikashi,2156,0,1,6,7,14.3%,2h
35799,1,[sLowAf]CheeeseLouis,2156,38,1,8,9,11.1%,3h
35799,1,dreacarys,2156,0,0,1,1,0.0%,47m
35799,2,TingLouie,2156,0,0,5,5,0.0%,14m
35822,1,[tact1c]awfulflame,2155,1759,70,61,131,53.4%,2h
35822,2,lambdrool,2155,1296,46,52,98,46.9%,3m
35822,1,cornshrimp,2155,304,28,32,60,46.7%,53m
35822,1,[PooNys]Onixmen,2155,250,8,13,21,38.1%,2h
35822,1,[MGN]MarioBoss,2155,191,7,10,17,41.2%,22m
35822,3,vinidinogs,2155,219,7,12,19,36.8%,46m
35822,1,FDR,2155,133,4,3,7,57.1%,3h
35822,1,[AlIin]Kartoffel,2155,116,4,7,11,36.4%,2h
35822,2,ThAtCrAzy,2155,123,3,4,7,42.9%,3h
35822,1,Apple,2155,97,2,1,3,66.7%,2h
35822,1,Zaiden,2155,36,2,7,9,22.2%,10m
35822,1,Violet,2155,84,2,8,10,20.0%,14m
35822,2,RAmzap,2155,30,1,1,2,50.0%,56m
35822,2,ursaMajor,2155,0,1,5,6,16.7%,52m
35822,1,EJEQUALSNOOB,2155,42,1,7,8,12.5%,46m
35822,2,magicpants,2155,0,0,1,1,0.0%,41m
35822,2,Kronix,2155,0,0,5,5,0.0%,1h
35839,3,Allezo,2154,1554,150,151,301,49.8%,2h
35839,2,Zephyr,2154,1203,58,51,109,53.2%,3h
35839,2,[neato]Smackanacho,2154,1078,45,44,89,50.6%,41m
35839,3,StevieBlues,2154,928,37,45,82,45.1%,18m
35839,1,[Lamort]FabroManiac,2154,336,16,14,30,53.3%,2h
35839,1,Nattzerimr,2154,266,8,10,18,44.4%,1h
35839,3,SmugCreature,2154,252,8,14,22,36.4%,56m
35839,3,Alterach,2154,273,7,15,22,31.8%,1m
35839,1,Zeratul,2154,96,3,7,10,30.0%,26m
35839,1,UndeadChew,2154,0,2,4,6,33.3%,43m
35839,2,[LAT18]Sval,2154,0,1,2,3,33.3%,3h
35839,2,Tactile,2154,0,0,1,1,0.0%,3h
35839,2,JonWry,2154,0,0,1,1,0.0%,2h
35839,2,[MLP0NY]BubbaG,2154,0,0,2,2,0.0%,18m
35839,2,LeonID,2154,0,0,5,5,0.0%,3h
35854,2,cesar,2153,1623,163,159,322,50.6%,1h
35854,2,Stryker,2153,1479,65,46,111,58.6%,3h
35854,1,Droglas,2153,820,55,62,117,47.0%,3h
35854,1,Cjkmaa,2153,520,49,41,90,54.4%,1h
35854,2,rawx,2153,605,21,29,50,42.0%,38m
35854,1,Ejemox,2153,734,21,31,52,40.4%,2h
35854,3,Dangelo,2153,542,19,27,46,41.3%,25m
35854,1,AngelloBC,2153,585,15,18,33,45.5%,33m
35854,2,CaptCalamari,2153,272,13,6,19,68.4%,48m
35854,2,BlackHawk,2153,184,6,6,12,50.0%,2h
35854,3,Tsunamizor,2153,88,5,10,15,33.3%,15m
35854,2,Snowcow,2153,86,4,3,7,57.1%,1h
35854,2,bronzeforlyf,2153,164,4,3,7,57.1%,58m
35854,2,Pesky,2153,0,2,4,6,33.3%,2h
35854,2,TraukoDV,2153,0,1,0,1,100.0%,11m
35854,2,deva,2153,38,1,3,4,25.0%,15m
35854,2,DoggishBeast,2153,0,1,4,5,20.0%,31m
35871,1,Cronico,2152,829,29,35,64,45.3%,3h
35871,1,StOpDrOp,2152,595,23,22,45,51.1%,2h
35871,1,Karma,2152,401,15,17,32,46.9%,7m
35871,2,shoemaker,2152,300,12,9,21,57.1%,2h
35871,3,thepredator,2152,269,9,17,26,34.6%,2h
35871,2,[IBIU]Shadow,2152,226,8,9,17,47.1%,1h
35871,1,Eerkaj,2152,186,8,10,18,44.4%,54m
35871,3,MrJohannes,2152,226,8,13,21,38.1%,26m
35871,2,MoistMarbles,2152,90,3,3,6,50.0%,3m
35871,1,Kosmic,2152,122,3,7,10,30.0%,5m
35871,2,SpaceDancer,2152,153,3,9,12,25.0%,3h
35871,2,Bizling,2152,0,1,4,5,20.0%,2h
35871,1,AsisTyrax,2152,44,1,6,7,14.3%,2h
35871,1,kaidoson,2152,0,1,6,7,14.3%,2h
35871,2,Azopf,2152,0,0,2,2,0.0%,3h
35871,1,Danaku,2152,0,0,4,4,0.0%,1h
35871,2,brsafado,2152,0,0,5,5,0.0%,57m
35888,2,spineforest,2151,957,77,57,134,57.5%,30m
35888,1,mrdestiny,2151,1287,52,53,105,49.5%,34m
35888,2,vortex,2151,639,26,27,53,49.1%,2h
35888,2,TrokoTelui,2151,503,18,17,35,51.4%,3h
35888,1,Jkarma,2151,364,15,13,28,53.6%,2h
35888,3,Squidward,2151,209,6,13,19,31.6%,18m
35888,1,WhyLordWhy,2151,92,4,3,7,57.1%,3h
35888,2,Baujahr,2151,118,4,4,8,50.0%,4m
35888,1,[HOT69]FUNcommander,2151,199,4,7,11,36.4%,3h
35888,1,TERFW,2151,73,2,10,12,16.7%,3h
35888,2,TheSenate,2151,0,1,3,4,25.0%,1h
35888,1,giubruno,2151,0,1,5,6,16.7%,32m
35888,2,luixito,2151,0,0,2,2,0.0%,15m
35888,2,josepepe,2151,0,0,5,5,0.0%,19m
35902,1,[MeanM]Odo,2150,290,11,12,23,47.8%,3h
35902,1,BottomQuat,2150,254,7,13,20,35.0%,25m
35902,1,[CRA]keter,2150,0,3,3,6,50.0%,3h
35902,1,[SWOU]Radamanthys,2150,0,3,4,7,42.9%,2h
35902,3,SwarmingCris,2150,151,3,7,10,30.0%,16m
35902,2,[DHLx]MasterVman,2150,34,2,1,3,66.7%,3h
35902,2,ROJAMVER,2150,124,2,7,9,22.2%,58m
35902,2,Drizzt,2150,0,1,1,2,50.0%,15m
35902,2,Nifidriel,2150,0,1,2,3,33.3%,2h
35902,1,Neltharion,2150,97,1,3,4,25.0%,3h
35902,2,ZestisBest,2150,0,1,4,5,20.0%,41m
35902,2,Fry,2150,0,0,2,2,0.0%,2h
35914,1,Budamunk,2149,1678,105,115,220,47.7%,5m
35914,1,TheHolyAsdf,2149,274,9,14,23,39.1%,14m
35914,2,NickH,2149,248,9,17,26,34.6%,3h
35914,1,isaiahck,2149,304,8,10,18,44.4%,2h
35914,3,legends,2149,114,6,13,19,31.6%,2h
35914,2,[ZWUT]Venom,2149,90,4,5,9,44.4%,15m
35914,2,deakdollars,2149,34,3,4,7,42.9%,2h
35914,2,TiGrEx,2149,36,2,4,6,33.3%,3h
35914,1,WillahG,2149,48,2,8,10,20.0%,41m
35914,2,Insane,2149,0,0,3,3,0.0%,22m
35924,2,[xDiKx]Hijinks,2148,1013,119,117,236,50.4%,2h
35924,1,[MrSolo]pmanriquez,2148,1727,111,120,231,48.1%,3h
35924,1,Coburn,2148,1723,77,87,164,47.0%,3h
35924,2,[TPride]FitzWing,2148,839,51,42,93,54.8%,2h
35924,2,DarkRaven,2148,908,42,21,63,66.7%,2h
35924,3,Soneido,2148,981,37,53,90,41.1%,14m
35924,1,JediNinja,2148,258,8,11,19,42.1%,2h
35924,1,[NLTN]bigdirty,2148,38,2,7,9,22.2%,1h
35924,2,milamber,2148,0,1,0,1,100.0%,15m
35924,1,SicTransMund,2148,43,1,2,3,33.3%,1h
35924,1,GrasDBacon,2148,42,1,12,13,7.7%,3h
35924,2,[ALTF04]Mike,2148,0,0,1,1,0.0%,2h
35936,2,Haz,2147,1341,49,48,97,50.5%,52m
35936,2,Optimus,2147,647,29,25,54,53.7%,48m
35936,2,MrOcho,2147,646,25,28,53,47.2%,15m
35936,2,Lichari,2147,303,21,18,39,53.8%,19m
35936,1,morgano,2147,296,9,12,21,42.9%,29m
35936,2,Iscariot,2147,173,6,2,8,75.0%,3h
35936,2,DjBloodRealm,2147,218,5,8,13,38.5%,30m
35936,2,[RONPAP]sirhenry,2147,60,3,0,3,100.0%,3h
35936,2,Story,2147,93,3,3,6,50.0%,1h
35936,1,scalar,2147,76,3,8,11,27.3%,43m
35936,2,Thor,2147,30,2,0,2,100.0%,3h
35936,2,criss,2147,60,2,6,8,25.0%,1h
35936,2,killomar,2147,137,2,6,8,25.0%,2h
35936,2,[IiUiI]KoshNaranek,2147,0,1,0,1,100.0%,13m
35936,2,gold,2147,93,1,1,2,50.0%,2h
35936,2,FernandoMan,2147,0,0,4,4,0.0%,60m
35952,1,Heolx,2146,1296,47,50,97,48.5%,3h
35952,2,Johann,2146,298,14,5,19,73.7%,3h
35952,1,Mydogsmia,2146,488,14,18,32,43.8%,59m
35952,1,MaxxAmmo,2146,371,11,17,28,39.3%,44m
35952,2,[CanWar]claudiugh,2146,184,7,7,14,50.0%,2h
35952,3,FearHack,2146,220,7,13,20,35.0%,1h
35952,2,[TPGGXD]AliensXD,2146,236,6,10,16,37.5%,3h
35952,1,MosesBeard,2146,148,4,7,11,36.4%,3h
35952,2,GoldLabel,2146,112,3,4,7,42.9%,2h
35952,2,Rickyguz,2146,0,1,4,5,20.0%,2h
35952,1,[piiink]Math,2146,0,1,6,7,14.3%,34m
35952,2,siresombre,2146,0,0,1,1,0.0%,32m
35952,1,Henritus,2146,0,0,2,2,0.0%,2h
35965,1,Mercury,2145,905,41,39,80,51.2%,3h
35965,2,BigRahb,2145,997,37,36,73,50.7%,1h
35965,2,Pelantaru,2145,772,31,31,62,50.0%,22m
35965,1,KingSnivle,2145,367,13,25,38,34.2%,7m
35965,2,[lifebd]Hyrulian,2145,314,12,8,20,60.0%,3h
35965,2,[NwAs]MaelG,2145,0,5,0,5,100.0%,54m
35965,2,NewCoat,2145,162,5,4,9,55.6%,1m
35965,1,GrosToss,2145,38,3,5,8,37.5%,22m
35965,2,[NM8]ACE,2145,153,3,6,9,33.3%,22m
35965,2,AntiHeRo,2145,0,1,4,5,20.0%,3h
35965,2,Aizen,2145,0,0,2,2,0.0%,2h
35965,2,[GRUSP]Saint,2145,0,0,3,3,0.0%,2h
35977,1,BobLobLaw,2144,1198,59,58,117,50.4%,3h
35977,2,trimmer,2144,994,48,40,88,54.5%,1h
35977,3,Mayari,2144,848,32,46,78,41.0%,32m
35977,1,Sheldrake,2144,336,14,14,28,50.0%,7m
35977,2,raisedhollow,2144,152,6,3,9,66.7%,44m
35977,2,Saga,2144,186,6,10,16,37.5%,2h
35977,1,vitosnake,2144,186,6,13,19,31.6%,2h
35977,1,[ZergW]Fad,2144,152,5,3,8,62.5%,1h
35977,3,Russty,2144,147,4,12,16,25.0%,27m
35977,2,Bullpup,2144,62,2,1,3,66.7%,22m
35977,1,riflesanfco,2144,0,2,4,6,33.3%,2h
35977,1,Jake,2144,44,2,7,9,22.2%,3h
35977,2,MARIHUALINK,2144,88,1,1,2,50.0%,1h
35977,3,NoMercy,2144,0,1,6,7,14.3%,26m
35977,2,[CHONK]ThisIsTheWay,2144,0,0,1,1,0.0%,7m
35977,2,Ignacio,2144,0,0,1,1,0.0%,3h
35977,2,Dutton,2144,0,0,2,2,0.0%,12m
35977,3,MCMiky,2144,0,0,2,2,0.0%,47m
35995,1,tatchka,2143,1123,91,82,173,52.6%,2h
35995,2,FLATLINE,2143,938,35,33,68,51.5%,3h
35995,2,Scubatropin,2143,586,23,19,42,54.8%,2h
35995,2,squarebeak,2143,586,18,30,48,37.5%,19m
35995,3,BossHogan,2143,370,16,21,37,43.2%,31m
35995,2,[iS1MP]thomas,2143,58,5,3,8,62.5%,3h
35995,2,Canaan,2143,120,5,5,10,50.0%,48m
35995,2,Surge,2143,92,4,2,6,66.7%,52m
35995,2,Aayuiasesino,2143,96,4,5,9,44.4%,3h
35995,2,RAcleaner,2143,60,2,4,6,33.3%,2h
35995,1,GunsGoBlaka,2143,97,2,9,11,18.2%,3h
35995,2,cyberoach,2143,0,1,0,1,100.0%,58m
35995,2,[NS1933]Fluffygiggle,2143,0,1,0,1,100.0%,3h
35995,3,Brokenaegis,2143,0,1,1,2,50.0%,1h
35995,2,[E10269]Sergiio,2143,0,1,1,2,50.0%,3h
35995,2,Kazid,2143,0,1,1,2,50.0%,2h
35995,2,StarKnight,2143,0,1,4,5,20.0%,2h
35995,2,[IMeQ]NinnZyAeQ,2143,0,0,1,1,0.0%,3h
35995,1,Tenseigan,2143,0,0,3,3,0.0%,1h
35995,2,AlbieCrazy,2143,0,0,5,5,0.0%,48m
36015,2,[YEGG]Jrocker,2142,249,9,15,24,37.5%,13m
36015,2,Kyle,2142,126,5,5,10,50.0%,1h
36015,3,DecrepitAPK,2142,177,5,11,16,31.2%,52m
36015,2,PST,2142,35,2,1,3,66.7%,3h
36015,1,Starr,2142,48,2,5,7,28.6%,2h
36015,2,YEET,2142,30,1,1,2,50.0%,41m
36015,2,MERCURIO,2142,44,1,2,3,33.3%,3m
36015,2,Gugnir,2142,0,0,1,1,0.0%,3h
36015,2,Marinaflea,2142,0,0,2,2,0.0%,2h
36024,2,Ale,2141,1045,162,178,340,47.6%,10m
36024,1,[Gylos]louis,2141,1241,71,74,145,49.0%,28m
36024,1,MAS,2141,1458,60,79,139,43.2%,39m
36024,2,Hantuayr,2141,563,15,25,40,37.5%,4m
36024,2,GuerilaStout,2141,387,12,21,33,36.4%,3h
36024,1,Wufferus,2141,84,5,6,11,45.5%,3h
36024,2,MMRGiver,2141,122,3,1,4,75.0%,2h
36024,2,Cyclone,2141,0,2,2,4,50.0%,2h
36024,3,SilianRail,2141,0,2,9,11,18.2%,2m
36024,2,Joni,2141,0,0,1,1,0.0%,2h
36024,2,SpartaKevin,2141,0,0,2,2,0.0%,1h
36035,2,Lunchpail,2140,944,36,40,76,47.4%,3h
36035,1,dilanquijije,2140,888,33,30,63,52.4%,1h
36035,2,Fokus,2140,246,8,10,18,44.4%,3h
36035,2,Mrsicknasty,2140,205,6,13,19,31.6%,52m
36035,1,yukigira,2140,272,5,10,15,33.3%,6m
36035,1,deathgods,2140,92,2,4,6,33.3%,3h
36035,1,CHIZZLER,2140,0,2,9,11,18.2%,3h
36042,1,JPOW,2139,1065,64,61,125,51.2%,40m
36042,2,Blazifmosif,2139,926,31,41,72,43.1%,3h
36042,2,ZrgLunchable,2139,254,15,12,27,55.6%,3h
36042,1,Tipples,2139,407,15,21,36,41.7%,33m
36042,1,[RoyP]Oppenheimer,2139,406,13,18,31,41.9%,43m
36042,1,Logosh,2139,213,8,8,16,50.0%,3h
36042,3,Alexisherre,2139,215,6,5,11,54.5%,2h
36042,1,NoobyNevie,2139,141,4,1,5,80.0%,2h
36042,3,SoytheLB,2139,30,2,0,2,100.0%,2h
36042,3,[GRNSKN]SupplyZone,2139,0,2,6,8,25.0%,2h
36042,2,kini,2139,76,2,6,8,25.0%,44m
36042,1,Ambition,2139,0,2,6,8,25.0%,1h
36042,3,AnGeLuZ,2139,42,1,2,3,33.3%,1h
36042,2,[PobSC]Setyury,2139,0,0,1,1,0.0%,30m
36042,2,Shanti,2139,0,0,2,2,0.0%,3h
36042,2,nokia,2139,0,0,5,5,0.0%,22m
36042,2,YungDubah,2139,0,0,5,5,0.0%,3h
36042,2,[Xirius]Thermite,2139,0,0,5,5,0.0%,3h
36060,2,dune,2138,1264,50,48,98,51.0%,56m
36060,2,KutePajamas,2138,625,22,22,44,50.0%,48m
36060,2,Europa,2138,220,9,9,18,50.0%,2h
36060,1,[McBox]BaneRain,2138,92,5,5,10,50.0%,28m
36060,2,[Mota12]ERKOS,2138,90,3,7,10,30.0%,2h
36060,1,gorymaster,2138,126,3,9,12,25.0%,18m
36060,3,[25FK]Mouldybiscut,2138,97,1,5,6,16.7%,2m
36060,1,EvilKermit,2138,0,0,6,6,0.0%,1h
36068,2,Sethracido,2137,474,20,11,31,64.5%,19m
36068,2,BlizzIsDead,2137,495,19,16,35,54.3%,3h
36068,2,drcakeman,2137,504,17,20,37,45.9%,53m
36068,1,[EBAGmn]theswarm,2137,428,16,13,29,55.2%,3h
36068,1,LeoCantus,2137,325,15,18,33,45.5%,5m
36068,1,Stamen,2137,166,9,9,18,50.0%,2h
36068,2,SkullKrusher,2137,236,8,6,14,57.1%,30m
36068,2,steadyeddy,2137,152,7,8,15,46.7%,3h
36068,3,Rags,2137,195,5,4,9,55.6%,7m
36068,1,[PwT]Faiskado,2137,205,5,10,15,33.3%,3h
36068,3,Vozveratu,2137,125,3,4,7,42.9%,55m
36068,1,xxvii,2137,97,2,7,9,22.2%,3h
36068,1,smallfry,2137,84,2,8,10,20.0%,25m
36068,2,[TUSS]RacerC,2137,30,1,1,2,50.0%,1m
36068,1,charkattack,2137,0,1,7,8,12.5%,1h
36068,2,[meTREE]TreeIsMe,2137,0,0,1,1,0.0%,14m
36068,2,TEZA,2137,0,0,5,5,0.0%,2h
36085,2,Serral,2136,1251,82,90,172,47.7%,37m
36085,2,JeanC,2136,1101,63,59,122,51.6%,6m
36085,2,VirtualDhruv,2136,1160,48,47,95,50.5%,3h
36085,1,CHERO,2136,588,16,24,40,40.0%,58m
36085,2,Locust,2136,438,14,9,23,60.9%,1h
36085,3,cryston,2136,304,12,21,33,36.4%,7m
36085,1,Nirat,2136,307,10,9,19,52.6%,3h
36085,2,eetmabalz,2136,174,10,14,24,41.7%,2h
36085,3,DopaminE,2136,119,4,11,15,26.7%,2h
36085,2,BacKaSswArdZ,2136,88,3,2,5,60.0%,3h
36085,2,Boss,2136,98,3,10,13,23.1%,1h
36085,2,terminater,2136,97,1,1,2,50.0%,7m
36085,2,HerboLeon,2136,48,1,2,3,33.3%,48m
36085,2,DARGON,2136,0,1,4,5,20.0%,2h
36085,1,ArnoldsBack,2136,0,1,7,8,12.5%,3h
36085,2,sainraja,2136,0,0,1,1,0.0%,3h
36101,2,Noctrnal,2135,1033,38,38,76,50.0%,14m
36101,2,Overmight,2135,858,31,36,67,46.3%,3h
36101,2,ShaneFalco,2135,744,27,27,54,50.0%,53m
36101,1,Messeycows,2135,491,23,37,60,38.3%,2h
36101,2,joseph,2135,380,14,12,26,53.8%,15m
36101,1,LionMonkey,2135,370,13,18,31,41.9%,2h
36101,2,Bonitela,2135,206,8,6,14,57.1%,37m
36101,2,Andromedus,2135,182,5,5,10,50.0%,2h
36101,3,[AiMB]WoodytheOG,2135,200,5,8,13,38.5%,19m
36101,3,KaKaYIV,2135,153,4,8,12,33.3%,55m
36101,1,FernoMon,2135,146,4,11,15,26.7%,3h
36101,1,Valoreanthes,2135,48,2,3,5,40.0%,2h
36101,2,Valkyrie,2135,48,2,5,7,28.6%,22m
36101,2,Frosty,2135,96,2,7,9,22.2%,1h
36101,2,Ivanosky,2135,0,1,0,1,100.0%,8m
36101,1,Maton,2135,0,1,0,1,100.0%,2h
36101,2,[MP1]Gupu,2135,30,1,1,2,50.0%,2h
36101,2,Marcelito,2135,0,1,2,3,33.3%,60m
36101,1,virus,2135,48,1,3,4,25.0%,44m
36101,2,creyes,2135,0,0,1,1,0.0%,1m
36101,1,neonfighter,2135,0,0,6,6,0.0%,25m
36122,1,tommy,2134,936,31,36,67,46.3%,1h
36122,2,[HD7K]KNicolas,2134,316,12,8,20,60.0%,19m
36122,2,stiuvenelvro,2134,243,7,11,18,38.9%,2h
36122,2,Roland,2134,134,4,7,11,36.4%,2h
36122,2,Carlomagno,2134,46,2,4,6,33.3%,2h
36122,2,MaGiK,2134,0,1,0,1,100.0%,3h
36122,2,Grogswiper,2134,0,1,2,3,33.3%,15m
36122,2,Mobkiller,2134,0,1,3,4,25.0%,8m
36122,2,jeylan,2134,0,0,1,1,0.0%,2h
36122,2,CrossfireFox,2134,0,0,1,1,0.0%,11m
36122,2,Natsafu,2134,0,0,1,1,0.0%,3m
36122,2,abas,2134,0,0,1,1,0.0%,51m
36122,2,NoVa,2134,0,0,2,2,0.0%,2h
36122,1,[ConFed]winnethepooh,2134,0,0,3,3,0.0%,41m
36122,2,Faceless,2134,0,0,5,5,0.0%,3h
36122,1,Maverick,2134,0,0,7,7,0.0%,44m
36138,1,Zoklev,2133,465,17,23,40,42.5%,53m
36138,2,filorice,2133,294,14,13,27,51.9%,31m
36138,1,Ascentior,2133,290,11,13,24,45.8%,6m
36138,1,MrSparkly,2133,119,6,4,10,60.0%,3h
36138,1,[GC2042]Axolotl,2133,239,4,5,9,44.4%,41m
36138,3,PichuloskY,2133,62,2,8,10,20.0%,2h
36138,1,NickSwisk,2133,48,1,4,5,20.0%,1h
36138,2,Moos,2133,48,1,6,7,14.3%,60m
36138,2,[SONT]Aldosont,2133,0,0,1,1,0.0%,1h
36138,2,chris,2133,0,0,2,2,0.0%,22m
36138,2,WolfmasterMx,2133,0,0,3,3,0.0%,1h
36138,2,CHUGGY,2133,0,0,5,5,0.0%,3h
36150,2,Jie,2132,1331,66,61,127,52.0%,3h
36150,2,Foxlain,2132,1445,55,60,115,47.8%,3h
36150,1,Oorgle,2132,395,15,15,30,50.0%,14m
36150,2,[GEKO]GusNar,2132,214,7,3,10,70.0%,3h
36150,3,Rashcrack,2132,188,6,0,6,100.0%,1h
36150,2,perropatata,2132,168,5,2,7,71.4%,14m
36150,2,xLetzulx,2132,146,5,9,14,35.7%,3h
36150,2,octaviotin,2132,122,4,5,9,44.4%,22m
36150,2,[DETER]ComradeDoppy,2132,214,4,9,13,30.8%,2h
36150,1,scouter,2132,0,2,7,9,22.2%,9m
36150,1,DerpestWolf,2132,0,1,0,1,100.0%,9m
36150,2,DougDimadome,2132,0,1,4,5,20.0%,2h
36150,3,GARDIAN,2132,0,1,7,8,12.5%,2h
36150,2,[7EK]Shishkabob,2132,0,0,2,2,0.0%,30m
36150,2,loidster,2132,0,0,2,2,0.0%,1h
36150,2,BazooKa,2132,0,0,5,5,0.0%,31m
36166,1,MarioJesuus,2131,1741,125,127,252,49.6%,1h
36166,1,Baselerd,2131,771,97,96,193,50.3%,25m
36166,1,Dani,2131,788,26,33,59,44.1%,3h
36166,1,[ZTempz]NeoPeterPan,2131,626,18,29,47,38.3%,1h
36166,1,WilfordBrim,2131,274,9,13,22,40.9%,29m
36166,1,[MexTec]BillytheKid,2131,318,8,14,22,36.4%,1h
36166,1,lolenricoxd,2131,198,5,9,14,35.7%,6m
36166,1,ZodiakSC,2131,122,4,9,13,30.8%,58m
36166,2,Belial,2131,121,3,3,6,50.0%,25m
36166,2,[B33R]CaribouLou,2131,0,1,4,5,20.0%,3h
36166,2,[QW3RTY]DeskWolf,2131,30,1,4,5,20.0%,3h
36166,2,Parallax,2131,0,0,1,1,0.0%,3h
36178,2,[ALLate]mkultra,2130,1108,134,138,272,49.3%,3h
36178,1,CrazyLazyT,2130,1302,46,46,92,50.0%,3h
36178,1,doncuervo,2130,973,39,35,74,52.7%,1h
36178,3,derick,2130,594,19,29,48,39.6%,2h
36178,1,Avatar,2130,424,13,14,27,48.1%,3h
36178,1,hectorconcar,2130,153,5,8,13,38.5%,3h
36178,1,Sinow,2130,153,4,8,12,33.3%,49m
36178,2,xAlinkin,2130,0,2,7,9,22.2%,47m
36178,3,[SINSTR]roberhpp,2130,0,1,0,1,100.0%,41m
36178,2,DeathMuffin,2130,0,1,2,3,33.3%,41m
36178,2,[LTlord]KippaSaurio,2130,0,0,1,1,0.0%,39m
36189,2,RafaelRg,2129,846,34,28,62,54.8%,19m
36189,2,rldlimon,2129,552,20,19,39,51.3%,2h
36189,1,ShadySusy,2129,217,7,7,14,50.0%,44m
36189,1,raulendymion,2129,216,7,13,20,35.0%,2h
36189,1,[maes]craftthis,2129,162,3,11,14,21.4%,3h
36189,1,[Sylis]Mopiere,2129,120,2,7,9,22.2%,47m
36189,1,Heyzues,2129,145,2,7,9,22.2%,34m
36189,2,DarkLord,2129,46,1,1,2,50.0%,52m
36189,1,Hucrot,2129,0,1,5,6,16.7%,3h
36189,1,ALEX,2129,0,1,6,7,14.3%,2h
36189,2,Dirt,2129,0,0,1,1,0.0%,25m
36189,2,BirdmanXD,2129,0,0,1,1,0.0%,3h
36189,2,Vivalavida,2129,0,0,1,1,0.0%,48m
36189,3,AtillatheFun,2129,0,0,3,3,0.0%,1h
36189,2,Ngatai,2129,0,0,5,5,0.0%,3h
36204,1,[hekn]Jret,2128,1537,90,86,176,51.1%,3h
36204,1,[NFKing]SubZerO,2128,356,27,29,56,48.2%,3h
36204,2,[1for2]javixF,2128,437,18,14,32,56.2%,3h
36204,1,[7FP]Nimbus,2128,198,5,16,21,23.8%,7m
36204,2,Zetny,2128,58,4,5,9,44.4%,7m
36204,2,SifirDK,2128,100,4,5,9,44.4%,58m
36204,1,GoMarines,2128,145,2,4,6,33.3%,27m
36204,1,Goldfish,2128,48,2,7,9,22.2%,3h
36204,2,Fedwig,2128,30,1,1,2,50.0%,3h
36204,2,yumikat,2128,46,1,3,4,25.0%,7m
36204,1,[Amoove]CptWasabi,2128,0,0,5,5,0.0%,5m
36215,1,[Deleto]JontyTowers,2127,1756,90,100,190,47.4%,3h
36215,1,[LOHs]popin,2127,317,22,29,51,43.1%,2h
36215,1,Dan,2127,478,14,27,41,34.1%,58m
36215,2,Kiwala,2127,352,12,8,20,60.0%,14m
36215,2,[VFam]Fury,2127,176,7,4,11,63.6%,14m
36215,1,[ActUse]Wheezy,2127,171,7,6,13,53.8%,2h
36215,1,MajorDOT,2127,48,2,7,9,22.2%,3h
36215,2,ablindman,2127,0,1,0,1,100.0%,2h
36215,3,kemol,2127,97,1,1,2,50.0%,21m
36215,2,Leblanc,2127,30,1,2,3,33.3%,2h
36215,1,Steve,2127,113,1,6,7,14.3%,3h
36215,2,Hermendas,2127,0,0,1,1,0.0%,38m
36215,1,Nomoe,2127,0,0,1,1,0.0%,2h
36215,2,Necros,2127,0,0,5,5,0.0%,1h
36215,2,scara,2127,0,0,5,5,0.0%,2h
36230,1,DreamState,2126,414,13,20,33,39.4%,1h
36230,2,pplarge,2126,383,13,20,33,39.4%,3h
36230,3,[SKES]Drausio,2126,242,8,2,10,80.0%,2h
36230,2,ranezu,2126,158,5,8,13,38.5%,3h
36230,1,Carson,2126,241,5,9,14,35.7%,3h
36230,2,Legend,2126,0,1,0,1,100.0%,19m
36230,2,Juan,2126,0,1,4,5,20.0%,4m
36230,3,ARKANGEL,2126,0,0,1,1,0.0%,48m
36230,1,Chybo,2126,0,0,3,3,0.0%,22m
36230,2,Atros,2126,0,0,5,5,0.0%,3h
36230,2,Twelve,2126,0,0,5,5,0.0%,2h
36241,1,BrodaciousD,2125,334,8,12,20,40.0%,3h
36241,2,booya,2125,224,7,8,15,46.7%,54m
36241,2,MoOnX,2125,146,5,6,11,45.5%,2h
36241,2,McWizard,2125,96,3,4,7,42.9%,2h
36241,1,JediZeroCool,2125,117,2,3,5,40.0%,3h
36241,2,Tucson,2125,0,1,1,2,50.0%,3h
36241,1,[CrazyC]Antaury,2125,97,1,1,2,50.0%,1h
36241,2,XeroXen,2125,97,1,6,7,14.3%,3h
36241,2,maverick,2125,0,0,1,1,0.0%,54m
36241,2,killalphaout,2125,0,0,1,1,0.0%,3h
36241,2,[BraziI]chiky,2125,0,0,2,2,0.0%,2h
36241,2,dinobooot,2125,0,0,2,2,0.0%,11m
36253,2,Maltaman,2124,412,40,28,68,58.8%,44m
36253,1,PugsWithMugs,2124,498,18,31,49,36.7%,1h
36253,2,Sinrob,2124,554,17,20,37,45.9%,2h
36253,1,Pyro,2124,532,15,21,36,41.7%,1h
36253,2,xiaoGayly,2124,262,12,7,19,63.2%,2h
36253,2,MurKy,2124,294,11,4,15,73.3%,3h
36253,1,diGGEr,2124,176,6,10,16,37.5%,2h
36253,2,CHADALAK,2124,148,5,7,12,41.7%,2h
36253,1,Solman,2124,213,4,9,13,30.8%,42m
36253,2,VACation,2124,88,3,8,11,27.3%,58m
36253,2,iLuMiNaTi,2124,0,1,0,1,100.0%,3h
36253,2,Nico,2124,31,1,2,3,33.3%,2h
36253,2,Lobstertorch,2124,0,0,1,1,0.0%,2h
36253,2,Razherrt,2124,0,0,1,1,0.0%,48m
36253,1,Adoy,2124,0,0,2,2,0.0%,42m
36253,1,Superior,2124,0,0,3,3,0.0%,49m
36253,2,CaiquegoesI,2124,0,0,5,5,0.0%,7m
36270,1,onetimeuser,2123,1675,162,161,323,50.2%,59m
36270,1,Odiseo,2123,936,55,53,108,50.9%,3h
36270,2,QualityCTRL,2123,676,52,22,74,70.3%,3h
36270,1,Slaytanic,2123,1182,47,48,95,49.5%,2h
36270,1,Zut,2123,812,27,30,57,47.4%,2h
36270,2,enuve,2123,348,12,7,19,63.2%,15m
36270,1,[AbcCo]sickboy,2123,34,5,6,11,45.5%,59m
36270,2,Sputnik,2123,150,4,7,11,36.4%,1m
36270,2,jjoshie,2123,136,4,13,17,23.5%,1h
36270,2,[GrnBrd]DarthBrookes,2123,0,2,1,3,66.7%,2h
36270,2,Grave,2123,30,2,2,4,50.0%,3h
36270,3,Syluna,2123,97,1,1,2,50.0%,2h
36270,2,DragónLeón,2123,0,1,1,2,50.0%,2h
36270,1,Heavystorm,2123,0,1,6,7,14.3%,2h
36270,1,hoovooloo,2123,0,0,1,1,0.0%,2h
36270,3,isotopoloco,2123,0,0,1,1,0.0%,48m
36270,2,Javengers,2123,0,0,1,1,0.0%,6m
36287,1,Srolikan,2122,764,70,68,138,50.7%,2h
36287,1,OberKammando,2122,603,49,51,100,49.0%,3h
36287,2,[MFMS]deathtoch,2122,372,13,11,24,54.2%,13m
36287,2,[CraCan]scannerxt,2122,336,12,12,24,50.0%,2h
36287,1,Gauss,2122,344,10,18,28,35.7%,59m
36287,2,PartinGG,2122,124,2,3,5,40.0%,4m
36287,2,CharsLover,2122,30,2,4,6,33.3%,12m
36287,1,Johnnyplunk,2122,48,1,1,2,50.0%,1h
36287,1,Garrett,2122,91,1,7,8,12.5%,29m
36287,1,Beargar,2122,0,0,1,1,0.0%,2h
36287,2,Dante,2122,0,0,5,5,0.0%,2h
36298,1,Raven,2121,1106,39,43,82,47.6%,2h
36298,2,Waly,2121,932,33,35,68,48.5%,1h
36298,2,tupac,2121,767,31,25,56,55.4%,22m
36298,3,IIIIIIIIIIII,2121,229,8,1,9,88.9%,2h
36298,1,SKorn,2121,116,7,4,11,63.6%,3h
36298,2,xFickle,2121,144,7,8,15,46.7%,1h
36298,1,dibis,2121,208,7,13,20,35.0%,2h
36298,2,[TGCrew]mythical,2121,70,6,10,16,37.5%,14m
36298,2,zerico,2121,118,5,4,9,55.6%,1h
36298,2,[CHL0NG]MaxWellhouse,2121,30,2,0,2,100.0%,13m
36298,2,ginovr,2121,32,2,0,2,100.0%,1h
36298,2,[HN504]noobleak,2121,123,2,5,7,28.6%,2h
36298,2,asdf,2121,0,1,5,6,16.7%,7m
36298,2,cubo,2121,0,0,4,4,0.0%,32m
36298,2,Traus,2121,0,0,5,5,0.0%,51m
36313,1,OZLO,2120,1751,154,161,315,48.9%,1h
36313,1,LeonHard,2120,1714,134,131,265,50.6%,29m
36313,2,[KhanZ]Twist,2120,1384,93,102,195,47.7%,1h
36313,1,Zergatory,2120,858,42,48,90,46.7%,1h
36313,1,[Spænkd]BusinessMan,2120,544,21,22,43,48.8%,3h
36313,1,Cbrizzall,2120,385,16,12,28,57.1%,23m
36313,2,GenErrante,2120,372,15,12,27,55.6%,2h
36313,1,Doney,2120,356,14,19,33,42.4%,3h
36313,1,Caterpie,2120,279,9,10,19,47.4%,1h
36313,2,Androbot,2120,196,7,4,11,63.6%,1h
36313,1,ChrisDavies,2120,243,5,4,9,55.6%,1h
36313,2,Hellscream,2120,48,2,7,9,22.2%,51m
36313,2,freshflea,2120,48,1,3,4,25.0%,1h
36313,2,[S420W]Rashhhh,2120,0,1,4,5,20.0%,2h
36327,1,BEVAN,2119,1070,38,37,75,50.7%,2h
36327,1,DoUNOKimchi,2119,873,28,35,63,44.4%,2h
36327,1,RedBird,2119,794,27,24,51,52.9%,28m
36327,1,Borregong,2119,688,26,23,49,53.1%,23m
36327,2,Alp,2119,136,4,6,10,40.0%,23m
36327,1,[DkVb]DTCory,2119,96,2,4,6,33.3%,1h
36327,2,[KG73]AlexThor,2119,48,1,1,2,50.0%,1h
36327,1,[BP8S]ddddurrrrrrr,2119,0,1,6,7,14.3%,3h
36327,2,Crank,2119,0,0,1,1,0.0%,54m
36336,2,[OVRSOC]FolkRebel,2118,567,18,24,42,42.9%,54m
36336,2,ironweezle,2118,82,4,1,5,80.0%,41m
36336,2,max,2118,121,3,8,11,27.3%,58m
36336,2,keanu,2118,30,2,0,2,100.0%,20m
36336,2,Ivan,2118,0,2,5,7,28.6%,1h
36336,3,SvyatoyOtez,2118,97,1,1,2,50.0%,42m
36336,1,youngson,2118,48,1,2,3,33.3%,1h
36336,2,itzimperial,2118,0,1,3,4,25.0%,2h
36344,1,Kimo,2117,1726,85,90,175,48.6%,3h
36344,2,BolsonaroRJ,2117,877,37,28,65,56.9%,49m
36344,1,[Chuchi]RiflePoet,2117,1082,36,41,77,46.8%,25m
36344,1,cndnsinger,2117,652,21,23,44,47.7%,2h
36344,2,[MABOY]Bora,2117,524,20,20,40,50.0%,2h
36344,2,OptiMystiC,2117,370,12,16,28,42.9%,56m
36344,2,ZayNar,2117,342,11,7,18,61.1%,31m
36344,3,[GTO4]AkhunDelar,2117,121,3,6,9,33.3%,19m
36344,2,Raz,2117,48,2,4,6,33.3%,2h
36344,1,pixthegost,2117,34,2,7,9,22.2%,3h
36344,2,BlackGuy,2117,48,1,7,8,12.5%,2h
36344,2,Buck,2117,0,0,1,1,0.0%,43m
36344,2,Jmorfa,2117,0,0,5,5,0.0%,39m
36357,2,[XGang]JayKay,2116,747,25,28,53,47.2%,3h
36357,3,StarCars,2116,284,11,16,27,40.7%,19m
36357,1,RonHua,2116,265,6,12,18,33.3%,2h
36357,1,IIDarkProII,2116,142,4,0,4,100.0%,2h
36357,1,MRREEEEETTV,2116,191,4,9,13,30.8%,47m
36357,3,QuickshotFox,2116,60,4,10,14,28.6%,15m
36357,2,Wheatie,2116,92,3,4,7,42.9%,2h
36357,1,fryzie,2116,76,3,9,12,25.0%,1h
36357,2,Marc,2116,0,1,1,2,50.0%,3h
36357,2,ApT,2116,0,0,1,1,0.0%,2h
36357,2,[DOINB]AceL,2116,0,0,1,1,0.0%,41m
36357,2,esclerglade,2116,0,0,1,1,0.0%,51m
36357,2,Zireael,2116,0,0,5,5,0.0%,3h
36370,2,Bilursag,2115,1466,87,84,171,50.9%,2m
36370,2,SavagePoodle,2115,1121,75,79,154,48.7%,3h
36370,1,Vdubkrob,2115,1015,39,50,89,43.8%,1h
36370,1,[Deathl]Furmiguinha,2115,422,23,24,47,48.9%,3h
36370,2,Sputnik,2115,534,21,21,42,50.0%,2h
36370,2,Hetrovono,2115,233,8,8,16,50.0%,1h
36370,2,poliozerglin,2115,150,6,9,15,40.0%,1h
36370,2,[SWOU]spartanops,2115,166,5,7,12,41.7%,56m
36370,2,[GdAT]Righteousnes,2115,0,1,4,5,20.0%,2h
36370,2,[Bommmm]CapeGoblin,2115,32,1,6,7,14.3%,44m
36380,1,[Colrs]charizma,2114,1090,62,63,125,49.6%,2h
36380,1,Happytaco,2114,426,11,18,29,37.9%,1h
36380,2,[ThCz]Wraith,2114,196,6,4,10,60.0%,1h
36380,1,[TFC37]Dman,2114,148,5,11,16,31.2%,1h
36380,2,[SWOU]Anominacion,2114,62,2,7,9,22.2%,41m
36380,1,[D10S]Arthas,2114,0,1,8,9,11.1%,60m
36380,2,[DaFew]Shawdster,2114,0,0,1,1,0.0%,22m
36387,1,OrbOfChaos,2113,1700,68,67,135,50.4%,2h
36387,3,Pieroyya,2113,283,9,9,18,50.0%,13m
36387,2,guido,2113,92,4,1,5,80.0%,3h
36387,2,raul,2113,70,2,1,3,66.7%,3h
36387,2,Corruption,2113,134,2,6,8,25.0%,2h
36387,2,Monstrum,2113,62,2,8,10,20.0%,2h
36387,2,simulation,2113,0,1,1,2,50.0%,3h
36387,2,Boyscout,2113,0,1,2,3,33.3%,3h
36387,1,HurigDennard,2113,0,1,6,7,14.3%,46m
36387,1,retziel,2113,0,1,6,7,14.3%,2h
36387,3,Primate,2113,0,1,8,9,11.1%,2h
36387,3,TrumpYeezy,2113,0,0,1,1,0.0%,58m
36387,2,[Algebr]MathTeacher,2113,0,0,3,3,0.0%,2h
36400,1,[Crip1]Zergaholic,2112,1689,328,344,672,48.8%,2h
36400,1,Ozzmosis,2112,1522,127,128,255,49.8%,3h
36400,1,Finith,2112,1052,43,35,78,55.1%,2h
36400,2,Mechanicore,2112,158,7,8,15,46.7%,1h
36400,1,Matador,2112,88,3,5,8,37.5%,23m
36400,2,Gedeon,2112,96,3,6,9,33.3%,52m
36400,1,Adgor,2112,30,2,8,10,20.0%,2h
36400,2,[Etfine]Drixenol,2112,0,1,0,1,100.0%,2h
36400,2,Drexciya,2112,0,0,1,1,0.0%,14m
36400,3,[simp34]Mashall,2112,0,0,2,2,0.0%,18m
36400,2,mecano,2112,0,0,4,4,0.0%,3h
36400,2,matchpoint,2112,0,0,5,5,0.0%,43m
36412,1,erickpve,2111,1721,79,88,167,47.3%,2h
36412,2,SgRedeemer,2111,548,20,16,36,55.6%,2h
36412,2,Cthulhu,2111,471,18,15,33,54.5%,2h
36412,2,Luxemburgo,2111,280,12,12,24,50.0%,1h
36412,2,DOLL,2111,357,11,18,29,37.9%,3m
36412,2,Gunslinger,2111,224,8,7,15,53.3%,1h
36412,2,likmedik,2111,242,8,12,20,40.0%,1h
36412,2,[Preran]guachimiri,2111,145,3,3,6,50.0%,3h
36412,2,[MNVN]Perdue,2111,124,3,9,12,25.0%,3m
36412,1,JRoc,2111,0,2,7,9,22.2%,3h
36412,2,alsimmons,2111,30,1,1,2,50.0%,2h
36412,3,milesatra,2111,0,1,1,2,50.0%,2h
36412,2,Necreport,2111,97,1,5,6,16.7%,2h
36412,2,Navi,2111,48,1,6,7,14.3%,1h
36412,1,Beastman,2111,0,1,7,8,12.5%,3h
36412,2,[TCOIH]ShadowCaster,2111,0,0,1,1,0.0%,2h
36412,2,Magnunn,2111,0,0,1,1,0.0%,3h
36412,2,JMFV,2111,0,0,1,1,0.0%,7m
36412,2,Threesixteen,2111,0,0,4,4,0.0%,3m
36431,1,[xDYEx]MERCENARIO,2110,1564,96,90,186,51.6%,31m
36431,1,ProfitOfDoom,2110,1012,49,42,91,53.8%,43m
36431,1,Ackbar,2110,1244,46,51,97,47.4%,43m
36431,1,NoSkillDave,2110,192,6,9,15,40.0%,3h
36431,2,Xavity,2110,124,5,4,9,55.6%,53m
36431,1,[Monrom]ella,2110,96,3,10,13,23.1%,41m
36431,2,[UpxV]RAYDER,2110,0,2,1,3,66.7%,1h
36431,1,Gisastoj,2110,42,2,9,11,18.2%,2h
36431,2,BlackGhost,2110,0,1,0,1,100.0%,1h
36431,1,[Chihui]Wilsao,2110,0,1,6,7,14.3%,1h
36431,3,Exodeus,2110,0,0,1,1,0.0%,28m
36431,2,Bismarck,2110,0,0,1,1,0.0%,56m
36431,2,[ROSC2]ZhusLyth,2110,0,0,2,2,0.0%,2h
36431,2,Tarakhan,2110,0,0,5,5,0.0%,40m
36431,2,SpaceBlock,2110,0,0,5,5,0.0%,3h
36446,1,[DRKESP]Krgansgrampa,2109,1709,373,386,759,49.1%,46m
36446,1,Seltzer,2109,1077,250,247,497,50.3%,27m
36446,1,BlueMachine,2109,1689,123,124,247,49.8%,41m
36446,2,Crab,2109,1149,86,89,175,49.1%,37m
36446,2,GenadiBukin,2109,414,31,31,62,50.0%,14m
36446,2,Conda,2109,460,18,12,30,60.0%,53m
36446,2,PPGG,2109,468,17,22,39,43.6%,55m
36446,2,KeaSon,2109,353,14,11,25,56.0%,22m
36446,2,[Eagle1]WhiteEagle,2109,179,4,4,8,50.0%,1h
36446,1,Jimmy,2109,97,3,6,9,33.3%,20m
36446,2,[ZTemp]Wolv,2109,150,3,9,12,25.0%,1h
36446,1,THESALTLORD,2109,123,2,6,8,25.0%,55m
36446,2,Waddar,2109,0,0,1,1,0.0%,3h
36446,1,[BAMF]BadJudgment,2109,0,0,3,3,0.0%,3h
36446,2,Ritchie,2109,0,0,5,5,0.0%,49m
36461,2,RoninWorkout,2108,1624,83,83,166,50.0%,49m
36461,1,IBLACKIHEART,2108,1242,44,48,92,47.8%,1h
36461,2,blackfire,2108,785,28,33,61,45.9%,53m
36461,1,Masterwolf,2108,825,28,38,66,42.4%,43m
36461,2,[ADEP]KalixDrake,2108,392,16,21,37,43.2%,3h
36461,1,Mikey,2108,473,13,18,31,41.9%,3h
36461,1,SowFar,2108,330,10,9,19,52.6%,1h
36461,1,[AOrder]SpiritEater,2108,264,8,15,23,34.8%,3h
36461,1,RaynorV,2108,162,7,15,22,31.8%,3h
36461,2,Jellyman,2108,164,4,8,12,33.3%,48m
36461,3,Cocomax,2108,30,3,9,12,25.0%,28m
36461,1,pizzo,2108,0,2,4,6,33.3%,2h
36461,2,WDNMD,2108,30,2,5,7,28.6%,3h
36461,1,Shibbs,2108,0,1,0,1,100.0%,2h
36461,2,taelesh,2108,0,0,2,2,0.0%,25m
36461,2,Skyra,2108,0,0,2,2,0.0%,60m
36461,1,Rodrigo,2108,0,0,4,4,0.0%,46m
36461,3,[SCRlM]Bonzalez,2108,0,0,5,5,0.0%,2h
36479,2,Phelix,2107,1251,97,99,196,49.5%,1h
36479,1,[xNG3x]TDiddy,2107,1703,88,83,171,51.5%,25m
36479,1,iMUSE,2107,1022,33,43,76,43.4%,2h
36479,2,Wolfrick,2107,497,19,24,43,44.2%,19m
36479,1,Slade,2107,383,14,21,35,40.0%,2h
36479,2,Fdsk,2107,348,12,14,26,46.2%,3h
36479,1,orcotuna,2107,290,10,17,27,37.0%,1h
36479,2,SoDeeeeeeep,2107,158,8,10,18,44.4%,1h
36479,1,TonTon,2107,0,1,1,2,50.0%,38m
36479,2,Pet,2107,0,0,1,1,0.0%,3h
36479,1,Nurax,2107,0,0,3,3,0.0%,2h
36490,2,thechosenone,2106,512,38,54,92,41.3%,1h
36490,2,Connorzxl,2106,814,31,33,64,48.4%,58m
36490,2,samurobot,2106,288,9,12,21,42.9%,15m
36490,1,Wonderhorn,2106,253,7,15,22,31.8%,3h
36490,2,Cademan,2106,122,5,2,7,71.4%,2h
36490,2,melevan,2106,130,4,8,12,33.3%,41m
36490,2,mithrandir,2106,0,3,2,5,60.0%,2h
36490,3,Frank,2106,60,3,10,13,23.1%,57m
36490,2,BevoLonghorn,2106,88,2,1,3,66.7%,1h
36490,2,LawmanIV,2106,70,2,3,5,40.0%,3h
36490,2,[BzDp]Spydattack,2106,0,1,0,1,100.0%,2h
36490,3,Mordecai,2106,0,1,0,1,100.0%,3h
36490,2,tsunamiarrow,2106,0,0,1,1,0.0%,3h
36490,2,Riddickk,2106,0,0,1,1,0.0%,3h
36490,2,GROZLEX,2106,0,0,1,1,0.0%,56m
36490,2,Goomba,2106,0,0,5,5,0.0%,2h
36506,2,Fabulouslife,2105,818,30,28,58,51.7%,41m
36506,1,Yisushh,2105,304,10,13,23,43.5%,55m
36506,2,[SUDAKA]ElMataPerras,2105,92,3,2,5,60.0%,31m
36506,1,Schubaltz,2105,138,3,8,11,27.3%,2h
36506,2,Devin,2105,62,2,7,9,22.2%,3h
36506,2,Spazmo,2105,143,2,7,9,22.2%,2h
36506,2,[SYNDCT]Unicorn,2105,34,1,2,3,33.3%,3h
36506,1,zergrush,2105,0,0,1,1,0.0%,1h
36506,2,[XpKAc]Koin,2105,0,0,5,5,0.0%,2h
36515,1,McJoey,2104,1368,223,235,458,48.7%,1h
36515,2,KingKringlet,2104,1582,125,138,263,47.5%,4m
36515,3,[F4GG]rePhy,2104,889,29,42,71,40.8%,1h
36515,2,Duke,2104,594,20,23,43,46.5%,3h
36515,1,normalbrain,2104,524,17,27,44,38.6%,34m
36515,2,eliteleadrr,2104,426,16,11,27,59.3%,3h
36515,2,plentyplenty,2104,283,14,1,15,93.3%,3h
36515,2,Ether,2104,248,7,10,17,41.2%,31m
36515,1,[EpicG]King,2104,238,6,13,19,31.6%,2h
36515,1,Dankful,2104,210,5,10,15,33.3%,13m
36515,1,ralph,2104,82,4,8,12,33.3%,3h
36515,1,SanKeR,2104,0,2,5,7,28.6%,49m
36515,1,Chestiter,2104,46,2,6,8,25.0%,3h
36515,2,[AtiRoL]Navi,2104,0,0,5,5,0.0%,1h
36515,2,Kolobok,2104,0,0,5,5,0.0%,1h
36515,2,zZThuyZz,2104,0,0,5,5,0.0%,11m
36515,2,Grimi,2104,0,0,6,6,0.0%,1h
36532,2,Kchorro,2103,1511,66,59,125,52.8%,1h
36532,1,MonstaGoliat,2103,593,23,22,45,51.1%,25m
36532,1,[DaFish]XxCHAOSxX,2103,504,21,18,39,53.8%,2h
36532,1,Holsch,2103,668,20,24,44,45.5%,2h
36532,2,[BRobli]Tdestroyer,2103,362,12,18,30,40.0%,2h
36532,2,Doomsiren,2103,340,11,17,28,39.3%,48m
36532,2,[1v1me]SCUnicorn,2103,130,4,2,6,66.7%,3h
36532,1,mbr,2103,48,4,5,9,44.4%,2h
36532,2,Reis,2103,92,3,4,7,42.9%,39m
36532,1,Federcio,2103,0,1,1,2,50.0%,3h
36532,2,mApleStriKe,2103,34,1,3,4,25.0%,52m
36532,2,[HIBOYZ]Artanis,2103,0,0,1,1,0.0%,40m
36532,2,pepe,2103,0,0,1,1,0.0%,20m
36532,2,ptyred,2103,0,0,5,5,0.0%,40m
36532,2,Nefarox,2103,0,0,5,5,0.0%,1h
36532,2,Spongy,2103,0,0,5,5,0.0%,1h
36548,1,Sid,2102,942,29,33,62,46.8%,3h
36548,2,dellano,2102,730,28,27,55,50.9%,1h
36548,1,ChrisWhyTY,2102,277,7,6,13,53.8%,41m
36548,1,Armadica,2102,197,5,7,12,41.7%,40m
36548,2,Oversear,2102,98,4,6,10,40.0%,49m
36548,2,zero,2102,58,2,1,3,66.7%,44m
36548,2,Evan,2102,66,2,4,6,33.3%,2h
36548,2,[NoFrac]chaseno,2102,46,1,5,6,16.7%,1h
36548,2,wrothbow,2102,0,0,1,1,0.0%,4m
36548,2,space,2102,0,0,4,4,0.0%,2h
36548,1,SombrA,2102,0,0,5,5,0.0%,3m
36548,2,HamSandwich,2102,0,0,5,5,0.0%,32m
36560,2,brunao,2101,231,10,7,17,58.8%,1h
36560,2,[USplan]bobgokou,2101,256,8,8,16,50.0%,3h
36560,2,Todd,2101,154,6,3,9,66.7%,3h
36560,3,ericshen,2101,60,4,9,13,30.8%,34m
36560,2,Klee,2101,86,3,8,11,27.3%,15m
36560,1,WonnieJuu,2101,136,2,8,10,20.0%,2h
36560,1,Chomamonka,2101,48,1,1,2,50.0%,2h
36560,1,MaruJR,2101,88,1,4,5,20.0%,14m
36560,2,Veers,2101,30,1,5,6,16.7%,2h
36560,2,BSmooth,2101,0,0,1,1,0.0%,1h
36560,2,Swidge,2101,0,0,1,1,0.0%,7m
36560,2,EvilKenshin,2101,0,0,1,1,0.0%,1h
36560,2,[SANGRE]SMach,2101,0,0,5,5,0.0%,3h
36573,3,Rasputin,2100,585,116,120,236,49.2%,12m
36573,1,MagicTurtle,2100,1575,72,74,146,49.3%,41m
36573,1,MychalM,2100,849,27,31,58,46.6%,2h
36573,2,alejandro,2100,636,26,16,42,61.9%,1h
36573,2,Shunzilla,2100,615,23,20,43,53.5%,38m
36573,2,Mithrandir,2100,653,23,24,47,48.9%,54m
36573,2,TerranYouUp,2100,464,15,23,38,39.5%,2h
36573,3,grecia,2100,240,9,11,20,45.0%,18m
36573,2,solt,2100,175,7,2,9,77.8%,1h
36573,1,Horizon,2100,165,5,8,13,38.5%,23m
36573,1,Dnysc,2100,116,3,7,10,30.0%,31m
36573,2,AwesomeSauce,2100,130,2,2,4,50.0%,14m
36573,2,[BigMcS]Opaloso,2100,0,1,0,1,100.0%,2h
36573,2,[AbcCo]sopaxx,2100,0,1,0,1,100.0%,2h
36573,2,ThEvOlTa,2100,46,1,1,2,50.0%,2h
36573,1,TWEELAD,2100,95,1,2,3,33.3%,1h
36573,1,[SHFO]Watering,2100,30,1,8,9,11.1%,22m
36573,2,LocoCalato,2100,0,0,1,1,0.0%,2h
36573,1,Sebo,2100,0,0,3,3,0.0%,44m
36573,2,DoctorDunlap,2100,0,0,5,5,0.0%,2h
36593,2,Fingolfin,2099,791,34,34,68,50.0%,1h
36593,2,MisterZed,2099,46,4,3,7,57.1%,8m
36593,2,DREEP,2099,110,4,5,9,44.4%,14m
36593,2,youmannaguy,2099,86,3,2,5,60.0%,3h
36593,2,[FiRiKS]MOTE,2099,30,1,2,3,33.3%,23m
36593,1,lowpeasy,2099,48,1,4,5,20.0%,3m
36593,2,wooba,2099,0,0,1,1,0.0%,3h
36593,2,theimmortal,2099,0,0,6,6,0.0%,15m
36601,2,ERI,2098,771,33,33,66,50.0%,2h
36601,2,Zergalerg,2098,410,20,18,38,52.6%,4m
36601,1,Terline,2098,396,15,22,37,40.5%,44m
36601,2,Hiver,2098,394,14,13,27,51.9%,19m
36601,2,Lout,2098,396,14,17,31,45.2%,3h
36601,1,[NAGGR5]Cirrus,2098,327,8,31,39,20.5%,2h
36601,1,[FeedUs]Finally,2098,221,7,15,22,31.8%,3h
36601,1,Bozo,2098,172,5,24,29,17.2%,47m
36601,2,CIS,2098,30,3,3,6,50.0%,2h
36601,2,comandoepapu,2098,90,3,4,7,42.9%,3h
36601,2,Icebreaker,2098,30,2,2,4,50.0%,58m
36601,2,flicly,2098,0,2,3,5,40.0%,13m
36601,1,gotime,2098,96,1,2,3,33.3%,2h
36601,3,Astro,2098,0,1,3,4,25.0%,56m
36601,1,[P0WA]GATOOOOOOOOO,2098,0,1,3,4,25.0%,3h
36601,2,[Very]Skyptical,2098,0,0,1,1,0.0%,52m
36601,2,Vipro,2098,0,0,4,4,0.0%,2h
36618,1,Corioa,2097,1666,122,135,257,47.5%,2h
36618,2,DGEAR,2097,874,83,69,152,54.6%,2h
36618,1,[Over1]blackcaptain,2097,1096,53,50,103,51.5%,44m
36618,1,Leido,2097,737,31,30,61,50.8%,1h
36618,1,Meevil,2097,268,8,16,24,33.3%,17m
36618,2,[MMPR2]TheBody,2097,120,2,2,4,50.0%,15m
36618,3,[Exper]JACKATLAS,2097,0,1,0,1,100.0%,24m
36618,2,villevalo,2097,0,1,0,1,100.0%,7m
36618,2,hotcheetos,2097,0,1,1,2,50.0%,3h
36618,2,girafffe,2097,30,1,2,3,33.3%,3h
36618,3,Vassig,2097,0,0,1,1,0.0%,36m
36618,2,juan,2097,0,0,6,6,0.0%,2h
36630,1,Slowhand,2096,1688,173,181,354,48.9%,24m
36630,2,DrFlahooty,2096,1080,40,39,79,50.6%,37m
36630,2,Paranoid,2096,288,10,12,22,45.5%,56m
36630,2,RadagastQlo,2096,296,9,11,20,45.0%,3h
36630,1,Killman,2096,174,7,7,14,50.0%,2h
36630,1,Rocky,2096,162,4,8,12,33.3%,34m
36630,2,PitLorde,2096,58,3,4,7,42.9%,19m
36630,2,Deestoryer,2096,0,1,1,2,50.0%,31m
36630,1,Timinator,2096,0,1,7,8,12.5%,1h
36630,2,Shamanei,2096,0,0,4,4,0.0%,2h
36630,2,Aegaetis,2096,0,0,5,5,0.0%,2h
36641,2,[mnsfld]shadow,2095,1252,54,61,115,47.0%,56m
36641,1,MrNoob,2095,372,15,23,38,39.5%,47m
36641,1,[MPC]ThexArtistx,2095,174,7,10,17,41.2%,2h
36641,1,CodeBuilder,2095,188,6,9,15,40.0%,2h
36641,2,Crillic,2095,62,4,2,6,66.7%,1h
36641,1,[PoWs]Crackle,2095,218,4,8,12,33.3%,27m
36641,2,HighDro,2095,30,2,1,3,66.7%,40m
36641,1,Zognolo,2095,0,2,6,8,25.0%,20m
36641,2,[L0GZ]JSO,2095,92,2,7,9,22.2%,60m
36641,1,jindacool,2095,48,1,6,7,14.3%,2h
36641,2,AngelOfDeath,2095,0,0,1,1,0.0%,2h
36641,2,ShibyLeBeouf,2095,0,0,5,5,0.0%,2h
36653,1,ZoConn,2094,1346,49,61,110,44.5%,27m
36653,2,RedQuill,2094,981,39,30,69,56.5%,56m
36653,1,Anokolisa,2094,898,33,35,68,48.5%,29m
36653,2,PizzaioloNL,2094,364,21,18,39,53.8%,1h
36653,1,wildz,2094,622,20,28,48,41.7%,2h
36653,2,[CPL7]Andreyiti,2094,437,18,11,29,62.1%,60m
36653,2,Buddpudge,2094,478,14,21,35,40.0%,2h
36653,2,FSDRKSLDR,2094,323,10,16,26,38.5%,41m
36653,2,acdcnut,2094,240,9,9,18,50.0%,54m
36653,1,Rebel,2094,155,7,5,12,58.3%,1h
36653,2,Nash,2094,164,5,11,16,31.2%,2h
36653,3,[BSauce]Sybenz,2094,30,2,6,8,25.0%,27m
36653,2,SupayPisco,2094,0,1,4,5,20.0%,32m
36653,2,envokezYT,2094,0,1,4,5,20.0%,40m
36653,2,EcartNameir,2094,0,0,1,1,0.0%,1h
36653,2,Chutata,2094,0,0,5,5,0.0%,2h
36669,1,DopamineRush,2093,920,89,102,191,46.6%,53m
36669,1,sossy,2093,1703,66,70,136,48.5%,3h
36669,1,Milo,2093,1505,61,65,126,48.4%,3h
36669,2,BQsauce,2093,1004,38,39,77,49.4%,1h
36669,2,[UTSG]Dragen,2093,1038,38,44,82,46.3%,3h
36669,2,[DDOINK]Mal,2093,627,24,17,41,58.5%,1h
36669,3,lmMike,2093,453,15,25,40,37.5%,2h
36669,3,Mccordman,2093,196,10,19,29,34.5%,17m
36669,2,Biplex,2093,200,6,2,8,75.0%,3h
36669,2,DaniloCivil,2093,124,2,5,7,28.6%,14m
36669,2,[MATTO]SneakyWombat,2093,0,1,0,1,100.0%,1h
36669,2,Papagal,2093,46,1,1,2,50.0%,31m
36669,2,Killcide,2093,30,1,4,5,20.0%,38m
36669,2,kiaaaaaaaaaa,2093,40,1,6,7,14.3%,2h
36669,2,[ACCBLD]Grimwolf,2093,0,0,1,1,0.0%,3h
36669,2,Spergling,2093,0,0,1,1,0.0%,2h
36669,2,RYSE,2093,0,0,1,1,0.0%,55m
36669,2,Maiev,2093,0,0,1,1,0.0%,48m
36669,2,Sparticus,2093,0,0,3,3,0.0%,2h
36688,1,Sam,2092,1193,138,146,284,48.6%,2h
36688,1,PastorM,2092,1305,42,48,90,46.7%,2h
36688,2,ReseT,2092,524,18,19,37,48.6%,3h
36688,2,Gimbborim,2092,160,13,9,22,59.1%,3h
36688,2,MarineGirl,2092,305,10,9,19,52.6%,52m
36688,1,HoldingW,2092,234,9,10,19,47.4%,2h
36688,2,Xandros,2092,241,7,11,18,38.9%,3h
36688,1,MrHooper,2092,263,6,12,18,33.3%,2h
36688,2,Shadow,2092,30,2,0,2,100.0%,3h
36688,2,Grak,2092,0,1,0,1,100.0%,58m
36688,1,Trumpsuckz,2092,40,1,1,2,50.0%,3h
36688,2,ChibiMoon,2092,0,0,1,1,0.0%,2h
36688,2,Canaca,2092,0,0,5,5,0.0%,7m
36701,1,Ardas,2091,969,48,42,90,53.3%,2h
36701,1,Pride,2091,785,26,31,57,45.6%,3h
36701,2,LeeNR,2091,689,25,21,46,54.3%,2h
36701,2,[GayFsh]Johnson,2091,44,2,7,9,22.2%,2h
36701,1,[MyT]carpaltunnel,2091,141,2,9,11,18.2%,27m
36701,2,KozukiOden,2091,0,1,0,1,100.0%,1h
36701,2,TheNoobOne,2091,30,1,4,5,20.0%,3h
36701,1,Franklin,2091,0,0,1,1,0.0%,2h
36701,2,DrSmoo,2091,0,0,5,5,0.0%,48m
36701,2,INVASOR,2091,0,0,5,5,0.0%,1h
36701,2,Fusion,2091,0,0,5,5,0.0%,1h
36712,2,NerdyOctopus,2090,1572,87,102,189,46.0%,3h
36712,2,kmaradarti,2090,852,33,31,64,51.6%,3h
36712,1,Cruzonjaos,2090,918,33,47,80,41.2%,3m
36712,2,CinosBR,2090,423,29,34,63,46.0%,2h
36712,2,[PNV]TastyCorn,2090,640,23,27,50,46.0%,2h
36712,2,[John]HabsLaurin,2090,464,18,13,31,58.1%,2h
36712,2,[SIMPx]TottyX,2090,420,17,11,28,60.7%,16m
36712,1,Herycov,2090,80,3,8,11,27.3%,1h
36712,2,DeathPotatos,2090,97,2,8,10,20.0%,3h
36712,2,masti,2090,54,2,8,10,20.0%,48m
36712,2,Jackdaniel,2090,0,1,4,5,20.0%,2h
36712,2,INYOURNIGHT,2090,44,1,6,7,14.3%,47m
36712,2,Bradley,2090,46,1,6,7,14.3%,2h
36712,2,CiieJiie,2090,0,0,1,1,0.0%,51m
36726,1,[CCoWW]Rob,2089,1043,38,45,83,45.8%,32m
36726,2,Kermit,2089,398,18,11,29,62.1%,2h
36726,1,[RaRR]Veritas,2089,584,17,23,40,42.5%,2h
36726,1,Rexxuz,2089,356,14,18,32,43.8%,29m
36726,1,WELLGODDAMN,2089,354,9,23,32,28.1%,2h
36726,2,Shogun,2089,113,3,4,7,42.9%,22m
36726,2,Zerglaive,2089,97,1,3,4,25.0%,3h
36726,2,[LMAYO]Halcyon,2089,0,0,2,2,0.0%,2h
36734,1,weiaruyafew,2088,1658,326,406,732,44.5%,2h
36734,1,Sevatividam,2088,1719,187,201,388,48.2%,2h
36734,2,Spytalons,2088,1587,75,76,151,49.7%,3h
36734,1,LuigiBananza,2088,1643,61,62,123,49.6%,3h
36734,2,Zasler,2088,331,23,16,39,59.0%,14m
36734,3,AKellen,2088,302,12,10,22,54.5%,52m
36734,2,leion,2088,166,6,4,10,60.0%,13m
36734,2,Player,2088,114,6,13,19,31.6%,21m
36734,1,[Raver2]WorldRaver,2088,190,4,8,12,33.3%,23m
36734,1,AetherNyx,2088,167,4,10,14,28.6%,3h
36734,2,Blank,2088,95,3,4,7,42.9%,2h
36734,2,Machtigen,2088,30,2,4,6,33.3%,3h
36734,2,Pronker,2088,30,1,6,7,14.3%,56m
36734,2,AAviator,2088,0,0,5,5,0.0%,3h
36748,1,Kojimatsu,2087,1465,69,81,150,46.0%,49m
36748,2,LoganMetal,2087,948,53,47,100,53.0%,3h
36748,2,Subterfuge,2087,752,36,27,63,57.1%,2h
36748,1,Oeloun,2087,594,21,30,51,41.2%,53m
36748,1,walten,2087,329,9,16,25,36.0%,2h
36748,2,[SHCrew]Luxes,2087,155,6,7,13,46.2%,3h
36748,2,[SqBD]Emminent,2087,200,6,7,13,46.2%,3h
36748,2,NightKnight,2087,195,5,3,8,62.5%,55m
36748,1,MercilesTrol,2087,34,3,7,10,30.0%,2h
36748,2,elbermix,2087,0,1,0,1,100.0%,48m
36748,2,[POCHA]SrSandía,2087,0,1,0,1,100.0%,3h
36748,2,DorArmand,2087,93,1,5,6,16.7%,1h
36748,2,Sobolinko,2087,38,1,6,7,14.3%,47m
36748,2,Blurpy,2087,0,0,2,2,0.0%,3h
36748,2,rzj,2087,0,0,5,5,0.0%,2h
36763,1,Arun,2086,1001,73,74,147,49.7%,44m
36763,2,Phoenix,2086,577,23,29,52,44.2%,1h
36763,2,Sentree,2086,560,20,22,42,47.6%,54m
36763,2,Fergs,2086,474,16,15,31,51.6%,2h
36763,1,ThatGuy,2086,234,13,17,30,43.3%,45m
36763,2,LoliLikha,2086,311,10,15,25,40.0%,3h
36763,2,Pacman,2086,87,8,15,23,34.8%,3h
36763,2,[Madppl]UnrulyJa,2086,234,7,16,23,30.4%,2h
36763,2,HoneyBadger,2086,234,5,10,15,33.3%,3h
36763,1,[ReB3L]nerdaton,2086,173,5,10,15,33.3%,43m
36763,3,Wattsin,2086,122,3,12,15,20.0%,2h
36763,2,juanxs,2086,30,2,1,3,66.7%,3h
36763,2,[TRPSC]Crid,2086,32,2,3,5,40.0%,31m
36763,2,cubanpapi,2086,117,2,5,7,28.6%,2h
36763,2,jackfoo,2086,46,2,6,8,25.0%,2h
36763,2,llllllllllll,2086,0,1,0,1,100.0%,60m
36763,1,JrlLive,2086,97,1,1,2,50.0%,1h
36763,2,Anonymus,2086,30,1,3,4,25.0%,1h
36763,2,[SL0]Roxzerga,2086,0,0,1,1,0.0%,15m
36782,1,[NUTZZZ]Andy,2085,488,40,39,79,50.6%,1h
36782,1,[NnRs]ZLog,2085,466,15,20,35,42.9%,3h
36782,2,Burrito,2085,219,8,6,14,57.1%,2h
36782,3,manahanralph,2085,62,6,7,13,46.2%,39m
36782,2,[HnTr]Osiris,2085,66,3,5,8,37.5%,5m
36782,1,saymyname,2085,145,3,9,12,25.0%,2h
36782,2,Deliriun,2085,30,2,0,2,100.0%,2h
36782,2,Riko,2085,30,1,1,2,50.0%,25m
36782,2,truth,2085,0,1,1,2,50.0%,12m
36782,2,Sinlentes,2085,97,1,5,6,16.7%,22m
36782,3,gcbc,2085,0,1,7,8,12.5%,57m
36782,2,[GDKND]zorg,2085,0,0,1,1,0.0%,2h
36782,2,ElCirculoso,2085,0,0,5,5,0.0%,32m
36795,1,Corm,2084,1385,87,86,173,50.3%,2h
36795,1,[mrslck]lenlegend,2084,512,19,25,44,43.2%,57m
36795,1,Kurisuten,2084,422,12,21,33,36.4%,59m
36795,1,Axiz,2084,120,4,8,12,33.3%,3h
36795,2,[1vsM]Pickles,2084,86,3,2,5,60.0%,7m
36795,1,Dannydorito,2084,48,3,9,12,25.0%,2h
36795,2,Gutz,2084,60,2,8,10,20.0%,2h
36795,2,ZACARABA,2084,46,1,6,7,14.3%,43m
36795,2,VanGuilty,2084,0,0,5,5,0.0%,11m
36795,2,Frank,2084,0,0,5,5,0.0%,3h
36795,3,Alejandro,2084,0,0,8,8,0.0%,7m
36806,2,DominantVth,2083,1598,116,108,224,51.8%,56m
36806,2,tattoo,2083,1383,101,104,205,49.3%,11m
36806,1,GhostDragon,2083,1001,38,45,83,45.8%,2h
36806,2,[PobSC]Ragnar,2083,696,33,21,54,61.1%,3m
36806,2,Wibze,2083,272,9,12,21,42.9%,12m
36806,3,Skaya,2083,188,8,15,23,34.8%,2h
36806,1,[posta]edacx,2083,48,1,1,2,50.0%,2h
36806,2,Hennessy,2083,0,1,1,2,50.0%,40m
36806,1,Reznor,2083,0,1,7,8,12.5%,54m
36806,2,Blkdynamite,2083,0,1,8,9,11.1%,3h
36806,2,THERUSSIAN,2083,0,0,2,2,0.0%,2h
36806,2,Eddielane,2083,0,0,5,5,0.0%,48m
36806,2,awungsauce,2083,0,0,5,5,0.0%,22m
36819,1,rtwodeetwo,2082,1599,72,76,148,48.6%,57m
36819,2,Taskmaster,2082,594,26,25,51,51.0%,13m
36819,1,Ruffeo,2082,670,20,33,53,37.7%,1h
36819,2,Kaime,2082,389,14,15,29,48.3%,1h
36819,2,MAYCOL,2082,291,12,11,23,52.2%,3h
36819,2,Maximus,2082,346,12,14,26,46.2%,31m
36819,3,[pobhla]ficcus,2082,110,3,4,7,42.9%,28m
36819,2,dexrow,2082,0,0,2,2,0.0%,3h
36819,2,[ALTF04]zeuzgrande,2082,0,0,2,2,0.0%,31m
36819,2,Deth,2082,0,0,5,5,0.0%,3h
36829,2,Predator,2081,566,56,57,113,49.6%,2h
36829,1,DhaRalCon,2081,339,14,14,28,50.0%,43m
36829,2,Swampton,2081,200,7,8,15,46.7%,2h
36829,1,ominous,2081,139,4,6,10,40.0%,23m
36829,2,[ROSC2]DIHmaster,2081,97,2,1,3,66.7%,2h
36829,2,Cybertron,2081,88,1,1,2,50.0%,1h
36829,2,Thomas,2081,0,1,6,7,14.3%,2h
36829,2,toontownlego,2081,0,0,1,1,0.0%,1h
36829,2,tikigodlax,2081,0,0,1,1,0.0%,1h
36829,2,RebelRB,2081,0,0,5,5,0.0%,3h
36829,2,JoTheSloth,2081,0,0,5,5,0.0%,3h
36829,2,chazzle,2081,0,0,5,5,0.0%,47m
36841,3,Lulzmate,2080,494,28,43,71,39.4%,2h
36841,2,WheelJackAtt,2080,505,22,22,44,50.0%,22m
36841,2,Swinestein,2080,524,18,22,40,45.0%,1h
36841,2,[8iSh]Protossible,2080,332,13,6,19,68.4%,8m
36841,1,sowhat,2080,394,13,20,33,39.4%,29m
36841,3,Crusty,2080,356,12,21,33,36.4%,2h
36841,2,NotSure,2080,236,7,7,14,50.0%,1h
36841,2,luchosoruco,2080,42,5,2,7,71.4%,2h
36841,2,KATT,2080,58,3,3,6,50.0%,2h
36841,2,MAEM,2080,58,2,4,6,33.3%,3h
36841,1,NomHok,2080,145,2,10,12,16.7%,28m
36841,1,Spacelord,2080,48,1,9,10,10.0%,4m
36841,1,Zentenk,2080,0,0,1,1,0.0%,1h
36841,2,Dangergirl,2080,0,0,4,4,0.0%,52m
36841,2,Sigurd,2080,0,0,6,6,0.0%,3h
36841,1,DancaT,2080,0,0,6,6,0.0%,6m
36857,2,Beerlighter,2079,1086,44,39,83,53.0%,1h
36857,2,butterman,2079,534,25,9,34,73.5%,19m
36857,2,WormKing,2079,409,24,30,54,44.4%,2h
36857,2,Crimsong,2079,537,19,28,47,40.4%,44m
36857,2,Despik,2079,308,11,12,23,47.8%,2h
36857,2,KalTar,2079,138,5,7,12,41.7%,2h
36857,1,[demian]Blacknight,2079,216,5,11,16,31.2%,1h
36857,2,DarthSeverus,2079,119,4,4,8,50.0%,1h
36857,2,ajleal,2079,64,2,3,5,40.0%,4m
36857,2,MrWizard,2079,0,0,1,1,0.0%,23m
36857,2,[GioGio]Arabo,2079,0,0,5,5,0.0%,22m
36868,1,[Nu]kilcupcake,2078,1557,117,129,246,47.6%,39m
36868,2,cheeto,2078,952,39,36,75,52.0%,8m
36868,2,Kyle,2078,385,25,23,48,52.1%,56m
36868,1,Souvent,2078,468,15,23,38,39.5%,2h
36868,1,Niki,2078,345,11,14,25,44.0%,3h
36868,2,TaraIsAnime,2078,58,3,2,5,60.0%,58m
36868,2,[MoBaW]Deflecto,2078,92,3,7,10,30.0%,54m
36868,2,HybridZerg,2078,0,1,1,2,50.0%,38m
36868,1,[Atena]wickywoo,2078,0,0,1,1,0.0%,2h
36868,2,Zephyr,2078,0,0,2,2,0.0%,31m
36878,2,elChule,2077,444,15,17,32,46.9%,15m
36878,2,[SWOU]Bregains,2077,324,11,8,19,57.9%,2h
36878,2,[NPhasA]Stared,2077,290,10,6,16,62.5%,56m
36878,1,MrBadHabits,2077,247,9,12,21,42.9%,2h
36878,1,KIRRI,2077,184,8,15,23,34.8%,2h
36878,1,Smokeybud,2077,228,7,11,18,38.9%,2h
36878,2,Kingslayer,2077,86,3,4,7,42.9%,14m
36878,1,[K1yomi]sqrefff,2077,48,2,9,11,18.2%,3h
36878,3,Mogwai,2077,38,2,11,13,15.4%,3h
36878,2,ZoofZealot,2077,93,1,1,2,50.0%,51m
36878,1,[mustaf]protosusalad,2077,48,1,3,4,25.0%,1h
36878,2,Drakethos,2077,0,1,6,7,14.3%,3h
36878,2,dpidcoe,2077,0,1,6,7,14.3%,2h
36878,2,Loopy,2077,0,0,1,1,0.0%,2h
36878,2,death,2077,0,0,2,2,0.0%,2h
36878,2,andone,2077,0,0,5,5,0.0%,1h
36878,2,BullseyeSlic,2077,0,0,5,5,0.0%,41m
36895,1,Heartless,2076,1532,126,125,251,50.2%,2h
36895,1,[MIDMX]Ale,2076,772,31,28,59,52.5%,3h
36895,1,Scooter,2076,937,29,37,66,43.9%,3h
36895,2,babsAngel,2076,556,20,19,39,51.3%,14m
36895,1,MAXPOWER,2076,561,18,27,45,40.0%,3h
36895,2,otakusperro,2076,456,17,14,31,54.8%,19m
36895,2,[AbcCo]SapitoFacha,2076,30,2,1,3,66.7%,5m
36895,2,destruckr,2076,30,2,5,7,28.6%,2m
36895,2,[Khalta]milcerelpro,2076,0,1,1,2,50.0%,22m
36895,1,lego,2076,96,1,2,3,33.3%,45m
36895,2,Chris,2076,0,1,4,5,20.0%,2h
36895,1,ZONIKSRR,2076,73,1,4,5,20.0%,57m
36895,1,Zemiyic,2076,0,1,6,7,14.3%,2h
36895,2,weeedman,2076,0,0,1,1,0.0%,58m
36895,1,Patricio,2076,0,0,2,2,0.0%,45m
36895,2,Kamhal,2076,0,0,5,5,0.0%,3h
36911,2,Urgelgrew,2075,600,49,47,96,51.0%,3h
36911,2,cybertronph,2075,795,35,43,78,44.9%,44m
36911,2,[LMI42]CoolingArc,2075,799,29,33,62,46.8%,4m
36911,3,[TTaco]tacotoucherz,2075,580,22,28,50,44.0%,56m
36911,1,Escherichia,2075,492,17,18,35,48.6%,44m
36911,2,Skatobetho,2075,413,16,11,27,59.3%,23m
36911,2,tom,2075,276,8,7,15,53.3%,2h
36911,2,WeonPromedio,2075,30,2,2,4,50.0%,3h
36911,1,ZzorroO,2075,96,2,2,4,50.0%,1h
36911,2,kidzplaygame,2075,30,2,4,6,33.3%,3h
36911,1,Misoramen,2075,48,2,9,11,18.2%,27m
36911,2,Prometeo,2075,97,1,1,2,50.0%,8m
36911,2,DELFIN,2075,0,1,4,5,20.0%,1h
36911,2,bladeecity,2075,0,0,1,1,0.0%,2h
36911,2,NoonGoon,2075,0,0,4,4,0.0%,3h
36911,2,KingCommando,2075,0,0,5,5,0.0%,2h
36927,1,heroboec,2074,1384,53,63,116,45.7%,37m
36927,3,Bob,2074,275,9,14,23,39.1%,48m
36927,2,serghero,2074,252,8,9,17,47.1%,1h
36927,2,Battleooze,2074,160,5,1,6,83.3%,2h
36927,2,Aidan,2074,150,5,6,11,45.5%,1h
36927,2,raynivitron,2074,30,2,0,2,100.0%,5m
36927,2,Sibbs,2074,0,1,0,1,100.0%,15m
36927,2,Commander,2074,0,1,4,5,20.0%,2h
36927,2,WhoAmI,2074,46,1,6,7,14.3%,1h
36927,1,reizercris,2074,0,1,7,8,12.5%,45m
36937,2,[2pz2ez]maelstrom,2073,1602,105,101,206,51.0%,1h
36937,2,scaboo,2073,1080,42,46,88,47.7%,54m
36937,1,lekaroom,2073,932,32,38,70,45.7%,2h
36937,2,Lilgyboi,2073,263,15,10,25,60.0%,1h
36937,2,Nicolas,2073,332,10,11,21,47.6%,54m
36937,2,GangGreen,2073,137,2,8,10,20.0%,43m
36937,2,francescusco,2073,0,1,4,5,20.0%,41m
36937,1,Fremen,2073,0,1,6,7,14.3%,3h
36937,3,Hopper,2073,0,0,2,2,0.0%,2h
36937,2,[33Sof9]monkeyfoot,2073,0,0,4,4,0.0%,14m
36937,2,[NEnM]Verrous,2073,0,0,5,5,0.0%,52m
36937,2,Discordia,2073,0,0,5,5,0.0%,2h
36949,2,Leviathann,2072,1514,88,94,182,48.4%,20m
36949,1,SSJARI,2072,648,23,24,47,48.9%,3h
36949,2,Zanthar,2072,375,15,16,31,48.4%,41m
36949,3,[AzG]PapaBearz,2072,60,4,10,14,28.6%,3h
36949,1,ImaKILLyoAZZ,2072,84,3,10,13,23.1%,10m
36949,1,REDoSCOUT,2072,0,0,2,2,0.0%,13m
36949,2,Pablo,2072,0,0,5,5,0.0%,49m
36949,2,[nieBla]ALAMUERTE,2072,0,0,6,6,0.0%,41m
36957,2,Whion,2071,1412,78,80,158,49.4%,2h
36957,1,SoFartSH,2071,872,27,39,66,40.9%,1h
36957,2,SOPITA,2071,496,24,16,40,60.0%,3h
36957,2,ANoobXD,2071,507,24,24,48,50.0%,54m
36957,2,shadynasty,2071,508,21,18,39,53.8%,3h
36957,2,TwoPointO,2071,170,6,7,13,46.2%,38m
36957,2,elmachaco,2071,154,5,6,11,45.5%,3h
36957,2,HERBY,2071,164,5,10,15,33.3%,2h
36957,1,Skinner,2071,196,5,15,20,25.0%,10m
36957,2,Helsyngh,2071,88,4,6,10,40.0%,3h
36957,2,Bogdanovist,2071,86,3,2,5,60.0%,31m
36957,1,thehWood,2071,40,2,8,10,20.0%,15m
36957,2,Isaac,2071,0,1,0,1,100.0%,2h
36957,1,PLADIN,2071,0,1,0,1,100.0%,45m
36957,2,Slyfox,2071,32,1,2,3,33.3%,23m
36957,1,Superium,2071,0,1,9,10,10.0%,1h
36957,2,ohhia,2071,0,0,1,1,0.0%,3h
36957,2,Bearkorps,2071,0,0,1,1,0.0%,8m
36957,2,Diego,2071,0,0,3,3,0.0%,43m
36957,2,bellotalco,2071,0,0,3,3,0.0%,1h
36957,2,Cosmo,2071,0,0,5,5,0.0%,31m
36978,2,Guerdon,2070,1203,52,41,93,55.9%,2h
36978,1,BULGORITE,2070,885,45,43,88,51.1%,18m
36978,2,[EPCK]LightNinjaSC,2070,482,34,33,67,50.7%,2h
36978,1,Azir,2070,854,32,43,75,42.7%,2h
36978,2,IIIIIII,2070,154,8,6,14,57.1%,2m
36978,3,[BigBr]BigRarls,2070,213,6,13,19,31.6%,2h
36978,1,TerranRB,2070,200,5,12,17,29.4%,14m
36978,2,Taz,2070,104,4,4,8,50.0%,3h
36978,2,BBQmaxiXXL,2070,125,4,7,11,36.4%,3h
36978,2,goTZ,2070,182,3,7,10,30.0%,49m
36978,2,SantiagoG,2070,93,2,2,4,50.0%,38m
36978,1,Noah,2070,30,2,7,9,22.2%,2h
36978,1,Sargent,2070,46,2,7,9,22.2%,2h
36978,1,[Tenn]Dagus,2070,0,1,0,1,100.0%,1h
36978,2,matareynor,2070,0,1,0,1,100.0%,2h
36978,2,TechTophia,2070,0,1,3,4,25.0%,38m
36978,1,Tankermp,2070,0,1,4,5,20.0%,2h
36978,2,king,2070,0,0,3,3,0.0%,31m
36978,3,MikeyTrump,2070,0,0,5,5,0.0%,3h
36978,3,xel,2070,0,0,5,5,0.0%,2h
36998,2,[MEGAR]GianCarlos,2069,1537,160,161,321,49.8%,1h
36998,2,mundodev,2069,979,60,66,126,47.6%,60m
36998,2,Tono,2069,614,21,24,45,46.7%,3h
36998,1,ZergPriest,2069,249,10,15,25,40.0%,3h
36998,2,MinH,2069,241,9,14,23,39.1%,1h
36998,2,LiderPotato,2069,185,8,5,13,61.5%,3h
36998,2,DeathFreedom,2069,102,3,1,4,75.0%,2h
36998,2,Princess,2069,126,3,2,5,60.0%,1h
36998,2,Bijan,2069,136,3,2,5,60.0%,1h
36998,1,roughninja,2069,145,3,3,6,50.0%,1h
36998,2,GuppyNate,2069,138,3,9,12,25.0%,58m
36998,2,Likapichu,2069,30,2,5,7,28.6%,23m
36998,2,[Zynos]Jblaarg,2069,0,1,5,6,16.7%,48m
36998,1,Balfadr,2069,0,1,7,8,12.5%,30m
36998,3,KelaGOD,2069,0,0,2,2,0.0%,60m
36998,2,[THB]Eric,2069,0,0,5,5,0.0%,1h
37014,1,[AMXS]Viperaxel,2068,1238,234,241,475,49.3%,2h
37014,2,DonAce,2068,1600,129,126,255,50.6%,19m
37014,1,bandALEchuga,2068,1359,54,53,107,50.5%,23m
37014,2,Chairman,2068,505,17,21,38,44.7%,3h
37014,2,fabricio,2068,356,12,16,28,42.9%,2h
37014,1,[Zetoss]Pepperfreez,2068,391,12,19,31,38.7%,2h
37014,2,[Zyzz]Shadowphase,2068,222,9,9,18,50.0%,3h
37014,1,[DhZAc1]KeitSunagi,2068,193,8,6,14,57.1%,2h
37014,2,DeathBNimble,2068,156,7,16,23,30.4%,2h
37014,3,[cerbrs]Pattymelt,2068,170,5,3,8,62.5%,2h
37014,2,skittleninja,2068,138,5,7,12,41.7%,2h
37014,2,SpacemnSplff,2068,66,3,3,6,50.0%,3h
37014,1,[TGF456]TonyferLove,2068,97,2,0,2,100.0%,24m
37014,2,Phoenix,2068,30,2,4,6,33.3%,22m
37014,2,MAD,2068,30,1,8,9,11.1%,14m
37014,1,eGirl,2068,0,0,1,1,0.0%,2m
37014,3,Igna,2068,0,0,5,5,0.0%,2m
37014,2,Broker,2068,0,0,5,5,0.0%,54m
37032,2,Rutger,2067,1111,133,134,267,49.8%,4m
37032,1,Arkan,2067,552,16,30,46,34.8%,32m
37032,2,acmunpt,2067,426,15,20,35,42.9%,16m
37032,2,Asciiman,2067,92,5,5,10,50.0%,51m
37032,2,MrRobot,2067,60,2,4,6,33.3%,40m
37032,2,iMakeZergYes,2067,74,2,7,9,22.2%,2h
37032,2,wedawn,2067,0,1,0,1,100.0%,4m
37032,2,KIDCUTTA,2067,46,1,6,7,14.3%,2h
37032,3,PumpkinSpook,2067,0,0,5,5,0.0%,1h
37041,2,Blitzkrieg,2066,946,40,37,77,51.9%,3h
37041,2,mutabeast,2066,884,32,33,65,49.2%,2h
37041,2,monicagalind,2066,666,24,23,47,51.1%,2h
37041,2,Orange,2066,442,22,9,31,71.0%,15m
37041,2,[KKG]Gabbar,2066,480,19,15,34,55.9%,38m
37041,2,BetaStar,2066,366,13,14,27,48.1%,3h
37041,1,swarm,2066,296,8,14,22,36.4%,1h
37041,2,PhilMcGlackn,2066,269,7,14,21,33.3%,2h
37041,2,Trillin,2066,197,6,11,17,35.3%,3h
37041,2,LittleJedi,2066,285,5,12,17,29.4%,1h
37041,1,NecroSummone,2066,88,5,13,18,27.8%,1h
37041,1,[KrAce]edgysarcasm,2066,42,3,8,11,27.3%,31m
37041,2,IIIIIIIIIIII,2066,0,1,0,1,100.0%,3h
37041,1,Faye,2066,0,1,6,7,14.3%,50m
37041,2,firemedic,2066,0,0,2,2,0.0%,3h
37041,2,marcus,2066,0,0,2,2,0.0%,30m
37041,3,LudisDeSeto,2066,0,0,5,5,0.0%,3h
37058,2,bobalva,2065,1600,177,178,355,49.9%,5m
37058,2,XzackattackX,2065,1034,40,39,79,50.6%,2h
37058,2,linguiniboyo,2065,334,11,11,22,50.0%,2h
37058,2,naters,2065,323,9,10,19,47.4%,2h
37058,3,[AK7]PWNADILE,2065,206,8,18,26,30.8%,2h
37058,2,Survivorr,2065,0,3,2,5,60.0%,7m
37058,1,garotopexe,2065,32,2,8,10,20.0%,2h
37058,2,krusknog,2065,30,1,2,3,33.3%,3h
37058,2,[TR0L]Virus,2065,0,1,6,7,14.3%,60m
37058,1,DMTshadows,2065,0,1,7,8,12.5%,2h
37058,3,[NwAs]killua,2065,0,0,5,5,0.0%,1h
37069,2,SwampLord,2064,358,17,15,32,53.1%,38m
37069,2,GoblinSlayer,2064,330,12,19,31,38.7%,3h
37069,1,OMEGA,2064,343,10,21,31,32.3%,1h
37069,2,[Kco]dirrlei,2064,241,8,12,20,40.0%,2h
37069,2,[COV69]ROBOTOMOJO,2064,160,5,3,8,62.5%,3h
37069,1,Artanis,2064,183,5,10,15,33.3%,3h
37069,1,SeungguLee,2064,168,4,10,14,28.6%,2h
37069,2,ZergBrotherS,2064,146,3,3,6,50.0%,2h
37069,2,perezningle,2064,30,2,1,3,66.7%,3h
37069,2,Nonsense,2064,0,0,1,1,0.0%,3h
37069,2,[BSauce]jemory,2064,0,0,1,1,0.0%,2h
37069,2,Markdat,2064,0,0,5,5,0.0%,41m
37081,2,GLHaveFun,2063,833,43,49,92,46.7%,11m
37081,2,Galimatías,2063,428,20,10,30,66.7%,2h
37081,2,MannyFresh,2063,0,4,2,6,66.7%,41m
37081,1,[FaZe]Ythalo,2063,193,3,10,13,23.1%,3h
37081,3,Grim,2063,0,2,3,5,40.0%,2h
37081,1,cuspcecowboy,2063,42,2,9,11,18.2%,1h
37081,2,RAMX,2063,0,1,0,1,100.0%,1h
37081,2,Bnjo,2063,30,1,2,3,33.3%,54m
37081,2,DonComedia,2063,0,0,2,2,0.0%,56m
37090,2,DEREKFOREALZ,2062,1531,64,56,120,53.3%,3h
37090,2,BlitzKrieg,2062,1320,50,58,108,46.3%,2h
37090,2,unKempt,2062,234,9,12,21,42.9%,3h
37090,1,Cerberus,2062,114,3,2,5,60.0%,43m
37090,1,IgnoreTaName,2062,95,3,7,10,30.0%,3h
37090,2,StarLegions,2062,79,2,3,5,40.0%,1h
37090,1,llllllllllll,2062,0,1,0,1,100.0%,1h
37090,2,[ZTemps]Tengu,2062,30,1,2,3,33.3%,23m
37090,2,ROJKA,2062,32,1,2,3,33.3%,2h
37090,2,Riath,2062,30,1,2,3,33.3%,54m
37090,2,Sloth,2062,95,1,5,6,16.7%,22m
37090,2,dragonknight,2062,95,1,7,8,12.5%,2h
37090,1,[KSADOs]Cramunhão,2062,0,1,7,8,12.5%,2h
37090,2,SeventyFU,2062,0,0,1,1,0.0%,3h
37090,2,Chaos,2062,0,0,1,1,0.0%,38m
37090,2,touchpad,2062,0,0,2,2,0.0%,8m
37090,3,enfour,2062,0,0,5,5,0.0%,2h
37090,2,[clow]Guerrero,2062,0,0,5,5,0.0%,52m
37108,1,HughMan,2061,1214,83,96,179,46.4%,3h
37108,2,Lucas,2061,797,42,44,86,48.8%,3h
37108,2,Pickles,2061,324,12,12,24,50.0%,1h
37108,2,Firelove,2061,318,10,17,27,37.0%,58m
37108,1,Bosse,2061,184,7,11,18,38.9%,39m
37108,2,[TYFTRS]Duch,2061,134,3,5,8,37.5%,2h
37108,1,[chsq]yamtron,2061,48,2,3,5,40.0%,3h
37108,1,Adore,2061,48,2,8,10,20.0%,2h
37108,2,Scubadoo,2061,0,1,0,1,100.0%,3h
37108,2,alexded,2061,95,1,1,2,50.0%,8m
37108,2,[BYU]SirSpen,2061,0,1,4,5,20.0%,23m
37108,2,[Sc2Maf]Durzan,2061,30,1,6,7,14.3%,2h
37108,2,XYZrd,2061,30,1,6,7,14.3%,2h
37108,1,[MNVN]ultragoat,2061,0,1,6,7,14.3%,1h
37108,2,Brad,2061,0,0,1,1,0.0%,2h
37108,2,WildBurns,2061,0,0,2,2,0.0%,38m
37108,2,cajachan,2061,0,0,5,5,0.0%,58m
37108,2,PVagrant,2061,0,0,6,6,0.0%,2h
37108,2,Deku,2061,0,0,6,6,0.0%,2h
37127,2,Bobby,2060,1366,176,237,413,42.6%,1h
37127,2,paraFox,2060,672,24,28,52,46.2%,16m
37127,2,[DFWU]Caveman,2060,151,4,9,13,30.8%,2h
37127,2,Angel,2060,112,3,2,5,60.0%,2h
37127,2,jmgzch,2060,35,2,6,8,25.0%,3h
37127,2,BethLoggins,2060,30,2,7,9,22.2%,2h
37127,2,[Dazlrs]Moosey,2060,0,1,1,2,50.0%,38m
37127,2,KungFlu,2060,0,1,2,3,33.3%,48m
37127,2,cablaz,2060,0,0,6,6,0.0%,2h
37136,2,cHeeToBoY,2059,1070,40,42,82,48.8%,58m
37136,2,KillerDragon,2059,417,15,19,34,44.1%,3h
37136,2,NaClGlaive,2059,169,8,6,14,57.1%,56m
37136,3,churchraptor,2059,227,8,15,23,34.8%,48m
37136,1,Radiant,2059,269,6,13,19,31.6%,2h
37136,1,Fabius,2059,286,6,14,20,30.0%,1h
37136,2,HotKhocket,2059,115,2,1,3,66.7%,3h
37136,2,DankoJones,2059,0,1,4,5,20.0%,3h
37136,3,pakotena,2059,0,1,4,5,20.0%,3h
37136,2,[αXLa]Jopipemi,2059,0,0,1,1,0.0%,1h
37136,2,Stargell,2059,0,0,1,1,0.0%,2h
37136,2,Shadowolf,2059,0,0,5,5,0.0%,58m
37148,1,Boristen,2058,1459,66,81,147,44.9%,2h
37148,1,snow,2058,483,14,21,35,40.0%,1h
37148,1,RIVERA,2058,303,8,14,22,36.4%,1h
37148,3,Kskbj,2058,206,7,16,23,30.4%,2h
37148,2,[XANNY]BigSmoke,2058,0,3,1,4,75.0%,1h
37148,2,PeluchinSR,2058,93,2,0,2,100.0%,2h
37148,1,KBrownie,2058,118,2,3,5,40.0%,3h
37148,2,[Msia]Milo,2058,97,2,6,8,25.0%,58m
37148,2,[CHILN]Coach,2058,0,1,1,2,50.0%,2h
37148,2,gladiador,2058,0,0,1,1,0.0%,3h
37158,3,IAINTEVENMAD,2057,747,79,96,175,45.1%,46m
37158,2,bigamer,2057,1154,43,46,89,48.3%,60m
37158,2,[RAR3]Nshaffer,2057,829,31,27,58,53.4%,4m
37158,2,hoser,2057,537,21,20,41,51.2%,5m
37158,2,VLADE,2057,411,18,23,41,43.9%,54m
37158,1,Punisher,2057,468,15,18,33,45.5%,1h
37158,2,BeHappyyy,2057,358,14,22,36,38.9%,44m
37158,1,MrGarrison,2057,277,10,16,26,38.5%,6m
37158,1,cipcop,2057,286,9,16,25,36.0%,2h
37158,2,GabrielGP,2057,196,5,8,13,38.5%,2h
37158,1,Ragabash,2057,179,5,9,14,35.7%,1h
37158,1,lariats,2057,162,5,14,19,26.3%,2h
37158,2,Gian,2057,58,3,3,6,50.0%,2h
37158,1,Empire,2057,139,3,4,7,42.9%,2h
37158,2,Gobstopper,2057,0,2,4,6,33.3%,2h
37158,1,zenob,2057,102,2,7,9,22.2%,1h
37158,2,Penetro,2057,0,1,2,3,33.3%,14m
37158,2,Lethaltempho,2057,97,1,4,5,20.0%,56m
37158,1,ItsMeDio,2057,0,0,1,1,0.0%,2h
37158,3,Willardson,2057,0,0,2,2,0.0%,3h
37178,2,Sambo,2056,1597,83,88,171,48.5%,1h
37178,2,AKARead,2056,1365,66,89,155,42.6%,2h
37178,2,MrWishes,2056,857,34,28,62,54.8%,2h
37178,1,Palpatine,2056,426,13,20,33,39.4%,50m
37178,1,Shaman,2056,436,12,28,40,30.0%,3h
37178,1,RobtgMx,2056,164,6,7,13,46.2%,1h
37178,2,edwinrockq,2056,44,4,4,8,50.0%,2h
37178,2,[CzdT]LoPai,2056,103,3,4,7,42.9%,23m
37178,2,guardian,2056,30,2,2,4,50.0%,55m
37178,2,scarletrxse,2056,30,1,2,3,33.3%,52m
37178,3,[iMkS]Andrei,2056,0,1,3,4,25.0%,58m
37178,1,Evader,2056,0,1,7,8,12.5%,2h
37178,2,Vagenis,2056,0,0,6,6,0.0%,2h
37191,1,frozefrostle,2055,794,29,44,73,39.7%,55m
37191,2,TomateMozza,2055,678,24,22,46,52.2%,2h
37191,3,Thief,2055,295,14,9,23,60.9%,2h
37191,3,JUICEBOX,2055,0,3,2,5,60.0%,2h
37191,1,SirTkPk,2055,96,3,9,12,25.0%,1h
37191,2,[INKA5]Sturm,2055,0,1,0,1,100.0%,1h
37191,1,coronavirus,2055,0,0,2,2,0.0%,2h
37191,3,Espada,2055,0,0,2,2,0.0%,3h
37191,3,Gustavex,2055,0,0,3,3,0.0%,44m
37191,3,Muddy,2055,0,0,5,5,0.0%,2h
37201,2,URIEL,2054,1448,56,60,116,48.3%,1h
37201,2,Farnecio,2054,775,29,30,59,49.2%,2h
37201,2,[TPGGXD]ramiro,2054,576,20,18,38,52.6%,1h
37201,2,Mazinga,2054,496,19,15,34,55.9%,1h
37201,2,SatanicGecko,2054,404,14,13,27,51.9%,3h
37201,2,ZerGi,2054,256,9,8,17,52.9%,52m
37201,2,XXDINAMICOXX,2054,282,9,13,22,40.9%,3h
37201,3,Kowalski,2054,281,9,19,28,32.1%,2h
37201,2,[RSTD]XxLagMasterx,2054,170,6,7,13,46.2%,1h
37201,2,alequei,2054,30,2,2,4,50.0%,2h
37201,2,Plasmonic,2054,64,2,5,7,28.6%,56m
37201,2,PackerBack,2054,30,1,1,2,50.0%,2h
37201,1,Lighwave,2054,0,1,2,3,33.3%,24m
37201,1,nastos,2054,0,1,5,6,16.7%,3h
37215,2,Lichtgestalt,2053,1083,42,36,78,53.8%,3h
37215,2,Bucknasty,2053,685,27,28,55,49.1%,8m
37215,2,AlmiusJuez,2053,606,24,30,54,44.4%,14m
37215,2,nap,2053,352,18,11,29,62.1%,38m
37215,2,bruto,2053,204,6,6,12,50.0%,2h
37215,2,NachoZ,2053,88,3,3,6,50.0%,31m
37215,1,ShadowBoxer,2053,34,3,12,15,20.0%,56m
37215,2,Judged,2053,0,1,0,1,100.0%,3h
37215,1,Latinloover,2053,0,1,5,6,16.7%,3h
37215,2,arraes,2053,0,0,5,5,0.0%,3h
37225,1,somechips,2052,830,28,33,61,45.9%,10m
37225,2,AnGGELLo,2052,706,27,34,61,44.3%,1h
37225,1,ThreeFOOT,2052,464,24,39,63,38.1%,3h
37225,2,elefanteHOT,2052,210,10,12,22,45.5%,55m
37225,2,ZEDATUL,2052,168,6,11,17,35.3%,3h
37225,1,kunguen,2052,74,3,10,13,23.1%,2h
37225,2,Asbeel,2052,0,0,2,2,0.0%,2h
37225,2,ParoX,2052,0,0,5,5,0.0%,16m
37225,2,Xan,2052,0,0,5,5,0.0%,8m
37225,1,MAJCHRISTIAN,2052,0,0,8,8,0.0%,6m
37235,2,Xcne,2051,460,22,22,44,50.0%,3h
37235,2,NickPeique,2051,392,14,22,36,38.9%,3h
37235,2,EasyMyMind,2051,160,8,11,19,42.1%,1h
37235,2,Riban,2051,30,3,5,8,37.5%,60m
37235,2,Donoblaine,2051,46,2,3,5,40.0%,60m
37235,2,notibob,2051,53,2,3,5,40.0%,3h
37235,2,StealthyE,2051,30,1,1,2,50.0%,2h
37235,2,JhosuaSuren,2051,0,1,1,2,50.0%,60m
37235,2,Jukestar,2051,0,1,2,3,33.3%,31m
37235,3,CtrlAltDel,2051,97,1,2,3,33.3%,59m
37235,2,Zaius,2051,94,1,6,7,14.3%,60m
37235,2,[ClanHs]DreaMy,2051,95,1,6,7,14.3%,22m
37235,2,Persona,2051,88,1,6,7,14.3%,2h
37235,2,PearlMilkTea,2051,0,0,1,1,0.0%,3h
37235,2,BlueZeppelin,2051,0,0,1,1,0.0%,38m
37235,1,[4bronz]starlove,2051,0,0,12,12,0.0%,57m
37251,2,GoMigo,2050,486,21,27,48,43.8%,8m
37251,2,HyperSaline,2050,425,20,14,34,58.8%,2h
37251,1,Haidee,2050,369,13,21,34,38.2%,3h
37251,1,[FyHr]Setban,2050,228,6,5,11,54.5%,43m
37251,2,sadiedog,2050,152,6,5,11,54.5%,38m
37251,2,Jose,2050,92,4,6,10,40.0%,3h
37251,2,Rymachelin,2050,128,3,9,12,25.0%,2h
37251,2,[FatMom]Xenocide,2050,90,3,11,14,21.4%,2h
37251,1,Lichbich,2050,0,2,6,8,25.0%,1h
37251,1,SORAJIANG,2050,0,1,1,2,50.0%,39m
37251,2,mrawsome,2050,0,0,1,1,0.0%,2h
37251,2,Paladin,2050,0,0,1,1,0.0%,47m
37251,2,Tayer,2050,0,0,1,1,0.0%,23m
37251,3,BazookaJoe,2050,0,0,5,5,0.0%,2h
37251,2,Skoll,2050,0,0,6,6,0.0%,1h
37266,1,XoR,2049,1357,51,58,109,46.8%,3h
37266,2,WillxWallace,2049,389,42,38,80,52.5%,38m
37266,2,Ank,2049,682,25,24,49,51.0%,31m
37266,2,Zelot,2049,348,13,10,23,56.5%,8m
37266,2,[GiLLs]Dalton,2049,337,13,12,25,52.0%,1h
37266,1,AnimeJunky,2049,250,7,12,19,36.8%,3h
37266,2,Mythros,2049,190,5,5,10,50.0%,31m
37266,2,DylDeki,2049,86,3,6,9,33.3%,2h
37266,2,terrorblack,2049,128,3,7,10,30.0%,4m
37266,1,BludgeonStik,2049,96,3,10,13,23.1%,3h
37266,1,IceFox,2049,0,2,5,7,28.6%,2h
37266,1,Nemesis,2049,66,2,6,8,25.0%,41m
37266,1,Vajitarian,2049,0,1,7,8,12.5%,3h
37266,1,Nyx,2049,0,1,8,9,11.1%,35m
37266,1,Ariseph,2049,0,0,1,1,0.0%,47m
37266,2,[CalEnt]GingerAl,2049,0,0,1,1,0.0%,3h
37266,2,[asco]MusMey,2049,0,0,3,3,0.0%,2h
37266,1,ADVOCATUS,2049,0,0,3,3,0.0%,27m
37284,2,peluchecolon,2048,1574,66,65,131,50.4%,1h
37284,1,Tormenta,2048,579,22,26,48,45.8%,2h
37284,2,Raeniell,2048,333,18,24,42,42.9%,14m
37284,2,SNOWMAN,2048,232,9,14,23,39.1%,1h
37284,2,[LOHs]Zerlite,2048,216,8,4,12,66.7%,1h
37284,2,hahanoob,2048,209,8,4,12,66.7%,1h
37284,2,creAtion,2048,199,8,6,14,57.1%,2h
37284,2,jean,2048,267,8,7,15,53.3%,1h
37284,1,Sada,2048,144,3,9,12,25.0%,3h
37284,2,CarlosDa,2048,0,1,3,4,25.0%,1h
37284,2,Ghost,2048,30,1,6,7,14.3%,42m
37284,2,Algu,2048,0,1,6,7,14.3%,2h
37284,1,Hazard,2048,0,0,3,3,0.0%,42m
37297,2,nowhereman,2047,1625,218,236,454,48.0%,3h
37297,2,vvxxwxxvv,2047,1407,62,62,124,50.0%,2h
37297,2,wheezy,2047,595,19,28,47,40.4%,3h
37297,2,sup,2047,126,3,2,5,60.0%,3h
37297,2,Rakzo,2047,30,1,2,3,33.3%,3h
37297,2,ANCIENT,2047,0,0,1,1,0.0%,14m
37297,2,boba,2047,0,0,1,1,0.0%,1h
37297,3,chessmaster,2047,0,0,5,5,0.0%,3h
37305,2,Alphakenyone,2046,644,48,51,99,48.5%,2h
37305,2,Jamz,2046,450,42,34,76,55.3%,3h
37305,2,[OrNos]Telkicel,2046,912,42,35,77,54.5%,3h
37305,1,[DeadMP]VaRogue,2046,1122,40,49,89,44.9%,57m
37305,2,Rakem,2046,434,14,23,37,37.8%,2h
37305,1,Ekikouki,2046,397,12,23,35,34.3%,1h
37305,1,[blub0i]Kirazoya,2046,188,6,5,11,54.5%,1h
37305,1,[4Sci]Skepsis,2046,186,6,12,18,33.3%,1h
37305,1,Cryptic,2046,97,4,5,9,44.4%,2h
37305,2,Ddeathgun,2046,96,4,7,11,36.4%,39m
37305,2,fingers,2046,44,4,10,14,28.6%,2h
37305,2,Nadnerb,2046,102,3,0,3,100.0%,11m
37305,2,BardaArmy,2046,161,3,7,10,30.0%,32m
37305,1,BattlePants,2046,135,3,10,13,23.1%,54m
37305,2,hdhierro,2046,123,2,8,10,20.0%,55m
37305,2,[ThShMe]Bbto,2046,38,1,2,3,33.3%,3h
37305,2,BouncyBear,2046,30,1,3,4,25.0%,22m
37305,2,ApmTen,2046,0,1,4,5,20.0%,31m
37305,1,DEANO,2046,0,0,2,2,0.0%,15m
37305,2,Monk,2046,0,0,5,5,0.0%,3h
37305,2,BonekSBY,2046,0,0,6,6,0.0%,51m
37326,2,[JOSOWE]HeroZealot,2045,785,32,22,54,59.3%,3h
37326,1,Floridian,2045,408,15,27,42,35.7%,36m
37326,2,RoadToPlaty,2045,152,5,2,7,71.4%,48m
37326,2,Pikinski,2045,144,5,5,10,50.0%,3h
37326,2,ziggy,2045,86,3,4,7,42.9%,16m
37326,2,cuervo,2045,30,2,1,3,66.7%,2h
37326,2,pingor,2045,96,2,3,5,40.0%,3h
37326,3,ItachiUchiha,2045,0,1,4,5,20.0%,2m
37326,3,TheClone,2045,0,0,2,2,0.0%,3h
37326,2,Ominous,2045,0,0,2,2,0.0%,50m
37336,2,Spock,2044,905,39,30,69,56.5%,2h
37336,2,rocketman,2044,571,22,21,43,51.2%,2h
37336,2,ferrer,2044,260,12,8,20,60.0%,53m
37336,1,SOLABAC,2044,316,9,18,27,33.3%,39m
37336,2,mukelamon,2044,225,7,9,16,43.8%,3h
37336,2,GhostDemon,2044,102,2,6,8,25.0%,5m
37336,2,BetaStar,2044,62,2,7,9,22.2%,42m
37336,2,CobraKai,2044,0,1,2,3,33.3%,15m
37336,2,jakesbar,2044,46,1,4,5,20.0%,2h
37336,2,[KOPPN]RollinPaper,2044,88,1,5,6,16.7%,2h
37336,2,Rollwit,2044,0,0,1,1,0.0%,1h
37336,2,physx,2044,0,0,1,1,0.0%,22m
37336,2,Geterix,2044,0,0,2,2,0.0%,1h
37349,2,Hustabega,2043,385,36,37,73,49.3%,31m
37349,2,Sathariel,2043,564,31,1,32,96.9%,53m
37349,2,SamelCamel,2043,233,8,5,13,61.5%,4m
37349,2,[FyHr]MrGlycrM,2043,187,4,3,7,57.1%,22m
37349,2,[ERFT]Sargento,2043,30,2,1,3,66.7%,3h
37349,2,CarlosMagno,2043,102,2,1,3,66.7%,5m
37349,2,[H3ll]Mordred,2043,0,1,0,1,100.0%,3h
37349,2,Joshpiolin,2043,46,1,2,3,33.3%,22m
37349,2,[EPCK]joaquinad,2043,38,1,6,7,14.3%,50m
37358,2,David,2042,1496,73,74,147,49.7%,1h
37358,2,Stybo,2042,613,23,32,55,41.8%,3h
37358,2,Ririmumble,2042,368,14,13,27,51.9%,1h
37358,1,Spinilith,2042,418,14,16,30,46.7%,3h
37358,2,apolo,2042,252,10,13,23,43.5%,2m
37358,1,JHCARAJOXD,2042,284,10,22,32,31.2%,57m
37358,1,Birdiebird,2042,226,9,11,20,45.0%,3h
37358,2,Jynx,2042,176,6,9,15,40.0%,22m
37358,1,wildcoyote,2042,150,6,9,15,40.0%,2h
37358,2,Tempest,2042,64,2,8,10,20.0%,1h
37358,2,[RLPC]Wyatt,2042,0,1,1,2,50.0%,2h
37358,2,juancamaney,2042,119,1,5,6,16.7%,23m
37358,1,BeNiceToMe,2042,0,0,1,1,0.0%,2h
37358,2,nate,2042,0,0,1,1,0.0%,2h
37358,2,AlmiranteNC,2042,0,0,3,3,0.0%,14m
37358,3,Adrii,2042,0,0,5,5,0.0%,16m
37374,2,Trafalgar,2041,565,20,25,45,44.4%,3h
37374,1,Bills,2041,632,17,35,52,32.7%,3h
37374,3,Crownlyi,2041,211,6,8,14,42.9%,3h
37374,1,Ustin,2041,223,5,6,11,45.5%,1h
37374,2,Slawven,2041,104,3,7,10,30.0%,60m
37374,2,Muzzinguava,2041,107,1,6,7,14.3%,1h
37374,2,[LOSCTM]PICHULOTOTE,2041,0,0,1,1,0.0%,2h
37381,1,Piranha,2040,1358,49,59,108,45.4%,58m
37381,3,Jellyman,2040,282,10,23,33,30.3%,16m
37381,2,GANTZ,2040,210,8,10,18,44.4%,2h
37381,2,RmasterJ,2040,209,6,6,12,50.0%,3h
37381,2,Hunterball,2040,130,4,2,6,66.7%,1h
37381,2,[Loli03]traquer,2040,126,3,1,4,75.0%,14m
37381,1,JordanElFake,2040,96,3,5,8,37.5%,2h
37381,1,iskiie,2040,46,2,9,11,18.2%,1h
37381,2,ZercMundus,2040,0,1,0,1,100.0%,54m
37381,3,xzxzorigin,2040,96,1,1,2,50.0%,3h
37381,2,Yuuta,2040,88,1,5,6,16.7%,16m
37381,1,Cotton,2040,0,1,9,10,10.0%,23m
37381,3,jdmbucket,2040,0,0,1,1,0.0%,16m
37394,2,[C0NC1L]Woozard,2039,758,32,22,54,59.3%,2h
37394,2,[XpKAc]XwVIRUSwX,2039,553,18,26,44,40.9%,3h
37394,2,GudStuff,2039,292,10,15,25,40.0%,2h
37394,2,Johnson,2039,232,8,7,15,53.3%,4m
37394,3,Pete,2039,173,5,14,19,26.3%,9m
37394,2,[VIRII]Ripclaw,2039,126,4,7,11,36.4%,22m
37394,2,BetterThanU,2039,102,3,8,11,27.3%,25m
37394,1,tazador,2039,96,3,11,14,21.4%,1h
37394,1,vegetalpro,2039,0,1,0,1,100.0%,2h
37394,2,Sharts,2039,30,1,3,4,25.0%,25m
37394,2,Rencee,2039,30,1,3,4,25.0%,19m
37394,2,[TCJN]tacoman,2039,0,0,1,1,0.0%,1h
37406,2,westbricks,2038,1368,49,55,104,47.1%,3h
37406,2,CnlMaul,2038,1110,43,41,84,51.2%,1h
37406,2,killerwaffle,2038,125,10,11,21,47.6%,55m
37406,2,Colbkilla,2038,193,8,1,9,88.9%,3h
37406,2,Nemco,2038,30,2,2,4,50.0%,3h
37406,1,[5252]Timelost,2038,48,2,3,5,40.0%,43m
37412,1,Frank,2037,692,24,32,56,42.9%,2h
37412,1,supermente,2037,609,23,30,53,43.4%,1h
37412,3,Zyndro,2037,228,21,38,59,35.6%,49m
37412,2,imtired,2037,547,20,27,47,42.6%,3h
37412,2,[CCUUCC]Gnarijuana,2037,484,18,28,46,39.1%,2h
37412,3,Naykyd,2037,533,17,28,45,37.8%,3h
37412,2,ProfessorOak,2037,311,13,7,20,65.0%,1h
37412,2,Craalb,2037,279,11,7,18,61.1%,3h
37412,2,LightningZap,2037,156,7,1,8,87.5%,3h
37412,2,xXOverMindXx,2037,214,7,15,22,31.8%,2h
37412,2,Etrain,2037,154,4,4,8,50.0%,2h
37412,1,xxMYMANxX,2037,171,4,11,15,26.7%,2h
37412,2,JeffDahmer,2037,102,2,1,3,66.7%,25m
37412,2,Vapouous,2037,114,2,5,7,28.6%,60m
37412,2,[FatPP]YumyumBB,2037,0,1,0,1,100.0%,52m
37412,1,HeMan,2037,48,1,2,3,33.3%,45m
37412,2,moldyCarrots,2037,0,0,1,1,0.0%,3h
37412,2,Levelsnake,2037,0,0,2,2,0.0%,2h
37412,2,Yudin,2037,0,0,6,6,0.0%,1h
37431,2,shinjiuchiha,2036,1171,95,85,180,52.8%,4m
37431,1,Pepefka,2036,1089,82,90,172,47.7%,2h
37431,2,Rusher,2036,786,31,28,59,52.5%,2h
37431,2,[Micr0]Ginnylynn,2036,512,19,22,41,46.3%,1h
37431,1,[420SC2]barbarian,2036,419,13,18,31,41.9%,2h
37431,2,azapheus,2036,141,5,1,6,83.3%,1h
37431,3,KodekX,2036,30,2,10,12,16.7%,55m
37431,2,Deathbringer,2036,0,1,4,5,20.0%,3h
37431,2,llllllllllll,2036,88,1,5,6,16.7%,15m
37431,2,Quezocoatl,2036,30,1,8,9,11.1%,31m
37441,2,TinSoldier,2035,1414,60,59,119,50.4%,2h
37441,2,Chronoboom,2035,327,9,20,29,31.0%,42m
37441,2,LUIZ,2035,176,7,4,11,63.6%,1h
37441,1,Fred,2035,156,5,15,20,25.0%,3h
37441,1,Jonathan,2035,213,4,10,14,28.6%,28m
37441,1,[TMKOs]grålöc,2035,96,3,4,7,42.9%,4m
37441,1,stryker,2035,0,1,8,9,11.1%,2h
37441,2,TrainingUnit,2035,0,0,5,5,0.0%,8m
37441,2,Delta,2035,0,0,6,6,0.0%,2h
37450,2,RenDrag,2034,684,39,50,89,43.8%,2h
37450,2,[xDYEx]manzur,2034,1030,36,40,76,47.4%,25m
37450,2,[oSa]Szam,2034,673,25,28,53,47.2%,1h
37450,2,govnr,2034,547,19,20,39,48.7%,2h
37450,2,tinyfist,2034,485,19,26,45,42.2%,2h
37450,2,Salvador,2034,305,17,17,34,50.0%,19m
37450,2,ricP,2034,332,13,11,24,54.2%,49m
37450,1,JaseEF,2034,348,10,22,32,31.2%,2h
37450,2,CptnBuckaroo,2034,249,9,7,16,56.2%,1h
37450,2,ODIN,2034,203,6,5,11,54.5%,2h
37450,2,Borisin,2034,197,6,5,11,54.5%,2h
37450,1,[CCoWW]Willindorn,2034,114,5,9,14,35.7%,3h
37450,1,coward,2034,48,4,6,10,40.0%,10m
37450,1,Kaylix,2034,142,4,11,15,26.7%,1h
37450,1,[franci]francis,2034,212,4,19,23,17.4%,11m
37450,2,AnalScorcher,2034,30,3,4,7,42.9%,2h
37450,2,Solitaire,2034,118,2,8,10,20.0%,1h
37450,1,entropi,2034,38,2,9,11,18.2%,2h
37450,2,voidleecher,2034,30,1,7,8,12.5%,3h
37450,2,Askedmed,2034,0,0,1,1,0.0%,3h
37470,1,pocoyo,2033,353,12,17,29,41.4%,14m
37470,2,[OhWoW]ThEdUdE,2033,192,7,10,17,41.2%,1h
37470,2,Roger,2033,130,5,9,14,35.7%,2h
37470,2,MacroKing,2033,145,4,5,9,44.4%,52m
37470,2,Dumbname,2033,86,2,8,10,20.0%,3h
37470,2,JUANDAVID,2033,0,0,6,6,0.0%,52m
37476,1,BaradaTonta,2032,829,71,79,150,47.3%,45m
37476,2,Emergence,2032,984,42,43,85,49.4%,54m
37476,2,chuydog,2032,390,18,10,28,64.3%,3h
37476,1,Asparagus,2032,30,4,6,10,40.0%,3h
37476,2,Luka,2032,0,2,2,4,50.0%,2h
37476,3,peekeg,2032,0,2,3,5,40.0%,2h
37476,1,Lomildor,2032,64,2,7,9,22.2%,29m
37476,2,Origen,2032,92,2,8,10,20.0%,2h
37476,2,SCARFACE,2032,0,1,1,2,50.0%,2h
37476,1,nightmare,2032,0,1,6,7,14.3%,3h
37476,2,Sasquatch,2032,0,0,1,1,0.0%,3h
37476,2,[GGBr0]ADDICTED,2032,0,0,2,2,0.0%,1h
37476,2,Holoyuri,2032,0,0,2,2,0.0%,2h
37476,2,direrraven,2032,0,0,6,6,0.0%,18m
37490,2,CHUCKNORRIS,2031,510,18,24,42,42.9%,20m
37490,2,WilliamFurno,2031,178,7,6,13,53.8%,3h
37490,2,LightWolf,2031,142,5,7,12,41.7%,49m
37490,2,Mozambiqued,2031,128,3,3,6,50.0%,1h
37490,2,Lunamax,2031,46,3,7,10,30.0%,2h
37490,2,Georges,2031,0,0,4,4,0.0%,3h
37490,2,cochalo,2031,0,0,5,5,0.0%,3h
37490,2,llllllllllll,2031,0,0,6,6,0.0%,8m
37498,1,djtal,2030,446,94,99,193,48.7%,46m
37498,2,HASGARD,2030,1362,66,70,136,48.5%,2h
37498,2,frugele,2030,939,36,44,80,45.0%,22m
37498,2,probox,2030,461,18,20,38,47.4%,49m
37498,2,Matt,2030,368,14,16,30,46.7%,57m
37498,2,BlackSky,2030,263,10,3,13,76.9%,1h
37498,2,mikwerdna,2030,214,6,11,17,35.3%,3h
37498,2,daimremREWES,2030,0,1,0,1,100.0%,19m
37498,2,carlos,2030,30,1,2,3,33.3%,31m
37498,1,JTrade,2030,0,1,8,9,11.1%,2h
37498,2,Platano,2030,0,0,4,4,0.0%,3h
37509,2,Aloha,2029,1013,38,38,76,50.0%,3h
37509,1,Aenima,2029,504,31,38,69,44.9%,2h
37509,2,Komzy,2029,389,20,22,42,47.6%,1h
37509,2,SgtFluffy,2029,517,19,18,37,51.4%,1h
37509,2,Funktazma,2029,360,11,18,29,37.9%,42m
37509,1,Drako,2029,221,7,9,16,43.8%,2h
37509,2,lss,2029,89,5,1,6,83.3%,2h
37509,1,PWRDark,2029,117,4,7,11,36.4%,2h
37509,2,MicroMachine,2029,60,2,3,5,40.0%,3h
37509,2,bushmarine,2029,0,1,2,3,33.3%,31m
37509,1,Agatean,2029,0,0,1,1,0.0%,3h
37509,2,JAE,2029,0,0,1,1,0.0%,57m
37521,2,magicturtle,2028,529,22,21,43,51.2%,3h
37521,1,XTREME,2028,408,17,23,40,42.5%,15m
37521,2,Juicelord,2028,493,16,22,38,42.1%,3h
37521,2,TheHobGobler,2028,183,6,5,11,54.5%,3h
37521,2,FNGRBLSTR,2028,196,6,6,12,50.0%,3h
37521,2,BossmanX,2028,0,1,3,4,25.0%,3h
37521,1,ESTEBAN,2028,0,1,8,9,11.1%,2h
37521,2,Avenger,2028,0,0,1,1,0.0%,8m
37521,2,Kolfur,2028,0,0,1,1,0.0%,8m
37521,3,AsesinoNorti,2028,0,0,3,3,0.0%,22m
37521,2,tde,2028,0,0,6,6,0.0%,55m
37532,2,Brogue,2027,576,20,22,42,47.6%,15m
37532,2,PREACMUONS,2027,228,11,6,17,64.7%,2h
37532,2,ProfArronax,2027,124,7,16,23,30.4%,3h
37532,2,darklordhill,2027,212,6,18,24,25.0%,31m
37532,1,INFERNOPRO,2027,144,4,7,11,36.4%,2m
37532,2,Guterbaljo,2027,0,1,1,2,50.0%,55m
37532,2,mrgio,2027,0,0,2,2,0.0%,2h
37539,1,darkstiglitz,2026,751,34,36,70,48.6%,11m
37539,1,entropy,2026,560,21,24,45,46.7%,24m
37539,2,Crisstomvs,2026,423,14,23,37,37.8%,2h
37539,2,CCCP,2026,367,12,15,27,44.4%,2h
37539,3,TheBirdFace,2026,326,11,18,29,37.9%,1h
37539,2,PaNDitA,2026,0,4,3,7,57.1%,2h
37539,2,[C4NN0N]Conspiracy,2026,48,4,5,9,44.4%,2h
37539,2,Little,2026,0,1,1,2,50.0%,31m
37539,3,SgtoTony,2026,30,1,1,2,50.0%,2h
37539,1,Joker,2026,0,1,6,7,14.3%,2h
37539,2,rainon,2026,30,1,7,8,12.5%,3h
37539,2,IIITHOMASIII,2026,30,1,7,8,12.5%,2h
37539,3,Moltar,2026,0,0,1,1,0.0%,2h
37539,2,Patar,2026,0,0,6,6,0.0%,39m
37539,2,Ackerman,2026,0,0,6,6,0.0%,2h
37554,2,Wrel,2025,152,5,7,12,41.7%,1h
37554,3,PolskiBoi,2025,161,4,5,9,44.4%,3h
37554,2,[QCArmy]tackell,2025,88,2,1,3,66.7%,23m
37554,3,ezeld,2025,0,1,1,2,50.0%,60m
37554,1,Wingbox,2025,0,0,1,1,0.0%,2h
37554,2,kanec,2025,0,0,2,2,0.0%,42m
37560,2,PapaMidnight,2024,1026,39,38,77,50.6%,49m
37560,2,Tricky,2024,851,38,28,66,57.6%,11m
37560,3,Luebs,2024,577,22,21,43,51.2%,3h
37560,2,Debauch,2024,431,19,16,35,54.3%,1h
37560,1,JohnMartin,2024,540,19,21,40,47.5%,1h
37560,2,beryl,2024,88,4,5,9,44.4%,2h
37560,1,SANGETSU,2024,190,3,5,8,37.5%,53m
37560,2,blademaster,2024,135,2,2,4,50.0%,1h
37560,2,Gnumer,2024,0,2,4,6,33.3%,3h
37560,2,ToiletDive,2024,96,2,5,7,28.6%,8m
37560,3,MrJakeSnake,2024,121,2,8,10,20.0%,1h
37560,1,Socrates,2024,30,2,8,10,20.0%,34m
37560,1,SanTisimo,2024,97,1,4,5,20.0%,3h
37560,3,RingoStarr,2024,0,0,1,1,0.0%,2h
37560,3,cuervoNegro,2024,0,0,1,1,0.0%,2h
37560,2,theoppofdog,2024,0,0,4,4,0.0%,3h
37576,3,KevinGainElo,2023,278,18,8,26,69.2%,52m
37576,2,[GRNSKN]LETHALxDRONE,2023,332,13,14,27,48.1%,7m
37576,2,SaRkO,2023,310,13,15,28,46.4%,39m
37576,1,[DBASAF]shadycat,2023,190,5,11,16,31.2%,46m
37576,2,Skinare,2023,100,3,6,9,33.3%,13m
37576,2,killerkira,2023,114,2,2,4,50.0%,12m
37576,2,Jcoop,2023,0,2,4,6,33.3%,4m
37576,2,coldtose,2023,0,1,2,3,33.3%,2h
37576,3,[ALTF04]SAMISHERMES,2023,0,0,1,1,0.0%,1h
37576,3,Nasdry,2023,0,0,1,1,0.0%,48m
37586,2,Rossdale,2022,1102,142,157,299,47.5%,1h
37586,2,voilierrouge,2022,968,39,40,79,49.4%,3h
37586,2,Ren,2022,880,32,36,68,47.1%,38m
37586,2,ShadowZack,2022,636,25,23,48,52.1%,54m
37586,1,Gagi,2022,708,23,31,54,42.6%,1h
37586,2,[AbcCo]Neblip,2022,178,8,12,20,40.0%,16m
37586,3,Darius,2022,144,5,3,8,62.5%,3h
37586,2,nerok,2022,124,5,9,14,35.7%,20m
37586,1,Zyron,2022,188,5,11,16,31.2%,43m
37586,2,mamatroll,2022,122,3,6,9,33.3%,23m
37586,2,bTsfOreVeR,2022,191,3,9,12,25.0%,3h
37586,2,[SWOU]Rookspwnshop,2022,115,2,2,4,50.0%,47m
37586,2,Smoogles,2022,64,2,11,13,15.4%,12m
37586,1,[AbcCo]Amir,2022,48,1,1,2,50.0%,2h
37586,2,ScareKrow,2022,30,1,7,8,12.5%,31m
37586,1,galvatron,2022,36,1,7,8,12.5%,18m
37586,1,razord,2022,0,1,7,8,12.5%,15m
37586,3,ruler,2022,0,0,1,1,0.0%,2h
37604,3,[10MMR]Swarm,2021,699,26,27,53,49.1%,19m
37604,1,Dabby,2021,312,9,13,22,40.9%,3h
37604,1,[SWOU]darkfox,2021,233,7,16,23,30.4%,26m
37604,2,OdebYaráPium,2021,102,2,7,9,22.2%,1h
37604,2,Hershel,2021,60,2,8,10,20.0%,2h
37604,3,Typhon,2021,0,1,0,1,100.0%,52m
37604,2,phoders,2021,97,1,5,6,16.7%,2h
37604,2,raftol,2021,30,1,7,8,12.5%,15m
37612,2,HBKqueef,2020,1568,220,224,444,49.5%,3h
37612,1,DNO,2020,1142,160,174,334,47.9%,59m
37612,3,Samojht,2020,331,14,13,27,51.9%,33m
37612,3,Neft,2020,303,11,10,21,52.4%,33m
37612,1,Drake,2020,168,6,15,21,28.6%,50m
37612,2,Joey,2020,203,4,8,12,33.3%,1h
37612,2,[DSz]zerghardi,2020,0,3,3,6,50.0%,52m
37612,2,hoon,2020,64,3,4,7,42.9%,15m
37612,3,Willlipe,2020,30,2,1,3,66.7%,1h
37612,3,Polvus,2020,0,2,7,9,22.2%,52m
37612,3,[FFAA]NiceHand,2020,0,1,4,5,20.0%,1h
37612,2,[XpKAc]Nando,2020,0,0,2,2,0.0%,2h
37612,2,ViRioN,2020,0,0,3,3,0.0%,18m
37625,2,MAURI,2019,982,39,37,76,51.3%,23m
37625,2,Lihuel,2019,466,16,16,32,50.0%,3h
37625,3,BooMSelectA,2019,290,10,15,25,40.0%,57m
37625,2,[hikari]Katsumi,2019,129,4,5,9,44.4%,22m
37625,1,Marcosjaimel,2019,145,3,9,12,25.0%,24m
37625,2,Xeno,2019,46,1,7,8,12.5%,48m
37625,3,[P0t4t0]Rawr,2019,30,1,29,30,3.3%,6m
37625,3,Hamsplosion,2019,0,0,5,5,0.0%,2h
37625,2,Username,2019,0,0,6,6,0.0%,18m
37634,2,ERIK,2018,757,40,32,72,55.6%,3h
37634,2,Igmopop,2018,916,39,33,72,54.2%,1h
37634,2,YungRicey,2018,618,22,31,53,41.5%,19m
37634,2,MaTT,2018,198,8,12,20,40.0%,3h
37634,3,Fuleyazon,2018,162,6,6,12,50.0%,1h
37634,1,JackHerrer,2018,159,6,8,14,42.9%,3h
37634,1,Zergerino,2018,0,3,5,8,37.5%,3h
37634,1,SilentStorm,2018,48,2,4,6,33.3%,42m
37634,1,RaZ,2018,0,1,7,8,12.5%,3h
37634,2,patrick,2018,0,0,2,2,0.0%,12m
37634,1,Haywire,2018,0,0,4,4,0.0%,2h
37634,1,Ditter,2018,0,0,4,4,0.0%,3h
37634,1,GriPs,2018,0,0,6,6,0.0%,42m
37634,2,grayco,2018,0,0,6,6,0.0%,39m
37634,2,Thesuperamo,2018,0,0,6,6,0.0%,1h
37634,3,PezNeck,2018,0,0,8,8,0.0%,3h
37650,2,[pLaYaS]mrjenkins,2017,903,97,104,201,48.3%,14m
37650,2,HFernandez,2017,644,49,46,95,51.6%,3h
37650,2,Rico,2017,1116,46,43,89,51.7%,2h
37650,2,Monch,2017,310,12,20,32,37.5%,22m
37650,2,JãoTI,2017,270,10,7,17,58.8%,60m
37650,1,Drath,2017,230,10,14,24,41.7%,3h
37650,2,positronium,2017,120,5,14,19,26.3%,54m
37650,1,kuro,2017,100,4,11,15,26.7%,2h
37650,3,GlueSniffer,2017,88,3,2,5,60.0%,2h
37650,3,[dengue]Jaum,2017,0,2,3,5,40.0%,56m
37650,2,Jedi,2017,30,1,5,6,16.7%,49m
37650,1,[kOOp]hax,2017,0,0,4,4,0.0%,2h
37650,2,Encanzo,2017,0,0,6,6,0.0%,2h
37663,2,Scoe,2016,1399,62,62,124,50.0%,19m
37663,1,XINYIU,2016,1660,58,79,137,42.3%,20m
37663,1,Chance,2016,653,21,35,56,37.5%,47m
37663,2,DevilFish,2016,323,12,9,21,57.1%,3h
37663,2,Scrid,2016,212,9,7,16,56.2%,3h
37663,2,Commander,2016,180,5,10,15,33.3%,3h
37663,3,LUCIFER,2016,30,1,1,2,50.0%,52m
37663,2,[M1V1P]Immortal,2016,0,1,1,2,50.0%,50m
37663,3,zergatoss,2016,0,0,1,1,0.0%,59m
37663,2,NukeStrike,2016,0,0,1,1,0.0%,8m
37663,3,zZeamuZz,2016,0,0,5,5,0.0%,57m
37674,2,jrscriv,2015,1408,77,70,147,52.4%,3h
37674,2,ShackAttack,2015,576,21,19,40,52.5%,3h
37674,2,[Grimm6]Grimmjow,2015,343,12,22,34,35.3%,1h
37674,3,fizzyelf,2015,194,6,14,20,30.0%,18m
37674,3,Novo,2015,62,4,12,16,25.0%,2h
37674,2,[7SDS]sevdeadsin,2015,88,3,5,8,37.5%,42m
37674,2,ramsesxix,2015,95,3,5,8,37.5%,2h
37674,2,Yuriz,2015,38,2,6,8,25.0%,32m
37674,3,Ingas,2015,30,2,11,13,15.4%,22m
37674,1,jofl,2015,0,1,0,1,100.0%,2h
37674,2,[Lucky6]Quantonium,2015,30,1,3,4,25.0%,1h
37674,3,[FFAA]Enmanuel,2015,0,0,5,5,0.0%,3h
37686,2,XGuardianZ,2014,932,53,48,101,52.5%,3h
37686,2,killlghosts,2014,703,45,49,94,47.9%,16m
37686,1,Beto,2014,911,34,38,72,47.2%,57m
37686,3,Potatomaster,2014,452,17,9,26,65.4%,22m
37686,3,Hydralisk,2014,311,11,3,14,78.6%,1h
37686,2,Pricursor,2014,241,8,12,20,40.0%,19m
37686,2,ronald,2014,218,7,18,25,28.0%,3h
37686,2,Vicboss,2014,158,5,11,16,31.2%,1h
37686,1,snowman,2014,160,4,3,7,57.1%,2h
37686,2,[ExcIgN]rokoloc,2014,60,2,4,6,33.3%,59m
37686,2,crackfienz,2014,30,1,1,2,50.0%,1h
37686,2,Destruction,2014,96,1,2,3,33.3%,2h
37686,2,Eric,2014,46,1,8,9,11.1%,2h
37686,3,[loja]Miktian,2014,0,0,1,1,0.0%,3h
37686,3,Tommy,2014,0,0,1,1,0.0%,33m
37686,2,Ethan,2014,0,0,4,4,0.0%,49m
37702,2,CodeBar,2013,1290,89,98,187,47.6%,42m
37702,2,MARS,2013,1638,64,83,147,43.5%,3h
37702,3,doonder,2013,1387,55,82,137,40.1%,3h
37702,2,NICODEMUS,2013,522,22,17,39,56.4%,3h
37702,2,SDWolf,2013,136,7,5,12,58.3%,57m
37702,3,ZerVencedor,2013,0,5,0,5,100.0%,28m
37702,3,sebastian,2013,0,2,2,4,50.0%,29m
37702,2,Zealot,2013,0,1,0,1,100.0%,2h
37702,3,Megashark,2013,0,1,0,1,100.0%,8m
37702,1,CRISTIAN,2013,0,1,7,8,12.5%,30m
37702,1,Zues,2013,0,0,1,1,0.0%,2h
37702,3,MaxFerrite,2013,0,0,1,1,0.0%,1h
37714,2,EZEnzaen,2012,332,11,11,22,50.0%,60m
37714,2,[GGMESP]Mozart,2012,262,9,12,21,42.9%,1h
37714,2,quest,2012,216,6,8,14,42.9%,7m
37714,1,Jigsaw,2012,216,6,9,15,40.0%,2h
37714,2,JAVI,2012,182,6,9,15,40.0%,14m
37714,2,[LegSC]HoYing,2012,144,3,4,7,42.9%,2h
37714,3,Duloxetine,2012,58,2,5,7,28.6%,59m
37714,2,Verme,2012,30,1,3,4,25.0%,3h
37714,3,WILLIAM,2012,38,1,3,4,25.0%,57m
37714,2,SheepKiller,2012,0,1,4,5,20.0%,2h
37724,3,olix,2011,402,14,16,30,46.7%,2h
37724,3,Jake,2011,86,4,0,4,100.0%,47m
37724,2,iCrazyJarvis,2011,126,4,7,11,36.4%,3h
37724,2,Onemanband,2011,72,4,14,18,22.2%,31m
37724,2,Gravix,2011,88,3,10,13,23.1%,1h
37724,3,[RSC2]Coronel,2011,0,2,3,5,40.0%,1h
37724,2,EXTREMIX,2011,0,1,3,4,25.0%,12m
37724,3,Momia,2011,0,0,2,2,0.0%,1h
37732,2,[3x0diA]cLMarines,2010,1112,63,66,129,48.8%,3h
37732,3,[NePe]Tatascan,2010,543,24,9,33,72.7%,48m
37732,2,JamesBreznev,2010,478,18,39,57,31.6%,3h
37732,2,Ironfist,2010,526,17,23,40,42.5%,15m
37732,2,Sputnik,2010,250,10,17,27,37.0%,3h
37732,2,[WolfX]SINVERGUENZA,2010,46,2,2,4,50.0%,3h
37732,3,Wishak,2010,97,2,2,4,50.0%,32m
37732,3,Wind,2010,0,0,1,1,0.0%,29m
37732,3,[BWZz]Butterflyluv,2010,0,0,1,1,0.0%,29m
37732,2,Gohan,2010,0,0,6,6,0.0%,3h
37742,2,IVXX,2009,195,6,8,14,42.9%,3h
37742,3,Evilcedric,2009,30,2,0,2,100.0%,2h
37742,3,andrwdnnis,2009,0,1,4,5,20.0%,2h
37742,2,LIkEABOSS,2009,0,0,2,2,0.0%,2h
37742,2,cafecomleite,2009,0,0,2,2,0.0%,1h
37742,3,Magno,2009,0,0,5,5,0.0%,22m
37748,1,picatrix,2008,893,101,120,221,45.7%,15m
37748,2,Kamva,2008,626,48,53,101,47.5%,57m
37748,2,salviano,2008,424,13,19,32,40.6%,23m
37748,3,Foxtrot,2008,330,12,12,24,50.0%,52m
37748,2,Zero,2008,374,12,15,27,44.4%,3h
37748,3,[exPFC]exPFCgoats,2008,166,6,19,25,24.0%,13m
37748,1,Nabbit,2008,239,5,6,11,45.5%,1h
37748,1,honey,2008,151,5,11,16,31.2%,42m
37748,2,Sasha,2008,156,4,4,8,50.0%,31m
37748,2,Pennunjun,2008,88,3,6,9,33.3%,1h
37748,2,stutter,2008,92,3,7,10,30.0%,2h
37748,1,Jin,2008,0,2,6,8,25.0%,3h
37748,3,[PotE]Camzz,2008,0,0,1,1,0.0%,6m
37748,3,TOP,2008,0,0,5,5,0.0%,17m
37762,2,DerioxXp,2007,1284,96,102,198,48.5%,3h
37762,2,Spiro,2007,340,10,11,21,47.6%,2h
37762,1,Teeters,2007,96,3,11,14,21.4%,29m
37762,2,joebob,2007,0,0,6,6,0.0%,2h
37766,2,xcc,2006,214,10,12,22,45.5%,2h
37766,3,SpiderJ,2006,205,9,7,16,56.2%,46m
37766,3,[Bru1al]PillowBoy,2006,112,2,5,7,28.6%,19m
37766,3,gusta,2006,0,1,0,1,100.0%,46m
37766,2,[Bhros]Feljator,2006,0,1,4,5,20.0%,2h
37766,2,Pop,2006,30,1,5,6,16.7%,1h
37766,2,Rebel,2006,0,1,6,7,14.3%,2h
37766,2,Art,2006,46,1,8,9,11.1%,59m
37766,1,elroble,2006,0,0,4,4,0.0%,1h
37775,2,Mikoto,2005,1156,122,142,264,46.2%,56m
37775,1,Tobi,2005,1646,82,87,169,48.5%,2h
37775,1,[dtwist]DarkVoice,2005,1262,69,44,113,61.1%,25m
37775,2,NovaZerg,2005,610,20,29,49,40.8%,3h
37775,3,Amsterdan,2005,30,3,3,6,50.0%,2h
37775,1,Aerithvia,2005,140,3,9,12,25.0%,1h
37775,2,CALDOMAN,2005,97,2,4,6,33.3%,54m
37775,2,TNOZADAR,2005,38,2,5,7,28.6%,3h
37775,2,Pogz,2005,102,2,7,9,22.2%,11m
37775,3,Azazel,2005,0,1,0,1,100.0%,57m
37775,2,[FNES1]OHWTV,2005,0,1,3,4,25.0%,3h
37775,3,[SCIIpy]Vash,2005,0,1,4,5,20.0%,2h
37775,3,Maliciousgoo,2005,0,0,2,2,0.0%,18m
37775,2,flowers,2005,0,0,2,2,0.0%,2h
37775,2,SauceySauce,2005,0,0,6,6,0.0%,48m
37775,2,pdq,2005,0,0,6,6,0.0%,58m
37791,2,Monteclinto,2004,980,44,34,78,56.4%,50m
37791,2,Tijarod,2004,86,3,3,6,50.0%,57m
37791,1,[ROA1]CJOEL,2004,143,2,5,7,28.6%,2h
37791,3,Blackout,2004,0,1,2,3,33.3%,1h
37791,2,PolarisStar,2004,48,1,6,7,14.3%,2h
37791,3,[PATACH]thonyboy,2004,0,0,1,1,0.0%,2h
37791,3,Vulpecula,2004,0,0,1,1,0.0%,53m
37791,1,SlagBuster,2004,0,0,2,2,0.0%,2h
37791,3,chimpandolfo,2004,0,0,5,5,0.0%,19m
37800,2,draxerel,2003,398,12,17,29,41.4%,2h
37800,1,Andrew,2003,320,10,13,23,43.5%,30m
37800,2,terasilfo,2003,180,6,16,22,27.3%,2h
37800,2,Mac,2003,116,4,1,5,80.0%,55m
37800,3,[MFNS]QuickSilverZ,2003,114,4,3,7,57.1%,5m
37800,2,Cwide,2003,92,2,8,10,20.0%,23m
37800,1,kirlanx,2003,48,2,10,12,16.7%,2h
37800,2,XaRdOz,2003,0,0,1,1,0.0%,49m
37800,2,MrAcorn,2003,0,0,3,3,0.0%,23m
37809,2,James,2002,1605,141,157,298,47.3%,3h
37809,2,Atrocity,2002,234,6,10,16,37.5%,2h
37809,2,[OPLADR]ForbiddenOne,2002,111,4,4,8,50.0%,53m
37809,2,Behastie,2002,120,4,9,13,30.8%,2h
37809,3,dblock,2002,0,1,4,5,20.0%,2h
37814,1,Magius,2001,590,24,27,51,47.1%,47m
37814,2,Dogmar,2001,279,21,26,47,44.7%,2h
37814,2,SorryDude,2001,271,10,19,29,34.5%,38m
37814,3,CygnusDX,2001,222,8,5,13,61.5%,56m
37814,2,CanOpener,2001,88,4,8,12,33.3%,42m
37814,2,mothoglan,2001,70,3,8,11,27.3%,2h
37814,3,Dallas,2001,0,0,1,1,0.0%,42m
37814,3,[JUGOS]alexis,2001,0,0,1,1,0.0%,1h
37814,2,Combo,2001,0,0,6,6,0.0%,3h
37823,2,ZERGJC,2000,1516,67,79,146,45.9%,52m
37823,2,Phlaigh,2000,639,25,31,56,44.6%,3h
37823,2,NorthWood,2000,46,4,5,9,44.4%,1h
37823,2,Rokki,2000,96,4,6,10,40.0%,55m
37823,2,HiddenEmpire,2000,48,1,7,8,12.5%,1h
37823,1,IkerAS,2000,90,1,9,10,10.0%,32m
37823,3,MHATIUS,2000,0,0,3,3,0.0%,57m
37830,3,Nope,1999,332,12,12,24,50.0%,3h
37830,3,chato,1999,244,9,7,16,56.2%,2h
37830,2,[ACCR]belOwZerO,1999,188,7,8,15,46.7%,60m
37830,3,RiverOnthway,1999,88,3,3,6,50.0%,3h
37830,3,HaloTach,1999,18,2,0,2,100.0%,2h
37830,2,Blackshape,1999,114,2,3,5,40.0%,15m
37830,1,DarthSniper,1999,0,1,0,1,100.0%,27m
37830,2,Achilles,1999,44,1,2,3,33.3%,3h
37830,2,Swisher,1999,30,1,7,8,12.5%,44m
37830,1,Alex,1999,88,1,8,9,11.1%,34m
37830,2,hellturtle,1999,0,0,6,6,0.0%,2h
37841,2,PiiPiiHead,1998,578,20,29,49,40.8%,3m
37841,2,BlackOut,1998,467,17,14,31,54.8%,3h
37841,1,Fingerdance,1998,164,7,12,19,36.8%,2h
37841,2,[GaaaSQ]iSrAlex,1998,0,3,2,5,60.0%,22m
37841,1,Ender,1998,0,1,0,1,100.0%,2h
37841,3,[SCMK]Negas,1998,96,1,4,5,20.0%,47m
37841,2,PainSerj,1998,0,1,5,6,16.7%,1h
37841,3,chupameesta,1998,97,1,10,11,9.1%,16m
37841,3,iNsticT,1998,0,0,5,5,0.0%,2h
37841,3,StormCross,1998,0,0,5,5,0.0%,59m
37841,2,[TSCP]Ashtah,1998,0,0,5,5,0.0%,15m
37841,2,Azgul,1998,0,0,6,6,0.0%,1h
37853,2,MineCraft,1997,730,28,33,61,45.9%,2h
37853,2,Scotsman,1997,469,22,19,41,53.7%,3h
37853,2,Kia,1997,368,14,15,29,48.3%,1h
37853,2,[zerg9]zergDJ,1997,425,13,22,35,37.1%,49m
37853,3,Ittifi,1997,248,11,25,36,30.6%,34m
37853,1,Hitchslap,1997,249,10,13,23,43.5%,3h
37853,1,arkantos,1997,328,8,8,16,50.0%,2h
37853,2,Overlord,1997,156,7,2,9,77.8%,3h
37853,1,Eder,1997,237,6,13,19,31.6%,2h
37853,3,Jnoresl,1997,30,2,0,2,100.0%,5m
37853,2,CesarOS,1997,60,2,6,8,25.0%,2h
37853,1,[NLTN]carlostito,1997,48,1,1,2,50.0%,4m
37853,3,lloydxmas,1997,0,1,1,2,50.0%,48m
37853,3,Scott,1997,30,1,2,3,33.3%,56m
37853,2,jusn,1997,0,0,6,6,0.0%,5m
37868,1,VietNamHello,1996,0,4,4,8,50.0%,42m
37868,2,alolemur,1996,0,1,0,1,100.0%,39m
37868,3,badrhari,1996,0,1,4,5,20.0%,58m
37868,1,JuuzouSuzuya,1996,97,1,6,7,14.3%,27m
37872,2,SaiKisaragi,1995,1282,60,70,130,46.2%,1h
37872,2,[ASC1]TiredRaptor,1995,228,8,10,18,44.4%,3h
37872,2,[MAJ0R]Kusanagi,1995,166,6,11,17,35.3%,3h
37872,1,Cigratt,1995,168,3,7,10,30.0%,47m
37872,2,RML,1995,62,2,8,10,20.0%,15m
37872,3,Kral,1995,0,1,0,1,100.0%,3h
37872,1,adrianpro,1995,0,1,8,9,11.1%,1h
37872,3,Jnostrils,1995,0,0,1,1,0.0%,12m
37880,2,Underling,1994,1580,223,239,462,48.3%,3h
37880,2,HAVOC,1994,793,100,97,197,50.8%,2h
37880,2,[MaxWin]FrozenG,1994,1371,49,60,109,45.0%,3h
37880,3,Loz,1994,391,12,19,31,38.7%,52m
37880,1,fhingin,1994,388,12,21,33,36.4%,3h
37880,2,DLaw,1994,276,9,11,20,45.0%,22m
37880,2,[MKQLEA]Hulk,1994,115,3,7,10,30.0%,31m
37880,1,KevinYX,1994,0,1,1,2,50.0%,2h
37880,2,WayZ,1994,88,1,6,7,14.3%,3h
37880,1,alenpro,1994,0,1,7,8,12.5%,2h
37880,3,ForgottenOne,1994,0,0,1,1,0.0%,57m
37880,1,NumberOne,1994,0,0,2,2,0.0%,3h
37892,2,[oaRGho]mxd,1993,487,17,20,37,45.9%,53m
37892,3,Daellex,1993,163,13,12,25,52.0%,59m
37892,2,POIROT,1993,0,0,7,7,0.0%,44m
37895,2,HansTrooper,1992,549,22,17,39,56.4%,2h
37895,2,[TPGGXD]ChristianB,1992,236,8,7,15,53.3%,2h
37895,3,Astreus,1992,187,6,3,9,66.7%,3h
37895,2,BrightDyed,1992,121,3,3,6,50.0%,20m
37895,1,[UpxV]neil,1992,94,2,1,3,66.7%,2h
37895,3,Marogan,1992,0,2,3,5,40.0%,9m
37895,3,Miracle,1992,0,1,0,1,100.0%,22m
37895,2,Aguerosss,1992,0,1,1,2,50.0%,3h
37895,2,bunkwgn,1992,0,0,1,1,0.0%,48m
37904,1,Ito,1991,290,9,20,29,31.0%,21m
37904,3,Isan,1991,200,8,5,13,61.5%,60m
37904,3,LIMAS,1991,114,5,2,7,71.4%,3h
37904,2,[BCX119]Ale,1991,182,5,7,12,41.7%,1h
37904,2,fadedlotus,1991,120,4,6,10,40.0%,3h
37904,2,BigBlueFox,1991,133,3,4,7,42.9%,3h
37904,1,Amsterdam,1991,143,3,4,7,42.9%,2h
37904,3,SalmO,1991,0,3,6,9,33.3%,4m
37904,2,HowDoYouPlay,1991,58,3,10,13,23.1%,19m
37904,3,greenlepp,1991,30,1,2,3,33.3%,9m
37904,2,[ICahn]steare,1991,0,0,1,1,0.0%,2h
37904,3,[HWAR]YoungAtlas,1991,0,0,1,1,0.0%,2h
37904,2,Fruits,1991,0,0,3,3,0.0%,1h
37917,3,[SloBum]FrankCastle,1990,665,25,26,51,49.0%,17m
37917,3,RedOnionz,1990,464,17,9,26,65.4%,11m
37917,3,Ajax,1990,407,15,8,23,65.2%,8m
37917,1,Skeliott,1990,200,6,11,17,35.3%,1h
37917,2,Baleo,1990,0,3,4,7,42.9%,59m
37917,3,YippeeKiYay,1990,60,2,3,5,40.0%,2h
37917,2,RaphaLeão,1990,76,2,8,10,20.0%,2h
37917,3,[IrmBRs]valoroso,1990,30,1,3,4,25.0%,56m
37917,2,Glados,1990,88,1,3,4,25.0%,1h
37917,3,imdirtydan,1990,0,0,1,1,0.0%,18m
37927,2,Seaneboy,1989,711,26,36,62,41.9%,3h
37927,1,Javier,1989,348,13,20,33,39.4%,2h
37927,2,Bonst,1989,175,6,10,16,37.5%,2h
37927,2,ale,1989,88,2,4,6,33.3%,18m
37927,3,Nazaryel,1989,0,1,0,1,100.0%,22m
37927,3,Pentor,1989,30,1,2,3,33.3%,59m
37927,2,Ragingslaya,1989,0,1,6,7,14.3%,23m
37934,2,Mariame,1988,947,104,115,219,47.5%,2m
37934,1,SRG,1988,658,25,28,53,47.2%,3h
37934,3,Zornhau,1988,254,9,5,14,64.3%,57m
37934,3,Learning,1988,206,7,8,15,46.7%,2h
37934,3,[ZITAB1]AkaiWerito,1988,144,3,2,5,60.0%,2h
37934,3,[LMI42]JDOUBLE,1988,0,1,1,2,50.0%,2h
37934,1,candycekae,1988,0,1,8,9,11.1%,3h
37934,1,Vash,1988,0,0,1,1,0.0%,3h
37934,2,Clubspecial,1988,0,0,6,6,0.0%,42m
37934,2,MASTERALEX,1988,0,0,6,6,0.0%,16m
37944,3,[AngryB]NeedleBrakeR,1987,793,87,80,167,52.1%,2h
37944,3,infoattack,1987,200,7,7,14,50.0%,60m
37944,2,kaseywithak,1987,134,5,8,13,38.5%,3h
37944,1,[VETS]DonOmar,1987,164,4,1,5,80.0%,39m
37944,2,SlimShady,1987,0,1,3,4,25.0%,1h
37944,1,ALEMAO,1987,0,1,5,6,16.7%,2h
37944,2,JimmyNeutron,1987,0,0,3,3,0.0%,50m
37944,2,BigWillyBoi,1987,0,0,6,6,0.0%,32m
37952,2,mrbeefx,1986,782,31,32,63,49.2%,1h
37952,2,macroKing,1986,776,28,31,59,47.5%,1h
37952,2,sobriety,1986,240,9,13,22,40.9%,42m
37952,1,donavon,1986,0,2,7,9,22.2%,47m
37952,1,HabutFaka,1986,48,1,4,5,20.0%,1h
37952,3,[KGIA]Tassillio,1986,0,1,4,5,20.0%,1h
37952,3,GinjaNinja,1986,0,0,1,1,0.0%,19m
37959,2,victorXD,1985,747,35,43,78,44.9%,2h
37959,2,cucu,1985,476,21,18,39,53.8%,2h
37959,2,Aprendiz,1985,453,17,25,42,40.5%,31m
37959,3,LeoCWBr,1985,253,10,15,25,40.0%,1h
37959,2,[D4Bros]Italianlamb,1985,215,9,8,17,52.9%,2h
37959,1,FOX,1985,143,5,6,11,45.5%,2h
37959,1,Windu,1985,237,5,12,17,29.4%,24m
37959,2,CAZPER,1985,174,4,8,12,33.3%,52m
37959,1,GrayToar,1985,124,4,11,15,26.7%,3h
37959,3,xXjFeSpeCtXx,1985,62,3,12,15,20.0%,57m
37959,3,Infineon,1985,0,2,9,11,18.2%,2h
37959,1,Kai,1985,48,2,10,12,16.7%,3h
37959,3,dereaccion,1985,30,1,1,2,50.0%,3h
37959,1,Dalmuth,1985,0,1,7,8,12.5%,3h
37959,3,Tassadar,1985,0,0,1,1,0.0%,13m
37959,3,xdemianx,1985,0,0,1,1,0.0%,3h
37959,3,Artanis,1985,0,0,5,5,0.0%,3h
37959,3,Miqueagul,1985,0,0,5,5,0.0%,9m
37977,1,KAPUA,1984,1464,97,120,217,44.7%,3h
37977,3,slunky,1984,652,24,22,46,52.2%,47m
37977,2,isaacsu,1984,376,14,13,27,51.9%,3h
37977,2,keanarritos,1984,206,8,6,14,57.1%,2h
37977,1,MoreOrLess,1984,313,8,13,21,38.1%,3h
37977,2,hydra,1984,132,4,3,7,57.1%,2h
37977,2,Gonz,1984,102,3,1,4,75.0%,3h
37977,3,[AbcCo]kloctk,1984,0,1,0,1,100.0%,1h
37977,2,Arjuna,1984,46,1,5,6,16.7%,2h
37977,3,Moshé,1984,0,0,1,1,0.0%,9m
37977,3,Geoff,1984,0,0,2,2,0.0%,2h
37977,2,Detpack,1984,0,0,2,2,0.0%,23m
37977,2,Horbert,1984,0,0,2,2,0.0%,1h
37990,2,Ton,1983,868,33,40,73,45.2%,3h
37990,2,blank,1983,437,24,26,50,48.0%,2h
37990,2,dizzle,1983,455,20,17,37,54.1%,15m
37990,2,Andres,1983,408,14,16,30,46.7%,2h
37990,1,Tactician,1983,190,8,12,20,40.0%,1h
37990,2,duendeverde,1983,166,6,5,11,54.5%,22m
37990,3,BigKEV,1983,214,6,13,19,31.6%,45m
37990,3,jherico,1983,0,0,1,1,0.0%,25m
37990,2,zikuth,1983,0,0,6,6,0.0%,20m
37999,2,andrei,1982,978,83,85,168,49.4%,2h
37999,2,Tezcatlipoca,1982,357,14,16,30,46.7%,3h
37999,2,Billoman,1982,302,12,8,20,60.0%,1h
37999,1,[L3G4CY]Dread,1982,307,9,18,27,33.3%,3h
37999,1,TrivialLoops,1982,192,5,19,24,20.8%,57m
37999,2,kix,1982,0,0,4,4,0.0%,3h
38005,1,Spiderman,1981,626,26,33,59,44.1%,45m
38005,2,Duckwhite,1981,155,19,25,44,43.2%,3h
38005,2,Renfield,1981,480,17,20,37,45.9%,59m
38005,3,Atrocious,1981,454,17,20,37,45.9%,46m
38005,2,[MADPAM]Franco,1981,182,5,9,14,35.7%,31m
38005,3,JBMoonscape,1981,30,2,1,3,66.7%,2h
38005,2,[DVHSC]RATMATAZZ,1981,95,2,6,8,25.0%,23m
38005,3,HomingMidget,1981,0,1,0,1,100.0%,48m
38005,3,Ace,1981,30,1,2,3,33.3%,28m
38005,1,UnMen,1981,0,1,8,9,11.1%,54m
38005,1,[mustaf]Notlikethis,1981,0,0,1,1,0.0%,1h
38005,2,jade,1981,0,0,6,6,0.0%,59m
38017,2,username,1980,1259,52,59,111,46.8%,23m
38017,2,PenguinKing,1980,537,21,25,46,45.7%,15m
38017,1,leeboy,1980,472,17,22,39,43.6%,3h
38017,2,[icCCce]Firestorm,1980,151,6,5,11,54.5%,44m
38017,2,PANDASALVAJE,1980,0,1,0,1,100.0%,51m
38017,3,[ALTF04]Geo,1980,0,0,1,1,0.0%,3h
38017,3,AbdulHakeem,1980,0,0,1,1,0.0%,57m
38024,3,DEADLIFT,1979,935,36,27,63,57.1%,57m
38024,3,DavidHR,1979,713,36,35,71,50.7%,22m
38024,3,AdoyleRules,1979,200,7,8,15,46.7%,18m
38024,2,ilgard,1979,178,6,9,15,40.0%,3h
38024,2,NewFrenchman,1979,141,3,4,7,42.9%,1h
38024,3,Kerrigan,1979,30,1,12,13,7.7%,55m
38024,3,[PG101]LilChungis,1979,0,0,1,1,0.0%,2h
38031,2,Ethan,1978,1285,87,92,179,48.6%,15m
38031,2,HAMMER,1978,506,80,78,158,50.6%,2h
38031,1,SWOLYxCAT,1978,1035,35,51,86,40.7%,3h
38031,3,primerib,1978,126,4,7,11,36.4%,14m
38031,3,destructor,1978,86,3,1,4,75.0%,22m
38031,1,Leo,1978,144,3,7,10,30.0%,23m
38031,3,Raynor,1978,62,3,11,14,21.4%,2h
38031,3,Jcesar,1978,60,3,11,14,21.4%,39m
38031,2,[ROFLM]Shinybullet,1978,0,1,1,2,50.0%,2h
38040,2,Anim,1977,1238,132,140,272,48.5%,2h
38040,2,Devo,1977,1153,44,54,98,44.9%,2h
38040,2,Prodigy,1977,722,26,38,64,40.6%,3m
38040,2,Scotty,1977,569,22,21,43,51.2%,1h
38040,2,ARGET,1977,377,15,15,30,50.0%,1h
38040,2,ZombieHunter,1977,250,9,7,16,56.2%,3h
38040,2,Fiky,1977,226,7,7,14,50.0%,3h
38040,1,MASHOLE,1977,169,6,11,17,35.3%,3h
38040,1,Wombosi,1977,193,5,3,8,62.5%,29m
38040,2,[LoShay]NachoCapony,1977,156,4,7,11,36.4%,16m
38040,2,Magnifeye,1977,94,3,4,7,42.9%,2h
38040,1,ShadowDragon,1977,90,2,5,7,28.6%,27m
38040,2,ETPHQC,1977,46,2,6,8,25.0%,3h
38040,2,RadioBoi,1977,0,0,6,6,0.0%,1h
38054,2,SENSUI,1976,520,20,23,43,46.5%,3h
38054,2,AlphaOneIV,1976,442,15,22,37,40.5%,38m
38054,2,gigition,1976,350,14,24,38,36.8%,44m
38054,2,Burn,1976,46,5,6,11,45.5%,51m
38054,1,[CITIOS]TheFK,1976,193,4,6,10,40.0%,1h
38054,3,Overlord,1976,121,3,3,6,50.0%,52m
38054,1,smeagle,1976,95,2,1,3,66.7%,29m
38054,3,HoneyReeRee,1976,0,0,1,1,0.0%,2h
38054,3,Mazzu,1976,0,0,2,2,0.0%,2h
38054,2,Avut,1976,0,0,2,2,0.0%,51m
38054,3,Hormigón,1976,0,0,5,5,0.0%,58m
38054,2,hateme,1976,0,0,6,6,0.0%,44m
38066,2,Ymir,1975,1520,92,104,196,46.9%,2h
38066,2,Ares,1975,460,15,20,35,42.9%,16m
38066,3,PacificGamer,1975,46,2,1,3,66.7%,14m
38066,3,Gillitux,1975,30,1,6,7,14.3%,11m
38066,2,[XDL]DainonihBiBi,1975,48,1,8,9,11.1%,2h
38066,3,matasanos,1975,0,0,1,1,0.0%,22m
38066,1,WOJTEK,1975,0,0,1,1,0.0%,1h
38066,3,ShadowWalker,1975,0,0,2,2,0.0%,47m
38066,3,[kØ]Srpankeke,1975,0,0,2,2,0.0%,58m
38075,2,AlienatorZ,1974,1588,220,240,460,47.8%,54m
38075,2,Lystat,1974,794,61,73,134,45.5%,58m
38075,2,RudyoBom,1974,1497,57,62,119,47.9%,1h
38075,2,GrownTea,1974,606,21,28,49,42.9%,3h
38075,2,deEz,1974,218,7,10,17,41.2%,2h
38075,1,MegaBoss,1974,97,2,4,6,33.3%,53m
38075,1,KSK,1974,48,2,8,10,20.0%,14m
38075,2,Feyd,1974,42,1,4,5,20.0%,1h
38075,1,rdiddles,1974,0,1,10,11,9.1%,29m
38075,3,Martz,1974,0,0,1,1,0.0%,28m
38085,2,Neno,1973,494,22,20,42,52.4%,11m
38085,3,SukMyCrit,1973,370,13,15,28,46.4%,33m
38085,3,[Year06]bigjoe,1973,246,9,7,16,56.2%,8m
38085,3,cgh,1973,148,5,4,9,55.6%,2h
38085,1,SalazarNT,1973,192,5,14,19,26.3%,1h
38085,1,Merthos,1973,0,1,3,4,25.0%,15m
38085,3,[NOVOPS]DILLYDOG,1973,92,1,7,8,12.5%,8m
38085,2,xyruo,1973,0,0,5,5,0.0%,3h
38093,1,[CXMP]Gooey,1972,1639,58,76,134,43.3%,3h
38093,2,tatsumi,1972,154,6,8,14,42.9%,23m
38093,2,Raygar,1972,0,3,3,6,50.0%,3h
38093,1,paosroach,1972,0,1,1,2,50.0%,13m
38093,1,Thadrach,1972,0,1,8,9,11.1%,3h
38093,2,ShadowXlayer,1972,0,0,6,6,0.0%,23m
38099,1,Mmadmax,1971,1603,117,133,250,46.8%,2h
38099,1,Demo,1971,956,81,82,163,49.7%,9m
38099,3,headhunter,1971,1560,81,112,193,42.0%,17m
38099,2,Bobzilla,1971,506,25,30,55,45.5%,3h
38099,2,SmargfX,1971,657,22,26,48,45.8%,55m
38099,3,chunchumaru,1971,489,18,10,28,64.3%,27m
38099,3,feast,1971,318,11,9,20,55.0%,25m
38099,3,rXycenobita,1971,281,11,9,20,55.0%,9m
38099,2,[FyH]salomon,1971,174,6,14,20,30.0%,2h
38099,2,[ISMDI]SaberTooth,1971,58,4,7,11,36.4%,23m
38099,3,Swordkiller,1971,30,2,1,3,66.7%,46m
38099,1,Cochiwarrior,1971,48,2,12,14,14.3%,45m
38099,1,Thunderpain,1971,0,1,0,1,100.0%,2h
38099,1,Lytotes,1971,0,1,7,8,12.5%,2h
38099,3,Sacubutrilo,1971,0,0,1,1,0.0%,3h
38114,3,Reijik,1970,894,34,31,65,52.3%,8m
38114,3,Fiot,1970,411,25,17,42,59.5%,1h
38114,3,Santino,1970,380,17,19,36,47.2%,3h
38114,2,ELGOSU,1970,392,14,14,28,50.0%,3h
38114,2,Sneezy,1970,292,11,18,29,37.9%,31m
38114,1,rtia,1970,254,8,19,27,29.6%,2h
38114,2,peteplantman,1970,184,6,6,12,50.0%,3h
38114,1,TimeForCrab,1970,198,5,4,9,55.6%,45m
38114,1,Roku,1970,141,4,4,8,50.0%,3h
38114,2,Garrison,1970,58,3,4,7,42.9%,16m
38114,2,WAIT,1970,93,2,0,2,100.0%,9m
38114,2,Duracel,1970,110,2,4,6,33.3%,1h
38114,2,Stormchild,1970,0,2,5,7,28.6%,2h
38114,3,Feha,1970,0,1,2,3,33.3%,19m
38114,1,migredanquin,1970,48,1,6,7,14.3%,45m
38114,3,zerathull,1970,0,0,1,1,0.0%,11m
38114,2,[oye]VirusNK,1970,0,0,1,1,0.0%,18m
38114,3,StarDestroy,1970,0,0,1,1,0.0%,16m
38114,1,RAGE,1970,0,0,5,5,0.0%,1h
38114,2,[TeePee]VryAwsmJJ,1970,0,0,6,6,0.0%,1h
38114,2,lowcandrew,1970,0,0,6,6,0.0%,2h
38135,2,tsjjm,1969,842,39,31,70,55.7%,23m
38135,3,[BO0MER]EricTheRippr,1969,448,17,17,34,50.0%,1h
38135,1,ytrewq,1969,415,15,19,34,44.1%,6m
38135,3,Diogenes,1969,399,14,21,35,40.0%,56m
38135,1,[2faded]WhaTever,1969,93,2,8,10,20.0%,6m
38135,2,MushroomCake,1969,0,1,1,2,50.0%,47m
38135,3,Ivan,1969,0,1,1,2,50.0%,22m
38135,3,GoldenPants,1969,0,0,6,6,0.0%,58m
38135,2,llllllllllll,1969,0,0,6,6,0.0%,7m
38144,1,Llacuf,1968,140,4,12,16,25.0%,3h
38144,2,ANNA,1968,0,1,0,1,100.0%,1h
38144,2,willdrewp,1968,46,1,1,2,50.0%,9m
38144,2,TarBall,1968,46,1,2,3,33.3%,51m
38144,2,[BoBSti]ElPrincident,1968,44,1,3,4,25.0%,23m
38144,3,[BDEA]frdsfrds,1968,0,0,2,2,0.0%,2h
38144,2,[FatMom]Earth,1968,0,0,5,5,0.0%,3h
38151,2,Xaqar,1967,1512,59,61,120,49.2%,2h
38151,1,SpiritPuno,1967,811,42,60,102,41.2%,47m
38151,1,Walloflight,1967,294,9,18,27,33.3%,3h
38151,2,[SABO]ORAGNA,1967,190,6,11,17,35.3%,39m
38151,2,zuela,1967,116,4,5,9,44.4%,32m
38151,1,Ltabyss,1967,48,4,9,13,30.8%,2h
38151,3,antunXDpoder,1967,30,1,3,4,25.0%,47m
38151,3,Igor,1967,0,1,4,5,20.0%,1h
38151,2,Alexinatron,1967,0,1,8,9,11.1%,2h
38151,3,AlexBlikerd,1967,0,0,3,3,0.0%,14m
38151,3,Hamster,1967,0,0,5,5,0.0%,2m
38151,3,ssurf,1967,0,0,6,6,0.0%,29m
38151,2,Destructor,1967,0,0,6,6,0.0%,55m
38151,2,scott,1967,0,0,7,7,0.0%,8m
38165,3,[SobH]iBugs,1966,373,12,20,32,37.5%,8m
38165,2,GangstaBling,1966,298,8,15,23,34.8%,3h
38165,3,danieltapia,1966,58,3,0,3,100.0%,5m
38165,1,DACASHOES,1966,88,3,13,16,18.8%,30m
38165,3,LuchoQwerty,1966,30,2,4,6,33.3%,3h
38165,2,Weasle,1966,48,2,8,10,20.0%,51m
38165,1,JorgeMS,1966,0,1,8,9,11.1%,39m
38172,2,Chaichon,1965,1448,62,83,145,42.8%,23m
38172,2,MacacoBranco,1965,847,38,32,70,54.3%,3h
38172,1,yuyo,1965,194,7,12,19,36.8%,24m
38172,3,Aliyra,1965,72,2,6,8,25.0%,8m
38172,3,KilroyJinkin,1965,0,1,1,2,50.0%,46m
38172,3,DarkBios,1965,0,0,1,1,0.0%,56m
38172,3,UncleSam,1965,0,0,2,2,0.0%,59m
38172,3,MrRatburn,1965,0,0,2,2,0.0%,47m
38180,2,[Hulu]TheTrain,1964,694,27,27,54,50.0%,1h
38180,3,FLoveShady,1964,373,16,27,43,37.2%,59m
38180,3,zahpkielart,1964,148,5,4,9,55.6%,8m
38180,2,[Blader]BLACK,1964,0,3,3,6,50.0%,41m
38180,3,SonOfClay,1964,0,1,4,5,20.0%,3h
38180,2,SAIXONE,1964,0,0,6,6,0.0%,1h
38186,2,Rgsd,1963,242,7,15,22,31.8%,15m
38186,1,Giantsbro,1963,142,4,12,16,25.0%,1h
38186,1,deathwish,1963,133,3,11,14,21.4%,45m
38186,2,Sejun,1963,48,2,3,5,40.0%,9m
38186,3,renatotrool,1963,0,1,1,2,50.0%,3h
38191,2,[ZTempz]Liberty,1962,787,46,58,104,44.2%,3h
38191,3,[RSC2]Zerathul,1962,506,19,17,36,52.8%,11m
38191,3,TSST,1962,144,5,6,11,45.5%,27m
38191,1,[BEHH]spacedude,1962,116,3,9,12,25.0%,6m
38191,2,GingerSlime,1962,90,3,9,12,25.0%,19m
38191,3,UpperUnicorn,1962,30,2,2,4,50.0%,1h
38191,3,[KFClub]TheAmasianTJ,1962,0,1,0,1,100.0%,19m
38191,3,KermitDaFrog,1962,30,1,1,2,50.0%,46m
38191,3,RiKuH,1962,0,0,5,5,0.0%,29m
38200,2,GhostPants,1961,475,60,58,118,50.8%,7m
38200,3,[GoldPo]TRUEJUSTICE,1961,1346,48,53,101,47.5%,27m
38200,2,viceps,1961,277,14,18,32,43.8%,14m
38200,2,Micajah,1961,0,3,5,8,37.5%,23m
38200,3,Ingenebrio,1961,30,2,1,3,66.7%,2h
38200,2,Wholelttaluv,1961,70,2,8,10,20.0%,2h
38200,2,[jerga]shadown,1961,0,1,2,3,33.3%,44m
38200,3,PatriotValor,1961,0,0,1,1,0.0%,1h
38208,3,TsaeBLerraF,1960,1192,52,42,94,55.3%,12m
38208,3,[RSHB]Sammypty,1960,0,3,2,5,60.0%,7m
38208,1,DeathbySeth,1960,144,3,13,16,18.8%,27m
38208,2,Bloodshot,1960,0,0,1,1,0.0%,23m
38208,3,Gladiator,1960,0,0,2,2,0.0%,36m
38208,2,Primeabcz,1960,0,0,2,2,0.0%,3h
38208,3,XsockooX,1960,0,0,5,5,0.0%,7m
38215,2,Sraw,1959,1594,253,291,544,46.5%,1h
38215,1,[XchiX]ReiDeLaMort,1959,965,37,37,74,50.0%,1h
38215,2,TonnyUrsa,1959,883,33,38,71,46.5%,5m
38215,2,Agile,1959,714,32,35,67,47.8%,20m
38215,2,Kurakura,1959,522,18,25,43,41.9%,11m
38215,2,Abominous,1959,422,16,21,37,43.2%,5m
38215,3,Idontknow,1959,371,13,15,28,46.4%,52m
38215,3,Shinwelwensa,1959,289,10,4,14,71.4%,1h
38215,2,YaMi,1959,231,9,16,25,36.0%,1h
38215,2,AlfredPollo,1959,236,7,20,27,25.9%,12m
38215,1,SLIM,1959,142,4,12,16,25.0%,23m
38215,1,mfernandinom,1959,48,1,4,5,20.0%,48m
38215,1,Excalibro,1959,0,1,6,7,14.3%,2h
38215,2,[AbcCo]ZergDroid,1959,0,0,7,7,0.0%,40m
38229,2,Cowboy,1958,1173,205,221,426,48.1%,31m
38229,2,ThinkBlue,1958,488,18,23,41,43.9%,2h
38229,3,Hijastro,1958,258,9,11,20,45.0%,1h
38229,3,Caleb,1958,0,2,3,5,40.0%,2h
38229,1,gabrielpro,1958,32,2,8,10,20.0%,2h
38229,3,[UAK]Deries,1958,0,1,0,1,100.0%,14m
38229,3,Glowstix,1958,0,1,4,5,20.0%,1h
38229,2,MrNoisy,1958,0,1,4,5,20.0%,1h
38229,3,FatalFuze,1958,0,0,1,1,0.0%,2h
38238,2,VoidHog,1957,788,103,116,219,47.0%,2h
38238,2,Cheeseling,1957,408,30,41,71,42.3%,2h
38238,3,Chrisniffum,1957,267,16,7,23,69.6%,6m
38238,3,couchman,1957,346,11,12,23,47.8%,1h
38238,3,STUKOV,1957,258,9,7,16,56.2%,2h
38238,1,chowda,1957,193,5,12,17,29.4%,44m
38238,3,[KRAFTT]hsingh,1957,118,4,3,7,57.1%,8m
38238,2,[EPCK]Ritersky,1957,86,3,8,11,27.3%,59m
38238,3,darkos,1957,30,2,4,6,33.3%,2h
38238,3,[FaTlAd]Terranhero,1957,42,1,3,4,25.0%,8m
38238,3,JfthSndvl,1957,0,0,6,6,0.0%,28m
38238,2,antonio,1957,0,0,8,8,0.0%,1h
38250,2,PENTAGRAMA,1956,849,186,196,382,48.7%,2h
38250,3,Dced,1956,609,24,29,53,45.3%,19m
38250,3,Albinogrinch,1956,435,14,11,25,56.0%,2h
38250,3,Camus,1956,153,6,7,13,46.2%,28m
38250,3,[DXPCA]more,1956,172,5,4,9,55.6%,18m
38250,3,[BKLS]BorealumLO,1956,92,3,3,6,50.0%,11m
38250,3,Charybdis,1956,147,3,11,14,21.4%,2h
38250,3,[D11313]FERRARI,1956,30,2,4,6,33.3%,2h
38250,2,VoidStalker,1956,50,2,7,9,22.2%,16m
38250,3,kcaniz,1956,0,1,0,1,100.0%,2h
38250,3,MOSHE,1956,0,0,1,1,0.0%,2h
38261,2,mad,1955,450,14,22,36,38.9%,12m
38261,3,cTHREE,1955,198,5,9,14,35.7%,47m
38261,1,[SXO]Auto,1955,190,5,14,19,26.3%,3h
38261,2,FOBUS,1955,97,3,7,10,30.0%,2h
38261,2,TruePotato,1955,185,3,10,13,23.1%,3h
38261,3,Nando,1955,0,2,3,5,40.0%,2h
38261,2,PapaKendo,1955,46,2,9,11,18.2%,51m
38261,3,[DevilF]CartianGlory,1955,0,1,1,2,50.0%,48m
38261,3,Ismael,1955,30,1,2,3,33.3%,8m
38261,3,[TGosuD]Deadfield,1955,0,1,5,6,16.7%,2h
38261,3,pokota,1955,0,0,2,2,0.0%,3h
38261,2,Koda,1955,0,0,6,6,0.0%,42m
38273,3,Planur,1954,910,32,33,65,49.2%,19m
38273,3,AmE,1954,363,12,8,20,60.0%,27m
38273,3,squibbbo,1954,0,1,9,10,10.0%,5m
38273,3,darthkahl,1954,0,0,1,1,0.0%,40m
38277,1,Gen,1953,1644,80,102,182,44.0%,57m
38277,2,noaraf,1953,1132,78,82,160,48.8%,58m
38277,3,Tantrika,1953,328,18,9,27,66.7%,2h
38277,2,DALLAS,1953,264,7,13,20,35.0%,3h
38277,2,zakiro,1953,187,3,10,13,23.1%,48m
38277,3,[FatMom]Unerwunscht,1953,30,1,3,4,25.0%,32m
38277,3,Gabrelicious,1953,0,0,5,5,0.0%,3h
38284,2,anthony,1952,883,65,63,128,50.8%,2h
38284,3,suicidal,1952,1436,50,58,108,46.3%,2h
38284,1,Ragnarök,1952,966,36,44,80,45.0%,10m
38284,2,Domador,1952,322,13,15,28,46.4%,42m
38284,2,SaintRazz,1952,387,13,18,31,41.9%,31m
38284,2,Krexx,1952,265,10,12,22,45.5%,2h
38284,3,cicery,1952,284,9,17,26,34.6%,59m
38284,3,nkazul,1952,100,6,12,18,33.3%,9m
38284,3,Datralo,1952,145,4,13,17,23.5%,15m
38284,3,Horseface,1952,58,3,1,4,75.0%,2h
38284,1,jmann,1952,96,3,12,15,20.0%,1h
38284,3,[NM8]ROnDEAu,1952,62,3,15,18,16.7%,46m
38284,3,ness,1952,30,2,0,2,100.0%,1h
38284,3,NONA,1952,0,1,1,2,50.0%,52m
38284,3,TrashRaceP,1952,0,1,4,5,20.0%,3h
38284,3,ohm,1952,30,1,11,12,8.3%,25m
38284,2,Ltigrediablo,1952,0,0,1,1,0.0%,2h
38284,3,WickyWoo,1952,0,0,3,3,0.0%,58m
38302,3,SaBeR,1951,755,32,22,54,59.3%,47m
38302,3,poeta,1951,171,6,5,11,54.5%,12m
38302,2,HERZOG,1951,128,3,10,13,23.1%,2h
38302,3,[SCPER1]maza,1951,0,0,2,2,0.0%,3h
38302,3,telegeniic,1951,0,0,2,2,0.0%,2h
38307,2,[GGWolf]Ghost,1950,814,27,38,65,41.5%,1h
38307,2,DthreeR,1950,494,19,23,42,45.2%,2h
38307,3,elcachero,1950,0,1,2,3,33.3%,27m
38307,2,dualrect,1950,48,1,6,7,14.3%,44m
38307,3,Soulrogue,1950,0,0,6,6,0.0%,8m
38307,2,Antonio,1950,0,0,6,6,0.0%,3h
38313,2,[ØFoxF2]llllllllllll,1949,60,3,8,11,27.3%,3h
38313,1,Cytan,1949,0,1,8,9,11.1%,3h
38313,3,cibl,1949,0,0,1,1,0.0%,8m
38313,3,MrPotassium,1949,0,0,1,1,0.0%,8m
38317,2,Gutgrek,1948,976,34,46,80,42.5%,1h
38317,1,emeUNO,1948,167,7,10,17,41.2%,1h
38317,2,NatorNZ,1948,159,3,10,13,23.1%,2h
38317,1,Cheezpower,1948,142,3,11,14,21.4%,3h
38317,1,Alex,1948,42,2,8,10,20.0%,2h
38317,3,Thunder,1948,0,0,1,1,0.0%,8m
38317,2,theArtist,1948,0,0,3,3,0.0%,48m
38317,2,UnicornKnigh,1948,0,0,8,8,0.0%,44m
38325,2,[A1312]entropia,1947,1467,76,88,164,46.3%,38m
38325,1,Cjas,1947,906,30,44,74,40.5%,1h
38325,2,Methos,1947,486,18,24,42,42.9%,3h
38325,2,asgardian,1947,492,17,24,41,41.5%,54m
38325,3,ProbeKing,1947,358,12,14,26,46.2%,2h
38325,2,mgsmid,1947,58,3,4,7,42.9%,11m
38325,3,[LaCraG]Ferna,1947,84,2,1,3,66.7%,50m
38325,3,FABIOBR,1947,0,1,4,5,20.0%,2h
38325,2,mindhive,1947,30,1,9,10,10.0%,3h
38325,3,GeneralBlu,1947,0,0,2,2,0.0%,60m
38335,2,Kotaro,1946,667,26,27,53,49.1%,3h
38335,2,Arinze,1946,376,13,17,30,43.3%,23m
38335,2,[ZRN]KungFuUnicrn,1946,318,9,19,28,32.1%,31m
38335,1,SixFortyK,1946,143,6,7,13,46.2%,2h
38335,3,meDaBoss,1946,0,1,0,1,100.0%,53m
38335,2,Scout,1946,0,1,6,7,14.3%,2h
38335,3,Steven,1946,0,0,1,1,0.0%,25m
38335,3,BigWilli,1946,0,0,1,1,0.0%,48m
38335,2,max,1946,0,0,1,1,0.0%,1h
38335,2,dalg,1946,0,0,7,7,0.0%,51m
38345,2,TheDog,1945,1554,228,267,495,46.1%,55m
38345,3,DaneGRClose,1945,888,36,33,69,52.2%,3h
38345,3,BigDirt,1945,865,35,25,60,58.3%,2h
38345,3,Francocala,1945,240,8,7,15,53.3%,22m
38345,2,draka,1945,208,8,18,26,30.8%,2h
38345,2,AbellaDanger,1945,210,7,8,15,46.7%,31m
38345,1,smothercomet,1945,208,6,12,18,33.3%,46m
38345,3,Karnage,1945,177,5,14,19,26.3%,2h
38345,1,convinced,1945,211,4,6,10,40.0%,1h
38345,1,TANG,1945,102,3,0,3,100.0%,3h
38345,2,[RESCUE]Vulcan,1945,60,2,6,8,25.0%,1h
38345,2,Kaderin,1945,132,2,7,9,22.2%,3h
38345,3,Syra,1945,0,1,0,1,100.0%,52m
38345,1,Picador,1945,0,1,8,9,11.1%,54m
38345,3,kidpritchard,1945,0,0,1,1,0.0%,59m
38360,3,apeffect,1944,591,28,18,46,60.9%,19m
38360,3,[DKBR]noppdoog,1944,664,26,25,51,51.0%,2h
38360,3,UnlimitedxIQ,1944,0,2,3,5,40.0%,47m
38360,3,Shoe,1944,30,1,1,2,50.0%,2h
38360,3,[henne]hlos,1944,88,1,3,4,25.0%,2h
38360,2,SeanOverLuck,1944,46,1,3,4,25.0%,2h
38360,3,SLIMDOGVERNO,1944,30,1,5,6,16.7%,11m
38360,2,fiascoavertd,1944,0,1,6,7,14.3%,42m
38360,2,PALERMO,1944,44,1,8,9,11.1%,1h
38360,3,Sampson,1944,0,0,1,1,0.0%,1h
38360,3,pablo,1944,0,0,6,6,0.0%,3h
38371,3,[2Hott]Papa,1943,1376,56,58,114,49.1%,3h
38371,3,GabrielP,1943,379,13,12,25,52.0%,8m
38371,3,ppsmalls,1943,180,5,2,7,71.4%,48m
38371,2,CNDallas,1943,58,3,9,12,25.0%,2h
38371,3,Jonas,1943,0,1,5,6,16.7%,25m
38371,2,charr,1943,0,1,7,8,12.5%,11m
38371,3,LPMuseFan,1943,0,0,1,1,0.0%,58m
38371,3,Open,1943,0,0,5,5,0.0%,1h
38379,1,mestrejho,1942,1605,370,398,768,48.2%,25m
38379,2,Harvest,1942,542,20,28,48,41.7%,1h
38379,3,Diligence,1942,466,17,16,33,51.5%,1h
38379,2,EricoAliaga,1942,231,9,15,24,37.5%,15m
38379,3,UtilityMnstr,1942,159,7,4,11,63.6%,1h
38379,3,RealDiego,1942,0,1,2,3,33.3%,3m
38379,1,[Satday]PotLuck,1942,0,1,9,10,10.0%,2h
38379,2,HZubeydulla,1942,0,0,3,3,0.0%,3h
38387,2,CAZADOR,1941,1330,76,89,165,46.1%,57m
38387,2,dexlinx,1941,314,11,18,29,37.9%,1h
38387,1,Darkmagic,1941,104,10,20,30,33.3%,1h
38387,3,[Domare]SeanJohn,1941,250,7,10,17,41.2%,1h
38387,3,Hunt,1941,0,2,4,6,33.3%,3h
38387,2,TheOne,1941,0,0,4,4,0.0%,32m
38393,3,Grospen,1940,648,24,27,51,47.1%,1h
38393,2,whalen,1940,464,18,21,39,46.2%,2h
38393,3,ALUKAR,1940,305,11,5,16,68.8%,2h
38393,1,Xritsken,1940,62,4,12,16,25.0%,3h
38393,3,Juda,1940,0,0,3,3,0.0%,53m
38393,2,Kayper,1940,0,0,6,6,0.0%,54m
38399,2,Saltman,1939,749,70,69,139,50.4%,1h
38399,3,DENRIAT,1939,349,11,21,32,34.4%,33m
38399,2,victhesnake,1939,188,6,8,14,42.9%,5m
38399,3,DIEGOVILLCA,1939,90,4,3,7,57.1%,2h
38399,3,Lifeline,1939,30,2,5,7,28.6%,19m
38399,3,[EDGEz]Treefitty,1939,0,1,3,4,25.0%,19m
38399,3,Yamiseta,1939,44,1,5,6,16.7%,28m
38399,3,dimondsoul,1939,0,0,2,2,0.0%,53m
38399,3,llllllllllll,1939,0,0,5,5,0.0%,1h
38399,2,Café,1939,0,0,7,7,0.0%,3h
38409,2,Iceman,1938,1596,107,119,226,47.3%,3h
38409,2,KenshinX,1938,234,29,34,63,46.0%,7m
38409,3,Raini,1938,273,9,18,27,33.3%,49m
38409,3,GrimChipmunk,1938,218,7,7,14,50.0%,3h
38409,1,ZzZ,1938,143,7,12,19,36.8%,1h
38409,2,Demon,1938,155,5,7,12,41.7%,2h
38409,2,CARPIVANj,1938,126,5,11,16,31.2%,3h
38409,3,Kiffage,1938,0,1,0,1,100.0%,19m
38409,3,enller,1938,42,1,2,3,33.3%,19m
38409,1,Bammer,1938,0,1,6,7,14.3%,1h
38419,2,[Voyage]CaptainDOTd,1937,787,110,121,231,47.6%,45m
38419,2,Isaac,1937,219,7,10,17,41.2%,2m
38419,3,Roshi,1937,154,6,18,24,25.0%,10m
38419,1,Yonstar,1937,113,2,5,7,28.6%,1h
38419,3,Kharon,1937,0,1,0,1,100.0%,17m
38419,2,doubleaa,1937,30,1,8,9,11.1%,19m
38419,3,SuperNicolas,1937,0,0,1,1,0.0%,33m
38426,2,Sweetie,1936,602,21,31,52,40.4%,3h
38426,2,yaiguyguitar,1936,534,20,27,47,42.6%,39m
38426,1,xPolar,1936,370,19,35,54,35.2%,57m
38426,3,CharlieBrown,1936,30,2,4,6,33.3%,2h
38426,3,[4CM1PT]ChuckNopi,1936,0,1,5,6,16.7%,2h
38426,3,JdssPEvolved,1936,0,0,1,1,0.0%,3m
38426,2,Fesax,1936,0,0,2,2,0.0%,48m
38433,2,PirateButler,1935,302,11,19,30,36.7%,2h
38433,3,Eduardo,1935,204,10,10,20,50.0%,53m
38433,3,Chater,1935,216,7,7,14,50.0%,3h
38433,3,[XpKAc]BJÓ,1935,140,6,2,8,75.0%,2h
38433,3,polymesh,1935,146,6,11,17,35.3%,2h
38433,1,Redirac,1935,160,4,7,11,36.4%,29m
38433,3,yubario,1935,42,2,7,9,22.2%,29m
38433,1,goodnyborg,1935,48,2,11,13,15.4%,2h
38433,3,OOOOOOOOOOOO,1935,30,1,5,6,16.7%,27m
38433,3,jeffthekille,1935,0,0,3,3,0.0%,2h
38433,3,mewtho,1935,0,0,5,5,0.0%,29m
38444,1,Branboom,1934,1114,97,110,207,46.9%,3h
38444,3,Hoegaarden,1934,86,3,5,8,37.5%,3h
38444,2,[NTINE]gabriel,1934,0,1,1,2,50.0%,2h
38444,3,[UMCP]AmazingDH,1934,30,1,4,5,20.0%,2h
38448,2,luqueve,1933,883,33,36,69,47.8%,38m
38448,3,Hittokiri,1933,58,3,1,4,75.0%,1h
38448,3,frogger,1933,88,3,3,6,50.0%,3h
38448,3,HierarchAdun,1933,0,1,1,2,50.0%,2h
38448,3,Samalmi,1933,34,1,2,3,33.3%,50m
38448,3,Anju,1933,0,0,1,1,0.0%,2h
38448,3,RAG,1933,0,0,2,2,0.0%,2h
38448,3,Zeratul,1933,0,0,4,4,0.0%,9m
38456,2,kst,1932,198,6,13,19,31.6%,1h
38456,3,[CHONK]HIJACK,1932,114,5,1,6,83.3%,1h
38456,3,LIKASOHMBODE,1932,95,2,0,2,100.0%,3h
38456,3,OneLazyHero,1932,0,1,0,1,100.0%,3h
38456,2,Randomperson,1932,46,1,8,9,11.1%,3h
38456,1,dirk,1932,0,1,9,10,10.0%,2h
38456,2,jamesbondtra,1932,0,0,4,4,0.0%,2h
38456,2,[ITUSKI]Hirtis,1932,0,0,4,4,0.0%,1h
38456,3,DarthMorice,1932,0,0,5,5,0.0%,19m
38465,1,Clarin,1931,1153,170,192,362,47.0%,1h
38465,2,[LegSC]DarkWin,1931,528,74,76,150,49.3%,50m
38465,2,Jhaiisiin,1931,833,30,43,73,41.1%,2h
38465,2,TAURUS,1931,418,13,18,31,41.9%,2h
38465,3,Blessaim,1931,0,2,1,3,66.7%,2h
38465,3,[RTY]XxrtyxX,1931,0,1,0,1,100.0%,22m
38465,2,happyliar,1931,0,1,5,6,16.7%,14m
38465,3,gYeQ,1931,0,0,5,5,0.0%,40m
38473,2,Toenails,1930,1277,49,51,100,49.0%,3h
38473,3,donerman,1930,342,12,13,25,48.0%,3h
38473,2,Guardiian,1930,371,12,21,33,36.4%,2h
38473,3,Macloud,1930,243,8,18,26,30.8%,2h
38473,1,Arjhan,1930,211,6,4,10,60.0%,2h
38473,3,Dragon,1930,122,4,8,12,33.3%,40m
38473,3,ureta,1930,0,0,1,1,0.0%,3h
38473,3,Nocturne,1930,0,0,2,2,0.0%,3m
38481,2,GeeBee,1929,833,56,59,115,48.7%,3h
38481,3,Brayden,1929,475,18,13,31,58.1%,18m
38481,3,Grimbo,1929,508,18,19,37,48.6%,3h
38481,3,JuniorBacon,1929,143,7,1,8,87.5%,58m
38481,2,Walker,1929,44,2,3,5,40.0%,48m
38481,1,Willzy,1929,30,2,11,13,15.4%,3h
38481,2,[spicyc]Len,1929,0,1,0,1,100.0%,2h
38481,3,Bazookajoe,1929,0,1,0,1,100.0%,58m
38481,3,GioCarrera,1929,0,1,0,1,100.0%,3m
38481,3,ZonateSaturn,1929,0,0,1,1,0.0%,42m
38481,3,darksalvador,1929,0,0,2,2,0.0%,5m
38481,3,fatman,1929,0,0,2,2,0.0%,19m
38493,3,GoToSleep,1928,1228,67,79,146,45.9%,2h
38493,1,Phuhque,1928,1152,52,62,114,45.6%,59m
38493,2,ToffyUK,1928,892,32,35,67,47.8%,4m
38493,3,Pierox,1928,337,12,12,24,50.0%,1h
38493,3,[877142]Freefrag,1928,268,11,12,23,47.8%,8m
38493,3,[TRUMPP]Farrox,1928,298,10,18,28,35.7%,2h
38493,2,[TRASHH]Danklord,1928,148,6,11,17,35.3%,31m
38493,2,Slay,1928,156,5,17,22,22.7%,2h
38493,2,ShArK,1928,144,4,8,12,33.3%,5m
38493,2,aehu,1928,140,3,9,12,25.0%,3h
38493,3,DixieNourmos,1928,30,2,3,5,40.0%,52m
38493,2,nomadic,1928,0,1,7,8,12.5%,59m
38505,3,germy,1927,634,23,22,45,51.1%,2h
38505,3,eclipserP,1927,197,6,15,21,28.6%,56m
38505,3,Gualter,1927,72,4,6,10,40.0%,2h
38505,2,Rick,1927,58,2,8,10,20.0%,2h
38505,2,[a1vNA]blackstar,1927,88,1,3,4,25.0%,2h
38505,2,Castlewolf,1927,0,0,7,7,0.0%,2h
38511,3,TheHighChamp,1926,647,75,89,164,45.7%,17m
38511,3,dizzyopossum,1926,746,30,25,55,54.5%,8m
38511,3,[LPrusa]Xforcex,1926,459,16,21,37,43.2%,3h
38511,2,SineWave,1926,444,16,23,39,41.0%,3h
38511,2,kaos,1926,236,8,19,27,29.6%,56m
38511,2,GianTheMan,1926,118,5,16,21,23.8%,27m
38511,3,[SSkull]TDAUE,1926,58,2,9,11,18.2%,5m
38511,3,Bigbirdalex,1926,0,0,5,5,0.0%,2h
38511,2,monster,1926,0,0,8,8,0.0%,2h
38520,3,stratos,1925,707,25,26,51,49.0%,3h
38520,3,agag,1925,118,8,8,16,50.0%,9m
38520,3,marquis,1925,178,7,6,13,53.8%,2h
38520,3,ketch,1925,174,6,5,11,54.5%,27m
38520,2,Charon,1925,0,0,4,4,0.0%,2h
38525,2,leo,1924,1199,53,72,125,42.4%,2h
38525,1,LynoX,1924,824,29,43,72,40.3%,3h
38525,3,Ares,1924,376,13,19,32,40.6%,59m
38525,3,Vexxtor,1924,267,8,11,19,42.1%,12m
38525,2,Donald,1924,32,1,9,10,10.0%,2h
38525,2,ZzzangelzzZ,1924,0,0,2,2,0.0%,1h
38525,1,cytoxan,1924,0,0,2,2,0.0%,3h
38525,1,GLHF,1924,0,0,5,5,0.0%,3h
38533,2,CumGroyper,1923,1248,154,152,306,50.3%,2h
38533,2,Mecanicox,1923,1368,148,157,305,48.5%,3h
38533,3,McLightningF,1923,1298,55,64,119,46.2%,49m
38533,2,solidvhero,1923,371,31,34,65,47.7%,2h
38533,2,DITO,1923,266,10,11,21,47.6%,58m
38533,1,malekey,1923,142,3,10,13,23.1%,47m
38533,1,Raglemo,1923,0,1,0,1,100.0%,2h
38533,3,Saito,1923,0,1,4,5,20.0%,3h
38533,3,DantePH,1923,0,0,4,4,0.0%,1h
38542,3,LJthedon,1922,58,3,2,5,60.0%,3h
38542,3,tequilas,1922,0,1,1,2,50.0%,53m
38542,3,xaxisdix,1922,94,1,2,3,33.3%,60m
38542,2,sdayac,1922,90,1,8,9,11.1%,3h
38542,2,TinyDragon,1922,0,0,1,1,0.0%,49m
38542,3,MVMNOOOB,1922,0,0,5,5,0.0%,60m
38548,3,odinthegreat,1921,1534,72,73,145,49.7%,2h
38548,2,[Pharoh]XxrasiixX,1921,873,30,37,67,44.8%,2h
38548,3,InsanePsych,1921,652,25,25,50,50.0%,33m
38548,2,spacefrog,1921,472,15,21,36,41.7%,2h
38548,2,NetherendsSC,1921,398,15,21,36,41.7%,8m
38548,2,Jeguhu,1921,360,13,16,29,44.8%,8m
38548,3,Imroth,1921,0,0,1,1,0.0%,9m
38555,3,Sulaco,1920,688,24,26,50,48.0%,36m
38555,2,Shilla,1920,81,24,40,64,37.5%,1h
38555,2,Gahzi,1920,216,6,8,14,42.9%,2h
38555,2,Corpzey,1920,97,5,9,14,35.7%,18m
38555,3,DJAngo,1920,198,5,10,15,33.3%,49m
38555,3,miroslav,1920,58,3,2,5,60.0%,19m
38555,3,[NoEnMi]DoorStuck,1920,0,2,4,6,33.3%,19m
38562,2,[felpa]JhosuePT,1919,829,35,45,80,43.8%,1h
38562,3,Gabriel,1919,846,30,37,67,44.8%,22m
38562,3,MrKoreXD,1919,384,18,13,31,58.1%,22m
38562,3,igncar,1919,403,15,24,39,38.5%,8m
38562,2,PerroChaleco,1919,375,14,20,34,41.2%,42m
38562,2,Derek,1919,338,11,18,29,37.9%,56m
38562,3,AwesomSparky,1919,148,5,2,7,71.4%,1h
38562,3,larr,1919,58,4,5,9,44.4%,18m
38562,2,ArdillaCo,1919,180,4,16,20,20.0%,3h
38562,3,eagleselfs,1919,94,3,4,7,42.9%,3h
38562,2,Gilbeyz,1919,110,3,10,13,23.1%,3h
38562,2,AMinstinct,1919,60,2,8,10,20.0%,2h
38562,2,RollForward,1919,92,2,10,12,16.7%,44m
38562,3,Dizzlers,1919,0,1,0,1,100.0%,1h
38562,2,cheeseyfart,1919,30,1,7,8,12.5%,3h
38562,2,zreeeeeeeg,1919,32,1,9,10,10.0%,1h
38578,3,quarterdave,1918,540,32,38,70,45.7%,3h
38578,2,Yan,1918,466,22,19,41,53.7%,3h
38578,3,aimer,1918,592,22,27,49,44.9%,3h
38578,3,[NastyB]joseluis,1918,86,4,3,7,57.1%,22m
38578,3,ElGordoT,1918,0,2,3,5,40.0%,2h
38578,3,albert,1918,0,1,0,1,100.0%,22m
38578,3,[RRC]DorthVordar,1918,0,0,2,2,0.0%,2h
38578,3,BeepBoop,1918,0,0,4,4,0.0%,5m
38586,3,[40oztF]Dominus,1917,0,1,0,1,100.0%,59m
38586,3,jungkook,1917,0,1,2,3,33.3%,59m
38586,2,Fitz,1917,0,1,7,8,12.5%,23m
38586,2,Shinigami,1917,0,0,7,7,0.0%,1h
38590,3,OropesaGCB,1916,273,10,9,19,52.6%,2h
38590,2,irany,1916,88,4,10,14,28.6%,3h
38590,2,SaTcH,1916,93,3,6,9,33.3%,48m
38590,3,[WOTG]XAXADUN,1916,62,2,6,8,25.0%,8m
38590,3,chargelot,1916,0,1,0,1,100.0%,2h
38590,3,SWAGMONEY,1916,30,1,2,3,33.3%,1h
38590,2,Denniskyc,1916,94,1,4,5,20.0%,32m
38590,1,Hezzz,1916,0,1,6,7,14.3%,3h
38590,3,scosco,1916,0,0,1,1,0.0%,2h
38599,3,Zykrus,1915,1148,51,49,100,51.0%,46m
38599,3,TaeKa,1915,322,12,18,30,40.0%,1h
38599,3,KAKITAS,1915,301,10,6,16,62.5%,3h
38599,3,DeeperCookie,1915,362,10,15,25,40.0%,9m
38599,3,Psychomatu,1915,58,3,6,9,33.3%,3h
38599,3,[CNSC]TheGodCrow,1915,34,2,5,7,28.6%,58m
38599,2,[LOHd]AlraK,1915,0,1,2,3,33.3%,3h
38599,3,Cid,1915,0,1,4,5,20.0%,59m
38599,3,RayLiotta,1915,96,1,5,6,16.7%,9m
38599,3,Moth,1915,0,0,3,3,0.0%,3m
38599,2,barcafan,1915,0,0,8,8,0.0%,40m
38610,1,FUGITIVO,1914,268,11,15,26,42.3%,3h
38610,2,RaysDtoy,1914,92,4,8,12,33.3%,2h
38610,2,adam,1914,122,4,11,15,26.7%,2h
38610,2,Chronoss,1914,136,2,1,3,66.7%,44m
38610,3,[SWOU]Amagno,1914,64,2,8,10,20.0%,16m
38610,3,JAML,1914,0,0,1,1,0.0%,27m
38616,3,dragonboy,1913,949,105,125,230,45.7%,48m
38616,2,ghostpants,1913,949,90,81,171,52.6%,1h
38616,2,goldenhalo,1913,654,48,50,98,49.0%,2h
38616,3,Khan,1913,331,24,24,48,50.0%,5m
38616,2,diego,1913,561,18,34,52,34.6%,2h
38616,2,RANDAL,1913,433,15,36,51,29.4%,1h
38616,3,illusive,1913,212,10,11,21,47.6%,1h
38616,3,Xyclon,1913,248,8,19,27,29.6%,27m
38616,3,TheiLLtype,1913,0,3,3,6,50.0%,58m
38616,3,Bloodgeon,1913,30,1,3,4,25.0%,5m
38616,2,ALDEBARÁN,1913,0,0,1,1,0.0%,32m
38616,3,Switchmaier,1913,0,0,2,2,0.0%,49m
38628,1,Convolution,1912,240,8,14,22,36.4%,50m
38628,3,Algocox,1912,197,5,3,8,62.5%,2h
38628,3,Zayres,1912,93,1,2,3,33.3%,49m
38628,3,[CHASQ]Attatrix,1912,0,1,4,5,20.0%,8m
38628,1,DrZing,1912,0,1,9,10,10.0%,2h
38628,3,Philippe,1912,0,0,3,3,0.0%,33m
38634,3,Yensy,1911,766,31,27,58,53.4%,57m
38634,2,BleueyBlob,1911,423,15,19,34,44.1%,1h
38634,3,[uhh]Sproo,1911,382,14,3,17,82.4%,3m
38634,3,BubbaKiller,1911,454,14,19,33,42.4%,3h
38634,3,Malazar,1911,0,0,1,1,0.0%,1h
38634,2,[106865]Afifty,1911,0,0,6,6,0.0%,3h
38640,2,[pSC20]IronClaD,1910,810,29,38,67,43.3%,31m
38640,1,soulbinder,1910,290,9,21,30,30.0%,3h
38640,2,Deadsectorbh,1910,120,4,9,13,30.8%,32m
38640,3,ever,1910,0,1,0,1,100.0%,51m
38640,2,mistakes,1910,97,1,8,9,11.1%,3h
38640,3,Suriban,1910,0,0,1,1,0.0%,2h
38640,2,AceInTheFace,1910,0,0,3,3,0.0%,56m
38640,2,Andy,1910,0,0,7,7,0.0%,23m
38648,2,captainbob,1909,1533,118,136,254,46.5%,20m
38648,3,jisang,1909,0,2,4,6,33.3%,5m
38648,3,LeAcH,1909,0,1,4,5,20.0%,51m
38648,3,Graceofkings,1909,0,1,4,5,20.0%,3h
38648,2,BYN,1909,0,0,2,2,0.0%,44m
38653,3,lizardking,1908,414,14,16,30,46.7%,3h
38653,3,[cluez]unxblackjoke,1908,74,2,3,5,40.0%,1h
38653,2,sergio,1908,30,2,7,9,22.2%,16m
38653,2,Ferghost,1908,0,1,1,2,50.0%,2h
38657,3,CUERVO,1907,30,1,3,4,25.0%,2h
38657,2,NovemberRain,1907,30,1,5,6,16.7%,16m
38657,3,Timbershave,1907,0,0,6,6,0.0%,28m
38660,3,Raflitz,1906,915,35,31,66,53.0%,2h
38660,3,Malchofa,1906,373,14,17,31,45.2%,1h
38660,2,PabloDelaQ,1906,170,6,8,14,42.9%,16m
38660,2,FearBlack,1906,203,6,15,21,28.6%,57m
38660,3,idrasil,1906,107,5,4,9,55.6%,27m
38660,3,maadcx,1906,86,4,2,6,66.7%,49m
38660,3,warboy,1906,0,0,1,1,0.0%,56m
38660,2,andresquivel,1906,0,0,1,1,0.0%,53m
38660,2,[Eat314]BigTityGirls,1906,0,0,2,2,0.0%,2h
38669,1,Korrhil,1905,440,13,24,37,35.1%,2h
38669,3,Zetho,1905,322,12,9,21,57.1%,53m
38669,3,rale,1905,62,3,10,13,23.1%,1h
38669,2,[Epokhé]grosso,1905,0,0,1,1,0.0%,51m
38673,3,downtiowntra,1904,1275,52,48,100,52.0%,8m
38673,2,RebelSoldier,1904,140,6,6,12,50.0%,3h
38673,3,Boodor,1904,187,5,4,9,55.6%,59m
38673,3,MahuSWC,1904,114,4,4,8,50.0%,1h
38673,2,bolsominion,1904,0,3,5,8,37.5%,53m
38673,3,MonkeyDLuffy,1904,0,2,3,5,40.0%,1h
38673,3,fantasma,1904,0,1,4,5,20.0%,53m
38673,2,jayden,1904,0,0,1,1,0.0%,32m
38673,3,[SAAM]StarwarriorX,1904,0,0,5,5,0.0%,2h
38682,1,BananaHippo,1903,149,5,15,20,25.0%,2h
38682,3,[FCTR]Ragnarok,1903,36,4,3,7,57.1%,9m
38682,2,GothicCrisis,1903,94,3,9,12,25.0%,1h
38682,3,KrimzonGuard,1903,0,1,2,3,33.3%,19m
38682,2,weweweyou,1903,30,1,2,3,33.3%,3h
38682,3,Tabarnakers,1903,0,0,7,7,0.0%,58m
38688,3,CiRiS,1902,450,16,9,25,64.0%,3h
38688,3,TunaGina,1902,68,3,6,9,33.3%,58m
38688,3,OBI,1902,44,2,4,6,33.3%,22m
38688,1,motionless,1902,133,2,6,8,25.0%,14m
38688,3,SolarSwarm,1902,0,1,0,1,100.0%,55m
38688,2,Artanis,1902,42,1,1,2,50.0%,1h
38688,2,Rideout,1902,0,1,7,8,12.5%,32m
38688,1,[MATB]FBIKnight,1902,0,0,1,1,0.0%,35m
38688,2,klhart,1902,0,0,5,5,0.0%,2h
38688,3,Dragonlord,1902,0,0,6,6,0.0%,1h
38698,1,VoidWraith,1901,140,5,13,18,27.8%,45m
38698,3,[HooX]Hooks,1901,60,3,6,9,33.3%,2h
38698,3,Suneater,1901,30,1,2,3,33.3%,2h
38698,3,Sugeknight,1901,0,0,1,1,0.0%,22m
38702,2,Mental,1900,152,4,5,9,44.4%,1h
38702,2,moke,1900,0,0,1,1,0.0%,3h
38702,3,amazingsax,1900,0,0,1,1,0.0%,56m
38705,2,Alseer,1899,654,27,30,57,47.4%,2h
38705,1,Errk,1899,590,21,26,47,44.7%,2h
38705,3,[AbcCo]lee,1899,263,8,16,24,33.3%,2h
38705,1,CNeifert,1899,244,8,19,27,29.6%,3h
38705,2,Ozzy,1899,130,6,19,25,24.0%,54m
38705,1,Lokicat,1899,217,4,14,18,22.2%,3h
38705,2,nocturnill,1899,60,2,9,11,18.2%,2h
38705,3,tØtØ,1899,0,1,9,10,10.0%,2h
38705,3,vision,1899,0,0,3,3,0.0%,2h
38714,2,PinkiePie,1898,474,17,43,60,28.3%,17m
38714,2,NovaGames,1898,346,11,24,35,31.4%,2h
38714,1,Thedestoryer,1898,325,8,17,25,32.0%,2h
38714,3,karlosebenjp,1898,58,2,2,4,50.0%,1h
38714,3,[HERD]PHZ,1898,30,2,5,7,28.6%,25m
38714,2,AkumuD,1898,0,0,3,3,0.0%,13m
38720,3,TheChadGuy,1897,615,22,33,55,40.0%,19m
38720,3,XpolMachina,1897,274,17,13,30,56.7%,8m
38720,2,Xmas,1897,286,8,16,24,33.3%,3h
38720,1,[Gogui]Jeosung,1897,170,7,15,22,31.8%,3h
38720,3,Bunkers,1897,110,4,5,9,44.4%,33m
38720,1,Bread,1897,92,2,8,10,20.0%,42m
38726,3,[ZTemps]Aegis,1896,619,49,47,96,51.0%,55m
38726,3,Baddestbill,1896,290,12,9,21,57.1%,2h
38726,3,rip,1896,253,9,18,27,33.3%,2h
38726,3,Krumer,1896,74,4,3,7,57.1%,1h
38726,3,Artix,1896,0,1,4,5,20.0%,2h
38726,3,gdiasgamer,1896,0,1,4,5,20.0%,22m
38732,2,FreakyFrank,1895,540,18,30,48,37.5%,3h
38732,3,elchuno,1895,296,13,13,26,50.0%,19m
38732,2,TYCHUS,1895,162,6,9,15,40.0%,2h
38732,1,iMMoRtaL,1895,218,6,14,20,30.0%,48m
38732,3,[Zulu]Slabba,1895,151,3,9,12,25.0%,1h
38732,2,Pime,1895,127,3,13,16,18.8%,3h
38732,1,Ghost,1895,48,2,10,12,16.7%,2h
38732,3,ODBrent,1895,30,1,2,3,33.3%,46m
38740,3,Mongoose,1894,701,25,25,50,50.0%,57m
38740,2,MaFraJoaMaTo,1894,112,6,8,14,42.9%,3h
38740,3,WIWI,1894,170,6,9,15,40.0%,55m
38740,3,ParchedZebra,1894,184,5,13,18,27.8%,53m
38740,3,SirJohnEh,1894,144,4,1,5,80.0%,33m
38740,2,[XPARTA]SUPERBADBOY,1894,203,4,18,22,18.2%,3h
38740,2,Marwakii,1894,116,2,6,8,25.0%,1h
38740,2,[Metric]ThortraLisk,1894,0,1,0,1,100.0%,3h
38740,3,toreto,1894,0,0,5,5,0.0%,16m
38740,2,Biff,1894,0,0,7,7,0.0%,3h
38750,2,YUGI,1893,738,34,38,72,47.2%,3h
38750,3,imaazhol,1893,620,23,20,43,53.5%,2h
38750,2,Gabotwister,1893,342,12,18,30,40.0%,14m
38750,3,[GELIUM]fenix,1893,261,10,9,19,52.6%,33m
38750,3,Jrok,1893,279,9,12,21,42.9%,19m
38750,3,Durch,1893,146,7,9,16,43.8%,27m
38750,3,[Tsurai]AraiTakahiro,1893,231,6,11,17,35.3%,59m
38750,3,Queiroga,1893,174,4,9,13,30.8%,20m
38750,2,jhon,1893,46,1,8,9,11.1%,2h
38750,1,warmech,1893,34,1,10,11,9.1%,3h
38760,3,[EnRb]GGamer,1892,1073,58,69,127,45.7%,47m
38760,3,Lilswampton,1892,1005,40,34,74,54.1%,22m
38760,3,Simp,1892,274,10,18,28,35.7%,48m
38760,3,[TY4GG]Grandma,1892,159,4,4,8,50.0%,3h
38760,3,zerg,1892,0,2,3,5,40.0%,19m
38760,2,ghvp,1892,0,0,7,7,0.0%,1h
38760,2,JESU,1892,0,0,7,7,0.0%,3h
38767,3,Indigo,1891,1294,92,116,208,44.2%,48m
38767,1,[IMDSI]DiegoShulla,1891,893,39,52,91,42.9%,3h
38767,1,Achilles,1891,1132,39,59,98,39.8%,33m
38767,2,SneakyZeeky,1891,222,8,10,18,44.4%,3h
38767,2,Sislix,1891,134,7,19,26,26.9%,2h
38767,3,Ikaika,1891,146,4,2,6,66.7%,27m
38767,3,[opWeed]Accelerator,1891,0,0,1,1,0.0%,3h
38774,2,[KhanZ]Kaos,1890,1540,73,90,163,44.8%,38m
38774,3,Boarderdude,1890,252,9,13,22,40.9%,40m
38774,3,BeastQualls,1890,0,0,2,2,0.0%,1h
38774,2,NewloveJc,1890,0,0,7,7,0.0%,18m
38778,3,xkillerx,1889,714,26,26,52,50.0%,36m
38778,3,Nobody,1889,305,13,13,26,50.0%,46m
38778,3,[NnRs]Juanjocs,1889,248,9,13,22,40.9%,1h
38778,2,DarkLights,1889,146,5,12,17,29.4%,14m
38778,3,Vownstille,1889,30,2,1,3,66.7%,5m
38778,3,[ACTKK2]RhynoJunior,1889,0,1,5,6,16.7%,2h
38778,3,Figs,1889,0,0,1,1,0.0%,58m
38778,3,NMRWDR,1889,0,0,1,1,0.0%,29m
38778,2,Pikaslash,1889,0,0,7,7,0.0%,1h
38787,3,Bancocoman,1888,1182,49,46,95,51.6%,1h
38787,3,tino,1888,1217,45,56,101,44.6%,2h
38787,3,DavAq,1888,502,22,18,40,55.0%,33m
38787,3,torres,1888,280,9,13,22,40.9%,48m
38787,2,Eidean,1888,58,5,7,12,41.7%,2h
38787,3,Dharma,1888,98,3,5,8,37.5%,2m
38787,2,Jawesome,1888,88,3,5,8,37.5%,1h
38787,3,BillySlick,1888,0,1,0,1,100.0%,9m
38787,2,dirjthemirge,1888,93,1,8,9,11.1%,3h
38787,3,GKale,1888,0,0,1,1,0.0%,57m
38787,2,sion,1888,0,0,3,3,0.0%,44m
38787,3,matadorx,1888,0,0,5,5,0.0%,3h
38799,2,ProjectVast,1887,1546,130,161,291,44.7%,2h
38799,3,CHERRA,1887,238,7,14,21,33.3%,14m
38799,3,ninñawwwwwpp,1887,92,2,0,2,100.0%,3h
38799,3,Rakzer,1887,0,2,4,6,33.3%,2h
38799,3,PoseidonRage,1887,0,0,4,4,0.0%,12m
38799,3,Smokey,1887,0,0,6,6,0.0%,17m
38805,3,[SDC14]PikaDiamante,1886,118,7,9,16,43.8%,3h
38805,2,TomaterBagel,1886,260,6,19,25,24.0%,26m
38805,1,[GGMB]Fritigern,1886,173,5,14,19,26.3%,4m
38805,3,maykel,1886,88,4,2,6,66.7%,3h
38805,3,BetaStar,1886,72,3,3,6,50.0%,9m
38805,3,ThiaguiNTTFU,1886,0,1,0,1,100.0%,58m
38805,3,kanekiken,1886,0,1,0,1,100.0%,59m
38805,3,MagicOps,1886,0,1,1,2,50.0%,58m
38805,3,starhue,1886,0,1,1,2,50.0%,12m
38805,2,Smaenblack,1886,0,1,4,5,20.0%,2h
38805,2,polifofo,1886,90,1,7,8,12.5%,1h
38805,3,Mimsi,1886,0,0,6,6,0.0%,42m
38805,2,ELxTIRRI,1886,0,0,7,7,0.0%,1h
38818,3,Pietroski,1885,258,9,18,27,33.3%,28m
38818,3,NitroDubz,1885,150,3,13,16,18.8%,20m
38818,3,Wartreynexxx,1885,58,2,1,3,66.7%,2h
38818,3,Fenny,1885,0,1,0,1,100.0%,2h
38822,2,TlonUqbar,1884,419,65,75,140,46.4%,2h
38822,1,[MIDMX]Markus,1884,171,7,11,18,38.9%,29m
38822,3,ceptar,1884,142,6,8,14,42.9%,2h
38822,3,Tsuyu,1884,30,3,4,7,42.9%,53m
38822,3,ShadowMancer,1884,0,0,1,1,0.0%,20m
38822,3,Titans,1884,0,0,1,1,0.0%,2h
38822,2,hiya,1884,0,0,3,3,0.0%,49m
38829,2,ralphw,1883,1464,99,109,208,47.6%,2h
38829,3,[DhZAc1]iGunnyn,1883,409,34,44,78,43.6%,2h
38829,3,YASHA,1883,661,27,23,50,54.0%,5m
38829,3,ExTris,1883,612,20,22,42,47.6%,3m
38829,3,IIIIIIIIIIII,1883,555,18,18,36,50.0%,33m
38829,3,Poodlepuff,1883,287,10,5,15,66.7%,2h
38829,3,[ICTH]lol,1883,266,8,8,16,50.0%,1h
38829,2,Fate,1883,204,6,10,16,37.5%,3h
38829,2,CyrusVanB,1883,172,4,12,16,25.0%,1h
38829,3,ecpsssante,1883,72,4,17,21,19.0%,57m
38829,2,xKIRAx,1883,30,2,5,7,28.6%,2h
38829,3,Veritas,1883,95,1,3,4,25.0%,33m
38829,3,Bellzybub,1883,0,1,5,6,16.7%,33m
38829,3,RogerThat,1883,30,1,8,9,11.1%,37m
38829,3,JacoDaMaco,1883,0,0,1,1,0.0%,58m
38844,1,[The3Bs]derek,1882,1248,46,60,106,43.4%,2h
38844,2,Deadite,1882,793,29,37,66,43.9%,3h
38844,3,Thorn,1882,378,16,16,32,50.0%,2h
38844,3,[gLk]QueenHarley,1882,219,11,11,22,50.0%,59m
38844,3,IronTalus,1882,109,4,4,8,50.0%,8m
38844,3,naps,1882,0,3,3,6,50.0%,19m
38844,2,Tiketh,1882,44,1,6,7,14.3%,23m
38844,2,JohnnyLaw,1882,48,1,11,12,8.3%,44m
38844,3,DonMafa,1882,0,0,1,1,0.0%,14m
38844,3,hello,1882,0,0,6,6,0.0%,28m
38854,3,Lee,1881,603,22,24,46,47.8%,59m
38854,3,TicketyBoo,1881,291,12,4,16,75.0%,1h
38854,2,jimi,1881,0,0,1,1,0.0%,23m
38854,3,DalphaKiller,1881,0,0,3,3,0.0%,1h
38858,2,krek,1880,1577,272,339,611,44.5%,2h
38858,3,[PPLean]Malograo,1880,718,37,34,71,52.1%,2h
38858,3,Teranasaurus,1880,455,15,19,34,44.1%,2h
38858,3,BriterDays,1880,330,13,11,24,54.2%,11m
38858,1,[Av0c]Pandasaurus,1880,262,8,16,24,33.3%,3h
38858,3,aranguejo,1880,190,5,5,10,50.0%,57m
38858,2,[BTY]GhostReanima,1880,122,3,11,14,21.4%,3h
38858,3,GHANEH,1880,0,0,1,1,0.0%,46m
38866,3,Crash,1879,516,23,5,28,82.1%,2h
38866,3,Jackson,1879,122,3,8,11,27.3%,2h
38866,2,LlamaRoo,1879,40,1,4,5,20.0%,2h
38869,2,Enu,1878,1482,98,107,205,47.8%,1h
38869,2,barcode,1878,315,69,89,158,43.7%,32m
38869,3,BaronVonEvil,1878,1147,45,42,87,51.7%,27m
38869,3,jadebonsai,1878,564,21,16,37,56.8%,53m
38869,3,ChronoTriggR,1878,417,17,18,35,48.6%,2h
38869,2,[R33D]Sam,1878,402,15,21,36,41.7%,12m
38869,3,Scalin,1878,296,10,13,23,43.5%,19m
38869,3,Zaxz,1878,225,8,5,13,61.5%,59m
38869,3,[THBG]Steadfast,1878,97,2,0,2,100.0%,57m
38869,3,EISIIPIII,1878,30,2,6,8,25.0%,33m
38869,3,DavidVigoya,1878,60,2,8,10,20.0%,58m
38869,2,Matt,1878,88,2,9,11,18.2%,1h
38869,2,chicho,1878,30,1,9,10,10.0%,1h
38869,2,[KOSC]KnightHawk,1878,0,0,8,8,0.0%,2h
38883,3,LanPaMo,1877,393,16,20,36,44.4%,2h
38883,3,Jakar,1877,394,13,19,32,40.6%,25m
38883,3,VietCong,1877,0,0,6,6,0.0%,5m
38886,1,Solacoman,1876,1538,80,96,176,45.5%,2h
38886,3,IIIEviLIII,1876,1516,79,93,172,45.9%,19m
38886,2,Tiger,1876,1399,59,72,131,45.0%,3h
38886,2,judgefudge,1876,408,20,27,47,42.6%,2h
38890,3,Smikes,1875,149,11,12,23,47.8%,1h
38890,3,NullSet,1875,322,10,13,23,43.5%,2h
38890,1,Rozan,1875,48,2,10,12,16.7%,1h
38890,3,GoldenCat,1875,0,0,1,1,0.0%,2m
38890,3,RoachMaster,1875,0,0,7,7,0.0%,8m
38895,3,destruidor,1874,457,20,17,37,54.1%,2h
38895,3,Draco,1874,366,13,16,29,44.8%,3h
38895,3,FIRSTCANNON,1874,62,2,5,7,28.6%,28m
38895,3,ApmTen,1874,0,0,5,5,0.0%,51m
38899,3,Shadow,1873,527,29,30,59,49.2%,27m
38899,3,supremo,1873,343,18,14,32,56.2%,5m
38899,3,[LOSCTM]Alejo,1873,407,16,20,36,44.4%,19m
38899,3,XYON,1873,38,2,1,3,66.7%,22m
38899,1,Gomitas,1873,48,2,10,12,16.7%,2h
38899,3,YaNZZ,1873,46,1,8,9,11.1%,2h
38905,3,Templario,1872,305,11,9,20,55.0%,2h
38905,2,OhRob,1872,336,11,24,35,31.4%,23m
38905,3,Niine,1872,88,3,6,9,33.3%,2h
38905,3,[cluez]royery,1872,0,1,1,2,50.0%,2h
38905,2,[CRaPaN]IIIIIIIIIIII,1872,0,1,7,8,12.5%,59m
38905,3,oxykill,1872,0,0,6,6,0.0%,2m
38911,3,Ghost,1871,204,8,9,17,47.1%,3h
38911,3,[PTSF]LouTenantDan,1871,254,8,10,18,44.4%,1h
38911,3,Gilbert,1871,30,2,0,2,100.0%,2h
38911,2,Dogzen,1871,0,1,6,7,14.3%,3h
38911,3,Nicalds,1871,0,0,6,6,0.0%,2h
38916,3,Hydro,1870,558,22,20,42,52.4%,1h
38916,3,KingJames,1870,158,5,13,18,27.8%,48m
38916,3,killerx,1870,38,1,1,2,50.0%,29m
38916,3,MpBurn,1870,0,1,3,4,25.0%,58m
38916,3,MajorTalon,1870,30,1,5,6,16.7%,3h
38916,3,SaltyVortex,1870,38,1,7,8,12.5%,2h
38922,3,Nickname,1869,277,8,16,24,33.3%,2h
38922,1,HQCosTheta,1869,305,8,17,25,32.0%,30m
38922,3,ADRIAN,1869,132,6,6,12,50.0%,1h
38922,3,MrMoon,1869,0,2,4,6,33.3%,47m
38922,3,FORECASTER,1869,0,0,2,2,0.0%,43m
38922,3,helio,1869,0,0,2,2,0.0%,19m
38922,3,Yúsurus,1869,0,0,3,3,0.0%,3h
38922,3,PhoenixJGrey,1869,0,0,3,3,0.0%,37m
38930,3,Qaphsiel,1868,1217,46,55,101,45.5%,14m
38930,3,NinjaGamerTV,1868,434,15,18,33,45.5%,19m
38930,1,embertap,1868,250,6,16,22,27.3%,37m
38930,3,Whasagoo,1868,119,2,2,4,50.0%,2h
38930,2,[TCD]LcrdSnccp,1868,0,0,1,1,0.0%,33m
38935,2,[4shizl]Morpheuos,1867,274,21,36,57,36.8%,2h
38935,3,Isosceles,1867,354,12,15,27,44.4%,2h
38935,3,EdEd,1867,318,11,17,28,39.3%,55m
38935,3,miguel,1867,204,7,12,19,36.8%,19m
38935,2,[BALANG]BRzonoitildo,1867,209,6,10,16,37.5%,48m
38935,1,MarkdesS,1867,0,3,6,9,33.3%,2h
38935,3,Cgal,1867,0,2,3,5,40.0%,49m
38935,3,MURDEREK,1867,0,1,1,2,50.0%,3h
38935,3,Evshrug,1867,42,1,3,4,25.0%,2h
38935,2,Nived,1867,0,0,9,9,0.0%,2h
38945,1,PrinceVegeta,1866,1093,41,59,100,41.0%,44m
38945,2,Moogerfooger,1866,472,18,28,46,39.1%,3h
38945,3,Rudeboy,1866,245,8,5,13,61.5%,33m
38945,3,dillon,1866,118,5,5,10,50.0%,1h
38945,2,Yveltalman,1866,60,2,9,11,18.2%,2h
38945,2,FredGCT,1866,0,0,7,7,0.0%,2h
38945,2,[dodgy]TorpicalFish,1866,0,0,8,8,0.0%,2h
38952,3,Rebelpa,1865,891,44,31,75,58.7%,19m
38952,3,zzergname,1865,530,20,21,41,48.8%,47m
38952,2,WolfCrimson,1865,422,14,23,37,37.8%,3h
38952,3,Cryntowel,1865,246,8,11,19,42.1%,28m
38952,3,eluwu,1865,287,8,12,20,40.0%,2h
38952,3,startech,1865,60,3,3,6,50.0%,5m
38952,3,DysfncTion,1865,0,1,2,3,33.3%,8m
38952,3,ryan,1865,0,0,2,2,0.0%,9m
38952,3,ddfjndfj,1865,0,0,6,6,0.0%,2h
38961,3,[z2o]Vissionking,1864,246,8,10,18,44.4%,2h
38961,3,lllllllllll,1864,208,7,13,20,35.0%,55m
38961,1,Forgotten,1864,0,0,1,1,0.0%,3h
38964,3,Pavel,1863,141,4,1,5,80.0%,25m
38964,3,Rization,1863,18,2,2,4,50.0%,53m
38964,3,daloco,1863,0,2,5,7,28.6%,60m
38964,3,SOLON,1863,30,1,4,5,20.0%,2h
38964,2,onorch,1863,30,1,8,9,11.1%,3h
38964,2,MarkoMXx,1863,0,0,8,8,0.0%,2h
38970,3,RebelSC,1862,1101,181,231,412,43.9%,2h
38970,3,Riz,1862,118,4,6,10,40.0%,1h
38970,2,jamesrp,1862,0,2,6,8,25.0%,53m
38970,2,harrypostres,1862,0,1,2,3,33.3%,3h
38970,3,Dennis,1862,0,0,1,1,0.0%,2h
38970,2,Zoltar,1862,0,0,1,1,0.0%,3h
38976,2,[UAK]SmokingZerg,1861,1489,113,123,236,47.9%,38m
38976,3,Player,1861,381,12,14,26,46.2%,19m
38976,3,Atlas,1861,120,3,0,3,100.0%,59m
38976,1,[Huffs]craft,1861,48,2,12,14,14.3%,1h
38976,3,ryany,1861,97,1,5,6,16.7%,57m
38976,3,JonnyBear,1861,0,0,1,1,0.0%,19m
38976,3,lit,1861,0,0,6,6,0.0%,1h
38976,2,BrewedWar,1861,0,0,7,7,0.0%,40m
38984,3,NioSD,1860,426,15,15,30,50.0%,1h
38984,3,aleden,1860,322,12,12,24,50.0%,2h
38984,3,Constantine,1860,368,12,18,30,40.0%,29m
38984,2,Moh,1860,225,8,9,17,47.1%,59m
38984,3,[RAR3]Jaccob,1860,228,8,10,18,44.4%,49m
38984,3,Gorriti,1860,72,2,4,6,33.3%,1h
38984,3,[TMKOs]Chasky,1860,0,1,0,1,100.0%,17m
38984,1,heyjoa,1860,48,1,6,7,14.3%,54m
38984,3,Tamashi,1860,0,0,1,1,0.0%,3h
38984,3,GoldRoyerD,1860,0,0,2,2,0.0%,11m
38994,3,Ghostrider,1859,410,13,15,28,46.4%,1h
38994,3,Drankuz,1859,246,8,9,17,47.1%,14m
38994,3,harrangaa,1859,176,7,8,15,46.7%,3h
38994,3,Opie,1859,121,2,2,4,50.0%,3h
38994,3,Xiaofei,1859,72,2,3,5,40.0%,46m
38994,3,RicharTristo,1859,0,1,0,1,100.0%,1h
38994,3,Elio,1859,0,0,1,1,0.0%,25m
38994,3,antares,1859,0,0,2,2,0.0%,51m
39002,1,NeonFusion,1858,356,12,21,33,36.4%,2h
39002,3,[TSBr2]ShangTsung,1858,222,6,6,12,50.0%,53m
39002,2,Jcat,1858,232,6,15,21,28.6%,1h
39002,3,JayAreno,1858,70,3,4,7,42.9%,1h
39002,3,Toruk,1858,98,3,6,9,33.3%,3h
39002,3,ShreamLeky,1858,0,1,3,4,25.0%,29m
39002,2,zerg,1858,0,0,9,9,0.0%,8m
39009,3,ZergyMarley,1857,1526,69,71,140,49.3%,3h
39009,3,LGMMaverik,1857,699,29,30,59,49.2%,11m
39009,3,Joshicus,1857,327,12,18,30,40.0%,60m
39009,3,[LaWeaV]MatrixYT,1857,30,2,2,4,50.0%,2h
39009,2,Ace,1857,30,1,11,12,8.3%,2h
39009,3,Angelek,1857,0,0,1,1,0.0%,43m
39009,3,[HeHe72]DragoonV,1857,0,0,1,1,0.0%,46m
39016,1,FKCHINAGOHK,1856,843,27,43,70,38.6%,2h
39016,3,Berserker,1856,273,9,18,27,33.3%,2h
39016,1,Menerez,1856,158,5,17,22,22.7%,2h
39016,3,wannabe,1856,58,3,2,5,60.0%,12m
39016,3,Johnkim,1856,0,2,5,7,28.6%,1h
39016,2,Zerochaotic,1856,44,1,9,10,10.0%,2h
39016,1,stars,1856,0,1,9,10,10.0%,1h
39016,3,Cluntang,1856,0,0,1,1,0.0%,11m
39016,2,Achilles,1856,0,0,3,3,0.0%,53m
39016,3,[504Hn]SeawolfHN,1856,0,0,3,3,0.0%,12m
39026,3,Gorillamusha,1855,79,4,4,8,50.0%,58m
39026,2,caligreen,1855,104,2,2,4,50.0%,2h
39026,2,[EpicG]ander,1855,102,2,2,4,50.0%,1h
39026,1,Kerlif,1855,0,1,10,11,9.1%,2h
39026,3,Weequd,1855,0,0,1,1,0.0%,1h
39026,3,Moogota,1855,0,0,1,1,0.0%,2h
39026,2,JoeBurlyBoy,1855,0,0,2,2,0.0%,18m
39033,3,Tonclei,1854,635,21,28,49,42.9%,58m
39033,3,EVILSKY,1854,554,20,21,41,48.8%,2h
39033,3,Sleigher,1854,352,13,19,32,40.6%,22m
39033,3,WuuHyper,1854,30,5,3,8,62.5%,19m
39033,2,Gaspar,1854,132,4,13,17,23.5%,3h
39033,3,joe,1854,0,2,1,3,66.7%,17m
39033,3,blizzmang,1854,94,2,4,6,33.3%,3h
39033,2,[S0O]Marry,1854,0,1,0,1,100.0%,2h
39033,3,[464]kingZERATUL,1854,0,0,6,6,0.0%,2h
39042,3,Fegelein,1853,225,7,10,17,41.2%,3h
39042,3,Sylar,1853,46,4,6,10,40.0%,53m
39042,3,eframm,1853,141,4,11,15,26.7%,58m
39042,3,BadAss,1853,0,1,1,2,50.0%,2h
39042,3,mudd,1853,95,1,6,7,14.3%,33m
39042,3,return,1853,0,0,4,4,0.0%,22m
39042,2,rxque,1853,0,0,7,7,0.0%,23m
39049,1,[prise]Drako,1852,290,6,15,21,28.6%,19m
39049,3,CHACAX,1852,0,4,1,5,80.0%,43m
39049,3,Jekko,1852,97,3,3,6,50.0%,53m
39052,2,KingOfClouds,1851,596,30,39,69,43.5%,2h
39052,3,Law,1851,624,21,31,52,40.4%,47m
39052,3,BomberMan,1851,204,8,13,21,38.1%,8m
39052,2,Sleepy,1851,177,6,9,15,40.0%,48m
39052,3,JBOMB,1851,114,5,6,11,45.5%,8m
39052,3,CanisLupus,1851,88,4,3,7,57.1%,2h
39052,3,krywaj,1851,0,2,3,5,40.0%,57m
39052,2,[FFAA]BERSERKER,1851,30,2,8,10,20.0%,26m
39052,1,sans,1851,48,2,9,11,18.2%,19m
39052,2,curita,1851,0,1,0,1,100.0%,50m
39052,3,iceyeti,1851,0,0,5,5,0.0%,46m
39063,3,MMMMMHOTDOGS,1850,171,5,1,6,83.3%,3h
39063,2,BubuCaceres,1850,132,5,9,14,35.7%,3h
39063,3,Goopsimus,1850,0,1,1,2,50.0%,55m
39066,2,Triton,1849,1626,223,248,471,47.3%,3h
39066,3,Grifor,1849,1233,45,49,94,47.9%,47m
39066,3,Nyssa,1849,677,29,15,44,65.9%,1h
39066,3,RoyalMarius,1849,186,7,19,26,26.9%,56m
39066,3,SANTIJAZA,1849,0,1,0,1,100.0%,2h
39066,3,high,1849,97,1,2,3,33.3%,1h
39066,1,Wildomathic,1849,0,0,2,2,0.0%,2h
39073,3,CapMarmota,1848,158,4,7,11,36.4%,1h
39073,1,Thatguy,1848,136,4,13,17,23.5%,42m
39073,2,[SBZg]Missmisery,1848,90,3,11,14,21.4%,1h
39073,2,dabir,1848,30,1,8,9,11.1%,15m
39073,1,ObeseZombie,1848,46,1,11,12,8.3%,2h
39073,3,[ZTempz]RokMan,1848,0,0,1,1,0.0%,37m
39073,3,ggcring,1848,0,0,1,1,0.0%,59m
39073,3,Revenge,1848,0,0,1,1,0.0%,1h
39081,3,[WELP]TomInSpace,1847,350,11,18,29,37.9%,3h
39081,3,MISTERKRABBS,1847,0,2,3,5,40.0%,33m
39081,3,Daniel,1847,0,0,1,1,0.0%,2h
39081,3,[CRaPaN]IIIIIIIIIII,1847,0,0,3,3,0.0%,60m
39081,3,[TSFK]JenningsRage,1847,0,0,5,5,0.0%,19m
39086,3,[LOHe]blargon,1846,731,27,29,56,48.2%,5m
39086,3,[TBABIT]Thumbsupkid,1846,94,1,1,2,50.0%,2h
39086,3,pants,1846,30,1,7,8,12.5%,2h
39086,3,[Drum]Retrac,1846,0,0,1,1,0.0%,43m
39086,3,Silverstar,1846,0,0,1,1,0.0%,2m
39086,2,Alexzc,1846,0,0,3,3,0.0%,59m
39092,3,SMD,1845,888,56,67,123,45.5%,48m
39092,3,inigoMontoya,1845,430,22,27,49,44.9%,29m
39092,2,Honeylisk,1845,489,18,35,53,34.0%,42m
39092,3,Wraydar,1845,401,16,17,33,48.5%,2h
39092,1,Kingw,1845,289,9,14,23,39.1%,1h
39092,3,Warllo,1845,255,8,13,21,38.1%,2h
39092,3,EvilEoz,1845,200,5,8,13,38.5%,3m
39092,3,Zancudo,1845,30,3,3,6,50.0%,2h
39092,2,[KotW]Jadyn,1845,157,3,5,8,37.5%,23m
39092,3,Arcturus,1845,58,3,8,11,27.3%,12m
39092,3,turdhurdler,1845,0,2,3,5,40.0%,56m
39092,3,vip,1845,0,0,5,5,0.0%,17m
39092,3,RaGe,1845,0,0,5,5,0.0%,11m
39105,3,DROPEX,1844,97,8,9,17,47.1%,11m
39105,3,Randahl,1844,152,7,18,25,28.0%,47m
39105,1,[gnosis]GralDanielFV,1844,134,4,4,8,50.0%,25m
39105,2,PlasmaMouse,1844,110,3,9,12,25.0%,8m
39105,3,[KSTONE]SpecialAxe,1844,0,0,2,2,0.0%,2h
39110,2,WAP,1843,532,41,48,89,46.1%,39m
39110,3,CrnkyDiabetc,1843,1100,30,111,141,21.3%,41m
39110,3,SpongyFishin,1843,331,10,22,32,31.2%,7m
39110,3,brandon,1843,217,6,10,16,37.5%,48m
39110,2,TITAN,1843,96,2,1,3,66.7%,9m
39110,2,templariobr,1843,44,2,8,10,20.0%,53m
39116,3,thewallyo,1842,162,6,6,12,50.0%,1h
39116,3,walgrenz,1842,190,6,14,20,30.0%,20m
39116,3,MatchaSage,1842,108,5,18,23,21.7%,56m
39116,2,[KhanZ]JoNuts,1842,60,4,9,13,30.8%,1h
39116,2,Gammawatt,1842,72,3,11,14,21.4%,2h
39116,3,WalkingDude,1842,0,1,4,5,20.0%,29m
39116,3,DreamPhoenix,1842,0,1,5,6,16.7%,19m
39116,3,UFOpilot,1842,0,0,7,7,0.0%,12m
39124,3,Toshii,1841,709,26,29,55,47.3%,1h
39124,3,muganynnos,1841,619,22,29,51,43.1%,1h
39124,3,ERR,1841,175,5,8,13,38.5%,12m
39124,3,[GGMESP]FabioSR,1841,142,4,4,8,50.0%,2h
39124,3,Spideybih,1841,120,3,3,6,50.0%,22m
39124,3,hondureño,1841,60,3,4,7,42.9%,1h
39124,3,Dragonspirit,1841,48,3,4,7,42.9%,3h
39124,3,Tavo,1841,60,2,4,6,33.3%,12m
39124,3,Sebastian,1841,0,1,0,1,100.0%,8m
39124,3,ChronoTGK,1841,30,1,6,7,14.3%,53m
39124,3,EvilBanana,1841,0,0,7,7,0.0%,2h
39135,3,PROJECT,1840,1432,52,66,118,44.1%,1h
39135,3,soga,1840,365,13,6,19,68.4%,2h
39135,3,HDtr,1840,145,4,6,10,40.0%,58m
39135,3,MagicAddict,1840,0,3,4,7,42.9%,9m
39135,2,mrscv,1840,0,0,7,7,0.0%,8m
39140,1,redqueen,1839,490,13,34,47,27.7%,3h
39140,3,LARMSTONE,1839,276,9,9,18,50.0%,19m
39140,2,adamdude,1839,218,9,11,20,45.0%,41m
39140,3,HappyRangers,1839,0,2,7,9,22.2%,51m
39140,1,ARTANIS,1839,130,2,12,14,14.3%,18m
39140,1,MRist,1839,0,1,0,1,100.0%,2h
39140,3,fams,1839,0,1,0,1,100.0%,8m
39140,3,Nothomb,1839,0,0,3,3,0.0%,2h
39140,1,Nutstomper,1839,0,0,7,7,0.0%,2h
39140,2,Ryanaft,1839,0,0,8,8,0.0%,23m
39140,2,yodigi,1839,0,0,8,8,0.0%,1h
39151,1,PurpleBoboz,1838,1774,54,60,114,47.4%,28m
39151,3,[SKyber]Arcanjo,1838,536,21,29,50,42.0%,19m
39151,3,Dreekuz,1838,307,19,20,39,48.7%,2h
39151,3,[LFUT]FireZerg,1838,364,11,22,33,33.3%,29m
39151,1,[KUKLX]destroyer,1838,90,4,13,17,23.5%,56m
39151,1,KobePplays,1838,38,2,9,11,18.2%,42m
39151,1,Datnikka,1838,0,1,0,1,100.0%,25m
39151,1,[n00bp]MadPfeiffer,1838,0,1,0,1,100.0%,3h
39151,3,thejoe,1838,0,0,1,1,0.0%,2h
39151,3,battlefist,1838,0,0,4,4,0.0%,3h
39151,1,Coatlius,1838,73,0,8,8,0.0%,2h
39162,1,[DSTN]entropy,1837,382,11,21,32,34.4%,2h
39162,3,[Antss]tURD,1837,162,5,8,13,38.5%,2h
39162,2,Destroyer,1837,60,2,10,12,16.7%,3h
39162,3,Hecatonquiro,1837,30,1,3,4,25.0%,1h
39166,3,Ithklur,1836,262,9,13,22,40.9%,53m
39166,1,Shinobi,1836,188,4,5,9,44.4%,3h
39166,1,delta,1836,30,2,10,12,16.7%,35m
39166,1,Shahkanarnar,1836,48,1,5,6,16.7%,2h
39170,3,Zorion,1835,866,29,37,66,43.9%,53m
39170,3,BeginnersLuq,1835,387,17,10,27,63.0%,12m
39170,2,destiny,1835,210,7,15,22,31.8%,57m
39170,3,TacticalCow,1835,0,1,0,1,100.0%,29m
39170,3,SeñorSandia,1835,0,1,1,2,50.0%,20m
39170,2,KKangs,1835,95,1,4,5,20.0%,3h
39170,3,gunquistador,1835,0,0,3,3,0.0%,17m
39170,2,muvlo,1835,0,0,4,4,0.0%,18m
39178,2,lionpro,1834,157,3,1,4,75.0%,32m
39178,3,Lenin,1834,0,1,1,2,50.0%,2h
39178,3,[TSOTI]DeathnDisco,1834,0,0,4,4,0.0%,3h
39178,3,TwitchNultsy,1834,0,0,7,7,0.0%,2h
39182,2,Anaya,1833,180,6,14,20,30.0%,2h
39182,2,juanqv,1833,102,2,4,6,33.3%,54m
39182,3,[PFOne]AbnerPF,1833,30,1,6,7,14.3%,14m
39182,1,Snuffy,1833,0,1,10,11,9.1%,2h
39186,2,ANNIHILATOR,1832,696,23,35,58,39.7%,3h
39186,2,donkaments,1832,526,16,23,39,41.0%,2h
39186,3,Masterchief,1832,279,9,13,22,40.9%,53m
39186,1,[SBlock]Vergara,1832,306,8,4,12,66.7%,3h
39186,1,AlwaysFresh,1832,244,5,11,16,31.2%,28m
39186,2,zennguyen,1832,132,5,12,17,29.4%,53m
39186,3,Hazelmalkav,1832,123,2,6,8,25.0%,2h
39186,3,monkeyyoubi,1832,0,0,2,2,0.0%,9m
39186,3,Tuefel,1832,0,0,6,6,0.0%,59m
39195,3,Naofumi,1831,1174,45,55,100,45.0%,1h
39195,1,[LBanda]nachosmc,1831,1207,35,41,76,46.1%,2h
39195,2,JondalarCHL,1831,933,33,49,82,40.2%,3h
39195,3,degoplay,1831,804,27,37,64,42.2%,19m
39195,1,[GaOn]Crankit,1831,710,19,18,37,51.4%,1h
39195,3,nemo,1831,213,10,5,15,66.7%,58m
39195,1,SteveHarvey,1831,353,7,19,26,26.9%,2h
39202,2,Tamerlan,1830,1553,182,231,413,44.1%,2h
39202,3,YashoLMAo,1830,286,11,14,25,44.0%,3h
39202,3,Joaquin,1830,88,3,5,8,37.5%,22m
39202,3,FateYeah,1830,88,3,10,13,23.1%,12m
39202,3,[ALTF04]Rorro,1830,0,1,0,1,100.0%,59m
39207,3,unknown,1829,196,10,16,26,38.5%,3h
39207,2,WinterKnight,1829,234,7,8,15,46.7%,2h
39207,3,BalderJiri,1829,0,2,3,5,40.0%,2h
39207,2,Luckaith,1829,96,2,3,5,40.0%,3h
39207,1,sempie,1829,0,1,4,5,20.0%,47m
39207,1,Jaefcope,1829,97,1,6,7,14.3%,2h
39207,3,PREDADOR,1829,0,1,8,9,11.1%,22m
39207,3,KINDERMALO,1829,0,0,1,1,0.0%,17m
39215,3,Mixcoatl,1828,642,28,37,65,43.1%,49m
39215,1,FernasRPG,1828,82,4,5,9,44.4%,2h
39215,3,LearninG,1828,60,4,10,14,28.6%,43m
39215,2,inbalance,1828,128,2,6,8,25.0%,59m
39215,3,RealKeeper,1828,0,1,12,13,7.7%,18m
39215,3,DJWHALE,1828,0,0,8,8,0.0%,2h
39221,3,Amrak,1827,652,22,41,63,34.9%,2h
39221,3,CombatJester,1827,474,20,23,43,46.5%,47m
39221,3,[DXPCA]artanis,1827,346,11,15,26,42.3%,2h
39221,2,CcloudsS,1827,0,1,0,1,100.0%,44m
39221,1,Derpatron,1827,46,1,1,2,50.0%,3h
39221,3,maxwell,1827,0,1,4,5,20.0%,17m
39227,3,domishere,1826,1062,91,132,223,40.8%,2h
39227,3,earthaven,1826,844,29,36,65,44.6%,2h
39227,1,[TPVZ]Braxis,1826,44,2,1,3,66.7%,1h
39227,2,Atila,1826,0,2,5,7,28.6%,56m
39227,1,[HTP450]ErenJaeger,1826,0,1,0,1,100.0%,2h
39227,2,VoidFlames,1826,0,1,1,2,50.0%,44m
39227,3,[KSRP]HarryLeTaint,1826,0,1,3,4,25.0%,1h
39227,1,[SLKNM]Arryman,1826,0,1,4,5,20.0%,1h
39227,2,LeftaroO,1826,0,0,1,1,0.0%,23m
39236,3,Oso,1825,467,16,16,32,50.0%,10m
39236,3,Jokio,1825,186,6,12,18,33.3%,3h
39236,2,Gerard,1825,60,4,10,14,28.6%,3h
39236,2,TheBranman,1825,78,2,10,12,16.7%,33m
39240,3,KilrInstinct,1824,94,1,2,3,33.3%,2h
39240,3,Zero,1824,0,1,7,8,12.5%,49m
39242,3,[OPKZ]conceptmatt,1823,274,8,15,23,34.8%,9m
39242,3,gab,1823,225,7,19,26,26.9%,2h
39242,3,diosdelsexo,1823,166,6,5,11,54.5%,56m
39242,3,BlackMagic,1823,0,1,0,1,100.0%,2h
39242,1,PhamilyMahn,1823,46,1,2,3,33.3%,3h
39242,3,BichoOscuro,1823,30,1,3,4,25.0%,37m
39248,3,Ekelly,1822,467,18,19,37,48.6%,33m
39248,1,SuperSantos,1822,234,6,4,10,60.0%,2h
39248,2,kushalisk,1822,124,4,20,24,16.7%,54m
39248,3,BlacPower,1822,0,2,4,6,33.3%,48m
39248,1,BushMaori,1822,44,2,11,13,15.4%,3h
39253,3,DarthDread,1821,206,7,14,21,33.3%,2h
39253,3,[ThEps]Nannamal,1821,148,6,5,11,54.5%,3h
39253,2,DomadorToros,1821,30,3,7,10,30.0%,1h
39253,3,frame,1821,97,1,12,13,7.7%,27m
39253,2,Kahr,1821,0,0,2,2,0.0%,18m
39258,3,[cluez]Grandma,1820,433,17,20,37,45.9%,9m
39258,2,alskjdfkljas,1820,326,12,16,28,42.9%,2h
39258,3,Tigre,1820,0,1,3,4,25.0%,2h
39258,3,malikor,1820,18,1,5,6,16.7%,22m
39258,1,Zero,1820,0,0,1,1,0.0%,39m
39258,3,[CHOLOS]Master,1820,0,0,1,1,0.0%,17m
39258,3,Topus,1820,0,0,1,1,0.0%,1h
39258,1,crozzer,1820,0,0,3,3,0.0%,2h
39266,3,SneakyTurtle,1819,956,37,48,85,43.5%,29m
39266,3,Indistrol,1819,504,25,11,36,69.4%,5m
39266,1,CrAzYdRiVeR,1819,279,11,12,23,47.8%,1h
39266,1,Eclipse,1819,172,4,7,11,36.4%,2h
39266,1,bigman,1819,0,0,1,1,0.0%,29m
39266,3,Kruadel,1819,0,0,6,6,0.0%,2h
39272,2,tatertheslyr,1818,1040,56,65,121,46.3%,55m
39272,1,Astaroth,1818,232,5,2,7,71.4%,1h
39272,2,LongSchlong,1818,46,4,9,13,30.8%,23m
39272,1,koomkookie,1818,0,0,1,1,0.0%,3h
39272,3,NEO,1818,0,0,2,2,0.0%,2h
39277,2,Mickabooo,1817,185,4,5,9,44.4%,8m
39277,3,HeatFenix,1817,118,3,2,5,60.0%,59m
39277,3,[FCKAHO]Orin,1817,88,3,6,9,33.3%,9m
39280,3,gonzalom,1816,852,33,39,72,45.8%,2h
39280,3,Vanic,1816,655,28,18,46,60.9%,1h
39280,3,PEREJIL,1816,0,0,8,8,0.0%,1h
39283,2,MaxRocknRoll,1815,1261,97,135,232,41.8%,2h
39283,2,Doubles,1815,372,12,20,32,37.5%,2h
39283,3,PlowingUrMOM,1815,66,5,3,8,62.5%,29m
39283,1,BooJiggeyPop,1815,48,1,2,3,33.3%,2h
39283,1,MegaClonpi,1815,73,1,5,6,16.7%,2h
39283,2,ElyasToor,1815,0,0,1,1,0.0%,59m
39283,1,[CRAKS]zerathul,1815,0,0,2,2,0.0%,24m
39290,1,Sleepy,1814,512,13,13,26,50.0%,1h
39290,3,Dell,1814,188,6,10,16,37.5%,1h
39290,3,Heria,1814,136,4,11,15,26.7%,3h
39290,1,xLibertador,1814,0,1,9,10,10.0%,1h
39290,3,tdbronco,1814,0,0,5,5,0.0%,9m
39295,3,Jokesonyou,1813,192,6,8,14,42.9%,21m
39295,2,Lego,1813,42,1,4,5,20.0%,1h
39295,3,exilledogz,1813,42,1,8,9,11.1%,3h
39298,3,FluffyOps,1812,333,13,20,33,39.4%,8m
39298,2,Sisyphus,1812,0,3,9,12,25.0%,49m
39298,3,[WTNRCL]RyuShin,1812,0,2,4,6,33.3%,2h
39301,3,Cubanissimo,1811,1460,106,117,223,47.5%,25m
39301,1,FeelThePain,1811,182,4,7,11,36.4%,15m
39301,2,littycomitee,1811,58,4,9,13,30.8%,1h
39301,2,xenoryt,1811,0,1,3,4,25.0%,53m
39305,3,BobbyHill,1810,342,11,16,27,40.7%,1h
39305,3,[KohShe]Prom,1810,105,4,8,12,33.3%,59m
39305,1,SuperTroy,1810,115,2,4,6,33.3%,2h
39305,3,DaltonicoCTM,1810,26,2,5,7,28.6%,17m
39305,1,BlindingSW,1810,46,2,12,14,14.3%,2h
39305,3,Haltzman,1810,0,1,0,1,100.0%,9m
39305,3,[ExcIgN]GaBiTo,1810,94,1,6,7,14.3%,3h
39312,1,DRONEXXX,1809,140,4,3,7,57.1%,2h
39312,2,[K3oudy]LUKAS,1809,130,3,2,5,60.0%,2h
39312,1,Ding,1809,155,2,8,10,20.0%,47m
39312,3,DudeComeOn,1809,121,2,9,11,18.2%,2h
39312,1,Redkane,1809,0,1,1,2,50.0%,5m
39317,3,SandmanMX,1808,104,3,7,10,30.0%,3h
39317,1,Mathew,1808,68,2,8,10,20.0%,44m
39317,3,QuickChick,1808,0,0,1,1,0.0%,53m
39320,3,Shark,1807,392,59,78,137,43.1%,9m
39320,2,BigAl,1807,124,5,7,12,41.7%,1h
39320,3,Sekuv,1807,30,3,4,7,42.9%,53m
39320,1,JoseÁguila,1807,48,2,1,3,66.7%,1h
39320,1,[asdfsd]Kobra,1807,96,2,6,8,25.0%,44m
39320,1,Flyingprube,1807,30,1,9,10,10.0%,3h
39326,3,Computer,1806,1515,67,73,140,47.9%,1h
39326,3,[JRT]MasacrePy,1806,169,5,7,12,41.7%,22m
39326,3,LoreHorse,1806,175,5,10,15,33.3%,58m
39326,3,PvCure,1806,60,3,10,13,23.1%,2h
39326,1,ThisIsME,1806,88,2,2,4,50.0%,15m
39326,3,Hydralisk,1806,0,0,2,2,0.0%,1h
39332,2,Brad,1805,552,18,32,50,36.0%,3h
39332,1,Rowey,1805,544,16,25,41,39.0%,1h
39332,1,YooZwei,1805,0,3,2,5,60.0%,2h
39332,3,[SyLx]MrCool,1805,0,0,1,1,0.0%,9m
39332,2,pumba,1805,0,0,8,8,0.0%,56m
39337,1,prosor,1804,126,4,15,19,21.1%,3h
39338,2,MorceGuuu,1803,1515,181,236,417,43.4%,3h
39338,1,TheOvermind,1803,0,1,1,2,50.0%,2h
39340,2,Eurozone,1802,271,48,76,124,38.7%,2h
39340,3,JonC,1802,703,25,32,57,43.9%,58m
39340,2,CowboyDream,1802,377,17,20,37,45.9%,12m
39340,3,LOBOSALVAJE,1802,0,0,4,4,0.0%,5m
39340,2,Crazycat,1802,0,0,9,9,0.0%,59m
39345,3,[xLgNx]IamGroot,1801,367,50,64,114,43.9%,2h
39345,1,TheBeatles,1801,388,13,27,40,32.5%,2h
39345,3,Viper,1801,324,10,16,26,38.5%,3h
39345,1,woaiplatinum,1801,217,5,9,14,35.7%,29m
39345,3,Lunchbox,1801,0,2,6,8,25.0%,1h
39345,3,[Fever]skilletsnail,1801,58,2,7,9,22.2%,55m
39345,1,lightorais,1801,0,1,0,1,100.0%,2h
39345,3,BloodHands,1801,0,0,1,1,0.0%,29m
39345,2,NIGHTMARE,1801,0,0,8,8,0.0%,3h
39354,3,SeniorButSec,1800,1262,50,65,115,43.5%,47m
39354,3,ZstyAlphabet,1800,548,19,25,44,43.2%,20m
39354,1,Janomon,1800,136,3,3,6,50.0%,2h
39354,1,Brisk,1800,0,1,2,3,33.3%,2h
39354,3,RUGAL,1800,0,0,3,3,0.0%,58m
39354,3,BlueDream,1800,0,0,5,5,0.0%,1h
39354,3,Kefka,1800,0,0,6,6,0.0%,1m
39361,2,[0425]NEMO,1799,752,23,45,68,33.8%,3h
39361,2,BenjaminJk,1799,278,10,14,24,41.7%,3h
39361,3,Gilberto,1799,258,9,20,29,31.0%,2h
39361,1,Farter,1799,272,7,3,10,70.0%,1h
39361,2,[Kusshh]Dondiablo,1799,140,3,7,10,30.0%,41m
39361,1,scibri,1799,0,1,0,1,100.0%,2h
39361,2,RockinRolla,1799,0,0,8,8,0.0%,3h
39368,2,DiegoFuzatto,1798,1376,49,60,109,45.0%,57m
39368,3,Todd,1798,663,25,26,51,49.0%,33m
39368,3,zorroxf,1798,346,13,16,29,44.8%,21m
39368,2,timhuang,1798,310,11,21,32,34.4%,8m
39368,3,Enurta,1798,240,10,15,25,40.0%,12m
39373,1,Reever,1797,388,11,39,50,22.0%,2h
39373,3,cringelord,1797,126,5,8,13,38.5%,1h
39373,3,jones,1797,30,1,5,6,16.7%,3h
39373,2,PRETORIUS,1797,0,0,8,8,0.0%,55m
39377,1,[cluez]Bubbles,1796,1476,42,55,97,43.3%,2h
39377,3,URUALFA,1796,900,35,37,72,48.6%,3m
39377,1,wondrbread,1796,650,18,16,34,52.9%,2h
39377,2,[TTKOPF]Jisharu,1796,513,17,35,52,32.7%,2h
39377,3,seashepherd,1796,383,13,18,31,41.9%,48m
39377,3,axel,1796,125,2,8,10,20.0%,20m
39383,1,Foofus,1795,1939,96,117,213,45.1%,2h
39383,1,BlackWolf,1795,123,2,7,9,22.2%,1h
39385,2,Saku,1794,726,43,73,116,37.1%,3h
39385,3,CrabJuice,1794,487,16,31,47,34.0%,29m
39387,3,xDarkFaze,1793,0,1,0,1,100.0%,53m
39387,1,DonOdion,1793,44,1,1,2,50.0%,2h
39387,3,Denzil,1793,0,1,6,7,14.3%,46m
39387,1,Jang,1793,0,1,9,10,10.0%,1h
39387,1,Hellscross,1793,0,0,1,1,0.0%,2h
39392,2,Ender,1792,202,8,10,18,44.4%,3h
39392,1,sariel,1792,126,3,1,4,75.0%,3h
39392,1,Legbone,1792,0,0,1,1,0.0%,3h
39392,2,carlosgrosas,1792,0,0,6,6,0.0%,44m
39396,3,Lucas,1791,1288,95,107,202,47.0%,57m
39396,3,Neopactech,1791,72,3,6,9,33.3%,3m
39396,3,chinin,1791,106,3,7,10,30.0%,53m
39396,3,[xNetx]kevin,1791,62,2,7,9,22.2%,2h
39396,3,SpokenTruth,1791,0,0,3,3,0.0%,1h
39401,3,TerryDane,1790,933,45,45,90,50.0%,20m
39401,1,Kirashnikova,1790,357,8,19,27,29.6%,2h
39401,3,Menjunje,1790,148,3,11,14,21.4%,60m
39401,3,BIizzard,1790,58,2,2,4,50.0%,29m
39401,3,Craftostar,1790,0,2,3,5,40.0%,8m
39401,3,Ozzy,1790,0,0,6,6,0.0%,2h
39407,1,kevclang,1789,373,16,14,30,53.3%,28m
39407,2,GhostDog,1789,362,14,22,36,38.9%,2h
39407,2,[Sathus]Sathus,1789,0,0,2,2,0.0%,2h
39407,2,[FIow]ChickenHawk,1789,0,0,7,7,0.0%,42m
39411,3,Kobra,1788,173,5,5,10,50.0%,22m
39411,2,Vince,1788,42,2,10,12,16.7%,53m
39411,1,Traquemort,1788,0,1,0,1,100.0%,2h
39411,3,Nightscatter,1788,0,1,9,10,10.0%,50m
39411,3,gonzalo,1788,0,0,3,3,0.0%,22m
39416,1,[diaman]davA,1787,1382,42,49,91,46.2%,46m
39416,1,LUKECRAFT,1787,398,9,6,15,60.0%,11m
39416,1,[VINGAD]Graby,1787,259,8,20,28,28.6%,46m
39416,3,ZandsT,1787,162,5,7,12,41.7%,53m
39416,3,Pchelovod,1787,124,4,9,13,30.8%,48m
39416,2,Hiraku,1787,211,4,14,18,22.2%,3h
39416,3,Schlanko,1787,36,2,4,6,33.3%,3h
39423,1,Daneye,1786,649,18,24,42,42.9%,2h
39423,1,Devastador,1786,303,7,8,15,46.7%,2h
39423,3,ZeroPoint,1786,193,6,8,14,42.9%,2h
39423,1,GabeThWicked,1786,218,6,13,19,31.6%,1h
39423,2,mewwwkitty,1786,30,4,8,12,33.3%,15m
39423,1,Loki,1786,142,4,17,21,19.0%,1h
39423,1,zergOP,1786,42,1,1,2,50.0%,1h
39423,2,DarkWolf,1786,38,1,11,12,8.3%,2h
39423,1,JOHANSON,1786,0,0,1,1,0.0%,60m
39423,3,RiFF,1786,0,0,5,5,0.0%,1h
39423,1,Brother,1786,0,0,5,5,0.0%,1h
39434,3,Eyedea,1785,343,16,20,36,44.4%,40m
39434,1,CrAzYwAsP,1785,141,4,15,19,21.1%,24m
39436,3,Kristjan,1784,1388,75,95,170,44.1%,8m
39436,2,AtticusGrey,1784,42,1,5,6,16.7%,33m
39436,3,Jiye,1784,0,0,4,4,0.0%,3h
39436,3,iOsiris,1784,0,0,7,7,0.0%,18m
39440,2,PaddyQ,1783,1521,63,69,132,47.7%,1h
39440,1,juancalito,1783,1513,49,55,104,47.1%,28m
39440,2,dylan,1783,168,6,8,14,42.9%,51m
39443,3,ROY,1782,1459,68,86,154,44.2%,46m
39443,2,FatherFigure,1782,583,20,25,45,44.4%,1h
39443,3,JorgeSV,1782,0,1,1,2,50.0%,9m
39443,1,[110011]Andhren,1782,73,1,4,5,20.0%,2h
39447,1,AvanzinKK,1781,852,24,27,51,47.1%,46m
39447,1,craneoroto,1781,174,4,6,10,40.0%,1h
39447,3,mayhem,1781,0,0,1,1,0.0%,51m
39447,2,Mrbootz,1781,0,0,8,8,0.0%,1h
39451,3,Flyguy,1780,1506,57,77,134,42.5%,7m
39451,2,Spartacan,1780,93,1,2,3,33.3%,3h
39451,3,bardem,1780,44,1,5,6,16.7%,1m
39451,3,KingOfTheDam,1780,0,1,6,7,14.3%,60m
39451,1,ArfanRDX,1780,0,0,1,1,0.0%,2h
39456,1,Gutoman,1779,291,8,18,26,30.8%,11m
39456,3,Kahn,1779,72,3,8,11,27.3%,60m
39456,1,Ciciri,1779,0,1,0,1,100.0%,2h
39456,1,[cluez]ThedoctorS,1779,0,0,4,4,0.0%,39m
39456,1,[RCSM]Frankkexx,1779,0,0,4,4,0.0%,2h
39456,1,JoakorVF,1779,73,0,4,4,0.0%,2h
39456,3,[TLPD]World,1779,0,0,5,5,0.0%,2h
39463,3,Akcarr,1778,428,13,25,38,34.2%,2h
39463,2,Peter,1778,213,8,12,20,40.0%,59m
39463,2,Jetpackracer,1778,188,4,9,13,30.8%,12m
39463,1,Kronx,1778,46,1,1,2,50.0%,1h
39463,3,NOVA,1778,0,0,2,2,0.0%,2h
39463,1,Aleliv,1778,0,0,3,3,0.0%,1h
39469,1,[brenst]archsten,1777,379,12,24,36,33.3%,3h
39469,3,Slyndovv,1777,0,2,5,7,28.6%,2h
39469,1,[Gbm0d]Pdepuma,1777,0,0,1,1,0.0%,2h
39472,1,Coronohoax,1776,1129,29,30,59,49.2%,2h
39472,3,THEHUNTDOG,1776,430,22,33,55,40.0%,27m
39472,2,james,1776,0,1,5,6,16.7%,56m
39475,3,Rampage,1775,308,13,12,25,52.0%,2h
39475,1,[space3]Fantasma,1775,214,6,5,11,54.5%,1h
39475,2,Berzerger,1775,244,6,14,20,30.0%,1h
39475,1,levvn,1775,0,0,1,1,0.0%,2h
39479,3,CLON,1774,196,6,14,20,30.0%,1h
39479,2,COATL,1774,74,3,2,5,60.0%,50m
39479,3,AJLegacy,1774,0,0,2,2,0.0%,20m
39482,3,Demo,1773,340,12,16,28,42.9%,49m
39482,3,MEMEQBGT,1773,191,5,7,12,41.7%,1h
39482,2,WhiteAngelNs,1773,118,4,15,19,21.1%,41m
39482,1,edifoo,1773,84,3,4,7,42.9%,2h
39482,3,[AKWarr]TimmyVader,1773,30,1,5,6,16.7%,55m
39482,3,gnzl,1773,0,0,1,1,0.0%,3h
39488,1,Coldf,1772,659,19,15,34,55.9%,11m
39488,1,[SWOU]SonofFugnuts,1772,73,0,8,8,0.0%,1h
39490,3,Seba,1771,1316,54,55,109,49.5%,22m
39490,2,joefish,1771,1206,51,63,114,44.7%,59m
39490,1,[OPMs]Berserk,1771,228,6,5,11,54.5%,2h
39490,3,PhoenixLASO,1771,228,6,8,14,42.9%,1h
39490,1,Yone,1771,0,0,1,1,0.0%,3h
39490,2,Yestro,1771,0,0,2,2,0.0%,18m
39496,1,Thor,1770,710,19,27,46,41.3%,1h
39497,3,Hector,1769,326,10,22,32,31.2%,58m
39497,1,[AltRT]Sarento,1769,48,1,1,2,50.0%,2h
39497,2,Skillzkillz,1769,40,1,10,11,9.1%,1h
39497,3,Dendep,1769,0,0,8,8,0.0%,9m
39501,1,Arthur,1768,394,10,8,18,55.6%,47m
39501,3,TenaciousT,1768,95,2,5,7,28.6%,33m
39501,2,Tomcat,1768,0,1,0,1,100.0%,1h
39501,1,desordures,1768,46,1,3,4,25.0%,1h
39501,3,[BLT666]wil,1768,30,1,8,9,11.1%,2h
39501,1,BeckemKong,1768,0,0,2,2,0.0%,2h
39501,1,[urdone]InSaNiTy,1768,0,0,2,2,0.0%,2h
39508,1,Electrico,1767,1519,45,57,102,44.1%,43m
39508,3,Mantai,1767,890,32,52,84,38.1%,33m
39508,1,PONYO,1767,96,3,4,7,42.9%,2h
39508,2,JASTAN,1767,30,1,10,11,9.1%,3h
39508,1,kimdaeho,1767,0,0,1,1,0.0%,3h
39508,1,DaGrizzman,1767,0,0,3,3,0.0%,1h
39514,3,Psyko,1766,238,9,21,30,30.0%,17m
39514,1,ditxw,1766,258,7,13,20,35.0%,2h
39514,3,Kalevanji,1766,66,5,15,20,25.0%,2h
39514,1,BananaLord,1766,124,3,5,8,37.5%,3h
39514,1,UncleSam,1766,88,3,7,10,30.0%,2h
39519,3,Manuel,1765,1470,62,65,127,48.8%,2h
39519,1,VegetaZerG,1765,1119,53,45,98,54.1%,20m
39519,1,MetroKnome,1765,866,25,20,45,55.6%,20m
39522,1,Apollyon,1764,926,23,44,67,34.3%,2h
39522,3,Krlam,1764,483,15,24,39,38.5%,1h
39522,3,Azunek,1764,294,9,20,29,31.0%,48m
39522,3,cronos,1764,36,2,5,7,28.6%,3m
39526,1,Verth,1763,40,4,8,12,33.3%,3h
39526,1,ReyAhead,1763,0,3,2,5,60.0%,3h
39528,1,ancestors,1762,48,2,15,17,11.8%,11m
39528,3,Anderson,1762,0,1,1,2,50.0%,3h
39530,1,jason,1761,48,1,2,3,33.3%,3h
39531,1,Victor,1760,716,22,21,43,51.2%,28m
39531,1,llllll,1760,96,3,1,4,75.0%,3h
39531,1,fenixgth,1760,90,3,1,4,75.0%,3h
39531,1,DrlSgtSykes,1760,132,3,7,10,30.0%,1h
39531,1,[ApmTen]Bronze,1760,0,0,5,5,0.0%,3h
39536,3,alexx,1759,282,8,18,26,30.8%,22m
39536,3,CesarDTmay,1759,143,3,7,10,30.0%,5m
39536,3,Herb,1759,0,1,2,3,33.3%,59m
39539,1,Keats,1758,816,21,23,44,47.7%,2h
39539,1,ian,1758,338,14,3,17,82.4%,47m
39539,1,Silence,1758,446,14,6,20,70.0%,1h
39539,3,Dandoh,1758,158,6,15,21,28.6%,53m
39539,2,BronzeHero,1758,60,5,8,13,38.5%,3h
39539,1,nay,1758,174,4,7,11,36.4%,2h
39539,1,[WuTang]MasterWU,1758,0,1,0,1,100.0%,1h
39539,3,OoOVVOoO,1758,30,1,4,5,20.0%,48m
39539,3,Asmodeay,1758,0,1,5,6,16.7%,1m
39548,3,panchatantra,1757,1496,227,288,515,44.1%,1h
39548,3,MasterCpu,1757,868,37,48,85,43.5%,5m
39548,1,Dante,1757,168,4,5,9,44.4%,2h
39548,3,TEMPLARIUS,1757,32,2,0,2,100.0%,18m
39548,2,perez,1757,46,1,8,9,11.1%,1h
39548,1,[LLDN]Max,1757,0,0,1,1,0.0%,2h
39554,1,danyphanton,1756,1816,96,139,235,40.9%,2h
39554,3,Daddy,1756,30,4,6,10,40.0%,21m
39554,3,EddieKing,1756,13,4,14,18,22.2%,9m
39554,3,Shadow,1756,0,3,4,7,42.9%,37m
39554,1,Activistsnow,1756,0,1,10,11,9.1%,33m
39554,2,Alphaleader,1756,0,0,2,2,0.0%,52m
39560,1,GhOsTrYdEr,1755,302,10,16,26,38.5%,2h
39560,2,[EmberR]TwistedTemp,1755,132,3,2,5,60.0%,18m
39560,3,KentNizzy,1755,96,1,2,3,33.3%,19m
39563,1,ipconfigged,1754,1004,59,66,125,47.2%,28m
39563,3,asdaichunli,1754,540,18,38,56,32.1%,1h
39563,1,LokoRine,1754,353,11,15,26,42.3%,2h
39563,2,Wiracocha,1754,30,3,14,17,17.6%,23m
39563,3,Harkness,1754,0,0,1,1,0.0%,9m
39568,2,rddeathlord,1753,1099,45,57,102,44.1%,3h
39568,3,Marr,1753,0,0,1,1,0.0%,53m
39568,3,MENDEZ,1753,0,0,2,2,0.0%,58m
39568,3,Pushka,1753,0,0,7,7,0.0%,33m
39572,1,Crock,1752,1273,39,57,96,40.6%,3h
39572,3,[HTSS]Lucifer,1752,62,3,6,9,33.3%,17m
39572,2,Cocun,1752,106,3,12,15,20.0%,50m
39572,1,[nieBla]JECS,1752,0,1,4,5,20.0%,1h
39572,3,KRAMPHUS,1752,0,0,9,9,0.0%,3h
39577,1,Slyfer,1751,324,10,8,18,55.6%,5m
39577,2,rams,1751,198,7,11,18,38.9%,1h
39577,1,SWAG,1751,94,3,14,17,17.6%,3h
39577,3,Happynec,1751,30,1,8,9,11.1%,1h
39577,1,[DDSC]giocastilla,1751,0,0,5,5,0.0%,1h
39582,2,[Apixel]gabriel,1750,360,13,24,37,35.1%,56m
39582,3,BlacKobs,1750,297,8,25,33,24.2%,1h
39582,1,PINOCHET,1750,0,1,0,1,100.0%,2h
39582,1,rip,1750,0,1,4,5,20.0%,2h
39586,1,GIBED,1749,220,5,6,11,45.5%,2h
39586,3,Redx,1749,86,2,6,8,25.0%,17m
39588,1,Prolochs,1748,1045,30,40,70,42.9%,29m
39588,1,DarkKnight,1748,466,16,29,45,35.6%,24m
39588,1,Demonesa,1748,426,11,24,35,31.4%,1h
39588,3,[UndrCr]Beagle,1748,216,7,15,22,31.8%,3h
39588,1,BeerAndSC,1748,135,4,3,7,57.1%,5m
39588,3,Aubzstein,1748,0,2,6,8,25.0%,1h
39588,2,CAPTnCRUNCH,1748,30,1,9,10,10.0%,2h
39588,3,SaintReagan,1748,0,0,1,1,0.0%,53m
39596,2,Baphomet,1747,485,19,35,54,35.2%,8m
39596,3,Vagha,1747,306,11,16,27,40.7%,10m
39596,3,LOTAR,1747,313,11,20,31,35.5%,46m
39596,1,SergioXd,1747,372,9,11,20,45.0%,2h
39596,1,GGamrrage,1747,130,3,7,10,30.0%,25m
39596,2,stricker,1747,128,3,14,17,17.6%,23m
39596,3,Max,1747,139,3,14,17,17.6%,1h
39596,3,ZAOLOTSUDACA,1747,0,1,2,3,33.3%,1m
39596,3,hiddenpylon,1747,0,1,5,6,16.7%,53m
39596,3,Alcey,1747,0,0,5,5,0.0%,3h
39606,3,killem,1746,154,7,6,13,53.8%,17m
39606,1,darkgus,1746,176,4,3,7,57.1%,3h
39606,2,RAUL,1746,136,3,1,4,75.0%,9m
39606,3,[3TT]Rhadamanthys,1746,96,3,7,10,30.0%,59m
39606,1,[aIien]Kit,1746,40,2,2,4,50.0%,1h
39606,1,Airness,1746,0,0,6,6,0.0%,1h
39612,1,Pure,1745,1137,30,36,66,45.5%,1h
39612,1,OnEKinG,1745,878,24,34,58,41.4%,1h
39612,1,itzbrant,1745,138,4,5,9,44.4%,60m
39612,1,Dan,1745,0,2,4,6,33.3%,36m
39612,3,Dave,1745,30,2,8,10,20.0%,10m
39617,3,Petamai,1744,776,35,40,75,46.7%,3h
39617,2,Harmless,1744,0,0,1,1,0.0%,1h
39617,3,LuisO,1744,0,0,1,1,0.0%,1h
39617,3,jnpascua,1744,0,0,2,2,0.0%,3h
39621,3,Kindamoist,1743,156,3,11,14,21.4%,1h
39621,3,Impey,1743,0,0,8,8,0.0%,21m
39623,1,DimeAvellan,1742,264,7,7,14,50.0%,2h
39623,1,[NNKZ]False,1742,0,0,1,1,0.0%,1h
39625,3,SuperKamiG,1741,36,3,6,9,33.3%,51m
39625,3,Michy,1741,88,3,16,19,15.8%,2h
39625,3,Nusenthea,1741,0,0,1,1,0.0%,51m
39628,3,freddyman,1740,1479,100,121,221,45.2%,58m
39629,3,Hexanoic,1739,278,9,21,30,30.0%,7m
39630,3,Bethuka,1738,316,10,14,24,41.7%,1h
39630,3,Zug,1738,30,1,8,9,11.1%,2h
39632,1,Team,1737,406,10,22,32,31.2%,5m
39632,1,PeePoo,1737,236,6,4,10,60.0%,5m
39632,1,zea,1737,0,4,1,5,80.0%,47m
39632,3,LeeroyJonson,1737,30,2,6,8,25.0%,13m
39632,1,SSSS,1737,0,0,4,4,0.0%,3h
39632,2,linkborg,1737,0,0,5,5,0.0%,52m
39638,1,Sebastian,1736,1456,66,83,149,44.3%,16m
39638,1,AwesomeOne,1736,172,4,15,19,21.1%,2h
39638,2,BESTERMAN,1736,130,3,15,18,16.7%,2h
39638,1,innovenision,1736,73,2,7,9,22.2%,1h
39642,1,JOHNSNOWED,1735,441,19,19,38,50.0%,1h
39642,1,DiegoRZ,1735,410,11,17,28,39.3%,3h
39642,1,Lazarus,1735,46,1,4,5,20.0%,40m
39642,3,BOA,1735,0,0,1,1,0.0%,1m
39642,3,Soij,1735,0,0,8,8,0.0%,51m
39647,3,Eduardo,1734,282,11,23,34,32.4%,7m
39647,2,RekkeR,1734,0,1,11,12,8.3%,1h
39647,3,Ross,1734,0,0,1,1,0.0%,2h
39650,1,Joradrivia,1733,90,2,5,7,28.6%,2h
39650,1,Zexonith,1733,46,1,5,6,16.7%,24m
39650,2,HentaiLegend,1733,0,0,10,10,0.0%,2m
39653,1,Pdtroia,1732,314,8,4,12,66.7%,2h
39653,1,[aisg]Temperau,1732,252,7,6,13,53.8%,20m
39653,2,[xXGDXx]rex,1732,0,0,9,9,0.0%,15m
39656,1,FireInTheSky,1731,716,30,39,69,43.5%,31m
39656,1,CookieJars,1731,523,17,27,44,38.6%,3h
39656,1,fmartink,1731,46,2,4,6,33.3%,3h
39659,2,Umm,1730,433,14,30,44,31.8%,56m
39659,3,NoPulse,1730,0,0,1,1,0.0%,3h
39661,1,COLT,1729,892,22,30,52,42.3%,14m
39661,1,Echo,1729,212,6,9,15,40.0%,11m
39661,1,rohirrim,1729,0,2,4,6,33.3%,48m
39661,1,ThatPZT,1729,0,2,4,6,33.3%,46m
39661,1,[KUKA]NekoUchiha,1729,0,0,1,1,0.0%,1h
39666,3,zeroskill,1728,0,1,0,1,100.0%,1m
39666,3,[cluez]JesúsdeNasrt,1728,30,1,7,8,12.5%,37m
39666,1,jefe,1728,0,0,1,1,0.0%,24m
39666,1,neisaf,1728,0,0,6,6,0.0%,2h
39670,1,ILOVEYOUALL,1727,626,17,20,37,45.9%,3h
39670,3,SETHY,1727,0,1,1,2,50.0%,2h
39670,1,Frank,1727,88,1,6,7,14.3%,2h
39673,1,[LSDEX6]Naughty,1726,518,23,18,41,56.1%,5m
39673,1,[DROM]Espectro,1726,246,7,11,18,38.9%,2h
39673,1,Heffy,1726,44,2,1,3,66.7%,14m
39673,3,Zex,1726,40,2,5,7,28.6%,29m
39677,3,[CooL10]lemonsfly,1725,1530,65,82,147,44.2%,1h
39677,3,Einzlander,1725,618,21,32,53,39.6%,57m
39677,1,ElihuDeP,1725,510,18,33,51,35.3%,2h
39677,1,BeyondBlank,1725,421,10,7,17,58.8%,2h
39677,3,FrozenPhreak,1725,180,6,28,34,17.6%,3h
39677,2,Verds,1725,144,4,1,5,80.0%,1h
39677,1,RepliedHydra,1725,46,2,14,16,12.5%,2h
39684,1,TwEeKs,1724,0,0,2,2,0.0%,3h
39685,1,Zaro,1723,766,31,38,69,44.9%,3h
39685,1,skimbo,1723,262,6,13,19,31.6%,3h
39685,3,[TPGZ]JakTheRipper,1723,0,4,4,8,50.0%,21m
39685,3,superior,1723,125,4,8,12,33.3%,49m
39685,1,Zam,1723,86,2,5,7,28.6%,14m
39685,1,Flou,1723,117,1,8,9,11.1%,2h
39691,2,cmillie,1722,240,10,19,29,34.5%,53m
39691,1,bombbomb,1722,42,1,5,6,16.7%,25m
39691,1,Legobeanz,1722,0,1,12,13,7.7%,3h
39691,1,[Zil]blanket,1722,73,0,3,3,0.0%,3h
39695,1,DipnDotz,1721,445,14,24,38,36.8%,3h
39696,1,cptmorgan,1720,462,13,16,29,44.8%,2h
39697,3,danteTHEfox,1719,813,82,92,174,47.1%,6m
39697,1,[CARIO]CariocoKille,1719,281,11,23,34,32.4%,1h
39697,1,[TMCP]Xavy,1719,0,1,14,15,6.7%,54m
39700,1,SuperCool,1718,1072,28,46,74,37.8%,11m
39700,1,Fergersen,1718,636,18,11,29,62.1%,3h
39700,1,daveruski,1718,210,7,16,23,30.4%,1h
39700,3,Letholdus,1718,30,2,7,9,22.2%,1h
39700,2,LuCheCoCo,1718,0,2,9,11,18.2%,1h
39705,1,buluseo,1717,0,1,3,4,25.0%,3h
39706,1,[foxsay]Fantasy,1716,135,5,3,8,62.5%,16m
39706,2,TatoJenkins,1716,88,2,12,14,14.3%,49m
39708,2,puroano,1715,266,10,12,22,45.5%,3h
39708,3,gerarfa,1715,0,1,1,2,50.0%,3h
39708,3,iSpiGaO,1715,0,0,2,2,0.0%,23m
39711,2,James,1714,534,20,30,50,40.0%,2h
39711,1,MiniNinja,1714,94,3,1,4,75.0%,3m
39713,3,ASCII,1713,0,1,0,1,100.0%,1h
39713,1,Alukard,1713,0,0,1,1,0.0%,2h
39715,1,[DBS999]Winterstein,1712,386,11,14,25,44.0%,20m
39715,3,IIIIIIIIIIII,1712,231,8,11,19,42.1%,2h
39715,1,aito,1712,270,6,21,27,22.2%,1h
39715,1,CucaraChaCha,1712,46,2,4,6,33.3%,3h
39715,1,Skryp,1712,86,2,10,12,16.7%,2h
39715,2,ADAM,1712,60,2,12,14,14.3%,3h
39721,3,[DRKDMN]bangranjait,1711,108,5,10,15,33.3%,2h
39721,3,Radamantis,1711,0,1,0,1,100.0%,53m
39721,1,Milkman,1711,0,1,4,5,20.0%,3h
39721,3,diamond,1711,0,0,2,2,0.0%,53m
39721,2,Monkeyking,1711,0,0,9,9,0.0%,1h
39726,3,[DriveC]Ster,1709,1414,70,94,164,42.7%,53m
39726,3,phrOdiE,1709,263,8,15,23,34.8%,2h
39726,3,dave,1709,0,1,4,5,20.0%,3m
39729,1,marduk,1708,216,6,17,23,26.1%,3h
39729,1,Xivi,1708,131,2,7,9,22.2%,2h
39729,3,ramen,1708,30,2,14,16,12.5%,26m
39729,1,Elius,1708,0,0,2,2,0.0%,2h
39729,1,Drawer,1708,0,0,3,3,0.0%,1h
39734,3,Juddthejuice,1707,898,65,75,140,46.4%,2h
39734,2,Armageddon,1707,146,5,10,15,33.3%,51m
39734,1,Aero,1707,176,4,8,12,33.3%,24m
39734,3,[QCSC]Molly,1707,0,1,3,4,25.0%,8m
39734,3,[KANGS]Methol,1707,0,0,8,8,0.0%,9m
39739,1,hyperia,1706,1669,78,112,190,41.1%,2h
39739,2,Conner,1706,252,11,19,30,36.7%,40m
39739,1,[ProA]IIIIIIIIIIII,1706,136,3,3,6,50.0%,20m
39739,3,Martron,1706,46,1,6,7,14.3%,1h
39743,3,Shield,1705,425,13,32,45,28.9%,1h
39743,3,Ever,1705,62,4,6,10,40.0%,3m
39745,3,KOchaotix,1704,342,11,14,25,44.0%,3m
39745,1,Ravyyn,1704,113,3,6,9,33.3%,2h
39745,3,soulgamer,1704,0,1,2,3,33.3%,8m
39748,3,MataDioses,1703,470,16,30,46,34.8%,2h
39748,1,FoxDARK,1703,402,11,8,19,57.9%,1h
39748,1,Strauss,1703,318,11,22,33,33.3%,1h
39748,3,fredoren,1703,0,0,1,1,0.0%,59m
39748,3,Jake,1703,0,0,3,3,0.0%,45m
39753,1,JackOLantern,1702,263,13,21,34,38.2%,28m
39753,1,tupacamaruII,1702,326,9,21,30,30.0%,3h
39753,1,ZipMaiFlai,1702,204,5,7,12,41.7%,1h
39753,1,AresVico,1702,46,2,1,3,66.7%,3h
39753,3,Altrius,1702,0,1,0,1,100.0%,17m
39758,3,AAAAAHH,1701,902,31,59,90,34.4%,3h
39758,3,WaterAtTwoAM,1701,0,1,4,5,20.0%,2h
39760,1,hiro,1700,588,17,17,34,50.0%,20m
39760,1,silverwolf,1700,234,8,14,22,36.4%,1h
39760,3,darkzirux,1700,90,4,18,22,18.2%,42m
39760,1,SamuraiJack,1700,0,1,4,5,20.0%,1h
39760,3,Sam,1700,0,0,5,5,0.0%,23m
39765,2,[Bommmm]efra,1699,0,1,5,6,16.7%,1h
39765,1,PermaNoob,1699,0,0,1,1,0.0%,3h
39765,1,HumptyDumpty,1699,0,0,1,1,0.0%,3m
39768,3,ColdSweat,1698,1438,122,160,282,43.3%,48m
39768,3,jubileu,1698,424,14,31,45,31.1%,48m
39768,3,Behbehbear,1698,62,4,15,19,21.1%,57m
39768,2,oscar,1698,0,0,1,1,0.0%,40m
39768,1,Chaos,1698,0,0,5,5,0.0%,1h
39773,1,Vataria,1697,998,27,32,59,45.8%,1h
39773,1,TheQuailman,1697,716,25,46,71,35.2%,49m
39773,2,Arahgon,1697,378,14,38,52,26.9%,2h
39773,2,Seedling,1697,158,4,15,19,21.1%,3h
39777,3,VoicedNose,1696,0,0,1,1,0.0%,45m
39778,3,UncleTtwo,1695,190,6,21,27,22.2%,17m
39778,1,Fronkinstean,1695,90,3,3,6,50.0%,2h
39778,1,ZeratuL,1695,142,3,21,24,12.5%,2h
39778,1,[Wonger]Adam,1695,0,1,0,1,100.0%,3h
39778,3,BOOOO,1695,0,0,8,8,0.0%,18m
39778,3,TIM,1695,0,0,8,8,0.0%,1h
39784,1,eleegom,1694,108,5,4,9,55.6%,2h
39784,3,ELGGNOMAS,1694,0,3,5,8,37.5%,1h
39786,1,gunbelch,1693,1452,44,61,105,41.9%,3h
39786,1,Cawffee,1693,220,6,10,16,37.5%,2h
39786,2,[FalPal]Gogofresh,1693,46,1,2,3,33.3%,33m
39786,1,Ando,1693,0,0,2,2,0.0%,1h
39790,1,GATO,1692,136,4,5,9,44.4%,46m
39790,1,Zapletal,1692,88,4,5,9,44.4%,2h
39792,1,[Over1]nikolo,1691,606,15,22,37,40.5%,36m
39792,1,[MMSTAR]tommyrod,1691,419,9,12,21,42.9%,1h
39792,1,Celta,1691,36,1,5,6,16.7%,2h
39795,2,iash,1690,701,154,191,345,44.6%,50m
39795,1,Lebowski,1690,1893,75,106,181,41.4%,1h
39795,3,[HYGame]Harster,1690,509,18,29,47,38.3%,20m
39795,2,mazoluminozo,1690,184,11,10,21,52.4%,2h
39795,3,Emiko,1690,0,0,3,3,0.0%,53m
39795,2,kerigian,1690,0,0,6,6,0.0%,2h
39801,3,kor,1688,148,4,10,14,28.6%,2h
39802,1,[TPGGXD]phoenix,1687,922,25,39,64,39.1%,40m
39802,3,rex,1687,30,1,8,9,11.1%,2h
39804,1,Dinamicy,1686,1138,36,53,89,40.4%,3h
39804,2,dildopuncher,1686,0,3,6,9,33.3%,16m
39804,1,Rooster,1686,0,2,3,5,40.0%,25m
39804,1,JoeyS,1686,0,1,2,3,33.3%,14m
39804,3,Maar,1686,0,0,2,2,0.0%,29m
39809,1,[EMV]Dizzy,1685,448,10,9,19,52.6%,2h
39810,3,sTrAnGeBiRd,1684,157,4,8,12,33.3%,19m
39811,3,Gabo,1683,1382,76,116,192,39.6%,53m
39811,1,TheDova,1683,270,10,16,26,38.5%,3h
39811,1,coolcool,1683,214,5,13,18,27.8%,3h
39811,3,crazycat,1683,30,2,5,7,28.6%,3h
39811,3,Horizons,1683,0,0,1,1,0.0%,29m
39816,1,TheLastSith,1682,660,22,27,49,44.9%,28m
39816,3,PavlovsBelle,1682,92,3,10,13,23.1%,51m
39816,1,TripleAA,1682,0,0,2,2,0.0%,1h
39819,2,[BRGAME]BolsoTrump,1681,152,6,17,23,26.1%,3h
39819,1,FazoC,1681,120,3,9,12,25.0%,2h
39819,1,mAiNsTreAm,1681,0,0,1,1,0.0%,60m
39822,2,end,1680,118,4,14,18,22.2%,2h
39823,1,GoldenPants,1679,346,8,17,25,32.0%,1h
39823,1,[HOT69]UmessUdead,1679,127,3,4,7,42.9%,60m
39823,3,Rokxbot,1679,30,2,1,3,66.7%,29m
39823,3,WAUWANT,1679,125,2,9,11,18.2%,1h
39827,3,RAFFAST,1678,191,7,10,17,41.2%,1h
39827,1,baltex,1678,73,0,3,3,0.0%,2h
39829,1,tortugavil,1677,1191,58,73,131,44.3%,24m
39829,1,David,1677,254,6,12,18,33.3%,1h
39829,3,sharkslayer,1677,0,3,4,7,42.9%,2h
39829,3,Elizooky,1677,58,2,1,3,66.7%,17m
39833,3,yAGO,1676,126,4,10,14,28.6%,3h
39833,2,kri,1676,88,2,13,15,13.3%,1h
39833,1,Kirvo,1676,103,1,11,12,8.3%,2h
39833,2,yerdad,1676,44,1,12,13,7.7%,2h
39837,1,ciberninja,1675,92,2,9,11,18.2%,36m
39837,3,Snarfdoobly,1675,0,0,4,4,0.0%,59m
39839,3,ProctorOak,1674,30,1,2,3,33.3%,9m
39840,3,Carrijo,1673,206,10,4,14,71.4%,59m
39840,2,KSIMS,1673,156,4,13,17,23.5%,1h
39840,1,OBIONE,1673,86,3,1,4,75.0%,2h
39843,1,YNO,1672,268,8,10,18,44.4%,11m
39844,3,YOURMOM,1671,0,0,5,5,0.0%,3h
39845,3,ThreliSand,1670,442,14,23,37,37.8%,20m
39845,3,kfurmkos,1670,240,9,19,28,32.1%,1h
39845,1,[FCTR]Dokkisse,1670,293,8,14,22,36.4%,2h
39845,1,TrueMrE,1670,222,5,7,12,41.7%,11m
39845,1,Smoon,1670,73,0,2,2,0.0%,1h
39845,3,LNandez,1670,0,0,8,8,0.0%,1h
39851,2,Sakibpagla,1669,425,27,57,84,32.1%,32m
39851,2,David,1669,128,4,14,18,22.2%,3h
39851,1,BigdipNibs,1669,0,1,1,2,50.0%,24m
39851,1,lllllllllll,1669,0,0,5,5,0.0%,2h
39855,3,ZERGMAN,1668,96,1,4,5,20.0%,29m
39855,3,Krezcent,1668,0,0,2,2,0.0%,59m
39857,1,Dantor,1667,309,14,18,32,43.8%,3h
39857,3,kofekt,1667,0,2,2,4,50.0%,1h
39857,3,marvin,1667,0,1,1,2,50.0%,3h
39857,2,maseroan,1667,30,1,13,14,7.1%,23m
39861,1,Alphareaver,1666,494,13,18,31,41.9%,2h
39861,1,Miunick,1666,124,6,5,11,54.5%,3h
39863,1,Edgar,1665,381,10,20,30,33.3%,1h
39863,1,[ZTemps]IIIIIIIIIIII,1665,237,6,3,9,66.7%,2h
39863,1,Alamo,1665,0,3,3,6,50.0%,2h
39866,1,ElGreñas,1664,313,8,22,30,26.7%,2h
39866,1,Chupacabras,1664,270,6,7,13,46.2%,24m
39866,1,Fernando,1664,149,5,8,13,38.5%,3h
39866,1,ImmaFlexHo,1664,46,1,2,3,33.3%,2h
39870,1,BENJAMIN,1663,131,2,15,17,11.8%,2h
39871,3,zurdo,1662,1047,36,53,89,40.4%,20m
39871,1,Gini,1662,465,16,16,32,50.0%,3h
39871,1,Bob,1662,546,15,20,35,42.9%,46m
39874,1,[DMONlC]jhjhggj,1661,38,1,5,6,16.7%,3m
39875,3,DarthZeran,1660,1389,53,92,145,36.6%,40m
39875,1,THZRodCoco,1660,677,21,21,42,50.0%,2h
39875,1,DonkeyFace,1660,602,18,13,31,58.1%,2h
39875,2,SharpKnife,1660,202,7,21,28,25.0%,2h
39879,3,Bumcrust,1659,609,19,33,52,36.5%,23m
39880,1,Intrasync,1658,187,3,16,19,15.8%,2h
39880,2,PtZaDstroyr,1658,88,1,11,12,8.3%,2h
39880,1,MeBadNoMad,1658,0,0,5,5,0.0%,28m
39883,1,DrackonHntr,1657,414,14,20,34,41.2%,25m
39883,1,GoldenGoose,1657,0,1,0,1,100.0%,3h
39883,1,PraetorianB,1657,38,1,2,3,33.3%,14m
39883,3,ken,1657,0,0,1,1,0.0%,1h
39883,1,[TCJN]SneezyDwarf,1657,0,0,1,1,0.0%,20m
39888,2,Hanupod,1656,129,3,3,6,50.0%,2h
39889,1,[COLNSR]AndresRosas,1655,516,14,17,31,45.2%,3m
39889,1,TERRACOTA,1655,347,12,12,24,50.0%,36m
39889,1,trevas,1655,418,10,8,18,55.6%,2h
39889,1,RebelRedgard,1655,0,1,1,2,50.0%,2h
39889,3,shemsho,1655,0,0,1,1,0.0%,29m
39894,1,cirno,1654,709,24,37,61,39.3%,1h
39894,2,JINTVBot,1654,130,4,15,19,21.1%,24m
39894,1,Mosko,1654,0,3,6,9,33.3%,2h
39897,1,IIIIIIIIIIII,1653,605,15,16,31,48.4%,2h
39897,1,[dait]Impulseonpc,1653,517,12,10,22,54.5%,2h
39897,1,limberg,1653,150,2,8,10,20.0%,2h
39900,1,Angkorian,1652,705,20,26,46,43.5%,2h
39900,1,Edy,1652,134,3,4,7,42.9%,2h
39900,1,FallenAngel,1652,38,1,2,3,33.3%,2h
39903,1,Bigboogy,1651,172,4,18,22,18.2%,2h
39903,1,oldtown,1651,142,3,7,10,30.0%,2h
39903,1,Brandon,1651,88,1,2,3,33.3%,1h
39906,3,Desolate,1650,1342,201,238,439,45.8%,10m
39906,1,[SANGRE]bichox,1650,0,1,1,2,50.0%,3h
39906,1,[raener]theswarm,1650,103,1,10,11,9.1%,1h
39906,3,HonorGuideMe,1650,0,0,5,5,0.0%,8m
39910,1,SnakeEyes,1649,591,16,23,39,41.0%,46m
39910,3,[Bommmm]Freddykawai,1649,88,3,11,14,21.4%,60m
39910,2,batlecruiser,1649,67,1,1,2,50.0%,52m
39913,3,FlamingLava,1648,0,0,4,4,0.0%,8m
39914,1,Saherron,1647,0,0,7,7,0.0%,29m
39915,1,hokagesiete,1646,854,21,29,50,42.0%,2h
39915,3,Lazzoni,1646,233,8,11,19,42.1%,3h
39915,1,[zNRCz]watcheR,1646,172,5,0,5,100.0%,1h
39918,1,SrSebtvicet,1645,224,8,3,11,72.7%,3h
39918,1,noles,1645,95,1,4,5,20.0%,3h
39918,3,IIllllIIIllI,1645,0,0,1,1,0.0%,9m
39921,1,peppercorn,1644,261,11,10,21,52.4%,44m
39922,2,EriktheRed,1643,309,11,18,29,37.9%,55m
39922,3,shrillimpala,1643,0,2,2,4,50.0%,29m
39922,3,Cakeboss,1643,60,2,7,9,22.2%,1h
39922,1,MechEng,1643,0,0,4,4,0.0%,1h
39926,1,goku,1642,105,1,13,14,7.1%,2h
39927,3,battleborn,1641,0,0,1,1,0.0%,29m
39927,1,[Naif]IcyMaple,1641,73,0,2,2,0.0%,2h
39929,2,[MORGUE]Ajindo,1640,230,250,304,554,45.1%,3m
39930,3,[BEEDS]rmattingly,1639,30,2,16,18,11.1%,2h
39930,1,master,1639,0,1,0,1,100.0%,46m
39930,3,Azzurri,1639,0,1,8,9,11.1%,58m
39933,1,Denariihodl,1638,1389,87,100,187,46.5%,24m
39933,2,TehEpikDuck,1638,300,10,19,29,34.5%,1h
39933,1,Tassadar,1638,198,5,12,17,29.4%,2h
39933,1,LipsOfDad,1638,118,3,21,24,12.5%,28m
39933,3,vvv,1638,30,2,0,2,100.0%,1h
39933,1,[LY0]ALEX,1638,0,0,1,1,0.0%,2h
39939,1,tecomatador,1637,1364,40,59,99,40.4%,3h
39939,1,Eldar,1637,524,16,16,32,50.0%,2h
39939,1,[028]daviobg,1637,0,0,4,4,0.0%,2h
39939,2,Harold,1637,0,0,13,13,0.0%,9m
39943,1,SwarmN,1636,86,2,4,6,33.3%,3h
39944,1,Exilus,1635,723,20,29,49,40.8%,1h
39945,1,MingDi,1634,307,11,17,28,39.3%,11m
39946,3,joemer,1633,123,2,13,15,13.3%,2h
39947,1,Vince,1632,1435,43,52,95,45.3%,11m
39947,1,killwithfear,1632,0,0,1,1,0.0%,2h
39949,2,HORUS,1631,273,7,32,39,17.9%,2h
39950,2,[MPC]PMSCHICK,1630,1269,590,829,1419,41.6%,1h
39950,1,GpainSwag,1630,219,7,8,15,46.7%,60m
39950,3,Adam,1630,0,0,1,1,0.0%,18m
39950,1,DARKLORD,1630,73,0,8,8,0.0%,2h
39954,1,Destroyer,1629,188,4,16,20,20.0%,1h
39954,1,Samuraiblue,1629,0,1,3,4,25.0%,3m
39956,1,atomgrist,1628,92,2,6,8,25.0%,2h
39956,1,Noom,1628,0,0,5,5,0.0%,2h
39958,3,Goldenpearl,1627,230,7,15,22,31.8%,60m
39958,1,Qbear,1627,88,2,0,2,100.0%,43m
39958,1,[Fever]Gloriserve,1627,44,2,5,7,28.6%,28m
39961,1,pelado,1626,412,10,11,21,47.6%,3h
39961,1,[RogueW]PookieWon,1626,269,6,9,15,40.0%,2h
39961,3,ELKANEL,1626,58,2,4,6,33.3%,17m
39961,2,Wyvrn,1626,88,1,5,6,16.7%,2h
39965,2,Vicky,1625,0,1,1,2,50.0%,2h
39965,3,Daniel,1625,30,1,10,11,9.1%,23m
39967,2,[DETER]Low,1624,306,9,28,37,24.3%,1h
39967,3,Eragon,1624,266,8,22,30,26.7%,60m
39967,1,ImperialWGmr,1624,143,4,6,10,40.0%,2h
39967,1,NocJar,1624,0,0,6,6,0.0%,2h
39967,3,jhudihangel,1624,0,0,8,8,0.0%,3h
39967,3,EvOLaIIViruS,1624,0,0,9,9,0.0%,58m
39973,1,VenomTerror,1623,0,0,1,1,0.0%,1h
39973,2,Warlax,1623,0,0,4,4,0.0%,3h
39973,1,Slayer,1623,73,0,6,6,0.0%,2h
39976,3,Antifa,1622,533,54,86,140,38.6%,47m
39977,1,SPARKIIE,1621,1159,38,57,95,40.0%,2h
39977,2,[LeDoge]Tahshaw,1621,540,16,34,50,32.0%,1h
39977,1,Rheumason,1621,0,0,1,1,0.0%,2h
39977,2,DireRaven,1621,0,0,10,10,0.0%,2h
39981,1,TemplarDT,1620,1824,57,85,142,40.1%,3h
39981,1,Supa,1620,278,10,8,18,55.6%,16m
39981,1,TonySlark,1620,222,9,9,18,50.0%,3h
39984,3,mkpcksbich,1619,227,6,17,23,26.1%,25m
39984,1,[DarkPG]Ignaciocapo,1619,200,4,5,9,44.4%,3h
39984,3,[HGLORD]Pochahontis,1619,92,3,13,16,18.8%,8m
39984,1,FancyDancer,1619,0,0,2,2,0.0%,54m
39988,1,Franklin,1618,1034,29,59,88,33.0%,15m
39988,1,Penumbera,1618,401,12,21,33,36.4%,44m
39988,1,Hunter,1618,73,2,9,11,18.2%,1h
39988,3,domdotdoom,1618,0,0,1,1,0.0%,29m
39992,1,crepygamer,1617,326,12,10,22,54.5%,2h
39992,1,swederik,1617,220,6,8,14,42.9%,2h
39992,1,[waRp1]EDUKT,1617,106,2,3,5,40.0%,46m
39995,1,[Psluts]ThunderPuss,1616,767,25,35,60,41.7%,25m
39995,1,yaratilin,1616,0,1,1,2,50.0%,5m
39997,3,TheCtrl,1614,0,1,7,8,12.5%,3m
39998,1,ELCHAMAN,1613,694,20,22,42,47.6%,1h
39999,1,andree,1612,371,11,17,28,39.3%,3h
39999,3,tzeyuan,1612,134,6,14,20,30.0%,3m
39999,1,mikinot,1612,240,6,19,25,24.0%,14m
39999,2,[FltBat]JOEY,1612,66,5,10,15,33.3%,40m
40003,3,FABRICRAK,1611,164,5,13,18,27.8%,1m
40003,1,[Bommmm]Benjamin,1611,90,2,5,7,28.6%,2h
40003,3,[Nat20s]MarionBlyth,1611,0,0,9,9,0.0%,59m
40006,2,javier,1610,158,6,15,21,28.6%,42m
40006,1,NENE,1610,134,3,8,11,27.3%,2h
40006,1,MAQUIAVEL,1610,114,2,6,8,25.0%,1h
40006,1,skizzll,1610,0,0,1,1,0.0%,2h
40010,1,BnLaKaY,1609,494,16,30,46,34.8%,1h
40010,3,Akari,1609,0,0,3,3,0.0%,9m
40012,1,baron,1608,353,11,14,25,44.0%,2h
40012,3,BoydCustom,1608,0,1,9,10,10.0%,1h
40012,1,GirthyBenis,1608,0,0,6,6,0.0%,2h
40015,2,[VFam2]SneakyPanda,1607,38,1,2,3,33.3%,2h
40016,1,scotton,1606,1458,97,119,216,44.9%,28m
40016,2,chez,1606,0,0,1,1,0.0%,19m
40018,1,MASTERHSM,1605,208,5,8,13,38.5%,2h
40018,2,RobPaulson,1605,68,2,2,4,50.0%,44m
40018,3,Agujaman,1605,0,0,1,1,0.0%,8m
40018,3,oweneljisus,1605,0,0,3,3,0.0%,8m
40022,1,henry,1604,912,27,50,77,35.1%,1h
40022,1,[SalvA]geo,1604,0,0,2,2,0.0%,3h
40022,3,[KhanZ]terran,1604,0,0,2,2,0.0%,2h
40025,1,JScar,1603,44,2,4,6,33.3%,1h
40025,1,Studzman,1603,90,2,9,11,18.2%,2h
40025,1,Cuchito,1603,0,1,1,2,50.0%,3h
40025,3,spike,1603,0,1,1,2,50.0%,9m
40029,1,barcode,1602,187,4,9,13,30.8%,2h
40029,1,battlepants,1602,48,2,17,19,10.5%,2h
40031,2,mct,1601,30,1,11,12,8.3%,3m
40031,3,CMDRSnack,1601,0,0,2,2,0.0%,54m
40031,2,goofy,1601,0,0,3,3,0.0%,9m
40034,1,TMJAMES,1600,820,28,50,78,35.9%,1h
40034,2,Legacyplays,1600,48,1,13,14,7.1%,2h
40036,1,SALZEE,1599,179,3,8,11,27.3%,1h
40037,2,atlbraves,1598,123,5,7,12,41.7%,2h
40038,1,Tarik,1597,194,8,8,16,50.0%,28m
40038,1,JKaido,1597,113,2,2,4,50.0%,29m
40038,2,rumble,1597,131,2,15,17,11.8%,32m
40038,3,Roberto,1597,0,0,2,2,0.0%,18m
40042,1,CopeMayne,1595,550,22,26,48,45.8%,3h
40042,2,[DRKESP]Nitro,1595,504,17,21,38,44.7%,51m
40042,1,Dante,1595,258,9,25,34,26.5%,3h
40045,1,Doge,1594,351,12,12,24,50.0%,20m
40045,3,yeeeeeeeeee,1594,30,3,7,10,30.0%,1m
40047,1,INGRICHARD,1593,1098,31,40,71,43.7%,1h
40047,2,RIFB,1593,286,11,6,17,64.7%,1h
40047,2,David,1593,40,1,12,13,7.7%,9m
40050,1,[RnRFTP]FENDER,1592,490,11,21,32,34.4%,3m
40051,3,DrCheeks,1591,0,1,4,5,20.0%,30m
40052,1,Kernel,1590,791,34,49,83,41.0%,28m
40052,3,Pirézdeath,1590,206,8,24,32,25.0%,52m
40052,1,petitpoule,1590,178,4,8,12,33.3%,3h
40055,1,Ghost,1589,281,5,21,26,19.2%,16m
40055,2,alvaromalca,1589,98,3,5,8,37.5%,24m
40057,2,[YUCK]Bogey,1588,94,3,1,4,75.0%,2h
40058,1,kingofblades,1587,1003,31,37,68,45.6%,60m
40058,2,[xCGYx]HALYCONFIVE,1587,32,1,1,2,50.0%,52m
40060,1,hedykiesler,1586,424,16,17,33,48.5%,28m
40061,3,Brnl,1585,344,12,19,31,38.7%,49m
40061,1,NDubbz,1585,262,8,13,21,38.1%,15m
40061,1,Rookclaybard,1585,92,1,3,4,25.0%,28m
40061,3,fatsdabs,1585,0,1,4,5,20.0%,3m
40065,1,yonatan,1584,1132,30,61,91,33.0%,60m
40065,1,[ORUS]ancesur,1584,339,9,19,28,32.1%,3h
40065,2,cide,1584,42,2,5,7,28.6%,3h
40065,2,Duke,1584,30,1,12,13,7.7%,9m
40065,3,deathmage,1584,0,0,4,4,0.0%,54m
40070,3,JuanVicky,1583,0,0,4,4,0.0%,2h
40070,3,Eldritch,1583,0,0,5,5,0.0%,2h
40072,1,PaulSydney,1581,82,3,17,20,15.0%,1h
40073,1,fatgoblin,1580,44,1,3,4,25.0%,20m
40073,2,Bhaktivedant,1580,0,0,1,1,0.0%,2h
40075,3,eldermagic,1579,30,4,3,7,57.1%,9m
40075,2,Shuhac,1579,0,1,1,2,50.0%,3h
40077,3,Ubbah,1578,0,2,3,5,40.0%,2h
40078,2,sic,1577,680,23,29,52,44.2%,3h
40078,1,Greatheart,1577,417,13,21,34,38.2%,3h
40078,1,SkyG,1577,221,7,12,19,36.8%,43m
40078,2,ssotorp,1577,200,5,16,21,23.8%,50m
40082,2,LaBLaTTe,1575,0,0,11,11,0.0%,45m
40083,1,InsertNoob,1574,335,7,25,32,21.9%,2h
40084,2,otter,1573,140,3,16,19,15.8%,9m
40084,3,kerim,1573,76,2,10,12,16.7%,29m
40086,1,[GrnBrd]Neotholic,1572,983,32,46,78,41.0%,1h
40086,1,JKryptic,1572,180,4,14,18,22.2%,1h
40086,2,Desertdawg,1572,0,0,1,1,0.0%,53m
40089,3,ccc,1570,58,2,1,3,66.7%,23m
40089,3,Darthblaze,1570,0,0,6,6,0.0%,1h
40091,1,HaitianNinja,1569,494,13,25,38,34.2%,36m
40091,2,Pufferfish,1569,284,8,6,14,57.1%,44m
40091,1,wisthons,1569,122,4,8,12,33.3%,3h
40091,3,Nambi,1569,0,0,1,1,0.0%,2h
40091,3,Christmas,1569,0,0,4,4,0.0%,30m
40096,1,Masacre,1568,73,0,10,10,0.0%,3h
40097,1,CooCooClock,1567,423,15,21,36,41.7%,2h
40098,1,kennedyfried,1566,948,54,74,128,42.2%,14m
40098,1,erikthered,1566,93,1,6,7,14.3%,2h
40100,2,EDUARDO,1565,1416,87,145,232,37.5%,3h
40101,2,jambo,1564,362,11,27,38,28.9%,54m
40101,1,NahueKiller,1564,400,11,32,43,25.6%,2h
40101,3,ROGER,1564,161,4,23,27,14.8%,2h
40101,3,SILVER,1564,0,1,4,5,20.0%,3h
40105,2,LaChinche,1562,518,16,20,36,44.4%,52m
40106,3,NAbronzeACC,1561,0,0,6,6,0.0%,1h
40107,3,EMERSON,1560,76,2,4,6,33.3%,23m
40107,3,[GUARA1]InSaNiTyZz,1560,0,0,5,5,0.0%,3h
40109,2,Dzueba,1558,192,6,6,12,50.0%,9m
40110,2,MULE,1557,30,4,2,6,66.7%,3h
40110,2,[AlamoC]Major,1557,120,3,8,11,27.3%,2h
40110,3,salladboy,1557,70,3,8,11,27.3%,1m
40113,2,MurderChapel,1556,170,6,4,10,60.0%,1h
40114,2,Templar,1554,88,1,3,4,25.0%,45m
40115,1,hotjoetato,1552,614,22,29,51,43.1%,3h
40116,2,Snurffe,1551,0,1,4,5,20.0%,2h
40117,1,mongo,1550,84,3,19,22,13.6%,30m
40118,2,[DomFor]BMWMFLY,1549,264,7,11,18,38.9%,3h
40119,1,MikeRoss,1548,96,3,22,25,12.0%,1h
40119,1,MGX,1548,73,0,11,11,0.0%,2h
40121,3,Dankhole,1547,534,18,34,52,34.6%,3h
40121,3,szargeras,1547,0,1,7,8,12.5%,3m
40123,1,ZeroAPM,1546,0,0,9,9,0.0%,43m
40124,2,ToxicWaste,1545,0,0,2,2,0.0%,3h
40125,2,DarkAngel,1543,42,2,5,7,28.6%,1h
40125,3,Aubrey,1543,0,0,5,5,0.0%,51m
40127,2,Vash,1542,559,17,24,41,41.5%,23m
40127,3,[SGCC]ReaperGRiM,1542,62,2,15,17,11.8%,2h
40129,1,Ladvrain,1540,0,0,4,4,0.0%,3h
40130,2,EatRawFish,1539,96,3,3,6,50.0%,52m
40131,1,ReMaCHeZ,1538,1516,73,101,174,42.0%,28m
40131,3,Rediscool,1538,0,0,9,9,0.0%,1h
40133,3,Samael,1537,712,22,51,73,30.1%,23m
40133,1,[3pro5u]Andresaurio,1537,261,6,11,17,35.3%,1h
40133,1,Fenix,1537,106,3,6,9,33.3%,2h
40133,1,ChaseInvader,1537,119,1,13,14,7.1%,3h
40137,2,xavi,1536,0,1,4,5,20.0%,2h
40138,1,Gator,1535,238,8,26,34,23.5%,30m
40138,1,Chadbaby,1535,160,5,13,18,27.8%,30m
40138,3,vikinglore,1535,0,0,7,7,0.0%,8m
40138,1,StripTease,1535,0,0,9,9,0.0%,2h
40142,2,IIIIIIIIIII,1534,896,30,36,66,45.5%,1h
40143,2,Badger,1532,88,1,2,3,33.3%,53m
40143,1,swootton,1532,105,1,7,8,12.5%,48m
40145,1,BuhoFuerte,1531,1799,64,95,159,40.3%,40m
40146,1,BOoM,1530,155,2,13,15,13.3%,2h
40147,1,SumBu,1529,914,29,51,80,36.2%,3h
40147,2,Xayid,1529,114,4,2,6,66.7%,1h
40147,3,NOCHo,1529,30,1,5,6,16.7%,3h
40150,2,Walkinzxz,1528,0,3,11,14,21.4%,1h
40151,2,Gimya,1527,294,11,15,26,42.3%,1h
40151,1,Tyrant,1527,357,10,19,29,34.5%,2h
40151,2,Orozconeitor,1527,90,3,4,7,42.9%,2h
40151,2,Alex,1527,80,2,3,5,40.0%,2h
40155,2,kratoss,1526,478,16,35,51,31.4%,3h
40155,2,mariita,1526,190,6,8,14,42.9%,52m
40155,2,Duckier,1526,0,1,4,5,20.0%,2h
40158,2,ñañi,1525,162,4,9,13,30.8%,2h
40158,2,TheBiasPious,1525,44,2,7,9,22.2%,2h
40158,3,[iMkS]YeraldSC,1525,0,0,1,1,0.0%,1h
40161,2,samuel,1524,416,22,43,65,33.8%,1h
40162,3,[LoShay]efimera,1523,30,2,11,13,15.4%,3h
40162,1,asendedkerri,1523,97,1,5,6,16.7%,1h
40164,1,concon,1522,459,12,30,42,28.6%,3h
40165,3,KALDANIS,1521,0,1,1,2,50.0%,58m
40166,1,Taando,1520,378,12,22,34,35.3%,1h
40166,2,BigNoobL,1520,0,2,3,5,40.0%,2h
40168,1,gelato,1519,0,2,4,6,33.3%,2h
40169,1,bangzyomama,1518,576,18,29,47,38.3%,2h
40169,3,PureDragon,1518,110,5,11,16,31.2%,30m
40169,2,[LMI42]huenex,1518,0,0,1,1,0.0%,1h
40172,1,Reelople,1517,1525,38,88,126,30.2%,1h
40173,3,Skon,1516,0,0,11,11,0.0%,3h
40174,1,DataRobot,1514,450,15,42,57,26.3%,3h
40174,2,Serious,1514,0,0,5,5,0.0%,19m
40176,3,lightcloud,1512,30,1,3,4,25.0%,8m
40177,2,[TDRGN]Aramis,1511,64,2,1,3,66.7%,2h
40177,3,RoboPooper,1511,0,1,0,1,100.0%,59m
40179,2,LuCheCoCo,1510,90,4,2,6,66.7%,2h
40180,1,[GURKI]ProstiDude,1509,224,5,21,26,19.2%,2h
40180,2,skywaybtb,1509,0,2,4,6,33.3%,49m
40180,2,Jayjay,1509,0,0,1,1,0.0%,3h
40183,3,weed,1508,0,0,11,11,0.0%,1h
40184,2,Racu,1507,0,3,5,8,37.5%,2h
40184,2,RawStick,1507,42,1,11,12,8.3%,52m
40186,1,DaghoBrazil,1506,202,5,21,26,19.2%,1h
40187,2,Egoneronomo,1505,70,2,14,16,12.5%,3h
40187,3,Dsouza,1505,30,1,6,7,14.3%,9m
40189,1,BaMG,1504,1430,59,86,145,40.7%,3h
40190,1,Tristan,1503,410,12,23,35,34.3%,20m
40190,3,PizzaBob,1503,0,0,1,1,0.0%,54m
40192,2,Trujyaya,1502,0,0,1,1,0.0%,1h
40193,3,Genexiller,1501,30,1,13,14,7.1%,3h
40194,1,SafariJoe,1500,541,19,30,49,38.8%,1h
40194,1,EpicEric,1500,345,13,13,26,50.0%,47m
40196,1,erikxito,1499,204,6,24,30,20.0%,1h
40197,2,RKPalmerJr,1498,176,6,12,18,33.3%,24m
40198,3,nemesis,1497,30,3,5,8,37.5%,58m
40198,3,FrostBite,1497,0,1,2,3,33.3%,29m
40198,2,Melanie,1497,0,0,1,1,0.0%,33m
40201,1,[Pyroz]DARKMATTER,1496,474,18,21,39,46.2%,3h
40202,1,Psignosys,1495,38,1,9,10,10.0%,2h
40202,2,Kalior,1495,73,1,11,12,8.3%,2h
40202,2,Wraz,1495,46,1,15,16,6.2%,3h
40205,2,BAMBAM,1494,177,11,19,30,36.7%,19m
40205,1,Kradeno,1494,146,2,16,18,11.1%,2h
40207,2,MESSALA,1493,115,2,2,4,50.0%,32m
40208,2,Killercat,1491,396,12,15,27,44.4%,3h
40209,2,stephano,1490,190,9,22,31,29.0%,1h
40210,1,zele,1489,1191,40,119,159,25.2%,1h
40210,2,Arturus,1489,95,1,2,3,33.3%,2h
40212,2,[EZDUNK]IIIIIIIIIIII,1487,660,21,35,56,37.5%,54m
40213,1,necronomicon,1486,372,9,16,25,36.0%,3m
40213,1,MichaelMeyer,1486,159,4,20,24,16.7%,1h
40213,2,Artigy,1486,30,1,2,3,33.3%,1h
40213,2,Pinlight,1486,38,1,4,5,20.0%,2h
40217,3,RubberFangz,1485,0,0,6,6,0.0%,59m
40218,2,ricilon,1484,152,4,12,16,25.0%,2h
40218,3,TeddyBear,1484,0,0,4,4,0.0%,54m
40220,2,DKING,1483,0,0,5,5,0.0%,2h
40221,3,Diego,1481,144,3,23,26,11.5%,3h
40222,1,CmteKarma,1480,489,13,25,38,34.2%,2h
40222,2,PeenerPopper,1480,112,4,2,6,66.7%,2h
40224,3,Cusigma,1479,296,9,33,42,21.4%,1h
40224,3,BLUAY,1479,0,0,2,2,0.0%,3h
40226,3,fatfucck,1478,114,4,7,11,36.4%,1h
40226,2,BMG,1478,0,0,1,1,0.0%,2h
40228,2,ImSoBad,1477,0,0,5,5,0.0%,1h
40229,3,WhackMySack,1475,72,10,29,39,25.6%,53m
40230,2,adam,1474,88,2,1,3,66.7%,9m
40230,3,Velius,1474,0,1,7,8,12.5%,3m
40230,2,Darandomness,1474,0,0,5,5,0.0%,3h
40233,2,SpaceLemming,1471,99,1,2,3,33.3%,2h
40233,3,Matthew,1471,0,0,5,5,0.0%,59m
40235,2,[LETAL]javito,1470,0,0,12,12,0.0%,59m
40236,2,sectionist,1469,1538,59,84,143,41.3%,52m
40237,1,DigitalCrazy,1468,152,6,25,31,19.4%,3h
40237,3,Prowler,1468,66,3,8,11,27.3%,58m
40239,2,RAMCITO,1465,46,1,16,17,5.9%,56m
40239,2,silver,1465,0,0,3,3,0.0%,44m
40241,2,Lucia,1464,238,7,20,27,25.9%,49m
40242,2,JUKEIIEY,1462,220,6,2,8,75.0%,52m
40242,3,Alamuerte,1462,76,3,3,6,50.0%,29m
40242,2,LeetPuff,1462,36,1,6,7,14.3%,52m
40242,2,kenpokilla,1462,0,0,6,6,0.0%,45m
40246,1,Javert,1461,1085,36,67,103,35.0%,3m
40247,3,[KABOOM]DALMATiaN,1460,0,0,5,5,0.0%,59m
40248,2,[TONIC]susanoo,1456,121,3,2,5,60.0%,2h
40248,2,bomba,1456,0,1,1,2,50.0%,2h
40250,2,mineprox,1455,73,0,3,3,0.0%,45m
40251,2,Noctis,1454,0,1,8,9,11.1%,50m
40252,1,SonMatheus,1453,73,2,12,14,14.3%,3h
40252,3,Maxpowerz,1453,30,1,5,6,16.7%,58m
40254,2,xxaX,1450,468,18,21,39,46.2%,2h
40254,3,Ranchu,1450,0,0,3,3,0.0%,2h
40256,3,[Lp]LpxZLoboZx,1448,0,0,1,1,0.0%,18m
40257,1,evertdan,1445,899,26,49,75,34.7%,2h
40257,2,Juloowewoo,1445,0,0,6,6,0.0%,2h
40259,2,DarkAngel,1442,76,2,11,13,15.4%,40m
40259,2,Storchick,1442,0,0,1,1,0.0%,32m
40261,2,sonic,1441,212,6,11,17,35.3%,45m
40262,2,Leandrus,1440,0,1,5,6,16.7%,1h
40263,3,JÁJÁ,1436,0,0,1,1,0.0%,58m
40264,3,MarcelitoYT,1435,0,1,1,2,50.0%,18m
40265,3,MetalikDawg,1434,0,2,3,5,40.0%,59m
40266,3,ShadowDragon,1432,0,0,10,10,0.0%,9m
40267,2,green,1427,0,2,3,5,40.0%,2h
40268,3,bee,1426,86,4,18,22,18.2%,1h
40268,2,itachiuchiha,1426,192,3,14,17,17.6%,44m
40268,3,Protosspro,1426,0,1,4,5,20.0%,18m
40268,2,Smarties,1426,109,1,13,14,7.1%,1h
40272,3,PapiMario,1423,144,6,10,16,37.5%,9m
40273,3,ryecatcher,1419,0,1,0,1,100.0%,30m
40274,2,Camelfarmer,1418,437,35,66,101,34.7%,2h
40274,2,[KhanZ]Omarstar,1418,484,15,25,40,37.5%,2h
40274,3,Necropool,1418,0,1,4,5,20.0%,1m
40277,2,Maverick,1417,224,6,10,16,37.5%,59m
40277,2,Zeno,1417,0,0,10,10,0.0%,1h
40279,2,ChineseFox,1416,206,5,22,27,18.5%,1h
40280,2,Peta,1415,456,15,25,40,37.5%,2h
40281,1,PBJcyclops,1414,48,1,12,13,7.7%,2h
40282,2,barista,1413,72,3,15,18,16.7%,51m
40283,2,FreeBelarus,1412,0,0,1,1,0.0%,2h
40284,2,cactusman,1410,0,0,1,1,0.0%,1h
40285,2,kiwimaori,1406,163,5,5,10,50.0%,1h
40286,2,raynor,1405,225,7,16,23,30.4%,2h
40287,3,Javii,1401,148,4,16,20,20.0%,1h
40287,2,[UpeV]NewEra,1401,0,0,2,2,0.0%,2h
40289,2,paulomenega,1400,163,2,13,15,13.3%,59m
40290,3,RioTheHippy,1399,308,9,37,46,19.6%,1h
40291,2,StarFire,1395,64,2,8,10,20.0%,9m
40291,3,xelnaga,1395,0,0,5,5,0.0%,54m
40293,2,Bitkruked,1387,242,5,26,31,16.1%,40m
40294,2,Ludwig,1385,0,0,2,2,0.0%,54m
40295,2,DerekZoger,1383,175,2,18,20,10.0%,2h
40296,1,Vincent,1382,117,4,10,14,28.6%,2h
40297,2,Alexiana,1379,176,4,6,10,40.0%,2h
40298,1,OhadiNacnud,1378,392,10,26,36,27.8%,47m
40298,3,Simon,1378,0,1,1,2,50.0%,1h
40300,2,StumblnHome,1377,0,0,6,6,0.0%,2h
40301,1,Reeper,1376,458,14,43,57,24.6%,43m
40301,2,sami,1376,0,0,7,7,0.0%,1h
40303,2,borise,1373,1246,96,182,278,34.5%,52m
40304,1,RosinPress,1372,538,23,58,81,28.4%,36m
40304,1,SugarBoi,1372,108,1,13,14,7.1%,2h
40306,1,Fairy,1365,40,1,8,9,11.1%,2h
40307,2,HolyDiver,1362,124,6,17,23,26.1%,2h
40307,2,xdelpro,1362,132,4,20,24,16.7%,3h
40309,3,Lyghtning,1361,0,1,1,2,50.0%,3h
40310,1,sgtmalone,1360,456,15,35,50,30.0%,1h
40311,2,sloth,1359,262,7,22,29,24.1%,1h
40311,2,raynor,1359,66,2,11,13,15.4%,45m
40313,2,AdonnisF,1357,382,11,25,36,30.6%,2h
40314,2,CATNOIR,1356,128,3,16,19,15.8%,2h
40315,1,SuperNOOB,1355,1435,172,246,418,41.1%,35m
40316,2,NorthNomad,1354,212,6,21,27,22.2%,23m
40317,3,luizgoro,1352,0,1,0,1,100.0%,58m
40318,3,[DeeCeS]Tywolf,1351,255,7,28,35,20.0%,19m
40319,3,CraftzUwU,1349,58,3,5,8,37.5%,18m
40320,2,LEINAD,1346,155,3,12,15,20.0%,2h
40321,2,Jean,1344,659,24,45,69,34.8%,9m
40322,2,[C96741]Burgernose,1342,527,16,34,50,32.0%,24m
40322,3,AshbySan,1342,0,0,1,1,0.0%,45m
40324,2,ALLENCHILE,1338,196,5,15,20,25.0%,44m
40325,3,willahoo,1333,184,7,31,38,18.4%,1h
40325,2,PRiNCE,1333,0,2,6,8,25.0%,45m
40327,1,JCrack,1331,669,19,57,76,25.0%,11m
40327,3,Bola,1331,170,7,19,26,26.9%,29m
40329,2,luna,1329,1466,57,117,174,32.8%,44m
40330,3,OZZY,1327,0,0,5,5,0.0%,29m
40331,3,[0cool]Leetsteele,1321,68,2,11,13,15.4%,51m
40332,1,Fujin,1320,106,3,11,14,21.4%,1h
40332,3,Tumadre,1320,0,0,1,1,0.0%,23m
40334,3,Torbaz,1317,0,0,1,1,0.0%,2h
40335,3,holacomoewsk,1316,192,6,6,12,50.0%,29m
40336,1,Poptartman,1312,442,12,43,55,21.8%,2h
40336,3,XzX,1312,86,3,3,6,50.0%,45m
40336,3,TGH,1312,0,0,5,5,0.0%,59m
40339,3,DaWest,1305,0,0,1,1,0.0%,45m
40340,3,Glaurung,1301,213,19,19,38,50.0%,17m
40340,2,BEERDUGO,1301,0,0,8,8,0.0%,2h
40342,2,GardianBravo,1296,30,1,9,10,10.0%,45m
40343,3,solidsnake,1277,0,0,1,1,0.0%,29m
40344,3,Jyveks,1274,89,3,2,5,60.0%,9m
40345,2,Khayla,1272,940,32,71,103,31.1%,52m
40346,3,Eduardo,1271,0,0,4,4,0.0%,3h
40347,3,afrAy,1270,1020,33,78,111,29.7%,45m
40348,3,gralTIZIANO,1261,92,3,12,15,20.0%,9m
40349,3,juiceling,1260,0,0,1,1,0.0%,30m
40350,3,miguelh,1256,0,1,9,10,10.0%,58m
40351,3,JumpinJames,1252,188,6,9,15,40.0%,9m
40352,2,[OD]Xeros,1246,128,5,16,21,23.8%,48m
40353,2,Korzus,1244,390,11,31,42,26.2%,50m
40354,2,[EAbad]sfhvuivhiovh,1212,30,1,22,23,4.3%,2h
40355,3,Gunnerguy,1210,27,1,2,3,33.3%,9m
40356,3,[LAAR]Osirisgirls,1199,30,1,4,5,20.0%,17m
40357,3,ruben,1183,30,1,1,2,50.0%,9m
40358,3,HJODQWEHGEDW,1182,68,2,6,8,25.0%,54m
40359,3,jefemaestro,1178,142,5,18,23,21.7%,9m
40359,3,Werdwolf,1178,0,0,10,10,0.0%,45m
40361,3,Lukem,1177,0,0,6,6,0.0%,59m
40362,3,SuperNinja,1166,0,1,6,7,14.3%,45m
40363,3,[ME123]CDRshepards,1133,0,0,1,1,0.0%,45m
40364,3,BBattleBott,1123,58,2,11,13,15.4%,3h
40365,3,hazemaker,1064,232,8,23,31,25.8%,45m
40366,3,Maverick,1058,0,0,5,5,0.0%,45m
40367,3,[LOHd]Bella,1039,152,5,13,18,27.8%,2h
40368,3,[Batmn]kratoz,1014,30,2,0,2,100.0%,45m
40369,1,JaboomTwins,991,1447,44,130,174,25.3%,36m
40370,3,hahahay,969,88,2,7,9,22.2%,8m
40371,2,Plecto,880,0,586,416,1002,58.5%,36m
40372,3,WorstplyrNA,805,58,2,3,5,40.0%,58m
40373,3,[coI]AboveTheLaw,765,1084,674,840,1514,44.5%,33m
40373,3,JamminJohn,765,0,0,3,3,0.0%,9m
40375,2,agjil,718,1056,500,804,1304,38.3%,3h
40376,3,[D1ckd]BirdLeague,456,0,0,12,12,0.0%,51m
