rank,tier,name,mmr,points,wins,losses,played,winrate,age
1,1,[GGGSC2]Cyan,6233,3035,158,22,180,87.8%,4m
2,1,[那绝对不可能]夜蝶蝶蝶蝶蝶蝶蝶,6111,2092,94,6,100,94.0%,4m
3,1,[TeamLP]JieShi,6110,3035,194,23,217,89.4%,4m
4,1,[iGSCII]iGMacSed,6023,2354,112,20,132,84.8%,11m
5,1,[同化完成了]TSGCloudy,6006,48,2,1,3,66.7%,23m
6,1,小金者,5922,1230,59,16,75,78.7%,18m
7,1,[不讲武德]郑德重,5847,384,9,6,15,60.0%,11m
8,1,[早上好]SiaFerox,5811,0,0,1,1,0.0%,19m
9,1,[Lorie]爱护萝莉,5767,0,1,0,1,100.0%,24m
10,1,[蓬莱伝説]红球球,5751,361,23,10,33,69.7%,19m
11,1,[PTB]DPGEnchant,5692,2665,125,60,185,67.6%,4m
12,1,[KeRn]oRyoN,5674,0,1,0,1,100.0%,23m
13,1,[AnSwer]Omega,5671,1954,103,18,121,85.1%,18m
14,1,[守护内心秩序]神气宝贝,5667,0,1,3,4,25.0%,19m
15,1,[天界]Wzq,5632,0,1,0,1,100.0%,19m
16,1,[丨SLT丨]Yukki,5624,2941,285,160,445,64.0%,4m
17,1,[iGSCII]iGCoffeeMs,5614,126,3,2,5,60.0%,23m
18,1,投资银行不投资,5569,885,24,6,30,80.0%,17m
18,1,[全天在线]全网最低神族教学,5569,249,17,16,33,51.5%,49m
20,1,TOTO,5567,96,7,2,9,77.8%,12m
21,1,[岁月]月迷枫影,5566,0,1,0,1,100.0%,19m
22,1,[Beauti]Venus,5561,0,0,1,1,0.0%,19m
23,1,[Ogier]IIIIIIIIIIII,5540,0,1,0,1,100.0%,17m
24,1,[SLTHHH]SADFANS,5530,2836,168,77,245,68.6%,4m
25,1,Bloodless,5526,1540,42,8,50,84.0%,19m
26,1,[星际教学组]sweet,5513,0,1,0,1,100.0%,17m
27,1,IIIIIIII,5501,946,21,2,23,91.3%,12m
28,1,我永远喜欢加藤惠,5496,0,1,0,1,100.0%,49m
29,1,[XYFANS]AdrenalinE,5493,147,3,3,6,50.0%,11m
30,1,[PTB]MATH,5472,2312,300,121,421,71.3%,17m
31,1,[Beasty]Maxpff,5470,452,14,4,18,77.8%,17m
32,1,[丨SLT丨]苏言,5443,222,6,7,13,46.2%,4m
33,1,[HHHFAN]rewhitefans,5428,782,34,12,46,73.9%,54m
34,1,弥新,5417,393,11,4,15,73.3%,4m
35,1,llllllllllll,5413,894,46,18,64,71.9%,24m
36,1,[TNLet]季裂鲜明,5410,1938,94,48,142,66.2%,54m
37,1,[小仙女联盟]沧海客,5381,942,48,15,63,76.2%,54m
38,1,[XYFANS]鸟哥真爱粉,5373,3141,184,86,270,68.1%,4m
38,1,[TNLet]飞环,5373,188,5,0,5,100.0%,23m
40,1,[吹毛]沧海客,5368,1628,60,35,95,63.2%,4m
41,1,[SoIoAs]沧海客,5366,1082,52,15,67,77.6%,18m
42,1,[PTB]Alka,5361,3122,169,99,268,63.1%,4m
43,1,[VirGo]KloulriD,5360,1182,55,39,94,58.5%,18m
43,1,[金灿灿狙击队]白花花,5360,144,4,0,4,100.0%,18m
45,1,IIIIIIIIIII,5356,0,0,1,1,0.0%,17m
46,1,[VirGo]鲜明,5347,1494,143,87,230,62.2%,54m
47,1,[金灿灿狙击队]你尽然不知道狗哥,5340,144,4,1,5,80.0%,11m
48,1,ByuN,5330,603,27,8,35,77.1%,19m
48,1,[Revive]LPU,5330,518,12,9,21,57.1%,18m
50,1,[VirGo]Blood,5327,144,4,0,4,100.0%,12m
51,1,[XYFANS]不讲武德的年轻人,5322,607,23,17,40,57.5%,11m
52,1,[暗中观鸡]肖嗨佬,5312,750,17,3,20,85.0%,49m
53,1,llllllllllll,5310,336,10,1,11,90.9%,4m
54,1,[传说萌娘团]萝莉沧海客,5307,648,28,2,30,93.3%,11m
54,1,[享受星际]南京胡翔,5307,48,1,1,2,50.0%,17m
56,1,[独行无名流]无名一统地堡宗师,5303,3019,346,234,580,59.7%,4m
57,1,[金灿灿狙击队]Yancy,5301,3041,235,155,390,60.3%,4m
58,1,星空凛凛凛凛凛凛,5297,2010,124,74,198,62.6%,17m
59,1,[Thpj]Psmoonsun,5285,73,1,1,2,50.0%,18m
60,1,[享受星际]极光永夜,5274,130,4,0,4,100.0%,24m
61,1,[SoloAs]Bistork,5267,1211,58,9,67,86.6%,26m
62,1,Nezuko,5265,0,3,2,5,60.0%,12m
63,1,llllllllllll,5256,2019,102,59,161,63.4%,4m
64,1,IIIIIIIIIIII,5241,2427,155,88,243,63.8%,4m
65,1,[肉鸡的饲养]如何共勉,5239,178,4,3,7,57.1%,13m
66,1,[Ogier]月光下的流水,5236,0,1,0,1,100.0%,12m
67,1,Zeus,5234,0,1,0,1,100.0%,19m
68,1,[神域天堂]武神,5232,0,1,0,1,100.0%,19m
69,1,[ZJU]Daydreamer,5231,46,2,2,4,50.0%,11m
70,1,[BLaDe]小坚强,5223,749,21,20,41,51.2%,54m
71,1,TIME,5221,915,29,4,33,87.9%,54m
72,1,KingT,5219,697,33,14,47,70.2%,18m
72,1,[ISENGD]NEWBIES,5219,582,20,4,24,83.3%,4m
74,1,[Solo]nEOiMAGING,5217,0,0,1,1,0.0%,18m
75,1,[IMRTS]PolamaWang,5214,0,1,0,1,100.0%,12m
76,1,[金灿灿狙击队]TOTO,5207,44,2,1,3,66.7%,5m
77,1,[樱火之森]乱舞,5206,0,0,1,1,0.0%,17m
78,1,[北京大学鸡协]搜到我你已经赢了,5203,0,0,1,1,0.0%,17m
78,1,浅小言,5203,0,0,1,1,0.0%,18m
80,1,llllllllllll,5201,476,11,6,17,64.7%,24m
80,1,[SSCG]诺娃誓死不出兵,5201,26,3,1,4,75.0%,12m
82,1,[享受星际]乌龟,5198,140,4,6,10,40.0%,17m
83,1,IIIIIIIIIIII,5193,229,6,5,11,54.5%,4m
84,1,[丨SLT丨]陈忱只会跳鸡猎,5181,762,18,11,29,62.1%,24m
84,1,灰冬,5181,0,0,1,1,0.0%,19m
84,1,[丨SLT丨]IIIIIIIIIIII,5181,0,0,1,1,0.0%,18m
87,1,[AnSwer]牛顿炖牛肉,5178,0,1,0,1,100.0%,49m
88,1,你竟然不认识硕哥,5177,0,0,1,1,0.0%,24m
89,1,[Shawk]ChiHiro,5175,1552,75,40,115,65.2%,12m
90,1,[SoloAs]Resolution,5172,0,1,1,2,50.0%,24m
91,1,斯嘉丽,5164,679,33,11,44,75.0%,54m
92,1,[Sv]羽瀨川小笛,5163,310,8,11,19,42.1%,5m
93,1,[五月花]llllllllllll,5156,1247,80,41,121,66.1%,18m
94,1,[冰泪湖的岸边]冰冻誓言,5155,1533,68,55,123,55.3%,4m
95,1,[SK]IIIIIIIIII,5153,272,7,4,11,63.6%,17m
96,1,[干拉炒面]三维立体混元劲,5152,1510,73,45,118,61.9%,4m
97,1,[SK]ivy,5149,433,15,6,21,71.4%,4m
98,1,[HST]牙隹雅,5146,46,2,2,4,50.0%,17m
99,1,神绮,5138,169,20,10,30,66.7%,23m
100,1,RBGHOS,5137,330,7,7,14,50.0%,17m
101,1,[享受星际]soso,5136,926,23,24,47,48.9%,19m
101,1,字数补丁,5136,154,5,1,6,83.3%,49m
103,1,llllllllllll,5134,0,1,0,1,100.0%,12m
104,1,[Holygl]expertX,5131,534,21,19,40,52.5%,11m
105,1,HfYuki,5125,1634,83,56,139,59.7%,11m
106,1,[PTB]布基波普,5122,96,2,0,2,100.0%,19m
107,1,[Ogier]Moonlight,5121,0,1,0,1,100.0%,12m
108,1,[不可能会]真有人打不过我吧,5118,812,88,66,154,57.1%,26m
109,1,[湖南大学]掠影,5116,2930,324,242,566,57.2%,4m
110,1,llllllllllll,5114,1027,57,44,101,56.4%,17m
111,1,闪击英雄,5107,0,1,0,1,100.0%,24m
112,1,[浅小言]dhyhecker,5106,211,23,12,35,65.7%,24m
113,1,[PTB]DiscoProtoss,5103,178,5,0,5,100.0%,54m
114,1,[苍之彼方]鸢泽美咲,5102,1224,76,50,126,60.3%,26m
114,1,llllllllllll,5102,1146,28,15,43,65.1%,12m
116,1,Jackywu,5100,2621,130,90,220,59.1%,4m
116,1,[星际教学组2]艾尔航母,5100,1150,29,24,53,54.7%,24m
118,1,[Maxp]pff,5097,225,11,2,13,84.6%,19m
118,1,梅普璐,5097,0,1,0,1,100.0%,5m
120,1,[Ogier]反正我只爱小红红,5096,46,1,2,3,33.3%,12m
121,1,[SCJWJ3]IIIIIIIIIIII,5082,2877,174,132,306,56.9%,4m
122,1,[RSTAR]白给小菜鸡,5081,960,41,23,64,64.1%,49m
123,1,Opportunity,5078,507,25,6,31,80.6%,17m
124,1,[金灿灿狙击队]FoolishYX,5077,165,20,10,30,66.7%,23m
125,1,[LDP]Twins,5070,0,0,1,1,0.0%,5m
126,1,苏州孙一峰,5067,0,3,2,5,60.0%,26m
126,1,[笙风]笙风,5067,0,0,1,1,0.0%,13m
128,1,科普卢第一小仙女,5066,0,0,1,1,0.0%,18m
129,1,[PTB]DespeRado,5058,511,19,18,37,51.4%,4m
129,1,[SK]FreedomJay,5058,197,13,2,15,86.7%,23m
131,1,[小小小橘猫]Flash,5057,92,3,5,8,37.5%,17m
132,1,[学习使我快乐]小林者,5049,0,1,0,1,100.0%,5m
133,1,llllllllllll,5047,0,1,0,1,100.0%,19m
134,1,[浙江工商大学]superMC,5046,44,1,1,2,50.0%,12m
135,1,[妙手回春]Dreamhaven,5044,140,3,2,5,60.0%,24m
136,1,[Thpj]闪击英雄,5042,422,10,6,16,62.5%,23m
136,1,[Beasty]aier,5042,0,1,0,1,100.0%,5m
136,1,[PTB]若世有神明,5042,0,0,1,1,0.0%,13m
139,1,[KPG]我是隐形的寡妇雷,5036,512,12,9,21,57.1%,11m
140,1,[不要叫我毒爆]艾尔毒爆,5033,360,22,2,24,91.7%,19m
141,1,llllllllllll,5032,765,38,25,63,60.3%,12m
142,1,丨丨丨丨丨丨丨丨,5030,0,0,1,1,0.0%,5m
143,1,[Marry]我队友是鸡,5026,0,0,1,1,0.0%,26m
144,1,tinypig,5025,2848,155,108,263,58.9%,4m
144,1,高考完就回来,5025,0,0,1,1,0.0%,54m
146,1,[PsNasa]Zest,5023,0,0,1,1,0.0%,19m
147,1,[IMRTS]IIIIIIIIIIII,5022,0,0,1,1,0.0%,17m
148,1,[肉鸡的饲养]魔法骚女凯露酱,5021,534,22,10,32,68.8%,4m
148,1,[o瞳孔o]Vip,5021,0,0,1,1,0.0%,26m
148,1,[o瞳孔o]吹梦到西洲,5021,0,0,1,1,0.0%,12m
151,1,[金击圆弧]llllllllllll,5020,2585,278,211,489,56.9%,4m
151,1,[南京大学]明年入学,5020,0,0,1,1,0.0%,54m
153,1,[RTSGo]XiaMenByuN,5017,0,1,0,1,100.0%,17m
154,1,[雨何时会下]ATRI,5016,310,45,8,53,84.9%,17m
154,1,[凯哥集团]闪电风暴,5016,237,34,20,54,63.0%,49m
154,1,[TAK]SamAir,5016,0,1,0,1,100.0%,19m
157,1,[神界]女王,5014,0,1,0,1,100.0%,19m
158,1,老芒果,5012,262,7,5,12,58.3%,13m
158,1,[SK]BurNIng,5012,0,1,0,1,100.0%,12m
160,1,[P1]Fragment,5011,1784,501,448,949,52.8%,18m
160,1,Treacherous,5011,2136,115,43,158,72.8%,4m
160,1,[同化完成了]Nice,5011,410,14,0,14,100.0%,13m
163,1,[肉鸡的饲养]思薇,5010,176,5,1,6,83.3%,18m
164,1,[加油大魔王]阿尔菲丶妃儿,5009,758,31,33,64,48.4%,4m
164,1,[人族是我爹]akuo,5009,0,0,1,1,0.0%,24m
166,1,[SK]llllllll,5007,2105,93,100,193,48.2%,49m
166,1,[只会666]水龍玥,5007,493,78,6,84,92.9%,24m
168,1,[Ogier]kinm,5006,2824,444,346,790,56.2%,4m
169,1,[LIOON]月色萧然,5004,682,43,8,51,84.3%,23m
169,1,养老神族,5004,0,0,1,1,0.0%,24m
171,1,llllllllllll,5003,0,0,1,1,0.0%,24m
172,1,[Ogier]反正我又不会玩,5002,600,15,10,25,60.0%,18m
172,1,[享受星际]海洋之心,5002,0,0,2,2,0.0%,12m
174,1,[雨何时会停]Akiha,5001,1468,67,46,113,59.3%,4m
175,1,[泰拉多尔港湾]败瘠薄攒其我,4995,0,0,1,1,0.0%,5m
176,1,雍雍喈喈,4994,1292,70,25,95,73.7%,4m
177,1,[皇子]LuciferHeart,4993,44,2,1,3,66.7%,19m
177,1,[Hist]Andy,4993,0,0,1,1,0.0%,12m
179,1,永远喜欢佩可莉姆,4992,953,41,42,83,49.4%,11m
180,1,loveisgone,4990,0,0,1,1,0.0%,12m
181,1,国服炸鱼无耻,4986,84,3,0,3,100.0%,17m
182,1,[TPoA]全都是等号,4983,2024,108,78,186,58.1%,4m
182,1,[Shawk]HappyStar,4983,477,21,11,32,65.6%,18m
182,1,[肉鸡的饲养]Summoner,4983,450,15,15,30,50.0%,4m
185,1,llllllllllll,4981,46,2,0,2,100.0%,12m
186,1,llllllllllll,4976,1508,87,42,129,67.4%,18m
186,1,[ZJU]Daydreamer,4976,48,2,1,3,66.7%,26m
188,1,[小仙女联盟]伊人醉,4975,0,0,1,1,0.0%,23m
189,1,[幽金贮藏堆]xzzzzz,4973,559,30,5,35,85.7%,19m
190,1,[ENB]EmmyNicole,4971,0,0,1,1,0.0%,12m
191,1,youjizy,4967,2673,358,301,659,54.3%,4m
192,1,[BGD]寒冰之陨,4966,0,0,1,1,0.0%,54m
193,1,IIIIIIIIIIII,4965,614,29,5,34,85.3%,24m
193,1,[肉鸡的饲养]小魔女伊蕾娜酱,4965,428,15,15,30,50.0%,4m
195,1,泷泽政道,4958,285,8,8,16,50.0%,4m
196,1,[南京大学]TBK,4955,218,5,7,12,41.7%,49m
196,1,[孙红雷]llllllllllll,4955,0,0,1,1,0.0%,24m
198,2,[SK]Gloriam,4954,81,5,1,6,83.3%,24m
199,1,一笑而过,4953,0,0,1,1,0.0%,19m
200,1,[魔法少女小屋]玖诺,4952,0,4,1,5,80.0%,24m
200,1,[雷本]INnoVation,4952,0,0,1,1,0.0%,12m
202,1,[我们是无敌的]西风踏雪雁归来,4951,48,1,1,2,50.0%,17m
203,1,㞺㞺㞺㞺㞺㞺㞺㞺,4950,1521,61,52,113,54.0%,4m
204,2,zyc,4949,0,3,5,8,37.5%,8m
204,1,[Beasty]ProtossOutl,4949,0,1,0,1,100.0%,14m
206,1,[Beasty]Wave,4948,1366,57,49,106,53.8%,4m
207,1,[金灿灿狙击队]神速偷鸡,4946,601,23,15,38,60.5%,11m
208,1,dDreAm,4945,1760,174,119,293,59.4%,18m
209,1,[柳丁FANS]magicprotoss,4943,460,12,1,13,92.3%,14m
210,1,[Beasty]道外流牙,4941,1500,124,98,222,55.9%,23m
211,1,[谢拉单推联盟]咕咕侠,4939,650,25,18,43,58.1%,4m
211,1,[丨SLT丨]婉若清风,4939,332,8,8,16,50.0%,17m
211,1,[羊驼羊驼羊]AbyssApostl,4939,0,0,1,1,0.0%,24m
214,1,[Ogier]hzzero,4935,144,4,3,7,57.1%,11m
215,1,[SSCG]Nanako,4930,0,0,1,1,0.0%,24m
216,1,Katharsis,4929,1430,58,53,111,52.3%,4m
217,1,[FoD]爱疯的我们,4928,0,0,1,1,0.0%,12m
218,1,llllllllllll,4925,1005,91,45,136,66.9%,54m
218,1,[HST]墨染,4925,0,0,1,1,0.0%,54m
220,1,[炼狱修罗]猫爷,4923,138,4,5,9,44.4%,54m
221,1,[XYFANS]LiquidClem,4920,1525,59,58,117,50.4%,4m
221,1,Grrrr,4920,0,0,1,1,0.0%,14m
223,1,IIIIIIIII,4919,2039,100,86,186,53.8%,4m
223,1,llllllllllll,4919,265,11,7,18,61.1%,17m
225,1,[TNLet]曼施坦因,4918,684,17,10,27,63.0%,12m
226,1,[专打嘤嘤怪]希尔瓦娜斯,4916,852,28,2,30,93.3%,17m
227,1,[WIK]沧海客,4914,0,1,1,2,50.0%,14m
228,1,[AnSwer]樱丶桃,4913,212,22,15,37,59.5%,24m
228,1,[丨SLT丨]NanYi,4913,0,1,1,2,50.0%,49m
230,1,llllllllllll,4912,958,55,12,67,82.1%,4m
230,1,郑舒宇,4912,266,7,1,8,87.5%,26m
232,1,[星选组]熙超大婷呀,4909,0,1,0,1,100.0%,11m
232,1,[寿司吧嘤嘤怪]llllllllllll,4909,0,0,1,1,0.0%,54m
234,1,[Rhusky]TOTO,4908,1547,98,82,180,54.4%,18m
234,1,[單兵聯盟]青柠,4908,0,0,1,1,0.0%,23m
236,1,[金灿灿狙击队]你尽然不知道袖哥,4907,702,29,21,50,58.0%,4m
237,1,llllllllllll,4906,1241,61,42,103,59.2%,4m
237,1,丶胤真,4906,418,17,14,31,54.8%,17m
237,1,[一觞醉红颜]执笔道思念,4906,88,2,5,7,28.6%,17m
240,1,[SK]瞎眼斗将,4905,2803,1021,927,1948,52.4%,4m
241,1,[专业单一小组]余生有你,4904,344,21,9,30,70.0%,12m
242,1,llllllllllll,4903,1917,119,114,233,51.1%,18m
243,1,llllllllllll,4902,73,4,1,5,80.0%,54m
243,1,[Shawk]Lanthanum,4902,138,4,1,5,80.0%,26m
245,1,[丨SLT丨]断手小人皇,4901,1006,30,16,46,65.2%,12m
246,1,[届不到的恋]地堡人,4897,785,35,27,62,56.5%,17m
246,1,[Shawk]SkyHawk,4897,761,22,17,39,56.4%,24m
248,1,[雅典卫城]Athena,4894,0,1,0,1,100.0%,19m
249,1,[老年娱乐星际]奇霸霸,4893,690,17,15,32,53.1%,11m
250,1,[RSTAR]STAR,4890,410,11,9,20,55.0%,5m
251,1,新手电脑,4887,0,0,1,1,0.0%,12m
252,1,[YM]艾辰学长,4886,0,0,1,1,0.0%,49m
253,1,[半个大哥]misery,4884,174,5,6,11,45.5%,24m
254,1,[美少女萬華鏡]灵寒舞吃玥玥,4883,0,0,1,1,0.0%,14m
255,1,[五弊三缺]汉文成留侯,4878,781,35,34,69,50.7%,4m
256,1,雅雅国国王王雅雅,4877,94,2,12,14,14.3%,19m
256,1,[KPG2]RedStar,4877,0,0,1,1,0.0%,11m
258,1,[丶yong]上海饭店,4876,1622,77,62,139,55.4%,12m
258,1,户部巷,4876,925,28,32,60,46.7%,26m
260,1,Tensor,4875,2451,116,111,227,51.1%,11m
261,1,[正不胜谐]星际前锋,4870,0,0,1,1,0.0%,12m
262,1,[HST]威严满满抱头蹲防,4869,496,13,12,25,52.0%,24m
263,1,CAFANS,4868,174,5,4,9,55.6%,24m
263,1,Pansea,4868,0,1,0,1,100.0%,12m
263,1,[可可萝]百地希留耶,4868,0,0,1,1,0.0%,18m
266,1,[中华讲武堂]樱雨下第一财团,4866,0,0,1,1,0.0%,24m
267,1,[KPG]可乐,4864,297,11,5,16,68.8%,54m
268,1,白白球,4863,422,19,17,36,52.8%,12m
269,1,[肉鸡的饲养]时崎狂三,4862,846,38,22,60,63.3%,12m
269,1,[Hist]一一得三,4862,629,28,24,52,53.8%,4m
269,1,三千水平七千嘴,4862,0,0,1,1,0.0%,24m
269,1,[Holyam]Linn,4862,0,0,3,3,0.0%,23m
273,1,[69岁狙击手]铁骨铮铮白咲花,4860,0,1,0,1,100.0%,11m
274,1,艾尔之殇,4854,532,14,7,21,66.7%,23m
275,1,[80后丶]JYQBaBy,4853,2447,106,102,208,51.0%,4m
276,1,[黄漫老师]香风和泉,4852,1133,46,34,80,57.5%,4m
276,1,墨殇,4852,0,0,1,1,0.0%,23m
278,1,[Beasty]汁先生,4851,762,53,20,73,72.6%,4m
278,1,[丨SLT丨]菜多大馍王,4851,304,8,5,13,61.5%,17m
278,1,可口可乐,4851,180,4,13,17,23.5%,17m
281,2,藤原妹红,4848,0,3,5,8,37.5%,24m
282,1,海妖的小触手,4847,349,24,17,41,58.5%,49m
282,1,[KFC]ShowTime,4847,0,0,1,1,0.0%,17m
284,1,[杂种种族]松活弹抖闪电鞭,4846,1809,92,53,145,63.4%,4m
285,1,[四叶草]无敌的橄榄虫,4843,1143,69,54,123,56.1%,14m
285,1,[KPG]大爱许单言,4843,904,44,31,75,58.7%,17m
285,1,IIIIIIIIIIII,4843,82,2,10,12,16.7%,49m
288,1,[KPG]AloneWolf,4840,2636,210,185,395,53.2%,4m
288,1,星河舜,4840,2343,106,94,200,53.0%,4m
288,1,残疾智障瞎子,4840,161,4,4,8,50.0%,12m
291,1,IIIIIIIIIII,4839,0,1,0,1,100.0%,24m
292,1,[Beasty]Pluto,4838,449,15,17,32,46.9%,54m
293,2,[星选组]暴雪的爹,4837,0,0,1,1,0.0%,50m
294,1,llllllllll,4836,36,1,1,2,50.0%,18m
295,1,iiiiiiiiiiii,4835,675,53,39,92,57.6%,23m
295,1,[P好imba]希儿的灾厄魔盒,4835,0,0,1,1,0.0%,19m
297,1,Jiejie,4834,468,25,4,29,86.2%,14m
298,1,Irie,4833,625,34,7,41,82.9%,26m
298,1,[魔法少女小屋]RFZealot,4833,266,7,2,9,77.8%,18m
300,1,[迪克boy]五更琉璃,4832,1140,56,40,96,58.3%,54m
301,1,[KPG2]OhhhYeah,4829,188,4,2,6,66.7%,11m
302,1,[气息辉煌之剑]十六月黑月,4828,0,0,1,1,0.0%,17m
303,1,[Shawk]Goya,4826,0,0,1,1,0.0%,27m
304,1,[笙风]月下小怪兽,4823,1438,186,161,347,53.6%,14m
305,1,IIIIIIIIIIII,4822,658,29,25,54,53.7%,5m
306,1,Melinda,4821,352,27,2,29,93.1%,19m
307,1,[Beasty]llllllllllll,4820,2719,251,187,438,57.3%,4m
307,1,SuzunoMiihi,4820,86,3,0,3,100.0%,12m
307,1,[天坑a]或悲或喜感谢相遇,4820,0,0,1,1,0.0%,5m
310,1,[星际丨老男孩]Smile,4817,0,0,1,1,0.0%,19m
311,1,[i马士]年轻人不讲武德,4814,500,14,15,29,48.3%,19m
311,1,[Legacy]酱肘子给谁吃,4814,48,1,5,6,16.7%,14m
311,1,[Beasty]九叔,4814,0,0,1,1,0.0%,49m
314,1,DarkCarrot,4813,2664,248,191,439,56.5%,4m
314,1,[丨SLT丨]秋月爱莉,4813,430,14,22,36,38.9%,4m
316,1,ggfreelancer,4812,0,1,1,2,50.0%,18m
316,1,娜娜奇太可爱了,4812,48,1,2,3,33.3%,17m
316,1,MeasL,4812,0,0,1,1,0.0%,11m
319,1,[塔达林净化者]夜雨声烦,4811,331,10,16,26,38.5%,4m
319,1,IIIIIIIIIIII,4811,80,2,4,6,33.3%,17m
321,1,[Beasty]艺伎不是姬,4810,0,0,1,1,0.0%,24m
322,1,你是猪,4809,2450,294,287,581,50.6%,4m
322,1,[SYP]钉钉小仙女,4809,0,0,1,1,0.0%,12m
322,1,llllllllllll,4809,0,0,1,1,0.0%,24m
325,1,专业抬棺团队,4808,90,2,3,5,40.0%,54m
325,1,Cloudtopwalk,4808,0,0,1,1,0.0%,23m
327,1,[FAFA]sTarMoon,4807,282,8,7,15,53.3%,24m
328,1,[我是云玩家]用脚打星际,4806,1029,101,82,183,55.2%,49m
329,1,llllllllllll,4805,1169,98,101,199,49.2%,54m
329,1,GTV,4805,204,6,9,15,40.0%,5m
329,1,GREATAGAIN,4805,0,0,1,1,0.0%,17m
332,1,[极品菜鸟]我又不空大,4804,2720,217,192,409,53.1%,4m
332,1,[Thpj]喵發,4804,0,1,0,1,100.0%,24m
334,1,llllllllllll,4803,2377,159,148,307,51.8%,4m
334,1,[凯哥集团]金中山已几,4803,676,32,15,47,68.1%,4m
336,1,[純槍兵就宗]水無月笛,4801,0,0,1,1,0.0%,12m
337,1,[封弊者]三世,4800,2124,124,76,200,62.0%,17m
337,1,人生何处不青山,4800,718,58,6,64,90.6%,14m
339,1,[SK]千机变,4794,2604,437,426,863,50.6%,4m
340,1,[华尔街股神]巴菲特,4793,355,11,21,32,34.4%,12m
341,1,[合作老司机]黯淡卟变,4792,386,18,8,26,69.2%,24m
341,1,[IMRTS]我不是萝莉控,4792,488,17,22,39,43.6%,4m
343,1,[你已经死啦]Ccli,4790,208,6,3,9,66.7%,17m
343,1,[AIURst]lingyu,4790,0,1,0,1,100.0%,19m
343,1,[手握黄金舰队]挽星,4790,0,0,1,1,0.0%,14m
346,1,[人族是我爹]TATP,4789,2619,324,305,629,51.5%,4m
346,1,神族爸爸来了,4789,525,21,23,44,47.7%,4m
348,1,[老婆吼我就退]Banana,4788,643,47,17,64,73.4%,27m
349,1,[SoloAs]ljk,4785,574,15,11,26,57.7%,23m
349,1,[幻世情缘]Nawkham,4785,0,0,1,1,0.0%,12m
351,1,[韩宗快乐屋]Azrael,4784,2167,145,125,270,53.7%,4m
351,1,[Molis]茉莉兔兔,4784,2613,140,133,273,51.3%,4m
351,1,[我永远单推]花园瑟蕾娜,4784,542,22,24,46,47.8%,18m
351,1,人类,4784,0,1,4,5,20.0%,19m
355,1,[大青铜小联盟]巧克力威化饼干,4783,1765,99,91,190,52.1%,18m
355,1,[SoloAs]桐生一马,4783,0,0,1,1,0.0%,12m
357,1,[笙风]潜行之影,4780,0,0,1,1,0.0%,23m
358,3,[指尖奶茶]蕾米莉亚,4778,97,2,3,5,40.0%,26m
359,1,sad,4776,0,1,0,1,100.0%,14m
359,1,甄不错,4776,0,0,1,1,0.0%,24m
361,1,[Shawk]Danny,4775,1344,70,50,120,58.3%,18m
361,1,llllllllllll,4775,444,12,8,20,60.0%,17m
363,1,KingOfTempo,4774,2848,304,251,555,54.8%,14m
363,1,[SCAP]EtdhaGongDa,4774,0,0,1,1,0.0%,5m
363,3,Clay,4774,0,0,1,1,0.0%,22m
366,1,[Shawk]虎王小何,4771,0,0,1,1,0.0%,19m
367,1,[8kmage]条码条码条码条码,4769,573,29,8,37,78.4%,27m
367,2,提馏线方程,4769,148,4,0,4,100.0%,6m
369,1,[蝴蝶泉]请赐我女仆么么哒,4767,569,32,6,38,84.2%,54m
370,1,堡本,4766,1598,375,368,743,50.5%,14m
370,1,[魔法少女小屋]弱小学姐,4766,308,9,2,11,81.8%,12m
372,1,[Pro]LindL,4764,2114,415,401,816,50.9%,12m
372,1,救赎,4764,0,0,1,1,0.0%,24m
374,1,llllllllllll,4763,516,20,13,33,60.6%,4m
374,1,[TUF]魂牵冰点,4763,0,0,1,1,0.0%,24m
376,1,[Beasty]letian,4761,1169,92,79,171,53.8%,27m
377,1,you,4760,0,0,1,1,0.0%,23m
378,1,[我不是乱舞]狂花,4758,665,20,29,49,40.8%,24m
379,1,[秋毫第七分队]llllllllllll,4755,46,1,2,3,33.3%,19m
380,1,JumpingStone,4754,709,30,7,37,81.1%,5m
380,1,远方,4754,213,7,6,13,53.8%,24m
382,1,[YMET]IIIIIIIIIIII,4752,1004,43,32,75,57.3%,19m
382,1,[SNShna]ParadoX,4752,30,1,1,2,50.0%,17m
382,1,[中国科学院]樱桃小丸子,4752,0,0,1,1,0.0%,12m
385,1,[六奇]TOTO,4750,216,6,3,9,66.7%,17m
385,1,IIIIIIIIIIII,4750,0,0,1,1,0.0%,19m
387,1,[小金上天队]万年沉封,4748,369,20,13,33,60.6%,23m
388,1,DcProtoss,4747,0,0,1,1,0.0%,12m
389,1,[四叶草]lllllllll,4746,1149,93,100,193,48.2%,54m
390,1,lllllllllll,4742,286,18,5,23,78.3%,12m
390,1,[七咕咕]Linus,4742,0,1,0,1,100.0%,24m
390,1,[不讲武德]郑德重,4742,0,0,1,1,0.0%,19m
393,1,[GHet]爱嘉惠真是太好了,4739,605,27,25,52,51.9%,49m
394,1,[青娱乐]希里吉薇艾尔,4738,370,10,2,12,83.3%,24m
395,1,[IMRTS]我真的很菜啊,4737,509,16,6,22,72.7%,14m
396,1,[不死突袭3]迪奥的奇妙冒险,4736,363,21,14,35,60.0%,12m
397,1,国宗一半是我艾尔,4734,0,1,0,1,100.0%,24m
398,1,[娱乐星际]Verfallen,4733,1231,45,37,82,54.9%,12m
398,1,二一六,4733,170,4,7,11,36.4%,12m
400,1,幽兰雀翎,4730,162,25,10,35,71.4%,23m
401,2,[AnSwer]CarGO,4729,133,5,6,11,45.5%,8m
402,2,[柠哥nb]呜咩,4727,376,19,2,21,90.5%,6m
402,1,[单推音无妹妹]音无来未单推人,4727,474,16,8,24,66.7%,24m
402,1,[寒鸦]杀戮同行,4727,0,0,1,1,0.0%,24m
405,1,[Shawk]天下第一美穆萝莉,4726,334,9,7,16,56.2%,11m
406,1,[唯爱彦神]战巡舰掌柜,4725,0,0,1,1,0.0%,12m
407,1,[我们是无敌的]Trap,4723,2938,149,135,284,52.5%,12m
408,1,[狐疑单推协会]鳴海兎亜,4722,156,5,1,6,83.3%,12m
409,1,[诺娃1]子屈,4721,0,0,1,1,0.0%,12m
410,1,[begin]牙神,4720,2590,228,224,452,50.4%,23m
411,1,[Missy]Explorer,4717,2924,117,125,242,48.3%,27m
411,1,[SK]艾尔小圆盾,4717,152,5,1,6,83.3%,24m
413,1,[SK]竹杖芒鞋,4716,2645,264,226,490,53.9%,4m
414,1,[丨SLT丨]Stats,4714,130,3,4,7,42.9%,17m
414,1,[NT]ajbn,4714,44,2,1,3,66.7%,19m
416,1,[SoloAs]血花缭乱,4713,1418,60,57,117,51.3%,18m
417,1,[丨SLT丨]秋名山的老司机,4712,605,31,15,46,67.4%,23m
418,1,[享受星际]Crazydiamond,4711,42,1,11,12,8.3%,14m
418,1,进击的胖狗,4711,0,0,1,1,0.0%,17m
420,1,[丹东男神天团]丹东大老肥,4710,234,7,5,12,58.3%,17m
421,1,[六骑]TOTO,4709,2604,597,565,1162,51.4%,11m
422,1,[PTB]诗乃,4708,0,3,2,5,60.0%,51m
423,1,greatCSS,4707,519,16,16,32,50.0%,49m
424,1,[SK]DirtyProtoss,4706,40,1,1,2,50.0%,24m
425,1,[武汉理工大学]Serral,4705,1372,63,48,111,56.8%,17m
426,1,[ELSD]HerO,4702,0,0,1,1,0.0%,24m
426,1,[百香果菠萝人]止损,4702,0,0,3,3,0.0%,17m
428,1,[浙江工商大学]Sarrrrrright,4701,1620,108,92,200,54.0%,54m
428,1,[金灿灿狙击队]如是我闻,4701,839,27,19,46,58.7%,27m
430,1,[跳虫四人组]跳虫五号,4700,252,12,3,15,80.0%,18m
431,1,[一色彩彩羽]比企谷八幡,4699,0,0,1,1,0.0%,18m
432,1,[SK]Enliven,4698,236,6,6,12,50.0%,23m
433,1,[Sc神奇宝贝]闪光卡比兽,4697,88,2,3,5,40.0%,23m
433,1,[tiandi]Mercury,4697,0,0,3,3,0.0%,54m
435,1,混元星际大师兄,4696,84,2,8,10,20.0%,24m
436,1,IIIIIIIIIIII,4693,449,24,20,44,54.5%,12m
436,1,[你可以挑战我]哈哈不能,4693,0,0,2,2,0.0%,27m
438,1,渔北,4689,1161,77,70,147,52.4%,12m
439,3,Altuin,4688,0,0,1,1,0.0%,21m
440,1,香辣巨无霸,4687,2584,182,157,339,53.7%,19m
441,1,[爱国武术家]陈真,4685,48,3,2,5,60.0%,46m
442,1,TempleR,4684,2181,227,206,433,52.4%,14m
442,1,llllllllllll,4684,0,0,1,1,0.0%,24m
444,1,Hero,4683,587,36,14,50,72.0%,27m
444,1,ThePotato,4683,862,25,33,58,43.1%,49m
446,1,[传说萌娘团]KotorItsuka,4682,0,0,1,1,0.0%,24m
447,1,[Shawk]真岛吾郎,4681,92,2,3,5,40.0%,19m
448,1,[科普卢小仙女]Cinderella,4680,618,18,21,39,46.2%,18m
449,1,[丨SLT丨]艾尔小圆盾,4679,1223,65,34,99,65.7%,24m
450,1,IIIIIIIIIIII,4678,90,2,1,3,66.7%,18m
451,1,[SCJWJ3]丿醉梦丶听风灬,4677,2302,103,99,202,51.0%,5m
451,1,[BGD]IIIIIIIII,4677,1459,56,46,102,54.9%,19m
451,1,[肉鸡的饲养]Herodropship,4677,0,1,0,1,100.0%,49m
454,1,花鸟风月,4674,475,87,19,106,82.1%,17m
455,1,Deathcoil,4673,48,2,0,2,100.0%,54m
455,1,[Ours]粉盒,4673,0,0,1,1,0.0%,18m
455,1,刀塔职业选手,4673,0,0,1,1,0.0%,12m
458,1,[随便吧]ForVengeance,4668,0,0,3,3,0.0%,27m
459,1,[艹妹联盟]洵濑绘里,4666,0,1,0,1,100.0%,24m
460,3,我们是艾尔的利刃,4664,169,9,0,9,100.0%,26m
461,1,Stalker,4659,164,4,11,15,26.7%,11m
462,1,[内蒙古海军]内蒙古人皇,4657,535,14,11,25,56.0%,27m
463,1,[加菲啊]Garfield,4656,131,5,0,5,100.0%,27m
464,1,llllllllllll,4655,422,12,12,24,50.0%,12m
465,1,全是内战,4654,634,18,15,33,54.5%,17m
466,1,[主从是好啊]樱小路游星,4653,0,0,1,1,0.0%,23m
466,1,[丨CRH丨]你好我叫高天伦,4653,0,0,1,1,0.0%,24m
468,1,aier,4652,0,0,6,6,0.0%,24m
469,1,yamato,4649,0,0,1,1,0.0%,24m
470,1,[共鸣的鸣]悲鸣的鸣,4648,496,68,11,79,86.1%,49m
471,1,Twistzz,4647,0,1,0,1,100.0%,12m
472,1,御坂美琴,4646,1387,58,45,103,56.3%,14m
473,1,[GAGA二队]Elijah,4643,42,2,0,2,100.0%,17m
474,1,[大佬请把鞋给]君心可晴,4642,2630,128,129,257,49.8%,12m
475,1,Mashiro,4641,136,3,1,4,75.0%,5m
476,1,IIIIIIIIII,4639,1602,91,80,171,53.2%,49m
477,1,代号,4638,2952,121,128,249,48.6%,12m
478,1,BiliBiliGoGo,4637,564,26,11,37,70.3%,17m
478,1,[小金上天队]宇文月树,4637,88,3,3,6,50.0%,54m
480,1,[莉莉柯林斯]BVB,4636,44,2,0,2,100.0%,5m
480,1,鸡猎毁一生,4636,0,1,0,1,100.0%,17m
482,1,llllllllllll,4635,2124,89,79,168,53.0%,49m
482,1,[皇女单推协会]Anastasia,4635,0,0,1,1,0.0%,17m
484,1,[野马星际]History,4634,36,2,0,2,100.0%,18m
484,1,igxyFANS,4634,62,2,16,18,11.1%,14m
486,1,[OLY]Invincible,4633,1335,50,40,90,55.6%,12m
486,1,[小金上天队]slahserk,4633,336,9,14,23,39.1%,17m
486,1,超级爱吃冰糖葫芦,4633,256,7,7,14,50.0%,18m
486,1,INDIVIDUAL,4633,154,4,2,6,66.7%,49m
486,1,you,4633,0,0,1,1,0.0%,27m
491,1,冷藏,4632,1548,161,155,316,50.9%,54m
491,1,[牛頭人之家]胜利属于牛頭人,4632,0,0,1,1,0.0%,5m
493,1,IIIIIIIIIIII,4631,0,1,0,1,100.0%,24m
494,1,[无銘之辈]Evidour,4628,0,3,2,5,60.0%,23m
495,1,[SoloAs]IIIIIIIIIIII,4627,0,1,0,1,100.0%,5m
496,1,[Beasty]lingyu,4624,2674,233,217,450,51.8%,5m
497,3,水银之血,4623,0,0,1,1,0.0%,52m
498,1,llllllllllll,4622,1532,339,327,666,50.9%,27m
498,1,元气少女芭芭拉,4622,452,35,9,44,79.5%,49m
498,2,[丨SLT丨]IIIIIIIIIIII,4622,0,0,1,1,0.0%,43m
501,1,北灵南落,4618,1639,144,143,287,50.2%,54m
501,1,[Beasty]lejdkjsa,4618,1082,58,56,114,50.9%,49m
501,1,[2天一盘]Reyna,4618,0,1,7,8,12.5%,54m
504,1,Zzzdy,4617,842,30,26,56,53.6%,27m
504,1,[SoloAs]Zone,4617,642,24,33,57,42.1%,12m
506,1,SanTone,4616,0,0,1,1,0.0%,12m
506,3,[晚枫]琉璃丶倾城,4616,0,0,1,1,0.0%,18m
508,1,[唐泽雪穗]糖蔗雪穗,4615,1254,62,57,119,52.1%,17m
509,1,[猪一样的盟友]神一样的高手,4614,1512,59,68,127,46.5%,27m
510,1,ShowTime,4613,0,1,0,1,100.0%,17m
511,1,[孙红雷]DreameReader,4611,0,0,1,1,0.0%,25m
511,1,[半个菜鸟]神宮寺奈绪,4611,0,0,1,1,0.0%,17m
513,1,[SK]Trap,4610,1777,79,60,139,56.8%,54m
513,1,圣光会赐予我胜利,4610,555,67,45,112,59.8%,24m
513,1,[我们是无敌的]ppxxyy,4610,421,13,8,21,61.9%,24m
516,1,捅马医生,4609,611,34,9,43,79.1%,11m
516,1,[SoIoAs]SCnpc,4609,124,3,4,7,42.9%,12m
518,1,[双手离开键盘]xingchen,4608,74,2,3,5,40.0%,19m
519,1,[SK]暴雪我是你爹,4607,314,8,8,16,50.0%,49m
520,1,[白给滴神]血花缭乱,4604,700,28,25,53,52.8%,25m
521,1,llllllllllll,4602,566,17,18,35,48.6%,17m
522,1,[我是徐佳莹]杭州孙一峰,4601,783,40,11,51,78.4%,49m
522,1,[SK]千机变,4601,418,12,8,20,60.0%,14m
522,3,[深圳老年星际]老婆看我打星际,4601,244,10,5,15,66.7%,7m
525,1,[ZJU]Zionic,4599,2125,246,262,508,48.4%,25m
525,1,[SoIoAs]血花缭乱,4599,370,15,7,22,68.2%,25m
527,1,[毒奶色]BsharpT,4598,0,1,0,1,100.0%,17m
528,1,[上分女孩]Yukino,4597,1235,51,51,102,50.0%,17m
528,1,[三浦透子]今天又是什么奶茶,4597,0,0,1,1,0.0%,24m
530,1,[TNLet]Spirit,4596,120,3,5,8,37.5%,12m
530,1,[Beasty]张天志,4596,0,1,1,2,50.0%,19m
532,1,[IMRTS]mYthRendeR,4594,2886,325,279,604,53.8%,18m
532,1,[KPG2]做个幸福的神族,4594,863,43,42,85,50.6%,14m
532,1,[YaBEEL]童码医生,4594,564,20,19,39,51.3%,17m
535,1,[Shawk]青岛安纳,4593,991,36,31,67,53.7%,24m
536,1,[CnNami]土豆豆豆,4591,1295,130,106,236,55.1%,14m
536,1,落笔画素颜,4591,359,14,12,26,53.8%,17m
536,1,倾尽天下,4591,0,0,1,1,0.0%,24m
539,1,[水光潋滟]ZZZZZZZest,4588,0,0,1,1,0.0%,24m
540,1,[Nostop]肠老潘,4587,0,0,1,1,0.0%,5m
541,1,[KPG]浅浅,4586,2076,81,92,173,46.8%,17m
541,1,[大佬请把鞋给]揽明月入怀,4586,156,5,6,11,45.5%,27m
543,1,皓彩以兑人谷,4584,0,1,0,1,100.0%,14m
543,1,[Ryon榕]FoRtiSimO,4584,0,0,1,1,0.0%,14m
545,1,[甜甜圈]牵绊,4583,1304,44,40,84,52.4%,24m
546,1,龙骑,4581,6,4,1,5,80.0%,5m
546,1,[只用异虫]美女,4581,0,1,1,2,50.0%,19m
546,1,[四叶草]老提,4581,0,0,1,1,0.0%,25m
549,1,[传说萌娘团]Shaula,4578,0,0,1,1,0.0%,11m
550,1,Cmexa,4577,196,5,7,12,41.7%,24m
551,1,[艾尔小圆盾]小野芒果,4576,1413,57,51,108,52.8%,18m
551,1,llllllllllll,4576,106,3,0,3,100.0%,49m
551,1,愿艾露恩与你同在,4576,0,0,1,1,0.0%,54m
554,1,昕儿,4575,0,0,1,1,0.0%,24m
555,1,[六芒星s]wnrpj,4574,136,3,8,11,27.3%,12m
556,1,[五月花]Gandalf,4573,238,9,5,14,64.3%,24m
557,1,llllllllll,4572,620,40,11,51,78.4%,17m
557,1,llllllllllll,4572,373,26,18,44,59.1%,12m
557,3,[WHU]SevenChen,4572,0,0,1,1,0.0%,27m
560,1,[PTB]King,4570,965,53,30,83,63.9%,17m
560,1,[魔槍]黑木玄斎,4570,188,5,11,16,31.2%,24m
562,1,[传说萌娘团]EIXA,4569,128,4,0,4,100.0%,18m
563,1,[SoloAs]这游戏好难,4567,0,0,1,1,0.0%,12m
564,1,[泰伦反谐联盟]BUFF,4566,107,2,1,3,66.7%,17m
565,1,[三千分的幽灵]沧海客,4563,925,48,27,75,64.0%,24m
565,1,[半个菜鸟]刀锋冷,4563,0,0,1,1,0.0%,12m
567,1,[丨SLT丨]柳丁,4562,84,2,12,14,14.3%,25m
567,1,[KPG]曾經最美最美曾經,4562,92,1,2,3,33.3%,14m
569,1,[寡妇雷就无敌]MagicWang,4561,2267,95,90,185,51.4%,11m
569,1,llllllllllll,4561,431,22,4,26,84.6%,11m
571,1,高阶圣堂武士,4560,2125,211,187,398,53.0%,18m
572,1,[TNLet]奈拉齐姆渣女头子,4559,1134,63,32,95,66.3%,54m
573,1,[我们是无敌的]我是球霸,4558,735,27,22,49,55.1%,5m
573,1,[混元无极星际]IIIIIIIII,4558,0,0,1,1,0.0%,24m
575,2,[欧姓玩家]KOF,4556,485,36,7,43,83.7%,17m
576,1,ggfreelancer,4552,707,27,27,54,50.0%,11m
576,2,PPP,4552,66,2,1,3,66.7%,50m
576,1,[瑶瑶公主]MAXLove,4552,0,1,1,2,50.0%,50m
579,1,[I徐佳莹I]沧海客,4551,720,25,23,48,52.1%,54m
579,2,猪猪只,4551,0,1,0,1,100.0%,43m
581,1,尤朵拉,4550,0,4,1,5,80.0%,51m
582,1,[SoloAs]ZvTvP,4548,258,9,5,14,64.3%,17m
583,1,爱你的九号,4547,48,1,3,4,25.0%,52m
584,1,[SK]菠萝丶之海,4545,262,7,11,18,38.9%,17m
585,2,[1990]斗鱼直播继良云,4544,126,5,2,7,71.4%,17m
586,2,[Beasty]KayleStorM,4542,0,1,0,1,100.0%,24m
587,1,[受死吧喵星人]TriuMph,4541,238,8,4,12,66.7%,49m
587,2,慎轩丶,4541,0,0,1,1,0.0%,50m
587,1,SDF,4541,0,0,2,2,0.0%,27m
590,1,[四叶草]remember,4539,814,26,25,51,51.0%,14m
591,1,[艾哈妹子是我]太极集团,4538,1628,57,59,116,49.1%,17m
592,2,[废墟图书館]亡蝶葬仪,4537,0,0,1,1,0.0%,50m
593,1,[EZWIN]llllllllllll,4536,2600,156,148,304,51.3%,17m
594,2,[中南大学官网]MOMO,4534,439,20,16,36,55.6%,24m
594,1,[白给的神]动作指导,4534,0,0,1,1,0.0%,53m
596,2,Lythrum,4533,0,0,1,1,0.0%,8m
597,1,IIIIIIIIIIII,4532,1430,120,118,238,50.4%,27m
598,1,超神追猎,4529,1538,55,55,110,50.0%,12m
598,1,kill,4529,70,3,9,12,25.0%,5m
600,2,[陈一发儿呀]玩小号必死亲妈,4528,0,1,0,1,100.0%,8m
600,2,[Rhusky]初音未来世界第一,4528,0,0,1,1,0.0%,50m
602,1,[OLY]Oberonia,4527,428,14,13,27,51.9%,14m
602,2,[沙包]静静的小柴犬,4527,0,1,0,1,100.0%,50m
602,2,萌萌哒的小可爱,4527,0,0,1,1,0.0%,11m
605,1,IIIIIIIIIIII,4525,1643,238,233,471,50.5%,27m
605,1,IIIIIIIIIIII,4525,76,2,7,9,22.2%,11m
607,1,吟风弄月,4524,574,16,28,44,36.4%,12m
608,2,[YR]Solresol,4522,0,0,1,1,0.0%,50m
609,2,小顾顾,4521,532,22,16,38,57.9%,6m
609,2,猪猪党,4521,76,3,2,5,60.0%,50m
611,1,[GDUT]被劝退师,4520,2398,216,221,437,49.4%,14m
611,2,[TeamNL]HooinKyoma,4520,0,1,0,1,100.0%,50m
613,2,IIIIIIIIIIII,4519,16,2,0,2,100.0%,11m
614,2,鲨鱼辣椒,4518,0,0,1,1,0.0%,11m
615,1,月下舞清影,4516,200,21,9,30,70.0%,17m
615,2,[只用随机]随机,4516,0,1,0,1,100.0%,50m
615,2,丽芙,4516,0,0,1,1,0.0%,8m
618,1,llllllllllll,4515,42,1,9,10,10.0%,12m
619,2,[天堂岛]Nero,4514,1910,90,88,178,50.6%,11m
620,2,因为我添腹一饼,4511,1083,52,45,97,53.6%,24m
620,1,[SK]超高校级的泰伦,4511,929,35,34,69,50.7%,27m
620,1,[大佬请把鞋给]月之泪,4511,230,6,13,19,31.6%,17m
623,1,[NBU]Elijah,4510,240,8,12,20,40.0%,27m
624,2,[ELSD]小鱼妹妹,4509,473,37,22,59,62.7%,50m
624,2,[抬棺大队长]IIIIIIIIIIII,4509,0,0,1,1,0.0%,24m
626,2,Naohiiiii,4508,1246,56,49,105,53.3%,17m
626,3,[KPG]松氏垂直学院,4508,276,16,2,18,88.9%,17m
628,1,[四叶草]wwww,4507,2602,111,99,210,52.9%,54m
628,2,[Fansc]ShOw,4507,0,1,0,1,100.0%,43m
630,2,[抓住疯狗]DGHfour,4506,52,2,4,6,33.3%,11m
631,2,[星之所在RI]环彩羽,4505,1258,58,39,97,59.8%,20m
631,2,[SoIoAs]小笨比血花缭乱,4505,248,10,7,17,58.8%,24m
633,2,IIIIIIIIIIII,4503,1547,91,24,115,79.1%,24m
634,2,SnowWolf,4502,0,0,1,1,0.0%,11m
635,1,[Sv]Guider,4501,2660,113,102,215,52.6%,11m
635,2,[海德单推协会]一个笨比,4501,340,18,5,23,78.3%,50m
635,1,[孙红雷]Braveheart,4501,388,12,14,26,46.2%,25m
638,1,二十四岁是沧海客,4499,1122,42,46,88,47.7%,17m
639,2,[资江钓鱼]主宰的存在,4498,512,21,18,39,53.8%,43m
640,2,Zest,4497,1005,72,20,92,78.3%,6m
640,1,IIIIIIIIIIII,4497,44,1,7,8,12.5%,11m
642,1,[Beasty]不讲武德,4496,2647,438,452,890,49.2%,54m
643,2,[髙樂集团]程丶贝贝,4495,0,0,1,1,0.0%,11m
643,2,[苏大星际]Storm,4495,0,0,1,1,0.0%,24m
643,1,Dosomething,4495,0,0,5,5,0.0%,17m
646,2,[丨SLT丨]是无解吖,4493,50,2,2,4,50.0%,24m
647,2,llllllllllll,4492,296,13,5,18,72.2%,50m
647,2,[KPG2]ATLast,4492,0,3,6,9,33.3%,6m
649,2,Keal,4489,0,0,1,1,0.0%,11m
650,2,[AnSwer]涂山容容,4487,232,10,7,17,58.8%,17m
650,2,徐家汇圣堂巡遊者,4487,0,0,1,1,0.0%,50m
650,2,[鸡饲料加工厂]丹妮莉丝龙妈,4487,0,0,1,1,0.0%,24m
653,1,强壮的得分王,4486,2819,497,507,1004,49.5%,14m
654,1,IIIIIIIIIIII,4485,1735,360,368,728,49.5%,27m
654,1,IIIIII,4485,988,35,38,73,47.9%,18m
654,1,[我们是无敌的]纵横熊猫,4485,170,5,13,18,27.8%,25m
654,2,[Rhusky]iNaive,4485,0,0,2,2,0.0%,43m
658,2,[炸鱼]沧海客,4484,622,31,12,43,72.1%,20m
658,1,TOTO,4484,154,5,7,12,41.7%,25m
658,2,今夜打老虎,4484,0,0,2,2,0.0%,6m
661,2,启明星的指引,4483,0,1,3,4,25.0%,8m
662,1,[我们是无敌的]IIIIIIIIIIII,4481,2672,192,184,376,51.1%,24m
663,2,TOTO,4480,0,0,1,1,0.0%,43m
664,1,[SK]绯想剑,4479,0,2,5,7,28.6%,49m
665,2,[SK]HavoC,4478,897,45,46,91,49.5%,43m
665,1,从零开始,4478,491,34,14,48,70.8%,5m
665,2,[Thpj]番茄,4478,0,0,1,1,0.0%,11m
665,2,无桑,4478,0,0,1,1,0.0%,24m
669,2,[OgiNA]MooN,4476,415,24,5,29,82.8%,20m
669,1,[笙风]lonely,4476,190,7,12,19,36.8%,19m
669,2,[学习使我快乐]LOST,4476,0,0,1,1,0.0%,50m
672,2,IIIIIIIIIIII,4474,2603,535,541,1076,49.7%,20m
673,2,llllllllllll,4473,72,2,6,8,25.0%,50m
674,2,[守望黎明]幼灵,4472,417,26,15,41,63.4%,24m
674,2,[YT]艾泽拉斯的探机,4472,0,0,1,1,0.0%,8m
674,2,[独自去吃大餐]风雪兼程,4472,0,0,1,1,0.0%,50m
677,2,[o星辰o]一梦恍然就如昨,4471,0,0,1,1,0.0%,20m
678,2,[1983]斗鱼直播继良云,4470,138,6,2,8,75.0%,6m
678,2,FallenSakura,4470,0,1,0,1,100.0%,43m
678,1,[80后丶]阔落加冰才好喝,4470,0,0,1,1,0.0%,47m
681,2,冷月小兔兔,4468,18,1,1,2,50.0%,20m
682,2,[AnSwer]MoNsooN,4467,0,0,1,1,0.0%,50m
683,2,FeedtheFlame,4466,16,1,1,2,50.0%,20m
684,1,Cunning,4465,528,17,30,47,36.2%,19m
684,1,[PTB]斋藤飞鸟,4465,138,4,9,13,30.8%,12m
686,2,柠檬,4464,924,43,27,70,61.4%,43m
686,2,[丨SLT丨]rewhitefans,4464,0,1,2,3,33.3%,50m
688,2,[传说萌娘团]GhostElf,4463,1579,74,80,154,48.1%,24m
688,2,三道,4463,0,1,0,1,100.0%,6m
690,1,[武汉理工大学]Classic,4462,2474,96,105,201,47.8%,12m
691,2,重生之我是拔本,4461,26,3,1,4,75.0%,50m
692,1,[武德]年轻人,4460,72,3,7,10,30.0%,19m
693,2,爱神,4459,0,1,5,6,16.7%,50m
694,2,[CLaffy]Sorrow,4458,0,0,1,1,0.0%,11m
695,2,[WIK]llllllllll,4457,208,9,7,16,56.2%,43m
695,2,[兔宫]软软萌兔,4457,0,1,0,1,100.0%,50m
697,1,奔四光棍儿老吊丝,4456,2827,301,305,606,49.7%,27m
697,2,[一个小可爱]苏云雪笙,4456,0,0,1,1,0.0%,20m
699,2,[LLC]Martin,4455,174,7,9,16,43.8%,17m
700,2,电脑,4454,651,34,20,54,63.0%,6m
700,1,[PTB]MIIIIIIIIIIc,4454,386,11,31,42,26.2%,12m
700,2,[打上花火]爱染小汐,4454,0,0,1,1,0.0%,11m
703,2,TrashP,4453,359,18,7,25,72.0%,6m
704,2,小饼,4451,324,13,13,26,50.0%,8m
704,2,[PTB]白球,4451,0,0,1,1,0.0%,50m
706,2,玉树临风灰灰灰,4447,0,0,1,1,0.0%,17m
707,2,醉笑红尘丶,4446,1429,65,58,123,52.8%,20m
708,1,[TNLet]多多泰利,4445,2758,389,414,803,48.4%,54m
708,1,CarGO,4445,144,3,7,10,30.0%,7m
710,2,SpiderYao,4444,104,3,4,7,42.9%,8m
710,2,[YMFM丶]Seele,4444,0,0,1,1,0.0%,50m
712,1,InnoVation,4442,996,50,65,115,43.5%,19m
712,1,[THX]FiNeSiTi,4442,96,2,4,6,33.3%,14m
714,1,沧海客,4440,1473,133,141,274,48.5%,11m
714,2,IIIIIIIII,4440,145,15,4,19,78.9%,11m
714,2,景严,4440,0,1,0,1,100.0%,8m
717,2,[SoloAs]IIIIIIII,4439,1198,51,56,107,47.7%,24m
718,1,llllllllllll,4438,2132,102,96,198,51.5%,14m
718,2,[Arhan]troublemaker,4438,1251,94,91,185,50.8%,20m
720,2,[中南大学官网]poi,4437,464,53,57,110,48.2%,17m
720,2,Okita,4437,352,18,9,27,66.7%,43m
722,2,llllllllllll,4436,571,30,10,40,75.0%,11m
722,2,[汉堡FANS]Printf,4436,104,4,6,10,40.0%,50m
724,1,[Beasty]小蓝,4434,821,47,51,98,48.0%,19m
724,2,[RyH键谈坊]CaptainAM,4434,0,0,1,1,0.0%,43m
726,2,[顺德有高铁]顺德小刘鸭,4433,1773,88,85,173,50.9%,50m
726,1,低调超人,4433,1288,59,64,123,48.0%,11m
726,2,[六芒星s]GGG,4433,38,2,1,3,66.7%,11m
729,2,[Hist]采风者,4432,0,1,1,2,50.0%,8m
729,2,[葡萄汁]葡萄汁,4432,0,0,1,1,0.0%,8m
731,2,[别搜内战了]LJQ,4430,50,2,8,10,20.0%,50m
732,2,[Beasty]Photon,4429,341,18,9,27,66.7%,11m
732,2,会长,4429,0,0,1,1,0.0%,17m
732,2,[晚枫]苍兰,4429,0,0,1,1,0.0%,8m
735,1,[同化已完成]叫我好哥哥啊,4428,358,7,6,13,53.8%,53m
735,2,[彼岸花开]魂魄妖梦,4428,0,0,1,1,0.0%,50m
737,2,独饮月色,4426,168,8,2,10,80.0%,11m
737,2,[烽夜长歌]我就是撒娇怎么办,4426,0,0,1,1,0.0%,43m
739,1,[第八舰队丶]IIIIIIIIIII,4425,2744,242,256,498,48.6%,11m
739,2,[学习使我快乐]Artanis,4425,88,5,2,7,71.4%,6m
739,2,[半个菜鸟]天养生,4425,0,1,0,1,100.0%,8m
742,2,[OgiNA]Fruit,4422,0,0,1,1,0.0%,43m
743,2,accelerator,4421,916,37,43,80,46.2%,50m
743,2,瓜皮一个,4421,92,3,9,12,25.0%,8m
743,2,[第八舰队丶]新宿,4421,0,1,0,1,100.0%,50m
746,2,Cavalier,4420,0,0,1,1,0.0%,8m
747,1,[CA神教]顽山木,4419,2778,339,357,696,48.7%,49m
747,2,[tiandi]饭宗的南妈妈,4419,476,21,19,40,52.5%,6m
747,2,Atns,4419,0,0,1,1,0.0%,24m
750,2,[Beasty]Damocles,4418,77,1,5,6,16.7%,11m
751,2,萌萌的小萌新,4417,1807,290,216,506,57.3%,8m
752,1,IIIIIIIIIIII,4416,1332,47,56,103,45.6%,14m
752,2,[Legacy]上尉湿人,4416,64,3,3,6,50.0%,11m
752,1,[Hist]HistOG,4416,0,0,1,1,0.0%,47m
755,2,IIIIIIIIIII,4415,2546,359,377,736,48.8%,24m
755,2,[好多小兔兔]冷月无声,4415,0,0,1,1,0.0%,24m
755,2,冷环渊,4415,0,0,1,1,0.0%,8m
758,2,[Rhusky]DragonGzh,4413,0,1,0,1,100.0%,50m
758,2,[BGD]繁星,4413,0,1,1,2,50.0%,6m
760,2,llllllllllll,4412,26,1,1,2,50.0%,43m
760,3,[ZSG]ZSGMoQY,4412,0,0,1,1,0.0%,18m
762,2,一般少女夏色祭,4411,0,0,1,1,0.0%,20m
762,2,[LSDsc2]SisterEr,4411,0,0,4,4,0.0%,43m
764,2,Heronic,4410,0,1,0,1,100.0%,50m
764,2,[SK]远坂凛,4410,24,1,1,2,50.0%,6m
766,2,[传说萌娘团]五十块的好兄弟,4409,499,24,8,32,75.0%,6m
766,2,[每日一问]暴雪今天倒闭了吗,4409,6,3,0,3,100.0%,43m
768,2,福特号,4408,176,12,10,22,54.5%,11m
769,1,[Rhusky]IceLin,4407,2467,108,119,227,47.6%,12m
769,2,Cooooooool,4407,52,2,1,3,66.7%,50m
771,1,IIIIIIIII,4405,2576,350,348,698,50.1%,24m
772,1,[TossSE]无尽的虚空,4403,2788,255,267,522,48.9%,24m
772,2,[炼丹工]OPzealot,4403,0,0,1,1,0.0%,8m
774,1,人族就输不了,4402,1057,42,48,90,46.7%,54m
774,2,[SYP]Kuroko,4402,209,11,5,16,68.8%,6m
774,2,樱花,4402,0,1,0,1,100.0%,8m
777,2,lanker,4401,2485,143,129,272,52.6%,17m
777,2,IIIIIIIIIIII,4401,0,0,1,1,0.0%,17m
777,2,[SoloAs]FTTerran,4401,0,0,1,1,0.0%,8m
780,1,[SK]BHunterB,4399,812,37,39,76,48.7%,17m
781,2,[TNLet]想想花花会怎么做,4397,349,23,7,30,76.7%,24m
781,2,胖丁追随者,4397,175,9,4,13,69.2%,11m
781,2,[HustSC]beee,4397,0,0,1,1,0.0%,43m
781,2,lhp,4397,0,0,2,2,0.0%,20m
785,2,你不要探路好不好,4396,202,19,17,36,52.8%,11m
786,2,轻狂,4395,477,35,38,73,47.9%,50m
786,3,[TZRF]血花缭润,4395,362,20,2,22,90.9%,46m
786,2,亨利大叔,4395,0,0,1,1,0.0%,24m
789,2,[SK]慧慧,4393,968,41,44,85,48.2%,20m
790,2,niVeUS,4392,842,42,33,75,56.0%,50m
790,2,[红萌馆]蓬莱人形,4392,0,0,1,1,0.0%,11m
792,2,不讲武德,4391,0,1,0,1,100.0%,8m
793,2,[SK]不开矿怎么暴兵,4390,1640,71,79,150,47.3%,17m
794,2,[SK]Twilight,4387,240,12,7,19,63.2%,24m
795,2,朽木冬子,4386,0,0,1,1,0.0%,11m
796,1,不会起名字,4385,2609,238,234,472,50.4%,11m
796,2,[叫我兔本]Larres,4385,1500,70,44,114,61.4%,6m
798,3,MiyaMiyaMiya,4384,368,21,1,22,95.5%,18m
798,3,[时光静寂流逝]月兮兰兮,4384,404,18,1,19,94.7%,7m
798,2,[新手人类]人类,4384,111,8,4,12,66.7%,24m
801,2,岱铉,4383,577,27,14,41,65.9%,6m
801,2,[星河气象学院]谁狗谁孙子,4383,0,0,1,1,0.0%,10m
803,2,[海德单推协会]CandyPaint,4382,1262,53,59,112,47.3%,50m
804,2,[衣钵之卫]吟绿颂青,4381,426,21,19,40,52.5%,17m
804,2,HECTOR,4381,16,1,7,8,12.5%,17m
806,3,永安长宁,4380,235,19,3,22,86.4%,27m
807,2,[盛先生粉丝团]求老仙奶诺不开心,4379,87,2,1,3,66.7%,50m
807,2,llllllllllll,4379,0,0,1,1,0.0%,50m
809,2,拳王破阵曲,4378,36,5,3,8,62.5%,50m
809,2,林夕,4378,0,0,1,1,0.0%,17m
811,1,我是你爹,4377,2506,269,269,538,50.0%,50m
811,2,敌法出跳,4377,78,3,4,7,42.9%,20m
813,2,[四叶草]明理知秋,4376,2047,170,148,318,53.5%,6m
814,2,御坂菱,4374,772,30,34,64,46.9%,8m
814,2,IIIIIIIIIIII,4374,0,1,0,1,100.0%,11m
814,2,[武汉理工大学]Stats,4374,0,1,0,1,100.0%,6m
817,2,llllllllllll,4373,1585,241,221,462,52.2%,11m
818,2,[C41474]诺娃,4372,0,0,1,1,0.0%,50m
819,2,[Batman]Restart,4371,82,1,1,2,50.0%,6m
820,2,刚玩星际大佬轻虐,4370,1191,124,76,200,62.0%,50m
820,2,[各种无敌者]Over,4370,0,1,0,1,100.0%,17m
820,2,Jun,4370,0,0,1,1,0.0%,8m
823,2,[五月花]暴打养鸡场,4369,0,4,1,5,80.0%,8m
823,2,[丨SLT丨]洪承畴,4369,0,2,3,5,40.0%,28m
825,3,[羊驼羊驼羊]IIIIIIIIIIII,4368,220,20,1,21,95.2%,27m
826,2,[小仙女联盟]全斗焕大统领,4367,79,2,0,2,100.0%,20m
827,2,[红魔SDEP]古龙顶端宝石虫,4366,1039,45,41,86,52.3%,50m
828,2,IIIIIIIIIIII,4364,2386,199,212,411,48.4%,25m
828,2,[KPG]IIIIIIIIIIII,4364,1277,134,138,272,49.3%,50m
828,2,安静,4364,1182,62,35,97,63.9%,50m
828,1,[YU]新谷灯华,4364,620,19,28,47,40.4%,5m
832,2,黄金脆皮鸡,4363,0,3,2,5,60.0%,20m
832,1,[冲就完了]星际捷尔任斯基,4363,193,3,5,8,37.5%,52m
834,2,[ScAPs]藤原妹红,4362,0,1,0,1,100.0%,20m
835,2,[DMRz]LVn,4361,0,0,1,1,0.0%,50m
836,2,Snow,4360,1344,66,29,95,69.5%,20m
836,2,我爱你有左灯右行,4360,438,45,32,77,58.4%,20m
836,2,[OB丶]浪荡少女橘子酱,4360,527,35,8,43,81.4%,20m
836,2,[青娱乐]火枪手,4360,48,3,6,9,33.3%,43m
840,2,[SK]偷花贼,4359,838,62,69,131,47.3%,25m
840,2,llllllllllll,4359,1079,61,33,94,64.9%,8m
840,1,无昵称,4359,1714,57,76,133,42.9%,5m
840,2,[燕大SC]llllllllll,4359,91,4,0,4,100.0%,6m
844,1,MemOry,4358,48,2,2,4,50.0%,51m
844,3,谁扔的炮仗,4358,0,1,0,1,100.0%,21m
844,3,[上分女孩]Neko,4358,0,0,1,1,0.0%,6m
844,3,[SoloAs]薛定谔的猫,4358,0,0,1,1,0.0%,28m
848,3,[快乐泰伦人]LiquidThemry,4355,0,1,0,1,100.0%,6m
849,1,[SoloAs]无名王者,4352,2745,285,311,596,47.8%,17m
849,2,[希靈使徒]秋月爱莉,4352,468,28,8,36,77.8%,43m
849,3,[传说萌娘团]wjh,4352,0,1,0,1,100.0%,18m
852,2,[烽夜长歌]IIIIIIIIIIII,4351,2096,142,136,278,51.1%,20m
852,3,[SoloAs]索尼克,4351,0,0,1,1,0.0%,52m
854,2,[斧头帮x]magiczerg,4350,490,22,21,43,51.2%,17m
855,3,[是我赢了]一只小萌新,4349,508,27,14,41,65.9%,52m
855,2,[教我玩神族]时崎狂北小北姬,4349,44,2,5,7,28.6%,8m
857,2,chaos,4348,85,2,2,4,50.0%,43m
858,2,IIIIIIIIIIII,4347,0,0,2,2,0.0%,52m
859,1,Silence,4346,2549,204,225,429,47.6%,55m
859,2,[SK]NewXiaoBo,4346,1250,52,58,110,47.3%,50m
859,3,[我是一只机]雪夜音,4346,0,1,0,1,100.0%,22m
862,1,黑无常,4345,288,15,0,15,100.0%,51m
863,1,[SK]balabala,4344,2171,169,188,357,47.3%,19m
863,3,MPF,4344,136,15,11,26,57.7%,53m
865,3,开门暗影卫队,4343,16,2,0,2,100.0%,7m
865,1,[YA]FaNsorSK,4343,97,1,2,3,33.3%,47m
867,3,NuclearPiano,4340,375,23,3,26,88.5%,7m
868,2,Error,4339,50,2,10,12,16.7%,50m
869,2,黄子韬,4338,117,4,4,8,50.0%,11m
869,3,中断之吻,4338,8,2,0,2,100.0%,21m
869,3,iconfour,4338,0,0,1,1,0.0%,7m
869,2,[哔翻天梯鸡]Sunny,4338,0,0,11,11,0.0%,6m
873,1,llllllllllll,4337,2670,251,264,515,48.7%,50m
874,3,[衣钵之卫]我才不是小辣鸡,4336,643,47,25,72,65.3%,46m
874,3,大神澪,4336,150,11,6,17,64.7%,6m
874,3,bigwhitefish,4336,6,1,1,2,50.0%,28m
877,2,IIIIIIIIIII,4335,1554,62,74,136,45.6%,20m
877,3,[蕙质兰心]呐呐呐,4335,0,1,0,1,100.0%,17m
877,3,[IGS]是逗比还是逗逼,4335,0,0,1,1,0.0%,46m
880,2,[青铜树]rain,4334,1612,75,72,147,51.0%,50m
881,3,[HFUOT]Weirdo,4332,659,46,42,88,52.3%,7m
881,3,IIIIIIIIIIII,4332,0,0,1,1,0.0%,22m
883,3,[只想一直空想]PLongBao,4331,448,22,2,24,91.7%,53m
884,3,春日野穹,4330,416,22,3,25,88.0%,18m
884,2,[SC2近卫军]果果,4330,92,2,3,5,40.0%,50m
886,2,姜小鱼,4328,2544,1254,1298,2552,49.1%,50m
886,2,[Flowex]Rain,4328,2549,204,213,417,48.9%,43m
886,2,桂马香车,4328,1752,68,78,146,46.6%,25m
889,2,[异乱II]Taxi,4327,1174,49,62,111,44.1%,11m
889,3,金陵吕布,4327,264,19,14,33,57.6%,18m
891,3,你吗临死前,4324,475,23,11,34,67.6%,27m
892,2,[Warp]希格斯玻色子,4323,734,33,30,63,52.4%,20m
892,3,KearFernLyy,4323,0,1,0,1,100.0%,6m
892,3,[北京城管]woodsock,4323,0,1,0,1,100.0%,17m
892,3,[Psy保安]咖啡豆,4323,0,0,1,1,0.0%,6m
896,1,SOS,4322,1853,80,85,165,48.5%,11m
896,2,流光,4322,1668,76,52,128,59.4%,8m
896,2,未闻花名,4322,677,29,33,62,46.8%,11m
896,2,[六芒星s]CarolMalus,4322,215,9,8,17,52.9%,6m
900,2,[库啵啵库啵]快乐的小鸡,4321,935,47,39,86,54.7%,50m
901,1,桐生马子,4320,2711,188,213,401,46.9%,5m
902,3,我混上去的不用慌,4319,410,21,4,25,84.0%,52m
902,2,贱狗,4319,309,16,24,40,40.0%,3m
902,3,[工蜂无限多]宏机制无敌泽格,4319,28,2,3,5,40.0%,17m
902,3,美好的远方,4319,22,2,4,6,33.3%,28m
902,3,[ANNEX]昭之吹风机,4319,0,0,1,1,0.0%,18m
902,3,[大叔同盟]炸天帮徐缺,4319,0,0,1,1,0.0%,22m
908,2,Jaehyung,4318,1682,90,91,181,49.7%,17m
908,3,[隐杀]xicn,4318,123,2,3,5,40.0%,52m
910,1,IIIIIIIIIIII,4317,2655,165,182,347,47.6%,27m
910,1,chinahudie,4317,2301,143,166,309,46.3%,5m
912,1,Twistzz,4316,2638,323,342,665,48.6%,11m
912,2,农奴要翻身,4316,2511,314,316,630,49.8%,3m
912,3,[Beasty]想想凛宝会怎么做,4316,292,17,18,35,48.6%,6m
912,3,密斯姐姐的斯密,4316,114,13,9,22,59.1%,6m
912,3,[卡吧基佬]洋葱,4316,0,1,0,1,100.0%,22m
917,3,刘珂嘉最帅,4313,396,21,3,24,87.5%,17m
917,1,SaintLouis,4313,265,6,3,9,66.7%,51m
917,3,[Holyam]芥子尘,4313,16,3,0,3,100.0%,18m
920,2,[金灿灿狙击队]你尽然不知道韬哥,4312,1491,94,84,178,52.8%,50m
920,2,小海,4312,0,3,3,6,50.0%,52m
920,3,[我好冷]lllllllll,4312,0,0,1,1,0.0%,28m
923,3,电脑,4311,0,0,1,1,0.0%,27m
924,1,左砍树右砍树,4310,2687,112,128,240,46.7%,25m
924,2,修地堡牛大爷,4310,943,81,87,168,48.2%,17m
924,3,Remile,4310,464,51,25,76,67.1%,46m
927,3,[HustSC]ForSaber,4309,0,1,0,1,100.0%,53m
927,1,[致逝去的青春]百变虫族,4309,0,0,1,1,0.0%,46m
929,3,IIIIIIIIIIII,4308,40,5,1,6,83.3%,18m
929,3,[NUAA]AiurProbe,4308,34,3,4,7,42.9%,48m
929,3,[爱吃鱼的赤瞳]IIIIIIIIIIII,4308,0,0,1,1,0.0%,27m
932,3,[X英雄圣域X]欧洲雄狮猛男,4307,78,6,4,10,60.0%,27m
933,2,[异乱]仙再见,4306,2555,376,391,767,49.0%,8m
933,3,胡尼玛,4306,168,12,9,21,57.1%,7m
933,3,[DBER]硬顶,4306,0,1,0,1,100.0%,17m
936,2,[ANNEX]啊呀,4305,2260,117,127,244,48.0%,11m
936,3,二叔叔二,4305,408,21,4,25,84.0%,6m
936,2,[XMG00]hero,4305,456,16,26,42,38.1%,11m
936,3,koala,4305,0,1,0,1,100.0%,28m
940,3,[FsA]永远鲜红的幼月,4304,18,2,2,4,50.0%,17m
941,1,[SoloAs]Tkak,4303,2627,153,163,316,48.4%,14m
941,3,[慢手e族]Also,4303,0,0,1,1,0.0%,22m
943,3,[Holygl]ruirui,4302,0,0,1,1,0.0%,18m
944,3,[杀虫]玄光,4299,620,69,48,117,59.0%,46m
945,3,[德莉莎]Bronya,4298,0,0,1,1,0.0%,28m
946,3,[KPG2]Lotus,4297,334,20,13,33,60.6%,7m
946,3,[狗头狗头]shino,4297,224,11,1,12,91.7%,27m
946,3,[sky圣殿]哦嚯完蛋,4297,0,0,1,1,0.0%,47m
949,2,[Holyam]LUCKGODSPEED,4295,1440,60,76,136,44.1%,3m
949,3,ZestFans,4295,98,6,10,16,37.5%,53m
951,3,西西不嘻嘻,4294,0,1,2,3,33.3%,18m
952,3,hero,4292,1816,111,75,186,59.7%,52m
953,1,[五月花]歨冥谷乂,4291,2703,191,194,385,49.6%,12m
953,3,[德意志之心]Kirito,4291,1190,63,37,100,63.0%,27m
953,3,[Ogier]邪王真眼,4291,46,3,3,6,50.0%,7m
956,3,[寂灵]甜橙,4290,219,60,1,61,98.4%,28m
956,3,恶魔史莱姆,4290,443,40,34,74,54.1%,27m
956,2,[SCAP]YoukoYo,4290,42,2,10,12,16.7%,50m
956,3,[Solo]LosTATlantis,4290,0,1,0,1,100.0%,27m
956,3,gongfu,4290,0,1,4,5,20.0%,48m
961,2,[SoloAs]电脑卡的一逼,4289,1342,78,82,160,48.8%,3m
961,3,[卑微的星灵]ZTimba,4289,426,21,4,25,84.0%,28m
963,2,天机,4287,1392,103,47,150,68.7%,50m
964,3,[CMU]张挺拔,4286,727,198,192,390,50.8%,27m
964,3,香蕉你个不楠楠,4286,316,14,12,26,53.8%,7m
964,3,[好多小兔兔]MIB,4286,148,3,7,10,30.0%,17m
967,3,[SSB]WDNMD,4284,421,29,11,40,72.5%,48m
968,3,[IMRTS2]llllllllllll,4283,0,1,0,1,100.0%,6m
968,3,[寰宇]彗星,4283,0,0,1,1,0.0%,22m
970,1,[他上王者]红叶,4282,852,28,45,73,38.4%,25m
970,3,花葬,4282,14,2,3,5,40.0%,46m
972,3,EMINEM,4281,0,1,0,1,100.0%,53m
973,3,[TossLL]等你一秒钟,4280,0,0,1,1,0.0%,27m
974,3,圣地亚哥伯纳乌,4279,0,0,1,1,0.0%,18m
974,3,幻丨瞳,4279,0,0,2,2,0.0%,18m
974,2,jimdebaba,4279,0,0,5,5,0.0%,22m
977,2,llllllllllll,4277,1619,74,65,139,53.2%,11m
977,3,[从来不打正面]甜食超人,4277,266,24,17,41,58.5%,18m
977,1,[那里不可以]Croaker,4277,288,7,12,19,36.8%,52m
977,3,[YM]yaN,4277,0,1,0,1,100.0%,7m
977,3,声音大点听不见,4277,0,1,0,1,100.0%,27m
982,2,LiquidTaeJa,4276,1589,177,182,359,49.3%,17m
983,2,[KPG]Alostof,4274,2482,326,330,656,49.7%,8m
983,2,IIIIIIIIIIII,4274,171,9,9,18,50.0%,3m
983,3,[噗噗噗]光之影面,4274,28,4,5,9,44.4%,21m
983,3,[小金上天队]己莫为,4274,12,2,0,2,100.0%,17m
987,3,天然的菜菜,4273,118,11,6,17,64.7%,28m
988,3,沙河口南波万,4272,1613,213,196,409,52.1%,53m
988,3,llllllllllll,4272,1492,75,56,131,57.3%,53m
988,3,[ESP三队]启元,4272,0,1,2,3,33.3%,53m
991,2,简单电脑,4271,274,13,13,26,50.0%,20m
991,3,我真的不会玩追猎,4271,0,1,0,1,100.0%,18m
993,2,[SteEng]JediDiah,4270,970,41,52,93,44.1%,50m
993,3,[我们是无敌的]月落星辰,4270,237,28,5,33,84.8%,21m
993,3,[BGD]星灵棱镜威力变身,4270,0,1,0,1,100.0%,46m
993,3,[艾尔难民]哭弱就会加强,4270,0,1,1,2,50.0%,21m
997,3,[SK]Fantasy,4269,56,5,3,8,62.5%,18m
998,2,llllllllllll,4268,48,4,2,6,66.7%,25m
999,2,[突然亮出宝贝]Screaming,4267,411,21,22,43,48.8%,11m
999,3,IIIIIIIIIIII,4267,0,1,0,1,100.0%,47m
1001,2,[SK]欲沐东湖,4266,1496,63,72,135,46.7%,8m
1002,3,[还是选赵敏吧]OsharasShiel,4265,0,1,0,1,100.0%,28m
1002,3,IIIIIIIIIIII,4265,6,1,4,5,20.0%,7m
1002,3,祭幻,4265,0,0,1,1,0.0%,27m
1005,2,[大阪男同王]言尽,4264,1401,62,68,130,47.7%,20m
1005,3,[SK]圣光小熊,4264,44,5,3,8,62.5%,22m
1007,3,[炮炮]炮炮,4262,14,1,1,2,50.0%,47m
1008,2,[学姐是我的]樱岛麻衣,4261,84,5,10,15,33.3%,3m
1009,2,[TShark]linyujoker,4260,875,40,43,83,48.2%,8m
1009,3,Relive,4260,22,2,0,2,100.0%,52m
1009,3,[斯巴达血战团]独步杀戮,4260,0,1,0,1,100.0%,21m
1012,1,选神族或选胜利,4259,429,10,7,17,58.8%,47m
1012,3,喵小影家黑猪,4259,24,5,0,5,100.0%,18m
1012,3,[暴雪十四队]我是个萌新,4259,28,4,2,6,66.7%,18m
1015,3,阿萨辛,4258,0,0,1,1,0.0%,7m
1015,2,[暴雪我是你爹]lllllllll,4258,0,0,2,2,0.0%,14m
1017,3,[无敌neeb]東条希,4257,0,0,1,1,0.0%,46m
1018,3,[RyH魔力鸭]Royal,4256,1601,200,182,382,52.4%,53m
1018,2,IIIIIIIIIIII,4256,1521,100,101,201,49.8%,50m
1018,3,likejuly,4256,566,69,60,129,53.5%,46m
1018,3,sine,4256,93,6,4,10,60.0%,22m
1018,3,不打内战,4256,0,2,0,2,100.0%,21m
1018,3,llllllllllll,4256,0,0,1,1,0.0%,48m
1024,3,九条都,4255,346,19,5,24,79.2%,6m
1024,3,[KPG]龟田一峰,4255,0,2,3,5,40.0%,52m
1024,3,阿贡,4255,0,0,1,1,0.0%,28m
1027,3,[偏执王]亚莉基菈,4254,121,21,6,27,77.8%,7m
1027,3,[四叶草]折纸冰雨冷扇阁,4254,0,0,1,1,0.0%,22m
1029,3,Leon,4253,1566,92,87,179,51.4%,6m
1029,3,[六爷唯一女粉]六花妹,4253,186,6,12,18,33.3%,48m
1029,1,AzzzQa,4253,48,2,1,3,66.7%,46m
1029,2,咘溪,4253,0,1,0,1,100.0%,5m
1029,3,[ZJU]SmallPotato,4253,0,1,0,1,100.0%,17m
1034,3,[小金上天队]久睡成瘾,4252,20,1,1,2,50.0%,52m
1035,3,[闪电尾汁酱]贪婪的星灵,4251,1408,80,60,140,57.1%,7m
1036,3,IIIIIIIIIIII,4249,20,10,7,17,58.8%,22m
1036,3,[ToHo]Thefuture,4249,0,0,1,1,0.0%,17m
1038,2,[艾尔之主]subjunctive,4248,2523,404,410,814,49.6%,3m
1038,3,[Aaron]阿荣,4248,4,3,0,3,100.0%,21m
1038,3,[呆呆丶]绵绵的呆呆,4248,0,0,1,1,0.0%,6m
1041,3,[我高贵的族人]暗影独行,4247,0,1,0,1,100.0%,17m
1041,3,llllllllllll,4247,0,0,1,1,0.0%,7m
1043,3,[只用人类]人类,4246,0,1,1,2,50.0%,6m
1043,3,[PTB]穹鸟隔阂,4246,6,1,2,3,33.3%,53m
1043,3,[緋色月下]Hanser,4246,0,0,1,1,0.0%,47m
1043,3,llllllllll,4246,0,0,2,2,0.0%,27m
1047,3,若雪丶心殇,4245,739,51,24,75,68.0%,46m
1047,3,潇湘夜雨,4245,0,0,1,1,0.0%,52m
1049,2,[Fiend]silence,4244,1824,181,179,360,50.3%,17m
1049,3,[Thpj]NaUShiKa,4244,44,3,5,8,37.5%,27m
1051,2,IIIIIIIIIIII,4242,71,16,21,37,43.2%,3m
1051,3,Edward,4242,0,1,0,1,100.0%,7m
1051,1,[风寄百里]Team,4242,0,0,1,1,0.0%,50m
1054,3,[孙红雷]南京孙一峰,4241,0,1,0,1,100.0%,18m
1054,3,[我们的奇迹]我即是虫群,4241,0,0,1,1,0.0%,47m
1056,3,[武汉理工大学]小刀哥,4240,1239,230,187,417,55.2%,7m
1056,3,[AnSwer]Swaying,4240,18,3,3,6,50.0%,18m
1056,3,xiaoz,4240,20,2,4,6,33.3%,21m
1056,2,sue,4240,0,0,1,1,0.0%,26m
1060,2,[第七舰队丶]阿尔萨斯,4239,2444,347,355,702,49.4%,8m
1060,3,麻辣鱼丸,4239,2318,178,165,343,51.9%,7m
1060,3,[徐佳莹]鹤太太,4239,317,13,2,15,86.7%,47m
1060,3,[黑粉头子]青肆,4239,74,4,9,13,30.8%,6m
1060,3,[浪啊浪]忘记你需要多久,4239,0,1,0,1,100.0%,53m
1060,3,[情谊至上]闪击英雄,4239,4,1,1,2,50.0%,53m
1066,3,妖娆玖玖,4238,0,0,1,1,0.0%,7m
1067,2,[舞鹤海军工厂]特型吹雪级晓,4237,0,1,1,2,50.0%,22m
1068,3,上海拆迁户,4236,983,284,273,557,51.0%,7m
1068,3,IIIIIIIIIIII,4236,0,1,0,1,100.0%,18m
1070,3,wenboyang,4235,10,2,2,4,50.0%,18m
1070,3,llllllllllll,4235,0,1,0,1,100.0%,7m
1072,3,[Tricky]IIIIIIIIIII,4234,787,49,38,87,56.3%,6m
1072,3,[Beasty]混元星际门诺诺,4234,32,3,2,5,60.0%,28m
1072,2,雅儿贝德,4234,0,1,0,1,100.0%,14m
1072,3,灵幻河谷,4234,0,1,0,1,100.0%,53m
1072,3,[QWQa]小凛,4234,0,0,1,1,0.0%,21m
1072,3,[ESP三队]Voldemort,4234,0,0,1,1,0.0%,53m
1072,3,Alex,4234,0,0,1,1,0.0%,46m
1079,3,小小小越越,4233,0,1,0,1,100.0%,7m
1079,3,[HustSC]疯人病院的腿控,4233,0,0,1,1,0.0%,17m
1079,3,beieifjs,4233,0,0,1,1,0.0%,17m
1082,1,张小连,4231,2435,141,143,284,49.6%,25m
1082,3,加把劲骑士,4231,0,1,0,1,100.0%,6m
1084,2,[RBO]Aiur,4230,2407,134,140,274,48.9%,20m
1084,3,GGjinjin,4230,0,1,0,1,100.0%,17m
1086,3,[星灵守卫者]Crimsonxi,4229,449,25,9,34,73.5%,17m
1086,1,[希靈使徒]溪边花,4229,235,13,1,14,92.9%,22m
1086,3,IIIIIIIIII,4229,0,1,0,1,100.0%,21m
1086,3,[lover]你猜嘞,4229,0,0,1,1,0.0%,53m
1090,3,带你去看流星雨,4228,276,11,5,16,68.8%,6m
1090,3,[TPoA]星辰,4228,0,1,0,1,100.0%,48m
1090,2,EffOrt,4228,0,0,1,1,0.0%,14m
1093,3,[我高贵的族人]Kurumi,4227,413,17,2,19,89.5%,8m
1093,3,GEASS,4227,10,2,2,4,50.0%,47m
1093,3,丨银河丶,4227,0,1,2,3,33.3%,6m
1096,3,帝国交大,4226,291,21,5,26,80.8%,17m
1096,2,IIIIIIIIIIII,4226,262,12,21,33,36.4%,3m
1098,3,[玩一玩]小脑斧,4224,445,20,17,37,54.1%,8m
1098,3,棋客,4224,30,3,6,9,33.3%,6m
1098,3,[北京大学鸡协]SkyHaitian,4224,0,0,1,1,0.0%,21m
1101,3,[巨像吊炸天]智如智如,4223,288,16,8,24,66.7%,17m
1101,3,[HNU]INnoVation,4223,0,1,0,1,100.0%,21m
1103,3,[四叶草]xixi,4221,202,29,10,39,74.4%,28m
1103,3,xwinder,4221,589,29,12,41,70.7%,22m
1103,3,全宇宙最帅的男人,4221,569,26,8,34,76.5%,28m
1106,3,[洛丹伦的雨夜]乄迷丨途灬,4220,98,5,3,8,62.5%,22m
1107,3,[四叶草]PPT,4219,314,16,12,28,57.1%,27m
1107,3,[帝国交大]请开始你的表演,4219,16,2,4,6,33.3%,7m
1107,3,[雇佣兵]仁凶,4219,0,1,0,1,100.0%,6m
1110,3,LDDDD,4218,981,74,48,122,60.7%,48m
1110,2,[神族真简单]MaXWell,4218,202,28,27,55,50.9%,11m
1110,3,[ErebuS]IIIIIllllIlI,4218,8,1,1,2,50.0%,27m
1113,3,[Thpj]小跳虫,4216,56,7,7,14,50.0%,46m
1113,3,Septem,4216,0,0,1,1,0.0%,21m
1115,3,llllllllllll,4215,568,46,48,94,48.9%,22m
1116,2,[纨绔才孑]牛人,4214,92,6,1,7,85.7%,24m
1117,2,以圣光之名,4213,229,20,33,53,37.7%,25m
1117,3,发椿人,4213,145,7,5,12,58.3%,18m
1117,3,婉茹小仙女,4213,0,1,0,1,100.0%,22m
1120,3,一峰吃炸鸡,4212,2099,154,143,297,51.9%,48m
1121,2,IiIiIiIiIiI,4211,2477,319,338,657,48.6%,17m
1121,2,[JJJ]xixihoholala,4211,1850,171,158,329,52.0%,6m
1123,3,月苍茫,4210,700,36,17,53,67.9%,18m
1123,2,[D7]zimart,4210,66,5,13,18,27.8%,25m
1123,3,[白翎舰队]离殇,4210,0,0,1,1,0.0%,22m
1126,3,[lover]你猜,4209,0,0,1,1,0.0%,53m
1127,3,nanjolno,4208,136,14,13,27,51.9%,22m
1127,3,shuige,4208,0,0,2,2,0.0%,18m
1129,2,[雾雨魔法森林]萌萌铃仙酱,4207,46,2,0,2,100.0%,10m
1129,3,忽远忽近的洒脱,4207,0,0,1,1,0.0%,28m
1131,3,[ToHo]susvara,4206,0,0,1,1,0.0%,48m
1131,3,蚊子,4206,0,0,1,1,0.0%,28m
1131,3,[休伯利亚号]lyj,4206,0,0,1,1,0.0%,17m
1134,2,[KD]Falcon,4205,2479,168,186,354,47.5%,25m
1134,1,派大星星,4205,323,15,5,20,75.0%,7m
1134,3,[中南大学官网]邓紫棋,4205,0,0,1,1,0.0%,21m
1134,3,Carolinena,4205,0,0,1,1,0.0%,48m
1138,2,IIIIIIIIIII,4204,1365,129,134,263,49.0%,20m
1139,3,[阴间战术天才]京九,4203,355,58,20,78,74.4%,17m
1139,3,[铭刻於红魂丶]泄矢诹访子,4203,0,0,1,1,0.0%,7m
1139,3,[洛水伊人]凉城旧梦丶,4203,0,0,1,1,0.0%,48m
1139,2,sos,4203,0,0,5,5,0.0%,10m
1143,3,Today,4202,1495,130,99,229,56.8%,53m
1143,3,IIIIIIIIIIII,4202,1488,117,79,196,59.7%,21m
1143,3,HimikoToga,4202,276,21,24,45,46.7%,53m
1143,3,Max,4202,114,9,10,19,47.4%,48m
1143,3,IIIIIIIIIIII,4202,28,4,3,7,57.1%,21m
1148,3,[见同族就GG]IIIIIIIIII,4201,1224,116,91,207,56.0%,27m
1148,3,初生婴儿,4201,741,101,85,186,54.3%,46m
1148,3,[专业时代僵尸]Tempted,4201,265,38,12,50,76.0%,18m
1148,2,[传说萌娘团]泰伦很努力哦,4201,461,22,24,46,47.8%,3m
1148,3,[Shawk]不要炸鱼了,4201,0,0,1,1,0.0%,46m
1153,3,[Misty]星海迷航,4200,295,13,14,27,48.1%,6m
1153,3,苏珊杰克逊,4200,34,5,4,9,55.6%,22m
1153,3,[神庙]hello,4200,0,0,1,1,0.0%,18m
1153,3,[Beauty]RainBowBlaXX,4200,0,0,1,1,0.0%,17m
1157,3,[Beasty]白衣夜歌行丶,4199,0,0,1,1,0.0%,6m
1157,3,[神虫一家亲]bule,4199,0,0,1,1,0.0%,28m
1159,3,[废墟图书館]KelThuzad,4198,113,18,15,33,54.5%,48m
1160,3,DDaLL,4197,742,33,15,48,68.8%,18m
1161,3,地火明夷,4196,287,64,49,113,56.6%,6m
1161,3,ggplay,4196,0,1,0,1,100.0%,53m
1161,3,驻马店最强级别人,4196,16,1,2,3,33.3%,46m
1161,3,韭菜哥,4196,0,0,1,1,0.0%,18m
1165,3,艾尔祖宗,4195,392,111,103,214,51.9%,27m
1165,3,越前龙雅,4195,66,9,12,21,42.9%,21m
1165,3,king,4195,18,2,3,5,40.0%,8m
1165,3,[WeOnE]STYslemy,4195,0,0,1,1,0.0%,48m
1165,3,[谐星TV]涵意,4195,0,0,1,1,0.0%,28m
1165,3,[菊园三结义]IIIIIIIIIIII,4195,0,0,1,1,0.0%,18m
1171,3,NADA,4194,1684,78,79,157,49.7%,6m
1171,3,[Sv]版小将,4194,518,20,13,33,60.6%,48m
1171,3,东临碣石有遗篇,4194,0,0,1,1,0.0%,48m
1174,3,llllllllllll,4193,1425,138,124,262,52.7%,6m
1174,3,一个小锤子,4193,781,46,35,81,56.8%,17m
1174,3,[闪电伍连鞭]茶水,4193,390,16,3,19,84.2%,8m
1174,3,[暴雪我是你爹]RNMsbBLZ,4193,22,4,2,6,66.7%,6m
1174,3,[Rhusky]IOIO,4193,14,2,1,3,66.7%,27m
1174,3,[CNboys]Surika,4193,0,0,1,1,0.0%,6m
1174,3,[废墟图书館]炎雀,4193,0,0,1,1,0.0%,28m
1174,3,水白菜,4193,0,0,2,2,0.0%,48m
1182,3,yulouyue,4192,0,0,1,1,0.0%,48m
1183,3,[凸一v一凸]halu,4190,2323,168,157,325,51.7%,53m
1183,3,不服就干,4190,1577,139,133,272,51.1%,8m
1183,3,[扫黄]魔法少女唐可可,4190,635,53,31,84,63.1%,48m
1183,3,[Thpj]冬马和纱,4190,6,1,3,4,25.0%,6m
1187,3,[三鞭不倒]阿萨姆,4189,457,60,44,104,57.7%,46m
1187,3,[KPG]xinshou,4189,553,35,39,74,47.3%,17m
1187,3,[tiandi]鹿目圆香,4189,36,6,6,12,50.0%,7m
1187,3,TiempO,4189,0,0,1,1,0.0%,46m
1191,3,啤酒,4188,311,35,15,50,70.0%,28m
1191,3,lllllllllll,4188,52,5,12,17,29.4%,21m
1191,3,[一块晶体矿]白白胖胖一坨肉,4188,0,0,2,2,0.0%,21m
1194,3,IIIIIIIII,4187,2027,220,193,413,53.3%,7m
1194,3,[HTW]手无缚鸡之力,4187,691,68,23,91,74.7%,48m
1194,3,[Mikon]血统纯净的喵星人,4187,666,28,11,39,71.8%,52m
1194,3,此间的少年,4187,0,0,1,1,0.0%,17m
1194,3,[军姬]本渡枫,4187,0,0,1,1,0.0%,48m
1194,3,大蝙蝠,4187,0,0,1,1,0.0%,48m
1200,3,[天女座]雪姬之神,4186,0,0,1,1,0.0%,28m
1201,3,[练出来了协会]recO,4185,0,3,5,8,37.5%,6m
1201,3,[KSARet]LIFEISHARD,4185,0,0,1,1,0.0%,7m
1203,3,KIR,4184,219,48,32,80,60.0%,27m
1203,3,我叫张大嘴,4184,8,1,2,3,33.3%,22m
1203,3,网一亡者,4184,0,0,1,1,0.0%,52m
1206,3,安达垣爱姬,4183,2307,553,495,1048,52.8%,52m
1206,3,[五月花]神之宣告,4183,707,33,15,48,68.8%,53m
1206,3,[诡诈]诡诈,4183,359,21,1,22,95.5%,53m
1206,3,Bazinga,4183,0,0,1,1,0.0%,18m
1206,3,[辉煌华夏]jiaserj,4183,0,0,1,1,0.0%,48m
1206,3,[HK丶S]广末,4183,0,0,1,1,0.0%,7m
1206,3,会长,4183,0,0,2,2,0.0%,52m
1213,3,IIIIllllllI,4182,42,5,5,10,50.0%,46m
1214,3,修地堡单矿一波,4181,160,14,18,32,43.8%,22m
1214,3,[我们的奇迹]最后的神之长子,4181,0,0,1,1,0.0%,48m
1216,3,[ISMU星际]Icecream,4180,978,106,103,209,50.7%,7m
1216,3,[IMRTS2]DeadpooL,4180,406,22,23,45,48.9%,46m
1216,3,[我们菜的1b]北虚川,4180,0,1,3,4,25.0%,21m
1216,3,OblivioN,4180,0,0,1,1,0.0%,18m
1216,3,[木星重工]ygtggggggggg,4180,0,0,1,1,0.0%,22m
1221,3,[肉鸡的饲养]rorisaiko,4179,1507,153,122,275,55.6%,48m
1221,2,[醉生梦死]眼眸印溫柔,4179,633,74,70,144,51.4%,20m
1221,3,[别圈养我]Accelerator,4179,535,31,19,50,62.0%,52m
1221,3,那你真的很棒帮哦,4179,91,12,0,12,100.0%,48m
1221,3,whybwhyb,4179,97,2,0,2,100.0%,27m
1221,2,IIIIIIIIIIII,4179,0,2,3,5,40.0%,53m
1227,3,zjh,4178,940,89,66,155,57.4%,7m
1227,3,[暴雪十五队]LXPartinG,4178,181,31,23,54,57.4%,6m
1227,3,[X星核战队X]Undefined,4178,99,4,1,5,80.0%,21m
1227,3,[肉鸡的饲养]魔法少女秦心酱,4178,0,0,1,1,0.0%,48m
1227,3,[孙某人上天队]magiclin,4178,0,0,1,1,0.0%,6m
1227,3,[J1nAir]Trap,4178,0,0,1,1,0.0%,21m
1233,3,[你画我瞎]究极神兵绝境战,4177,739,108,82,190,56.8%,22m
1233,3,[游戏风云OL]二次元刀酱,4177,960,70,52,122,57.4%,7m
1233,3,GXT,4177,158,49,6,55,89.1%,28m
1233,3,[NPUED]Stalker,4177,807,38,18,56,67.9%,52m
1233,2,llllllllllll,4177,42,1,1,2,50.0%,3m
1233,3,[烽夜长歌]钟情,4177,0,0,2,2,0.0%,48m
1239,3,恶棍,4176,1136,255,252,507,50.3%,18m
1239,3,瓜皮,4176,607,35,20,55,63.6%,18m
1239,3,lllllllllll,4176,581,23,12,35,65.7%,52m
1239,3,[四叶草]埃协鲁,4176,466,22,8,30,73.3%,7m
1239,3,你的探机哭哭啼啼,4176,290,11,5,16,68.8%,52m
1244,3,Izayoi,4175,606,54,21,75,72.0%,48m
1244,3,别修地堡求你了,4175,200,43,5,48,89.6%,6m
1244,3,motherhunter,4175,530,30,21,51,58.8%,7m
1247,3,[CNN1]卷鸡神经网,4174,574,44,32,76,57.9%,46m
1247,3,[教我玩神族]JIMCHEN,4174,412,21,18,39,53.8%,22m
1247,3,[ANNEX]人皇丶洛萨,4174,18,4,4,8,50.0%,27m
1247,3,马上结婚打不了了,4174,0,0,1,1,0.0%,52m
1247,3,欣舞东风,4174,0,0,1,1,0.0%,27m
1247,1,[QWQa]游戏提示,4174,0,0,1,1,0.0%,22m
1253,3,萌新打星际,4173,442,124,84,208,59.6%,46m
1253,3,[薄暮之光]慕笺年,4173,1068,112,85,197,56.9%,48m
1253,3,[miku守护]疯狂的菜菜,4173,1136,105,97,202,52.0%,46m
1253,3,[掉分中v恭喜]IIIIIIIIIIII,4173,483,82,35,117,70.1%,17m
1253,3,[PTB]Heller,4173,1177,59,55,114,51.8%,18m
1253,3,[下辈子学内战]这个折纸不会玩,4173,350,51,9,60,85.0%,6m
1253,3,[希靈使徒]Raven,4173,927,48,13,61,78.7%,53m
1253,3,[海韵]妤柃,4173,388,20,6,26,76.9%,48m
1253,3,halfhours,4173,450,17,4,21,81.0%,52m
1253,3,[BGD]Yuuki,4173,217,7,1,8,87.5%,7m
1253,3,GhostElf,4173,219,6,4,10,60.0%,22m
1253,3,[可我没有狗]我的狗狗叫马达,4173,0,0,1,1,0.0%,21m
1253,3,[萌王]心中只有诺娃,4173,0,0,1,1,0.0%,7m
1266,3,[萝莉之芯]艾尔,4172,432,54,45,99,54.5%,22m
1266,3,IIIIIII,4172,484,49,35,84,58.3%,46m
1266,3,[星歌]命运,4172,54,5,8,13,38.5%,7m
1266,3,[青葱与纯色]号封一个月,4172,12,1,2,3,33.3%,48m
1266,3,[leia]Leia,4172,0,0,1,1,0.0%,6m
1271,3,[FDS47]双刃,4171,2261,434,451,885,49.0%,48m
1271,3,[TNL]风之伤,4171,2246,273,281,554,49.3%,22m
1271,3,[地堡隐刀飞机]心恙之人,4171,473,88,99,187,47.1%,18m
1271,3,llllllllllll,4171,348,40,33,73,54.8%,6m
1271,3,[Miku骑士]IIIIIIIIIIII,4171,181,11,1,12,91.7%,6m
1271,3,余灰丶糖醋肉团,4171,132,9,1,10,90.0%,28m
1271,3,[SK]洗脚,4171,40,6,7,13,46.2%,18m
1271,1,[Killyo]AIliang,4171,48,4,6,10,40.0%,46m
1279,3,[GAGA]艾尔,4170,170,5,2,7,71.4%,46m
1280,3,[小狐狸真可爱]睡不醒的栗子喵,4169,903,52,6,58,89.7%,53m
1280,3,IIIIIIIIIIII,4169,242,15,21,36,41.7%,7m
1280,3,雪风,4169,141,5,7,12,41.7%,27m
1283,2,[星河气象学院]下赛季前叫沧海客,4168,2435,381,391,772,49.4%,20m
1283,3,[世界树]飞鼠,4168,128,44,6,50,88.0%,7m
1283,3,[SC2近卫军]龙珀,4168,627,31,2,33,93.9%,48m
1283,3,Stellaris,4168,439,16,12,28,57.1%,6m
1283,3,樱弥,4168,146,4,2,6,66.7%,6m
1283,2,[TWV]麻花,4168,0,0,1,1,0.0%,22m
1283,3,Johnsk,4168,0,0,1,1,0.0%,17m
1290,3,[NEUQ东大]Panda,4167,2192,110,109,219,50.2%,17m
1290,3,[神武骑士团]打奥特曼的小怪兽,4167,1156,64,32,96,66.7%,52m
1290,3,[小鸡屠宰场a]脆皮鸡,4167,258,9,5,14,64.3%,21m
1293,3,带投大鸽,4166,256,94,27,121,77.7%,27m
1293,3,[KPG]SeleiXi,4166,1037,94,65,159,59.1%,48m
1293,3,地狱守门人,4166,1125,54,27,81,66.7%,52m
1293,3,llllllllll,4166,611,29,14,43,67.4%,48m
1293,3,[SKT俱乐部]Neil,4166,397,20,5,25,80.0%,18m
1298,3,IIIIIIIIII,4165,852,47,50,97,48.5%,52m
1299,3,[Shawk]六十五额降低无锡,4164,430,18,2,20,90.0%,46m
1299,3,DaydReamIao,4164,220,7,3,10,70.0%,21m
1299,3,福利路小霸王,4164,48,6,8,14,42.9%,7m
1302,3,南泽泉理,4163,1277,117,93,210,55.7%,48m
1302,3,[重新集结虫群]小熊守护,4163,775,91,63,154,59.1%,7m
1302,3,[谁在呼叫舰队]拔刀亦然留不住你,4163,781,68,6,74,91.9%,18m
1302,3,[国际巨星]呵呵,4163,252,20,22,42,47.6%,53m
1306,1,[KPG]暴躁的探机,4162,2587,548,599,1147,47.8%,12m
1306,3,[0点到为止0]打星际我只选神族,4162,1713,186,157,343,54.2%,27m
1306,3,llllllllllll,4162,1277,140,75,215,65.1%,46m
1306,3,莫渊,4162,810,63,12,75,84.0%,18m
1306,3,DasHenAiDF,4162,759,30,25,55,54.5%,53m
1306,3,kuan,4162,536,23,11,34,67.6%,48m
1306,3,星际新老白,4162,383,20,6,26,76.9%,52m
1313,3,夕阳红星际,4161,616,45,19,64,70.3%,48m
1313,3,七零后,4161,332,12,4,16,75.0%,53m
1313,3,ASDQWE,4161,0,0,1,1,0.0%,28m
1313,3,[東方心念語]因幡帝,4161,0,0,2,2,0.0%,48m
1317,3,雨洗玉兰花,4160,1122,98,85,183,53.6%,52m
1318,3,imagination,4159,952,54,44,98,55.1%,6m
1318,3,hardtosleep,4159,324,12,9,21,57.1%,7m
1318,3,[狗笔神族]CaptainLu,4159,107,4,2,6,66.7%,7m
1321,1,ANANAN,4158,0,0,1,1,0.0%,47m
1322,3,[肉鸡的饲养]小魔女伊蕾娜,4157,607,27,6,33,81.8%,6m
1322,3,流光若影丶,4157,105,14,5,19,73.7%,7m
1322,1,[TJMU]同济医大丨云玩家,4157,0,0,1,1,0.0%,19m
1325,3,征服,4156,850,251,226,477,52.6%,46m
1325,1,[HENUSC]however,4156,48,2,0,2,100.0%,22m
1327,3,YinYi,4155,1936,231,225,456,50.7%,27m
1327,3,[Onceme]OnlyOne,4155,8,1,5,6,16.7%,27m
1329,3,[花绯玉丶]jiyue,4153,1702,119,118,237,50.2%,7m
1329,3,xingzhizi,4153,455,76,77,153,49.7%,21m
1331,3,[传说萌娘团]oaza,4152,226,72,70,142,50.7%,21m
1331,3,诅咒,4152,70,35,29,64,54.7%,6m
1333,1,VictorLiu,4151,240,5,3,8,62.5%,24m
1334,3,OoC,4149,1981,221,219,440,50.2%,48m
1334,3,[神宫寺玖惠澄]小埋,4149,609,39,28,67,58.2%,46m
1334,1,[NAVl]KhasKlnG,4149,0,0,1,1,0.0%,47m
1337,1,DeadGame,4147,0,0,1,1,0.0%,49m
1337,3,[Shawk]泰伦,4147,0,0,2,2,0.0%,48m
1339,3,clart,4145,565,29,17,46,63.0%,18m
1340,3,IIIIIIIIIIII,4143,2241,176,188,364,48.4%,48m
1340,3,圣堂武士,4143,0,1,1,2,50.0%,18m
1340,1,菜鸟也疯狂,4143,0,0,2,2,0.0%,24m
1343,3,[月之所在RI]AWM,4142,1195,60,46,106,56.6%,52m
1344,3,IIIIIIIIIII,4141,2176,271,279,550,49.3%,48m
1344,3,浮华一场不过游戏,4141,0,0,2,2,0.0%,6m
1346,3,老送,4140,1773,89,96,185,48.1%,28m
1347,3,KAIYIFODOM,4139,1574,168,155,323,52.0%,6m
1347,3,Accelerator,4139,1074,56,47,103,54.4%,6m
1347,1,[FDU]生命之怒,4139,862,20,16,36,55.6%,14m
1350,1,[Shawk]trap,4138,0,1,1,2,50.0%,18m
1351,2,死神海拉,4137,0,0,2,2,0.0%,3m
1351,1,为了艾尔,4137,0,0,2,2,0.0%,14m
1353,3,[Elaina]小牧兰,4136,2109,718,694,1412,50.8%,53m
1353,3,[種田梨沙]渡辺早季,4136,42,8,14,22,36.4%,6m
1353,1,[芒市鱼塘]只会出蟑螂,4136,0,0,1,1,0.0%,53m
1356,3,柳子小猫咪,4135,412,25,36,61,41.0%,6m
1356,1,lIIIllllllII,4135,0,0,1,1,0.0%,9m
1356,3,面对疾风吧,4135,0,0,3,3,0.0%,6m
1359,3,坐下坐下基本懆作,4132,786,164,127,291,56.4%,27m
1359,3,Rubick,4132,800,45,50,95,47.4%,18m
1359,1,IIIIIIIIIIII,4132,1215,34,15,49,69.4%,49m
1359,3,[然哥强无敌]然哥你认识不,4132,10,2,3,5,40.0%,27m
1363,3,[老娘是最强的]病弱蠢萌尛尛酱,4131,146,4,2,6,66.7%,17m
1364,3,[HustSC]圣堂之刃,4129,111,4,5,9,44.4%,22m
1364,1,选择神族选择胜利,4129,48,1,2,3,33.3%,49m
1366,2,[逗比神教]人族就输不了,4128,188,32,37,69,46.4%,3m
1366,2,[Mica]黑贞赛高,4128,523,30,34,64,46.9%,50m
1366,3,[ZJU]此生无悔入粪坑,4128,183,9,7,16,56.2%,17m
1366,2,[博云星际学院]BoyuN,4128,0,0,1,1,0.0%,21m
1370,3,[四叶草]花落影榭,4126,1282,65,56,121,53.7%,52m
1371,3,鸮鸮夜雨,4125,8,1,4,5,20.0%,7m
1372,1,[输本夺冠啦]Fenix,4124,0,1,0,1,100.0%,19m
1373,3,[Wifi]Rival,4123,2093,169,157,326,51.8%,7m
1373,1,[VirGo]morning,4123,144,3,2,5,60.0%,51m
1373,1,IIIIIIIIIIII,4123,0,0,1,1,0.0%,22m
1376,3,[奈亚子]Cyclone,4122,45,5,9,14,35.7%,18m
1376,1,这个探机很关键,4122,0,0,1,1,0.0%,52m
1376,1,Aventador,4122,0,0,1,1,0.0%,19m
1379,3,Histallkill,4120,2242,675,621,1296,52.1%,7m
1379,3,ggbond,4120,1086,193,181,374,51.6%,7m
1381,1,[Hist]Rainbow,4119,2090,72,54,126,57.1%,53m
1381,1,Rethyfox,4119,850,20,17,37,54.1%,50m
1381,2,IIIIIIIIIIII,4119,0,1,2,3,33.3%,6m
1384,3,闲潭落英,4118,802,50,39,89,56.2%,27m
1384,3,[黄漫老师]上白泽慧音,4118,843,47,34,81,58.0%,18m
1386,1,llllllll,4116,1580,140,124,264,53.0%,50m
1386,2,oGsMC,4116,943,106,94,200,53.0%,20m
1386,1,llllllllllll,4116,0,0,1,1,0.0%,25m
1389,2,IGXY,4115,2375,320,341,661,48.4%,20m
1389,3,[RTSGo]查大麦,4115,334,18,19,37,48.6%,6m
1391,1,toM,4112,481,18,19,37,48.6%,9m
1392,3,[幽明异路]黑圆酱,4111,199,57,23,80,71.2%,6m
1392,3,神罗天征,4111,674,38,31,69,55.1%,48m
1392,3,[我们是害虫之]CCapgb,4111,0,0,4,4,0.0%,27m
1395,3,你这瓜保熟吗,4110,373,25,23,48,52.1%,53m
1395,2,[张润Fans]张润我滴超人,4110,203,11,0,11,100.0%,11m
1397,3,IIIIIIIIII,4109,76,48,51,99,48.5%,27m
1398,3,BreakWind,4108,50,6,16,22,27.3%,27m
1399,1,我是一只小菜鸟,4107,786,17,21,38,44.7%,46m
1399,3,不可阻挡,4107,22,5,10,15,33.3%,6m
1399,3,[萎黄瓜小子]Shiver,4107,34,3,13,16,18.8%,6m
1402,3,DDaLL,4106,857,146,125,271,53.9%,48m
1402,3,[专干直播狗]女妖王,4106,139,6,8,14,42.9%,18m
1402,2,llllllllllll,4106,44,4,2,6,66.7%,23m
1402,1,岱铉,4106,96,3,1,4,75.0%,22m
1406,1,[那里不可以]尚柠檬,4105,0,1,0,1,100.0%,47m
1407,3,[文韬武略]IncuBus,4104,1618,234,230,464,50.4%,53m
1407,1,[VKR]选神族就赢不了,4104,48,2,0,2,100.0%,49m
1409,3,TIMBA,4103,2033,152,152,304,50.0%,48m
1409,1,[开军舰]静刃,4103,0,1,0,1,100.0%,7m
1411,3,[小金上天队]费拉不堪凯露酱,4102,887,57,24,81,70.4%,7m
1411,3,胡桃夹子,4102,46,6,9,15,40.0%,6m
1413,3,IIIIIIIIIIII,4101,1873,895,884,1779,50.3%,7m
1413,3,田銘楷死去的爹,4101,1592,515,497,1012,50.9%,53m
1413,1,Bansss,4101,2184,82,72,154,53.2%,46m
1413,1,[文艺]五更瑠璃,4101,1094,65,57,122,53.3%,7m
1417,3,[我们是无敌的]Heleve,4100,442,15,16,31,48.4%,53m
1418,1,logan,4098,635,59,28,87,67.8%,9m
1419,3,小蒙,4097,157,64,69,133,48.1%,48m
1419,2,[CNboys]MixKristin,4097,136,7,4,11,63.6%,6m
1419,1,IIIIIIIIII,4097,48,1,1,2,50.0%,46m
1422,3,[FsA]LuckySon,4096,1534,74,79,153,48.4%,18m
1422,3,[MAC]xmxbm,4096,20,2,8,10,20.0%,18m
1424,1,[Ogier]猪肥自有刀来迎,4093,48,2,0,2,100.0%,51m
1425,3,波士顿汉堡,4091,2090,99,96,195,50.8%,6m
1425,1,信石,4091,0,0,1,1,0.0%,46m
1427,1,SpringField,4090,1748,45,43,88,51.1%,51m
1428,1,爱雨夜风,4089,1917,65,57,122,53.3%,51m
1428,1,[TNLtr]荒塞沫寒,4089,144,3,5,8,37.5%,7m
1430,1,[esport]OwenLaw,4087,1766,73,74,147,49.7%,19m
1430,1,[小金上天队]socol,4087,1006,24,20,44,54.5%,25m
1430,1,hello,4087,0,1,0,1,100.0%,23m
1433,3,IIIIIIIIIIII,4086,1621,97,84,181,53.6%,7m
1433,1,LOST,4086,96,2,4,6,33.3%,2m
1435,3,强哥哥,4085,256,22,32,54,40.7%,46m
1435,3,lllllllll,4085,314,17,21,38,44.7%,48m
1437,3,yang,4084,556,35,41,76,46.1%,28m
1438,1,为爱逆战,4083,0,0,1,1,0.0%,19m
1439,1,llllllllllll,4082,2183,75,70,145,51.7%,7m
1440,3,[Ogier]杂技神族,4081,641,88,95,183,48.1%,22m
1440,1,[不谐]雨林之中,4081,0,1,1,2,50.0%,50m
1442,2,StalkerInBED,4079,2372,494,488,982,50.3%,9m
1442,1,[SC2近卫军]无毒不丈夫,4079,1378,83,57,140,59.3%,50m
1442,3,[上海大学]白筑慕,4079,10,2,9,11,18.2%,22m
1445,3,Dorabear,4078,1641,86,79,165,52.1%,7m
1445,1,丶丶丶,4078,2156,75,65,140,53.6%,2m
1445,2,IIIIIIIIIIII,4078,31,55,68,123,44.7%,12m
1448,1,October,4077,1797,94,52,146,64.4%,18m
1449,1,IIIIIIIIIIII,4075,1487,106,76,182,58.2%,17m
1449,3,[EZWIN]破晓惊云,4075,183,7,9,16,43.8%,52m
1451,1,[博爱之城]士官长,4071,521,15,6,21,71.4%,51m
1452,2,染雪,4070,0,0,1,1,0.0%,1m
1453,1,IIIIIIiiiiII,4069,512,12,7,19,63.2%,9m
1453,1,[传说萌娘团]灵乌路空,4069,48,2,0,2,100.0%,53m
1453,1,[麻酱罐]牛肉味麻酱,4069,0,0,1,1,0.0%,9m
1453,2,丿特战队丶光明丿,4069,0,0,2,2,0.0%,10m
1457,3,shadowking,4068,71,12,20,32,37.5%,48m
1457,1,simon,4068,192,5,7,12,41.7%,51m
1459,1,shuige,4067,852,20,21,41,48.8%,46m
1459,2,格拉摩根伯爵,4067,289,14,2,16,87.5%,18m
1461,1,[SK]白球球,4066,378,9,3,12,75.0%,25m
1461,3,[中南大学官网]Riven,4066,34,7,13,20,35.0%,46m
1461,1,IIIIIIIII,4066,183,5,7,12,41.7%,49m
1464,3,榕江小子,4065,1506,94,105,199,47.2%,17m
1464,2,[小淦上天队]IIIIIIIIIII,4065,1479,70,83,153,45.8%,25m
1464,2,[ELSD]Threnody,4065,890,54,24,78,69.2%,9m
1464,1,白赢到黄金,4065,1346,37,24,61,60.7%,47m
1464,1,[英国大理石]FaNsorSK,4065,234,6,3,9,66.7%,24m
1464,1,[狗逼速成班]LeoVirgo,4065,144,4,2,6,66.7%,21m
1464,1,[SFTRA3]Raboy,4065,0,0,1,1,0.0%,18m
1471,3,[星际把妹王]我永远单推鲨鲨,4064,150,47,14,61,77.0%,7m
1472,2,海外散修厉飞雨,4062,2295,291,289,580,50.2%,50m
1472,3,IIIIIIIIIIII,4062,2000,210,206,416,50.5%,6m
1474,1,[ToHo]半桶水,4061,993,35,11,46,76.1%,24m
1475,1,[GAP]雨神,4060,96,3,1,4,75.0%,7m
1475,1,AsuKa,4060,142,3,7,10,30.0%,25m
1475,1,[Igirls]IdontFKwithU,4060,0,1,0,1,100.0%,46m
1478,3,[5EU]ScarletAMMO,4059,1765,632,590,1222,51.7%,53m
1478,1,颤抖的五花肉,4059,830,51,37,88,58.0%,7m
1480,3,[喵丫咪呀]色眯眯的大肥猫,4057,2140,140,138,278,50.4%,52m
1481,3,[暴雪我是你爹]saberheart,4056,2095,167,164,331,50.5%,48m
1481,1,[TNL]我有一只小可爱,4056,875,52,37,89,58.4%,7m
1481,1,[一等星]CoLa,4056,48,1,1,2,50.0%,2m
1484,1,[北京大学鸡协]芭芭拉冲鸭,4055,2042,88,86,174,50.6%,23m
1485,1,[Els]Foy,4053,0,0,1,1,0.0%,17m
1486,1,胡尼玛,4052,1467,38,37,75,50.7%,51m
1486,1,[SK]十六夜咲夜,4052,718,23,17,40,57.5%,51m
1486,1,[丨SLT丨]大河,4052,48,2,1,3,66.7%,47m
1489,3,[star星]城市化的缔造者,4050,198,20,28,48,41.7%,6m
1490,3,[TossSE]樱小路,4049,585,37,35,72,51.4%,46m
1490,1,[上帝的叹息]KurokiTomoko,4049,881,33,4,37,89.2%,7m
1492,3,[妹控万岁]逐影,4048,2099,420,381,801,52.4%,46m
1492,1,神武,4048,1617,54,40,94,57.4%,21m
1492,1,WellDown,4048,144,4,1,5,80.0%,19m
1495,1,[乳主头子]那只狗是我的,4047,2043,98,82,180,54.4%,23m
1495,3,YZY,4047,108,9,21,30,30.0%,17m
1495,2,[KPG]鱼鱼鱼,4047,174,4,5,9,44.4%,28m
1498,2,[ANNEX]斩赤红灬之瞳,4046,90,5,5,10,50.0%,24m
1499,3,[TRSS]星之魔法,4045,450,168,181,349,48.1%,17m
1499,1,[KPG2]螺蛳粉小妹,4045,18,1,13,14,7.1%,18m
1499,3,[泰伦]QingRen,4045,0,0,3,3,0.0%,22m
1502,1,洛天依,4044,250,6,9,15,40.0%,19m
1502,1,[星际老徐坤]IIIIIIIII,4044,0,1,0,1,100.0%,53m
1504,2,Fiona,4043,1715,169,192,361,46.8%,3m
1504,2,joe,4043,1626,76,91,167,45.5%,51m
1504,2,[Beasty]IIIIIIII,4043,44,2,1,3,66.7%,8m
1507,1,[大元师]MGJProtoss,4042,1712,109,102,211,51.7%,49m
1507,2,xly,4042,947,49,49,98,50.0%,51m
1507,1,[SK]祝你今天愉快,4042,378,9,7,16,56.2%,47m
1507,1,IIIIIIIIIII,4042,48,2,2,4,50.0%,9m
1507,2,[帅得不行的]喵先生,4042,0,1,2,3,33.3%,9m
1507,1,[赐竹]纯粹的,4042,0,0,1,1,0.0%,7m
1507,1,luckyzerg,4042,0,0,1,1,0.0%,50m
1507,1,Paraesthesia,4042,0,0,1,1,0.0%,50m
1515,3,Anlgt,4041,1521,317,294,611,51.9%,18m
1515,1,[HustSC]灬烈艹焰灬,4041,896,21,21,42,50.0%,23m
1515,1,[Holyam]ReFuse,4041,312,8,2,10,80.0%,47m
1518,1,Nemu,4040,481,12,12,24,50.0%,17m
1519,1,iceedog,4039,2129,144,129,273,52.7%,18m
1519,1,布拖鞋,4039,1383,48,44,92,52.2%,51m
1519,2,[星际评定会]iiiiiiiii,4039,0,0,1,1,0.0%,28m
1522,3,灬衰神灬,4037,890,52,59,111,46.8%,48m
1522,1,[i5]Timshel,4037,96,2,4,6,33.3%,53m
1524,3,[谐新部落]blink,4036,2142,607,599,1206,50.3%,52m
1524,1,[SoloAs]長谷川優酱,4036,1224,51,31,82,62.2%,46m
1524,1,[丨SLT丨]堕魔旋风,4036,0,1,0,1,100.0%,51m
1527,1,[万川归流]墨汌,4035,983,79,19,98,80.6%,22m
1527,1,[F91孙焕佳]梦幻之空小白酱,4035,354,9,8,17,52.9%,49m
1527,1,[暴雪我是你爹]吃素还真养生,4035,0,1,0,1,100.0%,7m
1530,1,[X少NB]狛枝凪斗,4034,236,6,7,13,46.2%,7m
1531,2,有米不吃菜,4033,1705,212,221,433,49.0%,12m
1531,3,[KtZest]IIIIIIIIIIII,4033,2168,167,150,317,52.7%,52m
1531,3,大爸爸,4033,1396,140,136,276,50.7%,7m
1531,1,[神族天下无敌]阿毛,4033,1955,64,53,117,54.7%,7m
1531,1,[NUAA]吃素还真养生,4033,0,1,0,1,100.0%,17m
1536,1,银枪小霸王,4032,1491,74,68,142,52.1%,49m
1537,3,[i瑶]孙六空,4031,1296,145,134,279,52.0%,7m
1538,3,dakness,4030,1444,181,175,356,50.8%,18m
1538,1,www,4030,1893,104,90,194,53.6%,17m
1538,1,[天地會分舵]MADMAN,4030,240,6,9,15,40.0%,21m
1541,1,Apollo,4029,2138,153,141,294,52.0%,51m
1541,1,[SYP]SAKURAKI,4029,2033,90,36,126,71.4%,47m
1541,3,[SK]古明地觉,4029,335,33,33,66,50.0%,27m
1541,1,东方彧卿,4029,969,28,10,38,73.7%,48m
1545,1,[异虫就输不了]又大又圆的光头,4028,1948,250,229,479,52.2%,49m
1545,1,[NT]Kiril,4028,1860,65,43,108,60.2%,18m
1547,2,晓风残月,4027,0,0,1,1,0.0%,55m
1548,1,[扫黄]公狗安娜全家爆炸,4026,1940,121,128,249,48.6%,14m
1548,3,沧海客,4026,1116,56,66,122,45.9%,48m
1548,1,星燃魂,4026,904,38,25,63,60.3%,7m
1548,1,[四川麻将协会]鱿鱼丝,4026,274,8,6,14,57.1%,53m
1548,1,[佣兵的夕暮]绚辻词,4026,0,1,0,1,100.0%,53m
1548,3,[KPG]天煞落世,4026,0,1,4,5,20.0%,2m
1554,1,吕布保护协会会长,4025,556,12,13,25,48.0%,24m
1554,1,[哟呵呵]天满八纯,4025,370,8,3,11,72.7%,7m
1556,1,IIIIIIIIIIII,4024,1380,35,35,70,50.0%,26m
1556,3,孙一峰,4024,0,4,5,9,44.4%,6m
1556,1,MnOMnO,4024,0,1,0,1,100.0%,18m
1556,1,[Vgirls]云浅雪,4024,0,0,3,3,0.0%,49m
1560,1,[半个菜鸟]GuardEunByul,4023,1047,32,16,48,66.7%,52m
1560,1,[凛风]己莫为,4023,0,1,0,1,100.0%,7m
1562,1,给我一个亿,4022,1053,77,60,137,56.2%,53m
1562,3,IIIIIIIIIIII,4022,1291,65,70,135,48.1%,21m
1562,1,刘长海站撸星际,4022,0,0,1,1,0.0%,14m
1565,3,dapangtu,4020,1607,127,103,230,55.2%,7m
1565,1,[键盘在冒奶]灰烬使者,4020,1435,63,34,97,64.9%,46m
1565,1,[皓蒙之剑]有礼有貌安度因,4020,628,15,7,22,68.2%,7m
1568,1,Spincx,4019,1532,193,153,346,55.8%,2m
1568,2,IIIIIIIIIIII,4019,1914,90,90,180,50.0%,50m
1570,3,IIIIIIIIIIII,4018,1293,122,124,246,49.6%,47m
1570,1,蜻蜓队长,4018,0,0,1,1,0.0%,23m
1572,1,[kotomi]Kotomi,4017,1197,188,135,323,58.2%,24m
1572,1,[USCK]KyaruSuki,4017,328,7,8,15,46.7%,52m
1572,3,fagda,4017,4,2,11,13,15.4%,7m
1575,3,玉娜的暖风,4016,1489,370,360,730,50.7%,52m
1575,1,[七咕咕]伪物的妖妖,4016,1241,34,21,55,61.8%,52m
1575,1,[传说萌娘团]惜梦,4016,0,1,2,3,33.3%,7m
1578,3,[老奶奶]用脚玩神族,4015,1788,110,110,220,50.0%,48m
1579,1,IIIIIIIIIIII,4014,842,23,17,40,57.5%,47m
1579,1,行路難,4014,144,3,4,7,42.9%,19m
1581,3,死神一波真智障,4013,1203,291,313,604,48.2%,21m
1581,1,狗尾草,4013,761,85,57,142,59.9%,52m
1581,1,奶死你,4013,139,4,0,4,100.0%,2m
1581,1,wzgl,4013,0,0,1,1,0.0%,49m
1585,1,FiftyBrotho,4012,1657,52,34,86,60.5%,52m
1586,3,Lions,4011,895,47,43,90,52.2%,7m
1586,3,冥想神族鸦喵喵,4011,826,47,58,105,44.8%,47m
1586,1,[舔琪亚娜胖次]南小鸟,4011,283,16,19,35,45.7%,19m
1586,1,炒股败家,4011,378,9,13,22,40.9%,23m
1586,3,[丨SLT丨]小小怪,4011,48,7,14,21,33.3%,6m
1591,1,[AOSmt]Rye,4010,2048,141,104,245,57.6%,24m
1591,1,幸运魔法兔,4010,1611,70,41,111,63.1%,24m
1593,1,[西城孙一峰]泽拉图斯特拉,4009,284,7,6,13,53.8%,9m
1593,1,[KPG]愿我艾尔万世长存,4009,95,2,0,2,100.0%,47m
1595,2,[神秘代码]跳跳鲲,4008,271,12,5,17,70.6%,14m
1595,1,青童君,4008,94,3,4,7,42.9%,22m
1595,1,xinlaide,4008,0,1,1,2,50.0%,22m
1595,1,IIIIIIIIIIII,4008,0,0,5,5,0.0%,21m
1599,1,葫芦娃,4007,701,145,110,255,56.9%,52m
1599,3,老年星际,4007,1519,77,81,158,48.7%,52m
1599,1,果果篮子,4007,1102,40,19,59,67.8%,46m
1602,1,蜜汁小汉堡,4006,1061,171,163,334,51.2%,19m
1602,3,[TNLet]白霖秋,4006,1354,69,83,152,45.4%,47m
1602,3,[兔兔之家]GeneraLaw,4006,796,45,63,108,41.7%,17m
1602,1,高效液相,4006,330,6,22,28,21.4%,9m
1602,1,[KPG]彼岸星辰,4006,46,1,2,3,33.3%,23m
1607,1,[半个菜鸟]菜鸡一只,4005,1534,63,52,115,54.8%,49m
1607,1,身下下士,4005,96,3,3,6,50.0%,46m
1607,1,[XVII]Steorra,4005,46,1,1,2,50.0%,7m
1610,1,奥巴驴,4004,702,17,13,30,56.7%,14m
1610,1,[我高贵的族人]綾地寧寧,4004,370,8,4,12,66.7%,17m
1610,1,曦寒,4004,94,6,2,8,75.0%,53m
1610,1,[华晨宇]宋炳鋸丧俗,4004,96,2,2,4,50.0%,51m
1610,1,[突变攻略组]GENG,4004,0,0,1,1,0.0%,23m
1615,2,MikiSayaka,4003,1674,153,163,316,48.4%,51m
1615,1,Zanni,4003,2051,152,109,261,58.2%,49m
1617,1,InnoVation,4002,0,0,1,1,0.0%,52m
1618,1,IIIIIIIIIIII,4001,1989,116,111,227,51.1%,53m
1618,1,[集大鸡协]海院扛把子,4001,508,11,11,22,50.0%,53m
1618,3,小洛,4001,0,0,9,9,0.0%,28m
1621,3,巴克鲁鲁,4000,1715,166,162,328,50.6%,7m
1621,1,[SCJWJ3]赛大男神,4000,46,1,3,4,25.0%,22m
1621,1,[LDP]柏木英理,4000,0,0,1,1,0.0%,49m
1624,1,[只玩人类]人类,3998,190,5,9,14,35.7%,2m
1624,2,erio,3998,88,2,0,2,100.0%,9m
1624,1,[肉鸡的饲养]UNccccc,3998,0,1,1,2,50.0%,47m
1627,3,[SKT俱乐部]要用魔法打败魔法,3995,1582,156,150,306,51.0%,48m
1627,1,星际第一钢琴家,3995,1771,69,57,126,54.8%,49m
1629,1,[不主动不拒绝]跟你就是走流程,3994,48,2,1,3,66.7%,17m
1630,3,IIIIIIIIIIII,3993,868,62,66,128,48.4%,21m
1630,1,[iN]AkimotoAkira,3993,1309,44,32,76,57.9%,7m
1632,1,抽刀断水水更流,3992,2072,290,222,512,56.6%,48m
1632,3,[KPG]Luminous,3992,1397,132,135,267,49.4%,7m
1632,1,热点战神二五仔,3992,0,1,0,1,100.0%,9m
1635,1,[七咕咕]自动机炮,3990,656,16,9,25,64.0%,24m
1635,1,wulusi,3990,422,9,9,18,50.0%,2m
1635,1,AmmoNia,3990,48,1,7,8,12.5%,18m
1638,1,蔡徐坤打爆星际狗,3989,588,56,38,94,59.6%,14m
1638,1,[青风堂]上海上找上海,3989,1316,34,29,63,54.0%,53m
1640,1,[GAGA]所谓肉香,3988,2102,97,96,193,50.3%,53m
1640,1,[一等星]minamotoF,3988,820,20,21,41,48.8%,53m
1640,1,boomcaca,3988,508,14,21,35,40.0%,53m
1640,1,国铜虐韩宗,3988,234,5,6,11,45.5%,18m
1640,1,[TYPEM]Feather,3988,0,0,1,1,0.0%,46m
1640,1,[绯世梦璃花]砂糖少女以爱为食,3988,0,0,1,1,0.0%,49m
1646,1,[暴雪我是你爹]braveterran,3987,1168,62,48,110,56.4%,7m
1646,1,[带哥]为所欲为,3987,365,13,14,27,48.1%,47m
1646,3,[情谊至上]扒拉猛干,3987,0,1,4,5,20.0%,18m
1649,1,[歌唱虫族]恶臭小子,3986,372,8,5,13,61.5%,47m
1650,3,[KPG2]rayyyyy,3985,1903,184,184,368,50.0%,48m
1651,1,IIIIIIIIIII,3984,1463,48,33,81,59.3%,7m
1651,1,[情谊至上]次元大介,3984,261,8,5,13,61.5%,49m
1651,3,[现世执妄]vhjkdcv,3984,0,2,3,5,40.0%,24m
1651,1,[汇通村镇银行]ETJiaOzi,3984,46,1,1,2,50.0%,49m
1655,1,沧海客,3983,0,0,39,39,0.0%,12m
1656,3,IIIIIIIIIIII,3981,1817,87,100,187,46.5%,22m
1656,1,IIIIIIIIIII,3981,46,1,3,4,25.0%,7m
1658,1,[SFAQL]我练出来了,3980,48,1,1,2,50.0%,21m
1659,3,[第八舰队丶]Kingdom,3979,1100,57,71,128,44.5%,21m
1659,1,[TAPC]jhxz,3979,278,6,4,10,60.0%,52m
1659,1,[好人阿轲]Fantasylyh,3979,234,6,5,11,54.5%,7m
1659,1,hello,3979,186,6,5,11,54.5%,2m
1659,1,[无情沛块]和泉丨纱雾,3979,0,0,1,1,0.0%,14m
1664,1,[SK]胖胖的猪,3978,988,23,27,50,46.0%,7m
1665,1,浩然正气,3977,2028,98,99,197,49.7%,17m
1665,1,凶残乐,3977,142,4,5,9,44.4%,48m
1665,1,[韩宗快乐屋]墨绒绒丶,3977,0,0,1,1,0.0%,52m
1668,1,ssssssssssss,3976,750,23,11,34,67.6%,49m
1668,1,[我妻]yyk,3976,0,1,0,1,100.0%,46m
1670,1,Leifo,3975,2089,109,102,211,51.7%,47m
1670,1,[bnuphy]ggboud,3975,0,1,0,1,100.0%,49m
1670,1,TIMBA,3975,0,0,1,1,0.0%,18m
1673,1,[菜菜子家族]matthorner,3974,94,2,9,11,18.2%,7m
1674,1,[Maximu]fate,3973,416,9,12,21,42.9%,53m
1674,1,[艾尔圆盾]sOs,3973,0,1,1,2,50.0%,49m
1676,3,几朵,3972,925,57,66,123,46.3%,22m
1676,1,[CSC]Luy,3972,814,20,16,36,55.6%,7m
1678,1,[荣耀归于我主]dearxiaogao,3971,688,15,9,24,62.5%,53m
1678,1,[ZTSCAP]FallenAsh,3971,630,14,11,25,56.0%,26m
1678,1,[XXHZ22]断罪之翼,3971,48,1,3,4,25.0%,7m
1681,1,[暴雪十队]一寸灰,3970,1922,121,106,227,53.3%,53m
1681,1,Mac,3970,0,0,2,2,0.0%,53m
1683,1,[SK]臭打游戏的,3968,188,5,3,8,62.5%,46m
1683,3,BlueSun,3968,30,3,5,8,37.5%,23m
1685,3,[Hiiro]橘猫,3967,0,0,1,1,0.0%,54m
1686,1,Rikka,3965,2032,163,136,299,54.5%,46m
1687,3,[一颗赛艇]消失的海岸线,3964,1009,78,72,150,52.0%,18m
1687,1,[快乐上分]馒不讲理,3964,0,0,1,1,0.0%,22m
1689,3,[ANNEX]克丽丝岚,3963,143,5,15,20,25.0%,22m
1690,1,[FDG后援团]王叭,3962,1409,44,26,70,62.9%,53m
1690,1,[拉比安罗斯]别杀我农民,3962,464,10,10,20,50.0%,14m
1692,1,[暴雪我是你爹]sky,3961,1018,26,21,47,55.3%,19m
1692,1,hellokitty,3961,0,1,0,1,100.0%,52m
1694,3,三天之内杀你马,3960,0,0,1,1,0.0%,1m
1694,1,[星歌]歪比歪比,3960,0,0,3,3,0.0%,7m
1696,3,摇摇星冰乐,3959,1603,172,175,347,49.6%,7m
1696,1,克制不说泰伦英霸,3959,1152,30,23,53,56.6%,49m
1696,1,[文韬武略]我的最终幻想,3959,414,9,8,17,52.9%,53m
1696,1,Synchronicit,3959,48,1,1,2,50.0%,26m
1700,1,[快乐风男]绘梨衣,3957,0,1,0,1,100.0%,24m
1700,1,[DDSK]新垣结衣孙一峰,3957,0,0,1,1,0.0%,21m
1702,1,[盲人鸡饲料]为了部落,3956,552,21,0,21,100.0%,47m
1703,1,[CRBS]防空部长,3955,1465,61,44,105,58.1%,53m
1703,1,[老油条战队4]正义之剑,3955,190,4,7,11,36.4%,47m
1703,3,[TSF]Ares,3955,30,2,4,6,33.3%,23m
1706,1,IIIIIIIIIIII,3954,1372,44,32,76,57.9%,22m
1706,2,[浙大战队]MoneySniper,3954,346,9,8,17,52.9%,22m
1706,1,[铜锣湾话事人]大飞,3954,362,8,4,12,66.7%,14m
1706,1,IIIIIIIIIII,3954,48,2,1,3,66.7%,26m
1706,1,Doraemon,3954,0,1,0,1,100.0%,53m
1706,1,游戏风云,3954,0,0,2,2,0.0%,53m
1712,1,白白不会修地堡,3953,475,19,9,28,67.9%,47m
1712,3,[SCJWJ3]夜晚和黎明,3953,110,11,22,33,33.3%,27m
1712,1,[不鸡RBQ]神秘奥特曼,3953,94,2,2,4,50.0%,18m
1715,1,[五月花]DAVID,3952,2057,323,301,624,51.8%,47m
1715,1,RYTA,3952,378,8,15,23,34.8%,51m
1717,1,[老年人反应]不要打我一波好嘛,3951,496,11,12,23,47.8%,7m
1718,1,OOOOOOOOOOOO,3949,792,78,61,139,56.1%,9m
1718,1,[TeamET]CDX,3949,0,1,0,1,100.0%,22m
1718,1,纪年,3949,0,0,3,3,0.0%,18m
1721,1,[无敌的泽哥]猫腻,3948,48,2,5,7,28.6%,47m
1721,2,[xuan]灬沫沫,3948,0,0,1,1,0.0%,10m
1723,3,星尘择宇,3947,2104,194,210,404,48.0%,48m
1723,1,[天朝]乱世王者,3947,1256,74,59,133,55.6%,23m
1723,1,[童话小镇]hydrallsks,3947,0,3,2,5,60.0%,7m
1726,1,IIlllIIIll,3946,1104,27,25,52,51.9%,24m
1726,1,[RSTAR]红柚依然,3946,94,3,6,9,33.3%,49m
1728,1,欲哒小风,3945,1284,128,121,249,51.4%,17m
1728,1,magiczerg,3945,988,24,28,52,46.2%,47m
1728,1,[世风第三帝国]雷神的荣耀,3945,516,20,4,24,83.3%,7m
1731,3,IIIIIIIIII,3944,1939,149,136,285,52.3%,6m
1732,1,奥特曼,3943,2020,358,327,685,52.3%,7m
1732,1,aasd,3943,1478,87,77,164,53.0%,24m
1732,1,Bruce,3943,740,38,33,71,53.5%,19m
1732,2,Pretty,3943,0,0,1,1,0.0%,14m
1736,1,pig,3942,1741,104,55,159,65.4%,52m
1736,1,[艾尔大聪明]Miracle,3942,1400,61,65,126,48.4%,17m
1738,1,[您好]我没有基态,3941,2077,207,198,405,51.1%,7m
1738,1,[SoloAs]地狱把妹王,3941,677,17,21,38,44.7%,7m
1738,1,虎虎虎叭,3941,372,8,12,20,40.0%,9m
1738,1,IIIIIIIIIIII,3941,48,1,4,5,20.0%,47m
1742,1,[TPoR]鶸鰔空,3940,716,17,17,34,50.0%,50m
1742,2,PQIGAB,3940,150,5,0,5,100.0%,8m
1742,1,llllllllllll,3940,0,0,1,1,0.0%,53m
1745,3,qip,3939,2086,242,259,501,48.3%,6m
1745,1,[DMR]脲道微波,3939,1313,86,72,158,54.4%,53m
1745,1,[这都是好事]星际舰队,3939,399,15,7,22,68.2%,46m
1745,2,[丨SLT丨]铅华,3939,0,0,1,1,0.0%,10m
1749,1,qdhgogo,3938,236,7,5,12,58.3%,49m
1749,2,[Bstar]物述有栖,3938,124,3,3,6,50.0%,23m
1751,1,QosTerry,3937,274,6,12,18,33.3%,50m
1751,1,[Shawk]小天使,3937,0,0,1,1,0.0%,53m
1751,1,Lyzz,3937,0,0,1,1,0.0%,53m
1754,1,[33CM]Hengj,3935,1112,52,44,96,54.2%,21m
1754,3,[滄海客殺手]炸鱼有罪,3935,316,13,17,30,43.3%,18m
1754,1,Braver,3935,186,4,5,9,44.4%,53m
1754,2,GlassesLee,3935,102,3,0,3,100.0%,3m
1758,1,IIIIIIIIIIII,3934,0,1,0,1,100.0%,17m
1758,3,IIIIIIIIIIII,3934,0,1,1,2,50.0%,55m
1760,1,[YR]city,3933,328,8,13,21,38.1%,47m
1761,3,[HustSC]FROZDEN,3932,0,2,3,5,40.0%,27m
1762,2,[TShark]酸酸甜甜就是我,3931,271,8,8,16,50.0%,17m
1762,1,PartinG,3931,142,3,2,5,60.0%,50m
1762,1,[武汉理工大学]IIIIIIIIIIII,3931,0,0,4,4,0.0%,21m
1765,1,[暴雪二十六队]初见丶,3930,1964,64,62,126,50.8%,7m
1765,1,Beam,3930,825,37,30,67,55.2%,7m
1765,1,[幽冥之狼]丛林战狼康康,3930,938,25,28,53,47.2%,9m
1765,1,水菜丽真爽,3930,153,6,5,11,54.5%,17m
1769,3,麦兜,3928,399,26,32,58,44.8%,21m
1770,1,四季栞那,3927,2075,164,147,311,52.7%,49m
1770,1,潘潘,3927,2073,103,91,194,53.1%,47m
1770,1,neeb,3927,569,16,4,20,80.0%,7m
1770,1,Myth,3927,0,1,0,1,100.0%,17m
1774,1,[SCUT]marvelous,3926,0,1,0,1,100.0%,49m
1774,3,[半个菜鸟II]背篼丶王子,3926,30,1,2,3,33.3%,6m
1776,1,llllllllllll,3925,328,7,11,18,38.9%,47m
1776,1,[都是为了艾尔]linker,3925,92,3,0,3,100.0%,21m
1776,1,吕布又倒了,3925,0,1,0,1,100.0%,49m
1779,1,威严满满的大小姐,3924,94,3,0,3,100.0%,2m
1780,1,[艾尔之巅]科学养猪第一人,3923,495,18,16,34,52.9%,49m
1780,1,国服第一半藏,3923,0,0,1,1,0.0%,17m
1780,1,NIO,3923,0,0,1,1,0.0%,7m
1780,1,[四宫财团]stuffyuri,3923,0,0,1,1,0.0%,46m
1784,1,[我们是无敌的]ZergFans,3920,48,1,5,6,16.7%,51m
1785,1,在劫难逃,3919,230,6,4,10,60.0%,53m
1786,3,[A灬shOw]preDiLeCtion,3918,1664,109,104,213,51.2%,7m
1786,1,IIIIIIIIIIII,3918,1000,28,21,49,57.1%,22m
1786,3,不羁的灵魂,3918,0,1,0,1,100.0%,8m
1786,1,[Vgirls]夜合,3918,48,1,1,2,50.0%,52m
1790,1,我建超世志,3917,1952,104,96,200,52.0%,53m
1790,2,[SK]CHNszxy,3917,164,4,9,13,30.8%,22m
1790,1,IIIIIIIIIIII,3917,46,2,0,2,100.0%,48m
1790,1,[神族难民]Repick,3917,0,0,1,1,0.0%,51m
1794,1,[折翼丿天使灬]evilangel,3916,1780,93,88,181,51.4%,18m
1794,1,[吹个牛B而已]星际争霸嘴上过,3916,592,14,24,38,36.8%,46m
1794,1,[神族难民]栗子蛋糕,3916,0,1,0,1,100.0%,51m
1794,1,[CE源汇点]HoNaCoo,3916,0,0,1,1,0.0%,7m
1798,3,mykicwwsr,3915,0,1,0,1,100.0%,50m
1799,1,Melom,3914,1074,39,28,67,58.2%,22m
1800,1,[肉鸡的饲养]手残老年人,3913,874,47,59,106,44.3%,17m
1800,1,庐山真传赤小兔,3913,772,20,24,44,45.5%,47m
1802,1,王哥,3912,2054,163,151,314,51.9%,50m
1803,1,[子旭FANS]Gradually,3911,0,0,1,1,0.0%,14m
1803,1,[柠檬汁]条码人,3911,0,0,1,1,0.0%,17m
1805,1,Neltharion,3910,142,4,0,4,100.0%,23m
1805,1,[虫族就输不了]我小色真名叫周宁,3910,0,1,0,1,100.0%,46m
1805,1,llllllllllll,3910,0,1,0,1,100.0%,17m
1805,1,pluviophile,3910,0,0,1,1,0.0%,7m
1809,1,sandom,3909,1587,68,53,121,56.2%,47m
1809,1,[退休总统]DonaldTrumP,3909,1275,60,56,116,51.7%,52m
1809,1,DXF,3909,1080,26,36,62,41.9%,49m
1812,3,[我即正义]小可爱你们好,3908,2091,239,248,487,49.1%,7m
1812,1,Brokenwings,3908,1282,38,33,71,53.5%,22m
1812,1,[HK丶S]屠杀弟弟,3908,0,0,1,1,0.0%,7m
1815,1,小金天梯号,3907,680,24,16,40,60.0%,18m
1816,1,死亡舰队已经抵达,3906,440,21,7,28,75.0%,53m
1816,1,ooooooooooo,3906,526,17,12,29,58.6%,48m
1816,1,云将,3906,190,5,10,15,33.3%,48m
1819,1,[查尔高阶枪兵]星辰,3905,1426,43,34,77,55.8%,52m
1819,3,[魔法少女小屋]Usagi,3905,192,10,1,11,90.9%,49m
1819,2,star,3905,127,3,4,7,42.9%,18m
1822,1,常草草,3904,1955,139,123,262,53.1%,52m
1822,1,lOneLy,3904,48,1,7,8,12.5%,52m
1822,1,[Beau]Jennifer,3904,0,0,1,1,0.0%,52m
1822,1,LyTimeAsc,3904,0,0,2,2,0.0%,51m
1822,3,FlashGOGOGO,3904,0,0,6,6,0.0%,14m
1827,1,蔚蓝之海,3902,1442,63,43,106,59.4%,22m
1827,1,子鹅,3902,499,25,13,38,65.8%,47m
1829,1,Summer,3901,785,26,30,56,46.4%,49m
1829,3,酷酷朝南,3901,0,2,2,4,50.0%,49m
1829,1,Warrior,3901,0,1,0,1,100.0%,48m
1829,1,[世界上最帅的]与我一战三生有幸,3901,46,1,1,2,50.0%,2m
1833,1,甜橙,3900,0,1,1,2,50.0%,52m
1834,1,Angel,3899,2022,176,164,340,51.8%,51m
1835,1,[神族赢不了]IIIIII,3898,267,6,5,11,54.5%,7m
1835,1,[神秘的力量]导哥,3898,140,4,8,12,33.3%,21m
1835,1,[丨SLT丨]uwuThermy,3898,94,2,1,3,66.7%,7m
1835,1,沧海,3898,48,1,6,7,14.3%,47m
1839,1,[中南大学官网]乾坤深似海,3897,1561,91,92,183,49.7%,19m
1839,1,[西南风]Mapleleaf,3897,404,10,7,17,58.8%,7m
1839,2,[大姐酒家]Engine,3897,213,9,1,10,90.0%,28m
1839,1,[武大萌新]复旦神皇,3897,46,2,0,2,100.0%,21m
1843,1,妈个鸡泽哥,3896,0,1,1,2,50.0%,52m
1843,1,小涛歌,3896,46,1,2,3,33.3%,19m
1845,1,[慢手e族]IIIIIIIIIIII,3895,1353,68,25,93,73.1%,48m
1845,1,[泰古]taenggu,3895,1837,56,49,105,53.3%,52m
1845,1,llllllllllll,3895,128,5,2,7,71.4%,7m
1848,1,[love西瓜]rollingdice,3894,1421,171,133,304,56.2%,49m
1848,1,清越,3894,1209,35,46,81,43.2%,2m
1848,1,[KPGSC2]TarGax,3894,836,29,14,43,67.4%,22m
1848,1,[猎妈人联盟]神奇猎马人,3894,376,11,9,20,55.0%,23m
1852,1,紫薯布丁,3893,650,16,13,29,55.2%,53m
1852,1,[那里不可以]Mercury,3893,264,13,12,25,52.0%,46m
1852,1,崇足思嘛,3893,0,1,0,1,100.0%,21m
1852,1,[人不冲踩麻木]Sunja,3893,0,0,1,1,0.0%,52m
1852,1,[柑橘之息]白上吹雪,3893,0,0,1,1,0.0%,46m
1857,1,[老油条死全家]我是彩笔别杀我,3892,1190,40,37,77,51.9%,7m
1858,1,[XXHZ8]奶哥,3891,1555,70,65,135,51.9%,22m
1858,1,[克拉丽丝]Alethea,3891,1467,47,43,90,52.2%,19m
1858,1,斗鱼直播温言酱,3891,46,2,2,4,50.0%,51m
1861,1,[EtdNew]NNGL,3890,0,1,0,1,100.0%,49m
1862,3,IIIIIIIIIII,3889,1851,344,334,678,50.7%,28m
1862,1,第一番队长,3889,2036,149,145,294,50.7%,47m
1862,1,[SK]llllllllllll,3889,1632,109,101,210,51.9%,46m
1862,1,想想球霸会怎么做,3889,360,24,15,39,61.5%,49m
1862,1,[为了地球]电光,3889,80,3,2,5,60.0%,51m
1862,3,[泰伦]LaLa,3889,30,1,2,3,33.3%,51m
1868,2,llllllllllll,3888,202,6,11,17,35.3%,28m
1868,1,[北交威武神奇]萌萌哒鸡,3888,0,1,0,1,100.0%,49m
1870,1,自爆球真好用,3887,746,33,34,67,49.3%,51m
1870,1,三减二等于一,3887,584,14,14,28,50.0%,53m
1870,1,雨和弦,3887,501,12,7,19,63.2%,52m
1873,3,[捞你沟子]翡翠城,3886,2066,439,461,900,48.8%,48m
1873,1,[这就是天t]Tocqueville,3886,1570,53,48,101,52.5%,22m
1873,1,[暴雪我是你爹]阿莱克修斯,3886,900,30,21,51,58.8%,53m
1873,1,[丨SLT丨]旭旭也想变可爱,3886,413,10,5,15,66.7%,52m
1873,1,总会过去,3886,118,3,4,7,42.9%,49m
1873,1,HowToDo,3886,0,0,1,1,0.0%,2m
1879,1,[艾尔之名]Timba,3885,640,32,20,52,61.5%,49m
1879,1,aytem,3885,253,9,5,14,64.3%,7m
1879,1,起点,3885,46,1,2,3,33.3%,52m
1882,1,[勇敢的活下去]我玩什么,3883,761,37,26,63,58.7%,51m
1883,1,灵寒舞,3882,303,63,5,68,92.6%,49m
1884,1,奥丁吕,3881,1527,79,78,157,50.3%,23m
1884,1,[大阪大学]lekbuss,3881,1736,57,44,101,56.4%,51m
1884,1,[慈溪宁]小桥留穂,3881,94,3,2,5,60.0%,52m
1884,1,Car,3881,0,0,1,1,0.0%,22m
1888,1,smous,3880,388,10,11,21,47.6%,52m
1888,1,[大连理工]梦羽,3880,184,5,3,8,62.5%,53m
1890,1,[禽禽禽]邪灬火,3879,1847,75,85,160,46.9%,21m
1891,1,Legato,3877,679,25,14,39,64.1%,53m
1891,2,樱杏子,3877,295,16,1,17,94.1%,28m
1891,1,[Beauty]半澤直樹,3877,0,1,0,1,100.0%,2m
1894,1,[HTW]手捂腹肌之力,3876,182,4,4,8,50.0%,53m
1894,1,NeaLoop,3876,0,1,0,1,100.0%,53m
1894,3,llllllllllll,3876,0,0,4,4,0.0%,10m
1897,1,[LEor]Darkseid,3875,226,6,4,10,60.0%,49m
1898,1,[海德单推协会]白痴,3873,525,14,8,22,63.6%,49m
1898,2,[NKTJ]Ganker,3873,295,12,6,18,66.7%,25m
1898,1,Zimba,3873,138,4,3,7,57.1%,52m
1901,3,abc,3872,484,106,114,220,48.2%,18m
1901,1,阿一二三,3872,732,40,14,54,74.1%,46m
1901,1,孙一峰永远是我哥,3872,790,20,17,37,54.1%,47m
1901,1,名字一向难起,3872,92,3,0,3,100.0%,2m
1901,2,[金枪手徐宁]Crazy,3872,92,3,8,11,27.3%,18m
1901,1,摆渡人,3872,46,1,1,2,50.0%,22m
1901,1,IIIIIIIIIIII,3872,46,1,2,3,33.3%,21m
1908,3,[AnSwer]Rhythm,3871,1177,76,79,155,49.0%,22m
1908,1,[大漢]托儿索狂干小学僧,3871,184,5,3,8,62.5%,23m
1910,1,solost,3870,1390,64,62,126,50.8%,52m
1910,1,Maple,3870,425,22,1,23,95.7%,7m
1910,2,教父,3870,141,5,1,6,83.3%,8m
1910,1,IIIIIIIIIIII,3870,90,3,3,6,50.0%,2m
1910,1,丶一方通行,3870,0,1,1,2,50.0%,52m
1910,3,TATQwQ,3870,0,0,1,1,0.0%,22m
1916,1,PiNoJ,3869,1596,206,190,396,52.0%,53m
1916,1,[白银联盟]aaa,3869,1622,102,95,197,51.8%,24m
1916,1,[鬼谷]零壹魔,3869,614,14,16,30,46.7%,26m
1916,3,[啊这啊这啊这]MilkyTea,3869,0,0,2,2,0.0%,50m
1920,1,安白,3868,282,7,2,9,77.8%,14m
1920,3,[wande]LastReunion,3868,0,0,1,1,0.0%,12m
1922,1,pbx,3867,1995,111,115,226,49.1%,17m
1923,3,galaxyHunter,3865,295,172,178,350,49.1%,19m
1923,1,[P就]二仙桥,3865,1102,29,30,59,49.2%,18m
1923,1,[不败的魔术师]奇迹的杨,3865,145,5,2,7,71.4%,53m
1923,1,Honor,3865,142,4,9,13,30.8%,7m
1927,1,往事随风,3864,996,57,41,98,58.2%,52m
1927,1,[miku守护]Futech,3864,932,37,32,69,53.6%,7m
1927,1,Pimab,3864,225,5,1,6,83.3%,52m
1927,1,小黑,3864,48,2,2,4,50.0%,46m
1931,1,llllllllll,3863,134,3,5,8,37.5%,26m
1932,2,[PITB]DataAngel,3862,1897,189,199,388,48.7%,50m
1932,1,桃花弄影,3862,1623,88,58,146,60.3%,2m
1932,1,[战X队]哦豁完蛋,3862,897,28,37,65,43.1%,19m
1932,1,[DMR]WOOD,3862,0,0,1,1,0.0%,17m
1932,1,Ryusuke,3862,0,0,1,1,0.0%,52m
1937,1,mikon,3861,0,1,0,1,100.0%,26m
1937,1,双败女人孙一峰,3861,46,1,5,6,16.7%,9m
1937,1,hankS,3861,0,0,1,1,0.0%,9m
1940,1,冻土森林的大蒜头,3860,0,1,0,1,100.0%,46m
1940,1,总司令,3860,48,1,1,2,50.0%,19m
1942,1,IIIIIIIIIIII,3859,1121,32,28,60,53.3%,53m
1943,1,yun,3858,0,0,1,1,0.0%,18m
1944,1,lvyuemen,3857,138,4,1,5,80.0%,14m
1944,2,天天牛币,3857,0,0,1,1,0.0%,24m
1944,2,我真的不是小灰灰,3857,0,0,1,1,0.0%,12m
1947,1,[大哥队]安工大,3856,1027,69,30,99,69.7%,18m
1947,1,[我队伍很强大]小青酱,3856,717,32,29,61,52.5%,49m
1947,3,[大姐酒家]Albert,3856,167,9,0,9,100.0%,2m
1950,3,[KPG]不要吓我,3855,2037,670,720,1390,48.2%,8m
1950,1,[盲人康复院]欲沐东湖的父亲,3855,1829,103,101,204,50.5%,26m
1950,1,LOMOI,3855,844,31,34,65,47.7%,52m
1950,1,LuckyTerran,3855,0,1,0,1,100.0%,19m
1954,1,[四叶草]苍蓝的回忆,3854,1742,110,83,193,57.0%,14m
1954,1,zzyy,3854,798,28,21,49,57.1%,53m
1954,1,飞龙骑脸怎么输,3854,137,3,0,3,100.0%,47m
1954,1,JingGG,3854,70,3,2,5,60.0%,7m
1954,1,Tanapai,3854,92,2,2,4,50.0%,7m
1954,1,KillerRen,3854,0,0,2,2,0.0%,53m
1960,1,猥琐到底,3853,1941,76,76,152,50.0%,52m
1960,1,IIIIIIIIIIII,3853,94,3,4,7,42.9%,46m
1960,1,就这破游戏瞎玩呗,3853,46,2,3,5,40.0%,2m
1963,3,[MASC]功夫熊猫,3852,1746,315,339,654,48.2%,48m
1963,1,[鸡家军]喵喵喵,3852,1895,78,63,141,55.3%,50m
1965,2,[保护自然协会]Entaronature,3851,138,3,2,5,60.0%,52m
1966,1,IiIiIiIiIiI,3850,1518,110,122,232,47.4%,17m
1967,3,[四叶草]深海鱼人蝶,3849,117,7,15,22,31.8%,47m
1967,3,[Icer]冰点,3849,30,1,1,2,50.0%,2m
1969,1,孤泉,3848,2025,390,340,730,53.4%,47m
1969,1,Broken,3848,2018,146,140,286,51.0%,2m
1969,1,[雨默三千秋]神无月,3848,0,1,0,1,100.0%,49m
1969,2,[炽焰六翼]天神右翼,3848,32,1,1,2,50.0%,52m
1973,1,冒牌孙一峰,3847,1618,519,486,1005,51.6%,48m
1974,1,ghgiugiu,3846,1218,35,28,63,55.6%,48m
1974,1,[196]天空的狂想诗,3846,0,1,0,1,100.0%,19m
1976,1,magic,3845,32,1,1,2,50.0%,49m
1976,3,[威震天下]Aoney,3845,0,0,1,1,0.0%,7m
1978,1,[Anticw]ShangRen,3844,1718,55,59,114,48.2%,49m
1978,1,疆左枚郎,3844,1078,33,30,63,52.4%,52m
1978,1,[刺蛇互助天团]Artia,3844,877,25,24,49,51.0%,50m
1978,1,[TPoA]影子零号,3844,601,22,20,42,52.4%,53m
1978,1,萌新想找大佬带,3844,198,5,1,6,83.3%,18m
1978,1,Worry,3844,0,1,0,1,100.0%,52m
1984,3,[秋毫第七分队]LoveWL,3843,1202,200,221,421,47.5%,18m
1984,1,rampage,3843,1452,68,60,128,53.1%,7m
1984,1,glaip,3843,1830,50,59,109,45.9%,46m
1984,1,[DMR]Stalker,3843,184,4,6,10,40.0%,2m
1984,1,SCPLAYER,3843,0,0,1,1,0.0%,18m
1989,1,三生杜牧,3842,555,12,11,23,52.2%,14m
1989,1,Statistics,3842,189,8,4,12,66.7%,19m
1991,1,[DMR]MomoDuin,3841,229,48,42,90,53.3%,47m
1991,1,彬彬好逊,3841,1060,47,32,79,59.5%,53m
1991,1,[RUBE]Tango,3841,1325,47,37,84,56.0%,48m
1991,1,教父,3841,543,23,24,47,48.9%,53m
1991,3,[ToHost]神灵武士,3841,0,5,0,5,100.0%,14m
1991,1,[Arcake]LMFAO,3841,0,0,1,1,0.0%,18m
1991,1,[丨SLT丨]GoodNight,3841,0,0,1,1,0.0%,49m
1998,1,放大看什么,3840,1249,52,44,96,54.2%,18m
1998,1,[Anticw]SeeKfaithman,3840,1170,30,40,70,42.9%,49m
1998,1,[暗夜王牌]周大爷,3840,776,22,26,48,45.8%,2m
1998,1,[鬼杀队]某科学的我妻善逸,3840,482,14,9,23,60.9%,52m
1998,1,SFSkim,3840,209,6,3,9,66.7%,46m
1998,2,qwer,3840,120,3,7,10,30.0%,52m
2004,1,know,3839,1120,34,28,62,54.8%,7m
2004,1,[名最好别太长]Attack,3839,381,17,5,22,77.3%,52m
2004,1,[miku守护]ghoti,3839,0,1,0,1,100.0%,9m
2007,1,魂殇,3838,1646,49,51,100,49.0%,7m
2007,1,[星辰之海]SoChel,3838,893,38,23,61,62.3%,48m
2007,1,[SoloAs]沧海客,3838,90,2,2,4,50.0%,48m
2007,1,[KPG]Misslavendar,3838,0,1,1,2,50.0%,2m
2007,1,明衣刀,3838,0,0,1,1,0.0%,52m
2012,1,燃烧月色,3837,2002,232,218,450,51.6%,20m
2012,1,[看啥]tankboy,3837,501,32,3,35,91.4%,46m
2012,1,ish,3837,0,1,1,2,50.0%,48m
2015,3,[高樂集团]君如玉,3836,2058,263,269,532,49.4%,18m
2015,1,[KPG2]星际迷航二号,3836,916,24,28,52,46.2%,17m
2015,3,DOG,3836,223,23,17,40,57.5%,18m
2015,1,dkga,3836,578,19,11,30,63.3%,52m
2015,1,Inspire,3836,138,3,1,4,75.0%,26m
2020,1,IIIIIIIIIIII,3835,1053,57,22,79,72.2%,52m
2020,1,[传说级搞事王]安卓君,3835,799,28,30,58,48.3%,2m
2020,1,哇啦哇啦,3835,0,0,1,1,0.0%,9m
2023,1,猎妈人,3834,263,17,10,27,63.0%,21m
2023,1,llllllllllll,3834,436,10,12,22,45.5%,53m
2023,1,lucifer,3834,136,4,3,7,57.1%,7m
2023,1,AuToLoSs,3834,0,0,1,1,0.0%,53m
2027,1,[withme]立大功,3833,273,12,7,19,63.2%,49m
2027,1,[星歌]danceInDark,3833,244,6,4,10,60.0%,14m
2027,1,[WgSC2]AgFoxMMS,3833,92,2,6,8,25.0%,26m
2030,1,三斤,3832,1397,88,17,105,83.8%,48m
2030,1,[Beasty]风暴要火,3832,666,22,21,43,51.2%,14m
2030,1,[锉刀酱真可爱]紫罗兰,3832,610,15,13,28,53.6%,21m
2030,1,[仁义礼智信]Sparkling,3832,200,6,3,9,66.7%,53m
2030,1,trumpV,3832,96,2,11,13,15.4%,26m
2030,1,[黄旭东]StevenG,3832,0,1,0,1,100.0%,53m
2036,2,[萌及正义]生活就像憋圣剑,3831,375,17,7,24,70.8%,14m
2036,3,[羊驼羊驼羊]落天依然星痕在,3831,0,0,1,1,0.0%,51m
2036,3,逼良为娼,3831,0,0,4,4,0.0%,20m
2039,1,[我潇洒]秋刀鱼的滋味,3830,604,51,33,84,60.7%,50m
2039,1,丫丫,3830,140,5,1,6,83.3%,53m
2039,3,[萌完吃个糖丶]苏打蛋糕,3830,30,2,0,2,100.0%,27m
2039,1,[我高贵的族人]恐惧学,3830,0,0,1,1,0.0%,2m
2043,2,污染问题提供商方,3829,0,1,0,1,100.0%,8m
2044,1,[没有闪]我是菜鸡泰伦,3828,328,12,14,26,46.2%,7m
2044,1,[我队伍很强大]Vad,3828,160,6,0,6,100.0%,53m
2044,3,[小女友]艺琳,3828,86,6,4,10,60.0%,52m
2044,2,樱小路露娜,3828,38,2,2,4,50.0%,17m
2044,2,[LYFANS]庄烋真,3828,0,1,1,2,50.0%,16m
2049,2,AndreaYIvan,3827,278,14,5,19,73.7%,28m
2050,1,[白银联盟]NoahsArk,3826,289,31,15,46,67.4%,49m
2051,1,[LFY]辉耀,3825,406,74,66,140,52.9%,7m
2051,1,大招还是运营,3825,273,14,12,26,53.8%,53m
2051,1,[目標諾森德]口丁乐,3825,486,12,14,26,46.2%,52m
2051,1,Stormwind,3825,129,4,0,4,100.0%,26m
2051,1,月回廊,3825,0,0,1,1,0.0%,48m
2056,1,[SCAP]xiaobai,3824,92,2,3,5,40.0%,17m
2057,1,IIIIIIIIIIII,3823,1484,248,219,467,53.1%,48m
2057,1,LuckyNaki,3823,1439,89,79,168,53.0%,7m
2057,1,[Serica]irohia,3823,1752,54,51,105,51.4%,47m
2057,1,普通电脑,3823,793,28,31,59,47.5%,49m
2057,1,bot,3823,247,14,11,25,56.0%,49m
2057,1,[魔法少女小屋]Sakana,3823,0,1,3,4,25.0%,49m
2063,1,[就这就这]bobo,3821,1535,202,204,406,49.8%,48m
2063,1,[桜公馆]新垣绫濑,3821,437,21,8,29,72.4%,48m
2065,1,桃太郎,3820,694,147,138,285,51.6%,46m
2065,3,llllllllllll,3820,170,9,1,10,90.0%,13m
2065,1,[肉鸡的饲养]瞎际争霸,3820,109,2,1,3,66.7%,46m
2065,2,不是星辰哦,3820,0,1,0,1,100.0%,21m
2065,1,多魔,3820,0,0,1,1,0.0%,24m
2065,1,太上忘情豆,3820,0,0,1,1,0.0%,20m
2065,1,[窈窕淑女]我不逑,3820,0,0,1,1,0.0%,47m
2072,1,[ChENCE]魔法少女清澈上上,3819,1980,125,126,251,49.8%,53m
2072,1,LuckyProtoss,3819,239,6,3,9,66.7%,22m
2072,1,墨霜,3819,91,2,0,2,100.0%,46m
2075,1,llllllllllll,3818,1096,158,150,308,51.3%,14m
2075,1,Libre,3818,0,1,0,1,100.0%,54m
2075,1,[我们是无敌的]llllllllllll,3818,0,1,0,1,100.0%,54m
2078,1,dsqkk,3817,637,27,20,47,57.4%,54m
2078,1,[紫夜镇守府]霜月花铃,3817,408,10,9,19,52.6%,7m
2078,1,[GSXY]Mercurial,3817,173,6,6,12,50.0%,23m
2078,1,[丨SLT丨]Magejiterran,3817,0,0,3,3,0.0%,26m
2082,1,[龙语冰川]龙语者冰兰,3816,1450,132,74,206,64.1%,50m
2082,1,Asuuuuuuu,3816,1987,96,92,188,51.1%,21m
2082,1,中吻,3816,1580,73,78,151,48.3%,20m
2082,1,[NPUED]pathfinder,3816,835,32,30,62,51.6%,18m
2082,1,花落影榭,3816,312,16,15,31,51.6%,49m
2082,1,yuiki,3816,409,13,11,24,54.2%,7m
2082,1,qinjl,3816,262,6,5,11,54.5%,22m
2082,1,星际争霸,3816,155,4,3,7,57.1%,48m
2090,1,[GSC]itaeyeon,3815,1427,202,131,333,60.7%,22m
2090,1,[KSARrk]烟雨暮尘,3815,1179,52,60,112,46.4%,48m
2090,1,IIIIIIIIIIII,3815,176,3,3,6,50.0%,46m
2090,1,[NUAA]invorker,3815,0,0,1,1,0.0%,18m
2094,1,llllllllllll,3814,606,56,35,91,61.5%,52m
2094,1,[铭刻於红魂丶]加菲喵和欧迪汪,3814,0,0,3,3,0.0%,17m
2096,1,[王富贵]王富贵二号,3813,1971,186,155,341,54.5%,7m
2096,1,[快乐糖活]松坂砂糖,3813,387,17,15,32,53.1%,48m
2098,1,[北京大学鸡协]llllllllllll,3812,1896,86,74,160,53.8%,54m
2098,1,[一等星]lingzhengjie,3812,427,11,14,25,44.0%,20m
2098,1,[星歌]Kagamine,3812,46,1,3,4,25.0%,18m
2101,1,被击杀的菜鸟,3811,1616,68,76,144,47.2%,53m
2101,1,THEBOSS,3811,983,38,28,66,57.6%,50m
2101,2,[谁都打不赢]旅游者,3811,106,3,2,5,60.0%,52m
2104,1,紫罗兰,3810,1853,69,71,140,49.3%,7m
2104,1,煞笔女人被狗日,3810,372,9,23,32,28.1%,50m
2104,2,[ZJU]Moonlight,3810,126,4,1,5,80.0%,24m
2107,3,[八一六]Seven,3809,58,3,0,3,100.0%,5m
2107,3,llllllllllll,3809,0,2,2,4,50.0%,17m
2107,1,[ELSD]IIIIIIIIIIII,3809,0,0,4,4,0.0%,47m
2110,1,琼希,3808,1695,66,71,137,48.2%,14m
2110,2,[肉鸡的饲养]小魔女流水酱,3808,444,16,9,25,64.0%,13m
2110,1,[星河气象学院]yyyyy,3808,362,9,11,20,45.0%,18m
2110,2,[享受游戏]鱼塘快乐行,3808,186,9,38,47,19.1%,51m
2114,1,ilcsc,3807,320,8,13,21,38.1%,17m
2114,1,冬马,3807,90,3,8,11,27.3%,7m
2114,1,帅裂苍穹的学长,3807,48,1,3,4,25.0%,52m
2114,1,全靠演,3807,0,0,3,3,0.0%,23m
2118,1,Siva,3806,178,5,7,12,41.7%,53m
2118,2,[斜星连萌]可爱的小灵儿,3806,0,1,0,1,100.0%,47m
2120,1,interesting,3805,980,24,34,58,41.4%,7m
2120,1,[窃光]wlt,3805,386,17,5,22,77.3%,22m
2120,2,IIIIIIIIII,3805,336,13,1,14,92.9%,17m
2120,2,[KPG]ShineLight,3805,300,11,6,17,64.7%,28m
2120,3,William,3805,244,9,3,12,75.0%,50m
2120,2,llllllllllll,3805,32,2,0,2,100.0%,22m
2126,1,Ockham,3804,1758,182,183,365,49.9%,17m
2126,1,TOLQ,3804,1974,114,117,231,49.4%,49m
2126,1,[德哈卡小分队]星际小菜鸡,3804,215,6,3,9,66.7%,24m
2126,2,[紫gbawe]alex,3804,0,0,1,1,0.0%,19m
2126,3,LastNight,3804,0,0,2,2,0.0%,21m
2131,2,ForAiur,3803,1659,154,124,278,55.4%,24m
2132,2,[SK]jojo,3802,2121,267,303,570,46.8%,12m
2132,3,TTTLLL,3802,0,1,0,1,100.0%,10m
2132,3,nothing,3802,0,0,1,1,0.0%,8m
2135,1,[青娱乐]FutureWorld,3801,1818,82,56,138,59.4%,26m
2135,1,[温柔兔公主]zfr,3801,345,25,21,46,54.3%,53m
2135,2,[RwGami]良辰不喜,3801,0,0,1,1,0.0%,51m
2138,1,[KPG2]叶落孤舟钦钦爱,3800,1925,174,168,342,50.9%,23m
2138,2,[一块晶体矿]苏打苏打苏,3800,78,2,3,5,40.0%,17m
2138,2,[GAC]尘封着的曾经,3800,0,1,0,1,100.0%,6m
2141,1,IIIIIIIIIIII,3799,730,594,593,1187,50.0%,6m
2141,2,[北极光小组]我将再次修起地堡,3799,522,20,12,32,62.5%,26m
2141,3,[Beasty]SupermAn,3799,0,0,1,1,0.0%,11m
2144,2,[miku守护]Duron,3798,432,16,7,23,69.6%,25m
2144,2,llllllllllll,3798,46,4,4,8,50.0%,8m
2144,3,[GaHo]瑚太郎小鸟,3798,0,0,1,1,0.0%,13m
2147,1,[火焰雷兽]Wangjiet,3797,1618,93,93,186,50.0%,47m
2147,1,davis,3797,643,28,17,45,62.2%,9m
2147,1,[lgfsb]叔叔不是这种人,3797,165,6,2,8,75.0%,7m
2147,1,[练不出来]IIIIIIIIIII,3797,184,4,11,15,26.7%,23m
2147,1,xYXy,3797,0,0,3,3,0.0%,18m
2152,2,[哔翻天梯鸡]新型冠状病毒,3796,536,25,16,41,61.0%,47m
2152,2,[Icer]GuAngMo,3796,38,1,1,2,50.0%,52m
2152,2,yun,3796,0,0,1,1,0.0%,26m
2155,1,[宝鸡谐会]众生之门,3795,107,3,1,4,75.0%,17m
2155,2,zeratul,3795,0,1,0,1,100.0%,24m
2155,2,flyup,3795,38,1,2,3,33.3%,6m
2155,2,[Dark势力]PrinzEugen,3795,0,0,1,1,0.0%,28m
2155,2,[菜的没人带]秦心變態,3795,0,0,1,1,0.0%,47m
2160,3,DTA,3794,1913,132,136,268,49.3%,19m
2160,1,[KPG]IIIIIIIIII,3794,1764,124,103,227,54.6%,48m
2162,1,非阿贝尔规范场,3793,1972,590,588,1178,50.1%,20m
2162,1,有点咸,3793,1919,416,400,816,51.0%,18m
2162,1,绝望尽头还是绝望,3793,830,43,32,75,57.3%,46m
2162,1,luck,3793,816,24,21,45,53.3%,48m
2162,2,饥饿的巨猹,3793,96,3,2,5,60.0%,6m
2167,1,llllllllllll,3792,1314,74,66,140,52.9%,53m
2167,1,垃圾,3792,1608,53,45,98,54.1%,9m
2167,2,咩呜咔,3792,0,0,2,2,0.0%,3m
2170,1,[N送一喷]Yilia,3791,138,4,9,13,30.8%,54m
2171,1,[东大电竞]Saber,3790,1924,146,135,281,52.0%,48m
2171,1,lIIIlIIllIIl,3790,877,64,74,138,46.4%,17m
2171,1,可乐不长胖,3790,474,30,20,50,60.0%,9m
2171,2,要分直接说别狗我,3790,391,18,6,24,75.0%,10m
2171,2,[lgfsb]叔叔就是这种人,3790,164,5,4,9,55.6%,24m
2171,2,[黑冰]Yukikaze,3790,0,0,1,1,0.0%,14m
2177,1,[HZAU]milka,3788,1942,369,335,704,52.4%,21m
2177,1,IIIIIIIIIIII,3788,1837,349,367,716,48.7%,22m
2177,1,[SC2近卫军]lllllllllll,3788,1905,170,182,352,48.3%,2m
2177,2,GGtaste,3788,234,7,5,12,58.3%,2m
2177,1,嘤帼星际大力士,3788,211,6,3,9,66.7%,18m
2177,3,[FLAT]FORyoungman,3788,0,1,0,1,100.0%,24m
2177,1,鹿杖客,3788,48,1,6,7,14.3%,24m
2184,1,东海小恶魔,3787,1963,332,344,676,49.1%,48m
2184,1,IIIIIIIIIIII,3787,751,96,89,185,51.9%,14m
2184,1,IlllIIIllllI,3787,1760,85,94,179,47.5%,21m
2184,1,ASK,3787,46,1,6,7,14.3%,23m
2188,3,[重拾]HistWind,3786,532,36,60,96,37.5%,54m
2188,2,[中华讲武堂]starlett,3786,756,25,27,52,48.1%,14m
2188,2,西木野真姬,3786,502,20,8,28,71.4%,21m
2188,1,[CJLU]zyh,3786,232,5,15,20,25.0%,18m
2188,2,[沧月女装协会]莽偷稳狗谐,3786,40,1,1,2,50.0%,19m
2193,2,[雪月]回归的狙击手,3785,198,5,5,10,50.0%,24m
2194,1,[请叫我萌本]超级黑莓大萌妹,3784,1947,271,240,511,53.0%,54m
2194,1,羽落星辰,3784,596,17,16,33,51.5%,2m
2194,2,[Beasty]LYLY,3784,290,10,8,18,55.6%,19m
2194,3,我是一撮呆毛,3784,30,6,1,7,85.7%,10m
2198,1,欢乐炸鱼,3783,434,16,7,23,69.6%,18m
2198,1,Dave,3783,460,11,10,21,52.4%,49m
2200,2,[Shawk]lelouch,3782,941,42,20,62,67.7%,28m
2200,1,[DSE]lIlIllllIIII,3782,679,20,18,38,52.6%,52m
2200,2,培南一样的帅气,3782,412,19,6,25,76.0%,2m
2200,2,希望取舍正确,3782,238,7,8,15,46.7%,25m
2200,3,[thu战队]Hazyknight,3782,0,2,2,4,50.0%,19m
2200,2,请叫我孙一峰,3782,0,0,2,2,0.0%,26m
2200,3,[Flowex]四月是你的谎言,3782,0,0,5,5,0.0%,17m
2207,2,IIIIIIIIIIII,3781,788,29,22,51,56.9%,53m
2207,2,游戏怎么玩淦真难,3781,412,28,22,50,56.0%,24m
2207,2,[夏空的英仙座]遠野恋,3781,238,11,13,24,45.8%,28m
2210,1,疾风怒涛,3780,1970,90,82,172,52.3%,50m
2210,2,我这人稳得一匹丶,3780,284,9,11,20,45.0%,10m
2210,1,犹豫就会败北,3780,72,4,7,11,36.4%,17m
2210,1,自古金发多孝子,3780,48,2,3,5,40.0%,17m
2214,2,俊豪是我宝贝,3779,0,0,1,1,0.0%,6m
2215,1,白给,3778,371,16,8,24,66.7%,47m
2216,1,Tohsaka,3777,383,16,11,27,59.3%,47m
2216,1,[青娱乐]BlackRaven,3777,132,4,4,8,50.0%,24m
2216,3,[暴雪我是你爹]阳光人族,3777,97,2,3,5,40.0%,4m
2216,1,[失恋阵线联盟]xyz,3777,0,0,4,4,0.0%,17m
2220,1,年轻人好自为之,3776,1746,122,94,216,56.5%,14m
2220,3,光天水秀,3776,0,1,5,6,16.7%,49m
2222,1,好吃不过饺子,3775,221,5,5,10,50.0%,7m
2222,2,STone,3775,38,1,3,4,25.0%,9m
2222,3,[星灵王]我以为先生,3775,0,0,1,1,0.0%,24m
2222,2,[ZJU]Unununium,3775,0,0,1,1,0.0%,9m
2226,1,IGJACKlove,3774,1685,157,133,290,54.1%,52m
2226,2,[幼稚园电竞班]NhB,3774,364,14,8,22,63.6%,9m
2228,2,zsl,3773,1271,53,40,93,57.0%,48m
2229,2,[欢乐星际]FalsE,3772,0,0,1,1,0.0%,25m
2230,1,alex,3771,549,39,23,62,62.9%,47m
2231,1,[由我们重回]不笑猫,3770,1251,82,47,129,63.6%,52m
2231,2,[Happy]EndlessDream,3770,192,5,3,8,62.5%,17m
2231,3,SToPire,3770,0,0,1,1,0.0%,11m
2234,1,死一样难过,3769,1147,69,57,126,54.8%,9m
2234,2,frostmourne,3769,0,0,3,3,0.0%,13m
2236,2,eggcraft,3768,0,0,1,1,0.0%,53m
2237,1,皇徒,3767,897,34,20,54,63.0%,50m
2237,3,鲸落南北,3767,147,8,1,9,88.9%,49m
2239,2,[五月花]超高校级的希望,3766,567,32,21,53,60.4%,28m
2239,1,小辣鸡,3766,796,19,26,45,42.2%,9m
2241,2,aNwAlt,3765,444,16,13,29,55.2%,10m
2242,1,鸡冠,3764,1558,112,117,229,48.9%,7m
2242,2,都是大哥,3764,34,2,0,2,100.0%,14m
2242,2,穹宇,3764,0,1,1,2,50.0%,17m
2242,2,[可爱团]番薯,3764,0,0,1,1,0.0%,10m
2246,2,[肉鸡的饲养]此夕何夕,3763,245,13,6,19,68.4%,3m
2246,2,hengheng,3763,0,1,0,1,100.0%,8m
2246,2,[鸡家军]啪啪啪,3763,0,0,1,1,0.0%,8m
2249,1,[有投行推叫我]Ange,3762,716,18,23,41,43.9%,54m
2249,1,ARXS,3762,530,15,13,28,53.6%,14m
2249,2,IIIIIIIIIII,3762,30,2,0,2,100.0%,17m
2249,2,专门狙击一束七,3762,0,0,1,1,0.0%,2m
2253,1,[KPG2]人间正道是沧桑,3761,1895,111,126,237,46.8%,49m
2253,1,连环局,3761,1789,62,48,110,56.4%,48m
2253,2,[梦瑾空人心]一盘都赢不了,3761,0,0,1,1,0.0%,12m
2256,1,[GDG]Kaldalis,3760,1449,142,133,275,51.6%,53m
2256,2,[丨SLT丨]Dean,3760,206,7,5,12,58.3%,21m
2256,1,[请先打我隊友]青岛孙一峰,3760,265,6,7,13,46.2%,53m
2256,2,我能守护亦能暖心,3760,0,0,1,1,0.0%,12m
2260,2,[天天打电脑]IIIIIIIIIIII,3759,1593,105,93,198,53.0%,10m
2260,2,spidery,3759,0,1,0,1,100.0%,13m
2262,1,DIESWZ,3758,1718,114,91,205,55.6%,26m
2262,1,天照之子,3758,909,47,46,93,50.5%,8m
2262,2,[打一辈子星际]void,3758,208,8,10,18,44.4%,2m
2262,2,Madrior,3758,62,3,0,3,100.0%,9m
2262,2,[艾洛格姆]Ryona,3758,0,0,1,1,0.0%,10m
2267,2,头头,3757,1522,148,136,284,52.1%,10m
2268,1,[反黑行动组]阿尔萨斯,3756,1880,156,138,294,53.1%,9m
2269,2,废柴,3755,359,46,39,85,54.1%,48m
2269,2,子鹅,3755,238,21,12,33,63.6%,2m
2269,1,松轩,3755,404,10,18,28,35.7%,14m
2269,2,[凛风]雏咲深羽,3755,36,1,1,2,50.0%,51m
2273,1,[KPG2]慕白,3754,1943,256,246,502,51.0%,54m
2273,1,[GOTAL]流星,3754,983,37,32,69,53.6%,26m
2273,1,[不想打tvt]zsewqsc,3754,182,4,9,13,30.8%,52m
2273,2,Capciron,3754,0,0,1,1,0.0%,14m
2277,1,可乐骑士,3753,1246,116,106,222,52.3%,21m
2277,1,[Rhusky]IIIIIIIIIII,3753,1061,45,40,85,52.9%,52m
2277,2,[DMRc]happygame,3753,1100,42,36,78,53.8%,24m
2277,1,东上,3753,298,8,8,16,50.0%,50m
2277,2,[麻酱罐]梦寻童游,3753,140,5,4,9,55.6%,17m
2277,2,机械咒,3753,153,5,5,10,50.0%,17m
2283,1,海因里希,3752,1445,98,84,182,53.8%,18m
2283,2,[hero00]IIIIIIIIII,3752,0,1,0,1,100.0%,8m
2283,3,llllllllllll,3752,0,0,14,14,0.0%,24m
2286,1,death,3751,1712,86,90,176,48.9%,49m
2286,1,develop,3751,1569,59,67,126,46.8%,22m
2286,2,Hunter,3751,370,20,8,28,71.4%,10m
2286,1,[TossSE]艾尔之刃,3751,516,15,17,32,46.9%,49m
2286,2,[3GPP]减肥成功的基王,3751,0,0,1,1,0.0%,3m
2286,2,Lizean,3751,0,0,1,1,0.0%,22m
2292,1,[FPT]人中吕布李信衡,3750,1879,84,84,168,50.0%,23m
2292,2,[P就输不了]打星际我只选神族,3750,344,17,6,23,73.9%,24m
2292,2,[Csquad]MrR,3750,0,1,0,1,100.0%,47m
2295,1,IIIIIIIIIIII,3749,1937,326,328,654,49.8%,53m
2295,1,[C02337]阿发,3749,997,41,44,85,48.2%,17m
2295,1,xiaokv,3749,119,20,7,27,74.1%,9m
2295,1,[我们都是铁头]一拳超人,3749,386,10,14,24,41.7%,24m
2295,2,IIIIIIIIIIII,3749,0,1,1,2,50.0%,16m
2295,3,[Killyo]海洋大鲸鱼尾巴,3749,0,0,1,1,0.0%,8m
2295,2,ArimaKisho,3749,0,0,5,5,0.0%,51m
2302,1,不准狗人,3748,1470,192,186,378,50.8%,7m
2302,2,[我们是无敌的]Morgana,3748,490,31,13,44,70.5%,53m
2302,2,野生胖虎,3748,34,1,1,2,50.0%,26m
2302,2,Fus,3748,0,0,1,1,0.0%,13m
2306,1,[红白梦恋]招财夢,3747,602,15,19,34,44.1%,48m
2306,2,[惯着你了]孙小欣,3747,0,1,0,1,100.0%,22m
2308,1,IIIIIIIIIIII,3746,1852,126,127,253,49.8%,49m
2308,1,VanSouL,3746,636,54,41,95,56.8%,23m
2308,1,[KPG]狂暴的小咩羊,3746,780,35,24,59,59.3%,18m
2308,2,谐星鬼王,3746,564,21,14,35,60.0%,6m
2308,2,少女强则少年扶墙,3746,184,6,4,10,60.0%,23m
2308,2,WALKMEN,3746,34,1,1,2,50.0%,19m
2314,2,[SoloAs]RitaLai,3745,1671,72,71,143,50.3%,55m
2314,2,Rogue,3745,372,13,14,27,48.1%,6m
2314,2,[火车烧基地]wsgfs,3745,275,9,11,20,45.0%,4m
2314,2,[我高贵的族人]Ghost,3745,0,1,0,1,100.0%,12m
2314,2,萌新爱萌,3745,32,1,1,2,50.0%,53m
2314,2,[CPT]星河丶万世浩劫,3745,0,0,1,1,0.0%,22m
2320,2,RenoJakeson,3744,81,7,7,14,50.0%,48m
2320,1,[五月花]星夜极光,3744,182,5,9,14,35.7%,9m
2322,2,死马电信,3743,238,8,7,15,53.3%,24m
2322,3,切糕终结者,3743,86,4,4,8,50.0%,28m
2322,3,[FET]BossL,3743,0,0,1,1,0.0%,4m
2325,1,五叶神,3742,1927,521,527,1048,49.7%,14m
2325,2,人族虫族来受死,3742,1653,76,69,145,52.4%,14m
2325,1,再见了宋哈娜,3742,986,32,37,69,46.4%,20m
2325,2,星术,3742,258,8,8,16,50.0%,16m
2325,3,天雾夕音,3742,0,1,4,5,20.0%,22m
2325,2,[小鸡屠宰场5]ELiteArK,3742,0,0,1,1,0.0%,22m
2331,2,MikuLINK,3741,152,5,2,7,71.4%,12m
2332,2,[中二疯人院]刷叉就完事了,3740,600,57,26,83,68.7%,14m
2332,1,llllllllllll,3740,302,8,14,22,36.4%,49m
2332,2,FTDXF,3740,89,3,3,6,50.0%,9m
2332,2,[Shawk]一六鸽只想恰饱饭,3740,98,3,4,7,42.9%,10m
2336,3,玩星际的萌妹子,3739,0,1,0,1,100.0%,13m
2337,2,[龙腾]heybabe,3738,1127,112,99,211,53.1%,48m
2337,2,SOS,3738,272,11,3,14,78.6%,2m
2337,3,seeheart,3738,0,0,1,1,0.0%,19m
2340,1,IIIIIII,3737,1914,268,289,557,48.1%,52m
2340,2,[DMR]我玩虫族只换家,3737,399,17,10,27,63.0%,21m
2340,3,[山包]MarineKing,3737,0,0,1,1,0.0%,10m
2343,1,[小鸡屠宰场3]hundanxingmo,3736,1914,546,527,1073,50.9%,47m
2343,2,原为君羊,3736,555,25,14,39,64.1%,52m
2343,2,BloodHarry,3736,274,11,8,19,57.9%,13m
2343,3,[A丶rise]樱小路才华,3736,93,2,0,2,100.0%,29m
2347,1,[透一下清酒]喜欢小郑同学,3735,1526,469,401,870,53.9%,26m
2347,1,[ZAS]Thymus,3735,1709,59,56,115,51.3%,47m
2347,2,[暴雪三十二隊]左能者,3735,931,49,11,60,81.7%,28m
2347,3,小莫妮卡,3735,97,6,0,6,100.0%,7m
2351,1,[曾经一群兔子]lalala,3734,1430,42,51,93,45.2%,50m
2351,2,ElementHero,3734,0,0,1,1,0.0%,12m
2353,2,起名真心难,3733,381,68,61,129,52.7%,17m
2353,2,真的要卡死了,3733,513,20,18,38,52.6%,54m
2353,2,[丨SLT丨]accusation,3733,520,18,17,35,51.4%,13m
2353,2,[MeowMe]陈默的小弟,3733,0,0,1,1,0.0%,6m
2357,2,crazy,3731,0,1,0,1,100.0%,2m
2357,2,[Holyam]palion,3731,0,0,1,1,0.0%,2m
2359,1,icedog,3730,1059,315,273,588,53.6%,7m
2359,2,[蒙蔽梦游团]艾尔今天停电了吗,3730,184,7,1,8,87.5%,6m
2359,2,[现世执妄]白之风铃,3730,0,1,0,1,100.0%,48m
2359,2,[RSTAR]四季映姬,3730,0,1,4,5,20.0%,14m
2359,2,玄清若尘,3730,0,0,1,1,0.0%,52m
2364,2,卧虫诸葛,3729,1455,64,67,131,48.9%,4m
2364,1,Tany,3729,330,12,8,20,60.0%,8m
2364,3,小向同学,3729,121,7,0,7,100.0%,17m
2364,3,[全村之希望]星际不死,3729,97,1,1,2,50.0%,29m
2364,2,[SoloAs]奶味小魔女,3729,0,0,1,1,0.0%,13m
2369,1,胡喵喵,3728,626,26,31,57,45.6%,2m
2369,2,llllllllllll,3728,304,12,3,15,80.0%,14m
2369,2,[洛丹伦的雨夜]ASKY,3728,0,1,0,1,100.0%,52m
2369,2,执厥中,3728,0,0,2,2,0.0%,6m
2369,1,久红,3728,0,0,5,5,0.0%,54m
2374,1,小马佩德罗,3727,1716,257,246,503,51.1%,52m
2374,2,MagicBiken,3727,698,28,15,43,65.1%,53m
2376,3,Aaaaaaaxing,3726,0,2,3,5,40.0%,9m
2376,2,King,3726,0,0,1,1,0.0%,12m
2378,1,没用的阿吉,3725,1641,105,114,219,47.9%,50m
2378,3,快雪时晴,3725,92,7,4,11,63.6%,52m
2378,2,[真实星际玩家]六翼路西法,3725,150,5,3,8,62.5%,10m
2381,2,[loveMM]IIIIIIIIIIII,3724,1181,224,212,436,51.4%,48m
2381,1,[GFA]沉心,3724,1301,58,65,123,47.2%,52m
2381,1,[KPG2]IIIIIIIIIIII,3724,1311,39,46,85,45.9%,20m
2381,2,llllll,3724,622,29,23,52,55.8%,19m
2381,2,美滋滋,3724,0,0,1,1,0.0%,2m
2381,2,[CnNami]chicken,3724,0,0,1,1,0.0%,6m
2387,1,AOTTRY,3723,1845,188,189,377,49.9%,24m
2387,2,[大胸神族]男神灬不凡,3723,1540,100,54,154,64.9%,47m
2387,2,控盘天骄,3723,1488,70,49,119,58.8%,47m
2387,2,[XXHZ31]lelouch,3723,693,25,20,45,55.6%,6m
2387,1,SuperstarX,3723,808,20,30,50,40.0%,50m
2387,2,自由,3723,0,0,1,1,0.0%,47m
2393,2,lllllllll,3721,0,1,0,1,100.0%,9m
2393,2,[无影丶神]草莓味的棉花糖,3721,0,1,0,1,100.0%,2m
2393,2,凌星飞雪,3721,0,0,1,1,0.0%,14m
2396,1,[Toss]新的希望,3720,1892,234,237,471,49.7%,47m
2396,3,[抱头蹲防]蕾米莉亚丶,3720,0,3,2,5,60.0%,5m
2398,2,[Davi]三岁,3719,142,5,7,12,41.7%,53m
2398,3,[带哥]姬柊雪菜,3719,97,3,0,3,100.0%,21m
2398,2,White,3719,72,3,5,8,37.5%,6m
2398,2,[wexomg]神风之殇丶,3719,30,2,1,3,66.7%,12m
2402,2,[孤独与烈酒]零功,3718,704,28,19,47,59.6%,53m
2402,2,[枫殇]BipolarTrans,3718,470,17,14,31,54.8%,52m
2404,2,吖灭爹,3717,303,114,93,207,55.1%,8m
2404,1,[搬砖实录]你的民工父亲,3717,1304,38,49,87,43.7%,47m
2404,2,谁的益达,3717,565,25,13,38,65.8%,24m
2404,2,九十九遊馬,3717,293,13,7,20,65.0%,29m
2404,3,[刺蛇互助协会]刺蛇桑,3717,0,4,1,5,80.0%,28m
2409,2,[慢手e族]王者是天空,3716,1128,130,119,249,52.2%,49m
2409,1,[西南风]Cygnus,3716,1280,39,44,83,47.0%,50m
2409,2,[兆景埋土大学]雪之下雪乃,3716,759,33,21,54,61.1%,2m
2409,1,黑凤梨,3716,906,23,30,53,43.4%,48m
2409,1,Thanatos,3716,0,5,0,5,100.0%,22m
2414,1,[iWoWi]histBigGun,3715,608,64,82,146,43.8%,20m
2414,2,[BNU]Gray,3715,230,20,10,30,66.7%,21m
2414,3,Apollo,3715,196,10,3,13,76.9%,7m
2417,3,[文韬武略]IIIIIIIIIIII,3714,1929,112,134,246,45.5%,22m
2417,1,cynicism,3714,410,12,13,25,48.0%,52m
2417,2,songtou,3714,0,0,2,2,0.0%,21m
2420,1,[大漢]围观群众,3713,1918,525,507,1032,50.9%,8m
2420,2,潇洒,3713,1123,74,66,140,52.9%,6m
2420,1,[嘛意思弟弟]南通孙一峰,3713,639,27,27,54,50.0%,48m
2420,3,MoiEtLacroix,3713,144,8,1,9,88.9%,5m
2420,2,kokodayo,3713,208,8,2,10,80.0%,21m
2420,2,[LDP]飞科和我五五开,3713,0,0,1,1,0.0%,2m
2426,1,iiiiiiiiiiii,3712,1914,298,309,607,49.1%,8m
2426,2,探鸡不是鸡,3712,1639,83,61,144,57.6%,52m
2426,2,苏打粉,3712,847,80,74,154,51.9%,14m
2426,2,周淑怡的逼也很嫩,3712,944,42,29,71,59.2%,53m
2426,2,[我们都是铁头]艾尔之子,3712,426,19,10,29,65.5%,21m
2426,2,[YLXH]奔跑的小灰灰,3712,205,7,10,17,41.2%,6m
2426,2,[哨兵信条]玉藻前,3712,38,2,0,2,100.0%,16m
2426,2,我为国家省布料,3712,0,1,0,1,100.0%,21m
2434,2,[ACI]IIIIIIIIII,3711,30,1,1,2,50.0%,49m
2434,3,玉麒麟,3711,0,1,2,3,33.3%,28m
2436,1,问号,3710,822,80,69,149,53.7%,47m
2436,2,[NGA观察团]Kaz,3710,0,0,1,1,0.0%,47m
2438,2,骨头碳水,3708,497,23,11,34,67.6%,26m
2438,3,使徒不能给你,3708,165,8,1,9,88.9%,25m
2438,3,[GrHd]AmmP,3708,58,3,3,6,50.0%,5m
2438,3,Threnody,3708,0,1,0,1,100.0%,8m
2438,3,[三杯鸡]抱走文圭丽,3708,30,1,3,4,25.0%,50m
2438,2,lxx,3708,0,0,1,1,0.0%,53m
2444,1,llllllllllll,3707,1926,153,154,307,49.8%,2m
2444,2,求得一世乐逍遥,3707,802,49,43,92,53.3%,9m
2444,2,[异乱]雇佣兵,3707,137,6,10,16,37.5%,21m
2444,2,我是你的霸霸,3707,0,0,1,1,0.0%,11m
2448,1,IIIIIIIIIIII,3706,1901,317,308,625,50.7%,17m
2449,2,[KUMA28]FadeAway,3705,484,18,11,29,62.1%,49m
2449,1,llllllllllll,3705,174,4,10,14,28.6%,53m
2451,1,[传说萌娘团]想想黄哥会怎么做,3704,1899,112,106,218,51.4%,18m
2451,1,[PImba不]小小,3704,1252,52,52,104,50.0%,23m
2451,2,[STSTST]IIIIIIIIIIII,3704,526,23,6,29,79.3%,13m
2451,2,[请受害者登场]动感超人,3704,573,21,16,37,56.8%,21m
2451,1,四十而立,3704,180,4,8,12,33.3%,53m
2451,1,封印之首,3704,0,3,2,5,60.0%,14m
2451,2,[NZNZ]松竹,3704,0,0,1,1,0.0%,8m
2458,2,SilenceYang,3702,1580,246,225,471,52.2%,2m
2458,2,[是我赢了]星际小萌新,3702,372,12,16,28,42.9%,29m
2458,2,Biltz,3702,0,0,1,1,0.0%,10m
2461,1,[泰伦阴霸]行星要塞,3701,1789,235,222,457,51.4%,54m
2461,1,woshibaba,3701,1835,153,145,298,51.3%,50m
2461,2,[KPG]落叶伤悲,3701,264,10,6,16,62.5%,19m
2461,3,[KPG]IIIIIIIIIII,3701,58,3,6,9,33.3%,27m
2461,2,不想赢就不会输,3701,0,0,1,1,0.0%,24m
2466,1,佩恩,3700,509,13,16,29,44.8%,50m
2466,2,[UF]神之遐想,3700,0,0,1,1,0.0%,14m
2468,2,[火焰雷兽]ZDZD,3699,280,10,11,21,47.6%,6m
2468,2,[陽光男孩]sio,3699,0,1,0,1,100.0%,14m
2470,2,[北极光小组]Laevatein,3698,192,8,3,11,72.7%,52m
2471,1,[丨SLT丨]苍生涂涂天下渺渺,3697,1769,107,104,211,50.7%,48m
2471,1,lichadebo,3697,979,87,99,186,46.8%,20m
2471,1,RECO,3697,534,14,19,33,42.4%,47m
2471,2,aotpmbd,3697,86,4,1,5,80.0%,24m
2471,2,[白翎舰队]Snowman,3697,0,0,2,2,0.0%,25m
2476,2,[NVKR]青落菌,3696,1639,307,282,589,52.1%,16m
2476,2,仰望,3696,1458,88,62,150,58.7%,2m
2476,2,[SoloAs]yyf,3696,854,30,31,61,49.2%,16m
2476,2,[在下小学生]小李,3696,192,11,6,17,64.7%,19m
2476,3,加藤惠,3696,164,9,0,9,100.0%,21m
2476,1,LiquidTaeJa,3696,0,5,0,5,100.0%,3m
2476,2,[情谊至上]永丿灭灬,3696,118,5,1,6,83.3%,13m
2483,3,不要亲怡怡,3695,146,8,1,9,88.9%,16m
2483,2,[CHN]CHNraGingX,3695,122,4,4,8,50.0%,24m
2485,2,街头狂路霸,3694,214,8,10,18,44.4%,9m
2485,2,[PTB]薊遼督師袁崇煥,3694,30,1,7,8,12.5%,21m
2487,1,IIIIIIIIIIII,3693,1850,134,127,261,51.3%,26m
2487,2,天若有情天亦老,3693,1555,71,62,133,53.4%,6m
2487,1,[GIE]背影,3693,1216,48,50,98,49.0%,8m
2487,2,星际这么难打毛,3693,661,30,20,50,60.0%,25m
2487,2,歌者,3693,234,9,3,12,75.0%,9m
2487,3,[CNboys]只会狗招,3693,97,3,0,3,100.0%,52m
2487,3,清丞,3693,97,2,1,3,66.7%,25m
2487,2,繁星夜空下,3693,0,1,0,1,100.0%,21m
2487,1,智多星潘凤,3693,0,1,4,5,20.0%,20m
2496,1,LYQQ,3692,1906,309,311,620,49.8%,54m
2496,1,xxzzjjii,3692,1013,251,236,487,51.5%,47m
2496,2,[水无月]生死看淡,3692,1638,134,116,250,53.6%,51m
2496,2,[传奇舰队]宝贝龙,3692,1424,106,99,205,51.7%,17m
2496,2,[PITB]WIO,3692,166,7,1,8,87.5%,53m
2496,2,tassar,3692,91,4,3,7,57.1%,3m
2496,2,[OgiNA]uKing,3692,62,2,2,4,50.0%,25m
2496,2,[Hist]素衣莫起风尘叹,3692,30,2,3,5,40.0%,10m
2496,2,失意,3692,70,2,7,9,22.2%,11m
2505,2,[爆裂吧现实]liurui,3691,1070,110,74,184,59.8%,14m
2505,2,不上钻石不改名,3691,721,37,13,50,74.0%,29m
2505,2,[ToHo]哥斯拉,3691,591,36,32,68,52.9%,48m
2505,2,mothership,3691,90,3,7,10,30.0%,13m
2509,1,bilibili,3690,1079,65,63,128,50.8%,8m
2509,1,[Beasty]宗师也是鸡,3690,1335,42,46,88,47.7%,53m
2509,2,[C17079]深色的夜空,3690,470,19,10,29,65.5%,22m
2509,1,[鬼谷]人族就输不了,3690,448,11,18,29,37.9%,48m
2509,1,[ZTSCAP]CornField,3690,0,1,0,1,100.0%,54m
2514,2,CaptainBiken,3689,720,29,19,48,60.4%,14m
2515,1,[HUC群雄]GTcong,3688,1210,79,90,169,46.7%,17m
2515,2,[foryss]zEAlotyc,3688,308,11,7,18,61.1%,6m
2517,2,[死亡收割]MixJdcy,3687,341,13,14,27,48.1%,53m
2517,2,[Ogier]Deadpool,3687,152,5,9,14,35.7%,47m
2519,2,[SC2ACG]IIIIIIIIIIII,3686,1074,54,48,102,52.9%,9m
2520,1,[人间黎明]养金鱼,3685,1833,226,191,417,54.2%,47m
2520,2,[一等星]枪兵叉叉和狗的事,3685,1629,117,121,238,49.2%,28m
2520,2,哈士奇,3685,1294,60,54,114,52.6%,10m
2520,2,耗子尾汁,3685,705,30,16,46,65.2%,6m
2520,2,MissileTruck,3685,434,16,14,30,53.3%,24m
2520,1,汤圆圆圆圆,3685,86,2,9,11,18.2%,7m
2520,2,超人无敌,3685,0,0,1,1,0.0%,52m
2520,1,影子影子,3685,0,0,1,1,0.0%,7m
2520,3,巴姆,3685,0,0,1,1,0.0%,3m
2529,1,Awkward,3684,1867,624,619,1243,50.2%,26m
2529,2,ForsakenSoul,3684,977,83,79,162,51.2%,22m
2529,2,[X英雄圣域X]蓝色的水,3684,952,51,45,96,53.1%,52m
2529,1,大阪孙一峰,3684,836,31,22,53,58.5%,54m
2529,1,poi,3684,588,28,19,47,59.6%,8m
2529,2,[TPoR]Shady,3684,508,26,4,30,86.7%,6m
2529,2,[無輪幻想]清风千叶,3684,0,0,1,1,0.0%,51m
2536,2,[我们是无敌的]pololulu,3683,627,25,21,46,54.3%,48m
2536,2,[新冠携带者]特朗普,3683,514,24,6,30,80.0%,52m
2536,3,简单的多线,3683,163,5,0,5,100.0%,5m
2536,2,IIIIIIIIIIII,3683,30,2,0,2,100.0%,10m
2536,3,[EmPirE]DragonsnowCN,3683,97,1,1,2,50.0%,23m
2536,2,[舰队行驶中]Hell,3683,30,1,3,4,25.0%,13m
2536,1,[素貭極差]车马邮件比较慢,3683,0,0,1,1,0.0%,13m
2543,1,楊泳贒,3681,1149,203,207,410,49.5%,49m
2543,2,[閃光]結城明日奈,3681,444,108,78,186,58.1%,9m
2543,1,[傲世丨听雨轩]出兵核弹,3681,1240,95,90,185,51.4%,50m
2543,1,Dust,3681,1696,80,82,162,49.4%,50m
2543,2,[SoIoAs]血花缭乱,3681,434,15,14,29,51.7%,17m
2543,2,辉之环,3681,128,6,2,8,75.0%,21m
2543,2,IIIIIIIIIIII,3681,30,1,2,3,33.3%,21m
2550,2,shihun,3680,1232,48,43,91,52.7%,21m
2550,1,神族指挥官,3680,331,26,26,52,50.0%,48m
2550,1,[SCAP]Memory,3680,566,13,28,41,31.7%,2m
2550,2,IIIIIIIIIIII,3680,0,1,0,1,100.0%,47m
2554,2,[审判日号]IIIIIIIIII,3679,178,10,9,19,52.6%,3m
2555,1,苍天在上,3678,1859,142,158,300,47.3%,17m
2555,2,forever,3678,0,0,2,2,0.0%,17m
2557,1,麦田守望者,3677,1694,397,372,769,51.6%,54m
2557,2,别学机械,3677,515,34,7,41,82.9%,14m
2557,1,JayZl,3677,477,29,29,58,50.0%,54m
2557,1,[死亡收割]Taka,3677,622,16,21,37,43.2%,2m
2557,2,草莓奶昔,3677,254,10,6,16,62.5%,6m
2557,2,magician,3677,232,8,12,20,40.0%,19m
2557,2,[laomo]LaoMo,3677,122,5,4,9,55.6%,51m
2557,2,[风暴来袭]塔萨达之影,3677,0,0,1,1,0.0%,17m
2565,1,你若微笑便是晴天,3676,1476,82,79,161,50.9%,49m
2565,1,[Hs浪]单机狂魔,3676,1317,55,51,106,51.9%,8m
2565,2,北府宰相,3676,0,0,1,1,0.0%,4m
2568,2,[手撕鸡]TaKaShi,3675,144,5,9,14,35.7%,6m
2568,2,查拉图特斯拉,3675,30,2,4,6,33.3%,19m
2568,2,[青娱乐]llllllllllll,3675,0,0,1,1,0.0%,29m
2571,2,[魔法少女小屋]命运神龙超级萌新,3674,264,9,11,20,45.0%,8m
2571,2,[Beasty]TerranRifle,3674,58,3,4,7,42.9%,14m
2571,2,IIIIIIIIIIII,3674,0,0,1,1,0.0%,8m
2571,2,[狗窝猪圈]Shirobana,3674,0,0,1,1,0.0%,24m
2575,2,Relic,3673,506,25,15,40,62.5%,28m
2575,2,[SoloAs]Fck,3673,501,20,8,28,71.4%,10m
2575,2,[极坐标]练回去了,3673,500,19,13,32,59.4%,28m
2575,2,长路漫漫,3673,194,7,3,10,70.0%,23m
2575,2,aragaki,3673,58,3,1,4,75.0%,52m
2575,3,[PITB]dark,3673,0,1,0,1,100.0%,51m
2575,2,[CHN]LoVeD,3673,0,0,1,1,0.0%,24m
2582,1,果子,3672,1539,191,197,388,49.2%,52m
2582,2,[NVKR]Archon,3672,796,29,29,58,50.0%,14m
2582,1,[EL骑士团]稀神旭东,3672,0,3,2,5,60.0%,7m
2585,2,SuperShinHye,3671,498,24,18,42,57.1%,3m
2585,2,沉默内漂泊,3671,32,2,2,4,50.0%,8m
2585,2,[星际仲裁者]selendis,3671,0,1,0,1,100.0%,17m
2588,2,[惊天浪涛杀]垃圾人族如何生存,3670,440,16,14,30,53.3%,22m
2588,3,奶骑风向标,3670,30,1,1,2,50.0%,16m
2588,2,[天坑a]Iskdhi,3670,0,1,1,2,50.0%,12m
2591,1,星际停更暴雪倒闭,3668,1410,81,82,163,49.7%,17m
2591,2,艾尔之巅,3668,864,34,23,57,59.6%,52m
2591,1,mandery,3668,754,22,25,47,46.8%,14m
2591,2,虫子,3668,152,6,5,11,54.5%,14m
2591,2,[丨SLT丨]夜雨声烦黄少天,3668,58,2,1,3,66.7%,28m
2591,2,[GTV]我就活该被辜负嘛,3668,0,0,1,1,0.0%,6m
2597,2,[鸭蛋万岁]fladon,3667,894,39,23,62,62.9%,24m
2597,1,FUTURE,3667,475,32,28,60,53.3%,2m
2597,1,不罔行,3667,916,25,34,59,42.4%,26m
2597,1,Nichloas,3667,237,5,22,27,18.5%,48m
2601,1,UntilWeDie,3666,676,16,24,40,40.0%,50m
2601,2,[武汉理工大学]鹤望兰,3666,218,7,9,16,43.8%,2m
2601,2,[纸壳]誓死效忠埃蒙,3666,0,1,0,1,100.0%,52m
2601,2,Just,3666,0,1,0,1,100.0%,6m
2601,2,[大鸟转转转]unnerf,3666,34,1,3,4,25.0%,24m
2606,2,CLAAFresno,3665,1638,136,120,256,53.1%,53m
2606,2,llllllllllll,3665,294,11,6,17,64.7%,26m
2606,2,[LDP]EGOIST,3665,0,0,1,1,0.0%,52m
2606,3,[SK]虎丶痴,3665,0,0,6,6,0.0%,23m
2610,1,[Fear]通往天堂,3664,398,11,21,32,34.4%,50m
2610,2,兰登,3664,268,9,11,20,45.0%,26m
2610,1,[鸡层干部]又菜瘾又大,3664,0,1,0,1,100.0%,53m
2613,2,[我们是无敌的]不偷不狗顶正面,3663,1245,62,57,119,52.1%,3m
2613,2,[Beasty]FLInovation,3663,451,21,15,36,58.3%,47m
2613,2,Locust,3663,392,15,8,23,65.2%,9m
2613,2,[撒硕之王]秘制小汉堡,3663,30,2,1,3,66.7%,6m
2613,3,[RyH键谈坊]龙战,3663,0,1,0,1,100.0%,7m
2613,2,曲速拖拉机,3663,0,1,3,4,25.0%,10m
2619,1,[Spacet]心生,3662,1815,438,435,873,50.2%,48m
2619,2,[阿库西斯教廷]LSK,3662,438,15,17,32,46.9%,14m
2619,1,[喂了虫群]TilinZuokana,3662,0,1,0,1,100.0%,17m
2619,2,一朵奇葩,3662,0,1,0,1,100.0%,16m
2619,2,[跟你好好运营]TaeYuKi,3662,0,1,0,1,100.0%,54m
2619,3,小寒,3662,0,1,1,2,50.0%,12m
2619,2,[洛天依我老婆]人生凄惨,3662,0,0,3,3,0.0%,6m
2626,2,IIIIIIIIIIII,3660,1054,41,38,79,51.9%,2m
2626,2,llllllllll,3660,210,32,32,64,50.0%,14m
2626,3,艾尔城市学院,3660,242,11,4,15,73.3%,14m
2626,2,[练出来了协会]陨落之星,3660,75,5,3,8,62.5%,17m
2626,2,状元,3660,0,1,0,1,100.0%,17m
2631,2,不但行而且行,3659,751,33,27,60,55.0%,12m
2631,2,筱寒,3659,602,25,12,37,67.6%,28m
2631,2,流星雨,3659,295,18,15,33,54.5%,13m
2631,2,[I7]edifiep,3659,144,6,0,6,100.0%,52m
2631,2,[教我玩神族]Kirito,3659,238,6,8,14,42.9%,19m
2631,2,[四叶草]Skyhigh,3659,66,3,0,3,100.0%,2m
2637,1,老田,3658,558,23,31,54,42.6%,49m
2637,2,烫手山芋,3658,181,15,7,22,68.2%,28m
2637,2,shiro,3658,230,9,6,15,60.0%,2m
2637,2,FAGZ,3658,142,6,3,9,66.7%,14m
2637,2,[谁在呼叫舰队]红茶奶昔,3658,0,1,1,2,50.0%,2m
2637,2,[超级哈皮]Spicybar,3658,0,0,1,1,0.0%,10m
2643,2,IIIIIIIIIIII,3657,351,18,23,41,43.9%,47m
2643,2,[HFUOT]Minipax,3657,174,7,4,11,63.6%,55m
2643,2,[肉鸡的饲养]魔法少女帕琪酱,3657,66,2,2,4,50.0%,47m
2643,2,伟伟,3657,0,0,3,3,0.0%,14m
2647,2,我是一个小萌新,3656,1658,473,445,918,51.5%,12m
2647,2,XSGing,3656,1310,50,47,97,51.5%,13m
2647,2,[GAFASC]Jayecc,3656,534,22,10,32,68.8%,6m
2647,2,[彼岸鸽友会]yamakaze,3656,460,17,13,30,56.7%,28m
2647,2,汉堡哥哥丫霸,3656,372,14,11,25,56.0%,22m
2647,2,[中华兄弟会]我和黄哥击剑,3656,192,8,4,12,66.7%,48m
2647,2,[新的蜜蜂]我永远爱维多利加,3656,146,6,3,9,66.7%,13m
2647,2,[瞎际霸打]超能之鱼人,3656,0,0,1,1,0.0%,8m
2655,1,voider,3655,1443,167,141,308,54.2%,54m
2655,2,橘子,3655,866,32,39,71,45.1%,19m
2655,2,[Rhusky]给你马刷排叉子,3655,460,17,13,30,56.7%,9m
2655,3,[幽灵闪现wo]TheSoldier,3655,194,9,2,11,81.8%,52m
2655,2,龍天尊,3655,64,3,3,6,50.0%,24m
2660,2,好大一分头,3654,196,6,3,9,66.7%,24m
2660,2,lllllllllll,3654,66,5,3,8,62.5%,8m
2660,2,[神圣刘毅天国]研究生,3654,48,2,4,6,33.3%,54m
2660,2,奈亚拉图提普,3654,0,1,0,1,100.0%,52m
2664,2,[ISMU星际]innovation,3653,691,26,32,58,44.8%,13m
2664,1,[最菜战队]毒奶色粉丝,3653,144,6,1,7,85.7%,20m
2664,2,[莱茵实验组]Meteor,3653,0,0,3,3,0.0%,28m
2667,2,[ToHo]诸葛小亮,3652,365,18,19,37,48.6%,22m
2667,2,[GSC]等风也等你,3652,144,5,2,7,71.4%,51m
2667,1,BOSS,3652,0,1,0,1,100.0%,5m
2667,2,小星星,3652,0,1,0,1,100.0%,6m
2671,2,[萌新萌新萌]YukikazeU,3651,522,25,6,31,80.6%,51m
2671,2,IIIIIIIIIIII,3651,441,15,18,33,45.5%,54m
2671,2,萌新小工蜂,3651,345,11,16,27,40.7%,13m
2671,3,[你们都是渣]非常狠得,3651,173,6,1,7,85.7%,48m
2671,1,呵呵,3651,0,5,1,6,83.3%,13m
2676,2,[SK]necrophagist,3650,1333,63,49,112,56.2%,26m
2676,2,[XYFANS]Misaki,3650,1077,48,27,75,64.0%,28m
2676,2,Lewis,3650,931,45,23,68,66.2%,24m
2676,2,[Vgirls]驻马店孙一峰,3650,122,4,6,10,40.0%,13m
2676,2,[極限戰神]devil,3650,30,1,4,5,20.0%,9m
2676,3,PlaYFair,3650,0,0,1,1,0.0%,48m
2676,2,xyy,3650,0,0,1,1,0.0%,23m
2676,2,IIIlllllIIII,3650,0,0,3,3,0.0%,2m
2684,1,[星河清梦]松坂砂糖,3649,1722,248,254,502,49.4%,54m
2684,2,李村委,3649,197,21,2,23,91.3%,13m
2684,3,Nexus,3649,0,0,1,1,0.0%,16m
2687,2,ladaman,3648,1656,219,214,433,50.6%,9m
2687,2,我是菜鸡,3648,1603,117,97,214,54.7%,14m
2687,2,陌上花开,3648,443,31,21,52,59.6%,19m
2687,2,孤儿请滚,3648,768,28,27,55,50.9%,13m
2687,2,[XXHZN2]羽时俱竞,3648,122,7,6,13,53.8%,9m
2687,2,Starry,3648,30,2,5,7,28.6%,52m
2693,1,llllllllllll,3647,1862,274,269,543,50.5%,8m
2693,2,IIIIIIIIIIII,3647,1373,65,60,125,52.0%,3m
2693,3,control,3647,201,10,3,13,76.9%,7m
2693,3,[买图联系我]全图打星际,3647,121,2,2,4,50.0%,27m
2693,2,[索嚗命鋲斋]烬染不夜,3647,0,1,0,1,100.0%,13m
2693,2,夏雨荷,3647,0,1,1,2,50.0%,14m
2693,2,[十三贴身侍卫]FutureLeader,3647,0,0,1,1,0.0%,8m
2693,2,飞龙骑脸怎么输,3647,0,0,1,1,0.0%,14m
2693,2,[去死吧陈建文]zzylovesll,3647,0,0,3,3,0.0%,18m
2702,2,Seele,3646,1610,72,60,132,54.5%,29m
2702,2,[今天超市打折]潮汐骑单车,3646,492,19,14,33,57.6%,54m
2702,2,[C1359]一般单推屑弟弟,3646,0,1,0,1,100.0%,49m
2702,2,临风听暮蝉,3646,30,1,2,3,33.3%,23m
2702,2,kappa,3646,0,0,3,3,0.0%,19m
2707,2,[桜公馆]园神凛祢,3645,148,5,4,9,55.6%,6m
2707,2,MagejiTerren,3645,124,4,8,12,33.3%,54m
2707,2,[软萌甜小萝莉]机械之刃,3645,30,2,0,2,100.0%,55m
2707,2,[黑丝即是正义]Refuse,3645,0,1,0,1,100.0%,6m
2707,2,IIIIIIIIIIII,3645,30,1,1,2,50.0%,24m
2707,2,[谁在呼叫舰队]playdogaaa,3645,0,1,1,2,50.0%,3m
2713,2,Ptner,3644,975,79,57,136,58.1%,13m
2713,2,海贼王路飞,3644,1165,60,39,99,60.6%,8m
2713,2,xswl,3644,114,5,2,7,71.4%,19m
2713,2,落叶丶,3644,108,5,5,10,50.0%,13m
2713,2,[谁在呼叫舰队]IIIIIIIIIIII,3644,58,2,1,3,66.7%,9m
2718,2,阿缺,3643,1624,136,124,260,52.3%,21m
2718,2,[遭不住呀]Gabriel,3643,815,92,78,170,54.1%,6m
2718,1,[IMRTS]仁义无双总司令,3643,1703,76,95,171,44.4%,23m
2718,2,[充气团]夜刀神十香,3643,1548,72,71,143,50.3%,2m
2718,2,[苟逼无敌]IIIIIIIIIIII,3643,0,0,1,1,0.0%,54m
2723,2,[火焰雷兽]reader,3642,1050,58,20,78,74.4%,21m
2723,2,我不是谐星,3642,350,12,12,24,50.0%,8m
2723,2,[恋战皇朝]原神真好玩,3642,114,4,1,5,80.0%,10m
2723,2,[洁白之巅]csj,3642,0,0,2,2,0.0%,55m
2727,2,[大姐酒家]兄弟要赢的话说下,3641,1216,104,65,169,61.5%,2m
2728,2,OoO,3639,711,164,136,300,54.7%,8m
2728,2,[皓蒙之剑]龙神之鬼兵,3639,30,1,2,3,33.3%,49m
2730,2,[不谐]刀宗黄仁勋,3638,1204,48,41,89,53.9%,10m
2730,2,运了,3638,156,5,10,15,33.3%,24m
2730,2,[ETG]icestyleTYTY,3638,86,3,4,7,42.9%,16m
2730,3,简单电脑,3638,123,3,6,9,33.3%,9m
2730,1,[六芒星]黑曼巴,3638,0,1,0,1,100.0%,51m
2730,2,老猫咪,3638,0,1,1,2,50.0%,25m
2736,1,RoyMustang,3637,162,6,14,20,30.0%,47m
2736,2,[TNLtr]晨灵,3637,0,1,0,1,100.0%,47m
2738,2,lllllllll,3636,1592,278,267,545,51.0%,3m
2738,1,沃德缇娜,3636,1836,240,247,487,49.3%,52m
2738,2,[YA]人菜瘾又大,3636,408,14,16,30,46.7%,24m
2741,2,[响当当水友]PartinG,3635,1425,153,138,291,52.6%,54m
2741,1,莫妮卡,3635,0,0,1,1,0.0%,22m
2743,2,派拉蒙,3634,725,34,27,61,55.7%,18m
2743,1,SuperstarX,3634,796,22,35,57,38.6%,50m
2743,2,[最菜神王]lonestar,3634,485,20,10,30,66.7%,8m
2743,2,[可爱的你们]mness,3634,0,0,1,1,0.0%,11m
2747,2,天亮説晚安,3633,1616,200,188,388,51.5%,4m
2747,2,leexzq,3633,148,6,4,10,60.0%,8m
2747,2,霸天异形,3633,116,4,7,11,36.4%,8m
2750,2,[爱4]老夫很强,3632,1615,397,399,796,49.9%,54m
2750,2,[NVKR]虫族肄业生,3632,1512,61,56,117,52.1%,53m
2750,2,大哥一样的侦察,3632,816,55,46,101,54.5%,4m
2750,2,[ISMU星际]WAY,3632,60,2,2,4,50.0%,19m
2750,2,[svmoon]神圣星光,3632,0,0,1,1,0.0%,53m
2755,2,naan,3631,839,49,49,98,50.0%,19m
2755,2,[Can]Samtair,3631,455,20,7,27,74.1%,6m
2755,2,IIIIIIIIIIII,3631,276,15,12,27,55.6%,9m
2755,3,[舔茶神]比那名居天子,3631,97,5,3,8,62.5%,25m
2755,2,对韭当割,3631,88,3,3,6,50.0%,26m
2755,2,[哔翻天梯鸡]ddddd,3631,68,2,8,10,20.0%,55m
2755,2,sky,3631,0,0,1,1,0.0%,25m
2762,1,IIIIIIIIIIII,3630,1725,552,540,1092,50.5%,7m
2762,2,这就是神族吗,3630,645,52,42,94,55.3%,14m
2764,2,ArSonMan,3629,817,75,76,151,49.7%,28m
2764,2,[HoA]四季夏目,3629,150,6,4,10,60.0%,13m
2764,1,[HotW]StromLord,3629,140,4,1,5,80.0%,5m
2764,2,BinARy,3629,30,2,1,3,66.7%,25m
2764,2,就想和你爽一下,3629,58,2,2,4,50.0%,55m
2769,3,兰兰奇,3628,140,8,1,9,88.9%,8m
2769,2,muru,3628,0,1,0,1,100.0%,55m
2769,2,[尤摩扬禁卫军]不开矿怎么爆兵,3628,0,1,1,2,50.0%,48m
2769,2,[闲散人员]LOL,3628,0,0,1,1,0.0%,14m
2769,2,[琪与玥]千殇月,3628,0,0,1,1,0.0%,16m
2774,1,lllllllllll,3627,1796,535,541,1076,49.7%,50m
2774,2,[Tpb]Thanatos,3627,1164,76,58,134,56.7%,19m
2774,2,[虚拟歌手团体]洛天依,3627,1355,61,44,105,58.1%,55m
2774,2,地堡专业户,3627,347,21,15,36,58.3%,4m
2774,2,Matu,3627,508,18,18,36,50.0%,13m
2774,2,[光头恐惧症]灭神斩,3627,331,16,22,38,42.1%,55m
2774,2,[神之卐领域]黎明之光,3627,90,4,5,9,44.4%,26m
2774,2,[无脑T白给P]FAMOUS,3627,0,1,1,2,50.0%,6m
2774,2,[Killyo]林枫,3627,0,0,2,2,0.0%,16m
2783,2,IIIIIIIIIIII,3626,971,83,72,155,53.5%,25m
2783,2,四万万人齐下泪,3626,474,19,9,28,67.9%,23m
2783,2,吸气牛,3626,310,10,16,26,38.5%,24m
2783,2,轩辕敬城,3626,216,8,9,17,47.1%,55m
2783,1,KPOkaht,3626,97,1,1,2,50.0%,14m
2783,2,[地质大学武汉]Sapphire,3626,0,0,1,1,0.0%,13m
2789,2,sNowTeS,3625,679,29,14,43,67.4%,17m
2789,2,dasdw,3625,0,1,0,1,100.0%,49m
2789,2,[DMRc]英国大力士,3625,0,0,1,1,0.0%,49m
2792,2,Chase,3624,0,0,1,1,0.0%,21m
2792,2,RxSevenZ,3624,0,0,2,2,0.0%,6m
2794,2,[巨龙降临]ZhaJ,3623,172,6,6,12,50.0%,22m
2794,2,林月如的逍遥哥哥,3623,0,1,1,2,50.0%,22m
2796,1,[Shawk]混元星际门炜弟,3622,1621,137,115,252,54.4%,8m
2796,2,[4everY]deadfisheye,3622,1231,81,63,144,56.2%,10m
2796,2,[六骑]是镜子总会反光的,3622,733,76,77,153,49.7%,13m
2796,3,DRGgo,3622,217,7,1,8,87.5%,50m
2796,3,Ghost,3622,119,3,1,4,75.0%,21m
2796,2,[安徽农大]ChenYoung,3622,30,1,1,2,50.0%,6m
2802,1,钢筋,3621,1386,78,93,171,45.6%,50m
2802,2,[名最好别太长]CRCaptain,3621,1652,74,66,140,52.9%,26m
2802,2,[CaiBLu]十二,3621,30,1,1,2,50.0%,53m
2802,2,[守护者睁开眼]逆方向移动,3621,0,0,1,1,0.0%,23m
2806,2,那一刻我没有惊呆,3620,1381,148,126,274,54.0%,26m
2806,1,CQJTUpipi,3620,0,1,0,1,100.0%,5m
2808,2,[天下大同]bird,3619,1371,89,70,159,56.0%,26m
2808,3,宇宙无敌美洲豹,3619,215,8,7,15,53.3%,18m
2810,2,[Mica]吊打老哥,3618,414,31,9,40,77.5%,24m
2810,2,[五月花]蟑螂舞姬,3618,298,11,6,17,64.7%,2m
2810,2,经常放大招,3618,175,6,8,14,42.9%,2m
2810,1,[MSC2GA]superMC,3618,0,1,0,1,100.0%,13m
2814,2,[lDPG]PartinG,3617,1421,95,97,192,49.5%,24m
2814,2,[Shawk]彼岸花开空断肠,3617,1182,84,71,155,54.2%,18m
2814,2,不到三千五不改名,3617,1193,54,41,95,56.8%,2m
2814,2,JVA,3617,60,3,4,7,42.9%,6m
2818,1,IIIIIIIII,3616,1672,352,338,690,51.0%,26m
2818,1,Mars,3616,1828,89,97,186,47.8%,52m
2818,2,肖战哥哥打星际狗,3616,833,42,22,64,65.6%,24m
2818,2,[FLAT]凯枫,3616,300,11,3,14,78.6%,48m
2818,3,MLP,3616,0,1,0,1,100.0%,24m
2818,2,[Tov]IIIIIIIIIIII,3616,0,0,2,2,0.0%,25m
2818,2,EnTaroAdun,3616,0,0,3,3,0.0%,19m
2825,2,[CNboi]线影,3615,506,18,17,35,51.4%,19m
2825,2,[SdDdG]LEE,3615,92,3,6,9,33.3%,25m
2827,2,Tenet,3614,1366,78,72,150,52.0%,4m
2827,2,[Encore]LinZero,3614,846,34,27,61,55.7%,13m
2827,2,[萝莉之芯]搞搞,3614,0,1,0,1,100.0%,47m
2827,2,[SK]星际争霸嘴上过,3614,0,0,2,2,0.0%,22m
2831,3,[NYJC]HardWorKnG,3613,276,14,8,22,63.6%,12m
2831,2,一抹纯白,3613,158,5,9,14,35.7%,14m
2831,2,耶巴蒂莱维贝贝,3613,90,4,5,9,44.4%,11m
2831,3,[KMHKNN]岬明乃,3613,120,3,0,3,100.0%,12m
2831,2,[D7]一级翻白眼运动员,3613,102,2,2,4,50.0%,6m
2831,2,[半个菜鸟II]灰太狼,3613,0,0,1,1,0.0%,2m
2837,2,justin,3612,886,141,121,262,53.8%,17m
2837,1,Death,3612,697,45,46,91,49.5%,14m
2837,2,飞鱼火花,3612,320,12,10,22,54.5%,10m
2837,2,[青铜树]曼珠沙华,3612,0,0,3,3,0.0%,18m
2841,2,[雾雨魔法店]伊蕾娜桑,3611,403,21,11,32,65.6%,55m
2841,3,[SCAP]拿骚的莫里斯,3611,236,11,3,14,78.6%,27m
2841,2,[SLBOY]寒塘渡鹤影,3611,168,6,5,11,54.5%,51m
2841,2,Shinichi,3611,88,3,2,5,60.0%,6m
2841,2,[Rar兄弟会]小花,3611,30,2,2,4,50.0%,19m
2841,2,[X2QK]乾坤深似海,3611,0,1,0,1,100.0%,10m
2847,2,[NS]孤身一人进女厕,3610,530,18,28,46,39.1%,23m
2847,2,[天下第一莽]纳达,3610,458,16,19,35,45.7%,28m
2847,3,红朔,3610,145,8,3,11,72.7%,25m
2850,2,鸽帝熙离,3609,280,11,7,18,61.1%,18m
2850,2,RangerLeader,3609,248,10,5,15,66.7%,26m
2852,2,苏远烟,3608,709,33,32,65,50.8%,10m
2852,2,[Rhusky]风神凌霄,3608,605,30,22,52,57.7%,26m
2852,2,省油的灯,3608,362,17,20,37,45.9%,48m
2852,2,[洛梦绫音]rin,3608,58,2,1,3,66.7%,53m
2852,2,[小小怪怪]Dark,3608,0,0,1,1,0.0%,14m
2857,2,ZasgAk,3607,1599,72,56,128,56.2%,14m
2857,2,[Rhusky]神风子,3607,709,29,19,48,60.4%,29m
2857,2,[Aiursf]阿弱,3607,114,4,2,6,66.7%,10m
2860,1,[幽冥之狼]幽州夜雨,3606,1719,194,200,394,49.2%,50m
2860,2,[T太IMBA]风眼,3606,0,1,0,1,100.0%,52m
2860,2,各位大佬求轻虐,3606,0,1,0,1,100.0%,11m
2863,2,llllllllllll,3605,1207,209,193,402,52.0%,2m
2863,1,[TCP]IIIIIII,3605,1828,86,81,167,51.5%,24m
2863,2,[雨女无瓜]lyfshoot,3605,314,16,10,26,61.5%,6m
2863,2,[Encore]Observer,3605,208,7,1,8,87.5%,55m
2863,2,Humanitysham,3605,94,4,7,11,36.4%,21m
2868,3,NghtOwl,3604,216,10,3,13,76.9%,9m
2868,2,小小白,3604,164,5,13,18,27.8%,2m
2868,2,[枪兵叉叉狗]壹拾叁,3604,0,1,0,1,100.0%,48m
2868,3,杀猪的,3604,0,1,0,1,100.0%,10m
2868,2,[怎么赢z]一束七,3604,0,0,1,1,0.0%,51m
2873,1,[SK]七十二岁带病一波,3603,893,55,66,121,45.5%,54m
2873,2,[守夜]taiho,3603,842,32,30,62,51.6%,6m
2873,2,三色堇,3603,166,7,2,9,77.8%,13m
2873,2,扣怒殴迪奥哒,3603,30,1,2,3,33.3%,26m
2877,2,[Sc养老]残心,3602,814,67,46,113,59.3%,47m
2877,2,解放者猥琐,3602,116,4,5,9,44.4%,25m
2877,1,YeahMen,3602,97,3,0,3,100.0%,4m
2880,1,饭香味的米斯蒂娅,3601,1315,266,255,521,51.1%,23m
2880,2,[中南大学官网]IIIIIIIIIIII,3601,609,57,45,102,55.9%,16m
2880,2,[CPT]星际抄袭王者荣耀,3601,482,18,13,31,58.1%,29m
2880,2,[舰队我是你爹]Xel,3601,220,8,4,12,66.7%,23m
2880,1,[羊驼驼]英雄王子,3601,96,3,3,6,50.0%,48m
2880,2,黑猫紧张,3601,88,3,4,7,42.9%,52m
2880,2,鸡饲料,3601,30,1,1,2,50.0%,6m
2880,2,刘俊义爸爸,3601,34,1,3,4,25.0%,4m
2888,2,[GSX]LadyVe,3600,58,2,3,5,40.0%,6m
2888,3,[HK丶S]雾起时鹿吟,3600,0,1,0,1,100.0%,13m
2890,2,[HK丶S]麒麟竞技,3599,1647,110,100,210,52.4%,9m
2890,2,[现世执妄]人生之遂,3599,849,32,32,64,50.0%,13m
2890,2,Magiczerg,3599,0,1,0,1,100.0%,8m
2893,2,[凶猛]ssdadas,3598,427,23,17,40,57.5%,52m
2893,2,年轻人耗子尾汁,3598,412,15,9,24,62.5%,25m
2893,2,Root,3598,30,2,0,2,100.0%,53m
2893,2,TwoFiveBoy,3598,66,2,7,9,22.2%,16m
2897,2,IIIIIIIIIIII,3597,392,23,17,40,57.5%,10m
2897,2,[舞铲阶级]专打艾尔刁民,3597,174,7,5,12,58.3%,9m
2897,1,PANSUYIN,3597,0,1,0,1,100.0%,12m
2897,1,[TCP]黎明卿,3597,0,1,0,1,100.0%,27m
2897,2,咩冭,3597,0,0,1,1,0.0%,55m
2902,2,屈臣氏,3596,1561,134,112,246,54.5%,26m
2902,2,DAMIMI,3596,1292,55,38,93,59.1%,52m
2902,2,[抱歉我菜死了]无视一切,3596,452,21,15,36,58.3%,29m
2902,3,maru,3596,0,1,0,1,100.0%,21m
2902,2,节操战士,3596,30,1,1,2,50.0%,53m
2907,2,上神,3595,388,13,17,30,43.3%,13m
2907,2,慕容小沫,3595,30,1,3,4,25.0%,13m
2909,2,不会放大招,3594,1570,154,130,284,54.2%,3m
2909,3,SABER,3594,254,13,3,16,81.2%,9m
2909,2,我的运营像吕布,3594,161,9,4,13,69.2%,16m
2909,3,[掌中萌虎0]LIANG,3594,30,2,3,5,40.0%,16m
2909,3,[镜花水月]天狼星,3594,0,1,0,1,100.0%,11m
2909,2,[戴德给拇]满船清梦压星河,3594,0,0,1,1,0.0%,19m
2915,2,哇哈哈哈哈哈,3593,1022,76,74,150,50.7%,2m
2915,2,没有鸽子的鸽子汤,3593,336,12,7,19,63.2%,8m
2915,2,江南人见愁,3593,0,2,2,4,50.0%,16m
2915,2,[般若巴巴空]大威天龙,3593,0,0,1,1,0.0%,9m
2919,2,BABA,3592,228,8,15,23,34.8%,19m
2919,2,dfdf,3592,30,2,1,3,66.7%,55m
2921,2,pandax,3591,1627,513,474,987,52.0%,29m
2921,2,胜败乃兵家常事,3591,1105,226,215,441,51.2%,53m
2921,2,[BOOMER]TYTY,3591,972,42,43,85,49.4%,2m
2921,2,Maru,3591,392,14,13,27,51.9%,53m
2921,2,FatFish,3591,222,8,10,18,44.4%,55m
2921,2,MSGA,3591,88,3,3,6,50.0%,7m
2927,2,碎纸机,3590,1008,64,51,115,55.7%,54m
2927,2,[星际永不为奴]完结的电锯,3590,244,9,7,16,56.2%,7m
2927,3,[凛凛拎个鳖]血翼鸿鹄,3590,172,8,5,13,61.5%,50m
2927,2,Minteeeeeeee,3590,62,2,5,7,28.6%,3m
2927,2,全艾尔的希望,3590,30,1,4,5,20.0%,21m
2927,2,Darkforest,3590,0,0,1,1,0.0%,53m
2927,2,忠犬洪七公,3590,0,0,2,2,0.0%,29m
2934,2,yumiko,3589,1248,66,72,138,47.8%,2m
2934,2,Pepper,3589,30,1,3,4,25.0%,26m
2934,2,[哔哩哔哩乾杯]无敌的罐头,3589,0,0,2,2,0.0%,55m
2937,2,[暴雪我是你爹]擒敌拳,3588,1432,66,59,125,52.8%,21m
2937,2,SCPLAYER,3588,694,27,24,51,52.9%,9m
2937,2,zyf,3588,356,14,12,26,53.8%,9m
2937,1,新垣绫濑,3588,0,1,0,1,100.0%,28m
2941,2,希小弥,3587,1588,338,311,649,52.1%,21m
2941,3,微笑,3587,253,13,1,14,92.9%,55m
2941,2,[薄暮之光]吓哭拉斯之剑,3587,154,6,7,13,46.2%,9m
2944,1,[瞎胡玩玩]FinalFantasy,3586,1802,184,182,366,50.3%,52m
2944,1,[小鸡啄小鱼]小鸡,3586,1087,79,88,167,47.3%,7m
2944,2,IIIIIIIIIIII,3586,376,15,12,27,55.6%,9m
2944,2,Eminem,3586,30,1,3,4,25.0%,7m
2944,2,[中视研]杰钢队长,3586,0,0,3,3,0.0%,25m
2949,2,PAPAHAN,3585,632,25,20,45,55.6%,51m
2949,2,Mimoriuchi,3585,362,16,10,26,61.5%,6m
2949,2,吉安娜,3585,0,1,0,1,100.0%,18m
2952,2,flick,3584,788,34,25,59,57.6%,29m
2952,2,[艾尔大断电]ziposcar,3584,748,31,25,56,55.4%,7m
2954,1,skyseansons,3583,1794,204,213,417,48.9%,17m
2954,2,IIIIIIIIIIII,3583,618,188,172,360,52.2%,8m
2954,2,FIRTY,3583,1459,73,77,150,48.7%,10m
2954,2,[HFUOT]合作怎么玩啊,3583,0,0,1,1,0.0%,51m
2958,2,llllllllllll,3582,1569,86,76,162,53.1%,21m
2958,2,[Ginuna]Nidhoog,3582,480,18,14,32,56.2%,22m
2960,1,[Borne]我乃一能,3581,1132,53,62,115,46.1%,54m
2960,2,[RPG神教]卖萌的探机,3581,873,49,42,91,53.8%,4m
2960,2,松果痰抖闪电鞭,3581,168,6,3,9,66.7%,53m
2960,2,[抱歉我菜死了]东皇明,3581,0,0,1,1,0.0%,26m
2964,2,STXBoGus,3580,218,7,4,11,63.6%,28m
2965,2,[shyxz]念与不念镜花水月,3579,498,43,39,82,52.4%,2m
2965,2,[KPG]cjy,3579,780,39,48,87,44.8%,7m
2965,3,DaoFengTD,3579,350,15,7,22,68.2%,51m
2965,2,Composure,3579,308,12,10,22,54.5%,19m
2965,2,[MC5]ShadowFiend,3579,244,9,12,21,42.9%,21m
2965,2,智哥,3579,182,6,0,6,100.0%,6m
2965,2,[MikoSp]博丽灵梦,3579,0,5,0,5,100.0%,23m
2965,2,[海石三叉戟]LYandGB,3579,74,3,1,4,75.0%,13m
2965,3,软萌倩宝宝吖,3579,0,0,1,1,0.0%,27m
2974,2,思君不见下渝州,3578,1471,150,119,269,55.8%,25m
2974,2,Charon,3578,872,36,31,67,53.7%,11m
2974,2,[SCL]Wilhelmina,3578,30,1,4,5,20.0%,54m
2974,2,空心汤圆,3578,0,0,1,1,0.0%,26m
2978,2,好好玩加油别放弃,3577,1232,48,43,91,52.7%,9m
2978,2,[洁白之巅]掉分炸鱼真君,3577,986,45,26,71,63.4%,52m
2978,1,请不要,3577,852,22,38,60,36.7%,21m
2978,2,[iih]Kikyo,3577,208,8,9,17,47.1%,22m
2978,2,MKKKKKKK,3577,60,3,3,6,50.0%,53m
2978,2,[现世执妄]柔柔,3577,0,0,1,1,0.0%,25m
2984,1,[不会散枪兵]zjh,3576,1673,264,266,530,49.8%,23m
2984,2,修你地堡,3576,1505,191,179,370,51.6%,22m
2984,1,虐死高手,3576,1502,161,179,340,47.4%,17m
2984,2,shapefm,3576,141,13,20,33,39.4%,23m
2984,3,[打一辈子星际]社会你金哥,3576,172,7,6,13,53.8%,16m
2984,2,[核平宇宙]冠状毒爆虫,3576,114,4,3,7,57.1%,12m
2990,2,IIIIIIIIIIII,3575,1554,103,86,189,54.5%,26m
2990,2,fengye,3575,1596,69,54,123,56.1%,25m
2990,2,不月巴的月半子,3575,967,44,31,75,58.7%,13m
2990,2,阿艺子,3575,530,20,16,36,55.6%,51m
2990,1,Sakuraryo,3575,142,7,2,9,77.8%,22m
2990,2,东霸天,3575,58,2,4,6,33.3%,24m
2990,2,Reichlaufen,3575,0,1,0,1,100.0%,19m
2990,1,超级宝宝猫,3575,0,1,1,2,50.0%,55m
2998,2,July,3574,1001,41,40,81,50.6%,49m
2998,2,[KMFA]CatasTRophiC,3574,506,20,16,36,55.6%,16m
2998,1,NaNiwa,3574,0,0,1,1,0.0%,52m
2998,2,[RPG神教]萌萌的探姬,3574,0,0,1,1,0.0%,24m
2998,3,[B站君煌夜]亚托莉,3574,0,0,1,1,0.0%,21m
2998,3,[SteEng]Sun,3574,0,0,2,2,0.0%,50m
3004,1,王总满江红,3573,1582,202,219,421,48.0%,7m
3004,2,IIIIIIIIIIII,3573,1536,91,66,157,58.0%,53m
3004,3,LYsecond,3573,327,12,9,21,57.1%,2m
3004,1,CJsKyHigh,3573,184,8,2,10,80.0%,52m
3004,2,IIIIIII,3573,142,6,8,14,42.9%,11m
3004,2,[第六駆逐鑑隊]我叫白小纯丶,3573,0,1,0,1,100.0%,6m
3004,3,[优纪]美味鱼肉,3573,0,1,0,1,100.0%,12m
3011,3,[大姐酒家]爱利卡,3572,185,10,2,12,83.3%,8m
3011,2,骑着追猎去抢钱,3572,30,1,4,5,20.0%,8m
3011,2,[CcW]IiIiIiIiIiIi,3572,0,0,1,1,0.0%,19m
3011,2,[AHO骑士团]艾酱,3572,0,0,2,2,0.0%,4m
3015,1,seacooky,3571,1752,177,185,362,48.9%,19m
3015,2,[KPG2]邪恶蠢鱼,3571,1326,53,47,100,53.0%,52m
3015,2,CurMsei,3571,664,52,40,92,56.5%,49m
3015,2,日耳曼玫瑰,3571,839,49,38,87,56.3%,2m
3015,2,[就是锉刀怪]緒方理奈,3571,343,10,11,21,47.6%,55m
3015,2,[谁在呼叫舰队]Foreverspide,3571,168,6,5,11,54.5%,29m
3015,2,星际二凉了,3571,0,1,0,1,100.0%,4m
3015,2,HatsuneMiku,3571,0,1,1,2,50.0%,10m
3015,2,[嗜血BaSa]雨人,3571,0,0,1,1,0.0%,7m
3015,2,[混吃混喝]sun,3571,0,0,1,1,0.0%,9m
3015,2,快滚出战场,3571,0,0,1,1,0.0%,25m
3026,2,KTZest,3570,385,12,18,30,40.0%,22m
3026,2,[GB]ProQWQ,3570,30,2,2,4,50.0%,12m
3026,2,ZeroM,3570,0,2,3,5,40.0%,33m
3029,2,慕丶,3569,94,3,8,11,27.3%,22m
3029,2,Stark,3569,30,2,3,5,40.0%,25m
3029,2,[目標諾森德]mater,3569,0,2,3,5,40.0%,10m
3029,2,[Solo]哪鹅,3569,0,1,0,1,100.0%,29m
3029,2,[Buakaw]天威蛟龙,3569,0,0,1,1,0.0%,10m
3029,2,月夜茶会,3569,0,0,10,10,0.0%,21m
3035,2,啥都不会,3568,1390,280,254,534,52.4%,19m
3035,2,[飞鸟牡丹配]timo,3568,1255,53,38,91,58.2%,24m
3035,2,龙之心,3568,390,25,30,55,45.5%,14m
3035,2,llllllllllll,3568,140,5,3,8,62.5%,25m
3035,3,太仓药贩子,3568,121,2,3,5,40.0%,23m
3035,2,dogG,3568,0,0,1,1,0.0%,29m
3041,1,Kings,3567,1679,144,148,292,49.3%,19m
3041,2,三年不洗卵,3567,877,86,74,160,53.8%,9m
3041,2,[我爱熊猫头]LightDragon,3567,810,33,37,70,47.1%,49m
3041,2,[九虚空神教]末代王粉,3567,784,31,24,55,56.4%,18m
3041,2,[神武骑士团]游弈天下,3567,239,11,6,17,64.7%,18m
3041,2,玫瑰,3567,114,4,2,6,66.7%,9m
3041,2,山东郭奉孝,3567,0,1,0,1,100.0%,9m
3041,2,mumu,3567,0,1,0,1,100.0%,29m
3049,2,鸡饲料,3566,381,45,45,90,50.0%,18m
3049,2,[我队伍很强大]立华奏我老婆,3566,564,21,17,38,55.3%,13m
3049,2,[IBE]大主教的亲兵,3566,86,4,0,4,100.0%,9m
3049,2,[i5]DarkArchon,3566,88,3,2,5,60.0%,24m
3049,2,[415]冈本武藏,3566,58,2,4,6,33.3%,14m
3049,2,[浐灞孙一峰]阿布大魔王,3566,0,1,2,3,33.3%,55m
3055,2,[台州温岭]Butcher,3565,582,24,21,45,53.3%,26m
3055,2,不知道取什么名字,3565,280,11,6,17,64.7%,23m
3055,2,IIIIIIIII,3565,95,9,4,13,69.2%,4m
3055,3,七月的风,3565,169,5,1,6,83.3%,56m
3055,2,iGMacsed,3565,120,5,3,8,62.5%,55m
3055,2,卓越,3565,30,1,1,2,50.0%,29m
3055,2,浩然,3565,0,0,1,1,0.0%,10m
3055,2,IIIIIIIIIIII,3565,0,0,2,2,0.0%,6m
3063,2,Zest,3564,1609,283,260,543,52.1%,19m
3063,2,[酷睿i7]ccs,3564,30,2,4,6,33.3%,53m
3065,2,穆拉丁,3563,0,0,1,1,0.0%,2m
3065,2,鲲吞天下,3563,0,0,1,1,0.0%,2m
3067,2,[你个]萌萌哒的金甲虫,3562,368,15,16,31,48.4%,18m
3067,3,天朝第一恒酱,3562,187,10,2,12,83.3%,50m
3067,2,[桃家帮]韬叶,3562,120,5,6,11,45.5%,13m
3067,2,[阿塔尼斯]星际喵,3562,86,4,1,5,80.0%,9m
3067,2,[SC2近卫军]诸神之王,3562,0,1,0,1,100.0%,21m
3067,3,seed,3562,0,1,0,1,100.0%,48m
3073,2,[EGL]flyaway,3561,670,21,34,55,38.2%,25m
3073,2,ZIMBA,3561,137,15,17,32,46.9%,54m
3073,2,逼格之链第一人,3561,62,5,12,17,29.4%,53m
3076,2,[亀山社中]白石麻衣毕业快乐,3560,718,32,17,49,65.3%,21m
3076,2,[TLGD]帅楷,3560,495,27,19,46,58.7%,51m
3076,2,[宇宙职业战队]Classical,3560,356,16,3,19,84.2%,26m
3076,2,部队集结者,3560,344,12,15,27,44.4%,29m
3076,2,研默,3560,250,10,5,15,66.7%,53m
3076,2,[炮火46]用眼神秒杀你,3560,75,4,5,9,44.4%,8m
3076,1,野人不需要智力,3560,116,3,0,3,100.0%,25m
3076,2,随风看海,3560,60,3,6,9,33.3%,21m
3076,2,[星海绚丽]AvaLanche,3560,0,1,0,1,100.0%,7m
3076,2,[南京27中]长弓如青月,3560,30,1,4,5,20.0%,12m
3076,2,[星空杀鸡]仰望星空,3560,0,0,1,1,0.0%,9m
3076,2,[KPG]帝林,3560,0,0,2,2,0.0%,2m
3088,2,[YA]hzy,3559,719,38,22,60,63.3%,19m
3088,2,[五月花]宫内莲华,3559,605,27,13,40,67.5%,2m
3088,2,[HK丶S]夕颜凉,3559,224,9,0,9,100.0%,55m
3091,1,IIIIIIIIIII,3558,1733,104,100,204,51.0%,47m
3091,1,[ZJU]Archer,3558,1493,92,78,170,54.1%,54m
3091,2,[输本夺冠啦]来碗豆腐司机,3558,1541,90,72,162,55.6%,2m
3091,2,包了个媛,3558,931,50,29,79,63.3%,53m
3091,2,风吹蛋凉,3558,436,16,14,30,53.3%,13m
3091,3,[雾雨魔法森林]西行寺幽幽子,3558,191,6,2,8,75.0%,22m
3091,2,大师以下跳逼没妈,3558,140,5,2,7,71.4%,29m
3091,2,夜章,3558,86,4,1,5,80.0%,55m
3091,2,[doka]feiying,3558,0,1,0,1,100.0%,10m
3091,2,TheCall,3558,0,0,1,1,0.0%,14m
3091,2,Wayne,3558,0,0,1,1,0.0%,22m
3102,2,我的神族像鸟哥,3557,1395,66,42,108,61.1%,23m
3102,2,[FLDSCL]小魔仙,3557,949,50,22,72,69.4%,55m
3102,2,[XX丶OO]旧丿年,3557,181,8,9,17,47.1%,3m
3102,2,[牌面]傲魄,3557,95,6,4,10,60.0%,8m
3102,2,[女仆之心]CharAznable,3557,58,3,4,7,42.9%,52m
3102,2,llllllllllll,3557,0,0,1,1,0.0%,23m
3102,2,JekyllHyde,3557,0,0,1,1,0.0%,22m
3109,2,Dreamflsh,3556,306,9,13,22,40.9%,12m
3109,3,[OgiNA]aragon,3556,6,3,34,37,8.1%,19m
3109,3,MMA,3556,0,0,1,1,0.0%,28m
3112,2,[Marry]ForAiur,3555,257,40,47,87,46.0%,18m
3112,2,[s黑色玫瑰s]禁区枭歌,3555,809,31,42,73,42.5%,48m
3112,2,青丿灬小溪,3555,554,25,26,51,49.0%,54m
3115,2,[四叶草]漫长总是不满,3554,442,16,16,32,50.0%,25m
3115,2,Sincerely,3554,394,14,12,26,53.8%,7m
3115,2,[国足救星]yelg,3554,296,11,10,21,52.4%,2m
3115,2,INNoVation,3554,168,6,3,9,66.7%,14m
3115,2,闪电五连鞭,3554,60,3,4,7,42.9%,53m
3115,2,Echo,3554,0,0,1,1,0.0%,22m
3115,2,[南京工业大学]寂静荣誉方舟骑士,3554,0,0,3,3,0.0%,13m
3122,2,IIIIIIIIIIII,3553,1468,60,55,115,52.2%,8m
3122,2,魔法少女黄旭东,3553,681,52,49,101,51.5%,53m
3122,2,凡沙,3553,735,40,24,64,62.5%,6m
3122,3,[由我们重回]血刃可否挽樱落,3553,231,10,0,10,100.0%,25m
3122,2,[秋毫]QOVEN,3553,306,10,17,27,37.0%,52m
3122,3,[缇娜缇娜缇]星辰雪,3553,58,2,2,4,50.0%,52m
3128,2,隔壁小黄,3552,1288,113,83,196,57.7%,23m
3128,2,[南京工业大学]dhran,3552,557,28,27,55,50.9%,26m
3128,2,[Tgirl]放纵的青春,3552,300,13,10,23,56.5%,6m
3128,2,[刺蛇互助社团]TureNo,3552,216,7,12,19,36.8%,6m
3128,2,[Flowex]GUL,3552,86,4,7,11,36.4%,19m
3128,2,[昆明RANK]Gwagen,3552,0,0,1,1,0.0%,11m
3134,2,[Volvo]Timberwolf,3551,698,28,26,54,51.9%,26m
3134,2,Sakura,3551,117,15,11,26,57.7%,49m
3134,2,菜的想自杀,3551,95,5,1,6,83.3%,14m
3134,1,xiaopengyou,3551,48,4,5,9,44.4%,5m
3134,2,Aomine,3551,30,2,0,2,100.0%,53m
3134,2,zeratul,3551,0,1,0,1,100.0%,49m
3134,2,[宣书赏月]毫挥御桌上宣,3551,30,1,2,3,33.3%,49m
3134,2,victor,3551,0,0,2,2,0.0%,6m
3142,2,[婬蕙涩情]lIIllIlIlIlI,3550,1601,288,279,567,50.8%,19m
3142,2,[探机大人]不打探机好不好,3550,762,58,38,96,60.4%,25m
3142,2,宇智波狂笑四杰,3550,187,14,12,26,53.8%,53m
3142,2,菜虚鲲,3550,272,10,5,15,66.7%,8m
3142,1,sjy,3550,203,8,2,10,80.0%,17m
3142,2,[西南风]会哭的佩可莉姆,3550,140,5,4,9,55.6%,10m
3142,2,IIIIIIIIIIII,3550,114,5,5,10,50.0%,9m
3142,2,Destiny,3550,58,3,1,4,75.0%,3m
3142,1,[Thpj]IIIIIIIIIIII,3550,48,3,4,7,42.9%,27m
3142,2,[C26289]遇事不决莽一波,3550,0,2,4,6,33.3%,25m
3142,2,[一条菜狗]泷泽萝拉,3550,0,1,0,1,100.0%,48m
3142,2,[SHNU]Fantasy,3550,0,0,2,2,0.0%,2m
3154,2,[NTZX]Adestiny,3549,847,69,66,135,51.1%,48m
3154,2,辞尘,3549,376,17,8,25,68.0%,55m
3154,2,武大国软咸鱼王,3549,246,9,3,12,75.0%,54m
3154,2,上城丶上城,3549,0,4,1,5,80.0%,3m
3154,2,[TNLtr]Arpeggio,3549,0,1,0,1,100.0%,14m
3154,2,[半个菜鸟II]ForeverQi,3549,0,1,0,1,100.0%,18m
3154,2,FreeDTG,3549,30,1,2,3,33.3%,26m
3154,2,肌肉酸痛,3549,0,0,1,1,0.0%,10m
3162,2,多线爆炸,3548,216,8,7,15,53.3%,6m
3162,2,小百合,3548,0,1,0,1,100.0%,7m
3162,2,FYFYFY,3548,0,1,0,1,100.0%,4m
3162,2,在你家起地堡,3548,32,1,1,2,50.0%,53m
3162,3,[野蛮猫骑士]llllllllllll,3548,0,0,2,2,0.0%,47m
3167,2,刀哥传说,3547,1547,196,197,393,49.9%,4m
3167,2,[折纸后援团]阿库卢马卡卡,3547,1478,189,171,360,52.5%,18m
3167,2,沉稳的牧凡,3547,1309,102,86,188,54.3%,11m
3167,2,[KPL1vc]Violet,3547,732,41,22,63,65.1%,6m
3167,2,[寿司吧嘤嘤怪]世羽丶波拿文都拉,3547,465,26,14,40,65.0%,13m
3167,2,虎狼之顾,3547,0,1,0,1,100.0%,4m
3173,2,IIIIIIiIIIII,3546,334,22,17,39,56.4%,12m
3174,2,mgjprotoss,3545,426,17,9,26,65.4%,55m
3174,2,[万物齐一]随心自在,3545,30,2,0,2,100.0%,48m
3176,1,[火焰雷兽]JacKsonVille,3544,1630,57,69,126,45.2%,18m
3176,2,小小萌新,3544,509,29,7,36,80.6%,55m
3176,1,[Ogier]贤狼赫萝,3544,156,6,3,9,66.7%,20m
3176,2,LSCHuei,3544,0,0,1,1,0.0%,19m
3176,2,[野生无公害]野生的浅宇柒,3544,0,0,1,1,0.0%,29m
3181,2,[什么族自己猜]人口满了怎么弄,3543,1609,84,48,132,63.6%,23m
3181,2,[我们是无敌的]幽依,3543,762,34,23,57,59.6%,13m
3181,2,[基金会]迪特里希,3543,0,2,4,6,33.3%,3m
3181,2,两岸风景,3543,0,1,0,1,100.0%,18m
3181,2,菜鸟,3543,0,1,0,1,100.0%,53m
3181,1,IIIIIIIIIIII,3543,96,1,2,3,33.3%,51m
3181,2,国产零零漆,3543,0,1,3,4,25.0%,26m
3181,2,PANDAY,3543,0,0,3,3,0.0%,53m
3189,2,WillLose,3542,1571,378,377,755,50.1%,54m
3189,2,[哈莉奎茵丶]MarScarrY,3542,413,88,52,140,62.9%,14m
3189,2,[青生浮梦]青木裕光,3542,808,32,26,58,55.2%,14m
3189,2,Immortal,3542,872,31,28,59,52.5%,14m
3189,2,铃兰十礼,3542,457,21,14,35,60.0%,10m
3189,2,[星际传销组织]theEGG,3542,136,6,3,9,66.7%,4m
3189,2,seals,3542,0,1,0,1,100.0%,24m
3189,2,[星际仲裁者]清尘宇灵,3542,0,0,1,1,0.0%,28m
3189,2,[LM]IIIIIIIIIIII,3542,0,0,1,1,0.0%,19m
3189,2,Bommz,3542,0,0,1,1,0.0%,10m
3199,2,[你不对劲]我有问题,3541,1528,60,53,113,53.1%,2m
3199,2,可哥可妻孙一峰,3541,232,8,3,11,72.7%,52m
3199,2,[loveMM]沧海客,3541,88,3,3,6,50.0%,25m
3199,2,[鬼眼通天]sdf,3541,30,1,3,4,25.0%,15m
3203,1,[入侵地球]农夫三拳有点疼,3540,1235,253,245,498,50.8%,23m
3203,2,等风来,3540,1581,148,136,284,52.1%,47m
3203,2,IIIIIIIIII,3540,929,92,84,176,52.3%,14m
3203,2,[素貭極差]大源哥,3540,627,24,19,43,55.8%,25m
3203,2,[送分大队]ALARICUS,3540,194,7,5,12,58.3%,48m
3203,2,Madrior,3540,140,6,3,9,66.7%,22m
3203,2,[BJTU]FTDfangge,3540,0,1,0,1,100.0%,23m
3203,1,llllllllllll,3540,0,1,4,5,20.0%,52m
3203,2,泰伦就无敌,3540,0,0,1,1,0.0%,6m
3203,2,[Auir]FoRong,3540,0,0,2,2,0.0%,8m
3213,1,希望的光芒,3539,1774,148,120,268,55.2%,8m
3213,2,starcat,3539,1517,128,128,256,50.0%,53m
3213,2,[暴雪我是你爹]醉花荫磊,3539,772,30,25,55,54.5%,7m
3213,2,[我们都是鸽子]鸽子王,3539,176,7,10,17,41.2%,24m
3213,2,[入侵地球]niColeTnT,3539,0,0,2,2,0.0%,19m
3218,2,繁星夜月,3538,1256,93,85,178,52.2%,28m
3218,2,redt,3538,898,32,40,72,44.4%,22m
3218,3,来骗来偷袭,3538,195,7,7,14,50.0%,49m
3218,1,[天子这大菜B]虎牙丶阳光,3538,0,1,0,1,100.0%,12m
3218,2,[喵喵舰队]比格沃斯喵酱舰长,3538,0,0,1,1,0.0%,13m
3223,2,[黑丝即是正义]羽灰琥珀,3537,1147,167,121,288,58.0%,18m
3223,2,苏九,3537,722,40,11,51,78.4%,16m
3223,2,宇智波鼬,3537,324,13,10,23,56.5%,13m
3223,2,MuCh,3537,30,2,0,2,100.0%,25m
3223,1,[温柔兔公主]Dale,3537,48,2,3,5,40.0%,28m
3223,2,[哔翻天梯鸡]MarineKing,3537,0,0,1,1,0.0%,14m
3229,2,Crema,3536,1591,84,69,153,54.9%,26m
3229,2,[ZJU]ROBIN,3536,161,8,6,14,57.1%,16m
3229,2,蛛丝马迹,3536,0,1,1,2,50.0%,18m
3232,1,prophet,3535,1457,180,186,366,49.2%,54m
3232,2,killuko,3535,1543,175,178,353,49.6%,13m
3232,2,你的探姬遭到搞基,3535,167,6,3,9,66.7%,11m
3232,2,阿西吧,3535,95,2,4,6,33.3%,29m
3236,2,黄浦江深,3534,1156,64,68,132,48.5%,22m
3236,2,雷政富,3534,300,46,49,95,48.4%,47m
3236,2,时间走快点,3534,180,7,9,16,43.8%,13m
3236,2,阿斯蒂芬,3534,0,5,0,5,100.0%,20m
3236,2,[MUL]sum,3534,58,2,2,4,50.0%,7m
3236,2,[不谐]武圣马保国,3534,0,0,3,3,0.0%,49m
3242,2,两仪式,3533,1197,116,115,231,50.2%,12m
3242,2,[保证不秀地堡]恐怖如斯,3533,873,65,42,107,60.7%,13m
3242,2,IIIIIIIIIIII,3533,276,10,11,21,47.6%,53m
3242,2,[半个大哥]IIIIIIIII,3533,0,1,4,5,20.0%,50m
3246,2,hhhhhhhhhhhh,3532,795,35,22,57,61.4%,19m
3246,2,[Icycry]DeathKnight,3532,0,0,1,1,0.0%,47m
3246,2,[奥术之光]低语,3532,0,0,2,2,0.0%,9m
3249,2,TIMO,3531,883,125,101,226,55.3%,2m
3249,2,[YBY]你们无敌的老师,3531,736,29,27,56,51.8%,25m
3249,2,[153cm]diao,3531,534,20,22,42,47.6%,53m
3249,3,[十三音]比那名居天子,3531,170,5,3,8,62.5%,50m
3249,2,[南京工业大学]重熙累叶,3531,142,5,5,10,50.0%,10m
3249,1,[i9]㝵㝵㝵㝵㝵㝵㝵㝵,3531,164,4,0,4,100.0%,10m
3249,2,TKTIM,3531,0,1,0,1,100.0%,8m
3249,2,[哔哩哔哩杯乾]DayFly,3531,0,0,1,1,0.0%,9m
3249,3,Shermie,3531,0,0,1,1,0.0%,49m
3258,1,[TNL]奔跑的蜗牛,3530,1499,293,289,582,50.3%,8m
3258,2,雅虎,3530,1099,80,66,146,54.8%,4m
3258,2,霜狼,3530,230,6,8,14,42.9%,23m
3258,2,咔哒哒,3530,30,2,5,7,28.6%,29m
3258,2,逆犬之王,3530,0,0,1,1,0.0%,9m
3258,2,[Mensa]Stormrage,3530,0,0,1,1,0.0%,23m
3264,2,[刺蛇单推协会]INNovaTion,3529,1536,89,89,178,50.0%,18m
3264,2,[Fisher]儒花,3529,582,22,22,44,50.0%,4m
3264,2,[北极光小组]SpringIce,3529,250,8,5,13,61.5%,18m
3264,2,[红萌馆]西江月,3529,113,3,6,9,33.3%,14m
3264,2,[在途喵喵打击]秋天的宇希菌,3529,0,0,1,1,0.0%,53m
3269,2,[穿梭]英灵战歌,3528,1527,150,148,298,50.3%,9m
3269,2,[白给了]llllll,3528,1539,94,85,179,52.5%,7m
3269,2,realgun,3528,1216,93,88,181,51.4%,47m
3269,2,[GGGLLL]Original,3528,853,72,77,149,48.3%,10m
3269,2,澳门丽景湾,3528,410,29,24,53,54.7%,24m
3269,2,奥尔加一直卡,3528,417,15,17,32,46.9%,3m
3275,1,暴雪不在乎你意见,3527,1676,256,233,489,52.4%,8m
3275,2,[五月花]千年之蝶,3527,1576,170,141,311,54.7%,15m
3275,2,带带梁慕容霸,3527,275,53,49,102,52.0%,53m
3275,2,FateHarlaown,3527,168,6,7,13,46.2%,47m
3275,2,EnTaroStats,3527,114,5,3,8,62.5%,10m
3275,2,[HeroZP]索伦之眼,3527,0,3,3,6,50.0%,13m
3275,3,莫知我哀,3527,58,2,2,4,50.0%,7m
3275,2,[52区]IIIIIIIIIII,3527,30,2,3,5,40.0%,53m
3275,2,释迦牟尼,3527,0,1,0,1,100.0%,22m
3275,2,[铭刻於红魂丶]芙兰朵樱,3527,30,1,1,2,50.0%,22m
3275,2,枪神尤里,3527,0,0,1,1,0.0%,2m
3286,2,郎笑藕丝,3526,188,14,13,27,51.9%,9m
3286,3,英雄联盟小学生,3526,190,6,2,8,75.0%,25m
3286,2,Zozzj,3526,58,2,2,4,50.0%,10m
3286,2,[NeXT]冰雪沸腾,3526,30,2,10,12,16.7%,10m
3286,2,[CARMYS]温柔善良王潇涵,3526,0,1,0,1,100.0%,13m
3286,2,[上海海洋大学]谷寻,3526,0,1,0,1,100.0%,24m
3286,2,IIIIIII,3526,30,1,2,3,33.3%,21m
3293,1,无情的下棋机器,3525,1500,222,227,449,49.4%,20m
3293,2,lyon,3525,1552,199,192,391,50.9%,47m
3293,2,[大河向东流]Grommashlee,3525,1232,81,68,149,54.4%,6m
3293,2,小邓,3525,675,51,37,88,58.0%,21m
3293,2,好哥哥别放狗招,3525,84,5,5,10,50.0%,3m
3293,2,missju,3525,30,2,4,6,33.3%,19m
3293,2,SchoolDays,3525,0,1,0,1,100.0%,26m
3293,2,[肉鸡的饲养]魔法少女咩咩酱,3525,0,0,4,4,0.0%,51m
3301,2,大佬让我一把,3524,507,56,47,103,54.4%,13m
3301,2,子安文人,3524,0,1,1,2,50.0%,18m
3301,2,[GAGA]Viva,3524,30,1,2,3,33.3%,22m
3304,2,llllllllllll,3523,1293,180,174,354,50.8%,28m
3304,2,IIIIIIIII,3523,326,12,12,24,50.0%,16m
3304,2,llllllllllll,3523,0,5,0,5,100.0%,12m
3304,2,logicabin,3523,0,5,0,5,100.0%,19m
3304,2,[Encore]MrLoveQ,3523,150,5,11,16,31.2%,26m
3304,2,[Abadon]干锅包菜煲,3523,0,2,2,4,50.0%,26m
3304,2,[温柔兔公主]我爱修地堡,3523,32,2,7,9,22.2%,29m
3311,2,[火焰雷兽]海阔天空,3522,684,512,500,1012,50.6%,54m
3311,2,[放弃治疗]白菜,3522,1436,57,60,117,48.7%,13m
3311,3,[JOKER]sky,3522,190,10,4,14,71.4%,17m
3311,2,[张润Fans]润宝我的超人,3522,220,8,13,21,38.1%,22m
3311,2,IIIIIIIIIII,3522,0,5,0,5,100.0%,16m
3311,2,[肉鸡的饲养]TYty,3522,116,4,4,8,50.0%,48m
3317,1,wzyu,3521,1355,127,130,257,49.4%,23m
3317,2,花开若相惜,3521,1341,100,87,187,53.5%,8m
3317,2,枯萎之地,3521,694,25,24,49,51.0%,8m
3317,2,反贪局局长侯亮平,3521,0,5,0,5,100.0%,49m
3317,2,大梦谁先觉,3521,0,1,0,1,100.0%,6m
3317,2,[混沌领主]格尔哈特,3521,0,1,0,1,100.0%,54m
3317,2,RaVaGer,3521,0,0,1,1,0.0%,12m
3324,2,[搔浪剑]浪客无疾君莫忧,3520,1511,77,47,124,62.1%,53m
3324,2,Milotic,3520,899,57,52,109,52.3%,19m
3324,2,[我们是无敌的]混元星际门昭太羊,3520,669,30,23,53,56.6%,29m
3324,2,[JPS]神棍德,3520,58,2,2,4,50.0%,14m
3324,2,AntiRain,3520,0,0,1,1,0.0%,13m
3329,1,随风潜入夜,3519,1696,198,213,411,48.2%,8m
3329,2,[河北科技大学]奇妙兔斯基,3519,447,18,15,33,54.5%,22m
3329,2,forever,3519,466,16,14,30,53.3%,26m
3329,3,[KPL1vc]Violet,3519,296,10,13,23,43.5%,49m
3329,2,SIX,3519,242,9,4,13,69.2%,12m
3329,2,寂默,3519,30,1,1,2,50.0%,13m
3329,2,Betelgeuse,3519,0,1,3,4,25.0%,28m
3329,2,[雾雨魔法森林]自闭人,3519,0,0,1,1,0.0%,10m
3337,2,landmine,3518,1370,101,84,185,54.6%,26m
3337,2,[SCer]xiaoxiao,3518,1031,86,68,154,55.8%,22m
3337,2,[尤摩扬科技]xiaoS,3518,138,6,4,10,60.0%,11m
3340,2,peter,3517,1509,206,202,408,50.5%,4m
3340,1,[我们是无敌的]watch,3517,1733,73,89,162,45.1%,54m
3340,2,手残党,3517,618,41,39,80,51.2%,20m
3340,2,唐毅萌萌哒哟,3517,646,32,15,47,68.1%,6m
3340,2,[寂灵]FOR,3517,737,31,21,52,59.6%,6m
3340,2,Kylin,3517,206,25,14,39,64.1%,47m
3340,2,请不要欺负小萌新,3517,0,3,2,5,60.0%,50m
3340,2,[rush2]苹果味菠萝酱,3517,0,1,0,1,100.0%,54m
3348,2,Lemures,3516,1568,251,234,485,51.8%,6m
3348,2,[THLC]Troway,3516,1571,208,183,391,53.2%,8m
3348,2,SuKmino,3516,1454,130,118,248,52.4%,55m
3348,2,[不偷不狗硬顶]可恨的菜逼,3516,1061,54,57,111,48.6%,9m
3348,2,Meltlilith,3516,1007,46,32,78,59.0%,13m
3348,2,[EXcell]Afendis,3516,418,36,36,72,50.0%,13m
3348,2,banerer,3516,499,25,10,35,71.4%,3m
3348,2,恶魔,3516,592,25,16,41,61.0%,13m
3348,2,[XYFANS]SLIMSHADY,3516,244,9,11,20,45.0%,12m
3348,3,RedMoon,3516,232,8,3,11,72.7%,21m
3348,2,冰血之殇,3516,210,7,3,10,70.0%,6m
3359,2,[杜克SC2]永远的下巴,3515,1340,79,79,158,50.0%,49m
3359,2,[NKTJ]tuguapi,3515,316,13,6,19,68.4%,23m
3359,3,不想运营,3515,208,10,5,15,66.7%,21m
3359,2,满脸横肉的孙哥,3515,86,6,6,12,50.0%,26m
3359,2,米拉,3515,174,6,12,18,33.3%,20m
3359,2,谷歌浏览器,3515,0,5,0,5,100.0%,8m
3359,2,炸鱼崽种亲妈必死,3515,86,3,3,6,50.0%,55m
3359,2,kerjinl,3515,30,1,1,2,50.0%,13m
3359,2,NAWI,3515,0,0,1,1,0.0%,52m
3359,2,[肉鸡的饲养]夜的第七章,3515,0,0,2,2,0.0%,55m
3369,2,[极限菜鸟]ConstanTine,3514,1591,181,165,346,52.3%,6m
3369,1,[GAGA二队]BIG,3514,1239,36,60,96,37.5%,9m
3369,2,[暴雪我是你爹]rye,3514,740,29,21,50,58.0%,25m
3369,2,[大姐酒家]心中只有爱萌,3514,443,23,5,28,82.1%,8m
3369,2,莽夫米兰达,3514,312,14,3,17,82.4%,2m
3369,1,RFZealot,3514,163,8,2,10,80.0%,51m
3369,2,大脚游戏论坛,3514,244,8,16,24,33.3%,8m
3369,2,[小金上天队]Meow,3514,88,4,2,6,66.7%,11m
3369,2,[HTW]Origin,3514,30,2,1,3,66.7%,3m
3369,2,[SCAP]真的好久不打了,3514,30,1,4,5,20.0%,8m
3369,2,[禽禽禽]KingRabbit,3514,0,0,1,1,0.0%,53m
3380,2,范超,3513,1519,189,195,384,49.2%,54m
3380,2,NEWLxND,3513,658,48,42,90,53.3%,13m
3380,2,[Holyam]solves,3513,422,14,20,34,41.2%,13m
3380,2,别狗不会防,3513,350,13,19,32,40.6%,22m
3380,2,Bonnenuit,3513,30,1,1,2,50.0%,49m
3380,2,人生若只如初见,3513,30,1,9,10,10.0%,51m
3380,2,Shine,3513,0,0,4,4,0.0%,26m
3387,2,WinterKiller,3512,564,20,20,40,50.0%,20m
3387,3,追猎骑脸怎么输,3512,264,12,5,17,70.6%,5m
3387,3,[烽夜长歌]PBBB,3512,140,7,2,9,77.8%,50m
3387,3,[kG]恶灵,3512,159,5,0,5,100.0%,51m
3391,2,谐星之超兵丿,3511,1169,46,44,90,51.1%,23m
3391,2,NBA,3511,603,36,22,58,62.1%,10m
3391,2,我要打你一波,3511,644,26,18,44,59.1%,22m
3391,2,RainbowC,3511,314,12,9,21,57.1%,54m
3391,3,[杀生业报]maru,3511,261,8,7,15,53.3%,53m
3391,2,雾忆殇,3511,30,1,1,2,50.0%,19m
3391,2,[丨SLT丨]重生在她的梦里,3511,30,1,1,2,50.0%,3m
3391,2,[Ziyan]Wayne,3511,0,0,1,1,0.0%,11m
3399,1,Zealot,3510,1750,639,623,1262,50.6%,48m
3399,2,金将军,3510,1297,482,463,945,51.0%,26m
3399,2,RoseWeiser,3510,1201,91,51,142,64.1%,23m
3399,2,[升格之链hh]Gloud,3510,658,30,21,51,58.8%,51m
3399,1,[洛丹伦的雨夜]Radiance,3510,118,3,1,4,75.0%,3m
3399,1,[i5]杨煜鸥,3510,115,2,1,3,66.7%,4m
3399,2,[APT]AsadaShino,3510,0,1,0,1,100.0%,14m
3399,2,[艾抖露]BlackHand,3510,0,0,1,1,0.0%,19m
3407,2,[NZNZ]辉门山,3509,1463,698,693,1391,50.2%,3m
3407,2,小鹏,3509,385,128,110,238,53.8%,24m
3407,1,[YM]Littlefly,3509,1730,89,93,182,48.9%,51m
3407,2,Saber,3509,950,46,26,72,63.9%,3m
3407,2,IIIIIIIIIIII,3509,687,28,21,49,57.1%,3m
3407,2,DarJumpKing,3509,448,15,18,33,45.5%,3m
3407,2,小桥若,3509,378,14,10,24,58.3%,10m
3407,2,[NLH]wsgh,3509,118,5,5,10,50.0%,7m
3407,2,IIIIIIIIIII,3509,0,2,0,2,100.0%,3m
3407,2,herO,3509,30,2,1,3,66.7%,3m
3407,2,[EL骑士团]坚持到底,3509,58,2,2,4,50.0%,29m
3407,2,[北京大学鸡协]小蛋壳,3509,30,1,4,5,20.0%,11m
3407,3,[四叶草]大星淡,3509,30,1,6,7,14.3%,55m
3420,1,止啼文远,3508,1593,329,332,661,49.8%,21m
3420,2,伊卡洛斯,3508,1530,174,153,327,53.2%,53m
3420,2,IIIIIIIIIIII,3508,985,45,30,75,60.0%,22m
3420,2,[钉宫病]你指尖跃动的电光,3508,602,24,18,42,57.1%,47m
3420,3,跳跳舞,3508,235,11,5,16,68.8%,22m
3420,2,文昌小学第一神族,3508,220,10,1,11,90.9%,8m
3426,2,[BGD]Miczz,3507,914,100,93,193,51.8%,29m
3426,2,[最高萌新议会]一个人你害怕吗,3507,0,5,0,5,100.0%,14m
3426,2,yTY,3507,58,3,3,6,50.0%,18m
3426,2,蓝白,3507,18,2,1,3,66.7%,22m
3430,1,红烧肉,3506,1699,162,177,339,47.8%,21m
3430,2,沉默风暴,3506,313,16,11,27,59.3%,6m
3430,2,ForBidden,3506,0,1,0,1,100.0%,23m
3430,3,Scorpion,3506,0,1,2,3,33.3%,27m
3430,2,[RTSGo]doomwatcher,3506,0,0,2,2,0.0%,53m
3435,2,BlackbeaNs,3505,568,20,20,40,50.0%,55m
3435,2,擎苍龍,3505,86,4,4,8,50.0%,9m
3435,2,[FZD]艾尔必将光复,3505,0,3,2,5,60.0%,22m
3435,2,塞肉是暴雪爹,3505,30,2,2,4,50.0%,3m
3435,3,冰冰敲可耐,3505,0,0,3,3,0.0%,5m
3440,2,藏家小男孩,3504,832,35,26,61,57.4%,54m
3440,2,康康大神,3504,647,32,35,67,47.8%,4m
3440,3,[小冷不会打]IIIIIIIIIIII,3504,290,13,7,20,65.0%,50m
3440,2,seaplayer,3504,126,4,1,5,80.0%,3m
3440,3,[一等星]耂婆霞,3504,58,3,1,4,75.0%,22m
3440,2,夏妖,3504,58,2,2,4,50.0%,22m
3440,3,Ylc,3504,0,0,1,1,0.0%,5m
3440,2,iStan,3504,0,0,1,1,0.0%,15m
3448,2,[浙江大学战队]混元星际掌门人,3503,1181,82,73,155,52.9%,53m
3448,2,IIIIIIIIIIII,3503,774,61,54,115,53.0%,51m
3448,2,[SteEng]风子,3503,254,10,7,17,58.8%,10m
3448,2,[25boys]艾尔恶势力,3503,0,1,0,1,100.0%,10m
3448,2,[Eroman]oblivion,3503,0,1,1,2,50.0%,18m
3448,2,五更琉璃,3503,0,0,1,1,0.0%,19m
3448,2,天禄的小鬼本人,3503,0,0,6,6,0.0%,12m
3455,2,syf,3502,1561,254,250,504,50.4%,4m
3455,2,丢人椛,3502,597,52,27,79,65.8%,15m
3455,1,[Marry]字数补丁是我,3502,936,45,30,75,60.0%,51m
3455,2,[独步天下]亡游孤魂,3502,810,39,21,60,65.0%,11m
3455,2,[白银联盟]笨拙,3502,703,28,23,51,54.9%,25m
3455,2,黑山小南瓜,3502,622,28,23,51,54.9%,29m
3455,2,[JNUSC]LittleFlower,3502,583,25,17,42,59.5%,10m
3455,3,IIIIIIIIIIII,3502,163,8,3,11,72.7%,27m
3455,2,时军锋,3502,0,1,0,1,100.0%,15m
3455,2,搞个大新闻,3502,48,1,2,3,33.3%,23m
3455,2,[chise]坑钱的企鹅公司,3502,0,0,1,1,0.0%,22m
3455,3,IvesZero,3502,0,0,1,1,0.0%,53m
3455,2,[人生知己多少]霸王,3502,0,0,2,2,0.0%,28m
3455,2,RESPECTtime,3502,0,0,2,2,0.0%,2m
3469,2,[FXeon]Twenkis,3501,1600,503,486,989,50.9%,13m
3469,2,好人,3501,136,5,5,10,50.0%,3m
3469,2,[NanTeS]DIABLOoo,3501,0,0,1,1,0.0%,22m
3472,2,[此天下之绝响]糖皮面人,3500,1098,55,62,117,47.0%,14m
3472,2,[miku守护]Asds,3500,1093,54,55,109,49.5%,8m
3472,2,Ophelia,3500,379,17,7,24,70.8%,23m
3472,2,[同化完成VI]知雨千秋,3500,0,0,1,1,0.0%,12m
3472,2,IIIIIIIIIIII,3500,0,0,1,1,0.0%,51m
3477,2,[Holyfe]xxf,3499,1515,69,80,149,46.3%,14m
3477,2,视野,3499,1293,57,43,100,57.0%,55m
3477,2,[lSCVl]zxxy,3499,442,23,9,32,71.9%,3m
3477,1,TsaoTsao,3499,430,17,33,50,34.0%,48m
3477,2,[萌新保护协议]ColdSeadling,3499,244,9,5,14,64.3%,55m
3477,2,[我即是菜狗]luckydestroy,3499,198,8,6,14,57.1%,14m
3477,2,white,3499,204,7,8,15,46.7%,24m
3477,2,我从不狗人,3499,152,5,11,16,31.2%,28m
3477,2,ProtossBoy,3499,0,0,4,4,0.0%,22m
3486,2,杨万里,3498,342,16,9,25,64.0%,3m
3486,2,诚诚诚诚幻,3498,256,8,6,14,57.1%,7m
3486,1,知否,3498,143,7,3,10,70.0%,52m
3486,2,[丨SLT丨]星球大战,3498,86,3,3,6,50.0%,11m
3486,2,[拉稀]骑着你欺负猪,3498,0,1,0,1,100.0%,8m
3486,3,妮妮,3498,0,1,0,1,100.0%,2m
3486,2,永恒悲惨的命运,3498,0,1,0,1,100.0%,10m
3486,2,[一言不合SD]SacredBuffon,3498,0,0,1,1,0.0%,14m
3494,2,shenhao,3497,1525,128,118,246,52.0%,29m
3494,2,酷酷使徒汪,3497,230,11,4,15,73.3%,8m
3494,2,Arknights,3497,112,2,1,3,66.7%,6m
3494,2,[YT]乌克兰总统,3497,0,0,1,1,0.0%,23m
3494,2,mumu,3497,0,0,2,2,0.0%,3m
3499,2,ULTRATE,3496,1042,116,116,232,50.0%,18m
3499,2,GiannaJun,3496,663,52,56,108,48.1%,9m
3499,2,[暴雪三十队]豆丁,3496,620,24,18,42,57.1%,23m
3499,2,[星际鸽子组]天之云片,3496,436,19,10,29,65.5%,13m
3499,2,Lcattus,3496,316,11,9,20,55.0%,11m
3499,2,泡沫丶漓,3496,116,4,9,13,30.8%,8m
3499,3,[枪兵二营]blinkheart,3496,120,2,2,4,50.0%,13m
3499,2,[JIMAIR]DawnFox,3496,50,2,3,5,40.0%,3m
3499,2,[夏祭]lonelyLOON,3496,0,0,1,1,0.0%,33m
3508,2,[从阴影中现身]逐火之荧,3495,438,18,11,29,62.1%,13m
3508,2,神乐,3495,312,11,19,30,36.7%,9m
3508,2,卡其脱离太,3495,46,6,1,7,85.7%,53m
3508,2,[萌新萌新萌]秋月孝三,3495,30,2,0,2,100.0%,3m
3508,2,[肉鸡的饲养]曼珠沙华,3495,30,2,0,2,100.0%,54m
3508,2,章北海,3495,0,0,1,1,0.0%,22m
3508,2,西湖底灵感大王,3495,0,0,1,1,0.0%,4m
3515,2,everyoneHF,3494,754,33,21,54,61.1%,23m
3515,2,小破,3494,532,30,8,38,78.9%,29m
3515,2,[铁三角]Neo,3494,288,11,11,22,50.0%,47m
3515,2,天启,3494,0,5,0,5,100.0%,49m
3515,2,李问,3494,0,0,1,1,0.0%,3m
3515,2,lwl,3494,0,0,1,1,0.0%,8m
3515,2,维罗妮卡,3494,0,0,3,3,0.0%,25m
3522,1,Veritas,3493,917,97,114,211,46.0%,8m
3522,2,[BGD]moMentDs,3493,726,36,39,75,48.0%,13m
3522,2,[Toss]神族就输不了,3493,848,32,28,60,53.3%,6m
3522,2,llllllllll,3493,0,1,0,1,100.0%,23m
3522,2,[Tilt]蛋奶星星,3493,0,1,0,1,100.0%,25m
3527,2,shadow,3492,865,78,56,134,58.2%,26m
3527,2,快乐,3492,545,24,11,35,68.6%,25m
3527,2,[四叶草]这个凯子,3492,441,17,14,31,54.8%,29m
3527,2,[Months]IIIIIIIIII,3492,196,7,3,10,70.0%,25m
3527,2,[田鼠单推人]一椛懸命,3492,0,1,0,1,100.0%,8m
3527,2,Maximtop,3492,30,1,4,5,20.0%,6m
3527,2,[miku守护]Zknight,3492,0,0,2,2,0.0%,11m
3534,2,[NZNZ]GhostTown,3491,1490,142,103,245,58.0%,25m
3534,2,[老油条战队4]huangwu,3491,429,18,13,31,58.1%,55m
3534,3,橙子西柚,3491,273,12,5,17,70.6%,55m
3534,2,[飞跃来]小巫女,3491,274,11,10,21,52.4%,8m
3534,2,少女初夜收割者,3491,142,5,5,10,50.0%,26m
3534,2,天天,3491,148,5,6,11,45.5%,29m
3534,2,[火焰雷兽]KON,3491,126,4,0,4,100.0%,13m
3534,2,[YM]hjx,3491,0,1,0,1,100.0%,4m
3534,2,FLYINTHESEA,3491,0,1,0,1,100.0%,15m
3534,2,wwwww,3491,0,1,2,3,33.3%,53m
3544,2,tarfet,3490,1102,43,45,88,48.9%,53m
3544,2,[clzg]IIIIIII,3490,140,18,8,26,69.2%,26m
3544,2,终极白给,3490,90,7,2,9,77.8%,47m
3544,3,[拱火吹逼斗图]Kotori,3490,197,6,4,10,60.0%,8m
3544,2,云淡,3490,90,3,9,12,25.0%,8m
3544,3,IIIIII,3490,30,2,0,2,100.0%,23m
3544,2,ToolMan,3490,30,2,2,4,50.0%,10m
3544,2,[虞城星际]ZesT,3490,0,0,2,2,0.0%,4m
3552,2,暴雪大西南分公司,3489,389,75,67,142,52.8%,10m
3552,2,IIIIII,3489,1537,65,52,117,55.6%,23m
3552,2,baskt,3489,786,29,28,57,50.9%,14m
3552,2,[XZQK]UNiverse,3489,542,22,14,36,61.1%,3m
3552,2,MALYY,3489,569,21,16,37,56.8%,20m
3552,2,KAKINE,3489,180,8,2,10,80.0%,3m
3552,1,wmw,3489,142,3,5,8,37.5%,26m
3552,2,[SF1]阿拉纳克,3489,0,0,1,1,0.0%,26m
3552,2,[火车烧基地]八两,3489,0,0,2,2,0.0%,23m
3561,2,慧英,3488,1240,55,45,100,55.0%,3m
3561,2,[天雪]随波逐流,3488,242,11,3,14,78.6%,23m
3561,2,WILL,3488,184,7,14,21,33.3%,22m
3561,2,春日野悠,3488,0,5,0,5,100.0%,2m
3561,2,[闵行第一人]黄泉列车,3488,0,4,1,5,80.0%,11m
3561,2,ShakeJJ,3488,114,4,6,10,40.0%,3m
3561,2,[APT]Lilystar,3488,0,1,2,3,33.3%,19m
3561,2,[镜花水月]萌萌的白团子,3488,0,0,1,1,0.0%,18m
3569,2,运气是实力的全部,3487,1157,144,112,256,56.2%,29m
3569,2,达斧王,3487,1049,123,111,234,52.6%,15m
3569,2,三笠,3487,662,34,24,58,58.6%,18m
3569,3,[LTQLZ]庾婉媚,3487,0,0,1,1,0.0%,10m
3573,2,人族最强近战,3486,1196,70,39,109,64.2%,25m
3573,2,[北京城管]你别慌,3486,671,30,22,52,57.7%,6m
3573,2,[宇宙职业战队]腐竹,3486,268,12,4,16,75.0%,3m
3573,2,无头吃货,3486,244,10,5,15,66.7%,29m
3573,1,WhackingLove,3486,211,7,7,14,50.0%,4m
3573,2,[半个菜鸟]nist,3486,116,5,5,10,50.0%,3m
3573,3,酷酷猫,3486,0,1,0,1,100.0%,7m
3573,2,[NGA观察团]莽莽莽莽女王,3486,0,1,1,2,50.0%,26m
3573,2,[你的剑很美]唯独二货,3486,30,1,2,3,33.3%,12m
3573,2,[振兴中华]李明,3486,0,0,1,1,0.0%,13m
3583,2,PImbA,3485,613,45,6,51,88.2%,19m
3583,2,shirosakiren,3485,428,38,24,62,61.3%,9m
3583,2,[世纪末霸者]laomaiG,3485,587,34,38,72,47.2%,25m
3583,2,Leviathan,3485,593,27,17,44,61.4%,55m
3583,2,援气少女柠檬酱,3485,196,18,3,21,85.7%,10m
3583,2,[星际争霸第一]blizzarnmsl,3485,296,13,5,18,72.2%,6m
3583,2,菱形波纹,3485,344,13,15,28,46.4%,12m
3583,2,低熵体,3485,128,4,1,5,80.0%,7m
3583,2,puck,3485,128,4,1,5,80.0%,16m
3583,3,我只会两船兵,3485,151,4,6,10,40.0%,53m
3583,2,Kura,3485,104,4,7,11,36.4%,9m
3583,2,Glashutte,3485,90,3,5,8,37.5%,25m
3583,2,致命之矛,3485,88,1,1,2,50.0%,23m
3583,2,枪兵推销员,3485,0,0,1,1,0.0%,29m
3597,2,loveddoouuu,3484,1465,167,154,321,52.0%,11m
3597,2,一只咸鱼,3484,290,11,10,21,52.4%,9m
3597,2,titanium,3484,253,10,8,18,55.6%,47m
3597,2,[帝国Aeon]ddd,3484,90,4,8,12,33.3%,29m
3597,2,Style,3484,0,2,1,3,66.7%,49m
3597,2,llllllllllll,3484,0,1,0,1,100.0%,3m
3597,2,叨叨个大蘑菇,3484,0,1,0,1,100.0%,9m
3604,2,calvin,3483,1210,249,237,486,51.2%,53m
3604,2,[洁白之巅]NoBody,3483,1552,131,123,254,51.6%,27m
3604,2,ARXS,3483,335,21,6,27,77.8%,23m
3604,2,[星歌]言明曦无,3483,261,12,4,16,75.0%,29m
3604,2,BlemIsh,3483,296,10,10,20,50.0%,6m
3604,2,MagicProtoss,3483,203,8,4,12,66.7%,22m
3604,3,[浮世清欢]奈何我太笨,3483,228,8,7,15,53.3%,53m
3604,2,cyan,3483,162,5,3,8,62.5%,55m
3604,2,[holyhp]Gostop,3483,112,3,1,4,75.0%,19m
3604,2,IIIIIIIIIIII,3483,0,1,0,1,100.0%,28m
3604,2,为艾尔而战,3483,88,1,1,2,50.0%,18m
3615,2,kimi,3482,1563,713,695,1408,50.6%,10m
3615,2,爱紫薇真是太好了,3482,1516,311,276,587,53.0%,3m
3615,2,游戏之王,3482,1456,126,131,257,49.0%,23m
3615,2,[SK]ZerO,3482,854,35,30,65,53.8%,10m
3615,2,[TeamCD]AyaseEli,3482,417,26,28,54,48.1%,54m
3615,2,[踌躇]看我出手盘,3482,0,2,0,2,100.0%,22m
3615,2,alaventus,3482,0,0,3,3,0.0%,28m
3622,1,[娱乐玩家]一束九,3481,1068,242,231,473,51.2%,15m
3622,2,[OranLa]SHowClassic,3481,769,54,47,101,53.5%,20m
3622,2,sinlee,3481,1011,43,40,83,51.8%,53m
3622,2,[miku守护]萨尔纳加,3481,667,27,21,48,56.2%,55m
3622,3,李璐江,3481,245,12,5,17,70.6%,2m
3622,2,浮生若梦,3481,126,4,9,13,30.8%,3m
3628,2,[暴雪我是你爹]嘤嘤嘤喏卫星,3480,821,45,27,72,62.5%,23m
3628,2,FROZEN,3480,492,17,15,32,53.1%,25m
3628,2,[LCKS]天外来客,3480,62,2,7,9,22.2%,28m
3628,2,wee,3480,0,1,5,6,16.7%,9m
3632,2,[菜鸟会]LIKE,3479,1276,215,195,410,52.4%,3m
3632,2,我是你爹,3479,1441,55,56,111,49.5%,3m
3632,2,Lancer,3479,532,24,13,37,64.9%,55m
3632,2,醒词,3479,30,2,4,6,33.3%,22m
3632,2,乌云撞皎月,3479,0,1,0,1,100.0%,6m
3632,2,[逗比神教]asdf,3479,88,1,1,2,50.0%,29m
3638,2,别被游戏玩了,3478,1064,94,86,180,52.2%,53m
3638,2,兔子老虎,3478,1173,63,78,141,44.7%,3m
3638,2,[火焰雷兽]你运营有点慢,3478,640,51,37,88,58.0%,7m
3638,2,[中南大学官网]咪仙星,3478,761,49,50,99,49.5%,11m
3638,2,血爪,3478,741,35,22,57,61.4%,3m
3638,2,一千年以前,3478,686,27,26,53,50.9%,23m
3638,2,IIIIIIIIIII,3478,336,27,28,55,49.1%,3m
3638,2,[区区八婆紫]Doooomino,3478,522,21,18,39,53.8%,51m
3638,2,[小猫咪的梦想]浩崽陀,3478,102,2,1,3,66.7%,22m
3638,2,[跨境帮]杨老板衣锦不夜行,3478,0,1,0,1,100.0%,10m
3648,2,米爸,3477,1571,293,284,577,50.8%,48m
3648,2,Crazyzayn,3477,576,28,14,42,66.7%,54m
3648,2,害虫,3477,325,19,9,28,67.9%,54m
3648,2,[TPLINK]CreeperJimTH,3477,384,16,27,43,37.2%,3m
3648,3,weqe,3477,294,14,6,20,70.0%,8m
3648,2,[Shawk]萌新神族,3477,334,10,26,36,27.8%,7m
3648,2,软萌萝莉小仙,3477,252,8,7,15,53.3%,51m
3648,2,sycshc,3477,86,4,3,7,57.1%,8m
3648,2,[Holyam]黑暗森林,3477,102,3,0,3,100.0%,20m
3648,2,冰镇甜橙沁心柠檬,3477,30,1,4,5,20.0%,2m
3658,2,[六骑]amg,3476,1624,108,98,206,52.4%,22m
3658,2,扎克斯,3476,102,12,18,30,40.0%,4m
3658,3,Requiemshabi,3476,0,5,0,5,100.0%,5m
3658,2,枣枣,3476,30,2,2,4,50.0%,26m
3658,2,[原谅兄弟会]LuLoer,3476,0,1,0,1,100.0%,11m
3663,2,满脸横肉的孙哥,3475,1470,123,90,213,57.7%,22m
3663,2,[星歌]三千,3475,947,37,33,70,52.9%,6m
3663,2,[暴雪线上实测]星际争霸平衡组,3475,74,6,5,11,54.5%,4m
3663,2,[TsFz]SoS,3475,210,6,6,12,50.0%,55m
3663,2,wanhuanyi,3475,202,6,6,12,50.0%,53m
3663,2,练回去,3475,0,1,4,5,20.0%,11m
3663,2,[AUV]DestinationF,3475,0,0,1,1,0.0%,51m
3670,2,你们城里人真会玩,3474,684,329,334,663,49.6%,8m
3670,2,蟑螂不就很好嘛,3474,1492,63,50,113,55.8%,55m
3670,2,[妹控万岁]妹控都是好人,3474,952,51,29,80,63.8%,19m
3670,2,[第九舰队丶]无观,3474,102,3,0,3,100.0%,8m
3670,3,[蓬莱伝説]璃瞳曦风,3474,0,0,1,1,0.0%,50m
3670,2,谐的一匹,3474,0,0,2,2,0.0%,6m
3676,2,GgYy,3473,1575,239,228,467,51.2%,23m
3676,2,锋转全球,3473,1210,75,70,145,51.7%,2m
3676,2,[框本之魂]老框本,3473,748,32,30,62,51.6%,11m
3676,2,[审判长]Sik,3473,116,4,0,4,100.0%,10m
3676,3,[理想国]秒杀一切空军,3473,120,3,0,3,100.0%,4m
3676,3,Gavin,3473,0,3,2,5,60.0%,55m
3676,2,艾尔的黎明静悄悄,3473,88,2,0,2,100.0%,18m
3676,2,[为了星歌]星歌的阿奇拉部族,3473,0,1,0,1,100.0%,55m
3676,2,帅的被人砍,3473,0,0,1,1,0.0%,53m
3676,2,IIIIIIIIIIII,3473,0,0,2,2,0.0%,51m
3686,2,NeverMore,3472,747,52,44,96,54.2%,3m
3686,2,[今天什么奶茶]随机电脑,3472,254,10,5,15,66.7%,6m
3686,3,金三胖,3472,278,9,13,22,40.9%,47m
3686,2,黔莫川,3472,154,5,11,16,31.2%,11m
3686,2,炮台狗自己滚,3472,0,1,0,1,100.0%,2m
3686,2,[Brs]请先打我萌友,3472,0,1,1,2,50.0%,9m
3692,2,雨夜屠夫,3471,1617,348,333,681,51.1%,7m
3692,2,[野蛮猫骑士]我永远单推李静,3471,1617,145,122,267,54.3%,3m
3692,2,[Shawk]SclDooM,3471,330,12,14,26,46.2%,29m
3692,3,星际要火,3471,250,11,4,15,73.3%,26m
3692,3,[火焰雷獸]bel,3471,223,7,3,10,70.0%,21m
3692,2,minParting,3471,30,2,1,3,66.7%,47m
3692,2,职业法师,3471,30,1,2,3,33.3%,53m
3692,2,[GSN300]塞兰迪斯,3471,30,1,3,4,25.0%,11m
3692,2,[NGZK46]steven,3471,0,0,2,2,0.0%,6m
3701,2,llllllllllll,3470,1127,101,93,194,52.1%,2m
3701,2,[茶队星分部]雨过添晴,3470,543,49,16,65,75.4%,18m
3701,2,[神樂七奈ol]阳菜,3470,226,9,8,17,52.9%,15m
3704,2,SKTeiecomDP,3469,929,45,39,84,53.6%,24m
3704,2,[CPT]zoun,3469,770,28,32,60,46.7%,53m
3704,2,Park,3469,355,14,13,27,51.9%,50m
3704,2,IIIIIIIIIIII,3469,191,9,7,16,56.2%,11m
3704,2,YCKOBE,3469,158,6,11,17,35.3%,47m
3704,2,暴走的司马老贼,3469,127,3,2,5,60.0%,2m
3704,2,我在身边,3469,30,2,4,6,33.3%,23m
3704,2,igXY,3469,30,1,3,4,25.0%,3m
3704,3,爱唠叨的小仙女,3469,0,1,4,5,20.0%,10m
3704,2,QAQ,3469,30,1,10,11,9.1%,55m
3704,1,[韩宗快乐屋]菜鸡,3469,0,0,1,1,0.0%,10m
3715,2,herbalistbw,3468,1344,70,69,139,50.4%,13m
3715,2,[CPT]混元星际门辞寒,3468,720,49,26,75,65.3%,19m
3715,2,[你的剑很美]MSGA,3468,777,34,24,58,58.6%,27m
3715,2,爬满树,3468,280,14,14,28,50.0%,54m
3715,2,跳跳骑士,3468,88,2,4,6,33.3%,20m
3720,2,白青,3467,1577,175,162,337,51.9%,48m
3720,2,[浪啊浪]亚里斯多德,3467,742,82,74,156,52.6%,19m
3720,2,amumu,3467,389,18,10,28,64.3%,23m
3720,2,[百宝箱]TreeSea,3467,171,14,12,26,53.8%,19m
3720,2,[TCP]Mercy,3467,266,10,17,27,37.0%,47m
3720,2,庄周,3467,245,9,5,14,64.3%,15m
3720,2,Chembuster,3467,58,2,5,7,28.6%,7m
3720,3,[你画我瞎]魔法少女一开叫,3467,0,1,0,1,100.0%,18m
3720,2,[YMFM丶]IIIIIIIIIIII,3467,0,0,1,1,0.0%,25m
3720,3,武林盟主丶月月,3467,0,0,1,1,0.0%,6m
3730,2,阿萨德木头人,3466,1118,392,360,752,52.1%,27m
3730,2,IIIIIIIIIIII,3466,1518,62,69,131,47.3%,23m
3730,2,[五月花]伏枥老鸡,3466,286,43,34,77,55.8%,54m
3730,3,[馨怡]SCCZL,3466,0,3,1,4,75.0%,15m
3730,3,Aurora,3466,0,0,1,1,0.0%,11m
3735,2,Rorschach,3465,1488,130,129,259,50.2%,51m
3735,2,[泰伦]张三岁先森,3465,498,19,19,38,50.0%,2m
3735,1,sycshc,3465,95,1,1,2,50.0%,29m
3735,3,为了艾尔,3465,30,1,2,3,33.3%,56m
3735,2,[GAC]soso,3465,0,0,2,2,0.0%,6m
3740,2,挚爱丶汀,3464,400,75,70,145,51.7%,11m
3740,2,[萝莉之芯]影月仇,3464,971,34,42,76,44.7%,9m
3740,2,晓美焰丶,3464,516,19,16,35,54.3%,53m
3740,2,车万永不过气,3464,195,7,4,11,63.6%,22m
3740,2,[凯莎女王]JoJo,3464,92,5,7,12,41.7%,12m
3740,2,口妹,3464,150,5,8,13,38.5%,10m
3740,3,borinpp,3464,0,0,1,1,0.0%,6m
3747,3,炎冥杀魔刀,3463,304,14,8,22,63.6%,28m
3747,3,[星际教学组]Ombramaifu,3463,314,13,6,19,68.4%,22m
3747,2,一方,3463,358,13,15,28,46.4%,54m
3747,1,Elazer,3463,251,11,3,14,78.6%,18m
3747,2,[Shawk]衡安学校没有妈妈,3463,292,10,21,31,32.3%,47m
3747,2,[成立]间奏曲,3463,179,6,7,13,46.2%,26m
3747,3,[初雪的樱花]小坂井绫,3463,114,5,4,9,55.6%,6m
3747,1,[SFTRA3]洛天依,3463,162,4,1,5,80.0%,5m
3747,2,[谐星联盟]菜头,3463,88,2,1,3,66.7%,3m
3756,2,[DARKAA]wwe,3462,503,22,15,37,59.5%,7m
3756,2,IlIlIlIlIlIl,3462,139,7,1,8,87.5%,4m
3756,2,[神之常子]陆修,3462,112,3,2,5,60.0%,25m
3756,2,CoinCidenCe,3462,116,3,3,6,50.0%,6m
3756,2,Trap,3462,30,1,4,5,20.0%,14m
3761,3,虫二,3461,1082,164,147,311,52.7%,5m
3761,2,抗着步枪,3461,746,51,40,91,56.0%,15m
3761,2,影流之主,3461,536,29,18,47,61.7%,53m
3761,2,[BGD]dream,3461,308,13,7,20,65.0%,56m
3761,2,桃毛雄,3461,268,11,6,17,64.7%,6m
3761,2,[小淦上天队]魔法少女鸽子酱,3461,296,11,13,24,45.8%,7m
3761,3,TsuKi,3461,116,4,3,7,57.1%,24m
3761,2,[CMQ]普通的霓轰高中生,3461,92,4,9,13,30.8%,19m
3761,2,DietmarP,3461,76,3,4,7,42.9%,26m
3761,2,[YA]醉了的小生,3461,0,1,1,2,50.0%,19m
3771,2,银平爱坨,3460,1543,642,639,1281,50.1%,3m
3771,3,[Solo]对人虫使用炎拳,3460,1117,134,123,257,52.1%,29m
3771,2,[SFTRA3]Sphere,3460,1501,67,46,113,59.3%,55m
3771,2,[公事公办]人生当苦无妨,3460,850,51,31,82,62.2%,15m
3771,3,[F2A莽夫]虫虫快跑啊,3460,140,12,4,16,75.0%,55m
3771,3,[SoloAs]Madlife,3460,0,1,0,1,100.0%,28m
3771,1,[洛水天依]灰烬使者,3460,0,1,0,1,100.0%,20m
3771,2,IIIIIIIIIIII,3460,44,1,2,3,33.3%,20m
3771,3,VincentLaw,3460,0,0,1,1,0.0%,3m
3771,3,[Vault]森森,3460,0,0,1,1,0.0%,51m
3781,2,[找虐]泽拉瑞斯大主教,3459,1580,227,209,436,52.1%,29m
3781,2,Milky,3459,1270,131,122,253,51.8%,18m
3781,2,[不服来战]牛牛,3459,1429,113,121,234,48.3%,3m
3781,2,[四叶草]面具人,3459,1252,57,47,104,54.8%,6m
3781,2,[半个菜鸟II]黄注卵,3459,889,34,34,68,50.0%,29m
3781,3,Rrrstii,3459,294,13,4,17,76.5%,19m
3781,2,[不打内战随机]粑本,3459,179,13,17,30,43.3%,18m
3781,3,[星歌]DASHGO,3459,214,9,1,10,90.0%,25m
3781,2,无情扫人机器,3459,94,3,9,12,25.0%,22m
3781,2,孙一峰是我大哥,3459,30,2,2,4,50.0%,25m
3791,2,红烧牛腩面,3458,1287,100,92,192,52.1%,23m
3791,2,九一大神李先生,3458,692,56,46,102,54.9%,19m
3791,2,冬天的王老吉,3458,927,52,31,83,62.7%,7m
3791,2,[RSTAR]Leaf,3458,481,40,37,77,51.9%,53m
3791,2,[KPG]IIIIIIIIIIII,3458,1070,36,51,87,41.4%,3m
3791,3,Nero,3458,738,30,28,58,51.7%,19m
3791,3,Hoomin,3458,228,9,5,14,64.3%,9m
3791,2,[iFu]Crooked,3458,194,9,9,18,50.0%,50m
3791,2,[叫我兔本]mikasa,3458,114,2,3,5,40.0%,19m
3800,2,cinereus,3457,1383,234,211,445,52.6%,18m
3800,2,[桜公馆]高性能星际机器人,3457,254,9,11,20,45.0%,13m
3800,2,[SCU]shaker,3457,60,2,8,10,20.0%,26m
3800,3,[正义旳伙伴]魔法少女伊莉亚,3457,0,1,0,1,100.0%,6m
3800,3,[深淵]Isaac,3457,0,0,2,2,0.0%,24m
3805,3,这把有点悬,3456,658,25,18,43,58.1%,24m
3805,2,asaasa,3456,349,21,13,34,61.8%,50m
3805,2,黑暗学生,3456,474,17,17,34,50.0%,15m
3805,3,[RtN]DNA,3456,194,7,3,10,70.0%,14m
3805,3,盗跖庄屩流誉后,3456,114,6,5,11,54.5%,7m
3805,1,JiRu,3456,165,4,3,7,57.1%,5m
3805,3,[伞公司]随缘,3456,0,1,0,1,100.0%,26m
3805,2,[秋千千秋]灵相,3456,0,0,2,2,0.0%,51m
3813,2,[闪击战]五十块的好兄弟,3455,1391,98,83,181,54.1%,23m
3813,2,湯音,3455,144,4,4,8,50.0%,13m
3813,2,[红井]Sakura,3455,0,1,2,3,33.3%,54m
3813,3,[人間之里]flash,3455,0,0,1,1,0.0%,53m
3813,2,[救赎蔷薇]天国副君萨斯利尔,3455,0,0,1,1,0.0%,55m
3818,2,这不是坏,3454,1596,205,199,404,50.7%,3m
3818,2,IIIIIIIIII,3454,1586,116,93,209,55.5%,25m
3818,3,[银翼之光]灵魂流转,3454,1652,108,79,187,57.8%,54m
3818,2,IIIIIIIIII,3454,851,59,71,130,45.4%,15m
3818,2,風行奧蕾莉亞,3454,698,42,34,76,55.3%,25m
3818,2,Arestronger,3454,263,38,23,61,62.3%,56m
3818,2,[white开]GGBind,3454,97,5,1,6,83.3%,10m
3818,3,Boys,3454,0,0,1,1,0.0%,18m
3826,2,[突变攻略组]春哥,3453,1563,167,145,312,53.5%,24m
3826,3,小库头,3453,1662,159,137,296,53.7%,6m
3826,2,[Fantsy]Pluto,3453,1383,79,57,136,58.1%,22m
3826,2,[TREMOR]江南皮革厂厂长,3453,344,12,19,31,38.7%,16m
3826,2,[蓝色星尘]LRY,3453,331,11,16,27,40.7%,16m
3826,2,Fox,3453,90,3,7,10,30.0%,22m
3826,2,[HustSC]桑采撷,3453,62,2,7,9,22.2%,25m
3833,2,[桜公馆]博士家的东云名乃,3452,1216,214,198,412,51.9%,25m
3833,2,进击的艾伦,3452,1488,82,66,148,55.4%,53m
3833,2,[FoD]男女啪啪在山中,3452,459,47,37,84,56.0%,10m
3833,2,aguesuka,3452,153,29,28,57,50.9%,23m
3833,2,[火焰雷兽]复仇云图,3452,217,10,4,14,71.4%,56m
3833,3,少侠归来,3452,146,5,3,8,62.5%,7m
3833,3,enzo,3452,0,0,1,1,0.0%,14m
3840,1,跳动的鱼子酱,3451,963,81,97,178,45.5%,9m
3840,3,IIIIIIIIIIII,3451,597,26,20,46,56.5%,50m
3840,3,Phoenix,3451,274,12,5,17,70.6%,6m
3840,1,[DaCapo]朕无敌,3451,231,10,4,14,71.4%,14m
3840,2,泰伦无敌,3451,245,9,7,16,56.2%,7m
3840,2,[战X队]思明吕布,3451,58,2,4,6,33.3%,13m
3840,2,[青铜星友汇]osososo,3451,58,2,4,6,33.3%,29m
3840,3,机暴雪豹,3451,0,1,0,1,100.0%,13m
3848,2,[一等星]baofahu,3450,1602,613,585,1198,51.2%,20m
3848,2,[orjer]orjer,3450,1552,117,118,235,49.8%,51m
3848,3,[真实建设集团]Fourwings,3450,644,24,18,42,57.1%,7m
3848,2,[东大电竞]Dark,3450,510,21,15,36,58.3%,25m
3848,3,[熊大和熊二]NAXX,3450,244,8,4,12,66.7%,8m
3848,3,Fog,3450,86,4,1,5,80.0%,48m
3848,2,soulman,3450,136,4,20,24,16.7%,13m
3848,3,聖光出鞘,3450,0,3,2,5,60.0%,5m
3848,2,[薄暮之光]lvyaqiao,3450,96,3,9,12,25.0%,19m
3848,3,[BGD]SEA,3450,58,2,1,3,66.7%,8m
3848,2,你不要过来啊,3450,0,0,2,2,0.0%,7m
3848,2,SSF,3450,0,0,3,3,0.0%,12m
3860,3,欢欢好漂亮,3449,0,4,1,5,80.0%,12m
3860,3,我是吖吖,3449,58,3,0,3,100.0%,53m
3860,1,有天赋的选手,3449,46,2,0,2,100.0%,27m
3860,3,WNRZW,3449,0,1,0,1,100.0%,9m
3864,2,[名人集团]IIIIIIIIIIII,3448,460,63,51,114,55.3%,15m
3864,2,IIIIIIIIIIII,3448,669,34,27,61,55.7%,15m
3864,2,llllllllllll,3448,722,26,38,64,40.6%,53m
3864,3,塔罗会星星,3448,268,12,5,17,70.6%,51m
3864,3,破天荒之风,3448,30,1,1,2,50.0%,51m
3864,3,[我哀党]名侦探灰原哀,3448,0,0,1,1,0.0%,10m
3870,2,[GTA]老鼠扛刀满街找猫,3447,679,55,61,116,47.4%,9m
3870,2,hfgherteredd,3447,440,15,18,33,45.5%,6m
3870,3,DietmarP,3447,216,9,2,11,81.8%,56m
3870,3,[SUST1]Buqun,3447,246,9,6,15,60.0%,53m
3870,2,不爱吃豆豆,3447,186,6,12,18,33.3%,22m
3870,3,[别看了就你了]人醉人疲惫,3447,0,1,0,1,100.0%,13m
3870,3,Elaina,3447,0,0,1,1,0.0%,2m
3870,3,[四叶草]布丁味的咖啡,3447,0,0,1,1,0.0%,8m
3878,2,[德拉米尔]战争精英,3446,1003,58,51,109,53.2%,7m
3878,2,[风涩]二十五夜,3446,790,36,33,69,52.2%,19m
3878,1,Tripos,3446,264,11,4,15,73.3%,27m
3878,3,兜兜没得糖,3446,46,2,2,4,50.0%,5m
3878,3,YakumoRan,3446,30,1,1,2,50.0%,4m
3878,2,[蕾米0莉亚]IIIIIIIIIIII,3446,0,1,3,4,25.0%,24m
3884,1,grrrxl,3445,1261,356,376,732,48.6%,15m
3884,2,顾翊庭,3445,816,194,153,347,55.9%,11m
3884,2,Passenger,3445,641,99,80,179,55.3%,7m
3884,2,[海德单推协会]战姬还是姬甲,3445,1228,59,43,102,57.8%,55m
3884,3,[831]一只鸡,3445,710,29,18,47,61.7%,52m
3884,3,redhome,3445,465,17,13,30,56.7%,21m
3884,3,史莱姆,3445,396,15,4,19,78.9%,53m
3884,3,[瘾大眼瞎]宅宅萝卜,3445,296,12,5,17,70.6%,12m
3884,1,这游戏真的难,3445,0,0,1,1,0.0%,27m
3893,2,YOUTH,3444,573,26,35,61,42.6%,9m
3893,2,[亀山社中]这么小声还开航母,3444,369,19,14,33,57.6%,20m
3893,3,[深远Hist]噩梦来临,3444,58,3,0,3,100.0%,54m
3893,3,[RFIC]DarkKnight,3444,30,2,0,2,100.0%,22m
3893,3,[真就白给啊]llllllllll,3444,0,0,1,1,0.0%,48m
3898,1,巨像能对空,3443,1671,270,255,525,51.4%,50m
3898,2,Ddmz,3443,1279,144,142,286,50.3%,11m
3898,2,霹雳流星,3443,1580,128,119,247,51.8%,29m
3898,2,小懒,3443,1232,55,40,95,57.9%,22m
3898,3,[YPC]年轻人,3443,30,2,0,2,100.0%,14m
3903,2,[WinWin]hellforever,3442,1092,44,49,93,47.3%,10m
3903,2,耗自为汁,3442,359,14,14,28,50.0%,7m
3903,3,[Voidx]YinATTCK,3442,308,13,5,18,72.2%,19m
3903,2,[olg]武林虾米,3442,293,11,8,19,57.9%,24m
3903,3,[辉煌华夏]十分甜加奶霜,3442,86,3,3,6,50.0%,54m
3903,3,[80s丶]小飞哥,3442,30,2,1,3,66.7%,20m
3903,3,[东大电竞]windawn,3442,30,1,1,2,50.0%,53m
3910,2,myzhimes,3441,1525,79,69,148,53.4%,27m
3910,3,[Taurus]Marinethos,3441,794,34,21,55,61.8%,12m
3910,2,[哔翻天梯鸡]StaYGoLD,3441,764,33,24,57,57.9%,51m
3910,3,如梦令,3441,114,4,2,6,66.7%,6m
3910,3,[单推人]llIlIIIIIlll,3441,30,2,2,4,50.0%,49m
3910,3,抛物线救国贾萌萌,3441,0,0,1,1,0.0%,7m
3910,3,eeee,3441,0,0,1,1,0.0%,50m
3910,3,[TCP]kennyS,3441,0,0,2,2,0.0%,18m
3918,2,燚龘,3440,890,47,48,95,49.5%,22m
3918,2,lethe,3440,894,33,35,68,48.5%,7m
3918,3,[华政之光]俞超,3440,102,4,2,6,66.7%,11m
3918,2,[我们都是萌新]夜空隐灭,3440,130,4,4,8,50.0%,22m
3918,3,Aingkong,3440,58,3,0,3,100.0%,50m
3923,3,[NKTJ]李十七,3439,161,8,5,13,61.5%,48m
3923,3,Heirito,3439,0,1,0,1,100.0%,3m
3923,1,好好玩加油别放弃,3439,0,1,0,1,100.0%,55m
3926,2,你的死兆星在闪烁,3438,1425,128,107,235,54.5%,29m
3926,2,llllllllllll,3438,146,6,8,14,42.9%,25m
3926,3,[神族最棒了]protoss,3438,58,2,1,3,66.7%,7m
3926,2,[一种乐器]坤坤,3438,30,2,3,5,40.0%,24m
3926,3,[谁在呼叫舰队]十次血字,3438,0,1,0,1,100.0%,22m
3931,2,[Igirls]style,3437,1573,107,106,213,50.2%,54m
3931,2,[浪啊浪]IIIIIII,3437,1068,79,64,143,55.2%,7m
3931,3,zerral,3437,436,19,6,25,76.0%,14m
3931,2,小觉,3437,244,9,19,28,32.1%,18m
3931,2,Pflegefur,3437,180,6,7,13,46.2%,24m
3931,3,慕容冷雪,3437,0,3,2,5,60.0%,53m
3931,3,xinshou,3437,0,1,1,2,50.0%,26m
3931,3,Lee,3437,0,0,2,2,0.0%,14m
3939,2,骑着鸡裂去抢钱,3436,748,28,35,63,44.4%,18m
3939,2,lmlAlter,3436,490,22,18,40,55.0%,3m
3939,3,William,3436,30,2,2,4,50.0%,29m
3939,3,[我从来不狗的]我从阴影中现身,3436,0,1,0,1,100.0%,5m
3939,3,yfx,3436,0,0,1,1,0.0%,54m
3939,3,[Ogier]OGNotailFANs,3436,0,0,1,1,0.0%,50m
3945,2,[果围同盟]Lyrics,3435,637,74,73,147,50.3%,29m
3945,2,冲一辈子坦克,3435,1235,60,67,127,47.2%,24m
3945,2,IIIIIIIIIII,3435,935,43,32,75,57.3%,25m
3945,2,Tsukumo,3435,330,19,9,28,67.9%,54m
3945,3,[12306]ourpairs,3435,190,6,2,8,75.0%,15m
3945,2,萌新,3435,58,2,5,7,28.6%,15m
3951,3,[星际兄弟]二班学霸,3434,544,20,16,36,55.6%,22m
3951,3,Thyme,3434,347,12,11,23,52.2%,55m
3951,3,[十六夜咲夜]友利奈绪,3434,140,8,3,11,72.7%,49m
3951,3,越今朝,3434,202,8,5,13,61.5%,21m
3951,3,久九,3434,0,0,2,2,0.0%,14m
3956,2,聚集的祈愿,3433,512,23,14,37,62.2%,3m
3956,3,Peggy,3433,490,21,4,25,84.0%,48m
3956,2,kjd,3433,214,7,7,14,50.0%,22m
3956,3,[兆景埋土大学]IIIIIIIIIIII,3433,90,3,3,6,50.0%,27m
3956,2,野生丶凹凸曼,3433,0,1,5,6,16.7%,22m
3961,2,[桥桥奇妙星际]我不做人了,3432,1434,69,67,136,50.7%,50m
3961,2,Moladom,3432,857,59,57,116,50.9%,54m
3961,3,Wen,3432,342,13,13,26,50.0%,10m
3961,2,[暴雪全能亡]潇孜,3432,168,4,6,10,40.0%,25m
3961,3,[SCcr]player,3432,60,3,3,6,50.0%,14m
3961,3,[九天星辰同萌]快乐每天,3432,90,3,4,7,42.9%,11m
3961,3,[这不起飞]skty,3432,0,1,0,1,100.0%,22m
3968,2,[请先打我隊友]旌旗十万斩阎罗,3431,1305,388,371,759,51.1%,13m
3968,2,[KPG]爱国者,3431,1574,134,120,254,52.8%,15m
3968,2,清浅旧时光,3431,1113,42,40,82,51.2%,7m
3968,3,[北京城管]迷彩,3431,374,18,13,31,58.1%,52m
3968,3,[哔翻天梯鸡]Dobby,3431,408,14,14,28,50.0%,13m
3968,2,[暴雪我是你爹]白痴,3431,42,2,0,2,100.0%,23m
3968,3,[纳兰皇族]幕罚,3431,0,1,0,1,100.0%,21m
3968,3,像羊树,3431,0,0,1,1,0.0%,29m
3976,3,圣剑宙斯,3430,585,24,15,39,61.5%,54m
3976,2,[我就]是渣渣,3430,70,8,3,11,72.7%,3m
3976,3,[甜甜圈]胐月,3430,30,1,1,2,50.0%,25m
3979,2,watmelon,3429,997,233,196,429,54.3%,9m
3979,2,Jack,3429,1282,113,90,203,55.7%,13m
3979,3,摔跤不带滚,3429,952,48,28,76,63.2%,24m
3979,2,IIIIIIIIIIII,3429,829,39,33,72,54.2%,7m
3979,2,小仓朝日,3429,991,37,40,77,48.1%,48m
3979,3,[暴雪我是你爹]ktx,3429,168,6,2,8,75.0%,17m
3979,2,BIAO,3429,157,4,5,9,44.4%,48m
3979,3,[4399]IlllIIlIIllI,3429,30,1,2,3,33.3%,15m
3987,2,[CHW]kakalu,3428,765,119,118,237,50.2%,13m
3987,2,[真的叼]Potato,3428,618,79,51,130,60.8%,13m
3987,2,hAppynOOb,3428,358,31,34,65,47.7%,3m
3987,2,llllllllllll,3428,262,11,14,25,44.0%,51m
3987,3,[神威灵装五番]ItsukaKotori,3428,0,4,1,5,80.0%,12m
3987,2,[FORI2]小比比醬,3428,46,1,1,2,50.0%,4m
3987,3,[世界何平]Melody,3428,30,1,2,3,33.3%,5m
3987,3,[求女友]不理我就慢慢拆,3428,0,0,1,1,0.0%,26m
3987,3,小萌新,3428,0,0,1,1,0.0%,50m
3996,2,funFunNy,3427,970,51,52,103,49.5%,7m
3996,3,[教我玩神族]AbsoluteZero,3427,60,2,2,4,50.0%,14m
3996,2,[暴雪我是你爹]hopeless,3427,30,2,4,6,33.3%,15m
3996,3,渐逝的生命,3427,0,0,3,3,0.0%,27m
4000,3,[不会散枪兵]以艾尔的之名,3426,1609,176,159,335,52.5%,14m
4000,2,神族就输不了,3426,839,117,114,231,50.6%,20m
4000,2,机械烈海王,3426,1302,47,56,103,45.6%,55m
4000,2,DLDL,3426,493,26,23,49,53.1%,47m
4000,2,[学医不如狗]风也惆怅,3426,518,20,19,39,51.3%,7m
4000,3,[吃喝啦打埃蒙]墨千羽,3426,0,0,1,1,0.0%,25m
4000,3,[圣堂皮皮]与我无关何必在意,3426,0,0,1,1,0.0%,18m
4007,3,llllllllllll,3425,1107,52,24,76,68.4%,25m
4007,3,winzerlot,3425,29,2,1,3,66.7%,21m
4007,3,江洋,3425,0,1,0,1,100.0%,23m
4010,2,[我也首发医生]SilentRanger,3424,934,41,35,76,53.9%,54m
4010,2,[Hist]Rapier,3424,634,23,27,50,46.0%,23m
4010,2,[2teNO1]不讲武德大勇哥,3424,331,14,10,24,58.3%,25m
4010,3,[这人倍儿帅]王二牛,3424,216,10,10,20,50.0%,14m
4010,3,荆门李信衡,3424,178,6,8,14,42.9%,12m
4015,2,夺夺兵,3423,888,31,36,67,46.3%,29m
4015,2,[超级联盟]SuperHuiHui,3423,700,27,25,52,51.9%,23m
4015,2,一条大菜狗,3423,300,14,14,28,50.0%,7m
4015,3,我要重新集结部队,3423,158,5,0,5,100.0%,11m
4015,3,[烽夜长歌]Aloof,3423,0,0,1,1,0.0%,14m
4015,3,暖光呐,3423,0,0,1,1,0.0%,6m
4021,2,[慢手e族]guzimillet,3422,1539,155,137,292,53.1%,53m
4021,3,大厦将倾狂澜既倒,3422,803,64,60,124,51.6%,5m
4021,2,羲哥不要,3422,747,52,51,103,50.5%,13m
4021,2,[KPG2]隐刀我是你爹,3422,706,31,27,58,53.4%,22m
4021,3,jkjbkb,3422,337,24,23,47,51.1%,17m
4021,3,二毛,3422,482,19,12,31,61.3%,10m
4021,3,[miku守护]miku,3422,333,15,3,18,83.3%,3m
4021,2,[好哥哥抬一手]RocketBo,3422,272,11,12,23,47.8%,54m
4021,3,坑逼就是我,3422,162,8,5,13,61.5%,4m
4021,3,[DGS]IceVi,3422,192,8,7,15,53.3%,29m
4021,1,[天梯引路人]mayu,3422,119,4,4,8,50.0%,29m
4021,3,阿尔托利亚,3422,22,3,0,3,100.0%,26m
4021,3,[审判日号]舍命玩文,3422,58,3,3,6,50.0%,4m
4021,3,[二次元同好会]樱大路露娜,3422,58,2,4,6,33.3%,55m
4035,2,死亡只是个开始,3421,1639,233,229,462,50.4%,27m
4035,1,[HTW]海蓝鲸,3421,504,44,40,84,52.4%,24m
4035,3,DarkTempar,3421,475,20,11,31,64.5%,50m
4035,3,mumu,3421,116,5,2,7,71.4%,8m
4035,3,Mirage,3421,0,1,0,1,100.0%,47m
4035,3,[GaHo]liar,3421,30,1,1,2,50.0%,26m
4035,3,[C95792]caia,3421,30,1,2,3,33.3%,14m
4035,3,[眼瞎的车万苟]西行寺幽幽纸,3421,0,1,2,3,33.3%,8m
4043,2,IIIIIIIIIIII,3420,1076,54,56,110,49.1%,22m
4043,2,丶小染,3420,1146,52,38,90,57.8%,53m
4043,3,lIIIIIIII,3420,680,32,12,44,72.7%,54m
4043,1,我喜欢黑卫衣,3420,951,31,48,79,39.2%,8m
4043,3,[专打嘤嘤怪]Tassadar,3420,227,15,12,27,55.6%,11m
4043,3,面壁人,3420,311,13,9,22,59.1%,3m
4043,3,IIIIIIII,3420,86,4,0,4,100.0%,53m
4043,3,[ImPa丶]MacSed,3420,44,3,2,5,60.0%,28m
4043,3,Phoenix,3420,0,1,0,1,100.0%,10m
4043,3,[第五駆逐鑑隊]贞德达尔克,3420,0,0,1,1,0.0%,18m
4053,2,[一怼到底]斯巴达,3419,1535,248,247,495,50.1%,11m
4053,2,[LOP]LYT,3419,1521,182,155,337,54.0%,3m
4053,3,[SoloBM]弑神,3419,0,0,2,2,0.0%,12m
4053,3,鱼和尚,3419,0,0,2,2,0.0%,53m
4057,2,AngelY,3418,1630,92,100,192,47.9%,11m
4057,3,[大姐酒家]Bluetea,3418,306,14,6,20,70.0%,8m
4057,2,无梦灬生,3418,334,14,10,24,58.3%,15m
4057,2,民主候选人拜登,3418,252,8,9,17,47.1%,3m
4057,2,[DMRc]Tricker,3418,206,7,12,19,36.8%,13m
4057,3,TYfans,3418,0,1,0,1,100.0%,8m
4063,2,鼠标流,3417,899,150,130,280,53.6%,7m
4063,3,kissmenglin,3417,431,18,10,28,64.3%,13m
4063,2,[killer]操我的队友不在,3417,498,16,24,40,40.0%,29m
4063,2,[四叶草]白鹞,3417,412,15,21,36,41.7%,7m
4067,3,medium,3416,1576,74,38,112,66.1%,3m
4067,2,自由的腿毛,3416,1131,50,52,102,49.0%,7m
4067,2,抱紧林雨,3416,870,40,28,68,58.8%,24m
4067,3,崩撤卖溜,3416,522,21,15,36,58.3%,23m
4067,2,Elm,3416,94,4,8,12,33.3%,3m
4067,2,[未临桑夏]小弥,3416,60,3,5,8,37.5%,47m
4073,2,放狗招的是坏蛋猪,3415,1526,129,120,249,51.8%,7m
4073,3,[NtS特工队]白色玫瑰,3415,400,41,42,83,49.4%,22m
4073,3,[废墟图书館]强袭自由,3415,166,7,2,9,77.8%,22m
4073,2,[高素质]XYling,3415,182,7,8,15,46.7%,24m
4073,3,血泪残痕,3415,0,4,1,5,80.0%,24m
4073,3,[禽禽禽]全太阳,3415,58,3,0,3,100.0%,50m
4073,3,king,3415,30,2,2,4,50.0%,6m
4073,2,[Znmsl]loveNobody,3415,30,1,7,8,12.5%,11m
4073,3,[神圣龙猪]龙小霞,3415,0,0,1,1,0.0%,49m
4073,3,[FsA]falseC,3415,0,0,4,4,0.0%,6m
4083,3,JACKYZOU,3414,121,4,0,4,100.0%,4m
4083,3,旺豆宝,3414,58,3,0,3,100.0%,9m
4085,3,念思望璇,3413,1239,123,104,227,54.2%,56m
4085,2,kusotori,3413,779,31,39,70,44.3%,26m
4085,3,老菜鸡,3413,254,10,7,17,58.8%,15m
4085,3,[创世会]DANRWXC,3413,228,8,7,15,53.3%,47m
4085,3,流光,3413,136,6,4,10,60.0%,48m
4085,1,每天睡不够,3413,48,2,8,10,20.0%,29m
4085,3,zest,3413,0,1,0,1,100.0%,7m
4085,3,[歌者]土星环,3413,0,0,1,1,0.0%,7m
4093,2,[落魄山]星际站长,3412,1059,40,39,79,50.6%,3m
4093,2,[holyhp]MarineKing,3412,304,11,13,24,45.8%,54m
4093,2,天龙,3412,184,8,7,15,53.3%,7m
4093,3,魏宏,3412,118,4,6,10,40.0%,6m
4093,3,Monoid,3412,0,0,1,1,0.0%,23m
4093,2,永夜黎明,3412,0,0,5,5,0.0%,7m
4093,2,[扫黄打黑]zchenah,3412,0,0,7,7,0.0%,12m
4100,2,raymond,3411,1515,309,299,608,50.8%,2m
4100,3,[Rich]andyoungcrew,3411,1322,78,62,140,55.7%,13m
4100,2,[青莲剑阁]taoist,3411,701,63,51,114,55.3%,11m
4100,3,[NUAA]BfMoSang,3411,848,33,29,62,53.2%,11m
4100,3,VcrLimrS,3411,194,8,5,13,61.5%,52m
4105,3,周先丶森,3410,1254,52,39,91,57.1%,21m
4105,3,[晋升者]独山大道,3410,150,6,5,11,54.5%,11m
4105,3,雅修特拉,3410,58,3,2,5,60.0%,18m
4105,2,Demon,3410,86,3,8,11,27.3%,3m
4105,3,Zest,3410,0,1,0,1,100.0%,29m
4105,3,[TCCHL]冰翼,3410,0,0,1,1,0.0%,24m
4105,3,[红果果QwQ]也许云端没有梦,3410,0,0,1,1,0.0%,29m
4112,2,天朝法拉利,3409,1289,131,121,252,52.0%,20m
4112,3,奇怪的神族玩家,3409,1169,112,81,193,58.0%,8m
4112,2,LyShiNe,3409,253,33,36,69,47.8%,10m
4112,2,[GAGA]清泉石上流,3409,536,18,31,49,36.7%,10m
4112,1,[LZX]公举粑粑,3409,166,8,4,12,66.7%,55m
4112,3,天天修地堡,3409,243,7,11,18,38.9%,51m
4112,3,[大秦皇朝]皇帝,3409,60,3,2,5,60.0%,19m
4112,3,ByuN,3409,0,0,1,1,0.0%,25m
4120,2,垣根帝督,3408,720,26,32,58,44.8%,9m
4120,2,电竞毒奶黄旭东,3408,485,23,17,40,57.5%,10m
4120,3,[战X队]鼓浪屿胖丁,3408,299,12,6,18,66.7%,29m
4120,3,时时时时时时说,3408,30,2,2,4,50.0%,24m
4120,3,运气不太好,3408,0,0,1,1,0.0%,27m
4120,3,[EL骑士团]Alice,3408,0,0,1,1,0.0%,29m
4120,3,守护麦迪文的法杖,3408,0,0,3,3,0.0%,53m
4127,2,[十班好星际]xianguchulai,3407,1532,136,139,275,49.5%,11m
4127,2,SCPLAYER,3407,1074,84,57,141,59.6%,3m
4127,3,[s金色玫瑰s]叶落空留风寂寞,3407,268,11,4,15,73.3%,26m
4127,3,[深远Hist]Wakatsuki,3407,114,4,4,8,50.0%,47m
4127,3,[CNU星际]RangerWD,3407,0,1,0,1,100.0%,50m
4127,3,isafire,3407,30,1,2,3,33.3%,28m
4127,3,[我高贵的族人]金陵吳老狗,3407,0,0,2,2,0.0%,55m
4134,2,[星2一群狗]虚空湮灭,3406,1550,208,197,405,51.4%,9m
4134,2,[loveMM]人仙,3406,676,25,28,53,47.2%,27m
4134,3,[Mikon]音無彩名,3406,114,4,4,8,50.0%,27m
4134,3,[为了地球]musha,3406,58,3,2,5,60.0%,50m
4134,3,浮生辞,3406,0,1,0,1,100.0%,28m
4134,3,[醫生姐姐來了]Kratos,3406,0,0,1,1,0.0%,7m
4140,1,[妖精卜卜口]小新,3405,1680,206,221,427,48.2%,24m
4140,2,[Holygl]newsun,3405,1511,142,132,274,51.8%,29m
4140,3,ProToss,3405,1472,81,82,163,49.7%,47m
4140,2,black,3405,392,18,13,31,58.1%,3m
4140,3,星星,3405,262,11,4,15,73.3%,21m
4140,3,MuCh,3405,30,2,2,4,50.0%,18m
4146,1,Justice,3404,1491,163,172,335,48.7%,52m
4146,2,spelling,3404,599,27,19,46,58.7%,3m
4146,3,Richmona,3404,243,12,7,19,63.2%,56m
4146,2,优品忧学第一人,3404,170,9,11,20,45.0%,55m
4146,2,IIIIIIIIIII,3404,88,3,9,12,25.0%,56m
4146,3,[博博憋大和]Wonder,3404,30,1,1,2,50.0%,11m
4152,3,tianzhiyi,3403,1657,167,144,311,53.7%,6m
4152,2,[爱吃鱼的赤瞳]xiaofu,3403,323,13,10,23,56.5%,23m
4152,2,oyoy,3403,132,8,4,12,66.7%,51m
4152,3,IIII,3403,0,1,0,1,100.0%,4m
4156,2,llllllllllll,3402,1559,115,114,229,50.2%,13m
4156,2,[XGLM]疾风君,3402,1557,98,90,188,52.1%,23m
4156,3,易水寒亭,3402,192,7,4,11,63.6%,5m
4156,3,我只吃熊猫,3402,18,2,2,4,50.0%,53m
4156,3,[暴鹿狂小分队]好汉请先打我队友,3402,0,1,0,1,100.0%,18m
4156,3,Tiddler,3402,0,0,1,1,0.0%,5m
4156,3,Sarath,3402,0,0,3,3,0.0%,54m
4163,2,真的不会玩,3401,1537,366,332,698,52.4%,24m
4163,2,[不会散枪兵]菜的一米多高,3401,1478,71,74,145,49.0%,47m
4163,2,[MOB]伊澄小姐,3401,1019,41,43,84,48.8%,15m
4163,3,[肉鸡的饲养]Link,3401,890,34,32,66,51.5%,56m
4163,3,鹿目圆香,3401,320,15,23,38,39.5%,55m
4163,2,旅行到宇宙边缘,3401,392,13,19,32,40.6%,11m
4163,2,Castiel,3401,210,7,13,20,35.0%,23m
4163,3,我们是方舟的骑士,3401,0,3,0,3,100.0%,50m
4163,3,是大发光火,3401,46,3,1,4,75.0%,29m
4163,3,rtyr,3401,58,2,2,4,50.0%,55m
4163,3,KyDParzival,3401,0,0,1,1,0.0%,4m
4174,2,Relativity,3400,1403,213,218,431,49.4%,3m
4174,3,[神椿]isekaijoucho,3400,97,6,0,6,100.0%,11m
4174,3,[三大队三人行]黑暗顾问,3400,0,0,1,1,0.0%,7m
4177,2,Isdweww,3399,1608,247,235,482,51.2%,25m
4177,3,[耀眼的青春]飞雪再临之时,3399,1375,237,211,448,52.9%,10m
4177,1,[Awyr]klim,3399,1216,129,137,266,48.5%,50m
4177,2,最强生物卡兹,3399,1262,52,51,103,50.5%,19m
4177,2,[NiCola]Coral,3399,434,14,17,31,45.2%,53m
4177,3,[底特律KAR]AyachiNene,3399,58,3,1,4,75.0%,8m
4177,2,出虚空等于无敌,3399,58,3,9,12,25.0%,9m
4177,3,AprilYun,3399,0,2,3,5,40.0%,9m
4177,3,钻钻钻钻钻,3399,0,1,1,2,50.0%,8m
4186,3,[SCVF2]SCV,3398,0,0,1,1,0.0%,52m
4186,3,suibian,3398,0,0,1,1,0.0%,3m
4188,3,[Fe3o4]世界,3397,322,11,13,24,45.8%,5m
4188,3,[求捶死]你是我的唯一,3397,0,2,3,5,40.0%,50m
4188,3,快乐的龙九,3397,0,0,1,1,0.0%,11m
4188,3,[抽爷]钟南山,3397,0,0,3,3,0.0%,20m
4192,2,hailin,3396,1156,289,275,564,51.2%,3m
4192,2,[超神给你看哦]Expecto,3396,1494,183,174,357,51.3%,15m
4192,2,[星际新手联邦]你大爷,3396,983,59,64,123,48.0%,20m
4192,3,[超电磁炉]今朝梦初情,3396,1122,52,50,102,51.0%,55m
4192,3,帝国远征军,3396,450,18,10,28,64.3%,9m
4192,3,顶级死法,3396,361,15,12,27,55.6%,56m
4192,3,Value,3396,116,6,5,11,54.5%,50m
4192,3,[手残老年组]dreamdown,3396,114,5,3,8,62.5%,28m
4192,3,Mononoke,3396,88,4,1,5,80.0%,7m
4192,3,[天际浩劫]木子,3396,60,3,2,5,60.0%,22m
4202,2,探索黑暗未见光明,3395,1186,54,38,92,58.7%,13m
4202,2,[SK]氵雨丶神灬,3395,151,7,13,20,35.0%,10m
4202,3,[五月花]原木真品,3395,0,1,0,1,100.0%,7m
4202,3,[SoIoAs]血花缭乱,3395,0,1,0,1,100.0%,17m
4202,3,[迦勒底]bbko,3395,30,1,4,5,20.0%,18m
4202,3,[艾尔最后之光]Dream,3395,0,0,1,1,0.0%,25m
4208,1,PotatoDeity,3394,1682,353,365,718,49.2%,48m
4208,3,独行侠,3394,310,24,17,41,58.5%,9m
4208,3,任春爽我爱你,3394,502,18,13,31,58.1%,53m
4208,2,Suffocating,3394,142,5,3,8,62.5%,51m
4208,3,[我们是无敌的]抱歉你不配,3394,30,2,1,3,66.7%,28m
4208,3,[TYFANS]湖底典狱长,3394,0,1,0,1,100.0%,53m
4208,3,[干翻黄旭东]终有弱水替沧海,3394,0,0,1,1,0.0%,20m
4208,3,[一米六]拿破仑,3394,0,0,1,1,0.0%,18m
4216,2,暴风践踏,3393,593,27,26,53,50.9%,54m
4216,3,crescent,3393,168,7,3,10,70.0%,17m
4216,3,辣鸡暴雪还我星际,3393,194,7,8,15,46.7%,14m
4216,3,LinkinPony,3393,118,5,5,10,50.0%,15m
4216,3,[望断星尘]ShiKi,3393,0,1,0,1,100.0%,27m
4216,3,[CJHero]无极舰队,3393,0,0,1,1,0.0%,11m
4222,2,史卢比,3392,1538,401,391,792,50.6%,23m
4222,2,[LFY]九折水平,3392,1085,121,123,244,49.6%,9m
4222,3,[Rhusky]伊藤失之咲,3392,614,32,18,50,64.0%,12m
4222,3,[白丝黑丝萝莉]狂杀落雪,3392,261,12,5,17,70.6%,22m
4222,2,[练出来了协会]练出来了,3392,344,12,18,30,40.0%,7m
4222,3,小眼睛,3392,118,4,7,11,36.4%,24m
4222,3,[醉红颜]簡單壹點,3392,0,1,0,1,100.0%,48m
4222,3,铂金的神,3392,0,1,0,1,100.0%,23m
4222,3,你们都上网冲浪啊,3392,0,0,3,3,0.0%,28m
4222,3,Pur,3392,0,0,4,4,0.0%,10m
4232,2,[天人合一]无距,3391,1565,139,128,267,52.1%,9m
4232,3,[不死突袭3]老童哥,3391,589,41,23,64,64.1%,6m
4232,3,[醉生梦死]IIIIIIIIIIII,3391,610,23,22,45,51.1%,28m
4232,3,[浪啊浪]QIRIIYUE,3391,539,22,12,34,64.7%,13m
4232,3,卡拉卡拉,3391,250,10,10,20,50.0%,12m
4232,3,蓝色花园,3391,104,9,5,14,64.3%,7m
4232,3,[pp]YHC,3391,114,4,5,9,44.4%,53m
4232,3,PanzerIV,3391,0,3,2,5,60.0%,47m
4232,2,YIYI,3391,90,3,11,14,21.4%,11m
4232,1,Lampard,3391,0,1,0,1,100.0%,12m
4232,3,[MR1]满天都是小土雷,3391,0,0,2,2,0.0%,14m
4243,3,[鲲之大]脆脆果仁,3390,804,149,136,285,52.3%,14m
4243,2,[幼儿园W]深巷观花,3390,251,17,17,34,50.0%,18m
4243,3,[燚龘0958]燚龘,3390,166,6,5,11,54.5%,21m
4243,3,[HEX]hexagram,3390,118,4,4,8,50.0%,21m
4243,3,傻九九,3390,0,0,1,1,0.0%,5m
4248,2,青衫负雪,3389,495,31,24,55,56.4%,19m
4248,2,IIIIIIIII,3389,651,26,28,54,48.1%,26m
4248,2,[绝对三角领域]少校,3389,348,12,20,32,37.5%,15m
4248,3,[王者家族]血涂碟,3389,292,10,11,21,47.6%,17m
4248,3,lllllllllll,3389,116,5,5,10,50.0%,5m
4248,1,[不会散枪兵]ACCOMPANY,3389,0,0,1,1,0.0%,21m
4254,3,Superior,3388,1533,87,67,154,56.5%,11m
4254,2,TomYan,3388,1004,66,60,126,52.4%,7m
4254,2,Ckira,3388,952,40,40,80,50.0%,18m
4254,3,纯白天使,3388,443,18,7,25,72.0%,21m
4254,2,[鸡会友狗服人]黄金先生,3388,246,8,10,18,44.4%,10m
4254,2,浮沉,3388,144,6,9,15,40.0%,53m
4254,3,夜雨声烦,3388,60,2,5,7,28.6%,7m
4254,3,[洁白之巅]DizzyRogue,3388,0,1,0,1,100.0%,49m
4254,3,THOOH,3388,0,1,0,1,100.0%,28m
4254,3,[扫黄]Fenrisulfr,3388,0,1,0,1,100.0%,4m
4254,3,[dsnggs]久黎,3388,0,0,1,1,0.0%,7m
4254,3,[一只废宅]Aaron,3388,0,0,2,2,0.0%,49m
4266,2,XXXXLia,3387,1620,125,115,240,52.1%,13m
4266,2,天狼,3387,1022,53,47,100,53.0%,13m
4266,2,llllllllllll,3387,1222,52,55,107,48.6%,29m
4266,2,Least,3387,1071,38,43,81,46.9%,47m
4266,3,[菜的没人带]陌陌陌,3387,524,20,16,36,55.6%,6m
4266,3,Alarak,3387,166,7,4,11,63.6%,9m
4266,3,[Rhusky]作思竹,3387,178,6,7,13,46.2%,48m
4266,3,[miku守护]御神夜,3387,88,4,3,7,57.1%,25m
4266,3,FanscDragon,3387,88,4,6,10,40.0%,55m
4266,3,[SoLi]火灬焰,3387,0,0,1,1,0.0%,24m
4276,3,Exia,3386,278,10,10,20,50.0%,53m
4276,2,Glif,3386,116,3,0,3,100.0%,11m
4276,3,[Pllmba]神族就输不了,3386,0,3,2,5,60.0%,48m
4276,3,无法显示,3386,0,0,1,1,0.0%,54m
4280,2,[中中网咖]Rosefinch,3385,68,4,9,13,30.8%,54m
4280,3,[葛温王下骑士]卫宫士郎,3385,0,3,2,5,60.0%,29m
4280,2,困困困困困,3385,94,3,12,15,20.0%,54m
4280,3,[VirGo]云在青天,3385,30,2,1,3,66.7%,15m
4280,3,[伊天降同萌会]八神传说,3385,30,2,1,3,66.7%,18m
4280,3,觉悟的新手,3385,0,1,0,1,100.0%,15m
4280,3,醉明月,3385,0,0,1,1,0.0%,56m
4280,3,[大爱EMT]江田岛聋哑学校,3385,0,0,1,1,0.0%,11m
4288,3,IIIIIIIIIIII,3384,1153,65,63,128,50.8%,11m
4288,3,幽月,3384,456,33,21,54,61.1%,25m
4288,3,EleVen,3384,503,20,8,28,71.4%,14m
4288,3,Justice,3384,330,19,19,38,50.0%,53m
4288,2,IIIIIIIIIIII,3384,347,16,12,28,57.1%,27m
4293,2,[圆娇]失败者,3383,1512,143,113,256,55.9%,3m
4293,3,[我菜请打队友]亚特兰蒂斯,3383,667,33,30,63,52.4%,48m
4293,3,[叫我杰哥]野兽仙贝,3383,438,19,11,30,63.3%,53m
4293,3,[华师大二附中]Noleft,3383,335,15,8,23,65.2%,23m
4293,2,[哔哩哔哩乾杯]JinrMaru,3383,224,8,15,23,34.8%,54m
4293,1,INnoVation,3383,0,1,0,1,100.0%,5m
4293,3,[Shawk]简单电脑,3383,0,0,2,2,0.0%,53m
4300,2,melegend,3382,1503,513,497,1010,50.8%,3m
4300,2,nvroe,3382,1468,152,134,286,53.1%,10m
4300,2,[七山龙]flywolf,3382,1129,98,72,170,57.6%,3m
4300,3,[YT]蓝瘦,3382,705,31,17,48,64.6%,7m
4300,3,[快乐谐星go]条码人,3382,704,28,18,46,60.9%,50m
4300,3,Hellscythe,3382,390,14,10,24,58.3%,53m
4300,1,花样男子勇闯星际,3382,294,11,5,16,68.8%,22m
4300,2,暗影风暴,3382,94,3,8,11,27.3%,22m
4300,3,慵懒的像只猫,3382,0,1,0,1,100.0%,53m
4300,3,[字数补丁]虐猫狂魔薛定谔,3382,0,1,0,1,100.0%,24m
4300,1,maru,3382,0,0,6,6,0.0%,5m
4311,3,[TeamCD]我不会玩,3381,919,57,33,90,63.3%,49m
4311,3,tsuki,3381,1188,48,37,85,56.5%,21m
4311,2,[文韬武略]Olsen,3381,581,30,34,64,46.9%,15m
4311,3,[YA]MeGuMI,3381,416,17,8,25,68.0%,22m
4311,3,[ONE拳]Wicken,3381,168,7,2,9,77.8%,10m
4311,3,[人族无敌]香风智乃,3381,142,5,2,7,71.4%,54m
4311,3,[SC联盟]Maru,3381,140,5,3,8,62.5%,17m
4311,3,[教我玩神族]KawakazeXD,3381,0,1,0,1,100.0%,26m
4311,3,[WA2白学家]KazusaKH,3381,0,1,0,1,100.0%,51m
4311,3,破碎的承诺,3381,0,1,0,1,100.0%,29m
4321,3,kiprop,3380,373,17,6,23,73.9%,50m
4321,3,风之殇,3380,368,15,7,22,68.2%,52m
4321,2,Misaka,3380,234,9,14,23,39.1%,10m
4321,3,[江南虫王]混元星际孙一峰,3380,148,6,3,9,66.7%,21m
4321,3,[新手保护协会]IlluSioN,3380,58,3,0,3,100.0%,22m
4321,3,卡扎菲,3380,30,2,0,2,100.0%,6m
4321,3,[霖fince]霖风,3380,97,2,0,2,100.0%,55m
4321,3,[暴走獠牙]暗黑之狼,3380,30,1,1,2,50.0%,28m
4321,3,中单帕克,3380,0,0,1,1,0.0%,12m
4330,2,[zombie]柱岛泊地咸鱼,3379,1539,203,178,381,53.3%,24m
4330,2,[NKTJ]Templar,3379,1095,169,163,332,50.9%,22m
4330,3,听风,3379,1090,52,30,82,63.4%,20m
4330,3,sea,3379,58,3,0,3,100.0%,12m
4330,2,[sbcoys]pandasssss,3379,114,2,6,8,25.0%,25m
4330,3,[传说萌娘团]星语,3379,0,1,0,1,100.0%,8m
4330,3,[拿枪的探鸡]泽拉图,3379,0,0,1,1,0.0%,5m
4337,3,manu,3378,1488,58,53,111,52.3%,11m
4337,2,[慢手e族]最可爱的波波,3378,950,41,39,80,51.2%,52m
4337,2,[RPGBoY]lllllllll,3378,854,33,34,67,49.3%,3m
4337,3,victim,3378,143,10,7,17,58.8%,56m
4337,2,大帝,3378,0,5,1,6,83.3%,8m
4337,3,布丁,3378,0,0,1,1,0.0%,21m
4337,3,克拉一执政官,3378,0,0,4,4,0.0%,6m
4344,2,[XYFANS]player,3377,1465,185,183,368,50.3%,23m
4344,3,HowToDo,3377,1345,70,62,132,53.0%,52m
4344,2,Alexander,3377,635,36,37,73,49.3%,2m
4344,3,[五月花]佐仓枫,3377,567,31,12,43,72.1%,18m
4344,3,llllllllllll,3377,176,6,8,14,42.9%,1m
4344,2,[情义天下]Polaris,3377,0,1,1,2,50.0%,29m
4350,2,Woodyabner,3376,1477,112,124,236,47.5%,26m
4350,3,IIIIIIIIIIII,3376,298,13,6,19,68.4%,23m
4350,2,这个世界太乱,3376,201,9,3,12,75.0%,11m
4350,2,逆风,3376,44,6,2,8,75.0%,51m
4350,1,[Canton]莫作栋,3376,0,1,0,1,100.0%,7m
4355,2,[Dcboy]PartinG,3375,1616,221,229,450,49.1%,3m
4355,3,mirror,3375,1600,168,155,323,52.0%,14m
4355,2,[魔法少女小屋]tristone,3375,707,69,68,137,50.4%,22m
4355,3,chris,3375,576,48,37,85,56.5%,55m
4355,2,kkkk,3375,42,4,5,9,44.4%,27m
4355,3,[丨SLT丨]逐光,3375,58,2,2,4,50.0%,52m
4361,2,WGY,3374,598,115,111,226,50.9%,13m
4361,2,[cycle]海神,3374,1100,90,85,175,51.4%,9m
4361,3,[FW没胆单挑]条码条码条码条码,3374,461,23,19,42,54.8%,13m
4361,2,[Vgirls]手冲达人,3374,514,18,30,48,37.5%,7m
4361,2,IIIIIIIIIIII,3374,306,11,17,28,39.3%,10m
4361,3,balcare,3374,0,2,3,5,40.0%,50m
4361,3,幺云,3374,0,1,0,1,100.0%,4m
4361,3,[洁白之巅]一个无法更改的,3374,30,1,2,3,33.3%,26m
4361,3,荣耀,3374,30,1,5,6,16.7%,52m
4370,3,krownkkk,3373,616,23,20,43,53.5%,3m
4370,2,Demon,3373,282,11,12,23,47.8%,25m
4370,3,[脉脉不得语]TheDream,3373,58,2,3,5,40.0%,11m
4370,3,鸡菜,3373,58,2,3,5,40.0%,6m
4374,2,QAQ,3372,1501,98,100,198,49.5%,7m
4374,3,照裆猛踢,3372,829,52,55,107,48.6%,51m
4374,2,Star,3372,987,42,54,96,43.8%,11m
4374,2,打我打,3372,469,20,17,37,54.1%,24m
4374,3,IIIIIIIIIIII,3372,324,11,11,22,50.0%,28m
4374,2,[TMUSC2]Empress,3372,150,5,13,18,27.8%,22m
4374,3,Feilx,3372,114,4,3,7,57.1%,14m
4374,3,[I苏维埃I]前略,3372,90,3,4,7,42.9%,56m
4374,3,blackhuwn,3372,90,3,6,9,33.3%,5m
4374,3,NovaAlex,3372,30,1,1,2,50.0%,50m
4374,3,DevotionLK,3372,30,1,2,3,33.3%,21m
4374,3,sword,3372,20,1,5,6,16.7%,7m
4374,3,何尼玛,3372,0,0,2,2,0.0%,12m
4387,2,[agafaa]我是你爹,3371,1398,147,140,287,51.2%,29m
4387,3,[阿斯塔特]黄金马桶上的干尸,3371,133,7,1,8,87.5%,2m
4387,3,[A丶rise]白银,3371,0,5,0,5,100.0%,27m
4387,3,[XDUSC2]DirectorZ,3371,118,3,0,3,100.0%,50m
4387,3,[EL骑士团]冈崎汐,3371,0,1,0,1,100.0%,29m
4387,3,星际熊猫,3371,0,1,2,3,33.3%,21m
4387,2,[尹志平]你居然不认识东本,3371,0,0,1,1,0.0%,27m
4394,3,llllllllllll,3370,1202,61,26,87,70.1%,21m
4394,2,Hideonbush,3370,1140,58,54,112,51.8%,25m
4394,3,[半个菜鸟]月色真美,3370,490,18,17,35,51.4%,7m
4394,3,[大爱星际二]学前教育,3370,58,2,2,4,50.0%,18m
4398,3,有幸遇到,3369,1125,317,304,621,51.0%,28m
4398,3,霸王尼尼,3369,58,2,3,5,40.0%,14m
4398,2,通商寛农,3369,44,2,4,6,33.3%,27m
4398,2,打得好我认输,3369,88,2,5,7,28.6%,3m
4398,3,潜入女捜査官,3369,96,1,3,4,25.0%,52m
4403,2,人帅何须艾迪拽,3368,1249,60,50,110,54.5%,29m
4403,2,[合作帝]螓猩恋恋,3368,769,33,30,63,52.4%,15m
4403,2,AurorA,3368,626,32,18,50,64.0%,3m
4403,3,[CIE]迪奥,3368,210,11,7,18,61.1%,29m
4403,3,[小乖与大乖]曾某人,3368,196,7,1,8,87.5%,2m
4403,3,waterproof,3368,174,6,6,12,50.0%,22m
4403,3,papo,3368,0,0,1,1,0.0%,11m
4410,3,温小二,3367,613,27,9,36,75.0%,3m
4410,3,waffleyyy,3367,140,6,0,6,100.0%,5m
4410,3,[Fe3o4]haha,3367,30,2,1,3,66.7%,28m
4410,3,[背着预言家的]zsdzz,3367,30,1,1,2,50.0%,21m
4414,3,辉煌,3366,821,93,92,185,50.3%,24m
4414,3,UltraMan,3366,395,19,3,22,86.4%,3m
4414,2,[影视家协会]无宇伦比,3366,452,16,19,35,45.7%,3m
4414,3,格里芬小将叶戈尔,3366,114,5,2,7,71.4%,10m
4414,3,[3Ky]Chimney,3366,140,5,3,8,62.5%,6m
4414,3,IIIIIIIIIIII,3366,116,4,3,7,57.1%,56m
4414,3,[抽爷]wwqlove,3366,0,0,1,1,0.0%,22m
4414,3,[怀念曾经温柔]圆滚滚的滚滚圆,3366,0,0,1,1,0.0%,22m
4422,2,[专业de团队]太行上帝,3365,855,31,38,69,44.9%,53m
4422,3,[桃乃木香奈]IIIIIIIII,3365,308,12,13,25,48.0%,21m
4422,3,顾影自怜,3365,276,10,10,20,50.0%,49m
4422,3,泽琦,3365,268,10,10,20,50.0%,53m
4422,3,[金毛猫娘]蒽菲,3365,140,6,6,12,50.0%,53m
4422,3,[P就IMBA]Ayanami,3365,114,5,3,8,62.5%,14m
4422,3,Ragrander,3365,140,4,1,5,80.0%,17m
4422,3,[萝莉之芯]PanDaYu,3365,30,1,2,3,33.3%,26m
4422,3,See,3365,0,0,1,1,0.0%,10m
4422,3,Perfect,3365,0,0,1,1,0.0%,12m
4422,3,岛市老八,3365,0,0,1,1,0.0%,52m
4422,3,[cstdio]volta,3365,0,0,1,1,0.0%,50m
4434,3,莫殇痕,3364,517,22,13,35,62.9%,28m
4434,3,[大陆谐会]西北孙一峰,3364,316,12,8,20,60.0%,11m
4434,3,德莉莎第一可爱,3364,50,3,3,6,50.0%,10m
4434,3,MIKEzhang,3364,58,2,1,3,66.7%,21m
4434,3,IIIIIIIIIIII,3364,0,2,4,6,33.3%,15m
4434,3,MrKiKo,3364,0,1,0,1,100.0%,24m
4434,2,静静的小柴犬,3364,0,1,4,5,20.0%,29m
4441,3,悠木碧,3363,258,10,1,11,90.9%,1m
4441,3,[小媛]皇马之魂,3363,107,6,6,12,50.0%,24m
4441,3,[TNLet]狐疑,3363,86,3,1,4,75.0%,24m
4441,3,丶晴天,3363,0,0,1,1,0.0%,11m
4441,3,[纳格兰之翼]WBKstorm,3363,0,0,2,2,0.0%,4m
4446,2,二分心智,3362,368,16,21,37,43.2%,26m
4446,3,BonesAQ,3362,172,6,11,17,35.3%,13m
4446,1,[z好弱啊]LenmeeSander,3362,96,2,3,5,40.0%,5m
4446,3,暗龙,3362,30,1,2,3,33.3%,50m
4446,1,[Igirls]Summer,3362,0,1,4,5,20.0%,54m
4451,2,[titit]香烟火柴盒啊,3361,1565,229,226,455,50.3%,3m
4451,3,[哔哩哔哩乾杯]无有才德,3361,1571,97,96,193,50.3%,24m
4451,3,[骨灰拌饭]中路杀神,3361,1109,61,36,97,62.9%,8m
4451,3,carrot,3361,1436,58,50,108,53.7%,13m
4451,3,WolfButJK,3361,698,38,22,60,63.3%,18m
4451,3,嘿嘿他菜鸟,3361,776,31,29,60,51.7%,29m
4451,2,IIIIIIIIIIII,3361,624,25,24,49,51.0%,13m
4451,3,沉默寡言黄少天,3361,62,4,7,11,36.4%,22m
4451,2,[VKR]西湖底的二五仔,3361,168,4,9,13,30.8%,53m
4451,2,IIIIlllIIIll,3361,30,2,7,9,22.2%,18m
4461,2,JUNL,3360,453,21,24,45,46.7%,11m
4461,3,[神奇的联萌]咒逐之祈福,3360,144,6,2,8,75.0%,13m
4461,3,[糖宗]灰流丽,3360,0,0,1,1,0.0%,7m
4464,3,OldYu,3359,1465,103,97,200,51.5%,14m
4464,2,有才与长歌,3359,1509,100,101,201,49.8%,1m
4464,3,King,3359,436,31,15,46,67.4%,9m
4464,3,变成娜哈特的狗,3359,355,24,15,39,61.5%,13m
4464,3,弱小艾尔求加强,3359,164,19,16,35,54.3%,9m
4464,2,艾尔没辫子,3359,282,9,21,30,30.0%,56m
4464,3,[是嫂子自愿的]御倾,3359,174,6,4,10,60.0%,52m
4464,3,探机,3359,86,4,1,5,80.0%,21m
4464,3,[TOKYO]Sakura,3359,0,1,0,1,100.0%,3m
4464,3,[我随便打打的]月季,3359,30,1,2,3,33.3%,13m
4474,3,[二阶堂真红]水上由岐,3358,285,14,5,19,73.7%,23m
4474,3,savelove,3358,88,4,2,6,66.7%,56m
4474,3,[WHU]罗辑,3358,0,1,4,5,20.0%,4m
4474,3,ForeverMXX,3358,0,0,2,2,0.0%,25m
4478,2,Magaotan,3357,601,190,177,367,51.8%,15m
4478,3,破两票,3357,1087,55,48,103,53.4%,1m
4478,3,[传说萌鸡团]Shaquille,3357,1270,50,41,91,54.9%,6m
4478,1,尼飞彼多,3357,1426,42,74,116,36.2%,54m
4478,3,IyYHL,3357,390,16,6,22,72.7%,55m
4478,3,[M870]人活着是为了拉拉,3357,30,2,1,3,66.7%,3m
4478,3,[XMG00]越狱,3357,0,1,0,1,100.0%,6m
4478,3,脏脏,3357,0,1,0,1,100.0%,11m
4478,3,龟田一峰,3357,30,1,2,3,33.3%,22m
4487,3,卡德加的学徒,3356,736,28,23,51,54.9%,5m
4487,3,[YR]天坑丶盒纸,3356,250,19,6,25,76.0%,4m
4487,2,[深远Hist]Sheep,3356,294,10,17,27,37.0%,25m
4487,3,[光剑皇族]爱梦超,3356,88,3,3,6,50.0%,56m
4487,3,[HNU]LeGend,3356,0,0,1,1,0.0%,22m
4492,2,华皇旋影,3355,716,24,33,57,42.1%,3m
4492,3,lllllllllll,3355,617,22,17,39,56.4%,10m
4492,2,风林火山,3355,457,18,18,36,50.0%,17m
4492,3,hyfxiaohao,3355,450,17,14,31,54.8%,28m
4492,3,pzh,3355,236,9,9,18,50.0%,28m
4492,3,[武大萌新]TohsakaRin,3355,144,5,6,11,45.5%,29m
4492,3,DLee,3355,83,4,1,5,80.0%,56m
4492,3,[科普鲁苏维埃]Eden,3355,0,1,0,1,100.0%,3m
4500,3,ihlown,3354,1602,102,96,198,51.5%,13m
4500,3,[棒棒堂]jazz,3354,732,66,58,124,53.2%,11m
4500,3,Wxr,3354,832,48,39,87,55.2%,6m
4500,3,[狗不理战队]暴走黑衣人,3354,841,31,29,60,51.7%,25m
4500,3,源大神,3354,411,17,20,37,45.9%,14m
4500,3,[香風智乃]卡布奇诺,3354,172,6,14,20,30.0%,6m
4500,2,Duiess,3354,44,2,0,2,100.0%,8m
4500,3,[汉东反贪总局]侯亮平,3354,60,2,8,10,20.0%,14m
4500,3,[tiandi]半丶丶梦,3354,0,0,2,2,0.0%,10m
4509,2,运营哥,3353,1183,191,181,372,51.3%,29m
4509,2,[LDP]imbzp,3353,1581,171,162,333,51.4%,7m
4509,2,[KPG2]primeuk,3353,1555,138,143,281,49.1%,7m
4509,2,[PKU]利比亚刘,3353,1515,127,119,246,51.6%,3m
4509,2,[GAC]独醉千殇,3353,1314,114,120,234,48.7%,53m
4509,3,SuperChris,3353,1287,58,39,97,59.8%,26m
4509,3,你咬我啊,3353,488,16,20,36,44.4%,7m
4509,1,星际吃枣药丸,3353,253,8,10,18,44.4%,15m
4509,3,kom,3353,58,3,0,3,100.0%,21m
4509,3,SCFOREVER,3353,30,2,0,2,100.0%,55m
4509,3,[C55401]混元星际门大弟子,3353,0,0,1,1,0.0%,7m
4509,3,翻滚吧丶小番茄,3353,0,0,1,1,0.0%,53m
4509,3,Cat,3353,0,0,1,1,0.0%,22m
4522,2,咖啡碱,3352,1622,393,365,758,51.8%,3m
4522,2,[PKU]神算子吕奉先,3352,1371,238,208,446,53.4%,13m
4522,2,iiiiiiii,3352,1471,222,205,427,52.0%,22m
4522,3,Frank,3352,1331,60,60,120,50.0%,13m
4522,3,[一起多人运动]TerranCtl,3352,380,14,13,27,51.9%,52m
4522,1,罗伯斯庇尔,3352,183,6,2,8,75.0%,21m
4522,1,潦草人生,3352,0,3,2,5,60.0%,1h
4522,3,戏言,3352,92,3,4,7,42.9%,53m
4530,3,大是大非,3351,1681,295,281,576,51.2%,8m
4530,2,年轻人要讲武德,3351,1127,129,122,251,51.4%,2m
4530,2,IIIIIIIII,3351,216,24,35,59,40.7%,10m
4530,3,[炮火46]tiger,3351,142,5,6,11,45.5%,17m
4530,2,[PITB]Saint,3351,60,3,11,14,21.4%,9m
4530,3,小陌陌,3351,0,0,1,1,0.0%,12m
4536,2,炸鱼仔四圈加,3350,1410,68,58,126,54.0%,20m
4536,3,东少,3350,1485,66,63,129,51.2%,24m
4536,3,吼好还,3350,114,4,8,12,33.3%,20m
4536,3,[天地丶无双]社会你磊哥,3350,86,3,5,8,37.5%,11m
4536,3,灰暗,3350,96,2,0,2,100.0%,15m
4536,3,[梦回虫群之心]sOs,3350,0,0,1,1,0.0%,56m
4542,3,[SDE]卖女孩的小火柴,3349,1589,118,113,231,51.1%,26m
4542,3,llllllllllll,3349,1055,60,36,96,62.5%,11m
4542,3,大橘为重,3349,950,36,33,69,52.2%,12m
4542,3,[觀天習文]光陨,3349,310,12,4,16,75.0%,28m
4542,3,[女装埃蒙]Away,3349,58,3,2,5,60.0%,2m
4542,3,scfreu,3349,30,1,3,4,25.0%,57m
4542,3,[刀使之巫女]衛藤可奈美,3349,30,1,4,5,20.0%,11m
4542,3,[一戳一蹦跶]桃子,3349,0,0,1,1,0.0%,13m
4550,3,[基金会]闪烁的星辰,3348,1258,126,93,219,57.5%,8m
4550,3,[菜有菜的道理]自己去悟,3348,1479,82,74,156,52.6%,57m
4550,3,Tempest,3348,306,21,6,27,77.8%,21m
4550,3,七弦念,3348,270,10,1,11,90.9%,50m
4550,1,[屑之魔女]小魔女伊蕾娜,3348,119,3,2,5,60.0%,6m
4550,3,御剑蜀山,3348,0,1,0,1,100.0%,17m
4550,3,[冰霜不朽]一条懒狗,3348,0,1,0,1,100.0%,26m
4550,3,[北京大学鸡协]MaGeJiProtos,3348,0,1,0,1,100.0%,20m
4558,3,妹妹你坐船头,3347,836,95,94,189,50.3%,6m
4558,3,[你的剑很美]本毒物,3347,1653,89,61,150,59.3%,3m
4558,3,[我们是无敌的]果断就会白给,3347,674,30,22,52,57.7%,10m
4558,3,小浪浪,3347,146,5,1,6,83.3%,24m
4558,3,[SAE]Feryquitous,3347,0,0,1,1,0.0%,20m
4558,3,[初音未來]凉薄少女梦,3347,0,0,1,1,0.0%,20m
4558,2,[花花]MRmoney,3347,0,0,8,8,0.0%,7m
4565,2,[黄金战队]洛殿,3346,1538,170,160,330,51.5%,3m
4565,3,CsAi,3346,1633,68,56,124,54.8%,7m
4565,3,登哥,3346,778,50,39,89,56.2%,24m
4565,3,[慢手e族]Beyond,3346,118,5,7,12,41.7%,6m
4565,3,Destiny,3346,86,4,0,4,100.0%,56m
4565,3,zdwssx,3346,0,1,0,1,100.0%,28m
4565,3,Fostone,3346,0,0,1,1,0.0%,17m
4565,3,[APoX]机械之忍,3346,0,0,1,1,0.0%,7m
4565,3,[砲平四海]陆战人员,3346,0,0,1,1,0.0%,10m
4574,3,[致敬蒙斯克]请冷静,3345,338,14,18,32,43.8%,11m
4574,3,RYSKAH,3345,188,9,10,19,47.4%,53m
4574,2,Jingyu,3345,246,8,5,13,61.5%,18m
4574,3,KEVIN,3345,58,3,2,5,60.0%,17m
4574,3,星空交错,3345,0,0,2,2,0.0%,12m
4579,3,liaaa,3344,538,21,12,33,63.6%,18m
4579,3,LOVEzw,3344,334,13,10,23,56.5%,3m
4579,3,人族就赢不了,3344,118,5,4,9,55.6%,26m
4579,1,[despai]atom,3344,186,5,6,11,45.5%,21m
4579,2,[哔哩哔哩乾杯]艾尔必将光复,3344,0,1,0,1,100.0%,52m
4579,3,herO,3344,0,0,1,1,0.0%,25m
4579,3,[伊莉雅真可爱]老婆伊莉雅真可爱,3344,0,0,1,1,0.0%,9m
4579,3,[王师北定]子非鱼,3344,0,0,2,2,0.0%,52m
4587,2,culmings,3343,1228,182,183,365,49.9%,2m
4587,3,IIIIIIIIIIII,3343,954,50,32,82,61.0%,17m
4587,3,[RHODE]Genro,3343,238,8,10,18,44.4%,3m
4587,3,sevens,3343,58,3,0,3,100.0%,13m
4587,2,古明地图炮,3343,62,2,11,13,15.4%,20m
4587,3,战占斩,3343,0,0,1,1,0.0%,20m
4593,2,凤凰,3342,1555,118,113,231,51.1%,11m
4593,3,[悟了]哔哩哔哩丶森林猫,3342,628,28,8,36,77.8%,11m
4593,3,[TCP]Pureyellow,3342,124,4,8,12,33.3%,51m
4593,3,[北部战区]SoS,3342,58,3,5,8,37.5%,3m
4593,3,[灬红萌馆灬]warm,3342,60,2,2,4,50.0%,9m
4598,3,DietmarP,3341,360,14,11,25,56.0%,57m
4598,3,总有刁民想害朕,3341,228,8,8,16,50.0%,11m
4598,3,[黑丝即是正义]Reynold,3341,97,5,1,6,83.3%,56m
4598,3,椎名真白丶,3341,114,4,2,6,66.7%,28m
4598,3,[暴雪养鸡场]在下王三岁,3341,86,4,2,6,66.7%,50m
4598,3,[KPG2]来找小秘书,3341,88,3,8,11,27.3%,18m
4604,3,deadwalk,3340,434,18,16,34,52.9%,49m
4604,3,[屠夫预备队]SKTrealy,3340,302,12,8,20,60.0%,52m
4604,3,llllllllllll,3340,30,2,0,2,100.0%,5m
4604,3,低熵体,3340,0,1,0,1,100.0%,55m
4604,3,[GUF]时过境迁,3340,0,1,0,1,100.0%,24m
4604,3,ydydm,3340,30,1,1,2,50.0%,10m
4604,3,小雨泽,3340,0,0,1,1,0.0%,29m
4611,3,[美少女壮士]梵天净,3339,1448,137,102,239,57.3%,53m
4611,2,IIIIIIIIIIII,3339,978,127,133,260,48.8%,25m
4611,3,雪之下雪乃,3339,531,34,18,52,65.4%,21m
4611,3,时说,3339,710,24,27,51,47.1%,21m
4611,3,Stats,3339,303,23,21,44,52.3%,7m
4611,3,[我们是无敌的]呆呆,3339,242,9,5,14,64.3%,53m
4611,2,断幺九,3339,224,7,11,18,38.9%,11m
4611,1,逆魔天狂,3339,0,3,2,5,60.0%,1h
4611,3,[紫gbawe]blackrock,3339,30,2,2,4,50.0%,7m
4611,3,scgirl,3339,58,2,3,5,40.0%,21m
4611,3,[萨尔那加之刃]jiuzi,3339,0,1,1,2,50.0%,15m
4611,3,某李姓后勤部部长,3339,30,1,3,4,25.0%,8m
4611,3,[ByuNgl]xOnEmAnArmYx,3339,0,0,1,1,0.0%,52m
4611,3,[就硬莽]championsoO,3339,0,0,1,1,0.0%,11m
4625,3,HAIILO,3338,1501,233,215,448,52.0%,5m
4625,2,瓦塔诺,3338,1121,194,189,383,50.7%,9m
4625,2,的瑟玩意,3338,833,121,118,239,50.6%,56m
4625,3,ZheroZ,3338,633,84,64,148,56.8%,11m
4625,3,重复购买奶粉,3338,1240,47,44,91,51.6%,6m
4625,3,[艾尔之主]狡猾之异虫,3338,176,6,5,11,54.5%,24m
4625,3,咖喱棒,3338,58,2,2,4,50.0%,56m
4625,3,我好菜啊,3338,0,0,1,1,0.0%,56m
4633,3,REPULSER,3337,312,12,4,16,75.0%,7m
4633,3,[小鸡屠宰场a]吟唱丶琉璃新月,3337,0,0,1,1,0.0%,14m
4635,3,[RGFC]Limbo,3336,1194,54,47,101,53.5%,55m
4635,3,璀璨星华,3336,853,36,31,67,53.7%,5m
4635,3,GrayFinger,3336,324,12,10,22,54.5%,13m
4635,3,[opppp]NowLoading,3336,162,7,2,9,77.8%,55m
4635,3,[Period]Tarzan,3336,150,5,9,14,35.7%,26m
4635,2,[涨停敢死队]鸡霸,3336,58,3,8,11,27.3%,29m
4635,3,你怎么看,3336,30,2,3,5,40.0%,56m
4635,3,狮子王,3336,0,1,0,1,100.0%,4m
4635,1,aada,3336,0,1,0,1,100.0%,1h
4635,3,白夜凛音,3336,0,1,2,3,33.3%,50m
4645,3,Vampirerider,3335,684,24,28,52,46.2%,24m
4645,3,IIIIIIIIIIII,3335,485,21,11,32,65.6%,7m
4645,3,sherry,3335,520,20,16,36,55.6%,11m
4645,3,chosen,3335,86,4,4,8,50.0%,12m
4645,2,医学苑丶帆,3335,92,3,11,14,21.4%,20m
4650,3,波波龙,3334,1301,74,61,135,54.8%,28m
4650,2,eth,3334,593,25,27,52,48.1%,17m
4650,3,IIIIIIIIIIII,3334,562,23,17,40,57.5%,3m
4650,3,MarTin,3334,405,15,14,29,51.7%,14m
4650,3,[空中劈叉]RaidenMei,3334,172,6,5,11,54.5%,57m
4650,3,meaniloy,3334,146,5,4,9,55.6%,6m
4650,3,spj,3334,0,1,0,1,100.0%,24m
4650,2,Campas,3334,0,1,0,1,100.0%,19m
4650,3,[北京大学鸡协]llllllllllll,3334,0,1,1,2,50.0%,29m
4650,3,[青铜树]GAMEKING,3334,18,1,2,3,33.3%,18m
4650,3,上杉丶绘梨衣,3334,0,0,1,1,0.0%,11m
4661,3,鬼头明里,3333,1421,106,74,180,58.9%,3m
4661,2,IIIIIIIIII,3333,1185,44,50,94,46.8%,3m
4661,3,老年菜鸡,3333,245,14,8,22,63.6%,21m
4661,3,setsuna,3333,202,8,8,16,50.0%,50m
4661,3,kindles,3333,167,7,3,10,70.0%,11m
4661,3,[滨江昏庸无道]夜凉城,3333,90,4,3,7,57.1%,14m
4661,3,yaliu,3333,114,4,3,7,57.1%,3m
4661,3,[珞喻路第一P]邦少皇,3333,30,2,1,3,66.7%,18m
4669,3,TOSS,3332,1552,121,112,233,51.9%,53m
4669,3,随机尼玛呢随机,3332,654,64,56,120,53.3%,25m
4669,2,星海畅游,3332,1425,62,64,126,49.2%,20m
4669,3,LTbyun,3332,1287,54,40,94,57.4%,2m
4669,3,小刺蛇,3332,1130,51,34,85,60.0%,3m
4669,3,小熊,3332,551,32,26,58,55.2%,22m
4669,3,[哔翻天梯鸡]妲己终妖,3332,116,5,1,6,83.3%,56m
4669,3,赤佬,3332,88,4,4,8,50.0%,9m
4669,1,我得重新集结部队,3332,90,3,2,5,60.0%,14m
4669,3,[萌芯]March,3332,0,1,0,1,100.0%,28m
4669,3,[GFTS]迈向星辰,3332,0,1,3,4,25.0%,28m
4669,3,[北京大学鸡协]llllllllllll,3332,0,1,3,4,25.0%,3m
4681,3,QWQ,3331,1319,67,62,129,51.9%,28m
4681,2,Lindada,3331,516,17,25,42,40.5%,54m
4681,3,[星际爱好者队]全靠内力,3331,86,3,1,4,75.0%,14m
4681,3,鸡饲料,3331,60,2,3,5,40.0%,22m
4681,2,IIIIIIII,3331,0,1,0,1,100.0%,49m
4681,3,HeroFish,3331,30,1,1,2,50.0%,10m
4681,3,[枪兵滾毒爆]llllllllllll,3331,0,0,1,1,0.0%,21m
4681,3,皮卡丘,3331,0,0,1,1,0.0%,55m
4681,3,[HENUSC]sOs,3331,0,0,2,2,0.0%,26m
4690,2,[包子爬虫]包子爬虫,3330,634,113,87,200,56.5%,18m
4690,3,Mcy,3330,1403,84,62,146,57.5%,18m
4690,2,无头吃货三,3330,545,79,60,139,56.8%,54m
4690,3,king,3330,467,64,32,96,66.7%,53m
4690,2,[德哈卡神教]戏中人,3330,606,45,34,79,57.0%,18m
4690,3,xuduoduo,3330,418,28,13,41,68.3%,53m
4690,3,MagejiTerran,3330,266,14,5,19,73.7%,20m
4690,2,鹰鸟小鸟,3330,203,9,5,14,64.3%,1m
4690,3,嘿嘿嘿嚯,3330,198,8,6,14,57.1%,6m
4690,3,Somnus,3330,144,5,8,13,38.5%,14m
4690,3,守护者孙一鸡,3330,86,4,5,9,44.4%,9m
4690,3,[圣光帝国]狗曰的藤讯,3330,0,0,1,1,0.0%,55m
4690,1,[花香惹人醉]一一不喜欢我,3330,0,0,1,1,0.0%,1h
4703,3,前期不会后期无力,3329,1515,64,52,116,55.2%,20m
4703,3,跳跳虫,3329,823,31,31,62,50.0%,18m
4703,3,暴雪令人失望,3329,664,27,20,47,57.4%,53m
4703,3,[超级大谐星]VHwy,3329,204,7,7,14,50.0%,19m
4703,3,子橙橙,3329,86,4,1,5,80.0%,19m
4703,3,[吻丶Say]LoseControl,3329,0,3,2,5,60.0%,5m
4703,3,[演员神教]AmatsukaMaoi,3329,0,1,0,1,100.0%,20m
4710,3,SCVonBulaga,3328,283,11,10,21,52.4%,14m
4710,3,[世纪之舟]SMILE,3328,239,8,2,10,80.0%,22m
4710,2,大闸蟹,3328,208,8,15,23,34.8%,13m
4710,3,[星际旅游团]午后的抹茶,3328,118,5,3,8,62.5%,14m
4710,3,[微软]宝宝姐姐,3328,0,1,0,1,100.0%,25m
4710,3,蛋炒饭很好吃,3328,97,1,2,3,33.3%,10m
4710,3,[禽禽禽]caicai,3328,0,0,3,3,0.0%,12m
4717,3,devilish,3327,1621,285,263,548,52.0%,22m
4717,3,凉着,3327,1667,82,70,152,53.9%,53m
4717,3,看见你我蛋疼,3327,909,71,58,129,55.0%,15m
4717,3,姑娘莫怕,3327,339,15,14,29,51.7%,7m
4717,1,[TSR]林磊,3327,0,1,0,1,100.0%,34m
4717,3,JamesHard,3327,0,1,3,4,25.0%,18m
4717,3,[黄金海舰队]buxu,3327,0,0,1,1,0.0%,12m
4717,3,萌新的潜行者,3327,0,0,2,2,0.0%,50m
4725,3,[BKG]Trap,3326,640,25,18,43,58.1%,21m
4725,3,是啊红吖,3326,247,15,10,25,60.0%,29m
4725,3,爱人言,3326,143,7,3,10,70.0%,11m
4725,3,小心渣男,3326,140,6,1,7,85.7%,21m
4725,3,电脑,3326,169,5,5,10,50.0%,3m
4725,2,[嘤嘤中心]天神宙斯,3326,137,3,2,5,60.0%,50m
4725,3,天海翼,3326,60,3,3,6,50.0%,3m
4725,1,MoonLee,3326,0,0,2,2,0.0%,1h
4733,3,llllllllllll,3325,1484,92,55,147,62.6%,17m
4733,2,对面的都是鸡,3325,1108,39,48,87,44.8%,11m
4733,3,[四叶草]千年之狐,3325,467,21,2,23,91.3%,26m
4733,3,[TCP]柑橘奶昔,3325,396,15,9,24,62.5%,30m
4733,2,[TPoA]星辰不及眉中山河,3325,410,14,20,34,41.2%,13m
4733,2,aska,3325,154,7,10,17,41.2%,53m
4733,1,乌鸦医生,3325,0,4,1,5,80.0%,1h
4733,2,[Borne]Vikingman,3325,0,1,1,2,50.0%,17m
4733,3,DietmarP,3325,0,1,2,3,33.3%,50m
4733,3,Should,3325,0,0,1,1,0.0%,21m
4733,3,[通附谐会]南通孙一峰,3325,0,0,1,1,0.0%,12m
4744,3,张璐是个好姐姐,3324,1267,56,52,108,51.9%,56m
4744,3,IIIIIIIIIIII,3324,374,27,15,42,64.3%,24m
4744,3,[皇家科院]盲人星际,3324,589,23,23,46,50.0%,52m
4744,3,[红果果QwQ]凤尾金鱼,3324,202,8,7,15,53.3%,13m
4744,3,哇啊,3324,0,1,0,1,100.0%,28m
4744,1,[天下无敌丶]风流倜傥百战无双,3324,0,0,2,2,0.0%,20m
4744,3,[NPUED]孙焕佳,3324,0,0,2,2,0.0%,9m
4751,2,[祝你生日快乐]青落,3323,446,17,26,43,39.5%,3m
4751,3,llllllllllll,3323,354,14,13,27,51.9%,14m
4751,2,[葬魂]Jei,3323,135,3,2,5,60.0%,13m
4751,3,我们还行吧,3323,30,1,1,2,50.0%,56m
4755,3,苏大俊,3322,1094,41,44,85,48.2%,19m
4755,3,[DX战队]mirror,3322,916,36,27,63,57.1%,18m
4755,3,yudian,3322,443,18,20,38,47.4%,28m
4755,3,DietmarP,3322,228,8,6,14,57.1%,21m
4755,3,CaileXXX,3322,30,1,2,3,33.3%,49m
4755,3,AutoWin,3322,0,0,1,1,0.0%,10m
4761,3,风未吹,3321,1096,74,58,132,56.1%,16m
4761,3,Empire,3321,554,70,32,102,68.6%,51m
4761,3,realitydark,3321,671,69,67,136,50.7%,28m
4761,2,疯了的大牛,3321,930,42,49,91,46.2%,10m
4761,3,红澜,3321,514,26,21,47,55.3%,53m
4761,3,[四叶草]俯首甘为孺子牛,3321,664,26,24,50,52.0%,21m
4761,2,doitbest,3321,389,26,32,58,44.8%,29m
4761,1,FenGX,3321,316,13,6,19,68.4%,52m
4761,3,[TPoA]Dark,3321,300,12,7,19,63.2%,24m
4761,3,星际迷航,3321,170,6,11,17,35.3%,52m
4761,3,小绵羊奥力给,3321,60,4,6,10,40.0%,54m
4761,3,SaRA,3321,0,1,0,1,100.0%,7m
4761,3,[Beasty]llllllllllll,3321,30,1,1,2,50.0%,10m
4761,3,剑指苍天,3321,0,1,4,5,20.0%,22m
4761,3,[Melt病毒]必死无疑九条喵,3321,0,0,1,1,0.0%,2m
4761,3,染陌憂,3321,0,0,3,3,0.0%,16m
4777,3,[钻石守门员]SHIROHA,3320,1589,139,100,239,58.2%,8m
4777,3,相信自己,3320,1206,82,80,162,50.6%,13m
4777,3,[艾尔之巅]唐糖塘溏瑭,3320,588,29,13,42,69.0%,18m
4777,3,曾某人,3320,384,17,14,31,54.8%,30m
4777,2,BravoSix,3320,152,4,2,6,66.7%,12m
4777,3,[USNavy]Enterprise,3320,116,4,3,7,57.1%,55m
4777,3,[AIAI]Atom,3320,58,3,0,3,100.0%,49m
4777,3,就这么爱着我的宁,3320,60,3,1,4,75.0%,56m
4777,3,[怀念曾经温柔]Neuer,3320,0,1,0,1,100.0%,4m
4786,3,[我们是无敌的]PREDATOR,3319,650,24,20,44,54.5%,7m
4786,3,TmTdog,3319,274,14,5,19,73.7%,11m
4786,3,克鲁斯约翰,3319,360,13,4,17,76.5%,7m
4786,3,月下彼岸花,3319,282,10,13,23,43.5%,53m
4786,3,狗逼死全家,3319,245,8,11,19,42.1%,28m
4786,1,lllllllll,3319,204,4,1,5,80.0%,21m
4786,3,[PITB]珞珈山炮王,3319,30,2,4,6,33.3%,12m
4786,3,Moster,3319,30,1,2,3,33.3%,25m
4786,3,[社交学超可爱]神一般的菜鸟,3319,0,0,1,1,0.0%,3m
4786,3,五更琉璃,3319,0,0,1,1,0.0%,18m
4796,3,南山亦谷,3318,252,11,15,26,42.3%,56m
4796,2,宇文逸豆归,3318,214,9,5,14,64.3%,23m
4796,3,火之晨曦,3318,142,5,3,8,62.5%,28m
4796,1,不倒翁,3318,184,4,5,9,44.4%,19m
4796,3,Nemo,3318,58,2,3,5,40.0%,55m
4796,3,[汉堡FANS]也许我是臭八八,3318,0,0,1,1,0.0%,12m
4796,3,[VirGo]Shaco,3318,0,0,4,4,0.0%,20m
4803,2,LAIN,3317,1428,188,190,378,49.7%,10m
4803,2,[萌新酒吧]小雇佣兵,3317,733,30,28,58,51.7%,29m
4803,3,魍魉,3317,530,20,23,43,46.5%,53m
4803,3,XiaoXianJ,3317,361,14,8,22,63.6%,26m
4803,3,Critical,3317,168,7,3,10,70.0%,14m
4803,3,[Mousse]Tiramisu,3317,58,3,2,5,60.0%,4m
4803,3,[鸡饲料加工厂]购买后,3317,0,1,0,1,100.0%,55m
4810,3,[AICa]PZdog,3316,1094,43,35,78,55.1%,52m
4810,3,[社交学大可爱]Kikuru,3316,452,19,12,31,61.3%,51m
4810,3,[gusl]星灵米图,3316,133,17,15,32,53.1%,14m
4810,3,刺客之心,3316,372,16,14,30,53.3%,13m
4810,3,mercy,3316,90,4,7,11,36.4%,10m
4810,3,[反叛的鲁路修]Sakuya,3316,58,3,1,4,75.0%,22m
4810,2,zongjingbo,3316,44,3,6,9,33.3%,6m
4810,3,裙下之臣,3316,0,1,0,1,100.0%,2m
4810,3,[Whitey]SWeWeTheart,3316,0,0,2,2,0.0%,17m
4819,3,佳佳的牛,3315,1603,145,125,270,53.7%,28m
4819,3,keviiiin,3315,878,40,28,68,58.8%,8m
4819,3,wannnnn,3315,563,24,17,41,58.5%,28m
4819,2,花火,3315,486,18,28,46,39.1%,25m
4819,2,南极企鹅,3315,207,10,3,13,76.9%,26m
4819,1,[獬豸]Assassin,3315,162,9,3,12,75.0%,6m
4819,3,Occupy,3315,148,7,10,17,41.2%,55m
4819,3,[就凭你这赘婿]沉默寡言幻想鹏,3315,181,6,2,8,75.0%,53m
4819,3,一拳超人,3315,120,4,10,14,28.6%,3m
4819,3,IIIIIIII,3315,0,2,3,5,40.0%,54m
4819,3,超音速法拉利,3315,30,1,1,2,50.0%,53m
4830,3,[Rhusky]root,3314,58,3,0,3,100.0%,26m
4830,2,樱岛麻衣,3314,0,0,1,1,0.0%,3m
4832,3,cainiao,3313,945,77,56,133,57.9%,20m
4832,3,[传说萌娘团]Flood,3313,681,27,20,47,57.4%,14m
4832,3,秋风萧瑟,3313,275,24,26,50,48.0%,6m
4832,3,艾尔青锋所向无前,3313,354,22,19,41,53.7%,21m
4832,3,[UDI]NoteamSOS,3313,262,10,6,16,62.5%,29m
4832,3,向阳道与莲儿,3313,225,8,2,10,80.0%,4m
4832,3,[贰0]oops,3313,118,5,3,8,62.5%,49m
4832,3,[佐伯湾总督府]桐谷演人,3313,140,4,0,4,100.0%,4m
4832,3,AlexLee,3313,0,1,0,1,100.0%,50m
4841,2,前排前排起,3312,1553,257,239,496,51.8%,3m
4841,2,小祖宗,3312,1302,73,83,156,46.8%,14m
4841,3,你的小熊走丢了,3312,986,69,51,120,57.5%,25m
4841,3,[星歌]ArthasMeneth,3312,963,59,52,111,53.2%,14m
4841,3,das,3312,1106,47,31,78,60.3%,49m
4841,3,[111gfg]IIIIIIIIIIII,3312,1036,38,42,80,47.5%,28m
4841,3,[手残眼瞎瘾大]白门楼破产律师,3312,260,10,11,21,47.6%,6m
4841,3,咪咕猫,3312,260,10,12,22,45.5%,52m
4841,3,[永远的艾尔]小艾才不是傲娇,3312,58,3,0,3,100.0%,2m
4841,3,情燃心殇,3312,58,2,4,6,33.3%,10m
4851,2,[今天超市打折]ALOOP,3311,959,152,128,280,54.3%,20m
4851,2,Sunnyboy,3311,1333,90,90,180,50.0%,10m
4851,3,永诀,3311,772,31,27,58,53.4%,53m
4851,3,[RNavy]Belfast,3311,205,11,4,15,73.3%,24m
4851,2,[AOSmt]Feeling,3311,184,8,3,11,72.7%,11m
4851,3,[EtdNew]赢了都靠运气好,3311,204,7,7,14,50.0%,21m
4851,3,[骑B团]上将军,3311,0,5,1,6,83.3%,28m
4851,2,[Echoes]凉宫春日的消失,3311,180,5,4,9,55.6%,10m
4851,1,条码人,3311,96,2,1,3,66.7%,20m
4851,3,小福报,3311,60,2,2,4,50.0%,11m
4851,3,[乖乖u]SkyLinE,3311,58,2,3,5,40.0%,8m
4851,1,[105远征师]属性之主,3311,0,1,0,1,100.0%,27m
4851,3,许圆圆圆圆,3311,0,1,1,2,50.0%,9m
4864,3,资深男酮,3310,1527,77,69,146,52.7%,53m
4864,3,ayanami,3310,586,32,23,55,58.2%,56m
4864,3,[TPoA]laplace,3310,631,24,20,44,54.5%,10m
4864,3,[火焰雷兽]yeedshower,3310,113,14,17,31,45.2%,22m
4864,2,[妹妹也挺好]AIR,3310,258,12,3,15,80.0%,3m
4864,2,肖邦,3310,151,6,14,20,30.0%,14m
4864,3,CrazyStar,3310,172,5,5,10,50.0%,28m
4864,3,SmallSnow,3310,0,1,0,1,100.0%,55m
4864,3,EVEN,3310,0,1,1,2,50.0%,6m
4864,3,Guu,3310,0,0,1,1,0.0%,6m
4864,2,[Killyo]刹那彷徨,3310,0,0,1,1,0.0%,13m
4864,1,烛光,3310,0,0,1,1,0.0%,57m
4876,2,异虫是食物,3309,1636,766,721,1487,51.5%,23m
4876,3,寒梅傲雪,3309,664,58,57,115,50.4%,11m
4876,3,[菜有菜的道理]油漆加糖,3309,789,36,14,50,72.0%,3m
4876,3,纯洁的一血,3309,799,34,26,60,56.7%,26m
4876,3,[1VA]吃你家小笼包了吗,3309,134,4,0,4,100.0%,3m
4876,1,[YKSN]回忆很轻,3309,0,4,1,5,80.0%,1h
4876,3,[夙樱夜雨]落樱,3309,30,1,1,2,50.0%,6m
4883,2,speqe,3308,1490,183,162,345,53.0%,25m
4883,3,巴黎上空的猪,3308,1025,131,136,267,49.1%,13m
4883,3,[旺旺战士]dzz,3308,878,39,20,59,66.1%,24m
4883,3,IIIIII,3308,49,5,8,13,38.5%,14m
4883,3,[雾雨魔法森林]射命丸丶文,3308,114,4,1,5,80.0%,52m
4883,3,NKcyAN,3308,97,3,4,7,42.9%,9m
4883,3,[白银联盟]Zeratul,3308,30,2,0,2,100.0%,52m
4883,3,克里斯蒂娜,3308,30,2,1,3,66.7%,10m
4883,3,[衡水中学]IIIIIIIIIII,3308,0,1,0,1,100.0%,25m
4883,3,IIIIIIIIIIII,3308,0,1,0,1,100.0%,25m
4883,3,[暴雪我是你爹]XYfan,3308,0,0,1,1,0.0%,14m
4894,3,平独镇露的波兰球,3307,783,52,42,94,55.3%,10m
4894,3,[学院派神族]腥基小男孩,3307,289,26,31,57,45.6%,25m
4894,2,Aihara,3307,566,20,28,48,41.7%,25m
4894,3,IIIIIIIIIIII,3307,298,19,13,32,59.4%,25m
4894,3,蚊子爱吸血,3307,371,18,6,24,75.0%,9m
4894,2,[白玉楼的幽灵]墨染的吃货,3307,330,12,22,34,35.3%,54m
4894,3,余生以待梦清澄,3307,242,10,6,16,62.5%,14m
4894,1,挚爱,3307,97,5,0,5,100.0%,1h
4894,1,RESTRAIN,3307,97,5,1,6,83.3%,1h
4894,3,[休闲的电脑]电脑,3307,30,2,1,3,66.7%,12m
4904,2,[艾尔之巅]丰城市铁路镇,3306,1271,336,345,681,49.3%,1m
4904,3,[DMRc]浅梦丿漓,3306,1023,45,47,92,48.9%,24m
4904,3,WBWB,3306,556,27,30,57,47.4%,56m
4904,3,你从没见过我,3306,564,22,16,38,57.9%,12m
4904,3,[幽金贮藏堆]二五仔,3306,373,14,8,22,63.6%,23m
4904,3,[刺蛇互助协会]大藏瑠美音,3306,0,0,1,1,0.0%,14m
4904,3,[OsTi]Sasori,3306,0,0,1,1,0.0%,6m
4911,2,毒奶打击就绪,3305,1379,68,59,127,53.5%,25m
4911,3,[明帝国]招荡的黄金剧场,3305,724,50,40,90,55.6%,7m
4911,3,[YA]冰雨,3305,1086,43,37,80,53.8%,53m
4911,3,断水,3305,440,27,14,41,65.9%,53m
4911,3,伏尔加,3305,500,20,13,33,60.6%,8m
4911,3,懒狗,3305,375,16,6,22,72.7%,51m
4911,3,Sky,3305,254,10,5,15,66.7%,28m
4911,3,[DMRc]两个年轻人,3305,30,2,1,3,66.7%,10m
4911,3,无限,3305,60,2,6,8,25.0%,53m
4911,3,[埃蒙调教团]晓风残月陪你走过,3305,0,1,0,1,100.0%,20m
4911,2,Viva,3305,93,1,1,2,50.0%,24m
4922,3,[禁止捕捞]神族就无敌,3304,1013,57,53,110,51.8%,6m
4922,3,LycheeFM,3304,779,41,26,67,61.2%,29m
4922,3,INnoVation,3304,564,36,27,63,57.1%,29m
4922,3,orz,3304,701,28,17,45,62.2%,24m
4922,3,无情,3304,508,20,15,35,57.1%,56m
4922,3,星际联盟,3304,366,14,10,24,58.3%,30m
4922,3,OpzrL,3304,265,9,8,17,52.9%,50m
4922,2,打你屁屁,3304,241,8,4,12,66.7%,9m
4922,3,[Fear]浅唱,3304,170,7,7,14,50.0%,18m
4922,3,猥琐成就超神,3304,58,2,4,6,33.3%,4m
4922,3,[逸仙谐星]我大意了啊没有闪,3304,0,1,0,1,100.0%,54m
4922,1,[MGT谐星会]CPT,3304,0,1,0,1,100.0%,1h
4922,3,[GAGA]magejizerg,3304,0,0,1,1,0.0%,17m
4935,2,好好学,3303,1519,150,150,300,50.0%,20m
4935,3,[IMRTS]傲然诶,3303,1589,73,48,121,60.3%,26m
4935,2,[29CM]光之英雄,3303,1245,67,60,127,52.8%,29m
4935,3,普罗钓丝,3303,744,49,45,94,52.1%,30m
4935,3,[XXRXX]我是中年人,3303,185,41,34,75,54.7%,29m
4935,3,[我丶超勇的]意兴阑珊的滋味鱼,3303,668,31,30,61,50.8%,57m
4935,3,磊哥,3303,377,17,13,30,56.7%,14m
4935,3,Entarotasada,3303,220,8,4,12,66.7%,26m
4935,1,younggzzheng,3303,96,5,1,6,83.3%,57m
4935,3,[火焰贝壳]被虐的靶子,3303,86,4,2,6,66.7%,4m
4935,3,Clear,3303,120,4,4,8,50.0%,18m
4935,3,Avalon,3303,88,3,6,9,33.3%,18m
4935,3,faiz,3303,97,2,0,2,100.0%,11m
4935,3,phDzealot,3303,0,1,0,1,100.0%,53m
4935,1,砖家叫兽,3303,0,1,4,5,20.0%,1h
4935,3,烟雨,3303,0,0,2,2,0.0%,51m
4951,3,铁甲西奇,3302,1574,218,197,415,52.5%,10m
4951,3,ink,3302,1308,147,121,268,54.9%,4m
4951,3,IIIIIIIIIIII,3302,1181,57,31,88,64.8%,10m
4951,3,[装大佬的鸡]WSPHY,3302,192,8,2,10,80.0%,14m
4951,3,wuhao,3302,0,3,2,5,60.0%,26m
4951,3,goldhero,3302,38,2,0,2,100.0%,15m
4951,3,[苍青色的幻影]湛蓝水晶,3302,30,2,2,4,50.0%,10m
4951,3,yuyu,3302,0,1,0,1,100.0%,14m
4951,1,SakayMuni,3302,0,0,3,3,0.0%,5m
4960,3,浅醉一生,3301,1063,123,109,232,53.0%,29m
4960,2,IIIIIIIIIII,3301,1440,78,93,171,45.6%,22m
4960,3,[XYFANS]沐雨橙风,3301,1475,69,55,124,55.6%,56m
4960,3,Jackson,3301,988,54,45,99,54.5%,2m
4960,3,[Shawk]QCsweet,3301,1201,52,47,99,52.5%,22m
4960,3,[菜有菜的道理]IIIIIIII,3301,180,7,7,14,50.0%,21m
4960,3,Legend,3301,58,2,2,4,50.0%,6m
4960,3,Walker,3301,30,2,5,7,28.6%,24m
4968,3,[Beasty]冷冷的笑,3300,1380,316,299,615,51.4%,56m
4968,2,YukiChan,3300,1565,283,280,563,50.3%,30m
4968,2,loster,3300,874,102,103,205,49.8%,27m
4968,3,[同济大学]unluckyP,3300,1410,57,60,117,48.7%,53m
4968,3,可可里拉,3300,632,24,25,49,49.0%,10m
4968,2,yosang,3300,416,15,29,44,34.1%,22m
4968,2,IIIIIIIIIIII,3300,376,15,31,46,32.6%,18m
4968,3,炭治郎,3300,292,13,11,24,54.2%,3m
4968,3,[RyH魔力鸭]RyHMengMeng,3300,290,11,7,18,61.1%,22m
4968,3,机械化死个吗,3300,170,6,4,10,60.0%,29m
4968,3,[JXSA]mumu,3300,120,5,5,10,50.0%,49m
4968,3,[底特律KAR]绿毛酱,3300,152,5,9,14,35.7%,16m
4968,1,Zeitgeist,3300,0,1,0,1,100.0%,34m
4968,3,[倚栏夜听雨]扶苏,3300,0,1,0,1,100.0%,21m
4968,3,爱滴魔力转圈圈,3300,30,1,1,2,50.0%,11m
4968,3,暖心萌菇凉,3300,0,0,1,1,0.0%,22m
4984,2,阿拉灯,3299,1543,372,377,749,49.7%,18m
4984,3,Walte,3299,1367,80,66,146,54.8%,6m
4984,3,[请先打我隊友]laoshi,3299,1049,71,55,126,56.3%,8m
4984,3,[IGS]弑神之力,3299,640,34,29,63,54.0%,53m
4984,3,Zincye,3299,166,7,4,11,63.6%,53m
4984,3,IIIIIIIIIIII,3299,206,7,6,13,53.8%,11m
4984,3,乾坤无定,3299,172,7,7,14,50.0%,53m
4984,1,miku,3299,0,4,1,5,80.0%,29m
4984,1,命运审判,3299,0,4,1,5,80.0%,24m
4984,3,IIIIIIIIIIII,3299,0,1,0,1,100.0%,9m
4984,2,[MN]Sneaky,3299,92,1,4,5,20.0%,27m
4984,3,陈曦,3299,0,1,4,5,20.0%,4m
4984,3,小红曜石,3299,0,0,1,1,0.0%,4m
4997,3,[妹控万岁]Asura,3298,1536,206,199,405,50.9%,55m
4997,2,zhyf,3298,209,6,2,8,75.0%,13m
4997,3,IIIIIIIIIIII,3298,178,6,8,14,42.9%,12m
4997,3,[北师大二附中]Annihilation,3298,120,5,6,11,45.5%,8m
4997,3,ssssss,3298,97,3,1,4,75.0%,24m
4997,3,[兰均竹空]舔舔舔舔舔大怪兽,3298,60,3,2,5,60.0%,22m
4997,3,[一波]小鸡的勇敢,3298,60,2,5,7,28.6%,28m
4997,1,葬花礼,3298,0,1,0,1,100.0%,1h
4997,3,NTRfirst,3298,30,1,1,2,50.0%,17m
5006,3,誓约胜利,3297,550,61,54,115,53.0%,26m
5006,3,大混子,3297,1004,54,56,110,49.1%,11m
5006,3,[Brave]Rice,3297,216,9,3,12,75.0%,18m
5006,3,[Toss]阿虚,3297,118,2,1,3,66.7%,51m
5006,3,燕南赵北石家庄,3297,0,2,5,7,28.6%,28m
5006,3,been,3297,0,0,1,1,0.0%,21m
5006,3,天地初始,3297,0,0,1,1,0.0%,10m
5006,3,cstar,3297,0,0,1,1,0.0%,3m
5006,3,Suyuan,3297,0,0,2,2,0.0%,28m
5015,3,枫溪风兮,3296,1573,245,233,478,51.3%,10m
5015,3,[工口]Damon,3296,643,71,54,125,56.8%,10m
5015,3,[星歌]喜欢幽幽子的迪奥,3296,1534,62,52,114,54.4%,21m
5015,3,[HFUOT]色格脖,3296,656,29,12,41,70.7%,29m
5015,3,瑞克的莫蒂,3296,458,16,19,35,45.7%,3m
5015,3,[KSARsn]拿着步枪的隐刀,3296,308,11,11,22,50.0%,12m
5015,3,IIIIIIIIIIII,3296,122,10,12,22,45.5%,14m
5015,3,[萌萌拳]魔刹,3296,120,6,2,8,75.0%,24m
5015,3,[天地會总舵]陈近南,3296,57,3,4,7,42.9%,4m
5015,3,[小老虎吃雪糕]路西,3296,0,1,0,1,100.0%,10m
5015,3,[送分大佬]源千鹤,3296,0,1,2,3,33.3%,28m
5015,3,千年喵,3296,0,0,1,1,0.0%,53m
5027,2,[南京理工大]honest,3295,1339,80,75,155,51.6%,26m
5027,3,[Csquad]Ushin,3295,800,32,27,59,54.2%,12m
5027,3,BurnInHell,3295,657,25,19,44,56.8%,2m
5027,3,[血港魅影]糖心,3295,381,14,6,20,70.0%,19m
5027,3,酷酷,3295,390,14,20,34,41.2%,2m
5027,1,Daydreamer,3295,0,5,0,5,100.0%,40m
5027,3,llllllllllll,3295,0,1,0,1,100.0%,28m
5027,2,artificial,3295,44,1,3,4,25.0%,28m
5027,3,[打星际快乐么]LiArRn,3295,0,0,1,1,0.0%,5m
5036,3,RainyStars,3294,1636,116,95,211,55.0%,3m
5036,3,PDIAAJ,3294,863,45,32,77,58.4%,24m
5036,3,[华文中学]ASDUH,3294,595,35,17,52,67.3%,22m
5036,3,[新手保护协会]余生阿迎,3294,417,18,5,23,78.3%,11m
5036,1,墨迹,3294,150,5,2,7,71.4%,15m
5036,3,文明上下车,3294,0,1,0,1,100.0%,14m
5036,3,[AstoIF]Diamond,3294,0,1,0,1,100.0%,12m
5036,3,HardWalnut,3294,0,1,0,1,100.0%,22m
5036,3,[西伯利亚土豆]Probe,3294,0,0,1,1,0.0%,7m
5036,1,附属白给反应堆,3294,0,0,1,1,0.0%,22m
5036,3,神族,3294,0,0,2,2,0.0%,54m
5047,3,[浪啊浪]PAIPAIYUE,3293,1491,155,140,295,52.5%,20m
5047,3,cool,3293,619,131,118,249,52.6%,13m
5047,2,[刑事组之虎]aoao,3293,1039,47,58,105,44.8%,50m
5047,3,翰墨琉璃,3293,347,23,14,37,62.2%,13m
5047,3,怕死的毒爆,3293,286,15,11,26,57.7%,24m
5047,3,qfdwerhbegf,3293,148,8,7,15,53.3%,52m
5047,3,[91大神]港城梦郎,3293,138,6,7,13,46.2%,2m
5047,3,就爱蛋炒饭,3293,0,1,0,1,100.0%,6m
5047,1,[瘟疫来自肉食]星海小萌,3293,0,1,0,1,100.0%,1h
5047,1,呕奶,3293,0,1,8,9,11.1%,54m
5057,3,[31CM]MasterDA,3292,840,36,21,57,63.2%,20m
5057,3,IIIIIIIIIIII,3292,318,10,7,17,58.8%,9m
5057,3,[怀念曾经温柔]WADU,3292,148,10,8,18,55.6%,25m
5057,3,透里妈批,3292,194,8,7,15,53.3%,4m
5057,3,快递难找,3292,150,5,7,12,41.7%,21m
5057,3,[NUAA]牛川枫,3292,92,4,7,11,36.4%,9m
5057,2,滚滚红尘深似海,3292,116,3,2,5,60.0%,26m
5057,3,SCARE,3292,0,1,0,1,100.0%,24m
5065,2,[SC2近卫军]lllllllllll,3291,1532,346,330,676,51.2%,14m
5065,3,[魔法少女小屋]LonelinesS,3291,1547,120,114,234,51.3%,24m
5065,3,[LOHv]海洋,3291,1333,57,41,98,58.2%,56m
5065,3,Leon,3291,631,41,33,74,55.4%,14m
5065,2,[虚拟歌手团体]钻石鸡苦练运营,3291,568,38,39,77,49.4%,29m
5065,3,larryberry,3291,336,14,9,23,60.9%,49m
5065,3,避雷针,3291,357,12,17,29,41.4%,14m
5065,3,[秋毫第七分队]puck,3291,228,9,13,22,40.9%,5m
5065,3,[菲雅利]风中风铃,3291,148,5,5,10,50.0%,28m
5065,3,AiXiaoKe,3291,30,1,1,2,50.0%,15m
5065,3,黑化麻酱,3291,30,1,1,2,50.0%,2m
5065,3,kiwi,3291,0,0,2,2,0.0%,3m
5065,3,[人人有功炼]我无欲无求,3291,0,0,3,3,0.0%,50m
5078,3,Ian,3290,413,108,100,208,51.9%,23m
5078,3,夏天协奏曲,3290,1577,81,68,149,54.4%,49m
5078,2,DarkRanger,3290,1295,61,49,110,55.5%,54m
5078,3,[秋毫]年轻人不讲武德,3290,929,47,46,93,50.5%,14m
5078,3,IIIIIIII,3290,686,26,21,47,55.3%,21m
5078,3,[SoloAs]白泽,3290,338,13,8,21,61.9%,57m
5078,3,两船兵,3290,342,13,10,23,56.5%,12m
5078,3,苍阳,3290,326,12,7,19,63.2%,6m
5078,3,[新鲜菜鸡]Adversities,3290,231,8,14,22,36.4%,7m
5078,3,[全是谐星]英俊的圆头,3290,166,7,2,9,77.8%,21m
5078,3,[萌新爱萌]zyhgmy,3290,98,6,1,7,85.7%,4m
5078,2,[DDOS大厅]黄旭东,3290,176,5,4,9,55.6%,20m
5078,3,[傻爆无敌]傻爆追猎,3290,116,4,4,8,50.0%,26m
5078,3,[Shawk]几度晚,3290,30,1,3,4,25.0%,24m
5078,3,旋风剑豪泽拉图,3290,0,0,1,1,0.0%,7m
5093,3,IlIlIIIlllII,3289,1555,215,199,414,51.9%,26m
5093,3,忘了,3289,875,43,16,59,72.9%,3m
5093,3,IIIIIIIIIIII,3289,262,17,17,34,50.0%,26m
5093,2,[专业抓G贼]进入黑店,3289,456,15,28,43,34.9%,7m
5093,3,[最菜战队]十二地死妈死全家,3289,330,12,11,23,52.2%,8m
5093,2,随心所欲流,3289,285,11,5,16,68.8%,24m
5093,2,傻傻呆呆,3289,201,10,6,16,62.5%,8m
5093,3,只出凤凰是傻,3289,77,4,2,6,66.7%,28m
5093,3,IIIIIIIIIIII,3289,58,3,0,3,100.0%,11m
5093,3,[Mentor]CJHAAAAAA,3289,30,2,2,4,50.0%,11m
5093,3,[鹌鹑带星]雪皇墨笙白神泽,3289,0,1,0,1,100.0%,19m
5093,3,星海巡航,3289,0,1,2,3,33.3%,23m
5093,3,[六味地黄丸]huodaoshi,3289,0,0,2,2,0.0%,18m
5093,3,[除非花手要过]sunxi,3289,0,0,2,2,0.0%,49m
5107,3,[憨憨成群]翔中翔,3288,1099,72,71,143,50.3%,18m
5107,3,国服工蜂,3288,986,61,40,101,60.4%,28m
5107,3,唐毅萌萌哒喲,3288,1062,43,44,87,49.4%,28m
5107,3,[Beasty]掠天,3288,361,18,14,32,56.2%,56m
5107,3,[夙愿东流]Far,3288,416,16,10,26,61.5%,54m
5107,1,忘川,3288,238,13,5,18,72.2%,15m
5107,2,整瑜,3288,205,10,3,13,76.9%,10m
5107,1,[呆萌呆萌]真理之刃,3288,48,4,2,6,66.7%,1h
5107,3,[Nostop]NewbeeStaR,3288,0,1,0,1,100.0%,16m
5107,3,ImmoRtaL,3288,0,1,1,2,50.0%,55m
5107,3,[内蒙星际联盟]稚嫩的二五仔,3288,30,1,5,6,16.7%,24m
5118,3,沉睡的雄狮,3287,1304,164,156,320,51.2%,22m
5118,3,[Vv]鬼鬼,3287,278,32,32,64,50.0%,13m
5118,3,[佩佩FANS]Sholva,3287,374,14,3,17,82.4%,17m
5118,3,[CPT]kindles,3287,382,14,11,25,56.0%,8m
5118,3,[肉鸡的饲养]魔法少女鸭鸭酱,3287,0,4,1,5,80.0%,55m
5118,2,XXXXXXX,3287,88,3,13,16,18.8%,7m
5118,1,IIIIIIIIII,3287,0,2,3,5,40.0%,1h
5118,3,[X英雄圣域X]新手,3287,0,0,3,3,0.0%,26m
5126,2,[亀山社中]缺舟一帆渡,3286,1500,256,240,496,51.6%,3m
5126,3,[QwQYo]IDMissing,3286,228,8,7,15,53.3%,14m
5126,3,云中不知雀,3286,119,6,2,8,75.0%,5m
5126,1,橘子,3286,48,5,2,7,71.4%,34m
5126,1,胖子熊,3286,94,2,1,3,66.7%,29m
5126,3,[XJTU]风檐展书读,3286,0,1,0,1,100.0%,15m
5132,3,雨中黄叶,3285,1596,348,341,689,50.5%,56m
5132,3,曾经小坑刘冬雨,3285,1528,90,73,163,55.2%,28m
5132,3,雾神丶,3285,1330,63,46,109,57.8%,18m
5132,2,虫群暴君,3285,1242,49,46,95,51.6%,7m
5132,2,[多线空投]我只想好好运营,3285,704,26,34,60,43.3%,14m
5132,1,主人,3285,96,5,1,6,83.3%,45m
5132,3,[我星际]少帮主,3285,119,4,2,6,66.7%,28m
5132,3,吸溜吸溜吸溜,3285,97,3,4,7,42.9%,24m
5132,3,[EHClub]GalaxyDust,3285,30,2,0,2,100.0%,26m
5132,3,[丿Es灬回忆]周大侠,3285,0,1,0,1,100.0%,51m
5132,3,TCDD,3285,0,1,0,1,100.0%,7m
5132,3,Yangnannan,3285,0,0,1,1,0.0%,11m
5132,3,梭默,3285,0,0,1,1,0.0%,29m
5145,3,[是我赢了]loschristmas,3284,1600,222,214,436,50.9%,30m
5145,3,Alarak,3284,192,8,4,12,66.7%,6m
5145,3,威灵顿,3284,86,4,1,5,80.0%,26m
5145,3,[YA]当铺里的狐狸君,3284,86,4,3,7,57.1%,56m
5145,3,[lmpala]EinXh,3284,90,3,6,9,33.3%,6m
5145,3,[不知]scarLett,3284,120,2,1,3,66.7%,1m
5145,3,[暴雪三十队]新手灬别打脸,3284,60,2,5,7,28.6%,20m
5145,3,[宇宙职业战队]Maru,3284,62,2,8,10,20.0%,14m
5145,3,[虚拟歌手团体]Misaka,3284,0,0,1,1,0.0%,19m
5154,2,[初号機]现实花园在劈杈,3283,1453,224,214,438,51.1%,25m
5154,3,[斯巴达血战团]涂山雪雪,3283,1574,140,140,280,50.0%,18m
5154,3,啊豆,3283,639,52,37,89,58.4%,16m
5154,3,llllllllllll,3283,790,28,33,61,45.9%,28m
5154,3,[中老年车队]人之剑仙,3283,666,26,20,46,56.5%,57m
5154,3,skyaway,3283,377,20,15,35,57.1%,14m
5154,3,[天依我女神]北森铃鹿,3283,356,16,9,25,64.0%,20m
5154,3,Zoe,3283,270,11,5,16,68.8%,49m
5154,3,天河望舒,3283,192,8,3,11,72.7%,26m
5154,1,Dinakia,3283,0,4,1,5,80.0%,1h
5154,3,[格里芬克鲁格]TosakaUCW,3283,0,1,0,1,100.0%,23m
5154,3,[台州温岭]Adolph,3283,0,0,1,1,0.0%,24m
5166,3,Kella,3282,1220,53,47,100,53.0%,5m
5166,2,TanyQwQ,3282,1074,45,37,82,54.9%,7m
5166,3,[扫黄]Puzzle,3282,338,12,12,24,50.0%,10m
5166,3,统一,3282,256,9,11,20,45.0%,49m
5166,3,[Rp1st]Vinson,3282,244,8,5,13,61.5%,55m
5166,3,[百宝箱]星月凛,3282,116,4,2,6,66.7%,10m
5166,3,星河之翼,3282,58,3,1,4,75.0%,22m
5166,3,[普残l攻略组]星辉,3282,0,0,1,1,0.0%,51m
5174,2,猛地一逼,3281,616,153,170,323,47.4%,9m
5174,2,大伟,3281,1399,109,119,228,47.8%,23m
5174,3,Guikarist,3281,806,35,17,52,67.3%,7m
5174,1,阿肥,3281,144,3,0,3,100.0%,13m
5174,3,[有为青年]十六夜咲夜,3281,58,3,1,4,75.0%,29m
5174,3,Samael,3281,90,3,5,8,37.5%,28m
5174,3,Sftx,3281,0,1,0,1,100.0%,22m
5174,3,[武大萌新]shisizhong,3281,0,0,1,1,0.0%,21m
5182,2,逐风而行,3280,1500,88,83,171,51.5%,25m
5182,3,陛下何故谋反,3280,1040,73,67,140,52.1%,18m
5182,3,[QFT]ghcrow,3280,691,46,45,91,50.5%,13m
5182,3,ARBAlex,3280,414,16,12,28,57.1%,12m
5182,3,孤寂的寒星,3280,392,14,18,32,43.8%,25m
5182,2,[最菜神王]云梦白四酒,3280,271,11,7,18,61.1%,6m
5182,3,段段段段段丶,3280,244,9,3,12,75.0%,8m
5182,3,[艾尔之巅]仙师二口合,3280,190,8,6,14,57.1%,2m
5182,2,稳当轩昂,3280,222,7,3,10,70.0%,51m
5182,3,SKTone,3280,114,4,1,5,80.0%,53m
5182,3,yajrdu,3280,30,2,0,2,100.0%,7m
5182,3,Win,3280,97,2,3,5,40.0%,49m
5182,3,[女人影响剑速]帅比,3280,0,1,0,1,100.0%,22m
5182,3,wei,3280,0,0,1,1,0.0%,56m
5182,3,[SK]RERzeng,3280,0,0,3,3,0.0%,7m
5182,3,[不打内战]Qsn,3280,0,0,6,6,0.0%,24m
5198,3,[输本保护协会]有节操啊有节操,3279,517,31,28,59,52.5%,29m
5198,3,IIIIIIIIIIII,3279,665,30,12,42,71.4%,12m
5198,3,我是一只小小鸟,3279,486,19,11,30,63.3%,26m
5198,3,[云雾黎明]沁音的手指面包,3279,291,18,9,27,66.7%,12m
5198,1,dawn,3279,256,11,8,19,57.9%,15m
5198,1,战网,3279,0,4,1,5,80.0%,16m
5198,2,ForFun,3279,94,2,4,6,33.3%,13m
5205,2,StoneCold,3278,1066,264,249,513,51.5%,30m
5205,2,喜欢殴打虫族,3278,1546,219,191,410,53.4%,7m
5205,3,[火焰雷兽]阿康,3278,1012,172,161,333,51.7%,22m
5205,3,[脆皮鸡]WDDCXUZ,3278,1541,64,69,133,48.1%,53m
5205,3,梦与樱叶,3278,60,2,5,7,28.6%,9m
5205,3,[舰队已经抵达]一本正经,3278,0,1,0,1,100.0%,11m
5211,2,只會放大招,3277,1486,102,94,196,52.0%,7m
5211,3,coco,3277,919,100,88,188,53.2%,11m
5211,3,ProRandom,3277,146,5,8,13,38.5%,19m
5211,3,[超电磁炉]一羊迁徙,3277,88,3,8,11,27.3%,19m
5211,3,[K39]keep,3277,0,1,0,1,100.0%,54m
5211,3,大喵,3277,0,1,0,1,100.0%,50m
5211,3,INnoVation,3277,30,1,3,4,25.0%,56m
5211,3,Jeffthewit,3277,0,0,1,1,0.0%,15m
5211,2,菜鸡一个,3277,0,0,1,1,0.0%,29m
5220,2,llllllIIllIl,3276,1229,291,312,603,48.3%,55m
5220,3,扮猪吃老虎,3276,553,27,15,42,64.3%,9m
5220,3,Edward,3276,640,25,20,45,55.6%,24m
5220,2,llllllll,3276,442,15,23,38,39.5%,23m
5220,3,IIIIIIIIIIII,3276,242,7,7,14,50.0%,18m
5220,3,[瘾大眼瞎]虾仔,3276,185,6,1,7,85.7%,2m
5220,1,[Zhjtfl]Enernitysky,3276,0,4,1,5,80.0%,32m
5220,3,[幺幺]Lucky,3276,97,2,2,4,50.0%,54m
5220,1,Strik,3276,0,0,1,1,0.0%,29m
5229,2,山水郎,3275,1547,316,309,625,50.6%,12m
5229,2,IIIIIIIIIIII,3275,1458,85,102,187,45.5%,22m
5229,3,熏干酪,3275,1081,61,58,119,51.3%,24m
5229,3,killik,3275,1097,49,31,80,61.2%,21m
5229,1,Nicholas,3275,638,24,50,74,32.4%,1m
5229,3,Light,3275,444,21,17,38,55.3%,14m
5229,3,Plato,3275,283,13,10,23,56.5%,22m
5229,3,[半个大哥]Zerofoll,3275,312,11,13,24,45.8%,12m
5229,3,[s黑色玫瑰s]智障,3275,129,9,8,17,52.9%,26m
5229,2,[Solo]IIIIIIIIIIII,3275,268,9,19,28,32.1%,23m
5229,3,[A丶rash]CTRahmRemm,3275,172,7,5,12,58.3%,21m
5229,3,[龙中地表最强]SecretBase,3275,114,4,3,7,57.1%,56m
5229,3,[四叶草]焰野辞旧,3275,30,2,4,6,33.3%,4m
5229,3,[孙一喵]oldblack,3275,30,2,4,6,33.3%,22m
5229,3,[快乐谐星]哆啦哆一嗦,3275,60,2,6,8,25.0%,55m
5229,3,IIIIIIIIIIII,3275,0,1,0,1,100.0%,10m
5229,3,[星际同萌]和平还是核平,3275,0,0,1,1,0.0%,12m
5246,3,[YA]一个渣渣,3274,1549,173,161,334,51.8%,10m
5246,3,[ATKs]IIIIIIIIIIII,3274,1126,106,70,176,60.2%,28m
5246,3,fuy,3274,411,45,34,79,57.0%,57m
5246,3,条码仁,3274,278,14,11,25,56.0%,13m
5246,3,SBZR,3274,196,8,6,14,57.1%,55m
5246,3,小和的狐狸,3274,168,6,5,11,54.5%,56m
5246,3,tristana,3274,114,5,0,5,100.0%,28m
5246,1,[不碎之灵]所有万千世界之力,3274,0,4,1,5,80.0%,1h
5246,3,Nestle,3274,0,1,1,2,50.0%,13m
5246,3,[吾皇大赦天下]MrCharles,3274,0,0,1,1,0.0%,10m
5256,3,腌辣椒,3273,1660,306,278,584,52.4%,23m
5256,3,酱油,3273,324,12,11,23,52.2%,2m
5256,2,炉石东哥,3273,38,6,3,9,66.7%,9m
5256,3,[老乱]衣小宽,3273,0,1,0,1,100.0%,20m
5256,3,mnkk,3273,0,1,0,1,100.0%,20m
5256,3,挥别笑留名,3273,30,1,1,2,50.0%,14m
5262,2,秋风瑟瑟,3272,1534,225,223,448,50.2%,14m
5262,2,bbbyong,3272,446,62,89,151,41.1%,11m
5262,3,两只老虎,3272,650,24,25,49,49.0%,6m
5262,3,白毛浮绿水,3272,342,15,12,27,55.6%,3m
5262,3,yazeroO,3272,370,13,11,24,54.2%,57m
5262,3,[魔虫教主万岁]saas,3272,174,7,3,10,70.0%,50m
5262,3,TheSense,3272,58,5,4,9,55.6%,3m
5262,3,神秘的车头,3272,30,2,0,2,100.0%,27m
5262,3,[TSOD]ToBeYYG,3272,30,2,1,3,66.7%,56m
5262,3,令人发笑的电脑,3272,30,2,2,4,50.0%,11m
5262,3,[灵兮]霜兮,3272,58,2,6,8,25.0%,52m
5262,3,[BTD]DeathMarshal,3272,0,1,0,1,100.0%,53m
5262,3,MagicZerg,3272,30,1,2,3,33.3%,4m
5262,3,Darknesscome,3272,0,0,5,5,0.0%,23m
5276,3,[歌者李仙姬]杀不完的机枪兵,3271,494,62,54,116,53.4%,24m
5276,3,[Borne]IIIIIIIIIIII,3271,949,39,36,75,52.0%,14m
5276,3,Dancer,3271,302,11,8,19,57.9%,7m
5276,1,玩别卡,3271,142,6,2,8,75.0%,15m
5276,3,或许你便是眼中人,3271,140,5,2,7,71.4%,29m
5276,1,llllllllllll,3271,158,4,4,8,50.0%,21m
5276,3,[霸气军团]David,3271,30,2,1,3,66.7%,52m
5276,1,Ylllllllllll,3271,0,2,1,3,66.7%,1h
5284,2,LoveGodZ,3270,1463,225,226,451,49.9%,55m
5284,3,在遇见你一次也好,3270,1206,62,19,81,76.5%,11m
5284,2,可爱小乖乖,3270,1334,48,62,110,43.6%,3m
5284,3,ZeroLinR,3270,656,32,32,64,50.0%,10m
5284,1,Carly,3270,284,12,9,21,57.1%,8m
5284,3,Darin,3270,210,7,12,19,36.8%,22m
5284,1,[清影无敌]不就是钱么,3270,0,4,1,5,80.0%,15m
5284,3,[ETG]SmileY,3270,114,4,6,10,40.0%,15m
5284,3,可以吗,3270,58,3,5,8,37.5%,3m
5284,3,[辩证法]徐政委遛弯,3270,86,3,7,10,30.0%,12m
5284,3,[TG1]ddzforever,3270,49,2,1,3,66.7%,30m
5284,3,[Icer]IIIIIIIIIIII,3270,0,1,0,1,100.0%,15m
5284,1,[WFFF]张学友,3270,94,1,1,2,50.0%,54m
5297,2,夜幕肆虐,3269,300,48,52,100,48.0%,56m
5297,3,TaeYeoN,3269,909,47,37,84,56.0%,14m
5297,3,[莫扎特]茜茜公主,3269,419,15,11,26,57.7%,28m
5297,3,slimeSB,3269,369,14,15,29,48.3%,15m
5297,3,李十七,3269,173,8,6,14,57.1%,25m
5297,3,Ring,3269,166,7,0,7,100.0%,56m
5297,3,BBLLLLC,3269,122,5,4,9,55.6%,28m
5297,3,老程,3269,58,3,0,3,100.0%,54m
5297,3,wangbababa,3269,97,2,1,3,66.7%,11m
5297,3,IIIIIIIIIIII,3269,0,1,0,1,100.0%,6m
5297,2,露娜,3269,91,1,2,3,33.3%,50m
5297,3,Light,3269,30,1,3,4,25.0%,22m
5297,1,[TPoR]dsy,3269,0,0,5,5,0.0%,22m
5310,3,花前月下暂相逢,3268,895,451,422,873,51.7%,13m
5310,2,Dark,3268,982,50,38,88,56.8%,14m
5310,3,[小小怪怪]夜月,3268,424,15,20,35,42.9%,21m
5310,3,周大胆,3268,142,5,5,10,50.0%,6m
5310,3,永远爱潇潇,3268,114,4,3,7,57.1%,11m
5310,1,[DPGsc2]IAsonu,3268,115,2,4,6,33.3%,6m
5310,3,[AX]大秦帝国,3268,30,1,2,3,33.3%,28m
5317,3,[GGES]REIKSGUARD,3267,910,37,31,68,54.4%,19m
5317,3,弗拉基米尔,3267,350,18,13,31,58.1%,19m
5317,3,[五十块的兄弟]skythrough,3267,264,10,8,18,55.6%,56m
5317,3,啦啦啦德玛西亚,3267,143,7,3,10,70.0%,2m
5317,2,invorker,3267,154,5,2,7,71.4%,18m
5317,3,[湖南工大]我是小白,3267,58,3,3,6,50.0%,52m
5317,3,[水晶的眼泪]练家子,3267,58,2,1,3,66.7%,14m
5317,3,慕晨,3267,30,1,1,2,50.0%,28m
5317,3,鬼奉孝,3267,30,1,2,3,33.3%,53m
5317,3,WDLN,3267,0,1,3,4,25.0%,2m
5317,3,king,3267,30,1,5,6,16.7%,3m
5317,3,Amaranth,3267,0,0,1,1,0.0%,13m
5317,3,天梯马保国,3267,0,0,4,4,0.0%,28m
5330,3,[六字母连体人]三酱,3266,1156,83,71,154,53.9%,8m
5330,3,[24K纯萌]龙龙,3266,406,48,40,88,54.5%,57m
5330,3,小萝莉没有熊,3266,295,12,2,14,85.7%,52m
5330,3,[通灵女孩]勇敢的狗子,3266,220,9,4,13,69.2%,53m
5330,3,IIIIIIII,3266,228,9,6,15,60.0%,25m
5330,3,[毒雨]自然选择号,3266,92,3,4,7,42.9%,50m
5330,3,[饭太稀]娜迦之泪,3266,0,1,0,1,100.0%,23m
5330,3,[四叶草]幻想天生,3266,0,1,0,1,100.0%,6m
5330,3,[送分大队]非坑才怪,3266,0,1,4,5,20.0%,3m
5339,3,[吞吞]我不是,3265,316,68,59,127,53.5%,11m
5339,2,半岛的风,3265,792,58,59,117,49.6%,25m
5339,1,姑苏流萤,3265,0,4,1,5,80.0%,1h
5339,3,Sageras,3265,86,3,1,4,75.0%,56m
5339,2,qwmunyvr,3265,143,3,4,7,42.9%,54m
5339,3,[吾王世界第一]Altria,3265,60,2,5,7,28.6%,53m
5339,3,太上忘情豆,3265,0,0,1,1,0.0%,27m
5346,3,[在下菜鸡一只]蔚蓝天际,3264,1396,126,115,241,52.3%,14m
5346,3,[香蕉舟]Benana,3264,756,61,46,107,57.0%,6m
5346,3,comeX,3264,426,17,17,34,50.0%,56m
5346,3,[南京工业大学]Laplace,3264,380,16,10,26,61.5%,52m
5346,3,[TBE]飘源,3264,278,11,9,20,55.0%,24m
5346,3,coldzer,3264,68,6,4,10,60.0%,51m
5346,1,御剑仙,3264,97,3,3,6,50.0%,1h
5346,3,zhz,3264,30,2,5,7,28.6%,55m
5346,3,koishi,3264,30,1,10,11,9.1%,12m
5346,3,[ForStk]未妨清狂,3264,0,0,1,1,0.0%,4m
5346,3,[守护香港]boyniu,3264,0,0,1,1,0.0%,26m
5357,2,SwankyGuy,3263,1523,305,290,595,51.3%,9m
5357,3,[小金上天队]比利,3263,1383,104,84,188,55.3%,52m
5357,3,alex,3263,471,28,22,50,56.0%,22m
5357,3,darrick,3263,454,18,9,27,66.7%,13m
5357,3,皮皮猪,3263,90,4,2,6,66.7%,17m
5357,3,[剑b狗逼t]llllllllllll,3263,30,1,1,2,50.0%,56m
5357,3,用八倍镜看你叮叮,3263,30,1,5,6,16.7%,56m
5364,3,[HZAU]LZR,3262,1580,148,116,264,56.1%,20m
5364,3,Chandler,3262,1446,56,56,112,50.0%,29m
5364,3,[東方心念語]快速度,3262,567,23,16,39,59.0%,15m
5364,3,[方阵塔防标准]默默家的卡卡,3262,470,18,15,33,54.5%,25m
5364,1,liuJ,3262,96,6,0,6,100.0%,1h
5364,3,[教主别动队]锦绣柒阅,3262,168,6,3,9,66.7%,15m
5364,3,[白杨骚啊]Accelerator,3262,90,3,5,8,37.5%,54m
5364,3,[勤奋勇猛果敢]Joker,3262,0,1,1,2,50.0%,56m
5364,3,[Beasty]逐风,3262,0,0,1,1,0.0%,28m
5364,3,[埃蒙保护局]大地,3262,0,0,1,1,0.0%,6m
5364,3,[中海大]llllllllllll,3262,0,0,1,1,0.0%,15m
5364,3,[NVKR]TED,3262,0,0,2,2,0.0%,8m
5364,3,妥协艺术,3262,0,0,2,2,0.0%,52m
5377,3,leiyifan,3261,592,28,27,55,50.9%,13m
5377,3,[海德单推协会]痴人说梦,3261,488,27,0,27,100.0%,52m
5377,3,[KPG]没头脑,3261,666,24,31,55,43.6%,53m
5377,3,Biu,3261,86,4,0,4,100.0%,52m
5377,3,奥秘法司马,3261,180,4,5,9,44.4%,4m
5377,3,IIIIIII,3261,30,2,4,6,33.3%,51m
5377,3,[半个菜鸟]Littlebird,3261,0,1,0,1,100.0%,20m
5377,3,[凉凉]Forgotline,3261,0,1,0,1,100.0%,30m
5377,3,[哔哩哔哩乾杯]黑框眼镜渡边曜,3261,0,0,1,1,0.0%,30m
5386,3,[最菜战队]Edward,3260,1327,75,63,138,54.3%,11m
5386,3,[奶嘴司马]IIIIIIIIIIII,3260,336,37,31,68,54.4%,14m
5386,3,从心彗随,3260,188,11,16,27,40.7%,14m
5386,3,Tuteli,3260,192,7,2,9,77.8%,52m
5386,3,恩曲他滨替诺福韦,3260,97,5,2,7,71.4%,13m
5386,3,[Abadon]游侠,3260,60,5,4,9,55.6%,5m
5386,3,[WOSk]小渣渣,3260,58,3,0,3,100.0%,13m
5386,3,一袋米要抗几楼,3260,0,1,0,1,100.0%,53m
5386,1,[达拉姆内务部]giao,3260,0,1,0,1,100.0%,1h
5395,3,icoke,3259,1024,90,68,158,57.0%,4m
5395,3,可哥可妻孙一封,3259,1088,40,43,83,48.2%,8m
5395,3,中二好柃,3259,630,27,23,50,54.0%,18m
5395,3,有梦想的大师兄,3259,585,25,23,48,52.1%,19m
5395,3,Youngmarquis,3259,148,6,4,10,60.0%,12m
5395,2,[艾尔之名]Yolandale,3259,0,5,0,5,100.0%,1h
5395,3,[冰川镜华]狗狗,3259,152,5,12,17,29.4%,51m
5395,2,Practise,3259,0,4,1,5,80.0%,1h
5395,3,[阿莎丽突击队]hjh,3259,30,2,3,5,40.0%,28m
5395,2,[墨影]巨鲨梦,3259,0,1,0,1,100.0%,51m
5395,3,[刺蛇女装协会]IIIIIIIIIIII,3259,0,1,1,2,50.0%,14m
5406,2,lllllll,3258,1512,257,270,527,48.8%,27m
5406,3,sunsun,3258,1015,50,49,99,50.5%,14m
5406,2,[琴筝]星际争霸,3258,667,31,42,73,42.5%,15m
5406,3,鸡贼的王司机,3258,719,29,22,51,56.9%,53m
5406,3,[Beastp]夜听风,3258,650,26,19,45,57.8%,11m
5406,3,[吕布保护集团]杨三岁,3258,316,11,11,22,50.0%,20m
5406,3,[主从是好啊]冈格尼尔,3258,191,5,2,7,71.4%,53m
5406,3,紫风,3258,120,5,4,9,55.6%,29m
5406,1,[逗比神教]逗比,3258,0,1,0,1,100.0%,1h
5406,3,[YM]南风知我意,3258,30,1,1,2,50.0%,3m
5406,3,[专业de团队]群星,3258,0,1,1,2,50.0%,6m
5406,2,我来酱油一把,3258,0,1,1,2,50.0%,1h
5406,3,[神灵飞电]雪儿,3258,0,0,1,1,0.0%,19m
5406,1,太上忘情豆,3258,0,0,1,1,0.0%,1h
5420,3,[小小合作任务]Robert,3257,830,66,54,120,55.0%,56m
5420,3,妖怪,3257,1282,50,53,103,48.5%,4m
5420,3,[双神教小主教]FairyAzis,3257,528,18,18,36,50.0%,10m
5420,3,我要曹哩啊,3257,330,12,6,18,66.7%,23m
5420,1,柚子味长腿仙女,3257,96,5,1,6,83.3%,1h
5420,3,神罗天征,3257,120,5,5,10,50.0%,10m
5420,2,想啥呢大兄弟,3257,0,4,1,5,80.0%,4m
5420,3,Taker,3257,0,3,2,5,60.0%,22m
5420,3,[刺蛇互助协会]WatuZhY,3257,0,1,0,1,100.0%,7m
5420,2,Wslfash,3257,0,1,0,1,100.0%,17m
5420,3,[新手电脑粋]迷亭,3257,0,1,2,3,33.3%,13m
5420,3,大药丸子,3257,30,1,4,5,20.0%,3m
5432,3,IIIIIIIIIII,3256,1653,792,763,1555,50.9%,8m
5432,3,雪梅花,3256,961,58,45,103,56.3%,7m
5432,3,别玩水老王,3256,251,9,11,20,45.0%,28m
5432,3,[北京大学鸡协]搜到你我已经没了,3256,30,2,1,3,66.7%,14m
5432,3,Milayii,3256,0,1,0,1,100.0%,12m
5432,3,盟重,3256,0,1,0,1,100.0%,20m
5432,3,[浙大战队]德玛西亚,3256,0,1,1,2,50.0%,13m
5432,3,分数白给,3256,0,0,1,1,0.0%,11m
5432,3,[去玩儿法T]VagusNerve,3256,0,0,5,5,0.0%,21m
5441,2,尊贵的杜卡迪车主,3255,1613,421,410,831,50.7%,2m
5441,2,pvoid,3255,1523,418,414,832,50.2%,15m
5441,3,[ISMU星际]沉默风暴,3255,320,16,15,31,51.6%,53m
5441,1,sss,3255,96,2,0,2,100.0%,1h
5441,3,[大阪黑门市场]Arcobaleno,3255,58,2,3,5,40.0%,3m
5441,3,July,3255,0,1,0,1,100.0%,8m
5441,1,[倥偬]纯乾三,3255,0,1,0,1,100.0%,6m
5441,3,面包超人,3255,0,0,1,1,0.0%,27m
5449,3,Angelo,3254,1646,209,172,381,54.9%,3m
5449,3,小怪兽其乐无穷,3254,1297,95,82,177,53.7%,9m
5449,3,挚爱愿,3254,1329,58,42,100,58.0%,52m
5449,2,[CHP]Bleach,3254,0,4,1,5,80.0%,1h
5449,3,贝露蒂娜,3254,30,2,0,2,100.0%,18m
5449,3,[荣耀归于我主]皮卡丘弟地皮痒痒,3254,30,2,1,3,66.7%,11m
5449,3,[七咕咕]影月,3254,0,1,0,1,100.0%,53m
5449,3,[三族同萌会]ACG,3254,0,1,0,1,100.0%,22m
5449,3,骨性关节炎,3254,0,1,0,1,100.0%,24m
5449,3,滴嗒嘀嗒,3254,0,1,2,3,33.3%,53m
5449,3,小探鸡,3254,30,1,2,3,33.3%,22m
5460,2,freedomX,3253,1350,94,104,198,47.5%,19m
5460,3,tinyparting,3253,443,35,28,63,55.6%,56m
5460,3,魔想十六夜,3253,481,20,15,35,57.1%,7m
5460,3,打吊针,3253,320,13,8,21,61.9%,22m
5460,1,IIIIIIIIIIII,3253,352,12,11,23,52.2%,15m
5460,3,钵钵鸡,3253,286,12,14,26,46.2%,21m
5460,3,新人混子,3253,252,10,6,16,62.5%,56m
5460,2,[上海海洋大学]夜色影舞,3253,233,9,7,16,56.2%,14m
5460,3,[噶姐美如花]花枝,3253,142,6,4,10,60.0%,17m
5460,3,夜羽酱,3253,160,6,11,17,35.3%,22m
5460,2,DDTABA,3253,0,4,1,5,80.0%,1h
5460,3,[传说萌娘团]herO,3253,0,1,0,1,100.0%,4m
5460,3,小怪兽,3253,30,1,2,3,33.3%,56m
5460,3,[社交学教导]亨利克利格,3253,30,1,3,4,25.0%,21m
5474,3,IIIIIIIII,3252,438,26,25,51,51.0%,22m
5474,2,WindSpeaker,3252,225,10,5,15,66.7%,10m
5474,3,shadow,3252,206,8,7,15,53.3%,54m
5474,3,王长棍,3252,114,5,3,8,62.5%,3m
5474,2,[葛温王下骑士]IntruderLLL,3252,0,4,1,5,80.0%,13m
5474,3,[老油条战队]炒股十年,3252,33,2,4,6,33.3%,15m
5480,3,利剑苍穹,3251,418,16,13,29,55.2%,51m
5480,1,tina,3251,288,11,7,18,61.1%,53m
5482,3,量子丶波函数坍缩,3250,1181,93,74,167,55.7%,7m
5482,3,[兆景埋土大学]Rinne,3250,887,36,26,62,58.1%,16m
5482,3,[半个菜鸟]无畏舰长,3250,388,14,15,29,48.3%,26m
5482,1,KirilQ,3250,163,6,1,7,85.7%,1h
5482,3,[艾尔供电集团]凯莫瑞安的凯子,3250,30,1,1,2,50.0%,29m
5482,3,[洁白之巅]IIIIIIIIIIII,3250,30,1,1,2,50.0%,20m
5482,3,紫夜,3250,30,1,6,7,14.3%,7m
5489,3,[Shawk]反正游戏都凉了,3249,782,36,21,57,63.2%,11m
5489,2,不上宗不改名,3249,404,16,26,42,38.1%,55m
5489,3,可能你不快乐,3249,390,15,7,22,68.2%,25m
5489,3,在线发牌,3249,120,4,7,11,36.4%,21m
5489,3,Reality,3249,94,4,9,13,30.8%,28m
5489,3,浩聚天下,3249,30,1,4,5,20.0%,7m
5489,3,[Givenc]jjdaxian,3249,30,1,6,7,14.3%,10m
5496,3,手速五够快,3248,234,13,8,21,61.9%,15m
5496,3,Fisher,3248,154,7,2,9,77.8%,29m
5496,3,点点,3248,154,7,3,10,70.0%,53m
5496,3,Auir,3248,58,3,0,3,100.0%,16m
5496,3,[KPG2]队长别开枪是我,3248,94,3,14,17,17.6%,49m
5496,3,[无边之空]sdf,3248,30,2,0,2,100.0%,15m
5502,3,[TeamLP]医生姐姐来了,3247,1156,104,81,185,56.2%,53m
5502,3,[胖子触电]LEFTEYE,3247,460,18,15,33,54.5%,6m
5502,3,[就这就这]LimYoona,3247,140,6,3,9,66.7%,28m
5502,1,shaxing,3247,119,5,2,7,71.4%,1h
5502,3,MrLumingfei,3247,114,4,1,5,80.0%,3m
5502,3,baDFruit,3247,120,4,5,9,44.4%,51m
5502,3,[格里芬克鲁格]荒原老铁,3247,58,2,1,3,66.7%,3m
5502,3,[虚拟歌手团体]Misaka,3247,58,2,2,4,50.0%,10m
5502,3,[克哈小狗烧烤]星夜神话,3247,0,1,0,1,100.0%,18m
5502,3,[银河舰队]清风战龙涛,3247,0,1,0,1,100.0%,12m
5502,3,[达拉姆毒爆]圣堂武士立华奏,3247,0,0,1,1,0.0%,7m
5502,3,[白给先生]人无迷途枉流连,3247,0,0,1,1,0.0%,29m
5514,3,[后宫园]异端,3246,758,30,25,55,54.5%,22m
5514,3,雅蠛蝶,3246,238,9,7,16,56.2%,12m
5514,3,[粉红公主]LambRazor,3246,200,8,7,15,53.3%,52m
5514,3,不许黑大主教,3246,0,1,0,1,100.0%,6m
5514,3,[后宫团]雾雨魔理沙,3246,0,0,1,1,0.0%,23m
5514,2,Moon,3246,0,0,1,1,0.0%,11m
5520,3,混元太极爱偷袭,3245,1520,161,160,321,50.2%,18m
5520,3,坐等墙倒清算,3245,1139,91,76,167,54.5%,52m
5520,3,妈咪妈咪哄,3245,1213,54,40,94,57.4%,4m
5520,3,[四叶草]RainySky,3245,1191,48,38,86,55.8%,12m
5520,3,[砖业团队]偷心盗贼,3245,434,17,15,32,53.1%,12m
5520,3,wzm,3245,364,12,20,32,37.5%,29m
5520,3,老螃蟹,3245,226,11,9,20,55.0%,12m
5520,1,[Rhusky]皮皮吃下了今令,3245,96,5,1,6,83.3%,15m
5520,3,GrimPigeon,3245,168,5,8,13,38.5%,6m
5520,3,Cuctuz,3245,0,1,0,1,100.0%,50m
5520,3,[眼瞎的车万苟]八雲橴,3245,0,1,1,2,50.0%,25m
5520,3,Musician,3245,0,0,1,1,0.0%,49m
5532,3,zjd,3244,1038,128,121,249,51.4%,4m
5532,3,goubiscboy,3244,1584,89,83,172,51.7%,8m
5532,3,如东掘港人,3244,516,21,17,38,55.3%,55m
5532,3,机枪滚毒爆,3244,250,11,8,19,57.9%,15m
5532,3,[通灵女孩]yaobohan,3244,256,10,6,16,62.5%,3m
5532,3,[ATLS]氙气灯,3244,30,2,0,2,100.0%,25m
5532,3,Cynosure,3244,47,2,1,3,66.7%,25m
5532,3,[刺蛇互助天团]抱走萝莉,3244,0,1,0,1,100.0%,29m
5532,3,艾尔光辉,3244,0,0,1,1,0.0%,13m
5532,3,[HTML]老八秘制小汉堡,3244,0,0,1,1,0.0%,19m
5542,3,Requiem,3243,344,16,9,25,64.0%,52m
5542,3,希提亚小汤圆,3243,396,16,11,27,59.3%,56m
5542,3,[莽哥]英雄堂口,3243,208,10,1,11,90.9%,28m
5542,3,IIIIIIIIIIII,3243,260,9,6,15,60.0%,50m
5542,3,[老头星际]GGBreaker,3243,229,7,1,8,87.5%,11m
5542,3,sadfasda,3243,146,5,5,10,50.0%,55m
5542,2,摄政王阿强,3243,0,4,1,5,80.0%,6m
5542,3,[我要重新集结]PhoirA,3243,118,4,10,14,28.6%,16m
5542,3,[流星龙]宇宙耀变龙,3243,60,3,1,4,75.0%,17m
5542,3,郭德纲砸缸,3243,88,3,3,6,50.0%,52m
5542,3,[社交学超可爱]Baldwin,3243,58,2,2,4,50.0%,9m
5542,3,[为了遥远的]柚子茶,3243,0,1,0,1,100.0%,29m
5542,1,dwt,3243,0,1,0,1,100.0%,13m
5542,3,[莽成一匹野马]DOOM,3243,0,0,1,1,0.0%,14m
5556,3,[哔翻天梯鸡]Mephisto,3242,1006,45,27,72,62.5%,52m
5556,3,[亮出光刄]RoarCoCo,3242,655,31,33,64,48.4%,23m
5556,3,打星际像蔡徐坤,3242,508,21,9,30,70.0%,11m
5556,3,[同济大学]长门秘书舰,3242,0,1,0,1,100.0%,7m
5556,3,[lxkj]咸宁鸡腿王游子建,3242,0,1,0,1,100.0%,18m
5556,3,星夜之影,3242,30,1,1,2,50.0%,56m
5562,2,IIIIIIIIIII,3241,815,113,119,232,48.7%,54m
5562,3,[逗比神教]零零小副官,3241,1523,81,64,145,55.9%,55m
5562,3,[冲就完了]CKCZ,3241,778,59,41,100,59.0%,53m
5562,3,ColdRoad,3241,218,47,44,91,51.6%,14m
5562,3,lzzn,3241,327,12,13,25,48.0%,22m
5562,3,[温柔兔公主]JJJJJJJ,3241,288,11,12,23,47.8%,8m
5562,3,VOID,3241,263,9,8,17,52.9%,22m
5562,3,[孙一峰小迷妹]不敢晚上上厕所,3241,196,7,6,13,53.8%,28m
5562,2,[分析]shiny,3241,0,5,0,5,100.0%,1h
5562,3,高独倚危楼,3241,0,1,0,1,100.0%,16m
5562,1,哎我的蟑螂呢,3241,0,1,1,2,50.0%,19m
5562,3,[THUDE]宁萌酱,3241,0,0,1,1,0.0%,15m
5574,3,瑞星星星,3240,942,77,59,136,56.6%,19m
5574,2,IIIIIIIIIII,3240,1229,52,59,111,46.8%,7m
5574,3,mijuma,3240,439,45,40,85,52.9%,12m
5574,3,[x不打内战x]整活小王子,3240,838,39,22,61,63.9%,10m
5574,3,解冻,3240,352,37,30,67,55.2%,10m
5574,2,FdSpoOkyc,3240,192,6,20,26,23.1%,3m
5574,3,[饲料厂]Tooko,3240,73,4,1,5,80.0%,15m
5574,3,[达拉姆查卡拉]Hunter,3240,116,4,7,11,36.4%,22m
5574,3,我是超级小月,3240,0,1,0,1,100.0%,22m
5574,3,坠落于空,3240,0,1,4,5,20.0%,12m
5574,3,[Beasty]llllllllllll,3240,0,0,6,6,0.0%,50m
5585,3,无产阶级劳动人民,3239,1484,97,67,164,59.1%,3m
5585,3,楪祈,3239,601,26,13,39,66.7%,11m
5585,3,[智商下线]secondheaven,3239,312,12,10,22,54.5%,49m
5585,3,便士,3239,174,9,6,15,60.0%,12m
5585,3,[GOTAL]旷工,3239,128,5,12,17,29.4%,20m
5585,3,IIIIIIIII,3239,58,3,2,5,60.0%,26m
5585,3,生镜雾,3239,60,2,3,5,40.0%,56m
5585,3,御命丹心,3239,0,1,2,3,33.3%,6m
5585,3,没有感情的条码人,3239,0,1,2,3,33.3%,14m
5585,3,毛茸茸大尾巴,3239,0,0,1,1,0.0%,2m
5585,2,[偽娘万歳]地狱咆哮,3239,0,0,5,5,0.0%,44m
5596,1,lightblue,3238,1575,1181,1188,2369,49.9%,51m
5596,3,[不想PVP]Sail,3238,615,76,58,134,56.7%,52m
5596,3,叼着烟打星际,3238,388,52,45,97,53.6%,28m
5596,3,[鸡饲料协会]漆黑的乌鸦,3238,641,24,25,49,49.0%,3m
5596,3,[Edge]蔚蓝之翼,3238,296,11,7,18,61.1%,16m
5596,3,[NKTJ]蟑螂舞女,3238,294,11,14,25,44.0%,4m
5596,3,[西湖水产巨子]暴风雪,3238,114,5,0,5,100.0%,56m
5596,3,zerg,3238,58,3,0,3,100.0%,55m
5596,3,Chierls,3238,55,2,2,4,50.0%,24m
5596,3,James,3238,30,1,1,2,50.0%,53m
5596,3,Wesukiliye,3238,30,1,5,6,16.7%,25m
5596,2,[保护伞公司]ZARD,3238,0,0,1,1,0.0%,14m
5608,3,[VKR]BATTERY,3237,1066,61,58,119,51.3%,5m
5608,3,SoLo,3237,1134,52,28,80,65.0%,3m
5608,3,[菜鸡玩家]LALALAL,3237,116,5,3,8,62.5%,25m
5608,3,[最弱的玩家]死神,3237,123,3,2,5,60.0%,20m
5608,3,[瘾大眼瞎]艾尔暗影卫队,3237,30,2,0,2,100.0%,54m
5608,2,好吃鸡的虫子,3237,0,1,0,1,100.0%,2m
5608,3,[狼牙盟]JackeyTi,3237,0,0,1,1,0.0%,28m
5608,3,[刺蛇互助社团]蒂月,3237,0,0,2,2,0.0%,14m
5616,3,IIIIIIIIIIII,3236,1538,69,57,126,54.8%,10m
5616,3,Minister,3236,1141,54,46,100,54.0%,49m
5616,3,[老油条战队2]星河舰队,3236,850,34,23,57,59.6%,6m
5616,3,Doot,3236,606,23,17,40,57.5%,20m
5616,2,血花缭乱,3236,176,6,31,37,16.2%,23m
5616,3,[肉鸡的饲养]YogSothothDD,3236,88,4,2,6,66.7%,52m
5616,3,[牌面]Pva,3236,0,1,0,1,100.0%,50m
5616,3,[传统星际届]暴雪今天倒闭了吗,3236,0,1,0,1,100.0%,24m
5616,1,[miku守护]哔哔哔,3236,0,1,3,4,25.0%,53m
5625,3,[25500]晚秋,3235,1467,78,56,134,58.2%,21m
5625,3,[兄弟连]tiamo,3235,550,19,27,46,41.3%,56m
5625,3,[星际联萌]手选火枪,3235,366,14,13,27,51.9%,4m
5625,1,[瘾大眼瞎]TATQwQ,3235,158,9,3,12,75.0%,28m
5625,1,[Xkp]我的源氏刀法贼强,3235,97,4,3,7,57.1%,6m
5625,3,物是人非,3235,120,3,1,4,75.0%,25m
5625,3,Conceal,3235,62,3,5,8,37.5%,26m
5625,3,Fairytale,3235,0,1,0,1,100.0%,57m
5633,3,[QWQa]今日解签宜下江南,3234,988,90,73,163,55.2%,6m
5633,1,IIIIIIIIIIII,3234,383,15,9,24,62.5%,11m
5633,3,iiiiiiiiiiii,3234,350,14,17,31,45.2%,28m
5633,3,[不知不觉天亮]GYT,3234,255,9,2,11,81.8%,4m
5633,1,树懒,3234,100,9,12,21,42.9%,5m
5633,3,我爱光明,3234,211,7,4,11,63.6%,54m
5633,3,[媳妇一喊就G]太空小丑,3234,176,6,8,14,42.9%,9m
5633,3,[Tyche]AtheNa,3234,30,2,1,3,66.7%,10m
5633,3,[JCWZ]一生一个李,3234,0,1,0,1,100.0%,55m
5633,3,IDCOD,3234,0,1,0,1,100.0%,4m
5633,3,幽冥神刺,3234,0,1,1,2,50.0%,9m
5633,3,[雾雨魔法森林]光之心,3234,0,0,1,1,0.0%,29m
5645,3,种族狂热,3233,1069,119,86,205,58.0%,9m
5645,3,春开那夜,3233,1610,96,93,189,50.8%,2m
5645,3,[KPGSC2]空谷幽兰,3233,1490,75,70,145,51.7%,14m
5645,3,[冲上去就是干]语叶可馨,3233,565,38,32,70,54.3%,7m
5645,3,SoS,3233,732,32,41,73,43.8%,14m
5645,3,[萌新爱萌]源光之路,3233,595,29,15,44,65.9%,23m
5645,3,IIIIIIIIII,3233,507,21,16,37,56.8%,52m
5645,2,Nakira,3233,254,9,4,13,69.2%,26m
5645,1,Haeta,3233,139,7,7,14,50.0%,13m
5645,3,[Beasty]CenturiesBoy,3233,86,3,3,6,50.0%,13m
5645,3,[小金上天队]丿零度乄,3233,86,3,4,7,42.9%,29m
5645,3,[序列sao]低音号黄前久美子,3233,0,1,2,3,33.3%,25m
5657,3,kkkkk,3232,348,21,17,38,55.3%,54m
5657,3,LGG,3232,350,12,11,23,52.2%,28m
5657,3,只爱七姐姐,3232,198,8,9,17,47.1%,13m
5657,3,愛的承諾,3232,60,2,8,10,20.0%,2m
5657,3,SCiVessel,3232,0,1,0,1,100.0%,56m
5657,3,[红烛昏罗帐]貳拾肆,3232,0,1,0,1,100.0%,27m
5657,3,[搔浪剑]PartinG,3232,0,0,1,1,0.0%,14m
5657,3,真瑞,3232,0,0,1,1,0.0%,4m
5665,3,nihao,3231,1397,318,316,634,50.2%,14m
5665,3,水银,3231,860,32,31,63,50.8%,28m
5665,3,小蜗,3231,754,29,28,57,50.9%,2m
5665,3,底迪,3231,172,7,3,10,70.0%,25m
5665,3,秋刀鱼的滋味,3231,58,2,1,3,66.7%,50m
5665,3,破名想半天,3231,0,1,0,1,100.0%,52m
5665,3,[萌新保护协议]Nico,3231,0,1,0,1,100.0%,10m
5665,3,[TPoR]企鹅物流,3231,0,1,0,1,100.0%,8m
5665,3,[总司令]xpy,3231,0,0,1,1,0.0%,18m
5665,3,[黑鲨]小色叫你玩神族,3231,0,0,1,1,0.0%,10m
5665,3,Artemis,3231,0,0,1,1,0.0%,21m
5665,3,Infinite,3231,0,0,4,4,0.0%,14m
5677,2,[艾尔之巅]自由探戈,3230,713,55,49,104,52.9%,7m
5677,3,Memory,3230,192,38,45,83,45.8%,29m
5677,3,灰太狼,3230,562,20,21,41,48.8%,12m
5677,2,人皇出征寸草不生,3230,203,10,6,16,62.5%,11m
5677,3,[努力到最强]Tery,3230,30,2,0,2,100.0%,28m
5677,1,[LLQ]我不要听,3230,0,0,1,1,0.0%,16m
5683,3,关山月,3229,926,40,35,75,53.3%,55m
5683,3,lsb,3229,466,22,16,38,57.9%,28m
5683,3,iweiko,3229,394,17,10,27,63.0%,4m
5683,2,HHHFFGG,3229,0,4,1,5,80.0%,1h
5683,3,[医学奇迹之花]花很讨厌,3229,0,1,0,1,100.0%,11m
5683,3,我要重新集结部队,3229,30,1,1,2,50.0%,29m
5683,3,坳里催花,3229,0,1,2,3,33.3%,10m
5683,3,炒鸡可爱王霸星,3229,30,1,3,4,25.0%,10m
5683,3,Aspcoder,3229,0,1,4,5,20.0%,13m
5683,3,风之迷沙,3229,0,0,2,2,0.0%,5m
5693,2,dazzle,3228,917,135,140,275,49.1%,29m
5693,3,[DMRc]内德维德,3228,1046,68,67,135,50.4%,56m
5693,3,IIIIIIIIIIII,3228,1039,52,43,95,54.7%,2m
5693,3,[我忘记升折跃]zeratul,3228,1154,42,44,86,48.8%,49m
5693,3,[最菜战队]天梯白给鸡,3228,326,13,9,22,59.1%,20m
5693,3,狗子霸霸,3228,352,12,7,19,63.2%,9m
5693,2,[萌新互助团]霸王,3228,148,6,7,13,46.2%,17m
5693,3,莫丶小陌,3228,114,4,1,5,80.0%,4m
5693,3,进击的艾伦,3228,88,4,3,7,57.1%,6m
5693,1,[Solo]弹指间湮灭,3228,119,3,1,4,75.0%,1h
5693,3,黄博导,3228,0,1,2,3,33.3%,30m
5704,3,Ace,3227,709,29,21,50,58.0%,55m
5704,3,[原谅兄弟会]不讲武德耗子尾汁,3227,344,13,10,23,56.5%,3m
5704,3,[福影双生]金鱼丶金鱼,3227,322,12,13,25,48.0%,49m
5704,3,糖醋狸吉,3227,81,5,4,9,55.6%,28m
5704,3,老子胖可丁,3227,58,3,0,3,100.0%,8m
5704,2,SoWhat,3227,0,1,0,1,100.0%,53m
5704,3,木雨,3227,0,0,1,1,0.0%,54m
5704,3,[TES]MarineFiend,3227,0,0,1,1,0.0%,13m
5704,3,[菜的没人带]大佬带带我吧,3227,0,0,1,1,0.0%,56m
5704,3,[Banned]风继续吹,3227,0,0,1,1,0.0%,14m
5714,2,发育狂,3226,1111,64,64,128,50.0%,56m
5714,3,zzz,3226,310,12,8,20,60.0%,52m
5714,3,布兰妮的心,3226,196,12,22,34,35.3%,22m
5714,3,[星际丶老男孩]滚平机枪,3226,208,8,6,14,57.1%,26m
5714,3,出飞龙司马,3226,180,7,9,16,43.8%,10m
5714,1,陆少爷老婆,3226,163,6,3,9,66.7%,15m
5714,3,poep,3226,90,4,2,6,66.7%,10m
5714,3,酷酷尔,3226,86,3,4,7,42.9%,54m
5714,3,flyingnoob,3226,0,1,0,1,100.0%,21m
5714,3,我想你了,3226,0,0,1,1,0.0%,6m
5724,3,IIIIIIIIIIII,3225,1116,61,62,123,49.6%,14m
5724,2,奥巴牛,3225,1550,61,71,132,46.2%,8m
5724,3,[九天星辰同萌]kangkang,3225,619,59,52,111,53.2%,18m
5724,3,wishstudio,3225,1233,50,50,100,50.0%,4m
5724,3,噶姐半糖去冰,3225,798,30,28,58,51.7%,2m
5724,3,[文韬武略]xiaoxiao,3225,408,16,21,37,43.2%,51m
5724,3,[黑豹]rubyruby,3225,395,14,9,23,60.9%,22m
5724,3,[北洋谐星组合]心终以矝,3225,266,10,14,24,41.7%,18m
5724,3,HTeOolK,3225,167,8,3,11,72.7%,5m
5724,3,[七彩斑斓]相声大师丘吉尔,3225,198,8,6,14,57.1%,19m
5724,3,星海,3225,202,7,7,14,50.0%,7m
5724,3,是金子涵呀,3225,174,6,7,13,46.2%,6m
5724,3,云千千纤,3225,30,2,1,3,66.7%,57m
5724,3,[Vgirls]暗夜中的杀手,3225,0,1,0,1,100.0%,4m
5724,3,供奉院爱礼纱,3225,0,1,0,1,100.0%,28m
5724,3,[花间虫]腥红风暴,3225,30,1,1,2,50.0%,29m
5724,3,KTflash,3225,0,1,1,2,50.0%,50m
5724,1,二十四小时,3225,0,1,5,6,16.7%,23m
5724,3,promise,3225,0,0,1,1,0.0%,9m
5724,3,[一血大队]又土又木,3225,0,0,3,3,0.0%,10m
5744,2,[不会散枪兵]imbasupertnt,3224,1497,96,93,189,50.8%,20m
5744,3,高党,3224,988,52,46,98,53.1%,29m
5744,3,pimbaisuck,3224,249,34,10,44,77.3%,29m
5744,3,[随便]waez,3224,612,25,21,46,54.3%,7m
5744,3,YumeKara,3224,366,18,12,30,60.0%,11m
5744,3,[疼王阁]傻子被盘子打死,3224,92,17,3,20,85.0%,28m
5744,3,[SJTU]Bubble,3224,153,9,19,28,32.1%,29m
5744,1,MariaRose,3224,96,5,2,7,71.4%,25m
5744,2,[别发hf谢谢]ZEST,3224,143,4,8,12,33.3%,17m
5744,3,dogjk,3224,30,2,0,2,100.0%,28m
5744,2,我是牛人,3224,78,2,6,8,25.0%,11m
5744,3,[曾经一群兔子]电子竞技没有快递,3224,0,1,0,1,100.0%,4m
5744,2,需要更多的补给站,3224,0,1,0,1,100.0%,23m
5744,3,[近铁小酒馆]czdqwq,3224,0,0,1,1,0.0%,15m
5744,3,[浪啊浪]jack,3224,0,0,2,2,0.0%,28m
5759,3,youareonly,3223,1430,92,78,170,54.1%,29m
5759,3,[传说萌娘团]爱与和平,3223,336,12,11,23,52.2%,11m
5759,1,[魔界之主]神绮玛格特罗伊德,3223,167,7,2,9,77.8%,1h
5759,3,leey,3223,116,5,5,10,50.0%,56m
5759,3,[IMRTS2]ghost,3223,142,5,7,12,41.7%,25m
5759,3,笨笨,3223,86,3,2,5,60.0%,11m
5759,3,VINNIE,3223,0,1,0,1,100.0%,8m
5766,3,lamb,3222,1338,126,122,248,50.8%,24m
5766,3,天宇,3222,1376,58,51,109,53.2%,28m
5766,3,kirakira,3222,858,37,25,62,59.7%,7m
5766,2,年轻人不讲,3222,150,7,6,13,53.8%,15m
5766,3,[第八舰队丶]Amateru,3222,144,6,7,13,46.2%,5m
5766,2,赵缀空,3222,0,4,1,5,80.0%,1h
5766,2,[血腥狂热]寂寞的贪吃蛇,3222,93,2,3,5,40.0%,9m
5766,3,立陶宛农民,3222,0,1,1,2,50.0%,3m
5766,3,[NLD]踏歌仙,3222,30,1,3,4,25.0%,20m
5775,3,[GOTAL]烨殒,3221,1366,58,56,114,50.9%,5m
5775,3,NULL,3221,1078,46,38,84,54.8%,15m
5775,3,骨灰级神,3221,561,38,29,67,56.7%,21m
5775,3,FReeloo,3221,394,16,13,29,55.2%,18m
5775,1,Ash,3221,93,2,0,2,100.0%,11m
5775,2,翱玥七星,3221,0,1,0,1,100.0%,53m
5775,3,Mante,3221,0,1,1,2,50.0%,56m
5775,3,星际争霸嘴上过,3221,0,0,1,1,0.0%,56m
5783,3,[oxyed]分田就能提高产量,3220,1156,47,38,85,55.3%,11m
5783,3,[Mtp]绝望中忘了使徒,3220,200,11,7,18,61.1%,14m
5783,3,[目標諾森德]两面宿傩第一手,3220,252,9,10,19,47.4%,12m
5783,2,星际玩家一号,3220,219,8,1,9,88.9%,2m
5783,3,我快乐就行,3220,124,4,13,17,23.5%,22m
5783,3,这你敢信吗,3220,58,2,4,6,33.3%,24m
5783,3,KingSpeech,3220,0,1,2,3,33.3%,4m
5783,3,[扣扣哒呦]天堂之戟,3220,0,0,1,1,0.0%,50m
5791,3,玄武再现,3219,1609,103,86,189,54.5%,26m
5791,3,简单的电脑,3219,655,47,44,91,51.6%,23m
5791,3,[菜有菜的道理]Aries,3219,459,46,42,88,52.3%,9m
5791,3,[ACG系]小智,3219,254,9,10,19,47.4%,25m
5791,3,樱岛麻衣,3219,58,3,1,4,75.0%,27m
5791,3,TreeSea,3219,30,2,4,6,33.3%,56m
5791,3,[红果果QwQ]奶啊奶啊盐,3219,0,1,0,1,100.0%,57m
5791,1,[逗中之霸]Shifu,3219,96,1,4,5,20.0%,1h
5791,1,[张博文是只鸡]瞧尔萨斯,3219,0,0,2,2,0.0%,23m
5800,3,[猫神撅总司]世界再大只是个球,3218,1541,140,139,279,50.2%,28m
5800,2,[零之玛利亚]月光疾风,3218,931,123,133,256,48.0%,20m
5800,3,[KPG2]cherry,3218,1506,62,66,128,48.4%,23m
5800,3,Fidei,3218,1038,50,43,93,53.8%,2m
5800,3,[0APM]和和,3218,693,24,29,53,45.3%,24m
5800,1,KanDaolaoshi,3218,96,5,2,7,71.4%,1h
5800,3,[黑暗圣堂棱镜]冰弦结御,3218,30,2,0,2,100.0%,9m
5800,3,Young,3218,50,2,5,7,28.6%,23m
5800,3,kinou,3218,0,1,0,1,100.0%,15m
5800,3,大地之春,3218,0,0,1,1,0.0%,57m
5800,3,Saber,3218,0,0,1,1,0.0%,23m
5811,3,[BoAiur]Alan,3217,1598,67,56,123,54.5%,56m
5811,3,[Toss]朽木白虎虚,3217,616,30,21,51,58.8%,18m
5811,3,深的,3217,141,7,3,10,70.0%,25m
5811,3,LovePoem,3217,0,1,0,1,100.0%,53m
5811,3,天雪蓝,3217,0,1,2,3,33.3%,5m
5816,3,CAL,3216,872,32,32,64,50.0%,15m
5816,3,dovetoo,3216,318,12,5,17,70.6%,11m
5816,3,DunaYe,3216,246,9,11,20,45.0%,22m
5816,2,北巷清风,3216,192,8,8,16,50.0%,10m
5816,3,含光,3216,86,4,0,4,100.0%,51m
5816,3,[野生无公害]ghost,3216,30,2,1,3,66.7%,55m
5816,3,超级无敌小宗宗,3216,0,1,0,1,100.0%,23m
5816,3,彼季离,3216,0,0,2,2,0.0%,23m
5816,3,[埃蒙保护局]小怪兽路明非,3216,0,0,2,2,0.0%,6m
5816,1,[雾雨魔法森林]YEARS,3216,0,0,3,3,0.0%,27m
5826,3,第五象限,3215,1241,49,40,89,55.1%,3m
5826,3,快乐粪坑,3215,490,30,17,47,63.8%,9m
5826,3,[进击花园宝宝]玛卡巴卡,3215,399,25,5,30,83.3%,21m
5826,3,胆大如斗黄旭东,3215,266,19,10,29,65.5%,53m
5826,3,寄人间于朝暮,3215,233,11,3,14,78.6%,13m
5826,3,[唯爱彦神]BYDY,3215,164,9,7,16,56.2%,14m
5826,3,矿物储量不足,3215,139,3,2,5,60.0%,49m
5826,3,[MYC]拉克希尔大乱斗,3215,92,3,8,11,27.3%,6m
5826,3,萌萌哒的傻黄丶,3215,0,1,0,1,100.0%,56m
5826,3,Auroth,3215,0,0,1,1,0.0%,7m
5826,3,doudou,3215,0,0,1,1,0.0%,11m
5837,3,福兴高照,3214,406,40,47,87,46.0%,8m
5837,3,鬼影,3214,356,16,11,27,59.3%,9m
5837,3,羡才,3214,204,8,7,15,53.3%,24m
5837,3,[千只鹤]鹿目圆,3214,170,7,7,14,50.0%,10m
5837,3,缤纷黑马,3214,208,7,10,17,41.2%,21m
5837,3,[敢死队]子龍,3214,88,3,5,8,37.5%,28m
5837,2,新手,3214,0,2,0,2,100.0%,1h
5837,3,仁义无双总司令,3214,60,2,4,6,33.3%,9m
5837,3,无奈无语无辜,3214,30,2,5,7,28.6%,54m
5837,3,xsghf,3214,97,1,1,2,50.0%,55m
5837,1,[查尔之矛]我又不会玩,3214,0,1,3,4,25.0%,7m
5848,3,[RAY]RedArmySnack,3213,691,35,31,66,53.0%,12m
5848,3,不要射在脸上,3213,688,24,25,49,49.0%,52m
5848,3,arthas,3213,456,17,18,35,48.6%,8m
5848,3,艾尔小圆盾,3213,464,15,25,40,37.5%,7m
5848,2,QAQ,3213,114,7,3,10,70.0%,51m
5848,3,[306]Phoenix,3213,204,7,7,14,50.0%,6m
5848,3,金华孙一峰,3213,220,6,12,18,33.3%,13m
5848,3,IIIIIIIIII,3213,142,5,0,5,100.0%,7m
5848,2,[Brust]剪子卖萌,3213,0,1,7,8,12.5%,50m
5848,3,Vampire,3213,0,0,1,1,0.0%,20m
5848,3,Hukuro,3213,0,0,1,1,0.0%,53m
5848,3,探姬,3213,0,0,2,2,0.0%,17m
5860,3,[不可解]花谱,3212,1353,162,158,320,50.6%,56m
5860,3,llllllllll,3212,1126,42,41,83,50.6%,30m
5860,3,[知乎战队]Logan,3212,191,8,6,14,57.1%,7m
5860,2,[辉煌华夏]虎牙小华,3212,0,4,1,5,80.0%,44m
5860,3,[Swing]LvMaX,3212,0,1,1,2,50.0%,4m
5860,3,ssssssss,3212,30,1,1,2,50.0%,53m
5860,3,持枪证,3212,30,1,4,5,20.0%,25m
5867,3,iPhoneIIII,3211,686,168,149,317,53.0%,19m
5867,3,朱雀星君,3211,1468,56,58,114,49.1%,54m
5867,3,[LFY]南皇,3211,779,43,17,60,71.7%,7m
5867,3,[病娇癌病友会]庸医老魏,3211,472,18,14,32,56.2%,24m
5867,3,[萌新在下挨打]马保国大师,3211,345,14,3,17,82.4%,52m
5867,3,[NKVD]ShOhEi,3211,324,13,11,24,54.2%,28m
5867,3,Balance,3211,114,5,1,6,83.3%,3m
5867,3,cdy,3211,146,5,8,13,38.5%,14m
5867,2,[miku守护]warrior,3211,0,2,0,2,100.0%,1h
5867,3,[童话小镇]fallen,3211,58,2,3,5,40.0%,3m
5867,3,小仓由菜,3211,0,1,1,2,50.0%,30m
5867,2,panshixiang,3211,96,1,1,2,50.0%,1h
5867,3,我就是个控,3211,0,0,1,1,0.0%,26m
5867,3,[中南大学官网]生如幻,3211,0,0,3,3,0.0%,6m
5881,3,caote,3210,1559,119,99,218,54.6%,20m
5881,3,[Kiloli]霸双无绝,3210,422,15,10,25,60.0%,6m
5881,3,daodao,3210,252,10,8,18,55.6%,24m
5881,3,[守护小太阳]小小小太阳,3210,58,3,6,9,33.3%,23m
5881,1,[星际联盟战队]淡淡的忧伤丶,3210,48,2,1,3,66.7%,15m
5881,2,[天生鬈毛]不喜内战,3210,94,2,4,6,33.3%,6m
5881,3,[爆破VII课]ApoXips,3210,0,1,0,1,100.0%,29m
5881,3,[零柒零柒]liggia,3210,0,1,0,1,100.0%,19m
5881,3,[近影]亚美爹,3210,0,1,0,1,100.0%,13m
5881,3,[Texas]明宗,3210,0,1,0,1,100.0%,19m
5881,3,[逐火之蛾]一方通行,3210,0,1,0,1,100.0%,10m
5881,3,llllllllllll,3210,0,1,0,1,100.0%,26m
5881,3,Evannnn,3210,0,1,1,2,50.0%,13m
5881,3,zhucome,3210,0,0,1,1,0.0%,3m
5895,3,yaya,3209,1546,335,330,665,50.4%,19m
5895,2,一般性与大众性,3209,1311,216,215,431,50.1%,19m
5895,3,一般赢不了,3209,944,133,127,260,51.2%,17m
5895,3,[卡尔达利斯]诫躤,3209,697,61,55,116,52.6%,8m
5895,3,Msvivi,3209,946,38,35,73,52.1%,53m
5895,3,[幽冥之狼]博丽灵梦,3209,559,21,16,37,56.8%,26m
5895,3,莽我,3209,538,21,17,38,55.3%,6m
5895,3,狗哥且战且退,3209,418,17,9,26,65.4%,22m
5895,2,sdasdfassd,3209,82,6,4,10,60.0%,15m
5895,3,[壮士打我队友]你随意了,3209,143,3,5,8,37.5%,51m
5895,3,[sc谐盟]子笛大帅哥,3209,0,1,0,1,100.0%,21m
5895,3,Vector,3209,0,1,0,1,100.0%,17m
5895,2,[萌萌哒鸡]猪猪想吃饭,3209,95,1,5,6,16.7%,24m
5895,3,[Tuip]穿本,3209,0,0,1,1,0.0%,29m
5909,3,野良神,3208,1043,57,53,110,51.8%,4m
5909,3,她香欲顾之,3208,1134,53,37,90,58.9%,3m
5909,3,Stats,3208,522,39,38,77,50.6%,23m
5909,3,[文韬武略]未闻花名但知花香,3208,662,38,27,65,58.5%,9m
5909,3,IIIIIIIIIIII,3208,629,31,26,57,54.4%,30m
5909,3,星际争霸,3208,740,28,27,55,50.9%,50m
5909,3,south,3208,187,25,25,50,50.0%,15m
5909,3,佐佐往鼬走,3208,376,13,13,26,50.0%,6m
5909,2,小梨衣,3208,0,4,1,5,80.0%,1h
5909,3,风起竹桑田,3208,58,3,4,7,42.9%,54m
5909,3,耗子尾汁,3208,62,3,4,7,42.9%,12m
5909,3,foreverrain,3208,30,2,3,5,40.0%,54m
5909,3,[忙忙撸撸]春风秋元,3208,30,1,1,2,50.0%,24m
5909,3,[超电磁炉]栗山未来,3208,0,0,1,1,0.0%,6m
5909,3,[Mai丶]QuartzAbsink,3208,0,0,1,1,0.0%,51m
5909,3,[龘靐齉爩鶙]阿莱库利兹,3208,0,0,1,1,0.0%,53m
5909,3,浪漫的白金,3208,0,0,1,1,0.0%,26m
5909,3,DOWN,3208,0,0,1,1,0.0%,6m
5909,3,她和海水一样咸,3208,0,0,1,1,0.0%,27m
5928,2,镜花水月,3207,1503,60,72,132,45.5%,24m
5928,3,[狼烟]火爆猪肝,3207,318,57,54,111,51.4%,8m
5928,3,RAY,3207,784,35,29,64,54.7%,22m
5928,3,李十七,3207,568,32,19,51,62.7%,18m
5928,3,[七咕咕]一束七的小迷弟,3207,0,0,1,1,0.0%,56m
5933,3,李别吉,3206,1543,88,59,147,59.9%,56m
5933,2,明旭安,3206,1244,61,49,110,55.5%,14m
5933,3,edasuh,3206,895,48,44,92,52.2%,14m
5933,2,掌中老虎,3206,161,9,4,13,69.2%,9m
5933,3,不怕的,3206,226,9,5,14,64.3%,5m
5933,2,国服阴间人真的多,3206,251,7,10,17,41.2%,6m
5933,2,[北京城管]阿木,3206,118,4,2,6,66.7%,24m
5933,3,[老兄弟联盟]斯大林,3206,18,2,0,2,100.0%,22m
5933,3,[鸡层干部]LuckyTerran,3206,0,1,1,2,50.0%,6m
5933,3,[无畏巡洋]猎人,3206,0,0,1,1,0.0%,10m
5933,3,Rashka,3206,0,0,1,1,0.0%,6m
5933,3,Redwings,3206,0,0,1,1,0.0%,51m
5945,3,小熊摇摇车,3205,230,11,1,12,91.7%,25m
5945,3,[SDE]INnoVation,3205,268,10,1,11,90.9%,11m
5945,3,gloomylight,3205,256,9,8,17,52.9%,57m
5945,3,LIAR,3205,253,8,2,10,80.0%,53m
5945,3,玖琳吾妻,3205,123,6,13,19,31.6%,5m
5945,3,tab,3205,114,5,4,9,55.6%,15m
5945,3,llllllllllll,3205,148,5,9,14,35.7%,2m
5945,1,见招拆招,3205,136,4,1,5,80.0%,19m
5945,3,裤裆有杀气,3205,60,2,4,6,33.3%,3m
5945,3,Demon,3205,0,0,1,1,0.0%,53m
5945,3,这是绿色吗,3205,0,0,1,1,0.0%,14m
5956,3,艾尔之光,3204,1031,200,200,400,50.0%,24m
5956,3,永恒之泪,3204,596,68,43,111,61.3%,9m
5956,3,[斯巴达血战团]peanut,3204,1032,47,41,88,53.4%,54m
5956,3,皇家胜利者盖本,3204,318,12,13,25,48.0%,21m
5956,3,小小默,3204,231,8,1,9,88.9%,57m
5956,3,[王富贵]王富贵,3204,172,6,0,6,100.0%,25m
5956,3,llllllllllll,3204,29,2,3,5,40.0%,14m
5956,3,[百变小樱]Buakaw,3204,0,1,0,1,100.0%,25m
5956,3,排骨,3204,0,1,0,1,100.0%,9m
5956,1,[洛梦绫音]len,3204,0,0,1,1,0.0%,30m
5966,3,Diocletianus,3203,968,38,34,72,52.8%,11m
5966,3,fsweee,3203,707,30,23,53,56.6%,4m
5966,3,[Vcc]Vspring,3203,472,16,20,36,44.4%,11m
5966,3,冬夜雪下,3203,394,14,9,23,60.9%,5m
5966,2,长夏村墟,3203,307,13,7,20,65.0%,20m
5966,2,llllllllllll,3203,305,12,8,20,60.0%,23m
5966,3,仰天一刀,3203,0,1,0,1,100.0%,53m
5966,3,[菜鸡球带]星海泛舟,3203,0,1,0,1,100.0%,54m
5966,3,懒得讲武德,3203,0,1,1,2,50.0%,53m
5966,3,[奔驰何平]光照于生化,3203,0,0,1,1,0.0%,53m
5976,3,默存一生,3202,1090,68,51,119,57.1%,52m
5976,3,ULTRATE,3202,248,9,11,20,45.0%,12m
5976,3,amerce,3202,176,7,5,12,58.3%,3m
5976,2,HumanLegacy,3202,44,4,1,5,80.0%,1h
5976,3,菜鸡孙一峰,3202,90,4,2,6,66.7%,6m
5976,3,只会打一波,3202,86,3,5,8,37.5%,7m
5976,3,PImba,3202,30,2,1,3,66.7%,21m
5976,3,HFGL,3202,0,1,0,1,100.0%,53m
5976,3,梵天丸,3202,0,1,1,2,50.0%,30m
5976,3,[DMRe]Dust,3202,0,0,1,1,0.0%,11m
5986,3,[同化失败了]晴新短夏,3201,547,24,5,29,82.8%,3m
5986,3,磨豆腐,3201,456,19,13,32,59.4%,26m
5986,3,[多瑙河之珠]游城,3201,388,15,6,21,71.4%,3m
5986,3,FatTummy,3201,272,11,10,21,52.4%,28m
5986,3,格式文,3201,253,9,6,15,60.0%,10m
5986,3,[天照]沙漠之狐隆美尔,3201,0,1,0,1,100.0%,28m
5986,3,[九条命的狐狸]whitegive,3201,0,1,0,1,100.0%,52m
5986,3,运筹帷幄小阿远,3201,0,1,0,1,100.0%,13m
5986,3,知之曰明哲,3201,0,0,1,1,0.0%,10m
5995,2,[在下萌新一只]鲍大将军,3200,1267,113,77,190,59.5%,30m
5995,3,[北京城管]麻袋不要乱来,3200,640,65,57,122,53.3%,28m
5995,3,hzqj,3200,1219,57,53,110,51.8%,55m
5995,3,Renascence,3200,430,16,19,35,45.7%,2m
5995,3,VIRGINIA,3200,378,15,6,21,71.4%,56m
5995,3,BPD,3200,315,14,15,29,48.3%,23m
5995,2,[乱世]樱花与她皆落,3200,165,7,6,13,53.8%,50m
5995,3,神鬼不散,3200,180,6,9,15,40.0%,56m
5995,3,mumiai,3200,142,5,3,8,62.5%,7m
5995,3,[看啥]老庙,3200,128,5,8,13,38.5%,7m
5995,1,RainVoiceBox,3200,94,3,3,6,50.0%,14m
5995,3,西湖底二五仔,3200,0,1,0,1,100.0%,26m
5995,3,SilentMary,3200,0,0,1,1,0.0%,56m
5995,3,[今天超市打折]梦千秋,3200,0,0,1,1,0.0%,28m
6009,3,Tassada,3199,1017,71,70,141,50.4%,22m
6009,3,[某不知名鸡场]往生之翼,3199,645,56,50,106,52.8%,26m
6009,3,WHY,3199,1183,54,34,88,61.4%,18m
6009,3,[夙愿天下]紫路,3199,249,10,4,14,71.4%,9m
6009,3,IIIIIIIIIIII,3199,122,5,8,13,38.5%,4m
6009,3,绝望中忘了使徒,3199,88,4,4,8,50.0%,16m
6009,3,[充气团]蚂蚱晨晨,3199,0,1,0,1,100.0%,13m
6009,3,[七咕咕]llllllllllll,3199,0,1,0,1,100.0%,15m
6009,3,弱弱的幼女控桑,3199,0,0,1,1,0.0%,13m
6009,3,白花花,3199,0,0,1,1,0.0%,29m
6019,3,[上海大学]夏至泡泡,3198,951,37,31,68,54.4%,20m
6019,3,上弦月,3198,531,21,14,35,60.0%,9m
6019,3,[LDP]玩玩,3198,369,15,5,20,75.0%,5m
6019,3,kira,3198,115,12,20,32,37.5%,22m
6019,3,[猪头哥]猪猪侠,3198,254,10,6,16,62.5%,12m
6019,2,[刺蛇互助协会]price,3198,0,4,0,4,100.0%,33m
6019,3,IIIIIIIIII,3198,88,3,3,6,50.0%,25m
6019,3,llllllllll,3198,30,2,1,3,66.7%,57m
6019,3,[1sA]EtdMaoJin,3198,0,2,3,5,40.0%,16m
6019,2,快乐之子,3198,0,0,1,1,0.0%,8m
6029,3,低调小王,3197,1064,49,28,77,63.6%,20m
6029,3,perflove,3197,488,42,21,63,66.7%,52m
6029,3,心灵捕手,3197,680,28,24,52,53.8%,6m
6029,3,极品菜鸟,3197,477,23,12,35,65.7%,27m
6029,3,[动漫迷]游龙,3197,150,5,6,11,45.5%,11m
6029,3,东京不热,3197,90,4,2,6,66.7%,29m
6029,3,dream,3197,65,3,3,6,50.0%,15m
6029,3,[大主教的兄弟]Laowhite,3197,0,1,0,1,100.0%,50m
6029,3,[永夜樂想]超级嗨客,3197,30,1,1,2,50.0%,24m
6038,3,[飞云之上]HelloWorld,3196,757,36,16,52,69.2%,26m
6038,2,SilverLuna,3196,902,34,50,84,40.5%,55m
6038,3,风清扬,3196,405,15,10,25,60.0%,12m
6038,2,[武形秘仪]Thunder,3196,0,4,1,5,80.0%,1h
6038,1,akscar,3196,0,4,2,6,66.7%,14m
6038,3,[永不灭的战火]听风讲,3196,30,2,2,4,50.0%,3m
6038,3,[TAmG]乱码无名,3196,0,0,1,1,0.0%,13m
6038,3,沈渊,3196,0,0,1,1,0.0%,27m
6038,3,我是萌新,3196,0,0,1,1,0.0%,30m
6047,3,[BTBU]qyh,3195,1125,179,146,325,55.1%,49m
6047,3,茄丁柳,3195,1577,109,69,178,61.2%,3m
6047,2,AgentBunz,3195,689,107,114,221,48.4%,26m
6047,3,Teg,3195,1480,72,70,142,50.7%,54m
6047,3,[鸭蛋万岁]RiSkyKhan,3195,709,27,23,50,54.0%,8m
6047,2,[CCGV]GuoYhi,3195,0,3,1,4,75.0%,1h
6047,2,[辣氪昔儿]Nol,3195,95,2,0,2,100.0%,51m
6047,3,元始天王,3195,30,2,4,6,33.3%,8m
6047,3,格纳,3195,30,1,1,2,50.0%,5m
6047,3,[微星际]丨果子彡,3195,0,0,1,1,0.0%,9m
6047,3,vQoo,3195,0,0,1,1,0.0%,15m
6047,1,[Rhusky]IIIIIIIIl,3195,0,0,4,4,0.0%,1h
6059,3,nicy,3194,936,161,153,314,51.3%,8m
6059,3,[SoloAs]Mercy,3194,546,21,14,35,60.0%,3m
6059,3,WBYYing,3194,316,11,10,21,52.4%,6m
6059,3,[重理工]Rossoneri,3194,145,9,16,25,36.0%,14m
6059,3,风雪无痕,3194,158,8,4,12,66.7%,50m
6059,2,VAN,3194,0,4,1,5,80.0%,1h
6059,3,可乐要加冰,3194,94,4,12,16,25.0%,14m
6059,3,[北京城管]yedaxian,3194,30,2,0,2,100.0%,3m
6059,2,我是真的惨,3194,0,1,1,2,50.0%,10m
6068,3,[荒芜岁月]柳下鬼色,3193,1439,138,125,263,52.5%,21m
6068,3,llllllllllll,3193,605,23,17,40,57.5%,15m
6068,3,sdfk,3193,485,21,29,50,42.0%,9m
6068,3,卖萌熊,3193,240,11,10,21,52.4%,56m
6068,1,你看我严肃不,3193,170,10,8,18,55.6%,30m
6068,3,[奔驰何平]飘零的叶子,3193,63,5,1,6,83.3%,8m
6068,3,CELIANGSHI,3193,136,5,7,12,41.7%,20m
6068,3,[qhfz]sTariM,3193,71,5,9,14,35.7%,10m
6068,1,llaahg,3193,0,4,2,6,66.7%,23m
6068,3,[三三教会]IIIIIIIIIIII,3193,0,1,0,1,100.0%,53m
6068,3,horo,3193,0,0,1,1,0.0%,56m
6068,3,含泪甩飞龙,3193,0,0,4,4,0.0%,51m
6080,3,会飞的猪,3192,1495,85,73,158,53.8%,29m
6080,3,ODaNobuNaga,3192,1043,44,33,77,57.1%,26m
6080,3,热干面加点辣椒,3192,857,38,31,69,55.1%,51m
6080,3,Bye,3192,705,30,21,51,58.8%,12m
6080,3,冰与火之歌,3192,224,10,10,20,50.0%,54m
6080,3,[鬼谷]艾尔又叒叕沦陷了,3192,59,10,15,25,40.0%,28m
6080,3,一方萝莉控,3192,264,9,10,19,47.4%,57m
6080,3,无面,3192,134,7,2,9,77.8%,9m
6080,3,进击的中二骚年,3192,173,7,4,11,63.6%,27m
6080,3,[NEET姬]蓬莱山辉夜,3192,142,6,3,9,66.7%,30m
6080,3,WenZIc,3192,162,6,9,15,40.0%,12m
6080,2,魔想十六夜,3192,44,5,2,7,71.4%,1h
6080,2,残日星宿,3192,118,5,2,7,71.4%,1h
6080,2,[冥狐灬]紫月,3192,0,4,5,9,44.4%,23m
6080,3,Chilk,3192,30,2,3,5,40.0%,3m
6080,3,[随机自定义]有心兽,3192,0,0,1,1,0.0%,54m
6080,3,万人敬仰蝌蚪君,3192,0,0,1,1,0.0%,6m
6097,3,[SC2近卫军]蓝暴暴,3191,1646,149,143,292,51.0%,15m
6097,3,[Wlngs]PussinBotts,3191,1551,147,134,281,52.3%,15m
6097,3,白泽加奈惠的饼干,3191,1622,121,115,236,51.3%,55m
6097,3,SnowMan,3191,298,22,13,35,62.9%,26m
6097,2,龙兀,3191,216,9,6,15,60.0%,2m
6097,1,hanyy,3191,142,7,2,9,77.8%,1h
6097,3,[Hdl]矮油名字能这么长,3191,131,4,2,6,66.7%,50m
6097,3,[阿库西斯教团]无声黑白,3191,58,2,2,4,50.0%,24m
6097,2,[感恩]指挥官,3191,0,1,0,1,100.0%,2m
6097,3,雾中山行丶,3191,0,1,0,1,100.0%,6m
6107,3,[谐神]人间四月,3190,1616,77,75,152,50.7%,25m
6107,3,Urun,3190,677,61,49,110,55.5%,19m
6107,3,偶也,3190,657,31,39,70,44.3%,26m
6107,3,[大陆谐会]乘舆,3190,277,27,6,33,81.8%,15m
6107,3,老年人打星际,3190,508,20,14,34,58.8%,6m
6107,3,[RyH]猫猫,3190,483,18,27,45,40.0%,55m
6107,1,chenpie,3190,119,6,3,9,66.7%,14m
6107,3,艾尔必将沦陷,3190,6,2,2,4,50.0%,18m
6107,3,[SFTRA3]MisakaMikoto,3190,0,1,0,1,100.0%,5m
6107,3,富婆求子,3190,0,1,0,1,100.0%,25m
6107,3,喵喵喵喵喵喵喵,3190,30,1,1,2,50.0%,10m
6118,3,[SNShna]lianmi,3189,1439,145,119,264,54.9%,28m
6118,3,二等兵,3189,1203,55,50,105,52.4%,25m
6118,2,[专业单一小组]家长会领衔主演,3189,30,3,8,11,27.3%,4m
6118,3,金鳞岂是池中物,3189,58,2,1,3,66.7%,12m
6118,3,zyc,3189,60,2,4,6,33.3%,21m
6118,3,IIIIIIIIIIII,3189,0,1,2,3,33.3%,14m
6118,3,京魂匣,3189,0,0,1,1,0.0%,24m
6118,1,霜血三千,3189,0,0,1,1,0.0%,1h
6126,3,[美少男战队]家有很多岛国片,3188,1353,110,100,210,52.4%,6m
6126,3,[灰冥]星风,3188,726,26,27,53,49.1%,6m
6126,1,羽幕丶,3188,253,10,10,20,50.0%,16m
6126,3,[SUPSC]zhong,3188,276,10,11,21,47.6%,25m
6126,3,[CRSC2]我是新手,3188,150,6,13,19,31.6%,28m
6126,3,狂野之郎,3188,114,5,5,10,50.0%,55m
6126,3,[PITB]榊之長孖,3188,30,2,1,3,66.7%,6m
6126,3,[燕大SC]合作停更暴雪没妈,3188,0,0,1,1,0.0%,8m
6134,2,[Oceanx]JamesRccl,3187,144,158,158,316,50.0%,19m
6134,3,张玮津,3187,662,30,24,54,55.6%,56m
6134,1,温蕾萨风行者,3187,260,12,9,21,57.1%,13m
6134,3,巴拉拉,3187,208,7,9,16,43.8%,50m
6134,1,[奶农]爷创造神话嗯,3187,119,6,2,8,75.0%,1h
6134,3,郁闷些,3187,58,2,2,4,50.0%,6m
6134,3,势大力沉,3187,30,2,3,5,40.0%,15m
6134,3,[OgiNA]IIIIIIIIIII,3187,97,2,3,5,40.0%,25m
6134,3,[萨尔那加神庙]逗比帅,3187,0,1,0,1,100.0%,29m
6134,3,[哇哦金色传说]Legend,3187,0,1,0,1,100.0%,23m
6134,3,AthrunSara,3187,0,0,1,1,0.0%,5m
6134,3,[情谊至上]终不似丿少年游,3187,0,0,2,2,0.0%,15m
6146,3,[腥基佬男骸]疯瘤老煜哥,3186,983,103,98,201,51.2%,57m
6146,2,[汉堡FANS]新秀神族雨廷桑,3186,1439,73,89,162,45.1%,8m
6146,3,[才不是傲娇]ALVA,3186,1384,60,56,116,51.7%,14m
6146,3,[小仙女上线啦]行建国,3186,521,32,26,58,55.2%,14m
6146,3,[WILLE]至尊小超人,3186,342,31,33,64,48.4%,23m
6146,3,tiansky,3186,229,10,3,13,76.9%,10m
6146,3,iGMacSed,3186,144,5,4,9,55.6%,22m
6146,2,Quartet,3186,162,5,5,10,50.0%,5m
6146,3,zxrai,3186,60,2,2,4,50.0%,51m
6146,3,[弹剑]TACET,3186,0,1,0,1,100.0%,5m
6146,2,[白银联盟]JKdagger,3186,0,0,1,1,0.0%,15m
6146,3,[小鸡屠宰场3]一柱擎天,3186,0,0,2,2,0.0%,21m
6158,3,[歌者II]寒夜易冷,3185,1092,48,37,85,56.5%,6m
6158,3,imbap,3185,505,21,14,35,60.0%,11m
6158,3,[菜有菜的道理]狗头人军团,3185,427,18,9,27,66.7%,29m
6158,3,为提买买河里冷西,3185,188,16,14,30,53.3%,22m
6158,3,IIIIIIIIIIII,3185,283,13,12,25,52.0%,25m
6158,3,[上古世纪]ylnx,3185,311,11,6,17,64.7%,29m
6158,3,bogy,3185,143,4,0,4,100.0%,9m
6158,3,[Rar兄弟会]Axxxxxxxxxxx,3185,30,1,9,10,10.0%,13m
6158,3,Blackjack,3185,0,0,1,1,0.0%,54m
6167,3,Fyah,3184,1235,47,53,100,47.0%,19m
6167,3,knight,3184,209,9,0,9,100.0%,51m
6167,3,灰烬之灵,3184,232,9,8,17,52.9%,25m
6167,3,Bitxxxxxxch,3184,204,7,7,14,50.0%,19m
6167,3,咕噜灵波,3184,0,1,0,1,100.0%,30m
6167,3,[瘾大眼瞎]桐予,3184,0,1,0,1,100.0%,9m
6167,3,[RTSGo]Ender,3184,30,1,3,4,25.0%,54m
6167,3,[第八舰队丶]西红柿,3184,0,0,1,1,0.0%,29m
6167,3,生无可恋,3184,0,0,1,1,0.0%,49m
6176,3,[九天星辰同萌]请不要欺负小魔影,3183,322,12,5,17,70.6%,3m
6176,3,[落魄山]咕咕咕,3183,252,9,7,16,56.2%,55m
6176,2,[我们都是萌新]似雨若离,3183,115,2,1,3,66.7%,12m
6176,3,[鸡饲料协会]大蒜拌黄瓜,3183,30,2,1,3,66.7%,23m
6176,3,[我要打11个]多吃手机身体好,3183,60,2,5,7,28.6%,8m
6176,3,LanTiss,3183,0,1,0,1,100.0%,30m
6176,3,姿势摆好了,3183,0,1,0,1,100.0%,15m
6176,3,[512]XIANGER,3183,0,1,0,1,100.0%,12m
6176,3,Nemophilist,3183,0,1,1,2,50.0%,29m
6176,3,[钉宫病]vampirelian,3183,97,1,4,5,20.0%,26m
6176,3,[LNT]妙手空空,3183,0,0,1,1,0.0%,30m
6176,3,[君临天下丶]redballs,3183,0,0,2,2,0.0%,21m
6188,3,silent,3182,1394,124,111,235,52.8%,8m
6188,3,山风流苏,3182,461,86,69,155,55.5%,55m
6188,3,[圣德怀特学园]lucifer,3182,619,23,16,39,59.0%,5m
6188,3,[SC2近卫军]icerJTR,3182,540,19,21,40,47.5%,23m
6188,2,[ESKT]偷币,3182,0,5,0,5,100.0%,25m
6188,3,刃下心,3182,141,4,0,4,100.0%,24m
6188,3,[LFZ]JustSlowly,3182,60,2,2,4,50.0%,57m
6188,2,[星歌]puddingbil,3182,0,1,1,2,50.0%,24m
6188,3,worjeff,3182,0,1,4,5,20.0%,11m
6188,3,[纸壳]降伏泰伦帝国,3182,0,0,1,1,0.0%,8m
6188,3,渡鸦鸦渡鸦鸦,3182,0,0,1,1,0.0%,30m
6188,3,[火焰雷兽]真波涛,3182,0,0,1,1,0.0%,18m
6188,1,光照之星,3182,0,0,2,2,0.0%,14m
6201,3,接化发,3181,1580,249,222,471,52.9%,55m
6201,2,南初妹妹,3181,310,92,90,182,50.5%,12m
6201,3,骑车去北京,3181,1555,66,73,139,47.5%,55m
6201,3,淡淡丶笑笑,3181,1165,52,38,90,57.8%,54m
6201,3,[Naz]lllllllllll,3181,860,41,23,64,64.1%,30m
6201,3,烤地瓜,3181,169,16,21,37,43.2%,56m
6201,1,llllllllllll,3181,206,8,4,12,66.7%,54m
6201,3,歌舞伎町之王,3181,154,6,8,14,42.9%,3m
6201,3,supernoob,3181,114,5,1,6,83.3%,29m
6201,2,天弑,3181,44,4,3,7,57.1%,24m
6201,3,[大漢]Marineking,3181,86,4,4,8,50.0%,52m
6201,3,[卡钦斯基跤流]龙啸九天,3181,30,2,1,3,66.7%,21m
6201,3,[暴雪三队]小丫丫,3181,0,1,0,1,100.0%,3m
6201,3,[极东支部]德丽莎阿波卡利斯,3181,0,0,1,1,0.0%,29m
6215,3,IIIIIIIIIIII,3180,1458,70,60,130,53.8%,22m
6215,3,NeedXue,3180,0,5,0,5,100.0%,6m
6215,3,[糖心煎蛋]给钱啥都干,3180,30,2,0,2,100.0%,52m
6215,3,[YA]David,3180,30,1,2,3,33.3%,52m
6215,3,AbAcUS,3180,0,0,1,1,0.0%,54m
6215,3,黑暗笼罩着大地,3180,0,0,9,9,0.0%,53m
6221,3,wonderful,3179,1433,79,84,163,48.5%,15m
6221,3,DeAn,3179,285,16,12,28,57.1%,7m
6221,3,Mmao,3179,298,13,2,15,86.7%,26m
6221,3,[五月花]舞殇,3179,240,8,4,12,66.7%,55m
6221,3,[JOKER]SKTpartinG,3179,218,8,7,15,53.3%,28m
6221,3,[饲料姐姐无敌]Marine,3179,172,6,5,11,54.5%,22m
6221,2,杨威利,3179,0,4,1,5,80.0%,9m
6221,3,wangfan,3179,60,2,3,5,40.0%,9m
6221,3,Cattoes,3179,30,1,1,2,50.0%,15m
6221,3,[纸壳]重创刀锋女王,3179,0,1,4,5,20.0%,26m
6231,3,恋蝶无邪,3178,1392,122,110,232,52.6%,3m
6231,3,[可可萝]优衣说噫,3178,1215,77,58,135,57.0%,20m
6231,3,大连狗哥,3178,574,25,13,38,65.8%,50m
6231,3,防不来一波,3178,462,18,14,32,56.2%,21m
6231,3,人生哲理灌汤豆,3178,283,16,10,26,61.5%,5m
6231,3,四十岁的菜鸡,3178,114,5,1,6,83.3%,56m
6231,3,[在下菜鸡一只]捍卫者,3178,146,5,5,10,50.0%,3m
6231,2,[鼎折覆餗]套套,3178,0,4,1,5,80.0%,47m
6231,3,六学神剑,3178,34,3,0,3,100.0%,55m
6231,3,[Shawk]迷人的面包,3178,0,1,0,1,100.0%,8m
6231,3,[希儿第一可爱]双生的彼岸花,3178,0,1,0,1,100.0%,12m
6231,1,以后能否如初,3178,0,1,0,1,100.0%,52m
6231,3,[金城江二中]大攻无私,3178,30,1,2,3,33.3%,25m
6231,3,Faraday,3178,30,1,4,5,20.0%,16m
6231,3,[来游戏吖]鸡饲料,3178,0,0,1,1,0.0%,25m
6246,3,LongCombo,3177,553,190,177,367,51.8%,3m
6246,3,发挥技术,3177,1243,53,47,100,53.0%,27m
6246,3,XiaoBaiChi,3177,1016,39,39,78,50.0%,51m
6246,3,maxwell,3177,214,21,28,49,42.9%,15m
6246,3,[TNL]林雨轩,3177,534,18,27,45,40.0%,4m
6246,3,[tyyt]llIIIIlllIII,3177,230,10,0,10,100.0%,26m
6246,3,LuckyMan,3177,200,8,7,15,53.3%,8m
6246,3,[堕落使徒]Handgun,3177,58,2,8,10,20.0%,19m
6246,3,如人饮水,3177,0,1,0,1,100.0%,57m
6246,3,毁灭,3177,0,1,2,3,33.3%,8m
6246,3,[地球协会]classic,3177,0,1,5,6,16.7%,15m
6246,3,[Sv]ccbb,3177,0,0,4,4,0.0%,23m
6258,3,[泉姐美如画]yelun,3176,1026,259,265,524,49.4%,55m
6258,3,[麋鹿迷路]IIIIIIIIIIII,3176,188,36,26,62,58.1%,56m
6258,3,Oos,3176,288,13,6,19,68.4%,13m
6258,3,梅春雨,3176,349,13,9,22,59.1%,56m
6258,2,此地可是白门楼,3176,410,13,30,43,30.2%,25m
6258,3,[逐火之蛾]empty,3176,291,10,5,15,66.7%,5m
6258,3,素羽流年,3176,228,9,6,15,60.0%,26m
6258,3,COLNAGO,3176,152,8,9,17,47.1%,18m
6258,3,寂灭阴影,3176,167,5,1,6,83.3%,53m
6258,3,[暴雪我是你爹]电脑玩家詹姆斯,3176,58,3,0,3,100.0%,26m
6258,3,Holiday,3176,30,1,1,2,50.0%,23m
6258,3,saide,3176,30,1,2,3,33.3%,20m
6270,3,[人人有功炼]黑眼豆豆,3175,1589,72,62,134,53.7%,51m
6270,3,iiiiiiiiiiii,3175,1216,49,46,95,51.6%,56m
6270,2,可畏天下第一,3175,384,17,5,22,77.3%,56m
6270,3,[BANDAL]MegaHouse,3175,297,10,10,20,50.0%,12m
6270,3,VioletDance,3175,211,8,3,11,72.7%,14m
6270,3,Abcd,3175,170,6,6,12,50.0%,13m
6270,3,supuo,3175,118,4,5,9,44.4%,4m
6270,3,斯巴达克斯,3175,128,4,18,22,18.2%,29m
6270,3,七七,3175,0,1,0,1,100.0%,27m
6279,3,youmentor,3174,458,18,18,36,50.0%,25m
6279,3,[Dracoi]sqrtthree,3174,304,12,10,22,54.5%,8m
6281,1,[夕颜]中华气死喵,3173,1538,220,254,474,46.4%,51m
6281,3,专打黄晓明,3173,737,136,139,275,49.5%,13m
6281,3,混沌武士,3173,1104,42,39,81,51.9%,21m
6281,3,[久美子珠宝]渣渣徽,3173,178,29,24,53,54.7%,13m
6281,3,Wuaouh,3173,601,27,27,54,50.0%,23m
6281,1,Fool,3173,188,7,4,11,63.6%,1h
6281,1,風十一郎,3173,184,6,6,12,50.0%,21m
6281,3,[Months]July,3173,120,5,4,9,55.6%,23m
6281,3,Gramto,3173,30,2,0,2,100.0%,53m
6281,3,[GDG]剑不归,3173,58,2,2,4,50.0%,30m
6281,2,漾哥打星际,3173,0,1,0,1,100.0%,1h
6281,3,flynife,3173,0,1,1,2,50.0%,26m
6281,2,[2233娘]李世民多久大量工,3173,0,0,1,1,0.0%,26m
6281,3,[校园谐恶势力]yyymgg,3173,0,0,2,2,0.0%,10m
6295,3,[暴雪三十二隊]Presents,3172,1621,202,180,382,52.9%,23m
6295,3,Aaron,3172,1428,62,48,110,56.4%,11m
6295,3,黄婷婷的口音饭,3172,358,39,36,75,52.0%,56m
6295,3,[浮夸的]msy,3172,849,32,30,62,51.6%,4m
6295,3,[TCP]西湖雅座有请,3172,626,26,20,46,56.5%,24m
6295,3,[国际第91号]classices,3172,545,23,12,35,65.7%,12m
6295,3,[xgnb]despair,3172,428,22,7,29,75.9%,7m
6295,3,Stats,3172,277,13,13,26,50.0%,12m
6295,3,Nobless,3172,161,5,2,7,71.4%,23m
6295,3,潘凤大战邢道荣,3172,34,3,5,8,37.5%,30m
6295,3,[sc扫黄大队]人沫沫,3172,30,2,0,2,100.0%,4m
6295,3,[求战队呀]Mayuri,3172,30,2,0,2,100.0%,28m
6295,3,[极俗便是雅]星际英雄,3172,0,1,0,1,100.0%,11m
6308,2,[DRI]NebuIaBackfi,3171,1484,148,131,279,53.0%,30m
6308,3,雪洁大人,3171,1609,111,110,221,50.2%,15m
6308,3,[禽禽禽]lxrismylove,3171,1493,90,91,181,49.7%,12m
6308,2,小白才不可爱,3171,1114,51,46,97,52.6%,23m
6308,3,marina,3171,242,8,9,17,47.1%,9m
6308,3,月香菱,3171,235,7,5,12,58.3%,13m
6308,3,[我们都是萌新]hero,3171,88,3,4,7,42.9%,14m
6308,3,LAN,3171,58,2,1,3,66.7%,13m
6308,3,Wilhelmine,3171,30,1,3,4,25.0%,22m
6317,3,kila,3170,892,119,105,224,53.1%,28m
6317,3,曲鹏润,3170,1357,113,98,211,53.6%,6m
6317,3,DarkSnake,3170,1113,77,73,150,51.3%,50m
6317,3,[四叶草]卡亚,3170,225,18,10,28,64.3%,13m
6317,3,dsa,3170,404,17,16,33,51.5%,27m
6317,3,文文,3170,0,1,0,1,100.0%,26m
6317,3,[XC丨星创]真实大帝,3170,0,1,1,2,50.0%,51m
6317,3,[NLH]岸回霖风,3170,0,1,1,2,50.0%,28m
6317,3,[Holyam]Yuudachi,3170,30,1,3,4,25.0%,6m
6317,3,凛冬已至,3170,0,0,2,2,0.0%,26m
6327,3,[暴雪养鸡场]Zest,3169,1313,140,115,255,54.9%,24m
6327,3,[一等星]默本无声,3169,1465,93,84,177,52.5%,22m
6327,3,五零点一,3169,880,33,37,70,47.1%,15m
6327,3,[战术性劝退]pupilczq,3169,681,30,18,48,62.5%,49m
6327,3,可导一定连续,3169,220,26,27,53,49.1%,22m
6327,3,[PKP]长颜草,3169,445,18,7,25,72.0%,11m
6327,3,[丨虫族灬战队]夜深,3169,372,15,12,27,55.6%,51m
6327,3,拉顿哈给顿,3169,298,11,13,24,45.8%,12m
6327,1,Sosi,3169,143,7,3,10,70.0%,25m
6327,3,TheShy,3169,228,7,5,12,58.3%,10m
6327,3,[一只捣蛋鸡]建设银行,3169,178,7,8,15,46.7%,15m
6327,3,IIIIIIIIIIII,3169,163,4,1,5,80.0%,21m
6327,3,[老东西]龙舌兰姑娘,3169,0,3,2,5,60.0%,1h
6327,3,[HustSC]sithlord,3169,30,2,2,4,50.0%,6m
6327,3,张润川是熊,3169,0,0,1,1,0.0%,25m
6327,3,帅到惊动党,3169,0,0,1,1,0.0%,15m
6327,3,[至高内歼]CQEDC,3169,0,0,1,1,0.0%,28m
6344,3,蓝色皮卡丘,3168,1128,92,94,186,49.5%,15m
6344,3,[韩宗快乐屋]pencil,3168,597,27,30,57,47.4%,27m
6344,3,Riricho,3168,543,20,14,34,58.8%,22m
6344,3,你别打我啊,3168,506,18,27,45,40.0%,56m
6344,3,[NLD]Catch,3168,314,12,10,22,54.5%,8m
6344,3,[Ours]IIIIIIIIIIII,3168,127,7,9,16,43.8%,23m
6344,3,[索尔特雷吉]啊啦哩啷,3168,0,4,1,5,80.0%,1h
6344,3,Alex,3168,114,4,4,8,50.0%,7m
6344,3,[AdamxL]臉基尼,3168,58,3,0,3,100.0%,5m
6344,3,那棵树生气了,3168,0,0,1,1,0.0%,5m
6344,3,[Shawk]iceCola,3168,0,0,4,4,0.0%,29m
6355,3,黄金冲击,3167,1565,67,58,125,53.6%,56m
6355,3,[倥偬]Zangll,3167,577,53,31,84,63.1%,26m
6355,3,IIIlllIIII,3167,930,34,40,74,45.9%,4m
6355,3,[老年娱乐团]时间跳跃者的妄想,3167,686,25,27,52,48.1%,55m
6355,2,IIIIIIIIIIII,3167,561,21,34,55,38.2%,55m
6355,3,钱是钱生出来的,3167,140,6,4,10,60.0%,12m
6355,3,会上树的猫,3167,123,5,8,13,38.5%,29m
6355,2,云淡风轻,3167,155,4,3,7,57.1%,27m
6355,3,[蓝鲸何平]肥宅的快乐,3167,88,3,4,7,42.9%,26m
6355,3,mingge,3167,0,1,0,1,100.0%,49m
6355,3,iNooooVation,3167,0,1,1,2,50.0%,52m
6355,3,Kurumi,3167,0,1,1,2,50.0%,51m
6355,1,筱瑜,3167,44,1,3,4,25.0%,55m
6355,3,手残泰伦,3167,0,0,2,2,0.0%,54m
6369,3,闲剑,3166,1528,183,175,358,51.1%,28m
6369,3,运营带师,3166,1508,132,126,258,51.2%,22m
6369,3,[319]给星际上柱香,3166,1414,105,73,178,59.0%,29m
6369,2,独孤战天,3166,1111,101,86,187,54.0%,12m
6369,3,NEWLYD,3166,1181,54,40,94,57.4%,53m
6369,3,PYTH,3166,905,41,26,67,61.2%,29m
6369,3,[Nin]qbq,3166,410,21,10,31,67.7%,6m
6369,1,大门牙,3166,371,18,8,26,69.2%,11m
6369,3,YoRHa,3166,317,12,1,13,92.3%,20m
6369,3,[CF]小西瓜,3166,216,6,9,15,40.0%,11m
6369,3,[miku守护]killer,3166,114,5,5,10,50.0%,13m
6369,2,[我们是无敌的]jim,3166,167,4,3,7,57.1%,34m
6369,1,[何故空留殇]Tong,3166,96,2,1,3,66.7%,1h
6369,2,[千杯酒酬知己]BlueSun,3166,116,2,2,4,50.0%,1h
6369,3,[WingsS]YNYN,3166,0,1,0,1,100.0%,12m
6369,3,小灰灰梁,3166,30,1,2,3,33.3%,53m
6369,2,[月野兔]啊啊啊的小仙女,3166,0,0,1,1,0.0%,1h
6386,3,ARbitrator,3165,1418,318,305,623,51.0%,56m
6386,3,[KPG]咕咕王,3165,1572,133,105,238,55.9%,55m
6386,3,[loveMM]Khala,3165,1523,105,101,206,51.0%,52m
6386,3,爱抚玖喵,3165,999,42,32,74,56.8%,55m
6386,3,lliilliiiiii,3165,222,9,8,17,52.9%,50m
6386,3,混元形意太极门,3165,208,7,10,17,41.2%,4m
6386,1,甘大神,3165,97,5,3,8,62.5%,1h
6386,3,huzhang,3165,0,4,1,5,80.0%,2m
6386,3,无名之辈,3165,0,4,1,5,80.0%,1h
6386,3,[幽靈客船]莉莉白,3165,0,1,1,2,50.0%,14m
6386,3,后排优等生,3165,0,0,2,2,0.0%,56m
6397,3,Tany,3164,1585,123,126,249,49.4%,19m
6397,3,玲音,3164,800,91,72,163,55.8%,6m
6397,3,诸司马迹,3164,1222,50,53,103,48.5%,14m
6397,3,你翔哥,3164,144,4,2,6,66.7%,13m
6397,1,hugo,3164,0,4,2,6,66.7%,23m
6397,3,[神圣]呆头部落,3164,118,3,0,3,100.0%,9m
6397,3,不要慌张,3164,0,3,1,4,75.0%,38m
6397,3,今天你动脑了吗,3164,60,3,2,5,60.0%,12m
6397,2,你打星际像蔡徐坤,3164,38,2,6,8,25.0%,15m
6397,3,[半岛铁盒]周杰伦,3164,0,1,0,1,100.0%,30m
6397,3,llOrzll,3164,30,1,1,2,50.0%,12m
6397,3,侠客,3164,30,1,2,3,33.3%,26m
6409,3,[二五仔联盟]晨星,3163,1629,213,200,413,51.6%,9m
6409,3,决不投降,3163,1586,65,53,118,55.1%,28m
6409,3,LLDXI,3163,570,37,19,56,66.1%,53m
6409,3,小姊姊,3163,459,20,9,29,69.0%,10m
6409,3,[栗子栗子栗]栗子,3163,204,14,0,14,100.0%,12m
6409,3,菜到没赢过,3163,324,14,14,28,50.0%,9m
6409,3,muhahaha,3163,264,10,7,17,58.8%,27m
6409,3,流云飞月,3163,199,8,3,11,72.7%,4m
6409,3,[APM30]LGHK,3163,163,5,0,5,100.0%,4m
6409,3,Rampant,3163,0,1,0,1,100.0%,52m
6409,3,[ZTSCAP]Pray,3163,0,1,0,1,100.0%,1h
6409,3,[浪啊浪]潇潇梧桐,3163,30,1,2,3,33.3%,4m
6409,3,[我棱镜掉了]Rether,3163,0,0,1,1,0.0%,23m
6422,3,[Tov]燕北飞,3162,1054,56,48,104,53.8%,10m
6422,3,[SK]IIIIIIIII,3162,181,6,1,7,85.7%,26m
6422,3,窝使逆霸霸,3162,142,5,4,9,55.6%,13m
6422,2,FsAIMIcy,3162,126,2,3,5,40.0%,55m
6422,3,Sorry,3162,0,1,0,1,100.0%,27m
6422,3,我来修地堡了,3162,0,1,0,1,100.0%,9m
6422,3,[第八舰队丶]风炎旗帜,3162,0,0,1,1,0.0%,29m
6422,3,DETR,3162,0,0,1,1,0.0%,26m
6422,3,我的女友邓紫棋,3162,0,0,1,1,0.0%,5m
6422,2,[腥基佬男骸]极客大会,3162,0,0,1,1,0.0%,26m
6432,3,[Vgirls]NeverLose,3161,634,153,138,291,52.6%,11m
6432,3,[圣晶石搬运队]lancelotvvv,3161,1487,129,123,252,51.2%,30m
6432,3,IIIIIIIIIIII,3161,552,76,78,154,49.4%,54m
6432,3,雷霆咆哮,3161,1172,47,36,83,56.6%,4m
6432,3,[妈个鸡诶]IIIIIIIIII,3161,167,42,36,78,53.8%,23m
6432,3,[奶茶三兄弟]今晚那个吗,3161,707,31,24,55,56.4%,16m
6432,3,啊啊刻晴我干了,3161,42,6,4,10,60.0%,54m
6432,3,[枪兵滾毒爆]神之长子,3161,104,5,0,5,100.0%,23m
6432,1,szg,3161,160,5,6,11,45.5%,13m
6432,3,[战意不熄]叹云兮,3161,114,4,4,8,50.0%,18m
6432,3,loveY,3161,93,2,4,6,33.3%,4m
6432,2,[悟了]谐神小绵羊,3161,0,1,0,1,100.0%,52m
6444,3,川陀的园丁,3160,1353,62,53,115,53.9%,13m
6444,3,plove,3160,461,59,30,89,66.3%,12m
6444,3,GJST,3160,1105,59,46,105,56.2%,8m
6444,3,[NPUED]ShauN,3160,417,38,26,64,59.4%,9m
6444,3,[最菜战队]kayanon,3160,556,26,21,47,55.3%,24m
6444,3,我说文政帅,3160,379,24,26,50,48.0%,14m
6444,2,[第999舰队]风暴,3160,229,20,25,45,44.4%,10m
6444,3,apsmxhh,3160,198,8,5,13,61.5%,25m
6444,3,[叫我兔本]伤痛之刺,3160,144,6,4,10,60.0%,18m
6444,3,[埃萌愚忠分子]ExtraStonKs,3160,180,6,9,15,40.0%,9m
6444,2,暗夜骑士,3160,170,5,3,8,62.5%,23m
6444,3,[幽冥之狼]峰哥,3160,144,5,8,13,38.5%,7m
6444,2,[盲人协会]jzq,3160,120,3,0,3,100.0%,12m
6444,3,[北有吾王]jessie,3160,114,2,1,3,66.7%,54m
6444,1,明朝流苏,3160,96,1,1,2,50.0%,50m
6444,3,[Unique]MiAmor,3160,30,1,3,4,25.0%,56m
6444,3,[一对的神兽]高丽野阿吽,3160,0,0,1,1,0.0%,26m
6444,3,废铁二号,3160,0,0,1,1,0.0%,10m
6462,3,少年祭,3159,662,26,24,50,52.0%,2m
6462,3,[丨SLT丨]Yurisa,3159,160,4,1,5,80.0%,7m
6462,3,Anakin,3159,30,2,1,3,66.7%,10m
6462,3,[星之所在RI]迷茫星空,3159,30,2,1,3,66.7%,12m
6462,3,Dark,3159,58,2,2,4,50.0%,11m
6462,3,朱旭宇,3159,0,1,0,1,100.0%,9m
6462,3,黑色守望,3159,30,1,2,3,33.3%,53m
6462,3,[无可厚肥]安静,3159,0,1,3,4,25.0%,24m
6462,3,想好名字在重新改,3159,0,0,1,1,0.0%,12m
6462,3,水牛机,3159,0,0,1,1,0.0%,54m
6462,3,[野人time]大和炮打探姬,3159,0,0,1,1,0.0%,56m
6462,2,[王者归来]小智,3159,0,0,1,1,0.0%,1h
6462,3,[2对2大师]只会刷机枪兵,3159,0,0,1,1,0.0%,19m
6475,3,脑瘀血玩家,3158,444,20,9,29,69.0%,26m
6475,3,[白给WUST]帅气的阿鸣,3158,220,10,4,14,71.4%,19m
6475,3,[人族都是狗]KomoDo,3158,60,2,9,11,18.2%,18m
6475,3,[幽金贮藏堆]blackjiuye,3158,0,0,1,1,0.0%,5m
6475,3,Hades,3158,0,0,1,1,0.0%,15m
6480,2,Kirtio,3157,1482,301,304,605,49.8%,4m
6480,3,yuan,3157,1577,259,232,491,52.7%,4m
6480,3,llllllllllll,3157,591,48,30,78,61.5%,8m
6480,3,Gray,3157,801,47,43,90,52.2%,56m
6480,3,[喵呜喵呜]瞧本,3157,432,18,10,28,64.3%,55m
6480,3,十系,3157,412,15,20,35,42.9%,14m
6480,2,[快乐糖活]Hibiki,3157,157,4,2,6,66.7%,51m
6480,3,cappuccino,3157,60,2,2,4,50.0%,9m
6480,3,霸气侧漏小阿龙,3157,30,2,3,5,40.0%,14m
6480,3,寂寞冷少,3157,30,1,2,3,33.3%,54m
6490,3,Coilrain,3156,1445,297,281,578,51.4%,22m
6490,3,[NCEPU]那年冬天,3156,1583,202,194,396,51.0%,3m
6490,3,[王霸胆老板]napoleon,3156,556,25,12,37,67.6%,50m
6490,3,[净罪的殉仪]KousakaReina,3156,409,18,11,29,62.1%,5m
6490,3,zxyking,3156,394,17,11,28,60.7%,9m
6490,3,[不要TVT]朱晨文的账号,3156,219,15,20,35,42.9%,14m
6490,3,[KPG]brownners,3156,262,8,6,14,57.1%,12m
6490,2,IIIIIIIIIIII,3156,263,8,7,15,53.3%,51m
6490,2,嘉雯泪痕,3156,121,5,2,7,71.4%,57m
6490,3,[呆毛来我迦]Avalon,3156,58,3,2,5,60.0%,52m
6490,3,沙坪坝勇士,3156,58,2,2,4,50.0%,25m
6490,3,千年幻想,3156,58,2,8,10,20.0%,22m
6490,2,CCYyo,3156,0,1,0,1,100.0%,1h
6490,3,莹络,3156,0,1,0,1,100.0%,22m
6490,3,[快乐就完事儿]Louisia,3156,30,1,2,3,33.3%,23m
6490,3,[为了地球]伊格古德曼,3156,0,0,1,1,0.0%,21m
6490,3,tianxuan,3156,0,0,1,1,0.0%,25m
6490,3,[YINGJI]曹老板,3156,0,0,1,1,0.0%,22m
6490,3,陈琛,3156,0,0,2,2,0.0%,4m
6490,3,[小无相功]在下鸠摩智,3156,0,0,4,4,0.0%,5m
6510,3,猩猩,3155,1240,93,87,180,51.7%,21m
6510,3,[好男人就是我]杰哥,3155,1315,76,74,150,50.7%,2m
6510,3,Nebula,3155,846,75,61,136,55.1%,22m
6510,2,困难电脑,3155,117,3,1,4,75.0%,51m
6510,3,[水光潋滟]AliceOU,3155,86,3,4,7,42.9%,29m
6510,3,[INS48]Fors,3155,30,1,2,3,33.3%,22m
6510,3,[雄兵天降]Catde,3155,0,0,1,1,0.0%,4m
6510,3,[老王睿智]小郑公主,3155,0,0,1,1,0.0%,24m
6510,3,[永不灭的战火]qinshou,3155,0,0,1,1,0.0%,53m
6510,3,[SCJWJ3]夜愿,3155,0,0,1,1,0.0%,12m
6510,3,你的好友,3155,0,0,1,1,0.0%,55m
6510,1,[飞云之上]孤独的影子,3155,0,0,1,1,0.0%,30m
6510,3,一个小小小菜鸟,3155,0,0,7,7,0.0%,50m
6523,3,煎蛋豆角红烧肉,3154,1462,319,288,607,52.6%,26m
6523,3,路桥,3154,904,43,34,77,55.8%,19m
6523,2,DisAster,3154,95,6,1,7,85.7%,6m
6523,2,胎神,3154,0,1,3,4,25.0%,27m
6523,3,[暴雪我是你爹]德日天,3154,0,1,4,5,20.0%,1h
6523,3,没有胡子的老柴,3154,0,0,1,1,0.0%,4m
6523,3,[风神少女]射命丸文,3154,0,0,1,1,0.0%,24m
6523,3,[动能矩阵开启]yyccvwic,3154,0,0,4,4,0.0%,22m
6531,3,Tany,3153,1310,71,75,146,48.6%,3m
6531,3,IIIIIIIIIIII,3153,1308,52,53,105,49.5%,9m
6531,3,alphaH,3153,131,40,24,64,62.5%,29m
6531,3,[废铁舰队]SCPLAYER,3153,563,26,22,48,54.2%,54m
6531,2,Yolooooooo,3153,349,12,5,17,70.6%,21m
6531,3,[万X奔腾]步兵,3153,181,6,3,9,66.7%,9m
6531,3,[白给丶兄弟]麦麦的春紫苑,3153,144,5,7,12,41.7%,14m
6531,3,[火焰雷兽]wlikel,3153,122,5,7,12,41.7%,21m
6531,3,[职业白给团队]西湖底雅座一位,3153,88,4,4,8,50.0%,8m
6531,3,[你要跳舞吗]TommyDiros,3153,30,2,2,4,50.0%,27m
6531,3,karasy,3153,0,0,1,1,0.0%,55m
6531,3,[高阶级执政官]oulli,3153,0,0,1,1,0.0%,14m
6531,3,[贪玩]Ramsey,3153,0,0,1,1,0.0%,15m
6544,3,Aries,3152,1495,121,122,243,49.8%,25m
6544,3,[l同化完成l]phantom,3152,1563,116,115,231,50.2%,52m
6544,3,鶸乚,3152,1518,75,72,147,51.0%,29m
6544,3,gezhenrui,3152,604,56,43,99,56.6%,9m
6544,3,[FlaSh啊]涛涛涛涛套子,3152,174,27,43,70,38.6%,15m
6544,3,[Eve联盟]中老年妇女之友,3152,666,23,31,54,42.6%,57m
6544,3,[小三爷]IIIIIIIIIIII,3152,530,19,22,41,46.3%,30m
6544,3,Juhe,3152,335,16,22,38,42.1%,10m
6544,3,男人就该干男人,3152,356,13,15,28,46.4%,6m
6544,3,[星际旅游团]asgardking,3152,158,9,4,13,69.2%,24m
6544,2,EASONwyc,3152,95,5,2,7,71.4%,34m
6544,3,[寒冰不朽]坑人西瓜侠,3152,117,3,0,3,100.0%,56m
6544,3,苏艺瑶,3152,0,3,3,6,50.0%,3m
6544,1,[FPT]BrisTorch,3152,118,2,7,9,22.2%,1h
6544,2,[有趣]MelonPan,3152,0,0,1,1,0.0%,38m
6544,1,[谢拉单推人]音羽,3152,0,0,1,1,0.0%,12m
6560,3,[风后奇门]DeliciousVii,3151,1376,92,72,164,56.1%,55m
6560,3,issenven,3151,1453,72,51,123,58.5%,22m
6560,3,泳于樱色之海,3151,672,33,24,57,57.9%,20m
6560,3,Arbiter,3151,496,25,21,46,54.3%,12m
6560,3,星易,3151,534,24,25,49,49.0%,25m
6560,3,沧海客,3151,370,15,8,23,65.2%,29m
6560,3,[3Ky]Rabbit,3151,365,14,11,25,56.0%,21m
6560,3,[Borne]翩跹,3151,232,9,13,22,40.9%,16m
6560,3,[CNboys]Linford,3151,0,1,0,1,100.0%,13m
6560,2,[STKT]SkYriM,3151,0,0,1,1,0.0%,8m
6560,3,虚空,3151,0,0,1,1,0.0%,3m
6560,2,丸山彩修车协会,3151,0,0,2,2,0.0%,19m
6560,3,Ice,3151,0,0,2,2,0.0%,60m
6573,3,忘忧岛,3150,1066,273,255,528,51.7%,24m
6573,3,leakers,3150,1505,233,199,432,53.9%,22m
6573,3,DesayGrace,3150,1330,120,79,199,60.3%,16m
6573,3,苇怡是炜青的唯一,3150,1249,69,57,126,54.8%,6m
6573,3,随便干的二五仔,3150,1319,58,51,109,53.2%,7m
6573,3,Nice,3150,1356,57,47,104,54.8%,51m
6573,3,[法兰街舞队w]Arthas,3150,211,10,6,16,62.5%,25m
6573,3,[科普卢菜鸡]ttttwwww,3150,236,8,5,13,61.5%,13m
6573,3,tyrantjay,3150,123,7,3,10,70.0%,12m
6573,3,Ljc,3150,207,6,3,9,66.7%,28m
6573,3,菲尔,3150,127,6,4,10,60.0%,56m
6573,3,我大哥孙一峰,3150,0,4,1,5,80.0%,20m
6573,3,[KPG]万俟泓旭,3150,0,4,1,5,80.0%,1h
6573,3,乐山孙一峰,3150,116,4,4,8,50.0%,29m
6573,3,[小金上天队]表情大师,3150,18,2,0,2,100.0%,13m
6573,3,只会用鼠标,3150,0,1,0,1,100.0%,13m
6573,3,wxhssg,3150,0,1,0,1,100.0%,11m
6573,3,phh,3150,0,1,0,1,100.0%,29m
6573,3,FRORE,3150,0,0,1,1,0.0%,54m
6592,3,[Beasty]cyberflower,3149,1156,314,303,617,50.9%,7m
6592,3,[TCP]Lough,3149,855,35,39,74,47.3%,55m
6592,2,[JUELE]JUELE,3149,346,11,7,18,61.1%,20m
6592,3,墨千澪,3149,235,10,6,16,62.5%,56m
6592,3,萌受,3149,178,6,6,12,50.0%,29m
6592,1,[战争巫妖]巫妖王的承诺,3149,184,4,2,6,66.7%,16m
6592,3,邦女郎,3149,60,2,3,5,40.0%,11m
6592,3,[黎明航向]夕月,3149,0,1,0,1,100.0%,54m
6592,3,[此乃白门楼]IlIlIlIlIlIl,3149,0,1,0,1,100.0%,12m
6592,3,[NLPA]五丈原之星,3149,0,0,1,1,0.0%,16m
6592,2,凯恩恩,3149,0,0,1,1,0.0%,1h
6592,3,XIaoyang,3149,0,0,1,1,0.0%,10m
6592,3,[时空巡逻队]大神官,3149,0,0,1,1,0.0%,54m
6592,3,[我很弱]starboy,3149,0,0,1,1,0.0%,12m
6606,3,英胸,3148,1580,121,96,217,55.8%,28m
6606,3,[怼彪]流浪的兔子,3148,1539,116,121,237,48.9%,22m
6606,3,小反弹,3148,890,70,60,130,53.8%,29m
6606,3,yyyyyyy,3148,1269,67,33,100,67.0%,8m
6606,3,我玩你,3148,941,61,40,101,60.4%,25m
6606,3,白菜,3148,307,11,8,19,57.9%,16m
6606,3,kanGaXX,3148,237,7,11,18,38.9%,4m
6606,3,[就是现在]火化他们,3148,30,2,2,4,50.0%,6m
6606,2,[浪啊浪]Ghost,3148,0,1,0,1,100.0%,26m
6606,2,[单人模拟战]简单电脑,3148,0,1,0,1,100.0%,11m
6606,3,[真正的粉丝]痛击我的队友,3148,30,1,3,4,25.0%,57m
6606,3,[肥宅香蕉船]夜刀神,3148,0,1,3,4,25.0%,23m
6606,3,[InsS]陆离,3148,0,0,1,1,0.0%,7m
6606,3,[凯露天下第一]AkiRinco,3148,0,0,1,1,0.0%,53m
6606,3,[白给WUST]LCzxf,3148,0,0,2,2,0.0%,19m
6621,3,XIALI,3147,788,34,27,61,55.7%,8m
6621,3,efly,3147,171,26,20,46,56.5%,2m
6621,3,Biturbo,3147,283,24,18,42,57.1%,22m
6621,3,dhdh,3147,517,22,16,38,57.9%,4m
6621,3,某科学的咕咕码,3147,203,9,4,13,69.2%,24m
6621,3,chjn,3147,216,9,10,19,47.4%,56m
6621,3,lingo,3147,148,6,7,13,46.2%,56m
6621,3,baby,3147,0,5,0,5,100.0%,20m
6621,3,五河士道,3147,114,3,0,3,100.0%,13m
6621,2,[WTFTM]菜出境界,3147,121,3,2,5,60.0%,23m
6621,2,cyc,3147,138,3,6,9,33.3%,1h
6621,3,[Beasty]三体执政圣堂武士,3147,30,2,1,3,66.7%,25m
6621,3,vircent,3147,43,2,2,4,50.0%,14m
6621,3,[铁华团何平]Coydxw,3147,58,2,3,5,40.0%,4m
6621,3,天使联盟,3147,0,1,0,1,100.0%,4m
6621,3,[亦菲物语]泡泡的天空,3147,0,0,1,1,0.0%,12m
6621,3,[DAK]BlackNight,3147,0,0,1,1,0.0%,52m
6621,3,[第九駆逐鑑隊]pentakill,3147,0,0,1,1,0.0%,12m
6639,3,[HUC铭心]潇洒猪,3146,940,85,68,153,55.6%,19m
6639,3,[闽都]氵沐清沨,3146,128,29,38,67,43.3%,29m
6639,3,nightinfall,3146,541,23,24,47,48.9%,29m
6639,3,莽汉亲你的小菊花,3146,334,19,19,38,50.0%,22m
6639,3,Shylock,3146,274,10,15,25,40.0%,25m
6639,3,Sakura,3146,175,7,1,8,87.5%,6m
6639,3,[VirGo]虎牢关卫星哥,3146,198,7,4,11,63.6%,15m
6639,3,粉红小兔兔,3146,92,4,5,9,44.4%,54m
6639,3,利维亚的杰洛特,3146,92,4,5,9,44.4%,13m
6639,3,[城市建设集团]JOKE,3146,137,3,4,7,42.9%,6m
6639,3,[iGMM]林星月,3146,119,2,1,3,66.7%,7m
6639,2,[WIE]Colin,3146,0,1,0,1,100.0%,51m
6639,3,[时光荏苒]小浩,3146,30,1,3,4,25.0%,22m
6639,3,[盲人康复院]头像越粉一波越狠,3146,0,0,1,1,0.0%,12m
6639,2,[追梦赤子心]阿甘,3146,0,0,1,1,0.0%,21m
6639,3,[咏春]萌纳龙,3146,0,0,2,2,0.0%,23m
6655,3,[暴雪我是你爹]TinY,3145,1576,199,196,395,50.4%,52m
6655,3,叫我影魔哥,3145,1521,65,76,141,46.1%,9m
6655,3,smtmn,3145,1087,56,46,102,54.9%,12m
6655,3,[梁山泊]jack,3145,1004,37,37,74,50.0%,6m
6655,3,[UNSC海军]玛修基列莱特,3145,338,13,15,28,46.4%,27m
6655,3,[暴兵军团]欲望之血,3145,356,12,19,31,38.7%,8m
6655,3,[最菜战队]萨古拉斯之刃,3145,199,7,1,8,87.5%,25m
6655,3,越今朝,3145,159,5,2,7,71.4%,11m
6655,3,暴躁萝莉,3145,30,2,2,4,50.0%,29m
6655,3,灵性小黑娃,3145,0,1,0,1,100.0%,50m
6655,3,东成西就,3145,0,1,2,3,33.3%,28m
6655,3,[第八舰队丶]湊阿库娅,3145,30,1,4,5,20.0%,4m
6655,3,[AgCu电池]INoVatio,3145,0,0,1,1,0.0%,50m
6655,3,新的开始,3145,0,0,1,1,0.0%,19m
6655,3,老带鱼,3145,0,0,1,1,0.0%,13m
6670,3,你的爱丽丝,3144,1697,177,166,343,51.6%,29m
6670,3,IlllIIIIIlll,3144,1521,80,82,162,49.4%,57m
6670,3,[淦1]刘大炮,3144,1133,45,39,84,53.6%,55m
6670,3,[HeroZP]激动无脑艾斯蒂,3144,300,25,20,45,55.6%,53m
6670,3,[Ehire]海淀马保国,3144,530,20,15,35,57.1%,7m
6670,3,战闪新星,3144,400,16,9,25,64.0%,22m
6670,3,[握槽皮好痒]防不来一波,3144,358,14,13,27,51.9%,14m
6670,3,fafafa,3144,58,2,3,5,40.0%,11m
6670,3,[TCP]Snorlax,3144,0,1,0,1,100.0%,19m
6670,3,[沧月女装协会]坤坤是我大哥,3144,0,1,0,1,100.0%,13m
6670,3,[玉虚门下]清源妙道真君,3144,96,1,1,2,50.0%,30m
6670,3,[遁去的壹]CarlYJQ,3144,0,1,1,2,50.0%,6m
6670,3,[蒽嗒若塔萨达]星际战争,3144,0,0,1,1,0.0%,16m
6670,3,Marauder,3144,0,0,3,3,0.0%,8m
6684,3,[马辉没有马]丿年少灬有为,3143,1051,116,90,206,56.3%,16m
6684,3,[刺蛇互助协会]祝暴雪早日倒闭,3143,1371,107,93,200,53.5%,22m
6684,3,野蛮人,3143,642,31,8,39,79.5%,23m
6684,3,[0216]llfm,3143,567,23,20,43,53.5%,30m
6684,3,二愣青年,3143,279,14,11,25,56.0%,9m
6684,3,魔法之龟,3143,225,10,5,15,66.7%,13m
6684,1,[KPG2]蛮力之枭,3143,218,8,5,13,61.5%,25m
6684,3,千叶叶赛高,3143,92,4,10,14,28.6%,52m
6684,3,hououyinkyou,3143,58,3,2,5,60.0%,29m
6684,3,IIIIIIIIIIII,3143,0,1,0,1,100.0%,22m
6684,3,[小狐狸]fsagfsag,3143,0,1,3,4,25.0%,22m
6684,3,[空中劈叉]兰夜行歌,3143,0,0,1,1,0.0%,18m
6684,3,[四叶草]学霸教我数理化,3143,0,0,1,1,0.0%,8m
6697,3,[四叶草]xyxyxyxyxy,3142,94,2,0,2,100.0%,10m
6697,3,就我吗,3142,0,2,3,5,40.0%,1h
6697,3,对面有七个人干我,3142,58,2,5,7,28.6%,5m
6697,2,[矿物储量过足]命运捉弄着我,3142,94,1,1,2,50.0%,16m
6697,3,smithereens,3142,0,0,1,1,0.0%,56m
6697,3,呼叫舰队,3142,0,0,1,1,0.0%,10m
6703,3,[TAPC]zny,3141,1572,172,163,335,51.3%,21m
6703,3,[火焰雷兽]洋的很,3141,1433,170,169,339,50.1%,15m
6703,3,[为了艾尔pp]陈安,3141,450,20,8,28,71.4%,12m
6703,3,[大雨的逆袭]儿子,3141,383,17,7,24,70.8%,6m
6703,3,[糯米丸子]knjj,3141,223,13,14,27,48.1%,29m
6703,3,[戊戌六君子]dimolto,3141,290,11,5,16,68.8%,26m
6703,3,[TNLet]priMuS,3141,140,5,13,18,27.8%,25m
6703,3,且听风起,3141,122,4,6,10,40.0%,15m
6703,3,Seglcone,3141,113,3,0,3,100.0%,12m
6703,3,Unique,3141,118,3,1,4,75.0%,25m
6703,3,[SCVF2]未知目标,3141,30,2,3,5,40.0%,4m
6703,3,浴血荣耀,3141,0,1,0,1,100.0%,1h
6703,3,[专业单一小组]MomKiller,3141,0,1,0,1,100.0%,5m
6703,3,Splendeur,3141,0,0,1,1,0.0%,53m
6717,3,[宗师一起上]莽夫,3140,1588,231,220,451,51.2%,22m
6717,3,Johnnie,3140,1170,43,51,94,45.7%,6m
6717,3,麦克阿色,3140,889,38,31,69,55.1%,51m
6717,3,frozenking,3140,377,37,27,64,57.8%,54m
6717,3,Amazry,3140,359,32,23,55,58.2%,7m
6717,3,南城酒,3140,625,30,17,47,63.8%,18m
6717,3,百里戕梅,3140,558,21,24,45,46.7%,54m
6717,3,[喜欢自定义]聖韻,3140,332,13,9,22,59.1%,4m
6717,3,埃蒙,3140,97,4,2,6,66.7%,15m
6717,3,Lynn,3140,166,4,3,7,57.1%,57m
6717,3,[格里芬克鲁格]SadLemon,3140,65,3,3,6,50.0%,25m
6717,3,[鬼谷]后树,3140,46,2,4,6,33.3%,25m
6717,3,Warspite,3140,94,1,4,5,20.0%,57m
6717,3,[NTOS]DaXun,3140,0,1,5,6,16.7%,4m
6717,3,EnTaroZertul,3140,0,0,1,1,0.0%,15m
6717,3,pai,3140,0,0,3,3,0.0%,12m
6733,2,[Beasty]关灯吃面,3139,1528,748,727,1475,50.7%,16m
6733,3,[8kmage]风逸,3139,539,80,50,130,61.5%,15m
6733,3,[综合酯法]KasuganoSora,3139,1216,62,32,94,66.0%,30m
6733,3,毒奶大豹,3139,869,42,32,74,56.8%,51m
6733,3,靓仔,3139,699,39,36,75,52.0%,53m
6733,3,Valuntyn,3139,490,26,28,54,48.1%,26m
6733,3,塔兰托之夜,3139,406,19,6,25,76.0%,4m
6733,3,[IBE]乾坤,3139,122,13,5,18,72.2%,5m
6733,3,[暴民永不低头]某科学的吉太,3139,106,13,8,21,61.9%,15m
6733,3,[幽冥之狼]TheOverMind,3139,294,10,20,30,33.3%,25m
6733,3,Pudge,3139,0,4,1,5,80.0%,55m
6733,3,[嘟嘟嘟噜]melodydei,3139,136,4,2,6,66.7%,10m
6733,3,不知道打什么族,3139,92,4,3,7,57.1%,8m
6733,3,checkmate,3139,58,3,3,6,50.0%,57m
6733,1,从前有只猫,3139,95,2,0,2,100.0%,1h
6733,3,[灵轩阁]上官轩宇,3139,94,2,0,2,100.0%,18m
6733,3,laya,3139,0,1,0,1,100.0%,9m
6733,2,王者小爱,3139,0,1,0,1,100.0%,12m
6733,3,苏双羊,3139,0,0,1,1,0.0%,52m
6733,3,阿克苏大苹果,3139,0,0,1,1,0.0%,24m
6733,3,[GOTAL]Sanae,3139,0,0,2,2,0.0%,3m
6733,3,[DZJ]SesLadyA,3139,0,0,3,3,0.0%,55m
6755,3,瞎子,3138,1541,190,183,373,50.9%,21m
6755,3,[艾尔之巅]yulong,3138,1504,154,149,303,50.8%,25m
6755,3,[老油条战队]机枪兵都死了,3138,1123,59,59,118,50.0%,15m
6755,3,汪汪先生,3138,901,43,30,73,58.9%,22m
6755,3,[最菜战队]枫辰,3138,603,23,22,45,51.1%,11m
6755,3,SILENCE,3138,425,21,7,28,75.0%,50m
6755,3,Prothean,3138,333,16,9,25,64.0%,22m
6755,3,[IGS]龙一,3138,362,14,14,28,50.0%,57m
6755,3,克罗米,3138,341,12,9,21,57.1%,56m
6755,3,[菜鸡球带]木有小丁丁,3138,239,9,6,15,60.0%,5m
6755,3,[至诚娱乐]IIIIIIIIIIII,3138,119,6,3,9,66.7%,20m
6755,3,[妖馆]教练我要学星际,3138,133,4,0,4,100.0%,25m
6755,3,[Booldy]今天真热啊,3138,126,4,0,4,100.0%,54m
6755,2,hypocrite,3138,0,4,2,6,66.7%,1h
6755,3,[KSARet]半个吉姆,3138,94,4,12,16,25.0%,56m
6755,3,手残纯属瞎玩,3138,114,2,2,4,50.0%,18m
6755,3,[冰蓝圣痕]夜尽天明,3138,0,1,0,1,100.0%,13m
6755,3,IIIIIIIIIIII,3138,0,1,1,2,50.0%,12m
6755,3,[Icer]Nevermore,3138,0,0,1,1,0.0%,26m
6755,2,[第二位面]幻想紫鲤鱼,3138,0,0,1,1,0.0%,1h
6775,2,Armstrong,3137,701,114,105,219,52.1%,26m
6775,3,IIIIIIIIIIII,3137,951,39,32,71,54.9%,50m
6775,3,芜湖航班,3137,753,38,15,53,71.7%,53m
6775,3,[Embers]YDM,3137,893,37,30,67,55.2%,55m
6775,3,happyend,3137,894,34,32,66,51.5%,22m
6775,3,DesertX,3137,819,33,28,61,54.1%,12m
6775,3,sdaw,3137,497,28,28,56,50.0%,30m
6775,3,Nyalotha,3137,518,27,8,35,77.1%,53m
6775,2,孤儿喜欢机械化,3137,544,19,40,59,32.2%,30m
6775,3,冰糖葫芦五加皮,3137,108,18,4,22,81.8%,10m
6775,3,始乱终逆,3137,373,15,10,25,60.0%,29m
6775,3,易小函,3137,261,12,7,19,63.2%,56m
6775,3,[狼王]祼筿蠡,3137,211,7,4,11,63.6%,25m
6775,3,SomnusM,3137,156,4,3,7,57.1%,57m
6775,3,ktflashgtg,3137,60,3,3,6,50.0%,19m
6775,3,IIIIIIIIIIII,3137,95,1,1,2,50.0%,9m
6775,1,李昂,3137,95,1,1,2,50.0%,1h
6775,3,[白鲸造船厂]大藏游星,3137,0,0,1,1,0.0%,5m
6793,3,庞白,3136,1274,123,97,220,55.9%,4m
6793,3,Hero,3136,1060,105,101,206,51.0%,12m
6793,3,[XXHZ0]一只恋厨,3136,1504,80,64,144,55.6%,29m
6793,3,player,3136,1088,63,57,120,52.5%,19m
6793,3,wdnmd,3136,418,17,11,28,60.7%,52m
6793,3,不考虑野水晶吗,3136,343,16,6,22,72.7%,29m
6793,3,Layton,3136,324,15,12,27,55.6%,13m
6793,3,UNKNOWN,3136,250,11,4,15,73.3%,55m
6793,3,ghost,3136,249,10,6,16,62.5%,51m
6793,3,鹿野良,3136,95,6,0,6,100.0%,50m
6793,3,Serral,3136,155,4,9,13,30.8%,25m
6793,3,[SUSTC]zero,3136,30,1,4,5,20.0%,56m
6793,3,孙哥的最爱佳慧,3136,0,0,1,1,0.0%,11m
6806,3,金联联长,3135,1395,79,61,140,56.4%,57m
6806,3,[DMRc]光酱咚咚光酱咚咚,3135,542,43,34,77,55.8%,19m
6806,3,Ulysses,3135,904,35,31,66,53.0%,56m
6806,3,全村之希望,3135,683,33,16,49,67.3%,9m
6806,3,[虚拟歌手团体]乐正绫,3135,644,33,21,54,61.1%,57m
6806,3,[狂野战队]龘龘龘龘龘龘龘龘,3135,715,32,24,56,57.1%,51m
6806,3,[我为何这么谐]流星丿半醉巴黎,3135,143,19,2,21,90.5%,5m
6806,3,[型月重工厂]Tohsaka,3135,220,14,6,20,70.0%,26m
6806,3,forever,3135,348,13,9,22,59.1%,13m
6806,3,[X英雄圣域X]tbcome,3135,210,7,3,10,70.0%,4m
6806,3,[火炬的合法]田哥不要啊,3135,153,6,1,7,85.7%,25m
6806,3,列车准点,3135,88,4,7,11,36.4%,55m
6806,3,IIIIIIII,3135,60,3,2,5,60.0%,13m
6806,3,FeE,3135,94,2,0,2,100.0%,4m
6806,3,[Borne]文人秋月,3135,58,2,3,5,40.0%,7m
6806,3,天下无敌,3135,60,2,4,6,33.3%,12m
6806,2,张海资,3135,0,1,0,1,100.0%,23m
6806,3,[IMRTS]简单电脑,3135,0,1,2,3,33.3%,1h
6824,3,[Beastp]HNC,3134,1576,317,308,625,50.7%,24m
6824,3,ProtoSeed,3134,1553,246,241,487,50.5%,26m
6824,3,[XXHZ33]人菜瘾大,3134,1396,79,72,151,52.3%,53m
6824,3,天下为公,3134,917,75,64,139,54.0%,3m
6824,3,环彩羽,3134,1304,50,55,105,47.6%,5m
6824,3,名字不能俗,3134,569,37,21,58,63.8%,7m
6824,3,牛奶是个萌妹子,3134,680,36,43,79,45.6%,7m
6824,3,ppp,3134,414,18,13,31,58.1%,25m
6824,3,Kioo,3134,276,10,12,22,45.5%,27m
6824,3,[江南不夜城]总有刁民要害朕,3134,201,8,1,9,88.9%,22m
6824,3,陌路同行,3134,120,3,1,4,75.0%,52m
6824,3,输本的妹夫,3134,55,2,3,5,40.0%,29m
6824,3,[软萌甜小萝莉]CodeZT,3134,94,1,1,2,50.0%,9m
6824,2,[鸽子窝]我不是富翁,3134,88,1,1,2,50.0%,12m
6824,3,eGoSeamew,3134,0,0,1,1,0.0%,10m
6824,3,[SC2近卫军]泰哥来袭,3134,0,0,2,2,0.0%,57m
6824,3,低调低调呵,3134,0,0,3,3,0.0%,6m
6841,3,海神明月,3133,788,47,47,94,50.0%,25m
6841,3,楚月,3133,796,32,27,59,54.2%,29m
6841,3,Satellite,3133,704,28,24,52,53.8%,26m
6841,3,sam,3133,404,14,15,29,48.3%,7m
6841,3,黑暗剑,3133,343,13,10,23,56.5%,30m
6841,3,搭把手回收,3133,322,11,12,23,47.8%,14m
6841,3,[哆啦B梦]月神,3133,144,5,6,11,45.5%,19m
6841,3,舞钶堂,3133,138,4,1,5,80.0%,11m
6841,3,TNGT,3133,133,3,1,4,75.0%,4m
6841,3,[SFG117]随机,3133,147,3,6,9,33.3%,24m
6841,3,[NPUED]路明非,3133,92,2,0,2,100.0%,19m
6841,3,[霸气军团]Apocalypse,3133,96,2,2,4,50.0%,16m
6841,3,[暴雪我是你爹]素质高一点,3133,0,1,0,1,100.0%,13m
6841,3,邪王的真眼,3133,30,1,2,3,33.3%,4m
6841,3,[菜鸡的天堂]炸鸡炸鸡,3133,0,1,2,3,33.3%,51m
6841,3,[KSA梦之队]Bigbulecat,3133,0,0,4,4,0.0%,25m
6857,3,Sword,3132,1528,339,335,674,50.3%,23m
6857,3,[KPG2]texousi,3132,1219,221,194,415,53.3%,18m
6857,3,[C70843]黎明,3132,375,117,87,204,57.4%,54m
6857,3,红色法拉利,3132,1336,74,62,136,54.4%,14m
6857,3,shadow,3132,1265,58,44,102,56.9%,4m
6857,3,[SoloAs]llllllllllll,3132,726,29,24,53,54.7%,10m
6857,3,嘻哈之韩同学,3132,188,24,19,43,55.8%,54m
6857,3,[犹豫会白给]藏娇入波月,3132,479,23,4,27,85.2%,6m
6857,3,阿龙龙,3132,402,15,14,29,51.7%,18m
6857,3,[最菜战队]Eugene,3132,420,15,14,29,51.7%,15m
6857,3,IIIIIIIIIIII,3132,210,8,9,17,47.1%,24m
6857,3,没有智力就是瞎莽,3132,201,6,3,9,66.7%,9m
6857,3,ForeverZxy,3132,142,6,8,14,42.9%,10m
6857,3,kim,3132,0,5,0,5,100.0%,20m
6857,3,[PhysRL]打星际你快乐吗,3132,94,4,2,6,66.7%,23m
6857,3,龚华东,3132,97,4,2,6,66.7%,1h
6857,3,TASSADAR,3132,31,4,4,8,50.0%,24m
6857,3,[我菜啊]你爹临死前,3132,93,2,0,2,100.0%,10m
6857,3,[Encore]摸鱼的嘤嘤怪,3132,62,2,5,7,28.6%,30m
6876,3,[ssts]梦醒时分,3131,360,77,55,132,58.3%,54m
6876,3,法兰尬舞队,3131,859,40,21,61,65.6%,7m
6876,3,speed,3131,745,31,26,57,54.4%,11m
6876,3,[Zero丿]小伙计,3131,587,24,14,38,63.2%,8m
6876,3,[泰伦娱乐会所]修伯利安,3131,249,15,19,34,44.1%,5m
6876,3,[兆景埋土大学]infinity,3131,330,14,6,20,70.0%,51m
6876,3,不破爱花,3131,209,7,4,11,63.6%,26m
6876,2,[XCode]坐最好的救护车,3131,94,5,2,7,71.4%,1h
6876,2,[四叶草]RainYoke,3131,145,4,2,6,66.7%,1h
6876,3,[IMRTS]Nikebulls,3131,97,4,6,10,40.0%,29m
6876,3,东方,3131,0,1,0,1,100.0%,54m
6876,3,派大星,3131,0,0,1,1,0.0%,54m
6876,3,[虚空守望]bacteria,3131,0,0,1,1,0.0%,1h
6889,3,你能把到我吗,3130,1545,84,82,166,50.6%,20m
6889,3,DDlording,3130,1008,73,69,142,51.4%,52m
6889,3,[C84131]TSEC,3130,1602,73,74,147,49.7%,57m
6889,3,神族难民,3130,999,40,35,75,53.3%,7m
6889,3,Prismriver,3130,754,35,20,55,63.6%,23m
6889,3,[为星光而战]你爹重回战场,3130,784,33,29,62,53.2%,29m
6889,3,MArteta,3130,183,29,30,59,49.2%,29m
6889,3,[lxh123]往事已然苍老,3130,381,28,21,49,57.1%,7m
6889,3,ReDempTion,3130,590,27,15,42,64.3%,11m
6889,3,豆子杀手,3130,590,25,16,41,61.0%,12m
6889,3,IIIIIIIII,3130,408,14,28,42,33.3%,12m
6889,3,[五月花]炽天,3130,240,10,3,13,76.9%,12m
6889,3,[星云际会]时光蓑湿,3130,140,4,1,5,80.0%,4m
6889,1,[CNU星际]莱莱莱莱莱茵,3130,114,2,3,5,40.0%,31m
6889,3,[我好冷]storyteller,3130,30,1,2,3,33.3%,10m
6889,3,简单的电脑,3130,0,0,2,2,0.0%,19m
6889,2,[DTeam]逗你玩,3130,0,0,4,4,0.0%,1h
6906,3,NewBee,3129,867,45,38,83,54.2%,55m
6906,3,桔子,3129,725,30,23,53,56.6%,29m
6906,3,[雪碧]喜欢喝血碧的人,3129,590,27,15,42,64.3%,10m
6906,3,量子丶命运,3129,408,27,18,45,60.0%,19m
6906,3,KilL,3129,548,18,25,43,41.9%,28m
6906,3,[萨尔那加之刃]自己人,3129,366,15,8,23,65.2%,53m
6906,3,半夏呼叫疯子,3129,361,13,6,19,68.4%,3m
6906,3,[魔女的骑士团]sakuya,3129,146,8,2,10,80.0%,18m
6906,1,Qzz,3129,186,7,5,12,58.3%,23m
6906,3,[菜有菜的道理]幻虚无,3129,123,6,2,8,75.0%,5m
6906,3,山里来的小帅哥,3129,178,6,3,9,66.7%,4m
6906,3,[萌王大人]lapland,3129,142,5,7,12,41.7%,7m
6906,3,somnosz,3129,88,4,5,9,44.4%,53m
6906,3,[荣耀丶殿堂]apple,3129,86,3,4,7,42.9%,50m
6906,3,[工程萌男]圣龙,3129,93,2,0,2,100.0%,5m
6906,3,混元星际孙保国,3129,119,2,2,4,50.0%,18m
6906,1,[望月]新月和流星雨,3129,0,1,0,1,100.0%,1h
6906,3,[西伯利亚土豆]机克术,3129,0,1,3,4,25.0%,52m
6906,3,[飞云之上]龇嘴獠牙,3129,0,0,3,3,0.0%,27m
6925,3,狗狗孩子,3128,1583,150,122,272,55.1%,57m
6925,3,[中南大学官网]我真的不会野你的,3128,1055,41,40,81,50.6%,22m
6925,3,香蒲,3128,378,38,26,64,59.4%,13m
6925,3,芬妮不是一,3128,575,32,30,62,51.6%,50m
6925,3,IIIIIIIIIIII,3128,467,32,32,64,50.0%,13m
6925,1,[刺蛇互助社团]念安,3128,268,11,3,14,78.6%,1h
6925,3,LinXiMM,3128,97,6,0,6,100.0%,1h
6925,3,[小狐狸]澪幽,3128,172,6,6,12,50.0%,16m
6925,2,雷神,3128,97,2,0,2,100.0%,25m
6925,3,YoyoSaki,3128,96,2,2,4,50.0%,11m
6925,3,[Beauty]MAKEYC,3128,30,1,2,3,33.3%,12m
6925,3,[Shiru]希尔特桑,3128,0,0,1,1,0.0%,22m
6925,3,ToneMba,3128,0,0,4,4,0.0%,1h
6938,3,[NKT]与寂寞有染,3127,1521,314,296,610,51.5%,19m
6938,3,hahaha,3127,1032,305,270,575,53.0%,9m
6938,3,XiaowenJ,3127,1385,152,139,291,52.2%,19m
6938,3,Licion,3127,1467,74,58,132,56.1%,4m
6938,3,Valentine,3127,1357,66,60,126,52.4%,29m
6938,3,[一盒峰我大哥]Lunar,3127,746,33,23,56,58.9%,51m
6938,3,迷人冷冷冷冷冷,3127,744,28,31,59,47.5%,15m
6938,3,[鸡饲料1]奈文摩尔,3127,431,16,12,28,57.1%,51m
6938,3,Yxxx,3127,316,15,7,22,68.2%,7m
6938,3,[黑白丝双马尾]救世神棍泽拉图,3127,382,14,16,30,46.7%,5m
6938,3,ONEND,3127,279,12,3,15,80.0%,23m
6938,3,freedom,3127,278,10,13,23,43.5%,21m
6938,3,[KPG]INnoVation,3127,246,9,10,19,47.4%,6m
6938,3,[暴雪全能亡]本群最跳狗逼嘴宗,3127,213,8,2,10,80.0%,19m
6938,3,龙卷风摧毁停车场,3127,229,8,4,12,66.7%,55m
6938,3,乔娜李莎的微笑,3127,139,3,2,5,60.0%,4m
6938,3,skyTree,3127,0,3,2,5,60.0%,25m
6938,3,[东大电竞]peter,3127,0,1,0,1,100.0%,60m
6938,3,Mooooop,3127,0,1,0,1,100.0%,29m
6938,3,[纸片人老婆]雅儿贝德,3127,0,1,3,4,25.0%,51m
6938,3,[那个男人]祈雨丶,3127,0,0,1,1,0.0%,26m
6938,3,[德哈卡神教]明明,3127,0,0,1,1,0.0%,56m
6960,3,小板狗,3126,993,116,100,216,53.7%,54m
6960,3,Best,3126,1498,108,89,197,54.8%,4m
6960,3,MagicProtoss,3126,785,32,25,57,56.1%,25m
6960,3,猪小帆,3126,433,31,21,52,59.6%,18m
6960,2,我爱宝贝,3126,300,13,7,20,65.0%,27m
6960,3,沙沙,3126,234,8,5,13,61.5%,13m
6960,2,考后笑嘻嘻,3126,95,6,1,7,85.7%,1h
6960,3,IIIIIIII,3126,110,5,4,9,55.6%,15m
6960,3,一剑清新,3126,0,3,1,4,75.0%,1h
6960,3,Saber,3126,0,1,0,1,100.0%,52m
6960,3,DISHPUSH,3126,0,1,0,1,100.0%,12m
6960,3,玄冰深雪,3126,30,1,2,3,33.3%,12m
6960,3,[TPoR]根号叁,3126,0,0,1,1,0.0%,54m
6960,3,[无畏巡洋]银河领主,3126,0,0,1,1,0.0%,10m
6974,3,saiakito,3125,1432,306,275,581,52.7%,16m
6974,3,云天自在,3125,1548,248,242,490,50.6%,54m
6974,3,何苦,3125,1093,152,125,277,54.9%,2m
6974,3,茉曦墨睿,3125,1127,108,100,208,51.9%,29m
6974,3,lkj,3125,394,102,90,192,53.1%,19m
6974,3,wangbaba,3125,1337,62,52,114,54.4%,55m
6974,3,[ljkFAN]晴朗,3125,1008,55,13,68,80.9%,5m
6974,3,赫萝的黄金龙爪,3125,596,30,19,49,61.2%,27m
6974,3,change,3125,444,19,13,32,59.4%,53m
6974,3,新开豆腐干,3125,434,16,18,34,47.1%,25m
6974,3,周星星,3125,356,13,12,25,52.0%,54m
6974,2,reverofniw,3125,316,12,9,21,57.1%,9m
6974,3,[瘾大眼瞎]打游戏我只选神族,3125,251,10,11,21,47.6%,8m
6974,3,长野原美绪,3125,95,8,4,12,66.7%,15m
6974,3,[浴火银河]赵思琪,3125,148,5,7,12,41.7%,15m
6974,3,[北京大学鸡协]Stats,3125,0,1,0,1,100.0%,4m
6974,3,[艾尔圣堂武士]暮光星灵,3125,93,1,1,2,50.0%,13m
6991,3,战歌号舰载机,3124,1093,93,65,158,58.9%,9m
6991,3,[为星光而战]橼橼,3124,1077,57,35,92,62.0%,51m
6991,2,[Anticw]星际天涯,3124,643,57,63,120,47.5%,26m
6991,3,Podeos,3124,812,34,23,57,59.6%,26m
6991,3,zcmorning,3124,394,22,10,32,68.8%,11m
6991,3,[foryss]唐瓜点,3124,237,21,5,26,80.8%,6m
6991,3,[红袖章]MarineKing,3124,501,20,15,35,57.1%,30m
6991,3,[Hist]destiny,3124,170,6,7,13,46.2%,14m
6991,3,[M8]银河之力,3124,0,4,1,5,80.0%,2m
6991,3,星光闪耀的瞬间,3124,115,3,0,3,100.0%,22m
6991,3,[艾抖露]ColdMoons,3124,129,3,1,4,75.0%,53m
6991,3,ZEST,3124,58,3,2,5,60.0%,22m
6991,3,神棍局局长,3124,0,1,0,1,100.0%,25m
6991,3,KelThuzad,3124,0,1,0,1,100.0%,57m
6991,3,lolo,3124,30,1,2,3,33.3%,22m
6991,3,fakelove,3124,0,0,1,1,0.0%,29m
6991,3,[又没气啦]Brave,3124,0,0,1,1,0.0%,57m
6991,3,[赞美生物质]RushB,3124,0,0,1,1,0.0%,49m
6991,3,[社交学大可爱]sheely,3124,0,0,3,3,0.0%,6m
7010,3,天空,3123,1529,162,154,316,51.3%,57m
7010,3,King,3123,362,34,19,53,64.2%,10m
7010,3,huzhang,3123,408,34,19,53,64.2%,30m
7010,3,[宫吧老哥狂喜]夏利文,3123,354,17,8,25,68.0%,53m
7010,3,[Rsh]Alice,3123,149,16,23,39,41.0%,11m
7010,3,TerranLife,3123,294,11,12,23,47.8%,57m
7010,3,[地嗪专卖店]楼主,3123,234,10,3,13,76.9%,53m
7010,3,colado,3123,245,8,5,13,61.5%,10m
7010,3,一只高端的大虾,3123,169,6,0,6,100.0%,57m
7010,3,吟魂何归,3123,189,5,6,11,45.5%,55m
7010,3,妈呀别打我探机,3123,115,3,0,3,100.0%,27m
7010,3,[Aos菜鸡队]上弦云,3123,0,1,0,1,100.0%,15m
7010,3,桦默,3123,30,1,3,4,25.0%,16m
7023,3,今晚打老虎,3122,1652,231,219,450,51.3%,29m
7023,3,Thesoul,3122,1608,207,187,394,52.5%,29m
7023,3,冯俊儒,3122,1570,143,128,271,52.8%,4m
7023,3,[柒堇年华]丹羽长秀,3122,1002,124,90,214,57.9%,7m
7023,3,[KPG]dart,3122,1292,99,69,168,58.9%,29m
7023,3,[IMRTS]Mmyue,3122,1008,59,49,108,54.6%,8m
7023,3,[ELC]Dalaran,3122,871,53,40,93,57.0%,29m
7023,3,pornhubuser,3122,1051,47,44,91,51.6%,15m
7023,3,素质特别差的选手,3122,673,34,20,54,63.0%,26m
7023,3,[看我朵蜜你]阿尔托莉雅,3122,860,33,31,64,51.6%,57m
7023,3,[侍奉社]雪之下雪乃,3122,329,23,3,26,88.5%,27m
7023,3,TYTY,3122,261,12,2,14,85.7%,11m
7023,3,innnnnnocent,3122,286,11,14,25,44.0%,15m
7023,3,[Shawk]打不过就是不够多,3122,219,10,15,25,40.0%,29m
7023,3,[扫黄]野人教我防隐刀,3122,228,9,10,19,47.4%,8m
7023,3,萧炎,3122,118,3,1,4,75.0%,55m
7023,3,[AT盟联]大西瓜,3122,60,2,3,5,40.0%,50m
7023,3,周瑜,3122,0,0,1,1,0.0%,19m
7023,3,[扫黄]米迦勒,3122,0,0,1,1,0.0%,7m
7023,3,ReMa,3122,0,0,8,8,0.0%,15m
7043,3,史莱克,3121,1520,90,87,177,50.8%,7m
7043,3,sadadsadasds,3121,1140,61,37,98,62.2%,4m
7043,3,[RNSM]Hymmnos,3121,687,50,42,92,54.3%,4m
7043,3,风暴之怒,3121,500,39,40,79,49.4%,12m
7043,3,一片空白,3121,638,29,25,54,53.7%,26m
7043,3,Bobyang,3121,542,18,28,46,39.1%,12m
7043,3,[Chitan]我的青春回来辣,3121,387,16,16,32,50.0%,56m
7043,3,[ENIAC]Eone,3121,351,15,7,22,68.2%,2m
7043,3,LoveYun,3121,167,6,1,7,85.7%,7m
7043,3,ruichong,3121,146,6,5,11,54.5%,12m
7043,3,微佀,3121,120,5,8,13,38.5%,29m
7043,3,combination,3121,114,3,0,3,100.0%,9m
7043,3,pineapple,3121,115,2,2,4,50.0%,22m
7043,3,[SoloBM]Beyond,3121,30,2,2,4,50.0%,27m
7043,3,[HTN]napusi,3121,0,1,0,1,100.0%,18m
7043,3,艾尔,3121,0,0,1,1,0.0%,1h
7043,3,michals,3121,0,0,1,1,0.0%,5m
7043,3,[艾卫道特联盟]莱宁锡特,3121,0,0,2,2,0.0%,14m
7043,2,[林都学子]SneakySquid,3121,0,0,2,2,0.0%,1h
7043,3,[1057]布衣怒,3121,0,0,3,3,0.0%,8m
7063,3,[秋毫第七分队]fish,3120,1129,46,39,85,54.1%,9m
7063,3,[蛮夫中的菜鸡]杨翼鹏,3120,484,17,22,39,43.6%,27m
7063,3,[虫族sm]NllRyu,3120,435,15,12,27,55.6%,55m
7063,3,[紫金魔龙皇]Eikasang,3120,368,14,8,22,63.6%,8m
7063,1,京东食尸鬼,3120,324,9,7,16,56.2%,21m
7063,3,一个小萌新,3120,188,6,3,9,66.7%,52m
7063,1,BravoProtoss,3120,164,4,1,5,80.0%,30m
7063,3,江南,3120,0,4,1,5,80.0%,16m
7063,1,[TSOD]掠夺者饿狼,3120,46,2,2,4,50.0%,10m
7063,1,[ToHo]涛哥,3120,0,1,0,1,100.0%,5m
7063,3,DominatorX,3120,0,0,1,1,0.0%,55m
7063,1,Cortana,3120,0,0,1,1,0.0%,19m
7075,3,darknessJW,3119,159,54,27,81,66.7%,23m
7075,3,[老年复健协会]年纪大了只会神族,3119,290,36,24,60,60.0%,13m
7075,2,[渣男]AirRayPotter,3119,996,35,43,78,44.9%,30m
7075,3,[耗子喂汁2]樱良,3119,806,32,25,57,56.1%,4m
7075,3,SteveRogers,3119,189,16,5,21,76.2%,56m
7075,1,ENZO,3119,84,3,1,4,75.0%,19m
7075,3,酷酷的柠檬,3119,30,2,2,4,50.0%,11m
7075,3,LKMJF,3119,0,0,2,2,0.0%,29m
7083,3,术高莫用,3118,298,14,3,17,82.4%,50m
7083,1,清玄子,3118,42,1,2,3,33.3%,8m
7083,1,月神,3118,0,0,1,1,0.0%,7m
7086,3,青菜白玉汤,3117,1509,215,213,428,50.2%,22m
7086,3,Simas,3117,292,49,46,95,51.6%,22m
7086,3,激动地男孩,3117,621,32,37,69,46.4%,22m
7086,3,沙漠之鹰,3117,420,16,11,27,59.3%,29m
7086,3,[MXGS]清水煮面,3117,354,14,14,28,50.0%,51m
7086,3,zzzrrr,3117,366,13,12,25,52.0%,4m
7086,3,机械鱼人,3117,266,10,6,16,62.5%,15m
7086,1,Hao,3117,40,2,0,2,100.0%,19m
7086,3,[RpGSE]sky,3117,0,0,1,1,0.0%,13m
7086,1,中出四十路熟女,3117,0,0,1,1,0.0%,7m
7096,3,[NKTJ]AIcup,3116,514,77,83,160,48.1%,53m
7096,3,[DDOS传奇]ydycycyd,3116,367,72,67,139,51.8%,54m
7096,3,贺老手,3116,1536,66,59,125,52.8%,9m
7096,3,玉宇琼楼,3116,474,17,22,39,43.6%,23m
7096,3,[南中南中]WEIAIYIXUAN,3116,162,8,9,17,47.1%,54m
7096,3,江边鸟,3116,0,5,0,5,100.0%,15m
7096,3,Sterben,3116,167,5,3,8,62.5%,5m
7096,3,[北极光小组]龙之神,3116,97,2,4,6,33.3%,1h
7096,1,静听烟雨,3116,0,1,0,1,100.0%,16m
7096,3,个顶顶顶,3116,30,1,3,4,25.0%,25m
7096,3,boss,3116,30,1,5,6,16.7%,7m
7096,1,孤独而热血的梦,3116,0,0,1,1,0.0%,11m
7108,3,咩咩羊,3115,1454,129,129,258,50.0%,22m
7108,3,THOSO,3115,1590,72,66,138,52.2%,54m
7108,3,文皇神明,3115,1308,64,37,101,63.4%,57m
7108,2,Kagarino,3115,201,15,7,22,68.2%,51m
7108,3,[斯巴达血战团]茫行,3115,206,8,11,19,42.1%,6m
7108,3,Mew,3115,184,7,7,14,50.0%,6m
7108,3,SoO,3115,118,4,10,14,28.6%,52m
7108,3,[暴雪娱乐]雷神,3115,30,1,4,5,20.0%,51m
7108,3,IIIIIIIIIII,3115,30,1,10,11,9.1%,16m
7117,2,春心荡漾的熊猫,3114,1472,315,297,612,51.5%,30m
7117,3,Lover,3114,362,38,22,60,63.3%,10m
7117,3,[BT]Qyc,3114,290,10,14,24,41.7%,22m
7117,1,sos,3114,194,5,4,9,55.6%,5m
7117,3,[TG1]万年龙神号,3114,94,2,1,3,66.7%,18m
7117,2,Skydog,3114,0,1,0,1,100.0%,5m
7117,1,推进之王,3114,0,1,0,1,100.0%,54m
7117,3,麦克斯韦方程组,3114,0,1,1,2,50.0%,52m
7117,1,亚奈叶月,3114,42,1,2,3,33.3%,53m
7117,3,hhhhh,3114,0,1,3,4,25.0%,4m
7117,1,angles,3114,0,0,1,1,0.0%,22m
7117,3,[大元师]吾义赴死,3114,0,0,2,2,0.0%,12m
7129,3,无尽头,3113,1470,256,246,502,51.0%,22m
7129,3,都别给我墨迹,3113,546,56,52,108,51.9%,18m
7129,3,[miofa]Sora,3113,648,54,35,89,60.7%,25m
7129,3,IIIIIIIIIIII,3113,344,13,5,18,72.2%,10m
7129,1,月兔回旋于空中,3113,313,10,1,11,90.9%,11m
7129,3,[拨云见日]卧龙,3113,134,8,4,12,66.7%,55m
7129,3,鞭性茎肛,3113,237,7,7,14,50.0%,8m
7129,3,幽弥狂,3113,0,5,0,5,100.0%,54m
7129,3,[Herald]塞尔瓦托丶小晓,3113,121,5,2,7,71.4%,49m
7129,3,黑骑,3113,92,4,8,12,33.3%,15m
7129,1,流觞,3113,61,2,1,3,66.7%,28m
7129,3,[女神候补生]Amadeus,3113,30,2,2,4,50.0%,53m
7129,1,[Trusty]大闹包,3113,42,1,1,2,50.0%,56m
7129,2,Curtain,3113,0,0,1,1,0.0%,5m
7143,3,IIIIIIIIIIII,3112,246,8,4,12,66.7%,29m
7143,2,[老家伙战队]寒羽良,3112,114,4,10,14,28.6%,51m
7143,2,[黑灬手灬党]DustPower,3112,0,0,2,2,0.0%,6m
7143,3,雪之下雪乃,3112,0,0,3,3,0.0%,20m
7147,3,[旺旺战士]IIIIIIIIIII,3111,447,82,68,150,54.7%,7m
7147,1,泪落在梦中,3111,963,45,27,72,62.5%,22m
7147,3,人间不值得,3111,863,45,32,77,58.4%,55m
7147,1,[Borne]Kirito,3111,644,44,31,75,58.7%,22m
7147,1,[闪电伍连鞭]smileboy,3111,748,36,21,57,63.2%,7m
7147,1,[Deepdk]但求实验能顺利,3111,586,21,9,30,70.0%,7m
7147,3,[绝望星灵]再见了星际,3111,163,6,5,11,54.5%,10m
7147,3,IIlIllllIIlI,3111,126,5,9,14,35.7%,3m
7147,1,御坂美琴,3111,30,1,2,3,33.3%,7m
7147,1,[能量]干掉黄旭东,3111,93,1,3,4,25.0%,8m
7157,3,[T阴吧]开心的名字,3110,1501,215,209,424,50.7%,19m
7157,3,[极限菜鸟]战王,3110,1565,167,131,298,56.0%,29m
7157,3,[五月花]潇洒哥大战黑大帅,3110,756,67,45,112,59.8%,19m
7157,2,泰伯尔同族体,3110,166,5,1,6,83.3%,1h
7157,3,[野怪也是虫]Rival,3110,88,3,7,10,30.0%,7m
7157,1,[M8]好兄弟无穷无尽,3110,42,2,0,2,100.0%,19m
7157,3,开豪车泡不到妞,3110,30,2,2,4,50.0%,52m
7157,1,[牌面]雷日神,3110,0,1,0,1,100.0%,5m
7157,1,snowsforever,3110,0,1,0,1,100.0%,26m
7157,3,奥利奥的微笑,3110,0,1,0,1,100.0%,1h
7157,1,luobo,3110,42,1,1,2,50.0%,5m
7157,1,[彩虹桥]无敌山,3110,42,1,2,3,33.3%,19m
7157,2,WHX,3110,0,0,1,1,0.0%,12m
7157,3,HenryLight,3110,0,0,3,3,0.0%,8m
7171,1,WINTSIR,3109,1528,173,121,294,58.8%,16m
7171,3,拉尼亚凯亚,3109,1506,68,78,146,46.6%,57m
7171,3,IIIIIIIIII,3109,620,26,23,49,53.1%,4m
7171,3,pppp,3109,307,12,13,25,48.0%,4m
7171,3,紫语青酸,3109,258,8,7,15,53.3%,15m
7171,3,Passerby,3109,210,7,4,11,63.6%,25m
7171,2,清酒,3109,84,5,4,9,55.6%,7m
7171,3,音乐阳,3109,142,5,8,13,38.5%,26m
7171,1,Fanstars,3109,0,1,0,1,100.0%,1h
7171,3,月夜神,3109,0,1,1,2,50.0%,22m
7171,3,[青铜树]飞龙,3109,30,1,3,4,25.0%,7m
7182,3,[18CM]GeorgeC,3108,1553,212,211,423,50.1%,19m
7182,3,LinGuo,3108,715,56,41,97,57.7%,7m
7182,1,Mirror,3108,523,18,11,29,62.1%,6m
7182,1,lllllllllll,3108,472,13,15,28,46.4%,7m
7182,3,Arcana,3108,324,12,19,31,38.7%,4m
7182,3,[星歌]妄言,3108,212,7,10,17,41.2%,30m
7182,3,[圣德怀特学园]宛枫,3108,181,4,7,11,36.4%,4m
7182,3,[内蒙星际联盟]不讲武德年轻人,3108,88,3,6,9,33.3%,10m
7182,2,[吕布看女团]fbh,3108,88,2,1,3,66.7%,23m
7182,1,Unicorn,3108,0,0,1,1,0.0%,29m
7182,3,[星辰之翼]KnightWindly,3108,0,0,1,1,0.0%,1h
7182,1,亚丝娜,3108,0,0,1,1,0.0%,1h
7182,2,[十鬼蛇区]艾尔天天大停电,3108,0,0,1,1,0.0%,16m
7195,3,多情男,3107,1567,77,62,139,55.4%,27m
7195,3,[星际马保国]黄旭东的儿子,3107,846,46,22,68,67.6%,50m
7195,3,扫清六合席卷八荒,3107,414,39,23,62,62.9%,54m
7195,3,llllllllllll,3107,669,27,32,59,45.8%,54m
7195,3,[硬朗派]阿嵬茨小志,3107,586,23,18,41,56.1%,12m
7195,3,[IGS]llllllllllll,3107,88,6,6,12,50.0%,26m
7195,1,[Goodg]IIIIIIIIIIII,3107,120,3,2,5,60.0%,20m
7195,3,lin,3107,30,1,8,9,11.1%,26m
7203,2,Askeladd,3106,1108,256,265,521,49.1%,8m
7203,1,东风化雨,3106,646,87,71,158,55.1%,52m
7203,3,宿舍长,3106,1280,54,57,111,48.6%,54m
7203,3,四五姐不是钢板,3106,785,49,51,100,49.0%,12m
7203,1,ProPhet,3106,629,45,39,84,53.6%,53m
7203,1,菜到不行,3106,310,10,6,16,62.5%,19m
7203,3,smvu,3106,120,6,1,7,85.7%,1h
7203,1,[Latte]猫南北,3106,202,6,3,9,66.7%,55m
7203,3,欧颜之蠢菜鸟,3106,182,5,4,9,55.6%,22m
7203,1,[93589]ShadowHunter,3106,40,1,1,2,50.0%,54m
7203,3,[你下面凉快吗]余晖烁烁,3106,0,0,2,2,0.0%,16m
7214,3,修地堡的都是狗,3105,853,63,54,117,53.8%,22m
7214,3,[你好可爱]Ashlost,3105,243,12,12,24,50.0%,15m
7214,3,[腥基佬男骸]AmazingLYH,3105,270,10,6,16,62.5%,8m
7214,3,[时间]Shadow,3105,131,7,9,16,43.8%,23m
7214,3,[草死尼玛哦]TheEnd,3105,38,6,1,7,85.7%,2m
7214,1,Gooddamn,3105,198,5,4,9,55.6%,22m
7214,3,[XXHZ32]烟雨如花,3105,79,4,1,5,80.0%,24m
7214,3,[银翼之光]闪电飞鱼,3105,97,4,2,6,66.7%,4m
7214,3,萌新,3105,0,1,0,1,100.0%,56m
7214,1,卤鹅饭,3105,42,1,1,2,50.0%,2m
7214,1,neveralong,3105,40,1,2,3,33.3%,12m
7225,3,XuanWu,3104,1540,120,106,226,53.1%,18m
7225,3,[NEAU]满眼星辰只为见你,3104,1581,118,105,223,52.9%,10m
7225,2,长安李不白,3104,895,108,105,213,50.7%,16m
7225,3,[哲学娱乐谐会]Kerrigan,3104,559,101,77,178,56.7%,19m
7225,3,三上悠亚天下无敌,3104,793,45,34,79,57.0%,16m
7225,3,[三国终结者]落花独舞笑看繁华,3104,415,17,16,33,51.5%,10m
7225,3,[DMRe]锦衣年华,3104,88,11,11,22,50.0%,30m
7225,3,[就会一招]EmrysYG,3104,30,2,3,5,40.0%,54m
7225,1,[色格脖]ayanamist,3104,0,1,0,1,100.0%,7m
7225,3,[比奇堡海滩]jess,3104,30,1,4,5,20.0%,29m
7235,1,物述有栖单推人,3103,397,15,6,21,71.4%,12m
7235,1,滨边美波我老婆,3103,298,9,4,13,69.2%,15m
7235,3,[RSTAR]SKYLINEROPE,3103,138,9,13,22,40.9%,15m
7235,3,[人类种]末时平生,3103,207,7,9,16,43.8%,20m
7235,3,[八爪鱼]紫影幻月,3103,189,6,9,15,40.0%,7m
7235,3,[萌萌哒萌萌哒]pomie,3103,133,4,1,5,80.0%,57m
7235,1,[逐火之蛾]艾姬多娜,3103,183,4,3,7,57.1%,17m
7235,3,Evangelion,3103,116,4,7,11,36.4%,22m
7235,1,光环,3103,75,3,0,3,100.0%,6m
7235,3,薰惋逡,3103,0,3,2,5,60.0%,4m
7235,3,NoBadY,3103,60,3,8,11,27.3%,5m
7235,1,WindYDawn,3103,0,1,0,1,100.0%,2m
7235,1,[边缘]CatCrossbow,3103,40,1,2,3,33.3%,52m
7235,1,[氧化钙]Hakurei,3103,0,0,1,1,0.0%,28m
7249,3,LUCKYBOY,3102,540,101,89,190,53.2%,29m
7249,3,诞生,3102,652,30,18,48,62.5%,19m
7249,3,锋行天下,3102,504,18,30,48,37.5%,18m
7249,2,[XXG]jameshhy,3102,212,8,1,9,88.9%,2m
7249,3,朱老板,3102,190,6,5,11,54.5%,11m
7249,2,sina,3102,0,4,2,6,66.7%,1h
7249,3,Liquor,3102,0,2,3,5,40.0%,43m
7249,3,还有谁,3102,0,1,3,4,25.0%,19m
7249,1,Senhnn,3102,0,0,1,1,0.0%,22m
7258,3,whishaw,3101,1432,322,304,626,51.4%,13m
7258,3,[快乐的海盗]恶寒青山,3101,1103,93,89,182,51.1%,54m
7258,1,[缘起幻想乡]葛饰应为,3101,788,38,13,51,74.5%,7m
7258,3,[鷄你太美]Chopin,3101,656,24,25,49,49.0%,10m
7258,3,锐风执剑,3101,380,16,9,25,64.0%,22m
7258,1,[LandSr]Ramu,3101,318,10,4,14,71.4%,28m
7258,3,[三大动力]liushui,3101,316,10,9,19,52.6%,56m
7258,3,[浙江大学战队]Demonic,3101,170,6,1,7,85.7%,51m
7258,3,Desperate,3101,0,5,0,5,100.0%,60m
7258,2,皮特鳄梨,3101,46,5,3,8,62.5%,1h
7258,2,大老虎小龙女,3101,156,4,9,13,30.8%,15m
7258,1,[Cytus]Dlove,3101,0,1,0,1,100.0%,11m
7258,3,死神之光芒,3101,96,1,2,3,33.3%,11m
7258,3,[两道菜]急急急,3101,0,0,2,2,0.0%,27m
7272,3,MCK,3100,1626,166,141,307,54.1%,8m
7272,3,[社交学小可爱]骑摩托的北方娃儿,3100,881,38,27,65,58.5%,22m
7272,3,他已经去了,3100,552,19,25,44,43.2%,6m
7272,3,听竹先生,3100,342,12,15,27,44.4%,26m
7272,3,Naive,3100,119,10,13,23,43.5%,25m
7272,2,DingF,3100,163,6,4,10,60.0%,1h
7272,3,[吉高由里子]Yoriko,3100,78,4,5,9,44.4%,13m
7272,1,[青铜树]Tdctpmu,3100,0,1,0,1,100.0%,2m
7272,3,[YH]jsbyyz,3100,83,1,2,3,33.3%,22m
7272,3,[地府]山夏雨,3100,0,0,1,1,0.0%,1h
7272,1,本地人,3100,0,0,1,1,0.0%,29m
7272,1,罗斯柴尔聪,3100,0,0,1,1,0.0%,10m
7284,3,普朗克叔叔,3099,1071,124,100,224,55.4%,25m
7284,2,sampro,3099,1523,115,137,252,45.6%,14m
7284,3,[一二一]IIIIIIIIII,3099,1594,81,85,166,48.8%,10m
7284,3,[探姬之骑士团]cjc,3099,532,19,22,41,46.3%,23m
7284,3,ypshy,3099,404,14,17,31,45.2%,12m
7284,1,[新人保护协会]古老头,3099,0,1,0,1,100.0%,6m
7284,1,haha,3099,40,1,1,2,50.0%,11m
7284,3,紫厌红莲,3099,0,1,2,3,33.3%,11m
7292,3,他和她的故事,3098,899,194,185,379,51.2%,57m
7292,3,一剑碎影,3098,1568,97,77,174,55.7%,11m
7292,1,壮士请先杀队友,3098,632,19,18,37,51.4%,22m
7292,1,iWalker,3098,300,9,7,16,56.2%,54m
7292,3,[永恒幻想乡]micge,3098,289,9,10,19,47.4%,51m
7292,3,流浪泰伦,3098,238,9,19,28,32.1%,14m
7292,1,[生物即是正义]超级兵,3098,0,4,1,5,80.0%,8m
7292,1,SourLemon,3098,0,2,3,5,40.0%,2m
7292,3,[WNZS]LLDD,3098,94,1,2,3,33.3%,52m
7292,3,[USN舰队]Lexington,3098,0,0,1,1,0.0%,1h
7292,3,[IGS]叉烧味的包子,3098,0,0,2,2,0.0%,4m
7292,3,[镜花水月丨]onlysky,3098,0,0,4,4,0.0%,26m
7304,3,JacobFranci,3097,1257,80,76,156,51.3%,12m
7304,3,蛋蛋的忧伤,3097,703,66,58,124,53.2%,2m
7304,3,zeyu,3097,904,50,44,94,53.2%,54m
7304,3,[我们是无敌的]子颜大大,3097,819,34,25,59,57.6%,55m
7304,3,Sup,3097,730,31,31,62,50.0%,22m
7304,2,[LSC]LSCbaid,3097,268,25,39,64,39.1%,21m
7304,3,[丶幸存丶]Justice,3097,220,10,6,16,62.5%,4m
7304,3,abc,3097,202,9,7,16,56.2%,52m
7304,3,[文韬武略]有基佬拉我苦练,3097,200,7,15,22,31.8%,31m
7304,3,[Shawk]Jackwea,3097,58,3,6,9,33.3%,11m
7304,3,[社交学巨可爱]一米二,3097,0,1,0,1,100.0%,1h
7304,3,[主观唯心主义]wHisPeR,3097,0,1,2,3,33.3%,9m
7304,1,[东南西北战区]拓孚大吊哥,3097,0,0,2,2,0.0%,19m
7317,3,赤松子,3096,756,194,165,359,54.0%,9m
7317,1,虫群无穷无尽,3096,1382,75,64,139,54.0%,55m
7317,1,山风,3096,1433,54,44,98,55.1%,15m
7317,3,[yxfans]静介,3096,493,20,16,36,55.6%,8m
7317,3,开图没马,3096,445,16,14,30,53.3%,19m
7317,3,我想我是海,3096,98,4,5,9,44.4%,55m
7317,3,[Timbar]我的皮肤漂亮吗,3096,30,1,4,5,20.0%,26m
7317,1,SNOW,3096,0,0,2,2,0.0%,8m
7325,3,[旺旺战士]michaelgbw,3095,896,94,106,200,47.0%,25m
7325,3,斯托克夫中将,3095,966,75,34,109,68.8%,7m
7325,3,[EL骑士二团]IIIIIIIIII,3095,986,65,71,136,47.8%,53m
7325,3,[传说萌娘团]魔法少女小鸟,3095,888,33,39,72,45.8%,10m
7325,3,超级无敌小超超,3095,97,6,0,6,100.0%,5m
7325,3,[PUSC2]Moriarty,3095,161,3,3,6,50.0%,31m
7325,3,[刺蛇互助社团]RAiNYSTARS,3095,58,2,7,9,22.2%,30m
7332,3,十一,3094,967,89,75,164,54.3%,11m
7332,3,qToTp,3094,488,73,57,130,56.2%,11m
7332,3,Ikaros,3094,849,41,23,64,64.1%,11m
7332,3,清风柒墨琉璃夏,3094,705,32,25,57,56.1%,54m
7332,1,富贵儿,3094,406,31,18,49,63.3%,22m
7332,3,[学姐赛高]老年人也要打生化,3094,211,10,15,25,40.0%,56m
7332,3,jianVShao,3094,156,8,11,19,42.1%,25m
7332,1,[XXHZ30]下岗的屠户,3094,160,5,3,8,62.5%,26m
7332,1,[北京城管]小小晨钰,3094,126,2,1,3,66.7%,54m
7332,1,newman,3094,42,2,2,4,50.0%,22m
7332,1,duckulachao,3094,40,1,2,3,33.3%,22m
7332,1,菁菁鲸,3094,0,0,1,1,0.0%,16m
7344,3,[KPG2]小群群,3093,858,36,34,70,51.4%,12m
7344,1,[Tov]freedom,3093,198,12,7,19,63.2%,28m
7344,3,肥躁,3093,234,8,12,20,40.0%,21m
7344,1,[s金色玫瑰s]NOTO,3093,114,4,2,6,66.7%,56m
7344,3,赵日天,3093,0,0,5,5,0.0%,2m
7349,1,[镇魂]白客,3092,606,25,21,46,54.3%,22m
7349,3,[农妇山泉]王大仙,3092,255,17,17,34,50.0%,14m
7349,1,[希靈使徒]铃村悟,3092,307,11,14,25,44.0%,26m
7349,3,[黄金大翔]AAA,3092,95,2,1,3,66.7%,52m
7349,3,JonDoe,3092,3,2,5,7,28.6%,24m
7349,2,eeeeeeeeeeee,3092,88,1,1,2,50.0%,55m
7349,1,[今晚去唐宫]小洲,3092,0,0,1,1,0.0%,5m
7349,1,[韵语之音]MDR,3092,0,0,1,1,0.0%,22m
7349,3,强仔,3092,0,0,3,3,0.0%,8m
7358,1,xionger,3091,574,25,17,42,59.5%,22m
7358,1,nightmareUC,3091,472,16,16,32,50.0%,16m
7358,3,[传说萌娘团]IIIIIIIIIIII,3091,384,15,19,34,44.1%,23m
7358,1,支点水,3091,209,8,4,12,66.7%,28m
7358,1,Alone,3091,286,7,10,17,41.2%,7m
7358,3,枼靈,3091,135,5,3,8,62.5%,7m
7358,3,陆小鳳不会开汽车,3091,90,3,9,12,25.0%,27m
7358,3,draco,3091,38,3,10,13,23.1%,22m
7358,1,[星歌]星歌永远是我大哥,3091,0,1,0,1,100.0%,8m
7358,3,[最菜]拆迁队队长,3091,30,1,7,8,12.5%,54m
7358,3,Prophet,3091,30,1,8,9,11.1%,51m
7358,1,LoveLL,3091,0,0,2,2,0.0%,54m
7358,1,路人甲,3091,0,0,2,2,0.0%,23m
7358,3,泽拉图,3091,0,0,4,4,0.0%,50m
7372,3,steven,3090,1477,213,201,414,51.4%,29m
7372,3,笨比萌娘团,3090,1544,56,67,123,45.5%,56m
7372,3,老唐,3090,1013,51,44,95,53.7%,8m
7372,3,小新,3090,779,47,55,102,46.1%,16m
7372,1,星界拾荒者,3090,1183,46,36,82,56.1%,5m
7372,3,Real,3090,884,39,43,82,47.6%,23m
7372,3,ForT,3090,382,24,14,38,63.2%,8m
7372,1,狗二蛋,3090,353,12,2,14,85.7%,14m
7372,3,一个谐星,3090,0,1,2,3,33.3%,5m
7372,1,IIIIIIIIIIII,3090,0,0,2,2,0.0%,7m
7382,3,[老男孩星际]Trap,3089,524,37,27,64,57.8%,29m
7382,1,wei,3089,623,33,4,37,89.2%,6m
7382,3,[Shawk]Linghun,3089,628,25,21,46,54.3%,52m
7382,1,iwooo,3089,789,24,23,47,51.1%,6m
7382,3,[龙骑舞尹志平]鬼才,3089,482,17,18,35,48.6%,54m
7382,3,[大师联萌]落花,3089,185,8,4,12,66.7%,12m
7382,1,[风纪委员会]zero,3089,178,5,4,9,55.6%,13m
7382,2,stats,3089,46,4,2,6,66.7%,1h
7382,1,[kurisu]贝伦卡斯特,3089,46,4,6,10,40.0%,31m
7382,3,[UES]三笠阿克曼,3089,121,3,0,3,100.0%,1h
7382,2,无已,3089,141,3,1,4,75.0%,9m
7382,1,[一般赢不了]自闭只想下棋,3089,44,2,0,2,100.0%,2m
7382,2,[星际三舰客]幽宇,3089,96,2,1,3,66.7%,1h
7382,1,[情义天下]暴暴龙,3089,84,2,3,5,40.0%,30m
7382,1,三水一昆,3089,0,1,0,1,100.0%,7m
7382,1,murasame,3089,0,1,0,1,100.0%,52m
7382,3,[GAC]夜黑风搞,3089,0,1,1,2,50.0%,3m
7382,3,fleetingtime,3089,30,1,1,2,50.0%,57m
7382,1,[bb的老父亲]闪击英雄,3089,42,1,3,4,25.0%,28m
7382,1,梦泽,3089,0,0,2,2,0.0%,22m
7382,2,老婆那里很苦,3089,0,0,3,3,0.0%,1h
7403,1,文艺秀儿,3088,1203,74,48,122,60.7%,52m
7403,3,[虚空王座]蛇皮大仙,3088,1080,46,46,92,50.0%,3m
7403,3,Xuan,3088,504,18,17,35,51.4%,54m
7403,1,魔法少女阿巴瑟,3088,187,6,2,8,75.0%,6m
7403,1,年轻人不讲武德,3088,0,0,1,1,0.0%,23m
7403,1,[暴雪二十八队]最初,3088,0,0,1,1,0.0%,30m
7403,1,[逐梦之影]山顶上听歌,3088,0,0,2,2,0.0%,19m
7410,3,[WANT]want,3087,1549,223,216,439,50.8%,30m
7410,3,[KPG2]RyanSoong,3087,1463,146,115,261,55.9%,27m
7410,3,jimmilos,3087,1434,123,114,237,51.9%,13m
7410,1,情人,3087,321,38,22,60,63.3%,14m
7410,1,蛇皮与皮皮虾,3087,593,28,17,45,62.2%,30m
7410,3,[TMUSC2]ArkFrostNova,3087,142,4,3,7,57.1%,26m
7410,1,[IM战队]IMNestea,3087,80,3,2,5,60.0%,30m
7410,1,NOVAC,3087,42,1,2,3,33.3%,24m
7418,3,第一秩序,3086,295,11,9,20,55.0%,50m
7418,1,云灵苏,3086,345,10,14,24,41.7%,53m
7418,1,IIIIIIIIIIII,3086,278,9,4,13,69.2%,22m
7418,1,[多萝多萝茜]Nome,3086,224,9,5,14,64.3%,46m
7418,3,暴走谐星,3086,176,6,15,21,28.6%,14m
7418,3,chenshuaimin,3086,97,1,1,2,50.0%,60m
7418,2,魔羯座,3086,0,0,3,3,0.0%,4m
7425,3,ssfs,3085,1419,324,325,649,49.9%,23m
7425,3,桂花湾,3085,1475,159,153,312,51.0%,4m
7425,3,[南湖匈奴]回忆始终是回忆,3085,1116,44,46,90,48.9%,23m
7425,1,[葛温王下骑士]正义的伙伴,3085,643,32,10,42,76.2%,16m
7425,1,[第九舰队丶]鱼塘塘主,3085,676,22,18,40,55.0%,22m
7425,3,[东京有点热]逝沫,3085,236,12,6,18,66.7%,29m
7425,3,xingzai,3085,42,5,2,7,71.4%,60m
7425,1,女刀丶寒冰刃乀,3085,82,3,1,4,75.0%,55m
7425,1,杨嘉禾,3085,40,2,0,2,100.0%,19m
7425,1,[经典神皇万岁]ALPHASTAR,3085,42,1,2,3,33.3%,14m
7435,1,gggg,3084,552,18,11,29,62.1%,24m
7435,1,JohnnyRoy,3084,430,17,16,33,51.5%,13m
7435,1,[路易斯邦德]SickD,3084,520,15,16,31,48.4%,22m
7435,3,[诺娃的隐身衣]lwl,3084,337,14,7,21,66.7%,20m
7435,3,赤樱,3084,72,4,7,11,36.4%,23m
7435,3,[换家引领世界]夜空中最亮的星,3084,121,3,3,6,50.0%,5m
7435,3,我从不存在于过去,3084,94,2,2,4,50.0%,29m
7435,3,Cloudychang,3084,30,1,6,7,14.3%,17m
7435,1,[头铁认真的]MISS,3084,0,0,1,1,0.0%,56m
7435,1,黎明的小黑不放箭,3084,0,0,1,1,0.0%,22m
7435,1,睾处不胜含,3084,0,0,1,1,0.0%,55m
7435,1,sagittarius,3084,0,0,2,2,0.0%,11m
7447,1,cccc,3083,1149,122,104,226,54.0%,22m
7447,3,荒火,3083,508,45,43,88,51.1%,53m
7447,3,雾隐雷藏,3083,969,40,34,74,54.1%,53m
7447,3,Era,3083,263,26,30,56,46.4%,16m
7447,3,LittleOgre,3083,221,20,17,37,54.1%,12m
7447,3,[我不做人了]nilins,3083,480,17,22,39,43.6%,5m
7447,1,yuriyuri,3083,398,12,5,17,70.6%,22m
7447,1,plotter,3083,217,8,6,14,57.1%,13m
7447,3,rua,3083,0,4,1,5,80.0%,28m
7447,1,[子长之神]TARMSAND,3083,72,3,1,4,75.0%,22m
7447,1,[JEIBO]ATHANASIA,3083,109,2,1,3,66.7%,31m
7447,3,[吉翁公国]背后一刀,3083,0,0,4,4,0.0%,26m
7459,3,我打星际像售太姆,3082,600,80,69,149,53.7%,7m
7459,1,[极限菜鸟]TUSKIN,3082,1349,62,43,105,59.0%,11m
7459,3,薛定谔的慕斯里,3082,426,15,23,38,39.5%,6m
7459,3,[皮霸子]Kaiser,3082,108,13,18,31,41.9%,23m
7459,3,群星璀璨之时,3082,188,9,6,15,60.0%,3m
7459,3,[斗鱼直播]红茶,3082,118,3,3,6,50.0%,55m
7459,2,[七彩神话]金色闪电,3082,95,2,2,4,50.0%,1h
7459,2,只求不狗打运营,3082,88,1,1,2,50.0%,29m
7459,3,阴影,3082,0,1,8,9,11.1%,54m
7459,3,[EL骑士团]海音,3082,0,0,1,1,0.0%,7m
7469,3,刘皇叔,3081,795,409,389,798,51.3%,11m
7469,3,北部之光,3081,1609,132,115,247,53.4%,56m
7469,3,cccccc,3081,1315,52,50,102,51.0%,12m
7469,3,DreamHunter,3081,455,19,13,32,59.4%,29m
7469,2,深海逆蓝,3081,179,7,4,11,63.6%,33m
7469,3,[你瞅啥]海奥瑞泽,3081,150,6,10,16,37.5%,29m
7469,3,Aubergine,3081,150,5,9,14,35.7%,29m
7469,1,上户彩,3081,171,4,6,10,40.0%,30m
7469,1,沉默之剑,3081,118,3,2,5,60.0%,29m
7469,3,[我爱屠鸡]IIIIIIIIIIII,3081,118,2,2,4,50.0%,3m
7469,3,蓝月纯银,3081,97,2,6,8,25.0%,51m
7469,1,第五邪神,3081,40,1,1,2,50.0%,56m
7469,3,loner,3081,0,0,2,2,0.0%,55m
7482,3,[辣鸡游戏CF]谷子地,3080,486,102,75,177,57.6%,7m
7482,3,传说中的啦啦,3080,677,35,34,69,50.7%,5m
7482,1,[Borne]黑白尺素,3080,523,17,10,27,63.0%,29m
7482,3,手残神族,3080,411,16,14,30,53.3%,22m
7482,3,麦诺希德,3080,144,6,0,6,100.0%,48m
7482,3,[basaka]Theday,3080,157,5,5,10,50.0%,19m
7482,3,[逼龙在天]以河,3080,0,3,2,5,60.0%,55m
7482,1,[Guider]从竹议官,3080,42,2,0,2,100.0%,8m
7482,1,exculibar,3080,83,2,0,2,100.0%,35m
7482,3,SUOYOUNO,3080,44,2,1,3,66.7%,1h
7482,1,deadgame,3080,40,1,3,4,25.0%,52m
7482,1,云中月,3080,0,0,1,1,0.0%,21m
7482,1,混元星际太极门,3080,0,0,1,1,0.0%,11m
7495,3,您的智商已欠费,3079,733,189,176,365,51.8%,14m
7495,3,asd,3079,1105,180,177,357,50.4%,9m
7495,3,[五月花]Random,3079,1211,111,104,215,51.6%,13m
7495,3,[ZHKU仲恺]dadaming,3079,1348,58,57,115,50.4%,57m
7495,3,[鸡饲料一堆]我是菜鸟,3079,512,27,11,38,71.1%,50m
7495,3,白门楼爆破能手,3079,527,21,18,39,53.8%,19m
7495,1,[盲人协会]孔维康最帅,3079,346,14,0,14,100.0%,24m
7495,3,ZEST,3079,202,8,9,17,47.1%,29m
7495,3,[HustSC]JokerGreed,3079,245,7,9,16,43.8%,54m
7495,3,[博灬弈丶论]叫我嚣张,3079,212,7,11,18,38.9%,15m
7495,1,地锅排骨,3079,160,5,0,5,100.0%,1h
7495,3,[Flowex]soupsword,3079,203,5,7,12,41.7%,29m
7495,3,烟雨,3079,111,3,0,3,100.0%,15m
7495,1,菜鸡,3079,42,2,1,3,66.7%,5m
7495,1,苦瓜,3079,0,2,3,5,40.0%,22m
7495,1,Bass,3079,40,1,1,2,50.0%,7m
7495,3,[暴雪家族]刃虫,3079,0,0,1,1,0.0%,38m
7495,1,[纸鸢i]zzreal,3079,0,0,2,2,0.0%,53m
7513,3,jiab,3078,121,5,2,7,71.4%,1h
7513,3,[MNK]万圣节的榴莲糖,3078,97,4,2,6,66.7%,55m
7513,3,nature,3078,0,3,2,5,60.0%,1h
7513,1,红色夕阳,3078,80,2,4,6,33.3%,5m
7513,3,由内而外,3078,30,2,8,10,20.0%,23m
7513,3,WuSanga,3078,42,1,2,3,33.3%,55m
7513,1,[胖次]breadguil,3078,0,0,1,1,0.0%,7m
7513,3,dang,3078,0,0,2,2,0.0%,52m
7521,3,[暴雪零队]旗鼓相当的对手,3077,656,332,330,662,50.2%,57m
7521,1,雾雨魔理安,3077,1626,191,173,364,52.5%,26m
7521,1,IIIIIIIIIIII,3077,1000,69,55,124,55.6%,53m
7521,3,王启同,3077,618,27,24,51,52.9%,21m
7521,3,ALEN,3077,457,17,16,33,51.5%,57m
7521,1,豌豆大亨孟德尔,3077,394,16,14,30,53.3%,8m
7521,3,[合作研究所]Supernova,3077,204,8,11,19,42.1%,21m
7521,1,entaroadun,3077,201,7,8,15,46.7%,28m
7521,3,IIIIIIIIIII,3077,144,3,5,8,37.5%,57m
7521,1,赖一祎和苏涵,3077,48,2,4,6,33.3%,1h
7521,3,predict,3077,30,1,3,4,25.0%,29m
7521,3,Kevin,3077,0,0,1,1,0.0%,28m
7521,1,抱歉,3077,0,0,1,1,0.0%,58m
7521,1,[萨尔那加议会]墨染流觞,3077,73,0,2,2,0.0%,54m
7535,3,[逗帝]萧炎,3076,704,43,35,78,55.1%,31m
7535,3,llllllllllll,3076,352,20,24,44,45.5%,54m
7535,3,[miku守护]鳴神,3076,165,8,8,16,50.0%,3m
7535,3,yuo,3076,214,8,12,20,40.0%,14m
7535,3,llllllllllll,3076,160,5,4,9,55.6%,54m
7535,1,落月潇潇,3076,184,5,4,9,55.6%,31m
7535,1,[不知不觉天亮]回归已是一人,3076,84,2,2,4,50.0%,13m
7535,1,不赶时间,3076,76,2,3,5,40.0%,16m
7535,1,[FILIX]致流浪的你,3076,0,1,0,1,100.0%,13m
7535,3,纯洁的男,3076,0,1,2,3,33.3%,11m
7535,1,[华夏何平]Frstleve,3076,0,0,1,1,0.0%,1h
7535,3,[v字复仇队]新哥哥完美,3076,0,0,1,1,0.0%,54m
7535,3,[戏命大魔王]ShriaZzz,3076,0,0,1,1,0.0%,21m
7535,1,[剑与玫瑰]空中漫步,3076,0,0,2,2,0.0%,16m
7549,3,[BGD]桶哥,3075,1002,138,111,249,55.4%,15m
7549,3,缘灭,3075,1005,56,62,118,47.5%,30m
7549,1,亲吾宝尼,3075,772,34,20,54,63.0%,5m
7549,3,物种,3075,425,16,15,31,51.6%,57m
7549,3,你不知道我是谁,3075,462,16,20,36,44.4%,27m
7549,1,[请叫我萌本]我儿子爱造航母,3075,466,14,10,24,58.3%,54m
7549,2,[背水一战]rwqq,3075,0,5,1,6,83.3%,54m
7549,2,blackknife,3075,138,3,4,7,42.9%,47m
7549,1,艾尔的屑主教,3075,0,0,1,1,0.0%,46m
7549,1,SmileTow,3075,0,0,1,1,0.0%,1h
7549,3,[背着预言家的]醉酒茬红尘,3075,0,0,1,1,0.0%,1h
7560,3,血色极光,3074,1140,91,82,173,52.6%,50m
7560,3,[纵丨横]璀璨之心,3074,1356,60,49,109,55.0%,9m
7560,3,FrozenEAKSO,3074,417,16,12,28,57.1%,9m
7560,2,惜丶兮,3074,181,7,1,8,87.5%,54m
7560,2,失窃的未来,3074,209,6,4,10,60.0%,1h
7560,1,牛牛怪人,3074,220,6,5,11,54.5%,16m
7560,1,有话直说,3074,166,5,1,6,83.3%,7m
7560,3,你那么矮怎么不去,3074,162,5,2,7,71.4%,50m
7560,1,粪海狂蛆,3074,156,4,6,10,40.0%,28m
7560,1,[情谊永恒]oir,3074,42,2,0,2,100.0%,7m
7560,1,vainope,3074,0,1,1,2,50.0%,35m
7560,3,kdfpa,3074,97,1,1,2,50.0%,1h
7560,3,IIIIIIIIII,3074,40,1,6,7,14.3%,51m
7560,1,[干死]对面的死妈玩意,3074,0,0,1,1,0.0%,7m
7560,1,邪王真眼是最强的,3074,0,0,1,1,0.0%,6m
7575,1,[Vgirls]命运天使,3073,659,25,15,40,62.5%,7m
7575,3,香巴拉帅猫,3073,230,13,23,36,36.1%,18m
7575,3,yqx,3073,358,12,13,25,48.0%,10m
7575,1,KakA,3073,110,4,0,4,100.0%,11m
7575,1,KUKUKIKI,3073,80,2,1,3,66.7%,53m
7575,3,[SHD2]AndrewLau,3073,0,1,3,4,25.0%,6m
7575,1,IIIIIIIIIIII,3073,36,1,3,4,25.0%,16m
7575,1,[miku守护]狂怒肆意,3073,0,0,1,1,0.0%,52m
7575,1,[乱杀]你的工蜂被屠啦,3073,0,0,1,1,0.0%,54m
7575,3,雅思娜,3073,0,0,2,2,0.0%,12m
7585,3,三叶草战神,3072,1500,150,126,276,54.3%,4m
7585,1,Thrones,3072,511,18,18,36,50.0%,6m
7585,1,虹滨,3072,461,16,7,23,69.6%,24m
7585,1,[刺蛇单推协会]天行,3072,337,15,13,28,53.6%,16m
7585,3,提耶拉,3072,399,15,16,31,48.4%,23m
7585,1,loveGjl,3072,323,14,12,26,53.8%,16m
7585,3,[五月花]全太阳的女巫帽,3072,210,8,11,19,42.1%,54m
7585,1,[你是狗逼吗]干掉上帝,3072,76,2,1,3,66.7%,5m
7585,1,[BETTY]pry,3072,0,1,2,3,33.3%,1h
7594,3,杰尼丶杰尼,3071,1572,161,147,308,52.3%,8m
7594,1,[极限菜鸟]dawn,3071,1287,70,41,111,63.1%,56m
7594,3,[混元形意]Fighter,3071,715,40,39,79,50.6%,22m
7594,3,[华溪岛]极光,3071,886,36,40,76,47.4%,27m
7594,1,[NPUED]代表,3071,307,11,5,16,68.8%,53m
7594,1,核弹爆炸,3071,222,6,9,15,40.0%,8m
7594,1,asgdfgdfgfdg,3071,44,1,2,3,33.3%,7m
7594,3,黑崎一护,3071,0,0,1,1,0.0%,29m
7602,1,清梦只是梦,3070,503,20,13,33,60.6%,22m
7602,3,醉卧沙场君莫笑,3070,455,16,18,34,47.1%,54m
7602,3,[Sc养老]IIIIIIIIIIII,3070,347,12,12,24,50.0%,7m
7602,3,[谐星难度]电脑,3070,207,9,7,16,56.2%,7m
7602,1,凤凰圣主,3070,250,7,7,14,50.0%,56m
7602,1,Forever,3070,272,6,4,10,60.0%,7m
7602,1,秒我是哪个,3070,112,4,3,7,57.1%,23m
7602,1,[万生相]天水麒麟,3070,82,2,1,3,66.7%,22m
7602,1,BTCtotheMoon,3070,0,0,4,4,0.0%,1h
7611,3,operation,3069,1122,284,288,572,49.7%,23m
7611,3,一波先生,3069,1532,238,223,461,51.6%,12m
7611,3,ZzZiLong,3069,1481,99,107,206,48.1%,13m
7611,3,时崎狂三,3069,1549,87,73,160,54.4%,8m
7611,3,叛逆者,3069,1560,84,77,161,52.2%,7m
7611,3,贪吃兽,3069,862,76,49,125,60.8%,25m
7611,3,骆驼,3069,1447,73,54,127,57.5%,12m
7611,3,我什么都看不见了,3069,1437,60,66,126,47.6%,14m
7611,1,[五月花]eiloeilo,3069,1171,52,35,87,59.8%,24m
7611,3,小风石,3069,696,43,41,84,51.2%,19m
7611,3,一只橙子,3069,675,25,23,48,52.1%,54m
7611,1,超级做做做,3069,292,18,8,26,69.2%,29m
7611,1,IIIIIIIIIII,3069,490,15,17,32,46.9%,21m
7611,3,SuperMan,3069,121,4,3,7,57.1%,51m
7611,1,IIIIIIIIIIII,3069,138,3,2,5,60.0%,1h
7626,3,[请先打我隊友]cayingsation,3068,389,25,32,57,43.9%,23m
7626,2,麻辣小聋瞎,3068,319,11,8,19,57.9%,18m
7626,1,倾红颜丶笑一心,3068,0,4,1,5,80.0%,1h
7626,3,最爱西瓜汁,3068,92,4,10,14,28.6%,5m
7626,3,西郭先生,3068,30,2,4,6,33.3%,23m
7626,1,Tyr,3068,40,1,1,2,50.0%,54m
7626,1,tigerhuxiao,3068,0,0,2,2,0.0%,51m
7626,3,[scttt]德玛西亚,3068,0,0,4,4,0.0%,11m
7634,3,Lsz,3067,1552,234,235,469,49.9%,23m
7634,3,bohu,3067,1336,178,175,353,50.4%,57m
7634,3,Rask,3067,857,68,61,129,52.7%,11m
7634,3,Cloudymoon,3067,384,14,16,30,46.7%,15m
7634,3,GVisbest,3067,277,11,1,12,91.7%,55m
7634,1,[电竟毒奶]坠落凡尘,3067,118,4,3,7,57.1%,22m
7634,3,YDH,3067,30,2,4,6,33.3%,4m
7641,3,[星辉国际]孙总,3066,438,15,16,31,48.4%,25m
7641,1,kotori,3066,366,14,14,28,50.0%,9m
7641,1,[我们是无敌的]菜鸟克高手,3066,289,11,2,13,84.6%,13m
7641,1,斜眼笑,3066,388,11,7,18,61.1%,7m
7641,3,nomanner,3066,198,9,11,20,45.0%,30m
7641,1,夜天之书,3066,110,3,3,6,50.0%,22m
7641,1,醒醒,3066,52,2,3,5,40.0%,13m
7641,1,女孩也能打星际,3066,0,1,0,1,100.0%,13m
7641,1,暴风,3066,0,0,1,1,0.0%,22m
7650,1,NIJAT,3065,797,40,13,53,75.5%,11m
7650,3,[火焰雷兽]星沉月浮,3065,929,36,33,69,52.2%,12m
7650,1,thatmine,3065,393,28,16,44,63.6%,56m
7650,1,内不输,3065,534,20,15,35,57.1%,53m
7650,3,[薄暮之光]Bruce,3065,537,19,19,38,50.0%,50m
7650,1,[嘤遍全球]ygyujiua,3065,314,10,5,15,66.7%,19m
7650,3,[暴雪十队]倾风雨里爱你,3065,242,9,13,22,40.9%,55m
7650,1,梦醒繁花落,3065,118,4,1,5,80.0%,7m
7650,3,永恒天幕,3065,97,4,2,6,66.7%,15m
7650,1,宝树堂,3065,0,3,2,5,60.0%,1h
7650,1,架完坦克投枪兵,3065,78,2,4,6,33.3%,53m
7650,3,[鬼谷]氯化氢公主,3065,0,2,4,6,33.3%,11m
7650,1,[元苜会]水滴,3065,0,1,0,1,100.0%,12m
7650,1,Ertong,3065,0,0,1,1,0.0%,14m
7650,1,会在爱过吗,3065,0,0,1,1,0.0%,11m
7650,1,[ImPa丶]IIIIIIIIIIII,3065,0,0,1,1,0.0%,54m
7650,1,tianyungao,3065,0,0,3,3,0.0%,14m
7667,3,[DukeA]Stork,3064,1148,154,164,318,48.4%,13m
7667,3,[您好]白球带冲锋,3064,712,40,48,88,45.5%,23m
7667,1,[Chiken]無心,3064,642,30,11,41,73.2%,54m
7667,1,宽锚人未来可期,3064,808,30,19,49,61.2%,17m
7667,3,绝地翻盘,3064,181,18,11,29,62.1%,23m
7667,1,littleyu,3064,266,15,7,22,68.2%,19m
7667,3,[北极光小组]藏逝,3064,260,10,7,17,58.8%,55m
7667,1,FrostyFeet,3064,279,7,5,12,58.3%,21m
7667,1,小雨,3064,140,6,5,11,54.5%,1h
7667,1,打硬铁的铁匠,3064,186,5,5,10,50.0%,54m
7667,1,李二傻,3064,0,4,1,5,80.0%,53m
7667,1,下手慢点,3064,160,4,4,8,50.0%,7m
7667,3,东莞龙骑士,3064,171,4,6,10,40.0%,3m
7667,1,就是干,3064,38,1,3,4,25.0%,14m
7667,2,[中二疯人院]暗夜风暴,3064,36,1,3,4,25.0%,15m
7667,1,[魔法少女小屋]非余生,3064,0,0,1,1,0.0%,7m
7683,3,没有,3063,1499,126,132,258,48.8%,30m
7683,3,saadg,3063,617,67,54,121,55.4%,8m
7683,3,Violet,3063,537,27,14,41,65.9%,11m
7683,3,卫宫士郎,3063,410,19,21,40,47.5%,13m
7683,1,liuxx,3063,350,12,5,17,70.6%,11m
7683,3,拜月丶,3063,212,11,7,18,61.1%,51m
7683,1,Innovation,3063,271,9,3,12,75.0%,53m
7683,2,naxx,3063,231,8,5,13,61.5%,5m
7683,1,星际之旅雷应昊,3063,120,4,3,7,57.1%,11m
7683,1,灯徒子,3063,0,4,3,7,57.1%,1h
7683,1,麺鮔人笙,3063,156,4,6,10,40.0%,24m
7683,1,[Guilty]ArchEgoist,3063,38,2,0,2,100.0%,5m
7683,1,Yoki,3063,0,1,0,1,100.0%,56m
7683,1,深圳孙一峰,3063,38,1,1,2,50.0%,23m
7683,1,阿澄,3063,0,0,1,1,0.0%,52m
7698,2,uuu,3062,1336,463,453,916,50.5%,28m
7698,3,MoonWalker,3062,759,87,87,174,50.0%,6m
7698,3,BLUE,3062,1015,40,38,78,51.3%,15m
7698,1,忠诚,3062,665,24,19,43,55.8%,8m
7698,2,花某,3062,167,7,5,12,58.3%,1h
7698,2,PenZhan,3062,0,4,2,6,66.7%,1h
7698,3,赵小墨,3062,0,0,1,1,0.0%,5m
7698,3,[潸然丶那些年]HLyx,3062,0,0,5,5,0.0%,23m
7706,3,IIIIIIIIIIII,3061,1575,328,315,643,51.0%,19m
7706,3,萧影殿下,3061,890,36,39,75,48.0%,15m
7706,3,星蓝海,3061,840,34,26,60,56.7%,22m
7706,3,南充高级中学,3061,425,16,16,32,50.0%,25m
7706,3,llllllllllll,3061,173,9,12,21,42.9%,12m
7706,1,boleng,3061,205,7,0,7,100.0%,9m
7706,2,小魔,3061,121,5,3,8,62.5%,1h
7706,1,[超级霸道]黑夜寒流,3061,156,4,1,5,80.0%,6m
7706,1,[QAQ55]OGLinX,3061,40,2,1,3,66.7%,23m
7706,1,Cheat,3061,0,1,0,1,100.0%,57m
7706,3,意志抑制异志,3061,0,1,0,1,100.0%,51m
7706,1,鹿无双,3061,40,1,1,2,50.0%,7m
7706,3,HistCool,3061,0,1,2,3,33.3%,7m
7706,1,吕归尘,3061,0,0,1,1,0.0%,9m
7706,1,[GKNB]皓月牌消防栓,3061,0,0,1,1,0.0%,6m
7721,1,疯狂的叉叉,3060,991,45,22,67,67.2%,53m
7721,3,xcy,3060,854,35,34,69,50.7%,25m
7721,3,醉后不知天在水,3060,590,34,30,64,53.1%,15m
7721,3,[基金会]星际只会出隐刀,3060,464,27,27,54,50.0%,4m
7721,3,[SUSTC]孤独狼,3060,258,10,13,23,43.5%,20m
7721,1,MagicSnorlax,3060,310,8,5,13,61.5%,19m
7721,3,ruby,3060,154,6,14,20,30.0%,20m
7721,1,IIIIIIIIIIII,3060,0,1,0,1,100.0%,22m
7721,1,天猫商城卖战舰,3060,40,1,1,2,50.0%,14m
7721,2,[iN]路飞会飞,3060,0,1,4,5,20.0%,11m
7721,1,[随机指挥官]shc,3060,0,0,1,1,0.0%,28m
7721,1,[黄旭东说]你的优势很大,3060,0,0,2,2,0.0%,14m
7733,1,Rain,3059,1035,51,18,69,73.9%,54m
7733,1,[8DA]jianzhongx,3059,612,23,20,43,53.5%,16m
7733,1,[青铜树]三土,3059,498,15,12,27,55.6%,28m
7733,1,[ECNUM]AntJPMystery,3059,391,12,19,31,38.7%,53m
7733,1,流炎若水,3059,0,4,1,5,80.0%,1h
7733,3,[暴雪十一队]llll,3059,97,4,1,5,80.0%,7m
7733,3,[肌肉]常师傅千锤百炼,3059,114,4,11,15,26.7%,15m
7733,3,[星星星]COLDFLAME,3059,0,1,0,1,100.0%,7m
7733,1,lllllllllll,3059,0,1,0,1,100.0%,7m
7733,1,[SDE]豆腐脑是甜的,3059,0,0,1,1,0.0%,7m
7733,1,[哔哩哔哩肝杯]雄霸天下,3059,0,0,1,1,0.0%,30m
7733,1,[TEAM21]蛙族之心,3059,0,0,1,1,0.0%,22m
7745,3,[你选的嘛偶像]武君罗喉,3058,1500,104,89,193,53.9%,11m
7745,1,plover,3058,250,45,24,69,65.2%,22m
7745,3,白音黑歌,3058,598,25,19,44,56.8%,30m
7745,2,[Sc养老]过尘,3058,288,14,8,22,63.6%,51m
7745,1,[成电沙河]yesmarWT,3058,457,13,12,25,52.0%,7m
7745,1,whh,3058,280,8,3,11,72.7%,9m
7745,2,[高阶战争使者]Kurumi,3058,142,6,1,7,85.7%,37m
7745,3,prayer,3058,108,5,2,7,71.4%,1h
7745,1,[猫之地灵殿]丝瓜猫,3058,94,5,3,8,62.5%,59m
7745,3,[金牌飞行员]高人在我身边,3058,97,4,2,6,66.7%,36m
7745,1,[独裁人机]Hanamaru,3058,0,3,2,5,60.0%,44m
7745,1,暴躁小牛,3058,0,0,1,1,0.0%,24m
7757,3,[星际小马]友谊的魔法,3057,1206,299,280,579,51.6%,54m
7757,2,JustLoser,3057,1560,201,199,400,50.2%,55m
7757,3,[别想歪]来给我咬,3057,1044,85,80,165,51.5%,29m
7757,1,冰冰冰,3057,527,28,12,40,70.0%,26m
7757,3,llllllllllll,3057,192,8,7,15,53.3%,28m
7757,3,恋紫,3057,0,4,2,6,66.7%,7m
7757,1,[饕鬄]茫然之死灵,3057,0,3,2,5,60.0%,20m
7757,1,祖国花骨朵,3057,80,2,2,4,50.0%,31m
7757,3,[闪电伍连鞭]贝塔,3057,62,2,8,10,20.0%,21m
7757,1,[鲁德欢]IIIIIIIIIIII,3057,34,1,1,2,50.0%,7m
7757,1,wywk,3057,42,1,4,5,20.0%,22m
7757,3,星空幻想,3057,0,0,1,1,0.0%,1h
7769,2,[999]绝对黑马,3056,1433,132,135,267,49.4%,16m
7769,3,llllllllllll,3056,890,49,45,94,52.1%,11m
7769,3,BoundlesS,3056,459,25,29,54,46.3%,15m
7769,1,转虫先锋,3056,364,12,9,21,57.1%,21m
7769,1,低落世界出其小友,3056,0,4,1,5,80.0%,20m
7769,3,[王者归来]香蕉,3056,97,3,1,4,75.0%,5m
7769,1,IOKingGgwF,3056,162,3,8,11,27.3%,19m
7769,3,GammaRay,3056,30,2,1,3,66.7%,3m
7769,1,叶落有孤城,3056,0,1,0,1,100.0%,14m
7769,1,周星星,3056,0,1,2,3,33.3%,53m
7769,1,[EXA]ZergGlory,3056,42,1,3,4,25.0%,7m
7769,3,[绝世高手]丿爆小七,3056,0,0,1,1,0.0%,29m
7769,1,[野蛮猫骑士]匹夫一怒血溅五步,3056,0,0,3,3,0.0%,46m
7782,3,Bin,3055,1402,58,52,110,52.7%,50m
7782,3,粉红喵喵拳,3055,814,29,34,63,46.0%,54m
7782,1,[DMRe]哀泣的梦魇,3055,367,17,10,27,63.0%,28m
7782,1,阿虚,3055,522,17,19,36,47.2%,7m
7782,1,三千分的鸡,3055,258,8,6,14,57.1%,21m
7782,3,黑白信仰,3055,0,1,0,1,100.0%,14m
7782,3,我不是虫群,3055,0,1,0,1,100.0%,50m
7782,1,ACfan,3055,0,1,1,2,50.0%,20m
7782,1,[GSC]ArFiGyCanT,3055,0,1,2,3,33.3%,24m
7782,2,[一起犯罪]流氓,3055,42,1,3,4,25.0%,54m
7782,1,gufu,3055,0,0,1,1,0.0%,11m
7793,2,[miku守护]黑暗骑士,3054,1529,425,429,854,49.8%,53m
7793,3,feiyezi,3054,1511,319,282,601,53.1%,51m
7793,3,PiMba,3054,1482,120,89,209,57.4%,13m
7793,1,Vctxixi,3054,1741,86,72,158,54.4%,20m
7793,3,小艾不要炫,3054,508,25,16,41,61.0%,53m
7793,3,青铜狗,3054,656,22,28,50,44.0%,9m
7793,1,[红色锤镰]Jupiter,3054,299,17,12,29,58.6%,6m
7793,3,FSH,3054,266,11,9,20,55.0%,11m
7793,3,StevenGG,3054,256,11,10,21,52.4%,7m
7793,3,叫兽,3054,336,11,14,25,44.0%,54m
7793,3,[Rhusky]云梦,3054,222,10,6,16,62.5%,29m
7793,2,马栏山孙一峰,3054,251,9,3,12,75.0%,15m
7793,2,血誓伊,3054,165,6,2,8,75.0%,1h
7793,1,[斯雷恩领主]大佬带我呀,3054,82,5,4,9,55.6%,7m
7793,1,[rushnm]ChuiNiuBier,3054,112,4,3,7,57.1%,14m
7793,1,玩世不恭,3054,0,3,2,5,60.0%,20m
7793,1,Style,3054,120,3,2,5,60.0%,7m
7793,1,吴翰,3054,70,2,3,5,40.0%,19m
7793,3,[暗黑幻想]BBOYCHEERS,3054,18,1,11,12,8.3%,7m
7793,1,习惯的走位,3054,0,0,1,1,0.0%,57m
7793,2,[某科学的]博丽灵梦,3054,0,0,1,1,0.0%,57m
7793,1,zcy,3054,0,0,2,2,0.0%,1h
7815,1,[媛气少女]不改一次浪费了,3053,1508,90,56,146,61.6%,20m
7815,1,[肌肉]asd,3053,310,25,17,42,59.5%,31m
7815,1,[Pemnst]萌动乐乐,3053,433,17,8,25,68.0%,53m
7815,1,剑走偏锋,3053,546,16,16,32,50.0%,54m
7815,3,西瓜刀少年,3053,228,8,20,28,28.6%,26m
7815,1,诺兹多姆,3053,0,1,0,1,100.0%,13m
7815,1,[AreS神会]愤怒的探机,3053,0,0,1,1,0.0%,17m
7815,1,[这是智障吗]他充钱了快跑,3053,0,0,1,1,0.0%,23m
7815,1,[23CM]窝窝头一块钱四个,3053,0,0,1,1,0.0%,6m
7824,3,牛大二细,3052,1567,194,186,380,51.1%,7m
7824,3,[哔哩哔哩乾杯]归海寒湘,3052,1571,125,121,246,50.8%,26m
7824,3,seven,3052,1430,92,79,171,53.8%,56m
7824,1,[Kin]寒江,3052,1692,81,66,147,55.1%,53m
7824,1,[江南剑客]Swordsman,3052,966,39,32,71,54.9%,12m
7824,3,sky,3052,888,35,32,67,52.2%,57m
7824,3,IIIIIIIIIIII,3052,451,24,24,48,50.0%,53m
7824,1,NTNVIN,3052,340,19,7,26,73.1%,53m
7824,1,永远单推星街彗星,3052,446,18,16,34,52.9%,12m
7824,3,Rain,3052,306,12,18,30,40.0%,7m
7824,2,加藤惠,3052,266,9,13,22,40.9%,17m
7824,2,[LOHv]NIMAB,3052,154,7,17,24,29.2%,55m
7824,1,TonyTommy,3052,150,5,4,9,55.6%,2m
7824,3,Knight,3052,56,5,8,13,38.5%,23m
7824,3,[人类防卫阵线]黑白大老鼠,3052,124,4,9,13,30.8%,30m
7824,3,[我们是无敌的]daddyhm,3052,119,3,2,5,60.0%,15m
7824,1,星邪不是星谐,3052,107,3,3,6,50.0%,21m
7824,1,[暴雪二十一队]YounGG,3052,34,1,1,2,50.0%,56m
7824,1,孤城,3052,36,1,3,4,25.0%,53m
7824,1,PartinG,3052,40,1,4,5,20.0%,13m
7824,1,[龙宫礼奈]yuanyuan,3052,40,1,4,5,20.0%,15m
7824,3,平安时代的黑云,3052,0,1,4,5,20.0%,6m
7824,2,你要找茬吗小子,3052,0,0,1,1,0.0%,1h
7847,1,小梨衣,3051,308,39,19,58,67.2%,23m
7847,1,MarsXX,3051,1116,39,42,81,48.1%,24m
7847,1,[ACE绝望军]堵口不关我事,3051,382,15,5,20,75.0%,21m
7847,3,LayoSHY,3051,404,15,17,32,46.9%,11m
7847,2,HIMAN,3051,0,1,0,1,100.0%,33m
7847,1,你好晴天,3051,0,1,2,3,33.3%,7m
7847,1,牛川,3051,40,1,2,3,33.3%,53m
7847,3,[上海龙]LeeJaeGon,3051,0,0,1,1,0.0%,7m
7847,1,darkness,3051,0,0,5,5,0.0%,46m
7856,3,冲不下来怎么办,3050,1562,203,176,379,53.6%,9m
7856,1,[万X奔腾]侯蹦蹦,3050,517,24,11,35,68.6%,9m
7856,3,艾文,3050,655,24,23,47,51.1%,4m
7856,1,永川纱夜,3050,651,21,17,38,55.3%,23m
7856,3,[woo]hammerhao,3050,430,15,31,46,32.6%,9m
7856,1,TayTay,3050,402,11,8,19,57.9%,53m
7856,1,lien,3050,285,10,2,12,83.3%,23m
7856,1,[27CM]SOLA,3050,270,8,3,11,72.7%,14m
7856,3,hhh,3050,201,7,11,18,38.9%,25m
7856,1,[AFSC2]Mordecai,3050,157,3,1,4,75.0%,23m
7856,1,最后的哀伤,3050,132,3,3,6,50.0%,15m
7856,1,Ancr,3050,76,2,4,6,33.3%,12m
7856,3,[绿林响马]龙骑士伊志平,3050,0,1,0,1,100.0%,29m
7856,1,zero,3050,38,1,1,2,50.0%,6m
7856,1,Seeyou,3050,0,0,2,2,0.0%,7m
7856,1,[S天堂之魔]衡阳枪兵王,3050,0,0,3,3,0.0%,7m
7872,3,tianyongzhu,3049,1372,181,161,342,52.9%,16m
7872,1,Ichigo,3049,1481,123,94,217,56.7%,7m
7872,1,重中之重,3049,1433,56,48,104,53.8%,16m
7872,1,[不死突袭3]麻辣烫,3049,288,45,37,82,54.9%,14m
7872,3,猜猜看,3049,468,16,22,38,42.1%,26m
7872,1,[EGE]曲速,3049,407,13,7,20,65.0%,11m
7872,3,[暴雪我是你爹]RangerX,3049,97,2,1,3,66.7%,39m
7872,1,zzztj,3049,0,1,0,1,100.0%,59m
7872,1,[不知]liu,3049,0,0,1,1,0.0%,26m
7881,3,[末日孤舰]小林大悟,3048,1523,306,298,604,50.7%,23m
7881,3,倒下的白门楼,3048,1594,109,124,233,46.8%,23m
7881,1,[HME]PqiIIIIIIGaP,3048,1421,54,47,101,53.5%,26m
7881,1,段筱侃,3048,940,40,24,64,62.5%,5m
7881,1,[VCTO]无情,3048,943,36,31,67,53.7%,17m
7881,1,[ISMU星际]brian,3048,888,30,24,54,55.6%,24m
7881,1,雨夜,3048,262,14,3,17,82.4%,53m
7881,1,[55open]北琦玉之神,3048,257,10,7,17,58.8%,1h
7881,3,带把的核桃,3048,256,8,17,25,32.0%,53m
7881,1,[Onceme]听风飘逸,3048,224,7,4,11,63.6%,30m
7881,3,小小先生,3048,179,6,1,7,85.7%,17m
7881,1,Snorlax,3048,117,5,4,9,55.6%,22m
7881,1,明熙丶,3048,78,3,3,6,50.0%,21m
7881,1,暴躁的裤子,3048,78,2,1,3,66.7%,29m
7881,3,Cyberpsycho,3048,30,2,5,7,28.6%,30m
7881,1,rusher,3048,0,0,1,1,0.0%,16m
7897,3,IDoL,3047,1558,194,182,376,51.6%,11m
7897,2,[恶劣玩家]北国丶雪域,3047,1239,77,77,154,50.0%,16m
7897,1,Connley,3047,371,13,13,26,50.0%,54m
7897,1,diachristo,3047,252,9,6,15,60.0%,1h
7897,1,Egoist,3047,274,8,5,13,61.5%,14m
7897,1,[FJUT]pimba,3047,269,6,5,11,54.5%,17m
7897,1,JUDGE,3047,182,6,5,11,54.5%,31m
7897,2,[两道菜]稳稳稳,3047,194,6,8,14,42.9%,5m
7897,1,DavidWai,3047,134,5,4,9,55.6%,53m
7897,1,三球真姬,3047,0,4,1,5,80.0%,1h
7897,1,喜欢你时风好甜,3047,0,3,2,5,60.0%,1h
7897,1,鲸落虚,3047,0,2,3,5,40.0%,1h
7897,1,[LSLS]PHOCHOU,3047,0,1,1,2,50.0%,6m
7897,1,[孙红雷]SamTsui,3047,0,0,1,1,0.0%,6m
7897,1,[mantis]天灾刺蛇,3047,0,0,4,4,0.0%,19m
7897,1,直翅目跳虫,3047,73,0,4,4,0.0%,28m
7913,1,NorthX,3046,1656,83,76,159,52.2%,24m
7913,3,桃源寻梦,3046,988,33,47,80,41.2%,4m
7913,3,kira,3046,619,26,23,49,53.1%,11m
7913,1,IIIIIIII,3046,452,18,15,33,54.5%,54m
7913,3,[五月花]IIIIIIIIIIII,3046,442,17,15,32,53.1%,13m
7913,3,夜航星,3046,477,16,19,35,45.7%,27m
7913,3,寒释冰,3046,122,5,3,8,62.5%,4m
7913,3,飒飒大,3046,97,4,3,7,57.1%,43m
7913,3,[七星]黑暗杀戮,3046,124,4,10,14,28.6%,13m
7913,1,咬死饺子,3046,0,3,2,5,60.0%,1h
7913,1,[野蛮猫骑士]她说万幸得以相识,3046,96,3,3,6,50.0%,1h
7913,1,[卫星点灯丶]三玖丶,3046,40,2,0,2,100.0%,7m
7913,1,此号上不了大师,3046,0,1,0,1,100.0%,9m
7913,1,[XXHZ29]小凌在此,3046,0,1,1,2,50.0%,19m
7913,1,[为谁而忧伤]EuFLORA,3046,0,0,1,1,0.0%,53m
7928,1,小小菜,3045,474,23,10,33,69.7%,7m
7928,1,FunkyPanda,3045,401,16,12,28,57.1%,13m
7928,1,holylight,3045,268,15,13,28,53.6%,6m
7928,1,[麒云]IIIIIIIIIIII,3045,199,7,0,7,100.0%,22m
7928,1,钟汉良,3045,183,7,4,11,63.6%,29m
7928,1,王小明,3045,172,7,4,11,63.6%,7m
7928,1,[Swing]没节操,3045,48,5,1,6,83.3%,21m
7928,1,神奇小徐,3045,160,5,5,10,50.0%,23m
7928,3,刘使君,3045,119,4,3,7,57.1%,21m
7928,1,[你已经死啦]凉城再无爱,3045,34,2,0,2,100.0%,6m
7928,1,[TCP]hallotongxue,3045,30,2,1,3,66.7%,5m
7928,3,[突变攻略组]蕉兵必败,3045,0,1,5,6,16.7%,28m
7928,1,[小金上天队]不旗鼓相当的对手,3045,0,0,1,1,0.0%,15m
7928,1,[鸡饲料加工厂]滥青年,3045,0,0,2,2,0.0%,24m
7928,1,[非洲度假]sora,3045,0,0,3,3,0.0%,6m
7943,2,lazyandfat,3044,1555,249,268,517,48.2%,16m
7943,3,[119]自由之翼,3044,954,83,85,168,49.4%,53m
7943,3,地狱灬寒冰,3044,1507,70,78,148,47.3%,24m
7943,3,曦曦了不起,3044,119,34,31,65,52.3%,15m
7943,1,入骨相思知不知,3044,707,32,17,49,65.3%,31m
7943,1,[夏恋]卡兰,3044,364,14,10,24,58.3%,23m
7943,1,闲云野鹤,3044,285,9,3,12,75.0%,54m
7943,1,[KPG]scvimba,3044,296,8,9,17,47.1%,12m
7943,1,[崑焅]怀言者,3044,120,6,4,10,60.0%,1h
7943,3,CCCCL,3044,156,6,12,18,33.3%,12m
7943,3,Berlinetta,3044,0,3,2,5,60.0%,1h
7943,1,[CPT]嘤彡喵班长,3044,164,3,4,7,42.9%,31m
7943,3,薙切绘里奈,3044,0,0,1,1,0.0%,1h
7956,3,醉酒当歌,3043,1315,435,410,845,51.5%,51m
7956,3,IIIIIIIIIIII,3043,1488,68,60,128,53.1%,54m
7956,1,Mars,3043,1148,43,38,81,53.1%,8m
7956,3,雅色易续风,3043,510,19,23,42,45.2%,30m
7956,3,海绵宝宝洛克儿,3043,403,17,12,29,58.6%,15m
7956,1,kai,3043,449,15,13,28,53.6%,15m
7956,1,llllllllllll,3043,305,13,4,17,76.5%,5m
7956,1,大番薯,3043,336,9,12,21,42.9%,15m
7956,2,一级响应,3043,124,6,6,12,50.0%,1h
7956,1,skydxmx,3043,0,5,0,5,100.0%,1h
7956,1,黄老板救我,3043,48,4,2,6,66.7%,1h
7956,2,光明降临,3043,0,4,3,7,57.1%,1h
7956,1,呵呵,3043,148,4,5,9,44.4%,14m
7956,1,西木野真姬,3043,0,3,2,5,60.0%,14m
7956,1,[运营之神]MixParG,3043,46,1,3,4,25.0%,1h
7956,1,Mortred,3043,0,0,1,1,0.0%,12m
7956,1,[不要毒奶]IMBAdeT,3043,0,0,1,1,0.0%,9m
7973,1,珂朵莉酱太可爱了,3042,1281,215,197,412,52.2%,31m
7973,1,[Roottt]CJherO,3042,750,33,20,53,62.3%,16m
7973,2,大勇哥丶咚咚咚,3042,164,5,1,6,83.3%,47m
7973,1,Zhuhai,3042,48,4,2,6,66.7%,1h
7973,3,Zhou,3042,152,4,7,11,36.4%,15m
7973,1,[底特律KAR]Blinker,3042,165,3,2,5,60.0%,14m
7973,1,何能吊打张卫启,3042,0,3,2,5,60.0%,44m
7973,1,星际迷,3042,40,2,1,3,66.7%,23m
7973,1,西木野甄姬,3042,0,1,2,3,33.3%,23m
7973,1,IIIIIIIIIIII,3042,0,0,1,1,0.0%,30m
7973,1,[圣杯战争]夜丶,3042,0,0,1,1,0.0%,29m
7984,3,RkKkgy,3041,941,39,34,73,53.4%,25m
7984,1,战神,3041,1025,36,30,66,54.5%,7m
7984,3,闪电法王,3041,376,34,36,70,48.6%,6m
7984,3,霸气江南,3041,579,29,35,64,45.3%,15m
7984,3,幻瘾,3041,668,28,42,70,40.0%,57m
7984,1,Odin,3041,365,16,12,28,57.1%,7m
7984,3,顾傻子,3041,187,12,8,20,60.0%,57m
7984,3,IWS,3041,316,12,15,27,44.4%,11m
7984,3,[慈溪宁]小包,3041,269,10,6,16,62.5%,11m
7984,3,[我亲爱的对手]恶魔天使,3041,272,10,15,25,40.0%,20m
7984,1,太行,3041,142,4,0,4,100.0%,53m
7984,1,[戏游人生]孙换家,3041,0,1,0,1,100.0%,9m
7984,1,淑惠的小狗砸,3041,0,1,0,1,100.0%,54m
7984,1,红枫,3041,0,1,1,2,50.0%,13m
7984,3,暗殇,3041,0,1,3,4,25.0%,4m
7984,3,yyt,3041,97,1,4,5,20.0%,26m
7984,1,[東風社]Bechervoka,3041,0,0,1,1,0.0%,31m
7984,1,山莴苣苦素,3041,0,0,1,1,0.0%,54m
7984,1,[缘之水]半夜忧伤,3041,0,0,1,1,0.0%,53m
8003,3,[远征舰队]中华远征军,3040,1186,101,81,182,55.5%,7m
8003,1,狂热陆战队员,3040,1650,83,65,148,56.1%,26m
8003,3,[妮妮专属]gamefy,3040,1036,56,43,99,56.6%,4m
8003,1,Flame,3040,1150,44,35,79,55.7%,7m
8003,3,usus,3040,451,24,36,60,40.0%,15m
8003,1,stwslll,3040,503,22,10,32,68.8%,7m
8003,3,纱雾,3040,451,19,25,44,43.2%,29m
8003,2,ShadowBoy,3040,380,15,9,24,62.5%,25m
8003,1,[为谁而忧伤]放开那女孩,3040,219,11,4,15,73.3%,14m
8003,3,沈梦欣的地心引力,3040,300,11,10,21,52.4%,21m
8003,1,[SFTRA3]BritishBall,3040,182,7,7,14,50.0%,23m
8003,1,[BLaDe]一把大宝剑,3040,0,2,3,5,40.0%,1h
8003,1,妖妖灵,3040,0,0,2,2,0.0%,23m
8016,3,半泽,3039,1587,198,208,406,48.8%,24m
8016,1,超级课程表,3039,1578,106,80,186,57.0%,16m
8016,3,机器制造,3039,1419,99,91,190,52.1%,54m
8016,1,两仪式,3039,1271,58,49,107,54.2%,24m
8016,3,[国铜战队]电脑难度丨普通丨,3039,1067,47,35,82,57.3%,27m
8016,3,IIIIIIIIIIII,3039,839,44,51,95,46.3%,7m
8016,3,[YM]SprinG,3039,954,36,36,72,50.0%,50m
8016,3,GunNRose,3039,591,24,21,45,53.3%,10m
8016,3,lilikaxi,3039,488,20,25,45,44.4%,3m
8016,3,无能狂怒,3039,322,11,13,24,45.8%,53m
8016,1,紧小肾危,3039,338,10,12,22,45.5%,22m
8016,3,[2233娘]掐柠檬的帕露西,3039,86,4,5,9,44.4%,39m
8016,1,选神族就输不了,3039,124,3,0,3,100.0%,12m
8016,2,似水流年,3039,114,3,3,6,50.0%,1h
8016,1,不动游走,3039,40,2,1,3,66.7%,2m
8016,1,绝不投降法兰西,3039,40,2,2,4,50.0%,7m
8016,1,[哔哩哔哩杯乾]ZYX,3039,0,1,0,1,100.0%,14m
8016,3,铜陵孙一峰,3039,0,0,2,2,0.0%,31m
8034,3,[勒雷联邦海军]巨像倒立扫飞龙,3038,1233,201,185,386,52.1%,21m
8034,3,董师汽车钥匙,3038,1372,161,157,318,50.6%,7m
8034,1,vanpersie,3038,1318,68,54,122,55.7%,19m
8034,3,心凌,3038,1037,52,57,109,47.7%,10m
8034,3,Irrational,3038,770,42,46,88,47.7%,15m
8034,1,樱幻,3038,649,26,13,39,66.7%,28m
8034,1,[普通难度]电脑,3038,578,18,16,34,52.9%,19m
8034,3,[大jj美少女]大吊少女,3038,264,10,15,25,40.0%,54m
8034,1,CuteSaber,3038,170,8,5,13,61.5%,46m
8034,1,[教我玩神族]河外空间站,3038,252,7,10,17,41.2%,2m
8034,3,[萌萌哒鸡]芳香的猪,3038,30,2,8,10,20.0%,55m
8034,1,sturdy,3038,38,1,1,2,50.0%,53m
8046,3,[暗室逢灯]瑟雷尼亚,3037,691,27,26,53,50.9%,11m
8046,1,赛塔姆布里尼,3037,600,25,14,39,64.1%,30m
8046,1,TinyTauren,3037,700,22,19,41,53.7%,54m
8046,1,未名之手,3037,260,11,14,25,44.0%,23m
8046,1,阿驴驴,3037,377,10,9,19,52.6%,29m
8046,1,大橙子,3037,230,9,4,13,69.2%,31m
8046,1,fightero,3037,302,9,10,19,47.4%,12m
8046,3,fantasybug,3037,208,8,4,12,66.7%,21m
8046,3,HandSomeHaw,3037,48,3,6,9,33.3%,3m
8046,1,白衣夜歌行丶,3037,124,2,1,3,66.7%,7m
8046,1,Truth,3037,0,0,1,1,0.0%,14m
8046,1,GoodGame,3037,0,0,1,1,0.0%,22m
8058,3,[开始掠夺]黑珍珠号的小弟,3036,1538,84,85,169,49.7%,12m
8058,1,llllllllllll,3036,928,55,41,96,57.3%,22m
8058,3,[艾尔之巅]我是余威我怕谁,3036,1147,49,47,96,51.0%,29m
8058,1,Kirin,3036,898,36,30,66,54.5%,56m
8058,1,绝世月夜枫,3036,382,19,5,24,79.2%,53m
8058,1,铁板鱿鱼,3036,431,17,9,26,65.4%,15m
8058,3,索然无味小刺蛇娘,3036,339,14,8,22,63.6%,26m
8058,1,[女王SVIT]TheShy,3036,248,8,3,11,72.7%,54m
8058,2,在结束处拉开序幕,3036,0,4,3,7,57.1%,22m
8058,1,故人倾,3036,126,3,0,3,100.0%,21m
8058,1,lixin,3036,118,3,3,6,50.0%,14m
8058,3,[FwgsOB]wintermelon,3036,122,2,6,8,25.0%,50m
8058,1,風之轨迹,3036,38,1,1,2,50.0%,8m
8058,1,电脑,3036,36,1,1,2,50.0%,22m
8058,3,烈火封印,3036,0,0,1,1,0.0%,21m
8073,3,让麻酱同化神族吧,3035,1362,66,67,133,49.6%,23m
8073,1,lIllllIIIIlI,3035,610,18,18,36,50.0%,23m
8073,1,狂龙,3035,606,18,21,39,46.2%,22m
8073,2,[NKTJ]教我打洛洛,3035,336,10,34,44,22.7%,25m
8073,3,[刺蛇互助天团]剑来,3035,60,3,0,3,100.0%,51m
8073,3,老劉,3035,120,3,0,3,100.0%,21m
8073,1,清清浅浅,3035,114,3,4,7,42.9%,21m
8073,2,變喸盦,3035,97,2,1,3,66.7%,22m
8073,1,明轩亦梦,3035,40,2,2,4,50.0%,57m
8073,3,苏筱北,3035,0,2,4,6,33.3%,28m
8073,1,[HoASD]gameboy,3035,0,1,0,1,100.0%,2m
8073,1,lalalalallal,3035,0,1,0,1,100.0%,17m
8073,1,逆流成河,3035,0,1,0,1,100.0%,57m
8073,1,果果的吉娜拉,3035,0,1,0,1,100.0%,11m
8073,1,[XXG]木偶,3035,0,1,0,1,100.0%,12m
8073,1,[社交学小可爱]她和手头一样紧,3035,0,1,0,1,100.0%,8m
8073,3,换家乐,3035,0,1,0,1,100.0%,21m
8073,3,[龙骨]ionicwind,3035,0,1,6,7,14.3%,12m
8073,1,dogdays,3035,0,0,1,1,0.0%,20m
8073,1,戒骄戒躁,3035,0,0,1,1,0.0%,28m
8073,3,Unchanged,3035,0,0,1,1,0.0%,21m
8073,3,伊巡,3035,0,0,4,4,0.0%,53m
8095,1,[SC2D]wolfgirl,3034,1356,76,67,143,53.1%,22m
8095,1,郝星辉,3034,1205,51,44,95,53.7%,31m
8095,3,心怡不倒翁,3034,788,28,34,62,45.2%,29m
8095,1,sdd,3034,413,17,12,29,58.6%,12m
8095,1,[纯路人]chb,3034,482,16,11,27,59.3%,16m
8095,1,wdk,3034,375,16,12,28,57.1%,13m
8095,3,飞越星河,3034,307,16,21,37,43.2%,27m
8095,1,[HoA]夜刀神十香,3034,332,14,5,19,73.7%,16m
8095,1,[嗑药小分队]DeathKnight,3034,472,14,16,30,46.7%,24m
8095,3,[SRI]彩笔没办法,3034,213,8,14,22,36.4%,30m
8095,3,教授,3034,121,5,2,7,71.4%,60m
8095,1,LIBERTY,3034,126,4,4,8,50.0%,53m
8095,1,斗鱼小宇丶,3034,152,4,7,11,36.4%,22m
8095,1,[剑七]夕惕若厉,3034,0,3,2,5,60.0%,53m
8095,1,溯流光,3034,36,2,0,2,100.0%,17m
8095,1,[miku守护]苹果炒辣椒,3034,36,2,1,3,66.7%,27m
8095,1,LieShoot,3034,38,2,1,3,66.7%,31m
8095,1,[万世大秦]狮子是大狮子,3034,0,1,0,1,100.0%,16m
8095,1,killer,3034,0,0,1,1,0.0%,28m
8114,1,乏善虚名,3033,1680,66,62,128,51.6%,7m
8114,1,富蓝氪淋企鹅,3033,897,34,27,61,55.7%,24m
8114,3,[Encore]白给的量仔,3033,275,12,19,31,38.7%,9m
8114,3,deemo,3033,146,6,4,10,60.0%,25m
8114,1,Creeper,3033,0,1,0,1,100.0%,54m
8114,1,[火焰雷兽]碎碎念,3033,0,1,1,2,50.0%,53m
8114,3,[Sc养老]BIBOU,3033,0,0,1,1,0.0%,1h
8121,1,[Beastp]SourTe,3032,1688,192,176,368,52.2%,53m
8121,3,[血色利刃]人生癫疯,3032,436,61,73,134,45.5%,8m
8121,3,川奈天吾,3032,1537,57,59,116,49.1%,3m
8121,1,[EoD]小张哥,3032,1150,48,31,79,60.8%,53m
8121,3,zardlike,3032,725,32,38,70,45.7%,23m
8121,3,钱东升,3032,347,12,14,26,46.2%,19m
8121,1,[鸡儿鸡儿]牛批的蜡笔小新,3032,242,8,6,14,57.1%,6m
8121,1,soi,3032,282,8,9,17,47.1%,23m
8121,1,[王富贵]Maple,3032,208,7,4,11,63.6%,7m
8121,1,向天再借五厘米,3032,222,6,7,13,46.2%,7m
8121,1,[刺蛇互助社团]Demons,3032,193,5,2,7,71.4%,14m
8121,1,忠肝义胆邢育森,3032,144,5,3,8,62.5%,55m
8121,1,[幻想神社]human,3032,105,3,0,3,100.0%,7m
8121,1,副官,3032,70,3,1,4,75.0%,24m
8121,1,LYB,3032,0,3,2,5,60.0%,1h
8121,1,[CM]Elric,3032,40,2,0,2,100.0%,7m
8121,1,[地球卫队]王小明,3032,38,2,0,2,100.0%,16m
8121,2,[嘤遍全球]MINO,3032,42,2,2,4,50.0%,1h
8121,1,[为了菲女王]失落叶,3032,72,2,3,5,40.0%,17m
8121,1,[玩个虫子]bigorbig,3032,40,2,4,6,33.3%,6m
8121,1,[迅哥儿]横眉冷对千夫指,3032,84,2,7,9,22.2%,17m
8121,1,Rebel,3032,0,1,0,1,100.0%,5m
8121,2,[幽冥之狼]天神下凡,3032,0,1,0,1,100.0%,1h
8144,3,chicken,3031,1623,80,85,165,48.5%,27m
8144,3,赐你死亡,3031,710,55,32,87,63.2%,6m
8144,1,[Rhusky]Yoga,3031,1121,47,35,82,57.3%,27m
8144,3,[探姬联萌]踏雪,3031,947,40,39,79,50.6%,13m
8144,1,[大毛无与伦比]二毛,3031,793,28,23,51,54.9%,23m
8144,1,[艾蒙敬老院]雷昊,3031,480,23,19,42,54.8%,2m
8144,1,我得重新集结部队,3031,487,20,12,32,62.5%,7m
8144,1,风画清颜,3031,372,13,10,23,56.5%,54m
8144,2,[萌萌吃包]早花怜羽,3031,0,4,3,7,57.1%,1h
8144,1,国服炸鱼亲妈暴毙,3031,0,1,0,1,100.0%,6m
8144,1,淡雅,3031,0,1,1,2,50.0%,23m
8144,1,[秦时明月]不爱董小姐,3031,0,0,1,1,0.0%,6m
8144,1,[青葱与纯色]凌星静夜,3031,0,0,1,1,0.0%,13m
8144,2,千与千寻,3031,0,0,1,1,0.0%,11m
8144,1,[我队伍很强大]滑稽的王尼玛,3031,0,0,2,2,0.0%,54m
8159,3,飞机飞机,3030,375,203,195,398,51.0%,27m
8159,3,icy,3030,1562,73,73,146,50.0%,8m
8159,1,Maps,3030,819,46,21,67,68.7%,12m
8159,1,人族就输不了,3030,646,34,10,44,77.3%,27m
8159,3,[四叶草]miaoxfive,3030,376,19,13,32,59.4%,25m
8159,3,柳先生,3030,256,11,8,19,57.9%,13m
8159,2,老王玩虫贼溜批,3030,146,6,5,11,54.5%,16m
8159,1,黑瞳天使,3030,146,5,3,8,62.5%,22m
8159,1,[法兰街舞队w]Arthas,3030,66,3,5,8,37.5%,7m
8159,1,只会打一波,3030,116,3,6,9,33.3%,7m
8159,1,[星际坟场选手]李氏神魔恋,3030,0,1,0,1,100.0%,7m
8159,1,ZERO,3030,0,1,0,1,100.0%,57m
8159,1,sakura,3030,40,1,1,2,50.0%,16m
8159,1,[贪玩]钢铁洪流,3030,0,1,2,3,33.3%,31m
8159,1,深夜的活动,3030,30,1,5,6,16.7%,8m
8159,1,白虎剑云飞,3030,0,0,2,2,0.0%,7m
8175,3,寂舞之司,3029,1620,388,374,762,50.9%,25m
8175,1,[冲就完了]只玩无敌的鸡谐化,3029,1168,68,44,112,60.7%,16m
8175,3,flying,3029,1170,46,50,96,47.9%,29m
8175,3,bingbing,3029,416,19,14,33,57.6%,19m
8175,1,Piezo,3029,522,19,22,41,46.3%,19m
8175,3,[Kuhaku]sky,3029,426,15,20,35,42.9%,27m
8175,1,caici,3029,265,7,5,12,58.3%,22m
8175,1,surprise,3029,174,6,6,12,50.0%,7m
8175,2,[武大萌新]沧海客,3029,196,5,5,10,50.0%,1h
8175,2,[工具人联盟]TLancelot,3029,0,4,2,6,66.7%,10m
8175,3,[HxD]Seldom,3029,122,4,12,16,25.0%,29m
8175,1,sysysysysy,3029,0,3,2,5,60.0%,1h
8175,1,豪放光头强,3029,40,2,0,2,100.0%,53m
8175,1,[卡拉传教士]最强近战小探机,3029,40,2,4,6,33.3%,22m
8175,1,[ctrlF1]天才的我,3029,0,1,0,1,100.0%,1h
8175,1,knight,3029,0,1,1,2,50.0%,7m
8175,1,Warden,3029,40,1,2,3,33.3%,7m
8175,1,[浪啊浪]ttx,3029,0,0,1,1,0.0%,56m
8193,3,sunpry,3028,1360,235,215,450,52.2%,7m
8193,1,[ACG系]凄隐落枫,3028,1092,45,35,80,56.2%,16m
8193,1,TapetAxian,3028,884,39,23,62,62.9%,17m
8193,1,[萝协会]贤者,3028,809,38,16,54,70.4%,16m
8193,1,天上的二郎君,3028,926,34,29,63,54.0%,31m
8193,1,[Rhusky]银月歌者,3028,588,25,13,38,65.8%,22m
8193,1,房顶丨折耳猫,3028,415,14,17,31,45.2%,16m
8193,1,妹抖萌太龙,3028,292,11,1,12,91.7%,1h
8193,1,[1VA]MagicProtoss,3028,188,6,2,8,75.0%,19m
8193,3,[Etern谐]墨色,3028,103,5,3,8,62.5%,25m
8193,1,[时雨时晴]straylemon,3028,163,4,5,9,44.4%,27m
8193,1,小宇爱风扇,3028,154,4,6,10,40.0%,20m
8193,1,本鸡需要援助,3028,84,3,4,7,42.9%,16m
8193,2,ccooll,3028,112,2,3,5,40.0%,1h
8193,1,月林星鱼,3028,38,2,5,7,28.6%,29m
8193,3,满船清梦压星河,3028,30,2,7,9,22.2%,28m
8193,1,ffg,3028,0,1,0,1,100.0%,7m
8193,1,killer,3028,0,1,1,2,50.0%,6m
8193,3,lylch,3028,30,1,7,8,12.5%,14m
8193,1,AlexLin,3028,0,0,2,2,0.0%,54m
8213,1,thomasKing,3027,1736,133,104,237,56.1%,5m
8213,1,[M8]雷电芽衣,3027,1360,64,57,121,52.9%,15m
8213,1,[CNboys]月赋情长,3027,573,22,17,39,56.4%,53m
8213,1,谐星团团长,3027,534,22,20,42,52.4%,31m
8213,1,klx,3027,580,20,25,45,44.4%,16m
8213,1,大魚傢,3027,308,12,8,20,60.0%,53m
8213,3,[fanta]秋山澪,3027,249,8,5,13,61.5%,17m
8213,1,音尘绝,3027,234,7,9,16,43.8%,13m
8213,1,恰糯米的老鼠,3027,223,6,6,12,50.0%,15m
8213,1,IIIIIII,3027,74,3,2,5,60.0%,17m
8213,1,nitai,3027,82,3,4,7,42.9%,8m
8213,1,Enjolras,3027,105,1,3,4,25.0%,27m
8213,1,Sjuy,3027,0,0,1,1,0.0%,8m
8226,3,JIANG,3026,653,36,41,77,46.8%,26m
8226,3,MMbloodAI,3026,870,30,38,68,44.1%,18m
8226,1,[我菜的]Overtu,3026,317,28,16,44,63.6%,22m
8226,1,starzargs,3026,331,11,8,19,57.9%,5m
8226,1,Bustling,3026,171,8,3,11,72.7%,16m
8226,1,LeoSydney,3026,256,8,5,13,61.5%,53m
8226,1,娱乐至上,3026,112,3,1,4,75.0%,56m
8226,1,[听雨轩]wanghui,3026,137,3,3,6,50.0%,1h
8226,1,xunyi,3026,108,3,4,7,42.9%,27m
8226,3,Gilbert,3026,97,2,1,3,66.7%,1h
8226,1,[老年特战队]流离失所,3026,0,1,0,1,100.0%,56m
8226,3,MrHange,3026,30,1,7,8,12.5%,57m
8226,1,[EL骑士二团]MagicYang,3026,0,0,1,1,0.0%,20m
8226,1,Dark,3026,0,0,1,1,0.0%,2m
8226,3,[怀中抱M杀]sunuanu,3026,0,0,1,1,0.0%,55m
8226,3,诺夏的奇迹,3026,0,0,1,1,0.0%,15m
8226,1,雾雨魔理沙,3026,0,0,1,1,0.0%,8m
8226,1,[I20I]sixks,3026,0,0,2,2,0.0%,56m
8244,1,钢铁菊花,3025,1048,43,39,82,52.4%,15m
8244,3,[40hour]Schumann,3025,798,37,24,61,60.7%,22m
8244,1,[被人绿了]虚空寻觅者,3025,378,18,18,36,50.0%,57m
8244,3,[五月花]東邪,3025,370,13,13,26,50.0%,8m
8244,3,[火焰雷兽]ted,3025,384,13,19,32,40.6%,57m
8244,1,[TCP]TinyQingYY,3025,385,11,8,19,57.9%,17m
8244,3,[我是一只机]王子涵,3025,324,11,17,28,39.3%,12m
8244,3,舰队小兵,3025,158,6,1,7,85.7%,7m
8244,1,suci,3025,120,6,1,7,85.7%,29m
8244,3,qlllp,3025,0,4,2,6,66.7%,28m
8244,1,[彩笔冬瓜]papa,3025,0,3,2,5,60.0%,1h
8244,1,亦可玩世不恭,3025,91,2,0,2,100.0%,54m
8244,3,hhh,3025,121,2,1,3,66.7%,14m
8244,1,无差别白给,3025,40,1,3,4,25.0%,57m
8244,1,四散的尘埃,3025,0,1,4,5,20.0%,20m
8244,1,JUST,3025,0,0,1,1,0.0%,19m
8244,1,DarkTemplar,3025,0,0,1,1,0.0%,57m
8244,1,Rise,3025,0,0,5,5,0.0%,17m
8262,3,[五月花]IIIIIIIIIII,3024,1101,62,43,105,59.0%,5m
8262,1,[谐莽狗偷稳奶]爱睡觉的橙子,3024,1414,61,49,110,55.5%,24m
8262,1,[信仰圣光指引]终极飞翔的权力,3024,832,39,20,59,66.1%,31m
8262,1,[牌面]Figo,3024,534,21,12,33,63.6%,22m
8262,1,[msyx]冥圣,3024,426,20,17,37,54.1%,22m
8262,2,黑暗的风暴,3024,250,12,12,24,50.0%,8m
8262,1,[krkrkr]杀猪强人,3024,362,11,10,21,52.4%,19m
8262,1,[BHSC]笨笨县长,3024,318,9,9,18,50.0%,31m
8262,3,[小淦上天队]偷税的鱼人,3024,153,4,2,6,66.7%,48m
8262,3,我重回战场,3024,136,4,7,11,36.4%,55m
8262,2,[奇葩战术]Darthvader,3024,88,2,0,2,100.0%,18m
8262,1,terran,3024,40,2,1,3,66.7%,31m
8262,1,白门楼建设委员会,3024,0,0,1,1,0.0%,54m
8262,1,五更琉璃的老公,3024,0,0,3,3,0.0%,19m
8276,1,[童话小镇]大战三百合,3023,1602,152,144,296,51.4%,22m
8276,3,iiiiiiiiiiii,3023,1538,93,83,176,52.8%,10m
8276,1,[吕布女团]陈烨扬,3023,589,27,22,49,55.1%,5m
8276,3,EnTaroZ,3023,611,26,21,47,55.3%,21m
8276,1,[扫黄]妈个鸡泰伦,3023,530,15,17,32,46.9%,23m
8276,3,艾尔小圆盾,3023,316,13,8,21,61.9%,52m
8276,1,[笙风]郑小俊,3023,184,6,4,10,60.0%,9m
8276,3,大葡萄籽,3023,97,5,2,7,71.4%,1h
8276,1,[Potato]Athenas,3023,114,4,3,7,57.1%,56m
8276,1,软绵绵的绿东西,3023,144,4,3,7,57.1%,6m
8276,1,[SF]Niconico,3023,46,3,6,9,33.3%,59m
8276,1,冰封辉归来,3023,119,2,5,7,28.6%,31m
8288,1,风影我是,3022,1666,557,535,1092,51.0%,7m
8288,3,灵风若影,3022,397,105,96,201,52.2%,57m
8288,1,蓝黑墨水,3022,1725,65,68,133,48.9%,56m
8288,3,Terminator,3022,894,33,34,67,49.3%,29m
8288,1,卡卡莎,3022,472,19,11,30,63.3%,53m
8288,1,humen,3022,315,9,7,16,56.2%,9m
8288,2,事儿,3022,143,6,6,12,50.0%,15m
8288,1,XingLH,3022,196,6,7,13,46.2%,24m
8288,3,楚休红在水,3022,144,4,0,4,100.0%,50m
8288,1,Anthony,3022,0,2,3,5,40.0%,37m
8288,2,IIIIIIIIIIII,3022,0,1,0,1,100.0%,1h
8288,3,十字军级截击舰,3022,0,1,0,1,100.0%,51m
8288,1,syjdd,3022,34,1,2,3,33.3%,12m
8288,1,[MYC]YouDareDogMe,3022,0,0,1,1,0.0%,7m
8302,1,骑着黛西,3021,723,29,25,54,53.7%,28m
8302,1,Laosu,3021,519,22,17,39,56.4%,15m
8302,1,[Esc]不和同族玩,3021,488,15,16,31,48.4%,20m
8302,3,来自地球的小孩丶,3021,264,11,7,18,61.1%,14m
8302,1,[QlimaX]Rain,3021,192,6,8,14,42.9%,16m
8302,3,[鸡变体]Celiever,3021,135,5,4,9,55.6%,60m
8302,2,法鸡你太美,3021,184,5,6,11,45.5%,1h
8302,1,[二次元联盟军]丧钟为谁而鸣,3021,38,2,2,4,50.0%,22m
8302,1,xuediao,3021,0,1,0,1,100.0%,7m
8302,1,乐芙兰,3021,0,1,1,2,50.0%,19m
8302,1,[只想一直空想]psano,3021,0,1,2,3,33.3%,24m
8302,1,[NZNZ]IIIIIIIIIIII,3021,0,0,1,1,0.0%,24m
8302,1,Kerrigan,3021,0,0,2,2,0.0%,6m
8315,1,风吹裤裆吊飞扬,3020,1691,78,71,149,52.3%,16m
8315,1,sdddddddddd,3020,1579,73,52,125,58.4%,12m
8315,3,棕色的浣熊,3020,776,58,29,87,66.7%,5m
8315,1,holy,3020,266,20,6,26,76.9%,19m
8315,1,GuMiHo,3020,277,9,8,17,52.9%,14m
8315,3,昊天巫尊,3020,200,9,9,18,50.0%,28m
8315,1,[第八舰队丶]yuting,3020,184,5,7,12,41.7%,9m
8315,3,mmj,3020,92,4,7,11,36.4%,19m
8315,2,[紫阳花]ALEXhanALICE,3020,118,3,3,6,50.0%,25m
8315,3,酥铭铭,3020,0,3,5,8,37.5%,21m
8315,2,[迷宫丨极限组]LWH,3020,42,2,0,2,100.0%,34m
8315,3,VIC,3020,97,2,1,3,66.7%,1h
8315,1,[喵星人]我猥琐我快乐,3020,0,0,1,1,0.0%,23m
8315,1,[秋毫七队]已为星海,3020,0,0,1,1,0.0%,5m
8329,3,llllllllllll,3019,1447,148,135,283,52.3%,19m
8329,3,小洛克侠,3019,1074,52,53,105,49.5%,7m
8329,3,[老油条战队4]占卜阿里巴巴,3019,834,30,45,75,40.0%,56m
8329,1,[嘟嘟嘟噜]最不会起名字了,3019,173,23,15,38,60.5%,22m
8329,1,小小埃蒙不讲武德,3019,521,23,16,39,59.0%,24m
8329,1,[XXS]念碎伊人面,3019,212,10,1,11,90.9%,7m
8329,1,嘿嘿优秀,3019,36,5,2,7,71.4%,16m
8329,3,玩星际你快乐吗,3019,97,1,1,2,50.0%,1h
8329,1,[为了娱乐]XIXIHAHADADA,3019,0,0,1,1,0.0%,12m
8329,1,霸王别激动,3019,0,0,1,1,0.0%,31m
8329,1,[帝门的小萌新]SCPLAYER,3019,0,0,1,1,0.0%,24m
8329,3,[山西晋绥军]天宇,3019,0,0,1,1,0.0%,25m
8329,1,SchalkeZYY,3019,0,0,1,1,0.0%,22m
8342,3,正能量,3018,1450,119,101,220,54.1%,13m
8342,1,[火焰雷兽]IIIIIIIIIIII,3018,1681,100,80,180,55.6%,27m
8342,1,谶言,3018,1651,63,56,119,52.9%,24m
8342,3,[SaiL]Chaos,3018,1006,39,36,75,52.0%,11m
8342,1,IIIIIIIIIIII,3018,988,35,31,66,53.0%,2m
8342,1,robbie,3018,590,23,19,42,54.8%,6m
8342,1,[薄荷的指挥官]夏沫,3018,287,12,7,19,63.2%,15m
8342,1,白菜,3018,231,9,8,17,52.9%,35m
8342,1,赫萝呐,3018,202,8,8,16,50.0%,11m
8342,1,[TeamAx]Amo,3018,136,6,0,6,100.0%,22m
8342,3,看见你我就跑,3018,90,5,10,15,33.3%,56m
8342,1,PPPPPsanG,3018,48,4,2,6,66.7%,38m
8342,1,刁民你也想害我,3018,173,4,5,9,44.4%,6m
8342,1,逗比张佳雨,3018,0,3,2,5,60.0%,1h
8356,3,[MGrass]亲爱的小孩,3017,744,51,46,97,52.6%,9m
8356,1,大鹏飞起,3017,227,35,32,67,52.2%,53m
8356,3,华生,3017,891,34,45,79,43.0%,53m
8356,3,一人,3017,541,27,27,54,50.0%,57m
8356,1,[TCP]HiddenKnife,3017,533,23,10,33,69.7%,24m
8356,1,ChinnY,3017,730,23,23,46,50.0%,15m
8356,3,[BRN卡路里]布考斯基,3017,348,12,21,33,36.4%,3m
8356,1,[RaMoC]BLacK,3017,392,11,15,26,42.3%,2m
8356,1,跳跳,3017,376,10,9,19,52.6%,54m
8356,3,llllllllllll,3017,223,8,7,15,53.3%,51m
8356,3,[三钛]蜗牛等等我,3017,135,6,4,10,60.0%,1h
8356,1,[丨哔哩哔哩丨]IIIIIIIIIIII,3017,241,6,6,12,50.0%,7m
8356,1,[败犬的胜利]UTAHA,3017,269,6,16,22,27.3%,53m
8356,1,开局炮塔全家生癌,3017,138,4,1,5,80.0%,56m
8356,1,飞飞的一天,3017,0,2,3,5,40.0%,1h
8356,1,每一颗核弹的梦想,3017,0,1,0,1,100.0%,1h
8356,1,封逸琎,3017,0,1,0,1,100.0%,28m
8356,1,[一盒峰我大哥]莫子枫卿,3017,0,0,1,1,0.0%,16m
8356,1,机智的狗子,3017,0,0,3,3,0.0%,52m
8356,3,[CPT]粉红泡泡,3017,0,0,3,3,0.0%,1h
8376,2,逍遥游,3016,1153,68,78,146,46.6%,18m
8376,3,蛛丝马迹,3016,813,32,36,68,47.1%,57m
8376,1,[Borne]叶修,3016,589,20,16,36,55.6%,17m
8376,1,面如死灰连卡拉,3016,266,15,8,23,65.2%,7m
8376,1,思密达烤肉,3016,312,10,10,20,50.0%,7m
8376,3,罗杰船长,3016,238,9,15,24,37.5%,31m
8376,1,蕾姆是我老婆,3016,264,8,11,19,42.1%,22m
8376,3,芬兰共产党,3016,97,4,3,7,57.1%,1h
8376,1,[AcePoX]Roy,3016,0,1,2,3,33.3%,2m
8376,1,[极限战团]白给的阿米娅,3016,0,0,1,1,0.0%,19m
8386,1,毛栗子,3015,1505,68,62,130,52.3%,14m
8386,1,林诺诺,3015,535,32,21,53,60.4%,54m
8386,1,[遥远的拂晓]FakeNews,3015,438,15,10,25,60.0%,54m
8386,1,山丘不带锤,3015,114,4,3,7,57.1%,54m
8386,1,暴风雪,3015,0,3,2,5,60.0%,1h
8386,1,Agoni,3015,96,2,4,6,33.3%,1h
8386,3,[一帮菜鸡]银翼的魔术师,3015,0,1,8,9,11.1%,57m
8386,1,[DMR]国服第一人子,3015,0,0,1,1,0.0%,2m
8386,3,[Rhusky]化学课呆表,3015,0,0,6,6,0.0%,6m
8395,3,养生星际,3014,624,63,60,123,51.2%,23m
8395,1,[刺蛇互助社团]枫叶漫漫,3014,440,21,9,30,70.0%,16m
8395,1,IIIIIIIIIIII,3014,575,18,16,34,52.9%,24m
8395,2,FoRtiSimO,3014,368,14,44,58,24.1%,8m
8395,3,徐智秀,3014,240,9,14,23,39.1%,24m
8395,1,[残日星宿]大天使鱼,3014,155,7,0,7,100.0%,29m
8395,1,你老婆开的门,3014,138,4,7,11,36.4%,12m
8395,1,[萝莉之芯]爱我就给我,3014,38,2,1,3,66.7%,6m
8395,1,月月月三月,3014,38,2,2,4,50.0%,6m
8395,1,[oo]black,3014,0,2,3,5,40.0%,16m
8395,1,稀地法师,3014,80,2,6,8,25.0%,29m
8395,1,龙骑,3014,0,1,2,3,33.3%,6m
8395,2,啵滴咚,3014,0,0,1,1,0.0%,14m
8408,3,Alexah,3013,1415,171,166,337,50.7%,19m
8408,1,hakuna,3013,1435,84,81,165,50.9%,30m
8408,3,孙哥起峰了,3013,823,66,60,126,52.4%,29m
8408,1,奥特小魔仙,3013,1007,41,31,72,56.9%,19m
8408,3,[Shawk]房子轩,3013,475,30,36,66,45.5%,27m
8408,1,[不怕念起]孙浩淼,3013,346,14,7,21,66.7%,53m
8408,1,[0o0]GYGT,3013,335,13,8,21,61.9%,7m
8408,1,[四狗联盟]Yaphet,3013,206,10,6,16,62.5%,24m
8408,1,[嘤嘤樱]黑子,3013,319,9,7,16,56.2%,6m
8408,3,[EL骑士团]菜鸟哇哇,3013,97,5,2,7,71.4%,5m
8408,1,红门馆,3013,0,4,1,5,80.0%,22m
8408,1,我是大怪物,3013,98,3,8,11,27.3%,7m
8408,1,[最菜战队]iloveyiming,3013,105,2,2,4,50.0%,22m
8408,1,[武大萌新]箫声咽,3013,46,2,5,7,28.6%,1h
8408,3,[23CM]库亚米路,3013,0,0,1,1,0.0%,60m
8408,1,洋葱头怎么回事,3013,0,0,2,2,0.0%,6m
8424,1,菜鸟,3012,1264,130,132,262,49.6%,56m
8424,1,喊硬霸的都是菜,3012,803,65,53,118,55.1%,7m
8424,3,DylonDi,3012,720,52,53,105,49.5%,7m
8424,1,[秋毫]Captain,3012,1046,42,41,83,50.6%,23m
8424,3,[envy]EnvyAngle,3012,1066,40,42,82,48.8%,4m
8424,1,[虚拟歌手团体]Misairu,3012,475,17,14,31,54.8%,22m
8424,1,静静,3012,288,10,12,22,45.5%,8m
8424,1,[塔达林难民]空城绝唱,3012,0,3,2,5,60.0%,57m
8424,1,III,3012,38,2,2,4,50.0%,7m
8424,1,Shiki,3012,0,0,1,1,0.0%,17m
8424,1,[东方幻想鄉]十六夜咲夜,3012,0,0,1,1,0.0%,6m
8435,1,[巨龙降临]YMYM,3011,1315,271,249,520,52.1%,24m
8435,3,[Mikon]仈月,3011,1463,67,58,125,53.6%,54m
8435,1,[全员恶人超凶]crywolf,3011,837,42,17,59,71.2%,53m
8435,1,中二五彩小王子,3011,558,19,14,33,57.6%,22m
8435,3,insomniachu,3011,126,9,7,16,56.2%,57m
8435,1,[觀天習文]我没练出来,3011,189,7,7,14,50.0%,1h
8435,1,MRSMILE,3011,138,4,1,5,80.0%,53m
8435,1,welldoom,3011,0,4,5,9,44.4%,14m
8435,1,Dandelion,3011,82,3,2,5,60.0%,14m
8435,3,taijixiaoshi,3011,143,3,3,6,50.0%,44m
8435,1,红白赛钱箱,3011,0,1,0,1,100.0%,57m
8435,1,Maya,3011,0,1,0,1,100.0%,8m
8435,1,蝙蝠发动机,3011,0,1,0,1,100.0%,1h
8435,1,曲终人散,3011,40,1,2,3,33.3%,16m
8435,1,PHILA,3011,0,0,1,1,0.0%,31m
8450,1,[Beasty]来一览美景吧,3010,1412,75,63,138,54.3%,7m
8450,1,[天下何平]Arbiter,3010,719,30,22,52,57.7%,8m
8450,1,Ponder,3010,277,18,11,29,62.1%,22m
8450,1,常山萝莉控,3010,141,6,5,11,54.5%,58m
8450,1,heihuhu,3010,96,3,7,10,30.0%,14m
8450,1,她说她是晒黑的,3010,34,2,1,3,66.7%,8m
8450,1,錵訫猴猴,3010,0,1,0,1,100.0%,7m
8450,1,围棋界的星际玩家,3010,0,1,0,1,100.0%,6m
8450,1,塔达林高阶刺蛇,3010,0,0,1,1,0.0%,31m
8459,3,SSS,3009,1522,120,112,232,51.7%,8m
8459,1,[幸运的撸客]祝菇生,3009,960,63,67,130,48.5%,23m
8459,1,Allen,3009,1269,49,47,96,51.0%,28m
8459,1,单曲循环,3009,563,43,42,85,50.6%,30m
8459,3,[暴雪十二队]SeanGuo,3009,910,39,30,69,56.5%,5m
8459,1,Tonysee,3009,522,24,33,57,42.1%,29m
8459,1,Scott,3009,652,21,20,41,51.2%,53m
8459,1,Joker,3009,294,9,10,19,47.4%,22m
8459,1,打吧,3009,239,8,6,14,57.1%,6m
8459,2,百撕不得骑姐,3009,154,6,7,13,46.2%,27m
8459,3,[谐的一逼]ShiningStars,3009,92,6,8,14,42.9%,54m
8459,3,清江河豚,3009,42,5,2,7,71.4%,1h
8459,1,NITAIN,3009,161,5,4,9,55.6%,20m
8459,1,发怒的公牛,3009,144,4,4,8,50.0%,16m
8459,1,我叫刘二丁,3009,105,3,0,3,100.0%,22m
8459,1,[oo]我只想默默躺赢,3009,144,3,4,7,42.9%,38m
8459,1,隔壁黄瑟,3009,88,2,0,2,100.0%,14m
8459,3,傲娇味儿的草莓,3009,133,2,3,5,40.0%,1h
8459,3,zentao,3009,32,2,8,10,20.0%,28m
8459,3,小帅帅,3009,42,1,3,4,25.0%,21m
8459,1,[卖力头破尼]Sparkle,3009,0,0,1,1,0.0%,6m
8459,1,坑的就是你,3009,0,0,1,1,0.0%,20m
8481,1,IIIIIIIIIIII,3008,1383,183,156,339,54.0%,23m
8481,3,[小米集团]ShowTime,3008,1131,60,68,128,46.9%,6m
8481,1,想要,3008,958,39,29,68,57.4%,53m
8481,3,幽夜灬悬空,3008,730,31,28,59,52.5%,54m
8481,1,[老吴天下第一]普通人族李信衡,3008,682,28,21,49,57.1%,29m
8481,3,钢琴手,3008,588,21,31,52,40.4%,5m
8481,1,[日月之殇]喵之小明特留斯,3008,296,12,5,17,70.6%,8m
8481,1,阳凉,3008,261,12,6,18,66.7%,22m
8481,1,IIIIIIIIIIII,3008,223,9,6,15,60.0%,14m
8481,1,龙翔,3008,345,9,10,19,47.4%,22m
8481,3,geyucong,3008,168,7,3,10,70.0%,1h
8481,1,最强女友,3008,218,5,5,10,50.0%,19m
8481,1,憨色是小天使,3008,135,5,5,10,50.0%,8m
8481,1,法尔,3008,145,5,11,16,31.2%,22m
8481,1,胜败乃兵家常事,3008,120,4,0,4,100.0%,22m
8481,2,[BUPTNB]LoveRain,3008,144,4,7,11,36.4%,10m
8481,1,Itachi,3008,88,2,0,2,100.0%,8m
8498,1,smallfatcat,3007,1139,52,40,92,56.5%,16m
8498,1,[孙岱玹]大头最厉害,3007,252,21,14,35,60.0%,23m
8498,1,IIIIIIIIIIII,3007,255,8,5,13,61.5%,17m
8498,1,ZGMFImpulse,3007,169,7,2,9,77.8%,54m
8498,1,小茶,3007,246,7,8,15,46.7%,16m
8498,3,[歌者II]zero,3007,175,6,3,9,66.7%,10m
8498,1,[XXHZ25]讨厌榴莲,3007,198,6,5,11,54.5%,56m
8498,1,憨豆特工,3007,0,3,2,5,60.0%,1h
8498,1,红霸霸,3007,120,2,2,4,50.0%,53m
8498,1,[Hist]remiss,3007,0,1,1,2,50.0%,14m
8498,1,irgsgjs,3007,36,1,2,3,33.3%,12m
8498,1,烩兔肉,3007,36,1,4,5,20.0%,29m
8498,3,[在这停顿]IROI,3007,0,1,9,10,10.0%,10m
8498,3,[GhostV]Joker,3007,0,0,1,1,0.0%,7m
8498,1,Zealotgogogo,3007,0,0,2,2,0.0%,5m
8498,3,[真理卐高中]埃尔之盾,3007,0,0,2,2,0.0%,44m
8498,1,久下,3007,0,0,3,3,0.0%,38m
8515,3,abook,3006,776,229,223,452,50.7%,50m
8515,3,却月,3006,753,125,115,240,52.1%,30m
8515,3,[野人time]Hersh,3006,952,73,67,140,52.1%,53m
8515,1,[ASMR]马杀鸡神族,3006,687,34,18,52,65.4%,16m
8515,1,[白手团]QTGcreed,3006,382,33,23,56,58.9%,22m
8515,1,SakuraiRin,3006,709,31,23,54,57.4%,6m
8515,1,DeVplume,3006,412,30,26,56,53.6%,53m
8515,1,彭州陈奕迅,3006,456,27,28,55,49.1%,14m
8515,2,沐洋,3006,230,12,1,13,92.3%,23m
8515,1,[暴打中师]Zach,3006,88,2,0,2,100.0%,28m
8515,1,Casinos,3006,0,2,3,5,40.0%,7m
8515,1,ZZZ,3006,0,0,1,1,0.0%,54m
8515,1,Elf,3006,0,0,2,2,0.0%,6m
8528,1,wuukyuy,3005,1399,102,75,177,57.6%,24m
8528,3,你吗个鸡,3005,1086,39,42,81,48.1%,29m
8528,3,llllllllllll,3005,916,31,47,78,39.7%,4m
8528,1,呵呵哒,3005,762,27,30,57,47.4%,16m
8528,1,[散华礼弥]蛋碎年华,3005,312,11,11,22,50.0%,12m
8528,1,永恒的誓言,3005,279,9,7,16,56.2%,6m
8528,3,小异,3005,120,5,3,8,62.5%,1h
8528,3,玩神族的都是废物,3005,114,3,1,4,75.0%,16m
8528,1,魔法虫族尿急王,3005,0,1,1,2,50.0%,52m
8528,1,Husky,3005,0,0,1,1,0.0%,24m
8538,1,powercc,3004,1716,324,304,628,51.6%,16m
8538,3,和我无关的猫,3004,1384,74,79,153,48.4%,53m
8538,3,[半个菜鸟II]黑天大神,3004,1072,70,69,139,50.4%,11m
8538,1,[长夜将至]柠檬琉璃夏,3004,1171,57,32,89,64.0%,22m
8538,1,未央片想,3004,1119,51,37,88,58.0%,23m
8538,1,[GSL联赛]Dimension,3004,859,38,34,72,52.8%,8m
8538,1,为我尊前笑不成,3004,378,21,16,37,56.8%,56m
8538,3,刀锋女王,3004,349,16,19,35,45.7%,29m
8538,1,丢丢鱼,3004,326,10,7,17,58.8%,28m
8538,1,[星光咖啡馆]三司绫濑,3004,269,10,7,17,58.8%,16m
8538,1,[荒芜岁月]情如朝露去匆匆,3004,186,6,6,12,50.0%,7m
8538,1,[糖稀日天帮]此处我贩剑,3004,182,6,6,12,50.0%,24m
8538,1,cijief,3004,171,3,7,10,30.0%,5m
8538,2,Contra,3004,0,1,2,3,33.3%,1h
8538,1,[核桃]HHHHHHH,3004,42,1,5,6,16.7%,5m
8553,1,alax,3003,1593,189,181,370,51.1%,31m
8553,1,王小秋,3003,1514,125,95,220,56.8%,27m
8553,1,[幻想神社]Kane,3003,978,56,56,112,50.0%,6m
8553,3,[荣耀丶殿堂]六味地黄芄,3003,646,31,32,63,49.2%,18m
8553,1,[Etern谐]Neil,3003,221,24,12,36,66.7%,31m
8553,1,[魔王的人生]绯弹的亚里亚,3003,273,12,5,17,70.6%,20m
8553,3,NEW,3003,301,12,9,21,57.1%,55m
8553,1,[SCAP]arthursaber,3003,202,10,8,18,55.6%,56m
8553,1,IIIIIIIIIIII,3003,156,5,2,7,71.4%,29m
8553,1,Fumino,3003,0,3,3,6,50.0%,14m
8553,1,IIIIIIIIIIII,3003,34,2,1,3,66.7%,53m
8553,1,[我们的奇迹]雪色光晕橙色奇迹,3003,68,2,3,5,40.0%,20m
8553,1,[江上数峰青]石膏博士,3003,0,2,3,5,40.0%,16m
8553,1,天山星泰罗,3003,0,1,0,1,100.0%,59m
8553,1,zdasdaf,3003,0,1,0,1,100.0%,53m
8553,1,庆幸的蛋糕,3003,0,1,1,2,50.0%,9m
8553,3,[我们是瞎子]东北独角仙,3003,0,1,1,2,50.0%,1h
8553,1,galaxy,3003,88,1,1,2,50.0%,8m
8553,3,[天雪]世界上谐星最强大,3003,0,0,1,1,0.0%,1h
8553,1,[呆毛来我迦]Chengsama,3003,0,0,1,1,0.0%,14m
8553,1,[summer]伏见老贼,3003,0,0,2,2,0.0%,53m
8553,1,uuu,3003,0,0,3,3,0.0%,6m
8553,1,痛击队友丶,3003,0,0,6,6,0.0%,22m
8576,1,banana,3002,929,39,35,74,52.7%,12m
8576,3,IIIIIIIIIIII,3002,567,32,23,55,58.2%,50m
8576,3,AlphaGG,3002,582,23,24,47,48.9%,52m
8576,1,[庚辰]AgreementAG,3002,524,21,15,36,58.3%,12m
8576,3,[PITB]洛阳,3002,332,12,15,27,44.4%,9m
8576,1,[酒池肉林]落宸印,3002,97,5,1,6,83.3%,38m
8576,1,XiaoZhaoQAQ,3002,180,5,3,8,62.5%,56m
8576,1,rushB,3002,84,4,4,8,50.0%,56m
8576,1,青阳,3002,0,3,2,5,60.0%,38m
8576,1,[莽夫苟熊]醉里挑灯看剑,3002,36,2,1,3,66.7%,53m
8576,1,[最强国铜]Bigblind,3002,0,1,0,1,100.0%,16m
8576,3,[我们是瞎子]wangxu,3002,0,1,0,1,100.0%,1h
8588,1,杰明,3001,1661,71,65,136,52.2%,56m
8588,1,haosijia,3001,1393,68,54,122,55.7%,12m
8588,1,herNPC,3001,767,35,20,55,63.6%,53m
8588,1,[入門電脳]痛苦星际,3001,318,11,6,17,64.7%,56m
8588,1,扬大男同李佳豪丶,3001,254,10,6,16,62.5%,58m
8588,1,啊啊啊啊,3001,283,10,9,19,52.6%,8m
8588,1,[少女的下午茶]DrEsther,3001,233,6,11,17,35.3%,59m
8588,1,[执氏]Zeratul,3001,0,3,2,5,60.0%,1h
8588,1,Marineking,3001,90,2,1,3,66.7%,9m
8588,1,Pimba,3001,0,1,0,1,100.0%,27m
8588,2,圣魂,3001,0,1,2,3,33.3%,7m
8588,1,InNOvation,3001,0,1,4,5,20.0%,1h
8588,1,AaronJYL,3001,0,0,1,1,0.0%,22m
8601,3,地狱已空,3000,1375,78,61,139,56.1%,27m
8601,1,[我永远]ForFun,3000,595,42,33,75,56.0%,8m
8601,1,待时间嘉许,3000,461,30,19,49,61.2%,20m
8601,3,我不是谐星,3000,703,25,30,55,45.5%,53m
8601,1,mmbj,3000,455,16,10,26,61.5%,16m
8601,1,大主教,3000,412,13,12,25,52.0%,23m
8601,1,[TCP]TYTY,3000,205,6,4,10,60.0%,5m
8601,1,小鸟儿小,3000,216,6,8,14,42.9%,22m
8601,2,IlIlllIlIllI,3000,155,5,2,7,71.4%,27m
8601,1,TYTY,3000,0,4,1,5,80.0%,28m
8601,1,[自由的气息]瘪大,3000,69,3,4,7,42.9%,57m
8601,1,是这个亚可,3000,0,2,3,5,40.0%,1h
8601,1,[MarCim]带带成公主,3000,68,2,4,6,33.3%,12m
8601,2,[TS1989]PabloAlboran,3000,0,1,0,1,100.0%,20m
8601,1,Arteezy,3000,0,1,0,1,100.0%,1h
8601,1,wuge,3000,0,1,2,3,33.3%,6m
8601,1,soos,3000,0,0,1,1,0.0%,1h
8601,1,[抱兔望月归]racconOak,3000,0,0,1,1,0.0%,54m
8619,3,[holyhp]恶魔之泪,2999,1522,91,87,178,51.1%,55m
8619,3,[玩个虫子]帅猫,2999,874,30,52,82,36.6%,53m
8619,1,[TNLet]HOODWEI,2999,239,9,4,13,69.2%,12m
8619,3,KannagiYuuri,2999,122,6,3,9,66.7%,1h
8619,1,[萨尔那加神殿]破壁人,2999,94,5,3,8,62.5%,6m
8619,1,星辰变,2999,121,3,1,4,75.0%,8m
8619,1,虎牢关飞将,2999,0,3,2,5,60.0%,57m
8619,2,silver,2999,0,1,0,1,100.0%,5m
8619,2,[充气团]IIIIIIIIII,2999,0,1,0,1,100.0%,7m
8619,3,似水流年,2999,30,1,2,3,33.3%,28m
8619,2,血月曼陀罗,2999,0,0,1,1,0.0%,24m
8630,3,ZHZ,2998,1327,161,159,320,50.3%,56m
8630,3,[老油条战队4]solostart,2998,1571,139,136,275,50.5%,29m
8630,1,我要上三千分,2998,470,21,12,33,63.6%,9m
8630,1,[菜有菜的道理]故故故久,2998,417,16,11,27,59.3%,7m
8630,2,[兆景埋土大学]Toby,2998,276,14,8,22,63.6%,28m
8630,2,北冥有牛,2998,226,9,6,15,60.0%,1h
8630,3,[只会平推]吃熊猫的尾巴,2998,265,9,17,26,34.6%,15m
8630,1,混元星际门孙保国,2998,313,8,8,16,50.0%,7m
8630,1,AlphaStar,2998,228,8,11,19,42.1%,22m
8630,1,sfp,2998,151,5,3,8,62.5%,56m
8630,1,[Sc养老]Gerort,2998,97,4,1,5,80.0%,44m
8630,1,[天坑a]吴门之邦,2998,0,1,0,1,100.0%,1h
8630,2,COldzera,2998,0,1,0,1,100.0%,24m
8630,1,[泰伦保护协会]volahri,2998,0,0,2,2,0.0%,17m
8644,3,YukoOgur,2997,1428,286,277,563,50.8%,21m
8644,3,虫族真滴太阴间了,2997,932,79,73,152,52.0%,53m
8644,3,南七技校大学渣,2997,1422,77,72,149,51.7%,22m
8644,3,[逍寒]逍遥者寒号,2997,1545,68,55,123,55.3%,4m
8644,3,元大,2997,456,29,24,53,54.7%,26m
8644,1,[CnNami]heikuia,2997,920,29,33,62,46.8%,27m
8644,1,[CNboys]萌萌的克尔苏加德,2997,356,13,10,23,56.5%,27m
8644,1,[ACG系]yinyinmaster,2997,265,11,5,16,68.8%,14m
8644,3,杭电四幺,2997,280,11,16,27,40.7%,57m
8644,2,weard,2997,240,9,4,13,69.2%,6m
8644,1,咸鱼奇迹,2997,97,6,4,10,60.0%,28m
8644,3,[这就对了]炙罹,2997,0,1,0,1,100.0%,55m
8644,1,阿薇最可爱,2997,0,1,5,6,16.7%,12m
8644,2,[KOTRT]鸡饲料保护协会,2997,0,0,1,1,0.0%,17m
8658,1,LIN,2996,1357,113,104,217,52.1%,53m
8658,3,小宝上线了,2996,424,43,44,87,49.4%,53m
8658,1,wolovewc,2996,610,37,29,66,56.1%,7m
8658,1,梅天王,2996,606,30,17,47,63.8%,16m
8658,1,[Pb丶pB]批爆丶正正南,2996,575,26,21,47,55.3%,31m
8658,3,kurumi,2996,371,14,7,21,66.7%,10m
8658,1,电击重闷拳,2996,0,4,1,5,80.0%,38m
8658,2,[TG1]布偶灬圣诞,2996,0,1,0,1,100.0%,52m
8658,2,我是谁呀一,2996,0,1,0,1,100.0%,5m
8658,3,zzzzzzz,2996,0,1,0,1,100.0%,28m
8658,1,[染年霜霜]sOs,2996,0,1,1,2,50.0%,6m
8658,1,酷龘龘,2996,91,1,2,3,33.3%,22m
8670,3,[埃蒙打的好呀]炽天使之魂,2995,1284,122,99,221,55.2%,25m
8670,1,skrskr,2995,1147,55,25,80,68.8%,14m
8670,1,[人族是我爹]HyperMes,2995,676,22,22,44,50.0%,3m
8670,3,狗我丶死全家,2995,380,13,25,38,34.2%,20m
8670,1,[正太连萌]你我他,2995,322,9,12,21,42.9%,6m
8670,3,[二五谐会]医生姐姐来了又死,2995,188,7,4,11,63.6%,44m
8670,1,SJONE,2995,166,6,5,11,54.5%,54m
8670,2,豆芽哥,2995,0,5,2,7,71.4%,1h
8670,1,时空之言,2995,209,5,6,11,45.5%,14m
8670,1,菜鸡请不要喷,2995,38,2,2,4,50.0%,23m
8670,1,cGay,2995,0,2,3,5,40.0%,21m
8670,2,[浪啊浪]MUZI,2995,0,1,0,1,100.0%,10m
8670,2,缥缈彼岸,2995,0,0,1,1,0.0%,13m
8670,2,IIIIIIIIIIII,2995,0,0,1,1,0.0%,24m
8684,2,[Sfae]不骚不得劲,2994,1637,149,142,291,51.2%,51m
8684,1,[FFJ]简则美,2994,1581,91,85,176,51.7%,14m
8684,1,xyz,2994,652,50,29,79,63.3%,23m
8684,1,[CPT]时崎狂三,2994,536,26,23,49,53.1%,24m
8684,1,[GOTAL]小型探知机,2994,494,18,18,36,50.0%,12m
8684,1,Capricornus,2994,348,12,10,22,54.5%,24m
8684,1,IIIIIIIIIIII,2994,173,12,14,26,46.2%,6m
8684,3,江山,2994,121,6,6,12,50.0%,11m
8684,1,[YINGJI]nianzhang,2994,144,5,3,8,62.5%,1h
8684,2,CCblackknigh,2994,88,3,3,6,50.0%,54m
8684,2,刺蛇没有刺,2994,30,2,0,2,100.0%,53m
8684,1,哥只是一个传说,2994,0,1,0,1,100.0%,1h
8684,2,SupressHE,2994,0,1,0,1,100.0%,29m
8684,2,[破落的灵魂]我是国王,2994,0,1,0,1,100.0%,24m
8684,2,小木剑者,2994,32,1,2,3,33.3%,16m
8684,1,好汉请杀我队友,2994,0,1,4,5,20.0%,22m
8684,1,IlIIIllllll,2994,0,1,4,5,20.0%,1h
8684,1,山风,2994,40,1,7,8,12.5%,22m
8684,2,Crazy,2994,0,0,1,1,0.0%,10m
8684,1,悦丶,2994,0,0,2,2,0.0%,22m
8684,1,天边的一朵云,2994,0,0,8,8,0.0%,1h
8705,3,随机死个马,2993,1497,173,155,328,52.7%,12m
8705,1,[社会]风中童年,2993,587,19,21,40,47.5%,12m
8705,2,ForeverTT,2993,334,12,9,21,57.1%,24m
8705,1,EvaNGelIoN,2993,374,11,15,26,42.3%,16m
8705,1,[江南狗王]埋了我吧,2993,97,4,2,6,66.7%,27m
8705,1,泡泡茶壶,2993,48,4,3,7,57.1%,43m
8705,1,AwsdOPX,2993,91,4,6,10,40.0%,7m
8705,1,[华师大二附中]youngyoungyo,2993,126,2,3,5,40.0%,36m
8705,1,[天梯引路人]醪糟睡觉,2993,64,2,4,6,33.3%,7m
8705,2,凉城旧梦,2993,0,1,0,1,100.0%,14m
8705,1,真言吗,2993,0,0,4,4,0.0%,22m
8716,2,mumu,2992,1530,297,303,600,49.5%,9m
8716,1,ttt,2992,1667,287,254,541,53.0%,16m
8716,3,[雄心挥剑笔]源稚女,2992,1132,64,51,115,55.7%,26m
8716,1,小蚂蚁爱上树,2992,738,41,38,79,51.9%,14m
8716,1,KZZZZ,2992,656,40,39,79,50.6%,31m
8716,2,knk,2992,550,22,12,34,64.7%,25m
8716,1,huangbanping,2992,610,19,20,39,48.7%,7m
8716,1,叉子骑牛烧火车,2992,374,11,14,25,44.0%,7m
8716,1,[Toss]Optimus,2992,236,7,4,11,63.6%,8m
8716,1,鬼邪,2992,96,3,5,8,37.5%,29m
8716,1,爆锤狗头,2992,0,1,0,1,100.0%,1h
8716,2,[科普卢老车队]Hym,2992,30,1,1,2,50.0%,10m
8716,1,[星灵神族]星灵神族,2992,0,1,2,3,33.3%,31m
8716,3,[RE灬EG]马老师的黑切,2992,30,1,6,7,14.3%,20m
8730,3,rrrrrrH,2991,1452,443,442,885,50.1%,55m
8730,3,快乐菜鸟,2991,1461,117,118,235,49.8%,5m
8730,3,[3332]Ryan,2991,783,83,87,170,48.8%,55m
8730,2,[Mikon]宫本武藏,2991,611,45,27,72,62.5%,28m
8730,1,火弦,2991,1001,44,31,75,58.7%,27m
8730,1,IIIIIIIIIIII,2991,1087,44,39,83,53.0%,20m
8730,3,[傲世丨听雨轩]没那个状态,2991,555,26,21,47,55.3%,4m
8730,3,shifengwunai,2991,522,18,30,48,37.5%,10m
8730,1,IIIIIIIIIIII,2991,420,12,12,24,50.0%,53m
8730,1,[HHZX]十点半的人生,2991,193,5,6,11,45.5%,22m
8730,2,理赔就用理赔男,2991,130,4,0,4,100.0%,11m
8730,2,二十八天速成鸡,2991,90,4,2,6,66.7%,11m
8730,2,Nting,2991,128,4,5,9,44.4%,52m
8730,1,Rain,2991,0,3,2,5,60.0%,1h
8730,3,Qee,2991,30,3,10,13,23.1%,7m
8730,2,我是菜鸟,2991,58,2,1,3,66.7%,17m
8730,1,[泰妍]赵啸丶,2991,0,2,3,5,40.0%,56m
8730,2,keke,2991,72,2,3,5,40.0%,56m
8730,3,lllllll,2991,96,1,3,4,25.0%,55m
8749,1,多多宝贝,2990,1689,119,113,232,51.3%,12m
8749,1,[我们是瞎子]老鼠特工,2990,1352,114,92,206,55.3%,22m
8749,1,孙一喵喵喵,2990,1655,82,70,152,53.9%,9m
8749,3,Novice,2990,643,40,36,76,52.6%,31m
8749,3,howmuchsoso,2990,875,33,37,70,47.1%,7m
8749,1,gto,2990,559,21,16,37,56.8%,15m
8749,3,大白丶,2990,517,19,19,38,50.0%,53m
8749,3,[宛如智障]LQLQ,2990,230,10,9,19,52.6%,15m
8749,2,[古代毒瘤协会]千秋雪落,2990,0,5,2,7,71.4%,23m
8749,2,无语,2990,122,5,2,7,71.4%,52m
8749,2,Freedom,2990,116,4,3,7,57.1%,24m
8749,1,阿鲁巴,2990,0,3,2,5,60.0%,1h
8749,2,各种空虚冷冷冷,2990,90,3,2,5,60.0%,21m
8749,2,Fish,2990,64,2,3,5,40.0%,3m
8749,2,[哔哩哔哩乾杯]古德莉安,2990,0,1,0,1,100.0%,5m
8749,1,Stork,2990,0,0,2,2,0.0%,22m
8749,3,Paradise,2990,0,0,3,3,0.0%,32m
8766,1,飞的岳,2989,590,97,84,181,53.6%,20m
8766,1,[浪啊浪]吕同轩帅,2989,846,34,30,64,53.1%,12m
8766,3,我曾触及星辰,2989,71,17,15,32,53.1%,58m
8766,3,entaroalarak,2989,245,9,6,15,60.0%,29m
8766,1,奇迹之海,2989,221,7,9,16,43.8%,47m
8766,3,逗比乖巧猪,2989,51,5,8,13,38.5%,13m
8766,1,你掀起波澜,2989,177,5,11,16,31.2%,15m
8766,1,伊利创造核心科技,2989,0,3,2,5,60.0%,1h
8766,1,永猎千珏,2989,0,3,2,5,60.0%,1h
8766,3,杰克,2989,97,1,1,2,50.0%,16m
8766,1,[SxAK]Kairaku,2989,0,0,1,1,0.0%,31m
8777,3,CandLes,2988,1474,114,111,225,50.7%,55m
8777,3,Ambiitious,2988,1412,99,86,185,53.5%,9m
8777,1,[四斋蒸蚝片]ForAiur,2988,1313,59,41,100,59.0%,53m
8777,1,hello,2988,686,58,56,114,50.9%,14m
8777,1,子沐淼,2988,564,51,51,102,50.0%,8m
8777,3,Sakura,2988,761,35,35,70,50.0%,53m
8777,1,克洛佐斯的喵喵酱,2988,363,28,20,48,58.3%,7m
8777,2,Kulo,2988,444,17,13,30,56.7%,25m
8777,3,[透一下清酒]Skyraza,2988,326,13,0,13,100.0%,21m
8777,1,jerrymo,2988,282,12,13,25,48.0%,23m
8777,1,[机械混成旅]羊三刀,2988,297,11,8,19,57.9%,5m
8777,1,BUGUNIAO,2988,254,7,9,16,43.8%,7m
8777,2,[Igirls]IIIIIIIIIIII,2988,62,3,1,4,75.0%,51m
8777,1,人勒,2988,0,2,1,3,66.7%,1h
8777,1,hehe,2988,72,2,5,7,28.6%,7m
8777,1,性格如此,2988,0,1,0,1,100.0%,1h
8777,1,黎明,2988,28,1,6,7,14.3%,23m
8777,1,灬虚空幻界灬,2988,0,0,1,1,0.0%,1h
8777,1,[飞云之上]Wondeful,2988,0,0,6,6,0.0%,5m
8796,1,黄旭东财产继承人,2987,476,29,28,57,50.9%,15m
8796,3,[东大电竞]雕刻时光说道,2987,287,11,11,22,50.0%,52m
8796,1,ALonelyOne,2987,143,5,3,8,62.5%,1h
8796,1,碎的喧嚣,2987,176,4,5,9,44.4%,54m
8796,2,[GIE]古明地恋天下第一,2987,30,2,0,2,100.0%,27m
8796,2,送葬者,2987,64,2,3,5,40.0%,35m
8796,2,OOO,2987,0,1,0,1,100.0%,28m
8796,1,Assassins,2987,0,0,2,2,0.0%,30m
8804,1,茜卓,2986,1171,74,60,134,55.2%,12m
8804,1,Creep,2986,1514,68,49,117,58.1%,31m
8804,3,[Beasty]杀手之魂,2986,535,64,72,136,47.1%,6m
8804,3,达拉姆肃反处,2986,140,7,2,9,77.8%,1h
8804,3,独孤求胜,2986,161,7,4,11,63.6%,26m
8804,1,[南邮憨B联盟]Howdy,2986,126,3,2,5,60.0%,15m
8804,1,[SC2战队]似友,2986,0,3,2,5,60.0%,56m
8804,2,IIIIII,2986,48,2,2,4,50.0%,31m
8804,2,[gusl]AlphaStar,2986,0,1,0,1,100.0%,56m
8804,1,[枫之翼]清枫羽落,2986,44,1,2,3,33.3%,1h
8804,1,LoaF,2986,90,1,2,3,33.3%,30m
8804,1,[文韬武略]表妹依旧消魂,2986,0,0,2,2,0.0%,57m
8804,1,PIPI,2986,0,0,2,2,0.0%,1h
8817,1,九头蛇,2985,1381,199,183,382,52.1%,31m
8817,3,[春兰]暴雪背叛了星际,2985,759,80,73,153,52.3%,6m
8817,2,Appreciation,2985,744,50,44,94,53.2%,27m
8817,1,NieJiPi,2985,497,22,21,43,51.2%,7m
8817,2,[LittyG]摩卡公子,2985,192,7,6,13,53.8%,1h
8817,2,heheda,2985,0,5,2,7,71.4%,1h
8817,3,[出兵大战T馆]爱打球的菜徐坤,2985,120,3,1,4,75.0%,5m
8817,1,[久美子文具店]qqq,2985,0,1,5,6,16.7%,56m
8817,2,星海无限,2985,0,0,1,1,0.0%,26m
8817,2,我是萌新,2985,0,0,1,1,0.0%,25m
8817,2,[Anticw]迷桐,2985,0,0,1,1,0.0%,52m
8817,2,[24CM]温冬亦歌,2985,0,0,1,1,0.0%,10m
8829,3,这菜鸡玩游戏图啥,2984,1328,187,196,383,48.8%,26m
8829,1,[长夜将至]LLLLL,2984,1701,100,91,191,52.4%,12m
8829,3,jerrylei,2984,864,31,39,70,44.3%,5m
8829,2,[内蒙第一舰队]owen,2984,725,28,21,49,57.1%,25m
8829,2,萌新,2984,141,5,6,11,45.5%,1h
8829,1,MarineTiger,2984,159,5,8,13,38.5%,6m
8829,2,跳楼鱿鱼,2984,64,3,1,4,75.0%,26m
8829,2,橘子味硬糖,2984,62,2,1,3,66.7%,6m
8829,2,OldCaptain,2984,62,2,1,3,66.7%,10m
8829,2,去你的轻轻,2984,0,1,0,1,100.0%,7m
8829,1,[阿里巴巴战队]家有娇花,2984,0,1,0,1,100.0%,1h
8829,2,星语恋薇,2984,93,1,1,2,50.0%,27m
8829,2,[追随自由指引]Birth,2984,0,0,1,1,0.0%,13m
8842,1,我只会做航母,2983,1625,314,297,611,51.4%,24m
8842,3,Bourne,2983,1129,173,168,341,50.7%,20m
8842,1,心跳减速,2983,1566,81,70,151,53.6%,23m
8842,1,why,2983,528,36,33,69,52.2%,7m
8842,1,MONOER,2983,491,31,34,65,47.7%,23m
8842,3,风流梦丶,2983,376,29,33,62,46.8%,15m
8842,1,李咏浩,2983,440,14,17,31,45.2%,56m
8842,3,[武形秘仪]塔达林逼格第一人,2983,247,13,20,33,39.4%,19m
8842,1,夏栀,2983,285,12,7,19,63.2%,46m
8842,1,雪乂,2983,248,8,6,14,57.1%,16m
8842,1,AnimalYang,2983,224,6,5,11,54.5%,14m
8842,2,歇斯底里的偷笑,2983,114,4,1,5,80.0%,54m
8842,2,[凯姐被绿了]补丁哥,2983,0,1,0,1,100.0%,12m
8842,1,[Aqou]高海千歌,2983,0,1,1,2,50.0%,56m
8842,3,yuka,2983,97,1,1,2,50.0%,26m
8842,3,[QRADIO]truestory,2983,0,0,2,2,0.0%,1h
8858,3,[KPG2]我是新手让让我啊,2982,1536,109,105,214,50.9%,56m
8858,3,我是鸡饲料,2982,1512,71,82,153,46.4%,55m
8858,1,DontRushMe,2982,1153,42,38,80,52.5%,16m
8858,1,Mahesvara,2982,472,22,11,33,66.7%,53m
8858,3,曲奇,2982,568,20,29,49,40.8%,8m
8858,1,lovelyleilei,2982,437,18,12,30,60.0%,53m
8858,2,llllllllllll,2982,436,17,13,30,56.7%,29m
8858,2,盖世英雄,2982,271,11,5,16,68.8%,1h
8858,2,[我们的故事]HEDBG,2982,266,10,8,18,55.6%,13m
8858,2,[PY交易集市]Moster,2982,164,7,6,13,53.8%,1h
8858,1,MichaelZ,2982,154,5,2,7,71.4%,29m
8858,1,fLowiNgyEar,2982,70,3,6,9,33.3%,54m
8858,1,镜中人,2982,109,2,1,3,66.7%,41m
8858,1,皮得很啊,2982,36,2,2,4,50.0%,20m
8858,3,[辉光骑士团]机甲旋风,2982,30,2,16,18,11.1%,53m
8858,2,[从0学起]SherKelly,2982,0,1,0,1,100.0%,51m
8858,2,[do啊do]jiangdodo,2982,0,1,0,1,100.0%,24m
8858,2,llllllllllll,2982,0,1,0,1,100.0%,12m
8858,1,HHH,2982,96,1,1,2,50.0%,43m
8858,2,[六芒星s]渺远时刻,2982,32,1,2,3,33.3%,24m
8858,1,Immortals,2982,0,0,2,2,0.0%,16m
8879,2,[在下菜鸡一只]银河下的星辰,2981,893,77,57,134,57.5%,10m
8879,1,[中南大学官网]桥本环奈老公,2981,849,30,26,56,53.6%,17m
8879,1,假情假意贾斯丁,2981,457,15,13,28,53.6%,20m
8879,3,顾大人,2981,283,10,12,22,45.5%,6m
8879,3,Delruce,2981,222,9,10,19,47.4%,22m
8879,2,大叔你好,2981,181,8,5,13,61.5%,1h
8879,1,KILL,2981,212,8,7,15,53.3%,59m
8879,1,大宇,2981,140,5,2,7,71.4%,1h
8879,1,ApinkWlof,2981,104,4,4,8,50.0%,17m
8879,3,[暴雪我是你爹]坦克不对空,2981,171,3,9,12,25.0%,44m
8879,1,XiaoYang,2981,0,1,0,1,100.0%,44m
8879,2,llllllllllll,2981,0,1,0,1,100.0%,10m
8879,3,[极俗便是雅]零王,2981,0,0,1,1,0.0%,3m
8879,2,[能白给就白给]奇遇,2981,0,0,1,1,0.0%,35m
8893,1,king,2980,1105,63,51,114,55.3%,7m
8893,2,超小企鹅,2980,198,29,25,54,53.7%,29m
8893,1,LSL,2980,769,28,22,50,56.0%,23m
8893,1,IceStorm,2980,717,25,21,46,54.3%,24m
8893,1,ByuN,2980,527,24,18,42,57.1%,12m
8893,2,[我们是无敌的]盈潇诗雨,2980,361,13,16,29,44.8%,51m
8893,1,兰斯,2980,277,11,6,17,64.7%,12m
8893,1,皮卡苏,2980,308,9,14,23,39.1%,7m
8893,3,[Buakaw]风羽,2980,284,9,18,27,33.3%,10m
8893,2,你大表哥,2980,180,7,3,10,70.0%,10m
8893,1,mgk,2980,252,7,7,14,50.0%,7m
8893,1,sixL,2980,133,3,2,5,60.0%,1h
8893,3,[我的ID是]小可爱丫,2980,0,1,0,1,100.0%,8m
8893,2,WWW,2980,0,0,1,1,0.0%,52m
8893,1,[头号玩家]盛世豪杰,2980,0,0,2,2,0.0%,17m
8893,3,llllllllllll,2980,0,0,2,2,0.0%,29m
8909,3,[GTX]必争,2979,1535,593,590,1183,50.1%,30m
8909,3,[暴雪二十六队]项擎旭,2979,1574,354,347,701,50.5%,55m
8909,2,nidhogg,2979,815,55,43,98,56.1%,53m
8909,1,后海不是海丷,2979,1254,52,42,94,55.3%,8m
8909,1,[CAS]河神,2979,1009,35,33,68,51.5%,3m
8909,2,想要哥哥的大唧唧,2979,489,26,48,74,35.1%,11m
8909,1,Momoko,2979,302,12,14,26,46.2%,12m
8909,1,多糟,2979,122,5,5,10,50.0%,12m
8909,2,郁闷中的猪,2979,97,4,4,8,50.0%,1h
8909,3,玊玉,2979,76,3,7,10,30.0%,1h
8909,1,[目標諾森德]哈哈哈拉开,2979,74,2,4,6,33.3%,20m
8909,1,[SFTRA3]TomJAng,2979,80,2,7,9,22.2%,29m
8909,2,白日衣冠,2979,0,1,0,1,100.0%,26m
8909,1,大裤衩,2979,0,1,2,3,33.3%,55m
8923,3,IlllIIlllIII,2978,1539,229,222,451,50.8%,23m
8923,3,SGCALLE,2978,1002,95,77,172,55.2%,57m
8923,3,[可怜弱小无助]Shield,2978,428,23,33,56,41.1%,55m
8923,1,[壮哉632]小黑,2978,452,14,18,32,43.8%,53m
8923,3,Dex,2978,270,10,22,32,31.2%,16m
8923,1,mds,2978,254,7,11,18,38.9%,17m
8923,1,独孤,2978,178,5,9,14,35.7%,57m
8923,3,[s金色玫瑰s]njl,2978,122,4,9,13,30.8%,11m
8923,1,Sami,2978,0,3,2,5,60.0%,16m
8923,1,[荣耀归于我主]充能,2978,0,1,1,2,50.0%,7m
8923,1,权哥哥,2978,0,1,4,5,20.0%,31m
8923,1,dandao,2978,0,0,3,3,0.0%,31m
8935,1,JJJJJJJ,2977,660,68,56,124,54.8%,17m
8935,1,ACXY,2977,839,43,33,76,56.6%,6m
8935,2,结尾之音,2977,431,18,9,27,66.7%,24m
8935,1,SisPARA,2977,523,16,18,34,47.1%,17m
8935,3,罗杰,2977,204,7,5,12,58.3%,32m
8935,3,虚空者,2977,234,7,6,13,53.8%,10m
8935,2,[潸然丶那些年]Bachelor,2977,150,6,1,7,85.7%,57m
8935,1,[最菜战队]marinelord,2977,108,3,5,8,37.5%,56m
8935,3,卖女孩的小火柴,2977,121,2,2,4,50.0%,17m
8935,3,Adidas,2977,0,1,0,1,100.0%,26m
8935,2,橘子的七十一号机,2977,30,1,2,3,33.3%,13m
8935,1,我的天,2977,34,1,3,4,25.0%,8m
8935,1,[Mensa]老年人玩星际,2977,38,1,8,9,11.1%,29m
8935,2,[pn]desireXXX,2977,0,0,1,1,0.0%,27m
8949,3,暗巫,2976,1416,316,298,614,51.5%,56m
8949,1,[CPT]NASA,2976,1709,273,256,529,51.6%,29m
8949,3,llllllllllll,2976,1545,62,66,128,48.4%,51m
8949,1,[TShark]牛在灰翔,2976,1362,56,62,118,47.5%,16m
8949,3,[Fe3o4]芷若,2976,899,52,50,102,51.0%,27m
8949,2,MOSFET,2976,602,26,16,42,61.9%,12m
8949,3,星辰,2976,482,22,19,41,53.7%,24m
8949,2,人机大魔王,2976,496,19,14,33,57.6%,19m
8949,1,rua,2976,448,18,11,29,62.1%,12m
8949,1,星期八,2976,222,7,5,12,58.3%,29m
8949,3,两块冰,2976,97,4,3,7,57.1%,1h
8949,1,[Faith]落樱吹雪,2976,114,4,6,10,40.0%,30m
8949,1,呵呵了,2976,0,3,2,5,60.0%,1h
8949,3,CrazyCat,2976,93,2,6,8,25.0%,11m
8949,2,圣堂,2976,0,0,1,1,0.0%,11m
8949,3,[一般赢不了]顾楠,2976,0,0,1,1,0.0%,52m
8949,2,switch,2976,0,0,1,1,0.0%,6m
8949,1,soulvc,2976,0,0,3,3,0.0%,22m
8967,1,粉红色的兔子,2975,764,36,28,64,56.2%,12m
8967,3,MEFQSQ,2975,709,28,35,63,44.4%,15m
8967,2,温柔与她皆无,2975,97,5,3,8,62.5%,1h
8967,2,[CMU]想你了,2975,117,2,3,5,40.0%,34m
8967,2,窗外的猫,2975,0,1,0,1,100.0%,19m
8967,2,limitations,2975,30,1,2,3,33.3%,19m
8967,2,holy,2975,30,1,3,4,25.0%,7m
8967,1,[pypypy]TIME,2975,0,0,2,2,0.0%,14m
8967,1,Keith,2975,0,0,3,3,0.0%,59m
8976,3,全程喊我来的,2974,1512,96,108,204,47.1%,14m
8976,1,haingz,2974,602,87,78,165,52.7%,23m
8976,1,[DMR]expelliomos,2974,849,36,26,62,58.1%,16m
8976,1,[Shawk]炸鱼死马嗷,2974,357,25,17,42,59.5%,24m
8976,2,垃圾顺,2974,582,22,15,37,59.5%,9m
8976,3,赟丨健,2974,517,21,32,53,39.6%,31m
8976,3,SolveLove,2974,163,7,3,10,70.0%,1h
8976,2,城南小霸王李现,2974,184,7,6,13,53.8%,1h
8976,2,[哔翻天梯鸡]BrandoFSu,2974,168,4,3,7,57.1%,31m
8976,2,[刺蛇单推协会]落雪,2974,0,1,0,1,100.0%,16m
8976,1,神界之战,2974,0,1,1,2,50.0%,55m
8976,2,高兴,2974,0,1,1,2,50.0%,28m
8976,2,apostle,2974,0,1,1,2,50.0%,16m
8976,1,[扫黄]角落亦清,2974,0,1,2,3,33.3%,1h
8976,1,WSK,2974,0,1,4,5,20.0%,7m
8976,1,[白狼天狗]犬走椛,2974,0,0,1,1,0.0%,1h
8976,2,[BUPTNB]JInAirRouge,2974,0,0,1,1,0.0%,13m
8976,1,ricky,2974,0,0,2,2,0.0%,10m
8994,1,受不了,2973,1667,212,189,401,52.9%,22m
8994,2,笑天下,2973,382,14,7,21,66.7%,27m
8994,2,zeratul,2973,204,8,5,13,61.5%,19m
8994,2,即将爆发,2973,174,7,6,13,53.8%,3m
8994,2,xieyang,2973,172,7,7,14,50.0%,54m
8994,1,[旭日之心]snoW,2973,176,6,7,13,46.2%,27m
8994,1,SuCCbbq,2973,0,3,2,5,60.0%,17m
8994,2,[Rar兄弟会]hitboy,2973,30,2,0,2,100.0%,19m
8994,2,[残雪映月]时停者咲夜,2973,58,2,1,3,66.7%,24m
8994,2,[戰無不勝]戰無不勝,2973,32,2,1,3,66.7%,53m
8994,3,趣多多,2973,42,2,5,7,28.6%,23m
8994,2,Dean,2973,0,1,0,1,100.0%,29m
8994,1,whltte,2973,89,1,3,4,25.0%,56m
8994,1,[珂学]MagejiTerran,2973,0,1,4,5,20.0%,12m
8994,1,空虚的雪,2973,0,0,4,4,0.0%,14m
9009,3,Snan,2972,781,60,66,126,47.6%,17m
9009,2,无人,2972,760,39,30,69,56.5%,28m
9009,2,超级无敌牛者,2972,751,36,20,56,64.3%,12m
9009,2,[羊圈]情过无痕,2972,409,36,31,67,53.7%,28m
9009,1,OSO,2972,839,32,29,61,52.5%,55m
9009,2,[蒂亞]特特,2972,189,8,6,14,57.1%,10m
9009,1,[镇魂]萨尔那加感染者,2972,244,8,9,17,47.1%,22m
9009,2,小小棉花糖,2972,146,6,2,8,75.0%,7m
9009,2,chaoshadow,2972,245,6,7,13,46.2%,23m
9009,1,西西里爱情,2972,96,4,3,7,57.1%,1h
9009,3,SKYover,2972,0,1,1,2,50.0%,1h
9009,2,王者艾克,2972,0,0,2,2,0.0%,28m
9021,3,WOAICHOUWAZI,2971,945,372,366,738,50.4%,14m
9021,1,die,2971,1636,293,267,560,52.3%,31m
9021,3,[五月花]喜欢月亮的你,2971,1491,262,236,498,52.6%,31m
9021,1,狗子,2971,1209,158,149,307,51.5%,14m
9021,1,翻不了身的咸鱼,2971,752,35,26,61,57.4%,53m
9021,2,[西菜场街道办]rrTYrr,2971,360,23,18,41,56.1%,28m
9021,2,三国泪,2971,415,22,0,22,100.0%,51m
9021,1,Krilry,2971,118,8,6,14,57.1%,22m
9021,2,大野爹,2971,167,7,6,13,53.8%,35m
9021,1,Excalibur,2971,233,7,9,16,43.8%,8m
9021,2,Say,2971,227,7,11,18,38.9%,54m
9021,1,凤凰院番茄,2971,186,5,10,15,33.3%,20m
9021,2,给你布置作业,2971,58,3,1,4,75.0%,19m
9021,2,llllllllll,2971,0,1,0,1,100.0%,25m
9021,2,随时会掉线的菜鸡,2971,30,1,2,3,33.3%,4m
9021,1,[合作无敌手]可是我无法绝恋,2971,97,1,5,6,16.7%,37m
9021,2,[要啥没啥爱咋]木券可待,2971,0,0,1,1,0.0%,22m
9021,1,[Sunglo]自由超鬼,2971,0,0,1,1,0.0%,49m
9021,3,llllllllllll,2971,0,0,2,2,0.0%,57m
9021,1,ZWTMZSMJ,2971,0,0,3,3,0.0%,45m
9041,3,iiiiiiiiiiii,2970,1488,76,89,165,46.1%,56m
9041,3,[战争结束了]麻薯,2970,1528,69,77,146,47.3%,30m
9041,1,vivalavida,2970,1571,63,59,122,51.6%,16m
9041,1,简单电脑,2970,312,18,15,33,54.5%,6m
9041,1,[红萌馆]毒奶黄旭东丶,2970,494,16,19,35,45.7%,57m
9041,1,[YT]萌妹玩星际,2970,396,13,13,26,50.0%,8m
9041,2,呵呵,2970,254,9,7,16,56.2%,29m
9041,1,龙骑吴奇隆,2970,158,6,3,9,66.7%,20m
9041,2,[混吃混喝]彳亍行者,2970,180,6,5,11,54.5%,28m
9041,3,人族怎么打嘛,2970,171,6,10,16,37.5%,10m
9041,1,大混子,2970,0,4,1,5,80.0%,1h
9041,1,我就是百度,2970,0,4,1,5,80.0%,1h
9041,1,Dalxnn,2970,97,4,2,6,66.7%,1h
9041,1,[JiTEAM]枭枭,2970,48,4,3,7,57.1%,16m
9041,2,锁心,2970,58,3,0,3,100.0%,24m
9041,3,kmert,2970,95,2,0,2,100.0%,3m
9041,2,佛朗哥,2970,30,1,1,2,50.0%,24m
9041,2,波晶夫,2970,0,0,1,1,0.0%,11m
9059,1,琉璃月羽,2969,1045,109,90,199,54.8%,14m
9059,1,SCV,2969,1630,95,88,183,51.9%,53m
9059,1,[混吃混喝]虚空之遗,2969,901,91,81,172,52.9%,20m
9059,1,拎壶冲,2969,490,18,15,33,54.5%,55m
9059,1,[水师主教之刃]PhoenixT,2969,228,6,6,12,50.0%,6m
9059,1,不如怀念,2969,188,6,9,15,40.0%,31m
9059,1,开坦克的苏克,2969,0,3,2,5,60.0%,1h
9059,1,出其东门,2969,133,2,2,4,50.0%,11m
9059,2,fighting,2969,110,2,4,6,33.3%,55m
9059,2,[不灭青铜]菜鸟,2969,30,1,1,2,50.0%,10m
9059,2,灰尘,2969,30,1,1,2,50.0%,31m
9059,2,[为欢几何]okc,2969,0,0,1,1,0.0%,15m
9059,3,[HPT]无聊至极,2969,0,0,1,1,0.0%,1h
9059,1,[凛风]bala,2969,0,0,2,2,0.0%,1h
9073,3,艾尔之心,2968,603,46,26,72,63.9%,14m
9073,3,[花开彼岸天]尔等有罪,2968,764,40,45,85,47.1%,53m
9073,1,Vinkin,2968,240,26,18,44,59.1%,31m
9073,2,三三得三,2968,343,11,10,21,52.4%,7m
9073,3,Ause,2968,116,8,3,11,72.7%,1h
9073,1,[SWUST灬]Justman,2968,175,6,2,8,75.0%,24m
9073,2,[白银联盟]star,2968,116,5,1,6,83.3%,25m
9073,2,[社交学教练]孤独的苍蓝星,2968,88,3,2,5,60.0%,11m
9073,1,此地可是白门楼,2968,0,2,0,2,100.0%,10m
9073,3,OBE,2968,0,0,1,1,0.0%,22m
9083,1,stee,2967,1658,117,111,228,51.3%,53m
9083,2,且弈,2967,847,77,55,132,58.3%,25m
9083,2,[CPT]虚空之王,2967,1103,55,34,89,61.8%,3m
9083,1,Kisshot,2967,979,52,43,95,54.7%,54m
9083,2,ripido,2967,267,11,2,13,84.6%,3m
9083,2,[Rhusky]TomTom,2967,282,10,8,18,55.6%,28m
9083,1,blank,2967,120,6,6,12,50.0%,1h
9083,2,Dreamer,2967,151,4,3,7,57.1%,24m
9083,2,damon,2967,142,3,1,4,75.0%,53m
9083,1,[高速钢]IIIIIIIIIIII,2967,123,3,3,6,50.0%,30m
9083,1,sun,2967,76,2,7,9,22.2%,31m
9083,1,叶茗,2967,48,1,1,2,50.0%,1h
9083,1,国服第一白给,2967,0,1,2,3,33.3%,41m
9083,2,[大小姐的红萌]高贵与罪恶的红月,2967,0,0,1,1,0.0%,14m
9097,3,[芽衣最可爱了]风间净琉璃,2966,1372,105,99,204,51.5%,58m
9097,2,[充气]芜湖起飞,2966,326,13,8,21,61.9%,7m
9097,2,蓝巴猫,2966,157,7,4,11,63.6%,19m
9097,3,铭泽,2966,120,5,3,8,62.5%,1h
9097,1,一枝菊花压海棠,2966,193,5,5,10,50.0%,12m
9097,1,[哔翻天梯鸡]sadsnow,2966,188,5,11,16,31.2%,29m
9097,2,[BereTA]Thor,2966,30,4,1,5,80.0%,35m
9097,2,Crie,2966,118,4,1,5,80.0%,3m
9097,1,Kudly,2966,0,4,4,8,50.0%,36m
9097,2,[第九舰队丶]虚空假面,2966,60,3,1,4,75.0%,29m
9097,1,FallenDust,2966,0,3,2,5,60.0%,31m
9097,1,陌上花开,2966,0,3,2,5,60.0%,53m
9097,1,[星际同萌]威严的蕾米莉亚,2966,0,3,2,5,60.0%,45m
9097,2,[用不服谁]MASTER,2966,60,2,2,4,50.0%,52m
9097,1,Miniko,2966,144,2,3,5,40.0%,1h
9097,2,cary,2966,0,1,0,1,100.0%,16m
9097,3,shgdjdjh,2966,0,1,6,7,14.3%,1h
9114,1,晴天星星,2965,1584,148,122,270,54.8%,16m
9114,1,苍苍蒹葭,2965,1048,36,38,74,48.6%,7m
9114,2,烟雨过客,2965,388,17,6,23,73.9%,17m
9114,1,酷酷的小脚丫,2965,386,15,10,25,60.0%,16m
9114,1,爽娃娃,2965,404,13,12,25,52.0%,7m
9114,1,步子太大容易扯蛋,2965,236,9,9,18,50.0%,1h
9114,1,FIREQIU,2965,233,9,12,21,42.9%,6m
9114,2,你来杀我呀,2965,126,5,2,7,71.4%,27m
9114,1,tan,2965,162,5,3,8,62.5%,58m
9114,3,[oo]苍穹云翳,2965,168,4,3,7,57.1%,3m
9114,1,[Fenix]久住小春,2965,0,4,5,9,44.4%,8m
9114,1,[西伯利亚土豆]Lin,2965,189,4,6,10,40.0%,17m
9114,1,[二次元同好会]皮卡丘,2965,103,3,3,6,50.0%,57m
9114,3,[盖世双谐]最帅男公关,2965,78,3,3,6,50.0%,5m
9114,1,[CSJJ]扒衣以示众,2965,0,1,0,1,100.0%,7m
9114,3,lllIllIlIlIl,2965,0,1,0,1,100.0%,1h
9114,3,刚刚好,2965,2,1,1,2,50.0%,1h
9114,2,汐夏,2965,36,1,1,2,50.0%,12m
9114,2,[Lus]MasterDecay,2965,34,1,2,3,33.3%,15m
9114,1,现世妄执,2965,0,1,2,3,33.3%,23m
9114,2,[龙猫]我爱虫虫,2965,0,0,1,1,0.0%,9m
9114,2,[荣耀归于我主]尤金农克尤克烈,2965,0,0,1,1,0.0%,9m
9136,3,朝露,2964,1482,410,392,802,51.1%,9m
9136,3,[龙眠山下的猫]泰伦基建狂魔,2964,973,95,96,191,49.7%,26m
9136,1,阿特,2964,449,57,55,112,50.9%,13m
9136,3,[菜有菜的道理]GoChinD,2964,1073,42,44,86,48.8%,13m
9136,3,haolou,2964,483,20,20,40,50.0%,8m
9136,1,姬川优耐,2964,417,16,15,31,51.6%,30m
9136,3,[嘟嘟嘟噜]鲨鱼的爸爸,2964,273,12,10,22,54.5%,5m
9136,1,你的益达,2964,36,2,3,5,40.0%,30m
9136,1,有什么冲我来,2964,70,2,5,7,28.6%,54m
9136,2,[虚拟歌手团体]洛天依,2964,133,2,5,7,28.6%,1h
9136,2,噶姐的迷弟,2964,0,1,0,1,100.0%,24m
9136,3,[菜的没人带]KRS,2964,0,1,1,2,50.0%,1h
9136,2,[齐富孙一峰]常天庆灬,2964,0,0,1,1,0.0%,5m
9136,2,Critical,2964,0,0,2,2,0.0%,27m
9150,1,LYINGHART,2963,968,77,74,151,51.0%,17m
9150,1,[瘾大眼瞎]衿丶,2963,1365,58,51,109,53.2%,55m
9150,1,妙语连珠,2963,1296,50,48,98,51.0%,9m
9150,1,Prayeon,2963,793,44,39,83,53.0%,9m
9150,1,ainiyiwannia,2963,965,34,31,65,52.3%,24m
9150,2,沈逼逼,2963,340,13,12,25,52.0%,17m
9150,1,[xgnb]圣达,2963,286,10,7,17,58.8%,57m
9150,2,[爪巴]艾尔知耻,2963,256,9,7,16,56.2%,19m
9150,2,锂明矾,2963,189,8,6,14,57.1%,1h
9150,1,那打不过能咋办嘛,2963,96,5,5,10,50.0%,1h
9150,1,IIIIIIII,2963,48,4,3,7,57.1%,1h
9150,2,[远坂世家]OpenFire,2963,0,1,0,1,100.0%,20m
9150,2,八云芦苇,2963,30,1,2,3,33.3%,57m
9150,2,[冥振四海]罅秣,2963,0,0,2,2,0.0%,13m
9150,1,[萌新保护协议]你的探姬都去哪了,2963,0,0,3,3,0.0%,3m
9165,3,Distort,2962,1382,77,70,147,52.4%,56m
9165,1,showtime,2962,1351,57,50,107,53.3%,17m
9165,1,dgy,2962,855,42,33,75,56.0%,20m
9165,1,[流氓高手]晨鸣,2962,775,32,38,70,45.7%,23m
9165,1,[SCD]蘑菇,2962,299,14,7,21,66.7%,29m
9165,2,[SHNU]斗鹰,2962,232,8,2,10,80.0%,17m
9165,3,瑞克灬桑切斯,2962,166,8,3,11,72.7%,17m
9165,2,Proletariat,2962,196,7,5,12,58.3%,5m
9165,3,[暴走族]美女吻过的野兽,2962,142,5,4,9,55.6%,1h
9165,3,[BUPTNB]无限远点的牵牛星,2962,0,4,3,7,57.1%,1h
9165,1,[夏日香气]冰柠檬物语,2962,138,4,3,7,57.1%,8m
9165,1,金牌运动员,2962,0,3,2,5,60.0%,1h
9165,1,[羊驼羊驼羊]Poca,2962,120,3,3,6,50.0%,57m
9165,2,[FF2f1A]你的当当,2962,0,1,0,1,100.0%,27m
9165,1,余辉烁烁,2962,0,1,0,1,100.0%,1h
9165,2,醒物,2962,0,1,0,1,100.0%,28m
9165,2,[神必完整]NerazimBean,2962,0,0,1,1,0.0%,13m
9165,2,[峡谷]我星际逆战版,2962,0,0,1,1,0.0%,21m
9165,2,phoenix,2962,0,0,1,1,0.0%,10m
9184,3,银向远,2961,847,39,42,81,48.1%,7m
9184,2,[GTA丶SE]TAGer,2961,443,19,8,27,70.4%,10m
9184,2,Inglorious,2961,338,12,10,22,54.5%,52m
9184,1,queenbee,2961,207,8,6,14,57.1%,1h
9184,1,[死亡之火]shensky,2961,96,5,1,6,83.3%,53m
9184,2,桐谷和人,2961,160,5,3,8,62.5%,35m
9184,1,终梦,2961,123,3,4,7,42.9%,12m
9184,3,院墨,2961,118,2,1,3,66.7%,23m
9184,2,别打了我自己退,2961,68,2,3,5,40.0%,25m
9184,2,IlIIllIllIIl,2961,0,1,0,1,100.0%,25m
9184,2,逍遥风影,2961,0,0,1,1,0.0%,13m
9184,2,打你不用鼠标,2961,0,0,1,1,0.0%,28m
9184,2,胡迪牛仔,2961,0,0,1,1,0.0%,51m
9184,1,Tins,2961,0,0,4,4,0.0%,20m
9198,1,Devil,2960,1469,101,88,189,53.4%,57m
9198,2,萌新玩星际,2960,279,46,27,73,63.0%,56m
9198,2,肉祖宗,2960,535,45,45,90,50.0%,56m
9198,2,七束一,2960,220,24,1,25,96.0%,21m
9198,2,IIIIIIIII,2960,551,24,15,39,61.5%,25m
9198,1,炸鱼号死全家,2960,344,17,14,31,54.8%,31m
9198,1,Saracjing,2960,336,12,10,22,54.5%,57m
9198,1,孤独不败,2960,324,11,9,20,55.0%,12m
9198,1,Aspire,2960,290,10,16,26,38.5%,24m
9198,2,[公爵]帅比帅比逍遥君,2960,178,7,6,13,53.8%,13m
9198,1,天涯,2960,0,3,2,5,60.0%,1h
9198,3,我是新手,2960,0,3,4,7,42.9%,1h
9198,2,[逍遙自在]白白胖胖,2960,30,2,0,2,100.0%,51m
9198,2,[洛丹伦的雨夜]llllllllllll,2960,32,2,2,4,50.0%,27m
9198,1,[小砍刀幼儿园]萌骑飞飞,2960,0,2,3,5,40.0%,1h
9198,1,RAIN,2960,0,1,0,1,100.0%,45m
9214,2,风吹裙起屁屁凉,2959,448,17,13,30,56.7%,52m
9214,2,felixcxj,2959,230,9,5,14,64.3%,1h
9214,1,Marok,2959,48,4,3,7,57.1%,1h
9214,2,[CDebug]Legion,2959,60,3,1,4,75.0%,13m
9214,1,[你是子龙啊]中华小当家,2959,0,3,2,5,60.0%,1h
9214,2,[愿如月照雪]寥寥若晨星,2959,62,3,2,5,60.0%,24m
9214,1,茗记爱你哟,2959,0,3,2,5,60.0%,52m
9214,1,行天下,2959,0,3,2,5,60.0%,1h
9214,2,Zero,2959,60,2,2,4,50.0%,21m
9214,2,幻小欣,2959,0,1,0,1,100.0%,10m
9214,2,[英雄之光]DemoN,2959,0,0,1,1,0.0%,25m
9214,2,[月影凝霜]态度极差,2959,0,0,1,1,0.0%,1h
9214,2,[futa]可缓缓归矣,2959,0,0,1,1,0.0%,21m
9214,3,Auslese,2959,0,0,1,1,0.0%,55m
9214,2,[牌面]SCCC,2959,0,0,1,1,0.0%,5m
9214,3,星辰,2959,0,0,3,3,0.0%,52m
9230,2,Kassler,2958,867,33,32,65,50.8%,25m
9230,1,VKprime,2958,176,9,2,11,81.8%,54m
9230,2,MMQ,2958,238,9,9,18,50.0%,30m
9230,2,[大宇恩]卡什,2958,154,6,3,9,66.7%,27m
9230,2,算命先生,2958,185,5,4,9,55.6%,52m
9230,1,[C06904]sky,2958,104,3,2,5,60.0%,23m
9230,1,IIIIIIIIIIII,2958,0,3,2,5,60.0%,27m
9230,1,八方古剑,2958,42,3,7,10,30.0%,8m
9230,2,殇梦,2958,30,2,0,2,100.0%,11m
9230,2,禁止非法炸鱼,2958,0,1,1,2,50.0%,12m
9230,2,[达拉姆之刃]为艾尔而战,2958,34,1,3,4,25.0%,52m
9230,1,[虚空光辉舰]姐姐要用力干哥哥,2958,89,1,3,4,25.0%,27m
9230,2,noooo,2958,0,0,1,1,0.0%,16m
9243,2,夜雨蔚蓝,2957,1216,96,84,180,53.3%,35m
9243,2,[肿肿]一宇,2957,1097,57,44,101,56.4%,24m
9243,1,第二适格者明日香,2957,977,55,51,106,51.9%,8m
9243,1,lxwforever,2957,833,44,36,80,55.0%,14m
9243,1,这次是真的,2957,1103,39,37,76,51.3%,8m
9243,1,Rosentale,2957,640,25,22,47,53.2%,17m
9243,2,[夏色吹雪协会]dimiyar,2957,206,8,2,10,80.0%,16m
9243,1,鸿宇大哥,2957,0,4,1,5,80.0%,56m
9243,1,[SaiL]老狼,2957,0,1,1,2,50.0%,1h
9243,1,LEMON,2957,97,1,1,2,50.0%,1h
9243,2,[璀璨的星空]魂魄西行寺,2957,0,0,1,1,0.0%,22m
9243,2,[MUL]血龙怒,2957,0,0,1,1,0.0%,10m
9243,1,[白给兄弟]INNOVATION,2957,0,0,1,1,0.0%,1h
9243,2,[HK丶S]KhanLing,2957,0,0,1,1,0.0%,34m
9243,2,[在鹿上]启源,2957,0,0,1,1,0.0%,27m
9258,1,[刺客槶]海阔天空,2956,1263,62,46,108,57.4%,57m
9258,1,zbm,2956,1469,53,54,107,49.5%,9m
9258,1,[三族鼎立]XRay,2956,1140,52,36,88,59.1%,17m
9258,3,watch,2956,566,23,23,46,50.0%,15m
9258,2,FIRe,2956,548,22,13,35,62.9%,16m
9258,3,多线起飞,2956,546,21,23,44,47.7%,25m
9258,2,[周哥神教]EEETT,2956,410,20,16,36,55.6%,27m
9258,1,OMO,2956,248,11,7,18,61.1%,31m
9258,2,侠盗,2956,250,8,12,20,40.0%,11m
9258,2,[WIE]Alphago,2956,170,7,3,10,70.0%,14m
9258,2,aaaaaaaaaaa,2956,64,5,4,9,55.6%,55m
9258,2,祖国的花,2956,32,2,0,2,100.0%,22m
9258,2,彼岸留芳,2956,30,2,1,3,66.7%,52m
9258,2,[老吴天下第一]会抱瑞文的小康妮,2956,62,2,4,6,33.3%,14m
9258,1,傲雪,2956,0,1,0,1,100.0%,20m
9258,2,[昊灵]zxx,2956,0,0,1,1,0.0%,20m
9258,3,FIreATAR,2956,0,0,1,1,0.0%,25m
9275,1,空白,2955,1576,177,168,345,51.3%,23m
9275,1,吾乃天命之子,2955,674,45,32,77,58.4%,16m
9275,1,[Y1]ssadsd,2955,914,35,33,68,51.5%,8m
9275,1,[破灭]fengxue,2955,936,33,35,68,48.5%,54m
9275,1,[你渴望力量吗]嘤嘤嘤,2955,812,30,24,54,55.6%,14m
9275,2,客即至当如何,2955,722,30,25,55,54.5%,51m
9275,3,IIIIIIIIIIII,2955,710,28,27,55,50.9%,26m
9275,1,执念浅殇,2955,619,26,21,47,55.3%,6m
9275,2,[银翼之光]查无此人,2955,615,24,20,44,54.5%,12m
9275,3,一颗电竞梦想的心,2955,557,20,24,44,45.5%,25m
9275,1,Dartagnan,2955,570,18,24,42,42.9%,22m
9275,2,萌萌哒的小猪,2955,221,12,6,18,66.7%,10m
9275,2,[艾尔之主]VFskyrim,2955,277,10,5,15,66.7%,31m
9275,3,[社交学教练]落花狼藉,2955,178,7,4,11,63.6%,5m
9275,1,茶色蔓延丶,2955,168,6,7,13,46.2%,1h
9275,2,洛克,2955,166,4,5,9,44.4%,11m
9275,1,起点,2955,0,3,2,5,60.0%,52m
9275,3,恰克船长,2955,94,2,0,2,100.0%,14m
9275,2,[我骄傲我自豪]Mantos,2955,0,2,4,6,33.3%,1h
9275,1,林笑宇,2955,74,2,5,7,28.6%,23m
9275,2,[珈百璃的天堂]我爱樱岛麻衣学姐,2955,0,1,0,1,100.0%,53m
9275,3,[永恒者]奥柏伦亲王,2955,0,1,0,1,100.0%,14m
9275,2,starry,2955,36,1,1,2,50.0%,12m
9275,1,VeniVediVici,2955,48,1,2,3,33.3%,10m
9275,3,茨科,2955,0,0,4,4,0.0%,3m
9300,3,nidie,2954,1275,103,93,196,52.6%,6m
9300,1,[K2]小萨摩,2954,835,99,93,192,51.6%,22m
9300,2,[我相信你能赢]枪神,2954,432,23,18,41,56.1%,15m
9300,2,IronProtoss,2954,385,22,15,37,59.5%,27m
9300,1,什么,2954,648,21,24,45,46.7%,14m
9300,3,maybe,2954,380,14,20,34,41.2%,12m
9300,1,evater,2954,117,4,3,7,57.1%,52m
9300,2,御姐控一只,2954,0,1,0,1,100.0%,22m
9300,2,妖妖灵,2954,0,1,0,1,100.0%,6m
9300,2,[队友是猪]AgainstRY,2954,0,1,1,2,50.0%,21m
9300,2,Darwin,2954,0,1,4,5,20.0%,3m
9300,2,艾泽拉斯大妈,2954,0,0,1,1,0.0%,53m
9312,3,best,2953,1040,232,214,446,52.0%,30m
9312,1,[碳酸骑士]刚毅冲锋叉,2953,1469,165,162,327,50.5%,8m
9312,1,[鬼谷]你敬爱的宁哥哥,2953,1241,68,64,132,51.5%,23m
9312,2,你野爹就是这样,2953,940,63,54,117,53.8%,14m
9312,2,[超实验级的]萨法尔,2953,293,21,7,28,75.0%,28m
9312,2,Miku,2953,266,10,3,13,76.9%,12m
9312,2,情意南确,2953,144,5,4,9,55.6%,3m
9312,1,[popTM]watergun,2953,223,5,8,13,38.5%,53m
9312,2,[我高贵的族人]THEONE,2953,32,2,0,2,100.0%,6m
9312,1,自动化的海龙,2953,48,1,1,2,50.0%,1h
9312,2,菜花黄,2953,0,1,1,2,50.0%,52m
9312,2,忘忧,2953,30,1,1,2,50.0%,52m
9312,1,Darkhunter,2953,97,1,1,2,50.0%,1h
9312,2,超级无敌范范范,2953,34,1,2,3,33.3%,54m
9312,1,darkcarrot,2953,0,1,3,4,25.0%,53m
9327,1,从入门到跑路,2952,1389,123,114,237,51.9%,12m
9327,2,芸芸,2952,378,58,39,97,59.8%,21m
9327,3,龙宫礼奈,2952,840,29,42,71,40.8%,17m
9327,3,thugss,2952,293,10,8,18,55.6%,7m
9327,1,[鲲之大]金三胖,2952,268,10,12,22,45.5%,16m
9327,2,kokoforever,2952,224,8,6,14,57.1%,52m
9327,1,pomp,2952,155,6,3,9,66.7%,1h
9327,2,阿尼慕斯菲亚,2952,144,5,4,9,55.6%,21m
9327,1,[YMSB]魔魂,2952,150,4,2,6,66.7%,1h
9327,3,[鸽子六发]另一个窝,2952,139,4,4,8,50.0%,3m
9327,2,虚渊玄,2952,30,2,0,2,100.0%,6m
9327,1,妨碍咱的渣渣,2952,0,2,2,4,50.0%,45m
9327,2,花悦婿艳,2952,0,1,0,1,100.0%,28m
9327,2,Ephemeral,2952,0,1,2,3,33.3%,10m
9327,2,有闪电就输不了,2952,0,1,4,5,20.0%,27m
9342,3,夏天小公主,2951,1374,344,348,692,49.7%,16m
9342,1,ZZF,2951,1602,83,86,169,49.1%,14m
9342,2,[冲就完了]天涯明月刀,2951,1392,60,45,105,57.1%,7m
9342,1,Soul,2951,1417,57,49,106,53.8%,23m
9342,1,浪无夜极星,2951,885,40,27,67,59.7%,54m
9342,1,又双叒叕,2951,690,37,26,63,58.7%,9m
9342,2,[GOTAL]只会玩小狗的菜鸟,2951,430,14,11,25,56.0%,11m
9342,1,[疼王阁]Azure,2951,190,5,10,15,33.3%,13m
9342,3,Cullen,2951,97,4,2,6,66.7%,1h
9342,1,[恶劣玩家]波波,2951,137,3,5,8,37.5%,29m
9342,2,[好爷爷]舰长大人,2951,30,2,1,3,66.7%,31m
9342,2,nilaia,2951,0,1,1,2,50.0%,30m
9342,2,[LDP]虚空,2951,0,0,1,1,0.0%,11m
9342,2,[一二一]啦啦啦,2951,0,0,1,1,0.0%,16m
9356,1,休伯利安号某门卫,2950,1182,55,50,105,52.4%,24m
9356,3,CorNeR,2950,946,36,43,79,45.6%,30m
9356,2,STEdge,2950,802,31,29,60,51.7%,5m
9356,2,MagicTerran,2950,457,18,11,29,62.1%,54m
9356,2,清雪,2950,322,15,1,16,93.8%,39m
9356,1,jimv,2950,0,2,2,4,50.0%,1h
9356,2,HHHHHHH,2950,0,1,0,1,100.0%,45m
9363,2,非心,2949,1494,65,47,112,58.0%,10m
9363,2,LYNX,2949,416,41,31,72,56.9%,22m
9363,1,新鲜土豆丝,2949,508,15,20,35,42.9%,15m
9363,1,SpaceCowboy,2949,378,14,16,30,46.7%,16m
9363,2,粪坑之王,2949,234,12,5,17,70.6%,17m
9363,2,盆满钵满蟹老板,2949,148,6,4,10,60.0%,51m
9363,1,狡猾,2949,0,3,2,5,60.0%,38m
9363,2,[花映]依丝卡普雷利尔,2949,62,3,3,6,50.0%,14m
9363,1,[Debu]KagamineRen,2949,0,2,3,5,40.0%,58m
9363,2,gao,2949,0,1,0,1,100.0%,28m
9363,2,無邪気女子初中生,2949,0,1,0,1,100.0%,56m
9363,2,梅川内酷,2949,30,1,1,2,50.0%,31m
9363,2,Crayn,2949,0,0,1,1,0.0%,52m
9363,2,TZP,2949,0,0,2,2,0.0%,1h
9377,3,[西红柿炒]XJH,2948,1314,117,112,229,51.1%,8m
9377,3,节日费,2948,1247,56,63,119,47.1%,17m
9377,2,嘤嘤嘤嘤嘤嘤,2948,838,31,26,57,54.4%,11m
9377,2,[硬骨头会所]孜然啊孜然,2948,464,19,10,29,65.5%,19m
9377,2,[埃蒙好可爱]怂出一片天,2948,272,11,3,14,78.6%,22m
9377,2,BLANKliming,2948,206,7,8,15,46.7%,52m
9377,2,波波良小伞,2948,188,5,2,7,71.4%,7m
9377,1,[ZeroT]HappyTian,2948,158,5,10,15,33.3%,57m
9377,2,tonyfu,2948,94,4,3,7,57.1%,11m
9377,1,博宝宝,2948,0,2,4,6,33.3%,28m
9377,1,[星际爱好者队]网鱼胖哥,2948,94,2,7,9,22.2%,15m
9377,2,[风轻云淡]旋风火舞,2948,0,1,0,1,100.0%,20m
9377,2,[相顾无言]雪色轻寒,2948,0,0,2,2,0.0%,19m
9390,2,[虚拟歌手团体]御坂美琴,2947,1508,67,63,130,51.5%,52m
9390,1,雏凤峰,2947,1542,61,56,117,52.1%,16m
9390,1,人生如戏心喜你,2947,1299,53,46,99,53.5%,17m
9390,2,迷路的麋鹿,2947,721,51,31,82,62.2%,53m
9390,2,上饶孙一峰,2947,1196,50,42,92,54.3%,3m
9390,1,[七咕咕]天幕下的银翼,2947,819,27,31,58,46.6%,6m
9390,1,[桃子zz]消失的神话,2947,48,4,3,7,57.1%,49m
9390,3,CCY,2947,116,3,2,5,60.0%,22m
9390,2,[KPG2]自由,2947,92,3,4,7,42.9%,58m
9390,1,不解释心,2947,0,2,2,4,50.0%,1h
9390,1,[你下面凉快吗]镜之边缘,2947,0,2,3,5,40.0%,52m
9390,2,翻飞夙愿,2947,0,1,0,1,100.0%,20m
9390,3,Asgard,2947,0,1,0,1,100.0%,1h
9390,2,竹虫猫,2947,0,1,0,1,100.0%,19m
9390,1,束默心,2947,0,0,1,1,0.0%,1h
9405,1,何处无风,2946,762,95,84,179,53.1%,54m
9405,1,[无花也浪漫]鬼子,2946,1652,81,72,153,52.9%,17m
9405,2,狗骑士,2946,594,23,16,39,59.0%,54m
9405,2,llllllllllll,2946,406,18,5,23,78.3%,21m
9405,1,[Choice]INnoVation,2946,360,11,15,26,42.3%,9m
9405,2,[Vgirls]Agoni,2946,144,5,4,9,55.6%,54m
9405,1,菌毯糊脸,2946,166,5,4,9,55.6%,55m
9405,2,简单难度电脑,2946,146,5,6,11,45.5%,10m
9405,1,wqwqwq,2946,116,4,3,7,57.1%,1h
9405,2,Froven,2946,139,4,4,8,50.0%,52m
9405,1,荒无极,2946,38,3,5,8,37.5%,8m
9405,1,LAO,2946,0,1,1,2,50.0%,1h
9417,1,SHtossfnione,2945,338,34,30,64,53.1%,8m
9417,2,[斯巴达血战团]JohnAnder,2945,409,17,9,26,65.4%,10m
9417,2,awakening,2945,183,12,13,25,48.0%,10m
9417,1,[武汉理工大学]琴吹紬,2945,143,4,2,6,66.7%,17m
9417,1,两颗糯米,2945,96,4,2,6,66.7%,58m
9417,2,[HustSC]yndeux,2945,90,4,3,7,57.1%,28m
9417,1,[你已经死啦]圆环之理,2945,48,3,4,7,42.9%,1h
9417,1,[哔翻天梯鸡]水静先生,2945,68,3,6,9,33.3%,17m
9417,2,星际领主,2945,34,2,2,4,50.0%,29m
9417,3,木下三生,2945,0,2,6,8,25.0%,3m
9417,1,[专业丶团队]光明审判者,2945,0,1,1,2,50.0%,1h
9417,2,mangr,2945,0,0,1,1,0.0%,16m
9429,2,夜雨声烦,2944,950,41,26,67,61.2%,3m
9429,2,错过花开,2944,286,33,21,54,61.1%,56m
9429,1,骑驴大咖,2944,677,26,27,53,49.1%,53m
9429,2,[TZJ]LaoYang,2944,251,15,14,29,51.7%,19m
9429,3,桥畔花盅喧街,2944,278,11,11,22,50.0%,57m
9429,1,帕秋莉丶诺蕾姬,2944,250,9,6,15,60.0%,36m
9429,1,suadpan,2944,176,4,1,5,80.0%,1h
9429,2,灭蟑螂大队,2944,139,3,2,5,60.0%,25m
9429,1,男人就该干男人,2944,0,3,2,5,60.0%,20m
9429,2,superT,2944,60,3,3,6,50.0%,23m
9429,3,[AIS]颠倒世界,2944,97,3,5,8,37.5%,29m
9429,1,TuiSi,2944,68,3,6,9,33.3%,55m
9429,2,[秋梨膏]超凡入圣,2944,62,2,3,5,40.0%,25m
9429,2,[社会]枫钟同年,2944,88,2,3,5,40.0%,30m
9429,2,阔落加冰,2944,30,1,1,2,50.0%,21m
9429,2,[败中求败]小黑龙殷海健,2944,32,1,2,3,33.3%,27m
9429,1,Echo,2944,48,1,2,3,33.3%,11m
9446,2,魔猎,2943,511,27,20,47,57.4%,10m
9446,1,三千世界,2943,446,16,15,31,51.6%,24m
9446,2,[四叶草]小小小棠芫,2943,363,14,9,23,60.9%,25m
9446,2,萌萌小探机,2943,140,6,5,11,54.5%,38m
9446,2,[古明地嗪]ChariotC,2943,164,5,2,7,71.4%,25m
9446,2,[BGD]有点甜,2943,122,4,5,9,44.4%,14m
9446,2,[逆袭]死忠守护者,2943,66,3,0,3,100.0%,10m
9446,2,[谐谐谐莽莽莽]DevotionJHM,2943,90,3,5,8,37.5%,6m
9446,3,马官人,2943,32,2,0,2,100.0%,3m
9446,3,auir,2943,58,2,13,15,13.3%,20m
9446,2,菜鸡萌新,2943,0,1,1,2,50.0%,15m
9446,2,[暴雪嘉年华]小小土人,2943,0,0,1,1,0.0%,52m
9446,2,XxSKTxX,2943,0,0,3,3,0.0%,28m
9459,2,IIIIIIIIIIII,2942,1225,114,96,210,54.3%,28m
9459,1,[峡谷]西伯利亚雪橇犬,2942,1079,83,83,166,50.0%,14m
9459,2,[贪睡家族]小恶魔,2942,549,30,25,55,54.5%,53m
9459,3,[白给白给]Aerith,2942,451,29,29,58,50.0%,57m
9459,1,小丑,2942,492,16,16,32,50.0%,17m
9459,1,[真正萌新]星宫六喰,2942,516,16,20,36,44.4%,12m
9459,2,誓约胜利之剑,2942,184,9,6,15,60.0%,13m
9459,2,[PZHSC]Shine,2942,118,5,2,7,71.4%,21m
9459,1,[雾之湖红萌馆]铃仙,2942,0,3,2,5,60.0%,7m
9459,1,轻松玩游戏,2942,108,3,8,11,27.3%,8m
9459,3,[南京工业大学]二五仔尸沉西湖,2942,97,2,2,4,50.0%,1h
9459,2,[yjacks]llllxyr,2942,30,1,2,3,33.3%,16m
9459,2,[菊花神教]黑暗骑士,2942,30,1,2,3,33.3%,17m
9459,2,不朽攻城坦克,2942,0,0,1,1,0.0%,29m
9459,1,[加油呀]Armazi,2942,0,0,1,1,0.0%,52m
9459,2,人间四月天,2942,0,0,2,2,0.0%,27m
9475,1,偷家吃粑粑吧,2941,666,25,24,49,51.0%,16m
9475,2,[雾雨魔法森林]Eternity,2941,348,20,8,28,71.4%,21m
9475,2,托尼,2941,391,15,10,25,60.0%,17m
9475,1,此生只想上钻石,2941,424,13,14,27,48.1%,6m
9475,3,南传兄贵泰伦,2941,332,13,19,32,40.6%,5m
9475,1,田中宽肾,2941,252,9,9,18,50.0%,1h
9475,1,小付,2941,138,7,8,15,46.7%,25m
9475,3,一毛钱,2941,122,5,4,9,55.6%,1h
9475,1,Darklily,2941,0,3,2,5,60.0%,1h
9475,2,随便打打啊,2941,70,3,3,6,50.0%,16m
9475,3,宗师坟墓,2941,97,2,0,2,100.0%,5m
9475,2,[小鸡屠宰场3]蓝黑之殇,2941,32,2,2,4,50.0%,52m
9475,2,zipssss,2941,92,1,1,2,50.0%,1h
9475,1,戮神,2941,0,1,4,5,20.0%,24m
9475,1,[萌新集结地]沐风,2941,0,0,1,1,0.0%,1h
9490,1,[明教]爸爸,2940,1589,146,138,284,51.4%,23m
9490,1,keepon,2940,1271,124,126,250,49.6%,14m
9490,2,Evilkiller,2940,1610,95,59,154,61.7%,17m
9490,1,刮胡子,2940,1665,74,81,155,47.7%,23m
9490,2,Daoyun,2940,534,66,51,117,56.4%,24m
9490,2,[传说萌娘团]魂之挽歌,2940,647,27,17,44,61.4%,51m
9490,1,[神羽]秋神紫羽,2940,420,24,24,48,50.0%,6m
9490,2,大王,2940,375,13,11,24,54.2%,51m
9490,2,[兵库北大胜利]雨宫天,2940,271,12,4,16,75.0%,54m
9490,2,羚羊,2940,222,9,3,12,75.0%,52m
9490,1,llllllll,2940,220,9,6,15,60.0%,1h
9490,3,[马哥太强了]带带大主教,2940,231,8,4,12,66.7%,1h
9490,3,灵乌路空,2940,164,6,4,10,60.0%,1h
9490,2,星丶丶球杯,2940,118,5,1,6,83.3%,27m
9490,2,不习惯的习惯,2940,121,5,4,9,55.6%,52m
9490,1,[反转摸鱼]pig,2940,114,4,7,11,36.4%,22m
9490,2,TOSSterran,2940,182,4,12,16,25.0%,52m
9490,2,无所谓,2940,58,3,0,3,100.0%,21m
9490,3,梧叶飘黄,2940,97,3,6,9,33.3%,1h
9490,1,[xhwya]你吗嫁人啦,2940,0,1,0,1,100.0%,21m
9490,1,[尤格萨隆]CLOSED,2940,0,1,4,5,20.0%,31m
9490,2,Bloody,2940,0,0,1,1,0.0%,52m
9490,2,你的爸爸,2940,0,0,1,1,0.0%,19m
9490,2,[dd神教]神楽七奈,2940,0,0,1,1,0.0%,19m
9514,1,leged,2939,1168,300,283,583,51.5%,20m
9514,2,尘曦,2939,1613,158,141,299,52.8%,19m
9514,1,小成故事,2939,1404,81,72,153,52.9%,12m
9514,1,笑面佛,2939,702,46,47,93,49.5%,16m
9514,1,[黑粉头子]国产大长腿,2939,595,35,34,69,50.7%,55m
9514,2,白果,2939,222,18,17,35,51.4%,5m
9514,2,Ghostking,2939,410,14,12,26,53.8%,29m
9514,2,[残梦之忆]afaasfsa,2939,205,11,2,13,84.6%,1h
9514,3,ttabl,2939,266,10,10,20,50.0%,51m
9514,3,么哈么哈,2939,326,10,24,34,29.4%,20m
9514,1,Trap,2939,286,9,13,22,40.9%,29m
9514,3,[追随自由指引]行之,2939,186,9,13,22,40.9%,53m
9514,1,不怎么会玩啊,2939,0,3,2,5,60.0%,1h
9514,2,Toxic,2939,0,1,1,2,50.0%,11m
9514,2,九九离,2939,0,0,1,1,0.0%,10m
9514,2,[头很铁的萌新]PEANUT,2939,0,0,1,1,0.0%,27m
9514,2,爱吃小白兔的熊,2939,0,0,2,2,0.0%,54m
9514,2,[一统天下]fewooe,2939,0,0,3,3,0.0%,45m
9532,2,MeOwSirrr,2938,856,62,51,113,54.9%,11m
9532,1,[你的剑很美]sails,2938,541,52,34,86,60.5%,14m
9532,1,Angle,2938,1059,49,40,89,55.1%,57m
9532,2,ZHT,2938,745,37,24,61,60.7%,16m
9532,1,天命,2938,412,27,21,48,56.2%,20m
9532,3,llllllllllll,2938,456,22,33,55,40.0%,52m
9532,1,[深黑幻想]IIIIIIIIIIII,2938,344,13,9,22,59.1%,16m
9532,2,[小鸡屠宰场9]黑黑黑,2938,330,13,11,24,54.2%,53m
9532,2,[积水潭]Usawakiko,2938,370,12,10,22,54.5%,10m
9532,1,Zkao,2938,131,10,10,20,50.0%,7m
9532,2,Fate,2938,248,8,5,13,61.5%,6m
9532,1,一念天堂一念地狱,2938,261,8,10,18,44.4%,17m
9532,2,[北京大学鸡协]搜到我你已经涨了,2938,148,6,4,10,60.0%,52m
9532,2,[嘴宗]Terry,2938,122,5,5,10,50.0%,13m
9532,1,金甲三脚猫,2938,97,4,3,7,57.1%,1h
9532,3,纯乾三,2938,120,3,0,3,100.0%,1h
9532,1,淡漠雨眸,2938,0,3,1,4,75.0%,38m
9532,2,ASURAN,2938,58,2,1,3,66.7%,10m
9532,1,mylifefaiur,2938,96,2,5,7,28.6%,44m
9532,2,暗影之风暴,2938,30,1,3,4,25.0%,17m
9532,2,全自动沪口,2938,0,0,2,2,0.0%,54m
9553,2,[四叶草]IIIIIIIIIIII,2937,1359,134,128,262,51.1%,3m
9553,3,[教我玩神族]LaSiA,2937,1318,134,143,277,48.4%,6m
9553,2,哦呵呵的魔理沙,2937,1108,123,103,226,54.4%,3m
9553,1,[YA]llllllllllll,2937,1658,96,91,187,51.3%,31m
9553,1,[谈笑间灭你]我爱彪彪,2937,1373,77,62,139,55.4%,23m
9553,1,IIIIIIIIIIII,2937,287,21,18,39,53.8%,20m
9553,1,lllllllll,2937,582,19,25,44,43.2%,23m
9553,3,[HUC妖皇]运行者,2937,295,13,10,23,56.5%,6m
9553,2,GCL,2937,272,10,5,15,66.7%,25m
9553,1,[天青车道]hehedeyifang,2937,210,6,11,17,35.3%,9m
9553,1,[LOHs]黑暗圣坛,2937,188,5,5,10,50.0%,1h
9553,2,来自星星的哥哥,2937,30,2,0,2,100.0%,14m
9553,1,Mruglyy,2937,104,2,5,7,28.6%,27m
9553,2,[空虚门下]逆羽幻翎,2937,0,1,0,1,100.0%,19m
9553,3,艾米莉亚,2937,97,1,1,2,50.0%,1h
9553,2,呆呆的虫子,2937,30,1,2,3,33.3%,53m
9553,2,silverbottle,2937,0,0,1,1,0.0%,22m
9553,2,[盈盈一水间]MOYING,2937,0,0,1,1,0.0%,23m
9553,3,[正乂]SwanykPants,2937,0,0,2,2,0.0%,1h
9572,3,cbf,2936,1552,195,200,395,49.4%,26m
9572,2,Mercury,2936,1219,146,127,273,53.5%,15m
9572,2,银河泡面,2936,1312,78,68,146,53.4%,52m
9572,1,YYYYYYYYYQ,2936,1342,69,63,132,52.3%,14m
9572,1,[XCode]RammsteiNpro,2936,572,37,32,69,53.6%,6m
9572,2,[GANGAN]VISTA,2936,702,26,26,52,50.0%,52m
9572,1,[斩月]天下第一呆,2936,331,20,18,38,52.6%,30m
9572,1,绿豆薄荷冰,2936,491,20,23,43,46.5%,9m
9572,2,Darkrabbit,2936,408,16,14,30,53.3%,20m
9572,1,温瞳,2936,179,6,6,12,50.0%,55m
9572,2,[Asc2]power,2936,88,4,4,8,50.0%,20m
9572,3,[RPGBoY]儿子许杰,2936,151,3,12,15,20.0%,58m
9572,1,南美尼哥内马尔,2936,80,2,8,10,20.0%,14m
9572,3,提风,2936,0,1,1,2,50.0%,23m
9572,2,疯子大兵,2936,0,0,1,1,0.0%,23m
9587,1,阿尔兹格雷特,2935,1496,204,195,399,51.1%,17m
9587,2,为了艾尔,2935,1524,141,115,256,55.1%,13m
9587,3,夜深人静喝咖啡,2935,414,19,16,35,54.3%,7m
9587,2,天下武功出混元,2935,468,19,20,39,48.7%,10m
9587,1,[武纺星际切磋]darkfantasy,2935,621,19,23,42,45.2%,15m
9587,1,[oshima]neoooxx,2935,238,10,10,20,50.0%,54m
9587,1,luobo,2935,331,10,11,21,47.6%,8m
9587,2,犹豫就会败北,2935,198,7,3,10,70.0%,28m
9587,2,Rico,2935,210,7,7,14,50.0%,54m
9587,2,[手撕神人虫]酒后误杀丈母娘,2935,143,6,6,12,50.0%,1h
9587,1,fengyu,2935,0,3,2,5,60.0%,31m
9587,3,摸鱼真的好爽啊,2935,97,2,2,4,50.0%,1h
9587,1,roco,2935,0,2,4,6,33.3%,1h
9587,1,沐山岚,2935,0,2,4,6,33.3%,1h
9587,1,Suger,2935,103,2,5,7,28.6%,22m
9587,2,就是不想起用户名,2935,0,1,0,1,100.0%,52m
9587,1,kuyuer,2935,0,1,0,1,100.0%,30m
9587,2,[六骑]皮城阿斗斗,2935,30,1,1,2,50.0%,27m
9587,1,夏默丹竹,2935,44,1,2,3,33.3%,59m
9587,2,乳山小霸王,2935,30,1,4,5,20.0%,54m
9587,2,清纯玉女苍井空,2935,0,0,5,5,0.0%,30m
9608,2,桜泠雪汐,2934,623,36,8,44,81.8%,15m
9608,1,[咖啡Fans]NightQueen,2934,763,35,19,54,64.8%,27m
9608,2,小玲吃西瓜,2934,558,21,16,37,56.8%,5m
9608,2,大可,2934,404,14,13,27,51.9%,28m
9608,3,[星核纪]啊这,2934,123,6,8,14,42.9%,17m
9608,1,hope,2934,97,5,1,6,83.3%,1h
9608,3,Ring,2934,121,5,4,9,55.6%,1h
9608,1,霸气测漏,2934,127,4,14,18,22.2%,23m
9608,2,打不好也打,2934,0,1,2,3,33.3%,11m
9608,2,[毛笨加油啊]向左走,2934,93,1,3,4,25.0%,27m
9608,2,[江苏俱乐部]少年夜闯秋名山,2934,0,0,1,1,0.0%,25m
9608,2,风吹得我好惬意,2934,0,0,2,2,0.0%,19m
9620,3,lvan,2933,1515,131,121,252,52.0%,22m
9620,1,VVVVV,2933,1480,82,78,160,51.2%,22m
9620,3,风静静地吹,2933,1336,75,85,160,46.9%,58m
9620,3,十八分之一,2933,1124,45,45,90,50.0%,30m
9620,1,奥古斯都帕拉丁,2933,871,41,36,77,53.2%,9m
9620,1,[黄金战队]Forever,2933,986,38,40,78,48.7%,9m
9620,2,[XTE]Linux,2933,812,31,26,57,54.4%,25m
9620,1,[秋毫第五分队]Polaris,2933,600,27,27,54,50.0%,29m
9620,2,ball,2933,240,9,8,17,52.9%,13m
9620,2,枂晏,2933,216,8,3,11,72.7%,21m
9620,2,llllllllllll,2933,180,7,0,7,100.0%,17m
9620,2,汉室宗亲,2933,132,3,1,4,75.0%,30m
9620,3,ChookStalker,2933,120,3,2,5,60.0%,3m
9620,1,药饭的,2933,0,3,2,5,60.0%,55m
9620,1,snjwyj,2933,0,3,2,5,60.0%,1h
9620,2,kid,2933,60,2,3,5,40.0%,10m
9620,2,大威天龙孙一峰,2933,58,2,3,5,40.0%,17m
9620,2,不觉流水年长,2933,0,0,1,1,0.0%,21m
9638,1,MixTokYoHoT,2932,889,140,136,276,50.7%,54m
9638,1,gaobiao,2932,1357,80,70,150,53.3%,29m
9638,1,晓予,2932,1425,75,67,142,52.8%,54m
9638,2,ReinHard,2932,446,19,17,36,52.8%,21m
9638,2,飞龙骑脸怎么输,2932,134,5,0,5,100.0%,10m
9638,1,[1939CN]乐高呆高乐,2932,189,5,6,11,45.5%,56m
9638,1,TifaTsubasa,2932,110,4,9,13,30.8%,6m
9638,2,[整个活]蒙斯克,2932,113,2,1,3,66.7%,58m
9638,2,[loveMM]陈紫莹,2932,0,1,0,1,100.0%,52m
9638,2,reality,2932,0,1,0,1,100.0%,16m
9638,2,[小狐狸]电波波波酱嘤嘤嘤,2932,30,1,1,2,50.0%,53m
9638,3,Sin,2932,0,1,2,3,33.3%,32m
9638,2,开心就好,2932,0,0,1,1,0.0%,24m
9651,1,除却巫山不是云,2931,622,59,51,110,53.6%,9m
9651,2,佩罗罗琪可,2931,828,33,26,59,55.9%,27m
9651,1,[2V2是沙雕]丁丁拉拉迪茜波,2931,539,30,30,60,50.0%,23m
9651,2,[DHT]怪兽河,2931,494,20,11,31,64.5%,52m
9651,2,[洁白之巅]瑞哥周,2931,452,18,15,33,54.5%,3m
9651,2,JasonGan,2931,439,16,11,27,59.3%,15m
9651,2,辣味女警黄小色,2931,341,12,8,20,60.0%,19m
9651,2,佳宁,2931,238,9,3,12,75.0%,29m
9651,2,[霸气雄图]小小呆,2931,258,9,11,20,45.0%,26m
9651,3,绫音,2931,213,9,15,24,37.5%,28m
9651,2,[查尔之矛]IIIIIIIIIIII,2931,226,8,3,11,72.7%,24m
9651,1,[南京工业大学]chenhu,2931,169,5,13,18,27.8%,9m
9651,1,[孙換家]我爱小诗诗,2931,48,4,3,7,57.1%,1h
9651,1,江城无敌,2931,117,4,3,7,57.1%,1h
9651,2,Shuaiigou,2931,120,4,5,9,44.4%,24m
9651,2,长命百岁苏沐秋,2931,98,3,4,7,42.9%,23m
9651,1,[聚变打击]跟你拼啦,2931,40,3,6,9,33.3%,57m
9651,2,杰克鸡,2931,30,2,0,2,100.0%,28m
9651,1,killbest,2931,0,1,0,1,100.0%,55m
9651,3,SAKURAQAQ,2931,97,1,3,4,25.0%,1h
9651,2,善待萌新我是萌新,2931,0,0,1,1,0.0%,53m
9651,2,[C33856]赵三湾银枪小霸王,2931,0,0,4,4,0.0%,9m
9673,3,RAINY,2930,1427,139,129,268,51.9%,58m
9673,2,符大大,2930,1598,74,62,136,54.4%,13m
9673,1,[地雷军团]弯刀,2930,1364,72,68,140,51.4%,16m
9673,2,传国灬玺,2930,1198,49,43,92,53.3%,5m
9673,3,Lemon,2930,832,28,38,66,42.4%,5m
9673,1,拱火天王黄旭东,2930,461,27,33,60,45.0%,30m
9673,1,小少,2930,409,15,12,27,55.6%,9m
9673,1,凛冬,2930,142,5,4,9,55.6%,10m
9673,2,SeeYou,2930,114,4,3,7,57.1%,51m
9673,1,小源源,2930,97,4,3,7,57.1%,1h
9673,2,灭骨达黑,2930,140,3,1,4,75.0%,7m
9673,2,丿丶想你灬永不变,2930,54,3,2,5,60.0%,53m
9673,2,nowato,2930,0,3,2,5,60.0%,1h
9673,3,凸凸找凹凹,2930,147,3,7,10,30.0%,57m
9673,2,[FKers]PatLethal,2930,30,1,1,2,50.0%,22m
9673,1,[鸽子六发]欧阳琛,2930,0,1,4,5,20.0%,17m
9673,3,简单电脑,2930,93,1,10,11,9.1%,20m
9690,3,wuyuan,2929,1573,198,191,389,50.9%,12m
9690,3,Paul,2929,524,178,181,359,49.6%,14m
9690,1,llllllllllll,2929,393,82,71,153,53.6%,53m
9690,1,是男人就来干,2929,609,19,20,39,48.7%,20m
9690,2,MagicTerran,2929,304,11,6,17,64.7%,16m
9690,2,lyy,2929,321,11,6,17,64.7%,16m
9690,1,llllllllll,2929,248,11,14,25,44.0%,22m
9690,1,Melt,2929,338,11,17,28,39.3%,56m
9690,2,seeds,2929,265,8,7,15,53.3%,13m
9690,3,[荣耀武士团]保存者吉尔伯特,2929,179,7,6,13,53.8%,15m
9690,2,银月幻影,2929,154,5,4,9,55.6%,29m
9690,1,zzy,2929,142,4,2,6,66.7%,1h
9690,2,[重理工]Statz,2929,100,4,4,8,50.0%,20m
9690,1,BLACKCAT,2929,74,3,6,9,33.3%,20m
9690,1,[北京城管]一只翻滚的爆爆虫,2929,96,2,0,2,100.0%,10m
9690,2,[NsfzSc]Rual,2929,58,2,4,6,33.3%,31m
9690,2,NOGAMENOLIFE,2929,0,1,0,1,100.0%,19m
9690,2,VashMX,2929,0,0,1,1,0.0%,52m
9690,2,神华降临,2929,0,0,1,1,0.0%,52m
9690,1,无叶樱,2929,0,0,2,2,0.0%,1h
9710,1,tmzhoupeng,2928,992,109,106,215,50.7%,55m
9710,1,SourBanana,2928,1638,95,97,192,49.5%,20m
9710,1,[Fiend]SonicMaster,2928,1283,71,61,132,53.8%,23m
9710,3,[养生会馆]世界核平,2928,1453,71,83,154,46.1%,55m
9710,1,KKKKKKK,2928,876,32,32,64,50.0%,20m
9710,1,[吕布女团]灿烂星空,2928,356,15,17,32,46.9%,12m
9710,2,奋斗不止的老张,2928,174,6,2,8,75.0%,31m
9710,2,Hydrogen,2928,152,5,6,11,45.5%,19m
9710,2,老鹰,2928,66,3,5,8,37.5%,22m
9710,3,夜闖峨嵋山,2928,116,2,2,4,50.0%,6m
9710,1,酒中仙灬,2928,0,1,0,1,100.0%,44m
9710,1,SOUL,2928,0,1,4,5,20.0%,22m
9710,2,Dopa,2928,0,0,1,1,0.0%,15m
9710,2,安静生活,2928,0,0,2,2,0.0%,58m
9710,1,星际争霸,2928,0,0,5,5,0.0%,29m
9725,2,听叶,2927,1599,102,91,193,52.8%,17m
9725,2,perflover,2927,219,87,56,143,60.8%,10m
9725,1,大王毛茸茸,2927,1020,77,66,143,53.8%,24m
9725,3,[BG]你的屁屁嘿嘿,2927,915,62,72,134,46.3%,6m
9725,2,shidianyanlu,2927,281,17,4,21,81.0%,10m
9725,2,[德国骨科]六月很忙,2927,258,10,8,18,55.6%,31m
9725,1,JustPlay,2927,328,10,16,26,38.5%,8m
9725,2,[XXHZN2]沈哥是你跌,2927,0,3,2,5,60.0%,42m
9725,2,有空一起拉翔,2927,38,2,4,6,33.3%,27m
9725,2,[姬汁]么么哒,2927,42,2,8,10,20.0%,1h
9725,2,[坎星宇航局]Proxima,2927,0,1,0,1,100.0%,25m
9725,2,[我是一只机]古道,2927,0,1,0,1,100.0%,10m
9725,2,[虚空守望]埃罗芒老师,2927,0,1,1,2,50.0%,51m
9725,2,永远寂寞的小远,2927,30,1,2,3,33.3%,12m
9725,2,ANAANA,2927,34,1,2,3,33.3%,22m
9725,1,lllllllll,2927,0,1,6,7,14.3%,23m
9725,2,RWBY,2927,0,0,1,1,0.0%,17m
9725,2,浊酒一杯温如言,2927,0,0,1,1,0.0%,54m
9725,2,roy,2927,0,0,1,1,0.0%,11m
9725,1,嗨呀,2927,0,0,1,1,0.0%,55m
9725,3,[一路有你]西雅图,2927,0,0,4,4,0.0%,22m
9746,2,月亮井常住宅,2926,729,160,186,346,46.2%,12m
9746,1,[星之所在RI]StarFish,2926,1048,48,48,96,50.0%,23m
9746,1,人肉打桩机,2926,462,17,17,34,50.0%,3m
9746,2,老瞎眼,2926,376,13,10,23,56.5%,23m
9746,2,小鸡抓老鹰,2926,364,13,11,24,54.2%,54m
9746,3,风月丿花鸟,2926,121,6,3,9,66.7%,1h
9746,2,[星歌]星咕咕咕咕咕,2926,130,3,1,4,75.0%,30m
9746,2,[陪我闹]飒冥,2926,0,3,2,5,60.0%,25m
9746,1,[瘾大眼瞎]warframe,2926,34,2,5,7,28.6%,21m
9746,2,[龙眠山下的猫]king,2926,34,1,1,2,50.0%,10m
9746,2,ASKJ,2926,0,0,1,1,0.0%,28m
9746,2,SuperNova,2926,0,0,1,1,0.0%,19m
9746,2,[注意防守]幽灵公爵,2926,0,0,1,1,0.0%,10m
9759,1,小菜鸡,2925,550,85,88,173,49.1%,15m
9759,1,Djcj,2925,1259,52,46,98,53.1%,3m
9759,2,Teardrop,2925,1143,47,41,88,53.4%,29m
9759,1,wolf,2925,584,22,20,42,52.4%,6m
9759,2,zhifu,2925,328,21,9,30,70.0%,14m
9759,1,caisss,2925,354,17,14,31,54.8%,20m
9759,1,PrincecessZZ,2925,390,13,12,25,52.0%,12m
9759,2,SilverAsh,2925,218,9,2,11,81.8%,28m
9759,1,[HFUOT]叫什么好呢,2925,119,5,3,8,62.5%,1h
9759,2,[GOTAL]你最厉害了,2925,144,5,5,10,50.0%,51m
9759,1,[小鸡屠宰场7]霜之刃,2925,170,5,7,12,41.7%,23m
9759,2,孤独巡礼,2925,120,4,5,9,44.4%,29m
9759,2,cqs,2925,91,2,2,4,50.0%,55m
9759,2,狂刀三浪,2925,0,2,3,5,40.0%,49m
9759,2,亮亮,2925,0,1,0,1,100.0%,52m
9759,2,[透一下清酒]我好聪明,2925,0,0,1,1,0.0%,27m
9759,2,[嘶哈]全部杀掉,2925,0,0,2,2,0.0%,28m
9776,2,MengDetong,2924,1087,46,35,81,56.8%,26m
9776,1,Ttrash,2924,629,27,23,50,54.0%,8m
9776,1,[浪啊浪]logo,2924,522,24,18,42,57.1%,16m
9776,2,[Shawk]dark,2924,379,19,11,30,63.3%,5m
9776,2,凹凸曼,2924,332,13,6,19,68.4%,52m
9776,2,Gifty,2924,212,9,6,15,60.0%,1h
9776,3,爷傲丿奈我何,2924,208,8,7,15,53.3%,1h
9776,2,Hades,2924,118,5,4,9,55.6%,28m
9776,1,[SCL]小辉,2924,182,5,13,18,27.8%,54m
9776,2,Infirm,2924,114,4,5,9,44.4%,19m
9776,3,[s黑色玫瑰s]人头无限好只是死,2924,145,4,11,15,26.7%,59m
9776,2,[盲人集散中心]浮云真多,2924,0,3,2,5,60.0%,9m
9776,2,除非包吃包住,2924,37,2,4,6,33.3%,55m
9776,2,[韩湾土锤搬家]YueChuNexus,2924,60,2,5,7,28.6%,29m
9776,2,[你在看nm呢]这游戏真好玩,2924,0,1,0,1,100.0%,28m
9776,2,黑暗森林,2924,0,1,0,1,100.0%,52m
9776,2,[NICOS]欧派,2924,0,1,2,3,33.3%,25m
9776,2,TZC,2924,0,0,2,2,0.0%,25m
9776,2,李家安逸,2924,0,0,4,4,0.0%,1h
9795,3,[StarG]Doveld,2923,1540,184,184,368,50.0%,5m
9795,2,asd,2923,630,101,87,188,53.7%,52m
9795,2,qszxde,2923,384,16,5,21,76.2%,10m
9795,2,江南狗王孙一峰,2923,292,15,2,17,88.2%,23m
9795,1,洛梵天丶,2923,165,3,1,4,75.0%,1h
9795,2,CounTingsTar,2923,0,3,2,5,60.0%,5m
9795,1,专家电脑,2923,97,3,4,7,42.9%,1h
9795,2,神枪手,2923,118,2,1,3,66.7%,29m
9795,2,桐叶,2923,30,2,3,5,40.0%,26m
9795,2,ProTossgo,2923,0,1,0,1,100.0%,28m
9795,1,[审判者]瞄之恋,2923,0,1,0,1,100.0%,1h
9795,1,[上帝的叹息]邪王真眼是最强的,2923,0,1,0,1,100.0%,51m
9795,1,[Rhusky]不巧者,2923,0,1,0,1,100.0%,10m
9795,2,化身孤岛的鲸,2923,30,1,2,3,33.3%,53m
9795,2,Chronic,2923,0,0,1,1,0.0%,52m
9810,3,福建任贤齐,2922,939,192,193,385,49.9%,13m
9810,1,放开我队友冲我来,2922,1548,101,79,180,56.1%,54m
9810,3,我喜欢偷哦,2922,1512,101,120,221,45.7%,17m
9810,2,[白给不要钱]乌鸦落在猪身上,2922,1465,59,51,110,53.6%,11m
9810,1,[Solo]SoloEmyth,2922,859,30,36,66,45.5%,14m
9810,2,孤殇,2922,293,11,5,16,68.8%,11m
9810,2,Ambidler,2922,231,9,8,17,52.9%,15m
9810,1,Magicka,2922,260,9,8,17,52.9%,8m
9810,2,[星际超快乐]夏洛克暴揍华生,2922,122,8,2,10,80.0%,13m
9810,2,[TZimba]為艾爾而生,2922,177,7,8,15,46.7%,1h
9810,2,[Mariss]毅童年,2922,100,3,4,7,42.9%,13m
9810,2,黑霘,2922,58,3,5,8,37.5%,30m
9810,1,一米,2922,48,2,3,5,40.0%,51m
9810,2,战神,2922,0,1,6,7,14.3%,1h
9810,2,Elysion,2922,0,0,1,1,0.0%,52m
9810,2,[萌萌哒战团]xinling,2922,0,0,1,1,0.0%,52m
9826,2,[CPT]ZHUJIAO,2921,1030,37,38,75,49.3%,10m
9826,2,[IMRTS]星一,2921,348,16,5,21,76.2%,14m
9826,1,卡卡罗特,2921,314,8,12,20,40.0%,22m
9826,2,[浮世清欢]Rollyoo,2921,205,6,6,12,50.0%,52m
9826,2,天极,2921,146,5,5,10,50.0%,38m
9826,2,老二刺猿,2921,96,4,2,6,66.7%,11m
9826,2,[Shawk]Vinikk,2921,94,4,2,6,66.7%,56m
9826,2,[他是个老人]IIIIIIIIIIII,2921,128,4,16,20,20.0%,10m
9826,2,without,2921,30,2,1,3,66.7%,35m
9826,2,李泽言,2921,0,1,0,1,100.0%,5m
9826,2,Tsum,2921,0,1,2,3,33.3%,9m
9826,2,被感染的探姬,2921,0,0,1,1,0.0%,15m
9826,2,伟大的神皇,2921,0,0,2,2,0.0%,16m
9839,3,[初音守护二队]云静天空,2920,1222,117,131,248,47.2%,55m
9839,3,SSSSSS,2920,698,101,94,195,51.8%,51m
9839,3,祈求者,2920,1274,51,50,101,50.5%,56m
9839,1,鸡蟹话硬刚,2920,784,30,27,57,52.6%,12m
9839,2,guardianxp,2920,620,23,22,45,51.1%,31m
9839,1,[大新闻记者]RecCy,2920,614,21,25,46,45.7%,14m
9839,2,[司马恒星]IIIIIIIIIIII,2920,291,12,5,17,70.6%,52m
9839,1,[M8]cavaliersile,2920,196,9,6,15,60.0%,24m
9839,2,[纳兰皇族]让天使破碎,2920,241,9,8,17,52.9%,1h
9839,2,星际争霸,2920,210,7,5,12,58.3%,18m
9839,3,怒火,2920,166,6,4,10,60.0%,1h
9839,2,小好丶,2920,144,6,6,12,50.0%,30m
9839,1,[星舟环宇]Yondar,2920,48,4,3,7,57.1%,30m
9839,2,不是很快乐,2920,150,4,3,7,57.1%,26m
9839,2,条码人,2920,60,3,1,4,75.0%,28m
9839,2,寒江,2920,0,2,1,3,66.7%,9m
9839,1,zombie,2920,117,2,1,3,66.7%,53m
9839,2,萌新别欺负我,2920,0,2,2,4,50.0%,1h
9839,2,聊天室忠实用户,2920,0,1,1,2,50.0%,1h
9839,2,我很好但我不温柔,2920,36,1,3,4,25.0%,30m
9839,2,[邪恶化身]呵呵哈嘿,2920,0,0,1,1,0.0%,27m
9860,1,cxs,2919,551,22,20,42,52.4%,20m
9860,2,[91二五仔]轰鸣之翼,2919,462,20,22,42,47.6%,10m
9860,2,我不讲武德,2919,482,19,14,33,57.6%,52m
9860,1,Birozhki,2919,294,12,9,21,57.1%,24m
9860,2,末日咒夜,2919,368,11,31,42,26.2%,27m
9860,2,哦列哇可挖诺噶,2919,243,10,6,16,62.5%,12m
9860,1,[疯狂掉分]zlxyxs,2919,238,8,10,18,44.4%,8m
9860,2,瓜大侠,2919,171,6,3,9,66.7%,21m
9860,2,[SCFFFF]zez,2919,116,4,5,9,44.4%,53m
9860,1,人类先锋,2919,141,4,6,10,40.0%,12m
9860,2,古怪之裤子,2919,58,3,1,4,75.0%,18m
9860,2,未知灬伤痛,2919,0,3,2,5,60.0%,60m
9860,2,[彡暁弎彡鞺灘]SCPLAYER,2919,51,3,3,6,50.0%,20m
9860,2,[心如死灰]stats,2919,96,3,7,10,30.0%,25m
9860,2,马斯克,2919,30,2,1,3,66.7%,13m
9860,2,TrailblazerL,2919,112,2,1,3,66.7%,13m
9860,2,钢茎侠,2919,30,2,2,4,50.0%,8m
9860,2,WWcr,2919,0,1,0,1,100.0%,52m
9860,2,[死亡收割]怪叔叔,2919,0,1,1,2,50.0%,13m
9860,2,酱油鸽子,2919,30,1,1,2,50.0%,30m
9860,2,[为谁而忧伤]ScHoOL,2919,0,0,1,1,0.0%,10m
9860,1,[萝莉保护会]陌璃,2919,0,0,1,1,0.0%,1h
9860,1,艾尔之咒,2919,0,0,2,2,0.0%,1h
9883,2,不帅朝脸踹,2918,1318,68,66,134,50.7%,10m
9883,2,[鸡猪]我就是死肥宅啊,2918,340,15,7,22,68.2%,30m
9883,3,破碎星辰,2918,68,14,17,31,45.2%,16m
9883,3,[鹌鹑带星]一朵小花,2918,244,12,12,24,50.0%,16m
9883,1,panic,2918,360,12,15,27,44.4%,24m
9883,1,僵尸黄皇,2918,191,11,3,14,78.6%,8m
9883,2,小风,2918,292,11,9,20,55.0%,21m
9883,2,[艾尔高等星灵]影之梦魇,2918,238,8,3,11,72.7%,56m
9883,1,[Ogiso1]ChampionTrap,2918,245,8,6,14,57.1%,1h
9883,1,[Marry]阿塔尼斯,2918,296,8,16,24,33.3%,20m
9883,3,要你命一万,2918,212,7,6,13,53.8%,30m
9883,3,[绫音后援团]咲夜绫音,2918,173,5,3,8,62.5%,14m
9883,1,Choice,2918,145,5,4,9,55.6%,1h
9883,2,[一针见血]Demon,2918,122,5,6,11,45.5%,10m
9883,2,[轴心最高议会]xujiaxu,2918,150,4,2,6,66.7%,16m
9883,2,夜雨声烦,2918,86,4,2,6,66.7%,21m
9883,2,十八停之后,2918,166,4,3,7,57.1%,13m
9883,1,Seniafiled,2918,119,4,4,8,50.0%,1h
9883,2,satiety,2918,122,4,8,12,33.3%,5m
9883,1,April,2918,122,3,5,8,37.5%,55m
9883,1,无从下手,2918,0,1,0,1,100.0%,1h
9883,2,prince,2918,0,1,0,1,100.0%,22m
9883,2,[无魂之鸭]mck,2918,0,1,1,2,50.0%,26m
9883,2,[GateX]CXT,2918,0,0,2,2,0.0%,28m
9907,3,快乐玩儿神族,2917,608,53,62,115,46.1%,28m
9907,1,[13love]MAKISAMA,2917,871,34,28,62,54.8%,23m
9907,3,我听见虚空的低语,2917,456,24,32,56,42.9%,6m
9907,2,[谁在呼叫舰队]大和炮正在干蠢狼,2917,432,21,6,27,77.8%,25m
9907,2,traveler,2917,364,18,15,33,54.5%,53m
9907,1,[bldm]abeisc,2917,414,16,10,26,61.5%,17m
9907,1,Michael,2917,280,10,9,19,52.6%,26m
9907,2,斯诺达科斯,2917,202,8,2,10,80.0%,54m
9907,1,菜的真实,2917,187,8,2,10,80.0%,1h
9907,2,飙马野郎老乔尼,2917,132,6,5,11,54.5%,34m
9907,3,kim,2917,172,6,5,11,54.5%,29m
9907,1,Eosee,2917,135,5,3,8,62.5%,7m
9907,2,[一块晶化瓦斯]西野七濑,2917,86,4,4,8,50.0%,26m
9907,2,iamkingsun,2917,0,3,2,5,60.0%,1h
9907,1,wwords,2917,48,2,1,3,66.7%,27m
9907,2,EnTaroMyself,2917,0,2,3,5,40.0%,47m
9907,3,一颗星星变了心,2917,0,2,5,7,28.6%,22m
9907,2,moliyo,2917,30,1,3,4,25.0%,11m
9907,2,[堕天使之翼]堕落的天使,2917,0,0,1,1,0.0%,6m
9907,2,[CPT]小叮当,2917,0,0,1,1,0.0%,3m
9907,1,IIIIIIIIIII,2917,0,0,1,1,0.0%,1h
9928,2,Ayanami,2916,1542,72,70,142,50.7%,13m
9928,2,ROxxxE,2916,969,55,48,103,53.4%,23m
9928,2,神奇的嘤嘤怪,2916,657,25,21,46,54.3%,21m
9928,2,ChinaDragon,2916,529,22,18,40,55.0%,25m
9928,1,翔宇战神,2916,606,19,24,43,44.2%,55m
9928,2,[周婉馨]馨儿,2916,126,10,17,27,37.0%,53m
9928,1,[最菜战队]easss,2916,202,7,13,20,35.0%,23m
9928,2,興趣使然的萌新,2916,148,6,4,10,60.0%,5m
9928,1,[s黑色玫瑰s]苏奇妙,2916,0,5,1,6,83.3%,38m
9928,2,铲车人领袖,2916,0,3,2,5,60.0%,1h
9928,2,杜祥明,2916,0,3,2,5,60.0%,16m
9928,1,星辰,2916,131,3,6,9,33.3%,17m
9928,3,[OwenSS]凝云未散,2916,58,3,7,10,30.0%,16m
9928,1,Midsolo,2916,0,1,0,1,100.0%,10m
9928,2,[抱舔天物]以沫的夏天,2916,0,0,1,1,0.0%,19m
9943,1,errrwwrr,2915,1651,239,228,467,51.2%,55m
9943,3,[holyhp]GGooo,2915,901,65,55,120,54.2%,30m
9943,1,隔壁老王,2915,484,19,21,40,47.5%,8m
9943,1,虚夜,2915,441,16,20,36,44.4%,15m
9943,1,愤怒绵羊,2915,396,12,18,30,40.0%,14m
9943,3,电竞毒瘤柯震东,2915,168,8,4,12,66.7%,1h
9943,3,wsnbb,2915,196,8,6,14,57.1%,1h
9943,3,[伢伢乐]堕天使,2915,0,4,4,8,50.0%,6m
9943,2,储浩,2915,0,3,2,5,60.0%,43m
9943,2,Deathscy,2915,80,3,6,9,33.3%,38m
9943,2,uglyProtess,2915,0,1,0,1,100.0%,25m
9943,1,[shana]三族统领随机娜,2915,0,1,0,1,100.0%,1h
9943,1,IIIIII,2915,0,0,1,1,0.0%,1h
9943,2,[NTUSL]忍者叉烧龟,2915,0,0,1,1,0.0%,16m
9943,2,桜花咲,2915,0,0,3,3,0.0%,36m
9958,3,唯爱轩,2914,1506,1118,1063,2181,51.3%,51m
9958,2,天际的家,2914,1125,209,193,402,52.0%,11m
9958,1,虾米,2914,1532,63,58,121,52.1%,8m
9958,1,[太微玉清宫]虚竹,2914,804,52,55,107,48.6%,31m
9958,1,[荆楚]plugins,2914,669,21,27,48,43.8%,23m
9958,2,[超实验级的]IIIIIIIIIIII,2914,452,19,9,28,67.9%,52m
9958,2,宇咒,2914,427,17,12,29,58.6%,8m
9958,2,莲华,2914,236,11,6,17,64.7%,1h
9958,2,leiaihui,2914,245,10,5,15,66.7%,29m
9958,1,鱼香肉丝来啦,2914,332,10,13,23,43.5%,31m
9958,2,JACKEY,2914,145,4,0,4,100.0%,1h
9958,2,金刚芭比宋小宝,2914,107,4,0,4,100.0%,16m
9958,3,天道,2914,97,4,4,8,50.0%,55m
9958,2,[Boeing]OHyes,2914,120,4,7,11,36.4%,25m
9958,2,南风慕羽,2914,101,3,1,4,75.0%,16m
9958,2,Eromanga,2914,0,3,2,5,60.0%,57m
9958,2,modeo,2914,0,2,3,5,40.0%,1h
9958,2,VanGuard,2914,0,1,0,1,100.0%,19m
9958,3,[植物大战僵尸]小绝,2914,30,1,6,7,14.3%,27m
9958,3,优势了就要送一波,2914,0,0,1,1,0.0%,49m
9978,2,[SS天煞]阿天,2913,1630,337,321,658,51.2%,22m
9978,2,追猎之魂,2913,1220,57,48,105,54.3%,15m
9978,1,咆哮的耳朵,2913,391,42,32,74,56.8%,29m
9978,1,枫雪煜悦,2913,856,29,33,62,46.8%,20m
9978,2,苦逼的平民,2913,310,26,21,47,55.3%,30m
9978,1,IIIIIIII,2913,527,17,20,37,45.9%,27m
9978,2,deathmagic,2913,256,10,9,19,52.6%,10m
9978,1,丨丨丨丨丨丨丨丨,2913,304,9,17,26,34.6%,17m
9978,2,血战沙场胜者为王,2913,205,8,6,14,57.1%,58m
9978,3,SKTIIISAMUAL,2913,64,6,5,11,54.5%,5m
9978,1,[社会性死亡]CTAC,2913,46,4,3,7,57.1%,1h
9978,2,SKT,2913,0,3,2,5,60.0%,28m
9978,2,pigegg,2913,66,2,4,6,33.3%,10m
9978,2,艾尔之子,2913,0,1,0,1,100.0%,53m
9978,2,条码人,2913,32,1,5,6,16.7%,10m
9978,2,[XXHZ30]良辰美景圣君,2913,0,0,2,2,0.0%,12m
9994,1,Cheng,2912,928,36,32,68,52.9%,14m
9994,2,CROW,2912,349,20,13,33,60.6%,27m
9994,2,Valentines,2912,327,14,12,26,53.8%,16m
9994,2,llllllllllll,2912,90,10,11,21,47.6%,11m
9994,2,[装大佬的鸡]红白故人,2912,116,4,0,4,100.0%,29m
9994,2,Crotchet,2912,0,4,1,5,80.0%,1h
9994,2,eyreray,2912,116,4,5,9,44.4%,5m
9994,2,[艰难电脑]光羽,2912,58,3,1,4,75.0%,25m
9994,1,jinkela,2912,0,3,3,6,50.0%,22m
9994,2,FGY,2912,0,2,3,5,40.0%,12m
9994,2,tao,2912,0,1,0,1,100.0%,16m
9994,2,[模拟电子技术]稳定大师奈奎斯特,2912,0,0,1,1,0.0%,14m
9994,1,KFC,2912,0,0,2,2,0.0%,38m
10007,2,xiaozhe,2911,971,126,106,232,54.3%,52m
10007,2,[blacko]我终成了你的故事,2911,1524,115,98,213,54.0%,8m
10007,2,AAA,2911,781,31,24,55,56.4%,3m
10007,2,sillyTong,2911,694,25,23,48,52.1%,54m
10007,2,[鸡王争爸]天国神曲,2911,521,20,16,36,55.6%,16m
10007,2,zealot,2911,323,13,13,26,50.0%,14m
10007,1,俺有三十公分,2911,259,12,8,20,60.0%,24m
10007,2,槿月巷,2911,138,3,2,5,60.0%,54m
10007,1,Bing,2911,0,3,3,6,50.0%,38m
10007,2,[香辣蟹]Gusabary,2911,30,2,0,2,100.0%,52m
10007,1,[四叶草]王霸巴,2911,97,2,1,3,66.7%,1h
10007,2,ccac,2911,112,2,1,3,66.7%,52m
10007,2,大白菜,2911,0,1,3,4,25.0%,21m
10007,2,[雾雨魔法森林]喜欢蕾米的芙兰,2911,0,0,1,1,0.0%,10m
10021,2,[可口稽饲料]KFJ,2910,734,32,22,54,59.3%,13m
10021,1,zaqx,2910,567,24,19,43,55.8%,55m
10021,2,MISSHY,2910,294,12,13,25,48.0%,23m
10021,1,黯然销魂者,2910,141,6,3,9,66.7%,1h
10021,2,zhdalao,2910,38,6,4,10,60.0%,16m
10021,2,在半路,2910,182,5,4,9,55.6%,16m
10021,1,[HFUOT]coldjun,2910,96,5,5,10,50.0%,10m
10021,2,可爱的蓝孩纸丶,2910,0,3,2,5,60.0%,1h
10021,2,Lewes,2910,0,3,2,5,60.0%,1h
10021,2,朋友过两招不,2910,30,2,1,3,66.7%,51m
10021,2,[新月]Joker,2910,0,1,0,1,100.0%,16m
10021,2,最爱打气球,2910,0,1,0,1,100.0%,12m
10021,2,相汝仆园,2910,0,1,1,2,50.0%,30m
10021,3,STlihua,2910,0,1,2,3,33.3%,1h
10021,1,qianli,2910,0,0,1,1,0.0%,38m
10021,2,打个游戏真难,2910,0,0,1,1,0.0%,13m
10037,3,McLAREM,2909,1330,155,160,315,49.2%,10m
10037,1,安娜塞利娅,2909,1644,140,138,278,50.4%,6m
10037,2,[马氏太极拳]MoonKesin,2909,906,41,32,73,56.2%,26m
10037,1,flanker,2909,411,33,37,70,47.1%,30m
10037,2,逆言,2909,520,20,13,33,60.6%,14m
10037,2,[龙腾九天]白给人皇李培楠,2909,392,15,17,32,46.9%,19m
10037,2,dalejj,2909,282,10,8,18,55.6%,58m
10037,2,魔法小侏儒,2909,230,8,8,16,50.0%,52m
10037,2,WAR,2909,118,5,5,10,50.0%,27m
10037,2,[孤傲就完事]iiiiiiiiiii,2909,154,5,6,11,45.5%,25m
10037,1,战神丨风云,2909,46,4,3,7,57.1%,31m
10037,2,wendid,2909,70,4,7,11,36.4%,5m
10037,2,ymy,2909,0,3,2,5,60.0%,1h
10037,2,九日星辰,2909,0,3,2,5,60.0%,49m
10037,1,星际迷航记,2909,0,1,0,1,100.0%,51m
10037,3,[舰队训练营]Lancerlot,2909,0,1,0,1,100.0%,1h
10037,1,完美风暴,2909,0,1,0,1,100.0%,1h
10037,2,零海,2909,0,1,2,3,33.3%,13m
10037,2,[辉煌灬时代]冉无叡,2909,30,1,4,5,20.0%,13m
10037,1,两眼一闭补农民,2909,0,0,3,3,0.0%,14m
10057,1,[爆杀]紫荆茶天,2908,1004,57,41,98,58.2%,12m
10057,3,[我大哥孙一峰]内鬼之王,2908,697,43,39,82,52.4%,55m
10057,2,sugarhe,2908,970,40,37,77,51.9%,11m
10057,2,GCKIssA,2908,538,19,17,36,52.8%,9m
10057,2,达死你,2908,424,16,14,30,53.3%,25m
10057,2,Snake,2908,304,14,12,26,53.8%,28m
10057,2,月夜风,2908,354,13,9,22,59.1%,21m
10057,3,菜王,2908,403,13,21,34,38.2%,28m
10057,2,小七,2908,164,9,5,14,64.3%,1h
10057,2,藐视群雄,2908,92,4,3,7,57.1%,12m
10057,2,城爸爸,2908,0,3,2,5,60.0%,58m
10057,2,溢出彼岸,2908,0,3,2,5,60.0%,41m
10057,1,ACMKTT,2908,0,3,3,6,50.0%,14m
10057,2,[四叶草]加冰流,2908,60,3,4,7,42.9%,35m
10057,2,冷凛西,2908,0,1,0,1,100.0%,28m
10057,2,llllllllllll,2908,0,1,0,1,100.0%,22m
10057,2,Rainbow,2908,30,1,1,2,50.0%,25m
10057,2,QuanTum,2908,92,1,3,4,25.0%,1h
10057,2,帝麒麟,2908,0,0,1,1,0.0%,21m
10057,3,戊烷,2908,0,0,1,1,0.0%,1h
10057,2,[DNF]禁忌,2908,0,0,1,1,0.0%,52m
10078,3,肛正不畸,2907,1451,125,107,232,53.9%,5m
10078,2,[集美大学]集美孙一峰,2907,1358,65,52,117,55.6%,35m
10078,1,天冬氨酸,2907,1382,52,50,102,51.0%,6m
10078,1,predator,2907,814,48,37,85,56.5%,8m
10078,1,[火焰雷兽]幽魂零,2907,1176,43,44,87,49.4%,16m
10078,2,总有刁民想害朕,2907,268,35,31,66,53.0%,27m
10078,3,花开安静,2907,437,23,32,55,41.8%,26m
10078,2,Innochicken,2907,512,20,15,35,57.1%,29m
10078,3,[聊天室钉子户]终焉,2907,218,7,6,13,53.8%,22m
10078,1,[blacko]fangkuairen,2907,144,5,4,9,55.6%,1h
10078,1,雷诺,2907,190,5,14,19,26.3%,25m
10078,2,[一卵最多三条]了然,2907,0,4,1,5,80.0%,16m
10078,2,[风起云涌0]小探姬找不到家了,2907,0,4,1,5,80.0%,12m
10078,1,雪音,2907,97,4,3,7,57.1%,22m
10078,2,情商,2907,126,4,5,9,44.4%,3m
10078,2,GnsHJ,2907,0,3,2,5,60.0%,1h
10078,2,[暴雪三十一队]德德逼,2907,62,2,4,6,33.3%,18m
10078,3,[第六駆逐鑑隊]Numb,2907,0,0,1,1,0.0%,16m
10096,3,[loveMM]江东徐大大,2906,1163,208,203,411,50.6%,6m
10096,1,zest,2906,1468,65,46,111,58.6%,6m
10096,2,[SCJWJ3]Stormrage,2906,435,26,11,37,70.3%,11m
10096,2,假装笨,2906,455,21,6,27,77.8%,17m
10096,3,NaneeWa,2906,617,21,31,52,40.4%,52m
10096,2,[无觉无惧]Null,2906,534,20,16,36,55.6%,15m
10096,2,notJenelle,2906,320,15,3,18,83.3%,3m
10096,1,[白银联盟]雷诺的小迷妹,2906,298,13,0,13,100.0%,1h
10096,2,叶叶叶叶,2906,387,13,12,25,52.0%,15m
10096,2,西行寺恒,2906,307,11,9,20,55.0%,21m
10096,1,Clifford,2906,237,10,2,12,83.3%,55m
10096,2,[单人模拟战]你爸爸的爸爸叫,2906,184,6,11,17,35.3%,15m
10096,2,[Trash]月影潇潇,2906,141,5,1,6,83.3%,58m
10096,1,大炸弹奥本海默,2906,164,5,3,8,62.5%,15m
10096,1,[暮光星灵]佐伊佐伊酱,2906,0,3,3,6,50.0%,31m
10096,1,鱼丸,2906,96,3,3,6,50.0%,1h
10096,2,Gentleman,2906,88,2,0,2,100.0%,11m
10096,2,[OB丶]星火,2906,30,2,1,3,66.7%,25m
10096,2,[TNLet]IIIIIIIIIIII,2906,88,2,2,4,50.0%,20m
10096,1,[PAHXX]独身太太快快跑,2906,0,1,0,1,100.0%,21m
10096,2,深渊,2906,88,1,2,3,33.3%,23m
10096,2,阿蒙,2906,0,0,1,1,0.0%,29m
10118,1,诡笑面具,2905,696,58,42,100,58.0%,9m
10118,2,少女与战车喀秋莎,2905,1097,58,44,102,56.9%,20m
10118,1,白云城主不戒大师,2905,1074,37,42,79,46.8%,12m
10118,1,打铁还需自身硬,2905,388,22,23,45,48.9%,9m
10118,1,[是我赢了]季淼,2905,511,19,16,35,54.3%,54m
10118,2,zzqmm,2905,354,13,10,23,56.5%,28m
10118,2,llllllllllll,2905,314,11,8,19,57.9%,28m
10118,2,梨沙,2905,252,9,6,15,60.0%,5m
10118,2,[同盟会]TEM,2905,92,4,3,7,57.1%,36m
10118,2,装甲空母加贺,2905,104,4,5,9,44.4%,12m
10118,2,[黄金海舰队]江南狗王孙哈娜,2905,0,3,1,4,75.0%,1h
10118,2,wang,2905,0,3,2,5,60.0%,48m
10118,2,一个炮灰,2905,30,2,0,2,100.0%,21m
10118,2,玲珑骰子安红豆,2905,94,2,0,2,100.0%,28m
10118,2,皓然来袭,2905,30,2,1,3,66.7%,52m
10118,2,lalala,2905,30,2,2,4,50.0%,20m
10118,2,[TPZTPZ]llllllllllll,2905,94,2,4,6,33.3%,15m
10118,1,[海石三叉戟]快龙酱,2905,0,1,1,2,50.0%,47m
10136,3,[KPG2]神的猪福,2904,1595,389,345,734,53.0%,7m
10136,3,Jianshi,2904,1575,381,379,760,50.1%,53m
10136,3,提叉叉,2904,1199,179,164,343,52.2%,58m
10136,2,海叶枫,2904,999,47,30,77,61.0%,27m
10136,1,[PHP最好]Trowar,2904,851,40,28,68,58.8%,56m
10136,1,犬夜叉,2904,663,31,33,64,48.4%,20m
10136,2,IIIIIIIIIIII,2904,429,20,6,26,76.9%,15m
10136,2,苏科孙红雷,2904,492,19,16,35,54.3%,11m
10136,2,挽歌,2904,357,14,10,24,58.3%,3m
10136,1,[国足救星]sunny,2904,302,13,10,23,56.5%,9m
10136,2,冰激凌综合症患者,2904,283,11,8,19,57.9%,1h
10136,2,裁决之矛,2904,208,7,3,10,70.0%,5m
10136,2,我要上三千分,2904,176,6,6,12,50.0%,13m
10136,1,[至高天]冰灬霖,2904,96,5,2,7,71.4%,1h
10136,3,[wwsixi]九霄,2904,140,4,0,4,100.0%,1h
10136,2,法克鱿,2904,133,4,5,9,44.4%,25m
10136,1,[TQTQ]GFIne,2904,144,3,1,4,75.0%,10m
10136,2,[幽冥之狼]伊什塔凛,2904,64,3,2,5,60.0%,11m
10136,1,[基金会]路飞,2904,44,2,0,2,100.0%,18m
10136,2,pzgg,2904,30,1,1,2,50.0%,16m
10136,2,Dliang,2904,0,0,1,1,0.0%,52m
10157,1,[天雪]星云,2903,362,21,20,41,51.2%,7m
10157,1,lyst,2903,538,21,23,44,47.7%,7m
10157,2,芹泽多摩雄,2903,561,20,24,44,45.5%,3m
10157,2,帝国影子,2903,430,19,10,29,65.5%,25m
10157,2,哈喽卖地罚款,2903,410,17,14,31,54.8%,51m
10157,2,白白胖胖,2903,124,9,4,13,69.2%,53m
10157,1,Liebig,2903,143,6,7,13,46.2%,1h
10157,2,[GG争霸]supereeee,2903,120,5,6,11,45.5%,20m
10157,2,叫我白老大,2903,112,3,0,3,100.0%,16m
10157,1,Stardusst,2903,119,3,6,9,33.3%,7m
10157,1,子木,2903,108,3,9,12,25.0%,15m
10157,2,江夕,2903,0,2,3,5,40.0%,41m
10157,2,[一群傻仔]gOb,2903,0,1,0,1,100.0%,11m
10157,2,[ZSXR]专门放战术,2903,0,1,1,2,50.0%,9m
10157,2,Iust,2903,0,0,2,2,0.0%,31m
10157,1,Devilboy,2903,0,0,4,4,0.0%,7m
10173,2,星际迷大叔,2902,1571,138,132,270,51.1%,9m
10173,2,[CPT]朱小可,2902,1387,121,116,237,51.1%,25m
10173,1,[入侵地球]ajgypsy,2902,1517,92,89,181,50.8%,21m
10173,2,零度冰寒,2902,709,48,32,80,60.0%,15m
10173,3,zik,2902,311,22,34,56,39.3%,24m
10173,2,[laosep]老色批,2902,320,13,12,25,52.0%,6m
10173,2,dsfb,2902,214,7,9,16,43.8%,7m
10173,1,[Silver]Luna,2902,135,6,2,8,75.0%,39m
10173,2,[皇室联盟]SworDarTon,2902,166,5,3,8,62.5%,7m
10173,1,老新手了,2902,143,5,4,9,55.6%,1h
10173,2,拉赛尔,2902,0,4,4,8,50.0%,1h
10173,2,痴情总被无情伤,2902,140,4,6,10,40.0%,29m
10173,2,朝阳的普成,2902,88,2,0,2,100.0%,22m
10173,2,[无限未来]JYCC,2902,34,2,1,3,66.7%,12m
10173,2,[UNDEAT]Nazul,2902,0,1,0,1,100.0%,16m
10173,2,[薛之谦]丨环环相扣丨,2902,0,1,3,4,25.0%,52m
10173,2,为了井盖,2902,0,0,1,1,0.0%,53m
10173,1,龙渊,2902,0,0,1,1,0.0%,7m
10191,3,kivvf,2901,1435,204,192,396,51.5%,55m
10191,2,虫猛人秀神挨揍,2901,355,35,24,59,59.3%,52m
10191,2,黄鸡舰队,2901,359,14,13,27,51.9%,29m
10191,2,[圣德怀特学园]plh,2901,303,12,6,18,66.7%,15m
10191,1,冠位大酋长,2901,314,10,11,21,47.6%,53m
10191,2,夜孤城,2901,222,8,8,16,50.0%,36m
10191,1,林彻,2901,219,6,10,16,37.5%,23m
10191,2,[C24930]dfghjklcf,2901,0,3,2,5,60.0%,49m
10191,2,还有一件事,2901,58,3,2,5,60.0%,52m
10191,2,LOVECD,2901,0,3,2,5,60.0%,1h
10191,1,枪兵突袭,2901,48,2,2,4,50.0%,22m
10191,2,Candy,2901,0,1,3,4,25.0%,59m
10191,2,zuofeng,2901,0,0,1,1,0.0%,12m
10204,1,[萌萌的探机]喵喵喵,2900,1479,93,80,173,53.8%,25m
10204,1,dimer,2900,537,56,31,87,64.4%,30m
10204,2,在下狄某,2900,1135,51,34,85,60.0%,53m
10204,2,orangesixone,2900,872,43,25,68,63.2%,4m
10204,2,老仙奶我人生不顺,2900,983,38,35,73,52.1%,29m
10204,1,笑容背后丶乐逍遥,2900,707,36,32,68,52.9%,54m
10204,2,JackLeen,2900,560,22,21,43,51.2%,18m
10204,1,她听着他说话,2900,332,15,16,31,48.4%,8m
10204,2,对酒当歌,2900,281,12,5,17,70.6%,13m
10204,2,[灰冥]摔下二楼的杰洛特,2900,277,9,11,20,45.0%,26m
10204,2,[猎馬人]XiutosObotth,2900,192,7,4,11,63.6%,12m
10204,2,天下最白,2900,136,4,1,5,80.0%,29m
10204,2,[二次元联盟军]朱朱战神,2900,102,3,0,3,100.0%,30m
10204,2,[幽冥楼阁]Konngara,2900,44,3,0,3,100.0%,1h
10204,1,[Hrizon]恋慕的全域,2900,144,3,1,4,75.0%,1h
10204,2,这个挺好的,2900,0,3,2,5,60.0%,60m
10204,3,尘净衣,2900,161,3,5,8,37.5%,44m
10204,2,[華鳥風月之父]饕餮,2900,0,1,0,1,100.0%,25m
10204,2,[LDP]她说放不下他,2900,0,1,0,1,100.0%,27m
10204,2,IIIIIIIIIIII,2900,0,1,0,1,100.0%,22m
10204,1,极珏幽璃,2900,0,1,1,2,50.0%,51m
10204,2,EdisonYyyy,2900,0,1,2,3,33.3%,56m
10204,2,永恒,2900,0,0,1,1,0.0%,20m
10204,2,[兔兔那么可爱]Emiyas,2900,0,0,1,1,0.0%,16m
10204,2,虾之哀伤,2900,0,0,1,1,0.0%,17m
10204,2,Conquer,2900,0,0,1,1,0.0%,30m
10230,1,榆中三汉,2899,1182,57,36,93,61.3%,25m
10230,1,大局为重,2899,344,32,22,54,59.3%,20m
10230,1,星际争霸嘴上过,2899,680,25,20,45,55.6%,55m
10230,1,[游戏风云OL]WifiDragon,2899,578,22,19,41,53.7%,16m
10230,2,[神智无知]杨永信,2899,377,16,9,25,64.0%,4m
10230,2,水天一色,2899,324,11,9,20,55.0%,53m
10230,2,[东方非想天则]齐藤千佳,2899,270,11,14,25,44.0%,51m
10230,1,灬错误代码灬凌,2899,194,8,7,15,53.3%,12m
10230,2,娘了个锤的,2899,148,5,3,8,62.5%,13m
10230,2,[斯巴达血战团]寒封丨飘雪,2899,88,4,2,6,66.7%,31m
10230,1,霓虹的伤,2899,120,3,6,9,33.3%,1h
10230,2,vegetawinner,2899,0,2,1,3,66.7%,1h
10230,2,[DMRc]cry,2899,102,2,1,3,66.7%,10m
10230,1,[SFloor]随去风来,2899,40,2,8,10,20.0%,10m
10230,3,[暗黑执政官]怎么说,2899,0,1,0,1,100.0%,1h
10230,2,[噩梦]Lounge,2899,0,0,1,1,0.0%,36m
10246,2,PalmehrNath,2898,1563,310,282,592,52.4%,13m
10246,1,对手是最好的教练,2898,872,163,171,334,48.8%,55m
10246,1,llllllllllll,2898,684,63,56,119,52.9%,21m
10246,3,[星际丶老男孩]justkidding,2898,995,45,58,103,43.7%,52m
10246,2,戏子,2898,747,29,29,58,50.0%,52m
10246,2,LEO,2898,196,8,2,10,80.0%,52m
10246,3,努力痊愈,2898,196,8,6,14,57.1%,29m
10246,2,[克哈驻防舰队]皇家卫队,2898,187,7,6,13,53.8%,28m
10246,2,中也,2898,122,5,6,11,45.5%,25m
10246,2,[为谁而忧伤]chunyu,2898,0,4,1,5,80.0%,25m
10246,1,smileZhong,2898,96,4,3,7,57.1%,57m
10246,2,yyp,2898,88,2,0,2,100.0%,56m
10246,1,挚爱毛毛,2898,0,1,0,1,100.0%,1h
10246,2,[途吉狂魔]凉薄少女梦,2898,0,1,0,1,100.0%,28m
10246,2,被杀超鬼,2898,88,1,1,2,50.0%,7m
10246,1,风林火山,2898,0,0,1,1,0.0%,34m
10246,2,[小鸡屠宰场8]DevilMayCry,2898,0,0,1,1,0.0%,16m
10246,1,枫叶,2898,0,0,1,1,0.0%,1h
10246,2,赢一把就睡,2898,0,0,1,1,0.0%,26m
10265,2,NICDIKO,2897,505,145,125,270,53.7%,22m
10265,1,[ZSG]professorY,2897,500,38,40,78,48.7%,16m
10265,2,紫水栈桥,2897,748,34,21,55,61.8%,52m
10265,2,IMPBlade,2897,474,22,13,35,62.9%,17m
10265,2,雁阵惊寒,2897,168,7,3,10,70.0%,26m
10265,3,AsceticBiSu,2897,97,4,4,8,50.0%,1h
10265,1,[嗑药小分队]恐鸡,2897,48,2,1,3,66.7%,22m
10265,1,御坂之光,2897,0,1,2,3,33.3%,1h
10265,2,钢筋直男的救赎,2897,0,1,2,3,33.3%,7m
10265,3,[青风堂]秽土转生,2897,0,0,3,3,0.0%,6m
10275,1,小豌豆,2896,1627,134,133,267,50.2%,12m
10275,2,Panda,2896,1283,98,84,182,53.8%,36m
10275,2,九班马龙,2896,696,26,29,55,47.3%,10m
10275,2,颅献皇座血祭神皇,2896,509,23,21,44,52.3%,12m
10275,2,Thinker,2896,236,9,11,20,45.0%,54m
10275,1,[瞧峰文化]落星缘,2896,219,7,10,17,41.2%,16m
10275,1,[应塔罗塔杀哒]翎鸢,2896,189,6,5,11,54.5%,10m
10275,1,[嘤嘤嘤啊]Face,2896,163,4,3,7,57.1%,12m
10275,3,[星际合作群]龙语者,2896,0,4,4,8,50.0%,1h
10275,2,[幻想神社]MorinoSeika,2896,114,4,6,10,40.0%,13m
10275,2,[SK]sNow,2896,62,2,5,7,28.6%,29m
10275,2,[TPoR]樱京,2896,0,1,0,1,100.0%,12m
10275,1,Apple,2896,48,1,3,4,25.0%,22m
10275,2,[Nostop]Paimon,2896,0,0,1,1,0.0%,22m
10275,2,evilpotato,2896,0,0,1,1,0.0%,21m
10290,2,维斯维尔星港,2895,808,92,73,165,55.8%,53m
10290,2,helped,2895,1576,80,68,148,54.1%,25m
10290,2,wtxj,2895,767,47,34,81,58.0%,10m
10290,1,可怜无助弱小菜鸡,2895,429,20,15,35,57.1%,15m
10290,1,紫霆残影,2895,280,17,16,33,51.5%,15m
10290,1,[GSMK]EternalLove,2895,317,14,11,25,56.0%,55m
10290,2,lililililil,2895,334,14,12,26,53.8%,19m
10290,2,[核平大队]作业狂人,2895,248,8,13,21,38.1%,15m
10290,2,IIIIIIIIIIII,2895,167,7,1,8,87.5%,17m
10290,2,[WLTeam]无畏兵长,2895,166,7,7,14,50.0%,34m
10290,2,[小仙女上线啦]NOLF,2895,102,5,4,9,55.6%,11m
10290,2,无双鬼少,2895,0,4,1,5,80.0%,47m
10290,2,[中华讲武堂]到发上,2895,119,3,1,4,75.0%,25m
10290,2,ALxs,2895,128,3,2,5,60.0%,52m
10290,2,DesTiny,2895,0,1,0,1,100.0%,54m
10290,2,[初音未来01]初音未来,2895,0,1,0,1,100.0%,23m
10306,1,[浙江大学战队]LeSoleil,2894,1643,130,133,263,49.4%,29m
10306,1,老子就这么单着,2894,1547,60,58,118,50.8%,16m
10306,2,Void,2894,1387,59,50,109,54.1%,17m
10306,2,zzzzzz,2894,906,38,28,66,57.6%,15m
10306,2,七重人格,2894,305,12,8,20,60.0%,8m
10306,1,NYJ,2894,258,8,14,22,36.4%,8m
10306,2,白羽,2894,188,7,6,13,53.8%,30m
10306,2,让我骚一下,2894,88,4,2,6,66.7%,23m
10306,2,[暹祤桟]咸鱼仙,2894,58,3,2,5,60.0%,22m
10306,2,小鬼砌,2894,90,3,7,10,30.0%,11m
10306,2,云之渺,2894,30,2,2,4,50.0%,22m
10306,1,ShawyuS,2894,0,1,3,4,25.0%,22m
10306,1,羽飞羽落,2894,0,0,1,1,0.0%,1h
10306,2,Sakura,2894,0,0,1,1,0.0%,25m
10306,2,MagicLAN,2894,0,0,2,2,0.0%,5m
10321,3,shifucai,2893,949,54,70,124,43.5%,51m
10321,2,[Beam]VoidVoyage,2893,916,43,25,68,63.2%,13m
10321,2,llllllllllll,2893,1025,40,33,73,54.8%,8m
10321,1,[miku守护]画中游,2893,785,26,35,61,42.6%,56m
10321,2,青春少年样样红,2893,494,21,18,39,53.8%,18m
10321,2,iab,2893,527,20,21,41,48.8%,16m
10321,2,IIIIIIIIIIII,2893,290,14,5,19,73.7%,29m
10321,2,麻辣龙利鱼,2893,322,13,9,22,59.1%,5m
10321,1,SolaStella,2893,361,13,11,24,54.2%,1h
10321,2,菜鸟,2893,216,10,8,18,55.6%,1h
10321,1,disk,2893,318,10,13,23,43.5%,56m
10321,3,NATE,2893,218,9,5,14,64.3%,29m
10321,1,Altoria,2893,138,6,6,12,50.0%,1h
10321,1,你看你马呐,2893,97,4,3,7,57.1%,57m
10321,2,[六分区]云佚,2893,58,3,3,6,50.0%,18m
10321,2,[DMRe]rushcrazy,2893,0,1,0,1,100.0%,36m
10321,2,星空下的粉毛怪盗,2893,34,1,5,6,16.7%,11m
10321,1,一波,2893,38,1,6,7,14.3%,15m
10321,2,[二次元联盟军]Tossgirl,2893,0,0,1,1,0.0%,21m
10321,2,[TNLet]Vittorino,2893,0,0,3,3,0.0%,54m
10341,2,[风暴领主]你是真的狗,2892,1271,194,199,393,49.4%,56m
10341,1,艾尔之盾,2892,1482,70,66,136,51.5%,16m
10341,2,葱油饼,2892,1263,63,58,121,52.1%,25m
10341,1,[午夜霓虹灯]singsong,2892,876,34,30,64,53.1%,12m
10341,1,Supertom,2892,890,33,28,61,54.1%,8m
10341,2,[三族同萌会]魔法少年郭冬临,2892,559,23,18,41,56.1%,29m
10341,1,[最菜战队]蒙古上单,2892,218,15,9,24,62.5%,31m
10341,2,[糯米丸子]淡定,2892,303,14,6,20,70.0%,4m
10341,2,pestak,2892,340,14,8,22,63.6%,16m
10341,3,QINGQING,2892,292,11,11,22,50.0%,29m
10341,1,[闭嘴基佬]SDDDDDDDDDGG,2892,242,7,8,15,46.7%,47m
10341,1,青铜连胜王,2892,219,5,10,15,33.3%,8m
10341,2,[工口组]纸片人,2892,136,4,2,6,66.7%,5m
10341,2,IIIIlIlIlIlI,2892,177,4,5,9,44.4%,59m
10341,2,[可遇不可求]练出来了,2892,0,1,0,1,100.0%,7m
10341,2,SEED,2892,0,1,0,1,100.0%,12m
10341,2,假大佬,2892,0,1,1,2,50.0%,16m
10341,2,EtdMaMaMia,2892,0,0,1,1,0.0%,13m
10341,2,[深渊注视着你]温柔,2892,0,0,3,3,0.0%,52m
10360,2,夏目大人,2891,1488,348,326,674,51.6%,15m
10360,1,魔法少女文森特,2891,1497,117,105,222,52.7%,23m
10360,2,门后有人,2891,1309,61,59,120,50.8%,28m
10360,2,一战,2891,1171,59,40,99,59.6%,16m
10360,2,[白与白白]你妹子的感动了我,2891,995,43,31,74,58.1%,28m
10360,2,Humphry,2891,791,36,22,58,62.1%,17m
10360,2,TICANFLY,2891,707,32,21,53,60.4%,52m
10360,2,忒修斯之船,2891,657,26,23,49,53.1%,17m
10360,1,[混元形意拳]along,2891,335,21,20,41,51.2%,23m
10360,2,Gary,2891,349,15,8,23,65.2%,25m
10360,2,枫阑干,2891,327,13,8,21,61.9%,26m
10360,3,[601]jackson,2891,54,10,37,47,21.3%,31m
10360,2,暗影空间,2891,176,6,9,15,40.0%,10m
10360,1,Polestar,2891,145,5,5,10,50.0%,7m
10360,2,热心网友小陈,2891,126,5,7,12,41.7%,21m
10360,2,[凯哥集团]凛冬将至,2891,88,4,3,7,57.1%,10m
10360,2,[轻风候君来]清风雨,2891,178,4,8,12,33.3%,46m
10360,2,SHAY,2891,112,3,1,4,75.0%,28m
10360,2,[艾拉]ErrOrs,2891,86,3,6,9,33.3%,28m
10360,2,[Fear]部落的肾亏都得死,2891,0,1,0,1,100.0%,53m
10360,2,sakura,2891,0,0,1,1,0.0%,13m
10360,2,八雲紫,2891,0,0,1,1,0.0%,8m
10360,2,[马鹿子]海兔柒,2891,0,0,3,3,0.0%,1h
10383,3,是人族就退,2890,772,794,762,1556,51.0%,26m
10383,2,Pimba,2890,787,45,35,80,56.2%,51m
10383,2,[萌新保护协议]玄冥苍宇,2890,786,33,24,57,57.9%,4m
10383,2,[鲁德欢]虚空来客,2890,603,30,13,43,69.8%,19m
10383,2,魂魄妖夢,2890,652,24,22,46,52.2%,53m
10383,2,sktwulaodog,2890,300,11,15,26,42.3%,9m
10383,2,[Shawk]谁骂我就打谁,2890,230,9,4,13,69.2%,25m
10383,2,光刻的遗迹,2890,165,7,1,8,87.5%,54m
10383,2,[星之所在RI]岁月河里的摆渡人,2890,215,7,3,10,70.0%,52m
10383,2,[萌萌哒鸡]Heath,2890,94,6,4,10,60.0%,1h
10383,2,走上屠狗路,2890,174,6,9,15,40.0%,23m
10383,1,Mastershy,2890,172,5,1,6,83.3%,1h
10383,2,我欲封天,2890,142,5,1,6,83.3%,13m
10383,2,黑虎阿福,2890,126,4,1,5,80.0%,31m
10383,2,机灵鬼,2890,152,4,3,7,57.1%,29m
10383,2,xianren,2890,102,2,1,3,66.7%,51m
10383,3,我有一个小香批,2890,89,2,1,3,66.7%,1h
10383,2,妈个鸡泰伦,2890,30,2,2,4,50.0%,52m
10383,2,紫苑寺有子,2890,62,2,6,8,25.0%,12m
10383,1,GhostDog,2890,0,1,0,1,100.0%,1h
10383,2,[龍狗毒爆]IIIIIIIIIIII,2890,0,1,0,1,100.0%,20m
10383,1,蓝色星系,2890,96,1,1,2,50.0%,54m
10383,2,[实地]缺啥找啥,2890,0,0,1,1,0.0%,58m
10383,2,百变鸡捌蛋,2890,0,0,1,1,0.0%,54m
10407,1,[黑桃A]Joker,2889,1227,76,63,139,54.7%,55m
10407,2,BlackUnicorn,2889,1156,52,50,102,51.0%,25m
10407,1,自由之风,2889,293,36,42,78,46.2%,24m
10407,2,我永远爱桥本环奈,2889,346,19,16,35,54.3%,58m
10407,1,[醋拌刺蛇头]光复艾尔,2889,435,18,19,37,48.6%,55m
10407,2,[Chest]侃爷,2889,405,16,11,27,59.3%,19m
10407,1,[西伯利亚土豆]阿塔尼斯,2889,325,12,9,21,57.1%,15m
10407,2,[萌新保护协议]一只无辜的路人,2889,296,10,9,19,52.6%,11m
10407,1,[Gate丶]FFFIRE,2889,196,6,17,23,26.1%,14m
10407,2,吉格,2889,88,4,5,9,44.4%,53m
10407,2,夜无涯,2889,48,4,6,10,40.0%,12m
10407,3,[MST]馒头丶,2889,121,3,1,4,75.0%,1h
10407,2,LOOO,2889,90,3,5,8,37.5%,58m
10407,2,牧羊人的怀抱,2889,114,2,2,4,50.0%,12m
10407,1,sleipnir,2889,48,2,2,4,50.0%,50m
10407,2,骑着蜗牛追飞机,2889,0,2,3,5,40.0%,1h
10407,2,荣耀归于长子,2889,115,2,3,5,40.0%,1h
10407,1,[老婆一喊就退]用泪点烟,2889,30,2,8,10,20.0%,8m
10407,2,堡垒说得对,2889,30,1,3,4,25.0%,11m
10407,1,LDrain,2889,34,1,6,7,14.3%,7m
10407,3,[学习使我快乐]沧海一厘米,2889,0,0,1,1,0.0%,23m
10428,2,斯奈菲尔,2888,852,91,82,173,52.6%,56m
10428,1,[TSU]Suzutsuki,2888,1052,69,71,140,49.3%,21m
10428,2,[谐星毒奶]FLASH,2888,623,28,23,51,54.9%,36m
10428,2,[逸仙谐星]Corleone,2888,168,6,3,9,66.7%,19m
10428,1,凌亦辰,2888,190,6,5,11,54.5%,38m
10428,3,[咖啡Fans]梦蝶蝶蝶蝶蝶,2888,191,5,4,9,55.6%,1h
10428,2,猪排骨,2888,120,5,5,10,50.0%,53m
10428,2,[七咕咕]Ulysses,2888,138,4,1,5,80.0%,1h
10428,1,千代梦,2888,117,4,3,7,57.1%,1h
10428,2,sakura,2888,0,3,2,5,60.0%,1h
10428,2,骑猪上高速,2888,32,2,3,5,40.0%,52m
10428,2,沁淇,2888,0,1,0,1,100.0%,17m
10428,2,孙一峰是我大哥,2888,0,1,0,1,100.0%,44m
10428,2,[缩阳入腹]丨旋风老阴逼丨,2888,0,1,1,2,50.0%,9m
10428,3,[BLZSC2]神话哥哥,2888,0,0,1,1,0.0%,3m
10443,2,[樱火之森]梦违,2887,726,31,31,62,50.0%,15m
10443,2,再见小强,2887,373,25,17,42,59.5%,9m
10443,1,gangsterSunn,2887,665,24,26,50,48.0%,20m
10443,2,MagicVilgil,2887,440,19,15,34,55.9%,19m
10443,1,Bing,2887,460,16,21,37,43.2%,31m
10443,2,[DSE]你瞅啥,2887,236,8,11,19,42.1%,9m
10443,3,将军,2887,172,7,6,13,53.8%,1h
10443,2,[黑暗幻想]KCIDMAN,2887,190,6,4,10,60.0%,9m
10443,2,经度,2887,142,5,6,11,45.5%,11m
10443,2,[星港咖啡厅]DEFT,2887,144,4,3,7,57.1%,53m
10443,2,快乐星际,2887,122,4,8,12,33.3%,29m
10443,1,奇迹的雨夜,2887,96,3,3,6,50.0%,1h
10443,2,[永不灭的战火]铁堡,2887,120,3,3,6,50.0%,13m
10443,1,呵呵,2887,48,2,2,4,50.0%,1h
10443,2,贝拉维拉,2887,0,2,3,5,40.0%,1h
10443,1,蒲公英,2887,0,1,0,1,100.0%,55m
10443,2,古明地觉,2887,0,1,1,2,50.0%,7m
10443,2,sunlight,2887,30,1,3,4,25.0%,31m
10461,2,[裤裆藏牛]Carica,2886,1254,60,61,121,49.6%,13m
10461,1,Hunter,2886,602,20,25,45,44.4%,24m
10461,2,[Mayuki]sclllJinG,2886,436,19,12,31,61.3%,53m
10461,2,邓氏坦克军,2886,205,10,6,16,62.5%,56m
10461,2,霸王鸡条,2886,206,8,6,14,57.1%,52m
10461,2,大地,2886,248,8,8,16,50.0%,15m
10461,3,大将韩信,2886,38,6,4,10,60.0%,16m
10461,2,FNCArslan,2886,102,3,1,4,75.0%,58m
10461,2,[神丿域]AflameAvenu,2886,128,3,2,5,60.0%,21m
10461,2,防守甭进攻,2886,0,1,0,1,100.0%,36m
10461,2,[RONIN]zest,2886,88,1,1,2,50.0%,8m
10461,2,Type,2886,0,1,2,3,33.3%,23m
10461,2,菜鸡神教长老,2886,0,0,1,1,0.0%,25m
10461,2,King,2886,0,0,1,1,0.0%,11m
10461,3,[四斋蒸蚝片]究极硬汉派大星,2886,0,0,1,1,0.0%,5m
10476,2,twotyq,2885,1585,213,185,398,53.5%,17m
10476,2,laevatain,2885,1569,116,107,223,52.0%,7m
10476,1,洋葱头怎么回事,2885,818,57,49,106,53.8%,18m
10476,1,lllllllll,2885,144,22,20,42,52.4%,13m
10476,2,Escape,2885,574,21,20,41,51.2%,52m
10476,2,随机,2885,269,10,2,12,83.3%,1h
10476,1,[白手团]功夫熊猫,2885,284,9,12,21,42.9%,54m
10476,1,Royitoh,2885,315,9,14,23,39.1%,57m
10476,2,[NLYH]Akira,2885,160,7,8,15,46.7%,1h
10476,2,coach,2885,0,4,1,5,80.0%,1h
10476,2,鹿目圆,2885,116,3,1,4,75.0%,4m
10476,2,Timeknight,2885,138,3,2,5,60.0%,1h
10476,2,[某科学的]夜空遗留的尾巴,2885,140,3,4,7,42.9%,9m
10476,1,qqq,2885,48,3,4,7,42.9%,10m
10476,2,[哔哩哔哩肝杯]Nong,2885,92,2,0,2,100.0%,34m
10476,1,[璃玥应援团]Abuther,2885,42,2,0,2,100.0%,13m
10476,2,blade,2885,90,2,0,2,100.0%,1h
10476,2,我当过人吗,2885,30,2,1,3,66.7%,54m
10476,1,[利兹与青鸟]Chen,2885,40,2,2,4,50.0%,1h
10476,2,[虚无]end,2885,0,1,0,1,100.0%,19m
10476,1,kcyclever,2885,0,1,0,1,100.0%,15m
10476,2,丶一个人挺好灬,2885,0,1,0,1,100.0%,28m
10476,2,[吾三美如画]达拉姆带主教,2885,0,1,4,5,20.0%,1h
10476,2,sksuzakufan,2885,0,0,1,1,0.0%,29m
10476,2,TCTG,2885,0,0,1,1,0.0%,18m
10476,2,异形重生,2885,0,0,3,3,0.0%,11m
10502,2,[华胥的恶魔]BlackMoon,2884,1567,197,183,380,51.8%,53m
10502,2,Maggen,2884,1347,151,142,293,51.5%,12m
10502,2,米二狗,2884,1566,108,91,199,54.3%,6m
10502,1,Goldforjoy,2884,1160,87,76,163,53.4%,10m
10502,2,[闲散人员]烟消云散,2884,863,38,28,66,57.6%,29m
10502,3,世末歌者,2884,189,7,6,13,53.8%,1h
10502,2,[哔翻天梯鸡]阿莱克修斯,2884,167,6,2,8,75.0%,52m
10502,2,简单,2884,130,5,1,6,83.3%,11m
10502,2,[莫蒂的外公]失心疯,2884,0,3,2,5,60.0%,48m
10502,2,GHTLH,2884,0,3,2,5,60.0%,17m
10502,2,sdddddddd,2884,128,3,4,7,42.9%,54m
10502,2,DeBrunk,2884,30,2,1,3,66.7%,51m
10502,1,Heart,2884,96,2,4,6,33.3%,8m
10502,2,[纳兰皇族]梦幻残影,2884,0,1,0,1,100.0%,27m
10502,1,夕阳下的贪吃蛇,2884,0,1,0,1,100.0%,1h
10502,2,yyyyy,2884,0,1,0,1,100.0%,36m
10502,2,[MOMIMO]昆虫,2884,88,1,1,2,50.0%,29m
10502,1,[暴风雨]上杉绘梨衣,2884,48,1,1,2,50.0%,14m
10520,2,啥也不是,2883,1588,95,78,173,54.9%,26m
10520,1,[O栋444]四川康王龙,2883,601,28,28,56,50.0%,57m
10520,2,弱小的普洛陀斯,2883,552,23,19,42,54.8%,15m
10520,2,timba,2883,343,13,12,25,52.0%,19m
10520,1,woaicaiyue,2883,277,12,8,20,60.0%,1h
10520,2,[一剑封喉]御爱坊母婴,2883,140,6,4,10,60.0%,23m
10520,1,HERO,2883,180,6,5,11,54.5%,45m
10520,1,sysuhan,2883,97,5,2,7,71.4%,1h
10520,2,ChinaerIC,2883,0,4,1,5,80.0%,47m
10520,2,GEO,2883,88,4,3,7,57.1%,25m
10520,2,浅色丶深色,2883,118,4,7,11,36.4%,19m
10520,2,[养正]飞雪舞霜华,2883,88,2,0,2,100.0%,11m
10520,2,[XYG]越打越菜,2883,30,2,1,3,66.7%,16m
10520,2,[sNOOBs]skeowm,2883,0,1,0,1,100.0%,53m
10520,2,[孤独与烈酒]Ash,2883,0,1,2,3,33.3%,30m
10520,2,Cloud,2883,0,0,1,1,0.0%,1h
10520,2,山峰雪,2883,0,0,1,1,0.0%,11m
10520,2,[Dream]dreamcog,2883,0,0,3,3,0.0%,19m
10538,1,[vaccin]只会虚空的都是傻,2882,1541,163,159,322,50.6%,55m
10538,2,sdfa,2882,1224,156,127,283,55.1%,22m
10538,2,[TAPC]Rain,2882,864,34,31,65,52.3%,25m
10538,3,[我爱黄嘉彦]伟大温度计,2882,643,33,46,79,41.8%,24m
10538,2,高手寂寞,2882,474,20,20,40,50.0%,58m
10538,2,Zeczery,2882,433,17,13,30,56.7%,25m
10538,2,风尊者,2882,134,5,8,13,38.5%,12m
10538,1,Somnus,2882,116,4,4,8,50.0%,1h
10538,3,realbin,2882,97,4,4,8,50.0%,1h
10538,2,[染年霜霜]染年霜霜冰封神域,2882,102,3,0,3,100.0%,13m
10538,2,alphafly,2882,73,1,2,3,33.3%,52m
10538,2,[TAPC]鬼夜哭,2882,0,1,3,4,25.0%,11m
10538,2,[阿板大队]potato,2882,0,0,1,1,0.0%,7m
10538,2,[装大佬的鸡]Frozen,2882,0,0,1,1,0.0%,12m
10552,2,Sonny,2881,1580,131,120,251,52.2%,26m
10552,2,[在下菜鸡一只]日京木华,2881,1137,50,42,92,54.3%,27m
10552,2,你的阳哥哈哈哈哈,2881,674,30,21,51,58.8%,13m
10552,1,[VHDL]燃烧吧青春,2881,740,29,29,58,50.0%,24m
10552,2,彭无殇,2881,718,26,28,54,48.1%,22m
10552,2,[ch1pnb]nimda,2881,472,19,14,33,57.6%,54m
10552,3,故乡的原风景,2881,423,19,38,57,33.3%,26m
10552,2,回归的便利店,2881,396,16,13,29,55.2%,26m
10552,1,[CKP]老韩之魂,2881,221,13,9,22,59.1%,1h
10552,2,Aquarius,2881,142,5,1,6,83.3%,7m
10552,2,思想落后的人,2881,150,5,3,8,62.5%,26m
10552,2,[小奶狼]WOLF,2881,130,5,3,8,62.5%,52m
10552,3,[猎马人军团]超级扛麦工,2881,142,4,0,4,100.0%,52m
10552,2,ZeroWindBlow,2881,102,3,0,3,100.0%,15m
10552,2,[七咕咕]一束七,2881,102,3,0,3,100.0%,12m
10552,2,Overwhelming,2881,0,3,2,5,60.0%,47m
10552,2,夏侯天游,2881,138,3,3,6,50.0%,19m
10552,2,Sandwitch,2881,58,3,3,6,50.0%,53m
10552,2,拂晓黎明,2881,88,2,0,2,100.0%,13m
10552,2,松松松松酱,2881,88,2,0,2,100.0%,27m
10552,2,[今天超市打折]扬扬,2881,88,2,4,6,33.3%,11m
10552,2,[海王星舰队]萌新,2881,0,1,0,1,100.0%,20m
10552,2,[AgCu电池]我雷兽三连了,2881,30,1,4,5,20.0%,4m
10552,1,song,2881,0,1,7,8,12.5%,8m
10552,2,xiaolan,2881,0,0,4,4,0.0%,21m
10577,2,Mourner,2880,1439,89,69,158,56.3%,26m
10577,1,[Beastp]逸丨尘灬,2880,1409,69,71,140,49.3%,17m
10577,1,俊浩祥,2880,1175,52,49,101,51.5%,16m
10577,2,飯鍥叁碗,2880,492,20,21,41,48.8%,58m
10577,2,饭团子,2880,231,14,6,20,70.0%,18m
10577,2,宇宙之神,2880,316,13,15,28,46.4%,53m
10577,2,iiiiiiii,2880,354,12,11,23,52.2%,5m
10577,2,[星际争霸第一]夏夏最美,2880,142,10,12,22,45.5%,16m
10577,2,Arcturus,2880,270,9,8,17,52.9%,19m
10577,1,俗人,2880,164,7,2,9,77.8%,1h
10577,3,[沙漠之鹰]StarHuang,2880,240,7,5,12,58.3%,1h
10577,1,宵夜大神,2880,139,5,2,7,71.4%,1h
10577,2,神裂影,2880,133,5,6,11,45.5%,1h
10577,2,玩玩飞刀,2880,130,4,9,13,30.8%,25m
10577,2,半城半埃落,2880,0,3,2,5,60.0%,5m
10577,1,lifezbb,2880,0,3,3,6,50.0%,16m
10577,3,传说哥,2880,145,3,8,11,27.3%,51m
10577,3,[求老仙奶我啊]FenixM,2880,30,2,1,3,66.7%,29m
10577,1,要鸭梨才有冻梨,2880,0,2,4,6,33.3%,1h
10577,2,[水的不行]imzealot,2880,0,0,1,1,0.0%,5m
10577,2,火鸡味锅巴,2880,0,0,1,1,0.0%,26m
10577,3,[华夏远征军]萧残,2880,0,0,1,1,0.0%,6m
10599,1,干神是我大哥,2879,1641,189,168,357,52.9%,7m
10599,2,Bill,2879,761,32,25,57,56.1%,29m
10599,2,[七咕咕]灰烬天堂,2879,295,22,18,40,55.0%,19m
10599,1,[GDG]南风如梦,2879,407,15,17,32,46.9%,8m
10599,1,心暖阳光,2879,480,15,22,37,40.5%,20m
10599,3,casear,2879,267,9,4,13,69.2%,7m
10599,2,YuiHatano,2879,176,7,7,14,50.0%,1h
10599,1,亿万分之一的相遇,2879,188,6,5,11,54.5%,1h
10599,1,[荣耀丶殿堂]天蔚湛蓝,2879,99,6,10,16,37.5%,56m
10599,2,Superstition,2879,165,5,3,8,62.5%,26m
10599,2,YCFL,2879,139,3,2,5,60.0%,17m
10599,2,游侠,2879,0,3,2,5,60.0%,25m
10599,1,枫树下的小狐狸,2879,96,3,4,7,42.9%,1h
10599,2,夜听风,2879,90,3,4,7,42.9%,29m
10599,3,脱法摇滚,2879,30,2,1,3,66.7%,6m
10599,3,Nic,2879,0,1,0,1,100.0%,1h
10599,3,紫叶神龙,2879,0,0,1,1,0.0%,27m
10616,1,[西湖水产巨子]Legion,2878,1625,116,119,235,49.4%,23m
10616,1,IIIIIIII,2878,1423,85,85,170,50.0%,54m
10616,2,[RDFZsc]无常,2878,866,37,29,66,56.1%,21m
10616,2,[20205]教皇,2878,812,32,27,59,54.2%,11m
10616,2,IIIIIIIIIIII,2878,359,26,13,39,66.7%,13m
10616,2,[CNboi]屠夫凯文,2878,282,15,16,31,48.4%,20m
10616,2,[全国修车]flydragon,2878,331,14,8,22,63.6%,26m
10616,3,打星际要讲武德,2878,225,9,7,16,56.2%,1h
10616,1,Focus,2878,140,5,4,9,55.6%,1h
10616,2,冰封雪羽,2878,120,5,7,12,41.7%,53m
10616,1,葡萄神,2878,96,4,3,7,57.1%,1h
10616,1,[BD丶]Thebreeze,2878,155,4,4,8,50.0%,1h
10616,3,[哔哩哔哩杯乾]琉璃易碎,2878,120,4,4,8,50.0%,27m
10616,3,芙利德的黑炎,2878,58,2,1,3,66.7%,53m
10616,1,[Holyfe]Ben,2878,48,2,2,4,50.0%,49m
10616,3,为了女王,2878,0,0,1,1,0.0%,5m
10616,3,Gaaai,2878,0,0,1,1,0.0%,12m
10633,2,菜鸟,2877,1348,65,56,121,53.7%,16m
10633,3,[混吃混喝]请叫我指挥官,2877,931,43,37,80,53.8%,6m
10633,3,神座千流,2877,542,24,9,33,72.7%,11m
10633,3,顾念,2877,716,24,36,60,40.0%,14m
10633,1,[KPG]巢导,2877,429,17,18,35,48.6%,8m
10633,2,[SOS1]那边的那一个人,2877,389,16,13,29,55.2%,51m
10633,1,洛丹伦的夜,2877,271,10,12,22,45.5%,16m
10633,3,倔强的小火鱼,2877,128,7,13,20,35.0%,25m
10633,2,illusion,2877,173,5,2,7,71.4%,28m
10633,2,Ghost,2877,0,4,1,5,80.0%,1h
10633,3,玲珑骰子,2877,145,4,2,6,66.7%,3m
10633,2,我书,2877,0,3,2,5,60.0%,1h
10633,2,[300]aaa,2877,95,3,3,6,50.0%,48m
10633,2,[大姐酒家]呆毛王,2877,30,2,1,3,66.7%,9m
10633,2,[独立團]beyond,2877,0,1,0,1,100.0%,1h
10633,2,[星际狗男孩]bobo,2877,0,1,1,2,50.0%,13m
10633,3,周数壬,2877,0,0,1,1,0.0%,13m
10633,3,[Beasty]禅虫,2877,0,0,1,1,0.0%,1h
10633,3,[梦想彼方]比比,2877,0,0,1,1,0.0%,53m
10633,1,钇子钇,2877,0,0,2,2,0.0%,27m
10653,1,kimjohoon,2876,1576,85,82,167,50.9%,7m
10653,2,[黑牧涯]THEONE,2876,251,44,38,82,53.7%,29m
10653,2,来一桶烧饼吧,2876,241,25,20,45,55.6%,28m
10653,2,sfasf,2876,325,13,13,26,50.0%,22m
10653,2,Neo,2876,204,7,4,11,63.6%,25m
10653,2,YEvWUshang,2876,164,7,7,14,50.0%,1h
10653,3,zero,2876,167,6,7,13,46.2%,1h
10653,2,大魔王,2876,0,3,2,5,60.0%,58m
10653,2,[我队伍很强大]正在找撤硕的波波,2876,92,3,7,10,30.0%,15m
10653,2,erEFF,2876,114,2,3,5,40.0%,23m
10653,3,kinto,2876,30,2,3,5,40.0%,3m
10653,1,穿越星际,2876,0,2,5,7,28.6%,22m
10653,1,飘零枫叶,2876,0,0,1,1,0.0%,1h
10666,2,Aldnoah,2875,1188,69,44,113,61.1%,17m
10666,1,素年云殇,2875,1032,61,53,114,53.5%,10m
10666,1,谁教我玩神族啊,2875,604,25,24,49,51.0%,9m
10666,2,绅士猪,2875,586,23,22,45,51.1%,25m
10666,1,[浙江大学战队]天梯对战乱入斯旺,2875,476,20,19,39,51.3%,17m
10666,2,[B11313]老歌与陈酒,2875,434,16,16,32,50.0%,21m
10666,2,[Strike]TheExileZAnd,2875,243,10,4,14,71.4%,22m
10666,3,Dean,2875,214,9,7,16,56.2%,1h
10666,2,waiTnight,2875,185,7,7,14,50.0%,26m
10666,2,西湖雅座有请,2875,174,7,9,16,43.8%,11m
10666,3,[谁都打不赢]打铁还需自身硬,2875,170,6,6,12,50.0%,7m
10666,2,[北京大学鸡协]左泉乾坤,2875,220,6,10,16,37.5%,1h
10666,3,小漏,2875,0,1,0,1,100.0%,8m
10666,3,[一花一世界]乱世辽夜,2875,0,1,0,1,100.0%,7m
10666,2,CorandoShine,2875,0,0,5,5,0.0%,26m
10681,3,wng,2874,1154,176,170,346,50.9%,22m
10681,2,鬼泣,2874,1573,159,129,288,55.2%,6m
10681,3,Hyperion,2874,1506,102,107,209,48.8%,26m
10681,2,Moonlight,2874,285,12,9,21,57.1%,23m
10681,1,ysx,2874,206,10,9,19,52.6%,18m
10681,2,[XYFANS]ManUtd,2874,256,9,8,17,52.9%,19m
10681,2,gansihuangxu,2874,148,6,6,12,50.0%,23m
10681,3,乱笙诉离殇,2874,141,5,1,6,83.3%,22m
10681,2,play,2874,0,3,2,5,60.0%,43m
10681,3,小伊,2874,97,3,6,9,33.3%,6m
10681,3,最强康复治疗师,2874,30,2,0,2,100.0%,55m
10681,3,[两道菜]fansytt,2874,30,1,1,2,50.0%,16m
10681,2,落尘,2874,48,1,3,4,25.0%,1h
10681,3,[自爆的白球]泰伦之狗普罗托斯,2874,0,0,1,1,0.0%,15m
10681,3,lxt,2874,0,0,1,1,0.0%,30m
10696,2,彡彡爱,2873,1332,79,62,141,56.0%,4m
10696,2,蜗牛快跑,2873,616,21,23,44,47.7%,19m
10696,1,情殇,2873,414,18,17,35,51.4%,54m
10696,2,[大实验]Yaphets,2873,154,15,14,29,51.7%,16m
10696,2,[快乐谐星go]你过来啊,2873,414,15,17,32,46.9%,16m
10696,2,[假面超人]常磐庄吾,2873,231,12,18,30,40.0%,16m
10696,3,你的寝室长,2873,168,6,6,12,50.0%,15m
10696,2,[慕灬小冷]高级指挥官,2873,120,5,4,9,55.6%,56m
10696,2,[彼方剑语]llllllllllll,2873,0,4,1,5,80.0%,42m
10696,2,cieli,2873,0,4,1,5,80.0%,1h
10696,2,川啊,2873,0,3,2,5,60.0%,1h
10696,2,[宇宙何平]wlitrun,2873,46,3,4,7,42.9%,42m
10696,3,adfxtl,2873,0,1,0,1,100.0%,52m
10696,3,铁马冰河入梦来,2873,0,0,1,1,0.0%,31m
10696,1,夙缘,2873,0,0,1,1,0.0%,39m
10711,2,函然如怡,2872,1613,132,123,255,51.8%,21m
10711,2,暗黑破坏神,2872,1566,120,108,228,52.6%,13m
10711,2,[大连民大]CPPmonk,2872,1068,65,53,118,55.1%,22m
10711,2,悠扬,2872,401,14,16,30,46.7%,5m
10711,1,[XCode]你也是傻子吗,2872,294,11,6,17,64.7%,17m
10711,3,[菜有菜的道理]求求你不要狗我,2872,292,10,8,18,55.6%,29m
10711,2,[美少年组合]IIIIIIIIIIII,2872,258,9,6,15,60.0%,32m
10711,3,[DMR]insomnia,2872,262,9,7,16,56.2%,14m
10711,3,[绝望中闪追猎]泊地水鬼,2872,140,6,1,7,85.7%,27m
10711,1,[总司令万岁]七月,2872,184,6,2,8,75.0%,1h
10711,2,saber,2872,142,6,6,12,50.0%,1h
10711,1,Erik,2872,137,5,4,9,55.6%,1h
10711,2,[TG天罡]Shane,2872,68,3,5,8,37.5%,16m
10711,2,MintoCCC,2872,30,2,2,4,50.0%,32m
10711,3,雷神,2872,60,2,2,4,50.0%,3m
10711,1,sryiu,2872,48,2,2,4,50.0%,1h
10711,2,金凤凰,2872,0,2,3,5,40.0%,43m
10711,3,试试水,2872,0,1,0,1,100.0%,4m
10711,3,[HK丶S]DoomSakura,2872,0,1,0,1,100.0%,15m
10711,3,NOVA,2872,30,1,1,2,50.0%,22m
10731,2,[干si孙一鸡]少侠你好,2871,1462,92,86,178,51.7%,12m
10731,1,疯狂的杀手,2871,1518,84,81,165,50.9%,23m
10731,2,奈文摩尔,2871,1169,60,45,105,57.1%,4m
10731,2,[妙不可言]坑爹尼玛,2871,767,31,25,56,55.4%,4m
10731,2,暴躁的风,2871,628,25,20,45,55.6%,18m
10731,1,oooooooo,2871,674,25,27,52,48.1%,17m
10731,2,qweris,2871,471,21,19,40,52.5%,26m
10731,3,Excalibur,2871,479,19,13,32,59.4%,4m
10731,2,[星歌]混合体天罚者,2871,481,19,15,34,55.9%,6m
10731,3,[魔法少女小屋]智慧虫族尿急王,2871,401,15,8,23,65.2%,6m
10731,3,刻进心的名字,2871,243,9,8,17,52.9%,22m
10731,3,西瓜味草莓酱,2871,194,8,2,10,80.0%,7m
10731,1,kywqqt,2871,254,8,11,19,42.1%,31m
10731,2,神人之光,2871,220,7,6,13,53.8%,56m
10731,3,wildranger,2871,148,6,3,9,66.7%,14m
10731,2,[青铜树]loveNAI,2871,180,5,6,11,45.5%,53m
10731,2,applejack,2871,0,4,1,5,80.0%,44m
10731,2,llllllllllll,2871,90,4,8,12,33.3%,19m
10731,2,Wings,2871,0,1,1,2,50.0%,54m
10731,2,银红星河,2871,0,1,2,3,33.3%,51m
10731,3,非洲酋长的复仇,2871,0,0,5,5,0.0%,15m
10752,1,天帝,2870,1632,284,286,570,49.8%,31m
10752,3,老仙奶我被吊打,2870,1192,83,51,134,61.9%,52m
10752,1,cyc,2870,1417,81,66,147,55.1%,55m
10752,3,[8K白丝弱音]Allen,2870,789,35,24,59,59.3%,28m
10752,2,abc,2870,600,30,24,54,55.6%,27m
10752,2,千叶小豆豆,2870,511,24,23,47,51.1%,29m
10752,3,[暴雪我是你爹]Ulysses,2870,255,12,9,21,57.1%,52m
10752,2,QWERZXC,2870,269,11,6,17,64.7%,51m
10752,3,[铁十字骷髅师]moon,2870,204,9,6,15,60.0%,1h
10752,3,mixz,2870,171,9,10,19,47.4%,30m
10752,3,唯一老婆名井南,2870,169,8,5,13,61.5%,44m
10752,1,千月,2870,175,6,5,11,54.5%,10m
10752,2,岂己,2870,118,5,4,9,55.6%,21m
10752,2,ZhangslyQ,2870,0,4,5,9,44.4%,26m
10752,2,NEAUTY,2870,0,3,2,5,60.0%,16m
10752,3,牛哥,2870,30,2,0,2,100.0%,27m
10752,3,治愈你毛病,2870,0,1,0,1,100.0%,12m
10752,3,RealChange,2870,0,1,0,1,100.0%,3m
10752,3,[秋千千秋]蟑螂舞娘钱赞企,2870,0,1,0,1,100.0%,55m
10752,3,低配版塞肉,2870,0,1,6,7,14.3%,1h
10752,3,shen,2870,0,0,1,1,0.0%,4m
10752,2,RTGSG,2870,0,0,1,1,0.0%,44m
10752,3,[樱之岛]物述有栖,2870,0,0,1,1,0.0%,13m
10752,2,[Borne]sixsixsix,2870,0,0,2,2,0.0%,29m
10776,2,雅辛少爷,2869,1532,138,125,263,52.5%,7m
10776,2,柠檬味红茶,2869,1349,81,70,151,53.6%,36m
10776,1,深邃之心,2869,1398,64,67,131,48.9%,7m
10776,2,AeF,2869,377,37,33,70,52.9%,30m
10776,3,kami,2869,716,32,18,50,64.0%,53m
10776,1,水墨孤影,2869,471,16,18,34,47.1%,21m
10776,3,守望者,2869,266,9,7,16,56.2%,15m
10776,3,螺旋之心,2869,170,7,7,14,50.0%,1h
10776,1,疎雨,2869,212,6,5,11,54.5%,38m
10776,1,[mazuri]fubuki,2869,190,5,5,10,50.0%,47m
10776,2,[高海千歌]千矢,2869,88,2,1,3,66.7%,18m
10776,3,NewPlayer,2869,0,1,0,1,100.0%,3m
10776,3,酒天童舞,2869,0,0,1,1,0.0%,27m
10789,2,妖精萧筱,2868,986,55,51,106,51.9%,23m
10789,2,夕阳下的落叶,2868,1129,49,41,90,54.4%,52m
10789,2,薇光,2868,971,40,34,74,54.1%,53m
10789,1,星火,2868,504,21,20,41,51.2%,8m
10789,3,机械之鱼人,2868,368,17,4,21,81.0%,7m
10789,2,末日枭雄,2868,298,11,14,25,44.0%,53m
10789,1,[僵尸博士牛X]郭然风,2868,46,4,4,8,50.0%,1h
10789,2,Gaster,2868,0,3,2,5,60.0%,1h
10789,3,Deathrebirth,2868,30,2,1,3,66.7%,53m
10789,3,狡猾的猎人,2868,0,1,0,1,100.0%,57m
10789,2,Mrender,2868,0,1,2,3,33.3%,11m
10800,1,[长夜将至]QianYi,2867,1491,78,67,145,53.8%,25m
10800,2,爱神,2867,370,14,11,25,56.0%,15m
10800,2,xhcchxjdbwpx,2867,360,13,14,27,48.1%,12m
10800,2,冲进白宫,2867,388,13,17,30,43.3%,53m
10800,3,[大爱星际二]火抢,2867,99,9,3,12,75.0%,29m
10800,3,ldc,2867,270,9,5,14,64.3%,15m
10800,3,神琪一幻,2867,171,7,7,14,50.0%,5m
10800,2,殴鸡酱,2867,172,7,7,14,50.0%,16m
10800,1,想不出,2867,211,6,4,10,60.0%,1h
10800,1,[全员F2A]chuadigo,2867,0,3,3,6,50.0%,47m
10800,3,[WIK]Faker,2867,30,2,0,2,100.0%,30m
10800,3,[王者家族]旺仔,2867,30,2,0,2,100.0%,25m
10800,3,BEFALL,2867,0,1,0,1,100.0%,29m
10800,3,zwy,2867,30,1,1,2,50.0%,30m
10814,2,高档豆腐,2866,759,35,22,57,61.4%,36m
10814,2,阻碍战争,2866,434,19,16,35,54.3%,13m
10814,2,PIAODD,2866,350,13,16,29,44.8%,8m
10814,1,SoujiAlter,2866,336,11,13,24,45.8%,1h
10814,2,[626]艾尔,2866,269,10,7,17,58.8%,4m
10814,2,级觉得,2866,0,3,1,4,75.0%,1h
10814,2,lllllllIllll,2866,0,3,2,5,60.0%,1h
10814,2,陈时蔚海,2866,0,1,1,2,50.0%,11m
10814,3,[应塔罗塔杀哒]那年寒冬将至,2866,0,0,1,1,0.0%,14m
10823,1,三嗦螺丝,2865,1620,503,483,986,51.0%,13m
10823,2,jianxin,2865,964,107,93,200,53.5%,26m
10823,2,妈个鸡,2865,1551,88,69,157,56.1%,6m
10823,3,[ACGGX]依旧神话,2865,694,34,26,60,56.7%,6m
10823,3,[WZerg]XElNagA,2865,256,31,17,48,64.6%,58m
10823,3,trap,2865,771,29,29,58,50.0%,14m
10823,3,Chalk,2865,216,13,7,20,65.0%,7m
10823,3,魅影凶灵,2865,273,13,10,23,56.5%,56m
10823,1,可乐加冰,2865,293,11,10,21,52.4%,12m
10823,2,鸢晨,2865,255,10,6,16,62.5%,23m
10823,1,风裂,2865,137,8,6,14,57.1%,1h
10823,1,历史沉默,2865,228,8,16,24,33.3%,7m
10823,2,[赐竹]纯粹纯粹,2865,156,5,10,15,33.3%,7m
10823,2,专坑队友,2865,0,4,1,5,80.0%,1h
10823,1,老大反着念,2865,187,4,2,6,66.7%,54m
10823,2,[别看了就你了]路鸣泽,2865,166,4,5,9,44.4%,26m
10823,1,eros,2865,118,3,1,4,75.0%,1h
10823,2,星际霸爸,2865,64,2,7,9,22.2%,56m
10823,2,孤毅,2865,0,1,1,2,50.0%,54m
10823,1,blue,2865,30,1,9,10,10.0%,7m
10823,2,lslsl,2865,0,0,1,1,0.0%,1h
10844,3,杨文博,2864,654,188,180,368,51.1%,51m
10844,2,imbalance,2864,917,65,49,114,57.0%,12m
10844,2,蓝骑士,2864,635,26,21,47,55.3%,58m
10844,2,上衫,2864,236,10,8,18,55.6%,1h
10844,3,statsfan,2864,202,8,7,15,53.3%,26m
10844,2,张战天,2864,192,7,8,15,46.7%,54m
10844,2,[雾切响子]月光下的蒲公英,2864,130,4,2,6,66.7%,52m
10844,2,枯叶,2864,102,3,1,4,75.0%,6m
10844,2,Parwernomer,2864,0,3,2,5,60.0%,36m
10844,2,像是艾斯打怪兽,2864,0,3,2,5,60.0%,26m
10844,3,[萌佬同好会]阿尔萨斯,2864,144,3,3,6,50.0%,56m
10844,2,Hego,2864,102,2,2,4,50.0%,53m
10844,3,[哲学娱乐谐会]DJG,2864,0,1,0,1,100.0%,22m
10844,1,rakim,2864,0,1,3,4,25.0%,1h
10844,3,bjz,2864,0,0,1,1,0.0%,4m
10859,2,nilion,2863,1200,134,128,262,51.1%,4m
10859,3,[失去理智]Rewriter,2863,1149,64,38,102,62.7%,56m
10859,2,demon,2863,1292,55,46,101,54.5%,53m
10859,2,[雾雨魔法森林]聊然,2863,1323,50,46,96,52.1%,18m
10859,2,阿仁科老师傅,2863,789,42,39,81,51.9%,32m
10859,1,VainGlory,2863,1093,42,45,87,48.3%,54m
10859,2,无言柳下,2863,969,39,35,74,52.7%,9m
10859,2,求尼玛老公抱,2863,277,35,37,72,48.6%,23m
10859,3,罗十一,2863,554,22,29,51,43.1%,54m
10859,2,星辰下的我们,2863,438,18,14,32,56.2%,9m
10859,1,统一酸菜牛肉面,2863,471,18,16,34,52.9%,21m
10859,2,StormCrow,2863,385,17,14,31,54.8%,6m
10859,2,[老油条战队]肥美的小羊羔,2863,350,13,12,25,52.0%,11m
10859,2,zcz,2863,232,8,7,15,53.3%,6m
10859,3,[奴家求勾搭]洛尘,2863,170,6,3,9,66.7%,7m
10859,2,拔丝光年,2863,38,4,3,7,57.1%,48m
10859,2,叶帛先生,2863,102,3,1,4,75.0%,9m
10859,3,NaiYouXueGao,2863,0,1,0,1,100.0%,15m
10859,3,上海周杰伦,2863,0,1,0,1,100.0%,12m
10859,2,还是叫伽罗瓦吧,2863,30,1,3,4,25.0%,15m
10859,2,大主教艾尔停电了,2863,0,1,4,5,20.0%,17m
10859,2,师傅,2863,30,1,5,6,16.7%,28m
10859,3,逍遥鹏,2863,0,0,1,1,0.0%,6m
10859,3,[笙风]柠檬橘子说拜拜,2863,0,0,1,1,0.0%,27m
10883,3,天涯浪子,2862,1330,146,154,300,48.7%,17m
10883,2,asdasd,2862,748,86,91,177,48.6%,11m
10883,3,FXY,2862,576,74,78,152,48.7%,12m
10883,2,[SteEng]最恨萌新,2862,1499,63,52,115,54.8%,26m
10883,2,[地大人]sass,2862,288,12,9,21,57.1%,23m
10883,2,IIIIIIIIIIII,2862,152,6,3,9,66.7%,10m
10883,2,以艾尔的滑稽为名,2862,200,6,6,12,50.0%,29m
10883,2,足智多谋的无钱,2862,148,6,7,13,46.2%,25m
10883,2,[中华汫武堂]人民革命军,2862,0,4,1,5,80.0%,36m
10883,3,EGOISTMoRan,2862,114,4,4,8,50.0%,4m
10883,3,黄泉回音,2862,84,2,6,8,25.0%,16m
10883,1,shadowkiller,2862,0,1,1,2,50.0%,1h
10883,2,[ToHost]我折跃进了死亡区,2862,0,1,1,2,50.0%,15m
10883,2,[奔跑吧供牺姬]於旻,2862,0,1,2,3,33.3%,19m
10883,2,[Beasty]不太聪明的亚子,2862,88,1,2,3,33.3%,1h
10883,2,打啥别打脸,2862,0,1,4,5,20.0%,11m
10883,3,apofh,2862,0,0,1,1,0.0%,22m
10883,3,[第六营游骑兵]Starcraf,2862,0,0,1,1,0.0%,27m
10883,3,[白丝使徒赛高]猪一样的队友,2862,0,0,1,1,0.0%,53m
10883,3,是维维呀,2862,0,0,1,1,0.0%,55m
10903,3,IlIIIIIIllll,2861,343,30,18,48,62.5%,52m
10903,2,[Aris]克利夫兰,2861,422,17,10,27,63.0%,26m
10903,3,恋上孤独,2861,441,17,16,33,51.5%,4m
10903,2,星际杀神,2861,343,16,7,23,69.6%,4m
10903,3,[NVKR]电竞老化石,2861,293,13,11,24,54.2%,12m
10903,2,PartinG,2861,151,10,10,20,50.0%,53m
10903,2,freedom,2861,262,8,9,17,47.1%,30m
10903,1,cannon,2861,259,7,7,14,50.0%,32m
10903,2,[丽日御茶茶]IIIIIIIIII,2861,214,7,12,19,36.8%,6m
10903,3,llllllllllll,2861,166,6,4,10,60.0%,12m
10903,3,吴潇楠,2861,199,5,5,10,50.0%,30m
10903,1,飞龙骑脸怎么输,2861,96,5,5,10,50.0%,1h
10903,3,[魔法少女小屋]EXmachina,2861,114,4,1,5,80.0%,52m
10903,3,不许你叫吴彦祖,2861,146,3,6,9,33.3%,40m
10903,1,[吕布保护鞋会]泰伦战神李老八,2861,0,1,0,1,100.0%,1h
10903,3,Uranus,2861,0,1,0,1,100.0%,32m
10903,2,弱鸡,2861,88,1,2,3,33.3%,13m
10903,2,布鲁仛,2861,30,1,4,5,20.0%,21m
10903,3,[黎明航向]王者的狗带,2861,0,0,1,1,0.0%,15m
10903,3,银色闪光亚丝娜,2861,0,0,1,1,0.0%,52m
10903,2,[斯巴达血战团]清甜奥利奥,2861,0,0,1,1,0.0%,28m
10924,2,夏天的风,2860,1517,214,187,401,53.4%,52m
10924,2,甜瓜,2860,1448,184,157,341,54.0%,26m
10924,2,宁静的心与夜,2860,1568,106,97,203,52.2%,12m
10924,2,[机械化虫群]HMC,2860,428,21,17,38,55.3%,32m
10924,3,暂隐,2860,463,19,13,32,59.4%,27m
10924,3,汉尼拔河丶,2860,362,15,11,26,57.7%,5m
10924,3,ThezGAgayY,2860,282,12,5,17,70.6%,6m
10924,3,天幻邪,2860,238,9,7,16,56.2%,52m
10924,3,京墨,2860,176,7,4,11,63.6%,7m
10924,1,迷失的盲人,2860,186,7,6,13,53.8%,1h
10924,2,[CNEB]SKTTossGirl,2860,58,3,4,7,42.9%,10m
10924,2,[HUC前衛]噬魂,2860,109,2,1,3,66.7%,14m
10924,3,EEnglish,2860,121,2,2,4,50.0%,53m
10924,2,[埃蒙调教团]rose,2860,114,2,3,5,40.0%,54m
10924,1,鸽子军团长,2860,0,2,5,7,28.6%,18m
10924,2,[混元星际小队]那梦境太过深刻,2860,60,2,7,9,22.2%,32m
10924,3,Ares,2860,30,1,1,2,50.0%,52m
10924,3,[乳主头子]Lastgop,2860,0,1,1,2,50.0%,55m
10924,3,艾尔之光,2860,30,1,1,2,50.0%,4m
10943,2,LastShadow,2859,1617,190,174,364,52.2%,23m
10943,2,[艾尔之巅]Nonesense,2859,798,43,38,81,53.1%,6m
10943,2,[上官秋月]Kangvins,2859,790,23,59,82,28.0%,31m
10943,1,一个热爱暴雪玩家,2859,318,11,16,27,40.7%,9m
10943,1,lies,2859,162,7,3,10,70.0%,1h
10943,2,[本子画师]对月亮讲晚安,2859,199,6,6,12,50.0%,4m
10943,3,[瘾大眼瞎]大和骑脸怎么输,2859,140,5,7,12,41.7%,27m
10943,3,[彩名保护协会]MVPGenius,2859,60,3,1,4,75.0%,51m
10943,3,克哈小兵,2859,104,3,3,6,50.0%,51m
10943,2,wfxdd,2859,90,3,5,8,37.5%,12m
10943,2,firmament,2859,92,3,7,10,30.0%,5m
10943,3,[NZNZ]近战艹龙法师,2859,0,1,0,1,100.0%,15m
10943,3,saber,2859,30,1,1,2,50.0%,22m
10943,3,[死者代言人]象征自由的男人,2859,30,1,1,2,50.0%,29m
10943,3,[啤酒小龙虾1]吕凯,2859,0,0,3,3,0.0%,29m
10958,2,冲芭芭拉鸭,2858,1287,55,44,99,55.6%,26m
10958,3,[五月花]trapper,2858,990,52,51,103,50.5%,6m
10958,2,闪亮之杖,2858,982,46,33,79,58.2%,4m
10958,3,[内华达数学系]Galois,2858,322,12,11,23,52.2%,7m
10958,1,吴主任,2858,284,11,9,20,55.0%,24m
10958,3,IIIIIIIIIIII,2858,193,7,8,15,46.7%,1h
10958,2,[月光]那遥远的雪,2858,148,6,7,13,46.2%,6m
10958,2,[我们很正经的]DrZou,2858,192,6,9,15,40.0%,54m
10958,2,[3A]业余渣子,2858,0,4,1,5,80.0%,1h
10958,3,我的小狗死得好惨,2858,86,4,1,5,80.0%,7m
10958,3,此人非良人,2858,112,3,7,10,30.0%,22m
10958,1,谁在呼叫舒哥,2858,0,2,5,7,28.6%,1h
10958,3,[问风]梦里不知身是客,2858,0,1,0,1,100.0%,14m
10958,3,[捌柒柒叁]旃东,2858,0,0,1,1,0.0%,22m
10958,3,寒冷,2858,0,0,2,2,0.0%,27m
10973,1,[DMRe]爱商熙欣晴,2857,1013,168,141,309,54.4%,57m
10973,2,innovation,2857,783,52,48,100,52.0%,11m
10973,1,CallMeAZ,2857,899,51,53,104,49.0%,17m
10973,2,[Fiend]初中什么样,2857,799,41,37,78,52.6%,36m
10973,3,[TAPC]龙迪,2857,845,40,27,67,59.7%,11m
10973,3,[Beasty]lei,2857,522,21,11,32,65.6%,52m
10973,2,[名人集团]星海游牧,2857,472,17,15,32,53.1%,26m
10973,2,神族归来,2857,396,14,18,32,43.8%,15m
10973,3,贺兰山,2857,246,11,12,23,47.8%,7m
10973,1,你的泡泡鱼丶,2857,227,10,7,17,58.8%,24m
10973,2,坏坏,2857,0,4,1,5,80.0%,1h
10973,2,夏侯惇,2857,0,3,2,5,60.0%,1h
10973,3,[萨尔那加之刃]tourist,2857,58,2,1,3,66.7%,26m
10973,2,[YOYOY]老毒虫,2857,114,2,3,5,40.0%,6m
10973,2,feel,2857,0,2,3,5,40.0%,43m
10973,3,凡星,2857,0,1,0,1,100.0%,56m
10973,2,银雷,2857,0,1,1,2,50.0%,53m
10973,2,ysy,2857,30,1,4,5,20.0%,53m
10973,3,月落银城,2857,0,0,1,1,0.0%,7m
10973,3,[斯巴达血战团]星际潜水员,2857,0,0,1,1,0.0%,1h
10973,3,Krobelus,2857,0,0,1,1,0.0%,9m
10973,3,[孤傲就完事]还是败给了时间,2857,0,0,2,2,0.0%,53m
10995,2,赛金花,2856,1064,142,122,264,53.8%,52m
10995,3,[T1one]我不会别打我,2856,867,39,30,69,56.5%,12m
10995,2,[三体]破壁人,2856,543,22,20,42,52.4%,26m
10995,3,吕布,2856,300,11,5,16,68.8%,27m
10995,2,鸡年大吉吧,2856,186,6,6,12,50.0%,54m
10995,2,[TJMU]MAGIC,2856,150,6,9,15,40.0%,18m
10995,2,伪善,2856,0,3,2,5,60.0%,1h
10995,3,[死亡大河]Mycroft,2856,30,2,1,3,66.7%,9m
10995,2,[Emc2]爱美的究极小迷妹,2856,30,2,2,4,50.0%,17m
10995,3,skyzo,2856,0,1,0,1,100.0%,7m
10995,1,黑八,2856,0,1,0,1,100.0%,45m
10995,3,太山,2856,30,1,1,2,50.0%,9m
10995,3,行情王最佳男友,2856,0,0,1,1,0.0%,18m
10995,3,Blank,2856,0,0,1,1,0.0%,22m
10995,3,十大名人,2856,0,0,2,2,0.0%,25m
11010,1,王得意,2855,965,216,207,423,51.1%,8m
11010,2,xuchaoya,2855,1631,206,189,395,52.2%,25m
11010,3,ForAiur,2855,1462,149,129,278,53.6%,29m
11010,2,蛮力之兽,2855,791,40,28,68,58.8%,4m
11010,2,杨威利,2855,375,17,14,31,54.8%,26m
11010,2,麦田守望芊,2855,318,14,12,26,53.8%,13m
11010,2,Timba,2855,386,13,18,31,41.9%,29m
11010,2,MagiCaL,2855,237,10,8,18,55.6%,11m
11010,3,untreBOSS,2855,219,9,7,16,56.2%,23m
11010,2,[Maiden]幺秀,2855,208,7,5,12,58.3%,46m
11010,2,大资本家,2855,214,7,10,17,41.2%,15m
11010,2,AAA,2855,0,4,1,5,80.0%,1h
11010,2,Alan,2855,144,4,4,8,50.0%,54m
11010,2,貝吉塔,2855,0,3,2,5,60.0%,58m
11010,2,YXiu,2855,74,3,5,8,37.5%,27m
11010,3,茫然的星灵,2855,30,2,1,3,66.7%,14m
11010,2,[舔茶神]Lancer,2855,30,2,4,6,33.3%,25m
11010,2,[地刺速埋协会]这就是地刺么,2855,95,2,4,6,33.3%,1h
11010,1,[南宁市动物园]七黑狒,2855,0,2,5,7,28.6%,17m
11010,2,雨落兰亭,2855,62,2,7,9,22.2%,29m
11010,3,君子剑,2855,0,1,0,1,100.0%,16m
11010,3,[格拉摩根领1]Napoleon,2855,30,1,2,3,33.3%,31m
11010,2,[菜就对了]qqq,2855,46,1,2,3,33.3%,43m
11010,2,[Smiths]longly,2855,30,1,4,5,20.0%,19m
11034,3,MeisterPanda,2854,882,49,43,92,53.3%,14m
11034,2,鹰巢城的伊鲁席尔,2854,354,14,13,27,51.9%,53m
11034,2,[蠢萌的大结界]rmb,2854,332,11,16,27,40.7%,15m
11034,1,LiEFenG,2854,227,8,6,14,57.1%,1h
11034,2,如月影,2854,218,8,8,16,50.0%,14m
11034,3,关谷,2854,129,6,2,8,75.0%,14m
11034,2,[第一序列]愚者,2854,148,5,8,13,38.5%,14m
11034,1,[暴雪我是你爹]天凌殇丶,2854,143,3,2,5,60.0%,39m
11034,1,[玫瑰十字会]沙漠风暴战神,2854,94,3,2,5,60.0%,1h
11034,3,玄门道人,2854,86,3,4,7,42.9%,22m
11034,1,FSSF,2854,48,2,0,2,100.0%,59m
11034,2,ChickenWings,2854,0,2,2,4,50.0%,58m
11034,2,拯救世界,2854,0,2,3,5,40.0%,38m
11034,3,雨落寒星,2854,0,1,0,1,100.0%,7m
11048,2,低调逃生,2853,1580,110,98,208,52.9%,14m
11048,2,痴心范,2853,996,47,29,76,61.8%,53m
11048,1,[SCMIW]笔芯,2853,941,36,35,71,50.7%,17m
11048,3,[翔安小分队]oGsMC,2853,340,13,8,21,61.9%,6m
11048,1,堂口的好兄弟,2853,258,6,7,13,46.2%,10m
11048,1,回忆灬人生,2853,0,5,2,7,71.4%,38m
11048,3,柠檬树树根,2853,0,4,4,8,50.0%,1h
11048,1,CnSiC,2853,139,3,1,4,75.0%,1h
11048,2,Tianlangxing,2853,0,3,2,5,60.0%,1h
11048,1,llllllllllll,2853,0,3,3,6,50.0%,1h
11048,2,Beefalo,2853,36,3,4,7,42.9%,52m
11048,2,白菜吃萝卜,2853,64,3,5,8,37.5%,58m
11048,3,Splendor,2853,30,2,0,2,100.0%,26m
11048,3,一杆咸鱼,2853,0,0,1,1,0.0%,15m
11048,3,我疯问佛,2853,0,0,1,1,0.0%,28m
11048,3,[中华讲武堂]可达鸭,2853,0,0,1,1,0.0%,29m
11048,1,喜欢冰激凌的鹌鹑,2853,0,0,2,2,0.0%,1h
11065,2,BBL,2852,1551,103,83,186,55.4%,15m
11065,2,NSK,2852,1083,43,38,81,53.1%,53m
11065,3,马大师,2852,1160,42,51,93,45.2%,12m
11065,2,TIME,2852,510,23,18,41,56.1%,11m
11065,1,[爱吃辣椒的猫]啦啦啦,2852,276,17,23,40,42.5%,7m
11065,3,amengkachi,2852,320,14,12,26,53.8%,57m
11065,2,新垣结衣,2852,236,10,6,16,62.5%,11m
11065,2,[inene]inene,2852,310,10,17,27,37.0%,14m
11065,3,Archer,2852,230,10,19,29,34.5%,13m
11065,2,爱情之谜,2852,220,7,6,13,53.8%,36m
11065,1,[小算草妙妙屋]snow,2852,130,5,13,18,27.8%,9m
11065,2,大魔王,2852,46,2,1,3,66.7%,43m
11065,3,电脑,2852,121,2,2,4,50.0%,26m
11065,2,[社团]LJP,2852,60,2,7,9,22.2%,15m
11065,2,史上可能最强人类,2852,46,1,1,2,50.0%,4m
11065,3,[金陵十二钗]左脸较大,2852,0,0,1,1,0.0%,52m
11065,2,可可,2852,0,0,1,1,0.0%,1h
11065,3,[你已经输啦]小花生,2852,0,0,1,1,0.0%,18m
11065,3,[A丶rise]石沉大海,2852,0,0,1,1,0.0%,28m
11065,2,冰霜雪狼,2852,0,0,3,3,0.0%,5m
11085,3,handsome,2851,1447,111,108,219,50.7%,15m
11085,3,幻影之舞,2851,1537,80,68,148,54.1%,6m
11085,3,老鹰,2851,985,53,30,83,63.9%,57m
11085,2,单身汉,2851,504,38,26,64,59.4%,22m
11085,2,[嘻哈战队]Zero,2851,735,31,23,54,57.4%,7m
11085,3,看你个锤子看,2851,718,29,25,54,53.7%,18m
11085,3,小雨下大了,2851,500,22,8,30,73.3%,52m
11085,3,二零二零脱单成功,2851,473,19,12,31,61.3%,5m
11085,2,吉吉鸡,2851,414,19,17,36,52.8%,21m
11085,2,hsh,2851,265,15,14,29,51.7%,14m
11085,2,[Ps]WomenKing,2851,303,11,8,19,57.9%,28m
11085,3,[落魄山]TrickyZerg,2851,308,11,8,19,57.9%,22m
11085,2,[桃园结义]逆鳞,2851,311,11,11,22,50.0%,18m
11085,3,DEMAND,2851,210,8,3,11,72.7%,9m
11085,3,[谐星集训]必胜,2851,146,7,5,12,58.3%,23m
11085,2,Classic,2851,182,7,6,13,53.8%,16m
11085,3,Trap,2851,160,6,2,8,75.0%,51m
11085,2,pOIv,2851,178,6,11,17,35.3%,15m
11085,3,[怎么赢P]一束七,2851,195,5,10,15,33.3%,26m
11085,3,[火焰雷兽]IIIIIIIIIIII,2851,88,4,2,6,66.7%,28m
11085,1,教练的朋友,2851,130,4,14,18,22.2%,8m
11085,3,silentsky,2851,60,3,1,4,75.0%,22m
11085,1,金拱门,2851,0,3,3,6,50.0%,1h
11085,2,[光影议会]鸽斯拉,2851,115,2,2,4,50.0%,24m
11085,2,妖刀,2851,0,1,2,3,33.3%,53m
11085,3,[星际一号]心向吾爱,2851,0,0,1,1,0.0%,4m
11111,2,[星战分部]thewolfwolf,2850,1356,60,45,105,57.1%,12m
11111,2,吉祥,2850,971,51,40,91,56.0%,13m
11111,2,[小鸡屠宰场9]晓看风云,2850,666,26,24,50,52.0%,16m
11111,1,血锋修罗心,2850,248,12,11,23,52.2%,10m
11111,2,Alexmores,2850,333,11,11,22,50.0%,25m
11111,2,你的童鞋,2850,308,10,18,28,35.7%,32m
11111,2,雄霸天下,2850,95,5,1,6,83.3%,1h
11111,1,血耀丶宇,2850,0,5,2,7,71.4%,50m
11111,1,[小菜逼]烧玻璃爱好者,2850,130,5,3,8,62.5%,1h
11111,2,[哦耶]Loi,2850,32,2,3,5,40.0%,4m
11111,3,[黑丝小幼女]阿疯,2850,30,1,2,3,33.3%,56m
11111,2,ICE,2850,30,1,4,5,20.0%,58m
11111,1,[大秦万世]为了地球,2850,0,0,1,1,0.0%,1h
11111,3,IIIIIIIIII,2850,0,0,2,2,0.0%,28m
11111,2,[YINGJI]酒恋轩,2850,0,0,5,5,0.0%,1h
11126,3,asfbesrdf,2849,1513,555,547,1102,50.4%,14m
11126,2,[旺旺战士]woolf,2849,1484,113,92,205,55.1%,21m
11126,2,FlyCreeper,2849,692,88,79,167,52.7%,16m
11126,2,LUREN,2849,1426,83,78,161,51.6%,17m
11126,2,[探姬同萌会]嫌疑喵,2849,1012,57,51,108,52.8%,26m
11126,2,Listen,2849,789,30,31,61,49.2%,54m
11126,3,[妮妮专属]Antonerl,2849,536,24,10,34,70.6%,31m
11126,1,内有大叔,2849,537,23,19,42,54.8%,10m
11126,3,谁在呼叫舰队,2849,414,17,13,30,56.7%,11m
11126,3,[谐会]VolLor,2849,321,13,13,26,50.0%,25m
11126,3,天哥无双,2849,136,9,3,12,75.0%,22m
11126,2,[天子这大菜B]不会白给的必杀,2849,171,5,1,6,83.3%,1h
11126,2,春日野悠,2849,115,5,6,11,45.5%,11m
11126,3,[渾元星际]llllllllllll,2849,76,4,1,5,80.0%,14m
11126,3,scared,2849,88,3,4,7,42.9%,6m
11126,2,[DMR]石头,2849,96,3,11,14,21.4%,16m
11126,3,IIIIIIIIIIII,2849,96,2,1,3,66.7%,29m
11126,3,sugaRe,2849,58,2,2,4,50.0%,30m
11126,3,Unqiue,2849,97,2,2,4,50.0%,52m
11126,2,兄弟情深雷日天,2849,0,2,3,5,40.0%,1h
11126,2,炉石结,2849,0,2,3,5,40.0%,4m
11126,3,疯狂大几吧,2849,0,1,0,1,100.0%,57m
11126,3,NTRbiss,2849,0,0,1,1,0.0%,9m
11126,1,咱没有名气,2849,0,0,1,1,0.0%,53m
11150,2,Darkness,2848,1311,108,83,191,56.5%,36m
11150,2,天之轿子,2848,639,28,25,53,52.8%,13m
11150,2,[奔驰何平]梁非凡,2848,564,24,15,39,61.5%,7m
11150,3,梦幻迷途之境,2848,299,12,8,20,60.0%,7m
11150,2,[四大发明]指南针,2848,348,12,16,28,42.9%,36m
11150,3,HyeokMin,2848,107,8,7,15,53.3%,7m
11150,2,[CoWo]irishman,2848,209,7,8,15,46.7%,26m
11150,3,我又不浪,2848,182,6,8,14,42.9%,26m
11150,2,一刀一个源石虫,2848,144,4,4,8,50.0%,26m
11150,3,不知是醉,2848,58,3,1,4,75.0%,14m
11150,3,[小鸡屠宰场a]fly,2848,60,3,2,5,60.0%,27m
11150,2,PartinG,2848,90,3,7,10,30.0%,10m
11150,2,零零小林,2848,102,2,3,5,40.0%,4m
11150,3,[魏无羡的魔笛]serral,2848,0,1,0,1,100.0%,9m
11150,1,园游会丶,2848,0,1,2,3,33.3%,15m
11150,3,暗夜之鸦,2848,0,0,2,2,0.0%,27m
11166,2,[浙大战队]失去单身的幽忧,2847,1054,81,65,146,55.5%,32m
11166,1,HaoTian,2847,1439,61,72,133,45.9%,15m
11166,2,卖女孩的小火柴,2847,721,34,21,55,61.8%,26m
11166,2,[暴雪十五队]honggl,2847,707,25,26,51,49.0%,8m
11166,3,QHlight,2847,494,18,15,33,54.5%,57m
11166,2,MAXPLANK,2847,433,17,13,30,56.7%,8m
11166,2,逃跑冠军丶,2847,468,17,16,33,51.5%,29m
11166,2,[内华达数学系]CanVas,2847,254,10,7,17,58.8%,56m
11166,3,表姐,2847,219,9,7,16,56.2%,1h
11166,2,[EC]黑猫,2847,226,8,13,21,38.1%,53m
11166,3,[星际一号]Ranger,2847,235,7,3,10,70.0%,22m
11166,3,llllllll,2847,166,7,5,12,58.3%,22m
11166,2,饭泡饭,2847,173,7,11,18,38.9%,17m
11166,2,病名为鹬,2847,0,5,0,5,100.0%,43m
11166,2,恐惧,2847,168,5,1,6,83.3%,1h
11166,2,[北极光小组]sorenblu,2847,140,5,3,8,62.5%,7m
11166,2,[老司机嘀嘀嘀]我的金箍棒呢,2847,140,4,3,7,57.1%,1h
11166,2,好小一只妍妍,2847,88,4,6,10,40.0%,53m
11166,2,[雾雨魔法森林]空空空,2847,134,4,9,13,30.8%,11m
11166,2,[笨比杀手]justinxue,2847,121,3,2,5,60.0%,11m
11166,2,[眷族]永恒的独行者,2847,30,2,3,5,40.0%,54m
11166,2,你永远不懂我的爱,2847,0,1,0,1,100.0%,1h
11166,1,[YiHz]那是谁,2847,0,1,0,1,100.0%,1h
11166,3,[XYFANS]一个菜鸟,2847,0,1,0,1,100.0%,54m
11166,3,残梦难复,2847,0,1,0,1,100.0%,22m
11166,3,旧梦初醒丶已千年,2847,0,1,0,1,100.0%,4m
11166,3,风之谷,2847,0,0,1,1,0.0%,15m
11166,3,剑雨情殇,2847,0,0,1,1,0.0%,53m
11166,1,[SGGame]慵懒的白球,2847,0,0,2,2,0.0%,59m
11166,2,我是三三啊,2847,0,0,5,5,0.0%,52m
11196,2,JioRyo,2846,919,159,156,315,50.5%,18m
11196,2,[田中姬铃木雏]艾尔吴彦祖,2846,1573,144,114,258,55.8%,8m
11196,2,[真实之泪]石动乃绘,2846,1076,131,130,261,50.2%,29m
11196,3,长予天,2846,1563,94,82,176,53.4%,14m
11196,1,大哥,2846,1421,56,54,110,50.9%,8m
11196,2,TaU,2846,350,46,26,72,63.9%,36m
11196,2,[孙哥的海鲜]Atalanta,2846,724,32,24,56,57.1%,15m
11196,2,[镜花水月丨]霸气的辰哥,2846,616,22,23,45,48.9%,12m
11196,3,[往事]我得重新集结部队,2846,383,15,4,19,78.9%,2m
11196,2,隔壁老猫猫,2846,239,15,15,30,50.0%,11m
11196,2,TheShy,2846,187,11,8,19,57.9%,19m
11196,3,SunSky,2846,186,9,16,25,36.0%,23m
11196,3,nale,2846,142,6,3,9,66.7%,22m
11196,3,[大鸟]除膜道人,2846,140,6,5,11,54.5%,7m
11196,3,[刺蛇互助社团]众星,2846,140,5,2,7,71.4%,57m
11196,2,magisk,2846,95,3,3,6,50.0%,1h
11196,2,aier,2846,88,2,2,4,50.0%,11m
11196,2,Mofrom,2846,30,2,3,5,40.0%,2m
11196,3,[Brs]请先打我队友,2846,0,1,0,1,100.0%,29m
11196,3,Demon,2846,30,1,1,2,50.0%,27m
11196,3,悠云孤鸿,2846,30,1,2,3,33.3%,2m
11196,2,八级大狂风,2846,0,1,2,3,33.3%,32m
11196,3,[Kindre]牧场,2846,0,0,1,1,0.0%,2m
11196,3,[Onceme]Innat,2846,0,0,1,1,0.0%,5m
11196,2,leon,2846,0,0,5,5,0.0%,11m
11221,2,lise,2845,1376,200,188,388,51.5%,7m
11221,2,[终极咸鱼]仙人爷爷,2845,511,62,60,122,50.8%,29m
11221,3,[C09]手游废宅,2845,1305,57,38,95,60.0%,7m
11221,2,Stom,2845,1132,52,46,98,53.1%,11m
11221,2,[兆景埋土大学]Leslie,2845,662,28,25,53,52.8%,13m
11221,2,牛旭蓬,2845,584,26,18,44,59.1%,32m
11221,1,成神也烦,2845,526,20,23,43,46.5%,17m
11221,2,御剑冥夜,2845,330,15,12,27,55.6%,11m
11221,3,[白鸦]BTseven,2845,231,8,2,10,80.0%,15m
11221,3,依山观澜,2845,229,8,6,14,57.1%,1h
11221,1,KyMugen,2845,96,5,5,10,50.0%,54m
11221,3,[整合]天下最萌小静怡,2845,114,3,2,5,60.0%,29m
11221,2,[幻想乡核电站]灰之魔女丶伊蕾娜,2845,0,3,2,5,60.0%,1h
11221,2,仁义无双总司令,2845,60,3,7,10,30.0%,12m
11221,1,学习学疯了,2845,60,3,7,10,30.0%,8m
11221,3,[注意防守]黑桐,2845,30,2,1,3,66.7%,58m
11221,3,浅巷墨漓,2845,0,1,0,1,100.0%,6m
11221,2,QuadStacker,2845,0,1,2,3,33.3%,58m
11221,2,Remedios,2845,0,1,2,3,33.3%,16m
11221,3,[倚栏夜听雨]九尾狐妃,2845,0,0,2,2,0.0%,56m
11221,2,这分段还有条码人,2845,0,0,4,4,0.0%,19m
11242,1,[Ttree]临阵,2844,904,67,66,133,50.4%,8m
11242,2,晓陌陌,2844,702,56,49,105,53.3%,2m
11242,1,紫电,2844,1268,45,50,95,47.4%,7m
11242,1,[香港]对面的煞笔没有妈,2844,731,27,40,67,40.3%,17m
11242,1,[De丶幺菱泗]Gungnir,2844,517,19,21,40,47.5%,29m
11242,2,[血鸦旅馆]CRZRY,2844,116,6,5,11,54.5%,23m
11242,2,humudne,2844,156,6,9,15,40.0%,11m
11242,2,拱火天喵孙一峰,2844,86,4,4,8,50.0%,1h
11242,2,闪现大龙,2844,0,2,0,2,100.0%,1h
11242,2,天涯雪静,2844,30,2,3,5,40.0%,55m
11242,3,MASTERLEO,2844,30,1,1,2,50.0%,15m
11242,3,[立华奏]立华奏,2844,0,0,1,1,0.0%,32m
11242,3,泡泡茶壶,2844,0,0,1,1,0.0%,30m
11242,3,Ghost,2844,0,0,1,1,0.0%,32m
11242,1,[歌者]ever,2844,0,0,2,2,0.0%,58m
11242,3,LanzhouLYB,2844,0,0,2,2,0.0%,2m
11258,2,减肥二十斤,2843,1553,81,86,167,48.5%,23m
11258,3,soldier,2843,1045,43,30,73,58.9%,7m
11258,3,紫气东来,2843,472,37,26,63,58.7%,30m
11258,2,[要啥没啥爱咋]玄学师,2843,460,35,24,59,59.3%,23m
11258,2,华仔给的忘情水,2843,176,24,25,49,49.0%,21m
11258,2,[虚拟歌手团体]逗比的战舰,2843,466,19,18,37,51.4%,8m
11258,2,[马保国]实验狗招专用号,2843,360,18,13,31,58.1%,17m
11258,3,STATE,2843,426,17,8,25,68.0%,56m
11258,3,上进的吹风机,2843,227,9,6,15,60.0%,1h
11258,2,deer,2843,169,6,4,10,60.0%,14m
11258,3,ZZZ,2843,148,6,4,10,60.0%,56m
11258,1,hehuaqi,2843,135,5,4,9,55.6%,55m
11258,3,[Beasty]避雷针,2843,86,4,2,6,66.7%,27m
11258,2,[PGR]李铱,2843,60,3,9,12,25.0%,27m
11258,1,狗不讲武德,2843,66,2,11,13,15.4%,8m
11258,2,mydream,2843,0,1,0,1,100.0%,1h
11258,3,[骚话]凉粉,2843,0,1,0,1,100.0%,58m
11258,3,[吃喝睡打埃蒙]夜痕,2843,0,1,1,2,50.0%,9m
11258,2,吴氏,2843,0,1,1,2,50.0%,1h
11258,3,[我们都相当菜]嫩竹的辉夜姬,2843,0,0,1,1,0.0%,15m
11258,3,[始祖龟求知者]蕾米莉亚天下第一,2843,0,0,1,1,0.0%,30m
11258,3,[天子这大菜B]萌新呀,2843,0,0,1,1,0.0%,57m
11258,3,[我们真学不来]不过尔尔,2843,0,0,2,2,0.0%,2m
11281,2,不要以为你赢了,2842,1196,159,142,301,52.8%,29m
11281,1,永恒的秩序,2842,1232,56,62,118,47.5%,18m
11281,3,[AOT]LHooM,2842,1037,46,28,74,62.2%,31m
11281,2,莣煜,2842,952,43,34,77,55.8%,20m
11281,2,[LyN]就是这么叼,2842,919,38,41,79,48.1%,11m
11281,1,哒稽姬,2842,813,28,31,59,47.5%,18m
11281,1,buriedmelife,2842,344,14,9,23,60.9%,1h
11281,3,Reminiscence,2842,191,8,5,13,61.5%,6m
11281,3,HAHAHA,2842,195,7,4,11,63.6%,1h
11281,1,iiinterestin,2842,48,4,5,9,44.4%,1h
11281,2,无色清风,2842,94,3,3,6,50.0%,1h
11281,2,HealerTTTTTT,2842,0,2,2,4,50.0%,36m
11281,3,汝可识得此阵,2842,34,2,2,4,50.0%,29m
11281,3,goldenstar,2842,0,1,0,1,100.0%,27m
11281,3,[吃原味麻酱]史诗之蛙,2842,0,1,0,1,100.0%,30m
11281,3,selion,2842,0,0,2,2,0.0%,56m
11281,3,guzhidao,2842,0,0,3,3,0.0%,22m
11281,2,tyt,2842,0,0,3,3,0.0%,7m
11299,2,[WLA]White,2841,934,140,131,271,51.7%,29m
11299,2,[SiW]山的哩,2841,378,13,16,29,44.8%,13m
11299,1,打星际你快乐吗,2841,202,7,14,21,33.3%,8m
11299,2,[萨丶]紫晶之殿丶,2841,142,5,3,8,62.5%,10m
11299,2,litsee,2841,95,4,2,6,66.7%,43m
11299,2,pain,2841,48,4,4,8,50.0%,20m
11299,2,[燃烧军团之怒]穿过海的尹璇,2841,0,3,2,5,60.0%,6m
11299,2,zhou,2841,0,3,2,5,60.0%,1h
11299,3,[真理高中]喀秋莎,2841,86,3,2,5,60.0%,7m
11299,3,[仙豆]一库,2841,0,2,3,5,40.0%,26m
11299,2,狗骑,2841,95,1,1,2,50.0%,44m
11299,3,子非鱼,2841,30,1,2,3,33.3%,2m
11299,2,[星域神界]apple,2841,94,1,5,6,16.7%,1h
11312,2,Alsatian,2840,540,84,82,166,50.6%,10m
11312,2,zerger,2840,1079,43,39,82,52.4%,13m
11312,1,[养生会馆]Kevin,2840,370,31,34,65,47.7%,32m
11312,3,lykmagic,2840,342,21,17,38,55.3%,18m
11312,2,农夫三拳,2840,379,15,11,26,57.7%,2m
11312,2,城市化就输不了,2840,336,13,11,24,54.2%,14m
11312,3,[KPG]凯莎女王赛高,2840,311,11,5,16,68.8%,9m
11312,2,巴巴罗萨,2840,252,10,18,28,35.7%,29m
11312,3,乱世,2840,223,9,1,10,90.0%,6m
11312,2,羽兮,2840,267,9,9,18,50.0%,26m
11312,2,colintao,2840,232,8,7,15,53.3%,15m
11312,2,ElecTricKiss,2840,183,6,5,11,54.5%,1h
11312,2,老婆随时找我,2840,152,4,5,9,44.4%,15m
11312,1,星途,2840,116,3,1,4,75.0%,1h
11312,2,joker,2840,88,3,3,6,50.0%,11m
11312,1,Dear,2840,0,3,3,6,50.0%,1m
11312,3,lijikai,2840,30,2,1,3,66.7%,58m
11312,3,longinus,2840,58,2,2,4,50.0%,58m
11312,1,[熊大和熊二]一波流大师,2840,0,1,0,1,100.0%,12m
11312,3,[戴德给拇]禅璃子单推夏色祭,2840,0,1,0,1,100.0%,30m
11312,3,[NUC]IIIIIIIIIIII,2840,30,1,1,2,50.0%,56m
11312,3,我真不会玩,2840,0,1,1,2,50.0%,29m
11312,3,Leunger,2840,30,1,2,3,33.3%,8m
11312,2,IIIIIIIIIIII,2840,0,0,1,1,0.0%,50m
11312,3,Mayflower,2840,0,0,2,2,0.0%,2m
11312,3,锤子大帝,2840,0,0,2,2,0.0%,7m
11338,2,njukiller,2839,235,85,82,167,50.9%,12m
11338,1,IIIIIIIIIIII,2839,916,69,62,131,52.7%,21m
11338,1,[新宿三丁目]佩恩,2839,576,42,41,83,50.6%,16m
11338,3,[Nao]艾尔学院,2839,442,18,15,33,54.5%,7m
11338,3,Ruin,2839,384,13,10,23,56.5%,27m
11338,3,destiny,2839,114,4,5,9,44.4%,2m
11338,2,TYTY,2839,95,2,0,2,100.0%,52m
11338,3,群殴无敌菜鸟,2839,0,1,1,2,50.0%,32m
11338,3,[上帝之首]vallix,2839,30,1,1,2,50.0%,29m
11338,3,[幻想舰队]天空的低语,2839,30,1,1,2,50.0%,7m
11338,2,烟火,2839,0,0,1,1,0.0%,1h
11338,3,[21CM]止战之殇,2839,0,0,1,1,0.0%,22m
11338,3,shine,2839,0,0,1,1,0.0%,27m
11338,3,寡妇梦见秋,2839,0,0,1,1,0.0%,4m
11338,3,[CPT]TheGua,2839,0,0,3,3,0.0%,8m
11353,1,LIN,2838,1434,128,126,254,50.4%,4m
11353,3,心急大神,2838,910,81,64,145,55.9%,29m
11353,2,她说五十一级爱我,2838,1214,75,58,133,56.4%,26m
11353,3,NAXX,2838,688,24,24,48,50.0%,57m
11353,3,猎妈人,2838,379,15,16,31,48.4%,27m
11353,3,早睡早起,2838,279,13,4,17,76.5%,15m
11353,2,耗子拿刀找猫,2838,168,6,9,15,40.0%,3m
11353,2,吾恋椿楸,2838,138,5,3,8,62.5%,1h
11353,3,[飞跃来]丧心病狂好丽友,2838,120,4,6,10,40.0%,4m
11353,3,我爱熊爱洁,2838,88,3,2,5,60.0%,22m
11353,2,千夜,2838,114,3,3,6,50.0%,29m
11353,3,[0710]Lollipop,2838,30,2,2,4,50.0%,56m
11353,2,[子小一口苗]子小火央亻圭,2838,30,2,3,5,40.0%,11m
11353,2,[萌帝国]kuroko,2838,0,2,3,5,40.0%,17m
11353,3,[暴雪八队]DarkRanger,2838,0,1,0,1,100.0%,27m
11353,3,熊本,2838,0,1,0,1,100.0%,27m
11353,3,XboxMcutL,2838,0,1,0,1,100.0%,8m
11353,1,[KTK]稻叶姬子,2838,0,1,1,2,50.0%,12m
11353,2,老羊,2838,0,1,1,2,50.0%,1h
11353,1,clkirito,2838,0,1,1,2,50.0%,32m
11353,3,漆黑晨星,2838,0,0,1,1,0.0%,27m
11353,3,火鸡味的大锅巴,2838,0,0,1,1,0.0%,31m
11375,2,星月心阅,2837,1532,80,57,137,58.4%,17m
11375,3,[Sagume]Duck,2837,1202,67,45,112,59.8%,31m
11375,2,JackieChan,2837,408,29,28,57,50.9%,6m
11375,2,[Aalis]ShiNoGu,2837,137,15,13,28,53.6%,5m
11375,1,prototype,2837,347,13,12,25,52.0%,57m
11375,1,[炸鱼大队]上海老鸡,2837,368,11,21,32,34.4%,57m
11375,3,黑暗圣老虎,2837,196,9,6,15,60.0%,8m
11375,3,喻奕扬,2837,145,6,5,11,54.5%,1h
11375,3,我一下就,2837,0,4,4,8,50.0%,22m
11375,3,Alonso,2837,114,4,6,10,40.0%,27m
11375,3,Pairous,2837,86,3,1,4,75.0%,56m
11375,1,[CPT]大王叫我来巡山,2837,0,1,2,3,33.3%,1h
11375,2,kegemo,2837,92,1,3,4,25.0%,1h
11375,3,啊塔妮丝,2837,0,0,1,1,0.0%,22m
11375,1,堡垒说的对啊,2837,0,0,1,1,0.0%,11m
11375,3,[lxh123]alleria,2837,0,0,1,1,0.0%,3m
11375,3,森卅,2837,0,0,1,1,0.0%,3m
11392,3,firefly,2836,578,45,29,74,60.8%,18m
11392,2,得过且过,2836,429,35,29,64,54.7%,21m
11392,3,肉山的魔王,2836,394,16,11,27,59.3%,31m
11392,2,[夜未央]永夜,2836,265,12,13,25,48.0%,25m
11392,1,[丹东男神天团]scv,2836,316,12,13,25,48.0%,52m
11392,3,夏色祭,2836,307,11,6,17,64.7%,15m
11392,1,imbaliu,2836,314,11,9,20,55.0%,1h
11392,3,Asinlcy,2836,140,5,5,10,50.0%,7m
11392,2,DOIT,2836,139,2,1,3,66.7%,1h
11392,2,Duranning,2836,88,1,3,4,25.0%,11m
11392,3,去看海,2836,0,0,1,1,0.0%,58m
11392,3,[3GPP]梁某,2836,0,0,1,1,0.0%,2m
11392,2,阳光好刺眼,2836,0,0,4,4,0.0%,3m
11405,1,快乐白给,2835,1257,140,119,259,54.1%,13m
11405,3,虫族我是你爹,2835,876,99,85,184,53.8%,31m
11405,2,只会憋航母,2835,967,40,32,72,55.6%,19m
11405,3,破坏神,2835,565,21,17,38,55.3%,56m
11405,2,evangelioner,2835,389,20,20,40,50.0%,5m
11405,2,weinima,2835,370,13,14,27,48.1%,23m
11405,2,[爱国]硬柿子,2835,272,10,8,18,55.6%,59m
11405,3,[灌灌灌灌0]darkbreak,2835,245,8,5,13,61.5%,5m
11405,3,黄花菜蒸扣肉,2835,218,8,8,16,50.0%,18m
11405,2,[幽冥之狼]KotoriItsuka,2835,198,8,9,17,47.1%,23m
11405,1,逆亡,2835,235,7,8,15,46.7%,1h
11405,3,HalloweenNC,2835,170,6,6,12,50.0%,5m
11405,1,ddaihong,2835,142,6,6,12,50.0%,1h
11405,3,Joker,2835,113,5,1,6,83.3%,26m
11405,2,[老炼铜术士]Hidenyer,2835,88,4,6,10,40.0%,12m
11405,2,SmallStrong,2835,0,3,2,5,60.0%,17m
11405,2,Corvuscy,2835,0,3,2,5,60.0%,1h
11405,2,Number,2835,98,2,3,5,40.0%,1h
11405,3,[只会xx一波]只会光子炮台一波,2835,0,1,0,1,100.0%,2m
11405,3,幻灵,2835,0,0,1,1,0.0%,1h
11405,3,[梦瑾空人心]斯文,2835,0,0,1,1,0.0%,12m
11405,2,Joker,2835,0,0,1,1,0.0%,1h
11405,3,[MDT]火翼,2835,0,0,2,2,0.0%,23m
11405,3,喜相逢,2835,0,0,2,2,0.0%,15m
11429,1,Adma,2834,1529,134,138,272,49.3%,30m
11429,2,stc,2834,942,86,73,159,54.1%,15m
11429,2,[永不灭的战火]飞机哥哥,2834,622,24,28,52,46.2%,11m
11429,3,[至翼二中]JackMx,2834,488,19,13,32,59.4%,56m
11429,2,我是大神不怕你耶,2834,367,14,14,28,50.0%,7m
11429,1,BlueIce,2834,353,13,17,30,43.3%,8m
11429,3,sdf,2834,198,8,4,12,66.7%,27m
11429,1,科普卢星区区长,2834,169,7,8,15,46.7%,42m
11429,3,小怂,2834,159,6,5,11,54.5%,2m
11429,1,无月夜,2834,138,5,4,9,55.6%,1h
11429,2,[knsk]国民老婆孙一峰,2834,157,5,5,10,50.0%,20m
11429,1,fancis,2834,143,5,5,10,50.0%,1h
11429,1,[SC2018]LGD,2834,164,5,10,15,33.3%,24m
11429,1,风暴一号,2834,46,4,4,8,50.0%,1h
11429,1,xukong,2834,96,4,4,8,50.0%,1h
11429,2,想想吕布会怎么做,2834,186,4,6,10,40.0%,30m
11429,2,[穿梭]厉夜白,2834,88,4,7,11,36.4%,29m
11429,3,[斧头帮OL]封魔,2834,126,3,1,4,75.0%,5m
11429,3,Aoip,2834,132,3,3,6,50.0%,15m
11429,3,[第九舰队丶]cannibai,2834,30,2,0,2,100.0%,15m
11429,2,llllllllllll,2834,94,2,3,5,40.0%,1h
11429,3,[镜花水月丨]长剑遗琴,2834,0,1,0,1,100.0%,15m
11429,3,星际浪子,2834,0,0,1,1,0.0%,32m
11429,3,均枭,2834,0,0,1,1,0.0%,58m
11429,3,[写进诗的结尾]七里香,2834,0,0,1,1,0.0%,57m
11429,3,[沙星部]Terry,2834,0,0,2,2,0.0%,14m
11455,2,[火焰雷兽]我爱祖国,2833,701,83,68,151,55.0%,26m
11455,2,DALI,2833,982,44,32,76,57.9%,2m
11455,3,[歌者]叶子言,2833,1005,41,34,75,54.7%,15m
11455,3,奔雷手,2833,528,23,15,38,60.5%,58m
11455,1,[712下北泽]桂花糊骑士,2833,529,23,27,50,46.0%,4m
11455,2,雪狼小飞,2833,540,21,19,40,52.5%,3m
11455,3,[萌新集结地]金色萌新啊喵,2833,448,18,15,33,54.5%,31m
11455,2,CWcgz,2833,400,16,13,29,55.2%,58m
11455,3,[FIFA]loveTT,2833,315,11,6,17,64.7%,3m
11455,2,愤怒者,2833,267,10,13,23,43.5%,15m
11455,1,不安,2833,286,9,17,26,34.6%,1h
11455,3,一心向佛阿门,2833,114,5,3,8,62.5%,15m
11455,3,学种田,2833,166,5,3,8,62.5%,1h
11455,3,拍拍熊,2833,68,4,7,11,36.4%,13m
11455,2,来自彼岸的凋零,2833,0,3,1,4,75.0%,10m
11455,1,博丽灵梦,2833,142,3,2,5,60.0%,11m
11455,2,凛冬将至,2833,96,3,3,6,50.0%,43m
11455,3,[萌萌哒萌萌哒]尼古拉斯贾富贵,2833,0,1,0,1,100.0%,15m
11455,3,[黄金老中医]GLHF,2833,0,1,0,1,100.0%,2m
11455,3,夏洛克的书签,2833,30,1,2,3,33.3%,29m
11455,3,[战旗第一分队]伤灬影子,2833,0,0,1,1,0.0%,2m
11455,3,[镜花水月]黎明审判,2833,0,0,1,1,0.0%,4m
11455,3,[新手保护协会]Bard,2833,0,0,1,1,0.0%,2m
11455,3,[WARZER]dog,2833,0,0,2,2,0.0%,32m
11479,1,陨落星辰,2832,1610,120,118,238,50.4%,10m
11479,2,LOL,2832,1633,90,86,176,51.1%,12m
11479,3,JERRY,2832,1135,87,71,158,55.1%,18m
11479,2,MarineKing,2832,911,66,64,130,50.8%,7m
11479,3,[黑白条神教]亚顿,2832,730,37,10,47,78.7%,9m
11479,3,[月之所在RI]Anchor,2832,142,5,3,8,62.5%,15m
11479,1,Quicksand,2832,97,5,3,8,62.5%,21m
11479,3,MagejiTerran,2832,143,4,5,9,44.4%,1h
11479,3,[SoloAs]冰枫,2832,58,3,2,5,60.0%,1m
11479,3,[末世纪]七濑的小迷弟,2832,60,3,2,5,60.0%,57m
11479,3,[野人time]白河愁,2832,58,2,2,4,50.0%,28m
11479,1,明过江南,2832,97,2,2,4,50.0%,29m
11479,3,朮拒,2832,0,1,0,1,100.0%,31m
11479,3,你不要过来啊,2832,30,1,4,5,20.0%,58m
11479,3,艾路蕾朵,2832,0,0,1,1,0.0%,31m
11479,2,[柠檬保护协会]aaa,2832,0,0,1,1,0.0%,1h
11495,3,[鸡家军]TongHickey,2831,499,20,11,31,64.5%,12m
11495,3,云之遥,2831,530,19,20,39,48.7%,58m
11495,2,Crimmmm,2831,363,14,12,26,53.8%,12m
11495,3,[AFSC2]Stats,2831,382,14,12,26,53.8%,1m
11495,3,一二三,2831,294,10,4,14,71.4%,2m
11495,3,[dgxfd]Awou,2831,250,9,7,16,56.2%,56m
11495,1,低调的喃喃,2831,294,9,19,28,32.1%,55m
11495,1,龙院吕小布,2831,175,7,8,15,46.7%,8m
11495,1,星宇,2831,197,7,10,17,41.2%,7m
11495,1,[情谊至上]有梦想的人不睡觉,2831,73,4,3,7,57.1%,1h
11495,3,Excalibur,2831,128,4,17,21,19.0%,8m
11495,3,血溅鸳鸯楼,2831,121,3,2,5,60.0%,1h
11495,3,Whimsy,2831,0,1,0,1,100.0%,2m
11495,1,[老司机翻车2]丑桔,2831,96,1,1,2,50.0%,21m
11495,3,[教父遇刺]孙哥屁屁好翘,2831,30,1,2,3,33.3%,29m
11495,2,[孤傲就完事]Novhope,2831,0,1,2,3,33.3%,1h
11495,3,Timothy,2831,30,1,2,3,33.3%,57m
11495,3,[最菜战队]forever,2831,0,0,1,1,0.0%,25m
11495,2,[北有吾王1队]孙焕佳,2831,0,0,2,2,0.0%,1h
11495,2,[HCG]Violet,2831,0,0,2,2,0.0%,14m
11495,3,奥斯卡丁,2831,0,0,3,3,0.0%,58m
11516,2,[KPG2]Megatron,2830,1425,100,83,183,54.6%,8m
11516,2,fantasy,2830,1082,46,38,84,54.8%,7m
11516,2,[黎明航向]Ozine,2830,700,25,28,53,47.2%,3m
11516,2,梦幻星眼,2830,541,21,18,39,53.8%,32m
11516,2,[滑稽联盟]魅惑,2830,472,18,21,39,46.2%,2m
11516,3,BOSS,2830,136,6,2,8,75.0%,7m
11516,1,[暴雪三十一队]三哥,2830,144,6,6,12,50.0%,1h
11516,3,[麻酱万岁]残酷的电脑,2830,114,5,2,7,71.4%,27m
11516,2,[Au丶Mus]llllllllll,2830,62,3,5,8,37.5%,55m
11516,2,飞殿下,2830,62,2,5,7,28.6%,17m
11516,3,打的就是你,2830,0,1,0,1,100.0%,27m
11516,2,fgfgfgfgfg,2830,0,1,0,1,100.0%,26m
11516,3,[孑然一人]孤爱心芳,2830,30,1,2,3,33.3%,57m
11516,3,[一花一世界]AIDEN,2830,0,0,1,1,0.0%,15m
11516,3,大神心肝,2830,0,0,1,1,0.0%,28m
11516,3,Yomi,2830,0,0,2,2,0.0%,9m
11532,2,[西湖雅座]古地明恋,2829,1463,72,67,139,51.8%,58m
11532,3,[威严满满DZ]蕾米莉亚,2829,745,29,35,64,45.3%,14m
11532,3,[蠢萌呆]萌萌的小喵喵,2829,454,16,16,32,50.0%,18m
11532,2,[傻妞]机械化说声我就退,2829,496,16,18,34,47.1%,29m
11532,3,星际魔人,2829,331,12,8,20,60.0%,15m
11532,2,影之刃,2829,259,9,12,21,42.9%,1m
11532,2,shane,2829,248,8,9,17,47.1%,1m
11532,3,devil,2829,86,4,1,5,80.0%,2m
11532,3,Jotaro,2829,58,3,0,3,100.0%,22m
11532,1,qccc,2829,188,3,4,7,42.9%,53m
11532,2,[太微玉清宫]LRBY,2829,60,2,5,7,28.6%,32m
11532,3,[XXHZ8]药水,2829,0,1,0,1,100.0%,29m
11532,2,[四蛆兄弟]夜凌丶冥,2829,0,1,1,2,50.0%,1h
11532,3,炜舞虫阳,2829,0,1,1,2,50.0%,22m
11532,3,共鸣心焦,2829,0,1,1,2,50.0%,7m
11532,3,Butcher,2829,0,1,2,3,33.3%,27m
11548,3,Dasein,2828,1389,128,126,254,50.4%,56m
11548,1,[aeahz]休闲玩家,2828,410,51,32,83,61.4%,31m
11548,2,網易,2828,718,28,30,58,48.3%,17m
11548,2,clem,2828,633,27,20,47,57.4%,26m
11548,2,呜呜呜我好菜啊,2828,480,19,16,35,54.3%,20m
11548,3,尚石,2828,304,12,12,24,50.0%,5m
11548,1,随风,2828,286,9,7,16,56.2%,1m
11548,1,[折纸后援团]fhjkhb,2828,162,7,3,10,70.0%,57m
11548,3,Goku,2828,69,4,2,6,66.7%,2m
11548,1,Dark,2828,0,3,2,5,60.0%,1h
11548,1,羊刀,2828,117,3,5,8,37.5%,11m
11548,3,sky,2828,58,2,1,3,66.7%,15m
11548,1,我是你怀里的猪,2828,0,2,5,7,28.6%,29m
11548,1,[sc谐盟]STICK,2828,96,2,6,8,25.0%,1h
11548,2,zerg,2828,90,1,1,2,50.0%,53m
11548,3,NewPlayer,2828,0,1,2,3,33.3%,3m
11548,3,[中华兄弟会]天宇之星,2828,0,0,3,3,0.0%,27m
11565,2,小火,2827,690,140,132,272,51.5%,21m
11565,2,[寻风]五行缺郭德纲,2827,794,62,48,110,56.4%,26m
11565,2,[YMYT]SaS,2827,1113,55,53,108,50.9%,29m
11565,3,[PlTB]IIIIIIIIIIII,2827,875,37,24,61,60.7%,2m
11565,2,阿毛耍星际,2827,507,19,19,38,50.0%,23m
11565,2,[帝王江山如画]wqe,2827,344,12,19,31,38.7%,22m
11565,3,Happydoog,2827,210,10,5,15,66.7%,4m
11565,2,[斯巴达血战团]ICE,2827,150,6,6,12,50.0%,35m
11565,3,全星灵的颜值担当,2827,86,4,1,5,80.0%,7m
11565,3,IIIIIIIOOOOO,2827,86,4,3,7,57.1%,7m
11565,3,[深圳老年星际]嘴巴打肿,2827,97,4,6,10,40.0%,1h
11565,2,[娱乐吃鸡]人在塔在,2827,0,3,2,5,60.0%,1h
11565,3,[星之所在RI]星空凛,2827,0,1,0,1,100.0%,58m
11565,3,这个探机很关键,2827,30,1,3,4,25.0%,15m
11565,3,[176642]黑白羽翼,2827,0,0,1,1,0.0%,29m
11565,2,少年儿童百科全书,2827,0,0,1,1,0.0%,1h
11581,1,[天朝大队]LiquidHero,2826,747,93,97,190,48.9%,13m
11581,2,[麻酱罐]依等红杏出墙,2826,731,35,31,66,53.0%,3m
11581,2,[aloha]兮兮,2826,668,23,28,51,45.1%,25m
11581,3,[超神给你看哦]玩人族母亲必出事,2826,504,20,11,31,64.5%,3m
11581,2,[炮火46]yingnovation,2826,455,18,17,35,51.4%,4m
11581,3,虐的就是你,2826,268,17,8,25,68.0%,2m
11581,3,[半个菜鸟]TARKIN,2826,327,15,2,17,88.2%,25m
11581,3,haomaomi,2826,363,15,10,25,60.0%,9m
11581,3,LandlordDDT,2826,231,9,8,17,52.9%,4m
11581,2,喜欢轻井泽惠,2826,276,9,14,23,39.1%,4m
11581,3,[败人品者sm]IIIIIIIIIIII,2826,118,5,4,9,55.6%,15m
11581,3,[EZ4XY]hrp,2826,79,4,2,6,66.7%,29m
11581,2,[Thpj]Kotori,2826,137,4,4,8,50.0%,17m
11581,3,[梦花]我叫萨萨,2826,142,3,1,4,75.0%,58m
11581,2,快乐的小猫,2826,0,3,2,5,60.0%,1h
11581,1,银剑,2826,0,3,3,6,50.0%,1h
11581,3,abel,2826,97,2,0,2,100.0%,1h
11581,2,QAQ,2826,0,2,2,4,50.0%,1h
11581,1,[雾雨魔法森林]虚灵之刃,2826,92,1,1,2,50.0%,1h
11581,3,[济南]黄旭东,2826,0,0,1,1,0.0%,4m
11581,3,小菜菜,2826,0,0,1,1,0.0%,56m
11581,3,好像一波,2826,0,0,2,2,0.0%,28m
11603,3,[鱼玩]上杉冰妍,2825,1231,77,54,131,58.8%,12m
11603,3,[脉脉不得语]呆呆,2825,1274,53,44,97,54.6%,18m
11603,3,空之境界,2825,646,46,30,76,60.5%,22m
11603,2,FrankMao,2825,1073,40,46,86,46.5%,14m
11603,2,Ezio,2825,534,21,19,40,52.5%,15m
11603,3,[薄暮之光]卡卡殷墟,2825,487,19,12,31,61.3%,4m
11603,3,[星际最强亡者]萌新,2825,472,16,17,33,48.5%,7m
11603,3,[迷迷迷]希望,2825,358,15,15,30,50.0%,3m
11603,1,[psadnj]我是酒店老板,2825,333,12,8,20,60.0%,8m
11603,1,[暴雪三十二隊]栀音,2825,208,8,6,14,57.1%,1m
11603,3,余晴话尽丶,2825,211,7,7,14,50.0%,8m
11603,3,[打我一波S全]新手,2825,150,7,10,17,41.2%,7m
11603,2,[日月神教]我们能走很久是吗,2825,128,4,3,7,57.1%,13m
11603,3,[江南不夜城]莽夫,2825,58,3,0,3,100.0%,6m
11603,2,Turning,2825,111,3,1,4,75.0%,1h
11603,2,脾英霸,2825,135,3,4,7,42.9%,1h
11603,1,[本质搞黄色]大魔王,2825,142,2,1,3,66.7%,1h
11603,3,[童话]恋语轻唱,2825,58,2,2,4,50.0%,15m
11603,3,[月姫]久远寺有珠,2825,0,1,0,1,100.0%,8m
11603,2,IIIIIIIIIIII,2825,0,1,2,3,33.3%,18m
11603,3,[闲散人员]happy,2825,30,1,4,5,20.0%,3m
11603,3,[ckx]YxLouis,2825,0,0,1,1,0.0%,7m
11603,3,伤心的恶魂,2825,0,0,2,2,0.0%,56m
11626,3,CazzForever,2824,829,32,28,60,53.3%,31m
11626,2,Kirito,2824,610,21,29,50,42.0%,17m
11626,2,[hellok]你猜,2824,482,20,16,36,55.6%,29m
11626,2,[NPCS]Sarutobi,2824,534,19,21,40,47.5%,8m
11626,3,[光明正大]神崎辄识,2824,401,14,10,24,58.3%,27m
11626,3,Miyazono,2824,306,11,10,21,52.4%,4m
11626,2,[czlp]单小西,2824,228,11,15,26,42.3%,28m
11626,3,梦想成为欧皇,2824,192,6,7,13,46.2%,40m
11626,2,清风伴月,2824,210,6,8,14,42.9%,55m
11626,2,[蜘蛛雷]啊咧,2824,154,5,10,15,33.3%,7m
11626,3,jin,2824,86,4,1,5,80.0%,29m
11626,1,[谐星w]实妹相伴小样菌,2824,0,4,3,7,57.1%,59m
11626,2,阿斯达,2824,93,3,2,5,60.0%,1h
11626,2,[我队伍很强大]幽灵,2824,91,2,1,3,66.7%,60m
11626,2,[RuShA]LINGER,2824,0,2,3,5,40.0%,1h
11626,3,[红烛昏罗帐]NGFour,2824,0,1,0,1,100.0%,7m
11626,1,Marin,2824,96,1,2,3,33.3%,1h
11626,1,小木曾和纱,2824,0,0,1,1,0.0%,12m
11626,3,[快乐白给]艺术就是派大星,2824,0,0,1,1,0.0%,7m
11626,1,IIIIIII,2824,0,0,1,1,0.0%,59m
11646,1,longF,2823,1572,142,143,285,49.8%,21m
11646,3,zoly,2823,438,17,16,33,51.5%,22m
11646,3,jerry,2823,298,13,9,22,59.1%,29m
11646,3,[黯月之剑]FutureV,2823,332,13,11,24,54.2%,28m
11646,3,砍人就对了,2823,176,6,7,13,46.2%,32m
11646,2,华丽雨林,2823,142,5,11,16,31.2%,15m
11646,3,迦楼罗,2823,60,3,2,5,60.0%,31m
11646,1,[你的枪兵死了]星马烈,2823,105,3,2,5,60.0%,56m
11646,3,[LJZ]gaoliangyi,2823,97,2,0,2,100.0%,29m
11646,2,爆张义菊,2823,94,2,4,6,33.3%,1h
11646,3,GBET,2823,0,1,0,1,100.0%,3m
11646,3,入侵者必亡,2823,0,1,1,2,50.0%,25m
11646,3,[cmfans]大草莓天下第一,2823,30,1,4,5,20.0%,14m
11646,3,Monster,2823,0,0,1,1,0.0%,27m
11646,3,fredning,2823,0,0,1,1,0.0%,9m
11646,3,李晶晶,2823,0,0,1,1,0.0%,57m
11646,3,结束先生,2823,0,0,2,2,0.0%,2m
11646,3,火之神神乐,2823,0,0,2,2,0.0%,3m
11664,2,苦力怕,2822,382,127,110,237,53.6%,1m
11664,2,深夜丶孤行,2822,1106,126,114,240,52.5%,28m
11664,2,[吹逼小分队]yjjabc,2822,1311,72,65,137,52.6%,14m
11664,2,[暴雪五队]square,2822,1337,60,47,107,56.1%,8m
11664,3,别让我看见神族,2822,670,31,24,55,56.4%,56m
11664,3,[KNAT]shadow,2822,314,12,8,20,60.0%,15m
11664,3,[青铜星友汇]神乐,2822,174,7,5,12,58.3%,7m
11664,2,决战青铜王,2822,200,7,6,13,53.8%,49m
11664,1,[我三玖]天下第一,2822,160,6,5,11,54.5%,1h
11664,2,寒暄小冥,2822,0,4,1,5,80.0%,6m
11664,3,Mikoto,2822,86,4,2,6,66.7%,8m
11664,1,大狐狸,2822,97,4,4,8,50.0%,22m
11664,3,鱼唇的叶某人,2822,150,4,13,17,23.5%,45m
11664,2,滑稽使者,2822,94,3,3,6,50.0%,1h
11664,2,我不想好好玩游戏,2822,95,2,0,2,100.0%,10m
11664,2,尋找,2822,44,2,5,7,28.6%,10m
11664,3,khgk,2822,0,1,0,1,100.0%,3m
11664,2,勾流,2822,0,1,2,3,33.3%,29m
11664,2,千羊斩谦卑,2822,0,0,1,1,0.0%,1h
11664,2,[鲁德欢]清蒸萨隆,2822,0,0,3,3,0.0%,11m
11684,1,白色暗影,2821,1443,324,320,644,50.3%,15m
11684,2,Ggg,2821,1076,69,69,138,50.0%,21m
11684,3,[未知生物]UNKNOWN,2821,1396,63,37,100,63.0%,29m
11684,2,我不是姓崔的,2821,531,22,17,39,56.4%,11m
11684,1,[琴瑟和鸣]雨行,2821,378,16,15,31,51.6%,9m
11684,2,[夙愿天下]簋爷,2821,337,12,12,24,50.0%,13m
11684,3,IIIIIIIIIIII,2821,0,8,22,30,26.7%,31m
11684,3,麦对有,2821,176,7,4,11,63.6%,7m
11684,2,[心中只有诺娃]塔达林白给萨满,2821,220,7,8,15,46.7%,26m
11684,1,小兵一号,2821,182,5,9,14,35.7%,49m
11684,2,quyunhao,2821,145,4,5,9,44.4%,11m
11684,2,埃蒙的部队,2821,95,3,3,6,50.0%,26m
11684,3,Blackrock,2821,30,2,2,4,50.0%,2m
11684,1,Tracy,2821,114,2,3,5,40.0%,22m
11684,1,米饭铺铺,2821,0,1,0,1,100.0%,1h
11684,3,你阿妈炸了,2821,0,0,1,1,0.0%,8m
11684,3,薛定谔的猫,2821,0,0,1,1,0.0%,8m
11701,3,[DSE]泰达,2820,990,42,36,78,53.8%,4m
11701,3,IIIIIIIIIIII,2820,748,28,28,56,50.0%,23m
11701,3,路边的一粒灰,2820,601,23,18,41,56.1%,9m
11701,2,boxer,2820,441,17,13,30,56.7%,4m
11701,3,[人类天下第一]必上女人不做光棍,2820,360,15,12,27,55.6%,2m
11701,3,syw,2820,322,12,13,25,48.0%,58m
11701,3,Tangist,2820,217,9,10,19,47.4%,16m
11701,3,Brutal,2820,170,7,2,9,77.8%,2m
11701,3,SGSW,2820,105,7,5,12,58.3%,3m
11701,1,IIIIIIIIIIII,2820,48,5,4,9,55.6%,3m
11701,1,never,2820,143,5,5,10,50.0%,46m
11701,2,BloodBox,2820,0,4,1,5,80.0%,1h
11701,2,玛奇朵,2820,0,3,2,5,60.0%,58m
11701,3,二零壹伍届武状元,2820,30,2,1,3,66.7%,2m
11701,3,[WEjsnj]樱花玉子,2820,30,2,2,4,50.0%,31m
11701,2,[丨贱圣丨]丨小疯子丨,2820,122,2,2,4,50.0%,35m
11701,3,fdasfsf,2820,30,2,2,4,50.0%,18m
11701,3,Chest,2820,94,1,3,4,25.0%,9m
11701,2,星际征霸,2820,88,1,4,5,20.0%,28m
11701,2,[Hawks]booyaUNO,2820,0,0,3,3,0.0%,35m
11701,1,仲夏夜之梦昏睡,2820,0,0,8,8,0.0%,12m
11722,1,竟然又,2819,1501,83,78,161,51.6%,7m
11722,2,莫得感情,2819,1007,62,44,106,58.5%,7m
11722,3,唯东,2819,393,24,22,46,52.2%,14m
11722,3,子非鱼,2819,191,13,12,25,52.0%,3m
11722,2,[BTD]Herakles,2819,213,9,7,16,56.2%,26m
11722,3,渣渣辉,2819,147,7,7,14,50.0%,58m
11722,3,Dominic,2819,189,6,3,9,66.7%,4m
11722,1,[绿林响马]IIIIIIIIIIII,2819,164,6,5,11,54.5%,1h
11722,3,篝之雾枝,2819,148,6,6,12,50.0%,1h
11722,2,扫地焚香,2819,172,6,10,16,37.5%,29m
11722,2,西尔维娅,2819,173,5,7,12,41.7%,1h
11722,1,PoiFQu,2819,97,4,3,7,57.1%,1h
11722,3,[秋毫]IIIIIIIIIIII,2819,30,2,0,2,100.0%,31m
11722,3,woshiwl,2819,62,2,4,6,33.3%,58m
11722,3,sdfg,2819,0,1,0,1,100.0%,9m
11722,1,夜魅影之泪,2819,0,1,0,1,100.0%,55m
11722,3,小野妹子,2819,0,1,1,2,50.0%,3m
11722,3,relax,2819,0,1,1,2,50.0%,6m
11722,3,MAIPACE,2819,0,0,1,1,0.0%,1h
11741,2,dabolo,2818,879,35,34,69,50.7%,13m
11741,3,Sucer,2818,678,30,21,51,58.8%,22m
11741,2,画心,2818,609,22,26,48,45.8%,22m
11741,3,[Mikon]Rinne,2818,462,21,12,33,63.6%,56m
11741,1,城市化请赐教,2818,303,20,23,43,46.5%,30m
11741,3,[四叶草]People,2818,477,19,12,31,61.3%,2m
11741,2,名字太帅无法显示,2818,340,13,11,24,54.2%,10m
11741,2,[乳主头子]星际小子,2818,264,10,11,21,47.6%,20m
11741,3,莫测的狂徒,2818,232,7,3,10,70.0%,8m
11741,1,仁义无双总司令,2818,138,7,4,11,63.6%,1h
11741,3,皮皮猫,2818,120,5,6,11,45.5%,58m
11741,3,[一起犯罪]土匪,2818,86,4,2,6,66.7%,23m
11741,2,好先生,2818,94,3,0,3,100.0%,20m
11741,1,白上丶狐,2818,96,3,1,4,75.0%,49m
11741,2,[朝花夕誓]麾安,2818,132,2,1,3,66.7%,1h
11741,3,地平线,2818,58,2,2,4,50.0%,58m
11741,3,丶苍白誓言灬,2818,0,1,0,1,100.0%,6m
11741,3,Mdoearth,2818,30,1,1,2,50.0%,29m
11741,3,[我是萌新Q]雾雨爱丽丝,2818,30,1,1,2,50.0%,15m
11741,2,重新命名角色,2818,0,1,4,5,20.0%,11m
11741,3,[塔达林军团]拉不起的仇恨,2818,0,0,1,1,0.0%,18m
11741,1,LOVESTORY,2818,0,0,5,5,0.0%,2m
11763,3,vdi,2817,1628,128,113,241,53.1%,22m
11763,1,回来,2817,1199,58,61,119,48.7%,21m
11763,3,[凤凰之门]蒜仔,2817,1435,54,50,104,51.9%,26m
11763,2,江河汇海,2817,781,39,16,55,70.9%,15m
11763,1,[DMRe]zero,2817,494,17,24,41,41.5%,17m
11763,2,[三只火鸡]手慢人笨年纪大,2817,295,12,9,21,57.1%,14m
11763,1,探姬,2817,201,9,2,11,81.8%,1h
11763,3,[lmars]Johnbiside,2817,230,8,5,13,61.5%,8m
11763,2,zhong,2817,193,8,8,16,50.0%,1h
11763,3,迪士尼在逃王子,2817,211,7,2,9,77.8%,57m
11763,2,[32CM]哼很难过,2817,114,6,6,12,50.0%,25m
11763,1,zzzz,2817,117,4,4,8,50.0%,1h
11763,2,llllllllllll,2817,0,3,3,6,50.0%,15m
11763,1,[卡尔达利斯]小灬,2817,0,3,4,7,42.9%,56m
11763,3,哈哈大战鲁比,2817,86,3,4,7,42.9%,4m
11763,2,十七,2817,46,2,1,3,66.7%,1h
11763,3,野猫,2817,30,2,2,4,50.0%,3m
11763,3,llllllllll,2817,0,1,0,1,100.0%,31m
11763,3,[野生无公害]YePriest,2817,0,0,1,1,0.0%,1h
11763,2,薛定谔的咬人猫,2817,0,0,1,1,0.0%,1h
11763,3,[虐杀琉森]离丶殇,2817,0,0,1,1,0.0%,1h
11763,3,SupplyBlock,2817,0,0,1,1,0.0%,14m
11785,2,Jes,2816,446,92,73,165,55.8%,17m
11785,3,[大洋彼岸团队]Giotto,2816,559,57,52,109,52.3%,56m
11785,1,人人都係食神,2816,397,22,26,48,45.8%,21m
11785,2,工口新一,2816,586,21,24,45,46.7%,2m
11785,3,[银河舰队]wzrlawyer,2816,390,15,11,26,57.7%,15m
11785,3,半夜那啥没带纸,2816,308,11,14,25,44.0%,27m
11785,3,[最牛的菜鸟队]一叶之秋,2816,280,9,6,15,60.0%,31m
11785,1,粉红少女郭德纲,2816,172,8,7,15,53.3%,1h
11785,1,泽水之轩,2816,170,7,6,13,53.8%,15m
11785,2,[鼠人共和国]fyty,2816,159,5,4,9,55.6%,38m
11785,3,绝世无双,2816,146,5,6,11,45.5%,27m
11785,3,[AOT]一如既往,2816,110,4,4,8,50.0%,56m
11785,2,[博云星际学2]Docr,2816,0,3,2,5,60.0%,13m
11785,3,[91谐会]六神,2816,30,2,0,2,100.0%,8m
11785,3,[无限圣堂]Card,2816,30,2,1,3,66.7%,7m
11785,3,达拉姆大主教,2816,30,2,1,3,66.7%,18m
11785,3,[ToHo]丶只要你微笑,2816,0,1,0,1,100.0%,28m
11785,2,ItsukaKotori,2816,0,1,0,1,100.0%,1h
11785,3,[歪比歪卜]反清复明泽拉图,2816,0,1,1,2,50.0%,1h
11785,3,Marian,2816,0,1,1,2,50.0%,2m
11785,1,[Fear]小邓,2816,0,0,1,1,0.0%,57m
11785,3,[远坂世家]LIUDA,2816,0,0,1,1,0.0%,58m
11807,2,梅常酥,2815,971,45,38,83,54.2%,26m
11807,3,[SRD]caiBycc,2815,599,27,13,40,67.5%,29m
11807,1,雷姆,2815,346,25,28,53,47.2%,17m
11807,3,redgold,2815,405,18,15,33,54.5%,32m
11807,3,[火焰雷兽]六道魔圣,2815,538,18,22,40,45.0%,27m
11807,3,风中答案,2815,320,13,12,25,52.0%,12m
11807,3,[小鸡屠宰场8]雪铁龙,2815,368,13,17,30,43.3%,22m
11807,3,叹息之墙,2815,306,11,10,21,52.4%,57m
11807,3,[西红柿炒]煎蛋,2815,250,10,11,21,47.6%,9m
11807,3,黄金燕楚,2815,265,9,4,13,69.2%,23m
11807,3,KelvinsTem,2815,204,8,6,14,57.1%,14m
11807,1,修地堡先死个马,2815,232,8,7,15,53.3%,1h
11807,2,[小阿giao]Shidifu,2815,114,5,7,12,41.7%,1m
11807,1,[彡暁弎彡鞺灘]寒蝉鸣泣,2815,48,4,4,8,50.0%,1h
11807,3,llllllllllll,2815,114,4,4,8,50.0%,31m
11807,1,[小鸡啄米]TDtudou,2815,97,4,4,8,50.0%,55m
11807,2,染柳堆烟,2815,46,4,4,8,50.0%,1h
11807,2,[星基佬男孩]黄旭北,2815,130,4,5,9,44.4%,10m
11807,3,[童话小镇]藤原妹红,2815,58,3,2,5,60.0%,8m
11807,3,路明飞,2815,60,3,3,6,50.0%,29m
11807,3,朱可夫,2815,86,3,3,6,50.0%,56m
11807,3,hehe,2815,146,3,5,8,37.5%,6m
11807,3,暗夜骑士,2815,30,1,2,3,33.3%,31m
11807,3,血泪,2815,0,0,1,1,0.0%,3m
11807,3,景沐雪,2815,0,0,1,1,0.0%,15m
11807,2,罐头,2815,0,0,1,1,0.0%,1h
11807,3,[致去的青春]Kirito,2815,0,0,2,2,0.0%,31m
11834,2,[Nostop]傲娇小姐姐,2814,1334,70,66,136,51.5%,36m
11834,2,[几何伦理学]SkyingMe,2814,335,42,22,64,65.6%,14m
11834,3,[小金上天队]极风行者,2814,1076,41,38,79,51.9%,27m
11834,2,[友人公馆]海盗夏夏,2814,865,34,28,62,54.8%,11m
11834,2,小兵真可爱,2814,659,32,18,50,64.0%,3m
11834,3,Universe,2814,808,32,29,61,52.5%,6m
11834,2,你也想起舞嘛,2814,874,32,35,67,47.8%,23m
11834,3,secret,2814,770,29,26,55,52.7%,57m
11834,3,通缉犯华,2814,628,26,21,47,55.3%,29m
11834,1,瞢盺,2814,496,17,25,42,40.5%,7m
11834,2,[SUSTC]白烛葵,2814,418,15,23,38,39.5%,11m
11834,3,心机争爸全是脑瘫,2814,381,14,16,30,46.7%,32m
11834,2,旅客身份,2814,267,10,9,19,52.6%,17m
11834,3,zues,2814,268,9,7,16,56.2%,8m
11834,3,Zeus,2814,236,9,11,20,45.0%,14m
11834,1,[你怕是没睡醒]scv,2814,213,8,5,13,61.5%,1h
11834,2,[天命组织]中二病也不谈恋爱,2814,148,6,8,14,42.9%,22m
11834,1,[混元崔欣门]DDFanTasy,2814,161,5,2,7,71.4%,29m
11834,3,Kerei,2814,0,4,5,9,44.4%,33m
11834,1,龙族,2814,142,4,8,12,33.3%,15m
11834,2,烟乄舞,2814,0,3,2,5,60.0%,10m
11834,2,FLY,2814,94,3,3,6,50.0%,1h
11834,1,犬走椛,2814,48,2,1,3,66.7%,1h
11834,2,lllllllll,2814,46,2,2,4,50.0%,1h
11834,2,[所向无前]嘤嘤嘤,2814,0,1,0,1,100.0%,36m
11834,3,[欢迎加入]Artemis,2814,30,1,1,2,50.0%,58m
11834,3,華麗哖蕐,2814,97,1,3,4,25.0%,1h
11834,1,apologize,2814,0,0,1,1,0.0%,1h
11834,3,红烧排骨有点腻,2814,0,0,2,2,0.0%,25m
11834,3,[长岛歌舞会]麻雀,2814,0,0,2,2,0.0%,2m
11834,3,xiaxia,2814,0,0,2,2,0.0%,3m
11834,3,都是弟弟,2814,0,0,3,3,0.0%,16m
11866,2,猫不希,2813,709,193,167,360,53.6%,11m
11866,1,二刀流,2813,1171,183,181,364,50.3%,32m
11866,2,十二岁天才少年,2813,760,160,160,320,50.0%,14m
11866,3,王不留行,2813,1616,156,150,306,51.0%,2m
11866,3,一只猪竟然,2813,1420,144,150,294,49.0%,24m
11866,2,helloquantum,2813,1566,131,120,251,52.2%,31m
11866,3,[泰伦城说晚安]IIIIIIIII,2813,1118,76,78,154,49.4%,16m
11866,3,Aurora,2813,947,60,50,110,54.5%,7m
11866,3,Devotion,2813,766,30,23,53,56.6%,15m
11866,2,李娜同学水里吻我,2813,682,25,26,51,49.0%,57m
11866,2,[名越长越可爱]IIIIIIII,2813,447,20,16,36,55.6%,14m
11866,2,hughes,2813,495,18,18,36,50.0%,4m
11866,3,[IMRTS2]键盘冒毒奶,2813,246,9,5,14,64.3%,18m
11866,3,Joker,2813,239,8,4,12,66.7%,22m
11866,3,高呜呜,2813,173,6,3,9,66.7%,6m
11866,3,希尔裴罗娜,2813,148,6,5,11,54.5%,58m
11866,3,[荣耀丶殿堂]尹恩,2813,116,4,3,7,57.1%,7m
11866,2,[SC2近卫军]输多赢少,2813,138,4,4,8,50.0%,1h
11866,3,[半个菜鸟]freedom,2813,88,3,3,6,50.0%,1m
11866,3,[欧尼酱]酸奶君,2813,62,2,5,7,28.6%,31m
11866,3,可乐加冰,2813,0,1,0,1,100.0%,15m
11866,3,可爱毒爆喵,2813,0,1,0,1,100.0%,3m
11866,3,wcjsdb,2813,0,1,0,1,100.0%,3m
11866,3,小曹老板,2813,0,0,1,1,0.0%,27m
11866,3,仰望星空,2813,0,0,2,2,0.0%,57m
11891,1,玩这游戏素质真低,2812,922,328,306,634,51.7%,8m
11891,3,SLI,2812,836,96,84,180,53.3%,3m
11891,3,violet,2812,1033,43,33,76,56.6%,29m
11891,2,刀锋战士,2812,465,19,21,40,47.5%,14m
11891,2,鬼月,2812,304,19,25,44,43.2%,6m
11891,3,猪猪飞,2812,300,12,9,21,57.1%,3m
11891,1,青稞草,2812,113,11,16,27,40.7%,24m
11891,3,IIIIIIIIII,2812,256,9,8,17,52.9%,58m
11891,3,[NZNZ]枫羽泠洛,2812,151,5,2,7,71.4%,6m
11891,2,耳东陈,2812,0,3,2,5,60.0%,1h
11891,3,啦啦啦啦德玛西亚,2812,58,3,5,8,37.5%,23m
11891,3,[KOKOKO]苍井空,2812,66,2,6,8,25.0%,1h
11891,3,菜是这样的,2812,60,2,6,8,25.0%,6m
11891,1,甘之若饴,2812,0,1,1,2,50.0%,7m
11891,3,[洛丹伦的雨夜]海神,2812,0,1,4,5,20.0%,45m
11891,3,偷矿选项,2812,30,1,4,5,20.0%,31m
11891,2,MagicLing,2812,0,0,1,1,0.0%,25m
11891,3,ztt,2812,0,0,1,1,0.0%,23m
11891,3,[iGMM]Peterinter,2812,0,0,3,3,0.0%,31m
11910,3,无上至尊,2811,1314,50,48,98,51.0%,30m
11910,3,SCxiaose,2811,599,24,21,45,53.3%,58m
11910,2,james,2811,265,16,11,27,59.3%,10m
11910,2,joker,2811,358,15,8,23,65.2%,1h
11910,2,七色云彩,2811,280,11,13,24,45.8%,3m
11910,1,[星河气象学院]Pionoor,2811,302,8,17,25,32.0%,21m
11910,1,THEAL,2811,94,4,3,7,57.1%,1h
11910,3,[人菜灬瘾大]tREE,2811,144,4,4,8,50.0%,29m
11910,2,搜到你我已经没了,2811,0,3,2,5,60.0%,1h
11910,3,[你看着办]李牧,2811,86,3,4,7,42.9%,29m
11910,1,哈洗拉马,2811,94,2,1,3,66.7%,1h
11910,3,雨田粗人,2811,0,1,1,2,50.0%,56m
11910,3,jclee,2811,30,1,1,2,50.0%,8m
11910,3,[HK丶S]阳光果粒橙,2811,30,1,3,4,25.0%,14m
11910,3,[幽冥之狼]要把握好时机,2811,30,1,4,5,20.0%,6m
11910,3,邪恶的大香蕉,2811,0,1,4,5,20.0%,57m
11910,3,luyou,2811,0,0,1,1,0.0%,58m
11910,1,[白给泰伦]全自动上海人偶,2811,0,0,3,3,0.0%,50m
11928,3,泡椒楠楠,2810,1561,78,60,138,56.5%,6m
11928,2,龙少若星,2810,1445,66,60,126,52.4%,16m
11928,2,要写论文辣,2810,844,49,50,99,49.5%,21m
11928,2,[为谁而忧伤]无敌的虫族,2810,1065,43,38,81,53.1%,2m
11928,2,visitordp,2810,716,32,25,57,56.1%,29m
11928,2,[神武骑士团]东皇阁下,2810,506,29,22,51,56.9%,30m
11928,2,[SCLR]叶落归根,2810,432,15,20,35,42.9%,20m
11928,2,[Porsch]回家,2810,386,13,20,33,39.4%,25m
11928,3,[专业de团队]艾尔建筑大师,2810,317,12,12,24,50.0%,9m
11928,3,TadisG,2810,291,11,5,16,68.8%,5m
11928,3,小迪大小姐,2810,235,9,3,12,75.0%,29m
11928,3,死歌行者,2810,173,8,5,13,61.5%,8m
11928,3,[萌妹集团]LGDSWSG,2810,190,6,2,8,75.0%,31m
11928,1,皓月,2810,164,6,5,11,54.5%,1h
11928,2,孤独风中一只羊,2810,139,4,4,8,50.0%,26m
11928,3,hzhp,2810,0,3,2,5,60.0%,27m
11928,3,[老头星际]威廉,2810,86,3,3,6,50.0%,28m
11928,3,[19CM]呵呵哒,2810,0,1,0,1,100.0%,27m
11928,2,杀手游戏,2810,30,1,5,6,16.7%,57m
11928,3,[大宇恩]Eucliwood,2810,0,0,1,1,0.0%,14m
11948,2,[基金会]Ever,2809,1585,72,72,144,50.0%,30m
11948,3,[香蕉派]蕉泥座人,2809,803,32,23,55,58.2%,2m
11948,3,铁血大飞哥,2809,570,27,26,53,50.9%,15m
11948,2,柠檬味布丁,2809,310,27,29,56,48.2%,2m
11948,2,[茶队星分部]Ehino,2809,291,25,17,42,59.5%,15m
11948,3,[闪电伍连鞭]Snail,2809,576,21,21,42,50.0%,31m
11948,3,[Tov]贾维斯,2809,468,18,15,33,54.5%,3m
11948,2,火羽无双,2809,231,9,9,18,50.0%,1h
11948,2,[FIND]复活节也要蛋,2809,204,8,10,18,44.4%,29m
11948,3,[Xbox]dada,2809,176,7,3,10,70.0%,28m
11948,1,歪个刻晴,2809,48,5,4,9,55.6%,1h
11948,2,[造物主泰勒]human,2809,172,4,4,8,50.0%,25m
11948,3,[敌人正在]撕碎我的部队,2809,163,4,5,9,44.4%,6m
11948,3,[五月花]DYDY,2809,148,4,7,11,36.4%,29m
11948,2,婴鳞,2809,0,3,3,6,50.0%,43m
11948,2,天歌,2809,90,3,8,11,27.3%,22m
11948,1,[244]绝雪天泠,2809,92,2,2,4,50.0%,48m
11948,2,江城我最棒,2809,0,1,1,2,50.0%,36m
11948,3,Leslie,2809,30,1,2,3,33.3%,15m
11948,3,企日天,2809,30,1,2,3,33.3%,18m
11948,3,[致逝去的青春]她还未婚我想等等,2809,0,0,1,1,0.0%,28m
11948,3,lmh,2809,0,0,3,3,0.0%,18m
11970,3,zyde,2808,1074,63,62,125,50.4%,25m
11970,3,HEovO,2808,567,24,14,38,63.2%,8m
11970,2,[斗鱼祁铭菌]wwwwwwwww,2808,419,17,15,32,53.1%,6m
11970,3,Loupat,2808,396,15,16,31,48.4%,3m
11970,2,coincidence,2808,188,14,15,29,48.3%,11m
11970,2,[星星你全家]铁吊小叮当,2808,313,12,9,21,57.1%,1h
11970,2,[萌蛋组合]IIIIIIIIIIII,2808,272,12,14,26,46.2%,30m
11970,3,一花一世界,2808,217,9,7,16,56.2%,9m
11970,1,[Sfae]晨曦之恋,2808,48,5,3,8,62.5%,1h
11970,1,愿得我心如明月,2808,119,5,5,10,50.0%,12m
11970,2,saibasidian,2808,122,5,10,15,33.3%,26m
11970,2,fontens,2808,0,3,3,6,50.0%,1h
11970,2,[最强战神]AYAqiue,2808,149,3,8,11,27.3%,3m
11970,3,小怪兽绘梨衣,2808,34,2,1,3,66.7%,15m
11970,3,[CMbiss]臭鱼烂虾,2808,58,2,2,4,50.0%,8m
11970,3,[梦里国宗]追梦少年小涵,2808,30,2,2,4,50.0%,58m
11970,3,[OkOKk]Allen,2808,34,2,4,6,33.3%,1h
11970,1,杀手,2808,0,2,4,6,33.3%,59m
11970,2,钻石星辰,2808,0,1,5,6,16.7%,4m
11970,3,GGNeverBack,2808,0,0,1,1,0.0%,3m
11970,3,[DTP]Arctic,2808,0,0,1,1,0.0%,29m
11970,2,游离,2808,0,0,1,1,0.0%,1h
11970,3,nittl,2808,0,0,1,1,0.0%,14m
11970,3,[秋毫七队]朱灿,2808,0,0,3,3,0.0%,58m
11994,3,Laura,2807,1187,154,172,326,47.2%,18m
11994,3,wvwvvvwwvwvw,2807,1326,71,63,134,53.0%,15m
11994,2,[老年人玩星际]FrenzyGoat,2807,1383,55,60,115,47.8%,14m
11994,2,HuaSheng,2807,264,38,39,77,49.4%,23m
11994,3,AACCOLI,2807,667,30,20,50,60.0%,57m
11994,2,剑鞘掉了丶亚索,2807,370,15,15,30,50.0%,26m
11994,3,不二阿,2807,382,14,18,32,43.8%,22m
11994,3,zxc,2807,296,9,7,16,56.2%,2m
11994,3,sun,2807,166,7,4,11,63.6%,30m
11994,2,[社交学超可爱]我也找不着,2807,196,6,7,13,46.2%,11m
11994,2,半山大雨,2807,128,4,4,8,50.0%,26m
11994,2,[你好抱歉]lllllll,2807,62,3,5,8,37.5%,23m
11994,3,[0D]OvO,2807,18,2,1,3,66.7%,6m
11994,3,MFtelinf,2807,60,2,3,5,40.0%,18m
11994,2,蝶舞星魂,2807,60,2,7,9,22.2%,10m
11994,3,绝对正点,2807,97,1,2,3,33.3%,1h
11994,1,[AI]Xelnaga,2807,0,1,7,8,12.5%,11m
11994,3,[古剑魂]long,2807,0,0,1,1,0.0%,25m
11994,3,好肥的大橘猫,2807,0,0,2,2,0.0%,3m
11994,3,孤航,2807,0,0,2,2,0.0%,22m
11994,1,Spray,2807,0,0,3,3,0.0%,47m
12015,2,极速等级,2806,673,128,124,252,50.8%,26m
12015,2,埃罗忙啊老师,2806,737,84,59,143,58.7%,26m
12015,2,[京城特务]闫大明,2806,1036,51,32,83,61.4%,36m
12015,2,驣龖,2806,467,23,26,49,46.9%,11m
12015,3,[江北星际]我猛得不配赢,2806,431,17,12,29,58.6%,32m
12015,3,[萌的一笔]惑星指揮官,2806,469,17,14,31,54.8%,15m
12015,3,Miku,2806,304,12,11,23,52.2%,4m
12015,3,[衡水中学]Faker,2806,188,8,7,15,53.3%,53m
12015,3,[致逝去的青春]天神下凡一锤四,2806,194,6,1,7,85.7%,9m
12015,3,[暗黑幻想]手速一飙八十八,2806,218,6,4,10,60.0%,3m
12015,3,咕噜嘎啦叫,2806,86,3,3,6,50.0%,22m
12015,2,[Holyfe]DarkeDave,2806,44,3,4,7,42.9%,1h
12015,2,海贼欧林,2806,62,2,18,20,10.0%,3m
12015,3,[星际老湿鸡]再见宋哈娜,2806,30,1,1,2,50.0%,18m
12015,1,[西伯利亚土豆]闪耀的芝士蛋挞,2806,0,1,2,3,33.3%,49m
12015,2,vinyl,2806,0,1,2,3,33.3%,13m
12015,3,[HW4]FUBUKI,2806,30,1,3,4,25.0%,7m
12032,3,冲啊,2805,1436,134,121,255,52.5%,2m
12032,3,铭楼,2805,1587,112,92,204,54.9%,22m
12032,2,帷羡,2805,1437,82,64,146,56.2%,20m
12032,2,[最菜战队]shen,2805,1280,59,49,108,54.6%,3m
12032,2,雪泪寒,2805,367,26,31,57,45.6%,11m
12032,2,天下耀莱,2805,529,21,19,40,52.5%,26m
12032,3,摔烂的西瓜,2805,465,21,21,42,50.0%,7m
12032,2,驭龙,2805,170,18,13,31,58.1%,18m
12032,2,龙炫,2805,469,17,12,29,58.6%,4m
12032,2,梅山宋仲基,2805,453,16,17,33,48.5%,7m
12032,2,[XXHZ10]死亡如风,2805,276,10,13,23,43.5%,31m
12032,1,[暴雪十二队]机枪兵,2805,177,8,10,18,44.4%,15m
12032,3,[汉堡FANS]天依,2805,144,6,7,13,46.2%,27m
12032,2,[草死尼玛哦]Fenix,2805,92,5,1,6,83.3%,1h
12032,3,[狛枝凪斗]超高校級的幸運,2805,116,3,0,3,100.0%,8m
12032,3,夜神琉璃,2805,86,3,2,5,60.0%,8m
12032,2,墨色轻语,2805,0,3,2,5,60.0%,10m
12032,2,起名,2805,76,3,5,8,37.5%,1h
12032,3,干锅刺蛇,2805,30,2,1,3,66.7%,25m
12032,3,October,2805,58,2,1,3,66.7%,30m
12032,2,[UNAME]Lancelot,2805,0,0,1,1,0.0%,1h
12032,3,[MTO]张庭浩,2805,0,0,1,1,0.0%,59m
12032,2,[DSE]尘世走笔,2805,0,0,3,3,0.0%,6m
12055,2,[SUN式]孙悟地,2804,1522,106,100,206,51.5%,30m
12055,1,苯环,2804,1306,72,74,146,49.3%,55m
12055,3,[仙女的云朵喵]樱花呀,2804,1304,64,53,117,54.7%,5m
12055,2,我叫大水年,2804,307,44,30,74,59.5%,12m
12055,3,快樂的大師兄,2804,424,26,17,43,60.5%,8m
12055,3,[我队伍很强大]byj,2804,482,18,11,29,62.1%,58m
12055,2,快乐,2804,383,18,21,39,46.2%,11m
12055,2,叫我白老大,2804,391,14,15,29,48.3%,3m
12055,3,樱桃撒旦,2804,380,14,17,31,45.2%,29m
12055,3,[无花也浪漫]修地堡没个妈,2804,290,12,2,14,85.7%,40m
12055,3,LaoK,2804,144,11,6,17,64.7%,30m
12055,3,[2对2大师]我本纯洁,2804,244,9,3,12,75.0%,57m
12055,3,panJIM,2804,226,8,9,17,47.1%,56m
12055,2,[哀伤]千羽稚生,2804,63,5,5,10,50.0%,14m
12055,2,stanley,2804,46,3,5,8,37.5%,1h
12055,3,[滴滴打人集团]天外飞剑,2804,30,2,0,2,100.0%,5m
12055,3,致命之足,2804,0,1,0,1,100.0%,57m
12055,1,[XXHZ35]Jones,2804,0,1,3,4,25.0%,1h
12055,2,DKrose,2804,30,1,6,7,14.3%,6m
12055,3,[应塔罗塔杀哒]浮生若梦,2804,0,0,1,1,0.0%,9m
12055,2,黑哥,2804,0,0,1,1,0.0%,1h
12055,3,祸首亮,2804,0,0,1,1,0.0%,28m
12055,3,[咏春]InNoVation,2804,0,0,1,1,0.0%,22m
12078,1,炸鱼妈早死,2803,928,92,95,187,49.2%,58m
12078,3,RookiEee,2803,1020,33,60,93,35.5%,14m
12078,2,星际云玩家,2803,835,32,39,71,45.1%,11m
12078,3,刱弑,2803,552,24,15,39,61.5%,13m
12078,2,碧海红日,2803,280,23,25,48,47.9%,11m
12078,3,return,2803,316,15,15,30,50.0%,14m
12078,3,llllll,2803,263,10,7,17,58.8%,33m
12078,1,[SDEt]TaMdVian,2803,120,4,5,9,44.4%,11m
12078,3,黑色幽默,2803,86,3,2,5,60.0%,16m
12078,2,木梁村正,2803,0,3,3,6,50.0%,1h
12078,3,[NAE]溟茫,2803,62,3,4,7,42.9%,8m
12078,3,[武裆星际]是我自己画地为牢,2803,0,1,1,2,50.0%,31m
12078,2,[Umaru2]SAI,2803,0,1,4,5,20.0%,1h
12078,3,天杀的,2803,0,0,1,1,0.0%,25m
12078,3,[老吴天下第一]Tgglol,2803,0,0,1,1,0.0%,58m
12078,3,[RPGBoY]小新,2803,0,0,1,1,0.0%,45m
12078,3,ARMstdio,2803,0,0,2,2,0.0%,7m
12078,2,深海鱼,2803,0,0,6,6,0.0%,7m
12096,3,LonelyPlanet,2802,1338,323,341,664,48.6%,31m
12096,2,我是一只小小鸟,2802,903,129,132,261,49.4%,16m
12096,3,榆垄,2802,666,68,50,118,57.6%,58m
12096,2,[Beastp]六地选手,2802,682,60,64,124,48.4%,16m
12096,3,hoshgonen,2802,1329,59,44,103,57.3%,2m
12096,3,[倚栏夜听雨]BreathlnG,2802,696,30,22,52,57.7%,2m
12096,3,花钱日下死,2802,271,10,4,14,71.4%,58m
12096,2,噩丨狼,2802,234,8,9,17,47.1%,22m
12096,3,莫奈,2802,193,7,6,13,53.8%,57m
12096,3,海阔天空,2802,92,4,6,10,40.0%,22m
12096,3,虎爱吉,2802,30,2,0,2,100.0%,58m
12096,3,BananaSkin,2802,30,2,1,3,66.7%,57m
12096,3,[斑斓]Coloryellow,2802,0,2,2,4,50.0%,2m
12096,2,快乐的肥宅,2802,0,2,3,5,40.0%,1h
12096,2,FearX,2802,60,2,7,9,22.2%,17m
12096,3,疤瘌味的桃子,2802,0,1,1,2,50.0%,8m
12096,2,[ntrbq]Kingest,2802,0,1,4,5,20.0%,11m
12096,3,Fitz,2802,0,0,1,1,0.0%,3m
12096,3,[Ausuna]MSCmake,2802,0,0,1,1,0.0%,7m
12096,3,[单人模拟战]新手电脑,2802,0,0,1,1,0.0%,2m
12116,2,LuckyEric,2801,1584,287,277,564,50.9%,8m
12116,3,黄缘,2801,1215,133,128,261,51.0%,59m
12116,1,乞龍,2801,1430,126,125,251,50.2%,13m
12116,2,[HQU战队]IIIIIIIIIIII,2801,1439,92,76,168,54.8%,16m
12116,3,Xros,2801,742,30,27,57,52.6%,8m
12116,2,[LAMBOR]zztr,2801,238,28,26,54,51.9%,6m
12116,2,紫星会,2801,512,18,20,38,47.4%,26m
12116,3,[专治格种不服]devil,2801,367,14,8,22,63.6%,57m
12116,2,Yuki,2801,310,13,15,28,46.4%,4m
12116,3,[sc日记]卡兰,2801,247,10,4,14,71.4%,3m
12116,3,Luluuuuuuu,2801,156,5,1,6,83.3%,31m
12116,2,死灵圣法神,2801,118,5,11,16,31.2%,26m
12116,3,liji,2801,60,3,1,4,75.0%,29m
12116,3,练习时长两年半,2801,86,3,3,6,50.0%,30m
12116,3,我什么也不想说,2801,144,3,4,7,42.9%,57m
12116,2,[长夜将至]hehuaqi,2801,0,2,3,5,40.0%,1h
12116,3,月影星痕,2801,108,2,4,6,33.3%,57m
12116,3,[DSE]副官,2801,30,1,1,2,50.0%,1h
12116,3,[XXHZ16]仇花徒花,2801,0,0,1,1,0.0%,1h
12116,3,[绍兴吴彦祖]zzy,2801,0,0,2,2,0.0%,8m
12116,2,[无敌的]无敌的,2801,0,0,5,5,0.0%,59m
12137,2,[CRSC2]Vegeta,2800,1590,168,163,331,50.8%,3m
12137,3,钓猫的鱼,2800,1354,123,112,235,52.3%,3m
12137,2,白首卧,2800,1018,89,78,167,53.3%,2m
12137,2,TitorJ,2800,1314,78,72,150,52.0%,59m
12137,2,玛格吉贾德诺,2800,1460,66,50,116,56.9%,8m
12137,3,三三三鹿,2800,455,52,36,88,59.1%,9m
12137,3,杞人忧天丶,2800,694,35,26,61,57.4%,8m
12137,3,颅骨,2800,547,24,11,35,68.6%,23m
12137,2,尉狼胜于蓝,2800,467,18,22,40,45.0%,14m
12137,3,gesila,2800,250,14,11,25,56.0%,15m
12137,2,孤城,2800,336,13,12,25,52.0%,6m
12137,3,[MiRacL]fringe,2800,235,7,7,14,50.0%,53m
12137,2,一曲相思,2800,0,4,1,5,80.0%,1h
12137,3,AOS,2800,120,4,4,8,50.0%,15m
12137,2,梦想指挥官,2800,44,4,4,8,50.0%,26m
12137,2,[五月花]小染,2800,115,4,4,8,50.0%,13m
12137,1,[火法]lulululunat,2800,164,4,13,17,23.5%,33m
12137,3,nbnbNDG,2800,30,2,2,4,50.0%,6m
12137,2,[社交学学者]yangguang,2800,0,1,2,3,33.3%,52m
12137,1,Fate,2800,0,0,1,1,0.0%,52m
12157,3,IIIIIIIIIIII,2799,514,29,20,49,59.2%,7m
12157,3,执剑,2799,467,19,11,30,63.3%,2m
12157,3,我就是我,2799,470,17,18,35,48.6%,15m
12157,2,llllllllllll,2799,125,4,0,4,100.0%,1h
12157,3,nigular,2799,120,4,4,8,50.0%,15m
12157,3,[刺蛇单推协会]sky,2799,136,3,1,4,75.0%,58m
12157,2,[萝莉是我们哒]立华奏初音,2799,0,3,3,6,50.0%,50m
12157,2,[有组织无纪录]sdrcf,2799,88,2,3,5,40.0%,48m
12157,3,理查德没汤姆帅,2799,0,1,0,1,100.0%,23m
12157,3,WYX,2799,0,1,0,1,100.0%,7m
12157,3,[黎明航向]贺兰山之虎,2799,0,1,0,1,100.0%,17m
12157,3,lxk,2799,0,1,1,2,50.0%,8m
12157,3,GGGGGGGG,2799,0,0,1,1,0.0%,13m
12157,3,龙卷风,2799,0,0,1,1,0.0%,4m
12171,2,丁大款,2798,1200,66,62,128,51.6%,30m
12171,1,[Fear]小太阳,2798,971,36,42,78,46.2%,56m
12171,3,白岚,2798,673,29,21,50,58.0%,8m
12171,3,意别万里,2798,262,10,5,15,66.7%,29m
12171,3,[HustSC]Otin,2798,232,10,12,22,45.5%,8m
12171,2,sheep,2798,193,7,8,15,46.7%,18m
12171,3,爱乐姬乐团唧唧叽,2798,189,6,5,11,54.5%,27m
12171,2,ddd,2798,118,4,3,7,57.1%,1h
12171,2,魔法少女绫波,2798,0,3,2,5,60.0%,50m
12171,3,[新宿三丁目]农民猎杀者,2798,90,3,4,7,42.9%,57m
12171,3,Atia,2798,88,3,6,9,33.3%,18m
12171,3,[222333]有人权的动员兵,2798,30,2,0,2,100.0%,7m
12171,3,草原狼王灰太狼,2798,0,1,0,1,100.0%,22m
12171,1,走位靠扭丶,2798,40,1,4,5,20.0%,2m
12171,3,[纱雾姐姐]鹿田纱雾,2798,0,0,2,2,0.0%,15m
12171,2,IIIIIIIIII,2798,0,0,7,7,0.0%,16m
12187,3,[甜软]Zilters,2797,1173,101,126,227,44.5%,32m
12187,2,随风,2797,1528,98,92,190,51.6%,36m
12187,2,月落星辰,2797,876,38,37,75,50.7%,6m
12187,2,你要回城了,2797,197,36,31,67,53.7%,20m
12187,3,[虚无分部]天狼,2797,517,28,19,47,59.6%,56m
12187,3,hongbaba,2797,609,25,24,49,51.0%,9m
12187,3,反心,2797,482,22,16,38,57.9%,2m
12187,3,[暴雪十队]不会打星际啦,2797,264,10,3,13,76.9%,29m
12187,3,[MFJ]captain,2797,86,4,4,8,50.0%,23m
12187,3,暴雪爷爷,2797,121,3,2,5,60.0%,24m
12187,3,瓦西西,2797,60,3,3,6,50.0%,17m
12187,3,leng,2797,86,3,4,7,42.9%,17m
12187,2,aaaa,2797,40,2,1,3,66.7%,1h
12187,2,Phil,2797,0,2,2,4,50.0%,1h
12187,2,我是萌新,2797,0,2,3,5,40.0%,1h
12187,1,[真理卐高中]极限,2797,38,2,9,11,18.2%,7m
12187,1,[DB3]小猪,2797,0,1,1,2,50.0%,13m
12187,3,休眠火山,2797,30,1,2,3,33.3%,59m
12187,1,寂静如雨,2797,0,1,2,3,33.3%,52m
12187,2,终结者,2797,0,1,4,5,20.0%,21m
12187,3,[萌芯启萌团]星光幕,2797,0,0,1,1,0.0%,38m
12187,3,吊二,2797,0,0,1,1,0.0%,9m
12209,3,Tony,2796,1092,214,213,427,50.1%,14m
12209,2,[咪神咪神]飞雪连天,2796,1465,169,156,325,52.0%,29m
12209,2,玉置亚子,2796,1032,48,47,95,50.5%,28m
12209,3,SApphire,2796,899,46,36,82,56.1%,9m
12209,3,euck,2796,580,44,33,77,57.1%,15m
12209,2,天通苑,2796,850,37,28,65,56.9%,16m
12209,3,龙蛇影,2796,234,11,7,18,61.1%,1h
12209,3,[列克星敦天下]第一,2796,246,8,3,11,72.7%,52m
12209,2,GzGz,2796,192,8,8,16,50.0%,24m
12209,1,[星际老屁孩]你甚至不肯叫我,2796,230,7,2,9,77.8%,54m
12209,2,[乳冰ing]Burningice,2796,82,7,6,13,53.8%,1h
12209,3,小可童鞋丶,2796,163,7,7,14,50.0%,1h
12209,3,圣光不脏,2796,187,6,10,16,37.5%,1h
12209,3,管子村村长,2796,116,5,3,8,62.5%,2m
12209,2,璃安,2796,116,4,3,7,57.1%,1h
12209,1,战三坑,2796,32,4,6,10,40.0%,8m
12209,3,[这局稳了]GHOST,2796,0,1,0,1,100.0%,15m
12209,3,[飞跃来]温柔得猪猪,2796,0,1,3,4,25.0%,1h
12209,3,[钢铁雄心官群]宇宙最帅的酷酷哒,2796,0,0,1,1,0.0%,56m
12209,3,[曾经一群兔子]快乐的菜鸟,2796,0,0,1,1,0.0%,9m
12209,3,[肉鸡的饲养]仙筝,2796,0,0,1,1,0.0%,9m
12209,3,[菊花神教]Bill,2796,0,0,2,2,0.0%,2m
12231,3,饼干,2795,1416,75,45,120,62.5%,5m
12231,2,寒夜的星辰,2795,505,25,22,47,53.2%,10m
12231,3,gdfret,2795,496,20,13,33,60.6%,15m
12231,2,[loveMM]阿道夫特朗普,2795,399,19,10,29,65.5%,3m
12231,2,Will,2795,346,19,16,35,54.3%,6m
12231,3,叫我光头哥,2795,352,15,12,27,55.6%,6m
12231,3,曲大帅,2795,295,12,16,28,42.9%,15m
12231,3,CGCL,2795,234,10,7,17,58.8%,1h
12231,1,维京战机,2795,142,7,6,13,53.8%,9m
12231,2,[长沙大学]这个冬天没有惊喜,2795,139,5,1,6,83.3%,29m
12231,3,RRREX,2795,183,5,3,8,62.5%,31m
12231,2,bbc,2795,46,4,3,7,57.1%,1h
12231,3,[北京大学鸡协]QYY,2795,122,4,6,10,40.0%,15m
12231,2,专业抄袭年,2795,0,3,2,5,60.0%,29m
12231,2,夏特,2795,60,2,11,13,15.4%,11m
12231,3,[那里不可以]Nightmare,2795,0,1,0,1,100.0%,22m
12231,2,[核电站输不了]barrett,2795,0,1,4,5,20.0%,13m
12231,2,KANON,2795,0,1,5,6,16.7%,44m
12231,3,zhangbi,2795,0,0,1,1,0.0%,22m
12231,2,[暴雪二十七队]念默,2795,0,0,1,1,0.0%,29m
12251,3,Hermetist,2794,1533,95,85,180,52.8%,5m
12251,3,[华夏何平]ccc,2794,1603,89,81,170,52.4%,15m
12251,2,红星,2794,615,28,23,51,54.9%,7m
12251,3,[幼儿园老大]寻一缕残温,2794,562,25,13,38,65.8%,25m
12251,2,interest,2794,483,22,14,36,61.1%,26m
12251,3,[征戰聯盟丶]BOBO,2794,207,20,18,38,52.6%,28m
12251,3,青衫,2794,377,14,10,24,58.3%,31m
12251,2,凯斯蒂亚,2794,343,14,15,29,48.3%,12m
12251,1,[曾经一群兔子]告别薇安,2794,140,3,0,3,100.0%,22m
12251,2,卢伟不忘本,2794,0,3,3,6,50.0%,1h
12251,1,Sbiutful,2794,114,2,1,3,66.7%,54m
12251,3,可乐鸡翅,2794,30,1,1,2,50.0%,31m
12251,3,[超会玩]我爱果果,2794,0,0,1,1,0.0%,7m
12251,2,Riddle,2794,0,0,5,5,0.0%,4m
12265,3,塑料多多,2793,555,31,43,74,41.9%,25m
12265,2,[NVKR]OWENWTY,2793,342,13,11,24,54.2%,16m
12265,1,煲汤比写诗重要,2793,168,7,8,15,46.7%,18m
12265,3,霸气你晨哥,2793,120,5,5,10,50.0%,16m
12265,1,Alan,2793,96,4,4,8,50.0%,1h
12265,2,Clear,2793,0,3,1,4,75.0%,26m
12265,3,[QWQa]小凛敢日坑道虫,2793,60,3,2,5,60.0%,7m
12265,3,[湖面倒影]苍蓝,2793,30,2,0,2,100.0%,27m
12265,2,[梁山泊]城市游鱼,2793,0,1,0,1,100.0%,10m
12265,3,[星际一号]玩星际的渣渣辉,2793,0,1,0,1,100.0%,27m
12265,2,一言不合就玩虫,2793,0,1,3,4,25.0%,16m
12265,3,撕裂光芒,2793,0,0,1,1,0.0%,18m
12265,3,阿西巴,2793,0,0,1,1,0.0%,5m
12265,3,兵者,2793,0,0,1,1,0.0%,31m
12265,3,巅锋,2793,0,0,4,4,0.0%,18m
12280,3,真夏夜的野兽先辈,2792,1195,71,52,123,57.7%,5m
12280,1,TIANYAKING,2792,1035,54,62,116,46.6%,24m
12280,2,PIPIPIGD,2792,1198,52,61,113,46.0%,30m
12280,3,断弦,2792,223,49,29,78,62.8%,27m
12280,2,love,2792,666,29,26,55,52.7%,12m
12280,2,[社交学导师]cxx,2792,692,29,28,57,50.9%,36m
12280,3,Trent,2792,550,23,14,37,62.2%,3m
12280,2,沉沦,2792,415,20,16,36,55.6%,22m
12280,3,[白银联盟]xhllybz,2792,270,12,3,15,80.0%,29m
12280,3,雨日,2792,230,11,7,18,61.1%,1h
12280,3,易玄,2792,140,4,1,5,80.0%,23m
12280,2,[面纱祭祀]PALLADINO,2792,46,2,1,3,66.7%,38m
12280,2,自由飞翔,2792,0,2,2,4,50.0%,36m
12280,1,咖喱棒,2792,93,2,3,5,40.0%,1h
12280,2,eeeeeriic,2792,0,1,0,1,100.0%,20m
12280,1,[混吃混喝]能不能别打探机啊,2792,0,1,1,2,50.0%,1h
12280,3,WaterOS,2792,30,1,2,3,33.3%,13m
12280,1,肥仔唔易做,2792,0,0,1,1,0.0%,38m
12298,3,zest,2791,1337,64,35,99,64.6%,22m
12298,3,疯恰恰,2791,244,25,25,50,50.0%,18m
12298,3,[WOAI]worldking,2791,174,21,22,43,48.8%,57m
12298,3,[FLDSCL]Flandre,2791,260,8,8,16,50.0%,31m
12298,3,夺走你的心,2791,245,7,8,15,46.7%,6m
12298,2,[不偷不狗全靠]可以吗,2791,144,3,8,11,27.3%,20m
12298,3,Fire,2791,0,1,1,2,50.0%,31m
12298,3,[暴雪家族]奥利尔,2791,30,1,1,2,50.0%,56m
12298,3,[嗜魂舰队]卡尔哦皮,2791,30,1,3,4,25.0%,16m
12307,3,[EMA]Reiuy,2790,855,40,29,69,58.0%,4m
12307,1,小猫小小猫,2790,452,16,21,37,43.2%,24m
12307,3,飘一个,2790,393,15,14,29,51.7%,2m
12307,2,Freedom,2790,347,14,16,30,46.7%,30m
12307,3,[奥利给857]别骚我行么,2790,263,9,5,14,64.3%,28m
12307,3,我不知道不要问我,2790,238,7,6,13,53.8%,30m
12307,3,[桜公馆]magejiTerran,2790,200,7,8,15,46.7%,59m
12307,3,llllIIIlllI,2790,111,4,4,8,50.0%,5m
12307,3,[四叶草]逆蝶,2790,60,4,5,9,44.4%,7m
12307,1,希望,2790,48,3,6,9,33.3%,59m
12307,3,Dark,2790,30,2,1,3,66.7%,5m
12307,3,DackStar,2790,58,2,2,4,50.0%,25m
12307,3,半个菜鸡,2790,58,2,2,4,50.0%,14m
12307,3,骚到死,2790,0,0,1,1,0.0%,57m
12307,3,DAhall,2790,0,0,1,1,0.0%,9m
12322,3,[NS]拥凌,2789,1158,62,89,151,41.1%,15m
12322,3,haibara,2789,687,29,18,47,61.7%,6m
12322,3,黄塞肉,2789,533,20,13,33,60.6%,29m
12322,3,[小鸡屠宰场a]LouisVuitton,2789,545,20,20,40,50.0%,3m
12322,2,[A2B]lanius,2789,533,19,22,41,46.3%,55m
12322,3,大鸡腿好吃,2789,407,16,13,29,55.2%,28m
12322,3,庄槿森,2789,314,12,6,18,66.7%,9m
12322,1,wolves,2789,278,8,7,15,53.3%,22m
12322,3,不可描述的瓜瓜,2789,34,4,4,8,50.0%,7m
12322,3,Demon,2789,58,3,1,4,75.0%,2m
12322,2,[血小板即正义]北笙,2789,92,3,3,6,50.0%,1h
12322,1,蘑菇云,2789,48,2,1,3,66.7%,59m
12322,1,征伐,2789,0,1,0,1,100.0%,47m
12335,3,全是弟弟,2788,1627,365,359,724,50.4%,5m
12335,3,大地堡小地堡,2788,1579,183,168,351,52.1%,8m
12335,3,Heinrich,2788,1031,48,49,97,49.5%,27m
12335,2,[开门查地嗪啦]感觉自己萌萌哒,2788,174,21,18,39,53.8%,11m
12335,3,可乐,2788,443,18,13,31,58.1%,56m
12335,3,[AB神教]caicai,2788,453,18,17,35,51.4%,15m
12335,3,疯子帅帅,2788,370,13,8,21,61.9%,2m
12335,3,红泪,2788,240,11,8,19,57.9%,57m
12335,3,半朵肖雅,2788,236,8,7,15,53.3%,56m
12335,3,butterfly,2788,151,7,10,17,41.2%,57m
12335,3,潞溍,2788,154,6,7,13,46.2%,15m
12335,3,[耶耶]Spec,2788,188,5,6,11,45.5%,12m
12335,2,我是萌新轻点打,2788,0,3,1,4,75.0%,10m
12335,3,猪的电视台,2788,86,3,3,6,50.0%,9m
12335,2,[暗黑执政官]魏氏天下,2788,46,3,3,6,50.0%,42m
12335,2,kissabc,2788,0,2,3,5,40.0%,1h
12335,3,[暴雪十九队]所以有,2788,30,1,1,2,50.0%,2m
12335,3,我是一条鱼,2788,0,0,1,1,0.0%,9m
12335,3,[虚空光辉舰]Elyos,2788,0,0,1,1,0.0%,57m
12335,3,lllllllllll,2788,0,0,2,2,0.0%,59m
12355,3,雷米阿萨德,2787,560,88,63,151,58.3%,31m
12355,1,ISlAMIC,2787,1014,39,45,84,46.4%,57m
12355,3,花泪,2787,601,26,20,46,56.5%,31m
12355,3,mlfs,2787,617,25,25,50,50.0%,27m
12355,3,[CPT]fengshao,2787,560,24,17,41,58.5%,6m
12355,3,Ywy,2787,262,19,17,36,52.8%,3m
12355,2,[小鸡屠宰场b]really,2787,456,16,26,42,38.1%,11m
12355,3,Raymond,2787,347,14,7,21,66.7%,12m
12355,3,[艾尔之巅]飞龙,2787,356,13,8,21,61.9%,27m
12355,3,小小的牢饭,2787,336,12,13,25,48.0%,58m
12355,2,在城,2787,324,12,15,27,44.4%,28m
12355,2,Change,2787,280,10,13,23,43.5%,22m
12355,2,jvhdaskh,2787,46,4,4,8,50.0%,45m
12355,2,崔思念想意郭郭,2787,0,3,2,5,60.0%,49m
12355,3,cmh,2787,60,3,3,6,50.0%,57m
12355,1,九天一,2787,189,3,5,8,37.5%,15m
12355,3,胜利,2787,0,1,0,1,100.0%,59m
12355,3,[ZLR]Zimba,2787,0,1,1,2,50.0%,5m
12355,2,先天圣体道胎,2787,0,1,2,3,33.3%,45m
12355,3,[HENUSC]格兰芬多,2787,0,0,1,1,0.0%,2m
12355,3,Welt,2787,0,0,1,1,0.0%,56m
12355,2,[董魔王制霸军]抽象大师,2787,0,0,1,1,0.0%,1h
12377,2,志在必得,2786,976,88,81,169,52.1%,27m
12377,3,Recalling,2786,534,23,13,36,63.9%,31m
12377,1,无能狂怒,2786,258,8,8,16,50.0%,1h
12377,3,[萌新一只]Bela,2786,185,5,3,8,62.5%,22m
12377,3,jack,2786,0,4,1,5,80.0%,5m
12377,2,woshinibaba,2786,118,4,1,5,80.0%,58m
12377,1,淡定未遂,2786,211,4,3,7,57.1%,39m
12377,2,[Announ]橙黄白毫,2786,141,3,1,4,75.0%,59m
12377,2,Monkey,2786,95,3,4,7,42.9%,25m
12377,2,llllllllllll,2786,89,2,1,3,66.7%,1h
12377,2,那句晚安你听了吗,2786,0,2,3,5,40.0%,13m
12377,3,[火焰雷兽]xuanily,2786,62,2,5,7,28.6%,59m
12377,3,[Rhusky]星海迷航,2786,0,1,0,1,100.0%,31m
12377,1,[OgiNA]蒜泥,2786,48,1,4,5,20.0%,1h
12377,3,Zerg,2786,0,0,5,5,0.0%,40m
12392,3,武汉刘德华,2785,1496,80,61,141,56.7%,6m
12392,2,红酒,2785,542,39,42,81,48.1%,2m
12392,2,[浮世清欢]锐步,2785,605,30,18,48,62.5%,21m
12392,3,[深海栖姬]茵催思汀,2785,432,22,7,29,75.9%,2m
12392,3,[CPT]冶瞳三炼,2785,206,16,7,23,69.6%,58m
12392,3,鲸落南北,2785,442,16,18,34,47.1%,3m
12392,3,[SC2战队]IIIIIIIIIIII,2785,263,10,5,15,66.7%,6m
12392,3,JiaHuan,2785,277,9,7,16,56.2%,15m
12392,3,芙兰朵露斯卡蕾特,2785,219,8,8,16,50.0%,22m
12392,3,Recort,2785,197,6,6,12,50.0%,8m
12392,1,章鱼蛋,2785,96,5,6,11,45.5%,45m
12392,2,[刀剑联盟]剑之神器,2785,94,4,2,6,66.7%,1h
12392,3,老大卖饭,2785,117,3,0,3,100.0%,59m
12392,2,阿巴巴,2785,0,3,2,5,60.0%,1h
12392,1,[迷路的麋鹿]世界首富博丽灵梦,2785,0,3,4,7,42.9%,11m
12392,3,PassJun,2785,30,1,3,4,25.0%,28m
12392,3,[SrA鹤望兰]济海,2785,0,0,1,1,0.0%,22m
12392,3,蜡笔小酸,2785,0,0,1,1,0.0%,53m
12392,2,TearsYu,2785,0,0,1,1,0.0%,1h
12392,2,[Freedo]Franks,2785,0,0,5,5,0.0%,49m
12412,2,PPP,2784,1647,454,440,894,50.8%,30m
12412,3,[慢手e族]多多丸,2784,1077,143,131,274,52.2%,12m
12412,2,指尖的艺术,2784,1027,65,57,122,53.3%,16m
12412,3,[Rhusky]markjimken,2784,807,30,26,56,53.6%,56m
12412,3,lixin,2784,454,18,13,31,58.1%,8m
12412,2,IIIIIIIIIIII,2784,324,10,14,24,41.7%,2m
12412,3,[蕾姆酱]灵符掌握,2784,235,9,3,12,75.0%,31m
12412,3,飞虎,2784,242,9,8,17,52.9%,8m
12412,3,Demon,2784,209,7,4,11,63.6%,5m
12412,1,越狱,2784,255,7,4,11,63.6%,22m
12412,2,萌新给点机会,2784,124,7,9,16,43.8%,11m
12412,3,[襄铃]绝世可爱刘人语,2784,148,6,2,8,75.0%,23m
12412,3,[贝贝龙]梦蝶蝶蝶蝶蝶,2784,162,5,2,7,71.4%,3m
12412,3,被冰封的蛙,2784,95,5,6,11,45.5%,7m
12412,2,rocket,2784,189,4,4,8,50.0%,44m
12412,3,[Wings]高橋美穂,2784,114,4,6,10,40.0%,15m
12412,3,[咕咕学院]幻想乡乡长,2784,132,3,2,5,60.0%,22m
12412,2,汉子也疯狂,2784,0,3,3,6,50.0%,1h
12412,2,皇家学会,2784,95,3,3,6,50.0%,43m
12412,3,[东风物流]亿万少女的白日梦,2784,115,3,4,7,42.9%,58m
12412,3,JOJO,2784,62,2,11,13,15.4%,2m
12412,3,[大健王朝]幻冰寒月,2784,0,1,1,2,50.0%,3m
12412,2,happy,2784,46,1,2,3,33.3%,17m
12412,3,青葉,2784,30,1,3,4,25.0%,7m
12412,3,[小鸡子娃]帅气的鸭蜀黍,2784,0,0,1,1,0.0%,56m
12412,3,Windrunner,2784,0,0,1,1,0.0%,28m
12412,3,皇恪,2784,0,0,1,1,0.0%,3m
12439,3,miracle,2783,1562,151,138,289,52.2%,5m
12439,3,红魔轨迹,2783,1581,137,125,262,52.3%,31m
12439,1,又菜又爱玩,2783,1285,127,134,261,48.7%,2m
12439,3,风羽翼之,2783,919,87,57,144,60.4%,4m
12439,3,星际战哥,2783,325,41,29,70,58.6%,3m
12439,2,Balalalala,2783,625,25,33,58,43.1%,26m
12439,3,心已失梦已碎,2783,454,21,9,30,70.0%,31m
12439,3,[寒绯樱]隐刀,2783,576,20,22,42,47.6%,7m
12439,2,Oyster,2783,361,13,10,23,56.5%,40m
12439,2,[帝国春秋]冥界死神,2783,288,13,11,24,54.2%,1h
12439,3,狱锁狂龙,2783,228,9,8,17,52.9%,2m
12439,3,樱满梨明,2783,236,9,9,18,50.0%,38m
12439,3,hyh,2783,231,9,10,19,47.4%,40m
12439,2,[你打过职业吗]AutumnCHN,2783,148,9,15,24,37.5%,7m
12439,2,IIIIIIIII,2783,138,8,3,11,72.7%,35m
12439,3,西风烈,2783,207,8,7,15,53.3%,1h
12439,1,Death,2783,228,6,5,11,54.5%,1h
12439,2,电脑,2783,0,4,1,5,80.0%,1h
12439,3,llllllllllll,2783,0,3,2,5,60.0%,1h
12439,3,新空调,2783,0,3,2,5,60.0%,42m
12439,3,感性的大压腿,2783,30,2,3,5,40.0%,3m
12439,3,[D0F]shinichi,2783,0,1,0,1,100.0%,59m
12439,3,秋风萧瑟,2783,0,1,1,2,50.0%,30m
12439,3,云中的雾,2783,30,1,2,3,33.3%,14m
12439,2,最美不过夕阳红,2783,46,1,2,3,33.3%,1h
12439,3,[游骑兵头子]吉姆雷诺,2783,0,0,1,1,0.0%,5m
12439,3,翻译羽绒服,2783,0,0,1,1,0.0%,13m
12439,3,kay,2783,0,0,2,2,0.0%,9m
12467,1,[火焰雷兽]为你而战,2782,556,143,146,289,49.5%,15m
12467,3,[TAK]syd,2782,633,47,36,83,56.6%,3m
12467,3,七七小可爱吖,2782,310,42,33,75,56.0%,15m
12467,3,[EOS]新手电脑,2782,910,37,35,72,51.4%,23m
12467,3,[HIT]Supertairio,2782,473,34,23,57,59.6%,23m
12467,1,卡卡希,2782,846,30,40,70,42.9%,13m
12467,1,[NVKR]呆表永远滴神,2782,543,22,23,45,48.9%,55m
12467,2,[嘤嘤嘤呜呜]IIIIIIIIIIII,2782,526,19,19,38,50.0%,27m
12467,3,她似白月中来,2782,391,17,11,28,60.7%,2m
12467,2,卓越乃罩,2782,91,17,19,36,47.2%,29m
12467,2,[专打嘤嘤怪]南云,2782,340,13,12,25,52.0%,21m
12467,3,Nick,2782,62,3,3,6,50.0%,58m
12467,2,zhaowenbosb,2782,94,3,3,6,50.0%,17m
12467,3,塔达林高阶跳虫,2782,113,2,1,3,66.7%,6m
12467,3,[专业de团队]泰伦永远在白给,2782,109,2,1,3,66.7%,56m
12467,3,韩宗,2782,0,1,0,1,100.0%,3m
12467,3,临渊羡鱼,2782,30,1,1,2,50.0%,28m
12467,3,[XXHZ1]黎明之光,2782,30,1,6,7,14.3%,4m
12485,2,IIIIIIIIIIII,2781,1539,255,247,502,50.8%,12m
12485,3,EDGclearlove,2781,1450,175,155,330,53.0%,59m
12485,2,星灵,2781,1579,98,90,188,52.1%,19m
12485,3,东华街道办主任,2781,1268,60,32,92,65.2%,8m
12485,3,情多误美人,2781,883,59,55,114,51.8%,3m
12485,3,PIGKING,2781,444,21,10,31,67.7%,14m
12485,3,[Sfae]千堂瑛里华,2781,367,14,12,26,53.8%,28m
12485,3,[艾尔之名]IIIIIIIIIIII,2781,319,13,5,18,72.2%,15m
12485,3,[我们是无敌的]superjc,2781,282,10,11,21,47.6%,3m
12485,3,不懒的懒猫,2781,250,9,6,15,60.0%,13m
12485,1,Itallnice,2781,262,8,8,16,50.0%,1h
12485,1,[合作老司机]嘿嘿呦嘿嘿,2781,164,7,4,11,63.6%,1h
12485,2,[电竞人贩子]哭哭哭哭泣,2781,179,4,6,10,40.0%,14m
12485,3,HANDHOME,2781,122,3,2,5,60.0%,1h
12485,2,风男,2781,0,3,3,6,50.0%,49m
12485,3,[Xie菜鸟]JerryXie,2781,55,2,2,4,50.0%,7m
12485,3,丑弟,2781,0,2,3,5,40.0%,1h
12485,1,andy,2781,0,1,0,1,100.0%,16m
12485,3,[白翎舰队]这个机场下得早啊,2781,0,1,1,2,50.0%,27m
12485,3,[别爱我像朋友]别爱我像朋友,2781,0,0,1,1,0.0%,23m
12485,3,半世清秋丶瑜,2781,0,0,1,1,0.0%,25m
12506,3,IMMC,2780,1302,237,230,467,50.7%,27m
12506,2,pingping,2780,844,52,42,94,55.3%,6m
12506,3,执政官,2780,323,45,36,81,55.6%,8m
12506,1,[入侵地球]星际蘸酱,2780,886,42,47,89,47.2%,10m
12506,3,我要起个好名字,2780,764,35,18,53,66.0%,31m
12506,3,[上班族牌护手]迷儿,2780,425,22,22,44,50.0%,59m
12506,1,youlong,2780,500,22,28,50,44.0%,4m
12506,3,少帮主,2780,288,18,14,32,56.2%,23m
12506,3,落幕,2780,114,5,4,9,55.6%,6m
12506,3,烧香,2780,114,5,4,9,55.6%,3m
12506,3,Capricorn,2780,93,4,2,6,66.7%,25m
12506,3,北有疑兵,2780,118,4,4,8,50.0%,4m
12506,1,孤独的的五香蛋,2780,48,4,5,9,44.4%,56m
12506,2,别看我,2780,91,2,0,2,100.0%,10m
12506,3,IIIIIIIIIIII,2780,0,1,0,1,100.0%,3m
12506,3,Joker,2780,0,1,0,1,100.0%,5m
12506,3,麋露露只会乱玩,2780,0,1,1,2,50.0%,23m
12506,2,魔法少女伊蕾娜,2780,0,0,1,1,0.0%,20m
12506,3,菊花侠,2780,0,0,1,1,0.0%,9m
12506,3,千灯引,2780,0,0,1,1,0.0%,2m
12506,3,[小鸡屠宰场3]安泰孙一峰,2780,0,0,3,3,0.0%,18m
12527,3,risk,2779,1550,552,573,1125,49.1%,2m
12527,2,摸爬滚打上白金,2779,1588,140,135,275,50.9%,27m
12527,3,PSUCK,2779,1398,102,96,198,51.5%,59m
12527,1,Echo,2779,748,91,95,186,48.9%,14m
12527,2,icelatte,2779,1503,69,68,137,50.4%,11m
12527,3,llllllllllll,2779,1544,65,55,120,54.2%,2m
12527,1,[菜有菜的道理]屠农啦,2779,1392,57,62,119,47.9%,21m
12527,3,[Misty]zai,2779,645,44,37,81,54.3%,58m
12527,3,风生水起,2779,621,24,22,46,52.2%,31m
12527,3,嘤嘤嘤,2779,469,18,14,32,56.2%,2m
12527,3,[这并非河里]羽沧,2779,350,16,5,21,76.2%,5m
12527,3,虚空低语,2779,148,12,14,26,46.2%,2m
12527,3,不知所措,2779,276,11,4,15,73.3%,22m
12527,3,[DJDNB]发酵工程,2779,279,11,5,16,68.8%,31m
12527,3,spectre,2779,302,11,8,19,57.9%,29m
12527,3,[混吃混喝]嘉裕关,2779,184,7,2,9,77.8%,5m
12527,3,[刺蛇互助天团]Kithri,2779,205,6,4,10,60.0%,1h
12527,3,小莫满满,2779,182,6,9,15,40.0%,1h
12527,2,[天云宫]问乾蟑螂比输本多,2779,42,5,2,7,71.4%,1h
12527,2,Kliomecem,2779,93,5,2,7,71.4%,52m
12527,1,风景似旧年,2779,120,5,5,10,50.0%,1h
12527,2,宸挽,2779,44,4,4,8,50.0%,1h
12527,2,[五月花]XiaoYu,2779,132,3,0,3,100.0%,10m
12527,3,winson,2779,0,3,2,5,60.0%,40m
12527,2,死亡之翼,2779,93,3,3,6,50.0%,39m
12527,3,[NB丶]永恒,2779,143,3,3,6,50.0%,56m
12527,3,YTYT,2779,58,2,2,4,50.0%,31m
12527,3,[XX丶OO]木目,2779,0,2,3,5,40.0%,32m
12527,1,[浙江大学战队]关东军防疫给水部,2779,0,1,0,1,100.0%,23m
12527,3,[笑傲星球]SunDay,2779,0,0,3,3,0.0%,27m
12557,3,[鲲之大]宇之可恋,2778,1545,106,95,201,52.7%,2m
12557,2,幻梦,2778,1273,60,46,106,56.6%,7m
12557,1,[誰与争锋]Kingone,2778,764,40,50,90,44.4%,8m
12557,3,[冠冕]lingtas,2778,900,39,28,67,58.2%,9m
12557,2,ShanHe,2778,640,31,24,55,56.4%,3m
12557,3,mihotel,2778,516,26,17,43,60.5%,31m
12557,3,[暴雪三十一队]云狂风虐,2778,309,10,9,19,52.6%,9m
12557,3,Graendal,2778,302,10,10,20,50.0%,58m
12557,3,[全员F2A]FantasyP,2778,204,7,5,12,58.3%,33m
12557,3,无线火力,2778,125,7,5,12,58.3%,1h
12557,1,didme,2778,116,5,6,11,45.5%,10m
12557,2,香飘飘,2778,94,3,3,6,50.0%,45m
12557,1,different,2778,96,3,4,7,42.9%,11m
12557,2,[暴雪二队]dolf,2778,94,3,4,7,42.9%,17m
12557,3,jxws,2778,30,2,2,4,50.0%,7m
12557,3,黑丝红高跟,2778,0,1,0,1,100.0%,23m
12557,3,爆不爆炸,2778,0,1,0,1,100.0%,15m
12557,3,TEwager,2778,0,0,1,1,0.0%,3m
12557,3,cys,2778,0,0,1,1,0.0%,22m
12557,3,耿彬吃粑粑,2778,0,0,1,1,0.0%,59m
12557,3,打不死风雅东方,2778,0,0,1,1,0.0%,56m
12557,3,桃源晓,2778,0,0,2,2,0.0%,58m
12579,3,[巨龙降临]阿莱克斯塔萨,2777,683,39,28,67,58.2%,14m
12579,3,JinAirMaru,2777,403,14,12,26,53.8%,17m
12579,3,[星际飙车王]御史神风,2777,374,14,12,26,53.8%,7m
12579,3,DJPOWER,2777,292,10,6,16,62.5%,28m
12579,3,[暴雪十五队]大多数,2777,168,7,0,7,100.0%,5m
12579,1,ikj,2777,167,7,4,11,63.6%,1h
12579,3,[烧酒叁叁]棣堂卿,2777,181,6,3,9,66.7%,14m
12579,3,人间不值得,2777,0,4,1,5,80.0%,1h
12579,2,[慢手e族]很有趣,2777,108,4,4,8,50.0%,1h
12579,1,誓言如尘染年华,2777,164,4,9,13,30.8%,33m
12579,2,洋爱奕,2777,0,3,3,6,50.0%,27m
12579,2,[鸽德]LAOFE,2777,128,3,4,7,42.9%,1h
12579,3,奴隶少女孙一峰,2777,30,2,2,4,50.0%,7m
12579,3,冷文渊,2777,0,1,0,1,100.0%,5m
12579,3,来吃脱氧核糖,2777,0,1,0,1,100.0%,7m
12579,3,[Fnova]kjl,2777,91,1,1,2,50.0%,14m
12579,3,Sirius,2777,42,1,3,4,25.0%,22m
12596,3,Martin,2776,1130,51,39,90,56.7%,14m
12596,3,[Hdl]estarvs,2776,957,37,33,70,52.9%,3m
12596,3,[hddys]远杂技,2776,814,33,29,62,53.2%,8m
12596,3,[共產星际]独立纵队先锋部队,2776,826,31,26,57,54.4%,28m
12596,3,维我余,2776,625,23,18,41,56.1%,3m
12596,3,战闪新星,2776,422,21,8,29,72.4%,13m
12596,3,云雨浩瀚,2776,378,15,7,22,68.2%,14m
12596,3,XZero,2776,380,14,12,26,53.8%,28m
12596,2,[GEM]弑殇的回忆,2776,279,12,10,22,54.5%,1h
12596,2,[东方之梦]永远亭的辉夜,2776,134,8,9,17,47.1%,47m
12596,3,泉水指挥官,2776,173,7,6,13,53.8%,1h
12596,2,[萌思课帝国]LikeSnowing,2776,209,6,10,16,37.5%,14m
12596,1,[超级大唧唧]吸舔乳来佛祖,2776,197,5,6,11,45.5%,31m
12596,3,沈菲洋吾儿,2776,0,4,5,9,44.4%,29m
12596,1,浩泽,2776,96,4,5,9,44.4%,22m
12596,3,[oneny]国民老婆孙一峰,2776,97,3,6,9,33.3%,53m
12596,3,二愣子,2776,94,2,0,2,100.0%,2m
12596,1,虫群之心,2776,48,2,3,5,40.0%,11m
12596,3,[暴雪我是你爹]命运,2776,0,1,0,1,100.0%,59m
12596,3,[花开彼岸天]dancer,2776,0,0,2,2,0.0%,7m
12616,3,lee,2775,1499,312,314,626,49.8%,27m
12616,2,[FKA]DTSknanLP,2775,1427,166,151,317,52.4%,10m
12616,3,cccccm,2775,1386,78,63,141,55.3%,15m
12616,3,四角吞金兽,2775,1303,61,52,113,54.0%,9m
12616,2,NarthurE,2775,802,60,53,113,53.1%,5m
12616,3,薄盐鳕鱼子,2775,694,55,52,107,51.4%,56m
12616,2,[星际旅游团]saligia,2775,856,37,31,68,54.4%,5m
12616,3,Pro,2775,706,33,21,54,61.1%,9m
12616,2,刘刘刘,2775,364,32,25,57,56.1%,11m
12616,3,[DGL丿茗门]埃尔德尼亚,2775,627,29,10,39,74.4%,18m
12616,3,IIIIIIIIIIII,2775,233,26,19,45,57.8%,3m
12616,2,[KPG2]季风行者,2775,448,26,27,53,49.1%,20m
12616,3,[深黑幻想]黑白为你,2775,372,15,14,29,51.7%,12m
12616,1,[25鸡]谈笑风生,2775,350,13,25,38,34.2%,24m
12616,2,magicka,2775,209,12,12,24,50.0%,20m
12616,3,[Toss]Skai,2775,235,10,1,11,90.9%,23m
12616,2,一十七,2775,178,8,1,9,88.9%,4m
12616,3,[HUC轩辕]商业头脑,2775,86,3,5,8,37.5%,57m
12616,2,Blackhole,2775,0,1,0,1,100.0%,1h
12616,3,[璀璨群星之刃]璀璨阿克尔蒙德,2775,0,1,1,2,50.0%,27m
12616,3,森近店长,2775,93,1,1,2,50.0%,5m
12616,2,尖椒肉丝,2775,46,1,2,3,33.3%,4m
12616,3,LemonScarlet,2775,0,0,1,1,0.0%,8m
12616,2,NooBPLaYeR,2775,0,0,1,1,0.0%,44m
12640,2,Ayo,2774,1243,49,50,99,49.5%,7m
12640,1,[東佰往事]泛希腊太守,2774,502,22,33,55,40.0%,10m
12640,1,lschacha,2774,554,18,30,48,37.5%,33m
12640,2,jimba,2774,476,16,23,39,41.0%,27m
12640,3,战地跑路,2774,363,14,12,26,53.8%,31m
12640,2,[宗师]小小国宝,2774,337,13,16,29,44.8%,23m
12640,2,[WINED]快乐就完事了,2774,328,12,19,31,38.7%,2m
12640,3,[纯净的]tomato,2774,228,9,9,18,50.0%,15m
12640,3,两剑飚血,2774,217,7,5,12,58.3%,28m
12640,3,Eins,2774,162,6,2,8,75.0%,29m
12640,2,[你好抱歉]无敌海豚猪,2774,130,5,11,16,31.2%,1m
12640,3,[KSAR]勿中卍别天神,2774,179,4,7,11,36.4%,1h
12640,3,[XXHZ21]旭东之考验,2774,58,3,2,5,60.0%,18m
12640,1,WALLE,2774,114,3,2,5,60.0%,23m
12640,1,[H2]孤影残月望春水,2774,0,2,6,8,25.0%,1h
12640,3,van,2774,0,1,0,1,100.0%,15m
12640,3,白菜,2774,0,1,2,3,33.3%,58m
12640,3,SpecterGhost,2774,0,1,3,4,25.0%,14m
12640,3,AVE,2774,0,1,4,5,20.0%,2m
12640,2,[埃蒙调教员]DIS,2774,0,0,1,1,0.0%,1h
12640,2,[星绘]麻麻,2774,0,0,1,1,0.0%,38m
12640,1,敢杀我的马,2774,0,0,1,1,0.0%,54m
12662,3,old,2773,846,80,65,145,55.2%,58m
12662,3,吾本爱媚,2773,1572,70,60,130,53.8%,31m
12662,3,樱落阶前月,2773,1203,54,34,88,61.4%,12m
12662,3,喵苏鲁的呼唤,2773,894,39,27,66,59.1%,22m
12662,3,maru,2773,714,27,26,53,50.9%,28m
12662,1,OOV,2773,456,18,25,43,41.9%,55m
12662,3,再菜也爱玩,2773,259,10,5,15,66.7%,57m
12662,3,[火焰雷兽]HopeLess,2773,271,10,5,15,66.7%,15m
12662,3,PartinG,2773,200,6,5,11,54.5%,6m
12662,3,RubberPig,2773,174,6,8,14,42.9%,57m
12662,1,天尊杨戬,2773,46,4,5,9,44.4%,59m
12662,2,蔷薇,2773,90,4,7,11,36.4%,1h
12662,3,eafewadw,2773,133,3,2,5,60.0%,17m
12662,2,愤怒的打卤面,2773,42,3,4,7,42.9%,44m
12662,3,[萌新酒吧]迷离,2773,94,2,0,2,100.0%,18m
12662,3,[HFH]FeniX,2773,93,2,1,3,66.7%,58m
12662,3,爱苏苏,2773,30,2,3,5,40.0%,23m
12662,3,星空,2773,60,2,4,6,33.3%,6m
12662,3,abcdhahahha,2773,62,2,4,6,33.3%,15m
12662,1,Cocofame,2773,119,2,4,6,33.3%,11m
12662,3,[高阶圣堂武士]幽鬼兔,2773,30,1,3,4,25.0%,32m
12662,3,沉默等待崛起死亡,2773,0,0,1,1,0.0%,9m
12662,3,[worst]NANGONG,2773,0,0,1,1,0.0%,57m
12662,2,[浪啊浪]野人王,2773,0,0,1,1,0.0%,1h
12662,3,瞎神再临,2773,0,0,2,2,0.0%,6m
12687,3,胡说八道,2772,830,121,123,244,49.6%,17m
12687,3,[暴雪七队]faoss,2772,1497,85,78,163,52.1%,14m
12687,2,阿离啊,2772,657,78,88,166,47.0%,10m
12687,3,我真的不野隐刀,2772,673,34,27,61,55.7%,14m
12687,3,医生,2772,472,26,16,42,61.9%,7m
12687,2,fght,2772,528,20,22,42,47.6%,20m
12687,3,归海一刀,2772,426,16,15,31,51.6%,8m
12687,1,Valvrave,2772,261,10,19,29,34.5%,9m
12687,3,[在下萌新一只]永恒即逝,2772,285,9,8,17,52.9%,18m
12687,2,[专制各种不服]戏中人易散,2772,225,7,8,15,46.7%,1h
12687,3,[Sc养老]Tory,2772,145,4,2,6,66.7%,59m
12687,1,爱夜夜夜夜,2772,117,4,6,10,40.0%,1h
12687,3,lilqh,2772,114,3,0,3,100.0%,28m
12687,1,SunsetQ,2772,0,3,4,7,42.9%,18m
12687,3,[四叶草]小萌新,2772,30,2,4,6,33.3%,15m
12687,3,CILDK,2772,0,1,0,1,100.0%,29m
12687,2,Poison,2772,0,1,0,1,100.0%,4m
12687,2,佛渡有缘人,2772,0,0,1,1,0.0%,1h
12687,3,[ETG]宿疾,2772,0,0,1,1,0.0%,58m
12687,1,WElxh,2772,0,0,4,4,0.0%,2m
12707,2,kenler,2771,1519,539,534,1073,50.2%,16m
12707,2,术高莫用,2771,1112,117,107,224,52.2%,17m
12707,3,在劫难逃终流影,2771,1548,110,89,199,55.3%,28m
12707,3,kyrie,2771,735,41,28,69,59.4%,31m
12707,3,Destroy,2771,894,37,29,66,56.1%,5m
12707,2,[KOTRT]halo,2771,452,27,29,56,48.2%,26m
12707,3,LiarsDice,2771,528,24,21,45,53.3%,31m
12707,3,饕餮,2771,361,17,18,35,48.6%,23m
12707,3,Extra,2771,350,13,14,27,48.1%,2m
12707,3,[寂寞空虚冷]howmuch,2771,258,10,7,17,58.8%,33m
12707,3,Dream,2771,197,7,4,11,63.6%,15m
12707,3,[冒险者谐会]长沙孙一峰,2771,188,6,4,10,60.0%,23m
12707,1,朝思暮想冰,2771,96,4,4,8,50.0%,59m
12707,1,[丨哔哩哔哩丨]哭五五,2771,48,4,5,9,44.4%,1h
12707,2,[TeamCD]ZhuZhuPet,2771,0,3,3,6,50.0%,10m
12707,2,科比,2771,93,3,3,6,50.0%,1h
12707,3,[壹玖]dalaoIIIorz,2771,93,2,0,2,100.0%,59m
12707,1,达斯维达黄旭东,2771,48,2,3,5,40.0%,32m
12707,1,xixi,2771,0,2,7,9,22.2%,1h
12707,1,bigseven,2771,0,1,2,3,33.3%,46m
12707,2,[WCD]StanleyAlex,2771,0,0,1,1,0.0%,1h
12707,2,[xin仰]Christophe,2771,0,0,1,1,0.0%,1h
12707,3,[加州室内装修]蓬莱山辉夜,2771,0,0,1,1,0.0%,6m
12707,3,一剑,2771,0,0,1,1,0.0%,15m
12731,1,你需要哲学,2770,1389,111,100,211,52.6%,18m
12731,3,[慢手e族]菜鸟达拉姆之刃,2770,1420,90,70,160,56.2%,6m
12731,3,[萌新联姻]指挥,2770,1608,88,81,169,52.1%,17m
12731,3,Ryzen,2770,1165,53,41,94,56.4%,6m
12731,2,xiaoliu,2770,858,32,36,68,47.1%,26m
12731,2,MagicBlue,2770,667,25,25,50,50.0%,30m
12731,3,[喵帕斯的说]绯色月下,2770,489,24,10,34,70.6%,56m
12731,3,冰叶寒霜,2770,474,18,13,31,58.1%,7m
12731,3,two,2770,276,17,11,28,60.7%,18m
12731,3,谐雨,2770,258,9,5,14,64.3%,30m
12731,3,不水船,2770,196,7,8,15,46.7%,7m
12731,2,阿萨德,2770,172,7,11,18,38.9%,30m
12731,3,[西窗法雨]竹节香附,2770,169,5,3,8,62.5%,14m
12731,1,[小鲨鱼]笨蛋阿妮拉,2770,146,5,7,12,41.7%,46m
12731,2,萝莉口工少女酱,2770,66,5,7,12,41.7%,1h
12731,3,伊凡,2770,116,4,8,12,33.3%,16m
12731,2,就是喜欢小包纸,2770,140,4,8,12,33.3%,20m
12731,2,[神子]卖乖儿,2770,93,3,3,6,50.0%,1h
12731,3,[leepay]为了达拉然,2770,112,2,2,4,50.0%,28m
12731,3,[社交学大可爱]AMG,2770,60,2,4,6,33.3%,3m
12731,3,自闭的五边形,2770,0,1,0,1,100.0%,29m
12731,3,[浮世清欢]耗子尾汁,2770,91,1,1,2,50.0%,14m
12731,3,keduoli,2770,0,1,2,3,33.3%,8m
12731,3,小兵一号,2770,30,1,3,4,25.0%,56m
12731,3,[宇宙说你皮]宇宙之梦,2770,0,0,1,1,0.0%,23m
12731,3,Colin,2770,0,0,1,1,0.0%,28m
12757,3,yxiaowai,2769,764,55,36,91,60.4%,30m
12757,3,fdsfsdf,2769,488,23,11,34,67.6%,18m
12757,3,[天才mvp]RHO,2769,356,19,17,36,52.8%,56m
12757,3,算春长不老,2769,322,14,7,21,66.7%,6m
12757,3,[我真的好菜]SadHUnter,2769,288,11,10,21,52.4%,23m
12757,3,[DJTU]CrazyJTY,2769,270,11,15,26,42.3%,30m
12757,3,浪呀嘛浪打浪,2769,188,7,2,9,77.8%,3m
12757,3,[常州大学]YanKEE,2769,171,6,1,7,85.7%,6m
12757,1,Sadness,2769,231,6,8,14,42.9%,56m
12757,2,年少无知,2769,38,5,6,11,45.5%,1h
12757,3,captain,2769,114,4,7,11,36.4%,59m
12757,1,[老八美食团]栗悟饭和龟波功,2769,140,3,1,4,75.0%,56m
12757,3,ssxc,2769,0,1,0,1,100.0%,29m
12770,3,zhonglin,2768,1459,615,631,1246,49.4%,22m
12770,2,[激情吃粉]小果酱,2768,1212,47,50,97,48.5%,13m
12770,3,真的大丈夫,2768,956,39,26,65,60.0%,5m
12770,3,寒辰飒沓,2768,579,26,14,40,65.0%,32m
12770,1,[YMSX]黑尾白猫,2768,299,20,30,50,40.0%,33m
12770,3,虫群之主,2768,257,9,10,19,47.4%,1h
12770,1,[Supers]yetmf,2768,186,7,8,15,46.7%,1h
12770,3,[救世曙光]八个塔防赢不了,2768,190,6,3,9,66.7%,7m
12770,3,IIIIIIIIIIII,2768,164,6,7,13,46.2%,1h
12770,3,带我,2768,0,4,1,5,80.0%,57m
12770,2,熊先生,2768,0,4,2,6,66.7%,17m
12770,3,litianxing,2768,76,4,4,8,50.0%,59m
12770,3,[绝世佳人]Yamato,2768,86,4,4,8,50.0%,18m
12770,2,闪电,2768,44,3,5,8,37.5%,4m
12770,3,light,2768,30,2,1,3,66.7%,13m
12770,3,来生滑稽幻想乡,2768,30,1,3,4,25.0%,59m
12770,2,我的五十块,2768,0,0,1,1,0.0%,59m
12770,2,[悬溺堕星河]夜竹星夕,2768,0,0,1,1,0.0%,1h
12770,3,[蓝蓝路]MrWhiteWolF,2768,0,0,1,1,0.0%,32m
12770,1,[社交学超可爱]llllllllllll,2768,0,0,1,1,0.0%,40m
12770,3,当云朵拥有雨滴,2768,0,0,2,2,0.0%,31m
12770,3,Gamma,2768,0,0,3,3,0.0%,5m
12770,3,monkey,2768,0,0,3,3,0.0%,6m
12770,3,[上车]soulshadow,2768,0,0,5,5,0.0%,29m
12794,2,蛋大如斗黄旭东,2767,1636,1428,1444,2872,49.7%,6m
12794,2,奥古斯都,2767,960,126,117,243,51.9%,30m
12794,3,药丸,2767,1445,82,72,154,53.2%,13m
12794,3,Smile,2767,967,71,51,122,58.2%,8m
12794,1,Mvp,2767,1565,69,77,146,47.3%,23m
12794,3,deepblue,2767,636,44,38,82,53.7%,14m
12794,3,咸鱼塘塘主,2767,1122,44,45,89,49.4%,8m
12794,2,zwzwzwz,2767,191,37,37,74,50.0%,6m
12794,3,犹如一扶风,2767,805,34,31,65,52.3%,4m
12794,3,[晚上吃基]星际玩家都是瞎子,2767,570,29,23,52,55.8%,56m
12794,3,Amonda,2767,600,26,14,40,65.0%,32m
12794,3,[嘤嘤怪保护所]阿塔尼斯,2767,435,20,11,31,64.5%,14m
12794,3,[罗德岛制药厂]墨染红尘,2767,537,20,22,42,47.6%,14m
12794,3,[柒堇年华]风雨过后,2767,444,16,14,30,53.3%,31m
12794,2,清涟龙尘,2767,275,16,20,36,44.4%,23m
12794,3,[思君便安心]Mgou,2767,289,9,9,18,50.0%,12m
12794,1,泡泡茶壶,2767,217,9,11,20,45.0%,43m
12794,2,[镜花水月丶]专注输出某椛酱,2767,208,7,7,14,50.0%,14m
12794,2,渣男黄琦,2767,94,4,0,4,100.0%,59m
12794,3,SCIII,2767,0,4,1,5,80.0%,1h
12794,1,[KN]thetastar,2767,168,4,3,7,57.1%,45m
12794,2,Daryal,2767,0,3,2,5,60.0%,37m
12794,2,asas,2767,97,2,1,3,66.7%,1h
12794,3,我是大坑逼,2767,0,1,0,1,100.0%,7m
12794,2,[SME]ForAiur,2767,0,1,0,1,100.0%,1h
12794,2,杨柳青青,2767,0,1,0,1,100.0%,1h
12794,3,喵咪大军团,2767,91,1,1,2,50.0%,56m
12794,3,FYY,2767,0,1,2,3,33.3%,27m
12794,3,母舰不是航母,2767,0,0,1,1,0.0%,23m
12794,3,泰拉之刃,2767,0,0,1,1,0.0%,4m
12794,2,[天羽不榖]淇侍,2767,0,0,1,1,0.0%,1h
12825,1,kobe,2766,1564,427,426,853,50.1%,22m
12825,3,论农场中猪的革命,2766,1427,59,55,114,51.8%,13m
12825,2,嗯嗯嗯呢,2766,978,44,31,75,58.7%,9m
12825,2,wyy,2766,1007,37,40,77,48.1%,27m
12825,3,卟乖,2766,265,32,15,47,68.1%,4m
12825,3,糊涂错觉,2766,643,30,13,43,69.8%,3m
12825,3,[KPG]Muzzle,2766,592,26,16,42,61.9%,29m
12825,3,塞缪尔白白,2766,572,26,20,46,56.5%,4m
12825,3,电脑玩家困难,2766,584,24,17,41,58.5%,29m
12825,3,洛神,2766,506,22,17,39,56.4%,16m
12825,2,嗜血,2766,449,16,19,35,45.7%,14m
12825,2,蛮力之兽,2766,376,13,17,30,43.3%,13m
12825,2,hhhcookie,2766,326,12,11,23,52.2%,32m
12825,1,无理的文,2766,307,12,11,23,52.2%,1h
12825,2,lovezly,2766,348,11,20,31,35.5%,21m
12825,3,LuckyTerran,2766,206,8,9,17,47.1%,58m
12825,2,抗毒伤害,2766,182,6,5,11,54.5%,10m
12825,3,木夕,2766,88,3,6,9,33.3%,58m
12825,3,[兆景埋土大学]HotDog,2766,30,2,2,4,50.0%,3m
12825,3,暮光闪闪,2766,0,1,0,1,100.0%,3m
12825,3,NOe,2766,30,1,3,4,25.0%,56m
12825,3,zzzbbbwww,2766,30,1,4,5,20.0%,28m
12825,3,QAQ,2766,0,0,1,1,0.0%,6m
12825,2,yuzijiang,2766,0,0,1,1,0.0%,10m
12825,3,轰天炮,2766,0,0,2,2,0.0%,19m
12825,2,棺材里的森森,2766,0,0,2,2,0.0%,59m
12851,3,狂乱的天外尾巴,2765,1500,97,76,173,56.1%,31m
12851,2,你真烦人,2765,595,25,21,46,54.3%,24m
12851,2,[基金会]大虾吃掉你,2765,567,21,23,44,47.7%,11m
12851,2,[幽冥之狼]dreambreak,2765,360,13,18,31,41.9%,13m
12851,3,Landgrave,2765,256,11,9,20,55.0%,57m
12851,3,优莉,2765,305,11,9,20,55.0%,1h
12851,3,白蔷薇,2765,277,10,3,13,76.9%,29m
12851,3,[浴火银河]prettyoung,2765,226,10,9,19,52.6%,1h
12851,3,lllllllll,2765,202,9,1,10,90.0%,16m
12851,3,[imbaZz]心丶仰天,2765,211,6,6,12,50.0%,30m
12851,1,狗头,2765,142,5,4,9,55.6%,15m
12851,1,MarkVier,2765,137,5,5,10,50.0%,45m
12851,3,pylonlord,2765,124,5,6,11,45.5%,3m
12851,3,[暴雪养鸡场]Shuyining,2765,138,5,6,11,45.5%,32m
12851,1,恒哥,2765,143,5,6,11,45.5%,1h
12851,2,壹玖贰,2765,0,2,1,3,66.7%,48m
12851,3,Smilence,2765,30,2,3,5,40.0%,31m
12851,2,LGYscT,2765,0,2,4,6,33.3%,59m
12851,1,[THUDE]OhYes,2765,0,1,0,1,100.0%,59m
12851,3,[李时珍的皮]风的忧伤,2765,0,0,1,1,0.0%,15m
12851,3,[萌萌哒萌萌哒]jiangXD,2765,0,0,1,1,0.0%,7m
12851,3,剑来,2765,0,0,1,1,0.0%,59m
12851,3,渣渣鹏,2765,0,0,2,2,0.0%,27m
12874,1,HAHAH,2764,1513,143,141,284,50.4%,55m
12874,2,小小超人,2764,1431,100,75,175,57.1%,37m
12874,2,[艾尔之主]waiyinhehao,2764,1370,57,62,119,47.9%,13m
12874,2,[晨风]鬼丞相,2764,588,44,42,86,51.2%,12m
12874,3,多多多米诺,2764,573,27,7,34,79.4%,14m
12874,3,一年肆忌,2764,708,27,23,50,54.0%,32m
12874,3,[IMRTS2]MarvinLuis,2764,494,23,15,38,60.5%,22m
12874,1,刘地爬,2764,423,19,23,42,45.2%,18m
12874,3,侍奉的不错,2764,260,14,9,23,60.9%,27m
12874,3,[江城十三少]后羿射日,2764,134,14,10,24,58.3%,7m
12874,3,mAd,2764,394,14,12,26,53.8%,57m
12874,2,[QwQYo]这个有点难,2764,313,11,11,22,50.0%,56m
12874,3,Jaramandys,2764,183,7,2,9,77.8%,17m
12874,3,苗瑞,2764,179,5,4,9,55.6%,31m
12874,3,[呜呜呜嘤嘤]IIIIIIIIIIII,2764,150,5,10,15,33.3%,19m
12874,2,MicplGe,2764,109,4,3,7,57.1%,1h
12874,2,天际浮云,2764,116,4,4,8,50.0%,1h
12874,3,[搞大事]跳虫军师,2764,143,3,4,7,42.9%,28m
12874,3,[萌物狩猎者]TOSOGO,2764,0,1,0,1,100.0%,5m
12874,2,[LWI]ChRisLiu,2764,46,1,2,3,33.3%,1h
12874,3,小草的燃烧,2764,0,1,3,4,25.0%,58m
12874,3,天生找雷劈,2764,0,0,2,2,0.0%,28m
12874,3,[哔哩哔哩乾杯]Corrupt,2764,0,0,3,3,0.0%,1h
12897,2,幽灵,2763,1571,203,195,398,51.0%,27m
12897,3,希夫,2763,1554,107,87,194,55.2%,56m
12897,3,奥力给不给力奥,2763,1381,78,68,146,53.4%,5m
12897,3,terminator,2763,883,35,35,70,50.0%,31m
12897,2,[菜的没人带]大佬带带我啊,2763,726,34,76,110,30.9%,22m
12897,2,冲锋是胜利荣光,2763,690,24,33,57,42.1%,31m
12897,2,[黑灬手灬党]不死楚凤凰,2763,645,22,32,54,40.7%,2m
12897,1,野生熊猫,2763,439,14,22,36,38.9%,55m
12897,3,逐星者,2763,170,11,5,16,68.8%,59m
12897,2,[教父遇刺]BISU,2763,286,11,18,29,37.9%,17m
12897,2,水椰,2763,177,7,3,10,70.0%,1h
12897,2,北极熊背上的男人,2763,97,5,1,6,83.3%,43m
12897,3,[慕灬小冷]星城,2763,110,3,0,3,100.0%,17m
12897,3,LEO,2763,0,3,2,5,60.0%,48m
12897,3,[Beauty]黄开发,2763,137,3,3,6,50.0%,7m
12897,3,karrysan,2763,32,2,2,4,50.0%,57m
12897,1,鸡你太美,2763,82,2,3,5,40.0%,22m
12897,3,伊莱克斯,2763,0,1,0,1,100.0%,41m
12897,3,星光守望,2763,0,1,0,1,100.0%,57m
12897,3,XIAOYAO,2763,0,1,4,5,20.0%,23m
12897,3,IIIIIIIIIIII,2763,0,0,1,1,0.0%,30m
12918,2,[咪神咪神]xingfuyishen,2762,1317,97,90,187,51.9%,2m
12918,2,王小刀,2762,1604,63,69,132,47.7%,29m
12918,3,海马,2762,1326,62,41,103,60.2%,23m
12918,1,[我们都很强]夕阳下的轻风,2762,818,40,41,81,49.4%,4m
12918,3,刀客,2762,768,33,29,62,53.2%,4m
12918,3,Verde,2762,188,30,21,51,58.8%,56m
12918,2,蓝天之翼,2762,307,30,29,59,50.8%,6m
12918,3,胖头鱼,2762,516,24,7,31,77.4%,16m
12918,3,galaxyc,2762,249,9,5,14,64.3%,56m
12918,3,我的,2762,242,8,5,13,61.5%,50m
12918,1,无味浪味仙,2762,225,8,8,16,50.0%,57m
12918,3,llllllllllll,2762,211,6,4,10,60.0%,56m
12918,3,[闪电伍连鞭]奶茶壶,2762,146,6,5,11,54.5%,15m
12918,3,TerranX,2762,142,5,0,5,100.0%,16m
12918,3,圣风无极,2762,145,4,2,6,66.7%,29m
12918,1,猴哥,2762,178,4,4,8,50.0%,1h
12918,3,疾风隐居者,2762,170,4,6,10,40.0%,1h
12918,3,我是大魔王,2762,90,3,7,10,30.0%,58m
12918,2,[最强内鬼]南瓜,2762,0,1,0,1,100.0%,45m
12918,3,[暴雪我是你爹]Lucky,2762,0,1,1,2,50.0%,31m
12918,3,[RDFZsc]是盒盒盒子啊,2762,0,0,2,2,0.0%,29m
12939,3,allies,2761,438,171,157,328,52.1%,58m
12939,2,wolaidh,2761,1610,58,65,123,47.2%,2m
12939,3,振兴国服,2761,581,24,19,43,55.8%,31m
12939,3,[科普鲁区分部]Kyrie,2761,489,23,13,36,63.9%,30m
12939,3,盖世闲鱼,2761,487,19,15,34,55.9%,17m
12939,2,Henrrry,2761,390,19,18,37,51.4%,19m
12939,3,koko,2761,300,12,6,18,66.7%,2m
12939,3,[MRI]艾斯蒂尔,2761,216,8,6,14,57.1%,25m
12939,3,TheOF,2761,234,8,13,21,38.1%,7m
12939,3,[TAK]星际之刃,2761,147,5,0,5,100.0%,58m
12939,2,Cerberus,2761,92,5,1,6,83.3%,37m
12939,1,对这个世界,2761,137,5,6,11,45.5%,56m
12939,3,[查尔之矛]大狂风,2761,167,4,4,8,50.0%,12m
12939,3,谁再呼叫舰队,2761,94,2,0,2,100.0%,7m
12939,3,[Kasuga]Blacker,2761,0,0,1,1,0.0%,56m
12939,3,[TJMU]我是犀利新兵,2761,0,0,1,1,0.0%,7m
12939,2,[白雪的魔女]小恋皇,2761,0,0,1,1,0.0%,1h
12956,3,[小仙女已上线]毒爆,2760,464,146,124,270,54.1%,18m
12956,2,狂热者,2760,923,81,66,147,55.1%,28m
12956,3,影刺灬西瓜,2760,1480,66,59,125,52.8%,13m
12956,3,银河护卫队,2760,454,26,18,44,59.1%,31m
12956,2,帅到被人骂,2760,338,14,21,35,40.0%,2m
12956,3,[白云城主]ZARD,2760,184,7,1,8,87.5%,23m
12956,2,[CPT]电脑,2760,0,3,3,6,50.0%,59m
12956,3,[凯露天下第一]高性能亚托莉,2760,76,2,7,9,22.2%,1h
12956,3,[黑鲨]东京王者,2760,0,1,0,1,100.0%,3m
12956,1,Hanlei,2760,96,1,3,4,25.0%,1h
12956,3,[神虫一家亲]孙一喵是我老婆,2760,0,0,1,1,0.0%,8m
12956,2,白给,2760,0,0,1,1,0.0%,1h
12968,3,Tesla,2759,722,140,150,290,48.3%,5m
12968,3,[太微玉清宫]北凉核武徐堰兵,2759,197,6,4,10,60.0%,16m
12968,3,WOWz,2759,0,4,1,5,80.0%,1h
12968,1,JInzhiyu,2759,145,4,3,7,57.1%,1h
12968,3,SuperJoven,2759,162,4,4,8,50.0%,16m
12968,2,碧曼丶,2759,131,4,4,8,50.0%,1h
12968,2,青衣月华舞,2759,128,3,9,12,25.0%,27m
12968,1,四地尅,2759,44,2,0,2,100.0%,32m
12968,3,[命中注定]瞧石娜蠢货德跑尔,2759,93,2,1,3,66.7%,25m
12968,2,[HaNaDa]IIIIIII,2759,88,2,1,3,66.7%,1h
12968,2,[请君醉沙场]一枕华胥,2759,0,1,0,1,100.0%,52m
12968,3,飘逸梦幻,2759,30,1,3,4,25.0%,13m
12968,3,IIIIII,2759,0,1,4,5,20.0%,31m
12968,1,[赢一盘就睡]dustin,2759,0,0,1,1,0.0%,1h
12968,3,[艾尔之名]茶茶丸,2759,0,0,2,2,0.0%,27m
12983,2,里擦的森,2758,1395,179,161,340,52.6%,24m
12983,2,丘山日辰,2758,1149,41,49,90,45.6%,17m
12983,1,囡囡,2758,941,38,29,67,56.7%,1h
12983,2,Harry,2758,826,33,30,63,52.4%,2m
12983,3,劲爆的锤子,2758,475,24,21,45,53.3%,15m
12983,3,双笙,2758,361,16,17,33,48.5%,16m
12983,1,哈麻批,2758,165,6,6,12,50.0%,2m
12983,3,先打我队友,2758,185,5,3,8,62.5%,1h
12983,2,坐看竹林峰,2758,139,4,2,6,66.7%,44m
12983,1,JustinBieber,2758,0,1,0,1,100.0%,13m
12993,3,Anne,2757,1310,73,59,132,55.3%,31m
12993,3,[星辰之海]巴御前超可爱,2757,1160,49,42,91,53.8%,30m
12993,3,龟壳黄旭东,2757,1267,47,46,93,50.5%,12m
12993,3,琴魔,2757,1007,42,34,76,55.3%,30m
12993,3,LOVErainRAin,2757,226,8,9,17,47.1%,7m
12993,1,爱吃小红帽,2757,258,7,6,13,53.8%,48m
12993,3,星际争爸,2757,124,6,5,11,54.5%,3m
12993,2,土豪张,2757,156,6,8,14,42.9%,2m
12993,3,挽风无痕,2757,121,3,4,7,42.9%,33m
12993,3,[BGD]教皇丶,2757,0,0,5,5,0.0%,3m
13003,2,[CPT]啦啦啦拉拉阿拉,2756,1457,244,232,476,51.3%,3m
13003,3,云灵苍,2756,1562,119,107,226,52.7%,3m
13003,2,BORK,2756,908,53,55,108,49.1%,22m
13003,2,wwkkk,2756,1140,47,44,91,51.6%,27m
13003,3,[大JJ]CAROL,2756,1083,43,37,80,53.8%,18m
13003,3,wind,2756,495,40,39,79,50.6%,59m
13003,3,丨灰鸽丨,2756,417,17,16,33,51.5%,4m
13003,3,清醒独到,2756,395,15,11,26,57.7%,6m
13003,1,[GTK丶]骑摩托的少年,2756,326,14,20,34,41.2%,24m
13003,3,INnoSerral,2756,243,11,5,16,68.8%,58m
13003,2,为了部落,2756,115,5,3,8,62.5%,1h
13003,2,帅哥,2756,140,5,4,9,55.6%,1h
13003,1,旭东黄,2756,168,4,1,5,80.0%,19m
13003,3,大白梨,2756,60,3,3,6,50.0%,23m
13003,3,逆袭,2756,110,2,2,4,50.0%,31m
13003,1,[暴雪养鸡场]土匪,2756,30,1,1,2,50.0%,60m
13003,1,梦缘殇,2756,46,1,2,3,33.3%,14m
13003,3,[清华野大学]吴一凡,2756,0,0,1,1,0.0%,1h
13003,3,[TeamGB]loveDd,2756,0,0,5,5,0.0%,1h
13022,3,喜欢打一波,2755,393,68,48,116,58.6%,28m
13022,3,FallenAngels,2755,222,9,10,19,47.4%,3m
13022,1,邓林,2755,294,8,5,13,61.5%,53m
13022,3,[大坏蛋海贼团]魅影,2755,180,6,2,8,75.0%,3m
13022,3,[璇玑]长歌丷,2755,185,6,4,10,60.0%,16m
13022,3,verybabu,2755,0,5,0,5,100.0%,59m
13022,3,[鸠UP]JoASHER,2755,0,2,1,3,66.7%,1h
13022,3,ted,2755,30,2,8,10,20.0%,23m
13022,2,[大刀队]故事里的安徒生,2755,0,1,0,1,100.0%,1h
13022,3,[暴雪十队]江流儿,2755,0,1,0,1,100.0%,45m
13022,2,[烽夜长歌]帝国元首,2755,44,1,1,2,50.0%,48m
13022,3,龙翼,2755,82,1,2,3,33.3%,7m
13022,3,[废料集中站]Takeasa,2755,0,0,1,1,0.0%,49m
13022,3,unknown,2755,0,0,1,1,0.0%,1h
13022,3,scv,2755,0,0,2,2,0.0%,58m
13037,3,何星伦,2754,1144,91,77,168,54.2%,14m
13037,2,雾鬓云鬟,2754,344,14,15,29,48.3%,18m
13037,3,alpacacrab,2754,204,7,7,14,50.0%,45m
13037,3,[一般赢不了]克劳泽,2754,122,5,9,14,35.7%,59m
13037,3,墨染丶李半仙,2754,0,4,1,5,80.0%,1h
13037,3,酷酷的柚子哥,2754,0,2,3,5,40.0%,1h
13037,2,[依米]槿年,2754,94,2,5,7,28.6%,44m
13037,3,Sven,2754,0,1,0,1,100.0%,50m
13037,1,[Stein]凤凰院凶真,2754,40,1,1,2,50.0%,1h
13037,1,[秋毫]快乐肥宅,2754,0,0,1,1,0.0%,1h
13037,3,仙人抚我顶,2754,0,0,2,2,0.0%,3m
13037,3,[小金XXXX]EnTaroTassda,2754,0,0,3,3,0.0%,7m
13049,2,Bereavement,2753,1513,103,99,202,51.0%,13m
13049,1,上官灬冷风,2753,928,40,50,90,44.4%,8m
13049,3,yonghen,2753,239,9,5,14,64.3%,9m
13049,3,[你的剑很美]折翼放逐,2753,130,4,3,7,57.1%,27m
13049,1,[乱杀]你的探机被屠啦,2753,0,1,0,1,100.0%,25m
13049,1,[龙姐姐真棒]空投小王子,2753,0,1,0,1,100.0%,16m
13049,3,[Riders]Terrorblade,2753,0,1,1,2,50.0%,28m
13049,1,[瘾大眼瞎]XST,2753,95,1,2,3,33.3%,2m
13049,3,[粑粑雄吃粑粑]realbird,2753,46,1,5,6,16.7%,1h
13058,1,爱丽丝狗王,2752,847,46,35,81,56.8%,25m
13058,2,[UNNC]Iwahova,2752,826,44,38,82,53.7%,17m
13058,3,慕容覆血,2752,1030,43,32,75,57.3%,5m
13058,1,死亡天幕,2752,637,26,18,44,59.1%,1h
13058,1,[第九駆逐鑑隊]千尘化妆颜,2752,426,14,8,22,63.6%,19m
13058,3,空投挖掘机,2752,283,11,10,21,52.4%,1h
13058,3,奥特曼,2752,269,10,7,17,58.8%,23m
13058,3,提尔比茨,2752,188,5,6,11,45.5%,7m
13058,3,Staseist,2752,133,4,2,6,66.7%,14m
13058,2,赤城,2752,135,4,5,9,44.4%,1h
13058,3,sans,2752,38,3,3,6,50.0%,1h
13058,2,lingming,2752,46,2,2,4,50.0%,44m
13058,2,踏血狂魔,2752,0,2,4,6,33.3%,1h
13058,2,智能电脑,2752,0,1,5,6,16.7%,1h
13058,1,[loOoOL]你贱得太过耀眼了,2752,0,0,1,1,0.0%,25m
13058,3,老工人去哪了,2752,0,0,1,1,0.0%,9m
13058,1,浅岚色,2752,0,0,1,1,0.0%,1h
13075,3,高力言,2751,647,91,87,178,51.1%,19m
13075,3,大舰巨炮,2751,758,54,56,110,49.1%,59m
13075,2,[EnTorn]非正常人类研究所,2751,718,48,43,91,52.7%,55m
13075,2,小超哥,2751,594,24,23,47,51.1%,27m
13075,1,条码人,2751,600,23,34,57,40.4%,19m
13075,3,神恩造物,2751,291,20,8,28,71.4%,8m
13075,1,木毛野獸神楽夸,2751,514,18,9,27,66.7%,1h
13075,1,忧忧的小芹菜丶,2751,518,18,15,33,54.5%,43m
13075,3,[迷宫丨极限组]llllllllllll,2751,224,8,9,17,47.1%,1h
13075,3,AGHWEIWEI,2751,123,6,6,12,50.0%,58m
13075,2,[NotDog]Anitra,2751,44,4,4,8,50.0%,1h
13075,2,[萌新小菜鸡]momo,2751,95,2,1,3,66.7%,1h
13087,2,[艾尔之主]树叶,2750,1228,95,102,197,48.2%,37m
13087,2,[高富帅]小牛牛,2750,765,34,35,69,49.3%,24m
13087,3,狗毒爆都是儿子,2750,582,31,34,65,47.7%,7m
13087,3,星际带学家,2750,345,25,26,51,49.0%,58m
13087,3,[星舰与太阳x]小橘,2750,380,14,16,30,46.7%,9m
13087,3,[软萌甜小萝莉]RedLotus,2750,294,11,13,24,45.8%,14m
13087,1,[艾尔我唆了蒜]二良狗影,2750,326,9,5,14,64.3%,13m
13087,1,神奇的胖丁,2750,228,7,3,10,70.0%,14m
13087,3,Cain,2750,166,5,5,10,50.0%,1h
13087,3,STman,2750,118,5,7,12,41.7%,31m
13087,3,eternal,2750,131,4,2,6,66.7%,29m
13087,3,咕咕鸡,2750,0,3,2,5,60.0%,1h
13087,1,[恋战皇朝]萌新三号,2750,0,3,4,7,42.9%,1h
13087,3,baba,2750,0,2,3,5,40.0%,56m
13087,2,陈十一,2750,82,2,9,11,18.2%,1h
13087,1,冒小驴,2750,105,1,2,3,33.3%,37m
13087,1,loktar,2750,0,1,4,5,20.0%,1h
13087,3,[以君之名]罩不住的小帅气,2750,0,0,1,1,0.0%,1h
13105,1,[HALO光晕]Payne,2749,852,35,20,55,63.6%,1h
13105,2,StarryBaru,2749,140,25,24,49,51.0%,30m
13105,1,Noodles,2749,551,22,16,38,57.9%,53m
13105,1,magicptz,2749,325,12,13,25,48.0%,26m
13105,3,[斯巴达血战团]白衣沽酒醉少年,2749,175,10,9,19,52.6%,28m
13105,3,正在重连至游戏,2749,212,8,9,17,47.1%,9m
13105,2,人族英霸,2749,186,7,13,20,35.0%,13m
13105,2,小菜鸟,2749,134,6,6,12,50.0%,1h
13105,1,老混子,2749,192,5,4,9,55.6%,1h
13105,1,废羊羊,2749,94,3,20,23,13.0%,11m
13105,1,[LGMG]Edianx,2749,76,2,1,3,66.7%,56m
13105,3,Hannya,2749,0,2,5,7,28.6%,30m
13105,1,小八,2749,0,1,0,1,100.0%,1h
13105,3,[生物即是正义]依卡萝娜,2749,0,0,1,1,0.0%,1h
13105,1,无极,2749,0,0,1,1,0.0%,13m
13105,2,ddddd,2749,0,0,2,2,0.0%,6m
13121,1,[SC2战队]HAPPY,2748,774,70,82,152,46.1%,25m
13121,2,LemonBlum,2748,884,49,53,102,48.0%,2m
13121,3,[火焰雷兽]JiNoVaTion,2748,738,29,31,60,48.3%,3m
13121,3,致命之伤,2748,341,25,24,49,51.0%,27m
13121,3,[小鸡屠宰场3]大嫖,2748,572,23,17,40,57.5%,12m
13121,2,[菜鸡悲]zzxnbaaa,2748,600,22,24,46,47.8%,19m
13121,3,轩辕梦秋,2748,552,21,20,41,51.2%,9m
13121,1,[撑过一小时]SCboy,2748,562,19,16,35,54.3%,48m
13121,2,[XDUSC2]IIIIIIIIIIII,2748,524,18,29,47,38.3%,29m
13121,1,混元星际门阿御,2748,184,7,8,15,46.7%,4m
13121,1,Coral,2748,0,4,4,8,50.0%,11m
13121,1,简单电脑丶,2748,114,3,0,3,100.0%,1h
13121,3,古德里安,2748,62,2,4,6,33.3%,8m
13121,3,[为星光而战]KING,2748,62,2,6,8,25.0%,7m
13121,1,[湖北郧阳中学]方方的无齿蚌,2748,0,1,0,1,100.0%,48m
13121,2,血幽,2748,0,1,0,1,100.0%,1h
13121,1,[萌新总队]萌新一枚,2748,0,1,0,1,100.0%,1h
13121,2,[初音Miku]遇见未能拥有,2748,90,1,3,4,25.0%,27m
13121,2,DKGT,2748,0,1,5,6,16.7%,17m
13121,1,魔白,2748,0,0,1,1,0.0%,23m
13141,2,xiaochen,2747,1544,102,97,199,51.3%,14m
13141,3,痴呆,2747,1088,46,38,84,54.8%,13m
13141,3,Doctor,2747,802,33,29,62,53.2%,28m
13141,2,[Sc养老]erlengdie,2747,501,23,23,46,50.0%,17m
13141,3,CALLMENOOB,2747,471,19,15,34,55.9%,6m
13141,3,沉默的艾泽拉,2747,300,12,8,20,60.0%,3m
13141,1,hassan,2747,217,8,6,14,57.1%,1h
13141,2,简单电脑,2747,120,6,9,15,40.0%,31m
13141,1,安静的美男子,2747,180,5,6,11,45.5%,1h
13141,1,艺电易玩,2747,116,4,4,8,50.0%,1h
13141,1,Theobold,2747,205,4,4,8,50.0%,1h
13141,3,GreatPUMA,2747,0,2,3,5,40.0%,43m
13141,3,gujinjin,2747,0,2,3,5,40.0%,1h
13141,1,电脑,2747,0,0,2,2,0.0%,29m
13141,3,llllllllllll,2747,0,0,2,2,0.0%,4m
13156,3,风折残灵,2746,1448,96,77,173,55.5%,4m
13156,3,ciel,2746,1249,76,67,143,53.1%,12m
13156,3,HomeSandMan,2746,1295,65,65,130,50.0%,3m
13156,3,天一生水,2746,976,38,39,77,49.4%,15m
13156,3,二师兄,2746,739,30,25,55,54.5%,30m
13156,3,虚无,2746,765,27,25,52,51.9%,7m
13156,3,[仁者]虚空王者,2746,464,19,18,37,51.4%,23m
13156,3,ZZZ,2746,332,12,11,23,52.2%,5m
13156,3,大脚盆,2746,286,9,9,18,50.0%,17m
13156,3,[PNC]Flauros,2746,214,8,11,19,42.1%,19m
13156,2,[咖啡Fans]有花堪折直须折,2746,135,6,2,8,75.0%,1h
13156,1,灬鸣鸿,2746,142,5,6,11,45.5%,46m
13156,1,一位野生的提督君,2746,64,2,1,3,66.7%,1h
13156,1,众人的爸爸,2746,0,1,0,1,100.0%,1h
13156,3,Mantle,2746,0,1,0,1,100.0%,45m
13156,1,[XXHZ16]宅金靈,2746,0,0,1,1,0.0%,56m
13156,1,[天门]plainuu,2746,0,0,1,1,0.0%,9m
13156,1,龙魂,2746,0,0,1,1,0.0%,54m
13174,3,德川家康,2745,887,39,33,72,54.2%,13m
13174,2,太极丨八卦丨搬拦,2745,531,35,31,66,53.0%,22m
13174,2,XYBB,2745,695,32,28,60,53.3%,2m
13174,3,zhanhuoys,2745,653,29,21,50,58.0%,31m
13174,3,[最菜战队]时光,2745,233,15,14,29,51.7%,8m
13174,1,咲夜布兰多,2745,406,15,19,34,44.1%,33m
13174,2,[GAGA]鸡中之霸,2745,246,9,13,22,40.9%,26m
13174,1,萌新不敢一对一,2745,212,7,5,12,58.3%,1h
13174,3,[幼稚园电竞班]TuDouMing,2745,166,5,1,6,83.3%,6m
13174,2,丨余生丿小啊然丨,2745,133,3,0,3,100.0%,1h
13174,1,WZIM,2745,46,2,1,3,66.7%,16m
13174,3,长泽雅美,2745,60,2,5,7,28.6%,3m
13174,2,[歌者II]luoyi,2745,0,1,0,1,100.0%,37m
13174,1,prettygay,2745,0,1,0,1,100.0%,19m
13174,2,Siyang,2745,0,1,0,1,100.0%,49m
13174,2,[KORSC2]CvMAX,2745,88,1,8,9,11.1%,24m
13174,2,没好话,2745,0,0,1,1,0.0%,18m
13174,1,不朽爹,2745,0,0,1,1,0.0%,26m
13174,2,[大主教后援团]欧尼酱,2745,0,0,1,1,0.0%,1h
13174,3,同一个服,2745,0,0,1,1,0.0%,14m
13174,3,GaoYH,2745,0,0,2,2,0.0%,7m
13174,3,暴雪滴神,2745,0,0,2,2,0.0%,31m
13196,3,上分真难,2744,1098,96,87,183,52.5%,16m
13196,3,普罗米修斯,2744,1488,55,58,113,48.7%,58m
13196,2,XIAOXAIO,2744,402,43,45,88,48.9%,17m
13196,3,决战之长河落日,2744,662,24,21,45,53.3%,15m
13196,3,打的太菜,2744,524,22,14,36,61.1%,7m
13196,2,最后的武士,2744,270,12,14,26,46.2%,17m
13196,2,[沙雕九王之]锦依卫,2744,289,11,14,25,44.0%,10m
13196,2,在隔壁房间,2744,297,10,13,23,43.5%,2m
13196,3,大角,2744,274,9,10,19,47.4%,30m
13196,1,余生,2744,42,5,8,13,38.5%,19m
13196,1,风小危,2744,74,3,0,3,100.0%,53m
13196,1,嘿嘿嘿,2744,0,3,4,7,42.9%,1h
13196,1,年轻人,2744,0,3,4,7,42.9%,30m
13196,1,[小鸡屠宰场3]幻瞬,2744,48,2,1,3,66.7%,1h
13196,1,[嚣张萌新]Revolution,2744,0,2,3,5,40.0%,48m
13196,3,Archer,2744,0,2,3,5,40.0%,2m
13196,3,莫语,2744,60,2,4,6,33.3%,27m
13196,2,ParkChoA,2744,95,1,7,8,12.5%,1h
13214,3,先生夺仁,2743,817,100,82,182,54.9%,19m
13214,3,tiges,2743,189,59,60,119,49.6%,16m
13214,3,baofushehui,2743,224,8,10,18,44.4%,3m
13214,3,[DMRz]雷布朗多星人,2743,212,7,9,16,43.8%,23m
13214,2,老菜狗,2743,111,5,2,7,71.4%,10m
13214,1,[XXHZN1]就是无脑干,2743,0,4,1,5,80.0%,48m
13214,2,HappyLee,2743,0,4,2,6,66.7%,13m
13214,3,vbnmlfkgjhdg,2743,86,4,6,10,40.0%,58m
13214,2,雪落红叶,2743,95,3,4,7,42.9%,39m
13214,3,床上反杀哥哥,2743,97,3,5,8,37.5%,5m
13214,2,ziluojs,2743,94,2,0,2,100.0%,44m
13214,1,寂寞没人陪,2743,109,2,4,6,33.3%,1h
13214,1,[仁义礼智信]一洋葱一,2743,0,1,0,1,100.0%,27m
13214,1,最后的赢家,2743,0,1,0,1,100.0%,1h
13214,1,毒奶必须死,2743,0,1,0,1,100.0%,24m
13214,1,[等打完仗娶你]卡尔达利斯,2743,42,1,1,2,50.0%,35m
13214,3,坤坤,2743,0,1,4,5,20.0%,1h
13214,1,DarkKnight,2743,0,0,1,1,0.0%,48m
13214,1,[点到为止]我们是害虫,2743,0,0,1,1,0.0%,49m
13214,1,资源与舰队皆失,2743,0,0,1,1,0.0%,1h
13234,1,冥王,2742,1723,166,162,328,50.6%,1h
13234,2,SONGWEI,2742,1399,130,115,245,53.1%,6m
13234,3,WhiteLex,2742,583,94,90,184,51.1%,16m
13234,3,虫猛人秀神挨揍,2742,239,11,10,21,52.4%,28m
13234,2,叫你还调皮,2742,288,10,8,18,55.6%,7m
13234,1,[暴雪三十二隊]郑希靖,2742,142,8,6,14,57.1%,1h
13234,1,朱笔利酷,2742,184,6,2,8,75.0%,1h
13234,1,[嘤嘤嘤呜呜]時崎,2742,154,5,2,7,71.4%,53m
13234,1,[不纯洁了]亚麻的春天,2742,106,5,6,11,45.5%,13m
13234,3,[VKR]唯心难却,2742,118,4,9,13,30.8%,15m
13234,3,笑太甜,2742,0,3,2,5,60.0%,2m
13234,1,IarmMan,2742,38,2,0,2,100.0%,1h
13234,1,[只会666]nobble,2742,30,2,0,2,100.0%,18m
13234,1,[屁屁硬]IIIIIIIIIIII,2742,68,2,1,3,66.7%,2m
13234,1,knightkami,2742,0,1,0,1,100.0%,19m
13234,1,kirito,2742,97,1,3,4,25.0%,1h
13234,1,来自天堂的魔鬼,2742,0,0,1,1,0.0%,1h
13251,3,西京小肥佬,2741,438,93,82,175,53.1%,57m
13251,1,我很菜轻点打,2741,790,78,69,147,53.1%,58m
13251,3,浅拂霜,2741,931,45,28,73,61.6%,23m
13251,3,small,2741,891,42,43,85,49.4%,7m
13251,2,lllilllillil,2741,1002,41,35,76,53.9%,11m
13251,1,白衣,2741,555,19,13,32,59.4%,14m
13251,1,[女帝1号]全球包邮,2741,626,19,19,38,50.0%,1h
13251,3,[NEP涅普]苦色殇声,2741,390,16,11,27,59.3%,4m
13251,3,[老犟狐]神雷,2741,448,16,12,28,57.1%,16m
13251,2,[loveMM]河北狗王,2741,374,13,18,31,41.9%,14m
13251,3,[繁花落尽]西行寺幽幽子,2741,188,6,6,12,50.0%,19m
13251,3,RookieWAng,2741,197,6,9,15,40.0%,1h
13251,2,TASIA,2741,0,3,3,6,50.0%,1h
13251,2,茗锦,2741,0,3,4,7,42.9%,1h
13251,1,Davidhan,2741,40,2,0,2,100.0%,56m
13251,2,[无双]YcDan,2741,117,2,3,5,40.0%,1h
13251,3,xchuo,2741,0,2,3,5,40.0%,1h
13251,1,[神奇的海螺]Dearsuger,2741,0,1,0,1,100.0%,32m
13251,1,[荣耀丶殿堂]心空之一,2741,40,1,1,2,50.0%,2m
13251,3,百夜千城,2741,0,1,2,3,33.3%,27m
13251,1,不送兵不舒服斯基,2741,0,0,1,1,0.0%,60m
13251,3,很胖的人,2741,0,0,2,2,0.0%,25m
13273,3,鲲鹏,2740,1018,59,59,118,50.0%,28m
13273,1,[TG战队]月下清酒,2740,1043,36,37,73,49.3%,9m
13273,3,TriStone,2740,532,22,24,46,47.8%,9m
13273,3,[荒芜岁月]迷失的小孩,2740,379,16,8,24,66.7%,28m
13273,1,chage,2740,373,14,5,19,73.7%,1h
13273,3,请打别人吧,2740,196,7,6,13,53.8%,30m
13273,1,苍崎橙子,2740,241,6,7,13,46.2%,1h
13273,1,[钢铁谐星]IIIIlllll,2740,152,5,5,10,50.0%,26m
13273,2,[破丶晓]灵影之风,2740,175,5,7,12,41.7%,57m
13273,1,头顶三寸呆毛,2740,110,4,1,5,80.0%,48m
13273,2,[白銀之手]抱腻需驱,2740,137,4,5,9,44.4%,1h
13273,1,只玩星核一打一,2740,48,4,5,9,44.4%,1h
13273,3,[MOMIMO]紫妈你别这样,2740,32,2,3,5,40.0%,1h
13273,1,胡吹一百年,2740,0,1,0,1,100.0%,14m
13273,1,tyrant,2740,0,0,1,1,0.0%,23m
13273,1,白菜菜,2740,0,0,5,5,0.0%,27m
13289,1,悟空,2739,923,135,147,282,47.9%,8m
13289,3,丘丘人,2739,1309,48,54,102,47.1%,30m
13289,2,星际,2739,610,24,26,50,48.0%,8m
13289,3,andy,2739,449,20,13,33,60.6%,3m
13289,3,确认退出,2739,478,18,15,33,54.5%,4m
13289,3,[情深天涯]火麒麟,2739,536,18,18,36,50.0%,27m
13289,2,无极,2739,442,17,18,35,48.6%,14m
13289,3,[星际仓鼠海盗]飨嚮響曏鄕,2739,356,14,15,29,48.3%,7m
13289,3,vampire,2739,324,13,14,27,48.1%,6m
13289,2,无情的菜鸡,2739,241,11,12,23,47.8%,1h
13289,1,哈哈哈哈哈哈哈,2739,389,10,8,18,55.6%,3m
13289,3,[251]十四不惑,2739,242,10,10,20,50.0%,1h
13289,1,[夜羊社]月社妃,2739,182,4,6,10,40.0%,1h
13289,2,[charol]zhou,2739,136,3,1,4,75.0%,1h
13289,3,断章,2739,30,2,2,4,50.0%,10m
13289,3,Vvvvv,2739,0,2,3,5,40.0%,47m
13289,1,hang,2739,0,1,1,2,50.0%,1h
13289,1,[大赦天下]Wisdom,2739,0,0,2,2,0.0%,1h
13289,3,Jim,2739,0,0,2,2,0.0%,59m
13308,2,宛若一个制杖,2738,1544,454,437,891,51.0%,3m
13308,2,流光,2738,1530,142,134,276,51.4%,3m
13308,1,[X7]卷毛哈士奇,2738,362,13,13,26,50.0%,49m
13308,3,莱茵哈特的光辉,2738,306,12,8,20,60.0%,3m
13308,2,[核平的红魔馆]蕾米莉亚斯卡雷特,2738,310,11,17,28,39.3%,57m
13308,3,祖安人皇,2738,153,9,7,16,56.2%,30m
13308,3,[老油条战队4]热血主任,2738,279,9,11,20,45.0%,4m
13308,1,腓特烈大帝,2738,276,8,8,16,50.0%,1h
13308,1,雨夜怪客,2738,231,6,2,8,75.0%,33m
13308,2,小萌新,2738,203,6,6,12,50.0%,44m
13308,1,[皇室联盟]雨疏江影,2738,120,5,5,10,50.0%,19m
13308,3,Prince,2738,137,4,1,5,80.0%,53m
13308,1,[永恒中华]AAA,2738,160,4,4,8,50.0%,28m
13308,1,Chen,2738,68,3,1,4,75.0%,1h
13308,2,[龙帝星云]巴巴罗萨,2738,136,3,2,5,60.0%,1h
13308,1,不吃猪的香菜,2738,117,3,3,6,50.0%,1h
13308,2,希尔瓦纳斯,2738,88,3,4,7,42.9%,1h
13308,3,[圣战之光]yang,2738,0,2,3,5,40.0%,1h
13308,3,reachinglove,2738,0,2,3,5,40.0%,1h
13308,1,kirito,2738,0,0,1,1,0.0%,1h
13308,3,嚟暝,2738,0,0,1,1,0.0%,43m
13308,2,牧濑红莉栖,2738,0,0,2,2,0.0%,27m
13308,3,网老腻,2738,0,0,2,2,0.0%,1h
13331,3,二五仔,2737,563,32,20,52,61.5%,5m
13331,2,Amalaveda,2737,121,29,34,63,46.0%,24m
13331,3,CoffeePro,2737,222,10,2,12,83.3%,1h
13331,2,Forever,2737,202,6,1,7,85.7%,1h
13331,1,[文韬武略]小满冬至霜降惊蛰,2737,258,6,4,10,60.0%,2m
13331,1,灬糖小悠,2737,138,5,6,11,45.5%,1h
13331,3,[l死亡议会l]塔达林逼格第一人,2737,114,5,7,12,41.7%,12m
13331,3,陈大仙,2737,68,4,4,8,50.0%,4m
13331,1,jimmy,2737,0,3,2,5,60.0%,48m
13331,1,NEJFD,2737,88,2,0,2,100.0%,43m
13331,1,[焖敦儿杀手]小付请你吃屁,2737,97,2,2,4,50.0%,1h
13331,3,Sheng,2737,0,2,3,5,40.0%,1h
13331,1,[换home]萨恶,2737,0,1,0,1,100.0%,37m
13331,3,副长丶,2737,0,1,3,4,25.0%,7m
13331,3,[华之二水战]天津風,2737,0,1,3,4,25.0%,10m
13331,2,狼牙兽表示不服,2737,0,0,1,1,0.0%,1h
13331,1,ivo,2737,0,0,1,1,0.0%,48m
13331,1,SwordP,2737,0,0,1,1,0.0%,48m
13331,2,白门楼施工队,2737,0,0,2,2,0.0%,1h
13331,2,不知道,2737,0,0,3,3,0.0%,48m
13351,3,兄弟们给我上,2736,1296,119,109,228,52.2%,31m
13351,3,一起去坑爹,2736,1251,51,50,101,50.5%,15m
13351,1,[暴雪五队]Dawn,2736,402,26,11,37,70.3%,1h
13351,3,将粪坑进行到底,2736,417,18,12,30,60.0%,5m
13351,3,[我们是无敌的]兽人永不为奴,2736,297,13,7,20,65.0%,23m
13351,1,[丨SLT丨]小鬼,2736,305,12,26,38,31.6%,33m
13351,3,你是真皮沙发,2736,219,11,16,27,40.7%,59m
13351,3,正在初始化,2736,223,7,9,16,43.8%,39m
13351,1,[草滩帝国大学]陈晖洁天下第一,2736,208,6,4,10,60.0%,1h
13351,1,[Feroci]雨暮苍山,2736,104,4,0,4,100.0%,2m
13351,3,[蓝鲸何平]好玩好玩好玩好玩,2736,140,4,3,7,57.1%,4m
13351,3,等天黑,2736,173,4,3,7,57.1%,9m
13351,3,阿卡林,2736,0,3,2,5,60.0%,18m
13351,1,雷霆风暴,2736,142,2,4,6,33.3%,1h
13351,2,冀夜,2736,30,2,8,10,20.0%,12m
13351,1,九阴争茎,2736,0,1,0,1,100.0%,1h
13351,1,干不死空气,2736,48,1,3,4,25.0%,1h
13351,3,Nanking,2736,30,1,5,6,16.7%,14m
13351,3,黑伽,2736,0,0,5,5,0.0%,40m
13370,3,[NVKR]十二年秋,2735,1532,135,128,263,51.3%,13m
13370,2,Chrono,2735,1027,50,53,103,48.5%,26m
13370,3,[菜有菜的道理]IIIIIIIIIIII,2735,836,46,36,82,56.1%,15m
13370,3,[萌的一笔]萌萌哒的小糕菌,2735,481,23,9,32,71.9%,15m
13370,1,沉誓,2735,438,16,10,26,61.5%,35m
13370,1,[天晴]FBW,2735,368,12,8,20,60.0%,1h
13370,3,[萨尔那加议会]RKD,2735,334,12,10,22,54.5%,2m
13370,1,[29CM]白嫖到底,2735,320,10,12,22,45.5%,49m
13370,2,煤炭里的黑猫,2735,184,7,9,16,43.8%,1h
13370,1,zhanggrrrr,2735,142,5,3,8,62.5%,26m
13370,3,绿贼,2735,188,5,6,11,45.5%,59m
13370,1,三缸,2735,48,3,7,10,30.0%,1h
13370,1,望月揽星辰,2735,74,2,2,4,50.0%,1h
13370,1,DrYang,2735,44,1,1,2,50.0%,35m
13370,1,Ghost,2735,0,0,1,1,0.0%,37m
13370,3,Alicia,2735,0,0,1,1,0.0%,1h
13386,3,[ACG系]TheGrist,2734,593,34,22,56,60.7%,58m
13386,1,[HFUOT]Sarrel,2734,871,34,29,63,54.0%,28m
13386,3,永远,2734,724,26,28,54,48.1%,8m
13386,1,UhUm,2734,452,19,16,35,54.3%,33m
13386,3,CleanProtoss,2734,362,13,15,28,46.4%,58m
13386,3,[暴雪养鸡场]毛衣,2734,267,10,6,16,62.5%,9m
13386,1,GQgenius,2734,131,7,6,13,53.8%,23m
13386,2,不讲武德,2734,110,7,10,17,41.2%,1h
13386,3,武侯,2734,139,5,2,7,71.4%,1h
13386,2,[衫斯的雪镇]言希,2734,118,5,3,8,62.5%,1h
13386,2,泰铁锤,2734,0,4,2,6,66.7%,27m
13386,3,拖了板儿,2734,110,3,1,4,75.0%,16m
13386,1,艾尔之子,2734,0,3,5,8,37.5%,1h
13386,1,[电风扇]咕噜灵波,2734,38,2,1,3,66.7%,1h
13386,1,chestnut,2734,0,1,0,1,100.0%,2m
13386,3,yhy,2734,40,1,1,2,50.0%,1h
13386,3,[CCHX]StarKillerW,2734,0,0,1,1,0.0%,1h
13403,2,渣男圣剑,2733,1518,91,91,182,50.0%,57m
13403,3,晨勃的大主教,2733,793,56,51,107,52.3%,16m
13403,3,[MOOOON]轩辕鱼,2733,443,33,27,60,55.0%,31m
13403,1,[猫跑去田间了]猫掉进井里了,2733,718,26,24,50,52.0%,33m
13403,3,[Nostop]Never,2733,678,25,27,52,48.1%,59m
13403,1,[HUC水军]Virgo,2733,529,21,19,40,52.5%,25m
13403,1,胡威威二叔,2733,214,7,5,12,58.3%,1h
13403,1,MLNB,2733,164,7,14,21,33.3%,55m
13403,2,Sammind,2733,165,5,5,10,50.0%,1h
13403,3,[sdsdsd]wodeshiojie,2733,120,5,6,11,45.5%,27m
13403,1,[miku守护]Dealer,2733,112,4,1,5,80.0%,9m
13403,1,[银翼之光]LETN,2733,158,3,3,6,50.0%,1h
13403,3,Bin,2733,97,3,3,6,50.0%,1h
13403,2,JianGLai,2733,132,2,1,3,66.7%,1h
13403,1,不是一个人,2733,66,2,3,5,40.0%,1h
13403,3,神一般的马子,2733,0,2,3,5,40.0%,48m
13403,2,TorresTao,2733,58,2,10,12,16.7%,24m
13403,1,YuShen,2733,0,1,0,1,100.0%,1h
13403,1,[XJCNJD]柚子,2733,38,1,1,2,50.0%,49m
13403,1,浮空掠影,2733,0,0,1,1,0.0%,1h
13403,2,[康复中心]樱溟,2733,0,0,3,3,0.0%,51m
13424,2,多哈,2732,1601,549,537,1086,50.6%,37m
13424,2,天工,2732,1527,181,176,357,50.7%,14m
13424,1,yamapi,2732,679,150,142,292,51.4%,4m
13424,2,QinGTian,2732,1006,91,86,177,51.4%,6m
13424,2,遗世紫丁香,2732,1049,62,54,116,53.4%,27m
13424,2,妃子笑,2732,415,17,17,34,50.0%,14m
13424,3,[机械混成旅]菌毯裹尸还,2732,321,11,11,22,50.0%,30m
13424,2,dwas,2732,314,11,12,23,47.8%,9m
13424,2,兽兽,2732,269,10,9,19,52.6%,1h
13424,3,宿伞无常,2732,249,9,12,21,42.9%,7m
13424,1,月夜灬无痕,2732,196,9,12,21,42.9%,1h
13424,2,消逝贤者圣契,2732,107,6,3,9,66.7%,1h
13424,3,魂魄妖梦,2732,58,5,5,10,50.0%,3m
13424,1,[完了卡人口了]那咋整啊,2732,140,5,7,12,41.7%,56m
13424,3,[萌友受到公鸡]醉意枫年,2732,0,4,1,5,80.0%,1h
13424,1,[卧龙凤雏]萌萌哒的鸡蛋饼,2732,74,3,0,3,100.0%,25m
13424,3,[TeamGB]RainDrop,2732,122,3,2,5,60.0%,1h
13424,3,[BLAME]雾亥,2732,142,3,5,8,37.5%,16m
13424,2,[AGC]华南施工,2732,90,3,8,11,27.3%,51m
13424,3,精壮男子,2732,0,2,3,5,40.0%,59m
13424,3,迪迦在我心中,2732,0,2,3,5,40.0%,1h
13424,3,时空霸者,2732,96,1,3,4,25.0%,27m
13424,1,TimeLoop,2732,0,0,1,1,0.0%,25m
13424,3,zhttty,2732,0,0,4,4,0.0%,13m
13448,3,[蓝星远征军]ABYSSANGEL,2731,1589,119,113,232,51.3%,26m
13448,3,西行寺焚岚,2731,519,68,63,131,51.9%,26m
13448,1,latoureffeil,2731,985,36,27,63,57.1%,17m
13448,3,言兮,2731,407,17,15,32,53.1%,17m
13448,1,nicep,2731,552,16,14,30,53.3%,2m
13448,1,Sky,2731,427,15,9,24,62.5%,2m
13448,3,[我们是害虫之]星落黎明,2731,180,9,9,18,50.0%,57m
13448,1,zeng,2731,252,8,7,15,53.3%,2m
13448,3,IIIIIIIIII,2731,176,7,9,16,43.8%,59m
13448,3,黑色小刀,2731,177,6,1,7,85.7%,39m
13448,1,轩镰,2731,195,6,3,9,66.7%,24m
13448,2,[水猫哥斯拉]没法打,2731,135,5,3,8,62.5%,5m
13448,2,巴西琉斯终成帕夏,2731,158,5,6,11,45.5%,1h
13448,1,REMY,2731,48,4,5,9,44.4%,1h
13448,3,[TwSG]鸦羽,2731,94,4,7,11,36.4%,59m
13448,2,Leonsourd,2731,139,3,1,4,75.0%,27m
13448,3,旺仔牛奶,2731,0,3,2,5,60.0%,1h
13448,3,干倒刘主任,2731,93,2,2,4,50.0%,26m
13448,3,IllIIIIlIIIl,2731,91,2,2,4,50.0%,2m
13448,3,吳心,2731,0,2,3,5,40.0%,7m
13448,3,sdd,2731,118,2,4,6,33.3%,5m
13448,1,[我没有女朋友]氵丶骚猪,2731,0,0,1,1,0.0%,26m
13448,1,雷利乌斯,2731,0,0,1,1,0.0%,14m
13448,1,爱慕皮五,2731,0,0,1,1,0.0%,33m
13448,1,SCboyLuyao,2731,0,0,1,1,0.0%,43m
13448,1,[老六突击队]下雪了,2731,0,0,1,1,0.0%,1h
13474,2,Jeffreyhan,2730,1630,67,69,136,49.3%,12m
13474,3,星辰,2730,555,24,20,44,54.5%,5m
13474,1,bluecat,2730,252,9,6,15,60.0%,1h
13474,1,磷光,2730,117,4,5,9,44.4%,12m
13474,3,[真实大帝哦]清雨,2730,121,4,11,15,26.7%,3m
13474,2,illidan,2730,0,3,3,6,50.0%,1h
13474,3,红的发黑,2730,62,3,4,7,42.9%,28m
13474,1,艾尔刁民,2730,147,3,5,8,37.5%,1h
13474,2,[大叔同盟]Ricardo,2730,40,2,1,3,66.7%,1h
13474,1,玄天,2730,76,2,3,5,40.0%,1h
13474,3,haha,2730,30,2,3,5,40.0%,7m
13474,3,[Hist]梦幻拉面,2730,118,2,4,6,33.3%,8m
13474,1,月亮月亮被啃弯,2730,127,2,5,7,28.6%,1h
13474,2,Nameless,2730,30,2,8,10,20.0%,30m
13474,1,Seven,2730,0,1,0,1,100.0%,43m
13474,1,adcadc,2730,0,0,2,2,0.0%,1h
13474,3,岳不群,2730,0,0,4,4,0.0%,54m
13491,3,[天津理工大学]城市星辰,2729,341,30,25,55,54.5%,59m
13491,1,杨师姐,2729,279,13,5,18,72.2%,22m
13491,3,优优,2729,271,12,8,20,60.0%,17m
13491,1,salad,2729,235,9,7,16,56.2%,9m
13491,2,无敌叶星星,2729,210,7,20,27,25.9%,2m
13491,3,信仰,2729,173,6,3,9,66.7%,2m
13491,3,她与疾风都是过客,2729,144,6,7,13,46.2%,31m
13491,2,[我菜请打队友]fiftygodv,2729,137,3,7,10,30.0%,15m
13491,1,SHUA,2729,34,2,1,3,66.7%,18m
13491,1,[仁者]大神澪,2729,40,1,1,2,50.0%,1h
13491,1,snow,2729,40,1,1,2,50.0%,1h
13491,1,[XXS]awsl,2729,40,1,1,2,50.0%,60m
13491,1,[最菜战队]赤瞳,2729,40,1,2,3,33.3%,37m
13491,1,[Deep]任重道远,2729,0,0,2,2,0.0%,53m
13505,1,[KPG2]Mauvais,2728,1070,76,59,135,56.3%,14m
13505,2,大脚盆,2728,451,20,22,42,47.6%,26m
13505,1,大腿,2728,484,19,18,37,51.4%,3m
13505,3,[萝莉之芯]没天赋的人族,2728,435,16,14,30,53.3%,3m
13505,1,花待葬,2728,347,13,3,16,81.2%,2m
13505,1,我想要女盆友,2728,302,11,8,19,57.9%,48m
13505,2,[薄暮之光]我爱一波流,2728,164,5,6,11,45.5%,5m
13505,2,我是萌新,2728,137,4,5,9,44.4%,44m
13505,3,OOOOOO,2728,121,3,3,6,50.0%,8m
13505,1,为了艾尔,2728,0,3,5,8,37.5%,8m
13505,2,[PL4y]BlackJack,2728,118,2,1,3,66.7%,1h
13505,1,[我们是无敌的]枣泥,2728,118,2,2,4,50.0%,48m
13505,3,[最强灬狼牙队]YHW,2728,126,2,5,7,28.6%,19m
13505,1,搞事专家,2728,0,0,1,1,0.0%,24m
13519,3,[北狼]guojian,2727,1065,124,131,255,48.6%,15m
13519,3,执魔,2727,1003,74,65,139,53.2%,30m
13519,1,[XCode]亦久亦,2727,1523,66,42,108,61.1%,9m
13519,2,可怜的人,2727,973,46,38,84,54.8%,22m
13519,1,韬略,2727,752,30,18,48,62.5%,60m
13519,3,[ACE绝望军]不成戒便成劫,2727,618,24,24,48,50.0%,23m
13519,1,谐星一号,2727,626,21,30,51,41.2%,24m
13519,3,撤硕老八,2727,435,19,17,36,52.8%,31m
13519,1,三是也,2727,466,14,9,23,60.9%,57m
13519,1,JINHON,2727,334,11,8,19,57.9%,19m
13519,1,土豆受害者,2727,144,5,2,7,71.4%,1h
13519,1,若夜,2727,200,5,2,7,71.4%,60m
13519,3,BLACKQQ,2727,148,4,4,8,50.0%,16m
13519,1,Uncleju,2727,72,3,2,5,60.0%,27m
13519,1,[龙眠山下的猫]zero,2727,94,3,5,8,37.5%,1h
13519,1,[非洲兄弟]睡猫,2727,42,2,0,2,100.0%,35m
13519,1,[寒绯樱]涮涮人,2727,36,2,0,2,100.0%,1h
13519,1,浪流连,2727,117,2,3,5,40.0%,19m
13519,1,QinGBai,2727,0,1,0,1,100.0%,37m
13519,1,[虫王巢]调戏丶剑姬,2727,0,1,2,3,33.3%,54m
13519,3,萧瑟的雪,2727,30,1,5,6,16.7%,28m
13540,1,烟头飞舞,2726,1291,52,35,87,59.8%,26m
13540,2,[运大星际系]明帝,2726,473,21,20,41,51.2%,8m
13540,2,那些很冒险的梦,2726,157,6,8,14,42.9%,1h
13540,3,ice,2726,145,4,1,5,80.0%,1h
13540,2,wanzxl,2726,46,3,4,7,42.9%,1h
13540,3,孙淦晨,2726,30,2,3,5,40.0%,19m
13540,3,keeep,2726,0,2,3,5,40.0%,1h
13540,3,[中国人民银行]东方白石,2726,40,1,1,2,50.0%,1h
13540,1,魔法石,2726,36,1,2,3,33.3%,9m
13540,3,[灰冥]赤瞳是我老婆,2726,30,1,4,5,20.0%,56m
13550,3,玩玩啊,2725,788,138,131,269,51.3%,8m
13550,3,我是的菜鸟,2725,1565,99,99,198,50.0%,3m
13550,3,猎户星座,2725,1253,86,88,174,49.4%,27m
13550,2,摸鱼小王子,2725,415,17,21,38,44.7%,13m
13550,1,king,2725,338,11,9,20,55.0%,1h
13550,1,玛德还有谁,2725,345,11,10,21,52.4%,33m
13550,2,[交附嘉分]immortal,2725,290,10,9,19,52.6%,31m
13550,3,wang,2725,0,4,1,5,80.0%,1h
13550,2,[涨停敢死队]extro,2725,110,4,5,9,44.4%,44m
13550,2,乱红,2725,88,3,2,5,60.0%,1h
13550,3,熄灭的香烟,2725,0,3,2,5,60.0%,24m
13550,2,[倥偬]LonelyBlack,2725,0,3,4,7,42.9%,39m
13550,1,Overmind,2725,74,2,1,3,66.7%,1h
13550,1,wyj,2725,38,2,2,4,50.0%,33m
13550,1,没有对象的屠戮机,2725,116,2,3,5,40.0%,2m
13550,1,[罗马帝国]李奥瑞克,2725,0,1,0,1,100.0%,25m
13550,1,IIIIIIII,2725,0,1,0,1,100.0%,48m
13567,1,[有毒]毒到了毒,2724,1230,154,161,315,48.9%,8m
13567,3,留住冬天,2724,546,71,63,134,53.0%,29m
13567,1,依旧第三,2724,1426,57,45,102,55.9%,26m
13567,2,虫母,2724,1292,44,56,100,44.0%,7m
13567,1,[B站星际小德]老面包啊,2724,203,7,8,15,46.7%,1h
13567,3,[信仰圣光指引]matt,2724,127,3,4,7,42.9%,1h
13567,3,[XXHZ28]liujv,2724,0,2,3,5,40.0%,33m
13567,3,殇月,2724,0,2,3,5,40.0%,56m
13567,1,[希望永不湮灭]hst,2724,0,1,0,1,100.0%,2m
13567,1,xiaofeng,2724,0,1,1,2,50.0%,26m
13567,2,[WLLWX]LLJ,2724,0,0,2,2,0.0%,1h
13567,3,白发三千丈,2724,0,0,3,3,0.0%,6m
13579,3,Semo,2723,1617,79,72,151,52.3%,30m
13579,3,eagle,2723,826,38,38,76,50.0%,30m
13579,1,小贩笑容,2723,930,35,40,75,46.7%,55m
13579,2,[社交学超可爱]星际最亮的仔,2723,641,26,26,52,50.0%,27m
13579,3,判官,2723,234,8,11,19,42.1%,10m
13579,2,[CPT]永远滴虫,2723,155,4,2,6,66.7%,39m
13579,1,[爱国]天使洛克,2723,150,4,4,8,50.0%,1h
13579,3,众神归来,2723,110,3,2,5,60.0%,58m
13579,1,[赋者]Artanis,2723,106,3,3,6,50.0%,1h
13579,1,你亲爱的老北鼻,2723,96,2,2,4,50.0%,1h
13579,3,黎恩舒华泽,2723,0,2,3,5,40.0%,1h
13579,1,流光倾泻的庭园,2723,0,1,0,1,100.0%,1h
13579,1,红雨,2723,0,1,0,1,100.0%,1h
13579,3,诺娃我觉得我可以,2723,30,1,4,5,20.0%,8m
13579,1,[萌新终结者]妮可妮非常妮,2723,0,0,1,1,0.0%,48m
13579,1,[颜面骑乘]她的父亲,2723,0,0,1,1,0.0%,1h
13579,3,hurricane,2723,0,0,1,1,0.0%,47m
13579,2,[我高贵的族人]人在飞机在,2723,0,0,2,2,0.0%,27m
13597,2,芭芭酷,2722,1492,192,179,371,51.8%,15m
13597,2,darkness,2722,1107,76,63,139,54.7%,3m
13597,2,ssw,2722,1458,71,67,138,51.4%,26m
13597,3,MARALST,2722,556,40,30,70,57.1%,19m
13597,3,暴力严,2722,431,18,15,33,54.5%,8m
13597,2,安安,2722,356,15,17,32,46.9%,26m
13597,3,[盈盈一水间]土豆小胡,2722,301,11,9,20,55.0%,32m
13597,3,[Kiloli]鸽屿,2722,227,9,6,15,60.0%,59m
13597,3,唐三一愧,2722,0,4,1,5,80.0%,1h
13597,1,未来的某一天,2722,157,3,1,4,75.0%,33m
13597,2,[辣鸡儿小队]Onepiece,2722,0,3,2,5,60.0%,5m
13597,3,果仁小黑,2722,97,3,3,6,50.0%,48m
13597,2,栗子糖,2722,95,3,4,7,42.9%,1h
13597,3,冰雾渡鸦,2722,0,2,3,5,40.0%,1h
13597,3,[探索]星辰领航者,2722,0,1,0,1,100.0%,18m
13597,2,最后的最后,2722,88,1,1,2,50.0%,15m
13597,1,OvO,2722,0,0,2,2,0.0%,13m
13614,3,sodiarig,2721,1397,133,119,252,52.8%,4m
13614,3,[Aos菜鸡队]小小,2721,1114,60,54,114,52.6%,32m
13614,2,[Ago]泰伦人民,2721,1116,53,52,105,50.5%,27m
13614,2,风云与誓言,2721,173,19,20,39,48.7%,33m
13614,1,唐味麻酱,2721,528,18,13,31,58.1%,1h
13614,2,罗辑,2721,210,6,15,21,28.6%,36m
13614,2,[第九舰队丶]有点故事的男孩子,2721,0,4,2,6,66.7%,1h
13614,3,笑小仙,2721,70,4,7,11,36.4%,9m
13614,3,雪树下等你,2721,92,2,3,5,40.0%,14m
13614,1,[折翼丿天使灬]ACCELERATOR,2721,72,2,4,6,33.3%,49m
13614,1,小虎杀疯啦,2721,70,2,5,7,28.6%,1h
13614,3,[雷蛇]开膛手灬洛萨,2721,60,2,6,8,25.0%,9m
13614,1,[SDEt]低旧雪,2721,0,1,1,2,50.0%,1h
13614,1,NITAI,2721,0,1,2,3,33.3%,37m
13614,3,叫我眼瞎玩家,2721,92,1,3,4,25.0%,58m
13614,3,夕阳的刻痕,2721,30,1,6,7,14.3%,12m
13614,3,很强的探机,2721,0,0,1,1,0.0%,14m
13614,1,[万世大秦]啃笔小陈,2721,0,0,1,1,0.0%,1h
13614,1,[绀野木绵季]援气少女卷毛酱,2721,0,0,2,2,0.0%,1h
13633,3,[社交学教官]小杰,2720,989,96,99,195,49.2%,28m
13633,2,Posoon,2720,167,27,21,48,56.2%,12m
13633,1,[TNH]parting,2720,436,18,10,28,64.3%,1h
13633,3,monster,2720,431,17,17,34,50.0%,15m
13633,3,[DSE]IIIIIIIIiI,2720,218,8,2,10,80.0%,1h
13633,1,[好想干点什么]嘲讽鲸鱼的猫,2720,190,7,7,14,50.0%,46m
13633,1,[幻想神社]小林林檎,2720,78,2,2,4,50.0%,10m
13633,3,[暴雪我是你爹]这一枪叫做晚安,2720,114,2,3,5,40.0%,15m
13633,1,翱翔的无奈,2720,38,1,2,3,33.3%,1h
13633,2,日月天,2720,0,1,3,4,25.0%,1h
13633,3,moxuanX,2720,0,1,4,5,20.0%,58m
13633,1,Money,2720,0,1,4,5,20.0%,1h
13633,3,[saty]fyylmfj,2720,0,0,1,1,0.0%,1h
13646,3,泽拉图,2719,699,45,40,85,52.9%,10m
13646,3,IIIIIIIIIIII,2719,719,40,25,65,61.5%,15m
13646,3,IIIIIIIIIIII,2719,601,33,29,62,53.2%,7m
13646,1,[湾区社会人]JohnsonQ,2719,315,18,9,27,66.7%,26m
13646,1,[夏色吹雪协会]白上吹雪,2719,468,16,10,26,61.5%,60m
13646,1,DEMO,2719,288,14,0,14,100.0%,27m
13646,3,[诺娃萌萌哒]moonlight,2719,302,12,4,16,75.0%,10m
13646,3,星言夜语,2719,164,9,6,15,60.0%,59m
13646,3,火星大王,2719,167,5,2,7,71.4%,1h
13646,1,神都,2719,96,4,6,10,40.0%,57m
13646,3,今夕何夕,2719,48,3,4,7,42.9%,30m
13646,1,[燕大SC]阿尔托莉雅,2719,40,2,0,2,100.0%,1h
13646,3,Music,2719,0,2,3,5,40.0%,1h
13646,3,粉红喵喵拳,2719,0,2,3,5,40.0%,1h
13646,3,兔比南包万,2719,6,2,5,7,28.6%,58m
13646,3,驾鹤望浮云,2719,0,1,5,6,16.7%,2m
13646,1,LIHUI,2719,0,0,1,1,0.0%,25m
13646,2,Ericsson,2719,0,0,1,1,0.0%,1h
13646,3,霸气的蠕虫,2719,0,0,4,4,0.0%,8m
13665,1,老年选手,2718,1528,311,300,611,50.9%,33m
13665,1,JACK,2718,1422,147,141,288,51.0%,14m
13665,2,开水,2718,1342,95,97,192,49.5%,16m
13665,1,NightRaid,2718,517,59,68,127,46.5%,30m
13665,1,[四剑客]光兮,2718,985,40,32,72,55.6%,57m
13665,3,lzp,2718,652,24,22,46,52.2%,2m
13665,1,forder,2718,501,18,16,34,52.9%,33m
13665,3,[专业收尸队]TFTPONE,2718,127,14,11,25,56.0%,29m
13665,1,基地炸了,2718,366,13,17,30,43.3%,1h
13665,1,西环会老大,2718,385,12,11,23,52.2%,37m
13665,3,幻化冥迷,2718,162,11,11,22,50.0%,59m
13665,3,xlking,2718,242,9,12,21,42.9%,1h
13665,1,Yuki,2718,184,8,7,15,53.3%,10m
13665,1,阿澜,2718,143,5,6,11,45.5%,1h
13665,2,CAT,2718,0,3,3,6,50.0%,1h
13665,2,神王,2718,0,3,4,7,42.9%,1h
13665,1,泡哥威武,2718,0,1,0,1,100.0%,1h
13665,1,cqcqcq,2718,0,0,1,1,0.0%,2m
13665,1,IIIIIIIIIIII,2718,0,0,1,1,0.0%,18m
13665,2,HELP,2718,0,0,1,1,0.0%,7m
13665,1,[活着为了]光复艾尔,2718,0,0,1,1,0.0%,1h
13665,1,[帅逼毒奶谐]泽拉图,2718,0,0,2,2,0.0%,16m
13687,2,joker,2717,1505,473,490,963,49.1%,12m
13687,3,CelestialBe,2717,757,36,25,61,59.0%,58m
13687,3,奥罗拉,2717,760,30,30,60,50.0%,9m
13687,3,jmdmke,2717,783,28,28,56,50.0%,6m
13687,3,狄安娜,2717,646,23,26,49,46.9%,59m
13687,3,[中南大学官网]KafuuChino,2717,481,19,22,41,46.3%,3m
13687,2,[oo]blues,2717,512,18,23,41,43.9%,2m
13687,1,venus,2717,433,16,13,29,55.2%,2m
13687,1,[飞云之上]阿塔尼斯,2717,458,14,12,26,53.8%,43m
13687,1,海纳百川,2717,317,12,5,17,70.6%,27m
13687,2,yuyutfy,2717,95,7,1,8,87.5%,1h
13687,3,fay,2717,166,7,13,20,35.0%,23m
13687,2,光之韵,2717,88,5,5,10,50.0%,1h
13687,1,IIIIIIIIIII,2717,100,4,2,6,66.7%,13m
13687,1,[CIE]熊哈哈哈哈,2717,146,4,4,8,50.0%,26m
13687,1,多弗朗冥歌,2717,90,3,3,6,50.0%,1h
13687,2,[目標諾森德]小猪仔,2717,88,2,0,2,100.0%,1h
13687,1,野人王,2717,40,2,2,4,50.0%,1h
13687,3,RYO,2717,0,2,3,5,40.0%,47m
13687,1,带你个十娘,2717,102,2,3,5,40.0%,13m
13687,3,NOTHINGTOALL,2717,0,2,3,5,40.0%,48m
13687,1,[社交学教员]Harry,2717,0,1,0,1,100.0%,3m
13687,3,[28CM]有蝠同享,2717,0,1,0,1,100.0%,1h
13687,3,boyNextdDooR,2717,0,1,2,3,33.3%,28m
13687,1,WYHWYH,2717,0,0,2,2,0.0%,26m
13687,1,[KPG]zimba,2717,0,0,2,2,0.0%,22m
13713,1,MsFh,2716,1613,73,63,136,53.7%,1h
13713,3,[同济大学]huodeheshiqu,2716,1181,51,49,100,51.0%,58m
13713,2,冷面阎罗,2716,889,37,36,73,50.7%,26m
13713,1,[媛气少女]垃圾史佳俊,2716,952,36,29,65,55.4%,53m
13713,3,犬儒,2716,625,22,23,45,48.9%,15m
13713,1,名字太长,2716,463,15,10,25,60.0%,1h
13713,3,蓝天,2716,196,10,9,19,52.6%,3m
13713,3,威廉先森,2716,198,8,8,16,50.0%,24m
13713,3,xyz,2716,201,8,10,18,44.4%,1h
13713,3,[琴筝]先行者,2716,97,5,6,11,45.5%,23m
13713,3,[泗水相逢]PYTCORNA,2716,122,4,4,8,50.0%,8m
13713,3,[Utada]TYTY,2716,139,3,2,5,60.0%,52m
13713,1,[fwzz]Foreverzz,2716,0,1,0,1,100.0%,54m
13713,3,[YINGJI]暗夜之骑士,2716,0,1,3,4,25.0%,1h
13713,1,小陈,2716,0,0,2,2,0.0%,48m
13713,1,DonaldTrump,2716,0,0,3,3,0.0%,1h
13729,1,小风,2715,1330,113,96,209,54.1%,28m
13729,3,kuhako,2715,1289,91,81,172,52.9%,13m
13729,3,[逗比神教]赣南孙一峰,2715,449,37,32,69,53.6%,9m
13729,3,flyinsky,2715,700,31,25,56,55.4%,32m
13729,3,[仙女的云朵喵]忧伤的落樱,2715,597,22,26,48,45.8%,28m
13729,3,[小剑人]长沙孙一峰,2715,480,21,19,40,52.5%,19m
13729,1,hyyhvv,2715,427,16,8,24,66.7%,53m
13729,3,[OwenSS]Grey,2715,310,12,13,25,48.0%,23m
13729,2,达令晚安,2715,188,11,17,28,39.3%,6m
13729,1,[菜鸡就是我]adslook,2715,112,4,2,6,66.7%,24m
13729,1,刀锋舔血,2715,96,4,4,8,50.0%,58m
13729,3,slayer,2715,36,4,8,12,33.3%,1h
13729,3,明月清风,2715,97,3,2,5,60.0%,1h
13729,2,陌七,2715,0,3,3,6,50.0%,11m
13729,3,虚空之剑,2715,97,3,3,6,50.0%,1h
13729,3,IIIIIIIIIIII,2715,60,3,5,8,37.5%,23m
13729,2,坟葬,2715,88,2,3,5,40.0%,25m
13729,3,圣诞节风光好,2715,123,2,6,8,25.0%,1h
13729,1,小胖,2715,0,1,0,1,100.0%,27m
13729,1,十一三,2715,42,1,2,3,33.3%,25m
13729,1,[兰均竹空]MaGIng,2715,0,0,1,1,0.0%,13m
13729,1,我得重新集结部队,2715,0,0,1,1,0.0%,17m
13729,2,达克毒爆,2715,0,0,2,2,0.0%,1h
13752,1,风铃,2714,1545,81,89,170,47.6%,55m
13752,3,Protoss,2714,1100,59,55,114,51.8%,30m
13752,3,[NSG致一]小猪爱睡觉,2714,588,21,21,42,50.0%,16m
13752,2,大麦苗,2714,418,16,20,36,44.4%,3m
13752,1,[grief]Alkan,2714,357,13,15,28,46.4%,28m
13752,1,悔丶,2714,390,11,9,20,55.0%,1h
13752,3,阿巴阿巴,2714,256,10,11,21,47.6%,23m
13752,2,新手,2714,239,7,2,9,77.8%,1h
13752,3,蓝天白菜,2714,164,7,9,16,43.8%,16m
13752,2,王趴趴,2714,179,5,6,11,45.5%,1h
13752,3,[C13063]Story,2714,0,4,1,5,80.0%,47m
13752,2,jia,2714,44,4,4,8,50.0%,1h
13752,1,在途的巨便打鸡,2714,103,4,6,10,40.0%,2m
13752,1,[IISC]早起的鸟儿硬邦邦,2714,64,3,0,3,100.0%,1h
13752,3,sakura,2714,131,3,0,3,100.0%,58m
13752,1,[Troubl]MuShI,2714,0,1,1,2,50.0%,1h
13752,3,智树的小钥匙,2714,0,1,4,5,20.0%,1h
13752,1,小学神,2714,0,0,1,1,0.0%,33m
13752,1,再炸豆芽就傻了,2714,0,0,1,1,0.0%,1h
13752,1,[BOA]LiquiDator,2714,0,0,1,1,0.0%,1h
13752,1,[暴雪十四队]卡罗拉,2714,0,0,2,2,0.0%,43m
13773,3,风潇雨落,2713,1489,63,65,128,49.2%,3m
13773,1,曾经的我,2713,712,42,54,96,43.8%,59m
13773,1,渐行渐远,2713,471,28,19,47,59.6%,25m
13773,1,pangas,2713,481,18,15,33,54.5%,57m
13773,3,Horace,2713,370,15,17,32,46.9%,10m
13773,3,丨高锰酸钾丨,2713,283,12,7,19,63.2%,9m
13773,2,Theshy,2713,252,11,11,22,50.0%,1h
13773,1,[PGJSF]拉锯赶路的男人,2713,238,11,13,24,45.8%,19m
13773,2,[火焰雷兽]我有一剑名扶摇,2713,246,8,18,26,30.8%,2m
13773,3,Thiswolf,2713,186,7,8,15,46.7%,28m
13773,1,wen,2713,188,6,3,9,66.7%,1h
13773,2,Ecris,2713,90,6,5,11,54.5%,59m
13773,3,[XXHZ4]心动在劫难逃,2713,0,4,1,5,80.0%,1h
13773,1,坐在坟头陪鬼睡,2713,116,3,4,7,42.9%,10m
13773,1,夜空,2713,40,2,1,3,66.7%,1h
13773,1,星际争霸真好玩,2713,0,1,0,1,100.0%,19m
13773,1,[初音守护二队]大神糕房,2713,0,1,1,2,50.0%,1h
13773,3,奶茶弟弟,2713,0,1,2,3,33.3%,1h
13773,1,胡旋,2713,0,0,1,1,0.0%,1h
13792,3,NewStar,2712,1245,94,89,183,51.4%,7m
13792,3,aiaiai,2712,1197,84,66,150,56.0%,31m
13792,1,喵神,2712,1155,65,57,122,53.3%,53m
13792,2,qwecindy,2712,1036,43,39,82,52.4%,3m
13792,1,finally,2712,866,35,33,68,51.5%,1h
13792,3,沙包,2712,550,21,21,42,50.0%,28m
13792,1,[工口]IIIIIIIIIIII,2712,533,19,16,35,54.3%,1h
13792,3,中华小果冻,2712,399,14,15,29,48.3%,29m
13792,3,robot,2712,204,9,7,16,56.2%,6m
13792,1,欧西里斯的天空龙,2712,194,5,2,7,71.4%,1h
13792,1,谷小宅,2712,138,5,6,11,45.5%,1h
13792,3,请叫我乖神,2712,0,4,1,5,80.0%,47m
13792,3,骏祥,2712,0,3,2,5,60.0%,8m
13792,3,天道,2712,0,2,3,5,40.0%,1h
13792,3,[HD]阿喀琉斯橡皮,2712,30,1,4,5,20.0%,58m
13792,2,MarineKing,2712,0,0,1,1,0.0%,1h
13808,2,电脑,2711,1525,141,140,281,50.2%,21m
13808,1,与孤独相吻,2711,1547,113,93,206,54.9%,19m
13808,2,[极限菜鸟]DREAMOON,2711,909,76,69,145,52.4%,3m
13808,3,[火焰雷兽]淑二,2711,867,71,71,142,50.0%,59m
13808,3,[Shawk]雪落南花,2711,671,60,49,109,55.0%,19m
13808,2,[秋毫]绝境只能想到坦克,2711,1047,48,46,94,51.1%,58m
13808,3,[Beasty]十二翼天使,2711,682,32,21,53,60.4%,16m
13808,1,无名称,2711,391,18,13,31,58.1%,1h
13808,1,老男人玩星际,2711,447,16,10,26,61.5%,1h
13808,1,我菜我骄傲,2711,316,11,5,16,68.8%,2m
13808,3,[shangd]白衣贼,2711,192,7,10,17,41.2%,9m
13808,1,[幼女真是棒]雏鹤一爱,2711,201,6,1,7,85.7%,49m
13808,2,TANSHUAI,2711,0,3,1,4,75.0%,18m
13808,2,joker,2711,0,3,3,6,50.0%,43m
13808,2,我不太会,2711,94,2,1,3,66.7%,53m
13808,3,Ayden,2711,0,2,3,5,40.0%,22m
13808,2,萌新一只友善对待,2711,0,1,1,2,50.0%,1h
13808,3,VIEN,2711,0,1,2,3,33.3%,9m
13808,3,llllllllllll,2711,0,0,1,1,0.0%,1h
13808,3,沉默之风暴,2711,0,0,1,1,0.0%,1h
13808,1,葛宝龙,2711,0,0,2,2,0.0%,3m
13829,1,[腥基佬男骸]子午夜梦,2710,622,22,21,43,51.2%,1h
13829,3,[小土鸡]saber,2710,599,22,23,45,48.9%,19m
13829,3,ice,2710,488,17,23,40,42.5%,26m
13829,3,ZeroG,2710,189,9,6,15,60.0%,30m
13829,1,[四世三公]ggbobn,2710,275,8,8,16,50.0%,1h
13829,3,悲伤的猪大肠,2710,201,8,8,16,50.0%,1h
13829,3,[timba6]蔡徐坤,2710,178,6,11,17,35.3%,28m
13829,1,[ESU二五仔]ELvis,2710,48,4,7,11,36.4%,18m
13829,1,爱到底,2710,76,3,2,5,60.0%,1h
13829,2,Domies,2710,0,3,4,7,42.9%,1h
13829,3,赫格杜克,2710,36,3,4,7,42.9%,1h
13829,1,[开菊怪]夜雨升凡,2710,40,2,3,5,40.0%,1h
13829,2,DeadlyPants,2710,0,2,4,6,33.3%,1h
13829,3,晴天,2710,0,2,5,7,28.6%,7m
13829,1,[XXHZ28]快递王道,2710,0,0,2,2,0.0%,13m
13829,2,你看起来很好吃呀,2710,0,0,2,2,0.0%,1h
13845,2,Seven,2709,1532,249,238,487,51.1%,8m
13845,2,[南京工业大学]氘化氢,2709,1389,149,147,296,50.3%,5m
13845,3,[西安交通大学]fungi,2709,1380,76,69,145,52.4%,16m
13845,1,HFR,2709,947,55,63,118,46.6%,19m
13845,3,[宇宙第一帅]米仓凉子,2709,337,31,21,52,59.6%,59m
13845,1,奥特曼,2709,829,31,32,63,49.2%,26m
13845,1,羽根,2709,418,16,9,25,64.0%,9m
13845,3,[毛毛球]补缺,2709,360,16,11,27,59.3%,26m
13845,3,有点暴躁,2709,240,9,10,19,47.4%,1h
13845,3,[社交学巨可爱]成的臭脾气,2709,170,7,9,16,43.8%,1h
13845,2,[上车]稀神探女,2709,159,5,5,10,50.0%,39m
13845,3,StealHeart,2709,122,5,9,14,35.7%,14m
13845,1,[有被爽到]Timba,2709,88,2,0,2,100.0%,1h
13845,1,躲猫猫,2709,42,2,1,3,66.7%,49m
13845,3,冰影,2709,0,2,3,5,40.0%,3m
13845,1,TheNightmare,2709,0,1,0,1,100.0%,1h
13845,1,[落魄山]流星,2709,0,1,0,1,100.0%,19m
13845,1,君主华夷,2709,0,1,0,1,100.0%,18m
13845,3,人族无敌,2709,30,1,5,6,16.7%,23m
13845,1,ppcy,2709,0,0,1,1,0.0%,1h
13845,1,一默一,2709,0,0,1,1,0.0%,1h
13845,1,[刺蛇互助天团]峰灵,2709,0,0,1,1,0.0%,16m
13845,2,半夜闻犬吠,2709,0,0,1,1,0.0%,37m
13868,1,himan,2708,1523,103,97,200,51.5%,19m
13868,3,胖胡,2708,1567,87,94,181,48.1%,30m
13868,1,Gforcens,2708,1229,47,46,93,50.5%,57m
13868,1,[不知道叫什么]新年年年,2708,1092,37,51,88,42.0%,9m
13868,1,[北有吾王]lllllllllll,2708,654,26,17,43,60.5%,49m
13868,3,dkrtt,2708,300,11,10,21,52.4%,28m
13868,3,[336]Komorebi,2708,332,11,14,25,44.0%,30m
13868,1,风花散,2708,322,10,12,22,45.5%,24m
13868,1,[ESKT]darling,2708,219,8,2,10,80.0%,43m
13868,1,[键盘冒毒奶]超能之狼炎,2708,221,7,3,10,70.0%,33m
13868,1,[小鸡屠宰场9]淦就完事了,2708,144,5,4,9,55.6%,1h
13868,1,Fuiwkso,2708,187,5,4,9,55.6%,1h
13868,3,jjh,2708,164,4,2,6,66.7%,1h
13868,3,立華奏,2708,0,2,3,5,40.0%,1h
13868,2,[小心我咬死你]岳健,2708,0,1,0,1,100.0%,1h
13868,3,风夜幻雪,2708,0,1,2,3,33.3%,58m
13884,3,荣光照耀艾尔,2707,1141,51,37,88,58.0%,10m
13884,1,热心怒,2707,804,25,27,52,48.1%,3m
13884,3,古怪之裤子,2707,195,14,13,27,51.9%,58m
13884,1,一直乱来,2707,354,13,14,27,48.1%,43m
13884,3,乐莫离,2707,280,11,12,23,47.8%,1h
13884,3,IIIIIIIIIIII,2707,114,8,5,13,61.5%,16m
13884,1,[TNLet]Solar,2707,155,5,1,6,83.3%,1h
13884,1,同心辞,2707,140,5,6,11,45.5%,18m
13884,2,[冬予]scarcely,2707,115,4,1,5,80.0%,1h
13884,1,小菜菜,2707,230,4,6,10,40.0%,60m
13884,1,我好帅,2707,76,3,1,4,75.0%,28m
13884,2,小萌新酱,2707,145,3,1,4,75.0%,44m
13884,2,灞波儿奔,2707,0,3,3,6,50.0%,5m
13884,1,ABCD,2707,108,3,4,7,42.9%,1h
13884,3,NZyan,2707,66,3,10,13,23.1%,1h
13884,2,[肆季]斯卡洛尔,2707,40,2,0,2,100.0%,5m
13884,3,[sgcc]淡憶,2707,0,2,3,5,40.0%,1h
13884,3,鬼鬼,2707,0,2,3,5,40.0%,1h
13884,3,最爱你的人,2707,0,2,3,5,40.0%,1h
13884,3,[玄武堂]taq,2707,129,2,10,12,16.7%,7m
13884,3,[薇薇安]Omnipotent,2707,0,1,1,2,50.0%,1h
13884,3,Jupiter,2707,0,0,1,1,0.0%,1h
13884,2,[无敌战队]圣堂之殇,2707,0,0,1,1,0.0%,1h
13884,1,FuYun,2707,0,0,2,2,0.0%,16m
13884,3,Overmind,2707,0,0,4,4,0.0%,8m
13909,1,死宅萌大奶,2706,1693,136,121,257,52.9%,53m
13909,3,天棋,2706,664,27,25,52,51.9%,16m
13909,1,影者,2706,460,25,21,46,54.3%,53m
13909,3,具颜欢,2706,416,21,13,34,61.8%,15m
13909,1,小淦,2706,528,19,11,30,63.3%,57m
13909,3,赫利肯之冬,2706,237,19,25,44,43.2%,14m
13909,1,童话里的王子,2706,222,18,11,29,62.1%,1h
13909,1,暮光,2706,414,16,15,31,51.6%,19m
13909,1,[gobee]ZFZ,2706,295,9,4,13,69.2%,13m
13909,1,guoyufan,2706,253,8,5,13,61.5%,13m
13909,3,[XJTU]futureshine,2706,139,4,4,8,50.0%,9m
13909,1,玲珑玺笙,2706,145,3,5,8,37.5%,1h
13909,1,梦圣,2706,36,2,0,2,100.0%,1h
13909,3,皮咔球,2706,0,2,3,5,40.0%,1h
13909,3,killer,2706,0,2,4,6,33.3%,49m
13909,1,[天地总舵会]余孤岚彡,2706,0,1,0,1,100.0%,49m
13909,2,半夜人族全是狗,2706,0,1,1,2,50.0%,59m
13909,1,[将军刽子手]放牛娃,2706,0,0,1,1,0.0%,60m
13927,3,IIIIIIIIIII,2705,1626,552,540,1092,50.5%,23m
13927,3,黎星刻,2705,967,60,58,118,50.8%,9m
13927,1,bkwyk,2705,796,49,37,86,57.0%,57m
13927,3,sora,2705,904,48,37,85,56.5%,32m
13927,1,[KPG2]化身邪恶富婆杀手,2705,1021,43,38,81,53.1%,27m
13927,2,神仙树下抚琴人,2705,736,35,45,80,43.8%,6m
13927,1,[老年特战队]阔咩那塞,2705,541,34,29,63,54.0%,16m
13927,1,任溶溶,2705,605,24,18,42,57.1%,1h
13927,1,[细水长流]皇族神龙,2705,218,14,9,23,60.9%,3m
13927,3,amethyst,2705,257,13,9,22,59.1%,3m
13927,1,[菜有菜的道理]Ilyich,2705,327,12,6,18,66.7%,15m
13927,3,oblivion,2705,328,12,14,26,46.2%,32m
13927,1,FATE,2705,48,5,6,11,45.5%,1h
13927,2,[萌王]我也是萌新,2705,117,4,2,6,66.7%,1h
13927,2,[Mikon]阿巴阿巴怪,2705,116,4,4,8,50.0%,1h
13927,1,[谐星联盟c]星云战争,2705,76,2,2,4,50.0%,2m
13927,1,Disruptor,2705,142,2,4,6,33.3%,1h
13927,3,恭喜见到爷,2705,0,1,0,1,100.0%,1h
13927,1,青铜宅男,2705,0,0,1,1,0.0%,1h
13927,1,Clean,2705,0,0,1,1,0.0%,1h
13947,1,Aeresa,2704,1340,192,189,381,50.4%,8m
13947,1,来辆劳斯莱斯,2704,1442,62,48,110,56.4%,33m
13947,3,alexu,2704,839,42,29,71,59.2%,2m
13947,3,普肉兔斯,2704,604,25,18,43,58.1%,7m
13947,3,Tabice,2704,556,24,20,44,54.5%,28m
13947,3,[扫黄]AcE,2704,427,15,17,32,46.9%,58m
13947,3,SupremeMagic,2704,398,14,17,31,45.2%,23m
13947,3,[西安石油大学]生气老表,2704,410,14,17,31,45.2%,12m
13947,1,蚂蚁,2704,322,13,14,27,48.1%,57m
13947,3,[新机械纪元]战斗吧歌姬,2704,250,10,11,21,47.6%,46m
13947,3,茉莉的小棉袄,2704,91,5,2,7,71.4%,3m
13947,3,永远单推久远千岁,2704,169,5,2,7,71.4%,41m
13947,1,踢你踢你体踢死你,2704,190,4,3,7,57.1%,16m
13947,2,[澄碧]微微微微微微微笑,2704,90,4,10,14,28.6%,30m
13947,3,海猪,2704,0,2,3,5,40.0%,1h
13947,1,影丶墨,2704,0,2,3,5,40.0%,19m
13947,2,[深空骑士]tpz,2704,0,1,0,1,100.0%,1h
13947,2,[韩宗快乐屋]WeiDaShuai,2704,0,1,0,1,100.0%,1h
13947,3,冰镇锦鲤,2704,0,0,1,1,0.0%,5m
13947,3,[CET6]EdenXiaomil,2704,0,0,2,2,0.0%,54m
13947,1,Mystic,2704,0,0,4,4,0.0%,1h
13968,1,[为了教父]疯猫,2703,1212,50,36,86,58.1%,36m
13968,3,[卖丶烂铁皮]SKTZX,2703,552,30,25,55,54.5%,57m
13968,2,犀利的小板砖,2703,336,27,34,61,44.3%,22m
13968,1,菲亚特合同法,2703,292,9,8,17,52.9%,1h
13968,1,[超级大后期]疯狗一样的电脑,2703,278,9,8,17,52.9%,40m
13968,1,[KPG2]GZEZHANGLP,2703,176,7,2,9,77.8%,1h
13968,3,bane,2703,223,7,7,14,50.0%,1h
13968,1,Fabeltier,2703,211,6,1,7,85.7%,1h
13968,1,[Hooray]Willionsmeal,2703,171,5,1,6,83.3%,1h
13968,1,[老头星际]梦想超级牛,2703,114,4,4,8,50.0%,9m
13968,2,江山可忆,2703,0,3,3,6,50.0%,14m
13968,2,seadrsmile,2703,0,3,3,6,50.0%,1h
13968,1,重新集结部队,2703,78,2,2,4,50.0%,25m
13968,1,[暴雪二十二队]艾露恩之陨,2703,0,1,0,1,100.0%,3m
13968,2,fff,2703,0,1,0,1,100.0%,1h
13968,1,我是你还是,2703,0,1,1,2,50.0%,23m
13968,1,舞曲歌颂者,2703,0,1,1,2,50.0%,48m
13968,1,望风的蜗牛,2703,0,1,1,2,50.0%,1h
13968,1,鸦猫酱,2703,36,1,2,3,33.3%,1h
13987,2,[慢手e族]人人从,2702,1637,540,530,1070,50.5%,21m
13987,2,小女巫没吃饭,2702,660,26,28,54,48.1%,37m
13987,1,[逗比神教]涛涛好可爱呀,2702,304,15,1,16,93.8%,43m
13987,3,[破浔第一闪]小丑竟然是我自己,2702,264,10,9,19,52.6%,29m
13987,1,黑黑忽忽,2702,228,8,9,17,47.1%,31m
13987,2,混子,2702,252,7,7,14,50.0%,1h
13987,3,PartinG,2702,102,4,8,12,33.3%,10m
13987,1,[鬼谷]Tianzai,2702,96,3,3,6,50.0%,1h
13987,1,[星际老YB]四攻四防,2702,38,2,1,3,66.7%,1h
13987,3,[雷霆崖]洛北,2702,0,2,3,5,40.0%,1h
13987,2,暗暗生天际,2702,48,2,5,7,28.6%,11m
13987,3,GOGOGO,2702,30,2,10,12,16.7%,29m
13999,3,鸡谐化就输不了,2701,697,92,86,178,51.7%,59m
13999,1,[兵长军团]兵长丶半兵,2701,472,21,6,27,77.8%,1h
13999,3,摇滚男孩,2701,396,17,16,33,51.5%,7m
13999,3,[MS13战术]幻化成风,2701,437,16,22,38,42.1%,28m
13999,2,llllllllllll,2701,380,13,13,26,50.0%,12m
13999,3,拿波里贵族,2701,151,9,10,19,47.4%,8m
13999,1,白求帶衝鋒,2701,180,7,7,14,50.0%,1h
13999,3,[龙腾宇内]镜月,2701,176,7,9,16,43.8%,15m
13999,1,东狂,2701,107,5,3,8,62.5%,33m
13999,2,hhhhhhh,2701,158,5,5,10,50.0%,7m
13999,2,遂宁孙一峰,2701,140,4,7,11,36.4%,12m
13999,3,达达里氏,2701,0,2,3,5,40.0%,33m
13999,3,appleloe,2701,0,2,3,5,40.0%,54m
13999,3,星火燎原,2701,0,2,5,7,28.6%,25m
13999,3,寒舞,2701,0,1,4,5,20.0%,3m
14014,3,娄艺潇,2700,387,24,24,48,50.0%,8m
14014,1,阳光泰伦,2700,423,15,10,25,60.0%,13m
14014,1,闪烁的刷新球,2700,248,8,7,15,53.3%,19m
14014,1,[幽金贮藏堆]那你不是很棒棒哦,2700,48,5,5,10,50.0%,56m
14014,2,龙中之风,2700,157,4,4,8,50.0%,51m
14014,3,sddddddgg,2700,133,4,4,8,50.0%,1h
14014,3,kid,2700,0,2,3,5,40.0%,1h
14014,1,绘梨衣,2700,0,1,0,1,100.0%,16m
14014,1,Growing,2700,0,1,2,3,33.3%,50m
14014,3,初音未来,2700,0,1,2,3,33.3%,1h
14014,1,[mdfz]鲍迪,2700,0,0,1,1,0.0%,26m
14014,2,蟑螂恶霸,2700,0,0,1,1,0.0%,11m
14026,3,SBR,2699,1044,248,296,544,45.6%,57m
14026,3,[重武器]wyx,2699,1596,203,194,397,51.1%,4m
14026,2,Crystal,2699,1413,191,220,411,46.5%,14m
14026,1,[灵猫]白猫与黑猫,2699,1054,46,28,74,62.2%,15m
14026,1,你与未来,2699,303,13,13,26,50.0%,3m
14026,3,神游苦苦,2699,253,10,10,20,50.0%,1h
14026,2,夜刀神十香,2699,159,8,6,14,57.1%,1h
14026,1,[Banned]MoeKotoki,2699,253,7,9,16,43.8%,1h
14026,3,小克,2699,118,4,8,12,33.3%,3m
14026,3,liquidghost,2699,0,2,2,4,50.0%,14m
14026,3,Loong,2699,0,2,3,5,40.0%,5m
14026,3,爱丽丝人仙,2699,0,2,3,5,40.0%,1h
14026,1,[s金色玫瑰s]寒原金盏花,2699,0,1,0,1,100.0%,1h
14026,1,[C06904]Creeper,2699,0,1,2,3,33.3%,29m
14026,1,[501三巨头]Maruuu,2699,0,1,4,5,20.0%,1h
14026,1,[小仙女上线啦]吉姆哈斯,2699,0,0,1,1,0.0%,1h
14042,1,[神圣路易帝国]doge,2698,661,35,27,62,56.5%,13m
14042,3,栗山未来,2698,682,32,27,59,54.2%,8m
14042,3,若休丶,2698,738,30,30,60,50.0%,32m
14042,1,梦醒,2698,479,18,21,39,46.2%,13m
14042,1,江龙,2698,392,16,11,27,59.3%,38m
14042,1,[神之族]黑火,2698,377,14,7,21,66.7%,1h
14042,1,IIIIIIII,2698,408,12,14,26,46.2%,1h
14042,1,[北极光小组]BBVS,2698,214,9,2,11,81.8%,57m
14042,1,香浓牛奶面包渣,2698,213,7,4,11,63.6%,1h
14042,1,[人类天下第一]邪亿杰,2698,179,6,3,9,66.7%,1h
14042,1,Metformin,2698,132,4,4,8,50.0%,13m
14042,1,你是不是要输了,2698,104,3,3,6,50.0%,33m
14042,3,我可是会嘤嘤的,2698,0,1,1,2,50.0%,1h
14055,1,Umbrella,2697,809,123,119,242,50.8%,1h
14055,1,战略防御,2697,680,42,30,72,58.3%,1h
14055,3,八月未央,2697,281,28,33,61,45.9%,59m
14055,1,卢大大,2697,350,21,15,36,58.3%,1h
14055,3,rare,2697,328,18,23,41,43.9%,19m
14055,3,LaYs,2697,461,15,18,33,45.5%,9m
14055,3,[最终旅途]傲娇领主高坚果,2697,331,11,11,22,50.0%,32m
14055,2,VivaLaVida,2697,92,11,16,27,40.7%,22m
14055,2,Slient,2697,181,6,6,12,50.0%,1h
14055,3,见芒,2697,124,5,9,14,35.7%,15m
14055,1,TonyQwQ,2697,96,4,4,8,50.0%,1h
14055,1,自贡超人黄旭东,2697,68,2,2,4,50.0%,38m
14055,3,[1sA]好多兄弟都牺牲了,2697,0,1,0,1,100.0%,48m
14055,1,RotuceXe,2697,0,1,0,1,100.0%,1h
14055,2,[菜的没人带]机壳路径灵,2697,0,1,0,1,100.0%,37m
14055,1,[华夏何平]LEON,2697,32,1,1,2,50.0%,1h
14055,1,[哔哩哔哩杯乾]biubiubiu,2697,0,0,1,1,0.0%,1h
14055,1,Ardo,2697,0,0,2,2,0.0%,1h
14073,3,Zaga,2696,1022,262,251,513,51.1%,24m
14073,3,[慢手e族]吾非空,2696,1542,107,104,211,50.7%,32m
14073,3,IIIIIIIIIIII,2696,1342,71,65,136,52.2%,5m
14073,1,yejq,2696,1650,71,69,140,50.7%,1h
14073,1,孙一喵喵,2696,1156,44,40,84,52.4%,1h
14073,3,llllllllllll,2696,664,28,29,57,49.1%,33m
14073,3,打不过就是不够多,2696,233,11,11,22,50.0%,27m
14073,1,[那里不可以]小阿雪,2696,202,6,2,8,75.0%,15m
14073,2,[電脑难度]新手,2696,205,6,3,9,66.7%,1h
14073,2,空条承太郎,2696,0,4,2,6,66.7%,1h
14073,2,黄家驹,2696,0,3,3,6,50.0%,43m
14073,1,[燕大SC]冈田麿里之钉,2696,0,0,2,2,0.0%,1h
14085,1,[江南虫王]咸鱼,2695,1667,135,137,272,49.6%,18m
14085,3,鬼一般的存在,2695,1533,87,72,159,54.7%,13m
14085,3,MyCruelLOL,2695,484,19,22,41,46.3%,5m
14085,3,mkb,2695,424,16,19,35,45.7%,32m
14085,1,[同浙星际]CNInnovation,2695,249,14,7,21,66.7%,26m
14085,1,dfgdgd,2695,353,13,12,25,52.0%,1h
14085,3,Adolph,2695,148,13,15,28,46.4%,3m
14085,1,Lasting,2695,272,11,5,16,68.8%,26m
14085,1,IIIIIIIIII,2695,235,11,5,16,68.8%,1h
14085,1,[云丿星]tegdsdw,2695,226,9,6,15,60.0%,1h
14085,1,lkooopop,2695,230,7,8,15,46.7%,36m
14085,2,LanTheRaper,2695,114,4,5,9,44.4%,1h
14085,1,缘灭,2695,76,3,3,6,50.0%,53m
14085,1,[快乐白给]慕斯,2695,112,3,4,7,42.9%,24m
14085,1,路陌人,2695,0,1,2,3,33.3%,49m
14085,3,[獬豸]独脚夔,2695,0,0,1,1,0.0%,1h
14085,1,星云,2695,0,0,1,1,0.0%,1h
14102,3,Mahakassapa,2694,1131,108,114,222,48.6%,9m
14102,3,FIRE,2694,1397,60,53,113,53.1%,5m
14102,3,[小鸡屠宰场9]可口可乐,2694,1160,47,47,94,50.0%,4m
14102,1,[联合动物园]苏维埃狗熊,2694,853,32,28,60,53.3%,1h
14102,3,路人,2694,431,17,18,35,48.6%,13m
14102,3,Uade,2694,282,11,12,23,47.8%,28m
14102,3,悖论,2694,307,10,11,21,47.6%,16m
14102,3,IIIIIIIIIIII,2694,214,8,11,19,42.1%,58m
14102,2,nfnfnf,2694,137,4,5,9,44.4%,14m
14102,2,[艾尔停电小组]酥情,2694,0,3,4,7,42.9%,49m
14102,2,KaiYu,2694,44,3,5,8,37.5%,1h
14102,1,可否一笑,2694,38,2,1,3,66.7%,1h
14102,3,飘雪沁人心,2694,38,2,1,3,66.7%,1h
14102,3,tya,2694,0,2,3,5,40.0%,14m
14102,3,擦拭发烫信仰,2694,0,2,3,5,40.0%,1h
14102,3,一只萌新,2694,97,2,4,6,33.3%,3m
14102,1,刀光哥,2694,51,2,4,6,33.3%,1h
14102,1,NesTea,2694,0,1,0,1,100.0%,38m
14102,1,[文化人联盟]冰封夕阳,2694,0,0,1,1,0.0%,13m
14102,1,[仨大傻子之队]传说之巅,2694,0,0,2,2,0.0%,23m
14102,3,[非酋公会]hhh,2694,0,0,2,2,0.0%,59m
14102,1,[六道]IIIIIIIIIIII,2694,0,0,3,3,0.0%,26m
14124,3,[英雄协会]骑士的称号,2693,1081,335,329,664,50.5%,7m
14124,1,Terry,2693,970,46,42,88,52.3%,1h
14124,1,[疯月]缘生梦,2693,668,33,28,61,54.1%,18m
14124,1,老班长,2693,652,29,13,42,69.0%,1h
14124,1,duck,2693,503,19,13,32,59.4%,1h
14124,1,别骂了别骂了,2693,365,18,11,29,62.1%,1h
14124,2,喜茶不加糖,2693,254,13,21,34,38.2%,6m
14124,1,MLPFlintie,2693,324,9,11,20,45.0%,1h
14124,2,繁星,2693,235,8,12,20,40.0%,1h
14124,1,大鸡肉一二一三八,2693,237,5,11,16,31.2%,57m
14124,1,[火焰刀]hehe,2693,108,4,3,7,57.1%,3m
14124,1,我不会啊,2693,116,4,5,9,44.4%,3m
14124,1,[盟约]YHB,2693,118,3,0,3,100.0%,10m
14124,3,XLZERO,2693,0,3,1,4,75.0%,1h
14124,1,PROS,2693,109,3,2,5,60.0%,1h
14124,1,saikou,2693,106,3,4,7,42.9%,1h
14124,1,nbhahaha,2693,156,3,4,7,42.9%,10m
14141,1,pzx,2692,661,30,15,45,66.7%,3m
14141,1,MarK,2692,425,17,11,28,60.7%,3m
14141,3,为了超姐上王者丶,2692,281,11,8,19,57.9%,9m
14141,1,[潮了]Spoony,2692,370,10,11,21,47.6%,1h
14141,1,Biut,2692,262,9,7,16,56.2%,1h
14141,1,[幽灵闪现wo]llllllllllll,2692,151,4,1,5,80.0%,57m
14141,1,allish,2692,135,3,1,4,75.0%,57m
14141,2,一只小思子,2692,93,3,4,7,42.9%,53m
14141,2,[冲国特攻]Enterprise,2692,0,3,4,7,42.9%,1h
14141,3,[果丹皮]vitas,2692,0,2,3,5,40.0%,59m
14141,1,[逗谐]刀疯圣鬼,2692,68,2,3,5,40.0%,25m
14141,3,一旦设定,2692,0,2,3,5,40.0%,40m
14141,1,[ETG]Rengar,2692,42,1,3,4,25.0%,1h
14141,2,pozzolana,2692,0,0,2,2,0.0%,27m
14155,1,zhandou,2691,1579,305,313,618,49.4%,32m
14155,3,[半个大哥]DriveaF,2691,1259,52,44,96,54.2%,9m
14155,1,[为了艾尔CO]神之长子,2691,328,12,7,19,63.2%,36m
14155,1,矿区风大听不清,2691,272,10,6,16,62.5%,53m
14155,1,[以众神之名]Silence,2691,181,10,8,18,55.6%,10m
14155,1,[莫妮卡]Monika,2691,235,9,3,12,75.0%,3m
14155,1,[550]xxaovven,2691,162,6,2,8,75.0%,1h
14155,1,[黄金小萌新]Ephemeral,2691,178,6,4,10,60.0%,57m
14155,1,prince,2691,168,6,4,10,60.0%,43m
14155,1,[C37916]青橙,2691,164,5,5,10,50.0%,28m
14155,2,sads,2691,72,5,5,10,50.0%,1h
14155,1,我和人机五五开,2691,152,4,2,6,66.7%,1h
14155,2,完美背后,2691,0,3,3,6,50.0%,39m
14155,1,[小区第一闪]Lee,2691,140,3,3,6,50.0%,13m
14155,1,Micheal,2691,74,3,3,6,50.0%,1h
14155,1,么義嗷喵,2691,30,2,2,4,50.0%,1h
14155,3,[星魂]解除武装,2691,0,2,3,5,40.0%,14m
14155,3,创建角色名称,2691,0,2,3,5,40.0%,44m
14155,3,小憨憨,2691,0,2,3,5,40.0%,1h
14155,1,ztzhuang,2691,38,1,2,3,33.3%,34m
14155,1,lonewolf,2691,0,1,2,3,33.3%,34m
14155,1,星舰人类,2691,0,0,1,1,0.0%,57m
14177,1,Shine,2690,1441,150,147,297,50.5%,11m
14177,3,花非花,2690,1254,55,43,98,56.1%,23m
14177,1,[温柔兔公主]虎皮猫猫,2690,1314,54,42,96,56.2%,13m
14177,2,水晶腊肉,2690,578,48,54,102,47.1%,56m
14177,1,花钱月下,2690,664,24,20,44,54.5%,36m
14177,1,[傲世丨听雨轩]Tysone,2690,596,23,21,44,52.3%,1h
14177,2,laizi,2690,331,12,17,29,41.4%,12m
14177,1,[摸鱼探姬]爱衣丶休伯利安,2690,317,9,9,18,50.0%,1h
14177,1,dfdfsa,2690,190,8,15,23,34.8%,1h
14177,1,寻思学家,2690,227,7,8,15,46.7%,12m
14177,3,战部渡,2690,200,7,11,18,38.9%,27m
14177,1,SDemon,2690,216,6,9,15,40.0%,10m
14177,3,魔鬼筋肉人,2690,0,2,3,5,40.0%,33m
14177,1,葬仪社丶冥兮,2690,38,2,3,5,40.0%,1h
14177,3,[東方心念語]undeadArc,2690,30,2,3,5,40.0%,1h
14177,2,我真的不会玩合作,2690,0,2,3,5,40.0%,49m
14177,2,御坂美琴的妹夫,2690,44,1,1,2,50.0%,1h
14177,2,[HFC]HFCtamago,2690,0,1,2,3,33.3%,1h
14177,1,星际好难玩,2690,0,0,1,1,0.0%,1h
14177,3,hyege,2690,0,0,5,5,0.0%,15m
14197,1,在家睡觉,2689,1696,184,168,352,52.3%,25m
14197,1,[我开矿了你呢]脑残必死,2689,901,58,52,110,52.7%,1h
14197,2,旗手,2689,878,37,34,71,52.1%,2m
14197,2,[沙雕]小宝贝,2689,178,11,13,24,45.8%,30m
14197,3,只是一只猫,2689,300,10,16,26,38.5%,7m
14197,1,[魂祀]路西法大人,2689,231,8,4,12,66.7%,49m
14197,3,funeral,2689,217,8,9,17,47.1%,19m
14197,3,全球冰淇淋,2689,178,8,12,20,40.0%,16m
14197,1,[Fear]stop,2689,232,7,4,11,63.6%,43m
14197,1,小翔,2689,238,7,4,11,63.6%,33m
14197,3,游翼诗,2689,208,7,15,22,31.8%,15m
14197,1,[神奇的联萌]IIIIIIIIIIII,2689,176,5,5,10,50.0%,1h
14197,1,江南奇怪,2689,0,3,0,3,100.0%,1h
14197,1,RYAN,2689,78,3,3,6,50.0%,3m
14197,1,Joker,2689,91,2,0,2,100.0%,19m
14197,3,[沙漠谐星]烈焰远征,2689,0,2,0,2,100.0%,1h
14197,1,路过,2689,46,1,6,7,14.3%,1h
14214,3,胖胖啊,2688,1574,420,396,816,51.5%,3m
14214,2,祈祷她被温柔所爱,2688,1433,69,68,137,50.4%,16m
14214,1,阿呆傻狗,2688,730,53,46,99,53.5%,54m
14214,3,奉先,2688,692,42,27,69,60.9%,32m
14214,1,浪波涛,2688,853,35,27,62,56.5%,28m
14214,1,手慢的笨比,2688,245,29,1,30,96.7%,13m
14214,1,valian,2688,442,29,19,48,60.4%,24m
14214,1,IIIIIIIIIIII,2688,367,15,9,24,62.5%,19m
14214,3,Dcring,2688,329,13,8,21,61.9%,5m
14214,1,[时光与酒oc]吉姆雷诺,2688,253,8,4,12,66.7%,33m
14214,2,阿喀硫斯,2688,0,4,2,6,66.7%,18m
14214,1,[泰坦星养老院]匆匆那年,2688,103,3,1,4,75.0%,1h
14214,1,好汉请打我同桌,2688,141,3,5,8,37.5%,1h
14214,2,cxkong,2688,134,2,2,4,50.0%,46m
14214,1,醉卧美人膝,2688,38,2,2,4,50.0%,1h
14214,3,doinB,2688,0,2,3,5,40.0%,1h
14214,3,Crazyzerg,2688,0,2,3,5,40.0%,41m
14214,3,寒霜誓言,2688,0,2,3,5,40.0%,1h
14214,1,[zdfs]宇轩灬皇,2688,30,1,1,2,50.0%,1h
14214,2,[基佬协会]叶梓痕,2688,0,1,1,2,50.0%,37m
14214,3,温酒斩华佗,2688,97,1,2,3,33.3%,24m
14214,1,丝瓜,2688,34,1,3,4,25.0%,49m
14214,1,[小鸡屠宰场]DragonHeart,2688,0,0,2,2,0.0%,25m
14237,3,妹妹来一发,2687,1506,274,280,554,49.5%,18m
14237,3,跌倒的小猪,2687,507,22,19,41,53.7%,7m
14237,3,[上帝之首]chzzir,2687,271,10,9,19,52.6%,10m
14237,1,人渣的本愿,2687,188,10,11,21,47.6%,38m
14237,3,咸味木洛,2687,273,10,12,22,45.5%,1h
14237,1,Money,2687,179,7,2,9,77.8%,15m
14237,3,摸鱼天王稀神探女,2687,121,3,1,4,75.0%,53m
14237,1,[梦乃栞]星空贝壳,2687,38,2,2,4,50.0%,1h
14237,1,xzlqz,2687,0,1,0,1,100.0%,49m
14237,1,第一次玩,2687,0,0,1,1,0.0%,4m
14247,1,[造物主的荣光]卡泽拉斯,2686,1128,54,43,97,55.7%,1h
14247,3,宝宝,2686,1003,42,36,78,53.8%,9m
14247,2,GsAyls,2686,1090,39,43,82,47.6%,4m
14247,2,孙悟空,2686,149,27,40,67,40.3%,30m
14247,2,退役熬夜员,2686,659,25,32,57,43.9%,12m
14247,3,墨嬴,2686,249,8,3,11,72.7%,1h
14247,1,路人甲,2686,126,3,1,4,75.0%,13m
14247,1,Rosa,2686,121,3,1,4,75.0%,1h
14247,1,东方求败,2686,82,3,2,5,60.0%,10m
14247,1,[浪啊浪]苞米地里的黑寡妇,2686,78,3,3,6,50.0%,1h
14247,2,[小鸡屠宰场7]勇者,2686,32,2,0,2,100.0%,37m
14247,3,我呐喊啊啊,2686,0,2,2,4,50.0%,1h
14247,1,Volcano,2686,74,2,3,5,40.0%,25m
14247,3,grsgsrgs,2686,0,1,0,1,100.0%,1h
14247,1,Occido,2686,0,0,2,2,0.0%,1h
14262,1,叮叮当当,2685,1384,58,50,108,53.7%,27m
14262,1,小探机,2685,1035,44,38,82,53.7%,19m
14262,1,MinkyX,2685,480,20,10,30,66.7%,43m
14262,1,ragnarok,2685,298,10,10,20,50.0%,12m
14262,1,冬雨冬雨不下雨,2685,211,6,4,10,60.0%,36m
14262,3,[幽冥之狼]anderson,2685,152,6,12,18,33.3%,59m
14262,1,Briarecs,2685,139,3,2,5,60.0%,25m
14262,1,han,2685,88,2,0,2,100.0%,18m
14262,1,[N0D兄弟会]核子井,2685,0,0,1,1,0.0%,24m
14262,1,PerterVv,2685,0,0,1,1,0.0%,24m
14272,1,臭脚丫子,2684,1618,186,186,372,50.0%,43m
14272,3,一天一夜,2684,927,138,126,264,52.3%,7m
14272,1,清华,2684,1692,108,101,209,51.7%,26m
14272,1,[CPT]吃牛排住大豪宅,2684,1632,107,92,199,53.8%,13m
14272,2,hgg,2684,1317,73,71,144,50.7%,4m
14272,2,[人人有功炼]tiantian,2684,479,73,80,153,47.7%,26m
14272,1,LastAngle,2684,786,40,35,75,53.3%,10m
14272,1,[CPT]赤子之心,2684,784,35,28,63,55.6%,15m
14272,3,这小伙子很帅,2684,768,34,34,68,50.0%,7m
14272,1,真理与和谐,2684,790,31,30,61,50.8%,3m
14272,3,汤圆,2684,749,30,29,59,50.8%,7m
14272,1,[就会一招]Endless,2684,827,28,28,56,50.0%,25m
14272,3,克里斯文,2684,170,8,9,17,47.1%,1h
14272,2,GXL,2684,162,6,4,10,60.0%,51m
14272,1,[UNN摄像组]十六酱,2684,127,5,0,5,100.0%,13m
14272,2,[单推]sounds,2684,133,5,5,10,50.0%,1h
14272,1,[白给不要钱]yyy,2684,91,2,0,2,100.0%,1h
14272,1,[天意不可违]穆雅,2684,36,2,1,3,66.7%,38m
14272,3,IIIIIIIIIIII,2684,0,2,2,4,50.0%,47m
14272,3,EVAknight,2684,0,2,3,5,40.0%,1h
14272,1,[TCP]Lupo,2684,0,1,1,2,50.0%,26m
14272,3,生日,2684,0,1,1,2,50.0%,1h
14272,3,川耀机械工程部队,2684,0,1,3,4,25.0%,1h
14272,1,SeRral,2684,0,0,1,1,0.0%,27m
14272,1,[达拉姆毒爆]旋风叉一键山雏,2684,0,0,2,2,0.0%,2m
14297,2,[CNB]无色十二月,2683,1145,89,94,183,48.6%,12m
14297,1,[cestla]吉原哀歌,2683,967,41,31,72,56.9%,17m
14297,1,淡雅儒风,2683,503,22,18,40,55.0%,28m
14297,3,[湖面倒影]鉄柱大魔王,2683,147,20,14,34,58.8%,58m
14297,1,喜欢你波,2683,410,17,7,24,70.8%,49m
14297,1,[Fear]电脑,2683,394,17,8,25,68.0%,27m
14297,1,[玄門]dydsg,2683,416,16,12,28,57.1%,49m
14297,2,[呀哈哈]sherlock,2683,95,5,2,7,71.4%,1h
14297,1,清纯小女生,2683,189,5,4,9,55.6%,1h
14297,2,黑翼,2683,154,5,6,11,45.5%,39m
14297,1,智障也有春天,2683,137,4,1,5,80.0%,10m
14297,1,ohyes,2683,94,3,3,6,50.0%,25m
14297,2,ToT,2683,158,3,3,6,50.0%,27m
14297,3,光之逝影,2683,92,3,11,14,21.4%,8m
14297,1,asdsa,2683,102,2,1,3,66.7%,17m
14297,1,皮英霸,2683,34,2,1,3,66.7%,1h
14297,1,stanis,2683,0,1,0,1,100.0%,19m
14297,1,[无须奉天]曦之神话,2683,46,1,2,3,33.3%,1h
14297,2,[润羽露西亚]泠鸢,2683,44,1,3,4,25.0%,1h
14297,1,艾斯乐瑞,2683,0,0,2,2,0.0%,1h
14297,1,heyang,2683,0,0,3,3,0.0%,3m
14318,2,汐下,2682,890,171,164,335,51.0%,3m
14318,3,PROTOSS,2682,1535,85,76,161,52.8%,58m
14318,2,[ZZYZSC]神秘博士,2682,1055,42,52,94,44.7%,4m
14318,1,[和风]Wtasqr,2682,495,26,37,63,41.3%,9m
14318,1,[莽夫苟熊]shiroe,2682,248,8,10,18,44.4%,18m
14318,1,black,2682,132,5,4,9,55.6%,2m
14318,1,马晓壮,2682,38,2,1,3,66.7%,49m
14318,3,重生丨抠脚帝王,2682,0,2,3,5,40.0%,58m
14318,3,toobemore,2682,0,2,3,5,40.0%,1h
14318,3,蓝色风暴,2682,0,2,3,5,40.0%,14m
14318,3,快来救我豪哥,2682,0,2,3,5,40.0%,1h
14318,1,DRAVEN,2682,76,2,4,6,33.3%,1h
14318,3,[Leaves]凯撒大帝,2682,30,1,7,8,12.5%,58m
14331,2,qqoooon,2681,1273,185,181,366,50.5%,26m
14331,1,萌新,2681,1603,92,78,170,54.1%,25m
14331,3,ZJC,2681,1304,82,84,166,49.4%,5m
14331,3,[衣钵之卫]看有灰机,2681,703,47,33,80,58.8%,7m
14331,1,莲丶阿修贝尔,2681,302,27,18,45,60.0%,57m
14331,1,宇飞,2681,496,15,16,31,48.4%,38m
14331,3,[HYsc]SHTossBoy,2681,333,13,10,23,56.5%,58m
14331,1,爱丽丝神皇,2681,254,11,6,17,64.7%,26m
14331,1,[这种事无所谓]土享文,2681,250,7,8,15,46.7%,1h
14331,2,冰霜之森,2681,129,5,6,11,45.5%,1h
14331,1,[我即是霸主]航母已经抵达,2681,102,3,0,3,100.0%,1h
14331,2,惜萍,2681,0,3,3,6,50.0%,1h
14331,1,寒沙折羽,2681,48,2,3,5,40.0%,1h
14331,3,周神,2681,0,2,3,5,40.0%,1h
14331,3,骑士,2681,0,2,4,6,33.3%,1h
14331,1,fish,2681,122,2,5,7,28.6%,27m
14331,3,流丶浪星之海,2681,0,1,0,1,100.0%,49m
14331,2,[第一国际]苏维埃太空军,2681,0,1,0,1,100.0%,1h
14331,1,[Epochs]远山咲,2681,0,1,1,2,50.0%,24m
14331,1,[苏联红军]魔法之侏儒,2681,96,1,2,3,33.3%,18m
14331,1,suibian,2681,0,0,1,1,0.0%,12m
14331,1,光棱坦克,2681,0,0,3,3,0.0%,3m
14353,1,[GD地狱伞兵]铁甲威龙,2680,1302,56,55,111,50.5%,18m
14353,1,[疯月]亡灵灬序曲,2680,845,30,27,57,52.6%,1h
14353,3,白门楼工程建造师,2680,439,26,25,51,51.0%,58m
14353,3,Person,2680,584,20,27,47,42.6%,19m
14353,1,落叶飞翔,2680,424,14,13,27,51.9%,1h
14353,3,SlayerXiapei,2680,354,13,19,32,40.6%,32m
14353,1,小小杰尼,2680,224,11,3,14,78.6%,17m
14353,1,郎情妾意,2680,368,10,7,17,58.8%,1h
14353,1,imback,2680,300,9,6,15,60.0%,1h
14353,2,QuietBoy,2680,216,7,7,14,50.0%,1h
14353,1,TOTORO,2680,146,5,5,10,50.0%,1h
14353,3,[Rexel]nor,2680,160,5,6,11,45.5%,5m
14353,3,baoxueaA,2680,0,2,3,5,40.0%,43m
14353,1,[SHENK]哈国飞,2680,0,0,1,1,0.0%,17m
14353,1,北卡罗来纳,2680,0,0,1,1,0.0%,1h
14353,3,[北极光小组]雷诺的游击队,2680,0,0,2,2,0.0%,1h
14353,1,忧伤,2680,0,0,3,3,0.0%,19m
14370,1,[意外之外]TTTTT,2679,633,37,4,41,90.2%,10m
14370,1,BLeeeee,2679,975,36,42,78,46.2%,22m
14370,1,[低调且自信]绝望的死水,2679,488,35,23,58,60.3%,1h
14370,1,[0D]bestfvcker,2679,455,19,11,30,63.3%,1h
14370,1,我好菜啊,2679,440,18,14,32,56.2%,19m
14370,1,[21CM]古城秋,2679,296,11,6,17,64.7%,10m
14370,1,[大爱EMT]森下下士,2679,214,8,2,10,80.0%,28m
14370,1,avota,2679,256,8,7,15,53.3%,1h
14370,3,BiancaSofia,2679,198,7,13,20,35.0%,4m
14370,2,巨屁泚响,2679,220,7,18,25,28.0%,12m
14370,1,Vibe,2679,161,5,2,7,71.4%,1h
14370,3,王大人,2679,0,5,4,9,55.6%,57m
14370,2,[虚无]野蛮开拓者,2679,0,4,4,8,50.0%,51m
14370,3,活在异界的田园猫,2679,123,3,3,6,50.0%,1h
14370,3,霸霸,2679,0,2,3,5,40.0%,1h
14370,1,[彼岸鸽友会]yukikaze,2679,70,2,4,6,33.3%,1h
14370,3,萧克明,2679,0,1,1,2,50.0%,1h
14370,1,[盲人协会]仲夏之夜,2679,0,1,1,2,50.0%,1h
14370,1,[星绘]ZIKW,2679,0,1,2,3,33.3%,26m
14370,3,TaeJa,2679,0,0,6,6,0.0%,14m
14390,3,陌路独行者,2678,968,41,45,86,47.7%,23m
14390,2,Historia,2678,610,24,33,57,42.1%,33m
14390,1,[极限菜鸟]梦无形心相伴,2678,513,19,15,34,55.9%,49m
14390,3,喝辣哥,2678,352,12,16,28,42.9%,4m
14390,3,[NLHR]星法,2678,187,7,10,17,41.2%,34m
14390,3,劈波彡斩浪,2678,157,6,4,10,60.0%,29m
14390,1,[安技科]Moody,2678,220,6,8,14,42.9%,28m
14390,1,来打我啊,2678,146,5,4,9,55.6%,57m
14390,1,爱抚玖喵,2678,62,3,2,5,60.0%,1h
14390,3,冰无小雪,2678,97,3,3,6,50.0%,1h
14390,3,MRJOKE,2678,0,2,1,3,66.7%,1h
14390,1,[KAH]Hanson,2678,38,2,1,3,66.7%,1h
14390,3,zht,2678,0,2,3,5,40.0%,1h
14390,3,Cosmos,2678,0,2,3,5,40.0%,19m
14390,1,[往后稍稍]病气帕邱莉,2678,0,1,0,1,100.0%,1h
14390,1,甜甜的花生米,2678,0,1,0,1,100.0%,13m
14390,1,KTFlash,2678,0,1,0,1,100.0%,26m
14390,1,axio,2678,0,0,1,1,0.0%,54m
14408,1,north,2677,1636,68,65,133,51.1%,26m
14408,1,努尔哈赤校长,2677,613,58,51,109,53.2%,54m
14408,2,李狗嗨,2677,591,34,36,70,48.6%,12m
14408,1,[五月花]zest,2677,652,20,20,40,50.0%,10m
14408,3,[文丑之考验]张小白,2677,414,18,13,31,58.1%,2m
14408,1,飞翔的荷兰人,2677,356,11,9,20,55.0%,1h
14408,1,火域龙神,2677,132,8,6,14,57.1%,1h
14408,1,[社交学教员]枫落,2677,218,6,4,10,60.0%,4m
14408,1,jihaoran,2677,134,5,4,9,55.6%,25m
14408,1,宫吧老哥狂喜,2677,74,3,2,5,60.0%,1h
14408,3,云端之上,2677,36,3,4,7,42.9%,47m
14408,2,雷霆出击,2677,0,3,4,7,42.9%,27m
14408,1,[暴雪二十一队]lcy,2677,88,2,0,2,100.0%,18m
14408,3,晚上吃啥,2677,0,2,3,5,40.0%,49m
14408,3,lovexixi,2677,0,2,3,5,40.0%,1h
14408,1,东瘟疫大蛆蛆,2677,78,2,4,6,33.3%,33m
14408,3,软泥怪,2677,0,1,1,2,50.0%,1h
14408,1,神丶讷,2677,0,0,1,1,0.0%,4m
14408,3,瞧瞧俏巧乔,2677,0,0,1,1,0.0%,1h
14408,3,[DX战队]KINGBHZX,2677,0,0,1,1,0.0%,1h
14408,3,Reese,2677,0,0,1,1,0.0%,50m
14408,1,[藤林杏]willwon,2677,0,0,2,2,0.0%,19m
14430,3,脑子进水,2676,1099,219,205,424,51.7%,32m
14430,3,小黄小黄,2676,1076,83,79,162,51.2%,4m
14430,1,稚名真白,2676,617,36,33,69,52.2%,34m
14430,1,[PUMC]Acancer,2676,952,36,36,72,50.0%,26m
14430,1,莫言无悔,2676,767,27,27,54,50.0%,1h
14430,3,TrIO,2676,483,23,20,43,53.5%,19m
14430,3,静哥大魔王,2676,332,13,6,19,68.4%,1h
14430,1,电脑,2676,276,12,3,15,80.0%,48m
14430,2,[诺娃小姐姐]路过的假面骑士,2676,153,5,0,5,100.0%,51m
14430,2,年轻人耗子喂汁,2676,135,4,6,10,40.0%,39m
14430,2,HelloSC,2676,92,3,5,8,37.5%,43m
14430,1,IIIIIIIII,2676,0,2,3,5,40.0%,1h
14430,3,陶棠,2676,0,2,3,5,40.0%,22m
14430,3,[德国骨科医院]小奇,2676,97,2,4,6,33.3%,15m
14430,1,Arrow,2676,38,2,4,6,33.3%,10m
14430,1,[嘤qwq]FGdoubi,2676,0,1,0,1,100.0%,1h
14430,1,鑫晗,2676,0,1,0,1,100.0%,10m
14430,1,兰娜尔,2676,0,0,1,1,0.0%,1h
14448,3,[基尼太美]柠檬怪兽,2675,1431,66,64,130,50.8%,32m
14448,1,沃德吉尔贼长,2675,632,29,22,51,56.9%,1h
14448,1,无招胜有招,2675,719,28,23,51,54.9%,25m
14448,1,[硬骨头会所]安稳度余生,2675,804,28,24,52,53.8%,1h
14448,1,YUKINO,2675,724,24,22,46,52.2%,13m
14448,1,Raylee,2675,579,24,23,47,51.1%,26m
14448,1,aswcd,2675,291,12,13,25,48.0%,10m
14448,1,RosingRAIN,2675,260,8,6,14,57.1%,17m
14448,3,知足常乐贴近生活,2675,177,7,12,19,36.8%,9m
14448,2,萝莉控,2675,194,7,14,21,33.3%,27m
14448,2,多普勒频移,2675,156,5,5,10,50.0%,7m
14448,1,[神龍鬥士]九九天,2675,145,5,7,12,41.7%,32m
14448,3,[残雪映月]小聂,2675,0,4,2,6,66.7%,54m
14448,1,[社交学大可爱]所谓的傲娇,2675,103,3,0,3,100.0%,26m
14448,1,[一剑倾国]本条二亚,2675,49,3,2,5,60.0%,1h
14448,1,简单电脑,2675,88,2,0,2,100.0%,13m
14448,1,[風林火山]chineseidiot,2675,88,1,1,2,50.0%,19m
14448,1,[四叶草]树人,2675,88,1,1,2,50.0%,24m
14448,1,[云起]Paladin,2675,94,1,2,3,33.3%,22m
14448,3,黎九,2675,0,0,1,1,0.0%,24m
14448,1,aawd,2675,0,0,2,2,0.0%,1h
14448,1,黑毛黑死你,2675,0,0,3,3,0.0%,1h
14470,3,城中村摩的佬,2674,894,289,286,575,50.3%,19m
14470,1,迷路的探姬,2674,1613,188,179,367,51.2%,1h
14470,3,月亮不睡我不睡,2674,1559,128,126,254,50.4%,57m
14470,1,剹弑,2674,1506,82,73,155,52.9%,43m
14470,1,[星际联盟军团]天龙,2674,940,36,32,68,52.9%,15m
14470,1,GENEK,2674,475,22,21,43,51.2%,49m
14470,1,星空碎片,2674,240,17,9,26,65.4%,25m
14470,1,四五是块钢板,2674,208,8,6,14,57.1%,27m
14470,1,shadowspirit,2674,257,7,6,13,53.8%,4m
14470,1,[KPG2]国服路人笑,2674,225,5,6,11,45.5%,10m
14470,1,何不入我神教,2674,140,5,7,12,41.7%,46m
14470,1,竹风,2674,97,4,6,10,40.0%,40m
14470,1,[Hdl]WSHYBB,2674,64,3,3,6,50.0%,33m
14470,3,[某不知名鸡场]我的心,2674,97,3,3,6,50.0%,40m
14470,1,Kenlence,2674,106,3,4,7,42.9%,10m
14470,1,欣然木糖,2674,76,3,5,8,37.5%,1h
14470,1,芭比污,2674,30,2,1,3,66.7%,1h
14470,1,[小鸡子娃]Leovain,2674,32,2,2,4,50.0%,34m
14470,3,[M8]乏味的世界,2674,0,2,3,5,40.0%,1h
14470,1,[童话小镇]没兴奋剂的枪兵,2674,0,1,0,1,100.0%,1h
14470,3,awfawerf,2674,36,1,1,2,50.0%,59m
14470,1,撵廿碾,2674,0,1,1,2,50.0%,3m
14470,1,凌幽,2674,0,0,1,1,0.0%,1h
14470,1,smurfs,2674,0,0,1,1,0.0%,48m
14470,3,[kirara]DreDiki,2674,0,0,5,5,0.0%,4m
14495,3,[白门楼拆迁组]好奇,2673,1561,111,108,219,50.7%,3m
14495,3,摇滚的猪,2673,849,81,68,149,54.4%,58m
14495,3,白给真善美,2673,144,64,56,120,53.3%,4m
14495,2,listenlovecn,2673,978,61,65,126,48.4%,16m
14495,1,庄严的执法者,2673,610,22,32,54,40.7%,8m
14495,3,koslk,2673,572,21,28,49,42.9%,7m
14495,3,[YANGLI]也霸天下,2673,295,11,12,23,47.8%,10m
14495,1,[极品二五仔]孙一峰,2673,248,10,7,17,58.8%,38m
14495,1,源静香西斯卡酱,2673,245,9,5,14,64.3%,1h
14495,1,[Rhusky]TerranUmaru,2673,206,8,7,15,53.3%,1h
14495,1,YesnO,2673,249,6,6,12,50.0%,25m
14495,1,龙萨,2673,122,5,3,8,62.5%,24m
14495,1,会钓鱼的猫昕,2673,157,4,2,6,66.7%,1h
14495,2,派诺塔,2673,0,4,2,6,66.7%,53m
14495,3,[星际养老院]睡美人的铜锣烧,2673,40,3,4,7,42.9%,8m
14495,2,[咕咕协会]咕咕啊咕咕,2673,94,3,5,8,37.5%,1h
14495,1,Storm,2673,40,2,3,5,40.0%,57m
14495,3,小可爱咪咪,2673,0,2,3,5,40.0%,1h
14495,3,极北之地,2673,0,2,3,5,40.0%,22m
14495,3,lxy,2673,0,2,3,5,40.0%,1h
14495,1,Flay,2673,94,1,1,2,50.0%,24m
14495,2,AAApoq,2673,44,1,3,4,25.0%,37m
14495,1,[王者家族]农工党,2673,0,0,1,1,0.0%,19m
14495,3,盲僧,2673,0,0,1,1,0.0%,7m
14519,1,弹幕永恒,2672,1359,52,44,96,54.2%,1h
14519,3,[逗比神教]盖欧卡,2672,555,27,15,42,64.3%,5m
14519,1,[xy饲料厂]鸟哥的小迷妹,2672,667,27,22,49,55.1%,17m
14519,3,女中豪杰,2672,488,24,13,37,64.9%,3m
14519,1,汤达人,2672,480,16,13,29,55.2%,57m
14519,1,拉萨拉拉,2672,259,14,2,16,87.5%,1h
14519,2,[花妈真可爱]KaguyaOwO,2672,132,4,5,9,44.4%,1h
14519,3,焦糖玛奇玛,2672,0,3,2,5,60.0%,1h
14519,2,萌新找师傅,2672,115,2,1,3,66.7%,1h
14519,3,酌酒琴歌,2672,0,2,3,5,40.0%,47m
14519,2,[火猫哥斯拉]我类个去,2672,0,2,5,7,28.6%,1h
14519,1,qxy,2672,145,2,5,7,28.6%,1h
14519,1,moocanono,2672,0,0,1,1,0.0%,33m
14519,1,就是各菜鸟,2672,0,0,2,2,0.0%,34m
14519,2,Alex,2672,0,0,2,2,0.0%,1h
14534,1,我要瓦斯,2671,1603,264,276,540,48.9%,19m
14534,1,[KPG2]lybbbbb,2671,1363,54,41,95,56.8%,48m
14534,3,快乐之足,2671,1171,45,48,93,48.4%,23m
14534,1,[miku守护]ScarLeet,2671,462,18,10,28,64.3%,38m
14534,1,琉璃雪,2671,278,11,9,20,55.0%,38m
14534,1,[昆明RANK]一个比较浪漫的人,2671,345,11,13,24,45.8%,1h
14534,3,[天空之怒]BORN,2671,302,11,16,27,40.7%,13m
14534,3,[旅店永远开着]炸服,2671,154,10,15,25,40.0%,16m
14534,1,[BJCN]开心就好,2671,302,9,11,20,45.0%,33m
14534,1,[氵艾泽拉斯]adadsdada,2671,281,8,8,16,50.0%,3m
14534,1,希航霸,2671,0,1,1,2,50.0%,1h
14534,3,[铃仙二号]望月,2671,0,1,2,3,33.3%,1h
14534,1,[枪兵二营]比那名居莉莉娅,2671,73,1,2,3,33.3%,1h
14534,3,EterniTY,2671,0,1,2,3,33.3%,41m
14534,2,Agsky,2671,0,1,6,7,14.3%,11m
14534,3,hljli,2671,0,0,1,1,0.0%,58m
14550,3,黑大帅,2670,1004,47,49,96,49.0%,16m
14550,1,[我菜请打队友]懒猫,2670,868,36,33,69,52.2%,1h
14550,1,丛羽,2670,750,34,22,56,60.7%,1h
14550,3,好名字真难起,2670,256,17,21,38,44.7%,8m
14550,1,llllllllllll,2670,213,7,4,11,63.6%,1h
14550,2,[武德教学学校]猪肉不肥只是受,2670,190,7,6,13,53.8%,1h
14550,1,断迷,2670,211,6,4,10,60.0%,43m
14550,1,[大帝重工]楪祈,2670,150,5,2,7,71.4%,49m
14550,1,[VLK]幽灵,2670,189,5,4,9,55.6%,1h
14550,2,[星歌]Eternity,2670,153,5,6,11,45.5%,26m
14550,1,二傻兔子,2670,210,5,8,13,38.5%,57m
14550,1,[SCgay]jckeliu,2670,132,4,5,9,44.4%,19m
14550,3,不见长安,2670,0,3,2,5,60.0%,33m
14550,3,右右,2670,38,3,3,6,50.0%,43m
14550,1,小猴子,2670,104,2,1,3,66.7%,10m
14550,3,科普卢第一莽夫,2670,40,2,1,3,66.7%,1h
14550,1,一招鲜,2670,36,2,2,4,50.0%,26m
14550,3,软珍二十一块,2670,0,2,3,5,40.0%,1h
14550,1,卑鄙的我,2670,68,2,5,7,28.6%,1h
14550,3,中华老咸鱼,2670,0,1,0,1,100.0%,1h
14550,1,YuongMan,2670,0,1,1,2,50.0%,1h
14550,1,幽灵殿下,2670,38,1,3,4,25.0%,3m
14572,2,[小蝶]keer,2669,268,11,16,27,40.7%,30m
14572,3,xtwf,2669,203,7,10,17,41.2%,1h
14572,3,[Pt小贴士]PuPuLAHa,2669,191,7,13,20,35.0%,29m
14572,3,我是你九哥,2669,0,4,1,5,80.0%,1h
14572,3,那一瞬丶刹那繁华,2669,0,3,2,5,60.0%,15m
14572,3,随便啦,2669,0,2,3,5,40.0%,49m
14572,1,[Rhusky]viva,2669,0,2,4,6,33.3%,1h
14572,1,[惠妻知我]普残遇疯子就退,2669,36,1,2,3,33.3%,4m
14572,1,回忆娟娟,2669,34,1,3,4,25.0%,38m
14572,3,[为了菲女王]滚动的虫苔,2669,0,0,1,1,0.0%,5m
14582,3,丰子鹿,2668,756,64,65,129,49.6%,13m
14582,1,[幽明异路]yzz,2668,954,38,30,68,55.9%,13m
14582,1,主啊赞美你,2668,933,35,31,66,53.0%,1h
14582,1,[七宫智音]艾尔之霜,2668,595,22,17,39,56.4%,1h
14582,1,firstblood,2668,510,20,15,35,57.1%,48m
14582,2,[DGL丿茗门]Misaki,2668,430,15,20,35,42.9%,3m
14582,2,WZT,2668,155,7,8,15,46.7%,1h
14582,3,执政,2668,187,7,9,16,43.8%,7m
14582,1,jjiiijiijjj,2668,158,6,1,7,85.7%,19m
14582,2,Faith,2668,46,4,5,9,44.4%,51m
14582,2,cloud,2668,128,4,5,9,44.4%,1h
14582,3,柿兵突击,2668,0,3,2,5,60.0%,1h
14582,1,zzzzz,2668,140,3,2,5,60.0%,46m
14582,2,[各种小蛋糕]LightsZod,2668,0,3,5,8,37.5%,13m
14582,3,[KZFANS]Wolfkisser,2668,0,2,3,5,40.0%,1h
14582,3,[萝莉控丶]空瞳,2668,0,2,3,5,40.0%,1h
14582,1,[暴雪十三队]littledog,2668,42,2,5,7,28.6%,1h
14582,2,长歌,2668,0,1,1,2,50.0%,53m
14582,1,IIIIIIII,2668,0,1,1,2,50.0%,26m
14582,1,Mistake,2668,0,1,2,3,33.3%,34m
14582,3,[25CM]浪迹孤狼,2668,0,1,2,3,33.3%,15m
14582,3,[歌者]Steven,2668,38,1,6,7,14.3%,1h
14582,1,[怎么脏怎么来]谈少,2668,0,0,1,1,0.0%,60m
14605,1,妙妙海里的鸡,2667,1627,105,96,201,52.2%,28m
14605,3,弥生十二,2667,1509,86,78,164,52.4%,23m
14605,1,小川,2667,533,65,62,127,51.2%,28m
14605,1,彭立辉,2667,954,56,33,89,62.9%,20m
14605,1,超越者是作者权威,2667,50,48,55,103,46.6%,58m
14605,1,[要啥没啥爱咋]长安丶,2667,600,31,9,40,77.5%,10m
14605,1,生人不要尾随,2667,700,26,23,49,53.1%,1h
14605,1,[教我玩神族]叉叉对空怎么输,2667,532,19,17,36,52.8%,1h
14605,2,萨迦西罗之剑,2667,250,10,1,11,90.9%,48m
14605,1,EWFIYF,2667,148,8,3,11,72.7%,1h
14605,1,学姐家的零二酱,2667,258,8,8,16,50.0%,1h
14605,1,IIIIIIIIIII,2667,173,5,1,6,83.3%,1h
14605,1,benben,2667,88,2,0,2,100.0%,19m
14605,3,sdsd,2667,97,2,4,6,33.3%,1h
14619,3,那个啥棒槌,2666,1382,88,78,166,53.0%,30m
14619,3,qqtyjt,2666,1309,69,65,134,51.5%,10m
14619,1,队长哈哈哈,2666,293,45,33,78,57.7%,1h
14619,1,aurelien,2666,1143,44,42,86,51.2%,1h
14619,2,[衡水中学]飞氘,2666,900,38,23,61,62.3%,1h
14619,1,zoeyqaq,2666,814,28,29,57,49.1%,1h
14619,3,八九年生人,2666,201,11,17,28,39.3%,59m
14619,2,LiWeQin,2666,266,9,3,12,75.0%,1h
14619,1,东契奇,2666,175,4,4,8,50.0%,28m
14619,1,大叔玩星际,2666,105,3,1,4,75.0%,1h
14619,1,[其徐如风]体温三十八度,2666,74,3,3,6,50.0%,15m
14619,3,[谐星新生代]双星,2666,92,3,11,14,21.4%,9m
14619,2,[黎明前线]苯上人,2666,44,2,1,3,66.7%,30m
14619,3,[恶魔龙族]洲毅,2666,0,2,3,5,40.0%,1h
14619,1,暴风行动,2666,94,2,4,6,33.3%,1h
14619,2,王者来临飞虎,2666,0,1,0,1,100.0%,36m
14619,2,[最菜战队]一边甩飞龙一边哭,2666,0,1,0,1,100.0%,18m
14619,1,苍岚,2666,0,1,1,2,50.0%,1h
14619,1,Trileptal,2666,36,1,3,4,25.0%,1h
14619,3,[28CM]隐刀只狼,2666,0,0,1,1,0.0%,24m
14619,2,[猪猪大家庭]王子涛,2666,0,0,1,1,0.0%,29m
14619,3,Chimare,2666,0,0,1,1,0.0%,1h
14619,2,太极大师马问,2666,0,0,2,2,0.0%,49m
14619,2,赵鸿晔,2666,0,0,2,2,0.0%,59m
14643,2,smallegg,2665,1186,117,109,226,51.8%,3m
14643,3,毒狼,2665,1527,107,97,204,52.5%,15m
14643,1,kAWASAKI,2665,1532,73,56,129,56.6%,43m
14643,2,呆萌的妹抖,2665,897,61,57,118,51.7%,58m
14643,2,天涯人生,2665,1040,40,48,88,45.5%,29m
14643,1,[折磨星际]Iron,2665,705,39,28,67,58.2%,1h
14643,1,[我心有猛虎]梦是林下夕,2665,569,25,21,46,54.3%,1h
14643,1,[你好抱歉]MingSir,2665,547,24,17,41,58.5%,1h
14643,3,hamburgerKO,2665,427,23,22,45,51.1%,57m
14643,3,加菲猫来啦,2665,430,20,18,38,52.6%,26m
14643,1,超级菜鸟,2665,270,13,6,19,68.4%,26m
14643,3,背背背背起了行囊,2665,224,10,10,20,50.0%,23m
14643,2,[文韬武略]sdhftuwy,2665,255,9,3,12,75.0%,50m
14643,1,疾风光刃,2665,214,9,4,13,69.2%,1h
14643,1,Rdyle,2665,140,3,3,6,50.0%,48m
14643,1,RUBEN,2665,89,3,4,7,42.9%,10m
14643,2,奶糖,2665,94,3,4,7,42.9%,1h
14643,3,[建着玩儿]女王至上,2665,0,2,0,2,100.0%,1h
14643,3,[TCP]奶昔不存在,2665,0,2,1,3,66.7%,1h
14643,3,Lucky,2665,0,2,3,5,40.0%,1h
14643,3,Spike,2665,0,2,3,5,40.0%,1h
14643,3,对面傻,2665,0,2,3,5,40.0%,1h
14643,3,对此我很抱歉,2665,0,2,3,5,40.0%,1h
14643,1,SpritixEX,2665,0,1,1,2,50.0%,17m
14643,1,[GaGaga]匠人金,2665,0,1,3,4,25.0%,1h
14643,2,我要去伊朗,2665,0,0,1,1,0.0%,27m
14643,2,IIIIIIIIIIII,2665,0,0,1,1,0.0%,1h
14643,3,[太美]崎岖之行,2665,0,0,2,2,0.0%,1h
14671,1,[软萌甜小萝莉]观测者,2664,832,29,27,56,51.8%,1h
14671,3,苏仨偲,2664,498,19,18,37,51.4%,32m
14671,1,ONE,2664,437,15,14,29,51.7%,1h
14671,3,准风月谈,2664,397,14,14,28,50.0%,30m
14671,3,弗丁教主,2664,191,5,9,14,35.7%,6m
14671,3,[zmsdmm]微澜之间,2664,142,5,16,21,23.8%,57m
14671,3,芝麻果子,2664,0,4,1,5,80.0%,22m
14671,1,XavierWu,2664,70,3,2,5,60.0%,26m
14671,3,zyq,2664,38,3,4,7,42.9%,1h
14671,3,未然,2664,120,3,6,9,33.3%,31m
14671,1,[快星际乐]Taburiss,2664,40,2,2,4,50.0%,3m
14671,3,[faxide]哦卖咖的外设,2664,0,2,3,5,40.0%,1h
14671,3,[A丶rash]edouard,2664,0,2,4,6,33.3%,49m
14671,1,[此地虎牢关]落羽汐月,2664,0,1,0,1,100.0%,1h
14685,3,奈落之花,2663,1436,222,210,432,51.4%,9m
14685,3,WCCD,2663,823,95,76,171,55.6%,4m
14685,1,秋雨霏霏,2663,1011,67,80,147,45.6%,11m
14685,3,投降输一半,2663,1238,51,49,100,51.0%,19m
14685,1,Jay,2663,1089,46,34,80,57.5%,57m
14685,1,IIIIIIIIIIII,2663,856,35,31,66,53.0%,20m
14685,2,血色孤独,2663,801,35,40,75,46.7%,28m
14685,2,SmallBobo,2663,153,17,7,24,70.8%,54m
14685,1,我爱肥肥喜,2663,414,16,19,35,45.7%,15m
14685,2,[仕兰]Gungnir,2663,331,14,2,16,87.5%,1h
14685,2,[西伯利亚土豆]QAQ,2663,322,12,8,20,60.0%,1h
14685,3,MaruTakuNan,2663,274,11,17,28,39.3%,14m
14685,1,张大爷,2663,280,8,12,20,40.0%,1h
14685,1,小胖胖,2663,115,5,5,10,50.0%,1h
14685,1,南邮码王,2663,96,5,7,12,41.7%,1h
14685,2,[MUL]GuluCAT,2663,102,3,8,11,27.3%,25m
14685,3,icegeram,2663,90,3,11,14,21.4%,58m
14685,2,[你们都是渣]TYTY,2663,32,2,0,2,100.0%,26m
14685,2,Amadeus,2663,0,1,0,1,100.0%,49m
14685,1,zzzzx,2663,0,1,1,2,50.0%,38m
14685,3,[断牙超帅的啊]Optimusprime,2663,0,0,1,1,0.0%,1h
14685,1,[AKC]SIlence,2663,0,0,2,2,0.0%,13m
14707,1,Ipj,2662,1408,107,114,221,48.4%,29m
14707,1,qiaoshen,2662,257,19,10,29,65.5%,1h
14707,3,fenenzhanshe,2662,414,15,14,29,51.7%,19m
14707,3,WDDW,2662,228,12,14,26,46.2%,4m
14707,3,深田咏美,2662,362,11,16,27,40.7%,13m
14707,1,举杯饮风雪,2662,319,10,11,21,47.6%,10m
14707,3,Operation,2662,40,6,1,7,85.7%,22m
14707,2,[scbaby]CSCEC,2662,44,3,3,6,50.0%,1h
14707,2,[LED]qwas,2662,139,3,5,8,37.5%,51m
14707,3,Wind,2662,0,2,3,5,40.0%,54m
14707,1,[峰吹起了过去]Mitsuha,2662,34,2,3,5,40.0%,17m
14707,2,Kasumi,2662,138,2,4,6,33.3%,1h
14707,2,XYQ,2662,0,1,0,1,100.0%,1h
14707,3,[美少女萬華鏡]顶级萝莉控,2662,0,1,0,1,100.0%,1h
14707,1,[CnNami]阿萨德,2662,0,1,2,3,33.3%,1h
14707,3,[养生会馆]肆谑,2662,0,1,4,5,20.0%,1h
14707,2,[歌者II]时光,2662,0,0,1,1,0.0%,57m
14724,2,星际神坤,2661,1462,198,189,387,51.2%,15m
14724,2,lxfyc,2661,1252,68,59,127,53.5%,3m
14724,2,sorry,2661,1387,67,66,133,50.4%,27m
14724,1,Fenrisfult,2661,1179,50,48,98,51.0%,13m
14724,3,呆呆熊丶,2661,502,16,21,37,43.2%,16m
14724,3,[葬媛]莪嘚嬡沵芣慬,2661,237,15,6,21,71.4%,39m
14724,3,hideinheart,2661,184,10,12,22,45.5%,60m
14724,1,星火燎原丶,2661,220,8,5,13,61.5%,26m
14724,3,[黑萝卜后援队]YellowCarrot,2661,191,6,6,12,50.0%,1h
14724,2,游刃,2661,126,5,2,7,71.4%,54m
14724,1,[莫得感情的人]风逸,2661,186,5,8,13,38.5%,60m
14724,2,[浮世清欢]沉稳,2661,88,3,0,3,100.0%,1h
14724,2,镜鬼,2661,70,3,1,4,75.0%,38m
14724,3,Grasshopper,2661,0,3,3,6,50.0%,58m
14724,2,[星际新手上路]zjFromDark,2661,30,2,1,3,66.7%,1h
14724,3,way,2661,0,2,3,5,40.0%,50m
14724,1,没办法就是玩,2661,97,2,6,8,25.0%,1h
14724,1,[星尘十字军]绘时光的诗,2661,0,1,1,2,50.0%,1h
14724,2,[凤凰虚空一波]linguistic,2661,0,0,1,1,0.0%,19m
14724,2,探险家,2661,0,0,1,1,0.0%,54m
14744,1,河北屁王,2660,1585,167,157,324,51.5%,14m
14744,2,灰常神奇,2660,1572,165,158,323,51.1%,1h
14744,1,JasonTric,2660,1266,48,40,88,54.5%,1h
14744,3,老星际吃瓜了,2660,883,34,37,71,47.9%,6m
14744,1,[你已经死啦]可怜孩子在线虐人,2660,617,25,14,39,64.1%,1h
14744,1,[第一次玩]Nryu,2660,526,20,16,36,55.6%,1h
14744,1,再见送哈哪,2660,254,11,7,18,61.1%,36m
14744,3,拓铸只野,2660,235,9,11,20,45.0%,1h
14744,3,来日可期,2660,208,8,13,21,38.1%,9m
14744,2,[半夏]nevermore,2660,30,5,3,8,62.5%,1h
14744,1,SYY,2660,202,5,5,10,50.0%,1h
14744,2,emm,2660,157,5,5,10,50.0%,39m
14744,1,[Fisker]Layzhang,2660,166,5,6,11,45.5%,18m
14744,1,[欧佩克]鳄鱼,2660,94,5,8,13,38.5%,16m
14744,1,[星际彩笔]落尘,2660,90,2,1,3,66.7%,36m
14744,2,[czlp]苏大小达克,2660,30,2,1,3,66.7%,1h
14744,1,爱蜜,2660,74,2,4,6,33.3%,33m
14744,2,蜡笔没有小新,2660,0,1,0,1,100.0%,1h
14744,3,[東方幻月舞會]我的手速真的很慢,2660,0,1,0,1,100.0%,50m
14744,1,[虚空舰队]羊宝宝,2660,38,1,4,5,20.0%,10m
14744,2,新希望,2660,0,0,1,1,0.0%,1h
14744,1,星光灿烂,2660,0,0,4,4,0.0%,18m
14766,1,名字再吊也没用,2659,1559,89,67,156,57.1%,1h
14766,1,[华夏远征军]zeratul,2659,362,12,10,22,54.5%,38m
14766,3,李佳玉,2659,287,12,12,24,50.0%,25m
14766,1,白糖糖,2659,405,12,17,29,41.4%,38m
14766,1,[武神]斩炎,2659,302,10,15,25,40.0%,49m
14766,2,Dragon,2659,155,8,8,16,50.0%,1h
14766,3,冬冬枣,2659,185,7,0,7,100.0%,1h
14766,3,[星际马保国]黄旭东的爸爸,2659,206,5,8,13,38.5%,18m
14766,3,玛丽亚,2659,0,4,1,5,80.0%,1h
14766,2,JinAirsOs,2659,58,3,2,5,60.0%,11m
14766,1,飞龙在天,2659,38,2,2,4,50.0%,1h
14766,3,癫疯指挥官,2659,0,2,3,5,40.0%,1h
14766,2,undertaker,2659,0,1,0,1,100.0%,1h
14766,3,姜太公,2659,0,1,1,2,50.0%,1h
14766,1,[一个传染俩]唉哦挨翅噻,2659,32,1,2,3,33.3%,1h
14766,2,Worldismine,2659,0,0,1,1,0.0%,32m
14766,3,peien,2659,0,0,1,1,0.0%,1h
14783,2,Perfect,2658,1586,140,134,274,51.1%,27m
14783,2,鸠羽千夜,2658,1457,103,107,210,49.0%,8m
14783,1,Ziyuanw,2658,595,23,24,47,48.9%,1h
14783,1,[五月花]aaa,2658,578,22,23,45,48.9%,3m
14783,2,hhd,2658,308,13,13,26,50.0%,60m
14783,3,人肉叉烧包,2658,274,11,13,24,45.8%,1h
14783,2,[极限菜鸟]完美是一种奢侈品,2658,192,7,0,7,100.0%,50m
14783,2,[波次]鬼影,2658,182,5,11,16,31.2%,48m
14783,3,遭重了啊,2658,137,4,6,10,40.0%,31m
14783,3,[第三駆逐鑑隊]zzx,2658,0,3,2,5,60.0%,1h
14783,2,雪菜包子,2658,0,3,2,5,60.0%,60m
14783,1,shero,2658,135,3,4,7,42.9%,46m
14783,2,战灵,2658,64,2,1,3,66.7%,1h
14783,3,[暗之末裔]JangSh,2658,0,2,3,5,40.0%,47m
14783,3,[训练模式电脑]遇事不决希儿解决,2658,0,2,3,5,40.0%,1h
14783,3,killer,2658,0,2,3,5,40.0%,1h
14783,1,[loveMM]moyu,2658,34,2,4,6,33.3%,1h
14783,1,[孤傲就完事]大帅比琴酒,2658,0,2,5,7,28.6%,1h
14783,3,[鱼人永不败]泰迪,2658,0,1,0,1,100.0%,1h
14783,2,誓约咖喱棒,2658,0,1,0,1,100.0%,26m
14783,2,[PKMON]杰尼龟,2658,0,0,1,1,0.0%,30m
14804,1,[欧佩克]Hatzerim,2657,1489,84,67,151,55.6%,48m
14804,1,脑血栓玩家,2657,985,81,64,145,55.9%,28m
14804,3,[闪电伍连鞭]你伟大的爹,2657,1236,72,74,146,49.3%,10m
14804,1,不内战,2657,546,26,22,48,54.2%,34m
14804,1,ssds,2657,616,24,18,42,57.1%,38m
14804,1,[小鸡屠宰场2]倚仗天穹,2657,358,12,13,25,48.0%,1h
14804,3,我骑着涂宇明,2657,155,4,0,4,100.0%,1h
14804,1,你女良,2657,76,2,5,7,28.6%,17m
14804,2,VanDarkholm,2657,0,1,0,1,100.0%,1h
14804,2,[电脑黑屏]不能天使,2657,0,1,0,1,100.0%,38m
14804,3,绘崎可乐助,2657,0,0,1,1,0.0%,1h
14815,2,[大白护卫队]开小号必没妈,2656,1598,419,413,832,50.4%,10m
14815,3,青枫,2656,1516,88,80,168,52.4%,7m
14815,1,爱不了,2656,833,51,46,97,52.6%,1h
14815,1,自由之翼,2656,645,24,21,45,53.3%,1h
14815,3,[镜花水月丶]不会玩怎么办,2656,501,20,17,37,54.1%,3m
14815,1,Rikaa,2656,536,20,19,39,51.3%,15m
14815,2,HoLLoWSTRING,2656,360,13,7,20,65.0%,10m
14815,3,[虚拟歌手团体]Goldwatch,2656,320,11,17,28,39.3%,26m
14815,3,老村长丶,2656,175,6,3,9,66.7%,17m
14815,1,我和皇子都有巨龙,2656,174,5,8,13,38.5%,26m
14815,1,藕丝泥巴,2656,48,4,6,10,40.0%,1h
14815,1,dio,2656,46,4,7,11,36.4%,3m
14815,2,漆黑之帐,2656,115,3,1,4,75.0%,49m
14815,1,[火焰雷兽]烟雨,2656,105,3,1,4,75.0%,1h
14815,1,IIIIIIIIIIII,2656,136,3,4,7,42.9%,1h
14815,3,[MGnb]INnoVation,2656,0,2,2,4,50.0%,1h
14815,3,[不可视战线]时钟之眼倒流,2656,0,2,3,5,40.0%,1h
14815,3,酷毙了我的俊丿,2656,0,2,4,6,33.3%,60m
14815,3,QuitMing,2656,0,2,4,6,33.3%,1h
14815,2,artificial,2656,0,1,0,1,100.0%,18m
14815,2,枯叶飘零,2656,0,1,0,1,100.0%,1h
14815,2,[极限菜鸟]黑火骑士,2656,44,1,2,3,33.3%,1h
14815,2,[鲨鼻网鱿]鬼鬼,2656,0,0,1,1,0.0%,36m
14815,2,我爱昵,2656,0,0,1,1,0.0%,1h
14815,1,[1v1白给]武汉喵,2656,0,0,2,2,0.0%,26m
14840,2,ltaaa,2655,1557,182,180,362,50.3%,1h
14840,3,bbc,2655,1396,97,92,189,51.3%,23m
14840,1,灰灰,2655,1502,56,74,130,43.1%,58m
14840,2,别打我先打我队友,2655,954,34,45,79,43.0%,6m
14840,2,风中的火柴,2655,527,22,15,37,59.5%,1h
14840,1,[第六駆逐鑑隊]GGboy,2655,584,22,18,40,55.0%,3m
14840,1,量子泡沫,2655,412,18,10,28,64.3%,28m
14840,1,草船借东风,2655,404,12,11,23,52.2%,43m
14840,3,大哥永远是我大哥,2655,215,7,11,18,38.9%,26m
14840,3,[你已经死啦]SCP,2655,163,6,6,12,50.0%,13m
14840,1,guanyuantao,2655,0,5,4,9,55.6%,46m
14840,1,Tyrion,2655,130,5,7,12,41.7%,1h
14840,1,开始进行折磨,2655,151,3,4,7,42.9%,3m
14840,2,Spica,2655,93,3,4,7,42.9%,60m
14840,3,dad,2655,40,3,5,8,37.5%,19m
14840,2,[下饭食堂]Wkk,2655,96,2,0,2,100.0%,28m
14840,2,starwei,2655,44,2,2,4,50.0%,1h
14840,3,hduesdhue,2655,0,2,3,5,40.0%,22m
14840,2,擎天柱,2655,0,1,0,1,100.0%,1h
14840,1,freedom,2655,0,1,1,2,50.0%,1h
14840,3,coj,2655,0,1,4,5,20.0%,1h
14840,2,撞树的猪,2655,0,0,1,1,0.0%,57m
14840,2,IMclio,2655,0,0,1,1,0.0%,57m
14840,2,[你已经死啦]氯丙嗪,2655,0,0,1,1,0.0%,1h
14864,1,大主教阿塔腻斯,2654,564,27,9,36,75.0%,20m
14864,3,赫赫呵呵喝喝,2654,659,23,27,50,46.0%,4m
14864,1,野蛮人,2654,417,15,17,32,46.9%,19m
14864,2,朱彦卿,2654,180,7,4,11,63.6%,1h
14864,2,财鸟,2654,174,7,6,13,53.8%,1h
14864,1,逆回十六夜,2654,132,6,9,15,40.0%,1h
14864,1,SCORPION,2654,139,5,7,12,41.7%,1h
14864,2,SCPLAYER,2654,106,3,1,4,75.0%,45m
14864,1,[随便玩]東門吹水,2654,96,2,3,5,40.0%,1h
14864,2,阿牛,2654,0,1,0,1,100.0%,1h
14864,2,一骑红尘妃子笑,2654,0,1,0,1,100.0%,1h
14864,3,ziyueba,2654,0,1,4,5,20.0%,1h
14864,2,小追,2654,0,0,1,1,0.0%,1h
14864,1,BuringArice,2654,0,0,2,2,0.0%,3m
14878,3,RMB,2653,1084,91,68,159,57.2%,9m
14878,3,夜星辰,2653,1592,72,76,148,48.6%,28m
14878,1,[乳主头子]薇风见月,2653,1242,52,48,100,52.0%,18m
14878,3,wwwwwwwwwwww,2653,1144,43,43,86,50.0%,9m
14878,1,费莲诺艾尔,2653,487,31,23,54,57.4%,1h
14878,3,[抢矿小分队]芝士,2653,478,21,13,34,61.8%,3m
14878,3,存在亦是逝去,2653,348,14,18,32,43.8%,4m
14878,3,纸鸢,2653,334,11,14,25,44.0%,8m
14878,1,我是真的菜啊,2653,259,9,9,18,50.0%,5m
14878,3,zxc,2653,184,6,13,19,31.6%,4m
14878,2,Kazna,2653,120,5,2,7,71.4%,1h
14878,3,刺客信条,2653,121,5,3,8,62.5%,1h
14878,2,看向未来,2653,112,4,5,9,44.4%,51m
14878,1,宣教士,2653,144,4,8,12,33.3%,1h
14878,1,那是松鼠吗,2653,66,3,3,6,50.0%,34m
14878,2,Doragiaogiao,2653,32,1,1,2,50.0%,1h
14878,2,[影流之主劫]单色孤独,2653,0,0,1,1,0.0%,15m
14878,2,Lair,2653,0,0,1,1,0.0%,1h
14896,3,阿史那特勤,2652,1067,81,75,156,51.9%,30m
14896,1,[混元行医]蓝关钰梦,2652,404,16,11,27,59.3%,14m
14896,1,[残雪映月]Newplayer,2652,240,11,7,18,61.1%,50m
14896,1,[华科大]keepersecond,2652,319,11,11,22,50.0%,1h
14896,3,Youkodo,2652,144,8,11,19,42.1%,4m
14896,3,[诠释城市化]雪葬天国,2652,161,6,4,10,60.0%,1h
14896,2,[萌盟]我的卡拉有点萌,2652,106,4,2,6,66.7%,48m
14896,1,一睡方休,2652,188,4,7,11,36.4%,52m
14896,3,[妹子万岁]冥心,2652,97,3,3,6,50.0%,57m
14896,1,[C54456]RNG,2652,119,3,3,6,50.0%,9m
14896,2,倾城,2652,0,3,3,6,50.0%,1h
14896,1,打星际我只玩神族,2652,152,3,4,7,42.9%,57m
14896,2,老谭头儿,2652,93,2,3,5,40.0%,45m
14896,2,[古代毒瘤协会]洋洲泰,2652,0,1,0,1,100.0%,1h
14896,2,湛蓝之风,2652,0,1,0,1,100.0%,1h
14896,1,IIIllllIIIll,2652,88,1,2,3,33.3%,13m
14896,1,[梦幻之星ol]轻井泽惠,2652,46,1,4,5,20.0%,12m
14896,3,KateCatheri,2652,0,0,1,1,0.0%,1h
14914,1,达达,2651,1631,72,59,131,55.0%,1h
14914,3,FreudDereco,2651,1210,62,59,121,51.2%,29m
14914,2,不讲武德,2651,910,53,52,105,50.5%,26m
14914,1,sochralar,2651,500,20,14,34,58.8%,1h
14914,2,IIIIIIIIIIII,2651,248,10,3,13,76.9%,1h
14914,1,谐星耍星际,2651,366,10,13,23,43.5%,1h
14914,2,[DC战队]流云,2651,227,8,8,16,50.0%,1h
14914,3,[KPG2]李阳彬的克星,2651,223,8,11,19,42.1%,24m
14914,2,[Shawk]Sunny,2651,176,7,3,10,70.0%,1h
14914,1,Alex,2651,195,7,7,14,50.0%,1h
14914,1,[只想干神族]尼玛花园,2651,291,7,7,14,50.0%,1h
14914,1,袭胸龙抓手,2651,170,6,5,11,54.5%,26m
14914,2,[GoTG]兵临城下之崛起,2651,141,5,5,10,50.0%,45m
14914,2,Innocence,2651,128,3,5,8,37.5%,45m
14914,2,蜡笔小新蜡笔画,2651,30,2,0,2,100.0%,15m
14914,1,无极,2651,103,2,2,4,50.0%,1h
14914,2,Mox,2651,30,1,1,2,50.0%,54m
14914,2,[白斩鸡]Tam,2651,0,0,1,1,0.0%,36m
14914,3,一星独烁,2651,0,0,1,1,0.0%,29m
14914,1,代价什么都不是,2651,0,0,4,4,0.0%,1h
14934,3,[火焰雷兽]yoyoAlex,2650,801,36,29,65,55.4%,6m
14934,2,[教父遇刺]innovat,2650,777,35,27,62,56.5%,1h
14934,1,冬去春来,2650,222,11,8,19,57.9%,3m
14934,1,一休不吃素,2650,228,8,11,19,42.1%,1h
14934,1,SakuiS,2650,237,7,6,13,53.8%,18m
14934,1,[csboy]jdy,2650,232,7,9,16,43.8%,1h
14934,2,[野BB与分奴]夜煞苍穹,2650,93,5,3,8,62.5%,39m
14934,2,灬墨丨尘丿,2650,44,4,4,8,50.0%,7m
14934,3,vhkjsr,2650,0,3,2,5,60.0%,43m
14934,2,德黑兰,2650,0,0,1,1,0.0%,12m
14934,2,mind,2650,0,0,1,1,0.0%,1h
14934,3,[SmartX]将军,2650,0,0,5,5,0.0%,1h
14946,3,渣渣天乐,2649,635,40,43,83,48.2%,60m
14946,1,脆脆,2649,521,27,14,41,65.9%,1h
14946,1,遗忘了,2649,550,25,15,40,62.5%,49m
14946,2,[曲终人散]wlxcy,2649,421,16,9,25,64.0%,1h
14946,1,跳跳熊,2649,361,13,8,21,61.9%,18m
14946,1,[Sc养老]蕾姆我的你们吃屁,2649,176,13,9,22,59.1%,1h
14946,1,江峰雨,2649,204,6,5,11,54.5%,49m
14946,1,[半人马座分部]haha,2649,232,6,10,16,37.5%,49m
14946,2,猪兔子,2649,88,4,1,5,80.0%,1h
14946,1,五九下山,2649,138,4,2,6,66.7%,1h
14946,3,见兵就退是你女马,2649,0,4,2,6,66.7%,1h
14946,1,若风,2649,102,4,4,8,50.0%,20m
14946,2,[暴雪三队]走位丶靠扭,2649,64,3,0,3,100.0%,41m
14946,2,[大哥烤鱼谐会]是世界的错,2649,0,1,0,1,100.0%,1h
14946,2,楚风,2649,30,1,1,2,50.0%,1h
14946,3,[萌新萌萌哒]小太壹,2649,38,1,1,2,50.0%,3m
14946,3,拉菲天下第一,2649,0,1,1,2,50.0%,1h
14946,3,地对地导弹,2649,0,1,2,3,33.3%,15m
14946,1,[miku守护]LXF,2649,0,0,2,2,0.0%,1h
14965,2,[折翼丿天使灬]liaoruiju,2648,1036,81,90,171,47.4%,2m
14965,1,[暴雪嘉年华]星际争爸,2648,882,32,28,60,53.3%,1h
14965,1,[RKT]Thor,2648,462,16,18,34,47.1%,10m
14965,1,Wen,2648,332,14,6,20,70.0%,56m
14965,1,yuds,2648,338,10,10,20,50.0%,1h
14965,2,[圆滚滚的]Meow,2648,228,9,6,15,60.0%,43m
14965,1,西住美穗,2648,147,6,3,9,66.7%,3m
14965,1,rongshu,2648,207,5,6,11,45.5%,60m
14965,3,星际憋憋乐玩家,2648,114,5,13,18,27.8%,4m
14965,1,丨冰糖,2648,72,3,4,7,42.9%,1h
14965,2,VERITAS,2648,0,3,4,7,42.9%,1h
14965,2,[工程萌男]MagicXM,2648,0,2,5,7,28.6%,59m
14965,1,[暴雪我是你爹]色相头,2648,0,1,0,1,100.0%,23m
14965,1,[失去了卡拉]pro,2648,0,1,2,3,33.3%,1h
14965,1,殇丶幽,2648,0,1,2,3,33.3%,1h
14965,2,qwesbb,2648,30,1,3,4,25.0%,1h
14965,2,stdooc,2648,0,0,1,1,0.0%,1h
14965,1,[牛头人战队]Tadger,2648,0,0,1,1,0.0%,16m
14965,2,[舅是何平]NITEIP,2648,0,0,2,2,0.0%,1h
14984,1,冯文龙,2647,339,43,41,84,51.2%,3m
14984,1,神秘人,2647,558,21,22,43,48.8%,1h
14984,2,[Beastp]bobeiya,2647,558,19,31,50,38.0%,56m
14984,2,zarc,2647,398,17,5,22,77.3%,12m
14984,2,来建房子玩,2647,412,15,11,26,57.7%,54m
14984,3,Jason,2647,344,13,10,23,56.5%,53m
14984,2,[暖吃翔就是干]TianGeLiya,2647,322,13,16,29,44.8%,1h
14984,2,[C51026]麦田,2647,188,6,3,9,66.7%,1h
14984,3,[这就是妹控啊]哈哈哈哈哈,2647,159,6,4,10,60.0%,46m
14984,3,weichen,2647,155,5,2,7,71.4%,1h
14984,3,潇洒洒脱,2647,36,4,4,8,50.0%,1h
14984,2,[使劲tao]想一想,2647,115,4,5,9,44.4%,27m
14984,2,dvakxy,2647,62,3,0,3,100.0%,7m
14984,2,莫测的狂徒,2647,0,3,4,7,42.9%,1h
14984,3,[萌的一笔]由乃,2647,0,2,3,5,40.0%,1h
14984,3,地表的宁静,2647,0,2,3,5,40.0%,60m
14984,3,攻略之神,2647,0,2,4,6,33.3%,1h
14984,2,风神,2647,0,1,0,1,100.0%,1h
14984,2,[鸡哥永远的神]上衫绘梨衣,2647,0,1,0,1,100.0%,1h
14984,3,阿隼打拳拉了拉,2647,97,1,3,4,25.0%,1h
14984,3,ShiCanHui,2647,0,1,4,5,20.0%,59m
14984,1,黄昏,2647,36,1,5,6,16.7%,10m
14984,2,[YKSN]涼月,2647,0,0,1,1,0.0%,1h
15007,2,wkwk,2646,1562,82,91,173,47.4%,4m
15007,2,羽幕丶,2646,1643,63,74,137,46.0%,3m
15007,3,朝花夕拾,2646,614,58,50,108,53.7%,4m
15007,1,再见赛特兰蒂斯,2646,734,43,28,71,60.6%,44m
15007,1,星际二五仔,2646,511,38,57,95,40.0%,15m
15007,2,SenorAgustin,2646,644,26,15,41,63.4%,1h
15007,1,[由我们重回]深色,2646,432,19,15,34,55.9%,44m
15007,2,snowery,2646,126,11,13,24,45.8%,1h
15007,2,KTunicorn,2646,244,11,14,25,44.0%,10m
15007,2,被简化的爱,2646,88,3,2,5,60.0%,1h
15007,3,StarUUU,2646,30,3,4,7,42.9%,1h
15007,1,利维坦,2646,36,3,5,8,37.5%,1h
15007,2,asdhwh,2646,0,1,2,3,33.3%,11m
15007,3,[相位水晶]AafuK,2646,30,1,6,7,14.3%,13m
15007,1,BoredMosters,2646,0,0,1,1,0.0%,1h
15007,3,Mrsem,2646,0,0,1,1,0.0%,49m
15007,1,阿峰,2646,0,0,5,5,0.0%,54m
15024,1,[暴雪三十二隊]溪云晚星,2645,1096,58,55,113,51.3%,1h
15024,1,xxj,2645,582,24,17,41,58.5%,49m
15024,1,软饭硬吃曹达华,2645,503,22,15,37,59.5%,1h
15024,2,IIIIIIIIIIII,2645,463,16,15,31,51.6%,32m
15024,3,[XJTU]Vincent,2645,190,14,21,35,40.0%,4m
15024,2,[komada]栗悟饭与龟波功,2645,375,12,17,29,41.4%,12m
15024,1,稳健运营也放狗招,2645,181,10,7,17,58.8%,1h
15024,1,[菜的徐坤都怕]拳打南山养老院,2645,246,8,7,15,53.3%,57m
15024,1,[琴筝]DARKPEACH,2645,250,8,10,18,44.4%,4m
15024,2,不可休思,2645,154,6,4,10,60.0%,36m
15024,2,核弹头,2645,40,6,9,15,40.0%,54m
15024,1,葵葵的小熊软糖,2645,185,5,3,8,62.5%,1h
15024,2,牛法拉,2645,144,4,7,11,36.4%,1h
15024,3,[夕阳下的浪客]历世的世语者世战,2645,0,3,2,5,60.0%,1h
15024,1,网恋鬼才可达鸭,2645,126,3,2,5,60.0%,26m
15024,2,forTASSADAR,2645,0,3,7,10,30.0%,21m
15024,2,[莽夫苟熊]盲人能看到的条码,2645,30,2,0,2,100.0%,15m
15024,1,七叔贼啦菜,2645,96,2,0,2,100.0%,59m
15024,2,[comes]SKT,2645,0,1,0,1,100.0%,1h
15024,2,名字真踏马难想,2645,0,1,0,1,100.0%,1h
15024,3,你师弟的,2645,0,1,0,1,100.0%,41m
15024,3,yejianhong,2645,97,1,1,2,50.0%,47m
15024,2,YUKI,2645,30,1,1,2,50.0%,1h
15047,1,eddie,2644,1640,179,171,350,51.1%,1h
15047,3,[我们为了粉丝]larryou,2644,835,57,65,122,46.7%,57m
15047,2,秦梦轩,2644,1197,54,38,92,58.7%,1h
15047,1,白猫吃橘子,2644,852,47,31,78,60.3%,19m
15047,1,coolzyk,2644,777,30,30,60,50.0%,1h
15047,3,黑袍,2644,255,18,17,35,51.4%,19m
15047,1,[不想打内战]Nerazim,2644,514,18,19,37,48.6%,1h
15047,1,蛤是大,2644,371,17,11,28,60.7%,20m
15047,2,Magic,2644,278,11,3,14,78.6%,60m
15047,1,[我太帅]运气是实力的全部,2644,273,9,9,18,50.0%,1h
15047,2,Ayanai,2644,174,5,1,6,83.3%,1h
15047,2,[富贵不存在]夏步,2644,118,5,3,8,62.5%,57m
15047,2,新手小杨,2644,216,5,4,9,55.6%,1h
15047,2,[HQX]ZXZXZX,2644,208,5,7,12,41.7%,1h
15047,2,白金之星,2644,0,4,2,6,66.7%,18m
15047,2,三宅,2644,0,4,3,7,57.1%,1h
15047,2,[入侵地球]chaoxi,2644,64,3,0,3,100.0%,1h
15047,2,BloodShadow,2644,30,2,0,2,100.0%,1h
15047,2,天女牛批,2644,30,2,0,2,100.0%,1h
15047,2,神族老爸,2644,30,2,0,2,100.0%,10m
15047,2,紫少,2644,113,2,1,3,66.7%,1h
15047,1,van,2644,91,1,4,5,20.0%,23m
15047,2,醉笑苍天,2644,0,0,1,1,0.0%,25m
15047,1,大雄搞星际,2644,0,0,2,2,0.0%,19m
15071,2,力拔山兮,2643,860,44,36,80,55.0%,1h
15071,2,甜甜的小糖丸,2643,788,27,38,65,41.5%,8m
15071,1,止境,2643,532,24,21,45,53.3%,19m
15071,2,这不是有手就行,2643,232,10,9,19,52.6%,48m
15071,3,[落水河畔]lightbird,2643,131,10,12,22,45.5%,28m
15071,2,李仁,2643,236,9,2,11,81.8%,1h
15071,1,腹黑邱,2643,191,8,3,11,72.7%,1h
15071,1,[我们是无敌的]人皇武圣星际魔君,2643,189,6,4,10,60.0%,1h
15071,1,打死了鞭尸,2643,188,6,10,16,37.5%,17m
15071,2,[龙魂天下]ares,2643,164,5,1,6,83.3%,1h
15071,1,[恶劣玩家]渣渣,2643,110,5,5,10,50.0%,24m
15071,1,[芜湖难铜]难铜贰号,2643,186,5,6,11,45.5%,1h
15071,1,MITCHESON,2643,146,5,7,12,41.7%,1h
15071,2,飞度,2643,60,5,8,13,38.5%,20m
15071,3,猿粪,2643,42,4,4,8,50.0%,1h
15071,2,duke,2643,116,4,5,9,44.4%,1h
15071,1,Demon,2643,186,4,6,10,40.0%,24m
15071,2,我教你呀,2643,116,4,6,10,40.0%,7m
15071,2,hanxiaozhi,2643,142,3,1,4,75.0%,1h
15071,1,彼岸花开,2643,116,3,2,5,60.0%,1h
15071,3,[多个老年人]蛋中如治麟,2643,0,3,2,5,60.0%,8m
15071,1,终有弱水替沧海,2643,89,2,1,3,66.7%,1h
15071,3,Dkyf,2643,0,2,3,5,40.0%,3m
15071,3,机智如我么么哒,2643,0,2,4,6,33.3%,59m
15071,2,[手握黄金舰队]傲骨啸如虎,2643,0,1,0,1,100.0%,1h
15071,2,時崎,2643,0,1,0,1,100.0%,19m
15071,2,wang,2643,0,0,1,1,0.0%,15m
15071,3,小豆豆,2643,0,0,1,1,0.0%,46m
15099,1,[暴雪三十一队]luckysky,2642,1664,163,152,315,51.7%,36m
15099,2,[恋战皇朝]丨魙丨,2642,1613,108,89,197,54.8%,3m
15099,2,[菜有菜的道理]理查德伊卡洛斯,2642,716,27,21,48,56.2%,1h
15099,1,虚荣,2642,330,10,11,21,47.6%,26m
15099,1,[专业曹波]sinReviAr,2642,256,7,7,14,50.0%,1h
15099,2,一笑而过,2642,181,6,0,6,100.0%,40m
15099,2,浪味仙,2642,206,6,7,13,46.2%,1h
15099,3,超能之法师,2642,0,4,1,5,80.0%,58m
15099,3,蝰哥,2642,97,3,3,6,50.0%,15m
15099,3,[神的降临]你猜啊,2642,0,3,3,6,50.0%,1h
15099,2,铁血丶英魂,2642,93,2,0,2,100.0%,1h
15099,3,牛牛村的渣,2642,0,2,3,5,40.0%,3m
15099,1,[凛风]首辅,2642,123,2,4,6,33.3%,38m
15099,3,任日生,2642,0,1,1,2,50.0%,50m
15099,2,疯狂吊人,2642,0,1,2,3,33.3%,37m
15099,2,艾泽拉斯,2642,0,0,1,1,0.0%,60m
15099,2,IIIIIIIIIIII,2642,0,0,1,1,0.0%,1h
15099,3,坟墓,2642,0,0,1,1,0.0%,1h
15099,3,sunwufan,2642,0,0,2,2,0.0%,29m
15118,1,濛江鸡蛋先生,2641,1347,189,182,371,50.9%,18m
15118,1,[sdadad]小朋友友友友,2641,1642,80,76,156,51.3%,1h
15118,3,[艾尔之名]MSDELL,2641,1501,71,61,132,53.8%,3m
15118,1,Leonzzz,2641,677,24,22,46,52.2%,57m
15118,1,HSM,2641,192,16,12,28,57.1%,4m
15118,1,[突变攻略小租]无敌的我,2641,271,12,11,23,52.2%,44m
15118,2,[NCHU]筱筱筱筱娅,2641,306,11,14,25,44.0%,3m
15118,1,[琴筝]威斯安抚,2641,254,8,7,15,53.3%,1h
15118,3,三千,2641,255,8,10,18,44.4%,16m
15118,2,凯撒大帝,2641,228,7,7,14,50.0%,21m
15118,2,上仙,2641,168,5,6,11,45.5%,1h
15118,3,[奶农]艾尔的光辉,2641,72,4,5,9,44.4%,49m
15118,3,[开心战队]我是爸爸,2641,0,3,3,6,50.0%,57m
15118,3,虫族双黄蛋,2641,0,2,3,5,40.0%,54m
15118,2,阿布,2641,64,2,4,6,33.3%,1h
15118,3,弃青衫,2641,0,2,4,6,33.3%,15m
15118,1,我我,2641,0,1,0,1,100.0%,1h
15118,2,DJJ,2641,0,1,1,2,50.0%,1h
15118,3,艾尔之名,2641,38,1,2,3,33.3%,1h
15118,2,ASHURA,2641,0,0,1,1,0.0%,46m
15138,2,秀智呀秀智,2640,1566,255,242,497,51.3%,38m
15138,2,恐龙跳跳,2640,1632,243,236,479,50.7%,28m
15138,2,[雷本]无敌乐,2640,1194,51,41,92,55.4%,8m
15138,3,[暴雪我是你爹]gene,2640,1039,49,50,99,49.5%,4m
15138,2,CrazyDiamond,2640,802,35,26,61,57.4%,1h
15138,2,voos,2640,631,27,15,42,64.3%,1h
15138,1,Ocean,2640,437,13,21,34,38.2%,20m
15138,1,CARL,2640,334,10,13,23,43.5%,1h
15138,3,[新手玩家]恰柠檬的单身狗,2640,0,4,1,5,80.0%,25m
15138,2,zfm,2640,120,4,2,6,66.7%,1h
15138,3,wwb,2640,32,4,3,7,57.1%,1h
15138,1,tianci,2640,122,3,3,6,50.0%,1h
15138,2,jiangshiken,2640,38,2,0,2,100.0%,41m
15138,3,[田中飞母]我为雪风丶带盐,2640,0,2,3,5,40.0%,1h
15138,2,Jormungandr,2640,0,1,0,1,100.0%,30m
15138,3,[查尔难民]Hydra,2640,0,1,1,2,50.0%,1h
15138,2,oyg,2640,34,1,2,3,33.3%,40m
15138,2,Superkevin,2640,0,0,1,1,0.0%,1h
15138,1,[NWAFU]只爱霞之丘诗羽,2640,0,0,4,4,0.0%,15m
15157,1,一季恋歌,2639,1667,140,130,270,51.9%,17m
15157,1,懂你芳心,2639,1120,44,37,81,54.3%,1h
15157,3,freedomyang,2639,1242,44,62,106,41.5%,60m
15157,1,[日月神教]clearlove,2639,1033,38,36,74,51.4%,1h
15157,2,[TNT]nicole,2639,596,30,26,56,53.6%,41m
15157,1,地霸,2639,706,29,25,54,53.7%,54m
15157,2,盲人电竞,2639,166,6,8,14,42.9%,15m
15157,2,[IDS]XTY,2639,90,4,9,13,30.8%,30m
15157,2,Antony,2639,58,3,0,3,100.0%,1h
15157,2,吃着薯片的可乐,2639,45,3,1,4,75.0%,1h
15157,3,[紫槿]volunteer,2639,0,3,2,5,60.0%,1h
15157,2,想去迪士尼,2639,30,2,0,2,100.0%,1h
15157,2,[阿里巴巴战队]sky,2639,30,2,1,3,66.7%,1h
15157,2,非洲大酋长,2639,66,2,4,6,33.3%,48m
15157,2,寒秋子夜,2639,0,1,0,1,100.0%,1h
15157,3,吃瓜群众,2639,0,1,0,1,100.0%,18m
15157,2,[菜的没人带]跑跑甘,2639,0,1,0,1,100.0%,57m
15157,3,奥西利斯之剑,2639,0,1,2,3,33.3%,25m
15157,3,玄眇,2639,0,0,1,1,0.0%,1h
15157,2,乔碧萝,2639,0,0,1,1,0.0%,48m
15157,3,心的开始,2639,0,0,1,1,0.0%,1h
15157,3,zhutougolian,2639,0,0,2,2,0.0%,1h
15179,2,[alisc2]皓文,2638,1480,273,284,557,49.0%,3m
15179,2,饕餮银之舞,2638,924,35,31,66,53.0%,18m
15179,2,[炸裂]SCIlence,2638,428,19,5,24,79.2%,36m
15179,1,[KPG2]半糖彡冰茶,2638,383,16,10,26,61.5%,57m
15179,2,Mike,2638,342,12,7,19,63.2%,36m
15179,1,ohpenfrost,2638,316,11,5,16,68.8%,59m
15179,3,Legend,2638,229,8,4,12,66.7%,1h
15179,1,hylydc,2638,276,8,8,16,50.0%,1h
15179,2,你是谁,2638,118,3,3,6,50.0%,1h
15179,2,IIIIIIIIIIII,2638,62,2,3,5,40.0%,11m
15179,3,kwa,2638,0,2,3,5,40.0%,1h
15179,3,逐星者,2638,0,2,3,5,40.0%,54m
15179,3,穿过记忆的隧道,2638,0,2,4,6,33.3%,1h
15179,2,BoBoDAI,2638,0,1,0,1,100.0%,38m
15179,2,rainsalt,2638,0,1,1,2,50.0%,1h
15179,3,[小仙女上线啦]TUWOKM,2638,0,1,2,3,33.3%,1h
15179,1,gty,2638,88,1,3,4,25.0%,19m
15179,3,且战且退孙一峰,2638,0,0,1,1,0.0%,1h
15179,3,[洛水伊人]魔之轩辕,2638,0,0,1,1,0.0%,1h
15179,2,木易,2638,0,0,2,2,0.0%,1h
15179,1,超越神话,2638,0,0,5,5,0.0%,33m
15200,3,[星际丨老男孩]星际宇,2637,676,35,29,64,54.7%,4m
15200,2,[少女的梦]人族正常开,2637,568,20,21,41,48.8%,57m
15200,3,星际王,2637,244,8,10,18,44.4%,5m
15200,2,二边形战士,2637,209,7,4,11,63.6%,1h
15200,1,晓美焰,2637,226,7,8,15,46.7%,1h
15200,1,沙漠王子哈哈哈,2637,275,7,14,21,33.3%,1h
15200,3,脑壳菜包,2637,194,6,3,9,66.7%,1h
15200,3,TVTGG,2637,201,6,4,10,60.0%,1h
15200,1,马保国,2637,194,6,9,15,40.0%,3m
15200,3,柚希,2637,0,4,1,5,80.0%,60m
15200,3,星际刺客,2637,97,4,2,6,66.7%,1h
15200,2,[小菜逼]xixili,2637,96,4,2,6,66.7%,1h
15200,2,刚出锅的呆猴,2637,90,4,3,7,57.1%,10m
15200,2,浮生,2637,96,4,3,7,57.1%,54m
15200,1,fxfkfxfk,2637,159,3,3,6,50.0%,1h
15200,3,[耶里切尼]黑色的纸片,2637,76,3,6,9,33.3%,1h
15200,3,[FODX]IIIIIIII,2637,0,2,3,5,40.0%,1h
15200,3,lyc,2637,0,2,3,5,40.0%,41m
15200,3,[Relx]klusen,2637,0,1,0,1,100.0%,1h
15200,1,[16CM]甲方据卡机,2637,0,1,2,3,33.3%,26m
15200,3,[Shawk]喵了个咪,2637,0,1,2,3,33.3%,1h
15200,2,[Onceme]嬉笑看人生,2637,0,0,1,1,0.0%,1h
15200,2,thead,2637,0,0,1,1,0.0%,1h
15200,2,鹤柒荔,2637,0,0,1,1,0.0%,11m
15200,2,宣子,2637,0,0,1,1,0.0%,17m
15225,1,space,2636,1604,81,72,153,52.9%,36m
15225,3,老张,2636,1463,57,61,118,48.3%,10m
15225,2,[万物皆可白给]我的机械化白给了,2636,540,18,28,46,39.1%,6m
15225,1,[TPZTPZ]神明,2636,291,7,9,16,43.8%,12m
15225,2,寒流,2636,161,6,2,8,75.0%,1h
15225,2,遊戯,2636,86,3,1,4,75.0%,14m
15225,3,东方坑爹,2636,97,3,3,6,50.0%,1h
15225,1,[埃蒙好可爱]锤子,2636,160,3,6,9,33.3%,16m
15225,2,[北有吾王3队]铸星索尔,2636,0,1,0,1,100.0%,48m
15225,2,[基金会]涅普涅普,2636,0,1,0,1,100.0%,19m
15225,2,[SUPER2]鱼慕凤鸾,2636,36,1,2,3,33.3%,19m
15225,2,[MEI]Jamison,2636,30,1,12,13,7.7%,21m
15225,2,[星芒]Templar,2636,0,0,1,1,0.0%,60m
15225,2,Forbormer,2636,0,0,2,2,0.0%,32m
15239,2,fastlorde,2635,811,57,66,123,46.3%,31m
15239,1,你脑缠,2635,930,33,36,69,47.8%,54m
15239,2,michaelssj,2635,248,10,12,22,45.5%,1h
15239,1,HANHAOHAO,2635,197,6,8,14,42.9%,1h
15239,3,[DC战队]MarineKingSY,2635,193,4,21,25,16.0%,19m
15239,2,[乳主头子]一只探机,2635,62,2,3,5,40.0%,1h
15239,2,venven,2635,135,2,4,6,33.3%,11m
15239,1,IIIIIIIIIIII,2635,36,2,5,7,28.6%,17m
15239,2,[星际星际星际]现实,2635,30,1,1,2,50.0%,1h
15239,2,[Iam鶸]塔达林高阶坚果,2635,32,1,3,4,25.0%,1h
15239,1,[飞跃来]风过无痕,2635,95,1,3,4,25.0%,1h
15239,2,吹梦到西洲,2635,30,1,3,4,25.0%,40m
15239,2,[星际星际星际]SPRINGWZ,2635,0,0,1,1,0.0%,1h
15239,2,朝烟,2635,0,0,1,1,0.0%,1h
15239,2,心平气核,2635,0,0,2,2,0.0%,27m
15254,2,唐古拉斯,2634,510,88,100,188,46.8%,27m
15254,1,王者猴子,2634,973,49,48,97,50.5%,1h
15254,2,神族,2634,591,45,52,97,46.4%,12m
15254,3,[HeroZP]Superman,2634,392,18,15,33,54.5%,29m
15254,1,chihiro,2634,338,14,16,30,46.7%,4m
15254,2,权威,2634,306,11,16,27,40.7%,1h
15254,1,店长,2634,174,7,5,12,58.3%,40m
15254,2,[仙阁]Stave,2634,211,7,7,14,50.0%,1h
15254,1,leizhouxi,2634,88,4,3,7,57.1%,44m
15254,3,夜凌星,2634,40,3,4,7,42.9%,57m
15254,3,请叫我爸爸丶,2634,97,2,0,2,100.0%,50m
15254,1,[光子炮台]探机佬,2634,46,2,1,3,66.7%,1h
15254,1,椎叶紬天下第一,2634,30,2,3,5,40.0%,38m
15254,1,[啾啾啾啾啾啾]二杠,2634,40,2,3,5,40.0%,1h
15254,2,软泥,2634,0,2,5,7,28.6%,1h
15254,2,[人类保卫队]死神之子,2634,0,1,0,1,100.0%,1h
15254,3,书生,2634,97,1,1,2,50.0%,1h
15254,2,MUSASHI,2634,0,0,1,1,0.0%,11m
15254,1,[菊花神教]cjy,2634,0,0,1,1,0.0%,1h
15254,2,[jui]呵呵龖丶,2634,0,0,2,2,0.0%,57m
15254,1,血月,2634,0,0,3,3,0.0%,36m
15254,3,[MIKU01]哥乌恩,2634,0,0,7,7,0.0%,19m
15276,1,PTHE,2633,1672,91,73,164,55.5%,36m
15276,1,南云的主人,2633,1062,37,37,74,50.0%,1h
15276,1,SCIKlLLER,2633,253,25,15,40,62.5%,1h
15276,2,ljqsb,2633,484,20,12,32,62.5%,1h
15276,2,[星辰腰子队]暗键师,2633,404,17,17,34,50.0%,42m
15276,2,轻玩家,2633,290,16,10,26,61.5%,15m
15276,1,[芜湖wuho]杜蕾斯,2633,390,15,18,33,45.5%,1h
15276,2,宫保蟋蟀,2633,194,6,2,8,75.0%,1h
15276,1,安逸尘,2633,96,2,4,6,33.3%,1h
15276,2,[LOHs]wdnmm,2633,0,1,1,2,50.0%,1h
15276,2,DowsonCole,2633,0,1,1,2,50.0%,48m
15276,2,尼德霍格,2633,0,1,1,2,50.0%,1h
15276,3,Artanis,2633,0,0,1,1,0.0%,1h
15276,2,仰望繁星,2633,0,0,1,1,0.0%,19m
15276,1,撤硕主宰,2633,0,0,1,1,0.0%,1h
15276,1,三日月夜空,2633,0,0,3,3,0.0%,1h
15292,1,FrAlive,2632,462,14,15,29,48.3%,1h
15292,1,风味餐,2632,324,10,10,20,50.0%,33m
15292,2,[我太帅]不良人,2632,208,7,7,14,50.0%,1h
15292,2,SimonHsu,2632,150,4,1,5,80.0%,38m
15292,2,[C53421]扒了猛干,2632,136,3,1,4,75.0%,18m
15292,2,golden,2632,95,2,1,3,66.7%,38m
15292,1,骨灰级萌新,2632,0,2,3,5,40.0%,35m
15292,2,崔九,2632,0,1,0,1,100.0%,3m
15292,2,[挨萌愚忠分子]TerranLight,2632,0,1,0,1,100.0%,18m
15292,2,FGFP,2632,0,1,1,2,50.0%,1h
15292,1,生如夏花死如秋叶,2632,38,1,6,7,14.3%,1h
15292,2,[Hape]enmin,2632,0,0,1,1,0.0%,1h
15292,3,春花哪堪几度霜,2632,0,0,1,1,0.0%,1h
15305,1,老人破机,2631,1406,339,316,655,51.8%,14m
15305,1,步兵,2631,970,105,99,204,51.5%,1h
15305,1,宁静致远,2631,974,75,64,139,54.0%,1h
15305,2,霞之丘诗羽,2631,982,32,45,77,41.6%,38m
15305,1,梅哥,2631,485,18,15,33,54.5%,1h
15305,1,TrebleARASI,2631,402,16,18,34,47.1%,1h
15305,1,[涉黑]大神,2631,227,9,7,16,56.2%,3m
15305,2,[天河联盟]star,2631,118,5,3,8,62.5%,1h
15305,1,臣妾紧握朕龙根,2631,180,5,5,10,50.0%,54m
15305,1,[小小熊]夏了夏天,2631,105,2,4,6,33.3%,36m
15305,3,[突变攻略组]hatsunemiku,2631,0,2,4,6,33.3%,1h
15305,2,SOS,2631,0,0,1,1,0.0%,57m
15305,1,迷茫,2631,0,0,2,2,0.0%,1h
15305,1,ADLLB,2631,0,0,3,3,0.0%,33m
15319,2,lychnis,2630,700,50,42,92,54.3%,36m
15319,1,NICK,2630,878,36,36,72,50.0%,1h
15319,1,[Happy]Prime,2630,481,20,15,35,57.1%,19m
15319,2,YANGRONG,2630,256,8,5,13,61.5%,1h
15319,2,荣耀归于达拉姆,2630,237,7,3,10,70.0%,32m
15319,1,神秘大帝,2630,191,6,10,16,37.5%,49m
15319,2,[爱丽丝幻月]火焰猫,2630,109,5,4,9,55.6%,49m
15319,2,[极限菜鸟]蚊子,2630,154,4,2,6,66.7%,1h
15319,3,[云玩家谐会]别打太猛,2630,94,3,14,17,17.6%,16m
15319,2,[Dili课堂]MrRight,2630,32,2,1,3,66.7%,50m
15319,1,Highness,2630,0,2,3,5,40.0%,43m
15319,3,你嵩哥,2630,0,2,4,6,33.3%,1h
15319,2,[我队伍很强大]虚幻,2630,0,1,0,1,100.0%,11m
15319,1,盛世之樱,2630,0,1,3,4,25.0%,1h
15319,2,阿斯,2630,0,0,1,1,0.0%,1h
15319,2,[乌拉拉啦啦啦]鑫爷,2630,0,0,1,1,0.0%,28m
15319,2,风之刃,2630,0,0,1,1,0.0%,48m
15319,3,[WLSA]TimWu,2630,0,0,1,1,0.0%,5m
15319,2,玄武裤裤球,2630,0,0,2,2,0.0%,38m
15338,2,Gerry,2629,1299,75,61,136,55.1%,1h
15338,3,sjljhfkuff,2629,915,38,39,77,49.4%,33m
15338,1,[二战武鉴阁]迹部少爷,2629,229,29,16,45,64.4%,3m
15338,2,枯木逢春,2629,628,22,23,45,48.9%,1h
15338,1,[113]达文西,2629,535,20,18,38,52.6%,14m
15338,2,大意了丶没有闪,2629,379,18,16,34,52.9%,28m
15338,2,无情小魔仙,2629,337,11,8,19,57.9%,60m
15338,2,[火焰雷兽]StrBro,2629,314,10,8,18,55.6%,1h
15338,2,不是你的宝贝,2629,227,8,7,15,53.3%,1h
15338,2,未晨,2629,180,7,1,8,87.5%,1h
15338,2,Conestantine,2629,196,7,6,13,53.8%,10m
15338,1,[12D专业]影墨,2629,201,7,6,13,53.8%,14m
15338,3,苗二狗,2629,90,7,7,14,50.0%,17m
15338,1,極楓,2629,226,6,7,13,46.2%,1h
15338,3,兪神,2629,97,4,3,7,57.1%,60m
15338,1,[Truth]渣渣,2629,0,2,2,4,50.0%,28m
15338,1,輕浮小情緒,2629,0,2,3,5,40.0%,1h
15338,1,ZHIDIANZHENA,2629,0,1,0,1,100.0%,1h
15338,2,Riove,2629,0,1,1,2,50.0%,11m
15338,2,[喵喵]滍语,2629,0,0,1,1,0.0%,57m
15338,2,我已颓废感觉良好,2629,0,0,1,1,0.0%,49m
15338,1,Broken,2629,0,0,1,1,0.0%,1h
15338,2,[二次元联盟军]IIIIIIIIIIII,2629,0,0,2,2,0.0%,30m
15338,1,霜烬春痕,2629,0,0,2,2,0.0%,1h
15362,3,[兆景埋土大学]xianyu,2628,1453,164,165,329,49.8%,17m
15362,1,YING,2628,1126,46,41,87,52.9%,1h
15362,3,豁老子,2628,609,29,28,57,50.9%,57m
15362,2,癸鼎,2628,578,22,20,42,52.4%,1h
15362,1,落寞达人,2628,378,15,18,33,45.5%,1h
15362,2,[咖啡Fans]Whispers,2628,186,6,2,8,75.0%,15m
15362,1,高数干离散,2628,185,6,5,11,54.5%,1h
15362,1,GOLINK,2628,162,6,5,11,54.5%,17m
15362,2,[埃萌流动炮房]TENX,2628,154,6,6,12,50.0%,1h
15362,2,千珏,2628,154,6,6,12,50.0%,1h
15362,1,小磊,2628,167,6,7,13,46.2%,14m
15362,3,[C94941]唯爱晓桐,2628,64,6,8,14,42.9%,1h
15362,2,杨汶锜,2628,141,5,5,10,50.0%,1h
15362,2,xzx,2628,42,2,0,2,100.0%,30m
15362,1,[毒遍天下]万一起荣悄悄,2628,0,2,3,5,40.0%,16m
15362,1,[星际穿梭]小橘子,2628,36,2,6,8,25.0%,10m
15362,2,Icy,2628,0,1,1,2,50.0%,49m
15362,2,[星空下第一]Lucifer,2628,30,1,1,2,50.0%,55m
15362,2,[TQTQ]MFine,2628,0,0,2,2,0.0%,1h
15381,3,绝命鬼手,2627,1037,107,105,212,50.5%,29m
15381,2,停电了怎么办,2627,923,37,34,71,52.1%,19m
15381,1,我寻思着我很帅,2627,836,28,32,60,46.7%,38m
15381,2,鼻孔比碗大,2627,492,21,11,32,65.6%,60m
15381,1,比企谷八幡,2627,480,17,19,36,47.2%,14m
15381,1,sda,2627,342,15,8,23,65.2%,1h
15381,2,别把自己当回事,2627,340,12,8,20,60.0%,1h
15381,1,[DWGDC]萌新,2627,170,11,10,21,52.4%,1h
15381,2,生命之弦,2627,342,11,14,25,44.0%,8m
15381,2,你看我还有机会么,2627,167,6,7,13,46.2%,40m
15381,1,Rambocheng,2627,96,5,4,9,55.6%,1h
15381,2,[soki]别西卜缪林,2627,148,5,5,10,50.0%,40m
15381,1,二九九丶,2627,230,5,7,12,41.7%,1h
15381,2,potatoluo,2627,122,4,6,10,40.0%,1h
15381,2,伞兵一号卢本伟,2627,71,3,2,5,60.0%,55m
15381,2,[希靈帝國]战袍,2627,92,3,3,6,50.0%,1h
15381,2,Accelerator,2627,0,1,0,1,100.0%,1h
15381,3,[斯巴达血战团]sunshine,2627,0,1,0,1,100.0%,1h
15381,2,爱笑的大哥哥,2627,0,1,4,5,20.0%,6m
15381,2,亚特鲁,2627,0,0,1,1,0.0%,32m
15381,1,火海刀山,2627,0,0,1,1,0.0%,55m
15381,2,[烽火长歌]千万人吾往矣,2627,0,0,2,2,0.0%,1h
15381,2,[对标是什么]白殇,2627,0,0,2,2,0.0%,8m
15381,2,[北洋水军]杨柳轻扬,2627,0,0,2,2,0.0%,40m
15381,1,凌凌子,2627,0,0,2,2,0.0%,1h
15406,2,beidou,2626,1627,490,501,991,49.4%,14m
15406,2,SCsuperstar,2626,825,37,25,62,59.7%,28m
15406,2,星之痕,2626,188,34,34,68,50.0%,36m
15406,1,遗言,2626,335,30,25,55,54.5%,1h
15406,3,Batman,2626,516,18,26,44,40.9%,29m
15406,1,[爱蒙保护协会]鸡猎者联盟,2626,354,15,17,32,46.9%,38m
15406,1,雪融,2626,380,14,11,25,56.0%,28m
15406,2,lsssss,2626,233,6,8,14,42.9%,6m
15406,3,舟小鸣,2626,64,5,5,10,50.0%,49m
15406,2,Lain,2626,120,4,4,8,50.0%,50m
15406,2,蛏子影胤,2626,0,3,3,6,50.0%,12m
15406,1,毛毛,2626,0,2,1,3,66.7%,16m
15406,2,longCC,2626,58,2,2,4,50.0%,1h
15406,2,失控的疯子祥子,2626,30,2,2,4,50.0%,38m
15406,1,GJML,2626,0,2,3,5,40.0%,1h
15406,2,逆小境哟,2626,0,2,4,6,33.3%,1h
15406,2,星神,2626,30,1,2,3,33.3%,1h
15406,1,金鱼师傅,2626,0,1,2,3,33.3%,57m
15406,2,打不过就是打不过,2626,0,0,1,1,0.0%,50m
15406,2,亦忘川,2626,0,0,1,1,0.0%,55m
15406,3,情怀美好残酷,2626,0,0,1,1,0.0%,1h
15406,3,黄金炸鸡舰队,2626,0,0,2,2,0.0%,1h
15428,2,[Sky翱翔]刀在后备箱,2625,1022,45,31,76,59.2%,25m
15428,1,GanD,2625,948,38,30,68,55.9%,26m
15428,1,[超次元超信仰]Noire,2625,473,33,29,62,53.2%,1h
15428,1,一拳超人,2625,555,27,15,42,64.3%,10m
15428,1,[神武骑士团]老男人,2625,694,24,27,51,47.1%,3m
15428,2,[透一下清酒]IIIIIIIII,2625,511,20,18,38,52.6%,28m
15428,1,请叫我热巴,2625,285,12,7,19,63.2%,36m
15428,2,gdmoo,2625,178,7,5,12,58.3%,1h
15428,1,[武圣]light,2625,150,5,4,9,55.6%,1h
15428,1,Adrian,2625,97,5,4,9,55.6%,24m
15428,2,如此凄美,2625,58,2,3,5,40.0%,55m
15428,1,Girei,2625,0,2,3,5,40.0%,19m
15428,1,helsing,2625,0,2,3,5,40.0%,1h
15428,2,[科普鲁苏维埃]往事如烟,2625,0,1,0,1,100.0%,50m
15428,2,专杀肺炎病毒,2625,0,1,2,3,33.3%,1h
15443,2,llllllllllll,2624,1442,90,107,197,45.7%,56m
15443,3,[神子]一个可爱的队友,2624,1176,42,64,106,39.6%,60m
15443,2,USERKEKY,2624,832,36,26,62,58.1%,42m
15443,2,冰冻菠萝油,2624,849,32,29,61,52.5%,1h
15443,1,杰哥,2624,416,22,17,39,56.4%,1h
15443,1,[GGWW]破灭的希望,2624,453,19,15,34,55.9%,3m
15443,1,我今天不高考,2624,255,18,11,29,62.1%,26m
15443,2,GreenGreen,2624,327,12,8,20,60.0%,1h
15443,1,[鸡烈]tossboy,2624,278,12,15,27,44.4%,3m
15443,3,春秋来信,2624,308,11,12,23,47.8%,1h
15443,1,[113]电脑,2624,237,7,8,15,46.7%,1h
15443,2,BAEBAE,2624,44,5,3,8,62.5%,5m
15443,2,[NtS媚娘队]虚空,2624,58,2,1,3,66.7%,57m
15443,2,尘土,2624,60,2,2,4,50.0%,36m
15443,2,[犹豫12败北]白给少年,2624,42,2,3,5,40.0%,1h
15443,1,不在江湖,2624,0,2,3,5,40.0%,39m
15443,1,天际,2624,0,2,3,5,40.0%,1h
15443,1,[艾尔永不沦陷]星际边缘,2624,118,2,4,6,33.3%,1h
15443,2,bieber,2624,0,1,0,1,100.0%,11m
15443,2,[北有吾王]衮神强,2624,30,1,1,2,50.0%,30m
15443,3,stranger,2624,0,0,1,1,0.0%,54m
15443,3,读着倒子傻有总,2624,0,0,1,1,0.0%,1h
15465,3,[burn]浣纱幼儿园下面陈,2623,440,109,123,232,47.0%,26m
15465,3,youwillgoal,2623,1170,40,49,89,44.9%,16m
15465,2,发胶过多,2623,627,26,15,41,63.4%,19m
15465,2,Varian,2623,258,13,12,25,52.0%,38m
15465,2,八星灯,2623,250,9,5,14,64.3%,42m
15465,2,萌新一个大佬轻锤,2623,220,8,3,11,72.7%,8m
15465,2,[TSOD]开始全面猛攻,2623,142,6,4,10,60.0%,15m
15465,3,小星星,2623,173,5,6,11,45.5%,1h
15465,2,Anonymous,2623,168,4,3,7,57.1%,1h
15465,1,亚哥,2623,114,3,2,5,60.0%,51m
15465,3,[无限圣堂]冷云舞月,2623,38,2,1,3,66.7%,1h
15465,2,灰烬,2623,60,2,4,6,33.3%,48m
15465,3,风醉,2623,0,2,4,6,33.3%,31m
15465,2,罪孽,2623,0,1,1,2,50.0%,5m
15465,1,快抱抱豹豹宝宝,2623,93,1,1,2,50.0%,3m
15465,2,[雷若警长]刘秀,2623,18,1,3,4,25.0%,38m
15465,2,回眸往事丶叮叮,2623,0,0,1,1,0.0%,1h
15465,1,[机器猫]我的脚下就是艾尔,2623,0,0,1,1,0.0%,1h
15483,1,PJY,2622,904,90,115,205,43.9%,20m
15483,1,PGG,2622,656,65,67,132,49.2%,24m
15483,2,MrRen,2622,463,20,6,26,76.9%,1h
15483,3,RogueFour,2622,429,19,14,33,57.6%,26m
15483,3,parkchoron,2622,361,19,20,39,48.7%,8m
15483,3,[小狗赛高]FooceCeser,2622,341,14,20,34,41.2%,9m
15483,1,[灰冥]闪耀却嘻嘻,2622,357,13,11,24,54.2%,1h
15483,3,来干我呀,2622,172,8,10,18,44.4%,1h
15483,1,新人,2622,225,8,10,18,44.4%,9m
15483,2,异虫,2622,118,5,2,7,71.4%,40m
15483,1,kkb,2622,121,5,7,12,41.7%,1h
15483,1,[弑血轻语]殇逝,2622,183,3,2,5,60.0%,1h
15483,2,神王剑神,2622,98,3,3,6,50.0%,38m
15483,2,科科,2622,88,3,4,7,42.9%,1h
15483,2,[蛟龙突击队]cycy,2622,102,3,5,8,37.5%,1h
15483,2,Jerry,2622,32,2,0,2,100.0%,1h
15483,1,[TheOne]琪亚娜丶卡斯兰娜,2622,0,2,3,5,40.0%,4m
15483,1,老龙,2622,0,2,3,5,40.0%,1h
15483,1,[自定义小队]凌零,2622,0,2,3,5,40.0%,1h
15483,2,盛唐桦韵,2622,0,1,0,1,100.0%,11m
15483,2,永夜,2622,0,1,0,1,100.0%,11m
15483,2,[真理卐高中]为你微笑,2622,30,1,1,2,50.0%,28m
15483,2,[1giao]AngelSin,2622,0,1,2,3,33.3%,1h
15483,2,Nefertair,2622,30,1,4,5,20.0%,28m
15483,2,TIOOIT,2622,46,1,4,5,20.0%,1h
15483,2,knighttheone,2622,0,0,1,1,0.0%,60m
15483,2,creepsama,2622,0,0,2,2,0.0%,13m
15510,3,大白鲨,2621,1498,225,218,443,50.8%,17m
15510,2,[堂口好兄弟]wjzzb,2621,788,34,20,54,63.0%,1h
15510,2,[萝莉的剑舞]Zafkiel,2621,602,25,22,47,53.2%,1h
15510,2,疯狂小野猪,2621,448,20,16,36,55.6%,1h
15510,2,撒法发,2621,46,4,6,10,40.0%,1h
15510,1,海子,2621,0,2,3,5,40.0%,1h
15510,1,[高ping]qweszf,2621,0,2,3,5,40.0%,1h
15510,1,我最帅了,2621,0,2,3,5,40.0%,35m
15510,2,youyou,2621,0,1,0,1,100.0%,1h
15510,2,lxl,2621,0,1,0,1,100.0%,1h
15510,3,[铁路第二监狱]ODSTJerry,2621,0,1,0,1,100.0%,1h
15510,1,兔子杀红了眼,2621,0,1,1,2,50.0%,15m
15510,2,[DSE]凛冰璃雪,2621,0,1,1,2,50.0%,16m
15510,3,Tsunami,2621,0,1,2,3,33.3%,1h
15510,2,被感染的叉叉,2621,30,1,3,4,25.0%,32m
15510,1,叶落知秋是也,2621,0,1,4,5,20.0%,17m
15510,2,chang,2621,0,0,1,1,0.0%,1h
15527,1,[飞云之上]ilovefrozen,2620,1272,53,48,101,52.5%,15m
15527,2,fengshen,2620,603,23,18,41,56.1%,32m
15527,2,想取骚名不知取啥,2620,447,20,5,25,80.0%,1h
15527,2,minever,2620,284,12,13,25,48.0%,1h
15527,1,[0v00v0]昆西昆西昆,2620,300,11,8,19,57.9%,24m
15527,3,零零双,2620,356,11,18,29,37.9%,17m
15527,3,[暴雪三十队]非死神,2620,276,10,11,21,47.6%,1h
15527,2,ilili,2620,168,7,9,16,43.8%,18m
15527,3,aaaaaa,2620,212,7,17,24,29.2%,9m
15527,1,红尘如梦,2620,124,3,4,7,42.9%,1h
15527,2,只会这一招,2620,62,2,1,3,66.7%,1h
15527,1,Sitlm,2620,0,2,3,5,40.0%,3m
15527,3,[Mentor]邮城一条龙,2620,0,2,4,6,33.3%,1h
15527,1,[你好抱歉]绫濑川修也,2620,88,2,8,10,20.0%,17m
15527,2,[在下萌新一只]伤逝,2620,0,1,1,2,50.0%,17m
15527,3,oldkingdead,2620,0,1,2,3,33.3%,48m
15527,2,Qiangwang,2620,0,0,1,1,0.0%,57m
15527,3,埃蒙,2620,0,0,1,1,0.0%,29m
15527,2,weygie,2620,0,0,1,1,0.0%,4m
15527,3,Roger,2620,0,0,2,2,0.0%,1h
15547,3,Deep,2619,1330,312,299,611,51.1%,18m
15547,1,ywr,2619,1643,255,244,499,51.1%,10m
15547,1,QDxun,2619,1658,79,83,162,48.8%,49m
15547,2,无敌,2619,848,30,35,65,46.2%,28m
15547,1,开智同学,2619,334,18,13,31,58.1%,15m
15547,2,慢点慢点,2619,401,15,16,31,48.4%,27m
15547,2,渣渣催,2619,148,6,4,10,60.0%,1h
15547,2,dwc,2619,144,5,4,9,55.6%,16m
15547,1,冈野大尉,2619,0,3,2,5,60.0%,45m
15547,3,好奇的猫,2619,120,3,4,7,42.9%,1h
15547,1,[o唔姆o]白门楼的阶梯,2619,94,3,5,8,37.5%,28m
15547,1,[然哥强无敌]Sam,2619,0,2,3,5,40.0%,60m
15547,2,[柚子she]钰麒麟,2619,70,2,3,5,40.0%,40m
15547,2,[NPUED]阿撒托斯,2619,30,1,1,2,50.0%,38m
15547,1,[幽灵闪现wo]overlord,2619,0,1,2,3,33.3%,33m
15547,1,暗河魅影,2619,0,1,3,4,25.0%,23m
15547,3,末影之龙,2619,0,1,4,5,20.0%,28m
15547,2,武学凯萨兰德,2619,0,0,1,1,0.0%,40m
15565,3,[钟欣潼]关羽,2618,1545,148,148,296,50.0%,8m
15565,2,Sickle,2618,1429,71,64,135,52.6%,1h
15565,3,[寄葉丶]涂山红红丶,2618,1045,61,74,135,45.2%,26m
15565,1,ZERO,2618,1173,50,52,102,49.0%,34m
15565,3,二比光环,2618,168,44,36,80,55.0%,8m
15565,1,[蓝天白云]未闻花名,2618,550,25,24,49,51.0%,1h
15565,1,[暴雪三队]简单电脑,2618,385,17,16,33,51.5%,26m
15565,1,李欣怡,2618,499,16,16,32,50.0%,1h
15565,1,黑色咏叹,2618,481,16,17,33,48.5%,10m
15565,2,wemkerman,2618,327,12,7,19,63.2%,1h
15565,1,[哟哟切克闹]柔客,2618,395,12,14,26,46.2%,26m
15565,3,KurtLyon,2618,263,11,13,24,45.8%,1h
15565,1,Perfect,2618,204,7,4,11,63.6%,1h
15565,2,[CPT]宝石怡情,2618,166,7,6,13,53.8%,1h
15565,1,[最菜战队]流川楓,2618,216,7,10,17,41.2%,38m
15565,2,IIIIIIIIIIII,2618,118,5,3,8,62.5%,1h
15565,2,[零点五个菜鸟]tossgirls,2618,60,3,4,7,42.9%,1h
15565,3,oLOVEo,2618,97,3,4,7,42.9%,1h
15565,3,[灬全员白给灬]xchxxd,2618,151,3,5,8,37.5%,1h
15565,2,[超实验级的]wrh,2618,32,2,1,3,66.7%,1h
15565,1,ZOOM,2618,76,2,9,11,18.2%,14m
15565,2,杉先生,2618,0,1,0,1,100.0%,42m
15565,2,[SF666]永夜的极光,2618,0,0,1,1,0.0%,40m
15565,1,[Eason]我讯话筒在飞,2618,0,0,4,4,0.0%,1h
15589,1,[是我赢了]逐秋,2617,1531,66,56,122,54.1%,1h
15589,3,安装,2617,395,17,18,35,48.6%,5m
15589,1,Devil,2617,530,17,20,37,45.9%,14m
15589,2,puzhenwei,2617,309,16,8,24,66.7%,15m
15589,2,暮烟,2617,316,13,6,19,68.4%,25m
15589,2,[Xiaod威]亚盾之矛发射,2617,391,13,13,26,50.0%,28m
15589,1,腿毛怪,2617,364,11,11,22,50.0%,1h
15589,1,我生已晚,2617,293,11,12,23,47.8%,34m
15589,1,绝活多线送兵,2617,138,5,7,12,41.7%,33m
15589,3,赤麟,2617,97,4,2,6,66.7%,1h
15589,3,[人生一场虚空]大风之心,2617,97,3,4,7,42.9%,1h
15589,1,[基金会]神圣联盟,2617,56,3,7,10,30.0%,1h
15589,2,[炸鱼biss]Lenor,2617,58,2,2,4,50.0%,57m
15589,1,不许黑大主教,2617,0,2,3,5,40.0%,1h
15589,3,苏王,2617,0,2,4,6,33.3%,60m
15589,1,莲叶舟中,2617,130,2,6,8,25.0%,1h
15589,2,航母出击,2617,0,1,1,2,50.0%,1h
15589,2,夜刃灬极夜,2617,30,1,2,3,33.3%,37m
15589,1,IlIlIIllII,2617,96,1,4,5,20.0%,1h
15589,2,Meanwcharon,2617,0,0,1,1,0.0%,1h
15589,2,[萌新集结地]back,2617,0,0,1,1,0.0%,1h
15589,1,[四宮辉夜]KAOfish,2617,0,0,2,2,0.0%,1h
15611,1,我很菜但我喜爱,2616,1573,140,133,273,51.3%,44m
15611,1,阿修,2616,860,108,99,207,52.2%,1h
15611,1,北殇,2616,1260,55,47,102,53.9%,1h
15611,1,[化学工厂]wwzz,2616,1294,53,52,105,50.5%,14m
15611,1,ncnbboy,2616,748,43,25,68,63.2%,49m
15611,1,[XXHZ36]新海天,2616,618,36,24,60,60.0%,28m
15611,1,雷诺,2616,166,14,17,31,45.2%,24m
15611,2,[柠檬保护协会]SuperLemon,2616,202,7,4,11,63.6%,15m
15611,3,[达拉姆督察]Juggernaut,2616,170,5,16,21,23.8%,24m
15611,3,Perfect,2616,129,3,0,3,100.0%,1h
15611,1,RUA,2616,0,2,3,5,40.0%,1h
15611,1,爷爷的爷爷,2616,0,2,3,5,40.0%,1h
15611,3,狂屠,2616,0,2,4,6,33.3%,1h
15611,2,[堕落之城]深田,2616,0,1,0,1,100.0%,37m
15611,2,[丨SLT丨]memory,2616,0,1,0,1,100.0%,17m
15611,3,零式,2616,0,1,0,1,100.0%,42m
15611,2,[最菜战队]我好菜我想变强,2616,32,1,4,5,20.0%,1h
15611,2,joker,2616,0,0,1,1,0.0%,30m
15611,2,你猜,2616,0,0,2,2,0.0%,44m
15630,1,[纯新手]剑阁踏天下,2615,1580,177,174,351,50.4%,44m
15630,1,[幼女萝莉同好]次元无限,2615,903,69,63,132,52.3%,27m
15630,2,[星之所在RI]位面翻转的天灾星,2615,202,9,8,17,52.9%,1h
15630,3,[异度黑核侵蚀]工口烧酒一伊莉雅,2615,168,8,1,9,88.9%,1h
15630,2,Boomfire,2615,262,8,10,18,44.4%,17m
15630,1,DUKE,2615,232,7,9,16,43.8%,14m
15630,2,blackhumor,2615,104,4,6,10,40.0%,1h
15630,2,[VCT]Ryta,2615,93,2,1,3,66.7%,1h
15630,1,DirecterFG,2615,0,2,3,5,40.0%,19m
15630,3,没事亮亮蛋,2615,0,2,4,6,33.3%,1h
15630,1,奔雷手,2615,48,2,7,9,22.2%,60m
15630,3,[基金会]一云,2615,30,2,9,11,18.2%,10m
15630,2,[要啥没啥爱咋]西尔维斯特,2615,0,1,0,1,100.0%,1h
15630,2,茜晖,2615,0,1,1,2,50.0%,57m
15630,3,[ICHYI]普罗托斯,2615,0,0,2,2,0.0%,1h
15645,2,[贪得无厌]爱喝冰峰,2614,1481,65,55,120,54.2%,1h
15645,2,我只想守护你,2614,390,44,39,83,53.0%,57m
15645,2,光环,2614,712,32,22,54,59.3%,1h
15645,2,[温柔兔公主]菜不是我的错,2614,758,31,28,59,52.5%,37m
15645,2,vonSolIII,2614,550,23,19,42,54.8%,8m
15645,2,masquerade,2614,272,12,13,25,48.0%,1h
15645,1,淡然,2614,230,8,11,19,42.1%,1h
15645,1,瓶邪,2614,168,5,12,17,29.4%,3m
15645,1,石头打蛋,2614,97,3,4,7,42.9%,9m
15645,2,[北京大学鸡协]Helium,2614,94,2,0,2,100.0%,1h
15645,1,死亡火腿肠盖饭,2614,0,2,3,5,40.0%,43m
15645,3,darklong,2614,30,2,10,12,16.7%,17m
15645,2,[中二疯人院]wangzhe,2614,0,1,0,1,100.0%,38m
15645,2,暗裔丶剑魔,2614,0,1,0,1,100.0%,38m
15645,3,[狂风暴风雨]星耀,2614,0,0,1,1,0.0%,1h
15645,2,Riche,2614,0,0,1,1,0.0%,1h
15645,2,LUCKYBABY,2614,0,0,2,2,0.0%,1h
15662,1,轩墨宝宝,2613,1655,637,650,1287,49.5%,10m
15662,3,[浴火银河]爸爸,2613,287,36,37,73,49.3%,29m
15662,2,[叫醒我]纳兰性德,2613,324,28,45,73,38.4%,3m
15662,2,ghost,2613,448,23,19,42,54.8%,13m
15662,1,funeral,2613,495,21,20,41,51.2%,54m
15662,2,有丶怠惰,2613,469,19,9,28,67.9%,1h
15662,1,[曾经一群兔兔]古楚小狼,2613,396,12,16,28,42.9%,18m
15662,1,sancky,2613,301,11,7,18,61.1%,24m
15662,2,千玥,2613,183,9,8,17,52.9%,57m
15662,2,茉沫,2613,212,7,7,14,50.0%,1h
15662,2,wrath,2613,58,3,0,3,100.0%,28m
15662,1,丰哥,2613,46,2,0,2,100.0%,52m
15662,2,noahonline,2613,0,2,5,7,28.6%,49m
15662,2,年轻人要讲武德,2613,0,1,0,1,100.0%,53m
15662,1,[混元极意星际]我说了算,2613,0,1,0,1,100.0%,60m
15662,2,zzz,2613,0,1,1,2,50.0%,1h
15662,3,[熊与猫]相见无期,2613,0,0,1,1,0.0%,46m
15662,2,死之歌,2613,0,0,2,2,0.0%,46m
15680,2,龍族老狗,2612,922,42,32,74,56.8%,28m
15680,2,不想被虐的小探姬,2612,716,40,30,70,57.1%,1h
15680,2,[Rhusky]我是条码人,2612,606,25,16,41,61.0%,1h
15680,2,草莓味布丁吖,2612,171,6,1,7,85.7%,27m
15680,2,辰夕,2612,186,6,7,13,46.2%,21m
15680,2,[艾尔之名]魔法少女北月酱,2612,160,5,1,6,83.3%,18m
15680,2,天梯鸡饲料,2612,150,5,2,7,71.4%,25m
15680,2,星际霸主一奥特曼,2612,92,5,3,8,62.5%,10m
15680,1,lalala,2612,162,4,5,9,44.4%,1h
15680,1,天帝之锤,2612,163,3,4,7,42.9%,31m
15680,1,安康,2612,102,3,8,11,27.3%,36m
15680,2,大主教万岁,2612,30,2,0,2,100.0%,1h
15680,1,[萌兔子吖]兔兔傻白甜,2612,0,2,3,5,40.0%,1h
15680,1,Alexx,2612,74,2,6,8,25.0%,1h
15680,1,[花影]Starry,2612,97,2,16,18,11.1%,1h
15680,2,一直在挨打的冻冻,2612,30,1,1,2,50.0%,16m
15680,2,[充气团]幻灵,2612,0,0,1,1,0.0%,37m
15680,3,玩失忆,2612,0,0,1,1,0.0%,1h
15680,2,刘林海的爹,2612,0,0,1,1,0.0%,1h
15680,1,SoYMiLk,2612,0,0,1,1,0.0%,60m
15700,1,IIIIIIIIIIII,2611,1586,215,222,437,49.2%,15m
15700,2,[上海大学]欢迎报考上海大学,2611,1108,69,67,136,50.7%,13m
15700,2,粗粗带你飞,2611,691,33,24,57,57.9%,32m
15700,2,IIIIIIIIIII,2611,402,17,17,34,50.0%,1h
15700,1,zcly,2611,405,17,17,34,50.0%,1h
15700,3,和尚洗头用飘柔,2611,407,17,17,34,50.0%,30m
15700,1,烧饼包子,2611,423,16,13,29,55.2%,1h
15700,1,孤独的狼,2611,252,7,11,18,38.9%,28m
15700,3,RenaiSsancE,2611,238,7,12,19,36.8%,32m
15700,1,宇宙炼铜第一人,2611,198,7,14,21,33.3%,17m
15700,2,爱情,2611,206,6,4,10,60.0%,1h
15700,2,千里烟波,2611,42,5,5,10,50.0%,53m
15700,2,帅的睡不着,2611,167,5,6,11,45.5%,1h
15700,2,[Mica]别人家的小孩,2611,126,4,0,4,100.0%,10m
15700,2,卡卡勇士,2611,111,4,6,10,40.0%,1h
15700,1,绝杀迷人阵,2611,33,3,5,8,37.5%,1h
15700,2,天下无敌,2611,30,2,0,2,100.0%,1h
15700,3,联川,2611,0,2,4,6,33.3%,58m
15700,2,[wean]阿拉纳克,2611,0,1,0,1,100.0%,40m
15700,2,死审,2611,0,1,2,3,33.3%,28m
15700,2,花泽类,2611,0,1,2,3,33.3%,8m
15700,1,dew,2611,0,0,1,1,0.0%,46m
15722,1,LoveTT,2610,834,135,136,271,49.8%,1h
15722,3,呆呆兽,2610,751,82,84,166,49.4%,29m
15722,2,INnoVation,2610,1438,56,51,107,52.3%,1h
15722,1,[瘾大眼瞎]唐诗,2610,948,45,49,94,47.9%,14m
15722,2,子丶轩,2610,753,29,29,58,50.0%,28m
15722,1,[皓蒙之剑]PEC,2610,423,17,12,29,58.6%,28m
15722,1,[神说要有手残]血月,2610,360,12,15,27,44.4%,1h
15722,1,子兮不懂人族,2610,383,11,17,28,39.3%,10m
15722,2,兜销丶面包,2610,171,9,6,15,60.0%,38m
15722,2,秋风带走的一片叶,2610,264,9,9,18,50.0%,16m
15722,2,[拆迁办事处]科普卢拆迁办,2610,245,8,10,18,44.4%,1h
15722,3,TRHRD,2610,0,4,2,6,66.7%,1h
15722,1,[我怎么没兵了]死神爱吃苹果,2610,0,4,5,9,44.4%,24m
15722,1,秀一脸,2610,120,3,4,7,42.9%,10m
15722,3,咱可是贤狼赫萝,2610,110,3,5,8,37.5%,47m
15722,2,[大爱星际二]呆萌小彩笔,2610,92,3,6,9,33.3%,1h
15722,1,看见,2610,96,2,1,3,66.7%,1h
15722,1,我爱吃番茄,2610,76,2,8,10,20.0%,1h
15722,2,[汉堡FANS]晨曦,2610,0,1,0,1,100.0%,19m
15722,2,[风流倜傥]吼吼吼吼吼李,2610,30,1,1,2,50.0%,27m
15722,2,艾尔之刃,2610,30,1,2,3,33.3%,30m
15722,2,gtyfyf,2610,0,1,5,6,16.7%,1h
15722,1,玄武,2610,46,1,7,8,12.5%,24m
15722,2,神谕,2610,0,0,1,1,0.0%,19m
15746,2,笑看,2609,1309,55,49,104,52.9%,14m
15746,2,新手,2609,580,27,27,54,50.0%,1h
15746,2,[毁灭降临]JokerErduo,2609,602,26,24,50,52.0%,1h
15746,1,Too,2609,627,25,25,50,50.0%,3m
15746,2,morphling,2609,443,20,6,26,76.9%,1h
15746,1,[鸽德]所罗门的疯狗,2609,303,17,17,34,50.0%,26m
15746,3,小狂孩儿,2609,337,13,11,24,54.2%,1h
15746,1,[罗马方标]BNEYE,2609,295,12,11,23,52.2%,1h
15746,2,[小鸡屠宰场a]QZCSUPER,2609,344,12,13,25,48.0%,1h
15746,2,无为,2609,118,5,2,7,71.4%,1h
15746,2,[冲就完了]卧枕盼星还,2609,118,5,3,8,62.5%,32m
15746,1,盛夏琉璃空人心,2609,46,5,5,10,50.0%,30m
15746,2,[BereTA]SKy,2609,60,3,2,5,60.0%,1h
15746,3,waddde,2609,0,3,3,6,50.0%,1h
15746,2,KLH,2609,88,3,4,7,42.9%,1h
15746,1,年轻人不讲武德,2609,144,3,8,11,27.3%,4m
15746,3,[我们是瞎子]远程小能手,2609,0,1,0,1,100.0%,46m
15746,2,jacklu,2609,0,1,0,1,100.0%,15m
15746,3,[世风第三帝国]汗水宝宝,2609,0,0,1,1,0.0%,1h
15746,1,Lky,2609,0,0,1,1,0.0%,1h
15746,2,不死灰熊,2609,0,0,1,1,0.0%,55m
15746,2,miuser,2609,0,0,1,1,0.0%,28m
15746,3,姜五,2609,0,0,2,2,0.0%,19m
15769,3,asdas,2608,1203,123,120,243,50.6%,24m
15769,1,[在下萌新一只]有星际好玩吗,2608,1190,94,95,189,49.7%,1h
15769,1,[雪乃万岁]wkw,2608,676,56,50,106,52.8%,1h
15769,2,lililililili,2608,614,25,15,40,62.5%,38m
15769,2,[darry]夕月,2608,502,17,15,32,53.1%,57m
15769,1,[老头星际]比企谷彩加,2608,346,13,11,24,54.2%,19m
15769,1,帝国之鹰,2608,372,13,15,28,46.4%,1h
15769,2,德莉大聪明,2608,262,9,5,14,64.3%,1h
15769,1,[镇魂]UFine,2608,219,8,0,8,100.0%,1h
15769,3,枪兵的命也是命,2608,204,8,3,11,72.7%,1h
15769,2,[川北电竞]水水大王,2608,209,8,4,12,66.7%,18m
15769,2,躺赢少年,2608,0,3,2,5,60.0%,1h
15769,3,[快乐地做人]Cain,2608,97,3,4,7,42.9%,15m
15769,1,[是我赢了]BuryTheLight,2608,0,2,2,4,50.0%,1h
15769,1,君莫笑,2608,0,2,3,5,40.0%,43m
15769,1,[TLKH]king,2608,64,2,6,8,25.0%,1h
15769,1,天地噬魂,2608,40,1,5,6,16.7%,10m
15786,2,[中华讲武堂]海归富婆重金求子,2607,1543,165,159,324,50.9%,42m
15786,2,KnightRL,2607,732,32,24,56,57.1%,42m
15786,2,[丨SLT丨]lllllllllill,2607,594,26,13,39,66.7%,1h
15786,2,JerkJ,2607,447,21,8,29,72.4%,1h
15786,1,[白丝萝莉赛高]犬走椛,2607,503,19,18,37,51.4%,10m
15786,2,回航,2607,331,12,15,27,44.4%,28m
15786,2,hank,2607,276,11,11,22,50.0%,1h
15786,2,唧唧歪歪啰里啰嗦,2607,277,10,7,17,58.8%,19m
15786,1,wdnmd,2607,145,9,5,14,64.3%,53m
15786,1,极限大龙虾,2607,258,9,10,19,47.4%,1h
15786,2,[死爸一笑]不讲武德,2607,204,8,6,14,57.1%,37m
15786,3,[打铁自身硬]Destory,2607,190,7,14,21,33.3%,59m
15786,2,evolee,2607,151,5,2,7,71.4%,8m
15786,2,sOs,2607,138,4,1,5,80.0%,1h
15786,2,[幻想乐园计划]射命丸文,2607,139,3,3,6,50.0%,1h
15786,1,IIIIIlllllII,2607,44,2,1,3,66.7%,14m
15786,2,屠人雄窃国候,2607,44,2,1,3,66.7%,1h
15786,1,[玫瑰十字会]故梦远殇,2607,0,2,3,5,40.0%,4m
15786,1,小小旺,2607,0,2,3,5,40.0%,28m
15786,2,愤怒的小鸡,2607,0,1,0,1,100.0%,1h
15786,2,水余三金石,2607,0,1,0,1,100.0%,1h
15786,2,驱逐船,2607,0,1,0,1,100.0%,13m
15786,2,GeekShow,2607,0,1,2,3,33.3%,27m
15786,1,Dopeman,2607,0,1,3,4,25.0%,4m
15786,1,无敌康桑,2607,0,0,1,1,0.0%,16m
15811,1,易易生生一,2606,1583,303,295,598,50.7%,1h
15811,3,ybltc,2606,1042,65,56,121,53.7%,3m
15811,2,[落魄山]落叶,2606,421,34,26,60,56.7%,10m
15811,1,风流倜傥丶花爷,2606,766,28,25,53,52.8%,1h
15811,1,玉衡,2606,273,21,17,38,55.3%,3m
15811,2,训练有素的医生,2606,355,19,5,24,79.2%,13m
15811,2,Valerian,2606,276,11,8,19,57.9%,1h
15811,1,她曾经来过,2606,0,5,0,5,100.0%,1h
15811,2,阳聪,2606,140,5,1,6,83.3%,1h
15811,3,[EZ4XYY]Udonkey,2606,175,5,7,12,41.7%,1h
15811,2,[北极光小组]雷神,2606,118,4,4,8,50.0%,42m
15811,2,[TCP]Ghostfan,2606,86,4,4,8,50.0%,12m
15811,2,Recur,2606,0,3,2,5,60.0%,28m
15811,2,舞法天女黄旭东,2606,86,3,4,7,42.9%,10m
15811,2,是可爱的鑫鑫鸭,2606,0,3,4,7,42.9%,12m
15811,2,张作翔,2606,97,2,3,5,40.0%,37m
15811,2,aaaa,2606,64,2,6,8,25.0%,1h
15811,2,keli,2606,0,1,0,1,100.0%,28m
15811,2,路明非,2606,0,1,0,1,100.0%,27m
15811,2,SlientStirm,2606,0,1,0,1,100.0%,1h
15811,3,[剑桥斧头帮]七柒祁祈,2606,0,1,0,1,100.0%,41m
15811,2,[火焰雷兽]梦魇灬华尔兹,2606,0,1,1,2,50.0%,27m
15811,2,[deaday]影流之魅,2606,44,1,5,6,16.7%,51m
15811,3,lake,2606,30,1,6,7,14.3%,1h
15835,1,一梦入泡,2605,1578,75,68,143,52.4%,1h
15835,2,[超实验级的]毕奥,2605,297,18,11,29,62.1%,1h
15835,1,时雨泠月,2605,478,18,20,38,47.4%,50m
15835,2,[XYFANS]尼哥,2605,299,12,5,17,70.6%,51m
15835,1,爱雯子真是太好啦,2605,211,9,7,16,56.2%,1h
15835,1,zjhzjh,2605,264,9,13,22,40.9%,12m
15835,1,[装大佬的鸡]蟹黄,2605,48,5,1,6,83.3%,20m
15835,2,毒奶不削星际必亡,2605,164,5,6,11,45.5%,1h
15835,2,[混元体我女仆]梦尘,2605,186,5,8,13,38.5%,1h
15835,2,[西湖底安保队]誓不投降法兰西,2605,112,3,0,3,100.0%,41m
15835,1,Aflame,2605,48,3,3,6,50.0%,1h
15835,2,休伯利安号舰长,2605,30,2,2,4,50.0%,42m
15835,1,rinima,2605,48,2,4,6,33.3%,45m
15835,1,[小鸡屠宰场a]鬼魂之龙,2605,68,2,7,9,22.2%,1h
15835,1,[星之所在RI]迷宫十字向右拐,2605,70,2,7,9,22.2%,1h
15835,2,[一口毒奶]悲一一忘记,2605,0,1,0,1,100.0%,55m
15835,2,[梦的第七章]尢落花海樱似梦,2605,30,1,1,2,50.0%,1h
15835,2,遗忘空间,2605,0,0,1,1,0.0%,13m
15853,3,[编一个战队名]一个不留,2604,439,34,33,67,50.7%,9m
15853,2,DeaceGrace,2604,366,30,22,52,57.7%,18m
15853,1,我剑圣跑得跟风一,2604,527,25,24,49,51.0%,1h
15853,2,Timber,2604,231,24,15,39,61.5%,30m
15853,1,[人族不配赢]五秒,2604,342,13,12,25,52.0%,20m
15853,2,wxw,2604,368,11,18,29,37.9%,1h
15853,1,[金盾男科医院]杨医生,2604,292,10,4,14,71.4%,51m
15853,2,zzz,2604,196,7,7,14,50.0%,37m
15853,2,MAGIC,2604,154,6,4,10,60.0%,1h
15853,2,惹不起的爸爸,2604,62,3,1,4,75.0%,1h
15853,3,飞龍在天,2604,97,1,2,3,33.3%,1h
15853,2,[XXHZ7]兄弟盟放我狗命,2604,0,0,1,1,0.0%,1h
15853,2,白给一号,2604,0,0,1,1,0.0%,1h
15853,2,面壁者泰勒奥瑞斯,2604,0,0,1,1,0.0%,15m
15853,2,正体不明,2604,0,0,1,1,0.0%,11m
15853,2,误点的闹钟,2604,0,0,3,3,0.0%,1h
15869,2,wys,2603,841,32,29,61,52.5%,1h
15869,1,小春,2603,762,31,25,56,55.4%,1h
15869,2,OptiMissTake,2603,372,14,10,24,58.3%,1h
15869,1,陈年老菜鸟,2603,249,13,11,24,54.2%,1h
15869,2,[野生的菜鸡]狼哥天下浪,2603,310,12,9,21,57.1%,28m
15869,1,[誓约殿堂]Lou,2603,263,11,10,21,52.4%,1h
15869,2,[暴雪三十队]baotoufuyun,2603,237,10,4,14,71.4%,1h
15869,2,空灵战甲,2603,259,9,7,16,56.2%,10m
15869,1,苏皖的,2603,220,8,9,17,47.1%,1h
15869,2,dtMAGA,2603,156,5,2,7,71.4%,1h
15869,3,逮住就是笋干缪撒,2603,121,5,3,8,62.5%,1h
15869,3,ntzzx,2603,121,5,3,8,62.5%,8m
15869,2,战丶狼,2603,102,3,1,4,75.0%,1h
15869,3,我叫紫妈怎么了嘛,2603,40,3,5,8,37.5%,34m
15869,3,[帝国公约]空中劈叉老舰长,2603,97,2,1,3,66.7%,8m
15869,1,骨砖血泥,2603,0,2,3,5,40.0%,1h
15869,2,石家庄陈坤,2603,36,1,2,3,33.3%,37m
15869,2,[捌柒柒叁]杨具铠,2603,30,1,5,6,16.7%,38m
15869,2,cen,2603,0,0,2,2,0.0%,1h
15869,2,[为星光而战]Mliu,2603,0,0,3,3,0.0%,1h
15869,3,[时光与酒oc]三亿萝莉的梦,2603,0,0,5,5,0.0%,1h
15869,1,墨羽,2603,0,0,5,5,0.0%,49m
15891,1,真有我的,2602,381,29,28,57,50.9%,17m
15891,1,菜石子,2602,439,20,24,44,45.5%,24m
15891,1,[人菜灬瘾大]TinaAI,2602,441,18,17,35,51.4%,33m
15891,2,追后天十,2602,388,14,15,29,48.3%,32m
15891,2,不可名状之物,2602,240,10,2,12,83.3%,28m
15891,2,[C01680]lyh,2602,286,9,11,20,45.0%,51m
15891,3,阿炜不俊,2602,218,8,15,23,34.8%,29m
15891,3,敛剑,2602,120,6,1,7,85.7%,1h
15891,3,IIIIIIIIIIII,2602,38,5,3,8,62.5%,1h
15891,2,哎呦,2602,58,3,1,4,75.0%,1h
15891,3,不灭帝皇,2602,125,3,1,4,75.0%,23m
15891,1,一城,2602,0,3,6,9,33.3%,1h
15891,1,WhoWhatIAm,2602,0,2,3,5,40.0%,16m
15891,3,[京城特务]佳辰,2602,0,2,4,6,33.3%,59m
15891,2,RunXimena,2602,86,2,5,7,28.6%,19m
15891,1,[秋毫]陈半仙的老庙,2602,0,1,0,1,100.0%,40m
15891,2,狩魔猎刀,2602,0,1,1,2,50.0%,16m
15891,2,Blackmoon,2602,30,1,3,4,25.0%,10m
15891,1,nescafe,2602,0,1,4,5,20.0%,1h
15891,2,[四零七]Myage,2602,0,0,1,1,0.0%,51m
15891,2,[神圣的大佐]tangxp,2602,0,0,1,1,0.0%,1h
15891,2,Kerrigan,2602,0,0,2,2,0.0%,1h
15891,2,笙箫昭玖,2602,0,0,2,2,0.0%,12m
15891,2,Aquarius,2602,0,0,4,4,0.0%,1h
15915,3,精致绽蓝,2601,1061,57,63,120,47.5%,32m
15915,3,Train,2601,1507,53,84,137,38.7%,4m
15915,2,DisDoR,2601,564,23,31,54,42.6%,28m
15915,2,[灬红萌馆灬]上善若水,2601,452,16,17,33,48.5%,1h
15915,2,silence,2601,351,15,5,20,75.0%,1h
15915,3,ForeverEgg,2601,422,14,19,33,42.4%,59m
15915,2,黑白信仰,2601,250,8,8,16,50.0%,1h
15915,2,[皮很痒求锤]小虫,2601,180,7,6,13,53.8%,15m
15915,1,嘿嘿嘿,2601,255,7,16,23,30.4%,17m
15915,2,艾思徽尔,2601,152,6,6,12,50.0%,1h
15915,2,Bulldandy,2601,181,6,7,13,46.2%,1h
15915,2,[点到为止]DeadlyBloom,2601,143,5,8,13,38.5%,57m
15915,3,吴曦,2601,121,4,2,6,66.7%,1h
15915,1,寻欢,2601,0,3,2,5,60.0%,54m
15915,3,银翼之烬,2601,0,3,2,5,60.0%,49m
15915,2,[浴火银河]Thappy,2601,88,1,1,2,50.0%,13m
15915,2,[基金会]浅山藏,2601,0,0,1,1,0.0%,1h
15915,2,[艾尔动漫协会]凯申物流,2601,0,0,1,1,0.0%,30m
15933,2,雨点,2600,1361,61,58,119,51.3%,1h
15933,2,波波多喝糖水,2600,1185,47,41,88,53.4%,1h
15933,1,SturmKrieger,2600,665,27,26,53,50.9%,10m
15933,2,尸之东偶,2600,619,22,20,42,52.4%,13m
15933,2,[NVKR]跳跳虎,2600,375,16,8,24,66.7%,19m
15933,2,[小菜逼]lllyyy,2600,371,15,8,23,65.2%,30m
15933,2,priority,2600,357,14,15,29,48.3%,42m
15933,2,GFGS,2600,215,7,5,12,58.3%,1h
15933,1,[暗夜王牌]Rocket,2600,53,5,9,14,35.7%,18m
15933,2,[星之所在RI]环忧,2600,108,3,0,3,100.0%,1h
15933,2,需要重新集结部队,2600,57,3,1,4,75.0%,16m
15933,2,[博云星际学院]浮夸与胖子,2600,60,3,3,6,50.0%,1h
15933,1,小熊猫,2600,119,3,3,6,50.0%,52m
15933,1,核弹倒计时,2600,0,3,6,9,33.3%,1h
15933,3,我老婆方可萱,2600,97,2,0,2,100.0%,1h
15933,1,哇哇,2600,0,2,3,5,40.0%,1h
15933,2,心痕,2600,0,2,5,7,28.6%,1h
15933,2,一一一一,2600,0,1,0,1,100.0%,8m
15933,3,yzq,2600,0,1,0,1,100.0%,1h
15933,2,宫小路由绘,2600,0,1,0,1,100.0%,57m
15933,3,llllllllllll,2600,0,1,0,1,100.0%,55m
15933,1,忘川失了魂,2600,0,0,1,1,0.0%,1h
15933,2,打不过人机,2600,0,0,1,1,0.0%,1h
15933,2,breeze,2600,0,0,1,1,0.0%,1h
15933,1,愤怒的探机,2600,0,0,1,1,0.0%,1h
15958,3,[XXHZ17]深蓝,2599,1158,137,124,261,52.5%,10m
15958,2,[LOHv]彷徨亡者,2599,376,103,100,203,50.7%,1h
15958,2,亦似花洛亦似霞,2599,1068,52,44,96,54.2%,1h
15958,1,琉璃殿主,2599,274,9,15,24,37.5%,38m
15958,2,我用脚玩谢谢,2599,202,7,7,14,50.0%,1h
15958,2,闪电海中做自己,2599,124,6,4,10,60.0%,1h
15958,2,一时想出来的名字,2599,140,5,2,7,71.4%,1h
15958,2,不要停下来啊,2599,60,3,1,4,75.0%,1h
15958,3,帅虎,2599,121,3,4,7,42.9%,1h
15958,2,Jessie,2599,113,2,2,4,50.0%,60m
15958,1,[神族可以删了]LLX,2599,88,2,3,5,40.0%,1h
15958,1,[塔达林升格]焚铭衍坤机,2599,0,2,3,5,40.0%,4m
15958,2,骷髅乞丐,2599,62,2,4,6,33.3%,1h
15958,3,老夫,2599,0,2,4,6,33.3%,57m
15958,2,古道西风瘦马,2599,30,1,1,2,50.0%,1h
15958,2,新手电脑,2599,30,1,2,3,33.3%,1h
15958,1,Ophelia,2599,0,0,1,1,0.0%,1h
15958,3,[框本之魂]衣鹤大人征服世界,2599,0,0,1,1,0.0%,1h
15976,2,艾泽拉斯使者,2598,1552,402,402,804,50.0%,13m
15976,2,[4058]刘阳,2598,1450,170,169,339,50.1%,28m
15976,1,[ZTSCAP]JOKE,2598,815,43,13,56,76.8%,36m
15976,2,圣母,2598,894,34,30,64,53.1%,32m
15976,1,简单,2598,875,32,29,61,52.5%,1h
15976,2,yycc,2598,391,15,13,28,53.6%,19m
15976,1,Lemom,2598,309,12,17,29,41.4%,1h
15976,2,十二丶门狂,2598,105,10,4,14,71.4%,16m
15976,2,脑袋带回,2598,158,9,7,16,56.2%,1h
15976,1,凹凹,2598,236,8,11,19,42.1%,28m
15976,3,SNRI,2598,121,5,4,9,55.6%,31m
15976,3,Dechets,2598,0,4,2,6,66.7%,1h
15976,2,ACzl,2598,152,4,2,6,66.7%,28m
15976,3,核动力小蜗牛,2598,0,4,3,7,57.1%,1h
15976,3,POMIKE,2598,129,3,1,4,75.0%,1h
15976,1,ameame,2598,137,3,4,7,42.9%,20m
15976,1,[此用户已成仙]晓之车,2598,36,3,5,8,37.5%,28m
15976,2,[HEU]艾尔第一皮,2598,30,2,2,4,50.0%,1h
15976,3,[TGone]朗个嫩锅骚,2598,42,1,6,7,14.3%,19m
15976,2,[星际丨猎妈人]指挥官,2598,0,0,1,1,0.0%,51m
15996,2,沉默之剑,2597,924,73,63,136,53.7%,1h
15996,2,爱福了友,2597,953,35,33,68,51.5%,1h
15996,2,惩罚者,2597,535,24,16,40,60.0%,38m
15996,1,卓耿,2597,556,23,21,44,52.3%,27m
15996,1,魔术星际,2597,630,20,24,44,45.5%,1h
15996,2,[菜鸡喵]森木下士,2597,246,14,7,21,66.7%,1h
15996,2,水封,2597,383,13,17,30,43.3%,1h
15996,2,Pstar,2597,244,6,8,14,42.9%,1h
15996,1,lwl,2597,0,4,8,12,33.3%,34m
15996,2,[不知不觉天亮]海鸥,2597,58,3,1,4,75.0%,1h
15996,3,慈父蒙斯克,2597,97,3,3,6,50.0%,1h
15996,1,衍若寒,2597,68,3,4,7,42.9%,49m
15996,2,[麻酱万岁]llllllllllll,2597,62,3,5,8,37.5%,27m
15996,2,Kano,2597,93,3,5,8,37.5%,1h
15996,1,keanu,2597,0,2,3,5,40.0%,54m
15996,2,[THK9]水晶充盈着仇恨,2597,0,1,0,1,100.0%,10m
15996,2,[萌萌哒鸡]XUTING,2597,0,1,0,1,100.0%,1h
15996,3,[Mikon]萨古拉斯之刃,2597,97,1,1,2,50.0%,41m
16014,2,llllllllllll,2596,894,40,32,72,55.6%,1h
16014,2,[马氏太极拳]Gray,2596,752,37,30,67,55.2%,1h
16014,1,[联合动物园]窃格瓦拉本人,2596,859,33,34,67,49.3%,38m
16014,2,凯恩,2596,469,30,28,58,51.7%,10m
16014,1,隔壁有只小蚊子,2596,247,9,11,20,45.0%,1h
16014,2,丽塔,2596,188,7,6,13,53.8%,1h
16014,1,不可能胖,2596,214,7,6,13,53.8%,59m
16014,2,IIIIIIIIIIII,2596,151,5,0,5,100.0%,41m
16014,2,绯弹的奈亚子,2596,112,3,0,3,100.0%,1h
16014,3,你不会魔法,2596,97,3,4,7,42.9%,49m
16014,2,永恒,2596,0,1,0,1,100.0%,12m
16014,1,天山马鹿,2596,0,1,1,2,50.0%,1h
16014,1,Triste,2596,0,1,4,5,20.0%,3m
16014,2,wingswind,2596,0,0,1,1,0.0%,1h
16028,3,[loveMM]king,2595,1441,70,65,135,51.9%,29m
16028,1,铁十字,2595,398,40,37,77,51.9%,1h
16028,2,AmenaDieL,2595,443,18,16,34,52.9%,18m
16028,2,大肥蛇,2595,210,8,8,16,50.0%,1h
16028,1,[秋毫第五分队]JZMansanpai,2595,214,7,4,11,63.6%,59m
16028,3,victory,2595,97,3,4,7,42.9%,1h
16028,2,薛定谔的猫,2595,30,2,2,4,50.0%,1h
16028,2,jack,2595,58,2,3,5,40.0%,38m
16028,1,ices,2595,36,2,4,6,33.3%,18m
16028,3,卑鄙的泰伦人,2595,68,2,5,7,28.6%,59m
16028,2,白学家,2595,42,1,2,3,33.3%,1h
16028,3,[兄贵会]淑怡,2595,34,1,3,4,25.0%,34m
16028,3,爱你阿凡,2595,42,1,3,4,25.0%,1h
16028,3,langser,2595,0,0,2,2,0.0%,23m
16042,2,向风偏笑艳阳人,2594,590,48,38,86,55.8%,1h
16042,2,ICEYANG,2594,603,23,20,43,53.5%,1h
16042,1,[Angels]龍紋,2594,549,21,29,50,42.0%,49m
16042,3,[日爆德哈卡]kangkang,2594,443,17,18,35,48.6%,29m
16042,2,[XXG]枫舞,2594,186,6,7,13,46.2%,1h
16042,3,[万事皆允]苍穹之链,2594,30,3,5,8,37.5%,3m
16042,2,[今天谁在辱教]薄荷绿,2594,30,2,1,3,66.7%,57m
16042,2,哲言,2594,95,2,3,5,40.0%,40m
16042,2,[火焰雷兽]skzhujin,2594,0,1,0,1,100.0%,1h
16042,2,帕累没有托,2594,0,0,1,1,0.0%,10m
16042,2,无独新兰,2594,0,0,2,2,0.0%,1h
16042,1,无敌鬼残杀,2594,0,0,2,2,0.0%,3m
16042,2,原罪,2594,0,0,2,2,0.0%,1h
16055,1,行者,2593,822,35,30,65,53.8%,1h
16055,2,zzZ,2593,652,26,19,45,57.8%,1h
16055,2,[想考托福的]AnGeee,2593,312,11,8,19,57.9%,1h
16055,2,moon,2593,278,10,5,15,66.7%,16m
16055,2,[星歌]智勇双全秋风瑟,2593,311,10,10,20,50.0%,38m
16055,2,IDarkMoon,2593,203,6,1,7,85.7%,1h
16055,2,天玄威武,2593,169,4,4,8,50.0%,48m
16055,2,镜中人,2593,86,4,4,8,50.0%,16m
16055,2,强魔气,2593,62,3,3,6,50.0%,55m
16055,3,ByuN,2593,97,3,4,7,42.9%,1h
16055,1,小东西往哪跑,2593,68,3,5,8,37.5%,28m
16055,1,GOD,2593,97,3,8,11,27.3%,23m
16055,2,[SS天羽]foever,2593,0,1,0,1,100.0%,48m
16055,3,[春去冬来]Kinoko,2593,0,1,0,1,100.0%,1h
16055,2,klero,2593,88,1,1,2,50.0%,51m
16055,2,Tim,2593,0,1,1,2,50.0%,1h
16055,2,电竞章北海,2593,30,1,3,4,25.0%,18m
16055,2,[基金会]还木有,2593,0,0,1,1,0.0%,1h
16073,2,[全部折跃]集结部队,2592,1215,54,48,102,52.9%,14m
16073,2,aokou,2592,254,10,6,16,62.5%,1h
16073,2,lmhrtn,2592,288,9,8,17,52.9%,55m
16073,2,[SC2VIP]VIPSM,2592,184,7,6,13,53.8%,12m
16073,2,改名大师,2592,202,6,8,14,42.9%,28m
16073,2,[龙在野]孤狼天,2592,162,5,4,9,55.6%,1h
16073,2,我很菜,2592,139,4,6,10,40.0%,27m
16073,2,[28CM]鲨鱼的华尔兹,2592,44,4,6,10,40.0%,44m
16073,3,冻顶乌龙茶,2592,78,4,6,10,40.0%,8m
16073,3,杰森,2592,121,3,1,4,75.0%,1h
16073,2,[小浪FANS]Cookie,2592,139,3,3,6,50.0%,1h
16073,2,沸腾的鸡汤,2592,88,2,0,2,100.0%,18m
16073,2,qiqi,2592,102,2,2,4,50.0%,26m
16073,2,[式神]八云蓝,2592,30,1,1,2,50.0%,1h
16073,2,[小姐姐协会]你家大红狗,2592,30,1,3,4,25.0%,48m
16073,1,[暗狱]突丝猫,2592,40,1,3,4,25.0%,60m
16073,1,[Airfv]夜神灬月,2592,30,1,5,6,16.7%,1h
16073,2,小咖喱黄不辣,2592,0,0,1,1,0.0%,1h
16073,2,阿塔尼斯我大哥,2592,0,0,1,1,0.0%,57m
16073,2,玛卡巴卡,2592,0,0,2,2,0.0%,1h
16093,1,MarcusAureli,2591,1609,142,121,263,54.0%,44m
16093,2,Tfire,2591,552,137,141,278,49.3%,13m
16093,3,BlackPinkJ,2591,1526,79,79,158,50.0%,3m
16093,1,[社交学学者]星光之耀,2591,1081,48,35,83,57.8%,26m
16093,2,雾弥彼方,2591,421,16,18,34,47.1%,17m
16093,2,纯白之黑,2591,271,9,8,17,52.9%,1h
16093,1,Asher,2591,256,9,11,20,45.0%,1h
16093,3,VPZ,2591,258,9,18,27,33.3%,31m
16093,2,[中华兄弟会]李永浩,2591,184,7,2,9,77.8%,32m
16093,3,冰戮,2591,145,7,8,15,46.7%,1h
16093,1,天下名楼黄鹤楼,2591,232,7,14,21,33.3%,4m
16093,2,zxhwd,2591,88,4,2,6,66.7%,19m
16093,3,hggh,2591,0,3,3,6,50.0%,1h
16093,1,helloKitty,2591,62,3,6,9,33.3%,20m
16093,2,Evangeline,2591,132,3,6,9,33.3%,1h
16093,2,最初绝望,2591,0,1,0,1,100.0%,1h
16093,2,咕咕鸮,2591,0,1,0,1,100.0%,28m
16093,2,风澜舞,2591,0,1,0,1,100.0%,1h
16093,2,zyx,2591,88,1,1,2,50.0%,16m
16093,1,柒陆,2591,0,1,1,2,50.0%,58m
16093,2,[为了Amon]利姆露老爷,2591,30,1,3,4,25.0%,30m
16093,2,Snow,2591,0,1,3,4,25.0%,16m
16093,1,[北极光小组]七殇无言,2591,46,1,3,4,25.0%,34m
16093,3,暗毅丶然,2591,0,0,1,1,0.0%,44m
16117,1,灰原哀,2590,691,62,60,122,50.8%,1h
16117,1,神谕,2590,971,34,38,72,47.2%,3m
16117,1,cmzfb,2590,566,22,19,41,53.7%,1h
16117,2,孤月,2590,322,12,10,22,54.5%,1h
16117,2,zhu,2590,271,11,6,17,64.7%,52m
16117,1,[暴雪十一队]南桉,2590,352,10,13,23,43.5%,34m
16117,1,永远有多远嘞,2590,269,8,10,18,44.4%,41m
16117,2,ali,2590,215,6,9,15,40.0%,1h
16117,1,宇智波宇,2590,0,5,0,5,100.0%,1h
16117,2,辣辣的香蕉,2590,138,4,1,5,80.0%,3m
16117,1,caiiix,2590,119,3,1,4,75.0%,1h
16117,3,星海风暴,2590,34,3,5,8,37.5%,1h
16117,3,爱玩游戏的达桑,2590,0,0,1,1,0.0%,1h
16130,3,darkmaster,2589,800,33,38,71,46.5%,20m
16130,3,chlty,2589,768,30,34,64,46.9%,34m
16130,2,Manuela,2589,574,23,24,47,48.9%,18m
16130,2,黄金舰队,2589,477,20,12,32,62.5%,1h
16130,2,lovelypea,2589,228,8,5,13,61.5%,1h
16130,1,渐渐再也不见,2589,97,5,5,10,50.0%,31m
16130,3,BUTEO,2589,135,4,4,8,50.0%,1h
16130,2,llllllllll,2589,88,3,4,7,42.9%,13m
16130,2,[以君之名]晓声说丶话,2589,0,3,5,8,37.5%,50m
16130,2,空艇,2589,92,2,1,3,66.7%,38m
16130,1,浮夸半生,2589,0,1,0,1,100.0%,1h
16130,2,仅取折扇入虹晨,2589,88,1,1,2,50.0%,1h
16130,2,[Mentor]飞龙骑脸怎么输,2589,32,1,2,3,33.3%,41m
16130,3,通常召唤马头鬼,2589,97,1,2,3,33.3%,1h
16130,1,NicetoFkU,2589,0,1,3,4,25.0%,40m
16130,3,zkq,2589,0,0,1,1,0.0%,1h
16146,1,饭冈加奈子,2588,1606,84,62,146,57.5%,34m
16146,1,小心勺勺,2588,1074,52,43,95,54.7%,50m
16146,2,MaGejiI,2588,591,24,17,41,58.5%,1h
16146,2,[哮天犬他老子]blueboxing,2588,180,7,7,14,50.0%,8m
16146,2,[Igirls]冥氡,2588,194,6,5,11,54.5%,48m
16146,2,生命守恒,2588,116,3,1,4,75.0%,38m
16146,2,tommao,2588,60,3,5,8,37.5%,1h
16146,2,[我们是灬害虫]HHHHDA,2588,0,3,5,8,37.5%,1h
16146,3,[棒棒糖丶]Mrkeis,2588,0,2,4,6,33.3%,30m
16146,2,企鹅冲钱咯,2588,0,1,0,1,100.0%,1h
16146,2,大哥别捶我,2588,0,1,3,4,25.0%,1h
16146,1,[浑元闪电]五连鞭,2588,0,1,4,5,20.0%,16m
16146,2,樱祭,2588,0,0,1,1,0.0%,8m
16146,1,告诉一位彭姓女子,2588,0,0,1,1,0.0%,38m
16146,2,[娱乐明星]听柠,2588,0,0,2,2,0.0%,26m
16146,2,还我飘飘拳,2588,0,0,3,3,0.0%,1h
16162,2,Harryhyspace,2587,868,35,39,74,47.3%,34m
16162,2,骄阳,2587,502,21,13,34,61.8%,1h
16162,1,[小仙女上线啦]次级子个体,2587,269,9,6,15,60.0%,13m
16162,1,大胖,2587,297,8,14,22,36.4%,1h
16162,2,[DMR]FuRy,2587,199,7,3,10,70.0%,1h
16162,2,geez,2587,196,7,3,10,70.0%,1h
16162,2,手打,2587,203,7,7,14,50.0%,45m
16162,1,[大一最强]反知识分子,2587,171,6,2,8,75.0%,31m
16162,2,无双,2587,82,5,4,9,55.6%,57m
16162,2,[18th]君铭帝龙,2587,120,5,5,10,50.0%,41m
16162,1,[为了地狱咆哮]法魄,2587,145,4,3,7,57.1%,54m
16162,2,FrozenThrone,2587,0,4,4,8,50.0%,1h
16162,3,随机怎么样,2587,68,4,6,10,40.0%,1h
16162,2,辞心,2587,90,3,3,6,50.0%,1h
16162,1,诺亚,2587,0,2,2,4,50.0%,36m
16162,2,九秋,2587,122,2,6,8,25.0%,1h
16162,2,[Mello]猫车党,2587,0,1,0,1,100.0%,18m
16162,2,Jumbo,2587,0,1,0,1,100.0%,42m
16162,2,清醉,2587,93,1,2,3,33.3%,1h
16162,2,超神明月,2587,0,1,2,3,33.3%,38m
16162,2,[灵猫]鲸梦,2587,0,0,1,1,0.0%,1h
16162,2,HFF,2587,0,0,2,2,0.0%,1h
16184,2,孤胆剑客,2586,704,32,16,48,66.7%,1h
16184,2,超神康,2586,274,16,13,29,55.2%,48m
16184,1,[i5]幽馨抉择,2586,404,14,14,28,50.0%,44m
16184,2,齐天大圣,2586,360,13,10,23,56.5%,37m
16184,1,IIIIIIIIIIII,2586,260,10,11,21,47.6%,9m
16184,2,LIA,2586,209,8,3,11,72.7%,1h
16184,2,[大熊的小鸟]大几把,2586,154,5,5,10,50.0%,1h
16184,3,清潼小白马,2586,92,5,6,11,45.5%,1h
16184,2,[南部战区]追猎者,2586,92,4,3,7,57.1%,27m
16184,2,星辰的硝烟,2586,0,3,2,5,60.0%,51m
16184,3,空战英豪老萨米,2586,0,3,4,7,42.9%,44m
16184,2,[暗夜王牌]bright,2586,30,2,1,3,66.7%,1h
16184,1,Abigail,2586,0,2,3,5,40.0%,39m
16184,2,Lrassion,2586,0,2,6,8,25.0%,1h
16184,2,[纸上的魔法使]烈烈中风,2586,0,1,0,1,100.0%,1h
16184,2,[killer]迷失的小朋友,2586,88,1,1,2,50.0%,16m
16184,2,benn,2586,0,1,1,2,50.0%,37m
16184,2,men,2586,0,0,1,1,0.0%,38m
16184,2,[Chaos6]Intothepower,2586,0,0,1,1,0.0%,1h
16184,2,噩梦,2586,0,0,3,3,0.0%,18m
16184,1,Artanis,2586,0,0,5,5,0.0%,1h
16205,2,土影我是,2585,876,36,25,61,59.0%,1h
16205,1,blackfat,2585,483,30,27,57,52.6%,1h
16205,2,[48K纯帅]电脑玩家普通,2585,507,23,11,34,67.6%,1h
16205,2,[出生开始单推]Minoriko,2585,572,21,18,39,53.8%,1h
16205,1,Milkpudding,2585,569,20,27,47,42.6%,1h
16205,2,巨像插嘴,2585,438,17,13,30,56.7%,29m
16205,2,小坏蛋,2585,296,11,9,20,55.0%,48m
16205,2,[葱芯]妖白,2585,186,10,5,15,66.7%,41m
16205,2,REsurrection,2585,234,9,8,17,52.9%,17m
16205,3,RaymandUN,2585,216,8,4,12,66.7%,1h
16205,2,我又是谁的青春,2585,114,6,3,9,66.7%,1h
16205,3,[Rhusky]王蝈蝈,2585,0,4,2,6,66.7%,1h
16205,1,Robert,2585,148,4,11,15,26.7%,58m
16205,3,教父的三米一,2585,121,3,1,4,75.0%,1h
16205,2,艾尔大停电了,2585,116,3,1,4,75.0%,17m
16205,3,[温柔兔公主]妙法莲华,2585,97,3,4,7,42.9%,1h
16205,2,狂扁先生,2585,90,3,5,8,37.5%,16m
16205,2,虾蟹支配者孙一峰,2585,94,3,7,10,30.0%,1h
16205,2,[LYB灬星际]Emperor,2585,0,1,0,1,100.0%,41m
16205,2,二年一八班死神,2585,0,1,0,1,100.0%,16m
16205,2,电风扇,2585,0,1,1,2,50.0%,28m
16205,2,破晓鸣城,2585,0,1,1,2,50.0%,10m
16227,3,比特大魔王,2584,1569,149,147,296,50.3%,27m
16227,3,灵感,2584,1378,93,85,178,52.2%,24m
16227,3,Bozsen,2584,1287,82,69,151,54.3%,10m
16227,3,牛宝宝,2584,1241,49,54,103,47.6%,16m
16227,2,heaven,2584,325,14,4,18,77.8%,10m
16227,1,淡定寒林,2584,432,14,15,29,48.3%,1h
16227,2,[VKR]四季,2584,330,10,28,38,26.3%,5m
16227,2,[ljk]白小纯,2584,254,9,6,15,60.0%,16m
16227,2,夜昕聆雨,2584,197,8,5,13,61.5%,57m
16227,2,Spider,2584,180,7,7,14,50.0%,1h
16227,2,幽影之翼,2584,182,6,7,13,46.2%,10m
16227,2,[西雅图咖啡店]bbx,2584,86,3,5,8,37.5%,13m
16227,2,那句晚安他听了吗,2584,0,3,5,8,37.5%,45m
16227,2,菜鸡本鸡,2584,88,2,0,2,100.0%,42m
16227,2,孙一峰是我打哥,2584,0,1,0,1,100.0%,51m
16227,2,织藤信红,2584,0,1,0,1,100.0%,37m
16227,2,jianhunZEROj,2584,0,1,1,2,50.0%,8m
16227,1,erictt,2584,0,1,2,3,33.3%,13m
16245,2,[高智商小队]豆芽小哥,2583,996,113,101,214,52.8%,19m
16245,2,[猫神撅后山]smile,2583,1080,47,33,80,58.8%,1h
16245,1,[物探]白澈,2583,653,28,26,54,51.9%,19m
16245,2,Cincelia,2583,549,21,21,42,50.0%,38m
16245,2,SineAnC,2583,471,18,14,32,56.2%,1h
16245,1,ftwoA,2583,371,14,16,30,46.7%,29m
16245,2,RBQ,2583,350,13,9,22,59.1%,8m
16245,2,IIIIIIIIIIII,2583,312,11,8,19,57.9%,1h
16245,2,必捷,2583,296,10,8,18,55.6%,1h
16245,2,最菜的菜鸟,2583,137,7,5,12,58.3%,1h
16245,1,火遁凤仙火,2583,216,7,8,15,46.7%,1h
16245,1,未央中庭,2583,170,7,10,17,41.2%,1h
16245,3,FZhu,2583,142,5,4,9,55.6%,1h
16245,1,havebeercome,2583,96,3,1,4,75.0%,1h
16245,2,[QFD]网骗梅林,2583,30,2,1,3,66.7%,17m
16245,2,[WIE]Mistletoe,2583,102,2,2,4,50.0%,32m
16245,1,[Banned]我能抱你嘛,2583,0,2,3,5,40.0%,45m
16245,2,[QWQa]造血干细胞,2583,58,2,4,6,33.3%,51m
16245,2,ssuyer,2583,0,1,1,2,50.0%,1h
16245,2,不供应烈酒,2583,30,1,2,3,33.3%,13m
16245,2,Kratos,2583,30,1,4,5,20.0%,30m
16245,2,[洛梦绫音]麻衣桑,2583,30,1,4,5,20.0%,1h
16245,3,talorswift,2583,0,0,1,1,0.0%,31m
16245,2,虚空,2583,0,0,1,1,0.0%,1h
16245,1,吹着口哨去流浪,2583,0,0,1,1,0.0%,20m
16270,1,[菜鸡球带]DSASDADA,2582,962,144,147,291,49.5%,33m
16270,2,NkemGtgfEOAA,2582,1605,96,89,185,51.9%,1h
16270,2,JJQQ,2582,812,58,55,113,51.3%,1h
16270,2,索恩灬,2582,1023,46,38,84,54.8%,1h
16270,3,[极限菜鸟]mountainmoon,2582,913,38,34,72,52.8%,29m
16270,2,[欧佩克]飘落纷飞,2582,430,37,21,58,63.8%,29m
16270,1,老鸟一号,2582,478,18,20,38,47.4%,1h
16270,2,[最菜战队]Zerg,2582,230,9,4,13,69.2%,29m
16270,2,[Encore]我爱米咪,2582,282,9,8,17,52.9%,10m
16270,1,假发,2582,263,9,11,20,45.0%,58m
16270,1,墨灬竹,2582,246,9,12,21,42.9%,9m
16270,1,笛卡尔,2582,285,8,11,19,42.1%,11m
16270,2,[星际旅游团]恨繁霜,2582,145,4,4,8,50.0%,14m
16270,3,[FZD]自由之翼袁,2582,127,3,2,5,60.0%,59m
16270,1,thespo,2582,48,2,4,6,33.3%,20m
16270,3,hhhhhh,2582,0,2,4,6,33.3%,1h
16270,1,[欢迎萌新]饭饭纸杯,2582,48,2,5,7,28.6%,1h
16270,3,[火箭联盟]无天,2582,38,1,1,2,50.0%,1h
16270,2,星际争霸权哥,2582,0,0,1,1,0.0%,48m
16270,2,unbeatableP,2582,0,0,1,1,0.0%,19m
16270,2,[暴雪二十三队]lyan,2582,0,0,1,1,0.0%,29m
16270,2,[绝对双刃]Neopolitan,2582,0,0,1,1,0.0%,30m
16292,2,Ghost,2581,631,24,25,49,49.0%,1h
16292,1,[ETT]deadlycool,2581,693,23,26,49,46.9%,1h
16292,3,阿尔托莉雅,2581,600,22,26,48,45.8%,16m
16292,1,奥野田美咲,2581,492,19,21,40,47.5%,1h
16292,1,问心问道,2581,142,11,8,19,57.9%,18m
16292,2,[暗00星]奔四的男人,2581,258,7,9,16,43.8%,1h
16292,2,皮黑投资小项宰,2581,167,7,14,21,33.3%,1h
16292,3,战光,2581,157,4,2,6,66.7%,1h
16292,1,益达,2581,0,3,2,5,60.0%,1h
16292,3,yzxk,2581,0,2,4,6,33.3%,1h
16292,3,notgood,2581,0,2,4,6,33.3%,31m
16292,2,庐山升龙霸,2581,0,1,0,1,100.0%,32m
16292,2,[小鸡屠宰场a]菜鸟角色,2581,0,1,0,1,100.0%,57m
16292,2,jinhao,2581,0,1,0,1,100.0%,1h
16292,3,CHINaSKyGT,2581,0,1,0,1,100.0%,1h
16292,2,MurdocNoodle,2581,0,0,1,1,0.0%,57m
16308,1,苏家屯彭于晏,2580,1560,366,362,728,50.3%,14m
16308,1,decoder,2580,1556,228,222,450,50.7%,1h
16308,3,[CPT]开心无敌,2580,785,146,138,284,51.4%,7m
16308,2,[幻海奇妙夜]Lexington,2580,870,32,32,64,50.0%,55m
16308,2,alohahong,2580,757,31,21,52,59.6%,1h
16308,2,zzlhb,2580,565,25,15,40,62.5%,38m
16308,2,dadadaxue,2580,482,23,22,45,51.1%,1h
16308,3,甜橙,2580,310,12,12,24,50.0%,34m
16308,1,[秋毫七队]香烟没毒,2580,248,11,11,22,50.0%,1h
16308,2,JACK,2580,179,7,2,9,77.8%,12m
16308,2,梦丶疯,2580,176,5,4,9,55.6%,1h
16308,3,进取号的老舰长,2580,78,4,6,10,40.0%,57m
16308,2,yAh,2580,96,3,7,10,30.0%,1h
16308,2,[AoD]小捞妹,2580,0,1,0,1,100.0%,1h
16308,1,冰镇大西瓜,2580,0,1,0,1,100.0%,1h
16308,2,狂奔的跳虫,2580,0,0,1,1,0.0%,8m
16308,2,[007]欧仔,2580,0,0,2,2,0.0%,1h
16308,2,llllllllllll,2580,0,0,2,2,0.0%,51m
16308,2,whang,2580,0,0,2,2,0.0%,28m
16308,2,[五月花]英雄联盟是辣鸡,2580,0,0,6,6,0.0%,57m
16328,1,绝园的暴风雨,2579,938,44,27,71,62.0%,1h
16328,2,[葬魂]MINI,2579,614,21,23,44,47.7%,1h
16328,1,艾尔的城管,2579,426,19,28,47,40.4%,1h
16328,2,可爱想日,2579,307,13,6,19,68.4%,1h
16328,1,TopOne,2579,319,10,20,30,33.3%,18m
16328,1,艾尔的耻辱,2579,172,6,11,17,35.3%,4m
16328,2,颜无墨迹,2579,178,5,5,10,50.0%,1h
16328,1,AlexBrad,2579,48,4,2,6,66.7%,1h
16328,2,[大威天龙oc]闲卿,2579,100,4,3,7,57.1%,16m
16328,2,IIIIIIIIII,2579,64,3,3,6,50.0%,1h
16328,2,yzzd,2579,88,2,0,2,100.0%,42m
16328,1,scv,2579,0,2,0,2,100.0%,3m
16328,1,xjx,2579,48,2,2,4,50.0%,39m
16328,1,瞙駺,2579,0,2,3,5,40.0%,1h
16328,1,妹子加微信,2579,48,2,5,7,28.6%,1h
16328,1,胖即是胖,2579,90,2,7,9,22.2%,1h
16328,1,[莽夫与匹夫]传说是猫头,2579,0,1,1,2,50.0%,4m
16328,2,[YT]皂滑弄人,2579,0,1,1,2,50.0%,30m
16328,1,有饭吃,2579,0,1,4,5,20.0%,36m
16328,2,grubby,2579,0,0,1,1,0.0%,1h
16328,2,[社交学导教]青椒炒巧克力,2579,0,0,1,1,0.0%,1h
16328,2,[爱之信仰]東风丶若言丿,2579,0,0,2,2,0.0%,1h
16328,2,并不是炳粉,2579,0,0,3,3,0.0%,1h
16351,2,fanmoumo,2578,1161,94,90,184,51.1%,19m
16351,1,yang,2578,824,87,87,174,50.0%,4m
16351,1,[艾杀星]小艾艾,2578,892,66,71,137,48.2%,34m
16351,1,西娃最菜,2578,1095,42,39,81,51.9%,1h
16351,2,[萌新在下挨打]小鳌,2578,701,37,37,74,50.0%,16m
16351,2,[BOC]IIIIIIIIIIII,2578,450,34,22,56,60.7%,1h
16351,2,Zero,2578,326,28,19,47,59.6%,48m
16351,2,vincent,2578,605,23,23,46,50.0%,1h
16351,1,彼岸红莲,2578,627,22,24,46,47.8%,26m
16351,2,[一椛一世界]墨曦,2578,247,21,13,34,61.8%,1h
16351,2,[橙子ovo]两仪式,2578,297,12,13,25,48.0%,27m
16351,2,[天意不可违]赌神土块,2578,218,8,6,14,57.1%,37m
16351,2,[霍霍酷铁锤]友谊之船上的死神,2578,93,5,4,9,55.6%,16m
16351,1,明天的你,2578,0,4,1,5,80.0%,1h
16351,3,[半个菜鸟]IlilI,2578,78,4,7,11,36.4%,1h
16351,3,[青莲剑阁]枯林,2578,78,4,12,16,25.0%,27m
16351,1,[雅阁]虚空灬回忆,2578,48,3,3,6,50.0%,23m
16351,1,遗恨千古,2578,92,3,4,7,42.9%,14m
16351,1,劳西梅尔上将,2578,0,2,3,5,40.0%,1h
16351,2,艾尔最靓的仔,2578,60,2,5,7,28.6%,1h
16351,2,朽木落叶,2578,0,1,1,2,50.0%,3m
16351,1,[Holygl]FUTURE,2578,97,1,7,8,12.5%,20m
16373,2,海南,2577,1530,307,296,603,50.9%,14m
16373,1,夜红蕊,2577,603,52,55,107,48.6%,11m
16373,2,[HTW]whs,2577,404,36,24,60,60.0%,29m
16373,1,楽之庄,2577,654,35,30,65,53.8%,26m
16373,1,iiiiiiiiiiii,2577,706,25,29,54,46.3%,34m
16373,2,gzz,2577,571,24,27,51,47.1%,38m
16373,2,FunkyMank,2577,421,19,13,32,59.4%,1h
16373,2,枫丹白露的月光,2577,466,17,15,32,53.1%,16m
16373,2,[第三駆逐鑑隊]孤独,2577,338,13,11,24,54.2%,19m
16373,1,一丶丶,2577,222,10,9,19,52.6%,1h
16373,1,清风淡落,2577,227,10,11,21,47.6%,1h
16373,2,谐星要塞,2577,197,8,1,9,88.9%,8m
16373,2,[傲世丨听雨轩]黑夜王,2577,250,8,10,18,44.4%,1h
16373,2,wodemarin,2577,181,7,9,16,43.8%,1h
16373,1,Alleen,2577,94,5,9,14,35.7%,58m
16373,2,Vicccc,2577,88,4,6,10,40.0%,1h
16373,3,[帅贯穿一身]yywl,2577,0,2,2,4,50.0%,41m
16373,3,少年吾德,2577,0,2,4,6,33.3%,60m
16373,2,倪神空空,2577,0,1,0,1,100.0%,3m
16373,2,[单人行动对吧]RoseMiku,2577,0,1,0,1,100.0%,10m
16373,2,Meranti,2577,0,1,2,3,33.3%,38m
16373,2,菜鸟来报到,2577,30,1,2,3,33.3%,8m
16373,2,JasonTheBug,2577,0,1,2,3,33.3%,1h
16373,1,jimmy,2577,89,1,6,7,14.3%,50m
16397,2,小小白,2576,1403,156,143,299,52.2%,1h
16397,1,马歇尔参谋长,2576,1513,133,141,274,48.5%,17m
16397,1,青宇,2576,1534,87,85,172,50.6%,28m
16397,3,SyuuJhin,2576,1581,67,78,145,46.2%,9m
16397,1,[Chook]MURPHY,2576,644,61,60,121,50.4%,38m
16397,2,圣行者,2576,447,38,31,69,55.1%,1h
16397,2,FYyy,2576,759,32,28,60,53.3%,1h
16397,2,[辉煌华夏]啦我又没了,2576,364,28,24,52,53.8%,26m
16397,2,吃橙子,2576,513,22,19,41,53.7%,42m
16397,2,九泉,2576,232,7,5,12,58.3%,51m
16397,3,[沙雕]大宝宝,2576,121,3,0,3,100.0%,1h
16397,2,维他柠檬茶,2576,60,3,2,5,60.0%,1h
16397,2,[21CM]llllllllllll,2576,60,3,4,7,42.9%,55m
16397,1,暗影风暴,2576,128,3,4,7,42.9%,1h
16397,2,HeLL,2576,30,2,2,4,50.0%,37m
16397,2,LRWBwhiteInk,2576,0,1,0,1,100.0%,18m
16397,3,[镜花水月]酒驾大师塔萨达,2576,0,1,2,3,33.3%,1h
16397,1,崔家大少,2576,0,1,4,5,20.0%,43m
16397,2,一个能打的都没有,2576,0,0,1,1,0.0%,1h
16397,2,[瘾大眼瞎]艾尔难民,2576,0,0,2,2,0.0%,1h
16417,2,[Huster]chistar,2575,763,30,30,60,50.0%,32m
16417,2,[lajiji]skynood,2575,433,29,18,47,61.7%,1h
16417,2,魔掼光杀炮,2575,544,27,18,45,60.0%,1h
16417,1,applefly,2575,778,27,34,61,44.3%,34m
16417,2,一枚逗比,2575,283,23,16,39,59.0%,1h
16417,3,千代梦,2575,237,20,28,48,41.7%,5m
16417,1,[不知不觉天亮]doctor,2575,224,7,3,10,70.0%,1h
16417,2,warriarking,2575,188,7,6,13,53.8%,1h
16417,1,西班火腿黄金舰队,2575,155,6,9,15,40.0%,1h
16417,2,上上签,2575,127,4,1,5,80.0%,1h
16417,1,[PhoCo]PhoSelect,2575,94,3,5,8,37.5%,24m
16417,1,ZNTNZ,2575,114,2,2,4,50.0%,17m
16417,1,五月我的爱,2575,0,2,3,5,40.0%,1h
16417,3,FranceFang,2575,0,2,4,6,33.3%,59m
16417,2,[b了狗]我们在燃烧,2575,0,1,0,1,100.0%,1h
16417,2,冥狼,2575,0,1,0,1,100.0%,16m
16417,2,[暴雪三十二隊]末日之心,2575,0,1,0,1,100.0%,30m
16417,2,TomTang,2575,0,1,1,2,50.0%,48m
16417,2,你的暴兵真是猛,2575,0,1,1,2,50.0%,38m
16417,1,[暴赱总司令]虚空结晶,2575,94,1,1,2,50.0%,32m
16417,2,zzxer,2575,0,0,1,1,0.0%,1h
16417,2,Gustaf,2575,0,0,1,1,0.0%,1h
16417,3,ZYHeart,2575,0,0,2,2,0.0%,1h
16440,1,[CPT]笑小小,2574,1578,95,84,179,53.1%,1h
16440,2,思甫,2574,1577,71,54,125,56.8%,14m
16440,2,Lorenzo,2574,996,43,39,82,52.4%,1h
16440,2,[爆虫抵抗联盟]谁在呼叫舰队,2574,567,19,24,43,44.2%,10m
16440,2,[ljk]zrzaaa,2574,299,11,7,18,61.1%,1h
16440,2,墨痕之王,2574,255,10,5,15,66.7%,1h
16440,3,南县人,2574,125,10,20,30,33.3%,20m
16440,2,风见桐,2574,244,9,5,14,64.3%,28m
16440,2,别动我的农民啊,2574,182,7,8,15,46.7%,1h
16440,3,故事止于盛夏,2574,185,6,6,12,50.0%,1h
16440,2,Blood,2574,198,6,7,13,46.2%,1h
16440,3,[银翼之光]断怨,2574,76,3,6,9,33.3%,25m
16440,1,[扫黄]IIIIIIIIIIII,2574,56,3,9,12,25.0%,1h
16440,1,[阿么]胖虎的爸爸,2574,0,2,2,4,50.0%,1h
16440,1,橘杀,2574,48,2,2,4,50.0%,1h
16440,3,sealer,2574,0,2,4,6,33.3%,1h
16440,1,[歪比]llllllllllll,2574,89,2,5,7,28.6%,27m
16440,2,HunTer,2574,30,1,3,4,25.0%,13m
16440,2,wjc,2574,0,0,1,1,0.0%,1h
16440,2,[Fe3o4]愿人类荣光永存,2574,0,0,1,1,0.0%,1h
16460,1,victory,2573,144,22,18,40,55.0%,1h
16460,2,九殇孤寒,2573,429,17,20,37,45.9%,1h
16460,2,夜路撕,2573,249,9,6,15,60.0%,30m
16460,2,wznddb,2573,189,6,7,13,46.2%,51m
16460,1,tonystark,2573,92,6,13,19,31.6%,1h
16460,1,[Awyr]奔跑的双星鞋,2573,48,4,3,7,57.1%,16m
16460,2,[半个菜鸟II]云雨虹阳,2573,94,3,6,9,33.3%,50m
16460,1,人称刘金贵,2573,106,3,10,13,23.1%,14m
16460,1,wmwmwm,2573,44,1,2,3,33.3%,1h
16460,2,蒂亚尼斯,2573,46,1,9,10,10.0%,6m
16470,2,YKHD,2572,1221,54,37,91,59.3%,1h
16470,1,snoppy,2572,1019,47,42,89,52.8%,34m
16470,2,绝望,2572,682,27,36,63,42.9%,25m
16470,2,[KK开]大海幻想,2572,608,24,20,44,54.5%,1h
16470,3,世界第一小创,2572,504,21,25,46,45.7%,14m
16470,2,爷很持久,2572,468,16,17,33,48.5%,1h
16470,2,[TwoB]丹麦灰,2572,212,8,7,15,53.3%,1h
16470,2,asdcvzxgtjy,2572,289,6,12,18,33.3%,1h
16470,3,虎爸爸,2572,88,4,3,7,57.1%,1h
16470,2,[看我朵蜜你]芝华士里有芝士,2572,132,4,3,7,57.1%,58m
16470,3,LFZ,2572,116,4,4,8,50.0%,1h
16470,3,MaGeJeTerran,2572,82,4,7,11,36.4%,49m
16470,3,Byun,2572,58,3,1,4,75.0%,1h
16470,1,剑神刃,2572,0,3,2,5,60.0%,1h
16470,2,[青龙帮]小贱,2572,0,3,5,8,37.5%,1h
16470,1,厉害了我的哥,2572,48,2,2,4,50.0%,1h
16470,1,[嫩爽口美鲍鱼]咸湿大叔,2572,0,2,3,5,40.0%,1h
16470,3,[TYB]Elvis,2572,0,1,0,1,100.0%,1h
16470,2,你好啊树,2572,0,1,1,2,50.0%,1h
16470,2,XRay,2572,48,1,3,4,25.0%,30m
16470,3,冷冷,2572,0,0,1,1,0.0%,1h
16470,2,[弱萌小队]执笔画爱,2572,0,0,2,2,0.0%,27m
16492,3,巨龙解放者,2571,1538,76,81,157,48.4%,4m
16492,1,窈窕淑女号,2571,1290,54,58,112,48.2%,19m
16492,1,迟暮,2571,1263,47,47,94,50.0%,29m
16492,2,阿发,2571,674,36,30,66,54.5%,57m
16492,3,我的脚下就是国门,2571,840,31,27,58,53.4%,1h
16492,1,[天羽不榖]哈里谢顿,2571,623,27,19,46,58.7%,1h
16492,2,[中华兄弟会]木乃森龙牙,2571,622,26,22,48,54.2%,1h
16492,3,IMMVP,2571,483,19,21,40,47.5%,40m
16492,3,燕尾仙翁,2571,138,6,13,19,31.6%,54m
16492,1,薄荷浅浅绿,2571,147,4,3,7,57.1%,25m
16492,3,子杰,2571,121,4,5,9,44.4%,1h
16492,2,卡特,2571,44,3,6,9,33.3%,22m
16492,2,dasaw,2571,30,2,3,5,40.0%,58m
16492,1,不要修我地堡,2571,0,0,1,1,0.0%,1h
16492,3,Sheva,2571,0,0,1,1,0.0%,11m
16492,3,长歌,2571,0,0,1,1,0.0%,24m
16508,2,JACKHE,2570,998,71,70,141,50.4%,13m
16508,1,[仓鼠党]Ciar,2570,1170,43,45,88,48.9%,39m
16508,2,神密森林,2570,682,27,25,52,51.9%,28m
16508,2,[舰队训练营]枪揽天上星,2570,304,13,15,28,46.4%,18m
16508,2,[秋名山赛车组]彼得帕克猪,2570,208,8,7,15,53.3%,45m
16508,2,蛇皮,2570,194,7,4,11,63.6%,1h
16508,2,EzioAuditore,2570,218,7,5,12,58.3%,32m
16508,2,Masis,2570,205,7,8,15,46.7%,1h
16508,2,[24CM]绝对鬼火,2570,212,5,5,10,50.0%,40m
16508,3,[唐延路夜宵组]Stan,2570,60,3,2,5,60.0%,55m
16508,3,[染年霜霜]幻世浪人,2570,0,1,0,1,100.0%,15m
16508,3,遇见我就可以上分,2570,30,1,1,2,50.0%,1h
16508,3,望海浮萍,2570,97,1,2,3,33.3%,1h
16508,3,戚莫格,2570,0,1,5,6,16.7%,1h
16508,2,张辽的尸体,2570,0,0,1,1,0.0%,1h
16508,2,owenxlo,2570,0,0,2,2,0.0%,19m
16524,1,Zealot,2569,1626,338,351,689,49.1%,1h
16524,3,[猛禽第二舰队]Scorpio,2569,1330,107,105,212,50.5%,33m
16524,1,菜菜,2569,1582,75,74,149,50.3%,1h
16524,1,土豆大魔王,2569,1376,67,74,141,47.5%,39m
16524,3,[CPT]yolime,2569,1591,65,53,118,55.1%,11m
16524,1,火拳,2569,363,17,5,22,77.3%,30m
16524,1,咸咸咸鱼,2569,316,10,13,23,43.5%,1h
16524,2,萧峰,2569,150,6,6,12,50.0%,1h
16524,2,SunJc,2569,118,5,4,9,55.6%,1h
16524,1,骑着猪儿看月亮,2569,48,3,4,7,42.9%,1h
16524,3,为所欲为,2569,34,3,5,8,37.5%,34m
16524,2,[我好菜]西卡罗,2569,0,1,2,3,33.3%,1h
16524,2,银色重炮,2569,30,1,3,4,25.0%,1h
16524,1,[AKAzuo]旋转震动男友,2569,30,1,6,7,14.3%,1h
16524,3,SooMing,2569,0,0,1,1,0.0%,1h
16524,2,天天,2569,0,0,3,3,0.0%,38m
16540,1,Charles,2568,1340,79,62,141,56.0%,49m
16540,3,gnefuw,2568,1481,65,65,130,50.0%,58m
16540,1,汐玄,2568,480,51,52,103,49.5%,1h
16540,1,[芭芭拉冲压]苍山雪,2568,1021,46,33,79,58.2%,28m
16540,2,[虫群永不休止]IIIIIIIIIIII,2568,839,33,24,57,57.9%,1h
16540,2,HSA,2568,681,30,23,53,56.6%,13m
16540,1,橘座,2568,872,30,37,67,44.8%,28m
16540,2,暴躁的浣熊,2568,557,22,20,42,52.4%,1h
16540,2,霸天橙子,2568,406,16,11,27,59.3%,16m
16540,2,一个菜鸡,2568,284,8,3,11,72.7%,1h
16540,1,DNA,2568,220,7,13,20,35.0%,16m
16540,1,羌笛何须怨杨柳,2568,173,4,5,9,44.4%,23m
16540,3,游魂,2568,97,3,1,4,75.0%,59m
16540,1,戏法涂鸦,2568,0,3,6,9,33.3%,25m
16540,2,Mark,2568,93,2,2,4,50.0%,44m
16540,1,狼八,2568,0,2,3,5,40.0%,1h
16540,2,小兔,2568,84,2,6,8,25.0%,1h
16540,3,汤哥归来,2568,30,1,2,3,33.3%,1h
16540,2,ZZbzghost,2568,0,1,3,4,25.0%,38m
16540,3,RichardoMLu,2568,0,1,3,4,25.0%,48m
16560,1,Jonson,2567,624,23,24,47,48.9%,27m
16560,1,[颓废天涯]Kilito,2567,559,23,27,50,46.0%,27m
16560,1,YRM,2567,446,20,18,38,52.6%,16m
16560,2,泰木人道,2567,453,16,15,31,51.6%,29m
16560,1,GGNS,2567,341,12,18,30,40.0%,34m
16560,2,ylsl,2567,182,9,3,12,75.0%,1h
16560,2,xiaoka,2567,240,9,10,19,47.4%,1h
16560,3,李奇,2567,0,4,2,6,66.7%,1h
16560,1,[骚起来]千月火云,2567,0,3,2,5,60.0%,35m
16560,2,[紫曜石]blueboy,2567,116,2,4,6,33.3%,1h
16560,1,皮皮,2567,70,2,9,11,18.2%,39m
16560,1,Nancheng,2567,0,1,4,5,20.0%,20m
16560,3,[坑坑坑坑]SadNess,2567,0,0,1,1,0.0%,4m
16560,3,MuSE,2567,0,0,1,1,0.0%,1h
16574,3,星空烁,2566,1544,156,143,299,52.2%,24m
16574,2,[荣耀指引我]萌王赛高,2566,1281,57,44,101,56.4%,1h
16574,1,qiqi,2566,702,29,24,53,54.7%,44m
16574,2,[青春恋爱物语]艾泽拉斯,2566,290,15,15,30,50.0%,28m
16574,1,sunzhaohuans,2566,255,11,9,20,55.0%,13m
16574,2,董太傻,2566,241,9,6,15,60.0%,51m
16574,3,阿斯塔罗特,2566,195,7,6,13,53.8%,1h
16574,1,CzarTech,2566,218,7,13,20,35.0%,1h
16574,3,[底特律KAR]无敌老剑客,2566,139,6,2,8,75.0%,1h
16574,2,地狱前线,2566,128,3,1,4,75.0%,28m
16574,1,[武道专家]遥遥無期,2566,154,3,3,6,50.0%,57m
16574,3,[瘾大眼瞎]pimba,2566,64,3,7,10,30.0%,50m
16574,2,WEW,2566,0,2,4,6,33.3%,1h
16574,3,Setsuna,2566,0,2,4,6,33.3%,1h
16574,3,[注意防守]东色风情,2566,0,1,0,1,100.0%,1h
16574,3,快来陪爷爷玩几盘,2566,0,1,1,2,50.0%,1h
16574,3,[天灾LGD]极致丶忘川,2566,30,1,2,3,33.3%,1h
16574,3,[C58559]雨露均沾水平一般,2566,0,0,1,1,0.0%,1h
16574,2,Ricardo,2566,0,0,3,3,0.0%,41m
16593,3,WIDOWMINE,2565,1140,47,44,91,51.6%,1h
16593,3,约书亚,2565,757,31,28,59,52.5%,1h
16593,1,wsgsgsgs,2565,614,27,28,55,49.1%,44m
16593,2,lurker,2565,415,20,13,33,60.6%,29m
16593,1,[DMR]夜雨的黑曜石,2565,266,9,12,21,42.9%,25m
16593,2,天津老贼张伯礼,2565,100,5,4,9,55.6%,1h
16593,3,十个,2565,97,5,4,9,55.6%,1h
16593,3,Holiness,2565,170,4,4,8,50.0%,29m
16593,1,高手爷爷,2565,0,3,6,9,33.3%,55m
16593,3,sliceRest,2565,30,2,0,2,100.0%,55m
16593,3,swanzn,2565,0,2,5,7,28.6%,1h
16593,3,谭阳,2565,0,1,0,1,100.0%,1h
16593,1,罪孽深重,2565,0,1,0,1,100.0%,1h
16593,3,巅峰苇名一心,2565,0,1,0,1,100.0%,1h
16593,3,start,2565,30,1,1,2,50.0%,1h
16593,2,Ghost,2565,30,1,3,4,25.0%,51m
16593,3,Mars,2565,0,1,6,7,14.3%,23m
16593,3,三天打鱼,2565,97,1,6,7,14.3%,1h
16611,3,guns,2564,1507,207,205,412,50.2%,25m
16611,2,[怕个虫子]加藤惠,2564,1413,67,60,127,52.8%,8m
16611,3,LJF,2564,691,29,37,66,43.9%,34m
16611,1,[洛梦绫音]一叶知秋,2564,238,9,11,20,45.0%,49m
16611,3,[SS天煞]浩寒,2564,130,8,6,14,57.1%,57m
16611,1,蛮族部落,2564,116,6,4,10,60.0%,1h
16611,1,谁在乱叫舰队,2564,134,6,10,16,37.5%,20m
16611,1,苏洛,2564,0,4,2,6,66.7%,1h
16611,2,scv,2564,128,4,6,10,40.0%,1h
16611,3,小火龙,2564,30,2,0,2,100.0%,1h
16611,3,wjx,2564,0,2,4,6,33.3%,1h
16611,1,mhk,2564,48,2,5,7,28.6%,20m
16611,3,power,2564,0,1,0,1,100.0%,1h
16611,3,[今天天气真好]薄荷喵呜,2564,0,1,0,1,100.0%,1h
16611,2,GDXJ,2564,0,1,0,1,100.0%,1h
16611,3,[萌的一笔]李嘉图,2564,97,1,2,3,33.3%,1h
16611,3,九山八海,2564,0,0,1,1,0.0%,1h
16628,2,[LHZ]naonaozai,2563,1135,50,34,84,59.5%,1h
16628,1,白色杀手,2563,999,43,49,92,46.7%,26m
16628,3,小拉基姐姐,2563,772,38,23,61,62.3%,1h
16628,2,战神之林登万,2563,788,37,31,68,54.4%,10m
16628,2,[DSE]啵啵鸡,2563,242,8,13,21,38.1%,37m
16628,1,小白,2563,151,7,8,15,46.7%,31m
16628,3,[混吃混喝]蛤蛤,2563,186,6,3,9,66.7%,1h
16628,2,scan,2563,201,6,9,15,40.0%,1h
16628,2,kueit,2563,175,5,4,9,55.6%,1h
16628,1,[罗马方标]秋色咕噜,2563,140,4,10,14,28.6%,1h
16628,3,愿圣光忽悠着你,2563,58,3,0,3,100.0%,1h
16628,3,比格沃斯小姐,2563,40,3,5,8,37.5%,1h
16628,2,盐西瓜,2563,88,3,6,9,33.3%,1h
16628,2,quitely,2563,90,3,6,9,33.3%,1h
16628,3,[需要更多部队]八方风雨,2563,30,2,0,2,100.0%,8m
16628,3,[虎牙祁铭菌]qaq,2563,123,2,3,5,40.0%,60m
16628,3,今天第一次打星际,2563,0,2,4,6,33.3%,1h
16628,3,mangzhong,2563,0,1,0,1,100.0%,1h
16646,2,ggGG,2562,1626,169,148,317,53.3%,48m
16646,1,想你的楠笙,2562,1126,70,60,130,53.8%,3m
16646,2,[绝世双谐]Arnoz,2562,707,26,23,49,53.1%,19m
16646,2,SecretLemon,2562,373,15,14,29,51.7%,1h
16646,1,[LDP]summer,2562,368,13,15,28,46.4%,1h
16646,1,扑街,2562,292,12,12,24,50.0%,1h
16646,1,星级迷航,2562,327,10,14,24,41.7%,1h
16646,3,肾宝,2562,232,9,7,16,56.2%,1h
16646,1,starfall,2562,244,8,11,19,42.1%,1h
16646,1,WlL,2562,144,4,3,7,57.1%,23m
16646,3,特仑苏羊奶,2562,0,3,4,7,42.9%,60m
16646,2,水封飞叶,2562,115,2,2,4,50.0%,60m
16646,3,你的剪影,2562,0,2,3,5,40.0%,1h
16646,2,October,2562,60,2,5,7,28.6%,1h
16646,2,GQZ,2562,18,1,3,4,25.0%,57m
16661,2,子龙,2561,440,15,18,33,45.5%,1h
16661,1,暗杀者马雷达,2561,374,15,20,35,42.9%,1h
16661,2,散白,2561,322,14,6,20,70.0%,1h
16661,2,涿玥云,2561,357,14,9,23,60.9%,1h
16661,1,星光入眸,2561,332,13,12,25,52.0%,3m
16661,1,IIIIIIIII,2561,145,12,9,21,57.1%,1h
16661,2,[暴雪二十八队]dunima,2561,184,7,4,11,63.6%,1h
16661,3,[我是萌新Q]罪人,2561,167,6,1,7,85.7%,18m
16661,1,DANAKKKA,2561,48,3,4,7,42.9%,16m
16661,3,[Quark]茶仙,2561,30,2,0,2,100.0%,24m
16661,1,成墨,2561,48,2,0,2,100.0%,1h
16661,1,lwffksj,2561,48,2,0,2,100.0%,23m
16661,3,[小奶狼]繁花落尽,2561,58,2,1,3,66.7%,1h
16661,2,发芽绿土豆,2561,88,2,1,3,66.7%,1h
16661,1,[最爱酸菜面]金坷垃种庄稼,2561,0,2,3,5,40.0%,1h
16661,3,拳拳,2561,0,1,0,1,100.0%,17m
16661,3,玩一玩,2561,0,1,0,1,100.0%,1h
16661,3,天天向上,2561,30,1,2,3,33.3%,17m
16661,1,[乱世]哎呀,2561,0,0,1,1,0.0%,39m
16661,2,yun,2561,0,0,2,2,0.0%,14m
16681,2,[孙一峰起峰了]起峰了,2560,249,17,19,36,47.2%,1h
16681,1,电竞马保国,2560,452,15,16,31,48.4%,39m
16681,3,悍戈,2560,188,5,2,7,71.4%,1h
16681,3,冰霜之犬,2560,58,3,0,3,100.0%,18m
16681,2,[咬我啊]未实施到位,2560,40,2,2,4,50.0%,60m
16681,2,你我开心哦,2560,134,2,3,5,40.0%,52m
16681,1,Chris,2560,0,2,3,5,40.0%,1h
16681,2,creeper,2560,94,2,7,9,22.2%,19m
16681,3,[战术核武器]hotwu,2560,0,1,0,1,100.0%,8m
16681,1,[燕大SC]风子爬一爬,2560,0,1,0,1,100.0%,1h
16681,1,ZhHerobrine,2560,0,1,0,1,100.0%,1h
16681,1,Fckle,2560,0,1,0,1,100.0%,1h
16681,1,[宗师]豆豆爸,2560,30,1,8,9,11.1%,1h
16694,3,手残脾气暴,2559,1539,196,199,395,49.6%,24m
16694,3,眉如远山,2559,1560,85,78,163,52.1%,5m
16694,3,丶白天,2559,707,81,82,163,49.7%,27m
16694,1,快乐星际,2559,1245,74,70,144,51.4%,1h
16694,1,长安一醉,2559,1022,71,64,135,52.6%,16m
16694,2,啦哦恩,2559,1461,59,58,117,50.4%,1h
16694,3,[CPT]Classic,2559,1253,56,51,107,52.3%,24m
16694,2,伊蕾娜,2559,1128,49,45,94,52.1%,32m
16694,2,隐蔽之鲷,2559,1169,47,42,89,52.8%,4m
16694,2,[超级二五仔]NaviSimple,2559,385,32,34,66,48.5%,19m
16694,3,[四叶草]瀛洲,2559,714,26,22,48,54.2%,29m
16694,1,爱兵如子高坚果,2559,204,14,9,23,60.9%,58m
16694,2,Mystery,2559,240,8,13,21,38.1%,19m
16694,2,KOI,2559,204,7,9,16,43.8%,38m
16694,2,梦违科学世纪,2559,206,5,6,11,45.5%,1h
16694,3,月现星暗,2559,58,3,2,5,60.0%,18m
16694,1,zhangyang,2559,48,3,4,7,42.9%,1h
16694,3,[需要更多部队]光影议会的白球,2559,30,2,0,2,100.0%,24m
16694,2,[FLF]佩恩天神道,2559,102,2,2,4,50.0%,19m
16694,3,小楠,2559,0,2,4,6,33.3%,57m
16694,1,yingnovation,2559,0,1,0,1,100.0%,49m
16694,2,[镜花水月丨]fengfeng,2559,0,1,0,1,100.0%,1h
16694,3,舒小魅,2559,0,0,1,1,0.0%,1h
16717,2,羽毛飘零,2558,293,45,31,76,59.2%,16m
16717,2,卖鱼强蕉太郎,2558,752,33,28,61,54.1%,16m
16717,1,[CPT]墓志铭结婚时代,2558,530,26,33,59,44.1%,1h
16717,1,[DogB]请叫我印度阿四,2558,300,11,10,21,52.4%,34m
16717,3,[SC2近卫军]一念花开,2558,231,10,2,12,83.3%,1h
16717,3,sadfdsdfasfg,2558,279,10,8,18,55.6%,8m
16717,3,[咕咕联合谐会]llllllllllll,2558,247,9,2,11,81.8%,26m
16717,2,[老衲爱尼姑]木子,2558,174,6,8,14,42.9%,1h
16717,2,[断后中队]叶戈尔,2558,204,6,8,14,42.9%,1h
16717,2,Starry,2558,180,6,9,15,40.0%,1h
16717,2,[南昌一枝花]不要吃太饱,2558,95,5,3,8,62.5%,1h
16717,2,凌霖,2558,130,4,2,6,66.7%,1h
16717,2,Oyi,2558,98,4,3,7,57.1%,12m
16717,3,shiro,2558,143,4,5,9,44.4%,4m
16717,3,澹澹潺潺,2558,119,3,0,3,100.0%,1h
16717,1,[ILAF]Altair,2558,0,3,2,5,60.0%,1h
16717,3,Flare,2558,30,2,0,2,100.0%,58m
16717,3,[ducang]week,2558,0,1,0,1,100.0%,10m
16717,2,冥冥之中,2558,90,1,2,3,33.3%,12m
16717,2,暗中观察的某探机,2558,30,1,3,4,25.0%,4m
16717,1,king,2558,0,1,3,4,25.0%,1h
16717,3,[战旗第六分队]觐天丶佐羽,2558,0,0,1,1,0.0%,1h
16717,2,浅夏染柒,2558,0,0,2,2,0.0%,54m
16717,2,打工魂,2558,0,0,2,2,0.0%,1h
16717,1,[萌虫争霸]小西瓜打天下,2558,0,0,2,2,0.0%,1h
16717,2,huanghuanshu,2558,0,0,3,3,0.0%,16m
16743,2,阿隆索,2557,1130,146,147,293,49.8%,16m
16743,1,[no总之遗]莫岚,2557,1555,116,111,227,51.1%,14m
16743,2,MvpTale,2557,783,28,31,59,47.5%,1h
16743,2,[无限月读]进击的珺仔,2557,457,27,24,51,52.9%,42m
16743,1,流光陷沙,2557,441,20,16,36,55.6%,1h
16743,2,诺娃上过黄金,2557,466,19,15,34,55.9%,16m
16743,3,铉晔,2557,271,12,13,25,48.0%,1h
16743,1,phl,2557,306,10,10,20,50.0%,13m
16743,1,beast,2557,216,6,8,14,42.9%,1h
16743,2,[极限菜鸟]鸡饲料,2557,154,5,3,8,62.5%,1h
16743,3,[HaNaDa]闰土啊,2557,175,4,2,6,66.7%,1h
16743,3,绫波,2557,42,3,6,9,33.3%,1h
16743,1,傲骨,2557,95,2,2,4,50.0%,1h
16743,3,树街猫,2557,0,2,5,7,28.6%,1h
16743,3,[镜花水月丶]黄头发妹妹爱黑丝,2557,0,1,4,5,20.0%,1h
16743,3,[绝世高手]海军上将吉安娜,2557,0,0,1,1,0.0%,11m
16743,3,deathlemon,2557,0,0,1,1,0.0%,1h
16743,1,[CNboys]shane,2557,0,0,8,8,0.0%,35m
16761,1,阿巴阿巴打夺夺,2556,1581,93,88,181,51.4%,10m
16761,1,[一股清流]高数,2556,706,41,31,72,56.9%,20m
16761,2,我的子墨宝宝,2556,429,33,23,56,58.9%,58m
16761,2,[不打GG]Lovecraft,2556,755,33,35,68,48.5%,29m
16761,1,宇宇宇,2556,672,32,31,63,50.8%,58m
16761,2,[224]忒修斯,2556,375,24,4,28,85.7%,1h
16761,3,修行的小刚,2556,198,23,21,44,52.3%,1h
16761,1,Tom,2556,518,20,21,41,48.8%,44m
16761,3,白兰地,2556,171,7,4,11,63.6%,1h
16761,1,Frost,2556,158,6,10,16,37.5%,1h
16761,1,战争之王,2556,0,3,2,5,60.0%,1h
16761,2,乔乔的奇妙战斗,2556,60,3,3,6,50.0%,1h
16761,2,倒走,2556,129,3,4,7,42.9%,30m
16761,3,像风一样,2556,36,3,5,8,37.5%,49m
16761,1,Tendos,2556,0,2,3,5,40.0%,1h
16761,3,[长征小白]我叫小难,2556,0,1,0,1,100.0%,4m
16761,3,jia,2556,0,1,0,1,100.0%,1h
16761,3,花城,2556,30,1,2,3,33.3%,1h
16761,2,Moon,2556,0,1,2,3,33.3%,1h
16761,2,[慢手e族]小艾尔,2556,30,1,3,4,25.0%,1h
16781,2,厌战,2555,1148,334,339,673,49.6%,28m
16781,2,为你而生为你而在,2555,548,24,19,43,55.8%,1h
16781,2,风居住的街道,2555,482,18,25,43,41.9%,4m
16781,3,Minjie,2555,121,18,27,45,40.0%,9m
16781,2,XUKIKImuamua,2555,198,8,7,15,53.3%,1h
16781,2,[猫神]艾弗森风帆,2555,170,8,10,18,44.4%,8m
16781,3,[鸡唧唧叽乐团]magicNOVA,2555,144,5,3,8,62.5%,1h
16781,2,笙梦,2555,208,5,5,10,50.0%,40m
16781,3,[TOPZEG]vaioS,2555,108,4,14,18,22.2%,1h
16781,3,凡吊毛,2555,0,2,4,6,33.3%,1h
16781,1,[猪星人在地球]骚猪最萌,2555,44,2,5,7,28.6%,31m
16781,3,墨染青瓷,2555,0,1,0,1,100.0%,1h
16781,3,[北辰]Alanak,2555,30,1,1,2,50.0%,1h
16781,3,[统一老坛酸菜]blushwine,2555,30,1,1,2,50.0%,1h
16781,1,[大姐酒家]StarHelix,2555,94,1,1,2,50.0%,20m
16781,3,[星际现象学]Wty,2555,34,1,2,3,33.3%,1h
16781,3,剑心,2555,0,0,1,1,0.0%,58m
16798,1,[提莫1234]Queeniorz,2554,279,58,50,108,53.7%,1h
16798,3,qsqsqs,2554,1040,53,49,102,52.0%,31m
16798,3,野生,2554,730,32,17,49,65.3%,1h
16798,1,硫代硫酸钠,2554,553,21,22,43,48.8%,37m
16798,1,皮闯,2554,182,19,24,43,44.2%,1h
16798,2,空白,2554,437,17,20,37,45.9%,13m
16798,3,[极限菜鸟]喜中五百万,2554,340,12,7,19,63.2%,1h
16798,2,白胖子,2554,309,12,15,27,44.4%,1h
16798,1,承影,2554,272,10,13,23,43.5%,23m
16798,2,[初来闸刀]samyang,2554,214,6,5,11,54.5%,51m
16798,2,[大元师]GGzfsa,2554,138,5,2,7,71.4%,1h
16798,3,我很菜别打我,2554,121,5,3,8,62.5%,1h
16798,1,非世,2554,217,5,7,12,41.7%,24m
16798,1,QPQPQ,2554,88,3,8,11,27.3%,23m
16798,3,[极限菜鸟]水院你东哥,2554,18,2,0,2,100.0%,24m
16798,3,半夏,2554,30,2,1,3,66.7%,26m
16798,3,[夕日坂]艾莉希尔,2554,119,2,1,3,66.7%,1h
16798,1,呵呵,2554,0,2,3,5,40.0%,5m
16798,3,秒僧无花果,2554,0,1,0,1,100.0%,26m
16798,3,Zest,2554,0,1,0,1,100.0%,32m
16798,2,isolation,2554,0,1,1,2,50.0%,1h
16798,3,Sikol,2554,0,0,1,1,0.0%,23m
16798,2,[TSOD]Zifer,2554,0,0,2,2,0.0%,10m
16821,1,[天天向上1]铺不上菌毯的虫母,2553,919,34,34,68,50.0%,27m
16821,2,日了狗了,2553,452,29,26,55,52.7%,1h
16821,2,[香槟神教]邪能小黄人,2553,111,16,10,26,61.5%,58m
16821,3,亿万星河,2553,318,12,3,15,80.0%,47m
16821,3,呐呐呐,2553,235,9,3,12,75.0%,1h
16821,1,[宫吧老哥狂喜]qwerta,2553,296,9,13,22,40.9%,44m
16821,3,方得始终,2553,131,7,0,7,100.0%,10m
16821,3,[黄旭东奶我输]efefwe,2553,208,6,14,20,30.0%,6m
16821,3,[Sentul]WANHUAN,2553,108,5,7,12,41.7%,60m
16821,3,[DBC]CarlJY,2553,155,4,1,5,80.0%,1h
16821,1,DeathMxRSPG,2553,48,3,4,7,42.9%,1h
16821,2,[大元师]SDALIUBGSDBA,2553,30,3,5,8,37.5%,1h
16821,2,silmy,2553,88,1,3,4,25.0%,27m
16821,3,[世纪之舟]jimmy,2553,0,0,1,1,0.0%,1h
16835,3,夜尽,2552,1072,56,60,116,48.3%,33m
16835,2,三白羽,2552,270,20,21,41,48.8%,37m
16835,3,白面馒头,2552,501,20,22,42,47.6%,5m
16835,2,[七海]七海千夜,2552,392,15,14,29,51.7%,37m
16835,1,keo,2552,239,14,17,31,45.2%,4m
16835,1,殇逝琉璃,2552,344,11,19,30,36.7%,35m
16835,3,天元,2552,308,10,8,18,55.6%,58m
16835,1,amwwzi,2552,251,8,10,18,44.4%,1h
16835,2,BBC,2552,251,7,13,20,35.0%,1h
16835,3,一直都很菜,2552,171,5,6,11,45.5%,1h
16835,2,[超级猎马带师]Kyle,2552,127,4,3,7,57.1%,38m
16835,2,三只松鼠,2552,94,4,5,9,44.4%,1h
16835,2,[半个菜鸟II]玫瑰巷的乞者,2552,92,4,6,10,40.0%,1h
16835,1,[老班干]anny,2552,114,3,1,4,75.0%,19m
16835,3,别搞啦,2552,49,3,1,4,75.0%,1h
16835,3,XJK,2552,97,3,5,8,37.5%,1h
16835,3,紫辰,2552,34,2,1,3,66.7%,42m
16835,3,予你星河,2552,40,2,1,3,66.7%,49m
16835,3,Demon,2552,0,2,4,6,33.3%,1h
16835,1,[叫我兔本]成都孙一峰,2552,97,2,4,6,33.3%,36m
16835,3,[星战分部]桃园乡主,2552,30,1,1,2,50.0%,24m
16835,1,jokepolk,2552,0,1,4,5,20.0%,23m
16835,3,[SC终结]niuniunaoshi,2552,0,0,1,1,0.0%,18m
16835,3,厂狗叶,2552,0,0,1,1,0.0%,1h
16835,3,随波逐流,2552,0,0,1,1,0.0%,1h
16835,3,刘博士,2552,0,0,2,2,0.0%,24m
16861,3,极品渣男,2551,1102,273,273,546,50.0%,27m
16861,3,灬飒爽英姿灬,2551,555,21,13,34,61.8%,26m
16861,2,[Encore]winterfell,2551,335,13,13,26,50.0%,32m
16861,2,Brucehello,2551,395,13,15,28,46.4%,8m
16861,3,[喜欢香香]冰尊帝影,2551,300,11,4,15,73.3%,1h
16861,2,[三族同萌会]MonsTeR,2551,210,7,4,11,63.6%,26m
16861,3,ypaaaaaa,2551,197,7,6,13,53.8%,1h
16861,2,战神丨势不可挡,2551,152,6,6,12,50.0%,30m
16861,3,[Dameng]疯狗张,2551,104,6,6,12,50.0%,1h
16861,1,jiangxiaorui,2551,212,5,9,14,35.7%,10m
16861,3,雾沉沉,2551,173,4,4,8,50.0%,1h
16861,2,[五年目放課後]Tian,2551,132,3,2,5,60.0%,1h
16861,2,半夏星夜,2551,128,3,4,7,42.9%,1h
16861,2,LiuPeiTong,2551,0,3,6,9,33.3%,1h
16861,3,llllllllllll,2551,30,2,1,3,66.7%,17m
16861,2,阿大,2551,88,2,2,4,50.0%,1h
16861,1,厉如风,2551,0,2,3,5,40.0%,1h
16861,3,倾卿,2551,0,1,0,1,100.0%,1h
16861,2,白幽灵,2551,0,1,2,3,33.3%,1h
16861,2,秋野,2551,0,1,4,5,20.0%,1h
16861,1,残花碎梦,2551,0,1,4,5,20.0%,36m
16861,3,sdy,2551,0,0,1,1,0.0%,32m
16861,3,[传奇再现]爽哥,2551,0,0,1,1,0.0%,1h
16861,1,[丷国民情夫丷]霸霸,2551,0,0,1,1,0.0%,23m
16861,3,魂之挽歌,2551,0,0,1,1,0.0%,1h
16861,2,开心果,2551,0,0,3,3,0.0%,30m
16887,1,林若亭,2550,1255,80,65,145,55.2%,1h
16887,2,aluha,2550,1165,78,66,144,54.2%,55m
16887,2,小学生,2550,529,44,30,74,59.5%,27m
16887,3,hfiisy,2550,1134,44,51,95,46.3%,16m
16887,2,magic,2550,835,40,38,78,51.3%,55m
16887,2,马五一,2550,867,37,32,69,53.6%,1h
16887,1,大猪蹄子,2550,782,31,32,63,49.2%,1h
16887,1,[社交学教练]溺水的鱼,2550,598,21,27,48,43.8%,18m
16887,3,五月,2550,193,18,5,23,78.3%,1h
16887,2,摸金校尉,2550,468,17,16,33,51.5%,20m
16887,2,光芒耀眼,2550,140,4,4,8,50.0%,30m
16887,2,大碗馄饨,2550,32,2,3,5,40.0%,1h
16887,1,大地的裂变,2550,44,2,5,7,28.6%,46m
16887,3,[嘤遍全球]飞机,2550,0,1,0,1,100.0%,51m
16887,3,御前带刀小飘,2550,0,1,0,1,100.0%,6m
16887,3,[荣耀归来]yuguo,2550,0,1,0,1,100.0%,1h
16887,3,白金之星,2550,34,1,3,4,25.0%,55m
16887,2,soynim,2550,18,1,5,6,16.7%,1h
16887,2,[人菜灬瘾大]风起云散,2550,0,0,3,3,0.0%,1h
16887,2,[ATLS]啧啧啧沼泽,2550,0,0,3,3,0.0%,1h
16907,3,夜雨声烦,2549,1445,83,80,163,50.9%,35m
16907,3,brown,2549,1574,80,69,149,53.7%,1h
16907,2,Player,2549,1367,55,52,107,51.4%,41m
16907,1,超神菜鸟,2549,642,25,27,52,48.1%,27m
16907,1,含泪甩飞龙,2549,432,17,18,35,48.6%,50m
16907,3,[CPT]夏恋花火,2549,242,8,8,16,50.0%,20m
16907,1,呵呵,2549,253,8,11,19,42.1%,1h
16907,2,小小白神族有点菜,2549,192,5,7,12,41.7%,1h
16907,3,[草死尼玛哦]nimasile,2549,0,4,2,6,66.7%,1h
16907,2,ydjhhhhhh,2549,0,4,5,9,44.4%,40m
16907,3,[Conque]龙之魂,2549,60,3,2,5,60.0%,51m
16907,3,青春无敌楼蛋蛋,2549,0,3,4,7,42.9%,1h
16907,3,龙魂,2549,30,3,5,8,37.5%,1h
16907,2,建国川,2549,90,3,6,9,33.3%,1h
16907,1,invoker,2549,0,3,6,9,33.3%,40m
16907,2,[北京大学鸡协]vinsmoksanji,2549,88,2,1,3,66.7%,10m
16907,1,[冲就完了]makeldld,2549,0,2,3,5,40.0%,1h
16907,3,SkyGemini,2549,58,2,4,6,33.3%,1h
16907,3,爱吃瓜瓜,2549,0,1,0,1,100.0%,20m
16907,3,ghost,2549,95,1,1,2,50.0%,1h
16907,2,英雄的叹息,2549,0,1,2,3,33.3%,12m
16907,1,[在下菜鸡一只]DSADSADA,2549,0,0,1,1,0.0%,1h
16929,1,JINA,2548,1515,265,256,521,50.9%,57m
16929,3,小德德,2548,1472,103,107,210,49.0%,59m
16929,1,钢铁熊津,2548,470,17,21,38,44.7%,50m
16929,2,[2000年]king,2548,72,14,16,30,46.7%,39m
16929,3,sysrq,2548,340,13,10,23,56.5%,1h
16929,2,ZeroTwo,2548,147,11,14,25,44.0%,1h
16929,3,ekfbey,2548,211,9,3,12,75.0%,1h
16929,1,DarkTD,2548,156,7,10,17,41.2%,3m
16929,1,[Mikon]恰克队长,2548,174,6,11,17,35.3%,26m
16929,1,可莉天下第一,2548,0,3,3,6,50.0%,45m
16929,3,DJzelot,2548,30,2,0,2,100.0%,8m
16929,3,Emperor,2548,30,2,1,3,66.7%,1h
16929,2,东方月初,2548,30,2,3,5,40.0%,1h
16929,3,缘之空,2548,0,1,0,1,100.0%,31m
16929,2,幽灵死侍,2548,0,1,0,1,100.0%,12m
16929,2,cjie,2548,0,1,1,2,50.0%,20m
16929,3,安哥,2548,30,1,1,2,50.0%,53m
16929,3,[达拉姆远征军]神奇的豆子,2548,30,1,2,3,33.3%,1h
16929,3,[我意凌云]殇丶櫖,2548,30,1,2,3,33.3%,1h
16929,1,Demons,2548,0,0,1,1,0.0%,1h
16929,3,[世纪之舟]apple,2548,0,0,2,2,0.0%,17m
16950,1,cjluwxh,2547,1069,117,116,233,50.2%,28m
16950,1,ACE,2547,1607,73,77,150,48.7%,55m
16950,2,姓已注册,2547,1077,41,39,80,51.2%,1h
16950,3,AlexChen,2547,824,37,41,78,47.4%,26m
16950,2,善茬,2547,679,33,33,66,50.0%,1h
16950,3,zhangsheng,2547,610,30,21,51,58.8%,24m
16950,3,[99ms]QTboom,2547,548,20,13,33,60.6%,1h
16950,2,yoshily,2547,385,12,27,39,30.8%,9m
16950,2,oko,2547,354,11,17,28,39.3%,55m
16950,1,Antony,2547,245,7,11,18,38.9%,1h
16950,3,[旺旺战士]巨疯捣蛋车,2547,165,5,4,9,55.6%,1h
16950,3,亚盾之茅,2547,0,4,2,6,66.7%,30m
16950,3,六道飞起,2547,162,4,4,8,50.0%,1h
16950,1,帝国,2547,162,4,6,10,40.0%,31m
16950,3,小明,2547,70,4,6,10,40.0%,50m
16950,1,[探机教]ArmG,2547,96,4,7,11,36.4%,1h
16950,3,[一股清流]夕阳的刻痕,2547,60,3,1,4,75.0%,11m
16950,3,想你的时候已失去,2547,58,3,2,5,60.0%,1h
16950,3,[专业收尸队]白衬衫,2547,0,3,2,5,60.0%,1h
16950,3,[神兽站队]herobrine,2547,60,2,3,5,40.0%,6m
16950,2,白马英豪,2547,60,2,5,7,28.6%,20m
16950,1,闯灬,2547,0,1,0,1,100.0%,1h
16950,1,buzhisuoyun,2547,46,1,1,2,50.0%,1h
16950,3,飞垫,2547,0,1,5,6,16.7%,10m
16950,3,Michelle,2547,0,0,1,1,0.0%,1h
16975,1,king,2546,1589,62,62,124,50.0%,1h
16975,2,丫丫,2546,1471,57,62,119,47.9%,1h
16975,2,[吼吼吼]sonny,2546,890,40,29,69,58.0%,1h
16975,3,南布岛,2546,861,37,36,73,50.7%,24m
16975,3,foeverdream,2546,652,28,19,47,59.6%,1h
16975,3,安稳,2546,570,22,16,38,57.9%,8m
16975,1,realcola,2546,278,16,23,39,41.0%,1h
16975,2,他为何这么叼,2546,252,15,12,27,55.6%,30m
16975,3,[辉煌盟约]无色辉火,2546,282,11,1,12,91.7%,8m
16975,2,Radioactive,2546,202,8,9,17,47.1%,1h
16975,3,小天,2546,124,4,6,10,40.0%,1h
16975,1,SeanHsiung,2546,48,3,2,5,60.0%,45m
16975,3,老痞子,2546,0,0,2,2,0.0%,1h
16988,2,素质极差丶艾尔,2545,1552,87,87,174,50.0%,1h
16988,3,[浙大战队]铜锣湾话事人,2545,932,38,36,74,51.4%,29m
16988,3,陌上公子,2545,695,33,10,43,76.7%,54m
16988,2,龙与地下城,2545,688,25,25,50,50.0%,26m
16988,1,Virtuoso,2545,696,24,30,54,44.4%,55m
16988,2,老崔天下无敌,2545,236,19,16,35,54.3%,1h
16988,2,[世界树]雾雨星月,2545,355,17,13,30,56.7%,1h
16988,3,太平洋的眼泪,2545,413,16,15,31,51.6%,6m
16988,2,城市化建筑师,2545,271,9,10,19,47.4%,1h
16988,3,拾念韶华,2545,144,7,7,14,50.0%,1h
16988,1,mmmm,2545,229,5,11,16,31.2%,16m
16988,1,半流尘埃,2545,0,4,1,5,80.0%,1h
16988,3,[loopf2]决明,2545,0,4,3,7,57.1%,1h
16988,1,KKSMD,2545,141,3,3,6,50.0%,1h
16988,3,YCLTFans,2545,90,3,4,7,42.9%,10m
16988,2,不会玩,2545,95,3,6,9,33.3%,1h
16988,3,这是人干的吗,2545,34,2,1,3,66.7%,60m
16988,1,啥玩样儿,2545,97,2,3,5,40.0%,16m
16988,3,tenyear,2545,0,1,1,2,50.0%,29m
16988,1,SaintSophia,2545,0,1,1,2,50.0%,1h
16988,3,我是盲人,2545,0,0,1,1,0.0%,53m
16988,3,[鲁德欢]次元骇客,2545,0,0,1,1,0.0%,55m
17010,3,亚丝喵,2544,1631,76,68,144,52.8%,1h
17010,1,[神奇海螺]月下行梦人,2544,1506,61,56,117,52.1%,14m
17010,2,浮生叹,2544,552,22,19,41,53.7%,18m
17010,3,竞赛答卷亏损较,2544,462,18,15,33,54.5%,47m
17010,2,sss,2544,466,17,17,34,50.0%,1h
17010,2,炸鱼没妈,2544,393,14,13,27,51.9%,1h
17010,2,LightFH,2544,340,13,8,21,61.9%,37m
17010,2,zhaoyj,2544,153,5,4,9,55.6%,51m
17010,3,我真不会玩神族,2544,116,4,4,8,50.0%,42m
17010,1,[第六護衛艦]護衛艦隊總督,2544,131,4,11,15,26.7%,5m
17010,3,[LHZ]叶知恩的莓籽儿,2544,129,3,2,5,60.0%,1h
17010,3,EchoYi,2544,0,1,0,1,100.0%,1h
17010,3,四糸乃,2544,30,1,2,3,33.3%,1h
17010,2,桃桃桃子在此丶,2544,0,1,2,3,33.3%,29m
17010,1,德雷斯罗萨,2544,46,1,4,5,20.0%,1h
17010,1,一咲不爱笑,2544,0,0,1,1,0.0%,1h
17026,2,asdfgh,2543,989,74,66,140,52.9%,13m
17026,1,SCemperor,2543,526,20,27,47,42.6%,50m
17026,2,苏大大,2543,248,16,14,30,53.3%,16m
17026,1,好麻烦,2543,315,11,13,24,45.8%,47m
17026,3,不不不不,2543,256,10,3,13,76.9%,1h
17026,2,一手遮天,2543,314,10,16,26,38.5%,1h
17026,3,fateowen,2543,264,9,9,18,50.0%,17m
17026,3,DeadGame,2543,235,8,2,10,80.0%,20m
17026,3,[埃辛诺斯战刃]likeddd,2543,218,8,7,15,53.3%,24m
17026,1,[虫海攻略组]千惠子,2543,114,4,3,7,57.1%,24m
17026,1,[QNMB]简直是威武,2543,96,3,5,8,37.5%,1h
17026,3,[BoA星际迷]急旋风,2543,0,1,0,1,100.0%,1h
17026,1,[C67011]saber,2543,93,1,2,3,33.3%,1h
17026,3,[一个小可爱]虎牙丶冷月,2543,0,1,2,3,33.3%,45m
17040,1,似曾相识,2542,469,59,69,128,46.1%,27m
17040,3,ghghf,2542,824,45,40,85,52.9%,1h
17040,1,llllllllllll,2542,1162,44,45,89,49.4%,28m
17040,3,百江渚与巴麻美,2542,674,24,21,45,53.3%,8m
17040,2,dsdsf,2542,176,10,10,20,50.0%,1h
17040,2,无殤丶火,2542,183,7,5,12,58.3%,1h
17040,2,[大佬请把鞋给]小骷髅,2542,202,7,10,17,41.2%,58m
17040,2,Kanna,2542,108,5,9,14,35.7%,29m
17040,3,[禽禽禽]大帝丶屠鸡虐狗,2542,170,5,18,23,21.7%,58m
17040,3,未知丶,2542,90,3,3,6,50.0%,1h
17040,3,北方的雪,2542,97,3,4,7,42.9%,1h
17040,1,该用户非常懒,2542,157,3,11,14,21.4%,26m
17040,3,骚太阳,2542,30,2,1,3,66.7%,35m
17040,3,Scholar,2542,0,2,4,6,33.3%,23m
17040,1,[KGIC]三日月夜空,2542,0,1,0,1,100.0%,16m
17040,3,拗不过时光的荏苒,2542,0,1,0,1,100.0%,1h
17040,3,寒霜夜骑士,2542,0,1,1,2,50.0%,19m
17057,3,baiy,2541,1521,277,269,546,50.7%,8m
17057,3,亚历山大赵四,2541,1531,178,174,352,50.6%,29m
17057,2,[您好]odnvnnoaef,2541,487,19,18,37,51.4%,1h
17057,3,[喵呜喵呜]别打了我头像,2541,458,18,13,31,58.1%,55m
17057,2,[舰C]枫叶椛,2541,517,17,24,41,41.5%,55m
17057,3,艾萨克,2541,391,14,8,22,63.6%,17m
17057,1,普罗米修斯,2541,367,12,15,27,44.4%,1h
17057,1,夏雨霸气小王子,2541,178,10,16,26,38.5%,39m
17057,2,denaif,2541,253,8,4,12,66.7%,12m
17057,2,Smar,2541,119,4,8,12,33.3%,12m
17057,3,LIY,2541,97,3,5,8,37.5%,1h
17057,1,[异度黑核侵蚀]黑猫,2541,94,2,1,3,66.7%,41m
17057,3,[幻想舰队]炎丨虎,2541,0,1,0,1,100.0%,8m
17057,3,[星际一号]zzy,2541,0,1,0,1,100.0%,24m
17057,3,宝贝婷婷,2541,0,1,0,1,100.0%,1h
17057,1,零点,2541,0,1,0,1,100.0%,41m
17057,1,LeonTArbiter,2541,0,1,0,1,100.0%,36m
17057,3,[jklkoj]wewr,2541,0,0,1,1,0.0%,1h
17057,2,冰点的火锅,2541,0,0,2,2,0.0%,1h
17057,3,上官空雪,2541,0,0,3,3,0.0%,31m
17077,2,稻壳岛,2540,1619,270,260,530,50.9%,1h
17077,2,MrainGee,2540,733,63,76,139,45.3%,13m
17077,2,[菜有菜的道理]plum,2540,199,51,47,98,52.0%,41m
17077,3,fute,2540,476,17,13,30,56.7%,1h
17077,1,kikuchan,2540,287,8,12,20,40.0%,49m
17077,2,怒吼天尊,2540,118,4,3,7,57.1%,1h
17077,3,[NLHR]风痕之醉,2540,118,4,7,11,36.4%,6m
17077,3,变态,2540,97,3,5,8,37.5%,1h
17077,3,[一块晶化瓦斯]齐格菲青年,2540,30,2,0,2,100.0%,40m
17077,3,徐小会,2540,58,2,1,3,66.7%,1h
17077,3,[枪兵营]小少爷,2540,60,2,3,5,40.0%,8m
17077,2,某某菌,2540,0,1,1,2,50.0%,1h
17077,2,我不是新闻工作者,2540,0,1,2,3,33.3%,1h
17077,2,春大神,2540,30,1,5,6,16.7%,1h
17077,3,虫虫,2540,0,1,5,6,16.7%,23m
17077,3,[ADASDA]BlackJack,2540,0,0,1,1,0.0%,1h
17077,3,RIDER,2540,0,0,1,1,0.0%,1h
17077,3,KEALTHAS,2540,0,0,2,2,0.0%,10m
17077,2,在下马保国,2540,0,0,4,4,0.0%,1h
17096,2,[恋战皇朝]lovelyinzhu,2539,1592,170,168,338,50.3%,1h
17096,2,[一杆枪定天下]战争与天下,2539,859,36,33,69,52.2%,1h
17096,1,[暴雪零队]SuperHero,2539,553,27,25,52,51.9%,1h
17096,3,[极限菜鸟]晚安还有吖,2539,467,18,19,37,48.6%,58m
17096,3,阿桔才不是受,2539,181,14,7,21,66.7%,11m
17096,2,drakedog,2539,335,14,9,23,60.9%,26m
17096,1,[四叶草]娱乐玩家,2539,356,12,12,24,50.0%,49m
17096,2,lost,2539,290,11,16,27,40.7%,1h
17096,1,暗影行者,2539,298,10,16,26,38.5%,1h
17096,1,邪魔之神,2539,285,9,13,22,40.9%,1h
17096,3,kiro,2539,114,4,3,7,57.1%,11m
17096,2,Deact,2539,172,4,6,10,40.0%,1h
17096,3,摩诃不可思议,2539,124,4,18,22,18.2%,10m
17096,1,回眸灬留我在空城,2539,0,3,2,5,60.0%,28m
17096,3,KZsecret,2539,30,2,0,2,100.0%,1h
17096,3,[Dirge丶]冷风啊,2539,30,2,1,3,66.7%,1h
17096,3,[北极光之旅]天降正义,2539,0,0,1,1,0.0%,10m
17096,3,Jcam,2539,0,0,2,2,0.0%,1h
17114,2,恶魔之吻,2538,1123,93,79,172,54.1%,1h
17114,1,TuriN,2538,1547,60,64,124,48.4%,1h
17114,2,[一峰海鲜市场]伯恩山,2538,1229,49,45,94,52.1%,1h
17114,2,track,2538,815,34,35,69,49.3%,28m
17114,2,身居野浪场,2538,427,31,30,61,50.8%,26m
17114,2,[SDEt]梅菜扣肉,2538,559,27,14,41,65.9%,20m
17114,2,御坂御坂,2538,428,19,7,26,73.1%,1h
17114,2,人菜瘾还大,2538,254,9,8,17,52.9%,1h
17114,1,抱走迪迪迪,2538,186,7,9,16,43.8%,3m
17114,1,神之长子万世长存,2538,183,6,4,10,60.0%,44m
17114,3,[CaiBee]JJZ,2538,86,4,2,6,66.7%,51m
17114,3,[Tsing]亲年,2538,167,4,2,6,66.7%,19m
17114,1,她不会回来了,2538,143,3,3,6,50.0%,10m
17114,2,darker,2538,92,3,6,9,33.3%,19m
17114,1,瓦卡那万岁,2538,0,2,3,5,40.0%,1h
17114,2,Lilpoike,2538,30,2,5,7,28.6%,30m
17114,3,alkfhlk,2538,0,1,0,1,100.0%,1h
17114,3,[缩阳入腹]旋风小麻批,2538,0,1,1,2,50.0%,24m
17114,2,是橘猫大人,2538,0,1,2,3,33.3%,1h
17114,2,宇宙中的一粒沙,2538,30,1,5,6,16.7%,1h
17114,3,[SS天羽]天马流星拳,2538,0,0,1,1,0.0%,1h
17114,1,眼泪的错觉,2538,0,0,1,1,0.0%,3m
17114,1,hqc,2538,0,0,2,2,0.0%,1h
17114,2,[吃喝睡打埃蒙]猛丶男,2538,0,0,3,3,0.0%,58m
17138,3,[势在必得]祺祺儿,2537,709,102,91,193,52.8%,8m
17138,3,YZKKKZ,2537,386,26,22,48,54.2%,1h
17138,2,明天星期七,2537,556,21,23,44,47.7%,16m
17138,3,plusplus,2537,356,16,2,18,88.9%,1h
17138,3,泰伦不攻击泰伦,2537,403,13,24,37,35.1%,17m
17138,3,脑虫在世输本酱,2537,336,12,9,21,57.1%,1h
17138,2,[队花探姬]风渡人影剑渡天,2537,128,9,7,16,56.2%,58m
17138,2,张叔,2537,201,6,6,12,50.0%,26m
17138,2,三体联邦,2537,234,6,7,13,46.2%,1h
17138,3,一叶知秋,2537,194,6,7,13,46.2%,1h
17138,2,IIIIIIIIIIII,2537,202,5,5,10,50.0%,15m
17138,2,[我队伍很强大]审判之日,2537,130,4,3,7,57.1%,13m
17138,2,RoyalKnight,2537,136,3,2,5,60.0%,1h
17138,3,星灵,2537,0,1,0,1,100.0%,1h
17138,3,先锋,2537,30,1,1,2,50.0%,1h
17138,2,[船舶人]镰仓先生,2537,0,1,1,2,50.0%,1h
17138,2,[东方众]Drsfjo,2537,0,1,2,3,33.3%,1h
17138,1,Kid,2537,0,1,4,5,20.0%,1h
17138,3,[星际老囡孩]孙一喵,2537,0,0,1,1,0.0%,1h
17138,3,[s黑色玫瑰s]贤贤易色,2537,0,0,2,2,0.0%,42m
17158,1,童话完成,2536,1082,58,62,120,48.3%,1h
17158,3,阿萨大雪糕,2536,667,27,19,46,58.7%,1h
17158,3,千万欲火难退身,2536,273,9,14,23,39.1%,40m
17158,2,nerone,2536,228,8,7,15,53.3%,11m
17158,3,HeOx,2536,176,6,5,11,54.5%,1h
17158,3,山海有声,2536,191,6,6,12,50.0%,1h
17158,3,luoye,2536,30,3,5,8,37.5%,23m
17158,3,燚渊,2536,30,2,1,3,66.7%,24m
17158,3,ChristopherM,2536,0,2,4,6,33.3%,1h
17158,3,[恒古不灭]指挥官,2536,0,1,0,1,100.0%,1h
17158,3,沈明轩,2536,0,1,1,2,50.0%,1h
17158,2,[马润万岁]boy,2536,0,1,7,8,12.5%,1h
17158,3,[魔神教主]浪影,2536,0,0,1,1,0.0%,1h
17158,3,[星际战魂]星际战魂丶超哥,2536,0,0,2,2,0.0%,8m
17158,3,小菜毛腿,2536,0,0,2,2,0.0%,1h
17173,2,Lingxin,2535,825,39,21,60,65.0%,1h
17173,1,星际学徒,2535,766,28,36,64,43.8%,44m
17173,2,Innovation,2535,438,27,25,52,51.9%,1h
17173,3,自由之子,2535,533,23,17,40,57.5%,10m
17173,1,[暴雪我是你爹]Wirard,2535,472,21,21,42,50.0%,16m
17173,1,jeff,2535,331,14,8,22,63.6%,39m
17173,2,[日最野的狗]wqdsfgf,2535,233,11,6,17,64.7%,51m
17173,3,leopards,2535,233,10,7,17,58.8%,1h
17173,2,ZGreement,2535,248,7,8,15,46.7%,46m
17173,2,铅笔,2535,128,6,9,15,40.0%,45m
17173,3,[南昌一枝花]始终茹一,2535,120,5,3,8,62.5%,10m
17173,3,此生绝非打工人,2535,167,5,6,11,45.5%,1h
17173,2,林蓝,2535,116,4,2,6,66.7%,1h
17173,3,DengSIr,2535,129,4,6,10,40.0%,1h
17173,3,[星际罪恶]神舟文明,2535,22,2,2,4,50.0%,1h
17173,1,wuming,2535,0,2,3,5,40.0%,1h
17173,3,moren,2535,0,1,0,1,100.0%,1h
17173,1,[黑暗葬送者]黑冥魂一幽灵魅,2535,0,1,0,1,100.0%,54m
17173,2,乌瑟尔,2535,0,0,1,1,0.0%,1h
17173,3,黑虎阿福,2535,0,0,1,1,0.0%,31m
17173,1,[康忙oO北鼻]我发的感觉,2535,0,0,2,2,0.0%,1h
17194,3,影峰,2534,626,23,19,42,54.8%,24m
17194,2,IIIIIIIIIIII,2534,192,19,14,33,57.6%,55m
17194,2,地球无敌舰队,2534,345,15,11,26,57.7%,1h
17194,2,撒撒撒,2534,429,14,15,29,48.3%,1h
17194,1,RENDERS,2534,360,14,16,30,46.7%,55m
17194,1,红叶,2534,318,8,11,19,42.1%,17m
17194,1,新手训练营,2534,122,5,8,13,38.5%,1h
17194,2,Storm,2534,130,4,0,4,100.0%,38m
17194,3,Sareonly,2534,58,3,0,3,100.0%,1h
17194,3,哇覆盖,2534,142,3,3,6,50.0%,58m
17194,3,钱噜噜,2534,97,3,3,6,50.0%,1h
17194,2,[请帮我嘴交谢]南呱头,2534,60,3,5,8,37.5%,33m
17194,3,吃饱的加菲猫,2534,0,2,4,6,33.3%,9m
17194,3,Resolution,2534,0,1,0,1,100.0%,10m
17194,3,FragmEENT,2534,0,1,0,1,100.0%,1h
17194,3,政政必拿奥斯卡,2534,30,1,2,3,33.3%,1h
17194,2,saber,2534,0,1,3,4,25.0%,1h
17194,1,啊那米亚,2534,0,1,4,5,20.0%,54m
17194,3,[荣耀丶殿堂]妈妈船,2534,0,0,1,1,0.0%,1h
17194,3,我的阿宝,2534,0,0,1,1,0.0%,58m
17194,3,年级组长王老师,2534,0,0,1,1,0.0%,1h
17194,3,一阳大胜利,2534,0,0,1,1,0.0%,46m
17194,3,马保国首席大弟子,2534,0,0,2,2,0.0%,20m
17194,2,东南信风,2534,0,0,3,3,0.0%,1h
17218,3,Rockyan,2533,1541,152,144,296,51.4%,1h
17218,2,showbad,2533,539,78,75,153,51.0%,1h
17218,1,GOGOL,2533,1507,77,79,156,49.4%,50m
17218,2,武破天,2533,1321,57,49,106,53.8%,1h
17218,3,大石碎胸口,2533,1255,48,46,94,51.1%,55m
17218,2,Untitled,2533,398,14,14,28,50.0%,1h
17218,3,分段的发顺嘿嘿,2533,192,8,5,13,61.5%,10m
17218,2,[MXJ]墨小菊,2533,165,8,9,17,47.1%,55m
17218,2,[一笑泯千仇]YGlover,2533,84,5,7,12,41.7%,60m
17218,2,萌小萌,2533,126,5,7,12,41.7%,1h
17218,3,[IBE]浅夏微梦,2533,107,4,3,7,57.1%,10m
17218,3,[SB250]福州土人,2533,60,3,1,4,75.0%,24m
17218,2,LEOH,2533,102,3,3,6,50.0%,51m
17218,1,光滑滑,2533,0,2,3,5,40.0%,1h
17218,1,[TJMU]决战声优,2533,48,2,4,6,33.3%,1h
17218,3,Katana,2533,0,1,0,1,100.0%,52m
17218,3,Bogus,2533,0,1,0,1,100.0%,1h
17218,3,speakman,2533,0,1,1,2,50.0%,34m
17218,3,Sai,2533,30,1,2,3,33.3%,53m
17218,3,[半夏]暗小白,2533,32,1,2,3,33.3%,1h
17218,3,[1萌新大军1]希绪费斯,2533,0,0,2,2,0.0%,1h
17218,3,indolent,2533,0,0,10,10,0.0%,1h
17240,3,[幽冥舰队]晓风明月,2532,1164,44,58,102,43.1%,11m
17240,2,裴柱现你也杀,2532,817,32,38,70,45.7%,1h
17240,3,[不知不觉天亮]孙一喵,2532,659,27,17,44,61.4%,1h
17240,1,[123猫猫]名词是名字,2532,729,24,30,54,44.4%,35m
17240,3,[社交学讲师]姜饼人,2532,403,14,10,24,58.3%,31m
17240,3,daby,2532,335,13,6,19,68.4%,58m
17240,3,Drzomboss,2532,266,10,9,19,52.6%,1h
17240,2,[你失马]塞翁你马死了,2532,228,8,0,8,100.0%,1h
17240,1,拾遗者,2532,230,8,13,21,38.1%,1h
17240,2,熊爷,2532,155,6,3,9,66.7%,1h
17240,2,djckawf,2532,149,4,1,5,80.0%,46m
17240,1,[灵猫]诺大的娃,2532,0,1,3,4,25.0%,1h
17240,3,[TJBAD]lBF,2532,0,0,1,1,0.0%,1h
17240,3,[X英雄圣域X]资本主义好,2532,0,0,1,1,0.0%,1h
17240,3,balabala,2532,0,0,1,1,0.0%,1h
17240,1,冰山一蕉,2532,0,0,1,1,0.0%,45m
17240,2,赤赤然,2532,0,0,4,4,0.0%,20m
17257,3,小胖子,2531,407,20,14,34,58.8%,32m
17257,3,Crucifix,2531,520,19,16,35,54.3%,1h
17257,2,灰飞烟灭,2531,325,14,13,27,51.9%,1h
17257,1,[月光]复仇者联盟,2531,315,11,17,28,39.3%,1h
17257,2,吟瘾怪,2531,188,5,2,7,71.4%,45m
17257,3,初相识,2531,96,5,2,7,71.4%,34m
17257,3,总司小姐大胜利,2531,114,4,4,8,50.0%,1h
17257,1,亚顿之矛,2531,134,4,8,12,33.3%,10m
17257,3,路人,2531,58,3,0,3,100.0%,20m
17257,3,[泰瑞亚]FKLQ,2531,60,3,1,4,75.0%,24m
17257,3,虎混天梯,2531,97,2,1,3,66.7%,44m
17257,3,[澪不法之徒]三千,2531,60,2,2,4,50.0%,1h
17257,3,企鹅物流,2531,0,2,4,6,33.3%,1h
17257,3,星爵,2531,0,1,0,1,100.0%,18m
17257,3,残梦,2531,30,1,1,2,50.0%,29m
17257,2,[MD2]SilveryGospe,2531,0,1,2,3,33.3%,4m
17257,3,Rage,2531,0,0,1,1,0.0%,1h
17257,3,[阿瓦隆之斩]Dream,2531,0,0,1,1,0.0%,10m
17257,3,暗金冥,2531,0,0,1,1,0.0%,44m
17257,3,[神子]Pinkrock,2531,0,0,2,2,0.0%,1h
17257,3,[樱之岛]IIIIIIIIIIII,2531,0,0,3,3,0.0%,11m
17278,3,你眼中的世界,2530,998,82,92,174,47.1%,20m
17278,1,IIIIIIIIIIII,2530,1464,71,66,137,51.8%,1h
17278,1,小布快跑,2530,912,36,41,77,46.8%,34m
17278,3,赭石,2530,471,18,26,44,40.9%,6m
17278,2,[暴雪二十二队]鸦之羽,2530,500,16,19,35,45.7%,30m
17278,3,Journal,2530,381,15,7,22,68.2%,1h
17278,2,[幼女萝莉同好]phantasma,2530,296,11,14,25,44.0%,1h
17278,1,[Milan1]陌上拾年,2530,255,8,5,13,61.5%,1h
17278,3,你好,2530,121,4,4,8,50.0%,1h
17278,2,DarlinG,2530,152,4,5,9,44.4%,1h
17278,2,[notdie]天宫丶帝俊,2530,184,4,6,10,40.0%,1h
17278,2,SoSooo,2530,104,3,3,6,50.0%,1h
17278,3,[miku守护]消失的雨,2530,0,1,1,2,50.0%,40m
17278,1,Christina,2530,97,1,2,3,33.3%,44m
17278,3,[葫芦娃救艾尔]艾尔高阶跳虫,2530,0,1,2,3,33.3%,1h
17278,2,[混元体我女仆]我问问而得到,2530,30,1,6,7,14.3%,16m
17278,1,[GalArC]永远的巫女,2530,0,0,1,1,0.0%,1h
17278,3,[星核纪]天墨非夜,2530,0,0,1,1,0.0%,20m
17296,1,yourgrace,2529,956,36,36,72,50.0%,1h
17296,2,踏梦而来,2529,313,14,4,18,77.8%,15m
17296,2,渡仁之隼,2529,231,11,13,24,45.8%,33m
17296,2,螟蜓,2529,180,10,12,22,45.5%,1h
17296,3,柳逸尘,2529,193,7,2,9,77.8%,20m
17296,2,SAOBTerran,2529,154,5,5,10,50.0%,1h
17296,2,LOVE,2529,84,4,9,13,30.8%,58m
17296,1,samoger,2529,48,3,4,7,42.9%,20m
17296,1,Lawrence,2529,141,3,6,9,33.3%,1h
17296,3,[单马尾赛高]marasaki,2529,30,2,0,2,100.0%,20m
17296,1,BIGSAN,2529,0,2,3,5,40.0%,17m
17296,3,尼德霍格,2529,60,2,4,6,33.3%,58m
17296,3,BAAAAAANG,2529,97,2,6,8,25.0%,51m
17296,3,鸟抛花语丸丸落,2529,0,1,0,1,100.0%,1h
17296,3,孤独寂寞,2529,0,1,1,2,50.0%,1h
17296,3,huojianpan,2529,0,1,2,3,33.3%,26m
17296,1,万隐下天山,2529,46,1,4,5,20.0%,1h
17296,3,吾妻狂三,2529,0,0,1,1,0.0%,52m
17296,3,ForAiur,2529,0,0,1,1,0.0%,1h
17296,3,原野青山,2529,0,0,1,1,0.0%,53m
17316,1,ttyttty,2528,1594,327,337,664,49.2%,34m
17316,3,盖儿,2528,802,35,31,66,53.0%,1h
17316,1,Enderman,2528,710,30,22,52,57.7%,37m
17316,3,[长征小白]沙加在世,2528,709,28,18,46,60.9%,1h
17316,3,[透一下清酒]永远喜欢着鹿乃,2528,577,23,15,38,60.5%,1h
17316,3,三水,2528,566,21,15,36,58.3%,1h
17316,3,liweisi,2528,339,12,13,25,48.0%,1h
17316,1,[天国之魔]GGmoonlight,2528,377,11,20,31,35.5%,1h
17316,2,Green,2528,223,8,5,13,61.5%,52m
17316,3,[洛水天依]卡拉是条狗,2528,145,5,4,9,55.6%,1h
17316,3,xxxxxxxx,2528,146,5,5,10,50.0%,1h
17316,2,[北京外事电竞]POWER,2528,168,4,2,6,66.7%,31m
17316,1,kevin,2528,48,3,4,7,42.9%,1h
17316,3,陆走走,2528,121,2,2,4,50.0%,1h
17316,3,[柠檬保护协会]老子是傻币,2528,34,2,2,4,50.0%,1h
17316,2,[相爱一家亲]深邃蔚蓝,2528,0,1,0,1,100.0%,12m
17316,3,[祢豆子真好看]喜欢祢豆子,2528,0,1,0,1,100.0%,1h
17316,3,新手电脑,2528,0,1,0,1,100.0%,8m
17316,3,虚空,2528,30,1,1,2,50.0%,8m
17316,3,[哦卡哇伊阔多]imbasun,2528,30,1,2,3,33.3%,1h
17316,2,Jerry,2528,91,1,2,3,33.3%,12m
17316,3,六十八,2528,0,0,1,1,0.0%,24m
17316,1,QINGYU,2528,0,0,1,1,0.0%,1h
17316,3,[P18]又菜又爱玩,2528,0,0,2,2,0.0%,40m
17316,3,[萝莉即真理]鸣濑白羽天下第一,2528,0,0,2,2,0.0%,31m
17341,2,Light,2527,1178,151,152,303,49.8%,1h
17341,1,上帝之鞭,2527,1110,46,49,95,48.4%,1h
17341,3,这把我要赢,2527,651,45,35,80,56.2%,1h
17341,2,kiser,2527,986,40,38,78,51.3%,30m
17341,3,苦痴,2527,421,15,9,24,62.5%,8m
17341,3,王新茹是猪,2527,310,11,5,16,68.8%,35m
17341,3,小雨子,2527,236,9,5,14,64.3%,1h
17341,2,Guikarist,2527,248,9,11,20,45.0%,1h
17341,3,OneKey,2527,237,8,1,9,88.9%,1h
17341,3,CaOiNGeR,2527,164,5,4,9,55.6%,8m
17341,3,当夜晚拥有星星,2527,193,5,5,10,50.0%,4m
17341,2,东莞虫王,2527,130,4,4,8,50.0%,1h
17341,2,[譏颰]Suker,2527,82,4,5,9,44.4%,1h
17341,2,leathersofa,2527,135,4,7,11,36.4%,1h
17341,3,[探机之怒]ByebyeBaby,2527,121,3,5,8,37.5%,58m
17341,2,wwei,2527,30,2,4,6,33.3%,1h
17341,3,霖不怂,2527,121,2,5,7,28.6%,1h
17341,3,我真的是萌新,2527,0,1,0,1,100.0%,1h
17341,3,爱喝雪碧的灰,2527,97,1,5,6,16.7%,26m
17341,3,静心大人,2527,0,0,1,1,0.0%,1h
17341,3,[谁在呼叫舰队]逼格之王,2527,0,0,1,1,0.0%,1h
17362,2,[皮断腿]孝悌,2526,1543,139,145,284,48.9%,58m
17362,2,鬼哭狼嚎,2526,857,56,48,104,53.8%,13m
17362,3,acrosol,2526,922,41,53,94,43.6%,16m
17362,2,[小鸡屠宰场8]相心,2526,524,25,25,50,50.0%,1h
17362,2,[毒雨]蓝色空间号,2526,473,19,23,42,45.2%,1h
17362,2,村雨,2526,377,14,19,33,42.4%,1h
17362,2,[Joyce]money,2526,270,11,10,21,52.4%,1h
17362,1,[東風快递]FORWARDWANG,2526,355,11,16,27,40.7%,11m
17362,1,[XYG]Saber,2526,218,9,13,22,40.9%,1h
17362,3,admkw,2526,246,8,5,13,61.5%,8m
17362,3,花开半夏,2526,120,5,6,11,45.5%,1h
17362,3,[琴筝]Kingdom,2526,90,4,3,7,57.1%,1h
17362,3,[低调且自信]低调虐菜,2526,38,3,6,9,33.3%,55m
17362,3,暗殇,2526,58,2,3,5,40.0%,55m
17362,1,Inherat,2526,0,2,3,5,40.0%,1h
17362,1,诺兰斯,2526,0,2,4,6,33.3%,1h
17362,3,[QWQa]抢码,2526,30,1,3,4,25.0%,1h
17379,2,率洒俄方面,2525,1151,87,74,161,54.0%,4m
17379,2,发胶手,2525,1553,70,59,129,54.3%,1h
17379,2,星际马保国,2525,766,39,33,72,54.2%,1h
17379,1,雨中漫步,2525,954,35,40,75,46.7%,34m
17379,3,[HustSC]闭关,2525,374,15,17,32,46.9%,55m
17379,3,[老色痞]人生何处不青山,2525,336,14,5,19,73.7%,55m
17379,1,天行者,2525,363,13,12,25,52.0%,49m
17379,1,rtfrhtf,2525,339,11,12,23,47.8%,17m
17379,3,渐行渐远,2525,260,10,4,14,71.4%,1h
17379,2,bony,2525,270,10,13,23,43.5%,13m
17379,3,风轻云淡,2525,227,9,8,17,52.9%,1h
17379,2,嘎嘎嘎,2525,136,5,2,7,71.4%,16m
17379,3,中二病骚年,2525,109,5,3,8,62.5%,1h
17379,2,lwzyzj,2525,120,5,10,15,33.3%,27m
17379,3,[清华野大学]宰我,2525,86,4,2,6,66.7%,40m
17379,3,[CPT]SYCQ,2525,58,3,1,4,75.0%,1h
17379,2,[谐星x]笔下生花,2525,128,3,6,9,33.3%,8m
17379,1,frank,2525,70,3,9,12,25.0%,1h
17379,1,孙龘,2525,0,2,3,5,40.0%,1h
17379,3,梦太重,2525,97,1,2,3,33.3%,1h
17379,3,无敌的鲨鱼鲨鱼,2525,97,1,2,3,33.3%,1h
17379,1,放的好机会,2525,0,0,1,1,0.0%,1h
17379,3,平方米,2525,0,0,1,1,0.0%,55m
17379,3,晓风肆雪,2525,0,0,1,1,0.0%,55m
17379,2,FGWJ,2525,0,0,6,6,0.0%,1h
17404,3,[91秦先生]哎呦卧槽,2524,1378,54,65,119,45.4%,11m
17404,2,[CPT]沧海月明,2524,635,46,47,93,49.5%,16m
17404,3,工蜂,2524,845,31,28,59,52.5%,1h
17404,2,[白银联盟]绝世好贱,2524,722,26,29,55,47.3%,1h
17404,3,[暴雪二十六队]只玩神族的新人,2524,591,24,22,46,52.2%,11m
17404,2,黑芒,2524,501,22,14,36,61.1%,1h
17404,3,[智青]修仙者,2524,250,13,17,30,43.3%,1h
17404,3,逍遥灬浪子,2524,294,11,3,14,78.6%,42m
17404,3,小黄狗,2524,227,11,12,23,47.8%,1h
17404,2,Dmessitup,2524,238,9,15,24,37.5%,1h
17404,2,利布拉,2524,76,8,4,12,66.7%,12m
17404,2,丨氢氧化钠丨,2524,250,6,13,19,31.6%,1h
17404,1,[KENNEL]五秒,2524,150,5,8,13,38.5%,1h
17404,2,傲天战皇,2524,30,4,6,10,40.0%,5m
17404,2,wadu,2524,114,4,7,11,36.4%,28m
17404,1,YPLV,2524,0,3,2,5,60.0%,3m
17404,3,siru,2524,118,3,3,6,50.0%,8m
17404,3,天纵,2524,90,3,4,7,42.9%,40m
17404,3,星神,2524,30,2,0,2,100.0%,1h
17404,1,[CnDY]Von,2524,0,2,3,5,40.0%,54m
17404,2,[ceeeeb]陆夯,2524,30,2,3,5,40.0%,1h
17404,3,[文韬武略]小怪兽,2524,60,2,3,5,40.0%,1h
17404,3,Human,2524,30,2,3,5,40.0%,18m
17404,3,benren,2524,0,0,1,1,0.0%,1h
17404,3,[ESKT]雷神,2524,0,0,1,1,0.0%,1h
17429,3,SuPRe,2523,1008,39,35,74,52.7%,1h
17429,2,Kirito,2523,511,27,21,48,56.2%,11m
17429,1,夜北凉,2523,627,24,21,45,53.3%,50m
17429,3,[泰伦斧头帮]scboyfaren,2523,442,18,7,25,72.0%,24m
17429,2,万增达,2523,382,16,10,26,61.5%,19m
17429,2,逆风好残,2523,466,15,18,33,45.5%,18m
17429,2,[红烛昏罗帐]风暴,2523,348,14,17,31,45.2%,58m
17429,1,MrISIS,2523,324,10,20,30,33.3%,1h
17429,3,[别害怕少年]蜗牛,2523,228,7,5,12,58.3%,1h
17429,3,布布吃饱了,2523,203,6,5,11,54.5%,30m
17429,2,[浙大战队]mogrli,2523,154,5,4,9,55.6%,1h
17429,1,萌新,2523,167,4,5,9,44.4%,1h
17429,1,[Sfae]DuskVerdict,2523,100,3,12,15,20.0%,18m
17429,3,[MGnb]LIAOYUAN,2523,38,2,0,2,100.0%,48m
17429,1,Ghoust,2523,0,2,3,5,40.0%,44m
17429,3,微笑的橙子,2523,30,2,3,5,40.0%,19m
17429,3,[DMRc]TdosXZ,2523,0,1,0,1,100.0%,1h
17429,3,奶牛,2523,0,1,1,2,50.0%,1h
17429,3,[SNC000]Eternity,2523,0,1,2,3,33.3%,55m
17429,1,Sora,2523,0,1,3,4,25.0%,1h
17429,2,阳光嘿宝,2523,0,1,4,5,20.0%,1h
17429,3,星空之萨尔那咖,2523,0,0,1,1,0.0%,1h
17429,3,战神,2523,0,0,1,1,0.0%,1h
17429,3,众生皆蝼蚁,2523,0,0,1,1,0.0%,54m
17429,1,[素质三连]pororo,2523,0,0,3,3,0.0%,28m
17454,2,gumin,2522,354,69,53,122,56.6%,1h
17454,3,秀川,2522,565,59,47,106,55.7%,10m
17454,2,飞龙骑脸怎么输,2522,574,34,46,80,42.5%,13m
17454,2,阿道夫叔叔,2522,369,15,9,24,62.5%,1h
17454,2,[战场之舞]MrAMC,2522,332,14,15,29,48.3%,1h
17454,3,THEFOOL,2522,370,13,17,30,43.3%,11m
17454,2,[29CM]宜选月冷风清,2522,218,10,9,19,52.6%,39m
17454,2,qing,2522,180,7,6,13,53.8%,16m
17454,2,keliove,2522,210,7,10,17,41.2%,6m
17454,2,[迦勒底]wind,2522,187,6,9,15,40.0%,46m
17454,1,[就这就这]Cephedra,2522,192,5,1,6,83.3%,1h
17454,1,Luciferre,2522,48,5,1,6,83.3%,1h
17454,2,FKPoAEW,2522,152,5,11,16,31.2%,1h
17454,3,Minghao,2522,114,4,3,7,57.1%,58m
17454,3,[KNAT]SCPLAYER,2522,90,4,4,8,50.0%,11m
17454,3,明月出天山,2522,38,4,6,10,40.0%,42m
17454,3,waris,2522,88,3,4,7,42.9%,54m
17454,2,[HHZX]燕归人,2522,88,2,2,4,50.0%,1h
17454,3,[是我赢了]恶魔先生,2522,60,2,3,5,40.0%,1h
17454,2,[ZSB铁憨憨]团队毒瘤,2522,107,2,3,5,40.0%,1h
17454,3,鹏彭砰,2522,122,2,3,5,40.0%,1h
17454,1,IDWLL,2522,0,2,4,6,33.3%,1h
17454,3,陈长青,2522,0,1,0,1,100.0%,25m
17454,3,[荣耀归于我主]卂残,2522,0,1,1,2,50.0%,1h
17454,3,[被感染的魔仙]当月亮坠进海里,2522,0,0,1,1,0.0%,1h
17454,3,[天马流星狗]皇后大道东,2522,0,0,1,1,0.0%,42m
17454,1,时光修补匠托奇,2522,0,0,2,2,0.0%,1h
17481,2,[Marisa]许末,2521,1082,130,125,255,51.0%,4m
17481,1,[夕林]Darkcookue,2521,1495,101,93,194,52.1%,14m
17481,3,逃跑小太郎,2521,1354,100,106,206,48.5%,17m
17481,2,芜湖,2521,1469,78,88,166,47.0%,22m
17481,2,[人族最强近战]小红帽的大镰刀,2521,1049,44,38,82,53.7%,58m
17481,1,[破晓黎明]泉声猪猪,2521,1039,40,46,86,46.5%,50m
17481,2,瞿帅比,2521,938,34,32,66,51.5%,1h
17481,2,[黑鲨]苏子莫邪,2521,740,33,34,67,49.3%,1h
17481,3,star,2521,612,25,15,40,62.5%,58m
17481,2,[LSC2]NextLevelCS,2521,556,24,29,53,45.3%,19m
17481,1,沐晗,2521,380,18,15,33,54.5%,1h
17481,2,linespace,2521,419,17,16,33,51.5%,42m
17481,3,[NanTeS]IIIIIIIIII,2521,288,11,4,15,73.3%,1h
17481,2,击剑高手,2521,261,11,7,18,61.1%,1h
17481,3,土豆,2521,267,9,6,15,60.0%,1h
17481,1,Regression,2521,330,9,12,21,42.9%,45m
17481,3,[X英雄圣域X]诸星,2521,235,8,3,11,72.7%,54m
17481,2,aWaY,2521,176,7,8,15,46.7%,1h
17481,3,汝装,2521,0,4,3,7,57.1%,1h
17481,3,本子妃,2521,108,4,5,9,44.4%,1h
17481,3,[洛河LH]柠檬不萌,2521,30,2,1,3,66.7%,1h
17481,3,暗之锋芒,2521,32,2,2,4,50.0%,1h
17481,3,神龙虾米,2521,60,2,3,5,40.0%,58m
17481,2,风暴风云,2521,46,2,5,7,28.6%,1h
17481,3,[最爱雪辉了]我妻由乃,2521,0,1,0,1,100.0%,1h
17481,2,玉川现食葱,2521,38,1,2,3,33.3%,38m
17481,2,[死亡的空隙]星际魔龙,2521,95,1,3,4,25.0%,16m
17481,3,今天也变白了呢,2521,0,0,3,3,0.0%,23m
17509,3,龙门泥鳅,2520,1059,41,34,75,54.7%,47m
17509,2,maruke,2520,954,41,36,77,53.2%,1h
17509,3,暗尘凌锋,2520,911,38,35,73,52.1%,1h
17509,3,白给二号,2520,686,31,19,50,62.0%,1h
17509,3,态度,2520,698,31,23,54,57.4%,1h
17509,2,[baqi]baqi,2520,668,26,27,53,49.1%,1h
17509,2,[半夏]KKblood,2520,349,12,12,24,50.0%,31m
17509,3,科学魔法师,2520,297,12,14,26,46.2%,1h
17509,2,鬼筱,2520,287,11,9,20,55.0%,49m
17509,3,硝鼠粮碴,2520,220,10,3,13,76.9%,11m
17509,2,floatdream,2520,308,9,6,15,60.0%,1h
17509,3,神之荣耀,2520,215,7,9,16,43.8%,47m
17509,1,月影依风,2520,217,7,11,18,38.9%,1h
17509,3,[世风第三帝国]本杰拉斯大赌怪,2520,213,6,3,9,66.7%,55m
17509,3,[推荐艺人]安吉拉逼逼,2520,144,5,5,10,50.0%,1h
17509,2,一波狗全家暴毙,2520,156,5,5,10,50.0%,41m
17509,3,Ranger,2520,92,4,2,6,66.7%,18m
17509,3,lee,2520,97,3,5,8,37.5%,1h
17509,2,征战,2520,45,3,7,10,30.0%,1h
17509,1,xiaofeng,2520,0,2,1,3,66.7%,28m
17509,1,sunshine,2520,0,2,3,5,40.0%,20m
17509,1,浪人,2520,0,2,3,5,40.0%,45m
17509,3,freeXeme,2520,0,1,0,1,100.0%,1h
17509,3,一百万基佬,2520,0,1,0,1,100.0%,1h
17509,1,[罗德岛研究组]阿米娅不是驴,2520,0,1,0,1,100.0%,17m
17509,3,lwb,2520,0,1,1,2,50.0%,59m
17509,3,lsc,2520,30,1,1,2,50.0%,1h
17509,3,霰氙,2520,0,1,1,2,50.0%,35m
17509,2,无奈,2520,0,0,1,1,0.0%,12m
17509,3,就欺负我不会玩虫,2520,0,0,1,1,0.0%,18m
17509,3,黑幽灵,2520,0,0,2,2,0.0%,1h
17509,3,空灵,2520,0,0,2,2,0.0%,55m
17509,3,星际零零后,2520,0,0,2,2,0.0%,1h
17542,2,天下第贰,2519,981,82,83,165,49.7%,58m
17542,3,lonerfans,2519,1072,46,36,82,56.1%,19m
17542,1,[慢手e族]松鼠,2519,867,38,36,74,51.4%,19m
17542,3,[镜花水月]OhmaZio,2519,589,22,18,40,55.0%,24m
17542,3,[幽灵闪现wo]饿饿饿,2519,366,14,14,28,50.0%,1h
17542,2,全知全能的树,2519,257,11,13,24,45.8%,13m
17542,3,Axie,2519,304,10,13,23,43.5%,35m
17542,1,少时诵诗书所,2519,168,9,19,28,32.1%,34m
17542,3,[太微玉清宫]情瘦先森,2519,94,5,5,10,50.0%,25m
17542,1,[嗑药小分队]苏南北,2519,235,5,9,14,35.7%,25m
17542,3,剪舌麻雀,2519,140,4,0,4,100.0%,55m
17542,2,momosad,2519,42,4,7,11,36.4%,12m
17542,3,dakness,2519,58,3,4,7,42.9%,1h
17542,3,秀儿,2519,32,3,6,9,33.3%,26m
17556,1,VOUS,2518,1515,227,243,470,48.3%,25m
17556,3,[CPT]obabo,2518,1594,80,71,151,53.0%,35m
17556,2,Spigven,2518,1485,69,75,144,47.9%,5m
17556,3,nameless,2518,797,31,25,56,55.4%,1h
17556,3,CryWind,2518,518,25,21,46,54.3%,24m
17556,2,闻袜者,2518,716,25,31,56,44.6%,1h
17556,2,[钟欣潼]血凌染,2518,580,21,27,48,43.8%,11m
17556,2,Revolution,2518,475,17,20,37,45.9%,18m
17556,3,稚气老妈,2518,332,13,14,27,48.1%,8m
17556,3,时光机阿斗,2518,317,11,6,17,64.7%,26m
17556,3,卑微小跳虫,2518,280,10,9,19,52.6%,24m
17556,3,裤裆藏雷,2518,171,5,7,12,41.7%,1h
17556,2,[我们是无敌的]究极黑暗,2518,152,5,10,15,33.3%,1h
17556,1,caserta,2518,168,4,5,9,44.4%,1h
17556,1,[自由的气息]刺蛇说的都对,2518,92,4,12,16,25.0%,39m
17556,3,[旭东白丝圣奶]绘梨,2518,60,3,1,4,75.0%,1h
17556,3,[NPUED]Arthas,2518,97,3,1,4,75.0%,1h
17556,3,无限泡泡,2518,97,3,5,8,37.5%,60m
17556,3,斯蒂芬,2518,119,2,1,3,66.7%,1h
17556,3,darkpants,2518,38,2,2,4,50.0%,55m
17556,1,晃荡的左腿,2518,48,2,6,8,25.0%,1h
17556,1,IIIIIIIIIIII,2518,48,1,1,2,50.0%,1h
17556,2,死柒,2518,0,1,2,3,33.3%,1h
17556,3,死神万恶召唤,2518,0,0,1,1,0.0%,11m
17556,3,wine,2518,0,0,1,1,0.0%,1h
17581,1,养猪,2517,1466,241,240,481,50.1%,1h
17581,3,星星不会玩,2517,1521,128,129,257,49.8%,1h
17581,3,一诺,2517,907,42,32,74,56.8%,1h
17581,3,Tist,2517,488,24,15,39,61.5%,54m
17581,2,铁马的汉子,2517,567,23,17,40,57.5%,13m
17581,2,Cloudz,2517,480,17,16,33,51.5%,51m
17581,2,[我们很正经的]bbb,2517,361,16,13,29,55.2%,1h
17581,3,虫鸣,2517,398,15,8,23,65.2%,11m
17581,1,不吃番茄,2517,499,15,22,37,40.5%,1h
17581,2,梁梁,2517,247,7,5,12,58.3%,12m
17581,3,伤痕残影,2517,153,7,10,17,41.2%,47m
17581,3,我是小芋头,2517,121,6,4,10,60.0%,1h
17581,3,[XXHZ35]费力浦斯,2517,190,6,5,11,54.5%,4m
17581,2,[大宇恩]独角兽的执着,2517,178,6,9,15,40.0%,1h
17581,3,罗的小跟班,2517,144,5,6,11,45.5%,11m
17581,2,冷锋过境,2517,140,5,7,12,41.7%,1h
17581,3,Kel,2517,88,4,3,7,57.1%,54m
17581,3,sdfhfdghrj,2517,118,4,5,9,44.4%,1h
17581,2,世纪流星,2517,90,3,7,10,30.0%,8m
17581,3,出手不凡,2517,40,2,2,4,50.0%,58m
17581,3,肥喷,2517,70,2,4,6,33.3%,1h
17581,3,不羡仙,2517,0,2,5,7,28.6%,47m
17581,1,[吾儿王缤]吾儿王缤阴阳人,2517,0,1,0,1,100.0%,20m
17581,1,萧箫,2517,0,1,1,2,50.0%,1h
17581,1,[歌者II]茗翎之媛,2517,0,1,1,2,50.0%,17m
17581,2,淹死的鱼,2517,0,0,1,1,0.0%,1h
17581,1,心计新人,2517,0,0,2,2,0.0%,1h
17608,3,情场浪子,2516,1560,204,197,401,50.9%,1h
17608,2,好汉饶命,2516,770,126,135,261,48.3%,41m
17608,1,smile,2516,1599,93,102,195,47.7%,29m
17608,3,神州一浩,2516,770,82,69,151,54.3%,1h
17608,2,Ghost,2516,1261,56,50,106,52.8%,33m
17608,3,向前看,2516,1145,53,30,83,63.9%,35m
17608,1,河上,2516,1034,36,46,82,43.9%,1h
17608,2,Sylarjin,2516,172,27,31,58,46.6%,1h
17608,3,FanJusTice,2516,552,21,21,42,50.0%,1h
17608,1,[DHG]Orochi,2516,292,17,26,43,39.5%,1h
17608,1,兮兮柳知,2516,485,16,20,36,44.4%,1h
17608,3,萌萌哒的小熊猫,2516,132,11,16,27,40.7%,5m
17608,3,GARFIELD,2516,233,8,3,11,72.7%,1h
17608,2,流氓战术集大成者,2516,218,7,12,19,36.8%,29m
17608,2,aeiou,2516,205,5,4,9,55.6%,1h
17608,3,古越少年,2516,197,5,9,14,35.7%,24m
17608,3,封心之恋,2516,132,4,1,5,80.0%,8m
17608,3,vivilove,2516,86,4,3,7,57.1%,1h
17608,2,阳光般耀眼的男人,2516,136,3,3,6,50.0%,1h
17608,3,[星际旅游团]KillingNight,2516,0,1,0,1,100.0%,11m
17608,1,寒影火舞,2516,0,0,1,1,0.0%,36m
17608,1,龙翼,2516,0,0,1,1,0.0%,3m
17608,3,spue,2516,0,0,2,2,0.0%,1h
17631,1,[Atoms]狂龙,2515,658,176,178,354,49.7%,1h
17631,1,allover,2515,1548,68,71,139,48.9%,29m
17631,3,Filtration,2515,725,40,35,75,53.3%,1h
17631,3,柯西不等式,2515,817,36,34,70,51.4%,6m
17631,1,wayne,2515,725,32,35,67,47.8%,1h
17631,1,[社交学小可爱]战狼,2515,618,23,24,47,48.9%,1h
17631,2,lizhen,2515,592,21,27,48,43.8%,19m
17631,3,十八岁头号,2515,512,18,20,38,47.4%,1h
17631,3,[菜有菜的道理]酒辛,2515,323,16,15,31,51.6%,1h
17631,3,米柚和羽入,2515,320,13,3,16,81.2%,11m
17631,3,ZEROCOOL,2515,358,13,9,22,59.1%,1h
17631,3,宇宇,2515,158,13,14,27,48.1%,1h
17631,2,翱翔长空,2515,155,10,18,28,35.7%,1h
17631,3,[YINGJI]HyperRich,2515,253,9,7,16,56.2%,1h
17631,1,ooxx,2515,228,8,15,23,34.8%,1h
17631,3,天火焚城,2515,231,7,5,12,58.3%,26m
17631,3,GOLDMAN,2515,186,5,3,8,62.5%,1h
17631,3,囧囧的人,2515,88,4,3,7,57.1%,54m
17631,1,小板砖,2515,96,4,3,7,57.1%,1h
17631,1,[浴火银河]killer,2515,96,4,5,9,44.4%,1h
17631,2,[炎发灼眼]极梦雅界,2515,38,4,7,11,36.4%,27m
17631,3,谪仙,2515,94,3,4,7,42.9%,1h
17631,1,adc,2515,145,3,5,8,37.5%,1h
17631,3,[tcr9]血疑,2515,30,2,0,2,100.0%,1h
17631,1,Risingstorm,2515,0,2,4,6,33.3%,16m
17631,3,一人行者逆风行,2515,0,2,4,6,33.3%,1h
17631,3,米兰,2515,60,2,5,7,28.6%,1h
17631,2,不朽者,2515,60,2,8,10,20.0%,1h
17631,1,划算的世界,2515,0,1,0,1,100.0%,58m
17631,3,眼泪,2515,0,1,0,1,100.0%,1h
17631,3,SingdanceABC,2515,97,1,1,2,50.0%,16m
17631,2,[33CM]阳光,2515,44,1,5,6,16.7%,5m
17631,3,已被血虐多年,2515,0,0,1,1,0.0%,55m
17664,2,[NHSD]DavidGin,2514,1532,64,68,132,48.5%,1h
17664,2,锦鸡舞,2514,731,60,53,113,53.1%,28m
17664,3,aeio,2514,952,42,31,73,57.5%,1h
17664,2,Cicy,2514,716,25,28,53,47.2%,58m
17664,2,提古雷查夫,2514,408,23,28,51,45.1%,26m
17664,3,protossz,2514,353,14,15,29,48.3%,24m
17664,2,[孙一峰小迷妹]你星际打的针不戳,2514,379,14,19,33,42.4%,55m
17664,2,西瓜点点,2514,279,11,11,22,50.0%,1h
17664,2,Sinan,2514,227,8,10,18,44.4%,8m
17664,3,西湖帮帮主,2514,166,6,9,15,40.0%,1h
17664,3,phh,2514,145,4,1,5,80.0%,1h
17664,3,AJPy,2514,114,4,4,8,50.0%,1h
17664,1,三土爹,2514,116,4,6,10,40.0%,1h
17664,2,矢量,2514,125,3,2,5,60.0%,7m
17664,2,[五月花]茫然之潜行者,2514,129,3,2,5,60.0%,1h
17664,1,blaze,2514,0,3,2,5,60.0%,58m
17664,3,wmzwmz,2514,140,3,2,5,60.0%,19m
17664,3,BScyan,2514,58,3,3,6,50.0%,1h
17664,3,MOLANX,2514,60,2,4,6,33.3%,31m
17664,1,别教我玩游戏谢谢,2514,92,1,3,4,25.0%,1h
17664,3,FateOP,2514,0,0,1,1,0.0%,1h
17685,1,[大爱星际二]为了部落,2513,1182,45,47,92,48.9%,37m
17685,2,该用户不存在的,2513,730,31,23,54,57.4%,1h
17685,1,[式神]卖萌的魔方,2513,525,28,31,59,47.5%,1h
17685,3,[时光静寂流逝]幽月,2513,557,26,16,42,61.9%,11m
17685,3,热心市民张先生,2513,659,25,20,45,55.6%,1h
17685,3,[秋毫七队]雪狼爽爽,2513,365,21,16,37,56.8%,1h
17685,3,fish,2513,272,11,2,13,84.6%,1h
17685,2,御剑锋芒,2513,305,11,12,23,47.8%,13m
17685,2,[WJY]Bstronaut,2513,204,10,12,22,45.5%,16m
17685,2,哦不住,2513,172,9,17,26,34.6%,1h
17685,2,瑞托崔普,2513,213,8,10,18,44.4%,54m
17685,2,[PAPSPC]世华,2513,182,7,9,16,43.8%,12m
17685,3,鸭子光线,2513,177,4,8,12,33.3%,40m
17685,3,暖夏,2513,30,2,0,2,100.0%,1h
17685,3,[CR6]AskA,2513,121,2,2,4,50.0%,1h
17685,1,今天又白干了,2513,0,2,3,5,40.0%,1h
17685,3,[谁是巴子]mickey,2513,80,2,7,9,22.2%,26m
17685,3,Zest,2513,0,1,0,1,100.0%,1h
17685,3,暴风中的冷静,2513,0,0,1,1,0.0%,6m
17685,3,[勇士的信仰]风华之殇,2513,0,0,1,1,0.0%,11m
17685,2,张口闭眼男,2513,0,0,2,2,0.0%,1h
17685,2,DUAN,2513,0,0,4,4,0.0%,1h
17685,2,[请先打我隊友]红叶知弦,2513,0,0,4,4,0.0%,1h
17685,1,[小耗子]阎魔爱的粉丝,2513,0,0,4,4,0.0%,1h
17709,3,手残菜鸟瘾还大,2512,1573,92,83,175,52.6%,8m
17709,3,[DX战队]奶油少女丶萌妹子,2512,986,44,48,92,47.8%,10m
17709,1,infily,2512,436,41,54,95,43.2%,1h
17709,2,微震天,2512,662,26,28,54,48.1%,9m
17709,3,[舰队训练营]孙逸枫,2512,657,25,21,46,54.3%,6m
17709,2,我没名字,2512,636,24,21,45,53.3%,16m
17709,2,[审判右翼]艾尔利刃,2512,568,22,21,43,51.2%,11m
17709,3,ZXCZSE,2512,424,15,15,30,50.0%,8m
17709,3,[暨大职业校队]蝶舞子望,2512,348,13,8,21,61.9%,11m
17709,2,轻薄的假象,2512,174,7,10,17,41.2%,1h
17709,3,局外人,2512,121,5,4,9,55.6%,1h
17709,2,BLUE,2512,181,5,9,14,35.7%,1h
17709,3,一石,2512,187,4,5,9,44.4%,1h
17709,3,[中华讲武堂]啦神又在种地,2512,135,3,2,5,60.0%,1h
17709,3,killer,2512,86,3,4,7,42.9%,47m
17709,3,[MMOPhD]TcK,2512,30,2,3,5,40.0%,1h
17709,2,pianobear,2512,103,2,4,6,33.3%,1h
17709,1,落雨青衫,2512,0,2,4,6,33.3%,45m
17709,3,Descent,2512,0,2,5,7,28.6%,1h
17709,3,美琴最高,2512,0,1,0,1,100.0%,18m
17709,3,暗鱼,2512,0,1,0,1,100.0%,1h
17709,1,[我们是萌新]柠萌小鱿鱼,2512,0,1,0,1,100.0%,1h
17709,3,fpfhhh,2512,0,1,0,1,100.0%,11m
17709,3,[星辰大海无限]fsffg,2512,0,1,1,2,50.0%,1h
17709,3,[废墟图书館]皮埃尔的带肉派,2512,0,0,1,1,0.0%,1h
17709,3,氕氘氚,2512,0,0,1,1,0.0%,1h
17709,1,樱高三年二班,2512,0,0,1,1,0.0%,17m
17709,3,阿飞,2512,0,0,2,2,0.0%,1h
17709,3,simmom,2512,0,0,3,3,0.0%,1h
17738,2,八坂神奈子,2511,1590,118,109,227,52.0%,1h
17738,3,player,2511,640,98,87,185,53.0%,1h
17738,2,城南老人棒,2511,1322,58,54,112,51.8%,1h
17738,3,我的温柔被你抛弃,2511,264,24,17,41,58.5%,20m
17738,3,Logic,2511,364,14,12,26,53.8%,19m
17738,2,你在干什么,2511,333,11,11,22,50.0%,46m
17738,2,[FPT]黄昏末日,2511,150,7,10,17,41.2%,1h
17738,2,[DMRc]淋浴,2511,161,5,7,12,41.7%,1h
17738,2,泰伦之光,2511,158,5,10,15,33.3%,1h
17738,3,少沐,2511,64,4,7,11,36.4%,1h
17738,3,zxoswald,2511,58,3,2,5,60.0%,1h
17738,1,[小鸡屠宰场6]TUZHEN,2511,145,3,6,9,33.3%,44m
17738,2,bryan,2511,0,3,6,9,33.3%,1h
17738,3,observer,2511,121,2,1,3,66.7%,58m
17738,3,halee,2511,0,1,0,1,100.0%,1h
17738,3,安卡诺,2511,30,1,2,3,33.3%,40m
17738,3,不会玩,2511,0,0,1,1,0.0%,25m
17755,3,灭霸,2510,1149,56,40,96,58.3%,1h
17755,3,[旺旺战士]藤条焖雷兽,2510,840,30,33,63,47.6%,1h
17755,3,克哈机动队,2510,510,23,9,32,71.9%,59m
17755,3,[出兵大战T馆]吾心,2510,310,21,13,34,61.8%,1h
17755,3,NIGHTMARE,2510,440,16,13,29,55.2%,59m
17755,3,待梦还,2510,327,14,4,18,77.8%,1h
17755,3,[BGA]BiGAcO,2510,317,10,9,19,52.6%,25m
17755,3,沉沦,2510,198,8,1,9,88.9%,54m
17755,3,hqd,2510,53,5,5,10,50.0%,1h
17755,3,[咸鱼谐会]HUCSummer,2510,148,5,8,13,38.5%,25m
17755,3,老许要媳妇不要,2510,120,4,4,8,50.0%,9m
17755,3,李昂,2510,118,3,0,3,100.0%,1h
17755,3,[do啊do]华昭,2510,58,3,1,4,75.0%,11m
17755,3,无所事事的包子,2510,58,3,2,5,60.0%,1h
17755,3,雇佣兵,2510,97,3,5,8,37.5%,30m
17755,1,科学家涅茧利,2510,0,2,1,3,66.7%,16m
17755,3,[神奇的星际哦]rangwolai,2510,30,2,2,4,50.0%,55m
17755,1,[新手玩家]被打的小兔,2510,0,2,3,5,40.0%,17m
17755,1,时俞,2510,0,2,4,6,33.3%,23m
17755,1,Zerojk,2510,0,2,4,6,33.3%,45m
17755,3,曼菲士,2510,0,1,0,1,100.0%,1h
17755,3,[人菜灬瘾大]雷鸣舞台,2510,0,1,0,1,100.0%,1h
17755,2,goushengxiao,2510,20,1,6,7,14.3%,1h
17755,3,灭霸,2510,0,0,1,1,0.0%,1h
17755,3,[由难到易]YURI,2510,0,0,1,1,0.0%,1h
17755,2,REC,2510,0,0,2,2,0.0%,1h
17755,1,没心没肺的辰星,2510,0,0,6,6,0.0%,1h
17782,2,[旺旺战士]大意没有闪,2509,1403,93,91,184,50.5%,11m
17782,3,干净虫族,2509,1133,49,36,85,57.6%,35m
17782,3,蓝叔叔,2509,714,41,35,76,53.9%,55m
17782,2,xxafx,2509,670,30,29,59,50.8%,20m
17782,3,路过的耀耀,2509,472,28,20,48,58.3%,55m
17782,3,Dipper,2509,512,21,17,38,55.3%,1h
17782,2,观阴大湿,2509,187,7,7,14,50.0%,5m
17782,2,loststars,2509,204,7,13,20,35.0%,1h
17782,3,[人类防卫阵线]小怪兽,2509,62,4,4,8,50.0%,1h
17782,3,gww,2509,172,4,5,9,44.4%,42m
17782,3,VanNESS,2509,122,4,9,13,30.8%,40m
17782,1,为爱,2509,0,3,2,5,60.0%,5m
17782,3,哀冬之伤,2509,92,3,6,9,33.3%,1h
17782,1,向玉栋的小迪奥,2509,0,2,0,2,100.0%,1h
17782,3,[BaiGei]远坂凛,2509,30,1,1,2,50.0%,47m
17782,3,[五月花]骚啊马飞啊,2509,0,1,1,2,50.0%,1h
17782,3,过犹不及,2509,30,1,1,2,50.0%,32m
17782,3,潜龙勿用,2509,30,1,1,2,50.0%,1h
17782,1,常被绿,2509,0,1,2,3,33.3%,1h
17782,1,Brasking,2509,0,1,4,5,20.0%,1h
17782,3,我知道你不爱我,2509,32,1,4,5,20.0%,45m
17782,3,Fire,2509,30,1,5,6,16.7%,42m
17804,1,YuYangP,2508,841,159,157,316,50.3%,1h
17804,3,Musketeer,2508,1201,50,60,110,45.5%,30m
17804,1,[大漢]粉毛小兔兔,2508,711,43,44,87,49.4%,4m
17804,2,刀锋,2508,269,37,34,71,52.1%,1h
17804,3,[死河]奎尔蒙特千秋,2508,479,19,11,30,63.3%,25m
17804,3,光的折射,2508,293,17,9,26,65.4%,19m
17804,3,霸道的腿毛,2508,410,16,8,24,66.7%,1h
17804,3,丿永恒死亡,2508,270,12,14,26,46.2%,8m
17804,1,予诺,2508,349,11,15,26,42.3%,15m
17804,3,GGKING,2508,275,10,4,14,71.4%,8m
17804,1,DaveXu,2508,235,8,9,17,47.1%,1h
17804,3,小霸道,2508,188,6,7,13,46.2%,1h
17804,3,[GDG]asjfajwafjf,2508,182,5,2,7,71.4%,1h
17804,3,Huahua,2508,142,5,4,9,55.6%,59m
17804,3,无限单通,2508,123,4,6,10,40.0%,1h
17804,3,nexus,2508,60,3,1,4,75.0%,1h
17804,3,MRX,2508,117,2,1,3,66.7%,1h
17804,1,[小小怪怪]Antonio,2508,0,2,2,4,50.0%,1h
17804,3,琼云,2508,58,2,4,6,33.3%,11m
17804,2,是葡萄不是萝卜,2508,80,2,5,7,28.6%,1h
17804,3,仗剑天涯,2508,0,1,0,1,100.0%,11m
17804,2,tony,2508,0,1,1,2,50.0%,1h
17804,3,长安,2508,30,1,2,3,33.3%,1h
17804,3,brbzjl,2508,97,1,2,3,33.3%,4m
17804,3,[小刺猬的后宫]萌萌哒的小刺猬,2508,0,0,1,1,0.0%,11m
17804,1,VIPER,2508,0,0,4,4,0.0%,1h
17830,1,水娃娃,2507,1563,199,196,395,50.4%,27m
17830,3,[红茶会]专业星际八一零年,2507,676,74,64,138,53.6%,20m
17830,1,虚空之影,2507,1457,73,78,151,48.3%,19m
17830,2,路明飞,2507,1182,45,45,90,50.0%,18m
17830,3,狄拉克之海,2507,583,38,29,67,56.7%,9m
17830,2,天小神,2507,924,33,38,71,46.5%,1h
17830,3,[XXHZ1]留下遗产,2507,646,30,14,44,68.2%,6m
17830,3,[镜花水月]独步,2507,698,28,25,53,52.8%,32m
17830,3,无爱式回忆,2507,582,23,20,43,53.5%,1h
17830,2,[寄生虫娱乐]saberbelief,2507,508,22,20,42,52.4%,28m
17830,1,[风之灵]小龙,2507,451,17,21,38,44.7%,1h
17830,2,[sakiwa]princew,2507,327,16,14,30,53.3%,1h
17830,2,[天青车道]杰克南瓜,2507,147,14,18,32,43.8%,1h
17830,2,[CPT]ALTER,2507,241,8,12,20,40.0%,28m
17830,2,小金,2507,225,7,10,17,41.2%,1h
17830,2,这也在你计划中吗,2507,190,6,8,14,42.9%,1h
17830,2,她也曾是我的破绽,2507,184,6,8,14,42.9%,1h
17830,3,何某航,2507,176,5,3,8,62.5%,29m
17830,1,[TDF]Phoenix,2507,97,4,2,6,66.7%,17m
17830,3,卑微的单推人,2507,121,3,0,3,100.0%,1h
17830,3,phoenix,2507,60,3,2,5,60.0%,1h
17830,3,YESSIR,2507,58,3,3,6,50.0%,1h
17830,1,Lucardo,2507,0,2,3,5,40.0%,36m
17830,3,sos,2507,0,1,0,1,100.0%,1h
17830,3,SmilEr,2507,0,1,2,3,33.3%,1h
17830,2,[Elite]咸鱼迪胖胖六六六,2507,0,0,1,1,0.0%,50m
17830,1,[高达]占戈哥欠走己,2507,0,0,1,1,0.0%,4m
17830,1,心之逆鳞,2507,0,0,1,1,0.0%,1h
17858,1,呱呱吖吖,2506,1573,335,336,671,49.9%,35m
17858,3,[萌新玩星际]海棠之鱼,2506,1193,202,200,402,50.2%,5m
17858,3,Guge,2506,1307,91,79,170,53.5%,1h
17858,3,faker,2506,1084,58,51,109,53.2%,32m
17858,3,MMYW,2506,459,33,21,54,61.1%,1h
17858,3,sakura,2506,510,24,18,42,57.1%,47m
17858,3,徐鸣人,2506,309,12,8,20,60.0%,1h
17858,3,包身工,2506,330,12,10,22,54.5%,1h
17858,3,哄着自己玩,2506,226,9,10,19,47.4%,32m
17858,1,爱拍小贤,2506,274,9,15,24,37.5%,58m
17858,2,[死亡降临]火星骑士,2506,262,9,17,26,34.6%,58m
17858,2,Phoneix,2506,96,8,14,22,36.4%,1h
17858,3,[我是萌新Q]小智,2506,196,7,7,14,50.0%,1h
17858,2,[天际线]清风丶,2506,108,7,13,20,35.0%,1h
17858,3,[看星星咯]梦露,2506,166,6,7,13,46.2%,32m
17858,3,此地乃是白门楼,2506,137,3,2,5,60.0%,11m
17858,1,瞳临,2506,96,3,3,6,50.0%,1h
17858,3,能鸽善鹉列克星敦,2506,97,3,5,8,37.5%,1h
17858,3,[老大哥]张市长,2506,30,2,0,2,100.0%,1h
17858,2,画风,2506,0,2,4,6,33.3%,1h
17858,3,[苏维埃红军]mingwang,2506,30,1,1,2,50.0%,29m
17858,3,[第九駆逐鑑隊]Faine,2506,97,1,3,4,25.0%,1h
17858,3,[四川四川]西境之西南境之南,2506,0,0,1,1,0.0%,1h
17858,3,sarie,2506,0,0,1,1,0.0%,20m
17858,3,[暗黑星球]呵呵的坑,2506,0,0,2,2,0.0%,1h
17883,2,李之甜,2505,247,35,39,74,47.3%,1h
17883,3,newworld,2505,626,23,20,43,53.5%,40m
17883,1,木之下和也,2505,514,19,26,45,42.2%,15m
17883,3,llllllllllll,2505,466,18,11,29,62.1%,1h
17883,3,年轻人耗子尾汁,2505,367,16,4,20,80.0%,1h
17883,2,聿君,2505,334,15,14,29,51.7%,55m
17883,2,Lcrab,2505,407,13,22,35,37.1%,1h
17883,2,清软喵,2505,266,12,8,20,60.0%,52m
17883,2,伟大的万,2505,245,11,8,19,57.9%,1h
17883,1,咿呦咿呦,2505,260,8,14,22,36.4%,15m
17883,3,阿苏卡到啦,2505,195,7,3,10,70.0%,25m
17883,2,古月发付,2505,211,7,7,14,50.0%,33m
17883,3,Hsg,2505,170,6,6,12,50.0%,1h
17883,2,澧水之滨,2505,164,6,8,14,42.9%,6m
17883,3,admin,2505,208,6,8,14,42.9%,1h
17883,3,[COMBN]萝卜,2505,116,5,4,9,55.6%,1h
17883,3,[弑神]langjiWya,2505,191,5,5,10,50.0%,8m
17883,3,[孙岱玹]拉克希尔仪式主持,2505,146,3,2,5,60.0%,50m
17883,3,[艾尔之主]gggggggggg,2505,84,3,4,7,42.9%,32m
17883,3,[水里有只猫]fruitaLAG,2505,88,3,5,8,37.5%,1h
17883,3,[小鸡屠宰场9]sUm,2505,113,2,3,5,40.0%,20m
17883,1,闲来没事出城西,2505,42,2,5,7,28.6%,1h
17883,3,[SFTRA3]舔我高跟鞋,2505,0,0,1,1,0.0%,55m
17883,3,[AT盟联]艾依路,2505,0,0,2,2,0.0%,32m
17883,1,Cyber,2505,0,0,3,3,0.0%,1h
17908,2,POPNEW,2504,1512,226,223,449,50.3%,43m
17908,3,Fate,2504,1609,71,65,136,52.2%,9m
17908,3,祖安大师,2504,1142,55,37,92,59.8%,20m
17908,3,Stear,2504,716,30,25,55,54.5%,1h
17908,1,[超合金战队]天罚风暴雷星闪耀,2504,793,28,34,62,45.2%,1h
17908,2,无畏,2504,452,18,16,34,52.9%,29m
17908,1,OIer,2504,200,14,10,24,58.3%,1h
17908,1,[喵内噶]樱木雨音,2504,278,13,11,24,54.2%,33m
17908,3,waini,2504,314,12,5,17,70.6%,8m
17908,1,Olivero,2504,299,10,13,23,43.5%,48m
17908,2,郑江永,2504,298,10,16,26,38.5%,33m
17908,3,[XCode]没用鼠标,2504,241,9,7,16,56.2%,47m
17908,1,[C34123]呆呆魔王,2504,224,8,14,22,36.4%,57m
17908,3,[皇室联盟]凉介,2504,211,7,3,10,70.0%,1h
17908,3,晓城,2504,189,6,7,13,46.2%,1h
17908,3,DannyRay,2504,158,5,0,5,100.0%,1h
17908,3,Veritas,2504,116,4,6,10,40.0%,19m
17908,2,幽狐,2504,120,4,11,15,26.7%,49m
17908,2,[娱乐至上]GEMGREAN,2504,123,3,2,5,60.0%,38m
17908,3,白米糯,2504,97,3,5,8,37.5%,42m
17908,2,[单人行动对吧]蝉时雨,2504,62,3,6,9,33.3%,1h
17908,3,放大招的都是弟弟,2504,44,3,6,9,33.3%,1h
17908,3,[人族最强近战]魔狱,2504,58,2,3,5,40.0%,1h
17908,1,快活的小飞机,2504,96,2,4,6,33.3%,1h
17908,2,Zhangwei,2504,36,2,5,7,28.6%,1h
17908,3,陨石巨翼,2504,0,0,1,1,0.0%,1h
17908,3,菜鸟,2504,0,0,2,2,0.0%,1h
17935,1,wek,2503,1597,667,662,1329,50.2%,5m
17935,3,xinmu,2503,827,57,46,103,55.3%,1h
17935,3,[暴雪养鸡场]Sunnyboy,2503,349,16,5,21,76.2%,11m
17935,3,自个的牛牛,2503,389,16,12,28,57.1%,19m
17935,2,[浴火银河]你神爸丿我在此丶,2503,258,11,6,17,64.7%,1h
17935,3,重装骑兵,2503,307,11,8,19,57.9%,32m
17935,3,这个游戏怎么玩,2503,238,8,5,13,61.5%,32m
17935,3,THEEND,2503,139,7,3,10,70.0%,54m
17935,3,sjk,2503,200,6,6,12,50.0%,16m
17935,2,刘哥,2503,156,5,8,13,38.5%,38m
17935,2,Clement,2503,130,4,3,7,57.1%,1h
17935,3,Marine,2503,90,4,4,8,50.0%,1h
17935,2,果师,2503,126,4,9,13,30.8%,51m
17935,3,[达拉姆内务部]我的王之力,2503,47,3,2,5,60.0%,1h
17935,3,HUIHUI,2503,60,3,3,6,50.0%,1h
17935,3,[远毅大肉球]小肉脑袋,2503,30,2,0,2,100.0%,20m
17935,3,purion,2503,0,1,0,1,100.0%,47m
17935,3,llllllllllll,2503,0,1,0,1,100.0%,59m
17935,3,[打啊]萌王殿下,2503,0,1,1,2,50.0%,1h
17935,2,[艾尔之主]IIIIIIII,2503,91,1,4,5,20.0%,46m
17935,2,[你有遗憾么]落樱不及姑娘你,2503,0,0,1,1,0.0%,52m
17935,3,SoraKage,2503,0,0,1,1,0.0%,49m
17935,2,马尔科罗伊斯,2503,0,0,3,3,0.0%,1h
17958,3,yixi,2502,516,82,75,157,52.2%,1h
17958,2,[杰希]Zai,2502,1302,68,64,132,51.5%,16m
17958,2,地主老豺,2502,928,64,68,132,48.5%,58m
17958,1,blue,2502,948,40,34,74,54.1%,50m
17958,3,[黑丝小幼女]诗妙音,2502,454,20,10,30,66.7%,59m
17958,2,芋头,2502,223,12,7,19,63.2%,1h
17958,3,Mika,2502,301,10,9,19,52.6%,47m
17958,2,尛明真猛,2502,241,8,9,17,47.1%,2m
17958,2,SESESE,2502,220,8,10,18,44.4%,1h
17958,2,空穴来风,2502,202,7,14,21,33.3%,56m
17958,2,蓝爵萨凯,2502,185,5,4,9,55.6%,22m
17958,2,霄痕,2502,93,5,4,9,55.6%,1h
17958,3,闪灵小侠,2502,114,5,7,12,41.7%,1h
17958,3,Naplean,2502,142,4,1,5,80.0%,2m
17958,3,[百年好合]爱星际,2502,86,4,5,9,44.4%,54m
17958,2,dark,2502,166,4,6,10,40.0%,28m
17958,3,扎扎,2502,116,3,0,3,100.0%,2m
17958,3,战神,2502,0,3,3,6,50.0%,1h
17958,3,datou,2502,117,2,1,3,66.7%,1h
17958,3,灯塔歹徒,2502,30,2,2,4,50.0%,1h
17958,3,Griffithgouf,2502,60,2,4,6,33.3%,1h
17958,3,老裤衩,2502,60,2,4,6,33.3%,54m
17958,1,[暴雪八队]ShW,2502,0,2,4,6,33.3%,1h
17958,3,[CcDd]云雾茶,2502,94,1,1,2,50.0%,59m
17958,3,丶祎,2502,30,1,1,2,50.0%,11m
17958,3,Moon,2502,0,0,1,1,0.0%,11m
17958,3,[没茅台]罪恶克星,2502,0,0,2,2,0.0%,20m
17958,3,[温柔兔公主]高进,2502,0,0,2,2,0.0%,1h
17958,3,您的父亲,2502,0,0,2,2,0.0%,19m
17987,3,名称不可用,2501,1153,115,99,214,53.7%,43m
17987,2,[Fansc]刘小羊,2501,1220,50,50,100,50.0%,1h
17987,1,[艾尔之巅]新手无虐,2501,768,45,41,86,52.3%,1h
17987,2,[Hdl]Assam,2501,1091,42,43,85,49.4%,1h
17987,3,[染之炼狱]yuko,2501,416,20,26,46,43.5%,17m
17987,3,Tormentia,2501,513,19,16,35,54.3%,1h
17987,2,[墨染樱]不讲武德,2501,524,18,21,39,46.2%,4m
17987,3,[颂菩蚝]永恒时代,2501,368,15,7,22,68.2%,19m
17987,3,cukimoo,2501,293,11,6,17,64.7%,1h
17987,3,white,2501,296,11,11,22,50.0%,9m
17987,3,[白丝黑丝萝莉]平尺淮,2501,165,8,2,10,80.0%,11m
17987,3,[破坏之王]howfan,2501,247,7,6,13,53.8%,8m
17987,1,星际流浪,2501,142,4,3,7,57.1%,44m
17987,3,jqylove,2501,106,4,7,11,36.4%,1m
17987,3,巨蟹之钳,2501,119,2,1,3,66.7%,1h
17987,3,DUCK,2501,0,2,5,7,28.6%,34m
17987,1,[物探]舒逸,2501,82,2,11,13,15.4%,1h
17987,2,神韵,2501,0,1,0,1,100.0%,31m
17987,3,此时年少,2501,30,1,3,4,25.0%,1h
18006,3,[萝莉loli]DARKhawk,2500,1490,57,58,115,49.6%,43m
18006,3,咕噜果,2500,636,35,31,66,53.0%,26m
18006,1,[老油条战队]dfgde,2500,540,22,23,45,48.9%,1h
18006,3,Kkhumous,2500,261,15,7,22,68.2%,1h
18006,2,[HLR]神知者,2500,361,14,18,32,43.8%,1h
18006,3,祁宝儿,2500,280,10,12,22,45.5%,9m
18006,2,[神子]君临不归处,2500,168,6,11,17,35.3%,4m
18006,1,ango,2500,280,6,18,24,25.0%,41m
18006,3,[黑暗]小孩丿有自尊,2500,123,5,5,10,50.0%,1h
18006,3,池漪,2500,107,3,1,4,75.0%,19m
18006,2,leifeng,2500,60,3,6,9,33.3%,1h
18006,2,风花雪夜,2500,18,2,5,7,28.6%,56m
18006,3,机器人藤田刚,2500,30,1,1,2,50.0%,26m
18006,3,lala,2500,0,0,1,1,0.0%,1h
18006,1,武松,2500,0,0,1,1,0.0%,1h
18006,3,逗比王杜甫,2500,0,0,2,2,0.0%,8m
18006,3,虎小六,2500,0,0,2,2,0.0%,1h
18023,2,橘子,2499,1559,217,219,436,49.8%,49m
18023,2,送你个核弹,2499,1581,141,150,291,48.5%,1h
18023,1,手慢的英语老师,2499,330,85,80,165,51.5%,11m
18023,2,Allen,2499,1549,78,78,156,50.0%,1h
18023,3,zgdjb,2499,670,30,35,65,46.2%,11m
18023,1,[LOHs]asdfiujhs,2499,755,28,33,61,45.9%,5m
18023,3,糖糖巫,2499,550,20,19,39,51.3%,11m
18023,2,[我滴个龟龟]嘀咕隆冬起抢起,2499,496,18,20,38,47.4%,9m
18023,2,ghost,2499,386,14,22,36,38.9%,29m
18023,3,寇可往吾亦可往,2499,292,10,11,21,47.6%,40m
18023,3,火離,2499,202,9,1,10,90.0%,1h
18023,3,[YRS党委会]三水加,2499,208,7,2,9,77.8%,1h
18023,3,我觉得我优势很大,2499,174,6,7,13,46.2%,59m
18023,2,safjAUFDju,2499,123,5,3,8,62.5%,1h
18023,3,NEZseven,2499,171,5,7,12,41.7%,58m
18023,3,vlianCoCo,2499,90,4,3,7,57.1%,1h
18023,3,[在途的聚变打]我今天想生气,2499,92,4,6,10,40.0%,51m
18023,3,[Months]scdf,2499,113,3,1,4,75.0%,2m
18023,3,fightforever,2499,64,3,2,5,60.0%,32m
18023,3,[温暖神族]光光光光光,2499,30,2,2,4,50.0%,2m
18023,1,Sasd,2499,0,2,2,4,50.0%,2m
18023,3,[XCode]要命的探机,2499,0,1,0,1,100.0%,52m
18023,3,[红色锤镰]天启,2499,0,1,1,2,50.0%,1h
18023,3,[景沐阳]NADA,2499,30,1,2,3,33.3%,1m
18023,1,小鉴鉴,2499,0,1,4,5,20.0%,1h
18023,3,[世风第三帝国]风一样的男子,2499,0,0,2,2,0.0%,1h
18049,2,新手屠夫,2498,1570,285,283,568,50.2%,20m
18049,2,UZL,2498,1492,85,70,155,54.8%,1h
18049,2,[老as联盟]血红校尉,2498,591,29,21,50,58.0%,1h
18049,1,情深似海,2498,730,28,34,62,45.2%,39m
18049,3,[KPG]春风拂兰露华浓,2498,661,25,20,45,55.6%,1h
18049,1,[loveMM]星际小兵,2498,148,18,22,40,45.0%,1h
18049,2,[f1a9]roosevelt,2498,265,8,12,20,40.0%,1h
18049,2,麻美桑,2498,221,7,5,12,58.3%,1h
18049,2,ziyou,2498,206,7,11,18,38.9%,20m
18049,2,盼盼,2498,243,6,7,13,46.2%,1h
18049,3,cfhcxz,2498,149,4,4,8,50.0%,1h
18049,3,炽昼微凉,2498,30,2,3,5,40.0%,1h
18049,3,神樂七奈,2498,123,2,6,8,25.0%,1h
18049,1,[Cake]PinkiePie,2498,0,1,0,1,100.0%,1h
18049,1,第五晓杰,2498,0,1,0,1,100.0%,36m
18049,3,章章,2498,97,1,1,2,50.0%,1h
18049,3,lanehaal,2498,0,1,1,2,50.0%,1h
18049,3,[旧日黄金舰队]迅捷之潜行者,2498,94,1,1,2,50.0%,1h
18049,2,[胡杨]星星小欢,2498,0,1,5,6,16.7%,1h
18049,3,[话梅糖]看不见你的笑,2498,0,0,1,1,0.0%,55m
18049,3,[DMRe]迎王,2498,0,0,1,1,0.0%,2m
18070,3,独家配方,2497,1434,77,74,151,51.0%,1h
18070,2,austin,2497,1477,76,65,141,53.9%,29m
18070,3,木华,2497,1391,61,51,112,54.5%,1h
18070,2,[传说萌娘团]pxr,2497,641,30,27,57,52.6%,37m
18070,3,[天下为公]宣武泽,2497,528,26,21,47,55.3%,1h
18070,2,死魂忏悔,2497,289,18,16,34,52.9%,37m
18070,3,重案组之虎曹达华,2497,491,17,14,31,54.8%,59m
18070,2,[要恰大肥兔]Recluse,2497,407,14,21,35,40.0%,14m
18070,3,liyuezhao,2497,397,13,14,27,48.1%,6m
18070,3,泽拉图,2497,114,9,10,19,47.4%,11m
18070,2,innovation,2497,226,7,1,8,87.5%,1h
18070,1,明日之子,2497,206,7,9,16,43.8%,1h
18070,3,[肌肉]Vampare,2497,173,6,7,13,46.2%,42m
18070,1,kirito,2497,179,6,13,19,31.6%,19m
18070,1,吴员外,2497,161,5,9,14,35.7%,1h
18070,3,刚学一星期的菜鸡,2497,133,4,0,4,100.0%,1h
18070,1,Mark,2497,48,4,4,8,50.0%,44m
18070,3,夜袭储秀宫,2497,116,4,5,9,44.4%,55m
18070,1,耗子尾汁,2497,96,4,6,10,40.0%,16m
18070,3,老年二五仔,2497,40,3,8,11,27.3%,42m
18070,2,[好基计友]JLMENGSK,2497,89,2,0,2,100.0%,1h
18070,1,[第六駆逐鑑隊]克鲁特,2497,0,2,4,6,33.3%,17m
18070,1,[明晚上钻石]狗哥,2497,0,2,4,6,33.3%,20m
18070,2,[大魔王先生]脸都被打歪了,2497,0,1,0,1,100.0%,1h
18070,3,雨叶,2497,0,0,1,1,0.0%,1h
18095,3,丁岩,2496,956,50,45,95,52.6%,1h
18095,3,狂影圣堂,2496,1041,43,40,83,51.8%,1h
18095,3,浪白条,2496,578,22,16,38,57.9%,6m
18095,3,IIIIIIIIIIII,2496,363,12,12,24,50.0%,8m
18095,3,Zack,2496,327,10,9,19,52.6%,1h
18095,2,EmptyCity,2496,302,10,10,20,50.0%,11m
18095,2,umisonoda,2496,309,10,13,23,43.5%,4m
18095,2,冻住不准洗澡,2496,150,8,13,21,38.1%,1h
18095,3,南初寒霜,2496,212,7,8,15,46.7%,1h
18095,3,核弹头批发商,2496,97,3,5,8,37.5%,1h
18095,3,[剑锋所至]死亡天降,2496,95,2,0,2,100.0%,26m
18095,3,一笑而锅,2496,117,2,2,4,50.0%,1h
18095,3,方舟,2496,0,1,0,1,100.0%,19m
18095,3,[嘤嘤嘤舰队]德丽莎第一可爱,2496,0,1,0,1,100.0%,1h
18095,3,[XCode]无限非概率驱动,2496,0,1,5,6,16.7%,6m
18095,3,Firefly,2496,0,0,1,1,0.0%,1m
18095,1,猴子,2496,0,0,1,1,0.0%,1h
18112,3,ADcarry,2495,1225,188,173,361,52.1%,1h
18112,2,星际微尘,2495,499,20,19,39,51.3%,58m
18112,3,春心莫共,2495,553,19,19,38,50.0%,11m
18112,2,幽魂,2495,431,16,17,33,48.5%,1h
18112,3,loveyjl,2495,381,15,9,24,62.5%,11m
18112,2,[九尾]希望守护星,2495,369,14,13,27,51.9%,18m
18112,2,我就呵呵,2495,299,11,12,23,47.8%,9m
18112,3,mgeji,2495,258,9,3,12,75.0%,2m
18112,3,默默然,2495,194,8,12,20,40.0%,9m
18112,3,食色,2495,210,7,10,17,41.2%,54m
18112,3,WON,2495,148,6,5,11,54.5%,54m
18112,3,Hoffmann,2495,82,6,5,11,54.5%,1h
18112,3,浑元星际马老师,2495,186,5,4,9,55.6%,47m
18112,3,WorldMaster,2495,148,5,6,11,45.5%,1h
18112,1,caner,2495,96,4,5,9,44.4%,36m
18112,3,凌舞雩,2495,97,3,5,8,37.5%,1h
18112,1,iiiii,2495,96,2,4,6,33.3%,4m
18112,3,郭桑桑,2495,60,2,5,7,28.6%,25m
18112,3,MitakeBot,2495,97,1,1,2,50.0%,58m
18112,1,Entity,2495,48,1,2,3,33.3%,1h
18112,3,Accelerator,2495,0,0,1,1,0.0%,1h
18112,3,[sky圣殿]残暴的我,2495,0,0,4,4,0.0%,32m
18134,1,战火风飞,2494,942,48,46,94,51.1%,39m
18134,3,fit,2494,967,43,32,75,57.3%,35m
18134,3,[TAPC]Kingsman,2494,420,18,14,32,56.2%,1h
18134,2,血夜晨曦,2494,441,17,24,41,41.5%,17m
18134,1,[一刀屠天下]一只菜狗,2494,317,15,21,36,41.7%,18m
18134,3,叶易卿,2494,216,6,5,11,54.5%,1h
18134,3,depthofwater,2494,121,6,7,13,46.2%,56m
18134,2,burning,2494,171,6,9,15,40.0%,1h
18134,3,Curtain,2494,169,5,2,7,71.4%,1h
18134,2,丶起舞弄清影,2494,38,4,7,11,36.4%,1h
18134,2,夏又末,2494,0,3,6,9,33.3%,50m
18134,1,[正义灬必胜]死亡老留氓,2494,48,2,1,3,66.7%,1h
18134,3,一叶知秋,2494,30,2,2,4,50.0%,1h
18134,3,[朵朵]为了战役,2494,0,1,0,1,100.0%,32m
18134,1,physicalsoul,2494,0,1,2,3,33.3%,44m
18134,3,[镜花水月丨]神殇柔心,2494,0,0,1,1,0.0%,2m
18134,3,[龙血]GeekAllianc,2494,0,0,1,1,0.0%,1h
18134,3,浮影孤鸿,2494,0,0,1,1,0.0%,59m
18134,3,MayBeLi,2494,0,0,1,1,0.0%,1h
18134,3,希望,2494,0,0,1,1,0.0%,1h
18154,3,风雪,2493,1586,78,66,144,54.2%,8m
18154,2,LTC,2493,705,57,76,133,42.9%,19m
18154,2,grkrg,2493,1137,55,60,115,47.8%,1h
18154,3,[雷霆半月斩]牧田,2493,840,32,29,61,52.5%,6m
18154,3,我在等风也在等你,2493,530,24,10,34,70.6%,1h
18154,3,无名,2493,347,24,18,42,57.1%,1h
18154,3,Greenday,2493,566,21,20,41,51.2%,54m
18154,3,Allander,2493,624,21,27,48,43.8%,52m
18154,2,[1997届]叛逆者,2493,348,11,9,20,55.0%,40m
18154,3,虚空,2493,250,8,5,13,61.5%,47m
18154,1,[躺好了来吧]SONGGE,2493,228,8,9,17,47.1%,1h
18154,3,[Ryon榕]汉斯的咖啡好喝,2493,116,5,5,10,50.0%,40m
18154,3,SmallCow,2493,152,4,4,8,50.0%,59m
18154,3,[火焰雷兽]HelloKiKi,2493,117,3,2,5,60.0%,1h
18154,3,阿尔萨斯王子,2493,60,3,3,6,50.0%,25m
18154,1,[DSR]惡夢,2493,48,3,5,8,37.5%,1h
18154,3,Patrick,2493,119,2,2,4,50.0%,11m
18154,3,杭喆,2493,121,2,2,4,50.0%,40m
18154,2,冰洁时刻,2493,40,2,4,6,33.3%,1h
18154,3,[bibiDI]宝宝,2493,0,2,5,7,28.6%,1h
18154,3,血染流年,2493,95,1,1,2,50.0%,26m
18154,3,[人生有梦]sun,2493,94,1,1,2,50.0%,1h
18154,1,qgh,2493,0,1,2,3,33.3%,4m
18154,3,[文韬武略]敖江,2493,0,0,1,1,0.0%,1h
18154,3,nepgear,2493,0,0,2,2,0.0%,32m
18154,1,各位打扰了,2493,0,0,2,2,0.0%,40m
18154,3,柳肥宅,2493,0,0,3,3,0.0%,1h
18154,2,泛舟当歌,2493,0,0,3,3,0.0%,29m
18182,2,永夜君王,2492,1540,92,84,176,52.3%,1h
18182,2,swing,2492,1087,53,35,88,60.2%,26m
18182,3,颜料,2492,895,48,50,98,49.0%,40m
18182,3,MIN,2492,1003,40,32,72,55.6%,9m
18182,3,[祢豆子真好看]风暴,2492,663,27,18,45,60.0%,59m
18182,2,鱼叫兽,2492,512,26,27,53,49.1%,29m
18182,3,[中南大学官网]JJLucky,2492,243,10,8,18,55.6%,20m
18182,2,finalarcher,2492,252,8,13,21,38.1%,1h
18182,3,周大福豆腐干,2492,295,8,15,23,34.8%,1h
18182,1,骚俊,2492,144,6,2,8,75.0%,36m
18182,3,[LFY]多久傲岸,2492,160,4,2,6,66.7%,9m
18182,2,铃仙铃仙铃仙,2492,116,4,3,7,57.1%,1h
18182,3,ROTTEN,2492,92,4,4,8,50.0%,32m
18182,3,cityhunter,2492,116,3,1,4,75.0%,1h
18182,3,儒雅的包子,2492,121,3,1,4,75.0%,1h
18182,2,[GOTAL]soviet,2492,90,3,9,12,25.0%,1h
18182,3,战地豪猪,2492,30,2,1,3,66.7%,1h
18182,3,[科普卢老车队]你的机枪兵死光啦,2492,0,1,0,1,100.0%,11m
18182,3,池二少,2492,0,0,1,1,0.0%,1h
18201,3,港澳富豪重金求子,2491,1126,137,128,265,51.7%,1h
18201,3,时下郡,2491,850,37,27,64,57.8%,1h
18201,3,WHY,2491,729,31,21,52,59.6%,1m
18201,1,Temptation,2491,524,24,20,44,54.5%,1h
18201,2,随心随性,2491,395,21,19,40,52.5%,1h
18201,2,王耐穿,2491,520,20,21,41,48.8%,11m
18201,3,[埃蒙调教团]freedom,2491,384,14,11,25,56.0%,59m
18201,3,leonidas,2491,127,13,14,27,48.1%,11m
18201,3,家住海边喜欢浪,2491,315,13,17,30,43.3%,1h
18201,1,fish,2491,334,12,13,25,48.0%,48m
18201,3,圣帝,2491,258,8,6,14,57.1%,1h
18201,1,嘟嘟嘟了,2491,225,8,10,18,44.4%,48m
18201,3,HEHEDI,2491,171,7,6,13,53.8%,9m
18201,3,小鸟伏特加,2491,178,5,2,7,71.4%,1h
18201,3,Saaer,2491,153,5,4,9,55.6%,1h
18201,1,ForeverCD,2491,48,4,4,8,50.0%,44m
18201,3,渊海之殇,2491,114,4,5,9,44.4%,1h
18201,1,[莽的不行]大瑞明不爱刷牙丶,2491,96,3,7,10,30.0%,1h
18201,3,COa,2491,58,2,4,6,33.3%,1h
18201,3,花开丶,2491,0,1,0,1,100.0%,4m
18201,1,丑二桨,2491,0,1,0,1,100.0%,4m
18201,3,苓溟寒钰,2491,0,1,0,1,100.0%,56m
18201,1,幻神创世,2491,48,1,1,2,50.0%,1h
18201,3,甲板船工,2491,0,0,1,1,0.0%,25m
18201,3,缓释吧,2491,0,0,3,3,0.0%,1h
18226,3,查森斯泰森,2490,1615,253,249,502,50.4%,8m
18226,2,亿万基佬居然,2490,1143,199,183,382,52.1%,1h
18226,3,智宇芳,2490,1576,115,97,212,54.2%,1h
18226,2,[阿里巴巴战队]SktHeibai,2490,908,36,28,64,56.2%,58m
18226,3,猪油拌饭,2490,742,36,34,70,51.4%,1h
18226,3,echopeach,2490,617,27,22,49,55.1%,26m
18226,3,龙的传人,2490,376,18,12,30,60.0%,1h
18226,3,请把狗狗还给我,2490,472,18,23,41,43.9%,31m
18226,1,失落丶狡诈,2490,422,17,23,40,42.5%,50m
18226,3,军力,2490,348,12,15,27,44.4%,11m
18226,3,EasyI,2490,254,9,5,14,64.3%,29m
18226,2,小桃吃不饱,2490,242,8,10,18,44.4%,46m
18226,3,高手很少,2490,173,5,8,13,38.5%,1h
18226,1,晏无师,2490,0,3,2,5,60.0%,39m
18226,3,断戟,2490,60,2,4,6,33.3%,11m
18226,3,[嗯哼嗯啊啊啊]艾姬多娜,2490,0,1,0,1,100.0%,1h
18226,3,[Growl]云中,2490,0,1,0,1,100.0%,1h
18226,3,leonero,2490,0,1,0,1,100.0%,52m
18226,3,哒哒哒哒哒哒哒,2490,0,1,2,3,33.3%,1h
18245,3,fdrgdfgfthth,2489,1509,90,87,177,50.8%,11m
18245,2,打上狸花猫,2489,772,51,55,106,48.1%,56m
18245,2,木子曦,2489,1074,50,48,98,51.0%,13m
18245,2,澐氺氷蘫,2489,543,44,39,83,53.0%,13m
18245,2,[风暴领主]Colossus,2489,727,29,34,63,46.0%,1h
18245,1,医疗兵贩卖商人,2489,454,17,22,39,43.6%,1h
18245,2,扣扣大有,2489,191,16,18,34,47.1%,41m
18245,1,恋夏,2489,392,16,20,36,44.4%,1h
18245,3,卧龙,2489,360,14,14,28,50.0%,55m
18245,3,lothric,2489,298,10,7,17,58.8%,1h
18245,2,fearless,2489,235,7,10,17,41.2%,1h
18245,3,家人健康最重要,2489,192,6,10,16,37.5%,1h
18245,2,Ghost,2489,90,4,6,10,40.0%,16m
18245,1,只狼,2489,0,3,2,5,60.0%,1h
18245,3,Chost,2489,58,3,5,8,37.5%,1h
18245,1,LZP,2489,130,3,11,14,21.4%,54m
18245,3,孤寂,2489,121,2,2,4,50.0%,42m
18245,1,我也不想坑啊,2489,97,2,4,6,33.3%,29m
18245,1,星辰,2489,0,1,0,1,100.0%,20m
18245,3,[草泥马战队]BBC,2489,0,1,1,2,50.0%,54m
18245,3,maray,2489,95,1,1,2,50.0%,1h
18245,3,怎样练成大神,2489,0,1,1,2,50.0%,1h
18245,3,[北极光小组]KingCrimson,2489,0,1,1,2,50.0%,1h
18245,3,星座之龙,2489,97,1,2,3,33.3%,45m
18245,3,[1v1白给]血腥死神,2489,0,0,1,1,0.0%,8m
18270,2,波罗,2488,1510,99,97,196,50.5%,28m
18270,3,[联合指挥区]Ares,2488,814,97,85,182,53.3%,1m
18270,2,[CPT]般若,2488,1090,55,55,110,50.0%,19m
18270,3,[WRQ]HaowenS,2488,936,49,49,98,50.0%,11m
18270,2,天空極緻,2488,743,25,33,58,43.1%,1h
18270,3,[暴雪二十三队]命魂殿,2488,241,14,13,27,51.9%,19m
18270,2,[合肥工大]选择人族选择胜利,2488,347,11,17,28,39.3%,17m
18270,2,[倒萨的地方]汉克,2488,183,7,7,14,50.0%,1h
18270,3,光明的力量,2488,134,5,3,8,62.5%,32m
18270,3,dasdws,2488,118,5,7,12,41.7%,2m
18270,1,nrxqwe,2488,94,5,10,15,33.3%,47m
18270,1,Alex,2488,0,3,3,6,50.0%,16m
18270,1,不再沉迷,2488,0,3,7,10,30.0%,31m
18270,3,king,2488,30,2,2,4,50.0%,11m
18270,3,你们都不睡觉的嘛,2488,30,2,2,4,50.0%,25m
18270,1,玄逍,2488,0,2,3,5,40.0%,36m
18270,3,[二科天下第一]御坂美琴,2488,58,2,4,6,33.3%,25m
18270,3,稍稍,2488,122,2,4,6,33.3%,7m
18270,3,[OrzMM]baizer,2488,0,1,0,1,100.0%,1h
18270,3,cracyboy,2488,0,1,0,1,100.0%,1h
18270,3,[星际情侣]宇宙第一帅,2488,0,1,2,3,33.3%,54m
18270,3,饿撒过百万,2488,0,0,1,1,0.0%,3m
18270,3,shuyi,2488,0,0,1,1,0.0%,20m
18270,3,羲月,2488,0,0,3,3,0.0%,11m
18270,3,甲亢战士酱爆,2488,0,0,3,3,0.0%,11m
18295,3,[Rhusky]李富贵,2487,1142,136,130,266,51.1%,1h
18295,3,溪边丶稻草人,2487,675,94,89,183,51.4%,52m
18295,3,沐浴龙血,2487,1609,79,71,150,52.7%,1h
18295,3,我是你爹,2487,1579,75,67,142,52.8%,1h
18295,3,微笑棺木,2487,1245,59,53,112,52.7%,47m
18295,3,baike,2487,414,47,39,86,54.7%,25m
18295,3,黑子,2487,358,44,34,78,56.4%,1h
18295,3,[董魔王制霸军]瞄了个咪咪,2487,529,22,18,40,55.0%,54m
18295,3,一心一祎,2487,514,19,18,37,51.4%,35m
18295,3,无情的注卵机器,2487,319,10,13,23,43.5%,59m
18295,3,maru,2487,224,8,1,9,88.9%,1h
18295,3,[DARKS]DarK,2487,252,8,6,14,57.1%,54m
18295,3,[训练模式电脑]八号潜艇酱,2487,223,7,11,18,38.9%,2m
18295,1,endocytosis,2487,306,7,16,23,30.4%,1h
18295,3,落星丶,2487,177,6,4,10,60.0%,1h
18295,3,[AGE19]HoMuRa,2487,212,6,7,13,46.2%,31m
18295,3,[爽快]轩辕神健,2487,165,4,3,7,57.1%,40m
18295,3,qqqqqq,2487,141,4,3,7,57.1%,20m
18295,1,戏剠,2487,0,4,8,12,33.3%,33m
18295,3,老夫乃天选之人,2487,88,2,0,2,100.0%,52m
18295,1,pureelement,2487,97,2,4,6,33.3%,1h
18295,2,[茉莉琉璃白]洛叶伤风,2487,46,2,5,7,28.6%,19m
18295,3,LoveLuLU,2487,97,1,1,2,50.0%,1h
18295,1,炫喧轩眩旋,2487,0,0,2,2,0.0%,1h
18295,3,[洛梦绫音]半夏,2487,0,0,2,2,0.0%,1h
18320,2,无聊旗子,2486,1257,64,72,136,47.1%,39m
18320,3,板刀村林冲,2486,787,37,39,76,48.7%,54m
18320,3,[震惊]一不小心选错族了,2486,351,31,19,50,62.0%,3m
18320,3,史尔特尔永远滴神,2486,518,22,13,35,62.9%,1h
18320,1,[云师三骚]护士由啊逮第,2486,442,17,26,43,39.5%,50m
18320,3,[纸巾是毒奶]菊花格格,2486,304,12,10,22,54.5%,3m
18320,2,鲨鱼辣椒,2486,289,9,26,35,25.7%,32m
18320,3,钢铁战士老八,2486,200,7,1,8,87.5%,59m
18320,3,灵某啥也不会,2486,201,7,6,13,53.8%,31m
18320,3,爷就是这么浪荡,2486,199,6,2,8,75.0%,43m
18320,3,王玉的王,2486,195,6,3,9,66.7%,1h
18320,3,blindy,2486,146,6,5,11,54.5%,1h
18320,3,一心向阳,2486,169,6,5,11,54.5%,26m
18320,3,[星塵联萌]士大夫,2486,148,6,8,14,42.9%,1h
18320,3,大佬,2486,183,5,8,13,38.5%,42m
18320,1,[成步堂事务所]Flipped,2486,167,4,5,9,44.4%,1h
18320,3,[暴雪二十二队]挤一挤,2486,74,3,4,7,42.9%,1h
18320,3,[基金会]sky,2486,95,2,0,2,100.0%,18m
18320,1,GKAAA,2486,48,2,1,3,66.7%,4m
18320,3,这个名不简单,2486,58,2,4,6,33.3%,54m
18320,1,[16CM]Sapphire,2486,48,2,5,7,28.6%,39m
18320,3,轻绘梨花泪沾衣,2486,0,1,0,1,100.0%,7m
18320,3,[韩宗谐会]IIllIIllII,2486,0,1,1,2,50.0%,25m
18320,3,无言,2486,30,1,2,3,33.3%,9m
18320,1,[禁语草]陌上人如玉,2486,0,1,3,4,25.0%,5m
18320,3,[樱花庄园]星辰下的樱花,2486,0,0,1,1,0.0%,55m
18320,3,weqeqweqweqw,2486,0,0,2,2,0.0%,55m
18347,3,[grief]atlas,2485,1358,96,81,177,54.2%,59m
18347,2,玩玩而已,2485,1054,77,57,134,57.5%,4m
18347,3,鸟哥哥,2485,1379,66,60,126,52.4%,1h
18347,3,熟练的让人心疼,2485,815,45,41,86,52.3%,1h
18347,2,[老年之家]欧青辣少,2485,851,42,46,88,47.7%,1h
18347,3,泡影,2485,477,35,28,63,55.6%,1h
18347,3,瀮雨,2485,361,15,16,31,48.4%,1h
18347,3,[镜花水月]无所限制,2485,386,14,14,28,50.0%,11m
18347,3,[素貭極差]我是菜比,2485,360,13,8,21,61.9%,1h
18347,3,回归平凡,2485,329,12,15,27,44.4%,55m
18347,3,亚历山大刘能,2485,241,8,10,18,44.4%,1h
18347,3,[SKT俱乐部]llllllllllll,2485,210,7,3,10,70.0%,1h
18347,3,skyboy,2485,136,6,7,13,46.2%,1h
18347,2,豁批犯,2485,162,6,8,14,42.9%,1h
18347,1,[迷宫丨极限组]农民杀手鸡哥,2485,48,3,5,8,37.5%,1h
18347,3,Conandcn,2485,116,2,1,3,66.7%,54m
18347,3,[自创]Aster,2485,117,2,2,4,50.0%,8m
18347,3,你信吗,2485,0,2,4,6,33.3%,35m
18347,1,lyk,2485,96,2,4,6,33.3%,39m
18347,3,[氕氘氚]感化不如火化,2485,0,1,0,1,100.0%,1h
18347,3,天命,2485,0,1,0,1,100.0%,9m
18347,3,xiaotou,2485,0,1,2,3,33.3%,1h
18347,3,[Eise]Archon,2485,95,1,2,3,33.3%,1h
18347,1,糊涂一哥,2485,0,0,1,1,0.0%,39m
18347,3,zhous,2485,0,0,2,2,0.0%,40m
18372,2,流云辰,2484,1535,209,214,423,49.4%,18m
18372,3,zws,2484,1515,132,135,267,49.4%,1h
18372,2,SPROK,2484,1628,109,95,204,53.4%,1h
18372,1,燕笑语兮,2484,1510,74,75,149,49.7%,5m
18372,3,黑兔子王,2484,512,26,19,45,57.8%,1h
18372,1,静墨百格,2484,477,19,22,41,46.3%,1h
18372,1,[好想干点什么]Legend,2484,328,15,9,24,62.5%,45m
18372,2,JustBecause,2484,358,14,15,29,48.3%,18m
18372,3,cyqc,2484,323,13,8,21,61.9%,1h
18372,3,sinon,2484,228,9,2,11,81.8%,18m
18372,3,蒙圈猛犬,2484,219,8,1,9,88.9%,1h
18372,3,banana,2484,219,8,2,10,80.0%,1h
18372,2,[2000年]夜樱,2484,250,7,12,19,36.8%,1h
18372,3,readers,2484,180,6,2,8,75.0%,1h
18372,2,海贼丶王路飞,2484,254,6,11,17,35.3%,1h
18372,3,理想天空,2484,114,5,4,9,55.6%,2m
18372,2,被谁偏爱过,2484,30,5,11,16,31.2%,1h
18372,3,巴西龟,2484,76,4,7,11,36.4%,1h
18372,1,kuppz,2484,48,3,5,8,37.5%,24m
18372,3,晓夜,2484,97,3,6,9,33.3%,1h
18372,3,孙一峰是我大哥,2484,90,3,6,9,33.3%,1h
18372,3,[超电磁炉]珈百璃,2484,30,3,6,9,33.3%,59m
18372,1,芝加哥打字员,2484,0,2,4,6,33.3%,1h
18372,1,小一哥哥,2484,145,2,5,7,28.6%,1h
18372,3,yiwerewrew,2484,0,1,3,4,25.0%,1h
18372,1,橙色的蛋卷,2484,0,1,5,6,16.7%,1h
18372,3,Alarielle,2484,0,0,1,1,0.0%,7m
18372,2,星星,2484,0,0,2,2,0.0%,41m
18372,3,飞翔,2484,0,0,2,2,0.0%,1h
18372,3,suv,2484,0,0,4,4,0.0%,11m
18372,1,混元太马保国,2484,0,0,5,5,0.0%,1h
18403,3,greatapple,2483,1506,267,255,522,51.1%,32m
18403,3,阿逵不砍第二刀,2483,1269,58,39,97,59.8%,48m
18403,3,pimba,2483,577,25,14,39,64.1%,25m
18403,2,[托非入欧]超次元海王星,2483,626,24,19,43,55.8%,43m
18403,3,Accelevector,2483,552,20,20,40,50.0%,43m
18403,3,[DTOC]LxVotre,2483,388,16,12,28,57.1%,1h
18403,3,bcoodjk,2483,331,14,17,31,45.2%,35m
18403,3,[Mica]不死,2483,226,8,10,18,44.4%,20m
18403,2,下雨天,2483,194,8,10,18,44.4%,1h
18403,1,[星战分部]llllllllllll,2483,250,7,11,18,38.9%,57m
18403,3,燃灯节红色,2483,177,5,2,7,71.4%,56m
18403,1,gao,2483,190,5,5,10,50.0%,5m
18403,3,Autos,2483,133,4,0,4,100.0%,1h
18403,1,境域,2483,132,4,2,6,66.7%,1h
18403,2,cent,2483,95,3,8,11,27.3%,7m
18403,3,聪明的蓝胖,2483,30,2,1,3,66.7%,18m
18403,3,七彩炫龙,2483,0,2,5,7,28.6%,1h
18403,3,Chelsea,2483,0,1,0,1,100.0%,1h
18403,3,秃头汤姆,2483,0,1,1,2,50.0%,11m
18403,1,[瘾大眼瞎]小徐,2483,48,1,1,2,50.0%,4m
18403,2,长沙砍王薛,2483,32,1,7,8,12.5%,26m
18403,3,shxje,2483,0,0,1,1,0.0%,1h
18403,2,CCCP,2483,0,0,1,1,0.0%,1h
18403,3,一只嘤嘤怪,2483,0,0,2,2,0.0%,51m
18403,3,烟淡风轻,2483,0,0,4,4,0.0%,8m
18428,3,我不想乱来,2482,886,40,29,69,58.0%,1h
18428,3,北海没有猫,2482,684,31,29,60,51.7%,48m
18428,3,kingwolf,2482,627,25,21,46,54.3%,8m
18428,1,[猫神]八嘎八嘎洗,2482,585,22,29,51,43.1%,37m
18428,1,冬马和纱,2482,274,20,30,50,40.0%,1h
18428,3,蒹葭苍茫猪猪侠,2482,453,17,13,30,56.7%,32m
18428,3,漫天飞舞,2482,356,12,13,25,48.0%,8m
18428,2,owl,2482,322,11,11,22,50.0%,1h
18428,2,亢奋的蛆宝宝,2482,282,11,20,31,35.5%,1h
18428,3,MasterM,2482,256,10,5,15,66.7%,1h
18428,3,重新集结部队,2482,267,9,10,19,47.4%,55m
18428,3,疏逸,2482,266,9,12,21,42.9%,1h
18428,2,清欢,2482,267,9,14,23,39.1%,12m
18428,3,[EnTorn]Tinky,2482,122,5,4,9,55.6%,1h
18428,3,可爱的叉子,2482,199,5,5,10,50.0%,8m
18428,3,阴天下之大险,2482,125,4,4,8,50.0%,58m
18428,2,HelloBABYOvO,2482,121,4,8,12,33.3%,53m
18428,3,杰瑞,2482,119,3,2,5,60.0%,1h
18428,3,[魔灵圣域]海洋君,2482,112,3,2,5,60.0%,1h
18428,1,ATM,2482,0,2,3,5,40.0%,44m
18428,1,菜鸟新手,2482,116,2,3,5,40.0%,1h
18428,3,爱静好,2482,54,2,3,5,40.0%,1h
18428,1,LUFFY,2482,0,1,0,1,100.0%,1h
18428,1,一根毛天上飘,2482,0,1,0,1,100.0%,1h
18428,1,狂野之狼,2482,0,1,4,5,20.0%,1h
18428,3,在仇与恨的地狱中,2482,0,0,1,1,0.0%,1h
18428,3,[星舰与太阳x]AMUMU,2482,0,0,1,1,0.0%,1h
18428,3,Davidjans,2482,0,0,2,2,0.0%,41m
18428,3,[扫黄打峰]巨像大长腿,2482,0,0,2,2,0.0%,1h
18428,1,月殇,2482,0,0,2,2,0.0%,24m
18458,3,[五月花]暗影卫队,2481,1385,98,90,188,52.1%,3m
18458,2,大别山游击,2481,1466,94,93,187,50.3%,4m
18458,3,eclipse,2481,982,36,37,73,49.3%,1h
18458,3,IIlIlIIIIIll,2481,463,20,9,29,69.0%,1h
18458,3,那晚她很狼狈,2481,405,19,7,26,73.1%,1h
18458,3,hopfffffffff,2481,245,19,9,28,67.9%,1h
18458,3,广开兮天门,2481,490,19,12,31,61.3%,59m
18458,3,[敢犯我河南者]部落的木木,2481,472,17,16,33,51.5%,1h
18458,1,浮夸的演员,2481,484,16,26,42,38.1%,16m
18458,1,zhoushunqin,2481,331,12,18,30,40.0%,1h
18458,2,burning,2481,394,12,28,40,30.0%,24m
18458,2,东马,2481,311,10,13,23,43.5%,1h
18458,3,泽拉图,2481,198,6,8,14,42.9%,1h
18458,3,星灵,2481,185,5,5,10,50.0%,11m
18458,3,[人类防卫阵线]龙傲天下,2481,117,5,6,11,45.5%,1h
18458,1,fcdqd,2481,46,4,3,7,57.1%,1h
18458,3,霜哀,2481,170,4,4,8,50.0%,41m
18458,3,[玛德治杖]小耗,2481,95,2,1,3,66.7%,1h
18458,3,是希儿不是希尔,2481,96,2,1,3,66.7%,1h
18458,1,雨添,2481,0,2,4,6,33.3%,1h
18458,3,五河琴理,2481,0,1,0,1,100.0%,1h
18458,3,[咕咕学院]雪溢,2481,0,1,0,1,100.0%,1h
18458,1,亦白,2481,0,1,0,1,100.0%,36m
18458,1,[IG丶]禁锢,2481,0,1,4,5,20.0%,36m
18458,1,微微一笑辣眼睛,2481,0,1,4,5,20.0%,39m
18458,2,gwsgtwq,2481,42,1,5,6,16.7%,2m
18458,3,浅语勿言,2481,30,1,6,7,14.3%,1m
18458,1,SCV,2481,0,0,1,1,0.0%,2m
18486,3,[相爱一家亲]上善若水,2480,757,35,20,55,63.6%,59m
18486,3,[银翼之光]死亡之翼,2480,374,27,17,44,61.4%,1h
18486,1,[人人人]SRay,2480,570,20,28,48,41.7%,28m
18486,3,西门十鲁炯,2480,415,18,5,23,78.3%,25m
18486,3,[生而狂野]阿汤哥,2480,452,17,13,30,56.7%,7m
18486,1,怀远周杰伦,2480,119,6,1,7,85.7%,1h
18486,3,tanshi,2480,151,6,3,9,66.7%,1h
18486,1,Sakura,2480,185,6,8,14,42.9%,3m
18486,2,Gdw,2480,0,4,4,8,50.0%,1h
18486,1,梦寒樱星雪蝉冰,2480,0,3,2,5,60.0%,1h
18486,3,[狼牙盟]赢了粪池蝶舞,2480,0,3,4,7,42.9%,1h
18486,3,美丽的潘姐姐,2480,30,2,2,4,50.0%,1h
18486,2,时之殇,2480,82,2,5,7,28.6%,20m
18486,3,星际猎人,2480,0,1,1,2,50.0%,1h
18486,1,ydchenyj,2480,73,1,1,2,50.0%,50m
18486,3,BackPacker,2480,0,0,1,1,0.0%,1h
18502,3,陨阳,2479,679,45,31,76,59.2%,1h
18502,1,[LOHv]记忆的透支,2479,1096,44,41,85,51.8%,50m
18502,2,[SC2战队]Noone,2479,337,27,25,52,51.9%,1h
18502,1,sswwwssd,2479,441,13,3,16,81.2%,6m
18502,1,[丨SLT丨]藤原卫星,2479,320,10,7,17,58.8%,1h
18502,3,[玛莎哥牛B]孙一喵,2479,223,6,7,13,46.2%,1h
18502,3,shadow,2479,96,5,9,14,35.7%,1h
18502,2,星空下的猫,2479,162,4,4,8,50.0%,1h
18502,3,wucaO,2479,68,4,7,11,36.4%,1h
18502,1,向我开炮,2479,0,3,2,5,60.0%,1h
18502,3,饿的福瑞迪,2479,86,3,4,7,42.9%,56m
18502,3,[猛的一B]嫂子放开我,2479,40,3,5,8,37.5%,7m
18502,3,[温柔兔公主]曲无忆,2479,120,2,1,3,66.7%,1h
18502,1,Kyo,2479,0,2,4,6,33.3%,1h
18502,3,[TGDD]安静,2479,58,2,5,7,28.6%,32m
18502,2,大兵文文,2479,95,2,10,12,16.7%,46m
18502,3,[综合酯法]东风快递,2479,0,1,1,2,50.0%,47m
18502,3,PhDbiotech,2479,0,1,2,3,33.3%,18m
18502,2,铁板鱿鱼,2479,44,1,6,7,14.3%,1h
18502,2,MRKi,2479,30,1,7,8,12.5%,1h
18522,1,玉疆战神,2478,1533,164,169,333,49.2%,1h
18522,2,BTX,2478,673,25,33,58,43.1%,13m
18522,3,血染姬发,2478,520,24,17,41,58.5%,1h
18522,1,我谁也打不过,2478,456,14,6,20,70.0%,3m
18522,3,答禄所罗,2478,288,11,17,28,39.3%,1h
18522,2,圣光龙,2478,291,10,13,23,43.5%,1h
18522,3,银河战舰,2478,180,6,9,15,40.0%,8m
18522,1,潜行之鲷,2478,160,5,3,8,62.5%,42m
18522,2,君莫笑,2478,224,5,9,14,35.7%,1h
18522,3,风之诺言,2478,60,4,7,11,36.4%,1h
18522,1,luckdog,2478,0,1,0,1,100.0%,13m
18522,3,[审判日号]KandaKouichi,2478,0,1,1,2,50.0%,11m
18522,3,洛宸,2478,0,1,1,2,50.0%,8m
18522,3,神主之王,2478,36,1,2,3,33.3%,35m
18522,1,鱼儿你是不是傻,2478,0,0,1,1,0.0%,42m
18522,3,[濯星]星蓝女子,2478,0,0,2,2,0.0%,1h
18522,3,星坠源,2478,0,0,2,2,0.0%,55m
18539,2,[红魔地下藏书]帕秋莉诺蕾姬,2477,1589,246,249,495,49.7%,18m
18539,1,永不言败,2477,1595,134,145,279,48.0%,1h
18539,2,大妈不自重,2477,204,40,39,79,50.6%,1h
18539,1,Momo,2477,1086,34,29,63,54.0%,25m
18539,3,战狼出击,2477,686,28,26,54,51.9%,1h
18539,3,[菜有菜的道理]农夫一拳,2477,561,24,19,43,55.8%,59m
18539,2,知者智志自至止,2477,417,21,21,42,50.0%,1h
18539,2,老班,2477,412,18,25,43,41.9%,1h
18539,3,魏向风,2477,440,17,13,30,56.7%,1h
18539,3,叶逝羽,2477,158,13,17,30,43.3%,19m
18539,2,康娜酱世界第一,2477,278,10,6,16,62.5%,1h
18539,3,CierraRunis,2477,303,10,8,18,55.6%,1h
18539,3,墨笔称谓,2477,127,10,9,19,52.6%,25m
18539,3,老贼,2477,174,7,10,17,41.2%,1h
18539,2,圆焰终恋,2477,241,7,11,18,38.9%,41m
18539,1,[镜花水月]爱吃面包的索菲,2477,206,6,4,10,60.0%,32m
18539,1,蒹葭,2477,130,4,2,6,66.7%,15m
18539,3,[谐星联盟XY]善良,2477,171,4,4,8,50.0%,1h
18539,3,Lannister,2477,98,4,6,10,40.0%,1h
18539,1,[Borne]erziqyy,2477,0,3,2,5,60.0%,1h
18539,1,[抗压]那我祝你平安,2477,96,3,2,5,60.0%,1h
18539,2,丶包子,2477,76,3,2,5,60.0%,29m
18539,1,无双天道,2477,144,3,5,8,37.5%,2m
18539,1,[NGFIRE]FtoAdm,2477,0,1,0,1,100.0%,1h
18539,1,[神棍三条]北溟鲲,2477,0,1,0,1,100.0%,1h
18539,1,WDNMD,2477,0,1,0,1,100.0%,36m
18539,3,电脑玩家蔡徐坤,2477,0,1,1,2,50.0%,1h
18539,3,[萌即是正义丶]Lived,2477,0,1,6,7,14.3%,49m
18539,3,死神,2477,0,0,2,2,0.0%,1h
18568,3,靓仔,2476,1579,153,143,296,51.7%,7m
18568,3,[慢手e族]战神,2476,1051,105,97,202,52.0%,1m
18568,2,buwanmei,2476,1448,74,60,134,55.2%,4m
18568,1,fzx,2476,974,69,68,137,50.4%,54m
18568,1,llllmlll,2476,779,23,17,40,57.5%,1h
18568,1,茶树咕,2476,522,15,8,23,65.2%,18m
18568,2,oxygen,2476,276,9,16,25,36.0%,42m
18568,3,[一二一]永恒,2476,150,6,6,12,50.0%,1h
18568,3,AHOPER,2476,197,6,8,14,42.9%,43m
18568,2,[暴雪十三队]Rainbow,2476,193,5,8,13,38.5%,1h
18568,1,[星核纪]白杨,2476,95,3,2,5,60.0%,1h
18568,3,noobzly,2476,38,3,6,9,33.3%,60m
18568,3,没有蜡,2476,72,3,6,9,33.3%,44m
18568,1,桑相,2476,86,2,3,5,40.0%,50m
18568,1,kevin,2476,0,1,0,1,100.0%,1h
18568,3,辐射,2476,0,1,2,3,33.3%,4m
18568,3,DaNiELYaNg,2476,97,1,3,4,25.0%,1h
18568,2,表面兄弟,2476,0,0,2,2,0.0%,1h
18568,3,李少,2476,0,0,2,2,0.0%,1h
18568,3,[QWQa]大佬请绕行,2476,0,0,3,3,0.0%,18m
18588,1,声闻于天,2475,1231,197,194,391,50.4%,59m
18588,2,[智商杯233]actfav,2475,1482,194,202,396,49.0%,18m
18588,2,lecxington,2475,1281,64,55,119,53.8%,1h
18588,2,[天堂之魔]laomao,2475,1338,48,55,103,46.6%,31m
18588,1,[单人模拟战]沉默之风暴,2475,644,21,11,32,65.6%,24m
18588,3,糖宝,2475,525,18,18,36,50.0%,43m
18588,3,好烦好像摸鱼,2475,281,12,4,16,75.0%,1h
18588,1,真实的菜鸡,2475,274,11,14,25,44.0%,1h
18588,2,老夫子,2475,157,10,9,19,52.6%,1h
18588,2,[虫海攻略组]我什么也做不到,2475,233,9,11,20,45.0%,1h
18588,3,怡宝大魔王,2475,150,7,6,13,53.8%,54m
18588,2,[不知不觉天亮]supercandy,2475,160,5,3,8,62.5%,1h
18588,2,沧笙,2475,124,5,9,14,35.7%,1h
18588,1,肉嘟嘟的肥皂,2475,48,3,5,8,37.5%,37m
18588,3,来呀打我呀,2475,60,2,2,4,50.0%,45m
18588,1,小胖三,2475,96,2,4,6,33.3%,4m
18588,3,FAUST,2475,0,2,5,7,28.6%,1h
18588,1,nick,2475,42,1,1,2,50.0%,1h
18588,2,mfq,2475,89,1,1,2,50.0%,41m
18588,3,[嗨宝]嗨宝,2475,95,1,2,3,33.3%,1h
18588,1,丿冰冷之月灬,2475,0,0,1,1,0.0%,56m
18588,1,[沉默影业]尺子,2475,0,0,1,1,0.0%,24m
18588,3,[UNSCC]凌寒,2475,0,0,3,3,0.0%,1h
18611,2,小鲸鱼子酱,2474,1417,55,53,108,50.9%,1h
18611,2,DJmi,2474,536,23,18,41,56.1%,29m
18611,2,空无,2474,281,13,7,20,65.0%,46m
18611,3,普通电脑,2474,222,8,5,13,61.5%,1h
18611,2,[明日方舟次老]修地堡司马,2474,0,4,4,8,50.0%,12m
18611,3,CrKingGy,2474,90,4,5,9,44.4%,1h
18611,1,Hussar,2474,48,3,5,8,37.5%,17m
18611,2,黄金虾,2474,0,3,6,9,33.3%,1h
18611,2,[WEjsnj]我是许可馨,2474,92,3,10,13,23.1%,1h
18611,1,MaRk,2474,59,2,2,4,50.0%,24m
18611,3,王叔叔,2474,0,2,6,8,25.0%,1h
18611,2,冷鸟没有腿,2474,44,1,7,8,12.5%,1h
18611,1,CHENXUE,2474,0,0,1,1,0.0%,44m
18624,3,灭团哥,2473,407,43,39,82,52.4%,41m
18624,2,中医世家,2473,260,19,18,37,51.4%,1h
18624,2,骑士魔王,2473,195,7,3,10,70.0%,1h
18624,1,打工戦士,2473,236,6,5,11,54.5%,57m
18624,2,多情应笑我,2473,203,6,14,20,30.0%,9m
18624,2,唯独在大地,2473,120,5,7,12,41.7%,1h
18624,2,[终极蛇皮队]悦耳的寒暄,2473,0,4,4,8,50.0%,54m
18624,3,Tricker,2473,119,3,2,5,60.0%,52m
18624,1,MagejiZerg,2473,34,1,1,2,50.0%,52m
18624,2,[北极光小组]erfan,2473,0,1,1,2,50.0%,1h
18624,1,INnoVation,2473,0,0,1,1,0.0%,1h
18624,1,伊卡若斯,2473,0,0,1,1,0.0%,18m
18624,1,八云金,2473,0,0,1,1,0.0%,4m
18624,1,星辰大海,2473,0,0,1,1,0.0%,37m
18624,3,[ESKT]九思源,2473,0,0,2,2,0.0%,1h
18624,3,[倚天乄未央]尘缘忄未央,2473,0,0,4,4,0.0%,1h
18640,3,Terran,2472,1348,129,118,247,52.2%,1h
18640,3,子午线,2472,856,36,37,73,49.3%,20m
18640,3,HeIsHero,2472,764,32,27,59,54.2%,1h
18640,2,子非鱼网,2472,644,24,26,50,48.0%,1h
18640,3,四季夏目,2472,366,15,12,27,55.6%,1h
18640,3,星际争霸,2472,304,14,15,29,48.3%,11m
18640,3,[曾经一群兔子]Storm,2472,320,12,7,19,63.2%,20m
18640,2,我是原质,2472,202,9,8,17,52.9%,1h
18640,2,骑士丶噬,2472,264,8,11,19,42.1%,1h
18640,3,NIGHTWISH,2472,228,6,8,14,42.9%,1h
18640,2,[GNMS]失心,2472,141,4,6,10,40.0%,1h
18640,3,楠枫流沐,2472,86,3,5,8,37.5%,1h
18640,1,[X英雄圣域X]甜不辣,2472,135,3,9,12,25.0%,18m
18640,3,Mingyez,2472,30,2,2,4,50.0%,48m
18640,3,[喵树]高温高压催化剂,2472,0,1,0,1,100.0%,1h
18640,3,YangWool,2472,0,1,0,1,100.0%,1h
18640,1,Luhai,2472,0,1,1,2,50.0%,44m
18640,1,hbhfn,2472,0,1,3,4,25.0%,1h
18640,3,YAN,2472,0,1,6,7,14.3%,7m
18640,1,[M8]外显子与内含子,2472,0,0,1,1,0.0%,1h
18640,1,nimi,2472,0,0,1,1,0.0%,1h
18640,1,送你一打冥币,2472,0,0,3,3,0.0%,4m
18662,1,为了联盟,2471,1294,157,154,311,50.5%,1h
18662,2,[琴筝]legend,2471,1571,100,96,196,51.0%,1h
18662,3,WEST,2471,1486,85,73,158,53.8%,1h
18662,3,刘小丁,2471,1156,47,52,99,47.5%,1h
18662,1,[兆景埋土大学]无常夏日与幽灵,2471,799,31,30,61,50.8%,32m
18662,2,疾风,2471,804,27,37,64,42.2%,29m
18662,2,未来花朵,2471,548,23,27,50,46.0%,42m
18662,2,AHOIHQOB,2471,286,20,23,43,46.5%,1h
18662,2,Stibium,2471,476,17,23,40,42.5%,1h
18662,3,少将师长,2471,202,8,7,15,53.3%,47m
18662,1,[XCode]渚之空汐之水,2471,134,7,9,16,43.8%,1h
18662,1,zsc,2471,48,4,4,8,50.0%,1h
18662,1,[专业单一小组]boorZerg,2471,186,4,8,12,33.3%,1h
18662,2,勇气人族,2471,0,2,5,7,28.6%,1h
18662,1,[浙江大学战队]丿灬若兮,2471,42,1,1,2,50.0%,1h
18662,1,密奕,2471,0,1,2,3,33.3%,1h
18662,3,青鸟火星,2471,0,0,1,1,0.0%,48m
18662,3,[老废物]刻酱,2471,0,0,2,2,0.0%,56m
18680,3,伯拉多尔,2470,701,315,333,648,48.6%,8m
18680,1,嗯哼,2470,1068,134,121,255,52.5%,15m
18680,1,白驹过隙,2470,1266,49,55,104,47.1%,51m
18680,3,[RaMoC]白门楼,2470,390,14,13,27,51.9%,3m
18680,1,亮亮,2470,444,11,10,21,52.4%,1h
18680,2,湘军小周,2470,268,8,12,20,40.0%,42m
18680,3,[星河气象学院]豆豆金,2470,172,7,9,16,43.8%,1h
18680,3,[AAO]SINANJU,2470,109,6,7,13,46.2%,20m
18680,3,孑然,2470,205,6,9,15,40.0%,43m
18680,2,lancer,2470,163,6,13,19,31.6%,58m
18680,1,[WILLE]夜游君,2470,182,4,7,11,36.4%,1h
18680,3,越玩越菜,2470,30,2,2,4,50.0%,1h
18680,3,[小小泰伦人]就是辣个天神,2470,60,2,4,6,33.3%,9m
18680,1,死之视,2470,0,1,0,1,100.0%,24m
18680,1,nobutama,2470,0,1,0,1,100.0%,1h
18680,3,nogamenolife,2470,0,0,2,2,0.0%,1h
18696,1,[违章建筑多多]燎原号,2469,865,34,16,50,68.0%,19m
18696,2,青空咏叹调,2469,218,7,10,17,41.2%,1h
18696,2,遂風烈,2469,146,5,8,13,38.5%,46m
18696,1,[混元星际門]Listid,2469,132,4,3,7,57.1%,1h
18696,3,忘不了,2469,122,3,2,5,60.0%,8m
18696,1,乐艳,2469,90,2,2,4,50.0%,15m
18696,1,Saber,2469,0,2,4,6,33.3%,1h
18696,3,[AMONPG]枫林溪畔,2469,0,1,1,2,50.0%,1m
18696,1,mosmh,2469,0,1,1,2,50.0%,1h
18696,1,午时怎么还没到啊,2469,0,0,1,1,0.0%,25m
18696,1,博丽魔理沙,2469,0,0,2,2,0.0%,45m
18696,1,哇灬金色传说,2469,0,0,2,2,0.0%,21m
18708,2,菲尼克斯,2468,507,45,44,89,50.6%,1h
18708,3,追上我,2468,455,17,23,40,42.5%,55m
18708,1,菲尼克斯,2468,359,12,15,27,44.4%,1h
18708,1,逼二了反看你,2468,270,9,13,22,40.9%,50m
18708,3,冰冰冰冰冰焰,2468,179,5,5,10,50.0%,43m
18708,1,KING,2468,122,3,3,6,50.0%,18m
18708,2,走过的路,2468,94,3,7,10,30.0%,1h
18708,1,终神,2468,86,3,11,14,21.4%,39m
18708,3,云界风源,2468,30,2,2,4,50.0%,1h
18708,1,幕夜星,2468,0,2,3,5,40.0%,1h
18708,2,猫神撅拓星团,2468,127,2,3,5,40.0%,46m
18708,1,炎舞最可爱,2468,0,2,3,5,40.0%,1h
18708,3,WDNMD,2468,60,2,4,6,33.3%,3m
18708,3,pig,2468,0,1,3,4,25.0%,56m
18708,1,[YMSX]kangming,2468,0,0,1,1,0.0%,1h
18708,1,[user]YuFeng,2468,0,0,1,1,0.0%,1h
18708,1,你好,2468,0,0,1,1,0.0%,54m
18708,3,[绘梨依]路明非,2468,0,0,2,2,0.0%,20m
18726,3,jazzw,2467,1168,49,42,91,53.8%,19m
18726,3,sain,2467,998,38,35,73,52.1%,32m
18726,1,无敌小兴兴,2467,403,29,19,48,60.4%,21m
18726,1,Blood,2467,708,20,18,38,52.6%,14m
18726,2,[樱丘]神利苏,2467,366,15,14,29,51.7%,4m
18726,3,IIIIIIIIIIII,2467,197,8,11,19,42.1%,11m
18726,3,方圆,2467,227,7,6,13,53.8%,25m
18726,1,探机说的对,2467,266,7,12,19,36.8%,1h
18726,2,暴力火车,2467,176,4,9,13,30.8%,1h
18726,3,[cgnb]YvesChan,2467,124,4,9,13,30.8%,43m
18726,1,风云突变,2467,115,3,3,6,50.0%,50m
18726,2,guanguanlili,2467,181,3,7,10,30.0%,52m
18726,3,我玩神族只搞后期,2467,122,3,8,11,27.3%,51m
18726,3,收到货不么无人,2467,30,2,2,4,50.0%,25m
18726,3,ACG,2467,30,2,2,4,50.0%,1h
18726,1,竹男,2467,0,2,4,6,33.3%,17m
18726,2,[裳卿阁]涟漪之羽,2467,95,2,7,9,22.2%,1h
18726,3,我累擦,2467,36,2,7,9,22.2%,1h
18726,1,[晋升者]伞兵一号卢本伟,2467,0,1,0,1,100.0%,1h
18726,1,[玲喵卡哇伊]REvoLution,2467,0,1,1,2,50.0%,1h
18726,3,不会玩别来贰打贰,2467,97,1,2,3,33.3%,21m
18726,1,旅店老板,2467,0,0,1,1,0.0%,1h
18726,1,magejizerg,2467,0,0,1,1,0.0%,24m
18749,1,天赐良机,2466,1153,50,52,102,49.0%,1h
18749,3,成凮,2466,1113,44,42,86,51.2%,9m
18749,3,迷茫骑士,2466,996,41,54,95,43.2%,32m
18749,3,为了部落,2466,618,33,27,60,55.0%,48m
18749,3,MHIWYA,2466,595,28,22,50,56.0%,1h
18749,3,[Kiloli]虚空次元,2466,653,24,21,45,53.3%,1h
18749,3,神垃圾,2466,469,20,12,32,62.5%,11m
18749,3,怅怅莫怪少年时,2466,326,12,9,21,57.1%,59m
18749,2,[XXHZ10]诸葛司马在下棋,2466,297,12,10,22,54.5%,1h
18749,1,[星云二五仔]fizzovation,2466,189,7,2,9,77.8%,1h
18749,2,[第三駆逐鑑隊]高阶犯罪者,2466,211,6,5,11,54.5%,13m
18749,2,[拨云见日]凤雏,2466,100,5,8,13,38.5%,1h
18749,2,暖阳冰球,2466,160,5,8,13,38.5%,1h
18749,3,[大战队]白银之鹰,2466,144,4,7,11,36.4%,1h
18749,3,名哥,2466,118,3,1,4,75.0%,1m
18749,3,Layoomiety,2466,144,3,5,8,37.5%,3m
18749,1,Dan,2466,161,3,7,10,30.0%,21m
18749,1,孤岛,2466,42,2,0,2,100.0%,32m
18749,1,独孤求败,2466,36,2,0,2,100.0%,1h
18749,1,我要修地堡了,2466,80,2,3,5,40.0%,1h
18749,3,江懿,2466,58,2,6,8,25.0%,54m
18749,1,[ZZFANS]Markinian,2466,42,1,1,2,50.0%,3m
18749,1,破损的青铜戟,2466,0,0,1,1,0.0%,1h
18749,1,我是垃圾哟,2466,0,0,1,1,0.0%,1h
18749,1,[29CM]喝茶的喵,2466,0,0,4,4,0.0%,17m
18749,2,彭霸天,2466,0,0,5,5,0.0%,7m
18775,3,[坦克36D]usadapekora,2465,933,40,29,69,58.0%,29m
18775,2,嚎呦哏,2465,327,35,36,71,49.3%,31m
18775,3,Merceraxz,2465,646,27,30,57,47.4%,55m
18775,3,[CPT]喵喵爱恰小鱼干,2465,506,18,20,38,47.4%,1h
18775,1,独行狼,2465,261,11,12,23,47.8%,1h
18775,2,萌新报道,2465,288,10,12,22,45.5%,1h
18775,2,浅尝辄止,2465,168,7,11,18,38.9%,1h
18775,3,[小仙女上线啦]天之蓝,2465,245,7,11,18,38.9%,1h
18775,2,王大,2465,95,5,5,10,50.0%,12m
18775,2,颌言,2465,131,4,7,11,36.4%,1h
18775,3,下次换你心动,2465,30,2,3,5,40.0%,1h
18775,1,MarsBattle,2465,97,2,5,7,28.6%,45m
18775,1,[XCode]MINITIAN,2465,48,2,6,8,25.0%,1h
18775,1,[为冰雪而战]初雪,2465,0,1,0,1,100.0%,59m
18775,1,我是笨比,2465,0,1,0,1,100.0%,1h
18775,1,老鹰,2465,0,0,1,1,0.0%,1h
18775,2,zyf,2465,0,0,1,1,0.0%,1h
18792,3,仙女倩,2464,1422,66,64,130,50.8%,25m
18792,3,神与人,2464,540,32,22,54,59.3%,32m
18792,2,星空虫族,2464,193,10,8,18,55.6%,1h
18792,2,九帝他还在,2464,165,5,4,9,55.6%,1h
18792,3,别走等我买橘,2464,144,5,6,11,45.5%,1h
18792,3,终焉时刻,2464,149,4,4,8,50.0%,16m
18792,3,么么哒小兔兔,2464,120,4,7,11,36.4%,1h
18792,1,北冥有鱼其名为咸,2464,116,3,2,5,60.0%,1h
18792,1,[振华之光]Stardust,2464,110,3,2,5,60.0%,25m
18792,3,[让让孩子吧]莱德林,2464,114,3,2,5,60.0%,25m
18792,3,GTR,2464,97,3,5,8,37.5%,1h
18792,3,胡涂仙,2464,0,2,5,7,28.6%,1h
18792,1,epicevent,2464,0,1,0,1,100.0%,1h
18792,1,阿克苏次,2464,0,0,1,1,0.0%,1h
18792,1,[Gj]风花雪月,2464,0,0,1,1,0.0%,32m
18792,1,村子里的文化仔,2464,0,0,1,1,0.0%,1h
18808,3,[北有唔王]星际菜鸟,2463,1510,102,108,210,48.6%,1h
18808,3,[慢手e族]峰寒,2463,989,47,30,77,61.0%,1h
18808,2,Andres,2463,669,34,38,72,47.2%,39m
18808,1,[Rhusky]拾柒丨半糖去冰,2463,864,30,46,76,39.5%,38m
18808,2,doge,2463,144,27,25,52,51.9%,1h
18808,3,CLOWN,2463,512,25,11,36,69.4%,11m
18808,3,Kimimango,2463,495,20,18,38,52.6%,18m
18808,1,总有脑瘫选风暴,2463,488,19,0,19,100.0%,10m
18808,2,missdegenban,2463,296,11,9,20,55.0%,1h
18808,3,青悠子呤,2463,156,7,5,12,58.3%,11m
18808,2,晨曦,2463,108,3,1,4,75.0%,1h
18808,3,xiaot,2463,141,3,3,6,50.0%,1h
18808,1,llllllllllll,2463,128,3,3,6,50.0%,15m
18808,1,魔鬼精肉人,2463,84,2,2,4,50.0%,21m
18808,1,温婉秋,2463,97,2,4,6,33.3%,5m
18808,1,迎王,2463,0,1,0,1,100.0%,1h
18808,1,我噼里啪啦,2463,0,1,0,1,100.0%,32m
18808,2,按时恰个饭,2463,92,1,6,7,14.3%,39m
18808,1,书剑卦临,2463,0,0,1,1,0.0%,14m
18808,1,[神子]sadas,2463,0,0,1,1,0.0%,25m
18828,3,山丘之王,2462,1558,205,206,411,49.9%,11m
18828,1,椿生,2462,702,32,23,55,58.2%,1h
18828,3,Kerrigan,2462,414,23,11,34,67.6%,54m
18828,3,LongSY,2462,497,19,17,36,52.8%,1h
18828,3,[宝贝趴好]吻吻我的小舌头,2462,398,13,15,28,46.4%,55m
18828,2,美如绝品势如龙,2462,282,12,15,27,44.4%,1h
18828,3,瞎子不配打星际,2462,193,11,6,17,64.7%,33m
18828,1,訫狐,2462,281,8,11,19,42.1%,1h
18828,3,我是亚托克斯,2462,196,6,8,14,42.9%,1h
18828,3,[RSTAR]Riddim,2462,127,5,6,11,45.5%,35m
18828,3,[加达里海军]川制消毒软糖,2462,146,5,7,12,41.7%,11m
18828,2,忆兮年,2462,122,3,3,6,50.0%,1h
18828,3,[Cytus]富丽雅游泳馆,2462,144,3,4,7,42.9%,7m
18828,1,[C47021]寒冰暗炎使,2462,0,2,3,5,40.0%,17m
18828,3,池鱼思,2462,0,1,0,1,100.0%,1h
18828,1,人生寂寞可快乐,2462,42,1,1,2,50.0%,1h
18828,3,无月绯色,2462,0,1,1,2,50.0%,54m
18828,3,Mmmilor,2462,30,1,2,3,33.3%,24m
18828,1,三缸成了一条狗,2462,0,0,1,1,0.0%,1h
18828,3,穿星魔锋,2462,0,0,2,2,0.0%,35m
18848,3,星际狩猎者,2461,1557,169,165,334,50.6%,32m
18848,3,[葛温王下骑士]月夜,2461,688,26,24,50,52.0%,1h
18848,2,[湖狸]墨染青衣颜,2461,282,21,16,37,56.8%,31m
18848,3,scvzbjx,2461,456,20,17,37,54.1%,11m
18848,2,孤舟白衣北海少年,2461,460,15,18,33,45.5%,56m
18848,3,Sunlight,2461,267,8,10,18,44.4%,1h
18848,3,夕阳的痕迹,2461,204,5,10,15,33.3%,1h
18848,1,对面俩母狗给我口,2461,145,4,1,5,80.0%,24m
18848,1,贝塔,2461,122,4,3,7,57.1%,1h
18848,1,不会玩,2461,96,4,6,10,40.0%,1h
18848,1,桀骜不驯,2461,96,2,4,6,33.3%,17m
18848,1,起个名字好难,2461,48,2,5,7,28.6%,1h
18848,1,Eeason,2461,0,1,0,1,100.0%,55m
18848,3,某坑,2461,94,1,2,3,33.3%,1h
18848,1,krobio,2461,0,1,4,5,20.0%,59m
18848,1,皈依红姑娘丶,2461,0,0,1,1,0.0%,41m
18848,3,自由之翼,2461,0,0,2,2,0.0%,1h
18848,3,[社交学超可爱]lwuxiel,2461,0,0,9,9,0.0%,43m
18866,2,影子,2460,1485,79,71,150,52.7%,1h
18866,3,爱姊,2460,694,52,45,97,53.6%,1h
18866,3,[CPT]Commissar,2460,441,32,45,77,41.6%,1h
18866,3,朱五四,2460,403,14,14,28,50.0%,1h
18866,1,[是我赢了]小樱花,2460,326,10,9,19,52.6%,1h
18866,2,[SCVsr]奇迹,2460,254,9,11,20,45.0%,1h
18866,2,[神奇宝贝联盟]末影小火龙,2460,275,9,13,22,40.9%,41m
18866,2,[mafia2]theologian,2460,228,7,11,18,38.9%,27m
18866,3,鸣仔,2460,197,6,6,12,50.0%,1h
18866,1,[GOTAL]龙族九哥,2460,124,3,2,5,60.0%,18m
18866,3,[尐懒猫]不染之血,2460,97,3,6,9,33.3%,51m
18866,3,皇少耶,2460,93,2,1,3,66.7%,1h
18866,1,wsrv,2460,0,2,1,3,66.7%,46m
18866,3,emyuvrewt,2460,121,2,3,5,40.0%,1h
18866,1,KISS,2460,0,0,1,1,0.0%,14m
18881,1,aazsabc,2459,1563,396,399,795,49.8%,28m
18881,1,[菜有菜的道理]Patience,2459,1074,83,86,169,49.1%,1h
18881,2,[F2ANB]上杉绘梨衣,2459,987,41,48,89,46.1%,42m
18881,3,Aceke,2459,644,29,30,59,49.2%,1h
18881,3,blackapple,2459,454,22,8,30,73.3%,1h
18881,3,KONKADHA,2459,351,13,16,29,44.8%,1h
18881,3,zaruaku,2459,265,10,3,13,76.9%,43m
18881,1,大白,2459,316,8,5,13,61.5%,47m
18881,3,[XXHZ30]小菜基也要玩,2459,197,5,11,16,31.2%,9m
18881,3,新手电脑,2459,145,4,1,5,80.0%,1h
18881,1,一梦一世,2459,156,4,5,9,44.4%,1h
18881,1,ulrezal,2459,122,3,2,5,60.0%,1h
18881,1,skybear,2459,0,1,0,1,100.0%,47m
18881,3,[WFFF]大肠粉,2459,0,1,0,1,100.0%,1h
18881,1,恶人,2459,0,1,0,1,100.0%,32m
18881,1,[随机团]IIIIIIIIIIII,2459,38,1,1,2,50.0%,1h
18881,1,[爱国]wangshi,2459,0,0,2,2,0.0%,14m
18881,1,wdcxjjbd,2459,0,0,3,3,0.0%,1h
18899,2,母大爷,2458,1538,86,87,173,49.7%,31m
18899,1,薛鹏程,2458,784,28,33,61,45.9%,1h
18899,3,形而上,2458,207,18,22,40,45.0%,1h
18899,3,不会开矿,2458,389,16,11,27,59.3%,25m
18899,3,right,2458,416,16,21,37,43.2%,28m
18899,2,路过的酱油党,2458,339,13,9,22,59.1%,16m
18899,3,[为了虫群zz]qiaomm,2458,305,10,12,22,45.5%,9m
18899,2,飓风狂飙,2458,214,8,13,21,38.1%,14m
18899,2,Quinlan,2458,172,6,13,19,31.6%,41m
18899,3,[OTAKU丨]昏君夏夏夏炎,2458,157,5,6,11,45.5%,35m
18899,2,隧道门空间,2458,86,4,7,11,36.4%,7m
18899,3,夏日微凉,2458,145,4,7,11,36.4%,1h
18899,3,新手跑得快,2458,97,3,5,8,37.5%,1h
18899,1,Ironman,2458,0,1,0,1,100.0%,1h
18899,3,魅影,2458,30,1,3,4,25.0%,1h
18899,1,sinner,2458,0,0,1,1,0.0%,41m
18899,1,VirusTAO,2458,0,0,2,2,0.0%,21m
18899,3,三少,2458,0,0,3,3,0.0%,33m
18899,1,我有点傻,2458,0,0,3,3,0.0%,1h
18918,3,嘎硕,2457,768,33,28,61,54.1%,1h
18918,2,[初音未來]ByFiona,2457,458,19,23,42,45.2%,1h
18918,1,Dumm,2457,548,18,15,33,54.5%,52m
18918,2,我整你嘴,2457,336,14,14,28,50.0%,28m
18918,3,[18th]wwyhy,2457,327,12,7,19,63.2%,1h
18918,3,[sc谐盟]士官长,2457,371,12,12,24,50.0%,1h
18918,1,千山鸟飞绝,2457,204,7,11,18,38.9%,58m
18918,2,Flash,2457,165,5,3,8,62.5%,1h
18918,1,[和平发育行不]Sunbeam,2457,132,3,4,7,42.9%,1h
18918,3,恐怕很菜哦,2457,32,3,7,10,30.0%,49m
18918,1,llllllllllll,2457,0,3,8,11,27.3%,1h
18918,1,[公主联盟]本公主不菜,2457,86,2,3,5,40.0%,3m
18918,1,PglsT,2457,0,1,0,1,100.0%,1h
18918,3,zhouzhou,2457,30,1,4,5,20.0%,1h
18932,3,saint,2456,453,77,70,147,52.4%,56m
18932,3,冰雪狂神,2456,1479,58,56,114,50.9%,8m
18932,3,借缘,2456,1299,55,52,107,51.4%,25m
18932,2,[小仙女上线啦]不能一错再错,2456,992,38,39,77,49.4%,1h
18932,1,imbalance,2456,827,32,28,60,53.3%,1h
18932,3,抬棺的黑人,2456,484,17,17,34,50.0%,8m
18932,1,何丁的爸爸,2456,192,6,1,7,85.7%,49m
18932,3,WSS,2456,150,6,10,16,37.5%,25m
18932,2,杀我农民就投降,2456,133,3,2,5,60.0%,39m
18932,1,言退者丶斩,2456,0,3,7,10,30.0%,25m
18932,1,[抹除开始]好兄弟吃了没,2456,0,1,0,1,100.0%,29m
18932,1,[埃蒙好可爱]呆头马,2456,44,1,1,2,50.0%,1h
18932,3,秋梨膏,2456,97,1,1,2,50.0%,1h
18932,1,行星,2456,44,1,2,3,33.3%,42m
18932,1,毁灭之影,2456,44,1,3,4,25.0%,15m
18947,3,来杯小可,2455,1364,74,66,140,52.9%,1h
18947,3,kojhsiuq,2455,1168,52,45,97,53.6%,1h
18947,1,我曾触碰星辰,2455,819,31,23,54,57.4%,4m
18947,3,Limbo,2455,564,23,22,45,51.1%,1h
18947,1,CKFREE,2455,272,11,14,25,44.0%,45m
18947,1,张洪民,2455,190,10,0,10,100.0%,47m
18947,3,YUE,2455,158,7,6,13,53.8%,59m
18947,2,铁一神教,2455,126,3,5,8,37.5%,1h
18947,3,苍云古齿,2455,121,2,1,3,66.7%,1h
18947,3,烤鸭,2455,0,2,5,7,28.6%,1h
18947,2,天下,2455,40,1,4,5,20.0%,13m
18947,1,角色名,2455,0,0,1,1,0.0%,49m
18947,1,黑衣剑士,2455,0,0,1,1,0.0%,14m
18960,1,你杨嗲嗲,2454,1103,50,44,94,53.2%,60m
18960,2,[浴火银河]RamBo,2454,891,35,40,75,46.7%,1h
18960,1,phantomyrq,2454,620,18,12,30,60.0%,1h
18960,3,何贱贱,2454,478,17,19,36,47.2%,1h
18960,2,Timeboy,2454,438,16,16,32,50.0%,1h
18960,2,马瑞,2454,151,9,16,25,36.0%,17m
18960,3,正正子御,2454,133,7,10,17,41.2%,20m
18960,1,TNT,2454,188,6,1,7,85.7%,1h
18960,1,黑色的宇,2454,232,6,5,11,54.5%,18m
18960,2,奥萨洛蒂,2454,191,6,6,12,50.0%,1h
18960,3,[dgxfd]赵中义,2454,172,6,8,14,42.9%,1h
18960,2,[萌M]与圣光作对,2454,130,5,8,13,38.5%,27m
18960,3,虹湾登陆者,2454,94,5,9,14,35.7%,47m
18960,3,朱纳尔多,2454,122,4,8,12,33.3%,9m
18960,1,我是菜逼,2454,97,2,5,7,28.6%,1h
18960,2,[贫乳小萝莉]大禹,2454,0,1,1,2,50.0%,1h
18960,1,[琴筝]IIIIIIIIIIII,2454,0,1,3,4,25.0%,1h
18960,1,我为第一,2454,0,1,4,5,20.0%,21m
18960,1,春风,2454,0,1,5,6,16.7%,1h
18960,2,[彼岸之花]Leo,2454,0,0,1,1,0.0%,1h
18960,3,昔梦,2454,0,0,2,2,0.0%,1h
18960,1,小明,2454,0,0,2,2,0.0%,21m
18960,3,spart,2454,0,0,3,3,0.0%,1h
18983,2,伏羲,2453,1313,90,84,174,51.7%,43m
18983,1,二五仔星际,2453,986,71,70,141,50.4%,15m
18983,1,KZY,2453,507,59,65,124,47.6%,4m
18983,2,[谁不服]Jarvis,2453,714,27,28,55,49.1%,1h
18983,2,[等我到十费]黑幕冥王,2453,243,9,6,15,60.0%,1h
18983,2,tenevil,2453,270,9,13,22,40.9%,1h
18983,2,SEVEN,2453,257,8,16,24,33.3%,49m
18983,1,dad,2453,96,6,3,9,66.7%,24m
18983,1,莉灬零,2453,0,3,2,5,60.0%,17m
18983,3,Lomina,2453,30,2,2,4,50.0%,25m
18983,1,怎么办啊,2453,78,2,2,4,50.0%,31m
18983,3,backgwy,2453,0,2,5,7,28.6%,1h
18983,1,Nerissa,2453,30,1,1,2,50.0%,60m
18983,1,Jnino,2453,0,1,4,5,20.0%,17m
18983,1,[428NB]别问问就你麻痹的,2453,0,0,1,1,0.0%,10m
18983,3,[战忽局总部]五乐泉,2453,0,0,2,2,0.0%,56m
18983,3,孤杀妖星,2453,0,0,5,5,0.0%,1h
19000,3,火雨,2452,1487,70,62,132,53.0%,41m
19000,3,纤纤擢素手,2452,746,53,47,100,53.0%,1h
19000,1,天上的声名,2452,730,23,24,47,48.9%,1h
19000,2,hikan,2452,559,22,22,44,50.0%,1h
19000,3,amberkoon,2452,246,9,11,20,45.0%,12m
19000,3,aaaaa,2452,168,4,1,5,80.0%,1h
19000,3,[秋毫第五分队]虐暴傻必狗队友,2452,90,4,6,10,40.0%,1h
19000,3,MUA,2452,179,4,6,10,40.0%,21m
19000,2,ali,2452,105,3,2,5,60.0%,1h
19000,3,[坠梦]为艾尔而战,2452,32,1,1,2,50.0%,49m
19000,3,寻觅厌己,2452,30,1,4,5,20.0%,19m
19000,3,内涵段子,2452,30,1,5,6,16.7%,1h
19000,2,流星,2452,0,0,1,1,0.0%,13m
19000,1,[镜花水月]有妹是穹,2452,0,0,1,1,0.0%,1h
19000,1,我是萌新,2452,0,0,1,1,0.0%,1h
19000,1,独饮半生,2452,0,0,4,4,0.0%,4m
19016,3,冥嗜,2451,463,190,184,374,50.8%,1h
19016,3,埃尔托斯,2451,472,25,25,50,50.0%,1h
19016,3,追猎舞者,2451,309,19,15,34,55.9%,19m
19016,1,Vertigo,2451,517,17,17,34,50.0%,1h
19016,1,留意,2451,317,11,3,14,78.6%,1h
19016,1,[桔梗花咲]拉扎尔苏,2451,218,6,7,13,46.2%,41m
19016,3,SCPLAYER,2451,198,6,9,15,40.0%,32m
19016,1,你的背影遥不可及,2451,77,4,2,6,66.7%,18m
19016,3,为了荣耀而站,2451,30,4,5,9,44.4%,1h
19016,3,[HUC兄弟]LXC,2451,68,4,8,12,33.3%,49m
19016,1,[草草草草草草]我是格鲁特,2451,122,3,3,6,50.0%,31m
19016,3,星云流,2451,121,3,3,6,50.0%,8m
19016,3,清隆,2451,38,2,3,5,40.0%,46m
19016,3,[星际国服班]月夜龙,2451,60,2,5,7,28.6%,27m
19016,3,[天羽不榖]AlbertShen,2451,0,1,0,1,100.0%,1h
19016,1,钻漾中凋零,2451,44,1,1,2,50.0%,1h
19016,1,[我们是萌新]HHWYMKF,2451,48,1,1,2,50.0%,1h
19016,1,[棱角分明]ZzzQlzzzzql,2451,0,0,1,1,0.0%,1h
19016,1,嘤嘤怪,2451,0,0,1,1,0.0%,42m
19035,2,卡索亚,2450,1178,106,107,213,49.8%,20m
19035,3,Kintz,2450,606,62,61,123,50.4%,1h
19035,1,来自宇宙,2450,775,35,25,60,58.3%,42m
19035,1,[秋毫第五分队]幽冥流沙,2450,367,16,9,25,64.0%,1h
19035,3,[空集]Scarlet,2450,365,13,17,30,43.3%,36m
19035,1,[暴雪二十五队]猛虎一号,2450,286,8,4,12,66.7%,21m
19035,3,啸平,2450,172,5,5,10,50.0%,56m
19035,3,[KK开]TianYa,2450,121,5,6,11,45.5%,1h
19035,3,[SCLR]NearNight,2450,147,5,8,13,38.5%,21m
19035,1,当个麦迪文,2450,126,4,2,6,66.7%,1h
19035,2,星星点点,2450,159,4,4,8,50.0%,51m
19035,1,不菲的孤独,2450,122,3,3,6,50.0%,1h
19035,3,IIIIIIIIIIII,2450,145,3,4,7,42.9%,9m
19035,3,ocean,2450,0,2,5,7,28.6%,58m
19035,1,大白班长,2450,0,0,1,1,0.0%,1h
19035,1,[SDE]Mos,2450,0,0,2,2,0.0%,26m
19035,1,[嘤嘤樱]废材优优,2450,0,0,2,2,0.0%,39m
19052,3,PhatomKaito,2449,1583,132,136,268,49.3%,59m
19052,3,坐标一二三,2449,575,23,18,41,56.1%,33m
19052,3,骑士包子,2449,522,19,26,45,42.2%,32m
19052,2,[暴雪三十二隊]夜半松风,2449,300,13,8,21,61.9%,1h
19052,1,老东西,2449,150,8,10,18,44.4%,59m
19052,1,tingyang,2449,249,7,16,23,30.4%,28m
19052,1,[吃了小宇]zhaom,2449,152,4,3,7,57.1%,1h
19052,3,[误国]霹雳虎,2449,86,4,5,9,44.4%,1h
19052,1,Marlboroo,2449,184,4,6,10,40.0%,21m
19052,1,[刺蛇互助协会]Shokaku,2449,84,3,1,4,75.0%,32m
19052,3,莎拉雷诺,2449,117,3,3,6,50.0%,1h
19052,2,[XXHZ30]醉过,2449,88,2,1,3,66.7%,1h
19052,3,醉枕江山,2449,95,2,2,4,50.0%,1h
19052,1,睡不醒的猫,2449,0,2,3,5,40.0%,40m
19052,3,ReoLFor,2449,20,2,3,5,40.0%,1h
19052,1,忻聆,2449,0,2,4,6,33.3%,24m
19052,3,马尔泰若曦,2449,30,1,4,5,20.0%,7m
19052,1,门铃,2449,0,1,4,5,20.0%,4m
19052,1,sfdawdaf,2449,0,0,1,1,0.0%,1h
19052,1,北沫,2449,0,0,1,1,0.0%,1h
19052,1,走资派,2449,0,0,2,2,0.0%,42m
19073,1,house,2448,454,59,67,126,46.8%,5m
19073,2,zxkdd,2448,1078,45,47,92,48.9%,1h
19073,1,清水明山,2448,626,36,23,59,61.0%,49m
19073,3,習飛御用,2448,947,35,34,69,50.7%,1h
19073,1,绚濑巧克里,2448,652,25,25,50,50.0%,52m
19073,3,开起来的小字母,2448,381,15,17,32,46.9%,59m
19073,3,流星,2448,357,13,10,23,56.5%,32m
19073,1,狐狗,2448,285,11,10,21,52.4%,1h
19073,1,youdian,2448,368,9,5,14,64.3%,1h
19073,2,[XCode]大鱼,2448,210,7,6,13,53.8%,31m
19073,2,[gusl]PrinCess,2448,161,5,6,11,45.5%,1h
19073,3,Fire,2448,122,5,7,12,41.7%,56m
19073,1,致命的爱,2448,48,3,4,7,42.9%,44m
19073,3,[暴力喵星]扎本,2448,30,2,3,5,40.0%,1h
19073,1,[你好骚啊]无敌的白金之星,2448,0,1,0,1,100.0%,18m
19073,1,[维也纳]sixxamalex,2448,0,1,0,1,100.0%,1h
19073,3,帝血弑天,2448,0,1,0,1,100.0%,26m
19073,3,Manday,2448,0,1,1,2,50.0%,43m
19073,1,[你的剑很美]涛涛,2448,30,1,1,2,50.0%,59m
19073,1,紫霞丶仙子,2448,0,1,4,5,20.0%,1h
19073,1,[XXHZ36]SenBrother,2448,0,1,4,5,20.0%,5m
19073,3,木子走刀口,2448,30,1,7,8,12.5%,1h
19073,1,我是兔子,2448,0,0,2,2,0.0%,1h
19096,3,星际小菜菜,2447,1293,60,58,118,50.8%,55m
19096,3,zhaoyi,2447,880,32,35,67,47.8%,1h
19096,2,李信陵,2447,600,31,36,67,46.3%,1h
19096,1,[菜有菜的道理]与正,2447,600,23,16,39,59.0%,32m
19096,3,ALTerNatIVe,2447,309,9,11,20,45.0%,11m
19096,3,无法无天,2447,183,7,6,13,53.8%,24m
19096,1,[西部狼群]不上钻石不改名,2447,204,6,1,7,85.7%,58m
19096,1,克里夫反抗军,2447,214,6,5,11,54.5%,1h
19096,1,cts,2447,240,5,7,12,41.7%,17m
19096,1,虚空无垠,2447,96,4,4,8,50.0%,36m
19096,1,六六,2447,141,3,5,8,37.5%,1h
19096,3,ZVSD,2447,30,3,6,9,33.3%,32m
19096,1,你的机枪兵,2447,0,2,1,3,66.7%,17m
19096,1,落墨山玉,2447,0,1,0,1,100.0%,55m
19096,1,[暴雪家族]橘子,2447,44,1,2,3,33.3%,45m
19096,1,[AOAOA]superggn,2447,42,1,3,4,25.0%,25m
19096,1,佞臣,2447,0,1,4,5,20.0%,1h
19096,1,老王,2447,0,0,1,1,0.0%,33m
19114,1,[极限菜鸟]逍遥自在,2446,1078,150,150,300,50.0%,1h
19114,1,daixiao,2446,902,34,22,56,60.7%,4m
19114,3,再也无她,2446,641,25,28,53,47.2%,55m
19114,3,[雷霆半月斩]天天,2446,529,22,17,39,56.4%,1h
19114,1,林仔,2446,395,19,21,40,47.5%,52m
19114,3,自抱自泣,2446,166,9,9,18,50.0%,54m
19114,2,命善,2446,188,8,8,16,50.0%,1h
19114,1,happyday,2446,216,8,14,22,36.4%,26m
19114,3,绝望中想起了换家,2446,180,7,7,14,50.0%,43m
19114,3,fgfdfd,2446,179,7,7,14,50.0%,49m
19114,1,[阿米娅是驴]今日绫波明日香,2446,196,5,2,7,71.4%,1h
19114,1,[二哈叼爱萌]呼呼,2446,48,4,4,8,50.0%,1h
19114,1,[神子]路明非,2446,128,3,4,7,42.9%,1h
19114,1,死亡之翼,2446,122,3,5,8,37.5%,1h
19114,1,凌河丶,2446,97,2,0,2,100.0%,21m
19114,1,胜多负少,2446,0,2,3,5,40.0%,1h
19114,1,插眼踢裆石灰粉,2446,135,2,4,6,33.3%,1h
19114,1,蒙恬,2446,0,1,0,1,100.0%,1h
19114,1,[风纪委员会]帕尼尼,2446,0,1,4,5,20.0%,1h
19114,3,蝎子徂,2446,0,0,1,1,0.0%,1h
19114,2,冰封夕阳,2446,0,0,1,1,0.0%,13m
19114,2,上山打老虎,2446,0,0,3,3,0.0%,5m
19114,3,一只海龟成功入水,2446,0,0,4,4,0.0%,1h
19114,3,山羊丶,2446,0,0,5,5,0.0%,30m
19114,3,月光独奏,2446,0,0,5,5,0.0%,19m
19139,3,洛燨,2445,1429,100,101,201,49.8%,30m
19139,2,Comgmyzi,2445,1117,44,50,94,46.8%,30m
19139,1,剑雨,2445,532,22,10,32,68.8%,33m
19139,3,神丶宇,2445,439,18,25,43,41.9%,2m
19139,1,星空下的少年,2445,419,14,8,22,63.6%,1h
19139,1,梧桐影,2445,418,12,5,17,70.6%,1h
19139,3,Ghost,2445,160,6,6,12,50.0%,1h
19139,3,[听山雨欲来]诸葛村夫,2445,112,6,6,12,50.0%,1h
19139,1,[秦朝妃子秀]九月未央,2445,206,5,2,7,71.4%,25m
19139,1,[20CM]HFserral,2445,124,4,0,4,100.0%,21m
19139,1,余江第一帅,2445,96,3,6,9,33.3%,45m
19139,1,斋藤飞鸟,2445,0,2,3,5,40.0%,1h
19139,1,那我祝妳平安,2445,97,2,5,7,28.6%,1h
19139,2,河南因脑为什,2445,88,1,1,2,50.0%,41m
19139,1,战争法师,2445,97,1,1,2,50.0%,1h
19139,1,llllllllllll,2445,42,1,3,4,25.0%,1h
19139,1,[LOHv]蓝山,2445,0,0,5,5,0.0%,1h
19156,2,自由在召唤,2444,616,43,44,87,49.4%,1h
19156,1,BigJJCaptain,2444,543,40,26,66,60.6%,20m
19156,1,[铃兰男子高校]StarMalison,2444,1111,39,31,70,55.7%,1h
19156,3,[四佑]打不死的电工,2444,875,34,38,72,47.2%,1h
19156,1,长岛冰茶,2444,574,15,11,26,57.7%,18m
19156,3,献花,2444,192,11,12,23,47.8%,1h
19156,1,星系领主,2444,352,10,8,18,55.6%,49m
19156,1,mzy,2444,345,10,8,18,55.6%,58m
19156,3,寒阳雪,2444,291,10,9,19,52.6%,1h
19156,2,krystal,2444,229,7,10,17,41.2%,53m
19156,2,[倚楼听风雨灬]King,2444,178,6,5,11,54.5%,9m
19156,1,[菜有菜的道理]伊卡赛高,2444,228,6,6,12,50.0%,1h
19156,1,兜兜,2444,178,5,5,10,50.0%,20m
19156,2,Xin,2444,149,5,10,15,33.3%,7m
19156,2,SHAYV,2444,84,5,10,15,33.3%,31m
19156,1,hhhh,2444,119,4,4,8,50.0%,46m
19156,3,[谐字当头一个]倒悬的王朗,2444,143,3,1,4,75.0%,21m
19156,1,飞天,2444,116,3,3,6,50.0%,1h
19156,1,很酷不想说话,2444,134,3,5,8,37.5%,32m
19156,1,东北狗王狂人郑,2444,0,1,0,1,100.0%,1h
19156,1,[卐二五仔]三生,2444,0,1,0,1,100.0%,54m
19156,3,[列克星顿]overlord,2444,0,1,2,3,33.3%,12m
19156,1,长廊,2444,0,1,2,3,33.3%,1h
19156,1,[艾尔]spiritlaser,2444,0,1,4,5,20.0%,1h
19156,1,苹果的恩赐,2444,0,0,1,1,0.0%,1h
19156,3,哦啊拉拉,2444,0,0,2,2,0.0%,1h
19182,3,IIIIIIIIIIII,2443,858,152,146,298,51.0%,17m
19182,2,深渊,2443,1205,54,52,106,50.9%,30m
19182,3,雪狼,2443,628,39,40,79,49.4%,1h
19182,3,环球黑米,2443,413,30,27,57,52.6%,1h
19182,2,枫歪歪,2443,568,19,25,44,43.2%,1h
19182,3,superBB,2443,414,16,12,28,57.1%,1h
19182,3,大海的对面是敌人,2443,306,15,12,27,55.6%,25m
19182,1,走火的小鸟枪,2443,308,9,12,21,42.9%,1h
19182,3,灵活的胖子,2443,185,6,6,12,50.0%,1h
19182,1,Misaka,2443,215,6,6,12,50.0%,1h
19182,2,死亡,2443,190,6,7,13,46.2%,7m
19182,1,乌鸦坐飞机,2443,192,5,2,7,71.4%,56m
19182,1,兰戈,2443,190,4,6,10,40.0%,1h
19182,1,BABYMETAL,2443,96,4,7,11,36.4%,17m
19182,1,[easyPC]木叶苍狼猛兽,2443,120,3,2,5,60.0%,6m
19182,1,[ToHo]asaa,2443,0,1,0,1,100.0%,3m
19182,2,鲲鹏万里,2443,0,1,0,1,100.0%,20m
19182,1,[6G芯片研發]开罗宣言,2443,0,1,1,2,50.0%,44m
19182,3,wdnmd,2443,0,1,1,2,50.0%,1h
19182,3,大圣贝尔,2443,30,1,4,5,20.0%,33m
19182,1,wwwasuscom,2443,0,1,4,5,20.0%,45m
19182,1,拾柒丨北城不夏,2443,0,0,1,1,0.0%,1h
19182,3,观铃的领带,2443,0,0,2,2,0.0%,1h
19182,3,sgu,2443,0,0,4,4,0.0%,1h
19206,3,溜溜球,2442,1493,70,64,134,52.2%,36m
19206,1,sasaas,2442,1380,55,44,99,55.6%,1h
19206,1,Demon,2442,435,16,15,31,51.6%,1h
19206,2,[ma个鸡泰伦]Shaw,2442,311,11,10,21,52.4%,13m
19206,1,Savior,2442,322,10,1,11,90.9%,1h
19206,1,zzl,2442,322,9,10,19,47.4%,18m
19206,2,Cage,2442,258,8,14,22,36.4%,1h
19206,1,lntianxiunl,2442,260,7,2,9,77.8%,25m
19206,1,鸡排饭加个蛋,2442,228,7,3,10,70.0%,17m
19206,1,油炸土豆泥,2442,188,7,17,24,29.2%,1h
19206,1,Ceefang,2442,194,5,4,9,55.6%,1h
19206,2,小泥鳅硬邦邦,2442,140,5,5,10,50.0%,1h
19206,3,[阿瓦隆之斩]星际蔡旭坤,2442,97,2,2,4,50.0%,60m
19206,1,时光新月,2442,0,2,3,5,40.0%,1h
19206,2,昊穹,2442,123,2,3,5,40.0%,9m
19206,1,Jack,2442,96,2,4,6,33.3%,1h
19206,1,XANA,2442,0,1,1,2,50.0%,1h
19206,1,卡比兽的蛋,2442,48,1,4,5,20.0%,4m
19206,1,efew,2442,0,1,4,5,20.0%,1h
19206,1,zjy,2442,0,0,1,1,0.0%,1h
19206,3,金抽抽抽爷,2442,0,0,3,3,0.0%,1h
19227,1,农夫,2441,1386,536,537,1073,50.0%,15m
19227,2,[麻酱罐]未完木偶,2441,1570,96,93,189,50.8%,20m
19227,3,Fury,2441,1345,85,90,175,48.6%,2m
19227,3,salazals,2441,889,76,63,139,54.7%,30m
19227,3,叶落尘凡,2441,316,31,33,64,48.4%,1h
19227,3,Null,2441,305,26,25,51,51.0%,21m
19227,3,joker,2441,321,18,17,35,51.4%,27m
19227,3,Hermit,2441,440,17,22,39,43.6%,41m
19227,3,[小仙女已上线]Garfield,2441,388,16,9,25,64.0%,1h
19227,2,LOS,2441,324,14,17,31,45.2%,1h
19227,3,菜得抠脚,2441,338,14,21,35,40.0%,30m
19227,1,Live,2441,326,9,2,11,81.8%,26m
19227,3,[沙星部]sanzy,2441,222,9,5,14,64.3%,25m
19227,2,德国国防军,2441,248,9,15,24,37.5%,17m
19227,3,bunnyMoXuan,2441,150,5,12,17,29.4%,1h
19227,1,van,2441,118,4,2,6,66.7%,47m
19227,1,飞靔,2441,0,3,3,6,50.0%,1h
19227,1,coldzera,2441,145,3,6,9,33.3%,1h
19227,1,[ljk3]蝉颜,2441,44,2,0,2,100.0%,49m
19227,1,[幻想温柔乡]小女不才,2441,97,2,5,7,28.6%,1h
19227,1,左眼皮老跳,2441,96,1,1,2,50.0%,1h
19227,1,[崔之公司超市]崔之,2441,0,0,1,1,0.0%,3m
19249,1,晓不德,2440,920,28,32,60,46.7%,1h
19249,1,GoguoBor,2440,492,14,16,30,46.7%,60m
19249,3,[黑粉头子]刘真,2440,279,10,5,15,66.7%,1h
19249,1,[龙之逆鳞]冥界皇太子,2440,332,10,7,17,58.8%,25m
19249,3,蛙哥,2440,216,9,6,15,60.0%,1h
19249,3,手拿菜刀向天笑,2440,267,9,10,19,47.4%,18m
19249,2,淦啊,2440,234,6,9,15,40.0%,1h
19249,2,[混元形意星际]JIANG,2440,122,5,13,18,27.8%,59m
19249,1,[你爹重回战场]RavenIeren,2440,168,4,3,7,57.1%,1h
19249,1,来自火星的男人,2440,42,2,0,2,100.0%,1h
19249,1,究极抗韩,2440,0,2,3,5,40.0%,1h
19249,3,和平,2440,30,2,5,7,28.6%,48m
19249,3,羁绊,2440,0,2,5,7,28.6%,10m
19249,3,[avg神社]焰色拥抱,2440,0,1,3,4,25.0%,32m
19249,1,天仙配,2440,0,0,1,1,0.0%,1h
19249,3,我要攻击之爪,2440,0,0,1,1,0.0%,1h
19249,1,梦醒时分醉清晨,2440,0,0,1,1,0.0%,32m
19249,3,季落尘,2440,0,0,1,1,0.0%,46m
19249,1,听风,2440,0,0,2,2,0.0%,1h
19268,1,Clannad,2439,893,31,27,58,53.4%,14m
19268,3,天空,2439,316,16,20,36,44.4%,33m
19268,3,protoss,2439,397,14,13,27,51.9%,59m
19268,3,阴阳剪刀,2439,186,7,7,14,50.0%,1h
19268,1,菜逼,2439,145,5,6,11,45.5%,1h
19268,2,min,2439,128,3,2,5,60.0%,1h
19268,3,moon,2439,151,3,3,6,50.0%,24m
19268,1,iNaive,2439,86,2,2,4,50.0%,1h
19268,3,DID,2439,0,2,4,6,33.3%,36m
19268,3,依伶听风,2439,95,1,3,4,25.0%,1h
19268,1,红尘有你,2439,0,1,4,5,20.0%,1h
19268,3,大马马,2439,0,0,3,3,0.0%,31m
19268,3,某科学的超电磁炮,2439,0,0,4,4,0.0%,7m
19281,2,tian,2438,1609,241,249,490,49.2%,20m
19281,1,感觉完美,2438,1580,66,75,141,46.8%,1h
19281,3,帅哥,2438,1077,41,49,90,45.6%,1m
19281,3,XXD,2438,350,31,33,64,48.4%,1h
19281,1,聪少,2438,954,29,24,53,54.7%,1h
19281,3,[XYG]无敌小鸡仔,2438,750,28,29,57,49.1%,48m
19281,1,芝麻通鉴,2438,645,23,23,46,50.0%,35m
19281,2,大地图,2438,315,13,9,22,59.1%,1h
19281,3,hhtiancai,2438,196,10,9,19,52.6%,1h
19281,1,神月沉默,2438,295,10,14,24,41.7%,49m
19281,1,小疯子哥哥,2438,312,8,8,16,50.0%,3m
19281,1,manman,2438,318,8,9,17,47.1%,14m
19281,1,llllllllllll,2438,124,4,2,6,66.7%,25m
19281,3,六月的雪,2438,129,4,7,11,36.4%,5m
19281,1,[钢铁远征军]Falsec,2438,0,1,0,1,100.0%,1h
19281,2,土豆巨像,2438,0,1,0,1,100.0%,48m
19281,1,灵灵柒,2438,0,1,0,1,100.0%,1h
19281,2,卡尔萨斯,2438,88,1,1,2,50.0%,1h
19281,1,[鲁德欢]梁凉,2438,0,1,1,2,50.0%,1h
19281,1,灬伊藤亚希子,2438,0,1,4,5,20.0%,1h
19281,3,高富帅,2438,30,1,6,7,14.3%,21m
19281,1,[SA破晓]FansticLIN,2438,0,0,1,1,0.0%,35m
19281,1,deep,2438,0,0,1,1,0.0%,1h
19281,1,BigFish,2438,0,0,1,1,0.0%,33m
19305,3,杰基洛夫,2437,410,55,50,105,52.4%,1h
19305,1,坑货死远,2437,427,11,7,18,61.1%,3m
19305,3,juruoKkvoid,2437,120,8,8,16,50.0%,5m
19305,1,[深邃黑色幻想]刹那又何必永恒,2437,225,7,13,20,35.0%,18m
19305,2,[皇族]北京迷瞳,2437,0,3,6,9,33.3%,1h
19305,3,Sunshine,2437,97,3,6,9,33.3%,47m
19305,1,[东京小泽玛利]孙马茹,2437,48,2,0,2,100.0%,29m
19305,1,曾经来过,2437,42,2,1,3,66.7%,53m
19305,2,Shawn,2437,0,0,1,1,0.0%,32m
19305,1,[旋风游骑兵]克己,2437,0,0,2,2,0.0%,55m
19305,1,柒涕,2437,0,0,2,2,0.0%,52m
19305,2,[菜有菜的道理]叶修,2437,0,0,3,3,0.0%,1h
19305,3,烂崽联盟,2437,0,0,3,3,0.0%,52m
19318,2,skywalker,2436,885,35,37,72,48.6%,19m
19318,3,darkkotori,2436,425,17,21,38,44.7%,1h
19318,3,王者归来,2436,423,15,13,28,53.6%,41m
19318,1,Chen,2436,480,14,16,30,46.7%,1h
19318,1,无敌的我,2436,399,13,14,27,48.1%,1h
19318,1,任飞,2436,129,7,9,16,43.8%,52m
19318,3,寒酸,2436,215,6,9,15,40.0%,1h
19318,2,[HK丶S]最终鸟倦归林,2436,193,5,4,9,55.6%,53m
19318,2,[Mentor]队友呢快救我,2436,190,5,8,13,38.5%,53m
19318,1,吉良吉影,2436,126,4,4,8,50.0%,32m
19318,1,Blue,2436,96,4,7,11,36.4%,1h
19318,3,[萨尔那加之刃]我不玩炮台,2436,112,3,3,6,50.0%,1h
19318,3,烟雨,2436,60,3,5,8,37.5%,1h
19318,1,[东十字军]Miraitowa,2436,96,2,3,5,40.0%,55m
19318,1,zero,2436,109,2,3,5,40.0%,14m
19318,1,zero,2436,0,2,4,6,33.3%,1h
19318,3,flybug,2436,60,2,6,8,25.0%,1h
19318,1,缓解脑力,2436,0,1,0,1,100.0%,1h
19318,1,[世界大战]方玲霞,2436,44,1,2,3,33.3%,1h
19318,1,雪兔子,2436,42,1,4,5,20.0%,6m
19318,1,不知道,2436,0,0,1,1,0.0%,1h
19339,2,我叫李俊英,2435,1574,61,65,126,48.4%,21m
19339,1,杀怪,2435,915,49,54,103,47.6%,12m
19339,3,[瓜果蔬菜]小麦,2435,288,19,12,31,61.3%,11m
19339,1,[黑暗在翻騰]MISSxiaodi,2435,468,16,15,31,51.6%,25m
19339,3,songxia,2435,324,15,12,27,55.6%,1h
19339,1,[XJTU]ATMShfeng,2435,349,14,24,38,36.8%,51m
19339,1,Bewaffnete,2435,266,11,14,25,44.0%,47m
19339,3,Whiss,2435,154,9,8,17,52.9%,21m
19339,2,黄铀猫,2435,168,3,7,10,30.0%,1h
19339,1,[Shiru]轩音无,2435,84,2,4,6,33.3%,1h
19339,1,十二字思修真言,2435,0,1,0,1,100.0%,1h
19339,1,青衫亿笙,2435,44,1,1,2,50.0%,1h
19339,1,[谁在呼叫舰队]LEO,2435,0,0,1,1,0.0%,24m
19339,1,塞巴多拉贡,2435,0,0,2,2,0.0%,33m
19339,2,[哀伤]ArdynSama,2435,0,0,5,5,0.0%,48m
19354,3,长桥猎人,2434,1143,77,74,151,51.0%,1h
19354,3,海星,2434,855,58,60,118,49.2%,1h
19354,1,[SME]一朵忧郁的王子,2434,1143,38,41,79,48.1%,1h
19354,3,[天棋阁]我的剑早已放不下,2434,415,19,12,31,61.3%,1h
19354,1,白虎杰米杨,2434,531,18,8,26,69.2%,41m
19354,1,那夜床踏了,2434,451,16,16,32,50.0%,1h
19354,2,YxlCl,2434,320,12,10,22,54.5%,1h
19354,3,异虫,2434,350,12,15,27,44.4%,1h
19354,1,岗壁羊,2434,202,6,3,9,66.7%,1h
19354,1,[暴雪我是你爹]咖咖咖咖咖咖咖啡,2434,200,6,6,12,50.0%,24m
19354,3,kirito,2434,153,5,3,8,62.5%,3m
19354,1,闻醉山清风,2434,146,4,3,7,57.1%,24m
19354,3,[幻嘤旅团]镰仓战神,2434,115,3,2,5,60.0%,52m
19354,1,[CPT]泰晤斯古梅特,2434,0,3,2,5,60.0%,58m
19354,1,公子丿扶苏,2434,48,3,6,9,33.3%,1h
19354,1,AsadKing,2434,44,2,2,4,50.0%,1h
19354,1,再追老子宰了你丶,2434,0,0,1,1,0.0%,1h
19354,1,寒冰,2434,0,0,2,2,0.0%,45m
19372,1,kelly,2433,1040,38,30,68,55.9%,6m
19372,1,[疯狗倒车小组]water,2433,754,25,23,48,52.1%,1h
19372,3,从不言败,2433,520,17,26,43,39.5%,1h
19372,3,SCALE,2433,250,14,19,33,42.4%,1h
19372,1,东鹏特饮一元畅享,2433,366,9,4,13,69.2%,14m
19372,1,DFKGMKLERNGL,2433,324,9,10,19,47.4%,57m
19372,1,TiMe,2433,196,7,6,13,53.8%,1h
19372,3,iiiiiiiiii,2433,184,6,7,13,46.2%,1h
19372,3,离隹,2433,196,5,8,13,38.5%,1h
19372,1,[鹌鹑带星]TheMuseFJRLH,2433,0,3,4,7,42.9%,1h
19372,2,白狼,2433,0,1,2,3,33.3%,44m
19383,2,[达拉姆督察]Accelerator,2432,1585,259,273,532,48.7%,1h
19383,2,耍耍,2432,1542,242,245,487,49.7%,5m
19383,3,萌男零零壹,2432,1237,76,78,154,49.4%,55m
19383,3,大佬请教我玩星际,2432,574,55,50,105,52.4%,18m
19383,1,XIUXX,2432,597,21,19,40,52.5%,26m
19383,3,[主教的好兄弟]森森超可爱,2432,161,13,10,23,56.5%,1h
19383,2,无情的白给机器,2432,277,9,12,21,42.9%,53m
19383,3,鬼灰,2432,242,8,10,18,44.4%,1h
19383,3,地二,2432,126,7,11,18,38.9%,34m
19383,2,ath,2432,180,5,6,11,45.5%,1h
19383,3,彭城祝公子,2432,157,4,4,8,50.0%,1h
19383,1,不死之人,2432,84,3,2,5,60.0%,60m
19383,3,小东方不败,2432,97,3,5,8,37.5%,1h
19383,2,诡行,2432,0,3,6,9,33.3%,23m
19383,1,[以后]Shmily,2432,0,1,0,1,100.0%,1h
19383,1,[星核战队]天道,2432,0,1,2,3,33.3%,1h
19383,1,为了艾尔,2432,0,0,1,1,0.0%,1h
19383,3,暗影之龙,2432,0,0,1,1,0.0%,7m
19383,1,绚濑绘里,2432,0,0,1,1,0.0%,46m
19383,3,[榜一007]wcwe,2432,0,0,3,3,0.0%,5m
19403,2,人狠话不多,2431,1567,263,256,519,50.7%,1h
19403,2,浮生若梦,2431,1501,81,64,145,55.9%,1h
19403,3,[贰伍仔集中营]多读读书,2431,1287,68,68,136,50.0%,1h
19403,2,哈雷克火葬之魔咒,2431,385,46,42,88,52.3%,1h
19403,1,大种马,2431,433,16,20,36,44.4%,3m
19403,2,[丨F2A丨]捣蛋亲王,2431,291,13,10,23,56.5%,29m
19403,1,艾尔难民头子,2431,330,11,14,25,44.0%,4m
19403,3,BiliLake,2431,192,8,9,17,47.1%,2m
19403,2,陆战队员没子弹,2431,62,8,15,23,34.8%,13m
19403,1,[蒸汽姬海老名]时间神玩,2431,234,7,6,13,53.8%,32m
19403,1,[月见]项羽,2431,182,7,6,13,53.8%,1h
19403,1,最弱二五仔,2431,42,5,3,8,62.5%,41m
19403,2,我的女孩,2431,156,5,13,18,27.8%,1h
19403,3,pbisharp,2431,94,4,6,10,40.0%,1h
19403,1,[暴打假萌新]lovef,2431,84,3,1,4,75.0%,25m
19403,2,可莉丿逃跑太阳乀,2431,0,3,2,5,60.0%,55m
19403,1,这些天,2431,0,2,1,3,66.7%,24m
19403,1,[秋毫]谪仙,2431,86,2,5,7,28.6%,49m
19403,3,二手女人回收地,2431,0,2,6,8,25.0%,1h
19403,2,暗神梦魇,2431,0,1,0,1,100.0%,1h
19403,1,[菜鸡球带]未见天的小黄瓜,2431,0,1,0,1,100.0%,1h
19403,1,TDrzu,2431,97,1,3,4,25.0%,59m
19403,2,PtP,2431,0,1,4,5,20.0%,44m
19403,2,[为了我爱的人]Barbie,2431,0,0,1,1,0.0%,1h
19427,1,Skywalker,2430,1454,100,94,194,51.5%,29m
19427,3,[TAPC]TITANS,2430,1287,78,56,134,58.2%,1h
19427,3,语录,2430,938,38,36,74,51.4%,12m
19427,3,丨丨丨,2430,864,36,33,69,52.2%,36m
19427,2,mmp,2430,509,23,46,69,33.3%,1h
19427,2,小王子皓皓,2430,652,22,35,57,38.6%,40m
19427,1,无敌人类,2430,516,15,15,30,50.0%,50m
19427,3,rakugo,2430,256,10,11,21,47.6%,1h
19427,2,超科学之魂,2430,318,10,13,23,43.5%,1h
19427,2,[迷宫丨极限组]candy,2430,214,8,10,18,44.4%,1h
19427,3,Rivers,2430,115,7,6,13,53.8%,25m
19427,3,Joka,2430,194,7,7,14,50.0%,10m
19427,1,[四叶草]他可是孙哥啊,2430,173,6,0,6,100.0%,32m
19427,1,rabbitguye,2430,97,6,1,7,85.7%,55m
19427,1,HFC,2430,96,4,7,11,36.4%,29m
19427,2,[老玩家]acas,2430,44,4,8,12,33.3%,1h
19427,1,[拯救凯瑞甘]灵之龙玄,2430,0,1,0,1,100.0%,56m
19427,1,暮色,2430,0,1,1,2,50.0%,1h
19427,1,Ping,2430,42,1,2,3,33.3%,42m
19427,2,拔刀能留住落樱吗,2430,0,1,4,5,20.0%,1h
19427,1,xbd,2430,0,0,1,1,0.0%,32m
19427,2,[北京大学鸡协]Unterseeboot,2430,0,0,1,1,0.0%,1h
19427,1,墨栀,2430,0,0,1,1,0.0%,4m
19427,1,帝神,2430,0,0,2,2,0.0%,1h
19427,3,fair,2430,0,0,2,2,0.0%,1h
19452,3,誓言,2429,1429,60,52,112,53.6%,1h
19452,1,良先生,2429,1144,48,41,89,53.9%,1h
19452,1,DEWAY,2429,1136,37,42,79,46.8%,1h
19452,3,ATMHERO,2429,795,29,32,61,47.5%,1h
19452,1,never,2429,904,28,26,54,51.9%,26m
19452,1,[温柔兔公主]llllllllllll,2429,910,28,29,57,49.1%,49m
19452,2,大哥别打我,2429,679,25,32,57,43.9%,5m
19452,2,吃了没文化的亏,2429,509,24,27,51,47.1%,1h
19452,3,[萝莉之芯]雨燕,2429,459,20,16,36,55.6%,43m
19452,1,一口毒奶,2429,215,8,4,12,66.7%,17m
19452,1,killeverbody,2429,134,6,4,10,60.0%,24m
19452,1,dqweqwew,2429,96,6,5,11,54.5%,17m
19452,1,吃素的蚊子,2429,0,4,1,5,80.0%,24m
19452,3,Denny,2429,171,4,6,10,40.0%,1h
19452,3,TitanLu,2429,122,4,7,11,36.4%,1h
19452,2,IlIlIlIlll,2429,133,4,8,12,33.3%,1h
19452,1,ATD,2429,88,2,4,6,33.3%,1h
19452,3,[CNboys]小马不过桥,2429,0,1,1,2,50.0%,47m
19452,1,[DMR]冬小梦,2429,42,1,1,2,50.0%,48m
19452,1,大懒猫,2429,42,1,2,3,33.3%,1h
19452,1,心之源,2429,0,0,1,1,0.0%,56m
19452,3,康康,2429,0,0,2,2,0.0%,56m
19452,1,[神乐nana]Reading,2429,0,0,3,3,0.0%,3m
19475,3,aaaaee,2428,1551,62,62,124,50.0%,43m
19475,3,零下,2428,1251,57,46,103,55.3%,1h
19475,1,月色有山河,2428,1334,54,44,98,55.1%,1h
19475,3,三十七摄氏度,2428,641,26,30,56,46.4%,1h
19475,2,龍子嘲風,2428,349,14,13,27,51.9%,43m
19475,2,小迪迪,2428,145,4,2,6,66.7%,1h
19475,1,ahhhhhhh,2428,171,3,6,9,33.3%,31m
19475,1,甫甫甫,2428,44,2,1,3,66.7%,1h
19475,2,绝缘体,2428,0,2,3,5,40.0%,6m
19475,1,[一起犯罪]强盗,2428,132,2,6,8,25.0%,18m
19475,1,RuckyJC,2428,0,1,2,3,33.3%,1h
19475,1,专业菜鸟,2428,48,1,3,4,25.0%,4m
19475,1,矿就是一切,2428,46,1,3,4,25.0%,1h
19475,2,keeper,2428,0,1,4,5,20.0%,43m
19475,1,大帥,2428,46,1,9,10,10.0%,21m
19475,1,[红色锤镰]sama,2428,0,0,1,1,0.0%,1h
19475,1,wwww,2428,0,0,1,1,0.0%,41m
19492,3,CrossEvery,2427,1465,115,118,233,49.4%,48m
19492,3,潵馓馓鏾,2427,788,39,35,74,52.7%,2m
19492,1,future,2427,705,28,21,49,57.1%,1h
19492,3,[通灵女孩]絕歌,2427,317,18,8,26,69.2%,1h
19492,1,燮羽羽,2427,547,18,20,38,47.4%,45m
19492,1,[吕布女团]穿着短裤去养生,2427,297,10,14,24,41.7%,1h
19492,1,wad,2427,294,8,9,17,47.1%,59m
19492,1,liudon,2427,233,7,3,10,70.0%,24m
19492,1,年老老主宰,2427,254,7,8,15,46.7%,20m
19492,3,陌欢,2427,178,6,11,17,35.3%,1h
19492,1,刀之梦,2427,210,5,5,10,50.0%,1h
19492,1,舞王蔡徐坤,2427,241,5,8,13,38.5%,1h
19492,1,Layers,2427,84,4,3,7,57.1%,17m
19492,2,Misiz,2427,136,3,2,5,60.0%,41m
19492,1,全王,2427,86,3,4,7,42.9%,4m
19492,3,航海小能手,2427,97,3,4,7,42.9%,1h
19492,1,初阳的猫,2427,42,2,0,2,100.0%,48m
19492,1,国宝食铁兽,2427,82,2,2,4,50.0%,1h
19492,1,最爱佩琪,2427,80,2,2,4,50.0%,1h
19492,1,[你渴望力量吗]反转宇宙,2427,0,2,5,7,28.6%,1h
19492,1,[撸你小管管]Zachary,2427,0,1,0,1,100.0%,4m
19492,2,aekai,2427,0,1,4,5,20.0%,1h
19492,2,TedKKK,2427,30,1,9,10,10.0%,29m
19492,1,刻薄的守卫者,2427,0,0,1,1,0.0%,18m
19492,2,llllllllllll,2427,0,0,5,5,0.0%,1h
19517,3,余大人,2426,1571,195,206,401,48.6%,11m
19517,3,爱茹,2426,1165,46,48,94,48.9%,1h
19517,3,BLACK,2426,840,32,33,65,49.2%,1h
19517,1,[一块晶化瓦斯]IIIIIIIIIIII,2426,894,29,23,52,55.8%,1h
19517,3,黑色的神秘,2426,569,26,14,40,65.0%,1h
19517,3,halo,2426,375,25,30,55,45.5%,1h
19517,1,恨繁霜鬓,2426,548,16,13,29,55.2%,1h
19517,3,尘辉,2426,264,8,10,18,44.4%,9m
19517,1,故国有明,2426,276,7,8,15,46.7%,32m
19517,3,星空残想,2426,238,7,8,15,46.7%,1h
19517,1,IIIIIIIIIIII,2426,266,7,8,15,46.7%,1h
19517,1,TeRiRi,2426,239,5,8,13,38.5%,46m
19517,3,建筑老师陈宏,2426,34,3,7,10,30.0%,24m
19517,1,[sssb]白岩景天,2426,0,2,4,6,33.3%,1h
19517,3,陆战队员,2426,30,2,5,7,28.6%,9m
19517,3,哥是星际,2426,62,2,5,7,28.6%,26m
19517,1,jytjtyutjtyy,2426,0,1,0,1,100.0%,56m
19517,3,[SS闪击]Dream,2426,97,1,3,4,25.0%,1h
19517,2,二五仔,2426,0,1,4,5,20.0%,44m
19517,2,酥从代炎静,2426,0,1,4,5,20.0%,18m
19517,1,炎帝化冥幻化神明,2426,0,0,1,1,0.0%,1h
19517,1,[尤摩扬护国队]Alarak,2426,0,0,1,1,0.0%,1h
19517,1,Immortanbird,2426,0,0,2,2,0.0%,6m
19517,1,[荒芜岁月]RUBY,2426,0,0,5,5,0.0%,1h
19541,3,NAPOLIYELLOW,2425,1365,68,63,131,51.9%,9m
19541,2,VDYANG,2425,527,32,36,68,47.1%,1h
19541,1,Adele,2425,589,19,10,29,65.5%,6m
19541,1,第五种力,2425,322,15,11,26,57.7%,18m
19541,3,Microwing,2425,124,8,8,16,50.0%,35m
19541,3,趴下别动,2425,220,8,10,18,44.4%,49m
19541,3,Jankiin,2425,192,6,6,12,50.0%,1h
19541,3,我得重新集结部队,2425,148,6,7,13,46.2%,1h
19541,2,血之冲突,2425,285,6,13,19,31.6%,20m
19541,3,好说话,2425,100,5,9,14,35.7%,3m
19541,1,欧西给之神,2425,158,4,2,6,66.7%,42m
19541,3,Timsless,2425,0,1,0,1,100.0%,49m
19541,1,[M8]叶问,2425,0,1,1,2,50.0%,1h
19541,2,陈雁松,2425,0,1,4,5,20.0%,34m
19541,2,零小度,2425,0,0,1,1,0.0%,7m
19541,2,空山竹语,2425,0,0,3,3,0.0%,56m
19557,3,Rockfeller,2424,1485,99,100,199,49.7%,21m
19557,3,[社交学大可爱]伊卡洛斯,2424,585,35,31,66,53.0%,1h
19557,2,wyskie,2424,758,26,35,61,42.6%,1h
19557,1,洛小雨,2424,734,24,21,45,53.3%,26m
19557,1,[四月一日]君寻,2424,216,6,2,8,75.0%,32m
19557,1,[浪啊浪]仁义无双野人王,2424,204,6,5,11,54.5%,54m
19557,2,想想蕉蕉会怎么做,2424,219,6,11,17,35.3%,39m
19557,1,健忘的鱼,2424,192,5,6,11,45.5%,1h
19557,3,跳虫速攻,2424,0,4,5,9,44.4%,1h
19557,3,[对面四秒射]樱岛麻衣,2424,120,4,6,10,40.0%,7m
19557,3,[自创]yka,2424,119,3,4,7,42.9%,1h
19557,1,暗夜骑士,2424,145,3,5,8,37.5%,1h
19557,1,注意碰组,2424,0,2,5,7,28.6%,1h
19557,1,[KK开]Kaishek,2424,0,1,0,1,100.0%,48m
19557,1,氖酆,2424,0,1,2,3,33.3%,1h
19557,1,[小埋]阿曼达,2424,0,0,1,1,0.0%,1h
19557,2,[馬家溝]宇宙霸主,2424,0,0,2,2,0.0%,1h
19574,3,[入手萌新]下手轻点我很菜,2423,948,43,43,86,50.0%,1h
19574,1,sdsd,2423,682,21,18,39,53.8%,4m
19574,1,[傲世丨听雨轩]Magicglory,2423,419,15,16,31,48.4%,1h
19574,3,梅卡德尔,2423,341,14,19,33,42.4%,9m
19574,1,淤白,2423,413,13,5,18,72.2%,21m
19574,1,ReoLFor,2423,259,6,5,11,54.5%,29m
19574,1,丷来自星星的你丷,2423,48,4,5,9,44.4%,1h
19574,1,ChinaWz,2423,84,3,1,4,75.0%,18m
19574,1,[艾蒙是弟弟]冰封,2423,132,3,1,4,75.0%,4m
19574,1,为爱见证,2423,48,3,6,9,33.3%,1h
19574,1,高丽老,2423,97,2,0,2,100.0%,1h
19574,1,饭团子,2423,84,2,1,3,66.7%,1h
19574,3,银狼王,2423,97,2,1,3,66.7%,47m
19574,1,[哔哩哔哩图奇]zero,2423,0,1,0,1,100.0%,42m
19574,2,灰爷,2423,0,1,4,5,20.0%,1h
19574,2,哇哇哇,2423,0,1,4,5,20.0%,18m
19574,1,樱九,2423,0,0,1,1,0.0%,54m
19574,3,零神,2423,0,0,2,2,0.0%,45m
19574,3,对你动心是原罪,2423,0,0,2,2,0.0%,1h
19574,3,老千层饼,2423,0,0,3,3,0.0%,31m
19594,1,PartinG,2422,1812,89,90,179,49.7%,48m
19594,1,一条命,2422,365,12,5,17,70.6%,1h
19594,1,弃疗型熊猫,2422,118,4,4,8,50.0%,1h
19594,1,tobu,2422,140,4,5,9,44.4%,1h
19594,3,JustICE,2422,171,4,6,10,40.0%,1h
19594,3,[Killyo]优秀势力,2422,123,3,4,7,42.9%,7m
19594,1,星辰闪耀,2422,97,3,7,10,30.0%,1h
19594,1,TiTan,2422,86,2,1,3,66.7%,6m
19594,3,[我是安娜哟]无当飞将,2422,60,2,3,5,40.0%,32m
19594,1,拔刀只为落樱,2422,80,2,5,7,28.6%,48m
19594,1,Roselia,2422,0,1,0,1,100.0%,1h
19594,1,氵戈笑丶丨孤寂,2422,0,1,0,1,100.0%,52m
19594,1,FYlike,2422,40,1,3,4,25.0%,16m
19594,2,走为上策的父亲,2422,0,1,4,5,20.0%,1h
19608,3,可哥可妻孙一峰,2421,767,31,27,58,53.4%,59m
19608,1,WINGG,2421,606,27,21,48,56.2%,1h
19608,3,[KSR]Rssss,2421,523,20,21,41,48.8%,1h
19608,1,[永恒之环]惊鸿,2421,341,12,13,25,48.0%,1h
19608,3,爱鬼混,2421,158,5,12,17,29.4%,54m
19608,1,[我是一只机]Chaos,2421,150,4,4,8,50.0%,49m
19608,1,[DSE]浪里小白糖,2421,72,3,3,6,50.0%,18m
19608,1,[战争武器]sky,2421,128,3,5,8,37.5%,48m
19608,1,[社交学学者]Foxpattern,2421,40,2,1,3,66.7%,18m
19608,3,时空,2421,0,2,5,7,28.6%,52m
19608,1,爱你吗卖麻花情,2421,0,1,0,1,100.0%,1h
19608,1,有种轰趴我,2421,0,1,0,1,100.0%,18m
19608,1,[QWQa]小雏菊,2421,0,1,0,1,100.0%,17m
19608,1,[天地一剑]不得不涩,2421,42,1,2,3,33.3%,1h
19608,2,星空霸主,2421,0,1,3,4,25.0%,34m
19608,2,ziluojs,2421,34,1,4,5,20.0%,20m
19608,2,雷鸟,2421,0,1,4,5,20.0%,1h
19608,2,hiddentroll,2421,0,1,4,5,20.0%,43m
19608,2,小超,2421,0,1,8,9,11.1%,9m
19627,3,剑灭苍穹,2420,1198,53,46,99,53.5%,36m
19627,3,水墨丹青,2420,1070,44,38,82,53.7%,1h
19627,3,养乐多,2420,770,31,33,64,48.4%,1h
19627,3,幸运之翼,2420,120,27,28,55,49.1%,1h
19627,1,香蕉面,2420,670,20,18,38,52.6%,14m
19627,3,[一群谐星]星际漫游者,2420,458,18,24,42,42.9%,25m
19627,3,[SUPSC]sadiest,2420,425,17,14,31,54.8%,1h
19627,1,Febiabiabia,2420,481,16,9,25,64.0%,1h
19627,1,换名找不到,2420,486,14,12,26,53.8%,1h
19627,1,pen,2420,228,6,4,10,60.0%,1h
19627,1,funeral,2420,179,5,2,7,71.4%,59m
19627,1,我是鸡,2420,160,5,3,8,62.5%,49m
19627,1,[最强战神]阿巴阿巴,2420,145,5,4,9,55.6%,1h
19627,1,[miku守护]打到铥,2420,162,5,5,10,50.0%,18m
19627,3,passerby,2420,94,4,5,9,44.4%,1h
19627,2,[鬓已星星也]Rffu,2420,159,4,8,12,33.3%,1h
19627,2,SWEG,2420,0,3,0,3,100.0%,1h
19627,1,双马尾大叔,2420,76,2,1,3,66.7%,1h
19627,3,[gusl]SCPGASTER,2420,122,2,2,4,50.0%,49m
19627,1,赏金猎手,2420,121,2,6,8,25.0%,1h
19627,1,从来没有放弃,2420,0,1,1,2,50.0%,1h
19627,1,[我们要娶老婆]暗鸦,2420,42,1,3,4,25.0%,31m
19627,2,chaos,2420,0,0,1,1,0.0%,6m
19627,1,奥澳嗷力给,2420,0,0,2,2,0.0%,53m
19651,3,[菜有菜的道理]星际杀手,2419,911,90,80,170,52.9%,1h
19651,1,卡尔达利斯,2419,548,17,15,32,53.1%,1h
19651,1,[敢犯我河南者]kamijo,2419,334,13,8,21,61.9%,20m
19651,1,Eternal,2419,272,7,8,15,46.7%,6m
19651,3,Napoooleon,2419,157,5,8,13,38.5%,10m
19651,3,小雨晨曦丶,2419,140,5,10,15,33.3%,56m
19651,1,金鱼花,2419,142,3,4,7,42.9%,1h
19651,3,霸气,2419,34,3,8,11,27.3%,1h
19651,2,chn,2419,0,2,7,9,22.2%,6m
19651,2,鲨掉东西,2419,0,1,1,2,50.0%,16m
19651,1,tassadar,2419,0,0,1,1,0.0%,50m
19651,3,Freya,2419,0,0,1,1,0.0%,1h
19663,3,一十柒,2418,1356,64,62,126,50.8%,48m
19663,1,会睡觉的超人,2418,734,58,48,106,54.7%,1h
19663,1,歪歪,2418,1046,36,27,63,57.1%,18m
19663,1,[斜星连萌]juno,2418,988,33,31,64,51.6%,14m
19663,3,Meng,2418,265,24,27,51,47.1%,20m
19663,2,腹肌除皱资深专家,2418,633,24,31,55,43.6%,29m
19663,3,jsrTBB,2418,447,16,18,34,47.1%,56m
19663,1,Cryingknight,2418,323,8,9,17,47.1%,1h
19663,1,[温柔兔公主]emiya,2418,207,8,14,22,36.4%,24m
19663,1,讨厌起名字,2418,236,6,1,7,85.7%,1h
19663,3,[艾尔必将停电]炖鱼,2418,144,3,1,4,75.0%,47m
19663,3,SDHFHAHSHF,2418,121,3,1,4,75.0%,47m
19663,1,UBeLieF,2418,80,2,2,4,50.0%,14m
19663,1,雾隐云山,2418,84,2,3,5,40.0%,1h
19663,1,杜渝成,2418,86,2,3,5,40.0%,24m
19663,2,你别皮老弟,2418,0,2,3,5,40.0%,1h
19663,1,yourppboom,2418,42,1,4,5,20.0%,1h
19663,1,这是一个菜鸟,2418,0,1,4,5,20.0%,1h
19663,2,梦岚,2418,0,1,4,5,20.0%,46m
19663,1,ORChailly,2418,0,0,2,2,0.0%,17m
19663,3,行者,2418,0,0,3,3,0.0%,1h
19684,1,Clown,2417,1428,50,46,96,52.1%,3m
19684,3,最好的疯疯,2417,763,35,37,72,48.6%,1h
19684,1,瑾丶凉,2417,758,27,20,47,57.4%,53m
19684,3,Eternity,2417,620,25,25,50,50.0%,7m
19684,1,十二月的肖邦,2417,373,15,12,27,55.6%,16m
19684,3,丶冰丨,2417,289,10,13,23,43.5%,1h
19684,3,cxz,2417,196,9,6,15,60.0%,59m
19684,2,Salvation,2417,252,9,12,21,42.9%,1h
19684,1,令狐巷雨,2417,294,8,8,16,50.0%,1h
19684,1,Air,2417,216,7,5,12,58.3%,1h
19684,1,哦豁,2417,84,6,5,11,54.5%,37m
19684,3,吻你胯下红唇,2417,231,6,11,17,35.3%,52m
19684,3,Riptide,2417,123,5,7,12,41.7%,17m
19684,1,月饼,2417,165,3,2,5,60.0%,37m
19684,2,[弃婴]明铭七,2417,0,3,4,7,42.9%,1h
19684,3,[低楽集团]Eta,2417,30,2,3,5,40.0%,1h
19684,2,Roseqm,2417,0,2,3,5,40.0%,58m
19684,3,[M80]赛罗奥特曼,2417,0,1,0,1,100.0%,52m
19684,1,不要堵门,2417,0,1,0,1,100.0%,1h
19684,1,离殇夜尽天明,2417,0,0,2,2,0.0%,49m
19684,1,[狼牙盟]Qgoodboy,2417,0,0,3,3,0.0%,1h
19705,3,[苏千]阿月,2416,1021,64,58,122,52.5%,21m
19705,1,[极限菜鸟]哈斯塔,2416,1386,57,45,102,55.9%,60m
19705,3,[破落的灵魂]画中梦生花,2416,766,32,30,62,51.6%,1h
19705,1,boki,2416,819,29,28,57,50.9%,1h
19705,1,超超超级菜鸡,2416,762,27,40,67,40.3%,56m
19705,1,MUSE,2416,461,25,15,40,62.5%,1h
19705,3,[旺旺战士]Light,2416,677,24,25,49,49.0%,41m
19705,1,小呱呱萌萌哒,2416,394,14,12,26,53.8%,33m
19705,2,SakuraMiko,2416,315,12,11,23,52.2%,2m
19705,1,潇洒封印,2416,166,5,17,22,22.7%,1h
19705,1,风清扬,2416,0,3,4,7,42.9%,21m
19705,3,你好我是猪,2416,125,2,3,5,40.0%,45m
19705,1,洛亚,2416,97,2,5,7,28.6%,1h
19705,1,你杰哥,2416,97,2,5,7,28.6%,17m
19705,3,多福多寿,2416,0,2,6,8,25.0%,1h
19705,1,[星际丶老男孩]星际狂热,2416,0,1,3,4,25.0%,1h
19705,1,一切化为焦土,2416,42,1,7,8,12.5%,25m
19705,1,[Onceme]云术,2416,0,0,1,1,0.0%,1h
19705,1,小伟,2416,0,0,2,2,0.0%,1h
19705,1,[坦克36D]MagicTeddy,2416,0,0,3,3,0.0%,31m
19725,3,Uchujin,2415,990,36,36,72,50.0%,1h
19725,1,驴毛,2415,862,27,24,51,52.9%,1h
19725,1,蛋卷儿,2415,495,16,13,29,55.2%,50m
19725,3,巴黎丶,2415,348,10,16,26,38.5%,1h
19725,1,[软柿子]kingzea,2415,262,9,5,14,64.3%,1h
19725,1,Hitsu,2415,232,7,5,12,58.3%,1h
19725,3,玄苍觞,2415,124,7,5,12,58.3%,31m
19725,3,胧村正,2415,100,5,9,14,35.7%,1h
19725,3,[科普卢拆迁办]一叶一菩提,2415,62,4,7,11,36.4%,1h
19725,1,Circuit,2415,39,2,3,5,40.0%,31m
19725,1,潜行之龟,2415,120,2,3,5,40.0%,6m
19725,1,太原孙一峰,2415,0,1,0,1,100.0%,4m
19725,1,云太白,2415,0,1,0,1,100.0%,42m
19725,2,[TOD死神]聚义城,2415,0,1,0,1,100.0%,7m
19725,3,[虚拟歌手团体]龙之传人,2415,0,1,1,2,50.0%,46m
19725,1,EASTMO,2415,46,1,5,6,16.7%,1h
19725,1,Kala,2415,0,0,2,2,0.0%,3m
19742,1,[TTZ]lddeck,2414,1245,116,119,235,49.4%,5m
19742,1,刘昱廷,2414,681,25,21,46,54.3%,48m
19742,1,SFM,2414,391,19,14,33,57.6%,41m
19742,1,一起走过的日子,2414,422,15,15,30,50.0%,1h
19742,1,DFBGDGD,2414,280,12,14,26,46.2%,26m
19742,1,lxw,2414,384,11,11,22,50.0%,1h
19742,1,小虎妖,2414,370,10,9,19,52.6%,52m
19742,1,克莱曼婷哥,2414,329,10,10,20,50.0%,1h
19742,3,霸气的胖胖喵喵,2414,307,10,12,22,45.5%,9m
19742,2,[南信大小萌新]跟我的影子打拳吧,2414,186,8,12,20,40.0%,1h
19742,3,neowait,2414,232,7,9,16,43.8%,1h
19742,3,Firebergs,2414,32,5,5,10,50.0%,49m
19742,1,Strawberry,2414,132,5,8,13,38.5%,1h
19742,3,wildwolf,2414,170,5,8,13,38.5%,1h
19742,3,[五月花]可心巧克力,2414,121,3,2,5,60.0%,51m
19742,2,浪江湖雨后,2414,0,3,2,5,60.0%,10m
19742,2,[我真的是萌新]SFC,2414,0,3,2,5,60.0%,46m
19742,1,魂祭一雪舞,2414,80,2,2,4,50.0%,16m
19742,1,镜花水月,2414,126,2,5,7,28.6%,1h
19742,1,洋葱,2414,0,1,0,1,100.0%,1h
19742,2,苏联政委,2414,0,1,1,2,50.0%,55m
19742,1,[社交学导教]你看我吊吗,2414,0,1,2,3,33.3%,1h
19742,2,[欧派萌新团]我是一波流,2414,0,1,4,5,20.0%,1h
19742,1,[EDR]佳果果,2414,0,0,1,1,0.0%,2m
19742,2,孤单的雨神,2414,0,0,1,1,0.0%,1h
19742,1,吾乃小凯乐,2414,0,0,1,1,0.0%,45m
19742,3,愤怒的白水,2414,0,0,3,3,0.0%,1h
19769,1,APangstrong,2413,1395,107,112,219,48.9%,1h
19769,1,[妖妖梦]Wasted,2413,1788,70,75,145,48.3%,48m
19769,3,wordwife,2413,424,14,25,39,35.9%,7m
19769,3,上杉绘梨衣,2413,187,6,5,11,54.5%,1h
19769,3,[一块晶体矿]叶落花之梦,2413,194,6,6,12,50.0%,49m
19769,2,翰林墨雨,2413,0,5,0,5,100.0%,10m
19769,3,Yulining,2413,171,5,6,11,45.5%,9m
19769,1,zio,2413,143,3,5,8,37.5%,1h
19769,1,[基金会]弑神,2413,124,3,6,9,33.3%,35m
19769,1,[嘤嘤嘤呜呜]Jayus,2413,144,2,2,4,50.0%,37m
19769,1,逍遥少年,2413,44,2,2,4,50.0%,1h
19769,1,sona,2413,0,1,1,2,50.0%,6m
19769,1,[XXHZ33]岚峪,2413,0,1,2,3,33.3%,1h
19769,2,风光无限,2413,0,1,4,5,20.0%,55m
19769,1,BLACKKEHL,2413,42,1,5,6,16.7%,18m
19769,1,卟丶弃,2413,73,0,2,2,0.0%,26m
19785,2,独上兰舟,2412,1483,67,56,123,54.5%,20m
19785,2,海洋,2412,888,54,53,107,50.5%,13m
19785,3,Woasky,2412,1053,39,44,83,47.0%,27m
19785,1,啊这,2412,1036,35,30,65,53.8%,1h
19785,1,荣光时刻,2412,565,16,14,30,53.3%,21m
19785,3,Hummpy,2412,378,15,17,32,46.9%,1h
19785,3,踏空,2412,123,12,16,28,42.9%,25m
19785,1,[阿尔泰瑟斯]IIIIIIIIIIII,2412,263,10,2,12,83.3%,42m
19785,2,核心价值观之惩戒,2412,241,9,12,21,42.9%,1h
19785,3,[嘤遍全球]大女乃,2412,262,8,13,21,38.1%,59m
19785,2,虐杀地带,2412,286,8,14,22,36.4%,1h
19785,1,vold,2412,190,7,5,12,58.3%,25m
19785,1,[失去理智]疾风蓝羽,2412,96,5,6,11,45.5%,1h
19785,1,Markflower,2412,0,2,5,7,28.6%,1h
19785,1,Majian,2412,0,1,0,1,100.0%,35m
19785,1,九槑,2412,0,0,1,1,0.0%,58m
19801,1,不会玩这个游戏,2411,1064,32,33,65,49.2%,18m
19801,2,FaastBao,2411,361,23,31,54,42.6%,1h
19801,3,Stormy,2411,360,15,19,34,44.1%,43m
19801,1,战役,2411,345,13,15,28,46.4%,1h
19801,1,ghs,2411,420,12,7,19,63.2%,1h
19801,3,言笑,2411,318,11,14,25,44.0%,59m
19801,2,Orange,2411,243,9,21,30,30.0%,1h
19801,2,星际流浪者,2411,245,7,11,18,38.9%,1h
19801,3,[GCT]cooooooool,2411,186,5,8,13,38.5%,2m
19801,3,[极限菜鸟]biubiubiubiu,2411,202,5,8,13,38.5%,19m
19801,1,kass,2411,136,4,4,8,50.0%,52m
19801,3,小小跳虫可笑可笑,2411,143,4,6,10,40.0%,1h
19801,1,无忌,2411,46,4,11,15,26.7%,1h
19801,1,爱莎公猪,2411,88,3,3,6,50.0%,59m
19801,1,李朝阳自豪,2411,120,3,5,8,37.5%,26m
19801,1,[最牛的菜鸟队]totalden,2411,74,2,2,4,50.0%,14m
19801,3,[大宇恩]炸鱼的废物,2411,121,2,4,6,33.3%,1h
19801,1,我才不是萌新呢,2411,97,2,5,7,28.6%,45m
19801,1,Moon,2411,0,1,3,4,25.0%,42m
19801,1,上山打鼠,2411,0,1,3,4,25.0%,18m
19801,2,zeleize,2411,0,1,4,5,20.0%,55m
19801,2,[20CM]你的老公,2411,0,0,1,1,0.0%,1h
19801,1,呵呵,2411,0,0,1,1,0.0%,37m
19801,1,镜花水月,2411,0,0,2,2,0.0%,18m
19825,3,奥克兰小霸王,2410,1220,133,134,267,49.8%,9m
19825,2,QueenSea,2410,1121,106,106,212,50.0%,59m
19825,3,逐风者之手,2410,1588,85,89,174,48.9%,1h
19825,3,Nobody,2410,704,43,39,82,52.4%,3m
19825,3,Harmmer,2410,270,20,26,46,43.5%,27m
19825,1,浪迹天涯,2410,322,14,12,26,53.8%,49m
19825,3,梦生丿醉死,2410,322,11,17,28,39.3%,27m
19825,3,favrous,2410,220,8,5,13,61.5%,1h
19825,1,冷沫,2410,190,5,5,10,50.0%,53m
19825,3,Silence,2410,198,5,9,14,35.7%,1h
19825,1,[哆啦]五代,2410,156,4,6,10,40.0%,1h
19825,3,zjp,2410,144,3,5,8,37.5%,35m
19825,3,jpcz,2410,122,3,7,10,30.0%,59m
19825,2,[萝莉航线]南宫夜殇,2410,88,1,1,2,50.0%,1h
19825,1,[華鳥風月之父]人一一一,2410,0,1,1,2,50.0%,1h
19825,1,拱火起手式,2410,0,1,1,2,50.0%,14m
19825,1,Star,2410,0,1,5,6,16.7%,17m
19825,1,你堵口了嘛,2410,0,0,1,1,0.0%,60m
19825,2,chenwenjie,2410,0,0,1,1,0.0%,1h
19825,1,夏天至尊,2410,0,0,1,1,0.0%,1h
19845,1,山间清爽的风,2409,519,62,66,128,48.4%,1h
19845,2,[恁死你]世外高人,2409,918,51,52,103,49.5%,1h
19845,1,[CPT]从前那个少年,2409,1010,33,26,59,55.9%,1h
19845,3,你想拘泥,2409,777,29,31,60,48.3%,1h
19845,1,[无边之空]老黄,2409,629,18,14,32,56.2%,14m
19845,3,LUCKY,2409,407,15,17,32,46.9%,1h
19845,2,[gost]斟酒对无言,2409,281,10,10,20,50.0%,2m
19845,1,[峰吹起了过去]星际启示者,2409,300,9,5,14,64.3%,1h
19845,1,CIAGRAY,2409,232,7,6,13,53.8%,52m
19845,1,神之长子,2409,241,6,2,8,75.0%,49m
19845,3,Xiapopo,2409,193,6,2,8,75.0%,60m
19845,2,[invtio]肤白人美大长腿,2409,196,5,8,13,38.5%,1h
19845,2,永恒空虚,2409,84,4,11,15,26.7%,1h
19845,1,[Le拉克丝]XingHum,2409,48,2,6,8,25.0%,1h
19845,3,[DMRc]ZIXan,2409,0,1,1,2,50.0%,51m
19845,3,无情三连,2409,0,1,2,3,33.3%,1h
19845,2,天阵,2409,0,1,4,5,20.0%,35m
19845,3,白白白白银,2409,0,1,4,5,20.0%,1h
19845,2,[琴之森]凉城,2409,0,1,4,5,20.0%,46m
19845,2,不出兵等打吗,2409,0,1,4,5,20.0%,58m
19845,1,九城,2409,0,1,6,7,14.3%,18m
19845,1,小小牵牛星,2409,0,0,1,1,0.0%,1h
19867,3,HHHHHHHHHHHH,2408,1405,59,57,116,50.9%,1h
19867,1,北朝,2408,832,58,54,112,51.8%,41m
19867,3,宝宝的愤怒,2408,1058,47,51,98,48.0%,9m
19867,1,qbsjq,2408,796,36,18,54,66.7%,26m
19867,1,HSHC,2408,393,19,10,29,65.5%,18m
19867,1,BRUCE,2408,340,18,17,35,51.4%,1h
19867,1,Zerg,2408,630,18,20,38,47.4%,26m
19867,1,文一,2408,368,13,10,23,56.5%,1h
19867,1,久安嘉禾,2408,428,12,14,26,46.2%,31m
19867,1,老子就是心软,2408,309,10,10,20,50.0%,1h
19867,3,[六道]ENT,2408,256,9,14,23,39.1%,33m
19867,3,枫叶浮生残雪,2408,132,8,8,16,50.0%,32m
19867,3,二货超人,2408,242,7,11,18,38.9%,1h
19867,3,[为谁而忧伤]为了虫族,2408,160,5,5,10,50.0%,11m
19867,3,初春飾利,2408,120,5,9,14,35.7%,1h
19867,3,暴雪你女马死了,2408,96,5,9,14,35.7%,1h
19867,2,周杰伦,2408,139,5,10,15,33.3%,13m
19867,2,夺命大石头,2408,40,4,9,13,30.8%,20m
19867,1,我既迷茫还懵批,2408,44,2,1,3,66.7%,21m
19867,1,天上的流星雨,2408,40,2,3,5,40.0%,1h
19867,1,QFZC,2408,145,2,3,5,40.0%,1h
19867,1,路明非,2408,0,1,2,3,33.3%,1h
19867,2,gaoziteng,2408,0,1,4,5,20.0%,43m
19867,1,arsilang,2408,0,0,1,1,0.0%,3m
19867,1,Apollo,2408,0,0,1,1,0.0%,1h
19867,1,[DFL]Durrinkun,2408,0,0,1,1,0.0%,1h
19893,3,悠扬,2407,1497,124,128,252,49.2%,1h
19893,3,Threefire,2407,1555,70,66,136,51.5%,36m
19893,3,[梦瑾空人心]光辉的晨星,2407,814,29,28,57,50.9%,1h
19893,1,[Sc养老]垂死卧病惊坐起,2407,707,25,18,43,58.1%,20m
19893,3,白给,2407,383,14,13,27,51.9%,30m
19893,3,酒后单杀丈母娘,2407,312,14,18,32,43.8%,1h
19893,3,rfewfdsfsf,2407,216,9,18,27,33.3%,1h
19893,1,猎手骁骁,2407,178,6,6,12,50.0%,1h
19893,1,[XXHZ36]爷爱美年达,2407,189,5,1,6,83.3%,1h
19893,1,[花笙]霁野,2407,191,5,5,10,50.0%,3m
19893,1,Morek,2407,82,3,2,5,60.0%,1h
19893,2,孤酒,2407,0,3,2,5,60.0%,1h
19893,1,parting,2407,86,2,3,5,40.0%,25m
19893,3,leman,2407,97,2,3,5,40.0%,3m
19893,2,DRAGON,2407,0,2,7,9,22.2%,9m
19893,2,tyaizx,2407,0,1,4,5,20.0%,34m
19893,2,青铜神族无敌强,2407,0,1,4,5,20.0%,55m
19893,2,没有名,2407,0,1,4,5,20.0%,43m
19893,1,[18th]一场凉水,2407,0,1,5,6,16.7%,1h
19893,1,[崩溃大队]霊湮,2407,0,0,1,1,0.0%,25m
19893,1,[CDSC]DINOSAUR,2407,0,0,1,1,0.0%,26m
19914,3,[长征小白]难兄难弟,2406,1587,146,146,292,50.0%,25m
19914,2,余文差,2406,295,83,85,168,49.4%,50m
19914,3,zhi,2406,1228,65,70,135,48.1%,43m
19914,1,pcchen,2406,766,23,19,42,54.8%,1h
19914,1,阿龙星际,2406,461,20,21,41,48.8%,52m
19914,1,剑藏,2406,501,17,22,39,43.6%,18m
19914,3,五庄观偷吃人参果,2406,275,16,14,30,53.3%,1h
19914,1,[领导先走]梦一场,2406,382,12,15,27,44.4%,49m
19914,2,[今天超市打折]达拉然,2406,322,12,19,31,38.7%,59m
19914,3,[黑森峰卐学院]弃坑菜鸟,2406,348,11,13,24,45.8%,43m
19914,1,[廷达罗斯之力]lululu,2406,326,10,3,13,76.9%,4m
19914,1,黑色梦魇,2406,234,10,9,19,52.6%,20m
19914,1,[凤凰山土匪]IIIIIIII,2406,340,9,7,16,56.2%,1h
19914,1,EinhartreMan,2406,322,8,4,12,66.7%,57m
19914,1,[不灭青铜]波粒二,2406,255,8,9,17,47.1%,1h
19914,1,猩鸡争霸,2406,265,8,10,18,44.4%,48m
19914,3,PLANEHIT,2406,147,7,6,13,53.8%,60m
19914,1,狐狸渔鸥,2406,283,6,8,14,42.9%,1h
19914,1,skylueise,2406,154,5,4,9,55.6%,1h
19914,2,一点儿也不好,2406,66,5,9,14,35.7%,47m
19914,3,mjyyyyyy,2406,170,4,3,7,57.1%,1h
19914,1,龙的传人,2406,141,3,2,5,60.0%,37m
19914,1,[虫海攻略组]椿的下面是甜的,2406,145,3,5,8,37.5%,1h
19914,1,彼岸花,2406,86,2,4,6,33.3%,1h
19914,3,上线发呆,2406,0,1,2,3,33.3%,7m
19914,3,Ohyes,2406,30,1,3,4,25.0%,1h
19914,2,[光井琉璃]亚璃子丶,2406,88,1,3,4,25.0%,1h
19914,2,zerotwo,2406,0,1,4,5,20.0%,55m
19914,2,雷神,2406,0,1,4,5,20.0%,1h
19914,2,visitttm,2406,0,1,4,5,20.0%,45m
19914,2,随心随性,2406,0,1,4,5,20.0%,34m
19914,2,csyyoyo,2406,0,1,4,5,20.0%,6m
19914,3,炳超,2406,0,1,5,6,16.7%,3m
19914,1,[欢迎萌新]开开心心,2406,0,0,2,2,0.0%,59m
19948,3,让梯若尔,2405,457,56,56,112,50.0%,27m
19948,1,我不菜,2405,561,18,21,39,46.2%,1h
19948,2,tsheep,2405,224,9,13,22,40.9%,46m
19948,3,封狼居胥,2405,189,8,13,21,38.1%,1h
19948,3,我很乖,2405,209,5,8,13,38.5%,1h
19948,1,GOLD,2405,166,4,4,8,50.0%,1h
19948,1,HHH,2405,48,3,4,7,42.9%,1h
19948,1,好人兄,2405,145,3,6,9,33.3%,45m
19948,2,[化物语丶]similar,2405,0,2,3,5,40.0%,46m
19948,1,节拍音乐散弹枪,2405,0,1,2,3,33.3%,1h
19948,1,[XCode]樱满八幡,2405,44,1,2,3,33.3%,26m
19948,2,[暴雪我是你爹]手刃降服重创最强,2405,0,1,4,5,20.0%,18m
19948,1,人族永不言弃,2405,0,0,1,1,0.0%,1h
19948,1,暗霄白虹,2405,0,0,1,1,0.0%,41m
19948,3,凯瑞甘首席女弟子,2405,0,0,2,2,0.0%,1h
19963,3,没有人比我更懂猫,2404,1548,133,128,261,51.0%,56m
19963,3,我就是我自己,2404,512,17,21,38,44.7%,25m
19963,1,[XXHZ37]骑驴打劫,2404,496,13,10,23,56.5%,1h
19963,3,CavalryID,2404,249,10,6,16,62.5%,56m
19963,3,听雨,2404,188,10,13,23,43.5%,26m
19963,2,Supervisor,2404,268,9,13,22,40.9%,1h
19963,2,DASHEN,2404,106,5,11,16,31.2%,1h
19963,2,END,2404,156,4,6,10,40.0%,1h
19963,2,光复艾尔,2404,129,4,6,10,40.0%,1h
19963,1,午夜休闲,2404,97,2,1,3,66.7%,1h
19963,3,Doppo,2404,121,2,3,5,40.0%,1h
19963,3,Revolution,2404,58,2,11,13,15.4%,55m
19963,2,BOD,2404,0,1,2,3,33.3%,35m
19963,1,aurora,2404,42,1,3,4,25.0%,32m
19963,1,不变的旋律,2404,0,0,2,2,0.0%,1h
19978,3,名为寂寞野兽,2403,1504,74,80,154,48.1%,1h
19978,1,[DX战队]神经科主任凯瑞甘,2403,869,36,20,56,64.3%,1h
19978,1,UYGHGHG,2403,235,14,26,40,35.0%,6m
19978,1,[萌的一笔]憨憨,2403,304,10,12,22,45.5%,14m
19978,1,[繁花落尽]Frisk,2403,188,9,10,19,47.4%,1h
19978,1,兜兜,2403,258,9,16,25,36.0%,5m
19978,3,夏小白,2403,264,9,16,25,36.0%,56m
19978,1,佐伯龙治,2403,289,8,4,12,66.7%,1h
19978,1,忆竹,2403,282,8,6,14,57.1%,16m
19978,1,飞鹰,2403,234,7,5,12,58.3%,1h
19978,1,zbzbzzb,2403,204,5,7,12,41.7%,1h
19978,1,MarK,2403,78,4,4,8,50.0%,1h
19978,1,蒜香鱼丸,2403,165,4,5,9,44.4%,37m
19978,1,[世界大战]飘零落英,2403,82,3,1,4,75.0%,1h
19978,2,苍茫也晴天,2403,114,3,1,4,75.0%,47m
19978,3,姓曹名备字仲谋,2403,122,3,5,8,37.5%,9m
19978,1,杜杜,2403,123,3,7,10,30.0%,18m
19978,1,Asagumoll,2403,92,2,6,8,25.0%,58m
19978,1,[荔枝]墨空羽,2403,0,1,1,2,50.0%,1h
19978,1,愤怒的橙子,2403,38,1,1,2,50.0%,3m
19978,1,呵呵,2403,0,1,1,2,50.0%,53m
19978,2,文轩,2403,0,1,4,5,20.0%,45m
19978,1,老袁绿水,2403,0,0,1,1,0.0%,60m
19978,1,给我芒果奶盖啊,2403,0,0,1,1,0.0%,4m
20002,2,这游戏还真没玩呢,2402,1558,137,146,283,48.4%,43m
20002,1,Ailk,2402,646,29,16,45,64.4%,1h
20002,1,落叶一随风,2402,885,26,32,58,44.8%,18m
20002,1,流氓兔耍流氓,2402,518,16,11,27,59.3%,48m
20002,3,天漠系居居,2402,320,13,17,30,43.3%,36m
20002,2,DJai,2402,289,10,14,24,41.7%,53m
20002,3,dede,2402,258,9,8,17,52.9%,1h
20002,1,Stark,2402,137,6,2,8,75.0%,29m
20002,2,[星际GG]主教,2402,92,5,10,15,33.3%,20m
20002,3,甜甜圈儿机枪兵,2402,97,4,4,8,50.0%,21m
20002,3,林加德,2402,155,4,8,12,33.3%,1h
20002,1,yotou,2402,97,2,5,7,28.6%,46m
20002,1,huiYe,2402,0,1,0,1,100.0%,59m
20002,1,hhh,2402,0,1,1,2,50.0%,55m
20002,1,alex,2402,0,0,3,3,0.0%,59m
20017,2,高手父亲,2401,652,125,117,242,51.7%,1h
20017,1,[ZSB铁憨憨]Critte,2401,487,39,31,70,55.7%,26m
20017,1,[噶姐美如花]hydra,2401,489,19,13,32,59.4%,1h
20017,1,Cuertain,2401,637,19,16,35,54.3%,25m
20017,1,是人族,2401,465,15,12,27,55.6%,5m
20017,1,初水,2401,351,12,9,21,57.1%,1h
20017,1,上海雅树展览有限,2401,206,11,4,15,73.3%,55m
20017,1,[暴雪二十七队]是个酱菜,2401,373,11,13,24,45.8%,1h
20017,1,JsZhai,2401,347,10,11,21,47.6%,1h
20017,1,你可真是个鬼才,2401,204,6,3,9,66.7%,32m
20017,1,职业彩笔,2401,112,3,4,7,42.9%,57m
20017,1,福尔特,2401,96,3,7,10,30.0%,1h
20017,1,超威吴克,2401,46,2,0,2,100.0%,1h
20017,3,死亡轰炸,2401,64,2,25,27,7.4%,34m
20017,1,[远坂世家]赵新拿破仑,2401,0,1,0,1,100.0%,25m
20017,1,茅野爱衣,2401,44,1,1,2,50.0%,1h
20017,1,上官同学,2401,0,1,1,2,50.0%,3m
20017,2,[Leaves]Zephyrix,2401,0,1,4,5,20.0%,1h
20017,3,动物凶猛,2401,0,0,4,4,0.0%,1h
20036,3,时代大帝,2400,1590,201,194,395,50.9%,30m
20036,2,liazz,2400,435,52,50,102,51.0%,17m
20036,1,[琴筝]澄江中孤屿,2400,1006,41,33,74,55.4%,11m
20036,3,清天祭,2400,701,26,30,56,46.4%,1h
20036,3,神之右大臣,2400,487,21,16,37,56.8%,1h
20036,3,DYc,2400,473,19,30,49,38.8%,34m
20036,2,Zzzqs,2400,311,13,10,23,56.5%,29m
20036,3,Ahri,2400,207,7,8,15,46.7%,1h
20036,1,deathknight,2400,210,6,9,15,40.0%,1h
20036,1,Puma,2400,124,4,6,10,40.0%,20m
20036,1,[OwenSS]彦祖,2400,82,3,0,3,100.0%,1h
20036,2,[电脑l难度]专家,2400,48,3,3,6,50.0%,1h
20036,1,碗里的肉酱面,2400,48,3,6,9,33.3%,46m
20036,3,你是不是个沙雕,2400,62,3,7,10,30.0%,19m
20036,1,虫爱虫网,2400,40,2,5,7,28.6%,42m
20036,1,[琴筝]Marstars,2400,0,1,0,1,100.0%,52m
20036,1,safari,2400,0,0,1,1,0.0%,1h
20036,3,无敌老剑客,2400,0,0,1,1,0.0%,1h
20036,2,lkaldsd,2400,0,0,1,1,0.0%,36m
20055,3,[谐星很忙]AlieZ,2399,905,35,41,76,46.1%,1h
20055,1,[迷宫丨极限组]十一,2399,667,26,15,41,63.4%,1h
20055,3,[专治格种不服]computer,2399,647,25,27,52,48.1%,1h
20055,1,月言,2399,689,22,21,43,51.2%,1h
20055,2,gumao,2399,353,15,20,35,42.9%,1h
20055,1,PatrickStar,2399,286,11,6,17,64.7%,5m
20055,1,LuckyEB,2399,338,10,8,18,55.6%,49m
20055,3,Yeezsue,2399,195,8,7,15,53.3%,32m
20055,1,[封闭者]生涯中,2399,198,6,4,10,60.0%,16m
20055,1,云淡风轻,2399,186,6,5,11,54.5%,1h
20055,2,FamousSJ,2399,145,5,2,7,71.4%,46m
20055,3,暖树,2399,72,5,6,11,45.5%,1h
20055,2,占星,2399,127,4,5,9,44.4%,1h
20055,1,无所不知川建国,2399,42,2,0,2,100.0%,1h
20055,1,safczxc,2399,42,2,1,3,66.7%,1h
20055,3,风之,2399,0,2,6,8,25.0%,1h
20055,3,沉默之剑,2399,0,2,6,8,25.0%,7m
20055,1,意中画,2399,0,1,0,1,100.0%,1h
20055,1,宿暮,2399,0,1,2,3,33.3%,59m
20055,1,微微一笑,2399,0,0,1,1,0.0%,1h
20055,1,[古明地嗪]小智,2399,0,0,1,1,0.0%,49m
20055,1,碧琪大闹天空,2399,0,0,1,1,0.0%,1h
20055,1,暗影之刺,2399,0,0,2,2,0.0%,18m
20055,3,黑夜海贼鸥,2399,0,0,2,2,0.0%,1h
20055,1,[车车人]芙兰朵露,2399,0,0,2,2,0.0%,59m
20055,3,[一剑光寒九州]麻雀,2399,0,0,4,4,0.0%,1h
20081,3,让你先冲,2398,385,14,19,33,42.4%,1h
20081,3,我得天啊啊啊,2398,209,10,7,17,58.8%,49m
20081,2,给我一个吻,2398,277,10,12,22,45.5%,1h
20081,3,[白给丶兄弟]Unnamed,2398,189,8,5,13,61.5%,1h
20081,3,我是新手,2398,192,7,7,14,50.0%,21m
20081,3,路人成,2398,226,7,12,19,36.8%,1h
20081,1,[Steel]SugarLess,2398,144,2,3,5,40.0%,1h
20081,2,Superfical,2398,0,2,3,5,40.0%,1h
20081,2,macker,2398,0,2,3,5,40.0%,34m
20081,3,zkw,2398,30,2,5,7,28.6%,1h
20081,1,Messi,2398,0,1,0,1,100.0%,1h
20081,1,POTO,2398,0,1,1,2,50.0%,4m
20093,3,神经不是病,2397,1556,70,66,136,51.5%,12m
20093,1,hoveyxu,2397,353,10,6,16,62.5%,1h
20093,1,明君,2397,355,10,10,20,50.0%,25m
20093,1,球球,2397,226,7,4,11,63.6%,53m
20093,1,jiangshi,2397,178,6,4,10,60.0%,1h
20093,1,iuhiuhuhuiih,2397,193,5,6,11,45.5%,1h
20093,1,Sora,2397,76,2,1,3,66.7%,1h
20093,1,[艾尔之主]RedMousse,2397,0,1,0,1,100.0%,31m
20093,1,孤独的路痴,2397,0,1,0,1,100.0%,41m
20093,1,血狼,2397,40,1,2,3,33.3%,59m
20093,3,STARFALL,2397,0,1,3,4,25.0%,5m
20093,2,我非好人,2397,0,0,2,2,0.0%,1h
20093,1,Nekoko,2397,0,0,3,3,0.0%,33m
20106,2,[RDFZsc]开发者丨木桶教皇,2396,970,164,165,329,49.8%,1h
20106,1,shen,2396,1519,106,103,209,50.7%,38m
20106,3,为我活,2396,821,84,85,169,49.7%,27m
20106,1,破冰船长,2396,981,38,28,66,57.6%,59m
20106,1,收到,2396,971,36,25,61,59.0%,1h
20106,2,[25CM]大佬带带我,2396,615,32,38,70,45.7%,1h
20106,3,泷十八,2396,736,26,26,52,50.0%,41m
20106,3,[realY]bluefive,2396,363,13,13,26,50.0%,10m
20106,1,Happyness,2396,352,12,17,29,41.4%,1h
20106,1,我说了我是瑪维,2396,256,8,5,13,61.5%,41m
20106,1,[全员新手]PicearChan,2396,190,6,2,8,75.0%,1h
20106,1,格纳,2396,107,5,3,8,62.5%,26m
20106,1,恁打不过俺,2396,233,5,6,11,45.5%,3m
20106,3,loveforswear,2396,152,5,10,15,33.3%,1h
20106,1,滚烫大香草,2396,96,3,2,5,60.0%,1h
20106,3,隔夜,2396,30,3,7,10,30.0%,1h
20106,1,pathetic,2396,48,2,1,3,66.7%,1h
20106,2,小燃打,2396,0,2,2,4,50.0%,58m
20106,1,郝运,2396,0,1,0,1,100.0%,42m
20106,1,我得重新集结部队,2396,0,1,0,1,100.0%,1h
20106,1,[嘤嘤嘤呜呜]染小诺,2396,40,1,5,6,16.7%,1h
20106,1,[问卧龙几两钱]jbcyh,2396,0,0,1,1,0.0%,1h
20128,3,[艾尔之名]tangzhongyi,2395,1456,129,121,250,51.6%,1h
20128,2,[HOMOFU]试验品,2395,1390,49,56,105,46.7%,30m
20128,1,[麻酱罐]万年渡,2395,999,40,34,74,54.1%,1h
20128,1,DarkHunter,2395,689,24,24,48,50.0%,1h
20128,3,至尊宝,2395,573,23,22,45,51.1%,43m
20128,1,ewfij,2395,424,13,12,25,52.0%,1h
20128,3,宇智波鼬,2395,249,7,9,16,43.8%,1h
20128,1,Renegade,2395,200,6,6,12,50.0%,54m
20128,3,混战的魔王,2395,149,6,15,21,28.6%,12m
20128,1,有道之士,2395,194,5,6,11,45.5%,1h
20128,1,selex,2395,82,3,4,7,42.9%,1h
20128,1,微笑月亮,2395,32,2,1,3,66.7%,1h
20128,2,VPM,2395,48,2,4,6,33.3%,6m
20128,3,[科普卢星系]屈斌爱玩星际争霸,2395,60,2,8,10,20.0%,41m
20128,1,[虚空掠夺者]圣剑,2395,0,1,0,1,100.0%,49m
20128,2,萌新勿虐求求了,2395,0,1,4,5,20.0%,6m
20128,3,zhoufl,2395,30,1,7,8,12.5%,30m
20128,1,IIIIIIIIIIII,2395,0,0,2,2,0.0%,57m
20128,1,毛茸茸的好好先生,2395,0,0,2,2,0.0%,4m
20128,1,小金人,2395,0,0,2,2,0.0%,1h
20128,1,局外人,2395,0,0,5,5,0.0%,1h
20149,1,onecon,2394,883,76,70,146,52.1%,1h
20149,3,打死希望,2394,628,27,24,51,52.9%,25m
20149,2,猪圈一号,2394,473,18,22,40,45.0%,20m
20149,1,HappyTime,2394,370,15,5,20,75.0%,1h
20149,3,dassd,2394,306,10,13,23,43.5%,1h
20149,3,星星电灯,2394,156,8,8,16,50.0%,49m
20149,1,[凯撒之門]肥肥的熊,2394,243,7,3,10,70.0%,1h
20149,1,拾染,2394,48,4,4,8,50.0%,17m
20149,3,DocxTC,2394,121,3,0,3,100.0%,5m
20149,1,Vampire,2394,0,3,3,6,50.0%,45m
20149,1,ssssssssssss,2394,46,2,1,3,66.7%,1h
20149,1,同大,2394,72,2,5,7,28.6%,1h
20149,2,大干蒸,2394,0,1,4,5,20.0%,58m
20149,2,Cattlez,2394,0,1,4,5,20.0%,1h
20149,1,[NightX]Younger,2394,0,0,1,1,0.0%,1h
20149,1,[Nostop]达芬奇奇奇奇奇奇,2394,0,0,2,2,0.0%,1h
20149,3,[自由朝鲜]人间芭比郭德纲,2394,0,0,2,2,0.0%,1h
20166,1,洛洛克,2393,1757,85,85,170,50.0%,1h
20166,3,可乐,2393,874,33,29,62,53.2%,30m
20166,1,IIIIIIIIIIII,2393,984,32,31,63,50.8%,1h
20166,1,[背刺中队]幼苗的幼苗,2393,651,25,22,47,53.2%,1h
20166,3,采月亮的小星,2393,628,25,22,47,53.2%,9m
20166,3,xmc,2393,630,25,30,55,45.5%,33m
20166,1,蜜汁,2393,250,10,10,20,50.0%,1h
20166,1,帅气的钻石,2393,314,9,9,18,50.0%,20m
20166,2,晴栀,2393,217,8,12,20,40.0%,1h
20166,2,小虫,2393,126,7,9,16,43.8%,46m
20166,1,输了也爱,2393,254,7,12,19,36.8%,1h
20166,1,虫族大军生生不息,2393,180,5,0,5,100.0%,5m
20166,1,llllllllllll,2393,158,4,7,11,36.4%,49m
20166,3,[飞翔的蔬菜]飞翔的蔬菜,2393,97,3,6,9,33.3%,48m
20166,3,慕带刀,2393,113,3,6,9,33.3%,12m
20166,1,屈子,2393,144,3,6,9,33.3%,59m
20166,3,[XXHZN3]我是无敌的嘿嘿,2393,36,3,7,10,30.0%,1h
20166,1,凌云,2393,44,2,1,3,66.7%,50m
20166,1,罗杰,2393,78,2,3,5,40.0%,26m
20166,1,风殇,2393,36,2,3,5,40.0%,41m
20166,2,BBB,2393,48,2,4,6,33.3%,34m
20166,1,[FKA]巴巴,2393,0,1,2,3,33.3%,21m
20166,1,御坂美琴我的我的,2393,0,1,2,3,33.3%,16m
20166,1,轩辕,2393,0,1,3,4,25.0%,42m
20166,2,润物静音,2393,0,1,4,5,20.0%,13m
20166,2,巅峰依旧,2393,92,1,5,6,16.7%,13m
20166,1,未来,2393,44,1,6,7,14.3%,26m
20166,1,bomb,2393,0,0,1,1,0.0%,1h
20166,1,forth,2393,0,0,1,1,0.0%,1h
20166,1,塞拉菲姆,2393,0,0,1,1,0.0%,1h
20166,1,DADA,2393,0,0,2,2,0.0%,37m
20197,3,[黄金海舰队]tyrande,2392,1193,81,73,154,52.6%,53m
20197,2,[爱国]wzdzd,2392,861,77,81,158,48.7%,1h
20197,2,邻危不救过河吃桥,2392,1143,68,72,140,48.6%,30m
20197,3,独立者号,2392,1335,54,51,105,51.4%,1h
20197,3,[六芒星s]折翼丶殇,2392,281,42,38,80,52.5%,1h
20197,3,[嘤遍全球]Magic,2392,1159,42,48,90,46.7%,36m
20197,1,自在极意功孙悟空,2392,1216,39,50,89,43.8%,4m
20197,1,[我队伍很强大]林嵠,2392,811,29,24,53,54.7%,1h
20197,3,真好,2392,619,25,19,44,56.8%,12m
20197,1,[乱世]afsfa,2392,300,11,16,27,40.7%,34m
20197,2,徐大人,2392,259,9,12,21,42.9%,1h
20197,1,lgmArios,2392,118,4,3,7,57.1%,24m
20197,1,那年春江花月夜,2392,94,4,6,10,40.0%,21m
20197,1,gaosi,2392,36,2,0,2,100.0%,32m
20197,3,YueGuo,2392,62,2,4,6,33.3%,1h
20197,3,撒旦先生,2392,60,2,8,10,20.0%,2m
20197,1,耀月,2392,0,1,0,1,100.0%,35m
20197,1,Ghoul,2392,0,1,1,2,50.0%,1h
20197,3,黄乾川,2392,0,1,2,3,33.3%,1h
20197,2,[SprFS]Tiane,2392,0,1,4,5,20.0%,1h
20197,2,淘气免疫,2392,0,1,4,5,20.0%,57m
20197,1,Youc,2392,0,0,4,4,0.0%,26m
20219,2,小显,2391,692,49,46,95,51.6%,5m
20219,2,[tyyt]天依,2391,760,30,27,57,52.6%,43m
20219,1,[Supre]星火燎原,2391,656,20,18,38,52.6%,20m
20219,3,苏卡布莉娅,2391,595,19,24,43,44.2%,1h
20219,3,TVzxg,2391,395,18,17,35,51.4%,32m
20219,1,筱杰,2391,382,13,15,28,46.4%,1h
20219,1,星浪网吧,2391,260,7,7,14,50.0%,37m
20219,3,铜锣烧,2391,200,6,9,15,40.0%,5m
20219,1,JBY,2391,194,5,6,11,45.5%,1h
20219,1,[电气游龙]shyha,2391,192,5,6,11,45.5%,1h
20219,1,光芒万丈陈彦祖,2391,204,5,8,13,38.5%,1h
20219,2,[我是真萌新]LemonBear,2391,0,4,1,5,80.0%,6m
20219,1,[圣芙蕾雅学院]superserse,2391,96,4,5,9,44.4%,1h
20219,3,读想,2391,66,4,8,12,33.3%,17m
20219,1,blackrose,2391,116,3,4,7,42.9%,55m
20219,3,Chingda,2391,97,3,6,9,33.3%,1h
20219,1,[北有吾王3队]葬仙,2391,127,2,1,3,66.7%,59m
20219,1,wxx,2391,0,1,0,1,100.0%,4m
20219,1,诚子,2391,0,1,1,2,50.0%,54m
20219,1,艾尔,2391,44,1,1,2,50.0%,1h
20219,2,时空旋,2391,0,1,2,3,33.3%,1h
20219,2,AthlanSARA,2391,0,1,4,5,20.0%,1h
20219,2,天依公主,2391,46,1,5,6,16.7%,1h
20219,1,MrLiu,2391,0,0,1,1,0.0%,35m
20219,1,小魍魉丶,2391,0,0,1,1,0.0%,1h
20219,1,REchelieu,2391,0,0,1,1,0.0%,41m
20219,1,YImbaZapear,2391,0,0,1,1,0.0%,32m
20219,1,希灵特使联络官,2391,0,0,1,1,0.0%,1h
20219,1,冷锋,2391,0,0,1,1,0.0%,1h
20219,1,最冷的昨天,2391,0,0,2,2,0.0%,55m
20219,1,gan,2391,0,0,3,3,0.0%,1h
20219,3,[天尊杨戬]老坛咸菜,2391,0,0,4,4,0.0%,31m
20251,1,荣耀指引我,2390,987,51,39,90,56.7%,31m
20251,1,呵呵,2390,641,26,20,46,56.5%,5m
20251,2,AiurProtoss,2390,310,19,22,41,46.3%,59m
20251,1,[暴雪养鸡场]强盗,2390,368,13,7,20,65.0%,49m
20251,2,雷诺叫我好兄弟,2390,289,10,13,23,43.5%,16m
20251,2,SKY,2390,161,6,10,16,37.5%,1h
20251,1,阿里来打星,2390,155,4,6,10,40.0%,29m
20251,1,joke,2390,164,4,7,11,36.4%,1h
20251,1,打装机,2390,86,3,0,3,100.0%,55m
20251,1,冰红茶,2390,145,3,6,9,33.3%,1h
20251,3,[暴雪三十二隊]victory,2390,0,2,6,8,25.0%,1h
20251,2,沐瞳,2390,0,1,0,1,100.0%,1h
20251,1,木匠和小怪物,2390,0,1,0,1,100.0%,1h
20251,2,[EGE]SupperWarIII,2390,0,1,4,5,20.0%,40m
20251,1,[北洋谐星组合]JonahReflux,2390,32,1,5,6,16.7%,1h
20266,1,ddwjmg,2389,1395,341,339,680,50.1%,16m
20266,2,风飞过得地方,2389,1431,117,123,240,48.8%,34m
20266,3,不要狗打运营,2389,681,27,25,52,51.9%,1h
20266,2,[艾尔之名]螂艮,2389,249,18,19,37,48.6%,1h
20266,1,[天羽不榖]鬼魂之父,2389,454,14,10,24,58.3%,1h
20266,1,QGhappy,2389,407,13,10,23,56.5%,18m
20266,1,nhr,2389,246,9,10,19,47.4%,1h
20266,2,天才,2389,0,3,2,5,60.0%,18m
20266,1,[INIAO]王兰花,2389,40,2,1,3,66.7%,1h
20266,1,[21CM]咸鱼冲撞,2389,96,2,5,7,28.6%,37m
20266,1,[Solo]墨语,2389,0,1,0,1,100.0%,5m
20266,1,木铎,2389,0,1,1,2,50.0%,1h
20266,1,白杨盾,2389,0,1,4,5,20.0%,26m
20266,2,赛尔王,2389,0,1,4,5,20.0%,1h
20266,2,天空下的未来色,2389,0,1,4,5,20.0%,58m
20266,1,[神子]HaiWuLiang,2389,42,1,5,6,16.7%,1h
20266,3,ANGElASD,2389,0,0,8,8,0.0%,7m
20283,1,[慢手e族]TUT,2388,1275,76,68,144,52.8%,1h
20283,1,Shadow,2388,940,32,29,61,52.5%,51m
20283,3,[探索]邪恶的大狼,2388,693,27,29,56,48.2%,1h
20283,1,苍颜轻尘,2388,522,18,16,34,52.9%,1h
20283,1,[天使部]纸芯德蝶,2388,348,10,6,16,62.5%,31m
20283,3,成果的脑残粉,2388,227,7,8,15,46.7%,1h
20283,1,[ye1]耶一战队公共账号,2388,261,7,9,16,43.8%,43m
20283,1,Bilibobo,2388,150,5,4,9,55.6%,34m
20283,3,SovietWings,2388,170,4,2,6,66.7%,24m
20283,1,曦光未泯,2388,124,4,3,7,57.1%,14m
20283,1,小宅,2388,168,4,7,11,36.4%,1h
20283,1,泠烨,2388,48,2,0,2,100.0%,17m
20283,1,蛀米虫,2388,30,2,3,5,40.0%,1h
20283,2,[绿拐天下第一]很神奇的海螺,2388,46,2,5,7,28.6%,6m
20283,1,[投降输一半]sjwillion,2388,0,1,0,1,100.0%,20m
20283,1,decade,2388,0,1,1,2,50.0%,54m
20283,1,[普刘思]鸡是灯棍,2388,0,1,1,2,50.0%,5m
20283,2,钛合金,2388,0,1,4,5,20.0%,35m
20283,2,[南信大小萌新]老船长,2388,0,1,4,5,20.0%,57m
20302,2,Joker,2387,473,58,50,108,53.7%,12m
20302,1,[DSE]mao,2387,977,39,45,84,46.4%,33m
20302,3,我不是狗狗,2387,878,37,40,77,48.1%,55m
20302,1,[鸡饲料协会]tardis,2387,791,24,26,50,48.0%,1h
20302,1,wound,2387,625,23,16,39,59.0%,59m
20302,3,戏子,2387,221,11,11,22,50.0%,26m
20302,3,[最菜战队]名字,2387,273,10,12,22,45.5%,1h
20302,3,Tian,2387,288,10,15,25,40.0%,1h
20302,2,Jhin,2387,255,9,5,14,64.3%,53m
20302,3,黎明之刃,2387,190,7,5,12,58.3%,1h
20302,1,Feisilinpu,2387,186,5,10,15,33.3%,25m
20302,3,Corby,2387,144,5,11,16,31.2%,26m
20302,1,GUNDAM,2387,70,4,1,5,80.0%,25m
20302,1,[社交学小可爱]gdfgrdfgdf,2387,132,4,5,9,44.4%,1h
20302,1,起飞,2387,111,3,0,3,100.0%,21m
20302,1,克哈炮王炮轰克哈,2387,97,2,1,3,66.7%,1h
20302,1,洛尘,2387,48,2,3,5,40.0%,1h
20302,1,战神,2387,0,1,0,1,100.0%,1h
20302,1,[壮士打我队友]北桫,2387,48,1,1,2,50.0%,1h
20302,1,[比心老子爱你]xiaomi,2387,0,1,1,2,50.0%,35m
20302,1,TheShy,2387,0,1,2,3,33.3%,1h
20302,2,[虎牙洛飞羽]Nimror,2387,0,1,4,5,20.0%,35m
20302,1,SDsd,2387,44,1,5,6,16.7%,48m
20302,3,他的父亲,2387,30,1,6,7,14.3%,1h
20302,1,小白菜,2387,0,0,1,1,0.0%,55m
20302,1,糖果屋,2387,0,0,1,1,0.0%,1h
20302,2,[一个军的兵力]来呀崽子,2387,0,0,1,1,0.0%,34m
20302,1,lzx,2387,0,0,2,2,0.0%,1h
20302,1,花开彼岸天,2387,0,0,3,3,0.0%,58m
20302,1,逍遥法外,2387,0,0,3,3,0.0%,1h
20302,3,求奶我事业不顺,2387,0,0,6,6,0.0%,20m
20333,3,fast,2386,641,73,73,146,50.0%,1h
20333,1,Raymondren,2386,668,27,25,52,51.9%,14m
20333,3,盒子,2386,516,18,23,41,43.9%,1h
20333,3,micha,2386,424,16,13,29,55.2%,1h
20333,1,[NavyF]MiTsuBiShi,2386,457,16,18,34,47.1%,46m
20333,1,manpoweron,2386,422,14,7,21,66.7%,26m
20333,1,[HustSC]涅普姬雅,2386,323,12,6,18,66.7%,52m
20333,1,[文韬武略]Helium,2386,284,9,6,15,60.0%,55m
20333,1,九天剑庄一幽冥,2386,333,9,12,21,42.9%,5m
20333,1,总有刁民想害朕,2386,264,7,7,14,50.0%,1h
20333,2,圣殿武士,2386,153,7,9,16,43.8%,6m
20333,3,纸鸢,2386,224,7,12,19,36.8%,3m
20333,1,Edison,2386,84,3,4,7,42.9%,3m
20333,1,圣灵,2386,82,2,2,4,50.0%,1h
20333,3,[今晚搞比利]Cappuccino,2386,0,2,6,8,25.0%,17m
20333,3,传千古,2386,0,1,0,1,100.0%,1h
20333,1,[渣男团体]极地武士,2386,48,1,3,4,25.0%,1h
20333,2,墨初,2386,0,1,4,5,20.0%,55m
20333,2,Vlikiss,2386,0,1,4,5,20.0%,45m
20333,1,孔哥,2386,0,0,2,2,0.0%,16m
20333,1,longwang,2386,0,0,2,2,0.0%,49m
20333,3,[地雷军团]无所谓无,2386,0,0,3,3,0.0%,5m
20355,3,wssw,2385,1553,156,155,311,50.2%,43m
20355,1,老相,2385,1378,53,43,96,55.2%,11m
20355,1,COOKIE,2385,1002,31,30,61,50.8%,1h
20355,3,[ZVP打后期]MrSupCNMBCNM,2385,478,19,17,36,52.8%,32m
20355,1,huaji,2385,590,18,17,35,51.4%,43m
20355,1,[中华何平]虫王回归,2385,341,16,27,43,37.2%,1h
20355,1,出现的黎明,2385,451,15,17,32,46.9%,5m
20355,3,[上古萌元素]星际迷徒,2385,202,7,16,23,30.4%,30m
20355,2,她还是短发吗,2385,64,5,9,14,35.7%,48m
20355,3,[神樂七奈ol]星源,2385,104,5,9,14,35.7%,1h
20355,1,天空小汤圆,2385,0,1,0,1,100.0%,19m
20355,1,至尊丶刘少,2385,0,1,1,2,50.0%,33m
20355,2,括弧笑,2385,0,1,1,2,50.0%,6m
20355,1,King,2385,48,1,3,4,25.0%,1h
20355,1,cupid,2385,0,0,2,2,0.0%,1h
20370,3,[112909]赵某某,2384,1477,78,77,155,50.3%,33m
20370,2,不可战胜,2384,1546,74,78,152,48.7%,42m
20370,1,[联合动物园]乌克兰臭猪,2384,645,31,31,62,50.0%,25m
20370,3,TNTB,2384,300,10,16,26,38.5%,3m
20370,1,老紫,2384,340,9,10,19,47.4%,49m
20370,1,大漠孤烟,2384,243,7,5,12,58.3%,1h
20370,3,老子就是菜怎么了,2384,241,7,9,16,43.8%,1h
20370,1,希尔瓦娜斯,2384,192,6,3,9,66.7%,1h
20370,3,紫川枫,2384,195,6,9,15,40.0%,49m
20370,1,[Eve联盟]洛璃,2384,154,4,5,9,44.4%,52m
20370,3,[迷宫丨极限组]菜鸡互啄,2384,76,4,9,13,30.8%,1h
20370,3,SCPLAYER,2384,97,2,0,2,100.0%,1h
20370,1,Ibelieve,2384,42,2,1,3,66.7%,59m
20370,1,HYx,2384,0,2,1,3,66.7%,1h
20370,1,[我们是瞎子]影刃,2384,42,2,2,4,50.0%,3m
20370,3,DJKK,2384,121,2,2,4,50.0%,1h
20370,2,魔法少女阿塔尼斯,2384,0,2,3,5,40.0%,46m
20370,3,SwinLu,2384,0,0,1,1,0.0%,1h
20370,1,[望月]萧辰州府,2384,0,0,1,1,0.0%,1h
20370,1,[暴雪六队]多尔兮,2384,0,0,2,2,0.0%,1h
20370,1,太乙,2384,0,0,2,2,0.0%,1h
20370,1,无情的男人,2384,0,0,2,2,0.0%,1h
20370,1,我不会玩,2384,0,0,2,2,0.0%,1h
20370,2,[白给丶兄弟]徐娘半老韵犹存,2384,0,0,5,5,0.0%,35m
20394,3,[世风第三帝国]风剑雪,2383,1332,61,44,105,58.1%,1h
20394,2,[CHP]aklhwek,2383,415,20,31,51,39.2%,29m
20394,2,塔鲁天堂,2383,415,16,24,40,40.0%,1h
20394,1,[CPT]天线宝宝,2383,352,13,12,25,52.0%,1h
20394,1,[乳主头子]DRONAG,2383,307,11,6,17,64.7%,59m
20394,1,IIIIIIIIIIII,2383,284,7,13,20,35.0%,1h
20394,3,Tong,2383,68,6,6,12,50.0%,27m
20394,3,少齐,2383,90,4,11,15,26.7%,1h
20394,1,一生一式一起走,2383,82,3,2,5,60.0%,1h
20394,1,[猫狗大队]SKYWATCHER,2383,104,3,3,6,50.0%,1h
20394,1,[能量]granger,2383,161,3,5,8,37.5%,1h
20394,3,CHENG,2383,97,3,6,9,33.3%,43m
20394,2,[各种少女的梦]百万少女梦,2383,0,2,2,4,50.0%,45m
20394,3,[岁月神殿]坑坑大神,2383,122,2,3,5,40.0%,1h
20394,1,[博丽大结界]博丽灵梦,2383,0,1,0,1,100.0%,33m
20394,3,破晓,2383,0,1,2,3,33.3%,31m
20394,1,我的小女子,2383,97,1,5,6,16.7%,1h
20394,3,[Strike]okay,2383,0,0,1,1,0.0%,27m
20394,1,小小书童,2383,0,0,1,1,0.0%,1h
20394,1,八方大爷,2383,0,0,1,1,0.0%,37m
20394,1,一剑飘香,2383,0,0,1,1,0.0%,41m
20394,1,sdf,2383,0,0,3,3,0.0%,25m
20416,1,新手电脑,2382,776,77,79,156,49.4%,33m
20416,1,潮汐之鸣,2382,1120,42,34,76,55.3%,7m
20416,1,[旋风骑士团]网瘾少女亚丝娜,2382,684,23,36,59,39.0%,17m
20416,1,你的四个老婆,2382,330,14,3,17,82.4%,1h
20416,1,SHANG,2382,262,10,6,16,62.5%,18m
20416,1,璀璨龙魂,2382,267,9,3,12,75.0%,1h
20416,3,ankle,2382,252,9,12,21,42.9%,1h
20416,3,[星灵充电宝]piece,2382,180,6,12,18,33.3%,53m
20416,1,偏爱小单,2382,189,5,3,8,62.5%,1h
20416,1,贱扫一条街,2382,181,4,1,5,80.0%,54m
20416,3,SKT,2382,144,4,7,11,36.4%,32m
20416,1,[KPG2]嘎巴脆,2382,80,4,11,15,26.7%,1h
20416,1,[墨氏孤朝]墨天寒,2382,128,4,11,15,26.7%,19m
20416,1,提尔皮茨酱,2382,116,3,2,5,60.0%,16m
20416,1,[社交学巨可爱]羽帝,2382,0,3,3,6,50.0%,18m
20416,3,星际菜鸟来了,2382,88,3,10,13,23.1%,1h
20416,1,七月,2382,48,2,6,8,25.0%,1h
20416,1,DarkPanda,2382,0,1,0,1,100.0%,5m
20416,3,[NBU]希尔薇,2382,30,1,4,5,20.0%,1h
20416,2,优洛,2382,0,1,4,5,20.0%,6m
20416,3,[情谊至上]九月中,2382,0,1,5,6,16.7%,1h
20416,1,[天枢皎月军]煮酒论英雄,2382,0,0,1,1,0.0%,1h
20416,2,简单的电脑,2382,0,0,1,1,0.0%,1h
20416,3,Backxsj,2382,0,0,1,1,0.0%,1h
20416,2,西湖溅狼,2382,0,0,2,2,0.0%,51m
20441,1,lugg,2381,793,26,28,54,48.1%,1h
20441,1,被神捡到的男人,2381,602,22,22,44,50.0%,26m
20441,1,[别杀我探姬]容我呵呵,2381,358,14,14,28,50.0%,49m
20441,1,杀虫剂,2381,301,12,17,29,41.4%,31m
20441,1,snake,2381,200,10,10,20,50.0%,55m
20441,1,诺克萨斯万岁,2381,163,4,1,5,80.0%,7m
20441,1,[全国修车]caiji,2381,167,4,5,9,44.4%,1h
20441,3,莲湖泛舟客,2381,0,2,6,8,25.0%,52m
20441,1,眺望星空,2381,0,1,0,1,100.0%,1h
20441,1,邵侠,2381,0,1,0,1,100.0%,19m
20441,1,SUPERHEART,2381,0,1,1,2,50.0%,1h
20441,1,浪子挽,2381,0,1,1,2,50.0%,5m
20441,1,[KIT6]skywings,2381,44,1,3,4,25.0%,59m
20441,2,hadas,2381,0,1,4,5,20.0%,6m
20441,1,[星际力量]Rich,2381,0,0,1,1,0.0%,1h
20441,1,神秘村支书,2381,0,0,1,1,0.0%,48m
20441,2,谜之呆毛,2381,0,0,1,1,0.0%,1h
20441,1,落花时节,2381,0,0,1,1,0.0%,21m
20441,1,智商堪忧锐萌萌,2381,0,0,1,1,0.0%,39m
20441,2,[Dran]海绵爆爆,2381,0,0,1,1,0.0%,34m
20441,1,菜鸟,2381,0,0,2,2,0.0%,11m
20462,3,ROY,2380,1352,103,115,218,47.2%,21m
20462,1,GRANDpapapa,2380,632,23,30,53,43.4%,1h
20462,1,MrNobody,2380,373,17,9,26,65.4%,1h
20462,1,你是可爱的猪,2380,322,13,11,24,54.2%,33m
20462,1,神圣卡拉,2380,276,9,4,13,69.2%,5m
20462,3,麻烦让我来,2380,172,5,9,14,35.7%,51m
20462,3,[衡水中学]clouky,2380,0,4,4,8,50.0%,1h
20462,1,八不诫,2380,163,4,8,12,33.3%,1h
20462,1,[开心战队]白给之王,2380,40,2,1,3,66.7%,16m
20462,1,骨灰级,2380,0,2,4,6,33.3%,1h
20462,1,daive,2380,0,2,5,7,28.6%,1h
20462,1,五步之内,2380,0,1,1,2,50.0%,25m
20462,1,[東方幻月舞會]归曼火花一闪,2380,0,1,2,3,33.3%,1h
20462,2,NIGESABI,2380,0,1,4,5,20.0%,1h
20462,3,[T阴吧]maru,2380,30,1,6,7,14.3%,1h
20462,1,伤心的流年,2380,0,0,1,1,0.0%,1h
20462,2,妈个鸡遭重了,2380,0,0,1,1,0.0%,1h
20479,1,[火焰雷兽]Qianniu,2379,1337,58,66,124,46.8%,40m
20479,1,阿呆,2379,1226,46,41,87,52.9%,1h
20479,1,memory,2379,903,37,29,66,56.1%,19m
20479,3,[红烧跳虫]Power,2379,361,17,16,33,51.5%,1h
20479,1,Synth,2379,256,14,15,29,48.3%,1h
20479,1,KISS,2379,402,12,9,21,57.1%,1h
20479,1,[鲲之大]加冰快乐肥宅水,2379,284,7,9,16,43.8%,1h
20479,1,廖斯基,2379,97,4,3,7,57.1%,1h
20479,1,xiaolx,2379,78,3,2,5,60.0%,1h
20479,3,tange,2379,0,3,8,11,27.3%,1h
20479,1,暗六,2379,40,2,1,3,66.7%,1h
20479,2,[为了阿米娅]高坚果,2379,0,1,4,5,20.0%,46m
20479,1,天涯浪人,2379,0,0,1,1,0.0%,1h
20479,1,成为凯瑞甘的男人,2379,0,0,2,2,0.0%,19m
20479,1,[艾尔之主]指挥官,2379,0,0,2,2,0.0%,39m
20494,1,海上升明月,2378,772,48,39,87,55.2%,25m
20494,1,离开我是解脱吗,2378,880,36,36,72,50.0%,55m
20494,3,Alfred,2378,480,20,20,40,50.0%,1h
20494,3,没名,2378,190,12,14,26,46.2%,20m
20494,1,[DJTCG]斗鱼琉某人,2378,323,11,17,28,39.3%,1h
20494,1,舔下霸娼,2378,333,10,8,18,55.6%,52m
20494,1,Tossboy,2378,216,7,1,8,87.5%,52m
20494,1,[306NB]亚服菜菜子,2378,208,6,1,7,85.7%,1h
20494,3,萌萌哒馒头,2378,172,5,8,13,38.5%,19m
20494,3,狩猎星辰,2378,64,4,8,12,33.3%,1h
20494,3,axcolin,2378,121,3,3,6,50.0%,4m
20494,2,诺灬彼岸,2378,102,2,3,5,40.0%,1h
20494,2,[暴风雨]asgold,2378,38,2,5,7,28.6%,47m
20494,3,此情可待成追忆,2378,0,2,6,8,25.0%,1h
20494,3,沉默,2378,0,2,7,9,22.2%,1h
20494,2,不似十三,2378,0,1,4,5,20.0%,1h
20494,2,油炸童年,2378,0,1,4,5,20.0%,6m
20494,2,SCPLAYER,2378,0,0,1,1,0.0%,18m
20494,2,Tip,2378,0,0,1,1,0.0%,1h
20513,3,你凭什么让她难过,2377,1537,89,92,181,49.2%,36m
20513,2,[狼牙盟]ICEY,2377,1414,71,76,147,48.3%,1h
20513,1,流浪汉,2377,1571,65,64,129,50.4%,1h
20513,1,MFRctA,2377,860,36,32,68,52.9%,1h
20513,3,[往事如风]莫才,2377,72,9,9,18,50.0%,12m
20513,2,IIIIIIIIIIII,2377,106,6,11,17,35.3%,1h
20513,1,dayue,2377,177,5,5,10,50.0%,58m
20513,1,南村群童扛把子,2377,188,4,4,8,50.0%,1h
20513,1,风暴之星,2377,170,4,9,13,30.8%,1h
20513,1,[雪松]盲人玩家,2377,88,3,3,6,50.0%,11m
20513,1,[新闻负责人]Duke,2377,82,2,3,5,40.0%,1h
20513,1,新手求轻虐,2377,0,1,0,1,100.0%,1h
20513,1,mdipp,2377,0,1,1,2,50.0%,1h
20513,2,zjzywwyc,2377,0,1,4,5,20.0%,34m
20527,3,飞野,2376,1154,52,49,101,51.5%,1h
20527,3,xiaoz,2376,251,32,40,72,44.4%,31m
20527,1,吕晓是狗,2376,856,27,22,49,55.1%,43m
20527,1,残裤,2376,473,15,9,24,62.5%,41m
20527,1,guang,2376,180,9,1,10,90.0%,46m
20527,1,yurisa,2376,42,2,0,2,100.0%,48m
20527,3,HeavyDan,2376,0,1,0,1,100.0%,1h
20527,3,威严满满抱头丿蹲,2376,0,1,0,1,100.0%,56m
20527,1,[我们是瞎子]啊大幅度,2376,0,1,1,2,50.0%,4m
20527,1,希雅魔琳,2376,93,1,3,4,25.0%,25m
20527,2,nekosu,2376,0,1,4,5,20.0%,6m
20527,1,失明云玩家,2376,36,1,5,6,16.7%,1h
20527,1,遥远的文明,2376,38,1,7,8,12.5%,41m
20527,1,拉啊啦啦啦啦,2376,0,0,1,1,0.0%,19m
20527,1,[镜花水月丶]dsd,2376,0,0,1,1,0.0%,1h
20527,1,极速疾风,2376,0,0,1,1,0.0%,1h
20527,1,Norton,2376,0,0,1,1,0.0%,1h
20527,1,旭东奶你一定能赢,2376,0,0,3,3,0.0%,1h
20545,3,谨慎者,2375,586,173,170,343,50.4%,41m
20545,2,垃圾的克星,2375,749,28,37,65,43.1%,19m
20545,3,看我大蛋蛋,2375,592,23,27,50,46.0%,44m
20545,1,京爷在世,2375,489,17,11,28,60.7%,1h
20545,1,捕捉仙女,2375,427,16,12,28,57.1%,58m
20545,3,[皇权至上]jiuzhe,2375,297,13,17,30,43.3%,56m
20545,3,HAPPY,2375,333,10,13,23,43.5%,60m
20545,1,[达拉姆内务部]hanyu,2375,277,9,5,14,64.3%,1h
20545,1,张顺飞,2375,251,7,13,20,35.0%,26m
20545,1,[光影双修]BJayW,2375,193,5,6,11,45.5%,41m
20545,1,[电气游龙]小周不姓小,2375,142,5,7,12,41.7%,1h
20545,1,山河妄入梦,2375,165,4,1,5,80.0%,1h
20545,1,天璇灵韵,2375,171,4,2,6,66.7%,1h
20545,1,Kriclay,2375,142,3,6,9,33.3%,46m
20545,2,神迹,2375,0,1,4,5,20.0%,1h
20545,2,[云师三骚]上床了吗,2375,0,1,4,5,20.0%,58m
20545,2,good,2375,0,1,4,5,20.0%,11m
20562,3,[老太太钻被窝]开始,2374,1412,110,113,223,49.3%,20m
20562,1,Nate,2374,1390,59,55,114,51.8%,4m
20562,1,陨侍尘,2374,1390,54,47,101,53.5%,14m
20562,1,[CHNova]嬲嬲嬲嬲嬲,2374,1008,34,28,62,54.8%,14m
20562,2,[神武骑士团]Calm,2374,701,30,39,69,43.5%,30m
20562,1,StormofSha,2374,828,26,27,53,49.1%,55m
20562,1,[镜花水月]瞎几把乱打,2374,468,23,1,24,95.8%,1h
20562,3,聚羽为花,2374,475,16,19,35,45.7%,33m
20562,1,太空军校生,2374,364,11,8,19,57.9%,1h
20562,1,十三个人,2374,229,6,2,8,75.0%,33m
20562,1,玲酱,2374,168,4,4,8,50.0%,1h
20562,2,[红茶可以吗]大主教魂魄妖风,2374,46,2,2,4,50.0%,40m
20562,1,[暴雪十七队]默珏,2374,48,1,1,2,50.0%,1h
20562,1,[GSL联赛]云天明,2374,34,1,3,4,25.0%,1h
20562,1,[噼里啪啦粑]四个奶妈八个奶,2374,0,0,1,1,0.0%,16m
20562,2,你的萌友,2374,0,0,1,1,0.0%,1h
20578,3,苍澜星寒,2373,836,35,33,68,51.5%,44m
20578,1,[万事俱来香]SCV,2373,496,20,13,33,60.6%,1h
20578,1,仰望,2373,548,19,18,37,51.4%,1h
20578,1,艾尔之子七夜,2373,516,18,18,36,50.0%,19m
20578,1,来根华子啊,2373,281,15,7,22,68.2%,1h
20578,1,鱿妖气,2373,346,9,14,23,39.1%,16m
20578,2,三尾虎,2373,253,8,11,19,42.1%,1h
20578,1,[快乐白给]showtime,2373,190,5,6,11,45.5%,1h
20578,1,[好方啊]dsg,2373,62,2,4,6,33.3%,41m
20578,1,[TNLtr]熊宝,2373,0,1,0,1,100.0%,1h
20578,1,三刀全出甜心刀,2373,0,1,1,2,50.0%,21m
20578,1,[神族灬]专业偷家二十年,2373,0,1,1,2,50.0%,45m
20578,1,潜行之龟,2373,48,1,1,2,50.0%,41m
20578,2,Pumeer,2373,0,1,4,5,20.0%,58m
20592,1,锁牢之惧,2372,550,25,11,36,69.4%,1h
20592,1,[混元体我女仆]我即天选更是唯一,2372,426,16,19,35,45.7%,57m
20592,1,Robin,2372,483,15,11,26,57.7%,33m
20592,2,人菜瘾大,2372,255,11,12,23,47.8%,1h
20592,1,无悔孤玖,2372,330,10,11,21,47.6%,1h
20592,2,AlexStarII,2372,157,8,9,17,47.1%,13m
20592,3,Otho,2372,178,5,10,15,33.3%,56m
20592,3,凉冰,2372,144,4,8,12,33.3%,56m
20592,2,朕不死尔终究是臣,2372,166,4,8,12,33.3%,29m
20592,2,飙风王子,2372,46,2,1,3,66.7%,58m
20592,1,zerotwo,2372,82,2,3,5,40.0%,48m
20592,1,森宝的战争,2372,96,2,5,7,28.6%,1h
20592,1,linkdao,2372,0,1,1,2,50.0%,18m
20592,3,华零零七,2372,30,1,6,7,14.3%,9m
20592,1,水至清,2372,0,0,1,1,0.0%,26m
20592,1,[神族灬]鬼剑,2372,0,0,1,1,0.0%,5m
20592,1,[LNC]二十三只猫,2372,0,0,2,2,0.0%,1h
20592,1,飞龙骑脸,2372,0,0,3,3,0.0%,4m
20592,1,LEO,2372,0,0,6,6,0.0%,45m
20611,3,[NLYH]冰封王兽,2371,1491,141,147,288,49.0%,3m
20611,1,琴弦上的指尖,2371,1690,137,131,268,51.1%,3m
20611,3,小俊,2371,1535,120,116,236,50.8%,48m
20611,3,高级坑人顾问,2371,1180,97,83,180,53.9%,3m
20611,2,SOS,2371,1276,57,67,124,46.0%,1h
20611,3,爱越,2371,1329,54,67,121,44.6%,3m
20611,1,破月,2371,981,44,31,75,58.7%,1h
20611,1,[绵阳黄旭东]碧绿,2371,1122,35,39,74,47.3%,1h
20611,1,星空月之舞,2371,427,25,20,45,55.6%,53m
20611,2,[克哈的女团]许大大,2371,696,24,38,62,38.7%,59m
20611,1,好好向前,2371,392,18,19,37,48.6%,1h
20611,1,ihdcdream,2371,218,13,8,21,61.9%,48m
20611,3,[胖虎稽查队]Zerg,2371,362,13,19,32,40.6%,19m
20611,1,Ling,2371,357,9,8,17,52.9%,32m
20611,1,一只菜鸡,2371,178,4,10,14,28.6%,18m
20611,2,Sakura,2371,0,3,2,5,60.0%,55m
20611,1,星际,2371,119,2,1,3,66.7%,18m
20611,1,Sail,2371,78,2,4,6,33.3%,1h
20611,1,Sparkling,2371,0,1,0,1,100.0%,1h
20611,1,[神奇的海螺]FRTR,2371,0,1,0,1,100.0%,55m
20611,2,死神之子,2371,0,1,1,2,50.0%,1h
20611,3,[混吃混喝]无法选择,2371,0,1,3,4,25.0%,1h
20611,1,[呆毛来我迦]Llxiang,2371,0,0,1,1,0.0%,1h
20634,1,zaa,2370,892,32,46,78,41.0%,28m
20634,1,坚如磐石,2370,626,20,13,33,60.6%,1h
20634,2,半魂魂,2370,275,10,13,23,43.5%,8m
20634,3,死神终结者,2370,178,10,14,24,41.7%,1h
20634,1,GHS,2370,187,5,7,12,41.7%,1h
20634,1,[纸鸢i]同性才是真爱,2370,144,3,5,8,37.5%,18m
20634,2,抚琴离歌,2370,0,3,8,11,27.3%,1h
20634,1,次当可,2370,34,2,1,3,66.7%,19m
20634,2,三清墨白,2370,0,1,3,4,25.0%,34m
20634,2,蛋蛋爱,2370,0,1,4,5,20.0%,34m
20634,1,浮生若梦,2370,0,0,1,1,0.0%,32m
20634,1,grape,2370,0,0,1,1,0.0%,1h
20634,2,中飞院最后的单纯,2370,0,0,1,1,0.0%,46m
20647,2,周周不是周周,2369,1301,76,67,143,53.1%,44m
20647,3,战神色打,2369,1274,62,69,131,47.3%,1h
20647,1,xianyunyehe,2369,516,15,16,31,48.4%,31m
20647,1,一锤锤死你,2369,194,6,9,15,40.0%,1h
20647,2,同济第一闪,2369,33,5,14,19,26.3%,1h
20647,1,boby,2369,118,4,2,6,66.7%,55m
20647,1,逆锋,2369,167,4,7,11,36.4%,6m
20647,1,bored,2369,46,2,6,8,25.0%,1h
20647,3,好久没玩,2369,0,1,2,3,33.3%,4m
20647,2,[热血即是浪漫]七月,2369,0,1,2,3,33.3%,44m
20647,1,半仙,2369,0,1,3,4,25.0%,59m
20647,1,[底特律KAR]seniorLong,2369,40,1,3,4,25.0%,7m
20647,1,暴君,2369,0,1,5,6,16.7%,39m
20647,1,灼灼,2369,0,1,5,6,16.7%,18m
20647,1,[EnTus]Summer,2369,0,0,3,3,0.0%,1h
20662,1,lIIIIl,2368,1672,63,54,117,53.8%,1h
20662,1,我是菜鸡,2368,774,32,30,62,51.6%,1h
20662,1,星河战队,2368,498,24,27,51,47.1%,41m
20662,1,坏毅,2368,457,20,9,29,69.0%,42m
20662,1,宇寒,2368,501,20,12,32,62.5%,1h
20662,1,[学不完了]模拟电路基础,2368,372,14,8,22,63.6%,46m
20662,3,孙焕佳,2368,360,13,18,31,41.9%,2m
20662,1,SaveME,2368,318,11,10,21,52.4%,14m
20662,1,奔跑的滋水枪,2368,326,10,8,18,55.6%,49m
20662,2,etc,2368,185,9,7,16,56.2%,1h
20662,1,[暴雪三十二隊]语如玉,2368,282,8,5,13,61.5%,43m
20662,1,莫里亚蒂教授,2368,290,7,6,13,53.8%,49m
20662,1,SakuraYae,2368,252,6,6,12,50.0%,26m
20662,1,荀文若,2368,236,6,8,14,42.9%,19m
20662,2,虾仁还要猪心,2368,165,5,11,16,31.2%,40m
20662,1,lkxx,2368,97,4,4,8,50.0%,1h
20662,1,溶解恋色中,2368,188,4,7,11,36.4%,1h
20662,1,游王子讴歌,2368,84,3,5,8,37.5%,1h
20662,1,[DDOS傲世]魅影,2368,38,2,0,2,100.0%,1h
20662,1,逆尘,2368,32,2,2,4,50.0%,7m
20662,1,[HAOREN]勇士,2368,76,2,5,7,28.6%,1h
20662,1,星战零亦,2368,0,1,0,1,100.0%,18m
20662,1,[虚空圣堂议会]宫羽暮晨,2368,38,1,1,2,50.0%,55m
20662,1,泪决,2368,0,1,1,2,50.0%,45m
20662,1,[超神给你看哦]nagee,2368,0,1,2,3,33.3%,5m
20662,1,jin,2368,40,1,3,4,25.0%,1h
20662,1,不太会内战,2368,0,0,1,1,0.0%,1h
20662,1,高深,2368,0,0,1,1,0.0%,1h
20662,1,[灰玖]玖狸,2368,0,0,1,1,0.0%,51m
20662,1,[都是兄贵]战争型四系乃,2368,0,0,1,1,0.0%,5m
20662,2,[XJCN]cartonwei,2368,0,0,2,2,0.0%,20m
20662,1,萧无千,2368,0,0,2,2,0.0%,1h
20662,1,进化,2368,0,0,2,2,0.0%,1h
20695,3,Pisces,2367,655,25,26,51,49.0%,1h
20695,1,千门,2367,486,18,12,30,60.0%,1h
20695,1,[老班干]灰太郎,2367,510,18,15,33,54.5%,19m
20695,3,长江遇上黄河,2367,332,17,12,29,58.6%,44m
20695,1,[秋毫]多出蔬菜长得帅,2367,341,15,9,24,62.5%,32m
20695,2,[恶劣玩家]就偶尔有,2367,163,9,10,19,47.4%,9m
20695,1,[投降也不抵抗]有文化的流氓,2367,275,7,6,13,53.8%,1h
20695,1,emmmm,2367,132,5,7,12,41.7%,55m
20695,3,[冲就完了]一航,2367,146,4,8,12,33.3%,1h
20695,1,在下万叉奔腾,2367,116,3,0,3,100.0%,18m
20695,2,ZSLlove,2367,74,2,4,6,33.3%,34m
20695,1,YUKO,2367,112,2,4,6,33.3%,59m
20695,2,[暴雪三十一队]血雨星锋,2367,0,1,1,2,50.0%,1h
20695,1,hfchengxx,2367,0,1,2,3,33.3%,49m
20695,2,fake,2367,0,1,4,5,20.0%,13m
20695,1,百鬼丸多多,2367,0,0,1,1,0.0%,3m
20695,3,蓦然天下,2367,0,0,1,1,0.0%,52m
20695,1,MrGodFather,2367,0,0,1,1,0.0%,42m
20695,1,[要啥没啥爱咋]someguys,2367,0,0,2,2,0.0%,26m
20695,1,[TB]大天二,2367,0,0,3,3,0.0%,1h
20695,1,[世界的另一头]黄天宇,2367,0,0,3,3,0.0%,14m
20695,2,暗香独醉,2367,0,0,3,3,0.0%,1h
20717,2,千岛寒流,2366,752,183,203,386,47.4%,27m
20717,1,紫川南,2366,1348,44,47,91,48.4%,1h
20717,1,[失去了卡拉]我们还有艾尔,2366,696,30,27,57,52.6%,1h
20717,1,HLH,2366,787,28,26,54,51.9%,1h
20717,1,[MS13战术]citybaboon,2366,379,22,20,42,52.4%,42m
20717,1,saber,2366,513,21,20,41,51.2%,1h
20717,1,Wersn,2366,290,13,11,24,54.2%,1h
20717,1,苍玄,2366,491,13,12,25,52.0%,43m
20717,1,clover,2366,259,9,7,16,56.2%,31m
20717,1,暂无昵称,2366,210,8,2,10,80.0%,1h
20717,1,捎一句再见,2366,145,6,5,11,54.5%,1h
20717,1,他马的,2366,165,4,1,5,80.0%,30m
20717,1,石原里美前男友,2366,96,2,1,3,66.7%,1h
20717,1,百里火照,2366,72,2,4,6,33.3%,25m
20717,3,[C28]糖宝,2366,30,2,6,8,25.0%,1h
20717,1,DarkSnake,2366,0,2,6,8,25.0%,17m
20717,1,北葵回暖南栀,2366,0,1,0,1,100.0%,1h
20717,1,ZXCTTAIR,2366,40,1,1,2,50.0%,1h
20717,1,[暴雪九队]bloodfe,2366,0,1,1,2,50.0%,1h
20717,3,打我呀,2366,0,1,1,2,50.0%,1h
20717,2,过往的云,2366,0,1,3,4,25.0%,1h
20717,1,AssAss,2366,48,1,3,4,25.0%,18m
20717,2,Faker,2366,0,1,4,5,20.0%,6m
20717,1,孤独,2366,0,0,2,2,0.0%,1h
20741,3,虎虎虎,2365,1515,105,108,213,49.3%,9m
20741,1,星空迷失者,2365,635,31,36,67,46.3%,1h
20741,1,bswangcheng,2365,784,27,22,49,55.1%,5m
20741,1,埃蒙小弟,2365,354,12,8,20,60.0%,1h
20741,1,孙嘉玮是麻瓜,2365,199,5,6,11,45.5%,42m
20741,1,猫咪警长爱吃鱼,2365,145,4,5,9,44.4%,60m
20741,1,agitator,2365,142,4,6,10,40.0%,1h
20741,1,Kevin,2365,78,3,3,6,50.0%,49m
20741,2,不纯骚年,2365,136,3,4,7,42.9%,55m
20741,1,渡鸦,2365,0,2,4,6,33.3%,1h
20741,2,大云,2365,46,2,4,6,33.3%,57m
20741,3,[CPT]呵呵博士,2365,0,2,6,8,25.0%,4m
20741,2,阿尔托莉雅,2365,0,1,0,1,100.0%,58m
20741,2,朱古力六六六屮,2365,0,1,1,2,50.0%,6m
20741,3,TanH,2365,0,0,1,1,0.0%,1h
20756,3,ooo,2364,1008,156,162,318,49.1%,1h
20756,1,分隔符,2364,958,65,64,129,50.4%,42m
20756,1,孔布,2364,1629,64,60,124,51.6%,1h
20756,1,麦克雷,2364,461,19,9,28,67.9%,1h
20756,1,ssss,2364,488,14,29,43,32.6%,36m
20756,1,zmxy,2364,312,10,8,18,55.6%,1h
20756,2,[化学工厂]绯月,2364,192,6,5,11,54.5%,16m
20756,1,crazyboy,2364,249,6,8,14,42.9%,18m
20756,1,人族死法示范,2364,156,4,4,8,50.0%,19m
20756,1,末夜,2364,121,3,1,4,75.0%,1h
20756,1,仁爱无疆,2364,117,3,6,9,33.3%,1h
20756,1,qianxun,2364,84,2,5,7,28.6%,60m
20756,1,娟娟,2364,0,2,5,7,28.6%,1h
20756,1,[2v2是什么]烈火雄心,2364,0,1,0,1,100.0%,1h
20756,1,KAILIGEN,2364,0,1,4,5,20.0%,1h
20756,1,好丽友,2364,0,1,5,6,16.7%,3m
20756,2,一个新的时代,2364,0,0,1,1,0.0%,1h
20756,1,MetalBron,2364,0,0,2,2,0.0%,21m
20774,1,[OwenSS]哪个啥的让着点,2363,629,58,58,116,50.0%,25m
20774,1,HansKatze,2363,511,18,12,30,60.0%,1h
20774,1,天选之人,2363,276,9,5,14,64.3%,1h
20774,3,jiatongmin,2363,148,7,11,18,38.9%,1h
20774,1,Seaser,2363,216,5,8,13,38.5%,30m
20774,1,神兽镜,2363,114,4,3,7,57.1%,1h
20774,3,[胜利不择手段]Droupnir,2363,123,2,7,9,22.2%,24m
20774,1,xvrrd,2363,0,1,0,1,100.0%,1h
20774,1,[终极蛇皮队]考拉,2363,0,1,2,3,33.3%,1h
20774,2,STONE,2363,0,0,1,1,0.0%,6m
20774,1,BlueSteel,2363,0,0,1,1,0.0%,1h
20785,1,[你已经死啦]唷林口,2362,1730,80,76,156,51.3%,5m
20785,3,[鹌鹑带星]来一起拉一大一便,2362,1226,65,73,138,47.1%,1h
20785,3,libo,2362,646,61,63,124,49.2%,10m
20785,1,Versuchen,2362,1022,52,56,108,48.1%,20m
20785,3,DrakeVon,2362,547,24,28,52,46.2%,60m
20785,3,[F2ANB]墨茗天悸,2362,613,23,31,54,42.6%,30m
20785,1,豆豆,2362,346,12,14,26,46.2%,4m
20785,1,qdhwdhsufe,2362,331,11,11,22,50.0%,58m
20785,3,贪睡,2362,245,8,11,19,42.1%,1h
20785,1,白宇,2362,262,8,12,20,40.0%,1h
20785,2,iiiiiiiiiiii,2362,199,6,8,14,42.9%,14m
20785,2,养猪大户高某人,2362,204,6,12,18,33.3%,40m
20785,1,铭睇似,2362,146,5,5,10,50.0%,1h
20785,3,[萝莉球]一看就是萌新,2362,199,5,9,14,35.7%,48m
20785,1,connor,2362,158,4,1,5,80.0%,34m
20785,3,耗子尾汁,2362,0,2,6,8,25.0%,1h
20785,2,冬望雪,2362,0,1,0,1,100.0%,40m
20785,2,我是大坑我不坑,2362,0,1,3,4,25.0%,34m
20785,1,刺猬,2362,0,0,1,1,0.0%,4m
20785,1,阿卡丽,2362,0,0,1,1,0.0%,40m
20785,1,Slavowitz,2362,0,0,7,7,0.0%,5m
20806,2,星际见习者,2361,977,74,73,147,50.3%,30m
20806,1,[fvv]coolove,2361,1344,51,47,98,52.0%,1h
20806,1,殇年忆,2361,1081,44,37,81,54.3%,1h
20806,1,全民祸害,2361,921,40,38,78,51.3%,1h
20806,1,xlspt,2361,764,35,28,63,55.6%,1h
20806,1,peter,2361,726,26,22,48,54.2%,4m
20806,1,[C97]DuangDuang,2361,594,19,33,52,36.5%,1h
20806,1,MOUK,2361,434,18,10,28,64.3%,48m
20806,3,刘培茄中将,2361,261,14,10,24,58.3%,1h
20806,1,马克威廉,2361,271,12,17,29,41.4%,27m
20806,1,天焰,2361,279,11,15,26,42.3%,1h
20806,1,虫族就无敌,2361,40,6,0,6,100.0%,46m
20806,2,ZHULU,2361,62,3,6,9,33.3%,1h
20806,1,[海鲜乱炖]Ender,2361,42,2,3,5,40.0%,1h
20806,1,不气不气不气,2361,48,2,7,9,22.2%,1h
20806,2,小睡魔,2361,0,1,4,5,20.0%,35m
20806,2,失落迷迭,2361,0,1,4,5,20.0%,44m
20806,1,Rambo,2361,0,0,1,1,0.0%,1h
20806,3,守护,2361,0,0,1,1,0.0%,1h
20806,1,黑星,2361,0,0,2,2,0.0%,37m
20806,2,会飞的叽叽,2361,0,0,2,2,0.0%,1h
20806,1,Harry,2361,0,0,3,3,0.0%,5m
20806,1,stdent,2361,0,0,3,3,0.0%,56m
20829,1,llllllllllll,2360,907,35,35,70,50.0%,49m
20829,1,[肥宅香蕉船]zdkp,2360,820,27,23,50,54.0%,5m
20829,1,锅巴喷火,2360,569,24,14,38,63.2%,26m
20829,1,forevernow,2360,435,18,15,33,54.5%,1h
20829,3,Zero,2360,493,18,21,39,46.2%,33m
20829,1,Darling,2360,240,9,11,20,45.0%,49m
20829,1,longxuanjian,2360,354,9,14,23,39.1%,1h
20829,2,太空狼,2360,186,8,7,15,53.3%,40m
20829,3,[国际空间站]保时捷,2360,165,5,10,15,33.3%,27m
20829,1,YORk,2360,112,4,4,8,50.0%,19m
20829,2,castle,2360,48,3,4,7,42.9%,40m
20829,1,[内蒙星际联盟]Napoleon,2360,145,2,8,10,20.0%,18m
20829,1,[428NB]襄阳洪世贤,2360,0,1,0,1,100.0%,1h
20829,1,雅诗兰黛,2360,0,1,2,3,33.3%,1h
20829,1,drttyj,2360,40,1,2,3,33.3%,25m
20829,1,彩笔,2360,0,0,6,6,0.0%,54m
20845,2,yuansir,2359,1550,389,403,792,49.1%,1h
20845,1,[CPT]齐齐啪啪,2359,1715,82,73,155,52.9%,1h
20845,1,创世大麦哥,2359,995,66,57,123,53.7%,1h
20845,1,YIBEN,2359,408,35,37,72,48.6%,26m
20845,1,king,2359,709,25,28,53,47.2%,14m
20845,1,dkJAZK,2359,355,12,13,25,48.0%,1h
20845,2,风火连城,2359,256,10,11,21,47.6%,13m
20845,2,酸菜鱼在线挨打,2359,212,8,4,12,66.7%,1h
20845,1,Mata,2359,272,8,10,18,44.4%,1h
20845,1,扫比阿量,2359,190,8,14,22,36.4%,14m
20845,3,普通电脑,2359,153,7,8,15,46.7%,5m
20845,1,suika,2359,154,4,5,9,44.4%,18m
20845,1,[左手狙神]SAE,2359,177,4,6,10,40.0%,4m
20845,1,[秋毫]迟来的缠,2359,82,3,5,8,37.5%,22m
20845,1,laocai,2359,0,2,3,5,40.0%,60m
20845,1,相羽爱乃,2359,91,1,1,2,50.0%,35m
20845,1,狠驴,2359,0,1,1,2,50.0%,46m
20845,1,[越来越瞎]zest,2359,0,1,1,2,50.0%,1h
20845,2,bearmoko,2359,0,1,4,5,20.0%,55m
20845,3,影战,2359,97,1,4,5,20.0%,1h
20845,1,艾米,2359,0,0,1,1,0.0%,1h
20845,2,ggwp,2359,0,0,1,1,0.0%,36m
20845,3,艾尔之光,2359,0,0,2,2,0.0%,1h
20868,3,雪诺大人,2358,1601,101,104,205,49.3%,5m
20868,1,ZSUCK,2358,1555,77,75,152,50.7%,49m
20868,1,SYQ,2358,460,13,10,23,56.5%,1h
20868,1,crimiadisant,2358,414,12,13,25,48.0%,1h
20868,1,jiangguangyi,2358,353,11,7,18,61.1%,33m
20868,1,向问天,2358,256,8,7,15,53.3%,4m
20868,3,爱宝宝,2358,218,6,4,10,60.0%,48m
20868,3,[温柔兔公主]阿天阿天,2358,173,5,4,9,55.6%,1h
20868,1,稷下遗风,2358,190,5,8,13,38.5%,21m
20868,1,[镜花水月丶]nsrdn,2358,114,3,4,7,42.9%,14m
20868,3,一世迷离,2358,30,2,5,7,28.6%,4m
20868,1,[暴雪三队]简单人机,2358,74,2,8,10,20.0%,1h
20868,1,[暴雪十九队]夜影枫,2358,0,1,2,3,33.3%,1h
20868,3,小飞,2358,0,0,1,1,0.0%,1h
20868,3,宜都宜红茶,2358,0,0,1,1,0.0%,1h
20868,1,[社交学导教]星战,2358,0,0,2,2,0.0%,54m
20884,1,龙哥哥,2357,1104,54,59,113,47.8%,1h
20884,2,[XXHZN2]stone,2357,697,32,40,72,44.4%,39m
20884,1,我只会狗招,2357,918,31,38,69,44.9%,1h
20884,1,HanSha,2357,635,22,13,35,62.9%,42m
20884,1,传说圣光,2357,453,14,19,33,42.4%,14m
20884,3,DoflaminGo,2357,322,11,19,30,36.7%,26m
20884,1,至尊大神,2357,316,9,11,20,45.0%,49m
20884,1,[SFF]pig,2357,250,7,12,19,36.8%,1h
20884,1,小憨憨,2357,96,2,2,4,50.0%,1h
20884,1,zzzzzzzZz,2357,40,2,3,5,40.0%,43m
20884,1,tesla,2357,46,2,4,6,33.3%,5m
20884,1,大圣爹陈俊,2357,0,0,1,1,0.0%,48m
20884,1,萌新威望肝出血,2357,0,0,1,1,0.0%,1h
20897,1,aaaaaaaa,2356,1333,55,44,99,55.6%,59m
20897,1,sponsor,2356,672,20,19,39,51.3%,55m
20897,1,[猪猪猪]母鸡不偷酸奶,2356,494,14,11,25,56.0%,1h
20897,1,可乐可不乐,2356,433,14,18,32,43.8%,5m
20897,3,[帝都战神]出门一波,2356,215,6,6,12,50.0%,10m
20897,1,只是蝴蝶不愿意,2356,188,6,6,12,50.0%,4m
20897,1,残梦,2356,158,5,7,12,41.7%,19m
20897,3,应急食品,2356,161,4,6,10,40.0%,1h
20897,1,player,2356,142,4,6,10,40.0%,18m
20897,1,leolian,2356,192,4,7,11,36.4%,1h
20897,1,NOBODY,2356,164,4,9,13,30.8%,54m
20897,1,大以巴龙,2356,105,2,1,3,66.7%,11m
20897,2,好响出去丸,2356,106,2,13,15,13.3%,1h
20897,1,[眉目清秀的]蓝白最爱,2356,0,1,0,1,100.0%,1h
20897,1,nihao,2356,0,1,0,1,100.0%,14m
20897,1,aaa,2356,0,0,1,1,0.0%,31m
20897,1,快乐风男,2356,0,0,1,1,0.0%,3m
20897,1,pangou,2356,0,0,6,6,0.0%,18m
20915,1,[蓝色雨]半只恐龙,2355,1392,190,194,384,49.5%,19m
20915,1,RiderStr,2355,1726,75,73,148,50.7%,1h
20915,3,行侠仗义安度因,2355,1295,71,68,139,51.1%,1h
20915,3,暴雪公司,2355,1253,51,51,102,50.0%,12m
20915,1,帕拉瑞尔,2355,515,19,16,35,54.3%,1h
20915,3,TandC,2355,400,14,19,33,42.4%,9m
20915,1,yangcheng,2355,391,13,18,31,41.9%,1h
20915,3,BigDaddy,2355,335,12,12,24,50.0%,1h
20915,3,寒烟丶忆,2355,299,11,11,22,50.0%,1h
20915,3,[大呲花]不死强,2355,226,9,10,19,47.4%,1h
20915,3,赞美太阳,2355,170,7,7,14,50.0%,45m
20915,1,[来1223]大结局,2355,242,6,6,12,50.0%,1h
20915,3,非洲放羊人,2355,134,6,11,17,35.3%,19m
20915,1,[要啥没啥爱咋]driverxdw,2355,158,4,5,9,44.4%,1h
20915,1,[西伯利亚土豆]鬼怪,2355,116,3,5,8,37.5%,1h
20915,1,梦魇之都,2355,120,3,6,9,33.3%,1h
20915,1,家住海边喜欢浪,2355,141,3,6,9,33.3%,22m
20915,2,nozomi,2355,0,2,3,5,40.0%,13m
20915,1,阿克尼斯,2355,80,2,4,6,33.3%,1h
20915,3,游云,2355,0,2,6,8,25.0%,10m
20915,3,蓝银唐,2355,0,2,6,8,25.0%,36m
20915,2,[一起吃鱼啊]大爱病娇,2355,0,1,0,1,100.0%,1h
20915,1,夏一可我老婆,2355,0,1,0,1,100.0%,57m
20915,2,LXY,2355,0,1,0,1,100.0%,40m
20915,1,[大战一群狗]英语教学组,2355,91,1,1,2,50.0%,60m
20915,2,灵风傲清,2355,0,1,4,5,20.0%,7m
20915,2,糖醋排骨,2355,0,1,5,6,16.7%,13m
20942,1,菠萝,2354,1482,63,76,139,45.3%,20m
20942,1,王文强二,2354,196,46,35,81,56.8%,22m
20942,1,肥皂,2354,466,33,24,57,57.9%,53m
20942,1,[SHNU]凤雏,2354,736,25,24,49,51.0%,1h
20942,1,[极限菜鸟]国产级菜狗,2354,246,13,2,15,86.7%,1h
20942,1,zzz,2354,319,11,8,19,57.9%,1h
20942,1,敛散心,2354,328,10,9,19,52.6%,1h
20942,2,akali,2354,298,8,13,21,38.1%,1h
20942,1,[神圣路易帝国]John,2354,112,4,3,7,57.1%,1h
20942,1,我永远喜欢,2354,144,4,4,8,50.0%,60m
20942,1,萌政委的机械魂,2354,191,4,7,11,36.4%,1h
20942,1,无火的不可燃垃圾,2354,127,3,1,4,75.0%,18m
20942,1,李云龙,2354,130,3,3,6,50.0%,54m
20942,3,一吊撂倒,2354,42,3,8,11,27.3%,1h
20942,1,[看星星咯]远坂时臣,2354,42,2,1,3,66.7%,49m
20942,1,红风凯辛,2354,90,2,2,4,50.0%,33m
20942,1,求带,2354,97,1,1,2,50.0%,1h
20942,2,菜鸽,2354,46,1,1,2,50.0%,35m
20942,1,Respect,2354,0,0,1,1,0.0%,1h
20942,1,卡叔叔丶,2354,0,0,1,1,0.0%,42m
20942,2,SCPLAYER,2354,0,0,1,1,0.0%,23m
20963,3,[DMRz]PartinG,2353,1480,117,124,241,48.5%,10m
20963,3,花生芽,2353,1311,81,88,169,47.9%,33m
20963,1,[TopSC]千叶丶长生,2353,365,13,18,31,41.9%,20m
20963,3,Shygo,2353,326,11,15,26,42.3%,1h
20963,2,[花月]诺晨奶奶,2353,320,10,19,29,34.5%,12m
20963,1,zbw,2353,213,9,7,16,56.2%,19m
20963,1,[励志第一]香脆杏仁饼,2353,206,6,9,15,40.0%,43m
20963,1,[专克嫩头]wbwfiena,2353,195,4,4,8,50.0%,1h
20963,1,[Melt病毒]无春元龙,2353,171,4,5,9,44.4%,1h
20963,1,一个菜鸡,2353,167,4,8,12,33.3%,1h
20963,1,小志,2353,40,2,1,3,66.7%,4m
20963,2,[单推小狐狸]雨玲珑,2353,102,2,5,7,28.6%,52m
20963,1,来啦老哥,2353,97,2,5,7,28.6%,25m
20963,2,[虫合虫合虫合]GuZIZB,2353,0,1,0,1,100.0%,42m
20963,1,恐怖猎杀,2353,0,1,0,1,100.0%,58m
20963,1,llllllllllll,2353,42,1,3,4,25.0%,1h
20963,1,llllllllllll,2353,48,1,3,4,25.0%,1h
20963,2,[Americ]king,2353,0,0,1,1,0.0%,6m
20963,1,drpff,2353,0,0,1,1,0.0%,60m
20963,1,AnthonyJhon,2353,0,0,1,1,0.0%,5m
20983,1,LEMON,2352,1176,85,89,174,48.9%,17m
20983,1,CYF,2352,677,22,20,42,52.4%,1h
20983,1,[KNAT]炙热苹果派,2352,689,20,23,43,46.5%,1h
20983,1,音律,2352,572,17,18,35,48.6%,55m
20983,1,[华溪岛]Kial,2352,432,14,14,28,50.0%,1h
20983,2,mdn,2352,38,6,11,17,35.3%,1h
20983,3,[太玄]勇士不灭,2352,88,5,9,14,35.7%,50m
20983,3,daijuanjuan,2352,181,5,11,16,31.2%,51m
20983,1,starsky,2352,97,4,4,8,50.0%,47m
20983,1,Killer,2352,165,4,7,11,36.4%,1h
20983,1,[诺克萨斯]fchbvg,2352,114,3,3,6,50.0%,1h
20983,1,非法用户,2352,0,3,4,7,42.9%,30m
20983,1,粘液键盘,2352,48,2,2,4,50.0%,1h
20983,2,[菜鸟会]iiuouoii,2352,46,2,4,6,33.3%,6m
20983,1,[死了都要爱]SKY,2352,92,1,1,2,50.0%,34m
20983,1,究极发狂憨八龟,2352,0,1,1,2,50.0%,1h
20983,1,[DMR]一只胖子,2352,46,1,2,3,33.3%,1h
20983,1,ddtnt,2352,0,1,2,3,33.3%,1h
20983,1,落丶樱,2352,97,1,2,3,33.3%,1h
20983,2,[wmtql]scytql,2352,0,1,3,4,25.0%,1h
20983,2,Gabriel,2352,0,1,4,5,20.0%,34m
20983,1,LiiSimple,2352,0,0,4,4,0.0%,1h
21005,1,arrow,2351,1685,65,64,129,50.4%,11m
21005,2,xylo,2351,1063,45,50,95,47.4%,1h
21005,2,Fenix,2351,662,26,37,63,41.3%,17m
21005,1,宇文苍穹,2351,475,18,19,37,48.6%,1h
21005,1,达摩克利斯之剑,2351,399,17,17,34,50.0%,1h
21005,1,HTML,2351,352,15,5,20,75.0%,15m
21005,1,谁家的那小谁,2351,527,15,15,30,50.0%,36m
21005,1,琛灬琛,2351,333,13,11,24,54.2%,1h
21005,1,封号苍穹,2351,302,10,14,24,41.7%,5m
21005,1,赢无翳,2351,263,9,16,25,36.0%,46m
21005,1,一只小林檎,2351,159,5,4,9,55.6%,58m
21005,1,[浙大战队]电池长城,2351,221,5,6,11,45.5%,1h
21005,1,ttaaa,2351,126,4,5,9,44.4%,1h
21005,1,洛天依,2351,165,3,2,5,60.0%,1h
21005,3,[上善若水di]含光君,2351,62,3,3,6,50.0%,1h
21005,3,流觞,2351,97,3,7,10,30.0%,5m
21005,1,[JNFLS]CHaRMING,2351,42,2,4,6,33.3%,1h
21005,1,黑羽塔卡,2351,0,2,4,6,33.3%,25m
21005,3,longer,2351,121,2,6,8,25.0%,21m
21005,1,ALIEZ,2351,0,1,0,1,100.0%,1h
21005,3,TheBigBang,2351,0,1,1,2,50.0%,6m
21005,3,月光下的小狮子,2351,0,1,2,3,33.3%,8m
21005,2,asterope,2351,0,1,2,3,33.3%,1h
21005,2,荒战,2351,0,1,4,5,20.0%,55m
21005,1,酷拉小皮卡,2351,0,0,1,1,0.0%,1h
21030,3,敢采于部,2350,1505,156,167,323,48.3%,5m
21030,3,[镜花水月丿]yangxi,2350,1147,84,89,173,48.6%,19m
21030,1,张大哥,2350,1088,56,53,109,51.4%,1h
21030,1,大爽,2350,1505,55,54,109,50.5%,14m
21030,1,[你瞧不起我吗]alll,2350,805,29,31,60,48.3%,19m
21030,1,蟑螂恶霸,2350,291,10,9,19,52.6%,1h
21030,1,[红莲骑士团]小哥哥,2350,290,9,9,18,50.0%,60m
21030,3,开局退死妈,2350,203,8,10,18,44.4%,1h
21030,1,别打龙龙,2350,239,5,9,14,35.7%,1h
21030,3,羽萧,2350,88,5,10,15,33.3%,32m
21030,1,[FOT]风沐烟苏,2350,152,4,5,9,44.4%,54m
21030,1,[活着为了爆菊]掉分的快乐,2350,32,4,8,12,33.3%,1h
21030,3,[猫神]苏打冻柠绿,2350,70,4,8,12,33.3%,1h
21030,2,陌栀,2350,149,4,9,13,30.8%,1h
21030,1,老贼,2350,48,3,6,9,33.3%,60m
21030,1,coco,2350,131,3,6,9,33.3%,1h
21030,1,[DMR]企鹅,2350,0,2,2,4,50.0%,37m
21030,3,mubai,2350,97,2,2,4,50.0%,48m
21030,1,Dandolo,2350,132,2,2,4,50.0%,26m
21030,1,[谐星与鸡]圣爹亚伯拉罕,2350,0,1,0,1,100.0%,1h
21030,1,歪比吧卟,2350,0,1,0,1,100.0%,51m
21030,1,莫欺我无娘子,2350,0,1,2,3,33.3%,19m
21030,3,YanPeng,2350,96,1,2,3,33.3%,48m
21030,1,谢沐泽,2350,38,1,2,3,33.3%,19m
21030,1,一头猪在飞,2350,48,1,4,5,20.0%,1h
21030,2,龙之魂,2350,0,1,4,5,20.0%,13m
21030,1,星雨,2350,0,1,5,6,16.7%,30m
21030,3,qqxu,2350,0,0,1,1,0.0%,24m
21030,2,nightmare,2350,0,0,1,1,0.0%,54m
21059,1,sha,2349,1664,81,77,158,51.3%,11m
21059,3,白给奇侠,2349,1543,74,81,155,47.7%,1h
21059,1,薛定谔的猫,2349,711,24,31,55,43.6%,5m
21059,1,deeew,2349,612,23,20,43,53.5%,11m
21059,1,凤仙,2349,347,9,8,17,52.9%,32m
21059,1,[秋毫七队]抹茶雪域,2349,216,6,9,15,40.0%,1h
21059,1,[红莲骑士团]阳光校长,2349,239,5,5,10,50.0%,27m
21059,1,你不会懂我,2349,91,2,1,3,66.7%,1h
21059,3,Kids,2349,0,2,6,8,25.0%,36m
21059,1,杀神幽魂,2349,0,1,0,1,100.0%,1h
21059,3,奇点,2349,0,0,1,1,0.0%,10m
21059,2,DDW,2349,0,0,1,1,0.0%,40m
21071,1,zivenchow,2348,1329,48,51,99,48.5%,1h
21071,1,旷工,2348,686,36,29,65,55.4%,1h
21071,3,[酒池肉林]zbcsb,2348,935,35,42,77,45.5%,12m
21071,1,fanmo,2348,721,33,40,73,45.2%,7m
21071,1,Run,2348,810,24,30,54,44.4%,16m
21071,1,秋水浮萍,2348,404,13,10,23,56.5%,42m
21071,1,尼古拉杰克,2348,418,12,13,25,48.0%,1h
21071,1,星空咸鱼,2348,339,11,9,20,55.0%,14m
21071,3,[褚烨协会]miracle,2348,155,6,8,14,42.9%,1h
21071,1,young,2348,260,6,10,16,37.5%,40m
21071,1,dwadwad,2348,123,4,0,4,100.0%,1h
21071,1,你妻任我骑,2348,94,3,4,7,42.9%,60m
21071,1,夜凉如雨,2348,48,2,1,3,66.7%,1h
21071,3,[黄金舰队GA]冷钢意志,2348,30,2,2,4,50.0%,1h
21071,1,巴黎不再哭,2348,0,1,1,2,50.0%,1h
21071,1,[哲学娱乐谐会]帝龘,2348,40,1,2,3,33.3%,16m
21071,1,[H1st]VIC,2348,40,1,6,7,14.3%,4m
21088,1,彩虹,2347,1075,62,48,110,56.4%,1h
21088,1,点点鼠标,2347,1218,40,39,79,50.6%,59m
21088,1,未来道具研究所,2347,838,32,35,67,47.8%,14m
21088,1,Sakura,2347,737,31,27,58,53.4%,1h
21088,1,[Mentor]龙骨,2347,490,14,13,27,51.9%,1h
21088,1,热爱星际,2347,319,12,10,22,54.5%,1h
21088,1,Locip,2347,208,8,10,18,44.4%,1h
21088,1,[神明]噢噢噢噢,2347,177,6,8,14,42.9%,26m
21088,1,lvsanjaer,2347,179,6,8,14,42.9%,55m
21088,1,Ferdinand,2347,204,6,10,16,37.5%,1h
21088,1,[天空之怒]按小东,2347,168,5,7,12,41.7%,1h
21088,1,aseqws,2347,118,4,1,5,80.0%,57m
21088,1,老王稳中带浪,2347,120,3,5,8,37.5%,1h
21088,3,Linmo,2347,34,2,4,6,33.3%,32m
21088,2,[菜有菜的道理]JzyParadise,2347,137,2,5,7,28.6%,34m
21088,2,Migi,2347,0,1,4,5,20.0%,1h
21088,1,RicaroMLU,2347,0,0,1,1,0.0%,54m
21088,1,闪亮之翼,2347,0,0,1,1,0.0%,32m
21088,1,[琴筝]没输过,2347,0,0,1,1,0.0%,1h
21088,2,Troesy,2347,0,0,1,1,0.0%,1h
21088,1,[幻想乡白门楼]安风,2347,0,0,2,2,0.0%,1h
21088,1,繁花散尽,2347,0,0,3,3,0.0%,1h
21088,3,asdfg,2347,0,0,4,4,0.0%,1h
21111,1,[丶月光流水]幕天席地,2346,1457,79,78,157,50.3%,53m
21111,1,[2233娘]figo,2346,1140,64,64,128,50.0%,1h
21111,1,Kleman,2346,973,42,39,81,51.9%,26m
21111,1,loushan,2346,963,40,38,78,51.3%,59m
21111,3,朝圣舰长,2346,493,19,21,40,47.5%,1h
21111,1,badgay,2346,412,12,12,24,50.0%,5m
21111,1,risingup,2346,184,5,5,10,50.0%,19m
21111,3,jklln,2346,120,3,2,5,60.0%,21m
21111,3,星海虫影,2346,97,3,6,9,33.3%,1h
21111,1,可爱的爱姬,2346,88,2,0,2,100.0%,15m
21111,1,[望月]圣灵,2346,48,2,3,5,40.0%,1h
21111,3,[XZZJ]陌秋漓,2346,0,1,1,2,50.0%,36m
21111,2,菜啊菜,2346,0,1,2,3,33.3%,55m
21111,1,我是神,2346,0,1,4,5,20.0%,58m
21111,2,[大风吹]合适的时间,2346,0,1,4,5,20.0%,55m
21111,1,[永恒星域]变形金刚,2346,0,0,1,1,0.0%,5m
21111,1,林幕,2346,0,0,2,2,0.0%,1h
21128,1,Vestal,2345,925,34,27,61,55.7%,1h
21128,3,[对战之队]星际争霸,2345,806,32,42,74,43.2%,36m
21128,1,道神祖,2345,814,27,28,55,49.1%,1h
21128,1,Smile,2345,236,9,7,16,56.2%,60m
21128,1,为国战蛮夷,2345,201,6,5,11,54.5%,1h
21128,1,河北唐山,2345,91,1,2,3,33.3%,1h
21128,1,[绝不白给]司离,2345,0,0,1,1,0.0%,48m
21135,1,[KCCO]搞事情的小周,2344,1646,116,122,238,48.7%,1h
21135,1,伞兵一号,2344,1009,35,39,74,47.3%,1h
21135,1,一之濑的租借费,2344,746,28,31,59,47.5%,1h
21135,3,木鱼大忽悠,2344,476,18,27,45,40.0%,1h
21135,1,[真的很强]我是象大宝,2344,554,15,20,35,42.9%,1h
21135,1,NEVERLAND,2344,325,13,17,30,43.3%,1h
21135,1,Vant,2344,385,12,8,20,60.0%,1h
21135,1,青铜濤,2344,381,12,19,31,38.7%,31m
21135,1,沉默终焉,2344,269,9,7,16,56.2%,1h
21135,1,FrozenKing,2344,272,7,10,17,41.2%,32m
21135,3,[XXHZ31]菲尼克,2344,191,6,5,11,54.5%,1h
21135,1,Aone,2344,118,4,5,9,44.4%,25m
21135,1,[暮Licht]Ichigao,2344,124,3,7,10,30.0%,4m
21135,1,命缘,2344,97,2,6,8,25.0%,25m
21135,1,塔下恶鬼,2344,48,1,1,2,50.0%,1h
21135,1,[暴雪二十三队]乌萨斯战熊,2344,0,1,3,4,25.0%,5m
21135,1,渣渣张很努力啊,2344,40,1,3,4,25.0%,1h
21135,2,皇城烟土,2344,0,1,4,5,20.0%,40m
21135,2,DAGGGG,2344,0,1,4,5,20.0%,6m
21135,1,魂念,2344,0,0,1,1,0.0%,1h
21135,1,快叫巴巴,2344,0,0,1,1,0.0%,1h
21135,2,ZNEWER,2344,0,0,5,5,0.0%,40m
21157,1,姜宏伟,2343,1490,90,99,189,47.6%,51m
21157,1,Deacrer,2343,1194,39,54,93,41.9%,49m
21157,1,那只猪,2343,358,14,10,24,58.3%,7m
21157,1,Ruin,2343,128,6,4,10,60.0%,1h
21157,1,明雨粥,2343,142,5,6,11,45.5%,1h
21157,1,TXC,2343,112,4,4,8,50.0%,19m
21157,3,阿巴,2343,32,3,8,11,27.3%,1h
21157,2,[沙漠联盟]孤单丶守候,2343,46,2,1,3,66.7%,1h
21157,1,倒掉,2343,82,2,4,6,33.3%,4m
21157,1,李氏家族,2343,0,1,0,1,100.0%,1h
21157,1,jackdad,2343,0,1,0,1,100.0%,1h
21157,1,[克哈防卫军]落叶依兰,2343,0,1,5,6,16.7%,1h
21157,1,总有刁民想害朕,2343,42,1,6,7,14.3%,1h
21157,1,[五月花]bodliu,2343,0,0,1,1,0.0%,25m
21157,1,窦晓璇,2343,0,0,2,2,0.0%,49m
21157,1,[桜公馆]Crush,2343,0,0,2,2,0.0%,1h
21173,3,IIIIIIII,2342,1073,198,198,396,50.0%,30m
21173,3,光辉,2342,1220,68,71,139,48.9%,27m
21173,1,不要打我要倒霉的,2342,678,52,55,107,48.6%,11m
21173,2,[DSE]boomba,2342,1079,50,60,110,45.5%,59m
21173,1,[公子世无双]浅幕之年我定逆天,2342,1087,39,35,74,52.7%,49m
21173,1,HarukA,2342,885,37,30,67,55.2%,1h
21173,1,阿萨德,2342,534,21,24,45,46.7%,4m
21173,1,你的农民被屠了,2342,648,20,27,47,42.6%,1h
21173,1,碟祈,2342,349,11,9,20,55.0%,59m
21173,3,tianling,2342,251,7,12,19,36.8%,33m
21173,1,久昀,2342,228,6,6,12,50.0%,33m
21173,1,[MTO]华北一才俊,2342,205,5,5,10,50.0%,53m
21173,1,彬彬路,2342,190,5,9,14,35.7%,1h
21173,3,[反克复联]我叫黑斧阿胡,2342,173,4,7,11,36.4%,1h
21173,1,[猩技蒸爸]Kraken,2342,126,3,1,4,75.0%,54m
21173,2,辅助,2342,0,3,2,5,60.0%,34m
21173,3,折戟沉沙,2342,30,3,8,11,27.3%,1h
21173,2,[Aimro]欧阳,2342,135,2,5,7,28.6%,58m
21173,1,摆渡,2342,89,1,1,2,50.0%,51m
21173,1,芭芭拉冲呀,2342,90,1,1,2,50.0%,1h
21173,2,[GAS丶]Ghost,2342,0,1,4,5,20.0%,44m
21173,1,我大哥就爱喵喵喵,2342,0,0,1,1,0.0%,1h
21173,1,自由之翼,2342,0,0,2,2,0.0%,53m
21196,3,新娘,2341,1282,66,62,128,51.6%,1h
21196,1,tonysun,2341,665,20,20,40,50.0%,1h
21196,1,苹果原子弹,2341,394,19,8,27,70.4%,1h
21196,1,赌王,2341,418,18,18,36,50.0%,27m
21196,3,IIIIIIIIIIII,2341,258,9,7,16,56.2%,1h
21196,1,OneMoreTime,2341,291,8,7,15,53.3%,51m
21196,2,OrzJerry,2341,200,6,7,13,46.2%,14m
21196,1,邱三哥来了,2341,192,4,8,12,33.3%,45m
21196,2,SeverVenm,2341,46,3,3,6,50.0%,57m
21196,1,迷你的小人,2341,0,3,4,7,42.9%,37m
21196,1,暗黑天使,2341,38,2,2,4,50.0%,20m
21196,1,[极限菜鸟]李靖,2341,40,1,2,3,33.3%,1h
21196,1,封鱼大大咸,2341,0,0,1,1,0.0%,18m
21196,2,颜如玉,2341,0,0,1,1,0.0%,40m
21196,1,[天际线]咕噜咕噜,2341,0,0,1,1,0.0%,60m
21196,3,只会憋舰队的菜鸡,2341,0,0,1,1,0.0%,1h
21196,3,我是萌新求放过,2341,0,0,1,1,0.0%,22m
21196,1,Hikki,2341,0,0,2,2,0.0%,33m
21196,1,roar,2341,0,0,3,3,0.0%,18m
21215,1,KIing,2340,1005,78,74,152,51.3%,1h
21215,1,不和谐,2340,1243,68,65,133,51.1%,1h
21215,2,MICCKLY,2340,866,33,45,78,42.3%,28m
21215,3,罗宾,2340,480,21,20,41,51.2%,36m
21215,2,从此风声可细听,2340,493,20,27,47,42.6%,1h
21215,1,水果沙拉勇士,2340,278,9,7,16,56.2%,1h
21215,1,LOGOS,2340,48,5,4,9,55.6%,1h
21215,1,information,2340,74,4,6,10,40.0%,11m
21215,1,[久美子足浴城]VZP,2340,114,3,7,10,30.0%,1h
21215,3,奥创,2340,97,3,7,10,30.0%,1h
21215,2,Devil,2340,0,3,7,10,30.0%,54m
21215,2,君臣,2340,48,2,5,7,28.6%,32m
21215,1,飞星镜池,2340,0,1,2,3,33.3%,15m
21215,3,[银闪的风姬]死神丶凯撒,2340,30,1,5,6,16.7%,32m
21215,3,花园小霸王,2340,0,0,1,1,0.0%,46m
21230,3,王亦轩,2339,1468,104,107,211,49.3%,1h
21230,1,[犀利颤抖机]比比啾,2339,1593,57,57,114,50.0%,14m
21230,3,帝殇,2339,1129,40,49,89,44.9%,1h
21230,1,混元功法帮你治疗,2339,862,36,35,71,50.7%,22m
21230,1,王宝贵,2339,338,32,31,63,50.8%,1h
21230,1,LVEW,2339,604,23,21,44,52.3%,33m
21230,1,[Hdl]风衅,2339,665,20,19,39,51.3%,25m
21230,3,[一群谐星]Abelard,2339,405,16,21,37,43.2%,33m
21230,1,[ExpDrv]Gekkoma,2339,396,12,15,27,44.4%,7m
21230,3,小字肖珂欣,2339,247,9,9,18,50.0%,1h
21230,1,[瘾大眼瞎]抚月居士,2339,142,5,2,7,71.4%,31m
21230,1,ZooEy,2339,180,5,3,8,62.5%,1h
21230,1,[最牛的菜鸟队]NothingKing,2339,78,3,3,6,50.0%,25m
21230,1,HXR,2339,76,3,4,7,42.9%,4m
21230,2,Axlx,2339,90,3,6,9,33.3%,1h
21230,1,mnlyn,2339,120,3,8,11,27.3%,36m
21230,1,丛林小子,2339,38,2,2,4,50.0%,33m
21230,1,爱笑的王浩浩,2339,145,2,2,4,50.0%,47m
21230,3,打酱油,2339,0,1,1,2,50.0%,1h
21230,1,哥的风骚你不懂,2339,0,1,2,3,33.3%,19m
21230,2,流烟,2339,0,1,4,5,20.0%,1h
21230,1,一只白狐狸,2339,0,0,1,1,0.0%,1h
21230,1,[秋毫]胖呼呼,2339,0,0,1,1,0.0%,14m
21230,1,遗忘随云,2339,0,0,2,2,0.0%,3m
21254,3,战影,2338,1429,78,74,152,51.3%,1h
21254,1,[小鸡屠宰场9]王者韬,2338,585,24,25,49,49.0%,1h
21254,1,红龙,2338,462,17,21,38,44.7%,1h
21254,3,斥言,2338,263,8,13,21,38.1%,1h
21254,1,angelos,2338,156,4,2,6,66.7%,46m
21254,3,名字好难起,2338,148,3,5,8,37.5%,6m
21254,1,求求你们别脏,2338,0,1,0,1,100.0%,1h
21254,1,[官翻战队]小朋友的迷失,2338,0,1,3,4,25.0%,48m
21254,1,小黄保护协会,2338,0,1,3,4,25.0%,20m
21254,1,打倒阿斯利亚,2338,36,1,3,4,25.0%,1h
21254,2,伪天使冷魅,2338,0,1,4,5,20.0%,44m
21254,3,[NLHR]fluito,2338,0,0,1,1,0.0%,1h
21254,1,[DMRc]龚羿达,2338,0,0,2,2,0.0%,57m
21254,1,[星际大镖客]Nobody,2338,0,0,2,2,0.0%,1h
21254,1,闪光少女孙一峰,2338,0,0,2,2,0.0%,1h
21254,2,沈一,2338,0,0,5,5,0.0%,6m
21270,1,爱哭的毛毛虫,2337,1741,92,90,182,50.5%,49m
21270,1,回忆空城,2337,1358,57,59,116,49.1%,49m
21270,1,炽焰,2337,511,20,9,29,69.0%,1h
21270,2,迦拉克隆,2337,439,15,25,40,37.5%,43m
21270,1,略略,2337,85,15,26,41,36.6%,1h
21270,1,ImProVise,2337,300,12,8,20,60.0%,1h
21270,1,祁轩铭,2337,374,12,11,23,52.2%,1h
21270,1,斯巴拉西,2337,420,12,14,26,46.2%,31m
21270,3,董先生,2337,278,9,13,22,40.9%,1h
21270,2,暗夜之骑士,2337,219,7,13,20,35.0%,55m
21270,1,[DJTCG]BEILIDADI,2337,220,6,9,15,40.0%,38m
21270,1,[YINGJI]沐渊,2337,161,5,6,11,45.5%,38m
21270,1,PERSYEE,2337,104,3,0,3,100.0%,1h
21270,1,纸先生,2337,156,3,3,6,50.0%,16m
21270,1,seaX,2337,152,3,4,7,42.9%,7m
21270,1,名称未定,2337,124,2,2,4,50.0%,5m
21270,1,EDC,2337,0,1,0,1,100.0%,20m
21270,2,observe,2337,0,1,4,5,20.0%,7m
21270,1,[起舞弄清影]殊荣,2337,0,0,1,1,0.0%,31m
21270,1,lczt,2337,0,0,2,2,0.0%,16m
21290,3,Drhuang,2336,1507,483,518,1001,48.3%,60m
21290,1,hansdhs,2336,1570,108,106,214,50.5%,1h
21290,1,deluxe,2336,905,89,81,170,52.4%,59m
21290,1,沙奇狗的忧伤,2336,1185,42,45,87,48.3%,1h
21290,1,玉女窒息,2336,553,38,14,52,73.1%,36m
21290,1,月亮捕手,2336,740,38,27,65,58.5%,1h
21290,1,毒药咚咚,2336,955,34,39,73,46.6%,53m
21290,1,IIIIIIIIIIII,2336,702,22,23,45,48.9%,5m
21290,3,[miku守护]enborn,2336,402,14,22,36,38.9%,9m
21290,1,simpson,2336,271,10,16,26,38.5%,1h
21290,3,oudear,2336,238,7,11,18,38.9%,1h
21290,1,大混混,2336,167,6,5,11,54.5%,22m
21290,1,[时令]零时雨,2336,196,5,9,14,35.7%,1h
21290,3,SCV,2336,142,5,11,16,31.2%,53m
21290,1,Evel,2336,116,4,0,4,100.0%,25m
21290,1,四宫辉夜,2336,123,4,4,8,50.0%,1h
21290,3,[金盾男科医院]随机生成什么鬼名,2336,149,4,5,9,44.4%,1h
21290,2,百战秋铭,2336,114,3,2,5,60.0%,1h
21290,1,Ahoyan,2336,44,2,4,6,33.3%,1h
21290,1,[Fear]蛋炒饭,2336,0,1,0,1,100.0%,58m
21290,1,魔羽,2336,0,1,0,1,100.0%,36m
21290,1,皮球导弹,2336,0,0,2,2,0.0%,1m
21290,3,人不猥琐枉少年,2336,0,0,2,2,0.0%,1h
21290,1,gdtjw,2336,0,0,5,5,0.0%,4m
21314,1,凌风箭手,2335,1265,189,187,376,50.3%,31m
21314,1,忧丶零少,2335,1363,81,77,158,51.3%,1h
21314,2,马列的红茶,2335,1340,78,78,156,50.0%,1h
21314,3,风化信仰,2335,610,55,53,108,50.9%,9m
21314,1,Tanke,2335,492,22,11,33,66.7%,1h
21314,1,mmp,2335,466,15,17,32,46.9%,11m
21314,3,优秀锦,2335,263,9,4,13,69.2%,1h
21314,3,金刚大头娃,2335,261,9,11,20,45.0%,1h
21314,1,SANGVISFERR,2335,194,6,6,12,50.0%,19m
21314,1,AtEasE,2335,261,6,9,15,40.0%,30m
21314,1,灯火听雨眠,2335,0,3,10,13,23.1%,1h
21314,1,[STCG]Glory,2335,90,2,1,3,66.7%,59m
21314,1,LCCTZ,2335,0,0,2,2,0.0%,26m
21327,2,爆炸虫虫,2334,1475,89,102,191,46.6%,19m
21327,1,dominator,2334,301,15,18,33,45.5%,1h
21327,1,老狼大盘鸡,2334,334,14,8,22,63.6%,34m
21327,1,不问苍生,2334,236,12,10,22,54.5%,1h
21327,1,我要重新集结部队,2334,346,10,12,22,45.5%,22m
21327,2,平凡人生,2334,208,9,14,23,39.1%,40m
21327,1,王楚,2334,96,3,4,7,42.9%,1h
21327,1,人机,2334,38,2,1,3,66.7%,1h
21327,1,liopion,2334,44,2,4,6,33.3%,1h
21327,2,灵虎,2334,0,2,4,6,33.3%,7m
21327,2,AdamREK,2334,94,2,5,7,28.6%,33m
21327,1,宗师之鹰,2334,0,1,0,1,100.0%,1h
21327,1,狗哥是我的,2334,0,1,0,1,100.0%,31m
21327,1,飞扬呵呵呵,2334,0,1,0,1,100.0%,1h
21327,1,[8v1玩泥巴]香风智乃,2334,88,1,2,3,33.3%,1h
21327,1,[艾尔之主]solarash,2334,0,0,1,1,0.0%,7m
21327,2,爵爷,2334,0,0,1,1,0.0%,1h
21327,1,dibur,2334,0,0,2,2,0.0%,1h
21345,2,FAFAFA,2333,542,21,30,51,41.2%,10m
21345,3,为你变乖,2333,465,17,23,40,42.5%,12m
21345,2,织田信长,2333,244,10,2,12,83.3%,24m
21345,2,阿泽的老父亲,2333,344,10,16,26,38.5%,53m
21345,3,三江飞雀,2333,211,7,10,17,41.2%,1h
21345,3,[中南大学官网]詹台清,2333,186,6,3,9,66.7%,10m
21345,3,自由,2333,148,4,9,13,30.8%,1h
21345,3,wjh,2333,123,3,2,5,60.0%,43m
21345,1,爱安安真是太好了,2333,112,3,2,5,60.0%,1h
21345,1,[WYHJT]霓人,2333,121,2,2,4,50.0%,1h
21345,2,又菜又爱玩的菜鸡,2333,0,1,0,1,100.0%,58m
21345,2,随风寻梦,2333,0,1,2,3,33.3%,1h
21345,2,[世界树]优衣对不起,2333,0,1,4,5,20.0%,19m
21345,2,[夙愿天下]面对疾风吧,2333,0,1,5,6,16.7%,58m
21345,2,[DMRc]瓦尔基里之约,2333,0,0,1,1,0.0%,1h
21345,3,[人类防卫阵线]Raven,2333,0,0,1,1,0.0%,1h
21345,1,[朵朵]九幽雪狐,2333,0,0,2,2,0.0%,60m
21345,3,[白银杀手]崔琦,2333,0,0,8,8,0.0%,1h
21363,1,逐鹿云梦丿,2332,367,11,9,20,55.0%,58m
21363,1,tina,2332,288,10,9,19,52.6%,42m
21363,1,ACUP,2332,189,8,3,11,72.7%,5m
21363,1,丿殇灬魅影,2332,248,8,10,18,44.4%,5m
21363,1,高高,2332,258,6,7,13,46.2%,1m
21363,1,很爱过谁会舍得,2332,120,2,2,4,50.0%,27m
21363,2,冰石千羽,2332,0,2,9,11,18.2%,1h
21363,2,Ehemann,2332,0,1,0,1,100.0%,55m
21363,2,这么远那么近,2332,30,1,1,2,50.0%,1h
21363,2,[CPT]月乌,2332,46,1,1,2,50.0%,1h
21363,1,小怪兽先生,2332,97,1,1,2,50.0%,1h
21363,1,pacific,2332,40,1,2,3,33.3%,22m
21363,3,孤独莫,2332,30,1,3,4,25.0%,36m
21363,2,[花花fans]Louis,2332,0,0,1,1,0.0%,1h
21377,1,necoarc,2331,446,19,12,31,61.3%,11m
21377,1,Reurl,2331,110,5,7,12,41.7%,1h
21377,3,王不留行,2331,30,4,6,10,40.0%,4m
21377,1,流泪的铁罐,2331,144,3,1,4,75.0%,25m
21377,3,Silent,2331,121,3,8,11,27.3%,1h
21377,2,nice,2331,60,2,1,3,66.7%,1h
21377,2,MAXOPG,2331,30,1,2,3,33.3%,17m
21377,3,moonwimd,2331,0,0,1,1,0.0%,1h
21377,2,[SC2战队]昆阿圭罗,2331,0,0,1,1,0.0%,14m
21377,1,second,2331,0,0,1,1,0.0%,1h
21377,2,SilverRay,2331,0,0,1,1,0.0%,1h
21377,1,Logic,2331,0,0,2,2,0.0%,1h
21389,1,faker,2330,1164,83,77,160,51.9%,1h
21389,1,粉碎者,2330,479,21,26,47,44.7%,42m
21389,3,Asuka,2330,605,21,29,50,42.0%,56m
21389,1,不是吧,2330,453,16,16,32,50.0%,1h
21389,1,chunshanjun,2330,497,16,23,39,41.0%,59m
21389,1,Rhapsody,2330,322,10,13,23,43.5%,60m
21389,3,我喜欢的人叫蓝澈,2330,232,7,12,19,36.8%,1h
21389,3,[星际新手上路]rookie,2330,156,6,14,20,30.0%,33m
21389,2,[鲲之大]小萌新求师父,2330,154,5,1,6,83.3%,1h
21389,1,大棒给你吃,2330,174,5,4,9,55.6%,1h
21389,1,Maru,2330,178,5,6,11,45.5%,16m
21389,2,求带,2330,145,4,3,7,57.1%,8m
21389,1,ytdjyjgjkh,2330,237,4,6,10,40.0%,1h
21389,1,STARXF,2330,118,3,6,9,33.3%,54m
21389,3,武德,2330,0,2,6,8,25.0%,1h
21389,2,佩奇,2330,0,1,0,1,100.0%,1h
21389,2,MBOMBE,2330,0,1,0,1,100.0%,54m
21389,3,时空,2330,0,1,0,1,100.0%,1h
21389,1,[暴雪十八队]我爸刚弄死他,2330,40,1,3,4,25.0%,1h
21389,1,HENRY,2330,48,1,3,4,25.0%,38m
21389,2,[HFS]HarrisNavy,2330,0,0,1,1,0.0%,6m
21389,1,追风赶海鸭,2330,0,0,2,2,0.0%,1h
21389,1,[给力嗷]zydbb,2330,0,0,6,6,0.0%,19m
21412,2,[慢手e族]啊浩你可以的,2329,1189,130,144,274,47.4%,1h
21412,1,天下无泪,2329,1084,65,57,122,53.3%,33m
21412,1,[小鸡屠宰场8]咸鱼秃头严,2329,567,43,37,80,53.8%,58m
21412,1,Seliver,2329,331,31,25,56,55.4%,19m
21412,1,军莫问,2329,892,29,26,55,52.7%,33m
21412,1,决定,2329,635,27,20,47,57.4%,27m
21412,1,迟疑,2329,508,18,18,36,50.0%,26m
21412,2,sunrays,2329,226,8,2,10,80.0%,1h
21412,1,点撒打算,2329,261,8,5,13,61.5%,22m
21412,1,ILXI,2329,139,5,1,6,83.3%,1h
21412,1,[内战霸主]哒哒哒哒哒,2329,145,3,2,5,60.0%,38m
21412,1,战斗之裤,2329,82,3,3,6,50.0%,36m
21412,1,yyyct,2329,0,3,4,7,42.9%,22m
21412,1,[萌新总队]打死你个小瓜皮,2329,91,2,1,3,66.7%,7m
21412,2,寂灭寒冰,2329,32,2,1,3,66.7%,14m
21412,2,无限剑制,2329,46,2,2,4,50.0%,11m
21412,2,南寒,2329,60,2,2,4,50.0%,24m
21412,2,刁蛮二娃,2329,0,2,3,5,40.0%,34m
21412,2,SHEHUINICHEN,2329,0,2,4,6,33.3%,57m
21412,2,李毅大帝真吊死,2329,42,2,4,6,33.3%,1h
21412,2,咣咣撞大墙,2329,136,2,5,7,28.6%,55m
21412,2,哈哈哈,2329,0,1,0,1,100.0%,1h
21412,2,insomnia,2329,0,1,4,5,20.0%,34m
21412,1,白烛葵,2329,0,1,5,6,16.7%,6m
21412,3,CaesarKing,2329,0,0,1,1,0.0%,1h
21412,1,狼王,2329,0,0,1,1,0.0%,1h
21412,1,[久美子]Berserker,2329,0,0,2,2,0.0%,5m
21439,3,没有名字不能玩,2328,1350,112,122,234,47.9%,1h
21439,1,MRnoob,2328,1056,88,91,179,49.2%,1m
21439,3,不要按农民,2328,620,48,53,101,47.5%,1h
21439,3,不讲武德,2328,658,24,38,62,38.7%,11m
21439,1,[送葬]德川家康,2328,584,18,20,38,47.4%,49m
21439,1,Rosmontis,2328,495,16,20,36,44.4%,1h
21439,3,大道寺知世,2328,410,16,20,36,44.4%,1m
21439,2,鸶翎骷,2328,371,16,24,40,40.0%,1h
21439,1,咖喱,2328,372,13,16,29,44.8%,50m
21439,1,lllllllllwx,2328,470,13,22,35,37.1%,1h
21439,3,[海湾特殊队]发拉利嗨,2328,302,10,15,25,40.0%,21m
21439,3,小电脑同学,2328,90,7,6,13,53.8%,27m
21439,1,[这把打快攻]爆草混血外国妞,2328,202,5,5,10,50.0%,1h
21439,2,[透一下清酒]我得重新集结枪兵,2328,167,3,13,16,18.8%,1h
21439,1,威威,2328,36,2,4,6,33.3%,22m
21439,2,[请帮我嘴交谢]LZZJW,2328,0,1,0,1,100.0%,54m
21439,1,游戏毁灭者,2328,0,0,1,1,0.0%,6m
21439,1,nemo,2328,0,0,3,3,0.0%,1h
21457,2,厉飞羽,2327,1502,92,91,183,50.3%,1m
21457,2,Blackmagic,2327,1149,70,73,143,49.0%,1h
21457,3,killerloura,2327,943,36,40,76,47.4%,53m
21457,1,醉鬼炎,2327,283,18,18,36,50.0%,1h
21457,1,暗夜星辰,2327,326,10,27,37,27.0%,1h
21457,1,[暴雪十队]hxdgssyf,2327,264,8,12,20,40.0%,36m
21457,3,TSG,2327,192,5,3,8,62.5%,1h
21457,1,dfdsfsdf,2327,144,4,7,11,36.4%,1h
21457,1,[大主教后援团]拥抱战斗的荣耀,2327,124,3,2,5,60.0%,1h
21457,1,黄幽,2327,74,3,5,8,37.5%,25m
21457,1,欧姆龍,2327,144,3,7,10,30.0%,6m
21457,3,[Mikon]丛雨世界第一,2327,108,2,3,5,40.0%,32m
21457,2,SWF,2327,0,1,2,3,33.3%,1h
21457,2,sohol,2327,0,1,4,5,20.0%,1h
21457,1,吾闪耀的芝士蛋挞,2327,36,1,5,6,16.7%,37m
21457,1,我菜我自豪,2327,44,1,5,6,16.7%,19m
21457,2,MVPhelp,2327,0,0,1,1,0.0%,52m
21474,1,DeathCoil,2326,1499,59,55,114,51.8%,43m
21474,1,爱情合作,2326,679,35,24,59,59.3%,5m
21474,2,FBMio,2326,836,32,27,59,54.2%,48m
21474,1,暗影之龙,2326,693,26,30,56,46.4%,49m
21474,3,[梦瑾空人心]天使之翼,2326,570,20,26,46,43.5%,49m
21474,2,安因兹乌尔贡,2326,404,16,15,31,51.6%,14m
21474,1,DKYG,2326,407,13,12,25,52.0%,59m
21474,1,鱼洞,2326,282,12,6,18,66.7%,1h
21474,1,DemonSakura,2326,201,9,4,13,69.2%,26m
21474,1,哈哈哈哈,2326,284,9,7,16,56.2%,1h
21474,1,佬魚,2326,216,6,8,14,42.9%,1h
21474,1,iiiiiiiiiiii,2326,166,5,7,12,41.7%,7m
21474,2,青青青青云,2326,0,1,1,2,50.0%,45m
21474,2,阿羊一级棒,2326,96,1,2,3,33.3%,47m
21474,2,奈奈奈奈子,2326,0,1,4,5,20.0%,1h
21474,2,[Holygl]噬魂,2326,0,1,5,6,16.7%,33m
21474,2,[丶幸存丶]凌绮枫,2326,0,0,1,1,0.0%,14m
21474,1,general,2326,0,0,2,2,0.0%,1h
21492,1,TwalkmanC,2325,1748,125,138,263,47.5%,1h
21492,2,[慢手e族]过来我给你说,2325,1482,89,86,175,50.9%,12m
21492,1,[职业选手]南二环的猫,2325,1239,65,66,131,49.6%,1h
21492,2,[您好]吹雨心,2325,1048,48,44,92,52.2%,1h
21492,1,您别急来打后期,2325,556,46,40,86,53.5%,57m
21492,1,阿利克斯莫瑟,2325,440,20,9,29,69.0%,1h
21492,1,XUANHANG,2325,433,16,18,34,47.1%,34m
21492,1,[不会散枪兵丶]Halfedcookie,2325,458,13,13,26,50.0%,48m
21492,1,[舅是何平]鲸落,2325,266,11,13,24,45.8%,5m
21492,1,sdasdasd,2325,396,11,13,24,45.8%,1h
21492,1,jacelu,2325,299,10,6,16,62.5%,1h
21492,3,剑来,2325,271,9,13,22,40.9%,1h
21492,1,阿尔布雷特,2325,186,8,4,12,66.7%,19m
21492,1,浪子走天涯,2325,220,8,15,23,34.8%,1h
21492,1,年轻人不讲武德,2325,170,6,5,11,54.5%,41m
21492,3,天马星神,2325,193,6,10,16,37.5%,51m
21492,1,enkidu,2325,191,5,8,13,38.5%,1h
21492,2,我不是山的那边,2325,0,4,2,6,66.7%,7m
21492,2,sorry,2325,46,2,0,2,100.0%,1h
21492,1,西洒街吴彦祖,2325,94,2,5,7,28.6%,1h
21492,1,豹豹不傻,2325,0,1,1,2,50.0%,22m
21492,1,风城歌舞诗,2325,0,1,2,3,33.3%,60m
21492,1,[秋毫]Delight,2325,36,1,4,5,20.0%,19m
21492,1,哈诺,2325,42,1,4,5,20.0%,16m
21492,2,落叶达鸣,2325,0,1,4,5,20.0%,47m
21492,1,陌上北,2325,40,1,5,6,16.7%,1h
21492,2,woshisb,2325,0,1,5,6,16.7%,6m
21492,2,訾璇,2325,0,0,1,1,0.0%,1h
21492,1,xxyxxyxxy,2325,0,0,1,1,0.0%,38m
21521,3,今晚打老虎,2324,950,63,74,137,46.0%,44m
21521,1,别野兵营了,2324,1112,58,52,110,52.7%,22m
21521,1,jerry,2324,410,15,16,31,48.4%,25m
21521,1,Innovation,2324,487,15,18,33,45.5%,19m
21521,1,Gilgamesh,2324,261,7,10,17,41.2%,6m
21521,1,秒杀,2324,48,5,4,9,55.6%,46m
21521,3,[CPT]仙师完败,2324,161,5,10,15,33.3%,50m
21521,2,饭饭,2324,92,3,5,8,37.5%,1h
21521,2,spril,2324,181,3,12,15,20.0%,52m
21521,1,[响当当水友]iiiiiiinnova,2324,38,1,3,4,25.0%,42m
21521,2,milk,2324,0,0,1,1,0.0%,17m
21521,2,没有战术直接莽,2324,0,0,1,1,0.0%,1h
21521,2,[社交学教授]wdnmd,2324,0,0,1,1,0.0%,1h
21521,1,[由我们重回]温柔撩人醉,2324,0,0,1,1,0.0%,1h
21521,3,[雾之湖红魔馆]蕾米莉亚斯卡雷特,2324,0,0,5,5,0.0%,57m
21536,2,Erict,2323,613,21,14,35,60.0%,14m
21536,1,[暴雪我是你爹]神龙大侠,2323,458,20,15,35,57.1%,26m
21536,1,xnono,2323,582,17,18,35,48.6%,1h
21536,3,以理服人,2323,388,15,16,31,48.4%,12m
21536,3,Hellhound,2323,270,8,9,17,47.1%,1h
21536,2,剑徒,2323,172,8,14,22,36.4%,1h
21536,1,[流河]Berserker,2323,162,5,6,11,45.5%,1h
21536,1,郗鉴,2323,168,3,5,8,37.5%,40m
21536,1,蛆虫型玩家,2323,0,3,6,9,33.3%,1h
21536,1,朝九晚五的玩家,2323,90,2,4,6,33.3%,3m
21536,1,尼可莱,2323,48,2,8,10,20.0%,37m
21536,1,请针对我谢谢,2323,0,1,0,1,100.0%,1h
21536,1,STY,2323,0,1,1,2,50.0%,1h
21536,1,浩哥,2323,0,1,2,3,33.3%,1h
21536,1,贵州普华制药,2323,42,1,4,5,20.0%,1h
21536,1,巨讨厌虫族,2323,0,0,2,2,0.0%,1h
21552,1,杰洛斯,2322,1725,166,154,320,51.9%,1h
21552,1,[H1st]SCPLAYER,2322,1106,99,108,207,47.8%,16m
21552,2,flahm,2322,812,36,28,64,56.2%,1h
21552,1,[菜有菜的道理]哒嗳,2322,600,19,19,38,50.0%,1m
21552,3,王者无敌,2322,372,14,22,36,38.9%,60m
21552,1,狙击手仍在,2322,183,13,7,20,65.0%,1h
21552,1,空空如也,2322,364,12,15,27,44.4%,1h
21552,2,小萌新,2322,324,11,6,17,64.7%,1h
21552,1,[CPT]圣剑可以不掉吗,2322,332,11,10,21,52.4%,1h
21552,1,[失恋阵线联盟]czy,2322,220,7,8,15,46.7%,1h
21552,1,[诅咒]小小傲岸,2322,237,6,6,12,50.0%,1h
21552,1,弱鸡,2322,118,4,1,5,80.0%,1h
21552,1,[CPT]大河,2322,146,4,7,11,36.4%,1h
21552,3,Badwoman,2322,30,2,1,3,66.7%,36m
21552,1,[懒散]onlyone,2322,48,2,4,6,33.3%,1h
21552,2,[曾经一群兔兔]曾经有一只兔子,2322,0,1,0,1,100.0%,52m
21552,2,[嘤嘤樱]坑坑,2322,0,1,0,1,100.0%,1h
21552,2,星际之遗,2322,30,1,1,2,50.0%,14m
21552,2,ACE,2322,34,1,2,3,33.3%,53m
21571,1,云中客,2321,979,37,43,80,46.2%,50m
21571,1,[嫩爽口美鲍鱼]秋风,2321,604,24,24,48,50.0%,1h
21571,1,[萌萌哒鸡]血骑,2321,582,20,23,43,46.5%,1h
21571,1,至臻灬柒,2321,437,19,11,30,63.3%,1h
21571,1,金太阳,2321,569,18,16,34,52.9%,1h
21571,2,Monk,2321,393,17,5,22,77.3%,1h
21571,1,爷傲奶我何,2321,410,17,13,30,56.7%,1h
21571,1,PersiaJuliet,2321,344,14,15,29,48.3%,1h
21571,1,[不服输就对了]小孩子,2321,437,13,13,26,50.0%,15m
21571,3,ThoughtRead,2321,234,9,10,19,47.4%,1h
21571,2,七点必起,2321,262,9,11,20,45.0%,42m
21571,1,与之爽爽,2321,300,7,19,26,26.9%,1h
21571,1,[社交学大可爱]WEALFJ,2321,202,6,7,13,46.2%,57m
21571,1,飘逸的字体,2321,192,6,10,16,37.5%,1h
21571,3,Life,2321,186,5,7,12,41.7%,1h
21571,1,[看我朵蜜你]luoaotian,2321,142,4,3,7,57.1%,1h
21571,1,打不过就投降,2321,118,4,7,11,36.4%,19m
21571,1,夜光,2321,142,3,3,6,50.0%,1h
21571,1,圣神龙皇,2321,42,2,2,4,50.0%,1h
21571,1,Anger,2321,137,2,8,10,20.0%,27m
21571,1,JJW,2321,0,1,1,2,50.0%,1h
21571,1,keke,2321,89,1,2,3,33.3%,19m
21571,1,幼女扶她喝牛奶,2321,0,1,2,3,33.3%,19m
21571,2,lzh,2321,48,1,3,4,25.0%,1h
21571,2,叼豪逗杰,2321,0,1,14,15,6.7%,10m
21571,2,[是我赢了]SCPX,2321,0,0,1,1,0.0%,17m
21571,2,zxh,2321,0,0,2,2,0.0%,19m
21571,2,单推人,2321,0,0,5,5,0.0%,36m
21599,1,[WIE]帝俊,2320,1562,72,77,149,48.3%,1h
21599,1,滑天下之大稽,2320,1141,55,44,99,55.6%,1h
21599,1,[不知不觉天亮]小白书生,2320,378,22,11,33,66.7%,1h
21599,1,九月的风,2320,692,21,25,46,45.7%,4m
21599,1,潜行之龟,2320,598,17,19,36,47.2%,50m
21599,3,UMR,2320,403,16,23,39,41.0%,1h
21599,2,[建院201]花火,2320,492,16,26,42,38.1%,12m
21599,1,托蒂,2320,449,15,14,29,51.7%,50m
21599,3,Richbrian,2320,290,12,11,23,52.2%,1h
21599,1,BinG,2320,251,11,24,35,31.4%,2m
21599,1,北沐,2320,368,10,14,24,41.7%,1h
21599,1,何为悔恨,2320,233,8,7,15,53.3%,1h
21599,3,小明,2320,245,8,10,18,44.4%,1h
21599,1,[小奶狼]我就叫夏洛啊,2320,253,7,3,10,70.0%,40m
21599,2,东御十三,2320,202,6,7,13,46.2%,1h
21599,1,[神魔降临]薯条,2320,182,5,9,14,35.7%,1h
21599,1,lllllllllll,2320,94,4,8,12,33.3%,18m
21599,1,[fanche]无名,2320,96,2,1,3,66.7%,41m
21599,2,腥基佬男孩,2320,0,1,0,1,100.0%,1h
21599,1,DDE,2320,0,1,1,2,50.0%,1h
21599,1,foreverMY,2320,25,1,7,8,12.5%,1h
21599,2,[柏林功德殿]迎风脱裤吹雀雀丶,2320,0,0,1,1,0.0%,1h
21599,2,萌萌哒鸡饲料,2320,0,0,2,2,0.0%,34m
21622,1,堕落血天使,2319,990,36,41,77,46.8%,26m
21622,3,lovelove,2319,722,33,34,67,49.3%,13m
21622,2,[瑞兽]汐山凉音我老婆,2319,476,19,13,32,59.4%,1h
21622,1,开普勒斯,2319,489,14,18,32,43.8%,21m
21622,1,战妖雪峰,2319,178,8,8,16,50.0%,26m
21622,2,ADSE,2319,210,7,4,11,63.6%,1h
21622,3,十一无恙,2319,142,6,13,19,31.6%,44m
21622,1,呵呵,2319,158,4,7,11,36.4%,4m
21622,1,独自两人,2319,80,3,3,6,50.0%,1h
21622,1,风一般的熊孩子,2319,0,3,4,7,42.9%,1h
21622,1,[A丶rash]HDWQAQA,2319,164,3,5,8,37.5%,1h
21622,1,[wdnmd茄]笑晨,2319,34,2,5,7,28.6%,53m
21622,2,[瞧本FANS]瞧治,2319,40,2,5,7,28.6%,59m
21622,3,星际会火,2319,0,2,7,9,22.2%,1h
21622,1,SacredLight,2319,0,1,0,1,100.0%,1h
21622,2,耶稣都救不了,2319,0,1,0,1,100.0%,1h
21622,2,无殇丶孤影,2319,36,1,1,2,50.0%,47m
21622,3,照烧酱,2319,30,1,11,12,8.3%,28m
21622,2,诸葛卧龙,2319,0,0,3,3,0.0%,1h
21622,3,尼德霍格,2319,0,0,5,5,0.0%,46m
21622,1,[瑞兽]拿女盆友换糖,2319,0,0,8,8,0.0%,22m
21643,2,赵大仙,2318,1201,206,200,406,50.7%,10m
21643,2,Elis,2318,1219,155,160,315,49.2%,29m
21643,1,mjds,2318,1670,99,106,205,48.3%,32m
21643,3,money,2318,530,88,93,181,48.6%,21m
21643,1,呼啸战神,2318,1043,66,80,146,45.2%,1h
21643,1,[NOTD战队]newsdays,2318,1161,43,35,78,55.1%,1h
21643,1,Zyme,2318,558,42,40,82,51.2%,54m
21643,2,goldenseed,2318,868,30,41,71,42.3%,31m
21643,1,[看我朵蜜你]Arcturus,2318,907,28,29,57,49.1%,1h
21643,3,[蟹堡王]未来,2318,400,24,35,59,40.7%,13m
21643,1,YJG,2318,521,19,22,41,46.3%,51m
21643,1,tby,2318,421,14,18,32,43.8%,25m
21643,3,焦糖,2318,268,9,12,21,42.9%,1h
21643,1,落鸢,2318,285,7,9,16,43.8%,1h
21643,1,暴雪我要抱抱,2318,168,6,5,11,54.5%,26m
21643,1,土韭头子咕咕鸡,2318,175,4,1,5,80.0%,45m
21643,1,席应情,2318,124,3,7,10,30.0%,19m
21643,1,MAGIC,2318,145,3,7,10,30.0%,1h
21643,2,探路者,2318,46,2,0,2,100.0%,57m
21643,1,[争锋]大雪天舞剑,2318,0,1,1,2,50.0%,1h
21643,1,河山正美,2318,38,1,3,4,25.0%,1h
21643,2,耀阳,2318,0,0,1,1,0.0%,52m
21643,2,[纵丨横]冷风,2318,0,0,1,1,0.0%,1h
21643,3,[别看了就你了]你必定会输,2318,0,0,2,2,0.0%,1h
21643,2,[X英雄圣域X]tntaec,2318,0,0,2,2,0.0%,1h
21668,1,嘟嘟噜赛高,2317,1384,103,112,215,47.9%,25m
21668,1,洋葱骑士,2317,739,77,85,162,47.5%,1h
21668,1,LUWOZAI,2317,486,14,19,33,42.4%,4m
21668,2,Zly,2317,316,11,7,18,61.1%,1h
21668,1,[NooBoy]lipid,2317,264,7,6,13,53.8%,33m
21668,3,azen,2317,247,7,8,15,46.7%,59m
21668,1,[黑色会]Burn,2317,206,6,4,10,60.0%,1h
21668,2,名字叫爱,2317,136,5,5,10,50.0%,47m
21668,3,gcb,2317,201,5,12,17,29.4%,59m
21668,2,[LSH]追梦的猪肘子,2317,0,3,2,5,60.0%,1h
21668,1,冰可枯,2317,141,3,3,6,50.0%,54m
21668,1,牵着蜗牛去旅行,2317,78,3,6,9,33.3%,1h
21668,1,[C90830]查理斯王子,2317,78,2,5,7,28.6%,1h
21668,1,saber,2317,96,2,6,8,25.0%,22m
21668,2,你八十岁的老父亲,2317,0,1,0,1,100.0%,1h
21668,2,[神子]机械之狼,2317,44,1,1,2,50.0%,1h
21668,2,fnks,2317,94,1,5,6,16.7%,1h
21668,1,Rosier,2317,0,0,1,1,0.0%,1h
21668,3,铲家军,2317,0,0,4,4,0.0%,1h
21668,2,大家好,2317,0,0,5,5,0.0%,40m
21688,2,CrmaBwe,2316,1531,203,211,414,49.0%,1h
21688,2,fthyoh,2316,1363,56,65,121,46.3%,1h
21688,1,星际穿越,2316,1161,53,45,98,54.1%,5m
21688,1,歪嘴战神赵老四,2316,414,14,17,31,45.2%,33m
21688,2,酱油酱,2316,236,11,5,16,68.8%,21m
21688,3,ooooooo,2316,218,10,8,18,55.6%,1h
21688,1,下西楼,2316,241,9,5,14,64.3%,16m
21688,1,蜜糖小气球,2316,255,9,6,15,60.0%,34m
21688,1,怜香惜玉,2316,235,8,7,15,53.3%,25m
21688,2,夕远,2316,102,4,2,6,66.7%,1h
21688,2,暗刃,2316,0,3,2,5,60.0%,13m
21688,2,刺客伍六一,2316,46,2,0,2,100.0%,59m
21688,1,暗影之龙,2316,117,2,10,12,16.7%,1h
21688,3,[四斋蒸蚝片]Hologram,2316,30,1,3,4,25.0%,1h
21688,1,李狗蛋,2316,38,1,4,5,20.0%,1h
21688,3,king,2316,0,1,5,6,16.7%,2m
21688,1,雨屋红胡子,2316,0,0,1,1,0.0%,60m
21705,1,踏雪无痕,2315,1672,190,210,400,47.5%,1h
21705,1,零氪,2315,1107,40,45,85,47.1%,43m
21705,2,流水,2315,540,39,42,81,48.1%,31m
21705,2,LVAN,2315,388,14,10,24,58.3%,52m
21705,1,violet,2315,129,10,8,18,55.6%,60m
21705,2,艹翻这江山,2315,209,8,17,25,32.0%,20m
21705,2,王中王,2315,34,6,2,8,75.0%,56m
21705,1,胖子先生,2315,188,6,4,10,60.0%,1h
21705,1,水月,2315,130,5,3,8,62.5%,1h
21705,3,[暴雪二十九队]烟云人生,2315,144,4,8,12,33.3%,6m
21705,3,懵猩,2315,121,3,0,3,100.0%,48m
21705,2,风萧萧兮易水寒,2315,0,3,2,5,60.0%,44m
21705,1,Lavie,2315,78,2,4,6,33.3%,7m
21705,1,[QwQYo]没钱的哥布林,2315,40,2,7,9,22.2%,1h
21705,2,[CcW]她眼中深藏温柔,2315,38,1,1,2,50.0%,21m
21705,1,[无欲则刚]星风,2315,0,1,2,3,33.3%,1h
21705,2,Sos,2315,0,1,4,5,20.0%,33m
21705,2,[如果爱有颜色]刚好的微妙,2315,0,0,1,1,0.0%,40m
21705,1,无敌六六,2315,0,0,2,2,0.0%,21m
21724,1,周司令,2314,184,14,9,23,60.9%,32m
21724,1,qwad,2314,341,14,16,30,46.7%,1h
21724,1,我真的不是条码人,2314,363,13,13,26,50.0%,1h
21724,1,Enter,2314,325,12,15,27,44.4%,54m
21724,1,FateC,2314,218,7,6,13,53.8%,11m
21724,2,唐僧洗头用飘柔,2314,219,7,13,20,35.0%,1h
21724,1,[旧日黄金舰队]MrLiu,2314,159,5,4,9,55.6%,1h
21724,1,大嘟嘟周郎,2314,145,5,6,11,45.5%,7m
21724,2,[无限期影]posider,2314,68,4,0,4,100.0%,1h
21724,1,llllllllllll,2314,140,3,1,4,75.0%,1h
21724,1,江之岛盾子,2314,143,3,7,10,30.0%,22m
21724,1,IIIIIIIIIIII,2314,48,2,2,4,50.0%,1h
21724,1,世态炎凉,2314,111,2,2,4,50.0%,43m
21724,1,派大蒙,2314,78,2,6,8,25.0%,4m
21724,2,龙魔爱,2314,0,1,1,2,50.0%,14m
21724,1,圣殿骑士,2314,90,1,2,3,33.3%,16m
21724,1,man,2314,30,1,3,4,25.0%,1h
21724,2,一棵小白菜,2314,0,1,4,5,20.0%,7m
21742,2,lijiang,2313,714,97,93,190,51.1%,1h
21742,1,三百斤的加肥猫,2313,1573,56,64,120,46.7%,50m
21742,2,暗物质,2313,724,46,56,102,45.1%,43m
21742,2,猎杀笨比的妈,2313,797,37,19,56,66.1%,17m
21742,1,执念,2313,658,30,27,57,52.6%,1h
21742,2,紫云雀,2313,399,29,33,62,46.8%,12m
21742,1,sOs,2313,351,26,16,42,61.9%,46m
21742,2,[Mikon]没人气的咕哒夫,2313,459,20,9,29,69.0%,1h
21742,1,Xhaizi,2313,333,12,16,28,42.9%,1h
21742,2,掩悲演欢丶,2313,276,11,3,14,78.6%,1h
21742,2,带刺蛇,2313,295,11,6,17,64.7%,21m
21742,1,wwwwww,2313,288,10,7,17,58.8%,1h
21742,1,Lose,2313,145,3,2,5,60.0%,60m
21742,1,今晚打老虎,2313,0,1,0,1,100.0%,1h
21742,1,孤清,2313,0,1,0,1,100.0%,5m
21742,2,悟空,2313,0,1,0,1,100.0%,10m
21742,2,HHELIBEBCNOF,2313,0,1,0,1,100.0%,57m
21742,2,[Sc养老]社会你烨哥,2313,0,1,2,3,33.3%,6m
21742,1,Frozen,2313,0,1,3,4,25.0%,1h
21742,2,瑞神,2313,0,1,4,5,20.0%,1h
21742,2,[Fnova]CCTV,2313,0,1,5,6,16.7%,1h
21742,2,[赛博朋克]Magiczerg,2313,0,0,1,1,0.0%,40m
21742,2,[SSR夕阳红]胖子是真的纯良,2313,0,0,1,1,0.0%,46m
21742,1,MagiCProtoss,2313,0,0,3,3,0.0%,1h
21742,1,咸鱼,2313,0,0,4,4,0.0%,1h
21742,2,我得重新集结部队,2313,0,0,4,4,0.0%,35m
21768,1,你个憨不拉几,2312,1731,92,90,182,50.5%,58m
21768,1,xxxxx,2312,1637,81,85,166,48.8%,1h
21768,1,ShowTime,2312,1610,80,76,156,51.3%,4m
21768,1,欠妥,2312,1264,43,51,94,45.7%,34m
21768,1,克苏鲁之信徒,2312,591,28,31,59,47.5%,48m
21768,1,绘梨衣小怪兽,2312,594,24,21,45,53.3%,1h
21768,1,参谋长,2312,537,20,14,34,58.8%,1h
21768,1,[Miku骑士]Snowdrop,2312,233,18,16,34,52.9%,1h
21768,2,[天天跪吃咸鱼]天边的一朵云,2312,392,13,10,23,56.5%,6m
21768,1,新手放过我,2312,270,9,10,19,47.4%,1h
21768,3,时崎狂三,2312,222,8,13,21,38.1%,17m
21768,2,嘟吧哒,2312,169,6,3,9,66.7%,35m
21768,1,[纸鸢i]猪儿虫,2312,216,6,8,14,42.9%,46m
21768,1,RATH,2312,141,3,7,10,30.0%,1h
21768,1,诸神之父,2312,167,3,7,10,30.0%,1h
21768,1,[CPT]起名还是这么难,2312,97,2,2,4,50.0%,53m
21768,2,killerQueen,2312,0,1,0,1,100.0%,42m
21768,2,放假,2312,44,1,1,2,50.0%,45m
21768,1,看到我棒棒糖了吗,2312,48,1,4,5,20.0%,1h
21768,2,天使落凡尘,2312,0,1,4,5,20.0%,1h
21768,2,[大魔王]EasyZerG,2312,0,0,1,1,0.0%,24m
21789,1,[温柔兔公主]csskl,2311,687,28,27,55,50.9%,25m
21789,1,黑虎阿福,2311,432,16,11,27,59.3%,1h
21789,1,承教于诺偌,2311,312,12,18,30,40.0%,54m
21789,1,黑山羊,2311,342,12,18,30,40.0%,1h
21789,1,dyjsws,2311,293,10,11,21,47.6%,1h
21789,3,迷茫的流浪者,2311,214,8,8,16,50.0%,1h
21789,1,[大乔无惨]gunima,2311,306,8,14,22,36.4%,48m
21789,3,[Shawk]FAMAS,2311,201,6,11,17,35.3%,13m
21789,1,[积水潭]Aldebaran,2311,287,6,11,17,35.3%,1h
21789,1,朕心,2311,152,5,3,8,62.5%,50m
21789,1,EASYpeazzzyy,2311,184,5,5,10,50.0%,54m
21789,1,流浪随风,2311,163,4,8,12,33.3%,18m
21789,1,wxhzwy,2311,0,3,9,12,25.0%,54m
21789,3,千赋,2311,30,2,0,2,100.0%,1h
21789,1,[来自喵星的人]CNge,2311,89,2,5,7,28.6%,1h
21789,2,老狼,2311,48,2,7,9,22.2%,1h
21789,2,[赤色卐中轴]似曾相识的味道,2311,0,1,0,1,100.0%,1h
21789,2,[NewV]foyes,2311,0,1,0,1,100.0%,47m
21789,2,RapperD,2311,0,1,0,1,100.0%,1h
21789,2,别逗了我穿的拖鞋,2311,0,1,1,2,50.0%,1h
21789,2,deadhead,2311,30,1,1,2,50.0%,1h
21789,2,墨迹,2311,30,1,1,2,50.0%,1h
21789,1,Myth,2311,38,1,4,5,20.0%,1h
21789,2,[CPT]百年经典,2311,0,1,5,6,16.7%,7m
21789,2,鱼别丢,2311,0,0,2,2,0.0%,24m
21789,1,逼逼小子,2311,0,0,2,2,0.0%,40m
21815,2,SAT,2310,896,34,32,66,51.5%,6m
21815,2,[KPG2]电竞蔡徐坤,2310,676,25,18,43,58.1%,1h
21815,3,loe,2310,298,13,9,22,59.1%,1h
21815,1,不朽,2310,249,7,10,17,41.2%,41m
21815,1,[完了卡人口了]法苏天女月磁光,2310,159,7,14,21,33.3%,59m
21815,1,了不烦,2310,117,6,9,15,40.0%,59m
21815,2,LizhengyUu,2310,60,3,2,5,60.0%,1h
21815,1,人族妈暴毙一下,2310,84,3,4,7,42.9%,43m
21815,3,艾尔芬,2310,18,2,0,2,100.0%,1h
21815,2,上条当麻,2310,60,2,2,4,50.0%,3m
21815,2,靠谱的红秋裤,2310,88,2,3,5,40.0%,52m
21815,1,[C94941]程千帆,2310,0,2,5,7,28.6%,40m
21815,3,神族你马死了,2310,0,1,0,1,100.0%,1h
21815,2,[你好抱歉]前尘封心,2310,0,1,0,1,100.0%,1h
21815,2,[FFFghs]友利奈绪,2310,0,1,0,1,100.0%,1h
21815,2,东方不胜,2310,30,1,1,2,50.0%,14m
21815,2,风萧萧兮易水寒,2310,88,1,1,2,50.0%,17m
21815,2,锦衣夜行,2310,34,1,1,2,50.0%,8m
21815,2,逍遥小包子,2310,0,1,1,2,50.0%,1h
21815,2,bacon,2310,0,1,1,2,50.0%,40m
21815,3,开飞机的舒克,2310,30,1,1,2,50.0%,1h
21815,2,凉小白丶,2310,32,1,3,4,25.0%,1h
21815,2,冥月无聊,2310,0,1,4,5,20.0%,44m
21815,2,归苏,2310,0,1,4,5,20.0%,1h
21815,1,[社交学小可爱]Together,2310,0,0,1,1,0.0%,1h
21815,1,[YoungD]CraneLFish,2310,0,0,4,4,0.0%,1h
21841,2,[透一下清酒]不能的许愿机,2309,978,38,41,79,48.1%,1h
21841,2,好的里哈撒,2309,623,23,17,40,57.5%,42m
21841,2,卡拉赞,2309,468,18,14,32,56.2%,1m
21841,2,BorisXu,2309,206,15,29,44,34.1%,28m
21841,3,Qqoong,2309,251,8,13,21,38.1%,32m
21841,2,TLP,2309,0,2,3,5,40.0%,1h
21841,2,一零捌柒,2309,44,1,2,3,33.3%,1h
21841,3,[DSE]RHTRU,2309,0,1,3,4,25.0%,46m
21841,2,天天,2309,0,1,4,5,20.0%,1h
21841,1,[铁血蓝军]直隶总督,2309,99,1,5,6,16.7%,1h
21841,3,FrezeeMe,2309,0,1,5,6,16.7%,6m
21841,2,爆裂大王,2309,0,1,5,6,16.7%,1h
21841,2,[Drgon]神丨桀骜者,2309,0,0,1,1,0.0%,42m
21841,1,xcz,2309,0,0,1,1,0.0%,1h
21841,1,想不出来,2309,0,0,1,1,0.0%,1h
21841,2,[荀彧喵]在神皇面前跪下,2309,0,0,2,2,0.0%,29m
21841,1,冰镇绿豆汤,2309,0,0,3,3,0.0%,1h
21858,1,用脚打就够了,2308,1119,51,47,98,52.0%,15m
21858,1,scxjz,2308,856,27,37,64,42.2%,1h
21858,3,[萨尔那加议会]CALLmeA,2308,487,15,23,38,39.5%,1h
21858,1,作曲家,2308,341,8,17,25,32.0%,57m
21858,2,[明教]殇爱恋,2308,92,4,5,9,44.4%,47m
21858,1,小志无,2308,96,4,8,12,33.3%,40m
21858,1,阳阳,2308,142,4,10,14,28.6%,1h
21858,1,Tom,2308,40,2,3,5,40.0%,1h
21858,2,Miraculum,2308,0,1,0,1,100.0%,1h
21858,2,艾尔之子,2308,0,1,0,1,100.0%,14m
21858,1,djaslkjd,2308,0,1,2,3,33.3%,15m
21858,2,[起舞弄清影]花开亦是花落时,2308,0,1,4,5,20.0%,1h
21858,2,永恒的法老,2308,0,1,5,6,16.7%,1h
21858,2,壹贰,2308,0,1,5,6,16.7%,44m
21858,2,Rooney,2308,0,1,5,6,16.7%,44m
21858,1,LlllII,2308,0,0,2,2,0.0%,1h
21874,1,风清鞅,2307,1637,147,148,295,49.8%,1h
21874,3,[miku守护]chck,2307,945,55,64,119,46.2%,28m
21874,1,朱远从,2307,1115,39,39,78,50.0%,7m
21874,1,夏日雨梓,2307,523,18,21,39,46.2%,43m
21874,1,[Hdl]斩月,2307,329,17,7,24,70.8%,15m
21874,2,沙格莱斯,2307,274,13,14,27,48.1%,12m
21874,1,魔鬼秀儿羲,2307,193,7,6,13,53.8%,46m
21874,1,[loveMM]gameplayer,2307,274,7,13,20,35.0%,15m
21874,2,这一刀叫两断,2307,58,2,1,3,66.7%,40m
21874,2,自由之翼,2307,60,2,4,6,33.3%,1h
21874,2,zzzzzzzzzzzz,2307,0,1,0,1,100.0%,35m
21874,1,[本质搞黄色]KRYISTO,2307,40,1,4,5,20.0%,43m
21874,2,[宇宙超级萌新]sfsf,2307,0,1,5,6,16.7%,7m
21874,2,[神奇的海螺]AESFresh,2307,0,0,1,1,0.0%,1h
21874,2,弁天女士,2307,0,0,2,2,0.0%,57m
21889,1,LBJ,2306,1424,59,58,117,50.4%,15m
21889,1,BLANDIS,2306,399,18,15,33,54.5%,1h
21889,1,[野良爱57]猪猡,2306,441,18,18,36,50.0%,1h
21889,2,lancer,2306,411,13,10,23,56.5%,30m
21889,1,hyy,2306,316,12,15,27,44.4%,1h
21889,2,最喜欢小雨了,2306,312,11,14,25,44.0%,29m
21889,1,[极限菜鸟]曹笛,2306,271,9,7,16,56.2%,21m
21889,1,晴天水清,2306,203,8,8,16,50.0%,42m
21889,1,[你特么过来呀]Larrywheel,2306,99,6,3,9,66.7%,42m
21889,1,heroaaa,2306,189,6,5,11,54.5%,1h
21889,1,ZMonk,2306,162,5,5,10,50.0%,1h
21889,1,King,2306,114,5,5,10,50.0%,60m
21889,1,帝奥,2306,148,5,8,13,38.5%,11m
21889,1,待你如初恋,2306,140,4,8,12,33.3%,1h
21889,2,[APM25]全村人的希望,2306,62,3,1,4,75.0%,54m
21889,2,[飞云之上]CHR,2306,58,3,1,4,75.0%,54m
21889,2,nixnix,2306,58,3,10,13,23.1%,22m
21889,2,RNGkiller,2306,38,2,2,4,50.0%,6m
21889,1,[圣晶石搬运队]AMGozzv,2306,44,2,6,8,25.0%,1h
21889,2,[Alexya]Polaris,2306,0,1,0,1,100.0%,47m
21889,1,动了情的痞子,2306,0,1,2,3,33.3%,42m
21889,2,加藤泷,2306,0,1,4,5,20.0%,1h
21889,3,PandapanC,2306,30,1,5,6,16.7%,43m
21889,2,下手轻点我怕疼,2306,0,0,1,1,0.0%,14m
21913,1,霸王,2305,1641,77,78,155,49.7%,1h
21913,1,方明大傻纸,2305,966,41,37,78,52.6%,15m
21913,1,大哥大姐过年好,2305,629,19,26,45,42.2%,1h
21913,2,Joker,2305,492,18,14,32,56.2%,1h
21913,1,[joster]一条菜蛇,2305,411,17,13,30,56.7%,2m
21913,1,小学生,2305,389,17,17,34,50.0%,1h
21913,2,满眼星河,2305,398,14,27,41,34.1%,15m
21913,1,萌萌萌萌新,2305,370,13,15,28,46.4%,58m
21913,3,大可奇丽,2305,272,10,13,23,43.5%,1h
21913,1,去年夏天彡,2305,238,7,8,15,46.7%,47m
21913,1,神坑小学生,2305,139,6,4,10,60.0%,30m
21913,2,HAOZI,2305,197,5,4,9,55.6%,56m
21913,2,[无星际不跳脸]cold,2305,145,4,3,7,57.1%,1h
21913,1,阿巴怪,2305,96,3,0,3,100.0%,2m
21913,1,suibian,2305,119,3,2,5,60.0%,1h
21913,2,[极限菜鸟]铁憨憨,2305,30,2,1,3,66.7%,6m
21913,1,夏夜银辉,2305,91,2,2,4,50.0%,43m
21913,2,梦蝶由依,2305,70,2,3,5,40.0%,1h
21913,3,[暴雪家族]橙子,2305,58,2,5,7,28.6%,1h
21913,2,XGSIWI,2305,0,1,1,2,50.0%,24m
21913,2,天降暗星,2305,0,1,1,2,50.0%,7m
21913,1,ASDonew,2305,76,1,3,4,25.0%,19m
21913,1,OnCountDown,2305,0,1,5,6,16.7%,60m
21936,1,星达,2304,1047,49,44,93,52.7%,50m
21936,1,king,2304,619,26,23,49,53.1%,1h
21936,2,[CPT]帅帅的我,2304,485,26,25,51,51.0%,14m
21936,1,我真的不会玩诺娃,2304,693,23,25,48,47.9%,1h
21936,1,一念山河成,2304,547,17,17,34,50.0%,1h
21936,2,离殇,2304,462,15,16,31,48.4%,48m
21936,1,qwe,2304,455,13,16,29,44.8%,50m
21936,2,鱼玄机,2304,251,9,11,20,45.0%,1h
21936,3,我能,2304,244,8,12,20,40.0%,1h
21936,3,[纵丨横]SKY,2304,217,8,13,21,38.1%,1h
21936,2,WSTLYTT,2304,182,5,4,9,55.6%,1h
21936,1,Lucifer,2304,96,3,4,7,42.9%,1h
21936,2,星际争霸霸中霸,2304,44,3,4,7,42.9%,59m
21936,1,[怀念曾经温柔]Ghost,2304,96,2,11,13,15.4%,1h
21936,3,大脑在颤抖,2304,0,1,4,5,20.0%,22m
21936,2,狗狗,2304,0,1,5,6,16.7%,59m
21936,2,王者,2304,0,1,5,6,16.7%,36m
21936,2,[倒萨的地方]Getwith,2304,0,1,5,6,16.7%,1h
21936,2,天人合一,2304,0,0,1,1,0.0%,48m
21936,2,男子单打型选手,2304,0,0,1,1,0.0%,1h
21936,2,乐乐公举,2304,0,0,1,1,0.0%,1h
21936,2,Alen,2304,0,0,5,5,0.0%,57m
21958,1,三英战芦苇,2303,1581,57,60,117,48.7%,49m
21958,1,[女神聨盟]紫靈锋,2303,1100,45,52,97,46.4%,33m
21958,1,[我们都是宝宝]ferragamo,2303,500,22,23,45,48.9%,33m
21958,2,MicSama,2303,243,7,5,12,58.3%,1h
21958,1,花开寒影,2303,165,6,6,12,50.0%,38m
21958,1,泽非,2303,78,5,11,16,31.2%,11m
21958,1,Wumx,2303,97,4,5,9,44.4%,1h
21958,3,老电报员,2303,170,4,6,10,40.0%,1h
21958,2,Gaspanic,2303,58,2,2,4,50.0%,54m
21958,2,大芳香脚,2303,44,2,5,7,28.6%,14m
21958,2,神眷之樱花,2303,0,1,0,1,100.0%,1h
21958,2,心在流浪,2303,0,1,1,2,50.0%,8m
21958,3,[星际铁憨憨]克鲁鲁,2303,0,1,1,2,50.0%,1h
21958,2,Lavie,2303,0,1,4,5,20.0%,57m
21958,1,遗物,2303,48,1,5,6,16.7%,46m
21958,2,带走你的死神,2303,0,0,1,1,0.0%,1h
21974,1,山的那一边,2302,1120,91,104,195,46.7%,42m
21974,1,台州椒江区林仁德,2302,1670,77,78,155,49.7%,25m
21974,1,自由的心,2302,741,40,37,77,51.9%,60m
21974,2,丨魄,2302,440,18,10,28,64.3%,1h
21974,1,erww,2302,478,13,19,32,40.6%,4m
21974,3,星际玩家,2302,302,12,14,26,46.2%,1h
21974,3,QWBB,2302,175,7,9,16,43.8%,6m
21974,2,最强男人黎力,2302,120,5,3,8,62.5%,1h
21974,1,世界第一爸爸,2302,119,5,4,9,55.6%,1h
21974,2,你是真的很让我烦,2302,74,4,2,6,66.7%,8m
21974,1,曈曈,2302,118,3,3,6,50.0%,1h
21974,2,[丨SLT丨]下雨不愁的头,2302,60,3,3,6,50.0%,56m
21974,2,孟买,2302,46,3,4,7,42.9%,7m
21974,2,youlin,2302,36,2,2,4,50.0%,1h
21974,2,我是琛琛,2302,60,2,2,4,50.0%,1h
21974,2,杭州少女想打电竞,2302,0,2,4,6,33.3%,1h
21974,3,Shark,2302,0,2,6,8,25.0%,1h
21974,3,FLY,2302,66,2,14,16,12.5%,1h
21974,3,HUAJUNJIEW,2302,0,1,0,1,100.0%,44m
21974,2,巴基大狂风,2302,42,1,2,3,33.3%,1h
21974,2,[暴雪三十一队]老油子,2302,34,1,2,3,33.3%,1h
21974,1,心忧风铃,2302,0,0,3,3,0.0%,1h
21974,2,[爱国]你爹深情回眸,2302,0,0,3,3,0.0%,1h
21974,2,[龙族战队]专属我用,2302,0,0,5,5,0.0%,1h
21998,1,nickdawson,2301,358,48,39,87,55.2%,1h
21998,1,Aron,2301,566,46,35,81,56.8%,25m
21998,3,大宝剑,2301,994,38,49,87,43.7%,1h
21998,1,[葫芦娃救艾尔]WRNDG,2301,392,23,14,37,62.2%,15m
21998,1,裤子掉了,2301,396,12,16,28,42.9%,1h
21998,2,酥麻凤蝶,2301,242,8,3,11,72.7%,1h
21998,1,[怪盗军团]至尊盗亡拉法姆,2301,204,8,7,15,53.3%,4m
21998,1,霸主,2301,180,4,8,12,33.3%,5m
21998,1,嫩么气质,2301,91,2,1,3,66.7%,1h
21998,2,[旺旺集团]LXT,2301,0,2,3,5,40.0%,7m
21998,1,对方告诉大范围,2301,48,2,7,9,22.2%,46m
21998,2,小水滴,2301,0,1,0,1,100.0%,47m
21998,3,ghhbh,2301,0,1,1,2,50.0%,50m
21998,3,伊利丹,2301,97,1,2,3,33.3%,43m
21998,2,[呼叫舰队按2]隐的不是身是寂寞,2301,32,1,2,3,33.3%,40m
21998,2,[朝阳F4]李粑粑,2301,0,1,5,6,16.7%,1h
21998,2,早欸,2301,95,1,5,6,16.7%,1h
21998,3,[XXHZ30]pang,2301,0,0,1,1,0.0%,6m
22016,1,在上庞某人,2300,1071,39,37,76,51.3%,4m
22016,2,春秋蝉,2300,466,18,18,36,50.0%,1h
22016,2,夜空灵,2300,377,14,16,30,46.7%,1h
22016,3,[DMRe]kimiedi,2300,291,12,23,35,34.3%,12m
22016,3,小傻,2300,258,9,13,22,40.9%,11m
22016,1,我是字母哥,2300,191,6,6,12,50.0%,1h
22016,1,白门楼建设队员,2300,254,6,7,13,46.2%,1h
22016,3,[黄霸天]Deathstroke,2300,38,3,8,11,27.3%,6m
22016,2,tttttt,2300,30,2,0,2,100.0%,3m
22016,2,[鲨你泉家]skr,2300,58,2,2,4,50.0%,1h
22016,2,电脑斗士,2300,0,1,0,1,100.0%,1h
22016,2,chicagotype,2300,30,1,1,2,50.0%,54m
22016,2,不叮熊,2300,0,1,4,5,20.0%,1h
22016,2,筱魂灬,2300,0,0,1,1,0.0%,30m
22016,2,[键盘冒毒奶]avenger,2300,0,0,4,4,0.0%,1h
22031,1,哇塞,2299,1227,108,113,221,48.9%,1h
22031,1,wwe,2299,1206,92,100,192,47.9%,43m
22031,1,[CPT]爱虫大作战,2299,1021,58,49,107,54.2%,43m
22031,1,Ateam,2299,420,26,34,60,43.3%,42m
22031,1,千斗五十铃,2299,334,24,28,52,46.2%,1h
22031,1,simon,2299,790,23,27,50,46.0%,1h
22031,2,黄金小鸡,2299,582,21,24,45,46.7%,1h
22031,1,艾尔永恒,2299,255,9,8,17,52.9%,2m
22031,1,IIIIIIIIIIII,2299,268,8,8,16,50.0%,21m
22031,2,次元游者,2299,0,3,2,5,60.0%,45m
22031,1,[浴火银河]取颅者,2299,48,2,0,2,100.0%,1h
22031,1,七曜,2299,0,2,5,7,28.6%,1h
22031,1,莹酱伴我入睡,2299,42,2,6,8,25.0%,18m
22031,2,[虎牙小金直播]金嫂是我的,2299,0,1,0,1,100.0%,3m
22031,1,是你得不到的爷爷,2299,48,1,5,6,16.7%,1h
22031,2,屿梒,2299,0,1,5,6,16.7%,41m
22031,2,梦魇,2299,0,0,1,1,0.0%,32m
22031,1,一贱穿鸡,2299,0,0,2,2,0.0%,1h
22031,2,[九镜尘埃]此时走来的狐狸,2299,0,0,4,4,0.0%,57m
22050,1,[五月花]zeeo,2298,856,107,111,218,49.1%,36m
22050,1,猛龙迅捷,2298,1295,104,102,206,50.5%,15m
22050,2,她说她是晒黑的丶,2298,718,29,29,58,50.0%,42m
22050,2,神级争霸,2298,585,22,23,45,48.9%,1h
22050,2,twe,2298,560,21,21,42,50.0%,1h
22050,2,有点,2298,326,15,17,32,46.9%,34m
22050,1,青灯锁禁天下魂,2298,448,12,19,31,38.7%,60m
22050,3,Pluto,2298,263,10,10,20,50.0%,52m
22050,3,meekiller,2298,266,10,12,22,45.5%,1h
22050,2,蓝蓝路,2298,208,8,5,13,61.5%,1h
22050,1,虎啸山林,2298,234,6,7,13,46.2%,4m
22050,1,全麻,2298,182,6,8,14,42.9%,1h
22050,3,水之浮云,2298,197,6,11,17,35.3%,1h
22050,1,小受,2298,141,5,6,11,45.5%,1h
22050,3,[插爆一切]菜鸡,2298,145,4,0,4,100.0%,1h
22050,2,逃命之王,2298,94,4,1,5,80.0%,42m
22050,1,[暴雪十六队]一头预言家,2298,237,4,6,10,40.0%,1h
22050,1,哈啥,2298,0,3,4,7,42.9%,1h
22050,3,[嘤嘤嘤呜呜]DAN,2298,148,3,5,8,37.5%,1h
22050,1,LRH,2298,145,2,4,6,33.3%,47m
22050,2,Palm,2298,0,1,4,5,20.0%,35m
22050,2,萌萌哒的雪平,2298,0,1,5,6,16.7%,7m
22050,2,[知乎战队]为了艾尔,2298,0,0,1,1,0.0%,1h
22050,2,killer,2298,0,0,1,1,0.0%,24m
22050,2,蜡笔小新,2298,0,0,1,1,0.0%,8m
22050,2,wdnmd,2298,0,0,1,1,0.0%,46m
22050,2,酒丨龙舌兰,2298,0,0,2,2,0.0%,29m
22077,2,[慢手e族]吕布屹立于虎牢关,2297,1179,46,44,90,51.1%,1h
22077,1,[就这就这]邱翼,2297,814,30,29,59,50.8%,11m
22077,1,胡萝卜公爵,2297,528,15,16,31,48.4%,1h
22077,1,TwinShadows,2297,393,14,19,33,42.4%,32m
22077,3,[32CM]对着阿巴瑟冲一发,2297,296,11,13,24,45.8%,1h
22077,1,Carl,2297,331,7,11,18,38.9%,1h
22077,3,Fantasie,2297,224,7,12,19,36.8%,1h
22077,2,花水雨离子,2297,124,5,3,8,62.5%,1h
22077,1,小风云,2297,46,4,11,15,26.7%,27m
22077,2,浩鹏呐,2297,100,3,4,7,42.9%,52m
22077,3,狗哥我爱你,2297,97,3,5,8,37.5%,1h
22077,2,[雷娘保护协会]蛇皮仙人,2297,32,2,0,2,100.0%,1h
22077,3,张澈凯,2297,97,1,3,4,25.0%,44m
22077,1,czg,2297,40,1,4,5,20.0%,4m
22077,1,[XXHZ18]GVYS,2297,40,1,9,10,10.0%,1h
22077,1,[Encore]星际娜,2297,0,0,1,1,0.0%,1h
22077,2,红头军,2297,0,0,1,1,0.0%,1h
22077,3,有钱的钢铁侠,2297,0,0,2,2,0.0%,1h
22095,1,风色幻想,2296,1382,98,90,188,52.1%,2m
22095,1,ZHH,2296,851,36,35,71,50.7%,1h
22095,1,[究极哈批]浅离陌上花,2296,288,20,17,37,54.1%,19m
22095,1,Please,2296,160,4,7,11,36.4%,49m
22095,2,云食月,2296,129,3,1,4,75.0%,1h
22095,1,天残,2296,163,3,4,7,42.9%,4m
22095,2,[星际茶馆]我与微风皆过客丶,2296,0,3,4,7,42.9%,33m
22095,3,MCzz,2296,121,3,5,8,37.5%,1h
22095,1,果然翁喔,2296,78,3,7,10,30.0%,1h
22095,1,烈玉,2296,48,3,7,10,30.0%,18m
22095,2,斐多悖论,2296,98,3,10,13,23.1%,1h
22095,2,没意识玩什么星际,2296,74,2,5,7,28.6%,1h
22095,1,如果果,2296,74,2,6,8,25.0%,1h
22095,2,卢本伟,2296,137,2,6,8,25.0%,44m
22095,1,[黑魔导女孩]梦回远古,2296,117,2,7,9,22.2%,1h
22095,2,cvergtgvywrt,2296,0,1,0,1,100.0%,30m
22095,3,筱狐狸,2296,30,1,2,3,33.3%,6m
22095,2,AMD,2296,0,0,1,1,0.0%,14m
22095,2,御坂钢琴,2296,0,0,10,10,0.0%,21m
22114,3,长风,2295,1283,51,59,110,46.4%,8m
22114,1,电竞乔北陆,2295,433,48,48,96,50.0%,19m
22114,2,水手辛巴达,2295,502,21,20,41,51.2%,1h
22114,2,重创神,2295,488,19,15,34,55.9%,1h
22114,2,斯托蕾雅,2295,387,15,12,27,55.6%,1h
22114,1,Sting,2295,301,14,17,31,45.2%,50m
22114,1,苑缘吊胖,2295,354,13,15,28,46.4%,36m
22114,3,杨蛤蜊,2295,335,13,22,35,37.1%,33m
22114,2,子豪君,2295,287,11,7,18,61.1%,6m
22114,2,爱詩诗詩诗,2295,120,5,3,8,62.5%,32m
22114,2,兰亭已矣,2295,148,5,7,12,41.7%,29m
22114,2,changyebo,2295,90,4,2,6,66.7%,1h
22114,1,永不完结的梦,2295,0,4,3,7,57.1%,1h
22114,2,上白泽慧音,2295,48,3,4,7,42.9%,1h
22114,2,迷失光谱,2295,74,2,4,6,33.3%,1h
22114,2,无敌兔,2295,0,1,0,1,100.0%,24m
22114,2,绝地污士,2295,0,1,0,1,100.0%,52m
22114,2,[嘤嘤樱]疯疯疯子,2295,93,1,1,2,50.0%,56m
22114,2,月下美人,2295,30,1,2,3,33.3%,52m
22114,2,[C43147]GFFFFF,2295,0,1,5,6,16.7%,45m
22114,2,BMWruina,2295,0,0,1,1,0.0%,1h
22114,1,洋气的羊,2295,0,0,1,1,0.0%,1h
22114,2,Mint,2295,0,0,3,3,0.0%,1h
22137,3,撸到天荒地老,2294,1154,74,72,146,50.7%,1h
22137,1,我要吃兔兔,2294,418,66,52,118,55.9%,22m
22137,1,你的帅爸爸,2294,1469,56,57,113,49.6%,1h
22137,2,紫幽浩,2294,204,14,11,25,56.0%,14m
22137,1,我是钢浪,2294,314,9,15,24,37.5%,1h
22137,1,[笙风]沐雨笙风,2294,169,6,5,11,54.5%,1h
22137,3,[暴雪娱乐]结束了孩子们,2294,231,6,12,18,33.3%,1h
22137,1,被小学生殴打一号,2294,96,4,11,15,26.7%,43m
22137,2,vfhgjga,2294,0,2,3,5,40.0%,36m
22137,1,PointBreak,2294,48,2,4,6,33.3%,42m
22137,2,shmily,2294,46,2,6,8,25.0%,1h
22137,2,沉默之剑,2294,0,1,1,2,50.0%,1h
22137,1,神小白,2294,38,1,6,7,14.3%,43m
22137,2,war,2294,0,0,1,1,0.0%,1h
22137,2,Angle,2294,0,0,1,1,0.0%,1h
22137,1,SawShark,2294,0,0,2,2,0.0%,1h
22153,1,苏卡不列,2293,451,19,18,37,51.4%,4m
22153,2,天翼之影,2293,213,8,3,11,72.7%,1h
22153,1,ccf,2293,279,8,9,17,47.1%,1h
22153,3,爱莹莹,2293,188,8,12,20,40.0%,25m
22153,3,[maijer]maijer,2293,246,8,14,22,36.4%,8m
22153,3,刘牌楼,2293,106,5,11,16,31.2%,44m
22153,1,天下无敌可爱,2293,196,4,10,14,28.6%,1h
22153,2,[秋千千秋]lavender,2293,58,2,1,3,66.7%,1h
22153,2,这个游戏好难,2293,30,2,1,3,66.7%,1h
22153,2,sheep,2293,0,1,0,1,100.0%,14m
22153,2,siwofu,2293,0,1,3,4,25.0%,7m
22153,1,AirndRealm,2293,107,1,4,5,20.0%,1h
22153,1,君子行乐,2293,48,1,4,5,20.0%,1h
22153,2,呜呼,2293,0,1,4,5,20.0%,35m
22153,2,Devil,2293,0,0,1,1,0.0%,1h
22153,1,曾来过,2293,0,0,4,4,0.0%,1h
22169,1,青铜滴神,2292,790,62,54,116,53.4%,26m
22169,1,错误,2292,665,41,44,85,48.2%,26m
22169,2,你好再见不送,2292,334,28,28,56,50.0%,28m
22169,2,Latheric,2292,402,16,14,30,53.3%,1h
22169,1,寂寞惹的祸,2292,407,10,14,24,41.7%,16m
22169,2,[我菜请打队友]chenkacheng,2292,271,8,17,25,32.0%,1h
22169,1,亲眼会,2292,146,5,11,16,31.2%,4m
22169,2,[QWQa]宙斯,2292,96,4,1,5,80.0%,46m
22169,2,阿斯达,2292,30,2,0,2,100.0%,47m
22169,1,[塔达林高坚果]mvt,2292,0,2,5,7,28.6%,1m
22169,2,acct,2292,0,0,1,1,0.0%,21m
22169,2,TYAINI,2292,0,0,1,1,0.0%,17m
22169,2,zrdlpl,2292,0,0,1,1,0.0%,8m
22169,2,THEFORCE,2292,0,0,3,3,0.0%,14m
22183,1,[GOTAL]kiss,2291,1247,105,107,212,49.5%,32m
22183,2,[DSE]kaichee,2291,408,72,84,156,46.2%,1h
22183,1,wos,2291,768,37,35,72,51.4%,16m
22183,2,Tonylyc,2291,572,23,21,44,52.3%,8m
22183,1,Darkchief,2291,237,9,7,16,56.2%,1h
22183,2,[DMR]candy,2291,221,8,7,15,53.3%,14m
22183,2,一言难尽,2291,178,7,4,11,63.6%,1h
22183,1,星灵狂战士,2291,219,6,6,12,50.0%,19m
22183,2,虎嗷嗷,2291,138,5,5,10,50.0%,1h
22183,2,[佩翔]saber,2291,68,4,3,7,57.1%,49m
22183,2,藐视对面一头犬,2291,46,2,5,7,28.6%,14m
22183,2,天之河,2291,0,1,0,1,100.0%,46m
22183,2,神爱世人,2291,32,1,2,3,33.3%,40m
22183,2,不负,2291,0,1,5,6,16.7%,7m
22197,3,小怪兽,2290,576,89,82,171,52.0%,1h
22197,1,叁月丶初四,2290,804,28,34,62,45.2%,1h
22197,2,[鹌鹑带星]柠檬,2290,556,26,16,42,61.9%,1h
22197,2,米猪,2290,735,25,46,71,35.2%,1h
22197,3,Garbage,2290,385,18,27,45,40.0%,4m
22197,2,azs,2290,444,17,9,26,65.4%,8m
22197,2,闲蜓,2290,175,10,5,15,66.7%,1h
22197,3,chinaren,2290,236,10,8,18,55.6%,1h
22197,2,君子,2290,275,10,15,25,40.0%,1h
22197,1,陌尘歌鸽啊,2290,319,8,9,17,47.1%,19m
22197,1,ErrorP,2290,206,7,9,16,43.8%,15m
22197,1,Harbour,2290,252,7,13,20,35.0%,60m
22197,2,打烂,2290,140,6,3,9,66.7%,1h
22197,3,DFEFE,2290,120,5,10,15,33.3%,1h
22197,3,幻宇,2290,128,5,15,20,25.0%,1h
22197,3,吔翔王,2290,74,4,10,14,28.6%,1h
22197,2,[大秦万世]小鱼儿你来吗,2290,62,3,0,3,100.0%,42m
22197,3,[神奇的海螺]姐姐不要碰那里,2290,125,3,4,7,42.9%,44m
22197,2,[世界需要英雄]宁度丿幻想,2290,44,2,5,7,28.6%,56m
22197,2,www,2290,30,1,2,3,33.3%,49m
22217,1,[爽一下]YjMars,2289,1729,616,654,1270,48.5%,1h
22217,2,EvenDark,2289,1098,43,56,99,43.4%,1h
22217,1,哀亩皮,2289,682,21,24,45,46.7%,42m
22217,2,[嗑药小分队]肥波,2289,422,18,7,25,72.0%,1h
22217,3,[第四駆逐鑑隊]Another,2289,359,13,15,28,46.4%,1h
22217,2,maoku,2289,197,12,15,27,44.4%,1h
22217,2,戏十六,2289,326,12,19,31,38.7%,1h
22217,1,小气的呆头,2289,361,11,12,23,47.8%,33m
22217,2,ASDFF,2289,166,10,6,16,62.5%,8m
22217,2,zenkiwang,2289,293,9,10,19,47.4%,14m
22217,3,简单的电脑,2289,203,7,10,17,41.2%,10m
22217,3,我们故事起于星海,2289,136,4,4,8,50.0%,57m
22217,2,[禽禽禽]冰霜之犬,2289,112,4,6,10,40.0%,14m
22217,1,BOSSX,2289,144,3,8,11,27.3%,3m
22217,2,萘钚氖斯,2289,46,2,6,8,25.0%,56m
22217,1,狼人,2289,97,2,6,8,25.0%,1h
22217,2,Elucidator,2289,0,1,0,1,100.0%,8m
22217,2,打死小强,2289,30,1,2,3,33.3%,1h
22217,2,gsef,2289,96,1,5,6,16.7%,1h
22217,2,[阿森纳法]扬心,2289,0,0,1,1,0.0%,44m
22217,2,gyy,2289,0,0,1,1,0.0%,14m
22217,2,可爱的小崽子,2289,0,0,1,1,0.0%,7m
22239,3,万有全无,2288,1222,62,60,122,50.8%,4m
22239,3,[中华何平]夜行者,2288,819,37,46,83,44.6%,3m
22239,2,静若水,2288,730,26,22,48,54.2%,24m
22239,2,在此之间,2288,442,19,7,26,73.1%,1h
22239,1,大罗金丹,2288,581,19,18,37,51.4%,1h
22239,2,[琴筝]笛卡尔,2288,390,15,9,24,62.5%,1h
22239,1,小奶柔,2288,467,15,16,31,48.4%,22m
22239,2,只会苟,2288,303,11,9,20,55.0%,3m
22239,2,闲人一个,2288,347,10,11,21,47.6%,30m
22239,1,言传,2288,265,9,8,17,52.9%,2m
22239,3,猎空,2288,146,5,10,15,33.3%,44m
22239,2,[hct]IIIIIIIIIIII,2288,98,4,2,6,66.7%,1h
22239,2,xibo,2288,58,3,2,5,60.0%,14m
22239,2,SPIKE,2288,66,2,3,5,40.0%,47m
22239,2,[我菜请打队友]chouachou,2288,0,1,2,3,33.3%,1h
22239,2,不羡仙,2288,30,1,2,3,33.3%,14m
22239,1,劳之寒梦,2288,90,1,4,5,20.0%,27m
22239,1,[四系乃啦啦啦]卓亦逊,2288,48,1,4,5,20.0%,46m
22239,2,正月初柒,2288,0,1,4,5,20.0%,47m
22258,1,野马脱缰,2287,1650,100,109,209,47.8%,22m
22258,1,没落尘埃,2287,1255,57,55,112,50.9%,4m
22258,2,[柠檬保护协会]国宝熊猫,2287,330,10,10,20,50.0%,10m
22258,2,[透一下清酒]老天师,2287,96,4,2,6,66.7%,1h
22258,1,必胜客在逃披萨,2287,0,2,5,7,28.6%,30m
22258,3,嘉文,2287,0,1,0,1,100.0%,25m
22258,2,她还未婚我想等等,2287,0,1,0,1,100.0%,1h
22258,3,光耀星痕,2287,0,1,0,1,100.0%,48m
22258,2,wuli,2287,0,1,0,1,100.0%,47m
22258,2,LSHH,2287,0,0,2,2,0.0%,1h
22258,1,天文鬼球,2287,0,0,6,6,0.0%,56m
22269,1,基努里维斯,2286,1687,108,106,214,50.5%,5m
22269,1,橘子指挥官,2286,1566,93,90,183,50.8%,42m
22269,2,雷神之锥,2286,542,27,18,45,60.0%,1h
22269,3,AstraeusZZZZ,2286,694,25,34,59,42.4%,1h
22269,1,CAY,2286,373,18,11,29,62.1%,1h
22269,2,VENNLIZST,2286,340,13,10,23,56.5%,1h
22269,1,劲风小草,2286,147,10,7,17,58.8%,1h
22269,2,[祥瑞战舰]雪风,2286,228,8,7,15,53.3%,8m
22269,2,[丢丢神明]周宇翔,2286,137,7,2,9,77.8%,1h
22269,1,Sparrow,2286,122,3,4,7,42.9%,1h
22269,3,TaitDana,2286,96,2,0,2,100.0%,1h
22269,1,小星星,2286,40,2,5,7,28.6%,1h
22269,2,guguEnoch,2286,0,1,1,2,50.0%,1h
22269,1,Silver,2286,0,1,2,3,33.3%,5m
22269,2,Xavier,2286,32,1,3,4,25.0%,24m
22269,2,Mordred,2286,0,1,5,6,16.7%,1h
22269,2,没有退路可言,2286,0,0,1,1,0.0%,56m
22286,1,[MZZ]小皮,2285,539,21,25,46,45.7%,1h
22286,1,HcyDD,2285,240,21,27,48,43.8%,33m
22286,2,虫虫,2285,459,20,8,28,71.4%,14m
22286,2,[特工]繁简繁,2285,548,19,15,34,55.9%,1h
22286,1,xiaozhu,2285,438,15,16,31,48.4%,1h
22286,3,哈哈哈哈,2285,242,7,8,15,46.7%,1h
22286,1,奇异磕翔兽,2285,260,7,15,22,31.8%,53m
22286,1,[007号探机]北京大兴谢霆锋,2285,210,6,10,16,37.5%,1h
22286,2,霞小猪,2285,154,5,4,9,55.6%,1h
22286,1,用户名为空,2285,188,4,7,11,36.4%,18m
22286,2,走神的阿业,2285,0,1,0,1,100.0%,1h
22286,1,Maxwell,2285,0,1,0,1,100.0%,18m
22286,2,观察者,2285,0,1,4,5,20.0%,1h
22286,2,凯瑞甘你好翘,2285,0,1,5,6,16.7%,19m
22286,2,woshibaba,2285,0,0,2,2,0.0%,56m
22301,1,NbUniversity,2284,1722,210,225,435,48.3%,27m
22301,1,霸气淡定的路人王,2284,1019,37,45,82,45.1%,1h
22301,1,Tamis,2284,422,13,18,31,41.9%,32m
22301,3,yelong,2284,52,13,20,33,39.4%,1h
22301,1,知之甚远,2284,420,12,19,31,38.7%,1h
22301,1,金太阳,2284,150,6,8,14,42.9%,4m
22301,3,狂战雄霸,2284,158,6,10,16,37.5%,50m
22301,3,永爱,2284,171,5,10,15,33.3%,1h
22301,3,遥望,2284,88,5,10,15,33.3%,1h
22301,3,唧唧复唧唧,2284,58,3,2,5,60.0%,52m
22301,2,片甲不留,2284,66,2,2,4,50.0%,46m
22301,1,怡怡在哪里吖,2284,117,2,5,7,28.6%,1h
22301,2,DNP,2284,0,1,2,3,33.3%,42m
22301,2,芜湖厨司,2284,0,1,4,5,20.0%,7m
22301,2,茫然,2284,0,0,2,2,0.0%,33m
22301,2,落地维京,2284,0,0,2,2,0.0%,35m
22301,3,我杀我自己,2284,0,0,3,3,0.0%,1h
22318,3,OSlaozhao,2283,1469,87,94,181,48.1%,57m
22318,3,一锅炖不下的鲲,2283,1225,75,74,149,50.3%,42m
22318,2,RICHKING,2283,740,62,74,136,45.6%,1h
22318,1,ling,2283,1344,48,48,96,50.0%,1h
22318,2,[极限菜鸟]plok,2283,501,34,35,69,49.3%,8m
22318,2,[极限菜鸟]黑暗之的舞,2283,800,29,40,69,42.0%,10m
22318,3,lsf,2283,240,28,35,63,44.4%,20m
22318,1,无聊的席经理,2283,402,14,20,34,41.2%,4m
22318,1,[贼tm硬]Hualan,2283,214,7,11,18,38.9%,17m
22318,1,无名少年,2283,141,4,3,7,57.1%,42m
22318,2,嘿夕彤,2283,157,4,4,8,50.0%,35m
22318,3,keysoul,2283,176,4,14,18,22.2%,50m
22318,2,坑爹的人族,2283,44,2,1,3,66.7%,19m
22318,2,饶周俊,2283,34,1,1,2,50.0%,1h
22318,2,LOO,2283,44,1,1,2,50.0%,1h
22318,2,黑色雪绒花,2283,32,1,2,3,33.3%,33m
22318,2,[探机反恐联盟]scv,2283,0,0,2,2,0.0%,1h
22318,2,晕染的五更琉璃,2283,0,0,3,3,0.0%,1h
22336,1,[CPT]棒棒,2282,1068,40,44,84,47.6%,1h
22336,1,王者,2282,523,36,32,68,52.9%,54m
22336,1,[浙江大学战队]DAAD,2282,650,26,30,56,46.4%,1h
22336,2,[丨SLT丨]ZeroZero,2282,645,25,19,44,56.8%,1h
22336,1,ATsDaytime,2282,703,25,26,51,49.0%,15m
22336,2,无情,2282,577,23,15,38,60.5%,56m
22336,2,晴天好心情,2282,457,16,12,28,57.1%,14m
22336,1,[Neeb]wanglei,2282,222,10,5,15,66.7%,15m
22336,1,哥哥是神,2282,260,7,13,20,35.0%,1h
22336,1,[幽灵闪现wo]sdfdsf,2282,206,6,6,12,50.0%,1h
22336,1,SmallCabbage,2282,162,5,6,11,45.5%,2m
22336,1,荡剑随风,2282,140,3,2,5,60.0%,1h
22336,3,ZXKLJ,2282,30,3,9,12,25.0%,1h
22336,2,starlion,2282,0,1,0,1,100.0%,1h
22336,2,木西,2282,0,1,4,5,20.0%,41m
22336,2,我纯不蠢,2282,0,1,5,6,16.7%,7m
22336,1,[极限菜鸟]江左夜行,2282,0,0,1,1,0.0%,1h
22353,1,[NLHR]艾尔,2281,881,36,32,68,52.9%,35m
22353,1,Frostwolf,2281,803,31,31,62,50.0%,1h
22353,1,被猎者白牙,2281,711,26,25,51,51.0%,1h
22353,1,星河盟主,2281,612,21,28,49,42.9%,1h
22353,1,[KOKOKO]菲尼克斯,2281,380,11,16,27,40.7%,49m
22353,2,wjijij,2281,280,9,3,12,75.0%,53m
22353,2,虎虎虎虎虎虎,2281,215,7,14,21,33.3%,46m
22353,1,[Esper]一蓑烟雨任平生,2281,210,6,6,12,50.0%,30m
22353,2,蛰龙已惊眠,2281,0,3,2,5,60.0%,1h
22353,3,坏宝宝,2281,146,3,4,7,42.9%,1h
22353,2,漾开贼在,2281,0,1,0,1,100.0%,48m
22353,2,但为君故,2281,32,1,1,2,50.0%,47m
22353,1,北匿,2281,48,1,3,4,25.0%,3m
22353,2,FirstTime,2281,0,0,1,1,0.0%,47m
22353,1,[秀气男孩]炮炮打在菌毯上,2281,0,0,1,1,0.0%,25m
22353,3,奉我为主,2281,0,0,1,1,0.0%,6m
22369,1,这个杀手不太冷,2280,901,31,35,66,47.0%,49m
22369,1,寒霜行者,2280,404,27,31,58,46.6%,1h
22369,2,只有白龙在挨揍,2280,556,20,15,35,57.1%,14m
22369,3,胡汉三,2280,290,12,8,20,60.0%,1h
22369,2,叶哥哥,2280,232,8,7,15,53.3%,7m
22369,1,路人甲,2280,238,8,9,17,47.1%,15m
22369,3,风间琉璃,2280,145,6,9,15,40.0%,52m
22369,1,TKcoco,2280,162,4,12,16,25.0%,1h
22369,1,[芜湖难铜]心若南风起,2280,142,3,0,3,100.0%,40m
22369,2,[Months]Zest,2280,30,2,0,2,100.0%,1h
22369,1,疾风帅无止境,2280,0,2,3,5,40.0%,1m
22369,1,你带来了希望,2280,46,2,9,11,18.2%,1h
22369,2,沫豫,2280,95,1,2,3,33.3%,59m
22369,3,寂寥的阿琛,2280,0,0,1,1,0.0%,1h
22369,2,[C06904]Libertin,2280,0,0,1,1,0.0%,57m
22369,1,[Gaole]躁动的胖子,2280,0,0,2,2,0.0%,1h
22369,1,哈哈哈,2280,0,0,2,2,0.0%,1h
22369,1,大树,2280,0,0,4,4,0.0%,36m
22387,3,[极限菜鸟]JAC,2279,1538,76,80,156,48.7%,12m
22387,1,DarkEnergy,2279,1646,66,75,141,46.8%,12m
22387,1,FMbudan,2279,695,48,48,96,50.0%,34m
22387,3,Campfire,2279,546,40,40,80,50.0%,1h
22387,1,忘说,2279,1099,40,44,84,47.6%,1h
22387,1,[舰队已抵达]SSS,2279,643,25,19,44,56.8%,15m
22387,1,狗撵摩托,2279,698,23,24,47,48.9%,15m
22387,1,yuanjshfjsnf,2279,454,20,19,39,51.3%,1h
22387,1,[smile]阿斯兰不死鸟,2279,217,13,15,28,46.4%,17m
22387,1,wrtrret,2279,232,7,12,19,36.8%,8m
22387,2,桥言,2279,88,4,0,4,100.0%,3m
22387,3,宇宙大帝,2279,148,4,4,8,50.0%,1h
22387,1,探机说得对,2279,168,3,3,6,50.0%,1h
22387,2,[RaMoC]我的花名,2279,46,2,5,7,28.6%,11m
22387,2,海中鱼,2279,38,2,5,7,28.6%,1h
22387,2,[aolige]金哲牌海蜇皮,2279,94,2,7,9,22.2%,1h
22387,1,[基金会]轻狂书生,2279,72,2,8,10,20.0%,1h
22387,2,冷暖,2279,48,1,3,4,25.0%,1h
22387,2,紫枫叶秋桦,2279,0,1,4,5,20.0%,1h
22387,1,qiaoooo,2279,0,0,1,1,0.0%,1h
22387,2,[TSR]紫林枫,2279,0,0,1,1,0.0%,1h
22387,2,星际指挥官,2279,0,0,1,1,0.0%,1h
22387,2,[西北]小铭同学,2279,0,0,2,2,0.0%,56m
22387,1,[半夏]黑翼路西法,2279,0,0,2,2,0.0%,46m
22411,3,魔兽争霸,2278,812,30,38,68,44.1%,2m
22411,2,luna,2278,680,25,36,61,41.0%,6m
22411,3,馒头就是力量,2278,706,23,38,61,37.7%,1h
22411,2,杨先生生生生,2278,544,21,28,49,42.9%,48m
22411,2,大理石急哦,2278,405,15,9,24,62.5%,54m
22411,3,新梦大狼,2278,390,15,24,39,38.5%,10m
22411,1,污污,2278,373,12,10,22,54.5%,1h
22411,2,辉天,2278,265,8,6,14,57.1%,1h
22411,1,氪金战士,2278,261,6,7,13,46.2%,1h
22411,3,高福帅,2278,204,6,11,17,35.3%,32m
22411,2,青年,2278,134,5,5,10,50.0%,1h
22411,1,叛逆者,2278,164,5,13,18,27.8%,36m
22411,2,不想取名,2278,94,4,5,9,44.4%,1h
22411,2,HansSama,2278,0,3,2,5,60.0%,1h
22411,1,Ivan,2278,48,2,3,5,40.0%,1h
22411,2,ZLT,2278,48,2,6,8,25.0%,47m
22411,2,小同学,2278,0,1,0,1,100.0%,49m
22411,2,[终极蛇皮队]笑望沧溟千军破,2278,0,1,1,2,50.0%,54m
22411,2,lkfthtrl,2278,0,1,4,5,20.0%,44m
22411,1,璨若太阳升朝霞,2278,0,0,2,2,0.0%,1h
22431,1,[NLHR]战任,2277,1461,72,67,139,51.8%,1h
22431,2,神人皇者,2277,461,17,11,28,60.7%,14m
22431,2,zzumi,2277,334,13,14,27,48.1%,52m
22431,1,[Dameng]仲夏夜的梦,2277,387,12,12,24,50.0%,1h
22431,1,apocalypse,2277,117,5,4,9,55.6%,1h
22431,2,[rikkaa]六六六花,2277,88,4,4,8,50.0%,1h
22431,2,[Fe3o4]吾妻蕾姆美如画,2277,60,3,0,3,100.0%,1h
22431,2,KINGofSC,2277,0,1,4,5,20.0%,47m
22431,2,被强煎的蛋,2277,0,0,1,1,0.0%,40m
22440,2,我爱范思哲,2276,1427,67,85,152,44.1%,18m
22440,1,Xavier,2276,1258,58,63,121,47.9%,1h
22440,2,所言尚早,2276,1185,45,46,91,49.5%,21m
22440,1,[温柔兔公主]暮扬思雪,2276,241,12,16,28,42.9%,1h
22440,3,XYfans,2276,275,10,13,23,43.5%,60m
22440,2,[鲁德欢]轰隆隆,2276,169,8,4,12,66.7%,30m
22440,2,KID,2276,172,8,13,21,38.1%,48m
22440,2,危险人物,2276,156,5,3,8,62.5%,1h
22440,2,老魔杖,2276,201,5,6,11,45.5%,14m
22440,3,飞翔的鱼儿,2276,66,4,9,13,30.8%,18m
22440,3,我怎么这么菜,2276,114,4,18,22,18.2%,26m
22440,2,Thooo,2276,141,2,6,8,25.0%,56m
22440,2,NightDragon,2276,0,1,0,1,100.0%,1h
22440,1,城市化天下无双,2276,96,1,3,4,25.0%,22m
22440,2,飞天的拉拉,2276,0,1,4,5,20.0%,1h
22440,2,紫陌青栀,2276,96,1,5,6,16.7%,46m
22440,2,[魔法少女小屋]WDNMD,2276,0,1,5,6,16.7%,36m
22440,2,funshion,2276,0,0,3,3,0.0%,17m
22458,2,御霄凌宇,2275,1611,69,68,137,50.4%,1h
22458,3,Sagittarius,2275,1193,56,49,105,53.3%,1h
22458,3,夜太黑,2275,1167,51,53,104,49.0%,1h
22458,1,Mrsluo,2275,847,42,36,78,53.8%,1h
22458,3,StArII,2275,996,37,45,82,45.1%,1h
22458,1,只会流氓舰队啊,2275,825,28,37,65,43.1%,51m
22458,1,kkaiez,2275,464,17,23,40,42.5%,1h
22458,2,野猪爱星灵,2275,214,6,7,13,46.2%,17m
22458,2,艾尔之盾的小萌萌,2275,92,4,4,8,50.0%,1h
22458,2,xidms,2275,32,2,1,3,66.7%,1h
22458,2,叮噹,2275,30,2,1,3,66.7%,1h
22458,2,蔚蓝之翼,2275,30,1,2,3,33.3%,1h
22458,2,[Fiend]aiaiai,2275,0,0,1,1,0.0%,1h
22458,2,守空房好,2275,0,0,1,1,0.0%,1h
22458,2,[RPD神教]leo,2275,0,0,1,1,0.0%,1h
22458,1,炸鸡人柱力,2275,0,0,1,1,0.0%,1h
22458,2,TANGUAN,2275,0,0,2,2,0.0%,1h
22458,1,乱世小熊,2275,0,0,2,2,0.0%,1h
22476,1,半边酒窝,2274,1322,61,61,122,50.0%,1h
22476,2,Gilgamesh,2274,699,28,22,50,56.0%,1h
22476,2,先死后生,2274,529,19,15,34,55.9%,1h
22476,1,[CPT]啥啊你们在哪,2274,142,3,0,3,100.0%,1h
22476,2,EFSFSP,2274,58,3,1,4,75.0%,24m
22476,1,提尔皮茨,2274,117,3,7,10,30.0%,1h
22476,1,艾尔之子,2274,0,2,5,7,28.6%,22m
22476,2,冷灬弑,2274,0,1,0,1,100.0%,8m
22476,3,真的很强,2274,0,1,1,2,50.0%,1h
22476,1,[你瞧不起我吗]暗墓,2274,0,0,5,5,0.0%,42m
22476,1,青龙,2274,0,0,5,5,0.0%,1h
22487,1,无心不灭,2273,1000,37,41,78,47.4%,1h
22487,1,华丽凯歌,2273,943,37,43,80,46.2%,49m
22487,1,七夜灬飘零,2273,369,11,13,24,45.8%,26m
22487,3,[孫红雷]卡卡罗特,2273,244,8,14,22,36.4%,1h
22487,2,白纸剩女,2273,259,7,6,13,53.8%,48m
22487,1,[M8]三五磷酸二酯键,2273,156,4,11,15,26.7%,49m
22487,1,Bidepan,2273,78,3,5,8,37.5%,2m
22487,1,xiaohaodesu,2273,48,2,1,3,66.7%,56m
22487,1,[柒堇年华]远汀,2273,44,2,6,8,25.0%,21m
22487,1,Caesar,2273,0,1,0,1,100.0%,1h
22487,2,miracle,2273,0,1,4,5,20.0%,1h
22487,2,deadlyghost,2273,0,0,1,1,0.0%,1h
22487,2,[赞美生物质]Amlip,2273,0,0,1,1,0.0%,7m
22500,2,晏景明,2272,360,18,7,25,72.0%,1h
22500,1,[浦大]派大吐星沫子,2272,577,18,23,41,43.9%,1h
22500,1,wbyxy,2272,449,13,17,30,43.3%,1h
22500,2,诺斯,2272,295,11,6,17,64.7%,1h
22500,3,JUNC,2272,258,9,6,15,60.0%,1h
22500,2,[极限菜鸟]神圣邻域,2272,260,9,12,21,42.9%,21m
22500,2,丿幻丶梦姬,2272,160,9,14,23,39.1%,1h
22500,2,[小鸡屠宰场3]saiwen,2272,214,7,2,9,77.8%,1h
22500,1,Supril,2272,97,5,5,10,50.0%,1h
22500,1,[无魂之鸭]齐峰大帅比,2272,190,5,8,13,38.5%,2m
22500,2,DarkTemplar,2272,46,4,4,8,50.0%,7m
22500,1,万古霉素,2272,143,4,7,11,36.4%,56m
22500,1,康河的叹息,2272,190,4,8,12,33.3%,1h
22500,2,PhoenixAnke,2272,97,3,4,7,42.9%,7m
22500,2,IIIIIIIIIII,2272,58,2,1,3,66.7%,17m
22500,1,解脱,2272,0,2,6,8,25.0%,46m
22500,2,FABchen,2272,42,2,6,8,25.0%,56m
22500,2,星际,2272,0,1,0,1,100.0%,53m
22500,2,[雨披]ASD,2272,0,1,0,1,100.0%,17m
22500,2,dfsfsfsf,2272,30,1,1,2,50.0%,48m
22500,2,Bunn,2272,30,1,2,3,33.3%,30m
22500,2,脚踩德哈卡,2272,0,1,4,5,20.0%,1h
22500,2,飞哥,2272,0,1,5,6,16.7%,44m
22500,1,西门,2272,0,0,1,1,0.0%,47m
22500,1,fanys,2272,0,0,3,3,0.0%,1h
22525,2,龙曾在此,2271,1316,85,82,167,50.9%,1h
22525,2,二分之一,2271,539,24,23,47,51.1%,1h
22525,2,皮皮虾,2271,472,18,22,40,45.0%,10m
22525,2,忘忧果,2271,370,11,11,22,50.0%,1h
22525,2,九尾凶猫,2271,152,6,6,12,50.0%,14m
22525,1,[葫芦娃救艾尔]豫才,2271,144,3,2,5,60.0%,1h
22525,2,顺劈斩,2271,0,3,4,7,42.9%,7m
22525,1,撸一发,2271,97,2,4,6,33.3%,25m
22525,1,独角兽,2271,107,2,6,8,25.0%,2m
22525,2,[搞笑打星际]PTCAT,2271,0,1,2,3,33.3%,1h
22525,2,[TOD死神]贪狼星君,2271,36,1,2,3,33.3%,53m
22525,2,[修罗王]匪军战神,2271,0,1,5,6,16.7%,35m
22525,2,[小鸡屠宰场b]柠檬红茶,2271,0,0,2,2,0.0%,1h
22525,1,原谅犬,2271,0,0,3,3,0.0%,1m
22539,1,dragoonzheng,2270,387,16,13,29,55.2%,15m
22539,1,[TLGD]Bomb,2270,368,13,12,25,52.0%,1h
22539,3,[贤者也]贤者,2270,268,9,6,15,60.0%,1h
22539,2,[SC2FT]MiracleMaker,2270,106,6,1,7,85.7%,56m
22539,2,miss,2270,102,4,1,5,80.0%,1h
22539,1,也无风雨也无晴,2270,158,4,9,13,30.8%,1h
22539,3,BLADE,2270,30,3,9,12,25.0%,2m
22539,2,夏川真凉,2270,109,2,6,8,25.0%,11m
22539,1,[彼岸之花]小天才,2270,0,1,1,2,50.0%,46m
22539,2,[萌羞羞]冥的忧伤,2270,0,1,5,6,16.7%,1h
22539,2,wddks,2270,0,0,1,1,0.0%,1h
22539,2,[干就完事]没落丶瞄,2270,0,0,1,1,0.0%,1h
22551,1,Sherlock,2269,1005,40,46,86,46.5%,59m
22551,1,jathet,2269,829,27,29,56,48.2%,60m
22551,2,[XXHZN1]方十里,2269,549,20,22,42,47.6%,1h
22551,1,文文文文,2269,498,20,25,45,44.4%,1h
22551,2,[在下菜鸡一只]probe,2269,375,14,11,25,56.0%,1h
22551,2,欧阳咳咳,2269,200,6,8,14,42.9%,33m
22551,2,姤海大鲨鱼,2269,188,6,12,18,33.3%,48m
22551,2,kino,2269,0,3,9,12,25.0%,14m
22551,2,aaa,2269,68,2,2,4,50.0%,1h
22551,2,JanKezy,2269,30,1,1,2,50.0%,1h
22551,3,来点血,2269,97,1,5,6,16.7%,1h
22551,1,用土埋葬,2269,40,1,8,9,11.1%,6m
22551,2,SUNFLOWERS,2269,0,0,1,1,0.0%,49m
22564,2,AWM,2268,1651,130,129,259,50.2%,52m
22564,3,北辰骑士,2268,293,11,13,24,45.8%,1h
22564,2,asdf,2268,210,8,4,12,66.7%,7m
22564,2,你的资源不足,2268,216,8,6,14,57.1%,14m
22564,3,shenjingbing,2268,239,7,13,20,35.0%,1h
22564,2,神话筱茨,2268,122,2,9,11,18.2%,1h
22564,2,novadersere,2268,0,1,5,6,16.7%,35m
22564,2,笑我孤陋,2268,0,0,2,2,0.0%,1h
22572,1,地藏,2267,896,48,43,91,52.7%,43m
22572,2,srunning,2267,671,23,24,47,48.9%,1h
22572,1,[打不来正面]别拆我基地,2267,621,20,27,47,42.6%,4m
22572,2,烟鬼,2267,444,18,21,39,46.2%,40m
22572,2,dnmajhjdh,2267,500,17,18,35,48.6%,1h
22572,2,NoBle,2267,272,16,11,27,59.3%,1h
22572,3,陌上人如玉,2267,354,14,10,24,58.3%,1h
22572,1,Nicolas,2267,476,13,18,31,41.9%,26m
22572,2,[璀璨群星之刃]八级大狂风,2267,289,11,11,22,50.0%,1h
22572,2,暴血,2267,175,11,12,23,47.8%,52m
22572,1,冰霜之树,2267,339,10,15,25,40.0%,1h
22572,2,[天门]清风,2267,240,9,7,16,56.2%,1h
22572,1,[Asc2]初代玛卡巴卡,2267,279,8,10,18,44.4%,1h
22572,2,chicken,2267,228,7,10,17,41.2%,1h
22572,2,老鬼,2267,140,5,5,10,50.0%,1h
22572,1,hamber,2267,140,5,8,13,38.5%,1h
22572,1,[最菜战队]Maybe,2267,176,4,6,10,40.0%,15m
22572,2,魁札尔科亚斑,2267,41,3,2,5,60.0%,37m
22572,2,黑白格,2267,88,3,3,6,50.0%,14m
22572,3,对面爷爷,2267,86,3,8,11,27.3%,1h
22572,1,GreenXN,2267,118,3,10,13,23.1%,1h
22572,2,SHNNG,2267,32,2,2,4,50.0%,1h
22572,2,阿一哥哥,2267,62,2,4,6,33.3%,1h
22572,2,Asuna,2267,0,1,0,1,100.0%,1h
22572,2,kitou,2267,36,1,2,3,33.3%,52m
22572,2,青鲨君,2267,0,1,4,5,20.0%,33m
22572,2,[我觉得不行]我觉得我行,2267,0,0,1,1,0.0%,36m
22572,1,雪姬,2267,0,0,5,5,0.0%,1h
22600,1,[整个活]窝佬攻,2266,888,49,57,106,46.2%,1h
22600,2,喵喵喵不是汪汪汪,2266,585,43,42,85,50.6%,52m
22600,3,会飞的猪噜噜,2266,510,17,31,48,35.4%,4m
22600,1,[新的蜜蜂]Luka,2266,447,15,22,37,40.5%,27m
22600,1,神主殿下,2266,308,9,15,24,37.5%,8m
22600,2,WTW,2266,0,5,1,6,83.3%,41m
22600,3,[蒙蔽梦游团]stardust,2266,186,5,9,14,35.7%,1h
22600,2,我今天三岁了,2266,167,4,2,6,66.7%,29m
22600,1,无限,2266,144,4,3,7,57.1%,1h
22600,1,为啥呀,2266,144,3,1,4,75.0%,1h
22600,2,Force,2266,88,3,7,10,30.0%,1h
22600,1,Max,2266,121,3,7,10,30.0%,1h
22600,2,[耗子尾汁]mIaO,2266,30,3,9,12,25.0%,1h
22600,2,无情老司机,2266,32,2,3,5,40.0%,1h
22600,2,式以京,2266,46,2,5,7,28.6%,35m
22600,3,[F2ANB]雪月,2266,121,2,6,8,25.0%,1h
22600,2,[神子]灰色时间,2266,0,1,0,1,100.0%,1h
22600,2,[化学工厂]塔萨达,2266,0,0,4,4,0.0%,1h
22618,2,墨玉,2265,564,24,19,43,55.8%,1h
22618,1,Chara,2265,676,22,33,55,40.0%,1h
22618,2,橙子,2265,393,14,10,24,58.3%,30m
22618,2,凤雏,2265,331,14,11,25,56.0%,17m
22618,2,酆都范无救,2265,284,13,7,20,65.0%,1h
22618,2,[DMRc]一路光明,2265,224,9,5,14,64.3%,14m
22618,2,liu,2265,217,9,5,14,64.3%,53m
22618,1,钱穆父,2265,226,7,7,14,50.0%,15m
22618,2,LuckyDragon,2265,121,5,3,8,62.5%,1h
22618,1,不过一场少年梦,2265,152,5,8,13,38.5%,27m
22618,1,那晚没有安,2265,177,4,6,10,40.0%,5m
22618,2,死神麒麟,2265,68,3,1,4,75.0%,1h
22618,2,寂寞人生,2265,88,3,3,6,50.0%,1h
22618,2,Asang,2265,160,3,7,10,30.0%,1h
22618,2,ghost,2265,22,2,1,3,66.7%,1h
22618,2,珺珹珹,2265,60,2,5,7,28.6%,1h
22618,3,人生梦死,2265,0,2,7,9,22.2%,22m
22618,2,[萌新启发会]洛基山狼,2265,40,1,1,2,50.0%,1h
22618,2,幽丶蓝,2265,0,1,1,2,50.0%,1h
22618,3,笑话,2265,0,1,1,2,50.0%,8m
22618,2,司徒爱劝七,2265,34,1,3,4,25.0%,3m
22618,2,双木林丶,2265,0,1,5,6,16.7%,44m
22640,1,珠珠侠,2264,1526,70,68,138,50.7%,1h
22640,2,WARS,2264,1390,53,50,103,51.5%,1h
22640,1,老鐵木真的假的,2264,933,50,49,99,50.5%,43m
22640,1,星光奉献给长夜,2264,801,38,26,64,59.4%,1h
22640,1,Ehud,2264,818,26,33,59,44.1%,21m
22640,1,[温柔兔公主]闲云野鹤,2264,614,23,26,49,46.9%,58m
22640,2,stdio,2264,574,21,10,31,67.7%,53m
22640,1,王魔,2264,288,9,21,30,30.0%,1h
22640,2,吉迈器楽行,2264,242,8,11,19,42.1%,52m
22640,2,血染的图腾,2264,186,7,8,15,46.7%,21m
22640,1,北凤,2264,186,5,6,11,45.5%,27m
22640,2,zjc,2264,48,3,1,4,75.0%,14m
22640,2,svipMissWang,2264,0,3,2,5,60.0%,33m
22640,2,ParTing,2264,62,3,3,6,50.0%,1h
22640,2,[西伯利亚土豆]胡杨,2264,30,2,0,2,100.0%,1h
22640,3,[中铁十七局]Tossboy,2264,0,2,7,9,22.2%,1h
22640,2,niuluoguo,2264,0,1,0,1,100.0%,1h
22640,2,影之龙吟,2264,0,1,0,1,100.0%,57m
22640,2,轩宇,2264,0,1,4,5,20.0%,1h
22640,2,徐小俊,2264,0,1,5,6,16.7%,41m
22640,2,德鲁伊,2264,0,0,2,2,0.0%,1h
22640,1,IIIIIIIIII,2264,0,0,2,2,0.0%,1h
22662,1,llll,2263,1183,57,61,118,48.3%,55m
22662,3,[欢迎萌新]Lstjay,2263,522,31,40,71,43.7%,1h
22662,3,NEwLife,2263,708,25,33,58,43.1%,31m
22662,3,新手但不想打人机,2263,269,9,13,22,40.9%,11m
22662,3,deli,2263,244,9,14,23,39.1%,6m
22662,3,玖夏,2263,122,7,10,17,41.2%,1h
22662,2,[13BES]zhl,2263,90,4,2,6,66.7%,46m
22662,2,Shadow,2263,58,3,2,5,60.0%,1h
22662,2,别无忈,2263,90,3,3,6,50.0%,1h
22662,2,[四叶草]Faliscr,2263,150,3,5,8,37.5%,1h
22662,2,骄傲的少年,2263,66,2,4,6,33.3%,1h
22662,1,LGD,2263,30,2,5,7,28.6%,33m
22662,2,Miss,2263,30,1,2,3,33.3%,29m
22662,1,恋旧丶否,2263,0,1,2,3,33.3%,42m
22662,2,sssnnnn,2263,0,1,6,7,14.3%,29m
22677,2,无名书生,2262,1489,58,62,120,48.3%,1h
22677,2,YYDawn,2262,908,33,34,67,49.3%,14m
22677,1,永不空二技能,2262,568,26,27,53,49.1%,1h
22677,1,快乐奶牛,2262,787,26,36,62,41.9%,12m
22677,2,恶龙出闸,2262,584,20,19,39,51.3%,1h
22677,1,大魔王,2262,327,8,10,18,44.4%,46m
22677,1,[SCL]吉吉国王,2262,212,7,7,14,50.0%,36m
22677,2,[Hdl]聆听,2262,96,6,0,6,100.0%,36m
22677,2,Max,2262,156,6,2,8,75.0%,24m
22677,2,[太微玉清宫]QWQ,2262,0,3,2,5,60.0%,1h
22677,2,[91二五仔]Jason,2262,98,3,5,8,37.5%,52m
22677,1,[渣男团体]土间埋,2262,96,2,5,7,28.6%,1h
22677,2,水银灯,2262,0,1,0,1,100.0%,30m
22677,3,为了艾尔而战,2262,0,1,0,1,100.0%,6m
22677,2,STEVEN,2262,0,1,0,1,100.0%,14m
22677,1,电竞男神郭德纲,2262,96,1,1,2,50.0%,38m
22677,2,大金曜,2262,0,1,5,6,16.7%,1h
22677,2,朽木,2262,0,0,4,4,0.0%,1h
22695,1,STARX,2261,736,27,43,70,38.6%,1h
22695,3,[暴雪二十二队]小佳哥们,2261,512,19,19,38,50.0%,22m
22695,2,[佳宏]bseryseuysrn,2261,367,15,3,18,83.3%,48m
22695,1,明日之后,2261,372,14,11,25,56.0%,1h
22695,2,北冥一只鲲,2261,314,13,5,18,72.2%,17m
22695,2,fate,2261,363,11,10,21,52.4%,1h
22695,1,buyaonilikai,2261,148,7,6,13,53.8%,40m
22695,2,hero,2261,263,7,10,17,41.2%,49m
22695,2,晚风吻尽荷花叶,2261,170,6,5,11,54.5%,1h
22695,2,[谐星快乐人]XIAO,2261,82,4,3,7,57.1%,1h
22695,1,[在下萌新一只]piaopiao,2261,144,4,9,13,30.8%,4m
22695,3,[886]六七八美酒,2261,68,4,11,15,26.7%,1h
22695,2,无名,2261,60,3,4,7,42.9%,8m
22695,1,ZAKAQ,2261,97,3,4,7,42.9%,18m
22695,2,YXXL,2261,0,2,3,5,40.0%,14m
22695,2,幽魂,2261,0,0,1,1,0.0%,21m
22695,2,旅客,2261,0,0,1,1,0.0%,1h
22712,1,都是大的,2260,1183,63,67,130,48.5%,42m
22712,3,随缘,2260,1021,35,45,80,43.8%,11m
22712,2,南柯一梦丶,2260,748,31,36,67,46.3%,1h
22712,2,啦啦啦,2260,452,16,14,30,53.3%,14m
22712,2,李子桃,2260,376,14,13,27,51.9%,1h
22712,2,xxxxxxxYc,2260,431,13,19,32,40.6%,53m
22712,2,求求你别杀我,2260,247,10,1,11,90.9%,1h
22712,1,[三口组]蓝天逝,2260,291,8,9,17,47.1%,50m
22712,1,为了血与雷霆,2260,245,7,9,16,43.8%,26m
22712,1,我要做有素质的人,2260,280,6,10,16,37.5%,1h
22712,3,[我们都是宝宝]周公子熙,2260,149,4,7,11,36.4%,44m
22712,2,阿尔法,2260,96,3,3,6,50.0%,56m
22712,2,llllllllllll,2260,0,3,9,12,25.0%,54m
22712,2,雲绮暮,2260,102,3,14,17,17.6%,1h
22712,2,无状态,2260,0,1,0,1,100.0%,37m
22712,2,卡拉之光,2260,30,1,2,3,33.3%,1h
22712,2,[星际老蓝海]jjy,2260,0,1,4,5,20.0%,7m
22712,2,哟儿我是的念着倒,2260,0,1,5,6,16.7%,1h
22712,2,[啊呜哒]deJager,2260,30,1,5,6,16.7%,47m
22712,2,[别杀我农民]一木,2260,0,0,2,2,0.0%,1h
22732,2,红尘过客,2259,1602,61,60,121,50.4%,54m
22732,2,DivineJudge,2259,1314,52,51,103,50.5%,46m
22732,1,tassder,2259,1073,37,46,83,44.6%,1h
22732,2,wtc,2259,0,3,10,13,23.1%,1h
22732,2,蜗牛君,2259,95,2,1,3,66.7%,7m
22732,2,生活呢,2259,0,2,2,4,50.0%,1h
22732,1,Zero,2259,0,2,4,6,33.3%,43m
22732,2,bthdglp,2259,0,1,4,5,20.0%,35m
22732,2,小魏君,2259,0,0,1,1,0.0%,1h
22741,1,[极限菜鸟]hollykaka,2258,1573,125,129,254,49.2%,6m
22741,3,寂静,2258,1049,40,51,91,44.0%,1h
22741,1,星灵陈主教,2258,1013,35,45,80,43.8%,15m
22741,2,神不在的星期天,2258,560,21,20,41,51.2%,17m
22741,2,Rudolf,2258,528,18,17,35,51.4%,1h
22741,1,王妞妞飞的快,2258,318,14,17,31,45.2%,1h
22741,1,周小时,2258,248,8,14,22,36.4%,4m
22741,2,宝贝孙一喵,2258,146,6,4,10,60.0%,1h
22741,1,Lonely,2258,142,5,4,9,55.6%,19m
22741,3,远道,2258,171,5,6,11,45.5%,60m
22741,1,[最初的星光]谱尼,2258,180,5,7,12,41.7%,52m
22741,1,虫神略,2258,131,3,4,7,42.9%,1h
22741,2,送分器,2258,60,2,1,3,66.7%,1h
22741,1,yuz,2258,0,0,2,2,0.0%,5m
22741,3,星际虎,2258,0,0,2,2,0.0%,49m
22741,1,[注意防守]魂断情殇,2258,0,0,3,3,0.0%,1h
22757,1,小小小学生来了,2257,1575,91,96,187,48.7%,50m
22757,3,[在下菜鸡一只]mountc,2257,866,45,58,103,43.7%,1h
22757,2,枭隼,2257,361,18,25,43,41.9%,1h
22757,2,Antediluvian,2257,297,12,3,15,80.0%,1h
22757,3,提携玉龙为卿死,2257,243,8,11,19,42.1%,1h
22757,1,南瓜糖,2257,126,7,12,19,36.8%,19m
22757,2,[诺娃的隐身衣]曾经无药可救,2257,168,5,4,9,55.6%,46m
22757,2,[绘梨依]Edgar,2257,158,5,7,12,41.7%,48m
22757,2,[似有似无]黑蝠魔皇,2257,58,3,1,4,75.0%,40m
22757,1,似初,2257,96,2,8,10,20.0%,1h
22757,2,chen,2257,92,1,5,6,16.7%,41m
22757,2,ArthurLWANG,2257,0,0,1,1,0.0%,58m
22769,1,欢迎来到祖安,2256,733,63,60,123,51.2%,21m
22769,3,岷白人,2256,233,8,10,18,44.4%,60m
22769,1,啊欢卖萌,2256,296,8,15,23,34.8%,49m
22769,3,[让你三刀]学习影响早恋,2256,94,6,10,16,37.5%,1h
22769,1,[小花]小米智能吱吱吱吱,2256,137,4,2,6,66.7%,1h
22769,2,绿色环保,2256,32,4,3,7,57.1%,59m
22769,2,一只小猫,2256,134,4,4,8,50.0%,1h
22769,2,甲壳布,2256,126,4,10,14,28.6%,1h
22769,1,[传说指挥官]月下流丽,2256,143,3,6,9,33.3%,22m
22769,2,为什么逼汗,2256,44,2,0,2,100.0%,7m
22769,2,liumo,2256,36,2,3,5,40.0%,1h
22769,2,流浪神,2256,46,2,6,8,25.0%,35m
22769,3,差点不是帅哥,2256,0,1,0,1,100.0%,1h
22769,2,剑与远征,2256,30,1,1,2,50.0%,8m
22769,2,失眠騒,2256,0,0,2,2,0.0%,1h
22784,3,hjj,2255,908,131,136,267,49.1%,1h
22784,2,星际路行者,2255,304,14,14,28,50.0%,10m
22784,1,豪风破魔虫,2255,383,14,21,35,40.0%,1h
22784,2,琪丶江,2255,448,14,27,41,34.1%,1h
22784,1,STARDUST,2255,382,12,15,27,44.4%,34m
22784,2,WCGshief,2255,236,8,7,15,53.3%,29m
22784,2,一注,2255,184,7,7,14,50.0%,21m
22784,1,鲍鱼蛋子君,2255,184,5,13,18,27.8%,35m
22784,1,大主教本尼迪塔斯,2255,48,2,8,10,20.0%,38m
22784,2,梦醒不相忆,2255,0,0,1,1,0.0%,1h
22784,2,[迅哥儿]cdp,2255,0,0,1,1,0.0%,59m
22784,2,Hiker,2255,0,0,2,2,0.0%,47m
22796,1,[SKO丶M]来互相伤害啊,2254,270,75,67,142,52.8%,20m
22796,1,勿忘秦岭,2254,958,54,57,111,48.6%,32m
22796,1,Coldfire,2254,1141,43,43,86,50.0%,1h
22796,2,王大头,2254,790,29,32,61,47.5%,29m
22796,1,[AKC]deltagogogo,2254,601,19,23,42,45.2%,27m
22796,2,MIsaya,2254,432,17,11,28,60.7%,40m
22796,1,铁木尔达,2254,358,17,18,35,48.6%,17m
22796,2,[不灭青铜]萧萧,2254,202,8,0,8,100.0%,14m
22796,2,母舰骑脸,2254,272,8,7,15,53.3%,1h
22796,2,[时光与酒oc]被太子虐的人机,2254,233,6,10,16,37.5%,48m
22796,2,林夜秋,2254,185,5,5,10,50.0%,1h
22796,2,[星舰与太阳x]Crane,2254,90,4,2,6,66.7%,49m
22796,2,骚扰我必诛之,2254,118,4,3,7,57.1%,33m
22796,2,徐大壮爱扫雷,2254,153,4,4,8,50.0%,36m
22796,1,quantum,2254,192,4,8,12,33.3%,38m
22796,2,TinTin,2254,58,3,1,4,75.0%,1h
22796,2,瞬间风,2254,38,2,1,3,66.7%,46m
22796,1,[s黑色孤儿s]帝国军,2254,95,2,2,4,50.0%,2m
22796,2,[山吹的聚光]夹心酱,2254,0,1,0,1,100.0%,1h
22796,2,咸鱼领主,2254,30,1,1,2,50.0%,29m
22796,3,深渊领主卢克索,2254,97,1,2,3,33.3%,50m
22796,2,咕叽咕叽,2254,0,0,1,1,0.0%,1h
22796,2,梦千,2254,0,0,1,1,0.0%,1h
22796,2,遥远的拂晓风暴眼,2254,0,0,2,2,0.0%,1h
22820,1,[VIC]shunshun,2253,1199,40,56,96,41.7%,1h
22820,2,[王者重现]康乾盛世,2253,297,11,5,16,68.8%,42m
22820,2,奎爷,2253,170,7,3,10,70.0%,1h
22820,3,破晓,2253,196,6,4,10,60.0%,1h
22820,3,神圣黑鸡,2253,164,5,7,12,41.7%,1h
22820,2,佟先生,2253,46,2,1,3,66.7%,59m
22820,2,爱得痛了,2253,34,2,3,5,40.0%,10m
22820,2,老左二货,2253,60,2,4,6,33.3%,14m
22820,2,断桥之上,2253,116,2,6,8,25.0%,1h
22820,2,[异端审判]ILxy,2253,30,1,1,2,50.0%,8m
22820,2,[Onceme]星际战神,2253,0,0,2,2,0.0%,48m
22831,2,wolverine,2252,885,38,38,76,50.0%,46m
22831,2,dfawsdfwadaw,2252,760,32,23,55,58.2%,1h
22831,2,[天气]廉价旅行者,2252,477,28,33,61,45.9%,1h
22831,3,[无敌之师]亮霸王,2252,388,15,18,33,45.5%,57m
22831,2,gggg,2252,178,6,7,13,46.2%,14m
22831,2,列兵阿奇,2252,30,2,0,2,100.0%,1h
22831,2,靠骗靠噢偷袭,2252,58,2,2,4,50.0%,53m
22831,2,死对头威尔特,2252,0,1,0,1,100.0%,7m
22831,2,Picard,2252,0,1,0,1,100.0%,37m
22831,2,晨曦之光,2252,0,1,4,5,20.0%,1h
22831,2,谨言慎行,2252,48,1,4,5,20.0%,1h
22831,2,简影,2252,0,0,1,1,0.0%,31m
22831,2,yan,2252,0,0,3,3,0.0%,3m
22831,2,achao,2252,0,0,5,5,0.0%,1h
22845,2,flash,2251,1052,92,101,193,47.7%,1h
22845,1,慢攻小王子,2251,1613,91,94,185,49.2%,1h
22845,1,是耿良辰呐,2251,422,17,18,35,48.6%,19m
22845,2,[菜鸡一起娱乐]小黑大王,2251,188,6,9,15,40.0%,52m
22845,1,天天,2251,213,6,9,15,40.0%,1h
22845,2,靓仔,2251,148,5,6,11,45.5%,1h
22845,2,浪子党,2251,96,4,5,9,44.4%,8m
22845,2,封建大帝,2251,124,4,6,10,40.0%,1h
22845,2,sherlockme,2251,142,4,24,28,14.3%,2m
22845,1,zealot,2251,74,3,8,11,27.3%,1h
22845,1,Aaron,2251,122,3,12,15,20.0%,15m
22845,2,艾陆可,2251,50,2,4,6,33.3%,40m
22845,2,[永逺亭]知名实况主油卡里,2251,0,1,0,1,100.0%,1h
22845,2,[FYXZ]东道主,2251,0,1,1,2,50.0%,48m
22845,2,[风暴ING]夜月青云,2251,30,1,2,3,33.3%,1h
22845,2,乾坤界主,2251,0,1,4,5,20.0%,56m
22845,1,wang,2251,0,0,1,1,0.0%,1h
22862,1,反杀闰土的猹,2250,422,106,98,204,52.0%,1h
22862,1,Ack,2250,992,39,34,73,53.4%,56m
22862,2,shallow,2250,280,9,17,26,34.6%,29m
22862,2,skkssk,2250,178,6,8,14,42.9%,1h
22862,1,SSEstonis,2250,215,5,10,15,33.3%,2m
22862,2,[社交学超可爱]叶玄,2250,240,5,11,16,31.2%,17m
22862,2,[SC2战队]百里东风,2250,0,4,1,5,80.0%,35m
22862,2,埃及法少,2250,0,0,1,1,0.0%,56m
22862,2,一切战术皆换家,2250,0,0,1,1,0.0%,1h
22862,2,[游戏风云OL]sdfasda,2250,0,0,1,1,0.0%,1h
22872,1,冰雨的风暴,2249,950,61,56,117,52.1%,17m
22872,2,不理不理左卫门,2249,638,35,43,78,44.9%,1h
22872,2,查查,2249,538,32,28,60,53.3%,1h
22872,2,xiegtgggk,2249,659,27,19,46,58.7%,17m
22872,1,Jaunt,2249,838,27,30,57,47.4%,44m
22872,2,codyvon,2249,704,23,27,50,46.0%,47m
22872,2,KevinLau,2249,528,20,19,39,51.3%,1h
22872,1,满目山河不及她,2249,550,19,21,40,47.5%,1h
22872,2,[死鹿特小公主]Onemy,2249,250,9,4,13,69.2%,1h
22872,3,NihaihuiLaiM,2249,255,9,13,22,40.9%,36m
22872,2,摸仙小王,2249,242,8,8,16,50.0%,52m
22872,2,zzs,2249,234,8,10,18,44.4%,1h
22872,2,随便玩会,2249,172,4,4,8,50.0%,1h
22872,2,[小仙女上线啦]vicky,2249,86,4,5,9,44.4%,21m
22872,3,司夜,2249,134,4,18,22,18.2%,1h
22872,1,碎灵,2249,72,3,6,9,33.3%,26m
22872,2,农民,2249,30,2,1,3,66.7%,43m
22872,2,时崎狂三,2249,0,1,5,6,16.7%,1h
22872,2,那一瞬间,2249,0,0,1,1,0.0%,1h
22872,2,雪瓜,2249,0,0,1,1,0.0%,46m
22872,2,[暴雪三十二隊]夏兮,2249,0,0,1,1,0.0%,14m
22872,2,Simper,2249,0,0,3,3,0.0%,47m
22872,1,BERR,2249,0,0,4,4,0.0%,22m
22895,1,剑仙不如剑人,2248,685,67,71,138,48.6%,1h
22895,1,湖边树,2248,792,38,44,82,46.3%,1h
22895,1,就是艾斯特了,2248,1022,35,36,71,49.3%,1h
22895,2,[旧日黄金舰队]wanwei,2248,454,16,13,29,55.2%,2m
22895,1,法规汇,2248,408,12,16,28,42.9%,32m
22895,2,[虚空闪烁]萤火虫满天,2248,228,9,8,17,52.9%,1h
22895,2,蒜这小子后劲大,2248,256,9,16,25,36.0%,47m
22895,1,龙之枪骑兵,2248,262,7,16,23,30.4%,1h
22895,2,躁狂症疯魔,2248,168,6,4,10,60.0%,43m
22895,2,[乱世]泡泡,2248,122,5,3,8,62.5%,1h
22895,1,Acre,2248,140,3,7,10,30.0%,60m
22895,2,草鸡萌新,2248,0,2,4,6,33.3%,19m
22895,2,[小鸡屠宰场2]小沈仔,2248,66,2,5,7,28.6%,54m
22895,2,[中华何平]EASY,2248,0,1,0,1,100.0%,14m
22895,2,秋恋,2248,44,1,2,3,33.3%,1h
22895,2,robotertowne,2248,91,1,5,6,16.7%,36m
22895,1,[一波]叫我帅哥就好了,2248,48,1,5,6,16.7%,1h
22895,2,iiiiiiiiiiii,2248,46,1,5,6,16.7%,7m
22895,2,许闪闪丶吖,2248,0,0,1,1,0.0%,14m
22914,3,大魔法师,2247,1304,54,60,114,47.4%,10m
22914,3,Eternal,2247,682,25,36,61,41.0%,10m
22914,1,[整个活]迷路的探姬,2247,508,20,28,48,41.7%,20m
22914,2,[久美子足浴城]星际霸王,2247,418,16,13,29,55.2%,1h
22914,1,萌新不会玩,2247,375,12,20,32,37.5%,1h
22914,1,mrquin,2247,272,9,13,22,40.9%,32m
22914,2,IMA,2247,152,6,6,12,50.0%,1h
22914,3,秋水化一,2247,197,6,8,14,42.9%,1h
22914,3,衰哥,2247,171,4,9,13,30.8%,18m
22914,2,吉米巴特勒,2247,0,3,2,5,60.0%,45m
22914,2,征战,2247,140,2,6,8,25.0%,56m
22914,2,LOGOS,2247,92,1,5,6,16.7%,7m
22914,2,TOTATM,2247,0,0,2,2,0.0%,56m
22914,2,[爱国]超级游戏,2247,0,0,5,5,0.0%,1h
22928,1,逗哥,2246,1416,88,89,177,49.7%,42m
22928,3,丶任土豆丨,2246,454,76,84,160,47.5%,27m
22928,2,[魔术]隔壁小孩,2246,526,25,29,54,46.3%,35m
22928,2,万无一失,2246,412,14,12,26,53.8%,1h
22928,2,半个菜鸡,2246,222,7,5,12,58.3%,1h
22928,2,陆云天,2246,113,3,2,5,60.0%,40m
22928,2,THM,2246,0,2,4,6,33.3%,1h
22935,1,MITO,2245,870,36,39,75,48.0%,21m
22935,1,[Onceme]竹林飘雨,2245,798,25,31,56,44.6%,1h
22935,2,大佬求轻虐,2245,586,21,21,42,50.0%,48m
22935,2,[mdzzz]学术界马天宇,2245,606,21,25,46,45.7%,54m
22935,2,令人发狂的人机,2245,317,12,17,29,41.4%,1h
22935,2,Reach,2245,112,10,13,23,43.5%,1h
22935,2,[琴筝]塔达林,2245,210,6,7,13,46.2%,1h
22935,2,camille,2245,178,6,7,13,46.2%,1h
22935,2,干切葱油萝卜,2245,186,6,9,15,40.0%,2m
22935,1,高阶领主,2245,231,6,9,15,40.0%,19m
22935,2,[Chain]麒麟萌,2245,152,5,7,12,41.7%,2m
22935,2,赫赫,2245,30,5,8,13,38.5%,1h
22935,2,辰木木木,2245,34,5,8,13,38.5%,31m
22935,1,Mize,2245,196,5,14,19,26.3%,15m
22935,1,和纱的愚忠分子,2245,142,4,6,10,40.0%,1h
22935,2,[A死你]小虾米,2245,159,4,8,12,33.3%,1h
22935,3,高粱地里吃过亏,2245,70,4,11,15,26.7%,1h
22935,2,[大爱星际二]我是你也八,2245,34,2,1,3,66.7%,1h
22935,2,[地下大坟墓]希姿德尔塔,2245,112,2,1,3,66.7%,1h
22935,1,小马无敌,2245,48,2,1,3,66.7%,60m
22935,1,流萤江火,2245,0,1,0,1,100.0%,1h
22935,2,[这是个陷阱啊]迷茫小号,2245,0,1,0,1,100.0%,56m
22935,2,围巾,2245,32,1,2,3,33.3%,1h
22935,2,shuzi,2245,46,1,2,3,33.3%,1h
22935,2,君莫笑,2245,0,0,1,1,0.0%,7m
22935,2,[单人行动对吧]chen,2245,0,0,2,2,0.0%,49m
22961,1,舒克,2244,931,37,40,77,48.1%,1h
22961,2,爱在西元前,2244,832,32,27,59,54.2%,1h
22961,2,[看我朵蜜你]绝霜,2244,206,8,7,15,53.3%,14m
22961,2,不死鸟之花盛开时,2244,120,4,7,11,36.4%,1h
22961,2,南栀的昼与夜,2244,78,2,2,4,50.0%,1h
22961,2,伪战士,2244,0,1,0,1,100.0%,2m
22961,1,[开心最重要嘛]嘀嘟,2244,95,1,1,2,50.0%,19m
22961,2,astronomia,2244,0,1,5,6,16.7%,59m
22961,2,新空,2244,0,0,3,3,0.0%,35m
22961,2,[乳主头子]atanice,2244,0,0,5,5,0.0%,1h
22971,2,[dgxfd]apple,2243,660,24,26,50,48.0%,1h
22971,2,齐物论,2243,502,20,22,42,47.6%,8m
22971,2,额启,2243,344,14,17,31,45.2%,1h
22971,2,[Fnova]泰伦鸡饲料,2243,75,5,8,13,38.5%,1h
22971,1,石猛,2243,204,5,9,14,35.7%,1h
22971,2,[汉堡FANS]常德郭富城,2243,88,4,2,6,66.7%,14m
22971,2,卡尔玛,2243,58,3,2,5,60.0%,1h
22971,2,夕颜,2243,90,3,8,11,27.3%,1h
22971,2,枯叶,2243,60,2,3,5,40.0%,33m
22971,2,Mihawk,2243,0,2,4,6,33.3%,47m
22971,2,[生气了吗]随心,2243,0,1,0,1,100.0%,1h
22971,2,[lmbaP]Cnlg,2243,30,1,2,3,33.3%,1h
22971,2,[糸色]BUTER,2243,38,1,3,4,25.0%,52m
22971,2,Sakura,2243,0,1,5,6,16.7%,56m
22971,1,vcu,2243,0,1,6,7,14.3%,40m
22971,2,dfqrtcsdf,2243,0,0,4,4,0.0%,1h
22987,2,须佐之男,2242,1196,45,46,91,49.5%,1h
22987,1,[高数的关爱]nbsw,2242,468,17,17,34,50.0%,1h
22987,3,lucifer,2242,281,10,12,22,45.5%,1h
22987,1,jsioadhfioas,2242,304,10,14,24,41.7%,4m
22987,2,[水墨丹青]WhiteZero,2242,146,5,4,9,55.6%,1h
22987,2,韩小柒,2242,30,5,10,15,33.3%,3m
22987,1,一朵菊花香,2242,0,4,3,7,57.1%,1h
22987,2,派打星,2242,30,2,1,3,66.7%,1h
22987,2,巴御前超可爱,2242,48,2,6,8,25.0%,14m
22987,2,Alien,2242,0,1,0,1,100.0%,42m
22987,2,SHI,2242,30,1,5,6,16.7%,56m
22987,1,Piporuakeiso,2242,0,0,1,1,0.0%,1h
22999,3,星际菜鸡,2241,1586,718,770,1488,48.3%,37m
22999,1,lianchao,2241,994,37,36,73,50.7%,43m
22999,1,寒菁,2241,552,27,26,53,50.9%,1h
22999,2,悲伤的红烧猪蹄,2241,700,27,27,54,50.0%,8m
22999,2,草率怪,2241,293,17,19,36,47.2%,33m
22999,1,HSSSS,2241,335,12,21,33,36.4%,12m
22999,1,Protomss,2241,261,10,9,19,52.6%,1h
22999,2,[大战队]死神初号机,2241,169,8,9,17,47.1%,14m
22999,2,AFKGlory,2241,92,5,5,10,50.0%,12m
22999,3,windysky,2241,58,3,5,8,37.5%,1h
22999,2,时光骆驼,2241,30,2,0,2,100.0%,10m
22999,2,[江南星际]Duang,2241,60,2,4,6,33.3%,40m
22999,3,MoYu,2241,30,2,5,7,28.6%,8m
22999,2,MagicianRain,2241,0,1,0,1,100.0%,1h
22999,3,[北酱]NanauLiyo,2241,0,1,0,1,100.0%,36m
22999,2,玄虚,2241,0,1,0,1,100.0%,1h
22999,1,菜鸟,2241,48,1,3,4,25.0%,1h
22999,2,沐澜,2241,0,0,1,1,0.0%,1h
23017,1,真的不会啊,2240,798,26,33,59,44.1%,1h
23017,2,warriors,2240,609,24,18,42,57.1%,1h
23017,2,南乡,2240,611,22,26,48,45.8%,1h
23017,2,飞翔的蜻蜓,2240,356,12,15,27,44.4%,49m
23017,1,[给婉儿洗澡]午夜,2240,216,6,14,20,30.0%,44m
23017,1,碧萝春,2240,208,4,2,6,66.7%,46m
23017,2,Jacky,2240,153,4,3,7,57.1%,1h
23017,3,BOBOY,2240,97,2,3,5,40.0%,36m
23017,3,TimE,2240,0,1,0,1,100.0%,1h
23017,2,pinor,2240,36,1,3,4,25.0%,1h
23017,2,fishhan,2240,0,1,4,5,20.0%,1h
23017,1,simon,2240,0,1,6,7,14.3%,31m
23017,2,zty,2240,0,0,1,1,0.0%,1h
23017,1,前期,2240,0,0,2,2,0.0%,1h
23017,2,[Conque]暗影迷踪,2240,0,0,3,3,0.0%,52m
23032,1,[VLK]怡乐汽水,2239,1218,44,54,98,44.9%,1h
23032,1,地主家的农民,2239,689,28,31,59,47.5%,22m
23032,2,[miku守护]殇之恋,2239,397,24,26,50,48.0%,33m
23032,2,上枫岁,2239,647,23,28,51,45.1%,1h
23032,1,老夫一颗少女心,2239,418,21,28,49,42.9%,53m
23032,2,芜湖,2239,374,14,25,39,35.9%,1h
23032,2,AndreHsu,2239,230,8,3,11,72.7%,1h
23032,1,[艾尔之巅]青山是哪只鸡,2239,216,6,4,10,60.0%,1h
23032,2,[园神凛祢]剑心,2239,90,3,4,7,42.9%,14m
23032,1,神武冰锋,2239,42,3,6,9,33.3%,36m
23032,2,nirvanaer,2239,96,3,8,11,27.3%,54m
23032,3,夜殇,2239,0,2,8,10,20.0%,1h
23032,2,xiaoleishou,2239,0,1,0,1,100.0%,40m
23032,2,Kiyan,2239,30,1,3,4,25.0%,14m
23032,2,我叫毛初一呀,2239,0,1,5,6,16.7%,1h
23047,1,BIKnit,2238,780,33,40,73,45.2%,21m
23047,2,如年渡日,2238,203,7,3,10,70.0%,1h
23047,1,一夜奇梦,2238,185,7,9,16,43.8%,1h
23047,1,光明主宰,2238,230,7,12,19,36.8%,1h
23047,2,chase,2238,171,5,12,17,29.4%,1h
23047,2,允许计划,2238,120,4,9,13,30.8%,14m
23047,3,吃米的猫,2238,125,4,9,13,30.8%,52m
23047,3,[高街村]下水道里的老鼠人,2238,121,3,3,6,50.0%,47m
23047,2,waad,2238,60,3,3,6,50.0%,1h
23047,2,Waitforlove,2238,149,3,7,10,30.0%,35m
23047,2,DSDD,2238,0,1,0,1,100.0%,14m
23047,2,GeoLLy,2238,0,1,0,1,100.0%,1h
23047,2,闩鉴,2238,0,1,2,3,33.3%,1h
23047,1,不妥我只是只猫,2238,0,1,2,3,33.3%,1h
23047,2,狗曰的幸福,2238,0,1,5,6,16.7%,1h
23047,2,毕竟小二,2238,0,1,5,6,16.7%,58m
23047,2,[雄心挥剑笔]天下无神,2238,0,0,1,1,0.0%,40m
23047,2,风云飞,2238,0,0,2,2,0.0%,30m
23065,1,lscwlchina,2237,1618,156,149,305,51.1%,15m
23065,2,WID,2237,1007,39,42,81,48.1%,1h
23065,2,[谐的一笔]ForeverY,2237,394,22,18,40,55.0%,2m
23065,2,void,2237,373,14,17,31,45.2%,54m
23065,3,我爱怡,2237,202,9,14,23,39.1%,6m
23065,2,这人有亿点下饭,2237,222,7,9,16,43.8%,1h
23065,1,无畏要塞,2237,250,6,11,17,35.3%,1h
23065,2,深渊,2237,140,5,7,12,41.7%,30m
23065,2,珺珺的小可爱,2237,48,4,7,11,36.4%,45m
23065,1,GXT,2237,95,2,0,2,100.0%,2m
23065,3,[玄门]玄天,2237,0,1,1,2,50.0%,1h
23065,3,我不会玩这游戏,2237,0,1,4,5,20.0%,57m
23065,2,赫赫战神,2237,0,0,1,1,0.0%,1h
23065,2,小小狗的大冒险,2237,0,0,1,1,0.0%,42m
23079,1,Panic,2236,1490,139,142,281,49.5%,1h
23079,1,晨辰尘,2236,975,51,53,104,49.0%,53m
23079,1,渡鸦,2236,800,29,37,66,43.9%,1h
23079,1,[Strike]达拉崩巴恒裕,2236,442,14,22,36,38.9%,1h
23079,2,夜雨声繁,2236,331,12,15,27,44.4%,53m
23079,2,紫魁星的使者,2236,266,11,4,15,73.3%,33m
23079,2,嗷嗷嗷嗷警告,2236,278,10,10,20,50.0%,40m
23079,2,AntiProto,2236,142,6,11,17,35.3%,14m
23079,1,再无白衣少年,2236,211,5,3,8,62.5%,1h
23079,2,菜鸟,2236,136,4,0,4,100.0%,1h
23079,2,cocoingo,2236,90,3,4,7,42.9%,42m
23079,2,郑二万,2236,100,3,5,8,37.5%,14m
23079,2,ZonFon,2236,48,3,5,8,37.5%,12m
23079,2,净化大师,2236,30,2,0,2,100.0%,48m
23079,2,中国的玩家的未来,2236,0,1,0,1,100.0%,49m
23079,1,saddasd,2236,44,1,4,5,20.0%,1h
23079,3,邢封,2236,0,1,4,5,20.0%,3m
23079,2,[华溪岛]八重桜,2236,0,1,5,6,16.7%,1h
23079,2,米达尔顿,2236,0,0,1,1,0.0%,1h
23079,2,坏家伙,2236,0,0,2,2,0.0%,1h
23099,1,wangxingyu,2235,1298,105,113,218,48.2%,1h
23099,2,好男人,2235,1228,46,43,89,51.7%,1h
23099,1,hrx,2235,532,20,23,43,46.5%,2m
23099,2,快叫爸爸,2235,460,17,20,37,45.9%,1h
23099,2,巧克力橙子,2235,220,10,4,14,71.4%,1h
23099,1,[DEAK]威猛先生,2235,306,7,12,19,36.8%,1h
23099,2,mmmmk,2235,144,6,6,12,50.0%,33m
23099,2,[Icycry]amida,2235,130,5,4,9,55.6%,54m
23099,3,肉弹冲击,2235,102,5,13,18,27.8%,47m
23099,3,oooo,2235,123,4,9,13,30.8%,1h
23099,2,霓裳残舞,2235,30,2,0,2,100.0%,47m
23099,2,彼岸花,2235,0,1,1,2,50.0%,1h
23099,2,安然,2235,0,1,3,4,25.0%,1h
23099,2,[Aos菜鸡队]卡美洛,2235,0,0,1,1,0.0%,47m
23099,2,[最强大佬]寒夜,2235,0,0,3,3,0.0%,40m
23114,1,辰逸,2234,543,21,26,47,44.7%,1h
23114,2,嘤嘤嘤娅,2234,508,18,16,34,52.9%,1h
23114,2,[DMR]亚里士没有德,2234,437,16,14,30,53.3%,33m
23114,2,FOX,2234,404,15,13,28,53.6%,1h
23114,2,小西瓜,2234,222,9,6,15,60.0%,1h
23114,2,我是新手请多关照,2234,209,9,6,15,60.0%,1h
23114,2,colowahaha,2234,202,8,6,14,57.1%,31m
23114,1,卿卿的亲亲,2234,131,5,8,13,38.5%,1h
23114,2,ChiangMaisky,2234,30,2,1,3,66.7%,1h
23114,2,面壁者逻辑,2234,46,2,1,3,66.7%,37m
23114,2,白云常自在,2234,0,1,0,1,100.0%,1h
23114,2,[M8]蓝色枫叶,2234,30,1,1,2,50.0%,1h
23114,2,灵犀六指,2234,0,1,5,6,16.7%,56m
23114,2,星水,2234,0,0,1,1,0.0%,1h
23114,2,上千个黎明,2234,0,0,1,1,0.0%,8m
23129,3,小白,2233,466,19,19,38,50.0%,1h
23129,2,敬汝一壶酒,2233,355,15,17,32,46.9%,1h
23129,2,ads,2233,344,12,10,22,54.5%,1h
23129,1,阿鹤,2233,229,9,11,20,45.0%,1h
23129,3,李真帅,2233,219,7,9,16,43.8%,18m
23129,3,行天渡,2233,146,5,5,10,50.0%,49m
23129,2,swedcx,2233,124,4,6,10,40.0%,1h
23129,2,Smile,2233,150,3,7,10,30.0%,1h
23129,1,北河观真君,2233,121,3,7,10,30.0%,1h
23129,2,执剑者,2233,30,2,0,2,100.0%,1h
23129,2,awsl,2233,30,2,1,3,66.7%,40m
23129,2,[GCL]九汐,2233,0,1,0,1,100.0%,1h
23129,3,艾萨克阿西莫夫,2233,0,1,4,5,20.0%,1h
23129,2,蒙牛王陛下,2233,94,1,5,6,16.7%,45m
23143,1,廷哥哥,2232,1627,138,140,278,49.6%,35m
23143,2,Auotman,2232,717,40,41,81,49.4%,56m
23143,1,小嘴凉飕飕,2232,1106,36,47,83,43.4%,5m
23143,2,礼品卡为阿见,2232,367,13,10,23,56.5%,1h
23143,2,蝶舞翩翩,2232,290,11,8,19,57.9%,40m
23143,3,不会,2232,291,9,15,24,37.5%,50m
23143,2,镜子里有你,2232,210,8,8,16,50.0%,41m
23143,1,[配合是王道]欣欣西瓜汁,2232,217,7,10,17,41.2%,32m
23143,2,Fame,2232,122,6,4,10,60.0%,1h
23143,1,药水哥,2232,136,5,10,15,33.3%,42m
23143,1,weisatx,2232,92,3,3,6,50.0%,56m
23143,1,繁星春水,2232,48,3,7,10,30.0%,22m
23143,2,星际流浪者,2232,0,1,1,2,50.0%,53m
23143,1,[社交学教练]空空落落,2232,96,1,4,5,20.0%,48m
23143,2,轩帝,2232,0,0,3,3,0.0%,54m
23158,2,wenijp,2231,838,120,121,241,49.8%,43m
23158,2,Kblink,2231,339,12,6,18,66.7%,1h
23158,1,逸方,2231,239,5,8,13,38.5%,48m
23158,2,shunan,2231,104,3,3,6,50.0%,56m
23158,1,lanryc,2231,0,2,5,7,28.6%,1h
23158,1,[残日星宿]小恶魔鱼,2231,0,1,4,5,20.0%,1h
23158,2,gou,2231,0,1,5,6,16.7%,56m
23158,2,蓝色天空,2231,0,0,8,8,0.0%,35m
23166,1,星际迷雾,2230,1276,50,51,101,49.5%,1h
23166,2,小贾超凶哒,2230,804,34,24,58,58.6%,14m
23166,1,wait,2230,205,22,16,38,57.9%,1h
23166,2,[三国志群雄]大嘟嘟,2230,554,20,22,42,47.6%,1h
23166,3,逍遥,2230,306,10,14,24,41.7%,1h
23166,1,扮猪吃虎,2230,183,7,7,14,50.0%,1h
23166,2,[地球特勤局]天蝎,2230,153,7,9,16,43.8%,1h
23166,1,枪出如龙,2230,215,7,9,16,43.8%,1h
23166,1,白马过红楼,2230,252,7,11,18,38.9%,1h
23166,1,RoAYakov,2230,96,5,9,14,35.7%,40m
23166,2,Icclin,2230,96,4,6,10,40.0%,1h
23166,1,ShuaiRuWo,2230,122,3,11,14,21.4%,6m
23166,2,ProphetZ,2230,30,2,1,3,66.7%,1h
23166,2,regular,2230,58,2,2,4,50.0%,24m
23166,2,啦啦啦啦啦,2230,0,1,0,1,100.0%,37m
23166,1,YTY,2230,0,1,0,1,100.0%,60m
23166,2,我代替我投降,2230,0,0,3,3,0.0%,1h
23183,1,[白银联盟]小白,2229,1348,116,132,248,46.8%,20m
23183,1,hualala,2229,1539,65,77,142,45.8%,1h
23183,2,doge,2229,670,25,28,53,47.2%,1h
23183,2,霄霄帅过吴彦祖,2229,314,19,14,33,57.6%,33m
23183,2,多来狗招锻炼一下,2229,439,17,13,30,56.7%,1h
23183,2,逸鸷,2229,294,11,14,25,44.0%,1h
23183,2,只为胜利,2229,258,9,4,13,69.2%,30m
23183,2,回首丶还是你,2229,208,8,8,16,50.0%,52m
23183,3,小包子,2229,96,5,13,18,27.8%,51m
23183,1,[TCronu]lvmyyang,2229,167,4,9,13,30.8%,31m
23183,1,[萌萌哒鸡]昨小楼夜,2229,0,1,0,1,100.0%,19m
23183,2,感受世界的痛苦,2229,46,1,3,4,25.0%,56m
23183,2,LoveYLS,2229,0,1,5,6,16.7%,7m
23183,2,dsf,2229,0,0,1,1,0.0%,1h
23183,1,希格拉之耀,2229,0,0,4,4,0.0%,2m
23198,1,阿尔酸菜鱼,2228,716,42,44,86,48.8%,1h
23198,2,翊风,2228,754,28,29,57,49.1%,1h
23198,1,天渐白,2228,218,14,17,31,45.2%,1h
23198,1,Fantasizer,2228,337,12,17,29,41.4%,50m
23198,2,[gaints]LLZ,2228,268,10,13,23,43.5%,47m
23198,2,joker,2228,170,5,4,9,55.6%,43m
23198,1,人武,2228,123,2,7,9,22.2%,1h
23198,2,卢本伟,2228,0,1,0,1,100.0%,33m
23198,2,芊芊每天都要,2228,0,1,0,1,100.0%,52m
23198,1,别动老子农民,2228,96,1,2,3,33.3%,1h
23198,2,[电脑黑屏]普通的王虫,2228,0,1,2,3,33.3%,41m
23198,2,zichen,2228,0,1,5,6,16.7%,46m
23198,2,无知,2228,0,1,5,6,16.7%,47m
23198,2,屡败屡战,2228,0,0,1,1,0.0%,2m
23198,1,毁三观,2228,0,0,1,1,0.0%,4m
23198,2,[兵长军团]Mdbiu,2228,0,0,2,2,0.0%,54m
23198,2,[sc协会]慕周,2228,0,0,2,2,0.0%,4m
23198,2,GIRL,2228,0,0,2,2,0.0%,1h
23216,2,人菜瘾大还瞎,2227,1570,218,233,451,48.3%,51m
23216,2,周末,2227,1550,91,100,191,47.6%,1h
23216,3,[暴tou]Lukatin,2227,938,49,55,104,47.1%,22m
23216,2,呵呵的熊,2227,740,28,26,54,51.9%,43m
23216,2,[汝父]抱起无敌王者鱼,2227,392,16,5,21,76.2%,1h
23216,1,黑暗森林,2227,452,15,14,29,51.7%,2m
23216,2,星际争俺,2227,324,12,8,20,60.0%,48m
23216,2,天外飞仙丶,2227,330,12,12,24,50.0%,1h
23216,3,大眼,2227,178,7,15,22,31.8%,47m
23216,2,谭谭,2227,172,6,8,14,42.9%,14m
23216,2,[恰饭]浙江刘亦菲,2227,104,4,4,8,50.0%,43m
23216,2,[七咕咕]Death,2227,0,3,3,6,50.0%,1h
23216,2,风之吟唱,2227,0,1,6,7,14.3%,33m
23216,2,愤怒的霏,2227,0,0,4,4,0.0%,1h
23230,2,CHAOSHUAI,2226,1313,118,112,230,51.3%,30m
23230,3,小达,2226,873,73,107,180,40.6%,13m
23230,1,Lancelot,2226,1168,41,51,92,44.6%,1h
23230,2,坚强的石头丶,2226,654,30,17,47,63.8%,1h
23230,2,XIAOAIXING,2226,342,29,32,61,47.5%,41m
23230,2,AGITATEDCAGE,2226,788,26,36,62,41.9%,1h
23230,1,[6G芯片研發]TonyStark,2226,481,17,27,44,38.6%,27m
23230,2,hhhhhh,2226,269,15,12,27,55.6%,31m
23230,1,JOJO,2226,320,8,11,19,42.1%,31m
23230,2,灵异的虫虫蛋,2226,196,5,4,9,55.6%,1h
23230,2,莫道茶茶,2226,54,4,6,10,40.0%,1h
23230,1,汝妻女吾养之,2226,188,4,7,11,36.4%,1h
23230,2,VIV,2226,104,4,11,15,26.7%,31m
23230,2,[北有唔王]洛轩,2226,30,3,7,10,30.0%,1h
23230,2,清灰,2226,0,1,1,2,50.0%,1h
23230,2,地球栽花匠,2226,0,1,4,5,20.0%,31m
23230,3,zhuowei,2226,0,1,4,5,20.0%,33m
23230,3,Time,2226,0,0,1,1,0.0%,57m
23230,2,[战网电竞]一只飞机别,2226,0,0,1,1,0.0%,31m
23230,1,彳亍不彳亍,2226,0,0,4,4,0.0%,1h
23250,2,CSo,2225,1572,88,102,190,46.3%,1h
23250,2,冠状病毒,2225,531,71,73,144,49.3%,52m
23250,1,虫群之心,2225,1207,68,66,134,50.7%,6m
23250,1,wrp,2225,909,41,46,87,47.1%,1h
23250,2,方寸山下,2225,597,23,22,45,51.1%,1h
23250,2,天罚殇,2225,214,14,15,29,48.3%,33m
23250,1,义武奋扬,2225,392,12,19,31,38.7%,1h
23250,2,致死的哥特黑猫,2225,306,11,8,19,57.9%,42m
23250,2,舰队争霸,2225,218,7,7,14,50.0%,21m
23250,2,奇迹喵星人,2225,88,4,3,7,57.1%,31m
23250,3,[众筹时间]依然已逝,2225,120,3,0,3,100.0%,6m
23250,2,AICE,2225,0,3,3,6,50.0%,35m
23250,1,莫西西丶,2225,121,3,8,11,27.3%,2m
23250,2,ZERO,2225,130,2,2,4,50.0%,1h
23250,2,LIFE,2225,34,2,4,6,33.3%,1h
23250,3,xuNLu,2225,97,2,5,7,28.6%,1h
23250,2,须臾,2225,0,1,0,1,100.0%,7m
23250,2,文刀春秋,2225,30,1,1,2,50.0%,22m
23250,2,[广寒宫]狂傲丶空洞,2225,0,0,2,2,0.0%,48m
23269,2,奇葩文学,2224,530,17,22,39,43.6%,48m
23269,2,飞爱雯,2224,362,14,18,32,43.8%,10m
23269,1,我柜子动了,2224,322,9,13,22,40.9%,17m
23269,1,[321abc]白傲寒,2224,297,9,15,24,37.5%,1h
23269,1,不造防空死全家,2224,234,8,17,25,32.0%,55m
23269,2,[Gary]呀吗得,2224,144,6,8,14,42.9%,15m
23269,1,暴躁之鼠,2224,166,4,9,13,30.8%,1h
23269,1,[兰肯纳斯]大兵,2224,0,3,5,8,37.5%,1h
23269,2,平行世界,2224,62,2,5,7,28.6%,1h
23269,1,小禾流水,2224,0,2,7,9,22.2%,2m
23269,1,慵懒之泰坦,2224,48,1,1,2,50.0%,1h
23269,2,[吃饭不吃菜]KotchiaSanae,2224,0,0,1,1,0.0%,1h
23269,2,路明非,2224,0,0,1,1,0.0%,17m
23282,1,天生就很坏,2223,202,10,11,21,47.6%,32m
23282,2,[诛心]圣彼德温,2223,270,10,12,22,45.5%,1h
23282,3,嘟嘟粑粑,2223,262,10,13,23,43.5%,1h
23282,1,小奶狗,2223,189,6,9,15,40.0%,38m
23282,2,aAszwe,2223,120,4,2,6,66.7%,10m
23282,2,gfhshfjg,2223,58,3,3,6,50.0%,7m
23282,2,dassa,2223,90,3,4,7,42.9%,49m
23282,1,璧驷,2223,119,3,5,8,37.5%,1h
23282,1,INsPire,2223,192,3,6,9,33.3%,56m
23282,2,天上的小鸟,2223,30,2,1,3,66.7%,1h
23282,2,wormbean,2223,58,2,2,4,50.0%,1h
23282,2,我的瑶,2223,93,2,5,7,28.6%,1h
23282,2,倰思,2223,0,1,4,5,20.0%,1h
23282,2,你拿什么感同身受,2223,0,1,5,6,16.7%,1h
23282,1,rpkanak,2223,0,1,6,7,14.3%,56m
23282,2,zyjgz,2223,0,1,6,7,14.3%,59m
23282,2,nbaba,2223,0,0,1,1,0.0%,48m
23282,2,星空之下,2223,0,0,1,1,0.0%,56m
23300,1,quanpeng,2222,627,24,28,52,46.2%,27m
23300,1,[DNF]IIIIIIIIIIII,2222,717,23,27,50,46.0%,1h
23300,2,片甲不留,2222,380,13,12,25,52.0%,15m
23300,2,ASUNA,2222,350,12,15,27,44.4%,22m
23300,2,天雅,2222,324,12,18,30,40.0%,48m
23300,1,攻击,2222,216,7,9,16,43.8%,1h
23300,2,龙朱,2222,60,3,3,6,50.0%,41m
23300,2,悲情小文,2222,90,3,4,7,42.9%,1h
23300,2,郭超超,2222,62,3,4,7,42.9%,1h
23300,2,[萌新小分队]默默默默含,2222,44,2,7,9,22.2%,7m
23300,2,我是你坝坝,2222,0,1,1,2,50.0%,1h
23300,3,派星星,2222,0,1,1,2,50.0%,32m
23300,2,[浙大战队]摇曳的快乐,2222,0,1,2,3,33.3%,1h
23300,2,老家的翠花,2222,0,0,1,1,0.0%,1h
23300,3,夜里声最烦,2222,0,0,3,3,0.0%,1h
23300,3,[Mikon]猫乃伊,2222,0,0,5,5,0.0%,1h
23316,2,Qinkobe,2221,817,41,37,78,52.6%,1h
23316,1,abner,2221,1174,38,50,88,43.2%,1h
23316,2,星际战神,2221,822,31,28,59,52.5%,1h
23316,1,毅毅,2221,368,11,19,30,36.7%,5m
23316,2,我的良猩需要治疗,2221,221,9,7,16,56.2%,1h
23316,2,等风来,2221,48,4,4,8,50.0%,7m
23316,2,[黑色领域]领主,2221,102,3,0,3,100.0%,33m
23316,3,[天际线]Shang,2221,0,2,2,4,50.0%,1h
23316,1,御烟,2221,45,1,1,2,50.0%,1h
23316,2,moliyo,2221,30,1,3,4,25.0%,1h
23316,2,KSSK,2221,73,1,4,5,20.0%,1h
23316,2,无冬夜,2221,92,1,5,6,16.7%,56m
23316,2,[PinkS]PinkSCV,2221,0,1,6,7,14.3%,33m
23329,2,[星灵守卫者]诗经,2220,1589,61,69,130,46.9%,1h
23329,2,king,2220,316,11,8,19,57.9%,14m
23329,2,丿神谕,2220,88,6,5,11,54.5%,33m
23329,2,类地行星外星人,2220,90,3,4,7,42.9%,1h
23329,2,saber,2220,86,3,4,7,42.9%,1h
23329,1,[望月]北纬星痕,2220,97,2,2,4,50.0%,1h
23329,2,[CanDle]memorytime,2220,60,2,4,6,33.3%,1h
23329,3,大萨摩,2220,58,2,5,7,28.6%,1h
23329,2,[失眠者同好会]爱皮斯坦,2220,0,1,1,2,50.0%,49m
23329,1,朱傛基,2220,0,1,1,2,50.0%,1h
23329,2,金盆洗铁手,2220,46,1,3,4,25.0%,7m
23329,2,谐星土块,2220,0,0,1,1,0.0%,21m
23329,2,有言在仙丶,2220,0,0,2,2,0.0%,1h
23329,1,[萌新保护协议]岚君,2220,0,0,2,2,0.0%,18m
23343,2,wwwwwwwwwwww,2219,642,32,22,54,59.3%,48m
23343,2,[全国修车]CyrusYU,2219,620,26,17,43,60.5%,42m
23343,2,人畜无害的月奏弦,2219,480,18,18,36,50.0%,1h
23343,2,麦克米兰中士,2219,457,15,18,33,45.5%,1h
23343,1,fsy,2219,467,15,19,34,44.1%,23m
23343,2,XIBA,2219,176,7,6,13,53.8%,14m
23343,1,stoojon,2219,238,7,13,20,35.0%,1h
23343,1,轶轶,2219,179,4,1,5,80.0%,22m
23343,2,干脆面,2219,88,4,2,6,66.7%,1h
23343,3,[TLFKR]东野青皮龟,2219,137,4,11,15,26.7%,1h
23343,2,Kin,2219,134,3,4,7,42.9%,47m
23343,2,踏雪,2219,62,3,5,8,37.5%,49m
23343,3,全军突击,2219,60,2,6,8,25.0%,28m
23343,2,[Fear]songwenyi,2219,30,1,1,2,50.0%,33m
23343,1,Maru,2219,0,1,3,4,25.0%,7m
23343,2,OOOOO,2219,0,1,5,6,16.7%,1h
23359,1,[印度洋舰队]GYL,2218,1589,122,134,256,47.7%,1h
23359,1,[鲨你泉家]JKS,2218,1077,35,44,79,44.3%,15m
23359,2,Windy,2218,762,29,25,54,53.7%,1h
23359,2,三个点,2218,655,22,29,51,43.1%,30m
23359,1,最爱,2218,539,22,30,52,42.3%,50m
23359,2,星际游侠,2218,556,20,20,40,50.0%,9m
23359,1,周欲为,2218,266,9,10,19,47.4%,1h
23359,2,民航杨永信,2218,176,7,8,15,46.7%,1h
23359,1,菜的一批,2218,201,5,10,15,33.3%,1h
23359,3,愿不忘初心,2218,0,4,5,9,44.4%,52m
23359,1,星际大脚,2218,96,3,9,12,25.0%,46m
23359,2,lbwnb,2218,30,2,0,2,100.0%,24m
23359,3,[INC]Phoenix,2218,0,2,3,5,40.0%,1h
23359,2,[ILYSK]天雷怒战,2218,0,1,0,1,100.0%,1h
23359,2,Manny,2218,0,1,5,6,16.7%,35m
23374,1,zhulei,2217,1672,147,165,312,47.1%,15m
23374,2,赤情已是修念,2217,1037,47,40,87,54.0%,1h
23374,2,mengli,2217,377,15,13,28,53.6%,33m
23374,2,[华师大二附中]儒雅随和的金贡,2217,432,15,23,38,39.5%,1h
23374,2,kkeeyy,2217,362,14,14,28,50.0%,56m
23374,3,明月清风,2217,289,12,12,24,50.0%,22m
23374,3,[拒绝流浪狗]Dreamhurt,2217,280,11,12,23,47.8%,22m
23374,2,配角儿,2217,208,6,3,9,66.7%,54m
23374,3,Annmak,2217,0,4,1,5,80.0%,57m
23374,2,HFTXYH,2217,44,3,3,6,50.0%,1h
23374,1,赵子龙,2217,144,3,3,6,50.0%,1h
23374,2,青衫牧,2217,86,3,7,10,30.0%,46m
23374,2,电脑一简单难度,2217,0,1,0,1,100.0%,1h
23374,2,异界行者,2217,0,1,0,1,100.0%,1h
23374,2,[喵帕斯喵]AstroPU,2217,30,1,1,2,50.0%,22m
23374,2,立心,2217,30,1,1,2,50.0%,1h
23374,2,斗圣强者,2217,30,1,2,3,33.3%,1h
23374,2,SodaLog,2217,0,0,1,1,0.0%,1h
23392,2,sbk,2216,738,29,39,68,42.6%,14m
23392,2,我爱你,2216,619,23,23,46,50.0%,1h
23392,2,大金,2216,567,22,17,39,56.4%,47m
23392,1,Freedom,2216,682,22,26,48,45.8%,1h
23392,2,STOP,2216,507,20,14,34,58.8%,1h
23392,2,habbby,2216,463,19,14,33,57.6%,1h
23392,2,残阳下望着窗外,2216,405,17,16,33,51.5%,1h
23392,3,[德哈卡神教]飞丶,2216,219,7,13,20,35.0%,1h
23392,2,[凤凰炸鸡]净化鸡,2216,160,6,9,15,40.0%,53m
23392,2,[不知不觉天亮]Horfey,2216,140,5,0,5,100.0%,48m
23392,1,落尘,2216,165,5,11,16,31.2%,1h
23392,1,[影之光]月之效力,2216,144,3,8,11,27.3%,19m
23392,3,好哥哥别打我,2216,58,2,9,11,18.2%,25m
23392,1,口腔的溃疡,2216,0,1,0,1,100.0%,1h
23392,1,Jerry,2216,0,1,0,1,100.0%,1h
23392,2,JunDi,2216,0,1,0,1,100.0%,56m
23392,1,掠影,2216,48,1,4,5,20.0%,1h
23392,2,战神神枪,2216,97,1,5,6,16.7%,35m
23392,2,次元战士,2216,0,0,1,1,0.0%,46m
23392,2,Sunabz,2216,0,0,1,1,0.0%,15m
23392,2,入戏太深,2216,0,0,1,1,0.0%,1h
23392,2,[在下菜鸡一只]Foooox,2216,0,0,2,2,0.0%,1h
23392,2,[秋毫]张小白,2216,0,0,3,3,0.0%,15m
23415,3,[裂火]lyd,2215,1529,209,221,430,48.6%,13m
23415,2,sbb,2215,975,36,38,74,48.6%,17m
23415,2,Sunway,2215,805,35,33,68,51.5%,53m
23415,1,黎明的银狼,2215,582,24,29,53,45.3%,20m
23415,2,老爱,2215,196,10,7,17,58.8%,24m
23415,1,血战,2215,319,10,16,26,38.5%,2m
23415,3,一个小塞图,2215,0,2,3,5,40.0%,57m
23415,2,[怂一怂]渡真理,2215,34,1,2,3,33.3%,1h
23415,2,时方知,2215,46,1,3,4,25.0%,7m
23415,2,看比赛看比赛,2215,0,0,1,1,0.0%,12m
23425,1,未来的人族皇帝,2214,549,37,28,65,56.9%,1h
23425,1,[小菜逼]JUSTINLIU,2214,177,6,9,15,40.0%,19m
23425,2,天盛长岛,2214,86,3,3,6,50.0%,56m
23425,2,妄人,2214,88,3,3,6,50.0%,10m
23425,1,[绝世高手]游戏而已,2214,48,1,3,4,25.0%,1h
23425,2,别打我了,2214,0,1,5,6,16.7%,1h
23425,1,郎月疏怀,2214,88,1,7,8,12.5%,1h
23425,2,[BOF丶佛堂]达斯坦王子,2214,0,0,1,1,0.0%,1h
23425,2,旺大师没有如果,2214,0,0,2,2,0.0%,15m
23434,2,luanyueyu,2213,1127,54,55,109,49.5%,17m
23434,2,自由之羽,2213,815,37,36,73,50.7%,41m
23434,3,骑辰,2213,944,33,48,81,40.7%,42m
23434,2,孙天我能让你,2213,699,26,23,49,53.1%,41m
23434,2,Bill,2213,590,21,25,46,45.7%,1h
23434,2,闲散惯了,2213,320,12,13,25,48.0%,1h
23434,2,[跑山鸡]世界青年,2213,244,10,10,20,50.0%,1h
23434,1,[最菜战队]wsglu,2213,264,9,11,20,45.0%,23m
23434,2,踏雪寻梅,2213,144,6,4,10,60.0%,17m
23434,2,枪炮龙,2213,84,2,1,3,66.7%,7m
23434,2,菜的只能玩合作,2213,0,1,0,1,100.0%,1h
23434,3,不会天梯不想人机,2213,0,1,4,5,20.0%,1h
23434,2,[Arctic]春宵丶美景,2213,0,0,1,1,0.0%,41m
23434,2,Zerdxue,2213,0,0,1,1,0.0%,15m
23434,1,[蛋家军]早安,2213,0,0,1,1,0.0%,22m
23434,3,星空,2213,0,0,2,2,0.0%,45m
23434,2,Ruin,2213,0,0,3,3,0.0%,1h
23434,2,大橙子,2213,0,0,3,3,0.0%,1h
23434,2,花哥哥在此,2213,0,0,4,4,0.0%,1h
23434,3,酷乐,2213,0,0,5,5,0.0%,1h
23454,2,BILLCHANG,2212,859,102,101,203,50.2%,1h
23454,1,终日乾乾,2212,1263,44,53,97,45.4%,1h
23454,1,阿叶,2212,814,27,37,64,42.2%,50m
23454,2,星轨,2212,788,26,33,59,44.1%,17m
23454,2,柯里昂,2212,547,25,28,53,47.2%,56m
23454,1,不讲武德,2212,179,7,5,12,58.3%,1h
23454,2,澜哥哲沧江,2212,210,7,5,12,58.3%,1h
23454,2,哦西吧,2212,160,5,3,8,62.5%,33m
23454,2,邻家的熊孩,2212,0,3,3,6,50.0%,36m
23454,1,[狂风暴风雨]朱振亿,2212,119,3,7,10,30.0%,18m
23454,3,卡拉森,2212,0,2,3,5,40.0%,1h
23454,2,只会修地堡,2212,48,2,7,9,22.2%,1h
23454,1,[纳兰皇族]terren,2212,48,1,2,3,33.3%,1h
23454,3,[我即是霸主]残火之鸢,2212,0,1,4,5,20.0%,1h
23454,2,[EMMM]ReamD,2212,0,0,1,1,0.0%,48m
23454,2,korerta,2212,0,0,2,2,0.0%,1h
23470,3,GGBJ,2211,1158,91,100,191,47.6%,57m
23470,2,为了艾尔而战,2211,987,43,33,76,56.6%,1h
23470,2,IIIIIIIIIIII,2211,830,35,33,68,51.5%,1h
23470,2,坚持就是胜利,2211,331,12,13,25,48.0%,1h
23470,2,夜寒殇,2211,120,4,7,11,36.4%,1h
23470,2,RmpRlyf,2211,88,2,0,2,100.0%,14m
23470,3,Harvey,2211,40,2,2,4,50.0%,39m
23470,2,意大利炮,2211,0,1,0,1,100.0%,7m
23470,2,[快乐白给]里奇,2211,42,1,3,4,25.0%,56m
23470,3,Towar,2211,0,1,4,5,20.0%,1h
23470,2,太阳不早起,2211,0,1,5,6,16.7%,1h
23470,2,Daniel,2211,0,1,6,7,14.3%,58m
23470,1,yyfhyy,2211,34,1,10,11,9.1%,1h
23470,2,wear,2211,0,0,1,1,0.0%,17m
23470,2,UNDRDG,2211,0,0,1,1,0.0%,1h
23470,1,阎罗魔人,2211,0,0,10,10,0.0%,58m
23486,2,[暴雪零队]楠楠,2210,1542,80,79,159,50.3%,10m
23486,1,出久生,2210,283,6,12,18,33.3%,18m
23486,1,开普勒泰坦,2210,94,3,9,12,25.0%,1h
23486,3,人王,2210,0,1,0,1,100.0%,1h
23486,2,general,2210,0,0,1,1,0.0%,14m
23491,1,Mrs,2209,1511,103,113,216,47.7%,52m
23491,1,这里是少爷广场,2209,1683,68,65,133,51.1%,35m
23491,1,娇饵,2209,1487,58,64,122,47.5%,1h
23491,2,铁血老牛,2209,1096,47,45,92,51.1%,1h
23491,2,风火雷电走,2209,394,14,15,29,48.3%,52m
23491,1,[五月花]yousa,2209,327,11,16,27,40.7%,1h
23491,1,国服第一骚的人,2209,301,10,12,22,45.5%,1h
23491,2,电脑玩家简单,2209,311,9,19,28,32.1%,53m
23491,3,haohaochi,2209,200,6,11,17,35.3%,6m
23491,2,Max,2209,46,4,5,9,44.4%,35m
23491,2,[星际拓荒者]我是猪队友多包涵,2209,68,3,3,6,50.0%,1h
23491,2,姜二黑,2209,90,3,4,7,42.9%,38m
23491,2,abcdefg,2209,30,2,1,3,66.7%,48m
23491,1,黄哥的小飞机,2209,46,2,3,5,40.0%,19m
23491,2,猩哥,2209,58,2,4,6,33.3%,22m
23491,2,fgodj,2209,90,2,8,10,20.0%,1h
23491,2,[无敌的人]某只受沙雕,2209,94,1,1,2,50.0%,1h
23491,2,zack,2209,0,1,6,7,14.3%,35m
23491,3,CZH,2209,30,1,7,8,12.5%,53m
23510,2,xiaogao,2208,614,23,20,43,53.5%,53m
23510,2,[ertwrt]ufofuo,2208,287,12,5,17,70.6%,1h
23510,2,[莫比斯远征队]dadapaopao,2208,276,10,10,20,50.0%,22m
23510,2,老年选手玩情怀,2208,220,8,9,17,47.1%,1h
23510,2,chara,2208,190,5,5,10,50.0%,1h
23510,2,孙焕家,2208,116,3,1,4,75.0%,53m
23510,2,火星奶茶不加糖,2208,86,3,9,12,25.0%,56m
23510,2,llllllllllll,2208,36,2,1,3,66.7%,21m
23510,2,无尽,2208,30,1,2,3,33.3%,47m
23510,2,征服天堂,2208,34,1,3,4,25.0%,1h
23510,3,[暨大职业校队]青糸,2208,0,1,4,5,20.0%,51m
23510,1,[灵猫]大体快乐偶尔难,2208,0,0,2,2,0.0%,1h
23510,2,凯萨,2208,0,0,2,2,0.0%,58m
23523,2,战皇,2207,771,31,25,56,55.4%,21m
23523,2,范海辛,2207,680,25,25,50,50.0%,49m
23523,2,[48K纯帅]llllllllllll,2207,387,15,16,31,48.4%,1h
23523,2,[千古大唐]小滴,2207,386,15,17,32,46.9%,24m
23523,2,伊斯利,2207,297,12,8,20,60.0%,1h
23523,3,天翔龙闪,2207,290,12,11,23,52.2%,1h
23523,2,[奔驰何平]艾柯斯,2207,212,6,5,11,54.5%,1h
23523,3,黑夜骑士,2207,102,6,11,17,35.3%,25m
23523,1,雪漫,2207,152,5,13,18,27.8%,1h
23523,2,麻薯子,2207,116,4,0,4,100.0%,1h
23523,2,浮云流水,2207,121,4,3,7,57.1%,1h
23523,2,圣灵天启,2207,151,3,7,10,30.0%,52m
23523,2,纯黑泰迪,2207,114,2,2,4,50.0%,30m
23523,2,朱警官,2207,64,2,6,8,25.0%,2m
23523,2,dixiao,2207,0,1,0,1,100.0%,1h
23523,3,你是一口井,2207,0,1,4,5,20.0%,1h
23523,2,[碰碰纽币]修改后,2207,0,0,1,1,0.0%,54m
23523,2,无殇,2207,0,0,1,1,0.0%,41m
23523,2,[小鸡屠宰场a]阿磊,2207,0,0,5,5,0.0%,1h
23523,3,星月之恋,2207,0,0,5,5,0.0%,57m
23543,3,[珍珠奶茶]长草的田,2206,613,60,68,128,46.9%,1h
23543,1,[荒唐社]Grye,2206,895,59,64,123,48.0%,32m
23543,2,hcxixi,2206,278,11,5,16,68.8%,1h
23543,2,狍子吃栗子,2206,102,3,0,3,100.0%,1h
23543,1,邓艾屯田,2206,144,3,6,9,33.3%,1h
23543,2,[卍卍卍]莯瑶,2206,88,2,0,2,100.0%,1h
23543,2,Waterlili,2206,30,2,3,5,40.0%,31m
23543,1,殇之痕,2206,0,1,0,1,100.0%,48m
23543,2,逗比小分队,2206,0,1,0,1,100.0%,43m
23543,2,[幻想乡丨]松坂砂糖,2206,0,1,0,1,100.0%,1h
23543,1,无畏风恒,2206,0,1,1,2,50.0%,1h
23543,2,[LOHv]智雨钦风,2206,44,1,2,3,33.3%,46m
23543,2,唔知丶寒,2206,38,1,3,4,25.0%,9m
23543,3,忍者不爱切水果,2206,0,0,2,2,0.0%,39m
23557,1,[CPT]小鸡,2205,430,39,35,74,52.7%,5m
23557,2,虫王重生,2205,528,19,16,35,54.3%,48m
23557,2,Sisyphus,2205,431,17,16,33,51.5%,1h
23557,2,Karice,2205,142,15,16,31,48.4%,1h
23557,2,vincenta,2205,282,12,18,30,40.0%,1h
23557,2,永夜之星,2205,254,9,10,19,47.4%,1h
23557,1,多吉,2205,293,9,13,22,40.9%,1h
23557,1,安洁莉娜,2205,227,8,9,17,47.1%,1h
23557,2,bestone,2205,132,6,2,8,75.0%,38m
23557,3,无倌,2205,36,5,1,6,83.3%,1h
23557,2,GKind,2205,46,3,5,8,37.5%,14m
23557,2,ciaocso,2205,88,2,0,2,100.0%,1h
23557,2,路泽,2205,0,1,0,1,100.0%,21m
23557,2,[QAQ]卧室里的神明,2205,0,1,1,2,50.0%,1h
23557,2,[虚拟歌手团体]洛天依我老婆,2205,30,1,1,2,50.0%,15m
23557,2,乐观王,2205,0,0,1,1,0.0%,1h
23573,1,[CPT]凤牙,2204,1492,59,64,123,48.0%,1h
23573,1,Layer,2204,1252,49,53,102,48.0%,35m
23573,2,CMOON,2204,407,18,12,30,60.0%,31m
23573,2,Bill,2204,120,5,5,10,50.0%,1h
23573,3,zhangxiwu,2204,145,4,8,12,33.3%,1h
23573,2,[一起犯罪]究极炼铜之王,2204,112,3,1,4,75.0%,1h
23573,2,专业吃土三十年,2204,30,2,1,3,66.7%,31m
23573,3,如善若水,2204,0,2,3,5,40.0%,34m
23573,2,Severus,2204,60,2,5,7,28.6%,48m
23573,2,[接受洗礼吧]灭却,2204,0,1,1,2,50.0%,1h
23573,2,渡苦恶,2204,0,0,2,2,0.0%,36m
23584,1,花生糖,2203,1662,172,178,350,49.1%,1h
23584,2,shinn,2203,171,13,11,24,54.2%,1h
23584,3,苏瑾,2203,214,9,14,23,39.1%,1h
23584,2,十七,2203,260,9,16,25,36.0%,1h
23584,2,dragonzhe,2203,176,7,9,16,43.8%,1h
23584,2,ccewo,2203,56,5,6,11,45.5%,14m
23584,3,Hello,2203,66,4,11,15,26.7%,2m
23584,2,[sc日记]需要重新集结部队,2203,112,2,2,4,50.0%,31m
23584,2,云天之翼,2203,0,1,0,1,100.0%,1h
23584,2,机甲世纪,2203,0,1,0,1,100.0%,41m
23584,2,QQWZYTJH,2203,0,1,2,3,33.3%,1h
23584,2,yuezhouzhou,2203,0,0,1,1,0.0%,33m
23596,1,不会写开题,2202,1629,120,122,242,49.6%,1h
23596,1,BOTB,2202,1440,63,70,133,47.4%,32m
23596,2,[大元师]可以不可以,2202,450,20,15,35,57.1%,1h
23596,2,萧瑟为谁吟,2202,452,17,14,31,54.8%,24m
23596,2,一切随风,2202,314,16,15,31,51.6%,1h
23596,1,坚定智,2202,345,13,20,33,39.4%,1h
23596,2,罡罡子,2202,172,8,5,13,61.5%,1h
23596,2,文明游戏,2202,72,7,8,15,46.7%,1h
23596,2,Rey,2202,190,5,5,10,50.0%,33m
23596,2,Luna,2202,84,5,15,20,25.0%,1h
23596,2,健康的性福生活,2202,120,4,8,12,33.3%,55m
23596,3,create,2202,97,4,8,12,33.3%,6m
23596,2,Aellose,2202,46,3,6,9,33.3%,14m
23596,3,宗依,2202,48,2,4,6,33.3%,1h
23596,2,jume,2202,0,1,2,3,33.3%,1h
23596,1,Scylla,2202,48,1,3,4,25.0%,4m
23596,3,愤怒的冰块块,2202,36,1,5,6,16.7%,39m
23613,1,是天,2201,1299,151,157,308,49.0%,32m
23613,2,定海,2201,1572,119,135,254,46.9%,1h
23613,2,嗑个药,2201,937,72,73,145,49.7%,30m
23613,1,军师,2201,485,27,32,59,45.8%,5m
23613,2,悟空,2201,293,11,6,17,64.7%,55m
23613,2,Jack,2201,322,11,12,23,47.8%,1h
23613,2,均衡是强者之道,2201,286,10,9,19,52.6%,1h
23613,2,[C21605]Mousko,2201,167,7,1,8,87.5%,1h
23613,1,simple,2201,277,6,11,17,35.3%,38m
23613,2,雨何时停,2201,187,5,17,22,22.7%,1h
23613,1,Alex,2201,204,4,4,8,50.0%,23m
23613,2,[XXHZ20]一目意山河,2201,60,2,4,6,33.3%,41m
23613,1,南夕,2201,0,0,1,1,0.0%,1h
23613,3,言成風,2201,0,0,5,5,0.0%,40m
23627,2,龙挚剑,2200,340,14,18,32,43.8%,1h
23627,2,Roy,2200,307,12,19,31,38.7%,1h
23627,2,冰封之星,2200,221,7,5,12,58.3%,1h
23627,2,蛇院小娘逼,2200,228,7,16,23,30.4%,17m
23627,2,[吕布保护集团]magejiterran,2200,159,6,2,8,75.0%,48m
23627,2,Regret,2200,154,5,3,8,62.5%,1h
23627,1,千羽,2200,142,5,10,15,33.3%,1h
23627,2,成都霸主,2200,128,3,2,5,60.0%,1h
23627,2,VSmylove,2200,42,2,7,9,22.2%,35m
23627,2,[热能]www,2200,0,1,0,1,100.0%,11m
23627,2,小西柚,2200,97,1,1,2,50.0%,1h
23627,2,俗人,2200,0,1,6,7,14.3%,1h
23627,2,[DMRc]IIIIIIIIIII,2200,0,0,1,1,0.0%,1h
23640,1,慕天泽,2199,1185,51,56,107,47.7%,1h
23640,1,[网瘾督导官]ALLCHOBO,2199,823,30,47,77,39.0%,41m
23640,1,[神圣纪元]皮特洛,2199,259,26,37,63,41.3%,17m
23640,2,叶落枫林,2199,473,18,18,36,50.0%,43m
23640,2,持久男,2199,397,16,19,35,45.7%,1h
23640,2,吾问无为谓,2199,363,15,20,35,42.9%,1h
23640,2,小菜鸡,2199,315,14,13,27,51.9%,1h
23640,2,Merrygoround,2199,243,8,5,13,61.5%,14m
23640,2,小法师安东尼奥,2199,224,8,10,18,44.4%,9m
23640,2,万恶,2199,210,7,8,15,46.7%,1h
23640,2,咖喱棒,2199,193,6,7,13,46.2%,36m
23640,2,橙橙橙橙橙子,2199,178,5,4,9,55.6%,15m
23640,2,我为欣欣上王者,2199,0,1,5,6,16.7%,35m
23640,2,超级指挥官,2199,0,1,6,7,14.3%,1h
23640,2,bitflying,2199,0,0,3,3,0.0%,1h
23655,2,烦烦烦,2198,1060,73,83,156,46.8%,55m
23655,2,silent,2198,216,24,27,51,47.1%,1h
23655,1,[Decemb]老子天下第一,2198,336,10,12,22,45.5%,48m
23655,1,flowingwind,2198,320,9,13,22,40.9%,31m
23655,3,overdose,2198,234,8,13,21,38.1%,1h
23655,2,沦落,2198,186,7,8,15,46.7%,47m
23655,2,玛格特罗伊德,2198,148,5,6,11,45.5%,1h
23655,3,[烽夜长歌]清水之源,2198,102,5,11,16,31.2%,18m
23655,1,龙城狂霸拽少,2198,48,2,7,9,22.2%,4m
23655,2,llllllllllll,2198,0,1,5,6,16.7%,14m
23655,2,执笔流年,2198,0,1,6,7,14.3%,56m
23655,2,[CPT]先生真乃神人也,2198,0,0,1,1,0.0%,35m
23667,1,LEO,2197,647,50,56,106,47.2%,1h
23667,1,辽东经略,2197,856,36,32,68,52.9%,8m
23667,2,deadlove,2197,604,25,19,44,56.8%,1h
23667,1,小白无敌,2197,473,24,23,47,51.1%,1h
23667,3,[玛戈几泰伦]有本事打正面,2197,570,21,26,47,44.7%,45m
23667,1,天空中的彩虹,2197,388,12,17,29,41.4%,1h
23667,1,[此间三两闲]少年有梦,2197,96,6,9,15,40.0%,1h
23667,1,十按九不准,2197,96,2,2,4,50.0%,1h
23667,1,菜鸟,2197,142,2,5,7,28.6%,38m
23667,1,路明非,2197,119,2,8,10,20.0%,1h
23667,2,[旺旺战士]三更,2197,88,1,1,2,50.0%,1h
23667,3,LacusClyne,2197,0,1,3,4,25.0%,34m
23667,3,Wrongzed,2197,32,1,5,6,16.7%,4m
23667,1,单手捏西瓜,2197,36,1,5,6,16.7%,1h
23667,3,LUOYU,2197,0,0,1,1,0.0%,1h
23667,2,千叶绯茜,2197,0,0,1,1,0.0%,1h
23667,3,special,2197,0,0,2,2,0.0%,1h
23684,1,amaZingCaT,2196,980,62,77,139,44.6%,32m
23684,2,迅猛,2196,502,27,30,57,47.4%,1h
23684,1,黯灭焰,2196,142,4,5,9,44.4%,2m
23684,1,本人素质极差,2196,145,4,8,12,33.3%,1h
23684,2,njfrog,2196,92,4,8,12,33.3%,7m
23684,2,悼亡的猪,2196,88,2,0,2,100.0%,1h
23684,2,[社交学大可爱]冬夜听雪,2196,30,2,2,4,50.0%,56m
23684,2,DETR,2196,144,2,4,6,33.3%,15m
23684,2,[棉毛裤]rio,2196,0,1,0,1,100.0%,1h
23684,2,znd,2196,0,1,0,1,100.0%,15m
23684,2,小锦鲤,2196,0,1,0,1,100.0%,56m
23684,2,嫖头领,2196,0,1,0,1,100.0%,1h
23684,2,tangmen,2196,30,1,3,4,25.0%,1h
23684,1,头疼又要起名字了,2196,0,0,1,1,0.0%,1h
23698,1,Estel,2195,818,95,104,199,47.7%,26m
23698,2,我想谈朋友,2195,510,22,17,39,56.4%,1h
23698,1,巴比尔,2195,204,7,9,16,43.8%,1h
23698,3,哈哈个哈,2195,44,5,12,17,29.4%,53m
23698,2,梦千秋,2195,92,3,3,6,50.0%,7m
23698,2,骚人就是我,2195,91,1,1,2,50.0%,35m
23698,2,哈哈哈哈,2195,88,1,1,2,50.0%,1h
23698,2,[琴筝]阳阳嘿,2195,97,1,2,3,33.3%,33m
23698,2,[萌萌拳]小如初,2195,0,1,5,6,16.7%,45m
23698,3,心动是小涛,2195,32,1,5,6,16.7%,51m
23698,3,faker,2195,0,0,5,5,0.0%,57m
23709,1,zxc,2194,1623,193,219,412,46.8%,34m
23709,3,豪的精彩,2194,900,40,55,95,42.1%,1h
23709,1,九幺刘先生,2194,895,37,31,68,54.4%,15m
23709,2,小小植物萌,2194,706,32,23,55,58.2%,48m
23709,1,SadAngel,2194,820,31,38,69,44.9%,59m
23709,2,Perfectly,2194,694,24,26,50,48.0%,1h
23709,2,无白,2194,303,10,17,27,37.0%,11m
23709,3,DEIOG,2194,268,9,12,21,42.9%,1h
23709,1,终期故梦,2194,210,5,7,12,41.7%,23m
23709,2,崂山道士,2194,182,5,10,15,33.3%,19m
23709,1,爱恨情愁,2194,120,4,9,13,30.8%,46m
23709,3,lingo,2194,38,1,2,3,33.3%,18m
23709,2,ysrx,2194,91,1,6,7,14.3%,7m
23709,2,清酒,2194,0,1,7,8,12.5%,37m
23723,1,稻道盗,2193,1196,111,122,233,47.6%,2m
23723,1,[琴筝]虫妖亚里莎,2193,716,30,39,69,43.5%,32m
23723,2,fdstged,2193,828,28,32,60,46.7%,9m
23723,1,我的战争,2193,734,22,35,57,38.6%,21m
23723,1,Dawn,2193,183,11,6,17,64.7%,1h
23723,1,EXTDDDDDDD,2193,272,8,14,22,36.4%,57m
23723,2,hzxbl,2193,200,7,6,13,53.8%,1h
23723,2,九亿少女的梦,2193,224,7,12,19,36.8%,15m
23723,2,溟色貂夜,2193,187,6,15,21,28.6%,48m
23723,3,卷略,2193,0,2,8,10,20.0%,28m
23723,2,[荒芜岁月]大屁兜的猖狂,2193,0,1,0,1,100.0%,4m
23723,2,Mylove,2193,30,1,2,3,33.3%,47m
23723,2,皮皮橘,2193,0,1,5,6,16.7%,33m
23723,2,MaoXi,2193,0,0,3,3,0.0%,48m
23737,1,orville,2192,1667,137,144,281,48.8%,5m
23737,1,[战斗女仆团]MDSxiaoT,2192,1469,65,78,143,45.5%,60m
23737,2,[你就是臭弟]雷胤,2192,996,47,56,103,45.6%,29m
23737,1,黑云,2192,731,27,36,63,42.9%,35m
23737,2,浅凉一梦,2192,331,14,7,21,66.7%,1h
23737,2,[傲世丨听雨轩]夜雨秋寒,2192,271,9,20,29,31.0%,43m
23737,3,天楚皇朝,2192,168,5,17,22,22.7%,1h
23737,1,BriskWind,2192,94,3,5,8,37.5%,1h
23737,2,越狱,2192,102,2,1,3,66.7%,56m
23737,2,花生,2192,58,2,3,5,40.0%,52m
23737,3,戈壁狼,2192,0,2,3,5,40.0%,1h
23737,2,圣爹,2192,0,0,1,1,0.0%,1h
23737,2,朔夜,2192,0,0,1,1,0.0%,1h
23750,1,十月初八,2191,860,29,40,69,42.0%,1h
23750,1,爆三样,2191,565,21,27,48,43.8%,49m
23750,3,[D3D]小月,2191,370,13,33,46,28.3%,43m
23750,2,枫树,2191,181,7,4,11,63.6%,1h
23750,1,睡仙,2191,207,6,19,25,24.0%,1h
23750,1,saber,2191,171,5,12,17,29.4%,41m
23750,2,RED,2191,92,3,9,12,25.0%,7m
23750,2,哪吒是个男孩,2191,42,2,1,3,66.7%,48m
23750,2,阿德曼斯,2191,92,2,5,7,28.6%,1h
23750,2,[萌大喵的日常]笑丿神箜,2191,0,1,0,1,100.0%,1h
23750,2,万能的神,2191,0,1,0,1,100.0%,48m
23750,2,三刀,2191,40,1,3,4,25.0%,1h
23750,2,yyy,2191,0,0,4,4,0.0%,12m
23763,1,李梓涵,2190,834,34,28,62,54.8%,50m
23763,2,海之泪,2190,812,29,34,63,46.0%,1h
23763,1,年少轻灬狂,2190,342,22,25,47,46.8%,20m
23763,2,[可爱的你们]我无敌,2190,464,19,19,38,50.0%,1h
23763,2,[inform]informol,2190,517,16,23,39,41.0%,1h
23763,2,[31CM]NICK,2190,221,7,8,15,46.7%,1h
23763,2,扫仙,2190,0,4,4,8,50.0%,33m
23763,2,KIRA,2190,102,3,0,3,100.0%,52m
23763,2,[寒冰机枪]雨落之后仍是雨,2190,146,3,2,5,60.0%,41m
23763,3,OTime,2190,36,1,1,2,50.0%,1h
23763,2,Frost,2190,0,1,2,3,33.3%,35m
23763,2,Azathoth,2190,0,1,5,6,16.7%,1h
23763,2,芳心纵火犯,2190,0,0,1,1,0.0%,1h
23776,2,[相爱一家亲]我还会飞啊,2189,131,12,16,28,42.9%,31m
23776,2,GIAO,2189,362,10,12,22,45.5%,11m
23776,2,万年渡,2189,236,8,5,13,61.5%,1h
23776,2,凯文杜兰特,2189,236,8,10,18,44.4%,1h
23776,1,沫小陌,2189,168,5,4,9,55.6%,1h
23776,3,血影,2189,121,5,8,13,38.5%,34m
23776,3,清欢,2189,0,3,2,5,60.0%,1h
23776,2,Xulaoshi,2189,157,3,8,11,27.3%,56m
23776,2,权天,2189,88,2,0,2,100.0%,1h
23776,2,史莱姆,2189,0,2,6,8,25.0%,1h
23776,2,一个失落的人,2189,0,0,1,1,0.0%,49m
23787,1,牧濑红莉栖,2188,1652,103,109,212,48.6%,5m
23787,2,风中的心情,2188,693,36,40,76,47.4%,30m
23787,2,星空帝国,2188,283,13,12,25,52.0%,1h
23787,2,极殊兵,2188,302,13,15,28,46.4%,1h
23787,2,兽医,2188,175,8,1,9,88.9%,1h
23787,2,[极限菜鸟]活死人,2188,205,7,8,15,46.7%,1h
23787,2,[雯雯酱]Killer,2188,183,6,7,13,46.2%,1h
23787,2,kan,2188,138,3,4,7,42.9%,22m
23787,2,宋乐其,2188,102,2,1,3,66.7%,9m
23787,3,Canaan,2188,0,2,3,5,40.0%,1h
23787,2,躺着混,2188,0,1,0,1,100.0%,41m
23787,2,婕妤,2188,88,1,1,2,50.0%,1h
23787,2,VOHOV,2188,91,1,1,2,50.0%,14m
23787,3,饲养员的小花,2188,0,1,4,5,20.0%,1h
23787,1,[Ryon榕]中单,2188,0,0,1,1,0.0%,1h
23787,2,Mewsen,2188,0,0,1,1,0.0%,49m
23787,2,MDMDXXS,2188,0,0,2,2,0.0%,41m
23804,2,sir,2187,432,23,24,47,48.9%,15m
23804,1,狂少时光,2187,206,7,5,12,58.3%,1h
23804,2,橘子皮哥哥,2187,73,1,2,3,33.3%,1h
23804,2,萌新,2187,0,0,3,3,0.0%,1h
23808,1,龙的传人,2186,1237,227,237,464,48.9%,56m
23808,1,園田海末丶,2186,1040,140,157,297,47.1%,1h
23808,1,醒醒吧大清亡了,2186,1580,118,126,244,48.4%,1h
23808,2,[乌拉拉啦啦啦]四慌,2186,238,8,6,14,57.1%,1h
23808,3,杀我王虫跟你拼命,2186,0,1,1,2,50.0%,1h
23808,3,xiaoxigua,2186,30,1,1,2,50.0%,47m
23808,2,八爪,2186,0,1,2,3,33.3%,41m
23808,2,南唔十三,2186,30,1,3,4,25.0%,1h
23808,2,blblbl,2186,0,1,6,7,14.3%,1h
23808,3,[XXMNML]Lovelin,2186,0,0,1,1,0.0%,1h
23808,3,[胧月无眠]两仪式,2186,0,0,1,1,0.0%,1h
23808,2,Zen,2186,0,0,1,1,0.0%,1h
23820,1,sparrow,2185,1294,64,77,141,45.4%,1h
23820,2,光明之神,2185,1023,38,36,74,51.4%,1h
23820,2,天啸,2185,308,8,11,19,42.1%,24m
23820,2,康佳云,2185,225,7,5,12,58.3%,11m
23820,2,自由一丶冷风,2185,98,4,4,8,50.0%,1h
23820,2,混合体巨兽,2185,158,3,4,7,42.9%,1h
23820,1,[神组]LUCAS,2185,0,0,1,1,0.0%,31m
23820,2,帅的泪奔,2185,0,0,2,2,0.0%,56m
23820,1,刘一璋,2185,0,0,2,2,0.0%,2m
23829,1,GIGI,2184,1620,131,143,274,47.8%,55m
23829,2,大白胖胖,2184,609,24,22,46,52.2%,2m
23829,3,YUSOBAD,2184,526,17,33,50,34.0%,1h
23829,2,战争狂人,2184,62,4,4,8,50.0%,1h
23829,2,[千叶之王]五更萝莉,2184,42,4,5,9,44.4%,1h
23829,2,虫哥,2184,124,4,8,12,33.3%,15m
23829,2,药石无医,2184,148,3,5,8,37.5%,1h
23829,2,大本,2184,0,2,3,5,40.0%,19m
23829,1,人去茶微凉,2184,115,2,3,5,40.0%,42m
23829,3,[苍翼王座]公输铅,2184,0,1,0,1,100.0%,40m
23829,1,[o唔姆o]MaGeJiTerran,2184,48,1,1,2,50.0%,1h
23829,3,超级无敌帅哥,2184,0,1,4,5,20.0%,1h
23841,1,[在下菜鸡一只]北京军团,2183,1674,126,134,260,48.5%,23m
23841,1,股小宝,2183,539,42,40,82,51.2%,26m
23841,2,坑爹的小蚂蚁,2183,835,42,46,88,47.7%,22m
23841,2,[CPT]不雷斯,2183,898,32,42,74,43.2%,1h
23841,2,PGuanW,2183,660,26,32,58,44.8%,1h
23841,2,QIU,2183,297,11,18,29,37.9%,1h
23841,2,Fredrica,2183,122,5,7,12,41.7%,56m
23841,3,烽烟,2183,30,3,10,13,23.1%,7m
23841,3,啊熊爱打星际争霸,2183,0,0,1,1,0.0%,1h
23850,1,菜鸟之路,2182,1631,209,218,427,48.9%,17m
23850,1,[我们是害虫1]RohanKishibe,2182,1612,129,142,271,47.6%,28m
23850,2,猥琐男小潘,2182,937,61,67,128,47.7%,1h
23850,2,MrHou,2182,959,49,47,96,51.0%,4m
23850,2,杰魁,2182,524,25,34,59,42.4%,31m
23850,2,kiss,2182,579,20,27,47,42.6%,1h
23850,3,博博文,2182,282,11,19,30,36.7%,44m
23850,2,我是新手,2182,137,6,3,9,66.7%,1h
23850,1,albo,2182,220,6,13,19,31.6%,1h
23850,3,阎鹏的父亲,2182,58,3,0,3,100.0%,1h
23850,3,无翼,2182,0,3,2,5,60.0%,1h
23850,2,呼唤你的人,2182,42,2,6,8,25.0%,46m
23850,2,沉默之剑,2182,46,2,7,9,22.2%,14m
23850,3,狂乱之心,2182,0,1,0,1,100.0%,1h
23850,1,[虫族就不会输]艾尔又双叒叕沦陷,2182,97,1,1,2,50.0%,23m
23850,2,青青子衿,2182,0,1,1,2,50.0%,7m
23850,2,DarkPirates,2182,0,1,1,2,50.0%,1h
23850,2,放学回家收谷子,2182,0,1,2,3,33.3%,1h
23850,2,[啊噗撸派]啊阿哦,2182,30,1,3,4,25.0%,1h
23850,2,电脑,2182,0,1,5,6,16.7%,1h
23850,3,大剌,2182,0,0,1,1,0.0%,47m
23850,3,[蔷薇之石]源稚女,2182,0,0,1,1,0.0%,1h
23872,3,[天下无敌]巨木,2181,1530,395,406,801,49.3%,11m
23872,1,云中翻月,2181,927,38,36,74,51.4%,44m
23872,2,风中凌乱,2181,513,25,17,42,59.5%,41m
23872,2,fixby,2181,521,20,23,43,46.5%,1h
23872,2,accele,2181,344,15,12,27,55.6%,1h
23872,3,流浪者,2181,262,10,7,17,58.8%,47m
23872,3,[新手保护协会]发现世界,2181,126,4,3,7,57.1%,47m
23872,2,绥城,2181,94,3,6,9,33.3%,1h
23872,2,Sherlock,2181,93,2,5,7,28.6%,1h
23872,2,LogRideR,2181,97,1,2,3,33.3%,1h
23882,2,一只探姬,2180,902,34,34,68,50.0%,1h
23882,2,Timba,2180,314,28,21,49,57.1%,1h
23882,2,雪域雄鹰,2180,361,16,23,39,41.0%,1h
23882,2,幻影,2180,298,13,7,20,65.0%,55m
23882,2,wind,2180,180,7,3,10,70.0%,1h
23882,3,随鸡硬变,2180,60,6,9,15,40.0%,33m
23882,3,Kda,2180,0,4,6,10,40.0%,34m
23882,1,魏玖漆,2180,142,3,8,11,27.3%,1h
23882,2,阿福,2180,30,2,4,6,33.3%,1h
23882,2,[ldp6]弟中弟,2180,92,2,5,7,28.6%,1h
23882,2,[萌新保护协议]傲娇,2180,94,1,1,2,50.0%,41m
23882,2,[KENNEL]狗苟招专用教学号,2180,0,0,1,1,0.0%,35m
23894,1,llllllllllll,2179,1483,356,372,728,48.9%,43m
23894,3,[暴雪十五队]敢达天盾,2179,1053,41,48,89,46.1%,3m
23894,2,[鸡家军]CatalChao,2179,394,17,4,21,81.0%,53m
23894,2,TzKing,2179,467,17,20,37,45.9%,48m
23894,3,布莱恩丶,2179,332,12,18,30,40.0%,47m
23894,2,jiujiu,2179,266,9,11,20,45.0%,17m
23894,1,King,2179,219,7,7,14,50.0%,1h
23894,2,bbhss,2179,142,5,2,7,71.4%,31m
23894,2,[津富会]爱的飞行日记,2179,101,5,6,11,45.5%,1h
23894,2,法道混沌,2179,88,2,1,3,66.7%,1h
23894,2,[旺旺战士]龖靁魈,2179,91,1,2,3,33.3%,11m
23894,2,SBFR,2179,46,1,4,5,20.0%,59m
23894,1,小毒狼,2179,0,1,8,9,11.1%,41m
23894,2,[小扎的火车侠]公寓之狼,2179,0,0,1,1,0.0%,1h
23908,1,LED,2178,1644,254,263,517,49.1%,1h
23908,2,红花会,2178,969,52,56,108,48.1%,14m
23908,1,无知无畏,2178,627,45,54,99,45.5%,1h
23908,1,简爱,2178,507,17,18,35,48.6%,1h
23908,1,法国穷光蛋,2178,197,7,9,16,43.8%,3m
23908,2,借我一条裤衩,2178,150,6,7,13,46.2%,43m
23908,1,不动如山,2178,144,5,11,16,31.2%,19m
23908,3,Ouking,2178,167,4,4,8,50.0%,1h
23908,3,[沙皇政权]erwe,2178,0,3,2,5,60.0%,26m
23908,2,晚安,2178,40,2,1,3,66.7%,1h
23908,2,月玄,2178,30,1,4,5,20.0%,1h
23908,2,MasterLiu,2178,0,1,5,6,16.7%,33m
23908,3,comflict,2178,0,0,1,1,0.0%,1h
23908,3,sdflhjakldfs,2178,0,0,5,5,0.0%,1h
23922,2,dragon,2177,295,19,13,32,59.4%,1h
23922,2,jieyuhua,2177,425,15,20,35,42.9%,43m
23922,2,冰封之翼,2177,366,12,15,27,44.4%,15m
23922,2,守望,2177,30,2,3,5,40.0%,15m
23922,2,ALIEN,2177,30,2,3,5,40.0%,1h
23922,2,大风起兮云飞扬,2177,0,1,6,7,14.3%,45m
23922,2,[秋毫七队]剑圣,2177,0,0,1,1,0.0%,1h
23922,3,胡较瘦,2177,0,0,1,1,0.0%,1h
23930,2,[慢手e族]JABARI,2176,1568,83,88,171,48.5%,1h
23930,1,眼瞪,2176,1544,82,93,175,46.9%,1h
23930,2,条西,2176,402,13,22,35,37.1%,30m
23930,2,卢卡,2176,125,8,8,16,50.0%,7m
23930,2,孤独患者,2176,180,7,11,18,38.9%,1h
23930,2,执着是爱的痛,2176,131,4,3,7,57.1%,31m
23930,3,Christopher,2176,120,3,1,4,75.0%,11m
23930,2,啥都不会的皓子,2176,183,3,5,8,37.5%,19m
23930,3,[Losers]惆怅啊惆怅,2176,0,2,3,5,40.0%,60m
23930,2,汤圆,2176,0,2,4,6,33.3%,1h
23930,2,不讲五德,2176,46,2,6,8,25.0%,45m
23930,2,大桔的跟班,2176,0,1,6,7,14.3%,48m
23930,1,[屯溪]孤战,2176,48,1,7,8,12.5%,57m
23930,3,棋手,2176,0,0,5,5,0.0%,1h
23944,2,monster,2175,261,10,17,27,37.0%,22m
23944,3,Goose,2175,291,9,16,25,36.0%,11m
23944,2,Death,2175,178,8,18,26,30.8%,41m
23944,1,糊糊涂涂小生活,2175,136,6,6,12,50.0%,23m
23944,2,哥特风的琴键,2175,148,5,9,14,35.7%,1h
23944,1,杨晏,2175,165,3,2,5,60.0%,1h
23944,2,[仿若涅槃寂静]妖夢,2175,126,3,4,7,42.9%,1h
23944,3,subuc,2175,86,3,4,7,42.9%,44m
23944,2,许你万千星河,2175,36,2,0,2,100.0%,19m
23944,3,ingory,2175,0,1,4,5,20.0%,40m
23944,2,罗岗村民,2175,0,0,6,6,0.0%,1h
23944,2,Zest,2175,0,0,7,7,0.0%,9m
23956,2,ShadowWalker,2174,144,8,6,14,57.1%,49m
23956,2,Jun,2174,141,6,4,10,60.0%,1h
23956,3,Kevin,2174,156,6,5,11,54.5%,52m
23956,1,你哥,2174,193,6,11,17,35.3%,1h
23956,2,蓝色空间,2174,162,5,11,16,31.2%,1h
23956,2,叶湘伦,2174,206,4,4,8,50.0%,1h
23956,2,Kitinri,2174,84,3,7,10,30.0%,46m
23956,3,可可爱,2174,0,2,3,5,40.0%,1h
23956,1,[闪金镇守夜人]兰水,2174,0,1,0,1,100.0%,1h
23956,2,吧哩吧哩库呷库呷,2174,0,1,1,2,50.0%,15m
23956,2,[埃蒙帝国]雷诺指挥官,2174,0,0,1,1,0.0%,8m
23956,1,TeamFUTA,2174,0,0,1,1,0.0%,19m
23956,2,查尔的爪牙,2174,0,0,2,2,0.0%,7m
23956,2,[CEASIA]Abraham,2174,0,0,3,3,0.0%,1h
23970,3,阿塔尼斯,2173,766,27,21,48,56.2%,1h
23970,2,[萝莉航线]未见神明前,2173,603,26,25,51,51.0%,17m
23970,2,[新的蜜蜂]stats,2173,349,23,18,41,56.1%,15m
23970,2,米妮,2173,532,19,25,44,43.2%,53m
23970,3,BONIUBI,2173,246,10,6,16,62.5%,1h
23970,2,亦庄,2173,234,7,7,14,50.0%,1h
23970,1,佩恩,2173,248,7,22,29,24.1%,60m
23970,2,frank,2173,213,6,7,13,46.2%,1h
23970,1,夜半,2173,180,3,7,10,30.0%,1h
23970,2,小龙君,2173,94,3,8,11,27.3%,19m
23970,1,破灭,2173,48,3,9,12,25.0%,1h
23970,2,海中一粒,2173,80,3,9,12,25.0%,46m
23970,2,八条是瑶瑶,2173,137,2,2,4,50.0%,58m
23970,2,我的天哪,2173,30,2,3,5,40.0%,7m
23970,2,LvrTime,2173,128,2,3,5,40.0%,36m
23970,1,demaxiya,2173,96,1,2,3,33.3%,1h
23986,2,Ace,2172,1195,45,51,96,46.9%,1h
23986,1,凌问义,2172,1000,36,40,76,47.4%,60m
23986,2,第五绝柔,2172,446,17,15,32,53.1%,2m
23986,2,[CPT]yanghu,2172,363,15,8,23,65.2%,33m
23986,2,sssa,2172,367,12,13,25,48.0%,7m
23986,3,歌本哈根的星球,2172,291,10,15,25,40.0%,1h
23986,3,骑士爱德华,2172,169,6,11,17,35.3%,4m
23986,2,时光,2172,152,5,3,8,62.5%,1h
23986,2,她的力哥,2172,124,5,11,16,31.2%,1h
23986,2,意义不明的沙雕,2172,108,4,6,10,40.0%,49m
23986,2,苏苏,2172,74,3,8,11,27.3%,1h
23986,3,hfg,2172,0,2,3,5,40.0%,18m
23986,2,zhu,2172,46,2,7,9,22.2%,14m
23986,2,青丝弄瑶玉,2172,0,1,0,1,100.0%,1h
23986,3,[智乃超可爱w]我躺了,2172,30,1,2,3,33.3%,26m
23986,3,[半个菜鸟II]miaowumiao,2172,0,1,4,5,20.0%,1h
23986,3,zzzzzzzzz,2172,0,0,1,1,0.0%,58m
23986,2,[aboth]乌鲁克斧王,2172,0,0,3,3,0.0%,1h
23986,3,醋酸洋红,2172,0,0,5,5,0.0%,1h
24005,2,JIEZI,2171,526,17,27,44,38.6%,15m
24005,2,cyguhun,2171,326,13,21,34,38.2%,30m
24005,3,[小小克星]epiphany,2171,175,7,11,18,38.9%,1h
24005,3,晨赋无言,2171,58,3,0,3,100.0%,47m
24005,2,灵儿的逍遥哥哥,2171,114,3,3,6,50.0%,1h
24005,2,[初音守护二队]花爷,2171,0,1,2,3,33.3%,43m
24005,2,[艾尔之名]琉璃,2171,0,1,2,3,33.3%,1h
24005,2,dudi,2171,0,1,6,7,14.3%,36m
24005,3,巧克力灭世者同盟,2171,0,0,1,1,0.0%,1h
24005,2,EIN,2171,0,0,1,1,0.0%,1h
24005,3,神之长子接班人,2171,0,0,5,5,0.0%,4m
24016,1,pksolar,2170,1573,110,122,232,47.4%,17m
24016,2,qdbydknwzgnk,2170,681,25,37,62,40.3%,1h
24016,3,allen,2170,418,15,13,28,53.6%,48m
24016,3,看低你的傲气,2170,345,12,8,20,60.0%,1h
24016,1,秋目,2170,289,10,13,23,43.5%,39m
24016,1,游弋人世间,2170,405,9,15,24,37.5%,1h
24016,2,琴韵悠幽,2170,194,8,7,15,53.3%,47m
24016,1,Bryuner,2170,218,6,11,17,35.3%,6m
24016,3,那句话回家,2170,86,6,14,20,30.0%,1h
24016,3,Gus,2170,0,4,1,5,80.0%,1h
24016,2,死神的棒棒糖,2170,130,3,5,8,37.5%,1h
24016,2,卡达利斯,2170,60,3,7,10,30.0%,1h
24016,2,九个太阳,2170,88,2,1,3,66.7%,15m
24016,1,metropolis,2170,46,2,3,5,40.0%,19m
24016,1,bvbyb,2170,0,1,0,1,100.0%,57m
24016,1,旺仔小馒头,2170,48,1,2,3,33.3%,19m
24016,1,[yjj]夜雨,2170,48,1,2,3,33.3%,1h
24016,2,ShrekForever,2170,0,1,7,8,12.5%,8m
24016,2,呵呵哒,2170,0,0,1,1,0.0%,45m
24035,1,萝莉赛高,2169,1151,55,74,129,42.6%,5m
24035,1,以芒,2169,621,36,42,78,46.2%,1h
24035,3,superstar,2169,786,30,28,58,51.7%,1h
24035,2,[联合动物园]哥伦比亚老树懒,2169,398,16,13,29,55.2%,41m
24035,1,[十三音]炒炒炒炒炒饭,2169,311,9,14,23,39.1%,1h
24035,1,漩涡鸣人,2169,187,7,8,15,46.7%,1h
24035,2,奥里给,2169,178,6,10,16,37.5%,54m
24035,2,[烽夜长歌]移舟水溅差差绿,2169,208,4,9,13,30.8%,14m
24035,1,赵昱江,2169,48,2,10,12,16.7%,23m
24035,3,请叫我风骚哥,2169,0,1,0,1,100.0%,1h
24035,3,[晒职联合会]老萝卜两千型,2169,0,1,0,1,100.0%,1h
24035,2,LIU,2169,0,1,1,2,50.0%,30m
24035,2,阜者,2169,44,1,2,3,33.3%,1h
24035,2,wyx,2169,0,1,6,7,14.3%,12m
24035,3,hehe,2169,0,0,1,1,0.0%,60m
24035,3,browns,2169,0,0,1,1,0.0%,1h
24035,1,[TeamEK]伊红美蓝,2169,0,0,1,1,0.0%,26m
24035,2,战神大兜虫,2169,0,0,1,1,0.0%,20m
24035,3,坦克,2169,0,0,1,1,0.0%,1h
24054,1,银星勋爵,2168,771,90,111,201,44.8%,1h
24054,2,AZTZA,2168,1496,78,81,159,49.1%,15m
24054,2,余音之时,2168,1049,48,56,104,46.2%,53m
24054,1,SCII,2168,1178,40,54,94,42.6%,20m
24054,2,LPDAL,2168,783,32,25,57,56.1%,1h
24054,2,[JFW]骑乘位,2168,621,22,26,48,45.8%,30m
24054,2,战神罗米,2168,429,15,19,34,44.1%,1h
24054,2,乔尔斯,2168,262,10,5,15,66.7%,33m
24054,2,[大脑在震颤]ToTheSky,2168,102,4,6,10,40.0%,41m
24054,1,沉默滴羔羊,2168,92,3,6,9,33.3%,1h
24054,3,[万物皆可萌w]dfguhj,2168,30,3,10,13,23.1%,1h
24054,1,[虚空守望]夜差,2168,0,1,0,1,100.0%,42m
24054,2,[DEUS]Akira,2168,0,1,5,6,16.7%,35m
24054,2,TPC,2168,0,1,6,7,14.3%,1h
24068,2,Dio,2167,1015,39,45,84,46.4%,33m
24068,2,幻仙的爸爸,2167,376,15,10,25,60.0%,1h
24068,3,jhjhjhjh,2167,284,9,13,22,40.9%,60m
24068,2,寂渊,2167,195,6,4,10,60.0%,1h
24068,1,亚煞极,2167,153,6,7,13,46.2%,1h
24068,2,dream,2167,156,5,12,17,29.4%,7m
24068,2,[敢犯我河南者]yygy,2167,130,4,8,12,33.3%,7m
24068,1,安小念,2167,143,3,3,6,50.0%,1h
24068,2,tttttttttttt,2167,86,3,6,9,33.3%,20m
24068,3,佛眼看天,2167,0,1,0,1,100.0%,51m
24068,2,叶渊天,2167,48,1,2,3,33.3%,59m
24068,3,Joker,2167,0,0,1,1,0.0%,1h
24080,1,仙君,2166,1382,79,79,158,50.0%,1h
24080,1,天下,2166,878,70,77,147,47.6%,43m
24080,3,对面没有妈,2166,256,9,12,21,42.9%,34m
24080,2,[雪麒麟]伯爵,2166,230,7,12,19,36.8%,15m
24080,1,Yooo,2166,212,6,11,17,35.3%,1h
24080,1,StarWing,2166,84,2,2,4,50.0%,1h
24080,2,snake,2166,0,2,4,6,33.3%,41m
24080,3,装甲空母胜利,2166,0,2,9,11,18.2%,34m
24080,2,高调世哥,2166,88,1,2,3,33.3%,15m
24080,2,[开心战队]泪了嚄刀,2166,0,0,1,1,0.0%,56m
24080,2,arclon,2166,0,0,4,4,0.0%,1h
24080,3,猪小受,2166,0,0,5,5,0.0%,1h
24092,2,紫竹琳,2165,957,35,46,81,43.2%,1h
24092,3,Destroy,2165,492,18,14,32,56.2%,5m
24092,2,thirty,2165,420,18,19,37,48.6%,48m
24092,3,[NVKR]双峰贯耳搬拦捶,2165,506,17,17,34,50.0%,1h
24092,2,自然大地板,2165,313,15,18,33,45.5%,1h
24092,3,battleSHE,2165,326,11,16,27,40.7%,44m
24092,3,nnggg,2165,257,10,6,16,62.5%,48m
24092,3,[追猎人]hhxj,2165,218,9,4,13,69.2%,53m
24092,2,[社交学大可爱]探姬遭到公鸡,2165,135,9,5,14,64.3%,1h
24092,3,小鸡爱上黑沐耳,2165,90,4,3,7,57.1%,53m
24092,2,零都,2165,144,4,4,8,50.0%,1h
24092,3,海澜之家,2165,58,3,1,4,75.0%,1h
24092,2,王旭峰,2165,141,3,2,5,60.0%,22m
24092,2,感谢太多人工作,2165,42,2,7,9,22.2%,14m
24092,3,伯莎梅森,2165,0,1,1,2,50.0%,58m
24092,3,Memories,2165,36,1,3,4,25.0%,1h
24092,2,[纵丨横]三桑无夜,2165,0,1,6,7,14.3%,60m
24092,2,Jat,2165,0,0,1,1,0.0%,1h
24092,2,[月野兔]嗷嗷嗷的小仙女,2165,0,0,2,2,0.0%,1h
24092,2,太子城老侯,2165,0,0,2,2,0.0%,48m
24112,1,土方十四蛋黄酱,2164,582,24,30,54,44.4%,16m
24112,3,天梦,2164,190,7,4,11,63.6%,37m
24112,1,好吃的张张包,2164,138,4,12,16,25.0%,19m
24112,2,[这是什么玩意]老王是真的帅,2164,135,3,1,4,75.0%,1h
24112,1,[浙江大学战队]南大元帅,2164,90,3,2,5,60.0%,31m
24112,1,奎伦萨尔,2164,46,2,0,2,100.0%,39m
24112,3,[最炫之人]绝代智将,2164,0,0,1,1,0.0%,9m
24112,3,ghost,2164,0,0,1,1,0.0%,1h
24112,2,樱与郁金香,2164,0,0,2,2,0.0%,1h
24121,2,菜鸟,2163,448,104,113,217,47.9%,1h
24121,3,别打我啊不抗揍,2163,1419,54,56,110,49.1%,1h
24121,2,别跑,2163,647,28,27,55,50.9%,49m
24121,2,opooopooo,2163,90,4,5,9,44.4%,2m
24121,2,yyyyccccc,2163,46,4,6,10,40.0%,1h
24121,3,[羊驼羊驼羊]Sakura,2163,0,1,0,1,100.0%,12m
24121,3,deepcry,2163,30,1,1,2,50.0%,49m
24121,3,zlz,2163,85,1,1,2,50.0%,58m
24121,2,小乔,2163,42,1,3,4,25.0%,1h
24130,2,JGenou,2162,1258,70,75,145,48.3%,1h
24130,2,小豆梓,2162,1228,50,54,104,48.1%,48m
24130,2,sjdw,2162,728,44,52,96,45.8%,1h
24130,2,liang,2162,995,35,41,76,46.1%,1h
24130,3,srfes,2162,239,24,19,43,55.8%,1h
24130,2,zwsml,2162,117,17,19,36,47.2%,33m
24130,2,死亡魅魔夜魇,2162,410,14,16,30,46.7%,1h
24130,1,请勿理解,2162,332,10,13,23,43.5%,1h
24130,2,简单电脑,2162,263,9,16,25,36.0%,1h
24130,3,insight,2162,168,6,5,11,54.5%,33m
24130,1,绝影,2162,176,6,11,17,35.3%,1h
24130,1,Endid,2162,282,5,8,13,38.5%,47m
24130,2,pokuf,2162,177,4,9,13,30.8%,46m
24130,1,歪比巴布,2162,140,4,12,16,25.0%,1h
24130,2,[魂祀]清风,2162,62,3,6,9,33.3%,55m
24130,2,RooPanes,2162,88,3,7,10,30.0%,1h
24130,3,死神,2162,58,2,2,4,50.0%,47m
24130,2,深海鲨鱼王,2162,0,1,4,5,20.0%,1h
24130,2,天地任我行,2162,30,1,5,6,16.7%,1h
24130,3,龙族,2162,0,0,1,1,0.0%,1h
24130,3,查尔星土豪,2162,0,0,1,1,0.0%,1h
24130,3,chinaboy,2162,0,0,1,1,0.0%,7m
24152,2,Alxer,2161,961,38,35,73,52.1%,1h
24152,2,失去的记忆,2161,658,28,25,53,52.8%,1h
24152,3,haha,2161,575,21,22,43,48.8%,51m
24152,2,凯蒂,2161,441,19,13,32,59.4%,1h
24152,2,柠檬水放糖,2161,442,19,21,40,47.5%,11m
24152,2,在黑夜里隐身,2161,340,15,15,30,50.0%,15m
24152,1,hyacinth,2161,225,14,19,33,42.4%,5m
24152,2,[Okiam]魍魉,2161,222,8,6,14,57.1%,9m
24152,1,[AKGAME]CrazyDark,2161,181,7,9,16,43.8%,1h
24152,3,Galahad,2161,60,3,1,4,75.0%,51m
24152,3,luvian,2161,30,2,1,3,66.7%,51m
24152,3,[大熊猫]路灯下萌一萌,2161,0,1,2,3,33.3%,1h
24152,2,金人,2161,0,1,6,7,14.3%,60m
24152,3,吕玲琦,2161,97,1,7,8,12.5%,3m
24152,3,[绝世高手]夜影林灵,2161,0,0,1,1,0.0%,34m
24167,2,LIU,2160,673,81,82,163,49.7%,1h
24167,2,金环蛇,2160,1251,48,56,104,46.2%,1h
24167,2,jarod,2160,505,44,52,96,45.8%,7m
24167,2,反正是傻,2160,643,25,28,53,47.2%,1h
24167,2,MRchen,2160,433,18,19,37,48.6%,1h
24167,3,[小花]桑墨丶柳月,2160,224,6,8,14,42.9%,1h
24167,3,LJsquirrel,2160,60,2,2,4,50.0%,1h
24167,3,不死国王,2160,38,1,6,7,14.3%,1h
24167,2,[DMR]blinkblink,2160,0,0,4,4,0.0%,1h
24176,1,Tony,2159,1504,220,233,453,48.6%,44m
24176,2,柳岩的球迷,2159,1446,81,76,157,51.6%,49m
24176,1,SHYMF,2159,1004,56,63,119,47.1%,1h
24176,2,影子,2159,1121,48,48,96,50.0%,22m
24176,1,hhhh,2159,932,37,41,78,47.4%,1h
24176,2,神之领域,2159,338,12,20,32,37.5%,43m
24176,3,jdy,2159,238,7,2,9,77.8%,5m
24176,2,是土豆呀,2159,130,5,3,8,62.5%,55m
24176,2,州白,2159,96,5,6,11,45.5%,1h
24176,1,Pretend,2159,136,5,11,16,31.2%,1h
24176,2,地狱裁决,2159,218,4,10,14,28.6%,1h
24176,1,巨硬,2159,193,4,11,15,26.7%,1h
24176,1,[此花亭]星河,2159,95,2,2,4,50.0%,1h
24176,3,EmperorTFR,2159,58,2,2,4,50.0%,2m
24176,2,欧豆豆不想要,2159,0,1,1,2,50.0%,33m
24176,2,总有贱民偷袭我,2159,0,0,3,3,0.0%,57m
24176,2,SuperJoyc,2159,0,0,5,5,0.0%,1h
24193,2,域外神,2158,1010,53,55,108,49.1%,1h
24193,3,太阳公公爱洗澡澡,2158,855,36,34,70,51.4%,1h
24193,3,[孙岱玹]蟑螂舞姬,2158,834,35,17,52,67.3%,1h
24193,2,Rule,2158,730,25,29,54,46.3%,1h
24193,2,奇迹,2158,446,15,16,31,48.4%,1h
24193,2,幻夜浮屠,2158,358,12,13,25,48.0%,30m
24193,1,音无寒暄,2158,271,8,14,22,36.4%,39m
24193,1,阿巴阿巴,2158,229,7,14,21,33.3%,1h
24193,1,逍遥羽,2158,237,4,9,13,30.8%,1h
24193,2,Scalpel,2158,42,2,4,6,33.3%,43m
24193,2,天地孤影任我行,2158,58,2,6,8,25.0%,50m
24193,3,空心,2158,30,1,2,3,33.3%,1h
24193,2,Raphael,2158,0,0,1,1,0.0%,20m
24193,3,奋进的咸鱼丙,2158,0,0,5,5,0.0%,33m
24207,1,欧阳,2157,1634,96,109,205,46.8%,51m
24207,3,王中王,2157,1256,45,48,93,48.4%,1h
24207,1,哒哒,2157,869,30,42,72,41.7%,1h
24207,1,不器的爸爸,2157,577,18,30,48,37.5%,17m
24207,2,殇秋,2157,376,14,17,31,45.2%,1h
24207,2,披着羊皮的狼,2157,360,13,13,26,50.0%,1h
24207,2,Kenxzn,2157,299,12,16,28,42.9%,1h
24207,1,桐谷和人,2157,350,12,23,35,34.3%,59m
24207,3,丨王大锤丨,2157,283,10,15,25,40.0%,23m
24207,3,[王者重现]诺亚方舟,2157,254,8,3,11,72.7%,1h
24207,3,翻滚的仓鼠菌,2157,202,8,5,13,61.5%,53m
24207,2,无理诗人,2157,208,8,10,18,44.4%,1h
24207,2,为你扫天下,2157,224,8,13,21,38.1%,15m
24207,2,剑皇道一,2157,230,8,19,27,29.6%,1h
24207,3,花水月,2157,120,5,3,8,62.5%,52m
24207,1,符璃,2157,209,5,7,12,41.7%,1h
24207,1,[无谐可鸡]冈本大战杜蕾斯,2157,209,4,5,9,44.4%,41m
24207,3,小兵,2157,30,2,1,3,66.7%,1h
24207,3,我不想白给,2157,0,1,0,1,100.0%,1h
24207,2,江小鱼,2157,0,1,2,3,33.3%,1h
24207,1,无尽虚空,2157,97,1,4,5,20.0%,1h
24207,2,西瓜皮,2157,0,1,7,8,12.5%,14m
24207,3,夕阳的刻痕,2157,0,0,1,1,0.0%,1h
24207,1,天敕,2157,0,0,1,1,0.0%,1h
24231,2,[91谐会]Vogue,2156,497,23,25,48,47.9%,1h
24231,2,[NanTeS]尘马,2156,419,13,22,35,37.1%,4m
24231,3,BrightHammer,2156,336,11,11,22,50.0%,1h
24231,2,[暴雪养鸡场]RONIN,2156,204,8,9,17,47.1%,43m
24231,2,[萌妹cute]忆雨,2156,163,6,5,11,54.5%,1h
24231,2,[清华大学战队]七九,2156,202,6,9,15,40.0%,1h
24231,1,鸽王,2156,190,3,5,8,37.5%,23m
24231,2,德鲁大叔,2156,137,3,6,9,33.3%,1h
24231,1,死者丿神生者,2156,136,3,8,11,27.3%,42m
24231,2,SpicA,2156,0,2,6,8,25.0%,1h
24231,2,wjd,2156,0,1,6,7,14.3%,1h
24242,2,我好,2155,533,21,22,43,48.8%,15m
24242,3,一晌贪欢,2155,332,12,11,23,52.2%,47m
24242,1,KAZ,2155,324,10,13,23,43.5%,1h
24242,1,sword,2155,144,3,5,8,37.5%,1h
24242,1,四季大人我有罪,2155,0,1,0,1,100.0%,1h
24242,2,战式,2155,93,1,6,7,14.3%,45m
24242,3,SkyDer,2155,0,0,1,1,0.0%,1h
24242,1,我是痞子,2155,0,0,3,3,0.0%,1h
24250,1,输因为低调,2154,633,50,57,107,46.7%,52m
24250,2,黄金,2154,589,25,19,44,56.8%,1h
24250,2,天地正气,2154,330,21,16,37,56.8%,1h
24250,1,[喷子]喷死你妈妈,2154,346,10,17,27,37.0%,1h
24250,1,小阿善,2154,237,8,11,19,42.1%,38m
24250,3,[小菜逼]SHUAshua,2154,86,4,1,5,80.0%,1h
24250,1,偏爱小单,2154,199,4,4,8,50.0%,1h
24250,3,红白执法,2154,58,3,1,4,75.0%,26m
24250,2,青铜水平请多包涵,2154,88,3,8,11,27.3%,7m
24250,2,这波是肉蛋葱鸡,2154,42,2,7,9,22.2%,1h
24250,3,denny,2154,0,1,0,1,100.0%,28m
24250,2,unluckly,2154,44,1,1,2,50.0%,56m
24250,2,Hardess,2154,0,1,1,2,50.0%,57m
24250,2,一只羊,2154,0,1,5,6,16.7%,41m
24250,2,YatogamiTuki,2154,0,0,3,3,0.0%,47m
24265,2,[大洋彼岸团队]jkljlj,2153,1362,89,88,177,50.3%,1h
24265,3,[要啥没啥爱咋]血族,2153,746,52,55,107,48.6%,1h
24265,2,阡陌流萤,2153,560,20,21,41,48.8%,33m
24265,2,阿兹卡达哈,2153,494,18,22,40,45.0%,33m
24265,2,浮士德,2153,354,13,23,36,36.1%,48m
24265,2,会飞的小子弹,2153,112,2,4,6,33.3%,1h
24265,3,反射光乩,2153,0,2,9,11,18.2%,23m
24265,3,与你摊牌,2153,0,1,0,1,100.0%,58m
24265,2,BridmanL,2153,30,1,4,5,20.0%,1h
24265,3,[镜花水月丨]VOX,2153,0,0,1,1,0.0%,1h
24275,1,星星,2152,1608,97,105,202,48.0%,1h
24275,1,气德一匹,2152,646,21,32,53,39.6%,16m
24275,2,零五二四,2152,364,11,15,26,42.3%,57m
24275,1,Wone,2152,168,5,10,15,33.3%,1h
24275,3,我们中出了个叛徒,2152,58,2,1,3,66.7%,5m
24275,3,菲尼克斯,2152,30,2,2,4,50.0%,1h
24275,3,lishaoye,2152,0,0,2,2,0.0%,37m
24275,2,悍马威武,2152,0,0,2,2,0.0%,57m
24275,2,夏天的雪夜,2152,0,0,3,3,0.0%,1h
24275,2,Nagi,2152,0,0,3,3,0.0%,1h
24285,2,[帝都战神]Jimleinuo,2151,1499,79,90,169,46.7%,43m
24285,2,一只树奈奈,2151,791,53,66,119,44.5%,53m
24285,2,血狼,2151,326,12,12,24,50.0%,55m
24285,1,无敌即寂寞,2151,293,8,13,21,38.1%,57m
24285,2,showmaker,2151,153,5,5,10,50.0%,20m
24285,1,XynYsqq,2151,200,5,8,13,38.5%,19m
24285,3,我是大神,2151,97,2,1,3,66.7%,1h
24285,2,WSF,2151,76,1,3,4,25.0%,57m
24285,2,ASDV,2151,0,0,3,3,0.0%,1h
24294,2,月在那个玫瑰,2150,489,21,25,46,45.7%,43m
24294,3,音乐之海,2150,587,20,26,46,43.5%,1h
24294,2,云书雾廖,2150,375,18,11,29,62.1%,15m
24294,3,JIE,2150,242,9,5,14,64.3%,1h
24294,3,[奥林匹斯众神]末日之刃,2150,253,9,7,16,56.2%,34m
24294,2,bigdickman,2150,132,4,9,13,30.8%,45m
24294,1,雨逅清,2150,171,4,10,14,28.6%,1h
24294,3,[泥玛艹战队]哈逻,2150,0,1,5,6,16.7%,40m
24302,2,ShiLing,2149,1465,67,84,151,44.4%,1h
24302,2,清风浩存,2149,252,9,14,23,39.1%,31m
24302,3,[极限菜鸟]南木哥,2149,266,8,17,25,32.0%,37m
24302,2,燃烧我的卡路里,2149,213,7,6,13,53.8%,37m
24302,3,我萌新我很坑,2149,123,4,10,14,28.6%,49m
24302,1,[HUC前衛]花火丶,2149,124,4,13,17,23.5%,1h
24302,3,ZHANG,2149,90,3,5,8,37.5%,1h
24302,3,shaotianxiao,2149,30,2,1,3,66.7%,45m
24302,2,荣泽,2149,109,2,6,8,25.0%,14m
24302,2,SHENGLZJ,2149,88,1,1,2,50.0%,46m
24302,3,[黄金萌新战舰]不是特会起名,2149,46,1,4,5,20.0%,1h
24302,3,屿风灬兴哥,2149,0,0,1,1,0.0%,9m
24314,3,那句晚安你说了吗,2148,899,37,42,79,46.8%,1h
24314,2,[CPT]hood,2148,969,36,40,76,47.4%,9m
24314,2,谷鸡谷鸡,2148,879,33,34,67,49.3%,1h
24314,2,海底有针,2148,354,13,14,27,48.1%,1h
24314,3,真空快递员,2148,208,7,3,10,70.0%,1h
24314,3,iceking,2148,90,3,3,6,50.0%,47m
24314,3,逍遥天境,2148,30,2,1,3,66.7%,1h
24314,3,Bishop,2148,30,2,1,3,66.7%,44m
24314,2,方舟的骑士,2148,44,2,3,5,40.0%,20m
24314,3,灵语,2148,0,1,0,1,100.0%,58m
24314,3,LansloT,2148,30,1,2,3,33.3%,1h
24314,3,[visher]segarp,2148,96,1,2,3,33.3%,44m
24326,1,淡墨,2147,1363,77,89,166,46.4%,50m
24326,2,寒鸦之锋,2147,848,29,39,68,42.6%,1h
24326,2,zjy,2147,404,22,29,51,43.1%,57m
24326,3,sirenduao,2147,564,20,18,38,52.6%,1h
24326,2,[柠檬保护协会]斗鱼狼轩,2147,319,18,22,40,45.0%,22m
24326,2,[魔爱着神]橙汁,2147,372,13,23,36,36.1%,57m
24326,1,撩酒,2147,293,9,9,18,50.0%,1h
24326,3,阿努比斯,2147,146,8,13,21,38.1%,1h
24326,2,anizerf,2147,126,5,5,10,50.0%,15m
24326,2,猥琐达人,2147,128,5,9,14,35.7%,1h
24326,1,一个农民打天下,2147,140,3,1,4,75.0%,1h
24326,1,只会安装不会玩儿,2147,157,3,17,20,15.0%,1h
24326,3,[715]kirito,2147,30,2,0,2,100.0%,1h
24326,3,[圣墟]似雨若离,2147,0,1,1,2,50.0%,18m
24326,1,征伐者,2147,96,1,5,6,16.7%,1h
24326,3,张三先生,2147,0,0,2,2,0.0%,1h
24342,1,一二三四五六起,2146,1234,45,62,107,42.1%,1h
24342,3,Jerry,2146,656,22,23,45,48.9%,1h
24342,2,我太菜了,2146,158,4,6,10,40.0%,1h
24342,1,面壁,2146,120,4,7,11,36.4%,31m
24342,2,踏马玩就玩别笑我,2146,115,3,7,10,30.0%,7m
24342,1,SQS,2146,46,1,2,3,33.3%,19m
24342,3,LuoLe,2146,0,0,5,5,0.0%,1h
24349,2,米开朗芬奇,2145,762,29,38,67,43.3%,53m
24349,3,星际,2145,309,13,11,24,54.2%,1h
24349,3,[罗马方标]werwolf,2145,286,11,8,19,57.9%,23m
24349,2,[幕后煮shi]走走,2145,242,8,9,17,47.1%,48m
24349,3,雷神,2145,160,6,3,9,66.7%,1h
24349,1,变身终极猪猪超人,2145,250,5,6,11,45.5%,1h
24349,3,[000101]decade,2145,173,4,5,9,44.4%,1h
24349,2,帅气的小伙,2145,124,4,7,11,36.4%,1h
24349,2,南笙,2145,30,2,5,7,28.6%,25m
24349,3,[LSH]哇哈哈哈哈,2145,0,0,5,5,0.0%,1h
24359,2,aspid,2144,849,35,39,74,47.3%,1h
24359,2,taotao,2144,565,20,23,43,46.5%,53m
24359,2,眞露,2144,423,16,21,37,43.2%,1h
24359,2,乳此可怕,2144,334,13,18,31,41.9%,1h
24359,2,[暴雪二十二队]TONY,2144,238,10,8,18,55.6%,1h
24359,2,旅店老板,2144,202,9,9,18,50.0%,50m
24359,2,Moyan,2144,246,8,23,31,25.8%,31m
24359,1,上杉绘梨衣,2144,184,5,10,15,33.3%,42m
24359,3,寡妇制造者,2144,193,5,13,18,27.8%,1h
24359,2,咕咕咕,2144,174,3,4,7,42.9%,36m
24359,2,[黑氓]玩好看看,2144,64,3,6,9,33.3%,22m
24359,3,[田中姬铃木雏]GHOST,2144,36,2,0,2,100.0%,1h
24359,3,HeisenberG,2144,30,2,0,2,100.0%,5m
24359,3,CCLssr,2144,0,2,3,5,40.0%,1h
24359,3,[江南暮雪]执政官吉姆雷诺,2144,0,1,1,2,50.0%,1h
24359,3,[出兵大战萌新]星盟圣约,2144,0,1,4,5,20.0%,1h
24359,2,BenBen,2144,0,1,6,7,14.3%,46m
24359,2,梓菡,2144,0,0,3,3,0.0%,1h
24359,1,陌空城,2144,0,0,3,3,0.0%,1h
24378,2,花开如梦,2143,722,49,47,96,51.0%,1h
24378,3,叶寒儒,2143,574,20,16,36,55.6%,45m
24378,3,不安定的神明,2143,398,14,14,28,50.0%,49m
24378,2,Hqsz,2143,338,11,19,30,36.7%,1h
24378,1,桜島麻衣,2143,296,10,8,18,55.6%,1h
24378,2,[我们是瞎子]railgun,2143,104,3,4,7,42.9%,1h
24378,2,[歌者]INnoVation,2143,92,3,8,11,27.3%,1h
24378,3,陌上人,2143,30,3,10,13,23.1%,1h
24378,2,队长大剑,2143,0,1,1,2,50.0%,12m
24378,2,郝峰,2143,0,1,5,6,16.7%,58m
24388,2,传奇,2142,468,17,26,43,39.5%,54m
24388,2,AlephPi,2142,131,16,14,30,53.3%,1h
24388,2,日爆射,2142,248,13,18,31,41.9%,1h
24388,3,大飞哥打爆你菊,2142,302,10,10,20,50.0%,7m
24388,1,MagicTragic,2142,0,2,8,10,20.0%,1h
24388,1,[50块好狗子]小黑,2142,38,2,10,12,16.7%,1h
24388,2,穿云剑,2142,0,1,4,5,20.0%,1h
24388,2,[CPT]Magicterrani,2142,30,1,7,8,12.5%,1h
24388,3,[DMR]独秀阿飞,2142,0,0,2,2,0.0%,1h
24388,3,散打大大地范德萨,2142,0,0,5,5,0.0%,51m
24398,1,不道啥名,2141,1625,226,231,457,49.5%,1h
24398,2,[菜有菜的道理]常总,2141,497,19,29,48,39.6%,1h
24398,2,滑板,2141,500,18,24,42,42.9%,11m
24398,2,TNEX,2141,88,2,4,6,33.3%,1h
24398,2,孙一楠,2141,62,2,8,10,20.0%,1h
24398,2,菜鸟,2141,46,1,4,5,20.0%,1h
24398,2,三啥你母亲,2141,0,0,5,5,0.0%,1h
24398,3,Sueter,2141,0,0,6,6,0.0%,40m
24398,2,鬼冢,2141,0,0,7,7,0.0%,8m
24407,2,西瓜,2140,1246,52,58,110,47.3%,1h
24407,3,驻风,2140,346,28,35,63,44.4%,37m
24407,3,洛阳黑旋风,2140,317,12,5,17,70.6%,1h
24407,2,陌城,2140,389,11,21,32,34.4%,1h
24407,3,[太阳与野花]梦之科学边境,2140,203,7,12,19,36.8%,1h
24407,2,零度一下,2140,166,6,7,13,46.2%,15m
24407,2,无聊,2140,144,5,7,12,41.7%,1h
24407,3,[拯救孤独]我是卧底,2140,36,2,1,3,66.7%,51m
24407,1,[野蛮猫骑士]依然,2140,46,2,2,4,50.0%,47m
24407,1,lxm,2140,94,2,2,4,50.0%,1h
24407,3,qiqiyoung,2140,20,2,2,4,50.0%,47m
24407,3,PHGK,2140,30,1,1,2,50.0%,1h
24407,2,风落有时,2140,0,1,1,2,50.0%,57m
24407,3,[暴雪二十队]直死魔眼根源式,2140,0,0,1,1,0.0%,2m
24407,2,八云白墨,2140,0,0,3,3,0.0%,36m
24407,3,破风丶,2140,0,0,5,5,0.0%,1h
24423,3,比利小子,2139,642,25,30,55,45.5%,1h
24423,1,薄荷,2139,246,25,30,55,45.5%,56m
24423,2,余生,2139,448,17,17,34,50.0%,2m
24423,2,FallenScars,2139,163,8,23,31,25.8%,31m
24423,2,功夫胖,2139,137,6,5,11,54.5%,1h
24423,1,红红火火,2139,48,2,8,10,20.0%,1h
24423,2,老子要逆天,2139,109,2,9,11,18.2%,37m
24423,2,cha,2139,0,1,8,9,11.1%,1h
24423,3,[星灵王]菊爆大队,2139,0,0,1,1,0.0%,1h
24423,3,成都亿诺,2139,0,0,1,1,0.0%,1h
24423,3,猪猪的诺言,2139,0,0,5,5,0.0%,1h
24434,2,可乐,2138,1583,315,368,683,46.1%,49m
24434,3,冰月长安,2138,637,23,26,49,46.9%,60m
24434,2,NICEgood,2138,368,13,23,36,36.1%,43m
24434,3,ShaDow,2138,269,10,10,20,50.0%,1h
24434,2,五木,2138,196,7,13,20,35.0%,55m
24434,1,[Micer]Daguanren,2138,96,6,8,14,42.9%,19m
24434,2,Polaris,2138,199,6,8,14,42.9%,8m
24434,2,[龙背上的骑兵]CHINAHUI,2138,130,4,10,14,28.6%,1h
24434,2,刘艺控,2138,46,3,8,11,27.3%,58m
24434,1,GrafZeppelin,2138,97,2,8,10,20.0%,31m
24434,3,[阿波罗捏造说]茜宝,2138,0,0,1,1,0.0%,48m
24434,2,刺客丿千鸟,2138,0,0,1,1,0.0%,1h
24434,3,forever,2138,0,0,2,2,0.0%,1h
24447,1,灰太狼,2137,797,53,61,114,46.5%,16m
24447,3,yhf,2137,334,15,13,28,53.6%,52m
24447,3,夜空千耀,2137,122,9,16,25,36.0%,1h
24447,1,钢铁小馒头,2137,272,6,11,17,35.3%,26m
24447,2,BlackJoke,2137,88,3,7,10,30.0%,57m
24447,1,星灵王,2137,0,1,0,1,100.0%,23m
24447,3,[白丝萝莉协会]孤岛,2137,30,1,3,4,25.0%,1h
24447,3,浅笑水寒,2137,0,0,1,1,0.0%,1h
24455,2,[Rapier]schumidry,2136,1538,108,110,218,49.5%,54m
24455,2,幸运的老虎,2136,1151,58,73,131,44.3%,31m
24455,2,Garryfald,2136,1102,41,40,81,50.6%,1h
24455,1,karong,2136,809,34,49,83,41.0%,1h
24455,3,星际新手,2136,370,14,32,46,30.4%,19m
24455,2,影子的契约,2136,346,13,22,35,37.1%,1h
24455,3,MLApaul,2136,258,10,14,24,41.7%,1h
24455,1,[极限菜鸟]杀破天,2136,314,9,15,24,37.5%,1h
24455,3,[琴筝]xiongjiyang,2136,172,7,8,15,46.7%,45m
24455,3,无敌星皇菜鸡,2136,186,6,10,16,37.5%,28m
24455,3,光明匕首,2136,114,4,4,8,50.0%,1h
24455,1,泰森咬耳朵,2136,166,4,10,14,28.6%,19m
24455,2,[恶魔旗号队]冥王,2136,164,3,3,6,50.0%,34m
24455,2,漆黑的绝望,2136,140,3,5,8,37.5%,9m
24455,3,[兴欣网吧]一叶之秋,2136,60,2,2,4,50.0%,5m
24455,3,圣心达摩,2136,64,2,6,8,25.0%,1h
24455,3,宇智波阿飞,2136,0,1,0,1,100.0%,51m
24455,3,skt,2136,0,1,4,5,20.0%,1h
24455,2,MMD,2136,0,1,6,7,14.3%,1h
24474,2,嘛唧唧,2135,648,22,22,44,50.0%,48m
24474,3,竹阁士道,2135,634,22,28,50,44.0%,1h
24474,2,daigo,2135,524,21,18,39,53.8%,1h
24474,3,执法官,2135,216,8,4,12,66.7%,37m
24474,1,staim,2135,261,8,11,19,42.1%,47m
24474,1,墨染之樱,2135,205,5,5,10,50.0%,1h
24474,2,小强敖鸥,2135,174,5,7,12,41.7%,1h
24474,1,sfh,2135,48,2,9,11,18.2%,1h
24474,2,[战无不胜st]来自神秘的东方,2135,0,1,0,1,100.0%,1h
24474,2,[EILEN]ARI,2135,94,1,7,8,12.5%,1h
24474,3,龙与僵尸和骑士,2135,0,0,1,1,0.0%,3m
24474,1,按钮,2135,0,0,5,5,0.0%,6m
24486,2,bssss,2134,1403,73,84,157,46.5%,49m
24486,2,啦啦啦啦啦,2134,246,19,16,35,54.3%,1h
24486,3,薛定谔,2134,212,8,9,17,47.1%,45m
24486,1,川建国,2134,343,8,15,23,34.8%,3m
24486,2,sober,2134,103,7,8,15,46.7%,1h
24486,2,[Rhusky]Shino,2134,178,7,9,16,43.8%,15m
24486,2,紫云天涯,2134,146,5,3,8,62.5%,1h
24486,2,路下友人,2134,211,5,11,16,31.2%,1h
24486,3,Asasin,2134,127,4,11,15,26.7%,51m
24486,3,HelloStar,2134,47,4,12,16,25.0%,2m
24486,1,闪耀白羊,2134,141,3,2,5,60.0%,1h
24486,1,风格国际,2134,0,1,0,1,100.0%,3m
24486,3,有容奶大,2134,30,1,2,3,33.3%,47m
24486,1,三月一雨墲成铃,2134,96,1,2,3,33.3%,39m
24486,2,涯冢,2134,0,1,6,7,14.3%,37m
24486,3,丶花花,2134,0,0,1,1,0.0%,18m
24502,2,tskkBiss,2133,1305,206,223,429,48.0%,1h
24502,2,Richthofe,2133,278,35,36,71,49.3%,53m
24502,2,star,2133,379,13,22,35,37.1%,1h
24502,2,[鲜血蔷薇]人深,2133,150,5,13,18,27.8%,1h
24502,3,西瓜君,2133,30,2,2,4,50.0%,1h
24502,3,一生所爱,2133,30,1,2,3,33.3%,2m
24502,3,云神,2133,21,1,2,3,33.3%,58m
24502,1,老罗杰,2133,0,0,1,1,0.0%,1h
24502,2,[KPG2]依然是一个明光,2133,0,0,6,6,0.0%,1h
24511,3,TheEverLaS,2132,1128,125,147,272,46.0%,37m
24511,2,hismoon,2132,341,14,14,28,50.0%,1h
24511,3,superapple,2132,155,6,11,17,35.3%,9m
24511,2,油炸扎加拉,2132,158,5,13,18,27.8%,48m
24511,1,emperor,2132,212,4,7,11,36.4%,1h
24511,1,归来去兮,2132,165,4,9,13,30.8%,47m
24511,1,白浮尘,2132,96,3,4,7,42.9%,1h
24511,2,老六大魔王,2132,134,3,10,13,23.1%,48m
24511,1,尛夵,2132,92,3,11,14,21.4%,19m
24511,3,[炸天帮万岁]扬了你的奶粉,2132,30,1,3,4,25.0%,51m
24511,2,Don,2132,30,1,4,5,20.0%,4m
24511,2,周小公瑾,2132,30,1,6,7,14.3%,1h
24523,2,[埃蒙好可爱]云霄九天,2131,461,41,38,79,51.9%,7m
24523,3,不用怀疑不会,2131,310,11,11,22,50.0%,1h
24523,3,zty,2131,181,7,10,17,41.2%,1h
24523,2,咩咩,2131,196,6,5,11,54.5%,8m
24523,2,Cynicism,2131,242,6,7,13,46.2%,4m
24523,3,[FEILIA]绯灬,2131,90,3,3,6,50.0%,45m
24523,3,创界,2131,66,2,7,9,22.2%,51m
24523,2,[马家沟白给王]DECADE,2131,0,1,6,7,14.3%,8m
24523,3,遭重了啊,2131,0,0,1,1,0.0%,33m
24523,3,KKlhz,2131,0,0,1,1,0.0%,7m
24523,3,Fishhhhh,2131,0,0,1,1,0.0%,1h
24523,3,[TAK]疯子,2131,0,0,2,2,0.0%,1h
24523,3,威末,2131,0,0,3,3,0.0%,18m
24536,2,MAX,2130,1180,44,53,97,45.4%,1h
24536,2,Queen,2130,822,32,37,69,46.4%,43m
24536,3,kiva,2130,336,13,8,21,61.9%,37m
24536,3,闪闪亮的珍宝,2130,233,7,3,10,70.0%,45m
24536,2,虫祖,2130,0,1,0,1,100.0%,48m
24536,3,寂然,2130,30,1,1,2,50.0%,9m
24536,1,soap,2130,0,0,4,4,0.0%,19m
24543,1,ssk,2129,1421,132,139,271,48.7%,1h
24543,3,sdfdsfas,2129,276,9,11,20,45.0%,1h
24543,1,破阵将,2129,142,6,8,14,42.9%,26m
24543,3,爹地,2129,0,1,0,1,100.0%,1h
24543,3,谦谦,2129,30,1,3,4,25.0%,49m
24543,3,新线广告,2129,0,1,5,6,16.7%,40m
24549,2,[恒盛]火狐,2128,1563,316,348,664,47.6%,1h
24549,2,程雪,2128,1545,114,123,237,48.1%,1h
24549,1,潜行,2128,136,3,4,7,42.9%,1h
24549,3,tydjythdrg,2128,88,3,5,8,37.5%,51m
24549,2,柳叶安,2128,44,2,7,9,22.2%,1h
24549,3,Titans,2128,30,1,1,2,50.0%,49m
24549,3,无聊与无言,2128,0,0,1,1,0.0%,1h
24549,3,Rocinante,2128,0,0,5,5,0.0%,18m
24557,2,十二审判,2127,1490,70,83,153,45.8%,1h
24557,2,XRZX,2127,384,13,21,34,38.2%,1h
24557,3,让我杀一个人,2127,317,12,20,32,37.5%,1h
24557,2,[Dynami]暗影之风暴,2127,300,9,12,21,42.9%,1h
24557,1,Zaning,2127,221,7,8,15,46.7%,2m
24557,2,YFfinger,2127,137,4,3,7,57.1%,46m
24557,3,YyM,2127,0,2,4,6,33.3%,1h
24557,3,eternity,2127,0,1,0,1,100.0%,3m
24557,3,xjmxhh,2127,0,1,5,6,16.7%,1h
24557,3,[底特律KAR]Scalpel,2127,0,0,2,2,0.0%,1h
24567,2,千本樱丶翔月,2126,576,45,48,93,48.4%,1h
24567,1,[305]一只河河河河豚,2126,0,1,2,3,33.3%,1h
24567,2,BombardingT,2126,0,1,6,7,14.3%,1h
24567,1,[逆回十六夜]罗伯特基里曼,2126,0,0,1,1,0.0%,2m
24567,3,NJRR,2126,0,0,1,1,0.0%,1h
24572,2,JOJOFANSEN,2125,1599,100,117,217,46.1%,1h
24572,1,Hubble,2125,1059,43,63,106,40.6%,26m
24572,2,暗影兵神,2125,818,34,36,70,48.6%,49m
24572,3,cccvvv,2125,800,33,36,69,47.8%,3m
24572,2,[火焰雷兽]豫竹方便面,2125,386,14,14,28,50.0%,4m
24572,3,[CPT]恶魔之王,2125,293,11,7,18,61.1%,1h
24572,2,[DMRe]火云邪神,2125,222,8,11,19,42.1%,9m
24572,3,暴打雨涵,2125,164,6,4,10,60.0%,1h
24572,2,铁马冰河古人,2125,170,5,7,12,41.7%,30m
24572,3,Antimatter,2125,90,4,8,12,33.3%,2m
24572,1,蛇叔斯内克,2125,139,4,10,14,28.6%,1h
24572,1,司音,2125,92,3,11,14,21.4%,49m
24572,2,menk,2125,93,2,9,11,18.2%,12m
24572,3,Levy,2125,0,1,0,1,100.0%,1h
24572,3,扣除此次年,2125,0,1,0,1,100.0%,1h
24572,2,[香肠披萨]阿里巴巴,2125,0,1,1,2,50.0%,36m
24572,3,[征服一切]伟伟大仙,2125,0,1,4,5,20.0%,18m
24572,2,Aaronken,2125,0,1,4,5,20.0%,1h
24572,2,Lagrage,2125,0,0,2,2,0.0%,34m
24572,3,大狸子,2125,0,0,2,2,0.0%,54m
24592,3,刀锋,2124,1162,43,53,96,44.8%,1h
24592,2,天下第一,2124,585,24,23,47,51.1%,1h
24592,2,霸道小伙,2124,450,19,18,37,51.4%,54m
24592,3,淼沐,2124,440,17,17,34,50.0%,51m
24592,2,塔姆坤,2124,331,13,17,30,43.3%,1h
24592,2,[爱国]破晓之浩,2124,128,4,5,9,44.4%,41m
24592,2,战神切格瓦拉,2124,130,3,8,11,27.3%,8m
24592,3,一望便是蓬州,2124,0,2,11,13,15.4%,1h
24592,3,[呦反手掏]萨克友,2124,0,1,4,5,20.0%,18m
24592,3,大泽云光,2124,0,0,2,2,0.0%,51m
24602,2,[浙江大学战队]奔跑的汽车,2123,1202,77,73,150,51.3%,57m
24602,1,夜晓鸿雁,2123,1302,54,50,104,51.9%,1h
24602,2,TIAL,2123,555,19,29,48,39.6%,1h
24602,3,打我没妈,2123,324,12,13,25,48.0%,1h
24602,1,WOWOW,2123,172,5,6,11,45.5%,2m
24602,1,战火纷飞,2123,165,4,4,8,50.0%,48m
24602,3,[哔翻天梯鸡]YangYang,2123,0,2,3,5,40.0%,23m
24602,2,蓬莱人形,2123,46,1,3,4,25.0%,8m
24602,3,[兄弟和朋友]蛮力之枭,2123,30,1,4,5,20.0%,1h
24602,2,星辰代谢,2123,0,1,7,8,12.5%,1h
24602,2,黑马王子,2123,0,0,2,2,0.0%,8m
24613,2,鑫淼,2122,802,88,96,184,47.8%,15m
24613,3,帅阿磊,2122,189,10,7,17,58.8%,1h
24613,3,AODI,2122,215,10,8,18,55.6%,47m
24613,3,老逗到此一游,2122,280,10,15,25,40.0%,1h
24613,1,[樱丘]srlre,2122,323,9,8,17,52.9%,1h
24613,2,野渡无人,2122,182,8,7,15,53.3%,54m
24613,3,[LYFANS]尚文上门,2122,180,7,7,14,50.0%,1h
24613,1,蔡徐坤,2122,206,7,9,16,43.8%,1h
24613,3,[BTD]Aventador,2122,0,0,2,2,0.0%,12m
24613,2,凤凰,2122,0,0,2,2,0.0%,15m
24613,2,ghroth,2122,0,0,2,2,0.0%,1h
24624,2,黑翼舞者,2121,1101,87,89,176,49.4%,22m
24624,2,[暗黑破坏神3]冷枫花,2121,696,25,33,58,43.1%,43m
24624,3,ATV,2121,235,23,28,51,45.1%,51m
24624,3,lifei,2121,389,14,14,28,50.0%,1h
24624,2,Maple,2121,130,5,6,11,45.5%,37m
24624,3,DANDAN,2121,0,1,4,5,20.0%,3m
24624,3,LKMKM,2121,0,1,5,6,16.7%,1h
24624,3,lengend,2121,0,0,5,5,0.0%,1h
24624,3,瞬羲平心,2121,0,0,5,5,0.0%,18m
24633,2,MrMao,2120,886,34,42,76,44.7%,1h
24633,2,[反gong军]放人的鸟,2120,558,20,24,44,45.5%,1h
24633,2,[猫猫咪咪]JackGh,2120,439,15,22,37,40.5%,1h
24633,3,assassion,2120,88,3,4,7,42.9%,1h
24633,2,有趣君,2120,0,2,5,7,28.6%,57m
24633,3,bingtian,2120,0,1,0,1,100.0%,1h
24633,3,猎物,2120,0,1,4,5,20.0%,1h
24640,2,映客,2119,1358,102,119,221,46.2%,1h
24640,3,Yang,2119,505,19,27,46,41.3%,5m
24640,3,大禹,2119,437,15,10,25,60.0%,12m
24640,2,Lyons,2119,448,13,22,35,37.1%,33m
24640,3,落空的黎明,2119,128,5,6,11,45.5%,1h
24640,2,linlin,2119,154,5,8,13,38.5%,1h
24640,2,mikilab,2119,150,5,16,21,23.8%,53m
24640,3,核爆,2119,30,1,1,2,50.0%,51m
24640,1,集结部队,2119,42,1,2,3,33.3%,43m
24640,3,Avalon,2119,0,0,1,1,0.0%,7m
24650,2,星际常胜将军,2118,806,63,72,135,46.7%,15m
24650,2,德一甲师医疗兵,2118,897,35,37,72,48.6%,53m
24650,2,[极限菜鸟]消灭消灭,2118,472,15,18,33,45.5%,7m
24650,3,你还有遗憾吗,2118,256,9,4,13,69.2%,28m
24650,3,忍尔,2118,104,4,5,9,44.4%,1h
24650,3,cyo,2118,0,4,6,10,40.0%,1h
24650,2,伊藤诚,2118,64,3,7,10,30.0%,1h
24650,2,fighting,2118,0,2,4,6,33.3%,57m
24650,2,小雪糕,2118,0,2,4,6,33.3%,1h
24650,3,[百家姓]RunSlow,2118,46,1,2,3,33.3%,1h
24650,3,thebug,2118,0,0,1,1,0.0%,3m
24661,1,德信,2117,1573,93,108,201,46.3%,36m
24661,3,[Galet]gosh,2117,1163,53,68,121,43.8%,27m
24661,3,[张三忏悔录]狂妄张三,2117,1244,50,57,107,46.7%,1h
24661,3,[彩笔]ICEblade,2117,397,16,16,32,50.0%,12m
24661,3,天下是我的,2117,210,8,9,17,47.1%,18m
24661,1,爸爸,2117,214,7,13,20,35.0%,19m
24661,1,萨拉之巅,2117,196,6,4,10,60.0%,19m
24661,2,正恒啊,2117,139,5,6,11,45.5%,45m
24661,3,[SLZ]死侍,2117,86,4,3,7,57.1%,1h
24661,2,[M8]晁宇昕,2117,156,4,6,10,40.0%,15m
24661,2,牛奶有毒,2117,194,4,10,14,28.6%,1h
24661,3,桃子缔造者,2117,30,2,0,2,100.0%,1h
24661,1,湘南老油条,2117,0,2,8,10,20.0%,4m
24661,3,精灵龙,2117,30,1,1,2,50.0%,18m
24661,2,kisslove,2117,42,1,2,3,33.3%,1h
24661,2,咕哒夫,2117,48,1,5,6,16.7%,34m
24661,3,[两只好鸡]低污染才是王道,2117,0,0,1,1,0.0%,1h
24661,3,真就只会白给,2117,0,0,5,5,0.0%,1h
24661,3,哇乐载,2117,0,0,5,5,0.0%,18m
24680,2,MaryJ,2116,440,17,25,42,40.5%,45m
24680,3,小发,2116,252,10,18,28,35.7%,51m
24680,3,[紫罗兰之都]bai,2116,256,8,3,11,72.7%,44m
24680,1,我很菜,2116,192,8,11,19,42.1%,1h
24680,2,Mxmgs,2116,235,7,12,19,36.8%,1h
24680,1,[大主教下船了]死亡那个,2116,184,4,8,12,33.3%,1h
24680,2,盖世小神猪,2116,208,4,9,13,30.8%,57m
24680,3,无处流浪,2116,30,1,1,2,50.0%,2m
24680,2,赵日天,2116,0,0,1,1,0.0%,20m
24689,2,星际拯救者,2115,903,76,74,150,50.7%,15m
24689,2,[YG2020]龑殇梦之泪,2115,920,33,38,71,46.5%,1h
24689,2,昔弦,2115,223,7,19,26,26.9%,1h
24689,1,君顾,2115,156,4,17,21,19.0%,16m
24689,3,马德华,2115,0,3,3,6,50.0%,4m
24689,2,[落魄山]西博吉,2115,0,1,1,2,50.0%,1h
24689,3,yishiyzj,2115,0,1,2,3,33.3%,45m
24689,2,cctv,2115,0,1,6,7,14.3%,48m
24697,2,不可名状的喵咪,2114,695,33,28,61,54.1%,1h
24697,3,[886]祈风,2114,360,12,16,28,42.9%,1h
24697,2,Gujo,2114,88,10,20,30,33.3%,1h
24697,3,许三世暖阳,2114,232,7,5,12,58.3%,1h
24697,3,重庆最菜,2114,58,3,0,3,100.0%,1h
24697,3,EASON,2114,94,3,7,10,30.0%,1h
24697,2,Group,2114,0,2,4,6,33.3%,48m
24697,2,咆哮的小花鸡,2114,0,1,0,1,100.0%,8m
24697,3,我是赢子,2114,30,1,2,3,33.3%,1h
24697,3,进化之主,2114,72,1,5,6,16.7%,1h
24697,3,天上天下,2114,0,0,2,2,0.0%,45m
24697,3,whaik,2114,0,0,2,2,0.0%,1h
24709,2,追风逐月,2113,503,14,25,39,35.9%,1h
24709,1,king,2113,231,11,8,19,57.9%,1h
24709,2,LJb,2113,333,10,16,26,38.5%,1h
24709,1,消逝的锋芒,2113,277,7,14,21,33.3%,1h
24709,3,[CARMYS]劫凌殇,2113,60,3,2,5,60.0%,1h
24709,2,HarryAlbs,2113,46,2,8,10,20.0%,34m
24709,2,iiiiiiiiiiii,2113,42,1,2,3,33.3%,37m
24709,3,chani,2113,0,0,1,1,0.0%,1h
24709,1,[家里有矿]灰烬使者,2113,0,0,1,1,0.0%,6m
24709,3,Gumpert,2113,0,0,1,1,0.0%,34m
24719,1,sht,2112,1535,293,309,602,48.7%,17m
24719,1,[SC2战队]强森,2112,376,47,51,98,48.0%,1h
24719,1,mnmn,2112,524,18,30,48,37.5%,54m
24719,3,三只灬松鼠,2112,401,16,17,33,48.5%,51m
24719,2,[沙巴克]bobo,2112,264,15,14,29,51.7%,1h
24719,3,hxhx,2112,114,5,2,7,71.4%,1h
24719,2,青灰一堆堆,2112,128,4,10,14,28.6%,12m
24719,3,[秋毫七队]老表白给,2112,58,3,2,5,60.0%,47m
24719,2,[Rhusky]黑皮豆奶,2112,138,2,2,4,50.0%,1h
24719,1,[闪电5连鞭]西园寺世界,2112,96,2,3,5,40.0%,1h
24719,3,一方之鹏,2112,0,1,1,2,50.0%,18m
24719,2,sasori,2112,0,1,6,7,14.3%,37m
24719,3,yhy,2112,0,0,1,1,0.0%,26m
24719,3,[舰队训练营]Ryzen,2112,0,0,2,2,0.0%,37m
24719,3,Twilight,2112,0,0,11,11,0.0%,1h
24734,1,伊莉雅酱,2111,625,44,44,88,50.0%,1h
24734,1,好的,2111,302,7,15,22,31.8%,1h
24734,2,喔喔奶糖,2111,136,5,1,6,83.3%,1h
24734,3,[浦大]KeeLimoon,2111,128,5,5,10,50.0%,1h
24734,3,自有的喵咪嗷,2111,88,4,3,7,57.1%,1h
24734,1,欧阳鸡翅,2111,97,4,6,10,40.0%,1h
24734,3,本用户不存在,2111,58,3,1,4,75.0%,54m
24734,2,Neigeblanch,2111,58,3,6,9,33.3%,15m
24734,3,DAWASF,2111,48,2,6,8,25.0%,1h
24734,2,风无敌,2111,0,0,1,1,0.0%,20m
24734,3,狂风,2111,0,0,5,5,0.0%,58m
24745,3,[极限菜鸟]雪豹周卫国,2110,1241,45,55,100,45.0%,1h
24745,2,无畏冲锋,2110,963,40,42,82,48.8%,1h
24745,2,无凡,2110,327,12,13,25,48.0%,1h
24745,2,Snake,2110,160,6,12,18,33.3%,49m
24745,2,[imnoob]sugmadic,2110,88,4,3,7,57.1%,57m
24745,2,休闲,2110,46,4,7,11,36.4%,8m
24745,3,龙的传人,2110,30,2,3,5,40.0%,58m
24745,3,小虫虫的忧伤,2110,0,0,1,1,0.0%,1h
24745,3,丹生谷森夏,2110,0,0,1,1,0.0%,1h
24745,3,JoBran,2110,0,0,5,5,0.0%,33m
24755,1,renedcj,2109,874,37,47,84,44.0%,20m
24755,2,whxue,2109,638,24,29,53,45.3%,49m
24755,3,徐子陵苗苗,2109,433,18,19,37,48.6%,1h
24755,3,我是,2109,342,15,21,36,41.7%,44m
24755,1,上古,2109,285,9,12,21,42.9%,26m
24755,3,墨与染的钢铁之花,2109,62,7,5,12,58.3%,58m
24755,3,LYB,2109,140,5,9,14,35.7%,1h
24755,3,神的孩子都在跳舞,2109,170,5,9,14,35.7%,1h
24755,3,虚空与流浪,2109,156,4,0,4,100.0%,51m
24755,2,王爷沈,2109,111,2,2,4,50.0%,57m
24755,2,[无魂之鸭]暴打狗儿,2109,116,2,5,7,28.6%,43m
24755,3,源忆梦,2109,0,0,1,1,0.0%,1h
24767,3,[白丝黑丝萝莉]风吹雪,2108,439,15,10,25,60.0%,5m
24767,2,你的队友,2108,224,7,17,24,29.2%,8m
24767,2,星海,2108,174,5,11,16,31.2%,48m
24767,1,做不了宫城良田,2108,184,4,4,8,50.0%,1h
24767,2,LADTHELSING,2108,82,4,7,11,36.4%,48m
24767,3,swear,2108,86,3,2,5,60.0%,7m
24767,2,惜缘,2108,142,2,3,5,40.0%,42m
24767,2,MONDERU,2108,0,1,6,7,14.3%,20m
24767,3,新手,2108,0,0,4,4,0.0%,19m
24767,3,nwebie,2108,0,0,5,5,0.0%,40m
24777,2,太阳宫野人,2107,1550,83,90,173,48.0%,11m
24777,1,leo,2107,690,51,58,109,46.8%,1h
24777,3,xingkong,2107,1066,43,39,82,52.4%,5m
24777,2,Galgadot,2107,965,35,44,79,44.3%,18m
24777,1,豺狼,2107,649,21,35,56,37.5%,3m
24777,3,天马座光牙,2107,117,5,5,10,50.0%,1h
24777,3,[上学威龙]帝国每月最佳劳工,2107,116,4,3,7,57.1%,26m
24777,3,秋色,2107,0,4,4,8,50.0%,18m
24777,3,[开心玩]一四级公共账号,2107,122,4,5,9,44.4%,47m
24777,3,莫言,2107,68,2,7,9,22.2%,1h
24777,3,satam,2107,0,1,0,1,100.0%,1h
24777,3,TheRock,2107,42,1,1,2,50.0%,40m
24777,1,喜洋洋,2107,46,1,6,7,14.3%,47m
24777,3,梧言,2107,0,0,2,2,0.0%,9m
24791,2,偶得,2106,408,13,24,37,35.1%,1h
24791,3,SOo,2106,114,5,2,7,71.4%,9m
24791,3,暴力公熊,2106,0,1,1,2,50.0%,1h
24791,2,War,2106,0,0,2,2,0.0%,1h
24791,3,lugg,2106,0,0,5,5,0.0%,1h
24796,3,LegendFirst,2105,174,9,9,18,50.0%,58m
24796,2,白狐,2105,88,3,4,7,42.9%,1h
24796,2,路人海,2105,92,3,9,12,25.0%,1h
24796,3,Vincent,2105,0,0,1,1,0.0%,49m
24796,3,提督的决断,2105,0,0,2,2,0.0%,9m
24801,3,[xyjxyc]芜铭,2104,686,25,37,62,40.3%,1h
24801,2,[社交学巨可爱]只有影子,2104,359,14,21,35,40.0%,1h
24801,3,潇湘魂,2104,345,12,7,19,63.2%,1h
24801,2,[152mm]曲散,2104,277,9,9,18,50.0%,22m
24801,3,人类最强毒奶,2104,166,5,4,9,55.6%,49m
24801,3,凉介,2104,173,5,13,18,27.8%,1h
24801,1,[SIE]oafloat,2104,163,4,2,6,66.7%,1h
24801,3,Neeb,2104,84,4,3,7,57.1%,1h
24801,2,IIIIIIIIIIII,2104,70,4,8,12,33.3%,9m
24801,3,艾瑞克,2104,34,2,1,3,66.7%,58m
24801,3,[TOODMI]秦宇梁,2104,60,2,3,5,40.0%,1h
24801,3,晓菟菟,2104,0,1,4,5,20.0%,18m
24801,1,黯星旅者,2104,48,1,6,7,14.3%,57m
24801,3,夜雨声烦,2104,0,0,1,1,0.0%,40m
24801,2,嘿嘿嘿,2104,0,0,4,4,0.0%,36m
24816,2,百万迷妹的化身,2103,317,14,15,29,48.3%,9m
24816,3,[XXHZN3]遥远的桥,2103,152,10,11,21,47.6%,1h
24816,3,哈哈哈,2103,214,7,11,18,38.9%,1h
24816,2,丛林友情狼,2103,60,6,5,11,54.5%,1h
24816,3,[XXHZN1]有谁共鸣,2103,144,6,6,12,50.0%,51m
24816,2,夜斗,2103,128,4,5,9,44.4%,8m
24816,3,缪岩,2103,30,2,0,2,100.0%,1h
24816,3,劈叉舰长,2103,30,1,1,2,50.0%,1h
24816,2,不乖橙,2103,0,1,2,3,33.3%,1h
24816,2,天长地久,2103,0,0,1,1,0.0%,36m
24826,2,QND,2102,1350,95,107,202,47.0%,1h
24826,2,SCBOY,2102,1003,87,88,175,49.7%,43m
24826,1,开展,2102,1192,49,61,110,44.5%,34m
24826,3,[失去理智]星际争爸,2102,786,39,37,76,51.3%,1h
24826,1,过马路的蚂蚁,2102,424,15,20,35,42.9%,16m
24826,3,锡北上将,2102,36,5,2,7,71.4%,1h
24826,3,恶魂,2102,86,3,6,9,33.3%,7m
24826,3,果果蜜糖,2102,0,2,4,6,33.3%,51m
24826,2,bujue,2102,6,2,12,14,14.3%,31m
24826,2,Careerism,2102,0,1,1,2,50.0%,12m
24826,3,风魂七一,2102,0,0,1,1,0.0%,33m
24826,3,nick,2102,0,0,2,2,0.0%,1h
24838,2,[神罚]小星星,2101,1227,44,57,101,43.6%,1h
24838,2,maomao,2101,239,9,13,22,40.9%,1h
24838,3,请喊我蛮大人,2101,0,1,1,2,50.0%,1h
24838,3,随风如雨,2101,0,0,1,1,0.0%,53m
24838,3,hmy,2101,0,0,1,1,0.0%,7m
24838,3,筱卓,2101,0,0,2,2,0.0%,1h
24844,2,Flutter,2100,904,97,115,212,45.8%,8m
24844,2,OchiaiHatsu,2100,1306,84,91,175,48.0%,1h
24844,2,Animation,2100,677,47,53,100,47.0%,1h
24844,3,月夜,2100,636,27,24,51,52.9%,54m
24844,3,[萌新求带QA]QAQ,2100,114,4,8,12,33.3%,5m
24844,2,Arima,2100,90,2,7,9,22.2%,36m
24844,1,死神,2100,94,2,8,10,20.0%,1h
24844,3,Binbin,2100,30,1,2,3,33.3%,34m
24844,3,superstart,2100,0,1,4,5,20.0%,1h
24844,3,MakeMe,2100,0,0,1,1,0.0%,40m
24844,3,啥都不懂的萌新,2100,0,0,5,5,0.0%,1h
24855,1,[XXHZN1]dfgdsfg,2099,1590,166,179,345,48.1%,37m
24855,2,白嫖老师,2099,181,16,19,35,45.7%,1h
24855,2,三五八团楚云飞,2099,386,13,25,38,34.2%,22m
24855,1,浩瀚,2099,228,8,13,21,38.1%,1h
24855,3,END,2099,208,7,15,22,31.8%,1h
24855,2,若水,2099,60,6,7,13,46.2%,1h
24855,2,粗鄙之人,2099,90,3,10,13,23.1%,37m
24855,1,变能骑士,2099,48,2,0,2,100.0%,1h
24855,2,ICE,2099,88,2,1,3,66.7%,37m
24855,2,LoveTQF,2099,48,2,3,5,40.0%,1h
24855,3,[Shawk]Keter,2099,30,1,2,3,33.3%,1h
24855,1,蜂衣,2099,0,1,8,9,11.1%,1h
24855,3,SKSKDO,2099,0,0,1,1,0.0%,1h
24855,3,霸者,2099,0,0,2,2,0.0%,23m
24855,3,[DSE]阿尔托莉雅是我妻,2099,0,0,3,3,0.0%,47m
24870,2,统筹计划,2098,1313,94,109,203,46.3%,55m
24870,3,[聚变打鸡就绪]我是树某懒,2098,320,12,7,19,63.2%,1h
24870,3,fine,2098,146,5,12,17,29.4%,1h
24870,1,LIberty,2098,167,4,10,14,28.6%,1h
24870,3,幼刀专剁柚子厨,2098,86,3,3,6,50.0%,1h
24870,3,Kenny,2098,30,1,3,4,25.0%,49m
24870,3,junjiemango,2098,40,1,6,7,14.3%,1h
24870,3,[XXHZ1]泰坦,2098,0,0,1,1,0.0%,1h
24870,2,星际争霸者,2098,0,0,3,3,0.0%,8m
24870,2,QWER,2098,0,0,3,3,0.0%,1h
24880,2,cycc,2097,911,37,42,79,46.8%,9m
24880,2,你阿妈,2097,686,27,27,54,50.0%,1h
24880,2,我即是巅峰,2097,359,16,27,43,37.2%,1h
24880,2,[第六駆逐鑑隊]LazyTitan,2097,429,14,26,40,35.0%,1h
24880,3,还是你太软,2097,332,11,15,26,42.3%,1h
24880,2,Seqc,2097,206,6,9,15,40.0%,45m
24880,3,珂教兴国,2097,62,4,4,8,50.0%,51m
24880,3,[车万同好会]konata,2097,58,3,5,8,37.5%,58m
24880,3,Jimmy,2097,36,2,5,7,28.6%,1h
24880,3,rain,2097,0,1,0,1,100.0%,26m
24880,3,[星际老嘎嘎]虚空老嘎嘎,2097,0,0,5,5,0.0%,51m
24891,2,呵呵哒,2096,200,7,13,20,35.0%,34m
24891,3,[s黑色枚瑰s]一块红布,2096,90,5,12,17,29.4%,1h
24891,2,svochina,2096,88,3,5,8,37.5%,8m
24891,2,电脑,2096,88,3,10,13,23.1%,1h
24891,3,一止,2096,0,2,3,5,40.0%,28m
24891,1,李雾月,2096,0,2,8,10,20.0%,1h
24891,1,炸天帮徐缺,2096,48,1,6,7,14.3%,39m
24891,3,[太微玉清宫]南极统天元圣天尊,2096,0,0,1,1,0.0%,40m
24891,3,jasonlu,2096,0,0,2,2,0.0%,1h
24900,3,黑手,2095,1225,51,43,94,54.3%,1h
24900,2,征服者,2095,812,48,58,106,45.3%,22m
24900,3,三分甜,2095,534,29,30,59,49.2%,1h
24900,3,何为争霸,2095,355,15,15,30,50.0%,1h
24900,2,酷酷的小禹哥哥,2095,326,14,21,35,40.0%,22m
24900,2,[Micer]surprised,2095,280,11,12,23,47.8%,1h
24900,3,天冥冥,2095,322,11,19,30,36.7%,1h
24900,3,sjj,2095,96,3,3,6,50.0%,3m
24900,3,生鱼片,2095,0,3,3,6,50.0%,51m
24900,1,啊杰,2095,90,3,4,7,42.9%,1h
24900,3,折纸我爱你,2095,46,2,4,6,33.3%,1h
24900,2,free,2095,0,1,1,2,50.0%,1h
24900,1,深海鲨,2095,0,1,10,11,9.1%,47m
24900,2,xaiyubai,2095,0,0,1,1,0.0%,1h
24914,2,挽楓,2094,873,30,42,72,41.7%,31m
24914,2,Dracula,2094,258,10,17,27,37.0%,49m
24914,3,夜色桀,2094,206,8,11,19,42.1%,48m
24914,1,[ZGA]LionelKay,2094,187,7,3,10,70.0%,39m
24914,1,红豆汤,2094,260,6,14,20,30.0%,1h
24914,2,很快就会,2094,128,4,12,16,25.0%,1h
24914,1,deadpoll,2094,97,1,6,7,14.3%,1h
24914,3,你是憨批,2094,0,1,6,7,14.3%,40m
24914,3,IIIIIIIIIIII,2094,0,0,4,4,0.0%,40m
24923,3,Gaizi,2093,1178,42,49,91,46.2%,51m
24923,3,[乱世]萌呆二哈,2093,796,42,49,91,46.2%,33m
24923,2,不冬眠的南极熊,2093,848,31,32,63,49.2%,31m
24923,2,black,2093,267,13,14,27,48.1%,15m
24923,3,密度泛函是啥,2093,136,9,10,19,47.4%,1h
24923,1,[萌新都是大佬]kilodear,2093,305,8,15,23,34.8%,41m
24923,2,[一起9]红尘灬落日,2093,84,7,6,13,53.8%,37m
24923,3,天尊,2093,176,6,8,14,42.9%,1h
24923,3,咕噜咕噜鸡,2093,128,4,5,9,44.4%,1h
24923,3,死亡之血,2093,97,1,2,3,33.3%,45m
24923,3,[王师北定]秋桐,2093,0,1,4,5,20.0%,34m
24923,3,Mrxu,2093,30,1,5,6,16.7%,40m
24923,3,紫极冰恋,2093,0,0,1,1,0.0%,1h
24923,3,郜老师,2093,0,0,5,5,0.0%,1h
24937,3,Silence,2092,891,35,29,64,54.7%,48m
24937,2,awei,2092,646,25,22,47,53.2%,1h
24937,3,詹姆斯,2092,560,22,22,44,50.0%,1h
24937,3,爱吃火锅,2092,341,14,18,32,43.8%,7m
24937,2,就叫你莫邪吧,2092,300,12,23,35,34.3%,34m
24937,1,暗影之龙,2092,275,9,6,15,60.0%,47m
24937,1,暮雪秦川,2092,351,9,16,25,36.0%,1h
24937,2,地狱之眼,2092,112,3,5,8,37.5%,48m
24937,1,柯基,2092,121,3,10,13,23.1%,23m
24937,3,stormfire,2092,58,2,3,5,40.0%,26m
24937,3,微澜止水,2092,0,2,3,5,40.0%,1h
24937,3,[要啥没啥爱咋]KILLE,2092,30,1,3,4,25.0%,1h
24937,2,哈哈,2092,0,1,6,7,14.3%,34m
24937,3,痛打落水狗,2092,0,0,1,1,0.0%,1h
24937,3,狂神,2092,0,0,1,1,0.0%,7m
24937,3,我家的猫叫叉烧,2092,0,0,1,1,0.0%,1h
24937,3,HCGUJHDF,2092,0,0,5,5,0.0%,1h
24954,2,把卡把卡罗米宏,2091,781,33,27,60,55.0%,1h
24954,3,血鹰小昊昊,2091,207,15,13,28,53.6%,1h
24954,3,狰狞武士,2091,88,4,1,5,80.0%,1h
24954,3,[暴雪三十二隊]悄悄点否折磨队友,2091,0,2,3,5,40.0%,1h
24954,2,预见未来,2091,46,2,7,9,22.2%,12m
24954,2,我老婆加藤惠,2091,42,2,8,10,20.0%,45m
24954,2,月在浮云浅处明,2091,30,1,1,2,50.0%,36m
24954,3,麦子,2091,0,1,2,3,33.3%,7m
24954,3,帕琪,2091,30,1,2,3,33.3%,48m
24954,1,白月初,2091,0,0,1,1,0.0%,47m
24964,3,mmzzhh,2090,688,36,33,69,52.2%,49m
24964,3,雷诺的爷爷,2090,372,13,14,27,48.1%,1h
24964,2,TTAS,2090,401,13,20,33,39.4%,2m
24964,3,夜雨声烦,2090,226,9,4,13,69.2%,1h
24964,3,指尖誓言,2090,200,7,7,14,50.0%,49m
24964,3,[Thpj]PrinzEugen,2090,220,6,10,16,37.5%,53m
24964,2,AMDyes,2090,143,4,1,5,80.0%,8m
24964,3,xyfdbd,2090,0,0,1,1,0.0%,1h
24964,2,日月星光,2090,0,0,2,2,0.0%,36m
24973,3,风吹鸡儿一边倒,2089,221,7,5,12,58.3%,51m
24973,2,Harry,2089,217,7,16,23,30.4%,1h
24973,2,青木,2089,139,4,7,11,36.4%,60m
24973,3,深圳市便利店联盟,2089,0,3,3,6,50.0%,40m
24973,3,[电脑黑屏]IRVING,2089,90,3,4,7,42.9%,7m
24973,2,欧阳,2089,137,2,9,11,18.2%,20m
24973,1,[WLLWX]野兽先辈,2089,0,1,1,2,50.0%,43m
24973,2,WEK,2089,73,1,5,6,16.7%,15m
24973,3,零零落落,2089,0,0,1,1,0.0%,1h
24973,1,[星灵充电宝]大林,2089,0,0,1,1,0.0%,1h
24973,3,星空下那孤独的人,2089,0,0,1,1,0.0%,51m
24973,3,zqyNB,2089,0,0,2,2,0.0%,1h
24973,3,克里斯银月,2089,0,0,2,2,0.0%,1h
24986,1,鱼朝奉,2088,324,12,11,23,52.2%,2m
24986,3,akb,2088,312,9,15,24,37.5%,26m
24986,1,呵呵呵呵,2088,268,8,15,23,34.8%,47m
24986,1,[玖天揽玥]hyc,2088,216,6,10,16,37.5%,1h
24986,1,山好共同,2088,121,4,8,12,33.3%,6m
24986,2,岁月如歌,2088,90,2,10,12,16.7%,57m
24986,3,jackly,2088,0,1,0,1,100.0%,49m
24986,3,休伯利安号舰长,2088,30,1,1,2,50.0%,1h
24986,1,[谁能教我做人]洗心革面重新做人,2088,0,0,2,2,0.0%,39m
24986,3,[秋毫七队]鬼魂之龙,2088,0,0,3,3,0.0%,1h
24996,2,玉面飞龙,2087,1232,44,51,95,46.3%,41m
24996,2,DAZHU,2087,173,7,14,21,33.3%,9m
24996,3,Yahoo,2087,140,5,5,10,50.0%,45m
24996,3,我当队友有点坑,2087,88,4,4,8,50.0%,1h
24996,2,joe,2087,131,3,4,7,42.9%,36m
24996,3,梦与现实,2087,30,2,0,2,100.0%,5m
24996,3,[CPT]神族舰队都没傻,2087,58,2,2,4,50.0%,1h
24996,3,issac,2087,0,1,1,2,50.0%,51m
24996,3,[九月授衣]houba,2087,0,0,1,1,0.0%,1h
25005,1,Sun,2086,333,9,10,19,47.4%,1h
25005,3,阿文儿,2086,116,5,6,11,45.5%,51m
25005,2,撒旦大帝,2086,141,3,8,11,27.3%,60m
25005,3,功夫不错,2086,0,1,0,1,100.0%,29m
25005,3,DarkNebula,2086,0,0,1,1,0.0%,1h
25005,1,tom,2086,0,0,4,4,0.0%,1h
25011,3,月晕星华,2085,306,13,18,31,41.9%,1h
25011,1,永远喜欢坂井泉水,2085,230,7,8,15,46.7%,1h
25011,3,扶我起来我还能送,2085,207,7,15,22,31.8%,1h
25011,3,[菜有菜的道理]关关超爱,2085,29,2,1,3,66.7%,47m
25011,3,king,2085,121,2,2,4,50.0%,50m
25011,3,[极限菜鸟]宫野志保,2085,30,2,2,4,50.0%,1h
25011,3,Silicon,2085,0,1,0,1,100.0%,45m
25011,3,[天府成都]预言,2085,32,1,1,2,50.0%,58m
25011,3,帝皇的多恩酱,2085,0,1,2,3,33.3%,53m
25011,1,sfy,2085,96,1,4,5,20.0%,48m
25011,3,坠花湮蝉戏,2085,0,0,1,1,0.0%,1h
25022,3,十二修,2084,348,11,14,25,44.0%,26m
25022,3,路明非,2084,114,7,9,16,43.8%,1h
25022,1,[DSE]醉梦前尘,2084,189,4,4,8,50.0%,1h
25022,2,QuizMaster,2084,135,3,3,6,50.0%,20m
25022,1,闸总,2084,0,3,6,9,33.3%,8m
25022,1,Moo,2084,140,3,9,12,25.0%,23m
25022,3,waitme,2084,0,2,1,3,66.7%,1h
25022,3,funnymudpea,2084,58,2,3,5,40.0%,1h
25022,2,[圣龙之翼]济南吃饭王,2084,0,1,7,8,12.5%,58m
25022,3,QAQ,2084,0,0,2,2,0.0%,1h
25022,3,狡诈恶徒,2084,0,0,4,4,0.0%,1h
25033,3,[北辰]沉默无语的探机,2083,58,3,2,5,60.0%,53m
25033,3,kurisu,2083,0,3,2,5,60.0%,1h
25033,3,啊龙,2083,30,1,1,2,50.0%,1h
25033,3,莫才法行,2083,30,1,4,5,20.0%,58m
25033,2,丶咬蛋自尽,2083,0,1,6,7,14.3%,57m
25033,2,李逍遥,2083,0,1,7,8,12.5%,1h
25033,3,天莫邪,2083,0,0,1,1,0.0%,23m
25033,2,Selendis,2083,0,0,1,1,0.0%,1h
25033,2,人生真是寂寞如雪,2083,0,0,2,2,0.0%,12m
25042,1,我只能拱手相让,2082,830,147,158,305,48.2%,30m
25042,1,[二蛋带你飞]独白,2082,470,53,75,128,41.4%,8m
25042,2,肌儿邦硬,2082,1287,51,64,115,44.3%,54m
25042,3,夜宴,2082,405,16,21,37,43.2%,1h
25042,1,[NLHR]叄点一客,2082,328,9,20,29,31.0%,1h
25042,1,没有笑点,2082,179,8,15,23,34.8%,1h
25042,3,[际你太美]空调蕉大狼,2082,0,0,1,1,0.0%,18m
25042,3,夏天云的小雪,2082,0,0,1,1,0.0%,1h
25042,3,暗黑骑士,2082,0,0,2,2,0.0%,1h
25042,3,Perflover,2082,0,0,5,5,0.0%,18m
25042,3,rehuo,2082,0,0,5,5,0.0%,1h
25053,2,登高君,2081,542,35,31,66,53.0%,1h
25053,3,伍拾贰赫兹,2081,422,34,34,68,50.0%,1h
25053,2,祁星,2081,205,6,10,16,37.5%,1h
25053,3,请叫我中路杀神,2081,60,4,12,16,25.0%,26m
25053,3,鲍之晨,2081,0,1,1,2,50.0%,40m
25053,3,异端烧不尽,2081,0,0,1,1,0.0%,40m
25053,2,哇塞,2081,0,0,2,2,0.0%,57m
25053,3,睡觉嗷,2081,0,0,5,5,0.0%,1h
25061,2,[M8]Laughingsir,2080,350,39,46,85,45.9%,1h
25061,2,沉痛的梦伤,2080,457,20,25,45,44.4%,1h
25061,3,keke,2080,302,10,18,28,35.7%,1h
25061,3,殇神,2080,110,6,11,17,35.3%,1h
25061,2,Mikaela,2080,189,5,5,10,50.0%,37m
25061,1,漂流王,2080,44,2,9,11,18.2%,1h
25061,2,[骂人]对面煞笔敢还嘴吗,2080,0,1,0,1,100.0%,12m
25061,3,皓涟夏,2080,0,1,1,2,50.0%,1h
25061,3,丨昔年丨,2080,0,1,3,4,25.0%,34m
25061,3,starbos,2080,0,1,4,5,20.0%,3m
25061,1,战恶灬善,2080,0,0,4,4,0.0%,1h
25061,3,陨龙,2080,0,0,4,4,0.0%,19m
25073,3,北慕,2079,0,1,0,1,100.0%,33m
25073,1,郎中,2079,0,1,0,1,100.0%,1h
25073,3,verygood,2079,0,0,1,1,0.0%,40m
25073,3,卢克,2079,0,0,4,4,0.0%,1h
25077,3,打不来这个游戏啊,2078,1580,473,535,1008,46.9%,4m
25077,3,DEANLIII,2078,1059,37,41,78,47.4%,1h
25077,3,aaa,2078,758,28,29,57,49.1%,1h
25077,3,hesitation,2078,424,23,9,32,71.9%,1h
25077,3,大少,2078,301,10,8,18,55.6%,1h
25077,2,暴王之宇,2078,135,6,2,8,75.0%,1h
25077,2,狼某,2078,64,4,7,11,36.4%,43m
25077,3,[白银联盟]王的力量,2078,108,3,5,8,37.5%,1h
25077,3,吃火锅的卡卡,2078,60,3,7,10,30.0%,1h
25077,3,海军大将,2078,0,2,3,5,40.0%,33m
25077,2,[云师三骚]被绿了吗,2078,0,1,2,3,33.3%,1h
25077,3,[半藏为你效命]foreversteve,2078,34,1,6,7,14.3%,40m
25077,2,必须集结部队,2078,0,0,3,3,0.0%,38m
25090,3,萌萌,2077,672,28,24,52,53.8%,1h
25090,3,战斗弱鸡,2077,313,11,6,17,64.7%,1h
25090,3,小乔迎,2077,319,10,14,24,41.7%,19m
25090,1,无敌铲子嘴,2077,339,9,17,26,34.6%,1h
25090,1,Alan,2077,94,6,11,17,35.3%,47m
25090,3,饮优,2077,170,4,2,6,66.7%,1h
25090,2,星宇,2077,42,2,8,10,20.0%,48m
25090,2,Zenith,2077,119,2,8,10,20.0%,48m
25090,1,kinghhn,2077,139,2,12,14,14.3%,1h
25090,2,哈哈没想到吧,2077,0,1,6,7,14.3%,15m
25090,3,如风,2077,38,1,7,8,12.5%,1h
25090,3,美凌格,2077,0,0,3,3,0.0%,54m
25090,3,啦啦啦啦啦啦啦,2077,0,0,5,5,0.0%,1h
25103,3,喜欢吃橘子的汤汤,2076,697,25,34,59,42.4%,1h
25103,3,秀村,2076,544,21,16,37,56.8%,1h
25103,3,菜鸡,2076,508,18,21,39,46.2%,1h
25103,3,tian,2076,408,15,16,31,48.4%,33m
25103,1,nonochen,2076,243,9,11,20,45.0%,1h
25103,2,poisonkiss,2076,130,4,11,15,26.7%,57m
25103,2,Ugin,2076,82,2,3,5,40.0%,8m
25103,3,邋遢,2076,0,0,2,2,0.0%,1h
25103,3,PAPAPA,2076,0,0,6,6,0.0%,33m
25112,3,LiquidClem,2075,376,12,15,27,44.4%,1h
25112,3,行者,2075,200,6,13,19,31.6%,1h
25112,3,Davis,2075,86,5,6,11,45.5%,1h
25112,2,星辉,2075,116,5,9,14,35.7%,1h
25112,3,ziya,2075,162,4,3,7,57.1%,53m
25112,3,Hennessy,2075,116,4,6,10,40.0%,1h
25112,2,herobrine,2075,0,1,1,2,50.0%,42m
25112,1,大切,2075,0,1,5,6,16.7%,31m
25112,2,肆玖,2075,0,0,3,3,0.0%,57m
25112,2,rkhh,2075,0,0,6,6,0.0%,1h
25122,2,[Shawk]水迪迪,2074,638,103,118,221,46.6%,1h
25122,1,星灵之遗,2074,1170,68,93,161,42.2%,5m
25122,2,Ken,2074,319,13,16,29,44.8%,15m
25122,3,我能反杀,2074,78,7,16,23,30.4%,3m
25122,1,多少刁民要害朕,2074,166,4,14,18,22.2%,51m
25122,3,[白板]快乐,2074,60,3,2,5,60.0%,3m
25122,2,LOUIS,2074,154,3,5,8,37.5%,8m
25122,3,独眼马格瓦,2074,30,2,1,3,66.7%,1h
25122,2,墨逸轩,2074,0,1,1,2,50.0%,20m
25122,3,姐夫别这样,2074,0,1,4,5,20.0%,1h
25122,3,[星际一条心]天不拘兮地不羁,2074,0,0,1,1,0.0%,51m
25122,3,Classic,2074,0,0,2,2,0.0%,45m
25122,3,帝国幽灵,2074,0,0,2,2,0.0%,1h
25122,3,从零开始玩天梯,2074,0,0,3,3,0.0%,1h
25122,3,大本钟,2074,0,0,5,5,0.0%,4m
25122,3,猪猪兰,2074,0,0,5,5,0.0%,1h
25138,2,组对偷农民哈,2073,1153,57,57,114,50.0%,1h
25138,3,瓦斯科,2073,212,7,4,11,63.6%,51m
25138,3,csw,2073,30,2,3,5,40.0%,1h
25138,2,不喜友人,2073,0,1,1,2,50.0%,38m
25138,2,SORRY,2073,0,0,1,1,0.0%,37m
25143,1,COCO,2072,276,11,25,36,30.6%,1h
25143,3,圣歌,2072,219,7,6,13,53.8%,1h
25143,3,MiracleLee,2072,62,3,4,7,42.9%,33m
25143,3,正义的伙伴,2072,58,2,3,5,40.0%,3m
25143,3,[Jimba]阿尔法,2072,0,1,0,1,100.0%,1h
25143,3,[菜有菜的道理]广告推销商,2072,0,1,0,1,100.0%,1h
25143,3,DonColt,2072,0,0,1,1,0.0%,1h
25143,3,makui,2072,0,0,3,3,0.0%,45m
25151,1,PARADOX,2071,762,26,38,64,40.6%,1h
25151,3,wang,2071,392,14,16,30,46.7%,3m
25151,1,是但求其爱,2071,259,11,11,22,50.0%,39m
25151,3,年少轻狂,2071,172,6,8,14,42.9%,1h
25151,3,gloryWang,2071,76,4,4,8,50.0%,1h
25151,2,插刀,2071,116,4,4,8,50.0%,1h
25151,2,曼殊沙华,2071,182,4,6,10,40.0%,42m
25151,1,nmsl,2071,38,4,6,10,40.0%,26m
25151,3,阿聪,2071,121,2,7,9,22.2%,45m
25151,3,[LGBOY]星际有我一人掌控,2071,30,1,3,4,25.0%,50m
25151,3,帅加,2071,0,1,5,6,16.7%,4m
25151,2,我是个菜鸟,2071,0,1,7,8,12.5%,58m
25151,3,[蓝鲸何平]buai,2071,0,0,3,3,0.0%,1h
25164,1,朝歌晚酒,2070,191,5,10,15,33.3%,19m
25164,3,turris,2070,0,3,2,5,60.0%,1h
25164,3,[幽灵ABC]绝影战魔,2070,58,2,3,5,40.0%,26m
25164,3,eazy,2070,0,1,0,1,100.0%,9m
25164,3,[二斋]牢城营丁二,2070,96,1,5,6,16.7%,23m
25164,3,[基金会]NegoreRouse,2070,0,0,1,1,0.0%,58m
25164,3,还记的夏弥吗,2070,0,0,1,1,0.0%,1h
25164,3,[暴雪养鸡场]糖醋,2070,0,0,2,2,0.0%,50m
25164,3,[乐星际灬SC]地狱犬丶猫鱼,2070,0,0,5,5,0.0%,1h
25173,1,枪尖,2069,272,28,28,56,50.0%,1h
25173,3,是你的可爱多,2069,560,21,18,39,53.8%,50m
25173,3,Sugar,2069,558,18,21,39,46.2%,34m
25173,2,hannibal,2069,261,9,10,19,47.4%,38m
25173,2,lzh,2069,283,7,12,19,36.8%,57m
25173,3,云寒,2069,194,6,2,8,75.0%,45m
25173,3,夜莺,2069,141,3,3,6,50.0%,1h
25173,2,神明降临,2069,0,1,0,1,100.0%,1h
25173,3,暗之恋,2069,0,0,1,1,0.0%,29m
25173,2,[专治格种不服]一晚一个东北妞,2069,0,0,1,1,0.0%,48m
25183,3,打不过是你自己菜,2068,1540,130,164,294,44.2%,1h
25183,3,NPCjunyu,2068,152,6,8,14,42.9%,3m
25183,3,心想事成,2068,152,6,8,14,42.9%,19m
25183,2,神庄,2068,90,4,10,14,28.6%,15m
25183,3,艾尔之光,2068,30,2,0,2,100.0%,1h
25183,3,幕云,2068,0,1,2,3,33.3%,1h
25183,3,真心玩不动了,2068,96,1,5,6,16.7%,45m
25183,2,崩坏的小梦,2068,94,1,7,8,12.5%,1h
25183,3,天下,2068,0,0,2,2,0.0%,1h
25183,3,陌陌浅浅,2068,0,0,5,5,0.0%,1h
25183,3,单行道上的旅行者,2068,0,0,6,6,0.0%,1h
25183,2,wky,2068,0,0,6,6,0.0%,1h
25195,3,孙博父,2067,754,29,35,64,45.3%,12m
25195,3,是丫丫酱呀,2067,371,13,11,24,54.2%,1h
25195,3,鸽子不炼铜,2067,233,11,16,27,40.7%,1h
25195,2,无药之竞,2067,141,6,8,14,42.9%,44m
25195,3,战无不胜攻无不克,2067,120,4,7,11,36.4%,1h
25195,2,迟早猝死在网吧,2067,86,4,8,12,33.3%,1h
25195,3,衣带沾花,2067,0,2,3,5,40.0%,1h
25195,1,Anywn,2067,96,2,9,11,18.2%,8m
25195,3,动次打次,2067,30,1,1,2,50.0%,50m
25195,3,威尼斯特安,2067,0,1,3,4,25.0%,3m
25195,2,CrossKiller,2067,0,1,3,4,25.0%,47m
25195,2,糖果,2067,0,0,1,1,0.0%,1h
25195,1,[暴雪五队]无冕,2067,0,0,1,1,0.0%,43m
25195,3,[爱国]绝望吧,2067,0,0,5,5,0.0%,52m
25209,3,无情商的自恋狂,2066,428,19,24,43,44.2%,1h
25209,3,新手刚玩,2066,169,7,4,11,63.6%,1h
25209,2,humanwasdead,2066,169,4,3,7,57.1%,42m
25209,2,[WTC]嘿嘿我最菜,2066,0,1,1,2,50.0%,1h
25209,3,新手承让,2066,0,1,5,6,16.7%,1h
25214,3,马小可,2065,234,9,9,18,50.0%,3m
25214,3,萨格拉斯,2065,172,6,12,18,33.3%,1h
25214,3,Sarek,2065,0,5,1,6,83.3%,1h
25214,2,秋沐苏,2065,127,3,9,12,25.0%,37m
25214,1,星皇,2065,48,3,10,13,23.1%,39m
25214,2,铃科百合子,2065,0,1,0,1,100.0%,1h
25214,3,mucike,2065,0,1,5,6,16.7%,1h
25214,2,蛇皮少年,2065,93,1,6,7,14.3%,1h
25214,3,[泰伦拆迁办]东风破,2065,0,0,1,1,0.0%,1h
25214,2,风花丶岁月,2065,0,0,2,2,0.0%,57m
25214,3,科崃恩,2065,0,0,2,2,0.0%,1h
25225,3,ZooNrSClavie,2064,1145,55,63,118,46.6%,1h
25225,2,ease,2064,440,15,25,40,37.5%,1h
25225,3,暴雪游戏休闲玩家,2064,335,14,2,16,87.5%,47m
25225,3,桃夭,2064,211,6,9,15,40.0%,1h
25225,2,[西中街小学]Terry,2064,228,6,10,16,37.5%,1h
25225,1,二哈的世界你不懂,2064,233,4,10,14,28.6%,1h
25225,3,贾师傅好舒服,2064,0,2,3,5,40.0%,1h
25225,3,[超实验级的]magicmarine,2064,44,2,4,6,33.3%,33m
25225,3,DXS,2064,60,2,5,7,28.6%,1h
25225,3,爱唱歌的小哥哥,2064,0,0,1,1,0.0%,1h
25225,3,谈笑风声不动情,2064,0,0,2,2,0.0%,1h
25225,3,CYH,2064,0,0,3,3,0.0%,51m
25225,3,天行者,2064,0,0,3,3,0.0%,23m
25225,3,就是就是,2064,0,0,5,5,0.0%,58m
25225,2,轩轩轩,2064,0,0,9,9,0.0%,1h
25240,2,YZT,2063,524,94,97,191,49.2%,14m
25240,3,裤裆有杀气丶,2063,403,23,25,48,47.9%,1h
25240,1,[随心所欲]tank,2063,422,15,21,36,41.7%,22m
25240,1,前程似锦,2063,305,13,10,23,56.5%,39m
25240,3,[0D]ThePassion,2063,30,2,4,6,33.3%,26m
25240,1,苍白,2063,38,2,4,6,33.3%,1h
25240,2,ghost,2063,68,2,5,7,28.6%,1h
25240,1,蜡稽玩亦,2063,0,2,9,11,18.2%,41m
25240,3,[北京幇]坦克轰死你,2063,0,1,2,3,33.3%,3m
25240,2,AVENGERFFF,2063,0,1,2,3,33.3%,1h
25240,2,[自定义大佬]老诺,2063,0,1,2,3,33.3%,1h
25240,3,求指教,2063,0,0,1,1,0.0%,1h
25240,2,星际脆皮,2063,0,0,3,3,0.0%,8m
25253,2,[XCode]PROPHET,2062,820,43,48,91,47.3%,1h
25253,3,haizerotwo,2062,772,30,32,62,48.4%,19m
25253,3,enterprise,2062,512,28,22,50,56.0%,1h
25253,3,terrenking,2062,529,22,21,43,51.2%,3m
25253,3,Zac,2062,308,10,11,21,47.6%,53m
25253,3,asme,2062,160,4,5,9,44.4%,9m
25253,1,[天子这大菜B]曼殊沙华,2062,178,4,6,10,40.0%,8m
25253,3,殇星,2062,49,3,2,5,60.0%,40m
25253,2,不会玩,2062,91,2,2,4,50.0%,57m
25253,2,超亿覆盖,2062,0,1,0,1,100.0%,59m
25253,3,时间事件,2062,96,1,1,2,50.0%,1h
25264,1,多喝热水,2061,956,53,60,113,46.9%,18m
25264,3,WSND,2061,1187,47,54,101,46.5%,1h
25264,3,红色文化,2061,396,15,18,33,45.5%,23m
25264,2,[青铜星友汇]热师傅,2061,0,3,5,8,37.5%,8m
25264,3,执政官,2061,88,3,9,12,25.0%,34m
25264,3,星际霸王,2061,97,2,1,3,66.7%,47m
25264,3,sincejuly,2061,64,2,2,4,50.0%,1h
25264,3,[整合]争端,2061,58,2,4,6,33.3%,1h
25264,3,[月之所在RI]阿狸,2061,0,0,2,2,0.0%,1h
25273,2,阿青,2060,92,3,11,14,21.4%,1h
25273,1,神之吊死,2060,140,3,15,18,16.7%,41m
25273,2,无敌阿衡,2060,46,1,4,5,20.0%,57m
25273,3,[G868G]wryl,2060,0,0,1,1,0.0%,3m
25273,3,AlphaMoMO,2060,0,0,1,1,0.0%,1h
25273,3,蔓蔓青萝,2060,0,0,2,2,0.0%,58m
25279,2,酒醉金迷小道士,2059,235,22,24,46,47.8%,50m
25279,2,银河战舰,2059,428,15,24,39,38.5%,1h
25279,3,沧桑狐妖,2059,330,12,15,27,44.4%,3m
25279,1,我爱物理,2059,245,8,10,18,44.4%,31m
25279,3,ARSO,2059,139,3,2,5,60.0%,23m
25279,2,抵制星际,2059,92,3,12,15,20.0%,1h
25279,3,柒轩,2059,95,2,0,2,100.0%,1h
25286,3,[刮痧红舰队]GoldApple,2058,768,31,21,52,59.6%,1h
25286,3,[瘾大眼瞎]大马罗,2058,308,12,19,31,38.7%,54m
25286,2,我不是渣男,2058,94,2,7,9,22.2%,1h
25286,3,世界小好星,2058,0,0,1,1,0.0%,7m
25286,3,鬼鬼老仙女,2058,0,0,1,1,0.0%,3m
25291,3,tianya,2057,463,21,22,43,48.8%,1h
25291,2,[高阶圣堂武士]幻星海,2057,541,18,30,48,37.5%,1h
25291,2,唯雨倾诚,2057,280,10,18,28,35.7%,1h
25291,3,arthas,2057,201,6,5,11,54.5%,1h
25291,1,可怜人,2057,228,6,14,20,30.0%,1h
25291,3,陈大大,2057,192,5,3,8,62.5%,1h
25291,2,ghjdfjdj,2057,116,3,3,6,50.0%,36m
25291,3,[Treasa]变态定理,2057,30,2,2,4,50.0%,51m
25291,3,[梨子酥]魔方,2057,30,1,4,5,20.0%,7m
25291,3,[瑞兽]WSLSP,2057,0,0,1,1,0.0%,1h
25301,2,Sandy,2056,1533,82,159,241,34.0%,13m
25301,3,xcyrichard,2056,634,23,22,45,51.1%,37m
25301,3,艾尔不停电,2056,417,14,12,26,53.8%,7m
25301,1,suxi,2056,189,4,14,18,22.2%,1h
25301,2,山东舰,2056,80,2,9,11,18.2%,8m
25306,2,洛德,2055,474,33,38,71,46.5%,44m
25306,3,菜鸟,2055,595,22,21,43,51.2%,54m
25306,3,人民,2055,280,10,17,27,37.0%,1h
25306,3,[暴风雨]布死甜汤,2055,168,4,5,9,44.4%,1h
25306,1,PoH,2055,165,4,11,15,26.7%,1h
25306,3,逍遥的卤蛋儿,2055,30,1,5,6,16.7%,58m
25306,2,冷千秋,2055,0,1,7,8,12.5%,34m
25306,2,[Tnice]啥搜索,2055,0,0,3,3,0.0%,1h
25306,3,东方逍遥,2055,0,0,7,7,0.0%,33m
25315,2,阿卜杜勒哈扎耶夫,2054,656,70,83,153,45.8%,1h
25315,2,辰未明,2054,700,29,36,65,44.6%,1h
25315,3,为爱出水的鱼,2054,262,8,9,17,47.1%,1h
25315,2,小汪汪,2054,124,3,7,10,30.0%,34m
25315,2,诸神之锤,2054,86,3,9,12,25.0%,1h
25315,3,十三丶苏林,2054,118,2,3,5,40.0%,45m
25315,3,虎牙奶兔,2054,0,2,3,5,40.0%,40m
25315,1,刃心,2054,120,2,5,7,28.6%,1h
25315,2,贱骨头,2054,122,2,5,7,28.6%,57m
25315,2,[北有吾王2队]你好帅,2054,0,2,6,8,25.0%,1h
25315,2,太白丶,2054,46,1,6,7,14.3%,47m
25315,2,我既是虫群,2054,0,0,2,2,0.0%,1h
25327,2,风紧扯呼,2053,973,129,144,273,47.3%,15m
25327,2,信徒,2053,678,24,37,61,39.3%,43m
25327,3,狡诈妖怪,2053,253,10,6,16,62.5%,1h
25327,3,万里云,2053,274,9,8,17,52.9%,1h
25327,2,llllllllllll,2053,130,5,12,17,29.4%,15m
25327,3,Schcuk,2053,169,4,5,9,44.4%,1h
25327,3,[华溪岛]君临天,2053,90,4,6,10,40.0%,1h
25327,3,[旺旺战士]该还不错,2053,0,0,1,1,0.0%,47m
25327,3,kitory,2053,0,0,1,1,0.0%,1h
25327,3,宇殿下,2053,0,0,6,6,0.0%,58m
25337,1,Bogus,2052,949,78,89,167,46.7%,1h
25337,2,绅士,2052,1420,51,71,122,41.8%,1h
25337,1,kevin,2052,655,22,38,60,36.7%,1h
25337,3,星际战神灬,2052,337,14,15,29,48.3%,1h
25337,3,凹凸猛干,2052,321,11,13,24,45.8%,6m
25337,3,审判从天而降,2052,245,9,10,19,47.4%,1h
25337,2,篮坛权志龙,2052,280,9,10,19,47.4%,1h
25337,3,[叽叽呱呱]追猎证明了自己,2052,195,6,4,10,60.0%,1h
25337,3,sunchaser,2052,147,3,8,11,27.3%,1h
25337,3,史诗,2052,118,2,2,4,50.0%,1h
25337,2,宙斯之劫,2052,0,2,5,7,28.6%,8m
25337,2,州重口味,2052,82,2,6,8,25.0%,20m
25337,3,唐宋元明清,2052,0,1,2,3,33.3%,34m
25337,3,狗拿耗子,2052,0,0,1,1,0.0%,1h
25337,3,[斯大林保卫战]小唐,2052,0,0,6,6,0.0%,1h
25352,3,Artaher,2051,983,60,67,127,47.2%,34m
25352,3,邻家小可爱,2051,378,13,17,30,43.3%,47m
25352,1,青霜,2051,270,10,13,23,43.5%,1h
25352,1,加列儿,2051,317,7,17,24,29.2%,1h
25352,2,空城双子,2051,171,3,6,9,33.3%,1h
25352,2,[玖天揽玥]snowant,2051,139,2,5,7,28.6%,13m
25352,3,QING,2051,78,2,8,10,20.0%,1h
25352,3,Carla,2051,0,0,1,1,0.0%,9m
25360,2,李牧,2050,1431,105,115,220,47.7%,32m
25360,3,倾酒笑苍天,2050,281,10,6,16,62.5%,1h
25360,3,血族刀锋,2050,242,8,13,21,38.1%,48m
25363,1,[慕灬小冷]烂分大师,2049,901,37,35,72,51.4%,1h
25363,2,wsxxy,2049,465,31,33,64,48.4%,1h
25363,3,有你什么事,2049,472,20,28,48,41.7%,1h
25363,2,天恒,2049,289,13,24,37,35.1%,1h
25363,3,TYTY,2049,195,8,7,15,53.3%,1h
25363,3,天真,2049,62,7,3,10,70.0%,4m
25363,2,炎龙皇子,2049,158,4,5,9,44.4%,31m
25363,1,空对空露露对路,2049,152,4,7,11,36.4%,1h
25363,2,大亮哥,2049,0,1,0,1,100.0%,38m
25363,3,[WESG决赛]Aoto,2049,34,1,5,6,16.7%,40m
25363,3,StarKiller,2049,0,0,1,1,0.0%,1h
25363,3,Donquixote,2049,0,0,5,5,0.0%,1h
25375,3,幸存者,2048,391,19,12,31,61.3%,1h
25375,2,北峰吹海,2048,92,4,10,14,28.6%,59m
25375,3,陕西院长刘陕西,2048,0,3,2,5,60.0%,1h
25375,3,[第一戦門舰隊]阿巴,2048,0,1,0,1,100.0%,40m
25375,1,残月,2048,48,1,8,9,11.1%,1h
25380,3,Siri,2047,545,21,21,42,50.0%,9m
25380,3,无名法老王,2047,348,12,9,21,57.1%,1h
25380,2,[E奶飞天]ZeroTemplar,2047,336,11,30,41,26.8%,22m
25380,2,Yosky,2047,256,7,12,19,36.8%,1h
25380,2,狼王,2047,58,3,11,14,21.4%,41m
25380,3,[wkfkz]bright,2047,0,0,1,1,0.0%,1h
25380,3,llllllllllll,2047,0,0,2,2,0.0%,53m
25387,1,是你的六六呀,2046,908,167,177,344,48.5%,1h
25387,3,zhaoe,2046,106,21,26,47,44.7%,33m
25387,3,ZER,2046,435,17,19,36,47.2%,1h
25387,3,欧尼酱,2046,166,5,2,7,71.4%,1h
25387,2,有幸陪你走余生,2046,161,5,9,14,35.7%,37m
25387,2,陌念忆惜,2046,127,3,9,12,25.0%,48m
25387,3,时间,2046,58,2,9,11,18.2%,1h
25387,3,幽灵,2046,0,0,1,1,0.0%,19m
25395,3,战神,2045,1084,40,50,90,44.4%,51m
25395,3,今天礼拜七,2045,1081,39,42,81,48.1%,51m
25395,3,阿西吧,2045,118,7,9,16,43.8%,1h
25395,3,wmy,2045,228,7,11,18,38.9%,1h
25395,2,dhgjmlm,2045,172,4,13,17,23.5%,1h
25395,3,常威,2045,153,3,8,11,27.3%,53m
25395,3,小段,2045,119,2,3,5,40.0%,1h
25395,2,LikL,2045,46,2,8,10,20.0%,37m
25395,2,Poppy,2045,62,2,10,12,16.7%,55m
25395,3,且放白鹿青崖间,2045,0,0,4,4,0.0%,1h
25405,3,打趴丶李九九,2044,1476,56,71,127,44.1%,1h
25405,1,[专业单一小组]南瓜,2044,1080,35,53,88,39.8%,54m
25405,2,Lacus,2044,302,11,17,28,39.3%,18m
25405,3,阿帕斯,2044,180,6,3,9,66.7%,6m
25405,2,起初的相遇,2044,198,6,9,15,40.0%,1h
25405,3,落幕灬君莫笑,2044,30,3,10,13,23.1%,1h
25405,3,zzyyzz,2044,115,2,2,4,50.0%,1h
25405,3,xue,2044,0,0,1,1,0.0%,45m
25405,1,零度空间,2044,0,0,3,3,0.0%,1h
25414,3,[荣耀归来]帝皇侠,2043,166,6,9,15,40.0%,1h
25414,1,Keisuke,2043,140,4,13,17,23.5%,1h
25414,3,你在教我做事啊,2043,32,3,3,6,50.0%,34m
25414,3,西天有多美,2043,121,2,3,5,40.0%,3m
25414,3,黑白,2043,0,2,11,13,15.4%,1h
25414,3,[七咕咕]归挽,2043,0,1,1,2,50.0%,1h
25414,2,HYCYZH,2043,0,1,6,7,14.3%,38m
25414,2,史子僚,2043,0,0,1,1,0.0%,47m
25414,3,chenfaqiang,2043,0,0,2,2,0.0%,33m
25414,3,KovD,2043,0,0,3,3,0.0%,29m
25424,1,淦淦,2042,264,8,16,24,33.3%,1h
25424,3,黄旭东干不死,2042,118,5,6,11,45.5%,12m
25424,3,皇之帝霸,2042,109,2,3,5,40.0%,1h
25424,3,健身卡合成符,2042,0,0,1,1,0.0%,9m
25424,3,asdfg,2042,0,0,1,1,0.0%,41m
25424,3,[荣光在等待着]Pandora,2042,0,0,3,3,0.0%,1h
25424,3,[枉凝眉]Naccy,2042,0,0,5,5,0.0%,52m
25431,2,夏布,2041,390,14,23,37,37.8%,1h
25431,3,你携秋水揽星河,2041,238,8,12,20,40.0%,58m
25431,1,弟弟,2041,288,7,15,22,31.8%,1h
25431,3,白色铃木,2041,32,6,1,7,85.7%,58m
25431,2,大花裤衩子丷,2041,90,3,6,9,33.3%,37m
25431,2,[XXHZ0]sssss,2041,90,3,11,14,21.4%,1h
25431,3,呆呆丶鼠萌,2041,42,1,6,7,14.3%,1h
25431,2,买房卖房找我,2041,0,0,4,4,0.0%,1h
25439,1,ufo,2040,1549,261,283,544,48.0%,18m
25439,3,帅气小曾,2040,1518,67,72,139,48.2%,1h
25439,3,ertw,2040,1294,52,65,117,44.4%,3m
25439,2,evail,2040,284,43,53,96,44.8%,8m
25439,3,墨菲特,2040,456,14,25,39,35.9%,1h
25439,1,神奇的蛇皮怪,2040,522,13,20,33,39.4%,32m
25439,3,酒友如影随形,2040,232,9,11,20,45.0%,1h
25439,3,奶思的杰克,2040,118,4,6,10,40.0%,1h
25439,3,jiulets,2040,136,3,3,6,50.0%,37m
25439,2,ARealRookie,2040,78,3,9,12,25.0%,60m
25439,1,诗涵,2040,84,2,1,3,66.7%,1h
25439,3,wangling,2040,0,1,0,1,100.0%,52m
25439,1,hhhhh,2040,0,1,9,10,10.0%,48m
25439,3,[M8]knightlb,2040,0,0,2,2,0.0%,33m
25453,2,[神子]lbwnb,2039,553,19,26,45,42.2%,1h
25453,3,IIIIIIIIIII,2039,234,6,52,58,10.3%,28m
25453,1,白庚辰,2039,0,1,0,1,100.0%,1h
25453,3,星辰大海,2039,0,1,2,3,33.3%,1h
25453,1,痘痘没丁丁,2039,0,1,3,4,25.0%,1h
25453,3,时弦,2039,30,1,5,6,16.7%,33m
25453,2,[咆哮魔]凌忆,2039,0,1,7,8,12.5%,8m
25453,2,诸神黄昏,2039,0,0,1,1,0.0%,20m
25453,2,留下你的人,2039,0,0,4,4,0.0%,37m
25462,3,TopJerry,2038,886,34,37,71,47.9%,1h
25462,3,耀星,2038,550,22,21,43,51.2%,58m
25462,1,cjls,2038,90,3,0,3,100.0%,1h
25462,2,威威,2038,38,2,8,10,20.0%,36m
25462,2,炭烤银鳕鱼,2038,42,2,9,11,18.2%,8m
25462,1,coliver,2038,0,0,1,1,0.0%,23m
25462,3,[FKA]jkl,2038,0,0,3,3,0.0%,33m
25462,3,jokerking,2038,0,0,6,6,0.0%,33m
25470,1,星耀,2037,828,49,54,103,47.6%,1h
25470,2,指间飞沙,2037,842,30,46,76,39.5%,1h
25470,2,海拉鲁老流氓,2037,288,9,10,19,47.4%,47m
25470,3,刻于新月之铭,2037,248,9,21,30,30.0%,1h
25470,3,水浴,2037,185,6,15,21,28.6%,1h
25470,3,战神哥哥,2037,193,5,5,10,50.0%,1h
25470,1,ACDC,2037,190,5,7,12,41.7%,3m
25470,1,[基金会]可爱的小轩轩,2037,88,3,0,3,100.0%,41m
25470,2,kala,2037,44,2,8,10,20.0%,57m
25470,1,BENNET,2037,0,0,1,1,0.0%,39m
25480,3,谁在呼叫舰队,2036,413,15,27,42,35.7%,6m
25480,3,peko,2036,112,8,4,12,66.7%,1h
25480,2,早上好,2036,84,3,10,13,23.1%,34m
25480,3,腾皇,2036,62,2,6,8,25.0%,1h
25480,1,温卿,2036,0,1,0,1,100.0%,41m
25480,1,sreuw,2036,0,0,3,3,0.0%,23m
25486,3,奥浪,2035,1010,93,121,214,43.5%,1h
25486,3,神仙,2035,331,13,15,28,46.4%,1h
25486,2,弹痕,2035,414,13,22,35,37.1%,1h
25486,3,littlebead,2035,146,3,4,7,42.9%,1h
25486,2,你不行啊,2035,48,2,2,4,50.0%,8m
25486,1,HDZYAKKO,2035,0,1,3,4,25.0%,48m
25486,3,花落情未断,2035,0,1,4,5,20.0%,1h
25493,3,江风,2034,524,43,56,99,43.4%,37m
25493,1,[底特律KAR]你的时间归我了,2034,43,2,0,2,100.0%,1h
25493,1,[STCG]haytham,2034,94,2,1,3,66.7%,7m
25493,1,银色闪光,2034,0,0,1,1,0.0%,1h
25493,3,[瘾大眼瞎]路易法,2034,0,0,2,2,0.0%,18m
25498,1,不可能打一波的,2033,232,7,13,20,35.0%,39m
25498,3,牙三,2033,112,4,7,11,36.4%,1h
25498,2,寂寞的小乐,2033,182,4,10,14,28.6%,15m
25498,1,濏少奇,2033,0,0,1,1,0.0%,1h
25498,1,[求狙击]最上启示,2033,0,0,1,1,0.0%,1h
25498,2,[美少女萬華鏡]久遠寺有珠,2033,0,0,1,1,0.0%,1h
25498,1,小白,2033,0,0,1,1,0.0%,1h
25505,2,萌新接待员,2032,867,43,46,89,48.3%,1h
25505,1,kdhfgkjoanse,2032,300,12,15,27,44.4%,5m
25505,3,战神刑天,2032,0,3,2,5,60.0%,33m
25505,2,就是一个字擦,2032,91,3,5,8,37.5%,13m
25505,1,[谐竜小污湿]ulver,2032,48,2,0,2,100.0%,19m
25505,2,黑剑三,2032,0,0,2,2,0.0%,1h
25511,2,pjwangpku,2031,642,23,34,57,40.4%,1h
25511,1,最后防线,2031,437,20,15,35,57.1%,1h
25511,3,连三月,2031,395,15,10,25,60.0%,1h
25511,2,追梦人,2031,204,5,5,10,50.0%,15m
25511,2,肉松包子,2031,137,4,7,11,36.4%,47m
25511,3,吃一百份鸡肉卷,2031,116,3,2,5,60.0%,6m
25511,3,君主埃尔梅罗,2031,0,0,2,2,0.0%,1h
25511,3,Rorka,2031,0,0,4,4,0.0%,1h
25519,1,哈哈,2030,1371,95,105,200,47.5%,3m
25519,1,一曲清风,2030,269,8,7,15,53.3%,43m
25519,2,醉丶宠珊,2030,92,5,9,14,35.7%,34m
25519,2,Kotomi,2030,236,5,14,19,26.3%,1h
25519,2,白嫖大侠,2030,149,3,2,5,60.0%,1h
25519,1,龙慕雪,2030,46,1,1,2,50.0%,1h
25519,3,人间失格,2030,38,1,6,7,14.3%,1h
25519,2,优秀乄张野迪,2030,0,1,6,7,14.3%,57m
25519,1,shy,2030,0,1,9,10,10.0%,39m
25519,3,無念,2030,0,0,1,1,0.0%,40m
25529,2,[CUGer]uwyuwdqy,2029,499,25,21,46,54.3%,1h
25529,2,星尽星绝,2029,293,11,16,27,40.7%,57m
25529,2,江湖乘舟,2029,230,9,10,19,47.4%,1h
25529,3,KOO,2029,219,7,9,16,43.8%,7m
25529,3,水木,2029,42,1,6,7,14.3%,1h
25529,2,Jack,2029,95,1,7,8,12.5%,1h
25529,2,Lovingd,2029,0,1,7,8,12.5%,1h
25529,1,xhgh,2029,0,0,1,1,0.0%,43m
25537,3,AAAA,2028,896,36,47,83,43.4%,1h
25537,3,xfskllk,2028,504,24,24,48,50.0%,1h
25537,3,[无欲则刚]武媚,2028,470,17,18,35,48.6%,1h
25537,3,莱茵哈特,2028,467,16,25,41,39.0%,12m
25537,1,DAD,2028,291,10,15,25,40.0%,20m
25537,3,[无上荣耀]Bermuda,2028,118,5,6,11,45.5%,33m
25537,3,[Aegean]Quincy,2028,152,5,9,14,35.7%,1h
25537,3,风几许,2028,126,4,8,12,33.3%,52m
25537,1,君颜未改,2028,193,4,11,15,26.7%,1h
25537,3,潇湘浮尹,2028,118,3,1,4,75.0%,1h
25537,3,童竣天,2028,36,1,8,9,11.1%,52m
25548,1,七凉,2027,254,7,3,10,70.0%,1h
25548,1,橘乃,2027,210,6,15,21,28.6%,20m
25548,3,达尤克,2027,36,3,4,7,42.9%,1h
25548,1,斗鱼丶痴情而落花,2027,145,3,10,13,23.1%,32m
25548,3,Onland,2027,66,2,8,10,20.0%,1h
25548,3,[23336]Lemon,2027,0,0,1,1,0.0%,1h
25548,1,紫泪洛墨,2027,0,0,1,1,0.0%,1h
25548,3,凋谢的尘埃,2027,0,0,1,1,0.0%,33m
25556,3,ahhh,2026,926,33,44,77,42.9%,1h
25556,1,Make,2026,298,9,17,26,34.6%,1h
25556,3,JHD,2026,154,4,4,8,50.0%,1h
25556,3,李嘉图,2026,30,4,4,8,50.0%,41m
25556,1,胜利归来,2026,124,3,3,6,50.0%,47m
25556,3,随风行,2026,0,0,1,1,0.0%,18m
25556,1,樱合丶星落,2026,0,0,1,1,0.0%,1h
25556,3,术士司马懿,2026,0,0,1,1,0.0%,1h
25556,3,渣渣,2026,0,0,5,5,0.0%,1h
25556,3,怕死的毒爆,2026,0,0,5,5,0.0%,1h
25566,2,adssad,2025,502,18,31,49,36.7%,50m
25566,1,SLKING,2025,183,6,4,10,60.0%,1h
25566,1,不莽等啥呢,2025,130,4,0,4,100.0%,1h
25566,3,Krs,2025,70,3,3,6,50.0%,1h
25566,2,巨硕之斧,2025,40,1,2,3,33.3%,1h
25566,1,DesiWim,2025,0,1,9,10,10.0%,47m
25566,3,百里如玉,2025,0,0,3,3,0.0%,19m
25573,2,小神大虫,2024,1240,95,117,212,44.8%,41m
25573,3,谁与争锋,2024,667,25,32,57,43.9%,1h
25573,3,OFE,2024,565,20,26,46,43.5%,1h
25573,3,老鹰,2024,126,6,18,24,25.0%,1h
25573,1,梦龙,2024,88,3,1,4,75.0%,7m
25573,1,东都酒馆,2024,0,1,0,1,100.0%,1h
25579,2,Miracle,2023,189,7,20,27,25.9%,1h
25579,1,碳烤皮皮虾,2023,226,5,4,9,55.6%,1h
25579,3,天羽,2023,30,3,4,7,42.9%,1h
25579,3,唐棠,2023,104,3,8,11,27.3%,1h
25579,2,雨之流溪,2023,88,2,1,3,66.7%,1h
25579,3,有昵称,2023,0,0,5,5,0.0%,52m
25585,3,[瑞兽]Anonymous,2022,599,24,27,51,47.1%,7m
25585,2,[你已经死啦]黄子钰,2022,564,19,31,50,38.0%,11m
25585,3,小杯薄荷奶绿,2022,277,10,18,28,35.7%,1h
25585,3,中单小霸王,2022,274,9,20,29,31.0%,1h
25585,3,创始人,2022,114,3,5,8,37.5%,1h
25585,2,九资河一哥,2022,139,2,5,7,28.6%,1h
25585,3,snow,2022,30,1,3,4,25.0%,1h
25585,1,孤独的伯爵远,2022,0,0,1,1,0.0%,39m
25585,3,MZB,2022,0,0,4,4,0.0%,52m
25585,2,獨狼舞步,2022,0,0,6,6,0.0%,1h
25595,2,闽商,2021,1538,62,72,134,46.3%,1h
25595,3,[菜有菜的道理]新手电脑,2021,382,46,43,89,51.7%,58m
25595,2,半个菜鸟,2021,804,28,41,69,40.6%,18m
25595,3,Tkiv,2021,315,12,20,32,37.5%,12m
25595,3,protoss,2021,168,7,12,19,36.8%,1h
25595,2,kjhoihawio,2021,172,4,10,14,28.6%,15m
25595,1,NanShen,2021,116,3,4,7,42.9%,1h
25595,2,龙岩祥安,2021,128,2,3,5,40.0%,36m
25595,3,布布,2021,62,2,3,5,40.0%,1h
25595,3,Jotaro,2021,0,1,2,3,33.3%,1h
25605,2,蔡亮,2020,1506,107,117,224,47.8%,11m
25605,3,Shark,2020,611,22,30,52,42.3%,1h
25605,3,清风流水,2020,495,19,18,37,51.4%,1h
25605,2,zhangge,2020,329,15,25,40,37.5%,3m
25605,1,墨恒,2020,436,10,21,31,32.3%,1h
25605,1,divert,2020,175,4,4,8,50.0%,1h
25605,2,刘浩宇,2020,188,4,4,8,50.0%,59m
25605,3,PPSUC,2020,34,3,7,10,30.0%,40m
25605,1,柳然,2020,0,1,0,1,100.0%,1h
25605,1,kungfupanda,2020,0,0,1,1,0.0%,41m
25615,2,亚加拉达,2019,1520,109,124,233,46.8%,25m
25615,2,IIIIIIIIIII,2019,186,5,8,13,38.5%,36m
25615,3,天帝洛,2019,80,2,3,5,40.0%,4m
25615,3,jiepeng,2019,0,0,1,1,0.0%,1h
25615,3,我假装看不见,2019,0,0,1,1,0.0%,58m
25615,3,[疼王阁]十月十日寒酥,2019,0,0,7,7,0.0%,1h
25621,3,lijia,2018,916,32,40,72,44.4%,1h
25621,1,简单的电脑,2018,435,13,18,31,41.9%,1h
25621,1,Runru,2018,260,6,2,8,75.0%,7m
25621,1,[XXHZ21]风神异族,2018,128,4,4,8,50.0%,41m
25621,3,Jacob,2018,88,2,1,3,66.7%,1h
25621,3,[暴雪二十六队]保护江西的小,2018,126,2,4,6,33.3%,1h
25621,1,[FOT]切蛋鱼,2018,0,1,0,1,100.0%,43m
25621,1,史诗之风,2018,0,1,4,5,20.0%,47m
25621,3,是御姐偏要装可爱,2018,30,1,6,7,14.3%,1h
25621,1,爸爸,2018,0,0,1,1,0.0%,1h
25631,3,洗手间风暴,2017,753,33,32,65,50.8%,1h
25631,1,筱铭,2017,551,15,17,32,46.9%,1h
25631,3,诺亚方舟,2017,92,3,6,9,33.3%,26m
25631,3,ThomaS,2017,0,0,4,4,0.0%,33m
25635,3,[白给不要钱]仙人棒棒,2016,62,4,4,8,50.0%,1h
25635,1,肆時山間景,2016,90,3,2,5,60.0%,1h
25635,3,我的虫虫不打前期,2016,66,2,3,5,40.0%,1h
25635,3,夜色,2016,0,0,1,1,0.0%,58m
25635,1,图云,2016,0,0,2,2,0.0%,47m
25640,3,有美堂暴雨,2015,302,10,21,31,32.3%,1h
25640,3,白衣凰,2015,169,5,5,10,50.0%,7m
25640,2,辉仔,2015,128,3,3,6,50.0%,1h
25640,3,戮世魔罗,2015,30,2,4,6,33.3%,1h
25640,2,llj,2015,112,2,9,11,18.2%,13m
25640,1,[暴雪家族]zhiyouzhe,2015,0,1,0,1,100.0%,1h
25640,2,gly,2015,0,1,7,8,12.5%,46m
25640,2,麒麟才子,2015,0,0,11,11,0.0%,1h
25648,2,evil,2014,1250,133,162,295,45.1%,1h
25648,2,[XXHZN2]theY,2014,456,22,32,54,40.7%,1h
25648,3,万渊,2014,361,12,16,28,42.9%,1h
25648,2,暗夜骑士,2014,294,10,9,19,52.6%,44m
25652,2,给霸霸趴下,2013,593,21,36,57,36.8%,16m
25652,1,沧海一声,2013,683,18,26,44,40.9%,39m
25652,3,咸鱼王,2013,113,2,3,5,40.0%,51m
25652,3,拥抱战斗的荣耀,2013,0,0,1,1,0.0%,1h
25652,3,小张,2013,0,0,4,4,0.0%,33m
25657,2,LANREN,2012,1154,186,213,399,46.6%,32m
25657,3,啊啊,2012,922,33,41,74,44.6%,1h
25657,1,小小强,2012,91,2,2,4,50.0%,1h
25657,2,生存,2012,0,1,2,3,33.3%,1h
25657,2,[西伯利亚土豆]kindshen,2012,38,1,3,4,25.0%,8m
25657,2,STDD,2012,0,1,7,8,12.5%,48m
25657,3,笑若扶风,2012,30,1,7,8,12.5%,1h
25657,1,Albert,2012,0,1,10,11,9.1%,7m
25665,3,jianguihao,2011,1020,43,50,93,46.2%,19m
25665,3,huza,2011,245,8,8,16,50.0%,1h
25665,3,匿名,2011,78,4,3,7,57.1%,1h
25665,3,秀啊,2011,0,2,4,6,33.3%,1h
25665,2,[一点也不好啊]aire,2011,0,0,1,1,0.0%,1h
25670,3,[权权盗肉]长安的异乡人,2010,58,6,10,16,37.5%,1h
25670,1,星辰小造化,2010,147,5,3,8,62.5%,1h
25670,1,我是战盟,2010,208,5,4,9,55.6%,1h
25670,3,单独,2010,117,2,3,5,40.0%,3m
25670,3,[OB丶]上海萌兔,2010,58,2,4,6,33.3%,1h
25670,3,翩诺惊鸿,2010,58,2,5,7,28.6%,1h
25670,3,[不讲五德]大超超,2010,74,2,8,10,20.0%,1h
25670,3,电脑,2010,0,1,0,1,100.0%,58m
25670,2,小熊宝,2010,44,1,4,5,20.0%,1h
25670,1,仰望星空,2010,0,0,1,1,0.0%,1h
25680,3,我逆天,2009,1105,55,58,113,48.7%,1h
25680,3,一念生死,2009,1011,35,43,78,44.9%,1h
25680,3,优势,2009,333,11,20,31,35.5%,1h
25680,2,Emilia,2009,116,4,13,17,23.5%,36m
25680,3,旌旗十万斩阎罗,2009,118,2,3,5,40.0%,51m
25680,2,lafee,2009,72,2,6,8,25.0%,1h
25686,3,Uperhtm,2008,78,5,7,12,41.7%,1h
25686,3,我爱吃土豆,2008,197,5,8,13,38.5%,1h
25686,1,dust,2008,40,2,1,3,66.7%,1h
25686,3,Solitude,2008,0,1,3,4,25.0%,1h
25686,3,战王,2008,0,0,1,1,0.0%,18m
25686,3,灵梦,2008,0,0,3,3,0.0%,34m
25692,3,Zexal,2007,96,6,4,10,60.0%,1h
25692,1,魔孩,2007,75,2,2,4,50.0%,57m
25692,3,辛辰,2007,0,1,0,1,100.0%,1h
25695,2,人间失格,2006,581,41,57,98,41.8%,55m
25695,2,劈里啪啦,2006,657,37,43,80,46.2%,42m
25695,1,clownking,2006,414,10,18,28,35.7%,47m
25695,3,xuzzzz,2006,300,10,20,30,33.3%,50m
25695,2,cainingluan,2006,42,1,3,4,25.0%,57m
25695,3,fire,2006,40,1,4,5,20.0%,40m
25701,3,泥劳紫,2005,881,30,43,73,41.1%,1h
25701,3,[琴筝]Shidi,2005,683,25,29,54,46.3%,9m
25701,3,九条乐,2005,156,5,6,11,45.5%,1h
25701,1,InvocatioN,2005,178,4,8,12,33.3%,1h
25701,1,DTON,2005,136,3,5,8,37.5%,1h
25706,1,Qualony,2004,576,19,23,42,45.2%,3m
25706,1,电脑,2004,214,5,6,11,45.5%,39m
25706,2,桃花醉梨花殇,2004,107,2,8,10,20.0%,48m
25706,3,丑陋躯壳,2004,30,1,6,7,14.3%,1h
25706,1,已逝的流年,2004,0,0,1,1,0.0%,1h
25706,3,[你野爹]梦幻之夜,2004,0,0,2,2,0.0%,34m
25712,1,hunter,2003,1621,400,527,927,43.1%,7m
25712,1,混沌领主,2003,492,17,34,51,33.3%,9m
25712,2,四眼,2003,397,16,29,45,35.6%,1h
25712,2,灭霸,2003,164,6,3,9,66.7%,8m
25712,3,[DSE]小沫沫酱,2003,58,5,4,9,55.6%,1h
25712,3,wyplgy,2003,94,1,3,4,25.0%,1h
25712,3,时崎狂三,2003,30,1,8,9,11.1%,47m
25712,2,WEWe,2003,0,1,8,9,11.1%,42m
25712,1,可悲的伤逝,2003,0,0,1,1,0.0%,47m
25721,3,军傲,2002,12,1,4,5,20.0%,58m
25721,2,白鸯,2002,92,1,4,5,20.0%,20m
25721,3,interesting,2002,0,0,6,6,0.0%,1h
25724,3,sky,2001,286,10,16,26,38.5%,23m
25724,1,sssgggmmm,2001,307,9,16,25,36.0%,1h
25724,1,Emperorjk,2001,114,4,3,7,57.1%,1h
25724,1,HOLY,2001,0,1,0,1,100.0%,1h
25724,3,繁华落幕,2001,38,1,9,10,10.0%,1h
25724,1,沉默的洒脱,2001,0,0,1,1,0.0%,1h
25724,3,可以拥抱松松么,2001,0,0,7,7,0.0%,33m
25731,3,海底的菠萝屋,2000,340,11,19,30,36.7%,1h
25731,3,DTpony,2000,178,7,11,18,38.9%,3m
25731,2,红秋裤,2000,136,4,6,10,40.0%,59m
25731,1,就这么拽,2000,94,3,2,5,60.0%,47m
25731,2,SKYFIRE,2000,76,3,4,7,42.9%,1h
25731,1,RYYR,2000,48,2,2,4,50.0%,5m
25731,3,花花啊,2000,0,2,3,5,40.0%,1h
25731,2,蓝色火焰,2000,46,2,6,8,25.0%,1h
25731,3,徒手拆核弹,2000,0,0,2,2,0.0%,1h
25740,2,暗裔蚊子,1999,243,8,11,19,42.1%,1h
25740,3,[牛TV]Artemis,1999,30,3,6,9,33.3%,52m
25740,3,善良的小肥肉,1999,30,2,3,5,40.0%,1h
25740,3,日火,1999,0,0,1,1,0.0%,33m
25740,3,胜天,1999,0,0,1,1,0.0%,1h
25740,3,鲁迅,1999,0,0,6,6,0.0%,1h
25746,2,源伟清蔓,1998,454,45,64,109,41.3%,44m
25746,3,相忘于江湖,1998,978,37,44,81,45.7%,45m
25746,1,相关部门,1998,221,6,5,11,54.5%,1h
25746,1,吻她腿中唇,1998,132,3,3,6,50.0%,1h
25746,1,忘念,1998,40,2,2,4,50.0%,1h
25746,2,一点不酸的柠檬,1998,0,1,2,3,33.3%,46m
25752,3,[蝎子]满眼都是狐狸,1997,326,11,22,33,33.3%,1h
25752,3,zhzalpha,1997,143,4,3,7,57.1%,3m
25752,3,墨痕丿未染,1997,58,3,5,8,37.5%,35m
25752,1,蓝宝,1997,95,2,2,4,50.0%,1h
25752,2,阿纳斯搭,1997,81,2,4,6,33.3%,38m
25752,3,妖刀,1997,60,2,7,9,22.2%,34m
25758,3,到末世再疯狂,1996,673,23,37,60,38.3%,1h
25758,3,ocean,1996,375,13,11,24,54.2%,1h
25758,1,基础天天练,1996,0,0,1,1,0.0%,20m
25761,1,趟是一种学问,1995,1114,34,37,71,47.9%,58m
25761,2,superzhou,1995,776,26,36,62,41.9%,1h
25761,3,小菜鸟,1995,487,20,23,43,46.5%,1h
25761,1,Silvaia,1995,213,7,4,11,63.6%,1h
25761,2,manzuzhiwang,1995,236,6,12,18,33.3%,48m
25761,2,随心而动,1995,126,3,5,8,37.5%,46m
25767,2,颓废与堕落,1994,904,33,46,79,41.8%,1h
25767,3,[DMRe]Laughing,1994,646,24,25,49,49.0%,29m
25767,3,qwer,1994,507,18,27,45,40.0%,1h
25767,3,GATshanguang,1994,249,14,13,27,51.9%,47m
25767,2,岁月丶星恒,1994,428,14,28,42,33.3%,18m
25767,2,蒙牛没有我牛,1994,136,4,8,12,33.3%,38m
25767,3,贪睡之熊,1994,112,3,11,14,21.4%,26m
25767,1,YanZ,1994,0,1,0,1,100.0%,58m
25767,3,cmm,1994,34,1,5,6,16.7%,1h
25767,3,吾问无为谓,1994,0,1,7,8,12.5%,1h
25777,2,ppsuc,1993,1471,72,93,165,43.6%,1h
25777,3,随缘,1993,852,27,38,65,41.5%,51m
25777,3,黑暗之主,1993,262,8,5,13,61.5%,9m
25777,3,假斯文,1993,62,2,3,5,40.0%,1h
25777,3,第五篇,1993,0,2,6,8,25.0%,58m
25777,1,无名之铭,1993,97,2,9,11,18.2%,1h
25777,1,九霄云下月阳关,1993,0,0,1,1,0.0%,1h
25777,1,杀鸡取卵,1993,0,0,15,15,0.0%,1h
25785,2,[蛋糕小分队]灬神丶血魔,1992,266,7,7,14,50.0%,20m
25785,1,[数字信号处理]Rainbow,1992,191,4,13,17,23.5%,8m
25785,1,红花山,1992,46,2,6,8,25.0%,43m
25785,3,VFoxT,1992,0,2,8,10,20.0%,34m
25785,3,疾风骤雪,1992,0,1,4,5,20.0%,1h
25785,2,输了游戏赢了你,1992,48,1,4,5,20.0%,1h
25785,3,McOoooldWang,1992,48,1,7,8,12.5%,4m
25792,1,小梵,1991,397,11,10,21,52.4%,1h
25792,3,TeRiRi,1991,322,11,17,28,39.3%,1h
25792,3,暮雪逍遥,1991,231,6,16,22,27.3%,33m
25792,3,战狼吴彦祖,1991,36,1,7,8,12.5%,33m
25792,3,mastdw,1991,0,0,1,1,0.0%,1h
25792,1,随心所欲,1991,0,0,2,2,0.0%,47m
25798,3,秋色一速,1990,645,25,36,61,41.0%,1h
25798,1,Xman,1990,265,8,18,26,30.8%,1h
25798,2,小小之怪,1990,136,3,4,7,42.9%,20m
25798,3,[miku守护]刮板机,1990,123,2,6,8,25.0%,29m
25798,3,慕容紫宸,1990,76,2,10,12,16.7%,1h
25798,2,火的本能,1990,0,0,3,3,0.0%,1h
25804,1,弑神,1989,727,19,32,51,37.3%,49m
25804,1,番薯,1989,603,18,26,44,40.9%,20m
25804,3,疯子李,1989,0,2,4,6,33.3%,1h
25804,3,塞星,1989,0,1,2,3,33.3%,18m
25804,1,小飞鼠,1989,0,0,1,1,0.0%,58m
25804,2,RAPHAEL,1989,0,0,1,1,0.0%,36m
25804,1,小白龙,1989,0,0,1,1,0.0%,1h
25811,3,zth,1988,1032,62,70,132,47.0%,1h
25811,2,Yuan,1988,467,14,28,42,33.3%,1h
25811,3,卧是尼爹,1988,0,0,5,5,0.0%,18m
25811,3,trigger,1988,0,0,6,6,0.0%,52m
25815,3,寒冬,1987,1338,75,97,172,43.6%,19m
25815,2,TheLeader,1987,501,32,51,83,38.6%,1h
25815,1,[XXHZ32]梦毒,1987,116,3,2,5,60.0%,47m
25815,1,黑宇,1987,92,3,3,6,50.0%,1h
25815,2,战神,1987,46,3,10,13,23.1%,42m
25815,1,一走一婷,1987,42,2,1,3,66.7%,1h
25815,3,zhangsan,1987,97,1,5,6,16.7%,6m
25815,1,爱猪不要理由,1987,0,0,1,1,0.0%,43m
25815,1,夜雨风声,1987,0,0,1,1,0.0%,20m
25815,3,[红发海贼团]枪炮与玫瑰,1987,0,0,6,6,0.0%,58m
25825,3,尘以,1986,1363,85,112,197,43.1%,26m
25825,2,中融,1986,717,26,32,58,44.8%,44m
25825,3,[星舰与太阳x]法艰苦艰苦,1986,317,11,17,28,39.3%,53m
25825,1,网管的兄弟,1986,0,1,0,1,100.0%,1h
25825,1,Leopard,1986,44,1,5,6,16.7%,1h
25825,3,我们一起爱,1986,0,0,7,7,0.0%,35m
25831,3,帝都,1985,205,48,66,114,42.1%,26m
25831,1,lizheqqqq,1985,174,4,5,9,44.4%,1h
25831,3,小胡子,1985,100,3,10,13,23.1%,41m
25831,2,温柔似星水,1985,169,3,11,14,21.4%,13m
25831,3,ZSBEEN,1985,0,0,2,2,0.0%,1h
25836,2,新手上路,1984,776,53,59,112,47.3%,44m
25836,3,JackieTom,1984,681,26,34,60,43.3%,1h
25836,3,wxya,1984,64,2,3,5,40.0%,1h
25836,3,沐白苏,1984,0,0,1,1,0.0%,1h
25840,2,暖暖暖暖暖,1983,961,33,45,78,42.3%,49m
25840,1,EricChen,1983,262,9,18,27,33.3%,1h
25840,2,坎坎坷坷,1983,255,6,15,21,28.6%,1h
25840,1,zumar,1983,232,5,15,20,25.0%,1h
25840,3,wdnmddb,1983,70,3,9,12,25.0%,41m
25840,2,来了老弟,1983,86,2,8,10,20.0%,1h
25840,1,thfhuty,1983,0,1,0,1,100.0%,3m
25840,2,[CyS]摩尔夸克,1983,0,1,8,9,11.1%,59m
25840,1,阿迪,1983,0,0,1,1,0.0%,1h
25849,1,梅尔维布,1982,1547,525,629,1154,45.5%,1h
25849,3,Anly,1982,583,26,39,65,40.0%,1h
25849,3,PurPleMoon,1982,568,19,29,48,39.6%,1h
25849,1,三玖天下第一,1982,330,10,6,16,62.5%,39m
25849,1,星际一号,1982,232,7,6,13,53.8%,42m
25849,1,MRKAML,1982,86,2,3,5,40.0%,1h
25849,2,deg,1982,0,1,2,3,33.3%,57m
25849,3,我是我,1982,0,0,1,1,0.0%,5m
25857,1,[M8]微恋之风,1981,1090,34,23,57,59.6%,20m
25857,2,conmoore,1981,172,5,15,20,25.0%,47m
25857,3,梓豪,1981,0,0,6,6,0.0%,1h
25860,3,霹雳神州战神,1980,1343,144,159,303,47.5%,1h
25860,1,水卜樱,1980,1154,75,112,187,40.1%,57m
25860,2,随风而止,1980,964,38,60,98,38.8%,42m
25860,1,[至尊皇朝]我带你们打,1980,518,13,12,25,52.0%,43m
25860,3,流火,1980,327,12,11,23,52.2%,1h
25860,1,山茶花爿元宵,1980,308,8,13,21,38.1%,1h
25860,2,教主,1980,194,6,12,18,33.3%,1h
25867,2,从头再来,1979,216,8,12,20,40.0%,1h
25867,1,水火枫,1979,136,3,3,6,50.0%,1h
25867,1,Neptune,1979,48,1,1,2,50.0%,1h
25867,3,黑暗天使的小秘密,1979,30,1,6,7,14.3%,48m
25867,2,逆流的时光,1979,0,1,8,9,11.1%,8m
25867,2,漓殇,1979,0,1,8,9,11.1%,48m
25867,1,HAPPY,1979,0,0,1,1,0.0%,39m
25874,1,艾尔沦陷研究者,1978,173,3,4,7,42.9%,1h
25874,2,Traviss,1978,133,3,10,13,23.1%,8m
25874,3,PsyOwl,1978,0,0,1,1,0.0%,1h
25874,3,挟天子以令诸侯,1978,0,0,7,7,0.0%,40m
25878,3,文武之道,1977,1549,172,219,391,44.0%,1h
25878,3,神之不和,1977,164,5,9,14,35.7%,7m
25878,3,nicepeng,1977,121,3,12,15,20.0%,1h
25878,1,生生不息,1977,86,2,5,7,28.6%,1h
25878,2,浩瀚之然,1977,118,2,11,13,15.4%,57m
25878,2,雷诺,1977,0,0,4,4,0.0%,36m
25884,1,chen,1976,1026,28,29,57,49.1%,1h
25884,3,绘梦,1976,667,25,34,59,42.4%,52m
25884,3,生而为人,1976,384,13,23,36,36.1%,35m
25884,3,[DMRe]FLASH,1976,231,7,7,14,50.0%,45m
25884,3,幽灵魔闫,1976,115,6,10,16,37.5%,1h
25884,2,菜啊,1976,241,6,12,18,33.3%,1h
25884,1,Ricardo,1976,92,3,2,5,60.0%,3m
25884,1,风无名,1976,88,2,4,6,33.3%,1h
25884,2,莫湫,1976,108,2,4,6,33.3%,1h
25884,3,如火焚心,1976,0,1,2,3,33.3%,1h
25884,1,[非一般的帅]Adventure,1976,0,0,1,1,0.0%,1h
25884,3,川普的忠实粉丝,1976,0,0,5,5,0.0%,1h
25896,3,投命撞,1975,223,8,19,27,29.6%,3m
25896,3,zdw,1975,30,2,1,3,66.7%,1h
25896,3,心无悔,1975,0,1,5,6,16.7%,1h
25896,1,大虾饶命,1975,0,1,9,10,10.0%,3m
25896,2,[战鸽巢群]嗷嗷,1975,0,0,1,1,0.0%,46m
25901,2,[科学养猪]llllllllllll,1974,1166,44,56,100,44.0%,42m
25901,3,阿卡四十七,1974,458,18,24,42,42.9%,1h
25901,3,XTFX,1974,364,13,19,32,40.6%,54m
25901,2,[黑桃Ace]FatDragon,1974,256,8,9,17,47.1%,1h
25901,1,晚安记得早睡,1974,46,2,0,2,100.0%,1h
25901,1,[V地狱V]分带,1974,0,0,1,1,0.0%,1h
25907,1,此生不娶,1973,959,30,35,65,46.2%,1h
25907,3,qaqaqa,1973,337,11,13,24,45.8%,1h
25907,1,农村革命根据地,1973,44,1,2,3,33.3%,1h
25907,2,阿尔伯特,1973,91,1,3,4,25.0%,20m
25911,3,RIXTON,1972,358,13,29,42,31.0%,6m
25911,1,万星之主,1972,330,10,8,18,55.6%,43m
25911,1,tiasnlij,1972,333,9,3,12,75.0%,1h
25911,2,帅人,1972,42,2,10,12,16.7%,1h
25915,3,角膜上撒胡椒粉,1971,798,34,43,77,44.2%,54m
25915,2,robgd,1971,38,2,9,11,18.2%,1h
25917,2,怎么硕呢,1970,190,10,26,36,27.8%,1h
25917,1,阿柯柯,1970,344,8,9,17,47.1%,1h
25917,1,Manifesto,1970,184,4,5,9,44.4%,1h
25917,3,来吧,1970,44,4,7,11,36.4%,1h
25917,1,[十月]楚木,1970,0,1,0,1,100.0%,20m
25917,3,佩里奇死亡舰队,1970,0,1,5,6,16.7%,52m
25923,3,淡定一点,1969,76,3,6,9,33.3%,1h
25923,2,你问皎白月空,1969,46,2,8,10,20.0%,1h
25923,1,[一只小萌新丶]蝳行蟅,1969,0,0,2,2,0.0%,8m
25923,3,huboqin,1969,0,0,2,2,0.0%,35m
25927,2,没事玩一会,1968,483,17,29,46,37.0%,15m
25927,1,鬼与归期,1968,158,4,4,8,50.0%,1h
25927,1,樱花雨,1968,0,4,6,10,40.0%,20m
25927,3,AndyLeLe,1968,0,1,0,1,100.0%,52m
25927,2,四糸乃的四糸奈,1968,0,1,4,5,20.0%,59m
25927,2,失格,1968,0,1,8,9,11.1%,60m
25933,3,龙铃,1967,922,32,38,70,45.7%,1h
25933,1,烟尘荼縻,1967,194,6,6,12,50.0%,1h
25933,3,TWOandALASKA,1967,0,2,6,8,25.0%,1h
25936,2,陈先生,1966,789,29,40,69,42.0%,57m
25936,1,[灵猫]小百事,1966,184,4,9,13,30.8%,58m
25936,1,泡泡茶壶,1966,36,2,7,9,22.2%,8m
25936,3,某电音少年,1966,30,2,7,9,22.2%,1h
25936,3,[gobee]luckyX,1966,0,1,1,2,50.0%,1h
25936,3,逐鹿星河,1966,32,1,8,9,11.1%,1h
25942,3,eSO,1965,40,1,1,2,50.0%,5m
25943,3,白夜,1964,433,42,50,92,45.7%,26m
25943,3,霸天军团,1964,484,17,30,47,36.2%,52m
25943,2,枯叶蝶,1964,90,2,0,2,100.0%,48m
25943,3,hellfire,1964,48,1,3,4,25.0%,1h
25943,1,攻主,1964,0,0,1,1,0.0%,20m
25943,1,SJHJDH,1964,0,0,1,1,0.0%,49m
25949,1,baconhhh,1963,376,9,8,17,52.9%,58m
25949,1,xcl,1963,302,8,11,19,42.1%,20m
25949,3,yaobao,1963,66,4,9,13,30.8%,35m
25949,2,亚帝,1963,88,3,12,15,20.0%,1h
25949,3,相思暮君,1963,0,1,3,4,25.0%,1h
25954,1,[F2ANB]允执厥中,1962,481,15,18,33,45.5%,1h
25954,1,VIKI,1962,575,15,19,34,44.1%,8m
25954,2,[各种混子]混子,1962,148,4,12,16,25.0%,1h
25954,1,鸟鸟,1962,44,2,12,14,14.3%,1h
25954,3,橙无虞,1962,38,1,7,8,12.5%,58m
25954,2,倧领,1962,0,1,8,9,11.1%,1h
25960,3,drem,1961,128,5,10,15,33.3%,5m
25960,1,[瀚海无双]wangce,1961,126,3,5,8,37.5%,7m
25960,3,无敌,1961,30,2,6,8,25.0%,7m
25960,1,Bilispace,1961,0,1,1,2,50.0%,1h
25964,1,SHE,1960,0,1,1,2,50.0%,47m
25965,3,dsy,1959,657,25,28,53,47.2%,1h
25965,1,[非一般的帅]vagary,1959,0,1,0,1,100.0%,1h
25965,3,星魔宙帝,1959,48,1,2,3,33.3%,35m
25965,3,APM,1959,0,0,1,1,0.0%,1h
25969,3,安东尼大木,1958,848,30,45,75,40.0%,19m
25969,3,星际神之神,1958,457,15,25,40,37.5%,7m
25969,3,colinnnnnnnn,1958,0,0,2,2,0.0%,18m
25972,3,妖梦,1957,150,7,20,27,25.9%,1h
25972,1,自由之翼,1957,116,3,8,11,27.3%,43m
25972,2,裘革马洛,1957,38,2,2,4,50.0%,8m
25972,3,woodenfish,1957,34,2,10,12,16.7%,5m
25972,1,魔方网表,1957,44,1,1,2,50.0%,39m
25972,3,瓦斯不足,1957,0,0,1,1,0.0%,1h
25972,3,Ultralisk,1957,0,0,2,2,0.0%,41m
25979,2,angelxing,1956,146,4,11,15,26.7%,57m
25980,2,理想是暴捶徐阿峰,1955,74,2,7,9,22.2%,1h
25980,3,CHPHH,1955,0,0,1,1,0.0%,1h
25980,3,求佛不如拜我,1955,0,0,2,2,0.0%,1h
25983,1,[黄金海舰队]壮士请先打我队友,1954,439,16,20,36,44.4%,1h
25983,1,IGnanan,1954,341,9,21,30,30.0%,3m
25983,2,璃茉,1954,132,4,11,15,26.7%,36m
25983,3,脏愚哥,1954,106,3,11,14,21.4%,1h
25983,2,wlskflk,1954,44,2,5,7,28.6%,34m
25983,2,[爱国]彪悍的生活,1954,0,0,1,1,0.0%,37m
25983,1,rsgegreh,1954,0,0,1,1,0.0%,1h
25983,3,别拆了快住手,1954,0,0,3,3,0.0%,40m
25983,3,mfdjgiotdhgu,1954,0,0,6,6,0.0%,52m
25992,3,没有瞎猫,1953,100,3,8,11,27.3%,1h
25992,1,将就生活,1953,46,1,4,5,20.0%,47m
25994,1,安徽小辣鸡,1952,401,12,24,36,33.3%,1h
25994,2,虫族专业户,1952,319,10,12,22,45.5%,1h
25994,1,天涯路远望卿珍重,1952,148,5,3,8,62.5%,1h
25994,1,[Mentor]牛头人猎杀者,1952,152,4,9,13,30.8%,1h
25994,2,东海戴鱼,1952,149,3,6,9,33.3%,46m
25994,2,阿顿,1952,0,1,8,9,11.1%,1h
25994,3,oneday,1952,0,0,1,1,0.0%,33m
25994,3,悔清,1952,0,0,4,4,0.0%,5m
26002,2,奔驰,1951,614,20,32,52,38.5%,49m
26002,3,哈哈你猜我是吹,1951,274,9,11,20,45.0%,1h
26002,1,星空下的传说,1951,129,3,8,11,27.3%,7m
26002,2,[嘤嘤嘤呜呜]汤姆,1951,42,1,4,5,20.0%,1h
26002,3,赤壁怀古,1951,0,0,1,1,0.0%,5m
26007,3,冰天雪树,1950,497,16,22,38,42.1%,1h
26007,3,战神刑天,1950,86,3,9,12,25.0%,38m
26007,3,miku,1950,0,0,2,2,0.0%,1h
26010,3,shunlong,1949,552,21,30,51,41.2%,7m
26010,3,[刺蛇保护协会]Pendragon,1949,254,9,9,18,50.0%,10m
26010,1,慕辰,1949,402,9,11,20,45.0%,49m
26010,1,道可缘,1949,142,3,9,12,25.0%,20m
26010,2,杨好好,1949,0,1,7,8,12.5%,8m
26015,2,我是刘德华,1948,327,8,16,24,33.3%,49m
26015,1,KWOKHOU,1948,90,2,1,3,66.7%,1h
26015,2,小河北,1948,44,2,9,11,18.2%,8m
26015,3,ZGNB,1948,30,1,3,4,25.0%,41m
26019,2,大漠孤烟,1947,713,77,82,159,48.4%,1h
26019,1,白色底片,1947,84,3,2,5,60.0%,20m
26019,3,night,1947,90,3,11,14,21.4%,52m
26019,3,飘雪的回忆,1947,0,0,1,1,0.0%,1h
26023,3,[社交学教练]克尼马,1946,0,1,4,5,20.0%,1h
26024,3,苍蝇,1945,128,5,6,11,45.5%,1h
26024,3,Dingdang,1945,196,5,11,16,31.2%,1h
26024,2,NOR,1945,206,4,8,12,33.3%,1h
26024,3,[极限菜鸟]dawn,1945,34,1,10,11,9.1%,1h
26024,1,sddddddddddd,1945,0,0,1,1,0.0%,47m
26029,1,长城,1944,422,14,18,32,43.8%,1h
26029,1,SuperChinese,1944,346,9,9,18,50.0%,1h
26029,1,卡洛斯,1944,344,8,13,21,38.1%,1h
26029,2,KeGuoHan,1944,153,3,8,11,27.3%,34m
26029,3,江湖,1944,30,1,8,9,11.1%,35m
26034,3,[咸鱼招牌]血痕,1943,532,18,33,51,35.3%,1h
26034,3,小川,1943,350,14,30,44,31.8%,3m
26034,1,ddfh,1943,221,5,2,7,71.4%,20m
26037,3,天天向上,1942,795,93,118,211,44.1%,1h
26037,1,[极限菜鸟]小车,1942,216,5,5,10,50.0%,42m
26037,2,ZDZ,1942,209,5,15,20,25.0%,57m
26037,2,[Months]花花公子,1942,44,1,11,12,8.3%,1h
26041,2,无尽的任务,1941,204,11,7,18,61.1%,1h
26041,2,欧巴,1941,128,3,4,7,42.9%,36m
26041,3,[埃蒙好可爱]芬兰人民血战毛子,1941,38,1,2,3,33.3%,1h
26041,3,[一块晶体矿]旋律空灵,1941,0,0,1,1,0.0%,1h
26041,2,ElderLiang,1941,0,0,4,4,0.0%,1h
26046,3,好感为零,1940,415,16,24,40,40.0%,1h
26046,1,[生物即是正义]别给我机会,1940,0,4,8,12,33.3%,1h
26048,2,[极限菜鸟]潜行者,1939,1397,94,119,213,44.1%,42m
26048,1,Conan,1939,594,15,22,37,40.5%,1h
26048,1,暴龙雪,1939,340,8,11,19,42.1%,1h
26051,3,猎祖,1938,0,0,1,1,0.0%,1h
26051,1,天之涯海之南,1938,0,0,2,2,0.0%,20m
26051,1,龙琳,1938,0,0,3,3,0.0%,1h
26054,1,上杉越,1937,848,22,32,54,40.7%,1h
26054,1,梦晨,1937,112,3,1,4,75.0%,1h
26054,3,超级绒毛鸡,1937,39,2,9,11,18.2%,1h
26054,3,暴锤梁某某,1937,0,0,7,7,0.0%,1h
26058,1,[万神归一]耶稣与玛丽锁,1936,268,6,9,15,40.0%,1h
26058,1,Cherry,1936,219,4,1,5,80.0%,32m
26058,2,大纲狗,1936,74,2,11,13,15.4%,1h
26058,1,一堆虫子,1936,0,1,0,1,100.0%,1h
26058,3,劫戒,1936,0,0,3,3,0.0%,41m
26063,3,风温柔的侵袭,1935,42,1,8,9,11.1%,58m
26063,3,开门暗影卫队,1935,0,0,2,2,0.0%,33m
26063,3,[CPT]绝望亚伦,1935,0,0,2,2,0.0%,1h
26066,3,久远,1934,670,23,41,64,35.9%,1h
26066,3,韩厉枫,1934,355,11,18,29,37.9%,1h
26066,3,淘气之金龟子,1934,140,5,6,11,45.5%,52m
26069,1,怡和,1932,40,1,3,4,25.0%,43m
26069,2,战神,1932,96,1,4,5,20.0%,1h
26069,3,SCPLAYER,1932,0,0,2,2,0.0%,1h
26072,1,[急救车东西]YAOANSONG,1931,134,3,3,6,50.0%,1h
26072,2,waiting,1931,0,1,6,7,14.3%,1h
26074,2,夜夜泡的茶,1930,372,23,54,77,29.9%,19m
26074,2,十八,1930,245,8,14,22,36.4%,59m
26074,1,流浪,1930,188,4,15,19,21.1%,1h
26074,1,DEIUXTHEMAX,1930,140,3,13,16,18.8%,1h
26074,1,ThomasT,1930,44,2,2,4,50.0%,1h
26074,3,James,1930,0,1,1,2,50.0%,1h
26080,3,新手上路,1929,352,15,24,39,38.5%,53m
26080,2,擎天一柱万妾尝丶,1929,150,3,8,11,27.3%,9m
26080,3,百里小沐,1929,48,2,1,3,66.7%,1h
26080,2,仙人板板,1929,94,1,1,2,50.0%,36m
26080,3,欧阳荀宇,1929,0,1,2,3,33.3%,35m
26080,3,gjst,1929,0,0,6,6,0.0%,1h
26086,2,新人求虐待,1928,567,22,37,59,37.3%,31m
26086,2,叉子保护协会,1928,125,3,5,8,37.5%,1h
26086,2,[ANI]Rommol,1928,48,2,11,13,15.4%,57m
26086,3,Domen,1928,0,1,4,5,20.0%,1h
26090,2,暗审判,1927,532,17,36,53,32.1%,1h
26090,3,柒陆伍,1927,398,14,31,45,31.1%,1h
26090,1,[29CM]西伯利亚天狼星,1927,134,4,6,10,40.0%,1h
26090,1,EarlyNine,1927,0,0,1,1,0.0%,1h
26090,3,花花村乄村长,1927,0,0,1,1,0.0%,1h
26095,3,乐言神族很菜,1926,840,36,47,83,43.4%,1h
26095,1,萌新,1926,727,33,20,53,62.3%,1h
26095,1,不会,1926,648,20,47,67,29.9%,1h
26095,1,[9星际家园9]复仇者,1926,172,5,8,13,38.5%,47m
26099,1,李宝拓,1925,585,17,27,44,38.6%,42m
26099,1,寡妇村地男人,1925,0,0,1,1,0.0%,1h
26101,3,[AVICNB]DustWind,1924,386,15,24,39,38.5%,1h
26101,1,不过,1924,284,11,16,27,40.7%,3m
26101,1,海之回环,1924,48,1,1,2,50.0%,1h
26104,3,阿西博大,1923,138,4,9,13,30.8%,1h
26105,1,vmv,1922,224,5,11,16,31.2%,5m
26105,2,陈半仙,1922,112,4,13,17,23.5%,36m
26105,2,小乐乐,1922,128,4,13,17,23.5%,47m
26105,3,[XXHZN3]工具人,1922,30,3,2,5,60.0%,33m
26105,3,wdcl,1922,58,2,3,5,40.0%,1h
26105,3,哈哈哈哈,1922,0,1,4,5,20.0%,33m
26111,3,幸福的五花肉,1921,38,3,5,8,37.5%,58m
26111,2,陪你听风,1921,102,2,3,5,40.0%,1h
26111,2,[为了核平]巅峰时刻让啊,1921,93,2,5,7,28.6%,15m
26111,3,Flutter,1921,30,1,1,2,50.0%,1h
26115,1,Metaco,1920,346,10,11,21,47.6%,1h
26115,2,我来打酱油,1920,103,2,2,4,50.0%,47m
26117,1,dsfsa,1919,452,14,11,25,56.0%,1h
26117,3,知心小白,1919,347,11,15,26,42.3%,1h
26117,3,夕阳零,1919,0,1,0,1,100.0%,58m
26117,1,历史长河向东流,1919,41,1,1,2,50.0%,43m
26117,1,kamerin,1919,0,1,3,4,25.0%,1h
26122,2,[花店]神王,1918,46,5,7,12,41.7%,1h
26122,1,[新的蜜蜂]SOS,1918,225,5,10,15,33.3%,1h
26122,1,uxkz,1918,0,1,1,2,50.0%,1h
26125,1,黑色玄衣,1916,778,21,36,57,36.8%,39m
26125,1,wen,1916,264,7,11,18,38.9%,1h
26125,3,神圣巨像,1916,0,0,2,2,0.0%,40m
26128,3,[虎牙祁铭菌]天死灵,1915,0,1,0,1,100.0%,1h
26129,3,玛尔加德,1914,708,25,41,66,37.9%,1h
26129,3,kira,1914,112,9,17,26,34.6%,1h
26129,3,用心良苦,1914,134,4,12,16,25.0%,1h
26129,1,即爱,1914,90,2,4,6,33.3%,1h
26133,1,向美,1913,130,3,7,10,30.0%,1h
26133,3,神奇的小二,1913,48,3,13,16,18.8%,1h
26133,3,暴雪停机场,1913,30,1,4,5,20.0%,1h
26136,1,风尘,1912,346,11,12,23,47.8%,1h
26136,1,亚美蝶,1912,0,1,0,1,100.0%,3m
26136,1,[高冷大神]VdacaoWdasd,1912,40,1,3,4,25.0%,1h
26136,3,孤独的九爷,1912,0,1,5,6,16.7%,19m
26140,3,satellite,1911,496,19,37,56,33.9%,46m
26140,2,luesshine,1911,331,9,31,40,22.5%,1h
26140,3,Stadan,1911,97,5,9,14,35.7%,8m
26140,2,LOGIC,1911,132,5,13,18,27.8%,46m
26140,3,[要啥没啥爱咋]斯大林格勒,1911,58,3,7,10,30.0%,1h
26140,3,[瘾大眼瞎]我也曾拥过她,1911,0,1,0,1,100.0%,1h
26140,3,罗特,1911,0,1,6,7,14.3%,1h
26147,3,puretest,1910,680,20,34,54,37.0%,1h
26147,1,Northtundra,1910,170,4,5,9,44.4%,1h
26147,2,阿飞飞和我,1910,40,2,10,12,16.7%,1h
26150,1,Hermit,1909,116,3,2,5,60.0%,1h
26150,3,格里尔斯,1909,36,3,7,10,30.0%,1h
26152,3,勿忘,1908,38,3,6,9,33.3%,33m
26152,3,JUENA,1908,0,0,1,1,0.0%,1h
26154,3,羽落,1907,745,51,74,125,40.8%,46m
26154,3,matthew,1907,139,23,28,51,45.1%,1h
26154,3,JTR,1907,171,11,25,36,30.6%,1h
26154,1,玻璃海苔,1907,283,9,16,25,36.0%,1h
26154,1,我爱平底锅,1907,310,8,20,28,28.6%,3m
26154,1,九天风湖,1907,120,3,7,10,30.0%,32m
26154,1,[这就是妹控]沉默之剑,1907,0,1,3,4,25.0%,1h
26161,2,战战,1906,1403,100,131,231,43.3%,1h
26161,2,逝风,1906,516,19,28,47,40.4%,49m
26161,1,君临,1906,0,0,1,1,0.0%,20m
26161,3,Aierbotuo,1906,0,0,10,10,0.0%,1h
26165,2,brguerbguier,1905,814,25,50,75,33.3%,1h
26165,3,Death,1905,262,8,18,26,30.8%,1h
26165,1,duyred,1905,0,0,1,1,0.0%,1h
26165,1,唏嘘的胡渣子,1905,0,0,2,2,0.0%,1h
26169,1,hoop,1904,404,13,12,25,52.0%,7m
26169,1,林丑丑,1904,84,4,3,7,57.1%,1h
26169,1,xcdhtxzs,1904,42,1,4,5,20.0%,1h
26172,1,xjw,1903,753,31,40,71,43.7%,58m
26172,3,千人,1903,843,29,46,75,38.7%,1h
26172,1,星际晓青年,1903,317,9,6,15,60.0%,1h
26172,3,元老酱,1903,30,3,15,18,16.7%,23m
26172,3,窝窝头一块钱四个,1903,68,2,1,3,66.7%,5m
26172,3,阔脚裤呼呼,1903,38,1,7,8,12.5%,5m
26178,2,库娃,1902,1360,194,234,428,45.3%,1h
26178,3,Lane,1902,0,1,1,2,50.0%,19m
26178,3,卑微小小泰伦,1902,36,1,3,4,25.0%,33m
26178,3,cry,1902,0,1,7,8,12.5%,1h
26182,1,魔域残梦,1901,423,12,24,36,33.3%,20m
26182,1,龙剑,1901,436,10,18,28,35.7%,7m
26182,3,winner,1901,0,0,5,5,0.0%,1h
26182,3,南有乔木,1901,0,0,8,8,0.0%,58m
26186,2,我是初学者,1900,219,6,5,11,54.5%,42m
26186,2,zsx,1900,125,6,11,17,35.3%,1h
26186,2,hyhyhy,1900,106,5,6,11,45.5%,8m
26186,1,Freeeeeee,1900,0,1,0,1,100.0%,1h
26186,1,坦克黄玉,1900,0,0,2,2,0.0%,58m
26191,1,Ray,1899,808,23,37,60,38.3%,3m
26191,1,LiuYanlun,1899,504,14,24,38,36.8%,32m
26191,1,Ocpre,1899,296,9,8,17,52.9%,3m
26191,3,冰霜之犬,1899,120,5,7,12,41.7%,1h
26191,1,芜湖,1899,0,1,4,5,20.0%,43m
26191,3,[黑暗王者]skyboy,1899,0,1,8,9,11.1%,41m
26191,3,王侯将相,1899,0,0,1,1,0.0%,58m
26198,1,空间魔神,1898,0,0,1,1,0.0%,49m
26199,3,remember,1897,561,25,28,53,47.2%,1h
26199,1,IIIIIIIII,1897,730,19,30,49,38.8%,5m
26199,1,站在我后面,1897,563,15,30,45,33.3%,3m
26199,2,iiiiii,1897,120,9,14,23,39.1%,1h
26199,3,尼古拉斯张三,1897,0,1,7,8,12.5%,35m
26199,1,我是黑老大,1897,0,0,2,2,0.0%,1h
26205,2,米卢猫,1896,1494,183,221,404,45.3%,16m
26205,1,Stelatin,1896,695,22,30,52,42.3%,49m
26205,2,Kingslayer,1896,201,5,9,14,35.7%,36m
26205,1,杀丶天命,1896,88,2,2,4,50.0%,1h
26205,1,华夏联盟南宮塗山,1896,46,1,1,2,50.0%,1h
26210,2,GRV,1894,130,2,10,12,16.7%,36m
26210,2,Dash,1894,0,1,9,10,10.0%,60m
26210,3,酒徒,1894,0,0,8,8,0.0%,41m
26213,3,gsfxxupeng,1893,181,5,12,17,29.4%,1h
26213,3,酒柒,1893,0,0,2,2,0.0%,1h
26213,1,最后震惊了,1893,0,0,2,2,0.0%,1h
26213,2,禾郢,1893,0,0,2,2,0.0%,13m
26217,2,清城子,1892,262,10,13,23,43.5%,9m
26217,1,排红,1892,0,1,1,2,50.0%,1h
26217,3,XAWE,1892,0,1,4,5,20.0%,1h
26220,3,哈哈,1891,86,2,3,5,40.0%,1h
26220,3,dfgghgjhk,1891,32,1,9,10,10.0%,59m
26222,2,暗杀情,1890,97,1,9,10,10.0%,13m
26223,2,杀戮之影,1889,460,15,31,46,32.6%,1h
26223,1,[Nescal]路霸,1889,294,7,21,28,25.0%,49m
26223,1,泽拉图,1889,0,1,0,1,100.0%,1h
26223,1,请叫我落红君,1889,46,1,4,5,20.0%,1h
26223,3,放学后别走,1889,30,1,10,11,9.1%,1h
26223,3,[DMRe]李教授,1889,0,0,5,5,0.0%,19m
26229,2,[薄暮之光]萌哒哒的尤迪安,1887,0,3,10,13,23.1%,1h
26229,1,WABAGAZI,1887,94,3,12,15,20.0%,1h
26229,1,Angelll,1887,80,2,7,9,22.2%,8m
26232,1,Sakura,1886,662,18,32,50,36.0%,1h
26232,3,维克多雨果,1886,0,1,1,2,50.0%,5m
26232,3,老麦昏庸,1886,0,1,3,4,25.0%,19m
26235,1,[黑暗幻想]闪亮之翼,1885,0,1,0,1,100.0%,1h
26236,1,争霸霸王,1883,504,14,28,42,33.3%,8m
26236,1,电脑非常困难,1883,296,9,6,15,60.0%,1h
26236,1,[键盘冒毒奶]三毛找托尼,1883,0,1,7,8,12.5%,43m
26236,3,Crown,1883,0,0,8,8,0.0%,1h
26240,1,只为了娱乐刀塔二,1882,994,29,40,69,42.0%,24m
26241,1,[LOHs]daniel,1881,275,8,15,23,34.8%,1h
26241,2,乐乐,1881,170,5,11,16,31.2%,20m
26241,2,怎么赢,1881,42,2,2,4,50.0%,34m
26241,2,黑麦草,1881,46,2,13,15,13.3%,60m
26245,1,ljw,1880,905,27,45,72,37.5%,1h
26245,1,开心,1880,258,6,19,25,24.0%,58m
26247,1,星空,1879,314,9,22,31,29.0%,20m
26247,1,天空鬻林,1879,164,4,9,13,30.8%,1h
26247,3,[挚爱红颜]挚爱流云,1879,30,1,2,3,33.3%,33m
26250,3,上局见过,1878,0,0,1,1,0.0%,1h
26250,2,[0D]泽拉图,1878,0,0,1,1,0.0%,1h
26252,1,许诺,1877,598,17,33,50,34.0%,5m
26253,1,卡塞尔校长,1875,226,5,13,18,27.8%,1h
26253,3,[GAGA]MMdeZD,1875,48,1,9,10,10.0%,1h
26255,3,吃瘪扑街都是我,1874,136,6,5,11,54.5%,59m
26255,2,[温柔兔公主]最帅的男人,1874,102,2,2,4,50.0%,9m
26257,1,桃喰莉莉香,1873,308,7,15,22,31.8%,1h
26257,1,Roy,1873,0,0,1,1,0.0%,1h
26257,1,杀了我吧,1873,0,0,1,1,0.0%,1h
26260,2,Greenbieber,1872,210,6,15,21,28.6%,36m
26260,2,一念驭心,1872,48,2,13,15,13.3%,60m
26260,3,修罗,1872,44,1,6,7,14.3%,1h
26260,3,[暴雪二十九队]希灵,1872,0,0,1,1,0.0%,35m
26260,3,郁子,1872,0,0,2,2,0.0%,33m
26260,3,大魔王,1872,0,0,6,6,0.0%,52m
26266,3,旭儿呀,1871,0,0,1,1,0.0%,41m
26267,2,冷锋王者,1870,310,9,30,39,23.1%,12m
26267,2,不是但是算了我的,1870,74,3,11,14,21.4%,54m
26267,3,六二六号罪犯,1870,30,1,6,7,14.3%,1h
26267,2,韩东飞,1870,0,0,11,11,0.0%,60m
26271,3,风起,1869,126,4,11,15,26.7%,35m
26272,3,奥利给,1868,92,5,8,13,38.5%,1h
26272,3,[曾经一群兔兔]切月饼不要钱,1868,0,0,3,3,0.0%,1h
26274,3,iJarmin,1867,94,6,11,17,35.3%,19m
26275,1,换世门生,1866,416,12,24,36,33.3%,1h
26276,1,子系,1865,1589,53,79,132,40.2%,1h
26276,1,虫潮,1865,538,22,16,38,57.9%,1h
26276,1,同往独归,1865,506,12,29,41,29.3%,32m
26276,3,风忆天下,1865,380,10,25,35,28.6%,19m
26276,1,北方帝国,1865,0,1,0,1,100.0%,20m
26281,1,[PTR]Mht,1864,360,9,15,24,37.5%,5m
26282,3,暴火冰雷,1863,156,7,10,17,41.2%,33m
26283,3,阿凡达,1862,0,4,1,5,80.0%,1h
26284,2,aimm,1861,88,1,4,5,20.0%,9m
26284,2,吾神韵,1861,0,0,4,4,0.0%,38m
26286,1,[仨口组]柯基,1860,279,9,21,30,30.0%,1h
26287,1,xjpfyc,1859,385,15,6,21,71.4%,47m
26288,1,失引论,1858,880,35,37,72,48.6%,20m
26288,1,元首大人,1858,350,10,16,26,38.5%,58m
26288,1,太空找手,1858,190,6,4,10,60.0%,1h
26288,3,月夜见,1858,142,4,8,12,33.3%,35m
26288,2,小白,1858,152,4,15,19,21.1%,1h
26288,1,awwudh,1858,0,1,1,2,50.0%,1h
26294,3,李鑫璐,1857,259,41,49,90,45.6%,1h
26295,3,焊接工伟哥,1856,100,3,9,12,25.0%,35m
26296,2,磨舌,1855,0,0,10,10,0.0%,36m
26297,1,句酷还以,1854,92,2,1,3,66.7%,1h
26297,3,XIAOHUA,1854,0,1,0,1,100.0%,1h
26299,1,[南京何平]罗克斯威基,1853,0,1,0,1,100.0%,1h
26300,2,创世圣帝,1852,94,1,2,3,33.3%,57m
26301,1,[飞云之上]erter,1851,160,5,6,11,45.5%,1h
26301,1,小呆呆,1851,132,4,5,9,44.4%,27m
26303,3,心云,1850,150,6,13,19,31.6%,1h
26303,3,空中劈叉的清洁工,1850,0,0,2,2,0.0%,1h
26305,1,曦辰,1849,312,10,11,21,47.6%,24m
26305,3,hopesoft,1849,96,3,9,12,25.0%,1h
26307,3,言生语,1848,0,0,4,4,0.0%,41m
26308,2,浮梦一生,1847,48,2,7,9,22.2%,1h
26308,3,fdad,1847,34,1,6,7,14.3%,1h
26308,1,[童话小镇]泛舟当歌,1847,0,0,2,2,0.0%,1h
26311,3,吴曹舰长,1846,0,0,1,1,0.0%,41m
26312,1,wangxianhuei,1845,0,0,1,1,0.0%,20m
26313,3,疑似到底,1843,886,42,58,100,42.0%,8m
26313,1,空想,1843,292,8,14,22,36.4%,1h
26313,3,黑色教团,1843,0,0,8,8,0.0%,1h
26316,2,锦瑟,1842,48,2,11,13,15.4%,47m
26317,1,陆白,1841,194,7,17,24,29.2%,58m
26318,2,Moon,1840,0,0,1,1,0.0%,36m
26319,3,卵太痒,1838,296,10,25,35,28.6%,1h
26319,3,血影,1838,152,5,14,19,26.3%,1h
26319,3,nzk,1838,100,3,6,9,33.3%,1h
26319,3,[萌王]PROBE,1838,32,2,3,5,40.0%,1h
26319,3,chenged,1838,0,2,4,6,33.3%,1h
26319,1,[以君之名]zhoushijie,1838,0,0,2,2,0.0%,5m
26325,1,阿南,1837,454,16,23,39,41.0%,49m
26325,1,Lex,1837,224,6,18,24,25.0%,5m
26325,1,[baoxue]壹分,1837,0,1,2,3,33.3%,1h
26325,3,潘厚,1837,0,1,2,3,33.3%,52m
26329,1,天天,1836,591,16,31,47,34.0%,24m
26329,3,[游戏风云OL]主宰虫群之星,1836,0,0,1,1,0.0%,1h
26331,3,蒋晓炜,1835,766,27,42,69,39.1%,8m
26331,2,[BIG联盟]灬腻魅灬,1835,304,11,17,28,39.3%,37m
26331,1,九哥行天下,1835,299,10,20,30,33.3%,1h
26334,2,IIIIIIIIIIII,1834,0,1,2,3,33.3%,9m
26335,2,眉毛凯凯,1833,138,5,16,21,23.8%,42m
26336,1,河子滨,1832,694,20,34,54,37.0%,1h
26336,1,hui,1832,650,17,25,42,40.5%,8m
26336,3,魔少,1832,0,1,0,1,100.0%,52m
26339,1,罪恶王冠,1831,177,4,3,7,57.1%,1h
26339,1,[XXHZ11]我是大圣,1831,0,0,4,4,0.0%,1h
26339,3,zysd,1831,0,0,8,8,0.0%,1h
26339,2,HappyFeet,1831,0,0,10,10,0.0%,1h
26343,1,youzi,1830,783,22,40,62,35.5%,1h
26343,3,小龍,1830,0,0,6,6,0.0%,19m
26345,3,艾欧斯,1828,46,2,11,13,15.4%,52m
26346,3,孤客,1827,0,0,7,7,0.0%,1h
26347,1,天柚柚,1826,326,10,18,28,35.7%,1h
26347,1,王小淇,1826,196,5,9,14,35.7%,1h
26347,1,恋倾心,1826,202,5,18,23,21.7%,8m
26350,1,[GLZ]流川枫,1825,226,5,16,21,23.8%,1h
26350,1,鱼儿,1825,110,3,10,13,23.1%,7m
26350,3,tzhai,1825,0,2,4,6,33.3%,5m
26350,1,晴天,1825,0,0,4,4,0.0%,1h
26354,2,[龙背上的骑兵]erhsen,1824,187,4,15,19,21.1%,34m
26354,3,yfdterhrg,1824,30,3,8,11,27.3%,34m
26354,1,大雕王,1824,42,1,5,6,16.7%,48m
26357,1,[大连理工]皮大师,1823,157,4,6,10,40.0%,1h
26358,2,凯欧布里鹏,1821,326,12,14,26,46.2%,15m
26359,2,INNOVATION,1820,1515,108,151,259,41.7%,48m
26359,1,游戏王,1820,592,22,28,50,44.0%,4m
26359,1,萧瑟无语,1820,0,0,2,2,0.0%,1h
26362,3,阿斯,1819,102,3,3,6,50.0%,1h
26363,2,周仕贤的爸爸,1818,30,2,4,6,33.3%,1h
26364,2,科技界空,1817,0,0,2,2,0.0%,1h
26365,3,Athose,1816,58,3,6,9,33.3%,1h
26365,3,救向日,1816,0,1,0,1,100.0%,1h
26367,2,沙雕烟囱一柱擎天,1814,112,5,8,13,38.5%,1h
26368,1,djs,1813,259,7,19,26,26.9%,42m
26368,1,盛春林,1813,117,3,11,14,21.4%,1h
26370,3,天叶丶,1812,383,24,47,71,33.8%,1h
26371,3,夏洛克哥,1811,68,2,11,13,15.4%,1h
26372,2,又是一个小宝贝,1810,123,3,12,15,20.0%,60m
26373,2,战龙,1809,394,12,33,45,26.7%,55m
26374,3,Sword,1807,86,3,3,6,50.0%,41m
26375,2,madfrogfov,1806,1085,208,265,473,44.0%,1h
26375,3,MAN,1806,72,3,8,11,27.3%,52m
26375,3,給個機會吧,1806,0,1,7,8,12.5%,1h
26378,2,夜礼服假面,1805,0,0,1,1,0.0%,36m
26379,2,yuhua,1804,100,7,19,26,26.9%,1h
26379,2,大萨达奥多,1804,118,5,17,22,22.7%,37m
26379,2,[桜公馆]傲娇的蓝莓,1804,101,4,7,11,36.4%,1h
26382,1,FKsoon,1803,390,14,20,34,41.2%,40m
26382,3,臣服或毁灭,1803,337,13,26,39,33.3%,52m
26382,1,[XYFANS]识花认雪,1803,280,8,22,30,26.7%,20m
26382,1,点点,1803,0,0,3,3,0.0%,1h
26386,2,枕流,1801,153,3,15,18,16.7%,37m
26387,3,inori,1799,36,1,7,8,12.5%,52m
26388,3,奶嘴,1798,0,2,5,7,28.6%,1h
26388,2,战斗天使,1798,0,1,9,10,10.0%,36m
26390,1,无聊的闪电,1796,44,1,6,7,14.3%,8m
26391,3,爱吃,1794,98,3,12,15,20.0%,35m
26392,1,[哭笑脸]李现明,1792,278,11,16,27,40.7%,24m
26392,3,Alitalia,1792,60,2,12,14,14.3%,1h
26394,1,trhuqq,1791,136,2,9,11,18.2%,1h
26395,1,我为狂三上王者,1787,362,8,19,27,29.6%,1h
26395,1,SNN,1787,310,7,22,29,24.1%,1h
26397,1,辣椒恶魔,1785,1824,154,229,383,40.2%,1h
26397,2,[小小熊]轻松熊的逆袭,1785,30,1,1,2,50.0%,1h
26397,2,wcxssg,1785,0,0,2,2,0.0%,57m
26400,3,RobiN,1783,0,2,9,11,18.2%,41m
26401,2,史诗之,1781,1031,32,62,94,34.0%,1h
26402,3,Morrison,1780,0,0,3,3,0.0%,1h
26403,2,longzai,1779,108,4,16,20,20.0%,1h
26404,1,大虾,1778,732,20,42,62,32.3%,1h
26404,3,天启,1778,46,1,11,12,8.3%,1h
26406,1,[LOHv]钢铁元,1777,631,18,29,47,38.3%,24m
26406,2,aaa,1777,0,1,12,13,7.7%,8m
26408,3,[梨花与浅月]浅月落幽,1775,0,0,5,5,0.0%,41m
26409,3,[CPT]法海老儿毁我童年,1771,0,1,0,1,100.0%,52m
26409,2,[丢丢神明]zonker,1771,0,0,1,1,0.0%,1h
26411,3,二进制,1770,0,0,3,3,0.0%,19m
26412,3,敖德萨,1768,176,9,12,21,42.9%,34m
26413,2,终结蝉王,1766,176,5,8,13,38.5%,1h
26413,3,爱你如今的容颜,1766,0,0,2,2,0.0%,19m
26415,3,血雨探花,1765,30,2,1,3,66.7%,35m
26416,1,虔诚寒冰,1763,677,18,38,56,32.1%,1h
26417,3,但丁,1761,0,1,6,7,14.3%,1h
26418,2,吴璐璐,1759,86,3,6,9,33.3%,1h
26419,3,诗方长,1755,30,1,2,3,33.3%,41m
26419,3,玉龙,1755,0,0,2,2,0.0%,5m
26421,2,必有奇策,1753,0,1,0,1,100.0%,35m
26422,1,鸡儿炸了,1751,652,20,47,67,29.9%,47m
26423,1,梦食,1750,758,21,47,68,30.9%,1h
26423,3,SKIPPER,1750,132,4,12,16,25.0%,1h
26425,1,呃呃呃,1748,437,15,17,32,46.9%,1h
26425,3,爱乄武君,1748,34,2,2,4,50.0%,1h
26427,1,hbx,1746,566,18,34,52,34.6%,1h
26427,2,leavers,1746,48,1,1,2,50.0%,1h
26429,3,泣虚凰,1744,30,2,10,12,16.7%,1h
26429,3,LDRSSR,1744,0,1,10,11,9.1%,1h
26429,3,Thor,1744,0,0,8,8,0.0%,52m
26432,1,聚鑫缘,1742,439,14,33,47,29.8%,4m
26432,2,答案不唯一,1742,44,2,14,16,12.5%,35m
26434,1,Genie,1736,154,6,14,20,30.0%,20m
26434,3,光之晨曦,1736,0,1,7,8,12.5%,1h
26436,2,不落之翼,1735,0,1,0,1,100.0%,38m
26437,1,战天下,1734,408,10,24,34,29.4%,1h
26438,3,[教我玩神族]医生姐姐来啦,1733,0,0,1,1,0.0%,1h
26439,2,HOHOHOHO,1731,252,8,15,23,34.8%,13m
26439,3,superboy,1731,0,1,6,7,14.3%,1h
26441,3,ndfghdfg,1730,156,5,12,17,29.4%,1h
26442,2,感受自由,1728,870,32,44,76,42.1%,57m
26443,3,你看不见我,1726,0,0,4,4,0.0%,5m
26444,1,漫步者,1725,419,11,28,39,28.2%,1h
26445,2,[啊这阿巴]笨八八寄生体,1724,0,0,1,1,0.0%,57m
26445,2,jeff,1724,0,0,1,1,0.0%,1h
26447,2,燥动不安,1721,196,6,12,18,33.3%,1h
26448,3,路风,1720,78,2,6,8,25.0%,1h
26449,3,Hknsg,1714,0,0,2,2,0.0%,1h
26450,2,曙鸦,1713,0,0,1,1,0.0%,9m
26451,2,专打不要脸族,1710,218,6,4,10,60.0%,21m
26452,2,疯狂聪聪,1708,0,0,13,13,0.0%,60m
26453,2,xxxxxx,1707,0,1,4,5,20.0%,36m
26454,2,套马的汉子,1706,113,8,9,17,47.1%,1h
26455,2,帅霖,1705,201,7,4,11,63.6%,1h
26455,3,凌烟阁第一层,1705,0,0,1,1,0.0%,1h
26455,3,[无情突变王]守护,1705,0,0,5,5,0.0%,1h
26458,3,马骏,1704,0,0,1,1,0.0%,35m
26459,3,小苹果,1698,112,27,58,85,31.8%,49m
26459,2,[北极光小组]taouds,1698,0,0,1,1,0.0%,1h
26461,2,狙击,1697,508,16,27,43,37.2%,1h
26461,3,冷血动物,1697,178,6,17,23,26.1%,5m
26463,2,君莫笑,1696,129,2,11,13,15.4%,1h
26464,3,Jacques,1692,208,9,14,23,39.1%,1h
26465,3,中二领主高建国,1691,138,5,12,17,29.4%,1h
26466,3,降临者,1689,0,1,4,5,20.0%,1h
26467,3,[我们的年代记]Crytallized,1675,0,1,0,1,100.0%,1h
26468,1,Patrick,1673,713,32,68,100,32.0%,1h
26468,3,KHJ,1673,0,0,10,10,0.0%,1h
26470,3,[Cry丶]鳖憋补刀美如画,1669,0,0,1,1,0.0%,1h
26471,3,从零开始玩星际,1668,0,3,2,5,60.0%,1h
26472,1,RAIN,1658,1467,62,92,154,40.3%,20m
26473,3,狂战风暴,1648,180,8,13,21,38.1%,1h
26474,3,zozhifeng,1645,0,0,15,15,0.0%,41m
26475,2,jxy,1642,238,7,25,32,21.9%,60m
26476,3,ETGH,1634,0,4,1,5,80.0%,34m
26477,2,huige,1632,452,14,32,46,30.4%,1h
26478,3,Sony,1629,0,0,1,1,0.0%,1h
26479,1,PlayerHDGS,1627,940,23,58,81,28.4%,20m
26480,2,打死你个龟儿子,1612,812,25,51,76,32.9%,38m
26481,3,[JAXOLA]伍德,1607,0,0,1,1,0.0%,5m
26482,2,YCPetch,1605,100,4,10,14,28.6%,47m
26483,3,tao,1604,18,1,16,17,5.9%,1h
26484,3,aaa,1583,90,7,2,9,77.8%,5m
26485,3,白九,1569,406,14,24,38,36.8%,5m
26486,3,Death,1545,88,4,9,13,30.8%,1h
26486,3,外号非对称选手,1545,66,3,10,13,23.1%,1h
26488,3,敛余生,1541,0,0,5,5,0.0%,5m
26489,3,TIMBA,1506,0,0,6,6,0.0%,1h
26490,3,简单粗暴,1499,70,3,1,4,75.0%,5m
26491,1,shui,1495,1298,62,113,175,35.4%,1h
26492,3,[慢手e族]太子,1471,0,0,1,1,0.0%,41m
26493,3,旧爱难挡,1467,90,3,16,19,15.8%,41m
26494,1,GCU,1466,1054,55,126,181,30.4%,31m
26495,3,zzg,1333,0,1,0,1,100.0%,35m
26496,3,[C17079]PluKevin,1319,0,0,1,1,0.0%,52m
26497,3,痛苦的温暖,1075,0,0,1,1,0.0%,1h
26498,3,铁血锦衣卫,994,335,159,276,435,36.6%,10m
26499,3,黄旭东,978,0,0,1,1,0.0%,1h
26500,3,[圣歌团]寒潮冻死啦,933,0,0,2,2,0.0%,35m
26501,3,HRC,815,0,0,1,1,0.0%,52m
26502,3,[专治炸鱼狗]你不开心我就开心,206,18,1,6,7,14.3%,1h
