rank,tier,name,mmr,points,wins,losses,played,winrate,age
1,1,[GGGSC2]Cyan,5925,378,9,2,11,81.8%,18m
2,1,OGNotail,5327,354,9,0,9,100.0%,14m
3,1,雅雅国国王王雅雅,5303,0,4,3,7,57.1%,21m
4,1,[Rhusky]Poseidon,5273,0,4,1,5,80.0%,14m
5,1,旁白白,5249,0,1,0,1,100.0%,7m
6,1,[黄漫老师]香风和泉,5210,142,4,2,6,66.7%,13m
6,1,IIIIIIIIIIII,5210,46,2,0,2,100.0%,27m
8,1,llllllllllll,5163,73,3,2,5,60.0%,2m
9,1,专业抬棺团队,5162,0,3,2,5,60.0%,54m
10,1,不讲武德,5123,404,8,8,16,50.0%,22m
11,1,[星际鸽子组]铝离子,5103,1296,56,38,94,59.6%,2m
12,1,[祝暴雪倒闭]llllllllllll,5098,73,2,3,5,40.0%,2m
13,1,救赎,5072,0,0,1,1,0.0%,7m
14,2,[ZJU]Daydreamer,5071,0,2,3,5,40.0%,10m
15,1,[YMET]Shiro,5065,606,14,16,30,46.7%,7m
16,1,[Thpj]泡泡小纯,5049,0,1,0,1,100.0%,55m
17,1,苏州孙一峰,5040,92,4,3,7,57.1%,16m
18,1,[TPoA]全都是等号,5038,178,5,8,13,38.5%,18m
19,1,[Rhusky]苏梦梦,5010,118,6,0,6,100.0%,2m
20,1,[小狐狸真可爱]睡不醒的栗子喵,4956,0,2,3,5,40.0%,16m
21,1,[金灿灿狙击队]神速偷鸡,4952,419,17,13,30,56.7%,2m
21,1,[NavyF]isenguard,4952,48,1,1,2,50.0%,55m
23,1,[有投行推叫我]Ange,4935,0,0,3,3,0.0%,54m
24,1,运气是我实力全部,4934,48,2,1,3,66.7%,14m
25,1,㞺㞺㞺㞺㞺㞺㞺㞺,4902,934,37,28,65,56.9%,7m
26,1,[Beasty]Maru,4895,0,0,1,1,0.0%,50m
27,3,爱神,4877,0,1,0,1,100.0%,2m
28,1,llllllllllll,4853,180,4,5,9,44.4%,13m
29,1,[人族是我爹]仲夏夜粉丝,4831,674,18,12,30,60.0%,14m
30,1,[羊驼羊驼羊]AbyssApostl,4829,0,0,1,1,0.0%,50m
31,1,[封弊者]三世,4827,0,1,0,1,100.0%,18m
32,1,[大佬请把鞋给]君心可晴,4826,124,3,5,8,37.5%,18m
33,3,[Solo]Lifestyle,4825,0,0,5,5,0.0%,25m
34,1,[NT]DraCula,4823,898,34,22,56,60.7%,18m
34,1,高阶圣堂武士,4823,12,5,1,6,83.3%,14m
36,3,小顾顾,4800,0,2,0,2,100.0%,24m
37,3,[6点准时下班]郑老头,4788,0,1,0,1,100.0%,8m
38,1,Eustace,4787,466,24,6,30,80.0%,2m
39,1,[KPG]事件视界,4784,867,34,24,58,58.6%,18m
40,1,[混元太极星际]MagicTerran,4760,0,0,2,2,0.0%,14m
41,1,[KPG]大爱许单言,4753,139,6,3,9,66.7%,16m
42,1,[享受星际]南工大旋风解放王,4748,2661,165,140,305,54.1%,22m
42,3,[Solo]nEOiMAGING,4748,0,0,1,1,0.0%,8m
44,2,[BGD]繁星,4745,203,11,6,17,64.7%,27m
45,1,jianhao,4741,0,1,2,3,33.3%,26m
46,1,[Ogier]JOJO,4726,82,3,0,3,100.0%,55m
47,1,榕江小子,4720,0,0,1,1,0.0%,54m
48,1,[SLTHHH]SADFANS,4708,314,12,5,17,70.6%,19m
49,3,[高樂集团]JackSparrow,4705,48,2,2,4,50.0%,52m
50,3,人类,4701,0,1,1,2,50.0%,2m
51,1,[赌怪]东京孙一峰,4687,514,27,9,36,75.0%,16m
52,1,[千痔王]金山孙一峰,4684,0,1,0,1,100.0%,55m
53,1,[Shawk]国家级运动员,4680,0,0,1,1,0.0%,14m
54,1,IIIIIIIIIIII,4679,46,1,1,2,50.0%,55m
55,1,[SK]Gloriam,4669,374,43,40,83,51.8%,18m
56,1,ssssssssssss,4664,2804,223,211,434,51.4%,27m
57,3,[星河气象学院]谁狗谁孙子,4662,0,1,0,1,100.0%,8m
58,1,[SK]超高校级的泰伦,4661,0,1,2,3,33.3%,18m
59,1,[SoloAs]xsslqdz,4657,180,8,5,13,61.5%,27m
60,1,[四叶草]wwww,4649,92,6,5,11,54.5%,16m
61,1,[OLY]Invincible,4647,44,2,0,2,100.0%,55m
61,3,www,4647,0,1,1,2,50.0%,14m
63,3,[Kiloli]锉刀绫濑,4644,0,0,1,1,0.0%,20m
64,1,[RSTAR]STAR,4640,391,13,7,20,65.0%,55m
65,1,[妙手回春]Dreamhaven,4637,126,3,1,4,75.0%,55m
66,3,[很萌日很新]王英俊,4632,0,0,1,1,0.0%,21m
67,1,迷迷糊糊的孩子,4620,441,13,12,25,52.0%,27m
68,1,男同竟是所有人呢,4619,169,2,43,45,4.4%,22m
69,1,弧光灯,4615,0,1,4,5,20.0%,1m
70,3,TOTO,4614,97,2,0,2,100.0%,21m
71,1,二一六,4607,0,0,1,1,0.0%,55m
72,1,罪天使,4600,0,1,0,1,100.0%,53m
73,1,[SCAP]llllllllllll,4589,330,12,12,24,50.0%,14m
74,1,修地堡单矿一波,4584,0,1,1,2,50.0%,13m
75,1,夜幕冬至,4583,575,25,20,45,55.6%,22m
76,3,[Rhusky]IceLin,4578,24,1,6,7,14.3%,20m
77,1,灰冬,4576,2871,235,243,478,49.2%,22m
78,1,丨丨丨丨丨丨丨丨,4567,0,0,2,2,0.0%,7m
79,1,[湖南大学]掠影,4564,1460,55,56,111,49.5%,14m
80,1,[帅得不行的]喵先生,4563,130,6,2,8,75.0%,18m
81,1,[威震天下]Bumblebee,4562,600,22,21,43,51.2%,55m
81,1,[练出来了协会]recO,4562,0,4,1,5,80.0%,2m
81,1,[星选组]暴雪的爹,4562,0,0,1,1,0.0%,18m
84,3,NADA,4559,121,2,2,4,50.0%,25m
85,1,InnoVation,4555,88,2,4,6,33.3%,18m
85,1,[Hist]HistOG,4555,0,0,1,1,0.0%,53m
87,2,[七咕咕]Linus,4545,102,4,1,5,80.0%,5m
87,1,[喂了虫群]TilinZuokana,4545,0,1,0,1,100.0%,51m
89,1,[上海大学]白筑慕,4525,48,3,2,5,60.0%,53m
90,2,[雨何时会停]Akiha,4524,603,19,14,33,57.6%,27m
91,1,[miku守护]御神夜,4516,0,1,0,1,100.0%,17m
92,1,[白给的神]动作指导,4512,106,3,7,10,30.0%,19m
93,2,[青娱乐]假装小迷妹的尼酱,4509,0,0,1,1,0.0%,10m
94,2,[保国尾汁酱]SarreL,4492,18,1,3,4,25.0%,10m
95,2,llllllllllll,4489,0,0,1,1,0.0%,5m
96,2,[肉鸡的饲养]魔法少女猫猫酱,4481,0,0,1,1,0.0%,50m
97,1,[浪啊浪]忘记你需要多久,4475,0,1,0,1,100.0%,22m
98,2,llllllllllll,4466,198,9,8,17,52.9%,26m
99,2,FrankieSuper,4465,156,6,3,9,66.7%,27m
100,2,[寡妇雷就无敌]MagicWang,4452,398,19,11,30,63.3%,27m
101,2,老年人不讲武德,4450,0,1,0,1,100.0%,5m
102,2,[FsA]LuckySon,4436,38,2,1,3,66.7%,5m
103,2,[星之公主]天之川绮罗,4435,0,1,4,5,20.0%,10m
104,1,狙击司令二号,4434,96,3,0,3,100.0%,10m
105,2,llllllllllll,4430,915,53,34,87,60.9%,50m
106,2,[MGT谐星会]Strongest,4423,0,1,0,1,100.0%,10m
107,1,一纸水与青,4419,0,0,1,1,0.0%,1m
108,3,[A灬shOw]preDiLeCtion,4418,145,4,1,5,80.0%,7m
109,2,[加油大魔王]阿尔菲丶妃儿,4408,276,13,11,24,54.2%,15m
110,2,二筒,4407,0,0,1,1,0.0%,27m
111,2,IIIIIIIIIIII,4406,77,3,3,6,50.0%,8m
112,2,[我们是无敌的]我是球霸,4405,0,0,2,2,0.0%,5m
113,2,[SK]暴雪我是你爹,4400,0,0,1,1,0.0%,27m
114,2,[我们是无敌的]纵横熊猫,4398,104,4,9,13,30.8%,55m
115,2,[威震天下]Aoney,4382,0,0,1,1,0.0%,55m
116,2,在遇见你一次也好,4378,0,5,0,5,100.0%,15m
117,1,[卡吧基佬]洋葱,4375,0,3,3,6,50.0%,49m
117,1,[韩宗快乐屋]Azrael,4375,0,0,1,1,0.0%,1m
119,2,[Mi0]红莲的劫火,4372,14,1,4,5,20.0%,26m
120,2,恶魔史莱姆,4364,190,7,13,20,35.0%,10m
121,2,比那名居包子,4350,0,1,0,1,100.0%,3m
122,3,LLLLLLLLL,4349,122,2,6,8,25.0%,7m
123,2,[学习使我快乐]Artanis,4348,310,12,12,24,50.0%,8m
124,1,香港属于祖国,4336,36,2,8,10,20.0%,22m
125,3,lulu,4334,38,4,4,8,50.0%,7m
126,3,[Ogier]猪肥自有刀来迎,4327,20,2,1,3,66.7%,13m
127,3,[HTW]张学友,4320,12,2,2,4,50.0%,24m
128,2,FallenSakura,4318,0,0,1,1,0.0%,7m
129,1,[TuiELF]猫喜欢吉良,4315,264,9,4,13,69.2%,9m
130,3,吟风弄月,4310,148,17,9,26,65.4%,14m
131,3,困难,4307,18,5,4,9,55.6%,14m
132,3,Flash,4306,0,0,1,1,0.0%,14m
133,2,[好多小兔兔]MIB,4302,363,14,17,31,45.2%,27m
134,2,[金灿灿狙击队]你尽然不知道黑哥,4301,616,30,13,43,69.8%,10m
135,2,IIIIIIIIIIII,4298,0,1,0,1,100.0%,10m
136,2,IIIIlllIIIll,4297,38,3,3,6,50.0%,20m
137,1,lllllllllll,4296,0,0,4,4,0.0%,9m
138,3,[六芒星s]GGG,4295,82,9,6,15,60.0%,21m
139,3,[燕大SC]llllllllll,4290,504,27,15,42,64.3%,51m
139,2,[唯爱彦神]战巡舰掌柜,4290,0,1,4,5,20.0%,11m
141,1,IIIIIIIIIIII,4284,2589,494,511,1005,49.2%,22m
141,3,[六芒星s]CarolMalus,4284,0,1,3,4,25.0%,8m
143,3,满堂花醉三千客,4277,678,36,12,48,75.0%,24m
144,3,[IMRTS]Locke,4275,74,8,12,20,40.0%,14m
145,3,[star星]城市化的缔造者,4274,14,2,3,5,40.0%,7m
146,3,[RIKE]Fredierike,4271,0,0,1,1,0.0%,24m
147,3,Skip,4270,0,1,0,1,100.0%,29m
148,2,lllllllllll,4267,44,5,3,8,62.5%,1m
149,2,Pimba,4265,96,6,2,8,75.0%,7m
149,3,[肉鸡的饲养]时崎狂三,4265,0,1,0,1,100.0%,21m
151,3,nanjolno,4263,0,0,1,1,0.0%,24m
152,3,[指尖奶茶]蕾米莉亚,4261,0,0,1,1,0.0%,21m
152,2,琉玥扣鸢,4261,0,0,1,1,0.0%,3m
154,3,[TeamNL]HooinKyoma,4256,0,1,0,1,100.0%,8m
155,2,强哥哥,4254,94,4,5,9,44.4%,7m
156,3,LoveByZyy,4249,56,5,7,12,41.7%,7m
156,1,SDF,4249,169,5,7,12,41.7%,22m
156,3,[肉鸡的饲养]Herodropship,4249,0,1,0,1,100.0%,51m
159,2,奥巴牛,4248,0,1,0,1,100.0%,18m
160,2,[猛的一逼]Liqutid,4245,987,44,50,94,46.8%,50m
161,3,[不会散枪兵]火柴天堂,4244,0,0,1,1,0.0%,29m
162,3,全家老小一波流,4242,0,0,3,3,0.0%,24m
163,3,[SoloAs]APLUSVABLE,4238,0,1,0,1,100.0%,14m
164,2,Satie,4237,2018,259,276,535,48.4%,26m
164,3,[素貭極差]车马邮件比较慢,4237,0,1,0,1,100.0%,8m
166,3,[Sv]版小将,4230,0,1,0,1,100.0%,7m
167,3,[嘤遍全球]大女乃,4229,1440,103,30,133,77.4%,24m
167,3,[乳主头子]那只狗是我的,4229,97,5,1,6,83.3%,9m
169,3,qwer,4227,96,18,10,28,64.3%,52m
170,3,[红魔馆的主人]东风谷早苗,4223,0,0,1,1,0.0%,2m
171,3,[四叶草]浅夏未央夏忆凉,4218,1557,105,73,178,59.0%,14m
172,3,胡尼玛,4217,364,33,25,58,56.9%,8m
173,2,[探机之怒]DRINK,4213,0,0,1,1,0.0%,26m
173,1,[SoIoAs]血花缭乱,4213,0,0,1,1,0.0%,10m
175,3,[Warp]希格斯玻色子,4212,40,5,3,8,62.5%,29m
176,3,grezmuc,4211,393,31,31,62,50.0%,29m
177,1,[白鲸造船厂]大藏游星,4207,0,0,1,1,0.0%,28m
178,3,Stormwind,4201,26,4,3,7,57.1%,14m
178,3,[胖胖]kidn,4201,0,0,1,1,0.0%,20m
180,1,[西纳普斯]不要南妈妈,4197,0,1,0,1,100.0%,9m
181,3,胡喵喵,4196,0,0,1,1,0.0%,20m
182,3,[QFD]语尘堤,4195,97,4,2,6,66.7%,24m
183,3,[SK]CheckMate,4192,426,21,13,34,61.8%,9m
184,3,[我们是无敌的]月落星辰,4191,173,28,12,40,70.0%,8m
185,3,Demon,4187,0,0,1,1,0.0%,8m
186,3,[KUMA28]FadeAway,4186,916,65,46,111,58.6%,29m
186,3,Izayoi,4186,382,18,7,25,72.0%,7m
186,2,[HustSC]liberator,4186,44,1,1,2,50.0%,20m
189,3,初生婴儿,4184,764,33,19,52,63.5%,25m
190,2,[TUF]魂牵冰点,4183,0,0,1,1,0.0%,52m
191,3,[老油条战队4]Pgtwo,4182,0,0,1,1,0.0%,29m
192,3,[iWoWi]histBigGun,4181,166,46,29,75,61.3%,20m
192,3,[Solo]IIIIIIIIIIII,4181,0,0,1,1,0.0%,29m
194,2,[我们是无敌的]CTWEven,4178,0,0,1,1,0.0%,3m
195,3,[NSDs]土豆你个马铃薯,4176,262,78,75,153,51.0%,52m
196,3,[gan死x哥]蟑螂舞娘钱赞企,4171,1115,50,27,77,64.9%,7m
196,3,[五月花]宫内莲华,4171,633,27,7,34,79.4%,14m
198,3,冥松,4170,232,7,2,9,77.8%,8m
198,2,你的爱自己去寻找,4170,0,1,0,1,100.0%,12m
200,3,lllllllllll,4169,0,0,1,1,0.0%,9m
201,3,chinahudie,4168,0,1,0,1,100.0%,51m
201,3,[集大鸡协]海院扛把子,4168,0,0,1,1,0.0%,13m
203,3,[IMRTS]我真的很菜啊,4167,666,30,16,46,65.2%,29m
203,3,zeratul,4167,0,0,1,1,0.0%,52m
205,3,IIIIIIIIII,4165,222,6,6,12,50.0%,29m
206,3,[FPT]人中吕布李信衡,4163,265,8,2,10,80.0%,25m
207,3,[丨SLT丨]秋月爱莉,4162,297,9,10,19,47.4%,10m
208,3,七零后,4161,596,23,16,39,59.0%,14m
208,3,超级爱吃冰糖葫芦,4161,34,4,6,10,40.0%,29m
210,3,IIIIIIIIIIII,4160,839,46,49,95,48.4%,14m
210,2,sue,4160,0,0,2,2,0.0%,54m
212,3,[HTW]手无缚鸡之力,4156,60,9,9,18,50.0%,2m
213,1,好吃不过饺子,4155,0,0,1,1,0.0%,28m
214,1,胡尼玛,4153,417,13,12,25,52.0%,2m
215,2,奥尔加一直卡,4152,0,0,1,1,0.0%,4m
216,2,[深圳老年星际]老婆看我打星际,4149,48,2,5,7,28.6%,20m
217,2,[烽夜长歌]IIIIIIIIIIII,4145,0,0,1,1,0.0%,17m
218,3,[我们是无敌的]天生贵人霍去病,4143,149,4,4,8,50.0%,25m
219,3,[头发打乱了]小猪头,4133,1225,215,218,433,49.7%,8m
219,1,[四叶草]漫长总是不满,4133,0,1,1,2,50.0%,54m
221,2,[第七舰队丶]阿尔萨斯,4126,2342,585,612,1197,48.9%,50m
222,3,IIIIIIIIIIII,4125,296,9,10,19,47.4%,2m
223,3,[IMRTS]mYthRendeR,4115,387,43,44,87,49.4%,13m
224,1,幸运魔法兔,4113,0,4,1,5,80.0%,24m
224,1,[RyH键谈坊]CaptainAM,4113,95,1,3,4,25.0%,14m
226,2,[城管拆迁大队]不屈战魂,4111,1580,100,114,214,46.7%,5m
227,2,[炼丹工]OPzealot,4110,42,1,1,2,50.0%,19m
228,2,llllllllllll,4108,46,1,3,4,25.0%,15m
229,3,小金者,4107,98,7,16,23,30.4%,8m
230,1,sss,4102,378,8,8,16,50.0%,17m
231,1,摔跤不带滚,4101,225,10,3,13,76.9%,54m
232,1,血染的图腾,4093,0,0,3,3,0.0%,28m
233,2,真的要卡死了,4092,0,4,1,5,80.0%,3m
234,2,[我不是乱舞]狂花,4091,250,13,0,13,100.0%,52m
235,3,宇文逸豆归,4089,404,18,16,34,52.9%,29m
235,2,mandery,4089,0,0,1,1,0.0%,3m
237,1,[pp]YHC,4084,0,0,1,1,0.0%,27m
238,1,[SoloAs]Fck,4083,1428,37,36,73,50.7%,1m
238,2,[南京理工大]honest,4083,0,0,5,5,0.0%,18m
240,1,[SK]十六夜咲夜,4082,48,2,1,3,66.7%,26m
241,1,llllll,4080,0,1,0,1,100.0%,10m
242,1,DRGgo,4079,48,2,1,3,66.7%,51m
243,3,爹爹,4076,840,119,111,230,51.7%,2m
243,3,[中华讲武堂]张全蛋,4076,1834,101,112,213,47.4%,13m
243,2,[DMDG]qpc,4076,0,0,2,2,0.0%,25m
246,1,[我是一只机]雪夜音,4074,0,1,0,1,100.0%,49m
247,2,城市化请赐教,4072,0,0,1,1,0.0%,13m
248,3,帅哥的帅,4069,62,10,16,26,38.5%,25m
248,2,[新手村萌新]Tyrael,4069,0,0,1,1,0.0%,23m
250,1,金陵吕布,4066,426,13,4,17,76.5%,27m
250,3,[Road]GhostHack,4066,20,12,22,34,35.3%,51m
252,1,[KPG]巢导,4065,0,0,5,5,0.0%,15m
253,1,[X2QK]乾坤深似海,4063,48,2,0,2,100.0%,15m
254,1,[魔法少女小屋]玖诺,4062,520,12,21,33,36.4%,1m
255,3,[大连理工]梦羽,4060,105,3,9,12,25.0%,7m
255,2,[丨SLT丨]陈忱只会跳鸡猎,4060,0,0,1,1,0.0%,10m
257,1,[KPG]天煞落世,4059,0,0,1,1,0.0%,24m
258,2,SKTBisu,4056,0,0,1,1,0.0%,11m
259,1,[帝国Aeon]哈斯卡,4053,0,0,2,2,0.0%,15m
260,2,[弱萌小队]胖小埋,4050,0,1,0,1,100.0%,25m
260,1,橘子,4050,0,0,5,5,0.0%,28m
262,2,ZZZZZZZZZZZZ,4049,222,12,1,13,92.3%,24m
263,1,[SK]DirtyProtoss,4048,96,2,3,5,40.0%,28m
264,1,[GAGA]艾尔,4045,48,1,1,2,50.0%,26m
265,1,[南京大学]奎爷回来了,4041,458,10,19,29,34.5%,26m
266,2,[仁心会]IIIIIIIIIIII,4035,0,1,0,1,100.0%,51m
267,1,[UF]迟来的春天,4031,667,16,16,32,50.0%,3m
267,1,[情谊至上]炒股养家,4031,140,4,5,9,44.4%,54m
267,2,切糕终结者,4031,0,1,0,1,100.0%,11m
270,2,[身坚智残]德玛西亚,4028,46,2,3,5,40.0%,52m
271,1,[一颗赛艇]消失的海岸线,4027,0,2,3,5,40.0%,14m
272,1,[esport]Clear,4026,462,11,6,17,64.7%,51m
272,1,[惊天浪涛杀]垃圾人族如何生存,4026,122,4,5,9,44.4%,22m
274,2,[火车烧基地]wsgfs,4024,44,1,1,2,50.0%,15m
275,1,[我们是无敌的]Heleve,4019,1763,50,42,92,54.3%,26m
276,2,ZooM,4017,130,3,10,13,23.1%,20m
276,1,青丿灬小溪,4017,0,0,1,1,0.0%,25m
278,1,ilcsc,4016,144,4,5,9,44.4%,26m
279,1,[萝莉之芯]艾尔,4015,374,8,9,17,47.1%,52m
280,1,DietmarP,4014,0,3,2,5,60.0%,24m
281,2,[SK]古明地觉,4012,283,9,2,11,81.8%,25m
282,3,iiLiiIIILIIL,4008,360,35,27,62,56.5%,7m
282,1,金珍熙的口球,4008,144,4,4,8,50.0%,25m
282,1,大阪孙一峰,4008,0,3,2,5,60.0%,26m
285,3,igXY,4006,0,1,0,1,100.0%,25m
286,1,[巨像吊炸天]手撕酱,4005,188,5,0,5,100.0%,9m
287,1,湍流碎一地,4001,1096,27,19,46,58.7%,22m
288,1,[小金上天队]宇文月树,3997,1244,31,26,57,54.4%,52m
288,1,[P就]二仙桥,3997,96,2,6,8,25.0%,14m
290,1,fagda,3992,0,0,1,1,0.0%,24m
291,1,我我我我我我我我,3990,94,5,3,8,62.5%,2m
291,1,[KPG2]夏色祭,3990,0,0,2,2,0.0%,2m
293,3,[Misty]星海迷航,3985,1757,90,89,179,50.3%,2m
294,2,代号,3984,228,6,9,15,40.0%,3m
295,1,达康书记,3981,1202,47,35,82,57.3%,28m
296,3,小蒙,3978,0,1,0,1,100.0%,22m
297,2,Lairinis,3977,2269,311,337,648,48.0%,27m
298,1,Nemu,3976,88,3,7,10,30.0%,15m
299,1,[北邮孙一峰]小豆豆,3969,586,15,14,29,51.7%,53m
300,1,福特号,3968,142,4,4,8,50.0%,8m
301,1,[Hist]宫羽,3967,0,1,0,1,100.0%,28m
302,1,恒星的恒心,3966,282,7,4,11,63.6%,1m
303,3,[传说萌俍团]沧海空,3965,709,35,24,59,59.3%,8m
304,1,[我们是无敌的]ZergFans,3963,1230,49,25,74,66.2%,10m
305,1,[大阪大学]lekbuss,3960,1562,52,37,89,58.4%,24m
305,1,[TNL]我有一只小可爱,3960,472,14,23,37,37.8%,25m
307,1,IIIIIII,3958,232,6,3,9,66.7%,22m
307,2,[猎妈人联盟]神奇猎马人,3958,0,0,3,3,0.0%,54m
309,3,whiter,3951,0,0,1,1,0.0%,11m
310,1,[羊驼羊驼羊]IIIIIIIIIIII,3950,0,0,5,5,0.0%,29m
311,1,[暴雪我是你爹]sky,3944,46,2,0,2,100.0%,14m
311,2,LuckyTerran,3944,0,0,1,1,0.0%,2m
311,3,MGJ,3944,0,0,2,2,0.0%,19m
314,1,[Rhusky]伊藤失之咲,3942,0,2,4,6,33.3%,24m
315,1,[1sA]Ray,3940,0,0,5,5,0.0%,10m
316,1,[妹控万岁]妹控都是好人,3935,48,3,4,7,42.9%,17m
317,1,christon,3934,0,0,1,1,0.0%,27m
318,1,[周哥神教]LSheep,3933,1271,72,64,136,52.9%,53m
319,3,[TNLtr]荒塞沫寒,3932,504,31,46,77,40.3%,7m
319,2,[我高贵的族人]綾地寧寧,3932,130,5,4,9,55.6%,54m
321,1,[SoloAs]yyf,3929,186,5,4,9,55.6%,51m
322,1,lOneLy,3928,0,1,1,2,50.0%,14m
323,3,黄旭东的舅舅,3922,2079,460,456,916,50.2%,52m
323,1,[真的叼]Potato,3922,190,4,7,11,36.4%,54m
325,1,[XZQK]UNiverse,3921,46,1,2,3,33.3%,26m
326,1,[AOSmt]Rye,3919,48,4,5,9,44.4%,22m
327,1,[不想打tvt]zsewqsc,3918,0,0,1,1,0.0%,9m
328,1,Aqualung,3913,188,5,2,7,71.4%,25m
329,1,JDash,3912,572,14,9,23,60.9%,17m
330,2,YuKino,3910,0,1,0,1,100.0%,7m
330,2,术高莫用,3910,0,1,0,1,100.0%,7m
332,1,[Fiend]silence,3909,354,12,14,26,46.2%,17m
332,3,黄龙,3909,0,0,1,1,0.0%,27m
334,3,[OhYo]纨绔,3908,2060,359,354,713,50.4%,29m
335,1,别慌有我呢,3907,515,15,26,41,36.6%,3m
336,2,[科普鲁孙一峰]herO,3906,0,0,1,1,0.0%,11m
337,1,Coach,3905,186,4,9,13,30.8%,10m
337,3,Rubick,3905,30,1,2,3,33.3%,22m
339,1,牛奶超人,3903,719,23,13,36,63.9%,9m
339,1,[糯米丸子]Lawyer,3903,324,7,9,16,43.8%,53m
339,2,Myrren,3903,0,0,1,1,0.0%,7m
342,1,[TAPC]jhxz,3902,402,11,4,15,73.3%,27m
342,1,折戟沉沙铁未销,3902,94,3,2,5,60.0%,24m
342,1,[凛风]雏咲深羽,3902,48,1,3,4,25.0%,2m
345,1,咘溪,3901,182,5,3,8,62.5%,53m
346,3,江西孙一峰,3899,0,1,0,1,100.0%,9m
347,1,[爱吃鱼的赤瞳]IIIIIIIIIIII,3898,0,0,1,1,0.0%,54m
348,3,[Killyo]海洋大鲸鱼尾巴,3896,0,0,1,1,0.0%,9m
349,3,DietmarP,3895,0,0,1,1,0.0%,7m
350,2,ImCurious,3891,284,9,4,13,69.2%,3m
350,1,[喵内噶]LuckyRabbit,3891,184,4,6,10,40.0%,54m
352,1,llllllllllll,3888,741,24,12,36,66.7%,1m
353,1,莫民,3886,2029,346,339,685,50.5%,28m
353,1,[153cm]diao,3886,0,1,0,1,100.0%,24m
355,2,iconfour,3885,160,4,5,9,44.4%,26m
356,1,DEMO,3884,266,12,2,14,85.7%,24m
357,3,[Ogier]Deadpool,3883,253,15,27,42,35.7%,21m
358,1,Legato,3882,1008,36,17,53,67.9%,9m
358,1,浮华一场不过游戏,3882,557,13,16,29,44.8%,51m
358,1,飓风来袭,3882,46,1,6,7,14.3%,26m
361,3,[FPT]丑的想整容,3881,1438,163,174,337,48.4%,51m
362,1,[怎么赢P]顾非池,3879,1116,61,40,101,60.4%,9m
362,1,[miku守护]ghoti,3879,0,1,1,2,50.0%,10m
364,1,[神秘的力量]导哥,3877,536,12,19,31,38.7%,53m
364,1,[青娱乐]QIQI,3877,0,0,3,3,0.0%,28m
366,1,wulusi,3867,176,5,6,11,45.5%,54m
366,1,IIIIIIIIIIII,3867,138,4,13,17,23.5%,24m
368,1,银枪小霸王,3866,136,3,4,7,42.9%,9m
368,3,IIIIIIIIIIII,3866,0,0,1,1,0.0%,28m
370,1,云狐,3864,0,1,0,1,100.0%,51m
371,2,筱寒,3859,154,9,5,14,64.3%,9m
371,1,[C97568]执子之手与子偕老,3859,128,3,5,8,37.5%,2m
373,1,我要六块腹肌,3858,182,4,12,16,25.0%,54m
374,1,sasaice,3857,594,16,15,31,51.6%,26m
375,3,[布鲁斯弗莱]凹凹,3850,2023,102,128,230,44.3%,14m
376,1,小天才,3848,455,13,10,23,56.5%,24m
376,1,[星际古拳法]星际马保国,3848,366,8,17,25,32.0%,27m
378,1,[草泥马战队]羊驼教主,3846,991,181,151,332,54.5%,2m
379,1,[CaiBLu]十二,3845,92,2,2,4,50.0%,2m
380,1,[大哥队]庭哥,3844,302,11,9,20,55.0%,54m
381,1,菜鸟,3842,1009,36,33,69,52.2%,49m
382,1,[艾尔大断电]ziposcar,3841,278,6,7,13,46.2%,17m
383,2,鸡無力,3840,219,10,6,16,62.5%,14m
383,1,你这瓜保熟吗,3840,0,1,0,1,100.0%,22m
385,1,[GrHd]AmmP,3838,467,14,13,27,51.9%,8m
386,1,[四叶草]面具人,3837,768,19,21,40,47.5%,8m
387,1,[ToHo]囍羊羊,3836,232,6,10,16,37.5%,28m
388,3,[衣钵之卫]吟绿颂青,3835,88,4,1,5,80.0%,11m
388,2,[miku守护]Duron,3835,0,0,1,1,0.0%,10m
388,1,[第八舰队丶]Kingdom,3835,0,0,7,7,0.0%,24m
391,1,[桃家帮]韬叶,3833,1681,78,58,136,57.4%,9m
391,1,我是你爹,3833,316,7,15,22,31.8%,24m
391,3,[偽娘万歳]地狱咆哮,3833,0,3,2,5,60.0%,25m
394,1,[凛凛拎个鳖]血翼鸿鹄,3832,0,4,1,5,80.0%,26m
394,1,CymbiDD,3832,132,3,3,6,50.0%,25m
394,1,[星际老徐坤]IIIIIIIII,3832,0,0,1,1,0.0%,22m
397,1,[七咕咕]伪物的妖妖,3829,111,2,1,3,66.7%,1m
398,1,福利路小霸王,3826,1921,66,82,148,44.6%,10m
399,1,[SK]ZerO,3821,1130,30,32,62,48.4%,8m
400,3,IIIIIIIIIIII,3820,0,0,2,2,0.0%,10m
401,1,[AstoIF]IIIIIIIIIIII,3819,0,0,1,1,0.0%,22m
402,1,supuo,3818,863,44,19,63,69.8%,24m
402,2,oGsMC,3818,42,1,6,7,14.3%,7m
404,1,[IMRTS2]earlybird,3817,0,1,0,1,100.0%,8m
405,1,[我们的奇迹]养猪的大叔,3816,136,4,3,7,57.1%,25m
405,1,ColaFish,3816,48,1,3,4,25.0%,54m
407,1,[天朝]乱世王者,3815,1084,123,101,224,54.9%,25m
407,1,夕陽沙漏,3815,110,3,1,4,75.0%,10m
409,3,zxrai,3814,0,1,4,5,20.0%,3m
410,1,[青铜树]曼珠沙华,3813,0,0,1,1,0.0%,2m
411,1,[KPG2]Lotus,3811,1912,123,116,239,51.5%,14m
412,3,[orjer]orjer,3809,30,5,3,8,62.5%,1m
412,2,[SC联盟]Maru,3809,0,1,0,1,100.0%,3m
414,1,tingshouyu,3807,312,6,6,12,50.0%,22m
414,2,[谐拯救世界]Ewigkeit,3807,0,0,1,1,0.0%,25m
416,1,TTTLLL,3806,170,11,5,16,68.8%,53m
417,1,啊三,3802,619,42,43,85,49.4%,1m
418,1,[浴火银河]古鱼,3801,1936,243,239,482,50.4%,9m
418,3,[王师北定]Jcole,3801,0,0,2,2,0.0%,23m
420,1,[Holyam]芥子尘,3799,1910,129,121,250,51.6%,24m
420,2,喝完脉动割动脉,3799,0,0,1,1,0.0%,7m
422,1,[北京大学鸡协]芭芭拉冲鸭,3796,358,8,12,20,40.0%,1m
422,3,[NS]醉梦,3796,0,1,0,1,100.0%,8m
422,2,obo,3796,0,0,1,1,0.0%,3m
425,1,Relive,3794,1098,65,50,115,56.5%,22m
425,2,[不可能那么萌]北方,3794,36,2,1,3,66.7%,18m
427,2,TomYan,3793,616,50,37,87,57.5%,18m
427,3,[乘风寻道]步荀仙,3793,168,8,1,9,88.9%,26m
429,3,code,3792,121,4,2,6,66.7%,3m
429,3,llllllll,3792,0,2,3,5,40.0%,23m
431,1,就这破游戏瞎玩呗,3787,46,2,6,8,25.0%,28m
432,3,[HZAU]milka,3785,0,1,1,2,50.0%,23m
433,1,[Tricky]IIIIIIIIIII,3783,199,5,4,9,55.6%,1m
434,3,时说,3782,88,7,3,10,70.0%,18m
435,2,[CnNami]懒癌晚期,3781,0,1,0,1,100.0%,3m
436,2,[YM]Littlefly,3780,0,1,0,1,100.0%,20m
437,3,[萌佬同好会]夏利沫沫,3778,0,2,3,5,40.0%,22m
438,1,三年不洗卵,3777,807,116,102,218,53.2%,53m
438,2,[Solo]LosTATlantis,3777,0,0,1,1,0.0%,25m
440,2,Ginobili,3776,0,1,0,1,100.0%,10m
441,3,走丢的奶黄包,3774,169,7,3,10,70.0%,14m
441,3,[基金会]闪烁的星辰,3774,171,4,2,6,66.7%,1m
441,2,[KFC]ShowTime,3774,0,0,1,1,0.0%,29m
444,1,[SLB]落天血,3773,405,9,10,19,47.4%,52m
444,3,[SteEng]耗子尾汁,3773,0,1,0,1,100.0%,22m
446,2,[Thpj]魔法樱桃酱,3772,70,3,1,4,75.0%,51m
446,3,[Hurt]IIIIIIIIIIII,3772,0,0,1,1,0.0%,22m
446,2,[一波]小鸡的勇敢,3772,0,0,2,2,0.0%,20m
449,2,[DaCapo]ParadiseLost,3765,414,17,10,27,63.0%,18m
449,2,[Beasty]FLInovation,3765,236,8,6,14,57.1%,11m
451,3,Stats,3764,149,6,4,10,60.0%,12m
451,1,[CNboi]句号,3764,88,2,6,8,25.0%,24m
451,3,[我队伍很强大]虚幻,3764,0,1,0,1,100.0%,18m
454,2,[bnuphy]ggboud,3763,0,0,1,1,0.0%,54m
455,1,Rabby,3762,0,0,6,6,0.0%,28m
456,3,[SKT俱乐部]要用魔法打败魔法,3761,0,1,0,1,100.0%,15m
456,2,玫瑰,3761,0,1,0,1,100.0%,54m
458,2,[Solo]塔达林教徒,3760,335,13,11,24,54.2%,17m
458,1,谢家湾拉风小王子,3760,266,7,9,16,43.8%,14m
460,2,magician,3754,0,1,0,1,100.0%,16m
461,2,没错我就只会狗,3752,331,16,9,25,64.0%,23m
461,2,Headdy,3752,30,1,1,2,50.0%,19m
463,2,[亀山社中]白石麻衣毕业快乐,3751,410,15,9,24,62.5%,29m
463,2,[74110]就是要玩死你,3751,66,2,3,5,40.0%,25m
463,2,初号姬,3751,0,0,1,1,0.0%,54m
466,2,麻辣鱼丸,3750,138,3,2,5,60.0%,54m
467,2,[我队伍很强大]小青酱,3749,0,2,3,5,40.0%,23m
467,2,[万物齐一]随心自在,3749,0,1,0,1,100.0%,10m
467,2,IIIIIIIIIIII,3749,0,0,1,1,0.0%,15m
470,3,[杀马特集中营]三球,3748,0,3,3,6,50.0%,4m
471,1,㨿㑺㨿㑺㨿㑺㨿㑺,3747,1914,365,341,706,51.7%,1m
471,2,ropz,3747,166,6,7,13,46.2%,51m
473,3,[青铜树]GAMEKING,3746,0,1,1,2,50.0%,12m
474,1,IIIIIIIIIIII,3744,541,86,98,184,46.7%,28m
474,2,[C02337]阿发,3744,276,10,5,15,66.7%,18m
474,2,[东大电竞]雪之下雪乃,3744,0,1,0,1,100.0%,23m
477,2,[北极光小组]这辈子赢不了神族,3743,283,12,2,14,85.7%,18m
477,2,钵钵鸡,3743,0,3,2,5,60.0%,25m
477,3,CpuCwp,3743,0,1,4,5,20.0%,50m
480,2,IIIIIIIIIIII,3742,124,3,3,6,50.0%,23m
481,2,suyouck,3741,280,11,9,20,55.0%,54m
481,3,wei,3741,0,3,2,5,60.0%,26m
481,2,[肥飘俺的嫁]帕秋莉诺蕾姬,3741,0,1,1,2,50.0%,4m
484,2,weinibvhwo,3740,0,0,2,2,0.0%,25m
485,2,IIIIIIIIIII,3739,130,5,4,9,55.6%,54m
485,2,July,3739,0,0,1,1,0.0%,10m
487,2,菱形波纹,3736,189,7,8,15,46.7%,17m
487,3,[菜鸡球带]星海泛舟,3736,0,4,2,6,66.7%,12m
489,3,[恒古不灭]海绵宝宝,3735,0,0,1,1,0.0%,7m
490,2,[HoA]四季夏目,3733,0,1,0,1,100.0%,20m
491,3,樱岛麻衣,3732,0,1,1,2,50.0%,54m
492,3,狗逼死全家,3730,168,7,2,9,77.8%,2m
493,3,[阿库西斯教廷]LSK,3729,0,0,1,1,0.0%,3m
494,1,小悦,3728,1766,352,368,720,48.9%,52m
494,2,你不要过来啊,3728,280,11,5,16,68.8%,51m
494,3,正大光明,3728,121,3,4,7,42.9%,7m
497,2,[SC2ACG]IIIIIIIIIIII,3727,210,7,2,9,77.8%,23m
498,2,我是你爹,3726,308,10,10,20,50.0%,15m
499,2,[despai]ChoseOwnLife,3725,0,0,1,1,0.0%,10m
500,1,IIIIIIIIIIII,3724,1522,342,324,666,51.4%,26m
501,2,[撸管神器]过路菜鸟,3721,1430,199,171,370,53.8%,11m
501,3,[foryss]zEAlotyc,3721,0,3,2,5,60.0%,6m
503,2,maru,3720,0,1,0,1,100.0%,21m
504,3,泳于樱色之海,3719,0,4,1,5,80.0%,19m
504,2,Bonnenuit,3719,32,2,0,2,100.0%,12m
506,2,Leifo,3718,66,2,2,4,50.0%,10m
507,3,[CNboys]MixKristin,3717,144,8,1,9,88.9%,19m
508,2,IIIIIIIIIIII,3716,378,15,6,21,71.4%,21m
509,2,[咸鱼谐会]黑白的黎明,3715,0,1,0,1,100.0%,54m
509,3,忽远忽近的洒脱,3715,0,1,0,1,100.0%,51m
511,2,ish,3713,0,1,1,2,50.0%,51m
512,1,Piccolo,3712,488,11,20,31,35.5%,3m
513,2,[砖业团队]偷心盗贼,3711,40,1,3,4,25.0%,51m
514,1,胖次杀手,3710,0,0,5,5,0.0%,17m
515,2,IIIIIIII,3709,30,2,3,5,40.0%,7m
516,2,[北境]快到碗里来,3706,116,8,7,15,53.3%,10m
516,2,[莱茵实验组]Meteor,3706,30,2,2,4,50.0%,2m
518,1,GHS,3705,678,20,21,41,48.8%,25m
518,3,[老年人反应]不要打我一波好嘛,3705,0,1,0,1,100.0%,54m
520,1,zjh,3704,0,0,5,5,0.0%,18m
521,2,[华附谐会]EyesShu,3703,853,129,105,234,55.1%,7m
521,2,臭臭打天下,3703,996,39,31,70,55.7%,3m
523,2,[夏空的英仙座]遠野恋,3702,343,16,4,20,80.0%,22m
523,3,终梦,3702,97,2,0,2,100.0%,23m
525,2,IIIIIIIIIIII,3699,363,35,34,69,50.7%,25m
525,2,你居然在奶里下毒,3699,30,1,5,6,16.7%,25m
527,2,包包大侠,3698,1289,57,40,97,58.8%,25m
527,2,冬日可爱,3698,336,12,12,24,50.0%,25m
527,2,ToSsGirL,3698,128,4,6,10,40.0%,2m
527,3,[2090]花泽香菜,3698,58,2,1,3,66.7%,6m
531,2,[lwkmy]IIIIISIIIIII,3697,956,109,96,205,53.2%,10m
531,3,春日野穹,3697,152,8,1,9,88.9%,7m
531,3,IIIIIIIIIIII,3697,0,1,0,1,100.0%,10m
534,2,IzeGitoLc,3696,714,33,34,67,49.3%,3m
534,3,[萌新保护协议]ColdSeadling,3696,167,6,2,8,75.0%,24m
534,2,[XYFANS]Tossdaddy,3696,32,1,2,3,33.3%,10m
537,2,[不主动不拒绝]跟你就是走流程,3695,1181,47,42,89,52.8%,17m
537,3,[魔法少女小屋]命运神龙超级萌新,3695,0,1,0,1,100.0%,50m
539,2,[SCAP]EtdhaGongDa,3692,536,20,23,43,46.5%,11m
539,3,wwwww,3692,0,1,1,2,50.0%,29m
541,2,年轻人耗子尾汁,3690,1086,45,33,78,57.7%,51m
542,1,MILD,3687,945,207,207,414,50.0%,26m
543,1,[真正萌新]星宫六喰,3686,0,4,1,5,80.0%,11m
543,2,[哔翻天梯鸡]WGtoss,3686,36,1,1,2,50.0%,24m
545,3,[Encore]Observer,3682,86,4,2,6,66.7%,54m
546,2,[铁三玖]晓级驱逐舰響,3681,122,4,5,9,44.4%,19m
546,3,Zozzj,3681,60,2,4,6,33.3%,50m
548,2,不知道取什么名字,3679,144,5,4,9,55.6%,22m
548,2,孤岛中心,3679,88,2,0,2,100.0%,24m
550,2,小辣鸡,3678,98,4,5,9,44.4%,52m
551,2,[PoWs]水星人开拖拉机,3677,376,17,14,31,54.8%,16m
551,2,[1sA]llllllllllll,3677,0,0,1,1,0.0%,17m
553,2,llllllllllll,3676,0,1,0,1,100.0%,13m
554,1,[大哥队]安工大,3675,1552,192,153,345,55.7%,52m
555,2,不到三千五不改名,3674,409,15,8,23,65.2%,5m
555,2,jangbi,3674,0,0,1,1,0.0%,9m
557,3,[TCP]IIIIIII,3673,97,1,1,2,50.0%,28m
558,2,[Hindi]JJSYDW,3671,30,1,3,4,25.0%,17m
559,1,[Beasty]阳光,3670,538,13,22,35,37.1%,9m
560,3,[stkse]targetZ,3669,0,1,1,2,50.0%,26m
560,3,[南京总统府]玛戈几丶贾德诺,3669,0,0,1,1,0.0%,25m
562,3,恶魔,3668,0,0,1,1,0.0%,54m
563,2,XiaoLeiVSXM,3667,136,5,4,9,55.6%,10m
564,1,[NTOS]德国战车,3666,1683,143,148,291,49.1%,25m
564,2,[SCJWJ3]IIIIIIIIIIII,3666,160,6,7,13,46.2%,7m
566,2,冲一辈子坦克,3665,0,1,0,1,100.0%,24m
567,3,爱蜜莉雅,3663,0,0,1,1,0.0%,51m
568,1,[1sA]喜欢舔逼,3661,354,15,20,35,42.9%,53m
568,2,输给我死个妈,3661,0,5,0,5,100.0%,10m
570,3,[死亡收割]MixJdcy,3660,140,8,0,8,100.0%,9m
570,3,[星河气象学院]littleforest,3660,30,2,1,3,66.7%,14m
570,2,[NT]水果,3660,30,1,4,5,20.0%,14m
570,2,[FAFA]随机,3660,30,1,6,7,14.3%,17m
574,2,[Holyam]SwansSong,3659,162,5,5,10,50.0%,54m
574,1,Dreamflsh,3659,0,3,2,5,60.0%,26m
576,3,[C33687]威廉伯爵,3658,60,2,6,8,25.0%,12m
577,1,DietmarP,3657,0,1,0,1,100.0%,51m
577,2,[暗鹰爱凤凰]元我本真,3657,0,0,1,1,0.0%,29m
579,2,[Revive]LPU,3656,0,1,0,1,100.0%,7m
579,2,fengye,3656,0,0,2,2,0.0%,52m
581,2,[HoA]夜刀神十香,3654,0,0,1,1,0.0%,51m
582,2,空心汤圆,3653,62,2,5,7,28.6%,25m
582,1,manu,3653,0,1,0,1,100.0%,7m
582,3,lhp,3653,30,1,9,10,10.0%,1m
582,2,[突变攻略组]GENG,3653,0,0,1,1,0.0%,51m
586,2,[miku守护]哔哔哔,3652,32,1,1,2,50.0%,51m
587,2,Artanis,3651,588,28,26,54,51.9%,22m
587,3,英雄联盟小学生,3651,192,9,3,12,75.0%,29m
589,2,无梦灬生,3650,30,1,3,4,25.0%,13m
590,2,[miku守护]疯狂的菜菜,3649,915,49,43,92,53.3%,7m
590,1,[DMR]脲道微波,3649,1138,47,50,97,48.5%,53m
590,2,[KPG]SeleiXi,3649,408,19,19,38,50.0%,54m
590,2,[ZTSCAP]wdfk,3649,486,16,23,39,41.0%,25m
590,3,[刺蛇互助协会]WatuZhY,3649,146,3,2,5,60.0%,8m
590,2,IIIIIIIIIIII,3649,0,1,0,1,100.0%,52m
596,2,火柴天堂,3648,1568,303,306,609,49.8%,4m
597,1,llIllIIIllIl,3647,826,168,167,335,50.1%,9m
597,2,IIIIIIIIIIII,3647,30,1,1,2,50.0%,19m
599,2,[Sv]羽瀨川小笛,3646,372,26,4,30,86.7%,5m
599,2,紫罗兰,3646,64,2,2,4,50.0%,21m
601,2,萌新想找大佬带,3645,339,13,18,31,41.9%,54m
602,3,[TPoA]Dark,3644,215,9,4,13,69.2%,53m
602,2,[Encore]MrLoveQ,3644,0,1,2,3,33.3%,25m
604,1,IIIIIIIIIIII,3643,0,0,5,5,0.0%,22m
605,3,菜狗也疯狂,3642,170,14,5,19,73.7%,2m
605,3,[贵州人]记记丶,3642,147,8,2,10,80.0%,7m
605,3,[DaCapo]朕无敌,3642,0,1,0,1,100.0%,12m
605,2,canaan,3642,0,1,2,3,33.3%,7m
609,2,Ins,3641,1617,127,105,232,54.7%,51m
610,2,[艾尔之名]吊丝化的土肥圆,3640,0,0,1,1,0.0%,52m
611,2,tarfet,3639,507,21,23,44,47.7%,10m
612,2,[VCTO]无情,3637,322,14,13,27,51.9%,14m
612,2,[天天打电脑]IIIIIIIIIIII,3637,124,5,6,11,45.5%,14m
612,3,极昼永夜,3637,0,1,0,1,100.0%,8m
615,3,IIIIIIIII,3636,97,3,4,7,42.9%,29m
615,2,[暴雪三十一队]奥特曼,3636,36,1,5,6,16.7%,8m
617,2,[80s丶]弧光尖冰,3635,34,2,2,4,50.0%,10m
617,3,IIIIIIIIIIII,3635,0,1,2,3,33.3%,7m
619,3,[他输给孙哥喵]嵯峨想变得可爱,3633,0,1,0,1,100.0%,50m
620,2,[1sA]愤怒的海绵体,3632,0,0,1,1,0.0%,13m
621,1,[让我来点化你]手脑都残怎么办,3631,1196,52,55,107,48.6%,53m
621,2,忘了,3631,270,15,6,21,71.4%,15m
621,1,cAtty,3631,0,3,2,5,60.0%,25m
621,2,[中南大学官网]邓紫棋,3631,0,0,1,1,0.0%,25m
625,2,[SW]history,3630,154,5,11,16,31.2%,14m
625,1,Ddmz,3630,0,1,0,1,100.0%,51m
627,2,[中南大学官网]IIIIIIIIIIII,3629,424,18,7,25,72.0%,20m
628,2,[炮炮]PanDa,3628,145,4,1,5,80.0%,7m
629,2,[Toss]神族就输不了,3627,142,6,3,9,66.7%,8m
630,2,[堂口]傻暴兵,3626,83,4,2,6,66.7%,17m
630,3,[暴雪我是你爹]阳光人族,3626,30,1,3,4,25.0%,8m
632,3,htanmusic,3625,30,1,1,2,50.0%,29m
633,2,Tioe,3624,182,7,3,10,70.0%,12m
633,3,[TShark]为人须为陈冠希,3624,0,0,1,1,0.0%,53m
635,1,聖光出鞘,3623,412,14,15,29,48.3%,26m
635,2,FreeDTG,3623,0,0,1,1,0.0%,22m
637,2,llllllllllll,3622,0,1,4,5,20.0%,11m
638,2,IIIIIIIIIII,3620,459,20,9,29,69.0%,51m
639,2,[TeamCD]我不会玩,3619,30,5,1,6,83.3%,27m
639,1,[运营之神]MixParG,3619,0,1,1,2,50.0%,4m
641,1,[Solo]一步江湖无尽期,3618,1824,117,125,242,48.3%,3m
641,3,[水师主教之刃]PhoenixT,3618,255,11,2,13,84.6%,29m
641,3,IIIIIIIIIIII,3618,114,5,1,6,83.3%,7m
644,1,aytem,3617,294,8,18,26,30.8%,2m
644,3,新垣结衣,3617,0,1,0,1,100.0%,23m
646,2,LXLXLXLXLX,3616,174,6,11,17,35.3%,15m
647,1,刚玩星际大佬轻虐,3615,0,2,1,3,66.7%,24m
648,2,[我爱黄嘉彦]伟大温度计,3614,0,0,1,1,0.0%,3m
649,3,[古明地嗪]一生注雪,3613,227,12,1,13,92.3%,54m
649,3,原始野人,3613,194,9,4,13,69.2%,15m
649,2,[北京大学鸡协]llllllllllll,3613,114,5,2,7,71.4%,52m
649,2,llllllllllll,3613,30,2,1,3,66.7%,4m
649,2,龙翔,3613,0,1,0,1,100.0%,52m
654,2,冬马,3612,182,6,9,15,40.0%,22m
655,1,DragonAAAA,3610,143,7,1,8,87.5%,11m
655,2,[SCUG]Konoha,3610,131,7,4,11,63.6%,52m
657,2,[SoloAs]潇水咖啡,3609,312,14,8,22,63.6%,3m
657,2,猎妈人,3609,133,9,1,10,90.0%,5m
659,2,develop,3608,218,9,5,14,64.3%,16m
659,2,[我们的奇迹]zijia,3608,0,0,1,1,0.0%,51m
659,3,MKKKKKKK,3608,0,0,1,1,0.0%,12m
662,2,VeniVediVici,3607,887,35,26,61,57.4%,10m
662,2,[萌新ovo]SolitaryMan,3607,185,15,11,26,57.7%,25m
662,3,Kaczynski,3607,0,0,1,1,0.0%,19m
665,2,出虚空等于无敌,3606,32,2,1,3,66.7%,26m
665,2,[电游国]电游王,3606,0,0,1,1,0.0%,19m
667,1,[幽冥之狼]幽州夜雨,3605,0,0,1,1,0.0%,12m
667,1,我只会两船兵,3605,0,0,2,2,0.0%,6m
669,2,ArSonMan,3604,384,15,11,26,57.7%,20m
670,1,孙一峰,3603,1696,220,197,417,52.8%,2m
670,2,[KPG]brownners,3603,0,1,0,1,100.0%,25m
672,3,[CUSTE]女王榨汁机,3602,122,7,10,17,41.2%,54m
672,1,[浪啊浪]QIRIIYUE,3602,0,0,1,1,0.0%,24m
674,2,[XYFANS]SLIMSHADY,3601,0,1,0,1,100.0%,27m
675,2,深过冷的熔体,3600,387,15,9,24,62.5%,52m
676,1,幻海,3599,759,62,60,122,50.8%,2m
676,1,香橙味布丁吖,3599,97,1,1,2,50.0%,18m
678,2,[单矿跳大牛]HouBen,3598,126,4,11,15,26.7%,10m
678,1,PrinsY,3598,0,1,0,1,100.0%,26m
680,2,ladaman,3597,1588,86,79,165,52.1%,25m
680,2,[我们菜的1b]北虚川,3597,190,6,13,19,31.6%,3m
680,3,[辉光骑士团]机甲旋风,3597,0,1,0,1,100.0%,29m
683,2,谐星鬼王,3594,1593,122,116,238,51.3%,21m
684,2,[文韬武略]新兵伦伦,3593,0,4,1,5,80.0%,20m
684,2,[势必吊打雪穗]我給祖国添乱了,3593,0,0,1,1,0.0%,2m
684,3,MixTokYoHoT,3593,0,0,2,2,0.0%,12m
687,2,[牌面]傲魄,3592,86,3,1,4,75.0%,15m
688,2,Nicholas,3590,387,12,19,31,38.7%,7m
688,2,逼格之链第一人,3590,0,1,0,1,100.0%,2m
690,1,飞舞的石子,3589,1134,42,39,81,51.9%,14m
690,2,[战意不熄]叹云兮,3589,0,1,0,1,100.0%,16m
692,3,[游戏风云OL]二次元刀酱,3588,6,2,7,9,22.2%,15m
692,2,[web]fightaa,3588,0,1,0,1,100.0%,7m
692,3,[丨SLT丨]uwuThermy,3588,0,0,1,1,0.0%,17m
695,2,[哔翻天梯鸡]湖州张智霖,3587,408,15,13,28,53.6%,11m
695,2,[佣兵的夕暮]绚辻词,3587,162,6,9,15,40.0%,12m
695,2,[DTT]碉堡了,3587,46,3,1,4,75.0%,29m
698,2,INnoVation,3586,615,32,29,61,52.5%,10m
698,2,[miku守护]miku,3586,462,24,7,31,77.4%,10m
698,2,[Beauty]半澤直樹,3586,128,6,0,6,100.0%,15m
701,2,IIIIIIIIIIII,3585,630,23,25,48,47.9%,15m
701,3,Ferrari,3585,30,1,2,3,33.3%,25m
703,1,sycshc,3584,96,1,1,2,50.0%,6m
704,2,花鸟风月,3583,0,0,1,1,0.0%,25m
705,1,tossgirl,3580,0,0,1,1,0.0%,7m
706,2,[谁在呼叫舰队]十次血字,3579,30,1,6,7,14.3%,25m
707,2,[ETG]icestyleTYTY,3578,1079,77,80,157,49.0%,12m
708,2,SBZR,3577,726,28,22,50,56.0%,20m
709,2,kusotori,3576,60,2,3,5,40.0%,22m
710,2,BABA,3575,30,1,4,5,20.0%,17m
710,2,[破晓灬黎明丶]地狱圣灵,3575,30,1,5,6,16.7%,19m
710,2,[Period]Tarzan,3575,0,0,1,1,0.0%,21m
713,2,[斯巴达血战团]JohnAnder,3574,946,45,25,70,64.3%,24m
713,2,[最菜战队]纯新手,3574,184,7,6,13,53.8%,52m
713,2,[DMRc]英国大力士,3574,0,2,3,5,40.0%,10m
713,1,欢迎来到祖安,3574,0,0,2,2,0.0%,17m
717,2,Mahakala,3573,1537,140,121,261,53.6%,10m
718,3,教父,3572,306,14,4,18,77.8%,8m
719,2,[拜仁]FCBRose,3571,908,55,34,89,61.8%,12m
720,3,abook,3570,171,4,3,7,57.1%,19m
721,2,TheYuan,3568,387,19,18,37,51.4%,19m
721,2,fantasy,3568,164,6,13,19,31.6%,16m
723,2,Jian,3567,18,2,0,2,100.0%,23m
723,2,[镜花水月]天狼星,3567,0,1,0,1,100.0%,17m
723,2,[舰队行驶中]TIMBA,3567,0,1,3,4,25.0%,54m
726,2,肥躁,3565,30,4,4,8,50.0%,54m
727,3,[FET]BossL,3564,0,0,1,1,0.0%,4m
728,2,CLAAFresno,3562,1062,43,29,72,59.7%,25m
728,2,[东京有点热]神奇的猩猩充饥,3562,0,1,0,1,100.0%,7m
728,2,[SW]狼蛛,3562,0,0,1,1,0.0%,3m
731,2,[铁血判官]interment,3561,114,5,3,8,62.5%,12m
731,2,JingGG,3561,28,3,5,8,37.5%,29m
733,2,[GAGA]所谓肉香,3560,222,9,4,13,69.2%,14m
733,3,[無輪幻想]清风千叶,3560,0,0,1,1,0.0%,7m
735,2,aasd,3559,30,2,1,3,66.7%,19m
736,2,[狗才玩神族]MagicTom,3558,1559,277,269,546,50.7%,17m
736,2,ForsakenSoul,3558,407,15,21,36,41.7%,15m
738,2,rayswuha,3557,1462,146,140,286,51.0%,23m
738,2,[東方心念語]因幡帝,3557,149,13,6,19,68.4%,25m
738,2,[怎么赢P]一束七,3557,30,4,3,7,57.1%,7m
741,2,budatvt,3555,1120,45,42,87,51.7%,25m
742,2,LoveLL,3554,1573,321,297,618,51.9%,7m
743,2,[重庆1中]STURMOVIK,3553,34,1,3,4,25.0%,19m
744,2,hellokitty,3552,822,35,37,72,48.6%,21m
745,2,时时时时时时说,3549,242,9,8,17,52.9%,12m
745,2,TATQwQ,3549,95,4,2,6,66.7%,14m
745,2,[鸡会友狗服人]Loveless,3549,30,1,2,3,33.3%,20m
748,1,IDCOD,3548,1277,345,327,672,51.3%,2m
748,2,[Can]Samtair,3548,569,19,21,40,47.5%,52m
748,2,[ISMU星际]Icecream,3548,488,17,25,42,40.5%,10m
748,2,[鸡饲料1]奈文摩尔,3548,0,4,1,5,80.0%,20m
748,2,死性不改,3548,60,2,2,4,50.0%,7m
748,3,[三千分的幽灵]沧海客,3548,0,0,3,3,0.0%,23m
754,2,krypton,3547,76,10,7,17,58.8%,10m
754,2,[火焰雷兽]Yuraki,3547,120,4,6,10,40.0%,20m
754,2,哥哥来数,3547,0,1,0,1,100.0%,17m
757,2,不爱吃豆豆,3546,368,15,11,26,57.7%,24m
757,2,SCPLAYER,3546,120,5,4,9,55.6%,7m
757,2,[丨SLT丨]NanYi,3546,178,5,7,12,41.7%,10m
760,3,大壯,3545,97,1,1,2,50.0%,22m
761,2,FIRTY,3544,1554,83,78,161,51.6%,19m
761,2,Innovation,3544,0,1,0,1,100.0%,17m
763,1,DLDL,3542,236,6,6,12,50.0%,22m
764,1,greatCSS,3541,0,1,0,1,100.0%,17m
764,2,[柠檬汁]条码人,3541,0,1,0,1,100.0%,26m
766,2,飒岚,3540,1091,46,51,97,47.4%,17m
767,2,[KPG2]小菜,3539,992,38,43,81,46.9%,17m
768,3,Mars,3538,263,12,6,18,66.7%,13m
768,1,SoulHunter,3538,0,3,3,6,50.0%,5m
768,2,[BOOMER]TYTY,3538,0,1,0,1,100.0%,52m
771,3,资深男酮,3537,257,12,5,17,70.6%,13m
771,2,[肉鸡的饲养]魔法骚女凯露酱,3537,30,2,7,9,22.2%,17m
773,2,[镜花水月]瞎几把乱打,3536,938,56,13,69,81.2%,52m
773,1,浮生如梦,3536,130,3,0,3,100.0%,50m
773,2,[DMR]我玩虫族只换家,3536,0,1,0,1,100.0%,51m
776,2,噶姐半糖去冰,3535,0,1,0,1,100.0%,23m
777,2,宇智波狂笑四杰,3534,58,2,2,4,50.0%,4m
777,2,[KSARsn]上官轩煜丶,3534,0,0,2,2,0.0%,15m
779,1,JINWONTACK,3533,1754,580,587,1167,49.7%,28m
780,3,公孫無名,3531,277,12,5,17,70.6%,19m
780,2,[送分大队]ALARICUS,3531,314,11,9,20,55.0%,25m
780,1,国产零零漆,3531,144,3,4,7,42.9%,51m
780,3,电竞法王伊泽,3531,0,0,1,1,0.0%,50m
784,2,[Shawk]惜梦,3530,0,1,0,1,100.0%,52m
784,2,[你渴望力量吗]michaelqu,3530,30,1,4,5,20.0%,24m
786,2,抱紧林雨,3529,96,3,12,15,20.0%,14m
786,2,[LGX]iiiiiiii,3529,30,1,2,3,33.3%,25m
788,2,aGenT,3528,0,1,0,1,100.0%,2m
788,3,[WAK]Ultralucifer,3528,0,0,2,2,0.0%,2m
790,2,[盲人康复院]欲沐东湖的父亲,3527,981,55,39,94,58.5%,7m
790,1,MaGeJiTerran,3527,165,8,2,10,80.0%,27m
790,2,[核爆]Stitch,3527,0,1,0,1,100.0%,19m
790,3,[withme]立大功,3527,0,1,0,1,100.0%,10m
794,2,MIKEzhang,3526,30,1,1,2,50.0%,52m
795,2,[iceice]Zombie,3525,0,0,1,1,0.0%,10m
796,3,IIIIIIIIIIII,3524,213,6,5,11,54.5%,11m
797,2,陶宏开,3523,793,48,41,89,53.9%,15m
797,2,[火焰雷兽]Wangjiet,3523,242,8,4,12,66.7%,17m
797,2,xswl,3523,164,6,0,6,100.0%,7m
797,2,[四叶草]明理知秋,3523,32,2,2,4,50.0%,7m
801,3,[保证不秀地堡]恐怖如斯,3521,262,9,4,13,69.2%,12m
802,2,埃罗忙啊老师,3520,619,45,52,97,46.4%,51m
802,2,EssCstarDAY,3520,411,28,5,33,84.8%,27m
802,2,湯音,3520,92,3,6,9,33.3%,7m
802,2,[HEX]hexagram,3520,0,1,0,1,100.0%,20m
806,2,[KOZ]进哥,3519,377,39,37,76,51.3%,10m
806,2,[半个大哥]Zerofoll,3519,90,3,3,6,50.0%,18m
808,2,少年祭,3518,514,23,15,38,60.5%,10m
809,2,rusher,3517,333,44,43,87,50.6%,10m
809,2,OptimusPrime,3517,332,12,11,23,52.2%,21m
811,2,困困困困困,3516,1588,82,76,158,51.9%,18m
811,2,[北京外事电竞]POWER,3516,0,1,0,1,100.0%,3m
811,2,[Vgirls]驻马店孙一峰,3516,0,0,3,3,0.0%,54m
814,2,[L4WUDU]GAI,3515,60,3,3,6,50.0%,17m
814,2,OblivioN,3515,30,1,3,4,25.0%,22m
814,2,Eminem,3515,0,0,1,1,0.0%,4m
817,2,[小鸡屠宰场a]炸他个稀巴烂,3514,1537,182,181,363,50.1%,19m
817,2,Archer,3514,30,5,4,9,55.6%,26m
817,2,[SCJWJ3]夜愿,3514,116,4,7,11,36.4%,14m
817,2,[你渴望力量吗]锁妖,3514,118,4,12,16,25.0%,19m
821,2,[NUAA]BfMoSang,3513,646,40,33,73,54.8%,7m
822,2,IIIIIIIIIIII,3512,160,3,7,10,30.0%,51m
822,2,[ZJU]Archer,3512,0,2,4,6,33.3%,2m
822,3,深深大鱼海棠,3512,0,1,0,1,100.0%,8m
822,2,mumu,3512,0,0,1,1,0.0%,29m
826,2,[B得丶工夫乱]异域雪影儿,3511,1634,719,708,1427,50.4%,21m
826,1,IIIIIIIIIIII,3511,583,70,73,143,49.0%,28m
826,2,[RvA]人間幾度生華髮,3511,866,29,40,69,42.0%,13m
826,2,便士,3511,206,9,7,16,56.2%,4m
826,2,[五月花]IIIIIIIIIII,3511,0,3,3,6,50.0%,25m
831,2,IIIIIIIIIIII,3510,98,3,11,14,21.4%,51m
832,2,[SK]洗脚,3509,841,48,43,91,52.7%,17m
832,2,[KPG]松氏垂直学院,3509,439,19,14,33,57.6%,17m
832,2,ZeroReMind,3509,30,2,4,6,33.3%,23m
835,2,jimmilos,3507,285,10,10,20,50.0%,20m
836,2,LoveGodZ,3506,1249,254,233,487,52.2%,19m
836,2,壬生纳纳子,3506,46,6,1,7,85.7%,9m
838,2,游戏之王,3505,319,33,14,47,70.2%,52m
839,2,[BJTU]FTDfangge,3504,1515,141,121,262,53.8%,3m
840,2,[TeamLP]医生姐姐来了,3503,271,14,5,19,73.7%,21m
841,2,[DMRe]Hoklin,3502,548,23,17,40,57.5%,25m
841,2,IIIIIIIIIII,3502,0,2,4,6,33.3%,25m
841,1,[查尔之矛]我又不会玩,3502,0,0,1,1,0.0%,50m
844,2,Root,3501,1341,68,77,145,46.9%,14m
844,1,孤儿请滚,3501,187,3,4,7,42.9%,18m
846,2,tina,3499,476,20,16,36,55.6%,15m
846,2,冬泽,3499,30,1,2,3,33.3%,52m
846,2,新鲜土豆丝,3499,30,1,5,6,16.7%,25m
846,2,[老婆喊就退]spring,3499,0,0,1,1,0.0%,16m
850,2,[肉鸡的饲养]YogSothothDD,3498,95,4,2,6,66.7%,28m
851,2,[RSTAR]白给小菜鸡,3497,179,6,2,8,75.0%,4m
852,2,JigSaw,3496,834,64,59,123,52.0%,25m
853,2,THOOH,3494,0,0,1,1,0.0%,10m
853,1,火鸡味锅巴,3494,0,0,2,2,0.0%,27m
855,2,William,3493,216,9,3,12,75.0%,17m
855,3,sda,3493,97,6,3,9,66.7%,20m
855,2,[幽明异路]黑圆酱,3493,0,1,0,1,100.0%,25m
858,2,[起源]agang,3492,0,0,1,1,0.0%,10m
858,2,华皇旋影,3492,0,0,1,1,0.0%,7m
860,2,[龙眠山下的猫]泰伦基建狂魔,3491,0,0,1,1,0.0%,54m
861,3,就这么爱着我的宁,3490,30,2,0,2,100.0%,12m
862,2,[Gonzal]Again,3489,0,4,0,4,100.0%,22m
863,2,[iN]哀丶殇,3488,618,133,121,254,52.4%,17m
863,2,[斧头帮x]magiczerg,3488,972,54,37,91,59.3%,54m
863,2,[看啥]老庙,3488,122,5,7,12,41.7%,15m
866,2,IIIIIIIIIIII,3487,46,2,1,3,66.7%,54m
867,2,[多线空投]我只想好好运营,3486,114,4,6,10,40.0%,20m
868,2,[Encore]LinZero,3485,46,4,3,7,57.1%,16m
868,1,来过的路,3485,46,2,0,2,100.0%,22m
868,2,不想运营,3485,0,1,4,5,20.0%,2m
868,2,TIMBA,3485,0,1,5,6,16.7%,7m
868,2,[打死不修放空]老朱,3485,0,0,1,1,0.0%,12m
873,2,[KRR]imc,3484,1228,255,260,515,49.5%,17m
873,3,[NLHR]一个萌新,3484,213,11,4,15,73.3%,15m
875,2,飞龙骑脸怎么输,3483,547,33,19,52,63.5%,15m
875,2,[银翼之光]查无此人,3483,0,3,2,5,60.0%,15m
875,1,[受命于天]既寿永昌,3483,48,2,0,2,100.0%,17m
875,2,[超电磁炉]栗山未来,3483,0,1,0,1,100.0%,50m
875,2,pandasun,3483,0,1,0,1,100.0%,16m
875,2,每天睡不够,3483,0,0,1,1,0.0%,52m
881,2,[HK丶S]麒麟竞技,3482,1505,99,85,184,53.8%,17m
881,2,[ATLS]氙气灯,3482,280,11,7,18,61.1%,54m
881,3,[EtdNew]赢了都靠运气好,3482,90,4,6,10,40.0%,10m
884,2,太上忘情豆,3481,0,1,0,1,100.0%,10m
885,2,[四叶草]RainYoke,3480,46,4,4,8,50.0%,2m
885,2,你们都上网冲浪啊,3480,54,2,3,5,40.0%,10m
885,2,[斜星连萌]可爱的小灵儿,3480,0,1,1,2,50.0%,5m
888,2,change,3479,1267,56,42,98,57.1%,20m
888,2,llllllllllll,3479,208,8,10,18,44.4%,3m
888,1,SOS,3479,210,5,8,13,38.5%,17m
891,2,刑法二百三十七条,3478,418,13,25,38,34.2%,25m
891,2,挚爱毛毛,3478,0,1,0,1,100.0%,22m
891,1,皇家胜利者盖本,3478,0,0,1,1,0.0%,50m
891,1,IIIIIIIIIIII,3478,0,0,1,1,0.0%,24m
895,2,Lsz,3477,0,5,1,6,83.3%,8m
895,2,[血腥狂热]寂寞的贪吃蛇,3477,102,3,0,3,100.0%,8m
897,2,小库头,3476,1569,79,66,145,54.5%,51m
897,2,[神庙]hello,3476,1234,68,66,134,50.7%,23m
897,2,Fritzamoy,3476,94,3,3,6,50.0%,20m
900,1,别怕是酱油,3475,205,10,1,11,90.9%,15m
900,2,[南京工业大学]Mark,3475,0,0,1,1,0.0%,8m
902,2,ppp,3474,686,49,29,78,62.8%,27m
902,2,史莱克,3474,633,25,24,49,51.0%,24m
904,2,带带梁慕容霸,3473,216,11,3,14,78.6%,21m
904,2,IIIIIIIIIIII,3473,159,10,6,16,62.5%,17m
906,2,Relativity,3472,0,1,0,1,100.0%,3m
906,2,[80s丶]小脑斧丶,3472,0,0,1,1,0.0%,21m
908,2,IIIIIIIIIIII,3471,0,1,0,1,100.0%,14m
909,2,[ETG]小狐狸太棒了,3470,772,37,43,80,46.2%,54m
910,2,大魔王,3469,1089,53,39,92,57.6%,10m
910,2,alex,3469,541,21,27,48,43.8%,11m
910,1,[希靈使徒]铃村悟,3469,192,8,5,13,61.5%,50m
913,2,[LOHv]NIMAB,3467,675,31,42,73,42.5%,25m
914,3,姿势摆好了,3466,0,1,0,1,100.0%,53m
915,1,[纯洁的小白花]Romeo,3465,1698,915,917,1832,49.9%,10m
915,2,[Etern谐]黯黑魔导师,3465,260,8,9,17,47.1%,7m
915,2,[黑哨]蝎子莱莱,3465,94,5,1,6,83.3%,27m
915,2,[miku守护]warrior,3465,0,1,1,2,50.0%,17m
915,3,[暴雪我是你爹]电脑玩家詹姆斯,3465,0,0,1,1,0.0%,26m
915,3,哇啊,3465,0,0,1,1,0.0%,21m
921,2,[WinWin]hellforever,3464,305,14,6,20,70.0%,3m
921,3,[C91509]送分机器,3464,302,12,8,20,60.0%,3m
923,3,[夕阳下的浪客]历世的世语者世战,3463,0,5,0,5,100.0%,21m
923,2,InNEo,3463,92,4,9,13,30.8%,27m
923,2,[我们是无敌的]PREDATOR,3463,0,1,3,4,25.0%,16m
926,2,[TCP]柑橘奶昔,3462,178,7,16,23,30.4%,3m
926,3,[小鸡屠宰场9]黑黑黑,3462,0,1,0,1,100.0%,21m
928,2,[海石三叉戟]LYandGB,3461,162,6,3,9,66.7%,3m
928,3,SunSky,3461,0,4,1,5,80.0%,50m
928,3,[金灿灿狙击队]白花花,3461,30,2,0,2,100.0%,7m
931,2,最强生物卡兹,3460,434,18,20,38,47.4%,14m
931,2,sNowTeS,3460,266,14,5,19,73.7%,7m
931,2,Chen,3460,94,2,0,2,100.0%,14m
931,3,CyrusWY,3460,0,0,1,1,0.0%,23m
935,3,[猪头哥]猪猪侠,3459,142,6,2,8,75.0%,12m
935,2,[O栋444]四川康王龙,3459,93,3,2,5,60.0%,29m
935,2,ImperialDra,3459,0,1,0,1,100.0%,51m
938,2,[传说萌鸡团]Shaquille,3458,620,22,24,46,47.8%,3m
938,2,Xin,3458,30,1,5,6,16.7%,4m
940,2,绝望中的希望,3457,1397,61,57,118,51.7%,11m
940,1,[刀使之巫女]衛藤可奈美,3457,0,0,2,2,0.0%,11m
942,2,[龙中地表最强]恶魔皮卡,3456,718,34,30,64,53.1%,14m
943,2,[C63014]干丝黄毒奶,3455,0,0,2,2,0.0%,21m
944,2,入口柔一线喉,3454,318,12,13,25,48.0%,52m
944,3,赤樱,3454,0,0,1,1,0.0%,18m
946,3,llllllllll,3451,261,12,5,17,70.6%,28m
946,2,[CNboys]只会狗招,3451,115,6,1,7,85.7%,11m
946,2,llllllllllll,3451,181,5,5,10,50.0%,53m
949,2,DAMIMI,3450,722,27,36,63,42.9%,18m
949,2,跳不动的跳跳骑士,3450,292,16,18,34,47.1%,3m
951,3,KEVIN,3449,0,0,1,1,0.0%,21m
952,2,PowerGeyser,3448,406,13,17,30,43.3%,13m
952,2,[神圣]呆头部落,3448,0,1,0,1,100.0%,29m
954,2,[长虹贯日]我即是虫群,3447,0,0,2,2,0.0%,54m
955,2,今晨启,3446,93,4,3,7,57.1%,2m
956,2,枪兵推销员,3444,346,11,15,26,42.3%,3m
956,3,killer,3444,58,3,1,4,75.0%,10m
956,3,Lucrezia,3444,0,0,1,1,0.0%,16m
956,3,小白才不可爱,3444,0,0,1,1,0.0%,13m
960,1,[TYFANS]湖底典狱长,3443,96,2,0,2,100.0%,18m
961,2,IntelligencE,3442,1529,223,204,427,52.2%,17m
961,2,[什么族自己猜]人口满了怎么弄,3442,1520,92,83,175,52.6%,52m
961,3,[Holygl]DecodeTalker,3442,0,1,0,1,100.0%,21m
961,3,花悦婿艳,3442,30,1,1,2,50.0%,5m
965,3,llllllll,3441,114,5,0,5,100.0%,53m
965,3,[SWUST灬]Justman,3441,0,3,2,5,60.0%,7m
965,3,Yolooooooo,3441,0,3,2,5,60.0%,51m
965,1,[这就是天t]Tocqueville,3441,0,1,0,1,100.0%,26m
969,3,[最菜战队]kayanon,3440,190,8,1,9,88.9%,18m
969,3,馅儿软糖,3440,0,1,0,1,100.0%,21m
971,2,MVP,3439,120,5,1,6,83.3%,8m
972,2,紫月下的原野,3438,851,51,50,101,50.5%,17m
972,2,专门狙击一束七,3438,1002,49,45,94,52.1%,19m
972,2,[暴雪我是你爹]ktx,3438,0,1,0,1,100.0%,13m
975,2,[斩月]天下第一呆,3436,94,1,1,2,50.0%,3m
976,2,[软泥怪大团圆]自有科意,3435,226,77,61,138,55.8%,11m
976,3,冰冰敲可耐,3435,174,5,3,8,62.5%,5m
976,3,[老油条战队4]占卜阿里巴巴,3435,0,1,0,1,100.0%,4m
979,2,ZEALOT,3434,0,5,1,6,83.3%,28m
980,3,[白给不要钱]乌鸦落在猪身上,3433,0,0,1,1,0.0%,23m
981,2,[一生ACS]tzy,3432,1560,114,107,221,51.6%,7m
981,2,IIIIIIIIIIII,3432,719,79,81,160,49.4%,14m
981,3,[随便玩]東門吹水,3432,0,2,3,5,40.0%,13m
981,3,[oshima]马尔都克,3432,0,0,1,1,0.0%,55m
985,2,[我菜请打队友]亚特兰蒂斯,3431,662,70,60,130,53.8%,25m
985,3,tyt,3431,97,6,0,6,100.0%,4m
987,3,moonghost,3430,279,12,6,18,66.7%,9m
987,3,[高尚的人格]跳跳蛤,3430,30,2,0,2,100.0%,24m
987,3,长路漫漫,3430,0,0,1,1,0.0%,23m
990,3,[输一把就睡觉]Ghostmonster,3428,174,7,3,10,70.0%,8m
990,1,菜鸟,3428,157,5,3,8,62.5%,11m
990,3,小心渣男,3428,58,3,1,4,75.0%,12m
990,3,[大韩剧]再也不叫雷锋了,3428,0,1,0,1,100.0%,3m
990,3,[嘤遍全球]嘤酱,3428,0,0,1,1,0.0%,10m
995,3,[Beastp]逸丨尘灬,3427,0,3,2,5,60.0%,26m
996,2,桃花弄影,3426,1547,134,120,254,52.8%,55m
996,3,小学生,3426,146,6,4,10,60.0%,3m
998,2,IIIIIIIIIIII,3425,484,20,27,47,42.6%,13m
998,2,REPULSER,3425,0,1,1,2,50.0%,4m
1000,3,[独立团钢炮]菜牛,3424,243,10,8,18,55.6%,54m
1000,3,[NCHU]筱筱筱筱娅,3424,0,0,5,5,0.0%,6m
1002,3,飞鱼火花,3422,262,11,3,14,78.6%,19m
1003,3,SCVonBulaga,3421,156,17,11,28,60.7%,25m
1003,3,[NZNZ]GhostTown,3421,124,11,9,20,55.0%,23m
1003,3,[别靠近我]零静,3421,0,1,0,1,100.0%,6m
1003,3,[AnSwer]Rhythm,3421,0,0,1,1,0.0%,27m
1003,3,[Fansc]为艾尔而战,3421,0,0,1,1,0.0%,53m
1008,2,[Sc养老]残心,3420,1340,103,92,195,52.8%,8m
1008,2,[Fantsy]Pluto,3420,769,46,33,79,58.2%,52m
1008,2,DreamHunter,3420,298,10,18,28,35.7%,22m
1008,3,月下彼岸花,3420,0,1,4,5,20.0%,26m
1012,3,Pimab,3419,418,16,11,27,59.3%,6m
1012,3,[YA]快仙刀,3419,0,0,1,1,0.0%,12m
1014,3,[闪击战]五十块的好兄弟,3418,656,25,20,45,55.6%,50m
1014,3,[要啥没啥爱咋]长安丶,3418,495,18,13,31,58.1%,16m
1014,2,[831]一只鸡,3418,315,14,7,21,66.7%,7m
1014,1,[雷霆半月斩]七九要谦虚,3418,118,5,4,9,55.6%,18m
1014,3,[XJTU]风檐展书读,3418,0,0,1,1,0.0%,53m
1019,3,夜羽酱,3417,0,2,0,2,100.0%,12m
1019,3,[ZTSCAP]羽落,3417,0,0,1,1,0.0%,7m
1021,3,[五月花]aaa,3416,867,117,99,216,54.2%,27m
1021,1,GGtaste,3416,141,5,6,11,45.5%,20m
1023,3,SCARE,3415,0,1,0,1,100.0%,53m
1024,2,knight,3413,138,7,4,11,63.6%,17m
1024,3,莽我,3413,142,5,3,8,62.5%,21m
1024,2,新开豆腐干,3413,0,1,6,7,14.3%,19m
1027,3,[谐星联盟]菜头,3411,60,2,2,4,50.0%,24m
1027,3,bvcxp,3411,30,1,1,2,50.0%,8m
1027,3,INnoVation,3411,0,1,2,3,33.3%,21m
1030,2,song,3410,0,1,1,2,50.0%,9m
1031,2,IIIIIIIIIIII,3409,1078,41,45,86,47.7%,2m
1032,3,多线起飞,3408,0,0,1,1,0.0%,25m
1033,2,Aphrodite,3407,461,17,18,35,48.6%,25m
1034,3,[红烧兔头]惊涛骇浪五娃,3406,754,61,48,109,56.0%,4m
1034,3,哇哈哈哈哈哈,3406,30,2,2,4,50.0%,23m
1036,2,持着圣剑的男人,3405,479,21,13,34,61.8%,27m
1036,2,进击的艾伦,3405,296,11,11,22,50.0%,25m
1036,2,[Ryon榕]王菜花,3405,220,9,10,19,47.4%,17m
1036,3,写字,3405,0,1,0,1,100.0%,13m
1040,2,[六字母连体人]三酱,3404,1414,195,167,362,53.9%,51m
1040,2,[4everY]deadfisheye,3404,1558,98,87,185,53.0%,24m
1040,3,游戏怎么玩淦真难,3404,1205,63,53,116,54.3%,15m
1043,3,[八爪鱼]紫影幻月,3403,428,18,7,25,72.0%,18m
1043,2,[谐星联盟]wang,3403,60,2,9,11,18.2%,51m
1043,3,[禽禽禽]喵帕斯,3403,0,1,0,1,100.0%,24m
1043,2,Chrees,3403,0,0,2,2,0.0%,8m
1047,2,[Brave]Rice,3402,156,5,6,11,45.5%,12m
1047,3,[萌新萌新萌]秋月孝三,3402,0,2,3,5,40.0%,2m
1047,3,[索嚗命鋲斋]烬染不夜,3402,97,2,4,6,33.3%,53m
1047,3,[水的不行]imzealot,3402,0,0,1,1,0.0%,29m
1051,2,小蜗,3401,245,9,9,18,50.0%,53m
1051,3,[华师大二附中]MyStery,3401,92,4,4,8,50.0%,9m
1051,3,llllllllllll,3401,30,4,12,16,25.0%,27m
1054,2,[AIS]颠倒世界,3400,1252,184,179,363,50.7%,12m
1054,3,[YKSN]wudi,3400,218,8,6,14,57.1%,13m
1054,3,[丨SLT丨]苍生涂涂天下渺渺,3400,188,6,1,7,85.7%,26m
1054,3,[ZXY]INNOVATION,3400,30,2,0,2,100.0%,10m
1054,3,阿西吧,3400,0,1,4,5,20.0%,6m
1054,3,[肉鸡的饲养]小魔女伊蕾娜酱,3400,0,0,2,2,0.0%,3m
1060,3,DietmarP,3399,0,0,1,1,0.0%,19m
1061,3,[宝宝巴士]毁天灭地大魔王,3396,204,8,10,18,44.4%,21m
1061,2,[Fiend]倾尽天下,3396,102,3,4,7,42.9%,21m
1063,2,[DMRc]光酱咚咚光酱咚咚,3395,94,2,5,7,28.6%,13m
1063,3,有天赋的选手,3395,0,1,0,1,100.0%,21m
1065,3,悔丶,3394,262,8,7,15,53.3%,13m
1065,3,scplayer,3394,48,3,2,5,60.0%,50m
1067,3,[第九舰队丶]sixxxx,3393,224,8,9,17,47.1%,53m
1067,3,[SCUT]marvelous,3393,118,5,5,10,50.0%,21m
1067,3,[給錢什麼都做]十萬污女黑貓醬,3393,86,3,1,4,75.0%,11m
1067,3,流浪泰伦,3393,0,1,0,1,100.0%,53m
1067,3,[天府成都]路边一色狼,3393,30,1,2,3,33.3%,13m
1067,3,[sbcoys]pandasssss,3393,0,0,1,1,0.0%,8m
1073,2,IIIIIIIIIIII,3392,594,24,21,45,53.3%,23m
1073,2,[TPoA]星辰不及眉中山河,3392,378,14,15,29,48.3%,3m
1075,3,[TMUSC2]Empress,3391,0,1,1,2,50.0%,51m
1076,2,[蕙质兰心]呐呐呐,3390,0,1,0,1,100.0%,2m
1077,2,人族最强近战,3389,126,3,5,8,37.5%,10m
1077,3,[MRHJ]天王盖地虎,3389,0,1,0,1,100.0%,6m
1079,2,[Awyr]klim,3388,1600,205,187,392,52.3%,54m
1080,3,pppp,3387,299,11,13,24,45.8%,3m
1080,2,llllllllll,3387,199,6,4,10,60.0%,52m
1080,3,[1sA]llllllllllll,3387,0,0,1,1,0.0%,12m
1083,3,[B站T老师]TeacherT,3386,300,11,8,19,57.9%,55m
1083,2,[出兵大战萌新]哟哟哟,3386,258,9,15,24,37.5%,7m
1083,2,RAT,3386,179,4,7,11,36.4%,27m
1083,3,[Icycry]DeathKnight,3386,0,0,1,1,0.0%,50m
1087,3,您的智商已欠费,3385,194,9,7,16,56.2%,7m
1088,2,scfreu,3384,293,14,13,27,51.9%,14m
1088,3,LOVEzw,3384,189,9,4,13,69.2%,23m
1088,3,Elaina,3384,97,2,4,6,33.3%,21m
1091,2,[NYLLF]我很单纯,3383,982,72,85,157,45.9%,14m
1091,3,[喵星人]我猥琐我快乐,3383,0,1,0,1,100.0%,27m
1091,2,[屠夫预备队]SKTrealy,3383,0,1,0,1,100.0%,19m
1091,3,[星云际会]时光蓑湿,3383,0,0,4,4,0.0%,12m
1095,2,树杈,3382,411,40,37,77,51.9%,7m
1095,3,杰兰特,3382,60,3,2,5,60.0%,1m
1097,3,[皇家胜利者s]脸上修地堡,3381,140,5,2,7,71.4%,9m
1097,3,ziposcar,3381,0,4,1,5,80.0%,5m
1097,2,[张博文是只鸡]瞧尔萨斯,3381,0,1,0,1,100.0%,16m
1097,3,[孤独与烈酒]零功,3381,0,1,2,3,33.3%,13m
1101,2,neno,3380,350,25,37,62,40.3%,17m
1101,3,[Etd]EtdPGL,3380,143,7,2,9,77.8%,28m
1101,3,李清歌,3380,0,5,0,5,100.0%,14m
1101,2,xyfan,3380,44,2,1,3,66.7%,4m
1105,3,[汉堡FANS]cjcc,3378,349,13,8,21,61.9%,9m
1105,2,立华奏我老婆,3378,124,2,3,5,40.0%,4m
1107,3,[ACG系]凄隐落枫,3377,120,9,7,16,56.2%,51m
1107,2,点一下玩一年,3377,0,1,1,2,50.0%,17m
1109,3,钻钻钻钻钻,3376,990,38,34,72,52.8%,24m
1109,3,地锅排骨,3376,0,4,1,5,80.0%,25m
1109,3,鞭性茎肛,3376,88,4,2,6,66.7%,53m
1109,3,战神,3376,0,1,0,1,100.0%,11m
1113,3,oyoy,3375,121,6,2,8,75.0%,5m
1113,3,[PY交谊谐会]纯禽小畜男,3375,0,1,0,1,100.0%,23m
1113,3,[山西晋绥军]天宇,3375,0,0,1,1,0.0%,23m
1116,3,[打到你报警]bloodtear,3374,932,37,28,65,56.9%,16m
1116,2,LYQQ,3374,496,37,45,82,45.1%,17m
1116,3,[三浦透子]今天又是什么奶茶,3374,86,3,2,5,60.0%,51m
1116,3,[格里芬克鲁格]TosakaUCW,3374,0,1,0,1,100.0%,50m
1116,3,杀猪的,3374,0,0,1,1,0.0%,13m
1121,3,[血色雇佣兵]胖腿腿,3373,0,1,1,2,50.0%,21m
1121,3,Viva,3373,0,0,1,1,0.0%,55m
1123,3,[刺蛇互助社团]Demons,3372,360,12,10,22,54.5%,9m
1123,2,[羊驼驼]英雄王子,3372,310,12,17,29,41.4%,17m
1123,3,[桜公馆]新垣绫濑,3372,282,11,2,13,84.6%,7m
1123,1,[哔哩哔哩乾杯]艾尔必将光复,3372,0,1,0,1,100.0%,22m
1127,3,小迪大小姐,3371,192,8,4,12,66.7%,19m
1128,3,[x不打内战x]整活小王子,3370,1294,141,117,258,54.7%,8m
1128,2,[Beasty]simon,3370,1547,106,106,212,50.0%,55m
1128,3,[SCU]shaker,3370,86,4,3,7,57.1%,21m
1131,2,苏远烟,3369,1543,431,421,852,50.6%,11m
1131,3,汉堡哥哥丫霸,3369,394,15,11,26,57.7%,22m
1131,3,[鬼谷]氯化氢公主,3369,0,2,3,5,40.0%,8m
1131,3,[霸气军团]Cherry,3369,0,0,1,1,0.0%,5m
1135,3,[ZAS]Thymus,3368,30,2,5,7,28.6%,23m
1136,3,烤地瓜,3367,571,27,23,50,54.0%,55m
1136,2,[Holyam]霍恩海姆,3367,176,5,8,13,38.5%,7m
1136,3,[又高又硬]混元星际闪电鞭,3367,0,1,1,2,50.0%,12m
1136,2,[K39]keep,3367,0,0,1,1,0.0%,28m
1140,2,李信衡,3366,661,25,38,63,39.7%,15m
1140,3,[扫黄]打不来随便玩玩,3366,58,3,1,4,75.0%,8m
1142,3,[SoloAs]一束七教我玩神族,3365,139,7,5,12,58.3%,51m
1142,2,speqe,3365,90,6,7,13,46.2%,7m
1142,3,joker,3365,30,3,3,6,50.0%,24m
1142,3,[DukeA]Stork,3365,0,0,1,1,0.0%,4m
1146,3,[肉鸡的饲养]魔法少女言言酱,3364,30,2,1,3,66.7%,55m
1147,2,飞龙者,3363,203,8,3,11,72.7%,17m
1147,3,Walte,3363,30,2,3,5,40.0%,6m
1147,3,[肉鸡的饲养]踏剑寻昆仑,3363,0,0,1,1,0.0%,29m
1150,3,[SoloAs]白泽,3362,303,11,9,20,55.0%,3m
1150,2,[我们是无敌的]果断就会白给,3362,277,11,12,23,47.8%,22m
1150,3,[DSE]啵啵鸡,3362,97,2,1,3,66.7%,54m
1150,3,[中华兄弟会]我和黄哥击剑,3362,0,1,3,4,25.0%,21m
1154,3,妍妍的小玉兔,3361,30,2,3,5,40.0%,51m
1155,2,[Star丶P]Leviathan,3360,118,4,4,8,50.0%,23m
1155,3,我是菜鸡,3360,120,3,0,3,100.0%,55m
1155,3,[温柔兔公主]我爱修地堡,3360,0,0,1,1,0.0%,25m
1158,3,[Embers]YDM,3359,86,7,2,9,77.8%,21m
1159,2,[神子]一个可爱的队友,3358,1595,67,55,122,54.9%,20m
1159,3,[不爽就干]水月年华,3358,0,1,0,1,100.0%,23m
1161,2,觉醒,3356,219,8,11,19,42.1%,24m
1161,2,不死鸟,3356,60,7,4,11,63.6%,20m
1161,3,[Ziyan]Wayne,3356,30,2,2,4,50.0%,50m
1164,3,QuadStacker,3355,88,4,2,6,66.7%,18m
1164,3,[0o0]GYGT,3355,0,1,0,1,100.0%,10m
1166,3,[SCL]小辉,3354,829,34,22,56,60.7%,9m
1166,3,[济南]黄旭东,3354,0,1,0,1,100.0%,12m
1168,3,LycheeFM,3353,1259,90,82,172,52.3%,6m
1168,3,[我是龙的传人]唐纳德川普,3353,0,1,0,1,100.0%,13m
1170,3,一二三四五六七,3352,444,17,8,25,68.0%,22m
1170,2,[o瞳孔o]战士,3352,88,2,4,6,33.3%,27m
1170,3,MisakaMikoto,3352,0,1,0,1,100.0%,21m
1170,3,IIIIII,3352,30,1,1,2,50.0%,23m
1174,3,sksuzakufan,3351,0,3,4,7,42.9%,6m
1175,2,隐约雷鸣阴霾天空,3350,1559,322,333,655,49.2%,17m
1175,3,Naxc,3350,689,31,22,53,58.5%,55m
1175,2,WDDW,3350,200,16,15,31,51.6%,19m
1175,3,DaNn,3350,0,4,2,6,66.7%,25m
1175,3,[浪啊浪]jack,3350,30,2,5,7,28.6%,28m
1175,3,人族就输不了,3350,60,2,6,8,25.0%,22m
1175,2,太上忘情豆,3350,0,1,0,1,100.0%,15m
1175,3,一拳超人,3350,0,0,1,1,0.0%,53m
1183,3,[基佬协会]这周丶曰你有空吗,3349,686,29,16,45,64.4%,50m
1183,3,MagejiTerren,3349,0,1,0,1,100.0%,20m
1183,3,呼叫舰队,3349,0,0,1,1,0.0%,10m
1186,3,HoNyarara,3348,348,13,1,14,92.9%,6m
1186,3,妖妖灵,3348,0,1,0,1,100.0%,12m
1186,3,Zen,3348,0,0,1,1,0.0%,11m
1189,3,[四叶草]花落影榭,3347,114,4,2,6,66.7%,3m
1189,2,NZyan,3347,181,4,4,8,50.0%,52m
1191,3,摇滚男孩,3346,314,14,8,22,63.6%,8m
1191,2,[东大电竞]Dark,3346,226,8,15,23,34.8%,10m
1193,2,[一XX一]胜西汉森宝,3345,1352,108,111,219,49.3%,52m
1193,3,随机选手,3345,947,49,37,86,57.0%,7m
1193,3,总有刁民偷袭朕丶,3345,0,1,0,1,100.0%,26m
1193,2,[鸽子窝]我不是富翁,3345,0,1,0,1,100.0%,16m
1197,3,我是一只小小鸟,3343,1388,78,76,154,50.6%,19m
1197,3,BoxeR,3343,148,6,5,11,54.5%,10m
1199,3,朱雀星君,3342,261,8,8,16,50.0%,24m
1199,3,[KPG2]隐刀我是你爹,3342,143,6,2,8,75.0%,12m
1201,1,[悟了]哔哩哔哩丶森林猫,3341,0,3,2,5,60.0%,59m
1202,3,莫知我哀,3340,148,8,6,14,57.1%,11m
1202,3,起名无能,3340,0,1,5,6,16.7%,50m
1204,2,大梦谁先觉,3339,1527,103,110,213,48.4%,14m
1204,3,为了女王,3339,635,33,31,64,51.6%,18m
1204,3,[IMRTS]傲然诶,3339,292,13,7,20,65.0%,16m
1204,3,[lSCVl]zxxy,3339,117,3,0,3,100.0%,25m
1208,3,Critical,3338,88,4,4,8,50.0%,55m
1209,2,桃乃木香奈儿,3336,161,4,2,6,66.7%,52m
1209,3,[最弱的玩家]死神,3336,0,0,1,1,0.0%,14m
1211,2,[大东营帝国]上岸成功,3335,1534,122,134,256,47.7%,52m
1211,3,十六夜不爱吃宵夜,3335,30,1,1,2,50.0%,12m
1211,3,[灬红萌馆灬]warm,3335,0,1,4,5,20.0%,23m
1214,3,你拿什么感同身受,3334,0,1,0,1,100.0%,10m
1214,1,[Do]帝王,3334,0,1,1,2,50.0%,20m
1214,3,raincow,3334,30,1,2,3,33.3%,51m
1217,2,llllllllllll,3333,1542,129,120,249,51.8%,13m
1217,2,HAIILO,3333,472,19,25,44,43.2%,12m
1217,3,[闪电伍连鞭]贝塔,3333,456,16,18,34,47.1%,3m
1217,3,[XXHZ25]Joker,3333,208,7,9,16,43.8%,11m
1217,3,[Fish闪闪]Sunrise,3333,119,4,3,7,57.1%,29m
1217,3,[Beasty]混元星际门诺诺,3333,0,0,1,1,0.0%,9m
1223,3,[茶队星分部]雨过添晴,3332,326,14,7,21,66.7%,16m
1223,1,[禽禽禽]大帝丶屠鸡虐狗,3332,0,1,0,1,100.0%,1h
1225,2,[文韬武略]憨太叁叁,3331,1198,54,58,112,48.2%,3m
1225,3,[浙江大学战队]混元星际掌门人,3331,202,8,4,12,66.7%,28m
1227,3,zergling,3330,58,2,1,3,66.7%,18m
1228,1,[盖世双谐]最帅男公关,3329,87,3,4,7,42.9%,13m
1229,2,辞尘,3328,285,10,6,16,62.5%,10m
1229,3,暴风小蟹,3328,86,3,4,7,42.9%,9m
1231,2,[开始掠夺]黑珍珠号的小弟,3327,1012,39,45,84,46.4%,54m
1231,3,Berlinsyf,3327,30,2,0,2,100.0%,24m
1233,3,zero,3326,0,1,0,1,100.0%,15m
1233,3,luck,3326,0,1,1,2,50.0%,55m
1233,1,上户彩,3326,0,1,1,2,50.0%,8m
1236,3,[同济大学]长门秘书舰,3325,0,1,0,1,100.0%,7m
1237,3,苇怡是炜青的唯一,3324,843,43,26,69,62.3%,55m
1237,3,Cypher,3324,0,0,1,1,0.0%,5m
1239,1,[KPG]NCA,3323,0,3,2,5,60.0%,10m
1240,3,天机,3322,1002,68,46,114,59.6%,50m
1240,3,stanley,3322,58,6,2,8,75.0%,24m
1240,3,[八一六]Seven,3322,97,3,4,7,42.9%,4m
1240,1,星际迷航记,3322,0,1,0,1,100.0%,1h
1244,3,星星,3321,1640,284,260,544,52.2%,10m
1244,3,伊卡洛斯,3321,418,13,17,30,43.3%,10m
1244,3,Crema,3321,150,7,8,15,46.7%,8m
1244,3,[咕咕学院]幻想乡乡长,3321,140,5,3,8,62.5%,55m
1244,3,小色可乐,3321,0,0,2,2,0.0%,53m
1249,3,[火焰雷兽]你运营有点慢,3320,60,2,5,7,28.6%,12m
1249,3,Podeos,3320,0,1,0,1,100.0%,10m
1249,3,[EmPirE]DragonsnowCN,3320,0,0,1,1,0.0%,50m
1252,3,Xuan,3319,60,3,2,5,60.0%,4m
1252,3,[HK丶S]屠杀弟弟,3319,119,2,2,4,50.0%,5m
1254,2,Apple,3318,94,2,2,4,50.0%,14m
1254,2,[不打内战随机]粑本,3318,112,2,4,6,33.3%,29m
1254,3,Leviathan,3318,0,0,1,1,0.0%,21m
1257,3,Matin,3317,207,9,4,13,69.2%,4m
1257,1,醉剑,3317,0,4,1,5,80.0%,59m
1257,3,电脑,3317,0,4,2,6,66.7%,30m
1257,3,[希靈使徒]秋月爱莉,3317,0,1,1,2,50.0%,5m
1261,3,[扭曲魔口]waterblue,3316,146,5,6,11,45.5%,53m
1261,3,[东大电竞]peter,3316,0,0,1,1,0.0%,3m
1261,1,啊这,3316,0,0,1,1,0.0%,1h
1264,3,[养生会馆]世界核平,3315,900,32,36,68,47.1%,3m
1264,1,小羊羊,3315,281,9,12,21,42.9%,54m
1264,3,[GaHo]liar,3315,260,9,15,24,37.5%,13m
1264,3,暴雪令人失望,3315,0,0,2,2,0.0%,12m
1268,2,[千痔王]运营怪,3314,1534,246,251,497,49.5%,25m
1268,3,IIIIIIII,3314,200,7,4,11,63.6%,51m
1270,3,[月野兔]不会打神族,3313,97,5,2,7,71.4%,14m
1270,3,miku,3313,0,0,1,1,0.0%,53m
1272,2,[不要TVT]朱晨文的账号,3312,837,227,207,434,52.3%,8m
1272,3,MagicBlue,3312,717,28,18,46,60.9%,6m
1272,3,[情谊至上]曲线救国,3312,455,20,4,24,83.3%,11m
1272,3,[holyhp]恶魔之泪,3312,30,2,2,4,50.0%,23m
1276,2,JackBauer,3311,42,2,1,3,66.7%,23m
1276,2,[禽禽禽]全太阳,3311,44,1,4,5,20.0%,18m
1278,3,[Beastp]菱葉,3310,1342,139,128,267,52.1%,29m
1278,3,Twister,3310,0,1,0,1,100.0%,16m
1280,1,静静,3309,176,6,3,9,66.7%,50m
1280,3,[天使心立华奏]Kanade,3309,0,1,0,1,100.0%,16m
1280,3,[IGS]llllllllllll,3309,0,0,1,1,0.0%,50m
1283,3,Async,3308,211,6,3,9,66.7%,24m
1283,3,Chembuster,3308,142,6,4,10,60.0%,9m
1283,3,妈咪妈咪哄,3308,0,3,2,5,60.0%,54m
1283,1,[UNDEAT]Nazul,3308,97,2,0,2,100.0%,21m
1287,3,Tyr,3307,217,6,7,13,46.2%,13m
1287,3,粉笔绕你画圈圈,3307,0,0,1,1,0.0%,51m
1289,2,lllllllll,3306,1641,85,89,174,48.9%,54m
1289,3,翱玥七星,3306,216,42,34,76,55.3%,50m
1289,3,[CNboi]屠夫凯文,3306,214,8,11,19,42.1%,24m
1289,3,养生星际,3306,118,5,2,7,71.4%,7m
1289,3,开门暗影卫队,3306,30,2,2,4,50.0%,6m
1294,3,[最菜神王]lonestar,3305,242,9,8,17,52.9%,20m
1294,3,星际这么难打毛,3305,30,2,0,2,100.0%,20m
1294,3,狗哥且战且退,3305,0,1,0,1,100.0%,12m
1297,2,[Anticw]星际天涯,3304,705,233,234,467,49.9%,10m
1298,3,SilCreep,3303,498,24,12,36,66.7%,26m
1298,3,[Fisher]儒花,3303,287,10,11,21,47.6%,55m
1298,3,[北部战区]SoS,3303,30,1,1,2,50.0%,9m
1298,3,[holyhp]Gostop,3303,0,0,1,1,0.0%,6m
1302,3,不惑,3302,1157,133,117,250,53.2%,12m
1302,1,[夏恋]卡兰,3302,0,4,1,5,80.0%,35m
1302,3,Urun,3302,58,3,0,3,100.0%,22m
1302,3,[Beasty]掠天,3302,0,1,0,1,100.0%,10m
1302,3,[麻酱罐]牛肉味麻酱,3302,0,0,1,1,0.0%,54m
1307,3,XYfans,3301,727,38,39,77,49.4%,18m
1307,3,[Rich]andyoungcrew,3301,376,14,8,22,63.6%,25m
1307,3,[一束七粉丝团]哥本含根,3301,144,6,3,9,66.7%,13m
1307,3,好兄弟一起送,3301,86,4,5,9,44.4%,6m
1307,3,[LDP]imbzp,3301,121,3,2,5,60.0%,21m
1307,3,[炮火46]吃粑粑,3301,30,1,1,2,50.0%,17m
1313,3,[薄暮之光]Bruce,3300,595,47,47,94,50.0%,54m
1313,3,[Serica]irohia,3300,696,29,15,44,65.9%,29m
1313,3,土豆受害者,3300,0,4,1,5,80.0%,24m
1313,3,[赞助商我大哥]大寒无雪,3300,88,3,4,7,42.9%,6m
1313,3,就想和你爽一下,3300,0,0,1,1,0.0%,6m
1318,3,[萝莉之芯]影月仇,3299,968,37,36,73,50.7%,53m
1318,1,君忆嫤,3299,295,12,7,19,63.2%,14m
1318,3,黄婷婷的口音饭,3299,269,9,6,15,60.0%,23m
1318,3,llllllllllll,3299,146,6,5,11,54.5%,24m
1318,3,[Timbar]我的皮肤漂亮吗,3299,0,1,0,1,100.0%,55m
1318,1,zest,3299,0,0,1,1,0.0%,17m
1324,1,[莽夫智障团]跳跃猫杰西,3298,0,1,0,1,100.0%,1h
1325,3,sdy,3297,163,20,21,41,48.8%,23m
1325,3,lolo,3297,249,10,7,17,58.8%,9m
1327,3,我准备好了,3296,716,43,43,86,50.0%,13m
1327,3,[兆景埋土大学]Rinne,3296,90,4,5,9,44.4%,27m
1327,3,IIIIIIIIIIII,3296,0,1,1,2,50.0%,10m
1327,1,[HxEro]帕瓦,3296,0,0,1,1,0.0%,28m
1331,3,Innochicken,3295,264,9,11,20,45.0%,50m
1331,3,[M8]三五磷酸二酯键,3295,0,0,1,1,0.0%,13m
1333,3,[谐神]southred,3294,0,0,1,1,0.0%,8m
1334,3,[SCJWJ3]Stormrage,3293,244,9,5,14,64.3%,24m
1334,3,Prophet,3293,120,5,4,9,55.6%,17m
1334,2,[GO丨]Olajuwon,3293,135,3,4,7,42.9%,4m
1337,2,大野智,3292,951,89,99,188,47.3%,29m
1337,3,[SoloAs]Mercy,3292,92,4,4,8,50.0%,26m
1339,3,darkcarrot,3291,712,27,21,48,56.2%,8m
1339,3,[miku守护]killer,3291,0,1,0,1,100.0%,20m
1339,3,星际之旅雷应昊,3291,0,0,1,1,0.0%,16m
1342,3,紫轩,3290,157,5,3,8,62.5%,29m
1342,3,觉悟的新手,3290,0,1,0,1,100.0%,10m
1344,3,[专打嘤嘤怪]希尔瓦娜斯,3289,0,1,0,1,100.0%,51m
1344,3,SBZ,3289,30,1,2,3,33.3%,15m
1344,3,[鸡会友狗服人]饼妞,3289,0,0,1,1,0.0%,25m
1344,3,不动游走,3289,0,0,1,1,0.0%,50m
1348,3,神鬼不散,3288,295,11,5,16,68.8%,2m
1348,3,[Beastp]夜听风,3288,0,2,3,5,40.0%,25m
1350,3,IGJACKlove,3287,428,20,1,21,95.2%,20m
1350,3,冰封瘟疫,3287,169,8,9,17,47.1%,5m
1350,2,羽幕丶,3287,139,3,1,4,75.0%,2m
1350,3,llllllllllll,3287,0,0,1,1,0.0%,50m
1350,3,我是小学生,3287,0,0,2,2,0.0%,16m
1355,3,[耀眼的青春]飞雪再临之时,3286,493,21,20,41,51.2%,26m
1355,3,[BHH]llllllllllll,3286,298,11,7,18,61.1%,15m
1355,1,[特种兵营]小新,3286,0,1,0,1,100.0%,2m
1355,3,一拳超人,3286,30,1,2,3,33.3%,9m
1355,3,[RyH]Sweetiey,3286,0,0,1,1,0.0%,21m
1360,3,九吹帝,3285,0,1,1,2,50.0%,3m
1361,3,半壶纱,3284,0,1,1,2,50.0%,13m
1361,3,锋寒,3284,0,1,1,2,50.0%,53m
1363,3,Demon,3283,345,11,12,23,47.8%,21m
1363,3,Yoki,3283,0,1,0,1,100.0%,53m
1365,3,yxiaowai,3282,144,7,3,10,70.0%,29m
1366,2,realgun,3281,900,144,139,283,50.9%,53m
1366,3,[打星际快乐么]LiArRn,3281,252,12,6,18,66.7%,23m
1366,3,[深远Hist]Wakatsuki,3281,246,8,14,22,36.4%,4m
1366,3,[零柒零柒]liggia,3281,0,0,1,1,0.0%,55m
1366,3,纵横彡,3281,0,0,1,1,0.0%,6m
1371,3,福建任贤齐,3280,608,32,28,60,53.3%,21m
1372,3,reality,3279,574,32,30,62,51.6%,23m
1372,3,[MoyuAn]MoyuAn,3279,310,23,31,54,42.6%,12m
1372,3,larice,3279,30,1,2,3,33.3%,50m
1372,2,[哔翻天梯鸡]妲己终妖,3279,0,0,1,1,0.0%,16m
1376,3,[净罪的殉仪]KousakaReina,3278,30,4,4,8,50.0%,26m
1377,3,[NVKR]虫族肄业生,3277,1022,45,27,72,62.5%,16m
1377,2,玩游戏生气不值得,3277,802,32,34,66,48.5%,51m
1377,3,飘叶浮云,3277,280,10,11,21,47.6%,24m
1377,3,[Shawk]有时,3277,0,1,0,1,100.0%,11m
1377,3,[鬼杀队]某科学的我妻善逸,3277,97,1,7,8,12.5%,17m
1382,3,云淡风轻,3276,30,2,0,2,100.0%,5m
1383,3,[OIO]蚂菲亚,3275,418,15,16,31,48.4%,16m
1383,3,[tyyt]llIIIIlllIII,3275,116,7,3,10,70.0%,51m
1383,3,vircent,3275,109,5,5,10,50.0%,51m
1386,1,[最强灬狼牙队]YHW,3274,96,4,1,5,80.0%,51m
1387,1,慕容冷雪,3273,0,3,3,6,50.0%,1h
1388,2,[慢手e族]韬略成败在人谋,3272,1500,104,110,214,48.6%,19m
1388,2,天煞孤星,3272,542,18,35,53,34.0%,10m
1388,3,[Vgirls]暗夜中的杀手,3272,30,3,4,7,42.9%,11m
1391,2,DingF,3271,188,7,7,14,50.0%,14m
1391,2,[Shawk]星际真难玩,3271,129,3,0,3,100.0%,9m
1391,3,CazzForever,3271,0,2,3,5,40.0%,9m
1394,3,冥想神族鸦喵喵,3270,1531,60,58,118,50.8%,7m
1394,3,眉如远山,3270,90,3,5,8,37.5%,21m
1394,3,[TNT]nicole,3270,58,3,8,11,27.3%,18m
1394,1,TOSS,3270,0,2,0,2,100.0%,21m
1394,3,WhackingLove,3270,0,1,5,6,16.7%,23m
1399,3,[CNboi]线影,3268,114,5,1,6,83.3%,6m
1399,3,如东掘港人,3268,143,5,5,10,50.0%,14m
1399,1,knk,3268,139,2,3,5,40.0%,6m
1402,3,鹿目圆,3267,1404,69,44,113,61.1%,8m
1402,3,[我队伍很强大]立华奏我老婆,3267,509,20,11,31,64.5%,9m
1402,3,[丨SLT丨]Magejiterran,3267,311,12,1,13,92.3%,13m
1402,1,不二阿,3267,0,5,0,5,100.0%,40m
1402,1,艾尔必将沦陷,3267,0,3,2,5,60.0%,2m
1402,3,[GDG]剑不归,3267,0,0,1,1,0.0%,6m
1408,2,可能比你强点,3266,237,9,0,9,100.0%,29m
1408,3,杨嘉禾,3266,0,1,0,1,100.0%,20m
1410,2,[艾萌之友]会飞的苜蓿,3265,1624,117,130,247,47.4%,19m
1410,3,光明的影子,3265,1370,96,97,193,49.7%,21m
1410,3,我想你了,3265,580,22,14,36,61.1%,4m
1410,1,llllllllllll,3265,283,13,8,21,61.9%,50m
1410,3,shadowking,3265,222,8,8,16,50.0%,3m
1410,3,[Solo]弹指间湮灭,3265,163,4,1,5,80.0%,3m
1416,2,PBXX,3264,162,5,4,9,55.6%,10m
1416,1,[蒂亞]特特,3264,0,4,1,5,80.0%,20m
1416,3,[QWQa]今日解签宜下江南,3264,143,3,2,5,60.0%,22m
1416,3,[刺蛇互助社团]众星,3264,97,2,0,2,100.0%,17m
1416,3,[Maiar]時崎狂三,3264,0,0,1,1,0.0%,50m
1421,3,[Tgirl]放纵的青春,3263,354,15,11,26,57.7%,22m
1421,3,[一花一世界]隐士,3263,257,10,10,20,50.0%,24m
1423,3,[六芒星s]渺远时刻,3262,0,1,0,1,100.0%,28m
1424,3,[C06904]sky,3260,359,15,7,22,68.2%,7m
1424,2,kanGaXX,3260,392,14,25,39,35.9%,8m
1424,3,[莽哥]英雄堂口,3260,166,8,2,10,80.0%,14m
1424,3,[谢绝反击]TOTHEMOON,3260,142,3,2,5,60.0%,5m
1424,2,[神灵飞电]雪儿,3260,0,0,1,1,0.0%,16m
1429,3,别让我看见神族,3259,711,50,29,79,63.3%,6m
1429,3,[孙一峰小迷妹]不敢晚上上厕所,3259,176,7,6,13,53.8%,22m
1429,3,[久美子棉纺厂]山鸡哥,3259,114,4,6,10,40.0%,30m
1429,2,只会打一波,3259,127,3,0,3,100.0%,9m
1429,3,没有名字不能玩,3259,0,0,1,1,0.0%,21m
1434,3,富贵儿,3258,0,4,1,5,80.0%,20m
1434,2,[TSOD]掠夺者饿狼,3258,0,3,2,5,60.0%,1h
1436,1,nada,3257,119,5,3,8,62.5%,1h
1436,3,IIIIIIIIIII,3257,38,2,1,3,66.7%,29m
1436,3,[CAS]河神,3257,0,0,1,1,0.0%,11m
1436,3,[红烛昏罗帐]貳拾肆,3257,0,0,1,1,0.0%,55m
1440,3,[久美子珠宝]渣渣徽,3256,205,11,8,19,57.9%,51m
1440,3,[核平宇宙]冠状毒爆虫,3256,262,10,8,18,55.6%,26m
1442,3,养生星际,3255,988,39,37,76,51.3%,51m
1442,1,illusion,3255,0,1,0,1,100.0%,2m
1444,2,[AGC]华南施工,3254,1068,194,178,372,52.2%,10m
1444,3,星际联盟司令官,3254,104,11,12,23,47.8%,12m
1446,2,[鬼谷]刺星,3253,1321,165,165,330,50.0%,20m
1446,2,瓦塔诺,3253,1532,66,73,139,47.5%,20m
1446,3,[白银联盟]aaa,3253,101,4,4,8,50.0%,26m
1446,2,菜鸡萌新,3253,0,1,0,1,100.0%,28m
1450,3,[一等星]耂婆霞,3252,1587,119,115,234,50.9%,12m
1450,3,[一戳一蹦跶]桃子,3252,0,1,0,1,100.0%,6m
1452,3,[F2兄弟]星咏者,3251,1043,94,81,175,53.7%,50m
1452,3,[叫我兔本]mikasa,3251,30,1,4,5,20.0%,10m
1454,3,llllllllllll,3250,763,30,24,54,55.6%,26m
1454,3,[gusl]PrinCess,3250,342,13,8,21,61.9%,12m
1454,3,长野原美绪,3250,122,7,7,14,50.0%,10m
1454,1,黎恩舒华泽,3250,0,5,1,6,83.3%,44m
1454,3,[神之族]黑火,3250,97,5,3,8,62.5%,3m
1459,2,[菜的没人带]大佬带带我啊,3249,991,286,270,556,51.4%,14m
1459,2,人帅何须艾迪拽,3249,1542,237,235,472,50.2%,3m
1459,3,一般性与大众性,3249,1210,70,67,137,51.1%,51m
1459,3,偶尔放大招,3249,468,27,30,57,47.4%,54m
1459,3,FrostNova,3249,420,15,12,27,55.6%,26m
1459,3,IIIIIIIIIIII,3249,335,13,10,23,56.5%,9m
1459,3,Tempest,3249,0,2,3,5,40.0%,21m
1459,3,[葛温王下骑士]卫宫士郎,3249,0,0,1,1,0.0%,21m
1459,3,[辩证法]徐政委遛弯,3249,0,0,7,7,0.0%,28m
1468,2,我是一只鸡,3248,1116,451,454,905,49.8%,10m
1468,3,[SC2XBY]HunKey,3248,578,46,43,89,51.7%,6m
1468,2,[wwsixi]九霄,3248,346,15,2,17,88.2%,4m
1468,3,[第八舰队丶]牛子哥,3248,170,7,11,18,38.9%,53m
1468,3,[暴雪三十一队]神兽,3248,30,2,2,4,50.0%,50m
1468,2,XSGing,3248,0,0,1,1,0.0%,53m
1468,3,[火焰雷兽]wlikel,3248,0,0,1,1,0.0%,14m
1475,3,[盛先生粉丝团]求老仙奶诺不开心,3247,358,14,5,19,73.7%,22m
1475,3,那棵树生气了,3247,188,12,9,21,57.1%,13m
1475,3,[DC战队]最卖萌的吊丝,3247,86,3,1,4,75.0%,6m
1475,3,海因里希,3247,0,1,4,5,20.0%,9m
1479,2,[又没气啦]Brave,3246,91,1,1,2,50.0%,11m
1479,3,IIIIIIIIIIII,3246,0,0,1,1,0.0%,19m
1479,3,[我高贵的族人]达拉蹦吧,3246,0,0,3,3,0.0%,24m
1482,3,[1sA]EtdMaoJin,3245,276,59,42,101,58.4%,13m
1482,3,innovation,3245,453,23,24,47,48.9%,19m
1482,2,DaoFengTD,3245,30,5,7,12,41.7%,53m
1482,3,大花花,3245,30,1,2,3,33.3%,24m
1486,1,[Sc养老]过尘,3244,244,8,9,17,47.1%,6m
1486,3,IIIIIIIIIIII,3244,58,3,0,3,100.0%,25m
1488,3,[Borne]IIIIIIIIIIII,3243,380,14,6,20,70.0%,55m
1488,3,零海,3243,114,4,5,9,44.4%,27m
1488,1,[NXGZ]GoldenWillow,3243,95,2,2,4,50.0%,35m
1488,3,生死,3243,0,0,1,1,0.0%,13m
1488,3,杀狗的,3243,0,0,1,1,0.0%,54m
1493,3,[可我没有狗]我的狗狗叫马达,3242,994,161,159,320,50.3%,18m
1493,3,[北极光小组]我将再次修起地堡,3242,493,19,11,30,63.3%,15m
1493,3,TaeYeoN,3242,157,4,5,9,44.4%,13m
1493,3,[柠檬保护协会]SuperLemon,3242,0,3,2,5,60.0%,26m
1493,1,iiiiiiii,3242,0,1,0,1,100.0%,17m
1498,3,[火影何平]TSTFT,3241,0,0,1,1,0.0%,8m
1498,3,[昆明RANK]Gwagen,3241,0,0,1,1,0.0%,12m
1500,3,[Fear]Angle,3240,0,1,0,1,100.0%,15m
1500,3,cynicism,3240,97,1,3,4,25.0%,12m
1502,3,[抱舔天物]风中飘落的叶,3239,1382,80,72,152,52.6%,26m
1502,3,IIIIII,3239,146,5,4,9,55.6%,5m
1504,3,耗子尾汁,3238,563,27,10,37,73.0%,16m
1504,3,[Rhusky]化学课呆表,3238,396,26,22,48,54.2%,13m
1504,3,[嫂子夸我真棒]皮皮虾我们走,3238,0,1,0,1,100.0%,17m
1507,2,霜水明霄,3237,0,5,0,5,100.0%,1h
1507,2,册花,3237,0,5,0,5,100.0%,43m
1507,3,大连狗哥,3237,62,5,6,11,45.5%,28m
1507,3,[逗帝]萧炎,3237,30,4,2,6,66.7%,16m
1507,3,[耶耶]Spec,3237,0,0,1,1,0.0%,22m
1512,3,[超级二五仔]NaviSimple,3236,189,6,2,8,75.0%,20m
1512,3,Dust,3236,0,1,0,1,100.0%,13m
1514,3,龙卷风摧毁停车场,3235,146,6,6,12,50.0%,13m
1514,3,IIIIIIIIIIII,3235,197,5,3,8,62.5%,24m
1514,3,[星河气象学院]yyyyy,3235,0,0,1,1,0.0%,3m
1514,1,[魔法少女小屋]魔法少女软芳酱,3235,0,0,1,1,0.0%,21m
1518,2,统一,3234,526,26,38,64,40.6%,20m
1518,3,[SCAP]arthursaber,3234,114,5,1,6,83.3%,26m
1518,3,想好名字在重新改,3234,116,4,9,13,30.8%,3m
1518,3,Batman,3234,0,3,2,5,60.0%,13m
1518,3,[JIMAIR]DawnFox,3234,0,0,1,1,0.0%,23m
1523,3,[清梦压星河]南蛮入侵侵侵侵侵,3233,1544,138,133,271,50.9%,56m
1523,3,IIIIIIIIIIII,3233,558,24,18,42,57.1%,25m
1523,3,[28CM]有蝠同享,3233,122,9,3,12,75.0%,53m
1523,3,[HeroZP]无限寂寥,3233,226,8,9,17,47.1%,9m
1523,2,SKTone,3233,226,7,6,13,53.8%,5m
1523,3,逆魔天狂,3233,120,4,9,13,30.8%,6m
1523,3,MonkeyKing,3233,0,1,0,1,100.0%,21m
1530,3,[哔哩哔哩乾杯]无有才德,3231,416,15,14,29,51.7%,21m
1530,3,兰陵笑笑生,3231,390,14,16,30,46.7%,6m
1530,2,易水寒亭,3231,0,1,2,3,33.3%,52m
1533,2,ragnarok,3230,0,4,1,5,80.0%,1h
1533,3,[TNLet]想想花花会怎么做,3230,30,2,0,2,100.0%,3m
1533,3,[青莲剑阁]taoist,3230,0,1,0,1,100.0%,51m
1533,3,haha,3230,0,1,0,1,100.0%,9m
1533,2,[Ours]阿西吧,3230,36,1,3,4,25.0%,22m
1538,1,[希靈使徒]Raven,3229,379,18,5,23,78.3%,16m
1538,3,蛭子小比奈,3229,402,15,20,35,42.9%,19m
1538,1,[刺蛇互助协会]索然无味刺蛇娘,3229,94,1,1,2,50.0%,7m
1541,3,洒泪,3228,60,3,1,4,75.0%,12m
1542,3,无名游魂,3227,0,1,0,1,100.0%,12m
1542,3,砖家叫兽,3227,0,0,1,1,0.0%,23m
1544,3,QINGQING,3226,1604,339,314,653,51.9%,3m
1544,3,往后余生,3226,883,50,33,83,60.2%,7m
1544,3,莫比迪克,3226,654,24,28,52,46.2%,10m
1544,3,泉此方,3226,196,9,5,14,64.3%,5m
1544,3,Doug,3226,121,6,3,9,66.7%,2m
1544,3,这馒头没馅儿,3226,0,5,2,7,71.4%,26m
1544,2,Jingyu,3226,0,4,1,5,80.0%,33m
1544,3,[花开彼岸天]尔等有罪,3226,30,2,3,5,40.0%,4m
1544,3,[Icycry]simphunter,3226,30,1,2,3,33.3%,11m
1553,3,吾儿丨旭东,3225,730,43,46,89,48.3%,19m
1553,3,[uEstc]电子科大美女多,3225,346,12,20,32,37.5%,16m
1553,2,[TPoA]laplace,3225,0,2,3,5,40.0%,22m
1553,3,拉顿哈给顿,3225,30,1,1,2,50.0%,26m
1553,3,九十九遊馬,3225,30,1,6,7,14.3%,6m
1553,2,[朝鮮人民軍]谁家牲口,3225,0,0,1,1,0.0%,28m
1559,2,[X英雄圣域X]潇湘月影,3224,105,2,2,4,50.0%,56m
1559,3,大佬让我一把,3224,0,1,0,1,100.0%,24m
1559,2,[WIE]Colin,3224,0,0,1,1,0.0%,2m
1562,2,菜王,3222,1540,56,66,122,45.9%,8m
1562,1,星际与魔兽的区别,3222,143,5,2,7,71.4%,1h
1564,3,羲哥不要,3221,30,2,6,8,25.0%,18m
1564,1,老子打孔子,3221,0,1,0,1,100.0%,21m
1566,3,[HZNU]寂灭原子弹,3220,1339,81,77,158,51.3%,4m
1567,3,[头文字TB]DUTY,3219,1423,212,205,417,50.8%,15m
1567,2,llllllllllll,3219,178,9,10,19,47.4%,10m
1567,3,[破落的灵魂]冰忆丶飘,3219,140,6,6,12,50.0%,51m
1567,3,llllllllllll,3219,58,3,1,4,75.0%,12m
1567,3,[秋毫]如水的深蓝,3219,0,1,0,1,100.0%,3m
1567,1,[幽明异路]SuchLife,3219,0,0,1,1,0.0%,2m
1573,3,THOSO,3218,589,23,20,43,53.5%,21m
1573,3,[YINGJI]龙井茶,3218,182,7,10,17,41.2%,6m
1573,3,yuriyuri,3218,124,4,0,4,100.0%,6m
1573,3,[刑事组之虎]aoao,3218,94,3,9,12,25.0%,23m
1573,3,[Vgirls]光复艾尔的土间埋,3218,120,2,2,4,50.0%,10m
1573,3,Cloudychang,3218,0,0,1,1,0.0%,55m
1579,3,忠犬洪七公,3217,360,15,5,20,75.0%,3m
1579,3,Ttrash,3217,259,9,3,12,75.0%,15m
1579,2,[RHODE]Genro,3217,232,7,5,12,58.3%,53m
1579,2,[萨尔那加之刃]tourist,3217,189,6,4,10,60.0%,11m
1583,3,山莴苣苦素,3216,297,9,11,20,45.0%,55m
1584,3,请不要,3215,203,16,18,34,47.1%,24m
1584,2,永远有多远嘞,3215,95,5,1,6,83.3%,1h
1584,2,[是嫂子自愿的]量子二踢脚,3215,0,4,1,5,80.0%,40m
1584,2,xinzealot,3215,96,4,2,6,66.7%,43m
1584,3,[不怕念起]孙浩淼,3215,0,1,0,1,100.0%,27m
1584,2,[最菜战队]iloveyiming,3215,40,1,3,4,25.0%,11m
1584,3,llllllllllll,3215,0,0,1,1,0.0%,5m
1591,1,[星际鸽子组]天之云片,3214,257,10,10,20,50.0%,13m
1592,1,袋鼠,3213,163,6,2,8,75.0%,1h
1592,2,吉格,3213,134,3,6,9,33.3%,8m
1592,3,解冻,3213,0,1,0,1,100.0%,28m
1592,3,[CNboys]Linford,3213,0,0,1,1,0.0%,13m
1592,3,[残疾人康复院]yawnzhang,3213,0,0,2,2,0.0%,6m
1597,3,[大威天龙oc]闲卿,3212,249,12,11,23,52.2%,3m
1597,1,YuMingKo,3212,0,0,1,1,0.0%,35m
1599,2,star,3211,720,39,44,83,47.0%,13m
1599,3,[mantis]天灾刺蛇,3211,144,5,12,17,29.4%,16m
1599,1,[瘾大眼瞎]TATQwQ,3211,134,4,2,6,66.7%,51m
1599,3,[刺蛇互助天团]Yuna,3211,30,2,1,3,66.7%,5m
1599,1,[哔哩哔哩乾杯]Corrupt,3211,0,1,5,6,16.7%,1h
1599,3,[这人是菜鸡]我是鸽手,3211,0,0,1,1,0.0%,53m
1605,3,[网瘾主治医师]杨叔,3210,920,35,33,68,51.5%,18m
1605,3,sea,3210,868,31,32,63,49.2%,24m
1605,3,[Fear]pink,3210,254,10,9,19,52.6%,13m
1605,3,来跳我,3210,142,3,1,4,75.0%,3m
1609,2,追猎骑脸怎么输,3209,0,4,1,5,80.0%,1h
1609,1,[虚拟歌手团体]乐正绫,3209,96,1,1,2,50.0%,1h
1611,3,solost,3208,151,24,22,46,52.2%,22m
1611,1,Madrior,3208,0,0,1,1,0.0%,28m
1613,3,极品菜鸟,3207,1604,497,466,963,51.6%,50m
1613,3,[GGES]REIKSGUARD,3207,859,33,36,69,47.8%,15m
1613,3,[黑豹]rubyruby,3207,350,27,24,51,52.9%,25m
1613,3,汉斯,3207,30,1,2,3,33.3%,9m
1613,3,[青娱乐]IIIIIIIII,3207,0,1,3,4,25.0%,3m
1618,3,[CPT]帝国群英殿花式,3206,1017,61,49,110,55.5%,18m
1618,3,薇光,3206,117,4,3,7,57.1%,21m
1618,3,IIIIIIIIIIII,3206,0,1,0,1,100.0%,29m
1618,1,泪湖,3206,0,1,1,2,50.0%,20m
1622,1,[ZJU]Moonlight,3205,154,4,3,7,57.1%,17m
1622,3,IIIIIIIIIIII,3205,0,1,1,2,50.0%,28m
1624,3,[KPG2]小群群,3204,318,14,15,29,48.3%,7m
1624,3,白门楼爆破能手,3204,185,8,4,12,66.7%,28m
1624,3,[不会散枪兵]imbasupertnt,3204,0,0,3,3,0.0%,7m
1627,3,[单矿跳大龙]我只会一波啊,3203,174,5,1,6,83.3%,55m
1627,2,[CPT]星际屠夫,3203,0,2,2,4,50.0%,1h
1627,3,IIIIIIIIIIII,3203,30,1,1,2,50.0%,4m
1630,2,IIIIIIIIIIII,3202,1489,773,774,1547,50.0%,22m
1630,2,[Beasty]禅虫,3202,1534,92,92,184,50.0%,20m
1630,3,funian,3202,0,0,1,1,0.0%,53m
1630,3,[PITB]珞珈山炮王,3202,0,0,1,1,0.0%,13m
1634,3,[舰C]枫叶椛,3201,1101,99,80,179,55.3%,21m
1634,3,Sword,3201,642,25,15,40,62.5%,28m
1634,3,[Canton]莫作栋,3201,324,11,6,17,64.7%,13m
1634,2,[西南风]Mapleleaf,3201,206,8,6,14,57.1%,22m
1634,1,[粉红公主]LambRazor,3201,46,2,7,9,22.2%,6m
1634,3,lllllllllll,3201,0,1,1,2,50.0%,7m
1634,3,牙疼快吃糖,3201,30,1,8,9,11.1%,55m
1634,3,NewPlayer,3201,0,0,1,1,0.0%,12m
1634,3,小鬼狂,3201,0,0,1,1,0.0%,26m
1643,3,牛奶是个萌妹子,3200,1481,230,233,463,49.7%,23m
1643,1,人渣的本愿,3200,0,3,2,5,60.0%,1h
1643,3,子木,3200,0,1,0,1,100.0%,24m
1646,3,[咿呀咿]LittleRankeR,3199,426,14,20,34,41.2%,17m
1646,3,[TCP]Pureyellow,3199,250,10,6,16,62.5%,21m
1646,3,[鬼X家族]鬼厉,3199,166,6,5,11,54.5%,6m
1646,1,[OldGuy]湖广按察使,3199,119,5,3,8,62.5%,22m
1646,2,Freedom,3199,0,2,0,2,100.0%,1h
1646,3,玩神族的都是废物,3199,58,2,1,3,66.7%,21m
1652,3,yazeroO,3198,437,18,19,37,48.6%,16m
1652,3,[高阶萌新]上帝视角,3198,144,6,7,13,46.2%,7m
1652,2,冰凝,3198,0,5,0,5,100.0%,1h
1652,1,[kurisu]贝伦卡斯特,3198,141,5,4,9,55.6%,1h
1652,3,[半个菜鸟]Pine,3198,0,4,1,5,80.0%,9m
1652,1,微佀,3198,119,3,3,6,50.0%,51m
1658,1,[半个菜鸟]炽火羽翼,3197,295,14,9,23,60.9%,6m
1658,1,[Aris]克利夫兰,3197,301,14,9,23,60.9%,22m
1658,3,[仁者]从小就很帅,3197,94,1,2,3,33.3%,11m
1658,3,[暴雪八队]DarkRanger,3197,0,0,1,1,0.0%,10m
1658,3,Megatron,3197,0,0,3,3,0.0%,13m
1663,3,阿克蜀黍,3196,0,3,2,5,60.0%,9m
1664,2,[半个菜鸟]IlilI,3195,0,4,1,5,80.0%,1h
1664,3,阿驴驴,3195,0,1,0,1,100.0%,2m
1666,3,像羊树,3194,0,0,1,1,0.0%,21m
1666,2,Hukuro,3194,0,0,2,2,0.0%,16m
1668,3,[传说萌娘团]IIIIIIIIIIII,3193,522,25,7,32,78.1%,50m
1668,3,[Tpb]Thanatos,3193,86,4,5,9,44.4%,3m
1668,3,[C37916]青橙,3193,0,0,1,1,0.0%,9m
1671,3,[百战百败]诛文丑,3192,860,43,37,80,53.8%,5m
1671,3,[白给了]llllll,3192,392,14,13,27,51.9%,10m
1671,2,久红,3192,144,3,3,6,50.0%,23m
1671,3,太上忘情豆,3192,0,1,0,1,100.0%,8m
1675,2,霍尔布鲁克,3191,247,11,6,17,64.7%,20m
1675,3,[地嗪专卖店]楼主,3191,286,11,9,20,55.0%,9m
1675,3,[刺蛇单推协会]天行,3191,166,9,3,12,75.0%,5m
1675,3,[Print]TimeRod,3191,0,1,1,2,50.0%,53m
1675,2,Rise,3191,0,1,4,5,20.0%,22m
1680,3,IIIIIIIIIIII,3190,1207,186,182,368,50.5%,12m
1680,3,看见你我蛋疼,3190,1042,48,41,89,53.9%,6m
1680,3,[硬朗派]阿嵬茨小志,3190,314,12,9,21,57.1%,24m
1680,1,[觀天習文]光陨,3190,0,0,1,1,0.0%,16m
1684,3,SApphire,3189,856,35,28,63,55.6%,3m
1684,3,IIIIIIIIIIII,3189,424,20,18,38,52.6%,24m
1684,3,[缘起幻想乡]八雲紫的神隠,3189,0,0,1,1,0.0%,18m
1684,3,[IMRTS]PolamaWang,3189,0,0,1,1,0.0%,6m
1688,3,cijief,3188,304,11,10,21,52.4%,51m
1689,3,RifeL,3187,249,25,17,42,59.5%,6m
1689,3,对空,3187,344,12,11,23,52.2%,24m
1689,3,一个谐星,3187,170,6,6,12,50.0%,50m
1689,3,[冲就完了]CKCZ,3187,58,2,2,4,50.0%,51m
1689,3,[TKWC]grepe,3187,18,2,3,5,40.0%,22m
1689,3,ProRandom,3187,30,1,1,2,50.0%,17m
1695,3,[暴雪我是你爹]gene,3186,1582,100,78,178,56.2%,3m
1695,3,金刚葫芦娃,3186,1409,58,47,105,55.2%,9m
1695,3,八神秋月,3186,611,43,41,84,51.2%,18m
1695,3,[TCP]HiddenKnife,3186,0,1,0,1,100.0%,28m
1695,3,[镇江一外]CrazyMagelll,3186,0,0,1,1,0.0%,11m
1695,3,[SUST1]Buqun,3186,0,0,1,1,0.0%,24m
1701,3,克哈上的拟态雏虫,3185,330,35,13,48,72.9%,3m
1701,3,MrLumingfei,3185,121,3,1,4,75.0%,13m
1701,2,[相爱一家亲]山高勿远,3185,0,3,2,5,60.0%,55m
1704,3,[飞云之上]HelloWorld,3184,294,12,2,14,85.7%,27m
1704,1,IIIIIIIIIIII,3184,283,7,11,18,38.9%,19m
1704,2,Mcocomic,3184,0,4,1,5,80.0%,38m
1704,3,[东大电竞]windawn,3184,58,3,2,5,60.0%,23m
1704,3,[newday]菜鸟的自我修养,3184,30,1,1,2,50.0%,53m
1704,3,moonwolf,3184,0,1,4,5,20.0%,20m
1710,3,[家禽养殖]混元星际门姚保国,3183,90,4,4,8,50.0%,12m
1710,3,[魔物娘]杰瑞喵喵将军,3183,30,1,2,3,33.3%,23m
1712,3,五九下山,3182,0,1,0,1,100.0%,9m
1712,3,[医学奇迹之花]花很讨厌,3182,0,0,1,1,0.0%,52m
1714,3,[大雨的逆袭]儿子,3181,468,21,21,42,50.0%,11m
1714,3,[关山万里路]風吟丶,3181,165,6,15,21,28.6%,19m
1714,2,意志抑制异志,3181,0,5,0,5,100.0%,1h
1714,1,[瞎际霸打]超能之鱼人,3181,0,1,0,1,100.0%,1h
1714,3,她说她是晒黑的,3181,0,1,0,1,100.0%,10m
1714,3,[XYFANS]一个菜鸟,3181,0,0,1,1,0.0%,52m
1714,3,[装大佬的鸡]WSPHY,3181,0,0,1,1,0.0%,26m
1714,3,HHHHHHH,3181,0,0,1,1,0.0%,20m
1722,1,[霸王插插插插]两秒十七管,3180,139,4,3,7,57.1%,1h
1722,3,余生以待梦清澄,3180,92,2,0,2,100.0%,53m
1722,3,[噶姐美如花]花枝,3180,0,1,0,1,100.0%,8m
1725,2,[KPG]IIIIIIIIIIII,3179,475,81,92,173,46.8%,13m
1725,1,[dsnggs]你在看我吗,3179,182,7,3,10,70.0%,44m
1725,3,弱弱的幼女控桑,3179,0,0,1,1,0.0%,13m
1725,3,[缪丨葵]雾雨魔理沙,3179,0,0,1,1,0.0%,21m
1725,2,[星海绚丽]AvaLanche,3179,0,0,1,1,0.0%,16m
1725,3,风神,3179,0,0,2,2,0.0%,51m
1731,3,mrclean,3178,1129,70,64,134,52.2%,50m
1731,3,[星塵联萌]CrazyBoy,3178,742,29,33,62,46.8%,56m
1731,3,[哟呵呵]天满八纯,3178,276,10,3,13,76.9%,3m
1731,3,萌新的潜行者,3178,116,5,5,10,50.0%,29m
1731,3,NieJiPi,3178,30,2,0,2,100.0%,21m
1736,3,Guikarist,3177,60,5,5,10,50.0%,25m
1736,3,暴躁的裤子,3177,0,0,1,1,0.0%,53m
1738,2,[Holyfe]codmy,3176,1556,422,432,854,49.4%,4m
1738,3,[死亡降临]猛兽,3176,182,7,3,10,70.0%,3m
1738,3,咦这只竹鼠中暑了,3176,216,7,19,26,26.9%,29m
1738,3,杀生丸,3176,0,0,1,1,0.0%,12m
1742,3,nightmare,3175,0,1,0,1,100.0%,53m
1743,3,CAL,3174,1203,45,51,96,46.9%,6m
1743,1,[文韬武略]有基佬拉我苦练,3174,182,7,11,18,38.9%,19m
1743,1,沙条爱歌,3174,119,6,3,9,66.7%,2m
1743,2,棺材里的森森,3174,0,1,0,1,100.0%,10m
1743,3,[核桃]HHHHHHH,3174,0,0,1,1,0.0%,6m
1748,3,kevin,3173,208,9,4,13,69.2%,3m
1748,3,[白鸦]BTseven,3173,182,6,3,9,66.7%,14m
1748,3,嘤嘤怪,3173,144,4,0,4,100.0%,29m
1748,2,sdd,3173,0,4,1,5,80.0%,53m
1748,3,[菊花小王子]一壶浊酒渡一人,3173,0,1,0,1,100.0%,26m
1753,3,loster,3172,18,2,0,2,100.0%,23m
1753,3,[绯世梦璃花]砂糖少女以爱为食,3172,0,0,1,1,0.0%,26m
1753,2,音律,3172,0,0,1,1,0.0%,8m
1756,3,[雷诺警长]刘秀,3171,1562,104,108,212,49.1%,19m
1756,3,[KzK]Originalfake,3171,1371,57,53,110,51.8%,23m
1756,3,[薄暮之光]慕笺年,3171,60,2,7,9,22.2%,53m
1759,3,PiMba,3170,1449,296,271,567,52.2%,6m
1759,3,越子,3170,1354,63,41,104,60.6%,29m
1759,3,ShadowBoy,3170,740,31,23,54,57.4%,3m
1759,3,小浪浪,3170,146,6,6,12,50.0%,18m
1759,2,haibara,3170,95,4,2,6,66.7%,1h
1759,3,张璐是个好姐姐,3170,30,1,1,2,50.0%,21m
1765,2,Nanking,3169,867,325,322,647,50.2%,27m
1765,3,[暴雪十五队]LXPartinG,3169,235,11,5,16,68.8%,50m
1765,3,[星战中国]amu,3169,0,0,1,1,0.0%,3m
1768,3,吉恩,3168,488,43,43,86,50.0%,8m
1768,3,Nakira,3168,0,2,3,5,40.0%,1h
1768,3,ShaDow,3168,0,0,1,1,0.0%,6m
1771,3,kokoforever,3167,1533,93,74,167,55.7%,11m
1771,3,[TNL]花自飘零丶水自流,3167,587,25,24,49,51.0%,12m
1771,3,syd,3167,160,24,23,47,51.1%,51m
1771,3,虚空,3167,278,10,5,15,66.7%,6m
1771,3,[C52505]我事你霸霸,3167,88,4,3,7,57.1%,11m
1771,3,[血战菜鸡]KURONG,3167,58,3,1,4,75.0%,28m
1771,3,破晓夜袭,3167,0,0,1,1,0.0%,8m
1778,3,Rain,3166,1324,81,67,148,54.7%,20m
1778,2,[闪电伍连鞭]smileboy,3166,93,6,0,6,100.0%,1h
1778,3,Pimba,3166,0,0,1,1,0.0%,25m
1778,3,[LFY]观止,3166,0,0,1,1,0.0%,25m
1782,3,[残日星宿]大天使鱼,3165,250,13,9,22,59.1%,25m
1782,3,吾爱永恒,3165,90,4,3,7,57.1%,9m
1784,3,STXBoGus,3164,794,145,135,280,51.8%,29m
1784,3,funFunNy,3164,1042,36,50,86,41.9%,10m
1784,3,yosang,3164,457,33,24,57,57.9%,19m
1784,3,[KPG]小猫陆战队,3164,801,32,25,57,56.1%,3m
1784,3,CosXX,3164,0,4,1,5,80.0%,24m
1784,3,[浴火银河]ZGB,3164,0,0,7,7,0.0%,21m
1790,2,淡月炎,3163,855,201,183,384,52.3%,13m
1790,2,上古巨鱼,3163,233,11,8,19,57.9%,30m
1790,3,NoRc,3163,116,5,2,7,71.4%,21m
1790,3,Momoko,3163,92,3,7,10,30.0%,19m
1790,2,[RPGBoY]小新,3163,74,2,4,6,33.3%,18m
1790,3,利维亚的杰洛特,3163,58,2,6,8,25.0%,6m
1790,2,[社交学大可爱]sheely,3163,0,1,0,1,100.0%,14m
1797,2,羡才,3162,1568,359,357,716,50.1%,10m
1797,3,[名人集团]IIIIIIIIIIII,3162,1567,262,259,521,50.3%,16m
1797,3,yxang,3162,642,28,14,42,66.7%,6m
1797,3,玉宇九霄,3162,120,5,14,19,26.3%,23m
1797,1,Innovation,3162,139,4,5,9,44.4%,12m
1797,3,wjfjfjfjfj,3162,0,0,2,2,0.0%,25m
1803,3,raymond,3161,260,10,10,20,50.0%,22m
1803,3,[苏大星际]Snutte,3161,270,10,11,21,47.6%,16m
1803,3,IIIIIIIII,3161,58,2,1,3,66.7%,18m
1803,3,[幻想崩坏]娜丽塔雅,3161,0,0,1,1,0.0%,22m
1807,3,llllllllllll,3160,1010,131,116,247,53.0%,50m
1807,3,[半个菜鸟]nist,3160,1444,60,69,129,46.5%,4m
1807,3,Alleluia,3160,60,3,2,5,60.0%,9m
1807,3,酷酷使徒汪,3160,30,2,2,4,50.0%,24m
1811,3,啊豆,3159,343,17,3,20,85.0%,6m
1811,3,西湖雅座有请,3159,235,7,3,10,70.0%,22m
1811,1,[崩坏三的舰长]年少轻狂,3159,0,1,0,1,100.0%,2m
1814,3,风中的火柴,3158,437,19,12,31,61.3%,55m
1814,3,战地跑路,3158,86,3,5,8,37.5%,54m
1814,3,ccooll,3158,0,1,0,1,100.0%,14m
1814,3,BOSS,3158,0,0,1,1,0.0%,19m
1818,3,港子么度,3157,1180,176,163,339,51.9%,20m
1818,3,[GO萌新分队]梅西,3157,1264,117,116,233,50.2%,21m
1818,3,slover,3157,1437,63,50,113,55.8%,7m
1818,1,[加州室内装修]蓬莱山辉夜,3157,187,6,5,11,54.5%,1h
1818,1,一地流星,3157,130,3,5,8,37.5%,20m
1818,3,黑崎一护,3157,0,0,1,1,0.0%,25m
1824,3,紫苑寺有子,3156,578,29,25,54,53.7%,22m
1824,3,[foryss]唐瓜点,3156,205,17,9,26,65.4%,6m
1824,3,天津风,3156,322,13,12,25,52.0%,26m
1827,3,宝宝苦但宝宝不说,3155,552,86,81,167,51.5%,6m
1827,3,[南京工业大学]Laplace,3155,375,14,10,24,58.3%,8m
1827,3,[大漢]Marineking,3155,286,10,12,22,45.5%,4m
1827,3,[TeamCD]机械公敌,3155,155,5,1,6,83.3%,28m
1827,3,[沃永远喜欢]芭芭菲冲鸭,3155,118,3,0,3,100.0%,14m
1827,3,followme,3155,0,1,5,6,16.7%,11m
1833,3,ZEST,3154,262,12,6,18,66.7%,4m
1833,1,机械烈海王,3154,118,3,4,7,42.9%,13m
1835,3,邦女郎,3153,1083,48,54,102,47.1%,10m
1835,3,木鱼大鱼,3153,0,1,0,1,100.0%,8m
1835,1,状元,3153,95,1,1,2,50.0%,49m
1835,3,[剑与舞的奏曲]夕听风雨,3153,0,0,1,1,0.0%,5m
1835,2,prince,3153,0,0,1,1,0.0%,25m
1835,2,Stormfly,3153,0,0,1,1,0.0%,23m
1841,1,clem,3152,292,10,7,17,58.8%,13m
1842,3,沉默等待崛起死亡,3151,246,9,3,12,75.0%,25m
1842,2,[AgCu电池]INoVatio,3151,96,2,3,5,40.0%,52m
1844,3,[KOKOKO]苍井空,3150,0,5,0,5,100.0%,1h
1844,2,Squirrel,3150,46,5,3,8,62.5%,53m
1844,2,玄门道人,3150,0,1,0,1,100.0%,1h
1847,1,Deathscy,3149,0,1,0,1,100.0%,58m
1848,3,[KPG2]GZEZHANGLP,3148,1591,342,326,668,51.2%,22m
1848,3,ZHT,3148,283,30,16,46,65.2%,54m
1848,3,[丽日御茶茶]IIIIIIIIII,3148,442,16,11,27,59.3%,22m
1848,3,[CHW]教员的好学生,3148,252,13,4,17,76.5%,23m
1848,3,[浪啊浪]韩少校,3148,360,13,14,27,48.1%,30m
1848,3,BOBOY,3148,0,1,0,1,100.0%,7m
1848,3,[橘裡橘气]Flowers,3148,0,0,2,2,0.0%,5m
1855,3,[CJzMan]Yaojing,3147,1653,251,237,488,51.4%,52m
1855,3,修地堡的都是狗,3147,1615,71,59,130,54.6%,7m
1855,3,[小鸡屠宰场3]幻瞬,3147,669,30,19,49,61.2%,14m
1855,3,洛克菲,3147,0,4,1,5,80.0%,1h
1859,3,[我菜啊]你爹临死前,3146,30,2,0,2,100.0%,18m
1859,1,YUKO,3146,96,2,0,2,100.0%,39m
1859,3,[一盒峰我大哥]Lunar,3146,0,0,1,1,0.0%,18m
1862,3,[手残眼瞎瘾大]白门楼破产律师,3145,434,44,29,73,60.3%,53m
1862,3,MixSola,3145,0,4,1,5,80.0%,9m
1862,3,旧时天气旧时雨,3145,60,3,6,9,33.3%,13m
1862,2,MagicTerran,3145,0,1,0,1,100.0%,53m
1862,3,战姬,3145,30,1,2,3,33.3%,18m
1862,2,LaoK,3145,0,0,4,4,0.0%,18m
1868,3,MacGuffin,3144,350,12,21,33,36.4%,53m
1868,3,[Shawk]炸鱼死马嗷,3144,137,4,0,4,100.0%,4m
1868,3,[老油条战队4]huangwu,3144,115,2,1,3,66.7%,6m
1871,3,marina,3143,167,8,6,14,57.1%,10m
1871,3,[JOKER]SKTpartinG,3143,176,7,6,13,53.8%,51m
1871,3,Balalalala,3143,0,1,0,1,100.0%,13m
1871,3,[o瞳孔o]游魂跌宕,3143,0,1,3,4,25.0%,16m
1871,3,不许黑大主教,3143,0,0,2,2,0.0%,53m
1876,3,[Shawk]Lanthanum,3142,706,25,29,54,46.3%,50m
1876,3,神座千流,3142,587,22,17,39,56.4%,29m
1876,3,IIIIIIIIIIII,3142,294,12,7,19,63.2%,13m
1876,3,慢点慢点,3142,0,5,0,5,100.0%,1h
1876,1,横扫星际,3142,190,4,2,6,66.7%,13m
1876,3,[Mtp]绝望中忘了使徒,3142,0,0,1,1,0.0%,2m
1876,3,[传说萌鸡团]大地母亲,3142,0,0,2,2,0.0%,24m
1883,3,惨白色的啊飘,3141,94,6,0,6,100.0%,50m
1883,3,繁华落尽,3141,58,3,4,7,42.9%,14m
1885,3,周淑怡的逼也很嫩,3140,501,19,14,33,57.6%,50m
1885,2,[miku守护]ScarLeet,3140,305,14,6,20,70.0%,10m
1885,3,Mahesvara,3140,346,14,14,28,50.0%,13m
1885,3,[暴雪三十二隊]Presents,3140,172,8,5,13,61.5%,54m
1885,1,北海没有猫,3140,143,6,3,9,66.7%,28m
1885,3,[征戰聯盟丶]迪亚布罗,3140,114,3,0,3,100.0%,18m
1885,3,市规划局长,3140,32,1,2,3,33.3%,4m
1885,1,Belial,3140,0,0,1,1,0.0%,27m
1893,3,我爱光明,3139,228,9,8,17,52.9%,22m
1893,3,高党,3139,62,3,8,11,27.3%,7m
1893,3,[无畏巡洋]猎人,3139,0,0,1,1,0.0%,12m
1896,3,[NLHR]风痕之醉,3138,253,14,5,19,73.7%,28m
1896,3,[雅痞]流卝氓,3138,181,7,0,7,100.0%,3m
1896,3,[败中求败]小黑龙殷海健,3138,0,1,0,1,100.0%,8m
1896,3,[萝莉保护会]陌璃,3138,0,1,0,1,100.0%,27m
1896,2,MarineKing,3138,0,0,1,1,0.0%,16m
1901,3,[天堂之魔]laomao,3137,151,4,1,5,80.0%,16m
1901,3,[WZerg]XElNagA,3137,58,2,10,12,16.7%,24m
1901,3,人族英霸,3137,0,1,0,1,100.0%,21m
1901,3,IIIIIIIIIIII,3137,0,0,2,2,0.0%,21m
1905,3,IIIIIIIIIIII,3136,1413,60,59,119,50.4%,54m
1905,3,[共鸣的鸣]悲鸣的鸣,3136,667,36,19,55,65.5%,29m
1905,3,drankart,3136,176,9,6,15,60.0%,5m
1905,3,Fire,3136,154,5,0,5,100.0%,51m
1905,3,[UMB]阐释者,3136,58,2,3,5,40.0%,5m
1910,3,[敢死队]子龍,3135,957,125,119,244,51.2%,7m
1910,3,Djcj,3135,999,66,57,123,53.7%,28m
1910,3,[KPG]咕咕王,3135,836,35,26,61,57.4%,28m
1910,3,兰斯,3135,351,14,11,25,56.0%,21m
1910,3,[娱乐玩家]一束九,3135,174,7,5,12,58.3%,54m
1910,3,[贪玩]Ramsey,3135,0,1,0,1,100.0%,19m
1910,3,[霞之丘诗羽厨]NewTypeV,3135,0,0,1,1,0.0%,6m
1917,3,[KPG2]愤怒的公牛,3134,1543,121,122,243,49.8%,12m
1917,3,[最菜战队]天梯白给鸡,3134,360,19,4,23,82.6%,12m
1917,2,Taoxer,3134,140,5,0,5,100.0%,37m
1917,2,[瘾大眼瞎]LCFino,3134,119,3,0,3,100.0%,14m
1917,1,只会送,3134,0,1,0,1,100.0%,11m
1922,3,波士顿汉堡,3133,981,85,91,176,48.3%,7m
1922,3,[小鸡屠宰场9]远期,3133,412,75,53,128,58.6%,16m
1922,3,泪落在梦中,3133,1154,66,52,118,55.9%,25m
1922,3,[请叫我萌本]我儿子爱造航母,3133,545,22,15,37,59.5%,3m
1922,3,[北京大学鸡协]MaGeJiProtos,3133,588,20,22,42,47.6%,13m
1922,3,混元太极爱偷袭,3133,0,3,2,5,60.0%,55m
1922,3,IIIIIIIIIIII,3133,94,1,1,2,50.0%,25m
1922,3,[为了遥远的]柚子茶,3133,0,1,1,2,50.0%,21m
1922,3,[DMRz]雷布朗多星人,3133,0,0,1,1,0.0%,15m
1922,3,llllllllll,3133,0,0,2,2,0.0%,11m
1932,3,三三,3132,766,29,30,59,49.2%,9m
1932,3,[蓝调]特灡克斯,3132,0,0,1,1,0.0%,16m
1934,3,IIIIIIIIIIII,3130,345,13,9,22,59.1%,50m
1934,3,嗜血丶残红,3130,151,5,0,5,100.0%,7m
1934,3,心痛到无法呼吸,3130,125,4,1,5,80.0%,21m
1937,3,大腿,3129,795,30,26,56,53.6%,24m
1937,3,[牌面]雷日神,3129,147,5,1,6,83.3%,6m
1937,3,二十八天速成鸡,3129,122,3,2,5,60.0%,6m
1937,3,[三族同萌会]魔法少年郭冬临,3129,123,3,5,8,37.5%,8m
1937,3,[天青车道]hehedeyifang,3129,0,1,3,4,25.0%,28m
1937,2,[来游戏吖]鸡饲料,3129,0,0,1,1,0.0%,19m
1937,3,angles,3129,0,0,1,1,0.0%,5m
1944,3,[星际同萌]和平还是核平,3128,908,216,213,429,50.3%,2m
1944,3,以理服人,3128,1064,156,132,288,54.2%,3m
1944,3,DanielSnow,3128,959,35,41,76,46.1%,10m
1944,3,光刻的遗迹,3128,194,8,7,15,53.3%,5m
1944,3,[火焰雷兽]幽魂零,3128,105,3,1,4,75.0%,25m
1944,3,破两票,3128,94,2,0,2,100.0%,20m
1944,3,llllllllllll,3128,96,2,2,4,50.0%,5m
1951,3,带把的核桃,3127,1039,51,45,96,53.1%,14m
1951,3,[Shawk]反正游戏都凉了,3127,580,27,15,42,64.3%,7m
1951,3,[暴雪十队]泸沽诠梦,3127,170,9,13,22,40.9%,16m
1951,3,天地人和,3127,204,8,11,19,42.1%,4m
1951,1,[UTK]bokesdevil,3127,195,5,16,21,23.8%,52m
1951,2,[超神给你看哦]玩人族母亲必出事,3127,95,4,3,7,57.1%,23m
1951,1,[TWG]MIGHT,3127,115,3,1,4,75.0%,39m
1951,3,DavidWai,3127,0,1,0,1,100.0%,9m
1951,2,Ghost,3127,0,1,1,2,50.0%,1h
1951,1,tiansky,3127,0,1,2,3,33.3%,40m
1961,3,ODaNobuNaga,3126,1084,43,43,86,50.0%,50m
1961,3,[NTOS]ZipCheung,3126,512,18,21,39,46.2%,26m
1961,3,[lmpala]EinXh,3126,276,10,12,22,45.5%,27m
1961,3,Yangnannan,3126,174,6,1,7,85.7%,7m
1961,3,[NPUED]ShauN,3126,112,3,1,4,75.0%,10m
1961,3,[动漫迷]游龙,3126,114,2,1,3,66.7%,5m
1967,3,IIIIIIIIIIII,3125,155,13,3,16,81.2%,52m
1967,3,[幽冥之狼]TheOverMind,3125,231,9,2,11,81.8%,12m
1967,3,[Rhusky]SuPerNova,3125,226,8,4,12,66.7%,7m
1967,3,[XXHZ32]烟雨如花,3125,0,0,1,1,0.0%,11m
1971,3,IIIIIIIIIIII,3124,812,79,66,145,54.5%,19m
1971,3,某科学的咕咕码,3124,909,38,28,66,57.6%,29m
1971,3,IIIIIIIIIIII,3124,356,19,15,34,55.9%,12m
1971,3,[火焰雷兽]innovating,3124,202,7,4,11,63.6%,22m
1971,3,[超神给你看哦]Expecto,3124,142,5,7,12,41.7%,26m
1971,3,[浙江大学战队]Demonic,3124,128,2,3,5,40.0%,2m
1971,3,ForeverTT,3124,0,0,1,1,0.0%,55m
1978,3,NewPlayer,3123,812,140,136,276,50.7%,6m
1978,3,传说,3123,555,80,64,144,55.6%,9m
1978,3,扮猪吃老虎,3123,0,2,3,5,40.0%,53m
1978,3,[浪啊浪]MUZI,3123,58,2,4,6,33.3%,13m
1982,3,[oshima]neoooxx,3122,1402,77,66,143,53.8%,9m
1982,3,大白丶,3122,262,9,13,22,40.9%,6m
1982,3,Casinos,3122,195,7,9,16,43.8%,11m
1982,3,VINNIE,3122,128,3,3,6,50.0%,3m
1982,3,莫艾比,3122,0,0,1,1,0.0%,56m
1987,3,[暴雪全能亡]本群最跳狗逼嘴宗,3121,975,75,61,136,55.1%,9m
1987,3,TheGhoST,3121,472,42,45,87,48.3%,6m
1987,3,[妖馆]教练我要学星际,3121,213,7,3,10,70.0%,53m
1987,3,eagle,3121,93,2,2,4,50.0%,26m
1987,3,你从没见过我,3121,60,2,5,7,28.6%,53m
1992,3,打硬铁的铁匠,3120,124,12,10,22,54.5%,19m
1992,3,单矿爆大和,3120,0,1,0,1,100.0%,26m
1992,1,[Pro]leckcc,3120,0,0,1,1,0.0%,25m
1992,3,[Potato]SCA,3120,0,0,5,5,0.0%,1h
1996,3,[骨灰拌饭]中路杀神,3119,0,2,1,3,66.7%,1h
1996,3,AAAA,3119,0,1,0,1,100.0%,24m
1996,1,[傻妞]机械化说声我就退,3119,0,0,1,1,0.0%,6m
1999,3,吐蕃国师,3118,1432,125,130,255,49.0%,10m
1999,1,luckywg,3118,80,2,2,4,50.0%,51m
1999,1,[皇家科院]盲人星际,3118,0,0,1,1,0.0%,20m
1999,3,sky,3118,0,0,2,2,0.0%,51m
2003,3,[GFA]沉心,3117,818,54,53,107,50.5%,21m
2003,3,無我,3117,157,5,9,14,35.7%,28m
2003,2,Ashes,3117,0,0,1,1,0.0%,20m
2006,3,cinereus,3116,41,5,9,14,35.7%,18m
2006,3,[RSTAR]吾名为宙宇尘星,3116,97,1,3,4,25.0%,52m
2008,3,[我队伍很强大]Vad,3115,296,9,8,17,52.9%,10m
2008,3,[纸壳]重创刀锋女王,3115,228,8,11,19,42.1%,26m
2008,3,似水流年,3115,186,5,3,8,62.5%,16m
2008,3,[SxAK]Kairaku,3115,0,1,2,3,33.3%,15m
2008,3,名字已隐藏,3115,0,0,4,4,0.0%,52m
2013,3,松子,3114,97,5,1,6,83.3%,21m
2013,2,憨豆先生的小泰迪,3114,137,5,4,9,55.6%,1h
2013,3,顾念,3114,86,3,6,9,33.3%,13m
2016,3,RICO,3113,869,96,91,187,51.3%,12m
2016,3,[龙骑舞尹志平]鬼才,3113,502,20,13,33,60.6%,50m
2016,2,[风林火山的房]官人我要,3113,201,8,3,11,72.7%,53m
2016,2,妖娆,3113,0,4,2,6,66.7%,53m
2016,1,星界拾荒者,3113,0,3,2,5,60.0%,55m
2016,1,[由我们重回]为了爱与正义,3113,40,2,0,2,100.0%,7m
2016,1,songge,3113,0,1,0,1,100.0%,24m
2023,3,[Shawk]彼岸花开空断肠,3112,1598,217,209,426,50.9%,16m
2023,3,[暴雪三队]小丫丫,3112,334,12,15,27,44.4%,10m
2023,1,Kirito,3112,92,3,9,12,25.0%,1h
2023,1,[星际最强亡者]萌新,3112,0,0,1,1,0.0%,6m
2027,1,[K7]TJMangaMon,3111,0,0,1,1,0.0%,28m
2028,2,哦哟,3110,305,15,7,22,68.2%,20m
2028,3,艾尔小圆盾,3110,170,4,8,12,33.3%,25m
2028,3,[星际争霸第一]blizzarnmsl,3110,30,2,3,5,40.0%,12m
2031,3,桔子,3109,542,22,23,45,48.9%,12m
2031,3,[三族同萌会]银河之心,3109,419,16,13,29,55.2%,53m
2031,3,[我们是无敌的]人皇武圣星际魔君,3109,143,6,5,11,54.5%,53m
2031,3,[丨虫族灬战队]夜深,3109,118,5,5,10,50.0%,13m
2031,3,厦门孙一峰,3109,0,1,3,4,25.0%,16m
2031,1,IIIIIIIIIIII,3109,0,0,1,1,0.0%,5m
2037,3,[小青梅佐酒]赫尔辛根默斯肯,3108,286,10,26,36,27.8%,12m
2037,3,青衫负雪,3108,176,6,8,14,42.9%,2m
2039,2,星际大菜鸟,3107,632,21,38,59,35.6%,24m
2039,1,Soul,3107,0,0,1,1,0.0%,8m
2041,3,sad,3106,316,12,15,27,44.4%,3m
2041,3,PianistLI,3106,262,10,12,22,45.5%,21m
2041,1,[白丝黑丝萝莉]狂杀落雪,3106,0,1,0,1,100.0%,20m
2041,1,剑心,3106,42,1,1,2,50.0%,12m
2045,2,萌萌的小萌新,3105,157,4,2,6,66.7%,50m
2045,1,[Shawk]打不过就是不够多,3105,82,2,1,3,66.7%,25m
2045,3,DIESWZ,3105,0,1,0,1,100.0%,14m
2045,1,[萌芯]March,3105,0,0,1,1,0.0%,2m
2049,3,VXST,3104,1557,180,158,338,53.3%,28m
2049,3,Gai,3104,1594,73,69,142,51.4%,30m
2051,3,醉卧沙场君莫笑,3103,849,32,31,63,50.8%,13m
2051,3,zjd,3103,380,17,15,32,53.1%,4m
2051,1,[40hour]Schumann,3103,389,15,7,22,68.2%,20m
2051,1,[探姬联萌]踏雪,3103,302,8,8,16,50.0%,23m
2051,1,[湖面倒影]苍蓝,3103,195,6,7,13,46.2%,53m
2051,3,卡洛斯,3103,93,3,4,7,42.9%,50m
2051,3,[白羽蘇芳]JerryMou,3103,0,0,1,1,0.0%,29m
2058,3,[超电磁炉]今朝梦初情,3102,1180,52,38,90,57.8%,50m
2058,2,[高达]占戈哥欠走己,3102,0,1,0,1,100.0%,8m
2058,3,极乐天君,3102,0,1,3,4,25.0%,12m
2058,3,[阴弟]Hzyc,3102,0,0,2,2,0.0%,50m
2062,3,赤佬,3101,1545,229,217,446,51.3%,51m
2062,3,[我太帅]leenock,3101,1538,164,154,318,51.6%,53m
2062,3,lllllllllll,3101,206,7,4,11,63.6%,29m
2065,2,花式娱乐花式受虐,3100,306,12,12,24,50.0%,2m
2065,1,[YR]Yoshino,3100,96,5,3,8,62.5%,58m
2065,3,Terminator,3100,196,5,6,11,45.5%,3m
2065,1,das,3100,0,2,3,5,40.0%,51m
2065,2,[战争武器]ailaop,3100,0,1,2,3,33.3%,56m
2070,3,[RPG神教]卖萌的探机,3099,1587,113,117,230,49.1%,10m
2070,3,普通电脑,3099,663,28,22,50,56.0%,53m
2070,1,AmoyGoSt,3099,0,0,1,1,0.0%,20m
2073,3,星际二五仔,3098,1559,258,249,507,50.9%,4m
2073,1,[李培楠NB]寰宇彼方,3098,0,0,1,1,0.0%,51m
2075,3,GASLOT,3097,236,11,5,16,68.8%,28m
2075,2,[KK开]影舞灬涟,3097,0,1,3,4,25.0%,20m
2075,1,[传说萌鸡团]sdgdfhfdgjj,3097,0,0,1,1,0.0%,23m
2078,3,武小崴丶,3096,120,7,5,12,58.3%,3m
2078,3,涅普迪努,3096,0,0,1,1,0.0%,13m
2080,1,鹰鸟小鸟,3095,184,6,4,10,60.0%,55m
2080,3,comeX,3095,150,5,7,12,41.7%,13m
2082,3,[天下大同]bird,3094,716,26,31,57,45.6%,23m
2082,3,Gray,3094,60,3,3,6,50.0%,11m
2082,3,[血港魅影]糖心,3094,0,1,2,3,33.3%,55m
2085,1,陈墨的我,3093,529,24,5,29,82.8%,18m
2085,3,Ray,3093,222,7,5,12,58.3%,13m
2085,1,[风云神]对不起,3093,80,3,2,5,60.0%,18m
2085,1,SCiVessel,3093,0,1,0,1,100.0%,19m
2085,2,子非鱼,3093,0,1,0,1,100.0%,1h
2085,1,[Ours]IIIIIIIIIIII,3093,42,1,3,4,25.0%,18m
2085,1,llllllllllll,3093,0,1,4,5,20.0%,50m
2092,2,[神樂七奈ol]阳菜,3092,193,11,12,23,47.8%,5m
2092,2,[NVKR]呆表永远滴神,3092,162,7,7,14,50.0%,56m
2094,2,[第三方]烟云,3091,1587,402,379,781,51.5%,53m
2094,3,[二维码聚集地]不简单的二维码,3091,97,5,1,6,83.3%,1h
2094,1,Sadness,3091,0,3,2,5,60.0%,5m
2094,1,ASURAN,3091,0,1,0,1,100.0%,20m
2098,3,[小小怪怪]夜月,3090,558,19,20,39,48.7%,20m
2098,3,Kella,3090,252,9,7,16,56.2%,17m
2098,1,goooioong,3090,80,3,2,5,60.0%,6m
2098,3,MagejiTarren,3090,30,2,2,4,50.0%,11m
2098,3,ddddd,3090,0,0,1,1,0.0%,3m
2098,2,快樂的大師兄,3090,0,0,2,2,0.0%,14m
2104,3,张京华单推人,3089,501,22,17,39,56.4%,8m
2104,3,泰伦不攻击泰伦,3089,356,13,14,27,48.1%,55m
2104,1,[旺旺战士]Light,3089,245,10,2,12,83.3%,17m
2107,3,[你是狗逼吗]干掉上帝,3088,156,5,14,19,26.3%,53m
2107,3,春夏,3088,97,3,3,6,50.0%,1h
2107,1,[长夜将至]LLLLL,3088,118,3,4,7,42.9%,13m
2110,3,Centurion,3087,0,3,2,5,60.0%,1h
2111,3,[APM30]LGHK,3086,344,22,18,40,55.0%,53m
2111,3,王小刀,3086,73,8,7,15,53.3%,51m
2111,1,Lose,3086,137,4,3,7,57.1%,40m
2111,1,[我们都相当菜]嫩竹的辉夜姬,3086,0,1,0,1,100.0%,1h
2111,3,[空虚门下]逆羽幻翎,3086,0,0,1,1,0.0%,5m
2111,1,[鬼谷]后树,3086,0,0,1,1,0.0%,51m
2117,1,[宇宙职业战队]Classical,3085,277,9,6,15,60.0%,16m
2117,1,[衣玖油库里]jimmy,3085,40,1,3,4,25.0%,52m
2119,3,[萨尔那加神殿]破壁人,3084,121,4,4,8,50.0%,49m
2119,1,[103军区]Crystalore,3084,30,1,1,2,50.0%,5m
2119,2,华丽雨林,3084,0,0,2,2,0.0%,1h
2122,1,断背山之咖喱饭,3083,608,28,16,44,63.6%,5m
2122,1,璀璨星华,3083,0,1,0,1,100.0%,12m
2122,3,[KPG]没头脑,3083,34,1,2,3,33.3%,6m
2125,3,兄弟看好你农民,3082,1282,199,194,393,50.6%,9m
2125,3,[元苜会]水滴,3082,887,103,83,186,55.4%,9m
2125,3,比美团还能送,3082,0,3,2,5,60.0%,13m
2128,3,忘忧岛,3081,1214,175,158,333,52.6%,25m
2128,3,[北京城管]麻袋不要乱来,3081,1178,111,117,228,48.7%,24m
2128,1,垣根帝督,3081,608,26,9,35,74.3%,21m
2128,3,[GGGLLL]Original,3081,253,20,16,36,55.6%,52m
2128,3,Violet,3081,218,6,7,13,46.2%,56m
2128,3,一个菜鸟,3081,30,3,5,8,37.5%,12m
2128,1,[Keysu]lllllllll,3081,0,1,1,2,50.0%,20m
2128,2,[QWQa]小凛敢日畸变体,3081,0,0,1,1,0.0%,8m
2128,1,致命之足,3081,0,0,1,1,0.0%,20m
2128,1,混元星际太极门,3081,0,0,1,1,0.0%,52m
2138,1,[几何伦理学]Learning,3080,282,20,20,40,50.0%,21m
2138,1,Vinci,3080,264,8,4,12,66.7%,24m
2138,1,Dark,3080,154,7,6,13,53.8%,53m
2138,3,[文韬武略]表妹依旧消魂,3080,184,6,9,15,40.0%,26m
2138,3,[Naz]lllllllllll,3080,162,5,2,7,71.4%,10m
2138,3,[暴雪娱乐]舞动青春,3080,97,4,2,6,66.7%,33m
2138,3,含泪甩飞龙,3080,0,0,1,1,0.0%,28m
2145,3,[广龙日天]IMRealTaeja,3079,392,49,40,89,55.1%,22m
2145,1,[再抗战15年]闻疯丧胆,3079,140,5,6,11,45.5%,1h
2145,1,黑暗森林,3079,0,1,0,1,100.0%,28m
2145,1,[Thpj]闪击英雄,3079,0,0,1,1,0.0%,12m
2145,1,gordonflyer,3079,0,0,1,1,0.0%,27m
2150,3,MMbloodAI,3078,429,56,53,109,51.4%,27m
2150,2,IIIIIIIIIIII,3078,358,14,10,24,58.3%,29m
2150,3,豆腐君,3078,250,14,11,25,56.0%,52m
2150,1,[喵爷的虐待屋]血腥的喵喵酱,3078,0,0,2,2,0.0%,50m
2150,1,kaka,3078,0,0,2,2,0.0%,6m
2155,3,SKYWALKER,3077,685,30,20,50,60.0%,4m
2155,1,越今朝,3077,38,2,0,2,100.0%,21m
2155,3,[FF2f1A]你的当当,3077,0,1,0,1,100.0%,1h
2158,3,[久美子棉纺厂]kongyuxi,3076,1518,248,238,486,51.0%,8m
2158,1,[星灵最棒]frame,3076,434,15,19,34,44.1%,12m
2158,1,永诀,3076,116,3,1,4,75.0%,11m
2158,1,蛛丝马迹,3076,0,1,0,1,100.0%,43m
2158,1,[I20I]sixks,3076,0,0,1,1,0.0%,18m
2163,3,风静静地吹,3075,1399,115,107,222,51.8%,52m
2163,3,逆袭,3075,447,43,31,74,58.1%,11m
2163,3,IIIIIIIIIIII,3075,210,10,11,21,47.6%,51m
2163,2,[ToHo]风之悲伤,3075,0,1,1,2,50.0%,44m
2163,3,SurFaceYoung,3075,0,0,3,3,0.0%,16m
2168,1,[童话]恋语轻唱,3074,115,2,2,4,50.0%,22m
2168,1,MisterH,3074,0,1,0,1,100.0%,27m
2168,1,[CNboys]月赋情长,3074,40,1,2,3,33.3%,28m
2171,1,狂热陆战队员,3073,1633,99,84,183,54.1%,16m
2171,1,naxx,3073,721,24,20,44,54.5%,18m
2171,3,[我不會TVT]black,3073,265,10,10,20,50.0%,7m
2171,3,传说中的啦啦,3073,280,10,19,29,34.5%,4m
2171,3,独孤千里,3073,236,8,13,21,38.1%,10m
2171,2,亓士,3073,140,6,4,10,60.0%,33m
2171,1,[晨风]鬼丞相,3073,76,2,2,4,50.0%,51m
2171,1,[阿里巴巴战队]逗比南波湾,3073,0,0,1,1,0.0%,40m
2179,1,[勇者们]达拉崩巴,3072,424,14,7,21,66.7%,2m
2179,1,[随机团]八核随机生物科技,3072,0,1,0,1,100.0%,28m
2179,1,[comes]SKT,3072,0,1,0,1,100.0%,45m
2182,3,自废双蛋,3071,525,20,19,39,51.3%,12m
2182,3,无敌的不死小强,3071,330,12,12,24,50.0%,51m
2182,1,Triste,3071,0,2,1,3,66.7%,1h
2182,1,[卐帝国万岁卐]OvO,3071,0,1,1,2,50.0%,25m
2186,3,Ayden,3070,121,6,2,8,75.0%,1h
2186,1,[虎捉急]颂灬,3070,48,5,5,10,50.0%,27m
2186,3,泽拉图,3070,0,1,0,1,100.0%,1h
2189,3,[哔哩哔哩杯乾]琉璃易碎,3069,1097,82,91,173,47.4%,12m
2189,2,[NLH]wsgh,3069,231,8,3,11,72.7%,1h
2189,2,lovingmarine,3069,106,6,2,8,75.0%,53m
2189,1,梵天,3069,185,5,8,13,38.5%,1h
2189,2,[暴雪我是你爹]素质高一点,3069,114,2,1,3,66.7%,10m
2189,3,东方彧卿,3069,0,0,6,6,0.0%,35m
2195,3,[KPG2]邪恶蠢鱼,3068,584,22,24,46,47.8%,12m
2195,1,QWQ,3068,107,4,1,5,80.0%,51m
2195,1,[大主教的兄弟]Laowhite,3068,185,4,6,10,40.0%,12m
2195,1,JWonderchild,3068,0,1,4,5,20.0%,12m
2195,3,[暴雪嘉年华]小小土人,3068,0,0,1,1,0.0%,22m
2195,1,[GIE]古明地恋天下第一,3068,0,0,1,1,0.0%,21m
2201,2,wangfan,3067,1471,246,258,504,48.8%,52m
2201,3,[火焰雷兽]我有一剑名扶摇,3067,1469,134,138,272,49.3%,16m
2201,3,埃辛诺斯双刃,3067,1247,50,46,96,52.1%,27m
2201,3,深蓝,3067,242,8,10,18,44.4%,14m
2201,1,[XCode]泰州小绵羊,3067,156,5,6,11,45.5%,55m
2201,1,Alexx,3067,0,0,2,2,0.0%,40m
2207,3,[Rhusky]给你马刷排叉子,3066,220,6,10,16,37.5%,23m
2207,1,sktwulaodog,3066,0,2,3,5,40.0%,43m
2207,1,[浪啊浪]Ghost,3066,0,1,0,1,100.0%,51m
2210,3,冰冰冰,3065,0,1,4,5,20.0%,19m
2210,3,[透一下清酒]连翘,3065,0,0,1,1,0.0%,28m
2210,1,陈琛,3065,0,0,2,2,0.0%,55m
2213,1,朱书记,3064,1759,99,101,200,49.5%,13m
2213,3,[感恩]指挥官,3064,481,18,30,48,37.5%,5m
2213,3,大大的小小,3064,58,2,6,8,25.0%,2m
2216,1,chris,3063,371,15,3,18,83.3%,6m
2216,3,[专家联盟]曹一操,3063,121,6,1,7,85.7%,1h
2216,3,[第一萌新帝国]艾雅法拉,3063,60,3,6,9,33.3%,27m
2216,1,[流氓高手]晨鸣,3063,34,2,1,3,66.7%,16m
2216,1,龟壳黄旭东,3063,0,1,0,1,100.0%,17m
2221,3,[绝世佳人]Yamato,3062,96,2,1,3,66.7%,14m
2221,1,[眼瞎的车万苟]八雲橴,3062,0,0,1,1,0.0%,59m
2223,2,天弑,3061,118,6,1,7,85.7%,1h
2223,1,[KPG]dart,3061,89,4,2,6,66.7%,12m
2225,2,Pia,3060,159,4,3,7,57.1%,10m
2226,2,北极狐,3059,220,8,5,13,61.5%,56m
2226,2,猪是念来过倒,3059,186,7,4,11,63.6%,1h
2226,2,那打不过能咋办嘛,3059,94,3,5,8,37.5%,1h
2226,1,lylch,3059,82,2,4,6,33.3%,52m
2226,1,[WNZS]LLDD,3059,0,0,2,2,0.0%,6m
2231,3,NaneeWa,3058,1350,54,56,110,49.1%,16m
2231,3,Clement,3058,239,8,5,13,61.5%,2m
2231,1,[暗室逢灯]瑟雷尼亚,3058,204,5,3,8,62.5%,5m
2231,3,[一等星]默本无声,3058,173,5,11,16,31.2%,54m
2235,1,叶落有孤城,3057,0,2,3,5,40.0%,1h
2236,3,[荣耀丶殿堂]六味地黄芄,3056,268,9,16,25,36.0%,23m
2236,3,[刺蛇互助协会]祝暴雪早日倒闭,3056,212,7,9,16,43.8%,15m
2236,3,[ZJU]ROBIN,3056,60,3,8,11,27.3%,13m
2236,1,[战旗第9分队]IIIIIIIII,3056,0,0,1,1,0.0%,51m
2236,1,我疯问佛,3056,0,0,1,1,0.0%,20m
2241,1,eagle,3055,1215,47,42,89,52.8%,52m
2241,1,[混吃混喝]AAAAAAAAAAAA,3055,168,5,5,10,50.0%,24m
2241,3,[涅噗涅噗]NinjaAqua,3055,0,0,1,1,0.0%,16m
2244,3,生死狙击,3054,199,16,16,32,50.0%,20m
2244,1,[我们是无敌的]Morgana,3054,367,15,6,21,71.4%,6m
2244,1,QAQ,3054,269,12,11,23,52.2%,18m
2244,2,[狗哥NO01]King,3054,93,4,4,8,50.0%,1h
2248,1,星际韭菜,3053,388,12,11,23,52.2%,13m
2248,1,陨落星辰,3053,0,4,2,6,66.7%,52m
2248,2,Birozhki,3053,0,4,2,6,66.7%,38m
2248,1,虫族真滴太阴间了,3053,0,2,3,5,40.0%,17m
2248,1,[七宫智音]艾尔之霜,3053,0,1,0,1,100.0%,50m
2248,1,[111]oldman,3053,0,0,1,1,0.0%,19m
2254,3,两矿一憋炸断肠,3052,1601,205,198,403,50.9%,5m
2254,1,Zeczery,3052,934,42,28,70,60.0%,19m
2254,1,狗骑士,3052,264,8,3,11,72.7%,18m
2254,1,长泽雅美,3052,108,3,5,8,37.5%,19m
2254,2,[椿湫]不知所措,3052,0,1,0,1,100.0%,6m
2254,1,[神羽]秋神紫羽,3052,48,1,1,2,50.0%,27m
2260,3,Leon,3051,376,12,18,30,40.0%,54m
2260,3,[无须奉天]这就是你的运营吗,3051,262,9,9,18,50.0%,16m
2260,2,第二适格者明日香,3051,201,7,5,12,58.3%,1h
2260,1,[萌新爱萌]源光之路,3051,154,4,6,10,40.0%,51m
2260,3,迷之袜子,3051,115,3,2,5,60.0%,44m
2260,1,IIIIIIIIII,3051,0,1,4,5,20.0%,1h
2266,3,[眼瞎的车万苟]西行寺幽幽纸,3050,356,13,15,28,46.4%,10m
2267,3,steven,3049,957,71,65,136,52.2%,8m
2267,1,[PhysRL]打星际你快乐吗,3049,496,18,17,35,51.4%,12m
2267,1,orz,3049,38,2,0,2,100.0%,52m
2267,1,[52区]IIIIIIIIIII,3049,40,2,0,2,100.0%,6m
2267,1,TorresTao,3049,38,2,2,4,50.0%,51m
2267,1,苟且偷生,3049,0,1,0,1,100.0%,50m
2273,1,为艾尔而战,3048,152,13,6,19,68.4%,50m
2273,3,[TG1]ddzforever,3048,0,0,1,1,0.0%,5m
2275,3,IlIlIIIlllII,3047,851,162,167,329,49.2%,13m
2275,1,Zhou,3047,786,29,23,52,55.8%,7m
2275,3,Lewis,3047,595,24,23,47,51.1%,51m
2278,1,雁阵惊寒,3046,273,7,5,12,58.3%,13m
2278,1,[谁在呼叫舰队]大和炮正在干蠢狼,3046,115,3,3,6,50.0%,17m
2278,3,ococ,3046,58,2,8,10,20.0%,4m
2278,2,KTflash,3046,0,0,1,1,0.0%,43m
2282,3,[恒古不灭]上孩子,3045,157,4,4,8,50.0%,23m
2282,1,llllllllllll,3045,0,2,3,5,40.0%,18m
2284,3,一般般,3044,300,12,8,20,60.0%,17m
2284,2,[社交学超可爱]我也找不着,3044,0,4,3,7,57.1%,1h
2284,1,[啊这阿巴]笨八八寄生体,3044,126,2,1,3,66.7%,50m
2284,3,[霸蛮战队]斜流泵,3044,0,0,1,1,0.0%,1h
2288,3,Stochastic,3043,976,46,45,91,50.5%,24m
2288,3,赛塔姆布里尼,3043,164,5,3,8,62.5%,25m
2290,1,[天国恶魔]JasoNj,3042,140,4,0,4,100.0%,7m
2290,1,[江城十三少]虫神丶,3042,44,1,2,3,33.3%,20m
2292,3,Microsad,3041,852,32,40,72,44.4%,24m
2292,1,今晴,3041,768,27,27,54,50.0%,6m
2292,3,塔桑尼斯仓鼠,3041,84,5,10,15,33.3%,19m
2292,3,[Aegean]Quincy,3041,97,1,1,2,50.0%,44m
2292,1,[ToHo]米格二三七,3041,0,0,1,1,0.0%,6m
2292,1,[SUSTC]zero,3041,0,0,1,1,0.0%,16m
2298,1,泰伯尔同族体,3040,561,61,39,100,61.0%,27m
2298,3,pigpigbig,3040,604,21,28,49,42.9%,24m
2298,1,闷声发大财,3040,365,17,13,30,56.7%,24m
2298,1,[GOTAL]烨殒,3040,186,6,7,13,46.2%,51m
2298,1,[郭嘉的小伙伴]star,3040,125,3,0,3,100.0%,21m
2298,1,[Porsch]回家,3040,0,1,0,1,100.0%,27m
2304,3,[A2B]lanius,3039,574,21,24,45,46.7%,53m
2304,3,蛋蛋的忧伤,3039,322,13,16,29,44.8%,26m
2304,1,锐风执剑,3039,78,2,3,5,40.0%,6m
2304,1,Mac,3039,0,1,0,1,100.0%,12m
2308,3,[玄武堂]taq,3038,144,5,7,12,41.7%,29m
2308,1,ABANDON,3038,0,3,2,5,60.0%,1h
2310,1,[末世纪]七濑的小迷弟,3037,1599,84,82,166,50.6%,16m
2310,3,三千世界,3037,404,19,9,28,67.9%,9m
2310,3,FyMvpAddison,3037,133,6,3,9,66.7%,9m
2310,1,[刀锋男皇]尼哥杀手,3037,96,3,6,9,33.3%,1h
2310,1,Quartet,3037,0,2,3,5,40.0%,59m
2310,2,Mist,3037,0,1,0,1,100.0%,23m
2316,1,农村要致富,3036,601,27,18,45,60.0%,19m
2316,1,僵尸,3036,436,14,11,25,56.0%,27m
2316,1,誓约胜利之剑,3036,97,4,2,6,66.7%,1h
2319,3,牛子哥摸狗牛子,3035,1603,652,666,1318,49.5%,19m
2319,3,[刺蛇互助社团]SpecTrum,3035,142,4,4,8,50.0%,56m
2319,3,[暴雪我是你爹]坦克不对空,3035,97,1,1,2,50.0%,1h
2322,1,[VG]Guderian,3034,767,24,21,45,53.3%,16m
2323,3,firefly,3033,1536,99,80,179,55.3%,11m
2323,3,罙絔色,3033,663,27,25,52,51.9%,28m
2323,1,AaronJYL,3033,95,6,2,8,75.0%,2m
2323,1,[envy]EnvyAngle,3033,104,3,0,3,100.0%,19m
2323,1,[白球会冲锋]萌新,3033,0,1,0,1,100.0%,51m
2328,3,战神丨势不可挡,3032,60,3,3,6,50.0%,24m
2329,1,[condor]Scott,3031,153,9,6,15,60.0%,50m
2329,1,[哔哩哔哩乾杯]归海寒湘,3031,112,3,4,7,42.9%,20m
2329,2,Aeon,3031,0,2,3,5,40.0%,1h
2329,3,rrrr,3031,84,1,3,4,25.0%,28m
2333,3,沉稳的牧凡,3030,285,10,9,19,52.6%,11m
2333,2,[燃烧军团之怒]穿过海的尹璇,3030,116,6,4,10,60.0%,1h
2333,1,xiaojuan,3030,80,3,4,7,42.9%,51m
2333,3,JUDGE,3030,97,1,2,3,33.3%,16m
2337,3,[媳妇一喊就G]太空小丑,3029,655,52,49,101,51.5%,10m
2337,3,逃跑冠军丶,3029,654,45,49,94,47.9%,13m
2337,1,HaibaraAi,3029,402,10,10,20,50.0%,19m
2337,1,三攻三防,3029,0,0,1,1,0.0%,24m
2341,2,MaGejiI,3028,206,8,6,14,57.1%,53m
2341,1,[一二一]IIIIIIIIII,3028,184,6,4,10,60.0%,50m
2341,1,清浅旧时光,3028,138,3,7,10,30.0%,12m
2344,1,[喵呜喵呜]瞧本,3027,459,21,9,30,70.0%,8m
2344,1,[混吃混喝]暗夜破坏娃,3027,0,0,1,1,0.0%,24m
2346,1,GuoL,3026,276,9,4,13,69.2%,50m
2346,1,wangbaba,3026,48,2,1,3,66.7%,6m
2346,1,[FallOB]鸭梨山大,3026,0,1,0,1,100.0%,27m
2349,3,wwwwwwwwwwww,3025,1576,136,127,263,51.7%,8m
2349,1,llllllllllll,3025,456,18,10,28,64.3%,6m
2349,1,爱到底,3025,36,2,2,4,50.0%,21m
2349,1,川啊,3025,0,0,1,1,0.0%,42m
2353,1,[黑白丝双马尾]救世神棍泽拉图,3024,557,21,12,33,63.6%,7m
2353,1,乐色等级电脑,3024,473,17,11,28,60.7%,6m
2353,1,PIGKING,3024,0,2,4,6,33.3%,12m
2353,1,小菜鸟,3024,46,1,1,2,50.0%,1h
2357,3,[yxfans]静介,3023,169,4,1,5,80.0%,35m
2358,1,[大疯狗]兄弟别走再打会儿,3022,720,30,16,46,65.2%,15m
2358,1,[Rhusky]Yoga,3022,321,12,5,17,70.6%,55m
2360,1,MeGsAlpaca,3021,635,47,32,79,59.5%,51m
2360,3,Distort,3021,673,25,29,54,46.3%,56m
2360,1,llllllllllll,3021,0,1,0,1,100.0%,1h
2363,1,JohnnyRoy,3020,577,29,28,57,50.9%,20m
2363,1,[刀锋男皇]以德服人,3020,441,17,22,39,43.6%,23m
2363,1,[龍狗毒爆]IIIIIIIIIIII,3020,171,5,1,6,83.3%,27m
2366,1,OHyesDaGeNB,3019,314,11,9,20,55.0%,20m
2366,1,周数壬,3019,0,1,0,1,100.0%,8m
2366,1,[扫黄]静安黄旭东,3019,0,0,1,1,0.0%,12m
2369,2,WHY,3018,169,5,7,12,41.7%,41m
2369,3,[十鬼蛇区]不怕虎,3018,0,3,5,8,37.5%,5m
2369,1,小明,3018,0,1,0,1,100.0%,5m
2372,2,[幼女萝莉同好]wdnmd,3017,273,10,5,15,66.7%,33m
2372,1,东方,3017,289,9,6,15,60.0%,23m
2372,1,killik,3017,211,8,3,11,72.7%,12m
2372,3,ray,3017,0,1,5,6,16.7%,53m
2372,2,RTGSG,3017,0,0,1,1,0.0%,41m
2377,1,fightero,3016,940,39,34,73,53.4%,55m
2377,3,么哈么哈,3016,633,30,34,64,46.9%,8m
2377,3,啊门,3016,274,13,7,20,65.0%,13m
2377,1,龙骑士尹志平,3016,140,4,6,10,40.0%,51m
2377,1,舒肤佳,3016,68,3,4,7,42.9%,52m
2382,1,[子小一口苗]子小火央亻圭,3015,0,0,1,1,0.0%,25m
2382,1,怕死的毒爆,3015,0,0,1,1,0.0%,52m
2384,1,[Mirana]米拉娜月影,3014,1364,62,49,111,55.9%,27m
2384,1,天宇,3014,0,1,0,1,100.0%,50m
2386,3,[Beasty]hyman,3013,476,27,35,62,43.5%,51m
2386,1,Crazyzerg,3013,604,23,21,44,52.3%,12m
2386,1,紧小肾危,3013,223,7,4,11,63.6%,23m
2386,1,Keith,3013,88,2,0,2,100.0%,55m
2386,1,[PZHSC]Shine,3013,0,1,0,1,100.0%,1h
2391,1,[魔法少女小屋]LonelinesS,3012,1706,70,64,134,52.2%,7m
2391,1,[FLDSCL]Flandre,3012,496,21,10,31,67.7%,18m
2391,1,Viajero,3012,0,4,1,5,80.0%,1h
2391,3,[洛河LH]柠檬不萌,3012,143,3,1,4,75.0%,13m
2391,3,[我怎么这么菜]少年满地滚键盘,3012,97,2,0,2,100.0%,1h
2391,1,三国泪,3012,42,2,2,4,50.0%,50m
2391,1,[小鸡屠宰场5]上帝晒太阳,3012,0,1,0,1,100.0%,12m
2391,1,SlientStirm,3012,0,1,0,1,100.0%,23m
2391,1,[万X奔腾]侯蹦蹦,3012,48,1,1,2,50.0%,1h
2391,3,月神之妹,3012,0,0,5,5,0.0%,30m
2401,1,[popTM]watergun,3011,368,14,14,28,50.0%,24m
2401,1,符大大,3011,323,12,7,19,63.2%,1h
2401,1,[timba6]蔡徐坤,3011,0,1,0,1,100.0%,51m
2401,3,萌新玩星际,3011,0,0,1,1,0.0%,6m
2401,2,osos,3011,0,0,1,1,0.0%,14m
2406,3,IIIIIIIIIIII,3010,1170,45,57,102,44.1%,13m
2406,3,徘徊,3010,203,7,3,10,70.0%,18m
2406,1,[SHNU]斗鹰,3010,0,1,0,1,100.0%,12m
2406,1,只是长得帅了点,3010,36,1,2,3,33.3%,12m
2410,3,[玩个虫子]帅猫,3009,1299,173,154,327,52.9%,12m
2410,1,[红莲骑士团]diabloIII,3009,1408,87,80,167,52.1%,5m
2410,3,[为了地球]musha,3009,667,23,28,51,45.1%,19m
2410,3,裴柱现你也杀,3009,538,20,22,42,47.6%,13m
2410,3,[小鸡屠宰场6]田田田田,3009,216,7,14,21,33.3%,56m
2410,1,[呆毛来我迦]Avalon,3009,36,2,3,5,40.0%,2m
2410,1,[海王星舰队]萌新,3009,0,1,0,1,100.0%,20m
2410,3,阿西吧,3009,97,1,2,3,33.3%,1h
2410,1,[BHH]IIIIIIIIIIII,3009,0,0,2,2,0.0%,1h
2419,1,Tenet,3008,769,28,21,49,57.1%,12m
2419,1,[TGone]妖魔,3008,839,28,24,52,53.8%,24m
2419,1,BOOS,3008,163,26,19,45,57.8%,25m
2419,1,一二三,3008,122,4,7,11,36.4%,12m
2419,3,困难电脑,3008,0,2,4,6,33.3%,1h
2419,1,[正常人]毒光,3008,0,0,2,2,0.0%,6m
2425,3,五更琉璃,3007,1325,97,84,181,53.6%,8m
2425,1,[莫妮卡]Monika,3007,32,1,2,3,33.3%,52m
2427,3,yufish,3006,952,40,41,81,49.4%,25m
2427,1,Zhuhai,3006,375,15,14,29,51.7%,51m
2427,1,[GSXY]Mercurial,3006,310,11,6,17,64.7%,55m
2427,1,Lightning,3006,118,6,1,7,85.7%,27m
2427,1,sycshc,3006,144,4,7,11,36.4%,5m
2427,1,Eddie,3006,0,0,1,1,0.0%,24m
2433,3,gao,3005,292,11,10,21,52.4%,3m
2433,1,打人别打脸,3005,0,3,2,5,60.0%,38m
2433,3,yaliu,3005,0,1,1,2,50.0%,53m
2436,1,[社交学大可爱]深秋,3004,1340,99,94,193,51.3%,13m
2436,1,我很菜轻点打,3004,574,27,19,46,58.7%,28m
2436,3,Ling,3004,208,10,9,19,52.6%,14m
2436,3,MEFQSQ,3004,90,4,7,11,36.4%,6m
2436,1,鑫晗,3004,0,0,1,1,0.0%,39m
2441,1,IIIIIIIIIIII,3003,992,251,240,491,51.1%,24m
2441,3,狗毒爆都是儿子,3003,1586,71,66,137,51.8%,24m
2441,1,随便干的二五仔,3003,746,31,24,55,56.4%,50m
2441,1,星海霸主,3003,548,28,23,51,54.9%,21m
2441,1,[神虫一家亲]孙一喵是我老婆,3003,231,12,3,15,80.0%,14m
2441,1,一颗电竞梦想的心,3003,105,2,1,3,66.7%,18m
2441,3,抓鸭子抓几只,3003,0,0,1,1,0.0%,15m
2441,1,[夏祭]lonelyLOON,3003,0,0,1,1,0.0%,13m
2449,1,嘤嘤嘤嘤嘤嘤,3002,452,19,12,31,61.3%,51m
2449,3,疯恰恰,3002,241,19,20,39,48.7%,7m
2449,2,[梁山泊]eminem,3002,310,13,11,24,54.2%,28m
2449,1,[IBE]乾坤,3002,241,11,7,18,61.1%,50m
2449,1,[人人有功炼]大咖,3002,123,2,2,4,50.0%,28m
2449,1,hamber,3002,0,2,3,5,40.0%,1h
2449,3,楪祈,3002,0,1,1,2,50.0%,32m
2449,1,小猪,3002,40,1,4,5,20.0%,27m
2449,1,PImba,3002,0,0,1,1,0.0%,1h
2458,2,[小金上天队]比利,3001,206,8,3,11,72.7%,13m
2458,1,[纯路人]chb,3001,213,7,3,10,70.0%,27m
2458,1,[琴筝]星际争霸,3001,0,2,3,5,40.0%,51m
2458,1,[miku守护]Asds,3001,0,1,0,1,100.0%,15m
2458,1,赵小墨,3001,0,0,2,2,0.0%,50m
2463,1,[msyx]冥圣,3000,1493,68,64,132,51.5%,50m
2463,3,苦力怕,3000,86,14,15,29,48.3%,19m
2463,3,[Encore]妈妈厕所有鬼,3000,291,9,6,15,60.0%,4m
2463,1,Fumino,3000,0,3,2,5,60.0%,13m
2463,1,爱丽丝人仙,3000,0,3,2,5,60.0%,38m
2463,1,指南星,3000,0,3,2,5,60.0%,1h
2463,1,conatus,3000,0,1,4,5,20.0%,1h
2470,1,wqwqwq,2999,957,52,43,95,54.7%,17m
2470,1,靠谱为什么这么帅,2999,457,19,21,40,47.5%,18m
2470,2,[熊大和熊二]NAXX,2999,149,4,1,5,80.0%,10m
2470,3,[看我朵蜜你]巨臀队长,2999,0,3,5,8,37.5%,12m
2470,1,古风海豹,2999,0,1,4,5,20.0%,38m
2475,3,[猪一样的队友]求其的小白,2998,996,153,155,308,49.7%,27m
2475,3,[ME丶]MIsshY,2998,260,21,28,49,42.9%,19m
2475,1,[GL7]Shinami,2998,204,12,16,28,42.9%,24m
2475,3,ERtao,2998,144,7,2,9,77.8%,1h
2475,1,[奶爸你嘎哥]童嘎之瞳,2998,250,7,6,13,53.8%,39m
2475,2,[WCD]StanleyAlex,2998,34,2,0,2,100.0%,28m
2475,1,[神圣龙猪]龙小霞,2998,0,1,0,1,100.0%,45m
2475,3,[一起犯罪]土匪,2998,0,0,2,2,0.0%,52m
2483,1,狂龙,2997,498,17,16,33,51.5%,5m
2483,1,[孙哥的海鲜]Atalanta,2997,104,5,3,8,62.5%,12m
2485,3,loveddoouuu,2996,456,15,23,38,39.5%,26m
2485,1,羊刀,2996,249,9,11,20,45.0%,1h
2485,1,[菜的徐坤都怕]拳打南山养老院,2996,254,8,10,18,44.4%,17m
2485,3,[专拖后腿]coszj,2996,143,5,4,9,55.6%,35m
2485,3,[艾尔之主]VFskyrim,2996,117,2,2,4,50.0%,25m
2485,2,瞬间永恒,2996,0,1,0,1,100.0%,29m
2491,1,草草丶,2995,597,24,20,44,54.5%,27m
2491,2,要你命三千,2995,398,15,7,22,68.2%,30m
2491,1,bomber,2995,334,11,10,21,52.4%,6m
2491,3,[残日星宿]小恶魔鱼,2995,0,5,1,6,83.3%,1h
2491,1,[炮火46]yingnovation,2995,0,0,1,1,0.0%,59m
2496,3,[CPT]时崎狂三,2994,211,6,5,11,54.5%,15m
2496,1,寻思学家,2994,48,5,2,7,71.4%,12m
2496,1,[汉东男团]一心求死,2994,166,4,4,8,50.0%,23m
2496,1,Goulding,2994,172,4,4,8,50.0%,13m
2496,1,[CUMT]半城携半藏睡森林,2994,40,1,2,3,33.3%,1h
2496,2,低调低调呵,2994,0,0,1,1,0.0%,1h
2502,1,汤圆,2993,996,45,39,84,53.6%,7m
2502,2,[D0F]shinichi,2993,422,16,10,26,61.5%,13m
2502,2,[我队伍很强大]byj,2993,280,11,8,19,57.9%,26m
2502,1,灬折翼丶堕天使丨,2993,0,0,1,1,0.0%,1h
2506,3,优势了就要送一波,2992,121,3,2,5,60.0%,1h
2506,1,AsunaYuuk,2992,0,3,2,5,60.0%,48m
2506,1,未若橘花覆丶,2992,0,3,2,5,60.0%,1h
2506,1,巴塞塔,2992,0,3,2,5,60.0%,6m
2506,1,golden,2992,0,1,0,1,100.0%,45m
2511,1,[NavyF]无名,2991,443,46,35,81,56.8%,27m
2511,3,暴坑雪,2991,317,12,9,21,57.1%,11m
2511,1,艾尔之光,2991,0,3,2,5,60.0%,57m
2514,3,[永不放弃91]BurningAries,2990,677,53,58,111,47.7%,10m
2514,1,进击的艾伦,2990,38,2,2,4,50.0%,28m
2516,3,[Shawk]泰伦,2989,856,33,37,70,47.1%,16m
2516,1,[马氏太极拳]MoonKesin,2989,643,21,20,41,51.2%,7m
2516,3,玩世不恭,2989,164,8,3,11,72.7%,19m
2516,1,丹丹宝贝,2989,0,3,2,5,60.0%,48m
2520,3,[昊灵]zxx,2988,1262,59,58,117,50.4%,20m
2520,1,[六骑]MMA,2988,331,14,7,21,66.7%,15m
2520,2,鸽子军团长,2988,316,12,8,20,60.0%,9m
2520,2,[我不做人了]nilins,2988,304,10,6,16,62.5%,6m
2520,1,戏子,2988,150,4,6,10,40.0%,24m
2520,1,摇滚哪吒,2988,0,3,2,5,60.0%,56m
2520,3,IGXY,2988,0,1,0,1,100.0%,5m
2520,2,二零二零脱单成功,2988,0,0,1,1,0.0%,16m
2528,3,[Dracoi]sqrtthree,2987,136,4,3,7,57.1%,1h
2528,1,[笑傲星球]SunDay,2987,38,2,2,4,50.0%,13m
2528,3,LoveTT,2987,0,1,0,1,100.0%,14m
2528,2,[潸然丶那些年]Bachelor,2987,0,1,0,1,100.0%,52m
2532,1,白衣,2986,658,23,17,40,57.5%,16m
2532,3,放学后别走,2986,491,23,22,45,51.1%,20m
2532,1,豆子杀手,2986,407,11,12,23,47.8%,5m
2532,3,[DMRc]浅梦丿漓,2986,240,9,16,25,36.0%,17m
2532,2,[五月花]千年之蝶,2986,204,8,5,13,61.5%,22m
2532,1,[荒芜岁月]情如朝露去匆匆,2986,42,5,6,11,45.5%,39m
2532,1,青铜连胜王,2986,185,4,5,9,44.4%,13m
2539,1,一代人的怕和爱,2985,1649,176,164,340,51.8%,50m
2539,1,烦味丶凌驰,2985,97,4,2,6,66.7%,1h
2539,1,朴叙俊,2985,38,2,3,5,40.0%,16m
2539,2,Lighting,2985,0,0,1,1,0.0%,4m
2543,3,后浪,2984,1180,42,52,94,44.7%,22m
2543,1,金刚芭比宋小宝,2984,400,15,10,25,60.0%,15m
2543,3,回来,2984,234,12,11,23,52.2%,15m
2546,2,碧绿,2983,146,6,2,8,75.0%,52m
2546,2,[XXG]枫舞,2983,150,6,5,11,54.5%,6m
2546,2,[女王的茄子]DiDiBaBa,2983,0,0,1,1,0.0%,6m
2546,1,暴风城小卫兵,2983,0,0,1,1,0.0%,1h
2550,3,炮台狗自己滚,2982,1607,632,624,1256,50.3%,23m
2550,1,[仙女的云朵喵]忧伤的落樱,2982,96,4,2,6,66.7%,30m
2550,2,besttime,2982,0,1,0,1,100.0%,26m
2553,1,lntianxiunl,2981,322,11,4,15,73.3%,26m
2553,1,[暴雪十队]一寸灰,2981,284,10,8,18,55.6%,7m
2553,2,[暴雪五队]Dawn,2981,0,4,1,5,80.0%,19m
2553,1,来一打大和,2981,0,1,0,1,100.0%,1h
2553,3,小小铃铛,2981,0,1,1,2,50.0%,35m
2553,3,[艦Colle]MuraKumo,2981,0,1,2,3,33.3%,15m
2559,2,uile,2980,313,13,7,20,65.0%,30m
2559,1,iiiiiiiiiiii,2980,143,5,5,10,50.0%,52m
2559,3,LayoFlash,2980,97,4,3,7,57.1%,57m
2562,1,小酥饼吃了会变笨,2979,235,7,6,13,53.8%,59m
2562,1,RealChange,2979,151,6,2,8,75.0%,2m
2562,3,Piezo,2979,155,4,6,10,40.0%,1h
2562,2,[嗜魂舰队]卡尔哦皮,2979,0,1,0,1,100.0%,33m
2562,1,[序列sao]低音号黄前久美子,2979,0,0,1,1,0.0%,59m
2567,1,花开安静,2978,1634,184,177,361,51.0%,6m
2567,1,莪希醉厉嗐的异虫,2978,439,17,15,32,53.1%,27m
2567,3,[黑桃A]Joker,2978,358,15,15,30,50.0%,21m
2567,2,[Borne]翩跹,2978,254,10,8,18,55.6%,9m
2567,1,NEJFD,2978,176,9,6,15,60.0%,1h
2567,2,IIIIIIIIIIII,2978,224,7,3,10,70.0%,1h
2567,2,[逍寒]逍遥者寒号,2978,92,4,4,8,50.0%,15m
2567,3,[菜有菜的道理]小梆,2978,0,2,5,7,28.6%,12m
2567,2,arthas,2978,32,1,1,2,50.0%,17m
2567,1,[艾尔之巅]新手无虐,2978,0,1,1,2,50.0%,20m
2567,2,[TPZTPZ]llllllllllll,2978,38,1,4,5,20.0%,1h
2567,2,Sorry,2978,0,0,1,1,0.0%,4m
2579,3,[江上数峰青]石膏博士,2977,1492,117,110,227,51.5%,14m
2579,1,[情义天下]马大帅,2977,144,6,2,8,75.0%,38m
2579,3,地球联邦,2977,137,6,3,9,66.7%,5m
2579,2,[谁欠谁的幸福]千夜,2977,0,0,1,1,0.0%,53m
2579,3,小龙,2977,0,0,2,2,0.0%,25m
2584,3,小怂,2976,1296,62,64,126,49.2%,22m
2584,1,白菜菜,2976,885,34,32,66,51.5%,12m
2584,1,Aubergine,2976,794,30,35,65,46.2%,2m
2584,2,[HK丶S]阳光果粒橙,2976,30,2,0,2,100.0%,22m
2588,2,渣渣天乐,2975,414,12,15,27,44.4%,19m
2588,2,[ImPa丶]MacSed,2975,0,1,0,1,100.0%,11m
2588,2,群殴无敌菜鸟,2975,0,0,1,1,0.0%,12m
2588,2,[一波狂魔]llllllllllll,2975,0,0,1,1,0.0%,53m
2592,3,[泰伦战忽局]可爱天真纯,2974,81,9,22,31,29.0%,19m
2592,1,IIIIIIIIIIII,2974,0,3,2,5,60.0%,1h
2592,1,IIIIII,2974,129,2,7,9,22.2%,50m
2592,1,[文丑之考验]张小白,2974,0,0,2,2,0.0%,44m
2596,3,菜鸡孙一峰,2973,882,66,59,125,52.8%,9m
2596,2,哈喽卖地罚款,2973,418,19,10,29,65.5%,4m
2598,2,蓝莓果酱,2972,698,31,22,53,58.5%,53m
2598,1,神射手,2972,615,23,18,41,56.1%,19m
2600,1,雾雨魔理沙,2971,1348,160,143,303,52.8%,5m
2600,3,[疯狂掉分]zlxyxs,2971,732,63,45,108,58.3%,20m
2600,2,lazykun,2971,90,3,3,6,50.0%,12m
2600,2,就叫我小新吧,2971,0,1,0,1,100.0%,9m
2604,1,[BGD]桶哥,2970,499,87,73,160,54.4%,23m
2604,1,kirito,2970,461,19,15,34,55.9%,21m
2604,2,丢丢鱼,2970,120,3,0,3,100.0%,55m
2604,1,我不是谐星,2970,113,3,0,3,100.0%,1h
2608,1,[ZJU]迷迭香,2969,383,12,20,32,37.5%,5m
2608,2,[鸡层干部]维京落地杠大牛,2969,228,9,1,10,90.0%,53m
2608,1,BruderZeng,2969,150,4,12,16,25.0%,23m
2608,2,[四叶草]加冰流,2969,119,2,3,5,40.0%,17m
2608,2,Prismriver,2969,0,1,4,5,20.0%,14m
2608,2,[捌柒柒叁]旃东,2969,0,0,1,1,0.0%,54m
2608,2,LinkinPony,2969,0,0,1,1,0.0%,22m
2615,3,[RPGBoY]儿子许杰,2968,873,39,40,79,49.4%,13m
2615,1,IIIIIIIIIIII,2968,0,3,2,5,60.0%,6m
2615,1,[七咕咕]一束七,2968,0,3,2,5,60.0%,1h
2618,1,半个菜鸡,2967,232,22,17,39,56.4%,14m
2618,3,轻盈碟步,2967,304,13,9,22,59.1%,11m
2620,1,[YINGJI]GGboom,2966,872,34,29,63,54.0%,7m
2620,2,rrrrrrH,2966,745,32,23,55,58.2%,17m
2620,1,塔尔,2966,90,4,7,11,36.4%,27m
2620,2,ZHULU,2966,0,0,1,1,0.0%,1h
2624,1,[亡命之魂]zzr,2965,426,37,22,59,62.7%,20m
2624,1,萌受,2965,237,8,10,18,44.4%,1h
2624,1,EVAZ,2965,160,5,4,9,55.6%,18m
2624,1,[GalArC]星座二十八宿,2965,0,3,2,5,60.0%,18m
2624,2,[此花亭]不鄙视负分,2965,0,1,0,1,100.0%,15m
2624,2,探姬,2965,0,0,1,1,0.0%,10m
2630,2,[C81090]通杀武帝,2964,784,28,25,53,52.8%,20m
2630,2,风吹蛋凉,2964,650,23,36,59,39.0%,53m
2630,2,ftwoA,2964,316,14,11,25,56.0%,12m
2630,2,[AB神教]caicai,2964,140,6,4,10,60.0%,2m
2630,3,[炸鱼大队]上海老鸡,2964,97,3,5,8,37.5%,32m
2630,2,WGY,2964,0,0,1,1,0.0%,54m
2630,2,孤城,2964,0,0,2,2,0.0%,50m
2637,2,[小金上天队]久睡成瘾,2963,310,11,6,17,64.7%,26m
2637,2,[HUC轩辕]商业头脑,2963,318,11,7,18,61.1%,53m
2637,2,PartinG,2963,210,6,5,11,54.5%,44m
2637,2,[休闲的电脑]电脑,2963,58,3,1,4,75.0%,4m
2637,1,qiqi,2963,0,0,1,1,0.0%,1h
2642,2,[艾尔大断电]FTLK,2962,120,5,4,9,55.6%,53m
2642,3,TVAL,2962,97,2,1,3,66.7%,1h
2642,2,虚空者,2962,0,1,0,1,100.0%,19m
2642,2,陌欢,2962,93,1,2,3,33.3%,1h
2642,2,拖了板儿,2962,34,1,2,3,33.3%,28m
2647,3,随风,2961,250,8,5,13,61.5%,23m
2647,2,brown,2961,0,4,1,5,80.0%,12m
2647,2,[ling]lingperfect,2961,62,3,2,5,60.0%,12m
2647,1,让麻酱同化神族吧,2961,70,2,5,7,28.6%,20m
2647,1,今夜打母猪,2961,0,0,1,1,0.0%,1h
2652,3,[菜有菜的道理]Ilyich,2960,852,32,34,66,48.5%,4m
2652,2,小猪乔治,2960,443,19,15,34,55.9%,29m
2652,1,[3Ky]Rabbit,2960,379,14,16,30,46.7%,5m
2652,2,进取号的老舰长,2960,244,9,5,14,64.3%,1h
2652,2,[STTE]lovelin,2960,216,7,4,11,63.6%,10m
2652,1,[Shawk]QCsweet,2960,248,7,9,16,43.8%,2m
2652,2,推进之王,2960,139,6,4,10,60.0%,14m
2652,2,Francisco,2960,58,3,0,3,100.0%,50m
2652,3,[上帝的叹息]邪王真眼是最强的,2960,0,1,0,1,100.0%,5m
2661,2,[专业de团队]太行上帝,2959,62,3,1,4,75.0%,21m
2661,2,[ToHo]涛哥,2959,0,0,1,1,0.0%,23m
2663,1,[找虐]泽拉瑞斯大主教,2958,611,29,16,45,64.4%,12m
2663,2,[骑B团]上将军,2958,128,4,3,7,57.1%,16m
2663,3,超级迪克,2958,0,4,3,7,57.1%,22m
2663,2,CCblackknigh,2958,121,4,4,8,50.0%,12m
2663,1,IIIIIIIIIIII,2958,32,2,3,5,40.0%,21m
2663,1,DragonYang,2958,68,2,5,7,28.6%,16m
2663,1,[银翼之光]虚空梦魇,2958,74,2,7,9,22.2%,6m
2663,2,低调点饿的,2958,0,1,2,3,33.3%,1h
2663,2,鱼市场的孙骆驼,2958,0,0,1,1,0.0%,19m
2672,1,[虚拟歌手团体]钻石鸡苦练运营,2957,239,11,6,17,64.7%,16m
2672,2,[天棋阁]土鸡危苏速救,2957,30,1,3,4,25.0%,30m
2674,1,PrincipalZ,2956,814,39,41,80,48.8%,21m
2675,1,[NOBO]拂晓之光,2955,164,6,8,14,42.9%,5m
2675,3,去看海,2955,177,4,4,8,50.0%,15m
2675,2,[永远的艾尔]小艾才不是傲娇,2955,0,1,0,1,100.0%,12m
2675,2,VashMX,2955,30,1,1,2,50.0%,29m
2679,1,心跳无敌,2954,1198,44,43,87,50.6%,15m
2679,1,[敌人正在]撕碎我的部队,2954,0,1,0,1,100.0%,3m
2681,2,鶸乚,2953,1144,92,90,182,50.5%,9m
2681,1,开水,2953,965,49,40,89,55.1%,52m
2681,2,[Sc养老]Tory,2953,0,1,0,1,100.0%,53m
2684,1,[无节操拼下限]三十八度,2952,1579,386,359,745,51.8%,51m
2684,1,Superstition,2952,300,11,9,20,55.0%,53m
2684,2,[樱才生徒会]真心坑人,2952,92,4,2,6,66.7%,29m
2684,2,[百宝箱]星月凛,2952,34,2,1,3,66.7%,4m
2688,2,Mitterora,2951,236,10,8,18,55.6%,41m
2688,3,Mars,2951,108,4,10,14,28.6%,52m
2688,2,[不知道叫什么]新年年年,2951,30,2,0,2,100.0%,54m
2691,2,小丑,2950,1234,51,40,91,56.0%,12m
2691,1,[喜欢自定义]聖韻,2950,214,8,9,17,47.1%,11m
2691,2,[白给丶兄弟]麦麦的春紫苑,2950,226,7,4,11,63.6%,5m
2691,2,[星际lao瞎]死亡之翼,2950,0,1,0,1,100.0%,17m
2691,1,飞翔的岁月,2950,0,1,0,1,100.0%,1h
2696,3,Miyazono,2949,1117,81,75,156,51.9%,2m
2696,1,[吊炸天]宁德时代,2949,991,36,38,74,48.6%,21m
2696,2,IIFIIZIIQII,2949,318,12,13,25,48.0%,9m
2696,2,[突天脑回路]小猪的热巧克力,2949,0,1,0,1,100.0%,4m
2700,1,[DDOS传奇]ydycycyd,2948,641,25,22,47,53.2%,52m
2700,3,[火法]lulululunat,2948,215,6,8,14,42.9%,22m
2700,2,[艾尔之主]我好了你呢,2948,60,2,4,6,33.3%,52m
2700,3,[CPT]混元星际门的喽啰,2948,0,1,1,2,50.0%,1h
2704,1,[CoCo卫队]小八,2947,326,11,13,24,45.8%,21m
2704,2,llllllllllll,2947,266,10,9,19,52.6%,28m
2704,2,NOe,2947,134,3,3,6,50.0%,24m
2707,2,[萌的一笔]惑星指揮官,2946,1027,91,73,164,55.5%,28m
2707,2,[神武骑士团]东皇阁下,2946,66,2,2,4,50.0%,5m
2707,1,[黄漫老师]默白,2946,0,0,1,1,0.0%,1h
2710,2,IIIIIIIIIIII,2945,374,13,10,23,56.5%,50m
2710,2,Xiaokiss,2945,236,8,7,15,53.3%,28m
2712,1,ZerpMao,2944,804,29,26,55,52.7%,52m
2712,1,三笠,2944,108,3,2,5,60.0%,26m
2712,2,紫电,2944,118,1,4,5,20.0%,21m
2715,3,Chelsea,2943,1296,121,98,219,55.3%,12m
2715,1,曲鹏润,2943,929,35,27,62,56.5%,7m
2715,2,MarK,2943,422,14,12,26,53.8%,56m
2715,1,达死你,2943,348,14,16,30,46.7%,27m
2715,2,变成娜哈特的狗,2943,264,10,3,13,76.9%,12m
2715,2,[集美大学]集美孙一峰,2943,218,9,6,15,60.0%,2m
2715,2,[首席发怒啦]Eumenides,2943,86,4,1,5,80.0%,9m
2715,3,[SC2近卫军]我乱打的,2943,0,2,5,7,28.6%,25m
2723,2,[aeahz]休闲玩家,2942,1119,48,30,78,61.5%,20m
2723,2,[音乃木坂学院]SonodaUmi,2942,118,5,4,9,55.6%,53m
2723,2,[AcePoX]Roy,2942,94,3,4,7,42.9%,52m
2726,3,[HustSC]JokerGreed,2941,1092,50,61,111,45.0%,22m
2726,2,[zxcvxc]虐死个人,2941,64,3,2,5,60.0%,26m
2728,1,大师是个梦,2940,1220,82,84,166,49.4%,14m
2728,2,james,2940,212,7,3,10,70.0%,30m
2728,2,Craftdent,2940,0,5,2,7,71.4%,13m
2728,1,chicken,2940,119,4,1,5,80.0%,42m
2728,2,[菜鸡球带]湖鱼,2940,0,0,1,1,0.0%,24m
2733,1,[昆明RANK]一个比较浪漫的人,2939,444,54,46,100,54.0%,19m
2733,1,[罗马帝国]liuyunping,2939,512,16,18,34,47.1%,24m
2733,2,王小秋,2939,102,5,2,7,71.4%,12m
2733,2,Stardusst,2939,149,4,3,7,57.1%,53m
2733,2,welldoom,2939,88,4,4,8,50.0%,15m
2733,3,ForT,2939,68,2,5,7,28.6%,1h
2733,1,[暴雪我是你爹]神龙大侠,2939,0,1,0,1,100.0%,1h
2733,2,MAIPACE,2939,0,1,0,1,100.0%,2m
2741,1,LeoSydney,2938,974,55,58,113,48.7%,50m
2741,2,[SK]你与我相似,2938,225,13,4,17,76.5%,15m
2741,1,AngryBananan,2938,221,7,7,14,50.0%,16m
2741,2,IIIIIIIII,2938,120,4,5,9,44.4%,9m
2745,2,[极限战团]白给的阿米娅,2937,214,7,4,11,63.6%,23m
2745,1,[火焰雷兽]ted,2937,97,1,1,2,50.0%,1h
2745,1,Rockets,2937,0,0,1,1,0.0%,1h
2748,3,[火焰雷兽]Qianniu,2936,592,21,33,54,38.9%,23m
2748,1,[NSG致一]小猪爱睡觉,2936,533,18,19,37,48.6%,27m
2748,2,[高级吸血鬼]OnlyOneShty,2936,121,5,4,9,55.6%,14m
2748,3,快乐刀塔,2936,121,3,1,4,75.0%,49m
2748,2,guoyufan,2936,30,2,2,4,50.0%,10m
2748,2,SHAY,2936,60,2,2,4,50.0%,55m
2748,2,小彩笔,2936,0,1,1,2,50.0%,53m
2755,3,共和国之辉,2935,1443,87,89,176,49.4%,4m
2755,3,IIIIIIIIIIII,2935,418,13,30,43,30.2%,11m
2755,2,血凝羽翼,2935,0,1,1,2,50.0%,53m
2755,2,Veritas,2935,0,1,2,3,33.3%,52m
2755,2,[TALK]KKing,2935,42,1,4,5,20.0%,8m
2760,1,[半个菜鸟]SunHanoo,2934,1648,80,76,156,51.3%,15m
2760,2,小小擎,2934,583,24,24,48,50.0%,12m
2760,2,雪之下雪乃,2934,0,1,4,5,20.0%,8m
2763,2,[艾卫道特联盟]莱宁锡特,2933,369,13,9,22,59.1%,56m
2763,2,断章,2933,332,11,13,24,45.8%,55m
2763,2,[亀山社中]这么小声还开航母,2933,0,0,1,1,0.0%,53m
2763,2,[滨江嗝]大红克,2933,0,0,4,4,0.0%,5m
2767,2,APPLE,2932,624,100,96,196,51.0%,29m
2767,3,[珍珠奶茶]长草的田,2932,240,21,19,40,52.5%,23m
2767,1,丶哎哟啪啪啪,2932,253,9,5,14,64.3%,1h
2767,3,[psadnj]我是酒店老板,2932,207,7,2,9,77.8%,1h
2767,1,[第八舰队丶]敢同恶鬼争高下,2932,97,4,3,7,57.1%,27m
2767,1,[灰冥]摔下二楼的杰洛特,2932,48,1,3,4,25.0%,59m
2767,2,llllllllllll,2932,0,0,3,3,0.0%,10m
2774,1,[lIlIlI]Franky,2931,188,6,4,10,60.0%,1h
2774,1,TNT,2931,206,6,11,17,35.3%,51m
2774,2,[QFD]网骗梅林,2931,60,3,3,6,50.0%,26m
2774,2,[冲就完了]天涯明月刀,2931,120,3,3,6,50.0%,15m
2774,2,Refight,2931,60,2,2,4,50.0%,19m
2774,1,梦前光,2931,0,1,0,1,100.0%,21m
2774,2,阿克苏大苹果,2931,0,1,0,1,100.0%,17m
2781,2,[无形白给]小小雷神,2930,0,1,0,1,100.0%,4m
2781,2,管子村村长,2930,0,0,1,1,0.0%,29m
2783,2,[X英雄圣域X]诸星,2929,418,16,11,27,59.3%,56m
2783,3,lovezly,2929,219,8,9,17,47.1%,52m
2783,2,Scorpio,2929,60,3,3,6,50.0%,9m
2783,1,盛世之樱,2929,0,1,0,1,100.0%,1h
2783,2,[lxh123]alleria,2929,0,1,0,1,100.0%,19m
2783,2,[菜有菜的道理]幻虚无,2929,95,1,1,2,50.0%,17m
2789,2,[幽明异路]白狼,2928,0,4,1,5,80.0%,1h
2789,2,VTorres,2928,88,4,2,6,66.7%,23m
2789,1,IMMVP,2928,96,2,4,6,33.3%,1h
2789,3,dtMAGA,2928,0,1,0,1,100.0%,29m
2789,2,[虐菜]Banehallow,2928,0,0,1,1,0.0%,12m
2789,1,我是大怪物,2928,0,0,1,1,0.0%,10m
2795,1,MRSMILE,2927,317,39,35,74,52.7%,19m
2795,2,狗王之王,2927,241,10,6,16,62.5%,15m
2795,2,紫水栈桥,2927,146,5,5,10,50.0%,6m
2795,2,[3JJJ]小尐尛尛,2927,30,2,1,3,66.7%,29m
2795,2,[老衲憋不住啦]fangji,2927,30,2,4,6,33.3%,12m
2795,2,Juhe,2927,88,2,4,6,33.3%,28m
2801,1,yuki,2926,1675,97,88,185,52.4%,55m
2801,3,一条咸鱼,2926,149,7,3,10,70.0%,1h
2801,2,fgjmk,2926,154,6,6,12,50.0%,9m
2801,2,[瘾大眼瞎]唐诗,2926,172,5,4,9,55.6%,1h
2801,2,试试水,2926,30,1,1,2,50.0%,8m
2801,2,[Drgon]神丨桀骜者,2926,0,1,1,2,50.0%,52m
2807,1,Jack,2925,1653,225,222,447,50.3%,27m
2807,2,在家睡觉,2925,1587,116,101,217,53.5%,2m
2807,2,[小狐狸]电波波波酱嘤嘤嘤,2925,136,4,0,4,100.0%,20m
2807,3,庐山升龙霸,2925,0,0,1,1,0.0%,33m
2811,2,一苇渡江,2924,0,4,1,5,80.0%,1h
2811,2,咱没有名气,2924,66,4,1,5,80.0%,27m
2811,2,hzqj,2924,0,1,0,1,100.0%,12m
2814,2,浪蝶对狂蜂,2923,1623,319,309,628,50.8%,30m
2814,1,白金机甲,2923,166,8,7,15,53.3%,1h
2814,2,八云芦苇,2923,30,2,0,2,100.0%,52m
2817,3,Death,2922,647,93,104,197,47.2%,13m
2817,2,喊硬霸的都是菜,2922,241,8,4,12,66.7%,56m
2817,2,Milky,2922,147,6,0,6,100.0%,4m
2817,3,桥四爷,2922,97,4,3,7,57.1%,21m
2817,1,瞎子,2922,96,1,1,2,50.0%,1h
2817,2,littlejacky,2922,0,0,1,1,0.0%,23m
2817,2,cced,2922,0,0,3,3,0.0%,1h
2824,1,[蓝蓝路]rera,2921,1361,52,48,100,52.0%,12m
2824,1,心灵风暴,2921,565,33,29,62,53.2%,27m
2824,2,[霸气雄图]小小呆,2921,734,31,19,50,62.0%,29m
2824,1,这个世界太乱,2921,211,7,4,11,63.6%,4m
2824,2,愤怒的打卤面,2921,116,6,3,9,66.7%,16m
2824,2,想不出,2921,0,3,2,5,60.0%,56m
2824,2,FenGX,2921,42,1,5,6,16.7%,51m
2824,1,[深空骑士]tpz,2921,0,0,1,1,0.0%,6m
2832,2,[综合酯法]人人有功练,2920,359,13,8,21,61.9%,19m
2832,1,[X英雄圣域X]霸气丸子,2920,123,6,14,20,30.0%,5m
2832,3,[遥远的拂晓]FakeNews,2920,92,1,2,3,33.3%,13m
2835,2,[探索者]寡妇制造者,2919,1223,245,222,467,52.5%,52m
2835,1,黄鸡舰队,2919,374,14,15,29,48.3%,28m
2835,3,[KN]thetastar,2919,243,9,7,16,56.2%,4m
2835,2,[Cms]Flash,2919,0,1,0,1,100.0%,17m
2835,2,[SCMIW]笔芯,2919,0,1,0,1,100.0%,30m
2840,3,吴小白,2918,131,2,3,5,40.0%,15m
2840,2,十三少灬,2918,0,0,1,1,0.0%,6m
2840,1,fljlove,2918,0,0,2,2,0.0%,1h
2843,1,麻辣小龙虾,2917,1213,705,703,1408,50.1%,51m
2843,2,FORME,2917,989,49,47,96,51.0%,28m
2843,2,[HFUOT]Sarrel,2917,909,39,31,70,55.7%,14m
2843,1,禁止非法炸鱼,2917,314,10,13,23,43.5%,6m
2843,3,杜渝成,2917,215,8,5,13,61.5%,1h
2843,1,醉丶清风灬,2917,117,6,1,7,85.7%,10m
2843,2,[知乎战队]长门有希,2917,0,0,1,1,0.0%,29m
2850,1,李娜同学水里吻我,2916,722,128,119,247,51.8%,26m
2850,2,业火袭吊,2916,270,11,8,19,57.9%,54m
2850,1,[BeeOne]SuperStan,2916,244,9,7,16,56.2%,35m
2853,2,[loveMM]king,2915,496,18,16,34,52.9%,5m
2853,1,[星际旅游团]asgardking,2915,266,9,12,21,42.9%,42m
2853,2,不怕神一样的对手,2915,102,4,4,8,50.0%,21m
2853,3,[拨云见日]卧龙,2915,131,4,7,11,36.4%,49m
2853,2,御剑江湖,2915,32,2,1,3,66.7%,4m
2853,1,mkz,2915,118,2,1,3,66.7%,1h
2853,2,宽锚人未来可期,2915,0,1,0,1,100.0%,15m
2853,2,[PaPaZ]涅普姬雅,2915,99,1,4,5,20.0%,53m
2853,3,日天,2915,0,0,1,1,0.0%,33m
2862,2,姑娘莫怕,2914,554,23,21,44,52.3%,16m
2862,3,打星际我只玩神族,2914,166,4,3,7,57.1%,1h
2862,2,天杀的,2914,0,0,1,1,0.0%,16m
2865,3,[沉沦深渊]梁魈,2913,120,6,3,9,66.7%,60m
2865,2,遗言,2913,0,4,1,5,80.0%,50m
2865,2,王者的慈悲,2913,60,3,1,4,75.0%,53m
2865,2,居烟奈,2913,0,1,2,3,33.3%,1h
2869,2,[老吴天下第一]普通人族李信衡,2912,719,29,23,52,55.8%,20m
2869,2,皮西,2912,415,18,8,26,69.2%,50m
2869,2,[一针见血]Demon,2912,385,14,15,29,48.3%,11m
2869,1,闪电五连鞭,2912,158,5,11,16,31.2%,13m
2869,3,TerranX,2912,135,4,2,6,66.7%,4m
2869,2,[小仙女已上线]Garfield,2912,0,3,2,5,60.0%,16m
2869,2,cary,2912,0,1,0,1,100.0%,19m
2869,2,[ZTSCAP]JOKE,2912,0,1,0,1,100.0%,20m
2869,2,[BLZSC2]神话哥哥,2912,0,0,1,1,0.0%,23m
2869,2,spj,2912,73,0,2,2,0.0%,53m
2879,1,我曾触及星辰,2911,209,38,32,70,54.3%,14m
2879,1,lavapeacocg,2911,339,16,14,30,53.3%,9m
2879,2,喀喀喀,2911,0,4,1,5,80.0%,1h
2879,2,SCPLAYER,2911,0,1,0,1,100.0%,22m
2883,2,[暴雪二十六队]只玩神族的新人,2910,196,10,5,15,66.7%,5m
2883,2,乳山小霸王,2910,184,6,9,15,40.0%,17m
2883,2,暗影猎手,2910,154,4,3,7,57.1%,55m
2883,2,[上古世纪]ylnx,2910,86,3,3,6,50.0%,12m
2883,3,Light,2910,93,1,2,3,33.3%,13m
2883,2,[奥术之光]HoshimatiSui,2910,30,1,2,3,33.3%,22m
2889,3,撒旦复苏,2909,1585,174,177,351,49.6%,4m
2889,2,[黄金战队]洛殿,2909,674,31,25,56,55.4%,12m
2889,2,木子曦,2909,241,13,13,26,50.0%,26m
2889,2,老仙奶我人生不顺,2909,0,3,2,5,60.0%,19m
2889,2,Shadow,2909,92,3,5,8,37.5%,22m
2889,2,[社交学大可爱]AMG,2909,88,3,7,10,30.0%,12m
2889,2,[不想打内战]Nerazim,2909,30,2,0,2,100.0%,23m
2889,1,梅普璐,2909,95,2,0,2,100.0%,23m
2889,2,中也,2909,0,1,0,1,100.0%,52m
2889,2,Change,2909,0,1,0,1,100.0%,23m
2889,1,[113]达文西,2909,0,1,0,1,100.0%,39m
2889,1,[盈盈一水间]土豆小胡,2909,0,0,1,1,0.0%,48m
2901,1,[你选的嘛偶像]武君罗喉,2908,1242,49,46,95,51.6%,12m
2901,2,[暗狱]突丝猫,2908,208,6,4,10,60.0%,24m
2901,2,StarAlliance,2908,91,2,0,2,100.0%,4m
2901,2,[Gondor]Aragorn,2908,88,2,0,2,100.0%,56m
2905,1,星际迷航,2907,136,12,12,24,50.0%,25m
2905,3,IIlIlIIIIIll,2907,145,3,2,5,60.0%,1h
2905,1,[龙帝星云]巴巴罗萨,2907,96,2,0,2,100.0%,7m
2905,2,IIIIlIlIlIlI,2907,0,0,1,1,0.0%,19m
2909,1,若休丶,2906,1629,97,89,186,52.2%,55m
2909,2,李晶晶,2906,260,12,10,22,54.5%,26m
2909,2,呵呵呵哈哈哈哈,2906,228,9,4,13,69.2%,5m
2909,1,Darkangle,2906,220,5,10,15,33.3%,19m
2909,2,一代天骄,2906,92,1,1,2,50.0%,13m
2914,1,[伊瑟蓓拉]御坂美琴,2905,0,4,2,6,66.7%,27m
2914,2,三尾虎,2905,0,2,2,4,50.0%,1h
2916,3,[抽爷]wwqlove,2904,1516,725,715,1440,50.3%,55m
2916,3,BPD,2904,1515,233,248,481,48.4%,19m
2916,2,[ZCW]Jarhsing,2904,316,13,9,22,59.1%,10m
2916,1,啦啦啦德玛西亚,2904,141,5,4,9,55.6%,28m
2916,2,拉面,2904,58,2,2,4,50.0%,13m
2916,2,苏希然,2904,0,2,3,5,40.0%,16m
2922,2,[风暴领主]你是真的狗,2903,227,30,29,59,50.8%,17m
2922,1,[老男孩星际]Trap,2903,166,8,14,22,36.4%,51m
2922,2,[上帝的叹息]作死骚年,2903,0,3,2,5,60.0%,16m
2925,1,fkoh,2902,426,22,24,46,47.8%,51m
2925,2,[为谁而忧伤]lavigne,2902,0,4,1,5,80.0%,1h
2925,2,不法分子,2902,62,2,6,8,25.0%,52m
2925,2,gansihuangxu,2902,0,1,0,1,100.0%,18m
2925,1,Bogus,2902,0,1,0,1,100.0%,1h
2925,2,[七星]assassinkjx,2902,0,1,4,5,20.0%,22m
2925,1,SeRral,2902,0,0,1,1,0.0%,1h
2932,3,小短腿,2901,1494,148,137,285,51.9%,22m
2932,3,巴拉拉,2901,827,34,40,74,45.9%,11m
2932,2,[WinWin]koko,2901,116,26,26,52,50.0%,13m
2932,2,孤独巡礼,2901,375,20,13,33,60.6%,12m
2932,3,沙福林大人,2901,175,11,26,37,29.7%,22m
2932,2,hoshgonen,2901,0,2,3,5,40.0%,53m
2932,2,沈渊,2901,0,1,0,1,100.0%,29m
2932,2,浴血荣耀,2901,0,0,1,1,0.0%,21m
2932,1,[鬼谷]人族就输不了,2901,0,0,2,2,0.0%,1h
2941,1,熊猫,2900,206,6,8,14,42.9%,13m
2941,1,今天瑞瑞嘴甜了嘛,2900,0,3,3,6,50.0%,1h
2941,1,hhhhh,2900,116,3,12,15,20.0%,7m
2941,2,[国足救星]sunny,2900,32,1,2,3,33.3%,28m
2945,2,钟汉良,2899,204,24,22,46,52.2%,53m
2945,2,[风后奇门]ToliSeaSon,2899,622,24,28,52,46.2%,12m
2945,2,喵苏鲁的呼唤,2899,373,17,11,28,60.7%,30m
2948,2,[DMRe]马老师,2898,500,22,14,36,61.1%,12m
2948,2,戏言,2898,120,5,6,11,45.5%,27m
2948,2,[痞子敢死队]Clarence,2898,0,1,0,1,100.0%,29m
2948,2,[l海贼l]王路飞,2898,30,1,4,5,20.0%,4m
2952,2,[AgCu电池]我雷兽三连了,2897,154,8,5,13,61.5%,10m
2952,2,杰森,2897,0,4,1,5,80.0%,8m
2952,2,[快乐白给]艺术就是派大星,2897,30,2,1,3,66.7%,29m
2952,2,[逗比神教]零零小副官,2897,46,1,2,3,33.3%,1h
2956,2,[埃蒙调教团]rose,2896,255,10,6,16,62.5%,56m
2956,2,Letsburning,2896,142,5,1,6,83.3%,29m
2956,2,chiron,2896,30,2,1,3,66.7%,12m
2956,2,[西瓜杯]SilverSax,2896,88,1,1,2,50.0%,9m
2956,2,Ooplus,2896,22,1,2,3,33.3%,19m
2961,1,绝影,2895,691,54,48,102,52.9%,7m
2961,1,闪电五鞭,2895,424,14,19,33,42.4%,51m
2961,2,FIREQIU,2895,178,5,4,9,55.6%,19m
2961,2,砍人就对了,2895,0,0,2,2,0.0%,29m
2965,2,阻碍战争,2894,276,10,8,18,55.6%,15m
2965,2,张战天,2894,188,8,7,15,53.3%,23m
2965,2,狼仔,2894,172,6,7,13,46.2%,55m
2965,3,[野蛮猫骑士]她说万幸得以相识,2894,190,6,7,13,46.2%,14m
2965,2,杰明,2894,0,3,2,5,60.0%,53m
2965,3,桥言,2894,30,2,0,2,100.0%,14m
2965,2,DackStar,2894,30,2,3,5,40.0%,17m
2965,1,[单人模拟战]简单电脑,2894,0,1,0,1,100.0%,1h
2965,2,[江南狗王]SKTVIP,2894,0,0,1,1,0.0%,30m
2974,2,Lightning,2893,1506,80,79,159,50.3%,12m
2974,2,Allen,2893,1282,47,47,94,50.0%,3m
2974,2,骆驼,2893,334,12,14,26,46.2%,17m
2974,2,[第三帝國]RangerTazear,2893,244,8,6,14,57.1%,3m
2974,2,咸菜太贵了,2893,88,2,1,3,66.7%,24m
2974,2,猪油拌饭,2893,0,2,2,4,50.0%,1h
2974,2,[麻酱罐]依等红杏出墙,2893,0,2,3,5,40.0%,19m
2981,2,IIIIIIIIIIII,2892,1216,55,37,92,59.8%,3m
2981,2,七重人格,2892,985,38,35,73,52.1%,29m
2981,1,有点骚,2892,709,31,29,60,51.7%,22m
2981,2,pimbaisuck,2892,172,7,10,17,41.2%,4m
2981,3,公主牵老牛,2892,196,6,4,10,60.0%,1h
2981,1,[小菜鸟集中营]星游狼,2892,119,2,2,4,50.0%,28m
2981,2,WarriorZKB,2892,0,0,1,1,0.0%,28m
2988,1,波波良小伞,2891,1168,108,96,204,52.9%,25m
2988,1,AKGhoul,2891,568,35,35,70,50.0%,27m
2988,2,[APM30]高能瓦斯,2891,236,9,7,16,56.2%,26m
2988,2,霸蛮二杆子,2891,0,1,0,1,100.0%,1h
2992,1,倒走,2890,1463,416,397,813,51.2%,19m
2992,2,[妹控万岁]Asura,2890,1024,47,49,96,49.0%,55m
2992,2,sealer,2890,95,3,3,6,50.0%,1h
2992,2,[Strike]TheExileZAnd,2890,0,0,1,1,0.0%,14m
2996,1,[小鸡屠宰场3]你大哥,2889,1648,162,152,314,51.6%,28m
2996,1,MetalBron,2889,118,6,2,8,75.0%,38m
2996,2,混三第二帅,2889,0,0,1,1,0.0%,19m
2999,2,[白给丶兄弟]一百,2888,444,17,13,30,56.7%,8m
2999,2,Jack,2888,340,12,11,23,52.2%,10m
2999,1,黑子,2888,187,7,4,11,63.6%,1h
2999,2,茅野爱衣,2888,0,4,1,5,80.0%,4m
2999,2,nale,2888,0,0,2,2,0.0%,56m
3004,2,节操战士,2887,1161,46,45,91,50.5%,3m
3004,1,[loveMM]许昌孙一峰,2887,1203,45,45,90,50.0%,51m
3004,2,iiiiiiiiiiii,2887,305,13,6,19,68.4%,12m
3004,1,[SDgame]VanBryan,2887,163,6,5,11,54.5%,21m
3004,2,SDsd,2887,0,3,2,5,60.0%,37m
3004,2,[Beam]VoidVoyage,2887,30,1,2,3,33.3%,7m
3004,1,银红星河,2887,97,1,2,3,33.3%,38m
3011,2,投降输一半,2886,1081,77,61,138,55.8%,17m
3011,1,[欧佩克]撒旦神曲,2886,96,5,2,7,71.4%,25m
3011,3,[薇薇安]Omnipotent,2886,95,4,4,8,50.0%,1h
3011,2,耳东陈,2886,0,3,2,5,60.0%,1h
3011,1,我是菜鸟,2886,0,1,0,1,100.0%,36m
3016,1,[半个菜鸟]娇娇大锤,2885,1518,116,118,234,49.6%,22m
3016,2,史彼得羊,2885,330,13,13,26,50.0%,5m
3016,2,WON,2885,0,3,2,5,60.0%,56m
3019,2,JJQQ,2884,1442,121,107,228,53.1%,12m
3019,2,AAA,2884,173,8,4,12,66.7%,55m
3019,1,IIIIIIIIIIII,2884,119,4,4,8,50.0%,1h
3019,2,Joker,2884,18,2,5,7,28.6%,21m
3023,2,强者的苦痛,2883,497,20,14,34,58.8%,30m
3023,2,待时间嘉许,2883,246,8,8,16,50.0%,12m
3023,2,呵呵,2883,80,4,4,8,50.0%,30m
3023,2,菁菁鲸,2883,102,3,0,3,100.0%,3m
3023,2,薰薰张,2883,94,2,1,3,66.7%,1h
3023,2,[東佰往事]泛希腊太守,2883,0,0,3,3,0.0%,37m
3029,2,Agoni,2882,0,3,2,5,60.0%,53m
3029,2,樱落阶前月,2882,88,2,4,6,33.3%,3m
3029,2,sfp,2882,0,1,2,3,33.3%,30m
3029,2,[白斩鸡]Tam,2882,0,0,1,1,0.0%,5m
3033,2,ElevenGG,2881,1435,336,337,673,49.9%,30m
3033,1,Huebeck,2881,1646,116,121,237,48.9%,55m
3033,2,红狐狸,2881,395,16,17,33,48.5%,30m
3033,2,风之缘,2881,216,8,5,13,61.5%,29m
3033,1,蒂亚尼斯,2881,48,1,2,3,33.3%,58m
3038,2,注意我走位,2880,536,105,103,208,50.5%,29m
3038,2,艾思徽尔,2880,348,13,12,25,52.0%,27m
3038,2,[可遇不可求]练出来了,2880,270,10,7,17,58.8%,52m
3038,3,[艾尔之巅]我是余威我怕谁,2880,118,5,3,8,62.5%,30m
3038,2,[宇宙何平]wlitrun,2880,185,5,4,9,55.6%,54m
3038,2,高数干离散,2880,0,1,0,1,100.0%,1h
3038,1,wyj,2880,0,1,0,1,100.0%,1h
3038,2,天地,2880,0,1,3,4,25.0%,24m
3038,3,Iamfine,2880,0,0,1,1,0.0%,21m
3047,2,[loveMM]阿道夫特朗普,2879,959,47,43,90,52.2%,12m
3047,2,锦鸡舞,2879,521,45,38,83,54.2%,8m
3047,1,[媛气少女]不改一次浪费了,2879,422,35,34,69,50.7%,16m
3047,2,[崂山道士]三班李倩,2879,360,14,10,24,58.3%,52m
3047,2,llllllllllll,2879,192,5,5,10,50.0%,41m
3047,2,逼嘴辣啊,2879,46,4,2,6,66.7%,33m
3047,2,[Vgirls]命运天使,2879,0,2,1,3,66.7%,1h
3047,3,第五邪神,2879,0,1,0,1,100.0%,7m
3055,2,我玩不过你,2878,315,12,9,21,57.1%,27m
3055,3,枯木龙吟照大千,2878,0,4,1,5,80.0%,7m
3055,1,[熊大和熊二]一波流大师,2878,94,1,2,3,33.3%,45m
3055,1,[秋毫]年轻人不讲武德,2878,0,1,2,3,33.3%,1h
3059,1,[高富帅]小牛牛,2877,297,10,13,23,43.5%,1h
3059,1,[蛟龙突击队]DemoEisT,2877,144,4,3,7,57.1%,1h
3059,3,纵横天下,2877,58,2,2,4,50.0%,14m
3059,1,痴情总被无情伤,2877,0,2,5,7,28.6%,52m
3059,1,Aurora,2877,0,1,0,1,100.0%,39m
3064,2,jjinncqd,2876,759,31,28,59,52.5%,27m
3064,2,[衣钵之卫]看有灰机,2876,385,17,11,28,60.7%,3m
3064,1,Oneminute,2876,179,7,7,14,50.0%,27m
3064,2,光滑滑,2876,0,3,2,5,60.0%,1h
3064,3,ypaaaaaa,2876,30,2,0,2,100.0%,30m
3064,3,[SCD]蘑菇,2876,0,1,0,1,100.0%,21m
3064,1,[北京城管]永恒国度,2876,0,0,1,1,0.0%,17m
3064,3,[DSE]群峰之巅,2876,0,0,1,1,0.0%,22m
3072,1,[BLaDe]一把大宝剑,2875,181,6,5,11,54.5%,1h
3072,3,[四叶草]WindySummer,2875,0,1,0,1,100.0%,14m
3072,3,MVP,2875,0,0,1,1,0.0%,29m
3072,3,我菜我骄傲,2875,0,0,1,1,0.0%,24m
3076,2,库那么塔塔,2874,958,35,35,70,50.0%,15m
3076,2,pandaxia,2874,271,15,10,25,60.0%,15m
3076,1,[ssts]梦醒时分,2874,164,7,10,17,41.2%,9m
3076,2,Snoopy,2874,46,4,3,7,57.1%,33m
3076,3,monster,2874,97,4,4,8,50.0%,1h
3076,3,[斑斓]Coloryellow,2874,0,0,1,1,0.0%,53m
3082,2,蒙眼砸键盘,2873,347,15,7,22,68.2%,19m
3082,2,SSS,2873,314,11,11,22,50.0%,17m
3082,3,起点,2873,175,7,7,14,50.0%,57m
3082,3,爱丽丝神皇,2873,86,3,2,5,60.0%,18m
3082,2,EMINEM,2873,30,1,6,7,14.3%,53m
3082,1,[温柔兔公主]快乐星际,2873,85,1,6,7,14.3%,1h
3088,1,[ACG系]TheGrist,2872,293,12,10,22,54.5%,22m
3088,2,泡泡龙,2872,0,3,2,5,60.0%,1h
3088,3,[慢手e族]执政官,2872,0,1,0,1,100.0%,4m
3091,2,SiriusSix,2871,287,10,10,20,50.0%,41m
3091,1,[歪比]llllllllllll,2871,164,4,0,4,100.0%,1h
3091,2,[人族最强近战]大師兄,2871,92,3,5,8,37.5%,17m
3094,2,Kirin,2870,595,23,16,39,59.0%,10m
3094,1,逗比在此,2870,232,8,4,12,66.7%,27m
3094,3,[鸡饲料协会]tardis,2870,0,3,2,5,60.0%,11m
3094,2,[冠冕]lingtas,2870,0,3,2,5,60.0%,16m
3094,3,MacSedAir,2870,30,1,1,2,50.0%,14m
3094,3,黎明,2870,0,0,1,1,0.0%,25m
3100,1,Paradise,2869,1626,315,307,622,50.6%,12m
3100,2,她与疾风都是过客,2869,472,18,19,37,48.6%,56m
3102,2,四面楚歌,2868,430,23,21,44,52.3%,29m
3102,3,Sterben,2868,309,12,13,25,48.0%,30m
3102,2,星空虫族,2868,88,5,2,7,71.4%,29m
3102,3,周先丶森,2868,58,3,1,4,75.0%,14m
3102,2,[混吃混喝]狂魔,2868,0,1,1,2,50.0%,28m
3107,3,ALLFATHER,2867,1491,140,141,281,49.8%,54m
3107,2,低调逃生,2867,1170,47,43,90,52.2%,7m
3107,2,[OowoO]Jackie,2867,0,3,2,5,60.0%,1h
3107,3,foe,2867,0,0,1,1,0.0%,14m
3111,1,[云和山的彼端]横艾丶,2866,230,5,3,8,62.5%,58m
3111,3,夏天绿茶,2866,30,1,1,2,50.0%,7m
3113,3,[MSC]战旗至上,2865,1577,88,72,160,55.0%,19m
3113,2,对酒当歌,2865,258,8,8,16,50.0%,30m
3113,2,[第一次玩]Nryu,2865,156,6,2,8,75.0%,20m
3116,3,kira,2864,338,42,47,89,47.2%,18m
3116,2,[leia]Leia,2864,362,17,19,36,47.2%,4m
3116,2,小蚂蚁爱上树,2864,336,14,13,27,51.9%,19m
3116,3,叶叶叶叶,2864,233,9,7,16,56.2%,1h
3116,2,深田咏美,2864,210,8,10,18,44.4%,20m
3121,1,CyberVisionY,2863,1590,184,193,377,48.8%,51m
3121,2,[菜有菜的道理]求求你不要狗我,2863,404,15,15,30,50.0%,19m
3121,3,black,2863,202,8,6,14,57.1%,13m
3121,3,SCV,2863,30,5,1,6,83.3%,19m
3121,3,[东站任我行]快跑呀,2863,30,2,0,2,100.0%,7m
3121,3,yAh,2863,0,0,1,1,0.0%,23m
3127,2,[学习使我快乐]JeaaYellowSt,2862,0,0,1,1,0.0%,1h
3128,2,随风而来,2861,464,20,19,39,51.3%,19m
3128,1,Ahri,2861,288,12,10,22,54.5%,6m
3128,3,狱锁狂龙,2861,86,4,0,4,100.0%,25m
3128,2,llllllllllll,2861,0,3,2,5,60.0%,16m
3128,3,[人菜灬瘾大]tREE,2861,131,2,4,6,33.3%,22m
3128,3,小老虎,2861,0,0,1,1,0.0%,15m
3134,2,[星际罪恶]神舟文明,2860,1072,92,77,169,54.4%,17m
3134,1,Rainbow,2860,779,30,32,62,48.4%,52m
3134,2,摸仙小王,2860,286,12,9,21,57.1%,15m
3134,1,恋蝶无邪,2860,181,7,11,18,38.9%,18m
3134,2,小发烧,2860,0,4,1,5,80.0%,1h
3134,2,Alexah,2860,102,3,6,9,33.3%,29m
3140,2,Romance,2859,121,5,5,10,50.0%,14m
3141,3,AOS,2858,568,21,20,41,51.2%,12m
3141,3,燃尽一世繁华,2858,279,11,2,13,84.6%,5m
3141,1,女司机开发迪士尼,2858,119,6,3,9,66.7%,25m
3141,2,[s黑色玫瑰s]贤贤易色,2858,0,4,1,5,80.0%,1h
3141,1,大道至简,2858,165,4,4,8,50.0%,28m
3141,2,南布岛,2858,0,3,2,5,60.0%,1h
3141,3,FearX,2858,0,1,0,1,100.0%,23m
3141,2,[你们都是渣]嘿嘿嘿,2858,0,1,1,2,50.0%,1h
3141,2,八级大狂风,2858,0,1,2,3,33.3%,19m
3150,3,[神子]卖乖儿,2857,537,22,22,44,50.0%,11m
3150,2,供奉我吧奴仆们,2857,92,6,4,10,60.0%,1h
3150,2,[史蒂夫头]罗保,2857,0,2,3,5,40.0%,1h
3150,3,汝可识得此阵,2857,0,1,0,1,100.0%,26m
3150,3,[传奇舰队]宝贝龙,2857,0,0,1,1,0.0%,23m
3150,2,熊猫在燃烧,2857,0,0,3,3,0.0%,12m
3156,2,[深海栖姬]茵催思汀,2856,1511,80,67,147,54.4%,17m
3156,3,XXBEST,2856,373,27,17,44,61.4%,5m
3156,3,你掀起波澜,2856,196,10,5,15,66.7%,22m
3156,1,Alex,2856,119,6,3,9,66.7%,25m
3160,1,[somax]blackcamel,2855,1424,48,59,107,44.9%,25m
3160,2,YukoOgur,2855,546,20,26,46,43.5%,3m
3160,2,yqx,2855,301,11,9,20,55.0%,53m
3160,1,仙人抚我地中海,2855,186,6,6,12,50.0%,49m
3160,3,COldzera,2855,116,5,1,6,83.3%,18m
3160,3,洛灬夜,2855,30,1,2,3,33.3%,22m
3166,1,猴哥,2854,1300,72,69,141,51.1%,51m
3166,3,DALI,2854,0,4,1,5,80.0%,2m
3166,3,RAY,2854,34,4,5,9,44.4%,33m
3166,3,Rexsun,2854,122,2,3,5,40.0%,31m
3166,1,恰克船长,2854,0,1,1,2,50.0%,30m
3171,1,被抢的海盗船长,2853,1619,656,651,1307,50.2%,13m
3171,2,AbAcUS,2853,212,8,9,17,47.1%,10m
3171,3,猥琐的香蕉,2853,190,5,4,9,55.6%,56m
3171,1,EslArphone,2853,0,3,3,6,50.0%,10m
3171,3,[自创]Aster,2853,119,2,2,4,50.0%,1h
3171,3,年轻人耗子尾汁,2853,0,0,1,1,0.0%,15m
3177,1,愛伱一辈孓,2852,1340,132,131,263,50.2%,28m
3177,2,[第九舰队丶]有点故事的男孩子,2852,588,21,20,41,51.2%,52m
3177,2,三嗦螺丝,2852,194,9,7,16,56.2%,4m
3177,2,[Range]Mishion,2852,0,3,2,5,60.0%,1h
3177,3,[透一下清酒]喜欢小郑同学,2852,0,3,2,5,60.0%,54m
3177,3,Zest,2852,123,3,9,12,25.0%,15m
3177,2,[萌新在下挨打]小鳌,2852,0,1,0,1,100.0%,5m
3177,3,[文韬武略]敖江,2852,0,0,1,1,0.0%,7m
3177,1,[看我朵蜜你]阿尔托莉雅,2852,0,0,1,1,0.0%,4m
3186,3,YTYT,2851,164,5,4,9,55.6%,15m
3186,3,Linyao,2851,30,1,2,3,33.3%,30m
3186,3,喜欢轻井泽惠,2851,0,0,1,1,0.0%,30m
3189,3,天堂老人,2850,1597,354,361,715,49.5%,55m
3189,3,DNA,2850,868,45,36,81,55.6%,22m
3189,3,Architect,2850,140,5,3,8,62.5%,30m
3189,3,战闪新星,2850,120,2,2,4,50.0%,1h
3193,2,虫猛人秀神挨揍,2849,848,261,267,528,49.4%,10m
3193,3,暴躁的浣熊,2849,183,7,8,15,46.7%,14m
3193,2,wodemarin,2849,135,6,2,8,75.0%,37m
3193,1,Rick,2849,0,3,3,6,50.0%,1h
3193,1,流云飞月,2849,48,3,4,7,42.9%,1h
3193,2,[TPobab]北京途观狂,2849,0,0,3,3,0.0%,51m
3199,2,[刺客槶]海阔天空,2848,1086,56,45,101,55.4%,56m
3199,2,[人菜灬瘾大]TinaAI,2848,492,19,16,35,54.3%,15m
3199,2,[LOHv]glhf,2848,282,9,5,14,64.3%,45m
3199,3,和谐发展,2848,256,9,9,18,50.0%,2m
3199,3,你想想,2848,64,3,12,15,20.0%,4m
3199,2,油傻,2848,0,1,0,1,100.0%,37m
3199,3,就是艾斯特了,2848,0,1,4,5,20.0%,22m
3206,2,[AnSwer]MoNsooN,2847,458,18,15,33,54.5%,17m
3206,2,瑞星星星,2847,182,7,8,15,46.7%,3m
3206,1,钓猫的鱼,2847,0,3,5,8,37.5%,21m
3206,3,[校园谐恶势力]yyymgg,2847,0,1,0,1,100.0%,5m
3206,3,[江北星际]我猛得不配赢,2847,0,1,0,1,100.0%,29m
3206,2,[衡水中学]飞氘,2847,0,0,1,1,0.0%,22m
3212,3,[KPG2]Flash,2846,1609,617,607,1224,50.4%,8m
3212,3,克罗米,2846,766,78,65,143,54.5%,13m
3212,1,iiiiiiiiiiii,2846,142,3,2,5,60.0%,1h
3212,2,demon,2846,0,1,0,1,100.0%,1h
3216,1,zyzza,2845,445,23,33,56,41.1%,14m
3216,2,[火焰雷兽]爱谁是谁,2845,184,7,9,16,43.8%,54m
3216,2,rockzz,2845,113,4,3,7,57.1%,37m
3216,3,泌之洋洋,2845,141,3,1,4,75.0%,29m
3220,2,神奇的地瓜,2844,1616,96,99,195,49.2%,9m
3220,2,TIMER,2844,105,10,12,22,45.5%,16m
3220,1,[第三駆逐鑑隊]zzx,2844,0,4,3,7,57.1%,1h
3220,1,[星空下第一]Lucifer,2844,97,3,4,7,42.9%,1h
3220,3,我爱肥肥喜,2844,30,1,1,2,50.0%,23m
3225,3,[哦哟喂呀]星际萌新,2843,150,4,0,4,100.0%,14m
3225,3,星际世界,2843,118,4,1,5,80.0%,5m
3225,3,虍业,2843,0,0,1,1,0.0%,4m
3228,1,lise,2842,1610,142,126,268,53.0%,18m
3228,1,看你个锤子看,2842,823,29,32,61,47.5%,19m
3228,2,[瘾大眼瞎]衿丶,2842,784,27,33,60,45.0%,17m
3228,1,[Shawk]六十五额降低无锡,2842,509,18,21,39,46.2%,55m
3228,1,[响当当水友]iiiiiiinnova,2842,0,1,0,1,100.0%,1h
3228,3,自由之翼,2842,0,1,1,2,50.0%,5m
3228,3,皓然来袭,2842,0,0,1,1,0.0%,13m
3228,3,sliceRest,2842,0,0,1,1,0.0%,6m
3228,2,[戴德给拇]禅璃子单推夏色祭,2842,0,0,3,3,0.0%,53m
3237,2,Lewis,2841,329,41,37,78,52.6%,56m
3237,2,再菜也爱玩,2841,324,13,10,23,56.5%,4m
3237,1,[YINGJI]PPPPPPPPP,2841,0,2,3,5,40.0%,28m
3240,1,我永远喜欢团子,2840,745,26,30,56,46.4%,51m
3240,2,luckqian,2840,0,4,1,5,80.0%,1h
3240,3,[谁都打不赢]打铁还需自身硬,2840,58,3,0,3,100.0%,6m
3240,1,流浪,2840,0,2,3,5,40.0%,18m
3240,3,打的就是你,2840,0,1,0,1,100.0%,7m
3240,1,[教父遇刺]innovat,2840,0,1,1,2,50.0%,10m
3246,1,MrSandman,2839,117,4,4,8,50.0%,1h
3246,3,晓予,2839,97,2,3,5,40.0%,35m
3248,3,[镜花水月丶]黄头发妹妹爱黑丝,2838,95,3,3,6,50.0%,22m
3248,2,[IGS]LCorner,2838,129,2,11,13,15.4%,41m
3248,3,[社交学导教]半根辣条,2838,0,1,0,1,100.0%,1m
3251,3,[1VA]MagicProtoss,2837,1254,56,42,98,57.1%,15m
3251,3,bearfree,2837,180,7,7,14,50.0%,26m
3251,1,sisi,2837,48,5,4,9,55.6%,50m
3251,3,StealHeart,2837,122,4,5,9,44.4%,26m
3251,3,追后天十,2837,58,2,2,4,50.0%,13m
3256,2,ESEgva,2836,139,5,3,8,62.5%,4m
3256,1,Tom,2836,46,2,2,4,50.0%,1h
3258,2,王少,2835,676,51,46,97,52.6%,54m
3258,3,[TimoIN]zhonxian,2835,30,2,2,4,50.0%,2m
3258,3,[Emc2]爱美的究极小迷妹,2835,30,2,2,4,50.0%,6m
3261,2,异虫是食物,2834,346,14,13,27,51.9%,17m
3261,3,[AOT]LHooM,2834,244,8,10,18,44.4%,52m
3261,1,喻奕扬,2834,229,7,5,12,58.3%,1h
3261,3,[浮世清欢]锐步,2834,97,2,2,4,50.0%,11m
3261,2,[养生会馆]肆谑,2834,0,2,3,5,40.0%,19m
3261,1,TELEPHONE,2834,96,2,5,7,28.6%,57m
3261,3,[在鹿上]启源,2834,0,0,1,1,0.0%,6m
3268,3,星星,2833,511,20,18,38,52.6%,55m
3268,1,stasreleee,2833,0,3,3,6,50.0%,44m
3268,3,kpjjp,2833,60,2,2,4,50.0%,21m
3268,1,[魔法少女小屋]魔法少女软芳酱,2833,48,1,4,5,20.0%,23m
3268,1,阿萨德,2833,0,0,1,1,0.0%,1h
3268,2,[异度黑核侵蚀]黑猫,2833,0,0,1,1,0.0%,5m
3268,3,SupplyBlock,2833,0,0,1,1,0.0%,12m
3268,3,[小鸡屠宰场2]倚仗天穹,2833,0,0,2,2,0.0%,1m
3276,2,[XXHZ27]AIFINE,2832,44,4,3,7,57.1%,4m
3276,3,暴雪游戏休闲玩家,2832,0,0,1,1,0.0%,1m
3276,3,rhythm,2832,0,0,1,1,0.0%,51m
3279,2,[lmbaP]晨曦初晓,2831,485,23,27,50,46.0%,10m
3279,2,[南昌一枝花]战机还是机甲,2831,167,5,3,8,62.5%,54m
3279,2,[OTAKU丨]昏君夏夏夏炎,2831,0,4,1,5,80.0%,22m
3279,1,[孙換家]我爱小诗诗,2831,0,3,4,7,42.9%,29m
3279,1,谢大发明家,2831,97,2,1,3,66.7%,7m
3279,3,[黑暗圣堂棱镜]冰弦结御,2831,0,1,0,1,100.0%,22m
3279,3,[镜花水月丿]天雷折腰,2831,0,1,0,1,100.0%,1m
3286,2,[25鸡]谈笑风生,2830,390,14,18,32,43.8%,17m
3286,3,sochralar,2830,368,12,9,21,57.1%,15m
3286,2,IIIIIIIIIIII,2830,314,11,15,26,42.3%,54m
3286,2,[百宝箱]TreeSea,2830,154,5,9,14,35.7%,22m
3286,1,[SFTRA3]舔我高跟鞋,2830,0,1,2,3,33.3%,28m
3291,2,浪白条,2829,1229,65,54,119,54.6%,29m
3291,3,[gusl]AlphaStar,2829,1113,48,42,90,53.3%,22m
3291,3,就是喜欢小包纸,2829,92,3,6,9,33.3%,5m
3291,3,[TUF]曙光女神之宽恕,2829,0,0,1,1,0.0%,24m
3291,3,[龙之逆鳞]冥界皇太子,2829,0,0,1,1,0.0%,22m
3296,2,gdtjw,2828,412,14,15,29,48.3%,15m
3297,2,[嘴宗]Terry,2827,468,18,21,39,46.2%,3m
3297,2,世纪雄风,2827,405,17,18,35,48.6%,11m
3297,3,[SmartX]将军,2827,217,9,7,16,56.2%,1h
3297,3,[奔驰何平]光照于生化,2827,0,1,0,1,100.0%,12m
3297,1,梦魇,2827,0,1,0,1,100.0%,40m
3297,3,我的海绵宝宝会飞,2827,30,1,2,3,33.3%,6m
3303,3,Slient,2826,260,11,13,24,45.8%,4m
3303,2,大胖敦敦,2826,0,2,4,6,33.3%,1h
3305,3,[不灭青铜]菜鸟,2825,442,24,20,44,54.5%,22m
3305,2,花钱日下死,2825,284,24,20,44,54.5%,20m
3305,3,Sporioe,2825,213,9,7,16,56.2%,16m
3305,3,[M8]好兄弟无穷无尽,2825,226,8,9,17,47.1%,1m
3305,2,[336]Komorebi,2825,188,4,1,5,80.0%,2m
3305,3,暖夏,2825,58,3,0,3,100.0%,56m
3311,3,[Mikon]宫本武藏,2824,1539,167,173,340,49.1%,9m
3311,1,[沙漠之鹰]StarHuang,2824,1531,129,135,264,48.9%,8m
3313,3,这全都是浮云,2823,661,31,24,55,56.4%,14m
3313,2,[TeamGB]loveDd,2823,729,29,23,52,55.8%,12m
3313,1,[玲喵卡哇伊]REvoLution,2823,174,9,10,19,47.4%,29m
3313,2,RosingRAIN,2823,191,5,4,9,55.6%,2m
3313,3,[麻酱万岁]llllllllllll,2823,131,4,1,5,80.0%,55m
3313,3,[GKL]GKLKK,2823,0,1,0,1,100.0%,6m
3313,3,stanan,2823,0,0,1,1,0.0%,3m
3320,3,[Hist]Glittering,2822,1082,43,40,83,51.8%,24m
3320,3,[AKC]deltagogogo,2822,295,11,4,15,73.3%,1h
3320,3,随便随便,2822,108,5,4,9,55.6%,5m
3320,3,[91秦先生]哎呦卧槽,2822,0,0,1,1,0.0%,54m
3324,1,刺刀,2821,144,5,5,10,50.0%,1h
3324,1,smallegg,2821,96,4,4,8,50.0%,18m
3324,2,超威蓝猫,2821,101,4,5,9,44.4%,11m
3324,2,[彼岸鸽友会]yukikaze,2821,46,2,6,8,25.0%,1h
3324,3,EnTaroZertul,2821,0,1,0,1,100.0%,25m
3324,3,[社交学小可爱]Together,2821,0,1,0,1,100.0%,14m
3330,2,owl,2820,795,48,48,96,50.0%,18m
3330,3,Chokyi,2820,216,9,7,16,56.2%,27m
3330,3,老班长,2820,0,4,1,5,80.0%,22m
3330,2,菌毯糊脸,2820,152,4,4,8,50.0%,12m
3334,3,Lucky,2819,635,24,19,43,55.8%,6m
3334,3,寄人间于朝暮,2819,619,23,16,39,59.0%,1m
3334,3,[美少女萬華鏡]顶级萝莉控,2819,144,4,3,7,57.1%,35m
3334,3,[星际把妹王]我永远单推鲨鲨,2819,121,3,1,4,75.0%,1h
3334,3,忠肝义胆邢育森,2819,135,3,10,13,23.1%,51m
3334,3,[吃原味麻酱]史诗之蛙,2819,30,2,2,4,50.0%,55m
3340,3,[咖啡Fans]NightQueen,2818,388,14,13,27,51.9%,6m
3340,2,[你渴望力量吗]嘤嘤嘤,2818,356,12,15,27,44.4%,5m
3340,3,风林火山,2818,281,10,15,25,40.0%,2m
3340,3,ZJC,2818,144,6,6,12,50.0%,56m
3340,2,[CMFit]clkkk,2818,210,6,10,16,37.5%,10m
3340,3,冰霜雪狼,2818,171,5,5,10,50.0%,31m
3346,2,丶苍白誓言灬,2817,799,124,124,248,50.0%,1m
3346,2,[北约]killer,2817,506,18,18,36,50.0%,51m
3346,3,像微笑丶,2817,191,6,4,10,60.0%,9m
3349,1,[星际老湿鸡]再见宋哈娜,2816,706,57,66,123,46.3%,5m
3349,2,哎呦,2816,442,35,28,63,55.6%,15m
3349,2,[Ansaa]鎯鐚鈅,2816,901,34,33,67,50.7%,3m
3349,1,无聊旗子,2816,528,23,20,43,53.5%,51m
3349,2,cao,2816,95,3,3,6,50.0%,24m
3349,3,带你个十娘,2816,58,2,2,4,50.0%,6m
3349,3,Sparkling,2816,0,1,0,1,100.0%,13m
3349,3,[飞雷神]超越神一般的存在,2816,0,1,2,3,33.3%,14m
3349,3,sober,2816,92,1,3,4,25.0%,7m
3358,2,小白丶,2815,1410,117,115,232,50.4%,24m
3358,2,[Beasty]十二翼天使,2815,796,76,58,134,56.7%,16m
3358,2,[浙大战队]铜锣湾话事人,2815,543,20,21,41,48.8%,18m
3358,1,新手电脑,2815,187,6,16,22,27.3%,28m
3358,3,daixiao,2815,108,5,2,7,71.4%,6m
3358,2,[世界大战]方玲霞,2815,60,3,8,11,27.3%,15m
3358,2,zlczkx,2815,0,2,4,6,33.3%,7m
3358,2,galax,2815,90,2,9,11,18.2%,56m
3358,2,[DSR]惡夢,2815,0,0,1,1,0.0%,16m
3367,3,环彩羽,2814,199,6,2,8,75.0%,7m
3367,1,恒恒,2814,119,4,5,9,44.4%,1h
3367,3,[leepay]为了达拉然,2814,0,1,0,1,100.0%,25m
3367,3,IIIIIIIIIIII,2814,0,1,1,2,50.0%,13m
3371,1,NIVDC,2813,209,6,4,10,60.0%,29m
3371,3,[燕大SC]人活着就为伊莉雅,2813,0,1,0,1,100.0%,13m
3373,1,利维坦,2812,1180,65,60,125,52.0%,12m
3373,1,air,2812,218,62,66,128,48.4%,14m
3373,3,onlyFAI,2812,194,8,7,15,53.3%,18m
3373,1,Knight,2812,163,5,6,11,45.5%,1h
3373,3,黄缘,2812,30,2,1,3,66.7%,18m
3373,2,阿琨,2812,0,1,4,5,20.0%,10m
3373,1,[Beasty]路漫漫,2812,0,0,1,1,0.0%,50m
3380,2,好汉饶命,2811,745,159,141,300,53.0%,20m
3380,1,[HUC铭心]潇洒猪,2811,1121,39,42,81,48.1%,25m
3380,3,RenaiSsancE,2811,582,22,21,43,51.2%,26m
3380,3,Allander,2811,240,8,5,13,61.5%,9m
3380,1,笑容背后丶乐逍遥,2811,0,1,0,1,100.0%,60m
3385,1,alsook,2810,1548,84,80,164,51.2%,23m
3385,3,[4058]RifeL,2810,453,33,31,64,51.6%,21m
3385,3,[七海]七海千夜,2810,311,12,7,19,63.2%,27m
3385,2,[死鹿特小公主]Onemy,2810,203,7,6,13,53.8%,23m
3385,3,[Toss]Skai,2810,30,1,1,2,50.0%,54m
3385,3,[老吴天下第一]Tgglol,2810,30,1,1,2,50.0%,7m
3385,3,泰伦之光,2810,0,0,1,1,0.0%,2m
3392,2,野猫,2809,220,7,13,20,35.0%,4m
3392,3,[LOvve]HatsuneMiku,2809,0,0,1,1,0.0%,24m
3394,2,[神魔降临]薯条,2808,95,4,2,6,66.7%,44m
3394,3,星际好难玩,2808,106,2,1,3,66.7%,2m
3394,2,[嗑药小分队]恐鸡,2808,0,0,1,1,0.0%,52m
3397,3,[华夏远征军]zeratul,2807,370,16,8,24,66.7%,2m
3397,2,Nebula,2807,0,2,4,6,33.3%,15m
3397,3,zcz,2807,0,1,0,1,100.0%,54m
3400,3,热爱上树的小蚂蚁,2806,121,9,9,18,50.0%,45m
3400,3,IIIIIIIIII,2806,251,7,10,17,41.2%,12m
3400,3,克鲁斯约翰,2806,181,6,1,7,85.7%,1m
3400,3,[一剑光寒九州]麻雀,2806,86,3,5,8,37.5%,29m
3404,1,[慢手e族]多多丸,2805,1310,207,213,420,49.3%,5m
3404,3,Ggg,2805,372,15,12,27,55.6%,14m
3404,3,[南湖匈奴]赌神,2805,149,5,2,7,71.4%,26m
3404,3,你好可爱吖,2805,30,2,0,2,100.0%,25m
3404,2,[送分小队]SKTo,2805,30,2,5,7,28.6%,12m
3404,3,帝皇之息,2805,0,1,1,2,50.0%,19m
3410,3,[反叛的鲁路修]他们都说我有毒,2804,224,8,7,15,53.3%,7m
3410,3,Peak,2804,0,0,1,1,0.0%,23m
3410,1,[火焰雷兽]JiNoVaTion,2804,0,0,1,1,0.0%,28m
3413,2,[五月花]DYDY,2803,528,50,53,103,48.5%,8m
3413,1,[龙虾先锋]力力打天下,2803,462,15,20,35,42.9%,19m
3413,3,asdasd,2803,222,7,7,14,50.0%,15m
3413,2,[仙女的云朵喵]樱花呀,2803,237,7,8,15,46.7%,1h
3413,2,ALUCARD,2803,130,6,6,12,50.0%,22m
3413,3,暮烟,2803,169,4,3,7,57.1%,24m
3413,3,耿彬吃粑粑,2803,0,0,1,1,0.0%,24m
3413,2,[阿斯达芙]纵享丝滑,2803,0,0,1,1,0.0%,2m
3413,2,MeOwSirrr,2803,0,0,1,1,0.0%,16m
3413,1,我是盲人,2803,0,0,1,1,0.0%,7m
3413,3,[knsk]国民老婆孙一峰,2803,0,0,1,1,0.0%,11m
3424,3,星空,2802,1149,47,41,88,53.4%,14m
3424,2,[暴雪二十七队]甜茶小可爱,2802,187,8,1,9,88.9%,37m
3424,1,hzhp,2802,121,3,1,4,75.0%,1h
3424,2,彩笔,2802,0,1,0,1,100.0%,37m
3424,1,偏爱小单,2802,0,1,2,3,33.3%,59m
3424,3,Alex,2802,0,0,1,1,0.0%,54m
3424,3,吊二,2802,0,0,1,1,0.0%,21m
3431,2,[凤凰之门]蒜仔,2801,456,16,19,35,45.7%,10m
3431,3,[艾杀星]小艾艾,2801,0,4,1,5,80.0%,26m
3431,3,菜鸟,2801,30,2,1,3,66.7%,26m
3434,2,[打我一波S全]新手,2800,575,20,20,40,50.0%,17m
3434,2,[FOK]nyu,2800,204,10,14,24,41.7%,56m
3434,3,[大革命家]飞翔的蚂蚱,2800,253,7,10,17,41.2%,1m
3434,1,你的灵车我来漂移,2800,48,4,4,8,50.0%,45m
3434,3,[无魂之鸭]mck,2800,58,3,2,5,60.0%,1m
3434,1,haosijia,2800,0,0,1,1,0.0%,31m
3434,2,[四叶草]Skyhigh,2800,0,0,5,5,0.0%,40m
3441,2,白岚,2799,516,22,16,38,57.9%,51m
3441,3,DENVOU,2799,283,15,13,28,53.6%,5m
3441,2,[Deep]任重道远,2799,0,3,2,5,60.0%,1h
3441,3,[中国人民银行]东方白石,2799,30,2,1,3,66.7%,19m
3445,3,狂奔的跳虫,2798,549,22,13,35,62.9%,11m
3445,3,MagicTerran,2798,203,7,4,11,63.6%,1m
3445,3,不朽攻城坦克,2798,30,1,2,3,33.3%,12m
3448,1,峨眉峰,2797,187,8,9,17,47.1%,46m
3448,3,ChenXingBiao,2797,209,6,6,12,50.0%,35m
3448,2,[一起9]暗星,2797,0,4,1,5,80.0%,1h
3448,3,艾尔,2797,30,2,1,3,66.7%,26m
3448,1,二龙附身,2797,0,0,1,1,0.0%,1h
3453,1,[我们为了粉丝]larryou,2796,779,26,38,64,40.6%,2m
3453,1,庞白,2796,207,6,3,9,66.7%,1h
3455,3,打鸡血的巡洋舰,2795,374,14,9,23,60.9%,5m
3455,1,[贪得无厌]爱喝冰峰,2795,267,9,6,15,60.0%,4m
3455,2,丶可樂,2795,163,8,9,17,47.1%,1m
3455,3,[天意不可违]穆雅,2795,254,8,10,18,44.4%,14m
3455,3,挥剑只为红颜,2795,146,5,5,10,50.0%,5m
3455,1,望月砂,2795,94,5,6,11,45.5%,38m
3455,2,[小小小胖花儿]小花花,2795,134,4,2,6,66.7%,1h
3462,3,[哟哟哟]哟怎么哭了,2794,712,31,24,55,56.4%,3m
3462,1,LuckY,2794,199,7,6,13,53.8%,29m
3462,2,wwklk,2794,135,4,4,8,50.0%,1h
3462,2,人间不值得,2794,0,1,0,1,100.0%,53m
3462,3,Rage,2794,0,0,1,1,0.0%,5m
3462,3,[XXHZ7]随便玩玩而已,2794,0,0,1,1,0.0%,19m
3468,2,[GGBigH]ElevenGG,2793,1562,61,56,117,52.1%,29m
3468,1,bobo,2793,898,40,46,86,46.5%,25m
3468,2,[CPT]仙师完败,2793,117,4,3,7,57.1%,24m
3468,1,[SC2战队]IIIIIIIIIIII,2793,140,2,2,4,50.0%,45m
3468,3,不会开矿,2793,60,2,5,7,28.6%,6m
3473,2,RuiTI,2792,1115,165,151,316,52.2%,20m
3473,3,[Mikon]恰克队长,2792,675,35,28,63,55.6%,14m
3473,3,阿托罗姆,2792,230,9,10,19,47.4%,26m
3473,2,[DMR]石头,2792,287,7,12,19,36.8%,51m
3473,1,彭立辉,2792,120,6,4,10,60.0%,35m
3473,2,[C87丶]丨简单粗暴丨,2792,156,5,13,18,27.8%,56m
3473,2,[仓鼠党]Ciar,2792,46,4,3,7,57.1%,52m
3473,1,[幽灵闪现wo]TheSoldier,2792,0,1,0,1,100.0%,25m
3481,2,法海禅师,2791,207,8,8,16,50.0%,56m
3481,2,llllllllllll,2791,166,5,14,19,26.3%,4m
3481,3,Zeus,2791,58,3,4,7,42.9%,26m
3481,3,白特帅,2791,30,1,2,3,33.3%,54m
3481,3,银色闪光亚丝娜,2791,0,0,1,1,0.0%,14m
3486,2,吊比石头硬夫斯基,2790,518,20,20,40,50.0%,54m
3486,3,[RDFZsc]无常,2790,220,8,9,17,47.1%,12m
3486,1,[killer]床上那点事,2790,182,6,12,18,33.3%,26m
3486,3,孤傲,2790,95,2,1,3,66.7%,14m
3486,3,IIIIIIIIII,2790,0,1,1,2,50.0%,1m
3486,3,poltttt,2790,30,1,3,4,25.0%,22m
3486,3,半世清秋丶瑜,2790,0,0,1,1,0.0%,25m
3493,3,绝望中忘了使徒,2789,433,26,11,37,70.3%,19m
3493,2,悠姆,2789,547,24,24,48,50.0%,3m
3493,3,[DSE]虫族就赢不了,2789,0,1,2,3,33.3%,3m
3496,1,sun,2788,121,3,3,6,50.0%,7m
3496,3,低调的虫族,2788,0,0,1,1,0.0%,3m
3496,3,[白丝圣堂武士]小灰爱,2788,0,0,2,2,0.0%,3m
3499,3,xbarton,2787,1520,135,126,261,51.7%,18m
3499,3,阿奴儿的小宇宙,2787,1287,75,64,139,54.0%,22m
3499,1,MGJTERRAN,2787,666,23,34,57,40.4%,22m
3499,3,IIIIIIII,2787,457,19,17,36,52.8%,1m
3499,3,[为了娱乐]XIXIHAHADADA,2787,243,7,7,14,50.0%,45m
3499,2,rua,2787,140,4,4,8,50.0%,31m
3499,1,亮亮,2787,48,4,5,9,44.4%,29m
3499,2,[Swing]IIIIIIIIIIII,2787,95,2,5,7,28.6%,7m
3499,1,silent,2787,48,1,1,2,50.0%,28m
3508,3,[SUSTC]Littlewolf,2786,590,24,20,44,54.5%,21m
3508,3,TVTGG,2786,250,10,7,17,58.8%,27m
3508,3,老左二货,2786,30,1,1,2,50.0%,22m
3511,2,[五月花]Kooo,2785,1224,49,54,103,47.6%,11m
3511,1,[嘻哈战队]Zero,2785,576,21,25,46,45.7%,52m
3511,3,[XXHZ1]留下遗产,2785,0,4,1,5,80.0%,11m
3511,2,[专虐青铜]ChandlerBing,2785,143,4,4,8,50.0%,22m
3511,3,亮亮,2785,92,4,6,10,40.0%,2m
3511,2,溺游灵,2785,0,2,3,5,40.0%,22m
3511,3,[vaccin]只会虚空的都是傻,2785,97,2,4,6,33.3%,1h
3511,3,icelatte,2785,0,1,3,4,25.0%,29m
3519,3,成大大,2784,249,9,6,15,60.0%,22m
3519,2,[致失去的岁月]符号,2784,203,9,7,16,56.2%,1h
3519,3,Mike,2784,137,5,0,5,100.0%,18m
3519,3,[汝父]心田,2784,134,4,1,5,80.0%,14m
3519,3,鹰巢城的伊鲁席尔,2784,0,1,0,1,100.0%,1m
3519,3,jclee,2784,30,1,2,3,33.3%,15m
3525,3,放开我队友冲我来,2783,620,50,38,88,56.8%,27m
3525,3,smile,2783,142,5,6,11,45.5%,3m
3525,2,[玛奇朵]黛仙贝,2783,0,1,0,1,100.0%,1h
3525,3,IIIIIIIIIIII,2783,0,0,1,1,0.0%,2m
3529,3,杰哥,2782,1600,70,60,130,53.8%,26m
3529,1,术高莫用,2782,910,66,69,135,48.9%,2m
3529,2,白嫖一直爽,2782,219,31,41,72,43.1%,29m
3529,2,Wolf,2782,741,29,29,58,50.0%,2m
3529,3,[火焰雷兽]xuanily,2782,361,15,7,22,68.2%,21m
3529,3,[BTD]初凡,2782,94,2,0,2,100.0%,7m
3529,3,[败给小队]银不了,2782,120,2,1,3,66.7%,1h
3529,3,浪漫宙斯,2782,0,1,0,1,100.0%,22m
3529,1,rockET,2782,96,1,4,5,20.0%,1h
3538,3,[星际三舰客]幽宇,2781,285,12,6,18,66.7%,5m
3538,1,小辣鸡,2781,97,5,3,8,62.5%,1h
3538,3,麦克尔杰克骚,2781,91,2,1,3,66.7%,44m
3538,1,安然,2781,0,2,3,5,40.0%,50m
3538,3,[红色锤镰]天启,2781,30,1,2,3,33.3%,4m
3543,2,[Borne]燃烧的胸毛,2780,95,5,2,7,71.4%,40m
3543,3,[妖姬]新手轻虐,2780,136,4,2,6,66.7%,5m
3543,3,饕餮,2780,120,4,5,9,44.4%,14m
3543,3,[LOHs]asdfiujhs,2780,90,4,7,11,36.4%,55m
3543,2,immorts,2780,36,2,0,2,100.0%,1h
3543,2,对儿,2780,93,2,4,6,33.3%,1h
3543,3,WYHWYH,2780,0,1,1,2,50.0%,1m
3550,3,[保护伞公司]ZARD,2779,500,69,44,113,61.1%,52m
3550,3,深夜丶孤行,2779,735,47,38,85,55.3%,5m
3550,3,[浪啊浪]logo,2779,324,12,8,20,60.0%,29m
3550,3,[桜公馆]RKjohn,2779,156,5,1,6,83.3%,1m
3550,2,小小菜,2779,129,5,4,9,55.6%,37m
3550,2,FrAlive,2779,93,3,3,6,50.0%,1h
3550,3,YzHSureWin,2779,0,1,0,1,100.0%,16m
3557,3,倾尽天下,2778,531,62,58,120,51.7%,2m
3557,2,firstblood,2778,332,13,8,21,61.9%,19m
3557,3,Random,2778,242,10,9,19,52.6%,33m
3557,2,BLANKliming,2778,265,10,9,19,52.6%,10m
3557,3,[银翼之光]黑暗咏叹,2778,262,10,11,21,47.6%,6m
3557,2,我是三三啊,2778,116,4,10,14,28.6%,20m
3557,3,LJsquirrel,2778,0,2,3,5,40.0%,1h
3564,2,[星辰腰子队]暗键师,2777,1524,136,131,267,50.9%,23m
3564,3,Teletha,2777,491,54,53,107,50.5%,5m
3564,3,风羽翼之,2777,492,24,12,36,66.7%,3m
3564,3,[基金会]大虾吃掉你,2777,412,22,15,37,59.5%,7m
3564,1,[119]自由之翼,2777,515,19,23,42,45.2%,15m
3564,3,[HustSC]Otin,2777,120,3,2,5,60.0%,1h
3564,3,[ZTT]IIIIIIIIIIII,2777,58,3,3,6,50.0%,7m
3564,3,一只海龟成功入水,2777,30,1,2,3,33.3%,54m
3564,3,老衲不吃肉,2777,0,0,4,4,0.0%,3m
3573,1,[小鸡屠宰场3]天地良心,2776,1487,280,287,567,49.4%,51m
3573,3,萝莉控,2776,1544,76,63,139,54.7%,1m
3573,1,再见小强,2776,1300,54,52,106,50.9%,7m
3573,2,zhoushunqin,2776,1047,48,35,83,57.8%,17m
3573,3,偷家吃粑粑吧,2776,247,8,6,14,57.1%,25m
3573,3,[Borne]云在哭泣,2776,159,4,4,8,50.0%,24m
3573,3,[镜花水月]有妹是穹,2776,0,1,0,1,100.0%,1h
3580,2,[最菜战队]marinelord,2775,592,273,272,545,50.1%,29m
3580,2,得得得得得得得,2775,978,59,66,125,47.2%,4m
3580,3,[镜花水月丶]不会玩怎么办,2775,1367,58,55,113,51.3%,15m
3580,3,浅蓝色深海鲨,2775,642,27,20,47,57.4%,20m
3580,3,[小土鸡]saber,2775,436,27,24,51,52.9%,20m
3580,3,盼盼,2775,276,11,5,16,68.8%,11m
3580,1,[暴雪七队]蓝白画质小霸王机,2775,118,5,5,10,50.0%,1h
3587,2,Devil,2774,543,24,30,54,44.4%,1m
3587,2,Slipknot,2774,93,3,3,6,50.0%,1h
3589,3,[TAPC]Rain,2773,618,84,76,160,52.5%,22m
3589,3,sswwwssd,2773,934,38,35,73,52.1%,6m
3589,3,鬼头明里,2773,886,36,30,66,54.5%,3m
3589,3,人菜瘾还大,2773,253,10,8,18,55.6%,22m
3589,1,weixiang,2773,235,7,8,15,46.7%,1h
3589,1,[huobao]活宝,2773,118,4,5,9,44.4%,29m
3589,2,[蕾蒂甘甘]句章真人,2773,93,2,4,6,33.3%,56m
3589,2,夜北凉,2773,0,1,5,6,16.7%,1h
3597,1,小春,2772,766,34,41,75,45.3%,26m
3597,3,伊莱克斯,2772,401,17,9,26,65.4%,22m
3597,3,符箓灬锺,2772,276,9,6,15,60.0%,26m
3597,3,为了部落,2772,175,7,1,8,87.5%,55m
3597,2,Kevin,2772,231,7,16,23,30.4%,1h
3597,3,[VLK]幽灵,2772,105,3,4,7,42.9%,21m
3597,3,[浪啊浪]吕同轩帅,2772,30,1,3,4,25.0%,29m
3604,2,[火焰雷兽]iikdhsaudhsi,2771,1594,436,433,869,50.2%,57m
3604,2,潜行者,2771,625,34,29,63,54.0%,16m
3604,3,蓝色星系,2771,348,12,11,23,52.2%,22m
3604,2,弃疗型熊猫,2771,117,11,7,18,61.1%,14m
3604,3,神杀殇,2771,0,4,4,8,50.0%,1h
3604,1,[91谐会]六神,2771,143,3,4,7,42.9%,1h
3604,3,Cincelia,2771,0,1,0,1,100.0%,14m
3611,3,Licion,2770,585,22,20,42,52.4%,22m
3611,3,达芬蛋壳,2770,196,9,4,13,69.2%,6m
3611,3,胖胡,2770,238,8,5,13,61.5%,4m
3611,3,冬雨冬雨不下雨,2770,159,6,0,6,100.0%,1m
3611,1,[歌者]Steven,2770,284,6,10,16,37.5%,50m
3611,3,丨冰糖,2770,146,4,5,9,44.4%,18m
3611,3,[旋风游骑兵]克己,2770,0,1,2,3,33.3%,29m
3611,3,[AKAzuo]旋转震动男友,2770,30,1,4,5,20.0%,29m
3619,1,[火焰雷兽]我爱祖国,2769,1586,490,471,961,51.0%,6m
3619,3,Allenel,2769,465,21,11,32,65.6%,18m
3619,3,[联合动物园]哥伦比亚老树懒,2769,409,17,11,28,60.7%,3m
3619,3,hushw,2769,0,3,0,3,100.0%,11m
3619,3,[艾尔之名]IIIIIIIIIIII,2769,0,2,3,5,40.0%,1h
3619,3,Trace,2769,0,1,0,1,100.0%,55m
3625,3,云雨浩瀚,2768,818,36,27,63,57.1%,25m
3626,3,[鬼谷]你敬爱的宁哥哥,2767,215,53,45,98,54.1%,21m
3626,3,桜泠雪汐,2767,316,16,8,24,66.7%,14m
3628,3,镇妖剑,2766,580,22,18,40,55.0%,7m
3628,3,杜祥明,2766,401,15,14,29,51.7%,14m
3628,2,飞起,2766,275,11,10,21,52.4%,52m
3628,3,[蟹堡王]咬嘴,2766,0,4,2,6,66.7%,22m
3628,2,[XTE]Linux,2766,128,3,6,9,33.3%,54m
3628,2,萌新,2766,0,1,0,1,100.0%,1h
3628,3,阿瑞纳斯,2766,0,1,1,2,50.0%,6m
3628,3,[唯爱彦神]葛小伦,2766,30,1,3,4,25.0%,18m
3628,3,KKKomyo,2766,0,0,1,1,0.0%,6m
3637,2,Captain,2765,134,4,4,8,50.0%,1h
3638,2,挺喜欢星际争霸的,2764,1576,257,258,515,49.9%,20m
3638,3,issenven,2764,507,20,17,37,54.1%,15m
3638,3,送你丶凄凉,2764,262,10,6,16,62.5%,3m
3638,1,[loveMM]江东徐大大,2764,317,10,18,28,35.7%,53m
3638,3,zzlhb,2764,151,7,6,13,53.8%,5m
3638,3,苏双羊,2764,156,6,0,6,100.0%,5m
3638,3,[DMR]insomnia,2764,144,5,2,7,71.4%,22m
3638,2,heheda,2764,134,4,4,8,50.0%,1h
3638,2,[青莲剑阁]枯林,2764,42,2,2,4,50.0%,33m
3638,2,[CNEB]SKTTossGirl,2764,0,0,1,1,0.0%,1h
3638,2,探机说的对,2764,0,0,1,1,0.0%,30m
3649,3,ZeroG,2763,801,274,243,517,53.0%,1m
3649,3,小呱呱萌萌哒,2763,659,36,14,50,72.0%,26m
3649,3,忍忍,2763,573,22,17,39,56.4%,21m
3649,3,一起去坑爹,2763,327,13,15,28,46.4%,55m
3649,3,[干磨]Gin,2763,181,9,8,17,52.9%,5m
3649,3,[让我们创造]清凉油,2763,153,6,8,14,42.9%,1h
3649,3,IIIIIIIIIIII,2763,120,4,0,4,100.0%,15m
3649,3,天下耀莱,2763,123,3,2,5,60.0%,33m
3649,2,klgjelsghesj,2763,88,2,2,4,50.0%,1h
3649,2,SCPLAYER,2763,95,2,4,6,33.3%,1h
3649,1,吹梦到西洲,2763,48,1,1,2,50.0%,7m
3649,2,影者,2763,0,0,1,1,0.0%,16m
3661,3,秀智呀秀智,2762,1019,43,34,77,55.8%,13m
3661,3,[荣耀丶殿堂]妈妈船,2762,194,7,3,10,70.0%,7m
3661,2,Wednesday,2762,158,4,4,8,50.0%,8m
3661,3,[小花]桑墨丶柳月,2762,0,2,3,5,40.0%,1h
3661,1,无念,2762,97,2,7,9,22.2%,1h
3661,3,[叫声好哥哥]ALLSTAR,2762,0,1,1,2,50.0%,18m
3661,3,天意,2762,30,1,2,3,33.3%,23m
3668,3,Antonio,2761,1075,216,207,423,51.1%,1m
3668,3,歌舞伎町,2761,379,23,24,47,48.9%,4m
3668,2,[龙兄虎弟]嫑勥昆,2761,161,5,5,10,50.0%,44m
3668,2,[型月重工厂]Tohsaka,2761,94,1,2,3,33.3%,1h
3672,3,Alienware,2760,305,11,7,18,61.1%,52m
3672,3,[星痕]哥是神,2760,281,9,9,18,50.0%,27m
3672,1,麻辣香锅,2760,276,8,8,16,50.0%,59m
3672,3,scv,2760,174,5,3,8,62.5%,7m
3672,3,[怕个虫子]加藤惠,2760,0,3,2,5,60.0%,27m
3672,2,我既是虫群,2760,0,1,0,1,100.0%,1h
3672,1,[DC第1宇宙]Falankse,2760,48,1,2,3,33.3%,31m
3672,3,[Chest]侃爷,2760,0,0,4,4,0.0%,6m
3680,2,[杜老师]云海漫漫,2759,1587,69,73,142,48.6%,53m
3680,1,简单电脑,2759,776,54,68,122,44.3%,51m
3680,3,StudyRobot,2759,0,2,2,4,50.0%,1h
3680,2,[第六駆逐鑑隊]毛子兄弟不要钱,2759,0,1,1,2,50.0%,53m
3684,3,尘世之恋,2758,0,4,1,5,80.0%,1h
3684,1,妖刀,2758,0,3,4,7,42.9%,59m
3684,2,玲珑骰子安红豆,2758,0,1,0,1,100.0%,37m
3684,3,滨边美波我老婆,2758,0,0,3,3,0.0%,27m
3688,1,xiaomaomi,2757,1213,50,58,108,46.3%,26m
3688,2,[老年娱乐团]时间跳跃者的妄想,2757,486,17,17,34,50.0%,17m
3688,1,DeadGame,2757,345,13,3,16,81.2%,1h
3688,3,SWK,2757,42,1,5,6,16.7%,1h
3688,3,无爱式回忆,2757,0,0,5,5,0.0%,26m
3693,2,鸡年大吉吧,2756,1503,68,67,135,50.4%,54m
3693,3,[江南大学]蛋大如斗墨鱼仔,2756,1135,66,56,122,54.1%,11m
3693,3,Northtundra,2756,140,5,7,12,41.7%,60m
3693,3,冲不下来怎么办,2756,0,3,2,5,60.0%,1h
3693,1,LoveLuLU,2756,0,0,1,1,0.0%,1h
3698,3,[折磨星际]Iron,2755,110,5,3,8,62.5%,26m
3698,2,白给真善美,2755,0,4,3,7,57.1%,23m
3698,2,Luhai,2755,0,1,0,1,100.0%,16m
3701,3,[孙哥的海鲜]阿克西斯教的祭司,2754,1151,45,43,88,51.1%,11m
3701,1,[AsC]泰坦,2754,462,15,28,43,34.9%,25m
3701,1,AlexBian,2754,0,3,5,8,37.5%,18m
3701,1,[星月神族]TNT,2754,0,0,1,1,0.0%,1h
3705,3,[第四駆逐鑑隊]Another,2753,0,4,1,5,80.0%,45m
3705,1,久安嘉禾,2753,0,1,0,1,100.0%,1h
3705,1,[末世纪]无敌舰队,2753,0,0,1,1,0.0%,1h
3708,3,[X英雄圣域X]张海,2752,1203,115,101,216,53.2%,7m
3708,2,zxc,2752,121,6,5,11,54.5%,1h
3708,2,爱夜夜夜夜,2752,93,2,3,5,40.0%,52m
3708,2,mmmm,2752,0,1,0,1,100.0%,1h
3708,3,两只小蜜蜂,2752,0,1,3,4,25.0%,24m
3713,2,railgun,2751,1571,185,190,375,49.3%,57m
3713,2,Antony,2751,804,101,90,191,52.9%,9m
3713,2,椿生,2751,88,5,4,9,55.6%,7m
3713,3,[miku守护]enborn,2751,44,4,2,6,66.7%,1h
3713,3,贝塔,2751,122,2,3,5,40.0%,56m
3713,3,不会玩别来贰打贰,2751,42,1,2,3,33.3%,45m
3719,1,断幺九,2750,184,6,2,8,75.0%,1h
3719,1,暗之锋芒,2750,139,3,1,4,75.0%,49m
3719,2,GGNeverBack,2750,121,2,5,7,28.6%,1h
3719,2,liye,2750,0,1,0,1,100.0%,22m
3723,1,永夜君王,2749,1238,65,49,114,57.0%,40m
3723,3,[龙腾宇内]镜月,2749,835,34,28,62,54.8%,27m
3723,3,[人人有功炼]tiantian,2749,348,13,12,25,52.0%,25m
3723,1,老唐,2749,188,6,4,10,60.0%,40m
3723,3,[SS天羽]怀有兴趣,2749,0,3,2,5,60.0%,41m
3723,3,[Cinder]噶姐的炮灰宠物狗,2749,30,1,3,4,25.0%,25m
3723,1,[Pulse]MINA,2749,0,0,1,1,0.0%,40m
3730,3,苏二五,2748,255,16,12,28,57.1%,12m
3730,2,归海一刀,2748,277,12,12,24,50.0%,34m
3732,2,[Encore]我爱米咪,2747,88,2,3,5,40.0%,44m
3732,3,Goollllllll,2747,0,1,0,1,100.0%,48m
3734,2,默默然,2746,1208,53,48,101,52.5%,7m
3734,2,小绵羊,2746,110,6,2,8,75.0%,1h
3734,1,[鸠UP]JoASHER,2746,234,6,5,11,54.5%,59m
3734,3,[四叶草]RainySky,2746,130,3,2,5,60.0%,3m
3734,1,Chuck,2746,0,0,2,2,0.0%,14m
3734,2,白猫吃橘子,2746,0,0,2,2,0.0%,16m
3740,1,[宇宙职业战队]Maru,2745,192,6,3,9,66.7%,44m
3740,2,[黑白条神教]亚顿,2745,134,5,4,9,55.6%,1h
3740,3,[猫神]美狄亚塞斯,2745,0,2,3,5,40.0%,1h
3740,3,潜行人,2745,0,2,3,5,40.0%,1h
3740,3,红叶,2745,0,2,3,5,40.0%,1h
3745,1,苏家炮娘,2744,871,58,54,112,51.8%,18m
3745,2,白首卧,2744,81,2,1,3,66.7%,32m
3745,3,执魔,2744,30,1,3,4,25.0%,1m
3748,3,moon,2743,657,27,22,49,55.1%,54m
3748,3,Jackson,2743,292,10,12,22,45.5%,6m
3748,1,[墨染千城]adsuf,2743,166,3,4,7,42.9%,1h
3748,1,[BUPTNB]JInAirRouge,2743,40,2,0,2,100.0%,50m
3752,1,[UDI]NoteamSOS,2742,1442,232,238,470,49.4%,14m
3752,1,Palette,2742,315,13,12,25,52.0%,22m
3752,3,Fitz,2742,338,12,18,30,40.0%,2m
3752,2,DANAKKKA,2742,115,3,4,7,42.9%,1h
3752,1,千幻,2742,142,2,3,5,40.0%,49m
3752,3,赢无翳,2742,0,2,3,5,40.0%,29m
3752,3,犬儒,2742,0,1,2,3,33.3%,1m
3752,1,[芽衣最可爱了]风间净琉璃,2742,0,0,1,1,0.0%,1h
3752,1,段筱侃,2742,0,0,5,5,0.0%,1h
3761,2,[鸡王争爸]Mseveneight,2741,243,9,11,20,45.0%,1h
3762,3,[萌萌嗒]雨霁丶墨雪,2740,810,41,34,75,54.7%,1m
3762,1,[泥玛艹战队]FineGL,2740,274,8,10,18,44.4%,1h
3762,2,Jay,2740,88,6,4,10,60.0%,32m
3762,3,打救,2740,0,2,3,5,40.0%,7m
3766,3,[暴雪十一队]IIIIIII,2739,0,2,3,5,40.0%,1h
3766,1,小魍魉丶,2739,0,0,1,1,0.0%,41m
3768,3,[老年之家]欧青辣少,2738,766,30,32,62,48.4%,11m
3768,2,脑虫在世输本酱,2738,325,13,6,19,68.4%,1h
3768,3,xlking,2738,44,6,0,6,100.0%,11m
3768,1,[黑丝小幼女]阿疯,2738,96,3,5,8,37.5%,44m
3772,2,[LFY]南皇,2737,687,29,33,62,46.8%,10m
3772,3,寇可往吾亦可往,2737,225,8,12,20,40.0%,34m
3772,1,大滋滋,2737,216,6,8,14,42.9%,60m
3772,3,[裤裆藏牛]Carica,2737,120,2,3,5,40.0%,21m
3772,1,打不过是你自己菜,2737,0,1,1,2,50.0%,29m
3777,2,IIIIIIIIIII,2736,116,16,19,35,45.7%,15m
3777,3,狗头,2736,206,7,10,17,41.2%,55m
3777,2,肉肉,2736,97,4,7,11,36.4%,20m
3777,3,lpww,2736,0,2,3,5,40.0%,1h
3781,2,[蕾姆酱]灵符掌握,2735,136,21,22,43,48.8%,11m
3781,3,ivo,2735,302,15,11,26,57.7%,2m
3781,3,第一高手,2735,262,12,7,19,63.2%,1h
3781,3,predict,2735,157,4,7,11,36.4%,45m
3781,2,害羞小熊猫,2735,128,3,6,9,33.3%,38m
3786,1,雨夜,2734,365,15,10,25,60.0%,40m
3786,1,青年,2734,137,7,4,11,63.6%,7m
3786,3,阿卡林,2734,116,5,9,14,35.7%,6m
3786,1,烫着火锅把你留,2734,104,4,6,10,40.0%,36m
3786,3,羽子,2734,0,2,3,5,40.0%,1h
3791,3,乌兹永远滴神,2733,354,14,18,32,43.8%,27m
3791,3,狂野胖子,2733,146,4,2,6,66.7%,15m
3791,2,绫落丶纤尘,2733,139,3,2,5,60.0%,16m
3791,1,[DC战队]流云,2733,0,0,3,3,0.0%,7m
3795,2,美丽的潘姐姐,2731,139,5,4,9,55.6%,19m
3795,2,露娜,2731,0,1,0,1,100.0%,1h
3795,3,Zdd,2731,0,0,2,2,0.0%,29m
3798,3,zik,2730,617,24,18,42,57.1%,52m
3798,1,戰意昂扬的年华,2730,98,3,2,5,60.0%,36m
3800,1,Rain,2729,1076,51,33,84,60.7%,1h
3800,3,[月见]虞姬,2729,0,1,0,1,100.0%,1h
3802,3,Rallyist,2728,1601,297,290,587,50.6%,4m
3802,1,HYpnus,2728,979,65,52,117,55.6%,59m
3802,3,爱丽丝狗王,2728,442,63,46,109,57.8%,2m
3802,1,王启程啥币,2728,516,23,19,42,54.8%,40m
3802,1,Naplean,2728,94,3,5,8,37.5%,1h
3807,3,Chase,2727,289,9,12,21,42.9%,11m
3807,1,[银河舰队]abcouy,2727,183,8,8,16,50.0%,25m
3807,3,小超,2727,172,7,8,15,46.7%,54m
3807,3,JIANG,2727,182,7,11,18,38.9%,3m
3807,1,橘子汁,2727,92,3,6,9,33.3%,1h
3812,2,豁老子,2726,1544,69,72,141,48.9%,24m
3812,1,Ayo,2726,318,13,6,19,68.4%,22m
3812,1,[冲就完了]只玩无敌的鸡谐化,2726,262,11,7,18,61.1%,40m
3812,3,老年选手玩情怀,2726,214,7,2,9,77.8%,1h
3812,1,IIIIIIIIIIII,2726,146,6,6,12,50.0%,50m
3812,3,jxws,2726,150,4,3,7,57.1%,6m
3812,1,星际丶战龙,2726,0,1,1,2,50.0%,51m
3812,1,[Rhusky]拾柒丨半糖去冰,2726,30,1,3,4,25.0%,1h
3820,1,母舰不是航母,2725,92,2,0,2,100.0%,1h
3820,1,[XYFANS]尼哥,2725,36,2,1,3,66.7%,52m
3820,1,九头蛇,2725,0,0,1,1,0.0%,22m
3823,3,魔法石,2724,42,4,3,7,57.1%,1h
3824,1,圣城旅纵队指挥官,2723,222,8,5,13,61.5%,1h
3824,1,海叶枫,2723,117,4,3,7,57.1%,15m
3824,3,盖世闲鱼,2723,0,3,1,4,75.0%,29m
3827,2,[刺蛇女装协会]IIIIIIIIIIII,2721,1368,72,72,144,50.0%,11m
3827,1,小飞鼠,2721,46,1,4,5,20.0%,1h
3829,2,我不想好好玩游戏,2720,138,5,3,8,62.5%,1h
3829,1,[无欲则刚]酋长,2720,0,4,1,5,80.0%,1h
3829,1,凛冬,2720,0,2,3,5,40.0%,1h
3829,1,Revolution,2720,0,0,1,1,0.0%,10m
3833,1,[普罗托斯英霸]pnixnoyo,2719,1114,39,51,90,43.3%,36m
3833,3,ROxxxE,2719,274,9,9,18,50.0%,22m
3833,3,[是嫂子自愿的]SurviveAnye,2719,0,4,1,5,80.0%,1h
3833,3,[KPG2]Megatron,2719,116,3,6,9,33.3%,15m
3833,1,two,2719,0,1,0,1,100.0%,1h
3838,2,四角吞金兽,2718,590,23,24,47,48.9%,21m
3838,1,[综合酯法]KasuganoSora,2718,331,13,7,20,65.0%,3m
3838,1,我是一个菜鸟,2718,263,7,4,11,63.6%,54m
3838,3,[PhoCo]PhoSelect,2718,149,7,14,21,33.3%,25m
3838,1,谐星耍星际,2718,0,1,0,1,100.0%,27m
3838,1,LuckyTerran,2718,0,1,2,3,33.3%,22m
3844,1,[EA丶F天启]水月,2717,204,5,3,8,62.5%,14m
3844,2,[专治格种不服]devil,2717,162,5,7,12,41.7%,14m
3846,2,ShiinaKumo,2716,456,13,28,41,31.7%,21m
3846,1,安稳,2716,237,7,9,16,43.8%,6m
3846,1,[XXHZN3]jaty,2716,0,1,0,1,100.0%,3m
3846,1,sakura,2716,0,1,1,2,50.0%,31m
3850,3,[KOTRT]halo,2715,307,42,36,78,53.8%,55m
3850,3,鸟抛花语丸丸落,2715,97,4,2,6,66.7%,1h
3850,2,[KILICI]dsawd,2715,0,3,3,6,50.0%,37m
3850,1,[四叶草]People,2715,38,2,0,2,100.0%,26m
3850,1,[一群谐星]游戏而已,2715,0,0,1,1,0.0%,1h
3855,2,奥野田美咲,2714,1260,76,79,155,49.0%,19m
3855,3,tassder,2714,495,22,17,39,56.4%,29m
3855,1,如沐清风,2714,365,15,8,23,65.2%,1h
3855,3,硫代硫酸钠,2714,286,11,10,21,52.4%,54m
3855,1,[不知不觉天亮]doctor,2714,126,10,4,14,71.4%,1h
3855,1,[积水潭]齐八爷,2714,126,3,0,3,100.0%,1h
3855,2,pianobear,2714,110,2,3,5,40.0%,1h
3855,3,[疼王阁]傻子被盘子打死,2714,0,1,2,3,33.3%,1m
3863,2,TNGT,2713,919,79,84,163,48.5%,15m
3863,1,悸丶,2713,228,8,9,17,47.1%,4m
3863,2,玩失忆,2713,197,6,7,13,46.2%,15m
3863,2,龙魂,2713,0,1,1,2,50.0%,25m
3863,1,京东食尸鬼,2713,0,0,1,1,0.0%,1h
3868,1,萌萌小宠虫,2712,1587,58,53,111,52.3%,1h
3868,3,名阳,2712,404,14,18,32,43.8%,54m
3868,1,沉默之剑,2712,142,5,3,8,62.5%,3m
3868,2,子沐淼,2712,0,3,4,7,42.9%,1h
3868,2,[暴民永不低头]某科学的吉太,2712,44,1,3,4,25.0%,16m
3868,1,冲进白宫,2712,0,1,4,5,20.0%,1h
3874,2,丁大款,2711,1586,144,138,282,51.1%,10m
3874,1,[慕灬小冷]烂分大师,2711,813,37,32,69,53.6%,54m
3874,2,[SpUrT]SleepWalKer,2711,195,6,7,13,46.2%,7m
3874,1,麻辣龙利鱼,2711,183,5,2,7,71.4%,43m
3874,1,[南邮憨B联盟]苍穹浮云,2711,184,5,3,8,62.5%,1h
3879,2,[GoTG]兵临城下之崛起,2710,1471,57,63,120,47.5%,56m
3879,3,WombRaider,2710,448,44,62,106,41.5%,52m
3879,2,[式神]卖萌的魔方,2710,432,18,21,39,46.2%,29m
3879,2,随风飘摇的旺财君,2710,95,4,2,6,66.7%,52m
3879,1,[埃蒙打的好呀]炽天使之魂,2710,0,1,4,5,20.0%,1h
3884,1,冲啊,2709,1612,73,61,134,54.5%,36m
3884,1,[枪兵叉叉狗]壹拾叁,2709,1632,60,60,120,50.0%,1h
3884,3,[HUC兄弟]LXC,2709,357,32,22,54,59.3%,6m
3884,1,[此用户已成仙]晓之车,2709,450,19,19,38,50.0%,12m
3884,2,爱硬斯坦,2709,0,1,1,2,50.0%,22m
3884,2,VirusTAO,2709,0,1,2,3,33.3%,1h
3890,3,yingtian,2708,261,10,7,17,58.8%,5m
3890,1,简单的电脑人,2708,190,7,6,13,53.8%,49m
3890,2,我爱范思哲,2708,95,5,3,8,62.5%,40m
3890,1,不知火殇,2708,194,5,4,9,55.6%,27m
3890,1,机器人藤田刚,2708,140,4,6,10,40.0%,1h
3890,1,[KENNEL]星际萌新,2708,42,2,2,4,50.0%,27m
3890,3,朝歌晚酒,2708,0,2,3,5,40.0%,41m
3897,1,潶涩回忆,2707,429,17,16,33,51.5%,36m
3897,3,Puma,2707,97,2,0,2,100.0%,28m
3897,3,[突天脑回路]小毒的乌龙茶,2707,44,2,3,5,40.0%,1h
3897,1,SchoolDays,2707,42,1,2,3,33.3%,30m
3897,2,小鸡啄米,2707,0,0,2,2,0.0%,54m
3902,3,无极,2706,1271,76,64,140,54.3%,22m
3902,1,FateAlex,2706,387,33,21,54,61.1%,1h
3902,3,[银翼之光]死亡之翼,2706,314,18,23,41,43.9%,54m
3902,1,[皇室联盟]凉介,2706,94,2,0,2,100.0%,1h
3902,1,[夜猫IIII]小狗一两只,2706,42,2,5,7,28.6%,1h
3907,1,Frances,2705,290,17,16,33,51.5%,36m
3907,1,[YINGJI]沐渊,2705,142,8,2,10,80.0%,36m
3907,1,blade,2705,143,7,2,9,77.8%,3m
3910,3,进步小青年,2704,0,2,3,5,40.0%,6m
3911,3,nigular,2703,159,12,14,26,46.2%,26m
3911,1,austin,2703,120,6,2,8,75.0%,1h
3911,2,[Sfae]千堂瑛里华,2703,102,4,8,12,33.3%,13m
3911,3,mmmmk,2703,0,2,1,3,66.7%,31m
3911,2,[GAS丶]Ghost,2703,0,2,5,7,28.6%,22m
3916,1,knightkami,2702,775,35,23,58,60.3%,1h
3916,1,[死撕妹]库布里克,2702,116,4,2,6,66.7%,23m
3916,1,猛驴赛跑车,2702,115,3,0,3,100.0%,1h
3916,1,[富贵不存在]夏步,2702,74,3,2,5,60.0%,3m
3916,3,LllllllllL,2702,0,2,3,5,40.0%,11m
3916,1,老工人去哪了,2702,0,0,1,1,0.0%,59m
3922,3,光明的力量,2701,838,57,59,116,49.1%,25m
3922,1,卋偉書尐,2701,164,5,6,11,45.5%,1h
3922,1,Landgrave,2701,0,1,0,1,100.0%,25m
3922,1,[有趣]MelonPan,2701,0,0,1,1,0.0%,10m
3922,1,我从不存在于过去,2701,0,0,1,1,0.0%,54m
3922,1,LoveCash,2701,0,0,2,2,0.0%,54m
3922,2,nidie,2701,0,0,2,2,0.0%,9m
3929,1,坑哥的矿骡,2700,402,13,13,26,50.0%,22m
3929,3,[X英雄圣域X]帮个游子,2700,151,9,8,17,52.9%,25m
3929,1,尼德霍格,2700,156,5,4,9,55.6%,44m
3929,1,深海鲨鱼王,2700,124,5,7,12,41.7%,15m
3929,1,[天际线]darkness,2700,0,0,1,1,0.0%,23m
3934,2,丶过敏世界,2699,969,38,36,74,51.4%,19m
3934,2,无月夜,2699,212,9,12,21,42.9%,54m
3934,1,[北极光小组]KingCrimson,2699,130,5,0,5,100.0%,40m
3934,3,无敌小屁孩,2699,148,5,4,9,55.6%,55m
3934,3,刻于新月之铭,2699,144,4,4,8,50.0%,13m
3934,2,Zero,2699,44,2,2,4,50.0%,53m
3934,3,惜萍,2699,0,2,3,5,40.0%,1h
3934,1,荀文若,2699,0,0,1,1,0.0%,1h
3942,1,guy,2698,304,13,11,24,54.2%,1h
3942,2,寒烟丶忆,2698,159,7,4,11,63.6%,44m
3942,3,巨像插嘴,2698,90,4,3,7,57.1%,4m
3942,3,sora,2698,0,3,1,4,75.0%,51m
3942,3,[DDOS浪漫]至尊超薄,2698,0,2,3,5,40.0%,13m
3942,3,[艾尔之名]筱柒,2698,30,2,6,8,25.0%,15m
3948,3,[害怕]三码数,2697,146,3,3,6,50.0%,20m
3948,2,[侍奉社]雪之下雪乃,2697,130,3,3,6,50.0%,1h
3950,3,[NLH]岸回霖风,2696,1393,74,70,144,51.4%,29m
3950,1,逼傻了反看你,2696,555,23,19,42,54.8%,18m
3950,3,[Mayuki]sclllJinG,2696,366,13,15,28,46.4%,14m
3950,1,雅色易续风,2696,264,11,15,26,42.3%,26m
3950,1,李毅,2696,253,10,13,23,43.5%,10m
3950,1,realcola,2696,230,9,9,18,50.0%,1h
3950,2,克洛佐斯的喵喵酱,2696,156,4,4,8,50.0%,26m
3950,3,warforNova,2696,0,2,3,5,40.0%,1h
3950,3,林诺诺,2696,0,2,3,5,40.0%,1h
3950,2,[骚话]凉粉,2696,0,1,0,1,100.0%,44m
3950,3,封逸琎,2696,0,1,0,1,100.0%,3m
3950,1,[TimoIN]云裳翎,2696,0,0,1,1,0.0%,1h
3962,1,黑夜里的繁星,2695,259,8,9,17,47.1%,1h
3963,3,[siebte]瓦尔基里,2694,452,27,26,53,50.9%,25m
3963,3,妈个鸡,2694,278,9,12,21,42.9%,27m
3963,2,WIDOWMINE,2694,248,7,6,13,53.8%,26m
3963,1,月之泪,2694,112,3,4,7,42.9%,1h
3963,3,[香槟神教]邪能小黄人,2694,0,1,0,1,100.0%,12m
3968,2,就他马你叫夏洛啊,2693,1125,99,107,206,48.1%,2m
3968,3,[SFloor]随去风来,2693,489,20,21,41,48.8%,29m
3968,1,[GO09]GOLD,2693,342,10,13,23,43.5%,27m
3968,1,applefly,2693,238,7,4,11,63.6%,21m
3968,3,RinTinYli,2693,0,2,3,5,40.0%,17m
3973,3,[萌萌拳]魔刹,2692,312,13,16,29,44.8%,7m
3973,1,不太会内战,2692,250,8,9,17,47.1%,52m
3973,1,[混元形意拳]along,2692,144,5,3,8,62.5%,1h
3973,1,小刺蛇,2692,96,2,0,2,100.0%,1h
3977,3,影峰,2691,537,19,21,40,47.5%,3m
3977,1,[拨云见日]凤雏,2691,177,9,3,12,75.0%,60m
3977,1,[暴雪十队]不会打星际啦,2691,194,7,2,9,77.8%,43m
3977,2,DesiWim,2691,0,2,4,6,33.3%,37m
3977,1,高跟黑丝娘,2691,96,2,7,9,22.2%,1h
3977,1,寒爵,2691,0,1,1,2,50.0%,1h
3977,1,IIIIIIIIIIII,2691,0,0,3,3,0.0%,10m
3984,3,常威,2690,592,21,29,50,42.0%,11m
3984,1,[萝林好汉]狂野之狼,2690,134,4,9,13,30.8%,1h
3986,1,[夏姬八玩]ZPttty,2689,1592,330,335,665,49.6%,14m
3986,1,夜夜比海深,2689,184,6,12,18,33.3%,27m
3986,1,Magina,2689,48,4,6,10,40.0%,1h
3986,3,Robin,2689,0,2,3,5,40.0%,14m
3986,1,borinpp,2689,0,1,0,1,100.0%,23m
3986,1,神龙虾米,2689,0,1,0,1,100.0%,50m
3986,1,[最菜战队]Maybe,2689,0,1,1,2,50.0%,1h
3986,1,麦迪文,2689,42,1,2,3,33.3%,1h
3986,3,WEW,2689,0,1,5,6,16.7%,14m
3995,2,梅常酥,2688,1066,38,46,84,45.2%,5m
3995,1,Ken,2688,294,7,7,14,50.0%,54m
3995,3,花生芽,2688,92,3,9,12,25.0%,1h
3995,1,小虫子,2688,38,2,3,5,40.0%,1h
3999,3,[火焰雷兽]StrBro,2687,638,23,27,50,46.0%,27m
3999,1,钢铁菊花,2687,283,12,19,31,38.7%,1h
3999,1,[白门楼谐会]白门楼上的吕奉先,2687,142,7,5,12,58.3%,31m
3999,3,[DMXM]NEW,2687,148,6,7,13,46.2%,56m
3999,1,[太微玉清宫]虚竹,2687,162,5,5,10,50.0%,44m
3999,3,IIIIIIIIIIII,2687,0,4,1,5,80.0%,1h
4005,3,红门馆,2686,268,13,10,23,56.5%,43m
4006,2,[CHP]久皇叔,2685,112,4,6,10,40.0%,14m
4006,2,Ugo,2685,0,3,4,7,42.9%,31m
4006,3,电击重闷拳,2685,0,2,3,5,40.0%,14m
4006,2,[嘤嘤樱]废材优优,2685,0,2,5,7,28.6%,1h
4006,3,[ZZFANS]Markinian,2685,0,0,1,1,0.0%,59m
4011,3,[TCP]Lupo,2684,1156,53,48,101,52.5%,5m
4011,1,[暴雪养鸡场]地痞,2684,684,41,3,44,93.2%,40m
4011,1,[C21605]Mousko,2684,182,8,5,13,61.5%,26m
4011,3,Forestaurora,2684,0,2,3,5,40.0%,1h
4015,3,阳聪,2683,1427,68,64,132,51.5%,18m
4015,1,如风的老司机,2683,576,24,18,42,57.1%,26m
4015,1,[神奇宝贝联盟]末影小火龙,2683,239,9,8,17,52.9%,10m
4015,2,SEED,2683,91,2,1,3,66.7%,1h
4015,2,帝国影子,2683,0,0,3,3,0.0%,37m
4020,3,尘埃落定,2682,1130,53,49,102,52.0%,27m
4020,1,右倚笑尘,2682,199,5,5,10,50.0%,1h
4020,1,三水,2682,209,5,7,12,41.7%,42m
4020,2,[探机之怒]wbc,2682,140,4,5,9,44.4%,9m
4020,1,[虚拟歌手团体]逗比的战舰,2682,0,1,0,1,100.0%,1h
4020,2,虚荣,2682,0,1,0,1,100.0%,8m
4020,1,天空極緻,2682,0,1,1,2,50.0%,1h
4020,2,mingge,2682,0,1,6,7,14.3%,1h
4028,1,[CHP]aklhwek,2681,530,18,21,39,46.2%,1h
4028,3,OMINke,2681,318,15,12,27,55.6%,14m
4028,3,刘一本,2681,0,3,2,5,60.0%,1h
4028,2,孟靖翔,2681,0,0,2,2,0.0%,30m
4032,1,[V7P]maxvscore,2680,137,3,2,5,60.0%,3m
4032,1,sellfood,2680,57,2,3,5,40.0%,3m
4032,3,[YA]AFcstats,2680,0,1,0,1,100.0%,5m
4035,3,[我开矿了你呢]脑残必死,2679,760,29,31,60,48.3%,2m
4035,3,[软萌甜小萝莉]观测者,2679,552,24,17,41,58.5%,15m
4035,1,霸气测漏,2679,264,9,8,17,52.9%,50m
4035,2,强上郭德纲,2679,139,5,4,9,55.6%,2m
4035,1,whw,2679,117,4,0,4,100.0%,26m
4040,1,Adele,2678,1338,62,69,131,47.3%,26m
4040,1,咿呀呀,2678,313,11,9,20,55.0%,56m
4040,3,[XXHZ8]药水,2678,120,6,7,13,46.2%,1h
4040,1,龙与地下城,2678,144,5,8,13,38.5%,50m
4040,2,疯狂的野鼠,2678,95,3,4,7,42.9%,5m
4040,1,amethyst,2678,0,0,1,1,0.0%,1h
4046,3,名字太长,2677,0,3,2,5,60.0%,1h
4046,1,[星际三舰客]NuoyaAduoli,2677,66,2,4,6,33.3%,1h
4046,2,吾丶天命,2677,0,0,2,2,0.0%,14m
4049,2,[100T7]CCJOY,2676,1582,323,321,644,50.2%,57m
4049,2,[单人模拟战]沉默之风暴,2676,1113,88,89,177,49.7%,26m
4049,3,lllllllllwx,2676,929,33,34,67,49.3%,3m
4049,3,[譏颰]Suker,2676,305,12,12,24,50.0%,20m
4049,1,ZGY,2676,294,9,11,20,45.0%,6m
4049,1,复仇者,2676,114,3,8,11,27.3%,41m
4049,3,真空快递员,2676,0,2,2,4,50.0%,31m
4049,3,老眼镜,2676,0,2,3,5,40.0%,29m
4057,2,地二,2675,1326,86,98,184,46.7%,29m
4057,1,为父不仁,2675,470,25,26,51,49.0%,27m
4057,3,fishhan,2675,117,3,0,3,100.0%,34m
4057,3,TATQwQ,2675,97,3,3,6,50.0%,4m
4057,1,[核平大队]作业狂人,2675,0,1,1,2,50.0%,18m
4062,3,Bourne,2674,769,64,63,127,50.4%,21m
4062,1,悠然然然然然,2674,888,49,46,95,51.6%,46m
4062,1,[12323]玩手机,2674,271,9,6,15,60.0%,1h
4062,1,易灬,2674,147,8,3,11,72.7%,36m
4062,1,Icecreamerry,2674,144,5,6,11,45.5%,1h
4062,2,[EnTorn]非正常人类研究所,2674,0,0,2,2,0.0%,1h
4068,1,叫我小宇就好啦,2673,903,53,53,106,50.0%,26m
4068,2,duck,2673,90,6,7,13,46.2%,54m
4068,1,Loudes,2673,130,5,0,5,100.0%,21m
4068,3,[混元形意星际]JIANG,2673,145,5,3,8,62.5%,1h
4068,2,[秋毫]听风,2673,108,3,3,6,50.0%,1h
4073,3,最爱,2672,359,51,47,98,52.0%,14m
4073,3,[在下萌新一只]有星际好玩吗,2672,1280,48,50,98,49.0%,55m
4073,1,Snorlax,2672,186,8,15,23,34.8%,17m
4073,1,CaOiNGeR,2672,212,7,8,15,46.7%,1h
4073,1,忒修斯之船,2672,104,2,1,3,66.7%,52m
4078,2,[浪啊浪]苞米地里的黑寡妇,2671,558,19,32,51,37.3%,14m
4078,3,肉饼飞起,2671,301,12,14,26,46.2%,54m
4078,3,[半个菜鸟II]黑天大神,2671,287,9,13,22,40.9%,7m
4078,1,菜鸡请不要喷,2671,237,6,6,12,50.0%,22m
4078,1,Andy,2671,186,6,8,14,42.9%,13m
4078,1,嘟吧哒,2671,226,6,10,16,37.5%,35m
4078,3,Adele,2671,0,0,1,1,0.0%,41m
4085,2,FayeDream,2670,1621,97,104,201,48.3%,5m
4085,1,Saber,2670,236,11,2,13,84.6%,1h
4085,2,[埃蒙调教团]freedom,2670,168,6,7,13,46.2%,1h
4085,1,[大连民大]CPPmonk,2670,0,2,3,5,40.0%,1h
4085,1,[琴之森]wqdfs,2670,46,1,1,2,50.0%,29m
4090,1,东方坑爹,2669,1677,218,200,418,52.2%,1h
4090,1,大勇哥传奇,2669,619,24,22,46,52.2%,36m
4090,1,[海德单推协会]无敌鸦鸦者,2669,231,8,7,15,53.3%,1h
4090,3,invoker,2669,0,2,4,6,33.3%,1h
4090,1,[大煮鸡好菜]mrazor,2669,0,1,0,1,100.0%,1h
4090,3,你才萝卜,2669,0,1,1,2,50.0%,34m
4090,1,malcolm,2669,0,0,1,1,0.0%,1h
4097,3,[大洋彼岸团队]Giotto,2668,212,16,18,34,47.1%,6m
4097,1,真心玩不动了,2668,133,5,4,9,55.6%,1h
4097,2,那些很冒险的梦,2668,124,4,6,10,40.0%,1h
4097,3,阿道夫,2668,0,3,3,6,50.0%,11m
4097,2,[国际第91号]classices,2668,96,3,3,6,50.0%,1h
4097,3,陌七,2668,0,2,3,5,40.0%,34m
4103,3,同卵,2667,266,12,6,18,66.7%,14m
4103,1,[武圣]light,2667,205,6,5,11,54.5%,36m
4103,1,StZrhop,2667,218,6,10,16,37.5%,60m
4106,2,[极限菜鸟]鸿鹄飞鹰,2666,462,35,25,60,58.3%,11m
4106,3,[星s]夜零,2666,762,27,32,59,45.8%,6m
4106,1,Alan,2666,222,19,16,35,54.3%,1h
4106,1,[TeamGB]Bloodmage,2666,202,5,5,10,50.0%,45m
4106,2,[CPT]不雷斯,2666,93,3,4,7,42.9%,1h
4106,1,speedisgood,2666,36,2,1,3,66.7%,4m
4112,1,若风,2665,1213,55,52,107,51.4%,1h
4112,1,hddys,2665,471,16,22,38,42.1%,1h
4112,1,撒旦的哥哥,2665,97,4,2,6,66.7%,55m
4112,3,坏坏,2665,0,4,2,6,66.7%,4m
4116,2,[开矿咯]不狗不莽,2664,649,22,33,55,40.0%,54m
4116,2,长廊,2664,414,17,8,25,68.0%,43m
4116,3,Dante,2664,311,13,13,26,50.0%,27m
4116,1,[晴空未岛]云鬼,2664,226,8,10,18,44.4%,18m
4116,2,[CRSC2]Vegeta,2664,232,7,9,16,43.8%,58m
4116,2,雪狼小飞,2664,122,5,1,6,83.3%,45m
4116,2,YAN,2664,0,2,3,5,40.0%,37m
4116,3,[HUC轩辕]叫兽砖家欢迎咨询,2664,0,2,4,6,33.3%,7m
4116,2,[西雅图咖啡店]广胜,2664,0,1,0,1,100.0%,32m
4125,3,[小鸡屠宰场9]可口可乐,2663,820,28,37,65,43.1%,21m
4125,2,最爱佩琪,2663,120,5,3,8,62.5%,1h
4125,1,YesnO,2663,0,1,1,2,50.0%,4m
4125,3,赫萝的黄金龙爪,2663,0,1,4,5,20.0%,48m
4129,2,忘川失了魂,2662,0,4,3,7,57.1%,1h
4129,3,浮出水面的包子,2662,0,2,3,5,40.0%,28m
4131,1,[暨大职业校队]蝶舞子望,2661,406,14,16,30,46.7%,1h
4131,1,[别害怕少年]蜗牛,2661,143,6,1,7,85.7%,1h
4131,1,无情丶无殇,2661,92,3,2,5,60.0%,1h
4131,2,SCV,2661,0,0,1,1,0.0%,1h
4135,2,[YR]BadDog,2660,42,5,3,8,62.5%,54m
4135,1,[咸鱼谐会]HUCSummer,2660,112,3,3,6,50.0%,30m
4135,3,[全国修车]潜龙行空,2660,0,2,3,5,40.0%,1h
4135,1,[GCT]cooooooool,2660,40,1,5,6,16.7%,1h
4139,1,[不知不觉天亮]孙一喵,2659,1044,38,32,70,54.3%,1h
4139,2,[i5]Thanatos,2659,303,12,6,18,66.7%,1h
4139,1,Wiss,2659,201,7,4,11,63.6%,21m
4139,2,吃个汉堡压压惊,2659,0,1,0,1,100.0%,11m
4143,2,小莫满满,2658,879,95,100,195,48.7%,2m
4143,3,[菜有菜的道理]理查德伊卡洛斯,2658,532,25,14,39,64.1%,15m
4143,2,EvaNGelIoN,2658,343,11,22,33,33.3%,54m
4143,2,scan,2658,207,7,8,15,46.7%,1h
4143,3,TaU,2658,0,2,3,5,40.0%,1h
4148,3,DezhA,2657,875,111,112,223,49.8%,23m
4148,3,谢沐泽,2657,39,3,7,10,30.0%,13m
4148,2,IIIIIIIIIIII,2657,0,1,0,1,100.0%,1h
4148,2,[Igirls]冥氡,2657,0,0,1,1,0.0%,1h
4152,1,[五月花]東邪,2656,691,34,14,48,70.8%,23m
4152,3,[暴雪我是你爹]Ulysses,2656,0,1,4,5,20.0%,25m
4152,2,leonidas,2656,0,0,1,1,0.0%,1h
4155,3,AzazeI,2655,127,4,5,9,44.4%,15m
4155,1,[沙漠天团]小蝌蚪,2655,0,1,2,3,33.3%,36m
4157,3,心已失梦已碎,2654,700,62,56,118,52.5%,27m
4157,2,[混吃混喝]虚空之遗,2654,620,30,45,75,40.0%,2m
4157,2,太虚剑意,2654,360,13,24,37,35.1%,17m
4157,2,知秋一叶,2654,115,5,3,8,62.5%,21m
4157,3,Lembo,2654,97,2,4,6,33.3%,1h
4157,1,[江南虫王]咸鱼,2654,0,0,2,2,0.0%,1h
4163,1,胖头鱼,2653,610,25,20,45,55.6%,54m
4163,1,塔达林高阶刺蛇,2653,0,2,7,9,22.2%,23m
4165,2,花翎灬为谁祭,2652,762,28,35,63,44.4%,2m
4165,2,[旺旺战士]大意没有闪,2652,299,12,3,15,80.0%,1h
4165,2,热爱星际,2652,333,11,10,21,52.4%,16m
4165,3,AeF,2652,128,5,6,11,45.5%,21m
4165,3,lllidansad,2652,0,1,0,1,100.0%,1h
4165,2,华仔,2652,0,1,0,1,100.0%,1h
4165,1,误点的闹钟,2652,88,1,2,3,33.3%,54m
4172,1,[天国之魔]GGmoonlight,2651,36,1,3,4,25.0%,12m
4172,3,忆久弗哀,2651,0,0,1,1,0.0%,59m
4174,3,[LOHv]感觉瞬间,2650,1452,150,153,303,49.5%,15m
4174,2,行者,2650,183,4,4,8,50.0%,1h
4174,3,安安,2650,97,3,4,7,42.9%,31m
4174,3,大叔太可恶,2650,36,2,1,3,66.7%,1h
4178,1,[天庭]鸿飞哥哥,2649,696,68,51,119,57.1%,18m
4178,3,[小仙女上线啦]NOLF,2649,327,22,24,46,47.8%,21m
4178,2,llllllllllll,2649,276,11,5,16,68.8%,5m
4178,1,大脚盆,2649,350,11,12,23,47.8%,4m
4178,2,牛奶嫩嫩,2649,163,7,5,12,58.3%,1h
4178,2,[Fli]诸神黄昏,2649,144,5,3,8,62.5%,15m
4178,1,北有疑兵,2649,168,5,4,9,55.6%,52m
4178,1,[Foehn焚]秘制小汉堡,2649,134,4,7,11,36.4%,36m
4178,2,[谐莽狗偷稳奶]爱睡觉的橙子,2649,112,2,1,3,66.7%,1h
4178,1,訾璇,2649,0,0,2,2,0.0%,60m
4188,1,拼搏,2648,1017,52,47,99,52.5%,1h
4188,2,晚饭我来做,2648,264,9,4,13,69.2%,1h
4188,2,再难相遇,2648,140,4,5,9,44.4%,54m
4188,3,Meanwcharon,2648,0,1,0,1,100.0%,1h
4188,2,[ILYSK]天雷怒战,2648,0,0,1,1,0.0%,1h
4193,1,[暴tou]Lukatin,2647,169,8,6,14,57.1%,43m
4193,1,[帝国春秋]冥界死神,2647,0,3,5,8,37.5%,7m
4193,3,RoarPanda,2647,0,2,3,5,40.0%,17m
4193,3,清纯玉女苍井空,2647,0,2,3,5,40.0%,1h
4193,3,Antediluvian,2647,30,2,7,9,22.2%,6m
4193,1,情話,2647,90,1,2,3,33.3%,18m
4199,3,打小朋友,2646,806,29,33,62,46.8%,11m
4199,3,[请停止攻击]本客机里面没人,2646,0,2,3,5,40.0%,1h
4199,1,你信吗,2646,46,1,1,2,50.0%,1h
4199,1,LAODOU,2646,38,1,3,4,25.0%,1h
4203,1,[透一下清酒]IIIIIIIII,2645,495,21,14,35,60.0%,23m
4203,1,[C90830]查理斯王子,2645,379,13,12,25,52.0%,36m
4203,1,神奇,2645,28,2,4,6,33.3%,52m
4203,2,Fenix,2645,0,0,3,3,0.0%,1h
4207,2,可爱小乖乖,2644,678,23,34,57,40.4%,21m
4207,1,梨子,2644,277,12,14,26,46.2%,40m
4207,2,[CnNami]阿萨德,2644,0,1,0,1,100.0%,40m
4207,2,冷凛西,2644,0,0,1,1,0.0%,51m
4211,3,[新宿三丁目]imoyaki,2643,1426,78,78,156,50.0%,6m
4211,1,陨落星辰,2643,685,25,23,48,52.1%,53m
4211,1,[CPT]蛋疼的极品奶爸,2643,545,22,14,36,61.1%,1h
4211,1,超级课程表,2643,432,14,12,26,53.8%,46m
4211,3,Azeroth,2643,0,0,1,1,0.0%,1h
4211,2,firedK,2643,0,0,1,1,0.0%,1m
4217,1,上善若水,2642,97,7,9,16,43.8%,44m
4217,1,Bereavement,2642,173,6,2,8,75.0%,1h
4217,2,决战青铜王,2642,94,4,8,12,33.3%,36m
4217,3,朱未未,2642,56,2,10,12,16.7%,54m
4221,2,Umbrella,2641,924,111,117,228,48.7%,2m
4221,3,朱五四,2641,1251,49,60,109,45.0%,6m
4221,3,[天才mvp]RHO,2641,283,20,19,39,51.3%,29m
4221,2,[Kiloli]鸽屿,2641,0,0,1,1,0.0%,1h
4225,1,[火焰雷兽]内战太难了,2640,806,31,40,71,43.7%,12m
4225,2,兄台请慢走,2640,248,7,13,20,35.0%,15m
4225,3,IIIIIIIIIIII,2640,0,3,2,5,60.0%,17m
4225,3,丧病的龙娘,2640,0,2,3,5,40.0%,1h
4229,3,[瞧他不香吗]cccccc,2639,1444,77,75,152,50.7%,22m
4229,1,金毛豆豆,2639,860,33,32,65,50.8%,54m
4229,2,[DDOS群雄]bilibili,2639,115,5,3,8,62.5%,5m
4232,2,煎烤叫兽,2637,1360,61,72,133,45.9%,57m
4232,1,IIIllllIIIll,2637,1525,59,54,113,52.2%,36m
4232,2,手慢的笨比,2637,474,22,5,27,81.5%,29m
4232,2,[节操满满的]雾雨魔理莎,2637,0,0,1,1,0.0%,42m
4236,2,Marshall,2636,1562,179,183,362,49.4%,19m
4237,2,小菜菜,2635,1179,220,212,432,50.9%,20m
4237,1,[丨SLT丨]lllllllllill,2635,320,51,29,80,63.8%,12m
4237,1,妈个鸡泰伦,2635,632,24,19,43,55.8%,1h
4237,1,死神之颠,2635,274,15,12,27,55.6%,50m
4237,1,尘封你妹啊,2635,0,2,3,5,40.0%,1h
4242,3,别动老子农民,2634,1418,99,98,197,50.3%,20m
4242,1,何苦,2634,1268,80,83,163,49.1%,40m
4242,2,[晚上吃基]星际玩家都是瞎子,2634,685,68,72,140,48.6%,12m
4242,1,cruise,2634,284,7,9,16,43.8%,29m
4242,3,Recur,2634,60,5,6,11,45.5%,14m
4242,2,Tendos,2634,113,4,5,9,44.4%,1h
4242,3,[柠檬保护协会]国宝熊猫,2634,146,3,4,7,42.9%,34m
4242,2,[Aseris]BLANK,2634,0,0,1,1,0.0%,14m
4250,2,wolfheader,2633,1606,93,88,181,51.4%,23m
4250,3,[老头儿星际]大龄玩家,2633,917,51,54,105,48.6%,2m
4250,2,呼啸战神,2633,893,35,28,63,55.6%,56m
4250,2,健康的性福生活,2633,375,14,10,24,58.3%,43m
4250,2,[浓酸屁味]小泽玛莉亚丶,2633,0,0,1,1,0.0%,54m
4255,2,[DMR]expelliomos,2632,372,16,7,23,69.6%,58m
4256,2,[透一下清酒]永远喜欢着鹿乃,2631,266,9,5,14,64.3%,1h
4256,2,一波狗全家暴毙,2631,119,3,0,3,100.0%,1h
4258,1,footman,2630,1285,67,51,118,56.8%,1h
4258,1,永夜,2630,1011,41,39,80,51.2%,1h
4258,1,就这啊,2630,0,3,2,5,60.0%,42m
4258,3,翔宇战神,2630,120,2,3,5,40.0%,1h
4258,1,[开心战队]酒鬼,2630,0,2,3,5,40.0%,20m
4263,2,[充气团]IIIIIIIIII,2629,130,5,3,8,62.5%,1h
4263,2,Deutchland,2629,159,4,8,12,33.3%,1h
4263,1,铁血大飞哥,2629,0,3,5,8,37.5%,7m
4263,3,简单的电脑,2629,0,0,1,1,0.0%,1h
4267,2,ZeD,2628,292,12,2,14,85.7%,11m
4267,3,BeRichAsFuxk,2628,68,5,4,9,55.6%,1h
4267,1,那句晚安你听了吗,2628,0,2,3,5,40.0%,1h
4267,2,索然无味小刺蛇娘,2628,140,1,6,7,14.3%,1h
4271,1,[TeamGB]RainDrop,2627,1571,90,86,176,51.1%,1h
4271,2,[星际合作群]银翼,2627,906,60,47,107,56.1%,1h
4271,3,[EC]黑猫,2627,590,21,30,51,41.2%,2m
4271,3,sincejuly,2627,70,4,5,9,44.4%,1h
4275,3,奈落之花,2626,1656,107,101,208,51.4%,25m
4275,2,[不打GG]Lovecraft,2626,723,34,30,64,53.1%,1h
4275,3,[鸽子飞呀飞]是谁在呼叫舰队,2626,552,21,24,45,46.7%,7m
4275,3,Peter,2626,393,13,17,30,43.3%,14m
4275,1,无畏,2626,319,11,12,23,47.8%,25m
4275,1,[最后的晚餐]Repartee,2626,265,10,8,18,55.6%,7m
4275,3,电脑困难,2626,145,4,1,5,80.0%,12m
4275,2,IIIIIIIIIIII,2626,74,2,3,5,40.0%,37m
4283,2,[天朝大队]LiquidHero,2625,1276,39,66,105,37.1%,2m
4283,1,[银翼之光]灵魂流转,2625,304,7,12,19,36.8%,25m
4283,1,人皇,2625,0,2,3,5,40.0%,45m
4286,3,GGbond,2624,202,9,10,19,47.4%,1h
4286,1,[LOHv]艾尔,2624,141,7,8,15,46.7%,1h
4286,2,[火焰雷兽]淑二,2624,60,3,1,4,75.0%,45m
4286,3,Vicccc,2624,97,3,4,7,42.9%,11m
4286,1,大宝剑,2624,0,0,3,3,0.0%,1h
4291,2,EvenDark,2623,493,21,24,45,46.7%,1h
4291,2,[人族最强近战]小红帽的大镰刀,2623,535,20,18,38,52.6%,44m
4291,1,PIAODD,2623,425,15,20,35,42.9%,12m
4291,3,[2对2大师]我本纯洁,2623,139,3,10,13,23.1%,6m
4291,1,副官,2623,0,2,3,5,40.0%,3m
4296,1,无言丶,2622,471,16,16,32,50.0%,12m
4296,2,niuniuniu,2622,176,6,5,11,54.5%,1h
4296,3,昆仑玉,2622,0,0,1,1,0.0%,4m
4299,3,Liadrin,2621,114,4,3,7,57.1%,45m
4299,1,豆豆,2621,0,2,3,5,40.0%,27m
4299,1,[春兰]暴雪背叛了星际,2621,50,2,6,8,25.0%,1h
4302,1,栀寒晓,2620,335,11,12,23,47.8%,7m
4302,3,鱼玄机,2620,97,5,1,6,83.3%,1h
4302,2,热开水很香,2620,32,2,0,2,100.0%,21m
4305,2,[快乐白给]慕斯,2619,370,14,14,28,50.0%,25m
4305,2,Mvp,2619,216,8,2,10,80.0%,11m
4305,1,援气少女柠檬酱,2619,202,7,5,12,58.3%,38m
4305,1,[AFSC2]Stats,2619,159,6,6,12,50.0%,13m
4309,3,落无星,2618,1548,248,242,490,50.6%,15m
4309,3,[远坂世家]OpenFire,2618,114,5,10,15,33.3%,22m
4309,2,[SUSSSS]haoyv,2618,0,4,3,7,57.1%,1h
4309,1,[艦Colle]fcf,2618,0,2,3,5,40.0%,45m
4313,3,川普打星际,2617,391,13,23,36,36.1%,8m
4313,1,皮卡丘,2617,256,11,10,21,52.4%,18m
4313,3,斐多悖论,2617,258,10,13,23,43.5%,26m
4313,3,[重剑]猎魂觉醒,2617,30,1,8,9,11.1%,7m
4317,1,yan,2616,183,6,10,16,37.5%,1h
4317,2,[LOHv]星座左继军,2616,0,1,0,1,100.0%,1h
4319,2,[到爸爸这来]鹰可,2615,1530,678,674,1352,50.1%,54m
4319,1,HeroQiang,2615,523,71,70,141,50.4%,14m
4319,2,暗夜风中之狼,2615,0,1,1,2,50.0%,43m
4319,1,智障也有春天,2615,0,0,3,3,0.0%,4m
4323,1,jmdmke,2614,460,15,18,33,45.5%,14m
4323,1,[纸鸢i]同性才是真爱,2614,301,11,9,20,55.0%,27m
4323,3,LOL,2614,271,9,15,24,37.5%,3m
4323,2,[黎椛夜暮]希灵使徒,2614,30,2,0,2,100.0%,53m
4323,2,濛江鸡蛋先生,2614,0,2,3,5,40.0%,1h
4323,1,秦梦轩,2614,0,2,3,5,40.0%,21m
4323,2,沉誓,2614,0,1,2,3,33.3%,29m
4323,1,老病友,2614,38,1,5,6,16.7%,30m
4331,1,subingjia,2613,1275,113,108,221,51.1%,52m
4331,1,[混元星际門]小木曾雪菜,2613,256,9,13,22,40.9%,30m
4331,3,[树大王]王大树,2613,0,0,1,1,0.0%,1h
4334,3,BOLSHEVIK,2612,463,108,100,208,51.9%,20m
4334,2,小胖于儿,2612,549,22,23,45,48.9%,14m
4334,2,周大福豆腐干,2612,306,19,19,38,50.0%,21m
4334,1,樱岛麻衣,2612,0,5,3,8,62.5%,1h
4334,2,天上的声名,2612,0,4,1,5,80.0%,1h
4334,2,FlanDRe,2612,0,1,0,1,100.0%,1h
4340,1,endocytosis,2611,1649,343,344,687,49.9%,60m
4340,2,[暴雪二十二队]挤一挤,2611,30,1,1,2,50.0%,56m
4342,2,在途的巨便打鸡,2610,998,86,79,165,52.1%,1h
4342,3,[NEP涅普]苦色殇声,2610,750,36,42,78,46.2%,55m
4342,1,[白丝黑丝萝莉]平尺淮,2610,291,12,10,22,54.5%,40m
4342,2,[虚空守望]bacteria,2610,188,8,9,17,47.1%,1h
4342,1,究极抗韩,2610,0,3,2,5,60.0%,1h
4342,3,真夏夜的野兽先辈,2610,121,3,4,7,42.9%,4m
4342,2,[西伯利亚土豆]wangjunsen,2610,0,1,0,1,100.0%,1h
4342,3,[苏千]阿月,2610,0,0,1,1,0.0%,56m
4350,1,[逗比神教]赣南孙一峰,2609,372,14,4,18,77.8%,1h
4350,2,楠枫流沐,2609,175,5,2,7,71.4%,1h
4350,2,白泽加奈惠的饼干,2609,30,2,2,4,50.0%,41m
4350,1,[德哈卡神教]明明,2609,0,0,2,2,0.0%,44m
4354,2,[SteEng]最恨萌新,2608,387,16,8,24,66.7%,1h
4354,1,[缩阳入腹]丨旋风老阴逼丨,2608,108,4,6,10,40.0%,10m
4356,1,[日最野的狗]wqdsfgf,2607,1474,77,70,147,52.4%,59m
4356,2,柯西不等式,2607,677,26,28,54,48.1%,21m
4358,2,[永恒星域]变形金刚,2606,0,1,0,1,100.0%,1h
4359,2,[加州室内装修]tslone,2605,1574,244,251,495,49.3%,16m
4359,2,[金盾男科医院]杨医生,2605,348,26,23,49,53.1%,54m
4359,2,喵神,2605,130,5,5,10,50.0%,20m
4359,1,哥斯拉没吃饱,2605,0,2,3,5,40.0%,16m
4359,2,Kurumi,2605,0,0,1,1,0.0%,42m
4359,2,被小朋友殴打的路,2605,0,0,2,2,0.0%,1h
4365,3,llllllllllll,2604,406,12,21,33,36.4%,54m
4365,2,听雨,2604,173,6,7,13,46.2%,1h
4367,1,[大漢]粉毛小兔兔,2603,495,22,18,40,55.0%,1h
4367,2,OrzJerry,2603,0,3,2,5,60.0%,11m
4369,3,[神秘的队标]北海祭祀,2602,491,17,21,38,44.7%,54m
4369,1,lonewolf,2602,386,12,17,29,41.4%,60m
4369,1,hasagi,2602,273,10,9,19,52.6%,1h
4369,1,Grasshopper,2602,192,4,9,13,30.8%,52m
4369,2,[有为青年]偷瓜的震荡猹,2602,0,1,1,2,50.0%,14m
4374,3,Arestronger,2601,828,166,193,359,46.2%,12m
4374,3,zhanhuoys,2601,97,6,3,9,66.7%,1h
4376,2,食色,2600,270,9,7,16,56.2%,36m
4376,2,[哦哟喂呀]路虎揽胜,2600,180,7,6,13,53.8%,54m
4376,2,南宁靓仔,2600,0,1,0,1,100.0%,15m
4379,1,飞花逐月,2599,1333,169,166,335,50.4%,5m
4379,3,大佬请教我玩星际,2599,147,6,3,9,66.7%,1h
4379,3,fanhua,2599,42,4,4,8,50.0%,57m
4379,3,神秘人,2599,159,4,7,11,36.4%,13m
4379,1,一块一哈,2599,0,3,2,5,60.0%,11m
4379,2,老夫乃天选之人,2599,95,2,7,9,22.2%,14m
4385,1,十八岁头号,2598,1184,49,38,87,56.3%,1h
4385,1,耗子拿刀找猫,2598,386,14,13,27,51.9%,1h
4385,2,[极品二五仔]孙一峰,2598,226,9,11,20,45.0%,1h
4385,2,机枪兵,2598,90,1,2,3,33.3%,44m
4389,1,CoreRabbit,2597,1621,80,84,164,48.8%,44m
4389,2,可哥可妻孙一峰,2597,393,18,9,27,66.7%,1h
4389,2,[狂想曲]尼玛,2597,0,0,1,1,0.0%,51m
4392,2,天之轿子,2596,252,14,18,32,43.8%,16m
4392,1,风味餐,2596,158,6,10,16,37.5%,1h
4394,2,妖世浮屠,2595,175,10,5,15,66.7%,5m
4394,3,王虫,2595,181,8,9,17,47.1%,26m
4394,3,热爱核平的斯大林,2595,32,1,1,2,50.0%,5m
4397,2,[奔驰何平]神秘秘,2594,413,17,10,27,63.0%,17m
4397,3,MAGIC,2594,257,11,12,23,47.8%,3m
4397,3,段云的姑舅爸,2594,0,1,0,1,100.0%,1h
4397,2,zzzzx,2594,30,1,1,2,50.0%,1h
4397,2,汤达人,2594,0,0,2,2,0.0%,38m
4402,1,[teamco]FlamingC,2593,1349,101,94,195,51.8%,59m
4402,1,[极限菜鸟]梦无形心相伴,2593,0,2,3,5,40.0%,11m
4402,3,肢解怪人,2593,121,2,5,7,28.6%,29m
4405,3,恶魔大君,2592,0,4,2,6,66.7%,4m
4405,2,[塔达林的领主]Alarak,2592,58,2,3,5,40.0%,38m
4407,1,狂战,2591,688,28,26,54,51.9%,1h
4407,2,男子单打型选手,2591,209,15,16,31,48.4%,9m
4407,1,Azuk,2591,320,13,15,28,46.4%,1h
4407,3,Omega,2591,222,7,6,13,53.8%,1h
4407,2,[ASDFZ]Chouuken,2591,107,3,4,7,42.9%,36m
4412,2,么么哒小兔兔,2590,116,3,1,4,75.0%,54m
4412,1,hehuaqi,2590,0,2,3,5,40.0%,1h
4412,2,[ZLR]Bargon,2590,0,1,0,1,100.0%,44m
4415,2,[慢手e族]小艾尔,2589,509,21,15,36,58.3%,1h
4415,2,[华文中学]ASDUH,2589,194,7,2,9,77.8%,53m
4415,2,[幻想神社]MorinoSeika,2589,198,6,4,10,60.0%,29m
4418,1,猪头军长,2588,406,59,62,121,48.8%,12m
4418,3,[闭嘴基佬]SDDDDDDDDDGG,2588,1082,38,52,90,42.2%,54m
4418,2,[cestla]吉原哀歌,2588,192,7,4,11,63.6%,1h
4418,3,unknown,2588,127,4,5,9,44.4%,1h
4418,2,[CnDY]Von,2588,62,2,4,6,33.3%,29m
4418,3,gtyfyf,2588,97,1,1,2,50.0%,4m
4418,2,异虫,2588,30,1,2,3,33.3%,1h
4425,1,一战,2587,930,203,197,400,50.8%,22m
4425,1,[半个菜鸟]TARKIN,2587,568,22,22,44,50.0%,26m
4425,2,请打别人吧,2587,572,21,24,45,46.7%,39m
4425,2,停电了怎么办,2587,404,16,11,27,59.3%,24m
4425,2,深海折鸢,2587,163,7,0,7,100.0%,2m
4425,3,SuperCY,2587,148,5,8,13,38.5%,1h
4425,1,丿幻丶梦姬,2587,0,4,1,5,80.0%,20m
4425,2,威廉王,2587,90,4,3,7,57.1%,51m
4425,2,啊啊啊啊,2587,157,3,4,7,42.9%,1h
4434,2,[DMRe]封杀不果,2586,1622,66,64,130,50.8%,25m
4434,1,崔思念想意郭郭,2586,1545,60,64,124,48.4%,26m
4434,2,Jyee,2586,371,16,13,29,55.2%,1h
4434,2,[暴雪二十八队]dunima,2586,60,3,2,5,60.0%,1h
4434,1,马路杀手,2586,0,2,3,5,40.0%,20m
4434,2,[腥基佬男骸]极客大会,2586,90,1,2,3,33.3%,45m
4440,2,Weiss,2585,454,18,12,30,60.0%,1h
4440,2,[鲁德欢]虚空来客,2585,173,6,2,8,75.0%,45m
4440,2,熙晨永远不独行,2585,0,0,1,1,0.0%,2m
4443,2,[TAPC]Kingsman,2584,288,12,5,17,70.6%,15m
4443,3,真央,2584,34,3,5,8,37.5%,1h
4443,1,Lndota,2584,0,1,1,2,50.0%,4m
4446,1,甄不错,2583,543,22,20,42,52.4%,22m
4446,1,[北京肥宅]Tomerbaiwu,2583,142,4,7,11,36.4%,26m
4446,3,[积水潭]Usawakiko,2583,122,3,2,5,60.0%,1h
4446,2,势不可挡,2583,0,1,0,1,100.0%,25m
4450,2,哦啊拉拉,2582,738,29,23,52,55.8%,2m
4450,3,舒小魅,2582,145,4,5,9,44.4%,1h
4450,2,洛燨,2582,0,3,2,5,60.0%,1h
4450,3,iab,2582,0,0,1,1,0.0%,1h
4450,2,吟瘾怪,2582,0,0,1,1,0.0%,1h
4455,1,奇怪的神族玩家,2581,354,15,27,42,35.7%,6m
4455,2,[萌新zd]脚本,2581,127,6,1,7,85.7%,56m
4455,3,杨汶锜,2581,121,3,5,8,37.5%,56m
4455,2,[我觉得不行]我觉得我行,2581,0,0,1,1,0.0%,1h
4459,1,[llIlll]llllllllllll,2580,1635,412,406,818,50.4%,55m
4459,1,LightFH,2580,0,1,0,1,100.0%,1h
4459,2,梦回天国,2580,0,1,1,2,50.0%,51m
4459,2,virus,2580,0,1,1,2,50.0%,15m
4459,2,Maru,2580,0,0,3,3,0.0%,1h
4464,2,梅天王,2579,1060,47,36,83,56.6%,1h
4464,1,[皮断腿]孝悌,2579,490,25,25,50,50.0%,40m
4464,2,撒撒撒,2579,389,19,17,36,52.8%,2m
4464,1,麦诺希德,2579,545,19,20,39,48.7%,29m
4464,2,[夏日香气]冰柠檬物语,2579,185,8,2,10,80.0%,1h
4464,2,ATM,2579,30,2,2,4,50.0%,42m
4464,3,ChinaGg,2579,0,2,4,6,33.3%,1h
4464,2,[整个活]加尔巴兰,2579,30,1,3,4,25.0%,1h
4472,2,[智商杯233]actfav,2578,1582,97,102,199,48.7%,43m
4472,3,MagicTragic,2578,133,4,6,10,40.0%,1h
4472,2,Katana,2578,64,2,7,9,22.2%,1h
4475,2,知了,2577,1109,83,70,153,54.2%,34m
4475,2,李欣怡,2577,295,9,10,19,47.4%,1h
4475,2,消失的雷诺丶吉米,2577,236,8,9,17,47.1%,1h
4475,2,见芒,2577,178,7,5,12,58.3%,1h
4475,2,[耀世姚熙]暴雪的爹,2577,103,6,6,12,50.0%,1h
4475,2,wmzwmz,2577,183,5,4,9,55.6%,22m
4475,2,Timsless,2577,0,1,0,1,100.0%,56m
4482,1,畚祁,2576,310,8,5,13,61.5%,58m
4482,2,夜猫子,2576,60,3,4,7,42.9%,15m
4482,2,[星之所在RI]绝对靠谱,2576,0,1,0,1,100.0%,11m
4485,2,最后的战役,2575,142,6,6,12,50.0%,1h
4485,2,[虚无]野蛮开拓者,2575,0,0,1,1,0.0%,29m
4485,2,[老大哥]张市长,2575,0,0,2,2,0.0%,9m
4488,2,二火,2574,226,10,8,18,55.6%,1h
4488,2,沉睡的人,2574,246,8,9,17,47.1%,1h
4488,3,[暴雪二队]无敌金刚,2574,145,4,3,7,57.1%,1h
4491,3,邓林,2573,136,3,1,4,75.0%,12m
4491,3,ISSPolaris,2573,0,1,0,1,100.0%,1h
4491,1,hhhhhh,2573,0,1,4,5,20.0%,1h
4491,1,Nino,2573,0,1,5,6,16.7%,14m
4495,2,LBY,2572,1028,38,39,77,49.4%,44m
4495,2,按时恰个饭,2572,234,7,6,13,53.8%,44m
4495,2,ZSLlove,2572,0,1,1,2,50.0%,24m
4498,2,枪兵王,2571,78,2,2,4,50.0%,1h
4498,3,FIRe,2571,0,0,1,1,0.0%,1h
4500,2,[火影何平]奶申,2570,284,9,10,19,47.4%,56m
4500,2,难难,2570,244,8,11,19,42.1%,1h
4500,1,[小鸡屠宰场8]爱灬不爱,2570,0,0,1,1,0.0%,49m
4503,2,炸鱼没妈,2569,200,7,7,14,50.0%,41m
4503,2,[NightL]NMZL,2569,158,5,5,10,50.0%,1h
4503,3,[芦苇酒]ActiulBear,2569,0,1,0,1,100.0%,33m
4503,3,[喵喵咪]虚空真冷,2569,0,0,1,1,0.0%,17m
4503,3,誓言如尘染年华,2569,0,0,1,1,0.0%,10m
4508,2,青铜炮灰,2568,1015,70,64,134,52.2%,1h
4508,3,[小鸡屠宰场3]大嫖,2568,404,13,12,25,52.0%,60m
4508,3,tooyoung,2568,0,1,0,1,100.0%,14m
4508,1,zzz,2568,0,1,0,1,100.0%,42m
4512,3,覅睬弄,2567,1621,394,382,776,50.8%,51m
4512,1,Lcrab,2567,1658,168,175,343,49.0%,23m
4512,2,紫衫,2567,1171,54,48,102,52.9%,1h
4512,1,[狂野战队]苏雨凝,2567,796,34,30,64,53.1%,45m
4512,2,KOY,2567,231,7,6,13,53.8%,1h
4512,3,草原狼王灰太狼,2567,30,6,7,13,46.2%,15m
4512,3,zsv,2567,0,0,1,1,0.0%,25m
4519,1,IIIIIIIIIIII,2566,179,58,55,113,51.3%,6m
4519,3,[御阿礼之子丶]蕾拉普莉兹姆利巴,2566,0,1,0,1,100.0%,26m
4519,3,RicaroMLU,2566,30,1,1,2,50.0%,17m
4522,2,[永恒自由]Discover,2565,125,18,17,35,51.4%,1h
4522,3,suv,2565,140,5,2,7,71.4%,1h
4522,1,DAhall,2565,0,0,1,1,0.0%,13m
4525,3,冷沫,2564,1441,98,83,181,54.1%,7m
4525,3,[原谅兄弟会]不讲武德耗子尾汁,2564,282,10,14,24,41.7%,6m
4525,2,邪火,2564,234,9,8,17,52.9%,20m
4525,2,吃瓜群众,2564,116,3,3,6,50.0%,1h
4525,2,Mercy,2564,0,3,5,8,37.5%,32m
4525,1,深海寻觅者,2564,0,2,3,5,40.0%,49m
4525,2,斗鱼小宇丶,2564,0,0,2,2,0.0%,1h
4532,2,都是花哥的锅,2563,42,4,6,10,40.0%,23m
4532,1,[兰均竹空]utoo,2563,106,3,9,12,25.0%,23m
4534,2,星星不会玩,2562,1218,193,197,390,49.5%,53m
4534,1,tingyang,2562,1080,113,114,227,49.8%,1h
4534,3,[未知生物]UNKNOWN,2562,182,8,12,20,40.0%,8m
4534,1,Jiyeon,2562,179,5,9,14,35.7%,1h
4534,3,[Rhusky]GankPaSimpLe,2562,0,4,1,5,80.0%,1h
4534,3,[我们是无敌的]小狗,2562,0,0,1,1,0.0%,60m
4540,2,[NKTJ]减肥达人,2561,1070,46,34,80,57.5%,2m
4540,2,灬飒爽英姿灬,2561,304,13,6,19,68.4%,1h
4540,2,天天,2561,228,9,6,15,60.0%,17m
4540,2,上帝是个好女孩,2561,0,1,2,3,33.3%,2m
4544,2,欧阳鸡翅,2560,268,10,8,18,55.6%,1h
4544,1,[乱世]泡泡,2560,0,4,1,5,80.0%,54m
4546,2,[谁在呼叫舰队]星际战神,2559,1441,53,62,115,46.1%,34m
4546,3,猪兔子,2559,241,9,16,25,36.0%,14m
4546,3,小七,2559,62,6,4,10,60.0%,6m
4549,2,瞳影,2558,1475,73,87,160,45.6%,10m
4550,3,[克哈的女团]许大大,2557,719,48,51,99,48.5%,23m
4550,1,Grsoy,2557,960,38,39,77,49.4%,30m
4550,3,Thunder,2557,30,2,2,4,50.0%,29m
4550,3,[瘾大眼瞎]桐予,2557,0,2,8,10,20.0%,57m
4550,2,药丸,2557,32,1,3,4,25.0%,1h
4550,3,齐市三少,2557,0,0,1,1,0.0%,1h
4556,1,cary,2556,553,53,42,95,55.8%,36m
4556,1,鬼哭狼嚎,2556,188,7,11,18,38.9%,6m
4556,3,[虚无]GAN,2556,121,4,5,9,44.4%,1h
4556,2,胜哥,2556,114,2,3,5,40.0%,21m
4560,3,ango,2555,313,11,16,27,40.7%,1h
4560,3,千千,2555,88,3,3,6,50.0%,1h
4562,3,[龙族战队]专属我用,2554,0,0,2,2,0.0%,60m
4563,1,[YM都是沙比]小麟,2553,1614,286,268,554,51.6%,14m
4563,3,溜溜球,2553,332,12,11,23,52.2%,1h
4563,3,陨落人间,2553,38,3,5,8,37.5%,1h
4563,2,hughes,2553,0,1,3,4,25.0%,58m
4567,2,一条命,2552,419,25,20,45,55.6%,58m
4567,1,遥远的文明,2552,138,4,7,11,36.4%,1h
4569,2,优雅的天秤,2551,420,29,28,57,50.9%,42m
4569,2,[Rhusky]我是条码人,2551,122,5,5,10,50.0%,51m
4569,3,Rainfa,2551,74,4,6,10,40.0%,1h
4569,2,[我们是无敌的]吴迪,2551,147,2,5,7,28.6%,58m
4569,1,舔下霸娼,2551,0,1,0,1,100.0%,1h
4569,3,阿炜不俊,2551,0,0,1,1,0.0%,32m
4575,2,钢铁熊津,2550,370,12,16,28,42.9%,44m
4575,3,枯木逢春,2550,247,8,11,19,42.1%,27m
4577,2,INnoVation,2549,1099,98,94,192,51.0%,25m
4577,2,極楓,2549,60,3,5,8,37.5%,15m
4579,2,九尾凶猫,2548,553,21,21,42,50.0%,1h
4579,3,YUKINO,2548,58,3,1,4,75.0%,1h
4579,3,高能养胖胖,2548,0,1,0,1,100.0%,1h
4579,1,[夕林]Darkcookue,2548,48,1,1,2,50.0%,29m
4583,3,Saroman,2547,1066,109,97,206,52.9%,1h
4583,1,AAOC,2547,145,4,3,7,57.1%,49m
4583,2,jjh,2547,88,1,4,5,20.0%,37m
4586,1,艾恩俄面,2546,864,34,36,70,48.6%,1h
4586,3,[五月花]英雄联盟是辣鸡,2546,437,19,15,34,55.9%,20m
4586,2,[君之家]llllllllllll,2546,347,13,11,24,54.2%,24m
4586,3,[萌新保护协议]亭翰,2546,120,5,2,7,71.4%,1m
4586,3,成都蜀创,2546,84,5,3,8,62.5%,26m
4586,1,[无聊人生]kay,2546,0,2,3,5,40.0%,13m
4586,3,fredning,2546,0,1,0,1,100.0%,26m
4593,3,皮卡苏,2545,1305,245,257,502,48.8%,3m
4593,3,[CPT]ALTER,2545,525,49,51,100,49.0%,20m
4593,2,weor,2545,215,9,7,16,56.2%,1h
4593,2,朱大常丶,2545,282,9,14,23,39.1%,1h
4593,3,REchelieu,2545,241,8,3,11,72.7%,1h
4593,2,艾尔之子,2545,203,6,7,13,46.2%,1h
4593,2,小白玉兔,2545,0,4,3,7,57.1%,23m
4593,2,小小新手,2545,66,3,6,9,33.3%,56m
4593,3,[HK丶S]最终鸟倦归林,2545,0,2,2,4,50.0%,1h
4602,1,武汉刘德华,2544,591,21,24,45,46.7%,40m
4602,3,[艾尔之名]Yolandale,2544,133,5,5,10,50.0%,8m
4602,1,Flare,2544,0,0,1,1,0.0%,1h
4605,3,[武道专家]遥遥無期,2543,142,4,1,5,80.0%,45m
4605,3,[thu战队]雪菜浅乃,2543,30,2,0,2,100.0%,22m
4605,3,要妳命叁仟,2543,0,2,4,6,33.3%,1h
4608,2,[将军刽子手]放牛娃,2542,536,22,14,36,61.1%,43m
4608,1,[唐延路夜宵组]Stan,2542,308,11,15,26,42.3%,1h
4608,2,[一刀屠天下]一只菜狗,2542,160,5,4,9,55.6%,1h
4608,3,一默一,2542,88,3,4,7,42.9%,1h
4608,3,血色的祝福,2542,30,2,0,2,100.0%,1m
4608,1,Nectar,2542,48,2,5,7,28.6%,16m
4608,3,Cypress,2542,0,0,1,1,0.0%,44m
4615,1,LBellaRufis,2541,903,36,41,77,46.8%,23m
4615,1,ziyou,2541,0,2,3,5,40.0%,1h
4615,3,罗杰,2541,0,1,0,1,100.0%,28m
4615,3,[马家沟白给王]枪兵滚毒爆大师,2541,0,1,4,5,20.0%,1h
4619,1,小小猪,2540,308,10,12,22,45.5%,38m
4619,2,[EOS]新手电脑,2540,286,10,17,27,37.0%,1h
4619,3,绝活多线送兵,2540,237,8,2,10,80.0%,50m
4619,2,训咯,2540,0,0,4,4,0.0%,1h
4623,3,[老油条战队]内战好烦再见,2539,1606,95,97,192,49.5%,21m
4623,3,发胶手,2539,947,55,49,104,52.9%,33m
4623,1,这小伙子很帅,2539,182,7,11,18,38.9%,1h
4623,3,二分之一,2539,122,6,6,12,50.0%,7m
4627,3,炮灰,2538,388,45,51,96,46.9%,2m
4627,3,芷龙,2538,214,7,2,9,77.8%,54m
4627,1,矿骡王子,2538,32,5,4,9,55.6%,26m
4627,1,小小跳虫可笑可笑,2538,155,4,5,9,44.4%,1h
4627,1,[墨染樱]不讲武德,2538,48,2,4,6,33.3%,19m
4627,3,[17CM]兽到不能再兽,2538,0,1,0,1,100.0%,17m
4627,3,[HUC和平]聊语话香,2538,0,0,1,1,0.0%,22m
4634,3,showtime,2537,0,2,4,6,33.3%,1h
4634,1,小豆子,2537,91,1,5,6,16.7%,28m
4636,1,[超级哈皮]无可取代,2536,912,424,452,876,48.4%,24m
4636,1,Greenday,2536,723,37,33,70,52.9%,22m
4636,1,[TAPC]TITANS,2536,582,21,24,45,46.7%,26m
4636,2,THOOO,2536,272,9,14,23,39.1%,56m
4636,3,无敌的我灬解释,2536,94,7,4,11,63.6%,36m
4636,2,[犹豫12败北]白给少年,2536,263,7,8,15,46.7%,1h
4636,1,老少爷们,2536,224,7,9,16,43.8%,11m
4643,1,[超新星]perfect,2535,567,30,28,58,51.7%,1h
4643,2,[SERN]Amadeus,2535,166,7,10,17,41.2%,38m
4643,1,[小姐姐协会]xiaxian,2535,0,1,0,1,100.0%,20m
4643,3,yuka,2535,0,1,0,1,100.0%,54m
4643,1,爆不爆炸,2535,0,0,1,1,0.0%,39m
4648,3,[Guilty]ArchEgoist,2534,1600,1154,1177,2331,49.5%,6m
4648,2,强魔气,2534,1490,119,106,225,52.9%,29m
4648,2,lovelove,2534,257,10,6,16,62.5%,15m
4648,2,丿醉灬少丶,2534,122,4,7,11,36.4%,1h
4648,3,[C53421]扒了猛干,2534,0,0,1,1,0.0%,5m
4653,1,黑暗盖亚,2533,1526,143,134,277,51.6%,6m
4653,3,DivineJudge,2533,0,4,1,5,80.0%,36m
4653,1,击毙嚣张,2533,0,3,2,5,60.0%,1h
4653,2,幽凌之镰,2533,93,2,2,4,50.0%,53m
4653,1,[死亡降临]火星骑士,2533,0,2,3,5,40.0%,46m
4658,3,MagicSnorlax,2532,295,12,14,26,46.2%,26m
4658,1,[最强战神]蓄意一卖萌,2532,213,10,9,19,52.6%,14m
4658,3,鸡儿炸了,2532,30,1,1,2,50.0%,27m
4661,2,天天天,2531,367,13,14,27,48.1%,1h
4661,3,YUKI,2531,107,3,3,6,50.0%,36m
4661,3,Distancenam,2531,0,1,0,1,100.0%,15m
4661,3,Carly,2531,0,0,1,1,0.0%,43m
4665,3,[NVKR]十二年秋,2530,346,12,7,19,63.2%,45m
4666,3,manson,2529,1371,82,81,163,50.3%,25m
4666,2,亚克斯,2529,222,8,9,17,47.1%,1h
4666,2,zest,2529,144,5,7,12,41.7%,54m
4666,1,Hunter,2529,0,1,1,2,50.0%,1h
4666,1,天地上乘有顶天,2529,0,0,1,1,0.0%,1h
4671,3,鬼翼,2528,832,118,123,241,49.0%,23m
4671,3,player,2528,621,23,17,40,57.5%,11m
4673,2,好靓,2527,120,4,7,11,36.4%,29m
4673,3,赵昱江,2527,0,2,4,6,33.3%,8m
4673,2,yun,2527,0,0,2,2,0.0%,45m
4676,2,庄槿森,2526,264,28,35,63,44.4%,22m
4676,2,萌萌新,2526,786,26,35,61,42.6%,17m
4676,2,[大佬请把鞋给]小骷髅,2526,422,18,12,30,60.0%,1h
4676,2,[换家引领世界]夜空中最亮的星,2526,58,2,6,8,25.0%,24m
4680,3,手残在线康复训练,2525,1074,54,48,102,52.9%,51m
4680,3,Vant,2525,375,14,8,22,63.6%,14m
4680,2,虚空巴士,2525,180,7,11,18,38.9%,43m
4680,3,枪钢马子多,2525,30,2,3,5,40.0%,30m
4680,3,漂流王,2525,0,2,4,6,33.3%,56m
4680,1,天夜言,2525,0,0,1,1,0.0%,16m
4686,2,Atwm,2524,198,9,7,16,56.2%,1h
4686,3,[乃木坂46]斋藤飞鸟,2524,114,5,6,11,45.5%,1h
4686,1,[人人人]SRay,2524,0,2,3,5,40.0%,1h
4689,3,Blood,2523,1411,106,114,220,48.2%,21m
4689,2,爱莎公猪,2523,714,25,27,52,48.1%,54m
4689,2,[Hist]IIIIIIIIIIII,2523,328,12,15,27,44.4%,1h
4689,1,炎日当空,2523,285,12,16,28,42.9%,44m
4689,3,NSK,2523,233,8,3,11,72.7%,16m
4689,3,[NHSD]DavidGin,2523,249,8,6,14,57.1%,8m
4689,2,金黄枫叶,2523,0,3,4,7,42.9%,1h
4689,3,小志,2523,0,1,0,1,100.0%,1h
4689,3,[黑森峰卐学院]弃坑菜鸟,2523,0,0,1,1,0.0%,1h
4689,2,我今天三岁了,2523,0,0,1,1,0.0%,45m
4699,3,[MS13战术]幻化成风,2522,1269,51,52,103,49.5%,10m
4699,3,[慢手e族]菜鸟达拉姆之刃,2522,582,26,18,44,59.1%,26m
4699,1,客即至当如何,2522,375,13,10,23,56.5%,29m
4699,3,Mikrokosmos,2522,0,1,0,1,100.0%,1h
4703,3,沸腾的鸡汤,2521,236,8,3,11,72.7%,1h
4703,1,[暴赱总司令]虚空结晶,2521,258,8,15,23,34.8%,30m
4703,3,joeylee,2521,98,7,5,12,58.3%,1h
4706,1,[CPT]虚空之王,2520,216,5,13,18,27.8%,1h
4706,2,天籁灬神,2520,93,2,2,4,50.0%,38m
4706,3,[花看半开]卓安,2520,0,0,2,2,0.0%,6m
4706,3,[琴筝]DARKPEACH,2520,0,0,3,3,0.0%,26m
4710,3,[Onceme]嬉笑看人生,2519,1154,39,52,91,42.9%,6m
4710,1,灬風雲灬,2519,97,2,4,6,33.3%,54m
4710,1,XIN,2519,0,0,1,1,0.0%,16m
4713,1,我很菜但我喜爱,2518,243,9,9,18,50.0%,11m
4713,3,狛枝凪斗,2518,159,5,1,6,83.3%,36m
4713,3,安诚打麻将厉害,2518,91,4,5,9,44.4%,26m
4713,1,汝父在此,2518,0,1,0,1,100.0%,29m
4713,3,[战神之神]大哥的歌,2518,0,1,1,2,50.0%,32m
4718,3,[萌萌哒鸡]Heath,2517,0,3,4,7,42.9%,1h
4718,3,TEwager,2517,0,1,0,1,100.0%,43m
4718,3,[我意凌云]歌天澜,2517,0,1,1,2,50.0%,11m
4718,3,[基金会]sky,2517,0,0,1,1,0.0%,1h
4718,3,极光之舞的斥候,2517,0,0,1,1,0.0%,12m
4723,2,[慢手e族]战神,2516,60,5,5,10,50.0%,25m
4723,3,新手变老鸟,2516,72,4,7,11,36.4%,1h
4723,3,[KIT6]skywings,2516,0,1,0,1,100.0%,22m
4723,3,[清明上河图]我曰泥县人,2516,0,1,2,3,33.3%,1h
4723,1,布布吃饱了,2516,0,0,1,1,0.0%,1h
4728,2,[群英]套利达人,2515,422,15,19,34,44.1%,1h
4728,3,大地堡小地堡,2515,295,12,12,24,50.0%,1h
4728,3,[暮Licht]Ichigao,2515,30,1,1,2,50.0%,51m
4731,3,远方迷惘,2514,421,18,16,34,52.9%,2m
4731,2,[暴雪三队]简单电脑,2514,199,8,6,14,57.1%,17m
4731,2,[21CM]llllllllllll,2514,154,4,7,11,36.4%,14m
4731,1,[菜鸡喵]森木下士,2514,108,3,5,8,37.5%,1h
4731,1,[暨大职业校队]你的加菲猫,2514,0,2,3,5,40.0%,1h
4736,3,sorry,2513,1466,82,87,169,48.5%,55m
4736,3,huilixiao,2513,30,2,2,4,50.0%,11m
4736,1,[菜有菜的道理]故故故久,2513,86,2,8,10,20.0%,7m
4739,3,fanys,2512,307,12,5,17,70.6%,1h
4739,2,留意,2512,166,5,4,9,55.6%,1h
4739,1,魂祭一雪舞,2512,0,3,2,5,60.0%,54m
4739,1,[MFJ]captain,2512,0,1,2,3,33.3%,1h
4743,1,[Whitey]SWeWeTheart,2511,1593,560,561,1121,50.0%,27m
4743,1,[欧佩克]鳄鱼,2511,584,61,69,130,46.9%,43m
4743,1,[积水潭]qibaye,2511,48,3,5,8,37.5%,1h
4743,1,大脚盆,2511,0,1,4,5,20.0%,46m
4747,2,[我是攻子]小花,2510,809,31,32,63,49.2%,1h
4747,1,时光,2510,48,2,0,2,100.0%,30m
4747,1,[蚂蚁护卫队]聚光镜,2510,0,1,0,1,100.0%,11m
4747,3,一夢叁罒年,2510,97,1,2,3,33.3%,1h
4747,1,[谁在呼叫舰队]逼格之王,2510,0,0,5,5,0.0%,1h
4752,2,背锅侠一号,2509,218,7,10,17,41.2%,42m
4752,3,亦似花洛亦似霞,2509,150,6,5,11,54.5%,1h
4754,3,[CPT]般若,2508,969,37,33,70,52.9%,2m
4754,2,Perfect,2508,150,7,9,16,43.8%,1h
4754,3,midnight,2508,92,4,4,8,50.0%,1h
4757,3,齐天大圣,2507,1462,183,180,363,50.4%,11m
4757,3,夜雨声繁,2507,91,4,2,6,66.7%,1h
4757,3,亚哥,2507,30,2,2,4,50.0%,1h
4757,3,苍白,2507,0,1,0,1,100.0%,1h
4757,3,海风吹一吹,2507,30,1,1,2,50.0%,57m
4762,1,木白,2506,459,18,23,41,43.9%,30m
4763,1,llllllllll,2505,1591,128,133,261,49.0%,1h
4763,1,随便灭了你,2505,638,26,25,51,51.0%,26m
4763,3,Archangel,2505,30,1,1,2,50.0%,22m
4766,3,三缸,2504,1000,50,50,100,50.0%,22m
4766,1,[让让孩子吧]莱德林,2504,845,37,40,77,48.1%,6m
4766,3,零下,2504,169,4,7,11,36.4%,33m
4769,1,大器晚成,2503,48,2,2,4,50.0%,39m
4769,2,Toe,2503,0,0,1,1,0.0%,1h
4771,1,[闭眼憋农民]automaticapm,2502,145,2,1,3,66.7%,46m
4772,1,BBB,2501,982,102,102,204,50.0%,29m
4772,3,[113]电脑,2501,517,20,16,36,55.6%,11m
4772,3,[肉鸡的饲养]魔法少女鱼鱼酱,2501,288,10,5,15,66.7%,1h
4772,2,[旺旺战士]藤条焖雷兽,2501,162,7,7,14,50.0%,1h
4776,2,[奇迹革命家]Yicass,2500,1554,375,377,752,49.9%,1h
4776,3,坑哥的机枪兵,2500,1286,49,46,95,51.6%,51m
4776,3,[麒云]IIIIIIIIIIII,2500,799,41,61,102,40.2%,18m
4776,3,醉人心弦,2500,324,13,14,27,48.1%,17m
4776,3,MinazukiGear,2500,60,3,1,4,75.0%,1h
4776,3,鸽帝熙离,2500,0,1,0,1,100.0%,1h
4776,1,Archon,2500,0,1,5,6,16.7%,1h
4776,1,momodaa,2500,0,0,1,1,0.0%,19m
4784,3,这个游戏好难啊,2499,608,43,21,64,67.2%,1h
4784,3,RedArmyChen,2499,172,5,7,12,41.7%,8m
4784,1,星际菜鸟来了,2499,193,4,4,8,50.0%,49m
4784,3,[查尔之矛]秋荷,2499,0,1,0,1,100.0%,1h
4788,3,[火焰雷兽]misakamisaka,2498,1576,658,681,1339,49.1%,55m
4788,3,光明战神,2498,1526,92,102,194,47.4%,26m
4788,1,异虫,2498,1343,47,55,102,46.1%,27m
4788,3,[红发海贼团]枪炮与玫瑰,2498,354,14,12,26,53.8%,1h
4788,3,伊蕾娜,2498,184,6,3,9,66.7%,34m
4788,3,松果痰抖闪电鞭,2498,196,5,4,9,55.6%,1h
4788,3,[贰伍仔集中营]多读读书,2498,0,2,5,7,28.6%,1h
4788,3,星际迷雾,2498,0,0,1,1,0.0%,50m
4796,3,[妖精卜卜口]末裔,2497,1398,133,142,275,48.4%,6m
4796,1,[曾经一群兔兔]曾经有一只兔子,2497,578,102,96,198,51.5%,29m
4796,2,萌萌哒的小熊猫,2497,647,31,35,66,47.0%,17m
4796,3,Journal,2497,369,14,9,23,60.9%,1h
4796,1,[0D]ThePassion,2497,48,5,2,7,71.4%,1h
4796,2,我已颓废感觉良好,2497,120,3,8,11,27.3%,1h
4796,3,星际潇洒哥,2497,0,1,0,1,100.0%,45m
4803,3,fountainhead,2496,359,14,12,26,53.8%,57m
4803,2,xlks,2496,160,5,3,8,62.5%,1h
4803,3,[羊羊快跑]zww,2496,30,2,1,3,66.7%,1h
4806,1,[BGA]BiGAcO,2495,286,10,17,27,37.0%,43m
4806,1,[违章建筑多多]燎原号,2495,0,3,1,4,75.0%,1h
4806,3,游戏毁一生,2495,0,0,2,2,0.0%,16m
4809,2,剑心,2494,1461,61,60,121,50.4%,1h
4809,2,冯文龙,2494,261,8,11,19,42.1%,9m
4809,2,夜凯丶,2494,194,5,9,14,35.7%,1h
4809,3,芒果,2494,0,2,5,7,28.6%,17m
4809,1,西伯利亚狼,2494,0,1,0,1,100.0%,17m
4814,3,Versuchen,2493,228,7,3,10,70.0%,44m
4814,3,XJK,2493,0,3,4,7,42.9%,1h
4814,3,走之底,2493,30,3,6,9,33.3%,6m
4814,3,hgfghgh,2493,95,2,0,2,100.0%,1h
4814,3,元首大人,2493,0,0,1,1,0.0%,1h
4819,3,啦啦啦,2492,166,6,5,11,54.5%,12m
4819,2,IIIIIIIIIII,2492,0,1,3,4,25.0%,52m
4821,3,毛伙伴,2491,292,11,7,18,61.1%,28m
4821,3,[GGWW]破灭的希望,2491,142,4,2,6,66.7%,1h
4823,3,Callow,2490,489,18,19,37,48.6%,1h
4823,1,[零点五个菜鸟]tossgirls,2490,328,17,20,37,45.9%,52m
4823,3,戏子,2490,197,11,8,19,57.9%,26m
4823,3,刺客,2490,30,2,5,7,28.6%,1h
4823,3,梅山宋仲基,2490,0,1,0,1,100.0%,21m
4823,3,胖子先生,2490,0,1,0,1,100.0%,45m
4829,3,你在干什么,2489,312,12,13,25,48.0%,54m
4829,3,[征服永无止尽]荒兽,2489,114,3,0,3,100.0%,1h
4829,1,EastViper,2489,0,2,4,6,33.3%,13m
4829,1,你真的超级好,2489,0,0,2,2,0.0%,19m
4833,3,[暴雪二十二队]小佳哥们,2488,796,40,35,75,53.3%,12m
4833,3,王德发之辱,2488,651,29,18,47,61.7%,34m
4833,1,天地人脉,2488,207,17,18,35,48.6%,29m
4833,3,[特工]繁简繁,2488,155,4,2,6,66.7%,1h
4833,3,乏善虚名,2488,131,3,8,11,27.3%,1h
4833,3,longwang,2488,0,1,0,1,100.0%,54m
4839,3,JACKHE,2487,1539,188,188,376,50.0%,34m
4839,3,[暗室逢灯]niconiconi,2487,511,25,21,46,54.3%,1h
4839,3,来我白给,2487,590,21,20,41,51.2%,54m
4839,3,[浙大战队]失去单身的幽忧,2487,207,8,2,10,80.0%,1h
4839,2,[时令]零时雨,2487,0,3,3,6,50.0%,1h
4839,2,Nob,2487,130,3,3,6,50.0%,1h
4839,1,jack,2487,48,2,5,7,28.6%,1h
4839,3,黑叔叔之王,2487,0,1,0,1,100.0%,32m
4839,1,pangou,2487,0,0,5,5,0.0%,1h
4848,1,[温柔兔公主]菜不是我的错,2486,766,68,54,122,55.7%,29m
4848,3,ZHB,2486,180,7,6,13,53.8%,1h
4848,1,凌邪丨,2486,0,2,2,4,50.0%,42m
4848,3,埃蒙,2486,0,1,0,1,100.0%,1h
4848,1,kirito,2486,0,1,4,5,20.0%,1h
4853,3,你看起来很好好吃,2485,345,14,17,31,45.2%,1h
4853,3,[云丿星]tegdsdw,2485,161,5,6,11,45.5%,12m
4853,3,神乐七奈,2485,0,1,0,1,100.0%,12m
4853,3,寒菁,2485,0,0,1,1,0.0%,36m
4853,3,[菜鸟的聚集地]Beach,2485,0,0,1,1,0.0%,45m
4858,3,[DSE]IIIIIIIIiI,2484,319,13,6,19,68.4%,50m
4858,1,[Miku骑士]Snowdrop,2484,0,5,1,6,83.3%,46m
4858,3,苗二狗,2484,0,3,7,10,30.0%,4m
4858,1,Architext,2484,0,1,1,2,50.0%,54m
4858,1,[养老]Sakura,2484,0,0,1,1,0.0%,1h
4863,3,杨蛤蜊,2483,165,7,5,12,58.3%,1h
4863,3,火炎之王,2483,60,2,5,7,28.6%,1h
4865,3,erww,2482,362,14,11,25,56.0%,60m
4865,1,zhaowenbosb,2482,316,11,15,26,42.3%,1h
4865,1,wangwangpeip,2482,168,6,3,9,66.7%,19m
4865,1,你的机枪兵,2482,0,2,4,6,33.3%,1h
4865,1,喜悦的源头,2482,0,0,1,1,0.0%,1h
4870,2,URWOOD,2481,827,180,179,359,50.1%,24m
4870,3,jimv,2481,330,11,15,26,42.3%,54m
4870,1,阿淇,2481,194,8,12,20,40.0%,14m
4870,1,[童话]梦中,2481,182,4,13,17,23.5%,1h
4870,3,[秋毫]迟来的缠,2481,0,0,1,1,0.0%,25m
4870,3,[我菜请打队友]攻破癌症,2481,0,0,1,1,0.0%,27m
4876,3,想不出来好名字,2480,1157,73,68,141,51.8%,10m
4876,3,[6G芯片研發]TonyStark,2480,159,5,7,12,41.7%,49m
4876,3,[Holygl]城北十里亭,2480,0,1,1,2,50.0%,25m
4879,1,卖鱼强蕉太郎,2479,0,2,5,7,28.6%,1h
4879,1,午时怎么还没到啊,2479,0,1,0,1,100.0%,1h
4879,3,[G868G]wryl,2479,30,1,2,3,33.3%,26m
4882,3,表情大师,2478,1049,247,262,509,48.5%,2m
4882,3,眉如远山,2478,527,74,71,145,51.0%,7m
4882,3,cityhunter,2478,695,27,28,55,49.1%,1h
4882,2,血之修罗,2478,301,10,11,21,47.6%,47m
4886,1,周司令,2477,174,7,4,11,63.6%,43m
4886,2,科比,2477,141,5,8,13,38.5%,1h
4888,1,[只想干神族]尼玛花园,2476,0,1,0,1,100.0%,1h
4888,1,兜兜,2476,0,0,5,5,0.0%,13m
4890,3,[喵蛋]羊在红尘,2475,421,16,21,37,43.2%,1h
4890,1,[ajxdo]BananaWrap,2475,144,2,13,15,13.3%,1h
4890,1,wwww,2475,0,1,0,1,100.0%,21m
4890,1,keanu,2475,0,0,2,2,0.0%,1h
4894,2,[ZSG]professorY,2474,267,12,14,26,46.2%,1h
4894,1,阳阳,2474,0,2,3,5,40.0%,1h
4894,1,托雷基亚,2474,44,1,1,2,50.0%,5m
4894,1,daodaodao,2474,0,0,1,1,0.0%,25m
4898,3,[NLYH]冰封王兽,2473,955,36,32,68,52.9%,1h
4898,1,[XSXT]Touch,2473,175,5,1,6,83.3%,1h
4898,3,鲨鱼辣椒,2473,0,1,4,5,20.0%,17m
4898,3,Evel,2473,0,0,1,1,0.0%,1h
4898,1,萌新威望肝出血,2473,0,0,1,1,0.0%,8m
4898,3,[ljk3]蝉颜,2473,0,0,1,1,0.0%,1h
4904,3,繁爷,2472,705,33,29,62,53.2%,33m
4904,1,Linger,2472,0,2,3,5,40.0%,1h
4904,1,还有谁,2472,97,1,1,2,50.0%,27m
4904,1,[NHSD]君莫笑,2472,0,0,2,2,0.0%,1h
4908,3,坎坎坷坷,2471,97,3,5,8,37.5%,13m
4908,3,joker,2471,0,1,0,1,100.0%,1h
4910,1,流星,2470,40,2,0,2,100.0%,1h
4911,1,风潇雨落,2469,315,10,16,26,38.5%,1h
4911,3,Sustain,2469,269,9,8,17,52.9%,16m
4911,1,[四叶草]俯首甘为孺子牛,2469,266,6,20,26,23.1%,1h
4911,2,木子山方,2469,131,4,9,13,30.8%,1h
4911,1,OneKey,2469,0,0,1,1,0.0%,40m
4916,1,KnightRL,2468,910,38,40,78,48.7%,40m
4916,3,天翼之影,2468,207,5,5,10,50.0%,1h
4916,2,[落魄山]manman,2468,94,4,8,12,33.3%,1h
4916,1,飞龙骑脸,2468,48,1,6,7,14.3%,1h
4916,1,[沙星部]sanzy,2468,0,0,1,1,0.0%,1h
4916,1,[无敌西瓜]小西瓜,2468,0,0,1,1,0.0%,39m
4922,3,MIN,2467,970,38,31,69,55.1%,32m
4922,3,长桥猎人,2467,520,36,32,68,52.9%,1h
4922,2,火雨,2467,553,22,22,44,50.0%,1h
4922,3,斯巴拉西,2467,276,10,5,15,66.7%,22m
4922,2,无敌小宝,2467,221,8,9,17,47.1%,23m
4922,1,敢采于部,2467,48,1,8,9,11.1%,21m
4928,1,willion,2466,475,125,119,244,51.2%,3m
4928,3,力量,2466,228,7,4,11,63.6%,1h
4928,2,Mark,2466,224,7,7,14,50.0%,22m
4928,3,wasly,2466,90,4,5,9,44.4%,17m
4928,1,[太微玉清宫]JHFDUF,2466,78,2,1,3,66.7%,8m
4928,1,恋爱达人七十六,2466,0,1,4,5,20.0%,1h
4934,3,同一个服,2465,986,37,40,77,48.1%,1h
4934,3,丿乐,2465,86,3,5,8,37.5%,25m
4934,3,小雨下大了,2465,0,0,2,2,0.0%,1h
4937,2,DarJumpKing,2464,753,30,43,73,41.1%,34m
4937,3,五月,2464,62,3,3,6,50.0%,21m
4937,1,Mars,2464,48,2,5,7,28.6%,46m
4937,3,[MeLo]MentalSick,2464,0,0,2,2,0.0%,1h
4941,2,[萌萌哒鸡]血骑,2463,1387,54,52,106,50.9%,34m
4941,1,Summermer,2463,276,7,3,10,70.0%,1h
4941,2,破碎的小明,2463,151,4,0,4,100.0%,32m
4941,1,明日之子,2463,130,3,4,7,42.9%,1h
4941,1,clownking,2463,0,2,3,5,40.0%,1h
4946,1,JustBecause,2461,1511,140,141,281,49.8%,53m
4946,3,RUUA,2461,606,34,25,59,57.6%,50m
4946,3,邪魔之神,2461,292,11,11,22,50.0%,22m
4946,3,min,2461,125,2,9,11,18.2%,1h
4950,3,韭菜收割机,2460,1591,336,344,680,49.4%,2m
4950,2,夜猫,2460,406,15,21,36,41.7%,39m
4950,1,Limbo,2460,0,3,2,5,60.0%,1h
4950,3,滑稽使者,2460,0,2,5,7,28.6%,6m
4950,1,king,2460,0,1,2,3,33.3%,54m
4955,3,[中老年交友群]Fullen,2459,1191,117,123,240,48.8%,14m
4955,2,QiuLin,2459,1358,87,89,176,49.4%,22m
4955,3,伊莉雅酱,2459,97,1,3,4,25.0%,1h
4955,1,觉得静静地,2459,0,1,4,5,20.0%,1h
4959,3,圣殿小夫,2457,846,72,70,142,50.7%,57m
4959,3,[DMR]亚里士没有德,2457,232,8,2,10,80.0%,1h
4959,1,拾柒丨钟情一生,2457,270,8,10,18,44.4%,1h
4962,2,[DC战队]MarineKingSY,2456,1010,147,153,300,49.0%,38m
4962,3,Smile,2456,268,12,16,28,42.9%,53m
4962,3,[6G芯片研發]开罗宣言,2456,121,3,1,4,75.0%,1h
4962,1,回眸往事丶叮叮,2456,0,0,1,1,0.0%,1h
4962,3,我能,2456,0,0,1,1,0.0%,20m
4967,2,名称未定,2455,166,6,5,11,54.5%,1h
4968,2,人机六号,2454,211,11,14,25,44.0%,20m
4968,3,[暴雪养鸡场]流氓,2454,311,10,10,20,50.0%,17m
4968,1,HoLLoWSTRING,2454,0,2,3,5,40.0%,30m
4968,3,TriStone,2454,0,1,0,1,100.0%,34m
4972,2,[旺旺战士]greatdino,2453,792,135,134,269,50.2%,24m
4972,3,孤独的狼,2453,745,28,30,58,48.3%,1h
4974,3,Joka,2452,198,6,9,15,40.0%,30m
4974,2,Chalk,2452,108,4,9,13,30.8%,1h
4974,1,虫群之主,2452,130,4,10,14,28.6%,55m
4974,2,丑的别致笨的灵巧,2452,0,0,1,1,0.0%,9m
4978,3,施暴者,2451,173,7,8,15,46.7%,57m
4978,3,阿天哥,2451,127,4,7,11,36.4%,28m
4978,3,爱玩游戏的达桑,2451,0,0,1,1,0.0%,5m
4981,3,[北极光小组]小怪,2450,448,13,28,41,31.7%,7m
4981,3,xsmart,2450,322,11,15,26,42.3%,43m
4981,1,[秋毫第五分队]幽冥流沙,2450,0,1,2,3,33.3%,12m
4984,1,[联合指挥区]Ares,2449,750,35,30,65,53.8%,25m
4984,3,南乡,2449,525,22,18,40,55.0%,3m
4984,3,暗裔蚊子,2449,122,7,11,18,38.9%,29m
4984,1,核动力小蜗牛,2449,0,1,4,5,20.0%,19m
4988,1,这里是少爷广场,2448,475,19,10,29,65.5%,25m
4988,3,[银河喵波隆]PicACG,2448,432,16,26,42,38.1%,33m
4988,2,驴毛,2448,186,5,12,17,29.4%,42m
4988,3,天马,2448,58,2,6,8,25.0%,17m
4992,1,佛眼看天,2447,156,4,1,5,80.0%,1h
4993,3,流浪汉,2446,751,33,26,59,55.9%,1h
4993,3,special,2446,0,1,1,2,50.0%,1h
4993,2,居情,2446,38,1,1,2,50.0%,1h
4996,2,玩随机的菜鸟,2445,1556,181,194,375,48.3%,27m
4997,3,RMB,2444,426,20,10,30,66.7%,3m
4997,3,FMbudan,2444,338,14,12,26,53.8%,1h
4997,1,[德哈卡神教]CONQUEROR,2444,162,5,3,8,62.5%,13m
4997,1,friday,2444,86,2,2,4,50.0%,1h
5001,1,jydd,2443,340,12,16,28,42.9%,1h
5001,3,[Legacy]DoBadTemper,2443,308,10,11,21,47.6%,55m
5001,3,[嘤嘤嘤啊]Face,2443,263,8,8,16,50.0%,32m
5001,3,冷酷无情,2443,150,7,8,15,46.7%,44m
5001,2,[古明地嗪]星际时光,2443,82,6,7,13,46.2%,1h
5001,1,[崔之公司超市]崔之,2443,84,3,3,6,50.0%,28m
5001,3,[头号玩家]虚空之眼,2443,111,2,5,7,28.6%,1h
5008,1,PJY,2442,1577,150,168,318,47.2%,30m
5008,1,请叫我爸爸丶,2442,784,25,19,44,56.8%,1h
5008,3,万恶之源,2442,490,21,16,37,56.8%,1h
5008,3,Moment,2442,222,9,7,16,56.2%,4m
5008,2,qiaoshen,2442,121,4,1,5,80.0%,56m
5008,1,夜半风华,2442,0,0,1,1,0.0%,1h
5008,1,[在下萌新一只]伤逝,2442,0,0,4,4,0.0%,1h
5015,1,[CNB]无色十二月,2441,286,7,8,15,46.7%,28m
5015,2,地狱裁决,2441,34,2,4,6,33.3%,9m
5015,1,[KPG]春风拂兰露华浓,2441,0,1,0,1,100.0%,1h
5018,2,[最强大佬]寒夜,2440,140,3,6,9,33.3%,23m
5019,3,never,2439,613,23,22,45,51.1%,57m
5019,1,自由之翼,2439,0,0,2,2,0.0%,1h
5021,1,魔域残梦,2438,30,4,8,12,33.3%,24m
5022,3,愤怒者,2437,1190,94,98,192,49.0%,1h
5022,1,村头一枝鸭,2437,134,6,8,14,42.9%,39m
5022,1,[积水潭]余连,2437,40,2,1,3,66.7%,39m
5022,1,呆呆家的小呆,2437,0,1,2,3,33.3%,50m
5026,1,雷厉风行,2436,520,20,9,29,69.0%,1h
5026,3,[社交学教授]赣州金涛,2436,347,13,11,24,54.2%,34m
5028,1,清酒染白衣,2435,1003,56,56,112,50.0%,13m
5028,3,慈眉善目,2435,300,9,15,24,37.5%,1h
5028,3,小好丶,2435,238,8,6,14,57.1%,1h
5028,3,余生,2435,121,3,7,10,30.0%,51m
5028,1,sjue,2435,44,1,4,5,20.0%,1h
5028,1,乱拳挥死老师傅,2435,0,0,1,1,0.0%,31m
5034,1,[葱芯]妖白,2434,254,7,1,8,87.5%,28m
5034,1,盖亚,2434,0,3,3,6,50.0%,2m
5034,2,[Pt小贴士]PuPuLAHa,2434,30,1,1,2,50.0%,17m
5037,1,dassd,2433,226,6,8,14,42.9%,7m
5037,2,史蒂夫,2433,0,0,1,1,0.0%,21m
5039,3,blackrose,2432,312,56,55,111,50.5%,20m
5039,3,蒸汽豆子,2432,694,54,55,109,49.5%,36m
5039,1,一权,2432,48,2,7,9,22.2%,1h
5039,1,[琴筝]没输过,2432,0,1,1,2,50.0%,45m
5039,1,[sc协会]慕周,2432,0,0,1,1,0.0%,1h
5044,1,杨先生生生生,2431,1737,78,76,154,50.6%,29m
5044,3,ltaaa,2431,373,13,16,29,44.8%,14m
5044,1,冰菓,2431,270,8,15,23,34.8%,4m
5044,3,风之幻想,2431,150,7,9,16,43.8%,32m
5044,1,moren,2431,34,2,1,3,66.7%,1h
5049,3,[tyyt]天依,2430,169,5,8,13,38.5%,1h
5049,1,一贱穿鸡,2430,0,0,1,1,0.0%,1h
5051,3,亚特兰帝斯,2429,882,36,39,75,48.0%,21m
5051,1,[鲜血蔷薇]人深,2429,0,1,0,1,100.0%,1h
5053,1,种树人,2428,466,13,7,20,65.0%,18m
5053,3,[仁者]飞鸟信,2428,303,13,11,24,54.2%,43m
5053,3,[汉堡FANS]常德郭富城,2428,32,3,7,10,30.0%,1h
5053,1,蓝魔,2428,0,2,3,5,40.0%,19m
5057,1,[六道]ENT,2427,116,4,1,5,80.0%,49m
5057,1,[中情局]llllllllllll,2427,94,2,2,4,50.0%,1h
5057,2,ambog,2427,0,1,4,5,20.0%,57m
5060,3,你杨嗲嗲,2426,727,83,74,157,52.9%,12m
5060,2,[文韬武略]sdhftuwy,2426,216,6,6,12,50.0%,1h
5060,1,海角,2426,42,1,1,2,50.0%,1h
5060,2,断潮,2426,0,1,4,5,20.0%,1h
5060,1,[江苏俱乐部]cxc,2426,0,0,2,2,0.0%,26m
5065,1,不水船,2425,1759,64,65,129,49.6%,5m
5065,1,不会打正面,2425,194,6,1,7,85.7%,1h
5065,3,爱笑的大哥哥,2425,149,4,7,11,36.4%,1h
5065,1,lxxgyw,2425,80,3,0,3,100.0%,1h
5069,2,[敢犯我河南者]部落的木木,2424,322,12,20,32,37.5%,14m
5069,1,Jormungandr,2424,336,11,5,16,68.8%,19m
5069,1,溯洄,2424,0,2,4,6,33.3%,16m
5069,2,[摸鱼探姬]爱衣丶休伯利安,2424,32,1,3,4,25.0%,5m
5073,1,深睡的方解石,2423,513,20,23,43,46.5%,1h
5073,1,躺赢少年,2423,405,17,17,34,50.0%,27m
5073,3,[BoA星际迷]急旋风,2423,490,17,23,40,42.5%,57m
5073,1,花落人败,2423,42,2,3,5,40.0%,1h
5077,3,[抽爷]我玩警戒者,2422,1018,110,115,225,48.9%,11m
5077,2,king,2422,708,110,115,225,48.9%,58m
5077,1,Musketeer,2422,118,4,1,5,80.0%,39m
5077,2,BAEBAE,2422,0,1,4,5,20.0%,1h
5081,3,[CPT]NASA,2421,388,14,20,34,41.2%,34m
5081,3,[透一下清酒]FNAFSL,2421,80,4,17,21,19.0%,1h
5081,1,鲍鱼蛋子君,2421,88,2,3,5,40.0%,16m
5081,3,[社交学大可爱]探姬遭到公鸡,2421,0,0,1,1,0.0%,5m
5085,3,sishen,2420,154,5,9,14,35.7%,52m
5085,2,castle,2420,0,4,5,9,44.4%,48m
5085,1,hhh,2420,0,1,1,2,50.0%,57m
5085,1,郝幸福,2420,0,0,1,1,0.0%,28m
5089,2,罔途,2419,175,7,10,17,41.2%,1h
5089,1,马尔泰若曦,2419,97,2,0,2,100.0%,1h
5089,1,[清华野大学]吴一凡,2419,0,1,5,6,16.7%,2m
5089,1,[酒池肉林]zbcsb,2419,0,0,1,1,0.0%,11m
5093,2,Vakys,2418,140,7,9,16,43.8%,2m
5093,1,[1葫芦娃1]NOKIA,2418,158,4,5,9,44.4%,1h
5095,1,[萌新萌新萌]YukikazeU,2417,1302,51,57,108,47.2%,53m
5095,2,[神奇的联萌]IIIIIIIIIIII,2417,225,7,2,9,77.8%,23m
5095,1,殇星,2417,0,1,2,3,33.3%,1h
5098,2,小达,2416,1311,622,660,1282,48.5%,56m
5098,2,快点飞啊,2416,1355,116,120,236,49.2%,58m
5098,1,艾尔之盾,2416,358,10,8,18,55.6%,16m
5098,3,恭喜见到爷,2416,123,3,5,8,37.5%,1h
5102,2,leopards,2415,1601,213,218,431,49.4%,1h
5102,1,[双刺]灵龟死不了,2415,122,3,2,5,60.0%,45m
5102,1,[给力嗷]zydbb,2415,97,1,1,2,50.0%,1h
5102,1,[明教]殇爱恋,2415,0,0,1,1,0.0%,10m
5106,2,观阴大湿,2414,400,23,23,46,50.0%,24m
5106,1,拉啊啦啦啦啦,2414,0,0,1,1,0.0%,28m
5108,1,[执行部专员]玛戈基丶贾德诺,2413,193,4,2,6,66.7%,21m
5109,1,发奋邱温泉莫芬,2412,319,13,16,29,44.8%,1h
5109,1,帅气的钻石,2412,0,1,1,2,50.0%,14m
5111,2,BackPacker,2411,622,21,30,51,41.2%,1h
5111,3,TheDayIDied,2411,224,8,11,19,42.1%,1h
5111,2,[综合酯法]东风快递,2411,0,4,1,5,80.0%,35m
5111,1,天涯霜雪霁寒宵,2411,82,2,2,4,50.0%,43m
5111,1,千级萌新坑死你,2411,0,1,0,1,100.0%,25m
5111,3,啵滴咚,2411,0,0,1,1,0.0%,1h
5111,1,天川可,2411,0,0,1,1,0.0%,2m
5111,2,内科大小学生,2411,0,0,1,1,0.0%,35m
5119,1,sssnnnn,2410,606,21,22,43,48.8%,13m
5119,3,[绝世高手]啊今天又帅了,2410,0,1,0,1,100.0%,4m
5121,1,熊爷,2409,437,22,9,31,71.0%,1h
5121,1,[CPT]泰晤斯古梅特,2409,470,16,18,34,47.1%,1h
5121,1,Mrgodlele,2409,202,7,5,12,58.3%,40m
5121,1,半城残雪,2409,0,1,0,1,100.0%,56m
5121,1,[SS天羽]天马流星拳,2409,0,1,1,2,50.0%,51m
5126,3,Kenxzn,2408,844,34,35,69,49.3%,32m
5126,1,天使情人,2408,977,32,36,68,47.1%,16m
5126,3,艾萨克,2408,146,4,2,6,66.7%,30m
5126,2,wero,2408,0,1,0,1,100.0%,1h
5126,2,战恶灬善,2408,0,0,1,1,0.0%,1h
5131,2,[长征小白]难兄难弟,2407,371,15,15,30,50.0%,1h
5132,2,[KNAT]zhegufly,2406,1216,46,53,99,46.5%,3m
5132,1,[无魂之鸭]齐峰大帅比,2406,731,23,24,47,48.9%,1h
5132,2,铜锣烧,2406,0,1,4,5,20.0%,4m
5132,2,杀我王虫跟你拼命,2406,0,0,1,1,0.0%,21m
5136,1,[TTZ]lddeck,2405,189,6,5,11,54.5%,1h
5136,1,宝箱头,2405,120,3,3,6,50.0%,13m
5136,1,[麻瓜菌团]whoyhey,2405,0,1,3,4,25.0%,57m
5136,1,[琴筝]阳阳嘿,2405,0,1,3,4,25.0%,42m
5140,3,西瓜点点,2404,414,23,27,50,46.0%,36m
5140,1,GoguoBor,2404,144,3,6,9,33.3%,20m
5140,2,孙墨轩,2404,0,1,4,5,20.0%,59m
5140,2,[吼吼吼]小郑,2404,0,0,1,1,0.0%,1h
5140,2,[湖面倒影]鉄柱大魔王,2404,0,0,1,1,0.0%,1h
5145,1,美食魔王,2403,44,1,2,3,33.3%,4m
5146,3,凝辰,2402,231,7,9,16,43.8%,1h
5146,2,[怪盗军团]至尊盗亡拉法姆,2402,0,3,2,5,60.0%,31m
5146,1,伪天使冷魅,2402,0,2,5,7,28.6%,1h
5149,1,基努里维斯,2401,414,14,13,27,51.9%,57m
5149,1,我爱昵,2401,262,7,8,15,46.7%,45m
5149,1,[小埋]阿曼达,2401,144,4,3,7,57.1%,8m
5149,2,星灵狂战士,2401,0,2,2,4,50.0%,37m
5149,3,Silicon,2401,0,1,0,1,100.0%,1h
5154,1,IIIIIIIIIIII,2400,1546,231,247,478,48.3%,36m
5154,2,XFC,2400,1492,219,220,439,49.9%,11m
5154,3,Frederic,2400,95,2,4,6,33.3%,15m
5154,1,祺瑞未央,2400,0,0,1,1,0.0%,7m
5158,1,江清月近人,2399,350,12,16,28,42.9%,7m
5158,2,常先生,2399,125,4,2,6,66.7%,30m
5160,1,[爽快]轩辕神健,2398,98,4,0,4,100.0%,1h
5161,1,zaruaku,2397,118,4,2,6,66.7%,1h
5161,1,[YINGJI]雄霸灬皇朝,2397,48,3,3,6,50.0%,27m
5163,2,[LOVEME]niuniu,2396,850,29,39,68,42.6%,1h
5163,1,聚少离多,2396,0,1,0,1,100.0%,56m
5165,1,醒目滴克星,2395,748,28,37,65,43.1%,40m
5165,2,艾尔之剑,2395,338,14,19,33,42.4%,44m
5165,1,ALTerNatIVe,2395,84,3,2,5,60.0%,31m
5165,2,游龙当归海,2395,48,3,3,6,50.0%,30m
5165,1,仙人掌,2395,96,2,5,7,28.6%,1h
5170,1,[牛TV]Artemis,2393,927,66,74,140,47.1%,49m
5171,1,RiderKick,2392,1302,48,48,96,50.0%,49m
5171,1,风之诺言,2392,891,31,33,64,48.4%,13m
5171,2,Chickabiddy,2392,220,8,12,20,40.0%,34m
5171,1,进晚我人,2392,82,3,3,6,50.0%,1h
5171,1,[蓝色丶德哈卡]雷霆万钧,2392,144,2,2,4,50.0%,46m
5176,3,[623拆迁队]紫阳花,2390,237,9,10,19,47.4%,34m
5176,1,有可能,2390,330,9,11,20,45.0%,28m
5176,1,meekiller,2390,94,4,6,10,40.0%,42m
5176,2,[飞云之上]伍六七,2390,108,3,2,5,60.0%,45m
5180,2,不要狗打运营,2389,1472,67,79,146,45.9%,25m
5180,1,[我是萌新Q]罪人,2389,200,6,4,10,60.0%,28m
5180,1,礻斤丶,2389,116,2,1,3,66.7%,8m
5180,3,泡泡糖,2389,0,1,2,3,33.3%,1h
5180,1,wing,2389,0,0,4,4,0.0%,1h
5185,1,[丨SLT丨]HowToWinZVT,2388,144,3,0,3,100.0%,1h
5186,1,[ToHo]丶只要你微笑,2387,404,12,8,20,60.0%,4m
5186,2,吴员外,2387,0,3,6,9,33.3%,30m
5186,2,龙翼,2387,0,0,1,1,0.0%,31m
5189,2,[慢手e族]JABARI,2386,418,16,21,37,43.2%,1h
5189,1,empty,2386,284,12,15,27,44.4%,4m
5189,2,陨龙,2386,0,3,1,4,75.0%,60m
5189,1,[A死你]小虾米,2386,97,3,4,7,42.9%,1h
5193,3,好好向前,2385,22,9,13,22,40.9%,6m
5193,3,泉河,2385,253,7,12,19,36.8%,1h
5195,1,[头号玩家]mengmeng,2384,769,26,23,49,53.1%,60m
5196,1,[雷本]无敌乐,2383,1312,289,295,584,49.5%,10m
5196,1,无畏要塞,2383,665,40,26,66,60.6%,57m
5196,2,隠繧,2383,520,19,29,48,39.6%,11m
5196,2,平常心,2383,315,14,9,23,60.9%,1h
5196,2,Sony,2383,0,0,1,1,0.0%,31m
5201,2,为宁静而守护,2382,1549,359,373,732,49.0%,1h
5201,3,[专治格种不服]computer,2382,139,4,7,11,36.4%,21m
5201,1,[热能]求败人皇,2382,42,1,2,3,33.3%,26m
5201,1,星空之萨尔那咖,2382,36,1,5,6,16.7%,1h
5201,2,生灵灭,2382,0,0,1,1,0.0%,31m
5201,1,[Gj]风花雪月,2382,0,0,1,1,0.0%,42m
5207,2,IIIIIIIIIIII,2381,48,4,2,6,66.7%,60m
5207,1,屈子,2381,0,3,3,6,50.0%,46m
5207,1,残阳下望着窗外,2381,0,2,5,7,28.6%,16m
5210,2,IIIIIIIIIIII,2380,0,0,5,5,0.0%,1h
5211,1,爱吃七岁的三岁,2379,96,1,2,3,33.3%,21m
5211,3,liget,2379,82,1,3,4,25.0%,13m
5211,2,[KORSC2]CvMAX,2379,0,1,4,5,20.0%,59m
5214,1,[VIC]shunshun,2378,0,1,0,1,100.0%,1h
5214,1,XYQ,2378,18,1,5,6,16.7%,13m
5216,1,隐秘之兽,2377,1602,66,52,118,55.9%,5m
5216,2,澐氺氷蘫,2377,305,13,18,31,41.9%,1h
5216,1,充气老爷们,2377,120,4,6,10,40.0%,50m
5219,3,skytemple,2376,148,5,11,16,31.2%,36m
5219,3,北河观真君,2376,0,2,6,8,25.0%,4m
5219,1,[秀气男孩]炮炮打在菌毯上,2376,0,0,1,1,0.0%,49m
5222,1,芬达和可乐,2375,190,5,10,15,33.3%,57m
5223,1,崇明,2374,1256,53,73,126,42.1%,1h
5223,1,贪狼星,2374,261,19,19,38,50.0%,1h
5223,1,陳老板,2374,97,2,5,7,28.6%,1h
5223,1,狍子吃栗子,2374,0,0,1,1,0.0%,1h
5227,1,[SlRIUS]YooNa,2373,0,1,0,1,100.0%,1h
5227,1,mrquin,2373,0,1,0,1,100.0%,58m
5229,1,执政官,2372,120,4,5,9,44.4%,11m
5230,1,小菜毛腿,2371,84,3,1,4,75.0%,10m
5231,1,俄是个系魔,2370,144,6,6,12,50.0%,1h
5231,1,[西中街小学]Terry,2370,236,6,7,13,46.2%,1h
5231,3,理想,2370,0,3,5,8,37.5%,20m
5234,3,形而上,2368,217,29,30,59,49.2%,26m
5234,1,[入侵地球]飞龙骑脸怎么输,2368,0,0,1,1,0.0%,1h
5236,1,Sapporo,2367,269,8,8,16,50.0%,5m
5236,2,鬼鸟,2367,0,3,2,5,60.0%,35m
5236,1,天才,2367,118,3,4,7,42.9%,29m
5239,1,[Rooter]Rottmayer,2366,866,138,145,283,48.8%,53m
5239,1,风折残灵,2366,940,30,30,60,50.0%,5m
5239,3,骑士魔王,2366,373,14,13,27,51.9%,1h
5239,3,[老头儿星际]歹徒,2366,275,11,11,22,50.0%,28m
5239,3,SnAKe,2366,0,1,4,5,20.0%,43m
5244,1,IIIIIIIIIIII,2365,316,9,13,22,40.9%,1h
5244,2,宫吧老哥狂喜,2365,0,1,2,3,33.3%,1h
5246,1,Lucifer,2364,1109,194,213,407,47.7%,45m
5246,1,权天,2364,1081,90,84,174,51.7%,28m
5246,1,BOSS,2364,1098,46,42,88,52.3%,1h
5246,1,[YMSB]三角队,2364,0,0,2,2,0.0%,1h
5250,1,[熊孩纸联盟]Knife,2363,580,16,15,31,51.6%,10m
5250,1,[小奶狼]我就叫夏洛啊,2363,88,2,4,6,33.3%,7m
5252,1,荣耀指引我,2362,349,12,11,23,52.2%,28m
5252,3,SenorAgustin,2362,232,8,9,17,47.1%,1h
5252,1,Azir,2362,82,2,3,5,40.0%,1h
5252,1,jinhao,2362,0,0,1,1,0.0%,58m
5256,1,我是的菜鸟,2361,160,3,2,5,60.0%,1h
5256,2,CAY,2361,0,1,4,5,20.0%,1h
5258,1,[化学工厂]tiger,2359,122,3,5,8,37.5%,7m
5259,1,文轩,2358,837,113,122,235,48.1%,7m
5259,1,[为欢几何]okc,2358,156,3,2,5,60.0%,56m
5259,1,苍颜轻尘,2358,97,2,6,8,25.0%,42m
5259,1,拗不过时光的荏苒,2358,0,0,1,1,0.0%,1h
5263,2,[Marisa]Ixxooxxooxxo,2357,0,0,1,1,0.0%,38m
5263,2,璨若太阳升朝霞,2357,0,0,3,3,0.0%,1h
5265,2,雾雨听雷,2356,333,12,21,33,36.4%,1h
5265,3,阿尔萨斯,2356,0,2,6,8,25.0%,1h
5265,2,shirosaki,2356,0,0,1,1,0.0%,5m
5268,1,咕噜咕噜鸡,2355,48,2,3,5,40.0%,30m
5268,2,[爱国]wangshi,2355,0,0,1,1,0.0%,1h
5270,1,BlueSteel,2354,140,4,7,11,36.4%,42m
5271,3,Roubin,2353,225,8,10,18,44.4%,1h
5272,1,萌萌萌萌萌萌萌新,2352,145,3,7,10,30.0%,2m
5273,1,寒兰,2351,1658,98,97,195,50.3%,1h
5273,1,[HQU战队]IIIIIIIIIIII,2351,482,17,17,34,50.0%,28m
5275,1,大罗金丹,2350,417,13,14,27,48.1%,18m
5275,1,chjegxun,2350,269,10,16,26,38.5%,1h
5275,1,[看星星咯]梦露,2350,139,3,5,8,37.5%,49m
5275,2,美丽的时光,2350,0,1,4,5,20.0%,57m
5279,1,[热能]www,2349,530,16,18,34,47.1%,1h
5279,1,jostar,2349,510,14,18,32,43.8%,28m
5279,1,Danny,2349,264,8,4,12,66.7%,1h
5279,1,[超实验级的]IIIIIIIIIIII,2349,250,7,13,20,35.0%,13m
5279,3,星际游侠,2349,97,1,1,2,50.0%,8m
5279,2,[圆滚滚的]Meow,2349,0,1,4,5,20.0%,1h
5285,1,Goodidea,2348,1750,484,524,1008,48.0%,31m
5285,2,小影,2348,94,5,6,11,45.5%,1h
5285,1,[鸡家军]CatalChao,2348,133,3,2,5,60.0%,29m
5285,1,[SFSF]比蒙巨兽,2348,0,1,2,3,33.3%,1h
5285,1,小黄贼啦菜,2348,0,1,5,6,16.7%,25m
5290,2,跳跳骑士,2347,0,2,3,5,40.0%,20m
5290,1,sddddddddddd,2347,0,1,0,1,100.0%,15m
5290,1,[星灵充电宝]大林,2347,0,1,2,3,33.3%,15m
5293,3,肾不亏,2346,1238,65,62,127,51.2%,1h
5293,1,水果太狂,2346,563,18,23,41,43.9%,1h
5293,1,不知道,2346,144,4,5,9,44.4%,39m
5296,3,[JuNN]透过窗帘摸叼叼,2345,0,2,7,9,22.2%,12m
5296,2,[丶BIG联盟]XUE,2345,0,0,13,13,0.0%,1h
5298,3,IIIIIIIIIIII,2344,535,26,34,60,43.3%,16m
5298,1,酥麻凤蝶,2344,261,5,4,9,55.6%,49m
5300,1,[miku守护]殇之恋,2343,454,20,26,46,43.5%,15m
5300,1,丶丶丶丶,2343,207,6,4,10,60.0%,1h
5300,1,扣扣大有,2343,96,2,6,8,25.0%,49m
5303,2,Mouse,2342,95,3,9,12,25.0%,1h
5304,2,烽火洋流,2341,0,3,3,6,50.0%,1h
5305,1,Kleman,2339,683,24,24,48,50.0%,1h
5305,3,泡椒楠楠,2339,140,4,8,12,33.3%,44m
5307,1,otherguy,2338,1558,82,82,164,50.0%,7m
5307,1,极品渣男,2338,1180,63,71,134,47.0%,45m
5307,1,[壹拉捌]fvck,2338,836,27,35,62,43.5%,56m
5307,3,落叶一随风,2338,464,15,20,35,42.9%,1h
5307,1,礼品卡为阿见,2338,268,8,7,15,53.3%,46m
5307,1,潘老爷,2338,96,2,6,8,25.0%,16m
5307,1,圣神龙皇,2338,0,1,0,1,100.0%,7m
5307,3,如梦似人间,2338,0,0,1,1,0.0%,6m
5315,2,[蘑菇]硬硬的蘑菇头,2337,1559,139,153,292,47.6%,38m
5315,1,[JFW]骑乘位,2337,1000,88,95,183,48.1%,26m
5315,1,Leopard,2337,840,34,29,63,54.0%,1h
5315,1,沐浴龙血,2337,522,18,20,38,47.4%,29m
5315,2,战影,2337,30,5,5,10,50.0%,25m
5315,1,TLgoest,2337,133,4,3,7,57.1%,1h
5321,1,[大洋彼岸团队]皇家胜利者方少云,2336,1128,107,107,214,50.0%,1h
5322,1,[笙风]柠檬橘子说拜拜,2335,1458,62,47,109,56.9%,1h
5322,3,阿斯塔罗特,2335,224,9,9,18,50.0%,4m
5322,1,渣渣张很努力啊,2335,0,1,0,1,100.0%,42m
5325,1,[大工ACM]DLUTZeratul,2334,388,13,14,27,48.1%,16m
5326,3,希尔伯特,2333,120,8,8,16,50.0%,20m
5327,1,秋沐苏,2332,184,6,13,19,31.6%,1h
5327,2,小兔叽,2332,0,1,4,5,20.0%,1h
5329,1,[暴雪三队]海军上将,2331,0,1,3,4,25.0%,50m
5330,1,NAPOLIYELLOW,2330,286,8,11,19,42.1%,39m
5330,2,拉菲尔,2330,0,0,1,1,0.0%,1h
5332,1,怀剑听雪,2329,956,39,39,78,50.0%,39m
5332,2,hui,2329,0,1,1,2,50.0%,1h
5334,3,快枪手莫得法克尔,2328,1527,173,182,355,48.7%,1h
5334,3,片甲不留,2328,278,10,17,27,37.0%,20m
5334,1,雨过无声,2328,0,0,2,2,0.0%,1h
5337,2,[Losers]惆怅啊惆怅,2327,0,3,2,5,60.0%,1h
5338,2,[visher]segarp,2326,0,0,1,1,0.0%,16m
5339,1,Ehud,2325,319,13,17,30,43.3%,1h
5339,1,HSS,2325,414,12,14,26,46.2%,15m
5339,1,aaaaee,2325,192,8,10,18,44.4%,43m
5339,1,丨丨丨,2325,68,5,5,10,50.0%,5m
5339,2,别打我好不好,2325,0,3,2,5,60.0%,34m
5339,1,嘟嘟,2325,0,1,1,2,50.0%,18m
5345,2,ghost,2324,62,4,10,14,28.6%,1h
5346,2,SSS,2323,245,7,12,19,36.8%,8m
5346,1,[天下无敌]巨木,2323,96,2,5,7,28.6%,4m
5348,1,[中华何平]夜行者,2322,1529,58,71,129,45.0%,1h
5348,1,[芭芭拉冲压]苍山雪,2322,1148,44,41,85,51.8%,25m
5348,1,[谁能教我做人]洗心革面重新做人,2322,130,2,4,6,33.3%,1h
5351,1,[破落的灵魂]画中梦生花,2321,662,20,20,40,50.0%,1h
5351,1,awei,2321,357,12,8,20,60.0%,1h
5351,3,鱼干干,2321,72,4,9,13,30.8%,56m
5354,1,老许要媳妇不要,2320,556,17,19,36,47.2%,1h
5354,2,Trap,2320,185,13,0,13,100.0%,1h
5354,3,Dio,2320,30,5,5,10,50.0%,1h
5354,1,菜鸟混星际,2320,144,3,1,4,75.0%,21m
5354,2,CzarTech,2320,0,0,2,2,0.0%,1h
5359,2,Austen,2319,1494,255,271,526,48.5%,1h
5359,2,银色重炮,2319,0,0,1,1,0.0%,1h
5359,2,风格国际,2319,0,0,1,1,0.0%,60m
5362,1,[Mentor]队友呢快救我,2318,649,24,29,53,45.3%,1h
5362,1,无畏冲锋,2318,299,13,10,23,56.5%,7m
5364,2,肆余,2317,0,1,5,6,16.7%,1h
5364,3,奶猺,2317,0,0,1,1,0.0%,13m
5366,1,暴躁的风,2316,711,30,20,50,60.0%,1h
5366,2,[上海大学]绝叫之锋,2316,34,1,1,2,50.0%,38m
5368,1,神小白,2315,757,28,19,47,59.6%,1h
5369,1,雨落倾城微微凉,2314,508,17,12,29,58.6%,57m
5369,3,DrakeVon,2314,403,16,20,36,44.4%,3m
5369,1,冬瓜灰灰,2314,242,7,6,13,53.8%,13m
5372,2,QSHAN,2313,0,3,3,6,50.0%,31m
5372,2,[红烛昏罗帐]风暴,2313,0,1,0,1,100.0%,1h
5372,2,锐不可当丶,2313,0,0,2,2,0.0%,1h
5375,1,IIIIIIIIIIII,2312,924,44,37,81,54.3%,1h
5375,1,[十字荆棘阁]镜心棱,2312,0,1,2,3,33.3%,13m
5375,2,[涉黑]大神,2312,0,1,3,4,25.0%,1h
5375,2,神之天骑士,2312,0,0,1,1,0.0%,1h
5379,2,eslks,2311,1585,141,147,288,49.0%,1h
5379,2,新手电脑,2311,0,1,1,2,50.0%,1h
5379,1,米斯特布鲁,2311,0,1,5,6,16.7%,46m
5382,3,呼唤你的人,2310,223,7,12,19,36.8%,12m
5382,1,贼阿扣,2310,193,4,8,12,33.3%,1h
5382,2,Cynicism,2310,0,3,2,5,60.0%,31m
5385,2,tiyeshise,2309,36,1,2,3,33.3%,1h
5385,1,Julix,2309,88,1,2,3,33.3%,1h
5387,2,你不会懂我,2308,46,2,1,3,66.7%,31m
5388,1,[暴雪养鸡场]在下王三岁,2306,553,22,16,38,57.9%,1h
5388,3,风几许,2306,444,16,27,43,37.2%,22m
5388,1,死神终结者,2306,182,6,8,14,42.9%,45m
5388,1,未来道具研究所,2306,240,6,12,18,33.3%,20m
5388,2,hoveyxu,2306,38,4,3,7,57.1%,16m
5388,1,[一波]qwer,2306,0,1,2,3,33.3%,1h
5394,1,Rampant,2305,1493,193,202,395,48.9%,12m
5394,3,INnovation,2305,121,3,0,3,100.0%,13m
5394,1,[慕灬小冷]DragonKING,2305,78,2,9,11,18.2%,16m
5397,1,HENRY,2304,652,23,24,47,48.9%,50m
5397,1,三个点,2304,141,5,6,11,45.5%,1h
5397,2,[CCTV]大杀特杀哈哈,2304,0,1,4,5,20.0%,31m
5397,3,羽兮,2304,97,1,4,5,20.0%,60m
5401,2,会飞的猪噜噜,2303,510,18,33,51,35.3%,54m
5401,2,[社交学巨可爱]只有影子,2303,0,1,4,5,20.0%,60m
5403,3,苜苜蓿蓿,2302,30,3,9,12,25.0%,32m
5404,2,啊呜,2301,1588,1021,1046,2067,49.4%,2m
5404,2,[星际同萌]随便,2301,30,2,1,3,66.7%,1h
5406,1,barley,2300,1486,74,69,143,51.7%,50m
5406,1,ATM,2300,187,4,8,12,33.3%,1h
5408,1,涵少,2299,202,6,7,13,46.2%,40m
5409,3,柿兵突击,2298,465,17,26,43,39.5%,1h
5409,3,黑翼,2298,218,7,11,18,38.9%,1h
5409,2,Drrey,2298,44,2,5,7,28.6%,21m
5409,2,世界的繁华,2298,36,1,1,2,50.0%,25m
5413,2,醉丶宠珊,2297,1576,71,69,140,50.7%,38m
5413,1,Jiao,2297,384,20,20,40,50.0%,24m
5413,2,鲸落南北,2297,254,8,11,19,42.1%,23m
5413,2,[败给小队]团不过,2297,88,1,1,2,50.0%,1h
5417,3,llllllllllll,2296,1543,450,483,933,48.2%,1h
5417,3,战火风飞,2296,1532,164,173,337,48.7%,3m
5417,3,软饭硬吃曹达华,2296,261,10,13,23,43.5%,51m
5417,2,猎魔蝎,2296,62,3,0,3,100.0%,1h
5421,3,嘿夕彤,2295,241,8,11,19,42.1%,1h
5422,3,天纵,2293,233,8,11,19,42.1%,5m
5423,1,OnePower,2292,643,29,24,53,54.7%,39m
5423,1,laiyuyuyu,2292,190,5,6,11,45.5%,1h
5423,2,黑眼餖餖,2292,88,4,1,5,80.0%,5m
5426,1,[EjL]星星,2291,40,2,5,7,28.6%,1h
5426,1,[HIT]Supertairio,2291,0,0,2,2,0.0%,16m
5428,1,南有乔木,2290,1638,167,181,348,48.0%,1h
5428,1,塞缪尔白白,2290,245,12,15,27,44.4%,43m
5428,1,南京小马哥,2290,289,8,9,17,47.1%,49m
5428,2,[24K纯萌]龙龙,2290,250,8,25,33,24.2%,27m
5428,1,白虎杰米杨,2290,96,3,2,5,60.0%,15m
5428,2,[XXHZ20]一目意山河,2290,100,3,5,8,37.5%,1h
5428,2,新梦大狼,2290,0,1,4,5,20.0%,31m
5435,1,新手求虐,2289,48,1,3,4,25.0%,1h
5436,2,[戏命大魔王]ShriaZzz,2288,497,32,15,47,68.1%,27m
5437,3,bldg,2287,1449,271,302,573,47.3%,1h
5437,1,孙一楠,2287,160,5,12,17,29.4%,60m
5437,2,伊斯利,2287,0,2,3,5,40.0%,48m
5437,2,dfsd,2287,0,0,2,2,0.0%,1h
5441,1,古越少年,2286,684,20,26,46,43.5%,39m
5441,1,其米昂,2286,450,17,22,39,43.6%,1h
5441,2,[大青铜小联盟]巧克力威化饼干,2286,68,3,1,4,75.0%,5m
5444,1,[丰县一霸]应天的梦,2285,845,37,42,79,46.8%,50m
5445,3,谢谢合作,2284,293,9,14,23,39.1%,46m
5446,1,[NewV]君临黑帝,2283,1528,66,70,136,48.5%,35m
5446,3,世界的和平,2283,146,4,3,7,57.1%,28m
5446,2,lzr,2283,42,2,5,7,28.6%,31m
5446,2,LOS,2283,45,1,2,3,33.3%,1h
5446,1,lllllllllll,2283,96,1,8,9,11.1%,1h
5451,2,yycx,2282,452,16,13,29,55.2%,45m
5451,2,Vertigo,2282,0,1,4,5,20.0%,38m
5451,2,[新手保护协会]IlluSioN,2282,0,0,1,1,0.0%,1h
5454,2,一十七,2281,464,54,64,118,45.8%,42m
5454,2,奶思的杰克,2281,142,5,3,8,62.5%,5m
5454,1,[公子世无双]浅幕之年我定逆天,2281,0,0,3,3,0.0%,1h
5457,1,瑞士短毛猫,2280,0,2,5,7,28.6%,42m
5457,2,天命皇权,2280,0,0,5,5,0.0%,31m
5459,1,阿斯巴甜,2279,1058,55,55,110,50.0%,1h
5459,1,Destroy,2279,318,13,10,23,56.5%,4m
5459,1,娱乐哥哥,2279,0,0,2,2,0.0%,1h
5462,1,[第二驱逐鑑隊]小郭,2278,1672,96,103,199,48.2%,28m
5462,1,旷世灬,2278,135,19,16,35,54.3%,11m
5462,2,木鱼儿,2278,0,3,3,6,50.0%,1h
5462,2,rtwe,2278,0,0,2,2,0.0%,60m
5466,1,天才,2277,357,13,13,26,50.0%,60m
5466,1,[喵帕斯喵]AstroPU,2277,273,7,10,17,41.2%,11m
5466,2,[旺旺战士]长门战列舰,2277,152,6,3,9,66.7%,5m
5469,1,伪战士,2276,1294,122,123,245,49.8%,15m
5469,1,[舰队已抵达]小小害,2276,436,14,21,35,40.0%,1h
5469,2,[SSSSS]龙傲天,2276,0,2,3,5,40.0%,31m
5469,2,阿勒呼和,2276,0,0,2,2,0.0%,1h
5473,2,[大爱星际二]我是你也八,2275,48,1,3,4,25.0%,1h
5473,2,口腔的溃疡,2275,0,0,1,1,0.0%,1h
5473,1,张洪民,2275,0,0,4,4,0.0%,1h
5476,3,amaZingCaT,2272,1566,365,388,753,48.5%,37m
5476,3,小金人,2272,1562,246,259,505,48.7%,34m
5476,1,iiiiiiiiiiii,2272,488,18,17,35,51.4%,29m
5476,2,martin,2272,190,7,6,13,53.8%,38m
5476,2,gfhshfjg,2272,0,1,0,1,100.0%,1h
5481,1,阿鲁方索,2270,444,15,20,35,42.9%,1h
5481,3,[温柔兔公主]曲无忆,2270,182,8,11,19,42.1%,49m
5481,1,此生绝非打工人,2270,288,7,11,18,38.9%,11m
5481,2,咕叽咕叽,2270,112,4,3,7,57.1%,1h
5481,2,[镜花水月]枫叶,2270,36,1,1,2,50.0%,1h
5481,2,轩辕,2270,36,1,2,3,33.3%,1h
5487,1,心语星愿,2269,1587,99,105,204,48.5%,1h
5487,2,一个人,2269,126,4,2,6,66.7%,1h
5489,1,我大哥是孙一峰,2268,1563,120,145,265,45.3%,46m
5489,2,一走一婷,2268,0,4,1,5,80.0%,16m
5491,2,寡妇雷,2267,273,16,11,27,59.3%,38m
5491,2,起名什么的最烦了,2267,283,9,16,25,36.0%,1h
5491,2,leon,2267,0,1,1,2,50.0%,1h
5491,2,岗壁羊,2267,0,0,1,1,0.0%,1h
5491,1,海哥,2267,0,0,2,2,0.0%,46m
5496,2,我是新手,2266,166,8,12,20,40.0%,20m
5496,2,[传说萌娘团]星际之龙,2266,58,2,1,3,66.7%,1h
5498,1,战痘到底,2265,0,0,3,3,0.0%,1h
5499,2,gasga,2264,464,23,16,39,59.0%,1h
5499,2,LansloT,2264,304,10,11,21,47.6%,1h
5499,2,[社交学讲师]千羽,2264,48,1,3,4,25.0%,60m
5502,1,llllll,2262,1678,64,61,125,51.2%,11m
5502,2,上杉绘梨衣,2262,0,3,2,5,60.0%,16m
5502,2,猫黑,2262,0,1,0,1,100.0%,4m
5502,2,[Shawk]arwen,2262,0,1,2,3,33.3%,1h
5506,1,Laoyuuuuu,2261,568,66,71,137,48.2%,22m
5506,1,耶稣,2261,1344,61,60,121,50.4%,1h
5506,2,GzVan,2261,30,1,1,2,50.0%,1h
5509,2,星灵之遗,2260,1452,98,109,207,47.3%,48m
5509,1,[XXHZN3]遥远的桥,2260,0,0,4,4,0.0%,40m
5511,1,Embers,2259,170,4,6,10,40.0%,43m
5511,2,[我们是弟弟]开胃小菜,2259,0,0,2,2,0.0%,1h
5511,2,全民祸害,2259,0,0,5,5,0.0%,43m
5514,1,zxcvb,2258,1702,232,255,487,47.6%,29m
5514,2,[葫芦娃救艾尔]WRNDG,2258,678,30,31,61,49.2%,53m
5516,2,孙天我能让你,2257,102,4,4,8,50.0%,45m
5517,3,我的柴油,2256,1546,206,217,423,48.7%,36m
5517,1,EASYpeazzzyy,2256,657,21,29,50,42.0%,11m
5517,2,虎牙奶兔,2256,0,0,1,1,0.0%,31m
5517,1,吾本爱媚,2256,0,0,4,4,0.0%,1h
5521,1,ptu,2255,1394,46,55,101,45.5%,26m
5521,2,[清华大学战队]七九,2255,242,9,3,12,75.0%,1h
5523,2,御文阁阁主,2254,281,9,6,15,60.0%,1h
5523,2,云书雾廖,2254,0,3,2,5,60.0%,35m
5523,2,HelloStar,2254,0,3,3,6,50.0%,23m
5526,2,IIIIIIIIII,2253,0,1,0,1,100.0%,1h
5526,2,我爱你,2253,0,0,5,5,0.0%,20m
5528,2,大帥,2252,108,4,5,9,44.4%,1h
5528,2,战门,2252,30,1,1,2,50.0%,1h
5528,2,不可能打一波的,2252,0,1,3,4,25.0%,60m
5528,2,嗯哼,2252,0,1,4,5,20.0%,1h
5532,1,糖果屋,2251,0,0,1,1,0.0%,1h
5533,1,眞露,2249,1617,310,329,639,48.5%,1h
5533,2,[暗黑破坏神3]大灰狼来了,2249,304,11,9,20,55.0%,45m
5533,3,VENNLIZST,2249,180,8,14,22,36.4%,30m
5533,2,小学神,2249,0,0,1,1,0.0%,1h
5537,2,[小阿giao]无限虫群,2248,233,11,13,24,45.8%,5m
5538,1,祁轩铭,2247,806,27,29,56,48.2%,1h
5538,2,[有杀气童话]可恨的棒老三,2247,168,6,10,16,37.5%,38m
5538,2,[浦大]KeeLimoon,2247,0,1,0,1,100.0%,54m
5538,2,[白丝萝莉协会]孤岛,2247,32,1,3,4,25.0%,54m
5542,2,只会流氓舰队啊,2246,859,29,39,68,42.6%,1h
5543,1,天雅,2245,1581,76,79,155,49.0%,16m
5543,1,钓鱼者,2245,913,37,31,68,54.4%,5m
5543,2,金的虎,2245,60,3,1,4,75.0%,1h
5543,2,TONY,2245,0,0,1,1,0.0%,1h
5547,2,stormfire,2243,199,7,11,18,38.9%,1h
5547,1,Fate,2243,0,0,1,1,0.0%,1h
5547,1,Artaher,2243,0,0,3,3,0.0%,16m
5550,2,Ivan,2241,156,3,2,5,60.0%,59m
5550,2,readers,2241,0,0,1,1,0.0%,25m
5550,1,sdy,2241,73,0,9,9,0.0%,57m
5553,2,排骨饭,2240,579,37,30,67,55.2%,1h
5553,2,[传奇人物]Ewiglicht,2240,709,29,16,45,64.4%,1h
5553,2,[峰吹起了过去]星际启示者,2240,0,1,2,3,33.3%,22m
5556,1,嬴胖子,2239,416,12,16,28,42.9%,1h
5556,2,boo,2239,0,3,3,6,50.0%,20m
5556,2,Icclin,2239,0,1,1,2,50.0%,21m
5559,1,爆三样,2238,832,30,30,60,50.0%,1h
5560,1,越狱,2237,664,20,29,49,40.8%,1h
5560,1,[风之灵]小龙,2237,169,6,6,12,50.0%,12m
5560,2,泪落知秋,2237,0,0,1,1,0.0%,1h
5563,3,[Tmtj]feixingqis,2236,1076,38,51,89,42.7%,1h
5564,2,千万欲火难退身,2235,93,1,5,6,16.7%,1h
5565,2,SCBOY,2234,0,2,4,6,33.3%,1h
5566,2,[暴打假萌新]zheng,2233,0,1,4,5,20.0%,1h
5567,3,家有娇妻,2232,175,7,11,18,38.9%,12m
5568,1,玫瑰之宽恕,2231,944,62,58,120,51.7%,60m
5568,2,[尤摩扬护国队]Alarak,2231,539,17,25,42,40.5%,22m
5568,1,哈哈你猜我是吹,2231,455,15,13,28,53.6%,1h
5568,2,jehtro,2231,440,12,17,29,41.4%,53m
5568,2,[黑鲨]苏子莫邪,2231,224,8,7,15,53.3%,25m
5573,1,globle,2230,1099,57,61,118,48.3%,11m
5573,2,请叫我可怜的埃蒙,2230,0,1,3,4,25.0%,2m
5575,1,玄冥级战列巡洋舰,2229,1605,87,95,182,47.8%,56m
5575,2,一只白狐狸,2229,84,2,4,6,33.3%,9m
5577,2,全自动上海人小黄,2228,282,10,12,22,45.5%,41m
5577,3,YANyous,2228,145,3,9,12,25.0%,1h
5577,1,[无限圣堂]卡卡西,2228,94,3,12,15,20.0%,1h
5580,1,本人素质极差,2227,883,31,37,68,45.6%,13m
5580,1,我是彩笔的小行家,2227,145,4,7,11,36.4%,46m
5580,1,余大人,2227,96,3,5,8,37.5%,26m
5580,2,[Cuv]aaaa,2227,48,2,2,4,50.0%,31m
5584,3,[夕日坂]艾莉希尔,2226,97,1,1,2,50.0%,12m
5584,2,[GalArC]永远的巫女,2226,0,0,1,1,0.0%,4m
5586,2,looool,2225,126,3,2,5,60.0%,1h
5586,2,[Genius]枫洛夏,2225,173,3,8,11,27.3%,1h
5586,2,蛊惑翔,2225,0,1,0,1,100.0%,1h
5589,1,樱田妮妮,2224,1666,1567,1619,3186,49.2%,1h
5590,2,冰封之星,2223,434,14,24,38,36.8%,41m
5590,2,IIIIIIIIIIII,2223,290,12,11,23,52.2%,54m
5592,2,饭团子,2221,46,3,5,8,37.5%,16m
5592,2,只会苟,2221,112,2,2,4,50.0%,8m
5594,1,MRDJANGO,2220,818,31,30,61,50.8%,26m
5594,2,jasn,2220,583,21,20,41,51.2%,32m
5594,2,我要瓦斯,2220,46,1,4,5,20.0%,1h
5597,2,aaaaaaa,2219,118,14,14,28,50.0%,1h
5597,2,Gerry,2219,58,3,1,4,75.0%,54m
5599,2,[只为更强]生存的理由,2218,0,1,0,1,100.0%,5m
5600,3,我很温柔的,2217,1612,143,153,296,48.3%,20m
5601,2,药水哥,2216,617,22,30,52,42.3%,15m
5601,3,烦恼的成长,2216,0,1,0,1,100.0%,1h
5601,2,sadfdsdfasfg,2216,0,1,4,5,20.0%,34m
5601,2,第五屠皇,2216,0,1,5,6,16.7%,16m
5605,3,EASYgoing,2215,309,13,18,31,41.9%,1h
5606,2,[社交学教练]克尼马,2214,90,6,4,10,60.0%,59m
5606,2,彬少,2214,32,2,4,6,33.3%,1h
5606,2,小魔王,2214,105,2,6,8,25.0%,1h
5609,2,电脑,2213,46,2,6,8,25.0%,31m
5609,2,白木浮生,2213,30,1,5,6,16.7%,34m
5611,1,[自沉西湖底]教父又遇刺了,2211,1537,56,63,119,47.1%,1h
5611,2,[华夏何平]木头人,2211,168,9,15,24,37.5%,30m
5611,2,无为而治,2211,166,4,3,7,57.1%,1h
5611,2,StarWing,2211,0,0,1,1,0.0%,20m
5615,1,dragoonzheng,2208,791,90,90,180,50.0%,39m
5615,2,打死不投降,2208,887,38,24,62,61.3%,1h
5617,1,Eos,2207,1336,60,58,118,50.8%,1h
5618,2,GGKING,2206,92,3,8,11,27.3%,31m
5619,2,Humphry,2205,60,3,13,16,18.8%,1h
5620,2,猪猪兰,2204,854,36,40,76,47.4%,1h
5620,3,[迷宫丨极限组]十一,2204,0,3,2,5,60.0%,1h
5622,1,[不要你觉得]我要我觉得,2203,1565,188,186,374,50.3%,29m
5622,2,GDXJ,2203,0,0,1,1,0.0%,57m
5622,2,克哈,2203,0,0,2,2,0.0%,1h
5625,1,王亦轩,2202,0,0,1,1,0.0%,1h
5626,2,在此之间,2201,164,4,2,6,66.7%,43m
5626,2,Lion,2201,122,3,2,5,60.0%,1h
5626,2,菜鸟,2201,97,1,1,2,50.0%,1h
5629,2,神不在的星期天,2200,208,10,6,16,62.5%,1h
5630,1,SUUO,2199,197,5,12,17,29.4%,31m
5631,1,吃素的蚊子,2198,766,120,128,248,48.4%,1h
5631,1,李梓涵,2198,1085,70,68,138,50.7%,39m
5631,1,没有理智的博士,2198,464,17,23,40,42.5%,1h
5631,2,大虫贼,2198,88,1,1,2,50.0%,1h
5635,3,Innovation,2197,0,2,3,5,40.0%,1h
5636,2,干脆面,2196,162,5,3,8,62.5%,9m
5636,2,teys,2196,0,1,4,5,20.0%,1h
5638,1,IIIIIIIIIII,2194,1672,906,997,1903,47.6%,1h
5638,1,丁妮格菲儿,2194,1647,168,161,329,51.1%,49m
5640,3,君莫笑,2193,775,35,45,80,43.8%,50m
5641,2,[柠檬保护协会]斗鱼狼轩,2192,192,5,6,11,45.5%,8m
5641,1,treflip,2192,48,2,10,12,16.7%,16m
5643,1,Sickle,2191,1318,132,146,278,47.5%,1h
5643,2,iukonrfer,2191,112,2,2,4,50.0%,45m
5643,3,baofushehui,2191,0,0,3,3,0.0%,1h
5646,2,chuzer,2190,965,35,35,70,50.0%,1h
5647,2,浩哥,2189,0,0,2,2,0.0%,1h
5648,1,hfchengxx,2188,781,25,36,61,41.0%,1h
5649,2,WID,2187,722,42,45,87,48.3%,1h
5649,2,慕尘,2187,119,4,2,6,66.7%,5m
5651,1,菜鸡,2186,1663,369,396,765,48.2%,49m
5651,1,初末缪流年,2186,97,2,4,6,33.3%,15m
5651,2,猥琐达人,2186,0,1,0,1,100.0%,31m
5651,2,sohol,2186,0,1,6,7,14.3%,1h
5655,1,[代睡别人老公]宋哈娜,2185,1119,43,49,92,46.7%,29m
5655,3,战斗弱鸡,2185,192,6,3,9,66.7%,12m
5655,2,JOJOFANSEN,2185,251,6,9,15,40.0%,4m
5655,3,[柑橘之息]白上吹雪,2185,0,2,3,5,40.0%,56m
5655,1,ssw,2185,0,0,1,1,0.0%,15m
5660,3,哥哥是神,2184,90,4,2,6,66.7%,1h
5660,2,TSG,2184,90,3,6,9,33.3%,1h
5662,1,谁家的那小谁,2182,165,4,2,6,66.7%,26m
5662,2,猫转转阿爸,2182,107,4,4,8,50.0%,35m
5662,3,锋宝宝,2182,30,2,0,2,100.0%,49m
5665,3,红尘入梦邀故人,2181,342,14,11,25,56.0%,41m
5665,2,天下武功出混元,2181,30,2,1,3,66.7%,1h
5665,2,夏小白,2181,30,2,3,5,40.0%,1h
5665,2,破晓,2181,0,0,1,1,0.0%,1h
5669,2,为了自由,2179,70,5,5,10,50.0%,60m
5669,1,稚气老妈,2179,30,3,7,10,30.0%,43m
5671,2,xiaoyao,2177,0,0,2,2,0.0%,20m
5672,2,[琴筝]Shidi,2176,494,24,21,45,53.3%,1h
5672,1,Cinlink,2176,215,5,7,12,41.7%,11m
5672,3,花落情未断,2176,0,3,2,5,60.0%,41m
5675,2,巧克力橙子,2175,30,1,3,4,25.0%,17m
5676,2,汪汪先生,2173,1167,52,66,118,44.1%,1h
5676,2,MRKAML,2173,380,15,10,25,60.0%,1h
5676,2,micha,2173,44,2,3,5,40.0%,1h
5676,2,[HugeT]梦里千寻,2173,0,0,3,3,0.0%,9m
5680,2,虫群速度虫群规模,2171,0,2,3,5,40.0%,59m
5681,2,PPan,2170,364,13,19,32,40.6%,1h
5681,3,迷你之刃,2170,0,0,1,1,0.0%,1h
5683,2,对面没有妈,2169,599,22,23,45,48.9%,1h
5684,1,白色铃木,2168,981,81,86,167,48.5%,8m
5684,1,Adogen,2168,900,42,52,94,44.7%,28m
5684,3,drem,2168,0,3,2,5,60.0%,1h
5684,2,敬汝一壶酒,2168,123,2,7,9,22.2%,21m
5688,1,闲散惯了,2167,48,2,3,5,40.0%,1h
5689,2,战神罗米,2164,1335,57,50,107,53.3%,1h
5690,3,淦淦,2163,197,6,14,20,30.0%,20m
5690,2,sbk,2163,44,2,7,9,22.2%,1h
5692,2,ADTO,2162,517,19,20,39,48.7%,1h
5693,2,alexguo,2161,464,19,16,35,54.3%,5m
5694,2,战役,2160,756,47,50,97,48.5%,17m
5694,2,天飘板,2160,38,2,0,2,100.0%,57m
5696,1,[NLHR]落日余晖,2159,702,140,145,285,49.1%,31m
5696,2,虫王重生,2159,314,11,14,25,44.0%,1h
5696,3,[合作组合大队]非常六,2159,0,1,0,1,100.0%,13m
5699,3,王者归来,2158,468,16,16,32,50.0%,1h
5700,3,暗贱,2157,0,0,1,1,0.0%,1h
5701,2,哈哈哈哈,2156,0,1,1,2,50.0%,1h
5702,3,BigTT,2155,40,2,6,8,25.0%,57m
5703,3,[极限菜鸟]dawn,2154,171,5,3,8,62.5%,51m
5704,2,WDD,2153,570,21,26,47,44.7%,32m
5704,2,纯禽小畜女,2153,40,4,4,8,50.0%,59m
5704,1,按错机甲的维京,2153,46,1,3,4,25.0%,1h
5704,2,壮熊基佬,2153,0,0,1,1,0.0%,1h
5708,3,星光璀璨,2152,1603,143,169,312,45.8%,57m
5708,1,[大乔无惨]gunima,2152,1384,94,97,191,49.2%,24m
5708,2,[非一般的帅]vagary,2152,238,9,6,15,60.0%,1h
5711,2,[杀戮team]StarDiablo,2151,384,14,17,31,45.2%,53m
5711,2,野猪爱星灵,2151,0,2,1,3,66.7%,38m
5711,2,ling,2151,48,1,1,2,50.0%,35m
5714,3,[咏春]枪兵王,2150,0,0,1,1,0.0%,6m
5715,2,神奇老黄,2149,363,16,12,28,57.1%,1h
5715,3,[2B青年]huke,2149,86,4,4,8,50.0%,1h
5715,3,[绝世之神帝]傲世丶霸皇之剑圣,2149,0,0,1,1,0.0%,1h
5718,3,一只羊小咩,2148,0,0,1,1,0.0%,28m
5718,3,NPCjunyu,2148,0,0,1,1,0.0%,1h
5720,3,深沟之火,2146,0,0,1,1,0.0%,1h
5720,3,绝地武士,2146,0,0,5,5,0.0%,4m
5722,1,Jes,2145,343,80,82,162,49.4%,5m
5722,3,军师,2145,225,7,9,16,43.8%,5m
5724,2,水墨丹青,2144,112,2,5,7,28.6%,6m
5725,2,喜洋洋,2143,304,12,15,27,44.4%,1h
5726,1,自由之刃,2142,754,200,225,425,47.1%,1h
5726,1,张领导,2142,0,1,1,2,50.0%,20m
5728,2,Sincere,2141,240,9,8,17,52.9%,1h
5728,3,toobemore,2141,0,0,5,5,0.0%,10m
5730,2,梦魇之牙,2140,636,25,29,54,46.3%,1h
5730,3,[雷霆半月斩]天天,2140,186,14,15,29,48.3%,20m
5730,2,唯玮到来,2140,347,13,19,32,40.6%,10m
5730,2,篮坛权志龙,2140,156,3,8,11,27.3%,31m
5730,3,蜡笔小新,2140,0,0,3,3,0.0%,32m
5735,2,套马的汉子,2139,330,21,23,44,47.7%,1h
5735,2,Marrk,2139,134,5,1,6,83.3%,1h
5735,3,眼前人,2139,0,0,5,5,0.0%,1h
5738,3,Teacap,2138,0,0,1,1,0.0%,57m
5738,3,狗狗,2138,0,0,5,5,0.0%,1h
5740,1,anizerf,2137,1431,63,66,129,48.8%,26m
5741,2,[ANNEX]我家坦克能对空,2136,1537,72,63,135,53.3%,1h
5741,3,瓜皮哦,2136,0,0,1,1,0.0%,10m
5743,1,寂寞惹的祸,2135,1380,91,93,184,49.5%,45m
5743,3,无名法老王,2135,375,28,26,54,51.9%,26m
5743,1,手残还想玩虫族,2135,486,17,28,45,37.8%,1h
5746,2,Zerlinda,2134,486,16,26,42,38.1%,54m
5746,3,机械之咒,2134,0,3,3,6,50.0%,56m
5746,3,[花店]神王,2134,0,2,3,5,40.0%,56m
5746,2,BSM,2134,0,0,1,1,0.0%,16m
5750,1,兰亭已矣,2133,190,4,7,11,36.4%,1h
5750,3,生存,2133,30,2,0,2,100.0%,1h
5752,2,[刘相天]一只菜鸡,2132,971,180,193,373,48.3%,5m
5753,3,IIIIIIIIIIII,2131,120,5,4,9,55.6%,5m
5753,3,我可以自己爬的,2131,30,1,3,4,25.0%,32m
5755,2,[休闲养老]天空之怒,2130,0,0,1,1,0.0%,31m
5756,3,一只萌新,2129,301,13,8,21,61.9%,20m
5756,1,不造防空死全家,2129,303,9,23,32,28.1%,1h
5756,1,小辉辉,2129,138,4,3,7,57.1%,20m
5759,2,九个太阳,2128,853,38,42,80,47.5%,38m
5759,2,[久美子足浴城]破界神尊,2128,777,33,28,61,54.1%,54m
5759,2,中野三玖,2128,0,1,7,8,12.5%,21m
5762,1,很难赢一把,2127,713,117,125,242,48.3%,1h
5763,2,听风,2126,0,0,4,4,0.0%,25m
5764,2,二大爷和狗,2125,1014,48,53,101,47.5%,10m
5765,2,king,2124,570,19,25,44,43.2%,5m
5765,2,[玖天揽玥]hyc,2124,91,2,0,2,100.0%,1h
5765,3,[暴雪养鸡场]老年人休闲星际,2124,0,1,0,1,100.0%,27m
5765,3,[琴筝]笛卡尔,2124,18,1,3,4,25.0%,1h
5769,3,[星际拓荒者]我是猪队友多包涵,2122,310,13,14,27,48.1%,1h
5769,3,yan,2122,320,12,19,31,38.7%,20m
5769,2,Jim,2122,200,7,11,18,38.9%,6m
5769,2,我是新手,2122,106,3,4,7,42.9%,35m
5773,2,IIIIIIIIIIII,2121,1433,336,358,694,48.4%,15m
5774,3,小贾超凶哒,2120,178,7,5,12,58.3%,1h
5774,2,xiaoleishou,2120,0,1,4,5,20.0%,5m
5776,3,新手刚玩,2119,325,12,9,21,57.1%,1h
5776,3,Dash,2119,0,0,5,5,0.0%,1h
5778,1,不是但是算了我的,2118,1486,163,209,372,43.8%,43m
5778,3,TWOandALASKA,2118,0,2,3,5,40.0%,1h
5778,3,Angelll,2118,0,0,1,1,0.0%,1h
5781,2,fafa,2117,173,5,8,13,38.5%,2m
5781,2,Siiyuann,2117,46,2,9,11,18.2%,1h
5783,2,慢攻小王子,2116,324,12,20,32,37.5%,56m
5783,2,SOS,2116,0,0,10,10,0.0%,1h
5785,3,王小七,2114,64,2,6,8,25.0%,22m
5785,3,[DNF]IIIIIIIIIIII,2114,0,1,0,1,100.0%,6m
5787,2,[就这就这]Cephedra,2113,1538,149,176,325,45.8%,37m
5787,3,[123475]天霸,2113,0,1,0,1,100.0%,22m
5789,3,紫幽浩,2112,0,0,1,1,0.0%,26m
5790,1,fixby,2111,843,34,41,75,45.3%,1h
5790,3,围巾,2111,60,2,3,5,40.0%,15m
5792,3,希儿芙乐艾,2110,214,6,2,8,75.0%,1h
5792,3,long,2110,40,3,3,6,50.0%,1h
5794,2,[OhNo]IIIIIIIIIIII,2108,964,35,46,81,43.2%,1h
5794,3,[普洛拓斯族]黑暗使徒,2108,0,0,5,5,0.0%,6m
5796,3,kka,2107,223,39,56,95,41.1%,15m
5796,2,[你嘤尼玛呢]二狗子,2107,623,20,30,50,40.0%,1h
5796,3,最爱大云云,2107,86,3,4,7,42.9%,1h
5799,2,Ysb,2105,1197,48,53,101,47.5%,1h
5800,3,打不死风雅东方,2104,58,2,4,6,33.3%,14m
5801,3,flyingnoob,2103,133,2,2,4,50.0%,5m
5801,3,安小念,2103,30,2,2,4,50.0%,56m
5801,3,FJyifan,2103,0,0,1,1,0.0%,1h
5804,3,郜老师,2102,0,0,3,3,0.0%,1h
5804,3,纳兰苏菲,2102,0,0,5,5,0.0%,57m
5806,3,[埃蒙好可爱]云霄九天,2100,1003,36,36,72,50.0%,56m
5806,3,飘零若风,2100,0,0,1,1,0.0%,4m
5808,1,[DMRe]火云邪神,2099,699,35,42,77,45.5%,1h
5808,2,fdstged,2099,164,4,2,6,66.7%,1h
5808,2,红唇烈酒,2099,46,3,7,10,30.0%,1h
5808,2,式以京,2099,82,2,6,8,25.0%,60m
5808,3,凯撒星辰,2099,0,0,2,2,0.0%,13m
5813,1,真央,2098,937,130,115,245,53.1%,8m
5813,2,Jason,2098,941,33,48,81,40.7%,27m
5813,1,doOs,2098,48,1,1,2,50.0%,1h
5816,1,[口一口]我再也不打内战了,2096,1581,302,339,641,47.1%,43m
5816,3,fireray,2096,1506,74,75,149,49.7%,1h
5816,3,djaslkjd,2096,86,4,4,8,50.0%,1h
5819,3,吾皇,2095,649,33,46,79,41.8%,21m
5819,2,[腥基佬男骸]疯瘤老煜哥,2095,201,5,7,12,41.7%,1h
5819,3,欧西给之神,2095,0,0,1,1,0.0%,6m
5822,1,果果蜜糖,2094,96,2,7,9,22.2%,22m
5822,3,失引论,2094,0,1,4,5,20.0%,1h
5824,3,生女当如泉此方,2093,1488,67,77,144,46.5%,13m
5824,2,ABCEH,2093,97,3,7,10,30.0%,1h
5826,2,次了个瓜,2092,110,4,6,10,40.0%,59m
5826,1,bigcat,2092,142,4,10,14,28.6%,27m
5828,2,照烧酱,2091,356,12,16,28,42.9%,1h
5828,2,燃烧我的卡路里,2091,174,7,7,14,50.0%,60m
5828,2,许三世暖阳,2091,0,3,5,8,37.5%,1h
5831,3,[欧派萌新团]渺小的星星,2089,0,0,5,5,0.0%,1h
5832,2,Forgetmenot,2085,0,1,8,9,11.1%,38m
5833,1,Make,2084,1341,277,314,591,46.9%,26m
5834,2,绿色环保,2083,93,2,7,9,22.2%,1h
5835,3,摩羯之心,2082,186,8,4,12,66.7%,5m
5835,1,DEIUXTHEMAX,2082,142,6,11,17,35.3%,46m
5837,1,扰耳啊,2081,48,1,1,2,50.0%,42m
5838,2,鱼飞梭,2079,44,1,3,4,25.0%,31m
5839,1,[自走棋之王]木可小浩,2078,1366,47,67,114,41.2%,39m
5839,2,YFfinger,2078,60,4,8,12,33.3%,1h
5841,3,记录的地平线,2076,102,13,10,23,56.5%,4m
5841,2,[神子]lbwnb,2076,227,6,9,15,40.0%,1h
5841,3,[遇雨语余]疏鱼影,2076,0,2,4,6,33.3%,10m
5844,3,赵宁,2075,334,11,20,31,35.5%,35m
5844,3,Dracula,2075,271,9,8,17,52.9%,1h
5844,3,小段,2075,313,9,12,21,42.9%,1h
5844,3,[世风第三帝国]汗水宝宝,2075,0,0,5,5,0.0%,1h
5848,2,[阿里巴巴战队]我是你黄爹爹,2074,137,4,4,8,50.0%,31m
5848,2,夺命牙医,2074,86,4,10,14,28.6%,38m
5848,2,[极限菜鸟]JAC,2074,112,4,11,15,26.7%,1h
5848,3,[荒唐社]Grye,2074,0,0,1,1,0.0%,1h
5852,3,库库林白夜,2073,0,1,0,1,100.0%,6m
5852,3,勥氼,2073,30,1,4,5,20.0%,1h
5852,3,Lex,2073,0,1,4,5,20.0%,56m
5855,3,vty,2072,88,3,4,7,42.9%,1h
5855,3,永远也一样,2072,58,3,5,8,37.5%,12m
5857,1,小嘴凉飕飕,2071,178,5,10,15,33.3%,1h
5857,1,乌瑟尔,2071,0,0,1,1,0.0%,18m
5859,3,胖胖,2070,220,6,7,13,46.2%,1h
5860,3,菜鸟,2069,314,11,7,18,61.1%,4m
5860,3,[方阵塔防标准]badboy,2069,120,2,1,3,66.7%,8m
5860,3,[万神归一]耶稣与玛丽锁,2069,0,0,2,2,0.0%,1h
5863,3,哇哇,2067,1308,263,299,562,46.8%,16m
5863,3,blackapple,2067,190,6,4,10,60.0%,1h
5863,3,落月,2067,170,5,5,10,50.0%,35m
5866,3,龙城狂霸拽少,2066,1415,174,193,367,47.4%,27m
5866,2,哈哈,2066,1023,48,47,95,50.5%,45m
5866,3,豪的精彩,2066,74,2,8,10,20.0%,6m
5869,3,突突突,2065,90,3,6,9,33.3%,27m
5870,3,CGB,2064,0,0,1,1,0.0%,6m
5871,3,战天下,2063,38,3,11,14,21.4%,5m
5871,3,Layer,2063,0,0,1,1,0.0%,1h
5873,2,sherry,2062,1554,65,74,139,46.8%,20m
5873,3,[一群谐星]Abelard,2062,0,1,0,1,100.0%,46m
5873,3,prefect,2062,0,0,2,2,0.0%,1h
5876,3,[AF]龙将,2061,217,6,6,12,50.0%,1h
5876,2,人一己百,2061,131,3,7,10,30.0%,60m
5878,3,古风歌,2060,86,3,3,6,50.0%,1h
5878,2,hcxixi,2060,165,3,8,11,27.3%,1h
5880,3,人去茶微凉,2059,36,3,5,8,37.5%,6m
5881,3,角落,2058,1223,47,55,102,46.1%,1h
5881,3,[神罚]小星星,2058,588,23,25,48,47.9%,1h
5881,3,狂神,2058,0,0,1,1,0.0%,25m
5884,2,Dingdang,2057,406,14,18,32,43.8%,41m
5884,2,孙龘,2057,158,4,10,14,28.6%,21m
5886,3,素质极差,2055,312,10,17,27,37.0%,5m
5886,3,洗手间风暴,2055,142,7,9,16,43.8%,1h
5886,3,kungfupanda,2055,0,2,3,5,40.0%,56m
5886,3,zzh,2055,0,2,4,6,33.3%,22m
5890,2,[黄金老中医]GLHF,2054,249,8,17,25,32.0%,1h
5890,2,jack,2054,212,7,14,21,33.3%,38m
5890,3,[暴雪三十一队]xgqlhh,2054,217,6,6,12,50.0%,1h
5893,3,晚安记得早睡,2053,0,1,1,2,50.0%,1h
5894,1,执政官之手,2051,224,7,9,16,43.8%,25m
5894,2,ZHOU,2051,0,0,4,4,0.0%,1h
5896,3,[WIE]帝俊,2050,0,0,2,2,0.0%,1h
5897,3,人族妈暴毙一下,2049,570,181,209,390,46.4%,1h
5897,3,DJzwl,2049,0,0,2,2,0.0%,57m
5899,2,QND,2048,445,17,22,39,43.6%,1h
5899,3,iGJim,2048,110,3,9,12,25.0%,1h
5901,3,[瘾大眼瞎]大马罗,2047,30,3,2,5,60.0%,1h
5901,3,[明日帝国]明日帝国,2047,48,2,0,2,100.0%,10m
5901,3,永远喜欢坂井泉水,2047,30,2,3,5,40.0%,60m
5904,3,[E奶飞天]ZeroTemplar,2046,1513,80,85,165,48.5%,30m
5904,2,[萌萌拳]小如初,2046,265,8,12,20,40.0%,1h
5906,2,wjc,2043,0,0,1,1,0.0%,57m
5907,3,[绝世双谐]Kevin,2042,96,2,5,7,28.6%,12m
5907,2,sadha,2042,32,2,10,12,16.7%,20m
5907,3,[肉鸡的饲养]仙筝,2042,0,0,1,1,0.0%,1h
5910,3,KFC,2041,168,4,3,7,57.1%,26m
5910,3,悍吼,2041,96,1,1,2,50.0%,1h
5912,3,SOS,2040,96,1,1,2,50.0%,1h
5912,3,ghost,2040,0,1,4,5,20.0%,6m
5914,3,马大胡子,2039,1407,55,77,132,41.7%,1h
5914,2,洛神,2039,192,8,10,18,44.4%,1h
5914,3,阿飞飞和我,2039,172,6,7,13,46.2%,1h
5914,3,ppsuc,2039,88,4,7,11,36.4%,1h
5918,3,地霸,2038,36,1,3,4,25.0%,57m
5919,3,ZooNrSClavie,2037,30,5,5,10,50.0%,21m
5920,2,防空长城,2035,1395,195,207,402,48.5%,1h
5920,3,[白丝黑丝萝莉]风吹雪,2035,347,11,10,21,52.4%,1h
5920,3,Rommel,2035,0,0,6,6,0.0%,1h
5923,3,始皇蒙毅,2033,305,13,13,26,50.0%,1h
5923,3,ahuan,2033,0,0,1,1,0.0%,22m
5923,3,我爱彭晓琴,2033,0,0,2,2,0.0%,32m
5926,3,[坦克36D]usadapekora,2031,179,6,5,11,54.5%,1h
5926,2,啊军,2031,0,1,1,2,50.0%,1h
5928,3,Genie,2030,548,44,44,88,50.0%,18m
5928,3,[QWQa]小雏菊,2030,0,0,1,1,0.0%,4m
5930,1,ZSUCK,2029,145,2,6,8,25.0%,3m
5931,2,[大脑在震颤]ToTheSky,2028,476,16,21,37,43.2%,38m
5931,1,llllllllllll,2028,44,1,1,2,50.0%,1h
5933,1,[3GPP]减肥成功的基王,2025,0,1,0,1,100.0%,1h
5934,1,vivo,2024,0,1,0,1,100.0%,19m
5935,3,抚琴离歌,2023,329,11,24,35,31.4%,51m
5936,3,猥琐大师,2022,138,4,8,12,33.3%,1h
5936,3,[舜志满天下]舜志科技,2022,100,3,12,15,20.0%,4m
5938,2,Domen,2017,0,0,3,3,0.0%,35m
5939,3,MAX,2016,0,0,6,6,0.0%,1h
5940,3,执法官,2015,89,6,8,14,42.9%,1h
5940,3,浪迹天涯,2015,78,4,9,13,30.8%,1h
5940,1,[爆蛋比利王]盖瑞的机油,2015,0,0,1,1,0.0%,3m
5943,2,非洲妇联主任,2013,94,1,8,9,11.1%,20m
5944,1,我为狂三上王者,2012,392,9,14,23,39.1%,46m
5944,3,tsheep,2012,0,1,5,6,16.7%,30m
5946,2,[新星AKA]威武我朝,2010,1466,354,378,732,48.4%,31m
5946,3,[在下萌新一只]隔壁家子逸,2010,1211,58,59,117,49.6%,1h
5948,1,苏逍遥,2006,245,15,10,25,60.0%,1h
5948,2,心灵的伤痛,2006,36,2,9,11,18.2%,31m
5948,3,eeee,2006,36,1,4,5,20.0%,22m
5948,3,不落之翼,2006,0,0,1,1,0.0%,1h
5952,3,老狼大盘鸡,2005,884,30,37,67,44.8%,30m
5953,3,[瘾大眼瞎]我也曾拥过她,2004,0,1,0,1,100.0%,1h
5953,1,阿玛歌,2004,0,0,1,1,0.0%,1h
5955,3,红豆红,2002,0,0,5,5,0.0%,1h
5956,3,刺客伍六一,2001,0,1,0,1,100.0%,1h
5957,2,随风,2000,794,30,38,68,44.1%,1h
5957,1,陈先生,2000,487,11,23,34,32.4%,20m
5959,3,青霜,1997,34,2,4,6,33.3%,10m
5960,2,[LOHv]钢铁元,1996,1557,142,199,341,41.6%,54m
5960,1,年少轻狂,1996,48,1,1,2,50.0%,1h
5962,3,南柯一梦丶,1994,32,1,7,8,12.5%,1h
5962,1,杀鸡取卵,1994,0,0,18,18,0.0%,1h
5964,3,让你先冲,1993,1279,51,76,127,40.2%,46m
5964,1,[羊驼羊驼羊]Sakura,1993,34,1,2,3,33.3%,42m
5966,2,瞙駺,1989,810,33,46,79,41.8%,1h
5966,2,永言堂,1989,82,4,7,11,36.4%,43m
5968,2,HUIMU,1988,166,8,6,14,57.1%,1h
5969,2,AAAA,1987,460,15,30,45,33.3%,9m
5970,3,重返星际,1985,0,0,1,1,0.0%,41m
5971,3,[樱丘]srlre,1984,0,2,4,6,33.3%,27m
5972,3,[丨CRH丨]你好我叫高天伦,1983,850,31,30,61,50.8%,12m
5973,2,[云师三骚]被绿了吗,1982,546,18,33,51,35.3%,54m
5974,3,[墨染千秋]墨锋,1981,272,8,14,22,36.4%,6m
5974,3,鳄鱼先生丶,1981,121,3,8,11,27.3%,1h
5976,3,princess,1980,488,19,31,50,38.0%,1h
5977,3,SHENGLZJ,1975,30,1,1,2,50.0%,1h
5978,1,[可爱的你们]我无敌,1974,690,17,29,46,37.0%,16m
5979,1,好大一棵树,1972,48,1,14,15,6.7%,1h
5980,2,大脑在颤抖,1971,134,5,6,11,45.5%,43m
5981,2,卢本伟,1969,1472,70,70,140,50.0%,1h
5982,2,爱笑怎么了,1968,1032,36,46,82,43.9%,27m
5982,1,llllllllllll,1968,224,5,4,9,55.6%,1h
5982,3,夜色桀,1968,60,2,7,9,22.2%,42m
5982,3,[陀螺丶小分队]龙的后代,1968,0,1,1,2,50.0%,27m
5982,3,鲍之晨,1968,0,0,1,1,0.0%,1h
5982,3,骨灰一会发,1968,0,0,5,5,0.0%,1h
5982,3,shui,1968,0,0,7,7,0.0%,1h
5989,2,瓦里安,1966,0,1,4,5,20.0%,59m
5990,1,TokyoVice,1965,310,8,7,15,53.3%,1h
5991,3,zxh,1964,32,2,4,6,33.3%,1h
5992,1,michals,1963,1108,231,267,498,46.4%,22m
5992,3,一朵相似的花,1963,807,29,41,70,41.4%,1h
5992,3,繁星春水,1963,34,2,6,8,25.0%,56m
5995,3,[菜有菜的道理]农夫一拳,1962,0,1,0,1,100.0%,1h
5995,1,xiongkai,1962,46,1,1,2,50.0%,1h
5997,3,最爱青青,1961,494,28,68,96,29.2%,55m
5998,3,言传,1959,0,0,1,1,0.0%,1h
5999,3,evil,1957,0,1,6,7,14.3%,1h
6000,3,麦快玩麦块,1955,58,3,1,4,75.0%,56m
6000,2,[西伯利亚土豆]Rlothzy,1955,0,0,1,1,0.0%,60m
6002,1,[潸然丶那些年]Pimba,1950,723,85,137,222,38.3%,15m
6002,2,[F2ANB]允执厥中,1950,154,9,13,22,40.9%,57m
6004,1,八方大爷,1949,328,9,9,18,50.0%,1h
6004,1,Siri,1949,0,1,3,4,25.0%,25m
6006,3,HZH,1948,1643,75,107,182,41.2%,1h
6007,2,欧菲光巨,1947,257,7,13,20,35.0%,38m
6007,1,伪闲人,1947,0,2,4,6,33.3%,42m
6009,2,KyDParzival,1937,1149,40,53,93,43.0%,1h
6010,2,[GBWut]虫虫虫,1936,86,3,13,16,18.8%,60m
6011,2,[斗鱼大纲]feng,1934,38,2,3,5,40.0%,31m
6012,2,魔魂,1932,0,0,2,2,0.0%,60m
6013,1,YZT,1928,857,49,82,131,37.4%,3m
6014,3,Galgadot,1926,0,4,2,6,66.7%,41m
6015,3,[萌新都是大佬]kilodear,1925,0,0,6,6,0.0%,1h
6016,2,[BDMK]沙坪坝梁朝伟,1922,0,0,1,1,0.0%,1h
6016,3,战神哥哥,1922,0,0,1,1,0.0%,1h
6018,1,喜欢吃橘子的汤汤,1921,0,0,5,5,0.0%,16m
6019,1,KEMEK,1920,224,6,5,11,54.5%,16m
6019,3,洛克昂,1920,0,0,6,6,0.0%,1h
6021,3,刑天使者,1918,0,2,3,5,40.0%,57m
6022,1,渡鸦鸦渡鸦鸦,1916,132,3,3,6,50.0%,3m
6023,1,吉祥如意,1914,145,3,0,3,100.0%,29m
6024,2,斯巴达,1912,233,7,12,19,36.8%,4m
6024,3,[MORDEN]MLANDGG,1912,0,0,1,1,0.0%,1h
6026,2,[OB丶]上海萌兔,1911,812,32,39,71,45.1%,3m
6026,3,CGLB,1911,0,0,2,2,0.0%,1h
6028,1,李老板,1910,1320,39,61,100,39.0%,25m
6029,2,孙博父,1909,230,6,16,22,27.3%,1h
6030,3,东海戴鱼,1903,0,0,1,1,0.0%,1h
6031,3,bssss,1899,143,4,10,14,28.6%,1h
6031,3,haoshi,1899,0,0,1,1,0.0%,1h
6033,3,龙曾在此,1897,30,3,14,17,17.6%,46m
6034,3,Mihawk,1889,96,4,13,17,23.5%,1h
6035,3,Onland,1887,44,1,8,9,11.1%,1h
6036,1,天恒,1881,489,17,30,47,36.2%,1h
6036,3,林丑丑,1881,330,13,18,31,41.9%,1h
6036,3,ShiLing,1881,30,2,2,4,50.0%,1h
6039,3,Airmond,1877,36,1,1,2,50.0%,1h
6040,3,刀锋女王她哥,1871,114,5,4,9,55.6%,41m
6040,1,tun,1871,0,0,1,1,0.0%,28m
6040,1,youwillgoal,1871,0,0,6,6,0.0%,20m
6043,1,哈根达斯,1869,311,11,24,35,31.4%,1h
6043,1,一个人的情调,1869,158,5,4,9,55.6%,46m
6045,1,疑似到底,1865,691,18,18,36,50.0%,1h
6046,1,大家好,1863,48,3,14,17,17.6%,13m
6047,2,滴滴,1860,188,7,11,18,38.9%,1h
6048,1,setmefree,1859,0,1,3,4,25.0%,1h
6049,1,心之逆鳞,1855,296,7,29,36,19.4%,20m
6049,3,[孙岱玹]蟑螂舞姬,1855,42,6,4,10,60.0%,1h
6049,3,羽落,1855,30,1,7,8,12.5%,6m
6052,1,激浪稳进,1854,1217,36,59,95,37.9%,1h
6053,3,xfauh,1853,118,5,4,9,55.6%,1h
6054,1,辛普森,1852,93,1,1,2,50.0%,1h
6055,2,黄帝,1846,88,1,6,7,14.3%,16m
6056,3,[国际巨星]天赐,1845,0,2,14,16,12.5%,1h
6057,3,quanpeng,1840,108,4,11,15,26.7%,1h
6058,3,RYYR,1838,46,1,3,4,25.0%,22m
6058,3,[白银联盟]王的力量,1838,0,0,5,5,0.0%,41m
6060,3,多肉动物,1837,68,3,5,8,37.5%,1h
6061,3,战神丶冷,1833,0,1,4,5,20.0%,1h
6062,3,[太阳与野花]不是假发是桂,1832,0,0,7,7,0.0%,4m
6063,1,曙鸦,1831,451,13,23,36,36.1%,1h
6063,3,白刃血,1831,0,0,1,1,0.0%,1h
6063,3,功夫胖,1831,0,0,2,2,0.0%,1h
6066,3,[白板]桃子吖,1828,112,3,8,11,27.3%,22m
6067,3,欂杋,1827,0,0,7,7,0.0%,4m
6068,3,ghjdfjdj,1826,30,1,4,5,20.0%,1h
6069,3,血鹰小昊昊,1824,30,1,2,3,33.3%,1h
6070,1,天启,1822,657,18,33,51,35.3%,1h
6071,3,未来任性,1821,0,0,1,1,0.0%,1h
6072,1,LANREN,1820,32,3,5,8,37.5%,19m
6072,1,Group,1820,40,2,8,10,20.0%,12m
6074,3,天叶丶,1811,370,15,25,40,37.5%,1h
6074,2,浴火凤凰,1811,0,0,1,1,0.0%,20m
6076,1,[慢手e族]太子,1810,1074,101,127,228,44.3%,1h
6077,2,zzZ,1804,0,0,2,2,0.0%,16m
6078,1,DJhui,1799,252,6,12,18,33.3%,1h
6079,3,不用怀疑不会,1798,0,3,6,9,33.3%,41m
6079,3,黄金达拉燃,1798,0,0,1,1,0.0%,11m
6081,2,afs,1790,76,2,1,3,66.7%,59m
6082,3,Annmak,1788,0,1,1,2,50.0%,41m
6083,2,我逆天,1781,0,1,5,6,16.7%,57m
6084,3,仗剑天涯,1768,0,0,4,4,0.0%,1h
6085,2,老唐,1761,27,1,4,5,20.0%,60m
6086,1,[北有吾王3队]小丑笑一下,1760,309,9,19,28,32.1%,42m
6086,3,Cherry,1760,0,0,5,5,0.0%,1h
6088,3,[新手保护协会]发现世界,1757,0,1,0,1,100.0%,1h
6089,2,RAIN,1756,551,16,32,48,33.3%,59m
6090,1,[Vlo]MissHR,1749,179,8,23,31,25.8%,1h
6091,2,[传说之下]Moon,1747,86,5,0,5,100.0%,3m
6092,2,凯哥哥,1741,98,4,5,9,44.4%,59m
6093,3,暗雨,1734,94,4,11,15,26.7%,1h
6094,3,Sueter,1732,0,0,5,5,0.0%,1h
6095,3,裂地之哀,1724,62,2,10,12,16.7%,1h
6096,2,凰吉,1710,0,1,0,1,100.0%,1h
6097,3,lone,1702,0,0,10,10,0.0%,1h
6098,2,喵帕斯,1700,124,3,0,3,100.0%,31m
6099,3,[星际爱好者队]karsa,1697,0,0,1,1,0.0%,1h
6100,2,[青春只有一次]YoungStar,1688,390,142,188,330,43.0%,31m
6101,2,xbd,1685,165,8,10,18,44.4%,16m
6102,3,尛夵,1673,90,3,15,18,16.7%,41m
6103,3,[无情突变王]守护,1660,30,1,9,10,10.0%,22m
6104,3,FanscDragon,1617,40,1,3,4,25.0%,1h
6105,2,zardlike,1614,320,11,13,24,45.8%,1h
6106,3,一阵风和雨,1571,0,0,5,5,0.0%,1h
6107,3,exiagundum,1564,88,4,5,9,44.4%,1h
6108,3,[C17079]PluKevin,1547,0,0,1,1,0.0%,1h
6109,3,痛苦的温暖,1535,192,7,6,13,53.8%,22m
6110,3,[挨萌愚忠分子]ReinfoRce,1529,0,70,148,218,32.1%,21m
6111,3,别打我我发育,1520,212,6,31,37,16.2%,27m
6112,3,飞行家,1448,30,1,2,3,33.3%,1h
6113,3,[双截龙]布衣神相,1413,0,1,0,1,100.0%,1h
6114,3,TIMBA,1350,0,0,5,5,0.0%,1h
6115,2,[莫扎特]茜茜公主,1328,1491,283,931,1214,23.3%,38m
6116,3,战翼,1320,374,341,465,806,42.3%,12m
6117,3,简单粗暴,1265,236,9,2,11,81.8%,1h
6118,3,三色堇,1234,0,0,1,1,0.0%,1h
6119,3,kild,1117,448,19,63,82,23.2%,27m
6120,3,铁血锦衣卫,1068,128,2996,3883,6879,43.6%,46m
6121,3,Andy,1039,346,12,34,46,26.1%,1h
6122,2,[小小熊]轻松熊的逆袭,968,175,4,37,41,9.8%,60m
6123,3,黄旭东,951,0,0,1,1,0.0%,1h
6124,1,[神威鬼鸣]命运真是不可琢磨,838,187,3099,3725,6824,45.4%,26m
6125,3,Finale,780,613,870,998,1868,46.6%,55m
6126,3,[红烧牛肉面]威猛的小涛哥,580,0,0,4,4,0.0%,4m
6127,3,HRC,575,0,0,1,1,0.0%,1h
6128,1,sjy,567,846,3209,3556,6765,47.4%,8m
