rank,tier,name,mmr,points,wins,losses,played,winrate,age
1,1,[惠软]安艺伦也,6423,0,1,0,1,100.0%,24m
2,1,[iGSCII]iGCoffeeMs,6299,2860,170,17,187,90.9%,3m
3,1,[iGSCII]iGXY,6038,2361,124,24,148,83.8%,3m
4,1,[TNL]SpeakNow,5971,0,0,1,1,0.0%,11m
5,1,[XYFANS]鸟哥真爱粉,5859,0,3,1,4,75.0%,11m
6,1,IIIIIIIIIIII,5852,0,1,0,1,100.0%,37m
7,1,狐狸的小和,5781,48,1,3,4,25.0%,6m
8,1,[BLaDe]小坚强,5771,789,37,19,56,66.1%,37m
9,1,[鸟哥FANS]BDG,5748,0,0,1,1,0.0%,11m
10,1,[高樂集团]OOOOOOOOO,5696,190,5,0,5,100.0%,6m
11,1,[丨SLT丨]皮皮虾,5670,2332,124,68,192,64.6%,37m
12,1,[Hist]Soularium,5668,361,13,1,14,92.9%,36m
13,1,IIIIIIIIIIII,5615,535,22,7,29,75.9%,9m
14,1,[滑稽团]DawnLu,5591,0,0,1,1,0.0%,42m
15,1,[ZJU]Daydreamer,5555,0,1,0,1,100.0%,8m
16,1,[至高内歼]CQEDC,5547,238,5,1,6,83.3%,8m
17,1,[AnSwer]CarGO,5525,0,1,0,1,100.0%,43m
18,1,[Thpj]上海人形,5521,238,5,3,8,62.5%,8m
19,1,[FDSJ]Joseph,5509,0,1,0,1,100.0%,36m
20,1,[TGE]killer,5508,280,7,6,13,53.8%,42m
20,1,[阴影城]撕布累死,5508,0,1,0,1,100.0%,16m
22,1,[RSTAR]STAR,5495,48,2,0,2,100.0%,16m
23,1,[红曜石]爱因克洛提德,5488,530,14,4,18,77.8%,5m
24,1,[BJTU]WheelGunGun,5485,97,2,0,2,100.0%,11m
25,1,一级顶别人一百级,5484,0,0,1,1,0.0%,11m
26,1,[IMRTS]IIIIIIIIIIII,5477,1744,271,133,404,67.1%,3m
27,1,[妙手回春]Dreamhaven,5425,0,1,0,1,100.0%,43m
28,1,Amaranthine,5418,0,1,0,1,100.0%,6m
29,1,专业抬棺团队,5403,178,5,1,6,83.3%,9m
30,1,[SK]Local,5393,0,1,0,1,100.0%,37m
31,1,[Thpj]喵發,5392,140,4,1,5,80.0%,43m
32,1,[菜场]西红柿,5382,40,1,2,3,33.3%,43m
33,1,LPSTAR,5374,0,1,0,1,100.0%,43m
34,1,冷酷之盗贼,5358,184,4,2,6,66.7%,36m
35,1,[SK]祝你今天愉快,5352,990,35,14,49,71.4%,3m
36,1,[Thpj]阴间杀手,5347,190,6,0,6,100.0%,8m
37,1,[半个菜鸟]sGTYLGDTaidy,5344,0,0,1,1,0.0%,24m
38,1,[楠妈妈]楠妈妈,5333,822,38,23,61,62.3%,38m
39,1,[极品菜鸟]我又不空大,5330,3085,258,191,449,57.5%,3m
40,1,[Faith]雪之下雪乃,5327,0,0,1,1,0.0%,43m
41,1,[我们的奇迹]高坂穗乃果,5326,0,0,1,1,0.0%,9m
42,1,[合作老司机]黯淡卟变,5321,97,2,0,2,100.0%,36m
42,1,[PTB]垃圾人族菲斯,5321,0,0,1,1,0.0%,24m
44,1,[疼王阁]丶小庝,5318,401,21,0,21,100.0%,5m
45,1,[Rhusky]IceLin,5317,540,26,5,31,83.9%,8m
46,1,冻土森林的大蒜头,5304,2075,123,51,174,70.7%,3m
47,1,猜猜我是谁,5296,232,5,11,16,31.2%,42m
48,1,[Ogier]GhosT,5292,1949,104,58,162,64.2%,3m
49,1,[虫就输不了]鹿游原,5285,554,12,11,23,52.2%,38m
50,1,愤怒的垮爷,5282,0,0,1,1,0.0%,24m
51,1,[EL骑士团]星际队长,5279,0,0,1,1,0.0%,43m
52,1,[KeRn]oRyoN,5265,80,3,0,3,100.0%,5m
53,1,[Hist]yamworld,5262,3071,377,201,578,65.2%,3m
54,1,[TPoA]全都是等号,5259,828,19,9,28,67.9%,6m
55,1,[TeamLP]JieShi,5236,364,13,10,23,56.5%,7m
56,1,IIIIIIIIIIII,5234,1655,122,71,193,63.2%,24m
57,1,[传说萌娘团]魔法少女喵喵酱,5225,0,0,2,2,0.0%,36m
58,1,Air,5213,727,53,21,74,71.6%,9m
59,1,[上分女孩]Neko,5209,0,1,0,1,100.0%,5m
60,1,llllllllllll,5204,873,32,23,55,58.2%,3m
61,1,[是我赢了]Nightmares,5203,378,20,11,31,64.5%,38m
62,1,[吾乃津门莽霸]跳跳跳跳虫,5202,0,0,1,1,0.0%,6m
63,1,[重拾]HistGor,5194,0,0,2,2,0.0%,6m
64,1,[NS]IIIIIlIIIlll,5188,0,1,0,1,100.0%,11m
65,1,[肉鸡的饲养]llllllllllll,5187,510,28,3,31,90.3%,9m
66,1,llllllllllll,5178,943,36,23,59,61.0%,3m
67,1,[Hist]Narzisse,5168,0,0,1,1,0.0%,6m
68,1,极夜,5165,2312,122,61,183,66.7%,3m
69,1,旁白白,5163,0,0,3,3,0.0%,11m
70,1,[星选组]暴雪的爹,5144,0,0,3,3,0.0%,7m
71,1,LeeLee,5139,2645,192,121,313,61.3%,3m
72,1,[OkayS]冰川纱夜,5136,0,0,1,1,0.0%,43m
73,1,[SK]超高校级的泰伦,5128,1463,104,62,166,62.7%,5m
74,1,[XYFANS]NIKO,5126,2624,141,91,232,60.8%,3m
75,1,厦门孙一峰,5124,2209,217,153,370,58.6%,43m
76,1,[KPG]开局要打鸡儿盒饭,5111,2731,142,104,246,57.7%,3m
76,1,[一色彩彩羽]比企谷八幡,5111,482,11,10,21,52.4%,42m
78,1,LateInAutumn,5110,94,3,2,5,60.0%,7m
79,1,纯度,5107,628,18,17,35,51.4%,6m
80,1,[五月花]超高校级的希望,5106,819,117,62,179,65.4%,9m
80,1,[SCAP]xiaobai,5106,0,0,1,1,0.0%,16m
82,1,苏州孙一峰,5097,650,28,11,39,71.8%,3m
82,1,[VUP]南木羽鸟,5097,0,0,1,1,0.0%,6m
84,1,IrisFreyja,5094,449,15,17,32,46.9%,3m
85,1,IIIIllllllI,5092,0,1,0,1,100.0%,36m
86,1,[Hist]HistOG,5090,0,0,1,1,0.0%,9m
87,1,[国民]Lin,5089,819,29,23,52,55.8%,43m
88,1,zeros,5084,0,0,1,1,0.0%,36m
89,1,[执笔画春秋丶]尘封记忆,5080,721,21,17,38,55.3%,9m
90,1,[YA]Kazenon,5078,0,0,1,1,0.0%,5m
91,1,[IMRTS]BasaraKing,5071,0,0,1,1,0.0%,24m
92,1,[SCAP]MaGuLis,5070,1450,69,44,113,61.1%,16m
92,1,[半个菜鸟]我活该被辜负吗,5070,166,22,8,30,73.3%,43m
92,1,[Hist]卡人口的金甲虫,5070,690,17,12,29,58.6%,6m
95,1,llllllllllll,5067,2867,402,190,592,67.9%,3m
96,1,[ZTSCAP]深辰,5064,909,55,33,88,62.5%,37m
97,1,[AnSwer]Swaying,5060,0,0,3,3,0.0%,42m
98,1,上海阿腾哥,5051,698,26,42,68,38.2%,3m
99,1,[羊驼羊驼羊]AbyssApostl,5045,0,0,1,1,0.0%,43m
100,1,[Pro]LindL,5044,130,3,1,4,75.0%,36m
101,1,[猪一样的盟友]神一样的高手,5043,0,3,4,7,42.9%,38m
101,1,Xuanxuan,5043,0,1,0,1,100.0%,36m
103,1,[指尖奶茶]蕾米莉亚,5033,0,0,1,1,0.0%,7m
104,2,人类,5030,0,1,0,1,100.0%,15m
105,1,[KD]shesuncon,5029,0,0,1,1,0.0%,43m
106,1,[PTB]Ykn,5025,1602,73,48,121,60.3%,3m
106,1,[金灿灿狙击队]神速偷鸡,5025,683,36,17,53,67.9%,5m
108,1,[Marry]Hierarch,5024,0,1,0,1,100.0%,8m
109,1,[同化已完成]叫我好哥哥啊,5019,0,0,2,2,0.0%,36m
110,1,[Marry]丶老北京五开哥,5018,40,1,1,2,50.0%,5m
111,1,llllllllllll,5016,188,5,1,6,83.3%,6m
111,1,[FsA]SakiNanami,5016,0,0,2,2,0.0%,5m
113,1,青绾,5015,338,9,7,16,56.2%,42m
114,1,IIIIIIIIIIII,5013,1692,74,38,112,66.1%,3m
115,2,爱神,5012,0,1,0,1,100.0%,15m
116,1,[kotomi]gyro,5010,671,23,23,46,50.0%,9m
116,1,Galaxy,5010,73,5,0,5,100.0%,37m
116,1,[CA神教]我也是个好人,5010,0,0,1,1,0.0%,36m
119,1,[Rhusky]风神凌霄,5006,0,0,1,1,0.0%,42m
120,1,[SteEng]普拉多,5005,0,0,1,1,0.0%,7m
121,1,CarGO,5004,352,10,6,16,62.5%,16m
122,1,[红烧牛肉面]威猛的小涛哥,5002,62,6,2,8,75.0%,38m
123,1,IIIIIIIIIIII,5001,0,0,1,1,0.0%,7m
124,1,[SCAP]云图,4999,96,2,2,4,50.0%,5m
125,1,[惠软]加藤惠,4997,0,1,0,1,100.0%,42m
126,2,[Rhusky]TOTO,4996,36,1,1,2,50.0%,27m
127,1,[我们菜的1b]IIIIIIIIIIII,4995,0,0,1,1,0.0%,43m
128,1,[Beasty]lejdkjsa,4993,2212,134,113,247,54.3%,11m
129,1,[字数补丁]TIME,4992,0,0,1,1,0.0%,37m
130,1,[小狐狸真可爱]睡不醒的栗子喵,4990,797,110,22,132,83.3%,11m
130,2,[衣之咲璃乃]此号放假一天,4990,0,0,1,1,0.0%,15m
132,1,llllllllllll,4989,501,14,16,30,46.7%,24m
133,1,[Anticw]流氓有文化,4987,0,0,2,2,0.0%,43m
134,1,猗窝座,4985,1347,64,35,99,64.6%,36m
134,1,IIIIIIIIII,4985,795,33,24,57,57.9%,3m
136,1,[Beasty]SymondtY,4978,491,22,9,31,71.0%,3m
137,1,SAINTRyan,4977,447,49,15,64,76.6%,5m
138,1,鸡谐化就输不了,4970,2313,150,31,181,82.9%,3m
139,1,TOTO,4967,398,10,5,15,66.7%,36m
139,1,[丨SLT丨]秋月爱莉,4967,392,9,3,12,75.0%,9m
141,1,[Hist]金甲虫,4965,0,0,1,1,0.0%,8m
142,1,[HDU]IIllIllIIIIl,4962,1006,46,38,84,54.8%,24m
143,1,死人皮裹蛆沾痰吃,4961,140,4,2,6,66.7%,7m
143,1,[PMC]孤啸狼,4961,0,0,1,1,0.0%,43m
145,1,[传说萌娘团]方糖,4954,0,0,2,2,0.0%,42m
146,1,[SF]小小号,4953,214,16,5,21,76.2%,6m
147,1,[SCAP]星际争霸嘴上过,4946,0,0,1,1,0.0%,43m
147,1,[TNLet]想想花花会怎么做,4946,0,0,1,1,0.0%,43m
149,1,freesky,4945,2765,252,207,459,54.9%,3m
150,1,[AnSwer]孤独久了真会累,4943,132,3,4,7,42.9%,16m
151,1,EYE,4942,0,1,0,1,100.0%,24m
151,1,[BGD]繁星,4942,0,0,1,1,0.0%,43m
153,1,[鸡家军]鸡家军老周,4940,346,19,0,19,100.0%,42m
154,1,CAFANS,4939,0,0,1,1,0.0%,43m
155,1,[第七舰队丶]斗鱼丶失落少年,4935,0,0,1,1,0.0%,7m
156,1,[丨SLT丨]rewhitefans,4932,1273,45,41,86,52.3%,43m
157,1,llllllllllll,4931,572,16,8,24,66.7%,38m
158,1,[黄漫老师]香风和泉,4927,604,22,22,44,50.0%,3m
158,1,[惠软]英梨梨,4927,40,1,1,2,50.0%,24m
160,1,[Trust]戒烟的神,4925,2653,207,98,305,67.9%,3m
161,1,[SK]胖胖的猪,4921,1668,72,56,128,56.2%,3m
161,1,[Road]GhostHack,4921,0,1,0,1,100.0%,36m
163,1,[FDSJ]歌舞伎町的女王,4919,925,46,38,84,54.8%,36m
164,1,[纳兰皇族]幕罚,4917,0,0,1,1,0.0%,37m
165,1,[KPG]Zeratul,4916,681,25,35,60,41.7%,8m
166,2,[一只小萌新丶]可以赢但没必要,4915,0,1,0,1,100.0%,3m
167,1,[YU]新谷灯华,4913,1376,66,48,114,57.9%,3m
168,1,[SK]千机变,4909,544,15,9,24,62.5%,11m
168,1,比尔那名居天子,4909,107,3,3,6,50.0%,24m
170,1,[丨SLT丨]新手一个,4908,713,29,25,54,53.7%,3m
171,1,[Rhusky]iNaive,4906,186,7,13,20,35.0%,38m
172,1,[海德单推协会]CandyPaint,4904,2182,107,91,198,54.0%,3m
172,1,[Beasty]王留情,4904,1116,36,24,60,60.0%,5m
172,1,[SPRITE]loveNiNi,4904,380,10,8,18,55.6%,38m
172,1,[安玖珊好可爱]我是超级甜的玖珊,4904,0,0,1,1,0.0%,36m
176,1,[守护内心秩序]神气宝贝,4899,44,1,1,2,50.0%,43m
177,1,[IMRTS]Leo,4895,0,0,1,1,0.0%,7m
178,1,[KPG2]ATLast,4893,95,1,1,2,50.0%,3m
179,1,[上帝的叹息]KurokiTomoko,4890,1053,64,18,82,78.0%,3m
180,1,[传说萌娘团]黯灭龙魂,4889,259,26,1,27,96.3%,42m
181,1,我永远喜欢加藤惠,4887,220,5,3,8,62.5%,6m
182,1,[ANNEX]泡泡勇士,4877,483,22,8,30,73.3%,9m
183,1,llllllll,4875,649,28,30,58,48.3%,8m
183,1,[星河气象学院]丨鵺丨,4875,356,8,7,15,53.3%,16m
185,1,IIIIllIIIIll,4869,0,0,1,1,0.0%,6m
186,1,IIIIIIIIII,4868,972,27,24,51,52.9%,36m
187,1,llllllllll,4866,44,2,0,2,100.0%,36m
188,1,[TNLet]Spirit,4863,884,25,26,51,49.0%,36m
189,1,[PGSG]援娇少女妖梦酱,4861,0,0,1,1,0.0%,43m
190,3,Nuclear,4860,0,1,0,1,100.0%,13m
191,1,梵蒂冈法师,4853,140,4,5,9,44.4%,5m
192,1,[兔兔之家]Rain,4848,0,0,1,1,0.0%,16m
193,1,[Holygl]expertX,4847,0,0,2,2,0.0%,43m
194,1,[丨SLT丨]Yukki,4844,1813,82,75,157,52.2%,3m
194,1,[SK]臭打游戏的,4844,0,0,1,1,0.0%,11m
196,1,[武形秘仪]野德新之助,4843,0,1,0,1,100.0%,24m
196,1,[混元星际]接化发,4843,0,0,2,2,0.0%,37m
198,1,神族爸爸来了,4842,353,12,16,28,42.9%,3m
199,1,miss,4839,502,17,20,37,45.9%,36m
200,1,[SteEng]Maru,4838,0,0,1,1,0.0%,36m
201,1,[吉大纱窗]喵帕斯,4830,0,0,1,1,0.0%,6m
202,1,ExcepTiAN,4829,231,9,8,17,52.9%,3m
203,1,[五月花]llllllllllll,4828,1066,51,43,94,54.3%,11m
204,1,king,4825,0,0,1,1,0.0%,36m
205,1,YaoYe,4824,0,0,1,1,0.0%,24m
206,1,[SJZZ]Science,4823,269,7,11,18,38.9%,16m
207,1,[i5]希丝特莉亚,4822,0,1,0,1,100.0%,7m
208,1,[我们是无敌的]Hiro,4818,1814,138,113,251,55.0%,3m
208,1,[丨SLT丨]陈忱只会跳鸡猎,4818,1557,103,35,138,74.6%,3m
210,1,llllllllllll,4816,0,1,0,1,100.0%,36m
211,1,[甜甜圈]牵绊,4815,1067,50,40,90,55.6%,3m
212,1,[FDSJ]密苏里号,4812,46,2,0,2,100.0%,43m
212,1,[Hiiro]橘猫,4812,0,1,0,1,100.0%,9m
214,1,[堕天使之翼]堕落的天使,4811,0,0,1,1,0.0%,6m
215,1,Nakiami,4810,404,89,73,162,54.9%,43m
215,1,[四叶草]袖水,4810,476,31,4,35,88.6%,37m
215,1,[Gate]DarkPrincess,4810,0,0,1,1,0.0%,38m
218,1,[情切切意浓浓]丶情到深处自然浓,4809,0,0,1,1,0.0%,24m
219,1,[HDU]Scarb,4807,2061,96,77,173,55.5%,3m
219,1,救赎,4807,0,0,3,3,0.0%,38m
221,3,[WIK]llllllllll,4806,0,4,1,5,80.0%,26m
222,1,IIIIIIIIIIII,4804,2016,97,62,159,61.0%,3m
222,1,[Globus]栋栋,4804,473,34,6,40,85.0%,5m
222,1,[北京大学鸡协]Dream,4804,92,2,3,5,40.0%,36m
225,1,[SK]七月流火,4803,281,6,11,17,35.3%,5m
226,1,[Rhusky]GainsBoRough,4802,0,1,0,1,100.0%,5m
227,1,颜艺娘,4801,132,4,2,6,66.7%,11m
227,1,[Rhusky]苏梦梦,4801,0,1,0,1,100.0%,16m
229,3,[YM]Lovelin,4798,0,4,1,5,80.0%,26m
229,1,快刀手李奥,4798,0,0,1,1,0.0%,36m
229,3,blacktea,4798,0,0,1,1,0.0%,13m
232,1,[Beasty]IIIIIIIIIIII,4797,2586,278,271,549,50.6%,3m
232,1,雅雅国国王王雅雅,4797,1606,68,64,132,51.5%,5m
232,1,[Ours]Asasi,4797,634,39,28,67,58.2%,42m
232,1,[SoloAs]Evaluation,4797,0,1,0,1,100.0%,24m
236,1,[Marry]Luzian,4794,1271,121,91,212,57.1%,11m
236,1,Alien,4794,435,18,15,33,54.5%,5m
236,1,[四叶草]请输入姓名,4794,116,3,4,7,42.9%,36m
239,1,[TNLtr]夜刀神十香,4793,2398,180,165,345,52.2%,3m
239,1,[狂野战队]龘龘龘龘龘龘龘龘,4793,0,0,1,1,0.0%,6m
241,1,雅儿贝德,4792,1872,902,951,1853,48.7%,36m
242,1,[YA]INnoVation,4791,0,0,1,1,0.0%,6m
243,1,[SK]Enliven,4786,0,3,2,5,60.0%,5m
244,1,[猫奴真恶心]藤原娜娜,4785,44,1,2,3,33.3%,5m
245,1,[TNL]WaterMaster,4782,0,0,1,1,0.0%,43m
246,1,[丨SLT丨]accusation,4781,232,9,4,13,69.2%,3m
247,1,[KPG]可乐,4778,306,8,3,11,72.7%,37m
247,1,[我们的奇迹]西木野真姬,4778,0,0,1,1,0.0%,38m
249,1,TSGHickok,4777,184,4,4,8,50.0%,36m
249,1,Forward,4777,0,0,1,1,0.0%,36m
251,1,人帅吊又长,4776,396,13,6,19,68.4%,36m
252,1,[伊吹乱神]坑爹的世界,4772,664,32,5,37,86.5%,37m
252,1,[Hist]LittleND,4772,248,7,3,10,70.0%,8m
252,1,IIIIIIIIIIII,4772,0,0,1,1,0.0%,38m
255,1,[苍之彼方]有坂真白,4771,662,24,25,49,49.0%,8m
255,1,[飞龙隐刀司马]逍遥游,4771,42,2,1,3,66.7%,7m
257,1,[YR]Teocalli,4769,0,0,1,1,0.0%,43m
258,1,[昆明RANK]GWagen,4768,0,0,1,1,0.0%,11m
259,1,[打执政官找我]熊猫叫兽,4766,852,49,28,77,63.6%,11m
260,1,[NTSN]Quartette,4763,0,1,0,1,100.0%,6m
261,1,[虫族真不错]LuckTerran,4762,34,2,0,2,100.0%,37m
262,1,llllll,4758,0,0,1,1,0.0%,24m
263,1,[SK]远坂凛,4757,1250,43,45,88,48.9%,9m
263,1,[上帝的叹息]率性的十八,4757,0,0,1,1,0.0%,7m
265,1,[Ours]艾季的西瓜本人,4755,490,13,12,25,52.0%,5m
265,1,傻丫头是我的世界,4755,0,0,1,1,0.0%,43m
267,1,[威震天下]Bumblebee,4754,702,33,23,56,58.9%,37m
267,1,满堂花醉三千客,4754,496,20,10,30,66.7%,11m
269,1,[BJTU]FTDfangge,4753,42,1,1,2,50.0%,43m
270,1,[KPG2]Lotus,4752,165,3,1,4,75.0%,7m
270,1,红色的一只鹤,4752,0,0,1,1,0.0%,37m
272,1,IIIIIIIIIII,4745,515,22,12,34,64.7%,43m
273,1,[大佬请把鞋给]月之泪,4744,758,24,27,51,47.1%,5m
274,1,IIIIIIIIIIII,4742,2529,111,93,204,54.4%,3m
274,1,IIIIIIIIIIII,4742,481,14,5,19,73.7%,36m
276,1,高考完就回来,4741,46,2,2,4,50.0%,42m
277,1,[AnSwer]Titan,4740,2173,96,91,187,51.3%,36m
277,2,可爱风,4740,318,16,3,19,84.2%,27m
279,1,[STSTST]IIIIIIIIIIII,4739,1756,305,299,604,50.5%,24m
280,1,小小婕,4737,1128,46,39,85,54.1%,11m
280,1,Legendary,4737,327,12,5,17,70.6%,9m
282,1,[大佬请把鞋给]君心可晴,4736,2983,285,280,565,50.4%,37m
282,1,[西伯利亚土豆]结城明日奈,4736,495,16,11,27,59.3%,43m
282,1,[KPG]大爱许单言,4736,201,5,4,9,55.6%,7m
285,1,Dimension,4734,372,51,33,84,60.7%,16m
285,1,[东方乄红魔馆]绯色乄芙兰朵露,4734,0,0,1,1,0.0%,43m
287,1,[机械化冲我啊]ATP,4733,2712,483,417,900,53.7%,37m
287,1,[意外之外]TTTTT,4733,415,16,8,24,66.7%,9m
289,1,[BIG联盟]丶國家的栋梁,4732,0,1,0,1,100.0%,36m
290,1,[星河战舰]正义的老实人,4728,463,23,14,37,62.2%,43m
290,1,[AnSwer]GOCar,4728,0,0,1,1,0.0%,37m
292,1,NADA,4727,692,29,27,56,51.8%,36m
292,1,[GSC]HoPe,4727,440,28,16,44,63.6%,16m
292,1,二百斤大力士,4727,274,8,7,15,53.3%,6m
292,1,[SteEng]Paradox,4727,36,2,0,2,100.0%,38m
296,1,[杭州星际一哥]水粉最强五十哥,4726,324,11,15,26,42.3%,36m
296,1,[AT]NovaTerra,4726,0,1,1,2,50.0%,43m
298,1,[Marry]AlbaDiva,4725,0,0,1,1,0.0%,36m
299,1,[AnSwer]Scarecrow,4723,440,36,38,74,48.6%,42m
299,1,[SLTHHH]SADFANS,4723,667,29,24,53,54.7%,7m
301,1,[武汉理工大学]Serral,4721,540,15,16,31,48.4%,36m
301,1,[从来不吹牛]刘华强,4721,276,7,6,13,53.8%,11m
301,1,中二也要打星际,4721,0,1,0,1,100.0%,24m
304,1,Yrell,4720,649,35,8,43,81.4%,38m
304,1,[SoloAs]IIIIIIII,4720,204,12,4,16,75.0%,43m
306,1,月苍茫,4719,911,72,60,132,54.5%,42m
306,1,[丨SLT丨]血溅青衫,4719,1145,48,35,83,57.8%,36m
306,1,[Beasty]KayleStorM,4719,0,0,1,1,0.0%,36m
309,1,[yCm]YcM,4718,1095,67,44,111,60.4%,24m
310,1,[BGD]IIIIIIIII,4717,0,1,0,1,100.0%,5m
311,1,小战德业,4715,410,11,15,26,42.3%,37m
312,1,[奶嘴司马]IIIIIIIIIIII,4714,0,0,1,1,0.0%,37m
313,1,[海德单推协会]白痴,4713,356,9,9,18,50.0%,37m
313,1,[大佬请把鞋给]揽明月入怀,4713,284,7,15,22,31.8%,9m
315,1,发椿人,4712,1123,52,30,82,63.4%,11m
316,1,教练我想打星际,4711,0,0,1,1,0.0%,9m
317,1,[专干直播狗]女妖王,4710,2792,225,208,433,52.0%,8m
317,1,IIlllIIIll,4710,482,12,12,24,50.0%,11m
319,1,[星之公主]天之川绮罗,4705,431,17,19,36,47.2%,37m
319,1,[蓬莱伝説]花崎千雪,4705,0,0,1,1,0.0%,43m
319,1,[Tilt]Gloria,4705,0,0,1,1,0.0%,6m
322,1,TonsOfDmg,4704,0,0,1,1,0.0%,38m
323,1,[暴雪我是你爹]lllllllll,4703,312,8,9,17,47.1%,24m
324,1,[五月花]TieNan,4702,232,7,7,14,50.0%,24m
325,1,我是一只章鱼,4697,0,1,0,1,100.0%,24m
326,1,[HST]墨染,4696,0,0,2,2,0.0%,8m
327,1,绾绾,4694,401,10,3,13,76.9%,7m
328,1,IIIIIIIIIIII,4693,1186,191,163,354,54.0%,24m
329,1,[星际丶夜總會]蟲蟲,4691,478,77,1,78,98.7%,5m
330,1,[保国尾汁酱]SarreL,4690,698,19,19,38,50.0%,6m
331,1,EnolaHolmes,4688,46,1,1,2,50.0%,5m
332,1,[奥鲁斯的人选]药石无医,4687,0,0,1,1,0.0%,38m
332,3,llllllllllll,4687,0,0,4,4,0.0%,19m
334,1,[凯哥集团]灭霸,4686,0,0,1,1,0.0%,36m
334,1,[那里不可以]Croaker,4686,0,0,1,1,0.0%,8m
336,1,吴西诗,4685,290,9,6,15,60.0%,6m
337,1,[四叶草]面具人,4684,72,3,0,3,100.0%,42m
338,1,[汉军将至]中国玩家,4683,2085,95,103,198,48.0%,9m
338,1,[新宝岛]龙玉涛,4683,0,0,1,1,0.0%,8m
340,1,[Tsk]剑锋,4676,2381,125,115,240,52.1%,7m
341,1,[PTB]诗乃,4675,0,1,0,1,100.0%,8m
341,1,[SC2近卫军]战门封雪,4675,0,0,1,1,0.0%,5m
343,1,王牌指挥官四号,4674,0,0,1,1,0.0%,8m
344,3,[只用人类]人类,4673,0,1,0,1,100.0%,24m
345,1,llllllllllll,4671,92,3,4,7,42.9%,36m
345,1,[基佬协会]这周丶曰你有空吗,4671,0,0,1,1,0.0%,9m
347,1,[塔达林净化者]夜雨声烦,4670,402,10,16,26,38.5%,11m
347,1,[山东蓝翔]机械熊猫,4670,0,0,1,1,0.0%,6m
349,1,[天麻SGG]间宫羽咲,4669,0,0,2,2,0.0%,43m
350,1,利威尔兵长,4667,134,4,2,6,66.7%,42m
350,1,[RvA]Proton,4667,0,2,2,4,50.0%,27m
350,1,[RwGami]良辰不喜,4667,0,0,1,1,0.0%,9m
353,3,llllllllllll,4666,90,3,4,7,42.9%,19m
354,1,金甲虫赢妹子了吗,4665,318,8,9,17,47.1%,42m
355,1,[qweqwe]二块钱的人,4664,2326,101,68,169,59.8%,7m
355,1,凯撒,4664,308,19,11,30,63.3%,42m
355,1,[NavyF]isenguard,4664,606,18,16,34,52.9%,9m
358,1,[SCAP]PioNeeR,4663,202,6,7,13,46.2%,5m
359,1,[KPG2]OhhhYeah,4662,304,9,10,19,47.4%,38m
359,1,[Hist]采风者,4662,0,0,1,1,0.0%,11m
361,1,[樱火之森]乱舞,4659,144,3,22,25,12.0%,36m
362,1,[兔兔之家]败北清兔兔,4657,94,4,2,6,66.7%,7m
363,1,[浙江工商大学]Sarrrrrright,4656,1191,44,39,83,53.0%,37m
363,1,江东小霸王,4656,0,1,0,1,100.0%,16m
365,1,[FAFA]EKnife,4653,0,0,1,1,0.0%,8m
366,1,难返曾经,4651,307,9,14,23,39.1%,43m
367,1,[苍之彼方]鸢泽美咲,4650,32,1,5,6,16.7%,11m
368,1,[求狙击]奥利给,4649,0,1,0,1,100.0%,5m
368,1,[tiandi]Mercury,4649,42,1,1,2,50.0%,36m
368,1,CuMi,4649,0,0,1,1,0.0%,36m
371,1,[IMRTS]Killy,4648,1531,258,252,510,50.6%,6m
371,1,[FDSJ]WolfAlice,4648,158,4,8,12,33.3%,36m
371,1,[Chivo]llllllllllll,4648,0,1,0,1,100.0%,16m
374,1,凤凰院番茄,4646,0,0,1,1,0.0%,43m
375,1,[初雪的樱花]小坂井绫,4642,204,6,5,11,54.5%,16m
375,1,[四叶草]巴西烤鸡,4642,48,4,2,6,66.7%,16m
377,1,星空凛凛凛凛凛凛,4641,628,21,18,39,53.8%,7m
378,1,NICHOLASHK,4637,258,8,7,15,53.3%,11m
378,1,IIIIIIIIIIII,4637,88,3,2,5,60.0%,43m
378,1,IIIIIIIIIIII,4637,0,1,0,1,100.0%,8m
381,1,[KPG]IIIIIIIIIIII,4636,1753,92,49,141,65.2%,43m
381,1,[FPT]白银萌新,4636,44,1,3,4,25.0%,24m
383,1,[BGD]一剑霜寒十四州,4635,352,10,9,19,52.6%,38m
383,1,llllllllllll,4635,42,2,0,2,100.0%,36m
385,1,[狗头狗头]shino,4634,0,1,0,1,100.0%,7m
385,1,[不讲武德]郑德重,4634,0,0,1,1,0.0%,19m
387,1,[哔翻天梯鸡]Mephisto,4633,1350,107,41,148,72.3%,37m
387,1,[星河气象学院]谁狗谁孙子,4633,0,1,1,2,50.0%,6m
389,1,小和的狐狸,4632,0,1,0,1,100.0%,8m
390,1,lllllIIIll,4630,40,2,2,4,50.0%,9m
391,1,[B站党人]MarineKing,4629,190,6,3,9,66.7%,9m
392,1,[闪电尾汁酱]贪婪的星灵,4628,950,36,24,60,60.0%,36m
392,1,[Thpj]番茄,4628,220,7,2,9,77.8%,36m
394,1,llllllllllll,4627,2840,118,124,242,48.8%,6m
394,1,白赢到黄金,4627,0,1,0,1,100.0%,8m
394,1,llllllllllll,4627,0,0,2,2,0.0%,7m
397,2,sue,4626,121,7,1,8,87.5%,25m
397,1,[你已经死啦]Ccli,4626,292,7,14,21,33.3%,36m
399,1,我从不狗人,4624,1420,57,48,105,54.3%,24m
399,1,[OLY]Invincible,4624,1112,42,40,82,51.2%,8m
399,1,Dyna,4624,320,22,3,25,88.0%,38m
399,1,[80后丶]阔落加冰才好喝,4624,0,0,1,1,0.0%,43m
399,1,[Tilt]蛋奶星星,4624,0,0,1,1,0.0%,24m
404,1,[SCAP]innaba,4623,1576,109,112,221,49.3%,24m
405,1,[星选组]csgosclol,4622,0,0,1,1,0.0%,36m
406,2,thxsub,4621,211,10,11,21,47.6%,22m
407,1,[KPG]IIIIIIIIIII,4619,96,4,4,8,50.0%,19m
408,1,[惊天浪涛杀]垃圾人族如何生存,4616,2841,188,184,372,50.5%,38m
408,1,怪物史莱克,4616,470,13,15,28,46.4%,8m
410,1,[CLaffy]高远寒,4615,464,13,10,23,56.5%,16m
411,1,you,4614,2261,109,106,215,50.7%,7m
412,1,[Vgirls]云浅雪,4613,2246,99,94,193,51.3%,42m
412,1,[崩坏世界]千手蛟天,4613,0,0,1,1,0.0%,43m
412,1,[SK]小娇妻,4613,0,0,1,1,0.0%,42m
415,1,[Hist]一一得三,4611,914,42,23,65,64.6%,8m
415,1,男同竟是所有人呢,4611,518,14,12,26,53.8%,37m
415,1,IIIIIIIII,4611,286,8,9,17,47.1%,43m
415,1,[SoIoAs]小笨比血花缭乱,4611,72,3,1,4,75.0%,7m
419,1,www,4610,2540,319,320,639,49.9%,42m
420,1,[金灿灿狙击队]FoolishYX,4609,82,2,2,4,50.0%,16m
420,1,[iMuC]CuMi,4609,0,0,1,1,0.0%,37m
422,1,[四叶草]wwww,4608,2868,120,114,234,51.3%,16m
422,1,[KPG]龟田一峰,4608,994,36,28,64,56.2%,37m
422,1,小顾顾,4608,582,16,17,33,48.5%,7m
425,1,越前龙雅,4607,374,12,9,21,57.1%,38m
425,1,汉霖,4607,0,0,1,1,0.0%,16m
425,1,[南京工业大学]飞翔的荷兰人,4607,0,0,1,1,0.0%,24m
428,1,金沙,4606,2908,223,211,434,51.4%,16m
429,1,[雨何时会停]Akiha,4605,770,23,20,43,53.5%,16m
429,1,[哔翻天梯鸡]MarineKing,4605,0,0,1,1,0.0%,5m
431,1,[NT]南京枪兵王,4603,42,2,2,4,50.0%,5m
431,1,[SK]LittleTuzki,4603,0,1,0,1,100.0%,36m
433,1,[HustSC]灬烈艹焰灬,4601,1397,66,58,124,53.2%,5m
433,1,[谐逼]成都毒奶色,4601,0,0,2,2,0.0%,24m
435,1,YuNMaster,4599,2104,164,175,339,48.4%,43m
435,1,CapPucCinO,4599,2907,161,162,323,49.8%,8m
437,1,[Sv]羽瀨川小笛,4597,608,19,22,41,46.3%,38m
438,1,[新疆烤肉兄弟]杭州烤肉鸽,4596,2671,124,95,219,56.6%,9m
439,1,[Hist]llllllllllll,4595,1141,46,39,85,54.1%,5m
439,1,叶枫,4595,26,2,1,3,66.7%,36m
439,1,Ares,4595,0,0,2,2,0.0%,43m
442,1,人族活该断手,4594,0,0,1,1,0.0%,43m
443,1,[Shawk]Kirito,4593,0,1,0,1,100.0%,36m
443,1,MKP,4593,0,0,2,2,0.0%,16m
445,1,[SK]幻妖狼,4590,2721,229,237,466,49.1%,42m
445,1,[Thpj]上海人形的弟弟,4590,652,23,21,44,52.3%,24m
445,1,[iGSCII]iGMacSed,4590,794,23,35,58,39.7%,43m
448,1,[SoloAs]思然,4586,0,0,1,1,0.0%,36m
449,1,IIIIIIIIIIII,4584,0,0,1,1,0.0%,24m
450,1,末日为何不来,4583,38,1,2,3,33.3%,24m
451,1,[一血大队]又土又木,4581,0,0,1,1,0.0%,42m
452,1,[SK]Gloriam,4580,1024,57,58,115,49.6%,43m
452,1,[WIE]谐星老王,4580,0,0,1,1,0.0%,16m
454,1,NuclearPiano,4579,106,7,0,7,100.0%,37m
455,1,[KSARet]CNbomber,4578,124,4,8,12,33.3%,38m
455,1,寒风起站在城门外,4578,0,0,1,1,0.0%,8m
457,1,[Marry]电风扇,4577,1012,50,31,81,61.7%,36m
457,1,炊事班班长,4577,0,0,1,1,0.0%,36m
459,1,[胖胖白白球]汗小毛,4576,775,32,25,57,56.1%,24m
459,1,[高樂集团]天堂小爱,4576,192,6,3,9,66.7%,7m
459,1,[内蒙古海军]内蒙古人皇,4576,42,2,2,4,50.0%,42m
459,1,[东谐爱西毒]杨威利的红茶,4576,0,0,1,1,0.0%,37m
459,1,[i5]伊赫季安德尔,4576,0,0,1,1,0.0%,38m
464,1,[鸡家军]WJCDJCSFS,4575,0,0,1,1,0.0%,37m
465,1,[BGD]辰空星海,4573,814,34,24,58,58.6%,5m
466,1,llllllllllll,4572,522,25,23,48,52.1%,7m
466,1,[一库]回忆余温,4572,214,20,18,38,52.6%,7m
468,1,[在下小学生]小李,4571,1682,87,52,139,62.6%,42m
469,1,[四叶草]Skyhigh,4570,831,44,13,57,77.2%,36m
469,1,[OLY]Oberonia,4570,718,31,26,57,54.4%,8m
471,1,你不要过来啊,4568,375,14,14,28,50.0%,36m
471,1,全家老小一波流,4568,114,4,4,8,50.0%,42m
473,1,IIIIIIIIIII,4566,2862,122,123,245,49.8%,24m
473,1,Rengoku,4566,605,30,24,54,55.6%,9m
475,1,你走的那个晚上,4564,1019,57,18,75,76.0%,43m
476,1,llllllllllll,4563,90,2,10,12,16.7%,42m
476,1,zwM,4563,85,1,1,2,50.0%,9m
478,1,[SK]十六夜咲夜,4562,526,17,27,44,38.6%,24m
479,1,Dhchip,4560,2853,368,370,738,49.9%,38m
479,1,[永不灭的战火]嘤嘤嘤嘤嘤龙,4560,0,0,1,1,0.0%,7m
481,3,魔法少女夏虫语冰,4558,351,19,0,19,100.0%,17m
481,1,[KPG]猥琐玩,4558,112,4,6,10,40.0%,43m
483,1,IIIIIIIIIIII,4557,2587,194,199,393,49.4%,5m
484,1,[OLY]Armeria,4553,182,5,9,14,35.7%,7m
484,1,苦瓜,4553,74,3,3,6,50.0%,16m
486,1,[RyH键谈坊]RyHNewBee,4550,2022,77,75,152,50.7%,43m
486,2,[秋毫第七分队]llllllllllll,4550,118,4,3,7,57.1%,15m
488,1,帅哥的帅,4545,487,23,14,37,62.2%,36m
488,1,IIIIIIIIIIII,4545,303,14,9,23,60.9%,42m
488,2,[TossSE]SuperMarine,4545,0,0,1,1,0.0%,15m
491,1,[希靈使徒]秋月爱莉,4542,565,22,12,34,64.7%,5m
492,1,[HustSC]llllllllllll,4540,317,31,24,55,56.4%,24m
493,1,[KPG]巢导,4539,783,58,13,71,81.7%,11m
493,1,[CA神教]我是个好人,4539,298,8,21,29,27.6%,36m
495,2,[未临桑夏]丨楠花灬夏开丶,4538,0,0,1,1,0.0%,7m
496,1,[神族赢不了]IIIIII,4537,110,3,13,16,18.8%,38m
497,1,[SC2ACG]IIIIIIIIIIII,4535,282,27,12,39,69.2%,36m
497,3,[Thpj]魔法樱桃酱,4535,0,0,1,1,0.0%,36m
497,2,[苏大星际]Unstoppable,4535,0,0,1,1,0.0%,15m
500,1,启明星的指引,4534,1521,50,62,112,44.6%,36m
500,1,[iN]哀丶殇,4534,0,0,2,2,0.0%,38m
502,1,魔法少女孙一峰,4531,48,3,4,7,42.9%,41m
503,2,SeFio,4530,0,1,1,2,50.0%,27m
503,2,maybemiss,4530,0,0,1,1,0.0%,25m
505,1,[0点到为止0]打星际我只选神族,4528,2413,118,122,240,49.2%,43m
506,2,[萌萌哒萌萌哒]旋转跳跃我闭着眼,4527,0,0,1,1,0.0%,7m
507,1,tboneC,4526,160,5,7,12,41.7%,24m
508,1,[兄弟会]wshwk,4523,1124,42,44,86,48.8%,42m
508,1,周咏慷和傅熙莱,4523,360,16,11,27,59.3%,36m
510,2,[Ness]SONOLIA,4521,0,0,1,1,0.0%,39m
511,2,[ANNEX]人皇丶洛萨,4518,60,2,3,5,40.0%,43m
512,2,[猎妈人联盟]神奇猎马人,4517,343,45,35,80,56.2%,43m
512,1,[吹毛]沧海客,4517,96,2,4,6,33.3%,36m
512,2,[TAPC]灬就是馋她身子,4517,0,1,0,1,100.0%,25m
512,2,代号独狼,4517,0,0,1,1,0.0%,15m
512,3,bbbyong,4517,0,0,4,4,0.0%,8m
517,2,[混元太极星际]MagicTerran,4516,42,2,2,4,50.0%,39m
518,2,破碎的心惊不起,4515,994,60,8,68,88.2%,27m
518,1,[我们是无敌的]我是球霸,4515,364,11,14,25,44.0%,43m
518,1,[GLJLU]Photon,4515,133,3,4,7,42.9%,36m
521,1,[KPG]Soskovka,4514,2177,92,78,170,54.1%,43m
522,1,提馏线方程,4513,195,4,6,10,40.0%,24m
522,2,[SCAP]魔神剑客,4513,0,0,1,1,0.0%,39m
524,2,[i9]AlphaStar,4511,243,9,7,16,56.2%,39m
524,3,[DESUWA]橘一希尔芬一福特,4511,0,0,1,1,0.0%,9m
526,2,[SC2近卫军]帝国恶灵,4510,891,44,12,56,78.6%,15m
526,2,[SK]古明地觉,4510,529,26,15,41,63.4%,15m
526,2,[库啵啵库啵]快乐的小鸡,4510,0,2,3,5,40.0%,15m
529,2,[北京大学鸡协]芭芭拉冲鸭,4509,50,2,3,5,40.0%,43m
529,2,Ushio,4509,0,0,1,1,0.0%,39m
531,2,浮生如梦,4508,0,0,1,1,0.0%,22m
532,1,北风尘,4506,44,1,4,5,20.0%,5m
532,2,苏沫倩,4506,0,0,1,1,0.0%,22m
534,1,DragonRain,4505,38,2,4,6,33.3%,43m
535,2,[皇子]Fluctus,4504,1095,67,9,76,88.2%,25m
535,2,[四叶草]漫长总是不满,4504,88,4,1,5,80.0%,25m
537,2,[JinAir]Maru,4503,0,0,1,1,0.0%,7m
538,2,[AnSwer]Rogue,4501,172,7,4,11,63.6%,25m
539,1,[TeamLP]INforMaTion,4499,2582,128,130,258,49.6%,43m
540,2,toM,4498,64,2,2,4,50.0%,7m
541,2,烟雨潇湘,4497,87,2,0,2,100.0%,7m
541,2,[Marry]恍然如梦,4497,0,1,0,1,100.0%,27m
543,2,沙加天舞,4494,991,102,86,188,54.3%,3m
543,2,刘杀戮怒火重生,4494,0,0,1,1,0.0%,3m
545,1,SolidSnake,4493,0,0,6,6,0.0%,37m
546,2,[YA]FaNsorSK,4489,0,0,1,1,0.0%,15m
547,2,[血盟骑士团k]UTAHA,4488,14,2,2,4,50.0%,22m
548,2,珈百璃,4487,0,0,1,1,0.0%,39m
549,2,[加油大魔王]阿尔菲丶妃儿,4486,542,26,31,57,45.6%,39m
549,2,阿龙龙,4486,0,1,0,1,100.0%,15m
551,2,Marineklng,4485,108,4,5,9,44.4%,39m
552,2,八十军棍算个屁,4484,0,0,1,1,0.0%,25m
553,1,isafire,4483,0,1,0,1,100.0%,19m
553,2,[Aaron]阿荣,4483,0,0,1,1,0.0%,43m
555,2,[SK]虚火泡泡,4482,395,17,11,28,60.7%,27m
556,2,[Beauty]半澤直樹,4481,46,3,0,3,100.0%,15m
556,2,全民情敌,4481,0,1,0,1,100.0%,3m
558,1,llllllllllll,4480,564,30,26,56,53.6%,16m
558,1,[顺德有高铁]顺德小刘鸭,4480,0,0,1,1,0.0%,42m
560,2,[金灿灿狙击队]TOTO,4479,76,3,5,8,37.5%,22m
560,2,南无观世音菩萨,4479,0,0,1,1,0.0%,15m
560,2,[純槍兵就宗]水無月笛,4479,0,0,4,4,0.0%,3m
563,2,为早苗收集信仰,4478,0,0,1,1,0.0%,43m
564,3,[IMRTS]Lin,4477,359,20,0,20,100.0%,25m
565,1,[别搜内战了]LJQ,4476,101,2,7,9,22.2%,7m
566,1,[LOHv]AYGJ,4475,954,37,35,72,51.4%,16m
567,1,llllllllllll,4474,879,58,58,116,50.0%,43m
568,3,[惠软]冰堂美智留,4472,0,1,0,1,100.0%,18m
568,2,[YT]乌克兰总统,4472,0,0,1,1,0.0%,39m
570,1,[鸡家军]喵喵喵,4471,2612,184,183,367,50.1%,7m
570,1,[TFBOY]优雅贵族王源,4471,754,24,29,53,45.3%,37m
570,3,misery,4471,169,5,1,6,83.3%,24m
570,2,[黯然神伤]TheEndOfWar,4471,0,0,3,3,0.0%,15m
574,1,含泪飞基地,4470,92,7,7,14,50.0%,38m
574,2,[启元星际门]冈田和睦,4470,114,5,1,6,83.3%,15m
576,1,[ToHo]biuren,4469,2017,101,111,212,47.6%,43m
576,2,Madrior,4469,1434,70,54,124,56.5%,25m
578,3,[GAMERS]希尔梅莉亚,4467,0,0,1,1,0.0%,25m
579,2,[专打嘤嘤怪]Tassadar,4466,725,86,49,135,63.7%,15m
579,2,[Beasty]FLInovation,4466,699,49,53,102,48.0%,43m
581,2,[CAM]Octopus,4465,343,15,1,16,93.8%,3m
582,1,㞺㞺㞺㞺㞺㞺㞺㞺,4464,478,13,22,35,37.1%,8m
582,3,[rbqlvy]电击杀冒脸,4464,0,0,1,1,0.0%,13m
582,2,一个大菠萝,4464,0,0,1,1,0.0%,15m
585,2,llllllllllll,4462,404,19,20,39,48.7%,22m
586,2,[HustSC]beee,4461,452,28,35,63,44.4%,3m
587,1,[SK]ZerO,4460,2795,379,375,754,50.3%,8m
587,3,[无銘之辈]Evidour,4460,406,21,3,24,87.5%,41m
587,2,[久奈浜Fc部]ARlMashiro,4460,380,15,7,22,68.2%,25m
587,2,[SK]人族皇帝毁灭星际,4460,104,4,3,7,57.1%,7m
587,2,[龙王氵]AnXin,4460,0,1,0,1,100.0%,3m
592,2,智哥,4459,273,10,5,15,66.7%,39m
592,2,老婆饼没老婆,4459,0,0,1,1,0.0%,15m
594,2,[kanna丨]SpeakNow,4458,189,10,12,22,45.5%,43m
594,1,BiliBiliGoGo,4458,263,8,4,12,66.7%,19m
594,2,iGXiGua,4458,56,3,2,5,60.0%,3m
594,2,[严惩恶霸]徐智秀,4458,0,0,5,5,0.0%,39m
598,1,猪猪党,4456,734,24,34,58,41.4%,7m
599,2,混元星际大师兄,4454,0,1,1,2,50.0%,15m
600,1,[Solo]nEOiMAGING,4453,0,0,1,1,0.0%,27m
601,2,小破,4452,2057,98,71,169,58.0%,25m
601,3,[挚爱柔情]只谈情不说爱,4452,350,19,1,20,95.0%,19m
603,1,第二场雪,4451,2565,191,187,378,50.5%,42m
603,2,[四叶草]千年之狐,4451,2570,173,115,288,60.1%,25m
605,1,IIIIIIIIIIII,4449,2788,302,303,605,49.9%,11m
605,1,[享受星际]极光永夜,4449,457,15,17,32,46.9%,38m
607,2,修地堡单矿一波,4448,1143,53,33,86,61.6%,25m
607,2,[Sv]Liang,4448,572,22,26,48,45.8%,15m
607,2,[我们是无敌的]天生贵人霍去病,4448,26,2,3,5,40.0%,43m
610,2,谁知那一夜,4447,0,0,1,1,0.0%,7m
611,1,ABigFaceCat,4446,2816,554,584,1138,48.7%,11m
611,2,[SoloAs]萌宝宝,4446,0,1,5,6,16.7%,39m
613,2,IIIIIIIIIIII,4445,661,36,14,50,72.0%,15m
614,2,[北京城管]GUGU,4444,2605,114,117,231,49.4%,7m
614,1,[killer]旭东给九幺口口,4444,1943,102,108,210,48.6%,7m
614,1,小海,4444,336,7,0,7,100.0%,10m
617,1,inflame,4443,1012,40,41,81,49.4%,42m
617,1,llllllllllll,4443,0,2,3,5,40.0%,20m
619,2,[海韵]妤柃,4440,0,4,1,5,80.0%,27m
620,2,[降智光环]星空幸,4438,52,2,1,3,66.7%,7m
621,2,GTV,4437,775,47,11,58,81.0%,15m
621,1,嘤嘤嘤嘤嘤诺威欣,4437,805,28,34,62,45.2%,9m
621,2,[DLJ]IIIIIIIIIIII,4437,0,0,1,1,0.0%,39m
624,1,[KPG]ForeverVio,4436,2803,199,175,374,53.2%,8m
624,2,[P1]Fragment,4436,2189,137,128,265,51.7%,25m
624,2,llllllllllll,4436,0,1,0,1,100.0%,15m
627,1,[泰古]taenggu,4434,2686,191,202,393,48.6%,37m
627,2,[五月花]千年之墨,4434,1117,57,27,84,67.9%,27m
627,2,soyfans,4434,90,5,5,10,50.0%,43m
630,2,逼良为娼,4433,0,0,1,1,0.0%,15m
630,2,[傲气雄鹰]磊本座,4433,0,0,1,1,0.0%,3m
632,2,[SK]llllllllllll,4432,1295,58,54,112,51.8%,15m
632,2,[Bstar]物述有栖,4432,342,16,16,32,50.0%,15m
632,2,[人族是我爹]仲夏夜粉丝,4432,78,3,4,7,42.9%,3m
635,2,IIIIIIIIIIII,4431,0,0,1,1,0.0%,43m
636,2,[华尔街股神]查理芒格,4429,0,1,1,2,50.0%,25m
637,2,彩虹冰淇淋,4428,751,35,29,64,54.7%,43m
637,3,[皇室联盟]匿于情苦,4428,360,19,3,22,86.4%,19m
637,1,[武德]年轻人,4428,372,10,21,31,32.3%,7m
640,2,野生胖虎,4427,46,2,1,3,66.7%,7m
641,2,[SC2近卫军]llllllllllll,4426,0,0,1,1,0.0%,15m
642,2,[SxAK]Venom,4425,0,1,0,1,100.0%,7m
642,2,[今晚谁是鸡]皇权贵族殺馬特,4425,0,0,1,1,0.0%,39m
642,3,[登陆是无敌哒]小乔要努力变强,4425,0,0,1,1,0.0%,9m
645,2,ANARKI,4424,2608,456,475,931,49.0%,43m
645,2,[NGA考察站]Vegetable,4424,480,45,28,73,61.6%,39m
647,2,暗龙,4423,398,25,10,35,71.4%,27m
648,2,[海德单推协会]痴人说梦,4422,1183,73,15,88,83.0%,3m
649,2,IIIIIIIIIIII,4419,264,13,13,26,50.0%,15m
650,2,[TeamLP]医生姐姐来了,4418,370,140,85,225,62.2%,15m
650,2,刮哥送幸福,4418,227,9,4,13,69.2%,15m
650,2,大徐饿了要吃饭,4418,0,0,1,1,0.0%,43m
653,2,[帝国萌新联盟]柚子木羽,4417,0,0,1,1,0.0%,15m
654,2,[武汉理工大学]你甚至不叫我教父,4416,755,44,32,76,57.9%,15m
654,2,[二狗星际]百地希留耶,4416,0,0,1,1,0.0%,43m
656,2,啊希吧萌萌哒,4415,412,22,3,25,88.0%,27m
656,2,[永不灭的战火]Eternal,4415,0,0,1,1,0.0%,43m
658,2,[ZJU]曹小达,4414,1907,146,138,284,51.4%,43m
658,2,[魔虫教主万岁]hff,4414,510,27,8,35,77.1%,15m
658,2,迷雾中的幽灵,4414,290,11,9,20,55.0%,15m
661,2,[魔法少女小屋]Sakana,4413,400,24,24,48,50.0%,3m
661,2,[Rhusky]IIIIIIIIIII,4413,476,22,17,39,56.4%,43m
661,2,awswq,4413,0,0,3,3,0.0%,27m
664,2,杆杠真的烦,4412,0,0,1,1,0.0%,25m
665,2,行天夯,4410,0,0,1,1,0.0%,15m
666,2,alpha,4407,109,3,0,3,100.0%,7m
667,2,[逗B之家]Marine,4406,0,0,2,2,0.0%,7m
668,2,[传说萌娘团]IIIIIIIIIIII,4404,1250,200,200,400,50.0%,22m
668,2,llllllllll,4404,154,6,1,7,85.7%,3m
668,2,[萌萌嗒]Slaughter,4404,0,0,1,1,0.0%,43m
671,2,Akrios,4403,1585,71,77,148,48.0%,22m
671,1,ZooM,4403,234,8,14,22,36.4%,24m
671,2,DKz,4403,105,5,4,9,55.6%,39m
671,2,KinaTsui,4403,0,0,1,1,0.0%,22m
675,1,[Ogier]Deadpool,4402,1434,55,67,122,45.1%,43m
676,1,麥克晰米莉安,4401,2664,143,155,298,48.0%,7m
676,3,比利王,4401,364,19,3,22,86.4%,27m
676,2,[WokenD]KeyNG,4401,115,3,0,3,100.0%,22m
676,2,[Rhusky]香风智乃,4401,105,3,1,4,75.0%,43m
676,1,Summer,4401,0,0,6,6,0.0%,39m
681,1,别说话,4400,2280,88,106,194,45.4%,43m
681,2,[Beasty]llllllllllll,4400,206,8,8,16,50.0%,39m
683,1,NoTime,4398,2189,90,88,178,50.6%,36m
683,2,比尔盖茨,4398,0,0,1,1,0.0%,22m
685,2,[泰伦]QingRen,4397,371,26,12,38,68.4%,15m
685,2,吟风弄月,4397,276,16,10,26,61.5%,22m
687,1,君永夜,4396,300,16,0,16,100.0%,5m
687,2,群鸦的盛宴,4396,28,2,5,7,28.6%,15m
689,2,IIIIIIIIIIII,4394,96,3,0,3,100.0%,25m
690,2,[享受星际]南京胡翔,4393,360,13,15,28,46.4%,15m
691,2,CMStormPolt,4392,315,16,11,27,59.3%,15m
691,2,HaRa,4392,14,2,0,2,100.0%,43m
691,2,[我们是无敌的]ZergFans,4392,0,1,0,1,100.0%,27m
694,2,[SUSTC]ChuYi,4391,741,34,31,65,52.3%,25m
695,1,[薄暮之光]慕笺年,4390,1792,124,111,235,52.8%,38m
695,2,llllllllllll,4390,0,0,1,1,0.0%,7m
697,3,你的飞机我的梦,4389,403,21,1,22,95.5%,37m
698,2,[黄漫老师]东风谷早苗,4386,236,9,6,15,60.0%,22m
699,2,llllllllllll,4385,1482,138,85,223,61.9%,15m
699,2,二次元打你吗星际,4385,0,0,4,4,0.0%,15m
701,2,星际争霸,4384,20,1,2,3,33.3%,15m
701,2,[星之所在RI]不讲伍德的夹心酱,4384,0,0,1,1,0.0%,27m
703,2,[镇魂]死神的终结曲,4382,0,1,0,1,100.0%,43m
703,2,银雪,4382,0,1,0,1,100.0%,43m
703,2,[驻马店侠盗]河南人之井盖传送,4382,32,1,5,6,16.7%,39m
706,2,ShiinaKumo,4381,1571,76,57,133,57.1%,15m
706,2,IIIIIIIIIIII,4381,161,7,5,12,58.3%,15m
706,2,LoveX,4381,0,1,0,1,100.0%,22m
709,2,[民工俱乐部]旱地拔葱,4380,0,0,1,1,0.0%,16m
710,2,软萌萝莉小仙,4378,1013,48,42,90,53.3%,39m
710,2,楚休红,4378,581,42,40,82,51.2%,43m
710,2,HongLian,4378,507,25,13,38,65.8%,3m
710,1,KulaLA,4378,0,0,2,2,0.0%,12m
714,2,[SK]INnoVation,4377,0,0,1,1,0.0%,22m
715,1,[传说萌娘团]五十块的好兄弟,4375,97,4,3,7,57.1%,20m
716,2,我叫随机,4374,445,32,24,56,57.1%,43m
716,2,[四叶草]卡亚,4374,243,23,21,44,52.3%,15m
716,2,[泰伦]LaLa,4374,346,17,11,28,60.7%,27m
716,2,[L4WUDU]GAI,4374,200,9,4,13,69.2%,3m
716,2,[咏春]枪兵王,4374,0,1,0,1,100.0%,27m
721,2,Evil,4373,247,38,24,62,61.3%,15m
721,2,Clem,4373,441,22,16,38,57.9%,7m
721,2,Aduin,4373,0,0,1,1,0.0%,7m
724,1,[柠哥nb]呜咩,4370,337,16,1,17,94.1%,14m
725,3,Freedom,4369,105,3,1,4,75.0%,37m
726,2,[HHHFAN]rewhitefans,4368,85,3,0,3,100.0%,27m
726,2,櫻島麻衣,4368,18,2,1,3,66.7%,25m
726,2,请不要修我地堡,4368,0,0,1,1,0.0%,16m
729,2,IIIIIIIIIIII,4367,472,24,13,37,64.9%,7m
729,2,Errorist,4367,200,10,17,27,37.0%,22m
729,2,是金子涵呀,4367,135,5,1,6,83.3%,39m
729,2,[海德单推协会]一个笨比,4367,0,1,2,3,33.3%,39m
729,2,AutoWin,4367,0,0,1,1,0.0%,20m
734,2,[我们是无敌的]菜鸟克高手,4366,2218,188,143,331,56.8%,39m
734,2,[KPG]Misslavendar,4366,830,74,72,146,50.7%,15m
734,2,叫我影魔哥,4366,1064,49,29,78,62.8%,27m
737,2,Peanut,4364,93,4,1,5,80.0%,22m
737,2,[KSARet]壹直,4364,0,1,0,1,100.0%,22m
739,2,[Holygl]McNeil,4363,0,0,1,1,0.0%,43m
739,2,[NT]孤狼,4363,0,0,1,1,0.0%,16m
741,2,狂野之裤,4362,2609,121,103,224,54.0%,25m
741,2,[NT]Kotori,4362,112,3,3,6,50.0%,39m
743,1,[高樂集团]可爱豆腐乳,4361,1273,44,54,98,44.9%,43m
743,2,[兔兔之家]超级蓝兔兔,4361,115,5,3,8,62.5%,16m
743,2,[写意山河]万山红遍,4361,0,0,1,1,0.0%,7m
746,2,ATC,4360,0,0,1,1,0.0%,15m
747,3,[某科学的]可乐丶九条,4359,263,21,2,23,91.3%,36m
748,1,我爱黎明,4357,0,0,1,1,0.0%,16m
749,2,[好多小兔兔]MIB,4356,914,41,34,75,54.7%,16m
750,2,[169cm]雷神之物,4355,1806,83,78,161,51.6%,3m
750,2,[Beasty]llllllllllll,4355,460,20,24,44,45.5%,3m
750,2,因为我添腹一饼,4355,146,8,4,12,66.7%,7m
750,2,巴啦啦小猪鸭,4355,24,3,3,6,50.0%,22m
754,1,[SK]弱者心态,4354,1387,179,193,372,48.1%,24m
755,2,Apollo,4353,750,68,16,84,81.0%,3m
756,1,andy,4352,2441,287,290,577,49.7%,43m
756,2,[我们是无敌的]BeeNIN,4352,0,0,3,3,0.0%,25m
758,3,雪之下雪乃,4351,0,0,1,1,0.0%,37m
759,2,神族是我爹,4350,158,6,16,22,27.3%,39m
760,2,zeratul,4348,1381,80,72,152,52.6%,15m
761,3,[SteEng]FlashPoint,4347,0,0,1,1,0.0%,25m
762,3,DreamLee,4346,8,2,0,2,100.0%,36m
763,3,[QFT]ghcrow,4345,0,0,1,1,0.0%,41m
764,2,Pirate,4343,0,0,2,2,0.0%,3m
765,2,Micja,4342,220,78,81,159,49.1%,43m
765,2,盈丝烟雨,4342,428,23,5,28,82.1%,25m
767,2,[守望黎明]幼灵,4340,438,20,17,37,54.1%,3m
768,2,[SK]IIIIIIIIII,4339,1194,51,42,93,54.8%,16m
768,2,[Conque]灰原哀我爱你,4339,210,11,7,18,61.1%,15m
768,2,[SK]暴雪我是你爹,4339,112,3,5,8,37.5%,25m
768,3,[布伦杰尔特]娜塔莉娅,4339,0,0,2,2,0.0%,26m
772,2,[SK]necrophagist,4337,1464,254,271,525,48.4%,7m
773,1,机械化死个吗,4336,2594,150,149,299,50.2%,7m
773,2,IIIIIIIIIIII,4336,229,11,11,22,50.0%,3m
775,1,force,4335,1875,200,213,413,48.4%,16m
776,2,[归还枢机之光]Sparagmos,4334,796,37,32,69,53.6%,43m
776,3,阿米兔,4334,0,0,1,1,0.0%,36m
778,2,IIIIIIIIII,4332,322,45,40,85,52.9%,15m
778,2,新行星的要塞,4332,508,21,24,45,46.7%,27m
778,2,[o瞳孔o]吹梦到西洲,4332,0,0,1,1,0.0%,27m
781,3,[五月花]暴打养鸡场,4331,856,40,19,59,67.8%,13m
781,3,[CHW]kakalu,4331,0,0,2,2,0.0%,37m
783,1,别学机械,4330,2692,202,214,416,48.6%,42m
784,1,IIIIIIIIIIII,4329,2669,264,287,551,47.9%,42m
784,3,[NZNZ]XIAOXIAO,4329,1201,61,49,110,55.5%,25m
784,3,[净化者指挥官]塔兰达尔,4329,368,19,4,23,82.6%,19m
784,2,[在座各位]都是乐色,4329,22,2,3,5,40.0%,43m
784,3,NissanGTR,4329,0,0,1,1,0.0%,19m
789,3,llllllllllll,4328,0,1,0,1,100.0%,8m
790,2,Marine,4327,426,19,21,40,47.5%,27m
790,3,小土妹就是萝莉呀,4327,121,3,2,5,60.0%,8m
790,3,[FPT]scv,4327,0,0,1,1,0.0%,41m
793,3,[YA]宋哈娜,4325,466,53,22,75,70.7%,36m
793,3,请叫我孙牛牛,4325,0,0,1,1,0.0%,26m
795,2,[谢拉单推联盟]咕咕侠,4324,100,3,4,7,42.9%,27m
795,3,红色小晶锐,4324,0,0,1,1,0.0%,40m
797,2,藏家小男孩,4323,1871,87,88,175,49.7%,22m
797,1,超神追猎,4323,48,1,3,4,25.0%,14m
799,2,[SC2近卫军]泰哥来袭,4322,1313,86,94,180,47.8%,3m
800,2,变向技巧,4321,594,47,58,105,44.8%,3m
801,2,july,4319,449,30,13,43,69.8%,3m
801,2,llllllllllll,4319,316,15,12,27,55.6%,3m
801,1,Lunker,4319,336,11,9,20,55.0%,37m
801,3,PPLei,4319,0,0,1,1,0.0%,25m
805,2,[花绯玉丶]jiyue,4318,0,4,2,6,66.7%,41m
806,1,[永夜樂想]超级嗨客,4317,1363,55,66,121,45.5%,42m
806,2,[PITB]IIIIIIIIIIII,4317,270,23,33,56,41.1%,43m
806,1,IIIIIIIIIIII,4317,258,7,1,8,87.5%,14m
809,2,[大连理工]梦羽,4316,1888,97,104,201,48.3%,3m
809,3,[1232]次元之恋,4316,0,0,1,1,0.0%,25m
811,3,昊天,4315,1844,98,94,192,51.0%,40m
811,3,Finale,4315,180,15,12,27,55.6%,41m
811,3,VanillaFairy,4315,20,1,3,4,25.0%,25m
814,2,BladeRunner,4314,124,8,4,12,66.7%,22m
814,3,WinterZerg,4314,0,1,0,1,100.0%,37m
814,2,[SK]陆仁,4314,22,1,6,7,14.3%,16m
817,2,觉醒的新手,4313,2404,317,336,653,48.5%,15m
817,1,七凍一,4313,0,1,0,1,100.0%,14m
819,1,[无影丶神]时崎狂三,4312,2563,113,110,223,50.7%,16m
819,3,[中华兄弟会]智障选手,4312,0,0,1,1,0.0%,25m
821,3,[孙红雷]Braveheart,4311,64,6,4,10,60.0%,14m
822,1,[五月花]DAVID,4310,1158,532,516,1048,50.8%,16m
822,3,[丨SLT丨]NanYi,4310,251,14,1,15,93.3%,25m
822,3,MagejiZerg,4310,0,0,1,1,0.0%,19m
825,2,[共和时代]Soap,4308,364,16,19,35,45.7%,43m
825,3,DouS,4308,193,13,3,16,81.2%,36m
825,1,[33KS33]幻世凯撒,4308,0,0,1,1,0.0%,25m
828,3,Disruptor,4307,155,9,1,10,90.0%,25m
829,2,伟伟,4306,2336,657,696,1353,48.6%,16m
829,3,[SC2近卫军]爱鱼仔哦,4306,0,1,0,1,100.0%,19m
831,3,妈个鸡泽哥,4305,157,9,1,10,90.0%,14m
832,2,mykicwwsr,4304,608,28,26,54,51.9%,16m
833,2,[圣域守护]娜塔莉亚,4303,140,5,14,19,26.3%,16m
834,3,[北京城管]Kuku,4302,6,1,2,3,33.3%,36m
835,2,[Rhusky]Lightning,4301,1718,77,85,162,47.5%,43m
835,3,IIIIIIIIIIII,4301,0,2,3,5,40.0%,17m
835,3,努力没叼用,4301,0,1,0,1,100.0%,37m
838,3,斩业非斩人,4300,0,0,1,1,0.0%,17m
839,3,[西南政法大学]Clearlove,4299,0,1,0,1,100.0%,9m
840,3,乱笙诉离殇,4298,0,0,1,1,0.0%,8m
841,1,Morning,4296,387,9,5,14,64.3%,14m
842,3,[SC2近卫军]Yellowstar,4295,0,1,0,1,100.0%,14m
843,2,hanboyliang,4294,731,32,31,63,50.8%,25m
844,2,[无脑A地板]Granzon,4293,1961,139,116,255,54.5%,27m
844,2,[XYFANS]AdrenalinE,4293,786,36,29,65,55.4%,39m
844,2,llllllllllll,4293,0,0,5,5,0.0%,12m
847,3,IIIIIIIIIIII,4292,1957,226,209,435,52.0%,14m
848,3,[解放碑]航航,4291,228,10,3,13,76.9%,9m
848,3,[中中网咖]Rosefinch,4291,0,0,1,1,0.0%,18m
850,2,Madrior,4290,408,17,24,41,41.5%,16m
850,2,[GHet]战歌,4290,235,9,13,22,40.9%,27m
852,2,caibice,4289,501,317,294,611,51.9%,3m
852,3,[丨SLT丨]Stats,4289,340,17,4,21,81.0%,19m
852,3,[SC2近卫军]CentOS,4289,0,1,0,1,100.0%,40m
855,3,[RSTAR]闪击英雄,4288,60,7,2,9,77.8%,40m
855,3,[斗鱼艾弗二]挖墙脚抢红杏,4288,0,0,1,1,0.0%,25m
857,3,[Holygl]军团长,4287,56,11,11,22,50.0%,25m
858,2,[星际传销组织]星际猛男,4286,285,16,17,33,48.5%,25m
858,3,[TNLet]Isaac,4286,0,0,1,1,0.0%,14m
860,2,何景彬,4285,676,29,37,66,43.9%,39m
861,2,[寡妇雷就无敌]MagicWang,4284,998,51,49,100,51.0%,16m
861,3,霏霏,4284,879,45,24,69,65.2%,25m
861,2,[YA]人菜瘾又大,4284,92,1,4,5,20.0%,27m
861,3,[丨SLT丨]断手小人皇,4284,0,0,1,1,0.0%,18m
865,3,[菜鸡三人组]菜鸡人族,4283,0,0,1,1,0.0%,37m
866,2,[I苏维埃I]我是一只菜鸡,4282,365,68,50,118,57.6%,22m
866,2,[天地會分舵]youxi,4282,498,25,24,49,51.0%,25m
866,3,[孙換家]帝王丶玩命,4282,0,0,1,1,0.0%,41m
869,3,[Beasty]lazy,4281,16,2,1,3,66.7%,25m
869,3,[中中网咖]SHow,4281,0,1,0,1,100.0%,12m
869,1,LastAngle,4281,0,1,0,1,100.0%,37m
869,3,肥肥,4281,0,0,1,1,0.0%,25m
873,3,[学习使我快乐]Artanis,4280,68,5,7,12,41.7%,40m
874,3,[秋毫第七分队]marineking,4279,88,7,7,14,50.0%,37m
874,3,[CNboys]终不会成陌生人,4279,0,0,1,1,0.0%,26m
874,3,[社交学教员]Harry,4279,0,0,2,2,0.0%,18m
877,3,立华奏我老婆,4278,155,19,7,26,73.1%,37m
877,3,[月工火暴木几]虎纹鲨鱼,4278,0,0,1,1,0.0%,26m
879,2,[SC2近卫军]星际粉刷匠,4277,453,21,21,42,50.0%,3m
879,3,[鸭蛋万岁]fladon,4277,122,10,8,18,55.6%,14m
881,3,钟善人,4275,201,25,28,53,47.2%,9m
881,3,[紫光阁]啊朴老师,4275,58,4,5,9,44.4%,25m
883,3,yulouyue,4274,1919,103,93,196,52.6%,9m
883,3,想想球霸会怎么做,4274,225,26,9,35,74.3%,25m
883,3,klk,4274,0,1,0,1,100.0%,19m
883,3,[景德镇ACG]六点零,4274,12,1,1,2,50.0%,41m
883,3,[真天堂之魔]零九六,4274,0,0,1,1,0.0%,27m
883,3,永远喜欢新垣结衣,4274,0,0,1,1,0.0%,12m
889,3,[请叫我孙爷爷]汝乃胯下鸡儿,4273,2335,425,425,850,50.0%,19m
889,1,打死你玛拉皮,4273,1199,45,49,94,47.9%,36m
889,3,璟璟,4273,26,2,2,4,50.0%,36m
889,2,[有投行推叫我]Ange,4273,40,2,8,10,20.0%,39m
889,3,[文韬武略]我的最终幻想,4273,0,1,0,1,100.0%,19m
889,3,独饮月色,4273,0,1,0,1,100.0%,36m
889,2,[NUAA]我罗高帅富,4273,0,1,2,3,33.3%,43m
896,3,[SCL]Wilhelmina,4272,4,1,1,2,50.0%,41m
897,3,[肉鸡的饲养]时崎狂三,4271,0,0,1,1,0.0%,9m
898,3,[KUMA28]FadeAway,4270,384,28,24,52,53.8%,41m
898,3,[小言]xiaoyan,4270,192,16,15,31,51.6%,36m
898,3,stalker,4270,0,1,0,1,100.0%,40m
901,3,眼眸云水泱泱,4266,0,1,0,1,100.0%,14m
901,3,iiiiiiiiiiii,4266,0,0,1,1,0.0%,36m
903,3,饥饿的巨猹,4265,25,21,17,38,55.3%,8m
904,3,dDreAm,4264,1570,81,76,157,51.6%,14m
904,2,Woundman,4264,572,31,34,65,47.7%,43m
904,3,MrKiKo,4264,0,1,0,1,100.0%,14m
904,3,九十,4264,10,1,1,2,50.0%,36m
904,3,[RvA]幾度斜陽人倚樓,4264,0,0,1,1,0.0%,41m
909,3,[萌蛋组合]Korrger,4263,0,1,0,1,100.0%,17m
910,2,AurorA,4261,1313,67,70,137,48.9%,39m
910,3,[PaDoc]别找借口,4261,0,1,1,2,50.0%,18m
912,3,[丨SLT丨]菜鸡小渣,4260,0,0,1,1,0.0%,18m
913,2,IIIIIIIIIIII,4259,2282,356,341,697,51.1%,15m
913,3,[我不是乱舞]狂花,4259,121,3,1,4,75.0%,37m
915,3,[巨像吊炸天]拉链夹到鸟,4258,231,57,3,60,95.0%,41m
915,2,[玩人族先想想]你凭什么赢神族,4258,780,33,35,68,48.5%,15m
915,3,选择神族选择胜利,4258,20,3,2,5,60.0%,25m
915,3,老夫少女心态,4258,0,0,1,1,0.0%,26m
915,3,[孤孤孤]驯鸾少年,4258,0,0,1,1,0.0%,37m
920,1,蓝白,4257,2516,146,171,317,46.1%,43m
921,3,[MGrass]Romma,4255,0,1,0,1,100.0%,19m
922,2,可乐实验体,4254,2447,115,126,241,47.7%,8m
922,3,[Thpj]MyMoon,4254,8,2,1,3,66.7%,37m
922,1,报丧女妖,4254,48,1,1,2,50.0%,19m
925,3,COOL,4253,296,38,24,62,61.3%,8m
925,3,[揉脸党]Icytuzki,4253,36,4,2,6,66.7%,18m
927,3,[FsA]亚特璐,4252,28,2,2,4,50.0%,36m
928,3,[白魔法]娜塔莉娅,4251,30,3,7,10,30.0%,26m
928,3,五更琉璃,4251,0,1,0,1,100.0%,36m
928,1,NewKey,4251,0,0,1,1,0.0%,16m
931,2,金陵吕布,4250,863,39,43,82,47.6%,27m
931,3,[高速钢]IIIIIIIIIIII,4250,10,1,3,4,25.0%,36m
933,3,[硬骨头会所]軍长,4249,422,23,2,25,92.0%,12m
934,3,IIIIIIIIII,4248,547,96,91,187,51.3%,9m
934,3,Vicious,4248,8,2,0,2,100.0%,40m
936,3,草莓味布丁吖,4247,141,4,3,7,57.1%,25m
936,3,DRAGON,4247,0,0,1,1,0.0%,17m
938,3,[目標諾森德]小猪仔,4246,186,15,10,25,60.0%,25m
938,3,[秋毫第七分队]雷锁辛醑,4246,0,1,0,1,100.0%,25m
940,3,[fanta]秋山澪,4245,26,4,3,7,57.1%,40m
940,3,优昙华院,4245,0,0,1,1,0.0%,18m
942,2,[魔法少女小屋]玖诺,4244,176,7,3,10,70.0%,41m
942,3,[CnNami]chicken,4244,0,0,1,1,0.0%,8m
942,3,[查尔之矛]我又不会玩,4244,0,0,1,1,0.0%,18m
945,1,[封弊者]三世,4243,2299,215,109,324,66.4%,37m
945,3,阿巴阿巴,4243,790,41,44,85,48.2%,9m
945,3,湍流碎一地,4243,0,1,0,1,100.0%,37m
945,3,[翻滚吧WDB]圆你残奥梦,4243,0,1,1,2,50.0%,18m
945,3,Rainday,4243,0,0,1,1,0.0%,25m
950,3,[无限谐制]武器商人,4242,1195,107,68,175,61.1%,26m
951,3,IIIIIIIIIIII,4240,132,12,11,23,52.2%,8m
951,3,欢迎来到祖安,4240,0,1,0,1,100.0%,37m
951,3,[C60008]一只海龟成功入水,4240,0,0,1,1,0.0%,18m
954,2,[PTB]薊遼督師袁崇煥,4239,843,75,70,145,51.7%,15m
954,2,[RTSGo]XiaMenByuN,4239,1638,73,81,154,47.4%,22m
954,3,[魔法少女小屋]命运神龙超级萌新,4239,671,31,11,42,73.8%,14m
954,3,[SK]etdob,4239,244,13,4,17,76.5%,41m
954,3,[DMRe]扶我起来白给,4239,16,2,2,4,50.0%,12m
954,3,南无释迦牟尼佛,4239,0,1,0,1,100.0%,8m
954,3,吃了个饼,4239,0,0,1,1,0.0%,8m
954,3,[麻酱罐]贪比不得好死,4239,0,0,1,1,0.0%,8m
962,3,[补丁哥]UniversE,4238,24,3,4,7,42.9%,12m
962,3,Reality,4238,0,0,1,1,0.0%,26m
962,3,[凶猛]孙红雷,4238,0,0,1,1,0.0%,25m
965,3,[XYFANS]SLIMSHADY,4237,1075,58,50,108,53.7%,26m
965,3,MrBentley,4237,46,4,8,12,33.3%,12m
967,3,[不也挺好的吗]露崎舞衣是马娘,4236,334,13,10,23,56.5%,25m
967,3,MindWhistle,4236,0,0,1,1,0.0%,25m
967,3,[Encore]椰梦加得,4236,0,0,1,1,0.0%,40m
970,3,[依阿华级]素手挽秋风,4235,0,1,0,1,100.0%,36m
970,3,[温柔兔公主]布诺班尼,4235,0,1,1,2,50.0%,17m
970,3,[深淵]弑神刹,4235,0,0,1,1,0.0%,12m
973,2,姑获鸟之夏,4234,1198,57,63,120,47.5%,43m
973,3,[大阪大学]lekbuss,4234,362,16,6,22,72.7%,17m
973,3,Eternal,4234,34,4,2,6,66.7%,25m
973,3,威严满满的大小姐,4234,0,1,0,1,100.0%,18m
973,3,Mengze,4234,0,0,1,1,0.0%,25m
973,3,[Ogier]llllllllllll,4234,0,0,3,3,0.0%,17m
979,3,[XYFANS]player,4233,1142,100,74,174,57.5%,14m
979,3,午门孙一峰,4233,64,6,11,17,35.3%,37m
979,1,[Epochs]流月蔻鸳,4233,58,3,0,3,100.0%,14m
979,3,[Ogier]反正我又不会玩,4233,0,1,2,3,33.3%,12m
983,3,IIIIIIIIIIII,4232,2174,155,139,294,52.7%,26m
983,3,[Rhusky]伊藤失之咲,4232,143,28,8,36,77.8%,26m
985,3,[逸仙谐星]SYSUoZJU,4231,556,75,75,150,50.0%,8m
985,3,[Beasty]揭世白,4231,488,66,30,96,68.8%,19m
985,3,胡尼玛,4231,68,6,7,13,46.2%,37m
985,3,太上忘情豆,4231,0,0,1,1,0.0%,41m
989,2,[BGD]dream,4230,934,96,102,198,48.5%,22m
989,3,Revtime,4230,298,20,22,42,47.6%,17m
989,1,Mercer,4230,287,5,6,11,45.5%,42m
989,3,Mustang,4230,0,0,1,1,0.0%,37m
993,3,[Encore]LinZero,4229,238,17,17,34,50.0%,25m
993,3,[充气团]IIIIIIIIII,4229,6,2,1,3,66.7%,25m
993,3,[ImbaM]IIIIIIIIIIII,4229,0,1,0,1,100.0%,37m
993,3,FallenSakura,4229,0,1,0,1,100.0%,37m
993,3,[情谊至上]扒拉猛干,4229,12,1,7,8,12.5%,8m
998,3,Yinzy,4228,562,25,14,39,64.1%,36m
998,3,[丨SLT丨]春夏秋冬,4228,92,8,8,16,50.0%,26m
998,3,小小航,4228,0,0,1,1,0.0%,12m
1001,3,心之逆鳞,4227,2,2,0,2,100.0%,37m
1002,3,[YM]HerO,4226,60,5,5,10,50.0%,18m
1002,3,[IMRTS2]猩猩,4226,0,1,0,1,100.0%,9m
1002,3,[肉鸡的饲养]此夕何夕,4226,0,1,0,1,100.0%,41m
1002,3,IIIIIIIIIIII,4226,0,1,0,1,100.0%,37m
1002,3,BoxeR,4226,0,0,1,1,0.0%,17m
1002,3,jdaadw,4226,0,0,1,1,0.0%,40m
1002,3,[狗窝猪圈]读报,4226,0,0,1,1,0.0%,12m
1009,3,[Toss]unicorn,4225,284,14,15,29,48.3%,36m
1009,3,朝雾之花飘零时,4225,0,1,0,1,100.0%,37m
1009,3,[抱舔天物]闪电五鞭,4225,0,1,0,1,100.0%,18m
1009,3,可爱小楠楠,4225,0,0,1,1,0.0%,37m
1013,3,[32CM]晖哥三颗星,4224,278,25,30,55,45.5%,41m
1013,3,黑夜的阳光,4224,0,0,1,1,0.0%,25m
1015,3,IIIIIIIIIIII,4223,123,7,3,10,70.0%,37m
1015,3,[SCAP]Bomber,4223,0,1,0,1,100.0%,14m
1015,3,xyfan,4223,0,1,0,1,100.0%,14m
1015,3,CommonWealtH,4223,0,1,1,2,50.0%,25m
1015,3,成都孙一峰,4223,0,0,2,2,0.0%,12m
1020,3,[NYLLF]OVERwhelming,4222,0,0,1,1,0.0%,25m
1021,1,玩玩而已别唧歪,4221,317,9,21,30,30.0%,8m
1021,3,[吕布倒辣]whypsoimba,4221,34,5,6,11,45.5%,40m
1021,3,XYfans,4221,0,1,0,1,100.0%,41m
1021,3,江东小霸王,4221,0,0,1,1,0.0%,26m
1021,3,孙儿丶吃我一棒,4221,0,0,1,1,0.0%,26m
1026,2,[Killyo]AIliang,4219,48,2,2,4,50.0%,13m
1026,3,[我意凌云]歌天澜,4219,0,1,0,1,100.0%,12m
1026,3,[小剑人]深海摸鱼孙一峰,4219,8,1,2,3,33.3%,9m
1026,3,[WHU]SevenChen,4219,0,0,1,1,0.0%,8m
1026,3,[GalArC]PAnCake,4219,0,0,1,1,0.0%,40m
1026,3,[Rhusky]初音未来世界第一,4219,0,0,1,1,0.0%,26m
1026,3,[交个朋友吧]刚交的朋友,4219,0,0,1,1,0.0%,26m
1033,3,[TNLet]飞环,4218,10,2,0,2,100.0%,37m
1033,3,AuRevoiR,4218,0,1,0,1,100.0%,9m
1035,3,[TONGFU]fantasia,4217,24,3,3,6,50.0%,12m
1035,3,[别找我麻烦]TlmEs,4217,0,0,2,2,0.0%,26m
1037,3,hwappyZerg,4216,100,10,12,22,45.5%,17m
1038,3,[越练越菜]RngUzi,4215,0,1,0,1,100.0%,26m
1038,3,ScKing,4215,8,1,1,2,50.0%,12m
1038,3,MGJ,4215,0,0,1,1,0.0%,40m
1041,3,猫瑞尼,4214,32,4,7,11,36.4%,37m
1041,3,强哥哥,4214,0,1,0,1,100.0%,25m
1043,2,Agony,4213,554,23,28,51,45.1%,22m
1043,3,[LandSr]Ramu,4213,0,1,0,1,100.0%,19m
1043,3,丨丨丨丨丨丨丨丨,4213,0,0,1,1,0.0%,40m
1046,2,DJMeG,4212,1028,183,189,372,49.2%,39m
1046,2,小邓,4212,1401,82,76,158,51.9%,15m
1046,2,小心二次元,4212,90,3,0,3,100.0%,37m
1046,3,[TPoR]Shady,4212,0,0,1,1,0.0%,25m
1050,3,老年人不讲武德,4211,648,39,28,67,58.2%,40m
1050,3,[学院偶像祭]时崎狂三,4211,0,1,0,1,100.0%,14m
1050,3,[亚麻衣小魔女]HCuZn,4211,0,0,1,1,0.0%,37m
1050,3,[WingsS]YNYN,4211,0,0,1,1,0.0%,26m
1050,3,[HNU]INnoVation,4211,0,0,1,1,0.0%,40m
1055,3,黄金脆皮鸡,4210,174,29,25,54,53.7%,8m
1055,3,好吃不过饺子,4210,154,6,2,8,75.0%,19m
1055,3,[肉鸡的饲养]如何共勉,4210,46,5,5,10,50.0%,26m
1055,3,[iWoWi]histBigGun,4210,0,0,2,2,0.0%,41m
1059,3,[汪汪碎冰冰]Byun,4209,0,0,1,1,0.0%,37m
1060,3,[ISMU星际]WAY,4208,337,13,4,17,76.5%,25m
1060,2,点解你甘有计仔啊,4208,130,6,12,18,33.3%,43m
1060,2,[黑丝即是正义]Reynold,4208,0,1,0,1,100.0%,25m
1060,3,[Marry]賳繖脷磳篰縒,4208,0,0,1,1,0.0%,25m
1064,2,soulman,4207,1889,233,226,459,50.8%,27m
1064,3,[巨像吊炸天]抱着零食睡觉,4207,0,1,0,1,100.0%,14m
1064,3,emilia,4207,0,0,1,1,0.0%,37m
1067,2,NotNilc,4206,1815,109,111,220,49.5%,15m
1067,3,小寒,4206,30,4,3,7,57.1%,9m
1069,3,恋恋的心跳大冒险,4205,0,0,1,1,0.0%,37m
1070,3,无桑,4204,0,0,1,1,0.0%,18m
1071,2,[七咕咕]一束七,4203,634,109,64,173,63.0%,39m
1071,3,Milo,4203,0,0,1,1,0.0%,9m
1071,3,[一起多人运动]我梦,4203,0,0,1,1,0.0%,25m
1074,3,[HustSC]liberator,4202,183,8,3,11,72.7%,37m
1074,3,[丨SLT丨]oldmanSC,4202,6,1,1,2,50.0%,37m
1076,3,翼纪,4201,1174,225,210,435,51.7%,14m
1076,3,[16A06]ThunderRush,4201,0,0,1,1,0.0%,40m
1076,3,雷诺,4201,0,0,1,1,0.0%,8m
1076,3,[Vgirls]夜合,4201,0,0,2,2,0.0%,36m
1080,3,[Encore]胖头鱼,4200,6,1,1,2,50.0%,25m
1080,3,[Hist]水枪,4200,0,0,1,1,0.0%,12m
1080,3,阿峰,4200,0,0,1,1,0.0%,8m
1080,2,[四蛆兄弟]宇宙刺客,4200,0,0,1,1,0.0%,20m
1084,2,Psyqhical,4199,971,155,152,307,50.5%,16m
1084,3,Feisilinpu,4199,910,40,27,67,59.7%,26m
1084,3,[我是只守护鸡]阿美,4199,38,34,34,68,50.0%,37m
1084,3,numb,4199,0,0,1,1,0.0%,41m
1084,3,[DDOS狂雷]阿弥陀佛,4199,0,0,1,1,0.0%,8m
1089,3,[花样撸管]键盘操控手,4197,125,4,0,4,100.0%,37m
1089,2,久溺沉海,4197,0,1,1,2,50.0%,27m
1091,3,[反正都打不过]矿罗狂魔,4196,1258,88,39,127,69.3%,14m
1091,2,[二次元最高]Whisper,4196,247,12,0,12,100.0%,24m
1093,3,[SCGIRL]Lucy,4195,0,0,1,1,0.0%,18m
1093,3,瑞肥肥,4195,0,0,1,1,0.0%,25m
1093,3,[盲人康复院]头像越粉一波越狠,4195,0,0,1,1,0.0%,27m
1096,3,[Beasty]阳光,4194,1525,74,55,129,57.4%,37m
1096,3,llllllll,4194,0,0,1,1,0.0%,19m
1098,3,IIIIIIIIIIII,4193,4,1,3,4,25.0%,36m
1098,3,[华晨宇]宋炳鋸丧俗,4193,0,1,4,5,20.0%,18m
1098,3,[大漢]GLADIATOR,4193,0,0,1,1,0.0%,18m
1098,3,TheShy,4193,0,0,1,1,0.0%,40m
1102,3,Coach,4192,218,21,17,38,55.3%,8m
1103,3,[越后之龙]上杉谦信,4191,135,15,0,15,100.0%,26m
1103,3,IIIIIIIIIIII,4191,0,0,1,1,0.0%,25m
1105,2,董先生,4190,0,0,1,1,0.0%,12m
1105,3,Savage,4190,0,0,1,1,0.0%,18m
1107,3,IIIIIIIII,4189,236,41,21,62,66.1%,9m
1107,3,敌法出跳,4189,276,22,25,47,46.8%,41m
1107,3,lllllllll,4189,0,0,1,1,0.0%,37m
1107,3,大天使的南瓜灯,4189,0,0,1,1,0.0%,25m
1111,3,[ToHo]半桶水,4188,324,15,10,25,60.0%,37m
1111,3,NASA,4188,0,0,1,1,0.0%,9m
1111,3,Dai,4188,0,0,1,1,0.0%,25m
1114,3,[魔女联盟]Bernkastel,4187,275,17,9,26,65.4%,36m
1114,3,[审判长]IIIIIIIIIIII,4187,74,4,10,14,28.6%,25m
1114,3,[Beasty]混元星际门诺诺,4187,0,0,1,1,0.0%,18m
1114,3,[斯巴达血战团]姐姐的水多吗,4187,0,0,1,1,0.0%,26m
1114,1,[Mmmkay]Kingoi,4187,0,0,1,1,0.0%,38m
1119,3,[SCcr]player,4186,896,72,67,139,51.8%,26m
1119,3,[XZQK]UNiverse,4186,783,55,57,112,49.1%,37m
1119,3,七曜,4186,452,24,1,25,96.0%,26m
1122,3,[重拾]HistWind,4185,226,17,21,38,44.7%,14m
1123,3,[半个菜鸟]大圣头,4184,2073,100,90,190,52.6%,36m
1123,3,[无花也浪漫]渊流,4184,0,0,1,1,0.0%,36m
1125,3,每次扫黄都有你,4183,1378,104,53,157,66.2%,26m
1125,3,llllllllllll,4183,0,1,0,1,100.0%,37m
1125,3,[肉鸡的饲养]魔法少女鱼鱼酱,4183,0,0,1,1,0.0%,18m
1125,3,[肉鸡的饲养]mageji,4183,0,0,1,1,0.0%,18m
1129,3,迷人冷冷冷冷冷,4182,129,13,5,18,72.2%,26m
1129,3,浑身是胆,4182,259,12,10,22,54.5%,9m
1129,3,重庆孙一峰,4182,6,2,0,2,100.0%,37m
1129,3,[HustSC]Mimeticecho,4182,0,0,1,1,0.0%,36m
1133,3,[白玉楼的幽灵]惰性大发的式,4181,1801,118,94,212,55.7%,12m
1133,3,RAZE,4181,350,23,9,32,71.9%,25m
1133,3,[诡秘之主]Klein,4181,34,4,6,10,40.0%,19m
1133,3,llllllllllll,4181,0,1,0,1,100.0%,26m
1133,3,shawn,4181,97,1,1,2,50.0%,40m
1133,3,[菜的没人带]寂静调柔,4181,0,0,1,1,0.0%,18m
1139,3,人皇出征寸草不生,4180,677,36,10,46,78.3%,25m
1139,3,IIIIIIII,4180,460,22,17,39,56.4%,40m
1139,3,[SC联盟]Maru,4180,0,0,1,1,0.0%,37m
1139,3,Mitleit,4180,0,0,1,1,0.0%,25m
1139,3,我不整活,4180,0,0,2,2,0.0%,41m
1144,3,[第七舰队丶]阿尔萨斯,4179,1463,230,214,444,51.8%,12m
1144,3,[喵内噶]LuckyRabbit,4179,707,29,15,44,65.9%,9m
1144,3,[SK]GSDBD,4179,621,24,21,45,53.3%,19m
1144,2,春日野穹,4179,0,1,4,5,20.0%,21m
1144,2,染雪,4179,0,0,1,1,0.0%,20m
1149,3,Dest,4178,843,61,45,106,57.5%,25m
1149,3,Izayoi,4178,430,50,24,74,67.6%,40m
1149,3,[中国人寿]不知妻美,4178,588,25,5,30,83.3%,12m
1149,3,[一群谐星]bin,4178,280,10,5,15,66.7%,37m
1149,3,花鸟风月,4178,97,1,3,4,25.0%,37m
1149,3,[契约者117]骑士不徒手,4178,0,0,1,1,0.0%,26m
1155,2,大脚游戏论坛,4177,1736,132,131,263,50.2%,8m
1155,3,Stalker,4177,286,23,25,48,47.9%,19m
1155,3,全宇宙最帅的男人,4177,498,22,5,27,81.5%,18m
1155,3,[SoIoAs]血花缭乱,4177,110,9,7,16,56.2%,37m
1155,3,Heisenberg,4177,128,9,16,25,36.0%,25m
1155,3,[SoloAs]神之赵老,4177,195,5,5,10,50.0%,26m
1155,3,[SK]欲沐东湖,4177,0,0,1,1,0.0%,8m
1162,1,[Sv]版小将,4176,1375,156,179,335,46.6%,5m
1162,2,修你地堡,4176,1757,146,162,308,47.4%,3m
1162,3,[YM]hjx,4176,239,22,22,44,50.0%,40m
1162,3,叁点壹肆,4176,440,17,7,24,70.8%,26m
1162,3,[M8]Darrrrrk,4176,92,16,3,19,84.2%,18m
1162,3,IIIIIIIIIIII,4176,289,9,5,14,64.3%,26m
1168,3,[星际爱好者队]二五仔,4175,752,91,85,176,51.7%,37m
1168,3,[Toss]Skai,4175,352,36,11,47,76.6%,25m
1168,3,[太微玉清宫]龙说,4175,660,30,4,34,88.2%,8m
1168,3,晓风残月,4175,121,2,2,4,50.0%,41m
1172,2,Superficial,4174,2253,115,111,226,50.9%,27m
1172,3,左砍树右砍树,4174,1181,105,102,207,50.7%,12m
1172,3,隔壁老王,4174,591,103,93,196,52.6%,18m
1172,3,[无谐可鸡]强尼爬着,4174,418,53,6,59,89.8%,8m
1172,3,mrAcE,4174,1155,51,27,78,65.4%,18m
1172,3,seventeen,4174,957,38,33,71,53.5%,14m
1172,3,[NTZX]Adestiny,4174,157,15,9,24,62.5%,18m
1179,3,若不再伤神,4173,46,5,7,12,41.7%,12m
1179,3,练回去,4173,32,4,12,16,25.0%,40m
1179,3,[Rhusky]MaruFans,4173,0,0,2,2,0.0%,26m
1182,3,[暴雪我是你爹]阳光人族,4172,1619,110,106,216,50.9%,25m
1182,3,[虚拟歌手团体]Reaper,4172,889,73,16,89,82.0%,26m
1182,3,[Tilt]Accelerator,4172,1064,65,56,121,53.7%,14m
1182,3,[不败的魔术师]奇迹的杨,4172,10,20,24,44,45.5%,26m
1186,3,Distort,4171,1419,424,390,814,52.1%,12m
1186,3,[桐乃赛高]孤寂五柳,4171,144,4,0,4,100.0%,26m
1186,3,[KPG]jack,4171,97,2,0,2,100.0%,27m
1186,3,[CnNami]Raven,4171,0,0,1,1,0.0%,25m
1186,3,[飞云之上]Wondeful,4171,0,0,2,2,0.0%,25m
1191,3,[红魔SDEP]古龙顶端宝石虫,4170,1053,95,95,190,50.0%,40m
1191,3,[秋毫]绝境只能想到坦克,4170,645,93,46,139,66.9%,18m
1191,2,[我是一只机]雪夜音,4170,0,0,1,1,0.0%,26m
1194,3,[VKR]HIIT,4169,1019,43,33,76,56.6%,12m
1194,3,[四叶草]Aes,4169,171,10,10,20,50.0%,18m
1194,3,[沧海客]碎一地,4169,101,3,1,4,75.0%,12m
1194,3,[北京大学鸡协]llllllllllll,4169,0,1,0,1,100.0%,19m
1198,3,[NUAA]invorker,4168,1377,72,46,118,61.0%,12m
1198,3,EDIFIER,4168,540,21,8,29,72.4%,12m
1200,3,[五月花]求老仙奶我没女友,4167,954,58,8,66,87.9%,19m
1200,3,[Mikon]五河丶琴里,4167,1226,50,40,90,55.6%,12m
1200,3,[Rhusky]IIIIIIIIl,4167,72,37,40,77,48.1%,18m
1200,3,Saber,4167,138,15,2,17,88.2%,18m
1200,3,INDIVIDUAL,4167,97,1,1,2,50.0%,19m
1200,2,[POMF丶]水彩笔,4167,0,0,1,1,0.0%,17m
1200,3,[情谊至上]次元大介,4167,0,0,2,2,0.0%,41m
1207,3,前期不会后期无力,4166,1200,161,163,324,49.7%,18m
1207,3,[西南风]Mapleleaf,4166,535,32,28,60,53.3%,37m
1207,3,SlimeSlayer,4166,190,16,6,22,72.7%,25m
1207,3,[AnSwer]涂山容容,4166,0,0,5,5,0.0%,36m
1211,3,[SCAP]金矿不怕挖,4165,1389,123,114,237,51.9%,9m
1211,3,[一块晶化瓦斯]kira,4165,1361,70,51,121,57.9%,12m
1211,3,[野马星际]History,4165,16,3,3,6,50.0%,9m
1211,3,IIIIIIIIIIII,4165,0,0,1,1,0.0%,41m
1215,3,[五月花]IIIIIIIIIIII,4164,722,97,54,151,64.2%,18m
1215,3,gongfu,4164,995,51,26,77,66.2%,37m
1215,3,weak,4164,121,2,1,3,66.7%,25m
1218,3,[受死吧喵星人]胜哥,4163,1069,65,53,118,55.1%,25m
1218,3,seven,4163,1304,64,54,118,54.2%,19m
1218,3,[他上王者]红叶,4163,98,10,11,21,47.6%,37m
1218,3,[WILLE]IIIIIIIIIIII,4163,146,3,2,5,60.0%,9m
1222,1,年轻人不讲武德,4161,227,7,3,10,70.0%,12m
1222,3,[你们都是渣]TYTY,4161,0,0,1,1,0.0%,9m
1222,3,[不灭燃星]为了真理,4161,0,0,1,1,0.0%,37m
1222,3,[暴力喵星]扎本,4161,0,0,2,2,0.0%,9m
1226,3,iiiiiii,4160,147,4,2,6,66.7%,37m
1226,1,[SoloAs]这游戏好难,4160,0,0,1,1,0.0%,26m
1228,2,Maru,4159,2263,176,179,355,49.6%,15m
1228,3,[雾雨魔法森林]吞噬旋风,4159,123,22,12,34,64.7%,37m
1230,3,[丨SLT丨]uwuThermy,4158,948,104,100,204,51.0%,37m
1230,3,[杀生业报]maru,4158,431,42,18,60,70.0%,19m
1232,2,GiannaJun,4157,1457,97,95,192,50.5%,16m
1232,3,[TYFANS]湖底典狱长,4157,52,8,14,22,36.4%,26m
1234,3,RoyMustang,4156,1887,152,149,301,50.5%,9m
1234,1,llllllllllll,4156,144,3,2,5,60.0%,15m
1236,1,狙击司令二号,4155,1262,43,28,71,60.6%,27m
1236,3,练习,4155,44,5,8,13,38.5%,18m
1238,3,IIIIIIiiiiII,4153,558,24,13,37,64.9%,25m
1239,2,ShowTime,4152,1096,173,178,351,49.3%,39m
1239,1,[Mensa]Stormrage,4152,0,0,1,1,0.0%,16m
1241,3,[Igirls]愿我人族星火世传,4151,146,11,22,33,33.3%,26m
1241,1,RoyalAS,4151,0,0,1,1,0.0%,15m
1243,1,独奏悲歌,4150,0,1,0,1,100.0%,26m
1244,1,[青风堂]天怒小歪,4149,0,0,1,1,0.0%,19m
1245,1,oNSKYo,4147,443,18,7,25,72.0%,5m
1245,3,不知道取什么名字,4147,101,14,11,25,56.0%,41m
1247,3,Reality,4146,1828,117,102,219,53.4%,14m
1247,3,[NIKO]番茄丨扯淡,4146,844,87,90,177,49.2%,25m
1249,3,gravity,4145,1140,163,136,299,54.5%,14m
1249,1,[BGD]高能瓦斯不足,4145,0,0,1,1,0.0%,13m
1251,1,[斗鱼直播]红茶,4144,2222,137,131,268,51.1%,39m
1251,1,poidone,4144,144,3,1,4,75.0%,11m
1253,1,上官小水,4143,2588,131,140,271,48.3%,37m
1253,3,[Hist]SkaterBoy,4143,1927,114,94,208,54.8%,40m
1253,3,好人,4143,397,20,6,26,76.9%,14m
1256,3,[TPZTPZ]llllllllllll,4142,425,67,12,79,84.8%,37m
1257,3,[海石三叉戟]LYandGB,4141,103,22,10,32,68.8%,37m
1257,3,[乳鸟fan]yaoyao,4141,6,1,3,4,25.0%,18m
1257,1,喷泉旁的白鸽,4141,0,0,1,1,0.0%,18m
1260,3,Warren,4140,97,2,1,3,66.7%,18m
1260,1,IIIIIIIIIIII,4140,48,1,2,3,33.3%,41m
1260,1,听闻山上好风光,4140,0,0,1,1,0.0%,12m
1263,2,FUTURE,4139,1296,106,110,216,49.1%,8m
1263,3,[金毛猫娘]蒽菲,4139,10,2,6,8,25.0%,18m
1265,3,巴拉拉小魔仙,4138,931,168,153,321,52.3%,26m
1265,1,[NEUQ东大]Panda,4138,48,1,1,2,50.0%,4m
1267,1,[华师大二附中]Loser,4137,96,3,2,5,60.0%,5m
1268,1,IIIIIIIIIIII,4136,96,3,0,3,100.0%,19m
1268,1,[Borne]Kingofclubs,4136,0,1,0,1,100.0%,26m
1270,3,困难,4135,440,34,38,72,47.2%,37m
1270,3,[SoloAs]RitaLai,4135,366,26,30,56,46.4%,19m
1270,1,IIIIIIIIIIII,4135,656,14,14,28,50.0%,41m
1270,3,llllllllllll,4135,97,2,2,4,50.0%,36m
1270,1,shadow,4135,96,2,2,4,50.0%,15m
1270,1,染陌憂,4135,0,0,1,1,0.0%,15m
1276,3,IIIIlllIIIll,4133,1864,418,402,820,51.0%,18m
1276,3,纸盒,4133,1178,75,80,155,48.4%,9m
1278,1,lllllllIlI,4132,2040,94,77,171,55.0%,42m
1279,3,[1983]斗鱼直播继良云,4131,302,24,27,51,47.1%,12m
1279,1,[我队伍很强大]立华奏我老婆,4131,405,13,13,26,50.0%,16m
1279,2,[SC2近卫军]MrLee,4131,0,3,2,5,60.0%,11m
1279,1,[叫我兔本]马谡,4131,0,0,2,2,0.0%,42m
1283,3,[重庆人科学院]Intouchables,4130,2268,193,194,387,49.9%,14m
1283,3,lllllllll,4130,0,0,3,3,0.0%,9m
1285,3,[绵流祭]MONONOKE,4129,908,42,38,80,52.5%,26m
1285,3,Wilhelmine,4129,189,12,8,20,60.0%,14m
1285,3,[武汉理工大学]IIIIIIIIIIII,4129,162,12,20,32,37.5%,37m
1288,1,[SCJWJ3]ZooMaru,4127,0,1,0,1,100.0%,19m
1289,3,[TuiELF]猫喜欢吉良,4126,709,115,100,215,53.5%,19m
1289,2,IIIIIIIIIIII,4126,1448,61,76,137,44.5%,3m
1289,1,[赞助商我大哥]脑门刻忠赞小弟,4126,0,1,0,1,100.0%,5m
1292,3,这个世界太乱,4125,2216,261,251,512,51.0%,18m
1292,3,[帝国Aeon]zcs,4125,0,0,7,7,0.0%,41m
1294,3,[夙愿天下]希希的猪,4122,699,39,4,43,90.7%,18m
1294,1,[守望黎明]南极丶冰凌,4122,524,12,9,21,57.1%,21m
1294,1,[Ogier]猪肥自有刀来迎,4122,0,0,1,1,0.0%,15m
1294,1,[六芒星s]戈戈戈戈戈尔贡,4122,0,0,1,1,0.0%,5m
1294,1,IIIIIIIIIIII,4122,0,0,1,1,0.0%,16m
1294,1,[星际传销组织]苦练虫族,4122,0,0,2,2,0.0%,5m
1300,3,[SoloAs]yyf,4121,2175,187,189,376,49.7%,9m
1300,1,Gavin,4121,285,14,8,22,63.6%,15m
1302,1,zjh,4120,1512,223,196,419,53.2%,16m
1302,3,[BGD]比比,4120,192,19,22,41,46.3%,40m
1304,3,honoril,4119,2220,550,554,1104,49.8%,14m
1305,1,Monster,4118,930,22,13,35,62.9%,19m
1305,1,ILLYH,4118,0,1,0,1,100.0%,19m
1305,1,[M8]三五磷酸二酯键,4118,0,0,1,1,0.0%,17m
1308,1,[缒丶夣]夏色祭,4117,0,1,0,1,100.0%,19m
1308,3,IIIIIIIIIIII,4117,0,0,4,4,0.0%,26m
1310,1,IAMSMURFING,4116,1325,41,22,63,65.1%,13m
1310,1,[MarkX]陈绮贞,4116,0,1,1,2,50.0%,26m
1312,2,[SK]Null,4114,1378,71,90,161,44.1%,3m
1312,3,[D7]一级翻白眼运动员,4114,24,4,7,11,36.4%,36m
1312,1,[被感染的诺娃]本源之心,4114,0,0,1,1,0.0%,27m
1315,3,[KPG]cjy,4113,1414,71,58,129,55.0%,12m
1315,1,WindSpeaker,4113,302,16,2,18,88.9%,13m
1315,3,Zest,4113,327,15,14,29,51.7%,19m
1318,1,wjj,4112,418,9,8,17,52.9%,38m
1319,3,[四叶草]RainYoke,4111,409,18,23,41,43.9%,12m
1319,2,IIIIIIIIIIII,4111,294,14,1,15,93.3%,41m
1319,1,[石佛寺扛把子]Ninja,4111,470,11,8,19,57.9%,41m
1319,2,[DMDG]qpc,4111,0,3,3,6,50.0%,28m
1323,3,[亀山社中]白石麻衣毕业快乐,4110,18,4,10,14,28.6%,18m
1323,2,不羁的灵魂,4110,130,3,2,5,60.0%,42m
1323,1,[AOT]进击的泰伦,4110,0,0,1,1,0.0%,19m
1326,3,IIIIIIIIIIII,4109,1715,152,155,307,49.5%,40m
1326,3,[Toss]神奇的枪手,4109,249,8,10,18,44.4%,37m
1328,1,aragaki,4108,0,0,1,1,0.0%,19m
1329,1,IIIIIIIIIIII,4106,1103,28,27,55,50.9%,13m
1330,2,IIllIIIlIILL,4105,2381,244,263,507,48.1%,44m
1330,2,轻狂,4105,1322,91,98,189,48.1%,39m
1330,3,DAMIMI,4105,789,48,43,91,52.7%,25m
1333,2,[政委]全家老小一波流,4104,857,38,56,94,40.4%,8m
1333,1,[PTB]DPGEnchant,4104,514,11,14,25,44.0%,14m
1333,3,我是你爹,4104,22,4,8,12,33.3%,41m
1333,1,条码人,4104,94,3,1,4,75.0%,19m
1333,3,delatenomore,4104,8,2,6,8,25.0%,36m
1333,1,GoldRush,4104,48,1,2,3,33.3%,19m
1339,1,[KPG]Tiger,4103,2156,304,262,566,53.7%,15m
1339,2,[黄军别开枪]小野,4103,0,3,2,5,60.0%,37m
1341,1,[雾雨魔法森林]萌萌铃仙酱,4102,48,2,1,3,66.7%,41m
1342,3,[XYFAN]紫炎,4101,778,65,70,135,48.1%,41m
1343,1,[七步两炮]SAI,4100,490,11,7,18,61.1%,13m
1344,2,[神族天下无敌]阿毛,4098,2376,180,194,374,48.1%,3m
1344,3,[小女友]艺琳,4098,1738,88,80,168,52.4%,41m
1344,1,[Legacy]PerraN,4098,1055,42,43,85,49.4%,26m
1347,2,[AnSwer]Rhythm,4097,2343,178,190,368,48.4%,44m
1348,1,[Marry]休伯,4096,292,16,4,20,80.0%,19m
1349,1,Enjolras,4095,96,3,2,5,60.0%,21m
1349,1,[落星落个星]Noblecat,4095,0,0,1,1,0.0%,14m
1351,3,旗木,4094,1103,109,91,200,54.5%,12m
1351,3,IIIIIIIIIIII,4094,863,65,56,121,53.7%,36m
1353,1,沧海客,4093,144,3,5,8,37.5%,13m
1354,2,[源濑氏佐田]六十九岁老泰伦,4092,1242,306,303,609,50.2%,16m
1355,3,ADTgowjwj,4091,97,1,5,6,16.7%,14m
1355,1,AKIHIDE,4091,0,0,1,1,0.0%,14m
1357,3,llllllllllll,4090,8,1,8,9,11.1%,9m
1358,1,[NT]Lingling,4089,0,0,1,1,0.0%,41m
1359,3,[loveMM]爱妃朕封你为太子,4088,2195,166,161,327,50.8%,25m
1359,1,[丨SLT丨]Magejiterran,4088,800,18,9,27,66.7%,11m
1359,1,都说了是鸡腿哥,4088,0,0,2,2,0.0%,19m
1362,1,IIIIIIIIIIII,4087,142,3,3,6,50.0%,15m
1363,1,斗鱼直播继良云,4086,2523,1545,1593,3138,49.2%,8m
1363,2,[NT]DraCula,4086,394,17,35,52,32.7%,44m
1363,1,[GSC]等风也等你,4086,690,16,9,25,64.0%,19m
1363,1,七零后,4086,518,12,10,22,54.5%,26m
1363,1,InToTheWind,4086,378,9,7,16,56.2%,16m
1363,1,[SFTRA3]行星之上,4086,0,0,2,2,0.0%,26m
1369,1,[KPG2]来找小秘书,4085,1848,102,99,201,50.7%,16m
1369,1,[Miku骑士]魔理沙傻啥鲨莎沙,4085,0,0,1,1,0.0%,19m
1371,3,[TCP]kennyS,4084,187,18,18,36,50.0%,41m
1371,1,[练出来了协会]陨落之星,4084,288,7,5,12,58.3%,17m
1373,3,wwwww,4082,436,40,40,80,50.0%,25m
1373,3,大阪孙一峰,4082,605,32,17,49,65.3%,12m
1373,1,[SCLR]loner,4082,472,11,14,25,44.0%,16m
1373,1,谁都赢不了,4082,144,4,6,10,40.0%,17m
1373,1,krwlng,4082,0,0,1,1,0.0%,21m
1378,2,[KPG]Everglow,4081,2348,335,358,693,48.3%,22m
1378,3,[NT]条码人,4081,710,36,18,54,66.7%,19m
1378,1,xyfans,4081,607,23,10,33,69.7%,15m
1378,3,[PTB]Heller,4081,54,5,11,16,31.2%,25m
1382,1,Hyperion,4080,556,13,15,28,46.4%,4m
1382,1,[CHW]多啦,4080,0,0,1,1,0.0%,11m
1384,1,死亡舰队已经抵达,4079,1706,77,19,96,80.2%,13m
1384,2,Jackywu,4079,512,23,35,58,39.7%,39m
1386,3,奥巴牛,4078,1815,106,100,206,51.5%,14m
1386,3,[i5]Maru,4078,329,14,12,26,53.8%,25m
1386,3,SomnusM,4078,157,6,8,14,42.9%,36m
1389,1,[丨SLT丨]婉若清风,4077,560,12,13,25,48.0%,16m
1389,1,司徒汪朗,4077,320,9,9,18,50.0%,4m
1389,1,[闪耀DucK]Accelerator,4077,48,1,3,4,25.0%,41m
1392,3,Summer,4076,914,63,61,124,50.8%,37m
1392,1,[保护自然协会]Entaronature,4076,458,15,13,28,53.6%,15m
1394,1,[四叶草]asasi,4075,414,10,5,15,66.7%,19m
1394,1,为了艾尔,4075,48,2,2,4,50.0%,5m
1396,3,[北京大学鸡协]llllllllllll,4074,1069,56,48,104,53.8%,26m
1396,1,夏妖,4074,1583,46,29,75,61.3%,11m
1398,1,国宗一半是我艾尔,4073,1159,31,31,62,50.0%,27m
1398,1,[CnNami]好硬的牛子哥,4073,190,5,5,10,50.0%,19m
1398,1,[汉宫Clan]SoulEatherX,4073,0,0,1,1,0.0%,42m
1401,1,流浪的大妈,4071,0,0,1,1,0.0%,4m
1401,1,[TJMU]同济医大丨云玩家,4071,0,0,1,1,0.0%,38m
1403,2,[中南大学官网]Riven,4070,2169,145,171,316,45.9%,39m
1403,1,[鸭蛋万岁]想食红鸭蛋,4070,426,10,9,19,52.6%,18m
1403,1,Aventador,4070,144,3,6,9,33.3%,41m
1406,1,NikoNiko,4069,0,1,1,2,50.0%,16m
1406,3,[KD]Vivian,4069,4,1,9,10,10.0%,18m
1408,2,堡本,4068,1655,287,301,588,48.8%,8m
1408,1,[诺娃小姐姐]藤原卡卡西,4068,0,0,1,1,0.0%,18m
1410,2,[小鸡屠宰场]LYOKO,4067,2176,203,202,405,50.1%,4m
1410,1,[洁白之巅]TossMao,4067,347,11,17,28,39.3%,5m
1412,2,洛天依,4066,2303,118,135,253,46.6%,39m
1413,1,IronMan,4065,760,25,14,39,64.1%,4m
1413,1,Legato,4065,722,23,15,38,60.5%,16m
1413,1,[令人失望]文学少女,4065,96,3,3,6,50.0%,19m
1416,2,IIIIIIIIIIII,4064,1290,61,67,128,47.7%,39m
1417,3,[踏血无痕]zzh,4063,40,7,14,21,33.3%,18m
1417,1,[ELSD]Wokka,4063,192,5,3,8,62.5%,26m
1419,3,[KPG2]钢铁长城,4061,361,16,20,36,44.4%,40m
1420,3,kill,4060,1065,56,45,101,55.4%,37m
1420,1,EasyRider,4060,832,20,14,34,58.8%,15m
1420,2,[享受星际]南工大旋风解放王,4060,72,6,13,19,31.6%,22m
1420,1,[宝鸡谐会]AaWaLong,4060,48,1,1,2,50.0%,15m
1420,1,mgjterran,4060,48,1,3,4,25.0%,27m
1420,1,[麻豆导演组]他和她的猫,4060,0,0,1,1,0.0%,5m
1426,1,白给,4059,948,36,22,58,62.1%,42m
1426,1,[LEor]Apocalypse,4059,260,16,5,21,76.2%,26m
1428,1,IIIIIII,4058,138,3,6,9,33.3%,26m
1429,1,IIIIIIIIIIII,4057,0,0,1,1,0.0%,17m
1430,1,[古代毒瘤协会]雪落千秋,4056,0,0,1,1,0.0%,13m
1430,1,蓬莱人形,4056,0,0,1,1,0.0%,16m
1432,1,HongLian,4055,363,16,15,31,51.6%,4m
1432,1,阿道夫,4055,335,9,17,26,34.6%,18m
1432,1,蒙德勒赌场纵火犯,4055,0,0,1,1,0.0%,43m
1435,3,[哔翻天梯鸡]我的人族像孙哥,4054,971,118,115,233,50.6%,26m
1435,1,[SCAP]我是哈达威,4054,1796,52,47,99,52.5%,13m
1435,1,[暴雪我是你爹]醉花荫磊,4054,566,12,10,22,54.5%,40m
1435,3,迷迷糊糊的孩子,4054,4,2,7,9,22.2%,18m
1439,3,[ELSD]Mars,4053,420,28,37,65,43.1%,19m
1439,1,医生说他不能熬夜,4053,0,1,0,1,100.0%,15m
1439,1,[MSC2GA]superMC,4053,0,1,1,2,50.0%,13m
1442,1,[名最好别太长]Attack,4052,1207,77,61,138,55.8%,19m
1442,3,极度自律,4052,1532,76,87,163,46.6%,37m
1442,1,[教我玩神族]请别害了我,4052,504,11,10,21,52.4%,16m
1442,3,[Pro]milanjiayou,4052,68,8,17,25,32.0%,40m
1446,2,Camera,4051,288,10,8,18,55.6%,14m
1446,1,[丨SLT丨]大河,4051,0,1,0,1,100.0%,16m
1448,1,冰寂,4050,0,0,3,3,0.0%,19m
1449,1,我什么时候能大师,4049,924,28,7,35,80.0%,19m
1449,1,IIIIIIIIIIII,4049,280,7,5,12,58.3%,16m
1449,1,桃乃木香奈儿,4049,188,5,8,13,38.5%,16m
1452,1,[我亲爱的对手]yuuu,4048,2123,191,185,376,50.8%,4m
1452,1,IlIlIlIlIlIl,4048,1010,42,9,51,82.4%,43m
1454,3,中国争霸,4047,1412,206,211,417,49.4%,40m
1454,1,IIIIIIIIIIII,4047,0,0,1,1,0.0%,19m
1456,2,[横扫全服]konakona,4046,252,7,3,10,70.0%,21m
1457,1,戒赌中的东东,4045,46,2,1,3,66.7%,18m
1458,3,雷光,4044,1716,169,166,335,50.4%,37m
1458,3,饭太稀,4044,1375,151,153,304,49.7%,25m
1458,3,[禽禽禽]ByuN,4044,20,2,8,10,20.0%,18m
1458,1,人族妈暴毙一下,4044,0,0,1,1,0.0%,18m
1462,1,没有故事的男同学,4043,1041,50,31,81,61.7%,15m
1462,1,月下舞清影,4043,741,27,25,52,51.9%,38m
1462,1,iiiiiiiiii,4043,188,5,2,7,71.4%,26m
1462,1,[娜塔莉亚]布伦捷尔特,4043,48,1,4,5,20.0%,40m
1466,3,IIIIIIIIIIII,4042,2113,134,115,249,53.8%,14m
1467,1,Aphrodite,4041,48,1,2,3,33.3%,19m
1468,3,[天堂岛]Nero,4040,628,45,44,89,50.6%,19m
1468,3,llllllllllll,4040,229,9,12,21,42.9%,12m
1470,1,[丨SLT丨]llllllllllll,4039,1843,54,43,97,55.7%,37m
1470,1,[浮夸的]水月,4039,470,11,10,21,52.4%,14m
1470,1,亡灵天罚者,4039,236,7,5,12,58.3%,42m
1470,1,[GTV]我就活该被辜负嘛,4039,0,1,0,1,100.0%,37m
1470,1,樱岛麻衣,4039,0,0,1,1,0.0%,41m
1470,1,[第三方]烟云,4039,0,0,2,2,0.0%,26m
1476,1,孤独的行路人,4038,1584,41,35,76,53.9%,11m
1476,1,[窃光]wlt,4038,512,11,11,22,50.0%,4m
1476,1,小金者,4038,0,1,0,1,100.0%,19m
1479,1,你不要探路好不好,4037,417,11,17,28,39.3%,15m
1479,2,痛苦的面具,4037,157,10,0,10,100.0%,28m
1479,2,[NSL]HibaRIKyoyA,4037,0,0,1,1,0.0%,4m
1482,3,[TVTVT]ForeverFall,4036,2103,126,135,261,48.3%,37m
1482,1,[黄漫老师]上白泽慧音,4036,823,23,7,30,76.7%,15m
1482,1,[EAST]奶茶哥哥的鸡饲料,4036,48,1,4,5,20.0%,21m
1482,2,[打吊针]佐咲纱花,4036,0,0,1,1,0.0%,11m
1486,3,Euler,4035,1680,129,131,260,49.6%,12m
1487,1,[砖业团队]偷心盗贼,4033,1359,55,23,78,70.5%,18m
1487,1,xiaozhi,4033,36,2,9,11,18.2%,13m
1489,3,[入門電脳]痛苦星际,4032,409,104,96,200,52.0%,25m
1490,2,[七咕咕]Linus,4031,2138,152,164,316,48.1%,8m
1490,1,[用心良苦]marineking,4031,0,0,1,1,0.0%,14m
1492,3,Sitelin,4030,108,13,21,34,38.2%,26m
1493,1,lllllllllll,4029,1624,46,41,87,52.9%,4m
1493,1,Dust,4029,1086,27,16,43,62.8%,37m
1493,2,[ZTSCAP]乌丸千岁,4029,340,16,4,20,80.0%,37m
1493,2,Cloudtopwalk,4029,0,0,1,1,0.0%,38m
1497,3,iiiiiiiiiii,4028,1157,145,154,299,48.5%,40m
1497,3,[我高贵的族人]綾地寧寧,4028,124,13,22,35,37.1%,26m
1497,2,栋栋大宝宝,4028,0,1,0,1,100.0%,25m
1500,1,Velarian,4027,232,6,3,9,66.7%,19m
1501,3,[RPGBoY]lllllllll,4026,2018,97,115,212,45.8%,40m
1502,1,[有你的小镇]布塞菲勒斯,4025,190,4,2,6,66.7%,5m
1502,1,[牛有德]专打装逼者袁大爷,4025,0,1,1,2,50.0%,13m
1502,1,CallmeLTM,4025,0,0,1,1,0.0%,27m
1505,3,琳逐梦忆,4024,2046,358,363,721,49.7%,9m
1505,1,[TZRF]arrogance,4024,792,21,24,45,46.7%,42m
1507,2,Met,4023,116,8,0,8,100.0%,14m
1508,1,星际亡了,4022,1596,93,86,179,52.0%,16m
1508,1,不到三千五不改名,4022,924,28,9,37,75.7%,15m
1508,1,宇文逸豆归,4022,238,9,10,19,47.4%,11m
1511,1,死马电信,4020,1066,26,23,49,53.1%,27m
1511,1,TeamNoble,4020,375,9,11,20,45.0%,15m
1513,1,miya,4019,2029,141,144,285,49.5%,26m
1513,1,Dave,4019,2029,61,62,123,49.6%,38m
1513,1,[武大萌新]醉雪聆风,4019,1622,44,45,89,49.4%,16m
1513,2,[HDU]SuperNiNeSun,4019,397,14,4,18,77.8%,6m
1513,3,[浪啊浪]Ling,4019,145,10,16,26,38.5%,25m
1513,1,[Timba丶]空白,4019,286,6,15,21,28.6%,40m
1513,3,[山包]MarineKing,4019,50,5,16,21,23.8%,9m
1520,3,IIIIIIIIIIII,4018,2021,415,418,833,49.8%,37m
1520,2,旱地拔葱,4018,0,1,0,1,100.0%,4m
1520,1,[Na]Gwyn,4018,0,0,1,1,0.0%,4m
1523,1,[YR]Monster,4017,506,12,3,15,80.0%,13m
1523,1,XSGing,4017,48,2,2,4,50.0%,18m
1523,1,CoCo,4017,48,2,2,4,50.0%,38m
1526,1,云玩家,4016,192,5,4,9,55.6%,16m
1527,1,时说,4015,773,19,7,26,73.1%,26m
1527,1,[ZTSCAP]土牛王子来阴你,4015,226,7,9,16,43.8%,4m
1527,2,[人族是我爹]TATP,4015,44,2,0,2,100.0%,14m
1527,1,trump,4015,0,1,0,1,100.0%,15m
1527,1,[基金会]BorisYY,4015,48,1,1,2,50.0%,40m
1532,1,lllllll,4014,626,15,5,20,75.0%,14m
1532,1,[thu战队]Hazyknight,4014,466,10,11,21,47.6%,38m
1532,1,灰冬,4014,46,1,1,2,50.0%,38m
1532,1,[鹌鹑带星]水墨丹青烟波皱,4014,48,1,2,3,33.3%,18m
1536,1,[盲人康复院]欲沐东湖的父亲,4013,2000,62,57,119,52.1%,26m
1536,1,小影,4013,432,25,0,25,100.0%,41m
1536,1,[四叶草]WindySummer,4013,794,18,20,38,47.4%,40m
1536,1,[谷歌]夏目贵志,4013,594,14,17,31,45.2%,14m
1536,1,Ming,4013,368,9,3,12,75.0%,15m
1536,1,全是内战,4013,374,9,5,14,64.3%,14m
1536,2,[Hist]Night,4013,44,2,0,2,100.0%,12m
1536,2,[永不灭的战火]培训部文职,4013,0,0,1,1,0.0%,29m
1544,2,[KPG]天煞落世,4012,88,4,7,11,36.4%,26m
1544,1,[一块晶体矿]HYs,4012,0,0,1,1,0.0%,17m
1546,1,人族真是强,4011,1166,70,30,100,70.0%,16m
1546,1,[Fe3o4]吾妻蕾姆美如画,4011,1708,67,31,98,68.4%,26m
1546,1,rage,4011,96,2,6,8,25.0%,42m
1546,1,工具类,4011,48,1,5,6,16.7%,41m
1550,1,DeathKnight,4010,2027,132,118,250,52.8%,21m
1550,1,青丿灬小溪,4010,1580,64,60,124,51.6%,19m
1550,3,萌萌喵,4010,30,2,4,6,33.3%,10m
1550,1,随便玩玩,4010,0,0,1,1,0.0%,14m
1554,1,[Yanzi]Stefanie,4009,332,12,7,19,63.2%,5m
1554,1,[开菊怪]Ghost,4009,0,0,1,1,0.0%,27m
1556,1,小胖子,4008,1692,186,181,367,50.7%,26m
1556,3,[异乱II]Taxi,4008,819,77,80,157,49.0%,18m
1556,3,[Misty]星海迷航,4008,602,38,47,85,44.7%,14m
1559,3,wulusi,4007,2153,183,196,379,48.3%,18m
1560,2,穗果果,4006,116,7,1,8,87.5%,40m
1561,1,[Hist]素衣莫起风尘叹,4005,546,12,18,30,40.0%,42m
1562,3,maru,4004,2058,238,249,487,48.9%,37m
1562,1,SCFOREVER,4004,570,14,8,22,63.6%,21m
1562,1,MoonLight,4004,188,4,6,10,40.0%,42m
1565,1,NotGrownup,4003,647,58,35,93,62.4%,21m
1565,1,四十岁的菜鸡,4003,1672,45,51,96,46.9%,15m
1565,1,[猹狠萌的]狂奔的基洛夫,4003,863,21,19,40,52.5%,16m
1565,2,[萌皮战狼]你看我像正经妈么,4003,303,14,2,16,87.5%,40m
1565,1,紫菱夜颖,4003,0,1,0,1,100.0%,4m
1565,1,[星河气象学院]littleforest,4003,0,0,1,1,0.0%,15m
1571,1,IIIIIIIIIIII,4002,2120,438,431,869,50.4%,40m
1571,1,Delta,4002,529,22,26,48,45.8%,42m
1571,1,鸢一折纸,4002,0,1,0,1,100.0%,27m
1571,1,[无敌的泽哥]猫腻,4002,0,1,3,4,25.0%,11m
1575,1,[全村之希望]星际不死,4001,1783,62,64,126,49.2%,26m
1575,3,IIIIIIIIIII,4001,766,48,53,101,47.5%,18m
1575,1,[TShark]酸酸甜甜就是我,4001,1134,27,43,70,38.6%,4m
1578,1,IIIIIIIIIIII,4000,1179,204,207,411,49.6%,16m
1578,1,CBum,4000,2095,132,126,258,51.2%,19m
1578,1,[迪克boy]五更琉璃,4000,1347,58,29,87,66.7%,26m
1578,1,[洛丹伦的雨夜]llllllll,4000,981,24,14,38,63.2%,16m
1582,3,装逼大天使,3999,1202,188,179,367,51.2%,25m
1582,1,[打野大师]道李,3999,660,26,7,33,78.8%,26m
1584,1,[第八舰队丶]归宿,3998,2102,293,272,565,51.9%,15m
1584,1,HeroFish,3998,0,1,0,1,100.0%,19m
1586,1,[闪电伍连鞭]贝塔,3997,2102,294,268,562,52.3%,17m
1586,1,[轻岁月]HEalldin,3997,1434,46,30,76,60.5%,38m
1586,2,[196]RPGac,3997,157,10,0,10,100.0%,7m
1586,1,第二十卫戍师,3997,302,9,3,12,75.0%,15m
1586,1,奈文摩尔,3997,0,0,1,1,0.0%,5m
1591,3,[我们是无敌的]纵横熊猫,3996,117,5,12,17,29.4%,10m
1592,1,监控杆,3995,2124,87,78,165,52.7%,17m
1592,1,乾坤无定,3995,698,16,11,27,59.3%,40m
1594,1,树懒,3994,1458,165,152,317,52.1%,13m
1594,1,[Holyam]ReFuse,3994,79,2,3,5,40.0%,19m
1596,1,[萝莉之芯]没天赋的人族,3993,2125,507,497,1004,50.5%,38m
1596,3,[NVKR]TED,3993,858,47,60,107,43.9%,19m
1596,1,冬日可爱,3993,592,14,13,27,51.9%,18m
1596,2,byun,3993,198,11,1,12,91.7%,37m
1596,1,Should,3993,282,6,12,18,33.3%,13m
1596,2,[兔兔之家]ThisIsMeNow,3993,86,2,2,4,50.0%,21m
1602,1,雪之下雪乃,3992,291,8,2,10,80.0%,15m
1602,1,[despai]Zero,3992,192,4,10,14,28.6%,11m
1602,1,max,3992,0,1,0,1,100.0%,15m
1605,3,[妹控万岁]妹控都是好人,3991,2166,121,136,257,47.1%,3m
1606,1,IIIIIIIIIIII,3990,1681,96,105,201,47.8%,15m
1606,1,[五月花]五十块的好兄弟,3990,708,17,10,27,63.0%,16m
1606,1,[有你的小镇]金爷的契大佬,3990,0,1,0,1,100.0%,40m
1606,1,我混上去的不用慌,3990,0,1,4,5,20.0%,43m
1610,3,[CnNami]佛说人世间有八苦,3988,852,93,97,190,48.9%,19m
1610,3,别碰爷的小熊,3988,1359,88,90,178,49.4%,25m
1612,1,[TeamNL]HooinKyoma,3987,144,3,5,8,37.5%,21m
1613,1,Death,3986,1865,122,118,240,50.8%,19m
1613,3,星翎千雪,3986,20,3,17,20,15.0%,2m
1615,3,llllllllllll,3985,1356,148,159,307,48.2%,18m
1615,2,whh,3985,369,18,2,20,90.0%,41m
1615,1,MrC,3985,0,0,1,1,0.0%,15m
1618,1,开着奥迪去要饭,3984,1482,63,49,112,56.2%,26m
1619,1,[Toss]DDlxy,3983,1759,70,54,124,56.5%,15m
1619,2,Cappunior,3983,86,3,2,5,60.0%,4m
1621,1,[你已经死啦]你看那星辰大海,3982,1922,367,342,709,51.8%,16m
1621,1,在遇见你一次也好,3982,430,22,2,24,91.7%,38m
1621,1,[OYE]糖果,3982,96,2,5,7,28.6%,40m
1621,2,[星之所在RI]环彩羽,3982,0,1,1,2,50.0%,43m
1625,1,[二层楼]梳碧湖砍柴人,3981,494,11,10,21,52.4%,4m
1626,1,[坚果骑士]黑白意志,3980,585,22,11,33,66.7%,4m
1626,1,胡桃夹子,3980,302,8,6,14,57.1%,15m
1626,1,llllllllllll,3980,280,7,4,11,63.6%,11m
1626,1,[DMRz]断手流大师,3980,0,1,0,1,100.0%,21m
1626,1,[没错菜鸡就是]亦曲满江红,3980,0,0,1,1,0.0%,19m
1626,1,[Rhusky]root,3980,0,0,5,5,0.0%,26m
1632,1,甄不错,3979,48,1,2,3,33.3%,26m
1633,1,[宇宙职业战队]Maru,3978,2075,161,162,323,49.8%,38m
1633,1,[女装埃蒙]WAJICEW,3978,793,19,23,42,45.2%,16m
1633,1,尼古拉斯铁蛋,3978,48,1,1,2,50.0%,26m
1636,1,imbap,3977,2071,145,120,265,54.7%,20m
1636,1,[荆楚]工作不好找,3977,0,0,1,1,0.0%,20m
1638,3,IIIIIIIIIIII,3976,341,62,55,117,53.0%,41m
1638,1,[KSAR]Park,3976,1858,61,53,114,53.5%,41m
1638,1,[Hurt]IIIIIIIIIIII,3976,0,0,1,1,0.0%,6m
1641,3,IIIIIIIIIIII,3974,1870,163,178,341,47.8%,41m
1642,3,[Bleak]妹纸的小帅富,3973,454,30,35,65,46.2%,25m
1642,2,llllllllllll,3973,42,2,3,5,40.0%,8m
1644,2,IIIIIIIIII,3972,491,240,217,457,52.5%,39m
1644,1,人族就输不了,3972,1814,95,89,184,51.6%,4m
1644,1,YZY,3972,1246,32,39,71,45.1%,19m
1644,1,尤朵拉,3972,1108,30,19,49,61.2%,20m
1644,1,我大意了啊,3972,142,3,9,12,25.0%,27m
1649,1,[肌肉]常师傅千锤百炼,3971,912,23,12,35,65.7%,40m
1649,1,东旭黄,3971,144,3,7,10,30.0%,27m
1651,1,Release,3970,1166,32,29,61,52.5%,15m
1651,1,llllllllll,3970,763,26,6,32,81.2%,3m
1651,1,[SUSTC]Tiars,3970,96,3,6,9,33.3%,4m
1651,2,[寰宇集团]llllllllll,3970,0,0,1,1,0.0%,21m
1655,1,[FPT]人中吕布李信衡,3969,848,21,16,37,56.8%,41m
1655,1,[童话小镇]hydrallsks,3969,0,5,0,5,100.0%,26m
1655,1,eric,3969,48,2,5,7,28.6%,3m
1658,1,IIIIIIIIIIII,3966,948,42,11,53,79.2%,19m
1659,1,[你画我瞎]究极神兵绝境战,3965,1944,179,141,320,55.9%,19m
1660,1,羽一笑倾城,3964,2105,130,126,256,50.8%,38m
1660,1,IIIIIIIIIIII,3964,186,5,4,9,55.6%,38m
1662,3,[四叶草]伤透万千少女心,3963,360,255,248,503,50.7%,25m
1662,1,[KPG]yes,3963,2080,174,169,343,50.7%,42m
1662,1,iiiiiiiiiiii,3963,184,4,3,7,57.1%,21m
1665,1,ReMa,3962,2036,198,191,389,50.9%,19m
1665,2,[直男玩具]一米九的玩具,3962,2076,128,151,279,45.9%,15m
1665,1,TDF,3962,46,2,1,3,66.7%,17m
1668,1,Zero,3961,1220,60,47,107,56.1%,15m
1668,3,[Solo]IIIIIIIIIIII,3961,605,28,28,56,50.0%,3m
1668,1,[曾经一群兔子]lalala,3961,1058,27,19,46,58.7%,16m
1668,1,[丨SLT丨]李寻欢,3961,293,9,11,20,45.0%,27m
1668,1,[人族都是废物]魏忠贤,3961,0,1,0,1,100.0%,26m
1668,1,[pvt就输不]出飞龙怎么输,3961,0,1,3,4,25.0%,20m
1668,1,baizhi,3961,0,0,1,1,0.0%,16m
1668,1,sanae,3961,0,0,1,1,0.0%,42m
1676,1,欧尼酱大魔王,3960,824,19,20,39,48.7%,13m
1676,1,IIIIIIIIIIII,3960,174,8,8,16,50.0%,15m
1676,2,Akko,3960,157,5,1,6,83.3%,21m
1679,1,Viking,3959,2083,138,107,245,56.3%,43m
1679,3,[A灬shOw]preDiLeCtion,3959,1968,120,127,247,48.6%,18m
1679,1,九翼恶魔,3959,549,25,17,42,59.5%,26m
1679,3,[四川麻将协会]鱿鱼丝,3959,80,21,34,55,38.2%,9m
1679,1,崽崽大河马,3959,276,6,16,22,27.3%,20m
1684,1,[DMRc]百变人族炜弟,3958,94,3,2,5,60.0%,16m
1685,3,歌舞伎町之王,3957,1676,163,175,338,48.2%,25m
1685,1,[扫黄]LichKing,3957,0,1,0,1,100.0%,38m
1687,1,baDFruit,3956,960,24,18,42,57.1%,3m
1687,2,[升天Zhi途]玉软花柔贱,3956,188,5,1,6,83.3%,6m
1687,1,[GDUT]被劝退师,3956,205,4,4,8,50.0%,19m
1687,1,[第六駆逐鑑隊]Numb,3956,0,0,1,1,0.0%,3m
1691,1,可哥可妻孙一峰,3955,1382,73,15,88,83.0%,15m
1691,1,llllllllllll,3955,1628,67,41,108,62.0%,3m
1691,1,[Beasty]Wave,3955,598,14,8,22,63.6%,6m
1691,2,[为了加藤惠]King,3955,0,1,0,1,100.0%,40m
1691,1,Dark,3955,48,1,4,5,20.0%,16m
1696,1,[辉煌永续]BYBorDer,3954,554,13,14,27,48.1%,40m
1696,1,[锉刀酱真可爱]紫罗兰,3954,452,11,12,23,47.8%,38m
1696,1,IIIlllllIIII,3954,48,2,3,5,40.0%,15m
1696,1,月岛真面目,3954,48,2,9,11,18.2%,4m
1696,1,[一等星]SchWaRZer,3954,0,1,0,1,100.0%,38m
1701,3,好运相伴,3953,1822,396,410,806,49.1%,26m
1702,1,[CNYK]Cardinal,3951,46,1,2,3,33.3%,42m
1702,1,[为了地球]我是猩星,3951,0,1,2,3,33.3%,38m
1704,2,[五月花]全太阳的女巫帽,3950,2213,397,402,799,49.7%,28m
1704,1,奶骑风向标,3950,2082,105,102,207,50.7%,15m
1704,1,[花香惹人醉]一一不喜欢我,3950,410,15,6,21,71.4%,41m
1704,1,丶基友先森,3950,0,1,0,1,100.0%,11m
1704,3,IIIIIIIIIIII,3950,0,1,0,1,100.0%,14m
1704,3,[Killyo]海洋大鲸鱼尾巴,3950,0,1,3,4,25.0%,16m
1710,1,maru,3949,572,20,33,53,37.7%,40m
1710,2,[百鬼夜行丶]魑魅魍魉,3949,0,0,1,1,0.0%,11m
1712,1,CyberPunk,3948,613,16,5,21,76.2%,13m
1712,1,[QFD]forever,3948,142,4,2,6,66.7%,17m
1714,1,飞面神教虔诚教徒,3947,1111,31,26,57,54.4%,19m
1714,2,SDF,3947,208,4,9,13,30.8%,2m
1716,1,冥想神族鸦喵喵,3946,1556,102,81,183,55.7%,4m
1717,1,阿力,3945,2031,177,153,330,53.6%,15m
1717,1,三千水平七千嘴,3945,48,2,5,7,28.6%,13m
1717,1,TomWang,3945,0,0,1,1,0.0%,17m
1720,1,darkangel,3944,2081,382,375,757,50.5%,19m
1720,1,妹妹你坐船头,3944,1089,73,62,135,54.1%,17m
1722,3,[YH]Brolly,3943,2017,482,476,958,50.3%,3m
1722,1,札克纳梵,3943,733,26,14,40,65.0%,15m
1722,3,黑无常,3943,36,4,2,6,66.7%,39m
1722,1,阿兜与阿超,3943,0,1,0,1,100.0%,19m
1726,1,IIIIIIIIIIII,3942,1450,45,33,78,57.7%,43m
1726,2,[我们是无敌的]赤名莉香,3942,130,5,0,5,100.0%,2m
1726,2,Elizabeth,3942,0,0,1,1,0.0%,17m
1729,1,xswl,3941,92,3,0,3,100.0%,19m
1730,1,[KPG]Luminous,3940,2055,263,247,510,51.6%,42m
1730,1,春雨,3940,722,31,33,64,48.4%,15m
1730,1,[我即是菜狗]luckydestroy,3940,668,15,18,33,45.5%,21m
1730,1,[教我玩神族]Kirito,3940,234,6,2,8,75.0%,40m
1730,2,[IGA]梦邪幽灵,3940,69,3,8,11,27.3%,11m
1730,1,DDaLL,3940,0,2,4,6,33.3%,26m
1730,1,nozakikun,3940,46,1,3,4,25.0%,26m
1730,1,[粉红公主]LambRazor,3940,0,0,2,2,0.0%,26m
1738,1,简单的电脑,3938,599,24,12,36,66.7%,42m
1738,1,llllllll,3938,674,15,27,42,35.7%,15m
1738,1,[白给的神]动作指导,3938,48,2,0,2,100.0%,13m
1738,1,邀月,3938,0,1,0,1,100.0%,38m
1742,1,[开军舰]静刃,3937,980,32,32,64,50.0%,13m
1742,1,[FPT]Feelings,3937,368,8,16,24,33.3%,19m
1742,1,summer,3937,236,6,8,14,42.9%,15m
1742,1,[我们的奇迹]养猪的大叔,3937,0,0,1,1,0.0%,13m
1746,3,[LOHv]NIMAB,3936,1830,370,378,748,49.5%,3m
1746,1,Angrybirds,3936,527,18,7,25,72.0%,19m
1746,1,lllll,3936,46,2,0,2,100.0%,38m
1746,1,KAKINE,3936,0,1,0,1,100.0%,43m
1750,1,[金灿灿狙击队]四渡赤水,3935,2030,100,99,199,50.3%,14m
1750,1,Revolution,3935,1945,69,70,139,49.6%,41m
1750,1,甜橙,3935,1237,34,26,60,56.7%,15m
1750,1,[PITB]dark,3935,0,1,0,1,100.0%,26m
1754,1,[YH]首长讲武德,3934,2060,318,322,640,49.7%,26m
1754,1,[IMRTS]我真的很菜啊,3934,1383,65,36,101,64.4%,43m
1754,1,[Beasty]llllllllllll,3934,622,24,9,33,72.7%,17m
1754,1,[情谊至上]llllll,3934,559,13,5,18,72.2%,26m
1754,1,llllllll,3934,0,0,1,1,0.0%,20m
1754,1,[斜星连萌]可爱的小灵儿,3934,0,0,2,2,0.0%,26m
1760,3,夜幽梦,3933,2114,641,633,1274,50.3%,9m
1760,1,小猪佩奇,3933,1732,99,102,201,49.3%,20m
1760,1,kokodayo,3933,276,7,1,8,87.5%,17m
1763,1,鸢一折纸,3931,1869,68,63,131,51.9%,15m
1763,1,[孤独与烈酒]零功,3931,1104,57,57,114,50.0%,15m
1763,1,[XMG00]越狱,3931,231,12,0,12,100.0%,21m
1763,1,[糯米丸子]Lawyer,3931,0,0,1,1,0.0%,3m
1767,1,一切猥琐,3930,232,6,6,12,50.0%,19m
1767,1,[SC2近卫军]果果,3930,0,0,5,5,0.0%,6m
1769,2,珂朵莉瑟尼欧里斯,3929,2142,162,185,347,46.7%,39m
1769,3,[十三贴身侍卫]FutureLeader,3929,336,25,39,64,39.1%,25m
1769,1,NewCraft,3929,416,13,10,23,56.5%,38m
1769,2,[80后丶]城之内,3929,0,0,5,5,0.0%,8m
1773,1,MissileTruck,3928,1968,145,145,290,50.0%,40m
1773,1,sasaice,3928,1676,74,75,149,49.7%,19m
1773,1,[KPG]Innovation,3928,1728,71,38,109,65.1%,19m
1776,1,aieofjf,3927,2043,255,254,509,50.1%,17m
1776,2,Fighting,3927,182,11,1,12,91.7%,21m
1776,1,跆拳小子,3927,96,3,1,4,75.0%,38m
1779,1,老年人了,3926,2046,786,790,1576,49.9%,19m
1779,1,不入流,3926,1811,117,101,218,53.7%,3m
1779,1,[Encore]Observer,3926,442,10,7,17,58.8%,26m
1779,1,[叔叔不要啊]iero,3926,0,1,1,2,50.0%,41m
1779,1,[未临桑夏]黑玫瑰灬红蔷薇,3926,0,0,1,1,0.0%,17m
1779,2,[丨SLT丨]艾尔小圆盾,3926,0,0,1,1,0.0%,25m
1779,1,空心汤圆,3926,0,0,1,1,0.0%,11m
1779,1,[暗影之逆焰]叶修,3926,0,0,6,6,0.0%,27m
1787,1,[GO丨]INnoVation,3925,916,96,84,180,53.3%,38m
1787,1,[丨SLT丨]洪承畴,3925,974,28,17,45,62.2%,3m
1787,1,[NKTJ]阿尔萨斯诺林,3925,462,22,2,24,91.7%,42m
1787,1,致命之矛,3925,494,11,11,22,50.0%,26m
1787,1,我是你爹,3925,0,1,4,5,20.0%,21m
1792,1,chuan,3924,218,10,9,19,52.6%,4m
1792,1,[NUAA]小鸟游六花,3924,277,6,8,14,42.9%,14m
1794,1,[purgat]神眷之樱花,3923,2064,150,138,288,52.1%,15m
1794,1,苏珊杰克逊,3923,46,2,4,6,33.3%,38m
1796,3,HelionMad,3922,2090,309,307,616,50.2%,14m
1796,1,[火焰雷兽]我有一剑名扶摇,3922,1692,80,71,151,53.0%,4m
1796,1,樱小路露娜,3922,556,12,16,28,42.9%,19m
1796,1,虎狼之顾,3922,46,1,1,2,50.0%,26m
1796,1,[华东师大]末日时有空补番吗,3922,0,0,2,2,0.0%,18m
1801,1,碎纸机,3921,2060,192,202,394,48.7%,38m
1801,1,[KPG2]做个幸福的神族,3921,2082,84,82,166,50.6%,13m
1801,1,[SK]不开矿怎么暴兵,3921,494,15,9,24,62.5%,42m
1801,1,一个菜鸟,3921,228,9,9,18,50.0%,42m
1801,1,Snow,3921,0,1,5,6,16.7%,14m
1801,1,[鐡甲鋼拳]丶不抛弃丶不放弃,3921,0,0,1,1,0.0%,15m
1807,1,RattleRat,3920,2068,309,261,570,54.2%,41m
1807,1,WBYYing,3920,1678,100,79,179,55.9%,18m
1807,1,[铜锣湾话事人]乌鸦,3920,965,24,18,42,57.1%,20m
1807,1,[英国大理石]FaNsorSK,3920,726,16,21,37,43.2%,15m
1807,1,死神的镇魂曲,3920,0,0,1,1,0.0%,26m
1812,1,陆空联盟,3919,1775,113,111,224,50.4%,17m
1812,1,[Marry2]fractalg,3919,1330,36,38,74,48.6%,27m
1812,1,[XYFANS]逝去的风,3919,1050,31,20,51,60.8%,11m
1812,1,[布鲁斯弗莱]凹凹,3919,0,0,1,1,0.0%,19m
1816,1,[单纯的来宾仔]fatesWF,3918,848,32,36,68,47.1%,17m
1816,1,绘梨衣超甜甜甜,3918,548,23,9,32,71.9%,11m
1816,1,[WAST]Min,3918,0,0,1,1,0.0%,13m
1819,1,[缘起幻想乡]葛饰应为,3917,1936,131,110,241,54.4%,21m
1819,1,插眼锁喉撒石灰,3917,1877,67,39,106,63.2%,38m
1821,1,[都是为了艾尔]linker,3916,383,9,4,13,69.2%,40m
1821,1,[火车烧基地]wsgfs,3916,310,8,7,15,53.3%,14m
1823,1,[暴雪我是你爹]sky,3915,744,18,19,37,48.6%,41m
1823,1,[蓬莱伝説]HanSerena,3915,0,0,1,1,0.0%,17m
1823,2,[博云星际学院]BoyuN,3915,0,0,4,4,0.0%,6m
1826,1,[这种事无所谓]PIMBA,3914,2006,158,147,305,51.8%,41m
1826,1,[HTW]手无缚鸡之力,3914,1716,54,47,101,53.5%,20m
1826,1,[光影议会]鸽斯拉,3914,274,6,3,9,66.7%,40m
1826,1,仙女姐姐,3914,0,0,5,5,0.0%,13m
1830,1,[不会散枪兵]王白,3913,1964,86,80,166,51.8%,38m
1830,1,[star星]城市化的缔造者,3913,310,8,14,22,36.4%,15m
1830,1,[可我没有狗]我的狗狗叫马达,3913,46,1,1,2,50.0%,19m
1833,3,[TCP]柑橘奶昔,3912,1528,81,82,163,49.7%,18m
1833,1,[面包哥超垃圾]超厉害面包哥,3912,556,13,7,20,65.0%,14m
1833,2,eclipse,3912,182,10,2,12,83.3%,41m
1836,1,[AFSC2]Astesia,3911,2008,172,179,351,49.0%,41m
1836,1,福特号,3911,836,33,28,61,54.1%,19m
1838,1,[TONY]JohnnyLi,3910,2052,330,326,656,50.3%,26m
1838,1,[扫黄]野人教我防隐刀,3910,1953,177,155,332,53.3%,17m
1840,1,[TS嘉年华]猪头山,3909,1200,30,35,65,46.2%,43m
1840,1,[StriEu]ccong,3909,140,3,6,9,33.3%,19m
1842,1,上来搞笑一把,3908,2024,289,281,570,50.7%,15m
1842,1,joe,3908,316,9,8,17,52.9%,26m
1844,1,七束一,3907,2024,419,387,806,52.0%,14m
1844,1,[我们是无敌的]抱歉你不配,3907,1949,183,182,365,50.1%,13m
1844,3,IIIIIIIIIII,3907,1104,83,84,167,49.7%,26m
1844,3,同学慢走,3907,744,55,63,118,46.6%,19m
1844,2,ArtOfTerran,3907,187,11,24,35,31.4%,15m
1844,1,[仙人洞]丿离丶歌灬,3907,0,1,0,1,100.0%,26m
1844,1,水月镜花,3907,0,1,2,3,33.3%,6m
1844,1,[老太太鉆被窝]张嘉彤,3907,0,0,1,1,0.0%,3m
1852,1,Flash,3906,1661,293,298,591,49.6%,42m
1852,1,IIIIIIIIIIII,3906,928,23,23,46,50.0%,13m
1852,1,老年星际,3906,734,20,23,43,46.5%,19m
1852,1,[暗黑守望]大神棍,3906,0,1,0,1,100.0%,19m
1852,1,IIIIIIIIIIII,3906,0,0,1,1,0.0%,6m
1857,1,废铁二号,3905,1374,69,76,145,47.6%,19m
1858,3,[HustSC]FROZDEN,3904,901,85,90,175,48.6%,19m
1858,1,IIIIIIIIIIII,3904,1710,57,44,101,56.4%,3m
1858,1,Archer,3904,1378,38,37,75,50.7%,26m
1858,1,[大哥队]安工大,3904,461,20,6,26,76.9%,17m
1858,3,[怎么赢P]顾非池,3904,36,8,22,30,26.7%,40m
1858,1,[HPSC2]YQH,3904,162,5,3,8,62.5%,26m
1858,1,三死神跳牛,3904,138,4,1,5,80.0%,21m
1858,1,[RvA]人間幾度生華髮,3904,46,2,1,3,66.7%,26m
1866,1,[SoloAs]Madlife,3903,861,83,81,164,50.6%,38m
1866,1,时时时时时时说,3903,800,20,17,37,54.1%,20m
1866,1,Ene,3903,248,8,7,15,53.3%,19m
1866,1,共和国之辉,3903,46,2,0,2,100.0%,19m
1866,2,[bnuphy]ggboud,3903,0,0,1,1,0.0%,12m
1871,1,Aihara,3902,1948,94,85,179,52.5%,20m
1871,1,[Timer]小猫两三只,3902,138,3,1,4,75.0%,42m
1873,1,[BGD]星灵棱镜威力变身,3901,657,17,23,40,42.5%,15m
1873,1,[Beasty]魔法少女酥酥酱,3901,318,8,7,15,53.3%,19m
1873,2,[ESP三队]启元,3901,143,4,2,6,66.7%,40m
1873,1,GoldeChicken,3901,0,0,4,4,0.0%,21m
1877,3,[HJ灬GD]剑二十三,3900,1578,490,482,972,50.4%,3m
1877,1,[BGD]SEA,3900,540,19,5,24,79.2%,16m
1877,2,IIIIIIllllll,3900,276,14,4,18,77.8%,9m
1877,1,[四叶草]这个凯子,3900,408,9,10,19,47.4%,42m
1881,3,IIIIIIIIII,3899,2055,105,124,229,45.9%,2m
1881,1,[蓝色星尘]LRY,3899,340,9,2,11,81.8%,40m
1881,1,[TAPC]jhxz,3899,92,3,7,10,30.0%,15m
1884,1,[巨像吊炸天]智如智如,3896,901,27,17,44,61.4%,26m
1884,1,美酒和咖啡,3896,442,10,11,21,47.6%,41m
1884,1,[乃一开特]TKZerg,3896,94,3,2,5,60.0%,17m
1887,1,新开豆腐干,3895,1624,306,286,592,51.7%,27m
1887,1,woshibaba,3895,1945,158,154,312,50.6%,26m
1887,1,IIIIIIIII,3895,471,16,24,40,40.0%,42m
1887,1,[中日文化交流]FreeRabbit,3895,46,2,1,3,66.7%,15m
1891,1,大哥大,3894,694,36,47,83,43.4%,26m
1892,1,[SFAQL]我练出来了,3893,46,1,6,7,14.3%,26m
1893,1,zapco,3892,274,7,3,10,70.0%,40m
1893,1,[MaruNb]JinAirMaru,3892,0,0,1,1,0.0%,26m
1895,1,[浪啊浪]MagicProtoss,3891,927,43,25,68,63.2%,19m
1895,1,[SUPSC]zhong,3891,536,13,10,23,56.5%,15m
1895,1,[杀生业报]恶魔猎手,3891,90,3,0,3,100.0%,6m
1895,2,[艹妹联盟]西木野真姬,3891,0,0,1,1,0.0%,28m
1895,1,[生生不息]cavetiger,3891,0,0,1,1,0.0%,20m
1900,1,PoEW,3890,1289,107,78,185,57.8%,3m
1900,1,MagicBiken,3890,1148,89,79,168,53.0%,13m
1900,1,独舞人,3890,1760,75,72,147,51.0%,21m
1900,3,[暴雪我是你爹]IIIllllllll,3890,409,72,91,163,44.2%,18m
1900,1,[sbcoys]pandasssss,3890,0,1,0,1,100.0%,4m
1905,1,[Rhusky]不巧者,3889,992,46,22,68,67.6%,28m
1905,1,SOS,3889,1632,46,51,97,47.4%,16m
1905,1,大纱布,3889,46,1,1,2,50.0%,26m
1908,2,realyyc,3888,0,1,0,1,100.0%,8m
1909,1,萨克迈蒂克,3887,1966,284,279,563,50.4%,16m
1909,1,[WeOnE]deadgame,3887,67,2,3,5,40.0%,38m
1909,3,向死而生,3887,0,1,2,3,33.3%,40m
1909,1,[艾抖露]BlackHand,3887,0,0,1,1,0.0%,28m
1913,1,[ZXY]INNOVATION,3886,764,25,18,43,58.1%,6m
1913,1,[欢乐星际]FalsE,3886,326,8,8,16,50.0%,14m
1913,1,llllllllllll,3886,46,3,4,7,42.9%,19m
1916,1,IIIIIIIIIIII,3885,977,71,63,134,53.0%,40m
1916,1,[独爱冬马和纱]雪域山鹰,3885,138,3,3,6,50.0%,40m
1916,1,[大漢]ohyes,3885,92,3,8,11,27.3%,6m
1919,1,[Shawk]iceCola,3884,1694,109,97,206,52.9%,41m
1919,1,[RSTAR]白给小菜鸡,3884,455,12,6,18,66.7%,19m
1919,1,oOOOOOOOOOOO,3884,388,12,11,23,52.2%,19m
1922,1,烤地瓜,3883,804,19,21,40,47.5%,26m
1922,3,lalala,3883,4,14,34,48,29.2%,26m
1922,3,吃饭有点累,3883,109,9,1,10,90.0%,11m
1922,1,[TLA]虐狗侠,3883,92,2,8,10,20.0%,16m
1926,1,君王蟹,3882,1386,59,55,114,51.8%,21m
1926,1,[一起多人运动]TerranCtl,3882,314,7,7,14,50.0%,13m
1926,1,[六芒星s]CarolMalus,3882,0,1,1,2,50.0%,4m
1926,1,[Beauty]Toys,3882,0,1,1,2,50.0%,13m
1930,1,ropz,3880,184,5,2,7,71.4%,38m
1930,1,CaiForever,3880,188,4,7,11,36.4%,26m
1930,1,[蓝色星尘]Stardust,3880,0,1,1,2,50.0%,19m
1933,3,来找小秘书,3879,424,63,80,143,44.1%,2m
1933,1,Schumacher,3879,470,10,7,17,58.8%,40m
1933,3,Victorique,3879,0,4,1,5,80.0%,14m
1936,1,[USCK]KyaruSuki,3878,0,1,4,5,20.0%,26m
1936,1,[世界何平]Melody,3878,0,0,1,1,0.0%,14m
1936,2,樱岛麻衣,3878,0,0,1,1,0.0%,11m
1939,1,[暴雪我是你爹]擒敌拳,3877,1796,165,138,303,54.5%,19m
1939,1,supuo,3877,1758,80,83,163,49.1%,17m
1939,1,llllllllllll,3877,443,20,6,26,76.9%,19m
1942,1,[BXH]北极雪,3876,1926,79,73,152,52.0%,38m
1942,1,[DK龍]暗黑行为艺术家万,3876,1296,71,68,139,51.1%,17m
1944,1,TomYan,3875,1282,62,42,104,59.6%,41m
1944,1,[1990]斗鱼直播继良云,3875,776,19,27,46,41.3%,19m
1944,1,[宇宙职业战队]Maru,3875,474,14,16,30,46.7%,6m
1944,1,Senior,3875,138,6,8,14,42.9%,15m
1948,1,[北极光之旅]蜗牛,3874,404,9,12,21,42.9%,21m
1948,1,丶孤鸿灬,3874,184,5,4,9,55.6%,42m
1948,2,BlackorWhite,3874,28,2,1,3,66.7%,14m
1948,1,[yyc]superyyc,3874,0,0,1,1,0.0%,19m
1948,1,[YR]Solresol,3874,0,0,1,1,0.0%,15m
1953,1,[斧头帮x]magiczerg,3873,969,37,21,58,63.8%,43m
1953,1,步瓜,3873,1019,30,28,58,51.7%,41m
1953,1,[復仇者联盟]bdbaba,3873,525,20,11,31,64.5%,3m
1953,1,银骑士保护协会,3873,0,0,1,1,0.0%,26m
1957,1,鹿杖客,3872,362,8,4,12,66.7%,20m
1958,1,[Beasty]宗师也是鸡,3871,1939,134,129,263,51.0%,4m
1958,1,[KPG2]柜子里的老王,3871,1007,37,34,71,52.1%,26m
1958,1,[教我玩神族]BTOOO,3871,187,6,9,15,40.0%,15m
1958,1,NetEro,3871,140,4,6,10,40.0%,20m
1958,1,愤怒的泰迪,3871,0,0,1,1,0.0%,15m
1963,1,[Fiend]silence,3870,1630,105,110,215,48.8%,17m
1963,1,[目標諾森德]innovation,3870,893,27,18,45,60.0%,16m
1963,1,[無輪幻想]清风千叶,3870,0,0,1,1,0.0%,20m
1963,1,太上忘情豆,3870,0,0,1,1,0.0%,38m
1963,1,Relive,3870,0,0,1,1,0.0%,3m
1968,1,[美女集中滢]野战王,3869,1994,557,529,1086,51.3%,15m
1968,1,SCII,3869,1867,64,51,115,55.7%,19m
1968,1,Ryusuke,3869,262,7,6,13,53.8%,15m
1968,2,[海螺先生]iDamon,3869,42,1,7,8,12.5%,1m
1968,3,[再见孙悟空]dreaming,3869,0,0,1,1,0.0%,10m
1968,1,[一等星]liudx,3869,0,0,1,1,0.0%,28m
1974,1,hboxerh,3868,2036,374,350,724,51.7%,43m
1974,3,Kumo,3868,1854,147,138,285,51.6%,14m
1974,1,[1001]cccorn,3868,1270,110,110,220,50.0%,6m
1974,1,fagda,3868,452,10,20,30,33.3%,13m
1978,1,[我们是无敌的]果断就会白给,3867,1618,265,233,498,53.2%,18m
1978,1,女宿楼下卖瓜致富,3867,46,1,3,4,25.0%,26m
1978,1,海龟陆战队员,3867,0,0,1,1,0.0%,17m
1981,1,[玛莎拉拆迁办]菊花满山开,3866,1970,142,122,264,53.8%,11m
1981,1,[月野兔]啊啊啊的小仙女,3866,451,18,12,30,60.0%,19m
1981,1,[武大萌新]沧海客,3866,92,2,3,5,40.0%,15m
1981,1,[ZTSCAP]羽落,3866,0,0,1,1,0.0%,38m
1985,3,[狙击小闲12]我要曰逼,3864,0,0,1,1,0.0%,38m
1986,1,[C58]equal,3863,48,2,0,2,100.0%,13m
1986,1,[田鼠单推人]一椛懸命,3863,94,2,3,5,40.0%,21m
1986,1,[明教]WTgg,3863,0,1,0,1,100.0%,13m
1986,1,[GTZ]老弱病残,3863,0,1,0,1,100.0%,6m
1990,1,CaptainBiken,3862,821,26,20,46,56.5%,16m
1991,1,[NLD]Catch,3861,1970,102,98,200,51.0%,6m
1991,1,IIIIIIII,3861,485,12,6,18,66.7%,26m
1991,1,FreeDTG,3861,145,4,1,5,80.0%,15m
1991,1,[Thpj]Master,3861,46,1,2,3,33.3%,21m
1995,1,此地可是白门楼,3860,231,10,3,13,76.9%,19m
1995,1,[拯救孤独]椎名真昼,3860,0,1,0,1,100.0%,17m
1997,1,雷诺的好兄弟,3859,1023,60,59,119,50.4%,38m
1997,1,幸运魔法兔,3859,1425,53,38,91,58.2%,15m
1997,1,IIIIIIIIIIII,3859,269,19,1,20,95.0%,28m
1997,1,hnynlk,3859,0,0,1,1,0.0%,13m
1997,1,IIIIIIIIIIII,3859,0,0,1,1,0.0%,3m
2002,1,人族最强近战,3858,1992,177,172,349,50.7%,6m
2002,1,[lyg一生追]雪域山鹰,3858,570,14,17,31,45.2%,21m
2002,1,瓜皮,3858,92,3,1,4,75.0%,40m
2002,1,[SoIoAs]血花缭乱,3858,0,0,1,1,0.0%,28m
2006,1,[败犬的胜利]UTAHA,3857,289,10,5,15,66.7%,28m
2006,1,risk,3857,0,0,1,1,0.0%,43m
2008,1,名字尽量要取最长,3856,754,51,46,97,52.6%,13m
2008,1,[亿拳超人]伊利亚斯的断章,3856,907,34,44,78,43.6%,28m
2008,1,llllllllllll,3856,80,2,15,17,11.8%,14m
2011,1,[肉鸡的饲养]TYty,3855,831,56,47,103,54.4%,42m
2011,2,[PUSC2]Moriarty,3855,254,15,4,19,78.9%,21m
2011,1,tycoon,3855,319,12,2,14,85.7%,20m
2014,1,[IMRTS]mYthRendeR,3854,585,17,12,29,58.6%,11m
2014,1,[青娱乐]BlackRaven,3854,344,9,10,19,47.4%,19m
2014,1,[麻酱罐]羽翼,3854,294,7,4,11,63.6%,18m
2014,1,[彼岸之花]MagicProtoss,3854,48,1,1,2,50.0%,21m
2018,1,IIIIIIIIII,3853,369,15,8,23,65.2%,41m
2019,1,榕江小子,3852,1616,59,62,121,48.8%,26m
2019,1,[SK]RERzeng,3852,1116,29,34,63,46.0%,26m
2019,1,DropShip,3852,670,15,18,33,45.5%,43m
2019,1,IIIIIIIIIIII,3852,225,4,3,7,57.1%,26m
2023,1,沧海客,3851,1483,64,50,114,56.1%,6m
2023,1,云中月,3851,281,11,2,13,84.6%,3m
2023,1,[一XX一]胜西汉森宝,3851,182,5,4,9,55.6%,42m
2023,1,FiftyBrotho,3851,185,3,2,5,60.0%,19m
2027,1,[丨SLT丨]苍生涂涂天下渺渺,3850,46,2,0,2,100.0%,13m
2028,1,Prime,3849,708,28,17,45,62.2%,11m
2028,1,席应情,3849,498,16,12,28,57.1%,21m
2028,1,[青莲剑阁]帅轩,3849,0,0,1,1,0.0%,41m
2028,1,[萝莉即是正义]伪娘装什么扶她,3849,0,0,2,2,0.0%,17m
2032,1,SunnyBoy,3848,139,3,0,3,100.0%,28m
2032,1,TeachME,3848,0,1,0,1,100.0%,17m
2034,1,[天地會总舵]嘤嘤嘤,3847,1998,881,848,1729,51.0%,43m
2034,1,[FabLna]系鞋带之王,3847,1070,62,51,113,54.9%,19m
2034,1,[秋毫]如水的深蓝,3847,184,5,8,13,38.5%,21m
2034,3,IIIIIIIIIIII,3847,0,1,4,5,20.0%,20m
2038,1,[KENNEL]钻石恒久远,3846,1783,780,790,1570,49.7%,26m
2038,1,[九天星辰同萌]快乐每天,3846,1605,126,119,245,51.4%,15m
2038,1,[五月花]四分之一个菜鸟,3846,1416,58,58,116,50.0%,38m
2038,1,[六芒星s]GGG,3846,270,7,8,15,46.7%,6m
2038,1,[漂亮吧台小妹]IlIlIlIlIlIl,3846,133,3,0,3,100.0%,11m
2038,1,[XXHZ25]Joker,3846,48,1,3,4,25.0%,17m
2044,1,[TeamNV]llllllllllll,3845,1702,132,130,262,50.4%,6m
2044,3,[刺蛇互助社团]TureNo,3845,868,91,102,193,47.2%,10m
2044,1,llllllllllll,3845,228,5,5,10,50.0%,4m
2044,1,[不不要求求你]弗罗伦斯南丁格尔,3845,0,0,1,1,0.0%,14m
2048,1,[谐星乐园]哥们儿陪你玩星际,3844,499,17,15,32,53.1%,43m
2049,1,lllllllllll,3843,964,26,29,55,47.3%,4m
2050,1,[withme]立大功,3842,335,16,4,20,80.0%,15m
2050,1,垃圾,3842,224,11,4,15,73.3%,43m
2050,1,[希靈使徒]Raven,3842,179,5,5,10,50.0%,15m
2050,1,Legoshi,3842,180,4,4,8,50.0%,4m
2050,3,[HNU]LeGend,3842,0,0,1,1,0.0%,41m
2055,1,[HeroZP]Bagazi,3841,1901,149,136,285,52.3%,16m
2055,1,[PImba不]小小,3841,1604,111,118,229,48.5%,38m
2055,1,[小金上天队]slahserk,3841,1408,43,37,80,53.8%,15m
2055,1,Couragetime,3841,255,7,8,15,46.7%,21m
2055,1,星河之尽,3841,272,6,6,12,50.0%,40m
2055,1,Cathryn,3841,46,1,3,4,25.0%,11m
2061,3,[FFJ]欺师灭祖孙一峰,3840,856,164,166,330,49.7%,10m
2061,1,fuji,3840,94,2,4,6,33.3%,17m
2061,3,选神族或选胜利,3840,30,1,3,4,25.0%,16m
2064,1,[一等星]Titanium,3839,1739,298,292,590,50.5%,42m
2064,1,shanasaiko,3839,1891,83,76,159,52.2%,20m
2064,1,XiaoLeiVSXM,3839,502,32,16,48,66.7%,21m
2064,1,[神秘的力量]导哥,3839,704,19,29,48,39.6%,21m
2064,1,自爆球真好用,3839,439,17,12,29,58.6%,43m
2064,1,[断智]Pony,3839,0,0,1,1,0.0%,15m
2070,1,AAA,3838,1960,561,550,1111,50.5%,15m
2070,1,必扑,3838,1681,229,219,448,51.1%,11m
2070,1,[Rhusky]给你马刷排叉子,3838,1520,44,43,87,50.6%,15m
2070,1,[upcsc]犀利哥斯拉,3838,1348,38,35,73,52.1%,42m
2070,1,帝国矿工,3838,749,19,25,44,43.2%,26m
2070,1,[咏春]萌纳龙,3838,166,5,6,11,45.5%,21m
2070,3,杀狗的,3838,0,1,0,1,100.0%,14m
2077,1,wqwqwq,3837,787,40,18,58,69.0%,40m
2078,1,[桜公馆]高性能星际机器人,3836,2001,81,73,154,52.6%,41m
2078,1,天狼,3836,1421,69,61,130,53.1%,15m
2078,3,末日咒夜,3836,351,21,18,39,53.8%,25m
2078,1,大天二,3836,234,5,11,16,31.2%,26m
2078,1,[ETG]icestyleTYTY,3836,44,2,0,2,100.0%,14m
2078,3,[超电磁炉]栗山未来,3836,0,0,1,1,0.0%,41m
2084,3,[KPG]IIIIIIIIII,3835,2006,258,271,529,48.8%,3m
2084,1,[Beasty]TerranRifle,3835,1642,125,108,233,53.6%,13m
2084,1,[ZTSCAP]竹海旁回眸,3835,407,11,10,21,52.4%,40m
2084,1,[TeamET]CDX,3835,0,1,0,1,100.0%,41m
2084,1,[砖业团队]joygame,3835,0,0,1,1,0.0%,26m
2089,1,[银翼之光]查无此人,3834,1895,297,276,573,51.8%,13m
2089,1,llllllllllll,3834,940,41,23,64,64.1%,20m
2089,1,[ByuNgl]xOnEmAnArmYx,3834,235,9,8,17,52.9%,13m
2089,1,福利路小霸王,3834,358,8,14,22,36.4%,28m
2093,1,[飞院莽兽]强劲,3833,401,15,8,23,65.2%,19m
2093,2,遛狗人,3833,0,0,1,1,0.0%,4m
2095,1,[BGD]moMentDs,3832,1924,236,235,471,50.1%,26m
2095,1,[曾神]Haru,3832,0,1,1,2,50.0%,26m
2097,1,[despai]atom,3831,1503,110,87,197,55.8%,26m
2097,1,[中南大学官网]邓紫棋,3831,134,4,2,6,66.7%,19m
2099,1,llllllllllll,3830,334,57,33,90,63.3%,26m
2099,1,[RyH]猫猫,3830,781,30,18,48,62.5%,11m
2099,1,[HNU]Aurora,3830,168,17,12,29,58.6%,6m
2099,1,樱木花道,3830,230,5,7,12,41.7%,26m
2099,3,rrww,3830,0,1,0,1,100.0%,4m
2099,1,nnex,3830,48,1,2,3,33.3%,4m
2099,1,Sumida,3830,46,1,3,4,25.0%,15m
2106,1,[那里不可以]命运,3829,1933,124,102,226,54.9%,11m
2106,1,[ANNEX]IIIIIIIIIIII,3829,860,37,26,63,58.7%,16m
2106,1,llllllllllll,3829,94,2,10,12,16.7%,14m
2109,1,IIIIIIIIIII,3828,1155,61,29,90,67.8%,13m
2109,1,不跑不是小仙女,3828,1653,61,53,114,53.5%,14m
2109,1,[猪头哥]猪猪侠,3828,165,5,2,7,71.4%,17m
2109,1,[HappyK]Roker,3828,106,3,0,3,100.0%,26m
2109,3,软萌倩宝宝吖,3828,0,0,1,1,0.0%,3m
2114,2,llllllllllll,3827,1376,120,146,266,45.1%,4m
2114,1,IIIIIIIIIIII,3827,130,4,2,6,66.7%,11m
2114,1,Fog,3827,0,1,0,1,100.0%,13m
2117,1,[SoloAs]Fck,3826,1845,148,152,300,49.3%,28m
2117,1,勾雷兽的大肥蛇,3826,771,62,18,80,77.5%,42m
2117,1,[多瑙河之珠]游城,3826,335,11,9,20,55.0%,3m
2117,1,IIIIIIIIIIII,3826,151,6,5,11,54.5%,19m
2121,1,[P就输不了]打星际我只选神族,3825,448,35,22,57,61.4%,20m
2121,1,[暴雪我是你爹]StunGuN,3825,533,35,32,67,52.2%,6m
2121,1,[喵内噶]铁血战士,3825,184,6,3,9,66.7%,19m
2121,1,Rabbits,3825,138,3,4,7,42.9%,26m
2121,1,[充气团]蚂蚱晨晨,3825,0,0,1,1,0.0%,18m
2126,1,XYfans,3824,1238,175,172,347,50.4%,15m
2126,1,[despai]ChoseOwnLife,3824,309,23,13,36,63.9%,14m
2126,1,LuckyTerran,3824,0,1,0,1,100.0%,17m
2126,1,工具人,3824,91,1,1,2,50.0%,21m
2130,1,野生丶凹凸曼,3823,2013,378,366,744,50.8%,28m
2130,1,[Fear]Qilin,3823,1955,292,275,567,51.5%,15m
2130,1,[七咕咕]时崎狂三,3823,288,9,6,15,60.0%,21m
2130,1,高冷总裁,3823,90,3,2,5,60.0%,3m
2130,1,seals,3823,46,1,3,4,25.0%,20m
2130,1,falseface,3823,0,0,1,1,0.0%,11m
2136,1,大木博士,3822,867,55,42,97,56.7%,13m
2136,1,[DMRe]feng,3822,289,12,3,15,80.0%,4m
2136,1,INnoVation,3822,416,11,10,21,52.4%,13m
2136,1,[KPG]SeleiXi,3822,312,8,10,18,44.4%,17m
2140,3,新用户,3821,1999,444,447,891,49.8%,19m
2140,3,IIIIIIIIIIII,3821,304,27,43,70,38.6%,19m
2142,1,lethe,3820,1331,241,238,479,50.3%,17m
2142,1,[逐火之蛾]艾姬多娜,3820,355,11,8,19,57.9%,19m
2142,3,大纱布,3820,191,6,4,10,60.0%,22m
2142,3,你不能管我,3820,0,3,0,3,100.0%,42m
2146,1,shuipingxian,3819,324,8,6,14,57.1%,3m
2146,1,[天地會总舵]陈近南,3819,228,5,12,17,29.4%,17m
2146,1,[四叶草]ReVeLATION,3819,132,3,1,4,75.0%,26m
2146,1,[火车烧基地]八两,3819,0,0,2,2,0.0%,21m
2150,2,朝阳门孙一峰,3818,2137,256,287,543,47.1%,22m
2150,1,FIRTY,3818,1387,128,97,225,56.9%,15m
2150,1,ish,3818,237,13,12,25,52.0%,4m
2150,1,[Marry]逐风破影,3818,233,12,0,12,100.0%,43m
2150,1,[KPG]INnoVation,3818,159,4,4,8,50.0%,38m
2155,1,若凝霜,3817,588,24,11,35,68.6%,19m
2155,1,llllllllllll,3817,435,22,9,31,71.0%,19m
2155,1,HoNyarara,3817,445,16,13,29,55.2%,42m
2155,1,[浙大战队]MoneySniper,3817,480,15,12,27,55.6%,19m
2155,2,[侦测到喵入侵]枪舞,3817,0,0,1,1,0.0%,14m
2160,1,[Beasty]lllllllllll,3816,1835,522,515,1037,50.3%,41m
2160,1,IIIIIIIIIIII,3816,1227,52,44,96,54.2%,11m
2160,1,[ZJU]Polarised,3816,436,23,9,32,71.9%,41m
2160,1,[快乐上分]馒不讲理,3816,626,15,19,34,44.1%,28m
2164,1,[Beasty]美股波段投资者,3815,225,8,4,12,66.7%,26m
2164,2,[80s丶]弧光尖冰,3815,193,7,5,12,58.3%,27m
2164,1,[Z46]BestByuN,3815,126,3,2,5,60.0%,20m
2164,1,璀璨星华,3815,46,1,3,4,25.0%,11m
2168,1,[为星光而战]你爹重回战场,3814,906,53,29,82,64.6%,41m
2168,1,[NeXT]SeeKHIt,3814,182,5,5,10,50.0%,40m
2168,1,[DMRe]ByuN,3814,0,1,0,1,100.0%,17m
2168,3,[风暴来袭]塔萨达之影,3814,0,0,1,1,0.0%,14m
2172,1,[TPoA]星辰不及眉中山河,3813,822,36,24,60,60.0%,19m
2172,2,蜻蜓队长,3813,0,1,0,1,100.0%,25m
2172,1,海妖出动,3813,0,1,1,2,50.0%,28m
2175,1,XYsfans,3812,1972,77,79,156,49.4%,19m
2175,2,[那里不可以]Mercury,3812,744,28,17,45,62.2%,4m
2177,2,[TeamCD]五条人,3811,2131,262,291,553,47.4%,15m
2177,1,IIIIIIII,3811,1915,182,184,366,49.7%,26m
2177,1,[兆景埋土大学]IIIIIIIIIIII,3811,638,14,24,38,36.8%,41m
2177,3,我是一撮呆毛,3811,0,2,3,5,40.0%,19m
2177,2,loadingMXH,3811,0,0,1,1,0.0%,6m
2182,1,[大阪男同王]言尽,3810,1615,88,92,180,48.9%,26m
2182,1,oyoy,3810,577,28,14,42,66.7%,26m
2182,1,[CNN1]卷鸡神经网,3810,695,25,14,39,64.1%,26m
2182,1,宗族之筏,3810,324,9,10,19,47.4%,3m
2182,1,[QFD]凉宫春日,3810,0,1,1,2,50.0%,43m
2187,2,IIIIIIIIIIII,3809,1321,55,37,92,59.8%,43m
2187,2,Sakuraryo,3809,401,17,10,27,63.0%,41m
2187,2,Jlingz,3809,0,0,1,1,0.0%,25m
2190,1,[KPG2]星际迷航二号,3808,1352,36,40,76,47.4%,4m
2191,1,[TPoA]好名字都被狗取了,3807,1842,154,162,316,48.7%,19m
2191,1,银色黎明,3807,1837,54,62,116,46.6%,13m
2193,1,[没赢过]xuan,3806,462,23,23,46,50.0%,26m
2193,1,[人人有功炼]Raining,3806,760,18,26,44,40.9%,21m
2193,3,shadow,3806,197,10,2,12,83.3%,39m
2193,2,[傻壁二次元]Barbara,3806,168,6,3,9,66.7%,14m
2197,1,[星歌]bugOoOkkk,3805,1611,166,164,330,50.3%,17m
2197,1,rbq,3805,215,7,3,10,70.0%,15m
2197,1,小天才,3805,136,3,6,9,33.3%,11m
2197,2,qwer,3805,0,1,0,1,100.0%,43m
2201,1,三年不洗卵,3804,1318,95,88,183,51.9%,21m
2201,1,[93589]ShadowHunter,3804,1648,67,55,122,54.9%,26m
2201,1,LittleWiser,3804,224,5,9,14,35.7%,26m
2201,2,[巨鞭打鸡]IIIIIIIIII,3804,70,2,2,4,50.0%,8m
2201,2,Google,3804,55,2,2,4,50.0%,22m
2206,1,最爱虫虫,3803,1571,304,291,595,51.1%,17m
2206,1,专门狙击一束七,3803,900,86,69,155,55.5%,15m
2206,2,嘤帼星际大力士,3803,862,49,5,54,90.7%,6m
2206,1,[你已经死啦]小杰克,3803,138,3,2,5,60.0%,43m
2206,2,[找靠谱战队]雅儿贝德,3803,0,0,1,1,0.0%,40m
2206,2,OMGogoing,3803,0,0,1,1,0.0%,28m
2212,3,YuS,3802,2011,325,341,666,48.8%,25m
2212,2,[以琞龍的雄心]萨尔纳迦象牙塔,3802,0,0,1,1,0.0%,15m
2214,1,Billy,3801,1328,38,43,81,46.9%,43m
2214,1,唱跳,3801,736,31,36,67,46.3%,14m
2216,1,MagejiTerran,3800,987,43,32,75,57.3%,11m
2217,1,luck,3799,951,44,34,78,56.4%,11m
2217,1,Alexios,3799,453,21,17,38,55.3%,19m
2217,1,IIIIIIIIIIII,3799,788,20,19,39,51.3%,3m
2217,2,[集大鸡协]海院扛把子,3799,110,4,1,5,80.0%,1m
2217,3,酱油有魅力,3799,30,4,4,8,50.0%,22m
2217,2,[黑手黨]XXXRT,3799,0,0,1,1,0.0%,42m
2223,2,进击的艾伦,3798,1537,100,83,183,54.6%,4m
2223,2,[萎黄瓜小子]Shiver,3798,0,1,0,1,100.0%,43m
2225,1,[SK]sNow,3797,1942,171,167,338,50.6%,40m
2225,1,febix,3797,1672,58,61,119,48.7%,40m
2225,1,UntilWeDie,3797,746,18,22,40,45.0%,15m
2228,1,[五月花]東邪,3796,1599,86,59,145,59.3%,16m
2228,1,[票贩子]我要上钻石,3796,96,2,11,13,15.4%,40m
2228,3,[HustSC]疯人病院的腿控,3796,0,1,0,1,100.0%,13m
2231,1,mandery,3795,1582,45,53,98,45.9%,21m
2231,2,隐约雷鸣阴霾天空,3795,694,33,30,63,52.4%,4m
2231,2,[很强很厉害的]希诺希诺诺哦,3795,408,18,9,27,66.7%,43m
2231,2,[0D]菲尼克斯,3795,0,1,0,1,100.0%,25m
2235,1,[DRI]战无不胜,3794,1898,68,66,134,50.7%,16m
2235,1,高效液相,3794,1191,39,33,72,54.2%,17m
2235,1,[YMET]装了比就跑,3794,278,7,18,25,28.0%,13m
2235,1,cfp,3794,46,1,5,6,16.7%,15m
2235,2,[逗中之霸]Shifu,3794,0,0,1,1,0.0%,25m
2240,1,shuailai,3793,1669,113,91,204,55.4%,20m
2240,1,ksharpm,3793,1260,87,98,185,47.0%,15m
2240,1,[不知不觉天亮]doctor,3793,786,70,47,117,59.8%,20m
2240,3,飞龙者,3793,212,6,1,7,85.7%,39m
2244,1,[捞你沟子]翡翠城,3792,1970,389,391,780,49.9%,17m
2244,1,小鸡屠宰场,3792,184,4,16,20,20.0%,26m
2244,2,風十一郎,3792,124,3,2,5,60.0%,8m
2247,1,翟椎,3791,1942,248,229,477,52.0%,15m
2247,1,Toney,3791,1913,246,250,496,49.6%,21m
2247,2,TYTY,3791,1451,71,65,136,52.2%,10m
2247,2,钻钻钻钻钻,3791,122,5,2,7,71.4%,4m
2247,2,[雷诺喜当爹]黑羽丶涛叔,3791,36,1,3,4,25.0%,42m
2247,1,[你是狗逼吗]干掉上帝,3791,0,0,2,2,0.0%,16m
2253,2,[RTSGo]CcCc,3790,234,9,4,13,69.2%,29m
2253,2,[二次元死妈]Kpain,3790,114,2,3,5,40.0%,22m
2253,1,[NeXT]鸡本,3790,0,1,2,3,33.3%,20m
2253,2,鸮鸮夜雨,3790,0,0,1,1,0.0%,3m
2257,1,人族内战直接退,3789,337,7,9,16,43.8%,14m
2258,1,银月,3788,1968,320,304,624,51.3%,3m
2258,1,[tree]SCPLAYER,3788,1694,223,218,441,50.6%,20m
2258,1,沙河口南波万,3788,565,26,25,51,51.0%,14m
2261,1,[KPG2]夏色祭,3787,401,12,11,23,52.2%,43m
2261,2,Randy,3787,218,8,1,9,88.9%,41m
2261,3,Atns,3787,30,2,0,2,100.0%,9m
2261,2,[69岁狙击手]铁骨铮铮白咲花,3787,0,1,1,2,50.0%,21m
2265,1,放风筝,3786,1923,258,243,501,51.5%,11m
2265,1,云中笑笑,3786,1842,120,110,230,52.2%,15m
2265,1,[Rar兄弟会]Axxxxxxxxxxx,3786,806,47,58,105,44.8%,19m
2265,1,[传说萌娘团]Flood,3786,545,14,13,27,51.9%,19m
2269,2,[阿莎丽突击队]hjh,3785,1597,187,172,359,52.1%,19m
2269,1,[传说萌娘团]滄海客,3785,1503,164,154,318,51.6%,40m
2269,2,[凯子]专业备胎只舔不撩,3785,904,32,28,60,53.3%,41m
2269,3,大主教之弧将军,3785,0,1,4,5,20.0%,27m
2273,1,卡拉卡拉,3784,1568,154,137,291,52.9%,18m
2273,1,[拯救凯瑞甘]冰本,3784,151,3,4,7,42.9%,20m
2273,2,[幻世情缘]Nawkham,3784,0,0,1,1,0.0%,25m
2276,1,苏远烟,3783,849,34,34,68,50.0%,19m
2276,1,TsuKi,3783,0,1,1,2,50.0%,43m
2278,1,安徒生,3782,1151,71,69,140,50.7%,19m
2278,1,LebesgueMeas,3782,961,33,36,69,47.8%,16m
2278,2,Yoki,3782,130,4,2,6,66.7%,11m
2278,2,四十而立,3782,0,1,4,5,20.0%,43m
2282,1,[DFK]战争结束了,3781,934,36,35,71,50.7%,26m
2282,2,[HoA]四季夏目,3781,520,21,9,30,70.0%,43m
2282,2,Yan,3781,188,9,2,11,81.8%,14m
2282,2,[Igirls]葛阿姨用他的下,3781,38,2,1,3,66.7%,8m
2282,2,[威震天下]Aoney,3781,0,0,1,1,0.0%,16m
2287,2,Ceonsamea,3780,34,1,3,4,25.0%,14m
2288,1,钢铁洪流,3779,1933,379,378,757,50.1%,28m
2288,2,clowngin,3779,1265,95,72,167,56.9%,16m
2288,1,[紫金魔龙皇]Eikasang,3779,1043,65,43,108,60.2%,13m
2288,2,[GA]Delphinium,3779,684,23,25,48,47.9%,28m
2288,1,[Beasty]风暴要火,3779,591,15,16,31,48.4%,13m
2288,1,lqm,3779,304,8,9,17,47.1%,26m
2288,2,[蚊子FD]shaozhou,3779,68,2,4,6,33.3%,14m
2295,2,[Rhusky]皮皮吃下了今令,3778,678,33,9,42,78.6%,43m
2295,3,青菜萝卜包,3778,121,5,0,5,100.0%,44m
2295,2,Itachi,3778,104,4,2,6,66.7%,43m
2295,1,[菜菜是我大哥]我喊哥你就退好么,3778,44,2,3,5,40.0%,42m
2295,2,国产零零漆,3778,0,0,1,1,0.0%,6m
2295,2,别修地堡求你了,3778,0,0,1,1,0.0%,14m
2301,1,[AliF2E]lllllll,3777,1014,140,114,254,55.1%,41m
2301,1,llllllllllll,3777,976,25,32,57,43.9%,41m
2301,2,CancerMA,3777,296,12,3,15,80.0%,22m
2301,1,法式焗蜗牛,3777,142,3,4,7,42.9%,6m
2301,2,夕阳的刻痕,3777,0,0,1,1,0.0%,28m
2306,1,[五月花]llllllllllll,3776,1376,49,50,99,49.5%,16m
2306,3,[卡莱土豆]我得重新集结部队,3776,0,2,3,5,40.0%,8m
2308,1,[C94941]蛋町,3775,1332,36,48,84,42.9%,26m
2308,1,[金灿灿狙击队]llllllllllll,3775,663,32,19,51,62.7%,11m
2308,2,[肉鸡的饲养]魔法少女菜夜白,3775,610,24,13,37,64.9%,14m
2308,2,[Riders]ruoruo,3775,32,2,1,3,66.7%,25m
2308,2,[柠檬汁]条码人,3775,30,2,1,3,66.7%,14m
2313,2,这把有点悬,3774,1369,55,39,94,58.5%,14m
2313,2,Twistzz,3774,0,1,1,2,50.0%,21m
2315,1,ilcsc,3773,789,23,19,42,54.8%,14m
2315,2,damaomaomao,3773,404,13,10,23,56.5%,25m
2315,2,[CaiBLu]十二,3773,74,2,2,4,50.0%,21m
2315,2,[Ziyan]Wayne,3773,0,1,0,1,100.0%,29m
2319,1,人生几见月当头,3772,1540,143,129,272,52.6%,26m
2319,1,IIIIIIIIIIII,3772,1302,59,63,122,48.4%,26m
2319,1,[官人]官人我又要,3772,1359,49,42,91,53.8%,13m
2319,1,llllll,3772,232,6,8,14,42.9%,21m
2319,2,[快乐糖活]Hibiki,3772,0,1,0,1,100.0%,43m
2324,2,Vstar,3771,379,17,10,27,63.0%,9m
2324,1,简单电脑,3771,314,8,14,22,36.4%,28m
2324,2,[FindMe]balcare,3771,68,2,1,3,66.7%,42m
2324,2,[QRADIO]truestory,3771,0,1,0,1,100.0%,42m
2328,1,[皇室联盟]SworDarTon,3770,183,34,6,40,85.0%,42m
2328,2,菜狗也疯狂,3770,181,11,10,21,52.4%,28m
2330,1,ggsimida,3769,908,35,53,88,39.8%,16m
2331,1,吸气牛,3768,320,8,19,27,29.6%,19m
2331,1,[一块晶体矿]苏打苏打苏,3768,0,1,3,4,25.0%,40m
2331,3,遇事不決問春風,3768,0,1,4,5,20.0%,3m
2334,1,梅常酥,3767,1857,414,392,806,51.4%,15m
2335,1,impon,3766,1310,228,213,441,51.7%,21m
2335,2,[Hope]运营狗,3766,64,2,3,5,40.0%,21m
2337,2,跳跳虫,3765,1415,65,54,119,54.6%,14m
2337,2,[小仙女联盟]沧海客,3765,298,12,3,15,80.0%,6m
2337,2,德莉莎第一可爱,3765,308,11,6,17,64.7%,5m
2337,2,杠上开花黄旭东,3765,0,1,0,1,100.0%,40m
2341,1,星弧破碎,3764,636,15,20,35,42.9%,26m
2341,2,[华科大]电气攻城狮,3764,246,9,7,16,56.2%,14m
2343,1,一个谐星,3763,1279,157,98,255,61.6%,3m
2343,1,[白丝神教]泰罗奥特曼,3763,438,13,16,29,44.8%,15m
2343,2,[随便玩]回忆,3763,232,9,4,13,69.2%,16m
2343,3,[苍蓝残响]天空的旋律,3763,261,8,8,16,50.0%,2m
2343,2,[CUGer]云过天空,3763,0,0,2,2,0.0%,11m
2348,1,[Ogier]薰衣草,3762,1876,99,107,206,48.1%,38m
2348,1,[谐神]Requisition,3762,1450,47,59,106,44.3%,42m
2348,2,Satellite,3762,30,2,0,2,100.0%,14m
2351,1,Maki,3761,270,7,9,16,43.8%,43m
2351,2,[KPG]Orb,3761,38,1,2,3,33.3%,43m
2351,2,[喝馄饨]阿要辣油啊,3761,0,0,1,1,0.0%,15m
2351,2,TheYuan,3761,0,0,1,1,0.0%,9m
2355,1,TIME,3760,1961,201,178,379,53.0%,13m
2355,1,手残泰伦,3760,1928,123,128,251,49.0%,43m
2355,1,[传说萌娘团]wjh,3760,733,37,30,67,55.2%,16m
2355,2,LittlePrayer,3760,782,34,19,53,64.2%,14m
2355,2,APS,3760,128,5,3,8,62.5%,8m
2355,1,我好菜啊,3760,240,5,7,12,41.7%,20m
2355,3,低调超人,3760,0,1,0,1,100.0%,39m
2362,1,[Tuip]穿本,3759,385,9,13,22,40.9%,13m
2362,1,INNoVation,3759,241,7,7,14,50.0%,26m
2362,2,尼可,3759,0,1,0,1,100.0%,29m
2362,2,[鬼谷]帅雅文,3759,0,1,0,1,100.0%,41m
2362,2,[Brust]剪子卖萌,3759,0,1,1,2,50.0%,43m
2362,1,你好迪哥,3759,0,0,5,5,0.0%,3m
2368,1,VeniVediVici,3758,1932,442,437,879,50.3%,13m
2368,1,Fus,3758,736,65,49,114,57.0%,21m
2368,1,Reinforce,3758,478,32,47,79,40.5%,26m
2368,2,[你有毒吧]追猎萌萌哒,3758,316,11,12,23,47.8%,14m
2368,3,itisyyc,3758,0,0,1,1,0.0%,19m
2373,2,Haeta,3757,181,9,6,15,60.0%,20m
2373,2,Coldblooded,3757,0,0,1,1,0.0%,43m
2375,2,[TNLtr]荒塞沫寒,3756,196,6,5,11,54.5%,13m
2376,2,SpiderYao,3755,0,0,1,1,0.0%,21m
2377,1,[C33856]赵三湾银枪小霸王,3754,1807,206,218,424,48.6%,21m
2377,1,[火焰雷兽]Wangjiet,3754,1189,47,40,87,54.0%,42m
2377,1,[陈一发儿呀]玩小号必死亲妈,3754,275,8,8,16,50.0%,21m
2377,2,[我们是无敌的]你居然不知道治哥,3754,0,1,1,2,50.0%,18m
2381,1,好兄弟一起送,3753,1295,148,143,291,50.9%,13m
2381,2,南初妹妹,3753,1680,103,95,198,52.0%,8m
2381,3,氡瓜蛇皮,3753,58,2,2,4,50.0%,16m
2381,2,皮皮虾,3753,0,0,1,1,0.0%,4m
2385,2,[miku守护]萨尔纳加,3752,1097,58,52,110,52.7%,14m
2385,2,[C26289]遇事不决莽一波,3752,1184,50,33,83,60.2%,41m
2385,1,[DDOS破魂]纯机械化部队,3752,446,30,29,59,50.8%,16m
2385,2,夏隆,3752,278,13,4,17,76.5%,25m
2385,3,逆天中的逆天,3752,208,9,8,17,52.9%,15m
2385,2,不想运营,3752,166,6,5,11,54.5%,5m
2385,2,[IGS]是逗比还是逗逼,3752,0,0,1,1,0.0%,8m
2392,2,美丽的生活,3751,657,105,85,190,55.3%,40m
2392,2,[FAFA]sTarMoon,3751,1314,59,53,112,52.7%,6m
2392,1,[西湖底雅座]Tan,3751,1108,45,45,90,50.0%,14m
2392,2,马斯克,3751,133,9,4,13,69.2%,4m
2392,1,咘溪,3751,249,8,7,15,53.3%,26m
2397,2,DLDL,3750,288,11,3,14,78.6%,20m
2397,2,[底特律KAR]绿毛酱,3750,182,6,7,13,46.2%,14m
2397,2,[KK]落日耀,3750,32,2,1,3,66.7%,14m
2397,1,城市化请赐教,3750,92,2,11,13,15.4%,28m
2397,2,[DC战队]MarineKingSY,3750,0,0,2,2,0.0%,43m
2402,1,[NKTJ]tuguapi,3749,1289,72,62,134,53.7%,43m
2402,2,totoya,3749,522,60,46,106,56.6%,28m
2402,2,[TCP]Snorlax,3749,176,8,3,11,72.7%,22m
2405,1,不讲武德,3748,1753,234,233,467,50.1%,15m
2405,1,[SCJWJ3]加山天佑,3748,1822,157,173,330,47.6%,42m
2405,1,spelling,3748,1824,103,91,194,53.1%,20m
2405,1,[miku守护]killer,3748,1338,51,49,100,51.0%,21m
2405,2,[专干菜b队友]王小花,3748,656,34,10,44,77.3%,43m
2405,1,[幸运猫头鹰]dyppyd,3748,768,21,22,43,48.8%,26m
2405,2,[我们是无敌的]月落星辰,3748,0,0,1,1,0.0%,2m
2405,2,Fubuki,3748,0,0,1,1,0.0%,43m
2413,1,[真善美]Mvp,3747,1892,298,312,610,48.9%,40m
2413,2,ask,3747,284,9,11,20,45.0%,10m
2413,2,lllllllllll,3747,0,3,2,5,60.0%,12m
2413,2,小肚兜,3747,0,0,2,2,0.0%,25m
2417,1,[Holyam]LUCKGODSPEED,3746,1702,86,89,175,49.1%,14m
2417,2,[鸭蛋万岁]RiSkyKhan,3746,68,2,4,6,33.3%,8m
2417,2,PomeloTya,3746,0,0,1,1,0.0%,41m
2420,1,DietmarP,3745,155,3,6,9,33.3%,40m
2421,1,Forever,3744,1925,145,148,293,49.5%,14m
2421,2,[兰均竹空]舔舔舔舔舔大怪兽,3744,1407,101,93,194,52.1%,27m
2421,1,[杀虫剂]TOP,3744,616,16,18,34,47.1%,17m
2421,1,[ErebuS]IIIIIllllIlI,3744,662,16,27,43,37.2%,20m
2421,2,[chise]旋旋小飞机,3744,0,1,0,1,100.0%,3m
2426,1,Nicholas,3743,1647,87,76,163,53.4%,17m
2426,2,xsxs,3743,0,1,0,1,100.0%,25m
2428,3,共和国里当皇帝,3742,0,5,0,5,100.0%,18m
2428,1,[毒雨]自然选择号,3742,223,5,8,13,38.5%,20m
2428,2,[我菜请打队友]llllllllll,3742,0,0,1,1,0.0%,14m
2431,2,[哔翻天梯鸡]小瑞瑞是最可爱的,3741,376,13,11,24,54.2%,16m
2431,3,Gaster,3741,146,8,1,9,88.9%,28m
2431,2,sMo,3741,0,1,0,1,100.0%,25m
2431,2,[神族难民]Repick,3741,0,0,1,1,0.0%,28m
2431,2,[TYPEM]Feather,3741,0,0,1,1,0.0%,14m
2436,2,[不想打tvt]zsewqsc,3740,96,4,2,6,66.7%,14m
2436,2,[GAFASC]Jayecc,3740,70,2,6,8,25.0%,25m
2436,2,Arale,3740,0,1,0,1,100.0%,21m
2439,2,maochiyu,3739,1056,40,38,78,51.3%,18m
2439,2,[仙人BB]Maybe,3739,104,6,5,11,54.5%,14m
2439,2,羽落星辰,3739,160,6,8,14,42.9%,27m
2439,2,[你们都是渣]我真的不会防守,3739,96,4,0,4,100.0%,8m
2439,1,llllllllllll,3739,136,3,9,12,25.0%,20m
2444,2,[红魔馆的主人]东风谷早苗,3738,558,23,9,32,71.9%,6m
2444,2,点歌的人,3738,68,3,4,7,42.9%,25m
2444,2,[青风堂]mqdbxq,3738,0,1,0,1,100.0%,43m
2447,1,IIIIIIIIIIII,3737,1420,162,142,304,53.3%,19m
2447,1,懒牛牛,3737,1395,105,106,211,49.8%,3m
2447,1,[六芒星s]渺远时刻,3737,834,31,31,62,50.0%,15m
2447,2,[LOHv]木木,3737,0,1,0,1,100.0%,25m
2447,2,[北纬27度雨]薄荷微凉,3737,0,0,1,1,0.0%,29m
2447,2,[窈窕淑女]我不逑,3737,0,0,1,1,0.0%,21m
2453,2,[人人有功炼]大道之刑也,3736,756,28,29,57,49.1%,28m
2453,2,SCPLAYER,3736,222,7,9,16,43.8%,14m
2453,2,[ETG]SmileY,3736,96,4,0,4,100.0%,14m
2453,1,小黄狗,3736,88,3,9,12,25.0%,43m
2453,2,七海先辈,3736,0,0,1,1,0.0%,3m
2458,1,[慢手e族]熙羽连城,3735,1821,88,95,183,48.1%,17m
2458,1,YangYang,3735,224,6,15,21,28.6%,20m
2458,3,victorblack,3735,47,2,1,3,66.7%,40m
2458,1,Cooooooool,3735,46,2,5,7,28.6%,15m
2458,2,[旋风游骑兵]如果有一天,3735,0,1,1,2,50.0%,10m
2458,2,[最菜战队]纯新手,3735,0,1,1,2,50.0%,8m
2464,1,[凛风]雏咲深羽,3734,182,5,11,16,31.2%,41m
2464,1,IIIIIIIIIIII,3734,181,3,7,10,30.0%,20m
2464,2,[格里芬克鲁格]TosakaUCW,3734,0,1,0,1,100.0%,19m
2464,3,FayeDream,3734,30,1,2,3,33.3%,3m
2464,2,ddcat,3734,0,0,2,2,0.0%,12m
2464,3,Honor,3734,0,0,2,2,0.0%,21m
2470,1,[SCJWJ3]IIIIIIIIIIII,3733,1453,96,76,172,55.8%,43m
2470,1,[瓜瓜真是帅]sweet,3733,741,28,25,53,52.8%,15m
2470,2,超级无敌大炮哥哥,3733,388,20,4,24,83.3%,40m
2470,2,大秦黑客,3733,198,7,5,12,58.3%,27m
2474,2,[一等星]CoLa,3732,230,7,7,14,50.0%,6m
2474,2,[東京大学]最菜的假钻石,3732,0,0,1,1,0.0%,8m
2476,2,[火焰雷兽]旗鼓相当的对手,3731,1671,199,192,391,50.9%,14m
2476,1,星空交错,3731,1894,86,94,180,47.8%,19m
2476,1,[湖南大学]掠影,3731,1440,61,54,115,53.0%,11m
2476,1,IIIIIIIIIIII,3731,1319,48,39,87,55.2%,11m
2476,2,[带哥]为所欲为,3731,36,2,0,2,100.0%,44m
2481,1,星际争霸,3730,1902,529,509,1038,51.0%,19m
2481,2,mikes,3730,1356,75,44,119,63.0%,21m
2481,1,hmf,3730,1192,39,35,74,52.7%,13m
2481,2,[怎么羸P]一束七,3730,924,38,26,64,59.4%,15m
2481,2,[基金会]闪烁的星辰,3730,128,5,1,6,83.3%,9m
2481,2,SSF,3730,0,1,0,1,100.0%,8m
2481,2,[一起多人运动]野怪,3730,0,1,0,1,100.0%,21m
2481,2,[Team萌新]篝之雾枝,3730,0,0,1,1,0.0%,7m
2489,2,JumpingStone,3729,397,18,6,24,75.0%,14m
2489,2,经纬,3729,184,6,5,11,54.5%,29m
2489,1,rage,3729,254,6,12,18,33.3%,40m
2489,2,MPF,3729,118,5,9,14,35.7%,15m
2489,2,IIIIIIIIIIII,3729,64,3,2,5,60.0%,25m
2489,2,冰冰敲可耐,3729,70,3,2,5,60.0%,28m
2489,3,[QAQooo]黑白,3729,30,3,4,7,42.9%,15m
2489,3,[level7]MisakaMikoto,3729,0,1,0,1,100.0%,22m
2489,2,SilenceXuHui,3729,36,1,6,7,14.3%,6m
2489,2,没睡醒的某某菌,3729,0,0,1,1,0.0%,40m
2489,2,[ELSD]羊驼小哥哥,3729,0,0,2,2,0.0%,27m
2500,1,叶小钗,3728,1287,213,206,419,50.8%,3m
2500,2,SCV,3728,462,14,16,30,46.7%,14m
2500,3,[杀马特集中营]三球,3728,30,2,3,5,40.0%,8m
2503,2,RoyMustang,3727,36,2,1,3,66.7%,44m
2504,2,HIMAN,3726,242,9,3,12,75.0%,25m
2504,2,scplayer,3726,132,5,4,9,55.6%,12m
2504,2,[柠檬不萌]悲伤的大鹅,3726,34,2,0,2,100.0%,28m
2504,2,[艾抖露]唐可可,3726,0,0,1,1,0.0%,16m
2508,2,[夏树]Natsuki,3725,540,22,10,32,68.8%,20m
2508,3,Varuna,3725,0,0,1,1,0.0%,43m
2510,2,Mvp,3724,261,31,14,45,68.9%,28m
2510,1,IIIIIIII,3724,701,26,24,50,52.0%,13m
2510,2,[SKTCN]夏纪,3724,262,12,13,25,48.0%,19m
2513,2,[不不要求求你]别撕了我脱,3723,118,5,0,5,100.0%,15m
2513,1,window,3723,175,4,6,10,40.0%,21m
2513,2,SKTBisu,3723,0,0,1,1,0.0%,13m
2516,1,[FDG108]蜃気楼,3722,216,86,33,119,72.3%,17m
2516,2,结尾之音,3722,382,52,27,79,65.8%,21m
2516,2,IIIIIIIIIIII,3722,66,2,2,4,50.0%,6m
2516,3,[亚丝娜大白腿]结城明日奈,3722,0,1,0,1,100.0%,43m
2516,2,骑着追猎去抢钱,3722,40,1,1,2,50.0%,5m
2521,1,莫若枫雪,3721,572,17,20,37,45.9%,17m
2521,3,[太古]最爱吃兽奶,3721,144,8,1,9,88.9%,28m
2521,2,[HK丶S]屠杀弟弟,3721,0,0,2,2,0.0%,4m
2524,2,win,3720,908,36,29,65,55.4%,40m
2524,2,[pp]YHC,3720,572,21,25,46,45.7%,14m
2524,2,[PlMBA]UED,3720,66,2,2,4,50.0%,11m
2524,2,肚子疼请假,3720,30,1,2,3,33.3%,11m
2524,2,[混吃混喝]sun,3720,0,0,1,1,0.0%,21m
2529,2,[SteEng]红有三夏亚,3719,440,53,46,99,53.5%,19m
2529,3,大地小豪,3719,145,8,1,9,88.9%,15m
2529,2,幸福一家人,3719,64,3,3,6,50.0%,8m
2532,1,枪枪王,3718,1878,298,309,607,49.1%,28m
2532,1,[FORI]海凝清光,3718,1120,176,161,337,52.2%,40m
2532,1,[Encore]MrLoveQ,3718,1472,75,82,157,47.8%,6m
2532,2,[Shawk]青岛安纳,3718,1072,64,49,113,56.6%,4m
2532,1,酷酷尔,3718,1406,45,41,86,52.3%,43m
2537,2,优品忧学第一人,3717,1661,209,179,388,53.9%,8m
2537,1,[KPG2]skyline,3717,1696,170,171,341,49.9%,13m
2537,1,IIIIIIIIIIII,3717,1870,132,126,258,51.2%,15m
2537,2,IIIIIIIIIIII,3717,951,103,100,203,50.7%,6m
2537,1,[五月花]英雄联盟是辣鸡,3717,759,77,43,120,64.2%,26m
2537,2,小小擎,3717,1389,62,49,111,55.9%,21m
2537,1,KREC,3717,1168,33,39,72,45.8%,28m
2537,2,[肥飘俺的嫁]小野恵令奈,3717,656,24,23,47,51.1%,40m
2537,3,[Vgirls]幽鬼蛋,3717,0,3,2,5,60.0%,29m
2537,2,[Trow]StorM,3717,0,1,0,1,100.0%,25m
2537,2,[维庆是我儿]第一发言人,3717,34,1,3,4,25.0%,43m
2537,2,[青铜树]曼珠沙华,3717,0,0,1,1,0.0%,4m
2549,2,Rubick,3716,413,16,10,26,61.5%,6m
2549,2,喧哗上等,3716,324,11,9,20,55.0%,25m
2549,1,[tiandi]鹿目圆香,3716,134,4,11,15,26.7%,28m
2549,2,[YQJJ]Freedom,3716,0,1,0,1,100.0%,43m
2553,2,[丨SLT丨]柳丁,3715,642,35,72,107,32.7%,39m
2553,2,恶犬,3715,306,10,9,19,52.6%,21m
2553,1,[Vgirls]驻马店孙一峰,3715,268,7,14,21,33.3%,40m
2553,3,[大哥队]庭哥,3715,178,6,8,14,42.9%,24m
2553,1,wmw,3715,0,4,1,5,80.0%,19m
2558,1,[搬砖实录]你的民工父亲,3714,1661,86,93,179,48.0%,11m
2558,3,arthas,3714,120,7,0,7,100.0%,14m
2558,2,[BANDAL]SPIRITS,3714,0,1,0,1,100.0%,8m
2558,2,hzy,3714,0,0,1,1,0.0%,10m
2558,2,简单电脑,3714,0,0,1,1,0.0%,7m
2563,1,[FORI]waitxd,3713,1903,579,550,1129,51.3%,6m
2564,2,不会放大招,3712,1561,131,106,237,55.3%,43m
2564,1,[妖精卜卜口]QAQ,3712,1356,86,69,155,55.5%,13m
2564,2,胡尼玛,3712,128,5,4,9,55.6%,6m
2567,2,[SK]CheckMate,3711,814,33,30,63,52.4%,25m
2567,2,Sage,3711,299,15,7,22,68.2%,22m
2567,2,[猪一样的队友]求其的小白,3711,72,2,7,9,22.2%,14m
2567,2,[XJCN]CHNWR,3711,0,0,1,1,0.0%,3m
2567,2,[八一学校]TouFu,3711,0,0,1,1,0.0%,16m
2572,1,Mars,3710,1885,84,76,160,52.5%,3m
2572,3,[Anticw]SeeKfaithman,3710,0,1,5,6,16.7%,24m
2574,1,kalista,3709,210,5,8,13,38.5%,15m
2574,2,[雾雨魔法森林]麟汤团,3709,108,4,7,11,36.4%,8m
2574,2,[SoloAs]IIIIIIIIIIII,3709,0,0,1,1,0.0%,28m
2574,2,Speech,3709,0,0,2,2,0.0%,29m
2578,2,Acane,3708,869,38,31,69,55.1%,14m
2578,2,[枕头CRZ]星辰浩海,3708,1022,36,38,74,48.6%,8m
2580,2,DietmarP,3707,881,50,38,88,56.8%,20m
2580,2,[六字母连体人]三酱,3707,390,31,23,54,57.4%,21m
2580,2,[Rhusky]IOIO,3707,450,21,2,23,91.3%,44m
2580,2,chinahudie,3707,296,10,10,20,50.0%,25m
2580,2,[天际浩劫]木子,3707,204,8,10,18,44.4%,8m
2580,1,[RSTAR]红柚依然,3707,360,8,12,20,40.0%,28m
2586,3,ISHtar,3706,180,9,10,19,47.4%,8m
2586,2,noobs,3706,0,0,1,1,0.0%,6m
2586,2,开心超人,3706,0,0,1,1,0.0%,25m
2589,1,IIIIIIIIIIII,3705,1921,104,86,190,54.7%,19m
2589,2,Aquarius,3705,172,6,6,12,50.0%,3m
2589,3,[目標諾森德]演红袖真的是人吗,3705,0,1,0,1,100.0%,39m
2592,2,LeoLiu,3704,814,30,29,59,50.8%,25m
2592,3,将东方红,3704,213,10,3,13,76.9%,27m
2592,1,天天修地堡,3704,0,2,3,5,40.0%,39m
2592,2,[C55756]WEiQuNBrian,3704,0,1,7,8,12.5%,25m
2596,2,XXXXXXXX,3703,1573,341,324,665,51.3%,40m
2596,1,Lain,3703,1889,188,180,368,51.1%,17m
2596,2,炸鱼仔四圈加,3703,1702,104,86,190,54.7%,21m
2596,2,igXY,3703,160,6,6,12,50.0%,12m
2596,1,[Marry]逐风破影,3703,132,3,11,14,21.4%,28m
2601,2,[佩刀]Trigger,3702,1631,147,144,291,50.5%,44m
2601,1,[Flowex]米小五,3702,1614,78,76,154,50.6%,19m
2601,1,IIIIIIIIIIII,3702,614,15,19,34,44.1%,20m
2601,2,恋末灬,3702,272,11,7,18,61.1%,25m
2601,1,[华师大二附中]小小指挥官,3702,348,10,13,23,43.5%,17m
2601,2,大师我还有机会吗,3702,30,1,1,2,50.0%,28m
2607,1,随机尼玛呢随机,3701,383,13,13,26,50.0%,13m
2607,2,[DaCapo]朕无敌,3701,88,3,1,4,75.0%,40m
2609,1,[Solo]awesome,3700,1717,262,274,536,48.9%,15m
2609,2,[五月花]伏枥老鸡,3700,1292,133,103,236,56.4%,16m
2609,2,[禽禽禽]SCV,3700,650,24,22,46,52.2%,18m
2609,3,[PTB]骄阳想要沧海客,3700,0,0,7,7,0.0%,39m
2613,2,[X少NB]狛枝凪斗,3699,640,24,21,45,53.3%,18m
2613,2,小白兔,3699,440,17,10,27,63.0%,8m
2613,2,Invincible,3699,350,14,7,21,66.7%,21m
2613,2,[GaHo]liar,3699,102,4,4,8,50.0%,40m
2613,3,[炮炮]炮炮,3699,0,0,1,1,0.0%,42m
2618,2,SlayerSBoxeR,3698,600,24,13,37,64.9%,40m
2618,2,人族就赢不了,3698,68,2,1,3,66.7%,25m
2620,2,sampro,3697,1367,152,164,316,48.1%,4m
2620,1,develop,3697,1804,118,129,247,47.8%,26m
2620,1,llllllllllll,3697,1147,58,54,112,51.8%,27m
2620,2,[HypeR]LiquidSnute,3697,162,23,15,38,60.5%,8m
2620,2,[中华讲武堂]starlett,3697,486,18,13,31,58.1%,5m
2620,2,[每日一问]暴雪今天倒闭了吗,3697,32,1,3,4,25.0%,29m
2626,2,[魅笑]一阵风丶思念,3696,376,13,7,20,65.0%,42m
2626,2,DrSk,3696,0,1,4,5,20.0%,6m
2626,2,虽败灬小李,3696,0,0,1,1,0.0%,2m
2629,1,[混元星际流]孙一峰,3695,1244,37,47,84,44.0%,26m
2629,2,[牁鉿之子]神之刺客,3695,0,0,1,1,0.0%,25m
2631,1,[小鸡啄小鱼]小鸡,3694,1452,242,253,495,48.9%,39m
2631,2,[TZPer]ThunderBird,3694,263,24,21,45,53.3%,14m
2631,2,我爱你有左灯右行,3694,246,9,11,20,45.0%,27m
2631,2,[小鸡屠宰场a]脆皮鸡,3694,64,3,3,6,50.0%,22m
2631,2,星陨,3694,0,0,1,1,0.0%,21m
2631,2,[不可能那么萌]北方,3694,0,0,1,1,0.0%,7m
2637,1,[Spacet]心生,3693,1075,114,113,227,50.2%,42m
2637,1,ToSsGirL,3693,1526,76,85,161,47.2%,39m
2637,2,白夜星辰,3693,368,17,8,25,68.0%,9m
2637,1,塞肉是暴雪爹,3693,340,12,23,35,34.3%,15m
2637,3,AEGEL,3693,97,2,4,6,33.3%,16m
2637,2,[你好可爱]Ashlost,3693,0,1,0,1,100.0%,21m
2637,2,[龙猫]我爱虫虫,3693,0,0,1,1,0.0%,29m
2637,2,IIIIIIIIIII,3693,0,0,1,1,0.0%,25m
2645,2,[斯巴达血战团]JohnAnder,3692,1651,121,76,197,61.4%,13m
2645,1,lllllllllll,3692,591,21,24,45,46.7%,6m
2645,2,繁花落尽,3692,0,0,1,1,0.0%,16m
2648,2,yixiaohu,3691,536,35,28,63,55.6%,25m
2648,2,Destiny,3691,136,4,7,11,36.4%,10m
2648,3,明月君,3691,0,0,1,1,0.0%,4m
2648,2,Cabbage,3691,0,0,1,1,0.0%,22m
2652,2,wumian,3690,1650,210,194,404,52.0%,43m
2652,2,[GOTAL]丰厚的积分回复额,3690,1617,107,100,207,51.7%,41m
2652,2,Diamonds,3690,825,93,80,173,53.8%,28m
2652,2,青菜白玉汤,3690,522,22,11,33,66.7%,21m
2652,2,[星云]flzzking,3690,0,0,2,2,0.0%,1m
2657,1,[秋毫第七分队]puck,3689,1799,289,293,582,49.7%,39m
2657,2,[资江钓鱼]主宰的存在,3689,998,41,29,70,58.6%,28m
2657,2,[青娱乐]TTT,3689,952,37,31,68,54.4%,21m
2657,2,[墨者无敌]天天上上,3689,72,2,2,4,50.0%,25m
2657,2,晓美焰,3689,0,1,0,1,100.0%,21m
2662,2,[Elite]夲座,3688,302,10,13,23,43.5%,14m
2662,3,炸鱼,3688,107,5,4,9,55.6%,23m
2662,3,屠龙勇士,3688,147,3,2,5,60.0%,2m
2662,3,[Shawk]伊莉雅,3688,0,0,1,1,0.0%,10m
2666,2,[指尖奶茶]huxio,3687,815,74,67,141,52.5%,21m
2666,2,[ESP三队]Voldemort,3687,34,2,2,4,50.0%,40m
2666,2,特靠谱,3687,0,1,0,1,100.0%,21m
2666,2,[学习使我快乐]自由之神,3687,0,1,1,2,50.0%,10m
2670,2,我的运营像吕布,3686,62,3,1,4,75.0%,12m
2670,2,[空中劈叉]RaidenMei,3686,66,2,3,5,40.0%,29m
2670,2,[萨拉嘿]Batty,3686,0,1,0,1,100.0%,16m
2670,2,[YR]city,3686,0,0,1,1,0.0%,28m
2674,2,Say,3685,196,8,0,8,100.0%,19m
2674,2,[蕾米0莉亚]IIIIIIIIIIII,3685,109,5,6,11,45.5%,8m
2674,2,Lee,3685,64,3,6,9,33.3%,12m
2674,2,[江南狗王]墨鱼仔,3685,0,0,2,2,0.0%,43m
2678,2,[禁止捕捞]神族就无敌,3684,278,10,8,18,55.6%,4m
2678,3,炸鱼狗素质真差,3684,235,9,1,10,90.0%,5m
2678,2,[南北组一生推]Pluto,3684,102,4,1,5,80.0%,25m
2678,2,[哔哩哔哩乾杯]无敌的罐头,3684,30,2,4,6,33.3%,13m
2678,2,[Mello]BarCode,3684,0,0,1,1,0.0%,25m
2683,2,[武形秘仪]塔达林逼格第一人,3683,1621,137,142,279,49.1%,25m
2683,2,[丨SLT丨]小雨天天晴,3683,1077,56,57,113,49.6%,12m
2683,2,[WgSC2]cNyCN,3683,548,19,18,37,51.4%,8m
2683,2,深蓝,3683,351,18,7,25,72.0%,44m
2683,2,crescent,3683,120,5,4,9,55.6%,41m
2683,2,[YMET]IIIIIIIIIIII,3683,0,1,0,1,100.0%,14m
2683,2,星际争霸,3683,0,0,1,1,0.0%,10m
2683,2,[DSN]Mrsone,3683,0,0,1,1,0.0%,5m
2683,2,茜茜公主,3683,0,0,1,1,0.0%,9m
2692,1,绯幽,3681,740,19,28,47,40.4%,26m
2692,2,Auroras,3681,126,3,1,4,75.0%,8m
2692,2,若梦丶,3681,0,1,0,1,100.0%,3m
2692,2,[Bro2]MetatronX,3681,0,0,1,1,0.0%,41m
2692,2,娜贝,3681,0,0,1,1,0.0%,20m
2697,2,SBZR,3680,648,24,22,46,52.2%,2m
2697,2,[老油条战队]迷一样勒男人,3680,454,17,12,29,58.6%,21m
2697,2,[miku守护]Futech,3680,204,8,7,15,53.3%,21m
2700,2,IIIIIIIIII,3679,1473,84,56,140,60.0%,2m
2700,2,[Beauty]名字难起,3679,160,6,8,14,42.9%,27m
2700,3,Sunfinger,3679,147,5,4,9,55.6%,28m
2700,2,DietmarP,3679,66,3,0,3,100.0%,25m
2700,2,[卖鱼强]空条承太郎,3679,0,1,0,1,100.0%,14m
2700,3,[OsTi]Sasori,3679,0,1,1,2,50.0%,40m
2706,1,胡喵喵,3678,1121,96,109,205,46.8%,19m
2706,2,雷神同學,3678,0,0,1,1,0.0%,6m
2706,2,咖喱棒,3678,0,0,1,1,0.0%,21m
2709,2,xzylock,3677,322,12,7,19,63.2%,29m
2709,3,冲动是马桶,3677,207,11,1,12,91.7%,12m
2709,2,[我大哥孙换加]月望东山,3677,0,1,1,2,50.0%,9m
2712,1,[Beasty]盛夏未央灬,3676,658,56,58,114,49.1%,15m
2712,1,初生婴儿,3676,962,25,36,61,41.0%,43m
2712,2,HyperZero,3676,318,12,10,22,54.5%,43m
2712,2,[机械化之WD]TvT,3676,204,7,6,13,53.8%,25m
2712,2,[TGC]ByuN,3676,0,0,1,1,0.0%,43m
2717,2,[EcaT]IMMvp,3675,1187,141,118,259,54.4%,28m
2717,1,mimiga,3675,1248,46,39,85,54.1%,3m
2717,2,AAzhang,3675,442,17,9,26,65.4%,41m
2717,1,秋月白,3675,344,12,13,25,48.0%,19m
2717,3,[快活林]whwhzzz,3675,142,8,0,8,100.0%,4m
2717,2,[ANNEX]斩赤红灬之瞳,3675,216,7,5,12,58.3%,14m
2717,2,咩呜咔,3675,72,3,5,8,37.5%,2m
2724,2,[艾尔之巅]sweetheart,3674,571,124,107,231,53.7%,12m
2724,2,[遥远的拂晓]FakeNews,3674,1166,56,32,88,63.6%,4m
2724,2,[一等星]lingzhengjie,3674,364,12,14,26,46.2%,27m
2724,2,第八分队,3674,0,1,0,1,100.0%,14m
2728,2,[你的剑很美]MSGA,3672,1592,119,109,228,52.2%,21m
2728,2,[SoloAs]云生,3672,343,79,69,148,53.4%,28m
2728,1,孤儿请滚,3672,1596,50,59,109,45.9%,14m
2728,2,[DMRc]光酱咚咚光酱咚咚,3672,378,14,12,26,53.8%,5m
2728,3,Albertkelok,3672,211,10,2,12,83.3%,42m
2733,2,[肥飘俺的嫁]帕秋莉诺蕾姬,3671,0,0,2,2,0.0%,1m
2734,1,[Sc养老]过尘,3670,1633,111,87,198,56.1%,14m
2734,1,[DMRc]happygame,3670,1845,89,77,166,53.6%,20m
2734,2,[Hope]llllllllll,3670,1029,59,63,122,48.4%,12m
2734,1,Nyarlathotep,3670,310,7,20,27,25.9%,43m
2734,2,[TNLtr]Arpeggio,3670,60,3,2,5,60.0%,8m
2734,2,Broky,3670,150,3,4,7,42.9%,5m
2734,2,最终轨迹,3670,60,2,2,4,50.0%,25m
2741,1,[随便玩]東門吹水,3669,1853,100,85,185,54.1%,40m
2741,2,Ferrari,3669,1639,74,62,136,54.4%,3m
2741,1,[我们是无敌的]watch,3669,660,23,24,47,48.9%,15m
2741,2,[华师大二附中]MyStery,3669,322,13,6,19,68.4%,2m
2741,2,tossgirl,3669,62,2,2,4,50.0%,43m
2741,2,[火焰雷兽]innovating,3669,34,1,5,6,16.7%,10m
2747,1,zXt,3668,1218,85,92,177,48.0%,17m
2747,2,lIlIlIlI,3668,244,10,7,17,58.8%,40m
2749,1,[名最好别太长]CRCaptain,3667,1841,211,216,427,49.4%,4m
2749,2,[SoloAs]llllllllllll,3667,913,111,95,206,53.9%,6m
2749,2,[三千分的幽灵]沧海客,3667,552,20,19,39,51.3%,8m
2749,2,萌就是正义,3667,0,1,0,1,100.0%,25m
2753,2,[Fear]GoTIme,3666,0,1,0,1,100.0%,6m
2753,2,MarineKnight,3666,0,0,1,1,0.0%,28m
2755,3,摆渡人,3665,168,7,3,10,70.0%,18m
2756,2,change,3664,1395,63,40,103,61.2%,13m
2756,2,brook,3664,0,1,0,1,100.0%,21m
2756,3,危险药贩子,3664,30,1,3,4,25.0%,26m
2756,2,孙一峰,3664,0,0,4,4,0.0%,44m
2760,2,[五月花]千年之蝶,3663,1529,142,95,237,59.9%,9m
2760,2,[我们都是铁头]一拳超人,3663,530,19,17,36,52.8%,15m
2760,2,[SoloAs]zerone,3663,30,2,0,2,100.0%,3m
2760,2,llllllllllll,3663,0,1,0,1,100.0%,28m
2760,2,Garfii,3663,0,1,0,1,100.0%,11m
2765,1,未来史学派,3662,1846,228,243,471,48.4%,6m
2765,1,周杰伦,3662,1422,127,135,262,48.5%,13m
2765,2,小猫两三只,3662,0,0,1,1,0.0%,1m
2765,2,OnePower,3662,0,0,1,1,0.0%,21m
2769,2,外壳之魂,3661,1632,333,315,648,51.4%,1m
2769,2,结城明日奈,3661,1589,201,173,374,53.7%,11m
2769,2,IIIIIIIIIIII,3661,1503,102,102,204,50.0%,25m
2769,2,class,3661,252,19,5,24,79.2%,4m
2769,3,EiNaLParTing,3661,215,10,2,12,83.3%,23m
2769,3,[星灵王]我以为先生,3661,0,0,1,1,0.0%,43m
2769,2,[SoIoAs]血花缭乱,3661,0,0,1,1,0.0%,3m
2776,1,ForeverLove,3660,1854,66,82,148,44.6%,19m
2776,1,[秋毫]Themis,3660,1144,60,63,123,48.8%,26m
2776,2,[青娱乐]adidas,3660,1312,53,47,100,53.0%,3m
2776,2,Ecopter,3660,154,6,6,12,50.0%,13m
2776,2,[我们想睡觉]大概是投本,3660,92,4,2,6,66.7%,3m
2781,3,[Anticw]gxx,3659,215,7,1,8,87.5%,13m
2781,2,PrinceRegent,3659,0,1,0,1,100.0%,28m
2783,2,[最爱白鬼少女]ZainLayou,3658,1033,44,45,89,49.4%,20m
2783,2,[幼稚园电竞班]TuDouMing,3658,836,37,23,60,61.7%,5m
2783,2,[甜甜圈]天恩快乐,3658,376,16,10,26,61.5%,41m
2783,2,长春马,3658,167,5,3,8,62.5%,6m
2783,2,蓝白,3658,0,1,5,6,16.7%,14m
2783,2,金三胖,3658,0,0,5,5,0.0%,29m
2789,2,猪是的读来过倒,3657,1549,68,59,127,53.5%,41m
2789,2,[雏巢]zzzzzp,3657,142,5,9,14,35.7%,18m
2789,2,[XX丶OO]Geek,3657,0,0,1,1,0.0%,21m
2792,2,[贝塔]chen,3656,94,3,3,6,50.0%,9m
2792,1,空之轨迹,3656,46,1,10,11,9.1%,13m
2794,2,EssCstarDAY,3655,814,109,65,174,62.6%,4m
2794,2,DXF,3655,848,31,32,63,49.2%,14m
2794,3,[IBE]浅夏微梦,3655,326,16,1,17,94.1%,21m
2797,1,ToutLesoLe,3654,850,20,32,52,38.5%,40m
2797,2,SCPLAYER,3654,478,17,17,34,50.0%,14m
2797,2,nocastme,3654,30,1,1,2,50.0%,21m
2797,2,[Anticw]迷桐,3654,0,0,1,1,0.0%,4m
2801,2,[看啥]tankboy,3653,697,64,2,66,97.0%,8m
2801,2,SWTT,3653,402,25,26,51,49.0%,21m
2801,2,[C02337]阿发,3653,538,22,11,33,66.7%,19m
2801,2,Tuteli,3653,538,19,19,38,50.0%,18m
2801,2,AIFOX,3653,0,0,1,1,0.0%,43m
2806,1,kaguranana,3652,670,24,36,60,40.0%,26m
2807,1,[璀璨的星空]无畏字母,3650,295,21,19,40,52.5%,16m
2807,2,leexzq,3650,484,17,20,37,45.9%,28m
2807,2,[FsA]LuckySon,3650,198,10,9,19,52.6%,18m
2807,2,[HTW]手捂腹肌之力,3650,86,4,4,8,50.0%,8m
2807,2,[TossSE]樱小路,3650,60,3,4,7,42.9%,21m
2807,2,luvesyx,3650,0,1,0,1,100.0%,21m
2807,2,[神武骑士团]挖掘鸡,3650,0,1,2,3,33.3%,25m
2814,1,郭小洋,3649,1659,55,64,119,46.2%,20m
2814,2,炸鱼狗死妈,3649,274,11,3,14,78.6%,14m
2816,2,[KPG]彼岸星辰,3648,1504,73,63,136,53.7%,43m
2816,2,limitless,3648,666,30,19,49,61.2%,16m
2816,2,ByuN,3648,450,18,9,27,66.7%,15m
2816,3,陆昭恪子叹,3648,0,1,0,1,100.0%,4m
2816,2,[ETG]小狐狸太棒了,3648,0,1,0,1,100.0%,43m
2821,1,marry,3647,377,48,54,102,47.1%,19m
2821,2,[懟懟懟懟懟]漆欣然,3647,682,27,23,50,54.0%,40m
2821,2,qwer,3647,308,17,7,24,70.8%,41m
2821,2,LuckyLu,3647,332,13,7,20,65.0%,19m
2821,2,[落魄山]小周子,3647,0,0,2,2,0.0%,20m
2826,2,IIIIIIIIIIII,3646,1674,80,63,143,55.9%,40m
2826,2,[洗剪吹八元]麻辣刺猬,3646,1134,60,36,96,62.5%,14m
2826,2,IIIIIIIIIIII,3646,411,18,4,22,81.8%,10m
2826,2,CoinCidenCe,3646,132,5,3,8,62.5%,4m
2826,2,鬼影,3646,0,4,1,5,80.0%,3m
2826,2,[鹌鹑带星]字母丶,3646,0,0,1,1,0.0%,6m
2832,2,老送,3645,1022,52,57,109,47.7%,5m
2832,2,MaGeJiTerran,3645,532,39,29,68,57.4%,2m
2832,2,包了个媛,3645,32,2,4,6,33.3%,21m
2832,2,[EscII]筱雨,3645,0,0,1,1,0.0%,20m
2832,2,[祖安文豪协会]Fronk,3645,0,0,1,1,0.0%,25m
2837,2,[TeamAx]Amo,3644,663,44,30,74,59.5%,4m
2837,2,[禽禽禽]邪灬火,3644,996,34,42,76,44.7%,29m
2837,3,西木野真姬,3644,429,27,48,75,36.0%,20m
2837,2,[ELSD]DestInyuI,3644,92,4,10,14,28.6%,29m
2841,1,瓜大侠,3643,1153,37,38,75,49.3%,15m
2841,1,SCPLAYER,3643,750,28,39,67,41.8%,16m
2841,3,[粉红泡泡屋]白絮,3643,37,2,2,4,50.0%,10m
2844,2,不给曰就分手,3642,266,9,16,25,36.0%,4m
2844,2,[枫殇]BipolarTrans,3642,114,4,2,6,66.7%,13m
2844,2,[i瑶]孙六空,3642,0,2,3,5,40.0%,25m
2844,2,[天子这大菜B]虎牙丶阳光,3642,30,2,5,7,28.6%,14m
2844,2,[OhNo]紫色双华,3642,32,1,2,3,33.3%,4m
2844,3,mumu,3642,0,0,1,1,0.0%,17m
2850,2,[Gsumme]周杰伦,3641,706,33,13,46,71.7%,25m
2850,2,[FoD]lmUrFuture,3641,0,0,1,1,0.0%,27m
2850,2,巴姆,3641,0,0,1,1,0.0%,9m
2853,2,[ZTSCAP]军需官秦天瑞,3640,301,15,8,23,65.2%,10m
2853,2,IIIIIIIIIIII,3640,226,9,2,11,81.8%,43m
2853,2,[社交学教导]亨利克利格,3640,0,0,1,1,0.0%,41m
2853,2,从小就刘捷,3640,0,0,3,3,0.0%,6m
2857,1,[HTW]HowtoWinP,3639,1364,60,66,126,47.6%,3m
2857,1,[深圳老年星际]老婆看我打星际,3639,928,30,38,68,44.1%,3m
2857,3,Ranarok,3639,186,9,0,9,100.0%,22m
2857,2,YHC,3639,0,0,1,1,0.0%,21m
2861,3,sevens,3638,197,9,5,14,64.3%,44m
2861,2,kjd,3638,172,6,11,17,35.3%,3m
2861,3,[董魔王制霸军]人傻地多陶太守,3638,0,0,1,1,0.0%,43m
2864,2,啊球,3637,1414,211,194,405,52.1%,11m
2864,2,[adm]sunday,3637,0,1,0,1,100.0%,25m
2864,2,[NYLLF]我很单纯,3637,32,1,1,2,50.0%,4m
2864,2,大叔,3637,0,0,1,1,0.0%,15m
2864,2,[GalArC]玛艾露绿绿赫恩,3637,0,0,2,2,0.0%,11m
2869,2,[人族最强近战]魔仙堡第一美女,3636,1090,80,44,124,64.5%,11m
2869,2,MikuLINK,3636,608,22,22,44,50.0%,25m
2869,2,萌新小工蜂,3636,474,16,23,39,41.0%,12m
2869,2,Max,3636,154,7,3,10,70.0%,1m
2869,3,纯乾三,3636,142,4,1,5,80.0%,39m
2869,2,Speech,3636,0,0,1,1,0.0%,28m
2875,2,寂寞星辰,3635,1259,124,118,242,51.2%,27m
2875,2,llllllllllll,3635,778,29,29,58,50.0%,43m
2875,1,thinkBEN,3635,165,8,0,8,100.0%,5m
2875,1,葉璃,3635,0,5,0,5,100.0%,10m
2875,2,[吕布女团]魔法少女斯大林,3635,0,1,0,1,100.0%,41m
2875,2,[那日桃花灼灼]大鱼,3635,0,0,1,1,0.0%,1m
2881,2,[寿司吧嘤嘤怪]世羽丶波拿文都拉,3634,542,37,12,49,75.5%,6m
2881,2,[ACG系]小智,3634,540,30,23,53,56.6%,23m
2881,2,可乐骑士,3634,0,1,1,2,50.0%,3m
2884,2,[Vgirls]Agoni,3633,473,115,100,215,53.5%,21m
2884,2,[KPG2]隐刀我是你爹,3633,1490,87,74,161,54.0%,21m
2884,1,[TPoA]Chtholly,3633,1434,44,50,94,46.8%,39m
2884,2,[WILLE]sart,3633,402,15,10,25,60.0%,3m
2884,2,[幼稚园的故事]Yiyo,3633,292,11,10,21,52.4%,8m
2884,2,[月野兔]不会打神族,3633,164,7,2,9,77.8%,29m
2884,2,[ToHo]roshan,3633,88,4,2,6,66.7%,15m
2884,2,[大姐酒家]yyl,3633,0,1,0,1,100.0%,9m
2884,2,以圣光之名,3633,0,0,1,1,0.0%,23m
2893,2,sherlock,3632,348,13,9,22,59.1%,21m
2893,2,[XXHZ0]一只恋厨,3632,75,11,10,21,52.4%,14m
2893,2,莽夫黄旭东,3632,114,5,0,5,100.0%,40m
2893,2,[半个笨比]灰色吉连,3632,0,0,1,1,0.0%,12m
2897,1,悲剧小王子,3631,96,6,0,6,100.0%,39m
2897,2,浮华一场不过游戏,3631,179,6,4,10,60.0%,6m
2897,3,TTTLLL,3631,146,3,2,5,60.0%,29m
2897,2,亨利大叔,3631,32,2,4,6,33.3%,14m
2897,2,[萌M]虫族克星,3631,0,1,1,2,50.0%,5m
2897,2,[异乱]雇佣兵,3631,0,0,1,1,0.0%,25m
2903,1,为提买买河里冷西,3630,635,95,119,214,44.4%,39m
2903,2,[西窗法雨]竹节香附,3630,204,20,5,25,80.0%,19m
2903,2,斯巴达,3630,42,3,6,9,33.3%,19m
2903,2,小夜子,3630,0,0,2,2,0.0%,8m
2907,2,[一二一]IIIIIIIIII,3629,1638,215,195,410,52.4%,40m
2907,3,遥远之歌,3629,90,5,12,17,29.4%,21m
2907,2,llllllllllll,3629,86,4,7,11,36.4%,9m
2907,2,[ZJU]Unununium,3629,0,1,0,1,100.0%,21m
2907,2,我是你的霸霸,3629,0,1,0,1,100.0%,14m
2912,2,[入侵地球]农夫三拳有点疼,3628,1641,302,285,587,51.4%,27m
2912,2,朝如青丝暮成雪,3628,1096,48,50,98,49.0%,21m
2912,1,走丢的奶黄包,3628,0,2,2,4,50.0%,41m
2912,3,[棱镜]llllllllllll,3628,0,1,0,1,100.0%,26m
2916,1,IIIIIIIIIIII,3627,1840,827,836,1663,49.7%,6m
2916,2,紫罗兰,3627,1262,49,42,91,53.8%,4m
2916,2,[火焰雷兽]神印游,3627,680,23,29,52,44.2%,9m
2916,1,scer,3627,625,18,22,40,45.0%,27m
2916,2,[DMRe]INCONTROL,3627,278,11,10,21,52.4%,15m
2916,2,进击的艾伦,3627,317,11,11,22,50.0%,28m
2916,3,HelNYG,3627,30,1,12,13,7.7%,25m
2923,1,[萌新是真的菜]lllllllll,3626,120,3,14,17,17.6%,40m
2923,2,[肉鸡的饲养]小魔女伊蕾娜酱,3626,0,1,0,1,100.0%,4m
2923,2,谭松韵,3626,0,1,0,1,100.0%,4m
2923,2,XuChu,3626,0,0,1,1,0.0%,4m
2923,2,[镜花水月]萌萌的白团子,3626,0,0,2,2,0.0%,4m
2928,1,木雨,3625,1526,159,150,309,51.5%,27m
2928,2,[充气团]夜刀神十香,3625,418,16,15,31,51.6%,28m
2928,2,同义反复,3625,114,5,1,6,83.3%,9m
2928,2,对面的都是鸡,3625,136,4,11,15,26.7%,3m
2928,2,聯盟情報員,3625,34,2,4,6,33.3%,25m
2928,3,今晚不想心动,3625,0,1,0,1,100.0%,2m
2928,1,驻马店最强级别人,3625,48,1,3,4,25.0%,9m
2935,2,[恶劣玩家]北国丶雪域,3624,1189,63,54,117,53.8%,40m
2935,2,revolution,3624,30,2,0,2,100.0%,21m
2935,2,[生活奇奇怪怪]阿零零,3624,68,2,12,14,14.3%,27m
2935,2,[北极光小组]龙之神,3624,0,0,1,1,0.0%,8m
2939,2,[XJTU]MSGA,3623,1355,78,79,157,49.7%,12m
2939,2,[北邮猎猪人]拿破仑之魂,3623,616,64,63,127,50.4%,14m
2939,2,SBZ,3623,116,5,2,7,71.4%,25m
2939,3,[AOSmt]Feeling,3623,0,5,3,8,62.5%,25m
2939,1,为死而活,3623,96,4,4,8,50.0%,16m
2939,2,[众神的眷恋]Seapaw,3623,0,1,0,1,100.0%,14m
2945,1,MaggieYoung,3622,1816,752,732,1484,50.7%,14m
2945,2,DEADGAME,3622,1010,74,43,117,63.2%,29m
2945,2,[B站T老师]TeacherT,3622,718,31,17,48,64.6%,15m
2945,2,[DMR]光影三千,3622,150,6,5,11,54.5%,43m
2945,3,哼哼哈嘿,3622,0,0,2,2,0.0%,15m
2950,2,[四傻]PalaDin,3621,1551,107,95,202,53.0%,12m
2950,1,[YM]Littlefly,3621,1824,64,66,130,49.2%,14m
2950,2,钵钵鸡,3621,469,21,11,32,65.6%,43m
2950,2,[miku守护]哔哔哔,3621,422,17,11,28,60.7%,12m
2950,2,llllllllll,3621,60,3,1,4,75.0%,25m
2950,2,姓已注册,3621,0,0,1,1,0.0%,40m
2956,2,Cmos,3620,1537,119,105,224,53.1%,2m
2956,2,JekyllHyde,3620,437,23,22,45,51.1%,5m
2956,2,[运营之神]MixParG,3620,294,11,11,22,50.0%,21m
2956,2,[张校长]张大厨,3620,0,1,0,1,100.0%,21m
2960,2,[扫黄]IIIIIIIIIIII,3619,1187,49,38,87,56.3%,40m
2960,2,[死海古卷]铁胆火车侠,3619,0,1,3,4,25.0%,27m
2960,2,[我们的奇迹]稻花香里说丰年,3619,0,0,1,1,0.0%,3m
2960,2,[rush2]小杨东,3619,0,0,1,1,0.0%,21m
2960,2,[白给滴神]血花缭乱,3619,0,0,1,1,0.0%,42m
2965,2,游戏之王,3618,1509,167,171,338,49.4%,22m
2965,2,想名字真麻烦,3618,989,49,17,66,74.2%,21m
2965,2,[仨大傻子之队]传说之巅,3618,1071,48,27,75,64.0%,43m
2965,2,嘻哈氪金人,3618,711,31,21,52,59.6%,13m
2965,2,yudian,3618,606,24,15,39,61.5%,8m
2965,2,我要六块腹肌,3618,271,10,14,24,41.7%,9m
2965,2,蛋炒饭很好吃,3618,98,4,4,8,50.0%,40m
2965,2,[韩宗快乐屋]菜鸡,3618,102,3,1,4,75.0%,43m
2965,3,IIIIIIIIIII,3618,97,2,1,3,66.7%,13m
2965,2,[第八舰队丶]我差不多是只废虎,3618,0,0,1,1,0.0%,14m
2975,2,[好爷爷]跟兄弟打星际,3617,1435,71,63,134,53.0%,1m
2975,2,[英俊潇洒能打]地图全开,3617,755,32,21,53,60.4%,9m
2975,2,四四四,3617,90,4,2,6,66.7%,27m
2975,2,[3GPP]梁某,3617,0,0,1,1,0.0%,12m
2979,2,長春,3616,1422,66,45,111,59.5%,14m
2979,2,小小萌新,3616,1184,63,24,87,72.4%,43m
2979,3,wei,3616,163,8,2,10,80.0%,20m
2979,3,看你美,3616,241,8,7,15,53.3%,6m
2979,3,[RyH键谈坊]魂魄妖梦,3616,60,4,7,11,36.4%,17m
2984,2,Ophelia,3615,1444,122,110,232,52.6%,25m
2984,2,这个世界需要勇士,3615,1202,56,35,91,61.5%,25m
2984,2,IIIIIIIIIIII,3615,582,23,18,41,56.1%,6m
2984,2,真不错,3615,430,17,18,35,48.6%,44m
2984,1,IIIIIIIIIIII,3615,48,2,3,5,40.0%,4m
2984,3,[雪月]回归的狙击手,3615,0,1,2,3,33.3%,22m
2984,2,[HDU]GrayWolf,3615,0,0,1,1,0.0%,44m
2991,2,MasterKenobi,3614,1622,130,108,238,54.6%,13m
2991,2,Rogue,3614,705,34,12,46,73.9%,43m
2991,1,IIIIIIIIIIII,3614,192,6,19,25,24.0%,42m
2991,3,punish,3614,164,5,0,5,100.0%,28m
2991,2,IsFour,3614,58,2,2,4,50.0%,4m
2991,2,[SK]灵能风暴中的跳虫,3614,0,1,4,5,20.0%,27m
2997,1,[贵州人]小春我的阳,3613,0,4,0,4,100.0%,10m
2997,2,[Tilt]NiGhtHawK,3613,30,2,1,3,66.7%,23m
2997,3,Bloodless,3613,0,0,1,1,0.0%,17m
3000,1,llllllllllll,3612,1686,80,80,160,50.0%,27m
3000,2,[HFLSer]speaklater,3612,114,4,2,6,66.7%,2m
3000,2,CITADELDARK,3612,0,1,0,1,100.0%,25m
3000,2,[AHO骑士团]艾酱,3612,0,0,1,1,0.0%,22m
3004,2,[GO丨]YIyA,3611,198,8,5,13,61.5%,21m
3004,3,[不可解]花谱,3611,0,1,5,6,16.7%,17m
3004,2,[Ryon榕]王菜花,3611,0,0,1,1,0.0%,21m
3007,2,[星际争霸第一]blizzarnmsl,3610,1598,99,75,174,56.9%,13m
3007,2,[传说萌鸡团]吡虫啉,3610,627,23,25,48,47.9%,2m
3007,2,[阿库西斯教团]无声黑白,3610,30,2,2,4,50.0%,14m
3007,2,[rush2]INnovation,3610,30,1,2,3,33.3%,40m
3007,2,frostmourne,3610,0,0,1,1,0.0%,11m
3012,2,明熙丶,3609,1436,86,81,167,51.5%,25m
3012,2,[noterr]消失点,3609,612,24,20,44,54.5%,2m
3012,2,[TCP]西湖雅座有请,3609,128,6,2,8,75.0%,42m
3012,2,上神,3609,88,3,5,8,37.5%,27m
3012,2,Blank,3609,0,0,1,1,0.0%,12m
3017,2,[GOTAL]Snowpanda,3608,371,55,46,101,54.5%,18m
3017,2,四季和你五选一,3608,278,11,9,20,55.0%,14m
3019,2,[洁白之巅]洋洋得意,3607,1279,74,66,140,52.9%,6m
3019,2,llllllllllll,3607,263,10,10,20,50.0%,27m
3019,2,[真的是疯狗]炒饭但丁,3607,30,1,3,4,25.0%,23m
3022,2,SwordArt,3606,1392,55,48,103,53.4%,29m
3022,2,就他马你叫夏洛啊,3606,128,4,4,8,50.0%,21m
3022,2,[奈亚子]Cyclone,3606,58,2,1,3,66.7%,4m
3022,2,OVO,3606,0,0,1,1,0.0%,21m
3022,2,beieifjs,3606,0,0,1,1,0.0%,15m
3027,2,DealMeIn,3605,1625,83,66,149,55.7%,41m
3027,2,避雷针,3605,639,26,18,44,59.1%,25m
3027,3,Heven,3605,215,7,10,17,41.2%,3m
3027,1,[昆明RANK]毛脸雷公嘴的和尚,3605,0,1,3,4,25.0%,19m
3027,2,[单推五河宗]男妈妈,3605,30,1,3,4,25.0%,11m
3027,2,Murasame,3605,0,0,3,3,0.0%,3m
3033,2,蟹球的迷茫,3604,1641,289,262,551,52.5%,25m
3033,2,whiter,3604,909,67,73,140,47.9%,29m
3033,3,影白羊,3604,191,10,2,12,83.3%,13m
3033,1,萌新不会玩,3604,0,1,0,1,100.0%,4m
3033,1,BinARy,3604,0,0,1,1,0.0%,16m
3038,1,IIIIIIIIII,3603,1439,184,181,365,50.4%,17m
3038,2,[还是选赵敏吧]OsharasShiel,3603,1405,138,109,247,55.9%,21m
3038,2,BOX,3603,1448,81,72,153,52.9%,40m
3038,3,MusHEnFeNg,3603,268,12,6,18,66.7%,26m
3038,2,不要说话,3603,40,4,7,11,36.4%,14m
3038,2,[Legacy]浮夸的世界怎么办,3603,62,2,2,4,50.0%,20m
3038,3,[旋风游骑兵]空字第,3603,0,0,1,1,0.0%,6m
3038,2,[单一小队]切膏,3603,0,0,1,1,0.0%,22m
3046,2,[十堰]不追寻,3602,1412,84,75,159,52.8%,44m
3046,1,结束是永恒,3602,139,7,1,8,87.5%,4m
3046,2,破晓的流星,3602,164,7,10,17,41.2%,28m
3046,2,[传说萌娘团]星际争霸灬灵,3602,30,2,0,2,100.0%,21m
3046,2,超能陆战队,3602,0,1,2,3,33.3%,8m
3051,3,[Toss]新的希望,3601,1839,217,238,455,47.7%,10m
3051,2,IIII,3601,711,84,75,159,52.8%,28m
3051,2,HumanLegacy,3601,1242,50,47,97,51.5%,9m
3051,3,[四千分的幽灵]沧海客,3601,124,12,4,16,75.0%,12m
3051,2,[esport]Clear,3601,120,4,7,11,36.4%,8m
3051,2,[迷路的麋鹿]qthhh,3601,32,2,2,4,50.0%,19m
3051,2,[南京农业大学]llllllllllll,3601,0,1,0,1,100.0%,6m
3051,2,萝卜,3601,0,1,0,1,100.0%,42m
3051,2,[青娱乐]YinQ,3601,0,0,1,1,0.0%,25m
3060,1,老牛识途,3600,1809,348,350,698,49.9%,14m
3060,2,午时已到,3600,1411,91,89,180,50.6%,5m
3060,2,[Beasty]ProtossOutl,3600,360,13,11,24,54.2%,40m
3060,2,[魔幻星际]Ninro,3600,200,10,17,27,37.0%,18m
3060,2,傻閪灵芝超,3600,96,2,2,4,50.0%,4m
3060,2,飞天猪肉,3600,0,0,3,3,0.0%,43m
3066,1,ghgiugiu,3599,1778,94,105,199,47.2%,19m
3066,2,甩断手,3599,42,3,5,8,37.5%,28m
3066,2,为太阳而战,3599,0,1,2,3,33.3%,43m
3066,2,llllllllllll,3599,30,1,3,4,25.0%,20m
3070,2,[五月花]wzw,3598,1612,160,142,302,53.0%,6m
3070,2,流浪泰伦,3598,1595,111,96,207,53.6%,44m
3070,2,银仔,3598,993,44,39,83,53.0%,2m
3070,2,[NtS特工队]AiseYan,3598,280,11,6,17,64.7%,18m
3070,2,[RBO]Rainbow,3598,0,0,1,1,0.0%,2m
3070,1,二向箔,3598,0,0,1,1,0.0%,4m
3076,2,[哔翻天梯鸡]ddddd,3597,1490,64,62,126,50.8%,18m
3076,2,[南京大学]Jungle,3597,882,36,25,61,59.0%,21m
3076,2,[Ours]阿西吧,3597,439,19,16,35,54.3%,28m
3079,1,kakay,3596,1649,142,142,284,50.0%,16m
3079,2,[教主别动队]锦绣柒阅,3596,493,20,12,32,62.5%,5m
3079,2,天天开心,3596,397,14,16,30,46.7%,44m
3079,2,Closer,3596,300,11,10,21,52.4%,25m
3079,2,彬彬好逊,3596,194,10,6,16,62.5%,25m
3079,2,[休闲的电脑]电脑,3596,116,5,1,6,83.3%,3m
3085,2,[Rhusky]空城旧梦,3595,1219,100,82,182,54.9%,22m
3085,2,[饲料姐姐无敌]Marine,3595,92,3,2,5,60.0%,12m
3085,2,UEDerard,3595,0,1,0,1,100.0%,14m
3085,2,[真天堂之魔]泰凯斯,3595,0,1,0,1,100.0%,28m
3085,2,[青生浮梦]祈梦,3595,0,0,1,1,0.0%,25m
3090,2,[我们是无敌的]Morgana,3594,935,55,13,68,80.9%,27m
3090,2,Nemo,3594,30,1,2,3,33.3%,28m
3092,1,[哔翻天梯鸡]peipei,3593,1828,325,321,646,50.3%,17m
3092,2,hellokitty,3593,175,6,1,7,85.7%,6m
3092,2,刑宇瞻,3593,0,5,0,5,100.0%,22m
3092,2,不爱吃豆豆,3593,0,0,1,1,0.0%,13m
3092,2,[超级哈皮]Spicybar,3593,0,0,2,2,0.0%,25m
3097,3,[我们都是铁头]艾尔之子,3592,197,7,8,15,46.7%,44m
3097,2,[VSua3]万丈尘寰终独赴,3592,34,1,4,5,20.0%,43m
3097,2,[基佬协会]熊猫大侠,3592,0,0,4,4,0.0%,27m
3100,2,你的爱丽丝,3591,1399,64,69,133,48.1%,28m
3100,1,沧海客,3591,212,6,15,21,28.6%,17m
3100,3,ForTheDream,3591,30,1,4,5,20.0%,16m
3100,2,[Magic]JORE,3591,0,0,1,1,0.0%,8m
3104,1,[MAC]xmxbm,3590,1097,48,51,99,48.5%,17m
3104,2,[我们都是萌新]心如薄荷天生凉,3590,678,32,13,45,71.1%,4m
3104,2,[丿Es灬回忆]周大侠,3590,0,0,1,1,0.0%,9m
3107,2,[CPT]黑夜的光,3589,1616,79,73,152,52.0%,8m
3107,2,rise,3589,509,31,23,54,57.4%,15m
3107,2,[RaMoC]单人浪漫,3589,596,22,24,46,47.8%,40m
3107,2,爱蜜莉雅,3589,114,5,0,5,100.0%,14m
3107,2,[3GPP]减肥成功的基王,3589,0,0,1,1,0.0%,9m
3112,1,[教我玩神族]时崎狂北小北姬,3588,1706,158,164,322,49.1%,27m
3112,2,[ATeam]天丶依旧,3588,454,33,22,55,60.0%,5m
3112,2,IIIIIIIIIII,3588,116,4,7,11,36.4%,9m
3112,2,[狂风暴风雨]羽络,3588,0,1,0,1,100.0%,14m
3112,2,星灵,3588,0,0,1,1,0.0%,42m
3117,1,只是个小人物,3587,1648,69,78,147,46.9%,16m
3117,2,iconfour,3587,498,16,25,41,39.0%,21m
3117,2,ApmJustThree,3587,160,6,6,12,50.0%,20m
3117,2,[GFA]Fireworks,3587,76,3,3,6,50.0%,20m
3117,3,lichadebo,3587,58,2,5,7,28.6%,30m
3117,2,格里芬小将叶戈尔,3587,0,0,1,1,0.0%,14m
3117,2,[醫生姐姐來了]灵幻者,3587,0,0,1,1,0.0%,23m
3117,2,会上树的猫,3587,0,0,1,1,0.0%,28m
3125,2,[LyN]无限一波男,3586,1582,134,129,263,51.0%,14m
3125,2,Richmona,3586,1147,47,37,84,56.0%,9m
3125,2,[舞铲阶级]专打艾尔刁民,3586,826,35,37,72,48.6%,20m
3125,2,IIIIIIIIII,3586,0,5,0,5,100.0%,17m
3125,2,Xin,3586,114,4,2,6,66.7%,25m
3125,2,[肉鸡的饲养]Alone,3586,58,2,11,13,15.4%,13m
3125,2,[黑粉头子]静静的看你装逼,3586,0,1,0,1,100.0%,41m
3125,2,[称霸青铜界]够毒才男人,3586,0,0,1,1,0.0%,2m
3133,2,ArSonMan,3585,926,212,201,413,51.3%,12m
3133,2,九指神丐,3585,30,2,0,2,100.0%,42m
3133,2,国服阴间人真的多,3585,30,2,3,5,40.0%,6m
3133,2,[SST]我好菜,3585,30,1,2,3,33.3%,15m
3137,2,[四叶草]FireKeeper,3584,1517,120,104,224,53.6%,18m
3137,2,IIIIIIIIIIII,3584,34,1,2,3,33.3%,40m
3139,2,IIIIIIIIII,3583,178,7,7,14,50.0%,20m
3139,2,[Warp]希格斯玻色子,3583,126,4,10,14,28.6%,28m
3139,2,榜眼,3583,0,1,0,1,100.0%,3m
3139,2,[三国演义]maver,3583,0,0,2,2,0.0%,18m
3139,2,[笙风]lonely,3583,0,0,2,2,0.0%,29m
3144,2,Darin,3582,1528,196,176,372,52.7%,28m
3144,2,断手麒麟臂方少云,3582,58,2,3,5,40.0%,25m
3144,2,IIIIIIIIIII,3582,0,1,0,1,100.0%,22m
3144,2,IIIIIIIIIIII,3582,0,0,1,1,0.0%,6m
3148,2,[燕大SC]待宰的五只羊,3581,170,9,2,11,81.8%,14m
3148,2,老王,3581,58,3,5,8,37.5%,4m
3148,2,[老年人反应]不要打我一波好嘛,3581,60,2,3,5,40.0%,8m
3148,3,制霸,3581,0,1,0,1,100.0%,16m
3148,3,农夫山泉有点苦,3581,0,1,0,1,100.0%,28m
3148,2,长野原美绪,3581,30,1,2,3,33.3%,14m
3148,2,李舜生,3581,0,0,1,1,0.0%,6m
3148,2,HDZXX,3581,0,0,2,2,0.0%,12m
3156,2,MrChen,3580,901,39,38,77,50.6%,10m
3156,2,针不戳,3580,335,14,11,25,56.0%,5m
3156,2,[Poker]Miss,3580,400,14,17,31,45.2%,41m
3156,2,[大鸟转转转]unnerf,3580,294,11,7,18,61.1%,42m
3156,2,[蒙蔽梦游团]stardust,3580,90,4,5,9,44.4%,28m
3156,2,泡沫丶漓,3580,128,4,8,12,33.3%,25m
3156,2,[GO萌新分队]梅西,3580,0,1,0,1,100.0%,5m
3156,2,Alpha,3580,0,0,1,1,0.0%,9m
3164,1,[DHuman]mingCorleone,3579,1820,229,226,455,50.3%,13m
3164,2,[万川归流]墨汌,3579,686,56,37,93,60.2%,4m
3164,3,[武德充沛]王福顺,3579,144,8,3,11,72.7%,10m
3164,2,[鸽子窝]我不是富翁,3579,58,3,0,3,100.0%,8m
3164,2,一纸水与青,3579,96,3,9,12,25.0%,11m
3164,2,[北极光小组]寒风,3579,0,1,0,1,100.0%,41m
3170,2,[begin]LionCm,3578,30,2,4,6,33.3%,25m
3170,2,[just]marineking,3578,0,1,0,1,100.0%,21m
3170,2,[水光潋滟]乖乖小,3578,0,1,0,1,100.0%,8m
3170,2,MrainGee,3578,0,0,2,2,0.0%,27m
3174,2,[青莲剑阁]枯林,3577,472,60,38,98,61.2%,23m
3174,2,[绝望星灵]再见了星际,3577,458,18,15,33,54.5%,23m
3174,2,chiao,3577,280,11,7,18,61.1%,6m
3174,2,[暗黑幻想]BBOYCHEERS,3577,0,2,0,2,100.0%,4m
3174,2,[骂人]对面煞笔敢还嘴吗,3577,30,2,0,2,100.0%,42m
3179,2,jsdgfashg,3576,1458,63,62,125,50.4%,16m
3179,1,IIIIIIIIIIII,3576,831,48,53,101,47.5%,27m
3179,2,[我们菜的1b]北虚川,3576,1026,43,32,75,57.3%,11m
3179,2,[詹姆斯T]柯克舰长,3576,832,30,37,67,44.8%,11m
3179,2,千机变,3576,0,5,0,5,100.0%,28m
3179,2,Aphrodite,3576,86,4,1,5,80.0%,15m
3179,2,[红白梦恋]招财夢,3576,96,4,6,10,40.0%,44m
3179,2,野良神,3576,120,4,10,14,28.6%,40m
3179,2,科普卢第一莽夫,3576,0,2,3,5,40.0%,29m
3179,3,[救赎蔷薇]天国副君萨斯利尔,3576,0,1,0,1,100.0%,6m
3189,2,[金灿灿狙击队]白花花,3575,1591,94,94,188,50.0%,4m
3189,2,[Months]July,3575,570,19,26,45,42.2%,8m
3189,2,[社交学大可爱]希格拉,3575,163,10,11,21,47.6%,28m
3189,2,如梦令,3575,114,4,2,6,66.7%,20m
3189,2,需要更多的补给站,3575,30,2,0,2,100.0%,16m
3189,3,[你们都是渣]你们都是渣,3575,0,1,0,1,100.0%,27m
3189,2,Elaina,3575,0,0,1,1,0.0%,4m
3189,2,kappa,3575,0,0,1,1,0.0%,2m
3189,2,红白,3575,0,0,5,5,0.0%,2m
3198,1,[ToHost]小白菜,3574,1732,296,280,576,51.4%,11m
3198,2,柠檬酱是好人,3574,1373,83,69,152,54.6%,21m
3198,2,irrep,3574,1006,37,42,79,46.8%,3m
3198,2,[ME丶]MIsshY,3574,410,15,15,30,50.0%,12m
3198,2,William,3574,192,7,4,11,63.6%,3m
3198,2,[Guru]IIIIIIIIIII,3574,30,1,2,3,33.3%,6m
3204,2,[乳主头子]那只狗是我的,3573,1513,122,105,227,53.7%,44m
3204,2,[NZNZ]IIIIIIIIIIII,3573,694,25,28,53,47.2%,42m
3204,2,艾芙九瞄,3573,60,2,3,5,40.0%,14m
3204,2,[禽禽禽]推倒冰封,3573,30,1,3,4,25.0%,3m
3208,2,MogulNeggEr,3572,673,32,24,56,57.1%,40m
3208,2,[巨人猎手]不死鸟丶響,3572,228,8,10,18,44.4%,40m
3208,2,[少女的下午茶]DrEsther,3572,0,0,1,1,0.0%,44m
3208,2,iiiiiiiiiiii,3572,0,0,2,2,0.0%,41m
3212,1,[Toss]cindy,3571,1793,227,221,448,50.7%,3m
3212,2,橘子,3571,1557,139,142,281,49.5%,7m
3212,2,sleepyshaman,3571,1410,69,58,127,54.3%,8m
3212,2,humudne,3571,0,1,0,1,100.0%,8m
3212,2,[暴雪我是你爹]电脑玩家詹姆斯,3571,30,1,5,6,16.7%,15m
3212,2,[情谊至上]大雄的哆啦梦,3571,0,0,1,1,0.0%,3m
3218,2,[异乱]Drug,3570,1656,608,583,1191,51.0%,3m
3218,1,[Etd]小费,3570,1795,421,421,842,50.0%,16m
3218,2,fansykk,3570,1522,156,135,291,53.6%,14m
3218,2,IIIIIIIIIIII,3570,720,113,95,208,54.3%,8m
3218,2,可可里拉,3570,1166,61,61,122,50.0%,4m
3218,2,[格里芬克鲁格]荒原老铁,3570,577,21,16,37,56.8%,29m
3218,2,开门暗影卫队,3570,352,14,10,24,58.3%,7m
3218,2,[GAGA]清泉石上流,3570,264,10,8,18,55.6%,44m
3218,2,[邪能打鸡]Alastor,3570,30,2,0,2,100.0%,3m
3218,2,artificial,3570,0,1,0,1,100.0%,22m
3218,3,HardWalnut,3570,0,1,0,1,100.0%,16m
3218,2,香橙味布丁吖,3570,0,0,1,1,0.0%,9m
3230,2,幽月,3569,1273,173,169,342,50.6%,18m
3230,2,yeqi,3569,1129,59,45,104,56.7%,16m
3230,3,[武汉理工大学]小刀哥,3569,209,7,2,9,77.8%,28m
3230,2,[通灵女孩]yaobohan,3569,142,6,4,10,60.0%,21m
3230,2,[Tricky]IIIIIIIIIII,3569,114,5,4,9,55.6%,16m
3230,2,[miku守护]Duron,3569,120,4,6,10,40.0%,5m
3230,2,xCc,3569,94,3,5,8,37.5%,25m
3230,2,[Shawk]HappyStar,3569,30,2,0,2,100.0%,27m
3230,1,[酒池肉林]Flash,3569,48,1,6,7,14.3%,2m
3230,2,DDSSGG,3569,0,0,1,1,0.0%,44m
3230,2,永远十六的美少女,3569,0,0,1,1,0.0%,25m
3241,2,浮华上的沧桑,3568,1532,426,396,822,51.8%,9m
3241,3,九十九遊馬,3568,228,11,3,14,78.6%,19m
3241,2,[强者灬王者]若梦撕心,3568,178,6,7,13,46.2%,12m
3241,2,[荒芜岁月]梦魇之殇,3568,0,1,1,2,50.0%,41m
3245,1,zhz,3567,1551,140,129,269,52.0%,13m
3245,2,[探基物语]苦中作乐,3567,58,2,1,3,66.7%,9m
3245,2,何大梦,3567,0,1,1,2,50.0%,44m
3245,2,[南京龟广州兔]longinus,3567,0,1,2,3,33.3%,12m
3249,2,大爸爸,3566,974,39,37,76,51.3%,44m
3249,2,一生所爱,3566,202,7,2,9,77.8%,12m
3249,2,想吃牛肉干,3566,165,7,7,14,50.0%,20m
3249,2,alex,3566,146,6,4,10,60.0%,12m
3249,1,[虚拟歌手团体]llllllllllll,3566,48,2,0,2,100.0%,24m
3249,2,Doraemon,3566,30,1,2,3,33.3%,25m
3249,2,[Hnlg]灵魂当铺,3566,32,1,8,9,11.1%,6m
3249,2,[黑哨]蝎子莱莱,3566,0,0,1,1,0.0%,15m
3249,2,llllllllllll,3566,0,0,2,2,0.0%,8m
3258,2,killik,3565,1102,46,43,89,51.7%,8m
3258,2,耶巴蒂莱维贝贝,3565,1093,42,38,80,52.5%,8m
3258,2,[i9]㝵㝵㝵㝵㝵㝵㝵㝵,3565,412,21,5,26,80.8%,9m
3258,2,[玛莎哥牛B]大大,3565,0,1,1,2,50.0%,15m
3258,2,lastdream,3565,0,0,1,1,0.0%,11m
3263,1,justin,3564,1120,462,443,905,51.0%,43m
3263,2,IIIIIIIIII,3564,765,91,85,176,51.7%,6m
3263,2,[Beasty]CenturiesBoy,3564,362,13,7,20,65.0%,28m
3263,3,[中华兄弟会]刚好五个字,3564,229,12,5,17,70.6%,11m
3263,2,clear,3564,86,4,1,5,80.0%,42m
3263,2,南京孙一峰,3564,126,4,9,13,30.8%,44m
3263,3,[樱花女神团]猫小妖,3564,0,1,0,1,100.0%,16m
3263,2,[谐星TV]涵意,3564,30,1,1,2,50.0%,22m
3263,2,地瓜,3564,0,0,1,1,0.0%,11m
3263,2,mumu,3564,0,0,1,1,0.0%,21m
3273,2,痛击队友丶,3563,898,77,58,135,57.0%,6m
3273,2,空条承太郎,3563,850,71,41,112,63.4%,2m
3273,2,TakkiStone,3563,1097,69,65,134,51.5%,40m
3273,2,蟑螂一拱开三矿,3563,699,30,22,52,57.7%,9m
3273,2,南美尼哥内马尔,3563,274,11,6,17,64.7%,11m
3273,2,[亚投行]星灵风暴,3563,0,0,1,1,0.0%,41m
3279,2,三色堇,3562,194,9,0,9,100.0%,28m
3279,2,[Fear]CoCaCoLa,3562,0,1,0,1,100.0%,23m
3279,2,[HeroZP]siyang,3562,0,1,3,4,25.0%,21m
3279,1,[菜鸟根据地]咸鱼,3562,0,0,1,1,0.0%,7m
3283,2,llllllllllll,3561,1377,259,264,523,49.5%,20m
3283,2,KKKKKKKK,3561,579,108,76,184,58.7%,6m
3283,1,流云飞月,3561,1007,53,38,91,58.2%,28m
3283,1,IIIIIIIIIIII,3561,442,44,45,89,49.4%,20m
3283,2,DietmarP,3561,514,20,18,38,52.6%,44m
3283,2,大厦将倾狂澜既倒,3561,176,9,4,13,69.2%,2m
3283,1,[SK]DirtyProtoss,3561,222,5,15,20,25.0%,28m
3283,2,你赢了,3561,87,3,5,8,37.5%,9m
3291,1,天文三大错误,3560,1808,634,608,1242,51.0%,3m
3291,2,神族无毒,3560,1044,86,69,155,55.5%,42m
3291,2,[北师大二附中]Annihilation,3560,366,13,14,27,48.1%,25m
3291,2,[皓蒙之剑]有礼有貌安度因,3560,300,11,5,16,68.8%,8m
3291,2,Jons,3560,250,10,11,21,47.6%,28m
3291,2,Pimba,3560,30,1,1,2,50.0%,44m
3297,2,phmeet,3559,412,14,15,29,48.3%,4m
3297,2,克哈贱民不配赢,3559,280,10,4,14,71.4%,28m
3297,2,[要啥没啥爱咋]长安丶,3559,178,6,8,14,42.9%,40m
3297,1,[肉鸡旳饲养]IIIIIIIIIIII,3559,125,4,0,4,100.0%,39m
3297,2,[SoloAs]血花缭乱,3559,30,2,0,2,100.0%,42m
3302,2,[凯瑞甘教会]卖女孩的小火柴,3558,1605,184,173,357,51.5%,4m
3302,1,hehe,3558,1602,108,110,218,49.5%,43m
3302,2,Anduin,3558,1278,74,16,90,82.2%,13m
3302,2,[天驰风云]天驰风云,3558,476,23,8,31,74.2%,6m
3302,2,[Chitan]我的青春回来辣,3558,58,2,1,3,66.7%,42m
3302,3,李佑姆奔走,3558,0,1,0,1,100.0%,16m
3302,2,[赶紧补补水]Noah,3558,30,1,1,2,50.0%,40m
3309,2,natayu,3557,1515,146,116,262,55.7%,42m
3309,2,阿伦,3557,1499,98,69,167,58.7%,25m
3309,2,qwmunyvr,3557,1342,52,48,100,52.0%,4m
3309,2,[CHN]CHNraGingX,3557,30,1,4,5,20.0%,44m
3309,2,[BGD]asdfghjkl,3557,0,0,1,1,0.0%,25m
3314,2,[狐疑单推协会]古明地恋,3556,446,17,10,27,63.0%,8m
3314,2,[老油条战队]炒股十年,3556,322,16,18,34,47.1%,29m
3314,1,娜娜奇太可爱了,3556,403,13,19,32,40.6%,3m
3314,2,RYSKAH,3556,342,12,12,24,50.0%,3m
3314,2,贵丶族狼,3556,0,5,0,5,100.0%,28m
3314,2,Hunter,3556,118,5,2,7,71.4%,44m
3314,2,IOKIS,3556,0,1,0,1,100.0%,29m
3314,2,在你家起地堡,3556,0,0,1,1,0.0%,15m
3322,1,蛭子小比奈,3555,1768,83,111,194,42.8%,3m
3322,2,更符合,3555,788,36,17,53,67.9%,8m
3322,2,IIIIIIIIII,3555,30,2,1,3,66.7%,3m
3322,2,[FSG]CalpisAqours,3555,0,1,0,1,100.0%,25m
3322,2,[谐星联盟c]iiiii,3555,0,1,1,2,50.0%,40m
3322,2,iiiiiii,3555,0,0,1,1,0.0%,22m
3328,2,正大光明,3554,1334,70,63,133,52.6%,21m
3328,2,拉顿哈给顿,3554,1142,49,36,85,57.6%,18m
3328,2,魏宏,3554,58,2,5,7,28.6%,21m
3328,2,我闭眼开别狗我,3554,0,0,1,1,0.0%,28m
3332,2,[吹个牛B而已]星际争霸嘴上过,3553,240,9,11,20,45.0%,14m
3332,2,[哔翻天梯鸡]阿莱克修斯,3553,162,6,7,13,46.2%,20m
3332,2,[Beasty]LYLY,3553,124,5,5,10,50.0%,3m
3335,2,[肉鸡的饲养]rorisaiko,3552,0,0,5,5,0.0%,27m
3336,2,小付,3551,647,106,94,200,53.0%,6m
3336,2,友方,3551,941,49,40,89,55.1%,44m
3336,2,[杀生业报]略知一二,3551,155,26,22,48,54.2%,8m
3336,2,[PITB]珞珈山炮王,3551,518,20,19,39,51.3%,6m
3336,2,[星系之遗]啦啦啦,3551,0,1,1,2,50.0%,10m
3336,2,nmc,3551,30,1,2,3,33.3%,25m
3336,2,Mac,3551,0,0,1,1,0.0%,29m
3343,2,[C51792]DIEAWAY,3550,1588,149,128,277,53.8%,9m
3343,2,[人族最强近战]孝和,3550,30,1,1,2,50.0%,41m
3345,1,shava,3549,1468,123,126,249,49.4%,43m
3345,2,[堕落使徒]Handgun,3549,226,9,11,20,45.0%,14m
3345,2,剧情太美终究是戏,3549,176,6,12,18,33.3%,21m
3345,2,四道风,3549,146,5,7,12,41.7%,21m
3345,1,[CNboys]只会狗招,3549,144,4,2,6,66.7%,9m
3345,3,[香風智乃]卡布奇诺,3549,140,3,3,6,50.0%,9m
3351,2,[HustSC]ForSaber,3548,592,24,18,42,57.1%,13m
3351,3,一拳超人,3548,141,8,3,11,72.7%,10m
3351,2,星星迷阵,3548,0,1,0,1,100.0%,4m
3354,2,[小小合作任务]Robert,3547,925,84,50,134,62.7%,42m
3354,2,TuulaReiss,3547,90,4,5,9,44.4%,9m
3354,2,[鬼谷]星生,3547,58,2,1,3,66.7%,29m
3354,2,怎么可以吃兔兔,3547,30,2,6,8,25.0%,6m
3354,2,EEnglish,3547,0,0,1,1,0.0%,21m
3354,2,[TZS]SCBOY,3547,0,0,2,2,0.0%,9m
3360,2,瓶子,3546,1576,119,109,228,52.2%,42m
3360,2,太仓药贩子,3546,1584,92,43,135,68.1%,9m
3360,2,[最湿的战队]IMKT,3546,1596,85,87,172,49.4%,8m
3360,2,DietmarP,3546,662,25,22,47,53.2%,12m
3360,2,老唐酸菜宴,3546,0,5,0,5,100.0%,21m
3365,2,[浮夸的]msy,3545,1587,126,117,243,51.9%,6m
3365,2,[TBT]xbaby,3545,673,29,20,49,59.2%,13m
3365,2,[贰0]oops,3545,443,17,10,27,63.0%,8m
3365,2,[我没有女朋友]氵丶骚猪,3545,0,0,1,1,0.0%,12m
3369,2,天若有情天亦老,3544,1220,44,46,90,48.9%,5m
3369,2,WDLN,3544,352,14,10,24,58.3%,26m
3369,2,ASK,3544,320,12,13,25,48.0%,6m
3369,2,北十字星,3544,172,6,13,19,31.6%,5m
3369,2,仲夏夜之梦昏睡,3544,0,5,0,5,100.0%,26m
3369,2,纸灰机,3544,148,5,5,10,50.0%,16m
3369,2,[短笛魔王]尼勒克,3544,30,1,4,5,20.0%,3m
3369,2,Alex,3544,0,0,1,1,0.0%,44m
3369,2,Mooooop,3544,0,0,1,1,0.0%,3m
3369,2,[我是爸爸]BABA,3544,0,0,4,4,0.0%,42m
3369,2,fanr,3544,0,0,5,5,0.0%,28m
3380,2,DesMoines,3543,296,11,9,20,55.0%,42m
3380,2,MagejiTerren,3543,262,10,8,18,55.6%,6m
3380,1,weltmeister,3543,0,3,3,6,50.0%,41m
3380,2,mike,3543,30,2,1,3,66.7%,3m
3380,2,ssGuo,3543,30,1,4,5,20.0%,18m
3380,2,[突变攻略组]苍蓝野兽,3543,0,0,1,1,0.0%,14m
3386,2,[暴雪我是你爹]白痴,3542,370,14,12,26,53.8%,14m
3386,3,Yuki,3542,252,12,4,16,75.0%,9m
3386,2,[93589]bow,3542,286,11,4,15,73.3%,8m
3386,3,噶啊,3542,192,10,5,15,66.7%,30m
3386,2,[wtf啊]西陵葬月,3542,0,2,3,5,40.0%,17m
3386,2,[Solo]LosTATlantis,3542,0,1,0,1,100.0%,14m
3386,2,[EL骑士二团]Kirito,3542,0,1,0,1,100.0%,9m
3386,2,[寻风]乐正绫,3542,0,0,3,3,0.0%,20m
3386,2,ZaknaFein,3542,0,0,4,4,0.0%,25m
3395,2,IIIIIIIIIIII,3541,1633,140,136,276,50.7%,20m
3395,2,[KPG]曾經最美最美曾經,3541,654,23,28,51,45.1%,15m
3395,2,[周末娱乐]llllllllllll,3541,31,5,6,11,45.5%,22m
3395,2,你打星际像蔡徐坤,3541,0,1,0,1,100.0%,22m
3395,3,Remember,3541,0,1,0,1,100.0%,30m
3395,2,派拉蒙,3541,30,1,2,3,33.3%,4m
3395,1,[王者归来]小智,3541,0,0,1,1,0.0%,22m
3402,2,朱雀星君,3540,1612,90,78,168,53.6%,40m
3402,2,隐居豆腐店,3540,769,43,47,90,47.8%,29m
3402,2,SCPLAYER,3540,362,14,11,25,56.0%,18m
3402,2,夏空的英仙座,3540,170,6,6,12,50.0%,12m
3406,2,矿物储量不足,3539,1605,398,385,783,50.8%,28m
3406,2,[Anonym]Level,3539,1512,145,146,291,49.8%,2m
3406,2,[ZAS]Thymus,3539,1527,124,109,233,53.2%,29m
3406,2,IIIIIIIIII,3539,546,49,42,91,53.8%,28m
3406,2,电脑难度丨专家丨,3539,142,6,4,10,60.0%,25m
3406,2,[SFTRA3]滑稽炮,3539,0,1,0,1,100.0%,7m
3412,2,[今天超市打折]梦千秋,3538,170,7,7,14,50.0%,22m
3412,2,死亡收割者,3538,138,4,18,22,18.2%,28m
3412,2,越狱,3538,100,3,9,12,25.0%,10m
3412,2,[银荡可方万物]爱是一道绿光,3538,0,0,1,1,0.0%,44m
3412,2,[M8]ISISISIS,3538,0,0,1,1,0.0%,8m
3417,2,hyfxiaohao,3537,594,22,20,42,52.4%,18m
3417,2,[1233]天地汇,3537,124,4,13,17,23.5%,5m
3417,2,[RtN]DNA,3537,30,1,3,4,25.0%,14m
3417,2,自由之翼,3537,0,0,1,1,0.0%,5m
3421,2,[黄金海舰队]Aking,3536,1623,126,111,237,53.2%,29m
3421,2,TYfans,3536,964,41,29,70,58.6%,11m
3421,2,[Vgirls]暗夜中的杀手,3536,793,33,24,57,57.9%,22m
3421,3,[小仙女上线啦]青叶,3536,234,12,3,15,80.0%,10m
3421,2,irgsgjs,3536,175,12,10,22,54.5%,12m
3421,2,中断之吻,3536,236,9,10,19,47.4%,22m
3421,2,[青葱与纯色]号封一个月,3536,260,8,7,15,53.3%,25m
3421,2,[miku守护]蓝宗,3536,148,6,10,16,37.5%,15m
3421,2,ZeR,3536,160,5,14,19,26.3%,14m
3430,2,[丨SLT丨]FpxBest,3535,366,16,5,21,76.2%,28m
3430,2,[Ogier]贤狼赫萝,3535,178,5,3,8,62.5%,27m
3430,2,[银翼猎手]Viking,3535,0,1,0,1,100.0%,4m
3430,2,[镭ROCK]RookieROLL,3535,0,0,1,1,0.0%,6m
3430,2,[丹东男神天团]丹东大老肥,3535,0,0,1,1,0.0%,25m
3435,2,麦克斯韦方程组,3534,1445,70,55,125,56.0%,15m
3435,2,mumu,3534,773,35,33,68,51.5%,40m
3435,2,今天也很想佩佩,3534,582,24,19,43,55.8%,42m
3435,2,贼人,3534,540,19,16,35,54.3%,11m
3435,2,[突变攻略组]GENG,3534,0,1,0,1,100.0%,41m
3435,2,[VIira]Sin,3534,0,1,0,1,100.0%,22m
3435,2,saber,3534,0,1,0,1,100.0%,25m
3435,2,[余塘]鲨锅余头,3534,0,0,1,1,0.0%,7m
3443,2,[咖啡Fans]有花堪折直须折,3533,971,58,19,77,75.3%,21m
3443,1,[辉煌华夏]MrKing,3533,0,1,0,1,100.0%,29m
3443,2,[SteEng]八木,3533,0,0,1,1,0.0%,21m
3446,2,llllllllllll,3532,686,31,21,52,59.6%,16m
3446,2,[送分大队]ALARICUS,3532,114,5,2,7,71.4%,28m
3446,3,[ESKT]RokEr,3532,0,0,1,1,0.0%,20m
3446,2,never,3532,0,0,2,2,0.0%,44m
3450,2,hzqj,3531,1499,98,92,190,51.6%,44m
3450,2,MiKe,3531,149,4,4,8,50.0%,25m
3450,2,[NS]谁在呼叫舰队,3531,0,1,0,1,100.0%,23m
3450,2,打星际我只玩神族,3531,0,1,0,1,100.0%,25m
3450,2,[小鸡屠宰场9]星河舰队,3531,0,0,2,2,0.0%,12m
3455,2,[ljk]皱巴巴,3530,60,2,4,6,33.3%,7m
3455,2,[骚狗谐]yylch,3530,0,0,1,1,0.0%,26m
3455,2,御华万里,3530,0,0,1,1,0.0%,42m
3458,2,WindMoon,3529,787,52,41,93,55.9%,9m
3458,2,INnoVation,3529,533,21,25,46,45.7%,15m
3458,2,[这不起飞]skty,3529,370,14,12,26,53.8%,42m
3458,2,[Miku骑士]都市天际线玩家,3529,104,3,4,7,42.9%,9m
3458,2,[Beasty]一切都是为了兄弟,3529,0,0,2,2,0.0%,40m
3463,2,史莱克,3528,1560,494,476,970,50.9%,2m
3463,1,觉醒,3528,1368,43,58,101,42.6%,20m
3463,2,深深大鱼海棠,3528,841,32,27,59,54.2%,14m
3463,2,[SharpB]幽输拉,3528,340,14,16,30,46.7%,14m
3463,2,[Trusty]Fleurs,3528,367,13,21,34,38.2%,2m
3463,1,yyt,3528,209,8,4,12,66.7%,41m
3463,2,NCForzener,3528,150,5,0,5,100.0%,8m
3470,2,FirstGhost,3527,1208,232,215,447,51.9%,27m
3470,2,[DMR]FuRy,3527,447,95,84,179,53.1%,40m
3470,2,[肌肉]知止,3527,912,35,41,76,46.1%,4m
3470,2,[火焰雷兽]reader,3527,211,15,0,15,100.0%,20m
3470,2,[一等星]minamotoF,3527,176,6,9,15,40.0%,42m
3470,2,智障也有春天,3527,0,1,0,1,100.0%,5m
3470,2,BABA,3527,30,1,11,12,8.3%,2m
3470,2,雷诺,3527,0,0,1,1,0.0%,25m
3478,2,[olg]武林虾米,3526,798,30,31,61,49.2%,22m
3478,2,一拳超人,3526,338,16,8,24,66.7%,41m
3478,1,[中中网咖]只会爆大和,3526,566,14,39,53,26.4%,17m
3478,3,贤狼,3526,166,5,0,5,100.0%,25m
3478,2,[三浦透子]今天又是什么奶茶,3526,92,4,3,7,57.1%,15m
3478,3,哇哈哈哈哈哈,3526,86,3,8,11,27.3%,15m
3478,2,星野新一,3526,30,2,0,2,100.0%,42m
3478,2,SIMPSON,3526,30,1,6,7,14.3%,28m
3486,2,sunshine,3525,250,32,36,68,47.1%,22m
3486,2,Conceal,3525,262,10,14,24,41.7%,2m
3486,2,[Solo]众人皆醒我独醉,3525,0,5,0,5,100.0%,27m
3486,2,虫虫泡,3525,30,2,5,7,28.6%,28m
3486,2,[HZAU]milka,3525,30,1,7,8,12.5%,21m
3486,2,[请先打我隊友]Seven,3525,0,0,1,1,0.0%,9m
3492,3,[i5]别打我的脸,3524,171,5,4,9,55.6%,22m
3492,2,[半藏森林]青菜萝卜饺,3524,30,1,1,2,50.0%,8m
3492,2,YuAlger,3524,0,1,1,2,50.0%,25m
3492,2,[不是锉刀怪]魔法少女萨拉托加,3524,0,0,1,1,0.0%,25m
3492,2,荆棘刺血,3524,0,0,2,2,0.0%,10m
3497,1,[LEor]INnoVation,3523,1654,66,83,149,44.3%,22m
3497,3,[拯救科学家]周佳琦,3523,92,1,1,2,50.0%,9m
3497,2,[BWarmy]JOHSON,3523,0,0,1,1,0.0%,2m
3500,2,[KPG2]IMITATION,3522,1544,93,82,175,53.1%,25m
3500,2,[由我们重回]长治久安,3522,425,20,10,30,66.7%,21m
3500,2,llllllllllll,3522,352,17,11,28,60.7%,7m
3500,2,来自武汉的爸爸,3522,0,5,0,5,100.0%,20m
3500,1,[TNL]Sihao,3522,168,5,21,26,19.2%,14m
3500,3,[WILLE]Stevie,3522,0,0,1,1,0.0%,29m
3500,2,[HEX]hexagram,3522,0,0,1,1,0.0%,9m
3500,2,[肉鸡的饲养]思薇,3522,0,0,1,1,0.0%,3m
3508,2,[我亲爱的对手]恶魔天使,3521,1538,103,106,209,49.3%,29m
3508,2,[仁心会]IIIIIIIIIIII,3521,599,21,27,48,43.8%,6m
3508,2,[天雪]世界上谐星最强大,3521,390,17,7,24,70.8%,20m
3508,2,莫林山,3521,259,15,28,43,34.9%,23m
3508,3,朝如青丝暮成雪,3521,237,11,4,15,73.3%,16m
3508,2,[DMRc]默默,3521,291,11,5,16,68.8%,15m
3508,2,nixer,3521,156,9,15,24,37.5%,14m
3508,2,[KPGSC2]TarGax,3521,172,7,3,10,70.0%,9m
3508,2,[SNNU]StrongPP,3521,46,6,1,7,85.7%,45m
3508,2,OOOOOOOOOOOO,3521,90,4,3,7,57.1%,20m
3518,2,Least,3520,1561,112,114,226,49.6%,3m
3518,2,llllllllllll,3520,812,32,26,58,55.2%,44m
3518,2,[RPGBoY]小新,3520,281,23,14,37,62.2%,18m
3518,2,霜落夜,3520,288,11,5,16,68.8%,13m
3518,2,[CNboys]INnoVation,3520,115,7,6,13,53.8%,15m
3518,2,[叹往事成风]GoodTime,3520,184,7,7,14,50.0%,14m
3518,2,[DMRz]空城旧忆故人离,3520,0,5,0,5,100.0%,12m
3518,2,[六骑]MMA,3520,0,1,1,2,50.0%,21m
3518,2,[乾坤八卦]影殇,3520,30,1,1,2,50.0%,26m
3518,2,古明地图炮,3520,0,0,1,1,0.0%,14m
3528,1,[Mou]Thalnos,3519,969,164,170,334,49.1%,16m
3528,2,nicy,3519,1525,150,153,303,49.5%,25m
3528,3,[星选组]cnbb,3519,583,117,146,263,44.5%,4m
3528,2,丢下书籍便睡去,3519,0,0,1,1,0.0%,42m
3532,2,鸡汁的我,3518,1326,64,56,120,53.3%,21m
3532,2,银川李律师,3518,249,35,28,63,55.6%,9m
3532,2,MIKEzhang,3518,830,33,30,63,52.4%,44m
3532,2,Light,3518,534,31,25,56,55.4%,41m
3532,2,天澜彡,3518,315,13,8,21,61.9%,6m
3532,3,Trigger,3518,0,1,0,1,100.0%,5m
3532,3,IIIIIIIIIIII,3518,97,1,2,3,33.3%,30m
3539,2,[NUAA]牛川枫,3517,992,63,49,112,56.2%,8m
3539,2,荆门李信衡,3517,416,16,12,28,57.1%,43m
3539,2,IIIIIIIIIIII,3517,129,12,11,23,52.2%,28m
3539,2,XiaoBaiChi,3517,298,11,10,21,52.4%,44m
3539,2,TCDD,3517,252,9,13,22,40.9%,29m
3539,2,Tothnego,3517,0,0,1,1,0.0%,44m
3545,2,[扫黄]妈个鸡泰伦,3516,1043,107,103,210,51.0%,21m
3545,2,LONGRENWANG,3516,224,12,8,20,60.0%,7m
3545,2,PigPeek,3516,160,5,1,6,83.3%,18m
3545,2,[少年星际梦]暴雪娱乐,3516,0,0,1,1,0.0%,9m
3549,2,Sasha,3515,176,25,22,47,53.2%,5m
3549,3,kiprop,3515,216,10,5,15,66.7%,14m
3549,2,[deb]上帝之城,3515,0,5,0,5,100.0%,25m
3549,2,[星之所在RI]迷茫星空,3515,0,0,2,2,0.0%,5m
3553,2,Snow,3514,1398,52,53,105,49.5%,9m
3553,2,cAtty,3514,0,5,0,5,100.0%,28m
3553,2,HISER,3514,0,5,0,5,100.0%,23m
3553,2,Frozen,3514,137,4,1,5,80.0%,21m
3553,2,IIIIIIIIIIII,3514,60,3,1,4,75.0%,44m
3553,2,[芙萝娅]施公子,3514,66,2,8,10,20.0%,44m
3559,2,[丹东男神天团]scv,3513,1027,46,30,76,60.5%,15m
3559,2,[WHU]罗辑,3513,455,18,28,46,39.1%,21m
3559,2,[DSE]lIlIllllIIII,3513,208,8,13,21,38.1%,9m
3559,1,llllllll,3513,160,5,5,10,50.0%,7m
3559,2,[扫黄]AcE,3513,74,4,5,9,44.4%,18m
3559,2,[DMR]你算哪块小饼干丶,3513,0,1,1,2,50.0%,25m
3559,2,[SKF]ForeVerMsy,3513,0,0,1,1,0.0%,22m
3559,1,[汉堡FANS]新秀神族雨廷桑,3513,0,0,3,3,0.0%,6m
3567,2,长沙黄旭东,3512,1552,82,71,153,53.6%,8m
3567,2,金华孙一峰,3512,440,45,43,88,51.1%,41m
3567,2,[谁是谐星]Bloodthirsty,3512,824,34,26,60,56.7%,12m
3567,2,[SK]BurNIng,3512,254,10,5,15,66.7%,15m
3567,2,[蒙蔽梦游团]Sanya,3512,50,2,2,4,50.0%,28m
3567,2,SilverMask,3512,0,0,1,1,0.0%,14m
3573,2,我最倒霉行了吧,3511,241,23,15,38,60.5%,26m
3573,2,[七咕咕]伪物的妖妖,3511,572,20,27,47,42.6%,13m
3573,3,大佬单刷我吃瓜,3511,306,14,7,21,66.7%,12m
3573,2,[IGS]叉烧味的包子,3511,252,9,12,21,42.9%,21m
3573,2,IIIIIIIIIIII,3511,204,8,10,18,44.4%,41m
3573,2,HEVER,3511,0,5,0,5,100.0%,18m
3573,3,耗子尾汁,3511,30,2,0,2,100.0%,8m
3573,2,KelThuzad,3511,0,1,0,1,100.0%,8m
3573,2,[牌面]傲魄,3511,30,1,2,3,33.3%,28m
3573,2,[保险银行投资]韩晨,3511,0,0,1,1,0.0%,7m
3573,2,LinkDran,3511,0,0,5,5,0.0%,9m
3584,2,[五月花]IIIIIIIIIII,3510,1057,74,52,126,58.7%,25m
3584,2,obo,3510,514,16,29,45,35.6%,27m
3584,3,[希靈使徒]改变那命运,3510,96,2,0,2,100.0%,6m
3584,2,队友不稳,3510,58,2,1,3,66.7%,42m
3584,2,玫瑰,3510,30,2,3,5,40.0%,27m
3589,2,莫大峰,3509,266,9,7,16,56.2%,15m
3590,1,[泰伦就是鸡]efifjai,3508,1722,322,302,624,51.6%,13m
3590,2,Imagine,3508,1572,190,169,359,52.9%,2m
3590,2,[文韬武略]嗜血丨虫族,3508,339,52,45,97,53.6%,12m
3590,2,[温柔兔公主]JJJJJJJ,3508,718,30,36,66,45.5%,3m
3590,2,[烽夜长歌]IIIIIIIIIIII,3508,232,7,19,26,26.9%,23m
3590,2,AprilYun,3508,90,4,4,8,50.0%,25m
3590,2,[KOTRT]鸡饲料保护协会,3508,30,1,3,4,25.0%,9m
3590,2,Elec,3508,0,0,1,1,0.0%,25m
3598,2,[全员恶人超凶]crywolf,3507,675,31,33,64,48.4%,26m
3598,2,[SCUT]marvelous,3507,560,18,31,49,36.7%,28m
3598,2,[Rhusky]嘤嘤嘤,3507,0,5,0,5,100.0%,41m
3598,2,淑惠的小狗砸,3507,88,3,2,5,60.0%,8m
3598,1,[星际教学组]sweet,3507,48,2,0,2,100.0%,16m
3598,2,只是长得帅了点,3507,0,0,1,1,0.0%,2m
3604,2,[谁都打不赢]打的真不错,3506,1323,120,119,239,50.2%,2m
3604,2,小艾蒙你不讲武德,3506,510,27,12,39,69.2%,12m
3604,2,[CNboi]KNIGHT,3506,382,15,14,29,51.7%,30m
3607,1,[我们是无敌的]PREDATOR,3505,1757,364,364,728,50.0%,18m
3607,2,[天降同萌会]CSY,3505,552,34,33,67,50.7%,40m
3607,2,Kanata,3505,0,5,0,5,100.0%,43m
3607,2,[Flowex]Eternity,3505,0,0,1,1,0.0%,8m
3611,3,福尔摩喵,3504,230,10,4,14,71.4%,43m
3611,2,[基金会]Classic,3504,192,8,2,10,80.0%,12m
3611,2,摔跤不带滚,3504,253,8,7,15,53.3%,12m
3611,2,被砍掉的流海,3504,164,4,3,7,57.1%,20m
3611,2,MisakaMikoto,3504,30,2,5,7,28.6%,3m
3611,2,FancyJeffrey,3504,0,0,1,1,0.0%,21m
3611,2,[莽成一匹野马]DOOM,3504,0,0,1,1,0.0%,12m
3611,3,Musan,3504,0,0,1,1,0.0%,27m
3611,2,[SCAP]御坂美琴,3504,0,0,2,2,0.0%,25m
3620,2,青炎变,3503,444,46,35,81,56.8%,41m
3620,2,[KIIO]不知天上宫阙,3503,116,4,4,8,50.0%,25m
3620,2,[能白给就白给]奇遇,3503,112,2,1,3,66.7%,44m
3620,2,DLDL,3503,0,1,0,1,100.0%,21m
3620,2,用户封禁,3503,0,0,1,1,0.0%,18m
3625,2,weqe,3502,398,18,9,27,66.7%,28m
3625,3,哈哈哈瞎李哈哈哈,3502,322,14,6,20,70.0%,10m
3625,2,[Flowex]DarkMaster,3502,118,6,1,7,85.7%,12m
3625,2,那鸡很美,3502,170,6,6,12,50.0%,42m
3625,2,[FPT]玩的累啊,3502,62,3,9,12,25.0%,12m
3625,2,[SRD]一声不吭是冷酷,3502,0,1,0,1,100.0%,9m
3625,2,[蠢萌呆]呆萌无自信,3502,0,1,0,1,100.0%,15m
3625,3,[印度虫王]车队队长藤原拓海,3502,0,1,3,4,25.0%,39m
3625,2,手残的一笔,3502,0,0,1,1,0.0%,20m
3625,2,rlhmy,3502,0,0,1,1,0.0%,29m
3625,2,[GUF]时过境迁,3502,0,0,1,1,0.0%,5m
3625,2,[哔哩哔哩乾杯]艾尔必将光复,3502,0,0,1,1,0.0%,29m
3637,2,davis,3501,1200,59,37,96,61.5%,13m
3637,2,[我老公刘昊然]Fonia,3501,1079,50,57,107,46.7%,5m
3637,2,ztzdzwd,3501,167,7,0,7,100.0%,42m
3637,2,叶叶,3501,120,5,3,8,62.5%,8m
3637,2,[Wang]Garland,3501,0,4,0,4,100.0%,43m
3637,2,mob,3501,0,0,1,1,0.0%,20m
3637,2,[二哈叼爱萌]真不错,3501,0,0,1,1,0.0%,27m
3644,2,page,3500,1544,260,219,479,54.3%,8m
3644,2,手揣奶瓶逛青楼,3500,518,26,28,54,48.1%,27m
3644,1,IIIIIIIIII,3500,252,9,5,14,64.3%,23m
3644,2,[RvA]虎爷,3500,118,6,1,7,85.7%,14m
3644,2,JSent,3500,140,4,3,7,57.1%,13m
3644,2,[谢绝反击]TOTHEMOON,3500,30,2,6,8,25.0%,25m
3650,2,[神丿域]AflameAvenu,3499,707,37,41,78,47.4%,15m
3650,2,[MC5]ShadowFiend,3499,142,4,6,10,40.0%,15m
3650,2,[中南大学官网]天灰灰会不会,3499,112,2,1,3,66.7%,30m
3650,2,ZAAA,3499,0,1,0,1,100.0%,20m
3650,2,Hukuro,3499,0,1,0,1,100.0%,41m
3650,2,[Skt]定春与小流氓,3499,0,1,1,2,50.0%,15m
3650,2,[北极光小组]这辈子赢不了神族,3499,0,1,2,3,33.3%,9m
3650,2,[魔夜]NONO,3499,0,0,1,1,0.0%,5m
3658,2,打不来游戏了,3498,1487,98,86,184,53.3%,3m
3658,2,电脑,3498,1017,51,25,76,67.1%,21m
3658,2,时流,3498,999,42,50,92,45.7%,42m
3658,2,[暴雪二十八队]最初,3498,304,12,10,22,54.5%,25m
3658,2,[Happy]零點噬,3498,0,0,1,1,0.0%,42m
3658,2,解解,3498,0,0,2,2,0.0%,27m
3664,1,[激情男女]TBiboy,3497,1767,651,637,1288,50.5%,20m
3664,2,[文韬武略]嗦孙哥牛子,3497,1528,158,142,300,52.7%,8m
3664,2,JamesK,3497,945,44,27,71,62.0%,8m
3664,2,jealous,3497,974,35,39,74,47.3%,43m
3664,2,[莱茵实验组]Meteor,3497,180,7,8,15,46.7%,25m
3664,2,MKKKKKKK,3497,140,5,0,5,100.0%,44m
3664,2,[白给不要钱]乌鸦落在猪身上,3497,58,2,3,5,40.0%,23m
3664,2,SeaInTheSky,3497,52,2,4,6,33.3%,14m
3664,2,[AH64A]moon,3497,0,1,0,1,100.0%,10m
3664,2,Miracle,3497,0,1,1,2,50.0%,27m
3664,2,久遠寺有珠,3497,30,1,5,6,16.7%,9m
3664,2,Apex,3497,0,0,1,1,0.0%,25m
3676,2,ANDY,3496,378,57,55,112,50.9%,2m
3676,2,[就是现在]火化他们,3496,620,50,45,95,52.6%,28m
3676,2,MisDJ,3496,663,29,22,51,56.9%,8m
3676,2,友善的帅哥,3496,118,7,0,7,100.0%,45m
3676,2,YNYN,3496,30,1,1,2,50.0%,8m
3676,2,[SC3]探花,3496,0,0,1,1,0.0%,6m
3676,2,Amadeus,3496,0,0,3,3,0.0%,28m
3683,2,xiaochao,3495,1155,108,87,195,55.4%,8m
3683,1,[SoloAs]无名王者,3495,1355,55,72,127,43.3%,18m
3683,2,[扫黄]公狗安娜全家爆炸,3495,668,25,28,53,47.2%,23m
3683,2,ByuN,3495,30,1,3,4,25.0%,43m
3687,2,[天地會总舵]铁路局大鹏哥,3494,167,6,5,11,54.5%,15m
3687,2,[硬骨头会所]安稳度余生,3494,114,4,4,8,50.0%,28m
3687,2,Biltz,3494,30,2,0,2,100.0%,9m
3687,2,青檬,3494,0,1,0,1,100.0%,21m
3687,2,[B站星际小德]IIIIIIIIIII,3494,30,1,3,4,25.0%,21m
3692,2,黑雪姬,3493,1495,188,182,370,50.8%,14m
3692,2,[Flowex]安得切尔,3493,1416,67,65,132,50.8%,8m
3692,2,[七咕咕]帝国火枪手,3493,896,36,43,79,45.6%,7m
3692,2,[lSCVl]zxxy,3493,633,26,18,44,59.1%,25m
3692,3,高阶圣堂杨永信,3493,233,10,3,13,76.9%,44m
3692,2,[TLKH]毁灭,3493,30,2,6,8,25.0%,28m
3692,2,natrul,3493,0,1,0,1,100.0%,12m
3692,2,PaGe,3493,0,0,1,1,0.0%,9m
3692,2,[幽冥之狼]峰哥,3493,0,0,1,1,0.0%,3m
3692,2,一心向善塔塔子,3493,0,0,1,1,0.0%,42m
3702,2,IIIIIIIII,3492,1081,134,127,261,51.3%,25m
3702,3,LYsecond,3492,177,5,5,10,50.0%,10m
3702,2,白月光,3492,60,3,2,5,60.0%,3m
3702,2,lolo,3492,46,3,5,8,37.5%,12m
3702,2,[BTD]初凡,3492,58,2,5,7,28.6%,23m
3707,3,带头大哥阿拉纳克,3491,256,11,4,15,73.3%,18m
3707,2,mumu,3491,58,2,2,4,50.0%,22m
3707,2,[混元星际门]Edward,3491,0,0,1,1,0.0%,20m
3707,2,[不知道叫什么]我是咸鱼,3491,0,0,1,1,0.0%,22m
3711,2,研默,3490,535,23,14,37,62.2%,21m
3711,2,imagination,3490,332,11,27,38,28.9%,12m
3711,3,Rainstar,3490,205,10,7,17,58.8%,4m
3711,2,OptimusPrime,3490,290,10,15,25,40.0%,7m
3711,2,IronMan,3490,0,0,1,1,0.0%,25m
3716,2,[TS嘉年华]万色星辰,3489,1458,93,89,182,51.1%,41m
3716,2,[华东师大]VioletGarden,3489,298,10,18,28,35.7%,5m
3716,3,Leon,3489,229,7,8,15,46.7%,24m
3716,2,[暴雪二十九队]NERV,3489,114,4,6,10,40.0%,14m
3716,2,[五十块的兄弟]MARU,3489,112,3,0,3,100.0%,12m
3716,2,ClaireBaby,3489,0,0,1,1,0.0%,21m
3716,2,[星辰之海]SoChel,3489,0,0,1,1,0.0%,22m
3716,3,[斯巴达血战团]吞世者战团安格隆,3489,0,0,1,1,0.0%,11m
3724,2,[Sv]ccbb,3488,800,41,29,70,58.6%,7m
3724,2,[IMRTS]星一,3488,281,10,8,18,55.6%,44m
3724,2,[刺蛇单推协会]墨笙,3488,158,5,11,16,31.2%,44m
3724,2,[黑人抬棺团队]CIhuhu,3488,58,3,4,7,42.9%,29m
3724,2,年迈的老战士,3488,88,1,1,2,50.0%,26m
3724,2,[达拉姆万岁]蔡头,3488,0,0,1,1,0.0%,7m
3724,2,Argo,3488,0,0,1,1,0.0%,28m
3724,2,大地,3488,0,0,2,2,0.0%,8m
3732,2,[KPG2]Mauvais,3487,1564,311,287,598,52.0%,41m
3732,2,OranGe,3487,977,83,82,165,50.3%,18m
3732,2,CrazyStar,3487,1122,77,54,131,58.8%,44m
3732,2,迫切欧文,3487,1477,63,67,130,48.5%,18m
3732,2,llllllllllll,3487,1017,62,54,116,53.4%,6m
3732,2,KIRITOR,3487,1049,52,42,94,55.3%,9m
3732,2,年轻人耗子尾汁,3487,996,43,33,76,56.6%,8m
3732,2,[Shawk]惜梦,3487,861,42,37,79,53.2%,9m
3732,2,条码人,3487,899,35,32,67,52.2%,20m
3732,2,刑法二百三十七条,3487,704,24,30,54,44.4%,22m
3732,2,llllllllllll,3487,30,1,3,4,25.0%,43m
3743,2,XLS,3486,421,25,27,52,48.1%,42m
3743,2,李永菜,3486,432,15,14,29,51.7%,30m
3743,2,king,3486,122,5,2,7,71.4%,10m
3743,2,封印之首,3486,0,0,5,5,0.0%,29m
3747,2,[菜有菜的道理]IIIIIIII,3485,182,6,4,10,60.0%,22m
3747,2,湮灭的破碎之剑,3485,0,5,0,5,100.0%,18m
3747,2,[秋毫第七分队]BoPeeP,3485,54,4,6,10,40.0%,20m
3747,2,[魔法少女小屋]SnowTown,3485,30,1,2,3,33.3%,44m
3747,2,Deep,3485,0,0,1,1,0.0%,27m
3747,2,[Aqou]高海千歌,3485,0,0,1,1,0.0%,41m
3753,2,aasd,3484,1139,194,184,378,51.3%,2m
3753,2,YukoOgur,3484,311,73,63,136,53.7%,28m
3753,2,[桃园结义]橘子辉煌,3484,789,52,52,104,50.0%,26m
3753,2,[我们是无敌的]人皇武圣星际魔君,3484,443,44,31,75,58.7%,25m
3753,2,魔法少女阿巴瑟,3484,332,12,17,29,41.4%,22m
3753,2,[花姐Fan]magiczerg,3484,30,2,4,6,33.3%,6m
3753,2,[sure]镇魂曲,3484,0,0,1,1,0.0%,25m
3753,2,dkga,3484,0,0,1,1,0.0%,22m
3753,2,小黑,3484,0,0,2,2,0.0%,22m
3762,2,IIIIIIIIIIII,3483,1470,134,110,244,54.9%,14m
3762,2,大花猫,3483,1526,71,82,153,46.4%,44m
3762,2,[西野七瀬]DoiyaSan,3483,340,19,21,40,47.5%,30m
3762,2,[莽夫智障团]Tha,3483,334,12,9,21,57.1%,25m
3762,2,[衣钵之卫]吟绿颂青,3483,130,4,2,6,66.7%,15m
3762,2,hnghsd,3483,88,2,0,2,100.0%,6m
3762,2,南瓜灯,3483,0,0,1,1,0.0%,41m
3769,2,[TNL]Valkyria,3482,640,32,35,67,47.8%,10m
3769,3,LastOrder,3482,234,11,5,16,68.8%,27m
3769,2,[秋毫]Kratos,3482,106,6,3,9,66.7%,14m
3769,2,[miku守护]LuckYin,3482,90,3,4,7,42.9%,23m
3769,2,鲁迅中学保送牛,3482,86,3,8,11,27.3%,22m
3769,2,[青铜树]Romance,3482,0,0,1,1,0.0%,44m
3769,2,[miku守护]Zknight,3482,0,0,1,1,0.0%,29m
3776,2,[IGS]killer,3481,1648,756,749,1505,50.2%,27m
3776,2,SupplyBlock,3481,409,120,110,230,52.2%,12m
3776,2,Spray,3481,376,29,26,55,52.7%,21m
3776,2,落花流水春去也,3481,475,23,12,35,65.7%,21m
3776,2,[BOOMER]TYTY,3481,418,16,13,29,55.2%,12m
3776,3,SOS,3481,185,5,2,7,71.4%,26m
3776,2,kira,3481,88,1,1,2,50.0%,2m
3776,2,浩楠楠楠,3481,0,0,1,1,0.0%,22m
3784,2,[NUAA]吃素还真养生,3480,90,3,6,9,33.3%,5m
3784,2,三个贷表重要思想,3480,30,1,8,9,11.1%,27m
3784,2,Nanking,3480,0,0,1,1,0.0%,18m
3787,1,[大漢]微笑的炮,3479,1709,175,171,346,50.6%,17m
3787,2,井中月,3479,356,13,16,29,44.8%,12m
3787,2,DARKSEA,3479,58,3,3,6,50.0%,15m
3787,2,INnoVation,3479,30,2,1,3,66.7%,12m
3787,2,[黑粉头子]星火,3479,0,0,1,1,0.0%,3m
3792,2,麻辣刺猬,3478,143,26,28,54,48.1%,9m
3792,2,[Vgirls]命运天使,3478,219,10,2,12,83.3%,15m
3792,1,efly,3478,144,8,3,11,72.7%,12m
3792,2,Moon,3478,143,5,1,6,83.3%,44m
3792,2,Denyheart,3478,0,1,0,1,100.0%,41m
3792,2,[重庆1中]STURMOVIK,3478,0,0,1,1,0.0%,28m
3792,2,[洛水伊人]中华崛起之奋斗,3478,0,0,1,1,0.0%,25m
3799,2,[2233娘]掐柠檬的帕露西,3477,993,75,75,150,50.0%,27m
3799,2,[Raider]VenOMMMMMMM,3477,270,18,1,19,94.7%,41m
3799,2,我只吃熊猫,3477,470,17,23,40,42.5%,22m
3799,2,克制不说泰伦英霸,3477,102,3,1,4,75.0%,43m
3799,2,llllllllllll,3477,102,2,1,3,66.7%,22m
3799,2,ARXS,3477,0,2,3,5,40.0%,41m
3805,2,[WIE]Alphago,3476,1175,53,36,89,59.6%,44m
3805,2,咕噜噜,3476,1068,39,40,79,49.4%,14m
3805,2,[ScAPs]逍遥一时,3476,419,18,10,28,64.3%,12m
3805,3,[四叶草]明理知秋,3476,238,10,7,17,58.8%,19m
3805,2,[SKT俱乐部]要用魔法打败魔法,3476,148,5,7,12,41.7%,5m
3805,2,Boys,3476,60,3,2,5,60.0%,7m
3805,2,[夏恋]wsrb,3476,30,2,1,3,66.7%,2m
3805,2,llllllllllll,3476,30,1,3,4,25.0%,9m
3805,2,[星歌]DASHGO,3476,0,0,1,1,0.0%,26m
3805,2,IlIlIlIlIl,3476,0,0,4,4,0.0%,44m
3815,3,[菜鸡悲]AYASEELI,3475,307,13,7,20,65.0%,29m
3815,2,llllllllllll,3475,203,8,2,10,80.0%,12m
3815,2,Root,3475,142,4,2,6,66.7%,42m
3815,2,星星是国宝,3475,0,1,0,1,100.0%,2m
3815,2,[您好]StevenLI,3475,0,0,1,1,0.0%,12m
3820,2,[向程序员致敬]lumos,3474,1464,230,215,445,51.7%,8m
3820,2,小火龙,3474,302,12,13,25,48.0%,41m
3820,1,Matu,3474,144,3,2,5,60.0%,16m
3820,2,[i5]杨煜鸥,3474,95,3,3,6,50.0%,19m
3820,2,Zen,3474,62,3,6,9,33.3%,26m
3820,2,tarfet,3474,0,1,0,1,100.0%,7m
3820,2,[OTO]人间大炮,3474,0,0,3,3,0.0%,9m
3827,2,Mojito,3473,873,83,75,158,52.5%,25m
3827,2,[暴雪我是你爹]ktx,3473,670,37,41,78,47.4%,20m
3827,2,[榨菜与泡面]HoPeLess,3473,1049,37,42,79,46.8%,16m
3827,2,[半个菜鸟]Pine,3473,694,36,20,56,64.3%,22m
3827,3,火焰之灵,3473,171,9,5,14,64.3%,28m
3827,2,IIIIIIIIII,3473,0,1,0,1,100.0%,5m
3833,2,[Dicboy]zja,3472,1577,215,214,429,50.1%,42m
3833,2,yumiko,3472,1114,56,49,105,53.3%,16m
3833,2,[NUAA]坦克手贝塔,3472,140,4,2,6,66.7%,41m
3833,2,[YM]IGMarauder,3472,88,2,0,2,100.0%,44m
3833,2,[奶死对面]SuperMage,3472,0,1,0,1,100.0%,7m
3833,2,MVP,3472,0,1,1,2,50.0%,15m
3833,2,[Icer]GuAngMo,3472,0,0,1,1,0.0%,8m
3833,2,花落影榭,3472,0,0,1,1,0.0%,12m
3841,2,[不知不觉天亮]GYT,3471,1338,73,79,152,48.0%,23m
3841,2,[原谅兄弟会]不讲武德耗子尾汁,3471,750,37,20,57,64.9%,30m
3841,2,magician,3471,494,17,24,41,41.5%,26m
3841,2,坑逼就是我,3471,90,3,4,7,42.9%,2m
3841,2,我叫刘二丁,3471,0,1,2,3,33.3%,10m
3841,2,[桃谷]绯红女皇,3471,0,0,1,1,0.0%,44m
3847,2,IIIIIII,3470,1141,132,107,239,55.2%,20m
3847,2,Demon,3470,1281,101,88,189,53.4%,41m
3847,2,Microsad,3470,375,55,52,107,51.4%,14m
3847,2,[八爪鱼]紫影幻月,3470,1003,52,39,91,57.1%,27m
3847,2,十月御加加,3470,725,39,48,87,44.8%,8m
3847,2,innoovaation,3470,852,32,33,65,49.2%,43m
3847,2,利维亚的杰洛特,3470,270,10,12,22,45.5%,42m
3847,1,AtWill,3470,205,7,3,10,70.0%,2m
3847,2,[舔茶神]酱油,3470,0,0,1,1,0.0%,2m
3847,2,二奶要翻身,3470,0,0,2,2,0.0%,22m
3857,2,[传说萌鸡团]Shaquille,3469,1121,101,87,188,53.7%,8m
3857,2,[B站星际小德]老面包啊,3469,1560,78,60,138,56.5%,41m
3857,2,[OldGuy]DeviL,3469,141,44,35,79,55.7%,30m
3857,2,[神圣刘毅天国]研究生,3469,609,25,24,49,51.0%,21m
3857,2,桃太郎,3469,304,17,12,29,58.6%,20m
3857,3,lsb,3469,298,14,4,18,77.8%,17m
3857,2,[肉鸡的饲养]YogSothothDD,3469,268,9,7,16,56.2%,25m
3857,2,IIIIIIIIIIII,3469,137,9,11,20,45.0%,14m
3857,2,[张博文是只鸡]瞧尔萨斯,3469,234,8,6,14,57.1%,9m
3857,2,暴风丶晨晨,3469,0,0,1,1,0.0%,3m
3857,3,[探机萌新I]GraVitatioN,3469,0,0,1,1,0.0%,10m
3868,2,缔酒燈桦,3468,86,4,13,17,23.5%,2m
3868,2,llllllllllll,3468,116,4,15,19,21.1%,12m
3868,2,Lindada,3468,30,2,5,7,28.6%,15m
3868,2,[半个菜鸟II]路西法,3468,0,1,3,4,25.0%,16m
3868,2,[单推人]llIlIIIIIlll,3468,0,0,1,1,0.0%,42m
3873,2,南介,3467,287,11,11,22,50.0%,30m
3873,3,[六爷唯一女粉]六花妹,3467,167,9,4,13,69.2%,29m
3873,2,[刺蛇互助社团]Demons,3467,156,7,0,7,100.0%,29m
3873,1,[龙眠山下的猫]zero,3467,0,1,0,1,100.0%,16m
3873,2,[Tov]IIIIIIIIIIII,3467,0,0,3,3,0.0%,28m
3878,2,暴雪不在乎你意见,3466,1020,142,122,264,53.8%,5m
3878,3,我要吃棒棒糖,3466,258,12,5,17,70.6%,16m
3878,2,[Zoo]Zoojianren,3466,238,8,12,20,40.0%,7m
3878,3,Aerith,3466,58,3,0,3,100.0%,24m
3878,2,[地质大学武汉]Sapphire,3466,60,2,4,6,33.3%,28m
3878,3,[i5]WJlulu,3466,0,0,1,1,0.0%,27m
3884,2,Crema,3465,1362,59,52,111,53.2%,42m
3884,2,[YMFW]魂魄妖忌,3465,700,35,20,55,63.6%,28m
3884,2,[蕙质兰心]呐呐呐,3465,92,4,8,12,33.3%,8m
3887,2,[SCer]xiaoxiao,3464,1568,79,62,141,56.0%,44m
3887,2,[火焰雷兽]无敌烂人,3464,288,10,12,22,45.5%,8m
3887,2,IIIIIIIIII,3464,90,3,6,9,33.3%,20m
3890,1,鸡血化,3463,1696,965,950,1915,50.4%,5m
3890,2,[KPL1vc]贝伦卡斯泰露,3463,1247,59,39,98,60.2%,8m
3890,2,[AEGIS]MrYZ,3463,486,18,21,39,46.2%,8m
3890,2,IIIIIIIII,3463,176,7,4,11,63.6%,23m
3890,2,[IBE]大主教的亲兵,3463,88,2,1,3,66.7%,12m
3895,2,ZzZz,3462,1334,152,141,293,51.9%,7m
3895,2,CLAAFresno,3462,1388,111,97,208,53.4%,14m
3895,3,SpringField,3462,738,27,21,48,56.2%,12m
3895,2,[Miniyi]Dimseventhyi,3462,210,8,15,23,34.8%,12m
3895,2,Ttrash,3462,191,6,5,11,54.5%,26m
3895,3,[上古之神]全金属外壳,3462,0,0,1,1,0.0%,21m
3901,3,[没头脑]dingshuo,3461,396,15,12,27,55.6%,29m
3901,2,江南人见愁,3461,156,8,2,10,80.0%,8m
3901,3,嘤嘤嘤嘤嘤嘤嘤嘤,3461,144,5,5,10,50.0%,21m
3904,2,[其实是虎牢关]Zimba,3460,1552,139,123,262,53.1%,27m
3904,2,[后院躲猫猫]Ethan,3460,1596,89,94,183,48.6%,7m
3904,2,[沪杭联队V5]范西屏,3460,996,63,64,127,49.6%,21m
3904,2,[Toss]神族就输不了,3460,1429,57,61,118,48.3%,27m
3904,2,我的卡,3460,164,4,5,9,44.4%,9m
3904,2,YellowTank,3460,88,2,1,3,66.7%,7m
3904,2,[阿萨去]Rock,3460,18,1,4,5,20.0%,28m
3911,2,天照之子,3459,918,36,36,72,50.0%,5m
3911,2,ARBAlex,3459,803,34,28,62,54.8%,15m
3911,2,[绝版小喵]xzs,3459,388,16,10,26,61.5%,12m
3914,2,czbro,3458,775,91,80,171,53.2%,8m
3914,2,遇事不决两船兵,3458,1542,78,73,151,51.7%,3m
3914,2,[两道菜]fansytt,3458,845,39,33,72,54.2%,5m
3914,2,[暴兵军团]欲望之血,3458,342,12,11,23,52.2%,41m
3914,2,[湖南工大]我是小白,3458,294,10,12,22,45.5%,25m
3914,2,[神武骑士团]瑞兽,3458,139,7,1,8,87.5%,27m
3914,2,救赎之路,3458,116,6,1,7,85.7%,13m
3914,3,[刺蛇互助天团]Yuna,3458,30,1,1,2,50.0%,14m
3914,2,条码人,3458,0,1,1,2,50.0%,12m
3923,2,少年祭,3457,1437,140,150,290,48.3%,14m
3923,2,东哥,3457,1493,84,66,150,56.0%,27m
3923,2,Wen,3457,1387,69,64,133,51.9%,14m
3923,2,[BereTA]Thor,3457,1289,54,44,98,55.1%,42m
3923,3,Synew,3457,418,18,5,23,78.3%,22m
3923,2,[命运之夜]夏桀丶,3457,428,15,18,33,45.5%,3m
3923,2,terribel,3457,190,7,4,11,63.6%,5m
3923,2,said,3457,141,3,2,5,60.0%,5m
3923,3,[偽娘万歳]地狱咆哮,3457,0,1,4,5,20.0%,45m
3923,2,肯爱千金轻一笑,3457,0,0,2,2,0.0%,12m
3923,2,[你的剑很美]咸柠七,3457,0,0,2,2,0.0%,13m
3923,2,ByuN,3457,0,0,2,2,0.0%,42m
3935,2,重新上阵,3456,1664,214,201,415,51.6%,42m
3935,2,星际遥航,3456,820,57,69,126,45.2%,29m
3935,2,shhowever,3456,595,21,33,54,38.9%,7m
3935,3,诅咒来了,3456,146,13,8,21,61.9%,26m
3935,2,鸭子光线,3456,154,11,8,19,57.9%,2m
3935,3,[女人影响剑速]帅比,3456,60,3,1,4,75.0%,8m
3935,2,[SWlAT]战士,3456,0,1,0,1,100.0%,39m
3935,3,[miku守护]ghoti,3456,0,1,0,1,100.0%,29m
3935,3,破天荒之风,3456,0,0,1,1,0.0%,7m
3935,2,东霸天,3456,0,0,2,2,0.0%,13m
3945,2,[台州温岭]William,3455,712,28,24,52,53.8%,9m
3945,1,likejuly,3455,291,9,29,38,23.7%,41m
3945,2,[野蛮猫骑士]她说万幸得以相识,3455,218,7,6,13,53.8%,22m
3945,2,[DMRz]XYfans,3455,204,7,13,20,35.0%,27m
3945,2,[RPG神教]卖萌的探机,3455,184,6,8,14,42.9%,44m
3945,3,IIIIIIIIIIII,3455,0,0,1,1,0.0%,24m
3951,2,[IMRTS2]MarvinLuis,3454,612,29,17,46,63.0%,8m
3951,2,[华科大]Touch,3454,190,6,5,11,54.5%,12m
3951,2,[KSARrk]sHar,3454,88,1,2,3,33.3%,28m
3954,2,[打老虎]坏坏的撒卡,3453,1652,112,110,222,50.5%,29m
3954,2,最强生物卡兹,3453,1222,49,48,97,50.5%,26m
3954,1,FrancisK,3453,965,37,36,73,50.7%,44m
3954,2,[莽夫苟熊]盲人能看到的条码,3453,568,31,21,52,59.6%,29m
3954,2,llllllllllll,3453,262,18,15,33,54.5%,20m
3954,3,[他输给孙哥喵]嵯峨想变得可爱,3453,86,3,2,5,60.0%,39m
3960,3,gansisyf,3452,0,0,1,1,0.0%,43m
3960,2,[夕颜]中华气死喵,3452,0,0,3,3,0.0%,20m
3962,2,[冰雪巨人]教练我能吃苦,3451,1457,552,544,1096,50.4%,7m
3962,2,[大雨的逆袭]儿子,3451,933,188,174,362,51.9%,8m
3962,2,IIIIIIIIIIII,3451,970,46,35,81,56.8%,15m
3962,2,至尊寳,3451,938,34,38,72,47.2%,7m
3962,3,[uEstc]电子科大美女多,3451,145,8,4,12,66.7%,25m
3962,2,[IMRTS]OGOGO,3451,228,8,21,29,27.6%,3m
3962,2,[小仙女的]枪兵,3451,202,7,10,17,41.2%,41m
3962,2,[1911]Fencer,3451,88,2,1,3,66.7%,25m
3962,3,[HTW]Origin,3451,0,1,0,1,100.0%,10m
3962,3,[大龄女手残党]仁慈的羊角念文,3451,0,0,1,1,0.0%,5m
3972,2,[ZZZAKU]机巧武者八一八,3450,600,22,24,46,47.8%,12m
3972,2,[武汉理工大学]Stats,3450,180,6,4,10,60.0%,41m
3972,2,[东部战区]战场原黑仪,3450,142,3,4,7,42.9%,29m
3972,3,[新的蜜蜂]我永远爱维多利加,3450,30,2,1,3,66.7%,9m
3976,2,徐地雷,3449,1474,170,164,334,50.9%,29m
3976,2,繁星夜空下,3449,303,21,17,38,55.3%,12m
3976,3,Wednesday,3449,0,1,0,1,100.0%,40m
3976,3,trumpV,3449,30,1,7,8,12.5%,16m
3976,3,ilililililil,3449,0,0,1,1,0.0%,21m
3981,2,万色星辰,3448,1532,274,276,550,49.8%,5m
3981,2,菜鸟,3448,451,16,14,30,53.3%,29m
3981,3,[中南大学官网]IIIIIIIIIIII,3448,0,1,0,1,100.0%,15m
3981,3,[分析]LeeGhoST,3448,0,0,1,1,0.0%,14m
3981,3,VECTOR,3448,0,0,1,1,0.0%,15m
3981,2,[我就是个]冬泳怪鸽,3448,0,0,3,3,0.0%,5m
3987,2,[沙漠之狐]SFY,3447,1526,94,92,186,50.5%,25m
3987,2,我有难处孙一峰,3447,726,43,24,67,64.2%,3m
3987,2,[丨SLT丨]淡忘,3447,503,23,13,36,63.9%,12m
3987,2,llllllllllll,3447,483,18,18,36,50.0%,21m
3987,2,[Shawk]Jackwea,3447,408,15,20,35,42.9%,2m
3987,2,whquve,3447,146,5,9,14,35.7%,12m
3987,2,alaventus,3447,120,4,7,11,36.4%,20m
3987,3,丶晴天,3447,58,3,1,4,75.0%,41m
3987,3,[SCAP]arthursaber,3447,22,2,2,4,50.0%,8m
3987,3,三千分的鸡,3447,0,1,0,1,100.0%,42m
3987,3,[第八舰队丶]西红柿,3447,30,1,1,2,50.0%,2m
3987,2,[Anticw]Farser,3447,76,1,2,3,33.3%,15m
3987,2,fuy,3447,30,1,8,9,11.1%,20m
3987,2,灬弑杀丿星官,3447,0,0,2,2,0.0%,44m
4001,2,[兆景埋土大学]Leslie,3446,1578,129,120,249,51.8%,5m
4001,3,saber,3446,1022,57,49,106,53.8%,30m
4001,2,落日斜阳,3446,211,17,10,27,63.0%,20m
4001,3,[星云二五仔]fizzovation,3446,194,8,4,12,66.7%,17m
4001,3,[CNboi]句号,3446,86,3,1,4,75.0%,2m
4001,2,[四叶草]miaoxfive,3446,50,3,3,6,50.0%,6m
4001,2,红旗不倒,3446,58,2,4,6,33.3%,25m
4008,2,[Thpj]Alone,3445,1261,161,150,311,51.8%,25m
4008,2,满船清梦压星河,3445,554,151,152,303,49.8%,20m
4008,2,真的要卡死了,3445,1343,134,128,262,51.1%,44m
4008,3,llllllllll,3445,936,43,26,69,62.3%,4m
4008,3,陈冠希,3445,30,1,1,2,50.0%,15m
4008,3,神奇的妞妞,3445,0,0,1,1,0.0%,14m
4008,3,[丿Es灬回忆]小凯民,3445,0,0,1,1,0.0%,40m
4008,3,Nietzsche,3445,0,0,1,1,0.0%,21m
4008,2,太上忘情豆,3445,0,0,1,1,0.0%,5m
4017,3,僵尸黄皇,3444,1481,65,45,110,59.1%,7m
4017,2,[SC2XBY]HunKey,3444,517,20,17,37,54.1%,10m
4017,2,[孙红雷]Blair,3444,346,18,20,38,47.4%,12m
4017,3,天龙,3444,0,1,0,1,100.0%,21m
4017,3,[Cyans]LucisQvQ,3444,0,0,1,1,0.0%,28m
4022,2,Gama,3443,1526,132,139,271,48.7%,28m
4022,2,RAT,3443,792,29,41,70,41.4%,28m
4022,3,soldiers,3443,316,14,7,21,66.7%,30m
4025,2,我真的不是小灰灰,3442,303,14,7,21,66.7%,3m
4025,3,miku,3442,0,0,1,1,0.0%,29m
4027,2,Kose,3441,1491,91,90,181,50.3%,6m
4027,2,IIIIIIIIIIII,3441,1034,58,52,110,52.7%,29m
4027,2,[法医吴彦祖]菟耳绒绒萌,3441,1080,41,41,82,50.0%,8m
4027,3,ShowTime,3441,0,5,0,5,100.0%,2m
4027,3,KKE,3441,0,0,1,1,0.0%,40m
4032,2,Miyazono,3440,1327,75,71,146,51.4%,22m
4032,2,[holyhp]小袁,3440,252,9,15,24,37.5%,7m
4032,2,Prophy,3440,186,7,10,17,41.2%,44m
4032,2,PiNoJ,3440,74,3,7,10,30.0%,3m
4032,3,[小小怪怪]sparrow,3440,0,1,1,2,50.0%,30m
4037,3,両仪式,3439,166,6,3,9,66.7%,23m
4037,1,三千二人族找陪练,3439,188,6,7,13,46.2%,29m
4037,3,养生星际,3439,0,0,2,2,0.0%,12m
4040,3,[THK9]水晶充盈着仇恨,3438,504,24,0,24,100.0%,16m
4040,3,suyouck,3438,324,13,7,20,65.0%,13m
4040,3,[OgiNA]Fruit,3438,0,0,1,1,0.0%,4m
4043,2,[NSDs]土豆你个马铃薯,3437,1582,151,164,315,47.9%,12m
4043,2,[吕布保护集团]杨三岁,3437,1501,76,66,142,53.5%,41m
4043,3,[死亡收割]SCPLAYER,3437,284,12,6,18,66.7%,3m
4046,2,[龙眠山下的猫]泰伦基建狂魔,3436,1021,92,90,182,50.5%,25m
4046,2,kiwi,3436,1404,50,61,111,45.0%,28m
4046,2,[VCTO]无情,3436,469,37,26,63,58.7%,3m
4046,2,翩若惊鸿,3436,482,21,26,47,44.7%,7m
4046,1,落叶,3436,167,9,4,13,69.2%,4m
4046,3,[黄漫老师]hehe,3436,156,6,7,13,46.2%,10m
4046,3,[桐乃骑士团]FIGHT,3436,0,0,1,1,0.0%,22m
4053,3,[ERO]Fly,3435,60,3,1,4,75.0%,23m
4053,3,艾尔光辉,3435,58,3,2,5,60.0%,18m
4053,3,[萌完吃个糖丶]wohen,3435,30,1,3,4,25.0%,40m
4053,3,[龙眠山下的猫]king,3435,0,0,1,1,0.0%,30m
4057,2,IIIIIIIIIIII,3434,1507,104,101,205,50.7%,44m
4057,3,[Mikon]血统纯净的喵星人,3434,0,1,0,1,100.0%,21m
4057,2,[斯巴达血战团]熊猫,3434,0,1,0,1,100.0%,2m
4057,3,杀手冬天,3434,0,0,1,1,0.0%,27m
4061,2,半山大雨,3433,1515,154,168,322,47.8%,2m
4061,2,llllllllllll,3433,1556,132,138,270,48.9%,41m
4061,2,本鸡需要援助,3433,1026,38,42,80,47.5%,13m
4061,3,庆幸的蛋糕,3433,570,21,19,40,52.5%,7m
4061,3,[暴雪开发团队]IIIIIIIIIIII,3433,0,1,0,1,100.0%,27m
4061,3,[泰伦保护协会]volahri,3433,0,1,0,1,100.0%,44m
4061,3,[叶凛离]凛秋叶离花不青,3433,0,0,1,1,0.0%,14m
4061,3,[千本琉璃]铜锣喵,3433,0,0,1,1,0.0%,2m
4061,2,葫芦娃,3433,0,0,6,6,0.0%,9m
4070,3,哦叶女孩,3432,1598,96,87,183,52.5%,14m
4070,2,Hero,3432,433,27,6,33,81.8%,5m
4070,2,[XXHZ14]諾相恋,3432,393,15,13,28,53.6%,15m
4070,3,[飘逸的一笔]KaroLee,3432,276,12,8,20,60.0%,7m
4070,2,喝完脉动割动脉,3432,178,7,9,16,43.8%,8m
4070,3,[乐高集团]逃学威龙,3432,30,1,3,4,25.0%,27m
4070,2,[肉鸡的饲养]jldfhnslkvns,3432,0,0,5,5,0.0%,25m
4077,2,[要不然你歇会]人生如寄,3431,334,11,18,29,37.9%,3m
4077,2,[不不要求求你]柏崎星奈,3431,261,10,6,16,62.5%,41m
4079,3,心无旁骛,3430,1630,301,273,574,52.4%,4m
4079,2,[练不出来啊]现役男子小学生,3430,1393,66,56,122,54.1%,10m
4079,2,Rys,3430,1388,60,58,118,50.8%,41m
4079,2,[不会散枪兵]imbasupertnt,3430,1211,51,41,92,55.4%,5m
4079,2,小航狙击你的心,3430,250,11,8,19,57.9%,15m
4079,3,[九虚空神教]末代王粉,3430,216,9,6,15,60.0%,5m
4079,2,[星际你打了几]星火,3430,210,7,13,20,35.0%,13m
4079,3,NiPdraken,3430,114,4,3,7,57.1%,24m
4079,3,[殿手F91]她似秋风,3430,0,3,2,5,60.0%,15m
4079,2,[Shawk]Lanthanum,3430,102,2,3,5,40.0%,15m
4079,3,lacker,3430,30,1,3,4,25.0%,21m
4079,3,Terran,3430,0,0,1,1,0.0%,28m
4079,3,CtrLife,3430,0,0,1,1,0.0%,30m
4079,3,Tarocg,3430,0,0,1,1,0.0%,23m
4093,3,白毛浮绿水,3429,1100,111,93,204,54.4%,17m
4093,2,錵訫猴猴,3429,1511,93,85,178,52.2%,10m
4093,3,[SDE]INnoVation,3429,567,27,15,42,64.3%,28m
4093,2,桐生马子,3429,742,26,38,64,40.6%,25m
4093,3,maimiheat,3429,333,15,10,25,60.0%,14m
4093,3,丶丶丶,3429,118,5,5,10,50.0%,19m
4093,3,Dewey,3429,0,0,1,1,0.0%,40m
4100,2,吾有上将潘凤,3428,1012,58,59,117,49.6%,7m
4100,3,[在原七海]Mashiro,3428,664,25,21,46,54.3%,8m
4100,2,紫夜,3428,360,12,17,29,41.4%,26m
4100,3,IIIIIII,3428,192,8,4,12,66.7%,44m
4100,3,[银河喵波隆]PicACG,3428,120,5,5,10,50.0%,28m
4100,2,[野人time]大和炮打探姬,3428,158,5,10,15,33.3%,41m
4100,3,[ByuN]Bianco,3428,0,1,0,1,100.0%,23m
4100,3,余生的第一天,3428,30,1,3,4,25.0%,11m
4100,2,MMA,3428,30,1,6,7,14.3%,29m
4100,3,BevisTsye,3428,0,0,1,1,0.0%,13m
4100,3,[艾尔之名]吊丝化的土肥圆,3428,0,0,1,1,0.0%,26m
4100,3,[旭公子]丿北灬向丨,3428,0,0,1,1,0.0%,21m
4100,2,MixTokYoHoT,3428,0,0,2,2,0.0%,16m
4100,3,[CPT]小无名,3428,0,0,6,6,0.0%,29m
4114,3,[深远Hist]Wakatsuki,3427,974,40,37,77,51.9%,41m
4114,1,好汉请杀我队友,3427,241,12,4,16,75.0%,16m
4114,2,WAR,3427,139,3,1,4,75.0%,28m
4114,2,Ash,3427,120,3,4,7,42.9%,5m
4114,2,[BREEZ]咲暗,3427,6,2,6,8,25.0%,5m
4114,3,[陽光男孩]sio,3427,0,0,1,1,0.0%,29m
4114,2,FoRtiSimO,3427,0,0,1,1,0.0%,9m
4121,3,yiqiluo,3426,1626,311,269,580,53.6%,21m
4121,3,[JiTEAM]枭枭,3426,894,61,35,96,63.5%,21m
4121,2,[Hist]Rainbow,3426,658,24,31,55,43.6%,22m
4121,3,[孤影眾]IIIIIIIIIIII,3426,196,7,4,11,63.6%,11m
4121,3,带带梁慕容霸,3426,200,7,7,14,50.0%,30m
4121,1,艾尔之巅,3426,157,4,2,6,66.7%,24m
4121,3,Shiryo,3426,0,1,0,1,100.0%,2m
4121,3,吃翔用吸管,3426,0,0,1,1,0.0%,4m
4121,3,Beatles,3426,0,0,1,1,0.0%,41m
4130,2,黄金时代,3425,1395,87,76,163,53.4%,22m
4130,2,IIIIIIIIII,3425,716,32,23,55,58.2%,26m
4130,3,爱里寿,3425,88,4,3,7,57.1%,21m
4130,3,[i5]DarkArchon,3425,58,3,0,3,100.0%,13m
4130,3,Satellite,3425,0,1,1,2,50.0%,41m
4130,1,[夏芒]夏芒,3425,0,0,3,3,0.0%,17m
4130,2,sada,3425,0,0,4,4,0.0%,7m
4137,2,[初号機]现实花园在劈杈,3424,1155,179,165,344,52.0%,16m
4137,3,neeb,3424,1077,48,45,93,51.6%,12m
4137,2,[XYFANS]ManUtd,3424,1038,47,40,87,54.0%,3m
4137,2,captain,3424,674,23,32,55,41.8%,21m
4137,2,[千本琉璃]轻绘梨花泪沾衣,3424,319,22,11,33,66.7%,8m
4137,3,[RTSGo]冰晶雪色,3424,360,15,9,24,62.5%,27m
4137,3,shirosakiren,3424,135,3,3,6,50.0%,14m
4137,2,[BRK]牛山狗皇,3424,90,3,7,10,30.0%,3m
4137,3,被隐匿的幽香,3424,0,0,1,1,0.0%,17m
4146,2,InTheNighT,3423,354,13,21,34,38.2%,3m
4146,3,July,3423,305,12,8,20,60.0%,9m
4146,2,[Brave]Rice,3423,288,10,10,20,50.0%,6m
4146,3,枪神尤里,3423,71,5,2,7,71.4%,42m
4146,3,LAN,3423,0,1,0,1,100.0%,17m
4151,3,[雾雨魔法森林]催眠拿铁,3422,170,5,1,6,83.3%,11m
4151,3,丢你雷姆,3422,183,5,6,11,45.5%,30m
4151,1,[田中姬铃木雏]金木研,3422,48,2,5,7,28.6%,39m
4151,3,[王学]钢铁匠匠,3422,0,1,2,3,33.3%,27m
4151,3,[HoA]BlueBlue,3422,0,0,1,1,0.0%,8m
4151,3,黑雾,3422,0,0,1,1,0.0%,15m
4151,3,[TPoA]Minecraft,3422,0,0,1,1,0.0%,19m
4151,2,机械风暴,3422,0,0,5,5,0.0%,5m
4159,3,湘西土匪,3421,1654,232,228,460,50.4%,8m
4159,3,[紫gbawe]alex,3421,1318,77,71,148,52.0%,15m
4159,2,ZealotBlade,3421,613,33,17,50,66.0%,8m
4159,2,[葬魂]ddfdf,3421,384,13,23,36,36.1%,44m
4159,1,星邪不是星谐,3421,182,8,4,12,66.7%,24m
4159,3,[第四駆逐鑑隊]十丶王,3421,137,7,2,9,77.8%,40m
4159,3,懒得讲武德,3421,58,3,1,4,75.0%,30m
4159,3,木樨花秋,3421,30,1,2,3,33.3%,15m
4159,3,[时空巡逻队]大神官,3421,0,0,1,1,0.0%,25m
4168,3,小白才不可爱,3420,484,21,7,28,75.0%,26m
4168,3,星际,3420,194,10,7,17,58.8%,8m
4168,1,LonG,3420,209,5,22,27,18.5%,14m
4168,3,天梯马保国,3420,86,4,2,6,66.7%,16m
4168,3,[Etd]EtdYanQ,3420,30,1,4,5,20.0%,16m
4168,3,达尔,3420,0,0,1,1,0.0%,27m
4174,2,酶川酷酷,3419,1594,377,365,742,50.8%,2m
4174,3,[VirGo]云在青天,3419,1651,304,272,576,52.8%,26m
4174,3,[大漢]虽远必诛,3419,178,12,12,24,50.0%,41m
4174,2,liaaa,3419,357,11,14,25,44.0%,15m
4174,3,御坂美琴,3419,0,2,4,6,33.3%,25m
4174,3,[天雪]華鳥風月,3419,0,1,0,1,100.0%,8m
4174,3,JustForU,3419,0,1,1,2,50.0%,41m
4174,3,[旭东黄]phage,3419,0,0,2,2,0.0%,12m
4174,3,SAJ,3419,0,0,2,2,0.0%,22m
4183,3,游戏王,3418,1335,99,79,178,55.6%,15m
4183,2,[罗马帝国]机枪不如鸡强,3418,298,12,10,22,54.5%,41m
4183,2,[GO丨]Olajuwon,3418,142,8,2,10,80.0%,41m
4183,2,[谁在呼叫舰队]Foreverspide,3418,242,8,15,23,34.8%,8m
4183,3,IIIIIIIIIIII,3418,0,0,1,1,0.0%,40m
4183,3,[RyH键谈坊]龙战,3418,0,0,1,1,0.0%,42m
4189,2,Saniya,3417,1095,85,82,167,50.9%,41m
4189,3,[海德单推协会]无敌鸦鸦者,3417,1141,50,31,81,61.7%,16m
4189,2,银鹭爱的味道,3417,137,9,6,15,60.0%,2m
4189,3,[NLYH]usgk,3417,0,1,1,2,50.0%,24m
4189,3,[吕布女团]莫比斯军团,3417,0,0,1,1,0.0%,21m
4194,2,Devil,3416,1569,241,237,478,50.4%,30m
4194,2,榨菜好吃,3416,1538,117,128,245,47.8%,3m
4194,2,zjm,3416,728,42,24,66,63.6%,12m
4194,2,[武大萌新]Timba,3416,561,24,28,52,46.2%,12m
4194,3,[thu战队]AELITA,3416,198,15,9,24,62.5%,4m
4194,3,恶魔,3416,58,2,1,3,66.7%,24m
4194,3,IIIIIIIIIIII,3416,0,1,1,2,50.0%,29m
4194,3,GouGouMan,3416,30,1,1,2,50.0%,19m
4202,3,qjhsfather,3415,426,19,13,32,59.4%,15m
4202,2,浅夏,3415,62,3,4,7,42.9%,18m
4202,3,[IMRTS]你大爷,3415,30,1,2,3,33.3%,2m
4202,3,RESPECTtime,3415,0,0,1,1,0.0%,25m
4206,3,[西伯利亚土豆]Stare,3414,395,18,14,32,56.2%,12m
4206,3,[装大佬的鸡]WSPHY,3414,204,7,8,15,46.7%,15m
4206,2,烟鬼,3414,0,5,1,6,83.3%,42m
4206,3,[霸气军团]洗胖次的林阿狗,3414,60,2,5,7,28.6%,16m
4206,3,[TimoIN]maki,3414,30,1,1,2,50.0%,2m
4206,3,[艾尔之名]Timba,3414,30,1,1,2,50.0%,27m
4206,3,[Flowex]GUL,3414,0,0,1,1,0.0%,44m
4213,3,WanZi,3413,956,93,83,176,52.8%,12m
4213,3,坨阿姆,3413,1534,85,45,130,65.4%,3m
4213,2,[养生会馆]世界核平,3413,1492,74,71,145,51.0%,9m
4213,2,[紫gbawe]blackrock,3413,400,25,19,44,56.8%,3m
4213,3,DullBean,3413,464,21,12,33,63.6%,41m
4213,3,星际工作找我义务,3413,420,16,11,27,59.3%,44m
4213,1,乳摇骑士,3413,276,12,5,17,70.6%,24m
4213,2,害羞的西兰花,3413,0,5,1,6,83.3%,19m
4213,3,[真理卐高中]极限,3413,0,4,1,5,80.0%,7m
4213,3,[哔哩哔哩乾杯]JinrMaru,3413,92,4,4,8,50.0%,16m
4213,2,[WFFF]大肠粉,3413,0,1,0,1,100.0%,18m
4213,3,Betelgeuse,3413,0,0,1,1,0.0%,44m
4225,2,Critical,3412,455,22,15,37,59.5%,41m
4225,3,[蓝鸟]朝天宫球球,3412,150,6,6,12,50.0%,8m
4225,3,三千奈何流,3412,0,0,2,2,0.0%,12m
4228,2,[SC2战队]GHOST,3411,1498,175,170,345,50.7%,44m
4228,2,Somnus,3411,1554,124,127,251,49.4%,26m
4228,3,唐毅萌萌哒喲,3411,1339,84,70,154,54.5%,24m
4228,2,IIIIIIIIIIII,3411,1480,62,67,129,48.1%,28m
4228,2,[哈莉奎茵丶]MarScarrY,3411,629,43,31,74,58.1%,4m
4228,3,GraceLover,3411,494,24,11,35,68.6%,40m
4228,2,[DDOS不凡]RUNhonesT,3411,580,24,22,46,52.2%,30m
4228,3,[艦Colle]英梨梨的双马尾,3411,490,21,17,38,55.3%,4m
4228,3,Composure,3411,178,7,6,13,53.8%,21m
4228,2,胜败乃兵家常事,3411,62,2,11,13,15.4%,21m
4228,2,Glory,3411,0,0,5,5,0.0%,15m
4239,3,[天朝]乱世王者,3410,328,18,9,27,66.7%,10m
4239,3,sosoo,3410,88,4,2,6,66.7%,12m
4239,3,BearVigny,3410,0,2,3,5,40.0%,10m
4239,3,[阿库西斯教团]哔哩哔哩冷破穹,3410,0,1,0,1,100.0%,17m
4239,3,[ZTSCAP]Pray,3410,0,1,0,1,100.0%,16m
4239,3,[萌蛋组合]风吹屁屁凉,3410,0,1,1,2,50.0%,43m
4239,3,奶到成功黄旭东,3410,0,0,3,3,0.0%,25m
4246,2,[圣德怀特学园]lucifer,3409,318,13,11,24,54.2%,22m
4246,2,[AnSwer]IIIIIIIIII,3409,272,10,13,23,43.5%,26m
4246,3,Elijah,3409,60,7,6,13,53.8%,11m
4246,3,IIIIIIIIIIII,3409,0,2,4,6,33.3%,24m
4246,3,中世鸦人,3409,0,1,2,3,33.3%,9m
4246,3,[我们要娶老婆]结城明日奈,3409,0,0,1,1,0.0%,30m
4246,2,[白给不要钱]Mooyu,3409,0,0,9,9,0.0%,3m
4253,3,smous,3408,1544,78,64,142,54.9%,4m
4253,2,Chembuster,3408,1311,72,70,142,50.7%,44m
4253,3,我是吖吖,3408,142,5,3,8,62.5%,15m
4253,3,[星河气象学院]yyyyy,3408,114,4,5,9,44.4%,9m
4253,3,[NPUED]Stalker,3408,0,1,0,1,100.0%,29m
4258,2,[求女友]不理我就慢慢拆,3407,1574,232,246,478,48.5%,28m
4258,2,[天下第一莽]纳达,3407,1228,161,144,305,52.8%,3m
4258,3,一枚星际小萌新哟,3407,560,142,127,269,52.8%,43m
4258,3,IIIIIIIIIIII,3407,571,127,124,251,50.6%,16m
4258,2,TerranLife,3407,890,43,47,90,47.8%,12m
4258,2,[gan死x哥]倾国倾城孙伊枫,3407,1040,40,37,77,51.9%,43m
4258,3,[凛凛拎个鳖]血翼鸿鹄,3407,286,13,8,21,61.9%,45m
4258,3,[尤摩扬科技]幽冥王,3407,194,8,2,10,80.0%,8m
4258,2,llllllllllll,3407,93,3,15,18,16.7%,42m
4258,3,[基金会]SOo,3407,30,2,0,2,100.0%,2m
4268,2,[怎么赢P]一束七,3406,1539,141,136,277,50.9%,7m
4268,2,引力,3406,676,140,132,272,51.5%,7m
4268,2,DCores,3406,722,115,103,218,52.8%,26m
4268,2,YUI,3406,1346,70,57,127,55.1%,44m
4268,2,鐵血,3406,845,57,54,111,51.4%,9m
4268,2,半藏与半城在森林,3406,204,55,44,99,55.6%,12m
4268,3,[CF]小西瓜,3406,557,31,20,51,60.8%,41m
4268,3,wwwww,3406,361,16,8,24,66.7%,21m
4268,3,[CNboys]杀到你流泪,3406,0,1,0,1,100.0%,43m
4268,3,FutAKimArine,3406,0,1,0,1,100.0%,13m
4268,1,一念觉悟,3406,48,1,1,2,50.0%,40m
4268,3,loner,3406,0,0,1,1,0.0%,14m
4268,3,[不偷会死星人]歼星者,3406,0,0,2,2,0.0%,24m
4281,2,sudo,3405,1535,346,332,678,51.0%,12m
4281,3,[海鲜商人]KING,3405,1473,79,79,158,50.0%,5m
4281,1,[TLSC]LiquidHerO,3405,974,64,73,137,46.7%,43m
4281,3,ByuN,3405,757,32,24,56,57.1%,26m
4281,2,[阿尔托莉蕥]轻云出月风静月,3405,90,7,3,10,70.0%,19m
4281,2,[枪炮与玫瑰]AlianG,3405,154,6,15,21,28.6%,44m
4281,3,稀神旭东,3405,66,5,2,7,71.4%,9m
4281,3,[丨SLT丨]星球大战,3405,58,3,1,4,75.0%,3m
4281,3,[KFC]ShowTime,3405,0,0,1,1,0.0%,44m
4281,3,sebenshu,3405,0,0,1,1,0.0%,17m
4291,2,SourBanana,3404,1064,95,92,187,50.8%,7m
4291,2,[艾尔小圆盾]小野芒果,3404,1184,62,51,113,54.9%,7m
4291,2,灬知止灬,3404,1566,61,59,120,50.8%,5m
4291,3,DarkPanda,3404,0,0,1,1,0.0%,2m
4291,3,[暴雪我是你爹]坦克不对空,3404,0,0,1,1,0.0%,17m
4296,3,[中南大学官网]桥本环奈老公,3403,1583,74,64,138,53.6%,30m
4296,3,AsuKa,3403,722,29,20,49,59.2%,25m
4296,3,MVP,3403,255,9,7,16,56.2%,11m
4296,3,叁秒啪啪韩,3403,147,4,3,7,57.1%,13m
4296,3,ZeroTwo,3403,0,1,0,1,100.0%,30m
4296,3,[GAC]栗悟饭与龟波功,3403,30,1,3,4,25.0%,19m
4296,3,禁止非法炸鱼,3403,0,0,2,2,0.0%,5m
4303,2,HErrey,3402,1565,308,304,612,50.3%,22m
4303,2,拉雷,3402,649,58,55,113,51.3%,43m
4303,2,HandSomeHaw,3402,338,14,11,25,56.0%,10m
4303,3,[战旗第十分队]小胖,3402,30,1,2,3,33.3%,17m
4303,3,[KPG2]千岛,3402,0,0,1,1,0.0%,4m
4303,3,Albert,3402,0,0,2,2,0.0%,11m
4309,3,IIIIIIIIIIII,3401,914,176,165,341,51.6%,23m
4309,2,[火焰雷兽]洛丹伦,3401,1357,89,78,167,53.3%,44m
4309,2,Nevermore,3401,422,49,61,110,44.5%,15m
4309,3,想吃萝莉的小唧唧,3401,324,11,8,19,57.9%,18m
4309,2,Sterbliche,3401,220,9,12,21,42.9%,19m
4309,1,涂鸦,3401,144,5,6,11,45.5%,40m
4309,3,低调的嚣张,3401,0,1,0,1,100.0%,8m
4309,2,Scarlet,3401,0,1,0,1,100.0%,29m
4309,3,GREATAGAIN,3401,0,1,0,1,100.0%,13m
4309,2,[XXHZ35]Jones,3401,0,1,1,2,50.0%,8m
4309,3,[黄金海舰队]Ottersleepy,3401,0,0,1,1,0.0%,4m
4320,2,XiaoZhaoQAQ,3400,1255,49,48,97,50.5%,15m
4320,2,llllllllllll,3400,867,47,48,95,49.5%,19m
4320,3,我是牛人,3400,122,4,7,11,36.4%,4m
4320,3,WarriordayS,3400,0,1,0,1,100.0%,8m
4320,3,[丷虎牢关]Kings,3400,96,1,1,2,50.0%,40m
4325,3,SuperShinHye,3399,88,4,3,7,57.1%,9m
4325,3,代号,3399,88,3,3,6,50.0%,22m
4325,3,UnderTaker,3399,0,0,1,1,0.0%,39m
4328,2,憨憨跟筒筒是狗狗,3398,1481,421,417,838,50.2%,29m
4328,2,[GSC]ghost,3398,1540,127,131,258,49.2%,15m
4328,2,[叱咤青铜组]海淀孙一峰,3398,764,28,29,57,49.1%,22m
4328,2,[153cm]diao,3398,506,20,19,39,51.3%,26m
4328,3,野人不需要智力,3398,366,15,9,24,62.5%,2m
4328,3,[超可爱]涂山苏苏,3398,282,9,15,24,37.5%,25m
4328,3,KiseKiRV,3398,90,4,5,9,44.4%,44m
4328,3,hahaha,3398,0,1,0,1,100.0%,5m
4328,3,BOSS,3398,0,0,1,1,0.0%,9m
4337,2,asdfasdf,3397,1287,99,86,185,53.5%,27m
4337,3,[五月花]神之宣告,3397,819,34,29,63,54.0%,22m
4337,3,[萨尔那加之刃]tourist,3397,542,21,15,36,58.3%,30m
4337,2,顶级手法,3397,386,19,14,33,57.6%,10m
4337,3,[我们是无敌的]daddyhm,3397,456,18,11,29,62.1%,11m
4337,3,伏尔加,3397,292,11,7,18,61.1%,11m
4337,1,[卑微的星灵]ZTimba,3397,96,6,2,8,75.0%,24m
4337,2,Kirito,3397,119,4,2,6,66.7%,30m
4345,3,Delruce,3396,1662,251,212,463,54.2%,40m
4345,3,[胖子触电]LEFTEYE,3396,174,6,7,13,46.2%,26m
4345,3,[云南商学院]DGL,3396,62,2,4,6,33.3%,18m
4345,1,Explorer,3396,0,1,0,1,100.0%,23m
4345,2,打团让领导先走,3396,0,0,5,5,0.0%,28m
4350,3,九九子,3395,870,48,42,90,53.3%,23m
4350,2,Style,3395,263,11,10,21,52.4%,13m
4350,3,[暴雪我是你爹]braveterran,3395,264,10,4,14,71.4%,29m
4350,3,Night,3395,0,0,1,1,0.0%,15m
4354,2,MarineKing,3394,1593,110,101,211,52.1%,26m
4354,2,[酷肖帅谭]时针,3394,394,58,59,117,49.6%,21m
4354,2,MagejiTerran,3394,408,16,14,30,53.3%,4m
4354,3,[雨何时会下]ATRI,3394,259,11,11,22,50.0%,16m
4354,3,SYdHYe,3394,30,2,3,5,40.0%,4m
4354,3,zrzr,3394,30,1,1,2,50.0%,30m
4354,3,[KPG]AloneWolf,3394,0,0,1,1,0.0%,12m
4361,2,llllllllllll,3393,1253,136,136,272,50.0%,8m
4361,2,[SC2近卫军]无毒不丈夫,3393,613,30,22,52,57.7%,12m
4361,2,[基金会]迪特里希,3393,146,7,2,9,77.8%,6m
4361,3,殇影,3393,196,5,6,11,45.5%,27m
4361,3,CoOl,3393,30,2,3,5,40.0%,11m
4361,3,[NanTeS]jkai,3393,30,1,4,5,20.0%,11m
4361,3,IIIIIIIII,3393,0,0,1,1,0.0%,27m
4361,3,[五月花]富有思想的熊猫,3393,0,0,2,2,0.0%,13m
4369,2,[传说萌娘团]AFK,3392,1539,243,233,476,51.1%,26m
4369,2,丑得哭,3392,1498,114,107,221,51.6%,26m
4369,2,Dark,3392,46,2,2,4,50.0%,45m
4369,3,嘿丶马小跳,3392,0,0,1,1,0.0%,19m
4369,3,zzz,3392,0,0,1,1,0.0%,40m
4369,3,[武汉理工大学]鹤望兰,3392,0,0,1,1,0.0%,6m
4375,2,[Fear]小邓,3391,229,18,21,39,46.2%,14m
4375,2,[NHSD]PREFECT,3391,141,7,3,10,70.0%,6m
4375,3,曾某人,3391,204,7,8,15,46.7%,17m
4375,3,TOMOYO,3391,85,5,1,6,83.3%,14m
4375,3,公爵杀手,3391,0,0,3,3,0.0%,43m
4380,2,苍穹大地,3390,1839,370,411,781,47.4%,23m
4380,2,qxiangyun,3390,1538,267,284,551,48.5%,23m
4380,2,Bobyang,3390,1572,176,181,357,49.3%,8m
4380,2,[GAC]Notenough,3390,1159,65,57,122,53.3%,13m
4380,3,凹凸曼,3390,396,15,11,26,57.7%,44m
4380,1,szg,3390,98,5,2,7,71.4%,13m
4380,3,[C17079]深色的夜空,3390,30,2,1,3,66.7%,45m
4380,3,HeartBroken,3390,58,2,1,3,66.7%,6m
4380,2,[南昌堂口兄弟]ByuN,3390,0,0,5,5,0.0%,26m
4389,2,[五月花]魔法少女金月月,3389,1507,122,127,249,49.0%,10m
4389,2,蛛丝马迹,3389,142,4,6,10,40.0%,5m
4389,3,afawefeaw,3389,58,3,2,5,60.0%,9m
4389,3,MissMystery,3389,0,0,1,1,0.0%,23m
4393,3,Miniko,3388,1208,133,117,250,53.2%,41m
4393,3,为了艾尔,3388,866,86,10,96,89.6%,26m
4393,3,Tany,3388,311,13,6,19,68.4%,12m
4393,3,[是我赢了]星际小萌新,3388,240,10,3,13,76.9%,12m
4393,3,Chrees,3388,244,10,4,14,71.4%,30m
4393,3,[ISMU星际]Icecream,3388,280,10,7,17,58.8%,30m
4393,3,[LYFANS]雪之下雪乃丷,3388,241,10,10,20,50.0%,30m
4393,3,[鼠标流俱乐部]AzraelGG,3388,140,5,3,8,62.5%,40m
4393,2,魔鬼筋肉人,3388,102,2,5,7,28.6%,22m
4393,3,[舰队已经抵达]一本正经,3388,30,1,2,3,33.3%,23m
4393,3,Trileptal,3388,30,1,3,4,25.0%,17m
4393,3,我在吃西瓜,3388,30,1,5,6,16.7%,39m
4393,3,HuangYunnan,3388,0,0,1,1,0.0%,39m
4393,3,吃大餐,3388,0,0,2,2,0.0%,26m
4407,3,[鬼谷]后树,3387,1012,42,42,84,50.0%,28m
4407,2,星辰钟塔的玛利亚,3387,748,27,29,56,48.2%,3m
4407,3,[孤影眾]ByuN,3387,382,13,13,26,50.0%,15m
4407,3,Flash,3387,30,3,2,5,60.0%,5m
4407,2,[v字复仇队]新哥哥完美,3387,0,0,1,1,0.0%,30m
4407,3,banerer,3387,0,0,1,1,0.0%,18m
4413,2,冰血之殇,3386,1210,141,137,278,50.7%,15m
4413,2,LYDBB,3386,1034,96,92,188,51.1%,9m
4413,2,[群星璀璨]茶荼行,3386,14,4,9,13,30.8%,23m
4413,3,gunson,3386,0,0,1,1,0.0%,19m
4417,2,诸司马迹,3385,1472,225,207,432,52.1%,41m
4417,2,sandom,3385,1574,83,87,170,48.8%,3m
4417,2,卡德加,3385,520,19,24,43,44.2%,26m
4417,2,Ice,3385,116,3,1,4,75.0%,20m
4417,3,[weep]Smile,3385,0,0,1,1,0.0%,28m
4422,2,[agafaa]我是你爹,3384,1396,251,246,497,50.5%,7m
4422,3,我是炮灰我怕谁,3384,978,222,197,419,53.0%,11m
4422,2,诞生,3384,1534,164,150,314,52.2%,20m
4422,3,[DMRe]Elemento,3384,1422,53,54,107,49.5%,22m
4422,2,[TCP]TinyQingYY,3384,841,35,31,66,53.0%,29m
4422,3,莫殇痕,3384,481,20,8,28,71.4%,11m
4422,3,[净罪的殉仪]KousakaReina,3384,424,20,9,29,69.0%,41m
4422,3,[衣钵之卫]我才不是小辣鸡,3384,331,15,12,27,55.6%,11m
4422,3,[菜鸡悲]心无限大,3384,310,12,5,17,70.6%,16m
4422,1,[TPoR]fourteen,3384,230,7,10,17,41.2%,41m
4422,3,[一只捣蛋鸡]建设银行,3384,0,0,1,1,0.0%,23m
4433,2,xYXy,3383,1363,63,60,123,51.2%,15m
4433,2,瓦塔诺,3383,250,8,17,25,32.0%,22m
4433,2,三两烟火是人间丶,3383,141,3,1,4,75.0%,23m
4433,2,winner,3383,86,3,8,11,27.3%,8m
4433,3,tristana,3383,58,2,1,3,66.7%,23m
4433,3,[MIKUYY]snion,3383,58,2,2,4,50.0%,13m
4433,2,BossLing,3383,44,1,2,3,33.3%,27m
4440,3,忠犬洪七公,3382,967,147,118,265,55.5%,28m
4440,3,IIIIIIIII,3382,1339,58,53,111,52.3%,4m
4440,2,MMbloodAI,3382,1316,51,56,107,47.7%,42m
4440,3,随便玩玩,3382,818,39,13,52,75.0%,30m
4440,3,Korlar,3382,564,25,20,45,55.6%,28m
4440,3,[WZerg]XElNagA,3382,30,2,0,2,100.0%,8m
4440,3,[四叶草]点子王,3382,30,2,0,2,100.0%,17m
4440,3,彡黑夜灬传说,3382,0,1,0,1,100.0%,25m
4448,2,[贵州人]铁桥小锐哥,3381,1620,126,119,245,51.4%,44m
4448,2,soulvc,3381,1540,92,106,198,46.5%,8m
4448,3,谁在呼叫舰队,3381,876,39,23,62,62.9%,29m
4448,2,[TAPC]打不死的图图,3381,422,14,19,33,42.4%,30m
4448,2,Xyan,3381,0,5,1,6,83.3%,26m
4448,3,锋少,3381,0,0,1,1,0.0%,13m
4448,3,[爽的一比]票来荡去,3381,0,0,1,1,0.0%,30m
4448,3,[我好可爱]喜欢狐醬的四糸乃,3381,0,0,1,1,0.0%,30m
4456,3,同化完成,3380,1610,84,70,154,54.5%,3m
4456,3,[半个菜鸟II]黄注卵,3380,664,28,21,49,57.1%,43m
4456,3,辉之环,3380,254,10,5,15,66.7%,5m
4456,1,[咕咕兵器]虎千代,3380,226,5,4,9,55.6%,16m
4456,1,XiAoTd,3380,142,3,3,6,50.0%,14m
4456,3,大马哈哈鱼,3380,0,0,1,1,0.0%,26m
4456,3,小仓朝日天下第一,3380,0,0,2,2,0.0%,5m
4463,2,泰隆,3379,627,34,29,63,54.0%,26m
4463,3,KeyBoardMan,3379,336,12,13,25,48.0%,13m
4463,1,Lawrence,3379,209,9,4,13,69.2%,3m
4463,3,阿斯兰,3379,217,9,9,18,50.0%,13m
4463,2,hduesdhue,3379,161,7,5,12,58.3%,27m
4463,3,[兔兔之家]OOOOOO,3379,30,2,0,2,100.0%,40m
4463,3,阿西吧,3379,0,1,5,6,16.7%,13m
4470,3,出飞龙司马,3378,1405,80,62,142,56.3%,11m
4470,3,[sssb]匿名用户,3378,444,17,14,31,54.8%,45m
4470,2,firelove,3378,226,8,17,25,32.0%,26m
4470,3,[F2兄弟]星咏者,3378,58,3,2,5,60.0%,14m
4470,3,stargazer,3378,0,0,1,1,0.0%,7m
4470,3,STATE,3378,0,0,1,1,0.0%,29m
4476,3,[Rhusky]银月歌者,3377,1414,179,163,342,52.3%,17m
4476,2,[衣钵之卫]sadd,3377,697,61,48,109,56.0%,3m
4476,3,小蜗,3377,972,55,55,110,50.0%,9m
4476,3,[七彩斑斓]相声大师丘吉尔,3377,900,36,29,65,55.4%,14m
4476,3,[HK丶S]KhanLing,3377,363,24,5,29,82.8%,16m
4476,3,谐星鬼王,3377,426,15,15,30,50.0%,13m
4476,3,[五月花]贞德,3377,0,3,2,5,60.0%,22m
4476,3,[Etd]SeNTea,3377,0,1,0,1,100.0%,11m
4476,3,[Ttree]今晚打老虎,3377,0,1,2,3,33.3%,41m
4476,3,[C43833]disable,3377,0,0,1,1,0.0%,22m
4486,3,comeX,3376,676,51,50,101,50.5%,30m
4486,3,QINGQING,3376,641,25,20,45,55.6%,30m
4486,3,刚断奶的,3376,537,24,13,37,64.9%,12m
4486,3,Keith,3376,214,7,10,17,41.2%,15m
4486,3,Danlvpin,3376,114,5,1,6,83.3%,2m
4486,3,[大陆谐会]西北孙一峰,3376,116,5,5,10,50.0%,17m
4486,3,[KirIn0]Typical,3376,88,4,2,6,66.7%,27m
4486,3,摇光,3376,58,3,2,5,60.0%,40m
4486,3,ZanyToP,3376,30,1,3,4,25.0%,9m
4495,2,rainghost,3375,1463,238,224,462,51.5%,26m
4495,3,空山新雨后,3375,395,76,57,133,57.1%,25m
4495,3,IIIIIIIIIIII,3375,1291,54,46,100,54.0%,14m
4495,3,liumapp,3375,1292,53,40,93,57.0%,22m
4495,3,郁闷些,3375,350,13,13,26,50.0%,24m
4495,2,[NT]Kiril,3375,178,7,3,10,70.0%,23m
4495,3,[holyhp]小鸡裤裤,3375,86,4,5,9,44.4%,40m
4495,3,wxcc,3375,58,2,1,3,66.7%,9m
4495,3,[NTUSL]pppccc,3375,0,0,1,1,0.0%,13m
4495,3,战火之源,3375,0,0,2,2,0.0%,39m
4505,1,IIIIIIIIIIII,3374,1084,102,129,231,44.2%,20m
4505,2,汪弈如,3374,1596,88,80,168,52.4%,15m
4505,2,[Sc13]大岩石,3374,890,65,70,135,48.1%,26m
4505,3,llllllllllll,3374,312,12,8,20,60.0%,15m
4505,3,[星舟环宇]GameKiller,3374,99,7,5,12,58.3%,45m
4505,3,[洁白之巅]BATTLRENET,3374,0,1,0,1,100.0%,13m
4505,3,运气不太好,3374,0,0,1,1,0.0%,30m
4512,2,Bigboy,3373,666,24,31,55,43.6%,20m
4512,3,[极坐标]练回去了,3373,428,18,9,27,66.7%,40m
4512,2,urusai,3373,494,16,28,44,36.4%,13m
4512,3,[GZ柒班]苍龙可弑,3373,276,12,8,20,60.0%,24m
4512,3,[WinWin]hellforever,3373,86,4,4,8,50.0%,5m
4512,3,[逐火之蛾]一方通行,3373,30,2,0,2,100.0%,12m
4512,3,IIIIIIIIII,3373,58,2,4,6,33.3%,43m
4519,3,不死鸟,3372,1614,297,284,581,51.1%,21m
4519,2,错过花开,3372,199,9,3,12,75.0%,17m
4519,2,[BGD]BLove,3372,166,9,13,22,40.9%,8m
4519,3,神武,3372,114,5,7,12,41.7%,43m
4519,3,Twistzz,3372,86,4,2,6,66.7%,16m
4519,3,chosen,3372,90,3,3,6,50.0%,2m
4519,3,IIIIIIIIIIII,3372,0,1,0,1,100.0%,27m
4519,3,[柠檬与橙]Hinanawi,3372,30,1,1,2,50.0%,44m
4519,3,[NS]被遗忘者,3372,30,1,6,7,14.3%,9m
4519,3,[黑丝同盟会]巧克力与香子兰,3372,0,0,1,1,0.0%,44m
4529,2,顾影自怜,3371,1521,93,91,184,50.5%,12m
4529,3,[海石三叉戟]asd,3371,1071,58,45,103,56.3%,23m
4529,2,[ToHo]诸葛小亮,3371,339,20,22,42,47.6%,6m
4529,3,[DDOS不凡]hog,3371,144,9,6,15,60.0%,15m
4529,3,twoooooooo,3371,114,4,3,7,57.1%,43m
4529,3,kym,3371,86,3,4,7,42.9%,43m
4529,3,九条都,3371,30,2,1,3,66.7%,27m
4529,3,[天地會总舵]只有神知道的世界,3371,30,2,4,6,33.3%,5m
4537,3,资深男酮,3370,1625,175,163,338,51.8%,5m
4537,3,[魔王的人生]llllllllllll,3370,1350,80,70,150,53.3%,23m
4537,2,[Solo]赵宗祥老师,3370,687,38,45,83,45.8%,19m
4537,3,[40hour]Schumann,3370,801,34,27,61,55.7%,10m
4537,2,[刺蛇互助天团]Artia,3370,627,22,26,48,45.8%,5m
4537,3,[西野七瀬]Coluboccoro,3370,272,9,7,16,56.2%,13m
4537,2,狗逼死全家,3370,208,7,13,20,35.0%,28m
4537,3,CriticalHit,3370,97,5,1,6,83.3%,21m
4537,3,你吃火锅底料,3370,0,2,4,6,33.3%,14m
4537,3,五十块钱好兄弟,3370,30,1,2,3,33.3%,8m
4537,2,[Solo]ScpMcDonalds,3370,0,0,1,1,0.0%,28m
4537,3,[迷路的小狗]Magetron,3370,0,0,1,1,0.0%,29m
4537,3,[六芒星s]漠切丶,3370,0,0,2,2,0.0%,11m
4537,2,月夜茶会,3370,0,0,16,16,0.0%,10m
4551,3,llllllllllll,3369,1341,65,33,98,66.3%,16m
4551,3,[不主动不拒绝]跟你就是走流程,3369,986,39,33,72,54.2%,15m
4551,3,overmind,3369,871,38,29,67,56.7%,12m
4551,2,[TeamET]BIGblackcat,3369,434,29,42,71,40.8%,30m
4551,3,[勇往直前]滴水穿石,3369,248,20,19,39,51.3%,4m
4551,2,swift,3369,503,19,21,40,47.5%,26m
4551,3,poi,3369,414,16,10,26,61.5%,27m
4551,3,IIIIIIIIIIII,3369,278,10,8,18,55.6%,40m
4551,3,Armed,3369,142,6,6,12,50.0%,19m
4551,1,[羊驼驼]英雄王子,3369,198,6,9,15,40.0%,4m
4551,3,[薄暮之光]吓哭拉斯之剑,3369,58,3,1,4,75.0%,2m
4551,3,[高素质]XYling,3369,62,3,3,6,50.0%,17m
4551,3,[学习使我快乐]Rhha,3369,0,0,1,1,0.0%,21m
4564,3,Sahra,3368,662,28,16,44,63.6%,4m
4564,3,yanyan,3368,312,12,14,26,46.2%,43m
4564,3,DRGgo,3368,170,4,8,12,33.3%,18m
4564,3,冷调,3368,30,1,2,3,33.3%,16m
4564,3,Ping,3368,0,0,1,1,0.0%,5m
4569,2,[天天打电脑]IIIIIIIIIIII,3367,1532,214,224,438,48.9%,2m
4569,2,妖怪,3367,1411,208,199,407,51.1%,44m
4569,3,[正反甩死你]Apple,3367,299,14,9,23,60.9%,43m
4569,1,[排骨]巴卟肉肉,3367,94,3,5,8,37.5%,23m
4569,3,[SK]圣光小熊,3367,0,1,0,1,100.0%,40m
4569,3,[凯哥集团]打不过就用接化发,3367,0,1,9,10,10.0%,17m
4569,3,[STCG]samuel,3367,0,0,1,1,0.0%,22m
4569,3,IIIIIIII,3367,0,0,4,4,0.0%,30m
4577,2,张璐是个好姐姐,3366,1507,93,86,179,52.0%,41m
4577,2,贝吉塔,3366,444,15,22,37,40.5%,44m
4577,3,[SoyE]SoyEee,3366,203,11,5,16,68.8%,8m
4577,2,[舔茶神]比那名居天子,3366,224,8,14,22,36.4%,7m
4577,3,本地人,3366,0,1,2,3,33.3%,20m
4577,3,Akatsuki,3366,0,0,1,1,0.0%,13m
4577,3,[嘤遍全球]Ekoi,3366,0,0,1,1,0.0%,22m
4584,3,[四叶草]无敌的橄榄虫,3365,220,9,3,12,75.0%,27m
4584,3,IIIIIIIIII,3365,252,9,8,17,52.9%,26m
4584,3,维罗妮卡,3365,154,6,5,11,54.5%,24m
4584,3,[TCP]TeacherT,3365,148,6,9,15,40.0%,16m
4584,2,[譏颰]Ice,3365,124,6,10,16,37.5%,2m
4584,3,楼下的黑本,3365,94,4,6,10,40.0%,45m
4584,3,[抽爷]sYisme,3365,60,2,3,5,40.0%,16m
4584,3,[死亡收割]SweetCandy,3365,0,0,1,1,0.0%,15m
4584,3,asd,3365,0,0,1,1,0.0%,12m
4584,3,听党指挥能打胜仗,3365,0,0,1,1,0.0%,16m
4584,2,[征服之海]克哈人柱力,3365,0,0,6,6,0.0%,9m
4595,2,柚子苦瓜茶,3364,1573,146,160,306,47.7%,29m
4595,3,DaoFengTD,3364,1206,51,36,87,58.6%,40m
4595,2,方背洞貂猫,3364,537,44,53,97,45.4%,26m
4595,3,RageOfAngles,3364,150,7,5,12,58.3%,16m
4595,3,Cloudychang,3364,162,6,9,15,40.0%,6m
4595,3,[Sc神奇宝贝]闪光卡比兽,3364,30,2,0,2,100.0%,15m
4595,3,Lampard,3364,60,2,3,5,40.0%,40m
4595,3,樱空桃,3364,0,1,0,1,100.0%,11m
4595,3,[UOL]Rocky,3364,0,0,1,1,0.0%,41m
4595,3,[sc谐盟]information,3364,0,0,1,1,0.0%,9m
4595,3,鸡饲料,3364,0,0,1,1,0.0%,22m
4606,3,[查尔之矛]IIIIIIIIIIII,3363,686,28,32,60,46.7%,11m
4606,3,[Guard]kingdom,3363,280,11,6,17,64.7%,9m
4606,3,辞尘,3363,282,11,9,20,55.0%,25m
4606,3,开锁你得找我,3363,86,4,1,5,80.0%,2m
4606,3,[布星]这布盒里,3363,0,1,0,1,100.0%,9m
4606,3,飞奔的小裤衩,3363,0,1,0,1,100.0%,16m
4606,3,弱鸡,3363,0,0,2,2,0.0%,19m
4613,3,[Can]Samtair,3362,476,18,13,31,58.1%,24m
4613,2,IIIIIIIIIIII,3362,209,10,18,28,35.7%,5m
4613,3,[毒雨]蓝色空间号,3362,0,5,0,5,100.0%,24m
4613,3,[9999PG]yuiyuiyui,3362,0,1,0,1,100.0%,14m
4613,3,Reddington,3362,30,1,1,2,50.0%,12m
4613,3,[埃蒙保护局]大地,3362,0,0,1,1,0.0%,25m
4619,3,[二逼大联盟]逝柒,3361,1220,47,48,95,49.5%,5m
4619,3,[GYB]我爱玩英雄联盟,3361,300,16,17,33,48.5%,12m
4619,3,菜鸡一个,3361,146,6,6,12,50.0%,4m
4619,3,[miku守护]御神夜,3361,58,2,3,5,40.0%,44m
4619,1,小菜鸡,3361,0,1,0,1,100.0%,16m
4619,3,冷枫,3361,0,1,0,1,100.0%,4m
4619,3,[神圣]呆头部落,3361,30,1,4,5,20.0%,28m
4626,2,llllllllllll,3360,1529,59,61,120,49.2%,21m
4626,2,[FDS47]双刃,3360,740,28,32,60,46.7%,44m
4626,2,[TPoA]我永远喜欢伊莉雅,3360,565,26,26,52,50.0%,8m
4626,3,IIIIIIIIIIII,3360,638,25,19,44,56.8%,25m
4626,3,[孙一峰小迷妹]不敢晚上上厕所,3360,256,9,7,16,56.2%,12m
4626,3,[最菜]拆迁队队长,3360,137,3,5,8,37.5%,2m
4626,3,翱玥七星,3360,0,1,0,1,100.0%,3m
4626,2,养生星际老年人族,3360,0,0,5,5,0.0%,44m
4626,2,大和骑脸专业户,3360,0,0,8,8,0.0%,26m
4635,2,火星司令官,3359,1548,251,238,489,51.3%,7m
4635,3,[ToHo]lona,3359,576,36,28,64,56.2%,29m
4635,2,黑色特伦萨,3359,268,34,25,59,57.6%,21m
4635,2,吃素的乖了,3359,398,13,18,31,41.9%,11m
4635,3,慕容小沫,3359,192,5,6,11,45.5%,2m
4635,2,[阿塔尼斯]星际喵,3359,40,2,2,4,50.0%,41m
4635,3,痴傻发愣,3359,0,1,0,1,100.0%,28m
4635,3,雪风,3359,30,1,3,4,25.0%,4m
4643,3,[起名字真难]鬓白红颜殁,3358,1582,202,199,401,50.4%,26m
4643,2,Snofus,3358,1539,143,140,283,50.5%,22m
4643,2,[NS]孤身一人进女厕,3358,772,27,38,65,41.5%,44m
4643,3,[四叶草]FedSqrJames,3358,86,3,2,5,60.0%,27m
4643,3,[有趣]abukuma,3358,0,0,1,1,0.0%,28m
4648,2,[YZ]火耀,3357,1579,79,78,157,50.3%,7m
4648,3,XXXXXXX,3357,706,29,21,50,58.0%,25m
4648,3,无上光荣,3357,606,21,24,45,46.7%,19m
4648,3,[超级霸道]黑夜寒流,3357,290,17,8,25,68.0%,10m
4648,2,[铁血判官]interment,3357,245,7,8,15,46.7%,20m
4648,3,[RONIN]GrapE,3357,120,4,8,12,33.3%,12m
4648,3,是啊红吖,3357,62,3,3,6,50.0%,8m
4648,3,[TOP3]IIIIiiiiIIII,3357,0,0,1,1,0.0%,39m
4648,3,llllllllllll,3357,0,0,1,1,0.0%,4m
4657,3,llllllll,3356,1590,754,730,1484,50.8%,12m
4657,2,[第999舰队]风暴,3356,1515,316,305,621,50.9%,29m
4657,3,DaNn,3356,308,34,22,56,60.7%,4m
4657,3,小菜鸡,3356,369,17,15,32,53.1%,10m
4657,3,寶兒茜茜,3356,170,16,11,27,59.3%,11m
4657,3,Pentium,3356,254,9,8,17,52.9%,27m
4657,3,[镇魂]白客,3356,110,6,5,11,54.5%,16m
4657,3,筱寒,3356,166,6,5,11,54.5%,13m
4657,3,[Goodg]AmityQi,3356,97,5,1,6,83.3%,16m
4666,3,Mat,3355,1625,220,199,419,52.5%,24m
4666,2,thead,3355,657,23,39,62,37.1%,20m
4666,3,[秋毫第七分队]snow,3355,60,2,2,4,50.0%,15m
4666,1,zzm,3355,139,2,3,5,40.0%,8m
4670,2,aloop,3354,1416,51,58,109,46.8%,3m
4670,3,[ASSTt]IIIIIIIII,3354,482,19,16,35,54.3%,4m
4670,2,RichadoX,3354,356,18,19,37,48.6%,44m
4670,3,Mimoriuchi,3354,399,16,9,25,64.0%,27m
4670,3,[Hydra0]AraGakkiYui,3354,294,12,5,17,70.6%,24m
4670,3,[女仆之心]CharAznable,3354,114,5,1,6,83.3%,11m
4670,2,[星际老徐坤]IIIIIIIII,3354,94,3,12,15,20.0%,41m
4670,3,纳瑞亚之星,3354,30,1,1,2,50.0%,14m
4670,3,XiuXiang,3354,0,1,1,2,50.0%,43m
4670,3,医学苑丶帆,3354,30,1,4,5,20.0%,25m
4680,2,Aoip,3353,1550,239,235,474,50.4%,26m
4680,2,jxboby,3353,1012,60,59,119,50.4%,15m
4680,3,[交出萝莉]虐猪达人,3353,429,43,31,74,58.1%,39m
4680,2,Ghost,3353,678,27,30,57,47.4%,5m
4680,3,llllllllllll,3353,635,26,13,39,66.7%,6m
4680,3,省油的灯,3353,418,17,9,26,65.4%,8m
4680,3,[尤摩扬禁卫军]不开矿怎么爆兵,3353,220,9,4,13,69.2%,11m
4680,2,Kuroi,3353,114,6,2,8,75.0%,30m
4680,3,[SCAP]IIIIIIIIIIII,3353,152,6,10,16,37.5%,16m
4680,3,首届花式撸管冠军,3353,140,5,3,8,62.5%,11m
4680,2,[嘶哈]全部杀掉,3353,102,3,4,7,42.9%,30m
4680,3,德雷克,3353,30,2,0,2,100.0%,43m
4680,3,[NPUED]stellaris,3353,30,2,1,3,66.7%,5m
4680,3,[谐星联盟]菜头,3353,58,2,2,4,50.0%,22m
4680,3,[无敌之师]二十克纯吊丝,3353,60,2,4,6,33.3%,28m
4680,3,Relic,3353,0,1,0,1,100.0%,2m
4680,3,[Wade]Wade,3353,0,0,1,1,0.0%,43m
4680,3,[二哈叼爱萌]针不错,3353,0,0,1,1,0.0%,23m
4698,3,[HoASD]天上白玉京,3352,1569,68,62,130,52.3%,25m
4698,3,茄光体,3352,755,34,24,58,58.6%,11m
4698,2,[NVKR]虫族肄业生,3352,196,5,11,16,31.2%,28m
4698,3,kid,3352,30,2,0,2,100.0%,23m
4698,3,[扬州市高校]Mayght,3352,30,2,1,3,66.7%,40m
4698,3,曾小贤,3352,60,2,2,4,50.0%,9m
4698,3,sycshc,3352,0,1,1,2,50.0%,11m
4698,2,[我们是无敌的]frostmourne,3352,30,1,10,11,9.1%,26m
4706,1,llllllllllll,3351,1620,762,765,1527,49.9%,41m
4706,2,HenryLan,3351,1656,213,214,427,49.9%,29m
4706,2,Darkrabbit,3351,1433,75,68,143,52.4%,29m
4706,3,clkirito,3351,608,30,9,39,76.9%,7m
4706,3,[小鸡屠宰场9]远期,3351,239,8,4,12,66.7%,6m
4706,3,[迷失的三途川]四季映姬,3351,0,1,0,1,100.0%,42m
4706,3,[幻想神社]nocow,3351,0,1,0,1,100.0%,7m
4706,3,[InsS]陆离,3351,0,0,1,1,0.0%,25m
4714,3,[传说萌俍团]沧海空,3350,1601,129,128,257,50.2%,41m
4714,3,豆子杀手,3350,1606,111,101,212,52.4%,28m
4714,3,bbc,3350,1461,91,74,165,55.2%,13m
4714,3,[女装]AlphaGG,3350,1569,70,57,127,55.1%,22m
4714,2,搓澡兽,3350,734,28,31,59,47.5%,15m
4714,3,zergovermind,3350,535,19,22,41,46.3%,14m
4714,2,牛子哥的地堡,3350,218,12,14,26,46.2%,30m
4714,3,[七彩斑斓]森大人木乃乃,3350,176,6,7,13,46.2%,5m
4714,3,CamClay,3350,114,5,3,8,62.5%,8m
4714,3,[334小分队]苍蓝野兽,3350,114,4,1,5,80.0%,26m
4714,3,[泰伦反谐联盟]世上最贱的坑货,3350,0,1,0,1,100.0%,13m
4714,3,[团不胜独]澄镜,3350,0,1,0,1,100.0%,20m
4726,2,宋兵甲,3349,1540,348,319,667,52.2%,8m
4726,3,[weilku]我妻雷姆,3349,970,86,74,160,53.8%,9m
4726,3,[TNLtr]英梨梨,3349,945,79,55,134,59.0%,30m
4726,3,[李少会怎么做]fiveoneone,3349,1105,48,35,83,57.8%,40m
4726,3,阿虚,3349,554,24,12,36,66.7%,43m
4726,3,[最菜战队]terranplayer,3349,146,6,7,13,46.2%,23m
4726,3,[埋绝一生推]想想你的妈妈,3349,0,1,0,1,100.0%,45m
4733,2,克哈之子,3348,1643,192,190,382,50.3%,5m
4733,3,桃花弄影,3348,1582,83,66,149,55.7%,23m
4733,3,[XXHZ31]lelouch,3348,958,70,61,131,53.4%,9m
4733,3,star,3348,356,17,20,37,45.9%,8m
4733,3,[XYFANS]Lovely,3348,321,16,9,25,64.0%,2m
4733,3,[KSARet]LIFEISHARD,3348,152,6,17,23,26.1%,24m
4733,3,Kill,3348,0,1,1,2,50.0%,40m
4740,3,lllllll,3347,850,36,28,64,56.2%,29m
4740,3,避一世,3347,96,5,1,6,83.3%,20m
4740,3,就这破游戏瞎玩呗,3347,165,5,2,7,71.4%,8m
4740,3,laobim,3347,118,5,4,9,55.6%,17m
4740,1,香港人,3347,172,5,13,18,27.8%,15m
4740,3,[薄暮之光]lvyaqiao,3347,120,4,5,9,44.4%,27m
4740,2,养生星际,3347,58,2,9,11,18.2%,29m
4740,3,[Chloe]Kotori,3347,0,0,1,1,0.0%,12m
4748,2,黄金冲击,3346,1344,103,106,209,49.3%,29m
4748,3,MVP,3346,443,22,11,33,66.7%,3m
4748,3,[SoloAs]冰枫,3346,425,22,23,45,48.9%,30m
4748,3,可能比你强点,3346,330,15,10,25,60.0%,18m
4748,3,XingLH,3346,172,7,7,14,50.0%,21m
4748,3,慧英,3346,196,6,5,11,54.5%,17m
4748,3,IGMacSed,3346,0,0,1,1,0.0%,41m
4748,3,[XJTU]风檐展书读,3346,0,0,2,2,0.0%,28m
4748,3,[真正萌新]星宫六喰,3346,0,0,2,2,0.0%,4m
4757,2,[Beasty]SupermAn,3345,1597,576,530,1106,52.1%,28m
4757,2,MEC,3345,839,140,129,269,52.0%,26m
4757,3,[YH]jacky,3345,1631,125,110,235,53.2%,16m
4757,2,[闪击战]五十块的好兄弟,3345,1288,88,86,174,50.6%,15m
4757,3,小韩韩六六六,3345,634,22,27,49,44.9%,43m
4757,3,[祖安小分队]PHOENIX,3345,80,3,1,4,75.0%,28m
4757,3,[LDP]Twins,3345,0,0,1,1,0.0%,22m
4757,3,冬马和纱,3345,0,0,2,2,0.0%,5m
4757,3,[TMUSC2]Empress,3345,0,0,2,2,0.0%,41m
4757,3,Ian,3345,0,0,4,4,0.0%,25m
4767,3,[响当当水友]PartinG,3344,1620,115,82,197,58.4%,11m
4767,3,SECRETING,3344,526,51,43,94,54.3%,13m
4767,2,[SCAP]蚍蜉渡海,3344,1063,49,43,92,53.3%,30m
4767,2,[SdDdG]LEE,3344,462,27,36,63,42.9%,41m
4767,3,[天梯引路人]醪糟睡觉,3344,266,10,11,21,47.6%,17m
4767,3,timba,3344,88,3,3,6,50.0%,30m
4767,2,[火焰雷獸]bel,3344,94,2,1,3,66.7%,40m
4767,3,[Rhusky]只玩机械化,3344,0,1,0,1,100.0%,15m
4767,3,快乐小菜鸡,3344,0,0,1,1,0.0%,40m
4776,3,[Mikon]仈月,3343,1600,149,142,291,51.2%,3m
4776,3,das,3343,1336,51,49,100,51.0%,11m
4776,3,[纨绔才子]好想赢一盘,3343,626,29,9,38,76.3%,23m
4776,2,[O栋444]四川康王龙,3343,550,27,36,63,42.9%,12m
4776,2,TIMBA,3343,436,15,18,33,45.5%,26m
4776,1,柚子,3343,247,9,7,16,56.2%,4m
4776,3,[C51792]神丁阿拉灯,3343,246,8,11,19,42.1%,25m
4776,3,dayibo,3343,30,2,5,7,28.6%,11m
4776,3,Bass,3343,0,1,0,1,100.0%,24m
4776,3,[Thpj]潜水舰伊四零一,3343,0,1,0,1,100.0%,30m
4776,3,[柠檬保护协会]SnowStorm,3343,0,1,0,1,100.0%,8m
4787,1,IIIIIIIIIIII,3342,1110,110,133,243,45.3%,27m
4787,3,渣御坂,3342,996,82,79,161,50.9%,14m
4787,3,[丨SLT丨]堕魔旋风,3342,190,8,5,13,61.5%,40m
4787,3,LUCC,3342,222,8,11,19,42.1%,40m
4787,2,HyDralIsK,3342,146,5,16,21,23.8%,41m
4787,1,雷霸天下,3342,0,2,1,3,66.7%,1h
4787,3,星际丶争爸,3342,30,2,3,5,40.0%,13m
4787,3,[XYFANS]Strawberry,3342,0,1,0,1,100.0%,24m
4787,3,PlumpBean,3342,0,1,0,1,100.0%,5m
4787,3,[DMRc]SUN,3342,30,1,2,3,33.3%,27m
4787,3,明宇不会打星际,3342,0,0,1,1,0.0%,43m
4787,3,VIEN,3342,0,0,1,1,0.0%,43m
4799,2,Chrono,3341,1534,253,261,514,49.2%,26m
4799,2,benben,3341,1562,133,135,268,49.6%,9m
4799,3,[就是坑爹]SCPLAYER,3341,1273,95,86,181,52.5%,8m
4799,3,[小金上天队]IIIIIIIIIII,3341,614,22,20,42,52.4%,22m
4799,3,秋名山,3341,323,15,9,24,62.5%,18m
4799,3,[AZW]战无双,3341,41,3,1,4,75.0%,9m
4799,2,[老油条战队4]占卜阿里巴巴,3341,93,2,1,3,66.7%,19m
4799,3,Today,3341,30,1,2,3,33.3%,45m
4799,3,MagejiTarren,3341,0,0,1,1,0.0%,29m
4808,3,qlights,3340,1049,46,34,80,57.5%,26m
4808,3,[妖馆]教练我要学星际,3340,1054,42,34,76,55.3%,24m
4808,3,[上海大学]明明,3340,568,22,24,46,47.8%,13m
4808,3,[开航母]拦截机装配师,3340,188,10,5,15,66.7%,3m
4808,3,[Echoes]凉宫春日的消失,3340,252,9,5,14,64.3%,24m
4808,2,人族城市规划者,3340,240,9,16,25,36.0%,5m
4808,3,条码仁,3340,30,2,3,5,40.0%,17m
4815,2,skrskr,3339,1535,351,349,700,50.1%,17m
4815,2,神族我是你爹,3339,1128,236,227,463,51.0%,15m
4815,2,grezmuc,3339,784,29,37,66,43.9%,17m
4815,3,红红火火,3339,97,6,0,6,100.0%,14m
4815,3,BLASSRE,3339,97,2,0,2,100.0%,4m
4815,2,[暴雪三十队]豆丁,3339,111,2,1,3,66.7%,20m
4815,3,[纸壳]誓死效忠埃蒙,3339,30,2,5,7,28.6%,15m
4815,3,[雇佣]战争狂人,3339,0,0,3,3,0.0%,40m
4823,3,不打内战,3338,1668,138,140,278,49.6%,40m
4823,3,IIIIIIIIIIII,3338,1014,47,49,96,49.0%,40m
4823,2,Luiz,3338,338,12,18,30,40.0%,6m
4823,2,[TCP]Pureyellow,3338,274,9,14,23,39.1%,22m
4823,3,CenturiesBoy,3338,97,2,0,2,100.0%,10m
4823,3,Soul,3338,30,2,4,6,33.3%,26m
4823,3,Magjsk,3338,30,1,2,3,33.3%,30m
4823,2,[FET]BossL,3338,0,0,1,1,0.0%,4m
4823,3,IIIIIIIIIIII,3338,0,0,1,1,0.0%,27m
4823,3,阿卡四十七,3338,0,0,1,1,0.0%,26m
4823,2,[Etd猫队]数到三我就哭,3338,0,0,2,2,0.0%,20m
4834,3,李信衡,3337,1594,71,61,132,53.8%,11m
4834,2,[人人有功炼]愤怒的土豆,3337,1318,56,60,116,48.3%,3m
4834,2,金色铁憨憨,3337,686,28,32,60,46.7%,43m
4834,3,SherryOK,3337,354,14,11,25,56.0%,13m
4834,3,iweiko,3337,313,11,5,16,68.8%,42m
4834,3,[青娱乐]中野三玖,3337,86,4,0,4,100.0%,4m
4834,3,[幻月云阁]DIZzdeaY,3337,114,4,1,5,80.0%,29m
4834,3,[鬼谷]半分死人,3337,0,1,0,1,100.0%,30m
4834,3,赤樱,3337,0,0,1,1,0.0%,41m
4834,3,twilightzone,3337,0,0,2,2,0.0%,15m
4844,3,[广龙日天]IMRealTaeja,3336,1100,118,115,233,50.6%,16m
4844,2,[武德教学学校]猪肉不肥只是受,3336,770,95,86,181,52.5%,17m
4844,3,玉宇九霄,3336,538,94,76,170,55.3%,20m
4844,3,雪走,3336,148,11,13,24,45.8%,11m
4844,3,JACKEY,3336,190,8,4,12,66.7%,41m
4844,3,[Sc养老]星辉翼冷,3336,200,7,6,13,53.8%,44m
4844,2,羟基氢原子,3336,90,5,7,12,41.7%,9m
4844,3,llllllllll,3336,86,3,2,5,60.0%,25m
4844,1,[一花一世界]乱世辽夜,3336,0,1,0,1,100.0%,10m
4853,2,[地雷军团]秦川,3335,600,128,120,248,51.6%,26m
4853,3,[北京城管]炮哥,3335,1495,66,59,125,52.8%,12m
4853,3,银杏树,3335,741,32,28,60,53.3%,45m
4853,3,聖光出鞘,3335,452,20,12,32,62.5%,25m
4853,1,[怀念曾经温柔]WADU,3335,200,5,3,8,62.5%,40m
4853,3,Crazyrain,3335,88,4,4,8,50.0%,23m
4853,3,[FPT]LOgan,3335,62,3,6,9,33.3%,5m
4853,3,[追随自由指引]Birth,3335,30,2,1,3,66.7%,14m
4853,3,glbhf,3335,0,1,0,1,100.0%,30m
4853,3,逮虾户警告,3335,0,1,2,3,33.3%,2m
4853,3,[C63014]干丝黄毒奶,3335,30,1,4,5,20.0%,20m
4853,3,李老八丶,3335,0,0,1,1,0.0%,26m
4853,3,百度强力推荐,3335,0,0,1,1,0.0%,40m
4866,2,[野怪也是虫]Rival,3334,1274,87,73,160,54.4%,4m
4866,2,[学生妹]Skywalker,3334,750,49,58,107,45.8%,9m
4866,3,[剑与玫瑰]空中漫步,3334,564,20,21,41,48.8%,23m
4866,3,PrinsY,3334,226,8,5,13,61.5%,11m
4866,3,遇见预见,3334,140,5,1,6,83.3%,9m
4866,3,[隐藏文件夹]扶桑文化,3334,30,2,0,2,100.0%,13m
4866,3,[Melt病毒]必死无疑九条喵,3334,30,1,3,4,25.0%,27m
4866,3,[点到为止]我们是害虫,3334,30,1,7,8,12.5%,40m
4866,3,[ZTM]纸袋,3334,0,0,1,1,0.0%,26m
4875,2,[12306]ourpairs,3333,1471,170,175,345,49.3%,44m
4875,2,[KPG]GreatDevil,3333,830,117,106,223,52.5%,41m
4875,2,你若微笑便是晴天,3333,718,37,33,70,52.9%,16m
4875,3,狗头人,3333,416,20,9,29,69.0%,42m
4875,2,王哥,3333,180,9,4,13,69.2%,7m
4875,3,yufish,3333,0,4,1,5,80.0%,29m
4875,3,ZasgAk,3333,116,4,3,7,57.1%,19m
4875,3,[SiW]KniFe,3333,30,2,2,4,50.0%,5m
4875,3,dogjk,3333,0,1,0,1,100.0%,3m
4884,3,IIIIIIIIIIII,3332,1568,88,80,168,52.4%,6m
4884,3,[DARPA]MarineQueen,3332,823,48,36,84,57.1%,29m
4884,3,[prgirl]Miku,3332,300,11,11,22,50.0%,5m
4884,3,[白玉楼庭师]水上浸透,3332,0,0,1,1,0.0%,30m
4888,2,最终兵器,3331,1255,55,61,116,47.4%,7m
4888,3,三笠,3331,819,44,35,79,55.7%,15m
4888,3,MKMK,3331,650,25,19,44,56.8%,5m
4888,3,璃羽归无念,3331,354,16,7,23,69.6%,6m
4888,3,[中年]Uncle,3331,192,7,7,14,50.0%,29m
4888,3,[镜花水月]一之天梦梦梦,3331,174,6,6,12,50.0%,13m
4888,3,Michael,3331,0,4,2,6,66.7%,40m
4888,3,[七咕咕]我不给你咕咕咕,3331,146,4,3,7,57.1%,16m
4888,3,[情谊至上]终不似丿少年游,3331,58,3,4,7,42.9%,40m
4888,2,[丨哔哩哔哩丨]James,3331,62,3,9,12,25.0%,44m
4888,3,[星云际会]时光蓑湿,3331,0,0,1,1,0.0%,2m
4888,3,见朕不跪者杀,3331,0,0,1,1,0.0%,24m
4900,2,jsevenr,3330,677,121,118,239,50.6%,15m
4900,3,[钻石守门员]chen,3330,1011,40,30,70,57.1%,21m
4900,3,IIIIIIIIIIII,3330,866,38,23,61,62.3%,25m
4900,3,小黑,3330,699,31,16,47,66.0%,45m
4900,3,阿汤,3330,60,2,5,7,28.6%,17m
4900,3,羽落凡尘,3330,0,1,0,1,100.0%,5m
4906,3,Sun,3329,1232,115,99,214,53.7%,17m
4906,2,[开始掠夺]黑珍珠号的小弟,3329,984,92,86,178,51.7%,5m
4906,3,柴可夫的浪漫,3329,750,32,22,54,59.3%,11m
4906,3,DDTABA,3329,161,7,2,9,77.8%,45m
4906,3,[TPoR]樱京,3329,184,7,8,15,46.7%,15m
4906,3,星际游侠,3329,111,6,2,8,75.0%,10m
4906,3,臭豆腐集团总裁,3329,30,5,1,6,83.3%,17m
4906,3,我真無聊啊,3329,44,5,4,9,55.6%,11m
4906,3,[文韬武略]小户,3329,88,4,5,9,44.4%,43m
4906,3,[莫扎特]茜茜公主,3329,0,1,0,1,100.0%,11m
4906,3,[Shawk]亵渎黄泉,3329,0,1,0,1,100.0%,13m
4906,3,[星际同萌]和平还是核平,3329,0,0,1,1,0.0%,41m
4918,2,[菜鸟队]Taddy,3328,1342,48,56,104,46.2%,11m
4918,2,[Period]Tarzan,3328,716,25,33,58,43.1%,41m
4918,3,[内蒙星际联盟]冥帝,3328,592,24,23,47,51.1%,14m
4918,3,灰太狼,3328,662,24,27,51,47.1%,44m
4918,3,[永安]糖水鹿,3328,458,20,12,32,62.5%,22m
4918,3,沉默等待崛起死亡,3328,214,9,2,11,81.8%,11m
4918,3,IIIIIIIIIIII,3328,0,0,1,1,0.0%,28m
4925,1,[D7]小黄兔,3327,1333,364,365,729,49.9%,18m
4925,2,[HustSC]TkmkOrange,3327,1470,184,177,361,51.0%,15m
4925,3,为了艾尔,3327,777,129,92,221,58.4%,43m
4925,3,冬冬枣,3327,1097,106,94,200,53.0%,8m
4925,3,[五月花]宫内莲华,3327,1065,66,2,68,97.1%,19m
4925,2,Gloash,3327,628,55,68,123,44.7%,28m
4925,3,[人族不配赢]五秒,3327,30,2,0,2,100.0%,25m
4932,3,[Forwar]陈冠希,3326,1665,96,84,180,53.3%,43m
4932,3,[TLKH]Evergrande,3326,1599,75,49,124,60.5%,30m
4932,3,一波带你走,3326,630,28,20,48,58.3%,14m
4932,3,Jzzzzzzzzz,3326,490,22,20,42,52.4%,9m
4932,3,[TCP]黎明卿,3326,175,5,3,8,62.5%,16m
4932,3,[TFL]FLcurly,3326,94,3,6,9,33.3%,7m
4932,3,[DARPA]Excalibur,3326,97,2,0,2,100.0%,23m
4932,3,[一等星]诺娃,3326,0,0,1,1,0.0%,11m
4932,3,天难理容,3326,0,0,4,4,0.0%,6m
4941,2,koko,3325,1623,483,471,954,50.6%,4m
4941,3,waurtys,3325,535,32,28,60,53.3%,11m
4941,3,歌舞伎町,3325,242,21,11,32,65.6%,14m
4941,3,[谁在呼叫舰队]十次血字,3325,344,13,12,25,52.0%,41m
4941,3,ClouD,3325,288,10,16,26,38.5%,16m
4941,3,Jackwea,3325,60,2,3,5,40.0%,13m
4941,3,[老婆喊就退]spring,3325,58,2,4,6,33.3%,29m
4941,3,Hohenheim,3325,0,0,1,1,0.0%,21m
4941,3,[光光6]闪光亚丝娜,3325,0,0,1,1,0.0%,16m
4950,3,[七咕咕]历史的见证者,3324,434,110,86,196,56.1%,30m
4950,3,[i5]第五永乐,3324,1144,59,51,110,53.6%,41m
4950,3,[最菜战队]毒奶色粉丝,3324,60,3,2,5,60.0%,26m
4950,3,Ckira,3324,86,3,3,6,50.0%,3m
4950,3,[秋毫第七分队]就是喜欢浪,3324,120,2,4,6,33.3%,21m
4950,2,DarlinG,3324,30,1,9,10,10.0%,29m
4950,3,[膜法世家]Mojito,3324,0,0,1,1,0.0%,8m
4957,2,[Shawk]打不过就是不够多,3323,1435,75,72,147,51.0%,45m
4957,3,[南京工业大学]chenhu,3323,625,56,37,93,60.2%,30m
4957,3,小号,3323,923,41,28,69,59.4%,15m
4957,3,llllllllllll,3323,441,15,22,37,40.5%,14m
4957,1,Layton,3323,248,9,6,15,60.0%,26m
4957,3,小心渣男,3323,58,3,0,3,100.0%,11m
4957,3,[LGT]少侠好武功,3323,58,3,2,5,60.0%,17m
4957,3,[水师提督]水师提督,3323,0,1,0,1,100.0%,23m
4957,3,[我很不愉快]抗压勇士,3323,0,1,0,1,100.0%,26m
4957,3,[CNboi]线影,3323,0,1,0,1,100.0%,2m
4957,3,[我怎么这么菜]少年满地捡肥皂,3323,0,1,0,1,100.0%,14m
4957,3,[媳妇一喊就G]太空小丑,3323,30,1,1,2,50.0%,21m
4957,3,[游戏大厅玩家]游戏大厅娱乐玩家,3323,30,1,2,3,33.3%,15m
4970,3,IIIIIIIIIIII,3322,1390,96,79,175,54.9%,28m
4970,3,player,3322,1148,93,66,159,58.5%,26m
4970,3,REPULSER,3322,1078,38,44,82,46.3%,22m
4970,3,llllllllllll,3322,682,26,22,48,54.2%,43m
4970,2,SoLven,3322,552,21,25,46,45.7%,22m
4970,2,蓝月纯银,3322,547,20,22,42,47.6%,17m
4970,3,IIIIIIIII,3322,174,7,4,11,63.6%,13m
4970,3,[Csquad]天狼星,3322,30,1,1,2,50.0%,5m
4970,3,[Pimbaa]嘤嘤孙一峰你坏坏,3322,0,0,1,1,0.0%,17m
4970,3,雨落狂流之暗,3322,0,0,1,1,0.0%,28m
4980,2,[傻爆无敌]傻爆追猎,3321,1425,270,267,537,50.3%,26m
4980,3,[透一下清酒]萌王利姆鲁,3321,1625,229,185,414,55.3%,30m
4980,2,[CHN共青团]菊部有史特,3321,893,107,109,216,49.5%,5m
4980,3,苏艺瑶,3321,1045,103,69,172,59.9%,42m
4980,3,Edward,3321,919,40,31,71,56.3%,30m
4980,3,[瘾大眼瞎]艾尔暗影卫队,3321,141,4,0,4,100.0%,44m
4980,1,决战之长河落日,3321,0,0,1,1,0.0%,20m
4987,3,不打内战,3320,874,98,88,186,52.7%,26m
4987,3,[AreS神会]愤怒的探机,3320,765,79,60,139,56.8%,19m
4987,3,yosang,3320,905,69,62,131,52.7%,16m
4987,3,[浪啊浪]忘记你需要多久,3320,862,35,31,66,53.0%,11m
4987,3,backbone,3320,646,24,25,49,49.0%,30m
4987,3,夏弥,3320,207,20,16,36,55.6%,44m
4987,2,Casper,3320,420,13,29,42,31.0%,23m
4987,2,兰登,3320,346,11,24,35,31.4%,15m
4987,3,ghr,3320,157,9,11,20,45.0%,43m
4987,3,Moon,3320,176,7,6,13,53.8%,28m
4987,2,[神圣]赶猫骑猫的猫,3320,108,3,1,4,75.0%,6m
4987,3,[chise]Alchemy,3320,0,0,1,1,0.0%,12m
4987,3,[萌谐]伊利丹怒风,3320,0,0,1,1,0.0%,13m
5000,2,[NtS特工队]LOUISWANG,3319,1618,465,454,919,50.6%,15m
5000,3,Agoni,3319,1612,96,98,194,49.5%,11m
5000,2,[星际CXK]Atom,3319,341,14,22,36,38.9%,22m
5000,1,IIIIIIIIIIII,3319,96,5,1,6,83.3%,1h
5000,3,[亚投行]iiiiiiiiiiii,3319,64,5,3,8,62.5%,8m
5000,3,[TS嘉年华]eagletlee,3319,154,5,11,16,31.2%,43m
5000,3,艾尔青锋所向无前,3319,60,3,3,6,50.0%,26m
5000,3,railgun,3319,0,0,1,1,0.0%,11m
5008,3,[GSC]itaeyeon,3318,953,321,293,614,52.3%,13m
5008,2,[绝望星灵]freeshark,3318,1580,133,138,271,49.1%,15m
5008,2,[miku守护]Sunflower,3318,619,55,54,109,50.5%,41m
5008,3,[星际把妹王]我永远单推鲨鲨,3318,445,37,27,64,57.8%,40m
5008,3,[子旭FANS]Gradually,3318,297,32,32,64,50.0%,3m
5008,3,[偷稳谐莽狗]Tassadar,3318,161,5,3,8,62.5%,28m
5008,3,[输一把就睡觉]Ghostmonster,3318,142,5,6,11,45.5%,43m
5008,3,[红萌馆]西江月,3318,0,1,0,1,100.0%,8m
5008,3,[缪丨葵]雾雨魔理沙,3318,97,1,1,2,50.0%,43m
5008,3,[RDFZsc]tonculax,3318,0,1,4,5,20.0%,44m
5008,3,从终结的世界开始,3318,0,0,3,3,0.0%,30m
5008,3,高锰酸钾,3318,0,0,5,5,0.0%,43m
5020,3,SCxiaose,3317,1478,129,115,244,52.9%,6m
5020,3,[直男的爱]虎崽子,3317,1433,76,67,143,53.1%,28m
5020,2,[SoloAs]youngwizard,3317,648,41,41,82,50.0%,7m
5020,3,[YH]jsbyyz,3317,733,31,19,50,62.0%,16m
5020,1,老年人跟不上节奏,3317,229,11,6,17,64.7%,40m
5020,2,[Szb]宙斯盾矩阵战影,3317,265,8,13,21,38.1%,41m
5020,3,kirito,3317,0,5,2,7,71.4%,11m
5020,2,[CPT]嘤彡喵班长,3317,122,5,11,16,31.2%,42m
5028,1,[黑粉头子]全身心爱上我,3316,0,4,1,5,80.0%,1h
5028,3,Kratos,3316,58,3,0,3,100.0%,5m
5028,1,[公事公办]人生当苦无妨,3316,118,3,4,7,42.9%,14m
5028,3,你说你听不懂,3316,60,2,4,6,33.3%,13m
5028,3,[QWQa]你爹临死前丶,3316,0,0,1,1,0.0%,15m
5033,2,leonwiki,3315,1170,133,131,264,50.4%,44m
5033,3,SAN,3315,1351,82,78,160,51.2%,29m
5033,3,scfreu,3315,460,74,78,152,48.7%,41m
5033,3,[丨SLT丨]菜多大馍王,3315,342,12,14,26,46.2%,27m
5033,1,黄旭东财产继承人,3315,235,8,6,14,57.1%,14m
5033,3,逼格之链第一人,3315,153,8,7,15,53.3%,41m
5033,3,[背着预言家的]千愁,3315,119,4,2,6,66.7%,25m
5033,3,虫子嘻嘻嘻,3315,0,1,0,1,100.0%,12m
5041,3,醉后不知天在水,3314,1185,81,61,142,57.0%,26m
5041,3,[阿特兹]将你溺死在厕所,3314,988,43,31,74,58.1%,41m
5041,3,祖国花骨朵,3314,426,16,16,32,50.0%,9m
5041,3,吉安娜,3314,322,11,14,25,44.0%,8m
5041,3,ClarkXK,3314,178,7,9,16,43.8%,29m
5041,1,[Hs浪]单机狂魔,3314,111,3,1,4,75.0%,41m
5041,3,[萌萌哒鸡]楠对,3314,58,2,3,5,40.0%,18m
5041,3,[RyH]RyhBoneKyo,3314,0,1,0,1,100.0%,16m
5041,3,[审判日号]Plastic,3314,0,1,0,1,100.0%,42m
5050,3,从心彗随,3313,168,6,7,13,46.2%,30m
5050,2,[OIO]蚂菲亚,3313,182,5,4,9,55.6%,22m
5050,3,[湖北郧阳中学]方方的无齿蚌,3313,0,1,2,3,33.3%,25m
5050,1,[AF]战神,3313,0,1,3,4,25.0%,15m
5054,2,ToT,3312,1269,284,275,559,50.8%,41m
5054,3,[绝世佳人]Yamato,3312,1615,244,236,480,50.8%,28m
5054,3,曌世天下,3312,965,104,97,201,51.7%,15m
5054,2,IIIIIIIIIIII,3312,501,26,30,56,46.4%,7m
5054,3,AlphaGG,3312,417,21,21,42,50.0%,23m
5054,3,安达垣爱姬,3312,327,11,12,23,47.8%,3m
5054,3,iGMacSed,3312,244,10,4,14,71.4%,11m
5054,3,[2233娘]李世民多久大量工,3312,254,10,6,16,62.5%,26m
5054,3,[re0]紫苑,3312,0,4,2,6,66.7%,11m
5054,3,xJmc,3312,96,2,0,2,100.0%,28m
5054,3,Kiki,3312,30,1,2,3,33.3%,18m
5054,3,飞天神包,3312,0,0,1,1,0.0%,12m
5054,3,Cortana,3312,0,0,1,1,0.0%,14m
5067,2,[混元星际門]Listid,3311,971,94,75,169,55.6%,7m
5067,3,[黎明航向]破碎的祈愿,3311,851,58,57,115,50.4%,8m
5067,3,llllllllllll,3311,278,11,4,15,73.3%,40m
5067,1,FEIGE,3311,267,10,7,17,58.8%,16m
5067,3,Shinmyoumaru,3311,62,3,3,6,50.0%,45m
5067,3,[董魔王制霸军]泰伦之拳,3311,0,1,0,1,100.0%,40m
5067,1,[Dish]oOdxqOo,3311,0,1,0,1,100.0%,25m
5067,3,[菜鸟何苦为难]间客,3311,30,1,3,4,25.0%,19m
5067,1,SeRral,3311,0,0,1,1,0.0%,43m
5067,3,[忆峥嵘]萍水相逢,3311,0,0,3,3,0.0%,12m
5067,3,[星际传销组织]征服者一先驱,3311,0,0,6,6,0.0%,25m
5078,1,萌呆综合症,3310,1609,262,266,528,49.6%,28m
5078,3,[宠爱]給力,3310,1590,257,236,493,52.1%,28m
5078,3,[msyx]冥圣,3310,585,42,28,70,60.0%,5m
5078,2,疯了的大牛,3310,974,36,44,80,45.0%,22m
5078,3,[瘾大眼瞎]打游戏我只选神族,3310,336,13,8,21,61.9%,16m
5078,3,[谐星联盟]街亭上将马谡,3310,293,10,2,12,83.3%,30m
5078,3,[我们是无敌的]大连孙一峰,3310,200,7,6,13,53.8%,27m
5078,3,[i5]大头,3310,52,4,9,13,30.8%,41m
5078,3,[莽夫智障团]小威,3310,86,3,2,5,60.0%,18m
5078,3,七七,3310,60,2,2,4,50.0%,6m
5078,3,[撒比克高手]Martin,3310,0,1,0,1,100.0%,20m
5078,3,KOF,3310,0,1,0,1,100.0%,26m
5078,3,JessicaJung,3310,0,0,1,1,0.0%,16m
5091,3,Hoppsat,3309,1469,134,132,266,50.4%,20m
5091,3,[威严满满DZ]蕾米莉亚,3309,1410,118,93,211,55.9%,3m
5091,3,[神武骑士团]打奥特曼的小怪兽,3309,1037,61,52,113,54.0%,13m
5091,3,[teamJI]maybetttt,3309,858,32,35,67,47.8%,22m
5091,3,[Canton]莫作栋,3309,142,5,7,12,41.7%,15m
5091,3,多线起飞,3309,114,4,2,6,66.7%,11m
5091,3,[CPT]BearVigny,3309,30,2,0,2,100.0%,7m
5091,1,[游击士]银闪,3309,0,1,0,1,100.0%,25m
5091,3,[退休总统]DonaldTrumP,3309,30,1,2,3,33.3%,15m
5091,3,[WCL不咕了]Bankeye,3309,0,0,1,1,0.0%,44m
5091,2,心急沉默者,3309,0,0,3,3,0.0%,19m
5102,2,[致敬蒙斯克]请冷静,3308,1404,75,92,167,44.9%,28m
5102,3,llllllllllll,3308,914,47,15,62,75.8%,27m
5102,2,gqh,3308,1092,37,56,93,39.8%,5m
5102,3,[动漫迷]游龙,3308,148,6,4,10,60.0%,23m
5102,3,[futa]我是轩,3308,30,1,3,4,25.0%,7m
5102,3,balu,3308,0,0,1,1,0.0%,30m
5102,3,[是我赢了]奔雷手,3308,0,0,1,1,0.0%,40m
5102,3,[TG1]万年龙神号,3308,0,0,4,4,0.0%,4m
5110,2,自由之神,3307,1037,324,318,642,50.5%,28m
5110,2,myytjrx,3307,1394,92,85,177,52.0%,23m
5110,3,雪碧兑红牛,3307,445,55,40,95,57.9%,16m
5110,3,古德里安,3307,542,47,38,85,55.3%,30m
5110,3,大板人,3307,436,24,14,38,63.2%,13m
5110,3,绿豆薄荷冰,3307,399,23,18,41,56.1%,8m
5110,3,[白丝黑丝萝莉]狂杀落雪,3307,296,15,9,24,62.5%,41m
5110,3,随便玩,3307,171,10,11,21,47.6%,9m
5110,3,[北极光小组]Laevatein,3307,140,6,1,7,85.7%,6m
5110,3,chance,3307,114,5,4,9,55.6%,8m
5110,3,薛丫头,3307,0,0,1,1,0.0%,11m
5110,3,[送分大佬]Again,3307,0,0,1,1,0.0%,43m
5110,3,邪王真眼是最强的,3307,0,0,1,1,0.0%,29m
5123,2,andy,3306,1575,252,249,501,50.3%,42m
5123,3,[死亡收割]MixJdcy,3306,461,19,12,31,61.3%,45m
5123,3,[zzu123]月临城,3306,379,15,5,20,75.0%,10m
5123,3,FROZEN,3306,172,6,6,12,50.0%,25m
5123,3,MaruChina,3306,86,3,7,10,30.0%,14m
5123,3,[SoIoAs]血花缭乱,3306,90,3,7,10,30.0%,11m
5123,3,呵呵你赢了,3306,30,2,2,4,50.0%,18m
5123,3,[华师大二附中]ToFlight,3306,30,2,3,5,40.0%,8m
5123,3,[无花也浪漫]按键伤人,3306,60,2,6,8,25.0%,29m
5123,3,[小埋]弑狼,3306,0,0,1,1,0.0%,3m
5123,3,[麋鹿迷路]Magic,3306,0,0,4,4,0.0%,12m
5134,3,狮子奋迅,3305,1613,154,141,295,52.2%,29m
5134,3,[蛋摩力]十里送星際,3305,278,10,7,17,58.8%,11m
5134,3,[升格第一鸡]陈猥痣,3305,262,9,9,18,50.0%,15m
5134,3,[Ginuna]Nidhoog,3305,118,5,10,15,33.3%,10m
5134,1,[蒙蔽梦游团]德国骨科,3305,0,4,1,5,80.0%,3m
5134,3,啊你吓到我了,3305,0,4,2,6,66.7%,22m
5134,3,[DMRc]钱赞起,3305,60,3,3,6,50.0%,11m
5134,3,[Tpb]Thanatos,3305,0,1,0,1,100.0%,28m
5134,3,[星际黄旭东]几何,3305,0,1,0,1,100.0%,27m
5134,3,[Killyo]陈阳,3305,96,1,2,3,33.3%,3m
5144,2,大白的小武哥哥,3304,1449,127,127,254,50.0%,44m
5144,3,快乐,3304,534,29,18,47,61.7%,30m
5144,3,[底特律KAR]无敌老剑客,3304,574,23,21,44,52.3%,7m
5144,3,[一般赢不了]七月,3304,534,20,18,38,52.6%,11m
5144,3,[底特律KAR]粒子,3304,434,16,17,33,48.5%,45m
5144,3,[美丽的风景线]climaxform,3304,370,15,7,22,68.2%,11m
5144,3,[32CM]你蛇皮大哥,3304,331,13,3,16,81.2%,7m
5144,3,阿细懒,3304,172,7,4,11,63.6%,26m
5144,3,克哈李培楠,3304,142,6,5,11,54.5%,6m
5144,1,硝基胍,3304,0,4,1,5,80.0%,40m
5144,3,烂柯人,3304,90,4,4,8,50.0%,10m
5144,3,Aquarius,3304,0,0,1,1,0.0%,26m
5156,3,[芜湖难铜]难铜贰号,3303,1567,266,238,504,52.8%,19m
5156,3,猩猩,3303,1226,233,208,441,52.8%,27m
5156,3,麦克阿色,3303,807,42,44,86,48.8%,43m
5156,2,[HHZX]十点半的人生,3303,594,29,29,58,50.0%,9m
5156,3,WolfBisu,3303,375,18,12,30,60.0%,16m
5156,3,五眼联盟,3303,254,10,10,20,50.0%,24m
5156,3,[丨SLT丨]lllllllllill,3303,144,6,2,8,75.0%,30m
5156,3,[Kiloli]鸽屿,3303,31,5,5,10,50.0%,43m
5156,3,渐逝的生命,3303,0,1,0,1,100.0%,12m
5156,3,发条柚,3303,0,0,1,1,0.0%,17m
5156,3,[我不會TVT]black,3303,0,0,2,2,0.0%,44m
5167,2,选神族就赢了,3302,1497,411,413,824,49.9%,44m
5167,3,[一般赢不了]克劳泽,3302,1310,161,157,318,50.6%,7m
5167,3,HwaSIn,3302,1242,108,97,205,52.7%,19m
5167,3,Sirius,3302,1424,54,53,107,50.5%,13m
5167,3,[初晨忆夏和风]scapple,3302,454,19,16,35,54.3%,29m
5167,3,[夙愿天下]从未冷却,3302,366,17,8,25,68.0%,21m
5167,1,中华老咸鱼,3302,263,9,3,12,75.0%,44m
5167,3,星辰之巅,3302,207,8,3,11,72.7%,21m
5167,1,[鬼谷]氯化氢公主,3302,97,4,0,4,100.0%,1h
5167,3,令令小兵,3302,30,1,1,2,50.0%,26m
5167,3,TYYTYYT,3302,97,1,1,2,50.0%,7m
5178,2,抡臂大风车,3301,1574,223,228,451,49.4%,15m
5178,3,herbalistbw,3301,1448,86,77,163,52.8%,8m
5178,3,大番薯,3301,913,50,43,93,53.8%,40m
5178,2,[六芒星s]妹儿加我,3301,340,12,5,17,70.6%,23m
5178,3,OverWhelming,3301,198,8,5,13,61.5%,43m
5178,1,二五仔三叉戟,3301,0,5,0,5,100.0%,1h
5178,3,CazzForever,3301,0,3,2,5,60.0%,15m
5178,1,[1939CN]执政官,3301,0,2,3,5,40.0%,1h
5178,3,[SCP爱你哦]强大的楪鹄,3301,0,1,0,1,100.0%,30m
5187,3,[希靈帝國]ggazy,3300,1555,165,148,313,52.7%,43m
5187,3,cijief,3300,1492,132,113,245,53.9%,40m
5187,2,[我们是无敌的]superjc,3300,1417,106,115,221,48.0%,30m
5187,2,[OA]黑白,3300,1288,54,51,105,51.4%,28m
5187,3,花某,3300,1124,47,44,91,51.6%,44m
5187,2,[智青]Asho,3300,982,34,39,73,46.6%,6m
5187,3,Totoro,3300,486,19,10,29,65.5%,27m
5187,2,[乱杀]你的农民被屠啦,3300,136,3,6,9,33.3%,17m
5187,3,[枪兵二营]blinkheart,3300,0,1,1,2,50.0%,11m
5187,3,流泪的星河,3300,30,1,1,2,50.0%,19m
5187,3,神丶讷,3300,0,1,2,3,33.3%,13m
5187,3,[不要怂就是怕]hanzaki,3300,30,1,3,4,25.0%,19m
5187,3,布尔乔亚,3300,0,0,1,1,0.0%,8m
5187,3,[半个菜鸟II]莫道离殇,3300,0,0,1,1,0.0%,5m
5201,3,Monday,3299,1468,76,57,133,57.1%,40m
5201,3,炸他个菊花烂,3299,1268,50,44,94,53.2%,11m
5201,3,[辉煌华夏]Kira,3299,198,8,4,12,66.7%,9m
5201,3,[C79636]FireLord,3299,0,1,0,1,100.0%,30m
5201,3,oiqweyeiqu,3299,0,0,1,1,0.0%,24m
5206,3,[萌新保护协议]ColdSeadling,3298,328,18,10,28,64.3%,21m
5206,3,fengye,3298,314,14,13,27,51.9%,25m
5206,3,[传说萌娘团]shiki,3298,214,8,9,17,47.1%,21m
5206,3,prayer,3298,119,6,2,8,75.0%,45m
5206,3,微佀,3298,58,3,2,5,60.0%,11m
5206,1,沙漠王子哈哈哈,3298,0,1,0,1,100.0%,15m
5206,3,[医学奇迹之花]花很讨厌,3298,0,0,1,1,0.0%,30m
5206,3,小百合,3298,0,0,1,1,0.0%,5m
5214,2,PiMba,3297,1462,378,363,741,51.0%,41m
5214,2,[FLDSCL]小魔仙,3297,1520,93,98,191,48.7%,41m
5214,2,[第八舰队丶]Kingdom,3297,612,21,31,52,40.4%,26m
5214,2,Legacy,3297,474,18,19,37,48.6%,44m
5214,3,丿杨哲,3297,0,0,1,1,0.0%,23m
5219,2,[Rhusky]markjimken,3296,1584,172,165,337,51.0%,41m
5219,3,jumping,3296,1352,120,117,237,50.6%,45m
5219,3,[103军区]Crystalore,3296,478,18,16,34,52.9%,23m
5219,3,这分段还有条码人,3296,162,9,4,13,69.2%,10m
5219,3,[HxEro]帕瓦,3296,109,5,2,7,71.4%,8m
5219,3,[我们是无敌的]优格索托斯,3296,41,3,2,5,60.0%,8m
5219,3,[Igirls]Summer,3296,143,3,5,8,37.5%,4m
5219,1,[为了菲女王]滚动的虫苔,3296,0,2,1,3,66.7%,1h
5219,1,CNight,3296,0,2,3,5,40.0%,43m
5219,3,[泰伦娱乐会所]修伯利安,3296,0,1,0,1,100.0%,41m
5219,3,高阶圣堂武士,3296,0,0,1,1,0.0%,19m
5219,3,薄荷味雪碧,3296,0,0,1,1,0.0%,45m
5219,3,[KPG]帝林,3296,0,0,1,1,0.0%,6m
5219,3,肥猫就是正义,3296,0,0,1,1,0.0%,40m
5233,2,[YBY]你们无敌的老师,3295,1262,77,98,175,44.0%,7m
5233,3,[招商银行西安]亮哥带你飞,3295,580,29,17,46,63.0%,28m
5233,3,IPs,3295,325,17,7,24,70.8%,14m
5233,3,[IMRTS]Nikebulls,3295,60,2,8,10,20.0%,9m
5233,3,[潸然丶那些年]Pimba,3295,0,1,0,1,100.0%,7m
5233,3,Lizuko,3295,0,1,0,1,100.0%,26m
5233,3,[抚子号]御统百合香,3295,30,1,1,2,50.0%,6m
5233,3,舞文弄墨,3295,18,1,2,3,33.3%,18m
5233,3,[丨SLT丨]榜白白,3295,30,1,5,6,16.7%,19m
5233,3,[物探]舒逸,3295,0,0,1,1,0.0%,15m
5243,2,llllllllll,3294,1172,225,207,432,52.1%,9m
5243,3,[SoloAs]一束七教我玩神族,3294,1543,103,87,190,54.2%,26m
5243,3,[M8]又菜又爱玩,3294,306,11,14,25,44.0%,13m
5243,3,Yamazaki,3294,229,8,10,18,44.4%,13m
5243,1,AlchemistGL,3294,96,4,2,6,66.7%,35m
5243,3,魂牵梦萦之黑,3294,0,0,1,1,0.0%,12m
5249,3,[只会666]萌新不会玩,3293,1535,97,78,175,55.4%,40m
5249,2,paperpanda,3293,935,32,40,72,44.4%,26m
5249,3,我是来偷菜的,3293,411,18,7,25,72.0%,23m
5249,3,sycshc,3293,250,9,5,14,64.3%,20m
5249,3,[GGES]REIKSGUARD,3293,216,8,3,11,72.7%,41m
5249,3,[s金色玫瑰s]Sesd,3293,233,7,5,12,58.3%,19m
5249,3,[Marry]桑梓宁静,3293,199,6,5,11,54.5%,22m
5249,3,[混吃混喝]AAAAAAAAAAAA,3293,0,1,0,1,100.0%,41m
5249,3,[星际小盆友]TJY,3293,30,1,2,3,33.3%,13m
5249,3,MXH,3293,0,0,1,1,0.0%,20m
5249,3,[SlRIUS]InterPhase,3293,0,0,3,3,0.0%,43m
5260,2,纯为娱乐,3292,1071,205,200,405,50.6%,7m
5260,3,[KPG]llllllllll,3292,1509,164,147,311,52.7%,12m
5260,3,[青铜联盟]MLS,3292,738,76,77,153,49.7%,8m
5260,2,枪兵推销员,3292,1011,73,74,147,49.7%,9m
5260,3,[萌新ovo]SolitaryMan,3292,229,14,12,26,53.8%,45m
5260,3,[雾切响子]月光下的蒲公英,3292,366,12,19,31,38.7%,26m
5260,3,谐星,3292,300,11,10,21,52.4%,11m
5260,3,[NS]JACKSLOWFK,3292,176,6,9,15,40.0%,29m
5260,1,蓝迪克列,3292,0,4,1,5,80.0%,33m
5260,3,micC,3292,58,3,0,3,100.0%,16m
5260,3,[星域神界]apple,3292,40,1,3,4,25.0%,24m
5260,3,[BadM]franklo,3292,0,1,4,5,20.0%,16m
5272,2,jiachengbb,3291,1284,175,180,355,49.3%,2m
5272,3,[VKR]唯心难却,3291,1559,135,121,256,52.7%,17m
5272,2,Leifo,3291,1461,110,120,230,47.8%,22m
5272,3,圣剑宙斯,3291,862,36,27,63,57.1%,8m
5272,3,魔法少女黄旭东,3291,691,33,25,58,56.9%,11m
5272,3,[菜的没人带]goodthink,3291,778,29,28,57,50.9%,25m
5272,3,[最菜战队]蒙古上单,3291,363,15,12,27,55.6%,10m
5272,2,深巷的少女与猫,3291,234,10,5,15,66.7%,23m
5272,3,[听雨轩]CrazyEd,3291,172,7,6,13,53.8%,41m
5272,3,QuadStacker,3291,178,6,11,17,35.3%,28m
5272,1,金爷的契哥,3291,0,4,1,5,80.0%,53m
5272,3,[虞城星际]Walkers,3291,44,4,3,7,57.1%,45m
5272,3,axi,3291,30,2,2,4,50.0%,6m
5272,3,IIIIIIIIIIII,3291,30,2,2,4,50.0%,41m
5272,3,[CNU星际]ARES,3291,30,1,4,5,20.0%,16m
5272,3,史上可能最强人类,3291,0,0,2,2,0.0%,28m
5288,3,脾英霸,3290,786,31,28,59,52.5%,22m
5288,3,[4everY]deadfisheye,3290,323,15,8,23,65.2%,13m
5288,3,妈妈说不要放弃,3290,324,11,17,28,39.3%,7m
5288,3,不当舔狗,3290,140,6,2,8,75.0%,24m
5288,3,[教我玩神族]AbsoluteZero,3290,120,5,3,8,62.5%,11m
5288,1,[SFTRA3]BritishBall,3290,160,4,3,7,57.1%,40m
5288,1,WES,3290,0,3,2,5,60.0%,29m
5288,2,IIIIIIIIIII,3290,42,2,2,4,50.0%,5m
5288,3,Pur,3290,0,1,2,3,33.3%,19m
5288,3,[NOTD余波]Mrpotato,3290,0,0,1,1,0.0%,26m
5288,3,[17好人]whg,3290,0,0,1,1,0.0%,26m
5288,3,[scttt]德玛西亚,3290,0,0,2,2,0.0%,24m
5300,3,芙兰朵露斯卡蕾特,3289,1635,182,139,321,56.7%,13m
5300,3,bluewind,3289,1205,73,74,147,49.7%,41m
5300,3,[星际马保国]黄旭东的儿子,3289,724,31,20,51,60.8%,21m
5300,3,第二适格者明日香,3289,586,26,13,39,66.7%,12m
5300,3,这游戏要火,3289,411,17,11,28,60.7%,15m
5300,3,[Fear]通往天堂,3289,400,14,21,35,40.0%,12m
5300,2,[Beasty]禅虫,3289,209,10,13,23,43.5%,20m
5300,3,[HPT]Bakyun,3289,196,7,7,14,50.0%,43m
5300,3,长期被爆虐,3289,88,3,7,10,30.0%,4m
5300,3,stmsmg,3289,30,2,0,2,100.0%,29m
5300,3,[PKU]无为而治,3289,0,1,0,1,100.0%,21m
5300,3,pipipill,3289,30,1,5,6,16.7%,30m
5300,2,落雪无声,3289,0,0,1,1,0.0%,12m
5300,3,子安文人,3289,0,0,1,1,0.0%,26m
5300,3,献上菊花,3289,0,0,1,1,0.0%,43m
5300,3,[浪啊浪]苞米地里的黑寡妇,3289,0,0,3,3,0.0%,17m
5316,2,[孙岱玹]大头最厉害,3288,1224,266,220,486,54.7%,10m
5316,3,[菜有菜的道理]JzyParadise,3288,1418,130,106,236,55.1%,40m
5316,2,持枪证,3288,960,43,47,90,47.8%,13m
5316,3,iNmuSen,3288,651,32,30,62,51.6%,43m
5316,3,[北境]Vincent,3288,506,17,22,39,43.6%,23m
5316,2,超高校级的萝莉控,3288,308,12,5,17,70.6%,4m
5316,3,银爵,3288,118,6,2,8,75.0%,16m
5316,3,Pipers,3288,0,1,0,1,100.0%,44m
5316,3,[qpMqp]EasyCN,3288,30,1,3,4,25.0%,9m
5316,2,Hallelujah,3288,0,0,1,1,0.0%,15m
5326,2,三日月,3287,1504,161,181,342,47.1%,15m
5326,2,llllllllll,3287,368,86,76,162,53.1%,45m
5326,3,落星劫,3287,826,59,56,115,51.3%,24m
5326,3,[少年星际梦]Freddy,3287,642,49,44,93,52.7%,10m
5326,3,PeanuTJL,3287,550,25,15,40,62.5%,14m
5326,3,ooxx,3287,586,25,16,41,61.0%,40m
5326,3,[这就是天t]Tocqueville,3287,454,18,15,33,54.5%,26m
5326,3,IIIIIIIIIII,3287,391,15,4,19,78.9%,6m
5326,3,llllllllllll,3287,206,8,11,19,42.1%,2m
5326,3,独臂隆多,3287,114,5,0,5,100.0%,3m
5326,1,密麻麻,3287,0,4,1,5,80.0%,3m
5326,3,中吻,3287,30,2,1,3,66.7%,21m
5326,3,GTR,3287,30,2,2,4,50.0%,44m
5326,3,超临界,3287,0,1,0,1,100.0%,13m
5326,3,[cdgs]BarbiePrime,3287,0,0,1,1,0.0%,25m
5341,2,[交出萝莉]伽蓝空境,3286,1576,145,145,290,50.0%,30m
5341,3,黑夜,3286,1422,73,70,143,51.0%,43m
5341,2,[霸气王朝]人族领袖,3286,1328,47,57,104,45.2%,2m
5341,3,[THINK]养生星际玩家,3286,758,29,18,47,61.7%,22m
5341,2,[游戏风云OL]二次元刀酱,3286,358,26,22,48,54.2%,44m
5341,3,llllllllllll,3286,377,21,18,39,53.8%,8m
5341,3,[西伯利亚土豆]流雨,3286,321,12,12,24,50.0%,42m
5341,1,Dadin,3286,0,4,1,5,80.0%,1h
5341,3,无耻浑蛋,3286,30,2,1,3,66.7%,14m
5341,3,雾雨爱丽丝,3286,0,2,4,6,33.3%,21m
5341,3,黑水城,3286,0,1,0,1,100.0%,45m
5341,3,Blackjack,3286,0,0,1,1,0.0%,16m
5341,3,Ooplus,3286,0,0,2,2,0.0%,30m
5354,3,大脚快跑,3285,1386,420,383,803,52.3%,11m
5354,3,肉祖宗,3285,1570,349,334,683,51.1%,15m
5354,3,infily,3285,485,150,136,286,52.4%,28m
5354,3,[骨灰拌饭]中路杀神,3285,366,13,12,25,52.0%,27m
5354,3,[SoloAs]Tkak,3285,300,11,10,21,52.4%,6m
5354,3,[你可識得此陣]遲暮的丞相丶,3285,168,7,8,15,46.7%,13m
5354,3,小宇宙还没爆发,3285,166,6,4,10,60.0%,22m
5354,1,saladin,3285,0,4,1,5,80.0%,11m
5354,3,白给,3285,85,2,2,4,50.0%,45m
5354,3,[伊莉雅老婆]光明与信仰,3285,0,0,1,1,0.0%,28m
5354,3,[弱萌小队]AllureLove,3285,0,0,1,1,0.0%,26m
5365,2,向天再借五厘米,3284,500,43,40,83,51.8%,13m
5365,3,bjtuJYa,3284,722,29,23,52,55.8%,22m
5365,3,aqa,3284,521,23,14,37,62.2%,29m
5365,3,多线爆炸,3284,520,19,21,40,47.5%,9m
5365,3,风暴之怒,3284,168,6,4,10,60.0%,13m
5365,3,[泥石流人族]王大帅,3284,60,2,4,6,33.3%,23m
5365,3,[虐杀琉森]离丶殇,3284,0,1,0,1,100.0%,7m
5365,3,[无畏201]温酒斩华雄,3284,0,1,1,2,50.0%,42m
5365,3,顾念,3284,32,1,2,3,33.3%,45m
5365,3,WAWpredict,3284,0,0,1,1,0.0%,42m
5375,2,[RyH]CrazyMe,3283,1532,219,204,423,51.8%,45m
5375,3,[Canton]跨丿宇宙飞雪,3283,1536,174,159,333,52.3%,27m
5375,3,[新手保护协会]余生阿迎,3283,854,36,31,67,53.7%,24m
5375,3,[暴雪三队]小丫丫,3283,366,14,13,27,51.9%,43m
5375,3,[lxkj]咸宁鸡腿王游子建,3283,311,12,5,17,70.6%,15m
5375,3,Somebody,3283,217,12,12,24,50.0%,28m
5375,3,空虚的雪,3283,174,7,6,13,53.8%,42m
5375,1,多比和白久,3283,0,4,1,5,80.0%,18m
5375,3,YakumoRan,3283,0,1,0,1,100.0%,41m
5375,1,Style,3283,0,1,0,1,100.0%,7m
5375,3,[充气团]充气天启,3283,0,0,1,1,0.0%,28m
5386,3,快乐星际,3282,1566,283,287,570,49.6%,28m
5386,2,暴雪令人失望,3282,1510,114,109,223,51.1%,26m
5386,3,阉牛之友,3282,872,33,31,64,51.6%,12m
5386,3,ShakeJJ,3282,746,28,28,56,50.0%,43m
5386,2,馒头,3282,666,23,33,56,41.1%,6m
5386,3,IIIIIIIII,3282,140,6,4,10,60.0%,11m
5386,3,MsKleINe,3282,169,6,4,10,60.0%,22m
5386,3,llllllllllll,3282,176,6,6,12,50.0%,22m
5386,3,[温柔兔公主]走笔龙之介,3282,144,5,2,7,71.4%,19m
5386,3,[火焰雷兽]JiNoVaTion,3282,88,4,3,7,57.1%,43m
5386,3,CNigHt,3282,0,1,0,1,100.0%,24m
5386,3,[萌萌哒萌萌哒]pomie,3282,30,1,1,2,50.0%,12m
5386,3,[DARKAA]wwe,3282,30,1,6,7,14.3%,29m
5386,3,[蝉鸣护卫舰]依依爱你哦,3282,0,0,1,1,0.0%,14m
5400,2,ladaman,3281,1547,136,134,270,50.4%,41m
5400,3,[跟你好好运营]陈激动再玩一盘,3281,1339,106,104,210,50.5%,3m
5400,3,超级大大大,3281,1524,75,75,150,50.0%,26m
5400,3,[NSt1]Nyaruko,3281,617,43,41,84,51.2%,8m
5400,3,SCV,3281,971,40,40,80,50.0%,41m
5400,3,ForeverTara,3281,238,8,12,20,40.0%,20m
5400,3,安于一切,3281,167,5,5,10,50.0%,20m
5400,3,[SMY]IIIIIII,3281,140,5,10,15,33.3%,45m
5400,3,从前有只猫,3281,118,3,3,6,50.0%,25m
5400,3,李泽言,3281,30,1,4,5,20.0%,43m
5400,3,Sandwich,3281,0,0,2,2,0.0%,16m
5411,2,零海,3280,1409,111,126,237,46.8%,9m
5411,2,[大漢]Marineking,3280,1570,65,77,142,45.8%,26m
5411,3,ForT,3280,1046,51,36,87,58.6%,40m
5411,2,[小仙女上线啦]十夜弥生,3280,245,11,5,16,68.8%,6m
5411,3,[MUL]sum,3280,304,10,18,28,35.7%,5m
5411,3,[浪啊浪]ttx,3280,200,8,3,11,72.7%,8m
5411,3,[熊大和熊二]NAXX,3280,159,4,3,7,57.1%,27m
5411,3,[鬼谷]秋露止咳水,3280,30,2,0,2,100.0%,30m
5411,3,张小连,3280,30,2,5,7,28.6%,7m
5411,3,武藤游戏,3280,30,1,9,10,10.0%,40m
5411,3,[Aos菜鸡队]上弦云,3280,0,0,1,1,0.0%,8m
5411,3,彭州陈奕迅,3280,0,0,2,2,0.0%,26m
5423,2,[镜花水月]PZimba,3279,1312,213,211,424,50.2%,4m
5423,3,[TeamEK]伊红美蓝,3279,1431,100,84,184,54.3%,25m
5423,3,[暴雪二十五队]理里李,3279,1336,62,42,104,59.6%,40m
5423,3,业界良心电竞毒奶,3279,413,20,21,41,48.8%,8m
5423,3,MarineKing,3279,372,17,8,25,68.0%,9m
5423,3,[Icer]IIIIIIIIIIII,3279,113,12,18,30,40.0%,13m
5423,1,迀屍曂旮崬,3279,139,7,1,8,87.5%,29m
5423,3,金爷的契大佬,3279,120,6,3,9,66.7%,19m
5423,3,FYFYFY,3279,30,2,0,2,100.0%,41m
5423,3,李知恩,3279,0,1,0,1,100.0%,3m
5423,3,[蓬莱伝説]晨鸽迷你,3279,0,0,1,1,0.0%,26m
5434,3,IIIIIII,3278,1594,204,199,403,50.6%,25m
5434,1,[PITB]小变态,3278,140,6,2,8,75.0%,11m
5434,3,刘荣说,3278,58,3,2,5,60.0%,21m
5434,3,Excalibur,3278,16,2,6,8,25.0%,13m
5434,3,笨小孩,3278,0,0,1,1,0.0%,7m
5439,2,冒泡专家,3277,1570,122,128,250,48.8%,44m
5439,3,[我们是无敌的]懂得看才头猪,3277,1406,53,53,106,50.0%,27m
5439,3,Lewis,3277,350,12,13,25,48.0%,29m
5439,3,[虞城星际]ZesT,3277,266,10,10,20,50.0%,40m
5439,2,[XXHZ1]那只兔子,3277,210,9,5,14,64.3%,23m
5439,3,[ZLQ]kevin,3277,116,4,4,8,50.0%,40m
5439,2,[同化失败了]晴新短夏,3277,0,1,0,1,100.0%,12m
5439,2,LittleKankan,3277,0,1,0,1,100.0%,26m
5439,3,就这么爱着我的宁,3277,30,1,1,2,50.0%,3m
5439,3,Wayne,3277,0,0,1,1,0.0%,14m
5439,3,[星际鸡饲料]ESCapist,3277,0,0,3,3,0.0%,16m
5450,2,IIIIIIIIIIII,3276,1340,158,148,306,51.6%,44m
5450,3,[哔哩哔哩乾杯]无有才德,3276,1394,143,134,277,51.6%,18m
5450,3,Ddmz,3276,700,33,29,62,53.2%,29m
5450,3,COLNAGO,3276,614,24,20,44,54.5%,8m
5450,3,TNT,3276,272,10,8,18,55.6%,14m
5450,2,SilverHawk,3276,154,9,5,14,64.3%,4m
5450,3,[情义天下]暴暴龙,3276,142,5,3,8,62.5%,26m
5450,1,[悟了]哔哩哔哩丶森林猫,3276,188,5,4,9,55.6%,23m
5450,3,IMMvp,3276,141,4,1,5,80.0%,24m
5450,3,天河望舒,3276,120,4,4,8,50.0%,10m
5450,3,cynicism,3276,34,2,2,4,50.0%,45m
5450,3,孙焕家,3276,62,2,5,7,28.6%,7m
5450,3,见招拆招,3276,30,1,2,3,33.3%,30m
5463,3,德雷克塔,3275,1548,197,195,392,50.3%,16m
5463,3,Boxer,3275,1543,152,141,293,51.9%,29m
5463,3,Nting,3275,921,39,32,71,54.9%,40m
5463,3,工口小学生赛高,3275,818,33,28,61,54.1%,14m
5463,3,LoaF,3275,320,12,11,23,52.2%,19m
5463,2,纯白天使,3275,306,10,2,12,83.3%,12m
5463,2,胖胖胖胖熊,3275,216,8,26,34,23.5%,24m
5463,3,Demon,3275,0,0,1,1,0.0%,45m
5463,3,[ToHo]涛哥,3275,0,0,2,2,0.0%,21m
5472,3,[轻风候君来]清风雨,3274,369,29,7,36,80.6%,21m
5472,1,cadpig,3274,0,4,1,5,80.0%,41m
5472,1,luanyueyu,3274,0,4,1,5,80.0%,1h
5472,3,BruceWayen,3274,90,4,6,10,40.0%,8m
5472,3,波波,3274,30,2,3,5,40.0%,44m
5472,3,[文轩有大牛]晨先生,3274,0,0,1,1,0.0%,16m
5472,3,[霖fince]霖风,3274,0,0,1,1,0.0%,42m
5472,3,三千世界奈我何,3274,0,0,2,2,0.0%,27m
5480,2,[荣耀丶殿堂]六味地黄芄,3273,1446,154,142,296,52.0%,26m
5480,2,[慢手e族]IIIIIIIIIIII,3273,584,21,30,51,41.2%,4m
5480,3,虚空挥光剑,3273,146,6,4,10,60.0%,14m
5480,1,深秋浅唱丶,3273,0,4,1,5,80.0%,1h
5480,3,[吉高由里子]Yoriko,3273,76,4,3,7,57.1%,27m
5485,3,Luluuuuuuu,3272,1103,57,51,108,52.8%,21m
5485,3,Sincerely,3272,558,32,19,51,62.7%,30m
5485,3,[不知道叫什么]新年年年,3272,292,13,10,23,56.5%,42m
5485,3,[第八舰队丶]yuting,3272,316,11,15,26,42.3%,25m
5485,3,[白给兄弟]QeLin,3272,202,7,7,14,50.0%,25m
5485,3,[西伯利亚土豆]嗨到不行的跳虫,3272,164,5,2,7,71.4%,14m
5485,3,焦糖布丁,3272,58,2,1,3,66.7%,22m
5485,3,路人甲,3272,60,2,6,8,25.0%,25m
5485,3,[克哈驻防舰队]皇家卫队,3272,0,1,0,1,100.0%,9m
5485,3,[请君醉沙场]一枕华胥,3272,0,0,1,1,0.0%,41m
5485,3,王世杰,3272,0,0,3,3,0.0%,16m
5496,3,Miracle,3271,1484,149,149,298,50.0%,29m
5496,3,[STARV]胖蕃茄,3271,1472,111,112,223,49.8%,7m
5496,3,[Beastp]夜听风,3271,1464,64,51,115,55.7%,20m
5496,2,[我队伍很强大]幽灵,3271,156,5,4,9,55.6%,3m
5496,3,llllllllllll,3271,30,2,1,3,66.7%,3m
5496,3,[刀使之巫女]衛藤可奈美,3271,30,1,1,2,50.0%,26m
5496,2,[伊修加德男团]一森,3271,0,0,1,1,0.0%,10m
5503,3,TZC,3270,1136,106,103,209,50.7%,14m
5503,3,[瘾大眼瞎]衿丶,3270,842,32,27,59,54.2%,14m
5503,3,[NewSG]神座出流,3270,246,10,13,23,43.5%,25m
5503,3,xzk,3270,95,6,8,14,42.9%,11m
5503,3,打不过神族,3270,146,5,4,9,55.6%,7m
5503,3,kissu,3270,95,1,1,2,50.0%,18m
5503,3,雷神爷爷,3270,0,0,1,1,0.0%,30m
5510,3,丶呆萌汉堡,3269,1582,180,181,361,49.9%,16m
5510,3,LOVEandDREAM,3269,768,115,86,201,57.2%,43m
5510,3,希灵圣爹,3269,885,85,81,166,51.2%,29m
5510,3,[KENNEL]五秒,3269,454,17,17,34,50.0%,11m
5510,3,[逗帝]大海捞针,3269,264,9,8,17,52.9%,16m
5510,3,fluctus,3269,266,9,9,18,50.0%,40m
5510,3,[SFTRA3]Sakuragxz,3269,172,7,6,13,53.8%,9m
5510,3,Lilywhite,3269,6,2,0,2,100.0%,13m
5510,3,[天下布武]狮子莱昂,3269,30,1,1,2,50.0%,28m
5510,3,[肉鸡的饲养]落泪的梦,3269,0,1,1,2,50.0%,14m
5510,3,崩撤卖溜,3269,0,1,1,2,50.0%,31m
5510,3,故乡的原风景,3269,0,0,1,1,0.0%,13m
5510,3,xxxxxx,3269,0,0,1,1,0.0%,25m
5523,3,小蚂蚁爱上树,3268,917,69,49,118,58.5%,20m
5523,3,南传兄贵泰伦,3268,995,52,49,101,51.5%,24m
5523,3,erwerqwe,3268,1138,51,31,82,62.2%,30m
5523,3,Immortal,3268,868,35,33,68,51.5%,9m
5523,3,[魔鬼死练二队]三少,3268,653,28,19,47,59.6%,6m
5523,3,[ljk]twj,3268,366,19,6,25,76.0%,41m
5523,3,[五十块的兄弟]skythrough,3268,350,18,15,33,54.5%,8m
5523,2,圣诞节,3268,410,18,30,48,37.5%,42m
5523,3,玛雅,3268,418,16,11,27,59.3%,16m
5523,3,KKKKKKK,3268,444,15,18,33,45.5%,14m
5523,1,Pine,3268,0,4,1,5,80.0%,15m
5523,1,llllllllllll,3268,95,2,0,2,100.0%,25m
5523,3,AOS,3268,0,0,1,1,0.0%,30m
5536,3,mify,3267,1449,78,66,144,54.2%,3m
5536,3,接受正义的制裁吧,3267,1016,57,39,96,59.4%,12m
5536,2,Rikka,3267,642,34,35,69,49.3%,45m
5536,3,御剑仙,3267,264,10,12,22,45.5%,11m
5536,3,Henrypower,3267,122,5,9,14,35.7%,42m
5536,3,[合肥工大]工大玩家请联系我,3267,101,4,4,8,50.0%,24m
5536,3,[CHRIS]克里斯的小反应,3267,98,3,1,4,75.0%,44m
5536,1,[福影双生]金鱼丶金鱼,3267,0,3,1,4,75.0%,41m
5536,3,南辰北,3267,58,2,4,6,33.3%,45m
5536,3,llllllllllll,3267,58,2,5,7,28.6%,23m
5536,3,[Fe3o4]世界,3267,0,1,2,3,33.3%,25m
5536,1,银色子弹,3267,0,0,1,1,0.0%,29m
5548,2,硅酸盐,3266,1521,260,257,517,50.3%,10m
5548,2,银河,3266,1541,123,119,242,50.8%,29m
5548,2,missju,3266,757,65,68,133,48.9%,9m
5548,3,Casinos,3266,568,28,18,46,60.9%,6m
5548,3,梦醒,3266,679,28,21,49,57.1%,30m
5548,3,[zmsdmm]微澜之间,3266,529,23,19,42,54.8%,3m
5548,3,[80后丶]嘟嘟牛,3266,337,12,12,24,50.0%,22m
5548,3,树杈,3266,152,6,5,11,54.5%,25m
5548,3,[星歌]命运,3266,114,5,1,6,83.3%,17m
5548,3,叫兽,3266,114,4,2,6,66.7%,11m
5548,3,漫步,3266,86,4,3,7,57.1%,3m
5548,3,苹果树上的梨花,3266,60,3,5,8,37.5%,13m
5548,3,[小鸡屠宰场9]海底捞炒大司马,3266,60,3,5,8,37.5%,29m
5548,3,[HUC妖皇]SKTMsJoy,3266,0,1,0,1,100.0%,13m
5548,1,别碰爷的小熊,3266,0,1,0,1,100.0%,30m
5548,3,狗人者人恒狗之,3266,0,1,0,1,100.0%,23m
5548,3,此地乃为虎牢关,3266,0,1,1,2,50.0%,18m
5548,3,[至翼二中]AliveLotus,3266,0,0,1,1,0.0%,25m
5566,3,glsuv,3265,1466,70,62,132,53.0%,26m
5566,3,satiety,3265,1259,54,35,89,60.7%,10m
5566,3,[钉宫病]vampirelian,3265,1232,49,47,96,51.0%,25m
5566,3,Omega,3265,870,39,33,72,54.2%,44m
5566,3,[TPoA]影子零号,3265,520,21,9,30,70.0%,11m
5566,3,[谐逼]温江孙一峰,3265,242,9,7,16,56.2%,43m
5566,3,露米娅,3265,0,1,0,1,100.0%,43m
5566,1,[NTUSL]忍者叉烧龟,3265,0,1,0,1,100.0%,32m
5566,3,MouiepopuL,3265,0,0,3,3,0.0%,12m
5575,3,IIIIIIIIIIII,3264,1448,98,97,195,50.3%,14m
5575,3,[我们是无敌的]维纳斯的回忆,3264,1064,51,45,96,53.1%,43m
5575,3,[血港魅影]糖心,3264,417,17,15,32,53.1%,9m
5575,3,千草仙,3264,468,17,20,37,45.9%,11m
5575,3,佛哭了丶说,3264,167,7,3,10,70.0%,22m
5575,3,llllllllllll,3264,0,1,0,1,100.0%,43m
5575,1,[高达seed]kiralacus,3264,0,0,1,1,0.0%,42m
5575,3,[上海人型]大师之路,3264,0,0,1,1,0.0%,8m
5575,3,南泽泉理,3264,0,0,3,3,0.0%,16m
5584,1,那就叫折吧,3263,127,13,7,20,65.0%,30m
5584,3,[暴雪养鸡场]zero,3263,266,9,9,18,50.0%,43m
5584,3,云淡风轻,3263,132,4,1,5,80.0%,17m
5584,3,[NWP]Lavender,3263,86,3,1,4,75.0%,5m
5584,3,[大连理工]小李培楠,3263,88,3,4,7,42.9%,40m
5584,3,生鱼片,3263,58,2,4,6,33.3%,18m
5584,3,Reald,3263,30,2,6,8,25.0%,14m
5584,3,Shadow,3263,0,1,0,1,100.0%,19m
5584,3,水中客,3263,0,0,1,1,0.0%,20m
5593,3,[请先打我隊友]伽玛射线,3262,1486,371,360,731,50.8%,11m
5593,2,[文韬武略]Helium,3262,1549,356,351,707,50.4%,22m
5593,3,[LFY]辉耀,3262,1433,149,134,283,52.7%,26m
5593,2,[查尔高阶枪兵]星辰,3262,1489,119,127,246,48.4%,28m
5593,2,IIIIIIIIII,3262,726,112,101,213,52.6%,26m
5593,3,[TCP]HiddenKnife,3262,1237,65,63,128,50.8%,29m
5593,2,静墨,3262,764,53,55,108,49.1%,17m
5593,3,[DMRc]浅梦丿漓,3262,602,24,17,41,58.5%,40m
5593,3,[埃及众神]Raysh,3262,168,6,2,8,75.0%,28m
5593,3,[LHZ]叶知恩的莓籽儿,3262,119,5,2,7,71.4%,29m
5593,3,噶姐半糖去冰,3262,118,5,3,8,62.5%,21m
5593,2,baoweislu,3262,0,4,1,5,80.0%,1h
5593,3,[虚拟歌手团体]洛天依,3262,30,2,1,3,66.7%,29m
5593,2,[IMRTS2]国家一级演员,3262,93,2,3,5,40.0%,10m
5593,3,KIR,3262,62,2,6,8,25.0%,25m
5593,3,[喵内噶]dsqqk,3262,0,1,0,1,100.0%,18m
5593,3,FreeDom,3262,0,1,0,1,100.0%,22m
5593,3,llllllllllll,3262,0,1,1,2,50.0%,23m
5593,3,Dark,3262,30,1,4,5,20.0%,29m
5593,3,[封茗囧菌]冰夏菌,3262,30,1,6,7,14.3%,14m
5593,3,[拉比安罗斯]别杀我农民,3262,0,0,1,1,0.0%,30m
5593,3,[法兰街舞队w]Arthas,3262,0,0,2,2,0.0%,10m
5615,2,IIIIIIIIII,3261,1532,240,225,465,51.6%,44m
5615,2,[Titans]BabySOSorry,3261,1459,70,82,152,46.1%,19m
5615,3,[Banner]Oldpipe,3261,685,30,15,45,66.7%,10m
5615,3,[噶姐美如花]hydra,3261,580,27,26,53,50.9%,42m
5615,3,[NtS特工队]武仙马保国,3261,548,23,22,45,51.1%,6m
5615,3,大威天龙,3261,253,19,21,40,47.5%,41m
5615,3,[奶飞天]Ted,3261,455,18,20,38,47.4%,18m
5615,3,llllllllll,3261,330,13,4,17,76.5%,11m
5615,3,[最菜神王]lonestar,3261,229,7,6,13,53.8%,40m
5615,3,[SHNU]Fantasy,3261,30,1,1,2,50.0%,25m
5615,3,机械化死全家,3261,30,1,2,3,33.3%,17m
5615,3,[XXHZN2]羽时俱竞,3261,30,1,3,4,25.0%,8m
5627,3,[KPG2]小群群,3260,1344,183,172,355,51.5%,26m
5627,3,[青铜树]飞龙,3260,1403,102,100,202,50.5%,24m
5627,3,NIKyoo,3260,1572,97,90,187,51.9%,19m
5627,3,IIIIIIIIIIII,3260,1643,85,77,162,52.5%,45m
5627,3,[killer]JionK,3260,1549,59,61,120,49.2%,21m
5627,3,[斯巴达血战团]peanut,3260,1030,38,45,83,45.8%,17m
5627,3,Enamond,3260,466,21,12,33,63.6%,15m
5627,3,[星歌]danceInDark,3260,482,19,14,33,57.6%,44m
5627,3,[耗子尾汁]mIaO,3260,0,5,0,5,100.0%,40m
5627,3,咦咦咦,3260,62,2,4,6,33.3%,43m
5627,3,欧颜之蠢菜鸟,3260,30,1,1,2,50.0%,40m
5627,3,渡鸦鸦渡鸦鸦,3260,0,0,1,1,0.0%,21m
5627,3,白给丸,3260,0,0,2,2,0.0%,7m
5627,3,everyoneHF,3260,0,0,2,2,0.0%,11m
5641,2,wichtigste,3259,1008,516,516,1032,50.0%,4m
5641,3,令人发笑的电脑,3259,476,20,16,36,55.6%,7m
5641,3,Cyaegha,3259,342,12,20,32,37.5%,14m
5641,3,泽琦,3259,116,5,6,11,45.5%,5m
5641,3,[挨萌愚忠分子]菜鸟中谋生,3259,58,2,2,4,50.0%,46m
5641,3,[HoASD]gameboy,3259,0,0,1,1,0.0%,7m
5647,3,[幽冥之狼]dreambreak,3258,1568,144,130,274,52.6%,4m
5647,3,raincow,3258,1038,68,66,134,50.7%,30m
5647,3,[EtdNew]赢了都靠运气好,3258,728,27,28,55,49.1%,40m
5647,3,名字真难取,3258,566,22,22,44,50.0%,43m
5647,3,[明帝国]NEVERSAYNEVE,3258,390,14,16,30,46.7%,29m
5647,3,DEMAND,3258,272,10,5,15,66.7%,41m
5647,2,青帝,3258,116,6,3,9,66.7%,19m
5647,3,Silence,3258,178,6,8,14,42.9%,26m
5647,3,[K39]keep,3258,0,0,1,1,0.0%,15m
5647,3,良辰在此谢过,3258,0,0,1,1,0.0%,44m
5647,3,maxwell,3258,0,0,3,3,0.0%,8m
5658,3,timebreaker,3257,1150,239,214,453,52.8%,22m
5658,3,aokou,3257,1198,67,59,126,53.2%,9m
5658,3,ppp,3257,1131,48,41,89,53.9%,14m
5658,3,[闭眼打星际]老子细节做那么好,3257,510,20,18,38,52.6%,31m
5658,3,[A股敢死队]zhao,3257,88,4,2,6,66.7%,27m
5658,2,blankXD,3257,0,3,2,5,60.0%,45m
5658,3,[黑暗森林]奇点,3257,0,1,0,1,100.0%,19m
5665,2,[流氓会武术]Charming,3256,1587,423,413,836,50.6%,16m
5665,3,high,3256,547,30,32,62,48.4%,8m
5665,3,佳佳最可爱,3256,214,9,2,11,81.8%,43m
5665,3,[珂教兴国]珂朵莉的鳏夫,3256,120,3,2,5,60.0%,46m
5665,3,[暗夜王牌]周大爷,3256,60,3,4,7,42.9%,14m
5665,3,[青铜树]GAMEKING,3256,48,3,4,7,42.9%,43m
5671,2,[人人有功炼]神马有木有,3255,1542,213,211,424,50.2%,7m
5671,2,IIIIIIIIIIII,3255,1161,200,204,404,49.5%,21m
5671,2,[TPZTPZ]神明,3255,1287,91,92,183,49.7%,29m
5671,3,无情大鸡霸,3255,704,73,60,133,54.9%,25m
5671,2,llllllll,3255,1050,47,59,106,44.3%,42m
5671,3,[加里敦大学]HatsuneMiku,3255,550,34,37,71,47.9%,25m
5671,3,[狗X]你给老子等着,3255,524,19,19,38,50.0%,14m
5671,3,法玛尔,3255,339,19,22,41,46.3%,23m
5671,3,IIIIIIIIIIII,3255,270,8,6,14,57.1%,44m
5671,2,[花影]Starry,3255,214,8,10,18,44.4%,9m
5671,2,[区区八婆紫]dyd,3255,0,4,1,5,80.0%,1h
5671,3,[西格玛]Aypan,3255,60,3,3,6,50.0%,19m
5671,3,[老年人玩星际]FrenzyGoat,3255,121,2,7,9,22.2%,21m
5671,3,[Beasty]作弊电脑我大哥,3255,30,1,1,2,50.0%,40m
5671,2,[上海龙]LeeJaeGon,3255,0,0,1,1,0.0%,6m
5671,3,[纱雾姐姐]鹿田纱雾,3255,0,0,1,1,0.0%,3m
5671,3,小辣鸡,3255,0,0,5,5,0.0%,44m
5688,3,[超级大谐星]VHwy,3254,677,27,30,57,47.4%,3m
5688,3,AndreaYIvan,3254,375,16,8,24,66.7%,43m
5688,3,浩然正气,3254,372,14,15,29,48.3%,8m
5688,3,[今天什么奶茶]随机电脑,3254,58,3,0,3,100.0%,41m
5688,3,残生小喵,3254,97,2,1,3,66.7%,3m
5688,3,[TShark]牛在灰翔,3254,60,2,4,6,33.3%,5m
5688,1,李培楠的大老婆,3254,0,1,0,1,100.0%,25m
5688,3,[抽爷]铁甲城的卡巴内瑞,3254,30,1,1,2,50.0%,9m
5688,3,[红白团]博丽灵梦,3254,0,0,1,1,0.0%,18m
5688,3,[战役大师]一场游戏一场梦,3254,0,0,1,1,0.0%,11m
5688,3,[JIMAIR]DawnFox,3254,0,0,1,1,0.0%,13m
5688,3,[雾雨魔法森林]射命丸丶文,3254,0,0,1,1,0.0%,45m
5700,3,[Pro]leckcc,3253,938,116,100,216,53.7%,16m
5700,3,[西南财大]大腿之间,3253,664,95,91,186,51.1%,29m
5700,3,[Flowex]soupsword,3253,1377,82,80,162,50.6%,10m
5700,2,妈个鸡,3253,1254,71,70,141,50.4%,29m
5700,3,kirakira,3253,1351,56,39,95,58.9%,29m
5700,3,洋葱头怎么回事,3253,904,54,39,93,58.1%,10m
5700,3,莽我,3253,206,7,7,14,50.0%,40m
5700,3,[哟哟切克闹]柔客,3253,146,5,8,13,38.5%,5m
5700,2,兜里木有棉花糖,3253,0,4,1,5,80.0%,1h
5700,3,風行奧蕾莉亞,3253,58,3,5,8,37.5%,31m
5700,3,[尤摩扬科技]xiaoS,3253,58,2,3,5,40.0%,43m
5700,3,[哔哩哔哩乾杯]黑框眼镜渡边曜,3253,0,0,1,1,0.0%,10m
5700,3,[CPT]混元星际门辞寒,3253,0,0,1,1,0.0%,41m
5713,2,忘了,3252,1501,132,121,253,52.2%,10m
5713,3,[Ys]傻傻的狗子,3252,1473,121,118,239,50.6%,15m
5713,3,[ZJU]GBS,3252,1571,73,62,135,54.1%,6m
5713,3,Faiz,3252,1018,40,30,70,57.1%,43m
5713,3,BraveHeart,3252,1000,37,33,70,52.9%,21m
5713,3,做一辈子朋友,3252,370,13,16,29,44.8%,31m
5713,3,[CPT]凸一一凸,3252,204,8,3,11,72.7%,15m
5713,3,[DMRe]马老师,3252,202,7,9,16,43.8%,14m
5713,2,NITAI,3252,0,5,0,5,100.0%,34m
5713,3,星际韭菜,3252,60,3,3,6,50.0%,45m
5713,3,[HCG]Violet,3252,30,2,1,3,66.7%,11m
5713,3,黑鳍白鱼,3252,0,1,0,1,100.0%,12m
5713,3,[鸽子窝]TEMplar,3252,0,1,0,1,100.0%,41m
5713,3,西施,3252,0,0,1,1,0.0%,5m
5713,3,[BXH]INnoMayuNive,3252,0,0,1,1,0.0%,14m
5728,3,我力哥去,3251,1467,171,156,327,52.3%,25m
5728,2,IIIIIIIIIIII,3251,847,110,104,214,51.4%,12m
5728,3,AyanamiRei,3251,1407,84,69,153,54.9%,26m
5728,3,[大青州帝国]便行径肛,3251,833,37,33,70,52.9%,17m
5728,3,[miku守护]Dealer,3251,424,15,17,32,46.9%,3m
5728,3,[火焰雷兽]HopeLess,3251,316,12,15,27,44.4%,5m
5728,3,[Fantsy]Pluto,3251,202,7,7,14,50.0%,25m
5728,3,玖琳吾妻,3251,200,7,7,14,50.0%,9m
5728,3,[特种兵营]小新,3251,148,6,5,11,54.5%,17m
5728,1,[龙湖战队]cwsair,3251,0,1,1,2,50.0%,29m
5728,3,[KZiiii]番风,3251,0,0,1,1,0.0%,26m
5739,3,咸鱼菌,3250,1591,136,129,265,51.3%,41m
5739,3,[二蛋带你飞]wujian,3250,1251,54,39,93,58.1%,45m
5739,3,[薄暮之光]Bruce,3250,502,19,16,35,54.3%,14m
5739,3,[EqEqEE]挽灵,3250,142,6,3,9,66.7%,40m
5743,3,小伊,3249,686,53,48,101,52.5%,28m
5743,3,[TeamCD]我不会玩,3249,571,25,17,42,59.5%,43m
5743,3,realgun,3249,583,22,17,39,56.4%,25m
5743,1,Savage,3249,232,9,4,13,69.2%,6m
5743,3,雨中女郎,3249,150,9,8,17,52.9%,27m
5743,3,[飞跃来]小巫女,3249,198,8,6,14,57.1%,26m
5743,3,[STCG]榉象,3249,0,1,0,1,100.0%,23m
5743,3,Blossom,3249,30,1,1,2,50.0%,30m
5743,3,[NekoQw]FanTa,3249,30,1,1,2,50.0%,27m
5743,3,simple,3249,0,1,3,4,25.0%,22m
5753,3,[峡谷]余音,3248,1250,60,56,116,51.7%,23m
5753,3,[iN]路飞会飞,3248,552,47,35,82,57.3%,41m
5753,3,混元星际外门弟子,3248,966,37,32,69,53.6%,31m
5753,3,[星之所在RI]环忧,3248,606,29,10,39,74.4%,26m
5753,3,[武大萌新]sagiri,3248,418,19,7,26,73.1%,3m
5753,3,[为了遥远的]柚子茶,3248,354,14,8,22,63.6%,11m
5753,2,[叫我杰哥]野兽仙贝,3248,218,11,6,17,64.7%,8m
5753,3,雁阵惊寒,3248,258,9,8,17,52.9%,22m
5753,3,[搔浪剑]浪客无疾君莫忧,3248,121,3,2,5,60.0%,10m
5753,3,[西安翻译学院]香香打我香香骂我,3248,90,3,4,7,42.9%,18m
5753,3,[莽夫智障团]跳跃猫杰西,3248,30,2,0,2,100.0%,20m
5753,3,[迫害小黄鸡]Kenshin,3248,30,2,1,3,66.7%,16m
5753,3,iiiiiiii,3248,0,1,0,1,100.0%,27m
5753,3,银河第一的秘密,3248,0,1,1,2,50.0%,14m
5753,3,initiativlif,3248,30,1,4,5,20.0%,13m
5768,2,[时间]琴桑,3247,1315,255,257,512,49.8%,5m
5768,3,IIIIIIIIIIII,3247,1133,118,97,215,54.9%,43m
5768,3,[又练出来了]白羽苏芳,3247,536,108,89,197,54.8%,25m
5768,3,[社交学导练]浅忆丶晴初,3247,297,30,21,51,58.8%,9m
5768,3,FLLFFL,3247,395,16,5,21,76.2%,27m
5768,3,neno,3247,300,11,2,13,84.6%,25m
5768,1,Lakos,3247,140,5,2,7,71.4%,1h
5768,2,[OLY]薇尔莉特酱,3247,101,4,1,5,80.0%,10m
5768,3,擎天柱,3247,114,4,3,7,57.1%,17m
5768,3,shark,3247,92,4,5,9,44.4%,25m
5768,3,自由之翼,3247,30,2,2,4,50.0%,13m
5768,3,thugss,3247,0,1,0,1,100.0%,26m
5768,3,[查尔之矛]冠位御宅,3247,0,1,0,1,100.0%,6m
5768,3,[请先打我隊友]laoshi,3247,30,1,1,2,50.0%,25m
5782,3,[BG]你的屁屁嘿嘿,3246,1273,160,138,298,53.7%,23m
5782,3,amoi,3246,1503,152,133,285,53.3%,11m
5782,3,易折还皱,3246,918,93,74,167,55.7%,45m
5782,3,灵活的胖子,3246,1194,56,54,110,50.9%,9m
5782,3,樱洛,3246,792,36,16,52,69.2%,19m
5782,3,[博云星际学院]BBQxm,3246,376,14,5,19,73.7%,40m
5782,3,[RSTAR]吾名为宙宇尘星,3246,351,14,19,33,42.4%,8m
5782,3,IIIIIIIIIIII,3246,214,8,4,12,66.7%,21m
5782,3,bikaqiu,3246,218,8,5,13,61.5%,43m
5782,3,[不知]scarLett,3246,186,7,5,12,58.3%,25m
5782,3,[瞎际霸打]晓学牲食粪,3246,102,6,2,8,75.0%,42m
5782,1,[博云星际学院]乖仔虫,3246,237,6,13,19,31.6%,29m
5782,3,[打到你强退]人狠话不多丶,3246,135,5,5,10,50.0%,17m
5782,2,BPinarea,3246,193,5,5,10,50.0%,8m
5782,1,[千杯酒酬知己]BlueSun,3246,142,3,1,4,75.0%,34m
5782,3,Yangnannan,3246,0,1,0,1,100.0%,30m
5782,3,心丶空,3246,0,0,1,1,0.0%,27m
5782,3,[奇特家族]疯狂的蜗牛,3246,0,0,1,1,0.0%,22m
5782,3,zyWoo,3246,0,0,1,1,0.0%,26m
5782,3,[2对2大师]只会刷机枪兵,3246,0,0,1,1,0.0%,5m
5782,3,[Angel]丢人现眼,3246,0,0,2,2,0.0%,41m
5803,3,Hanlei,3245,1566,201,196,397,50.6%,30m
5803,3,Oxmood,3245,1102,52,24,76,68.4%,31m
5803,3,[31CM]MasterDA,3245,729,49,48,97,50.5%,12m
5803,3,goodgame,3245,854,45,41,86,52.3%,44m
5803,3,狗我丶死全家,3245,885,35,28,63,55.6%,25m
5803,2,budatvt,3245,522,20,27,47,42.6%,14m
5803,3,[今晚去唐宫]小洲,3245,374,17,12,29,58.6%,44m
5803,3,zzzzzzzz,3245,352,14,8,22,63.6%,26m
5803,3,[QAQ]小馒头丶,3245,97,5,2,7,71.4%,24m
5803,3,Licion,3245,64,4,0,4,100.0%,10m
5803,3,BBOYK,3245,90,4,4,8,50.0%,23m
5803,3,暴走的铅笔,3245,30,2,0,2,100.0%,12m
5803,3,[五月花]歨冥谷乂,3245,0,1,1,2,50.0%,5m
5803,2,[FM战队]浪雨夜呢,3245,0,0,2,2,0.0%,43m
5817,3,savelove,3244,782,31,21,52,59.6%,21m
5817,1,[清于欢]菜鸟清欢,3244,182,7,1,8,87.5%,14m
5817,3,阔落加冰,3244,168,7,3,10,70.0%,17m
5817,3,小米宝贝儿,3244,146,6,6,12,50.0%,26m
5817,3,[天人合一]无距,3244,58,3,3,6,50.0%,25m
5817,3,枫逝曳燃,3244,86,3,4,7,42.9%,18m
5817,3,SaLBcRa,3244,30,2,0,2,100.0%,14m
5817,3,IIIIIIII,3244,30,2,6,8,25.0%,40m
5817,3,[tiandi]MING,3244,0,0,1,1,0.0%,15m
5826,3,MGJTERRAN,3243,1586,108,101,209,51.7%,43m
5826,3,iiiiiiiiiiii,3243,1609,94,83,177,53.1%,28m
5826,3,各种空虚冷冷冷,3243,557,30,29,59,50.8%,29m
5826,3,解冻,3243,478,22,19,41,53.7%,43m
5826,3,[极限战团]白给的阿米娅,3243,166,6,2,8,75.0%,6m
5826,3,Tom,3243,58,3,2,5,60.0%,30m
5826,3,[传说萌娘团]星语,3243,60,3,2,5,60.0%,5m
5833,3,llllllllll,3242,1595,71,66,137,51.8%,26m
5833,3,llllllllllll,3242,885,39,36,75,52.0%,10m
5833,3,西恩刀塔,3242,214,9,4,13,69.2%,21m
5833,2,[湖南女子大学]IIIIIIIIIIII,3242,168,8,5,13,61.5%,27m
5833,3,[专业丶团队]光明审判者,3242,166,6,3,9,66.7%,11m
5833,3,Dieprinzen,3242,30,3,3,6,50.0%,24m
5833,1,守夜人,3242,48,3,5,8,37.5%,39m
5833,3,[青娱乐]LeamoNSixL,3242,30,2,1,3,66.7%,9m
5833,3,[败犬联盟]尽梨了,3242,60,2,2,4,50.0%,3m
5833,3,[Rhusky]iNTime,3242,30,1,1,2,50.0%,43m
5843,3,LVmax,3241,1564,131,116,247,53.0%,40m
5843,3,[您好]IIIIIIIIIIII,3241,1554,74,65,139,53.2%,41m
5843,3,宗师坟墓,3241,1029,42,34,76,55.3%,20m
5843,3,战神,3241,649,27,16,43,62.8%,6m
5843,3,[武汉理工大学]沧海一声笑,3241,660,23,25,48,47.9%,9m
5843,3,桜内蜜柑,3241,114,5,2,7,71.4%,43m
5843,3,[鸡家军]喵帕斯,3241,146,3,3,6,50.0%,14m
5843,3,beforer,3241,58,2,1,3,66.7%,3m
5843,3,[头文字TB]DUTY,3241,30,1,2,3,33.3%,17m
5843,3,Lei,3241,0,0,1,1,0.0%,20m
5843,3,晚行,3241,0,0,1,1,0.0%,44m
5843,3,DevotionLK,3241,0,0,2,2,0.0%,40m
5855,3,[谐莽狗偷稳奶]爱睡觉的橙子,3240,1549,161,140,301,53.5%,29m
5855,2,llllllllll,3240,1427,102,108,210,48.6%,43m
5855,3,Cruiser,3240,594,20,25,45,44.4%,27m
5855,2,吹不走你的心,3240,105,5,4,9,55.6%,28m
5855,2,总有刁民想害朕,3240,0,4,1,5,80.0%,28m
5855,3,[萨丶]休息,3240,30,2,0,2,100.0%,8m
5855,3,Maru,3240,58,2,3,5,40.0%,29m
5855,3,ZQTdiy,3240,0,1,0,1,100.0%,9m
5855,3,[上海海洋大学]Kommando,3240,0,0,1,1,0.0%,18m
5864,2,white,3239,1449,192,196,388,49.5%,7m
5864,2,[HK丶S]阳光果粒橙,3239,988,59,67,126,46.8%,11m
5864,2,[KPG2]队长别开枪是我,3239,1251,47,55,102,46.1%,26m
5864,3,[随便]waez,3239,1013,38,40,78,48.7%,4m
5864,3,[小鸡屠宰场8]Hopestar,3239,321,15,12,27,55.6%,20m
5864,1,未闻,3239,273,11,8,19,57.9%,42m
5864,3,ILave,3239,90,4,1,5,80.0%,26m
5864,3,[魔法少女小屋]Rahim,3239,86,3,1,4,75.0%,11m
5864,3,倦意已深,3239,90,3,5,8,37.5%,3m
5864,3,[龙骑舞尹志平]小花,3239,60,3,5,8,37.5%,12m
5864,3,Odin,3239,30,2,0,2,100.0%,40m
5864,3,[我队伍很强大]小青酱,3239,0,0,3,3,0.0%,40m
5876,2,悔丶,3238,1458,112,118,230,48.7%,42m
5876,3,Dreamflsh,3238,672,67,54,121,55.4%,22m
5876,3,KKpush,3238,943,38,40,78,48.7%,31m
5876,1,[慢手e族]背萝卜的兔子,3238,333,14,10,24,58.3%,30m
5876,3,[科普鲁苏维埃]星空,3238,237,9,5,14,64.3%,13m
5876,3,只会打一波,3238,172,7,7,14,50.0%,6m
5876,1,超级杰克奥特曼,3238,161,4,14,18,22.2%,10m
5876,3,[AtioN]欧根欧根欧,3238,58,3,1,4,75.0%,9m
5876,3,ThisEdge,3238,30,2,0,2,100.0%,17m
5876,3,seeight,3238,30,2,3,5,40.0%,23m
5876,3,[神族难民]栗子蛋糕,3238,0,0,1,1,0.0%,42m
5887,3,WED,3237,1362,62,60,122,50.8%,44m
5887,3,你们不要再打了啦,3237,552,57,46,103,55.3%,5m
5887,3,风平浪静,3237,1064,45,36,81,55.6%,45m
5887,3,Relativity,3237,820,33,29,62,53.2%,9m
5887,3,[萝莉之芯]有毒男与死神共舞,3237,384,14,21,35,40.0%,27m
5887,2,Leomeixi,3237,80,7,5,12,58.3%,28m
5887,3,状元,3237,82,6,3,9,66.7%,10m
5887,3,[Sicili]傻级一番舰,3237,60,3,2,5,60.0%,14m
5887,3,eAsy,3237,142,3,7,10,30.0%,4m
5887,3,梨花泪沾裳,3237,6,2,0,2,100.0%,8m
5887,3,[童话]恋语轻唱,3237,0,0,1,1,0.0%,43m
5898,3,JiaHuan,3236,649,25,15,40,62.5%,30m
5898,3,霜鸣,3236,594,22,28,50,44.0%,10m
5898,3,队友,3236,389,17,10,27,63.0%,25m
5898,3,[黑白丝双马尾]救世神棍泽拉图,3236,394,15,6,21,71.4%,31m
5898,3,[萝莉之芯]Illya,3236,284,11,9,20,55.0%,16m
5898,3,IIIIIIIIIIII,3236,222,9,5,14,64.3%,23m
5898,3,Tohsaka,3236,90,4,2,6,66.7%,30m
5898,2,roco,3236,0,3,2,5,60.0%,31m
5898,3,天地浮生,3236,152,3,6,9,33.3%,23m
5898,3,Envy,3236,30,2,1,3,66.7%,3m
5898,3,[STL]我是小菜鸟,3236,30,1,1,2,50.0%,26m
5898,3,[涅槃之火]Phoenix,3236,0,1,1,2,50.0%,26m
5898,3,这游戏好难,3236,30,1,1,2,50.0%,43m
5898,3,我是唐哥,3236,0,0,1,1,0.0%,4m
5898,3,[武汉理工大学]WHT,3236,0,0,1,1,0.0%,16m
5898,3,松果痰抖闪电鞭,3236,0,0,1,1,0.0%,18m
5898,3,[灰冥]赤瞳,3236,0,0,2,2,0.0%,22m
5915,3,IIIIIIIIII,3235,1535,126,123,249,50.6%,25m
5915,3,[鸡家军]TongHickey,3235,1504,109,87,196,55.6%,4m
5915,3,正锋君,3235,1527,58,59,117,49.6%,40m
5915,3,五道口流浪者,3235,858,37,21,58,63.8%,6m
5915,2,守护木叶的少年,3235,0,4,1,5,80.0%,53m
5915,3,[Halo06]YooJio,3235,0,1,0,1,100.0%,6m
5915,3,[龍雀]IIIIIIIIIIII,3235,30,1,2,3,33.3%,42m
5915,3,[长不大的]文学家笔下的海,3235,0,0,1,1,0.0%,11m
5915,3,[荒野之家]白衣丶不争,3235,0,0,1,1,0.0%,25m
5915,1,[DMRe]夜深狼吟,3235,0,0,1,1,0.0%,10m
5925,3,[专打嘤嘤怪]南云,3234,1555,142,130,272,52.2%,45m
5925,3,鲸落,3234,1371,60,41,101,59.4%,40m
5925,3,[瘾大眼瞎]大和骑脸怎么输,3234,797,44,27,71,62.0%,41m
5925,3,[扫黄]运气是实力的全部,3234,754,35,37,72,48.6%,44m
5925,3,[龙姐姐真棒]空投小王子,3234,466,27,7,34,79.4%,14m
5925,1,旭东黄,3234,352,15,7,22,68.2%,20m
5925,3,innovative,3234,130,12,10,22,54.5%,17m
5925,3,LayoSHY,3234,264,12,11,23,52.2%,17m
5925,2,[暴雪十一队]IIIIIII,3234,0,4,1,5,80.0%,1h
5925,3,[序列sao]低音号黄前久美子,3234,0,1,0,1,100.0%,44m
5925,3,[比企谷八幡]让往事随风逝去,3234,0,0,1,1,0.0%,11m
5936,3,IIIIIIIIIIII,3233,1001,152,139,291,52.2%,12m
5936,3,[ACG系]凄隐落枫,3233,1224,127,115,242,52.5%,25m
5936,3,[Vv]鬼鬼,3233,1048,123,123,246,50.0%,10m
5936,3,何处惹尘埃,3233,1500,58,56,114,50.9%,27m
5936,3,西瓜刀少年,3233,1037,44,45,89,49.4%,13m
5936,3,喝醉了好难受,3233,916,34,38,72,47.2%,9m
5936,3,[XYFANS]Misaki,3233,344,13,4,17,76.5%,26m
5936,3,[TCP]Loong,3233,150,6,5,11,54.5%,46m
5936,3,Entropy,3233,92,4,4,8,50.0%,8m
5936,3,旭阳,3233,129,3,1,4,75.0%,23m
5936,3,[嘤遍全球]tiankongzhiz,3233,0,1,0,1,100.0%,8m
5936,2,[软蛋和鸡]完虐不解释,3233,0,1,1,2,50.0%,22m
5936,3,EDHaid,3233,30,1,2,3,33.3%,43m
5936,3,花开月下,3233,0,1,2,3,33.3%,41m
5936,3,asd,3233,0,1,3,4,25.0%,6m
5936,3,[dsnggs]ALLENPOLE,3233,0,0,2,2,0.0%,13m
5936,3,IIIIIIIII,3233,0,0,3,3,0.0%,12m
5953,3,撒谎小猫,3232,1114,124,102,226,54.9%,12m
5953,3,白色的泡沫,3232,1259,77,77,154,50.0%,11m
5953,3,暗影风暴,3232,659,27,17,44,61.4%,24m
5953,3,十系,3232,350,13,12,25,52.0%,10m
5953,3,爱有好多字,3232,304,12,18,30,40.0%,14m
5953,3,landmine,3232,210,8,8,16,50.0%,42m
5953,3,[湖面倒影]苍蓝,3232,54,3,0,3,100.0%,41m
5960,2,IIIIIIIIIIII,3231,1399,201,204,405,49.6%,29m
5960,3,[小鸡屠宰场b]HolyChuck,3231,585,69,56,125,55.2%,30m
5960,3,MarK,3231,1008,37,39,76,48.7%,8m
5960,3,water,3231,430,33,26,59,55.9%,10m
5960,3,[Encore]摸鱼的嘤嘤怪,3231,812,30,30,60,50.0%,24m
5960,3,[東方心念語]快速度,3231,558,21,17,38,55.3%,8m
5960,3,年级组长王老师,3231,243,17,14,31,54.8%,13m
5960,3,AnimalYang,3231,168,7,2,9,77.8%,16m
5960,3,[Beasty]蟹小南江,3231,192,7,4,11,63.6%,11m
5960,3,田儿子真的蠢,3231,114,4,1,5,80.0%,28m
5960,3,为地球而生,3231,30,2,0,2,100.0%,14m
5960,3,KanAiyu,3231,58,2,2,4,50.0%,10m
5960,3,[rush2]zyseals,3231,0,1,0,1,100.0%,9m
5960,3,[pypypy]TIME,3231,0,1,0,1,100.0%,6m
5960,3,[GOTAL]Niggedie,3231,30,1,2,3,33.3%,20m
5960,3,[ArtMan]OffensiveCR,3231,30,1,6,7,14.3%,25m
5960,3,[牛子军团]UsillyB,3231,0,0,1,1,0.0%,15m
5977,2,TYTY,3230,1348,178,173,351,50.7%,28m
5977,3,[YA]MeGuMI,3230,1597,125,120,245,51.0%,12m
5977,3,[哔哩哔哩杯乾]琉璃易碎,3230,1183,107,102,209,51.2%,25m
5977,3,IIIIIIIII,3230,1536,73,66,139,52.5%,16m
5977,2,小库头,3230,1546,70,71,141,49.6%,45m
5977,3,白咕咕,3230,778,27,28,55,49.1%,16m
5977,3,酷酷,3230,220,8,8,16,50.0%,6m
5977,3,[建瓯谐星]小色鸡,3230,120,5,10,15,33.3%,22m
5977,3,[foryss]zEAlotyc,3230,0,1,0,1,100.0%,22m
5977,3,人皇打随机,3230,0,0,2,2,0.0%,14m
5977,3,Tivish,3230,0,0,2,2,0.0%,41m
5988,3,[我爱黄嘉彦]伟大温度计,3229,133,6,3,9,66.7%,44m
5988,2,罪恶火花三四三,3229,161,5,3,8,62.5%,10m
5988,2,斯巴达,3229,0,4,1,5,80.0%,31m
5991,3,仁义无双总司令,3228,667,34,24,58,58.6%,26m
5991,2,我即是虫群,3228,886,27,51,78,34.6%,15m
5991,3,一个菜鸟,3228,443,19,12,31,61.3%,29m
5991,3,鸡饲料,3228,454,16,11,27,59.3%,17m
5991,3,lonelyson,3228,290,14,10,24,58.3%,13m
5991,3,出虚空等于无敌,3228,382,14,22,36,38.9%,25m
5991,3,IIIIIIIIIIII,3228,202,7,6,13,53.8%,19m
5991,3,[腥基佬男骸]AmazingLYH,3228,101,5,2,7,71.4%,16m
5991,3,FlashGOGOGO,3228,114,5,6,11,45.5%,25m
5991,3,Tumerzu,3228,30,2,2,4,50.0%,27m
6001,3,Cher,3227,331,60,45,105,57.1%,11m
6001,3,[popTM]watergun,3227,1175,52,58,110,47.3%,9m
6001,3,从零开始,3227,893,34,32,66,51.5%,43m
6001,3,[Anticw]星际天涯,3227,389,28,4,32,87.5%,19m
6001,3,BnB,3227,125,17,9,26,65.4%,42m
6001,3,LuckyMan,3227,462,17,15,32,53.1%,40m
6001,3,[EmPirE]DragonsnowCN,3227,165,4,3,7,57.1%,21m
6001,3,龙七,3227,60,3,3,6,50.0%,26m
6001,3,[此花亭]慌垫溅,3227,86,3,5,8,37.5%,18m
6001,3,[飞云之上]ilovefrozen,3227,30,2,0,2,100.0%,9m
6001,3,[霸气无视]尼玛的屁演,3227,30,2,1,3,66.7%,44m
6001,3,Win,3227,60,2,14,16,12.5%,46m
6001,3,[我爱熊猫头]LightDragon,3227,0,1,0,1,100.0%,16m
6001,3,[死亡大河]Mycroft,3227,0,1,0,1,100.0%,6m
6001,3,Bliss,3227,0,0,1,1,0.0%,3m
6001,3,虫儿飞,3227,0,0,1,1,0.0%,16m
6017,2,[Sc养老]IIIIIIIIIIII,3226,1549,152,151,303,50.2%,29m
6017,2,[C97791]三当家,3226,314,55,63,118,46.6%,21m
6017,3,[67373]亦雨,3226,987,52,45,97,53.6%,25m
6017,3,[DMRc]淋浴,3226,544,32,27,59,54.2%,41m
6017,3,Mastershy,3226,451,19,17,36,52.8%,13m
6017,3,[ylx]magicianYZ,3226,518,19,25,44,43.2%,42m
6017,3,SINGLETON,3226,220,16,17,33,48.5%,41m
6017,3,[BloodY]Shine,3226,132,9,3,12,75.0%,13m
6017,3,[OB丶]炼铜术士,3226,86,3,3,6,50.0%,43m
6017,3,[XXHZ28]沧海沧桑,3226,0,1,0,1,100.0%,11m
6017,3,lllllllllll,3226,0,1,0,1,100.0%,27m
6017,3,[心跳文学部]支配之恶魔,3226,32,1,3,4,25.0%,23m
6017,3,Mkeyboard,3226,0,0,2,2,0.0%,45m
6017,2,情请清,3226,0,0,2,2,0.0%,13m
6031,2,看见你我就跑,3225,1531,265,280,545,48.6%,21m
6031,2,Koyou,3225,800,44,49,93,47.3%,26m
6031,3,忠肝义胆邢育森,3225,730,25,33,58,43.1%,6m
6031,3,漩涡鸣人,3225,239,14,16,30,46.7%,44m
6031,3,炒鸡可爱王霸星,3225,306,11,10,21,52.4%,29m
6031,3,kusamaki,3225,246,10,7,17,58.8%,3m
6031,3,[miku守护]素质人皇,3225,304,10,17,27,37.0%,26m
6031,3,[Beasty]小明,3225,126,4,12,16,25.0%,22m
6031,2,Legend,3225,92,2,1,3,66.7%,19m
6031,3,[肉鸡的饲养]小魔女流水酱,3225,0,1,0,1,100.0%,22m
6041,3,loop,3224,1397,226,200,426,53.1%,41m
6041,2,cini,3224,1425,222,223,445,49.9%,29m
6041,3,[封闭者]肥龙,3224,1523,106,85,191,55.5%,16m
6041,3,Jacob,3224,524,22,12,34,64.7%,28m
6041,3,灰色的青,3224,442,17,12,29,58.6%,12m
6041,3,[星际鸽子组]西伯利亚狼,3224,370,14,12,26,53.8%,41m
6041,1,RocKY,3224,303,13,9,22,59.1%,24m
6041,3,[江南剑客]Swordsman,3224,168,7,1,8,87.5%,27m
6041,3,[你自己去单刷]黑猩猩拍皮球,3224,30,2,0,2,100.0%,16m
6041,3,igxyFANS,3224,58,2,1,3,66.7%,11m
6041,3,[一库]Roman,3224,0,1,0,1,100.0%,8m
6041,3,HenryLight,3224,0,1,0,1,100.0%,26m
6041,3,[永磁帮]罗智学,3224,0,1,0,1,100.0%,12m
6041,3,[本子娜]泉户真白,3224,0,0,1,1,0.0%,20m
6041,3,孤寂的寒星,3224,0,0,2,2,0.0%,30m
6056,3,雪梅花,3223,851,64,48,112,57.1%,25m
6056,3,llllllllllll,3223,1266,52,56,108,48.1%,41m
6056,2,[西野七瀬]NanaseMaru,3223,1297,49,58,107,45.8%,3m
6056,3,[电脑侠]斗鱼七三八二八,3223,1090,40,40,80,50.0%,25m
6056,3,小翔,3223,316,20,17,37,54.1%,16m
6056,3,[小金上天队]打咩得斯,3223,552,18,26,44,40.9%,28m
6056,3,IIIIIIIIIIII,3223,456,16,18,34,47.1%,43m
6056,3,Alex,3223,245,10,4,14,71.4%,11m
6056,2,[烽夜长歌]PBBB,3223,96,2,0,2,100.0%,1h
6056,3,超级太假,3223,60,2,4,6,33.3%,22m
6056,3,守护者孙一鸡,3223,0,2,4,6,33.3%,28m
6056,3,[我们是无敌的]不偷不狗顶正面,3223,0,0,2,2,0.0%,45m
6056,3,[有杀气童话]雾雨魔理沙,3223,0,0,2,2,0.0%,9m
6069,3,[TCP]基尼泰美,3222,1572,152,141,293,51.9%,9m
6069,3,[最菜战队]kayanon,3222,1204,79,66,145,54.5%,43m
6069,3,唐毅萌萌哒哟,3222,1187,71,65,136,52.2%,43m
6069,3,[居然之家]一切尽在花落,3222,701,40,27,67,59.7%,28m
6069,3,[笙风]MGJTerran,3222,281,32,29,61,52.5%,5m
6069,3,丨氢氧化钠丨,3222,314,15,10,25,60.0%,41m
6069,3,Ivan,3222,135,9,9,18,50.0%,17m
6069,2,不要逼我机械化,3222,139,6,5,11,54.5%,8m
6069,3,啦啦啦德玛西亚,3222,149,4,7,11,36.4%,21m
6069,3,[KUMA28]KUMA,3222,0,1,0,1,100.0%,14m
6079,3,火烧猪屁屁,3221,611,111,101,212,52.4%,9m
6079,3,[KPG2]xinzhizhu,3221,1405,85,66,151,56.3%,12m
6079,3,llllllll,3221,1199,53,36,89,59.6%,15m
6079,3,[极品二五仔]孙一峰,3221,1173,51,45,96,53.1%,20m
6079,2,IIIIIIIII,3221,687,23,33,56,41.1%,7m
6079,2,sadfsd,3221,160,8,6,14,57.1%,12m
6079,1,Dadshaouxx,3221,119,5,2,7,71.4%,59m
6079,1,星璇,3221,0,4,2,6,66.7%,34m
6079,2,怕对面打的太辛苦,3221,120,3,8,11,27.3%,46m
6079,3,zwy,3221,30,2,1,3,66.7%,28m
6079,3,CalvinBoy,3221,0,1,0,1,100.0%,30m
6079,1,tomander,3221,0,1,1,2,50.0%,3m
6091,2,Yamato,3220,1414,86,96,182,47.3%,10m
6091,3,[养身人族]Bossun,3220,876,35,28,63,55.6%,44m
6091,3,[最菜战队]carry,3220,404,16,14,30,53.3%,44m
6091,3,[Ginuna]汤糖躺烫,3220,213,7,2,9,77.8%,28m
6091,3,肖邦,3220,155,5,6,11,45.5%,28m
6091,3,[奇葩战术]Darthvader,3220,58,2,1,3,66.7%,12m
6091,3,[开心小家]Jixiaochu,3220,58,2,1,3,66.7%,41m
6091,3,[一波]叫我帅哥就好了,3220,97,2,2,4,50.0%,44m
6091,3,苟且偷生,3220,0,1,0,1,100.0%,16m
6091,3,[火焰雷兽]我萌怪我咯,3220,0,1,4,5,20.0%,26m
6091,3,Kirtio,3220,0,1,4,5,20.0%,11m
6102,2,[IMRTS]傲然诶,3219,1580,70,79,149,47.0%,44m
6102,3,[XIn]ODOK,3219,1262,53,41,94,56.4%,11m
6102,3,[火焰雷兽]你运营有点慢,3219,469,19,9,28,67.9%,16m
6102,1,大隋丶凝霜,3219,118,6,2,8,75.0%,3m
6102,3,loster,3219,144,5,3,8,62.5%,45m
6102,3,煞笔女人被狗日,3219,148,5,4,9,55.6%,27m
6102,3,[YA]FrostyDog,3219,30,2,0,2,100.0%,41m
6102,3,[正统人族]Joan,3219,0,0,1,1,0.0%,13m
6102,3,秋收冬藏,3219,0,0,1,1,0.0%,25m
6111,3,[黎明前线]苯上人,3218,1546,131,127,258,50.8%,44m
6111,3,[武纺星际切磋]darkfantasy,3218,1493,72,68,140,51.4%,3m
6111,3,Milky,3218,1241,64,49,113,56.6%,25m
6111,3,Slavowitz,3218,742,43,30,73,58.9%,13m
6111,3,KAIYIFODOM,3218,760,35,25,60,58.3%,41m
6111,3,baskt,3218,406,20,22,42,47.6%,16m
6111,2,[请先打我隊友]cayingsation,3218,343,18,30,48,37.5%,16m
6111,2,明道若昧,3218,311,12,7,19,63.2%,17m
6111,3,[miku守护]clearlove,3218,276,10,8,18,55.6%,18m
6111,3,园游会丶,3218,92,5,5,10,50.0%,44m
6111,3,[爱丽丝幻乐]KiDxyl,3218,124,4,10,14,28.6%,10m
6111,3,BonlyuN,3218,60,2,4,6,33.3%,13m
6111,3,胖爷肥神,3218,30,2,6,8,25.0%,27m
6111,3,[marui]婀塔妮丝,3218,30,1,3,4,25.0%,13m
6111,3,[大反派]夏树良太,3218,0,0,1,1,0.0%,6m
6126,3,蛮力之兽,3217,926,200,191,391,51.2%,29m
6126,1,[Debu]KagamineRen,3217,374,15,9,24,62.5%,40m
6126,3,zeyu,3217,322,11,16,27,40.7%,26m
6126,3,[老吴天下第一]Tgglol,3217,88,4,2,6,66.7%,31m
6126,3,[DMR]蛮兽之力,3217,92,4,5,9,44.4%,23m
6126,3,[Flo]Sweetheart,3217,58,3,2,5,60.0%,10m
6126,3,blyat,3217,0,1,0,1,100.0%,25m
6126,3,Ervin,3217,0,0,1,1,0.0%,29m
6126,2,[刺蛇互助协会]刺蛇桑,3217,0,0,5,5,0.0%,1h
6135,3,[舰C]枫叶椛,3216,1040,146,143,289,50.5%,22m
6135,3,心凌,3216,1314,133,137,270,49.3%,17m
6135,3,LOVEAAA,3216,716,69,73,142,48.6%,21m
6135,3,段筱侃,3216,1284,66,31,97,68.0%,23m
6135,3,[暗黑幻想]村长大人,3216,647,40,34,74,54.1%,29m
6135,3,IIIIIIIIII,3216,722,27,28,55,49.1%,26m
6135,3,[tiandi]饭宗的南妈妈,3216,322,11,17,28,39.3%,12m
6135,3,PCSV,3216,270,10,8,18,55.6%,20m
6135,3,IIIIIIIIIIII,3216,264,10,15,25,40.0%,23m
6135,2,菜王,3216,292,9,11,20,45.0%,21m
6135,2,IIIIIIIIIIII,3216,0,4,1,5,80.0%,13m
6135,3,[星际装比仔]SteinerTrack,3216,30,2,1,3,66.7%,13m
6135,2,MORDRED,3216,0,2,2,4,50.0%,1h
6135,1,[WGwar]steve,3216,0,1,0,1,100.0%,19m
6135,3,都是好事儿,3216,0,1,0,1,100.0%,13m
6135,3,[现世执妄]人生之遂,3216,34,1,2,3,33.3%,20m
6135,3,Ulysses,3216,0,0,1,1,0.0%,18m
6135,3,[凛风]鲨芋馨,3216,0,0,1,1,0.0%,15m
6153,2,周飞狗,3215,1671,685,664,1349,50.8%,13m
6153,2,[风林火山]Duke,3215,1581,441,453,894,49.3%,16m
6153,3,[萌新互助团]霸王,3215,978,95,95,190,50.0%,18m
6153,3,[831]一只鸡,3215,1459,71,72,143,49.7%,17m
6153,3,Ptner,3215,1180,43,47,90,47.8%,43m
6153,3,oGsMC,3215,764,33,38,71,46.5%,25m
6153,3,Dreamer,3215,410,31,29,60,51.7%,11m
6153,3,[后宫园]异端,3215,536,19,23,42,45.2%,41m
6153,3,村边野匪,3215,86,3,2,5,60.0%,12m
6153,3,[JPS]失语,3215,30,2,2,4,50.0%,19m
6153,3,[SK]洗脚,3215,30,1,3,4,25.0%,9m
6153,1,Badapple,3215,0,0,1,1,0.0%,41m
6153,3,青城,3215,0,0,1,1,0.0%,18m
6166,2,WCY,3214,1507,123,136,259,47.5%,13m
6166,2,[RSTAR]Creation,3214,970,60,63,123,48.8%,6m
6166,2,ccTV,3214,723,54,57,111,48.6%,45m
6166,3,[NBU]希尔薇,3214,784,30,26,56,53.6%,29m
6166,3,IIo,3214,356,13,15,28,46.4%,25m
6166,3,靠谱为什么这么帅,3214,349,12,7,19,63.2%,25m
6166,3,PenZhan,3214,244,11,13,24,45.8%,12m
6166,3,传说中的啦啦,3214,228,9,7,16,56.2%,29m
6166,2,燃烧的卵毛,3214,95,2,0,2,100.0%,1h
6166,3,[你下面凉快吗]龙逆天,3214,0,0,1,1,0.0%,13m
6166,3,[Exi]呆呆的小小帆,3214,0,0,2,2,0.0%,16m
6166,3,[VKR]西湖底的二五仔,3214,0,0,2,2,0.0%,22m
6166,3,[miku守护]warrior,3214,0,0,2,2,0.0%,12m
6179,3,[Icer]琦琦小靓仔,3213,1493,274,266,540,50.7%,44m
6179,3,FLL,3213,1565,242,245,487,49.7%,44m
6179,3,[五月花]aaa,3213,1570,115,99,214,53.7%,29m
6179,3,[你有遗憾么]落樱不及姑娘你,3213,854,68,67,135,50.4%,44m
6179,3,llllllllllll,3213,788,34,23,57,59.6%,17m
6179,3,咲夜布兰多,3213,521,20,15,35,57.1%,29m
6179,3,DuanHongBiao,3213,524,20,18,38,52.6%,6m
6179,3,心随我动,3213,415,19,8,27,70.4%,19m
6179,3,pppp,3213,314,13,15,28,46.4%,30m
6179,3,[欺农猪]NaDa,3213,200,8,8,16,50.0%,41m
6179,2,崇明,3213,118,5,2,7,71.4%,43m
6179,2,JFKylin,3213,142,4,0,4,100.0%,7m
6179,3,summer,3213,0,1,0,1,100.0%,26m
6179,3,我是真滴菜,3213,0,1,0,1,100.0%,5m
6179,3,[我队伍很强大]虚幻,3213,0,0,1,1,0.0%,23m
6194,3,[旭东黄]来干我吧,3212,994,141,128,269,52.4%,41m
6194,3,Fish,3212,839,62,51,113,54.9%,23m
6194,3,余得曼,3212,942,58,28,86,67.4%,22m
6194,3,Dust,3212,1004,40,36,76,52.6%,8m
6194,3,[桜公馆]magejiTerran,3212,894,36,33,69,52.2%,11m
6194,3,Podeos,3212,356,17,14,31,54.8%,45m
6194,3,[暴雪二十六队]初见丶,3212,368,13,13,26,50.0%,16m
6194,3,小迪大小姐,3212,234,8,1,9,88.9%,43m
6194,3,酒鬼剑客,3212,218,8,6,14,57.1%,3m
6194,3,[孤影眾]肌饲料,3212,150,7,8,15,46.7%,46m
6194,3,黑色巫师,3212,58,3,1,4,75.0%,13m
6194,3,[浪啊浪]jack,3212,90,3,4,7,42.9%,29m
6194,2,羽幕丶,3212,40,2,3,5,40.0%,18m
6194,3,月夜星寒,3212,60,2,6,8,25.0%,14m
6194,1,没有鸽子的鸽子汤,3212,0,1,0,1,100.0%,1h
6194,3,[ENIAC]Eone,3212,0,1,1,2,50.0%,13m
6194,3,[探鸡]一只鱼人,3212,0,0,1,1,0.0%,18m
6194,3,[辉煌华夏]王臣,3212,0,0,1,1,0.0%,29m
6194,3,北辰丷,3212,0,0,1,1,0.0%,25m
6194,3,[我菜啊]你爹临死前,3212,0,0,1,1,0.0%,29m
6194,3,[1057]布衣怒,3212,0,0,1,1,0.0%,18m
6215,3,[盲人协会]孔维康最帅,3211,740,42,4,46,91.3%,14m
6215,3,[浴火银河]ZGB,3211,420,15,16,31,48.4%,46m
6215,3,[Beasty]XYL,3211,192,8,6,14,57.1%,14m
6215,3,IIIIIIII,3211,0,1,0,1,100.0%,17m
6215,3,GloRy,3211,0,1,0,1,100.0%,41m
6215,3,九十块钱,3211,0,0,1,1,0.0%,8m
6215,3,爱滴魔力转圈圈,3211,0,0,1,1,0.0%,6m
6215,3,Etdfhsdg,3211,0,0,1,1,0.0%,7m
6215,3,Distancenam,3211,0,0,1,1,0.0%,7m
6224,2,冲一辈子坦克,3210,1573,345,330,675,51.1%,26m
6224,3,[牡丹]徐老师,3210,370,12,19,31,38.7%,25m
6224,1,[PsNasa]小爱,3210,265,10,8,18,55.6%,23m
6224,3,透里妈批,3210,170,6,7,13,46.2%,43m
6224,2,熊猫君,3210,0,5,0,5,100.0%,1h
6224,1,[快乐谐星]哆啦哆一嗦,3210,119,4,5,9,44.4%,17m
6224,3,[注意防守]江南狗王孙一峰,3210,86,3,3,6,50.0%,27m
6224,3,[瘾大眼瞎]TATQwQ,3210,96,2,0,2,100.0%,20m
6224,3,[HDU]Serenity,3210,0,0,2,2,0.0%,9m
6224,3,[CDC丶TQ]JaxHermes,3210,0,0,2,2,0.0%,28m
6224,3,[牌面]yoyu,3210,0,0,6,6,0.0%,9m
6235,2,lonewolf,3209,1638,175,169,344,50.9%,41m
6235,3,桥言,3209,1614,80,62,142,56.3%,3m
6235,3,可乐要加冰,3209,1308,74,76,150,49.3%,18m
6235,2,[三族同萌会]魔法少年郭冬临,3209,1061,49,45,94,52.1%,4m
6235,3,[脉脉不得语]TheDream,3209,60,3,3,6,50.0%,23m
6235,3,打球的蔡徐坤,3209,0,1,0,1,100.0%,23m
6235,3,戊烷,3209,30,1,1,2,50.0%,14m
6235,3,[Gravia]金属大师,3209,0,1,2,3,33.3%,19m
6235,3,Heaven,3209,0,0,1,1,0.0%,11m
6244,2,Hurrican,3208,1513,143,149,292,49.0%,16m
6244,3,[不服来战]KTFlash,3208,1056,79,78,157,50.3%,12m
6244,3,狗哥且战且退,3208,1291,51,48,99,51.5%,12m
6244,3,[水手]泼出去的盆,3208,680,27,21,48,56.2%,6m
6244,3,Thyme,3208,382,19,15,34,55.9%,3m
6244,2,主人,3208,306,11,9,20,55.0%,43m
6244,3,黄大仙,3208,119,7,2,9,77.8%,46m
6244,3,[星际丨猎妈人]指挥官,3208,170,7,6,13,53.8%,29m
6244,2,[極限戰神]devil,3208,126,4,19,23,17.4%,21m
6244,3,初心,3208,72,3,2,5,60.0%,9m
6244,1,[Skrrr]楚云飞,3208,0,1,0,1,100.0%,1h
6244,3,[四叶草]苍蓝的回忆,3208,30,1,2,3,33.3%,22m
6244,3,[零柒零柒]liggia,3208,0,0,1,1,0.0%,45m
6244,3,夏柳浮华,3208,0,0,1,1,0.0%,25m
6244,3,哇啊,3208,0,0,1,1,0.0%,12m
6259,3,XieMo,3207,737,36,34,70,51.4%,5m
6259,3,sola,3207,714,28,19,47,59.6%,28m
6259,3,[lover]你猜嘞,3207,288,11,15,26,42.3%,45m
6259,3,齐天大圣,3207,294,10,13,23,43.5%,40m
6259,3,眼泪,3207,146,8,12,20,40.0%,24m
6259,3,唯伊,3207,170,6,6,12,50.0%,11m
6259,3,[星街彗星赛高]虫族脆如纸,3207,88,4,1,5,80.0%,42m
6259,3,MariaRose,3207,62,3,4,7,42.9%,28m
6259,3,WaterOS,3207,0,1,1,2,50.0%,41m
6259,3,Nanaya,3207,0,1,1,2,50.0%,41m
6259,3,zxjsg,3207,0,0,1,1,0.0%,15m
6270,3,挖矿,3206,1600,174,164,338,51.5%,17m
6270,3,shock,3206,894,125,111,236,53.0%,20m
6270,3,[星歌]妮可妮可妮,3206,832,32,34,66,48.5%,5m
6270,3,[Davi]三岁,3206,414,15,12,27,55.6%,45m
6270,3,Statistics,3206,114,5,1,6,83.3%,6m
6270,3,阿林,3206,148,5,8,13,38.5%,13m
6270,3,[三个二五仔]zzty,3206,30,2,0,2,100.0%,41m
6270,3,[LDP]Serral,3206,0,1,0,1,100.0%,19m
6270,3,Mahesvara,3206,0,1,0,1,100.0%,12m
6270,3,[sc谐盟]STICK,3206,30,1,1,2,50.0%,29m
6270,3,夜夜,3206,0,1,5,6,16.7%,22m
6270,3,大肥羊,3206,0,0,1,1,0.0%,26m
6270,3,Leviathan,3206,0,0,1,1,0.0%,8m
6270,3,[Azuki]水果棉花糖,3206,0,0,1,1,0.0%,13m
6284,3,[BRMC]FoxFire,3205,970,90,65,155,58.1%,9m
6284,3,ddddd,3205,651,63,51,114,55.3%,43m
6284,3,腌辣椒,3205,365,34,30,64,53.1%,46m
6284,3,[烽夜长歌]agadg,3205,640,25,18,43,58.1%,20m
6284,3,[超级二五仔]NaviSimple,3205,425,19,5,24,79.2%,14m
6284,3,酷酷朝南,3205,430,16,11,27,59.3%,3m
6284,2,小新的猫兄弟,3205,260,10,7,17,58.8%,19m
6284,3,Bunya,3205,101,9,6,15,60.0%,42m
6284,3,阿一乌誒哦,3205,118,5,3,8,62.5%,21m
6284,3,[SUST]SunshineYY,3205,86,3,2,5,60.0%,29m
6284,3,废柴,3205,137,3,6,9,33.3%,42m
6284,3,RED,3205,0,1,0,1,100.0%,30m
6284,3,[XYFANS]瓦里安乌瑞恩,3205,0,1,0,1,100.0%,22m
6284,3,SchoolDays,3205,0,1,1,2,50.0%,14m
6284,3,[SCU]shaker,3205,30,1,2,3,33.3%,24m
6284,2,LovePoem,3205,0,0,1,1,0.0%,6m
6284,3,[QWQa]豆沙渚面包,3205,0,0,1,1,0.0%,29m
6284,3,陶然,3205,0,0,2,2,0.0%,10m
6302,2,人走茶会凉,3204,585,60,69,129,46.5%,45m
6302,3,[FsA]村头王师傅,3204,562,21,25,46,45.7%,41m
6302,3,rockroll,3204,463,20,9,29,69.0%,45m
6302,3,[白送的每一天]EVE,3204,394,14,19,33,42.4%,3m
6302,3,Roy,3204,285,13,13,26,50.0%,11m
6302,3,[Kiloli]好兄弟无穷无尽,3204,326,12,5,17,70.6%,27m
6302,3,兰斯,3204,127,9,2,11,81.8%,5m
6302,3,夜航星,3204,234,9,6,15,60.0%,13m
6302,3,silverbottle,3204,206,7,9,16,43.8%,46m
6302,3,HienDek,3204,114,5,2,7,71.4%,15m
6302,3,[罗马方标]秋色咕噜,3204,166,5,2,7,71.4%,46m
6302,3,[飞天面神]我永远喜欢房佳,3204,0,1,0,1,100.0%,13m
6302,3,[贪婪]战國,3204,0,1,0,1,100.0%,9m
6302,3,jaychou,3204,0,1,0,1,100.0%,8m
6302,3,[萌响限定]兮夜桑,3204,30,1,1,2,50.0%,6m
6302,3,zkq,3204,30,1,1,2,50.0%,8m
6302,1,[就怕对手弱]秋爽,3204,0,1,4,5,20.0%,29m
6302,3,雾都杀手,3204,0,0,1,1,0.0%,22m
6302,3,[水师主教之刃]PhoenixT,3204,0,0,2,2,0.0%,27m
6321,3,[闪电伍连鞭]部落黄昏,3203,1487,236,225,461,51.2%,25m
6321,3,[GAGA]所谓肉香,3203,1242,50,44,94,53.2%,44m
6321,3,RYAN,3203,431,46,39,85,54.1%,23m
6321,3,[城市化]小智弟没有眼泪,3203,1210,45,53,98,45.9%,42m
6321,3,人族怎么打嘛,3203,1003,43,27,70,61.4%,17m
6321,2,一生之敌,3203,236,9,8,17,52.9%,24m
6321,3,OUKIHON,3203,144,6,2,8,75.0%,27m
6321,3,[久美子珠宝]渣渣徽,3203,97,5,4,9,55.6%,8m
6321,3,MagicTerran,3203,88,3,6,9,33.3%,24m
6321,3,小菜鸡学星际,3203,0,1,0,1,100.0%,12m
6321,3,haha,3203,30,1,1,2,50.0%,6m
6321,3,[盛先生粉丝团]求老仙奶诺不开心,3203,97,1,1,2,50.0%,12m
6321,2,llllllllllll,3203,0,0,1,1,0.0%,9m
6334,3,[您好]我没有基态,3202,1468,77,64,141,54.6%,17m
6334,3,TYTY,3202,1264,56,44,100,56.0%,43m
6334,3,抱紧林雨,3202,853,45,14,59,76.3%,24m
6334,3,[Shawk]反正游戏都凉了,3202,943,40,26,66,60.6%,4m
6334,3,小色教你打星际,3202,421,32,28,60,53.3%,13m
6334,3,tina,3202,237,8,5,13,61.5%,20m
6334,3,[侍奉社]雪之下雪乃,3202,218,8,7,15,53.3%,24m
6334,3,少女欧尼酱,3202,238,8,11,19,42.1%,12m
6334,1,残灬云,3202,142,6,2,8,75.0%,44m
6334,3,[Rindow]蟹黄堡,3202,58,6,3,9,66.7%,28m
6334,3,运气是实力的全部,3202,0,3,3,6,50.0%,28m
6334,3,仙人抚我顶,3202,30,2,1,3,66.7%,3m
6334,3,[汉堡FANS]战争结束了指挥官,3202,18,2,2,4,50.0%,40m
6334,3,[噶姐美如花]花枝,3202,0,1,0,1,100.0%,6m
6334,3,你怎么看,3202,0,1,0,1,100.0%,29m
6334,3,[可遇不可求]练出来了,3202,30,1,1,2,50.0%,10m
6334,3,DOIT,3202,0,1,1,2,50.0%,24m
6334,3,AOTTRY,3202,0,1,3,4,25.0%,21m
6334,3,Anliter,3202,0,0,2,2,0.0%,25m
6353,3,沉稳的牧凡,3201,1027,51,46,97,52.6%,9m
6353,3,星际吃枣药丸,3201,184,8,3,11,72.7%,46m
6353,3,Zhou,3201,136,7,6,13,53.8%,9m
6353,3,徘徊的诺亚,3201,142,6,3,9,66.7%,6m
6353,1,Lottie,3201,0,4,2,6,66.7%,1h
6353,3,GundamOO,3201,120,4,9,13,30.8%,29m
6353,3,[IM战队]IMNestea,3201,58,2,1,3,66.7%,28m
6353,3,[咩咩羊]SheepMan,3201,0,1,0,1,100.0%,20m
6353,3,[SGGame]慵懒的白球,3201,0,1,0,1,100.0%,41m
6353,3,[就是锉刀怪]緒方理奈,3201,0,0,1,1,0.0%,22m
6353,3,[林都学子]Minions,3201,0,0,1,1,0.0%,3m
6353,3,花火,3201,0,0,1,1,0.0%,29m
6365,3,暗礁海,3200,1482,139,142,281,49.5%,9m
6365,3,时间走快点,3200,272,11,8,19,57.9%,3m
6365,3,[Nevada]紫菜包饭,3200,185,6,2,8,75.0%,21m
6365,1,[韩宗快乐屋]Kuroko,3200,161,5,2,7,71.4%,42m
6365,3,[火焰雷兽]String,3200,116,5,2,7,71.4%,28m
6365,2,[指战星空]逆光折纸,3200,0,4,1,5,80.0%,33m
6365,2,llllllllllll,3200,0,3,2,5,60.0%,4m
6365,3,[金甲单一]进进,3200,30,2,3,5,40.0%,31m
6365,3,king,3200,30,1,1,2,50.0%,26m
6365,3,[吕布二号]IIIIIIIIIIBU,3200,0,0,1,1,0.0%,16m
6365,3,刺蛇,3200,0,0,2,2,0.0%,13m
6376,3,[XDU]我的舍友叫袁伟男,3199,320,53,54,107,49.5%,11m
6376,3,[easyPC]嘿家,3199,207,6,1,7,85.7%,28m
6376,3,[UED神教]AtSchool,3199,120,5,5,10,50.0%,25m
6376,3,黄旭东祝你老婆美,3199,38,2,1,3,66.7%,12m
6376,3,KLIM,3199,0,1,0,1,100.0%,15m
6376,3,xiaxia,3199,0,1,0,1,100.0%,16m
6376,1,把文物上交国家,3199,0,0,1,1,0.0%,1h
6376,3,[1sA]好多兄弟都牺牲了,3199,0,0,1,1,0.0%,45m
6384,2,[小鸡屠宰场9]VincentLucas,3198,1460,151,153,304,49.7%,17m
6384,2,[占占占占占占]异性恋的丁丁,3198,1417,119,137,256,46.5%,21m
6384,3,传说,3198,755,99,79,178,55.6%,12m
6384,3,Era,3198,670,94,96,190,49.5%,13m
6384,3,来把小子,3198,1602,74,61,135,54.8%,15m
6384,3,[红烧兔头]惊涛骇浪五娃,3198,1143,55,33,88,62.5%,11m
6384,3,诺言,3198,554,53,49,102,52.0%,8m
6384,3,[南宁市动物园]七黑狒,3198,1078,41,38,79,51.9%,22m
6384,3,Superstition,3198,588,25,12,37,67.6%,20m
6384,3,[IGS]llllllllllll,3198,444,19,15,34,55.9%,19m
6384,3,凯里的孤城,3198,336,16,1,17,94.1%,22m
6384,3,[KPG]brownners,3198,336,13,14,27,48.1%,13m
6384,1,野猫,3198,166,9,7,16,56.2%,25m
6384,2,STORYJACK,3198,0,4,1,5,80.0%,13m
6384,3,冰之洁衣,3198,90,3,7,10,30.0%,45m
6384,3,Tuxpp,3198,0,1,0,1,100.0%,14m
6384,3,[皇室联盟]不作死不会死,3198,0,1,0,1,100.0%,44m
6384,3,[SDE]shazhongyu,3198,0,0,1,1,0.0%,21m
6402,3,米旭傲,3197,1561,252,229,481,52.4%,18m
6402,3,prototype,3197,1077,200,186,386,51.8%,13m
6402,3,幻雪星落,3197,1005,75,83,158,47.5%,42m
6402,3,IIIIIIIIII,3197,1558,74,66,140,52.9%,25m
6402,3,kusotori,3197,715,53,54,107,49.5%,9m
6402,3,电竞毒奶黄旭东,3197,264,16,18,34,47.1%,41m
6402,3,我既是虫群,3197,346,13,12,25,52.0%,3m
6402,3,[bili丶]Yozora,3197,310,11,11,22,50.0%,13m
6402,3,第二号,3197,114,5,1,6,83.3%,25m
6402,3,Marineking,3197,90,4,4,8,50.0%,22m
6402,3,快乐之子,3197,18,2,2,4,50.0%,42m
6402,3,[克哈之翼]流浪泰伦,3197,30,1,1,2,50.0%,8m
6402,3,[X英雄圣域X]yysadasda,3197,0,0,1,1,0.0%,3m
6402,3,胖次杀手,3197,0,0,1,1,0.0%,40m
6402,3,淸規,3197,0,0,1,1,0.0%,43m
6417,3,小洛克侠,3196,1573,121,97,218,55.5%,30m
6417,3,[虫族sm]NllRyu,3196,1014,47,37,84,56.0%,41m
6417,3,[吕布天下第一]HAOXIAODUO,3196,259,17,23,40,42.5%,17m
6417,3,[潸然丶那些年]Bachelor,3196,430,16,9,25,64.0%,3m
6417,3,皮皮猪,3196,414,14,20,34,41.2%,21m
6417,3,桐叶,3196,278,12,15,27,44.4%,13m
6417,2,Crayfish,3196,267,10,10,20,50.0%,43m
6417,1,[红萌馆]消逝的海岸线,3196,160,7,3,10,70.0%,1h
6417,3,[霸气军团]Apocalypse,3196,86,4,1,5,80.0%,24m
6417,3,[仁者]从小就很帅,3196,30,2,1,3,66.7%,5m
6417,3,神界之战,3196,96,2,1,3,66.7%,23m
6417,3,[开心战队]傲娇腹黑柠檬妹,3196,0,1,0,1,100.0%,9m
6417,3,玩神族的都是废物,3196,30,1,1,2,50.0%,25m
6417,3,刻风月夜,3196,18,1,3,4,25.0%,25m
6417,3,鲁拉拉,3196,30,1,5,6,16.7%,17m
6417,3,黑崎一护,3196,0,0,1,1,0.0%,15m
6417,3,[青葱与纯色]凌星静夜,3196,0,0,1,1,0.0%,27m
6417,1,西木野甄姬,3196,0,0,1,1,0.0%,26m
6417,3,VioletEverG,3196,0,0,1,1,0.0%,22m
6436,3,[HoA]夜刀神十香,3195,986,67,17,84,79.8%,43m
6436,2,IIIIIIIIII,3195,648,21,38,59,35.6%,19m
6436,3,[逗比神教]公孙筠玖,3195,254,9,12,21,42.9%,22m
6436,3,[暴雪我是你爹]嘤嘤嘤喏卫星,3195,147,4,5,9,44.4%,30m
6436,3,平康大魔王,3195,90,4,5,9,44.4%,8m
6436,1,Diamond,3195,187,3,5,8,37.5%,34m
6436,3,Nebula,3195,0,1,0,1,100.0%,12m
6436,3,[CUSTE]Emerald,3195,30,1,3,4,25.0%,17m
6436,3,IIIIIIIIIIII,3195,0,0,1,1,0.0%,14m
6445,3,[XDUSC2]IIIIIIIIIIII,3194,1569,496,478,974,50.9%,44m
6445,3,庄严的执法者,3194,1573,469,451,920,51.0%,14m
6445,3,starlancer,3194,1607,212,209,421,50.4%,16m
6445,3,[神的降临]Lancelot,3194,1528,188,183,371,50.7%,29m
6445,2,神咖,3194,1555,112,130,242,46.3%,17m
6445,3,IIIIIIIII,3194,733,86,85,171,50.3%,46m
6445,3,[Holyam]芥子尘,3194,1378,51,59,110,46.4%,30m
6445,3,张伟伟,3194,926,40,27,67,59.7%,27m
6445,3,张澈凯,3194,707,27,28,55,49.1%,9m
6445,3,国服工蜂,3194,391,16,4,20,80.0%,31m
6445,3,[谐的一逼]blowing,3194,236,12,9,21,57.1%,45m
6445,3,[辩证法]徐政委遛弯,3194,271,12,11,23,52.2%,44m
6445,2,[Epochs]Change,3194,241,10,6,16,62.5%,19m
6445,2,LayoFlash,3194,208,10,7,17,58.8%,21m
6445,3,你那么矮怎么不去,3194,168,5,2,7,71.4%,25m
6445,3,LTbyun,3194,152,5,10,15,33.3%,43m
6445,3,地堡专业户,3194,162,4,6,10,40.0%,6m
6445,3,TENT,3194,37,3,4,7,42.9%,11m
6445,3,kidd,3194,96,3,9,12,25.0%,12m
6445,3,[妈个鸡谐会]MaGeJiTerran,3194,0,1,0,1,100.0%,18m
6445,2,万有引力,3194,0,1,0,1,100.0%,6m
6445,3,[gs唐建松]秋风,3194,30,1,2,3,33.3%,41m
6467,3,[TGDD]安静,3193,1317,105,107,212,49.5%,29m
6467,3,[浙江大学战队]混元星际掌门人,3193,1050,92,85,177,52.0%,28m
6467,3,草那个女孩,3193,723,43,47,90,47.8%,43m
6467,3,lhp,3193,867,33,43,76,43.4%,23m
6467,3,[Chaos6]Intothepower,3193,623,26,16,42,61.9%,20m
6467,3,玄叶清,3193,376,15,6,21,71.4%,13m
6467,3,[折翼丿天使灬]evilangel,3193,393,14,8,22,63.6%,6m
6467,2,[卡布基诺]全太阳,3193,418,14,27,41,34.1%,42m
6467,3,教主,3193,296,11,9,20,55.0%,43m
6467,3,[XC丨星创]真实大帝,3193,120,5,6,11,45.5%,9m
6467,2,Lzzz,3193,88,2,1,3,66.7%,42m
6467,3,[城市规划局]Altale,3193,0,1,0,1,100.0%,17m
6467,3,golshenlan,3193,30,1,4,5,20.0%,43m
6467,3,[时间]Icarus,3193,0,0,1,1,0.0%,13m
6481,3,卡洛斯,3192,1561,98,103,201,48.8%,20m
6481,3,Riricho,3192,1609,73,70,143,51.0%,24m
6481,3,zzzzzz,3192,966,37,38,75,49.3%,43m
6481,3,[scstar]Rose,3192,519,22,11,33,66.7%,15m
6481,3,不月巴的月半子,3192,384,15,15,30,50.0%,19m
6481,3,[ZJU]ROBIN,3192,114,5,3,8,62.5%,9m
6481,3,在城,3192,116,5,5,10,50.0%,10m
6481,3,[爆裂吧现实]liurui,3192,60,3,3,6,50.0%,23m
6481,1,只会打一波,3192,0,1,1,2,50.0%,1h
6481,2,那棵树生气了,3192,0,0,1,1,0.0%,1h
6481,3,[艾尔之巅]撒旦,3192,0,0,1,1,0.0%,6m
6481,3,[地球娱乐公会]Gogogo,3192,0,0,3,3,0.0%,17m
6493,3,[TeamLP]gluvly,3191,1400,288,242,530,54.3%,20m
6493,3,漆黑之帐,3191,960,175,166,341,51.3%,41m
6493,3,stephano,3191,1575,148,148,296,50.0%,3m
6493,3,断罪,3191,845,81,70,151,53.6%,10m
6493,3,xczy,3191,863,37,45,82,45.1%,11m
6493,3,YuShen,3191,390,15,16,31,48.4%,20m
6493,3,[LNT]妙手空空,3191,146,6,7,13,46.2%,46m
6493,3,[AreS神会]numberone,3191,144,5,6,11,45.5%,25m
6493,3,[没有F2]旋涡云,3191,166,4,1,5,80.0%,42m
6493,2,对面都是牲口畜生,3191,93,4,2,6,66.7%,23m
6493,3,括约肌撕裂者,3191,116,4,9,13,30.8%,25m
6493,1,skyjiro,3191,0,1,0,1,100.0%,1h
6493,3,[犹豫]luuuunacia,3191,0,1,1,2,50.0%,12m
6506,3,风尊者,3190,1203,54,37,91,59.3%,8m
6506,3,[IMRTS2]大森林里的毛毛虫,3190,960,47,49,96,49.0%,44m
6506,3,云起碧落,3190,572,46,42,88,52.3%,24m
6506,3,[南京工业大学]Laplace,3190,907,39,27,66,59.1%,15m
6506,3,[黑豹]rubyruby,3190,907,39,41,80,48.8%,27m
6506,3,[守护最美依依]好汉饶命,3190,143,19,30,49,38.8%,24m
6506,3,[输了穿女装]chara,3190,114,5,2,7,71.4%,28m
6506,1,FirstKiller,3190,163,5,4,9,55.6%,34m
6506,3,[华弟是巴子]Johnny,3190,144,5,6,11,45.5%,18m
6506,3,雷老虎,3190,58,3,5,8,37.5%,12m
6506,3,空虚公子,3190,88,3,8,11,27.3%,17m
6506,2,ForFun,3190,0,2,3,5,40.0%,5m
6506,3,IIIIIIIIIII,3190,0,0,1,1,0.0%,29m
6519,3,Luvjiujiujiu,3189,1479,139,138,277,50.2%,43m
6519,3,[诠释城市化]讲武德的年轻人,3189,1390,113,115,228,49.6%,29m
6519,2,GGtaste,3189,792,90,95,185,48.6%,43m
6519,3,IIIIIIIIIIII,3189,1585,83,80,163,50.9%,43m
6519,3,情殇,3189,940,36,33,69,52.2%,12m
6519,3,[别看了就你了]路鸣泽,3189,556,22,19,41,53.7%,42m
6519,3,[透一下清酒]starbaby,3189,391,19,16,35,54.3%,6m
6519,3,小渊,3189,151,7,6,13,53.8%,16m
6519,3,一心义,3189,172,7,6,13,53.8%,41m
6519,3,[TLGD]小猛一米一,3189,88,3,2,5,60.0%,17m
6519,3,[觀天習文]光陨,3189,30,2,2,4,50.0%,12m
6519,3,herO,3189,0,1,0,1,100.0%,3m
6519,3,[华夏预备队]火龙果,3189,0,1,0,1,100.0%,5m
6519,3,[孤影眾]仙凡魔人,3189,0,0,1,1,0.0%,28m
6519,3,Strik,3189,0,0,1,1,0.0%,16m
6519,3,[武大萌新]箫声咽,3189,0,0,4,4,0.0%,10m
6535,3,BOOS,3188,1058,202,196,398,50.8%,29m
6535,3,pianobear,3188,1572,139,128,267,52.1%,3m
6535,2,ZHI,3188,734,51,53,104,49.0%,42m
6535,3,[DDOS二队]血腥屠杀,3188,1128,43,45,88,48.9%,25m
6535,3,[雷本]马格努斯,3188,972,39,34,73,53.4%,45m
6535,3,[GAGA]KingDOOM,3188,718,28,26,54,51.9%,11m
6535,3,[雾雨魔法森林]聊然,3188,414,17,15,32,53.1%,22m
6535,3,邪皇星,3188,287,10,5,15,66.7%,25m
6535,1,David,3188,93,5,3,8,62.5%,1h
6535,3,Tosswomen,3188,30,2,0,2,100.0%,28m
6535,3,知之曰明哲,3188,58,2,1,3,66.7%,46m
6535,3,[黑粉头子]XuWangFC,3188,0,1,0,1,100.0%,12m
6535,3,mycoolbin,3188,0,1,0,1,100.0%,9m
6535,3,Murky,3188,30,1,1,2,50.0%,11m
6535,3,andy,3188,30,1,5,6,16.7%,27m
6535,3,无尽虚空丶,3188,0,0,1,1,0.0%,31m
6535,3,monokuma,3188,0,0,1,1,0.0%,17m
6552,3,MOSFET,3187,1482,128,113,241,53.1%,31m
6552,3,zbzbzzb,3187,1511,119,110,229,52.0%,30m
6552,3,michals,3187,613,54,52,106,50.9%,27m
6552,3,llllllllllll,3187,257,18,16,34,52.9%,41m
6552,3,[万物齐一]随心自在,3187,262,13,15,28,46.4%,44m
6552,3,为了艾尔,3187,129,3,13,16,18.8%,20m
6552,3,Antarc,3187,30,1,7,8,12.5%,16m
6552,3,Astral,3187,0,0,1,1,0.0%,46m
6552,3,[老八美食团]栗悟饭和龟波功,3187,0,0,2,2,0.0%,42m
6561,3,[名人集团]星海游牧,3186,1411,71,74,145,49.0%,12m
6561,3,[野人time]白河愁,3186,1034,69,60,129,53.5%,28m
6561,3,wanzxl,3186,667,35,23,58,60.3%,44m
6561,3,[青娱乐]llllllllll,3186,365,12,8,20,60.0%,26m
6561,2,一叶知秋,3186,193,7,4,11,63.6%,30m
6561,3,[Faith]落樱吹雪,3186,182,7,9,16,43.8%,9m
6561,3,无梦灬生,3186,58,3,1,4,75.0%,24m
6561,3,Crolin,3186,30,2,0,2,100.0%,29m
6561,1,JINWONTACK,3186,46,2,7,9,22.2%,42m
6561,3,二狗村王富贵,3186,0,1,1,2,50.0%,31m
6561,3,[柚子Yuzu]灶门灬弥豆子,3186,0,0,1,1,0.0%,13m
6572,3,[永恒中华]吴阿斗,3185,1639,276,257,533,51.8%,3m
6572,3,llllllllllll,3185,982,78,80,158,49.4%,8m
6572,3,rigido,3185,422,25,14,39,64.1%,45m
6572,3,ffgi,3185,513,20,14,34,58.8%,43m
6572,3,[你已经死啦]Leaves,3185,342,16,2,18,88.9%,17m
6572,3,[大小姐保护协]迪奥布斯,3185,194,7,5,12,58.3%,12m
6572,3,[铭刻於红魂丶]芙兰朵樱,3185,30,2,2,4,50.0%,26m
6572,2,[Liger]冷冷菲尔德,3185,0,2,6,8,25.0%,19m
6572,3,姿势摆好了,3185,0,1,0,1,100.0%,9m
6572,3,[CPT]fengshao,3185,0,1,0,1,100.0%,31m
6572,3,wsp,3185,30,1,2,3,33.3%,15m
6572,3,[C23]TheKing,3185,0,0,1,1,0.0%,44m
6584,3,水墨孤影,3184,1315,126,120,246,51.2%,43m
6584,3,[喝瓶宝矿力]朝田诗乃,3184,1011,71,56,127,55.9%,25m
6584,3,Formidable,3184,1433,57,57,114,50.0%,44m
6584,3,Cozyboy,3184,924,33,41,74,44.6%,25m
6584,3,假情假意贾斯丁,3184,484,19,18,37,51.4%,13m
6584,3,llllllllllll,3184,73,17,19,36,47.2%,16m
6584,3,永恒之泪,3184,374,13,9,22,59.1%,45m
6584,1,嵩嵩哥,3184,167,7,3,10,70.0%,1h
6584,3,DALI,3184,0,4,1,5,80.0%,22m
6584,3,[cgnb]技不如人甘拜下风,3184,60,3,1,4,75.0%,6m
6584,3,[南邮憨B联盟]苍穹浮云,3184,60,2,2,4,50.0%,41m
6584,3,[逸仙谐星]我大意了啊没有闪,3184,0,1,0,1,100.0%,9m
6584,3,[萌皮战狼]会说话的铜币喵,3184,0,0,1,1,0.0%,16m
6597,3,神族是我爹,3183,1577,107,96,203,52.7%,30m
6597,3,玩家,3183,171,8,5,13,61.5%,25m
6597,2,[乘风寻道]步荀仙,3183,146,4,2,6,66.7%,13m
6597,3,[EXA]ZergGlory,3183,58,2,2,4,50.0%,25m
6597,3,[咿呀]独舞灬,3183,0,1,0,1,100.0%,17m
6597,3,丿痞灬子,3183,0,1,0,1,100.0%,6m
6597,3,韩氏大叔,3183,0,1,1,2,50.0%,9m
6597,3,Cvery,3183,30,1,2,3,33.3%,13m
6597,3,[休伯利安殇]selflove,3183,0,0,1,1,0.0%,44m
6597,3,[SUST1]IIIIIIIIIIII,3183,0,0,1,1,0.0%,41m
6597,3,kaiwen,3183,0,0,1,1,0.0%,20m
6608,3,red,3182,289,10,5,15,66.7%,40m
6608,3,魔法大爷赵本山,3182,126,8,7,15,53.3%,24m
6608,3,风真喧嚣啊,3182,208,8,7,15,53.3%,12m
6608,3,咪咕猫,3182,121,3,2,5,60.0%,3m
6608,3,[虚空光辉舰]姐姐要用力干哥哥,3182,0,1,1,2,50.0%,15m
6608,3,[Kiloli]Flight,3182,30,1,1,2,50.0%,11m
6608,3,[XYFANS]一个菜鸟,3182,0,0,1,1,0.0%,46m
6608,3,NingYin,3182,0,0,4,4,0.0%,14m
6616,3,SnowLeopard,3181,1125,198,189,387,51.2%,6m
6616,3,挚爱毛毛,3181,774,34,19,53,64.2%,41m
6616,3,神一般的路人甲,3181,624,27,14,41,65.9%,6m
6616,3,Leyn,3181,556,20,19,39,51.3%,14m
6616,3,Alone,3181,300,10,18,28,35.7%,24m
6616,3,[USNavy]Enterprise,3181,44,8,11,19,42.1%,13m
6616,1,[暴雪养鸡场]悠然而小米,3181,48,5,3,8,62.5%,49m
6616,3,[FPT]vajva,3181,116,4,4,8,50.0%,28m
6616,3,[指尖奶茶]池田小雪,3181,141,3,1,4,75.0%,5m
6616,3,星之黄叶,3181,60,3,2,5,60.0%,22m
6616,3,[白鸦]BTseven,3181,58,2,1,3,66.7%,45m
6616,3,[查尔之矛]小金爱吃炸酥肉,3181,46,2,1,3,66.7%,6m
6616,2,[五月花]蟑螂舞姬,3181,0,1,0,1,100.0%,1h
6616,3,小吕布,3181,0,1,1,2,50.0%,30m
6616,3,lllllllllll,3181,0,1,1,2,50.0%,29m
6616,3,[HSCII]TYbestT,3181,30,1,2,3,33.3%,13m
6616,3,吉恩,3181,0,0,1,1,0.0%,23m
6616,3,胡阳,3181,0,0,3,3,0.0%,41m
6634,2,[武力征服]有志者事竟成,3180,887,321,302,623,51.5%,23m
6634,3,[火焰雷兽]IIIIIIIIIIII,3180,1560,308,290,598,51.5%,44m
6634,3,Batman,3180,1548,208,204,412,50.5%,17m
6634,3,楽之庄,3180,1522,195,185,380,51.3%,3m
6634,3,黑色浪潮,3180,1328,174,168,342,50.9%,14m
6634,3,触怒,3180,1474,168,139,307,54.7%,31m
6634,3,深渊,3180,1249,96,99,195,49.2%,6m
6634,2,啊五环,3180,1069,93,112,205,45.4%,7m
6634,3,Niko,3180,208,9,5,14,64.3%,45m
6634,3,IIIIII,3180,133,6,0,6,100.0%,13m
6634,3,[上古世纪]ylnx,3180,116,4,3,7,57.1%,18m
6634,3,magicTerran,3180,30,2,2,4,50.0%,11m
6634,3,[菜鸡悲]zzxnbaaa,3180,30,1,1,2,50.0%,10m
6634,3,[南京龟广州兔]我是鳗鱼,3180,0,0,1,1,0.0%,5m
6634,3,[我队伍很强大]滑稽的王尼玛,3180,0,0,1,1,0.0%,5m
6634,3,念安玺,3180,0,0,1,1,0.0%,21m
6634,3,[IBE]爱花,3180,0,0,1,1,0.0%,30m
6634,3,雨惑,3180,0,0,1,1,0.0%,9m
6652,3,Sucer,3179,1533,231,207,438,52.7%,13m
6652,3,[UNNC]亘古的雷斯神,3179,999,38,34,72,52.8%,15m
6652,3,[KKA1]Chost,3179,752,31,24,55,56.4%,12m
6652,3,[棱角]多边形棱角怪物,3179,542,20,19,39,51.3%,29m
6652,3,[纸壳]重创刀锋女王,3179,306,12,9,21,57.1%,26m
6652,3,过期情书,3179,242,8,4,12,66.7%,30m
6652,3,[洁白之巅]弄出一个大新闻,3179,60,3,1,4,75.0%,44m
6652,3,ShiyuN,3179,30,1,1,2,50.0%,9m
6652,3,[绝望星灵]陨落,3179,0,1,2,3,33.3%,3m
6652,3,[哔哩哔哩乾杯]MrCoke,3179,0,0,1,1,0.0%,22m
6652,3,SCHIICKSAL,3179,0,0,1,1,0.0%,13m
6652,3,[AImer蝶]AimerShine,3179,0,0,1,1,0.0%,44m
6664,3,孙奕秋,3178,1579,739,720,1459,50.7%,45m
6664,3,[YA]一个渣渣,3178,1475,193,183,376,51.3%,23m
6664,3,[神辉天耀]SYT,3178,759,35,24,59,59.3%,25m
6664,3,最佳损友,3178,601,25,17,42,59.5%,20m
6664,3,[瘾大眼瞎]踢歪踢歪,3178,168,7,8,15,46.7%,18m
6664,2,[在下菜鸡一只]sadd,3178,118,3,0,3,100.0%,25m
6664,3,FireUrWeapon,3178,60,2,4,6,33.3%,18m
6664,3,[萌新保护谐会]雅典幽灵,3178,0,1,0,1,100.0%,23m
6664,2,[废铁组]晓天之锚,3178,93,1,5,6,16.7%,5m
6664,3,菜鸡桑苏一二三,3178,0,0,1,1,0.0%,6m
6664,3,Yolansa,3178,0,0,2,2,0.0%,15m
6675,1,[红萌馆]小孩子,3177,1486,264,297,561,47.1%,40m
6675,3,warriarking,3177,1525,185,185,370,50.0%,41m
6675,3,scyarctos,3177,1109,171,144,315,54.3%,22m
6675,3,[暴雪三十二隊]Presents,3177,976,140,119,259,54.1%,10m
6675,3,嗜虐,3177,1398,66,57,123,53.7%,15m
6675,3,我考掉线了,3177,1080,58,66,124,46.8%,13m
6675,3,[你为什么要打]wotmmeimingz,3177,1182,56,56,112,50.0%,41m
6675,2,[可可萝]优衣说噫,3177,685,49,47,96,51.0%,27m
6675,3,可以小声一点吗,3177,708,31,28,59,52.5%,45m
6675,3,海子,3177,119,6,3,9,66.7%,25m
6675,2,山内丨樱良,3177,44,5,2,7,71.4%,44m
6675,2,[北极光小组]藏逝,3177,46,5,2,7,71.4%,14m
6675,2,[孤影眾]随心所欲,3177,166,5,5,10,50.0%,23m
6675,3,人族死法示范,3177,163,4,1,5,80.0%,28m
6675,3,[SCoM]云和山的彼端,3177,56,2,6,8,25.0%,42m
6675,3,李嘉图,3177,0,1,4,5,20.0%,28m
6691,3,Aldnoah,3176,1258,71,75,146,48.6%,9m
6691,3,哇哇哇,3176,296,65,11,76,85.5%,14m
6691,3,莘庄老司机,3176,1211,56,60,116,48.3%,25m
6691,3,DragonFly,3176,629,23,27,50,46.0%,43m
6691,3,[4wd]先驱音速,3176,378,15,8,23,65.2%,15m
6691,3,[秋千千秋]淦三小,3176,394,14,16,30,46.7%,41m
6691,3,Darker,3176,380,14,17,31,45.2%,31m
6691,3,[Mou]KoReyi,3176,124,8,5,13,61.5%,20m
6691,2,[Hist]IIIIIIIIIIII,3176,176,6,22,28,21.4%,30m
6691,2,RAISON,3176,44,5,2,7,71.4%,1h
6691,3,以父之名,3176,60,3,5,8,37.5%,26m
6691,3,[基金会]涅普涅普,3176,30,1,1,2,50.0%,24m
6691,3,Daydreamer,3176,0,1,2,3,33.3%,24m
6691,2,Beijingfans,3176,94,1,5,6,16.7%,25m
6691,3,gokoururi,3176,0,0,1,1,0.0%,26m
6706,2,joker,3175,1350,92,97,189,48.7%,3m
6706,2,[多头龙]Mint,3175,722,72,95,167,43.1%,31m
6706,3,xiemo,3175,597,58,52,110,52.7%,44m
6706,3,[一切只為亮騷]星际大叔,3175,1433,57,61,118,48.3%,23m
6706,3,ODaNobuNaga,3175,592,21,23,44,47.7%,26m
6706,3,[幻想神社]远空,3175,210,7,10,17,41.2%,5m
6706,2,教父,3175,140,3,0,3,100.0%,33m
6706,2,[风神少女]射命丸文,3175,0,3,0,3,100.0%,4m
6706,3,咋瓦鲁多,3175,30,2,2,4,50.0%,20m
6706,1,[S09]asuna,3175,0,1,2,3,33.3%,41m
6706,3,[Beastp]菱葉,3175,0,0,1,1,0.0%,45m
6717,3,[小金上天队]费拉不堪凯露酱,3174,844,34,21,55,61.8%,46m
6717,3,[落魄山]吕布粉丝,3174,681,28,29,57,49.1%,6m
6717,3,MagicBerries,3174,164,13,8,21,61.9%,18m
6717,3,[SK]IIIIIIIII,3174,114,4,3,7,57.1%,21m
6717,3,[rush2]Perfect,3174,88,3,6,9,33.3%,12m
6717,2,[为了艾萌酱]敏女王的虫群,3174,0,2,3,5,40.0%,43m
6717,3,[沙星部]冷艳全欺雪,3174,30,1,5,6,16.7%,9m
6717,3,[最菜战队]天梯白给鸡,3174,0,0,1,1,0.0%,11m
6725,3,[NVKR]跳跳虎,3173,1558,570,526,1096,52.0%,5m
6725,3,zjd,3173,873,137,141,278,49.3%,42m
6725,3,IyYHL,3173,567,24,16,40,60.0%,29m
6725,3,SoO,3173,488,19,19,38,50.0%,44m
6725,3,[玄武堂]taq,3173,406,16,14,30,53.3%,18m
6725,3,[SoloAs]白泽,3173,396,15,9,24,62.5%,27m
6725,3,[老油条战队4]萌友碳机遭到公鸡,3173,321,14,12,26,53.8%,20m
6725,3,沉陷,3173,323,13,6,19,68.4%,27m
6725,3,[多个老年人]快乐星际不快乐,3173,233,8,3,11,72.7%,41m
6725,3,[神武骑士团]wang,3173,208,6,2,8,75.0%,20m
6725,3,法克鱿,3173,60,3,2,5,60.0%,17m
6725,3,LEGEND,3173,146,3,4,7,42.9%,6m
6725,2,LANAYA,3173,0,2,0,2,100.0%,1h
6725,3,墨霜,3173,30,1,2,3,33.3%,41m
6725,1,火鸡味锅巴,3173,0,1,5,6,16.7%,18m
6725,3,麻烦对面崩下游戏,3173,0,0,2,2,0.0%,24m
6741,3,鸽子军团长,3172,621,67,61,128,52.3%,16m
6741,3,哎呦灬姑凉,3172,1346,58,60,118,49.2%,31m
6741,2,Rocket,3172,303,29,44,73,39.7%,26m
6741,3,Bestme,3172,604,25,20,45,55.6%,4m
6741,3,[今天超市打折]扬扬,3172,269,25,31,56,44.6%,41m
6741,3,[低调且自信]低调虐菜,3172,198,20,15,35,57.1%,18m
6741,3,[埃蒙好可爱]蛋黄加汤,3172,392,19,8,27,70.4%,25m
6741,3,东成西就,3172,532,19,22,41,46.3%,27m
6741,3,[四叶草]焰野辞旧,3172,334,14,9,23,60.9%,44m
6741,3,[UNAME]Lancelot,3172,264,11,5,16,68.8%,29m
6741,1,ElderArtist,3172,162,7,3,10,70.0%,42m
6741,2,真的好难,3172,0,4,1,5,80.0%,13m
6741,3,[TPoA]Dark,3172,30,2,1,3,66.7%,12m
6741,3,[幽冥之狼]Funny,3172,51,2,4,6,33.3%,11m
6741,3,手本,3172,30,1,7,8,12.5%,5m
6741,3,[我们是无敌的]IIIIIIIIIIII,3172,0,0,1,1,0.0%,12m
6757,3,[飞云之上]HelloWorld,3171,918,57,50,107,53.3%,9m
6757,3,游戏怎么玩淦真难,3171,639,29,14,43,67.4%,25m
6757,3,[艾杀星]小艾艾,3171,58,7,4,11,63.6%,28m
6757,3,Premise,3171,141,3,5,8,37.5%,41m
6757,3,SWORD,3171,96,2,0,2,100.0%,12m
6757,3,[HsSo0]呆呆神了,3171,30,2,3,5,40.0%,46m
6757,3,[汉东男团]一心求死,3171,0,1,0,1,100.0%,17m
6757,3,[臆想狂]北港正经猫娘,3171,0,1,1,2,50.0%,23m
6757,3,[WIK]Faker,3171,30,1,5,6,16.7%,17m
6757,3,[8999ms]Nero,3171,0,0,1,1,0.0%,9m
6757,3,[泰伦避难所I]贰玥,3171,0,0,2,2,0.0%,26m
6757,3,[哔翻天梯鸡]BrandoFSu,3171,0,0,3,3,0.0%,25m
6769,3,[AOT]LHooM,3170,1581,244,243,487,50.1%,27m
6769,3,Pasy,3170,1517,204,171,375,54.4%,46m
6769,3,神明的宠儿,3170,993,103,114,217,47.5%,9m
6769,3,特兰克斯,3170,1492,87,77,164,53.0%,20m
6769,3,ZGMFImpulse,3170,926,36,32,68,52.9%,10m
6769,3,星际之旅雷应昊,3170,600,23,27,50,46.0%,13m
6769,3,滴答滴的滴滴,3170,176,7,6,13,53.8%,5m
6769,3,reality,3170,152,5,9,14,35.7%,26m
6769,3,月双望乡,3170,114,4,5,9,44.4%,12m
6769,3,shadowking,3170,30,2,0,2,100.0%,14m
6769,3,[吕布门下弟子]野兵营输不了,3170,30,2,1,3,66.7%,27m
6769,3,[EporD]木下,3170,0,1,0,1,100.0%,9m
6769,3,[埃蒙好可爱]dragon,3170,30,1,2,3,33.3%,6m
6769,3,空白,3170,0,0,1,1,0.0%,5m
6769,3,[Gate丶]FFFIRE,3170,0,0,5,5,0.0%,24m
6784,3,少林寺的小道士,3169,1565,193,194,387,49.9%,28m
6784,3,[打造东软一流]Hadles,3169,352,26,17,43,60.5%,41m
6784,3,[SK]虎丶痴,3169,691,26,21,47,55.3%,44m
6784,3,[萝莉控丶]萌萌哒可爱小蓝藻,3169,233,25,8,33,75.8%,9m
6784,3,[鱼玩]上杉冰妍,3169,442,19,6,25,76.0%,30m
6784,3,建筑老师陈宏,3169,128,6,3,9,66.7%,42m
6784,3,徘徊,3169,126,4,9,13,30.8%,15m
6784,3,[UNDEAT]Nazul,3169,143,3,1,4,75.0%,22m
6784,3,[武大萌新]shisizhong,3169,58,2,1,3,66.7%,22m
6784,2,[GalArC]克诺索拉罗,3169,0,1,0,1,100.0%,22m
6784,3,panshixiang,3169,0,1,0,1,100.0%,4m
6784,3,[废墟图书館]KelThuzad,3169,96,1,2,3,33.3%,30m
6784,3,[踌躇]看我出手盘,3169,30,1,2,3,33.3%,24m
6784,3,[Fish闪闪]Sunrise,3169,30,1,6,7,14.3%,20m
6784,3,[比企谷八幡]半夏夜微凉,3169,0,0,1,1,0.0%,11m
6784,2,[今夜打老虎]娱乐圈弨哥,3169,0,0,2,2,0.0%,10m
6784,3,[优秀班级]十好少年,3169,0,0,2,2,0.0%,40m
6784,3,[咏春]InNoVation,3169,0,0,6,6,0.0%,29m
6802,3,gayoma,3168,1590,312,294,606,51.5%,17m
6802,3,[艾洛格姆]阿尔托利亚,3168,406,52,50,102,51.0%,11m
6802,3,[Shawk]六十五额降低无锡,3168,363,18,2,20,90.0%,41m
6802,3,[XYG]越打越菜,3168,490,18,15,33,54.5%,17m
6802,3,save,3168,194,9,15,24,37.5%,46m
6802,3,你们都上网冲浪啊,3168,144,6,3,9,66.7%,29m
6802,3,[谐星算什么]盧二虎,3168,58,3,0,3,100.0%,43m
6802,3,菜虚鲲,3168,30,2,1,3,66.7%,12m
6802,3,[scstar]YyYy,3168,0,1,2,3,33.3%,23m
6802,3,勇冠三军,3168,0,0,1,1,0.0%,6m
6812,2,[AX]大燕飘爷,3167,1566,185,180,365,50.7%,5m
6812,3,[AX]风暴天使,3167,936,33,40,73,45.2%,6m
6812,3,CAL,3167,822,30,31,61,49.2%,8m
6812,3,deer,3167,560,24,24,48,50.0%,45m
6812,3,好好玩加油别放弃,3167,553,21,16,37,56.8%,23m
6812,3,[目標諾森德]哈哈哈拉开,3167,520,19,19,38,50.0%,23m
6812,3,Devil,3167,278,13,1,14,92.9%,31m
6812,3,[吕布看女团]fbh,3167,245,10,15,25,40.0%,14m
6812,3,派大星,3167,192,5,7,12,41.7%,27m
6812,3,人生若只如初见,3167,58,3,0,3,100.0%,26m
6812,1,[菜茑遊樂場]审判者,3167,121,3,1,4,75.0%,8m
6812,3,[铁路第二监狱]ODSTJerry,3167,62,3,3,6,50.0%,10m
6812,2,[虫子必须死]RippeR,3167,0,0,1,1,0.0%,1h
6812,3,[谁在呼叫舰队]半夏的忧伤,3167,0,0,1,1,0.0%,44m
6812,3,[我们是无敌的]小狗,3167,0,0,1,1,0.0%,14m
6827,3,Dlive,3166,1548,119,117,236,50.4%,11m
6827,3,花悦婿艳,3166,530,32,37,69,46.4%,26m
6827,3,石家庄枪兵王,3166,475,21,16,37,56.8%,31m
6827,3,herNPC,3166,422,16,16,32,50.0%,5m
6827,3,[lxh123]往事已然苍老,3166,262,15,15,30,50.0%,11m
6827,3,[葛温王下骑士]卫宫士郎,3166,239,11,0,11,100.0%,23m
6827,3,[miku守护]miku,3166,148,7,7,14,50.0%,27m
6827,3,[Shawk]萌新神族,3166,118,5,3,8,62.5%,9m
6827,2,AzuraGLJ,3166,117,4,3,7,57.1%,1h
6827,3,VanNESS,3166,0,3,2,5,60.0%,39m
6827,3,提拉米苏,3166,88,3,4,7,42.9%,10m
6827,3,[我们的奇迹]雪色光晕橙色奇迹,3166,0,1,0,1,100.0%,11m
6827,3,IIIIIIIIIIII,3166,0,1,1,2,50.0%,20m
6827,3,[送分大佬]海若有因,3166,0,1,3,4,25.0%,12m
6827,3,[Anticw]脚踏飞剑来看你,3166,0,0,1,1,0.0%,4m
6827,3,FigoChu,3166,0,0,1,1,0.0%,9m
6843,2,Fancy,3165,702,105,93,198,53.0%,31m
6843,3,[QWQa]今日解签宜下江南,3165,961,95,84,179,53.1%,20m
6843,3,[机械混成旅]菌毯裹尸还,3165,1426,65,61,126,51.6%,5m
6843,3,Welt,3165,58,3,0,3,100.0%,26m
6843,3,修罗,3165,93,2,0,2,100.0%,10m
6843,3,楚休红在水,3165,0,1,0,1,100.0%,13m
6843,2,易水寒亭,3165,0,1,0,1,100.0%,43m
6843,3,titanium,3165,30,1,2,3,33.3%,15m
6851,2,lllllllllll,3164,1399,532,533,1065,50.0%,44m
6851,3,[深黑幻想]俺霸天下,3164,738,35,23,58,60.3%,11m
6851,3,[TPoA]laplace,3164,523,22,14,36,61.1%,14m
6851,3,[killer]操我的队友不在,3164,497,19,13,32,59.4%,20m
6851,3,黑骑,3164,202,13,15,28,46.4%,24m
6851,3,Sky,3164,346,12,12,24,50.0%,22m
6851,3,[扫黄]角落亦清,3164,0,0,1,1,0.0%,20m
6851,3,提督丶大人,3164,0,0,1,1,0.0%,16m
6851,3,[I20I]sixks,3164,0,0,4,4,0.0%,10m
6860,3,ByuN,3163,1589,159,131,290,54.8%,7m
6860,2,京东食尸鬼,3163,1392,60,66,126,47.6%,6m
6860,3,amumu,3163,349,14,14,28,50.0%,13m
6860,3,FsAEzwB,3163,413,14,19,33,42.4%,29m
6860,3,天弑,3163,290,11,5,16,68.8%,31m
6860,1,IIIIIIIIIIII,3163,158,8,8,16,50.0%,42m
6860,1,vivalavida,3163,223,8,11,19,42.1%,40m
6860,3,[鸿泰伟业]战意朦胧,3163,0,4,1,5,80.0%,1h
6860,3,Ares,3163,58,3,2,5,60.0%,11m
6860,3,[湖湖湖]湖以永信,3163,0,1,0,1,100.0%,14m
6860,2,[吞噬够突击队]MaybeLIFE,3163,0,1,1,2,50.0%,19m
6860,3,MASTERLEO,3163,0,0,1,1,0.0%,6m
6860,3,BABYJACKEY,3163,0,0,1,1,0.0%,9m
6860,2,ImmoRtaL,3163,0,0,1,1,0.0%,9m
6860,3,llllllllllll,3163,0,0,2,2,0.0%,9m
6875,3,光头哥的妹夫,3162,1497,162,127,289,56.1%,24m
6875,3,[love西瓜]只爱内战,3162,1559,118,121,239,49.4%,11m
6875,3,Tany,3162,1347,75,75,150,50.0%,17m
6875,3,[菊花朵朵开]地堡小王子,3162,1182,53,54,107,49.5%,21m
6875,3,[CNboys]月赋情长,3162,587,29,24,53,54.7%,14m
6875,3,[Rhusky]星海迷航,3162,576,27,26,53,50.9%,42m
6875,3,杀你血吗,3162,481,26,26,52,50.0%,41m
6875,1,[超级大谐星]唐宋元明清,3162,315,14,10,24,58.3%,24m
6875,3,lllllllllll,3162,219,8,12,20,40.0%,9m
6875,3,人类先锋,3162,146,5,8,13,38.5%,22m
6875,3,[TNLet]奈拉齐姆渣女头子,3162,0,4,1,5,80.0%,1h
6875,3,[鬼谷]零壹魔,3162,162,4,2,6,66.7%,30m
6875,3,[三杯鸡]抱走文圭丽,3162,118,3,0,3,100.0%,18m
6875,3,烤鱼赋予你,3162,30,2,2,4,50.0%,15m
6875,3,[asahia]喜欢萝莉指挥官,3162,0,1,0,1,100.0%,7m
6875,3,[28CM]有蝠同享,3162,30,1,2,3,33.3%,24m
6875,3,[沙漠老男人]gcd,3162,30,1,3,4,25.0%,21m
6892,3,[星辰之海]巴御前超可爱,3161,1337,72,49,121,59.5%,15m
6892,3,风吹裤裆蛋蛋疼,3161,1137,45,43,88,51.1%,5m
6892,3,磨豆腐,3161,498,21,17,38,55.3%,15m
6892,3,MMA,3161,300,12,5,17,70.6%,28m
6892,2,Occupy,3161,292,11,9,20,55.0%,30m
6892,3,蛤蛤的皇位之争,3161,332,11,18,29,37.9%,24m
6892,3,Async,3161,256,9,9,18,50.0%,42m
6892,3,磊哥,3161,115,4,14,18,22.2%,24m
6892,3,[SBS]那你还挺棒的,3161,58,2,3,5,40.0%,5m
6892,2,鬼与归期,3161,0,1,0,1,100.0%,1h
6892,2,Summer,3161,0,0,1,1,0.0%,56m
6892,3,[Naz]lllllllllll,3161,0,0,1,1,0.0%,25m
6892,3,井河阿莎姬,3161,0,0,1,1,0.0%,30m
6905,3,[景沐阳]非玩家角色,3160,732,136,126,262,51.9%,26m
6905,3,我是一只小小鸟,3160,1415,110,116,226,48.7%,9m
6905,3,海叶枫,3160,1477,75,63,138,54.3%,9m
6905,3,路准,3160,1248,71,64,135,52.6%,10m
6905,3,[Eve联盟]中老年妇女之友,3160,584,44,35,79,55.7%,13m
6905,3,[BNU]Gray,3160,356,20,16,36,55.6%,16m
6905,3,IIIIIIIIIIII,3160,414,15,15,30,50.0%,9m
6905,3,我是一只鸡,3160,53,10,15,25,40.0%,16m
6905,3,[Rhusky]高考的噩梦,3160,239,8,5,13,61.5%,41m
6905,3,[非洲度假]sora,3160,140,6,3,9,66.7%,13m
6905,3,[中国人寿]司机师傅等等我,3160,58,3,1,4,75.0%,11m
6905,2,简单电脑杀手,3160,94,2,0,2,100.0%,1h
6905,3,Volt,3160,30,2,1,3,66.7%,41m
6905,3,YImbaZapear,3160,0,1,0,1,100.0%,4m
6905,3,Saber,3160,0,1,1,2,50.0%,9m
6905,3,[一戳一蹦跶]桃子,3160,0,0,1,1,0.0%,18m
6905,3,Destiny,3160,0,0,1,1,0.0%,14m
6905,3,[丨SLT丨]易南,3160,0,0,1,1,0.0%,29m
6923,2,[AOAOA]superggn,3159,1589,472,458,930,50.8%,29m
6923,2,[刺蛇互助协会]祝暴雪早日倒闭,3159,1346,242,261,503,48.1%,43m
6923,3,光刻的遗迹,3159,1233,61,58,119,51.3%,45m
6923,3,keter,3159,1344,58,45,103,56.3%,44m
6923,3,曾经小坑刘冬雨,3159,1089,44,37,81,54.3%,27m
6923,3,苦力怕,3159,432,44,47,91,48.4%,9m
6923,3,[菜有菜的道理]RiVer,3159,451,16,15,31,51.6%,25m
6923,3,一拳超人方本座,3159,296,14,14,28,50.0%,9m
6923,3,开图没马,3159,366,14,15,29,48.3%,26m
6923,3,[让让孩子吧]刀光哥天下第一,3159,312,12,11,23,52.2%,23m
6923,1,无疑的滑稽怪,3159,165,5,7,12,41.7%,25m
6923,3,张启晓,3159,30,2,1,3,66.7%,31m
6923,3,[Sicili]暗影,3159,118,2,1,3,66.7%,8m
6923,3,[冰色]幻想郷丨不死之烟,3159,0,1,0,1,100.0%,8m
6923,3,MonkeyKing,3159,0,0,1,1,0.0%,9m
6923,3,[512]XIANGER,3159,0,0,1,1,0.0%,31m
6939,2,这就是青春,3158,1584,213,223,436,48.9%,13m
6939,3,[旺旺战士]dzz,3158,583,44,28,72,61.1%,12m
6939,3,喜剧明星,3158,871,37,34,71,52.1%,42m
6939,3,对不起我迷路了,3158,736,33,25,58,56.9%,12m
6939,3,梦魂丿逝风,3158,484,25,21,46,54.3%,45m
6939,2,萌新打星际,3158,502,24,37,61,39.3%,31m
6939,3,耗子尾汁,3158,394,17,10,27,63.0%,41m
6939,1,[腥基佬男骸]子午夜梦,3158,0,0,1,1,0.0%,34m
6939,3,蔚狼攻壳,3158,0,0,1,1,0.0%,42m
6939,3,Forevercos,3158,0,0,2,2,0.0%,45m
6939,3,lliilliiiiii,3158,0,0,2,2,0.0%,12m
6950,3,坐下坐下基本懆作,3157,729,103,101,204,50.5%,23m
6950,3,快手一賊丫卩卩,3157,1208,67,71,138,48.6%,45m
6950,3,[运营不放狗招]個性非凡,3157,437,43,38,81,53.1%,25m
6950,3,casear,3157,410,26,16,42,61.9%,46m
6950,3,test,3157,514,22,13,35,62.9%,22m
6950,3,ASURAN,3157,440,17,18,35,48.6%,45m
6950,3,不吉,3157,268,9,7,16,56.2%,30m
6950,2,[好基友手拉手]雷神,3157,141,6,2,8,75.0%,34m
6950,3,真的好玩么,3157,118,5,3,8,62.5%,10m
6950,3,joker,3157,0,4,1,5,80.0%,5m
6950,3,Umbrella,3157,86,4,5,9,44.4%,20m
6950,3,[东大电竞]Dark,3157,60,2,6,8,25.0%,10m
6962,3,清明上河,3156,1653,278,269,547,50.8%,6m
6962,3,[XX丶OO]ReVolution,3156,1586,198,191,389,50.9%,5m
6962,3,[Spin]SJHmilk,3156,1481,100,91,191,52.4%,28m
6962,3,[暴雪十九队]民商法学,3156,1215,91,84,175,52.0%,6m
6962,3,Rookie,3156,783,74,44,118,62.7%,44m
6962,3,RELAX,3156,1407,69,70,139,49.6%,9m
6962,3,[文韬武略]小满冬至霜降惊蛰,3156,1489,65,58,123,52.8%,13m
6962,3,[Beastp]呆萌人族,3156,1271,52,45,97,53.6%,31m
6962,3,GrimPigeon,3156,540,20,28,48,41.7%,29m
6962,3,Zero,3156,428,15,16,31,48.4%,13m
6962,3,FateHarlaown,3156,215,9,16,25,36.0%,17m
6962,3,mikelang,3156,228,8,8,16,50.0%,28m
6962,3,樱岛麻衣,3156,197,6,3,9,66.7%,12m
6962,3,Tummy,3156,118,4,6,10,40.0%,44m
6962,3,Osia,3156,169,4,7,11,36.4%,41m
6962,3,[瘾大眼瞎]虾仔,3156,90,3,8,11,27.3%,41m
6962,3,[莽成一匹野马]费斯特丶聖刃,3156,0,0,1,1,0.0%,16m
6979,3,zzangzj,3155,1159,46,50,96,47.9%,14m
6979,3,夜羽酱,3155,580,30,22,52,57.7%,12m
6979,3,我们还行吧,3155,405,18,7,25,72.0%,16m
6979,3,新的开始,3155,364,12,9,21,57.1%,40m
6979,3,[KPG]俺村的痞子,3155,80,7,9,16,43.8%,42m
6979,3,[Misty]Cup,3155,138,3,1,4,75.0%,23m
6979,3,[TBS]悠悠,3155,58,2,5,7,28.6%,3m
6979,3,以战止战,3155,0,0,1,1,0.0%,42m
6979,3,Creeper,3155,0,0,1,1,0.0%,24m
6979,3,[游戏风云OL]不是猫是狐狸,3155,0,0,1,1,0.0%,45m
6989,2,[gan死x哥]蟑螂舞娘钱赞企,3154,999,122,136,258,47.3%,6m
6989,3,张京华单推人,3154,1523,89,76,165,53.9%,24m
6989,3,ARTHUR,3154,595,29,15,44,65.9%,26m
6989,3,[核电站输不了]barrett,3154,708,28,24,52,53.8%,9m
6989,3,装甲空母加贺,3154,612,23,20,43,53.5%,28m
6989,3,菜鸡小白,3154,249,22,21,43,51.2%,24m
6989,3,IIIIIIIIIIII,3154,381,15,9,24,62.5%,20m
6989,3,西线,3154,172,9,14,23,39.1%,12m
6989,3,Saizuchi,3154,244,8,5,13,61.5%,45m
6989,3,[SBoys]sixsixfive,3154,208,7,10,17,41.2%,31m
6989,3,[目標諾森德]那冬宝用力嗦,3154,217,6,6,12,50.0%,13m
6989,3,[最菜战队]ruin,3154,41,3,6,9,33.3%,42m
6989,3,朽木冬子,3154,30,1,4,5,20.0%,41m
6989,3,DFlame,3154,0,0,1,1,0.0%,42m
6989,3,苟熊三号,3154,0,0,2,2,0.0%,30m
7004,3,[中华何平]CPZ,3153,1549,288,289,577,49.9%,7m
7004,3,[四叶草]我很菜,3153,666,121,114,235,51.5%,41m
7004,3,可爱的蟑螂哥,3153,532,54,58,112,48.2%,11m
7004,3,reality,3153,644,47,54,101,46.5%,11m
7004,3,[落魄山]落叶,3153,755,46,40,86,53.5%,11m
7004,3,绝望尽头还是绝望,3153,424,41,46,87,47.1%,46m
7004,3,[DTeam]逗你玩,3153,564,31,40,71,43.7%,5m
7004,3,MaruTakuNan,3153,677,29,21,50,58.0%,25m
7004,3,柴子狗,3153,487,26,23,49,53.1%,17m
7004,3,来骗来偷袭,3153,207,8,1,9,88.9%,20m
7004,3,[练出来了协会]crazy,3153,202,7,19,26,26.9%,28m
7004,3,丶可樂,3153,165,5,1,6,83.3%,5m
7004,3,ret,3153,122,4,7,11,36.4%,13m
7004,3,[要啥没啥爱咋]临风灬才子,3153,41,3,4,7,42.9%,12m
7004,3,安雨生丶林林,3153,30,2,1,3,66.7%,42m
7004,3,KEVIN,3153,30,2,2,4,50.0%,27m
7020,3,CIAGRAY,3152,1348,98,82,180,54.4%,29m
7020,3,Archer,3152,211,10,6,16,62.5%,29m
7020,3,球场被干星际被干,3152,175,7,9,16,43.8%,17m
7020,3,JInoVation,3152,226,6,10,16,37.5%,45m
7020,3,[咕咕学院]幻想乡乡长,3152,60,2,2,4,50.0%,31m
7020,3,Sos,3152,97,1,2,3,33.3%,29m
7020,3,[谁在呼叫舰队]IIIIIIIIIIII,3152,0,0,1,1,0.0%,13m
7020,3,ElenaHill,3152,0,0,1,1,0.0%,31m
7020,3,谢舜生,3152,0,0,1,1,0.0%,29m
7029,2,[死亡收割]怪叔叔,3151,1539,333,347,680,49.0%,45m
7029,3,[OgiNA]IIIIIIIIIII,3151,818,227,219,446,50.9%,18m
7029,3,你的寝室长,3151,1425,139,137,276,50.4%,44m
7029,3,[TNLet]喵内噶,3151,421,69,43,112,61.6%,6m
7029,3,输本的妹夫,3151,758,38,27,65,58.5%,28m
7029,2,DkkD,3151,777,31,34,65,47.7%,21m
7029,3,[我随便打打的]月季,3151,710,26,27,53,49.1%,10m
7029,3,ZergEarth,3151,244,15,8,23,65.2%,26m
7029,3,莫知我哀,3151,326,15,14,29,51.7%,18m
7029,3,[绮罗]我不当牧师好多年,3151,286,13,2,15,86.7%,23m
7029,3,[无限巅峰]强硬派,3151,339,11,11,22,50.0%,41m
7029,3,llllllllllll,3151,159,9,9,18,50.0%,46m
7029,2,LLLLLLLLLLLL,3151,164,8,5,13,61.5%,18m
7029,1,残日星宿,3151,190,7,4,11,63.6%,1h
7029,3,IllIIIIllllI,3151,0,1,0,1,100.0%,46m
7029,3,williamchen,3151,30,1,2,3,33.3%,3m
7029,3,此地乃虎牢关,3151,0,0,1,1,0.0%,28m
7046,3,DengSIr,3150,842,286,260,546,52.4%,26m
7046,3,圆滚滚,3150,1292,271,267,538,50.4%,11m
7046,3,哀木涕,3150,477,19,15,34,55.9%,46m
7046,3,mydecember,3150,358,15,14,29,51.7%,19m
7046,3,莽爸,3150,382,14,11,25,56.0%,13m
7046,3,[PaPaZ]涅普姬雅,3150,250,8,4,12,66.7%,11m
7046,1,是这个亚可,3150,120,6,2,8,75.0%,16m
7046,3,GIN,3150,198,6,5,11,54.5%,18m
7046,2,猗郁郁噫,3150,121,5,2,7,71.4%,1h
7046,3,黑框蟾蜍,3150,0,3,2,5,60.0%,15m
7046,3,[APT]AsadaShino,3150,30,1,1,2,50.0%,8m
7046,3,[混吃混喝]小瓶橙子味,3150,30,1,5,6,16.7%,22m
7058,3,白衣,3149,1435,144,141,285,50.5%,46m
7058,2,辣味女警黄小色,3149,1028,60,71,131,45.8%,17m
7058,3,恛洄茴廻,3149,1045,48,47,95,50.5%,44m
7058,2,[Borne]Vikingman,3149,673,36,47,83,43.4%,31m
7058,3,天夏,3149,297,21,13,34,61.8%,17m
7058,3,Joshua,3149,536,20,21,41,48.8%,41m
7058,3,FlashFan,3149,312,18,9,27,66.7%,31m
7058,3,苏恩曦,3149,402,17,13,30,56.7%,29m
7058,3,[死宅自救协会]synchronize,3149,361,13,14,27,48.1%,14m
7058,3,陈琛,3149,310,13,21,34,38.2%,9m
7058,3,南城一壶茶,3149,0,5,0,5,100.0%,16m
7058,3,IIIIIIIIIIII,3149,144,4,1,5,80.0%,12m
7058,3,海贼王路飞,3149,172,4,5,9,44.4%,17m
7058,3,星际教父,3149,0,1,1,2,50.0%,29m
7058,2,[DMRe]锦衣年华,3149,0,0,1,1,0.0%,1h
7073,3,油曼,3148,1538,124,119,243,51.0%,26m
7073,3,我不讲武德,3148,979,50,46,96,52.1%,29m
7073,3,哔站直播一一味觉,3148,197,23,9,32,71.9%,11m
7073,3,[satou]可露露,3148,416,21,16,37,56.8%,6m
7073,3,[爱北京]重案组之虎曹达华,3148,180,6,9,15,40.0%,26m
7073,3,free,3148,86,4,3,7,57.1%,26m
7073,3,[凛风]bala,3148,122,4,12,16,25.0%,42m
7073,3,IIIIIIIIIIII,3148,0,1,2,3,33.3%,45m
7073,3,[想考托福的]AnGeee,3148,30,1,2,3,33.3%,28m
7073,3,[Maiar]時崎狂三,3148,0,0,1,1,0.0%,23m
7073,3,肖爸爸给你的绿帽,3148,0,0,1,1,0.0%,29m
7073,3,弱弱的幼女控桑,3148,0,0,2,2,0.0%,3m
7085,3,[韩宗谐会]IIllIIllII,3147,1067,152,117,269,56.5%,22m
7085,3,小树懒懒懒,3147,1422,80,82,162,49.4%,27m
7085,3,王不留行,3147,786,51,50,101,50.5%,12m
7085,3,lllllllll,3147,434,15,21,36,41.7%,30m
7085,3,MarineDD,3147,310,12,11,23,52.2%,28m
7085,3,[一颗赛艇]消失的海岸线,3147,216,8,15,23,34.8%,28m
7085,1,天堂之外,3147,170,7,4,11,63.6%,29m
7085,3,薛定谔的猫,3147,60,3,1,4,75.0%,24m
7085,3,[IMRTS2]ghost,3147,30,2,7,9,22.2%,45m
7085,1,杆子,3147,94,1,2,3,33.3%,3m
7085,3,[超电磁炉]知叶,3147,0,0,1,1,0.0%,9m
7085,3,[Marry]阿塔尼斯,3147,0,0,1,1,0.0%,16m
7085,2,[魔鬼天堂]apiud,3147,0,0,1,1,0.0%,1h
7098,3,[鸡会友狗服人]黄金先生,3146,980,130,116,246,52.8%,45m
7098,3,APOLLO,3146,1309,88,90,178,49.4%,18m
7098,3,帅到被人骂,3146,665,54,29,83,65.1%,27m
7098,3,[SOD]llllllllllll,3146,276,30,31,61,49.2%,24m
7098,3,[GOTAL]二货青年欢乐多,3146,468,23,8,31,74.2%,28m
7098,3,Lilo,3146,346,16,5,21,76.2%,9m
7098,3,lllllllllll,3146,408,15,19,34,44.1%,7m
7098,3,[盖世双谐]最帅男公关,3146,305,11,11,22,50.0%,42m
7098,3,ALEX,3146,188,9,1,10,90.0%,14m
7098,3,青桃煮茶,3146,182,7,9,16,43.8%,3m
7098,3,陈老板的腹肌,3146,211,6,5,11,54.5%,42m
7098,3,[谐神]紫宫初雪,3146,146,5,11,16,31.2%,28m
7098,2,xlking,3146,97,4,2,6,66.7%,43m
7098,3,江峰雨,3146,72,4,5,9,44.4%,45m
7098,3,海外散修厉飞雨,3146,88,3,4,7,42.9%,46m
7098,3,遂宁孙一峰,3146,30,2,2,4,50.0%,29m
7098,3,[RD彩虹小马]XiaoYu,3146,60,2,3,5,40.0%,43m
7098,3,茵蒂克丝酱,3146,60,2,6,8,25.0%,9m
7098,3,[星际老湿鸡]再见宋哈娜,3146,0,0,1,1,0.0%,29m
7098,3,wei,3146,0,0,1,1,0.0%,14m
7098,3,[UGG]Marauder,3146,0,0,1,1,0.0%,27m
7119,3,MLNB,3145,1514,186,178,364,51.1%,45m
7119,3,紫语青酸,3145,1559,105,104,209,50.2%,7m
7119,3,[兆景埋土大学]Rinne,3145,770,31,30,61,50.8%,30m
7119,3,[千古大唐]格里芬安全承包商,3145,646,24,24,48,50.0%,6m
7119,3,IIIIiIIiII,3145,411,19,21,40,47.5%,14m
7119,3,NATE,3145,423,18,11,29,62.1%,9m
7119,3,鹰鸟小鸟,3145,343,15,7,22,68.2%,3m
7119,3,[扔核弹爆大和]Hobo,3145,420,15,15,30,50.0%,23m
7119,3,[半个菜鸟]TARKIN,3145,357,14,7,21,66.7%,41m
7119,3,朋友都不玩星际了,3145,202,8,15,23,34.8%,20m
7119,3,迷茫的螃蟹,3145,232,7,5,12,58.3%,28m
7119,3,北巷清风,3145,0,4,1,5,80.0%,28m
7119,3,[gusl]沐晨,3145,168,4,3,7,57.1%,14m
7119,1,懒惰,3145,95,2,0,2,100.0%,1h
7119,3,watmelon,3145,30,2,5,7,28.6%,9m
7119,3,[传说萌娘团]爱与和平,3145,30,1,2,3,33.3%,11m
7119,3,IIIIIIIIII,3145,30,1,3,4,25.0%,10m
7119,3,zlrose,3145,30,1,4,5,20.0%,12m
7119,3,Bonnenuit,3145,0,0,3,3,0.0%,42m
7138,3,独角猫,3144,1146,145,127,272,53.3%,12m
7138,3,别再秒投了,3144,1521,94,94,188,50.0%,41m
7138,3,[兆景埋土大学]infinity,3144,898,35,30,65,53.8%,18m
7138,3,[NPCS]Sarutobi,3144,756,29,35,64,45.3%,21m
7138,3,[纯路人]chb,3144,251,20,9,29,69.0%,46m
7138,3,汉堡哥哥丫霸,3144,183,6,2,8,75.0%,22m
7138,3,浮沉,3144,118,5,4,9,55.6%,31m
7138,3,Time,3144,178,5,4,9,55.6%,28m
7138,3,[第九舰队丶]椰汁,3144,143,4,1,5,80.0%,23m
7138,3,你的灵车我来漂移,3144,0,3,2,5,60.0%,21m
7138,3,[罗马帝国]liuyunping,3144,60,3,3,6,50.0%,26m
7138,2,[逗比别闹]愁绪,3144,97,2,0,2,100.0%,54m
7138,3,誓约胜利之剑,3144,0,2,3,5,40.0%,11m
7138,3,[holyhp]Gostop,3144,0,1,0,1,100.0%,26m
7138,3,[大爱星际二]kill,3144,0,0,1,1,0.0%,27m
7138,3,[爱之信仰]東风丶若言丿,3144,0,0,1,1,0.0%,31m
7138,3,[T阴吧]maru,3144,0,0,1,1,0.0%,21m
7138,3,[CcW]IiIiIiIiIiIi,3144,0,0,1,1,0.0%,29m
7156,3,[XYG]浪汹涌,3143,1572,236,234,470,50.2%,44m
7156,3,[Rhusky]云梦,3143,1289,89,74,163,54.6%,20m
7156,2,力挽狂澜,3143,216,55,68,123,44.7%,15m
7156,3,youngerblood,3143,1232,49,42,91,53.8%,28m
7156,3,可导一定连续,3143,266,36,44,80,45.0%,27m
7156,3,BBB,3143,60,3,1,4,75.0%,18m
7156,3,[新手电脑粋]迷亭,3143,0,1,0,1,100.0%,16m
7156,2,[星际黑店]黑店丶爸爸,3143,0,1,0,1,100.0%,5m
7156,3,[失恋阵线联盟]幽冥太子,3143,0,1,0,1,100.0%,44m
7156,2,[神圣]Sanctity,3143,0,1,1,2,50.0%,20m
7156,3,[s金色玫瑰s]浮云,3143,30,1,3,4,25.0%,23m
7156,3,IIIIIIIIIIII,3143,0,0,1,1,0.0%,30m
7156,3,[心如死灰]stats,3143,0,0,1,1,0.0%,24m
7156,3,[午夜风暴]唯一,3143,0,0,1,1,0.0%,14m
7156,3,糯米团,3143,0,0,6,6,0.0%,11m
7171,3,[至诚娱乐]夏胜宁我的狗,3142,803,110,111,221,49.8%,9m
7171,3,wsctk,3142,303,80,83,163,49.1%,24m
7171,3,[夙愿天下]簋爷,3142,510,44,29,73,60.3%,41m
7171,3,[升格之链hh]Gloud,3142,1050,40,38,78,51.3%,44m
7171,3,[以众神之名]Silence,3142,235,28,6,34,82.4%,22m
7171,3,QHlight,3142,532,19,23,42,45.2%,13m
7171,3,PanzerIV,3142,370,16,14,30,53.3%,46m
7171,3,superT,3142,214,10,10,20,50.0%,9m
7171,3,我是新手,3142,192,7,5,12,58.3%,46m
7171,3,[镜花水月丨]爱民如子蒙斯克,3142,170,6,9,15,40.0%,4m
7171,3,Joker,3142,0,4,1,5,80.0%,44m
7171,3,[KSARet]xiaoxiaoren,3142,58,2,2,4,50.0%,41m
7171,3,机枪滚毒爆,3142,58,2,5,7,28.6%,5m
7171,3,duck,3142,0,1,2,3,33.3%,14m
7171,3,[第一萌新帝国]蓬门今始为君开,3142,0,0,1,1,0.0%,9m
7186,3,[菜鸡球带]木有小丁丁,3141,1556,318,319,637,49.9%,11m
7186,3,[Steel]SugarLess,3141,1057,44,35,79,55.7%,41m
7186,3,[就这就这]bobo,3141,795,38,18,56,67.9%,12m
7186,3,低调小王,3141,633,26,16,42,61.9%,16m
7186,3,[一等星]耂婆霞,3141,735,26,33,59,44.1%,18m
7186,3,[专业曹波]sinReviAr,3141,459,20,3,23,87.0%,6m
7186,3,Simoki,3141,445,18,16,34,52.9%,30m
7186,3,终梦,3141,317,16,8,24,66.7%,9m
7186,3,喊硬霸的都是菜,3141,246,10,8,18,55.6%,20m
7186,3,FreeJoker,3141,184,6,7,13,46.2%,19m
7186,3,[核平宇宙]冠状毒爆虫,3141,165,5,2,7,71.4%,14m
7186,2,dgb,3141,121,4,2,6,66.7%,42m
7186,3,syc,3141,138,3,3,6,50.0%,45m
7186,3,[CHiCO]ZHY,3141,30,2,1,3,66.7%,41m
7186,3,Saber,3141,60,2,3,5,40.0%,3m
7186,3,TQEB,3141,0,0,1,1,0.0%,44m
7202,3,奔放的旋律,3140,1541,248,238,486,51.0%,41m
7202,3,绝不拖农民,3140,1445,173,160,333,52.0%,13m
7202,3,[浪啊浪]贵州生物老师,3140,1400,162,154,316,51.3%,6m
7202,3,爱是风,3140,811,48,45,93,51.6%,30m
7202,3,[KKA1]裴婷玉,3140,700,41,28,69,59.4%,28m
7202,3,llllllllllll,3140,794,37,21,58,63.8%,30m
7202,3,AlphaStar,3140,872,37,32,69,53.6%,21m
7202,3,[s黑色玫瑰s]禁区枭歌,3140,512,21,18,39,53.8%,28m
7202,3,[我队伍很强大]易十七小影,3140,558,19,24,43,44.2%,6m
7202,3,泳于樱色之海,3140,431,17,13,30,56.7%,14m
7202,3,[锋刃]灰烬使者,3140,340,16,9,25,64.0%,44m
7202,3,[雄鹰]LUPINIII,3140,335,14,11,25,56.0%,17m
7202,3,[传说萌娘团]万由里的裁决,3140,218,8,2,10,80.0%,13m
7202,3,LaoK,3140,24,4,7,11,36.4%,44m
7202,3,[薇薇安]Omnipotent,3140,125,3,1,4,75.0%,5m
7202,3,[丽日御茶茶]IIIIIIIIII,3140,115,3,1,4,75.0%,31m
7202,3,[炸鱼biss]Lenor,3140,60,3,3,6,50.0%,45m
7202,3,[TXSB]COSCO,3140,30,2,2,4,50.0%,31m
7202,3,[zhu123]承让了,3140,0,0,1,1,0.0%,24m
7202,3,十七情惆怅,3140,0,0,1,1,0.0%,29m
7202,3,菜鸟中的战斗机,3140,0,0,1,1,0.0%,31m
7202,2,[魔法网骗]魔法少女梅莉酱,3140,0,0,3,3,0.0%,29m
7224,3,破晓,3139,1229,63,62,125,50.4%,12m
7224,3,掌控七道,3139,1338,61,58,119,51.3%,12m
7224,3,daby,3139,1036,52,43,95,54.7%,23m
7224,3,林北吼力戏,3139,493,21,17,38,55.3%,46m
7224,3,常草草,3139,547,21,18,39,53.8%,3m
7224,3,[为了地球]电光,3139,352,14,8,22,63.6%,26m
7224,2,铜铜猪,3139,258,9,3,12,75.0%,41m
7224,3,Tyr,3139,120,4,5,9,44.4%,44m
7224,3,Lion,3139,30,2,2,4,50.0%,42m
7224,3,牛三斤,3139,0,1,0,1,100.0%,18m
7224,3,笙歌一曲段九州,3139,0,0,1,1,0.0%,25m
7235,3,[VGN]妖孽,3138,1636,238,232,470,50.6%,22m
7235,3,不会打星际,3138,1490,233,228,461,50.5%,5m
7235,3,天宇,3138,744,127,112,239,53.1%,14m
7235,3,妈个鸡,3138,1618,126,105,231,54.5%,6m
7235,3,不可能,3138,1188,121,102,223,54.3%,16m
7235,3,TheSense,3138,1632,77,63,140,55.0%,46m
7235,3,[底特律KAR]枪兵王,3138,551,72,45,117,61.5%,28m
7235,3,名字一向难起,3138,1135,57,71,128,44.5%,12m
7235,3,IIIIIIII,3138,593,27,18,45,60.0%,12m
7235,3,HardWalnut,3138,375,24,5,29,82.8%,28m
7235,3,[响当当水友]iiiiiiinnova,3138,403,18,7,25,72.0%,13m
7235,3,乾坤大挪移,3138,241,11,8,19,57.9%,16m
7235,3,Abby,3138,310,11,15,26,42.3%,5m
7235,3,某科学的咕咕码,3138,181,7,7,14,50.0%,44m
7235,3,白云城主不戒大师,3138,215,6,6,12,50.0%,45m
7235,3,[人族最强近战]大師兄,3138,90,4,6,10,40.0%,9m
7235,3,静静,3138,90,2,1,3,66.7%,14m
7235,3,带把的核桃,3138,0,0,1,1,0.0%,28m
7235,3,Jackson,3138,0,0,1,1,0.0%,23m
7254,3,叶落长安,3137,876,80,72,152,52.6%,6m
7254,3,桜泠雪汐,3137,1095,66,47,113,58.4%,5m
7254,3,[感恩]指挥官,3137,1488,66,61,127,52.0%,27m
7254,3,[第八舰队丶]从零不从心,3137,886,39,29,68,57.4%,23m
7254,3,小火,3137,541,24,16,40,60.0%,40m
7254,3,KateCatheri,3137,496,21,13,34,61.8%,41m
7254,3,[柠檬保护协会]SuperLemon,3137,185,20,5,25,80.0%,44m
7254,3,[真实之泪]石动乃绘,3137,435,20,9,29,69.0%,27m
7254,3,Nocua,3137,421,20,15,35,57.1%,45m
7254,3,[Borne]Kirito,3137,436,18,11,29,62.1%,30m
7254,3,老司机的上铺,3137,75,12,16,28,42.9%,44m
7254,3,[爱吃小炒肉]桃佳,3137,258,10,6,16,62.5%,45m
7254,3,显哥无敌,3137,178,5,2,7,71.4%,14m
7254,2,凤珊小妹正在努力,3137,0,4,2,6,66.7%,1h
7254,3,[AC8]Galakrond,3137,47,3,9,12,25.0%,42m
7254,3,[小鸡子娃]帅气的鸭蜀黍,3137,112,2,1,3,66.7%,14m
7254,3,[ACG系]yinyinmaster,3137,90,2,2,4,50.0%,11m
7254,3,[新冠携带者]特朗普,3137,58,2,3,5,40.0%,14m
7254,1,[P太IMBA]牧濑红莉栖,3137,0,1,0,1,100.0%,1h
7254,1,[C53674]GOGO,3137,0,1,2,3,33.3%,44m
7254,3,[内蒙星际联盟]稚嫩的二五仔,3137,30,1,5,6,16.7%,14m
7254,3,浮生若梦,3137,0,0,2,2,0.0%,28m
7276,3,好好玩加油别放弃,3136,1539,199,187,386,51.6%,26m
7276,3,[小浪FANS]Cookie,3136,625,29,21,50,58.0%,27m
7276,3,[Encore]winterfell,3136,107,22,1,23,95.7%,29m
7276,3,[意志]UFO,3136,468,20,10,30,66.7%,4m
7276,3,llllllllllll,3136,408,16,15,31,51.6%,23m
7276,3,黑凤梨,3136,375,14,12,26,53.8%,3m
7276,3,Scorpio,3136,363,13,11,24,54.2%,29m
7276,3,wby,3136,27,9,16,25,36.0%,9m
7276,3,Bogus,3136,214,7,4,11,63.6%,5m
7276,2,[CPT]宝石怡情,3136,139,6,1,7,85.7%,25m
7276,3,中融,3136,0,5,0,5,100.0%,1h
7276,3,DEFY,3136,158,4,4,8,50.0%,24m
7276,3,[后墙倒塌出逃]沙岭子的深井冰,3136,0,3,2,5,60.0%,17m
7276,3,乱世之颠,3136,86,3,5,8,37.5%,16m
7276,3,[奥术之光]innovation,3136,0,0,1,1,0.0%,14m
7291,3,[DSE]你瞅啥,3135,1560,303,273,576,52.6%,30m
7291,3,自废双蛋,3135,815,96,95,191,50.3%,3m
7291,3,汪先侁,3135,893,74,66,140,52.9%,6m
7291,2,伊文斯,3135,1525,57,74,131,43.5%,3m
7291,3,zoly,3135,486,47,37,84,56.0%,24m
7291,3,小萌新,3135,1171,47,43,90,52.2%,28m
7291,3,巴斯蒂安小猪,3135,546,42,30,72,58.3%,6m
7291,3,innnnnnocent,3135,335,13,11,24,54.2%,45m
7291,3,郑江永,3135,114,7,1,8,87.5%,23m
7291,3,芙利德的黑炎,3135,140,5,8,13,38.5%,46m
7291,3,Dankon,3135,0,1,0,1,100.0%,25m
7291,3,么哈么哈,3135,94,1,1,2,50.0%,27m
7291,3,[SLUK]文四爷,3135,0,1,4,5,20.0%,50m
7304,3,who,3134,1558,145,140,285,50.9%,42m
7304,3,小猪,3134,815,78,73,151,51.7%,6m
7304,3,全太阳的忠实粉丝,3134,1499,74,74,148,50.0%,29m
7304,3,早睡,3134,1068,66,66,132,50.0%,18m
7304,3,阿呆傻狗,3134,1131,59,53,112,52.7%,31m
7304,3,[四叶草]PPT,3134,929,47,23,70,67.1%,17m
7304,3,[最菜战队]Shella,3134,846,37,25,62,59.7%,27m
7304,3,[花樣作死冠軍]闪耀的白菜,3134,784,36,27,63,57.1%,19m
7304,3,KAmier,3134,450,26,24,50,52.0%,10m
7304,3,[种田流]yours,3134,536,24,18,42,57.1%,10m
7304,3,[染年霜霜]太公嗷天,3134,634,21,27,48,43.8%,9m
7304,3,[狗不理战队]暴走黑衣人,3134,622,21,31,52,40.4%,45m
7304,3,蒲公英,3134,339,18,10,28,64.3%,11m
7304,3,[巨龙降临]阿莱克斯塔萨,3134,420,16,18,34,47.1%,44m
7304,3,半仙不是仙,3134,279,12,4,16,75.0%,26m
7304,3,[TCP]thirdempire,3134,270,10,6,16,62.5%,6m
7304,3,KakA,3134,258,10,11,21,47.6%,20m
7304,3,[四叶草]王霸巴,3134,184,8,2,10,80.0%,10m
7304,3,ytjpdhz,3134,119,8,4,12,66.7%,42m
7304,3,shiro,3134,107,8,4,12,66.7%,16m
7304,3,[XXHZ32]烟雨如花,3134,122,7,2,9,77.8%,24m
7304,3,光头无敌,3134,116,5,7,12,41.7%,42m
7304,3,[Hist]remiss,3134,148,5,8,13,38.5%,3m
7304,3,[火焰雷兽]IIIIIIIIIIII,3134,128,4,0,4,100.0%,45m
7304,3,南山亦谷,3134,94,4,6,10,40.0%,26m
7304,3,某李姓后勤部部长,3134,0,1,0,1,100.0%,46m
7304,3,李平,3134,30,1,3,4,25.0%,14m
7304,3,最后一号,3134,0,0,2,2,0.0%,13m
7304,3,[Abadon]Storm,3134,0,0,3,3,0.0%,14m
7333,2,[龙骨]ionicwind,3133,1557,338,337,675,50.1%,30m
7333,3,[三月风]憋空军是弱质,3133,1084,59,21,80,73.8%,19m
7333,3,夜深人静喝咖啡,3133,826,46,15,61,75.4%,29m
7333,3,诺娃我觉得我可以,3133,460,37,29,66,56.1%,6m
7333,3,hhx,3133,552,34,23,57,59.6%,45m
7333,3,IIIIIIIIIIII,3133,548,23,15,38,60.5%,31m
7333,3,羡才,3133,149,6,8,14,42.9%,44m
7333,3,ren,3133,154,5,1,6,83.3%,23m
7333,3,[纸壳]降伏泰伦帝国,3133,114,4,5,9,44.4%,44m
7333,3,Alienware,3133,30,2,1,3,66.7%,6m
7333,3,[love然酱]TING,3133,0,2,1,3,66.7%,23m
7333,2,命运审判,3133,0,1,0,1,100.0%,43m
7333,3,[Tov]freedom,3133,0,1,1,2,50.0%,46m
7333,3,听竹先生,3133,0,0,1,1,0.0%,20m
7333,3,[1Kn]ProJactKs,3133,0,0,1,1,0.0%,14m
7333,3,Tsundere,3133,0,0,1,1,0.0%,44m
7333,3,InNOvation,3133,0,0,4,4,0.0%,13m
7350,2,[YH]凯泽,3132,1058,291,291,582,50.0%,30m
7350,3,清风柒墨琉璃夏,3132,1574,75,56,131,57.3%,19m
7350,3,[永不灭的战火]我是坏人,3132,1262,54,43,97,55.7%,27m
7350,3,龙霸天,3132,941,41,33,74,55.4%,25m
7350,3,邪恶的大香蕉,3132,708,38,9,47,80.9%,27m
7350,3,音乐阳,3132,711,30,23,53,56.6%,30m
7350,3,[PhysRL]打星际你快乐吗,3132,566,22,23,45,48.9%,17m
7350,3,[有手就行]海门罗志祥,3132,496,18,22,40,45.0%,9m
7350,3,[XYFANS]OGAlexsib,3132,346,13,15,28,46.4%,9m
7350,2,满脸横肉的孙哥,3132,120,5,3,8,62.5%,42m
7350,3,Tippo,3132,94,4,10,14,28.6%,41m
7350,3,身下下士,3132,115,3,1,4,75.0%,28m
7350,1,韩慧星,3132,142,3,2,5,60.0%,11m
7350,3,你的死兆星在闪烁,3132,94,2,0,2,100.0%,7m
7350,3,DaTy,3132,0,1,0,1,100.0%,12m
7350,3,以和为贵,3132,0,0,1,1,0.0%,21m
7350,1,百变神族,3132,0,0,1,1,0.0%,54m
7350,2,Egoist,3132,0,0,1,1,0.0%,1h
7350,3,[北部战区]Awx,3132,0,0,2,2,0.0%,46m
7369,3,小宝上线了,3131,317,59,45,104,56.7%,7m
7369,3,[s金色玫瑰s]njl,3131,1203,52,49,101,51.5%,28m
7369,3,[HK丶S]麒麟竞技,3131,755,44,40,84,52.4%,11m
7369,3,sicer,3131,717,35,49,84,41.7%,12m
7369,3,[专制各种不服]戏中人易散,3131,399,18,4,22,81.8%,5m
7369,3,[糯米丸子]TzhoAa,3131,228,7,16,23,30.4%,13m
7369,2,小羊羊,3131,142,6,3,9,66.7%,1h
7369,3,[诹访神教]青檀鱬竹,3131,0,5,0,5,100.0%,13m
7369,3,GHOST,3131,0,1,0,1,100.0%,28m
7369,3,夕陽沙漏,3131,30,1,4,5,20.0%,31m
7369,3,[S天堂之魔]衡阳枪兵王,3131,0,0,1,1,0.0%,24m
7369,3,xuxu,3131,0,0,1,1,0.0%,13m
7369,3,[乱世]请叫我豪总,3131,0,0,1,1,0.0%,9m
7382,3,[整装待发]周爬爬,3130,1499,162,155,317,51.1%,41m
7382,3,神族难民,3130,1456,97,82,179,54.2%,19m
7382,3,来跳我,3130,1239,55,36,91,60.4%,41m
7382,3,[又没气啦]Brave,3130,642,26,20,46,56.5%,29m
7382,3,zqz,3130,566,26,21,47,55.3%,14m
7382,3,llllllllllll,3130,613,25,16,41,61.0%,6m
7382,3,IIIIIIIIIIII,3130,305,22,8,30,73.3%,12m
7382,3,[枪兵滾毒爆]神之长子,3130,393,18,28,46,39.1%,12m
7382,3,[斜星连萌]Ironman,3130,368,14,8,22,63.6%,29m
7382,3,[Show]赤月,3130,98,9,3,12,75.0%,41m
7382,1,宇宙无敌美洲豹,3130,208,7,5,12,58.3%,1h
7382,2,艹船借贱,3130,119,4,3,7,57.1%,1h
7382,3,yuanxiaoming,3130,0,3,2,5,60.0%,1h
7382,3,暴走谐星,3130,88,3,4,7,42.9%,17m
7382,3,[LFZ]JustSlowly,3130,88,3,6,9,33.3%,16m
7382,3,spireslley,3130,58,2,4,6,33.3%,27m
7382,3,呼叫舰队,3130,89,1,1,2,50.0%,23m
7382,3,[老流氓孙一峰]浦西孙一峰,3130,0,0,1,1,0.0%,28m
7382,3,[菜鸡啄老鹰]医生姐姐来了喵,3130,0,0,1,1,0.0%,45m
7382,3,花开冥界,3130,0,0,1,1,0.0%,9m
7402,3,shave,3129,1038,41,40,81,50.6%,18m
7402,3,[VLK]幽灵,3129,837,40,18,58,69.0%,17m
7402,3,Fumino,3129,821,38,24,62,61.3%,6m
7402,3,大雕肉更器,3129,458,28,25,53,52.8%,41m
7402,3,[KPG]喵内噶,3129,315,22,13,35,62.9%,8m
7402,3,理塘丁真,3129,423,19,12,31,61.3%,17m
7402,3,[Rhusky]Yoga,3129,298,16,5,21,76.2%,15m
7402,3,[我们很正经的]DrZou,3129,293,14,8,22,63.6%,6m
7402,3,lilikaxi,3129,334,13,6,19,68.4%,17m
7402,3,钟汉良,3129,211,7,7,14,50.0%,25m
7402,3,梧叶飘黄,3129,160,5,2,7,71.4%,12m
7402,1,锋寒,3129,186,5,7,12,41.7%,12m
7402,3,龙翔,3129,103,2,1,3,66.7%,14m
7402,3,[白瑰焰影]一般人员,3129,0,2,3,5,40.0%,6m
7402,3,[浮夸的]Roy,3129,96,2,4,6,33.3%,24m
7402,3,灬守望灬,3129,60,2,4,6,33.3%,13m
7402,3,果厨一枚,3129,30,1,2,3,33.3%,6m
7419,3,WIDOWMINE,3128,1582,174,174,348,50.0%,17m
7419,3,[星战分部]llllllllllll,3128,1438,95,75,170,55.9%,46m
7419,3,[老吴天下第一]普通人族李信衡,3128,692,48,44,92,52.2%,31m
7419,3,老六,3128,436,26,27,53,49.1%,29m
7419,3,[NUAA]TomRun,3128,348,13,15,28,46.4%,25m
7419,2,稚嫩,3128,274,12,7,19,63.2%,43m
7419,3,小浪浪,3128,172,11,5,16,68.8%,45m
7419,3,Ayanai,3128,255,11,7,18,61.1%,18m
7419,3,iNooooVation,3128,281,9,7,16,56.2%,25m
7419,1,以战止战,3128,235,8,5,13,61.5%,41m
7419,3,zcmorning,3128,224,8,6,14,57.1%,16m
7419,3,DJeff,3128,168,6,2,8,75.0%,12m
7419,3,星火燎原丶,3128,180,6,4,10,60.0%,21m
7419,3,冰箱炉石,3128,152,5,0,5,100.0%,44m
7419,2,春天的蟲,3128,121,5,3,8,62.5%,7m
7419,2,Ayase,3128,145,4,2,6,66.7%,14m
7419,2,[老油条战队]机枪兵都死了,3128,95,2,3,5,40.0%,41m
7419,3,[GAGA]magejizerg,3128,0,1,0,1,100.0%,24m
7419,2,EvaNgeliON,3128,97,1,1,2,50.0%,31m
7419,3,[氤氲之城]zzzz,3128,0,0,3,3,0.0%,28m
7439,3,Doc,3127,1405,212,196,408,52.0%,28m
7439,3,[Beastp]逸丨尘灬,3127,1021,103,93,196,52.6%,21m
7439,3,流光,3127,752,67,52,119,56.3%,45m
7439,3,fish,3127,545,66,59,125,52.8%,6m
7439,3,放开那个姑娘,3127,1117,50,45,95,52.6%,16m
7439,3,RXOO,3127,734,35,28,63,55.6%,21m
7439,3,[诡诈]诡诈,3127,704,33,18,51,64.7%,17m
7439,3,[PtG]犬走椛,3127,604,29,16,45,64.4%,18m
7439,3,cole,3127,600,29,26,55,52.7%,28m
7439,3,啊你吓死我啦,3127,790,29,36,65,44.6%,29m
7439,3,[刺蛇互助社团]汐萍,3127,130,13,2,15,86.7%,4m
7439,3,[Beasty]不太聪明的亚子,3127,293,11,7,18,61.1%,44m
7439,3,一枪难搞,3127,220,10,6,16,62.5%,12m
7439,3,checkmate,3127,232,8,6,14,57.1%,42m
7439,3,Blackstar,3127,219,7,3,10,70.0%,25m
7439,3,曹操发达跑,3127,0,4,1,5,80.0%,12m
7439,3,天宇,3127,118,4,5,9,44.4%,8m
7439,3,[贪玩]Ramsey,3127,112,3,1,4,75.0%,21m
7439,3,FallinSheild,3127,60,3,2,5,60.0%,45m
7439,1,Mike,3127,92,3,3,6,50.0%,19m
7439,3,Avalanche,3127,62,3,6,9,33.3%,31m
7439,3,[白给小天才]小仓朝日,3127,93,1,1,2,50.0%,41m
7439,3,[汐弦真可爱]白发兔耳拉菲酱,3127,94,1,1,2,50.0%,22m
7439,3,条码人,3127,0,1,1,2,50.0%,44m
7439,3,AfteR,3127,0,0,3,3,0.0%,45m
7439,3,对韭当割,3127,0,0,5,5,0.0%,1h
7465,3,lifeChocolat,3126,1571,239,209,448,53.3%,7m
7465,3,大魔王,3126,1578,185,179,364,50.8%,26m
7465,3,[我太帅]运气是实力的全部,3126,1182,82,75,157,52.2%,12m
7465,3,[歪比巴卜]SCV,3126,556,48,27,75,64.0%,28m
7465,3,yazeroO,3126,544,26,15,41,63.4%,45m
7465,3,IIIIIIIIIIII,3126,652,25,20,45,55.6%,28m
7465,3,脑壳疼内战直接退,3126,394,18,8,26,69.2%,42m
7465,3,[tyyt]llIIIIlllIII,3126,336,14,7,21,66.7%,41m
7465,3,IIIIIIIIIII,3126,202,7,14,21,33.3%,22m
7465,3,[老王睿智]小郑公主,3126,182,6,1,7,85.7%,27m
7465,3,[诺娃1]席欣,3126,90,3,6,9,33.3%,24m
7465,3,密斯提斯,3126,0,0,1,1,0.0%,45m
7465,3,[徐佳莹]鹤太太,3126,0,0,1,1,0.0%,4m
7478,3,GGGGGGGG,3125,1474,160,150,310,51.6%,16m
7478,3,我永远喜欢伊蕾娜,3125,1481,81,75,156,51.9%,44m
7478,3,[桃园结义]逆鳞,3125,899,48,16,64,75.0%,44m
7478,3,星界拾荒者,3125,743,37,21,58,63.8%,27m
7478,3,[染年霜霜]sOs,3125,613,26,16,42,61.9%,41m
7478,3,[Borne]黑白尺素,3125,297,20,20,40,50.0%,42m
7478,3,[holyhp]恶魔之泪,3125,420,17,10,27,63.0%,12m
7478,3,[NSt1]EverRaynor,3125,381,17,12,29,58.6%,25m
7478,3,围棋界的星际玩家,3125,341,15,11,26,57.7%,41m
7478,3,陶陶乖妞,3125,257,10,4,14,71.4%,15m
7478,3,[YRS党委会]三水加,3125,94,10,8,18,55.6%,12m
7478,3,风雪翩跹,3125,269,9,4,13,69.2%,31m
7478,1,CAIJI,3125,169,8,5,13,61.5%,44m
7478,3,[Sc养老]Tory,3125,95,4,0,4,100.0%,9m
7478,3,滨边美波我老婆,3125,148,4,1,5,80.0%,17m
7478,3,烧光杀光抢光,3125,105,3,0,3,100.0%,17m
7478,3,Gary,3125,0,1,0,1,100.0%,42m
7478,1,Marine,3125,0,1,0,1,100.0%,16m
7478,3,[SoloAs]丶戏言,3125,0,0,1,1,0.0%,31m
7478,3,[铭刻於红魂丶]逸仙,3125,0,0,1,1,0.0%,12m
7478,3,[城市规划局]卡莲卡斯兰娜,3125,0,0,1,1,0.0%,5m
7499,3,[TCP]ReicaTT,3124,1570,128,94,222,57.7%,23m
7499,3,[Beam]VoidVoyage,3124,1573,114,90,204,55.9%,46m
7499,3,魂魄妖梦,3124,934,82,59,141,58.2%,27m
7499,3,我爱李越悦火,3124,820,49,50,99,49.5%,31m
7499,3,刘茗,3124,551,23,20,43,53.5%,41m
7499,3,kka,3124,121,22,19,41,53.7%,44m
7499,3,[RyH]Sweetiey,3124,520,21,14,35,60.0%,19m
7499,3,香菜土豆,3124,341,15,7,22,68.2%,17m
7499,3,[专打嘤嘤怪]希尔瓦娜斯,3124,275,13,1,14,92.9%,14m
7499,3,[鬼杀队]某科学的我妻善逸,3124,317,12,6,18,66.7%,20m
7499,3,WAKANDA,3124,255,11,6,17,64.7%,26m
7499,3,[艾尔之巅]仙师二口合,3124,245,8,7,15,53.3%,13m
7499,3,[贰伍仔集中营]CNmarine,3124,180,5,4,9,55.6%,23m
7499,3,YanceyBaBy,3124,0,0,1,1,0.0%,15m
7499,3,闪电五连鞭,3124,0,0,1,1,0.0%,11m
7514,3,钻石星辰,3123,1531,251,219,470,53.4%,27m
7514,3,IIIIIIIIIIII,3123,1302,170,161,331,51.4%,15m
7514,3,[萌新在下挨打]小鳌,3123,969,109,91,200,54.5%,46m
7514,3,Alsatian,3123,1398,107,91,198,54.0%,46m
7514,3,囡囡,3123,1368,54,52,106,50.9%,30m
7514,3,樱落阶前月,3123,581,33,28,61,54.1%,6m
7514,3,ForsakenSoul,3123,552,25,24,49,51.0%,12m
7514,3,RedDusT,3123,450,24,12,36,66.7%,8m
7514,3,Exia,3123,440,16,21,37,43.2%,5m
7514,3,[SDEt]低旧雪,3123,238,10,3,13,76.9%,23m
7514,3,[永安]这个辣鸡游戏,3123,239,9,5,14,64.3%,23m
7514,3,[yjacks]llllxyr,3123,201,7,3,10,70.0%,45m
7514,3,koishi,3123,213,7,3,10,70.0%,4m
7514,2,[六芒星s]炮灰,3123,118,5,3,8,62.5%,27m
7514,3,veltro,3123,0,4,5,9,44.4%,14m
7514,3,[绝世好人]但我是真的狗,3123,90,4,5,9,44.4%,10m
7514,3,大天使阿夸,3123,117,3,1,4,75.0%,16m
7514,3,越今朝,3123,48,2,8,10,20.0%,12m
7514,3,[LFY]观止,3123,0,1,0,1,100.0%,4m
7514,1,[花开彼岸天]尔等有罪,3123,0,1,0,1,100.0%,54m
7514,3,[Igirls]南柯一梦,3123,0,0,1,1,0.0%,26m
7514,1,[斯巴达血战团]魔法少女林北酱,3123,0,0,1,1,0.0%,20m
7514,3,风吹裤衩鸡,3123,0,0,1,1,0.0%,17m
7537,3,判官,3122,1619,115,111,226,50.9%,41m
7537,3,[心有明月]warp,3122,1575,75,65,140,53.6%,46m
7537,2,IIIIIIIIIIII,3122,893,39,57,96,40.6%,4m
7537,3,[丨SLT丨]藤原卫星,3122,729,35,21,56,62.5%,16m
7537,3,[miku守护]逝去的风,3122,632,33,34,67,49.3%,41m
7537,3,[狗才玩神族]MagicTom,3122,850,32,37,69,46.4%,23m
7537,3,[茶队星分部]雨过添晴,3122,300,30,14,44,68.2%,8m
7537,3,FReeloo,3122,580,22,20,42,52.4%,14m
7537,3,猛猛哒,3122,258,20,20,40,50.0%,44m
7537,3,打硬铁的铁匠,3122,349,18,15,33,54.5%,41m
7537,3,[埃蒙好可爱]锤子,3122,354,12,11,23,52.2%,45m
7537,3,看见你我蛋疼,3122,252,8,8,16,50.0%,26m
7537,3,UFO,3122,211,7,7,14,50.0%,23m
7537,3,神冀之翼,3122,120,6,5,11,54.5%,24m
7537,3,[CHW]教员的好学生,3122,124,5,6,11,45.5%,17m
7537,2,烟雾怪,3122,0,3,2,5,60.0%,1h
7537,3,Victory,3122,0,1,0,1,100.0%,3m
7537,3,IIIIIIIIIIII,3122,0,0,1,1,0.0%,23m
7537,3,[DMR]我玩虫族只换家,3122,0,0,2,2,0.0%,5m
7556,3,LoveGodZ,3121,1415,205,195,400,51.2%,27m
7556,3,[Korpru]Tit,3121,1420,118,112,230,51.3%,4m
7556,3,致命呼吸,3121,1154,91,97,188,48.4%,25m
7556,3,应化之光,3121,751,71,51,122,58.2%,16m
7556,3,qdbydknwzgnk,3121,888,35,35,70,50.0%,25m
7556,3,陶陶,3121,504,33,17,50,66.0%,14m
7556,3,[shamus]GrimReaper,3121,602,25,19,44,56.8%,30m
7556,3,[SQG]我是可爱的国子狸,3121,424,15,14,29,51.7%,31m
7556,3,[铁十字骷髅师]moon,3121,299,14,3,17,82.4%,12m
7556,3,void,3121,335,14,12,26,53.8%,17m
7556,3,[泰伦征兵中心]空军元帅,3121,298,13,3,16,81.2%,6m
7556,3,[xgnb]despair,3121,279,11,5,16,68.8%,14m
7556,3,旺旺雪饼,3121,144,11,13,24,45.8%,42m
7556,3,[ctrlF1]天才的我,3121,226,7,4,11,63.6%,23m
7556,3,[RPGBoY]儿子许杰,3121,134,6,8,14,42.9%,46m
7556,3,小秋铭,3121,88,4,4,8,50.0%,22m
7556,3,裤裆有杀气,3121,90,4,7,11,36.4%,16m
7556,3,paysonhua,3121,110,3,0,3,100.0%,41m
7556,3,helloworld,3121,116,3,1,4,75.0%,12m
7556,3,IIIIII,3121,58,2,6,8,25.0%,16m
7556,3,MarineKing,3121,0,1,0,1,100.0%,41m
7556,3,[璀璨群星之刃]最美不过夕阳红,3121,0,1,0,1,100.0%,9m
7556,3,镜花水月,3121,0,1,0,1,100.0%,1h
7556,1,[专家联盟]Maroon,3121,42,1,5,6,16.7%,18m
7556,3,我叫吕小布,3121,0,0,3,3,0.0%,25m
7581,3,[董魔王制霸军]瞄了个咪咪,3120,960,62,50,112,55.4%,46m
7581,3,[GDG]南风如梦,3120,1212,53,38,91,58.2%,28m
7581,3,死缠烂打,3120,834,31,30,61,50.8%,16m
7581,3,[加油呀]Armazi,3120,230,21,19,40,52.5%,12m
7581,3,SOS,3120,320,16,17,33,48.5%,45m
7581,3,刚玩星际大佬轻虐,3120,313,14,5,19,73.7%,9m
7581,3,jelly,3120,199,7,2,9,77.8%,26m
7581,3,bynicole,3120,110,3,0,3,100.0%,21m
7581,3,筛酒木樨,3120,92,3,6,9,33.3%,29m
7581,1,甲鱼丶君,3120,42,2,1,3,66.7%,24m
7581,1,[C06904]sky,3120,0,1,0,1,100.0%,17m
7581,3,Keeper,3120,0,0,1,1,0.0%,44m
7593,3,你说是辣就是,3119,1516,144,127,271,53.1%,17m
7593,3,Tankking,3119,1508,141,131,272,51.8%,10m
7593,3,Flyshadow,3119,708,50,40,90,55.6%,13m
7593,3,[s黑色玫瑰s]人头无限好只是死,3119,884,50,49,99,50.5%,24m
7593,3,小鹿乱撞,3119,516,19,20,39,48.7%,18m
7593,3,沉默寡言黄少天,3119,237,12,3,15,80.0%,46m
7593,3,年轻人不讲武德,3119,284,9,9,18,50.0%,26m
7593,3,在下李佩奇,3119,223,7,6,13,53.8%,41m
7593,3,Kuhaku,3119,0,2,1,3,66.7%,41m
7593,3,[没有风脸]Rays,3119,118,2,2,4,50.0%,30m
7593,3,[一群谐星]DayNine,3119,30,2,3,5,40.0%,43m
7593,1,[XXJTLU]教主之魂,3119,36,1,1,2,50.0%,4m
7593,1,[IMRTS]violet,3119,0,1,2,3,33.3%,44m
7593,3,[社交学大可爱]sheely,3119,0,0,1,1,0.0%,9m
7607,3,stefan,3118,1448,85,77,162,52.5%,30m
7607,3,[文韬武略]xiaoxiao,3118,1347,75,77,152,49.3%,12m
7607,3,[肌肉]旋转的蓝色枪兵,3118,1026,36,44,80,45.0%,28m
7607,3,[Embers]YDM,3118,580,24,19,43,55.8%,15m
7607,3,SuperJoven,3118,162,13,10,23,56.5%,6m
7607,1,[DMRc]英国大力士,3118,303,10,1,11,90.9%,11m
7607,3,[禽禽禽]白斩鸡,3118,188,6,1,7,85.7%,12m
7607,1,切糕终结者,3118,225,6,11,17,35.3%,6m
7607,3,[复活吧勇士]CommanderLee,3118,0,4,1,5,80.0%,55m
7607,3,GXiu,3118,58,3,7,10,30.0%,28m
7607,3,魍魉,3118,30,1,4,5,20.0%,13m
7607,1,[蛮夫中的菜鸡]杨翼鹏,3118,42,1,5,6,16.7%,8m
7607,1,heaven,3118,0,0,1,1,0.0%,25m
7607,1,[中华兄弟会]糖盐小仙,3118,0,0,1,1,0.0%,26m
7607,1,[小鸡屠宰场8]moonky,3118,0,0,1,1,0.0%,15m
7622,3,椎名林檎,3117,1337,234,233,467,50.1%,17m
7622,3,圣光不脏,3117,1020,80,83,163,49.1%,9m
7622,3,VanGogh,3117,870,59,40,99,59.6%,12m
7622,3,gdtjw,3117,898,39,31,70,55.7%,23m
7622,3,[HW4]FUBUKI,3117,909,36,35,71,50.7%,20m
7622,3,二十八天速成鸡,3117,776,31,25,56,55.4%,5m
7622,3,[埃蒙好可爱]呆头马,3117,662,30,23,53,56.6%,15m
7622,3,[越南洗剪吹]啊灰,3117,408,16,12,28,57.1%,10m
7622,2,qlllp,3117,90,7,3,10,70.0%,13m
7622,1,[YM都是沙比]送分白给,3117,96,6,2,8,75.0%,44m
7622,3,IIIIIIIIIIII,3117,179,6,3,9,66.7%,29m
7622,3,[GSZCX]JJJJJJJJJosh,3117,94,3,7,10,30.0%,44m
7622,1,[I苏维埃I]前略,3117,0,1,0,1,100.0%,7m
7622,3,[第八舰队丶]牛子哥,3117,0,1,1,2,50.0%,18m
7622,3,Doot,3117,0,1,2,3,33.3%,5m
7622,1,水无月,3117,0,1,2,3,33.3%,54m
7622,1,FreePxxn,3117,0,0,1,1,0.0%,30m
7622,3,StrigonAlex,3117,0,0,1,1,0.0%,16m
7640,1,只是一只猫,3116,1517,305,294,599,50.9%,41m
7640,3,[一等星]默本无声,3116,1450,96,90,186,51.6%,4m
7640,3,YMin,3116,993,60,55,115,52.2%,26m
7640,3,[笑傲江湖oL]辟邪剑丶林平之,3116,787,32,26,58,55.2%,30m
7640,3,clem,3116,730,28,26,54,51.9%,23m
7640,1,海王星,3116,302,24,18,42,57.1%,13m
7640,1,cyxysky,3116,222,9,5,14,64.3%,1h
7640,3,[不怕念起]孙浩淼,3116,164,6,8,14,42.9%,17m
7640,3,FirstCute,3116,0,5,0,5,100.0%,1h
7640,1,高城望断,3116,164,5,1,6,83.3%,41m
7640,3,SCspecialist,3116,42,5,2,7,71.4%,4m
7640,3,[TMUSC2]ArkFrostNova,3116,164,5,3,8,62.5%,45m
7640,3,DLTS,3116,38,2,8,10,20.0%,17m
7640,1,LiKer,3116,0,1,0,1,100.0%,26m
7654,3,mayi,3115,1553,301,297,598,50.3%,9m
7654,3,TedKKK,3115,1157,72,59,131,55.0%,26m
7654,3,苍阳,3115,1014,40,35,75,53.3%,41m
7654,3,星际风云,3115,650,29,35,64,45.3%,17m
7654,3,fsweee,3115,643,25,24,49,51.0%,42m
7654,3,[夏恋]卡兰,3115,262,11,3,14,78.6%,22m
7654,3,刘看水,3115,125,8,12,20,40.0%,10m
7654,3,Symbol,3115,169,6,6,12,50.0%,22m
7654,3,lwwayne,3115,118,5,5,10,50.0%,31m
7654,3,[华夏远征军]萧残,3115,0,4,0,4,100.0%,1h
7654,1,Ancr,3115,142,4,6,10,40.0%,24m
7654,3,艾尔必将沦陷,3115,147,3,4,7,42.9%,19m
7654,3,星际争霸嘴上过,3115,62,3,8,11,27.3%,12m
7654,3,IIIIIIIIIIII,3115,0,1,2,3,33.3%,20m
7654,1,[白狼天狗]犬走椛,3115,0,0,1,1,0.0%,31m
7654,3,战翼,3115,0,0,4,4,0.0%,15m
7670,3,[光头恐惧症]灭神斩,3114,396,88,70,158,55.7%,17m
7670,3,[不知不觉天亮]小白书生,3114,394,71,18,89,79.8%,12m
7670,3,[五月花]舞殇,3114,1058,39,49,88,44.3%,27m
7670,3,[星际传销组织]我不玩英雄联盟,3114,477,26,11,37,70.3%,41m
7670,3,张四疯,3114,291,22,16,38,57.9%,31m
7670,3,[喜欢自定义]聖韻,3114,480,21,12,33,63.6%,23m
7670,3,[剑走偏锋]arcadia,3114,495,18,19,37,48.6%,23m
7670,3,铁板鱿鱼,3114,296,10,14,24,41.7%,12m
7670,3,[梦想彼方]Chronosphere,3114,175,5,4,9,55.6%,8m
7670,3,iceTea,3114,90,4,6,10,40.0%,12m
7670,3,我肾去哪了,3114,116,4,8,12,33.3%,11m
7670,3,[iih]Kikyo,3114,0,0,2,2,0.0%,44m
7670,3,helloMinato,3114,0,0,4,4,0.0%,14m
7683,3,[传说萌娘团]IIIIIIIIIIII,3113,1259,93,85,178,52.2%,45m
7683,3,[红烛昏罗帐]风暴,3113,1213,53,43,96,55.2%,23m
7683,3,[艾尔大断电]ziposcar,3113,1192,44,49,93,47.3%,7m
7683,3,[BC]Zero,3113,1090,39,42,81,48.1%,20m
7683,1,[白给了]llllll,3113,800,24,21,45,53.3%,25m
7683,3,我在墙角等红杏,3113,653,23,32,55,41.8%,25m
7683,3,暴风雪,3113,505,20,19,39,51.3%,41m
7683,2,Eumenides,3113,199,17,5,22,77.3%,5m
7683,3,普通电脑,3113,240,9,11,20,45.0%,30m
7683,3,德玛西亚之力,3113,97,4,2,6,66.7%,1h
7683,1,洋洋,3113,116,4,2,6,66.7%,31m
7683,1,IIIIIIIIIIII,3113,84,2,2,4,50.0%,11m
7683,1,[文韬武略]憨太叁叁,3113,0,1,0,1,100.0%,26m
7683,1,SnipeHunter,3113,0,1,0,1,100.0%,25m
7683,3,啊塔妮丝,3113,0,1,1,2,50.0%,25m
7683,1,随便的名字,3113,0,0,1,1,0.0%,9m
7699,3,[Shawk]彼岸花开空断肠,3112,1434,181,156,337,53.7%,4m
7699,3,天朝真理部,3112,1333,145,130,275,52.7%,20m
7699,3,[铁三角]FORlight,3112,1374,133,139,272,48.9%,15m
7699,3,Gray,3112,1390,115,117,232,49.6%,14m
7699,3,IIIIIIIIIIII,3112,444,48,38,86,55.8%,18m
7699,3,藐视群雄,3112,722,48,42,90,53.3%,7m
7699,1,好骚年,3112,1130,43,35,78,55.1%,45m
7699,3,[SCLR]叶落归根,3112,611,23,21,44,52.3%,14m
7699,3,darkcarrot,3112,664,23,28,51,45.1%,10m
7699,3,FIREQIU,3112,223,16,11,27,59.3%,16m
7699,3,EnTaroMyself,3112,346,15,5,20,75.0%,18m
7699,1,[李知恩]野人一拳,3112,286,9,4,13,69.2%,11m
7699,3,沈梦欣的地心引力,3112,166,7,8,15,46.7%,41m
7699,3,[一二一]逆风局局长,3112,154,5,2,7,71.4%,23m
7699,3,[埃蒙好可爱]Toky,3112,150,5,7,12,41.7%,18m
7699,3,笑笑,3112,128,4,3,7,57.1%,27m
7699,1,PImbA,3112,0,1,0,1,100.0%,15m
7699,3,unobection,3112,0,1,1,2,50.0%,30m
7699,3,[为谁而忧伤]我爱吃生抽,3112,0,1,5,6,16.7%,24m
7699,1,[黄金三叉戟]Sergey,3112,0,0,1,1,0.0%,17m
7719,3,[队标长就厉害]Fate,3111,992,125,113,238,52.5%,15m
7719,3,需要更多的人口,3111,352,95,92,187,50.8%,14m
7719,3,lhy,3111,314,12,15,27,44.4%,6m
7719,1,[半个大哥]Zerofoll,3111,264,8,6,14,57.1%,18m
7719,3,[眼瞎的车万苟]八雲橴,3111,189,6,5,11,54.5%,13m
7719,1,黔莫川,3111,120,3,1,4,75.0%,41m
7719,3,[熊出没注意]湾区吴彦祖,3111,132,3,4,7,42.9%,30m
7719,2,[神威灵装五番]ItsukaKotori,3111,0,1,0,1,100.0%,1h
7719,1,江南狗王,3111,0,0,1,1,0.0%,30m
7719,1,感到的集团他已经,3111,0,0,1,1,0.0%,11m
7729,3,lschacha,3110,1003,110,102,212,51.9%,31m
7729,3,Lancer,3110,482,19,13,32,59.4%,7m
7729,3,Gary,3110,360,12,12,24,50.0%,41m
7729,1,[白银联盟]aaa,3110,364,10,8,18,55.6%,24m
7729,3,sdddddddd,3110,216,7,4,11,63.6%,15m
7729,2,[QAQ]燃烧的锅盖,3110,128,4,29,33,12.1%,11m
7729,3,killer,3110,85,3,3,6,50.0%,16m
7729,1,[雾雨魔法店]伊蕾娜桑,3110,0,1,2,3,33.3%,59m
7737,3,Zeus,3109,616,27,19,46,58.7%,44m
7737,3,[路易斯邦德]SickD,3109,546,23,18,41,56.1%,11m
7737,1,小疯紫,3109,483,19,15,34,55.9%,26m
7737,3,[sakiwa]princew,3109,412,18,27,45,40.0%,13m
7737,3,[旋风鹰]蓝飞鹰,3109,270,17,27,44,38.6%,42m
7737,3,DemonLord,3109,326,15,12,27,55.6%,23m
7737,3,[NVKR]LOL,3109,203,10,5,15,66.7%,42m
7737,1,[光头大魔王M]IIIIIIIIIIII,3109,0,1,0,1,100.0%,31m
7737,3,我重回战场,3109,0,0,2,2,0.0%,18m
7746,1,干的啊狗汪汪叫,3108,1570,527,552,1079,48.8%,17m
7746,3,[草滩帝国大学]陈晖洁天下第一,3108,214,13,19,32,40.6%,9m
7746,1,喵少奇,3108,264,8,6,14,57.1%,25m
7746,3,[雾雨魔法森林]花瓣终有凋零时,3108,183,6,2,8,75.0%,23m
7746,3,[Sarlor]勇敢的小鸡,3108,0,5,0,5,100.0%,44m
7746,3,Bai,3108,172,5,4,9,55.6%,14m
7746,3,[Shawk]几度晚,3108,0,4,1,5,80.0%,26m
7746,1,ItsukaKotori,3108,80,3,0,3,100.0%,21m
7746,1,[无限未来]JYCC,3108,80,2,1,3,66.7%,13m
7746,3,[混元星际小队]那梦境太过深刻,3108,123,2,3,5,40.0%,4m
7746,2,[幽金贮藏堆]那你不是很棒棒哦,3108,46,2,4,6,33.3%,19m
7757,3,doinB,3107,1343,81,61,142,57.0%,14m
7757,3,管子大哥,3107,994,66,67,133,49.6%,14m
7757,3,IIIIIIIIIIII,3107,324,14,8,22,63.6%,28m
7757,3,[IAT]CalVen,3107,242,8,7,15,53.3%,28m
7757,1,丿断剑丶,3107,253,7,4,11,63.6%,50m
7757,3,[为地图而生]北乔峰,3107,118,4,6,10,40.0%,44m
7757,3,[凤凰炸鸡]boy,3107,92,4,9,13,30.8%,44m
7757,3,输给我死个妈,3107,30,2,3,5,40.0%,3m
7757,3,llllllllllll,3107,62,2,6,8,25.0%,46m
7757,1,吉川春代,3107,40,1,1,2,50.0%,45m
7757,1,xfyshy,3107,95,1,1,2,50.0%,1h
7757,1,[噶姐美如花]一个男人,3107,0,0,1,1,0.0%,16m
7757,3,[loveMM]许昌孙一峰,3107,0,0,3,3,0.0%,26m
7757,3,[乱杀]你的工蜂被屠啦,3107,0,0,4,4,0.0%,15m
7771,3,TudooH,3106,1528,159,146,305,52.1%,30m
7771,3,INnoVation,3106,763,91,80,171,53.2%,27m
7771,3,[WCD]StanleyAlex,3106,855,54,50,104,51.9%,12m
7771,3,happyend,3106,1014,38,42,80,47.5%,6m
7771,3,Loger,3106,658,30,20,50,60.0%,28m
7771,3,[睫毛哥八百部]maoxinshu,3106,602,22,23,45,48.9%,17m
7771,3,低调的鹌鹑,3106,458,15,14,29,51.7%,7m
7771,3,[技嘉全球]老李,3106,178,6,8,14,42.9%,9m
7771,1,放进去自己动,3106,154,5,3,8,62.5%,10m
7771,3,一拳超人,3106,60,3,4,7,42.9%,24m
7771,3,宵想,3106,30,2,6,8,25.0%,15m
7771,1,[须玖莉]卖萌型小铃,3106,0,1,0,1,100.0%,26m
7771,1,sadsad,3106,0,0,1,1,0.0%,41m
7784,3,娜可露露,3105,217,29,20,49,59.2%,14m
7784,3,[killer]well,3105,236,29,25,54,53.7%,24m
7784,3,Cure,3105,466,15,27,42,35.7%,4m
7784,1,炸鱼崽种亲妈必死,3105,414,13,9,22,59.1%,26m
7784,3,[Trash]serral,3105,266,10,14,24,41.7%,41m
7784,1,MVPLegend,3105,214,6,2,8,75.0%,45m
7784,1,IIIIIIIIIIII,3105,141,6,3,9,66.7%,16m
7784,2,[tiandi]Roll,3105,44,5,3,8,62.5%,27m
7784,3,[蓝军车路士]化身孤岛的鲸,3105,153,4,2,6,66.7%,22m
7784,2,[瘾大眼瞎]QVQ,3105,153,4,3,7,57.1%,24m
7784,3,[RDFZsc]薛定谔的鼠,3105,101,4,7,11,36.4%,46m
7784,3,[C60373]ccy,3105,58,3,3,6,50.0%,42m
7796,3,iiiiiiiiiii,3104,376,14,16,30,46.7%,18m
7796,3,[我们的故事]来自远方的阿三,3104,168,10,15,25,40.0%,18m
7796,1,JUDGE,3104,346,9,4,13,69.2%,12m
7796,3,[DTP]泣鬼灬柒夜,3104,204,7,9,16,43.8%,12m
7796,1,Dionysus,3104,241,6,1,7,85.7%,24m
7796,3,hjf,3104,206,6,7,13,46.2%,13m
7796,2,陈教授,3104,120,3,1,4,75.0%,4m
7796,3,SGstar,3104,0,3,2,5,60.0%,41m
7796,3,[萝莉之芯]LeiGe,3104,58,2,5,7,28.6%,12m
7796,3,神族,3104,0,1,1,2,50.0%,16m
7796,1,殛丨天灵灭世,3104,42,1,2,3,33.3%,7m
7796,1,[钻石狗]四條,3104,0,0,1,1,0.0%,41m
7796,3,天堂隔壁,3104,0,0,1,1,0.0%,8m
7796,3,[IISC]江爷,3104,0,0,2,2,0.0%,31m
7810,3,年轻人要讲武德,3103,1169,652,636,1288,50.6%,44m
7810,3,[冲就完了]星际捷尔任斯基,3103,1600,362,351,713,50.8%,21m
7810,3,华魂战曲,3103,749,43,38,81,53.1%,13m
7810,3,[北京城管]一只翻滚的爆爆虫,3103,778,29,29,58,50.0%,44m
7810,3,[KPG]凯莎女王赛高,3103,584,23,21,44,52.3%,18m
7810,3,zeen,3103,191,16,23,39,41.0%,14m
7810,3,[葬魂]Jei,3103,366,14,14,28,50.0%,44m
7810,3,血色的祝福,3103,169,10,4,14,71.4%,18m
7810,3,July,3103,258,9,11,20,45.0%,17m
7810,2,[耀眼的青春]飞雪再临之时,3103,215,7,9,16,43.8%,28m
7810,3,霜月千泷,3103,97,4,2,6,66.7%,1h
7810,3,[七咕咕]影月,3103,112,3,2,5,60.0%,30m
7810,2,Neutrino,3103,38,2,0,2,100.0%,26m
7810,1,我们完蛋了,3103,0,1,0,1,100.0%,5m
7810,1,[中察]地狱里的战魂,3103,0,0,1,1,0.0%,25m
7810,3,风城玫瑰,3103,0,0,1,1,0.0%,1h
7810,3,王者史鹏,3103,0,0,2,2,0.0%,14m
7810,3,SkyT,3103,0,0,3,3,0.0%,19m
7828,3,大梦谁先觉,3102,1627,100,110,210,47.6%,46m
7828,3,IIIIIIIIIIII,3102,1180,94,81,175,53.7%,11m
7828,3,维斯维尔星港,3102,511,84,74,158,53.2%,42m
7828,3,[Thpj]PrinzEugen,3102,1414,68,54,122,55.7%,12m
7828,3,[谐神]wardove,3102,579,55,47,102,53.9%,29m
7828,3,[最牛的菜鸟队]一叶之秋,3102,843,36,30,66,54.5%,4m
7828,3,[混吃混喝]彳亍行者,3102,175,8,9,17,47.1%,12m
7828,1,[夙愿东流]Far,3102,222,7,4,11,63.6%,16m
7828,3,llllllllllll,3102,200,7,11,18,38.9%,31m
7828,3,我已,3102,171,6,4,10,60.0%,19m
7828,1,我爱老婆,3102,0,5,0,5,100.0%,18m
7828,3,[RGL]TOP,3102,97,5,1,6,83.3%,1h
7828,3,[文韬武略]HLM,3102,141,4,2,6,66.7%,9m
7828,1,巴拉拉,3102,118,4,2,6,66.7%,43m
7828,3,[HeroZP]Dark,3102,30,2,3,5,40.0%,29m
7828,1,IIIIIIIIIII,3102,0,1,0,1,100.0%,11m
7828,2,玲珑骰子,3102,0,1,0,1,100.0%,1h
7828,1,燕双鹰,3102,73,0,2,2,0.0%,26m
7846,3,[萌新一只]Bela,3101,1609,244,241,485,50.3%,23m
7846,3,Pimab,3101,224,9,9,18,50.0%,4m
7846,3,[XJTU]futureshine,3101,231,8,5,13,61.5%,27m
7846,3,[闪耀DucK]老雷,3101,88,3,5,8,37.5%,26m
7846,3,残夜魂,3101,139,3,5,8,37.5%,30m
7846,3,NAPOLIYELLOW,3101,90,3,5,8,37.5%,15m
7846,1,[IlIIll]IIIIIIIIII,3101,100,2,3,5,40.0%,21m
7846,3,Crown,3101,0,1,3,4,25.0%,4m
7854,3,TanyQwQ,3100,1050,38,49,87,43.7%,29m
7854,3,Brokenwings,3100,209,8,17,25,32.0%,10m
7854,2,技术不好把我送,3100,168,6,2,8,75.0%,1h
7854,3,小向同学,3100,97,4,2,6,66.7%,33m
7854,3,SCVonBulaga,3100,141,4,4,8,50.0%,46m
7854,3,[小奶猫狂热者]大哥的鸡乐器,3100,58,2,4,6,33.3%,9m
7854,1,ThomasT,3100,0,1,0,1,100.0%,27m
7854,1,[青铜树]他掉分一直可以的,3100,0,1,0,1,100.0%,30m
7854,1,[半个菜鸟]handsomeZENG,3100,0,1,0,1,100.0%,25m
7854,3,IIIIIIII,3100,30,1,4,5,20.0%,30m
7854,2,少前药丸,3100,40,1,5,6,16.7%,30m
7865,3,菜鸟,3099,1432,274,263,537,51.0%,15m
7865,3,凌亮,3099,1563,141,126,267,52.8%,41m
7865,3,[新机械纪元]战斗吧歌姬,3099,1237,134,114,248,54.0%,23m
7865,3,奕歌,3099,1334,90,88,178,50.6%,45m
7865,3,[四佑]忘川河,3099,712,62,38,100,62.0%,12m
7865,3,MISSHY,3099,892,39,31,70,55.7%,28m
7865,3,[Sc养老]卑劣的泰伦人,3099,210,8,12,20,40.0%,12m
7865,3,木下三生,3099,112,8,17,25,32.0%,21m
7865,3,[小鸡屠宰场9]黑黑黑,3099,110,5,8,13,38.5%,11m
7865,2,谈笑风生又一年,3099,0,4,2,6,66.7%,1h
7865,3,[折戟是只鸡]一只画画,3099,92,3,8,11,27.3%,25m
7865,3,[勇者丶]Kerrigan,3099,58,2,4,6,33.3%,41m
7865,3,Piezo,3099,0,0,6,6,0.0%,25m
7878,3,tempo,3098,1531,357,363,720,49.6%,9m
7878,3,[火花骑士]兔兔伯爵,3098,726,89,72,161,55.3%,28m
7878,3,[谐的一逼]ShiningStars,3098,658,58,67,125,46.4%,26m
7878,3,[IMRTS2]键盘冒毒奶,3098,770,30,25,55,54.5%,28m
7878,3,[MUL]GuluCAT,3098,255,12,5,17,70.6%,16m
7878,3,希灵新伊甸联邦,3098,143,6,7,13,46.2%,46m
7878,3,[请叫我萌本]我儿子爱造航母,3098,94,3,19,22,13.6%,26m
7878,2,萝卜兔,3098,36,1,1,2,50.0%,30m
7886,3,lanrenriji,3097,1544,592,591,1183,50.0%,29m
7886,2,徐家汇圣堂巡遊者,3097,1498,272,271,543,50.1%,45m
7886,3,[Tracy]麦川,3097,1421,210,203,413,50.8%,20m
7886,3,周淑怡的逼也很嫩,3097,1505,67,58,125,53.6%,28m
7886,1,六月勇者,3097,1287,64,55,119,53.8%,10m
7886,3,犬夜叉,3097,672,30,23,53,56.6%,21m
7886,3,mrclean,3097,387,17,14,31,54.8%,11m
7886,3,Ins,3097,368,13,21,34,38.2%,19m
7886,3,yamansimida,3097,187,9,4,13,69.2%,23m
7886,3,sakura,3097,230,9,19,28,32.1%,27m
7886,2,hanbaobao,3097,222,8,4,12,66.7%,43m
7886,3,[一等星]枪兵叉叉和狗的事,3097,216,8,11,19,42.1%,41m
7886,1,[LSDsc2]SisterEr,3097,174,6,4,10,60.0%,26m
7886,1,枫妍,3097,73,4,2,6,66.7%,13m
7886,3,[软萌甜小萝莉]RedLotus,3097,88,4,4,8,50.0%,14m
7886,1,[无敌战队]圣堂之殇,3097,117,3,2,5,60.0%,35m
7886,3,且听风起,3097,90,3,6,9,33.3%,23m
7886,1,艾尔,3097,70,2,3,5,40.0%,15m
7886,3,[Announ]橙黄白毫,3097,62,2,12,14,14.3%,30m
7886,1,[gusl]owenbin,3097,42,1,2,3,33.3%,41m
7906,2,你凭什么念念不忘,3096,1543,225,235,460,48.9%,31m
7906,3,[轻岁月]不爱说话,3096,1277,69,68,137,50.4%,18m
7906,3,战略防御,3096,786,60,42,102,58.8%,20m
7906,3,逆袭,3096,1468,54,63,117,46.2%,26m
7906,3,鬼月,3096,366,48,51,99,48.5%,24m
7906,1,Magicbox,3096,912,31,25,56,55.4%,25m
7906,3,[X英雄圣域X]诸星,3096,550,19,24,43,44.2%,10m
7906,3,[半个菜鸟]nist,3096,176,7,8,15,46.7%,44m
7906,3,[素貭極差]车马邮件比较慢,3096,146,6,6,12,50.0%,3m
7906,3,[壮哉我胖哥]Ricardo,3096,0,5,0,5,100.0%,1h
7906,2,[矿物储量过足]命运捉弄着我,3096,144,4,0,4,100.0%,6m
7906,1,NaneeWa,3096,158,4,3,7,57.1%,25m
7906,1,[五月花]IIIIIIIIIIII,3096,0,3,2,5,60.0%,17m
7906,3,[我队伍很强大]一只呆呆的泽兽,3096,30,2,3,5,40.0%,41m
7906,1,[妖精卜卜口]Madness,3096,0,0,1,1,0.0%,11m
7906,1,喵喵喵喵喵喵喵,3096,0,0,1,1,0.0%,30m
7922,3,SCV,3095,1466,93,87,180,51.7%,26m
7922,3,SAKURA,3095,892,85,89,174,48.9%,44m
7922,1,天国恶魔,3095,419,23,20,43,53.5%,24m
7922,3,我的天,3095,480,20,23,43,46.5%,12m
7922,3,[花花]MRmoney,3095,346,12,9,21,57.1%,44m
7922,3,星灵怎么打,3095,122,5,7,12,41.7%,42m
7922,1,血夜暗瞳,3095,87,4,2,6,66.7%,16m
7922,2,[QWERTY]Prophet,3095,97,4,3,7,57.1%,1h
7922,2,潇洒,3095,152,4,4,8,50.0%,18m
7922,2,[Ogier]OGNotailFANs,3095,94,2,0,2,100.0%,46m
7922,3,HaoHao,3095,0,1,0,1,100.0%,19m
7922,1,[底特律KAR]Blinker,3095,0,1,0,1,100.0%,26m
7922,1,光明的影子,3095,93,1,1,2,50.0%,41m
7922,3,[你画我瞎]魔法少女一开叫,3095,96,1,1,2,50.0%,12m
7922,1,隐子,3095,0,0,1,1,0.0%,30m
7922,1,wwwcec,3095,0,0,2,2,0.0%,15m
7938,3,[朗德贝尔]岂因祸福避趋之,3094,1204,170,155,325,52.3%,26m
7938,3,saadg,3094,1226,111,105,216,51.4%,12m
7938,3,我又不浪,3094,751,32,29,61,52.5%,31m
7938,3,夜神月,3094,442,29,32,61,47.5%,45m
7938,2,uptownfunk,3094,495,17,33,50,34.0%,23m
7938,3,奥秘法司马,3094,245,8,1,9,88.9%,24m
7938,3,千叉万狗奈我何,3094,144,3,3,6,50.0%,4m
7938,3,[社交学大可爱]Kikuru,3094,60,3,4,7,42.9%,30m
7938,2,机械爬虫,3094,95,2,1,3,66.7%,24m
7938,1,[艾尔之主]VFskyrim,3094,44,2,1,3,66.7%,33m
7938,1,[壮哉我胖哥]Yan,3094,0,1,0,1,100.0%,41m
7938,3,[斯巴达血战团]故寂笙歌,3094,0,0,3,3,0.0%,44m
7950,3,[好男人就是我]MODONLAI,3093,1510,222,218,440,50.5%,44m
7950,3,天真无邪小白浪,3093,1208,79,68,147,53.7%,12m
7950,3,momo,3093,904,48,50,98,49.0%,46m
7950,1,Smile,3093,695,25,14,39,64.1%,19m
7950,3,Ben,3093,682,25,28,53,47.2%,24m
7950,3,PlayHard,3093,478,16,25,41,39.0%,17m
7950,1,[miku守护]狂怒肆意,3093,347,10,5,15,66.7%,19m
7950,3,[科学养猪谐会]白给白给,3093,254,10,14,24,41.7%,24m
7950,3,erEFF,3093,187,6,4,10,60.0%,10m
7950,3,Aloamd,3093,0,5,0,5,100.0%,1h
7950,1,[玄門]FishZhou,3093,80,3,1,4,75.0%,15m
7950,3,Tempest,3093,0,2,4,6,33.3%,17m
7950,3,funengliang,3093,0,0,1,1,0.0%,15m
7963,3,Jungle,3092,1507,212,213,425,49.9%,9m
7963,3,执扇观雨落,3092,1534,113,78,191,59.2%,31m
7963,3,锁哥,3092,382,18,22,40,45.0%,4m
7963,1,zzz,3092,252,7,4,11,63.6%,41m
7963,3,Inglorious,3092,188,6,2,8,75.0%,20m
7963,1,Maple,3092,152,5,0,5,100.0%,26m
7963,3,元大,3092,0,4,1,5,80.0%,5m
7963,1,Fiylol,3092,138,4,3,7,57.1%,44m
7971,3,[GOTAL]烨殒,3091,1531,164,165,329,49.8%,14m
7971,3,兜里有糖,3091,1484,73,67,140,52.1%,9m
7971,3,banana,3091,1209,63,37,100,63.0%,7m
7971,3,[盖世双谐]打星际我只玩神族,3091,582,53,60,113,46.9%,18m
7971,3,hhhhhhhhhhhh,3091,601,45,32,77,58.4%,30m
7971,3,llllllllllll,3091,1015,38,38,76,50.0%,15m
7971,1,条码人,3091,668,25,20,45,55.6%,18m
7971,3,新垣结衣,3091,434,21,25,46,45.7%,14m
7971,1,丿情谊灬至上,3091,432,12,11,23,52.2%,4m
7971,3,[高富帅]小牛牛,3091,346,11,12,23,47.8%,19m
7971,2,[去喂斯大林]wer,3091,206,8,3,11,72.7%,4m
7971,3,可以吗,3091,120,5,7,12,41.7%,6m
7971,3,猥琐神教教主,3091,30,1,4,5,20.0%,8m
7971,1,泰伦无敌,3091,0,0,1,1,0.0%,17m
7971,1,我疯问佛,3091,0,0,1,1,0.0%,11m
7986,3,心理咨询师,3090,1524,198,201,399,49.6%,42m
7986,3,靖云,3090,788,65,51,116,56.0%,24m
7986,3,WIT,3090,794,47,53,100,47.0%,9m
7986,1,迭戈科斯塔,3090,705,40,32,72,55.6%,26m
7986,3,Mike,3090,343,13,12,25,52.0%,5m
7986,1,白菜,3090,257,9,7,16,56.2%,44m
7986,3,Sunday,3090,201,7,4,11,63.6%,9m
7986,1,[大哥海口开矿]滋滋,3090,186,5,6,11,45.5%,26m
7986,3,VINNIE,3090,193,5,7,12,41.7%,26m
7986,2,IIIIIIIIII,3090,182,5,7,12,41.7%,57m
7986,1,转守为攻,3090,42,1,2,3,33.3%,41m
7986,1,我爱稀饭,3090,0,0,2,2,0.0%,16m
7986,3,RUNE,3090,0,0,4,4,0.0%,26m
7999,3,fiv,3089,746,122,116,238,51.3%,8m
7999,3,xiaomiantang,3089,1150,90,90,180,50.0%,41m
7999,1,Terror,3089,1335,65,51,116,56.0%,21m
7999,1,[应塔罗塔杀哒]THUNDERGHOST,3089,1338,58,52,110,52.7%,16m
7999,3,打不赢神族,3089,1228,45,57,102,44.1%,31m
7999,3,heartbeat,3089,496,18,20,38,47.4%,27m
7999,3,Renekton,3089,134,4,2,6,66.7%,19m
7999,2,优势了就要送一波,3089,0,0,1,1,0.0%,1h
7999,1,KyDParzival,3089,0,0,1,1,0.0%,13m
8008,3,saddas,3088,739,122,117,239,51.0%,45m
8008,2,Tutato,3088,1032,66,68,134,49.3%,31m
8008,1,妈咪妈咪哄,3088,1206,51,41,92,55.4%,26m
8008,3,[Beasty]来一览美景吧,3088,1034,41,38,79,51.9%,26m
8008,3,陈墨的我,3088,829,33,29,62,53.2%,17m
8008,1,IIIIII,3088,491,18,8,26,69.2%,45m
8008,1,Eternity,3088,302,17,18,35,48.6%,4m
8008,3,鸡贼哥,3088,260,10,12,22,45.5%,44m
8008,3,[鲁德欢]洋葱葱,3088,184,7,3,10,70.0%,8m
8008,1,见鬼,3088,210,7,4,11,63.6%,8m
8008,3,鬼刀,3088,154,7,6,13,53.8%,42m
8008,2,专家电脑,3088,158,6,4,10,60.0%,48m
8008,3,慢热喜静,3088,97,4,2,6,66.7%,23m
8008,1,邪恶的蜗牛,3088,0,1,0,1,100.0%,7m
8008,1,charge,3088,0,1,4,5,20.0%,44m
8008,1,kokoforever,3088,0,0,1,1,0.0%,5m
8024,3,askjdghlAIUh,3087,1580,97,94,191,50.8%,30m
8024,1,[手残眼瞎瘾大]白门楼破产律师,3087,899,41,33,74,55.4%,25m
8024,1,TYTY,3087,478,18,13,31,58.1%,11m
8024,3,恋人心灬,3087,0,5,0,5,100.0%,15m
8024,3,IIIIIIIIIII,3087,97,4,2,6,66.7%,1h
8024,1,生无可恋,3087,38,2,0,2,100.0%,25m
8024,1,北府宰相,3087,89,2,1,3,66.7%,41m
8024,3,蒂亚尼斯,3087,0,2,3,5,40.0%,1h
8024,3,Pluto,3087,114,2,3,5,40.0%,12m
8024,1,TWSZAN,3087,0,1,0,1,100.0%,4m
8024,1,未来的某一天,3087,0,1,0,1,100.0%,25m
8024,1,lucygaga,3087,42,1,1,2,50.0%,17m
8024,1,[哔哩哔哩乾杯]NzRE,3087,0,0,1,1,0.0%,21m
8024,2,电竞法王伊泽,3087,0,0,2,2,0.0%,13m
8038,2,困困困困困,3086,1480,228,227,455,50.1%,17m
8038,2,叼豪逗杰,3086,1517,183,196,379,48.3%,30m
8038,3,老肥,3086,405,23,23,46,50.0%,6m
8038,3,[DMRc]twt,3086,312,17,17,34,50.0%,19m
8038,1,[喵星排]幻风猫,3086,343,11,5,16,68.8%,15m
8038,1,kill,3086,230,8,8,16,50.0%,4m
8038,3,[TShark]为人须为陈冠希,3086,204,6,11,17,35.3%,12m
8038,3,[S09]于洋釰天,3086,0,5,1,6,83.3%,40m
8038,3,[大螃蟹]新鲜的肥肉,3086,121,5,2,7,71.4%,5m
8038,3,[Mensa]HALO,3086,120,5,9,14,35.7%,12m
8038,2,Tripos,3086,145,3,6,9,33.3%,28m
8038,2,[月返]落叶如秋,3086,95,2,1,3,66.7%,7m
8038,3,Vanish,3086,0,2,4,6,33.3%,1h
8038,1,[大叔同盟]老蔡蔡不是老菜菜,3086,0,1,0,1,100.0%,10m
8038,3,秒退之前想想马,3086,0,1,0,1,100.0%,26m
8038,1,[可爱的你们]xxxxxx,3086,0,1,1,2,50.0%,15m
8038,3,盗跖庄屩流誉后,3086,0,1,6,7,14.3%,30m
8038,1,[北部战区]SoS,3086,0,0,1,1,0.0%,7m
8038,1,热心网友小陈,3086,0,0,1,1,0.0%,5m
8038,3,粗棍子,3086,0,0,3,3,0.0%,46m
8058,3,暴君,3085,1474,161,143,304,53.0%,43m
8058,2,SoSo,3085,1591,152,165,317,47.9%,7m
8058,3,[ZJU]Moonlight,3085,1331,106,117,223,47.5%,45m
8058,3,三明治爵士,3085,1197,67,55,122,54.9%,5m
8058,1,LUREN,3085,1456,53,50,103,51.5%,11m
8058,3,蟑螂不就很好嘛,3085,728,25,31,56,44.6%,6m
8058,3,ranson,3085,503,20,13,33,60.6%,12m
8058,3,[全靠风干]看片不用纸,3085,136,14,11,25,56.0%,4m
8058,3,[狼王]祼筿蠡,3085,195,11,14,25,44.0%,42m
8058,1,凤凰杨,3085,288,10,9,19,52.6%,10m
8058,3,憨批,3085,269,9,6,15,60.0%,4m
8058,3,铂金的神,3085,194,9,13,22,40.9%,26m
8058,1,恩曲他滨替诺福韦,3085,204,8,5,13,61.5%,44m
8058,2,点到为止,3085,138,6,4,10,60.0%,27m
8058,1,[伊天降同萌会]kkl,3085,0,5,2,7,71.4%,1h
8058,1,六竹,3085,118,4,1,5,80.0%,45m
8058,3,时光丶永恒,3085,0,3,2,5,60.0%,1h
8075,3,Pisces,3084,1562,668,649,1317,50.7%,8m
8075,3,jjjjjjj,3084,1494,246,245,491,50.1%,6m
8075,3,birdcai,3084,1179,124,106,230,53.9%,7m
8075,3,sknight,3084,217,21,25,46,45.7%,26m
8075,1,[CUC20]努力小千,3084,367,15,12,27,55.6%,26m
8075,3,sky,3084,235,9,5,14,64.3%,9m
8075,2,[Vgirls]茕茕白兔,3084,215,9,8,17,52.9%,21m
8075,3,sktwulaodog,3084,278,9,10,19,47.4%,11m
8075,2,闪烁的余辉,3084,94,2,0,2,100.0%,1h
8075,1,[审判右翼]IIIIIIIIIIII,3084,82,2,4,6,33.3%,41m
8075,1,crybaby,3084,0,1,0,1,100.0%,25m
8075,1,[不会散枪兵]ACCOMPANY,3084,0,1,0,1,100.0%,41m
8075,1,[CnNami]JinAirsOs,3084,0,1,0,1,100.0%,30m
8075,2,[CNboys]萌萌的克尔苏加德,3084,0,1,0,1,100.0%,46m
8075,1,Jiang,3084,42,1,2,3,33.3%,18m
8075,1,在想念一个人,3084,0,0,1,1,0.0%,5m
8075,3,一个人的星球,3084,0,0,1,1,0.0%,24m
8092,3,[永恒自由]你爹临死前,3083,1589,389,373,762,51.0%,13m
8092,3,AnubiS,3083,1279,159,148,307,51.8%,41m
8092,3,想吃我的小唧唧吗,3083,1332,154,149,303,50.8%,7m
8092,3,[浙江大学战队]天梯对战乱入斯旺,3083,867,32,31,63,50.8%,7m
8092,1,[Zop]好想和你吹吹风,3083,358,29,20,49,59.2%,41m
8092,3,[光板高校]栗山未来,3083,485,20,18,38,52.6%,16m
8092,3,[lXoXl]killGodv,3083,265,12,7,19,63.2%,22m
8092,3,[星河气象学院]Pionoor,3083,310,11,10,21,52.4%,41m
8092,1,[NeXT]雪之下弱音,3083,96,4,4,8,50.0%,42m
8092,1,[NPUED]llllllllllll,3083,0,1,0,1,100.0%,4m
8092,3,QWQ,3083,0,0,3,3,0.0%,15m
8103,3,[无抵押信用贷]JJyy,3082,1351,406,397,803,50.6%,41m
8103,3,[刺客槶]海阔天空,3082,975,365,334,699,52.2%,46m
8103,3,ccooll,3082,1462,208,215,423,49.2%,8m
8103,1,imbamcc,3082,1426,64,34,98,65.3%,45m
8103,3,mvp,3082,616,27,22,49,55.1%,30m
8103,3,[黄旭东奶我输]efefwe,3082,684,26,29,55,47.3%,9m
8103,1,小仓朝日,3082,460,15,10,25,60.0%,4m
8103,3,AiXiaoKe,3082,110,12,14,26,46.2%,8m
8103,3,haoztt,3082,225,9,13,22,40.9%,9m
8103,3,asdf,3082,137,5,3,8,62.5%,44m
8103,3,WilsonZZM,3082,120,4,12,16,25.0%,42m
8103,1,[哔哩哔哩杯乾]镇长,3082,80,3,2,5,60.0%,17m
8103,1,碎的喧嚣,3082,38,1,1,2,50.0%,25m
8103,1,飞翔的板砖,3082,38,1,2,3,33.3%,25m
8103,3,[哟呵呵]天满八纯,3082,0,0,3,3,0.0%,44m
8118,1,[BTD]Admiral,3081,1761,208,207,415,50.1%,41m
8118,3,悲伤的西班牙,3081,1561,200,205,405,49.4%,30m
8118,3,[WgSC2]AlwaysJade,3081,1470,198,204,402,49.3%,42m
8118,3,尘光,3081,1196,150,133,283,53.0%,23m
8118,3,[孤独与烈酒]星盾游侠,3081,1548,126,121,247,51.0%,15m
8118,3,[HTW]whs,3081,763,106,93,199,53.3%,24m
8118,3,[好哥哥抬一手]RocketBo,3081,1110,45,49,94,47.9%,9m
8118,3,[天地會总舵]虾米,3081,1132,45,55,100,45.0%,27m
8118,3,WGY,3081,677,44,32,76,57.9%,28m
8118,3,总司小姐大胜利,3081,517,23,19,42,54.8%,11m
8118,3,SlayerSBoxeR,3081,522,19,26,45,42.2%,12m
8118,3,IIIIIIIIIIII,3081,355,12,13,25,48.0%,7m
8118,1,Infirm,3081,364,10,12,22,45.5%,15m
8118,3,TNT,3081,237,8,8,16,50.0%,41m
8118,3,[DMR]八三年的老人,3081,146,6,10,16,37.5%,31m
8118,1,丶一个人挺好灬,3081,0,1,0,1,100.0%,26m
8118,1,[恋战皇朝]原神真好玩,3081,0,1,1,2,50.0%,45m
8118,1,最美不过夕阳红,3081,0,0,1,1,0.0%,45m
8118,1,Johnsk,3081,0,0,1,1,0.0%,24m
8137,3,[咖啡Fans]NightQueen,3080,1437,73,54,127,57.5%,26m
8137,3,[炮火46]yingnovation,3080,950,69,60,129,53.5%,21m
8137,1,星際幼儿班学员,3080,873,30,23,53,56.6%,9m
8137,3,枯萎之地,3080,637,25,25,50,50.0%,9m
8137,3,[orjer]orjer,3080,438,16,15,31,51.6%,7m
8137,1,[韩湾土锤搬家]YueChuNexus,3080,428,12,13,25,48.0%,41m
8137,3,赛塔姆布里尼,3080,315,11,10,21,52.4%,27m
8137,1,ShiraiKuroko,3080,36,2,1,3,66.7%,24m
8137,2,[吊炸天]宁德时代,3080,64,2,23,25,8.0%,23m
8137,2,老夫乃天选之人,3080,0,1,0,1,100.0%,27m
8137,1,[MS13战术]幻化成风,3080,0,0,1,1,0.0%,25m
8148,1,大红裤衩常常穿,3079,1364,192,153,345,55.7%,41m
8148,1,cinereus,3079,1540,140,132,272,51.5%,41m
8148,1,[民主平等敬业]白白,3079,1096,41,31,72,56.9%,26m
8148,3,IIIIIIIIIII,3079,698,35,28,63,55.6%,4m
8148,3,[净化者执行官]Valkyire,3079,777,34,25,59,57.6%,12m
8148,3,翰墨琉璃,3079,277,26,23,49,53.1%,15m
8148,3,SmallDouble,3079,294,18,19,37,48.6%,16m
8148,3,[F2兄弟]教你城市化的欧成,3079,279,10,10,20,50.0%,25m
8148,1,[佩佩FANS]Sholva,3079,313,9,4,13,69.2%,25m
8148,1,马保国,3079,96,5,4,9,55.6%,26m
8148,1,[虾仁猪心]movetak,3079,42,2,1,3,66.7%,15m
8148,3,[四叶草]花落影榭,3079,58,2,5,7,28.6%,15m
8148,2,[主教连结]凯露天下第一,3079,34,1,3,4,25.0%,8m
8148,1,[北区38号]尼爾卡修,3079,0,0,1,1,0.0%,31m
8148,1,[SoLi]MrWheel,3079,0,0,1,1,0.0%,9m
8148,1,[C54456]Zop,3079,0,0,1,1,0.0%,41m
8148,2,[羽毛丰满]天真小鱼,3079,0,0,1,1,0.0%,1h
8165,3,HenryCc,3078,1136,103,100,203,50.7%,15m
8165,3,[巨龙降临]辛达苟萨,3078,807,51,49,100,51.0%,17m
8165,2,[Hist]destiny,3078,814,27,49,76,35.5%,5m
8165,1,丁云龙,3078,527,23,7,30,76.7%,41m
8165,1,semeell,3078,436,21,3,24,87.5%,25m
8165,1,Innovation,3078,605,20,17,37,54.1%,25m
8165,3,[鸡儿鸡儿]牛批的蜡笔小新,3078,200,9,8,17,52.9%,11m
8165,3,我是菜鸟,3078,140,3,6,9,33.3%,23m
8165,3,[抱舔天物]风中飘落的叶,3078,30,2,5,7,28.6%,15m
8165,1,[第五駆逐鑑隊]贞德达尔克,3078,0,0,1,1,0.0%,18m
8165,1,Stunde,3078,0,0,1,1,0.0%,9m
8165,3,[Marry]命运神龙,3078,0,0,1,1,0.0%,26m
8165,2,XboxMcutL,3078,0,0,1,1,0.0%,24m
8178,3,不会玩自动滚,3077,1527,202,202,404,50.0%,42m
8178,1,[不骄不躁]泽拉图之影,3077,1372,54,51,105,51.4%,25m
8178,3,[天雪]慵蓝,3077,609,38,34,72,52.8%,24m
8178,3,Neo,3077,398,35,28,63,55.6%,15m
8178,1,brezzedddd,3077,797,30,17,47,63.8%,30m
8178,3,[屠夫预备队]SKTrealy,3077,498,21,17,38,55.3%,41m
8178,3,[星魂]解除武装,3077,303,11,6,17,64.7%,29m
8178,3,我的马子在天边,3077,174,7,9,16,43.8%,20m
8178,2,阿波罗,3077,140,6,4,10,60.0%,31m
8178,3,矢量反射,3077,97,5,1,6,83.3%,1h
8178,3,NYJ,3077,168,5,5,10,50.0%,23m
8178,1,TossMan,3077,0,0,1,1,0.0%,28m
8190,1,阳秀,3076,1667,133,119,252,52.8%,6m
8190,2,平推岛国,3076,1487,133,130,263,50.6%,11m
8190,3,森卅,3076,1317,81,84,165,49.1%,9m
8190,3,银枪小霸王,3076,1149,68,69,137,49.6%,46m
8190,3,不要欺负我,3076,1358,58,47,105,55.2%,12m
8190,3,大山里,3076,518,36,26,62,58.1%,29m
8190,1,[CPT]粉红泡泡,3076,576,24,9,33,72.7%,30m
8190,1,xiaolan,3076,172,7,5,12,58.3%,40m
8190,1,Sylvie,3076,264,7,7,14,50.0%,28m
8190,2,太行,3076,167,6,2,8,75.0%,11m
8190,3,diachristo,3076,140,6,2,8,75.0%,16m
8190,3,[鹌鹑说的对]IIIIIIIIII,3076,186,6,13,19,31.6%,7m
8190,3,[后新星]SNinfinite,3076,159,5,8,13,38.5%,10m
8190,1,宜昌雷霸天,3076,160,4,5,9,44.4%,4m
8190,3,[空气逐渐蕉躁]我在化粪池边,3076,128,4,8,12,33.3%,41m
8190,3,[雾雨魔法森林]地台拳,3076,92,4,10,14,28.6%,21m
8190,3,忘记与记,3076,86,3,10,13,23.1%,4m
8190,1,[QAQa]dede,3076,36,2,0,2,100.0%,26m
8190,2,[我们是无敌的]子颜大大,3076,0,1,0,1,100.0%,1h
8190,3,[海德单推协会]战姬还是姬甲,3076,0,1,3,4,25.0%,21m
8210,3,[不偷不狗硬顶]可恨的菜逼,3075,1466,190,182,372,51.1%,31m
8210,3,问问为什么玩生化,3075,439,38,38,76,50.0%,10m
8210,3,[此处乃虎牢关]我爱欧依士,3075,876,37,41,78,47.4%,30m
8210,3,此奶大胸之兆,3075,370,15,9,24,62.5%,20m
8210,1,[cgnb]LLLLLLgq,3075,322,8,6,14,57.1%,41m
8210,2,炼狱,3075,142,7,3,10,70.0%,1h
8210,2,蔷薇,3075,141,4,3,7,57.1%,58m
8210,2,虚空之音,3075,113,2,2,4,50.0%,4m
8210,1,Mrlemon,3075,80,2,3,5,40.0%,6m
8210,2,zero,3075,0,1,0,1,100.0%,43m
8210,1,waffleyyy,3075,0,1,0,1,100.0%,7m
8221,3,那是松鼠吗,3074,1563,245,226,471,52.0%,44m
8221,1,战部渡,3074,1587,86,61,147,58.5%,30m
8221,3,[IMRTS]Mmyue,3074,1499,58,63,121,47.9%,15m
8221,3,seraph,3074,63,14,19,33,42.4%,13m
8221,1,传奇天殇,3074,141,5,1,6,83.3%,33m
8221,3,JacobFranci,3074,88,3,7,10,30.0%,46m
8221,1,[Rhusky]化学课呆表,3074,78,2,3,5,40.0%,26m
8221,2,[C81090]通杀武帝,3074,117,2,4,6,33.3%,1h
8221,1,南麓,3074,40,1,2,3,33.3%,11m
8221,1,dark,3074,44,1,3,4,25.0%,4m
8221,3,yaoyao,3074,93,1,4,5,20.0%,44m
8221,1,希瓦守护,3074,0,0,4,4,0.0%,1h
8233,3,STXBoGus,3073,867,263,254,517,50.9%,8m
8233,3,MoMoTo,3073,787,92,89,181,50.8%,14m
8233,1,小新,3073,1564,74,63,137,54.0%,30m
8233,1,小小杰尼,3073,327,37,17,54,68.5%,41m
8233,1,TageXiao,3073,591,22,17,39,56.4%,13m
8233,3,[柠檬与橘]Twilight,3073,288,9,10,19,47.4%,16m
8233,2,黑暗剑,3073,186,6,5,11,54.5%,7m
8233,3,Neutrino,3073,165,5,2,7,71.4%,24m
8233,1,[透一下清酒]FNAFSL,3073,82,2,4,6,33.3%,43m
8233,3,Iust,3073,0,1,0,1,100.0%,13m
8233,1,[神灵飞电]雪儿,3073,32,1,2,3,33.3%,19m
8233,3,少女初夜收割者,3073,30,1,5,6,16.7%,28m
8233,1,[PITB]Nandemonaiya,3073,0,0,1,1,0.0%,4m
8233,1,黑猫,3073,0,0,1,1,0.0%,31m
8233,1,凡星,3073,0,0,3,3,0.0%,4m
8248,1,Okami,3072,983,37,33,70,52.9%,26m
8248,3,[Sc养老]残心,3072,237,14,18,32,43.8%,15m
8248,2,soldier,3072,187,7,0,7,100.0%,41m
8248,3,塘主,3072,96,2,1,3,66.7%,20m
8248,3,dalihou,3072,30,2,3,5,40.0%,31m
8248,2,[HUC妖皇]运行者,3072,0,2,5,7,28.6%,34m
8248,2,[我们是大哥]OMG,3072,0,1,0,1,100.0%,58m
8248,1,Qzc,3072,0,1,1,2,50.0%,1h
8248,1,[SS闪电部隊]Sam,3072,0,1,1,2,50.0%,10m
8248,1,天猪,3072,0,0,1,1,0.0%,4m
8248,1,出海部,3072,0,0,2,2,0.0%,41m
8259,3,waitOneYear,3071,309,60,50,110,54.5%,15m
8259,1,[旺旺战士]Light,3071,1202,50,37,87,57.5%,31m
8259,3,singingwood,3071,664,41,40,81,50.6%,9m
8259,3,NZyan,3071,514,21,29,50,42.0%,11m
8259,1,风中一匹狼,3071,290,12,3,15,80.0%,26m
8259,1,你来杀我呀,3071,404,12,10,22,54.5%,11m
8259,1,xiaoming,3071,210,8,5,13,61.5%,1h
8259,1,瞎玩,3071,143,8,5,13,61.5%,42m
8259,3,天资卓越的小男孩,3071,240,8,7,15,53.3%,31m
8259,3,GEO,3071,240,8,9,17,47.1%,42m
8259,3,什么样的名字可用,3071,97,4,2,6,66.7%,1h
8259,1,[限量]虎牙花夕月,3071,139,4,2,6,66.7%,18m
8259,1,旗鼓相当的对手,3071,96,4,3,7,57.1%,20m
8259,3,iiiiiiiiiiii,3071,135,3,1,4,75.0%,58m
8259,1,[101空降师]Airborne,3071,0,3,2,5,60.0%,56m
8259,1,[lzz123]妹妹真棒,3071,0,2,0,2,100.0%,1h
8259,1,Abcd,3071,82,2,3,5,40.0%,27m
8259,3,Locust,3071,36,1,6,7,14.3%,41m
8259,1,Devilmoon,3071,0,0,1,1,0.0%,7m
8259,1,[基尼太美]onlyvagabond,3071,0,0,1,1,0.0%,43m
8259,2,黯灭大帝,3071,0,0,1,1,0.0%,14m
8259,3,打星际你快乐吗,3071,0,0,5,5,0.0%,14m
8281,3,江河汇海,3070,842,75,53,128,58.6%,13m
8281,3,[咖啡Fans]梦蝶蝶蝶蝶蝶,3070,783,27,28,55,49.1%,22m
8281,3,[336]Komorebi,3070,606,26,20,46,56.5%,15m
8281,3,[XXHZ13]黎剑,3070,483,17,19,36,47.2%,9m
8281,2,Bing,3070,184,8,5,13,61.5%,6m
8281,1,[沙星部]空山竹语,3070,0,3,2,5,60.0%,8m
8281,1,OldCaptain,3070,79,3,4,7,42.9%,26m
8281,1,[泰坦星养老院]新手的受虐狂,3070,0,0,1,1,0.0%,18m
8281,1,DKGT,3070,0,0,1,1,0.0%,41m
8290,3,八千越甲可吞吴,3069,1441,109,116,225,48.4%,17m
8290,3,虫族在哪里啊,3069,1026,62,65,127,48.8%,17m
8290,3,[CUMT]半城携半藏睡森林,3069,1479,62,73,135,45.9%,8m
8290,3,sherry,3069,1210,45,47,92,48.9%,22m
8290,1,[LDP]玩玩,3069,757,43,25,68,63.2%,43m
8290,1,[不要TVT]朱晨文的账号,3069,426,12,13,25,48.0%,41m
8290,3,[KPG]IIIIIIIIIIII,3069,234,9,17,26,34.6%,16m
8290,3,[哔翻天梯鸡]刘小飞,3069,149,8,8,16,50.0%,9m
8290,1,kim,3069,266,7,7,14,50.0%,7m
8290,3,欧西里斯的天空龙,3069,195,6,6,12,50.0%,26m
8290,3,好像一波,3069,76,6,11,17,35.3%,44m
8290,1,SonMouren,3069,112,4,1,5,80.0%,27m
8290,3,[Choice]Maru,3069,120,2,5,7,28.6%,44m
8290,1,[这都是好事]Dawn,3069,40,1,2,3,33.3%,15m
8290,1,狡猾的猎人,3069,0,0,1,1,0.0%,43m
8305,3,ClEm,3068,1062,53,44,97,54.6%,41m
8305,3,Sakura,3068,1456,53,53,106,50.0%,45m
8305,3,[科普卢老车队]Hym,3068,1175,49,55,104,47.1%,25m
8305,3,[ESKT]taoranyuting,3068,1069,47,41,88,53.4%,13m
8305,3,狗哥他大哥,3068,277,11,7,18,61.1%,26m
8305,1,椎名真白丶,3068,241,7,1,8,87.5%,13m
8305,3,东京不热,3068,122,5,9,14,35.7%,26m
8305,2,ssssss,3068,113,3,2,5,60.0%,27m
8313,3,demon,3067,1364,140,132,272,51.5%,41m
8313,3,[Wifi]Rival,3067,1515,63,59,122,51.6%,23m
8313,1,[NVKR]mocamoca,3067,1082,44,29,73,60.3%,16m
8313,3,IIIIIIIIIIII,3067,229,27,24,51,52.9%,41m
8313,1,IIIIIIIIIIII,3067,572,21,17,38,55.3%,9m
8313,3,[暴雪十队]倾风雨里爱你,3067,353,13,11,24,54.2%,29m
8313,1,[DMRc]两个年轻人,3067,172,6,3,9,66.7%,12m
8313,1,[四叶草]布丁味的咖啡,3067,0,4,1,5,80.0%,21m
8313,2,橙子,3067,0,4,2,6,66.7%,1h
8313,3,[tiandi]ZSLMDRY,3067,146,4,3,7,57.1%,23m
8313,3,Sephiroth,3067,98,3,14,17,17.6%,41m
8313,1,[济南]黄旭东,3067,0,1,0,1,100.0%,26m
8313,1,[星际票友]走火入魔,3067,0,1,0,1,100.0%,21m
8313,1,[花都一霸]SupCinc,3067,40,1,3,4,25.0%,26m
8313,3,[P就输不了]打星际选神族包赢,3067,0,0,1,1,0.0%,11m
8328,3,[KPG2]GZEZHANGLP,3066,568,63,59,122,51.6%,14m
8328,1,土豪张,3066,690,24,17,41,58.5%,21m
8328,1,sasa,3066,573,23,16,39,59.0%,4m
8328,3,[哔翻天梯鸡]妲己终妖,3066,524,22,17,39,56.4%,8m
8328,3,[Y1]ssadsd,3066,420,15,21,36,41.7%,26m
8328,1,july,3066,256,8,1,9,88.9%,6m
8328,1,INnoVation,3066,80,3,3,6,50.0%,12m
8328,3,[养生会馆]Kevin,3066,0,3,3,6,50.0%,26m
8328,3,ToneMba,3066,97,3,5,8,37.5%,4m
8328,1,臣妾散不开啊,3066,40,2,0,2,100.0%,26m
8328,1,玖木,3066,72,2,2,4,50.0%,26m
8328,3,[SDE]Singularity,3066,97,2,2,4,50.0%,12m
8328,1,来去虫虫,3066,66,2,4,6,33.3%,19m
8328,1,[神庙]ReeceZ,3066,0,0,1,1,0.0%,2m
8328,3,孙一喵,3066,0,0,1,1,0.0%,50m
8328,1,IDQ,3066,0,0,2,2,0.0%,9m
8328,1,自贡超人黄旭东,3066,0,0,2,2,0.0%,18m
8328,1,帝国远征军,3066,0,0,3,3,0.0%,24m
8346,3,光照之星,3065,872,110,107,217,50.7%,28m
8346,3,[浙大战队]在红尘中成仙,3065,603,32,15,47,68.1%,28m
8346,3,你打快攻灵车漂移,3065,686,28,31,59,47.5%,13m
8346,1,轩辕,3065,530,26,18,44,59.1%,15m
8346,3,[璇玑]啊这丷,3065,308,16,9,25,64.0%,4m
8346,3,eGoSeamew,3065,248,9,7,16,56.2%,42m
8346,2,[Anonym]TasKiller,3065,202,6,0,6,100.0%,41m
8346,1,Matthews,3065,176,6,2,8,75.0%,41m
8346,3,[幼稚园电竞班]菜鸟不寂寞,3065,163,5,2,7,71.4%,15m
8346,2,yangyang,3065,125,5,3,8,62.5%,14m
8346,3,uuu,3065,107,5,10,15,33.3%,1m
8346,3,[TyLC]冰淇淋红茶,3065,140,4,2,6,66.7%,46m
8346,2,llllllllllll,3065,44,2,2,4,50.0%,19m
8346,1,[GFA]Nightbane,3065,40,2,3,5,40.0%,26m
8346,1,手起刀落,3065,0,1,0,1,100.0%,13m
8346,1,[中铁17局]长虎牙的猪,3065,0,1,0,1,100.0%,41m
8346,3,[努力到最强]魂魄妖梦,3065,0,1,0,1,100.0%,1h
8346,3,[van的领域]ShallowDream,3065,0,0,1,1,0.0%,24m
8346,3,[佑我中华]往东京扔核弹,3065,0,0,1,1,0.0%,1h
8365,3,冷丶疯子,3064,690,28,31,59,47.5%,7m
8365,1,[猛侽骑脸]真正的猛蓝,3064,534,18,14,32,56.2%,21m
8365,3,vansto,3064,91,16,12,28,57.1%,8m
8365,1,[暴雪八队]DarkRanger,3064,0,1,0,1,100.0%,25m
8365,1,深渊星芒,3064,0,1,0,1,100.0%,6m
8365,3,TIMING,3064,30,1,8,9,11.1%,41m
8365,3,老年人打星际,3064,0,0,2,2,0.0%,4m
8372,3,llllllllllll,3063,1554,278,256,534,52.1%,46m
8372,3,摇滚男孩,3063,1351,196,174,370,53.0%,23m
8372,3,马伟伦,3063,1571,139,137,276,50.4%,26m
8372,3,[GoONE]丿冷如霜,3063,1000,112,99,211,53.1%,4m
8372,3,Uncleju,3063,1266,66,60,126,52.4%,28m
8372,3,苇怡是炜青的唯一,3063,1206,58,60,118,49.2%,15m
8372,3,[泰伦永不屈服]樱花我想你,3063,852,32,38,70,45.7%,42m
8372,3,潘凤大战邢道荣,3063,866,30,41,71,42.3%,11m
8372,3,喝药就是等死,3063,503,22,17,39,56.4%,21m
8372,1,iNnoTime,3063,534,16,14,30,53.3%,42m
8372,1,lllllllllll,3063,364,10,11,21,47.6%,18m
8372,2,乃爹,3063,165,7,4,11,63.6%,48m
8372,1,[北京肥宅]Tomerbaiwu,3063,230,6,6,12,50.0%,24m
8372,3,UnknownSCV,3063,42,3,5,8,37.5%,1h
8372,1,Evil,3063,74,2,4,6,33.3%,26m
8372,1,[Fe3o4]瓦伦里安,3063,0,1,1,2,50.0%,10m
8372,1,[艾蒙不萌]夜晚的寂静,3063,0,0,1,1,0.0%,3m
8372,1,xueba,3063,0,0,1,1,0.0%,7m
8390,3,GUINNESS,3062,1488,152,144,296,51.4%,26m
8390,3,妈妈不让我玩星际,3062,1088,108,112,220,49.1%,26m
8390,3,[忙忙撸撸]乖宝宝的老公,3062,1370,76,72,148,51.4%,12m
8390,3,[萌新酒吧]小雇佣兵,3062,596,28,24,52,53.8%,20m
8390,3,妍妍的小玉兔,3062,298,10,8,18,55.6%,12m
8390,3,redhome,3062,290,10,9,19,52.6%,26m
8390,1,龙卷风摧毁停车场,3062,250,8,5,13,61.5%,41m
8390,3,Awkward,3062,182,7,11,18,38.9%,27m
8390,3,狂刀三浪,3062,97,4,2,6,66.7%,1h
8390,2,魔法虫族尿急王,3062,95,3,2,5,60.0%,33m
8390,1,[Borne]翩跹,3062,116,3,3,6,50.0%,18m
8390,2,[遁去的壹]CarlYJQ,3062,0,3,4,7,42.9%,24m
8390,3,TIMO,3062,0,2,1,3,66.7%,1h
8390,1,[镜花水月]天狼星,3062,0,1,0,1,100.0%,21m
8390,1,dannyhao,3062,0,0,1,1,0.0%,42m
8405,1,冰激凌综合症患者,3061,1674,276,256,532,51.9%,43m
8405,3,seed,3061,1451,68,76,144,47.2%,24m
8405,3,[铁拳陆战队]Alone,3061,800,37,30,67,55.2%,2m
8405,3,AAA,3061,258,9,14,23,39.1%,2m
8405,3,[TREMOR]江南皮革厂厂长,3061,242,8,8,16,50.0%,23m
8405,3,征服卡利姆多,3061,97,4,2,6,66.7%,55m
8405,1,mydream,3061,146,4,3,7,57.1%,15m
8405,1,[人菜灬瘾大]雷鸣舞台,3061,0,3,2,5,60.0%,1h
8405,1,死神海拉,3061,34,2,0,2,100.0%,15m
8405,3,[动能矩阵开启]yyccvwic,3061,30,2,5,7,28.6%,42m
8405,3,东风谷早苗,3061,0,0,1,1,0.0%,19m
8405,1,樱花树,3061,0,0,1,1,0.0%,43m
8405,1,[幼稚园电竞班]CLWJ,3061,0,0,1,1,0.0%,18m
8405,1,[除非花手要过]sunxi,3061,0,0,1,1,0.0%,26m
8419,3,liji,3060,1244,168,148,316,53.2%,19m
8419,3,[GSMK]EternalLove,3060,581,76,72,148,51.4%,42m
8419,3,薇光,3060,1311,56,48,104,53.8%,16m
8419,1,[秋毫]年轻人不讲武德,3060,826,34,25,59,57.6%,4m
8419,1,[虚拟歌手团体]乐正绫,3060,680,25,19,44,56.8%,17m
8419,1,[饭太稀]娜迦之泪,3060,394,12,11,23,52.2%,42m
8419,1,Seele,3060,345,11,9,20,55.0%,2m
8419,3,[无形白给]小小雷神,3060,0,0,1,1,0.0%,40m
8419,2,Soul,3060,0,0,2,2,0.0%,14m
8419,3,PIMBA,3060,0,0,2,2,0.0%,17m
8419,1,IIIIIIIIIIII,3060,0,0,2,2,0.0%,15m
8430,2,超霸灭霸,3059,1565,538,547,1085,49.6%,27m
8430,3,[老婆一喊就退]gomescc,3059,1200,131,120,251,52.2%,9m
8430,3,[大宇宙时代]通天鸣彻个头,3059,1087,114,112,226,50.4%,17m
8430,1,[IMRTS]PolamaWang,3059,1583,65,55,120,54.2%,7m
8430,3,[暴雪养鸡场]毛衣,3059,1511,65,63,128,50.8%,11m
8430,1,一二三四五六七,3059,1167,61,46,107,57.0%,27m
8430,3,NNN,3059,578,20,28,48,41.7%,14m
8430,3,永恒,3059,389,16,13,29,55.2%,23m
8430,1,[Fe3o4]魔法少女美琴酱,3059,254,8,6,14,57.1%,18m
8430,1,绯狱,3059,114,4,1,5,80.0%,3m
8430,1,[我永远爱贞德]尘世美,3059,40,2,0,2,100.0%,11m
8430,1,不许你叫吴彦祖,3059,0,2,2,4,50.0%,1h
8430,1,烈酒,3059,0,1,1,2,50.0%,11m
8430,1,POOR,3059,0,0,1,1,0.0%,25m
8430,3,[天青车道]hehedeyifang,3059,0,0,7,7,0.0%,12m
8445,3,训练模式电脑,3058,1578,418,416,834,50.1%,26m
8445,2,在光的背后,3058,1363,107,111,218,49.1%,43m
8445,3,[学姐赛高]老年人也要打生化,3058,942,85,85,170,50.0%,42m
8445,3,火锅好吃,3058,463,21,20,41,51.2%,7m
8445,3,大唐鸣迪,3058,393,17,18,35,48.6%,5m
8445,1,[MYC]YouDareDogMe,3058,349,13,4,17,76.5%,24m
8445,1,娘了个锤的,3058,78,3,0,3,100.0%,41m
8445,1,Aerolite,3058,80,3,1,4,75.0%,4m
8445,1,IIIIIIIIIIII,3058,118,3,3,6,50.0%,10m
8445,1,[sc谐盟]无名小卒,3058,0,1,1,2,50.0%,2m
8445,3,hawsud,3058,0,1,6,7,14.3%,40m
8445,3,Bruce,3058,0,0,1,1,0.0%,4m
8445,1,[DAK]BlackNight,3058,0,0,1,1,0.0%,42m
8445,1,yingnovation,3058,0,0,1,1,0.0%,26m
8459,3,aimiFFMM,3057,1513,453,448,901,50.3%,15m
8459,3,FrSyrup,3057,1578,156,158,314,49.7%,2m
8459,3,nidie,3057,1205,55,42,97,56.7%,23m
8459,3,中二五彩小王子,3057,769,47,47,94,50.0%,15m
8459,3,李娜同学水里吻我,3057,683,26,29,55,47.3%,13m
8459,3,[bilibi]嘟嘟噜,3057,205,26,31,57,45.6%,42m
8459,3,野人,3057,258,14,16,30,46.7%,18m
8459,3,僵尸猴,3057,171,7,6,13,53.8%,5m
8459,2,[素貭極差]大源哥,3057,196,7,12,19,36.8%,43m
8459,3,[火焰雷兽]涅槃安慕希,3057,56,5,9,14,35.7%,9m
8459,3,寒雨雾凇,3057,133,3,0,3,100.0%,17m
8459,1,[NZNZ]Dark,3057,128,3,1,4,75.0%,43m
8459,1,[WZG]MasterXie,3057,0,1,0,1,100.0%,7m
8459,1,longxi,3057,40,1,2,3,33.3%,9m
8459,1,SDG,3057,40,1,2,3,33.3%,21m
8459,1,[love西瓜]rollingdice,3057,0,0,1,1,0.0%,11m
8459,1,[闪击战]开坦克的皮皮鲁,3057,0,0,1,1,0.0%,8m
8459,1,[软萌甜小萝莉]MisterFrog,3057,0,0,1,1,0.0%,15m
8477,3,silverjun,3056,1539,168,164,332,50.6%,15m
8477,1,[舰队我是你爹]Xel,3056,1705,140,133,273,51.3%,9m
8477,3,别让我看见神族,3056,838,93,81,174,53.4%,44m
8477,3,Evilcounter,3056,984,67,58,125,53.6%,9m
8477,3,Grant,3056,528,23,24,47,48.9%,24m
8477,3,[SRI]彩笔没办法,3056,316,21,22,43,48.8%,10m
8477,1,[小金上天队]Meow,3056,218,6,6,12,50.0%,27m
8477,3,[抽爷]BBBBT,3056,0,5,1,6,83.3%,1h
8477,3,星炽,3056,97,5,2,7,71.4%,58m
8477,2,[小狐狸]电波波波酱嘤嘤嘤,3056,0,1,0,1,100.0%,54m
8477,1,[追踪剑击]再临犬走椛,3056,0,1,0,1,100.0%,34m
8477,1,第一秩序,3056,0,1,0,1,100.0%,24m
8477,1,monks,3056,0,1,2,3,33.3%,26m
8477,1,国服炸鱼亲妈暴毙,3056,0,0,1,1,0.0%,11m
8491,3,wadu,3055,1559,195,197,392,49.7%,12m
8491,3,Sybmars,3055,1150,44,44,88,50.0%,12m
8491,1,[TNLtr]蹲角菜鸡叫兽,3055,462,14,10,24,58.3%,14m
8491,1,[太极極門掌門]晓磊,3055,300,9,8,17,52.9%,3m
8491,3,人渣的本愿,3055,69,6,6,12,50.0%,10m
8491,1,woshisb,3055,0,5,0,5,100.0%,1h
8491,3,[绀野木绵季]援气少女卷毛酱,3055,177,5,8,13,38.5%,14m
8491,1,Fluctuation,3055,112,3,5,8,37.5%,45m
8491,1,LEO,3055,30,2,3,5,40.0%,10m
8491,3,[爆裂吧现实]十行雨,3055,30,1,3,4,25.0%,4m
8501,3,杀手游戏,3054,982,54,64,118,45.8%,15m
8501,3,我的光头能对空,3054,764,30,31,61,49.2%,44m
8501,3,Mabinogi,3054,577,26,24,50,52.0%,7m
8501,1,free,3054,215,8,3,11,72.7%,42m
8501,3,[长沙周黑鸭]没有啊,3054,97,4,2,6,66.7%,1h
8501,1,同济第一猥琐男,3054,0,4,3,7,57.1%,1h
8501,3,[tiandi]Wunder,3054,148,3,6,9,33.3%,41m
8501,1,[火焰雷兽]bjshuo,3054,0,1,0,1,100.0%,26m
8501,1,Uglyman,3054,73,1,1,2,50.0%,26m
8501,1,西北女马个鸡泰伦,3054,0,1,1,2,50.0%,42m
8501,1,[五月花]TalaTerran,3054,42,1,2,3,33.3%,14m
8501,1,坳里催花,3054,40,1,3,4,25.0%,25m
8501,3,旋风叉,3054,97,1,5,6,16.7%,33m
8501,3,[北极光小组]我将再次修起地堡,3054,30,1,6,7,14.3%,10m
8501,1,宝贝的猪头三,3054,0,0,1,1,0.0%,43m
8501,1,APM,3054,0,0,1,1,0.0%,19m
8501,1,[绯世梦璃花]砂糖少女以爱为食,3054,0,0,1,1,0.0%,9m
8501,3,[酷酷哒]容克斯图卡轰炸机,3054,0,0,1,1,0.0%,1h
8501,1,布谷鸟,3054,0,0,2,2,0.0%,41m
8520,3,想你的楠笙,3053,343,55,36,91,60.4%,8m
8520,3,修地堡的都是狗,3053,764,55,51,106,51.9%,22m
8520,3,糖糖糖糖,3053,903,42,44,86,48.8%,12m
8520,3,[东大电竞]windawn,3053,704,25,29,54,46.3%,17m
8520,3,IIIIIIIIIIII,3053,188,6,3,9,66.7%,8m
8520,1,specter,3053,66,3,4,7,42.9%,27m
8520,1,寂寞冷空虚,3053,34,1,2,3,33.3%,26m
8520,3,CILDK,3053,0,1,3,4,25.0%,20m
8520,1,PartinG,3053,0,0,2,2,0.0%,41m
8529,3,从入门到跑路,3052,1456,86,94,180,47.8%,11m
8529,3,dotaery,3052,413,16,13,29,55.2%,45m
8529,1,geyucong,3052,344,13,11,24,54.2%,8m
8529,3,韩少爷,3052,243,8,3,11,72.7%,15m
8529,2,卡其脱离太,3052,161,7,4,11,63.6%,29m
8529,3,INnoVation,3052,60,2,8,10,20.0%,12m
8529,1,[THUDE]OhYes,3052,0,1,0,1,100.0%,9m
8529,3,[镜花水月]有妹是穹,3052,0,1,0,1,100.0%,20m
8529,3,[传奇舰队]陆小哄,3052,96,1,2,3,33.3%,6m
8529,1,[梨花]太阳花上的幽香,3052,0,1,3,4,25.0%,7m
8529,3,wangfan,3052,30,1,5,6,16.7%,23m
8529,1,Simas,3052,0,0,1,1,0.0%,16m
8529,1,Calendula,3052,0,0,2,2,0.0%,26m
8529,1,[后宫园]huahua,3052,0,0,2,2,0.0%,1h
8543,3,无法决定,3051,1517,798,766,1564,51.0%,41m
8543,3,[Sc13]七二,3051,1464,344,349,693,49.6%,9m
8543,3,LittleCat,3051,1314,159,159,318,50.0%,3m
8543,3,AKZO,3051,955,137,125,262,52.3%,27m
8543,3,DylonDi,3051,859,59,65,124,47.6%,3m
8543,1,PartinG,3051,375,14,4,18,77.8%,19m
8543,1,zlczkx,3051,323,11,8,19,57.9%,25m
8543,1,[阿板大队]potato,3051,328,9,12,21,42.9%,18m
8543,1,枯叶飘零,3051,242,6,8,14,42.9%,9m
8543,3,神族小兵,3051,116,5,7,12,41.7%,18m
8543,1,[魔女兵器]麦茜,3051,106,4,3,7,57.1%,19m
8543,1,IIIIIIIIIIII,3051,82,3,5,8,37.5%,25m
8543,3,苦逼的平民,3051,122,2,4,6,33.3%,45m
8543,2,[摸鱼探姬]未来,3051,44,2,7,9,22.2%,2m
8543,3,人帅何须艾迪拽,3051,0,0,4,4,0.0%,17m
8558,1,Break,3050,574,23,17,40,57.5%,10m
8558,3,[混元崔欣门]DDFanTasy,3050,403,17,19,36,47.2%,17m
8558,1,felixcxj,3050,372,14,13,27,51.9%,46m
8558,2,FISH,3050,294,13,9,22,59.1%,44m
8558,1,[索嚗命鋲斋]烬染不夜,3050,340,12,6,18,66.7%,46m
8558,2,炎龍,3050,282,12,10,22,54.5%,13m
8558,1,Solar,3050,80,3,1,4,75.0%,25m
8558,1,Winds,3050,0,3,1,4,75.0%,32m
8558,3,洪俊杰,3050,30,2,7,9,22.2%,43m
8558,1,IIIIIIIIIIII,3050,0,1,1,2,50.0%,41m
8558,1,KUKUKIKI,3050,0,1,2,3,33.3%,26m
8558,3,佑丨昕,3050,0,1,3,4,25.0%,14m
8558,1,[无敌的]无敌的,3050,0,0,1,1,0.0%,17m
8571,1,[好爷爷]你狗哥你狗爷,3049,1043,104,95,199,52.3%,7m
8571,1,[ZJU]此生无悔入粪坑,3049,698,60,35,95,63.2%,16m
8571,3,Yuki,3049,841,37,49,86,43.0%,27m
8571,3,[envy]EnvyAngle,3049,408,24,26,50,48.0%,21m
8571,1,斗鱼丑开,3049,456,19,9,28,67.9%,15m
8571,3,我很乖,3049,265,13,7,20,65.0%,47m
8571,1,[SoLi]小学生归来,3049,322,10,10,20,50.0%,7m
8571,2,竹取,3049,121,5,3,8,62.5%,15m
8571,1,realbin,3049,48,4,2,6,66.7%,1h
8571,1,星光熠熠,3049,0,4,3,7,57.1%,1h
8571,3,[邓传薪]潮留美海,3049,120,4,11,15,26.7%,42m
8571,1,进击的枪兵,3049,72,3,2,5,60.0%,8m
8571,1,[HK丶S]雾起时鹿吟,3049,42,2,2,4,50.0%,11m
8571,2,[同卵双狗]上海孙一峰,3049,0,1,0,1,100.0%,34m
8571,1,空天,3049,0,1,0,1,100.0%,4m
8586,1,不觉流水年长,3048,691,84,82,166,50.6%,41m
8586,3,llllllllllll,3048,1097,65,62,127,51.2%,46m
8586,3,夏雨霸气小王子,3048,312,34,34,68,50.0%,1m
8586,3,Stochastic,3048,722,29,31,60,48.3%,21m
8586,1,[丨哔哩哔哩丨]IIIIIIIIIIII,3048,501,18,11,29,62.1%,43m
8586,1,Bymby,3048,375,15,11,26,57.7%,9m
8586,1,[五月花]冥王星雪,3048,341,13,7,20,65.0%,46m
8586,1,[时间]Shadow,3048,345,11,10,21,52.4%,13m
8586,1,自信枪兵,3048,351,10,6,16,62.5%,28m
8586,3,skyD,3048,137,5,4,9,55.6%,1h
8586,3,Mac,3048,0,3,3,6,50.0%,1m
8586,1,[SEEE]INnoVation,3048,0,1,0,1,100.0%,4m
8586,1,今天你动脑了吗,3048,0,1,0,1,100.0%,9m
8586,1,湖美全太阳,3048,0,1,0,1,100.0%,4m
8586,1,[rush2]斗斗无敌,3048,38,1,1,2,50.0%,25m
8586,1,呢招对我冇用,3048,0,1,4,5,20.0%,57m
8586,1,[纸鸢i]zzreal,3048,34,1,4,5,20.0%,2m
8603,3,唐僧,3047,1241,72,65,137,52.6%,46m
8603,3,Trent,3047,623,39,43,82,47.6%,11m
8603,3,[AstoIF]Diamond,3047,240,35,29,64,54.7%,42m
8603,1,[工口]Damon,3047,662,30,27,57,52.6%,25m
8603,3,侧耳倾听,3047,591,25,21,46,54.3%,1m
8603,3,请不要,3047,628,25,23,48,52.1%,3m
8603,3,蝇头小利啦,3047,224,15,21,36,41.7%,12m
8603,1,星际游丶圣战,3047,301,13,11,24,54.2%,3m
8603,1,老子戒酒,3047,116,3,2,5,60.0%,27m
8603,1,Romance,3047,38,2,1,3,66.7%,9m
8603,1,[Maple1]小枫,3047,0,1,0,1,100.0%,18m
8603,3,嘻哈之韩同学,3047,0,1,0,1,100.0%,17m
8603,1,[笙风]郑小俊,3047,0,0,1,1,0.0%,46m
8616,3,[小淦上天队]魔法少女鸽子酱,3046,480,21,25,46,45.7%,12m
8616,3,[红色锤镰]Jupiter,3046,534,20,19,39,51.3%,26m
8616,1,[核桃]HHHHHHH,3046,444,14,14,28,50.0%,18m
8616,1,skyTree,3046,301,10,3,13,76.9%,9m
8616,3,由内而外,3046,170,6,11,17,35.3%,44m
8616,3,[s黑色玫瑰s]追梦空哥,3046,0,5,1,6,83.3%,16m
8616,1,xiaodoudou,3046,97,4,2,6,66.7%,17m
8616,1,[YKSN]涼月,3046,198,4,3,7,57.1%,18m
8616,1,[南建盟]兔头人,3046,126,3,2,5,60.0%,18m
8616,1,十三少灬,3046,118,3,5,8,37.5%,26m
8616,3,[暴雪三十一队]奥特曼,3046,96,2,1,3,66.7%,8m
8616,3,等风来,3046,30,2,7,9,22.2%,19m
8616,1,[符华天下第一]Cynic,3046,0,0,1,1,0.0%,15m
8616,1,巴黎的春天,3046,0,0,4,4,0.0%,28m
8630,3,[微笑就好]Dorom,3045,268,11,10,21,52.4%,1m
8630,1,[Borne]文人秋月,3045,174,6,5,11,54.5%,25m
8630,1,点击取消,3045,264,6,5,11,54.5%,2m
8630,1,icarus,3045,186,6,7,13,46.2%,10m
8630,3,[曲线救国]铃屋什造,3045,138,4,1,5,80.0%,23m
8630,1,菜鸡,3045,114,3,6,9,33.3%,41m
8630,1,浪漫的白金,3045,40,2,1,3,66.7%,41m
8630,1,[最菜战队]iloveyiming,3045,0,1,0,1,100.0%,15m
8630,2,我的女友邓紫棋,3045,0,1,0,1,100.0%,1h
8630,1,soSo,3045,34,1,1,2,50.0%,41m
8630,3,[胖墩儿]Arcturus,3045,0,0,1,1,0.0%,1h
8630,1,[中华讲武堂]老八秘制小汉堡,3045,0,0,2,2,0.0%,41m
8642,3,HYS,3044,1544,143,131,274,52.2%,3m
8642,3,[社交学大可爱]虚空墨世,3044,1240,66,46,112,58.9%,41m
8642,1,MrGuo,3044,489,23,10,33,69.7%,2m
8642,1,OdettiHUI,3044,606,19,14,33,57.6%,6m
8642,3,胖子,3044,570,18,29,47,38.3%,44m
8642,3,IIIIIIIIIIII,3044,158,6,3,9,66.7%,24m
8642,1,太多了,3044,154,4,0,4,100.0%,26m
8642,3,[小金上天队]勇者是一方大人,3044,121,4,3,7,57.1%,47m
8642,1,[风蓬飘尽悲歌]冷月,3044,76,3,1,4,75.0%,16m
8642,1,Allmight,3044,106,3,3,6,50.0%,16m
8642,1,IIIIIIIIII,3044,40,2,0,2,100.0%,15m
8642,1,千年幻想,3044,126,2,1,3,66.7%,2m
8642,3,[心宽体胖]清宵短,3044,40,2,1,3,66.7%,17m
8642,1,普瑞赛斯,3044,42,2,1,3,66.7%,46m
8642,1,[XCode]泰州小绵羊,3044,0,0,1,1,0.0%,4m
8642,3,山海,3044,0,0,11,11,0.0%,7m
8658,3,[蟲出武装队]我爱地堡,3043,1321,82,68,150,54.7%,5m
8658,1,[敲半天有用么]Moment,3043,1064,37,34,71,52.1%,18m
8658,3,Scarlett,3043,880,32,38,70,45.7%,7m
8658,1,[以肉为主]正义波,3043,317,15,9,24,62.5%,13m
8658,2,loktar,3043,149,15,9,24,62.5%,6m
8658,3,[星之所在RI]岁月河里的摆渡人,3043,312,13,9,22,59.1%,46m
8658,1,[星际鸽子组]铝离子,3043,352,12,22,34,35.3%,11m
8658,2,灭世毒爆,3043,124,7,5,12,58.3%,28m
8658,2,[KPG]Alostof,3043,0,1,0,1,100.0%,58m
8667,3,lazyandfat,3042,1556,176,170,346,50.9%,3m
8667,1,TaeYeoN,3042,999,121,108,229,52.8%,21m
8667,2,[爱4]老夫很强,3042,1188,89,108,197,45.2%,27m
8667,1,魔法少女文森特,3042,1350,72,71,143,50.3%,3m
8667,3,我永远喜欢麻衣,3042,1047,64,47,111,57.7%,20m
8667,3,llllllllllll,3042,658,36,30,66,54.5%,44m
8667,1,[禽禽禽]全太阳,3042,879,32,26,58,55.2%,7m
8667,3,LPXiaoShuai,3042,517,21,20,41,51.2%,14m
8667,3,美少女万华镜莲华,3042,600,21,29,50,42.0%,8m
8667,1,快乐之足,3042,362,14,10,24,58.3%,11m
8667,2,瓦力,3042,276,13,10,23,56.5%,11m
8667,1,Alexken,3042,337,12,8,20,60.0%,24m
8667,1,风暴之灵,3042,186,8,6,14,57.1%,36m
8667,1,[樱酒猫]天际之谜,3042,264,8,9,17,47.1%,25m
8667,1,ghostking,3042,288,8,10,18,44.4%,10m
8667,3,zwx,3042,92,3,7,10,30.0%,20m
8667,3,[框本之魂]老框本,3042,94,3,14,17,17.6%,7m
8667,1,[黑粉头子]暗影之鱼,3042,95,2,1,3,66.7%,44m
8667,3,[吻丶Say]DuoReMi,3042,122,2,2,4,50.0%,1h
8667,1,星星,3042,40,2,2,4,50.0%,25m
8667,1,[鬼眯扯眼]雀神怪鸟,3042,30,1,1,2,50.0%,25m
8667,1,艾尔之光,3042,96,1,2,3,33.3%,1h
8667,1,[萝莉之芯]影月仇,3042,0,0,1,1,0.0%,15m
8690,3,emijoe,3041,1543,161,160,321,50.2%,18m
8690,3,CrossEvery,3041,1393,148,125,273,54.2%,12m
8690,3,左手舞键盘,3041,1321,137,139,276,49.6%,41m
8690,1,[兆景埋土大学]黑冰与神异,3041,1674,103,95,198,52.0%,14m
8690,3,米二狗,3041,1273,86,83,169,50.9%,2m
8690,1,[艾尔之主]草泥马是神马,3041,889,47,40,87,54.0%,15m
8690,3,[隐藏文件夹]欧域风情,3041,608,29,24,53,54.7%,15m
8690,1,freedom,3041,818,27,30,57,47.4%,9m
8690,2,ByuN,3041,245,11,9,20,55.0%,29m
8690,1,光之战翼,3041,228,9,6,15,60.0%,1h
8690,1,[GDG]剑不归,3041,210,5,4,9,55.6%,24m
8690,1,你今天也超可爱,3041,0,1,0,1,100.0%,9m
8690,1,[麒云]IIIIIIIIIIII,3041,0,1,0,1,100.0%,41m
8690,1,[我们的奇迹]我即是虫群,3041,40,1,2,3,33.3%,19m
8690,1,星际争霸,3041,0,0,1,1,0.0%,11m
8690,1,SunCy,3041,0,0,1,1,0.0%,14m
8706,3,[Ps]FirecLoUd,3040,1073,74,76,150,49.3%,9m
8706,1,[怎么赢P]一点一滴,3040,622,62,37,99,62.6%,25m
8706,3,[南京理工大]honest,3040,1294,45,56,101,44.6%,43m
8706,1,[香蕉派]蕉泥座人,3040,1180,42,41,83,50.6%,16m
8706,1,[皇族]暗淡的白,3040,713,25,17,42,59.5%,19m
8706,3,[噗噗噗]光之影面,3040,696,24,34,58,41.4%,46m
8706,1,别玩水老王,3040,450,14,12,26,53.8%,14m
8706,1,Recall,3040,186,6,4,10,60.0%,41m
8706,1,[艾利克斯]温柔可爱的小女仆,3040,220,6,6,12,50.0%,24m
8706,1,饲料加工,3040,152,4,1,5,80.0%,43m
8706,1,[SiL]Spirit,3040,78,3,4,7,42.9%,2m
8706,3,中飞院最后的单纯,3040,97,2,0,2,100.0%,4m
8706,1,[C39398]灵魂无须归宿,3040,38,2,1,3,66.7%,41m
8706,3,ANG,3040,30,1,7,8,12.5%,12m
8720,3,[一切只為亮騷]螳臂当车的歹徒,3039,1396,93,96,189,49.2%,14m
8720,3,年轻人不讲武德,3039,1021,57,46,103,55.3%,17m
8720,3,[FJUT]pimba,3039,396,25,22,47,53.2%,45m
8720,1,south,3039,462,16,13,29,55.2%,27m
8720,3,[天梯引路人]mayu,3039,276,11,26,37,29.7%,17m
8720,1,[万事皆允]苍穹之链,3039,214,10,6,16,62.5%,1h
8720,1,[大姐酒家]莽夫虫族,3039,182,4,2,6,66.7%,1h
8720,1,[DNF]小崔,3039,112,4,5,9,44.4%,41m
8720,1,[写进诗的结尾]七里香,3039,0,1,0,1,100.0%,11m
8720,3,忽远忽近的洒脱,3039,0,1,4,5,20.0%,43m
8720,1,[暴雪十一队]南桉,3039,0,0,1,1,0.0%,1h
8720,1,[皇室联盟]欧皇传说,3039,0,0,3,3,0.0%,27m
8732,3,MarineKing,3038,1294,73,81,154,47.4%,28m
8732,3,[北京外事电竞]POWER,3038,480,29,25,54,53.7%,20m
8732,1,gww,3038,425,26,11,37,70.3%,11m
8732,1,曾经爱啧祢,3038,238,8,6,14,57.1%,41m
8732,1,银河最速,3038,48,4,2,6,66.7%,1h
8732,1,[红果果QwQ]凤尾金鱼,3038,125,3,0,3,100.0%,8m
8732,1,[长夜将至]柠檬琉璃夏,3038,0,3,2,5,60.0%,15m
8732,1,黑暗骑士,3038,76,2,3,5,40.0%,2m
8732,1,sos,3038,0,1,0,1,100.0%,1h
8732,3,[Toss]IIIIIIIIIIII,3038,0,1,6,7,14.3%,28m
8732,2,[LittyG]摩卡公子,3038,0,0,2,2,0.0%,31m
8732,3,[黑粉头子]feak,3038,0,0,3,3,0.0%,25m
8744,3,[混吃混喝]蛤蛤,3037,540,72,68,140,51.4%,22m
8744,3,[龙骑舞尹志平]鬼才,3037,1067,57,50,107,53.3%,23m
8744,3,golden,3037,678,34,32,66,51.5%,41m
8744,1,[oshima]neoooxx,3037,397,19,8,27,70.4%,4m
8744,1,暴兵神器,3037,487,19,17,36,52.8%,4m
8744,3,大规模理,3037,300,15,6,21,71.4%,22m
8744,3,逗比乖巧猪,3037,115,13,20,33,39.4%,12m
8744,3,神恩如海,3037,291,11,8,19,57.9%,14m
8744,1,苍崎橙子,3037,272,9,12,21,42.9%,21m
8744,3,llllllllllll,3037,168,7,3,10,70.0%,1h
8744,3,白门楼爆破能手,3037,158,6,3,9,66.7%,1h
8744,1,asdasdas,3037,164,6,6,12,50.0%,54m
8744,1,[成电沙河]yesmarWT,3037,175,5,2,7,71.4%,43m
8744,1,[EP]雨落情深,3037,0,3,2,5,60.0%,19m
8744,3,[1VA]吃你家小笼包了吗,3037,97,2,0,2,100.0%,1h
8744,3,ArroganceKin,3037,0,1,0,1,100.0%,1h
8744,1,[丿sky丶]skymeiying,3037,40,1,4,5,20.0%,21m
8744,1,[星选组]魔法少女梨子酱,3037,0,0,1,1,0.0%,18m
8744,1,Whig,3037,0,0,2,2,0.0%,26m
8744,1,[RTSGo]桃桃桃桃桃桃桃子,3037,0,0,3,3,0.0%,25m
8764,1,[P就IMBA]Ayanami,3036,214,6,6,12,50.0%,18m
8764,2,郭德纲砸缸,3036,183,5,6,11,45.5%,7m
8764,1,[18]我了个唧唧歪歪,3036,144,4,1,5,80.0%,26m
8764,3,[Eason]我讯话筒在飞,3036,141,4,6,10,40.0%,13m
8764,1,飞哥,3036,97,3,2,5,60.0%,39m
8764,3,孤寂丶,3036,40,1,2,3,33.3%,40m
8764,1,Autojeans,3036,0,0,1,1,0.0%,15m
8764,1,[WIE]Colin,3036,0,0,1,1,0.0%,41m
8764,1,[暗影之怒]塔萨达地狱咆哮,3036,0,0,1,1,0.0%,4m
8764,3,IvesZero,3036,0,0,1,1,0.0%,19m
8774,3,stack,3035,1553,157,156,313,50.2%,18m
8774,1,lovezly,3035,1238,51,40,91,56.0%,28m
8774,3,[Tgirl]放纵的青春,3035,425,18,13,31,58.1%,3m
8774,1,艾丝凡,3035,484,15,15,30,50.0%,16m
8774,3,NKcyAN,3035,249,13,8,21,61.9%,19m
8774,2,飞翔翅膀,3035,266,9,8,17,52.9%,5m
8774,1,[夏日香气]冰柠檬物语,3035,268,9,9,18,50.0%,19m
8774,3,[loveMM]人仙,3035,223,6,8,14,42.9%,5m
8774,3,dakness,3035,224,6,10,16,37.5%,29m
8774,1,野人王,3035,166,4,2,6,66.7%,12m
8774,1,[配合是王道]Lannister,3035,142,3,1,4,75.0%,25m
8774,1,chovy,3035,0,1,0,1,100.0%,26m
8774,1,ZRY,3035,0,1,4,5,20.0%,18m
8774,1,[抱舔天物]一杆机枪,3035,0,0,1,1,0.0%,25m
8788,3,Dasein,3034,832,97,88,185,52.4%,3m
8788,1,SApphire,3034,1088,78,68,146,53.4%,4m
8788,1,重水,3034,909,43,35,78,55.1%,9m
8788,3,陀枪师姐,3034,353,14,12,26,53.8%,46m
8788,3,我永远喜欢上学酱,3034,315,12,8,20,60.0%,6m
8788,1,[ZJoU]Anastasia,3034,148,4,5,9,44.4%,10m
8788,1,唯一李哥李信衡,3034,36,1,2,3,33.3%,11m
8788,1,神奇退烧药,3034,0,1,3,4,25.0%,43m
8788,2,WoAiXiaoYan,3034,0,0,2,2,0.0%,1h
8788,3,丿丶小阳丶丨,3034,0,0,5,5,0.0%,29m
8798,3,万恶的人类,3033,1605,293,277,570,51.4%,2m
8798,3,[Worm]永不言败,3033,1192,180,188,368,48.9%,42m
8798,3,speqe,3033,1492,98,88,186,52.7%,16m
8798,3,莱茵哈特的光辉,3033,1180,48,44,92,52.2%,2m
8798,3,[DDOS传奇]ydycycyd,3033,617,38,44,82,46.3%,14m
8798,1,游侠,3033,310,12,13,25,48.0%,46m
8798,3,[同盟会]TEM,3033,273,9,11,20,45.0%,14m
8798,1,[肉鸡的饲养]手残老年人,3033,247,8,4,12,66.7%,26m
8798,2,一只阴险的咩,3033,186,8,6,14,57.1%,48m
8798,1,麋露露只会乱玩,3033,206,7,1,8,87.5%,42m
8798,1,[BestXY]fAKe,3033,53,2,3,5,40.0%,4m
8798,1,Ragrander,3033,139,2,4,6,33.3%,43m
8798,1,叛逆灬骚年,3033,0,1,0,1,100.0%,1h
8798,1,[寒绯樱]涮涮人,3033,0,1,2,3,33.3%,7m
8798,3,快乐风男,3033,0,0,1,1,0.0%,56m
8813,1,八九年生人,3032,716,112,105,217,51.6%,16m
8813,3,[NTUSL]飞龙飞龙甩甩甩,3032,660,28,21,49,57.1%,41m
8813,3,[孤傲就完事]iiiiiiiiiii,3032,729,28,27,55,50.9%,46m
8813,3,[我菜请打队友]亚特兰蒂斯,3032,492,26,43,69,37.7%,22m
8813,1,你与秋风皆过客,3032,258,13,8,21,61.9%,42m
8813,1,笨蛋,3032,354,11,11,22,50.0%,27m
8813,3,[31CM]名字好难其,3032,302,10,17,27,37.0%,46m
8813,1,黄金燕楚,3032,244,8,4,12,66.7%,18m
8813,3,淡定,3032,120,4,10,14,28.6%,44m
8813,1,[WCD]不可阻挡的男人,3032,0,3,2,5,60.0%,18m
8813,1,[萌新萌新萌]YukikazeU,3032,186,3,11,14,21.4%,1h
8813,1,[最弱的玩家]死神,3032,92,2,0,2,100.0%,24m
8813,1,[ASSSSS]konicy,3032,34,2,0,2,100.0%,16m
8813,1,Fmy,3032,0,1,0,1,100.0%,16m
8813,1,烩兔肉,3032,0,0,1,1,0.0%,14m
8828,1,冲不下来怎么办,3031,1487,222,193,415,53.5%,41m
8828,1,[孙一喵]oldblack,3031,628,20,20,40,50.0%,11m
8828,1,IIIIIIIIIIII,3031,172,5,1,6,83.3%,27m
8828,1,克哈炮王,3031,96,2,0,2,100.0%,8m
8828,1,[Pemnst]萌动乐乐,3031,42,2,1,3,66.7%,15m
8828,1,天火降临,3031,30,2,5,7,28.6%,7m
8828,1,[星歌]言明曦无,3031,0,1,0,1,100.0%,1h
8828,2,LowenSunday,3031,0,1,1,2,50.0%,1h
8828,1,[GTZ]源离,3031,0,1,1,2,50.0%,42m
8828,1,[要啥没啥爱咋]木券可待,3031,0,1,1,2,50.0%,19m
8828,1,AzzzQa,3031,0,1,1,2,50.0%,42m
8839,3,萌新,3030,1590,484,482,966,50.1%,13m
8839,3,[才不是傲娇]ALVA,3030,1395,168,181,349,48.1%,17m
8839,1,Youknow,3030,1038,88,60,148,59.5%,26m
8839,1,xiaokaikaioo,3030,1238,41,44,85,48.2%,3m
8839,1,llvorite,3030,621,28,21,49,57.1%,25m
8839,3,[NeXT]妈个鸡泰伦,3030,538,21,21,42,50.0%,44m
8839,1,foorl,3030,372,16,12,28,57.1%,24m
8839,1,TNT,3030,210,6,7,13,46.2%,26m
8839,1,绝不投降法兰西,3030,162,4,2,6,66.7%,3m
8839,3,洛华,3030,0,4,2,6,66.7%,47m
8839,1,[AsC]八青菜壹波,3030,0,3,2,5,60.0%,19m
8839,1,Mortis,3030,51,2,3,5,40.0%,16m
8839,1,Apake,3030,0,2,3,5,40.0%,36m
8839,1,我永远单推麻油鸡,3030,142,2,5,7,28.6%,31m
8839,1,[鸽子飞呀飞]是谁在呼叫舰队,3030,0,1,0,1,100.0%,26m
8839,1,[毒奶也有春天]长宁张晋源,3030,40,1,3,4,25.0%,25m
8839,1,山麓百货商店销售,3030,0,0,1,1,0.0%,10m
8839,3,JJDAJJ,3030,0,0,1,1,0.0%,47m
8857,3,[武神]斩炎,3029,1345,170,155,325,52.3%,27m
8857,1,一其当意,3029,1538,83,73,156,53.2%,41m
8857,1,手抓老婆饼,3029,569,39,17,56,69.6%,42m
8857,1,Bye,3029,960,33,33,66,50.0%,14m
8857,3,llllllllllll,3029,454,20,24,44,45.5%,15m
8857,1,wzm,3029,330,13,12,25,52.0%,18m
8857,1,[麻雀]AragakiYui,3029,243,8,5,13,61.5%,3m
8857,3,ruby,3029,143,5,1,6,83.3%,24m
8857,2,[慢手e族]法正,3029,144,5,3,8,62.5%,1h
8857,1,跌跌撞撞,3029,0,3,2,5,60.0%,4m
8857,1,我们都是煤老板,3029,36,1,2,3,33.3%,43m
8857,1,JianGLai,3029,0,0,2,2,0.0%,10m
8869,3,[火焰雷兽]星沉月浮,3028,1062,115,119,234,49.1%,27m
8869,1,伊卡洛斯,3028,1417,90,81,171,52.6%,4m
8869,1,一只森仔,3028,621,46,35,81,56.8%,27m
8869,1,[眼瞎的车万苟]西行寺幽幽纸,3028,576,22,17,39,56.4%,6m
8869,1,Matin,3028,600,21,25,46,45.7%,27m
8869,1,ImGodric,3028,0,3,2,5,60.0%,18m
8869,1,[四叶草]我将如闪电般归来,3028,104,3,3,6,50.0%,42m
8869,3,warriors,3028,96,2,0,2,100.0%,15m
8869,3,HYpnus,3028,0,1,0,1,100.0%,21m
8869,1,黎明的天空,3028,0,1,1,2,50.0%,12m
8869,2,[扫黄咑峰]源来氏佐田田,3028,0,0,1,1,0.0%,1h
8869,1,凝残月,3028,0,0,3,3,0.0%,4m
8881,3,benbenq,3027,769,162,162,324,50.0%,26m
8881,3,Tany,3027,1474,154,154,308,50.0%,27m
8881,1,选神族就输不了,3027,1604,65,47,112,58.0%,4m
8881,1,interest,3027,394,14,9,23,60.9%,43m
8881,2,自由之心,3027,268,11,10,21,52.4%,11m
8881,1,LoveYun,3027,105,3,0,3,100.0%,43m
8881,1,[过把瘾就死]ChickenMaru,3027,76,3,3,6,50.0%,26m
8881,3,[社会]枫钟同年,3027,0,3,3,6,50.0%,6m
8881,3,TIerS,3027,0,1,0,1,100.0%,26m
8881,1,flash,3027,109,1,3,4,25.0%,18m
8881,1,IIIIIIIIIIII,3027,40,1,4,5,20.0%,7m
8881,3,炫位丶奶茶,3027,0,1,5,6,16.7%,29m
8881,1,坐看竹林峰,3027,0,0,1,1,0.0%,1h
8881,3,XIAOTANG,3027,0,0,1,1,0.0%,44m
8881,1,[吟湿作乐]真的很坑爹,3027,0,0,2,2,0.0%,12m
8881,1,紫厌红莲,3027,0,0,2,2,0.0%,27m
8897,3,随机死个马,3026,1561,203,190,393,51.7%,21m
8897,3,Pflegefur,3026,907,106,101,207,51.2%,26m
8897,1,[混元崔欣门]JYJYJYY,3026,849,39,36,75,52.0%,4m
8897,3,[火焰雷兽]雨相山,3026,988,35,41,76,46.1%,42m
8897,3,llllllllllll,3026,443,30,28,58,51.7%,15m
8897,1,[超实验级的]IIIIIIIIIIII,3026,735,25,18,43,58.1%,10m
8897,1,Money,3026,449,15,8,23,65.2%,26m
8897,1,[北极光小组]Sam,3026,476,15,15,30,50.0%,4m
8897,2,无悔,3026,237,10,3,13,76.9%,1h
8897,1,llllllllllll,3026,253,9,3,12,75.0%,42m
8897,3,可爱的蓝孩纸丶,3026,154,5,4,9,55.6%,2m
8897,1,醉剑,3026,76,3,1,4,75.0%,11m
8897,1,一方萝莉控,3026,76,3,5,8,37.5%,22m
8897,1,有点拽达达,3026,0,2,3,5,40.0%,8m
8897,3,没完没了,3026,0,1,0,1,100.0%,1h
8897,1,[合作一队]Rains,3026,0,1,0,1,100.0%,15m
8897,1,努力努力再努力,3026,34,1,1,2,50.0%,46m
8897,1,猜猜酱,3026,93,1,1,2,50.0%,4m
8897,3,[手办王]科普特零夏将军,3026,0,0,1,1,0.0%,23m
8916,3,[第七舰队丶]失落的国度,3025,1569,248,253,501,49.5%,14m
8916,3,[无双]YcDan,3025,1060,145,139,284,51.1%,11m
8916,1,PrinceUniver,3025,1441,131,100,231,56.7%,43m
8916,3,Balalalala,3025,1496,117,115,232,50.4%,29m
8916,3,[菲雅利]铁甲小宝,3025,1359,103,99,202,51.0%,45m
8916,1,SAS,3025,777,86,75,161,53.4%,43m
8916,3,快递难找,3025,962,43,31,74,58.1%,16m
8916,3,可怜无助弱小菜鸡,3025,620,31,33,64,48.4%,23m
8916,1,丨冰糖,3025,604,29,10,39,74.4%,26m
8916,3,shidianyanlu,3025,303,21,26,47,44.7%,43m
8916,1,[yxfans]静介,3025,598,20,19,39,51.3%,26m
8916,1,柠檬味冰沙,3025,333,14,11,25,56.0%,9m
8916,1,[威吓一世]羊驼,3025,308,9,6,15,60.0%,43m
8916,1,[中华兄弟会]我和黄哥击剑,3025,168,9,7,16,56.2%,26m
8916,1,李晶晶,3025,246,8,4,12,66.7%,26m
8916,1,[Strike]TheExileLEnd,3025,0,1,0,1,100.0%,24m
8916,1,[永夜安港]星空流尘,3025,0,1,2,3,33.3%,1h
8933,1,odur,3024,674,24,24,48,50.0%,4m
8933,3,caici,3024,592,24,24,48,50.0%,11m
8933,3,[人间之屑]炖鸡,3024,295,21,22,43,48.8%,43m
8933,2,reverofniw,3024,284,11,11,22,50.0%,21m
8933,1,开局野基地,3024,336,10,13,23,43.5%,7m
8933,3,路桥,3024,252,9,12,21,42.9%,15m
8933,1,[叫醒我]纳兰性德,3024,70,3,2,5,60.0%,15m
8933,1,丘二,3024,0,3,2,5,60.0%,1h
8933,3,句芒,3024,65,3,10,13,23.1%,25m
8933,1,[Borne]sixsixsix,3024,40,2,0,2,100.0%,7m
8933,2,[星际鸽子组]天之云片,3024,44,1,3,4,25.0%,1h
8933,1,[TOMatS]哈哈哈,3024,38,1,3,4,25.0%,26m
8933,1,动物凶猛,3024,0,0,1,1,0.0%,42m
8933,1,苏双羊,3024,0,0,1,1,0.0%,12m
8947,1,Longinuce,3023,1237,53,41,94,56.4%,43m
8947,3,大野智,3023,710,25,33,58,43.1%,43m
8947,1,墨鸦,3023,172,23,19,42,54.8%,12m
8947,3,死线之蓝,3023,535,23,21,44,52.3%,28m
8947,3,南七技校大学渣,3023,592,20,25,45,44.4%,29m
8947,1,Maximilian,3023,416,13,12,25,52.0%,43m
8947,1,IIIIIIIIIIII,3023,74,2,2,4,50.0%,14m
8947,1,[神盾]RazingStormC,3023,0,1,0,1,100.0%,1h
8947,1,[miku守护]可畏,3023,0,1,0,1,100.0%,41m
8947,1,[C1359]一般单推屑弟弟,3023,0,1,0,1,100.0%,4m
8947,1,[不讲武德]郑德重,3023,0,1,0,1,100.0%,15m
8947,1,[双叶杏]LSH,3023,0,1,0,1,100.0%,1h
8947,1,[菊花神教]黑暗骑士,3023,0,1,3,4,25.0%,11m
8947,1,xiaolee,3023,0,0,1,1,0.0%,9m
8961,3,超级大跳比,3022,779,184,164,348,52.9%,26m
8961,3,什么,3022,1545,82,90,172,47.7%,4m
8961,3,firebathero,3022,261,69,77,146,47.3%,42m
8961,1,元始天王,3022,541,23,16,39,59.0%,9m
8961,1,[Tinnba]IIIIIIIIII,3022,312,17,14,31,54.8%,16m
8961,3,瞿帅比,3022,299,14,7,21,66.7%,22m
8961,1,[花店]Teaeggs,3022,410,11,10,21,52.4%,9m
8961,1,[RvA]完全新人,3022,232,9,7,16,56.2%,13m
8961,1,烫手的五号,3022,252,9,9,18,50.0%,42m
8961,3,再战只为她,3022,135,7,2,9,77.8%,24m
8961,3,西游之路,3022,168,7,4,11,63.6%,56m
8961,3,Crazyzerg,3022,163,6,4,10,60.0%,1h
8961,1,[Months]IIIIIIIIII,3022,216,6,7,13,46.2%,26m
8961,1,[七咕咕]灰烬天堂,3022,163,5,7,12,41.7%,45m
8961,3,小豪,3022,97,4,4,8,50.0%,23m
8961,3,花火,3022,60,2,9,11,18.2%,29m
8961,1,[欣博]Rptsi,3022,40,1,2,3,33.3%,26m
8961,3,[你怕是没睡醒]scv,3022,0,0,1,1,0.0%,4m
8979,3,遇到人族就退,3021,734,133,150,283,47.0%,47m
8979,2,[四叶草]火锅好吃,3021,525,125,121,246,50.8%,9m
8979,3,chinazergdj,3021,1543,118,128,246,48.0%,45m
8979,1,youareonly,3021,1165,54,42,96,56.2%,46m
8979,1,[KPG]没头脑,3021,689,30,17,47,63.8%,22m
8979,3,Max,3021,617,22,27,49,44.9%,21m
8979,1,静永拥义,3021,360,14,12,26,53.8%,46m
8979,1,[绝世高手]Mistle,3021,233,11,2,13,84.6%,18m
8979,3,翻江螃蟹,3021,142,5,3,8,62.5%,1h
8979,1,SuperW,3021,162,4,5,9,44.4%,26m
8979,1,[糖心煎蛋]给钱啥都干,3021,155,3,5,8,37.5%,25m
8979,1,IIIIIIIIIIII,3021,36,2,0,2,100.0%,43m
8979,3,Zyx,3021,0,2,2,4,50.0%,10m
8979,1,starrysky,3021,0,0,1,1,0.0%,11m
8979,1,[天坑a]Iskdhi,3021,0,0,2,2,0.0%,42m
8979,1,Maru,3021,0,0,2,2,0.0%,16m
8995,3,[冲就完了]零九二号陆战队员,3020,975,40,40,80,50.0%,23m
8995,1,StartS,3020,681,32,18,50,64.0%,18m
8995,1,[Borne]IIIIIIIIIIII,3020,974,32,32,64,50.0%,9m
8995,3,星宿劫,3020,588,29,30,59,49.2%,3m
8995,1,福兴高照,3020,663,25,16,41,61.0%,6m
8995,3,Arima,3020,510,18,25,43,41.9%,27m
8995,3,小呆娃,3020,258,12,10,22,54.5%,45m
8995,1,XiaoXiao,3020,269,8,5,13,61.5%,7m
8995,1,[小星河]菠萝派骑士,3020,175,6,1,7,85.7%,10m
8995,1,[皇家科院]盲人星际,3020,222,6,8,14,42.9%,42m
8995,1,一锅炖菜,3020,184,5,6,11,45.5%,26m
8995,1,[UMB]阐释者,3020,116,4,3,7,57.1%,14m
8995,1,Light,3020,76,3,4,7,42.9%,41m
8995,1,[IMRTS]简单电脑,3020,38,2,1,3,66.7%,19m
8995,1,[你已经死啦]凉城再无爱,3020,46,2,2,4,50.0%,43m
8995,1,Elysion,3020,0,1,0,1,100.0%,18m
8995,1,[亚顿之矛专供]斯旺的老熟人,3020,0,1,0,1,100.0%,26m
8995,1,黄山丶孙一峰,3020,0,1,1,2,50.0%,3m
8995,1,[核平大队]作业狂人,3020,34,1,4,5,20.0%,9m
8995,1,[AIZ]TikeR,3020,0,0,1,1,0.0%,14m
9015,3,[WILLE]FLOWER,3019,1492,94,100,194,48.5%,43m
9015,3,[NKTJ]蟑螂舞女,3019,1330,58,60,118,49.2%,2m
9015,1,[菠萝君]真打,3019,689,27,29,56,48.2%,26m
9015,3,IIIIIIIIII,3019,233,9,8,17,52.9%,22m
9015,1,玩玩飞刀,3019,322,9,11,20,45.0%,42m
9015,3,IIIIIIIIIIII,3019,168,6,8,14,42.9%,6m
9015,3,Firer,3019,160,5,2,7,71.4%,8m
9015,3,[联合帝国]阿斯朗,3019,141,5,3,8,62.5%,2m
9015,1,[无须奉天]这就是你的运营吗,3019,160,4,4,8,50.0%,1h
9015,1,[蕾丝花边]love,3019,118,4,8,12,33.3%,42m
9015,1,[钓鱼达人]七森,3019,103,3,0,3,100.0%,43m
9015,3,[来点色图]招财君,3019,0,1,1,2,50.0%,1h
9015,1,[哔哩哔哩乾杯]IIIIIIIIIIII,3019,0,1,2,3,33.3%,4m
9015,1,[FPT]龙哥你好,3019,0,0,1,1,0.0%,27m
9015,1,隐私对称性破缺,3019,0,0,1,1,0.0%,41m
9030,3,[我太帅啦]llllllllll,3018,1557,102,93,195,52.3%,46m
9030,1,重铸之星,3018,1350,65,62,127,51.2%,14m
9030,3,华皇旋影,3018,1162,42,46,88,47.7%,14m
9030,1,我爱熊爱洁,3018,745,38,28,66,57.6%,41m
9030,1,虐浪黑哥,3018,503,20,18,38,52.6%,14m
9030,3,[LUL]罗峰,3018,458,20,20,40,50.0%,17m
9030,3,一拳超人,3018,460,14,32,46,30.4%,25m
9030,1,萌新不看夜勤病栋,3018,426,13,10,23,56.5%,41m
9030,1,LeoSydney,3018,208,8,4,12,66.7%,24m
9030,2,啊吧啊吧啊吧,3018,163,6,7,13,46.2%,58m
9030,1,tyt,3018,143,3,2,5,60.0%,3m
9030,1,[FwgsOB]wintermelon,3018,38,2,1,3,66.7%,7m
9030,1,TiraMisu,3018,0,1,2,3,33.3%,1h
9030,1,Jefry,3018,0,1,4,5,20.0%,18m
9030,1,[最强灬狼牙队]YHW,3018,0,0,1,1,0.0%,12m
9045,3,[鲨鱼无敌]考拉也愤怒,3017,1481,111,102,213,52.1%,21m
9045,1,horseget,3017,1015,68,60,128,53.1%,26m
9045,1,[DMR]insomnia,3017,301,14,5,19,73.7%,11m
9045,2,StevenGG,3017,263,9,6,15,60.0%,4m
9045,1,behind,3017,234,7,10,17,41.2%,10m
9045,2,拾伍,3017,138,5,3,8,62.5%,53m
9045,1,Danz,3017,0,2,1,3,66.7%,1h
9045,3,铜陵孙一峰,3017,0,1,0,1,100.0%,1h
9045,1,[璀璨群星之刃]璀璨阿克尔蒙德,3017,38,1,2,3,33.3%,42m
9045,3,[同济大学]长门秘书舰,3017,30,1,19,20,5.0%,21m
9045,1,乐园归来,3017,0,0,1,1,0.0%,43m
9045,1,黑化麻酱,3017,0,0,1,1,0.0%,26m
9045,1,苏豪,3017,0,0,1,1,0.0%,7m
9058,1,迈克尔,3016,974,33,42,75,44.0%,12m
9058,1,[我太帅]JesseLeo,3016,195,20,4,24,83.3%,10m
9058,1,[好贵好贵]KingArthur,3016,434,15,17,32,46.9%,11m
9058,1,[天下大同]bird,3016,457,13,11,24,54.2%,18m
9058,3,[大胸神族]男神灬不凡,3016,212,8,0,8,100.0%,46m
9058,2,[终极咸鱼]仙人爷爷,3016,197,6,4,10,60.0%,1h
9058,2,[XXHZ25]讨厌榴莲,3016,145,6,6,12,50.0%,7m
9058,3,llllllllllll,3016,186,5,3,8,62.5%,1h
9058,3,LIAR,3016,173,5,11,16,31.2%,44m
9058,1,马大师,3016,0,0,2,2,0.0%,1h
9068,3,cattom,3015,1597,319,309,628,50.8%,42m
9068,3,[LDP]imbzp,3015,1449,79,83,162,48.8%,19m
9068,1,lovingmarine,3015,404,16,12,28,57.1%,46m
9068,1,[全员F2A]FantasyP,3015,354,11,8,19,57.9%,27m
9068,2,EvenDark,3015,228,10,5,15,66.7%,44m
9068,1,[NLH]岸回霖风,3015,328,10,13,23,43.5%,46m
9068,1,谐星之超兵丿,3015,197,5,4,9,55.6%,25m
9068,1,longcore,3015,40,2,2,4,50.0%,4m
9068,1,CHARSURVIVOR,3015,38,1,2,3,33.3%,10m
9077,1,blackhuwn,3014,1403,148,140,288,51.4%,3m
9077,3,两岸风景,3014,1600,109,106,215,50.7%,12m
9077,1,[绽放的花儿]TonyHawk,3014,1219,83,77,160,51.9%,6m
9077,1,马天驰,3014,844,36,31,67,53.7%,18m
9077,1,王鼎夫,3014,586,28,16,44,63.6%,4m
9077,1,黑色小刀,3014,298,13,8,21,61.9%,26m
9077,3,Blade,3014,287,12,10,22,54.5%,10m
9077,1,[纯净的]tomato,3014,243,8,5,13,61.5%,26m
9077,1,慕丶,3014,242,8,10,18,44.4%,41m
9077,1,lkkkk,3014,214,7,6,13,53.8%,11m
9077,1,zcz,3014,199,5,3,8,62.5%,10m
9077,1,[艾尔之主]我好了你呢,3014,104,4,2,6,66.7%,27m
9077,3,[CDBT]暴击吧萨满,3014,124,4,20,24,16.7%,42m
9077,1,[盲眼钟表匠]ZestySky,3014,32,2,1,3,66.7%,14m
9077,1,[小鸡屠宰场3]hundanxingmo,3014,118,2,9,11,18.2%,60m
9077,3,时间碎片,3014,0,1,0,1,100.0%,1h
9077,1,王许可,3014,0,1,1,2,50.0%,22m
9077,3,[好好超人队]企鹅男孩,3014,0,0,1,1,0.0%,41m
9077,1,[青莲剑阁]柯雷恩星灵,3014,0,0,2,2,0.0%,43m
9096,3,霸王叉叉叉,3013,1115,76,71,147,51.7%,41m
9096,3,Harry,3013,602,42,39,81,51.9%,8m
9096,1,希望的光芒,3013,1047,39,41,80,48.8%,6m
9096,1,Arteezy,3013,253,19,8,27,70.4%,7m
9096,1,Wind,3013,565,19,22,41,46.3%,25m
9096,3,小帅帅,3013,305,11,6,17,64.7%,18m
9096,1,[神智无知]杨永信,3013,179,7,1,8,87.5%,42m
9096,3,[德拉米尔]战争精英,3013,217,7,8,15,46.7%,2m
9096,3,小柯,3013,164,6,3,9,66.7%,1h
9096,3,幻昼流星,3013,102,5,6,11,45.5%,27m
9096,1,吕蒙,3013,84,3,3,6,50.0%,41m
9096,3,黄金渣,3013,42,3,6,9,33.3%,1h
9096,1,龙神,3013,0,1,0,1,100.0%,11m
9096,1,Berlinsyf,3013,0,1,1,2,50.0%,24m
9096,1,让我中路单,3013,0,1,2,3,33.3%,10m
9096,1,[巨龙降临]ZhaJ,3013,0,0,1,1,0.0%,11m
9112,1,[501三巨头]Maruuu,3012,515,89,71,160,55.6%,26m
9112,3,cmzfb,3012,908,60,48,108,55.6%,14m
9112,3,[青青草原霸主]SaiTAmA,3012,386,14,19,33,42.4%,2m
9112,1,夜幕,3012,177,7,3,10,70.0%,25m
9112,1,TomKerman,3012,169,6,2,8,75.0%,10m
9112,1,[我们是无敌的]小迷弟,3012,151,4,4,8,50.0%,18m
9112,1,[我不做人了]nilins,3012,40,2,4,6,33.3%,46m
9112,1,[莽哥]英雄堂口,3012,0,1,0,1,100.0%,29m
9112,1,[崩溃大队]RushB,3012,0,0,1,1,0.0%,7m
9112,3,[SKTT3]爱萝莉,3012,0,0,1,1,0.0%,27m
9112,1,[NBCLS]步伐,3012,0,0,1,1,0.0%,26m
9123,3,[timba6]蔡徐坤,3011,1530,468,471,939,49.8%,28m
9123,3,是你唇边夜雨清荷,3011,1493,98,92,190,51.6%,2m
9123,3,乐芙兰,3011,876,30,38,68,44.1%,46m
9123,1,[疼王阁]傻子被盘子打死,3011,107,16,9,25,64.0%,42m
9123,1,[北极光小组]BBVS,3011,307,13,7,20,65.0%,26m
9123,1,[小三爷]IIIIIIIIIIII,3011,426,12,11,23,52.2%,19m
9123,1,雅贼,3011,338,10,11,21,47.6%,24m
9123,1,闭月羞花乔碧萝,3011,153,9,10,19,47.4%,15m
9123,1,Freedom,3011,195,8,2,10,80.0%,9m
9123,1,[菜老虎]paper,3011,199,7,3,10,70.0%,41m
9123,1,Loudes,3011,141,5,1,6,83.3%,4m
9123,3,虾蟹支配者孙一峰,3011,143,5,3,8,62.5%,15m
9123,1,无情的注卵机器,3011,148,5,4,9,55.6%,10m
9123,1,月林星鱼,3011,36,2,6,8,25.0%,7m
9123,1,白给的平衡,3011,0,1,0,1,100.0%,26m
9123,1,[HustSC]sithlord,3011,92,1,1,2,50.0%,11m
9123,2,[庄生梦蝶]流连戏蝶舞纷飞,3011,0,1,1,2,50.0%,1h
9123,1,[在下菜鸡一只]西卡奈拉,3011,0,0,1,1,0.0%,15m
9141,3,crazyauditor,3010,1187,359,340,699,51.4%,6m
9141,1,一个旧人,3010,1687,133,115,248,53.6%,43m
9141,3,[艾尔之巅]刚玩三个月,3010,913,83,83,166,50.0%,45m
9141,1,[真理]爱自己更爱生活,3010,884,29,30,59,49.2%,42m
9141,1,事儿,3010,446,13,12,25,52.0%,7m
9141,1,[笑傲江湖oL]银河丨铁血战皇,3010,213,11,1,12,91.7%,3m
9141,1,[鸡层干部]LuckyTerran,3010,254,8,10,18,44.4%,26m
9141,1,Mrender,3010,242,7,7,14,50.0%,18m
9141,1,Reventon,3010,234,6,6,12,50.0%,9m
9141,1,[CKA不为奴]空战之王,3010,0,4,1,5,80.0%,1h
9141,1,GHS,3010,0,3,2,5,60.0%,1h
9141,1,[社交学学者]yangguang,3010,0,1,0,1,100.0%,10m
9141,1,[风云神]对不起,3010,0,0,2,2,0.0%,27m
9141,1,[寒绯樱]扎拉朵思,3010,0,0,2,2,0.0%,25m
9155,1,随风随行,3009,1630,83,78,161,51.6%,26m
9155,1,SNAIL,3009,1650,69,62,131,52.7%,18m
9155,1,ahhmi,3009,1568,58,61,119,48.7%,16m
9155,1,我真不会玩,3009,786,37,19,56,66.1%,18m
9155,2,十五的月亮十六元,3009,777,27,48,75,36.0%,17m
9155,1,[miku守护]龙龙,3009,572,22,14,36,61.1%,28m
9155,3,纸鸢,3009,466,17,21,38,44.7%,2m
9155,1,Alex,3009,154,5,3,8,62.5%,9m
9155,1,啊豆,3009,106,4,3,7,57.1%,15m
9155,1,来我们来决斗,3009,38,2,1,3,66.7%,19m
9155,3,丿斗丶神,3009,62,2,9,11,18.2%,15m
9155,3,[星基佬男孩]黄旭北,3009,0,1,0,1,100.0%,40m
9155,3,QAQ,3009,0,1,0,1,100.0%,47m
9155,1,[8023]萌萌哒鸡蛋卷,3009,0,1,2,3,33.3%,1h
9155,1,鸡你太美,3009,0,0,1,1,0.0%,27m
9170,1,求带,3008,1335,73,64,137,53.3%,7m
9170,1,IIIIIIIIIIII,3008,1095,39,35,74,52.7%,7m
9170,3,wwwcec,3008,577,25,22,47,53.2%,1m
9170,3,脱法摇滚,3008,484,17,20,37,45.9%,7m
9170,1,[喵帕斯的说]绯色月下,3008,360,14,12,26,53.8%,4m
9170,1,[TOO萘奕邬]莓姬会,3008,377,10,9,19,52.6%,25m
9170,1,Elevation,3008,236,9,7,16,56.2%,36m
9170,1,[斩仙除魔傲天]沙丘,3008,130,5,2,7,71.4%,25m
9170,1,ZergExist,3008,160,5,8,13,38.5%,42m
9170,2,NewSoundSty,3008,0,4,3,7,57.1%,1h
9170,1,杨万里,3008,0,3,2,5,60.0%,19m
9170,1,[SFloor]随去风来,3008,116,3,7,10,30.0%,25m
9170,1,[暴雪我是你爹]素质高一点,3008,0,2,0,2,100.0%,1h
9170,1,青衫负雪,3008,38,2,2,4,50.0%,25m
9170,3,极珏幽璃,3008,30,1,1,2,50.0%,16m
9170,1,[艾尔之名]Yolandale,3008,0,1,4,5,20.0%,1h
9170,1,[非洲兄弟]南极的熊,3008,0,0,1,1,0.0%,4m
9187,1,光光地,3007,1019,89,83,172,51.7%,9m
9187,1,Archer,3007,1183,53,31,84,63.1%,9m
9187,3,[刺蛇单推协会]INNovaTion,3007,1209,53,45,98,54.1%,15m
9187,1,GVisbest,3007,1059,49,25,74,66.2%,42m
9187,1,[Beasty]九叔,3007,658,22,26,48,45.8%,7m
9187,1,Crazyzayn,3007,448,20,9,29,69.0%,46m
9187,1,笑小仙,3007,176,20,19,39,51.3%,15m
9187,1,[我完事了嗷]SovietKiller,3007,219,6,4,10,60.0%,42m
9187,3,所爱之人刘弟弟,3007,122,5,3,8,62.5%,2m
9187,3,刨冰骑士,3007,143,5,3,8,62.5%,1h
9187,3,colintao,3007,124,4,12,16,25.0%,7m
9187,1,lxk,3007,104,3,0,3,100.0%,11m
9187,1,北地苍狼,3007,0,3,2,5,60.0%,1h
9187,1,[随意巴拉巴拉]夏梦渚,3007,0,1,2,3,33.3%,3m
9201,3,小兔子,3006,1142,139,143,282,49.3%,14m
9201,3,[菜有菜的道理]Aries,3006,444,40,44,84,47.6%,18m
9201,1,oGsNaDa,3006,993,38,34,72,52.8%,4m
9201,1,蓝黑墨水,3006,936,35,32,67,52.2%,18m
9201,1,ACEsch,3006,681,26,17,43,60.5%,8m
9201,1,谈笑华莱士,3006,474,22,13,35,62.9%,41m
9201,3,蛋疼君,3006,274,9,5,14,64.3%,3m
9201,3,[星际活久点]谐力觉醒,3006,94,9,7,16,56.2%,25m
9201,1,宽锚人未来可期,3006,231,8,3,11,72.7%,26m
9201,2,善解人衣,3006,161,5,3,8,62.5%,48m
9201,3,起个名想半天,3006,122,5,4,9,55.6%,1h
9201,2,银向远,3006,134,5,5,10,50.0%,15m
9201,2,[FOXS]卡卡罗特,3006,0,3,3,6,50.0%,1h
9201,1,[暴雪我是你爹]Heartcurtain,3006,130,3,3,6,50.0%,27m
9201,1,fafafa,3006,123,2,2,4,50.0%,26m
9201,3,[刺蛇单推协会]我是废物,3006,97,1,1,2,50.0%,1h
9201,1,Boreas,3006,0,1,1,2,50.0%,27m
9201,1,[Delive]BDM,3006,0,0,2,2,0.0%,3m
9201,1,[Rsh]AKAswiper,3006,0,0,2,2,0.0%,43m
9220,3,[南湖匈奴]回忆始终是回忆,3005,1478,87,99,186,46.8%,43m
9220,1,IIIIIIIIII,3005,1499,66,64,130,50.8%,18m
9220,1,[刑事组之虎]aoao,3005,1014,36,33,69,52.2%,18m
9220,3,[星际判官]深圳壶艺乐园,3005,199,9,9,18,50.0%,27m
9220,1,[SUST1]Buqun,3005,256,7,9,16,43.8%,43m
9220,1,[幻想神社]IgnisAi,3005,201,6,8,14,42.9%,11m
9220,3,MaryRicho,3005,42,2,1,3,66.7%,33m
9220,3,一代天骄,3005,97,1,1,2,50.0%,26m
9220,3,[娱乐玩家]一束九,3005,30,1,8,9,11.1%,18m
9220,1,SHANA,3005,0,0,1,1,0.0%,8m
9220,1,睾处不胜含,3005,0,0,1,1,0.0%,25m
9231,3,[人族保护协会]重案组之虎,3004,1504,305,298,603,50.6%,3m
9231,1,Ikaros,3004,1523,106,74,180,58.9%,9m
9231,3,帝血弑天,3004,756,75,52,127,59.1%,44m
9231,1,啊啊啊啊,3004,1494,63,55,118,53.4%,18m
9231,1,[磨烂席]chuei,3004,774,32,25,57,56.1%,18m
9231,1,[暗夜王牌]DESTINY,3004,492,25,12,37,67.6%,9m
9231,1,殺人好,3004,457,19,21,40,47.5%,26m
9231,1,MEFQSQ,3004,346,16,12,28,57.1%,42m
9231,1,术高莫用,3004,335,13,7,20,65.0%,41m
9231,1,Tesla,3004,296,12,8,20,60.0%,26m
9231,1,Youmilk,3004,180,7,3,10,70.0%,10m
9231,1,芹菜,3004,176,7,4,11,63.6%,7m
9231,3,ghost,3004,97,6,5,11,54.5%,22m
9231,1,[肌肉]asd,3004,167,6,8,14,42.9%,42m
9231,1,Chen,3004,133,4,2,6,66.7%,12m
9231,2,Prayeon,3004,95,4,4,8,50.0%,34m
9231,1,Aiolin,3004,0,3,2,5,60.0%,1h
9231,1,llllllllllll,3004,72,3,3,6,50.0%,8m
9231,1,[珂学]MagejiTerran,3004,34,2,2,4,50.0%,9m
9231,3,西野七濑,3004,30,1,2,3,33.3%,20m
9231,1,LUDWIG,3004,0,0,1,1,0.0%,25m
9252,3,死道友不死贫道,3003,1412,392,388,780,50.3%,6m
9252,3,IIIIIIIIIIII,3003,1585,367,368,735,49.9%,17m
9252,3,Olympicboy,3003,1510,156,152,308,50.6%,6m
9252,3,SuperTank,3003,1418,146,149,295,49.5%,25m
9252,1,[TGone]朗个嫩锅骚,3003,1700,108,87,195,55.4%,14m
9252,1,虐的就是你,3003,400,12,11,23,52.2%,41m
9252,3,为君倾城,3003,239,11,9,20,55.0%,13m
9252,1,[耶耶]Spec,3003,191,7,3,10,70.0%,28m
9252,2,[天青车道]三叠飞弹,3003,202,7,6,13,53.8%,1h
9252,1,[暴雪娱乐]雷神,3003,193,6,2,8,75.0%,3m
9252,1,FAN,3003,96,4,2,6,66.7%,1h
9252,1,浅醉一生,3003,147,4,4,8,50.0%,26m
9252,1,憨豆先生的小泰迪,3003,75,4,8,12,33.3%,15m
9252,1,[我们是新手]ghost,3003,125,3,1,4,75.0%,4m
9252,1,Marklope,3003,0,3,2,5,60.0%,1h
9252,1,[人族无敌]香风智乃,3003,40,2,4,6,33.3%,6m
9252,1,Kirschblvlen,3003,0,1,0,1,100.0%,4m
9252,3,[萌萌萌萌萌]狗粮,3003,0,0,1,1,0.0%,1h
9252,1,[电动小马达]Wliniam,3003,0,0,1,1,0.0%,26m
9252,3,[ZEXAL]盖聂,3003,0,0,3,3,0.0%,26m
9272,3,[miku守护]JosephChen,3002,1191,113,114,227,49.8%,26m
9272,1,[飞跃来]风过无痕,3002,871,38,27,65,58.5%,25m
9272,3,深海折鸢,3002,393,34,22,56,60.7%,20m
9272,1,[交附嘉分]immortal,3002,473,27,20,47,57.4%,15m
9272,3,fierce,3002,706,26,26,52,50.0%,45m
9272,3,Terminator,3002,623,25,24,49,51.0%,12m
9272,1,[25鸡]谈笑风生,3002,530,17,16,33,51.5%,41m
9272,1,Capricorn,3002,241,11,6,17,64.7%,1h
9272,3,大魔王,3002,215,10,6,16,62.5%,1m
9272,2,简单的电脑,3002,235,9,4,13,69.2%,3m
9272,2,小拳拳锤你,3002,208,9,6,15,60.0%,1m
9272,1,一二三,3002,252,9,7,16,56.2%,18m
9272,1,大爷的春天,3002,145,6,4,10,60.0%,26m
9272,1,沉默之剑,3002,187,6,7,13,46.2%,14m
9272,2,比较菜,3002,44,5,4,9,55.6%,10m
9272,1,whxues,3002,112,4,3,7,57.1%,10m
9272,1,[NZNZ]掠风窃尘托托莉,3002,46,4,7,11,36.4%,17m
9272,1,Jajac,3002,102,3,6,9,33.3%,9m
9272,1,[TCP]TYTY,3002,76,2,5,7,28.6%,3m
9272,1,吟魂何归,3002,0,1,0,1,100.0%,4m
9272,1,llllllllllll,3002,94,1,1,2,50.0%,41m
9272,1,[暗黑执政官]怎么说,3002,40,1,2,3,33.3%,42m
9272,1,[ToHost]新疆俊哥,3002,36,1,3,4,25.0%,18m
9272,1,海南大學,3002,40,1,4,5,20.0%,43m
9272,2,米莎卡,3002,0,0,1,1,0.0%,12m
9272,1,[大疯狗]兄弟别走再打会儿,3002,0,0,1,1,0.0%,18m
9272,1,[克哈发改委]克哈城市化包工头,3002,0,0,2,2,0.0%,25m
9299,3,如东掘港人,3001,1537,120,92,212,56.6%,28m
9299,3,长腿东启,3001,1321,87,87,174,50.0%,19m
9299,1,IIIIIIIIIIII,3001,1023,44,29,73,60.3%,3m
9299,3,[Shawk]泰伦,3001,675,32,39,71,45.1%,13m
9299,3,[觀天習文]我没练出来,3001,390,17,13,30,56.7%,24m
9299,1,杨木成,3001,329,12,8,20,60.0%,25m
9299,1,[残日星宿]大天使鱼,3001,230,11,2,13,84.6%,3m
9299,1,[歌者]Steven,3001,210,7,8,15,46.7%,60m
9299,1,一个小萌新,3001,145,5,1,6,83.3%,9m
9299,3,QSI,3001,160,5,6,11,45.5%,18m
9299,3,[萝莉航线]念辰,3001,141,4,0,4,100.0%,1h
9299,1,卧虫诸葛,3001,140,4,1,5,80.0%,26m
9299,1,月色灬黄泉,3001,0,2,3,5,40.0%,1h
9299,1,borinpp,3001,76,2,4,6,33.3%,18m
9299,3,落花飘雪,3001,0,1,0,1,100.0%,11m
9299,1,核弹之神,3001,0,1,0,1,100.0%,11m
9299,1,[KUMA28]天雾夕音,3001,0,1,3,4,25.0%,4m
9299,3,猜猜看,3001,0,1,7,8,12.5%,24m
9299,1,死寂无神,3001,0,0,1,1,0.0%,14m
9299,1,皓然来袭,3001,0,0,1,1,0.0%,10m
9299,1,IIllllIIII,3001,0,0,1,1,0.0%,8m
9320,3,plotter,3000,750,144,145,289,49.8%,15m
9320,3,COOLcool,3000,549,24,19,43,55.8%,23m
9320,3,虫子,3000,562,19,26,45,42.2%,11m
9320,3,[ToHo]风之悲伤,3000,265,11,11,22,50.0%,43m
9320,1,[鸡饲料加工厂]丹妮莉丝龙妈,3000,233,9,4,13,69.2%,9m
9320,3,你们城里人真会玩,3000,180,6,15,21,28.6%,29m
9320,1,[骗钱大师]天海春香,3000,145,5,2,7,71.4%,12m
9320,1,天雷劫地,3000,185,5,3,8,62.5%,3m
9320,1,笑多了会变帅,3000,136,4,7,11,36.4%,19m
9320,1,贪睡之熊,3000,115,3,1,4,75.0%,30m
9320,1,阿拉纳克,3000,0,3,3,6,50.0%,1h
9320,1,[制杖也有春天]炸薯条,3000,84,3,6,9,33.3%,17m
9320,1,[雷神IMBA]艾尔毒瘤,3000,0,1,0,1,100.0%,42m
9320,3,冰冰,3000,0,1,0,1,100.0%,42m
9320,2,李长生,3000,94,1,2,3,33.3%,42m
9320,2,鑫晗,3000,0,0,1,1,0.0%,7m
9336,3,盛夏光年,2999,1473,253,242,495,51.1%,3m
9336,1,一品梅,2999,513,17,13,30,56.7%,22m
9336,2,Xigua,2999,188,7,1,8,87.5%,28m
9336,2,[幻月云阁]达拉崩吧,2999,150,5,5,10,50.0%,12m
9336,1,艾露露,2999,0,3,2,5,60.0%,57m
9336,1,[猫跑去田间了]田间有只猫,2999,0,1,0,1,100.0%,1h
9336,3,poh,2999,0,1,2,3,33.3%,1h
9336,1,[野人]野人的正面一拳,2999,36,1,4,5,20.0%,42m
9336,2,TYTY,2999,0,0,1,1,0.0%,3m
9336,3,小学生,2999,0,0,1,1,0.0%,15m
9336,2,[同济大学]unluckyP,2999,0,0,1,1,0.0%,7m
9336,3,糖糖本糖,2999,0,0,1,1,0.0%,6m
9348,1,[荣耀归于我主]皮卡丘弟地皮痒痒,2998,1699,80,72,152,52.6%,42m
9348,3,loveddoouuu,2998,1084,72,72,144,50.0%,11m
9348,3,deathmagic,2998,961,53,49,102,52.0%,21m
9348,1,[Fear]stop,2998,1256,50,41,91,54.9%,15m
9348,1,锁牢之惧,2998,673,30,19,49,61.2%,3m
9348,2,shengling,2998,368,25,13,38,65.8%,20m
9348,3,恶魔之少,2998,686,24,27,51,47.1%,43m
9348,1,飞龙骑脸怎么输,2998,386,17,13,30,56.7%,14m
9348,1,[BUPTNB]LoveRain,2998,406,15,7,22,68.2%,41m
9348,1,不用数正好八个字,2998,304,9,10,19,47.4%,7m
9348,1,[专业de团队]太行上帝,2998,296,9,12,21,42.9%,27m
9348,1,[GTK丶]成哥丶观苍生,2998,0,4,1,5,80.0%,1h
9348,1,Sikol,2998,135,4,1,5,80.0%,11m
9348,1,xiguakly,2998,95,4,2,6,66.7%,39m
9348,2,遭不住,2998,68,2,1,3,66.7%,12m
9348,3,[二五仔协会]往复随安,2998,97,1,1,2,50.0%,27m
9348,1,[暴雪一队]路明非,2998,0,0,1,1,0.0%,1h
9365,1,美国程序猿,2997,1716,151,142,293,51.5%,22m
9365,3,happyxi,2997,517,129,106,235,54.9%,16m
9365,1,[童话小镇]果粒橙,2997,500,16,18,34,47.1%,22m
9365,2,LOGY,2997,90,3,3,6,50.0%,18m
9365,1,小猴猴,2997,66,3,3,6,50.0%,26m
9365,2,奈非天,2997,95,2,2,4,50.0%,58m
9365,1,TVN,2997,78,2,4,6,33.3%,28m
9365,1,[透一下清酒]我得重新集结枪兵,2997,74,2,4,6,33.3%,25m
9365,1,我从不存在于过去,2997,70,2,6,8,25.0%,3m
9365,2,FreeFly,2997,0,0,1,1,0.0%,44m
9365,2,[三年幻想乡]博丽灵梦,2997,0,0,1,1,0.0%,3m
9365,1,茫然灬圣光,2997,0,0,4,4,0.0%,43m
9377,1,FightForFree,2996,704,104,87,191,54.5%,6m
9377,3,UniC,2996,420,74,74,148,50.0%,9m
9377,3,PAPAHAN,2996,780,69,85,154,44.8%,10m
9377,1,[NPUED]ShauN,2996,447,23,17,40,57.5%,16m
9377,1,雪迹,2996,232,9,8,17,52.9%,1h
9377,1,[xgnb]圣达,2996,340,9,14,23,39.1%,3m
9377,2,流星鱼,2996,183,8,6,14,57.1%,44m
9377,2,呵呵了,2996,96,4,5,9,44.4%,48m
9377,1,有烟不寂寞,2996,0,3,2,5,60.0%,57m
9377,1,[400EPM]龍漫少年星期天,2996,32,1,3,4,25.0%,16m
9377,2,[山西晋绥军]天宇,2996,0,0,1,1,0.0%,12m
9388,3,[青训选手]我很糟糕她很好,2995,1119,128,117,245,52.2%,28m
9388,3,[多线空投]我只想好好运营,2995,1400,81,89,170,47.6%,3m
9388,1,Astraeus,2995,1338,75,46,121,62.0%,46m
9388,1,大大阿达,2995,1104,61,59,120,50.8%,6m
9388,2,Devotion,2995,910,38,26,64,59.4%,47m
9388,3,岳不群,2995,446,16,18,34,47.1%,7m
9388,1,blackknife,2995,526,16,19,35,45.7%,11m
9388,2,ZYXAA,2995,135,6,5,11,54.5%,1h
9388,3,Actin,2995,159,5,0,5,100.0%,1h
9388,1,斩九天,2995,176,5,8,13,38.5%,17m
9388,1,creeper,2995,0,4,1,5,80.0%,1h
9388,1,沐如晓枫,2995,0,4,1,5,80.0%,16m
9388,2,股聚机,2995,0,0,1,1,0.0%,25m
9388,2,武尊播求,2995,0,0,1,1,0.0%,43m
9388,1,粉红喵喵拳,2995,0,0,7,7,0.0%,33m
9403,3,[掛川]toshi,2994,1496,769,764,1533,50.2%,2m
9403,1,乌有之乡,2994,1662,144,137,281,51.2%,3m
9403,1,茶色蔓延丶,2994,726,84,71,155,54.2%,26m
9403,3,TaeJa,2994,952,46,46,92,50.0%,18m
9403,1,burning,2994,829,40,24,64,62.5%,43m
9403,1,Saber,2994,390,13,9,22,59.1%,3m
9403,1,[建着玩儿]女王至上,2994,246,7,7,14,50.0%,26m
9403,1,九槑,2994,190,6,7,13,46.2%,26m
9403,3,gravatation,2994,164,5,4,9,55.6%,45m
9403,1,[0D]bestfvcker,2994,153,5,7,12,41.7%,12m
9403,2,[湾区社会人]雷霆启寐,2994,0,1,0,1,100.0%,3m
9414,1,[Rhusky]我是条码人,2993,1077,79,58,137,57.7%,19m
9414,1,wqy,2993,42,5,4,9,55.6%,27m
9414,1,abel,2993,192,5,9,14,35.7%,18m
9414,1,[丶yong]上海饭店,2993,96,4,2,6,66.7%,1h
9414,1,刺刀,2993,144,4,3,7,57.1%,1h
9414,1,[GOTAL]娜娜,2993,108,4,4,8,50.0%,3m
9414,2,Mingzhe,2993,58,3,1,4,75.0%,8m
9414,2,[败中求败]小黑龙殷海健,2993,34,2,0,2,100.0%,43m
9414,1,[Marry2]幻痛,2993,89,2,1,3,66.7%,26m
9414,1,星际之神,2993,95,2,2,4,50.0%,27m
9414,3,[诺娃的隐身衣]道心常在,2993,0,1,0,1,100.0%,45m
9414,1,XEL,2993,0,1,1,2,50.0%,1h
9414,2,Gameover,2993,0,0,1,1,0.0%,6m
9427,1,自闭人族,2992,1304,86,81,167,51.5%,12m
9427,2,[日天SFK]WangJ,2992,486,54,82,136,39.7%,45m
9427,1,心暖阳光,2992,826,34,32,66,51.5%,26m
9427,1,[中老年交友群]Fullen,2992,507,16,23,39,41.0%,25m
9427,1,FUNZZY,2992,442,14,14,28,50.0%,41m
9427,2,apamuc,2992,353,13,12,25,52.0%,29m
9427,2,[丨SLT丨]SCstar,2992,120,4,1,5,80.0%,41m
9427,1,帝国交响乐队,2992,0,3,2,5,60.0%,1h
9427,2,电脑,2992,0,1,0,1,100.0%,43m
9427,3,莫丶小陌,2992,0,0,2,2,0.0%,1h
9437,3,durandal,2991,881,128,131,259,49.4%,23m
9437,3,Ghost,2991,1184,52,62,114,45.6%,43m
9437,1,sjkkoko,2991,742,33,26,59,55.9%,18m
9437,1,DrXu,2991,828,30,29,59,50.8%,3m
9437,2,[神圣F2]AiursHand,2991,511,21,15,36,58.3%,44m
9437,1,[SKT1]自由之翼,2991,437,15,11,26,57.7%,8m
9437,1,[萨丶]紫晶之殿丶,2991,134,4,6,10,40.0%,43m
9437,2,[软蛋和鸡]加贺老师,2991,64,3,0,3,100.0%,8m
9437,1,[skyzx]joxe,2991,118,3,2,5,60.0%,9m
9437,1,[TMUSC2]warriorJING,2991,153,3,4,7,42.9%,18m
9437,3,[CSC]Luy,2991,117,2,2,4,50.0%,45m
9437,2,Auslese,2991,0,1,0,1,100.0%,44m
9437,1,[好男人就是我]小滢虫,2991,0,1,1,2,50.0%,14m
9437,2,[出兵大战T馆]爱打球的菜徐坤,2991,0,1,1,2,50.0%,15m
9437,2,Newstart,2991,0,0,1,1,0.0%,12m
9437,1,[KPG2]邪恶蠢鱼,2991,0,0,2,2,0.0%,26m
9453,3,小胖子,2990,1290,178,189,367,48.5%,44m
9453,3,DUST,2990,1187,113,95,208,54.3%,10m
9453,1,木瓜,2990,364,73,63,136,53.7%,26m
9453,1,MInute,2990,572,18,21,39,46.2%,14m
9453,2,[盲人协会]XelNaga,2990,379,15,8,23,65.2%,29m
9453,3,[浑元闪电]五连鞭,2990,147,4,1,5,80.0%,17m
9453,1,whilelight,2990,108,4,5,9,44.4%,8m
9453,2,[宇宙说你皮]宇宙之梦,2990,60,3,2,5,60.0%,26m
9453,1,河北省的斯大林,2990,0,3,2,5,60.0%,39m
9453,2,[YT]Matter,2990,86,3,3,6,50.0%,35m
9453,2,北原和纱,2990,0,0,1,1,0.0%,5m
9453,2,xiaoT,2990,0,0,1,1,0.0%,44m
9453,2,入骨相思知不知,2990,0,0,1,1,0.0%,14m
9453,2,茄子蔫了,2990,0,0,1,1,0.0%,20m
9467,3,[TGone]妖魔,2989,1565,214,223,437,49.0%,15m
9467,3,[KPG2]酒年,2989,1526,144,133,277,52.0%,18m
9467,3,闪电,2989,1185,98,82,180,54.4%,21m
9467,1,[菜有菜的道理]太湖虫王,2989,961,86,76,162,53.1%,12m
9467,1,啦啦啦啦德玛西亚,2989,715,26,23,49,53.1%,17m
9467,1,[希靈使徒]铃村悟,2989,614,23,20,43,53.5%,9m
9467,1,llllllllllll,2989,433,19,11,30,63.3%,41m
9467,3,Crie,2989,310,14,8,22,63.6%,13m
9467,1,九一马先生,2989,0,3,2,5,60.0%,1h
9467,2,[Mousse]Tiramisu,2989,60,2,2,4,50.0%,46m
9467,2,[捌柒柒叁]旃东,2989,0,0,1,1,0.0%,43m
9467,2,勤奋者,2989,0,0,1,1,0.0%,20m
9467,2,litianxing,2989,0,0,1,1,0.0%,3m
9467,2,SHUA,2989,0,0,1,1,0.0%,21m
9467,1,nice,2989,0,0,1,1,0.0%,41m
9467,1,湖北武汉人,2989,0,0,3,3,0.0%,1h
9483,1,[半目后生仔]若影,2988,1123,49,44,93,52.7%,26m
9483,3,[朝花夕誓]锐步,2988,309,47,24,71,66.2%,20m
9483,3,TerranX,2988,649,28,39,67,41.8%,25m
9483,1,中也,2988,517,17,15,32,53.1%,25m
9483,2,[Sv]Guider,2988,364,16,4,20,80.0%,10m
9483,1,[Holydr]Loser,2988,258,7,11,18,38.9%,26m
9483,1,Creator,2988,165,5,3,8,62.5%,25m
9483,1,[Shawk]炸鱼死马嗷,2988,73,4,4,8,50.0%,14m
9483,1,DeathAimi,2988,0,3,2,5,60.0%,3m
9483,1,Atlantic,2988,0,3,2,5,60.0%,1h
9483,1,daodao,2988,78,2,5,7,28.6%,42m
9483,1,鞭性精肛,2988,0,0,2,2,0.0%,41m
9483,1,那个男人,2988,0,0,3,3,0.0%,26m
9483,1,TOPONE,2988,0,0,7,7,0.0%,14m
9497,3,凡雪之属,2987,1534,132,131,263,50.2%,12m
9497,3,超威蓝猫,2987,1436,96,79,175,54.9%,16m
9497,3,[萨尔那加神殿]破壁人,2987,803,33,35,68,48.5%,28m
9497,1,蜡笔没有小新,2987,771,29,23,52,55.8%,9m
9497,1,Hoomin,2987,611,28,25,53,52.8%,12m
9497,1,肯定会发达,2987,818,26,29,55,47.3%,17m
9497,1,[白玉楼的幽灵]墨染的吃货,2987,594,22,22,44,50.0%,14m
9497,1,[不谐]武圣马保国,2987,463,18,15,33,54.5%,9m
9497,3,[萌帝国]kuroko,2987,276,12,12,24,50.0%,3m
9497,1,[科普鲁苏维埃]半狐春,2987,148,5,6,11,45.5%,5m
9497,1,一叶遮天,2987,0,3,2,5,60.0%,57m
9497,2,Dragon,2987,0,0,1,1,0.0%,29m
9509,3,LuckyTerran,2986,1075,56,62,118,47.5%,15m
9509,1,CCblackknigh,2986,402,20,14,34,58.8%,27m
9509,2,战神,2986,258,9,6,15,60.0%,22m
9509,1,我想你了,2986,281,9,9,18,50.0%,18m
9509,1,NEWLYD,2986,0,3,2,5,60.0%,1h
9509,1,乌鸦医生,2986,0,3,2,5,60.0%,1h
9509,1,自由在飞翔,2986,127,3,3,6,50.0%,12m
9509,1,[燕大SC]樱花,2986,85,3,10,13,23.1%,4m
9509,1,kyo,2986,0,1,0,1,100.0%,17m
9509,2,[奔驰何平]光照于生化,2986,0,0,1,1,0.0%,19m
9509,1,MingFeiLU,2986,0,0,2,2,0.0%,27m
9520,3,虫族我是你爹,2985,802,220,220,440,50.0%,27m
9520,1,[TNLet]AIice,2985,840,96,81,177,54.2%,8m
9520,3,章北海,2985,1545,83,76,159,52.2%,2m
9520,3,福建任贤齐,2985,1395,78,90,168,46.4%,16m
9520,3,[芦苇酒]Rwiedei,2985,491,38,29,67,56.7%,42m
9520,3,辣个男人,2985,885,33,42,75,44.0%,3m
9520,2,[众筹时间]先爷爷,2985,589,30,14,44,68.2%,47m
9520,1,闪电五鞭,2985,820,25,31,56,44.6%,3m
9520,1,[水猫哥斯拉]没法打,2985,713,24,26,50,48.0%,41m
9520,3,[中华军武堂]看戏王,2985,570,19,31,50,38.0%,44m
9520,2,killerbig,2985,317,15,10,25,60.0%,21m
9520,3,[20CM]胡子都在笑,2985,250,13,7,20,65.0%,2m
9520,3,[构造部]SephirahHod,2985,272,10,4,14,71.4%,10m
9520,2,Ardo,2985,150,6,3,9,66.7%,29m
9520,3,涤心,2985,119,4,7,11,36.4%,47m
9520,3,AlexWu,2985,118,3,1,4,75.0%,10m
9520,1,情月渗伐,2985,0,3,2,5,60.0%,1h
9520,1,[奴家求勾搭]洛尘,2985,48,2,0,2,100.0%,1h
9520,2,[YINGJI]酒恋轩,2985,0,2,6,8,25.0%,1h
9520,2,[水手]Zerg,2985,0,1,0,1,100.0%,6m
9520,2,浪月,2985,0,1,0,1,100.0%,44m
9520,1,神楽七奈,2985,0,1,0,1,100.0%,1h
9520,3,[DDOS水军]NATO,2985,30,1,9,10,10.0%,14m
9520,3,SCPLAYER,2985,30,1,11,12,8.3%,10m
9520,2,释海潇,2985,0,0,1,1,0.0%,21m
9545,1,IIIIIIIIIIII,2984,761,58,51,109,53.2%,12m
9545,1,SilCreep,2984,735,51,18,69,73.9%,14m
9545,1,hello,2984,1053,37,39,76,48.7%,26m
9545,1,[原谅兄弟会]LuLoer,2984,560,30,17,47,63.8%,28m
9545,1,酷酷使徒汪,2984,325,13,11,24,54.2%,3m
9545,3,yan,2984,259,12,8,20,60.0%,16m
9545,1,[六骑]是镜子总会反光的,2984,247,9,6,15,60.0%,18m
9545,1,[吊打虫族]明天,2984,176,6,9,15,40.0%,27m
9545,2,残月,2984,162,5,3,8,62.5%,42m
9545,2,[你已经死啦]圆环之理,2984,46,5,3,8,62.5%,4m
9545,1,COUREGE,2984,186,5,10,15,33.3%,25m
9545,1,[在鹿上]寒冰,2984,116,3,2,5,60.0%,5m
9545,1,沐雨,2984,0,3,2,5,60.0%,40m
9545,1,[浪啊浪]MUZI,2984,36,2,2,4,50.0%,19m
9545,2,吕归尘,2984,62,2,2,4,50.0%,21m
9545,2,去看海,2984,0,1,0,1,100.0%,14m
9545,2,[白银联盟]老八美食家,2984,0,0,1,1,0.0%,3m
9562,1,[竞技星际]DDTBA,2983,1172,105,104,209,50.2%,5m
9562,1,[有毒]毒到了毒,2983,954,37,32,69,53.6%,19m
9562,1,衰王归来,2983,393,30,18,48,62.5%,22m
9562,1,可乃的小萝莉,2983,615,24,16,40,60.0%,3m
9562,2,楚子航,2983,608,24,19,43,55.8%,29m
9562,3,abc,2983,403,17,16,33,51.5%,20m
9562,1,WinterKiller,2983,320,15,8,23,65.2%,43m
9562,1,Shirazaki,2983,432,14,11,25,56.0%,6m
9562,2,[HK丶S]最终鸟倦归林,2983,296,13,1,14,92.9%,19m
9562,3,我是一只哈士奇,2983,151,5,2,7,71.4%,13m
9562,3,[北大路同好会]Gazer,2983,176,5,9,14,35.7%,14m
9562,1,左岸听涛,2983,30,2,2,4,50.0%,14m
9562,2,脑脑爱吃翔,2983,125,2,3,5,40.0%,32m
9562,1,摄政王阿强,2983,0,1,4,5,20.0%,16m
9562,1,[火焰雷兽]IIIIIIIIIIII,2983,0,0,2,2,0.0%,42m
9562,1,[黎椛夜暮]星际汪,2983,0,0,3,3,0.0%,42m
9578,3,strive,2982,1557,335,348,683,49.0%,10m
9578,1,[幽冥之狼]启示录级核弹头,2982,1218,56,41,97,57.7%,5m
9578,1,一枝菊花压海棠,2982,950,36,32,68,52.9%,8m
9578,1,LYQQ,2982,358,22,20,42,52.4%,27m
9578,1,Sadness,2982,478,17,15,32,53.1%,26m
9578,1,Sam,2982,120,6,3,9,66.7%,41m
9578,1,半城藏沙,2982,0,5,0,5,100.0%,50m
9578,3,[是嫂子自愿的]御倾,2982,170,5,7,12,41.7%,18m
9578,1,magisk,2982,0,3,2,5,60.0%,33m
9578,2,二年一八班死神,2982,92,3,3,6,50.0%,3m
9578,2,[拆迁办事处]科普卢拆迁办,2982,144,3,5,8,37.5%,1h
9578,1,花旗参,2982,107,2,3,5,40.0%,3m
9578,3,物述有栖,2982,30,2,8,10,20.0%,3m
9578,2,[l雪l]白丝赛高,2982,0,1,0,1,100.0%,3m
9578,2,你咬我啊,2982,0,0,1,1,0.0%,2m
9593,2,[北极光小组]tulip,2981,1454,357,376,733,48.7%,28m
9593,1,Kevin,2981,1690,275,261,536,51.3%,42m
9593,3,csm,2981,399,179,175,354,50.6%,3m
9593,3,Teardrop,2981,1491,89,91,180,49.4%,15m
9593,3,[星0战0月]xixxx,2981,870,86,87,173,49.7%,15m
9593,1,邪王的真眼,2981,648,26,19,45,57.8%,26m
9593,1,[鸠UP]JoASHER,2981,460,22,12,34,64.7%,3m
9593,3,mystery,2981,107,16,2,18,88.9%,21m
9593,2,艾尔小圆盾,2981,359,16,9,25,64.0%,9m
9593,1,[剑与舞的奏曲]夕听风雨,2981,197,7,1,8,87.5%,1h
9593,1,[Tiller]米莉娅莉娅,2981,189,5,5,10,50.0%,30m
9593,1,夕阳红苟德,2981,42,2,2,4,50.0%,16m
9605,3,[C81090]机械建造师,2980,1504,207,185,392,52.8%,2m
9605,1,[BANDAL]MegaHouse,2980,1577,171,175,346,49.4%,14m
9605,2,[七海]七海千夜,2980,1105,66,52,118,55.9%,29m
9605,2,萌萌小宠虫,2980,660,36,5,41,87.8%,23m
9605,1,[硬朗派]阿嵬茨小志,2980,623,22,25,47,46.8%,16m
9605,1,[MYC]拉克希尔大乱斗,2980,273,10,7,17,58.8%,18m
9605,1,金戈铁马,2980,196,8,5,13,61.5%,42m
9605,3,绝对无辜这,2980,167,5,1,6,83.3%,17m
9605,1,oLOVEo,2980,96,4,2,6,66.7%,1h
9605,1,未闻花名,2980,129,3,4,7,42.9%,1h
9605,1,[凯爹的游骑兵]Amulp,2980,118,3,5,8,37.5%,5m
9605,1,[吃个糖卖个萌]柠檬味,2980,97,2,1,3,66.7%,5m
9605,2,Jupiter,2980,68,2,2,4,50.0%,11m
9605,2,小鸟最可爱了,2980,0,1,0,1,100.0%,5m
9605,2,[守望黎明]DJsun,2980,32,1,1,2,50.0%,15m
9605,3,脉动,2980,97,1,1,2,50.0%,12m
9605,1,NewPlayer,2980,90,1,2,3,33.3%,7m
9605,1,Byun,2980,0,0,2,2,0.0%,7m
9623,1,[艾尔之巅]无敌小霸王,2979,422,82,64,146,56.2%,7m
9623,1,MrJ,2979,998,48,34,82,58.5%,27m
9623,1,xxxx,2979,314,14,12,26,53.8%,26m
9623,1,易爷找女神去了,2979,408,11,17,28,39.3%,42m
9623,2,[天狼星666]Paparazi,2979,62,3,1,4,75.0%,6m
9623,1,飞舞的石子,2979,0,3,2,5,60.0%,50m
9623,1,血手,2979,0,3,2,5,60.0%,1h
9623,2,吼吼,2979,60,2,3,5,40.0%,44m
9623,2,[HUC群雄]有机盐,2979,30,1,1,2,50.0%,7m
9623,1,[魔法少女小屋]智慧虫族尿急王,2979,92,1,1,2,50.0%,1h
9623,2,Slayer,2979,0,1,1,2,50.0%,44m
9623,1,[dwbzs]fearless,2979,0,1,4,5,20.0%,1h
9623,2,[合作帝]螓猩恋恋,2979,0,0,1,1,0.0%,20m
9636,3,南城旧少年,2978,1602,513,498,1011,50.7%,14m
9636,1,[四叶草]MRTSFR,2978,482,27,9,36,75.0%,6m
9636,2,我爱肥肥喜,2978,439,16,12,28,57.1%,26m
9636,2,Jackson,2978,184,6,0,6,100.0%,43m
9636,1,IIIIIIIII,2978,201,5,5,10,50.0%,16m
9636,1,Aazs,2978,0,3,2,5,60.0%,1h
9636,1,毒奶黄旭东喵,2978,38,2,3,5,40.0%,16m
9636,1,[高海千歌]千矢,2978,0,1,1,2,50.0%,1h
9636,2,AGHWEIWEI,2978,0,0,1,1,0.0%,46m
9645,2,linlinseven,2977,1640,193,180,373,51.7%,22m
9645,2,VioLet,2977,798,37,24,61,60.7%,24m
9645,1,[暴雪二十一队]YounGG,2977,850,32,25,57,56.1%,7m
9645,2,[慢手e族]瓜爷,2977,257,20,14,34,58.8%,7m
9645,1,MrXXXXXX,2977,408,20,15,35,57.1%,12m
9645,1,淡忘流年,2977,314,10,8,18,55.6%,46m
9645,2,[RwGami]芸豆,2977,144,6,4,10,60.0%,44m
9645,1,Capricornus,2977,104,4,6,10,40.0%,12m
9645,2,[星海绚丽]AvaLanche,2977,32,2,1,3,66.7%,22m
9645,1,[渣男团体]baofeng,2977,38,2,4,6,33.3%,27m
9645,3,[NPUED]孙焕佳,2977,0,1,0,1,100.0%,1h
9645,1,[我好冷]storyteller,2977,36,1,3,4,25.0%,25m
9645,2,Vampirerider,2977,0,0,1,1,0.0%,1h
9658,1,菜拿脱破这哥,2976,1411,55,44,99,55.6%,9m
9658,1,[Porsch]回家,2976,1388,49,49,98,50.0%,27m
9658,1,狗毒爆都是儿子,2976,1063,40,39,79,50.6%,43m
9658,3,Breath,2976,708,26,29,55,47.3%,12m
9658,3,SCPLAYER,2976,373,15,12,27,55.6%,21m
9658,1,IIIIIIII,2976,325,10,8,18,55.6%,12m
9658,3,wendy,2976,197,8,4,12,66.7%,45m
9658,2,[樱落]凶残的晓风,2976,210,7,7,14,50.0%,24m
9658,1,[大爱EMT]江田岛聋哑学校,2976,204,6,6,12,50.0%,46m
9658,1,荣旭,2976,0,4,1,5,80.0%,39m
9658,2,WHX,2976,88,3,3,6,50.0%,18m
9658,1,[全线开花]虚空充能完毕,2976,46,2,1,3,66.7%,43m
9658,2,劲射狂风,2976,62,2,3,5,40.0%,41m
9658,1,菜的好真实呀,2976,57,2,4,6,33.3%,27m
9658,1,OMGgg,2976,40,2,6,8,25.0%,5m
9658,2,[暴雪养鸡场]JavaSE,2976,30,1,1,2,50.0%,15m
9658,1,[MGJ]一碗灰鸡蘑菇汤,2976,0,1,2,3,33.3%,43m
9658,1,TOSSterran,2976,88,1,2,3,33.3%,18m
9658,2,老牛奶,2976,0,0,1,1,0.0%,28m
9658,2,愛宋杨,2976,0,0,2,2,0.0%,15m
9658,3,拆迁大队队长,2976,0,0,2,2,0.0%,1h
9679,1,予诺,2975,1609,95,86,181,52.5%,18m
9679,1,[虫群保护协会]forest,2975,1012,64,48,112,57.1%,43m
9679,2,阳光泰伦,2975,878,42,22,64,65.6%,11m
9679,1,orz,2975,829,31,26,57,54.4%,18m
9679,2,如月影,2975,582,24,20,44,54.5%,29m
9679,1,萌萌的小萌新,2975,606,21,18,39,53.8%,19m
9679,3,zyzza,2975,367,16,17,33,48.5%,4m
9679,2,地图炮,2975,388,15,8,23,65.2%,6m
9679,1,[违规女孩]吴宣仪,2975,309,10,8,18,55.6%,28m
9679,1,疾风光刃,2975,97,5,1,6,83.3%,1h
9679,1,暗翼剑魔,2975,154,5,7,12,41.7%,46m
9679,1,RookiEee,2975,182,5,12,17,29.4%,19m
9679,1,教主之遗,2975,0,4,1,5,80.0%,29m
9679,1,小郝,2975,0,4,2,6,66.7%,29m
9679,2,星辰浪子,2975,0,4,3,7,57.1%,1h
9679,1,fithe,2975,138,4,10,14,28.6%,27m
9679,1,[木寸女古木寸]MikeZhou,2975,0,3,2,5,60.0%,50m
9679,2,[AJNMSL]Eggeggboy,2975,60,3,3,6,50.0%,6m
9679,1,素年云殇,2975,0,2,3,5,40.0%,47m
9679,1,[gosh]小智,2975,0,2,3,5,40.0%,21m
9679,3,BOETR,2975,97,1,1,2,50.0%,25m
9679,2,[血色雇佣兵]胖腿腿,2975,38,1,2,3,33.3%,20m
9679,1,萨拉托加,2975,46,1,4,5,20.0%,42m
9702,1,newfish,2974,1619,131,123,254,51.6%,28m
9702,1,[艾尔之巅]Nonesense,2974,797,41,42,83,49.4%,26m
9702,2,IIIIIIIIIIII,2974,948,35,35,70,50.0%,5m
9702,1,那句晚安你说了吗,2974,520,23,17,40,57.5%,43m
9702,2,孙一峰是我大哥,2974,356,18,15,33,54.5%,29m
9702,1,frozenpier,2974,261,13,4,17,76.5%,1h
9702,1,华丽雨林,2974,277,10,7,17,58.8%,43m
9702,2,我的神族像鸟哥,2974,272,9,5,14,64.3%,21m
9702,1,天爱,2974,192,5,12,17,29.4%,7m
9702,2,XiaOlihoU,2974,64,3,1,4,75.0%,6m
9702,2,lotus,2974,58,2,3,5,40.0%,10m
9702,1,悍将,2974,29,2,8,10,20.0%,27m
9702,2,sclaoye,2974,0,1,0,1,100.0%,26m
9702,2,[哔哩哔哩杯乾]格里芬指挥官,2974,0,1,0,1,100.0%,29m
9702,2,[咋哇撸多]龙骑士制作大师,2974,0,1,0,1,100.0%,15m
9702,2,Zeta,2974,0,1,1,2,50.0%,25m
9702,2,华为为为,2974,0,1,1,2,50.0%,10m
9702,2,[友利奈绪丿]八云紫,2974,0,0,1,1,0.0%,1h
9702,2,[大洋彼岸团队]Commander,2974,0,0,1,1,0.0%,3m
9702,1,[奔驰何平]飘零的叶子,2974,0,0,3,3,0.0%,26m
9722,3,WWDA,2973,1573,355,333,688,51.6%,9m
9722,3,[不打内战随机]粑本,2973,912,187,189,376,49.7%,18m
9722,1,Drakedogs,2973,1127,92,89,181,50.8%,27m
9722,2,HAIILO,2973,470,17,11,28,60.7%,11m
9722,1,防火墙,2973,330,15,14,29,51.7%,19m
9722,1,[老婆一喊就退]用泪点烟,2973,140,5,7,12,41.7%,25m
9722,1,Ayu,2973,141,4,3,7,57.1%,27m
9722,2,FasecondAAA,2973,30,1,1,2,50.0%,10m
9722,1,[羊驼羊驼羊]Poca,2973,88,1,3,4,25.0%,42m
9722,1,[西湖底安保队]誓不投降法兰西,2973,0,0,1,1,0.0%,18m
9722,2,SouD,2973,0,0,1,1,0.0%,11m
9722,2,[保护伞公司]ZARD,2973,0,0,2,2,0.0%,7m
9734,3,[半个菜鸟]hwyzm,2972,1356,230,245,475,48.4%,4m
9734,2,[白银联盟]xhllybz,2972,1430,65,42,107,60.7%,44m
9734,1,GzGz,2972,765,31,27,58,53.4%,9m
9734,1,金臭臭,2972,688,23,27,50,46.0%,42m
9734,1,bingpoz,2972,472,19,12,31,61.3%,25m
9734,1,[青铜树]loveNAI,2972,477,18,23,41,43.9%,19m
9734,2,[辉煌华夏]jiaserj,2972,279,10,3,13,76.9%,11m
9734,2,吉吉国王郭开,2972,267,8,7,15,53.3%,9m
9734,1,沉默风暴,2972,176,6,1,7,85.7%,19m
9734,2,[正义者联盟]香宏斯派洛,2972,13,4,45,49,8.2%,17m
9734,2,[黎明航向]王者的狗带,2972,58,3,0,3,100.0%,11m
9734,1,涅神,2972,0,3,2,5,60.0%,47m
9734,2,SweetSoap,2972,62,3,3,6,50.0%,29m
9734,1,[MOD]Jack,2972,112,3,8,11,27.3%,27m
9734,2,thanagor,2972,30,2,1,3,66.7%,47m
9734,2,那一刻我没有惊呆,2972,0,1,0,1,100.0%,29m
9734,2,吾身,2972,0,1,2,3,33.3%,55m
9734,2,sam,2972,30,1,2,3,33.3%,25m
9734,2,[GIE]古明地恋天下第一,2972,0,0,1,1,0.0%,8m
9734,1,[Etern谐]xxxxxx,2972,0,0,5,5,0.0%,1h
9754,1,[世界大战]方玲霞,2971,701,30,22,52,57.7%,3m
9754,1,派哒丶猩,2971,880,30,30,60,50.0%,11m
9754,3,杨超越隐藏男友,2971,359,24,29,53,45.3%,26m
9754,3,孙一喵,2971,459,15,22,37,40.5%,14m
9754,3,苍穹一怒,2971,282,13,10,23,56.5%,6m
9754,1,半岛的风,2971,310,9,8,17,52.9%,18m
9754,2,[星际一号]玩星际的渣渣辉,2971,272,9,9,18,50.0%,13m
9754,3,八重桜悠子,2971,97,4,3,7,57.1%,1h
9754,2,[娜娜]偷吃猫的鱼,2971,122,4,4,8,50.0%,10m
9754,2,Aesktrl,2971,0,1,0,1,100.0%,18m
9754,1,大资本家,2971,0,1,2,3,33.3%,25m
9754,2,[NKT]LLawlite,2971,0,0,1,1,0.0%,42m
9766,1,华仔给的忘情水,2970,526,102,97,199,51.3%,12m
9766,3,[德国骨科]六月很忙,2970,704,100,101,201,49.8%,12m
9766,1,我不适合打星际,2970,1332,50,45,95,52.6%,10m
9766,3,[lover]你猜,2970,738,26,40,66,39.4%,17m
9766,2,goatsmilk,2970,328,13,3,16,81.2%,3m
9766,1,你可能不是人,2970,359,13,10,23,56.5%,3m
9766,2,死柒,2970,259,12,3,15,80.0%,29m
9766,2,VIRGINIA,2970,294,11,10,21,52.4%,47m
9766,2,北溟神鲲鱼,2970,305,10,7,17,58.8%,3m
9766,1,Nefertair,2970,273,9,12,21,42.9%,16m
9766,1,[艾尔永不沦陷]星际边缘,2970,148,4,7,11,36.4%,3m
9766,3,探机说的对,2970,0,1,0,1,100.0%,35m
9766,3,[雾雨魔法森林]破碎之灵,2970,96,1,3,4,25.0%,21m
9766,1,[妹液]带枪的尼姑,2970,0,1,4,5,20.0%,60m
9766,2,[有为青年]暴沙雪雕,2970,0,0,1,1,0.0%,29m
9766,3,Accelerator,2970,0,0,2,2,0.0%,6m
9782,2,[博灬弈丶论]叫我嚣张,2969,1550,95,93,188,50.5%,44m
9782,3,拉风男人,2969,1199,69,69,138,50.0%,13m
9782,2,[喵呜喵呜]别打了我头像,2969,1121,48,37,85,56.5%,47m
9782,1,maru,2969,1011,38,38,76,50.0%,42m
9782,1,梦想毁灭了,2969,498,26,24,50,52.0%,3m
9782,1,lIllllIIIIlI,2969,766,25,26,51,49.0%,19m
9782,1,[十月]tbck,2969,352,22,13,35,62.9%,25m
9782,1,[星际爱好者队]网鱼胖哥,2969,493,17,21,38,44.7%,28m
9782,3,zah,2969,316,13,9,22,59.1%,21m
9782,2,[旋风游骑兵]带你飞,2969,192,8,4,12,66.7%,20m
9782,3,虫群暴君,2969,172,6,15,21,28.6%,45m
9782,1,HHHHHHH,2969,136,4,7,11,36.4%,25m
9782,2,威猛的小老虎,2969,62,3,1,4,75.0%,21m
9782,1,[爱星际丨风暴]qazwsxedc,2969,0,3,2,5,60.0%,1h
9782,1,天霸,2969,0,3,2,5,60.0%,29m
9782,2,興趣使然的萌新,2969,60,2,1,3,66.7%,24m
9782,1,[Beasty]白衣夜歌行丶,2969,88,2,2,4,50.0%,27m
9782,2,空岛,2969,0,1,0,1,100.0%,6m
9782,2,她说她是晒黑的,2969,0,1,1,2,50.0%,15m
9782,2,[二次元联盟军]丧钟为谁而鸣,2969,0,1,1,2,50.0%,5m
9782,1,[仓鼠党]IIIIIIIIIIII,2969,0,1,1,2,50.0%,29m
9782,2,[神虫一家亲]孙一喵是我老婆,2969,30,1,1,2,50.0%,46m
9782,2,longCC,2969,0,0,1,1,0.0%,12m
9805,3,汉尼拔,2968,504,19,25,44,43.2%,8m
9805,1,[UNN新闻]Roxas,2968,322,10,8,18,55.6%,14m
9805,1,PIAODD,2968,236,8,5,13,61.5%,5m
9805,1,嘎嘎嘎搜索,2968,168,5,5,10,50.0%,7m
9805,2,[怡情别恋]筹钱买美国,2968,118,4,3,7,57.1%,21m
9805,2,鲁鲁修,2968,0,4,3,7,57.1%,32m
9805,2,[网瘾主治医师]杨叔,2968,62,3,1,4,75.0%,12m
9805,1,没有智力就是瞎莽,2968,82,3,6,9,33.3%,4m
9805,2,Ericchew,2968,32,2,1,3,66.7%,29m
9805,1,北念,2968,123,2,4,6,33.3%,16m
9805,1,[龍馬]老兵不死只是凋零,2968,74,2,5,7,28.6%,22m
9805,2,[猪星人在地球]骚猪最萌,2968,0,1,0,1,100.0%,14m
9805,3,[嗜血BaSa]futuredm,2968,97,1,1,2,50.0%,10m
9805,3,[王富贵]王富贵二号,2968,97,1,2,3,33.3%,27m
9805,1,Hathaway,2968,34,1,4,5,20.0%,42m
9805,2,Mini,2968,0,0,1,1,0.0%,44m
9805,2,诺夏的奇迹,2968,0,0,1,1,0.0%,3m
9805,2,[小菜逼]小虫他坏,2968,0,0,2,2,0.0%,29m
9805,1,混元星际太极门,2968,0,0,3,3,0.0%,3m
9824,1,纵情演绎,2967,1243,231,200,431,53.6%,12m
9824,1,martaT,2967,148,33,27,60,55.0%,5m
9824,2,爽的一逼,2967,580,24,16,40,60.0%,22m
9824,3,[东方赛高]小小的毒稻,2967,261,13,6,19,68.4%,3m
9824,2,黑板须鲸,2967,114,5,0,5,100.0%,3m
9824,3,皮皮虾飞起来,2967,0,4,2,6,66.7%,5m
9824,1,我觉得我又行了,2967,59,3,8,11,27.3%,42m
9824,2,[纯净的]死亡之翼,2967,88,2,2,4,50.0%,29m
9824,2,GinBB,2967,62,2,2,4,50.0%,6m
9824,1,专打不要脸族,2967,0,2,3,5,40.0%,1h
9824,2,[小小怪怪]小怪兽,2967,0,1,1,2,50.0%,21m
9824,2,kkkkk,2967,30,1,1,2,50.0%,7m
9824,2,LYNENG,2967,0,0,1,1,0.0%,44m
9837,2,[csuDMO]devillover,2966,1379,86,81,167,51.5%,44m
9837,3,IIIIIIIIIIII,2966,700,48,61,109,44.0%,43m
9837,1,打你的屁屁喔,2966,937,40,32,72,55.6%,27m
9837,1,XTSQAQ,2966,666,36,22,58,62.1%,9m
9837,2,terminator,2966,654,29,20,49,59.2%,44m
9837,2,流光织雨,2966,264,9,9,18,50.0%,44m
9837,3,涂爷的爆怒,2966,153,8,2,10,80.0%,1h
9837,2,FTISLAND,2966,214,7,3,10,70.0%,25m
9837,3,汤圆,2966,0,4,2,6,66.7%,1h
9837,2,Ophelia,2966,113,4,5,9,44.4%,24m
9837,2,[虚拟歌手团体]Misaka,2966,58,3,0,3,100.0%,44m
9837,1,[情义天下]神秘之强,2966,0,3,2,5,60.0%,1h
9837,2,loser,2966,0,0,1,1,0.0%,1h
9850,3,橘子汁,2965,1564,593,585,1178,50.3%,23m
9850,3,when,2965,1586,150,159,309,48.5%,12m
9850,1,[火炬的合法]SunTzu,2965,1381,60,51,111,54.1%,43m
9850,1,加藤鹰,2965,822,36,29,65,55.4%,7m
9850,1,[AM]IIIIIIIIIIII,2965,908,35,29,64,54.7%,43m
9850,3,Rain,2965,751,33,42,75,44.0%,42m
9850,1,[奔驰何平]梁非凡,2965,570,23,17,40,57.5%,3m
9850,1,[撒硕之王]秘制小汉堡,2965,221,18,7,25,72.0%,25m
9850,3,等松的鼠,2965,552,18,25,43,41.9%,13m
9850,3,MikiSayaka,2965,489,17,21,38,44.7%,3m
9850,1,[A丶rash]CTRahmRemm,2965,316,11,12,23,47.8%,16m
9850,1,[练出来了协会]ghds,2965,188,7,4,11,63.6%,18m
9850,2,夏默丹竹,2965,216,6,3,9,66.7%,21m
9850,1,[萌萌家族]我是有梦想的咸鱼,2965,190,5,11,16,31.2%,12m
9850,2,[肉鸡的饲养]魔法少女言言酱,2965,68,3,2,5,60.0%,44m
9850,1,ihsob,2965,0,3,2,5,60.0%,8m
9850,3,Moon,2965,0,3,3,6,50.0%,40m
9850,2,丿繁华落尽,2965,30,2,0,2,100.0%,13m
9850,2,[柠檬保护协会]aaa,2965,113,2,3,5,40.0%,1h
9850,1,菜鸡河马兽,2965,103,1,5,6,16.7%,3m
9850,2,smile,2965,0,0,1,1,0.0%,25m
9850,1,白学家,2965,0,0,4,4,0.0%,46m
9872,3,教父的三米一,2964,1482,84,82,166,50.6%,7m
9872,2,JasonGan,2964,559,34,23,57,59.6%,29m
9872,1,搏命玩家司马,2964,364,13,11,24,54.2%,28m
9872,1,星海畅游,2964,68,2,7,9,22.2%,7m
9872,1,[第一序列]愚者,2964,66,2,7,9,22.2%,3m
9872,1,DeVic,2964,0,1,0,1,100.0%,1h
9872,2,[荒芜岁月]RUBY,2964,30,1,1,2,50.0%,29m
9872,2,llllllllllll,2964,0,0,1,1,0.0%,44m
9872,2,上畄伄人姿态君,2964,0,0,1,1,0.0%,8m
9872,3,ioO,2964,0,0,2,2,0.0%,1h
9882,3,[NPUED]maru,2963,1574,286,277,563,50.8%,13m
9882,3,[Rhusky]GankPaSimpLe,2963,1385,179,170,349,51.3%,26m
9882,3,梁先生要超神,2963,827,127,127,254,50.0%,25m
9882,1,[七咕咕]llllllllllll,2963,1289,56,49,105,53.3%,22m
9882,1,[CUGer]Yukipedia,2963,993,34,34,68,50.0%,7m
9882,1,有点乱,2963,701,30,33,63,47.6%,42m
9882,1,[宗师]xffa,2963,580,29,32,61,47.5%,18m
9882,1,小熊,2963,642,28,22,50,56.0%,6m
9882,1,SuperFat,2963,738,25,28,53,47.2%,3m
9882,2,紫风,2963,355,14,8,22,63.6%,25m
9882,1,秋风瑟瑟,2963,374,13,10,23,56.5%,9m
9882,3,HWH,2963,188,13,15,28,46.4%,3m
9882,2,Urun,2963,288,11,8,19,57.9%,20m
9882,1,[PHSC]再睡一夏,2963,166,6,9,15,40.0%,9m
9882,1,[绝世高手]瑶瑶,2963,110,4,6,10,40.0%,13m
9882,1,wangDOU,2963,0,3,2,5,60.0%,9m
9882,1,[洁白之巅]Templar,2963,72,2,6,8,25.0%,7m
9882,2,小茶,2963,30,1,2,3,33.3%,12m
9882,1,[SoloBM]Beyond,2963,40,1,5,6,16.7%,11m
9882,1,[玉虚门下]清源妙道真君,2963,44,1,7,8,12.5%,43m
9882,2,[刺蛇互助社团]众星,2963,0,0,1,1,0.0%,44m
9882,1,[QFD]Suen,2963,0,0,4,4,0.0%,22m
9904,2,[LOHv]RuthskilLYo,2962,1417,61,45,106,57.5%,26m
9904,1,[Shawk]混元星际门炜弟,2962,915,34,28,62,54.8%,17m
9904,2,BLANKliming,2962,540,22,12,34,64.7%,3m
9904,2,[帝国公约]空中劈叉老舰长,2962,228,8,2,10,80.0%,46m
9904,1,Such,2962,224,6,11,17,35.3%,3m
9904,2,向阳道与莲儿,2962,170,5,2,7,71.4%,10m
9904,1,轻衣霓裳,2962,100,5,5,10,50.0%,17m
9904,2,桐二君,2962,64,3,2,5,60.0%,20m
9904,2,Foreveryoung,2962,59,3,2,5,60.0%,20m
9904,3,易水寒,2962,97,2,1,3,66.7%,48m
9904,1,help,2962,36,2,5,7,28.6%,4m
9904,2,[NZNZ]近战艹龙法师,2962,0,1,0,1,100.0%,14m
9904,2,朮拒,2962,0,1,0,1,100.0%,25m
9904,2,[Guider]从竹议官,2962,0,0,1,1,0.0%,21m
9918,3,[混元体我女仆]梦尘,2961,1359,144,131,275,52.4%,17m
9918,3,stanley,2961,1522,77,83,160,48.1%,24m
9918,1,我的头哥能对空,2961,815,37,29,66,56.1%,9m
9918,1,[哔翻天梯鸡]新型冠状病毒,2961,509,21,16,37,56.8%,27m
9918,1,hideshadous,2961,230,7,6,13,53.8%,3m
9918,1,戚莫格,2961,143,5,3,8,62.5%,1h
9918,3,[抹除开始]绯雨凝霜,2961,135,4,1,5,80.0%,13m
9918,1,[白给先生]人无迷途枉流连,2961,122,4,8,12,33.3%,42m
9918,1,walker,2961,96,3,0,3,100.0%,9m
9918,3,[至诚娱乐]IIIIIIIIIIII,2961,0,1,0,1,100.0%,46m
9918,2,[鬼谷]离天,2961,0,0,2,2,0.0%,28m
9929,3,OruA,2960,1543,68,62,130,52.3%,3m
9929,3,上善若水,2960,771,27,33,60,45.0%,26m
9929,1,中二叔,2960,482,16,15,31,51.6%,18m
9929,1,[文韬武略]有基佬拉我苦练,2960,295,11,9,20,55.0%,18m
9929,1,[sc谐盟]小白,2960,282,9,7,16,56.2%,7m
9929,3,[GAS丶]Ghost,2960,210,8,5,13,61.5%,1h
9929,3,[呆毛来我迦]肅挚,2960,265,8,8,16,50.0%,23m
9929,1,电竞丢勒,2960,48,4,1,5,80.0%,1h
9929,3,机枪兵,2960,153,4,2,6,66.7%,20m
9929,2,SSSSSSSSSS,2960,56,3,2,5,60.0%,2m
9929,2,Moster,2960,58,3,3,6,50.0%,7m
9929,2,[镜花水月丨]长剑遗琴,2960,92,3,4,7,42.9%,29m
9929,1,[灵猫]诺大的娃,2960,96,2,0,2,100.0%,47m
9929,1,Mcocomic,2960,48,2,5,7,28.6%,1h
9929,2,Auir,2960,0,1,0,1,100.0%,25m
9944,3,lsuang,2959,848,326,328,654,49.8%,10m
9944,3,JOUN,2959,1501,180,172,352,51.1%,16m
9944,3,鸡蟹话硬刚,2959,1503,174,190,364,47.8%,5m
9944,3,职业化菜鸟,2959,1629,103,110,213,48.4%,10m
9944,1,风林火山,2959,440,19,12,31,61.3%,3m
9944,1,洛灬夜,2959,344,19,16,35,54.3%,27m
9944,1,四季栞那,2959,513,18,18,36,50.0%,26m
9944,1,[我们要娶老婆]暗鸦,2959,236,8,7,15,53.3%,11m
9944,2,[TZRF]ZARD,2959,160,5,0,5,100.0%,3m
9944,1,来自格里芬的咸鱼,2959,158,4,12,16,25.0%,42m
9944,1,pangou,2959,0,3,2,5,60.0%,50m
9944,1,emm,2959,48,2,0,2,100.0%,1h
9944,2,[怒战新手人机]PIMBA,2959,32,2,1,3,66.7%,44m
9944,2,我爱萝莉控,2959,58,2,3,5,40.0%,29m
9944,2,llllllllllll,2959,0,1,0,1,100.0%,19m
9944,2,SCiVessel,2959,0,1,0,1,100.0%,8m
9960,1,[听雨轩]wanghui,2958,1438,196,189,385,50.9%,13m
9960,1,[科普鲁区分部]Kyrie,2958,1612,125,112,237,52.7%,12m
9960,3,七尺大乳,2958,1025,120,110,230,52.2%,29m
9960,1,[不乐意]飞翔煤球炉,2958,670,28,27,55,50.9%,25m
9960,2,随机,2958,528,21,13,34,61.8%,29m
9960,1,无言柳下,2958,378,12,16,28,42.9%,11m
9960,1,MrLumingfei,2958,265,8,10,18,44.4%,16m
9960,2,刁民你也想害我,2958,198,6,2,8,75.0%,28m
9960,1,[五月花]潇洒哥大战黑大帅,2958,88,5,2,7,71.4%,28m
9960,2,Mercy,2958,118,4,2,6,66.7%,12m
9960,2,我学周帅打星际,2958,90,4,2,6,66.7%,17m
9960,3,见人上,2958,142,4,4,8,50.0%,10m
9960,1,[猛的一B]冷大侠,2958,72,2,6,8,25.0%,11m
9960,2,我是非洲小白脸,2958,0,1,1,2,50.0%,26m
9960,3,孤影,2958,0,1,1,2,50.0%,48m
9960,1,[KPG2]Flash,2958,0,1,6,7,14.3%,27m
9960,3,PotatoDeity,2958,0,1,9,10,10.0%,45m
9977,1,shen,2957,1242,122,112,234,52.1%,3m
9977,1,ragnarok,2957,855,44,37,81,54.3%,11m
9977,2,丫丫,2957,669,34,7,41,82.9%,8m
9977,1,AltriasHair,2957,780,27,28,55,49.1%,46m
9977,2,飞龙骑脸怎么输,2957,520,22,19,41,53.7%,20m
9977,2,闪亮之杖,2957,380,15,11,26,57.7%,6m
9977,3,赐你死亡,2957,164,7,3,10,70.0%,42m
9977,3,Jerad,2957,168,7,5,12,58.3%,1h
9977,3,[暴龙]笑话,2957,157,6,4,10,60.0%,1h
9977,1,Bizza,2957,172,5,9,14,35.7%,7m
9977,1,二营长你在哪,2957,48,4,3,7,57.1%,16m
9977,2,REchelieu,2957,62,3,2,5,60.0%,20m
9977,3,非想非非想天之女,2957,156,3,2,5,60.0%,42m
9977,3,[白门楼拆迁队]Flashpoint,2957,0,1,0,1,100.0%,45m
9977,2,[星塵联萌]CrazyBoy,2957,30,1,2,3,33.3%,6m
9977,2,[蒙蔽梦游团]艾尔今天停电了吗,2957,30,1,2,3,33.3%,21m
9993,1,sjj,2956,1577,72,69,141,51.1%,27m
9993,1,妈个鸡好难玩啊,2956,1259,66,62,128,51.6%,28m
9993,2,WSDTL,2956,785,48,42,90,53.3%,29m
9993,2,[重新集结虫群]小熊守护,2956,445,18,9,27,66.7%,8m
9993,1,[OUO]你哈嘛批迈,2956,166,7,6,13,53.8%,1h
9993,2,FatBird,2956,62,3,4,7,42.9%,47m
9993,2,xiao,2956,30,2,0,2,100.0%,17m
9993,1,kmct,2956,96,2,0,2,100.0%,1h
9993,1,半夜火机,2956,0,2,2,4,50.0%,16m
9993,1,[初音未來]凉薄少女梦,2956,66,2,5,7,28.6%,42m
9993,2,你老婆在我手上,2956,0,1,1,2,50.0%,19m
9993,2,[星际传销组织]遣遗家的魔法帽,2956,30,1,1,2,50.0%,3m
9993,3,[一波]小鸡的勇敢,2956,0,0,1,1,0.0%,16m
9993,3,肾虚公子青柠菌,2956,0,0,1,1,0.0%,17m
10007,1,[Beasty]十二翼天使,2955,1605,204,189,393,51.9%,25m
10007,2,giottocenci,2955,469,58,21,79,73.4%,29m
10007,2,haibara,2955,1030,47,26,73,64.4%,4m
10007,1,大药丸子,2955,1171,43,43,86,50.0%,19m
10007,1,[LFZ]Esoteric,2955,295,37,39,76,48.7%,25m
10007,1,Dcring,2955,707,30,25,55,54.5%,46m
10007,1,一只鸡,2955,653,21,22,43,48.8%,27m
10007,1,IlIlIIIlllII,2955,469,19,15,34,55.9%,5m
10007,1,MOONFANS,2955,254,8,14,22,36.4%,3m
10007,1,劲爆的锤子,2955,210,6,9,15,40.0%,27m
10007,1,千叶小豆豆,2955,182,5,8,13,38.5%,53m
10007,1,[ASSSSS]BYH,2955,0,4,1,5,80.0%,19m
10007,2,[BINHU]Tadashi,2955,88,3,1,4,75.0%,24m
10007,1,[恁死你]世外高人,2955,0,3,2,5,60.0%,41m
10007,3,[Shawk]衡安学校没有妈妈,2955,94,3,25,28,10.7%,24m
10007,2,[1GTO1]凯撒,2955,0,1,0,1,100.0%,3m
10007,1,[纸上的魔法使]烈烈中风,2955,0,1,0,1,100.0%,1h
10007,3,gloomylight,2955,0,1,0,1,100.0%,26m
10007,2,Auction,2955,93,1,2,3,33.3%,5m
10007,1,冬雪沐霜亦风寒,2955,0,0,1,1,0.0%,1h
10007,2,[我们是瞎子]果冻小布丁,2955,0,0,1,1,0.0%,5m
10007,2,雨田粗人,2955,0,0,2,2,0.0%,47m
10029,1,小哥哥来坐爱么,2954,1653,140,112,252,55.6%,43m
10029,1,NeedXue,2954,1643,126,117,243,51.9%,3m
10029,2,人族无敌,2954,1109,66,48,114,57.9%,14m
10029,2,蛋糕与唇膏,2954,773,36,25,61,59.0%,44m
10029,3,卑鄙的泰伦人,2954,662,23,32,55,41.8%,28m
10029,1,[有手就行]影流之主,2954,562,19,19,38,50.0%,42m
10029,2,[白给白给白给]炮姐手中的硬币,2954,241,11,6,17,64.7%,44m
10029,1,迎难而上,2954,270,9,11,20,45.0%,42m
10029,2,[屠苏]紅花九叶,2954,200,7,1,8,87.5%,24m
10029,3,[Hdl]中山之狼,2954,167,6,3,9,66.7%,51m
10029,3,[宗师一起上]玩的是一种情怀,2954,74,6,6,12,50.0%,1h
10029,1,东方,2954,135,5,2,7,71.4%,26m
10029,1,呆呆丶鼠萌,2954,94,5,3,8,62.5%,1h
10029,2,Kella,2954,122,5,4,9,55.6%,3m
10029,1,[德意志之心]悯闻,2954,0,3,2,5,60.0%,41m
10029,1,看一下吧,2954,0,2,2,4,50.0%,18m
10029,2,菜鸟一个,2954,0,1,0,1,100.0%,5m
10029,1,danwang,2954,0,1,2,3,33.3%,19m
10029,1,薙切绘里奈,2954,0,0,1,1,0.0%,20m
10029,2,[猫神爱你哟]诗庶瑾丶,2954,0,0,3,3,0.0%,29m
10049,1,哇哈哈,2953,1636,99,98,197,50.3%,18m
10049,3,Jack,2953,760,29,40,69,42.0%,12m
10049,2,[青莲剑阁]尊仙,2953,540,22,19,41,53.7%,3m
10049,3,[沙雕九王之]锦依卫,2953,260,9,20,29,31.0%,27m
10049,3,ggggggggg,2953,165,7,4,11,63.6%,26m
10049,2,逆理开辟,2953,108,6,5,11,54.5%,1h
10049,2,[睾能瓦斯不足]你喜欢吃柚子嘛,2953,182,6,7,13,46.2%,4m
10049,1,[九天星辰同萌]LLLjx,2953,0,3,2,5,60.0%,9m
10049,1,[LOHs]黑暗圣坛,2953,0,3,2,5,60.0%,1h
10049,1,[麋鹿迷路]IIIIIIIIIIII,2953,0,2,4,6,33.3%,12m
10049,2,[火焰雷兽]wlikel,2953,0,1,0,1,100.0%,44m
10049,2,[TLGD]TIME,2953,0,0,1,1,0.0%,12m
10049,2,[DMR]荔枝蜜,2953,0,0,2,2,0.0%,29m
10062,1,[川北电竞]水水大王,2952,1178,49,49,98,50.0%,9m
10062,2,江湖人称有点叼,2952,1096,43,37,80,53.8%,12m
10062,1,iiiiiiiiiiii,2952,488,15,20,35,42.9%,27m
10062,2,OopsCupid,2952,178,10,5,15,66.7%,8m
10062,1,皮阴爸,2952,320,9,12,21,42.9%,19m
10062,1,寇可往吾亦可往,2952,48,6,1,7,85.7%,5m
10062,1,Obito,2952,156,6,10,16,37.5%,28m
10062,2,YTYT,2952,178,5,2,7,71.4%,47m
10062,2,[306]Phoenix,2952,118,4,4,8,50.0%,47m
10062,1,霸气测漏,2952,145,4,4,8,50.0%,10m
10062,2,功夫小熊,2952,118,4,5,9,44.4%,47m
10062,1,大胖敦敦,2952,118,4,7,11,36.4%,7m
10062,2,Legend,2952,0,1,0,1,100.0%,2m
10062,2,limitations,2952,30,1,1,2,50.0%,44m
10062,1,鬼头明里,2952,0,1,5,6,16.7%,3m
10062,2,prince,2952,0,0,2,2,0.0%,5m
10062,1,brian,2952,0,0,4,4,0.0%,12m
10079,3,momofine,2951,1533,178,179,357,49.9%,16m
10079,3,EtdMaMaMia,2951,1458,162,165,327,49.5%,24m
10079,3,[Beauty]MAKEYC,2951,927,100,107,207,48.3%,43m
10079,3,[鸟托邦]通天曉,2951,1450,81,87,168,48.2%,11m
10079,2,啊吸血鬼,2951,559,22,21,43,51.2%,13m
10079,1,[潮了]Spoony,2951,370,18,9,27,66.7%,11m
10079,3,糖醋排骨,2951,93,18,23,41,43.9%,5m
10079,2,[黑萝卜后援队]YellowCarrot,2951,144,6,2,8,75.0%,9m
10079,1,Demon,2951,165,4,5,9,44.4%,11m
10079,2,KYSpace,2951,0,1,0,1,100.0%,24m
10079,1,[何故空留殇]Tong,2951,0,1,1,2,50.0%,1h
10079,1,阿薇最可爱,2951,38,1,5,6,16.7%,14m
10079,2,[Conque]空鱼,2951,0,0,1,1,0.0%,6m
10079,2,我爱王菲,2951,0,0,1,1,0.0%,44m
10079,2,[tiandi]沙雕猫,2951,0,0,1,1,0.0%,28m
10094,3,dadalaohu,2950,1491,550,539,1089,50.5%,27m
10094,1,白给泰伦,2950,1231,84,80,164,51.2%,25m
10094,3,aaa,2950,853,74,75,149,49.7%,19m
10094,1,三墩方少云,2950,760,56,57,113,49.6%,19m
10094,2,[中华何平]海洋,2950,1326,50,45,95,52.6%,24m
10094,1,[鬼谷]xishu,2950,937,35,36,71,49.3%,42m
10094,1,伤梧桐,2950,557,21,21,42,50.0%,3m
10094,1,叉子骑牛烧火车,2950,590,19,22,41,46.3%,27m
10094,1,WBWB,2950,415,12,14,26,46.2%,4m
10094,2,你在干什么,2950,268,11,4,15,73.3%,7m
10094,1,锐风执剑,2950,269,10,10,20,50.0%,25m
10094,2,IIIIIIIIIIII,2950,225,9,9,18,50.0%,46m
10094,2,[萌新在下挨打]马保国大师,2950,62,7,3,10,70.0%,8m
10094,1,[幼儿园W]深巷观花,2950,104,4,7,11,36.4%,14m
10094,1,INnoVation,2950,44,1,4,5,20.0%,36m
10094,1,[地大人]sass,2950,38,1,5,6,16.7%,12m
10094,1,[我忘记升折跃]zeratul,2950,0,0,1,1,0.0%,1h
10094,2,[Fear]BAOBAODA,2950,0,0,3,3,0.0%,19m
10112,3,FGWJ,2949,1504,594,539,1133,52.4%,18m
10112,3,BigDaddy,2949,1365,118,116,234,50.4%,17m
10112,3,stan,2949,1373,96,94,190,50.5%,25m
10112,2,tedi,2949,1097,82,65,147,55.8%,22m
10112,2,斌爷在此,2949,1184,63,35,98,64.3%,25m
10112,2,[小鸡屠宰场3]一柱擎天,2949,1264,52,43,95,54.7%,3m
10112,1,行者,2949,777,35,24,59,59.3%,14m
10112,1,霞之丘诗羽,2949,576,26,29,55,47.3%,9m
10112,2,腾宇,2949,466,18,13,31,58.1%,29m
10112,3,简单电脑,2949,175,9,7,16,56.2%,25m
10112,2,看戏,2949,152,6,2,8,75.0%,29m
10112,3,东方巫术大师,2949,135,5,4,9,55.6%,6m
10112,2,[小鱼塘]大青花鱼,2949,0,0,1,1,0.0%,5m
10112,1,[DX战队]KINGBHZX,2949,0,0,1,1,0.0%,56m
10112,2,LastOrder,2949,0,0,2,2,0.0%,24m
10127,1,元氏,2948,1223,49,45,94,52.1%,6m
10127,2,[社交学导练]Miaoqy,2948,596,21,20,41,51.2%,29m
10127,1,Corki,2948,545,19,17,36,52.8%,11m
10127,2,[星灵王]linyi,2948,299,9,11,20,45.0%,25m
10127,2,Star,2948,148,5,7,12,41.7%,7m
10127,2,ooo,2948,58,3,1,4,75.0%,19m
10127,2,[奥术之光]德克萨斯做得到吗,2948,99,2,1,3,66.7%,8m
10127,2,Momo,2948,0,1,0,1,100.0%,12m
10127,1,[loveMM]小虎,2948,0,1,0,1,100.0%,18m
10127,2,[白给白给]Aerith,2948,0,1,1,2,50.0%,28m
10127,2,[小小怪怪]aida,2948,30,1,2,3,33.3%,29m
10127,2,[CNboi]屠夫凯文,2948,30,1,3,4,25.0%,7m
10127,2,superzhang,2948,0,0,1,1,0.0%,11m
10127,2,[Asaka]IIIIIIIIlll,2948,0,0,1,1,0.0%,44m
10127,2,仰望,2948,0,0,1,1,0.0%,21m
10142,1,送分选手,2947,1678,234,228,462,50.6%,28m
10142,1,[loveMM]污妖王,2947,1467,89,86,175,50.9%,5m
10142,1,[文韬武略]小怪兽,2947,691,61,52,113,54.0%,42m
10142,1,机械之水笔,2947,670,53,50,103,51.5%,6m
10142,2,[KPG]浪子回头,2947,242,35,25,60,58.3%,7m
10142,1,SettleACG,2947,410,17,12,29,58.6%,28m
10142,2,大王,2947,356,14,12,26,53.8%,21m
10142,2,我在追风闪电,2947,305,13,8,21,61.9%,29m
10142,1,要鸭梨才有冻梨,2947,178,9,9,18,50.0%,7m
10142,3,头骨骨,2947,200,8,6,14,57.1%,1h
10142,1,[芽衣最可爱了]风间净琉璃,2947,182,7,8,15,46.7%,19m
10142,3,Serendipity,2947,185,5,7,12,41.7%,24m
10142,1,panicmonster,2947,116,2,2,4,50.0%,1h
10142,2,黑虎阿福,2947,60,2,2,4,50.0%,11m
10142,1,loveOO,2947,30,2,4,6,33.3%,11m
10142,2,Sun,2947,0,1,0,1,100.0%,24m
10142,2,AstroUn,2947,0,1,2,3,33.3%,8m
10142,1,[失去了卡拉]我们还有大主教,2947,36,1,5,6,16.7%,14m
10142,2,[一个军的兵力]一个师的兵力,2947,0,0,1,1,0.0%,19m
10161,1,[星际老屁孩]霸王,2946,935,85,85,170,50.0%,18m
10161,3,[地瓜非红薯]Exercise,2946,1078,49,44,93,52.7%,13m
10161,1,[暗室逢灯]瑟雷尼亚,2946,1138,46,41,87,52.9%,25m
10161,3,若休丶,2946,849,33,31,64,51.6%,47m
10161,1,[baqi]这个游戏太难了,2946,920,32,33,65,49.2%,42m
10161,2,clow,2946,814,30,25,55,54.5%,42m
10161,2,[丶幸存丶]Justice,2946,546,23,14,37,62.2%,2m
10161,2,llllllllll,2946,286,11,9,20,55.0%,44m
10161,2,[TNLet]IIIIIIIIIIII,2946,170,7,5,12,58.3%,44m
10161,3,夏一可,2946,133,4,0,4,100.0%,16m
10161,1,[听潮阁]妈个鸡泰伦,2946,120,3,7,10,30.0%,42m
10161,2,[Ours]Taoge,2946,30,2,1,3,66.7%,14m
10161,3,Stats,2946,0,2,5,7,28.6%,1h
10174,2,Orioli,2945,1198,117,98,215,54.4%,11m
10174,3,durandal,2945,174,70,80,150,46.7%,15m
10174,1,[APM30]LGHK,2945,1015,55,51,106,51.9%,22m
10174,3,高斯老大,2945,1170,44,47,91,48.4%,18m
10174,3,[CoWo]irishman,2945,632,27,29,56,48.2%,27m
10174,3,Sunny,2945,778,27,34,61,44.3%,46m
10174,3,我是菜鸡,2945,486,16,26,42,38.1%,8m
10174,2,[北京大学鸡协]MaGeJiProtos,2945,394,14,15,29,48.3%,25m
10174,1,Heart,2945,383,13,16,29,44.8%,16m
10174,2,hhh,2945,300,11,6,17,64.7%,46m
10174,2,小明,2945,163,8,4,12,66.7%,1h
10174,3,我的探机呢,2945,165,4,2,6,66.7%,1h
10174,2,[朗基奴斯之枪]Winterstar,2945,0,1,0,1,100.0%,12m
10174,2,玉战天下,2945,30,1,2,3,33.3%,15m
10174,2,[听雨轩]duola,2945,0,0,1,1,0.0%,26m
10174,2,Harmful,2945,0,0,1,1,0.0%,8m
10174,2,Masaou,2945,0,0,2,2,0.0%,3m
10191,3,[嗜血BaSa]佳佳,2944,1421,170,178,348,48.9%,8m
10191,3,cheche,2944,1567,163,167,330,49.4%,7m
10191,3,[H1st]SCPLAYER,2944,1494,149,138,287,51.9%,30m
10191,3,IIIIIIIIIIII,2944,904,91,94,185,49.2%,2m
10191,3,[CPT]时崎狂三,2944,1316,86,92,178,48.3%,15m
10191,3,[五月花]黑夜圣歌,2944,974,57,61,118,48.3%,24m
10191,2,Marian,2944,534,20,21,41,48.8%,9m
10191,2,[3Ky]Rabbit,2944,432,16,16,32,50.0%,46m
10191,3,[日常]敏锐驻马店潜伏者,2944,374,14,25,39,35.9%,26m
10191,1,Force,2944,266,10,6,16,62.5%,45m
10191,2,天幻邪,2944,142,6,5,11,54.5%,49m
10191,3,新天地,2944,38,5,4,9,55.6%,1h
10191,3,[white开]GGBind,2944,0,4,3,7,57.1%,1h
10191,1,幸运的老虎,2944,0,3,2,5,60.0%,1h
10191,1,abc,2944,0,3,3,6,50.0%,25m
10191,1,Orion,2944,119,3,4,7,42.9%,1h
10191,2,[天津理工大学]MISSyou,2944,30,2,1,3,66.7%,26m
10191,2,XIaoyang,2944,30,2,3,5,40.0%,12m
10191,2,TorresTao,2944,60,2,4,6,33.3%,5m
10191,2,星际迷航记,2944,0,1,0,1,100.0%,27m
10191,1,[M8]银河之力,2944,0,1,0,1,100.0%,57m
10191,2,妹恋音,2944,0,1,1,2,50.0%,10m
10191,2,肌肉酸痛,2944,36,1,2,3,33.3%,19m
10191,3,[虚拟歌手团体]Misairu,2944,0,0,1,1,0.0%,27m
10215,1,北沫,2943,1337,78,81,159,49.1%,9m
10215,2,张战天,2943,596,51,36,87,58.6%,21m
10215,2,赣肆黄旭东,2943,1001,48,31,79,60.8%,4m
10215,3,[混吃混喝]虚空之遗,2943,958,38,48,86,44.2%,19m
10215,2,IIIIIIIIIIII,2943,380,14,9,23,60.9%,2m
10215,2,玉宇琼楼,2943,165,11,8,19,57.9%,24m
10215,1,[快乐谐星]Lwywarrior,2943,0,4,2,6,66.7%,4m
10215,2,克罗米,2943,145,4,3,7,57.1%,47m
10215,3,不懂输,2943,108,3,1,4,75.0%,21m
10215,2,witxpv,2943,90,3,5,8,37.5%,10m
10215,1,DavidWai,2943,158,3,6,9,33.3%,19m
10215,2,磁暴步兵杨永信,2943,30,2,2,4,50.0%,19m
10215,2,牛批,2943,60,2,2,4,50.0%,20m
10215,2,团子股,2943,22,2,3,5,40.0%,2m
10215,1,风也带不走,2943,0,1,0,1,100.0%,1h
10215,2,[随机团]湿了胸毛,2943,30,1,2,3,33.3%,20m
10215,1,tonystark,2943,0,1,4,5,20.0%,6m
10232,1,快乐,2942,637,122,114,236,51.7%,28m
10232,1,我曾触及星辰,2942,136,24,19,43,55.8%,11m
10232,2,cainiao,2942,255,10,10,20,50.0%,25m
10232,2,[为星光而战]小蓝星光,2942,243,8,8,16,50.0%,1h
10232,1,[泰妍]赵啸丶,2942,178,7,7,14,50.0%,53m
10232,2,十六夜不爱吃宵夜,2942,122,5,4,9,55.6%,44m
10232,2,llllllllllll,2942,146,5,5,10,50.0%,20m
10232,1,KEALTHAS,2942,182,5,7,12,41.7%,42m
10232,3,Ludwig,2942,167,4,3,7,57.1%,1h
10232,2,[末世纪]七濑的小迷弟,2942,30,2,0,2,100.0%,47m
10232,2,[喵星人]我猥琐我快乐,2942,0,1,0,1,100.0%,5m
10232,1,拉菲红酒醉拉菲,2942,0,0,1,1,0.0%,36m
10244,2,Edward,2941,668,83,56,139,59.7%,21m
10244,2,zhyszhy,2941,389,53,46,99,53.5%,43m
10244,2,[一盒峰我大哥]Lunar,2941,1039,41,37,78,52.6%,14m
10244,2,MinkyX,2941,791,34,23,57,59.6%,3m
10244,2,最强女友,2941,278,30,24,54,55.6%,5m
10244,1,[花式日狗第四]特籣克斯,2941,752,29,27,56,51.8%,9m
10244,1,[妖精卜卜口]末裔,2941,612,28,21,49,57.1%,19m
10244,3,five,2941,620,26,29,55,47.3%,2m
10244,1,[TWG]MIGHT,2941,399,25,19,44,56.8%,22m
10244,1,scv,2941,401,13,13,26,50.0%,9m
10244,1,晴天,2941,165,13,21,34,38.2%,42m
10244,1,CleanProtoss,2941,276,10,5,15,66.7%,45m
10244,2,记住我就好,2941,162,8,8,16,50.0%,15m
10244,3,TrunksZ,2941,43,6,17,23,26.1%,11m
10244,1,[小鸡屠宰场4]dfnjgkuisec,2941,145,5,3,8,62.5%,1h
10244,1,[兼善]黄里克,2941,134,4,5,9,44.4%,43m
10244,2,[帅逼毒奶谐]泽拉图,2941,30,2,1,3,66.7%,2m
10244,1,[不知道取什么]小马国的天狼星,2941,40,2,4,6,33.3%,11m
10244,2,神奇小嘉大冒险,2941,0,1,1,2,50.0%,42m
10244,2,谁在呼叫舰队,2941,0,1,1,2,50.0%,22m
10244,1,[SC2战队]死亡天降,2941,97,1,1,2,50.0%,34m
10244,1,[我要重新集结]PhoirA,2941,36,1,6,7,14.3%,7m
10244,2,DJoceanCN,2941,0,0,1,1,0.0%,29m
10267,3,狐狸,2940,1559,448,449,897,49.9%,8m
10267,1,明阳,2940,1540,144,124,268,53.7%,27m
10267,2,火弦,2940,883,34,29,63,54.0%,24m
10267,2,fay,2940,406,29,28,57,50.9%,44m
10267,2,ctzl,2940,94,4,1,5,80.0%,12m
10267,2,[纨绔才子]船齐霸业再改名,2940,118,4,3,7,57.1%,13m
10267,1,呐壹段旧时光,2940,0,2,3,5,40.0%,40m
10267,1,[BLaDe]一把大宝剑,2940,118,2,5,7,28.6%,6m
10267,2,[地狱之神]阴沉,2940,0,0,1,1,0.0%,12m
10267,1,MSIKLANTKnow,2940,0,0,1,1,0.0%,41m
10267,2,虫虫,2940,0,0,2,2,0.0%,21m
10267,2,Admin,2940,0,0,2,2,0.0%,4m
10279,3,ZJL,2939,1475,165,156,321,51.4%,4m
10279,1,[PGJSF]拉锯赶路的男人,2939,1663,116,109,225,51.6%,27m
10279,3,larryberry,2939,666,89,96,185,48.1%,7m
10279,2,[镜花水月丶]黄头发妹妹爱黑丝,2939,1464,76,61,137,55.5%,47m
10279,2,虚无的水汽,2939,827,50,37,87,57.5%,24m
10279,2,随便干的二五仔,2939,949,49,44,93,52.7%,19m
10279,1,小王,2939,657,48,32,80,60.0%,10m
10279,1,CCCCL,2939,1077,40,36,76,52.6%,17m
10279,1,桦默,2939,611,20,20,40,50.0%,43m
10279,3,天才少年,2939,348,14,16,30,46.7%,21m
10279,2,极品菜鸟,2939,291,11,10,21,52.4%,26m
10279,1,[镜花水月丶]白泽,2939,285,9,6,15,60.0%,2m
10279,2,RagnaroK,2939,214,8,2,10,80.0%,8m
10279,1,小小新手,2939,0,3,2,5,60.0%,1h
10279,3,天际小兵,2939,82,3,9,12,25.0%,48m
10279,1,DIESWZ,2939,95,2,2,4,50.0%,17m
10279,2,[夜弑]星晨霸主,2939,0,1,0,1,100.0%,4m
10279,2,[今晚谁是鸡]小热狗,2939,0,1,1,2,50.0%,7m
10279,2,[Ananak]范太子揍扁了吕布,2939,30,1,2,3,33.3%,29m
10279,2,至尊大神,2939,0,1,2,3,33.3%,1h
10279,2,叶落有孤城,2939,0,0,1,1,0.0%,25m
10279,2,混元太马保国,2939,0,0,1,1,0.0%,25m
10279,2,探姬,2939,0,0,2,2,0.0%,28m
10302,3,batman,2938,1470,113,103,216,52.3%,12m
10302,2,IIIIIIIIIIII,2938,595,73,63,136,53.7%,19m
10302,2,[星际仓鼠海盗]飨嚮響曏鄕,2938,721,32,25,57,56.1%,2m
10302,1,[汉堡FANS]cjcc,2938,398,31,14,45,68.9%,28m
10302,2,[虚空王座]蛇皮大仙,2938,517,25,9,34,73.5%,29m
10302,2,[废墟图书館]强袭自由,2938,272,21,18,39,53.8%,24m
10302,2,[魔法少女联盟]HOMURA,2938,402,15,14,29,51.7%,2m
10302,2,艾思徽尔,2938,412,14,16,30,46.7%,14m
10302,2,[神奇的联萌]努力吃药,2938,188,7,3,10,70.0%,4m
10302,2,[NCHU]筱筱筱筱娅,2938,221,7,5,12,58.3%,31m
10302,1,imcaxiaoxiao,2938,222,7,6,13,53.8%,27m
10302,2,CloserHell,2938,212,7,8,15,46.7%,45m
10302,3,FerriswheeL,2938,121,5,4,9,55.6%,2m
10302,2,轻松,2938,147,5,6,11,45.5%,24m
10302,1,Eight,2938,0,3,3,6,50.0%,16m
10302,2,[星歌]孜然,2938,117,2,3,5,40.0%,34m
10302,2,ziweiSIr,2938,58,2,3,5,40.0%,44m
10302,1,你是哪块小饼干,2938,0,2,4,6,33.3%,1h
10302,2,ZanyDruid,2938,0,1,0,1,100.0%,3m
10302,2,[NavyF]SsKy,2938,0,1,0,1,100.0%,7m
10302,2,[落魄山]Aries,2938,0,1,0,1,100.0%,25m
10302,2,花泽类,2938,30,1,1,2,50.0%,4m
10302,2,IIIIIIIIIIII,2938,30,1,1,2,50.0%,47m
10302,2,[X英雄圣域X]tbcome,2938,0,0,1,1,0.0%,14m
10326,1,[侦测到喵入侵]lisij,2937,1149,91,70,161,56.5%,27m
10326,3,[菜有菜的道理]Termmy,2937,631,34,38,72,47.2%,12m
10326,1,迪奥,2937,437,33,32,65,50.8%,42m
10326,1,[昆明碰瓷高手]我给你爹一飞腿,2937,552,18,18,36,50.0%,28m
10326,1,wnzxz,2937,465,15,17,32,46.9%,9m
10326,2,[慕灬小冷]高级指挥官,2937,168,7,3,10,70.0%,17m
10326,3,[萌佬同好会]Timba,2937,122,5,5,10,50.0%,42m
10326,1,[HUC前衛]噬魂,2937,191,5,6,11,45.5%,27m
10326,1,FLOVID,2937,0,3,2,5,60.0%,29m
10326,1,贪玩,2937,0,3,2,5,60.0%,1h
10326,2,闪电五鞭,2937,88,3,4,7,42.9%,29m
10326,2,六脉神宕,2937,0,1,1,2,50.0%,2m
10326,2,[不知不觉天亮]海鸥,2937,30,1,2,3,33.3%,12m
10326,2,[你下面凉快嘛]Moby,2937,0,1,2,3,33.3%,24m
10326,2,Pipi,2937,30,1,3,4,25.0%,46m
10341,2,[猫狗大队]SKYWATCHER,2936,1590,171,160,331,51.7%,2m
10341,2,INnoVation,2936,1605,117,104,221,52.9%,8m
10341,1,[SC2018]垚拨鼠,2936,216,59,52,111,53.2%,12m
10341,1,大腿,2936,570,32,30,62,51.6%,3m
10341,1,阿一二三,2936,674,30,27,57,52.6%,10m
10341,1,YESSIR,2936,468,22,17,39,56.4%,18m
10341,1,[27149]木子,2936,440,14,17,31,45.2%,26m
10341,3,[TCP]MRking,2936,281,11,3,14,78.6%,25m
10341,2,老瞎眼,2936,173,8,6,14,57.1%,15m
10341,1,[Fear]我爱吃鸡腿,2936,195,6,4,10,60.0%,37m
10341,1,[Lus]MasterDecay,2936,144,4,4,8,50.0%,48m
10341,2,[湖南工大]我是萌新,2936,132,3,1,4,75.0%,14m
10341,1,战斗吧少年,2936,0,3,2,5,60.0%,46m
10341,1,往事随风,2936,74,3,8,11,27.3%,19m
10341,2,狂龙,2936,30,2,0,2,100.0%,44m
10341,2,[眼瞎的车万苟]Satori,2936,0,1,0,1,100.0%,3m
10341,3,Liebig,2936,0,1,0,1,100.0%,47m
10341,2,手断也玩不好人族,2936,0,1,0,1,100.0%,11m
10341,2,[暴雪我是你爹]他就一边甩一边哭,2936,32,1,3,4,25.0%,29m
10341,1,pimba,2936,38,1,6,7,14.3%,18m
10361,1,[stkse]targetZ,2935,1613,97,81,178,54.5%,5m
10361,2,好哥哥别打我,2935,553,63,35,98,64.3%,10m
10361,1,[三族同萌会]ACG,2935,612,24,21,45,53.3%,26m
10361,2,WAKE,2935,189,6,2,8,75.0%,3m
10361,1,[C82230]湘天豆,2935,156,6,3,9,66.7%,26m
10361,3,一波先生,2935,199,5,12,17,29.4%,23m
10361,3,小祖,2935,95,2,0,2,100.0%,21m
10361,2,DATEALIVEqwq,2935,30,2,2,4,50.0%,29m
10361,2,斗鱼小宇丶,2935,0,2,3,5,40.0%,2m
10361,2,MagicSnorlax,2935,30,2,3,5,40.0%,19m
10361,2,[119]ErshunZ,2935,0,1,0,1,100.0%,20m
10361,2,[本子画师]对月亮讲晚安,2935,0,1,0,1,100.0%,14m
10361,1,[火焰雷兽]洋的很,2935,30,1,7,8,12.5%,19m
10361,2,[华夏何平]Frstleve,2935,0,0,1,1,0.0%,9m
10375,2,司马老贼,2934,1081,59,37,96,61.5%,8m
10375,2,ytJansbon,2934,679,50,43,93,53.8%,47m
10375,2,ccac,2934,852,32,30,62,51.6%,21m
10375,2,wdk,2934,367,15,14,29,51.7%,14m
10375,2,[MMOPhD]TcK,2934,375,14,12,26,53.8%,46m
10375,3,WHY,2934,306,12,11,23,52.2%,21m
10375,3,LzayoiSakuya,2934,165,6,5,11,54.5%,17m
10375,1,龙中之风,2934,97,4,2,6,66.7%,48m
10375,1,铁胆飞机,2934,0,3,2,5,60.0%,36m
10375,2,[孤独做菜下饭]沙僵,2934,60,3,2,5,60.0%,14m
10375,3,[死亡降临]格雷果克里冈爵士,2934,97,2,1,3,66.7%,12m
10375,2,root,2934,30,2,2,4,50.0%,19m
10375,2,[我菜请打队友]白门楼子,2934,60,2,3,5,40.0%,5m
10375,2,alex,2934,0,1,1,2,50.0%,45m
10375,2,大爱乾坤,2934,0,0,1,1,0.0%,2m
10375,1,疯狂幻想,2934,0,0,2,2,0.0%,50m
10391,3,[NLYH]两道杠,2933,1008,278,274,552,50.4%,22m
10391,1,[世纪之舟]apple,2933,1591,119,123,242,49.2%,14m
10391,2,Cloud,2933,1407,71,49,120,59.2%,10m
10391,1,香菜,2933,889,53,42,95,55.8%,9m
10391,3,不会,2933,991,40,39,79,50.6%,18m
10391,2,[COP]疯之殇,2933,466,36,22,58,62.1%,44m
10391,2,Dreamhacker,2933,385,15,17,32,46.9%,11m
10391,2,[Chest]侃爷,2933,333,13,7,20,65.0%,8m
10391,3,夜落沐晨,2933,266,12,11,23,52.2%,26m
10391,1,大宇,2933,142,6,2,8,75.0%,1h
10391,3,[色萝莉]东风谷早喵,2933,97,4,3,7,57.1%,17m
10391,2,qToTp,2933,62,3,1,4,75.0%,15m
10391,2,[我们是无敌的]Mushroom,2933,42,3,2,5,60.0%,4m
10391,2,阿克苏大苹果,2933,60,3,3,6,50.0%,21m
10391,2,萌主丶,2933,0,1,0,1,100.0%,20m
10391,2,[同济大学]帅气的得得,2933,0,1,0,1,100.0%,21m
10391,2,[死河]奎尔蒙特千秋,2933,0,1,0,1,100.0%,14m
10391,2,[我心有猛虎]梦是林下夕,2933,30,1,1,2,50.0%,17m
10391,2,[七咕咕]llllll,2933,30,1,1,2,50.0%,14m
10391,2,[君临天下丶]redballs,2933,0,0,1,1,0.0%,3m
10391,1,[猫咪一个顶俩]罗莎莉亚莉莉娅,2933,0,0,1,1,0.0%,1h
10412,2,暴走的卡卡西,2932,474,20,12,32,62.5%,20m
10412,1,唧唧歪歪啰里啰嗦,2932,219,10,8,18,55.6%,36m
10412,3,我太蓝了,2932,191,8,2,10,80.0%,9m
10412,2,IIIIIIII,2932,126,8,8,16,50.0%,32m
10412,1,[造物主泰勒]human,2932,196,6,4,10,60.0%,9m
10412,1,暴躁的裤子,2932,226,6,14,20,30.0%,12m
10412,1,[社交学教员]地中海渔民,2932,165,5,7,12,41.7%,43m
10412,2,[熊大和熊二]一波流大师,2932,120,4,6,10,40.0%,4m
10412,3,还我飘飘拳,2932,23,4,12,16,25.0%,10m
10412,2,Maya,2932,60,3,1,4,75.0%,29m
10412,1,天启,2932,0,3,2,5,60.0%,14m
10412,1,澳督,2932,0,3,2,5,60.0%,20m
10412,2,llllllIIlIlI,2932,30,2,1,3,66.7%,29m
10412,2,堡垒说得对,2932,99,2,3,5,40.0%,24m
10412,1,被铭记者,2932,66,2,6,8,25.0%,44m
10412,2,[花玲]陶典,2932,0,1,0,1,100.0%,12m
10412,2,[RTSGo]doomwatcher,2932,0,1,0,1,100.0%,23m
10412,1,御坂美琴,2932,0,1,0,1,100.0%,1h
10412,2,[星战分部]ZXY,2932,0,1,0,1,100.0%,47m
10412,2,Loras,2932,0,1,2,3,33.3%,20m
10412,2,mylily,2932,30,1,2,3,33.3%,17m
10412,2,青柠檬,2932,30,1,3,4,25.0%,24m
10412,1,路明飞,2932,0,0,3,3,0.0%,1h
10435,2,IlIIIIIIllll,2931,1168,283,268,551,51.4%,44m
10435,2,[琴筝]星际争霸,2931,1292,172,153,325,52.9%,44m
10435,3,fkoh,2931,1107,63,61,124,50.8%,2m
10435,2,Walte,2931,738,48,30,78,61.5%,14m
10435,2,扮猪吃老虎,2931,790,43,30,73,58.9%,21m
10435,1,你的矿物储量不足,2931,735,31,25,56,55.4%,10m
10435,1,[闪电伍连鞭]smileboy,2931,320,13,7,20,65.0%,1h
10435,1,[豪爽豪爽]手术刀,2931,454,13,22,35,37.1%,25m
10435,2,竹雨听风,2931,193,7,5,12,58.3%,24m
10435,1,地锅排骨,2931,185,6,4,10,60.0%,8m
10435,3,烧饼包子,2931,157,4,4,8,50.0%,43m
10435,2,樱岛麻衣,2931,62,3,3,6,50.0%,10m
10435,2,[暴雪二十五队]御宅候鸟的草径,2931,41,2,2,4,50.0%,7m
10435,2,GalaxyRIF,2931,38,2,2,4,50.0%,1h
10435,2,[德意志之心]Rapstar,2931,0,1,1,2,50.0%,29m
10435,2,天雪蓝,2931,30,1,1,2,50.0%,46m
10435,1,[Sc养老]切尔诺贝利,2931,48,1,2,3,33.3%,19m
10435,2,[人类只会狗]嘤嘤嘤嘤闹卫星,2931,0,1,3,4,25.0%,44m
10435,1,Sprint,2931,0,0,1,1,0.0%,45m
10454,3,llllllllllll,2930,1456,222,233,455,48.8%,44m
10454,2,[集美大学]集美孙一峰,2930,1582,121,99,220,55.0%,22m
10454,1,路明非,2930,958,32,37,69,46.4%,3m
10454,1,骑着黛西,2930,246,10,9,19,52.6%,53m
10454,1,[唯独你没懂]哔哩哔哩双音浮华,2930,223,8,8,16,50.0%,25m
10454,1,[好哥哥放过我]GunplaDX,2930,96,5,4,9,55.6%,41m
10454,2,URWOOD,2930,120,5,4,9,55.6%,29m
10454,2,maru,2930,150,5,8,13,38.5%,10m
10454,1,芜湖起飞,2930,96,4,2,6,66.7%,1h
10454,1,[战旗修道院]仙女还用卫生巾吗,2930,116,4,3,7,57.1%,1h
10454,2,[社交学超可爱]xxoo,2930,60,2,2,4,50.0%,5m
10454,1,心已失梦已碎,2930,74,2,6,8,25.0%,27m
10454,2,[我们是反抗军]隐葬,2930,0,1,2,3,33.3%,32m
10454,2,醉笑苍天,2930,0,0,3,3,0.0%,14m
10468,1,coach,2929,1388,221,193,414,53.4%,5m
10468,3,Clay,2929,1208,53,65,118,44.9%,4m
10468,2,[loveMM]你奈我何,2929,914,39,31,70,55.7%,20m
10468,1,隔壁王爷爷,2929,1057,36,40,76,47.4%,27m
10468,2,[菊花神教]Alcatraz,2929,617,24,18,42,57.1%,20m
10468,1,钢铁菊花,2929,590,21,19,40,52.5%,26m
10468,1,Bulldandy,2929,292,13,7,20,65.0%,1h
10468,1,cyhsss,2929,282,9,12,21,42.9%,43m
10468,2,[奶茶三兄弟]MRFuzzyPants,2929,252,8,6,14,57.1%,14m
10468,2,[暴雪十五队]澳华布特,2929,155,4,4,8,50.0%,45m
10468,2,[秋毫]快乐肥宅,2929,58,3,0,3,100.0%,44m
10468,2,[星绘]麻麻,2929,0,3,1,4,75.0%,1h
10468,2,[樱公馆]地平线倡议,2929,0,3,2,5,60.0%,1h
10468,2,[暴雪十五队]大多数,2929,30,2,0,2,100.0%,45m
10468,3,[萨尔那加之刃]jiuzi,2929,131,2,2,4,50.0%,1h
10468,1,唢呐吹百鸟朝凤,2929,126,2,6,8,25.0%,6m
10468,2,精封棺材,2929,0,1,2,3,33.3%,60m
10468,2,[最菜战队]forever,2929,0,0,1,1,0.0%,8m
10468,2,空焕颜,2929,0,0,1,1,0.0%,8m
10487,2,致命的爱,2928,1564,120,110,230,52.2%,21m
10487,2,cypf,2928,1600,113,91,204,55.4%,22m
10487,1,qxlsss,2928,1156,42,41,83,50.6%,19m
10487,1,[XXHZ33]人菜瘾大,2928,863,36,35,71,50.7%,27m
10487,1,不知道是谁的爸爸,2928,581,22,23,45,48.9%,10m
10487,2,AIDA,2928,494,21,18,39,53.8%,3m
10487,2,喵神,2928,462,17,19,36,47.2%,7m
10487,2,[KPL1vc]Violet,2928,291,11,5,16,68.8%,7m
10487,2,[小菜逼]lllyyy,2928,167,7,5,12,58.3%,58m
10487,2,[刺蛇互助社团]蒂月,2928,134,6,7,13,46.2%,4m
10487,1,飒飒大,2928,97,5,1,6,83.3%,1h
10487,1,艾尔的城管,2928,91,5,2,7,71.4%,22m
10487,1,[Riders]Terrorblade,2928,201,5,8,13,38.5%,19m
10487,2,[老衲]死亡梦魇,2928,0,3,2,5,60.0%,1h
10487,2,龙焱,2928,0,1,1,2,50.0%,8m
10487,2,[krp]creatorlxd,2928,30,1,2,3,33.3%,12m
10487,1,[KPG]重新集结部队,2928,0,1,3,4,25.0%,10m
10487,1,[KOKOKO]菲尼克斯,2928,0,0,1,1,0.0%,1h
10487,2,烧仙草煮可乐,2928,0,0,2,2,0.0%,20m
10487,2,[可可萝]百地希留耶,2928,0,0,2,2,0.0%,2m
10487,2,再见宋哈娜,2928,0,0,4,4,0.0%,47m
10508,2,SOLI,2927,1605,137,127,264,51.9%,21m
10508,3,三界梦少女,2927,1061,108,93,201,53.7%,30m
10508,2,划水大鲤鱼,2927,307,43,35,78,55.1%,12m
10508,2,[泰伦hz]INNOTerran,2927,882,36,33,69,52.2%,27m
10508,3,JOsmJoestar,2927,579,33,31,64,51.6%,19m
10508,2,[黑丝小幼女]紫铭,2927,325,28,22,50,56.0%,17m
10508,1,帝国飞龙,2927,742,23,30,53,43.4%,5m
10508,2,凤羽,2927,544,21,14,35,60.0%,29m
10508,2,云中不知雀,2927,289,12,11,23,52.2%,15m
10508,1,呵呵,2927,278,10,15,25,40.0%,14m
10508,3,总之好犀利,2927,97,4,4,8,50.0%,16m
10508,2,[博爱之城]士官长,2927,30,2,0,2,100.0%,26m
10508,2,[恋战皇朝]秩序缺乏情感,2927,58,2,1,3,66.7%,26m
10508,2,苟逼,2927,30,2,4,6,33.3%,20m
10508,2,[SUSTC]Flanker,2927,0,1,0,1,100.0%,29m
10523,1,[在下萌新一只]鲍大将军,2926,1629,205,172,377,54.4%,19m
10523,2,[ToHo]susvara,2926,854,87,84,171,50.9%,20m
10523,1,红烧咕咕鸡,2926,1152,76,67,143,53.1%,44m
10523,3,[西南风]Cygnus,2926,1038,76,85,161,47.2%,47m
10523,1,FGY,2926,548,32,33,65,49.2%,26m
10523,2,[透一下清酒]喜欢小郑同学,2926,324,21,0,21,100.0%,4m
10523,2,最后的远征军,2926,446,17,15,32,53.1%,44m
10523,1,执法机构,2926,267,13,7,20,65.0%,1h
10523,1,寒霜誓言,2926,96,5,1,6,83.3%,1h
10523,2,神鬼不散,2926,122,5,6,11,45.5%,29m
10523,2,GBET,2926,58,2,1,3,66.7%,26m
10523,2,正在重连至游戏,2926,0,1,0,1,100.0%,20m
10523,2,[宇宙职业战队]腐竹,2926,0,1,0,1,100.0%,5m
10523,2,吴小白,2926,0,1,1,2,50.0%,20m
10523,2,菜花黄,2926,30,1,2,3,33.3%,9m
10523,1,dsfb,2926,36,1,6,7,14.3%,11m
10523,3,[星区总指挥部]FORTHEHORDE,2926,0,0,1,1,0.0%,22m
10523,2,[小狐狸]澪幽,2926,0,0,1,1,0.0%,29m
10523,2,谁再呼叫舰队,2926,0,0,1,1,0.0%,14m
10523,2,[YaeRei]彼岸,2926,0,0,1,1,0.0%,15m
10523,2,光芒耀眼,2926,0,0,2,2,0.0%,24m
10544,1,yanmin,2925,1662,289,272,561,51.5%,18m
10544,1,寒霜,2925,1241,84,89,173,48.6%,42m
10544,1,哈哈大战鲁比,2925,1550,73,67,140,52.1%,10m
10544,2,[NVKR]青落菌,2925,1098,67,65,132,50.8%,15m
10544,2,[NHSD]Yorke,2925,708,34,20,54,63.0%,20m
10544,1,瞄了个咪,2925,639,25,24,49,51.0%,42m
10544,1,死一样难过,2925,572,22,21,43,51.2%,18m
10544,2,miku,2925,325,15,10,25,60.0%,3m
10544,2,暗影战魂之影,2925,187,9,5,14,64.3%,1h
10544,2,DragonYang,2925,244,9,8,17,52.9%,17m
10544,1,执剑,2925,210,6,7,13,46.2%,42m
10544,2,卖火柴的小男孩,2925,0,3,2,5,60.0%,10m
10544,2,梁笑堂,2925,60,3,3,6,50.0%,29m
10544,2,[GO天鸟分队]人菜瘾大,2925,30,2,0,2,100.0%,23m
10544,2,川普打星际,2925,30,2,1,3,66.7%,29m
10544,2,呆呆家的小呆,2925,0,1,0,1,100.0%,4m
10544,2,[嘎姐保护协会]Grey,2925,0,1,0,1,100.0%,13m
10544,2,可能你不快乐,2925,30,1,2,3,33.3%,12m
10544,2,wildwolf,2925,0,0,1,1,0.0%,14m
10563,2,我前世天蓬,2924,1560,111,86,197,56.3%,2m
10563,1,粉红色的兔子,2924,663,39,29,68,57.4%,16m
10563,1,花开安静,2924,695,34,33,67,50.7%,12m
10563,1,黄色的闪光,2924,389,11,15,26,42.3%,5m
10563,1,[Rhusky]TomTom,2924,151,5,7,12,41.7%,7m
10563,3,[DC战队]最卖萌的吊丝,2924,170,5,8,13,38.5%,45m
10563,2,书生,2924,164,4,3,7,57.1%,2m
10563,1,Nancheng,2924,144,4,4,8,50.0%,1h
10563,2,扫仙,2924,0,4,4,8,50.0%,1h
10563,1,拱火天王黄旭东,2924,0,3,3,6,50.0%,27m
10563,2,小小棉花糖,2924,0,1,0,1,100.0%,27m
10563,1,独钓寒江,2924,0,1,0,1,100.0%,43m
10563,2,我是鸡饲料,2924,0,1,1,2,50.0%,47m
10563,2,[星之所在RI]StarFish,2924,91,1,2,3,33.3%,53m
10563,2,珊蒂斯语风,2924,0,1,2,3,33.3%,45m
10563,2,[屯溪]幻世傲天,2924,0,1,2,3,33.3%,10m
10563,2,纸飞机的梦想,2924,0,0,1,1,0.0%,6m
10563,2,我的人族像蔡徐坤,2924,0,0,1,1,0.0%,15m
10563,2,西兰尼莫,2924,0,0,1,1,0.0%,8m
10563,1,[乳此]Freedom,2924,0,0,1,1,0.0%,16m
10583,1,[云南艺术学院]人族玩家,2923,993,141,130,271,52.0%,26m
10583,1,TIANYAKING,2923,1504,127,111,238,53.4%,12m
10583,1,[Energy]三硝基甲苯,2923,890,48,56,104,46.2%,42m
10583,1,小怂,2923,1072,36,43,79,45.6%,3m
10583,1,[我高贵的族人]THEONE,2923,346,11,17,28,39.3%,20m
10583,1,世界级退堂鼓手,2923,243,9,8,17,52.9%,25m
10583,1,[干si孙一鸡]少侠你好,2923,280,9,17,26,34.6%,42m
10583,1,[专业de团队]艾尔建筑大师,2923,228,7,5,12,58.3%,53m
10583,3,[幼儿园老大]寻一缕残温,2923,144,6,4,10,60.0%,1h
10583,3,极品闲人,2923,97,5,6,11,45.5%,21m
10583,2,[深空骑士]tpz,2923,0,2,3,5,40.0%,1h
10583,2,yuangude,2923,0,1,0,1,100.0%,15m
10583,1,[手残老年组]dreamdown,2923,36,1,6,7,14.3%,14m
10583,2,滴嗒嘀嗒,2923,0,0,1,1,0.0%,24m
10583,1,[萌新集结地]沐风,2923,0,0,1,1,0.0%,1h
10583,1,玄苍觞,2923,0,0,1,1,0.0%,4m
10599,2,justvery,2922,1154,111,104,215,51.6%,44m
10599,1,[艾尔之主]waiyinhehao,2922,1556,99,95,194,51.0%,10m
10599,3,BroHammer,2922,1481,79,84,163,48.5%,2m
10599,2,呼叫舰队,2922,1141,66,59,125,52.8%,47m
10599,3,Dartagnan,2922,1128,52,46,98,53.1%,13m
10599,2,[极楽净土]醉卧凡尘,2922,943,49,44,93,52.7%,6m
10599,2,Demon,2922,1092,48,34,82,58.5%,22m
10599,2,[游戏风云OL]龙少,2922,673,27,22,49,55.1%,15m
10599,2,IIIIIIIII,2922,265,19,17,36,52.8%,11m
10599,1,阿干,2922,382,14,13,27,51.9%,10m
10599,2,[小算草妙妙屋]snow,2922,308,11,7,18,61.1%,6m
10599,1,[冲就完了]CKCZ,2922,246,7,9,16,43.8%,8m
10599,1,加坦杰厄,2922,48,4,4,8,50.0%,1h
10599,2,[MaKers]NightSecret,2922,60,3,2,5,60.0%,12m
10599,2,MagicZerg,2922,60,3,2,5,60.0%,44m
10599,2,ihlown,2922,0,1,0,1,100.0%,12m
10599,3,[先驱者]超级小游戏高手,2922,0,1,0,1,100.0%,27m
10599,2,llllllllllll,2922,32,1,3,4,25.0%,8m
10599,2,[练出来了协会]Compass,2922,0,0,1,1,0.0%,15m
10599,2,[cANDj]滑稽,2922,0,0,1,1,0.0%,21m
10599,3,[東方幻月舞會]我的手速真的很慢,2922,0,0,1,1,0.0%,16m
10620,1,荒谬,2921,1622,281,248,529,53.1%,19m
10620,2,dsafafaa,2921,890,86,73,159,54.1%,2m
10620,2,[i5]符门俊杰,2921,1202,44,48,92,47.8%,10m
10620,2,llllllllllll,2921,295,24,27,51,47.1%,11m
10620,1,[大jj美少女]大吊少女,2921,623,23,21,44,52.3%,12m
10620,2,placedo,2921,509,20,14,34,58.8%,44m
10620,2,[南京工业大学]二五仔尸沉西湖,2921,429,16,12,28,57.1%,19m
10620,2,AAA,2921,382,14,11,25,56.0%,10m
10620,2,一人,2921,242,9,8,17,52.9%,15m
10620,3,[吾三美如画]达拉姆带主教,2921,198,6,5,11,54.5%,21m
10620,2,[萌新终结者]妮可妮非常妮,2921,58,3,1,4,75.0%,20m
10620,1,右耳,2921,78,3,6,9,33.3%,27m
10620,1,[迷路的麋鹿]世界首富博丽灵梦,2921,48,2,1,3,66.7%,29m
10620,2,[鱼人永不败]wko,2921,0,1,0,1,100.0%,44m
10620,2,剑道邪尊,2921,0,1,0,1,100.0%,4m
10620,2,[孙红雷]SamTsui,2921,0,1,1,2,50.0%,9m
10636,1,ZZX,2920,1325,49,50,99,49.5%,27m
10636,2,AkkUndDativ,2920,464,37,30,67,55.2%,15m
10636,2,肆无忌惮,2920,753,33,26,59,55.9%,10m
10636,1,[Goodg]废铁,2920,368,26,20,46,56.5%,12m
10636,3,[无敌之师]涩涩的青春,2920,235,11,12,23,47.8%,21m
10636,1,希望,2920,290,11,14,25,44.0%,26m
10636,1,妹子加微信,2920,239,10,10,20,50.0%,1h
10636,1,Cjnicolas,2920,96,4,1,5,80.0%,1h
10636,2,lllllll,2920,60,3,1,4,75.0%,24m
10636,3,[折纸后援团]阿库卢马卡卡,2920,0,2,6,8,25.0%,1h
10636,2,[刺蛇互助社团]子凌先生,2920,30,1,1,2,50.0%,24m
10636,2,StarMoonRNA,2920,30,1,2,3,33.3%,26m
10636,2,mangr,2920,92,1,3,4,25.0%,2m
10636,2,[卡吧基佬]Limboy,2920,0,0,1,1,0.0%,8m
10636,2,[电风扇]咕噜灵波,2920,0,0,1,1,0.0%,8m
10636,2,[佩刀]白门楼吕布,2920,0,0,1,1,0.0%,6m
10652,1,[我们是无敌的]求道者,2919,1014,92,83,175,52.6%,3m
10652,3,条码人,2919,921,65,78,143,45.5%,23m
10652,2,[泰伦征兵中心]不明伯爵,2919,322,17,3,20,85.0%,21m
10652,2,[装大佬的鸡]红白故人,2919,416,16,11,27,59.3%,2m
10652,2,[MP]小小菜鸟,2919,354,14,12,26,53.8%,10m
10652,1,[Gs黄老仙]宫水三叶,2919,408,13,15,28,46.4%,25m
10652,3,Snorlax,2919,278,12,14,26,46.2%,28m
10652,2,大橙子,2919,214,11,5,16,68.8%,20m
10652,3,[张师傅想致富]学习行家,2919,193,8,4,12,66.7%,1h
10652,1,Nov,2919,248,7,10,17,41.2%,5m
10652,1,[DN]NEXUS,2919,143,6,3,9,66.7%,1h
10652,2,猪鼻,2919,94,4,3,7,57.1%,21m
10652,2,RainbowC,2919,0,1,1,2,50.0%,45m
10652,1,伊利创造核心科技,2919,48,1,2,3,33.3%,1h
10652,2,[千痔王]随便,2919,0,0,1,1,0.0%,19m
10652,1,Raiden,2919,0,0,5,5,0.0%,42m
10668,3,珂朵莉酱太可爱了,2918,1505,428,419,847,50.5%,25m
10668,1,[盈盈一水间]土豆小胡,2918,1313,55,47,102,53.9%,26m
10668,2,[SYP]平凡安陆人,2918,1032,50,40,90,55.6%,21m
10668,2,风中的火柴,2918,958,44,26,70,62.9%,22m
10668,1,weinima,2918,757,34,26,60,56.7%,46m
10668,2,菜鸡请不要喷,2918,571,26,12,38,68.4%,2m
10668,1,llllllllllll,2918,374,24,22,46,52.2%,27m
10668,2,[钢铁雷兽]紫音砂风,2918,305,13,12,25,52.0%,29m
10668,2,天歌,2918,258,9,5,14,64.3%,44m
10668,2,[LFY]多久傲岸,2918,220,9,7,16,56.2%,21m
10668,1,炸成骨灰,2918,113,4,0,4,100.0%,14m
10668,2,zqyNB,2918,0,4,0,4,100.0%,1h
10668,2,程好马叉虫,2918,0,4,1,5,80.0%,28m
10668,2,浪人与狗,2918,112,3,0,3,100.0%,20m
10668,2,隔壁老王,2918,0,2,3,5,40.0%,9m
10668,2,General,2918,0,1,0,1,100.0%,4m
10668,2,秋海棠,2918,30,1,1,2,50.0%,7m
10668,2,[SATINE]种土豆,2918,34,1,1,2,50.0%,22m
10668,2,[听雨轩]LYL,2918,0,0,1,1,0.0%,22m
10687,2,Bomb,2917,1594,100,70,170,58.8%,45m
10687,1,Aquarius,2917,310,29,28,57,50.9%,5m
10687,2,智力无法接受,2917,443,17,12,29,58.6%,23m
10687,2,赤佬,2917,425,15,17,32,46.9%,4m
10687,2,OldDriver,2917,320,11,13,24,45.8%,2m
10687,3,[Etern谐]墨色,2917,186,8,5,13,61.5%,16m
10687,3,Shuai,2917,142,5,4,9,55.6%,2m
10687,3,TBsupersp,2917,127,5,5,10,50.0%,1h
10687,1,cccccc,2917,96,5,5,10,50.0%,49m
10687,1,Birozhki,2917,97,4,3,7,57.1%,1h
10687,3,[Deep]QichoNJAY,2917,124,4,13,17,23.5%,20m
10687,3,葵葵的小熊软糖,2917,122,4,14,18,22.2%,29m
10687,2,[凯哥集团]凛冬将至,2917,112,3,0,3,100.0%,29m
10687,2,转虫先锋,2917,60,3,2,5,60.0%,46m
10687,1,[大图书馆的]无忧无愁,2917,138,3,10,13,23.1%,3m
10687,1,[峰吹起了过去]Mitsuha,2917,95,2,3,5,40.0%,17m
10687,2,WenZIc,2917,0,1,0,1,100.0%,12m
10687,2,[最菜战队]赤瞳,2917,30,1,1,2,50.0%,11m
10687,1,星云寓言,2917,0,0,1,1,0.0%,1h
10687,2,[C53421]扒了猛干,2917,0,0,1,1,0.0%,46m
10687,2,sliceRest,2917,0,0,1,1,0.0%,47m
10687,2,[I苏维埃I]浅鲵鲸,2917,0,0,1,1,0.0%,12m
10687,2,停战吧,2917,0,0,2,2,0.0%,6m
10710,3,魏向风,2916,1387,126,114,240,52.5%,2m
10710,2,[Rhusky]霜封千夜,2916,1072,45,34,79,57.0%,20m
10710,2,Voodoo,2916,811,33,27,60,55.0%,44m
10710,2,[foryss]唐瓜点,2916,230,18,7,25,72.0%,44m
10710,3,鸡仔我儿,2916,417,12,24,36,33.3%,45m
10710,2,[菜有菜的道理]王尼玛,2916,228,10,4,14,71.4%,21m
10710,1,Sou,2916,0,4,3,7,57.1%,40m
10710,3,[大唐帝国]浮生未歇若水年華,2916,0,2,3,5,40.0%,13m
10710,2,国服第一白给,2916,110,2,3,5,40.0%,35m
10710,2,[江北星际]Poundba,2916,0,1,0,1,100.0%,6m
10710,2,[好哥哥求让]慕清,2916,30,1,2,3,33.3%,9m
10710,2,人族蔡徐坤,2916,0,0,1,1,0.0%,44m
10710,2,[秋毫第五分队]Polaris,2916,0,0,2,2,0.0%,14m
10723,1,我头哥很不爽,2915,671,85,78,163,52.1%,5m
10723,2,啊呆,2915,1045,71,59,130,54.6%,5m
10723,2,只卖身不卖艺,2915,590,46,48,94,48.9%,44m
10723,2,[RNavy]Belfast,2915,745,35,16,51,68.6%,20m
10723,2,[aloha]兮兮,2915,622,23,20,43,53.5%,44m
10723,1,xhcchxjdbwpx,2915,445,21,22,43,48.8%,9m
10723,1,[小鸡屠宰场7]霜之刃,2915,395,21,24,45,46.7%,14m
10723,1,[Foehn焚]秘制小汉堡,2915,490,20,17,37,54.1%,5m
10723,3,无脑憋航母,2915,216,10,3,13,76.9%,25m
10723,2,Sirius,2915,234,9,7,16,56.2%,1h
10723,2,浩泽,2915,197,6,4,10,60.0%,12m
10723,3,坐飞机的维京,2915,189,6,4,10,60.0%,16m
10723,2,灵雨既零,2915,213,5,6,11,45.5%,27m
10723,2,[我们是萌新]柠萌小鱿鱼,2915,136,4,1,5,80.0%,12m
10723,2,缘起缘灭总无情,2915,0,4,1,5,80.0%,1h
10723,2,SWK,2915,167,4,8,12,33.3%,25m
10723,1,[SUIBE]IIIIIIII,2915,104,3,11,14,21.4%,10m
10723,2,XiaOSu,2915,30,2,1,3,66.7%,48m
10723,2,icelee,2915,18,1,2,3,33.3%,47m
10723,2,[CNboys]Linford,2915,0,0,1,1,0.0%,44m
10723,2,[子小一口苗]子小火央亻圭,2915,0,0,1,1,0.0%,4m
10723,1,玄眇,2915,0,0,1,1,0.0%,1h
10723,2,[萌芯]March,2915,0,0,1,1,0.0%,47m
10746,1,[北京城管]麻袋不要乱来,2914,1031,37,41,78,47.4%,28m
10746,2,[西伯利亚土豆]阿塔尼斯,2914,897,35,33,68,51.5%,11m
10746,2,predator,2914,753,31,27,58,53.4%,10m
10746,2,[达拉姆查卡拉]Hunter,2914,103,4,5,9,44.4%,24m
10746,2,暗影随风,2914,0,3,2,5,60.0%,1h
10746,1,[目標諾森德]YAXeair,2914,138,3,2,5,60.0%,1h
10746,2,Allen,2914,64,2,4,6,33.3%,15m
10746,1,[GLGLGL]艾泽拉斯,2914,0,1,1,2,50.0%,1h
10746,2,警宏斯派洛,2914,30,1,3,4,25.0%,4m
10746,2,谷秋,2914,0,0,1,1,0.0%,20m
10746,2,evolee,2914,0,0,2,2,0.0%,49m
10757,2,蛤蟆爱上猫,2913,1190,195,172,367,53.1%,20m
10757,2,混元太极,2913,1385,65,45,110,59.1%,4m
10757,1,悍戈,2913,392,25,31,56,44.6%,42m
10757,2,沈逼逼,2913,508,20,19,39,51.3%,45m
10757,2,Imustone,2913,170,7,6,13,53.8%,23m
10757,2,[大M78星云]大一小咸鱼,2913,126,4,0,4,100.0%,48m
10757,2,[小小怪怪]夜月,2913,160,4,3,7,57.1%,21m
10757,2,XiaoSe,2913,96,4,6,10,40.0%,45m
10757,2,大混子,2913,86,3,3,6,50.0%,26m
10757,3,断绝的等待,2913,121,3,5,8,37.5%,12m
10757,2,战神丨势不可挡,2913,90,3,5,8,37.5%,2m
10757,2,[白给兄弟]INNOVATION,2913,34,2,1,3,66.7%,12m
10757,1,[六味地黄丸]百川,2913,30,2,6,8,25.0%,19m
10757,2,木易小哥,2913,0,1,0,1,100.0%,29m
10757,2,[江南狗王]SKTVIP,2913,0,0,1,1,0.0%,30m
10757,2,[够不够莽]卖了否冷,2913,0,0,1,1,0.0%,12m
10773,3,一击必杀,2912,947,55,67,122,45.1%,28m
10773,2,NEJFD,2912,1172,53,42,95,55.8%,7m
10773,2,rozerta,2912,847,38,29,67,56.7%,4m
10773,1,Momoko,2912,439,37,32,69,53.6%,10m
10773,1,[SFG117]随机,2912,564,21,20,41,51.2%,22m
10773,2,EdmundDZhang,2912,370,17,14,31,54.8%,23m
10773,3,[温柔兔公主]我爱修地堡,2912,122,13,14,27,48.1%,25m
10773,3,[不会散枪兵]Jason,2912,252,11,10,21,52.4%,14m
10773,2,CarryteZero,2912,178,7,7,14,50.0%,55m
10773,2,麻辣小龙虾,2912,30,2,2,4,50.0%,21m
10773,2,[人族盟约]反贪,2912,0,1,0,1,100.0%,30m
10773,2,cloudier,2912,0,1,0,1,100.0%,23m
10773,2,爱玩游戏的达桑,2912,0,1,0,1,100.0%,15m
10773,2,[神棍三条]北溟鲲,2912,0,1,1,2,50.0%,44m
10773,2,[文韬武略]凉夜,2912,30,1,1,2,50.0%,44m
10773,1,[miku组]哦买噶的,2912,0,0,3,3,0.0%,16m
10773,2,zjy,2912,0,0,4,4,0.0%,1h
10790,2,LIIIIIIIIIPN,2911,1113,54,32,86,62.8%,45m
10790,2,Drzomboss,2911,641,34,18,52,65.4%,48m
10790,1,HCLTMAC,2911,777,34,30,64,53.1%,27m
10790,2,简单粗暴,2911,148,22,14,36,61.1%,48m
10790,2,[透一下清酒]我好聪明,2911,249,9,7,16,56.2%,3m
10790,2,艾尔,2911,161,8,5,13,61.5%,6m
10790,1,仙祠,2911,96,5,4,9,55.6%,4m
10790,2,[SUSTC]白烛葵,2911,189,5,6,11,45.5%,20m
10790,2,亮亮,2911,60,3,2,5,60.0%,12m
10790,2,Scorpion,2911,0,3,2,5,60.0%,35m
10790,3,[璀璨]星辰,2911,34,2,1,3,66.7%,1h
10790,2,[亲吻那片花瓣]Doc,2911,60,2,5,7,28.6%,20m
10802,1,[流氓高手]晨鸣,2910,1395,203,199,402,50.5%,42m
10802,3,江爱宽宽,2910,1379,176,170,346,50.9%,22m
10802,3,皇子杀神,2910,1488,141,134,275,51.3%,18m
10802,2,白糖糖,2910,480,20,13,33,60.6%,44m
10802,3,Violet,2910,381,18,17,35,51.4%,25m
10802,2,Monk,2910,260,10,12,22,45.5%,23m
10802,2,七七捌捌,2910,244,9,7,16,56.2%,8m
10802,2,TototoT,2910,236,8,5,13,61.5%,15m
10802,2,[SDEt]Jeager,2910,114,5,4,9,55.6%,29m
10802,1,[在命运中挣扎]路人甲,2910,96,5,4,9,55.6%,40m
10802,2,东方,2910,0,1,0,1,100.0%,20m
10802,2,巅峰苇名一心,2910,0,1,0,1,100.0%,29m
10802,2,爱在日出前,2910,0,1,3,4,25.0%,44m
10802,1,[星际2虫族吧]Printa,2910,0,0,1,1,0.0%,40m
10802,2,米拉的劫掠部队,2910,0,0,1,1,0.0%,2m
10802,2,拽丶小浪,2910,0,0,3,3,0.0%,22m
10818,2,[死亡之火]shensky,2909,1574,113,87,200,56.5%,27m
10818,1,[CPT]ZHUJIAO,2909,1405,51,55,106,48.1%,19m
10818,1,AlexKenCN,2909,655,28,29,57,49.1%,17m
10818,1,Curtain,2909,507,23,15,38,60.5%,27m
10818,2,犹格索托斯,2909,626,23,22,45,51.1%,15m
10818,3,saddog,2909,212,7,1,8,87.5%,6m
10818,2,[海王星舰队]萌新,2909,182,6,2,8,75.0%,19m
10818,2,Energyhe,2909,194,5,7,12,41.7%,1h
10818,2,[挨萌愚忠分子]TerranLight,2909,90,4,3,7,57.1%,20m
10818,2,lllllllllll,2909,0,3,2,5,60.0%,1h
10818,1,DontRushMe,2909,92,3,5,8,37.5%,3m
10818,2,warriar,2909,30,2,0,2,100.0%,8m
10818,2,[ISMU星际]innovation,2909,30,2,1,3,66.7%,28m
10818,2,[星际兄弟]二班学霸,2909,32,2,3,5,40.0%,47m
10818,1,[梦瑾空人心]路名渊,2909,123,2,5,7,28.6%,26m
10818,2,[学峰叫]奇思妙想,2909,0,1,0,1,100.0%,4m
10818,2,[华政之光]皮皮鲁,2909,0,1,0,1,100.0%,29m
10818,2,[重案组之虎]吾名之名,2909,0,1,1,2,50.0%,21m
10818,2,门口卖酱油的,2909,0,1,1,2,50.0%,12m
10818,2,sadfasda,2909,30,1,1,2,50.0%,45m
10818,2,破产的蒙娜豆莎,2909,0,0,1,1,0.0%,9m
10818,2,IIIIIIIIIIII,2909,0,0,1,1,0.0%,23m
10818,2,忧伤的硬汉,2909,0,0,1,1,0.0%,42m
10818,2,[老油条战队]鱼市恶霸孙一峰,2909,0,0,1,1,0.0%,19m
10842,1,暗红星辰,2908,1071,63,59,122,51.6%,9m
10842,1,EtdCastiel,2908,1156,55,55,110,50.0%,20m
10842,2,[萌即正义]PhantomDK,2908,667,43,33,76,56.6%,15m
10842,1,[CRUSH]abc,2908,554,21,17,38,55.3%,18m
10842,3,IIIIIIIIIIII,2908,268,9,6,15,60.0%,48m
10842,1,Agsky,2908,143,6,6,12,50.0%,43m
10842,2,woca,2908,154,5,1,6,83.3%,25m
10842,1,步之道,2908,96,5,2,7,71.4%,1h
10842,2,lim,2908,120,5,4,9,55.6%,45m
10842,2,顾傻子,2908,30,2,3,5,40.0%,46m
10842,1,RIVER,2908,70,2,10,12,16.7%,19m
10842,2,渣男黄琦,2908,0,1,0,1,100.0%,3m
10842,1,[Globus]TYTY,2908,0,1,1,2,50.0%,29m
10842,1,[第一戦門舰隊]隳阗胤矜,2908,96,1,1,2,50.0%,48m
10842,2,[Iknow]第五丶,2908,0,0,1,1,0.0%,29m
10842,2,莽夫浩然,2908,0,0,1,1,0.0%,8m
10842,2,秋风,2908,0,0,1,1,0.0%,10m
10842,3,[i马士]年轻人不讲武德,2908,0,0,2,2,0.0%,46m
10860,2,很爱很爱你,2907,1356,124,105,229,54.1%,48m
10860,1,johnnyboy,2907,1551,59,65,124,47.6%,42m
10860,2,cenkee,2907,796,36,31,67,53.7%,9m
10860,1,[FsArH]狂派威震天,2907,755,30,25,55,54.5%,27m
10860,1,[Holygl]世界第二公主殿下,2907,896,29,36,65,44.6%,26m
10860,2,宇智波鼬,2907,463,20,11,31,64.5%,25m
10860,2,[鸡饲料1]奈文摩尔,2907,251,11,2,13,84.6%,3m
10860,2,guoyufan,2907,320,11,8,19,57.9%,8m
10860,2,人好,2907,204,7,8,15,46.7%,12m
10860,1,ptz,2907,117,6,2,8,75.0%,20m
10860,1,恒恒,2907,166,6,5,11,54.5%,58m
10860,1,[CLaffy]沉思往事立残阳,2907,164,5,6,11,45.5%,21m
10860,2,TQFLYER,2907,88,4,5,9,44.4%,24m
10860,2,摩诃不可思议,2907,112,2,1,3,66.7%,21m
10860,2,[无边之空]sdf,2907,0,1,0,1,100.0%,24m
10860,2,[刺蛇单推协会]落雪,2907,0,1,0,1,100.0%,23m
10860,2,[世风第三帝国]残念风寂落,2907,0,1,0,1,100.0%,17m
10860,2,星际领主,2907,30,1,1,2,50.0%,9m
10860,2,Mrboy,2907,0,1,1,2,50.0%,7m
10860,1,萌新菜菜子,2907,0,1,1,2,50.0%,43m
10860,2,[野蛮猫骑士]匹夫一怒血溅五步,2907,30,1,5,6,16.7%,42m
10860,1,Max,2907,0,1,6,7,14.3%,13m
10860,2,[暴雪嘉年华]小小土人,2907,0,0,1,1,0.0%,21m
10860,2,Steven,2907,0,0,1,1,0.0%,8m
10860,2,[AdamxL]臉基尼,2907,0,0,3,3,0.0%,5m
10860,2,[羊驼羊驼羊]IIIIIIIIIIII,2907,0,0,4,4,0.0%,1h
10860,1,[白给李老八]风起雁南下,2907,0,0,6,6,0.0%,8m
10887,1,[Beastp]六地选手,2906,1600,195,179,374,52.1%,14m
10887,2,JACK,2906,432,68,51,119,57.1%,4m
10887,1,TapetAxian,2906,1119,45,43,88,51.1%,26m
10887,2,浅梦克星,2906,550,27,16,43,62.8%,2m
10887,2,[游戏风云OL]WifiDragon,2906,627,24,20,44,54.5%,20m
10887,1,[浪啊浪]吕同轩帅,2906,458,17,19,36,47.2%,19m
10887,3,[夕阳下的浪客]历世的世语者世战,2906,327,13,10,23,56.5%,27m
10887,2,喵喵峰,2906,152,5,1,6,83.3%,3m
10887,1,[中国远征军]力挽狂澜,2906,0,3,3,6,50.0%,1h
10887,1,暗夜骑士,2906,48,2,1,3,66.7%,1h
10887,2,ZHE,2906,30,2,4,6,33.3%,8m
10887,2,[白银联盟]Zeratul,2906,0,1,0,1,100.0%,48m
10887,2,大佬让我一把,2906,0,1,1,2,50.0%,30m
10887,2,[星基佬男孩]一马当先锋盾,2906,0,1,2,3,33.3%,26m
10887,2,[幻想神社]whale,2906,0,1,2,3,33.3%,44m
10887,2,[不打内战]Qsn,2906,0,0,1,1,0.0%,45m
10887,2,VioletDance,2906,0,0,1,1,0.0%,28m
10904,2,shadow,2905,1570,473,482,955,49.5%,23m
10904,2,低保跑豪宅,2905,1383,95,70,165,57.6%,15m
10904,1,叶哥哥,2905,1534,74,53,127,58.3%,27m
10904,3,[SDE]卖女孩的小火柴,2905,767,31,37,68,45.6%,45m
10904,2,年少如歌,2905,408,18,7,25,72.0%,24m
10904,2,lllllllllll,2905,339,16,10,26,61.5%,4m
10904,2,Mama,2905,417,16,11,27,59.3%,48m
10904,2,Innochicken,2905,302,11,7,18,61.1%,15m
10904,3,Shinichi,2905,246,8,22,30,26.7%,24m
10904,1,[纵丨横]KINGWW,2905,48,4,4,8,50.0%,9m
10904,2,鞭性茎肛,2905,126,3,1,4,75.0%,21m
10904,2,sdd,2905,0,3,2,5,60.0%,1h
10904,1,michael,2905,0,3,3,6,50.0%,1h
10904,2,[Tov]燕北飞,2905,86,3,6,9,33.3%,30m
10904,1,[DRA]黑瞳,2905,108,3,10,13,23.1%,9m
10904,2,境域,2905,0,1,0,1,100.0%,8m
10904,2,[蕾米莉亚赛高]ZerAtuLR,2905,30,1,2,3,33.3%,30m
10921,2,哦呵呵的魔理沙,2904,1526,304,270,574,53.0%,23m
10921,2,[ljk]zrzaaa,2904,1548,60,57,117,51.3%,12m
10921,1,[火焰雷兽]EINSE,2904,1080,47,36,83,56.6%,9m
10921,2,[软泥怪大团圆]自有科意,2904,326,41,19,60,68.3%,12m
10921,2,[丨SLT丨]SiLeNce,2904,587,30,17,47,63.8%,20m
10921,2,索然无味小刺蛇娘,2904,363,13,9,22,59.1%,44m
10921,3,wuhao,2904,192,8,5,13,61.5%,1h
10921,2,觉悟的新手,2904,176,6,2,8,75.0%,48m
10921,2,yhw,2904,167,6,3,9,66.7%,4m
10921,1,[XXHZ33]岚峪,2904,180,6,5,11,54.5%,1h
10921,2,Entropy,2904,92,5,4,9,55.6%,1h
10921,3,[TZimba]為艾爾而生,2904,193,5,8,13,38.5%,12m
10921,1,wary,2904,0,4,2,6,66.7%,1h
10921,2,熠裳淡淡,2904,0,3,2,5,60.0%,45m
10921,2,遮掩天机,2904,48,3,2,5,60.0%,23m
10921,2,阿嚏斯特,2904,30,2,0,2,100.0%,20m
10921,1,[秀翻一堆]魔方,2904,117,2,5,7,28.6%,50m
10921,2,浅吟悲伤,2904,30,1,2,3,33.3%,26m
10921,1,[白银联盟]JKdagger,2904,0,0,2,2,0.0%,1h
10921,2,NOMattEr,2904,0,0,3,3,0.0%,8m
10941,2,对尖,2903,1392,62,45,107,57.9%,20m
10941,1,IIFIIZIIQII,2903,459,61,58,119,51.3%,11m
10941,1,河西炮哥,2903,1057,47,40,87,54.0%,10m
10941,1,Puma,2903,738,33,23,56,58.9%,7m
10941,2,[风流倜傥]整个菜鸟,2903,683,27,22,49,55.1%,45m
10941,3,[区区八婆紫]Doooomino,2903,557,20,30,50,40.0%,15m
10941,1,[温柔兔公主]菜不是我的错,2903,343,15,17,32,46.9%,26m
10941,2,[肉鸡的饲养]踏剑寻昆仑,2903,171,10,8,18,55.6%,44m
10941,2,[想念]开心就好,2903,208,8,9,17,47.1%,12m
10941,2,羚羊,2903,210,7,4,11,63.6%,20m
10941,1,HansKatze,2903,214,7,4,11,63.6%,26m
10941,2,丶苍白誓言灬,2903,177,6,2,8,75.0%,14m
10941,2,湯音,2903,166,5,3,8,62.5%,23m
10941,2,[嗜血BaSa]好强壮哦,2903,77,5,5,10,50.0%,11m
10941,1,相当神奇,2903,96,4,3,7,57.1%,1h
10941,2,Tursty,2903,112,3,0,3,100.0%,44m
10941,2,[整活六号]开奥西里斯的小白,2903,134,3,2,5,60.0%,27m
10941,3,争霸地球,2903,97,2,2,4,50.0%,1h
10941,3,[Gonzal]Again,2903,121,2,3,5,40.0%,17m
10941,3,Lilith,2903,0,1,0,1,100.0%,12m
10941,2,烟雨过客,2903,30,1,3,4,25.0%,5m
10941,2,[巴比Q]小浣熊烤肉味,2903,0,0,1,1,0.0%,4m
10941,2,zhang,2903,0,0,1,1,0.0%,29m
10964,1,Nonyin,2902,1581,372,335,707,52.6%,26m
10964,3,[白给了]creolulu,2902,1499,187,177,364,51.4%,4m
10964,1,范尼是德鲁伊,2902,708,79,70,149,53.0%,42m
10964,2,Destroy,2902,1532,77,67,144,53.5%,23m
10964,2,安然,2902,904,36,31,67,53.7%,28m
10964,3,花花神龙,2902,397,17,28,45,37.8%,13m
10964,2,狐狸与猎犬,2902,355,14,10,24,58.3%,2m
10964,1,鸭帅叼啊,2902,269,10,11,21,47.6%,36m
10964,3,舰队长,2902,210,9,5,14,64.3%,1h
10964,2,[莽夫苟熊]菜是原罪,2902,253,8,5,13,61.5%,47m
10964,2,汪汪先生,2902,207,6,4,10,60.0%,1h
10964,2,[PLD]寒霜,2902,126,3,1,4,75.0%,17m
10964,2,艾欧尼亚,2902,0,3,2,5,60.0%,1h
10964,1,[阿尔泰瑟斯]IIIIIIIIIIII,2902,96,2,0,2,100.0%,58m
10964,1,[神兵]白衣渡江,2902,142,2,2,4,50.0%,19m
10964,2,gao,2902,0,1,0,1,100.0%,26m
10964,2,拉菲,2902,0,1,1,2,50.0%,5m
10981,2,赵大爷啊,2901,1431,219,212,431,50.8%,3m
10981,1,[你好抱歉]MingSir,2901,1532,118,102,220,53.6%,25m
10981,2,理赔难,2901,1132,96,75,171,56.1%,21m
10981,1,MirageTank,2901,1412,93,87,180,51.7%,8m
10981,1,偷矿选项,2901,861,43,40,83,51.8%,19m
10981,2,無我,2901,498,19,17,36,52.8%,23m
10981,2,花待葬,2901,351,14,9,23,60.9%,45m
10981,2,kbkdlbj,2901,273,11,12,23,47.8%,2m
10981,2,第三次了,2901,144,6,5,11,54.5%,7m
10981,1,LBellaRufis,2901,178,6,8,14,42.9%,43m
10981,3,[炮火46]天下魔侠,2901,135,5,5,10,50.0%,1h
10981,2,十三岁天才少女,2901,30,4,3,7,57.1%,27m
10981,1,SIRHILTER,2901,96,2,0,2,100.0%,40m
10981,2,柚子味长腿仙女,2901,58,2,2,4,50.0%,2m
10981,2,红狐狸,2901,0,1,0,1,100.0%,47m
10981,2,[巴比Q]香辣蟹,2901,0,1,0,1,100.0%,4m
10981,2,牧羊人的怀抱,2901,0,1,1,2,50.0%,3m
10981,2,猜猜,2901,0,0,1,1,0.0%,12m
10981,2,IEjbd,2901,0,0,1,1,0.0%,21m
10981,1,blue,2901,0,0,1,1,0.0%,40m
10981,2,明轩亦梦,2901,0,0,1,1,0.0%,21m
10981,2,[天枢皎月军]煮酒论英雄,2901,0,0,2,2,0.0%,4m
11003,2,Amgsxj,2900,1003,173,154,327,52.9%,23m
11003,1,奔雷手文泰来,2900,1552,141,144,285,49.5%,17m
11003,2,Uranus,2900,1593,128,111,239,53.6%,44m
11003,2,BIANBIAN,2900,1423,66,47,113,58.4%,20m
11003,2,落花成殇丶雨萌萌,2900,1215,51,42,93,54.8%,23m
11003,2,zbc,2900,950,36,30,66,54.5%,8m
11003,3,[看啥]老庙,2900,398,13,27,40,32.5%,28m
11003,2,[我菜请打队友]宗师麒麟,2900,176,7,5,12,58.3%,22m
11003,2,[NS]拥凌,2900,202,6,4,10,60.0%,2m
11003,2,bomber,2900,167,5,4,9,55.6%,27m
11003,2,SKTone,2900,120,4,5,9,44.4%,9m
11003,2,[传说萌娘团]oaza,2900,116,3,1,4,75.0%,26m
11003,2,[GalArC]星座二十八宿,2900,0,3,2,5,60.0%,45m
11003,2,我玩不过你,2900,30,2,1,3,66.7%,15m
11003,2,碳酸天哪,2900,30,1,2,3,33.3%,20m
11003,2,吃一口甜,2900,0,0,2,2,0.0%,45m
11003,3,[暴雪我是你爹]RangerX,2900,0,0,4,4,0.0%,1h
11003,1,[雷本]INnoVation,2900,0,0,6,6,0.0%,27m
11021,1,starcat,2899,1010,116,105,221,52.5%,16m
11021,1,[葡萄汁]zwj,2899,1457,116,113,229,50.7%,26m
11021,3,LeRoiDuMonde,2899,652,87,97,184,47.3%,19m
11021,1,皆是这深夜的奴隶,2899,1071,84,67,151,55.6%,13m
11021,2,草木,2899,1584,79,60,139,56.8%,25m
11021,2,淡雅儒风,2899,1193,51,45,96,53.1%,11m
11021,1,PImba,2899,1147,40,45,85,47.1%,3m
11021,3,瓶腻耶沛,2899,709,36,35,71,50.7%,4m
11021,1,存钱买特斯拉,2899,786,30,26,56,53.6%,22m
11021,2,[TCP]四季覚,2899,339,27,21,48,56.2%,45m
11021,2,[从阴影中现身]逐火之荧,2899,200,7,8,15,46.7%,15m
11021,2,[浪啊浪]人族幽灵,2899,164,5,2,7,71.4%,2m
11021,2,苏希然,2899,82,5,7,12,41.7%,7m
11021,2,[wwooww]DestinyTony,2899,162,4,4,8,50.0%,15m
11021,2,沐涵,2899,102,3,0,3,100.0%,21m
11021,1,希灵渊,2899,34,3,3,6,50.0%,31m
11021,2,[INS48]Fors,2899,40,1,3,4,25.0%,42m
11021,2,CaileXXX,2899,0,0,2,2,0.0%,17m
11021,2,[4Aiur]轻风,2899,0,0,3,3,0.0%,21m
11040,2,TomZhou,2898,1535,184,153,337,54.6%,12m
11040,2,海贼丶王路飞,2898,1666,70,65,135,51.9%,11m
11040,2,那个男孩,2898,1385,54,52,106,50.9%,8m
11040,1,alioamy,2898,466,34,30,64,53.1%,8m
11040,2,JasonMelon,2898,436,15,17,32,46.9%,48m
11040,2,[薄荷的指挥官]城上海,2898,353,13,10,23,56.5%,10m
11040,2,你的微笑太甜,2898,283,12,5,17,70.6%,27m
11040,1,[一般赢不了]自闭只想下棋,2898,337,11,15,26,42.3%,27m
11040,1,暴坑雪,2898,48,5,3,8,62.5%,1h
11040,2,seveneleven,2898,140,4,7,11,36.4%,45m
11040,2,边昼爱严,2898,0,3,2,5,60.0%,55m
11040,2,[TSOD]月色真美,2898,60,3,6,9,33.3%,22m
11040,2,[洛梦绫音]len,2898,30,2,2,4,50.0%,24m
11040,2,[人类保卫队]死神之子,2898,0,1,0,1,100.0%,35m
11040,2,LUCKYBOY,2898,30,1,2,3,33.3%,48m
11055,3,打扰了,2897,1575,542,530,1072,50.6%,42m
11055,2,伊一,2897,728,28,30,58,48.3%,4m
11055,1,leng,2897,593,24,25,49,49.0%,44m
11055,1,leave,2897,415,17,23,40,42.5%,17m
11055,2,马本座出狱,2897,324,12,8,20,60.0%,22m
11055,2,president,2897,292,10,7,17,58.8%,6m
11055,2,枪兵王,2897,232,9,4,13,69.2%,10m
11055,2,[C94941]唯爱晓桐,2897,173,8,6,14,57.1%,6m
11055,3,blue,2897,144,6,5,11,54.5%,1h
11055,2,老裤衩,2897,92,4,3,7,57.1%,47m
11055,1,Cloyn,2897,144,4,10,14,28.6%,11m
11055,2,[PITB]Timbayo,2897,0,3,2,5,60.0%,1h
11055,2,[普残l攻略组]星辉,2897,60,2,7,9,22.2%,8m
11055,2,[DMRc]下一秒星火,2897,0,1,0,1,100.0%,8m
11055,2,[星舰与太阳x]小小号,2897,0,1,0,1,100.0%,44m
11055,2,神的孩子在跳舞,2897,0,1,3,4,25.0%,28m
11055,2,humen,2897,0,0,1,1,0.0%,2m
11055,2,YuongMan,2897,0,0,1,1,0.0%,45m
11073,2,皮英霸,2896,1568,149,142,291,51.2%,23m
11073,1,[真理]波利,2896,775,50,49,99,50.5%,11m
11073,2,夜醉金陵,2896,677,28,21,49,57.1%,20m
11073,3,我准备好了,2896,495,26,37,63,41.3%,4m
11073,1,IIIIIIIIIIII,2896,752,25,32,57,43.9%,11m
11073,2,wdnmd,2896,444,23,18,41,56.1%,3m
11073,2,消失的迪迦,2896,519,22,15,37,59.5%,21m
11073,2,[你画我瞎]抽烟喝酒烫头,2896,438,14,14,28,50.0%,20m
11073,3,见芒,2896,342,11,23,34,32.4%,24m
11073,2,[股市何平]Hamster,2896,173,9,5,14,64.3%,47m
11073,1,Revital,2896,97,5,2,7,71.4%,1h
11073,2,[巡山小汪]无毁的湖光,2896,156,5,3,8,62.5%,8m
11073,2,[孙哥的海鲜]Airaela,2896,169,4,4,8,50.0%,47m
11073,2,橘子夏丶,2896,100,3,1,4,75.0%,12m
11073,2,Pikachu,2896,116,3,2,5,60.0%,30m
11073,2,serral,2896,0,3,2,5,60.0%,29m
11073,2,OldDriver,2896,0,2,0,2,100.0%,13m
11073,2,Filtration,2896,88,2,0,2,100.0%,12m
11073,2,[贪玩]钢铁迷途,2896,88,2,0,2,100.0%,21m
11073,1,[我们不如电脑]艾尔德兰,2896,48,2,2,4,50.0%,1h
11073,2,dcba,2896,113,2,2,4,50.0%,1h
11073,2,wcjsdb,2896,0,1,0,1,100.0%,7m
11073,1,[坎星宇航局]Proxima,2896,96,1,1,2,50.0%,1h
11073,2,[卫星点灯丶]三玖丶,2896,88,1,1,2,50.0%,44m
11073,2,[型月重工厂]Tohsaka,2896,0,0,1,1,0.0%,15m
11073,2,绿豆冰冰,2896,0,0,1,1,0.0%,27m
11073,2,[浙江大学战队]VanChow,2896,0,0,5,5,0.0%,47m
11100,1,[婬蕙涩情]lIIllIlIlIlI,2895,1500,124,120,244,50.8%,42m
11100,2,[未知生物]UNKNOWN,2895,1462,84,65,149,56.4%,19m
11100,3,[雷神在此I]万神聚力,2895,1150,43,46,89,48.3%,17m
11100,1,汝可识得此阵,2895,597,39,36,75,52.0%,16m
11100,2,Faker,2895,805,37,26,63,58.7%,20m
11100,1,Seraph,2895,840,33,32,65,50.8%,44m
11100,2,[EMAYL]REIYL,2895,472,20,16,36,55.6%,12m
11100,2,[社会]风中童年,2895,443,17,21,38,44.7%,28m
11100,1,[XXHZ4]从魔兽到星际,2895,439,15,28,43,34.9%,44m
11100,2,[BUPTNB]JInAirRouge,2895,109,14,5,19,73.7%,20m
11100,1,梧痕,2895,187,8,7,15,53.3%,1h
11100,1,llllllllllll,2895,231,7,5,12,58.3%,1h
11100,2,水域天下,2895,180,6,3,9,66.7%,30m
11100,1,[X英雄圣域X]KingCrimson,2895,48,5,3,8,62.5%,4m
11100,1,[鸡猪]我就是死肥宅啊,2895,140,5,9,14,35.7%,8m
11100,1,冷瞳,2895,48,4,4,8,50.0%,1h
11100,2,请君莫愁,2895,0,3,1,4,75.0%,12m
11100,2,[威吓一世]勇士,2895,0,3,2,5,60.0%,1h
11100,2,肥鱼,2895,88,2,0,2,100.0%,10m
11100,2,半个菜鸟,2895,88,2,0,2,100.0%,45m
11100,1,嗯嗯啊嗯,2895,48,2,2,4,50.0%,1h
11100,2,Marlboroo,2895,0,2,3,5,40.0%,1h
11100,2,[百年好合]NLNL,2895,30,1,3,4,25.0%,26m
11123,2,[逗比神教]赣南孙一峰,2894,1562,137,107,244,56.1%,42m
11123,2,llllllllllll,2894,1562,88,75,163,54.0%,45m
11123,2,skywheel,2894,657,53,38,91,58.2%,47m
11123,3,[他是个老人]IIIIIIIIIIII,2894,754,41,56,97,42.3%,27m
11123,2,LycheeFM,2894,844,37,26,63,58.7%,23m
11123,1,TNOimba,2894,694,28,32,60,46.7%,27m
11123,2,Fire,2894,629,25,22,47,53.2%,4m
11123,2,[誰与争锋]魔鬼军团风雪一笑,2894,648,24,24,48,50.0%,7m
11123,2,夜雨声烦,2894,468,19,12,31,61.3%,25m
11123,2,[mazuri]fubuki,2894,273,12,7,19,63.2%,6m
11123,2,SmallBobo,2894,193,8,2,10,80.0%,15m
11123,2,[壹玖]dalaoIIIorz,2894,226,8,7,15,53.3%,30m
11123,1,实方三三,2894,144,6,6,12,50.0%,1h
11123,1,不死战神道友明,2894,178,6,7,13,46.2%,44m
11123,2,[凤凰阁]Mars,2894,152,5,2,7,71.4%,48m
11123,1,甘大神,2894,144,4,5,9,44.4%,1h
11123,2,sunlight,2894,53,4,8,12,33.3%,46m
11123,2,[专治格种不服]devil,2894,60,3,3,6,50.0%,10m
11123,2,[时刻微笑]van,2894,36,2,0,2,100.0%,55m
11123,2,woqu,2894,102,2,1,3,66.7%,15m
11123,2,[埃蒙好可爱]跳刀躲梅肯,2894,102,2,2,4,50.0%,21m
11123,2,探鸡不是鸡,2894,0,2,3,5,40.0%,1h
11123,2,ShowTime,2894,0,1,1,2,50.0%,46m
11123,2,[红烛昏罗帐]NGFour,2894,0,1,1,2,50.0%,7m
11123,2,永远只是背影,2894,88,1,1,2,50.0%,15m
11123,2,[星际爱好者队]全靠内力,2894,0,0,1,1,0.0%,20m
11149,1,小小飞虎队一霸气,2893,1631,130,116,246,52.8%,46m
11149,2,[啾啾啾啾啾啾]二杠,2893,1288,49,48,97,50.5%,44m
11149,2,[DMRc]IIIIIIIIIII,2893,727,34,31,65,52.3%,44m
11149,2,Xnn,2893,263,16,11,27,59.3%,26m
11149,2,江海大鸟哥,2893,244,9,5,14,64.3%,20m
11149,1,爸爸回来了,2893,144,6,3,9,66.7%,13m
11149,2,YUKO,2893,100,4,3,7,57.1%,46m
11149,2,暗影铭泽想要你,2893,128,3,2,5,60.0%,23m
11149,2,新月心雨,2893,30,2,1,3,66.7%,21m
11149,2,你猜是谁,2893,0,2,1,3,66.7%,1h
11149,2,[毒奶教]KorhalNeon,2893,30,2,3,5,40.0%,7m
11149,2,[CDPR]赛博朋克,2893,0,1,0,1,100.0%,28m
11149,2,[渾元星际]llllllllllll,2893,0,1,0,1,100.0%,22m
11149,2,八级大狂风,2893,88,1,1,2,50.0%,46m
11149,2,[泉姐美如画]散步的狼,2893,0,0,5,5,0.0%,2m
11164,3,Strong,2892,1586,243,231,474,51.3%,27m
11164,3,[KPG2]胡猪猪,2892,1500,138,141,279,49.5%,17m
11164,1,[雄心挥剑笔]源稚女,2892,1068,85,73,158,53.8%,18m
11164,1,[NLYH]Akira,2892,590,72,68,140,51.4%,27m
11164,2,[Mirana]米拉娜月影,2892,890,70,55,125,56.0%,15m
11164,2,鬼狱丶魂,2892,623,33,30,63,52.4%,15m
11164,2,[Shawk]QCsweet,2892,558,21,21,42,50.0%,5m
11164,2,kanGaXX,2892,360,11,19,30,36.7%,24m
11164,2,幻想沐紫,2892,182,8,3,11,72.7%,44m
11164,2,DDP,2892,207,6,5,11,54.5%,45m
11164,2,[Encore]白给的量仔,2892,150,5,6,11,45.5%,48m
11164,2,超超超王,2892,0,4,1,5,80.0%,24m
11164,1,[GNRNG]CaptainChina,2892,167,4,9,13,30.8%,3m
11164,2,[暴雪三十二隊]iron,2892,0,1,0,1,100.0%,44m
11164,2,[空虚门下]逆羽幻翎,2892,0,1,0,1,100.0%,8m
11164,2,[Kiloli]霸双无绝,2892,0,1,2,3,33.3%,17m
11164,2,[Utada]TYTY,2892,30,1,2,3,33.3%,29m
11164,2,ailmderz,2892,30,1,3,4,25.0%,23m
11164,2,NovaAlex,2892,0,0,1,1,0.0%,42m
11164,1,DeadlyAzrael,2892,0,0,2,2,0.0%,9m
11184,2,这游戏太难了,2891,1536,130,103,233,55.8%,12m
11184,2,小春,2891,1235,98,85,183,53.6%,22m
11184,2,IIIIIIIIIIII,2891,924,39,30,69,56.5%,7m
11184,2,[养生会馆]肆谑,2891,734,35,27,62,56.5%,25m
11184,1,[钢筋铁骨]黑椒里脊,2891,1015,33,41,74,44.6%,15m
11184,3,小马挺住哦,2891,648,22,36,58,37.9%,16m
11184,1,倾红颜丶笑一心,2891,136,5,4,9,55.6%,6m
11184,2,[老家伙战队]队长,2891,150,5,6,11,45.5%,44m
11184,2,llllllllllll,2891,0,4,1,5,80.0%,1h
11184,2,Seele,2891,60,2,7,9,22.2%,47m
11184,2,[黑豹]PigletPeggy,2891,0,1,0,1,100.0%,8m
11184,2,小电视,2891,0,0,1,1,0.0%,3m
11184,2,[Cheney]情比金坚,2891,0,0,1,1,0.0%,45m
11197,2,TopOne,2890,1529,253,231,484,52.3%,44m
11197,1,[菜有菜的道理]狗头人军团,2890,1493,134,117,251,53.4%,19m
11197,2,lpww,2890,1497,82,73,155,52.9%,4m
11197,1,老年选手玩情怀,2890,407,35,33,68,51.5%,12m
11197,2,[仙女的云朵喵]樱花呀,2890,669,34,20,54,63.0%,9m
11197,2,培刚,2890,345,17,4,21,81.0%,48m
11197,1,Psyduck,2890,536,17,21,38,44.7%,10m
11197,2,mht,2890,294,10,9,19,52.6%,30m
11197,2,[萌新zd]Brain,2890,169,8,8,16,50.0%,10m
11197,2,DatE,2890,192,6,4,10,60.0%,45m
11197,2,[刺蛇互助社团]Christina,2890,148,5,8,13,38.5%,4m
11197,1,[孙哥的海鲜]Atalanta,2890,96,4,3,7,57.1%,20m
11197,2,[燃雨极梦]YZC,2890,78,4,5,9,44.4%,24m
11197,2,[落魄山]gshjyxxl,2890,124,4,6,10,40.0%,24m
11197,1,mark,2890,0,2,2,4,50.0%,16m
11197,1,[手残眼瞎弱智]大大的,2890,136,2,4,6,33.3%,27m
11197,1,[邪神文献馆]琪露诺,2890,0,1,0,1,100.0%,29m
11197,2,[DARPA]GanGsTa,2890,88,1,1,2,50.0%,27m
11197,2,潜水员先生,2890,30,1,2,3,33.3%,29m
11197,2,[我棱镜掉了]Rether,2890,0,0,1,1,0.0%,25m
11197,2,沧海之鹰,2890,0,0,1,1,0.0%,7m
11197,2,[犹豫就会白给]艾妮熙德,2890,0,0,1,1,0.0%,4m
11197,2,czh,2890,0,0,2,2,0.0%,47m
11197,2,[谁不服]逆风奔跑,2890,0,0,2,2,0.0%,20m
11221,1,[天下何平]Arbiter,2889,1592,84,78,162,51.9%,8m
11221,2,[社交学小可爱]骑摩托的北方娃儿,2889,1060,41,38,79,51.9%,4m
11221,2,zhangzongrui,2889,517,24,15,39,61.5%,15m
11221,1,[大河向东流]Grommashlee,2889,453,13,17,30,43.3%,16m
11221,2,[龍狗毒爆]IIIIIIIIIIII,2889,114,6,9,15,40.0%,46m
11221,1,宇寒,2889,145,5,3,8,62.5%,1h
11221,2,[人类防卫阵线]黑白大老鼠,2889,120,5,4,9,55.6%,46m
11221,1,篝之雾枝,2889,96,5,5,10,50.0%,16m
11221,2,LOVEzw,2889,120,5,6,11,45.5%,4m
11221,1,[马氏太极拳]MoonKesin,2889,217,5,13,18,27.8%,5m
11221,2,[专业de团队]Skadi,2889,83,4,8,12,33.3%,48m
11221,2,yqx,2889,112,3,1,4,75.0%,28m
11221,2,[生物即是正义]依卡萝娜,2889,0,1,0,1,100.0%,30m
11221,2,[梁山泊]jack,2889,0,1,1,2,50.0%,4m
11221,2,[烽夜长歌]庄毕凡,2889,0,1,1,2,50.0%,23m
11221,2,[TAmG]乱码无名,2889,30,1,2,3,33.3%,47m
11221,2,夜北凉,2889,92,1,4,5,20.0%,1h
11221,2,只是个萌新罢了,2889,0,0,1,1,0.0%,12m
11221,2,[北极光之旅]江湖郎中桥,2889,0,0,2,2,0.0%,6m
11221,1,[污萌哒吉祥物]坎德鸡儿颖梆梆,2889,0,0,2,2,0.0%,1h
11241,1,再来亿把,2888,560,57,58,115,49.6%,17m
11241,3,[UNNC]Iwahova,2888,714,39,45,84,46.4%,19m
11241,1,[BRK]IIIIIIIIIIII,2888,797,28,30,58,48.3%,19m
11241,2,小虾米,2888,322,20,17,37,54.1%,14m
11241,2,VIC,2888,341,15,9,24,62.5%,48m
11241,1,七色堇,2888,214,9,8,17,52.9%,1h
11241,2,Kim,2888,225,8,6,14,57.1%,19m
11241,2,Stman,2888,165,7,6,13,53.8%,36m
11241,2,奎子,2888,166,5,3,8,62.5%,48m
11241,2,爱喝酸奶的猞猁,2888,30,2,1,3,66.7%,20m
11241,1,承诺灬,2888,0,1,0,1,100.0%,1h
11241,1,[Bien]Battlelife,2888,0,1,1,2,50.0%,1h
11241,2,Xuan,2888,0,1,1,2,50.0%,8m
11241,2,孙焕佳的前男友,2888,30,1,2,3,33.3%,2m
11241,2,[HFH]FeniX,2888,0,0,1,1,0.0%,11m
11241,2,[白楼门]INNOVATION,2888,0,0,2,2,0.0%,46m
11241,2,郭嘉,2888,0,0,2,2,0.0%,21m
11258,3,苏钵刺尼,2887,1267,53,51,104,51.0%,28m
11258,1,[HustSC]JokerGreed,2887,1214,51,56,107,47.7%,12m
11258,3,[ZZYZSC]神秘博士,2887,1006,50,51,101,49.5%,5m
11258,3,[墨染樱]不讲武德,2887,965,42,35,77,54.5%,4m
11258,1,爱喝雪碧的灰,2887,673,34,33,67,50.7%,8m
11258,1,无限,2887,630,33,34,67,49.3%,16m
11258,2,我天依然蓝,2887,114,32,14,46,69.6%,24m
11258,2,神樂七奈,2887,457,31,14,45,68.9%,48m
11258,1,戏子,2887,540,26,29,55,47.3%,12m
11258,2,[EZ4XYY]Udonkey,2887,647,25,26,51,49.0%,20m
11258,2,半个菜鸡,2887,181,22,20,42,52.4%,4m
11258,2,虚渺,2887,161,20,18,38,52.6%,29m
11258,2,commander,2887,176,15,20,35,42.9%,4m
11258,2,[在下菜鸡一只]银河下的星辰,2887,287,13,5,18,72.2%,15m
11258,2,AXEWR,2887,294,12,8,20,60.0%,21m
11258,2,[干不过女人]英勇的小鹦鹉,2887,272,11,10,21,52.4%,11m
11258,1,Innovation,2887,234,8,4,12,66.7%,1h
11258,1,仙人抚我地中海,2887,119,5,3,8,62.5%,40m
11258,2,桎久,2887,0,4,1,5,80.0%,11m
11258,2,[DVA后援团]之我为人皇,2887,60,3,2,5,60.0%,4m
11258,2,终有弱水替沧海,2887,0,1,1,2,50.0%,24m
11258,2,[萌萌拳]狂砍镹条街,2887,30,1,2,3,33.3%,20m
11280,3,甩断手,2886,1348,211,206,417,50.6%,42m
11280,1,freemeel,2886,1095,47,49,96,49.0%,5m
11280,3,痴情总被无情伤,2886,1144,43,54,97,44.3%,19m
11280,2,[萌的一笔]惑星指揮官,2886,855,37,27,64,57.8%,8m
11280,2,[Buakaw]无名,2886,826,35,30,65,53.8%,12m
11280,2,[勇字当头]我是鸡饲料,2886,182,10,5,15,66.7%,6m
11280,1,Wesukiliye,2886,286,8,16,24,33.3%,13m
11280,3,[混元星际闪电]IIIIIIIIIIII,2886,149,7,4,11,63.6%,1h
11280,1,OBE,2886,145,7,5,12,58.3%,1h
11280,2,TAO,2886,238,7,7,14,50.0%,5m
11280,2,闪电海中做自己,2886,143,6,6,12,50.0%,10m
11280,2,SUN,2886,166,5,3,8,62.5%,28m
11280,2,[理赔难]SmallTime,2886,154,4,4,8,50.0%,21m
11280,1,看拼音写生字,2886,48,4,4,8,50.0%,1h
11280,2,[小鸡啄米]TDtudou,2886,114,4,5,9,44.4%,58m
11280,2,文轩,2886,0,3,2,5,60.0%,1h
11280,1,Ghost,2886,120,3,4,7,42.9%,1h
11280,2,萌太新,2886,114,2,2,4,50.0%,44m
11280,1,[SteEng]风子,2886,0,1,0,1,100.0%,1h
11280,2,[BXH]ConMon,2886,0,1,0,1,100.0%,10m
11280,2,OneManArmy,2886,0,1,0,1,100.0%,45m
11280,1,乌鸦坐飞机,2886,0,1,0,1,100.0%,1h
11280,2,zhusimaji,2886,0,1,1,2,50.0%,30m
11280,2,[为了地球]豆腐渣大坝,2886,0,0,1,1,0.0%,27m
11280,2,[主宰之剑]璀璨之群星之巅,2886,0,0,1,1,0.0%,4m
11305,2,MrISIS,2885,1535,66,55,121,54.5%,8m
11305,2,隔壁老猫猫,2885,664,59,48,107,55.1%,3m
11305,2,[刃末]小啊小菜逼,2885,1036,53,49,102,52.0%,8m
11305,1,沙包,2885,1101,48,44,92,52.2%,4m
11305,1,[0610]nLak,2885,1150,40,45,85,47.1%,8m
11305,3,onlyfire,2885,941,34,45,79,43.0%,45m
11305,2,一点寒芒先到,2885,231,23,19,42,54.8%,48m
11305,2,蛇皮,2885,317,15,2,17,88.2%,44m
11305,2,[绝望中闪追猎]泊地水鬼,2885,297,11,10,21,52.4%,30m
11305,2,[PKUOC]微疯侠,2885,296,11,13,24,45.8%,3m
11305,1,Arcturus,2885,288,8,15,23,34.8%,11m
11305,2,Later,2885,148,6,9,15,40.0%,30m
11305,1,[刺蛇互助社团]SpecTrum,2885,151,4,6,10,40.0%,25m
11305,2,[SK]神月只会耍杂技,2885,116,3,3,6,50.0%,10m
11305,1,[屑魔女]抱着洋葱猫不说话,2885,0,3,4,7,42.9%,20m
11305,2,[SaberM]滴滴小黑马,2885,88,3,8,11,27.3%,21m
11305,2,tovy,2885,88,2,0,2,100.0%,44m
11305,2,[Smiths]longly,2885,30,2,2,4,50.0%,11m
11305,2,MachineGun,2885,30,2,2,4,50.0%,6m
11305,2,[uta]kazene,2885,0,1,0,1,100.0%,29m
11305,2,材狼,2885,88,1,1,2,50.0%,4m
11305,2,蒙狼,2885,0,0,1,1,0.0%,23m
11327,2,骑士爱德华,2884,1548,213,185,398,53.5%,17m
11327,2,内不输,2884,854,84,63,147,57.1%,21m
11327,2,[琴筝]二次元的演绎者,2884,909,55,52,107,51.4%,22m
11327,2,[JOKER]SKTpartinG,2884,1197,54,44,98,55.1%,47m
11327,2,御剑冥夜,2884,570,23,20,43,53.5%,15m
11327,1,[训练模式电脑]八号潜艇酱,2884,269,15,12,27,55.6%,5m
11327,2,LIJI,2884,293,13,3,16,81.2%,11m
11327,3,客即至当如何,2884,273,11,13,24,45.8%,14m
11327,2,舅舅来看你了,2884,220,7,11,18,38.9%,23m
11327,2,星际停更暴雪倒闭,2884,98,4,5,9,44.4%,44m
11327,2,[Banned]我能抱你嘛,2884,0,3,2,5,60.0%,1h
11327,1,pepper,2884,96,2,0,2,100.0%,1h
11327,2,朱笔利酷,2884,0,1,1,2,50.0%,26m
11327,2,战争,2884,0,1,2,3,33.3%,5m
11327,2,cary,2884,0,0,1,1,0.0%,11m
11342,1,pornhubuser,2883,1261,79,62,141,56.0%,9m
11342,2,电竞毒瘤柯震东,2883,1042,57,47,104,54.8%,15m
11342,2,Boardwell,2883,644,56,48,104,53.8%,44m
11342,3,[Solo]SoloEmyth,2883,1129,44,54,98,44.9%,5m
11342,2,[暴雪十队]一寸灰,2883,626,28,18,46,60.9%,12m
11342,2,[最菜战队]marinelord,2883,350,12,18,30,40.0%,21m
11342,3,啊啊刻晴我干了,2883,144,6,5,11,54.5%,1h
11342,1,狂风,2883,142,6,11,17,35.3%,5m
11342,2,最弱无败,2883,160,5,3,8,62.5%,21m
11342,2,Apple,2883,88,4,6,10,40.0%,17m
11342,3,依然冷瑟,2883,122,3,1,4,75.0%,27m
11342,2,为你而写,2883,0,3,2,5,60.0%,57m
11342,2,[血小板即正义]北笙,2883,0,3,2,5,60.0%,14m
11342,2,lovexiu,2883,0,3,2,5,60.0%,47m
11342,2,阿巴瑟,2883,88,2,0,2,100.0%,10m
11342,2,少女强则少年扶墙,2883,0,1,0,1,100.0%,25m
11342,3,燕人张翼德,2883,36,1,3,4,25.0%,41m
11342,2,[CPT]混元星际门的喽啰,2883,30,1,4,5,20.0%,26m
11342,2,SuPerChargeR,2883,0,0,1,1,0.0%,10m
11342,2,雷弥尔,2883,0,0,2,2,0.0%,4m
11342,2,[珈百璃的天堂]我爱樱岛麻衣学姐,2883,0,0,2,2,0.0%,44m
11363,1,HCH,2882,1636,127,125,252,50.4%,7m
11363,2,我只会做航母,2882,1263,121,110,231,52.4%,12m
11363,2,lmhrtn,2882,1357,77,75,152,50.7%,44m
11363,3,[Timbar]我的皮肤漂亮吗,2882,1441,77,89,166,46.4%,16m
11363,1,北部之光,2882,1495,72,71,143,50.3%,16m
11363,2,Ashhhhow,2882,844,52,32,84,61.9%,21m
11363,2,marines,2882,621,39,33,72,54.2%,48m
11363,2,[宗师]小小国宝,2882,425,20,14,34,58.8%,23m
11363,2,HZT,2882,182,16,9,25,64.0%,12m
11363,2,[MFJ]captain,2882,344,15,7,22,68.2%,48m
11363,2,LanzhouLYB,2882,308,14,8,22,63.6%,25m
11363,1,[东大电竞]血色黄昏,2882,357,12,17,29,41.4%,16m
11363,2,[SiW]山的哩,2882,296,10,14,24,41.7%,19m
11363,2,Eosee,2882,0,4,1,5,80.0%,57m
11363,2,之门,2882,0,3,2,5,60.0%,12m
11363,2,面如死灰连卡拉,2882,30,3,4,7,42.9%,45m
11363,2,SOTO,2882,0,0,1,1,0.0%,44m
11363,2,[时光静寂流逝]星语梦灵,2882,0,0,1,1,0.0%,21m
11363,2,圣殿小夫,2882,0,0,2,2,0.0%,4m
11382,1,流星,2881,621,35,35,70,50.0%,9m
11382,2,神裂影,2881,716,29,26,55,52.7%,27m
11382,2,爷很持久,2881,582,24,19,43,55.8%,27m
11382,2,[又高又硬]混元星际闪电鞭,2881,347,23,18,41,56.1%,23m
11382,2,llllllllllll,2881,602,22,21,43,51.2%,48m
11382,2,howmuchsoso,2881,397,16,12,28,57.1%,10m
11382,1,INnovation,2881,454,13,25,38,34.2%,3m
11382,1,[浴火银河]Amanda,2881,271,12,15,27,44.4%,4m
11382,2,[星际争霸第一]夏夏最美,2881,312,10,9,19,52.6%,25m
11382,2,[0APM]和和,2881,256,9,16,25,36.0%,22m
11382,2,[星歌]三千,2881,167,7,2,9,77.8%,8m
11382,2,故人倾,2881,182,7,3,10,70.0%,6m
11382,3,[为高建国效命]天梯少主,2881,193,6,6,12,50.0%,12m
11382,2,星际小孩,2881,0,3,2,5,60.0%,29m
11382,2,流光,2881,30,2,1,3,66.7%,11m
11382,2,[甜软]Zilters,2881,30,2,2,4,50.0%,6m
11382,1,Flame,2881,70,2,8,10,20.0%,27m
11382,1,[Taurus]Marinethos,2881,72,2,9,11,18.2%,26m
11382,2,[成都孙一峰]我又不乱来,2881,0,0,1,1,0.0%,21m
11382,1,不太可靠的波波沙,2881,0,0,1,1,0.0%,41m
11382,2,[童话小镇]fallen,2881,0,0,3,3,0.0%,46m
11403,2,[透一下清酒]IIIIIIIII,2880,1599,139,110,249,55.8%,21m
11403,2,RTHAN,2880,1566,84,72,156,53.8%,11m
11403,2,chicken,2880,1588,75,61,136,55.1%,26m
11403,2,红色俱乐部,2880,315,39,29,68,57.4%,20m
11403,2,[DSE]月少,2880,867,34,31,65,52.3%,25m
11403,2,[卡布基诺]变态公子,2880,944,33,38,71,46.5%,46m
11403,2,[APM50]额额,2880,426,17,16,33,51.5%,45m
11403,2,zzqmm,2880,370,15,10,25,60.0%,12m
11403,2,[麻酱罐]依等红杏出墙,2880,390,14,15,29,48.3%,29m
11403,2,[HFUOT]coldjun,2880,351,13,11,24,54.2%,15m
11403,2,易影,2880,326,11,14,25,44.0%,27m
11403,2,淡雅,2880,214,8,4,12,66.7%,2m
11403,1,RESTRAIN,2880,212,7,6,13,53.8%,1h
11403,2,[Vcc]Vspring,2880,186,7,9,16,43.8%,15m
11403,2,[蠢萌的大结界]rmb,2880,153,5,3,8,62.5%,4m
11403,2,打爆阿崔,2880,116,5,4,9,55.6%,44m
11403,2,[受死吧喵星人]蒙特祖玛,2880,139,3,4,7,42.9%,10m
11403,1,咕哒子,2880,48,2,0,2,100.0%,41m
11403,3,[怜夜曲之心]残夜,2880,0,1,0,1,100.0%,23m
11403,2,[为谁而忧伤]井之外,2880,0,1,0,1,100.0%,2m
11403,2,孔子,2880,0,1,0,1,100.0%,9m
11424,3,秦时明月,2879,1252,86,66,152,56.6%,14m
11424,1,[FourG]Gemini,2879,1256,46,47,93,49.5%,5m
11424,2,[霸蛮战队]斜流泵,2879,440,19,13,32,59.4%,29m
11424,2,[吕布女团]终是温柔,2879,146,15,15,30,50.0%,20m
11424,2,KISSmm,2879,170,14,15,29,48.3%,11m
11424,2,frozenking,2879,318,13,10,23,56.5%,29m
11424,3,[熊出没注意]熊妮小妹妹,2879,254,9,2,11,81.8%,9m
11424,2,骚太阳,2879,270,9,5,14,64.3%,8m
11424,3,朕在投胎,2879,172,7,7,14,50.0%,1h
11424,1,机枪兵,2879,192,6,6,12,50.0%,44m
11424,3,飞飞神,2879,146,5,4,9,55.6%,16m
11424,3,[海石三叉戟]暗影之殇,2879,0,1,0,1,100.0%,47m
11424,2,clearlove,2879,0,1,0,1,100.0%,1h
11424,2,potatokiller,2879,30,1,2,3,33.3%,8m
11424,3,哇哦丨金色天台,2879,30,1,2,3,33.3%,11m
11424,1,[Keysu]lllllllll,2879,93,1,3,4,25.0%,51m
11424,3,血色盛宴,2879,40,1,5,6,16.7%,41m
11424,3,[LGT]忆往昔,2879,0,0,1,1,0.0%,25m
11424,3,JOKER,2879,0,0,1,1,0.0%,27m
11424,1,咱没有名气,2879,0,0,1,1,0.0%,1h
11424,2,[乳主头子]特战宿主,2879,0,0,1,1,0.0%,20m
11424,2,[天马流星狗]皇后大道东,2879,0,0,2,2,0.0%,8m
11446,2,[BOOOM]Polaris,2878,747,29,27,56,51.8%,22m
11446,2,渣渣天乐,2878,164,15,15,30,50.0%,20m
11446,3,[四叶草]People,2878,282,10,7,17,58.8%,21m
11446,2,撸啊撸大婶,2878,266,9,12,21,42.9%,2m
11446,1,喜洋洋,2878,120,7,1,8,87.5%,1h
11446,2,[NPUED]代表,2878,116,4,2,6,66.7%,4m
11446,2,[星际仓鼠海盗]红颜旧灬八荒,2878,0,3,2,5,60.0%,5m
11446,2,Warm,2878,0,3,2,5,60.0%,1h
11446,3,ISCNewLife,2878,0,1,0,1,100.0%,27m
11446,3,[暴雪二十六队]三天之内撒了你,2878,0,1,0,1,100.0%,25m
11446,1,zombie,2878,0,1,0,1,100.0%,1h
11446,2,皮神,2878,0,1,1,2,50.0%,10m
11446,2,[32CM]天然呆自然萌,2878,0,0,1,1,0.0%,29m
11446,2,[有梦想的团]旭东探女,2878,0,0,3,3,0.0%,8m
11460,3,[吞吞]我不是,2877,1562,483,474,957,50.5%,3m
11460,1,东南赌王,2877,1605,203,211,414,49.0%,16m
11460,3,[KPG2]Megatron,2877,1324,118,115,233,50.6%,13m
11460,2,TOSS,2877,1362,57,51,108,52.8%,8m
11460,3,issenven,2877,992,48,18,66,72.7%,48m
11460,2,克哈的霓虹,2877,515,22,13,35,62.9%,25m
11460,2,IIIIIIIIIIII,2877,327,12,10,22,54.5%,21m
11460,3,Marauder,2877,344,12,10,22,54.5%,47m
11460,2,[糯米丸子]黯黑音,2877,182,7,4,11,63.6%,48m
11460,3,[老油条战队]玉小凤,2877,142,7,7,14,50.0%,17m
11460,2,雷子丶,2877,186,6,3,9,66.7%,25m
11460,3,Odin,2877,214,6,9,15,40.0%,59m
11460,2,奈文摩尔,2877,0,4,2,6,66.7%,23m
11460,2,不得儿行,2877,86,4,5,9,44.4%,14m
11460,2,[野人time]Hersh,2877,122,4,6,10,40.0%,15m
11460,1,[葬魂]闫珞,2877,0,3,3,6,50.0%,1h
11460,2,wangxingyi,2877,43,2,0,2,100.0%,8m
11460,2,炒面饼,2877,0,2,2,4,50.0%,1h
11460,3,巨蟒,2877,0,1,0,1,100.0%,6m
11460,3,[三年幻想乡]魂魄妖梦,2877,0,0,1,1,0.0%,14m
11460,1,[宇宙职业战队]哈利路亚,2877,0,0,1,1,0.0%,30m
11460,2,五河琴理,2877,0,0,2,2,0.0%,11m
11460,2,[木风]xmaple,2877,0,0,2,2,0.0%,47m
11483,3,iiiiiiiiiiii,2876,130,22,35,57,38.6%,43m
11483,2,奥托总长,2876,402,19,10,29,65.5%,44m
11483,3,汪嘉伟之父,2876,442,18,14,32,56.2%,21m
11483,3,黑色之血,2876,148,6,5,11,54.5%,15m
11483,2,听凭风引,2876,116,5,4,9,55.6%,12m
11483,2,雅蠛蝶,2876,146,5,8,13,38.5%,4m
11483,3,灰色的鸟,2876,60,3,1,4,75.0%,5m
11483,1,Nautilus,2876,0,3,3,6,50.0%,1h
11483,3,[MarCim]Longly,2876,86,3,4,7,42.9%,17m
11483,3,东临碣石有遗篇,2876,30,2,0,2,100.0%,21m
11483,2,[柚子she]KSCN,2876,30,2,2,4,50.0%,7m
11483,3,zerral,2876,58,2,2,4,50.0%,46m
11483,2,[北有吾王2队]闇隐,2876,97,2,3,5,40.0%,46m
11483,1,[霸气雄图]小小呆,2876,0,2,4,6,33.3%,1h
11483,1,Makoto,2876,0,2,6,8,25.0%,1h
11483,2,Summer,2876,0,1,2,3,33.3%,25m
11483,1,小凌宇,2876,97,1,2,3,33.3%,29m
11483,2,hehe,2876,30,1,5,6,16.7%,24m
11483,1,Cocofame,2876,0,0,1,1,0.0%,13m
11502,1,[舜志满天下]蓝色空间,2875,1627,293,280,573,51.1%,26m
11502,1,[火焰雷兽]幽魂零,2875,1606,112,115,227,49.3%,28m
11502,1,astrowang,2875,566,80,77,157,51.0%,9m
11502,1,xiaojiang,2875,876,36,34,70,51.4%,44m
11502,1,想吃你的奈奈,2875,1020,36,42,78,46.2%,28m
11502,3,[神之长子]SKING,2875,374,15,11,26,57.7%,5m
11502,2,爱追忆的云,2875,346,13,11,24,54.2%,22m
11502,2,画眉,2875,256,8,8,16,50.0%,44m
11502,3,双笙,2875,200,7,6,13,53.8%,14m
11502,3,开智同学,2875,174,6,6,12,50.0%,5m
11502,2,薄暮,2875,0,4,1,5,80.0%,1h
11502,2,为了施之璇而战,2875,0,4,1,5,80.0%,1h
11502,1,白狐黎,2875,144,4,3,7,57.1%,40m
11502,2,Viva,2875,162,4,4,8,50.0%,27m
11502,2,[社交学教导]lizewen,2875,68,4,5,9,44.4%,14m
11502,1,[辣鸡游戏CF]谷子地,2875,60,4,7,11,36.4%,7m
11502,3,二零二零十月十六,2875,143,3,2,5,60.0%,7m
11502,1,[Rhusky]拾柒丨半糖去冰,2875,88,1,2,3,33.3%,1h
11502,1,SHEsyehxgd,2875,0,1,3,4,25.0%,49m
11502,2,[AgCu电池]INoVatio,2875,0,0,2,2,0.0%,30m
11522,2,[卡佛里亚]路过的汪汪汪,2874,466,47,37,84,56.0%,7m
11522,2,理想天空,2874,824,44,35,79,55.7%,48m
11522,3,Maru,2874,1094,39,55,94,41.5%,4m
11522,2,[安蠢蛋]星奈子,2874,778,35,27,62,56.5%,15m
11522,3,NSK,2874,339,15,11,26,57.7%,13m
11522,3,Untie,2874,378,15,12,27,55.6%,44m
11522,1,Leon,2874,344,10,14,24,41.7%,9m
11522,1,[SC2近卫军]路标,2874,312,9,18,27,33.3%,27m
11522,2,不拿拿,2874,148,5,9,14,35.7%,7m
11522,2,[洛水天依]灰烬使者,2874,60,3,3,6,50.0%,8m
11522,2,IIIIIIIIIII,2874,0,1,0,1,100.0%,1h
11522,1,[此用户已成仙]布拉格个,2874,0,1,1,2,50.0%,1h
11522,2,WarriorZKB,2874,0,0,3,3,0.0%,5m
11535,1,飞翔的柯基汪号,2873,1662,148,135,283,52.3%,10m
11535,3,Empire,2873,1565,131,122,253,51.8%,46m
11535,2,[哈拉秀]海尔胸弟,2873,1546,68,61,129,52.7%,46m
11535,2,暴风中的冷静,2873,971,39,34,73,53.4%,4m
11535,2,[北极光小组]七殇无言,2873,644,28,22,50,56.0%,10m
11535,2,秋天的童话,2873,588,27,23,50,54.0%,45m
11535,3,[查尔之矛]大狂风,2873,372,16,7,23,69.6%,9m
11535,2,kira,2873,286,15,16,31,48.4%,14m
11535,3,秋去春来,2873,218,9,8,17,52.9%,51m
11535,2,[都是二五仔]嘤嘤嘤,2873,264,7,10,17,41.2%,11m
11535,2,Doragiaogiao,2873,176,6,9,15,40.0%,22m
11535,1,暖人心,2873,48,4,4,8,50.0%,1h
11535,2,Luhai,2873,95,3,1,4,75.0%,1h
11535,2,CAMILLE,2873,32,2,2,4,50.0%,20m
11535,1,[天枢皎月军]银色机翼,2873,0,1,0,1,100.0%,1h
11535,3,暗影之龙,2873,0,1,0,1,100.0%,18m
11535,2,[s黑色枚瑰s]小久,2873,30,1,2,3,33.3%,21m
11535,3,[DDOS朱雀]脑细胞没了,2873,0,0,1,1,0.0%,5m
11535,3,sword,2873,0,0,1,1,0.0%,17m
11535,3,塞班岛级,2873,0,0,1,1,0.0%,2m
11535,1,TNT,2873,0,0,2,2,0.0%,19m
11556,2,人族战士,2872,1518,167,151,318,52.5%,3m
11556,3,JMXY,2872,1493,140,149,289,48.4%,18m
11556,1,Scorpio,2872,1055,91,88,179,50.8%,15m
11556,1,[糯米丸子]淡定,2872,1159,90,83,173,52.0%,27m
11556,3,思维牛,2872,617,45,45,90,50.0%,16m
11556,1,刘宏楠二蛋,2872,961,35,34,69,50.7%,44m
11556,2,[我队伍很强大]byj,2872,566,21,22,43,48.8%,44m
11556,2,二师兄,2872,382,16,11,27,59.3%,15m
11556,3,[盲人康复院]米库,2872,266,12,8,20,60.0%,26m
11556,2,[致逝去的青春]天神下凡一锤四,2872,164,5,8,13,38.5%,10m
11556,2,[无魂之鸭]mck,2872,60,3,4,7,42.9%,23m
11556,3,白狼笑靥依旧灿烂,2872,0,1,0,1,100.0%,26m
11556,3,刻晴我老婆,2872,0,1,0,1,100.0%,2m
11556,3,TNGT,2872,0,1,0,1,100.0%,23m
11556,1,修地堡都死妈,2872,0,1,0,1,100.0%,1h
11556,3,[半个菜鸟]迷一般思想的,2872,30,1,1,2,50.0%,45m
11556,2,菜鸡萌新,2872,0,1,1,2,50.0%,35m
11556,3,Dancer,2872,0,0,1,1,0.0%,14m
11574,2,[ZHKU仲恺]dadaming,2871,1271,160,148,308,51.9%,4m
11574,1,一起去坑爹,2871,1622,113,112,225,50.2%,10m
11574,2,raymond,2871,1366,109,115,224,48.7%,7m
11574,3,CHrisTo,2871,1045,44,30,74,59.5%,7m
11574,1,Leon,2871,547,21,25,46,45.7%,44m
11574,1,[KPG]狂暴的小咩羊,2871,548,17,24,41,41.5%,23m
11574,2,IIIIIIIIIIII,2871,284,14,14,28,50.0%,13m
11574,2,囹圄,2871,358,12,16,28,42.9%,2m
11574,2,小黑兽,2871,288,11,10,21,52.4%,15m
11574,1,紫夜无光,2871,142,4,3,7,57.1%,20m
11574,3,阿瑞斯神灵,2871,86,3,1,4,75.0%,19m
11574,2,[裳卿阁]涟漪之羽,2871,0,3,2,5,60.0%,1h
11574,2,静静沫儿,2871,0,1,1,2,50.0%,24m
11574,3,[江上数峰青]石膏博士,2871,0,1,4,5,20.0%,6m
11574,3,我叫王牌我马没了,2871,0,0,1,1,0.0%,16m
11589,1,slistc,2870,1545,381,373,754,50.5%,16m
11589,2,TheTVister,2870,1437,114,113,227,50.2%,15m
11589,2,[荣耀归于我主]dearxiaogao,2870,1227,52,39,91,57.1%,2m
11589,3,[憨憨成群]翔中翔,2870,1072,50,24,74,67.6%,23m
11589,2,xply,2870,646,26,19,45,57.8%,22m
11589,2,ZQJ,2870,422,18,11,29,62.1%,45m
11589,2,西住美穗,2870,395,16,10,26,61.5%,21m
11589,3,夜幕,2870,186,7,5,12,58.3%,1h
11589,3,[汝负]celestial,2870,122,6,4,10,60.0%,18m
11589,2,[NEo7]DAQAQ,2870,153,6,6,12,50.0%,5m
11589,3,愤怒的打卤面,2870,143,4,2,6,66.7%,3m
11589,2,[丶朝花夕拾]BisHop,2870,138,4,3,7,57.1%,26m
11589,2,达哥,2870,0,3,2,5,60.0%,1h
11589,2,Withouteyes,2870,0,3,2,5,60.0%,1h
11589,2,[WDNMDB]USMC,2870,90,3,7,10,30.0%,48m
11589,1,[缘来是你]玖伍贰柒,2870,0,2,4,6,33.3%,1h
11589,1,[盲人协会]jzq,2870,0,1,1,2,50.0%,58m
11589,2,bREE,2870,0,1,2,3,33.3%,4m
11589,2,[德国战车]繁华似梦惜流年,2870,94,1,3,4,25.0%,15m
11589,2,仓鼠团子,2870,0,0,1,1,0.0%,44m
11589,3,ggboy,2870,0,0,1,1,0.0%,14m
11610,3,萌受,2869,1236,87,66,153,56.9%,7m
11610,2,[KPG2]cherry,2869,1239,66,68,134,49.3%,29m
11610,1,[SC2近卫军]icerJTR,2869,1454,50,62,112,44.6%,10m
11610,2,[泰伦城说晚安]IIIIIIIII,2869,380,15,13,28,53.6%,30m
11610,3,IIIIIIIIIIII,2869,290,12,13,25,48.0%,21m
11610,2,[miku守护]JackBauer,2869,283,11,9,20,55.0%,6m
11610,1,Knight,2869,184,10,14,24,41.7%,43m
11610,1,zhdalao,2869,118,6,2,8,75.0%,4m
11610,3,征服者,2869,155,6,5,11,54.5%,21m
11610,2,hellsinG,2869,99,5,5,10,50.0%,44m
11610,2,[暴雪家族]LOL,2869,114,3,2,5,60.0%,21m
11610,2,[komada]栗悟饭与龟波功,2869,96,3,3,6,50.0%,36m
11610,3,[泰伦]张三岁先森,2869,97,2,0,2,100.0%,7m
11610,3,随时会掉线的菜鸡,2869,0,1,0,1,100.0%,28m
11610,2,一颗电竞梦想的心,2869,88,1,2,3,33.3%,42m
11610,1,你再一次,2869,48,1,3,4,25.0%,19m
11610,3,[冥狐灬]紫月,2869,0,0,1,1,0.0%,21m
11610,1,技术不够缘份来凑,2869,0,0,1,1,0.0%,13m
11628,3,tienshi,2868,1591,646,656,1302,49.6%,4m
11628,1,hulihutu,2868,1635,566,552,1118,50.6%,26m
11628,1,llllllllllll,2868,1543,145,134,279,52.0%,19m
11628,1,唐古拉斯,2868,588,95,102,197,48.2%,43m
11628,1,[萝莉控后宫王]type,2868,588,34,36,70,48.6%,43m
11628,2,GLAMDRING,2868,569,23,19,42,54.8%,46m
11628,2,电中做自己,2868,294,10,13,23,43.5%,8m
11628,2,player,2868,0,3,2,5,60.0%,29m
11628,3,咆哮的耳朵,2868,97,2,0,2,100.0%,1h
11628,1,[X英雄圣域X]tntaec,2868,0,2,2,4,50.0%,13m
11628,2,大帛帛,2868,95,2,2,4,50.0%,57m
11628,3,EIGHTCZ,2868,0,0,1,1,0.0%,5m
11628,3,全教主最强解说,2868,0,0,1,1,0.0%,7m
11628,2,[嘟嘟嘟噜]melodydei,2868,0,0,1,1,0.0%,55m
11628,2,MIER,2868,0,0,5,5,0.0%,11m
11643,3,DJJ,2867,1494,309,295,604,51.2%,17m
11643,2,llllllllllll,2867,1068,291,273,564,51.6%,7m
11643,3,[巨像吊炸天]一只仓鼠,2867,1062,127,121,248,51.2%,15m
11643,2,三水,2867,1385,82,61,143,57.3%,7m
11643,3,IIIIIIIIIII,2867,358,55,64,119,46.2%,43m
11643,2,[梦瑾空人心]光辉的晨星,2867,799,31,29,60,51.7%,2m
11643,1,[AB神教]caicai,2867,558,22,23,45,48.9%,29m
11643,1,持盾的机枪兵,2867,507,20,20,40,50.0%,28m
11643,2,[天地會分舵]戴环,2867,115,15,11,26,57.7%,30m
11643,2,sanerjiulong,2867,478,14,40,54,25.9%,25m
11643,2,恐怕很菜哦,2867,249,11,6,17,64.7%,42m
11643,2,PatchiCake,2867,261,9,8,17,52.9%,15m
11643,3,人族废了呀,2867,58,3,2,5,60.0%,26m
11643,2,Froggen,2867,130,3,4,7,42.9%,25m
11643,2,[就这就这]LimYoona,2867,88,3,5,8,37.5%,8m
11643,2,SanitRIO,2867,58,2,4,6,33.3%,25m
11643,3,[我要打11个]多吃手机身体好,2867,0,0,1,1,0.0%,28m
11643,2,娱乐至上,2867,0,0,3,3,0.0%,29m
11661,1,一手遮天,2866,1597,79,67,146,54.1%,44m
11661,3,MeGsMichael,2866,1435,62,47,109,56.9%,7m
11661,1,神族都死马,2866,1530,56,64,120,46.7%,43m
11661,3,丰哥,2866,928,37,30,67,55.2%,46m
11661,3,[稳莽偷狗谐]YYYU,2866,224,10,7,17,58.8%,1h
11661,3,[Flak18]圣刀,2866,216,8,6,14,57.1%,27m
11661,3,IGXY,2866,211,8,7,15,53.3%,1h
11661,2,无命名,2866,236,8,8,16,50.0%,18m
11661,3,Observer,2866,218,7,6,13,53.8%,3m
11661,2,[虫巢主宰]快乐十船兵,2866,152,6,7,13,46.2%,44m
11661,1,龙魂,2866,164,4,1,5,80.0%,1h
11661,3,LaVish,2866,86,3,1,4,75.0%,21m
11661,3,嗨呀,2866,70,3,3,6,50.0%,1h
11661,1,IamTonyZHOU,2866,191,3,4,7,42.9%,58m
11661,2,[0216]llfm,2866,88,3,6,9,33.3%,9m
11661,2,Boxun,2866,88,2,1,3,66.7%,14m
11661,2,超级萌新玩具,2866,30,2,3,5,40.0%,11m
11661,2,[幽灵闪现wo]llllllllllll,2866,60,2,5,7,28.6%,12m
11661,1,[SYSUer]banana,2866,0,1,0,1,100.0%,17m
11661,1,FSSF,2866,0,1,0,1,100.0%,1h
11661,3,ASTROBOY,2866,0,0,1,1,0.0%,44m
11661,3,Messy,2866,0,0,1,1,0.0%,21m
11683,2,[小仙女上线啦]超级无敌环保卫士,2865,1014,77,68,145,53.1%,23m
11683,2,[寻风]Ghost,2865,894,42,38,80,52.5%,24m
11683,2,EricPAN,2865,332,15,7,22,68.2%,8m
11683,2,[伊势大神宫]機動戦士高达,2865,165,7,2,9,77.8%,4m
11683,1,不是博士是舰长,2865,167,7,3,10,70.0%,20m
11683,2,雨下不停,2865,129,7,6,13,53.8%,13m
11683,1,[NoTK]ReFrozen,2865,240,7,16,23,30.4%,5m
11683,1,[AVG1]Easlove,2865,0,3,3,6,50.0%,1h
11683,2,[暴雪十七队]黑暗之神,2865,30,2,3,5,40.0%,8m
11683,3,[艾尔之巅]RainKing,2865,0,1,0,1,100.0%,26m
11683,3,五里店保罗,2865,0,1,0,1,100.0%,16m
11683,3,萌萌哒的傻黄丶,2865,30,1,1,2,50.0%,15m
11683,2,[苍狼]未若柳絮因风起,2865,30,1,5,6,16.7%,30m
11683,3,[星歌]妄言,2865,0,0,1,1,0.0%,12m
11697,3,新鲜土豆丝,2864,1490,186,170,356,52.2%,43m
11697,2,[堂口好兄弟]wjzzb,2864,1611,93,85,178,52.2%,21m
11697,1,[Rhusky]viva,2864,325,38,24,62,61.3%,43m
11697,2,CARL,2864,687,27,23,50,54.0%,4m
11697,2,风在听我诉说,2864,305,11,11,22,50.0%,19m
11697,3,[暗黑执政官]魏氏天下,2864,262,9,2,11,81.8%,1h
11697,2,[尼古拉茹科]AdnyMinor,2864,238,9,11,20,45.0%,2m
11697,3,[进击花园宝宝]依古比古,2864,210,7,5,12,58.3%,34m
11697,3,[东方黄粱梦]射命丸文,2864,137,5,6,11,45.5%,8m
11697,2,烦味丶凌驰,2864,46,4,3,7,57.1%,1h
11697,2,[零度星际]韦氏银行,2864,90,4,5,9,44.4%,2m
11697,2,爱吃宵夜,2864,140,3,4,7,42.9%,1h
11697,3,Uranus,2864,30,1,1,2,50.0%,25m
11697,2,GkSongHot,2864,30,1,5,6,16.7%,44m
11697,3,SSSS,2864,0,0,1,1,0.0%,9m
11697,3,少奕丶,2864,0,0,1,1,0.0%,16m
11697,3,勇者小明,2864,0,0,1,1,0.0%,23m
11697,2,[YT]萌妹玩星际,2864,0,0,6,6,0.0%,8m
11715,2,Devil,2863,1438,64,56,120,53.3%,4m
11715,2,[化学工厂]呼叫舰队,2863,1094,55,48,103,53.4%,45m
11715,2,[艾尔之巅]huazhu,2863,1163,55,55,110,50.0%,5m
11715,2,untreBOSS,2863,449,42,40,82,51.2%,44m
11715,3,poundis,2863,122,5,5,10,50.0%,21m
11715,2,[艾尔动漫协会]南风,2863,179,5,5,10,50.0%,26m
11715,2,谶言,2863,196,5,7,12,41.7%,19m
11715,1,DJNeric,2863,48,3,3,6,50.0%,1h
11715,2,[中华讲武堂]到发上,2863,136,3,4,7,42.9%,27m
11715,2,[无影丶神]迪斯洛克,2863,30,2,5,7,28.6%,48m
11715,3,索特菲斯,2863,0,1,0,1,100.0%,21m
11715,3,CRINO,2863,0,1,0,1,100.0%,12m
11715,3,XBbrain,2863,0,1,0,1,100.0%,26m
11715,2,小菜鸟,2863,0,1,1,2,50.0%,22m
11715,2,[宣书赏月]毫挥御桌上宣,2863,30,1,4,5,20.0%,13m
11715,2,妖妖灵,2863,0,0,2,2,0.0%,1m
11715,2,IIIIlIlIlIlI,2863,0,0,2,2,0.0%,58m
11732,3,[桥桥奇妙星际]我不做人了,2862,1237,130,128,258,50.4%,5m
11732,2,IIIIIIIIIIII,2862,1561,80,78,158,50.6%,8m
11732,2,周先丶森,2862,1218,71,59,130,54.6%,42m
11732,1,钢铁战士老八,2862,538,23,22,45,51.1%,8m
11732,1,tnt,2862,624,23,26,49,46.9%,19m
11732,2,绚丽火花,2862,528,19,17,36,52.8%,4m
11732,1,[灰冥]赤瞳是我老婆,2862,475,17,19,36,47.2%,12m
11732,1,[四叶草]白兔,2862,526,17,26,43,39.5%,19m
11732,3,梦断成空,2862,368,16,9,25,64.0%,17m
11732,1,[Holyam]solves,2862,480,14,21,35,40.0%,4m
11732,2,[萌的一笔]萌萌哒的小糕菌,2862,304,13,7,20,65.0%,2m
11732,3,FrAlive,2862,340,12,13,25,48.0%,12m
11732,3,沫沫丶,2862,228,9,6,15,60.0%,5m
11732,3,wwwasuscom,2862,196,9,6,15,60.0%,25m
11732,2,[哔翻天梯鸡]sadsnow,2862,49,5,6,11,45.5%,20m
11732,2,flcl,2862,0,4,1,5,80.0%,1h
11732,3,九阴争茎,2862,0,1,0,1,100.0%,6m
11732,3,内马尔,2862,0,1,0,1,100.0%,22m
11732,1,暗之锋芒,2862,0,1,0,1,100.0%,36m
11732,3,state,2862,0,1,0,1,100.0%,26m
11732,2,destiny,2862,0,1,1,2,50.0%,11m
11732,3,smurfs,2862,0,0,1,1,0.0%,14m
11754,2,estaryin,2861,913,101,97,198,51.0%,2m
11754,2,月下彼岸花,2861,658,88,78,166,53.0%,48m
11754,1,孙一喵喵,2861,1045,78,62,140,55.7%,44m
11754,1,不如怀念,2861,673,36,39,75,48.0%,17m
11754,2,[暴雪线上实测]星际争霸平衡组,2861,764,30,25,55,54.5%,3m
11754,3,[FFJ]简则美,2861,476,21,16,37,56.8%,3m
11754,3,节奏逝如风,2861,261,11,4,15,73.3%,7m
11754,2,[征服一切]ghjfghfh,2861,174,5,3,8,62.5%,22m
11754,2,JinAirMaru,2861,188,5,6,11,45.5%,42m
11754,2,普朗克叔叔,2861,112,4,5,9,44.4%,12m
11754,3,Demon,2861,172,4,7,11,36.4%,23m
11754,2,加里罗,2861,116,3,3,6,50.0%,22m
11754,3,SYQ,2861,0,1,0,1,100.0%,27m
11754,3,MagicLAN,2861,0,1,0,1,100.0%,46m
11754,3,余生,2861,0,1,0,1,100.0%,5m
11754,3,封逸琎,2861,0,1,0,1,100.0%,21m
11754,2,[tiandi]半丶丶梦,2861,0,1,1,2,50.0%,15m
11754,3,Mrz,2861,0,0,1,1,0.0%,47m
11754,3,MARU,2861,0,0,1,1,0.0%,25m
11754,1,GoldenPants,2861,0,0,2,2,0.0%,41m
11774,3,Zealotgogogo,2860,1590,318,310,628,50.6%,29m
11774,2,[小鸡子娃]Leovain,2860,1383,75,68,143,52.4%,11m
11774,1,回来,2860,885,56,52,108,51.9%,29m
11774,2,[Anticw]ShangRen,2860,544,20,24,44,45.5%,44m
11774,3,frankchen,2860,470,18,16,34,52.9%,12m
11774,3,[暴雪三队]走位丶靠扭,2860,340,15,7,22,68.2%,16m
11774,2,[雾雨魔法森林]我家猫想你,2860,240,9,9,18,50.0%,44m
11774,2,敌羞吾去脱他衣,2860,192,8,7,15,53.3%,45m
11774,3,mzy,2860,194,7,6,13,53.8%,17m
11774,2,[舰队行驶中]熊仔钟意菠萝包,2860,140,6,5,11,54.5%,11m
11774,3,小兵一号,2860,165,6,6,12,50.0%,1m
11774,3,洛丹伦的夜,2860,121,4,8,12,33.3%,1h
11774,3,[综合酯法]人人有功练,2860,60,3,2,5,60.0%,20m
11774,2,[老兄弟联盟]斯大林,2860,0,3,2,5,60.0%,12m
11774,3,王者,2860,117,3,5,8,37.5%,44m
11774,2,陨星,2860,60,3,6,9,33.3%,11m
11774,3,[黑长直赛高]霞之丘诗羽,2860,30,2,1,3,66.7%,10m
11774,3,天凉好个秋,2860,0,1,0,1,100.0%,48m
11774,2,Angst,2860,0,1,1,2,50.0%,22m
11774,3,[神子]Mmc,2860,0,1,2,3,33.3%,1h
11774,2,CFH,2860,30,1,6,7,14.3%,18m
11774,2,[圆环之理教会]超高校级的圆学家,2860,0,0,1,1,0.0%,16m
11774,3,mediator,2860,0,0,1,1,0.0%,46m
11774,1,[谁都打不赢]旅游者,2860,0,0,1,1,0.0%,4m
11774,3,萝卜是酸的,2860,0,0,1,1,0.0%,3m
11774,2,张打斯裤子,2860,0,0,1,1,0.0%,1h
11774,2,[等打完仗娶你]卡尔达利斯,2860,0,0,4,4,0.0%,4m
11774,2,黄昏之后,2860,0,0,4,4,0.0%,45m
11802,2,tao,2859,1597,125,122,247,50.6%,19m
11802,2,[疯月]缘生梦,2859,982,53,44,97,54.6%,29m
11802,2,行测申论一百六,2859,852,33,28,61,54.1%,22m
11802,3,贪吃蛇酱,2859,421,17,14,31,54.8%,27m
11802,2,ForeverMXX,2859,441,16,18,34,47.1%,21m
11802,3,走位靠扭丶,2859,388,13,9,22,59.1%,10m
11802,2,灭蟑螂大队,2859,258,11,5,16,68.8%,1m
11802,1,九尾妖狐,2859,207,8,7,15,53.3%,10m
11802,3,[察哈尔路县中]Quin,2859,198,7,3,10,70.0%,6m
11802,3,[北方栖姬]逗紫,2859,188,6,4,10,60.0%,1h
11802,3,你才到碗里去,2859,78,3,4,7,42.9%,21m
11802,2,[loveMM]IIIIIIIIIIII,2859,38,2,1,3,66.7%,8m
11802,2,[铃仙二号]望月,2859,0,2,2,4,50.0%,57m
11802,3,冰霜雪狼,2859,0,1,0,1,100.0%,21m
11802,3,神圣的谎言,2859,0,1,0,1,100.0%,15m
11802,3,[整个活]蒙斯克,2859,0,1,0,1,100.0%,26m
11802,1,拿波里贵族,2859,0,1,0,1,100.0%,4m
11802,2,[Rhusky]阿尔茨海默综合征,2859,0,1,2,3,33.3%,15m
11802,3,最爱打气球,2859,0,0,1,1,0.0%,6m
11802,2,混元星际编外门徒,2859,0,0,2,2,0.0%,26m
11802,3,[Shawk]Michelangelo,2859,0,0,8,8,0.0%,5m
11823,2,WillBin,2858,333,36,27,63,57.1%,6m
11823,3,萌新小白,2858,646,35,24,59,59.3%,12m
11823,1,不快乐吗,2858,891,34,35,69,49.3%,42m
11823,1,[周婉馨]馨儿,2858,191,22,28,50,44.0%,42m
11823,2,害怕,2858,445,19,17,36,52.8%,12m
11823,2,航母出击,2858,180,9,6,15,60.0%,6m
11823,3,Python,2858,136,7,7,14,50.0%,45m
11823,1,玩家离开了游戏,2858,198,7,11,18,38.9%,44m
11823,2,[l死亡议会l]塔达林逼格第一人,2858,141,5,3,8,62.5%,26m
11823,3,王大剩,2858,88,4,2,6,66.7%,5m
11823,2,[恶劣玩家]渣渣,2858,87,4,2,6,66.7%,1h
11823,2,[Sfae]月神,2858,94,3,6,9,33.3%,15m
11823,3,咕噜嘎啦叫,2858,0,1,0,1,100.0%,23m
11823,1,[上海大学]夏至泡泡,2858,96,1,1,2,50.0%,19m
11823,2,[头铁认真的]MISS,2858,0,1,1,2,50.0%,27m
11823,3,[弥生]就系甘犀利,2858,30,1,1,2,50.0%,14m
11823,2,[ImPa丶]MacSed,2858,0,1,1,2,50.0%,46m
11823,2,faiz,2858,0,1,2,3,33.3%,4m
11823,1,[SC2近卫军]蓝暴暴,2858,0,0,2,2,0.0%,1h
11823,2,FNCArslan,2858,0,0,6,6,0.0%,25m
11843,1,但求自在,2857,1621,226,217,443,51.0%,26m
11843,2,[Ago]泰伦人民,2857,1554,151,138,289,52.2%,45m
11843,1,kniless,2857,959,54,43,97,55.7%,5m
11843,3,[一块晶化瓦斯]IIIIIIIIIIII,2857,1134,50,31,81,61.7%,4m
11843,1,saber,2857,970,43,40,83,51.8%,17m
11843,1,SKT,2857,648,31,31,62,50.0%,28m
11843,3,七重人格,2857,416,15,13,28,53.6%,15m
11843,2,[艾尔之名]螂艮,2857,337,15,13,28,53.6%,48m
11843,1,knk,2857,452,14,25,39,35.9%,5m
11843,3,波波,2857,170,8,7,15,53.3%,35m
11843,3,jim,2857,176,6,3,9,66.7%,13m
11843,1,[3BPYJY]易帝微微一笑,2857,100,4,10,14,28.6%,16m
11843,3,ACE,2857,152,3,2,5,60.0%,27m
11843,2,恺撒色拉,2857,0,3,2,5,60.0%,1h
11843,3,深入浅出,2857,86,3,2,5,60.0%,12m
11843,3,[底特律KAR]辽东王越,2857,60,2,3,5,40.0%,5m
11843,1,雪碧,2857,0,1,0,1,100.0%,49m
11843,2,喜欢轻井泽惠,2857,30,1,3,4,25.0%,23m
11843,2,[皮肤英雄没啦]打条跨,2857,12,1,5,6,16.7%,1m
11843,3,sakura,2857,0,0,2,2,0.0%,5m
11863,2,jimmilos,2856,1052,57,76,133,42.9%,47m
11863,2,我爱吃番茄,2856,487,21,19,40,52.5%,44m
11863,2,[百战百败]诛文丑,2856,472,18,16,34,52.9%,29m
11863,1,[老油条死全家]我是彩笔别杀我,2856,245,12,12,24,50.0%,5m
11863,1,三缸,2856,274,11,11,22,50.0%,1h
11863,3,TKTIM,2856,86,3,2,5,60.0%,26m
11863,2,苍穹,2856,0,3,2,5,60.0%,1h
11863,1,Jac,2856,0,3,3,6,50.0%,49m
11863,3,shen,2856,0,1,0,1,100.0%,6m
11863,3,zxapdh,2856,0,1,1,2,50.0%,5m
11863,3,[EG丶]Galaxy,2856,0,0,1,1,0.0%,46m
11863,3,浅夏彡,2856,0,0,1,1,0.0%,44m
11875,2,[芜湖难铜]dragonx,2855,1441,119,117,236,50.4%,1m
11875,2,狗骑士,2855,738,29,24,53,54.7%,23m
11875,3,[霸气]solo,2855,477,21,39,60,35.0%,15m
11875,2,枪兵的命也是命,2855,388,14,13,27,51.9%,18m
11875,2,[孤傲就完事]Novhope,2855,300,11,12,23,47.8%,16m
11875,3,[幻海奇妙夜]欧根欧根欧,2855,345,11,13,24,45.8%,28m
11875,3,Fresh,2855,114,5,2,7,71.4%,10m
11875,2,qiangtage,2855,0,4,1,5,80.0%,1h
11875,2,Entarotasada,2855,130,4,3,7,57.1%,21m
11875,1,Mruglyy,2855,152,4,13,17,23.5%,23m
11875,2,showmoney,2855,0,3,2,5,60.0%,13m
11875,3,郝亦腾,2855,30,2,1,3,66.7%,48m
11875,3,[本子画师]AHESL,2855,0,2,2,4,50.0%,5m
11875,2,不解释心,2855,0,2,3,5,40.0%,1h
11875,1,[半个菜鸟]无畏舰长,2855,74,2,10,12,16.7%,5m
11875,2,摸鱼真的好爽啊,2855,0,1,1,2,50.0%,33m
11891,2,潮鸣,2854,646,226,214,440,51.4%,1m
11891,1,狂野男孩苏大强,2854,1616,129,116,245,52.7%,19m
11891,2,杰森,2854,1144,43,46,89,48.3%,29m
11891,2,[逐梦之影]山顶上听歌,2854,302,11,14,25,44.0%,15m
11891,3,战姬,2854,273,10,3,13,76.9%,6m
11891,2,[华夏远征军]zeratul,2854,264,10,11,21,47.6%,22m
11891,2,[红烛昏罗帐]貳拾肆,2854,178,8,6,14,57.1%,1m
11891,1,ahgjiw,2854,201,8,9,17,47.1%,37m
11891,1,巴御前超可爱,2854,137,4,0,4,100.0%,1h
11891,2,[killer]bent,2854,130,4,3,7,57.1%,26m
11891,2,酸澄,2854,46,2,0,2,100.0%,45m
11891,3,[黄金舰队vs]kjguyt,2854,18,2,2,4,50.0%,21m
11891,2,ULTRATE,2854,46,2,3,5,40.0%,23m
11891,3,snowsforever,2854,0,1,0,1,100.0%,4m
11891,3,hfh,2854,44,1,5,6,16.7%,1h
11891,3,VashMX,2854,0,0,1,1,0.0%,23m
11891,3,STEVEN,2854,0,0,1,1,0.0%,11m
11891,3,DESERVE,2854,0,0,1,1,0.0%,25m
11891,2,生锈的兔斯基,2854,0,0,1,1,0.0%,44m
11910,2,疯子帅帅,2853,1219,77,63,140,55.0%,14m
11910,1,[泰伦斧头帮]scboyfaren,2853,1103,76,74,150,50.7%,9m
11910,2,桃浦黄旭东,2853,731,60,61,121,49.6%,44m
11910,1,[DSE]不高兴,2853,1348,60,64,124,48.4%,27m
11910,2,[超神给你看哦]玩人族母亲必出事,2853,589,27,21,48,56.2%,25m
11910,3,[H2]孤影残月望春水,2853,602,21,33,54,38.9%,18m
11910,1,刀口辣椒,2853,378,15,14,29,51.7%,13m
11910,2,dimer,2853,247,11,13,24,45.8%,11m
11910,3,OSO,2853,276,10,3,13,76.9%,14m
11910,3,好名字被狗起了,2853,229,10,7,17,58.8%,7m
11910,3,机械烈海王,2853,209,7,0,7,100.0%,10m
11910,3,快乐粪坑,2853,199,6,3,9,66.7%,8m
11910,2,[只想干神族]尼玛花园,2853,161,5,2,7,71.4%,49m
11910,1,[幽金贮藏堆]blackjiuye,2853,144,3,3,6,50.0%,1h
11910,2,让麻酱同化神族吧,2853,90,3,6,9,33.3%,13m
11910,3,seamehello,2853,30,2,0,2,100.0%,4m
11910,2,噬心人,2853,0,2,1,3,66.7%,55m
11910,3,Gentleman,2853,30,1,1,2,50.0%,7m
11910,2,AVE,2853,0,1,1,2,50.0%,1h
11910,2,[DDOS暴雪]只是恋恋风尘,2853,88,1,3,4,25.0%,15m
11910,2,传说哥,2853,0,0,5,5,0.0%,5m
11931,3,我爱黄哥,2852,1577,169,138,307,55.0%,4m
11931,3,Zeczery,2852,1359,73,57,130,56.2%,2m
11931,2,ghost,2852,1380,55,50,105,52.4%,20m
11931,3,[多个老年人]蛋中如治麟,2852,812,43,26,69,62.3%,28m
11931,2,[查尔之矛]宸星逸皓,2852,695,25,31,56,44.6%,18m
11931,3,尼彼梅勒,2852,364,14,12,26,53.8%,10m
11931,2,[杀媽冲锋队]戮默,2852,329,13,14,27,48.1%,20m
11931,3,IIIIIIIIIIII,2852,354,12,8,20,60.0%,28m
11931,2,[2对2大师]我本纯洁,2852,308,11,9,20,55.0%,44m
11931,2,战三坑,2852,305,10,14,24,41.7%,27m
11931,1,野猫,2852,238,7,15,22,31.8%,20m
11931,2,[小鸡屠宰场b]水木阳羽,2852,160,6,4,10,60.0%,4m
11931,2,Zincye,2852,99,6,7,13,46.2%,48m
11931,2,Jack,2852,137,4,2,6,66.7%,16m
11931,2,来自安徽的星际,2852,36,3,5,8,37.5%,21m
11931,2,GhostWolves,2852,90,3,8,11,27.3%,7m
11931,3,AuToLoSs,2852,30,2,1,3,66.7%,14m
11931,3,赵小墨,2852,0,1,0,1,100.0%,47m
11931,3,Ropivacaine,2852,0,1,0,1,100.0%,16m
11931,3,[西伯利亚土豆]乖乖站好,2852,30,1,1,2,50.0%,27m
11931,1,[核聚变打鸡]我是条码人,2852,0,1,2,3,33.3%,4m
11931,3,[超级哈皮]无可取代,2852,0,0,1,1,0.0%,23m
11953,1,芬里厄,2851,1445,133,152,285,46.7%,43m
11953,2,[神樂七奈ol]阳菜,2851,1284,52,52,104,50.0%,45m
11953,3,羊儿,2851,866,37,30,67,55.2%,21m
11953,3,[91二五仔]轰鸣之翼,2851,866,32,31,63,50.8%,21m
11953,3,[反黑行动组]阿尔萨斯,2851,251,10,1,11,90.9%,5m
11953,2,大脚盆,2851,218,8,6,14,57.1%,23m
11953,2,Ayumu,2851,58,3,4,7,42.9%,2m
11953,3,[中华讲武堂]SWeetKK,2851,88,3,5,8,37.5%,26m
11953,2,IIIIIIIIIIII,2851,88,2,2,4,50.0%,44m
11953,2,艾尔大停电,2851,0,2,2,4,50.0%,11m
11953,2,永远单推星街彗星,2851,0,2,3,5,40.0%,1h
11953,2,Rumor,2851,58,2,4,6,33.3%,12m
11953,2,[Shawk]房子轩,2851,0,1,0,1,100.0%,44m
11953,3,llllllllllll,2851,30,1,1,2,50.0%,26m
11953,3,鬼手速神走位,2851,0,1,1,2,50.0%,22m
11953,3,牙疼快吃糖,2851,30,1,2,3,33.3%,17m
11953,3,炮灰,2851,0,0,1,1,0.0%,11m
11953,3,[戴德给拇]禅璃子单推夏色祭,2851,0,0,1,1,0.0%,26m
11953,3,米兰达,2851,0,0,1,1,0.0%,17m
11972,1,RedstonePowe,2850,1519,252,243,495,50.9%,28m
11972,2,无敌中长大,2850,1562,168,163,331,50.8%,42m
11972,2,[超电磁炉]今朝梦初情,2850,886,60,53,113,53.1%,22m
11972,1,Agrush,2850,1102,44,48,92,47.8%,11m
11972,3,[最菜战队]流川楓,2850,463,20,16,36,55.6%,17m
11972,2,云雨浩瀚,2850,318,10,14,24,41.7%,11m
11972,3,淡淡的忧伤,2850,256,9,7,16,56.2%,1h
11972,1,GHS,2850,176,5,3,8,62.5%,1h
11972,1,[生物即是正义]超级兵,2850,119,4,4,8,50.0%,26m
11972,1,[FDG后援团]王叭,2850,116,3,0,3,100.0%,2m
11972,3,[乱世]傍晚的一抹夕阳,2850,92,3,2,5,60.0%,4m
11972,2,干神是我大哥,2850,0,3,3,6,50.0%,2m
11972,2,淡定未遂,2850,138,3,3,6,50.0%,6m
11972,1,control,2850,95,2,5,7,28.6%,42m
11972,2,Guang,2850,0,1,0,1,100.0%,1h
11972,3,黑暗森林,2850,0,1,0,1,100.0%,26m
11972,3,[合作研究所]Supernova,2850,0,1,1,2,50.0%,26m
11972,3,就是喜欢小包纸,2850,30,1,1,2,50.0%,28m
11972,2,暗影猎手,2850,0,1,2,3,33.3%,48m
11972,3,yytc,2850,30,1,2,3,33.3%,10m
11972,2,蜂之骑士,2850,30,1,4,5,20.0%,24m
11972,3,IIIIIIIIIIII,2850,0,0,1,1,0.0%,21m
11972,3,毛蛋,2850,0,0,1,1,0.0%,22m
11972,3,卡比丶,2850,0,0,1,1,0.0%,14m
11972,3,wyy,2850,0,0,2,2,0.0%,27m
11972,3,哇啦哇啦,2850,0,0,2,2,0.0%,22m
11998,3,小坏,2849,1224,69,63,132,52.3%,15m
11998,3,星辰,2849,434,17,13,30,56.7%,16m
11998,2,[不会散枪兵丶]丨音乐丶,2849,351,13,12,25,52.0%,11m
11998,2,[Sc老年组]哀之翼,2849,110,10,2,12,83.3%,48m
11998,3,littlebin,2849,270,10,3,13,76.9%,7m
11998,2,[闪电伍连鞭]奶茶壶,2849,102,3,3,6,50.0%,29m
11998,2,KampferWXY,2849,62,3,4,7,42.9%,11m
11998,3,bigbrother,2849,30,2,1,3,66.7%,26m
11998,2,逍遥兽,2849,95,2,4,6,33.3%,13m
11998,3,Astralzero,2849,0,1,0,1,100.0%,17m
11998,3,DonaldTrump,2849,0,1,0,1,100.0%,18m
11998,3,neo,2849,30,1,1,2,50.0%,25m
11998,3,[龙帝星云]巴巴罗萨,2849,0,0,1,1,0.0%,17m
11998,3,sdy,2849,0,0,1,1,0.0%,26m
11998,2,zeratul,2849,0,0,1,1,0.0%,1h
11998,2,不过一建不打星际,2849,0,0,4,4,0.0%,7m
12014,3,[虚数空间]校服婚纱都是摩擦,2848,1545,197,203,400,49.2%,26m
12014,1,[一心人人黄]粗心超人,2848,1523,167,160,327,51.1%,13m
12014,1,zhjs,2848,1034,72,71,143,50.3%,27m
12014,3,永恒大空,2848,1218,50,40,90,55.6%,44m
12014,3,[海德单推协会]Eureka,2848,791,44,37,81,54.3%,26m
12014,1,holylee,2848,804,28,34,62,45.2%,11m
12014,2,[艾尔之巅]我是余威我怕谁,2848,466,19,15,34,55.9%,48m
12014,1,asukafan,2848,547,19,22,41,46.3%,44m
12014,3,寂风,2848,376,13,8,21,61.9%,23m
12014,2,[SCJWJ3]Stormrage,2848,214,7,14,21,33.3%,9m
12014,3,Neversaygg,2848,114,4,1,5,80.0%,20m
12014,1,Prophet,2848,48,4,5,9,44.4%,51m
12014,3,乱丶舞,2848,58,3,2,5,60.0%,5m
12014,3,[呵中国城管]NIGHT,2848,127,2,5,7,28.6%,17m
12014,3,佐佐木丶,2848,30,1,1,2,50.0%,23m
12014,1,[野生无公害]YePriest,2848,0,1,2,3,33.3%,18m
12014,2,fqfq,2848,0,1,3,4,25.0%,1h
12014,2,[天妒嘤才]小黑棒棒哒,2848,30,1,4,5,20.0%,44m
12014,3,dafeiji,2848,0,0,1,1,0.0%,21m
12014,3,番茄炒西红柿,2848,0,0,2,2,0.0%,14m
12034,3,CaOiNGeR,2847,1372,237,230,467,50.7%,45m
12034,2,[暴雪零队]blyatman,2847,1357,118,95,213,55.4%,29m
12034,3,舞空,2847,1421,87,99,186,46.8%,25m
12034,1,caote,2847,1386,53,55,108,49.1%,10m
12034,2,你需要哲学,2847,1261,49,45,94,52.1%,15m
12034,2,realcola,2847,287,39,40,79,49.4%,6m
12034,3,[珍珠奶茶]长草的田,2847,753,30,22,52,57.7%,20m
12034,3,[M8]好兄弟无穷无尽,2847,711,29,21,50,58.0%,10m
12034,2,Prophet,2847,696,26,26,52,50.0%,47m
12034,1,起个名字真难,2847,322,23,29,52,44.2%,43m
12034,2,[女子独立团]呆萌的蠢白,2847,203,8,6,14,57.1%,48m
12034,2,[出兵大战萌新]LuoYao,2847,191,7,8,15,46.7%,59m
12034,1,[失恋阵线联盟]张国荣,2847,185,5,4,9,55.6%,31m
12034,2,[我菜请打队友]星际真霸,2847,188,5,8,13,38.5%,12m
12034,2,kingyh,2847,136,4,3,7,57.1%,22m
12034,1,[艦Colle]岛村卯月,2847,143,3,2,5,60.0%,36m
12034,2,TheGodOfDeat,2847,0,3,2,5,60.0%,1h
12034,3,[萝莉球]浮生若梦,2847,60,3,3,6,50.0%,6m
12034,3,火车,2847,30,2,1,3,66.7%,2m
12034,2,月亮邮寄员,2847,30,2,4,6,33.3%,47m
12034,2,[光头大魔王M]BornofFoer,2847,0,1,0,1,100.0%,29m
12034,2,[XIV]零食吃吗,2847,0,0,1,1,0.0%,1h
12034,3,[星星星]COLDFLAME,2847,0,0,1,1,0.0%,26m
12034,2,[XXHZ1]上条当麻,2847,0,0,1,1,0.0%,16m
12058,3,[企鹅]手术刀,2846,1506,72,66,138,52.2%,15m
12058,3,youai,2846,700,54,56,110,49.1%,11m
12058,2,[风雪]战争之影,2846,806,37,36,73,50.7%,7m
12058,2,LastTerran,2846,483,20,25,45,44.4%,11m
12058,2,cccc,2846,305,13,13,26,50.0%,42m
12058,2,akash,2846,344,11,8,19,57.9%,1h
12058,1,常威,2846,0,3,3,6,50.0%,40m
12058,3,LnJoYation,2846,0,1,0,1,100.0%,17m
12058,3,名字无所谓的好么,2846,30,1,1,2,50.0%,6m
12058,3,wingswind,2846,0,1,1,2,50.0%,46m
12058,3,幽灵,2846,0,0,1,1,0.0%,48m
12058,3,[leepay]为了达拉然,2846,0,0,1,1,0.0%,17m
12058,3,越今朝,2846,0,0,1,1,0.0%,46m
12071,1,[XXHZ16]real,2845,1545,164,155,319,51.4%,19m
12071,2,dwas,2845,1247,58,44,102,56.9%,21m
12071,3,权威,2845,1373,56,51,107,52.3%,46m
12071,2,[32CM]哼很难过,2845,482,26,20,46,56.5%,4m
12071,2,青春不回头,2845,305,24,27,51,47.1%,3m
12071,1,[愛可乐]LUFFY,2845,320,20,20,40,50.0%,13m
12071,3,Redfire,2845,392,15,14,29,51.7%,26m
12071,2,[SCL]小辉,2845,378,14,13,27,51.9%,45m
12071,2,有丝,2845,304,14,18,32,43.8%,7m
12071,3,[NOFUN]POWER,2845,222,9,4,13,69.2%,18m
12071,3,欧姆尼塞亚,2845,141,4,0,4,100.0%,47m
12071,3,[C97604]春夏秋董丶,2845,86,3,1,4,75.0%,5m
12071,3,科普卢不二烧烤店,2845,86,3,2,5,60.0%,26m
12071,2,墨匪,2845,0,2,3,5,40.0%,1h
12071,3,[校园谐恶势力]yyymgg,2845,0,1,0,1,100.0%,28m
12071,3,[相爱一家亲]深邃蔚蓝,2845,0,1,0,1,100.0%,4m
12071,3,菜鸟,2845,0,1,0,1,100.0%,16m
12071,3,llllllllllll,2845,0,1,0,1,100.0%,6m
12071,1,棺材里的森森,2845,0,1,0,1,100.0%,1h
12071,3,[Holydr]残风,2845,30,1,3,4,25.0%,28m
12071,2,[月之所在RI]AWM,2845,0,1,3,4,25.0%,9m
12071,3,大江千里,2845,0,0,2,2,0.0%,4m
12071,3,Historia,2845,0,0,8,8,0.0%,46m
12094,1,金装大洋根,2844,1114,144,126,270,53.3%,29m
12094,2,骷髅射手,2844,1115,112,102,214,52.3%,44m
12094,2,Sinaean,2844,1352,79,67,146,54.1%,27m
12094,1,MagicTerran,2844,1410,59,50,109,54.1%,26m
12094,3,zachariah,2844,890,53,43,96,55.2%,19m
12094,1,[NUC]IIIIIIIIIIII,2844,1142,45,44,89,50.6%,9m
12094,3,[星际旅游团]saligia,2844,572,21,19,40,52.5%,22m
12094,2,SJONE,2844,401,16,13,29,55.2%,9m
12094,2,Neuron,2844,370,13,14,27,48.1%,2m
12094,3,ProRandom,2844,194,7,6,13,53.8%,47m
12094,3,凌晨,2844,144,6,3,9,66.7%,4m
12094,2,了不起的杰弗里斯,2844,201,6,8,14,42.9%,11m
12094,1,baigennyS,2844,0,3,1,4,75.0%,31m
12094,2,你野爹就是这样,2844,0,3,3,6,50.0%,12m
12094,2,[一块晶化瓦斯]虎牙星点风白君,2844,90,2,3,5,40.0%,1h
12094,3,rokermmar,2844,0,1,0,1,100.0%,47m
12094,3,新颖子,2844,0,1,0,1,100.0%,20m
12094,3,Faith,2844,30,1,1,2,50.0%,28m
12094,3,XIAODAO,2844,30,1,1,2,50.0%,17m
12094,2,闻风拂落雨,2844,0,1,2,3,33.3%,42m
12094,3,云上,2844,0,0,1,1,0.0%,10m
12094,1,大老粗,2844,0,0,1,1,0.0%,1h
12094,2,[南京工业大学]重熙累叶,2844,0,0,3,3,0.0%,23m
12117,2,[暴雪全能亡]本群最跳狗逼嘴宗,2843,805,41,29,70,58.6%,12m
12117,2,Binromanti,2843,992,37,40,77,48.1%,12m
12117,3,[天下第一战神]Innovation,2843,460,20,10,30,66.7%,14m
12117,2,人生何处不青山,2843,406,14,17,31,45.2%,47m
12117,3,[青铜联盟]bluestar,2843,350,13,6,19,68.4%,6m
12117,1,[DHT]怪兽河,2843,96,4,2,6,66.7%,1h
12117,1,悲伤的火鸡侠,2843,0,3,3,6,50.0%,1h
12117,1,[grief]atlas,2843,0,3,3,6,50.0%,26m
12117,1,[小仙女上线啦]行建国,2843,96,2,1,3,66.7%,19m
12117,3,[孙哥的屁股]好翘好喜欢,2843,58,2,3,5,40.0%,6m
12117,3,Cyberpsycho,2843,58,2,3,5,40.0%,21m
12117,3,[东南西北战区]拓孚大吊哥,2843,0,1,0,1,100.0%,27m
12117,3,阿克尼西亚,2843,0,0,1,1,0.0%,17m
12130,3,勇气人族,2842,1109,144,122,266,54.1%,2m
12130,1,Universe,2842,685,142,128,270,52.6%,6m
12130,2,燕然,2842,924,115,98,213,54.0%,11m
12130,2,阜者,2842,1605,108,103,211,51.2%,45m
12130,3,DJmi,2842,1510,69,39,108,63.9%,4m
12130,2,忠诚,2842,495,22,19,41,53.7%,21m
12130,1,[暴雪十二队]机枪兵,2842,621,20,29,49,40.8%,27m
12130,2,天降七昭,2842,241,19,21,40,47.5%,5m
12130,2,阻碍战争,2842,351,15,10,25,60.0%,4m
12130,3,WHITEM,2842,212,7,2,9,77.8%,23m
12130,2,白给少年五十块,2842,222,7,8,15,46.7%,4m
12130,2,云之渺,2842,128,4,4,8,50.0%,9m
12130,3,sksuzakufan,2842,60,3,3,6,50.0%,48m
12130,3,[CIE]迪奥,2842,30,2,0,2,100.0%,6m
12130,3,试试水,2842,30,2,1,3,66.7%,2m
12130,1,LuckyEB,2842,0,2,2,4,50.0%,1h
12130,2,[夜未央]永夜,2842,46,1,1,2,50.0%,1h
12130,3,entaroWHN,2842,30,1,1,2,50.0%,21m
12130,3,凤清嘉羽,2842,30,1,1,2,50.0%,7m
12130,2,九亿少女的梦,2842,0,1,1,2,50.0%,11m
12130,3,鬼手,2842,30,1,2,3,33.3%,17m
12130,2,白花花,2842,0,1,3,4,25.0%,1h
12130,3,Shiki,2842,0,0,1,1,0.0%,13m
12130,3,浅尝辄止,2842,0,0,1,1,0.0%,10m
12154,2,yyshuai,2841,1015,78,77,155,50.3%,5m
12154,1,星际迷航,2841,1265,71,70,141,50.4%,12m
12154,3,steven,2841,269,68,70,138,49.3%,44m
12154,3,[同浙星际]CNInnovation,2841,1092,39,52,91,42.9%,11m
12154,2,SuperSCV,2841,589,27,22,49,55.1%,2m
12154,2,llllllllllll,2841,573,23,20,43,53.5%,45m
12154,3,shgdjdjh,2841,88,5,14,19,26.3%,22m
12154,3,zerotwo,2841,156,4,3,7,57.1%,1h
12154,2,打棒棒糖,2841,114,4,3,7,57.1%,36m
12154,2,didala,2841,126,4,4,8,50.0%,8m
12154,3,Feier,2841,46,4,5,9,44.4%,17m
12154,3,Blackrock,2841,88,3,2,5,60.0%,12m
12154,3,Ignize,2841,30,1,2,3,33.3%,27m
12154,2,龟田一峰,2841,0,1,5,6,16.7%,36m
12154,3,FlanDRe,2841,0,0,1,1,0.0%,20m
12154,3,Beriah,2841,0,0,1,1,0.0%,13m
12154,2,zbm,2841,0,0,3,3,0.0%,11m
12171,3,小兔,2840,1304,106,108,214,49.5%,47m
12171,2,两两,2840,958,86,75,161,53.4%,2m
12171,2,Mourner,2840,1551,66,61,127,52.0%,47m
12171,2,夏日,2840,671,51,41,92,55.4%,22m
12171,2,后海不是海丷,2840,663,42,26,68,61.8%,44m
12171,2,蓝天,2840,296,34,25,59,57.6%,47m
12171,3,nogood,2840,627,27,22,49,55.1%,3m
12171,2,艾莉西亚,2840,523,21,27,48,43.8%,45m
12171,3,AllureLove,2840,415,20,15,35,57.1%,6m
12171,3,[第八舰队丶]风炎旗帜,2840,256,8,5,13,61.5%,25m
12171,3,[武圣]light,2840,228,8,7,15,53.3%,28m
12171,2,[文韬武略]表妹依旧消魂,2840,52,6,8,14,42.9%,5m
12171,3,[曾经一群兔兔]队长阿威,2840,189,6,9,15,40.0%,17m
12171,3,[秋毫]极地之光,2840,30,2,1,3,66.7%,26m
12171,2,[你会有感应]星母,2840,88,2,2,4,50.0%,8m
12171,3,huaerzuihong,2840,30,1,1,2,50.0%,28m
12171,2,[OB丶]ByMonica,2840,88,1,4,5,20.0%,4m
12171,3,sad,2840,0,0,1,1,0.0%,15m
12189,3,[不要乱来]鹰小舍大,2839,1618,80,64,144,55.6%,27m
12189,1,[RDFZsc]无常,2839,1308,78,76,154,50.6%,19m
12189,2,冲冲冲冲冲,2839,788,59,67,126,46.8%,22m
12189,3,[瘾大眼瞎]LittleNight,2839,888,39,24,63,61.9%,23m
12189,3,英雄的叹息,2839,481,39,34,73,53.4%,26m
12189,2,DETR,2839,419,38,36,74,51.4%,2m
12189,2,[至诚娱乐]神父我有罪,2839,821,33,29,62,53.2%,3m
12189,2,欢神,2839,414,18,15,33,54.5%,22m
12189,1,[Angels]龍紋,2839,262,11,18,29,37.9%,16m
12189,2,菜鸽,2839,300,10,11,21,47.6%,20m
12189,2,取名怪才,2839,208,9,6,15,60.0%,45m
12189,2,晓阳炎,2839,230,9,11,20,45.0%,44m
12189,1,[无情沛块]和泉丨纱雾,2839,251,8,15,23,34.8%,4m
12189,3,如梦初醒,2839,150,7,10,17,41.2%,16m
12189,1,[我丶超勇的]黄旭东,2839,180,6,13,19,31.6%,28m
12189,3,南辙,2839,114,5,2,7,71.4%,27m
12189,3,神之吊死,2839,147,4,5,9,44.4%,48m
12189,3,疤瘌味的桃子,2839,0,1,0,1,100.0%,22m
12189,3,[19CM]呵呵哒,2839,0,1,1,2,50.0%,46m
12189,3,[曾经一群兔兔]古楚小狼,2839,0,1,1,2,50.0%,18m
12189,1,黑暗舰队,2839,0,1,1,2,50.0%,1h
12189,2,mckk,2839,0,0,1,1,0.0%,14m
12189,3,毅哥最帅,2839,0,0,1,1,0.0%,46m
12189,3,[银翼之光]feiji,2839,0,0,2,2,0.0%,28m
12213,2,牛币较真搞毛,2838,269,46,29,75,61.3%,18m
12213,1,[镜花水月]坂嶋鉄盒,2838,1086,45,45,90,50.0%,10m
12213,2,Grrr,2838,473,19,17,36,52.8%,2m
12213,3,萌萌哒,2838,349,16,10,26,61.5%,16m
12213,2,[浙大战队]顾津濠,2838,264,14,15,29,48.3%,2m
12213,1,姑娘莫怕,2838,332,13,11,24,54.2%,18m
12213,2,zero,2838,206,13,12,25,52.0%,25m
12213,2,[青风堂]秽土转生,2838,444,13,49,62,21.0%,29m
12213,1,神琪一幻,2838,170,11,10,21,52.4%,1h
12213,1,[无花也浪漫]inthewind,2838,94,3,2,5,60.0%,7m
12213,3,[黑鲨]东京王者,2838,30,2,0,2,100.0%,22m
12213,1,小邪神,2838,62,2,11,13,15.4%,7m
12213,3,dwh,2838,0,1,0,1,100.0%,5m
12213,3,求放水,2838,30,1,2,3,33.3%,48m
12213,2,萌新想找大佬带,2838,0,0,1,1,0.0%,5m
12213,1,[二次元联盟军]IIIIIIIIIIII,2838,0,0,1,1,0.0%,20m
12213,1,[SAX]永恒梦魇,2838,0,0,1,1,0.0%,1h
12213,1,[Holyfe]墨苍,2838,0,0,5,5,0.0%,1h
12231,1,[朝花夕誓]麾安,2837,1603,219,195,414,52.9%,4m
12231,2,Clyde,2837,1571,69,68,137,50.4%,21m
12231,3,[斑斓]Coloryellow,2837,496,19,15,34,55.9%,24m
12231,2,killerqueen,2837,320,15,19,34,44.1%,14m
12231,3,[谐星之家SC]saya,2837,280,11,7,18,61.1%,26m
12231,1,飞扬的腿毛,2837,326,10,19,29,34.5%,44m
12231,1,Obsessive,2837,280,8,7,15,53.3%,34m
12231,3,抗毒伤害,2837,199,8,8,16,50.0%,1h
12231,3,[战网电竞]飞飞窜,2837,218,8,8,16,50.0%,17m
12231,3,战灵,2837,170,7,4,11,63.6%,26m
12231,3,[牛痞最时尚]我是赌狗,2837,170,6,3,9,66.7%,5m
12231,1,菜鸡互啄,2837,159,5,1,6,83.3%,1h
12231,3,我为怡宝,2837,88,4,1,5,80.0%,26m
12231,1,[YR]Yoshino,2837,125,4,5,9,44.4%,41m
12231,2,山水郎,2837,118,4,7,11,36.4%,15m
12231,3,[呆毛来我迦]Avalon,2837,58,3,1,4,75.0%,18m
12231,2,[棒棒很棒棒哟]Alexxxxx,2837,0,3,2,5,60.0%,13m
12231,2,紫荆天坑,2837,0,3,3,6,50.0%,18m
12231,3,哥的冷漠万人迷,2837,30,2,0,2,100.0%,6m
12231,3,[蓝蓝路]MrWhiteWolF,2837,30,2,0,2,100.0%,13m
12231,3,YuShen,2837,112,2,2,4,50.0%,5m
12231,1,yzw,2837,96,2,3,5,40.0%,19m
12231,3,神棍局局长,2837,0,1,0,1,100.0%,46m
12231,3,inovation,2837,0,1,0,1,100.0%,5m
12231,3,[D丨VA]Yocto,2837,0,0,1,1,0.0%,6m
12231,3,LuHua,2837,0,0,1,1,0.0%,11m
12231,3,[万古长存]天涯有穷相思无尽,2837,0,0,1,1,0.0%,5m
12231,3,孙亦谐,2837,0,0,1,1,0.0%,16m
12259,3,[KPG]咱家不怕酸,2836,849,37,42,79,46.8%,25m
12259,3,月影流砂,2836,751,30,26,56,53.6%,46m
12259,1,[五月花]Kooo,2836,495,16,22,38,42.1%,20m
12259,2,[hbjg2b]ptzimba,2836,424,14,17,31,45.2%,11m
12259,2,Veritas,2836,206,7,11,18,38.9%,48m
12259,3,[血港魅影]Smile,2836,191,6,1,7,85.7%,6m
12259,2,[至诚娱乐]man,2836,118,5,2,7,71.4%,45m
12259,3,YzHSureWin,2836,99,5,4,9,55.6%,46m
12259,2,电脑,2836,44,4,3,7,57.1%,36m
12259,3,深夜的活动,2836,114,4,4,8,50.0%,25m
12259,1,圆圆敲阔爱,2836,161,4,5,9,44.4%,1h
12259,2,ZlW,2836,0,3,2,5,60.0%,29m
12259,2,[EoD]Trial,2836,88,3,7,10,30.0%,9m
12259,1,寻找周杰伦,2836,159,3,8,11,27.3%,51m
12259,2,[情谊至上]有梦想的人不睡觉,2836,0,2,3,5,40.0%,1h
12259,3,我是盲人,2836,0,1,0,1,100.0%,18m
12259,3,瑶瑟铅华,2836,0,1,1,2,50.0%,27m
12259,3,飞音,2836,30,1,3,4,25.0%,26m
12259,3,[神圣龙猪]龙小霞,2836,0,0,1,1,0.0%,5m
12259,3,[橘迟但到]ctoar,2836,0,0,1,1,0.0%,16m
12259,3,[悟了]谐神小绵羊,2836,0,0,1,1,0.0%,18m
12280,1,[黑桃A]Joker,2835,1031,53,55,108,49.1%,6m
12280,3,bony,2835,1062,40,39,79,50.6%,28m
12280,3,[Serica]irohia,2835,416,16,8,24,66.7%,26m
12280,3,AYZ,2835,383,14,13,27,51.9%,27m
12280,3,[lmbaP]风笛,2835,298,11,9,20,55.0%,10m
12280,2,最强神话,2835,227,10,8,18,55.6%,1h
12280,3,TCTG,2835,254,10,9,19,52.6%,6m
12280,1,[镇魂]liaocao,2835,259,9,5,14,64.3%,18m
12280,1,SpicA,2835,238,8,6,14,57.1%,1h
12280,3,[纸巾是毒奶]菊花格格,2835,114,5,3,8,62.5%,26m
12280,3,[一起吃鱼啊]大爱病娇,2835,140,5,3,8,62.5%,22m
12280,3,普罗德摩尔海军,2835,142,4,0,4,100.0%,14m
12280,3,[社交学导师]LALALA,2835,86,4,4,8,50.0%,21m
12280,2,notgood,2835,0,4,5,9,44.4%,1h
12280,3,[小黄鸭]星际女孩不恋爱,2835,30,2,2,4,50.0%,17m
12280,2,那些很冒险的梦,2835,0,2,3,5,40.0%,25m
12280,3,[暴雪十队]hxdgssyf,2835,30,1,1,2,50.0%,26m
12280,3,中国首席鉴黄师,2835,0,1,2,3,33.3%,7m
12280,1,[目標諾森德]两面宿傩第一手,2835,0,0,1,1,0.0%,1h
12299,2,飞飞,2834,1511,360,341,701,51.4%,11m
12299,3,[ELSD]Threnody,2834,1490,59,62,121,48.8%,12m
12299,1,我很菜轻点打,2834,907,58,49,107,54.2%,19m
12299,2,市政之光,2834,823,56,51,107,52.3%,45m
12299,1,yys,2834,832,42,44,86,48.8%,4m
12299,3,[闲散人员]烟消云散,2834,848,36,33,69,52.2%,27m
12299,2,[无花也浪漫]鬼子,2834,496,21,20,41,51.2%,18m
12299,3,Sunnyboy,2834,491,19,11,30,63.3%,12m
12299,3,萌萌哒,2834,353,15,11,26,57.7%,21m
12299,2,玄门道人,2834,347,13,15,28,46.4%,21m
12299,1,不水船,2834,318,12,12,24,50.0%,27m
12299,1,又菜又爱玩,2834,198,7,5,12,58.3%,20m
12299,1,Demon,2834,174,6,15,21,28.6%,54m
12299,2,零零小林,2834,156,5,12,17,29.4%,6m
12299,1,两矿一憋炸断肠,2834,136,4,13,17,23.5%,8m
12299,3,康斯坦丁,2834,58,3,0,3,100.0%,21m
12299,3,斯奈菲尔,2834,0,3,2,5,60.0%,46m
12299,3,[黑丝小幼女]阿疯,2834,58,3,2,5,60.0%,10m
12299,1,Kdurant,2834,0,3,3,6,50.0%,1h
12299,3,[火影何平]枯木逢春,2834,30,2,3,5,40.0%,6m
12299,3,[UA3存档组]晨曦之光,2834,0,1,0,1,100.0%,28m
12299,2,[诅咒的黑珍珠]万古邪帝丶君临,2834,0,1,1,2,50.0%,1h
12299,3,没好话,2834,0,0,1,1,0.0%,27m
12299,3,[旋风游骑兵]二中鸟叔,2834,0,0,1,1,0.0%,5m
12323,3,庄槿森,2833,983,140,125,265,52.8%,27m
12323,1,骆驼,2833,1587,91,89,180,50.6%,19m
12323,2,Pluto,2833,1290,67,65,132,50.8%,6m
12323,2,[老年人打星际]我妍,2833,736,30,31,61,49.2%,18m
12323,2,京金,2833,571,22,21,43,51.2%,45m
12323,2,我要攻击之爪,2833,118,14,8,22,63.6%,6m
12323,2,予不予,2833,408,14,19,33,42.4%,9m
12323,1,佐仓绫音丶,2833,159,5,3,8,62.5%,1h
12323,2,NickNight,2833,178,5,6,11,45.5%,45m
12323,3,吾皇,2833,135,5,6,11,45.5%,7m
12323,2,hhh,2833,0,3,2,5,60.0%,1h
12323,3,小嶙,2833,58,2,2,4,50.0%,6m
12323,3,[星际争霸第一]ohhh,2833,0,1,0,1,100.0%,11m
12323,3,[knsk]国民老婆孙一峰,2833,0,1,0,1,100.0%,28m
12323,1,科普卢星区区长,2833,0,1,0,1,100.0%,1h
12323,3,寂灭领主,2833,89,1,2,3,33.3%,22m
12323,3,你从没见过我,2833,0,0,1,1,0.0%,22m
12323,2,[废料集中站]Takeasa,2833,0,0,1,1,0.0%,23m
12323,3,Lembo,2833,0,0,3,3,0.0%,6m
12342,1,RuiTI,2832,1116,245,218,463,52.9%,43m
12342,2,重铸流年,2832,289,12,10,22,54.5%,58m
12342,2,[扶她狗集中营]Eternalcraft,2832,259,11,9,20,55.0%,30m
12342,2,神族,2832,275,9,7,16,56.2%,1h
12342,3,[赢一盘就睡]dustin,2832,176,7,6,13,53.8%,27m
12342,3,小喽罗,2832,121,6,4,10,60.0%,46m
12342,3,[SFTRA3]Sphere,2832,164,5,1,6,83.3%,19m
12342,1,战士,2832,48,4,4,8,50.0%,1h
12342,3,Accelerator,2832,58,3,1,4,75.0%,7m
12342,2,侏罗纪,2832,0,3,2,5,60.0%,1h
12342,1,中島由貴,2832,0,3,3,6,50.0%,1h
12342,3,Garstfy,2832,111,2,2,4,50.0%,27m
12342,3,[Chiken]阿尔达瑞斯,2832,116,2,3,5,40.0%,18m
12342,2,[冰川镜华]狗狗,2832,102,2,4,6,33.3%,23m
12342,3,[输赢靠我旭东]老实的州老师,2832,0,0,1,1,0.0%,25m
12357,1,IIIIIIIIIIII,2831,1453,147,153,300,49.0%,23m
12357,2,demerzel,2831,521,38,37,75,50.7%,16m
12357,3,你看我吊嘛,2831,383,20,19,39,51.3%,46m
12357,2,最后的泰伦,2831,530,20,24,44,45.5%,11m
12357,2,[吕布门下弟子]大王,2831,308,11,14,25,44.0%,2m
12357,2,[逗比神教]asdf,2831,246,9,3,12,75.0%,3m
12357,3,[X英雄圣域X]yyyyy,2831,144,9,7,16,56.2%,28m
12357,3,Boomfire,2831,170,7,5,12,58.3%,25m
12357,1,DAWASF,2831,138,6,4,10,60.0%,1h
12357,2,[光明正大]HUNTER,2831,151,5,4,9,55.6%,47m
12357,1,[NVKR]呆表永远滴神,2831,166,5,7,12,41.7%,1h
12357,3,汐泫,2831,116,4,3,7,57.1%,18m
12357,2,幽鬼兔,2831,0,3,2,5,60.0%,39m
12357,3,[譏颰]Suker,2831,0,0,1,1,0.0%,18m
12371,2,IIIIIIIIIIII,2830,1559,146,132,278,52.5%,2m
12371,3,ForzAm,2830,853,139,140,279,49.8%,13m
12371,2,愤怒的菜鸟,2830,925,132,125,257,51.4%,11m
12371,2,biubiubro,2830,1603,127,115,242,52.5%,45m
12371,2,[艾尔之巅]丿逝去丶秋天丶,2830,1108,112,107,219,51.1%,47m
12371,2,黄药师,2830,1372,81,81,162,50.0%,11m
12371,2,[凤凰之门]蒜仔,2830,1318,68,58,126,54.0%,5m
12371,3,[老板大气嗷]深海守护者孙一峰,2830,773,30,23,53,56.6%,13m
12371,3,[TAK]syd,2830,733,29,20,49,59.2%,17m
12371,3,半朵肖雅,2830,486,19,18,37,51.4%,22m
12371,3,sungel,2830,462,18,15,33,54.5%,48m
12371,2,莫奈,2830,296,17,21,38,44.7%,13m
12371,3,SGCALLE,2830,368,14,23,37,37.8%,26m
12371,2,[白银联盟]笨拙,2830,248,11,9,20,55.0%,25m
12371,3,菊花侠,2830,276,10,4,14,71.4%,25m
12371,3,剑皇道一,2830,189,7,6,13,53.8%,1h
12371,2,[社交学导师]阳炎级八幡舰丹阳,2830,116,5,6,11,45.5%,56m
12371,3,[Hs浪]九尾白,2830,119,4,1,5,80.0%,6m
12371,3,老子是地镭,2830,130,4,1,5,80.0%,17m
12371,2,问问问,2830,0,4,1,5,80.0%,57m
12371,3,哈克奥罗,2830,77,4,5,9,44.4%,20m
12371,3,御龍銘千古,2830,86,3,2,5,60.0%,44m
12371,2,white,2830,0,3,2,5,60.0%,1h
12371,2,[Conque]jyh,2830,94,3,3,6,50.0%,1h
12371,2,Elijah,2830,94,3,3,6,50.0%,1h
12371,3,Yoisa,2830,58,3,4,7,42.9%,27m
12371,3,[应塔罗塔杀哒]浮生若梦,2830,30,2,1,3,66.7%,26m
12371,3,[清风寨]duck,2830,30,2,1,3,66.7%,21m
12371,3,[可爱的德哈卡]俏雨之夜,2830,94,2,3,5,40.0%,22m
12371,3,[四世三公]ggbobn,2830,121,2,5,7,28.6%,6m
12371,1,莫吾知兮丶,2830,0,1,2,3,33.3%,5m
12371,2,ShaDow,2830,22,1,5,6,16.7%,5m
12371,3,[qOnOp]该用户已不存在,2830,0,0,1,1,0.0%,12m
12371,3,辣鸡暴雪还我星际,2830,0,0,1,1,0.0%,14m
12371,3,[炸裂]SCIlence,2830,0,0,1,1,0.0%,24m
12371,1,[战争巫妖]巫妖王的承诺,2830,0,0,1,1,0.0%,19m
12407,3,郑恩地,2829,1053,46,32,78,59.0%,28m
12407,2,Xiangyang,2829,182,31,27,58,53.4%,2m
12407,2,Commander,2829,869,31,33,64,48.4%,45m
12407,3,jsyzxpwhy,2829,492,18,18,36,50.0%,6m
12407,3,Subzero,2829,346,14,11,25,56.0%,14m
12407,2,[黄金海舰队]醉卧沙场君莫笑,2829,293,13,9,22,59.1%,9m
12407,3,WSX,2829,120,5,3,8,62.5%,22m
12407,3,乐山孙一峰,2829,142,5,5,10,50.0%,18m
12407,3,[miku守护]Aeglos,2829,58,3,2,5,60.0%,25m
12407,3,[goAway]KamiKaZeeE,2829,86,3,3,6,50.0%,44m
12407,3,[TheY]龙神,2829,0,1,0,1,100.0%,6m
12407,2,[萌萌哒萌萌哒]尼古拉斯贾富贵,2829,30,1,5,6,16.7%,47m
12407,3,[萌新爱萌]源光之路,2829,0,0,1,1,0.0%,28m
12407,3,[老娘就是毒奶]稀神探女,2829,0,0,1,1,0.0%,28m
12421,3,[Mikon]Rinne,2828,1597,122,105,227,53.7%,17m
12421,3,general,2828,1455,90,80,170,52.9%,22m
12421,3,小树,2828,917,89,90,179,49.7%,16m
12421,2,高手坟墓,2828,1372,68,63,131,51.9%,11m
12421,3,StateWeapons,2828,1099,49,36,85,57.6%,21m
12421,2,永诀,2828,1047,41,49,90,45.6%,9m
12421,2,贤者瓜,2828,546,28,26,54,51.9%,45m
12421,1,[暴雪十七队]vivi,2828,555,22,25,47,46.8%,12m
12421,2,[在下菜鸡一只]terry,2828,402,15,16,31,48.4%,4m
12421,2,[探姬同萌会]嫌疑喵,2828,408,14,18,32,43.8%,2m
12421,3,wdnmd,2828,267,8,9,17,47.1%,7m
12421,3,doubi,2828,174,7,5,12,58.3%,46m
12421,3,云卷云舒,2828,169,7,7,14,50.0%,1h
12421,3,rayxu,2828,166,6,5,11,54.5%,3m
12421,3,[零点五个菜鸟]tossgirls,2828,142,5,3,8,62.5%,5m
12421,1,慕容冷雪,2828,234,5,4,9,55.6%,17m
12421,2,[让让孩子吧]莱德林,2828,158,5,5,10,50.0%,22m
12421,2,管子村村长,2828,144,4,5,9,44.4%,47m
12421,3,[XCode]红色长夜何时终结,2828,114,4,5,9,44.4%,11m
12421,2,鬼魂之龙,2828,112,3,0,3,100.0%,1h
12421,1,[光明正大]神崎辄识,2828,118,3,3,6,50.0%,40m
12421,3,SeekDream,2828,30,2,1,3,66.7%,14m
12421,3,自来水拌饭,2828,0,0,2,2,0.0%,44m
12421,3,个个叫爸爸,2828,0,0,2,2,0.0%,5m
12445,2,[FEILIA]绯灬,2827,243,33,28,61,54.1%,47m
12445,3,随便搞一搞,2827,551,27,11,38,71.1%,46m
12445,3,明后天好,2827,368,14,12,26,53.8%,26m
12445,2,[miku守护]ScarLeet,2827,402,14,13,27,51.9%,13m
12445,3,[四叶草]西湖级前十秒钟,2827,259,13,11,24,54.2%,18m
12445,3,[Aris]克利夫兰,2827,307,12,13,25,48.0%,27m
12445,2,SHAY,2827,322,12,14,26,46.2%,47m
12445,1,[玛莎哥牛B]DREAM,2827,342,10,24,34,29.4%,47m
12445,1,吴曦,2827,167,7,4,11,63.6%,51m
12445,3,[X英雄圣域X]木鱼桑,2827,144,6,4,10,60.0%,27m
12445,1,[FLAT]凯枫,2827,215,6,11,17,35.3%,23m
12445,1,Varian,2827,144,5,4,9,55.6%,34m
12445,3,[嘴宗]Terry,2827,116,5,5,10,50.0%,14m
12445,2,NITAIN,2827,159,3,2,5,60.0%,1h
12445,2,呵呵哒,2827,0,3,3,6,50.0%,1h
12445,2,[永恒之环]惊鸿,2827,92,2,2,4,50.0%,36m
12445,2,JZMOUSE,2827,0,1,1,2,50.0%,44m
12445,1,你怎么不理我,2827,0,1,2,3,33.3%,36m
12445,3,阿卓,2827,30,1,2,3,33.3%,14m
12445,3,[BBR]第十四使徒,2827,0,0,1,1,0.0%,3m
12445,1,上路灯霸,2827,0,0,1,1,0.0%,34m
12466,3,huang,2826,1222,66,53,119,55.5%,22m
12466,3,[巨龙降临]YMYM,2826,445,60,59,119,50.4%,28m
12466,3,jacky,2826,980,35,36,71,49.3%,47m
12466,2,小李淳风,2826,887,34,33,67,50.7%,15m
12466,2,[亀山社中]这么小声还开航母,2826,581,22,22,44,50.0%,47m
12466,3,[M8]叶问,2826,441,19,7,26,73.1%,26m
12466,2,IIIIIIIIIIII,2826,397,14,18,32,43.8%,9m
12466,2,多弗朗冥歌,2826,280,10,9,19,52.6%,45m
12466,1,[反清复明]NewHero,2826,296,9,19,28,32.1%,10m
12466,3,星际小霸王,2826,207,8,7,15,53.3%,1h
12466,3,[老年娱乐团]时间跳跃者的妄想,2826,170,7,4,11,63.6%,22m
12466,2,[FIND]复活节也要蛋,2826,168,7,10,17,41.2%,3m
12466,3,白菜,2826,88,4,2,6,66.7%,11m
12466,3,[高冷大神]龙哥,2826,86,3,4,7,42.9%,26m
12466,1,车干浩,2826,96,3,4,7,42.9%,42m
12466,3,有脑子机器人,2826,0,3,5,8,37.5%,13m
12466,3,小红曜石,2826,30,2,1,3,66.7%,25m
12466,3,我有俯视眩晕症,2826,36,2,3,5,40.0%,25m
12466,3,[洛河LH]柠檬不萌,2826,0,1,0,1,100.0%,16m
12466,3,[贪玩]Mike,2826,0,1,0,1,100.0%,24m
12466,1,jihaoran,2826,92,1,2,3,33.3%,44m
12466,3,芭比污,2826,30,1,2,3,33.3%,10m
12488,1,Askeladd,2825,1078,214,218,432,49.5%,29m
12488,2,啊这,2825,1236,46,46,92,50.0%,45m
12488,2,amethyst,2825,633,28,19,47,59.6%,1m
12488,2,雷诺,2825,205,26,24,50,52.0%,14m
12488,3,河上,2825,301,11,4,15,73.3%,5m
12488,1,野小子,2825,312,11,10,21,52.4%,37m
12488,2,MRSMILE,2825,264,11,12,23,47.8%,2m
12488,2,[tiandi]wwwwwww,2825,270,10,10,20,50.0%,3m
12488,3,空之境界,2825,226,9,7,16,56.2%,17m
12488,3,耿彬吃粑粑,2825,146,5,4,9,55.6%,18m
12488,2,让你先冲,2825,154,5,4,9,55.6%,18m
12488,1,NEwLife,2825,48,4,5,9,44.4%,1h
12488,2,Eahon,2825,95,3,3,6,50.0%,25m
12488,2,老二刺猿,2825,46,3,4,7,42.9%,1h
12488,1,[PTA]arbiter,2825,48,2,1,3,66.7%,1h
12488,3,IIIIIIIIIIII,2825,0,1,0,1,100.0%,27m
12488,3,sdfg,2825,0,1,0,1,100.0%,28m
12488,3,BAAAAAANG,2825,30,1,2,3,33.3%,26m
12488,3,电脑简单的,2825,30,1,2,3,33.3%,19m
12488,3,Anlent,2825,0,0,1,1,0.0%,22m
12488,3,regular,2825,0,0,2,2,0.0%,22m
12488,1,sonofykq,2825,0,0,7,7,0.0%,8m
12510,2,[KPG2]kaer,2824,1414,141,129,270,52.2%,45m
12510,1,BATMAN,2824,640,86,95,181,47.5%,4m
12510,2,[荣耀丶殿堂]丶橘右京,2824,1172,68,64,132,51.5%,18m
12510,1,[双神教小主教]FairyAzis,2824,1127,48,41,89,53.9%,43m
12510,2,[Flowex]Grinch,2824,381,16,15,31,51.6%,27m
12510,2,麒宇,2824,157,15,14,29,51.7%,1m
12510,2,[SCAP]Yhk,2824,240,11,8,19,57.9%,13m
12510,2,nevver,2824,178,10,9,19,52.6%,15m
12510,3,[换家引领世界]夜空中最亮的星,2824,209,7,6,13,53.8%,46m
12510,1,[HAOREN]Journey,2824,210,6,7,13,46.2%,2m
12510,3,[华溪岛]Kial,2824,183,5,2,7,71.4%,8m
12510,2,随风潜入夜,2824,0,4,1,5,80.0%,1h
12510,3,女妖,2824,30,2,0,2,100.0%,16m
12510,3,[洛水天依]来咧,2824,30,2,2,4,50.0%,44m
12510,3,[萝莉之芯]爱我就给我,2824,0,1,0,1,100.0%,46m
12510,3,[ToHo]带带大师兄,2824,0,1,0,1,100.0%,22m
12510,3,[Alexya]Polaris,2824,0,1,1,2,50.0%,44m
12510,3,[Sc养老]erlengdie,2824,0,1,2,3,33.3%,28m
12510,3,Alonso,2824,0,0,1,1,0.0%,11m
12510,3,[扫黄]米迦勒,2824,0,0,2,2,0.0%,14m
12530,2,txb,2823,1608,195,178,373,52.3%,20m
12530,1,[不偷不狗全靠]可以吗,2823,1546,132,132,264,50.0%,6m
12530,2,歪歪,2823,1069,63,54,117,53.8%,25m
12530,2,DreadMonkey,2823,905,62,55,117,53.0%,18m
12530,2,火龙附体,2823,356,17,16,33,51.5%,16m
12530,2,[SOV1ET]那两个卖书的,2823,254,11,19,30,36.7%,21m
12530,1,星神来也,2823,207,7,6,13,53.8%,42m
12530,1,走为上计,2823,173,7,9,16,43.8%,37m
12530,3,[嘤嘤樱]黑子,2823,161,5,0,5,100.0%,7m
12530,1,黑暗圣堂,2823,0,5,1,6,83.3%,58m
12530,2,刺客之心,2823,176,5,7,12,41.7%,21m
12530,3,给条活路,2823,158,4,2,6,66.7%,13m
12530,3,紫水栈桥,2823,141,3,1,4,75.0%,7m
12530,1,齐天大圣猴哥,2823,120,3,2,5,60.0%,1h
12530,3,FALLOUT,2823,42,3,4,7,42.9%,4m
12530,2,时崎狂三,2823,133,3,4,7,42.9%,45m
12530,2,不一般的人类,2823,60,3,6,9,33.3%,11m
12530,1,青色黎明,2823,102,3,9,12,25.0%,14m
12530,2,dder,2823,0,2,1,3,66.7%,16m
12530,2,今夜打母猪,2823,0,2,3,5,40.0%,55m
12530,2,starlight,2823,0,2,3,5,40.0%,14m
12530,3,[汝负]逼碧君,2823,0,1,0,1,100.0%,22m
12530,3,秀一脸,2823,30,1,2,3,33.3%,5m
12530,1,[浮世清欢]小幽,2823,97,1,3,4,25.0%,1h
12530,1,星际好难玩,2823,0,0,1,1,0.0%,57m
12530,3,MFtelinf,2823,0,0,1,1,0.0%,23m
12530,3,小色,2823,0,0,1,1,0.0%,14m
12557,2,亦似花洛亦似霞,2822,1434,185,160,345,53.6%,21m
12557,1,少女之友,2822,1010,134,120,254,52.8%,28m
12557,2,[Rhusky]TerranUmaru,2822,1568,107,104,211,50.7%,21m
12557,2,枪兵大队长,2822,986,80,83,163,49.1%,45m
12557,1,[温柔兔公主]zfr,2822,1256,73,72,145,50.3%,6m
12557,2,[半个大哥]DriveaF,2822,1024,43,33,76,56.6%,12m
12557,3,遭重了啊,2822,722,38,35,73,52.1%,47m
12557,3,夜闖峨嵋山,2822,225,18,12,30,60.0%,18m
12557,3,sdfsdfes,2822,343,14,11,25,56.0%,3m
12557,2,[乳主头子]FierKshowdow,2822,339,14,18,32,43.8%,25m
12557,1,玩玩而已,2822,372,13,11,24,54.2%,46m
12557,2,[只会平推]吃熊猫的尾巴,2822,240,9,7,16,56.2%,9m
12557,2,[长夜将至]LLLLL,2822,196,7,14,21,33.3%,12m
12557,2,NicetoFkU,2822,184,6,12,18,33.3%,13m
12557,3,redt,2822,172,5,6,11,45.5%,23m
12557,3,[手撕鸡]TaKaShi,2822,118,4,3,7,57.1%,5m
12557,3,[升格第一鸡]山壑狼王,2822,90,4,5,9,44.4%,46m
12557,2,IIIIIIIIIIII,2822,116,3,2,5,60.0%,1h
12557,3,[萨尔那加议会]墨染流觞,2822,90,3,3,6,50.0%,13m
12557,3,[sc扫黄大队]人沫沫,2822,58,2,3,5,40.0%,16m
12557,1,Jingyu,2822,48,2,8,10,20.0%,50m
12557,3,lucky,2822,0,1,0,1,100.0%,21m
12557,2,可口小白菜,2822,0,1,3,4,25.0%,7m
12557,3,[comes]SKT,2822,0,0,1,1,0.0%,48m
12557,3,[贪玩]钢铁洪流,2822,0,0,2,2,0.0%,6m
12582,1,永夜君王,2821,1214,132,119,251,52.6%,26m
12582,2,豁老子,2821,1000,55,51,106,51.9%,14m
12582,3,LastWinder,2821,856,37,23,60,61.7%,21m
12582,2,[守盟]苏默霓的消逝,2821,282,16,13,29,55.2%,9m
12582,2,蛇皮与皮皮虾,2821,328,14,14,28,50.0%,7m
12582,2,[31CM]烂橘子,2821,376,13,13,26,50.0%,23m
12582,2,[gusl]PrinCess,2821,271,10,10,20,50.0%,12m
12582,3,风中逆转,2821,255,9,8,17,52.9%,26m
12582,2,队长饶命,2821,294,9,12,21,42.9%,18m
12582,3,PPPPPsanG,2821,205,8,7,15,53.3%,17m
12582,2,xiaot,2821,192,8,8,16,50.0%,4m
12582,2,海因里希,2821,228,8,12,20,40.0%,22m
12582,3,你的酷大叔,2821,146,6,4,10,60.0%,17m
12582,3,flu,2821,134,5,6,11,45.5%,46m
12582,3,冰点的火锅,2821,88,4,1,5,80.0%,22m
12582,2,November,2821,94,4,2,6,66.7%,1h
12582,1,bbc,2821,0,3,3,6,50.0%,1h
12582,3,SKDSBNM,2821,30,2,1,3,66.7%,44m
12582,1,ranmo,2821,96,2,1,3,66.7%,10m
12582,3,holomorphic,2821,60,2,3,5,40.0%,3m
12582,1,白白胖胖,2821,96,2,4,6,33.3%,1h
12582,2,IIIIIIIII,2821,0,1,0,1,100.0%,1h
12582,2,YanPeng,2821,0,1,0,1,100.0%,1h
12582,3,[德哈卡神教]明明,2821,0,1,0,1,100.0%,10m
12582,3,Dark,2821,0,1,1,2,50.0%,25m
12582,1,silver,2821,0,0,1,1,0.0%,1h
12582,3,Kura,2821,0,0,1,1,0.0%,13m
12609,3,三英战芦苇,2820,1474,187,161,348,53.7%,3m
12609,1,尼古拉斯钢蛋,2820,1410,180,162,342,52.6%,10m
12609,1,[i5]东方不败,2820,964,139,142,281,49.5%,28m
12609,2,[新宿三丁目]佩恩,2820,850,35,30,65,53.8%,47m
12609,2,[休闲I攻略组]何子昂,2820,342,16,12,28,57.1%,26m
12609,3,地球末日,2820,118,3,0,3,100.0%,5m
12609,1,shining,2820,0,3,3,6,50.0%,20m
12609,3,mangzhong,2820,60,2,3,5,40.0%,10m
12609,3,我就是个控,2820,0,0,1,1,0.0%,13m
12609,3,逆流成河,2820,0,0,1,1,0.0%,27m
12609,3,十三月的雨,2820,0,0,1,1,0.0%,46m
12609,2,算无遗策,2820,0,0,1,1,0.0%,1h
12621,2,悟空,2819,1599,98,93,191,51.3%,22m
12621,3,[wwsixi]九霄,2819,399,17,5,22,77.3%,7m
12621,3,呵呵呵呵,2819,352,15,14,29,51.7%,7m
12621,2,HAO,2819,410,14,17,31,45.2%,23m
12621,3,BlackFriday,2819,376,13,14,27,48.1%,3m
12621,3,无奈,2819,196,8,8,16,50.0%,1h
12621,1,单矿一波要小心,2819,189,7,6,13,53.8%,20m
12621,3,[艾尔之主]OuTLaw,2819,118,4,4,8,50.0%,14m
12621,2,紫苑寺有子,2819,108,4,11,15,26.7%,12m
12621,3,一只妖梦,2819,58,3,2,5,60.0%,22m
12621,2,[深圳老年星际]嘴巴打肿,2819,0,3,3,6,50.0%,1h
12621,3,[DMRe]Herlay,2819,90,3,7,10,30.0%,6m
12621,3,SorryImDregs,2819,0,1,0,1,100.0%,27m
12621,3,zhangbi,2819,30,1,2,3,33.3%,7m
12621,3,麦迪文,2819,30,1,4,5,20.0%,25m
12621,3,Maybe,2819,0,0,1,1,0.0%,21m
12621,3,cookie,2819,0,0,1,1,0.0%,6m
12638,2,[同族直接退]asswecan,2818,1604,196,195,391,50.1%,13m
12638,2,wokanakan,2818,1600,81,75,156,51.9%,12m
12638,2,绝境刘德华,2818,1589,67,59,126,53.2%,12m
12638,2,新月,2818,710,56,45,101,55.4%,22m
12638,1,fRoStFire,2818,607,25,27,52,48.1%,8m
12638,2,[雷神IMBA]DDD,2818,369,21,24,45,46.7%,25m
12638,3,白衣,2818,172,9,4,13,69.2%,6m
12638,2,[BKG]Trap,2818,226,7,8,15,46.7%,4m
12638,2,[练出来了协会]recO,2818,216,7,14,21,33.3%,16m
12638,3,好一个泰伦虫,2818,210,6,7,13,46.2%,14m
12638,3,夜汐,2818,146,5,4,9,55.6%,22m
12638,1,[虚拟歌手团体]洛天依,2818,198,5,7,12,41.7%,18m
12638,2,本华,2818,150,5,9,14,35.7%,10m
12638,2,谢雨航,2818,142,4,5,9,44.4%,2m
12638,1,呵呵哒,2818,48,4,5,9,44.4%,1h
12638,2,思密达烤肉,2818,0,3,3,6,50.0%,1h
12638,2,KTflAsh,2818,60,3,5,8,37.5%,4m
12638,2,虚空者,2818,94,2,5,7,28.6%,1h
12638,2,立华奏,2818,0,1,0,1,100.0%,47m
12638,3,[GAP]雨神,2818,0,1,1,2,50.0%,17m
12658,2,[nienie]肥仔超,2817,1554,156,154,310,50.3%,2m
12658,3,[马家沟白给王]枪兵滚毒爆大师,2817,1276,89,62,151,58.9%,7m
12658,3,[M8]cavaliersile,2817,1224,62,42,104,59.6%,27m
12658,2,打死逗比鱼,2817,532,20,18,38,52.6%,45m
12658,1,巴黎丶,2817,302,10,7,17,58.8%,51m
12658,1,gwsgtwq,2817,268,10,10,20,50.0%,44m
12658,3,Ghost,2817,226,8,8,16,50.0%,16m
12658,1,[GTK丶]骑摩托的少年,2817,176,6,6,12,50.0%,10m
12658,3,[传说萌娘团]想想黄哥会怎么做,2817,154,6,9,15,40.0%,7m
12658,3,Yaren,2817,114,5,3,8,62.5%,46m
12658,2,农夫,2817,0,4,1,5,80.0%,1h
12658,3,[送分大佬]隐侠,2817,114,4,7,11,36.4%,22m
12658,3,福鼎娃,2817,86,3,4,7,42.9%,24m
12658,3,一个炮灰,2817,0,1,0,1,100.0%,18m
12658,3,[一起犯罪]土匪,2817,0,0,1,1,0.0%,4m
12658,3,[三个鸡饲料]EVIL,2817,0,0,4,4,0.0%,28m
12674,3,neo,2816,1598,255,266,521,48.9%,16m
12674,2,ZIACK,2816,737,148,161,309,47.9%,45m
12674,3,DreamHunter,2816,1350,133,124,257,51.8%,25m
12674,3,[被人绿了]虚空寻觅者,2816,1074,122,102,224,54.5%,3m
12674,2,SSSSSS,2816,1564,107,93,200,53.5%,45m
12674,1,zzs,2816,740,29,33,62,46.8%,29m
12674,2,innovation,2816,158,22,19,41,53.7%,2m
12674,2,[星际老屁孩]你甚至不肯叫我,2816,482,21,13,34,61.8%,43m
12674,2,ShakeyShakey,2816,424,15,19,34,44.1%,44m
12674,3,sOngtOm,2816,340,13,12,25,52.0%,28m
12674,2,[菜有菜的道理]Ambuscias,2816,251,11,9,20,55.0%,58m
12674,2,FanscDragon,2816,187,11,13,24,45.8%,1m
12674,3,面对疾风吧,2816,266,10,3,13,76.9%,24m
12674,1,一只萌新,2816,220,6,9,15,40.0%,28m
12674,3,[龙腾]heybabe,2816,86,4,2,6,66.7%,26m
12674,3,风陵,2816,143,3,5,8,37.5%,24m
12674,3,[428NB]black,2816,30,2,1,3,66.7%,6m
12674,3,爬满树,2816,0,1,1,2,50.0%,28m
12674,2,[热血兔子团]tailor,2816,46,1,1,2,50.0%,1h
12674,2,Faraday,2816,0,1,2,3,33.3%,1h
12674,3,[知乎战队]喵小鱼,2816,30,1,3,4,25.0%,14m
12674,3,TMHLLMHT,2816,30,1,4,5,20.0%,6m
12674,3,[x不打内战x]整活小王子,2816,30,1,5,6,16.7%,19m
12674,1,boziwen,2816,0,0,2,2,0.0%,42m
12674,1,[TCP]奶昔不存在,2816,0,0,3,3,0.0%,1h
12699,2,波波良小伞,2815,1526,172,165,337,51.0%,13m
12699,3,[美少男战队]家有很多岛国片,2815,1343,123,115,238,51.7%,14m
12699,2,Railgun,2815,631,54,51,105,51.4%,1m
12699,3,明阳,2815,1007,52,33,85,61.2%,21m
12699,2,宫吧老哥狂喜,2815,374,14,16,30,46.7%,10m
12699,3,德雷斯罗萨,2815,418,13,31,44,29.5%,13m
12699,1,llllllllllll,2815,206,6,6,12,50.0%,1h
12699,2,[神之族]黑火,2815,144,5,3,8,62.5%,45m
12699,1,Carroazy,2815,0,4,3,7,57.1%,27m
12699,3,[多好的孩子啊]Doublelex,2815,120,4,6,10,40.0%,27m
12699,2,[反转摸鱼]掉渣天,2815,0,3,2,5,60.0%,1h
12699,2,最强王者,2815,0,3,2,5,60.0%,23m
12699,2,ENXI,2815,0,3,3,6,50.0%,45m
12699,3,Frank,2815,30,2,3,5,40.0%,15m
12699,1,magicka,2815,143,2,4,6,33.3%,2m
12699,3,IIIIIIIIIIII,2815,0,1,3,4,25.0%,6m
12699,3,[仁义礼智信]蚩尤,2815,0,0,1,1,0.0%,13m
12699,3,peter,2815,0,0,1,1,0.0%,18m
12699,3,SWATwynnb,2815,0,0,1,1,0.0%,11m
12699,3,嗜血苍狼,2815,0,0,3,3,0.0%,7m
12719,1,crazy,2814,1595,147,151,298,49.3%,18m
12719,2,葬花吟魂,2814,1623,123,129,252,48.8%,13m
12719,2,IIIIIIIIIIII,2814,645,64,53,117,54.7%,29m
12719,3,茉莉橙,2814,756,30,28,58,51.7%,7m
12719,3,[RaMoC]BLacK,2814,556,20,18,38,52.6%,13m
12719,2,Rocky,2814,302,11,11,22,50.0%,46m
12719,1,AIDI,2814,240,10,16,26,38.5%,20m
12719,3,在蓝天下冒险,2814,202,6,3,9,66.7%,5m
12719,3,奈何生在帝王家,2814,90,4,4,8,50.0%,26m
12719,3,给你布置作业,2814,144,3,2,5,60.0%,23m
12719,3,[暴雪二十一队]菜鸡卫星,2814,58,3,3,6,50.0%,5m
12719,2,[1giao]AngelSin,2814,0,1,0,1,100.0%,45m
12719,3,[ROBOT]NULL,2814,0,1,1,2,50.0%,6m
12719,2,[初音守护二队]云静天空,2814,30,1,5,6,16.7%,20m
12719,2,马蚤尼玛,2814,46,1,6,7,14.3%,1h
12719,3,xbd,2814,0,0,1,1,0.0%,26m
12719,3,[两道菜]急急急,2814,0,0,1,1,0.0%,7m
12736,2,havebeercome,2813,1230,90,71,161,55.9%,9m
12736,3,Happyness,2813,1374,81,62,143,56.6%,14m
12736,2,[奥林匹斯众神]末日之刃,2813,1200,65,48,113,57.5%,4m
12736,2,IIIIIIIIIIII,2813,1406,57,56,113,50.4%,21m
12736,3,[东方非想天则]Soryu,2813,331,14,14,28,50.0%,6m
12736,2,可以摸妳的头发吗,2813,265,12,10,22,54.5%,28m
12736,2,DZtimes,2813,324,11,12,23,47.8%,12m
12736,3,Wind,2813,246,8,6,14,57.1%,6m
12736,3,有种输给我,2813,176,6,6,12,50.0%,17m
12736,3,Rain,2813,157,5,0,5,100.0%,26m
12736,2,小呆,2813,46,4,4,8,50.0%,1h
12736,1,[嗑药小分队]夜空中最亮的星,2813,48,4,5,9,44.4%,30m
12736,2,好痒的,2813,0,3,3,6,50.0%,1h
12736,3,周大胆,2813,58,2,1,3,66.7%,5m
12736,3,[传统星际届]laohu,2813,30,2,1,3,66.7%,13m
12736,3,never,2813,0,1,1,2,50.0%,17m
12736,3,[孙一峰家族]邯郸孙一峰,2813,30,1,5,6,16.7%,28m
12736,3,鹰巢城的伊鲁席尔,2813,0,0,1,1,0.0%,46m
12736,3,[暴雪十六队]忆梦追思,2813,0,0,1,1,0.0%,28m
12736,3,Hero,2813,0,0,1,1,0.0%,1h
12736,3,流泪也对人笑嘻嘻,2813,0,0,2,2,0.0%,17m
12736,3,[miku守护]MagicAiur,2813,0,0,4,4,0.0%,5m
12758,2,BSS,2812,1181,110,113,223,49.3%,47m
12758,3,dimit,2812,542,21,17,38,55.3%,17m
12758,3,雅色易续风,2812,403,16,9,25,64.0%,6m
12758,2,战疫必胜,2812,341,13,15,28,46.4%,25m
12758,2,被遗忘的优雅,2812,281,10,10,20,50.0%,43m
12758,2,[文韬武略]未闻花名但知花香,2812,244,9,10,19,47.4%,20m
12758,3,小熊,2812,208,8,9,17,47.1%,21m
12758,3,wuming,2812,171,7,7,14,50.0%,52m
12758,2,幻梦,2812,163,7,9,16,43.8%,35m
12758,3,[HUC群雄]王牌,2812,68,6,6,12,50.0%,1h
12758,1,[恋战皇朝]嵐嵐嵐蘭,2812,189,5,5,10,50.0%,1h
12758,1,FTFT,2812,119,5,5,10,50.0%,1h
12758,3,[笑傲星球]SunDay,2812,120,5,6,11,45.5%,16m
12758,3,[RuShA]LINGER,2812,122,5,6,11,45.5%,1h
12758,3,Aubergine,2812,86,4,2,6,66.7%,25m
12758,2,讨你猴子,2812,94,3,3,6,50.0%,25m
12758,3,layton,2812,58,2,5,7,28.6%,26m
12758,3,老工人去哪了,2812,0,1,0,1,100.0%,28m
12758,3,浪呀嘛浪打浪,2812,0,1,0,1,100.0%,18m
12758,3,英俊战士,2812,0,0,1,1,0.0%,28m
12758,1,圣骑士,2812,0,0,1,1,0.0%,1h
12779,2,Milkpudding,2811,1486,111,105,216,51.4%,15m
12779,2,[vaccin]只会虚空的都是傻,2811,953,60,54,114,52.6%,15m
12779,2,coffeego,2811,775,35,42,77,45.5%,15m
12779,2,[八号医院]八号病床已出院,2811,381,16,19,35,45.7%,2m
12779,3,温柔与她皆无,2811,154,6,7,13,46.2%,43m
12779,1,影子,2811,96,4,4,8,50.0%,1h
12779,1,BoomShlt,2811,0,3,4,7,42.9%,19m
12779,3,[Syfish]无语小奈,2811,30,2,0,2,100.0%,17m
12779,2,ERtao,2811,0,2,4,6,33.3%,1h
12779,3,[钢筋铁骨]飘香牛蛙,2811,0,0,1,1,0.0%,5m
12779,3,[WCS全明星]酒过三巡,2811,0,0,1,1,0.0%,47m
12779,3,大神,2811,0,0,2,2,0.0%,18m
12791,1,[白银联盟]舟山星际老男孩,2810,1535,276,273,549,50.3%,19m
12791,1,红龙打下,2810,674,47,53,100,47.0%,14m
12791,2,[GSXY]Mercurial,2810,965,44,30,74,59.5%,8m
12791,3,Bootstrap,2810,774,27,29,56,48.2%,28m
12791,3,风静静地吹,2810,642,23,25,48,47.9%,6m
12791,3,fenenzhanshe,2810,525,21,15,36,58.3%,14m
12791,3,[sc谐盟]雪之下雪乃,2810,237,12,0,12,100.0%,28m
12791,1,Ronnie,2810,291,11,5,16,68.8%,1h
12791,3,[河南财经政法]清浅,2810,200,7,7,14,50.0%,16m
12791,3,zxrai,2810,148,5,7,12,41.7%,14m
12791,3,天上月丶,2810,90,4,4,8,50.0%,26m
12791,2,endocytosis,2810,102,3,3,6,50.0%,29m
12791,2,威廉哥哥,2810,0,3,3,6,50.0%,1h
12791,3,[社交学大可爱]所谓的傲娇,2810,58,2,2,4,50.0%,26m
12791,3,孙哥的最爱佳慧,2810,60,2,3,5,40.0%,5m
12791,3,梁应物,2810,0,1,0,1,100.0%,16m
12791,3,[美丽的风景线]purple,2810,0,1,0,1,100.0%,26m
12791,2,胡迪牛仔,2810,0,0,1,1,0.0%,1h
12791,3,LENBO,2810,0,0,1,1,0.0%,6m
12791,3,[天府禁军]无力悲伤,2810,0,0,1,1,0.0%,18m
12791,3,MISAKA,2810,0,0,1,1,0.0%,22m
12791,1,[入侵地球]niColeTnT,2810,0,0,1,1,0.0%,10m
12791,3,Mew,2810,0,0,3,3,0.0%,27m
12814,2,[Mikon]宫本武藏,2809,1184,157,158,315,49.8%,21m
12814,3,耍孩儿,2809,1519,70,59,129,54.3%,3m
12814,2,[M8]雷电芽衣,2809,1160,48,45,93,51.6%,18m
12814,3,白岚,2809,827,33,28,61,54.1%,27m
12814,3,霸气的胸毛,2809,485,21,17,38,55.3%,17m
12814,3,[一块晶化瓦斯]西野七濑,2809,544,20,18,38,52.6%,48m
12814,3,[情谊至上]闪击英雄,2809,303,15,1,16,93.8%,3m
12814,3,[KK开]影舞灬涟,2809,379,14,10,24,58.3%,46m
12814,2,[風林火山]chineseidiot,2809,318,10,14,24,41.7%,26m
12814,3,GWK,2809,149,7,6,13,53.8%,46m
12814,3,Trap,2809,120,4,4,8,50.0%,14m
12814,3,[七咕咕]天幕下的银翼,2809,108,4,10,14,28.6%,59m
12814,3,BarCode,2809,58,3,0,3,100.0%,21m
12814,3,我踏马心态崩了呀,2809,60,3,3,6,50.0%,10m
12814,2,[自治区党委]闹灾,2809,0,3,3,6,50.0%,1h
12814,2,大胖,2809,30,3,6,9,33.3%,46m
12814,3,[糯米丸子]knjj,2809,58,2,3,5,40.0%,27m
12814,2,Magicka,2809,0,2,3,5,40.0%,1h
12814,3,新造的人,2809,0,1,0,1,100.0%,21m
12833,3,[鸡饲料协会]tardis,2808,1531,69,71,140,49.3%,28m
12833,2,[小小猫战队]小怪兽,2808,459,66,68,134,49.3%,9m
12833,3,孤舟白衣北海少年,2808,597,23,18,41,56.1%,28m
12833,3,清涟龙尘,2808,546,23,19,42,54.8%,6m
12833,1,[上帝之首]chzzir,2808,466,22,18,40,55.0%,9m
12833,2,[无畏巡洋]猎人,2808,474,16,23,39,41.0%,8m
12833,3,JULY,2808,265,13,10,23,56.5%,47m
12833,1,[莽的不行]大瑞明不爱刷牙丶,2808,165,8,4,12,66.7%,49m
12833,2,GunNRose,2808,207,8,8,16,50.0%,11m
12833,3,假装持久的自信心,2808,220,7,10,17,41.2%,36m
12833,3,IIIIIIIIIIII,2808,192,6,3,9,66.7%,26m
12833,3,孙淦晨,2808,130,5,4,9,55.6%,10m
12833,2,LeeMarine,2808,115,4,0,4,100.0%,18m
12833,2,Ale,2808,46,4,3,7,57.1%,13m
12833,3,恐惧,2808,118,4,3,7,57.1%,26m
12833,3,IIIIIIIIIIII,2808,94,3,8,11,27.3%,1h
12833,3,[EDGNB]Ghost,2808,30,2,0,2,100.0%,6m
12833,3,johny,2808,30,2,1,3,66.7%,21m
12833,3,[s黑色玫瑰s]AAA,2808,0,1,0,1,100.0%,5m
12833,3,[社交学教授]月亮我踢弯,2808,0,1,0,1,100.0%,47m
12833,3,[东方刷刷乡]灵乌路空,2808,0,1,1,2,50.0%,36m
12833,3,半仙,2808,0,1,1,2,50.0%,48m
12833,3,cGay,2808,0,1,3,4,25.0%,46m
12833,3,[CUMTB]zion,2808,0,0,1,1,0.0%,15m
12833,2,IIIIIIIIIIII,2808,0,0,1,1,0.0%,1h
12833,3,[斯巴达血战团]独步杀戮,2808,0,0,1,1,0.0%,6m
12833,3,helloworld,2808,0,0,1,1,0.0%,21m
12860,2,[文韬武略]打的就是你,2807,182,44,47,91,48.4%,21m
12860,1,panJIM,2807,1004,33,48,81,40.7%,9m
12860,2,[能力值吊炸天]再看打死你,2807,642,23,25,48,47.9%,15m
12860,3,[审判右翼]Lei,2807,487,20,11,31,64.5%,18m
12860,1,这馒头没馅儿,2807,331,12,12,24,50.0%,18m
12860,2,Clare,2807,124,9,10,19,47.4%,3m
12860,2,JinHo,2807,216,7,1,8,87.5%,50m
12860,2,Person,2807,222,7,13,20,35.0%,13m
12860,3,rhythm,2807,206,6,5,11,54.5%,26m
12860,3,康康大神,2807,64,6,6,12,50.0%,17m
12860,3,[我是一只机]王子涵,2807,120,5,6,11,45.5%,48m
12860,2,[世界何平]悦动心弦,2807,108,4,3,7,57.1%,1h
12860,2,Player,2807,94,3,3,6,50.0%,13m
12860,2,跃龙山巨馍蘸酱,2807,0,3,3,6,50.0%,25m
12860,1,ShineSun,2807,0,3,5,8,37.5%,19m
12860,3,littlenewbie,2807,0,0,1,1,0.0%,26m
12860,3,死王灵,2807,0,0,1,1,0.0%,28m
12877,3,[风暴领主]你是真的狗,2806,774,94,78,172,54.7%,26m
12877,1,彭浦新村孙一峰,2806,1019,65,70,135,48.1%,4m
12877,1,炸鱼死全家,2806,1489,60,68,128,46.9%,6m
12877,2,蔚蓝之海,2806,599,55,52,107,51.4%,11m
12877,3,牵动的灵魂,2806,441,46,46,92,50.0%,29m
12877,2,kinsey,2806,849,34,33,67,50.7%,45m
12877,2,[神奇的联萌]IIIIIIIIIIII,2806,728,28,26,54,51.9%,46m
12877,2,专杀肺炎病毒,2806,591,24,20,44,54.5%,7m
12877,3,[头号玩家]盛世豪杰,2806,608,23,21,44,52.3%,6m
12877,1,卡拉克,2806,266,19,24,43,44.2%,9m
12877,2,银杏城公爵影狐,2806,414,15,15,30,50.0%,15m
12877,3,[专治格种不服]一晚一个东北妞,2806,350,14,13,27,51.9%,46m
12877,3,[VCB]Templar,2806,155,4,1,5,80.0%,47m
12877,1,忆里归乡,2806,165,4,6,10,40.0%,1h
12877,2,pluto,2806,0,3,2,5,60.0%,1h
12877,3,zuifan,2806,95,2,0,2,100.0%,13m
12877,3,[地堡砸脸]Alexandra,2806,18,2,0,2,100.0%,10m
12877,2,百鬼夜行,2806,0,2,1,3,66.7%,1h
12877,2,乂爻,2806,0,2,3,5,40.0%,1h
12877,2,[华东丢人舰队]红白城管,2806,42,2,7,9,22.2%,21m
12877,2,求布黑,2806,60,2,11,13,15.4%,47m
12877,1,蓝桥,2806,0,1,0,1,100.0%,1h
12877,1,[盲人村鸡窝]Georgeking,2806,0,1,1,2,50.0%,46m
12877,2,[西伯利亚土豆]鬼怪,2806,0,0,1,1,0.0%,44m
12877,2,八条是瑶瑶,2806,0,0,1,1,0.0%,1h
12877,3,Harry,2806,0,0,2,2,0.0%,17m
12903,1,[暴雪三十二隊]左能者,2805,810,129,105,234,55.1%,47m
12903,3,富蓝氪淋企鹅,2805,696,38,18,56,67.9%,6m
12903,1,[巅峰无悔]FSDAUGFDSIK,2805,344,32,43,75,42.7%,11m
12903,3,香菜,2805,660,29,14,43,67.4%,3m
12903,3,[2对2大师]jgjj,2805,548,21,20,41,51.2%,10m
12903,3,星蓝海,2805,304,19,12,31,61.3%,26m
12903,3,[鲲之大]金三胖,2805,396,17,14,31,54.8%,47m
12903,1,qfdwerhbegf,2805,288,11,14,25,44.0%,1h
12903,2,freeXeme,2805,212,8,13,21,38.1%,21m
12903,3,Bluesky,2805,151,7,6,13,53.8%,26m
12903,3,凯瑞甘之锋,2805,234,7,6,13,53.8%,4m
12903,3,[沙雕天灾]llllllllllll,2805,231,6,8,14,42.9%,18m
12903,3,BleachWD,2805,112,6,8,14,42.9%,17m
12903,1,小战团,2805,142,5,5,10,50.0%,1h
12903,2,[人族是我爹]HyperMes,2805,170,5,7,12,41.7%,28m
12903,3,艾尔之盾,2805,151,4,4,8,50.0%,22m
12903,1,[猪猪猪]母鸡不偷酸奶,2805,97,4,4,8,50.0%,1h
12903,3,soi,2805,118,4,5,9,44.4%,26m
12903,3,[李少开酒]瓦片的烈變,2805,58,3,1,4,75.0%,6m
12903,3,尼玛尼玛,2805,58,3,1,4,75.0%,26m
12903,2,回航,2805,0,3,2,5,60.0%,29m
12903,3,[萌的一笔]萌新,2805,26,2,2,4,50.0%,19m
12903,2,孙一峰是我大哥,2805,88,2,4,6,33.3%,21m
12903,3,qch,2805,0,1,0,1,100.0%,28m
12903,2,苏筱北,2805,0,1,1,2,50.0%,1h
12903,3,[舞鹤海军工厂]听夏,2805,30,1,2,3,33.3%,28m
12903,1,KaiserLi,2805,0,0,1,1,0.0%,1h
12930,2,[NKTJ]Templar,2804,1561,409,408,817,50.1%,45m
12930,2,磐达,2804,1539,85,80,165,51.5%,45m
12930,2,ashming,2804,1050,45,50,95,47.4%,25m
12930,3,牛批的很,2804,922,39,34,73,53.4%,25m
12930,1,Jiyeon,2804,1051,36,45,81,44.4%,19m
12930,2,Wuxie,2804,374,32,34,66,48.5%,10m
12930,3,FYlike,2804,742,31,22,53,58.5%,46m
12930,1,[CRSC2]Vegeta,2804,372,15,15,30,50.0%,11m
12930,3,[XXG]枫舞,2804,234,8,7,15,53.3%,57m
12930,3,beautiful,2804,234,8,10,18,44.4%,22m
12930,2,奇异磕翔兽,2804,83,8,11,19,42.1%,15m
12930,3,DarkTemplar,2804,202,7,1,8,87.5%,24m
12930,3,冠位大酋长,2804,201,7,2,9,77.8%,10m
12930,3,Diospada,2804,86,4,1,5,80.0%,13m
12930,3,[Fisker]Layzhang,2804,90,4,3,7,57.1%,19m
12930,1,xiaoliang,2804,0,3,4,7,42.9%,1h
12930,2,[TossSE]雷诺拆迁队,2804,94,3,11,14,21.4%,21m
12930,3,[MSpark]云里雾里莎,2804,60,2,2,4,50.0%,24m
12930,3,[SPMF]淋湿的火柴,2804,58,2,6,8,25.0%,28m
12930,3,[血橘]糖拌酱,2804,0,1,0,1,100.0%,47m
12930,3,大神,2804,30,1,1,2,50.0%,14m
12930,3,lllllllllll,2804,0,1,1,2,50.0%,16m
12930,3,vdfd,2804,30,1,1,2,50.0%,46m
12930,2,[孤傲就完事]还是败给了时间,2804,0,1,2,3,33.3%,1h
12930,3,天一,2804,30,1,4,5,20.0%,5m
12930,3,孔明孔亮,2804,0,0,1,1,0.0%,18m
12930,3,茶凉酒寒,2804,0,0,1,1,0.0%,15m
12930,3,[30CM]BattleSuck,2804,0,0,1,1,0.0%,22m
12930,2,初秋凉了夏,2804,0,0,1,1,0.0%,14m
12930,3,[MGT谐星会]CPT,2804,0,0,3,3,0.0%,21m
12960,2,我就是帅,2803,1315,54,50,104,51.9%,5m
12960,3,Jesse,2803,478,23,7,30,76.7%,5m
12960,3,cloud,2803,277,10,5,15,66.7%,28m
12960,2,名字再吊也没用,2803,189,9,7,16,56.2%,28m
12960,1,[昊灵]zxx,2803,241,6,14,20,30.0%,1h
12960,3,[家禽养殖]BKWhite,2803,146,5,6,11,45.5%,21m
12960,2,Ashes,2803,154,5,7,12,41.7%,22m
12960,2,PandaPig,2803,0,3,3,6,50.0%,1h
12960,2,瓦杜海阁,2803,0,3,3,6,50.0%,13m
12960,3,[高维使徒]HHYY,2803,86,3,4,7,42.9%,26m
12960,3,[NLD]故梦汝河,2803,30,2,0,2,100.0%,14m
12960,3,zest,2803,30,2,1,3,66.7%,25m
12960,2,styleA,2803,0,2,3,5,40.0%,29m
12960,2,无限魔幻,2803,0,2,4,6,33.3%,1h
12960,3,IIIIIIIIIIII,2803,30,2,4,6,33.3%,21m
12960,1,xxxshadder,2803,66,2,4,6,33.3%,1h
12960,2,THOSO,2803,0,1,0,1,100.0%,17m
12960,1,[今生必干花开]Forgettable,2803,0,1,0,1,100.0%,41m
12960,3,TslltvdSTD,2803,30,1,1,2,50.0%,19m
12979,2,ByVince,2802,1530,132,107,239,55.2%,10m
12979,2,boxer,2802,839,47,50,97,48.5%,15m
12979,2,[为了Amon]利姆露老爷,2802,760,44,50,94,46.8%,45m
12979,1,西湖优质二五仔,2802,532,41,47,88,46.6%,10m
12979,3,灰灰,2802,684,35,34,69,50.7%,21m
12979,3,意义不明的沙雕,2802,359,33,18,51,64.7%,14m
12979,3,源源源源源丨,2802,356,28,23,51,54.9%,26m
12979,3,阿巴阿巴阿巴,2802,550,24,14,38,63.2%,48m
12979,3,Gooddamn,2802,369,21,12,33,63.6%,25m
12979,3,Nyalotha,2802,332,19,16,35,54.3%,6m
12979,2,coffee,2802,449,18,17,35,51.4%,9m
12979,2,Hadoken,2802,330,11,18,29,37.9%,12m
12979,1,[miku守护]学海无涯,2802,168,6,3,9,66.7%,47m
12979,3,忍尔,2802,186,6,4,10,60.0%,1h
12979,3,llllllllllll,2802,116,5,2,7,71.4%,23m
12979,3,hdlcool,2802,86,4,5,9,44.4%,23m
12979,2,[Tsk]大咖,2802,0,3,3,6,50.0%,1h
12979,1,漾哥打星际,2802,44,3,4,7,42.9%,1h
12979,2,长泽雅美,2802,114,3,6,9,33.3%,21m
12979,3,孙小茶,2802,30,2,2,4,50.0%,27m
12979,3,[SHNU]斗鹰,2802,0,1,0,1,100.0%,22m
12979,1,[soki]别西卜缪林,2802,0,1,0,1,100.0%,42m
12979,3,[正常人]毒光,2802,0,0,1,1,0.0%,44m
12979,3,我快乐就行,2802,0,0,1,1,0.0%,27m
13003,1,神将拔本,2801,1390,141,139,280,50.4%,27m
13003,3,[小金上天队]比利,2801,1213,53,36,89,59.6%,3m
13003,1,大连狗哥,2801,808,36,32,68,52.9%,7m
13003,3,[四叶草]加冰流,2801,548,20,21,41,48.8%,21m
13003,3,看你爹完美运营,2801,388,16,8,24,66.7%,24m
13003,3,Rampant,2801,248,11,2,13,84.6%,13m
13003,2,李雅客,2801,132,10,19,29,34.5%,12m
13003,1,[半个菜鸟]娇娇大锤,2801,171,8,7,15,53.3%,19m
13003,2,Pimento,2801,193,8,10,18,44.4%,25m
13003,3,timba,2801,227,8,11,19,42.1%,21m
13003,1,安徒生的谎言,2801,118,4,4,8,50.0%,5m
13003,3,[浙江大学战队]Demonic,2801,117,3,0,3,100.0%,47m
13003,3,鸟黑头子,2801,30,2,0,2,100.0%,7m
13003,3,[社交学导教]黑脚矿工,2801,0,1,0,1,100.0%,18m
13003,3,暴雪不得好死,2801,0,1,1,2,50.0%,48m
13003,3,[血港魅影]贪狼,2801,0,0,1,1,0.0%,6m
13003,3,[嗨呀老哥]泽熙,2801,0,0,1,1,0.0%,24m
13020,1,[HME]PqiIIIIIIGaP,2800,1255,142,137,279,50.9%,15m
13020,3,[miku守护]京中有善口技者,2800,786,31,24,55,56.4%,24m
13020,3,周洛特利,2800,687,29,29,58,50.0%,22m
13020,2,Crucifix,2800,704,26,28,54,48.1%,21m
13020,2,紧小肾危,2800,620,22,27,49,44.9%,13m
13020,2,[PZHSC]Shine,2800,324,14,16,30,46.7%,25m
13020,3,XIAH,2800,206,9,8,17,52.9%,1h
13020,3,[晨风]鬼丞相,2800,226,8,8,16,50.0%,17m
13020,2,hzhp,2800,117,6,2,8,75.0%,18m
13020,3,KievWx,2800,154,4,2,6,66.7%,19m
13020,3,[吾主在此]美人我来了,2800,169,4,5,9,44.4%,1h
13020,2,SOSO,2800,144,4,6,10,40.0%,2m
13020,2,[西红柿炒]XJH,2800,118,3,1,4,75.0%,32m
13020,2,我是大神不怕你耶,2800,96,3,2,5,60.0%,1h
13020,1,[Allin]Silence,2800,138,3,5,8,37.5%,42m
13020,3,[Ogier]lela,2800,36,3,8,11,27.3%,6m
13020,3,Triste,2800,30,2,4,6,33.3%,21m
13020,3,[地球卫队]王小明,2800,0,1,2,3,33.3%,44m
13020,3,[魔法少女小屋]LonelinesS,2800,0,1,2,3,33.3%,22m
13020,2,[嗑药小分队]萌星洛羽,2800,0,0,1,1,0.0%,37m
13020,2,弗兰盆鱼宴,2800,0,0,1,1,0.0%,1h
13020,3,[FoD]神户牛肉,2800,0,0,2,2,0.0%,46m
13020,3,[灰冥]哼小曲丶,2800,0,0,2,2,0.0%,17m
13020,3,[星际爱好者队]白色巨塔,2800,0,0,3,3,0.0%,28m
13044,3,無意義,2799,1404,80,70,150,53.3%,27m
13044,3,我不是姓崔的,2799,1342,74,61,135,54.8%,48m
13044,3,[21CM]飞翔的荷兰人,2799,1468,71,66,137,51.8%,17m
13044,2,[Axline]Knights,2799,436,60,66,126,47.6%,2m
13044,2,taeja,2799,1328,55,57,112,49.1%,3m
13044,2,SCIKlLLER,2799,656,49,45,94,52.1%,20m
13044,1,烟色萦绕,2799,469,44,55,99,44.4%,15m
13044,3,[Hooray]Willionsmeal,2799,548,24,16,40,60.0%,26m
13044,3,战狼,2799,284,11,9,20,55.0%,46m
13044,3,[星际2谐会]知道不知道,2799,307,10,8,18,55.6%,26m
13044,3,爱新觉罗杨子,2799,102,10,8,18,55.6%,15m
13044,2,荒火,2799,121,5,6,11,45.5%,50m
13044,2,泽拉图的小嘴,2799,152,5,11,16,31.2%,43m
13044,2,佳静,2799,0,4,2,6,66.7%,22m
13044,3,PartinG,2799,86,4,5,9,44.4%,22m
13044,3,[黑粉头子]国产大长腿,2799,133,3,1,4,75.0%,27m
13044,1,yhy,2799,96,3,3,6,50.0%,1h
13044,2,纯粹时间,2799,90,2,2,4,50.0%,1h
13044,3,摸鱼天王稀神探女,2799,0,1,1,2,50.0%,26m
13044,1,[绅士]jiey,2799,95,1,3,4,25.0%,1h
13044,3,Pego,2799,0,0,1,1,0.0%,28m
13044,3,[月夜贵族]小妖显灵,2799,0,0,1,1,0.0%,28m
13044,3,Ricardo,2799,0,0,1,1,0.0%,46m
13044,2,Down,2799,0,0,2,2,0.0%,1h
13044,3,Nagisa,2799,0,0,3,3,0.0%,6m
13044,1,emmm,2799,0,0,3,3,0.0%,1h
13070,1,猎空,2798,1587,246,224,470,52.3%,43m
13070,1,Mercury,2798,1205,194,191,385,50.4%,19m
13070,1,Arestronger,2798,564,112,119,231,48.5%,11m
13070,2,[嘤嘤嘤啊]Face,2798,1153,98,86,184,53.3%,22m
13070,2,芹泽多摩雄,2798,1060,62,59,121,51.2%,3m
13070,1,CHAOS,2798,1235,50,52,102,49.0%,11m
13070,3,[哲学研究谐会]sosaria,2798,718,27,25,52,51.9%,4m
13070,1,断章,2798,387,12,16,28,42.9%,28m
13070,1,Peteryuo,2798,270,9,13,22,40.9%,11m
13070,2,万家灯火,2798,0,4,1,5,80.0%,58m
13070,2,菜鸟,2798,115,4,4,8,50.0%,1h
13070,3,回呀嘛回首掏,2798,88,3,4,7,42.9%,6m
13070,3,白给人皇,2798,97,2,4,6,33.3%,23m
13070,2,花言侨瑜,2798,0,1,2,3,33.3%,7m
13070,3,[天羽不榖]忧郁的二哈,2798,30,1,3,4,25.0%,4m
13070,3,[西部狼群]不上钻石不改名,2798,0,0,1,1,0.0%,6m
13070,3,[西装暴徒]IIIIIIIII,2798,0,0,1,1,0.0%,21m
13070,3,你歧视台式电脑吗,2798,0,0,1,1,0.0%,10m
13070,3,[优秀班级]请叫我灬淼大大,2798,0,0,3,3,0.0%,6m
13089,2,小时候凶的很,2797,1335,90,68,158,57.0%,49m
13089,3,zhanhuoys,2797,950,57,42,99,57.6%,22m
13089,3,顾翊庭,2797,512,23,13,36,63.9%,6m
13089,3,喻奕扬,2797,270,16,8,24,66.7%,17m
13089,2,Wystan,2797,319,16,18,34,47.1%,15m
13089,3,Creater,2797,335,14,15,29,48.3%,23m
13089,3,[蒸汽姬海老名]时间神玩,2797,324,11,10,21,52.4%,22m
13089,1,Monika,2797,234,7,7,14,50.0%,10m
13089,3,[谐星联盟XY]善良,2797,145,6,2,8,75.0%,22m
13089,3,[gusl]AlphaStar,2797,168,5,2,7,71.4%,3m
13089,3,[魔法少女小屋]ARTORIA,2797,88,4,2,6,66.7%,22m
13089,3,marsrat,2797,122,4,5,9,44.4%,14m
13089,2,[薄暮之光]卡卡殷墟,2797,114,4,9,13,30.8%,46m
13089,1,Huebeck,2797,100,3,17,20,15.0%,27m
13089,2,农场拖拉机,2797,0,2,1,3,66.7%,39m
13089,3,[最菜战队]我好菜我想变强,2797,58,2,3,5,40.0%,21m
13089,2,[Etern谐]Neil,2797,0,1,5,6,16.7%,1h
13089,3,[TNLtr]IIIIIIIIIIII,2797,0,0,1,1,0.0%,28m
13089,3,孤独巡礼,2797,0,0,3,3,0.0%,27m
13108,3,MellowVoid,2796,1567,76,73,149,51.0%,19m
13108,3,浅拂霜,2796,1480,65,47,112,58.0%,26m
13108,3,弦冥,2796,432,24,19,43,55.8%,22m
13108,2,cescmessi,2796,463,20,21,41,48.8%,21m
13108,3,星际蔡徐坤,2796,465,18,17,35,51.4%,22m
13108,3,[智乃超可爱w]圆桌的鬼神,2796,438,17,14,31,54.8%,27m
13108,3,[C91394]AKPL,2796,257,17,17,34,50.0%,27m
13108,3,ZGY,2796,317,13,15,28,46.4%,14m
13108,3,丢丢鱼,2796,281,12,7,19,63.2%,18m
13108,3,[北斗剑神]战风炎,2796,192,8,7,15,53.3%,22m
13108,3,air,2796,116,7,3,10,70.0%,6m
13108,2,[Holydr]淡定不纠结,2796,248,7,8,15,46.7%,2m
13108,2,蛋蛋的忧伤,2796,220,7,9,16,43.8%,2m
13108,3,tenevil,2796,146,6,4,10,60.0%,48m
13108,3,ZwZ,2796,116,5,5,10,50.0%,26m
13108,1,Gin,2796,0,3,4,7,42.9%,42m
13108,3,随缘箭送有缘人,2796,58,3,4,7,42.9%,18m
13108,3,我不光是个机枪兵,2796,30,2,1,3,66.7%,6m
13108,2,SUNBOY,2796,39,2,1,3,66.7%,29m
13108,3,[四斋蒸蚝片]Skyriver,2796,14,2,3,5,40.0%,17m
13108,3,[火焰雷兽]梦魇灬华尔兹,2796,60,2,6,8,25.0%,17m
13108,3,IIIIIIIIIII,2796,0,1,3,4,25.0%,27m
13130,3,绝望,2795,1065,49,47,96,51.0%,47m
13130,3,子乔,2795,677,29,19,48,60.4%,25m
13130,3,一只橙子,2795,307,10,11,21,47.6%,3m
13130,2,小紫英,2795,158,5,4,9,55.6%,1h
13130,2,被宇哥泡,2795,0,4,1,5,80.0%,1h
13130,3,[莽狗偷]brokenheart,2795,88,4,2,6,66.7%,12m
13130,3,火华华,2795,116,4,5,9,44.4%,17m
13130,3,[冲就完了]卧枕盼星还,2795,58,3,3,6,50.0%,25m
13130,2,贾一乐,2795,103,2,2,4,50.0%,56m
13130,3,[LSBZZ]一叶知秋,2795,97,2,3,5,40.0%,6m
13130,3,[二次元同好会]皮卡丘,2795,0,1,0,1,100.0%,25m
13130,3,[永恒的救济]blackhole,2795,30,1,1,2,50.0%,22m
13130,3,Immortals,2795,97,1,3,4,25.0%,28m
13130,3,Rage,2795,0,0,1,1,0.0%,12m
13130,3,infinity,2795,0,0,1,1,0.0%,27m
13130,2,spj,2795,0,0,1,1,0.0%,1h
13130,3,MisrLing,2795,0,0,2,2,0.0%,48m
13130,1,叫哥凌大爷,2795,0,0,3,3,0.0%,5m
13148,3,asfbesrdf,2794,1555,330,325,655,50.4%,21m
13148,2,夜靥,2794,1581,217,210,427,50.8%,21m
13148,1,Iraleen,2794,1026,64,69,133,48.1%,23m
13148,3,一人国王,2794,243,17,12,29,58.6%,6m
13148,2,[文韬武略]新兵伦伦,2794,278,14,14,28,50.0%,7m
13148,3,呵呵,2794,309,13,6,19,68.4%,47m
13148,2,Sean,2794,319,12,16,28,42.9%,6m
13148,2,[LOHs]晓婷,2794,258,11,8,19,57.9%,6m
13148,2,欣欣,2794,221,7,11,18,38.9%,6m
13148,3,ZeroWindBlow,2794,166,6,5,11,54.5%,28m
13148,1,阳菜,2794,97,4,4,8,50.0%,1h
13148,3,[765事务所]望月杏奈,2794,120,4,7,11,36.4%,6m
13148,2,一念起江山万里,2794,0,3,2,5,60.0%,1h
13148,1,flymetomoon,2794,119,3,2,5,60.0%,1h
13148,1,[兄贵会]淑怡,2794,138,3,7,10,30.0%,28m
13148,3,刘玄德之考验,2794,0,1,0,1,100.0%,26m
13148,1,[兆景埋土大学]Toby,2794,0,1,1,2,50.0%,6m
13148,2,舰姬,2794,0,1,1,2,50.0%,1h
13148,2,没有人,2794,96,1,1,2,50.0%,1h
13148,1,[星际小盆友]Players,2794,0,1,2,3,33.3%,13m
13148,3,爱吃麻辣香锅,2794,30,1,5,6,16.7%,28m
13148,3,ATM,2794,0,0,1,1,0.0%,23m
13148,2,赫鲁晓狐,2794,0,0,6,6,0.0%,21m
13171,2,赵鉴,2793,1531,189,166,355,53.2%,4m
13171,3,拟态雏虫,2793,737,28,22,50,56.0%,23m
13171,3,叫你还调皮,2793,226,17,7,24,70.8%,6m
13171,3,[落魄山]TrickyZerg,2793,301,12,5,17,70.6%,36m
13171,3,[沙漠天团]差不多先生,2793,317,11,9,20,55.0%,3m
13171,3,[wean]阿拉纳克,2793,154,6,3,9,66.7%,22m
13171,3,[XXHZN2]斯巴达奎爷,2793,135,4,0,4,100.0%,6m
13171,2,[呆萌小萝莉]白面,2793,155,4,3,7,57.1%,1h
13171,1,宇宇宇,2793,48,4,5,9,44.4%,10m
13171,3,[龙之队]Inferno,2793,129,3,2,5,60.0%,48m
13171,3,一般通过的车车人,2793,92,3,3,6,50.0%,24m
13171,1,平静少年,2793,0,3,4,7,42.9%,1h
13171,3,[ALSN]IIIIIIIlIIlI,2793,86,3,7,10,30.0%,18m
13171,3,[冥界有顶天]盖瑞金,2793,30,2,2,4,50.0%,3m
13171,2,[你看着办]李牧,2793,95,2,3,5,40.0%,21m
13171,3,Darkness,2793,0,1,0,1,100.0%,13m
13171,3,[快活林]谈笑风生,2793,0,1,0,1,100.0%,27m
13171,3,都别给我墨迹,2793,30,1,1,2,50.0%,27m
13171,3,[ACG系]Sentry,2793,30,1,1,2,50.0%,17m
13171,2,[大洋彼岸团队]Giotto,2793,0,1,1,2,50.0%,1h
13171,2,山东郭奉孝,2793,0,0,1,1,0.0%,12m
13192,2,星星,2792,1454,202,189,391,51.7%,2m
13192,3,Rosmontis,2792,1581,90,64,154,58.4%,5m
13192,2,剧情看一看,2792,702,66,53,119,55.5%,47m
13192,3,小玲吃西瓜,2792,588,27,16,43,62.8%,24m
13192,2,寄遇梦与蔷薇,2792,591,27,23,50,54.0%,21m
13192,3,羽幕丶,2792,471,19,8,27,70.4%,23m
13192,3,SpoKe,2792,267,15,9,24,62.5%,22m
13192,3,[狼牙盟]Qgoodboy,2792,172,6,7,13,46.2%,10m
13192,1,[失智博士]Shelter,2792,36,4,4,8,50.0%,1h
13192,2,[白嫖党]烈焰,2792,90,4,8,12,33.3%,8m
13192,3,风往的街角,2792,118,3,0,3,100.0%,3m
13192,3,Trap,2792,120,3,0,3,100.0%,19m
13192,3,[小花]桑墨丶柳月,2792,97,2,3,5,40.0%,7m
13192,2,[褚烨协会]soaringzhou,2792,0,2,4,6,33.3%,3m
13192,3,[灌灌灌灌0]darkbreak,2792,0,1,0,1,100.0%,6m
13192,1,loveqrz,2792,42,1,4,5,20.0%,21m
13192,3,SuperRailgun,2792,40,1,6,7,14.3%,1h
13192,3,PassionForU,2792,0,0,1,1,0.0%,14m
13192,3,伈伈伈伈伈,2792,0,0,1,1,0.0%,21m
13192,3,chenshuaimin,2792,0,0,1,1,0.0%,15m
13192,3,卩灬殇飞云丶,2792,0,0,1,1,0.0%,5m
13192,3,[我高贵的族人]ChinaBishop,2792,0,0,2,2,0.0%,6m
13214,2,WRNG,2791,1263,56,47,103,54.4%,45m
13214,2,[大元师]SDALIUBGSDBA,2791,1047,55,47,102,53.9%,13m
13214,2,llllIIIlllI,2791,1090,41,45,86,47.7%,46m
13214,2,[菜有菜的道理]Ilyich,2791,800,39,45,84,46.4%,45m
13214,3,大神,2791,627,25,23,48,52.1%,25m
13214,3,[WILLE]玫琳凯先生,2791,385,17,10,27,63.0%,24m
13214,1,IIIllIIllllI,2791,254,8,4,12,66.7%,1h
13214,3,白狼,2791,254,8,6,14,57.1%,10m
13214,2,[斗鱼大纲]英雄,2791,0,4,1,5,80.0%,45m
13214,3,西湖雅座有请,2791,90,4,4,8,50.0%,17m
13214,2,[CPT]大冲撞,2791,44,1,1,2,50.0%,1h
13214,3,天下最白,2791,91,1,2,3,33.3%,28m
13214,2,苍老湿御用,2791,30,1,9,10,10.0%,27m
13214,2,[万X奔腾]侯蹦蹦,2791,0,0,1,1,0.0%,45m
13214,1,赤色幽灵,2791,0,0,3,3,0.0%,15m
13229,2,王厂长,2790,1573,593,588,1181,50.2%,9m
13229,2,虫族真滴太阴间了,2790,1430,103,95,198,52.0%,9m
13229,3,conman,2790,1441,96,86,182,52.7%,13m
13229,3,[SmartX]将军,2790,1566,70,57,127,55.1%,21m
13229,2,如若梦似彩虹,2790,631,26,21,47,55.3%,49m
13229,3,llllllllllll,2790,506,20,10,30,66.7%,47m
13229,2,flag,2790,373,18,20,38,47.4%,21m
13229,3,venus,2790,229,10,8,18,55.6%,28m
13229,3,[丨虫族灬战队]夜深,2790,196,7,4,11,63.6%,15m
13229,1,幼麒,2790,165,3,4,7,42.9%,20m
13229,3,kingmark,2790,30,2,2,4,50.0%,28m
13229,1,大脑在颤抖,2790,144,2,3,5,40.0%,15m
13229,2,天涯雪静,2790,112,2,4,6,33.3%,1h
13229,3,午时怎么还没到啊,2790,0,1,0,1,100.0%,5m
13229,3,IIIIIIIIIIII,2790,30,1,2,3,33.3%,25m
13229,3,不是假发是桂,2790,30,1,3,4,25.0%,46m
13229,3,梅川内酷,2790,0,0,1,1,0.0%,46m
13229,3,[Ggame]红色闪电,2790,0,0,1,1,0.0%,6m
13229,3,日月天,2790,0,0,1,1,0.0%,27m
13229,3,Kevin,2790,0,0,2,2,0.0%,23m
13229,1,只爱小溪,2790,0,0,2,2,0.0%,1h
13250,2,allover,2789,1482,259,233,492,52.6%,5m
13250,2,joe,2789,1590,212,210,422,50.2%,47m
13250,2,姬川优耐,2789,1455,90,92,182,49.5%,11m
13250,3,狂人君,2789,743,48,47,95,50.5%,6m
13250,1,[白银联盟]NoahsArk,2789,341,38,41,79,48.1%,9m
13250,3,里昂,2789,559,34,28,62,54.8%,21m
13250,1,冲进白宫,2789,613,24,29,53,45.3%,8m
13250,3,llllllllllll,2789,584,23,18,41,56.1%,18m
13250,2,[社交学超可爱]我也找不着,2789,219,9,8,17,52.9%,2m
13250,3,IIIIIIIIIIII,2789,192,7,7,14,50.0%,47m
13250,2,HeiTaoGG,2789,180,7,11,18,38.9%,20m
13250,2,LANX,2789,176,6,12,18,33.3%,25m
13250,3,zzzbbbwww,2789,122,5,5,10,50.0%,47m
13250,2,[达拉姆卫队]龙澪音,2789,0,3,3,6,50.0%,55m
13250,2,我戴着黄色眼镜,2789,91,3,3,6,50.0%,25m
13250,2,小小的鱼虫,2789,94,2,0,2,100.0%,39m
13250,2,名哥,2789,109,2,1,3,66.7%,1h
13250,3,[快乐就完事儿]Louisia,2789,30,2,3,5,40.0%,27m
13250,3,ParkmanH,2789,0,0,1,1,0.0%,10m
13250,3,死囚漫步,2789,0,0,2,2,0.0%,28m
13270,2,[玫瑰十字会]沙漠风暴战神,2788,1612,376,362,738,50.9%,45m
13270,3,地主老豺,2788,1307,164,159,323,50.8%,6m
13270,2,变色龙,2788,1252,149,133,282,52.8%,5m
13270,3,[琴筝]legend,2788,1580,143,115,258,55.4%,5m
13270,2,你们这是自寻死路,2788,1217,109,92,201,54.2%,21m
13270,2,赟丨健,2788,1192,58,62,120,48.3%,5m
13270,2,IIIIIIIIII,2788,1318,49,52,101,48.5%,46m
13270,1,Djcj,2788,1116,43,42,85,50.6%,10m
13270,1,[MQ双狗]汤元度,2788,456,17,20,37,45.9%,8m
13270,2,黑命贵于白命,2788,442,16,17,33,48.5%,3m
13270,3,IIIIIIIIIIII,2788,365,14,8,22,63.6%,23m
13270,3,naxx,2788,314,13,12,25,52.0%,27m
13270,3,自由之翼,2788,240,8,4,12,66.7%,21m
13270,3,[艾尔之巅]唐糖塘溏瑭,2788,159,6,1,7,85.7%,18m
13270,3,[不想打内战]Nerazim,2788,166,6,8,14,42.9%,47m
13270,3,临渊羡鱼,2788,167,5,2,7,71.4%,6m
13270,3,城市化就输不了,2788,120,5,4,9,55.6%,3m
13270,2,[QMECC]KingPower,2788,0,3,1,4,75.0%,45m
13270,3,[Kuhaku]sky,2788,119,2,1,3,66.7%,1h
13270,3,菜鸟,2788,58,2,3,5,40.0%,13m
13270,3,PyPi,2788,0,2,3,5,40.0%,14m
13270,3,HammeR,2788,0,1,0,1,100.0%,21m
13270,2,saywon,2788,0,1,0,1,100.0%,39m
13270,3,[哔哩哔哩杯乾]biubiubiu,2788,0,1,1,2,50.0%,46m
13270,3,泡泡小纯,2788,30,1,2,3,33.3%,15m
13270,3,逆流成海,2788,0,0,1,1,0.0%,22m
13270,3,菜鸡万岁,2788,0,0,2,2,0.0%,15m
13297,2,萌妹,2787,818,93,88,181,51.4%,22m
13297,2,[不是天生要强]蓦然,2787,721,29,31,60,48.3%,21m
13297,2,hsh,2787,203,11,17,28,39.3%,21m
13297,1,逗比南波万,2787,231,10,5,15,66.7%,10m
13297,3,shine,2787,238,9,9,18,50.0%,26m
13297,3,IIIIIIIIIIII,2787,245,8,5,13,61.5%,17m
13297,3,[HEPs]Crescent,2787,164,5,3,8,62.5%,26m
13297,2,守望,2787,200,5,10,15,33.3%,24m
13297,3,Ama,2787,97,4,5,9,44.4%,7m
13297,2,星际萌新,2787,96,3,1,4,75.0%,36m
13297,2,Archermiao,2787,0,3,2,5,60.0%,46m
13297,3,[TG天罡]Shane,2787,30,2,1,3,66.7%,13m
13297,3,平安时代的黑云,2787,93,2,1,3,66.7%,6m
13297,3,qycqmber,2787,0,0,1,1,0.0%,23m
13297,3,凉城旧梦,2787,0,0,1,1,0.0%,19m
13312,3,[WGboys]XerathEan,2786,685,55,13,68,80.9%,10m
13312,3,[秋毫七队]抹茶雪域,2786,733,33,20,53,62.3%,3m
13312,3,浪客,2786,702,28,21,49,57.1%,14m
13312,3,[闲散人员]blznmsl,2786,588,24,18,42,57.1%,14m
13312,2,长安,2786,437,24,26,50,48.0%,21m
13312,1,[KOJIMA]lacusclyne,2786,516,21,25,46,45.7%,20m
13312,2,大梦初醒,2786,558,19,25,44,43.2%,16m
13312,3,Marine,2786,419,18,16,34,52.9%,21m
13312,3,[单推拉普兰德]reachel,2786,378,14,13,27,51.9%,22m
13312,3,诺亚,2786,339,12,9,21,57.1%,23m
13312,3,[Nin]qbq,2786,300,11,6,17,64.7%,14m
13312,3,他失散多年的亲爹,2786,254,10,10,20,50.0%,28m
13312,2,小小猪,2786,243,10,10,20,50.0%,6m
13312,3,Boomer,2786,215,9,8,17,52.9%,1h
13312,3,狗熊警官,2786,260,9,10,19,47.4%,10m
13312,2,[我高贵的族人]般若香蕉,2786,0,4,2,6,66.7%,1h
13312,2,黄宇峰,2786,0,4,5,9,44.4%,1h
13312,3,[孙換家]我爱小诗诗,2786,178,4,8,12,33.3%,3m
13312,1,Icewine,2786,118,3,0,3,100.0%,42m
13312,2,心殇,2786,0,3,3,6,50.0%,1h
13312,3,来自火星的天才,2786,153,3,5,8,37.5%,57m
13312,3,[滴滴打人集团]天外飞剑,2786,30,2,2,4,50.0%,18m
13312,3,[我高贵的族人]霸气乐怀冉,2786,0,0,1,1,0.0%,16m
13312,3,机油佬,2786,0,0,1,1,0.0%,21m
13312,3,温故知新,2786,0,0,2,2,0.0%,26m
13337,3,[艾尔之主]树叶,2785,1645,108,113,221,48.9%,17m
13337,2,[疯月]亡灵灬序曲,2785,885,76,71,147,51.7%,43m
13337,2,笑尽英雄图一天,2785,452,37,27,64,57.8%,8m
13337,3,大鼻子情敌,2785,580,29,21,50,58.0%,27m
13337,3,矢量,2785,565,27,11,38,71.1%,6m
13337,2,[GEM]弑殇的回忆,2785,532,22,21,43,51.2%,5m
13337,3,[Esc]不和同族玩,2785,501,17,23,40,42.5%,26m
13337,3,[HxD]Seldom,2785,220,8,7,15,53.3%,25m
13337,2,天才小然呆,2785,192,7,12,19,36.8%,3m
13337,3,[谐星x]笔下生花,2785,168,6,0,6,100.0%,25m
13337,3,[TJMU]MAGIC,2785,190,5,4,9,55.6%,17m
13337,3,[华文中学]ASDUH,2785,120,5,5,10,50.0%,47m
13337,3,李王,2785,146,5,8,13,38.5%,23m
13337,3,[裤裆藏牛]Carica,2785,90,4,6,10,40.0%,24m
13337,1,[DSE]黑暗中的骑士,2785,0,3,4,7,42.9%,1h
13337,1,wuid,2785,0,1,1,2,50.0%,1h
13337,3,桐原亮司,2785,30,1,3,4,25.0%,47m
13337,3,[温柔兔公主]淡水鳗鱼,2785,0,1,3,4,25.0%,43m
13337,3,[旭日之心]snoW,2785,0,0,1,1,0.0%,7m
13337,2,风神,2785,0,0,1,1,0.0%,1h
13337,3,HERRINGTON,2785,0,0,1,1,0.0%,5m
13337,3,带你个十娘,2785,0,0,2,2,0.0%,27m
13337,3,chage,2785,0,0,2,2,0.0%,6m
13337,3,[我队伍很强大]正在找撤硕的波波,2785,0,0,3,3,0.0%,46m
13361,3,Aztec,2784,788,79,80,159,49.7%,6m
13361,3,Keyl,2784,382,41,35,76,53.9%,26m
13361,2,烈阳天心,2784,291,10,11,21,47.6%,35m
13361,3,[Hooray]FoMIMo,2784,244,8,12,20,40.0%,14m
13361,1,缀星海,2784,96,6,6,12,50.0%,34m
13361,3,IIIIIIIIIIII,2784,144,6,7,13,46.2%,22m
13361,3,佳宁,2784,60,3,1,4,75.0%,13m
13361,2,我很菜,2784,0,3,3,6,50.0%,1h
13361,3,[最菜战队]我最菜,2784,30,2,0,2,100.0%,23m
13361,3,土豆受害者,2784,50,2,4,6,33.3%,22m
13361,2,[败给小队]莓办法,2784,92,1,3,4,25.0%,1h
13361,3,自由之翼,2784,0,0,1,1,0.0%,49m
13373,1,[HUC不凡]孜孜汲汲,2783,1447,130,124,254,51.2%,43m
13373,2,毛哥无敌,2783,1134,108,108,216,50.0%,22m
13373,2,[XTE]Linux,2783,1496,85,70,155,54.8%,9m
13373,3,[zxtgt]holmes,2783,584,22,23,45,48.9%,27m
13373,3,YoRHa,2783,264,14,0,14,100.0%,21m
13373,2,CyanLeaves,2783,223,10,12,22,45.5%,13m
13373,3,IIIIIIIIIIII,2783,248,9,3,12,75.0%,3m
13373,2,我们需要支援,2783,114,4,4,8,50.0%,1h
13373,2,空山飞雪,2783,0,3,3,6,50.0%,36m
13373,2,舞龙巨蟹,2783,102,3,6,9,33.3%,8m
13373,3,纵横天下,2783,91,2,0,2,100.0%,6m
13373,3,陆游器,2783,30,2,0,2,100.0%,14m
13373,3,[刀锋男皇]以德服人,2783,30,2,4,6,33.3%,22m
13373,3,[日新月异]滴水成冰地,2783,0,1,0,1,100.0%,28m
13373,3,revolution,2783,30,1,1,2,50.0%,46m
13373,3,成实,2783,0,0,1,1,0.0%,14m
13373,3,念雨尘封,2783,0,0,1,1,0.0%,22m
13373,3,说好的宗师呢,2783,0,0,2,2,0.0%,14m
13391,3,雷米阿萨德,2782,1134,161,140,301,53.5%,23m
13391,3,小菜鸟,2782,540,54,42,96,56.2%,19m
13391,2,kzy,2782,173,39,45,84,46.4%,8m
13391,3,一个胖子,2782,961,38,42,80,47.5%,2m
13391,2,FrankSoap,2782,912,36,39,75,48.0%,48m
13391,1,child,2782,735,30,32,62,48.4%,43m
13391,3,冰川双子催婚协会,2782,305,29,25,54,53.7%,21m
13391,2,everyone,2782,455,20,15,35,57.1%,45m
13391,3,Hades,2782,246,12,11,23,52.2%,21m
13391,3,artificial,2782,267,10,6,16,62.5%,6m
13391,1,SarahDD,2782,213,7,13,20,35.0%,27m
13391,2,[惠乃果厨]Rebam,2782,155,6,4,10,60.0%,1h
13391,3,[你的瓦斯不足]吾神矣,2782,147,4,2,6,66.7%,22m
13391,3,龙族,2782,98,4,11,15,26.7%,21m
13391,3,[大威天龙oc]闲卿,2782,58,3,2,5,60.0%,46m
13391,2,miaomiao,2782,95,3,3,6,50.0%,8m
13391,3,夜未央丨,2782,0,2,0,2,100.0%,1h
13391,3,Meanwcharon,2782,58,2,2,4,50.0%,47m
13391,3,[枪兵营]小少爷,2782,30,1,6,7,14.3%,24m
13391,3,暗逸,2782,0,0,1,1,0.0%,7m
13391,3,LCYSAWP,2782,0,0,1,1,0.0%,24m
13391,2,dagege,2782,0,0,1,1,0.0%,1h
13413,3,RedMoon,2781,625,34,25,59,57.6%,28m
13413,3,KING,2781,306,33,17,50,66.0%,27m
13413,3,我要上三千分,2781,499,22,11,33,66.7%,18m
13413,3,怪谈,2781,365,15,7,22,68.2%,15m
13413,2,TERRANS,2781,188,9,9,18,50.0%,46m
13413,3,MarK,2781,258,9,11,20,45.0%,49m
13413,3,欧帅帅,2781,254,8,6,14,57.1%,5m
13413,2,[ZJU]dEvil,2781,137,4,4,8,50.0%,14m
13413,3,壮士请先杀队友,2781,157,4,4,8,50.0%,21m
13413,1,GyBady,2781,0,3,4,7,42.9%,47m
13413,3,[黑骑]心向一,2781,30,2,2,4,50.0%,10m
13413,3,虚无之影,2781,0,2,3,5,40.0%,1h
13413,3,Deanyan,2781,0,2,3,5,40.0%,6m
13413,3,冥府夜宗,2781,0,1,0,1,100.0%,3m
13413,3,[命运黑夜]jssa,2781,0,1,0,1,100.0%,6m
13413,3,[miku守护]宁陌笙,2781,0,0,1,1,0.0%,14m
13413,1,众人的爸爸,2781,0,0,1,1,0.0%,1h
13413,3,sgc,2781,0,0,2,2,0.0%,26m
13413,3,两只小蜜蜂,2781,0,0,4,4,0.0%,33m
13432,3,守望黎明,2780,1657,156,146,302,51.7%,13m
13432,3,Yeezsue,2780,1392,146,122,268,54.5%,14m
13432,3,血战,2780,1558,97,83,180,53.9%,7m
13432,1,[远征舰队]中华远征军,2780,414,89,77,166,53.6%,28m
13432,3,我有一根通天大雕,2780,639,30,18,48,62.5%,3m
13432,3,泪落在梦中,2780,439,16,13,29,55.2%,6m
13432,2,骑着猪儿看月亮,2780,315,14,10,24,58.3%,33m
13432,3,疾风帅无止境,2780,359,12,10,22,54.5%,19m
13432,3,颅骨,2780,222,9,2,11,81.8%,44m
13432,3,[所向无前]嘤嘤嘤,2780,172,9,6,15,60.0%,1h
13432,1,[诺娃的隐身衣]lwl,2780,203,7,6,13,53.8%,48m
13432,2,fountainhead,2780,146,6,10,16,37.5%,47m
13432,1,Yamimomo,2780,97,5,3,8,62.5%,10m
13432,3,巫山不是云,2780,0,4,1,5,80.0%,3m
13432,3,[BOOMER]llllllllllll,2780,90,3,6,9,33.3%,6m
13432,2,香飘飘,2780,88,2,0,2,100.0%,1h
13432,1,yaliu,2780,0,1,0,1,100.0%,30m
13432,2,常被绿,2780,96,1,1,2,50.0%,37m
13432,1,流云,2780,0,1,3,4,25.0%,1h
13432,3,[闪耀DucK]skytop,2780,0,0,1,1,0.0%,24m
13432,3,Angle,2780,0,0,1,1,0.0%,49m
13432,1,德国战车,2780,0,0,1,1,0.0%,17m
13432,3,枫叶归途,2780,0,0,1,1,0.0%,6m
13432,1,吃鱼的猫,2780,0,0,1,1,0.0%,10m
13432,3,[琴筝]hope,2780,0,0,1,1,0.0%,13m
13432,2,[醫生姐姐來了]xzhxzh,2780,0,0,1,1,0.0%,24m
13432,3,[老6]IIIIIIIIIIII,2780,0,0,2,2,0.0%,22m
13432,3,在半路,2780,0,0,2,2,0.0%,6m
13432,3,天空,2780,0,0,3,3,0.0%,48m
13461,1,AKQ,2779,1507,170,165,335,50.7%,11m
13461,2,TYC,2779,363,82,87,169,48.5%,13m
13461,3,yuansir,2779,654,69,61,130,53.1%,21m
13461,3,坎沃德基尔邦英,2779,1366,56,53,109,51.4%,24m
13461,2,李狗蛋,2779,907,55,52,107,51.4%,49m
13461,2,承影,2779,931,55,56,111,49.5%,49m
13461,3,TheBestMan,2779,347,48,29,77,62.3%,15m
13461,3,ftwoA,2779,558,26,20,46,56.5%,23m
13461,2,[HUC不凡]yosang,2779,356,14,12,26,53.8%,24m
13461,3,[18th]一场凉水,2779,267,12,7,19,63.2%,1h
13461,1,[TSU]Suzutsuki,2779,279,12,12,24,50.0%,4m
13461,3,鹿目圆,2779,242,8,4,12,66.7%,10m
13461,1,KURIMU,2779,189,7,6,13,53.8%,23m
13461,2,[谁欠谁的幸福]廖家豪,2779,92,3,3,6,50.0%,1h
13461,2,[BOOMER]Iatewilly,2779,113,3,3,6,50.0%,1h
13461,3,天剑,2779,129,3,4,7,42.9%,60m
13461,3,神圣荣耀,2779,95,2,0,2,100.0%,15m
13461,3,[RGFC]nanana,2779,30,2,1,3,66.7%,47m
13461,3,YGY,2779,0,1,0,1,100.0%,6m
13461,3,roboxml,2779,30,1,4,5,20.0%,14m
13461,3,GluTTony,2779,0,0,3,3,0.0%,6m
13482,3,Klmzion,2778,1497,433,428,861,50.3%,28m
13482,3,bat,2778,908,39,29,68,57.4%,26m
13482,3,教父,2778,837,35,26,61,57.4%,10m
13482,3,云上飘丶,2778,910,33,36,69,47.8%,27m
13482,3,江汉吴彦祖,2778,595,23,21,44,52.3%,21m
13482,3,[XCL]鎶的傳説,2778,417,21,12,33,63.6%,18m
13482,2,[星际最强亡者]萌新,2778,578,21,28,49,42.9%,48m
13482,3,[萝莉之芯]lili,2778,412,16,12,28,57.1%,23m
13482,2,KKKomyo,2778,436,15,20,35,42.9%,20m
13482,3,[灵轩阁]上官轩宇,2778,264,9,10,19,47.4%,26m
13482,3,DarkDevil,2778,166,8,12,20,40.0%,22m
13482,2,[二次元bis]冬马和纱天下第一,2778,97,4,2,6,66.7%,25m
13482,3,绘崎可乐助,2778,118,4,4,8,50.0%,22m
13482,2,醉清风,2778,0,3,3,6,50.0%,1h
13482,3,罗杰船长,2778,93,2,0,2,100.0%,10m
13482,3,[一起犯罪]强盗,2778,58,2,3,5,40.0%,16m
13482,3,六十八柱贝利亚尔,2778,0,2,3,5,40.0%,59m
13482,1,无间,2778,0,1,0,1,100.0%,30m
13482,3,Lasting,2778,0,1,0,1,100.0%,47m
13482,3,yanshi,2778,30,1,4,5,20.0%,6m
13482,2,STY,2778,0,0,1,1,0.0%,46m
13482,3,今晚打灰机,2778,0,0,1,1,0.0%,27m
13482,3,软玉温香,2778,0,0,2,2,0.0%,28m
13482,2,iiiiiiii,2778,0,0,2,2,0.0%,1h
13506,1,Fin,2777,1190,72,78,150,48.0%,43m
13506,3,zzlhb,2777,720,52,46,98,53.1%,48m
13506,1,[lxh123]alleria,2777,1248,44,55,99,44.4%,29m
13506,2,JuckFeff,2777,488,32,25,57,56.1%,25m
13506,3,破坏神,2777,380,15,11,26,57.7%,14m
13506,3,[歌者II]寒夜易冷,2777,219,9,7,16,56.2%,28m
13506,3,Freeze,2777,162,8,5,13,61.5%,6m
13506,2,炮灰甲,2777,215,6,8,14,42.9%,21m
13506,2,忘川,2777,182,5,8,13,38.5%,12m
13506,3,Rocky,2777,90,4,5,9,44.4%,16m
13506,3,[萌新玩星际]星之公爵,2777,133,3,2,5,60.0%,27m
13506,2,何必呢,2777,0,3,2,5,60.0%,1h
13506,3,神阿德斯,2777,60,3,5,8,37.5%,28m
13506,3,惟吾德馨,2777,30,2,1,3,66.7%,6m
13506,3,朝花夕拾,2777,0,1,0,1,100.0%,1h
13506,3,贝塔,2777,0,1,2,3,33.3%,5m
13506,3,hyponstic,2777,0,0,1,1,0.0%,19m
13506,2,Python,2777,0,0,2,2,0.0%,1h
13524,2,[ACG系]TheGrist,2776,1342,67,53,120,55.8%,28m
13524,3,冰糖心三元一斤,2776,860,65,48,113,57.5%,47m
13524,2,彩笔,2776,1212,48,46,94,51.1%,11m
13524,3,[艾尔之名]盘螭,2776,521,39,26,65,60.0%,28m
13524,3,[喵呜喵呜]瞧本,2776,811,36,25,61,59.0%,12m
13524,3,哪里的跑,2776,427,21,16,37,56.8%,12m
13524,3,二流演员是也,2776,508,21,17,38,55.3%,18m
13524,3,嘲讽自嘲,2776,458,20,10,30,66.7%,15m
13524,2,鸡谐化就输不了,2776,384,13,16,29,44.8%,7m
13524,3,Specter,2776,213,6,11,17,35.3%,27m
13524,2,夜自昼来,2776,0,3,3,6,50.0%,1h
13524,1,那情咱卟懂,2776,0,3,4,7,42.9%,1h
13524,3,[凉了]水天,2776,94,2,0,2,100.0%,46m
13524,3,[PGR]李铱,2776,58,2,3,5,40.0%,15m
13524,3,Eon,2776,30,2,3,5,40.0%,10m
13524,1,临风,2776,0,1,0,1,100.0%,42m
13524,1,[HLR]界龙,2776,0,0,1,1,0.0%,36m
13524,3,舞法天女黄旭东,2776,0,0,2,2,0.0%,17m
13524,3,雪域,2776,0,0,2,2,0.0%,10m
13524,3,[开心战队]白给之王,2776,0,0,3,3,0.0%,12m
13544,3,[LOHv]艾尔,2775,1613,424,416,840,50.5%,29m
13544,2,[GNMS]小郎君,2775,1577,257,250,507,50.7%,21m
13544,2,曲奇,2775,1103,105,109,214,49.1%,21m
13544,3,犹如一扶风,2775,1451,89,68,157,56.7%,49m
13544,2,TheOF,2775,1391,54,56,110,49.1%,9m
13544,2,简单的电脑,2775,679,33,27,60,55.0%,22m
13544,2,扫清六合席卷八荒,2775,263,25,28,53,47.2%,21m
13544,3,[罗马帝国]拉莱耶公爵,2775,248,8,6,14,57.1%,17m
13544,2,专心狙击一束七,2775,274,5,31,36,13.9%,11m
13544,1,亵渎,2775,140,4,5,9,44.4%,30m
13544,1,大裤衩,2775,144,4,6,10,40.0%,1h
13544,3,aaab,2775,114,3,0,3,100.0%,7m
13544,2,[猫神]开国元勋,2775,0,3,3,6,50.0%,9m
13544,3,[地嗪专卖店]楼主,2775,30,2,1,3,66.7%,14m
13544,3,情意南确,2775,58,2,3,5,40.0%,26m
13544,2,无敌灬卡卡,2775,62,2,12,14,14.3%,16m
13544,3,[CPT]玄离,2775,0,1,0,1,100.0%,27m
13544,2,Lich,2775,0,1,0,1,100.0%,1h
13544,3,wsmznydxxzm,2775,0,1,0,1,100.0%,27m
13544,2,[艾尔高等星灵]影之梦魇,2775,0,1,0,1,100.0%,1h
13544,3,鸽帝熙离,2775,0,1,2,3,33.3%,49m
13544,3,梦蝶,2775,0,0,1,1,0.0%,22m
13544,3,屮艸芔茻,2775,0,0,1,1,0.0%,21m
13544,1,杜甫在死前,2775,0,0,7,7,0.0%,51m
13568,2,jason,2774,570,276,265,541,51.0%,29m
13568,3,[XXHZ16]SOCRATES,2774,1588,208,195,403,51.6%,27m
13568,1,IIIIIIII,2774,1535,153,153,306,50.0%,30m
13568,1,NewPlayer,2774,1410,62,67,129,48.1%,9m
13568,3,[人菜灬瘾大]tREE,2774,1305,58,36,94,61.7%,23m
13568,3,NexuS,2774,1427,57,50,107,53.3%,22m
13568,3,[我是一只机]Chaos,2774,952,51,37,88,58.0%,6m
13568,3,闪电五连鞭接化发,2774,674,42,28,70,60.0%,25m
13568,3,我再为你动情一次,2774,602,29,13,42,69.0%,46m
13568,3,KennyS,2774,483,21,16,37,56.8%,3m
13568,2,[萌的一笔]憨憨,2774,265,17,11,28,60.7%,10m
13568,3,[gost]原罪,2774,192,14,12,26,53.8%,6m
13568,1,Ahri,2774,181,7,5,12,58.3%,10m
13568,3,[Ruiko]Zangwill,2774,111,7,5,12,58.3%,46m
13568,3,星际自卫小龙,2774,30,4,6,10,40.0%,1h
13568,3,[我们都是萌新]似雨若离,2774,129,3,2,5,60.0%,7m
13568,3,足智多谋的无钱,2774,92,3,4,7,42.9%,18m
13568,3,hfchengxx,2774,60,2,3,5,40.0%,28m
13568,3,wwklk,2774,0,2,3,5,40.0%,1h
13568,3,妈个鸡泰伦,2774,0,1,0,1,100.0%,49m
13568,2,llllllllllll,2774,30,1,8,9,11.1%,20m
13589,2,日出东方,2773,1576,537,520,1057,50.8%,21m
13589,1,泰伦不攻击泰伦,2773,1196,56,63,119,47.1%,28m
13589,2,HansKatze,2773,805,42,38,80,52.5%,45m
13589,2,[察哈尔路县中]Starynight,2773,420,22,20,42,52.4%,11m
13589,3,DocxTC,2773,311,14,5,19,73.7%,26m
13589,2,kira,2773,366,11,17,28,39.3%,45m
13589,3,[魁拔联军]奇衡四,2773,281,9,8,17,52.9%,14m
13589,1,王牌指挥官三号,2773,211,8,7,15,53.3%,50m
13589,3,[致失去的岁月]lijiawei,2773,195,7,3,10,70.0%,7m
13589,3,[社交学超可爱]星际最亮的仔,2773,191,7,8,15,46.7%,23m
13589,1,天命与我,2773,185,6,2,8,75.0%,10m
13589,3,besttime,2773,194,6,4,10,60.0%,17m
13589,3,璋帝,2773,163,5,2,7,71.4%,27m
13589,1,romance,2773,48,5,3,8,62.5%,42m
13589,1,[Beastp]HNC,2773,96,3,2,5,60.0%,23m
13589,3,赫萝的黄金龙爪,2773,0,3,2,5,60.0%,6m
13589,3,鸶翎骷,2773,0,3,2,5,60.0%,47m
13589,3,红烧鲫鱼,2773,0,2,3,5,40.0%,17m
13589,3,jiab,2773,0,2,3,5,40.0%,9m
13589,2,Samsara,2773,0,1,0,1,100.0%,1h
13589,3,[滑稽联盟]Scylla,2773,30,1,4,5,20.0%,46m
13589,3,Sparrow,2773,0,0,1,1,0.0%,6m
13589,3,[F2赛高]浮生倾雨泪,2773,0,0,3,3,0.0%,28m
13612,3,adfadf,2772,1557,214,216,430,49.8%,28m
13612,3,Angelrose,2772,446,205,205,410,50.0%,44m
13612,3,Bing,2772,1015,64,61,125,51.2%,46m
13612,2,soullove,2772,1216,63,61,124,50.8%,46m
13612,3,[小土鸡]saber,2772,342,35,20,55,63.6%,26m
13612,3,[SCMIW]笔芯,2772,644,24,22,46,52.2%,23m
13612,3,[KPG]爱国者,2772,636,24,24,48,50.0%,6m
13612,3,白蔷薇,2772,543,22,26,48,45.8%,17m
13612,3,[一般赢不了]Berserker,2772,428,20,8,28,71.4%,15m
13612,3,yayoia,2772,233,18,8,26,69.2%,13m
13612,3,上户彩,2772,112,10,10,20,50.0%,6m
13612,3,[永远喜欢萝莉]森下下士,2772,222,8,4,12,66.7%,3m
13612,1,Ghost,2772,209,7,6,13,53.8%,38m
13612,3,[QwQYo]IDMissing,2772,186,5,5,10,50.0%,48m
13612,3,[入世禅]酒忤,2772,0,0,1,1,0.0%,23m
13612,1,晖芸雪谷,2772,0,0,1,1,0.0%,1h
13628,3,脑虫在世输本酱,2771,1381,76,86,162,46.9%,9m
13628,3,Escapist,2771,650,67,78,145,46.2%,29m
13628,3,莫得感情,2771,759,41,21,62,66.1%,27m
13628,3,ZBK,2771,157,23,22,45,51.1%,17m
13628,3,Vicccc,2771,529,22,17,39,56.4%,6m
13628,3,[放过我吧]肠胃炎的程大志,2771,397,15,10,25,60.0%,12m
13628,3,rushB,2771,303,14,8,22,63.6%,27m
13628,3,LemonScarlet,2771,244,8,8,16,50.0%,27m
13628,3,芸豆爱吃云雀,2771,58,3,2,5,60.0%,13m
13628,1,sky,2771,0,3,4,7,42.9%,36m
13628,1,红颜,2771,0,3,4,7,42.9%,1h
13628,3,曦洋,2771,93,2,0,2,100.0%,15m
13628,3,IIIIII,2771,0,1,0,1,100.0%,19m
13628,3,你阿妈炸了,2771,0,1,0,1,100.0%,15m
13628,3,PrincecessZZ,2771,30,1,3,4,25.0%,5m
13628,3,han,2771,0,0,1,1,0.0%,28m
13644,2,[KPG]咕咕王,2770,1542,109,104,213,51.2%,5m
13644,3,[软萌甜小萝莉]观测者,2770,1318,55,48,103,53.4%,22m
13644,3,你是真皮沙发,2770,808,50,50,100,50.0%,47m
13644,3,kodiak,2770,940,42,30,72,58.3%,21m
13644,3,DeBrunk,2770,589,40,34,74,54.1%,14m
13644,1,[火焰雷兽]StrBro,2770,1134,37,51,88,42.0%,4m
13644,3,[TBT]小陀螺,2770,628,30,9,39,76.9%,15m
13644,3,开心就好咧,2770,310,28,20,48,58.3%,18m
13644,3,IIIIIIIIIIII,2770,584,20,18,38,52.6%,46m
13644,3,法兰尬舞队,2770,387,18,7,25,72.0%,15m
13644,3,rider,2770,349,13,16,29,44.8%,12m
13644,3,[冠冕]lingtas,2770,293,12,6,18,66.7%,25m
13644,3,IIIIIIIII,2770,347,11,10,21,52.4%,3m
13644,2,幕雪绫熙,2770,232,9,8,17,52.9%,1h
13644,3,[搞大事]跳虫军师,2770,198,6,3,9,66.7%,14m
13644,3,dkrtt,2770,90,3,9,12,25.0%,19m
13644,2,恶男,2770,30,2,6,8,25.0%,47m
13644,3,fdasfsf,2770,0,1,0,1,100.0%,10m
13644,3,[堕天使之翼]小红狐,2770,0,1,1,2,50.0%,24m
13644,3,农村包围城市,2770,93,1,1,2,50.0%,18m
13644,3,[KNAT]SCPLAYER,2770,0,0,1,1,0.0%,47m
13644,3,Jim,2770,0,0,1,1,0.0%,28m
13644,3,[社交学导教]半根辣条,2770,0,0,1,1,0.0%,1h
13667,1,[浪啊浪]漂移后仰马桶投篮,2769,1322,114,116,230,49.6%,4m
13667,3,碑刺,2769,1423,103,108,211,48.8%,26m
13667,3,黑暗之主,2769,823,35,32,67,52.2%,5m
13667,2,沃德吉尔贼长,2769,439,21,19,40,52.5%,11m
13667,3,Jimmy,2769,383,16,9,25,64.0%,19m
13667,3,[一剑光寒九州]麻雀,2769,359,13,17,30,43.3%,21m
13667,3,离殇夜尽天明,2769,258,9,6,15,60.0%,48m
13667,1,[小鸡屠宰场4]dknc,2769,245,9,7,16,56.2%,7m
13667,3,[吹逼小分队]yjjabc,2769,92,4,5,9,44.4%,27m
13667,1,tetAE,2769,48,4,5,9,44.4%,1h
13667,2,[oshima]马尔都克,2769,48,3,3,6,50.0%,14m
13667,3,梦想成为欧皇,2769,90,3,7,10,30.0%,16m
13667,3,[小扎的火车侠]公寓之狼,2769,30,2,2,4,50.0%,27m
13667,3,五块钱的好兄弟,2769,52,2,3,5,40.0%,21m
13667,3,闪电,2769,34,2,4,6,33.3%,35m
13667,3,SpaCeMessAge,2769,32,1,3,4,25.0%,36m
13667,3,带帽的熊,2769,0,1,3,4,25.0%,40m
13667,3,[江南狗王]冷兔肉,2769,0,0,1,1,0.0%,7m
13667,3,satellite,2769,0,0,1,1,0.0%,21m
13667,2,呵呵呵,2769,0,0,1,1,0.0%,1h
13687,3,[火焰雷兽]iikdhsaudhsi,2768,1467,156,145,301,51.8%,13m
13687,3,[HJ灬GD]异端者,2768,370,60,42,102,58.8%,27m
13687,3,Kirin,2768,361,15,7,22,68.2%,13m
13687,3,中华绘图铅笔,2768,338,14,13,27,51.9%,48m
13687,1,KILLER,2768,150,9,3,12,75.0%,17m
13687,3,环太平洋,2768,262,9,7,16,56.2%,26m
13687,3,Prmoptimus,2768,259,8,7,15,53.3%,5m
13687,3,[D0F]shinichi,2768,232,7,6,13,53.8%,28m
13687,3,Marineking,2768,161,5,3,8,62.5%,21m
13687,3,么么哒小弟,2768,167,5,3,8,62.5%,23m
13687,3,Hans,2768,80,4,4,8,50.0%,7m
13687,3,[要啥没啥爱咋]ANYONE,2768,60,3,2,5,60.0%,22m
13687,3,[幼女萝莉同好]次元无限,2768,86,3,5,8,37.5%,6m
13687,3,[loveMM]gameplayer,2768,30,2,4,6,33.3%,27m
13687,2,是不是玩不起,2768,42,1,2,3,33.3%,1h
13687,3,twiceCN,2768,30,1,3,4,25.0%,46m
13687,3,[少女的梦]Sturmgest,2768,0,0,1,1,0.0%,16m
13687,3,[雾雨魔法森林]Eternity,2768,0,0,1,1,0.0%,22m
13687,3,ren,2768,0,0,2,2,0.0%,48m
13687,3,Primus,2768,0,0,2,2,0.0%,16m
13707,2,[艾尔之巅]飞龙,2767,1192,120,118,238,50.4%,16m
13707,3,七丶丿,2767,1128,71,57,128,55.5%,8m
13707,3,原木良,2767,513,41,37,78,52.6%,28m
13707,3,菲特泰斯特罗莎,2767,275,18,9,27,66.7%,10m
13707,2,我超可爱,2767,534,18,21,39,46.2%,6m
13707,3,RandomX,2767,337,14,11,25,56.0%,27m
13707,3,[社交学教练]落花狼藉,2767,308,11,8,19,57.9%,1h
13707,3,[妖怪山上转转]活泼可爱沙文鱼,2767,252,9,4,13,69.2%,12m
13707,3,[塔兰达尔]她牵了他,2767,256,9,6,15,60.0%,15m
13707,2,你好可爱吖,2767,128,5,4,9,55.6%,29m
13707,1,[苏联红军]魔法之侏儒,2767,133,5,4,9,55.6%,1h
13707,3,KKSK,2767,116,5,9,14,35.7%,16m
13707,2,伪善,2767,0,3,4,7,42.9%,1h
13707,2,[四叶草]白鹞,2767,116,3,5,8,37.5%,9m
13707,3,[幽冥舰队]晓风明月,2767,88,3,5,8,37.5%,21m
13707,3,[222333]有人权的动员兵,2767,0,1,0,1,100.0%,26m
13707,2,BornToKill,2767,0,1,0,1,100.0%,14m
13707,3,[HustSC]yndeux,2767,0,1,1,2,50.0%,19m
13707,3,Nyarlathotep,2767,30,1,4,5,20.0%,24m
13707,2,[逗帝]萧炎,2767,30,1,5,6,16.7%,16m
13707,3,怠惰的蘇打,2767,0,0,2,2,0.0%,47m
13728,3,我爱玛琪玛,2766,1592,139,131,270,51.5%,7m
13728,3,solost,2766,888,114,116,230,49.6%,22m
13728,3,阿驴驴,2766,1188,75,94,169,44.4%,19m
13728,3,[骚起来]随便卖个萌,2766,461,49,37,86,57.0%,6m
13728,3,Fan,2766,382,13,12,25,52.0%,25m
13728,3,Rise,2766,356,11,20,31,35.5%,24m
13728,3,[约德尔人]你狂的让我想笑,2766,228,9,9,18,50.0%,26m
13728,1,Rindy,2766,253,6,5,11,54.5%,48m
13728,3,牛奶是个萌妹子,2766,146,6,8,14,42.9%,17m
13728,1,你还在该多好,2766,46,5,3,8,62.5%,1h
13728,2,[肉鸡的饲养]白泽绘莺,2766,157,5,3,8,62.5%,1h
13728,3,[烽夜长歌]帝国元首,2766,146,4,1,5,80.0%,28m
13728,3,醉卧沙场君莫笑,2766,113,2,2,4,50.0%,47m
13728,2,钻石战舰,2766,0,1,0,1,100.0%,24m
13728,1,羁绊,2766,0,1,1,2,50.0%,3m
13728,3,[崂山道士]三班李倩,2766,30,1,2,3,33.3%,19m
13728,3,[绝对零度sc]我是大逗逼,2766,30,1,3,4,25.0%,18m
13728,3,[SFTRA3]TomJAng,2766,0,0,1,1,0.0%,6m
13746,3,吾颜白,2765,1560,107,97,204,52.5%,22m
13746,3,凭什么只有我受伤,2765,1466,104,94,198,52.5%,48m
13746,3,[你已经死啦]wyb,2765,1394,54,56,110,49.1%,5m
13746,3,梵素梨花叹,2765,923,41,35,76,53.9%,24m
13746,3,llllllllllll,2765,514,18,20,38,47.4%,3m
13746,3,[五月花]茫然之潜行者,2765,396,17,10,27,63.0%,28m
13746,3,[NLHR]ecrd,2765,288,14,12,26,53.8%,3m
13746,3,不造地堡,2765,248,13,9,22,59.1%,22m
13746,3,[浪啊浪]logo,2765,219,7,6,13,53.8%,22m
13746,2,半夏微凉不成殇,2765,86,6,8,14,42.9%,48m
13746,2,Ayden,2765,93,3,4,7,42.9%,1h
13746,3,[小鸡屠宰场7]勇者,2765,60,2,4,6,33.3%,17m
13746,3,[人菜灬瘾大]TinaAI,2765,53,2,5,7,28.6%,5m
13746,2,[CHP]东皇太一,2765,0,1,0,1,100.0%,36m
13746,3,[STARV]look,2765,0,1,0,1,100.0%,6m
13746,3,[宫吧老哥狂喜]夏利文,2765,89,1,1,2,50.0%,15m
13746,3,[黑白猫]花生牛奶配小乳酸,2765,0,0,1,1,0.0%,22m
13746,3,[最菜战队]我帅打我,2765,0,0,1,1,0.0%,17m
13746,1,阎雀裁缝拔刀术啾,2765,0,0,1,1,0.0%,1h
13746,3,speed,2765,0,0,2,2,0.0%,6m
13766,3,Midas,2764,1567,167,164,331,50.5%,24m
13766,1,小女巫没吃饭,2764,1457,139,123,262,53.1%,4m
13766,3,BiancaSofia,2764,1123,55,38,93,59.1%,24m
13766,3,阿飞上校,2764,1067,42,37,79,53.2%,28m
13766,3,wuyanzu,2764,381,18,12,30,60.0%,12m
13766,3,四四,2764,167,11,5,16,68.8%,22m
13766,2,旧约,2764,256,11,11,22,50.0%,8m
13766,3,[112909]赵某某,2764,188,7,4,11,63.6%,7m
13766,3,LastMarine,2764,120,5,7,12,41.7%,10m
13766,2,[血域]浴火凤凰,2764,164,4,10,14,28.6%,28m
13766,3,MLPdawn,2764,55,3,4,7,42.9%,47m
13766,3,永恒深渊,2764,93,2,0,2,100.0%,18m
13766,3,不是很快乐,2764,60,2,4,6,33.3%,19m
13766,3,QDxun,2764,0,1,4,5,20.0%,1h
13766,2,[星际最强亡者]ZERO,2764,0,0,2,2,0.0%,15m
13781,3,Nafly,2763,689,59,56,115,51.3%,6m
13781,2,伊巡,2763,662,30,34,64,46.9%,43m
13781,3,Alexx,2763,294,24,14,38,63.2%,23m
13781,3,knight,2763,172,5,4,9,55.6%,6m
13781,2,某正太,2763,80,5,5,10,50.0%,58m
13781,3,[济职学院]Chuan,2763,97,4,0,4,100.0%,6m
13781,3,INnovation,2763,90,4,5,9,44.4%,26m
13781,2,Slient,2763,140,4,5,9,44.4%,1h
13781,3,ZYCSB,2763,117,3,1,4,75.0%,3m
13781,2,傲娇绿坝娘,2763,94,3,3,6,50.0%,29m
13781,1,Aladdin,2763,119,2,2,4,50.0%,1h
13781,3,[X英雄圣域X]甜不辣,2763,0,2,3,5,40.0%,60m
13781,3,[一起单推小狗]人菜瘾大,2763,58,2,4,6,33.3%,47m
13781,3,[斩月]天下第一呆,2763,92,1,1,2,50.0%,7m
13781,3,佛朗哥,2763,93,1,1,2,50.0%,10m
13781,3,掠夺者,2763,30,1,2,3,33.3%,14m
13781,3,灬折翼丶堕天使丨,2763,96,1,2,3,33.3%,49m
13781,3,[WINED]快乐就完事了,2763,30,1,2,3,33.3%,48m
13781,3,koko,2763,0,1,4,5,20.0%,13m
13781,3,翔云破晓月,2763,0,0,1,1,0.0%,26m
13781,3,[休闲剧情党]飞火流星,2763,0,0,1,1,0.0%,18m
13781,3,一默一,2763,0,0,1,1,0.0%,14m
13781,2,缤纷黑马,2763,0,0,1,1,0.0%,1h
13804,3,母舰不是航母,2762,1569,227,222,449,50.6%,7m
13804,2,Radioactive,2762,1421,74,62,136,54.4%,22m
13804,2,XAUUSD,2762,1101,46,43,89,51.7%,11m
13804,3,[刺蛇互助社团]枫叶漫漫,2762,663,35,9,44,79.5%,21m
13804,3,LoveTT,2762,721,34,32,66,51.5%,6m
13804,3,SoFo,2762,644,27,18,45,60.0%,24m
13804,3,Bentley,2762,287,23,23,46,50.0%,17m
13804,3,守望者,2762,540,21,18,39,53.8%,49m
13804,3,[burn]浣纱幼儿园下面陈,2762,430,19,9,28,67.9%,14m
13804,2,宿伞无常,2762,226,16,22,38,42.1%,10m
13804,3,[沙星部]Terry,2762,308,12,6,18,66.7%,16m
13804,3,星痕,2762,316,11,13,24,45.8%,15m
13804,3,牧濑红莉栖,2762,196,8,1,9,88.9%,15m
13804,3,HiaLee,2762,126,5,7,12,41.7%,26m
13804,1,Buong,2762,48,4,6,10,40.0%,50m
13804,2,暗影之风暴,2762,93,3,3,6,50.0%,1h
13804,3,谪仙,2762,121,2,1,3,66.7%,42m
13804,3,咖啡不加糖,2762,30,2,3,5,40.0%,22m
13804,3,[这就对了]寰宇,2762,58,2,3,5,40.0%,28m
13804,1,洩矢诹访子,2762,118,2,5,7,28.6%,48m
13804,3,[公爵]帅比帅比逍遥君,2762,90,1,1,2,50.0%,22m
13804,2,茫然,2762,88,1,2,3,33.3%,34m
13804,3,[PITB]Dylan,2762,0,0,1,1,0.0%,14m
13804,1,虚夜,2762,0,0,1,1,0.0%,16m
13804,3,[无限圣堂]草帽小子,2762,0,0,1,1,0.0%,22m
13804,3,yuo,2762,0,0,2,2,0.0%,1h
13830,3,[RaMoC]白门楼,2761,694,75,60,135,55.6%,46m
13830,3,[美少女壮士]梵天净,2761,1495,66,54,120,55.0%,24m
13830,2,[星际旅游团]declaire,2761,905,48,44,92,52.2%,21m
13830,3,[APTIV]布拉布拉奇,2761,623,46,20,66,69.7%,10m
13830,1,沐雨白,2761,460,38,46,84,45.2%,15m
13830,3,一招制敌,2761,877,35,36,71,49.3%,24m
13830,3,[葬媛]莪嘚嬡沵芣慬,2761,398,33,21,54,61.1%,19m
13830,3,fantasy,2761,672,29,17,46,63.0%,15m
13830,3,[各种小蛋糕]LightsZod,2761,587,23,22,45,51.1%,26m
13830,3,崔海凝再此,2761,519,22,17,39,56.4%,24m
13830,3,努力痊愈,2761,519,21,20,41,51.2%,22m
13830,3,[江城十三少]gbswk,2761,165,20,16,36,55.6%,18m
13830,3,[我爱大奶妹]潘慢慢,2761,338,15,5,20,75.0%,1h
13830,3,Change,2761,442,15,15,30,50.0%,10m
13830,3,绝影,2761,258,9,6,15,60.0%,48m
13830,3,暴龙哥爱牛欢喜,2761,176,7,11,18,38.9%,17m
13830,3,[一个军的兵力]满李先生,2761,180,6,4,10,60.0%,6m
13830,3,[艾尔之巅]寒风凛冽,2761,166,6,7,13,46.2%,23m
13830,2,SCPLAYER,2761,139,5,4,9,55.6%,1h
13830,3,wsnd,2761,0,4,1,5,80.0%,1h
13830,3,别叫我芦总,2761,0,3,2,5,60.0%,1h
13830,2,[永恒者]奥柏伦亲王,2761,93,1,1,2,50.0%,29m
13830,3,红雨,2761,30,1,3,4,25.0%,7m
13830,3,[TZPer]flash,2761,0,0,1,1,0.0%,22m
13854,3,Marine,2760,679,28,24,52,53.8%,47m
13854,3,魔法少女绫波,2760,648,27,19,46,58.7%,13m
13854,2,小白龙蒙奇奇,2760,592,20,28,48,41.7%,29m
13854,3,南风如梦,2760,390,17,8,25,68.0%,19m
13854,3,整瑜,2760,373,15,15,30,50.0%,23m
13854,3,Jacobs,2760,200,12,8,20,60.0%,6m
13854,3,铭泽,2760,272,9,7,16,56.2%,1h
13854,3,[Quark]茶仙,2760,174,7,7,14,50.0%,10m
13854,3,[不灭青铜]菜鸟,2760,208,7,9,16,43.8%,28m
13854,3,给钱谢谢,2760,146,5,7,12,41.7%,15m
13854,3,[黑暗圣堂棱镜]冰弦结御,2760,118,4,6,10,40.0%,29m
13854,3,LEE,2760,111,3,1,4,75.0%,6m
13854,3,Hydrogen,2760,121,3,1,4,75.0%,26m
13854,3,vircent,2760,60,3,2,5,60.0%,44m
13854,3,沉默的艾泽拉,2760,93,2,1,3,66.7%,12m
13854,3,不冲基地龙魂桑,2760,34,2,5,7,28.6%,8m
13854,1,人生就像一盘棋,2760,0,1,0,1,100.0%,1h
13854,2,[天依的御厨]陈鹜霞,2760,0,1,3,4,25.0%,45m
13854,3,善良的房祖名,2760,0,0,1,1,0.0%,22m
13873,3,Beacon,2759,341,12,9,21,57.1%,23m
13873,1,东狂,2759,391,12,11,23,52.2%,51m
13873,3,[耀眼的夏娜]隔壁老王,2759,278,9,8,17,52.9%,10m
13873,1,影丶墨,2759,78,5,2,7,71.4%,1h
13873,2,吊炸天了你知道吗,2759,0,1,1,2,50.0%,1h
13873,3,Uni,2759,0,1,3,4,25.0%,10m
13873,3,骚猪,2759,30,1,4,5,20.0%,24m
13873,1,[分析]树新蜂,2759,0,0,2,2,0.0%,1h
13873,3,老劉,2759,0,0,3,3,0.0%,1h
13882,2,Kimgy,2758,1542,139,137,276,50.4%,2m
13882,2,[小鸡屠宰场2]无尚荣光,2758,983,128,119,247,51.8%,9m
13882,2,MARINEKING,2758,440,51,47,98,52.0%,7m
13882,3,小拉基姐姐,2758,985,47,32,79,59.5%,23m
13882,3,[纸鸢i]同性才是真爱,2758,623,26,19,45,57.8%,7m
13882,3,[CPT]zoun,2758,246,9,4,13,69.2%,26m
13882,3,川啊,2758,234,8,6,14,57.1%,1h
13882,3,[我们是萌新]Sky,2758,122,5,6,11,45.5%,43m
13882,2,近战狙击手,2758,92,4,3,7,57.1%,1h
13882,3,兵者诡道,2758,58,3,3,6,50.0%,23m
13882,3,Bogus,2758,96,3,21,24,12.5%,15m
13882,1,[永存]打啊打,2758,30,2,0,2,100.0%,1h
13882,1,[失败者联盟]不是塞肉是个菜姬,2758,0,1,0,1,100.0%,1h
13882,1,路过的杀手,2758,0,0,1,1,0.0%,42m
13882,3,HIdoc,2758,0,0,2,2,0.0%,4m
13882,3,夜昕聆雨,2758,0,0,4,4,0.0%,18m
13898,2,能动手尽量不吵吵,2757,781,89,94,183,48.6%,2m
13898,3,cxgccxgc,2757,700,73,57,130,56.2%,25m
13898,3,我要起个好名字,2757,961,47,23,70,67.1%,5m
13898,3,[Nostop]傲娇小姐姐,2757,768,32,26,58,55.2%,15m
13898,3,最后的群星,2757,656,27,25,52,51.9%,18m
13898,2,不玩同族对抗,2757,272,11,12,23,47.8%,34m
13898,1,玛德还有谁,2757,226,8,4,12,66.7%,37m
13898,3,SmallCow,2757,178,7,9,16,43.8%,27m
13898,1,[猫跑去田间了]猫掉进井里了,2757,258,6,7,13,46.2%,8m
13898,3,[iOTD]MithrilPipe,2757,131,5,6,11,45.5%,1h
13898,3,[Rhusky]公子酥,2757,105,5,6,11,45.5%,47m
13898,2,Afuture,2757,0,4,2,6,66.7%,1h
13898,3,fufv,2757,38,3,3,6,50.0%,60m
13898,1,一梦逝水流年,2757,0,3,4,7,42.9%,20m
13898,1,[我是萌新Q]雾雨爱丽丝,2757,36,2,1,3,66.7%,47m
13898,1,Novice,2757,0,2,3,5,40.0%,32m
13898,3,[嫉妒魔女]艾米莉亚,2757,0,2,3,5,40.0%,17m
13898,1,打的太菜,2757,0,1,0,1,100.0%,10m
13898,1,dasdws,2757,0,1,0,1,100.0%,37m
13898,2,[琴之森]阿姨我不想努力了,2757,44,1,1,2,50.0%,56m
13898,2,绝世月夜枫,2757,0,0,1,1,0.0%,1h
13919,3,低调逃生,2756,1326,296,284,580,51.0%,19m
13919,1,FlameAsh,2756,1581,249,243,492,50.6%,27m
13919,2,炳超,2756,1399,168,155,323,52.0%,22m
13919,1,铁马的汉子,2756,524,37,29,66,56.1%,44m
13919,3,[禽禽禽]大帝丶屠鸡虐狗,2756,792,28,31,59,47.5%,22m
13919,3,云游者,2756,162,19,20,39,48.7%,22m
13919,3,MMJ,2756,257,10,6,16,62.5%,25m
13919,2,JUSTICE,2756,193,7,5,12,58.3%,1h
13919,3,靠你吉瓦,2756,153,5,2,7,71.4%,24m
13919,1,SGWYWAN,2756,117,5,4,9,55.6%,5m
13919,1,[跟我们混]晓天,2756,40,2,1,3,66.7%,54m
13919,1,[龙之逆鳞]冥界皇太子,2756,82,2,3,5,40.0%,36m
13919,3,可乐,2756,0,1,2,3,33.3%,8m
13919,2,van,2756,93,1,2,3,33.3%,1h
13919,1,[176642]黑白羽翼,2756,0,0,1,1,0.0%,45m
13919,2,阿文儿,2756,0,0,1,1,0.0%,1h
13919,1,卑微小爱,2756,0,0,1,1,0.0%,45m
13936,1,DVCsv,2755,1292,149,134,283,52.7%,22m
13936,2,混元太极爱偷袭,2755,1236,110,81,191,57.6%,5m
13936,3,野生熊猫,2755,437,73,63,136,53.7%,13m
13936,3,喜欢冰激凌的鹌鹑,2755,1005,40,39,79,50.6%,5m
13936,3,夜空,2755,409,16,13,29,55.2%,22m
13936,2,[YT]皂滑弄人,2755,362,14,13,27,51.9%,21m
13936,1,爱丽丝神皇,2755,365,11,9,20,55.0%,1h
13936,3,[艾尔之主]狡猾之异虫,2755,298,10,14,24,41.7%,45m
13936,1,[爆裂吧现实]LAW,2755,286,9,6,15,60.0%,4m
13936,1,菜不好吗,2755,191,7,5,12,58.3%,14m
13936,1,DarkTempar,2755,0,3,4,7,42.9%,1h
13936,3,[传奇舰队]宝贝龙,2755,60,2,6,8,25.0%,6m
13936,3,砂糖酱,2755,0,1,3,4,25.0%,47m
13936,1,[樱花殿]神选者,2755,0,0,1,1,0.0%,1h
13936,3,[望月]完美丶告白,2755,0,0,2,2,0.0%,24m
13936,3,[热血即是浪漫]七月,2755,0,0,3,3,0.0%,1h
13952,1,Shawn,2754,1532,143,152,295,48.5%,27m
13952,3,女教师,2754,717,90,78,168,53.6%,12m
13952,3,星际争霸,2754,1392,59,49,108,54.6%,4m
13952,3,波波龙,2754,943,44,32,76,57.9%,15m
13952,1,做个快乐的单身狗,2754,704,23,20,43,53.5%,2m
13952,1,小刺蛇,2754,484,22,4,26,84.6%,47m
13952,3,[DMRc]IIIIIIIIIIII,2754,342,14,11,25,56.0%,29m
13952,3,kywqqt,2754,291,10,8,18,55.6%,47m
13952,3,都是弟弟,2754,256,9,6,15,60.0%,26m
13952,1,小桜茉莉,2754,227,8,8,16,50.0%,36m
13952,1,llllllllllll,2754,229,7,6,13,53.8%,1h
13952,1,伊蕾娜,2754,179,7,6,13,53.8%,59m
13952,3,想不出,2754,215,6,5,11,54.5%,60m
13952,3,苍之灵木,2754,120,5,5,10,50.0%,19m
13952,3,[暴雪十五队]honggl,2754,144,5,8,13,38.5%,14m
13952,1,Hofion,2754,48,4,5,9,44.4%,38m
13952,1,慢点慢点,2754,74,3,1,4,75.0%,1h
13952,3,逃跑冠军丶,2754,60,2,8,10,20.0%,6m
13952,1,xige,2754,0,1,0,1,100.0%,32m
13952,3,[A到死]Phoenix,2754,0,1,1,2,50.0%,7m
13952,3,[當都挡不住]另请高明,2754,36,1,1,2,50.0%,1h
13952,3,xsc,2754,42,1,1,2,50.0%,1h
13952,1,厉害了我的哥,2754,0,0,1,1,0.0%,22m
13952,1,小卖叔,2754,0,0,1,1,0.0%,1h
13976,3,像羊树,2753,1510,110,132,242,45.5%,14m
13976,1,lavapeacocg,2753,1106,57,58,115,49.6%,28m
13976,1,[听雨轩]南门俊友,2753,1070,57,71,128,44.5%,29m
13976,2,shencome,2753,1042,48,54,102,47.1%,9m
13976,3,[萌M]与圣光作对,2753,655,44,35,79,55.7%,23m
13976,1,[情深天涯]火麒麟,2753,731,29,26,55,52.7%,14m
13976,3,Timba,2753,353,14,16,30,46.7%,22m
13976,3,年轻人你,2753,158,11,8,19,57.9%,35m
13976,1,如故丶,2753,200,6,4,10,60.0%,56m
13976,3,疯恰恰,2753,163,5,2,7,71.4%,23m
13976,1,[背水一战]rwqq,2753,165,4,2,6,66.7%,30m
13976,3,[斯巴达血战团]星际潜水员,2753,0,2,3,5,40.0%,1h
13976,1,[Google]小女王和小毛驴,2753,0,1,0,1,100.0%,1h
13976,1,子非鱼,2753,0,1,0,1,100.0%,42m
13976,2,[坚持就是胜利]熊猫丨总是可爱,2753,0,0,1,1,0.0%,1h
13976,1,胡儿额,2753,0,0,1,1,0.0%,44m
13976,1,哎辣油,2753,0,0,1,1,0.0%,56m
13976,1,[秋毫第五分队]虐暴傻必狗队友,2753,0,0,2,2,0.0%,3m
13976,3,[XYFANS]黑白熊,2753,0,0,4,4,0.0%,25m
13995,1,CHRIS,2752,1585,162,162,324,50.0%,16m
13995,3,[KPG2]LoveDYX,2752,1491,117,101,218,53.7%,5m
13995,2,高坚果,2752,107,47,35,82,57.3%,15m
13995,3,kip,2752,479,18,15,33,54.5%,17m
13995,3,很爱过谁会舍得,2752,338,13,12,25,52.0%,25m
13995,3,ROxxxE,2752,245,9,2,11,81.8%,14m
13995,3,blacksunny,2752,237,8,6,14,57.1%,1h
13995,1,[GOTAL]只会玩小狗的菜鸟,2752,253,7,5,12,58.3%,10m
13995,3,dan,2752,161,6,8,14,42.9%,1h
13995,2,[星痕]大喵,2752,0,4,2,6,66.7%,1h
13995,3,失去连接,2752,0,3,2,5,60.0%,43m
13995,3,zardlike,2752,30,2,2,4,50.0%,28m
13995,1,朋友的妈妈,2752,40,1,1,2,50.0%,1h
13995,1,电脑难度丨休闲丨,2752,36,1,2,3,33.3%,1h
13995,3,wdcxjjbd,2752,0,0,2,2,0.0%,1h
13995,3,羽兮,2752,0,0,4,4,0.0%,27m
14011,3,[萝莉之芯]雨燕,2751,1500,183,177,360,50.8%,47m
14011,2,[NSG致一]小猪爱睡觉,2751,1493,83,77,160,51.9%,22m
14011,3,时过憬迁,2751,1149,54,33,87,62.1%,22m
14011,3,战地跑路,2751,824,30,31,61,49.2%,23m
14011,2,冰淳,2751,252,19,24,43,44.2%,25m
14011,1,星火燎原,2751,241,8,14,22,36.4%,4m
14011,3,Panda,2751,194,6,6,12,50.0%,20m
14011,3,MuYang,2751,118,5,4,9,55.6%,47m
14011,1,日常头铁,2751,256,5,6,11,45.5%,6m
14011,1,[暴风雨]上杉绘梨衣,2751,148,3,1,4,75.0%,42m
14011,3,力量,2751,0,3,2,5,60.0%,1h
14011,2,[YMSX]透明人,2751,95,3,4,7,42.9%,1h
14011,2,[鱼人永不败]泰迪,2751,113,3,4,7,42.9%,36m
14011,1,Crimmmm,2751,0,1,0,1,100.0%,52m
14011,2,[小奶狼]我就叫夏洛啊,2751,0,1,0,1,100.0%,1h
14011,2,[UDK]普通车万民,2751,0,0,1,1,0.0%,1h
14011,2,kafe,2751,0,0,1,1,0.0%,1h
14011,2,真的是萌新,2751,0,0,1,1,0.0%,1h
14011,3,[荒芜岁月]情如朝露去匆匆,2751,0,0,4,4,0.0%,7m
14030,2,Architect,2750,1354,219,206,425,51.5%,45m
14030,3,黄鸡舰队,2750,394,66,67,133,49.6%,17m
14030,2,[这游戏好难]UFCC,2750,1009,59,61,120,49.2%,4m
14030,2,IIIIIIIIIIII,2750,1027,48,47,95,50.5%,10m
14030,3,[天天向上1]铺不上菌毯的虫母,2750,859,32,30,62,51.6%,6m
14030,3,路明非,2750,412,20,22,42,47.6%,14m
14030,3,量子丶波函数坍缩,2750,501,19,20,39,48.7%,21m
14030,3,[Fiend]SonicMaster,2750,421,17,15,32,53.1%,47m
14030,3,LIUSEQINGYI,2750,446,16,18,34,47.1%,17m
14030,3,嘿嘿嘿,2750,147,6,7,13,46.2%,49m
14030,3,cctv,2750,97,4,6,10,40.0%,1h
14030,2,ZoHoY,2750,118,3,5,8,37.5%,1h
14030,3,[第八舰队丶]迷途坊,2750,30,2,2,4,50.0%,16m
14030,3,rusher,2750,30,2,3,5,40.0%,18m
14030,3,伊莱克斯,2750,119,2,5,7,28.6%,26m
14030,2,[一波上大师]天界的小泽同学,2750,0,0,1,1,0.0%,24m
14030,1,我超甜你爱不爱我,2750,0,0,1,1,0.0%,18m
14030,1,[黄金舰隊]芃芃要睡觉了,2750,0,0,1,1,0.0%,21m
14048,1,北冥有鱼其名为咸,2749,1555,257,260,517,49.7%,28m
14048,1,JackSparrow,2749,1093,69,74,143,48.3%,28m
14048,1,[CNboys]东三雪碧,2749,665,30,36,66,45.5%,16m
14048,2,[KPG2]嘎巴脆,2749,760,28,35,63,44.4%,26m
14048,3,无已,2749,522,25,27,52,48.1%,17m
14048,1,真的不会,2749,368,12,7,19,63.2%,28m
14048,2,[葛温王下骑士]月夜,2749,184,6,2,8,75.0%,50m
14048,3,[最菜战队]WATCHER,2749,180,5,4,9,55.6%,28m
14048,1,你的萌友,2749,211,4,5,9,44.4%,43m
14048,3,地狱已空,2749,0,3,2,5,60.0%,1h
14048,3,[MoSc2]Genthz,2749,30,2,1,3,66.7%,18m
14048,3,后月樂,2749,94,2,1,3,66.7%,23m
14048,3,drizzle,2749,0,2,3,5,40.0%,1h
14048,1,[四佑]生命一号,2749,0,1,0,1,100.0%,28m
14048,1,DAAWE,2749,107,1,2,3,33.3%,1h
14048,1,爷爷,2749,0,1,4,5,20.0%,17m
14048,1,风天小虎,2749,0,0,1,1,0.0%,14m
14065,2,llllllllllll,2748,822,35,38,73,47.9%,48m
14065,3,羊刀,2748,551,21,23,44,47.7%,49m
14065,3,abook,2748,359,13,12,25,52.0%,27m
14065,1,OvO,2748,314,10,5,15,66.7%,56m
14065,3,我为第一,2748,246,10,11,21,47.6%,5m
14065,3,[飞跃来]难搞的一批,2748,231,8,6,14,57.1%,8m
14065,1,[LGX]iiiiiiii,2748,150,5,1,6,83.3%,1h
14065,2,[天狼星]SiriusBlack,2748,93,3,4,7,42.9%,39m
14065,3,狗哥的鼠标,2748,0,2,3,5,40.0%,4m
14065,3,fgddg,2748,0,2,3,5,40.0%,1h
14065,1,[Igirls]冥氡,2748,0,1,0,1,100.0%,44m
14065,1,Tsukumo,2748,0,1,0,1,100.0%,33m
14065,1,金刚芭比宋小宝,2748,0,1,0,1,100.0%,36m
14065,3,[在鹿上]启源,2748,0,1,1,2,50.0%,27m
14065,1,浅酌,2748,38,1,2,3,33.3%,1h
14065,1,[夹心酱赛高]花园百合铃,2748,0,0,1,1,0.0%,10m
14065,1,[城市建设集团]JOKE,2748,0,0,4,4,0.0%,17m
14082,2,comflict,2747,1368,163,157,320,50.9%,21m
14082,3,卡尔沃丁,2747,1081,96,77,173,55.5%,27m
14082,3,毛蛋蛋,2747,817,67,49,116,57.8%,19m
14082,3,有丶怠惰,2747,712,40,31,71,56.3%,19m
14082,1,[秋毫]Ghost,2747,852,30,26,56,53.6%,56m
14082,3,DUNKPEKO,2747,362,16,11,27,59.3%,14m
14082,3,[miku守护]wise,2747,298,11,13,24,45.8%,7m
14082,1,[嘤遍全球]大女乃,2747,176,6,0,6,100.0%,28m
14082,1,brenchley,2747,48,5,5,10,50.0%,1h
14082,3,[飘逸的老司机]菜逼玩家,2747,123,4,1,5,80.0%,6m
14082,3,[哲学娱乐谐会]Kerrigan,2747,113,3,6,9,33.3%,26m
14082,3,[OgiNA]aragon,2747,30,1,3,4,25.0%,10m
14082,3,EterniTY,2747,0,0,1,1,0.0%,1h
14095,2,这游戏还真没玩呢,2746,1591,412,382,794,51.9%,46m
14095,2,[寄葉丶]涂山红红丶,2746,1153,63,67,130,48.5%,16m
14095,3,[幽明异路]yzz,2746,1259,58,48,106,54.7%,49m
14095,2,现世妄执,2746,1052,56,42,98,57.1%,22m
14095,3,IIIIIIIIIIII,2746,327,16,8,24,66.7%,8m
14095,1,TaKa,2746,299,10,2,12,83.3%,20m
14095,3,[您好]白球带冲锋,2746,215,7,11,18,38.9%,24m
14095,3,blankly,2746,146,6,8,14,42.9%,12m
14095,1,Ameame,2746,100,4,2,6,66.7%,1h
14095,2,[时令]无框木,2746,109,4,3,7,57.1%,1h
14095,3,打铁还需自身硬,2746,120,4,6,10,40.0%,14m
14095,3,[星之所在RI]IIIIIIIIIIII,2746,86,3,5,8,37.5%,7m
14095,1,DisDoR,2746,0,3,8,11,27.3%,45m
14095,1,ZXC,2746,78,2,3,5,40.0%,1h
14095,1,[kirara]DreDiki,2746,0,1,0,1,100.0%,1h
14095,3,凛冽的寒冬,2746,0,1,1,2,50.0%,26m
14095,2,黑山中的大虫,2746,94,1,1,2,50.0%,1h
14095,1,朱旭宇,2746,0,0,1,1,0.0%,15m
14095,1,垃圾顺,2746,0,0,2,2,0.0%,8m
14095,3,[虚无]end,2746,0,0,3,3,0.0%,22m
14115,2,solip,2745,1183,77,74,151,51.0%,27m
14115,3,[aeahz]休闲玩家,2745,924,48,39,87,55.2%,16m
14115,3,[KPG2]RyanSoong,2745,677,27,34,61,44.3%,46m
14115,3,JKeen,2745,256,21,21,42,50.0%,17m
14115,3,重复购买奶粉,2745,560,21,23,44,47.7%,5m
14115,1,立陶宛农民,2745,512,17,8,25,68.0%,21m
14115,3,好汉手下留情,2745,410,17,16,33,51.5%,20m
14115,3,[萌新保护协议]玄冥苍宇,2745,437,16,13,29,55.2%,19m
14115,3,古怪之裤子,2745,225,13,7,20,65.0%,19m
14115,3,[LMC]CPUANDUSB,2745,258,11,4,15,73.3%,24m
14115,3,真的大丈夫,2745,303,10,9,19,52.6%,5m
14115,2,cavalier,2745,169,6,6,12,50.0%,58m
14115,3,tiom,2745,0,4,2,6,66.7%,1h
14115,1,呆呆,2745,120,4,6,10,40.0%,1h
14115,2,jkln,2745,0,3,3,6,50.0%,17m
14115,1,[半个菜鸟]IIIIIIIIIIII,2745,138,3,8,11,27.3%,2m
14115,3,magejiTerran,2745,0,1,0,1,100.0%,1h
14115,2,FTZL,2745,44,1,2,3,33.3%,45m
14115,3,萧瑟为谁吟,2745,0,1,3,4,25.0%,22m
14115,1,lzxzuiniu,2745,0,0,1,1,0.0%,27m
14115,3,[浮世清欢]沉稳,2745,0,0,2,2,0.0%,22m
14115,3,TTB,2745,0,0,4,4,0.0%,10m
14115,3,[Sc养老]BIBOU,2745,0,0,5,5,0.0%,48m
14138,1,[狼牙盟]MoonWalker,2744,1517,122,127,249,49.0%,24m
14138,2,lglin,2744,177,28,31,59,47.5%,9m
14138,3,[Mentor]CJHAAAAAA,2744,139,18,9,27,66.7%,18m
14138,3,犬儒,2744,469,17,15,32,53.1%,5m
14138,3,yoshily,2744,319,10,19,29,34.5%,49m
14138,1,马老师一不小心,2744,174,6,3,9,66.7%,1h
14138,1,INforMation,2744,146,5,1,6,83.3%,21m
14138,1,我是萌新轻点打,2744,183,5,3,8,62.5%,1h
14138,3,siling,2744,0,3,2,5,60.0%,1h
14138,3,[北京带学]未央生,2744,142,3,4,7,42.9%,42m
14138,2,xsswsx,2744,44,2,0,2,100.0%,1h
14138,1,小虎,2744,34,1,2,3,33.3%,15m
14138,1,长萌有希恋古泉,2744,0,0,1,1,0.0%,38m
14138,1,拳打傻坤,2744,0,0,1,1,0.0%,10m
14138,2,ameame,2744,0,0,1,1,0.0%,34m
14138,3,爱火的鱼,2744,0,0,2,2,0.0%,15m
14138,2,IIIIIIIIIIII,2744,0,0,4,4,0.0%,8m
14138,2,[飞鸟牡丹配]timo,2744,0,0,7,7,0.0%,9m
14156,1,星际迷大叔,2743,1339,161,162,323,49.8%,5m
14156,3,IIIIIIIIIIII,2743,1265,52,55,107,48.6%,24m
14156,3,[GLZ]修理,2743,474,31,22,53,58.5%,18m
14156,3,游击队长,2743,292,24,20,44,54.5%,7m
14156,3,得过且过,2743,541,21,21,42,50.0%,49m
14156,3,斯卡蒂我老婆,2743,328,19,14,33,57.6%,22m
14156,1,[北工商萌新]LSGwen,2743,389,16,11,27,59.3%,2m
14156,3,[我们是无敌的]兽人永不为奴,2743,390,15,13,28,53.6%,22m
14156,2,按时恰个饭,2743,340,14,5,19,73.7%,55m
14156,1,[Ps]WomenKing,2743,388,13,9,22,59.1%,10m
14156,1,灵某啥也不会,2743,289,11,12,23,47.8%,47m
14156,1,[西南风]会哭的佩可莉姆,2743,285,10,3,13,76.9%,1h
14156,3,[四十四]rocky,2743,231,10,9,19,52.6%,35m
14156,3,鼓捣装神,2743,256,10,13,23,43.5%,10m
14156,3,[马辉没有马]iTrick,2743,146,7,7,14,50.0%,58m
14156,3,小呱呱萌萌哒,2743,116,5,9,14,35.7%,24m
14156,3,aaaaaaa,2743,135,3,4,7,42.9%,7m
14156,1,空心馒头,2743,0,3,5,8,37.5%,42m
14156,3,illusion,2743,30,2,2,4,50.0%,6m
14156,3,金大哥,2743,0,2,3,5,40.0%,1h
14156,3,毁灭之捶,2743,0,1,1,2,50.0%,15m
14156,1,陆战队掌勺的,2743,38,1,2,3,33.3%,45m
14156,1,刀锋剑影,2743,0,1,3,4,25.0%,1h
14156,1,Bolo,2743,0,0,1,1,0.0%,15m
14156,1,吭兑有,2743,0,0,1,1,0.0%,14m
14181,1,诚实的小猎人,2742,508,164,169,333,49.2%,44m
14181,3,[红茶会]专业星际八一零年,2742,839,106,87,193,54.9%,26m
14181,2,海蓝,2742,1157,96,91,187,51.3%,2m
14181,3,无名的英雄,2742,1553,88,66,154,57.1%,23m
14181,1,[第九駆逐鑑隊]Faine,2742,1604,83,78,161,51.6%,1h
14181,2,[保证不秀地堡]恐怖如斯,2742,609,65,65,130,50.0%,20m
14181,1,绝世无双,2742,1045,42,31,73,57.5%,45m
14181,2,IIIIIIIIIIII,2742,137,6,4,10,60.0%,1h
14181,2,[宇宙职业战队]Classical,2742,190,6,15,21,28.6%,26m
14181,1,snow,2742,171,5,0,5,100.0%,56m
14181,3,INnoSerral,2742,132,4,2,6,66.7%,28m
14181,3,Crazy,2742,159,4,4,8,50.0%,13m
14181,1,使徒,2742,141,3,1,4,75.0%,31m
14181,1,卡拉肖克丶云,2742,38,2,0,2,100.0%,2m
14181,3,ashwell,2742,0,2,3,5,40.0%,9m
14181,3,祸首亮,2742,30,2,4,6,33.3%,6m
14181,1,别这么认真啊,2742,0,1,0,1,100.0%,46m
14181,3,[落魄山]人类最强近战,2742,0,1,1,2,50.0%,24m
14181,3,海淀孙一峰,2742,0,0,2,2,0.0%,27m
14200,3,电竞马保国,2741,364,12,11,23,52.2%,22m
14200,3,万恶的大表哥,2741,269,10,9,19,52.6%,1h
14200,3,[paypay]魔法男孩孙一峰,2741,168,7,8,15,46.7%,1h
14200,1,[孙红雷]心語巧克力,2741,190,5,4,9,55.6%,35m
14200,3,饭饭,2741,122,4,6,10,40.0%,49m
14200,3,博丽灵梦,2741,36,3,2,5,60.0%,1h
14200,1,槐诗,2741,0,3,4,7,42.9%,1h
14200,1,JulianManson,2741,0,3,5,8,37.5%,1h
14200,3,神奇的土豆,2741,0,2,1,3,66.7%,1h
14200,1,凛冬,2741,0,2,3,5,40.0%,1h
14200,3,Arestone,2741,0,1,2,3,33.3%,48m
14200,1,[SFTRA3]MisakaMikoto,2741,0,1,5,6,16.7%,21m
14200,2,[众神议会]阿锐哦,2741,0,0,1,1,0.0%,1h
14200,3,Sorilar,2741,0,0,2,2,0.0%,7m
14200,1,killour,2741,0,0,3,3,0.0%,1h
14200,3,KISS,2741,0,0,4,4,0.0%,25m
14216,3,[慢手e族]松鼠,2740,1444,215,207,422,50.9%,22m
14216,1,欣晨艾露,2740,442,49,40,89,55.1%,45m
14216,3,AiZhimin,2740,720,28,24,52,53.8%,26m
14216,3,三日月夜空,2740,548,25,28,53,47.2%,18m
14216,3,cold,2740,547,22,21,43,51.2%,15m
14216,2,[KZiiii]酒店的高手,2740,454,17,21,38,44.7%,46m
14216,3,[逗比神教]零零小副官,2740,354,13,15,28,46.4%,10m
14216,2,[吻丶Say]LoseControl,2740,200,7,12,19,36.8%,3m
14216,2,墨轩哥哥,2740,124,5,12,17,29.4%,21m
14216,1,Kandu,2740,110,4,1,5,80.0%,4m
14216,3,杰克,2740,0,4,1,5,80.0%,1h
14216,2,崩坏小丑,2740,117,4,1,5,80.0%,1h
14216,3,山猪儿吃不来细糠,2740,90,4,6,10,40.0%,27m
14216,1,KPOkaht,2740,48,4,6,10,40.0%,27m
14216,2,奇谋百变庄文革,2740,92,4,11,15,26.7%,30m
14216,3,Bereavement,2740,30,3,5,8,37.5%,14m
14216,1,清清浅浅,2740,38,2,0,2,100.0%,52m
14216,1,小北,2740,30,2,0,2,100.0%,1h
14216,1,雪花飘飞,2740,136,2,6,8,25.0%,42m
14216,3,JInzhiyu,2740,0,1,0,1,100.0%,26m
14216,1,梦的凝固,2740,0,1,0,1,100.0%,52m
14216,3,[变态萝莉控]soldiers,2740,0,1,1,2,50.0%,23m
14216,1,被遗忘在天,2740,0,0,1,1,0.0%,56m
14216,2,幕后嘉宾,2740,0,0,1,1,0.0%,15m
14216,1,[血战菜鸡]KURONG,2740,0,0,2,2,0.0%,43m
14241,1,人族红领巾,2739,1619,224,220,444,50.5%,43m
14241,1,[红莲骑士团]yesandno,2739,1458,82,74,156,52.6%,28m
14241,2,学习学疯了,2739,1359,82,86,168,48.8%,43m
14241,1,小成故事,2739,1551,68,71,139,48.9%,12m
14241,3,Blue,2739,873,50,53,103,48.5%,6m
14241,1,Lcrab,2739,876,44,51,95,46.3%,20m
14241,3,ramlethal,2739,499,21,11,32,65.6%,24m
14241,1,[华溪岛]极光,2739,367,11,8,19,57.9%,33m
14241,3,二色蓮花蝶,2739,206,8,9,17,47.1%,17m
14241,1,macker,2739,259,7,10,17,41.2%,27m
14241,2,[暴雪我是你爹]色相头,2739,112,6,1,7,85.7%,1h
14241,3,一波狗全家暴毙,2739,142,5,9,14,35.7%,47m
14241,2,纸鸢丶,2739,93,4,3,7,57.1%,6m
14241,2,daiozhatian,2739,135,3,0,3,100.0%,24m
14241,3,[熊翔帝国]熊本富二代,2739,97,3,3,6,50.0%,5m
14241,3,dulang,2739,107,3,4,7,42.9%,18m
14241,3,XiaoAnn,2739,62,3,7,10,30.0%,24m
14241,3,[AgCu电池]我雷兽三连了,2739,93,2,1,3,66.7%,4m
14241,2,[NavyF]逢坂大河,2739,0,2,4,6,33.3%,1h
14241,1,智力无法接受,2739,109,2,4,6,33.3%,1h
14241,2,请打别人吧,2739,114,2,7,9,22.2%,2m
14241,1,Hikari,2739,0,1,0,1,100.0%,1h
14241,1,么么哒,2739,0,1,0,1,100.0%,33m
14241,2,SchalkeZYY,2739,95,1,1,2,50.0%,1h
14241,2,Melt,2739,46,1,2,3,33.3%,6m
14241,1,鸡贼的王司机,2739,48,1,5,6,16.7%,1h
14241,2,手握萝莉摘星辰,2739,0,0,1,1,0.0%,1h
14241,1,BlueNDX,2739,0,0,3,3,0.0%,1h
14241,2,千壑,2739,0,0,4,4,0.0%,6m
14270,1,颅献皇座血祭神皇,2738,1549,166,161,327,50.8%,9m
14270,3,Mox,2738,977,100,89,189,52.9%,24m
14270,2,子兮不懂人族,2738,775,32,30,62,51.6%,22m
14270,3,ysx,2738,633,28,22,50,56.0%,15m
14270,1,[Sfae]千堂瑛里华,2738,751,26,24,50,52.0%,56m
14270,3,狗曰的幸福,2738,123,5,7,12,41.7%,1h
14270,3,ETRobet,2738,195,5,8,13,38.5%,35m
14270,3,[浪啊浪]QIRIIYUE,2738,116,4,9,13,30.8%,15m
14270,1,[强制生育谐会]生男生女都一样,2738,87,3,1,4,75.0%,36m
14270,3,繁华落尽倾城泪,2738,70,3,5,8,37.5%,20m
14270,3,赌怪,2738,0,2,3,5,40.0%,12m
14270,2,[天子这大菜B]羽羽羽羽羽羽,2738,0,2,3,5,40.0%,1h
14270,2,lost,2738,94,2,4,6,33.3%,1h
14270,3,[XMG00]solo,2738,40,1,5,6,16.7%,1h
14270,2,nexus,2738,0,0,1,1,0.0%,1h
14270,2,喜多福,2738,0,0,2,2,0.0%,12m
14270,3,[太刀天下第一]垃圾人,2738,0,0,3,3,0.0%,15m
14287,1,天下一番,2737,1464,152,129,281,54.1%,5m
14287,1,erictt,2737,1623,76,71,147,51.7%,1h
14287,2,[落魄山]byeUtopia,2737,1506,62,68,130,47.7%,23m
14287,3,lijuzi,2737,1376,57,46,103,55.3%,7m
14287,2,dirk,2737,970,37,34,71,52.1%,43m
14287,3,[sord]Augustfour,2737,716,32,29,61,52.5%,15m
14287,3,君莫笑,2737,551,26,29,55,47.3%,5m
14287,1,学艺使人长胖,2737,449,22,12,34,64.7%,1h
14287,3,waris,2737,518,21,16,37,56.8%,18m
14287,3,Gravity,2737,314,13,15,28,46.4%,24m
14287,1,luesshine,2737,171,8,11,19,42.1%,45m
14287,3,[圣德怀特学园]宛枫,2737,193,7,4,11,63.6%,15m
14287,3,[面具老流氓]戴面具的老流氓,2737,0,4,1,5,80.0%,1h
14287,1,keeper,2737,140,4,4,8,50.0%,14m
14287,2,[CMFit]clkkk,2737,94,4,10,14,28.6%,28m
14287,2,[淦1]刘大炮,2737,135,3,4,7,42.9%,30m
14287,1,[WOSk]brilliantly,2737,38,2,1,3,66.7%,4m
14287,3,貝吉塔,2737,0,2,4,6,33.3%,15m
14287,1,[呆毛来我迦]Llxiang,2737,0,1,0,1,100.0%,2m
14287,1,Cxxxo,2737,36,1,1,2,50.0%,1h
14287,1,人往睾处肘,2737,40,1,1,2,50.0%,1h
14287,1,[守护巨龙]jiangxswy,2737,0,0,1,1,0.0%,29m
14287,1,毒奶防疫站,2737,0,0,1,1,0.0%,1h
14310,3,[来自喵星的人]CNge,2736,1340,117,100,217,53.9%,8m
14310,2,惩罚者,2736,1407,110,107,217,50.7%,22m
14310,3,nixieo,2736,725,32,22,54,59.3%,8m
14310,3,影丨杀手,2736,676,26,25,51,51.0%,14m
14310,3,无限剑制,2736,588,23,20,43,53.5%,24m
14310,3,[幽冥之狼]要把握好时机,2736,384,14,17,31,45.2%,47m
14310,1,Zonelrh,2736,406,13,7,20,65.0%,52m
14310,2,新星,2736,296,12,19,31,38.7%,20m
14310,1,茗锦,2736,233,9,9,18,50.0%,3m
14310,3,[真实大帝哦]清雨,2736,223,7,7,14,50.0%,22m
14310,2,xvkong,2736,119,4,4,8,50.0%,30m
14310,1,[AF]龙将,2736,150,4,5,9,44.4%,45m
14310,2,人神共愤,2736,0,3,3,6,50.0%,1h
14310,1,KIKO,2736,103,1,4,5,20.0%,1h
14310,1,lbh,2736,0,0,1,1,0.0%,1h
14310,2,隔壁老王,2736,0,0,1,1,0.0%,33m
14310,1,[叫声好哥哥]中学生,2736,0,0,2,2,0.0%,1h
14327,1,[小阿giao]Shidifu,2735,1576,131,116,247,53.0%,22m
14327,1,yongud,2735,686,128,119,247,51.8%,1h
14327,1,[星歌]Umeagi,2735,1064,37,49,86,43.0%,5m
14327,1,hank,2735,655,27,13,40,67.5%,47m
14327,3,[文韬武略]sdhftuwy,2735,519,20,18,38,52.6%,6m
14327,3,淦恁那朱振义,2735,232,8,7,15,53.3%,1h
14327,3,风花散,2735,162,5,2,7,71.4%,58m
14327,3,假的星际玩家,2735,0,3,2,5,60.0%,1h
14327,1,[爆笑艾泽拉斯]Legend,2735,38,2,1,3,66.7%,19m
14327,2,number,2735,0,2,2,4,50.0%,1h
14327,1,恋恋世界第一,2735,0,1,0,1,100.0%,52m
14327,3,幻墨,2735,0,1,0,1,100.0%,12m
14327,3,电脑,2735,0,1,2,3,33.3%,27m
14327,3,邪魔殿下,2735,0,0,1,1,0.0%,1h
14327,3,无限永生,2735,0,0,1,1,0.0%,1h
14327,3,一路走好,2735,0,0,3,3,0.0%,45m
14343,1,在下马保国,2734,1623,352,330,682,51.6%,16m
14343,3,[猛禽第二舰队]Scorpio,2734,1609,269,298,567,47.4%,4m
14343,3,[浙大战队]铜锣湾话事人,2734,857,61,57,118,51.7%,18m
14343,2,[最菜战队]Maybe,2734,1419,58,65,123,47.2%,15m
14343,3,我太鸡了,2734,433,15,13,28,53.6%,17m
14343,3,终南山下的闲人,2734,235,9,9,18,50.0%,1h
14343,1,[SK]氵雨丶神灬,2734,164,3,1,4,75.0%,29m
14343,3,小少,2734,58,3,3,6,50.0%,25m
14343,2,冥王,2734,0,3,3,6,50.0%,1h
14343,1,[瘾大眼瞎]胖次一丁,2734,116,3,4,7,42.9%,21m
14343,1,yellow,2734,90,2,1,3,66.7%,1h
14343,1,克鲁斯约翰,2734,0,1,0,1,100.0%,37m
14343,3,jimmyrone,2734,48,1,2,3,33.3%,48m
14343,3,Perfect,2734,30,1,3,4,25.0%,46m
14343,3,玩失忆,2734,0,0,1,1,0.0%,12m
14343,1,SCboyLuyao,2734,0,0,1,1,0.0%,44m
14343,1,[306]MAXINGER,2734,0,0,1,1,0.0%,1h
14343,3,ghost,2734,0,0,1,1,0.0%,12m
14343,1,你家隔壁王大爷,2734,0,0,2,2,0.0%,1h
14362,3,影峰,2733,1491,201,177,378,53.2%,3m
14362,3,骚到死,2733,1116,100,100,200,50.0%,18m
14362,3,[恋战皇朝]萌新三号,2733,811,33,34,67,49.3%,4m
14362,3,[IG丶]禁锢,2733,617,26,20,46,56.5%,25m
14362,1,[工口组]呆毛王,2733,462,18,12,30,60.0%,1h
14362,1,[暗狱]突丝猫,2733,460,14,11,25,56.0%,1h
14362,3,[LOHv]海洋,2733,321,14,20,34,41.2%,5m
14362,1,[娱乐组]丸山彩第一可爱,2733,181,7,1,8,87.5%,43m
14362,3,[MGnb]INnoVation,2733,213,7,5,12,58.3%,4m
14362,3,黑岩爱拉普兰德哟,2733,258,7,10,17,41.2%,45m
14362,3,美丽的潘姐姐,2733,151,5,5,10,50.0%,5m
14362,1,胡闲德,2733,157,4,0,4,100.0%,35m
14362,2,hideonli,2733,0,4,2,6,66.7%,13m
14362,2,FireHawk,2733,117,4,5,9,44.4%,1h
14362,2,老年二五仔,2733,46,3,5,8,37.5%,1h
14362,1,OAG,2733,117,2,2,4,50.0%,43m
14362,3,TomTang,2733,30,2,3,5,40.0%,49m
14362,3,唐棠,2733,0,2,3,5,40.0%,27m
14362,3,新垣结衣,2733,0,1,0,1,100.0%,1h
14362,1,wdnmd,2733,0,1,0,1,100.0%,1h
14362,2,[鸿泰伟业]影翼炽天使,2733,44,1,2,3,33.3%,22m
14362,2,泽青,2733,93,1,2,3,33.3%,19m
14362,1,小黄保护协会,2733,0,0,1,1,0.0%,1h
14362,3,water,2733,0,0,3,3,0.0%,7m
14386,3,[EL骑士团]克哈霓虹为我闪烁,2732,823,224,223,447,50.1%,19m
14386,3,[HUC青龙]xiaoliu,2732,1068,53,62,115,46.1%,16m
14386,3,[只狗不运营]Sakura,2732,109,23,20,43,53.5%,19m
14386,3,半杯凉茶,2732,495,21,9,30,70.0%,24m
14386,1,小学生,2732,301,10,7,17,58.8%,36m
14386,1,王者,2732,228,10,7,17,58.8%,6m
14386,1,[思君便安心]Mgou,2732,294,10,8,18,55.6%,43m
14386,3,少年儿童百科全书,2732,221,8,8,16,50.0%,14m
14386,2,快弃船,2732,178,5,3,8,62.5%,45m
14386,3,小蘑菇,2732,0,4,1,5,80.0%,22m
14386,1,电脑,2732,48,4,5,9,44.4%,1h
14386,3,[元苜会]飞天小老虎,2732,97,3,2,5,60.0%,1h
14386,3,[为了地球]musha,2732,62,3,9,12,25.0%,12m
14386,3,邻家小猫,2732,0,2,3,5,40.0%,49m
14386,3,[我是酱油众]暗邪,2732,0,2,3,5,40.0%,1h
14386,3,wowqnmlgb,2732,0,1,0,1,100.0%,28m
14386,1,[大姐酒家]呆毛王,2732,0,1,1,2,50.0%,44m
14386,3,随便搞,2732,90,1,1,2,50.0%,28m
14386,2,催奶圣手孙一峰,2732,0,1,2,3,33.3%,1h
14386,3,叫到分娩,2732,0,0,1,1,0.0%,12m
14386,1,axio,2732,0,0,1,1,0.0%,4m
14386,1,霸气的蠕虫,2732,0,0,1,1,0.0%,34m
14386,3,黑血兄弟,2732,0,0,2,2,0.0%,24m
14386,3,aier,2732,0,0,3,3,0.0%,6m
14410,2,[青青岛]天堂,2731,480,33,36,69,47.8%,22m
14410,3,我玩你,2731,406,23,20,43,53.5%,27m
14410,1,[雾之湖红萌馆]东风谷早苗,2731,286,11,3,14,78.6%,15m
14410,3,Noodles,2731,248,9,14,23,39.1%,25m
14410,1,lyy,2731,275,8,3,11,72.7%,38m
14410,3,JackCai,2731,190,7,10,17,41.2%,12m
14410,2,洗钱,2731,177,5,9,14,35.7%,12m
14410,1,German,2731,78,3,0,3,100.0%,57m
14410,1,IIIIIIIIIIII,2731,42,2,0,2,100.0%,22m
14410,3,Archer,2731,30,1,4,5,20.0%,24m
14410,1,[逝去的荣耀]深红的奏鸣,2731,0,0,1,1,0.0%,52m
14410,1,[PITB]三族之疡,2731,0,0,1,1,0.0%,1h
14410,1,[DWGDC]萌新,2731,0,0,1,1,0.0%,1h
14410,3,ALLURE,2731,0,0,3,3,0.0%,26m
14424,3,[菜有菜的道理]屠农啦,2730,872,66,78,144,45.8%,43m
14424,3,[菜有菜的道理]求求你不要狗我,2730,866,40,24,64,62.5%,18m
14424,3,步兵,2730,956,39,35,74,52.7%,49m
14424,3,神秘人,2730,939,37,36,73,50.7%,29m
14424,3,Prophet,2730,940,32,45,77,41.6%,19m
14424,1,[彩虹小玛]白雪公猪,2730,597,24,18,42,57.1%,1h
14424,1,渡鸦,2730,142,5,3,8,62.5%,1h
14424,1,Linonnade,2730,118,4,2,6,66.7%,6m
14424,3,沉默之初,2730,147,4,4,8,50.0%,23m
14424,1,[魂祀]defo,2730,0,3,4,7,42.9%,31m
14424,3,Weathering,2730,122,3,5,8,37.5%,13m
14424,3,monet,2730,0,2,3,5,40.0%,1h
14424,3,Santal,2730,0,1,1,2,50.0%,10m
14424,1,[彡暁弎彡鞺灘]三分清泉七分月,2730,46,1,2,3,33.3%,1h
14424,1,[琴帝失误了]爱民如子蒙斯克,2730,0,0,2,2,0.0%,47m
14424,1,YUKI,2730,0,0,2,2,0.0%,56m
14440,2,CyberVisionY,2729,1510,385,387,772,49.9%,2m
14440,1,阿发,2729,303,17,18,35,48.6%,7m
14440,1,三个人的宝贝,2729,239,7,7,14,50.0%,32m
14440,3,Dearest,2729,146,6,6,12,50.0%,22m
14440,1,[0o0]GYGT,2729,213,6,7,13,46.2%,48m
14440,2,snowrate,2729,115,4,4,8,50.0%,33m
14440,2,sfasf,2729,46,4,4,8,50.0%,1h
14440,3,INInovation,2729,92,4,8,12,33.3%,27m
14440,1,伞级战舰大和,2729,70,3,2,5,60.0%,57m
14440,3,[SCP基金會]浮城君,2729,58,3,5,8,37.5%,7m
14440,1,巅峰狂狼,2729,0,1,0,1,100.0%,1h
14440,1,[Domon]斡客,2729,0,0,1,1,0.0%,20m
14440,1,[A00]IIIIIIIIIIII,2729,0,0,1,1,0.0%,37m
14440,2,longbao,2729,0,0,1,1,0.0%,1h
14440,3,赫赫,2729,0,0,4,4,0.0%,20m
14440,3,Rosentale,2729,0,0,4,4,0.0%,1h
14440,2,[练出来了协会]练出来了,2729,0,0,7,7,0.0%,12m
14457,2,[暴雪我是你爹]gene,2728,1559,71,77,148,48.0%,47m
14457,3,fgwdq,2728,1386,68,64,132,51.5%,28m
14457,1,sancky,2728,494,27,22,49,55.1%,56m
14457,3,沙皇大伊万,2728,119,6,5,11,54.5%,13m
14457,1,小天,2728,140,6,7,13,46.2%,18m
14457,1,different,2728,112,3,1,4,75.0%,31m
14457,2,旭哥哥,2728,0,3,3,6,50.0%,1h
14457,3,荒了流年碎了梦,2728,30,3,3,6,50.0%,1h
14457,3,我需要集结部队,2728,44,3,4,7,42.9%,6m
14457,1,凉生初雨,2728,142,3,4,7,42.9%,27m
14457,3,[大哥的战队]cpa,2728,62,3,6,9,33.3%,49m
14457,1,[QWQa]小凛敢日坑道虫,2728,0,1,0,1,100.0%,35m
14457,1,豺狼,2728,0,0,1,1,0.0%,43m
14457,2,[NUPSL]ILoveSC,2728,0,0,1,1,0.0%,56m
14471,3,[内急]ASakuratooru,2727,1261,73,69,142,51.4%,6m
14471,2,INnoVation,2727,165,48,50,98,49.0%,12m
14471,3,忘忧岛,2727,258,31,20,51,60.8%,6m
14471,3,qyt,2727,610,22,20,42,52.4%,6m
14471,2,chase,2727,274,10,12,22,45.5%,1h
14471,2,FACL,2727,221,8,11,19,42.1%,37m
14471,3,[天地会分舵]IlIlIlIlIlIl,2727,231,7,7,14,50.0%,17m
14471,3,[谐字当头一个]倒悬的王朗,2727,168,5,4,9,55.6%,11m
14471,3,[专业收尸队]貔貅王爵,2727,180,5,6,11,45.5%,58m
14471,3,晓晓,2727,120,5,8,13,38.5%,49m
14471,3,木子曦,2727,120,5,10,15,33.3%,22m
14471,3,[爱国]Zerg,2727,0,4,1,5,80.0%,1h
14471,1,[阿瓦隆之斩]Dream,2727,76,3,1,4,75.0%,55m
14471,1,白北川,2727,76,3,1,4,75.0%,1h
14471,3,Mringrui,2727,97,3,3,6,50.0%,1h
14471,1,BLACKFENCER,2727,96,2,1,3,66.7%,32m
14471,3,Crawar,2727,0,2,3,5,40.0%,38m
14471,3,孖的个锶,2727,0,2,3,5,40.0%,1h
14471,3,小楼,2727,30,2,3,5,40.0%,25m
14471,3,YINGXS,2727,0,2,3,5,40.0%,1h
14471,1,[NavyF]凋零丿物语,2727,0,1,0,1,100.0%,14m
14471,1,IIIIIIIIIIII,2727,38,1,2,3,33.3%,20m
14471,1,[及時行樂]符华上仙是真滴强,2727,36,1,2,3,33.3%,56m
14471,1,[谐能打鸡]国铜选手焦作人,2727,0,0,1,1,0.0%,2m
14471,3,[主观唯心主义]wHisPeR,2727,0,0,1,1,0.0%,1h
14471,1,zyx,2727,0,0,1,1,0.0%,4m
14471,1,暗夜,2727,0,0,1,1,0.0%,1h
14498,3,ChiangMaisky,2726,1546,333,320,653,51.0%,27m
14498,2,秀智呀秀智,2726,1530,265,263,528,50.2%,4m
14498,1,MeOwSirrr,2726,1233,126,117,243,51.9%,12m
14498,3,[不知不觉天亮]孙一喵,2726,1448,123,105,228,53.9%,15m
14498,3,九尾凶猫,2726,1497,116,87,203,57.1%,45m
14498,3,鱼唇的叶某人,2726,872,86,77,163,52.8%,23m
14498,2,[辉煌永续]Duncan,2726,1489,62,68,130,47.7%,23m
14498,3,一帮大肥猪,2726,361,21,19,40,52.5%,46m
14498,1,[风涩]二十五夜,2726,360,12,7,19,63.2%,1h
14498,3,[soki]Mordor,2726,254,9,12,21,42.9%,15m
14498,1,水银,2726,248,8,7,15,53.3%,34m
14498,1,Dark,2726,230,7,2,9,77.8%,49m
14498,1,老蔡,2726,168,7,7,14,50.0%,35m
14498,1,云端祥龙,2726,253,6,7,13,46.2%,41m
14498,2,拱火天喵孙一峰,2726,125,5,5,10,50.0%,1h
14498,2,[斯巴达血战团]寒封丨飘雪,2726,137,5,7,12,41.7%,1h
14498,2,MIRACLE,2726,0,4,2,6,66.7%,1h
14498,1,[天意不可违]穆雅,2726,74,3,2,5,60.0%,57m
14498,1,IIIIIIIIIIII,2726,100,3,2,5,60.0%,19m
14498,3,卡迪卡,2726,0,2,3,5,40.0%,1h
14498,2,[TNLet]Vittorino,2726,0,2,4,6,33.3%,17m
14498,2,zoeyqaq,2726,135,2,7,9,22.2%,13m
14498,1,[我们是无敌的]混沌勇士,2726,0,1,0,1,100.0%,1h
14498,3,[断牙超帅的啊]Optimusprime,2726,0,1,0,1,100.0%,4m
14498,1,脏脏,2726,0,1,1,2,50.0%,44m
14498,3,幽魂,2726,0,1,3,4,25.0%,1h
14498,1,马保国,2726,0,0,1,1,0.0%,55m
14498,1,realzp,2726,0,0,1,1,0.0%,38m
14498,1,[最菜战队]十二地死妈死全家,2726,0,0,1,1,0.0%,1h
14498,3,星际小菜虫,2726,0,0,4,4,0.0%,49m
14528,3,简单的电脑,2725,1509,197,184,381,51.7%,49m
14528,3,[肝帝]乖乖小豪豪,2725,1067,146,160,306,47.7%,17m
14528,3,运营太难了吧呜呜,2725,1316,58,52,110,52.7%,14m
14528,3,颍川之主,2725,746,41,41,82,50.0%,22m
14528,2,Eureka,2725,267,14,17,31,45.2%,2m
14528,1,洞香春主,2725,310,13,12,25,52.0%,21m
14528,1,[硬骨头会所]孜然啊孜然,2725,346,12,6,18,66.7%,38m
14528,1,climic,2725,273,8,3,11,72.7%,21m
14528,2,[886]一毛钱硬币,2725,152,5,5,10,50.0%,1h
14528,1,追逐黑暗,2725,142,3,3,6,50.0%,45m
14528,3,[雁门苍云]咬人猫,2725,30,2,2,4,50.0%,24m
14528,3,零氪,2725,0,2,3,5,40.0%,1h
14528,1,[女神的叹息]苏日天,2725,142,2,4,6,33.3%,1h
14528,2,洋爱奕,2725,0,1,0,1,100.0%,1h
14528,3,Apple,2725,0,0,1,1,0.0%,24m
14528,2,Satellite,2725,0,0,1,1,0.0%,1h
14528,1,Fyah,2725,0,0,2,2,0.0%,1h
14545,2,独狼,2724,1560,175,163,338,51.8%,23m
14545,3,GQgenius,2724,1569,119,113,232,51.3%,14m
14545,3,[0D]张氏浪子,2724,1526,103,94,197,52.3%,29m
14545,3,PTHE,2724,1558,82,74,156,52.6%,49m
14545,1,[脉脉不得语]呆呆,2724,561,22,18,40,55.0%,1h
14545,2,小付,2724,368,14,14,28,50.0%,9m
14545,3,变成娜哈特的狗,2724,318,11,14,25,44.0%,17m
14545,3,[哔哩哔哩肝杯]倾听那旋律,2724,274,9,9,18,50.0%,25m
14545,1,[星舰与太阳x]Crane,2724,208,8,0,8,100.0%,1h
14545,1,IIIIIIIIII,2724,226,7,4,11,63.6%,1h
14545,1,minititan,2724,217,5,3,8,62.5%,1h
14545,2,杰出普莱尔,2724,198,5,6,11,45.5%,47m
14545,2,祁宝儿,2724,134,5,11,16,31.2%,22m
14545,3,[先进的程序]whitegive,2724,114,4,8,12,33.3%,45m
14545,1,[summer]伏见老贼,2724,111,3,2,5,60.0%,1h
14545,2,苏苏苏卡不烈,2724,94,3,4,7,42.9%,30m
14545,1,又懒又笨只会嘤嘤,2724,0,1,0,1,100.0%,1h
14545,1,FIyboat,2724,40,1,1,2,50.0%,29m
14545,1,宇宙第一大元帅,2724,0,0,1,1,0.0%,16m
14545,3,[四糸乃]最可爱的星宫六喰,2724,0,0,3,3,0.0%,6m
14565,2,Singularity,2723,1487,174,159,333,52.3%,16m
14565,2,[CPT]百年经典,2723,1564,76,69,145,52.4%,27m
14565,3,GsAyls,2723,508,20,17,37,54.1%,23m
14565,1,超性能芊芊,2723,265,10,1,11,90.9%,21m
14565,1,boar,2723,184,7,5,12,58.3%,1h
14565,1,EnTropy,2723,212,6,3,9,66.7%,7m
14565,1,IIIIIIIIIIII,2723,152,5,2,7,71.4%,16m
14565,3,bogy,2723,160,5,6,11,45.5%,6m
14565,3,冬夜雪下,2723,203,5,8,13,38.5%,42m
14565,3,霜云,2723,0,4,1,5,80.0%,5m
14565,2,白门楼,2723,197,4,8,12,33.3%,24m
14565,1,星际笨哥,2723,108,3,3,6,50.0%,43m
14565,1,孤独而热血的梦,2723,76,2,2,4,50.0%,45m
14565,1,格式化影子,2723,0,1,1,2,50.0%,38m
14565,2,协议,2723,0,1,6,7,14.3%,34m
14565,1,Artillery,2723,0,0,1,1,0.0%,32m
14565,1,孙一峰你又藏牛,2723,0,0,1,1,0.0%,1h
14565,1,[miku守护]Asds,2723,0,0,1,1,0.0%,57m
14583,3,肖战哥哥打星际狗,2722,653,96,91,187,51.3%,26m
14583,1,努力上白银,2722,1364,54,41,95,56.8%,1h
14583,1,[此地虎牢关]落羽汐月,2722,372,12,6,18,66.7%,2m
14583,3,Demon,2722,298,11,8,19,57.9%,11m
14583,1,斩服丶缠流子,2722,183,8,8,16,50.0%,20m
14583,1,跨光年的距离,2722,102,4,4,8,50.0%,29m
14583,3,银戟,2722,97,3,3,6,50.0%,1h
14583,3,IIIIIIIIIIII,2722,0,2,3,5,40.0%,1h
14583,3,憨色是小天使,2722,30,2,5,7,28.6%,6m
14583,3,Chen,2722,0,1,2,3,33.3%,18m
14583,3,ORECS,2722,0,0,1,1,0.0%,1h
14594,2,雾雨听雷,2721,1264,121,123,244,49.6%,10m
14594,3,ReVe,2721,1557,104,88,192,54.2%,15m
14594,3,三叶草战神,2721,1067,60,50,110,54.5%,24m
14594,3,原谅犬,2721,1022,51,35,86,59.3%,28m
14594,3,[黑丝小幼女]唐宛如,2721,1101,48,39,87,55.2%,49m
14594,3,[西瓜保熟不]叶神,2721,878,30,36,66,45.5%,17m
14594,1,Posoon,2721,609,26,13,39,66.7%,1h
14594,3,saibasidian,2721,725,26,28,54,48.1%,17m
14594,2,单身汉,2721,451,18,20,38,47.4%,46m
14594,3,[KPG]dart,2721,371,15,15,30,50.0%,28m
14594,3,天之永恒,2721,458,15,22,37,40.5%,27m
14594,3,bullet,2721,241,10,9,19,52.6%,26m
14594,1,BarryZL,2721,279,9,5,14,64.3%,19m
14594,1,[金色传说]青君,2721,158,6,3,9,66.7%,44m
14594,3,BeiNi,2721,46,5,2,7,71.4%,1h
14594,3,人族永不言弃,2721,146,4,4,8,50.0%,20m
14594,3,就爱虐你么么哒,2721,92,4,5,9,44.4%,6m
14594,1,剑来,2721,110,3,2,5,60.0%,1h
14594,3,樱岛麻衣,2721,0,3,2,5,60.0%,1h
14594,1,lalaal,2721,108,3,3,6,50.0%,32m
14594,1,sddddddddddd,2721,0,3,4,7,42.9%,5m
14594,1,[大元师]寒冷既是虚,2721,40,2,1,3,66.7%,20m
14594,1,Renault,2721,40,2,1,3,66.7%,55m
14594,3,耳东陈,2721,0,2,3,5,40.0%,1h
14594,3,Tsum,2721,60,2,6,8,25.0%,7m
14594,1,[DMRe]小磊,2721,0,1,0,1,100.0%,2m
14594,2,[虫群开始行动]温故而知新,2721,0,1,0,1,100.0%,56m
14594,1,[上地主]香蕉,2721,0,1,0,1,100.0%,19m
14594,3,以敬山川,2721,0,1,1,2,50.0%,1h
14594,2,乞力马扎罗,2721,94,1,1,2,50.0%,1h
14594,3,[NVIDIA]Acehearts,2721,30,1,5,6,16.7%,15m
14594,3,[七咕咕]一束七的小迷弟,2721,0,0,3,3,0.0%,28m
14626,3,[星云]卡布达,2720,1569,324,318,642,50.5%,8m
14626,2,铁砧,2720,1060,284,278,562,50.5%,16m
14626,3,大橙子,2720,1511,275,248,523,52.6%,27m
14626,3,AAAAA,2720,394,42,29,71,59.2%,6m
14626,3,[FMSI]MassiveCoco,2720,552,41,39,80,51.2%,14m
14626,3,深夜丶孤行,2720,625,28,21,49,57.1%,17m
14626,3,[九天星辰同萌]tangnice,2720,724,27,32,59,45.8%,18m
14626,1,真爱,2720,610,26,20,46,56.5%,1h
14626,1,[跑跑卡丁车]Avatar,2720,367,13,15,28,46.4%,47m
14626,3,寒沙折羽,2720,278,10,8,18,55.6%,27m
14626,1,我不是断手人族,2720,136,5,4,9,55.6%,21m
14626,2,flashguy,2720,47,5,15,20,25.0%,27m
14626,1,叔叔有棒棒糖,2720,48,4,6,10,40.0%,7m
14626,3,小花园,2720,0,2,3,5,40.0%,49m
14626,3,科普卢第一莽夫,2720,0,1,0,1,100.0%,1h
14626,1,[Krist]我娶孙换家,2720,0,0,1,1,0.0%,6m
14626,1,[中华讲武堂]songru,2720,0,0,1,1,0.0%,20m
14643,1,[二科天下第一]御坂美琴,2719,1635,124,114,238,52.1%,37m
14643,1,HAHAHA,2719,1019,46,43,89,51.7%,32m
14643,2,星际指挥官,2719,535,21,23,44,47.7%,28m
14643,3,[EV]Lelouch,2719,340,18,19,37,48.6%,23m
14643,2,血锋修罗心,2719,113,6,6,12,50.0%,26m
14643,1,ZhsqZ,2719,144,5,7,12,41.7%,10m
14643,3,专业抄袭年,2719,133,3,2,5,60.0%,1h
14643,1,[星际旅游团]午后的抹茶,2719,108,3,3,6,50.0%,22m
14643,3,顽石,2719,62,3,5,8,37.5%,46m
14643,2,马官人,2719,132,3,5,8,37.5%,46m
14643,2,Ciele,2719,0,2,2,4,50.0%,1h
14643,3,businessman,2719,0,2,3,5,40.0%,4m
14643,1,墨嬴,2719,36,1,1,2,50.0%,1h
14643,3,灬玖,2719,0,0,4,4,0.0%,28m
14657,2,[秋毫七队]香烟没毒,2718,1531,325,304,629,51.7%,24m
14657,2,狂战飞鞋圣剑,2718,1499,307,323,630,48.7%,19m
14657,1,雨夜,2718,1683,108,108,216,50.0%,32m
14657,1,[KPG2]化身邪恶富婆杀手,2718,1646,93,83,176,52.8%,34m
14657,1,IIIIIIII,2718,998,84,86,170,49.4%,45m
14657,3,蓝色空间,2718,1113,82,78,160,51.2%,6m
14657,1,kaishuihu,2718,826,26,28,54,48.1%,44m
14657,1,ByuN,2718,678,25,35,60,41.7%,20m
14657,3,llllll,2718,314,12,9,21,57.1%,1h
14657,3,[自由的气息]PIMBA,2718,270,11,8,19,57.9%,18m
14657,3,暗夜骑士,2718,262,9,9,18,50.0%,18m
14657,1,[RHODE]Genro,2718,142,4,5,9,44.4%,1h
14657,3,[陪我闹]飒冥,2718,0,3,2,5,60.0%,1h
14657,3,[miku守护]消失的雨,2718,117,3,3,6,50.0%,47m
14657,1,LOSTTIME,2718,78,3,4,7,42.9%,19m
14657,3,[终极咸鱼]咸者之鱼,2718,30,2,6,8,25.0%,5m
14657,1,zhoushunqin,2718,0,1,0,1,100.0%,1h
14657,1,[西伯利亚土豆]Dragon,2718,0,1,0,1,100.0%,38m
14657,1,galaxyc,2718,0,1,0,1,100.0%,43m
14657,1,科洛利亚侧翼,2718,40,1,1,2,50.0%,1h
14657,1,小鸟儿小,2718,0,0,3,3,0.0%,52m
14678,1,瞎子,2717,1549,88,78,166,53.0%,21m
14678,3,insomniachu,2717,264,25,16,41,61.0%,19m
14678,3,PsychoQAQ,2717,465,18,18,36,50.0%,23m
14678,3,[为了艾萌]Ter,2717,414,16,16,32,50.0%,20m
14678,1,我有点傻,2717,350,12,10,22,54.5%,46m
14678,1,[工程萌男]misCor,2717,253,11,4,15,73.3%,38m
14678,3,[P1训练队]GAYGEY,2717,267,9,10,19,47.4%,14m
14678,1,拉莱耶之仆,2717,0,5,3,8,62.5%,10m
14678,1,Polaris,2717,112,4,2,6,66.7%,1h
14678,2,xavier,2717,0,4,2,6,66.7%,1h
14678,2,土猫在木星,2717,164,4,4,8,50.0%,45m
14678,1,[LuckyE]Aeroblop,2717,48,1,4,5,20.0%,1h
14678,1,[为了娱乐]XIXIHAHADADA,2717,0,0,2,2,0.0%,47m
14678,1,天涯人生,2717,0,0,2,2,0.0%,19m
14678,2,笨比萌娘团,2717,0,0,6,6,0.0%,1h
14693,2,Leah,2716,341,100,88,188,53.2%,5m
14693,3,nemo,2716,1496,94,105,199,47.2%,21m
14693,3,歐德拽,2716,733,63,49,112,56.2%,5m
14693,1,十一三,2716,453,17,11,28,60.7%,11m
14693,1,陌巷思君,2716,381,14,15,29,48.3%,32m
14693,1,苍茫也晴天,2716,319,11,5,16,68.8%,1h
14693,3,弑神,2716,135,11,6,17,64.7%,21m
14693,3,臣妾紧握朕龙根,2716,276,9,9,18,50.0%,23m
14693,1,艹太阳丶,2716,207,8,6,14,57.1%,1h
14693,3,Faker,2716,212,7,13,20,35.0%,6m
14693,2,白狐,2716,118,5,3,8,62.5%,1h
14693,2,大西瓜和大菠萝,2716,0,4,2,6,66.7%,1h
14693,2,[DMUNB]星际练席生,2716,0,3,3,6,50.0%,1h
14693,2,[傲世丨听雨轩]Magicglory,2716,0,3,4,7,42.9%,1h
14693,3,[破灭]fengxue,2716,146,3,5,8,37.5%,7m
14693,3,俺是萌新,2716,0,2,3,5,40.0%,1h
14693,3,[星核纪]Canky,2716,0,2,3,5,40.0%,1h
14693,3,[狂风暴风雨]星耀,2716,111,2,4,6,33.3%,27m
14693,1,Aimer,2716,0,1,0,1,100.0%,22m
14693,1,HuaJiYic,2716,0,1,1,2,50.0%,21m
14693,1,飞翀昊苍,2716,0,0,1,1,0.0%,1h
14693,1,[立华奏]立华奏,2716,0,0,1,1,0.0%,1h
14693,1,Dopa,2716,0,0,1,1,0.0%,22m
14693,1,五十铃华,2716,0,0,1,1,0.0%,19m
14693,1,战斗之裤,2716,0,0,1,1,0.0%,57m
14693,1,[极限战团]倒霉孩儿,2716,0,0,1,1,0.0%,1h
14693,1,月楼,2716,0,0,1,1,0.0%,53m
14720,3,店长,2715,623,29,21,50,58.0%,6m
14720,3,李奇,2715,321,14,15,29,48.3%,22m
14720,1,似水流年,2715,274,11,4,15,73.3%,11m
14720,3,[JUELE]JUELE,2715,221,8,7,15,53.3%,28m
14720,1,[HQX]ZXZXZX,2715,180,7,0,7,100.0%,1h
14720,1,[全村最好的科]比狗骚要命,2715,222,7,5,12,58.3%,44m
14720,3,带投大鸽,2715,117,7,6,13,53.8%,21m
14720,1,zzzzz,2715,108,4,2,6,66.7%,16m
14720,1,[红色锤镰]天启,2715,102,4,2,6,66.7%,43m
14720,2,[猫神]Sakura,2715,46,4,6,10,40.0%,17m
14720,3,旭日,2715,0,2,3,5,40.0%,5m
14720,1,爱到底,2715,0,1,0,1,100.0%,19m
14720,1,礁石,2715,0,1,0,1,100.0%,37m
14720,1,污啊啊啊啊啊,2715,0,1,1,2,50.0%,53m
14720,1,[星灵王]两节课,2715,40,1,3,4,25.0%,1h
14720,1,zzwwjj,2715,0,0,1,1,0.0%,1h
14720,1,[M416]不变永恒的怀念,2715,0,0,1,1,0.0%,2m
14720,1,残帆,2715,0,0,1,1,0.0%,32m
14720,1,大熊和星北,2715,0,0,1,1,0.0%,23m
14720,3,Green,2715,0,0,4,4,0.0%,7m
14740,1,煤油鸣志,2714,1492,103,90,193,53.4%,38m
14740,2,月香菱,2714,1225,62,61,123,50.4%,8m
14740,3,Yuuki,2714,369,15,17,32,46.9%,28m
14740,1,[剑桥斧头帮]电子越共,2714,293,12,3,15,80.0%,53m
14740,2,[呆毛来我迦]Daniel,2714,235,12,18,30,40.0%,15m
14740,3,[小鸡屠宰场3]幻瞬,2714,266,10,6,16,62.5%,1h
14740,3,[小鸡屠宰场2]倚仗天穹,2714,257,9,7,16,56.2%,18m
14740,1,zzz,2714,255,8,9,17,47.1%,50m
14740,1,飞龙大帝,2714,161,6,6,12,50.0%,58m
14740,2,全国制霸,2714,0,4,2,6,66.7%,1h
14740,1,川叶,2714,68,3,0,3,100.0%,21m
14740,3,人类的宿敌,2714,119,3,0,3,100.0%,7m
14740,2,zcr,2714,96,3,4,7,42.9%,1h
14740,3,WDNMD,2714,0,2,3,5,40.0%,1h
14740,3,[远坂世家]HKBlackWatch,2714,119,2,5,7,28.6%,3m
14740,1,千里烟波,2714,36,1,2,3,33.3%,32m
14740,3,[萝莉乃正义]give,2714,0,0,1,1,0.0%,14m
14757,2,萧然落叶,2713,803,77,80,157,49.0%,3m
14757,1,新的希望,2713,366,35,28,63,55.6%,16m
14757,2,Revolution,2713,856,34,35,69,49.3%,3m
14757,1,Timsless,2713,473,26,23,49,53.1%,57m
14757,1,雾雨魔理沙,2713,630,19,35,54,35.2%,5m
14757,3,待时间嘉许,2713,546,18,22,40,45.0%,5m
14757,2,[TOPZEG]vaioS,2713,432,14,27,41,34.1%,15m
14757,1,星际憋憋乐玩家,2713,199,8,3,11,72.7%,57m
14757,3,不怕神一样的对手,2713,205,8,8,16,50.0%,23m
14757,1,[TOCOON]Nightmale,2713,205,7,6,13,53.8%,38m
14757,3,[进击花园宝宝]玛卡巴卡,2713,0,4,1,5,80.0%,12m
14757,3,[天降同萌会]hkingv,2713,121,4,3,7,57.1%,18m
14757,3,Sakura,2713,75,4,7,11,36.4%,16m
14757,1,浪子末,2713,76,3,0,3,100.0%,43m
14757,1,黑色的宇,2713,136,3,4,7,42.9%,3m
14757,3,我老婆是雷姆,2713,58,3,7,10,30.0%,28m
14757,3,[余烬天怒]呢里不可以,2713,42,2,5,7,28.6%,12m
14757,1,阿拉纳克,2713,91,1,1,2,50.0%,16m
14775,3,nihao,2712,1417,365,353,718,50.8%,25m
14775,3,西天取经的打火机,2712,1597,349,334,683,51.1%,49m
14775,3,ZnORc,2712,1204,91,86,177,51.4%,47m
14775,3,毛球儿,2712,575,34,37,71,47.9%,16m
14775,1,无味浪味仙,2712,462,17,12,29,58.6%,28m
14775,1,已乘黄鹤去,2712,278,10,5,15,66.7%,16m
14775,1,[工程萌男]MagicXM,2712,168,5,1,6,83.3%,16m
14775,2,[BGD]喝醉的加菲猫丶,2712,142,5,4,9,55.6%,46m
14775,3,[Tov]艺龙,2712,116,5,8,13,38.5%,27m
14775,3,EASTMO,2712,92,4,9,13,30.8%,27m
14775,1,长命百岁苏沐秋,2712,74,3,4,7,42.9%,47m
14775,1,[孙红雷]ManarFal,2712,36,2,0,2,100.0%,1h
14787,2,共和国居士,2711,1564,110,112,222,49.5%,45m
14787,2,[软柿子]kingzea,2711,450,77,65,142,54.2%,30m
14787,3,小达,2711,1183,42,57,99,42.4%,28m
14787,1,名花解语,2711,707,29,17,46,63.0%,1h
14787,1,Confusing,2711,608,21,19,40,52.5%,1h
14787,1,小丑,2711,630,21,20,41,51.2%,1h
14787,1,丿解除丶,2711,552,17,15,32,53.1%,38m
14787,1,Gunball,2711,257,8,8,16,50.0%,31m
14787,1,hotdog,2711,243,8,9,17,47.1%,48m
14787,2,北海没有猫,2711,184,7,4,11,63.6%,1h
14787,1,[谐星w]实妹相伴小样菌,2711,165,7,6,13,53.8%,1h
14787,1,无人,2711,184,6,4,10,60.0%,16m
14787,2,yyu,2711,143,6,9,15,40.0%,55m
14787,3,garnidelia,2711,177,5,6,11,45.5%,26m
14787,3,如此凄美,2711,120,4,8,12,33.3%,16m
14787,3,Mark,2711,0,3,2,5,60.0%,1h
14787,3,pcc,2711,145,3,6,9,33.3%,20m
14787,2,[北京大学鸡协]Unterseeboot,2711,86,3,12,15,20.0%,45m
14787,3,西尔维娅,2711,0,2,3,5,40.0%,1h
14787,3,路过的鬼,2711,0,2,3,5,40.0%,1h
14787,1,[龙的传人的爹]Dran,2711,0,1,0,1,100.0%,16m
14787,3,HECTOR,2711,0,0,4,4,0.0%,49m
14809,1,梅天王,2710,1033,45,38,83,54.2%,32m
14809,2,yzlx,2710,924,32,41,73,43.8%,10m
14809,3,Sandy,2710,254,9,13,22,40.9%,47m
14809,3,黎子阳,2710,133,5,3,8,62.5%,1h
14809,2,[宫吧老哥狂喜]qwerta,2710,93,3,4,7,42.9%,6m
14809,1,Sky,2710,38,2,2,4,50.0%,3m
14809,1,克哈小兵,2710,78,2,2,4,50.0%,1h
14809,3,剑徒,2710,0,2,3,5,40.0%,24m
14809,3,[charm]寂寞在森林,2710,30,2,4,6,33.3%,5m
14809,3,苏科孙红雷,2710,30,2,4,6,33.3%,18m
14809,1,Azrael,2710,70,2,5,7,28.6%,52m
14809,1,[幻昼]乞讨少女自闭中,2710,0,1,1,2,50.0%,1h
14809,3,[大熊猫饲养员]星际好难啊,2710,95,1,2,3,33.3%,1h
14809,1,胡旋,2710,0,0,1,1,0.0%,1h
14809,1,Kiko,2710,0,0,1,1,0.0%,1h
14809,1,致命之足,2710,0,0,1,1,0.0%,1h
14809,1,[NGFIRE]FtoAdm,2710,0,0,3,3,0.0%,1h
14809,1,杜莎夫人蜡像馆,2710,0,0,3,3,0.0%,4m
14827,3,尔符久喵,2709,1102,123,115,238,51.7%,15m
14827,1,中期解决,2709,1452,107,115,222,48.2%,14m
14827,1,[恒古不灭]清水,2709,1552,74,58,132,56.1%,47m
14827,2,WJF,2709,1138,62,64,126,49.2%,23m
14827,2,wuse,2709,794,61,55,116,52.6%,49m
14827,3,赫克托,2709,382,16,13,29,55.2%,45m
14827,1,[Rhusky]黑皮豆奶,2709,180,5,2,7,71.4%,38m
14827,1,晓游明,2709,140,5,4,9,55.6%,57m
14827,1,[无须奉天]曦之神话,2709,58,3,2,5,60.0%,20m
14827,1,[爷不能死]霜之谐星,2709,112,3,3,6,50.0%,1h
14827,3,[大艾尔]ZeroTwo,2709,0,2,3,5,40.0%,20m
14827,1,[暴雪三十队]星旭,2709,0,0,1,1,0.0%,6m
14827,3,女生宿舍下卖黄鳝,2709,0,0,1,1,0.0%,4m
14840,3,狂热陆战队员,2708,1555,92,82,174,52.9%,29m
14840,2,胖胡,2708,1625,73,64,137,53.3%,10m
14840,2,wdoqkp,2708,857,71,75,146,48.6%,16m
14840,1,Anger,2708,1248,51,46,97,52.6%,38m
14840,3,一片空白,2708,893,38,32,70,54.3%,15m
14840,3,棕色的浣熊,2708,626,30,19,49,61.2%,26m
14840,1,[炸鱼大队]上海老鸡,2708,568,21,18,39,53.8%,44m
14840,1,闲的无聊,2708,442,19,14,33,57.6%,1h
14840,3,[幻想乐园计划]丰聪耳神子,2708,437,17,18,35,48.6%,18m
14840,1,雪之下雪乃,2708,366,11,26,37,29.7%,27m
14840,1,丨余生丿小啊然丨,2708,206,9,6,15,60.0%,32m
14840,1,圣锤之毅,2708,228,8,2,10,80.0%,11m
14840,1,uglyProtess,2708,256,8,9,17,47.1%,20m
14840,3,LeLapin,2708,185,5,3,8,62.5%,26m
14840,3,[华师大二附中]Noleft,2708,96,5,7,12,41.7%,47m
14840,1,wiofnwfg,2708,140,5,10,15,33.3%,1h
14840,3,[樱之岛]我是坑,2708,0,3,2,5,60.0%,1h
14840,2,hhh,2708,94,3,4,7,42.9%,15m
14840,3,[五十块的兄弟]mikesteve,2708,0,2,3,5,40.0%,1h
14840,1,最强康复治疗师,2708,0,1,0,1,100.0%,32m
14840,1,青衫,2708,0,1,1,2,50.0%,1h
14840,1,[泰伦白给王]Vertigo,2708,30,1,1,2,50.0%,4m
14840,1,毒奶打击就绪,2708,34,1,1,2,50.0%,38m
14840,3,老年手速打竞技,2708,0,1,4,5,20.0%,47m
14840,3,打不过就是打不过,2708,0,1,5,6,16.7%,4m
14840,2,欲展宏图,2708,0,0,1,1,0.0%,1h
14840,1,sion,2708,0,0,1,1,0.0%,1h
14867,3,[KPG2]酒后秒杀老丈人,2707,1465,165,149,314,52.5%,22m
14867,3,晴天好心情,2707,1012,100,92,192,52.1%,11m
14867,1,[东大电竞]Ishmael,2707,1427,53,51,104,51.0%,1h
14867,2,呆呆熊丶,2707,708,25,31,56,44.6%,3m
14867,1,[EP]憔悴小男人,2707,365,14,13,27,51.9%,46m
14867,1,我那么菜怎么办,2707,349,13,28,41,31.7%,14m
14867,3,小禹,2707,229,10,15,25,40.0%,11m
14867,1,[华溪岛]游戏真难,2707,262,9,7,16,56.2%,53m
14867,1,人机玩家,2707,190,8,10,18,44.4%,53m
14867,1,[对面四秒射]樱岛麻衣,2707,188,6,6,12,50.0%,21m
14867,1,[式神]epo,2707,142,5,3,8,62.5%,1h
14867,1,[DMR]夜雨的黑曜石,2707,151,5,6,11,45.5%,1h
14867,1,[牡丹]马云,2707,142,5,6,11,45.5%,1h
14867,1,[暴雪十三队]Rainbow,2707,186,4,3,7,57.1%,1h
14867,1,你是神魔恋,2707,103,4,3,7,57.1%,16m
14867,1,花钱月下,2707,110,4,3,7,57.1%,1h
14867,2,穿云剑,2707,178,4,6,10,40.0%,58m
14867,3,田园霸主皮皮汪,2707,0,3,2,5,60.0%,1h
14867,3,三上悠亚天下无敌,2707,92,3,5,8,37.5%,7m
14867,3,DengSIr,2707,40,2,1,3,66.7%,12m
14867,3,丿美加子,2707,0,2,3,5,40.0%,1h
14867,1,BYuN,2707,0,1,0,1,100.0%,29m
14867,1,[Girl]小小小小就是晓晓,2707,36,1,4,5,20.0%,1h
14867,1,Bxcn,2707,0,0,2,2,0.0%,32m
14867,3,怎么可以吃兔兔,2707,0,0,4,4,0.0%,18m
14892,3,达达,2706,1569,181,173,354,51.1%,4m
14892,3,鶸乚,2706,855,139,132,271,51.3%,23m
14892,3,健康的性福生活,2706,1236,53,53,106,50.0%,4m
14892,3,丑不拉几先生,2706,1129,45,46,91,49.5%,7m
14892,2,徐逸尘,2706,286,41,44,85,48.2%,8m
14892,2,aaape,2706,534,39,40,79,49.4%,23m
14892,1,韭菜,2706,365,13,14,27,48.1%,45m
14892,1,[纵丨横]xingye,2706,301,10,5,15,66.7%,1h
14892,2,[CPT]金艾尔马鹿,2706,125,6,3,9,66.7%,1h
14892,3,大脚盆,2706,176,5,8,13,38.5%,29m
14892,3,星际战将,2706,159,4,4,8,50.0%,1h
14892,1,[感觉优势很大]烈风天翼,2706,117,2,3,5,40.0%,59m
14892,1,[哔哩哔哩乾杯]古德莉安,2706,0,1,0,1,100.0%,1h
14892,1,丫丫,2706,26,1,1,2,50.0%,1h
14892,1,RealChange,2706,0,1,2,3,33.3%,38m
14892,1,[KAH]Hanson,2706,0,0,1,1,0.0%,11m
14892,3,笙箫昭玖,2706,0,0,3,3,0.0%,28m
14909,3,superchen,2705,1365,134,132,266,50.4%,11m
14909,2,[虫子觉醒]秋雨微微,2705,1493,114,113,227,50.2%,44m
14909,3,我要你妹,2705,152,74,66,140,52.9%,16m
14909,3,骑士魔王,2705,966,55,46,101,54.5%,15m
14909,3,[打我一波S全]新手,2705,1184,45,50,95,47.4%,26m
14909,1,JustRight,2705,778,44,44,88,50.0%,57m
14909,1,IMAOHW,2705,527,29,22,51,56.9%,53m
14909,1,指尖的艺术,2705,447,17,12,29,58.6%,1h
14909,2,[半个菜鸟II]花非花丶雾非雾,2705,464,15,22,37,40.5%,26m
14909,3,[火影何平]不打内战,2705,253,13,14,27,48.1%,29m
14909,2,阿伟,2705,293,11,12,23,47.8%,57m
14909,1,不识庐山,2705,300,10,9,19,52.6%,23m
14909,2,[社交学超可爱]我是菜鸟,2705,160,6,3,9,66.7%,7m
14909,3,梦晓,2705,152,5,10,15,33.3%,47m
14909,1,IIIIIIII,2705,46,4,7,11,36.4%,20m
14909,1,奥利给,2705,0,3,4,7,42.9%,1h
14909,3,BasiloneLi,2705,112,2,4,6,33.3%,16m
14909,1,JANo,2705,0,0,1,1,0.0%,1h
14909,1,[爱我就喊爸爸]爸爸,2705,0,0,2,2,0.0%,4m
14909,1,成王败寇,2705,0,0,2,2,0.0%,1h
14909,1,独孤求胜,2705,0,0,2,2,0.0%,38m
14930,3,llllllllll,2704,614,27,14,41,65.9%,15m
14930,1,EinhartreMan,2704,435,16,11,27,59.3%,1h
14930,1,安德鲁,2704,454,15,15,30,50.0%,52m
14930,1,[星际一号]zzy,2704,283,12,3,15,80.0%,45m
14930,3,cuijc,2704,208,8,11,19,42.1%,29m
14930,1,恋紫,2704,237,7,9,16,43.8%,1h
14930,2,sdfsdfse,2704,0,4,2,6,66.7%,1h
14930,2,oooo,2704,94,4,4,8,50.0%,17m
14930,2,聿君,2704,113,4,5,9,44.4%,30m
14930,3,[worst]NANGONG,2704,109,3,3,6,50.0%,19m
14930,3,PKUnourish,2704,97,2,3,5,40.0%,60m
14930,1,[amya]Cartaiin,2704,0,1,0,1,100.0%,18m
14930,1,TANLANG,2704,0,0,1,1,0.0%,37m
14930,1,GOLDMAN,2704,0,0,1,1,0.0%,32m
14930,1,一叶知烟云,2704,0,0,2,2,0.0%,19m
14930,1,出库单,2704,0,0,2,2,0.0%,42m
14946,3,那晚她很狼狈,2703,1067,55,32,87,63.2%,8m
14946,3,这是一个菜鸟,2703,299,28,24,52,53.8%,23m
14946,2,sfp,2703,548,27,28,55,49.1%,26m
14946,3,阴阳门,2703,391,16,11,27,59.3%,14m
14946,2,[GalArC]黑什么剑,2703,335,13,21,34,38.2%,48m
14946,1,养鱼局局长,2703,352,11,7,18,61.1%,21m
14946,1,[拨云见日]幼麒麟,2703,205,7,3,10,70.0%,45m
14946,1,[泯灭快车]Winseven,2703,180,5,3,8,62.5%,19m
14946,1,[四叶草]良月十八,2703,108,4,2,6,66.7%,21m
14946,1,泉水指挥官,2703,114,4,3,7,57.1%,23m
14946,3,暗影之龙,2703,146,4,5,9,44.4%,49m
14946,1,[好兄弟炸鸡]霸道总裁,2703,106,3,4,7,42.9%,3m
14946,3,夏布,2703,0,2,3,5,40.0%,59m
14946,1,[黑龙帝国]风影,2703,38,1,3,4,25.0%,29m
14946,1,huni,2703,0,0,1,1,0.0%,20m
14946,2,llllllllllll,2703,0,0,1,1,0.0%,22m
14962,3,wuyuan,2702,1507,98,91,189,51.9%,23m
14962,2,[火焰雷兽]Qianniu,2702,1625,92,105,197,46.7%,14m
14962,1,艾尔之盾,2702,1161,45,42,87,51.7%,4m
14962,3,[浙大战队]摇曳的快乐,2702,879,34,35,69,49.3%,24m
14962,1,Rabb,2702,743,28,22,50,56.0%,1h
14962,1,她似白月中来,2702,453,19,16,35,54.3%,1h
14962,3,青青子衿,2702,288,12,11,23,52.2%,53m
14962,1,Number,2702,213,10,7,17,58.8%,57m
14962,1,[艾尔之巅]水手一号,2702,146,4,7,11,36.4%,45m
14962,1,枫叶子,2702,72,3,2,5,60.0%,11m
14962,1,[NKVD]ShOhEi,2702,96,2,2,4,50.0%,52m
14962,3,金盆洗铁手,2702,0,2,3,5,40.0%,1h
14962,3,光滑滑,2702,0,2,3,5,40.0%,38m
14962,2,[嘿嘿嘿萌新]神族复兴由此开始,2702,94,1,2,3,33.3%,1h
14962,3,爆锤狗头,2702,0,1,4,5,20.0%,1h
14962,1,星际浪子,2702,0,0,1,1,0.0%,16m
14978,3,节拍音乐散弹枪,2701,1412,111,108,219,50.7%,23m
14978,3,[Qist]yudi,2701,1310,83,71,154,53.9%,4m
14978,3,Lee,2701,651,33,35,68,48.5%,6m
14978,1,简单电脑,2701,297,22,21,43,51.2%,1h
14978,2,暴君邪神,2701,378,15,19,34,44.1%,46m
14978,2,Lemom,2701,195,8,11,19,42.1%,34m
14978,2,gordonflyer,2701,244,7,14,21,33.3%,17m
14978,3,zzw,2701,162,6,12,18,33.3%,17m
14978,1,[神奇的联萌]辉夜,2701,177,5,1,6,83.3%,1h
14978,3,Arthas,2701,36,2,2,4,50.0%,4m
14978,3,Zorthd,2701,0,2,3,5,40.0%,1h
14978,3,[教我玩神族]Aphrodiet,2701,0,1,0,1,100.0%,1h
14978,1,西湖溅狼,2701,0,1,1,2,50.0%,32m
14978,1,[Zenith]暮光,2701,0,1,1,2,50.0%,1h
14978,3,[潸然丶那些年]Carry,2701,0,1,2,3,33.3%,1h
14978,3,llllllllllll,2701,30,1,5,6,16.7%,23m
14978,1,IIIIIIIII,2701,0,0,3,3,0.0%,31m
14995,1,[破灭]凝水之心,2700,1441,145,151,296,49.0%,7m
14995,1,[艾薇儿]LTaeja,2700,1565,122,114,236,51.7%,20m
14995,1,juruoKkvoid,2700,526,35,19,54,64.8%,37m
14995,1,[啊这阿巴]笨八八寄生体,2700,917,34,26,60,56.7%,3m
14995,1,Dumm,2700,466,16,11,27,59.3%,4m
14995,1,天有点黑,2700,402,13,10,23,56.5%,1h
14995,3,[樱火之森]梦违,2700,284,11,11,22,50.0%,20m
14995,1,YesnO,2700,343,10,8,18,55.6%,4m
14995,2,Codeplayer,2700,205,7,6,13,53.8%,17m
14995,1,Demons,2700,218,6,9,15,40.0%,1h
14995,2,来个老婆不要饼,2700,90,5,5,10,50.0%,30m
14995,3,姜还是老的辣,2700,97,5,9,14,35.7%,27m
14995,3,Icy,2700,142,5,13,18,27.8%,26m
14995,1,[社交学巨可爱]天使的心跳,2700,74,3,2,5,60.0%,22m
14995,1,眼泪,2700,70,3,2,5,60.0%,29m
14995,1,[我队伍很强大]feilong,2700,72,3,2,5,60.0%,57m
14995,1,雕喇玛,2700,66,3,2,5,60.0%,1h
14995,1,[EL骑士二团]IIIIIIIIII,2700,72,3,4,7,42.9%,1h
14995,1,德克萨斯做的到吗,2700,72,3,4,7,42.9%,1h
14995,3,狗狗,2700,0,2,3,5,40.0%,1h
14995,3,RobotN,2700,0,2,3,5,40.0%,6m
14995,3,dfgdgd,2700,0,0,1,1,0.0%,1h
14995,1,[阿巴瑟军团]asd,2700,0,0,1,1,0.0%,1h
14995,1,[称霸幼儿园]崛起的新手,2700,0,0,1,1,0.0%,1h
15019,3,Manifesto,2699,885,125,117,242,51.7%,13m
15019,3,[EMA]Reiuy,2699,1023,74,61,135,54.8%,23m
15019,3,[五年目放課後]Tian,2699,530,41,34,75,54.7%,17m
15019,1,[超会玩]我爱果果,2699,991,39,33,72,54.2%,53m
15019,3,zzy,2699,452,25,23,48,52.1%,28m
15019,1,菁菁鲸,2699,459,16,10,26,61.5%,57m
15019,1,shane,2699,477,16,13,29,55.2%,3m
15019,3,级觉得,2699,283,10,7,17,58.8%,19m
15019,3,圣母,2699,217,7,7,14,50.0%,47m
15019,1,我得吃药了,2699,190,7,9,16,43.8%,14m
15019,1,纯情小萌新,2699,206,6,6,12,50.0%,44m
15019,2,NMSL,2699,114,4,5,9,44.4%,1h
15019,1,好久没吃到肉了,2699,0,3,5,8,37.5%,41m
15019,1,大水坨,2699,41,2,0,2,100.0%,1h
15019,3,[社交学导练]我永远爱时崎狂三,2699,0,2,2,4,50.0%,12m
15019,3,我已不是小学生,2699,0,2,3,5,40.0%,1h
15019,1,雾雨,2699,0,1,0,1,100.0%,22m
15019,1,朱老板,2699,0,1,0,1,100.0%,1h
15019,1,叼奶嘴的锅包肉,2699,0,1,1,2,50.0%,14m
15019,1,[吕布保护集团]一拳超人,2699,30,1,1,2,50.0%,1h
15019,1,czc,2699,0,1,1,2,50.0%,1h
15019,1,风城烟雨,2699,40,1,2,3,33.3%,1h
15019,3,流芳,2699,0,1,3,4,25.0%,42m
15019,1,[有趣]MelonPan,2699,0,0,1,1,0.0%,5m
15019,1,Blushingxy,2699,0,0,1,1,0.0%,14m
15019,3,星际无需视力,2699,0,0,1,1,0.0%,12m
15045,1,[KPG2]黄色小飞机,2698,1595,88,78,166,53.0%,55m
15045,1,[TeamGB]狂野之狼,2698,1012,35,39,74,47.3%,1h
15045,1,IIIIIIIIIIII,2698,772,31,27,58,53.4%,1h
15045,1,[死亡收割]youngandbeau,2698,550,25,11,36,69.4%,47m
15045,3,术高莫用,2698,520,22,20,42,52.4%,15m
15045,1,WJF,2698,431,17,8,25,68.0%,22m
15045,1,ssdb,2698,318,13,15,28,46.4%,1h
15045,3,NewPlayer,2698,99,12,14,26,46.2%,18m
15045,3,红茶不能洒,2698,227,9,11,20,45.0%,19m
15045,1,Snake,2698,232,7,9,16,43.8%,1h
15045,1,IIIIIIIIIIII,2698,162,5,1,6,83.3%,38m
15045,1,auir,2698,144,4,5,9,44.4%,20m
15045,3,胆大如斗黄旭东,2698,116,3,1,4,75.0%,1h
15045,3,肢解怪人,2698,97,3,3,6,50.0%,22m
15045,3,[北有吾王]lllllllllll,2698,92,3,7,10,30.0%,47m
15045,3,Morphlne,2698,0,2,3,5,40.0%,1h
15045,3,重力加速度,2698,0,2,3,5,40.0%,1h
15045,2,[so]观察者,2698,0,1,0,1,100.0%,1h
15045,1,[七咕咕]fire,2698,0,1,0,1,100.0%,1h
15045,1,Marin,2698,0,1,0,1,100.0%,32m
15045,1,[黎明航向]夕月,2698,0,0,1,1,0.0%,20m
15045,1,llllllllllll,2698,0,0,2,2,0.0%,45m
15045,2,[达拉姆内务部]逸康来了,2698,0,0,2,2,0.0%,12m
15068,1,[GAC]甩枪仔,2697,1528,239,243,482,49.6%,5m
15068,3,[人人有功炼]tiantian,2697,782,88,87,175,50.3%,7m
15068,1,暗毅丶然,2697,797,75,55,130,57.7%,20m
15068,1,NewRookie,2697,920,73,78,151,48.3%,45m
15068,2,lwl,2697,1530,68,75,143,47.6%,10m
15068,1,Cincelia,2697,700,43,29,72,59.7%,1h
15068,1,与门,2697,1041,42,34,76,55.3%,1h
15068,1,[镜花水月丶]不会玩怎么办,2697,784,33,25,58,56.9%,11m
15068,1,[拉拉德马西亚]夏日亲枫,2697,636,32,26,58,55.2%,1h
15068,2,MagicTerran,2697,458,19,23,42,45.2%,23m
15068,3,[要啥没啥爱咋]斯大林格勒,2697,479,18,17,35,51.4%,19m
15068,1,芊芊每天都要,2697,265,12,2,14,85.7%,47m
15068,3,起名字真麻烦,2697,261,11,8,19,57.9%,19m
15068,3,祈求者,2697,189,8,9,17,47.1%,1h
15068,1,再菜也爱玩,2697,253,7,4,11,63.6%,11m
15068,1,COldzera,2697,209,6,3,9,66.7%,34m
15068,2,[樱丘]神利苏,2697,150,6,5,11,54.5%,26m
15068,2,SansFans,2697,152,6,5,11,54.5%,15m
15068,1,青雪九翊,2697,142,5,4,9,55.6%,43m
15068,1,Dalxnn,2697,142,5,7,12,41.7%,11m
15068,1,苍穹漫步,2697,148,4,4,8,50.0%,6m
15068,1,[HUC轩辕]四年级森下下士,2697,135,3,1,4,75.0%,45m
15068,3,[云和山的彼端]横艾丶,2697,0,2,3,5,40.0%,1h
15068,2,[sc日记]Lucifinil,2697,94,2,3,5,40.0%,1h
15068,2,[一股清流]nnnnnnnp,2697,60,2,12,14,14.3%,46m
15068,1,准风月谈,2697,46,1,3,4,25.0%,1h
15068,2,[冠世一战]hanaihui,2697,0,0,1,1,0.0%,1h
15068,2,SCV,2697,0,0,2,2,0.0%,1h
15096,1,诡笑面具,2696,515,28,11,39,71.8%,57m
15096,1,[TGone]SunNight,2696,771,27,40,67,40.3%,12m
15096,3,星际霸爸,2696,297,16,9,25,64.0%,11m
15096,3,risk,2696,131,12,10,22,54.5%,9m
15096,1,VoCyt,2696,274,9,9,18,50.0%,1h
15096,3,ango,2696,288,9,15,24,37.5%,26m
15096,1,cmh,2696,141,4,0,4,100.0%,1h
15096,3,泰伦之光,2696,86,4,7,11,36.4%,23m
15096,1,公关广告,2696,72,3,1,4,75.0%,37m
15096,3,西尾维新,2696,0,2,3,5,40.0%,38m
15096,3,hugo,2696,0,2,3,5,40.0%,10m
15096,1,牙膏,2696,142,2,9,11,18.2%,1h
15096,1,[艾尔光复分队]DVV,2696,0,1,0,1,100.0%,52m
15096,1,极限生存,2696,42,1,3,4,25.0%,1h
15096,3,无望,2696,0,0,1,1,0.0%,1h
15096,1,玛格吉贾德诺,2696,0,0,1,1,0.0%,1h
15096,3,拂晓与萤火虫,2696,0,0,1,1,0.0%,19m
15113,1,我菜故我在,2695,1511,105,87,192,54.7%,1h
15113,1,[冲就完了]只玩无敌的鸡谐化,2695,989,79,76,155,51.0%,14m
15113,1,小莫满满,2695,653,27,41,68,39.7%,13m
15113,2,三林小学飞飞哥哥,2695,132,23,24,47,48.9%,46m
15113,3,影者,2695,349,17,18,35,48.6%,19m
15113,1,Landgrave,2695,389,15,13,28,53.6%,6m
15113,3,本是荒客,2695,322,13,16,29,44.8%,22m
15113,3,虚荣,2695,206,7,12,19,36.8%,6m
15113,1,[CPT]哔哩丶程八一,2695,184,6,2,8,75.0%,43m
15113,3,chang,2695,178,6,13,19,31.6%,28m
15113,2,惠惠啊喵啊喵,2695,0,4,3,7,57.1%,30m
15113,2,大地飞歌,2695,46,4,4,8,50.0%,1h
15113,1,[教廷丶]GDK,2695,123,3,1,4,75.0%,1h
15113,1,烟凡,2695,0,3,5,8,37.5%,1h
15113,1,哥的风骚你不懂,2695,42,2,3,5,40.0%,1h
15113,3,满心欢喜,2695,0,2,3,5,40.0%,22m
15113,1,IGXY,2695,0,1,0,1,100.0%,4m
15113,1,[银河舰队]wzrlawyer,2695,42,1,3,4,25.0%,44m
15113,3,你能把到我吗,2695,0,1,4,5,20.0%,6m
15113,3,战丶狼,2695,30,1,7,8,12.5%,49m
15113,1,菜鸡,2695,0,0,1,1,0.0%,22m
15113,1,shower,2695,0,0,1,1,0.0%,37m
15135,1,amaZingCaT,2694,1555,445,448,893,49.8%,52m
15135,3,[000101]ikaros,2694,1515,191,197,388,49.2%,22m
15135,2,Xavier,2694,723,179,176,355,50.4%,47m
15135,1,Jimmy,2694,1496,165,167,332,49.7%,13m
15135,1,痴心范,2694,483,24,13,37,64.9%,22m
15135,3,撒米,2694,281,14,15,29,48.3%,7m
15135,1,[SJTU]亂舞春秋,2694,377,13,16,29,44.8%,1h
15135,2,IIIIIIIIIIII,2694,288,12,11,23,52.2%,16m
15135,1,阿萝兰,2694,138,10,9,19,52.6%,22m
15135,3,丿翻山越岭丶,2694,319,10,13,23,43.5%,28m
15135,1,北白川馅子,2694,218,7,6,13,53.8%,53m
15135,1,[TPLINK]Clearlove,2694,130,3,1,4,75.0%,31m
15135,1,lkooopop,2694,154,3,2,5,60.0%,33m
15135,1,[我们是无敌的]difei,2694,106,3,4,7,42.9%,45m
15135,2,[哔咔快乐绅士]幵框本,2694,0,3,4,7,42.9%,1h
15135,3,Dzq,2694,0,2,3,5,40.0%,22m
15135,3,只看侧面,2694,0,1,0,1,100.0%,1h
15135,1,Chase,2694,40,1,2,3,33.3%,19m
15135,1,Poseidon,2694,0,0,1,1,0.0%,1h
15135,1,天使姐夫来啦,2694,0,0,1,1,0.0%,3m
15155,1,麦田守望芊,2693,935,51,46,97,52.6%,32m
15155,2,lIlIlIlIlIlI,2693,951,49,44,93,52.7%,6m
15155,1,路过,2693,778,28,24,52,53.8%,47m
15155,1,[大宇恩]Eucliwood,2693,540,21,13,34,61.8%,53m
15155,2,[北境]最逗的星,2693,438,18,25,43,41.9%,30m
15155,1,高歌此方,2693,259,12,13,25,48.0%,29m
15155,3,[MOMIMO]昆虫,2693,229,9,15,24,37.5%,19m
15155,2,Xsir,2693,151,7,7,14,50.0%,1h
15155,1,eridanus,2693,210,6,9,15,40.0%,43m
15155,1,[XXHZ21]旭东之考验,2693,173,5,2,7,71.4%,1h
15155,1,[飞天面神]我永远喜欢圆圆,2693,138,5,6,11,45.5%,22m
15155,3,一个人挺好,2693,0,4,1,5,80.0%,1h
15155,1,ByuN,2693,74,2,4,6,33.3%,1h
15155,3,SKTTFaker,2693,119,2,5,7,28.6%,28m
15155,1,FlagBroker,2693,0,1,0,1,100.0%,29m
15155,2,六月梅有雨,2693,0,1,1,2,50.0%,1h
15155,1,[miku守护]画中游,2693,0,0,3,3,0.0%,57m
15172,1,阿克塞尔,2692,1221,55,41,96,57.3%,11m
15172,1,[notdie]丶顽强的花岗岩丶,2692,1040,44,38,82,53.7%,34m
15172,1,无缘,2692,396,23,19,42,54.8%,34m
15172,1,Kurumi,2692,643,23,20,43,53.5%,34m
15172,1,会长,2692,678,22,40,62,35.5%,15m
15172,1,画风,2692,482,18,20,38,47.4%,4m
15172,2,陨落星辰,2692,366,16,19,35,45.7%,46m
15172,3,AnYi,2692,253,11,11,22,50.0%,1h
15172,1,Graendal,2692,318,10,11,21,47.6%,1h
15172,3,咕咕咕,2692,232,8,5,13,61.5%,19m
15172,2,Destiny,2692,90,4,4,8,50.0%,1h
15172,3,[干翻机械化]霸王,2692,0,2,3,5,40.0%,1h
15172,1,[永恒中华]AAA,2692,0,1,0,1,100.0%,1h
15172,1,凛樱初开,2692,95,1,1,2,50.0%,1h
15172,1,[魔王的人生]路过浪客,2692,48,1,5,6,16.7%,6m
15172,1,安东,2692,0,0,1,1,0.0%,45m
15172,3,[镜花水月丨]fengfeng,2692,0,0,1,1,0.0%,41m
15172,3,Pia,2692,0,0,1,1,0.0%,1h
15190,1,[理之律者]霜之结晶天然呆,2691,1447,57,49,106,53.8%,20m
15190,1,wywk,2691,392,31,41,72,43.1%,44m
15190,3,嘿嘿优秀,2691,686,28,25,53,52.8%,27m
15190,1,凶狠跑刀仔,2691,276,9,11,20,45.0%,16m
15190,2,[Vgirls]hjkg,2691,188,6,6,12,50.0%,46m
15190,1,[SCFFFF]zez,2691,161,4,2,6,66.7%,1h
15190,1,[Hawks]booyaUNO,2691,163,3,3,6,50.0%,49m
15190,2,joker,2691,0,3,4,7,42.9%,37m
15190,1,ACCG,2691,0,1,0,1,100.0%,11m
15190,3,XIN,2691,0,1,0,1,100.0%,17m
15190,1,[北京大学鸡协]Helium,2691,0,1,0,1,100.0%,33m
15190,1,[柠檬保护协会]斗鱼狼轩,2691,0,1,0,1,100.0%,22m
15190,1,我只想你开心,2691,0,0,1,1,0.0%,45m
15190,1,[燕大SC]Dirty,2691,0,0,1,1,0.0%,1h
15204,3,[DukeA]Stork,2690,1190,315,341,656,48.0%,29m
15204,2,[火焰雷兽]ted,2690,1506,82,82,164,50.0%,13m
15204,2,[我是鸡别A我]OoO,2690,516,18,22,40,45.0%,28m
15204,2,谐星要塞,2690,413,17,20,37,45.9%,30m
15204,3,彬彬,2690,326,13,10,23,56.5%,50m
15204,2,[别看了就你了]皮在痒,2690,215,7,7,14,50.0%,46m
15204,1,[我们是瞎子]远程小能手,2690,209,6,4,10,60.0%,37m
15204,3,白色獠牙,2690,169,5,6,11,45.5%,8m
15204,1,[战争武器]sky,2690,148,4,5,9,44.4%,19m
15204,1,Bitxxxxxxch,2690,164,4,7,11,36.4%,1h
15204,1,[HUC霸者]Intelligence,2690,107,3,0,3,100.0%,37m
15204,1,吐布狗,2690,38,2,1,3,66.7%,1h
15204,2,Akihi,2690,46,2,1,3,66.7%,1h
15204,3,[黑色丶雇佣兵]留守儿童,2690,0,2,3,5,40.0%,49m
15204,1,越锋,2690,32,1,1,2,50.0%,29m
15204,2,老司机,2690,93,1,1,2,50.0%,56m
15204,3,fengxingzhe,2690,0,0,1,1,0.0%,1h
15204,2,lxq,2690,0,0,2,2,0.0%,15m
15204,3,箫声桀,2690,0,0,2,2,0.0%,13m
15204,2,[独留清风醉]欢喜赴空山,2690,0,0,2,2,0.0%,23m
15224,1,曲奇曲奇,2689,1694,296,289,585,50.6%,1h
15224,1,肛正不畸,2689,1565,101,79,180,56.1%,1h
15224,1,[两道菜]稳稳稳,2689,1480,77,74,151,51.0%,1h
15224,1,[秋毫]香饽饽,2689,611,51,47,98,52.0%,43m
15224,3,[鲲之大]Dan,2689,694,25,29,54,46.3%,11m
15224,1,姚姚姚姚姚狗阿,2689,351,16,6,22,72.7%,34m
15224,1,IIIIIIIOOOOO,2689,444,15,13,28,53.6%,1h
15224,1,蒹葭,2689,468,14,12,26,53.8%,4m
15224,1,jason,2689,205,13,6,19,68.4%,29m
15224,3,[快乐谐星go]条码人,2689,286,11,2,13,84.6%,43m
15224,3,[123432]鬼车,2689,314,11,17,28,39.3%,18m
15224,1,[OB丶]雾尹,2689,280,7,6,13,53.8%,7m
15224,1,haha,2689,176,5,5,10,50.0%,1h
15224,3,cts,2689,0,4,1,5,80.0%,1h
15224,1,猪小帆,2689,156,4,3,7,57.1%,45m
15224,3,gggg,2689,134,4,5,9,44.4%,49m
15224,2,樱夜,2689,137,4,5,9,44.4%,1h
15224,3,SLI,2689,167,4,6,10,40.0%,18m
15224,1,卡了就行了,2689,82,2,4,6,33.3%,1h
15224,1,[秋毫]Erwin,2689,0,1,0,1,100.0%,47m
15224,1,Spike,2689,0,0,1,1,0.0%,22m
15224,1,呆呆的虫子,2689,0,0,3,3,0.0%,22m
15246,2,牛大头,2688,876,173,172,345,50.1%,46m
15246,1,EnTaroZertul,2688,876,38,27,65,58.5%,47m
15246,1,[半个菜鸟II]黑天大神,2688,446,20,11,31,64.5%,1h
15246,1,陈曦,2688,519,20,14,34,58.8%,1h
15246,1,[鲁德欢]不会玩虫族,2688,387,16,8,24,66.7%,43m
15246,1,呵呵,2688,230,7,4,11,63.6%,33m
15246,2,younger,2688,148,7,6,13,53.8%,1h
15246,1,帝国舰队,2688,205,6,2,8,75.0%,59m
15246,3,[星际合作群]龙语者,2688,149,3,6,9,33.3%,1h
15246,3,[莫妮卡]Monika,2688,90,3,8,11,27.3%,27m
15246,1,SkyGemini,2688,107,2,1,3,66.7%,29m
15246,1,ffg,2688,123,2,2,4,50.0%,1h
15246,3,Nosigh,2688,0,2,3,5,40.0%,1h
15246,3,无名哥,2688,0,2,3,5,40.0%,27m
15246,3,冰洁时刻,2688,62,2,7,9,22.2%,29m
15246,1,[野生无公害]SacYNa,2688,0,1,0,1,100.0%,19m
15246,2,人间不值得,2688,0,1,0,1,100.0%,1h
15246,1,[浪啊浪]CQBB,2688,0,1,1,2,50.0%,19m
15246,1,[社交学教导]一辈子挚爱,2688,36,1,1,2,50.0%,33m
15246,1,为我尊前笑不成,2688,36,1,2,3,33.3%,37m
15246,3,占地极限,2688,0,1,3,4,25.0%,49m
15246,1,放的好机会,2688,0,0,1,1,0.0%,18m
15246,3,胜利之光,2688,0,0,2,2,0.0%,1h
15246,1,TIMER,2688,0,0,2,2,0.0%,16m
15246,1,我就叫星际争霸,2688,0,0,2,2,0.0%,36m
15271,1,夜星辰,2687,1702,78,76,154,50.6%,16m
15271,2,zaa,2687,1488,76,69,145,52.4%,12m
15271,3,[中华何平]EASY,2687,1568,75,70,145,51.7%,5m
15271,2,生生,2687,917,33,40,73,45.2%,10m
15271,1,嫣嫣,2687,508,24,19,43,55.8%,1h
15271,1,无随缘黑,2687,212,8,7,15,53.3%,1h
15271,1,[滑稽联盟]Puerum,2687,148,7,6,13,53.8%,22m
15271,2,[名非]DADADA,2687,162,5,5,10,50.0%,1h
15271,3,RedJoker,2687,38,3,4,7,42.9%,1h
15271,3,[吃原味麻酱]史诗之蛙,2687,118,2,1,3,66.7%,1h
15271,3,[洛杉矶]屋檐就该挡月光,2687,0,2,3,5,40.0%,1h
15271,3,[谐星联邦]lIIyasviel,2687,0,2,3,5,40.0%,1h
15271,1,rakim,2687,0,1,0,1,100.0%,20m
15271,1,[同济大学]龙卷风摧毁停车场,2687,0,1,0,1,100.0%,34m
15271,2,虹滨,2687,0,1,1,2,50.0%,1h
15271,3,[净土]爱萌,2687,95,1,1,2,50.0%,48m
15271,1,王万魔,2687,36,1,3,4,25.0%,23m
15271,1,NWRattack,2687,0,0,1,1,0.0%,44m
15289,1,网上打老虎哟,2686,854,70,76,146,47.9%,29m
15289,1,ToDDD,2686,1558,65,72,137,47.4%,44m
15289,3,IMBganggang,2686,1172,62,58,120,51.7%,18m
15289,1,[GD地狱伞兵]郭敬明卡兵被踩死,2686,756,33,26,59,55.9%,47m
15289,1,鹿乃,2686,354,25,11,36,69.4%,29m
15289,1,[小仙女上线啦]TUWOKM,2686,575,23,16,39,59.0%,1h
15289,3,GhostKing,2686,607,23,24,47,48.9%,23m
15289,1,FACKERJOJO,2686,298,10,6,16,62.5%,1h
15289,3,youmentor,2686,192,8,9,17,47.1%,26m
15289,1,蓝巴猫,2686,180,7,4,11,63.6%,1h
15289,1,[整合]天下最萌小静怡,2686,152,6,1,7,85.7%,29m
15289,1,镜花水月,2686,184,6,7,13,46.2%,20m
15289,1,我爱喝旺仔牛奶,2686,204,6,7,13,46.2%,22m
15289,3,Recort,2686,0,4,2,6,66.7%,41m
15289,1,[逍遙自在]白白胖胖,2686,162,3,2,5,60.0%,18m
15289,1,[虚空舰队]羊宝宝,2686,38,2,2,4,50.0%,23m
15289,1,shadowkiller,2686,117,2,3,5,40.0%,32m
15289,1,[仕兰]Gungnir,2686,0,1,1,2,50.0%,20m
15289,1,头号盲人,2686,0,1,1,2,50.0%,32m
15289,1,[小仙女上线啦]二五仔,2686,38,1,3,4,25.0%,7m
15289,2,蛏子影胤,2686,0,0,1,1,0.0%,30m
15310,3,victor,2685,1195,107,106,213,50.2%,47m
15310,1,JJQQ,2685,1361,57,44,101,56.4%,1h
15310,1,IIIIIIII,2685,1139,50,39,89,56.2%,1h
15310,1,矿区风大听不清,2685,806,41,25,66,62.1%,45m
15310,3,[HP]MrRICKY,2685,458,21,30,51,41.2%,27m
15310,2,IlllIIlllIII,2685,608,20,34,54,37.0%,4m
15310,1,奔雷手,2685,286,10,9,19,52.6%,55m
15310,3,[混元体我女仆]我问问而得到,2685,180,9,8,17,52.9%,22m
15310,1,Stay,2685,167,6,7,13,46.2%,1h
15310,3,WALLE,2685,169,6,10,16,37.5%,47m
15310,2,Betrayer,2685,44,5,4,9,55.6%,59m
15310,2,[为了地狱咆哮]法魄,2685,132,5,5,10,50.0%,1h
15310,1,[大主教的兄弟]Laowhite,2685,112,3,0,3,100.0%,33m
15310,1,Lyuan,2685,70,3,2,5,60.0%,43m
15310,1,Forbormer,2685,82,3,4,7,42.9%,29m
15310,3,相汝仆园,2685,129,2,2,4,50.0%,1h
15310,3,[时光与酒oc]覆面,2685,0,1,0,1,100.0%,41m
15310,2,oooo,2685,0,0,2,2,0.0%,1h
15328,2,DID,2684,1505,172,153,325,52.9%,6m
15328,3,Too,2684,1124,47,46,93,50.5%,23m
15328,3,jingjing,2684,1126,45,45,90,50.0%,28m
15328,1,wishstudio,2684,986,37,38,75,49.3%,34m
15328,3,[社交学超可爱]lwuxiel,2684,756,26,33,59,44.1%,16m
15328,3,[菜的没人带]大佬带带我啊,2684,556,17,41,58,29.3%,3m
15328,1,我要成为那啥,2684,339,15,14,29,51.7%,47m
15328,1,[地刺速埋协会]这就是地刺么,2684,311,12,16,28,42.9%,37m
15328,1,KEE,2684,160,6,2,8,75.0%,1h
15328,1,再造乾坤,2684,38,2,3,5,40.0%,1h
15328,3,小爷我不认怂,2684,0,2,3,5,40.0%,4m
15328,1,[神羽]秋神紫羽,2684,74,2,20,22,9.1%,8m
15328,1,天天向上,2684,0,1,0,1,100.0%,19m
15328,1,[小鸡屠宰场b]BOYKA,2684,91,1,1,2,50.0%,14m
15328,1,天杀的,2684,0,0,1,1,0.0%,1h
15328,1,[喵喵]千山独行路曼曼,2684,0,0,1,1,0.0%,1h
15328,1,[一等星]小猪佩奇,2684,0,0,1,1,0.0%,47m
15328,1,霸霸,2684,0,0,1,1,0.0%,47m
15328,1,[宜宾兄弟伙]赫莫克利特斯,2684,0,0,1,1,0.0%,1h
15328,1,zxhyq,2684,0,0,1,1,0.0%,43m
15328,2,年轻人,2684,0,0,3,3,0.0%,58m
15349,3,SAOBTerran,2683,1413,59,55,114,51.8%,49m
15349,1,ccloudy,2683,730,28,27,55,50.9%,52m
15349,3,[一杆枪定天下]战争与天下,2683,650,28,31,59,47.5%,23m
15349,3,打神族太难了,2683,690,27,24,51,52.9%,29m
15349,3,[火焰雷兽]你还活在过去吗,2683,556,20,27,47,42.6%,23m
15349,3,IIIIIIIIIIII,2683,461,19,16,35,54.3%,8m
15349,1,小曦,2683,477,15,13,28,53.6%,47m
15349,1,[专业收尸队]TFTPONE,2683,413,14,10,24,58.3%,39m
15349,1,龙浩,2683,322,11,4,15,73.3%,1h
15349,1,peng,2683,372,10,10,20,50.0%,53m
15349,1,[nlio]Hibiki,2683,218,8,3,11,72.7%,19m
15349,3,SSS,2683,210,8,12,20,40.0%,29m
15349,3,特蕾西雅殿下,2683,121,4,3,7,57.1%,1h
15349,1,我和皇子都有巨龙,2683,106,3,0,3,100.0%,29m
15349,2,灯火听雨眠,2683,95,3,5,8,37.5%,1h
15349,2,雨夜怪客,2683,46,3,6,9,33.3%,1h
15349,2,Shine,2683,0,3,6,9,33.3%,5m
15349,3,芒果核,2683,0,2,3,5,40.0%,1h
15349,3,本名傲天,2683,0,2,3,5,40.0%,41m
15349,3,superff,2683,0,1,1,2,50.0%,5m
15349,1,天仙配,2683,34,1,3,4,25.0%,34m
15349,1,小盖比,2683,30,1,3,4,25.0%,34m
15371,3,FRtian,2682,1409,172,168,340,50.6%,25m
15371,2,[谐91]GTO,2682,1049,132,134,266,49.6%,9m
15371,3,[长夜将至]QianYi,2682,1073,100,92,192,52.1%,27m
15371,3,[冲就完了]天涯明月刀,2682,1538,67,54,121,55.4%,8m
15371,3,joker,2682,1505,59,62,121,48.8%,28m
15371,3,AlsoLove,2682,562,56,34,90,62.2%,14m
15371,2,[miku守护]打到铥,2682,964,47,53,100,47.0%,7m
15371,2,不上宗不改名,2682,648,32,26,58,55.2%,8m
15371,1,天使落凡尘,2682,758,30,28,58,51.7%,1h
15371,1,破两票,2682,534,21,14,35,60.0%,47m
15371,1,死亡只是个开始,2682,337,11,7,18,61.1%,14m
15371,3,[晚上吃基]星际玩家都是瞎子,2682,302,11,18,29,37.9%,7m
15371,3,[实力与骚并在]nly,2682,230,9,7,16,56.2%,23m
15371,1,Jason,2682,142,5,5,10,50.0%,57m
15371,1,haha,2682,148,4,2,6,66.7%,23m
15371,2,dgy,2682,94,4,3,7,57.1%,37m
15371,2,[东方灵车]倪丶裳,2682,152,4,8,12,33.3%,55m
15371,1,天光,2682,76,3,5,8,37.5%,1h
15371,1,Naizker,2682,188,3,5,8,37.5%,1h
15371,1,[盖世双谐]clown,2682,89,2,0,2,100.0%,55m
15371,3,晃悠的芦花鸡,2682,0,2,3,5,40.0%,5m
15371,1,[KGIC]三日月夜空,2682,0,1,0,1,100.0%,1h
15371,1,天堂的恶魔,2682,88,1,1,2,50.0%,37m
15371,1,碎龙吟,2682,0,1,1,2,50.0%,4m
15371,2,[一块晶体矿]猎妈者,2682,94,1,2,3,33.3%,1h
15371,1,[WEjsnj]樱花玉子,2682,0,0,1,1,0.0%,20m
15371,3,ghost,2682,0,0,1,1,0.0%,1h
15398,3,[鸡饲料加工厂]滥青年,2681,1156,71,68,139,51.1%,7m
15398,3,Comgmyzi,2681,1166,70,62,132,53.0%,4m
15398,3,四五是块钢板,2681,761,58,49,107,54.2%,15m
15398,1,Deft,2681,825,32,28,60,53.3%,29m
15398,3,啦啦啦啦,2681,310,12,15,27,44.4%,8m
15398,1,陈不笑君莫笑,2681,350,11,8,19,57.9%,38m
15398,1,我不想好好玩游戏,2681,206,6,4,10,60.0%,1h
15398,1,[氵艾泽拉斯]adadsdada,2681,188,5,2,7,71.4%,1h
15398,1,[帅贯穿一身]那天晚上的风,2681,103,3,0,3,100.0%,57m
15398,1,简单电脑,2681,76,3,4,7,42.9%,20m
15398,1,[XXHZ10]死亡如风,2681,116,3,4,7,42.9%,16m
15398,3,团子大家族,2681,0,2,2,4,50.0%,1h
15398,3,永丰余,2681,0,2,3,5,40.0%,38m
15398,3,[BTBU]qyh,2681,30,2,7,9,22.2%,8m
15398,3,IIIIIIIIIIII,2681,30,2,8,10,20.0%,14m
15398,1,[TAPC]Nain,2681,0,1,0,1,100.0%,52m
15398,3,ZYD,2681,0,1,2,3,33.3%,38m
15398,3,老瞎眼,2681,0,1,3,4,25.0%,38m
15398,2,噩梦幽魂曲,2681,0,0,1,1,0.0%,1h
15398,1,为爱尔而生,2681,0,0,2,2,0.0%,20m
15398,1,GHOSTKILL,2681,0,0,2,2,0.0%,1h
15398,1,Mark,2681,0,0,3,3,0.0%,39m
15398,1,[星辰舞雪]神小心,2681,0,0,3,3,0.0%,43m
15421,3,Oscar,2680,1566,703,692,1395,50.4%,7m
15421,2,MatriKeanEuX,2680,1512,99,94,193,51.3%,19m
15421,1,morphling,2680,855,46,37,83,55.4%,39m
15421,3,星尘择宇,2680,907,41,35,76,53.9%,23m
15421,3,果师,2680,679,26,27,53,49.1%,27m
15421,3,星空凛,2680,116,19,22,41,46.3%,23m
15421,1,[小鸡屠宰场3]大嫖,2680,530,18,17,35,51.4%,19m
15421,1,[快乐白给]慕斯,2680,267,11,10,21,52.4%,1h
15421,3,恨繁霜鬓,2680,273,9,11,20,45.0%,16m
15421,1,zhaoweilll,2680,244,8,8,16,50.0%,1h
15421,1,黄昏,2680,274,8,11,19,42.1%,1h
15421,3,wwxx,2680,171,5,4,9,55.6%,49m
15421,1,[艾尔我唆了蒜]二良狗影,2680,171,4,3,7,57.1%,1h
15421,2,长行,2680,0,4,3,7,57.1%,26m
15421,3,[为未来奋斗]WAR,2680,0,2,3,5,40.0%,1h
15421,2,tianling,2680,44,2,3,5,40.0%,1h
15421,3,雪影风霜,2680,0,2,3,5,40.0%,13m
15421,1,盟重,2680,0,1,0,1,100.0%,19m
15421,1,TBwalker,2680,0,1,1,2,50.0%,1h
15421,1,[暴雪九队]bloodfe,2680,40,1,3,4,25.0%,11m
15421,3,此地乃是白门楼,2680,0,0,1,1,0.0%,1h
15421,1,[嘤嘤樱]望风拂竹,2680,0,0,2,2,0.0%,20m
15421,1,[风云天下]百晓生,2680,0,0,2,2,0.0%,22m
15444,1,[gusl]fugitive,2679,1684,91,89,180,50.6%,1h
15444,1,[背刺中队]幼苗的幼苗,2679,690,22,21,43,51.2%,3m
15444,3,Gabkin,2679,584,20,22,42,47.6%,28m
15444,3,cjming,2679,482,18,22,40,45.0%,18m
15444,3,请不要欺负小萌新,2679,358,13,10,23,56.5%,1h
15444,3,咖喱,2679,224,11,6,17,64.7%,26m
15444,1,殴鸡酱,2679,218,11,10,21,52.4%,38m
15444,1,我今天不高考,2679,234,8,7,15,53.3%,1h
15444,1,[丨SLT丨]老干妈拌伏特加,2679,216,7,6,13,53.8%,45m
15444,1,[闪电]名字好难取龘,2679,108,3,0,3,100.0%,33m
15444,3,一花一世界,2679,0,3,3,6,50.0%,1h
15444,2,药水哥,2679,0,3,5,8,37.5%,3m
15444,1,丁哥,2679,0,3,5,8,37.5%,1h
15444,2,jimv,2679,115,3,6,9,33.3%,1h
15444,3,[浴火银河]prettyoung,2679,0,2,3,5,40.0%,1h
15444,1,崔智云,2679,0,1,0,1,100.0%,4m
15444,1,[首义学院]我还需要一个探姬,2679,0,1,0,1,100.0%,1h
15444,2,iFBxxx,2679,0,1,0,1,100.0%,15m
15462,1,[人菜灬瘾大]风起云散,2678,1596,68,58,126,54.0%,55m
15462,1,DLFJKALI,2678,1211,51,42,93,54.8%,19m
15462,2,[和风]Wtasqr,2678,823,41,51,92,44.6%,46m
15462,3,[群星永不消亡]白衣渡江,2678,506,33,31,64,51.6%,29m
15462,1,llllllllll,2678,512,22,15,37,59.5%,1h
15462,3,这不是有手就行,2678,531,21,21,42,50.0%,22m
15462,3,这是中文,2678,228,9,11,20,45.0%,4m
15462,2,TNTB,2678,272,9,20,29,31.0%,3m
15462,1,从小很狂,2678,210,7,7,14,50.0%,1h
15462,1,osjo,2678,153,6,2,8,75.0%,1h
15462,1,Chost,2678,198,6,3,9,66.7%,19m
15462,3,WorldMaster,2678,133,5,3,8,62.5%,13m
15462,1,[童话小镇]没兴奋剂的枪兵,2678,185,5,5,10,50.0%,11m
15462,3,死神之佐佑,2678,0,4,2,6,66.7%,10m
15462,1,leoyin,2678,102,4,3,7,57.1%,33m
15462,1,Naive,2678,114,4,6,10,40.0%,37m
15462,3,[老板大气嗷]FEFENGGAOGGI,2678,0,3,1,4,75.0%,18m
15462,1,Optimistic,2678,120,3,2,5,60.0%,11m
15462,2,小崔,2678,0,3,4,7,42.9%,25m
15462,1,不要以为你赢了,2678,90,2,0,2,100.0%,22m
15462,3,荣耀归于长子,2678,0,2,3,5,40.0%,49m
15462,1,卖女孩的小火柴,2678,0,1,0,1,100.0%,36m
15462,1,[酶丽芙]QingTang,2678,0,1,0,1,100.0%,45m
15462,1,[我是一只机]菩提树下,2678,38,1,2,3,33.3%,1h
15462,1,[Zenith]Rafael,2678,0,0,1,1,0.0%,1h
15462,1,[LJZ]gaoliangyi,2678,0,0,1,1,0.0%,57m
15462,1,为爱守护,2678,0,0,2,2,0.0%,14m
15462,2,[盈盈一水间]天晓得,2678,0,0,2,2,0.0%,1h
15462,3,我要上三千分,2678,0,0,6,6,0.0%,29m
15491,3,要写论文辣,2677,763,80,75,155,51.6%,14m
15491,1,杨之求,2677,839,31,31,62,50.0%,43m
15491,3,遗言,2677,345,19,19,38,50.0%,47m
15491,3,爱紫薇真是太好了,2677,88,6,14,20,30.0%,2m
15491,3,Jacky,2677,174,4,7,11,36.4%,1h
15491,1,[统一老坛酸菜]Messi,2677,102,3,0,3,100.0%,20m
15491,3,lyhcaipi,2677,96,2,1,3,66.7%,13m
15491,3,[小砍刀幼儿园]萌骑飞飞,2677,0,2,3,5,40.0%,1h
15491,3,星际霸主,2677,0,2,3,5,40.0%,4m
15491,1,抗着步枪,2677,80,2,4,6,33.3%,39m
15491,1,[秦朝妃子秀]九月未央,2677,74,2,5,7,28.6%,43m
15491,1,[埃蒙调教团]rose,2677,0,1,0,1,100.0%,36m
15491,1,嘿嘿嘿嚯,2677,34,1,2,3,33.3%,15m
15491,1,[牌面]LONG,2677,0,0,2,2,0.0%,57m
15491,1,惹不起的爸爸,2677,0,0,3,3,0.0%,33m
15506,3,深海听风,2676,1592,393,387,780,50.4%,30m
15506,2,鱼鱼,2676,931,253,255,508,49.8%,17m
15506,3,Real,2676,1494,80,88,168,47.6%,29m
15506,1,TVTGG,2676,959,60,53,113,53.1%,15m
15506,3,showtime,2676,1336,56,57,113,49.6%,19m
15506,1,小坏蛋,2676,841,54,44,98,55.1%,33m
15506,1,zzz,2676,798,49,36,85,57.6%,33m
15506,1,怪大爷,2676,1013,37,33,70,52.9%,1h
15506,3,[SC2ACG]BlackLHZmiku,2676,580,33,33,66,50.0%,28m
15506,1,逗比南波万,2676,726,27,23,50,54.0%,47m
15506,1,[XXHZ30]小菜基也要玩,2676,545,23,14,37,62.2%,1h
15506,1,Jean,2676,294,11,7,18,61.1%,55m
15506,3,ttgfs,2676,285,11,11,22,50.0%,9m
15506,1,帅就完事了,2676,301,8,8,16,50.0%,45m
15506,3,skynocs,2676,108,7,4,11,63.6%,1h
15506,1,[CHRIS]我的武器会发光,2676,120,5,6,11,45.5%,1h
15506,2,踏血狂魔,2676,168,5,6,11,45.5%,1h
15506,1,[StyOne]Skama,2676,198,5,9,14,35.7%,1h
15506,1,幽鬼魔魂,2676,122,3,1,4,75.0%,36m
15506,3,虚伪,2676,36,3,4,7,42.9%,22m
15506,1,SDemon,2676,38,2,1,3,66.7%,19m
15506,1,llllllllllll,2676,30,2,2,4,50.0%,23m
15506,1,[太微玉清宫]南极统天元圣天尊,2676,0,1,0,1,100.0%,37m
15506,1,沧海客,2676,88,1,1,2,50.0%,39m
15506,1,[小鸡屠宰场3]BBC,2676,96,1,4,5,20.0%,1h
15506,1,弑神,2676,0,0,1,1,0.0%,22m
15532,1,[HLR]wangqiulin,2675,1520,282,269,551,51.2%,53m
15532,2,ywn,2675,1582,136,136,272,50.0%,19m
15532,2,烫着火锅把你留,2675,593,109,120,229,47.6%,28m
15532,3,心急大神,2675,1334,100,86,186,53.8%,27m
15532,1,[招兵买马]uMaster,2675,487,25,25,50,50.0%,22m
15532,1,枯木龙吟照大千,2675,417,17,12,29,58.6%,47m
15532,1,人间大炮,2675,394,16,9,25,64.0%,37m
15532,3,天际抓根宝,2675,420,14,20,34,41.2%,5m
15532,1,大树怪,2675,321,13,15,28,46.4%,29m
15532,1,[江北星际]我猛得不配赢,2675,342,11,9,20,55.0%,22m
15532,1,看你个锤子看,2675,278,9,6,15,60.0%,45m
15532,1,一个滑稽,2675,257,9,6,15,60.0%,34m
15532,1,咸鱼航,2675,298,9,10,19,47.4%,1h
15532,1,[XXHZ1]黎明之光,2675,184,6,7,13,46.2%,47m
15532,1,DANAKKKA,2675,138,6,8,14,42.9%,1h
15532,2,KuronoKei,2675,157,4,2,6,66.7%,59m
15532,2,[DMRz]星之所在,2675,93,3,5,8,37.5%,45m
15532,1,[C67011]Dknight,2675,0,1,0,1,100.0%,23m
15532,1,翻译羽绒服,2675,0,1,1,2,50.0%,47m
15532,1,[社交学大可爱]新手玩家,2675,30,1,2,3,33.3%,22m
15532,1,智障也有春天,2675,88,1,2,3,33.3%,1h
15532,3,魂之挽歌,2675,0,0,1,1,0.0%,1h
15532,3,[五月花]暗影卫队,2675,0,0,1,1,0.0%,1h
15555,1,心悦,2674,1692,264,258,522,50.6%,1h
15555,3,青菜,2674,579,77,80,157,49.0%,7m
15555,3,紫川南,2674,1230,51,51,102,50.0%,23m
15555,3,神座千流,2674,685,42,34,76,55.3%,11m
15555,3,honor,2674,449,17,24,41,41.5%,49m
15555,3,[小白菜]Iven,2674,295,11,10,21,52.4%,49m
15555,1,甲板船工,2674,214,7,5,12,58.3%,47m
15555,3,青鸾,2674,0,4,1,5,80.0%,1h
15555,1,旧梦初醒丶已千年,2674,136,4,3,7,57.1%,31m
15555,3,阿巴阿巴阿巴,2674,74,4,5,9,44.4%,18m
15555,1,[火焰雷兽]我爱祖国,2674,103,3,1,4,75.0%,23m
15555,2,zhouzongchun,2674,0,3,3,6,50.0%,9m
15555,3,远坂凛,2674,36,2,1,3,66.7%,60m
15555,1,[重理工]whybbabo,2674,48,2,3,5,40.0%,16m
15555,2,幽云,2674,93,1,3,4,25.0%,24m
15555,1,[Unique]MiAmor,2674,0,1,6,7,14.3%,1h
15555,1,[卡尔达利斯]诫躤,2674,0,0,1,1,0.0%,36m
15555,1,[寻风]墨邑,2674,0,0,1,1,0.0%,16m
15573,1,[CPT]剪神,2673,1689,704,706,1410,49.9%,20m
15573,1,随机一个,2673,1211,105,101,206,51.0%,7m
15573,3,[仙女的云朵喵]忧伤的落樱,2673,598,57,53,110,51.8%,22m
15573,1,IIIIIIIII,2673,793,29,37,66,43.9%,15m
15573,1,nickfzt,2673,560,28,27,55,50.9%,14m
15573,1,Zoe,2673,503,22,11,33,66.7%,38m
15573,1,exiazs,2673,572,21,22,43,48.8%,20m
15573,1,[哇呀呀]被风吹着走的喵,2673,387,17,13,30,56.7%,16m
15573,3,咬你就两口,2673,478,16,18,34,47.1%,26m
15573,1,[X英雄圣域X]坦然的面对,2673,538,16,21,37,43.2%,14m
15573,1,[国际第91号]classices,2673,272,13,4,17,76.5%,1h
15573,1,蒙牛人奶,2673,388,11,11,22,50.0%,14m
15573,1,Fury,2673,324,10,10,20,50.0%,11m
15573,1,别走等我买橘,2673,186,7,6,13,53.8%,33m
15573,1,[Fiend]初中什么样,2673,160,4,3,7,57.1%,23m
15573,3,旺达,2673,46,3,4,7,42.9%,44m
15573,3,[黑喂苟]Dulles,2673,0,2,2,4,50.0%,7m
15573,3,lililililil,2673,0,2,3,5,40.0%,1h
15573,1,Snake,2673,0,1,2,3,33.3%,1h
15573,1,桐人,2673,0,0,1,1,0.0%,20m
15593,3,菠菜蛋花汤,2672,1391,184,172,356,51.7%,26m
15593,1,[专治格种不服]computer,2672,1426,83,63,146,56.8%,29m
15593,1,狂乱的天外尾巴,2672,853,39,31,70,55.7%,38m
15593,1,[半夏]KKblood,2672,511,20,16,36,55.6%,22m
15593,1,小暗,2672,301,15,14,29,51.7%,1h
15593,3,夏天协奏曲,2672,452,15,21,36,41.7%,19m
15593,3,阿森纳,2672,233,9,10,19,47.4%,23m
15593,1,[牌面]Figo,2672,132,5,5,10,50.0%,36m
15593,1,[sc日记]卡兰,2672,160,4,2,6,66.7%,1h
15593,2,龙渊,2672,126,4,5,9,44.4%,1h
15593,2,蔡猫,2672,137,4,6,10,40.0%,15m
15593,2,[明帝国]明太祖,2672,134,4,6,10,40.0%,1h
15593,3,BlackHans,2672,0,3,3,6,50.0%,1h
15593,1,SwordrainAF,2672,0,3,5,8,37.5%,33m
15593,3,[混元行医]Power,2672,125,3,6,9,33.3%,60m
15593,2,[SKT俱乐部]老胸哥,2672,30,3,19,22,13.6%,26m
15593,1,武田信玄,2672,95,2,1,3,66.7%,38m
15593,1,星空,2672,102,2,3,5,40.0%,45m
15593,3,吃瓜爱丽丝,2672,0,2,3,5,40.0%,1h
15593,3,杭喆,2672,0,2,4,6,33.3%,21m
15593,1,hhhhhhhhhhh,2672,103,1,3,4,25.0%,29m
15593,3,爱国者,2672,0,0,1,1,0.0%,60m
15615,3,Passion,2671,1475,71,75,146,48.6%,24m
15615,1,FentonLee,2671,986,43,36,79,54.4%,37m
15615,1,[快乐就完事儿]饲养员先生,2671,549,24,21,45,53.3%,1h
15615,1,卡卡希,2671,608,23,27,50,46.0%,55m
15615,1,Leonzzz,2671,388,18,8,26,69.2%,1h
15615,3,[苏维埃红军]防风草,2671,496,17,22,39,43.6%,47m
15615,3,小小西,2671,403,14,14,28,50.0%,15m
15615,3,神奇的意大利炮,2671,389,14,16,30,46.7%,7m
15615,1,JZW,2671,416,14,19,33,42.4%,1h
15615,1,李少,2671,336,11,12,23,47.8%,57m
15615,1,王者归来,2671,301,10,8,18,55.6%,39m
15615,1,无声桥,2671,213,9,5,14,64.3%,1h
15615,1,空白,2671,68,3,2,5,60.0%,29m
15615,1,Outsider,2671,132,3,4,7,42.9%,6m
15615,3,[Hdl]ASTROLOGY,2671,40,3,4,7,42.9%,1h
15615,3,堕落者,2671,97,2,0,2,100.0%,27m
15615,2,StarMaster,2671,42,2,1,3,66.7%,1h
15615,3,不穿短裤,2671,0,2,3,5,40.0%,6m
15615,3,装甲风暴,2671,0,2,3,5,40.0%,1h
15615,1,我为人皇,2671,38,2,4,6,33.3%,45m
15615,2,DezhA,2671,60,2,14,16,12.5%,30m
15615,1,耿鬼,2671,0,1,0,1,100.0%,57m
15615,2,Funeral,2671,0,1,1,2,50.0%,1h
15615,1,星空,2671,0,0,1,1,0.0%,45m
15639,3,ALTerNatIVe,2670,1516,110,98,208,52.9%,47m
15639,3,darklong,2670,1470,83,74,157,52.9%,23m
15639,2,quitely,2670,983,41,48,89,46.1%,50m
15639,1,[扫黄]Iris,2670,437,19,12,31,61.3%,45m
15639,1,麦诺希德,2670,386,15,12,27,55.6%,55m
15639,1,秋水浮萍,2670,287,10,6,16,62.5%,1h
15639,3,[暴雪七队]Sefira,2670,204,10,13,23,43.5%,7m
15639,1,封茗微雨,2670,220,8,5,13,61.5%,1h
15639,1,scared,2670,176,6,6,12,50.0%,22m
15639,1,黑骑士,2670,146,5,4,9,55.6%,19m
15639,2,蔡徐坤,2670,139,4,4,8,50.0%,37m
15639,1,[小金上天队]表情大师,2670,122,4,5,9,44.4%,3m
15639,2,[经常一起玩的]沉默志坚,2670,134,4,5,9,44.4%,1h
15639,3,[暴雪三十队]新手灬别打脸,2670,118,4,11,15,26.7%,26m
15639,3,RRREX,2670,0,3,2,5,60.0%,41m
15639,3,[超牛]好牛的牛,2670,0,2,2,4,50.0%,4m
15639,1,公爵,2670,135,2,4,6,33.3%,47m
15639,3,骑着狗咬天下,2670,62,2,9,11,18.2%,29m
15639,1,愚者,2670,88,1,1,2,50.0%,36m
15639,2,[Genial]小飞飞,2670,95,1,2,3,33.3%,19m
15639,2,[菜就对了]qqq,2670,0,0,1,1,0.0%,19m
15639,1,[QWQa]李少在线散枪兵,2670,0,0,1,1,0.0%,57m
15639,1,丶沐丨承,2670,0,0,1,1,0.0%,1h
15639,3,[战忽局总部]五乐泉,2670,0,0,1,1,0.0%,5m
15639,3,mubai,2670,0,0,1,1,0.0%,49m
15639,2,暗影之龙,2670,0,0,2,2,0.0%,1h
15665,1,Cling,2669,1529,112,107,219,51.1%,15m
15665,1,Allen,2669,1136,67,54,121,55.4%,1h
15665,1,无耻小学生,2669,633,33,36,69,47.8%,34m
15665,3,cjluwxh,2669,212,19,15,34,55.9%,16m
15665,3,看老夫的航母舰队,2669,337,15,15,30,50.0%,15m
15665,1,泰伦人,2669,332,13,12,25,52.0%,1h
15665,1,自在大忙人,2669,234,9,10,19,47.4%,1h
15665,1,咦这只竹鼠中暑了,2669,161,8,6,14,57.1%,52m
15665,3,[老司机翻车2]丑桔,2669,225,6,11,17,35.3%,1h
15665,1,FYyy,2669,158,5,2,7,71.4%,43m
15665,1,[我队伍很强大]菜的一比皮卡鸡,2669,192,5,5,10,50.0%,22m
15665,1,[爱依酱大胜利]候鸟与呓语的少女,2669,133,4,2,6,66.7%,20m
15665,3,不肝居士,2669,97,3,3,6,50.0%,1h
15665,1,[暴雪家族]橙子,2669,68,3,3,6,50.0%,1h
15665,3,杀康星人,2669,34,3,5,8,37.5%,1h
15665,2,[请帮我嘴交谢]羊羔的梦碎,2669,94,2,0,2,100.0%,25m
15665,1,烤熟的咸鱼,2669,88,2,0,2,100.0%,20m
15665,3,未来花朵,2669,0,2,2,4,50.0%,38m
15665,2,DunaYe,2669,40,1,1,2,50.0%,40m
15684,1,vikinggoilth,2668,1008,49,33,82,59.8%,47m
15684,1,归海一刀,2668,781,31,28,59,52.5%,57m
15684,3,艾恩俄面,2668,466,18,19,37,48.6%,7m
15684,1,红烧排骨有点腻,2668,444,15,18,33,45.5%,1h
15684,3,ypaaaaaa,2668,240,9,13,22,40.9%,23m
15684,1,[极限菜鸟]ConstanTine,2668,205,8,4,12,66.7%,19m
15684,2,[GTA丶SE]TAGer,2668,246,7,3,10,70.0%,1h
15684,1,[邪恶的郁金香]haitian,2668,246,7,7,14,50.0%,1h
15684,3,shadowhunte,2668,30,5,2,7,71.4%,48m
15684,3,[专治格种不服]wzf,2668,36,3,4,7,42.9%,1h
15684,3,探寻起源之人,2668,135,3,5,8,37.5%,1h
15684,3,皮克桃敲厉害,2668,60,3,6,9,33.3%,7m
15684,1,[荣耀丶殿堂]妈妈船,2668,88,2,0,2,100.0%,1h
15684,3,[XXXOOO]疯子,2668,0,2,2,4,50.0%,1h
15684,3,[最强大佬]奔跑的大豆,2668,0,2,3,5,40.0%,22m
15684,3,桥的麻袋,2668,0,2,3,5,40.0%,1h
15684,1,立华奏,2668,0,1,1,2,50.0%,16m
15684,1,[猫咪一个顶俩]浮生难遇你,2668,40,1,3,4,25.0%,1h
15684,3,[czlp]单小西,2668,96,1,3,4,25.0%,8m
15684,3,aaaaa,2668,0,0,1,1,0.0%,1h
15704,1,[EnTorn]Tinky,2667,1193,49,38,87,56.3%,19m
15704,1,梅川内依,2667,585,23,21,44,52.3%,45m
15704,1,机械化就不会输,2667,614,22,33,55,40.0%,21m
15704,1,[萝林好汉]狂野之狼,2667,366,16,17,33,48.5%,5m
15704,1,Phinkself,2667,394,13,14,27,48.1%,16m
15704,1,hahaha,2667,338,12,13,25,48.0%,1h
15704,3,王政,2667,249,9,9,18,50.0%,19m
15704,1,低调不会被打,2667,270,8,8,16,50.0%,1h
15704,1,StealHeart,2667,228,7,7,14,50.0%,7m
15704,1,[你好抱歉]lllllll,2667,149,5,1,6,83.3%,1h
15704,1,百鬼丸多多,2667,106,4,6,10,40.0%,5m
15704,1,SkyAlan,2667,74,3,3,6,50.0%,33m
15704,3,风之诺言,2667,36,3,4,7,42.9%,4m
15704,1,DKrose,2667,72,2,4,6,33.3%,1h
15704,1,囡妈妈,2667,0,1,0,1,100.0%,45m
15704,3,[星之开拓者]Tim,2667,0,0,1,1,0.0%,1h
15704,1,霍霍,2667,0,0,1,1,0.0%,1h
15704,3,粗糙哥,2667,0,0,2,2,0.0%,7m
15722,2,怡宝大魔王,2666,427,118,115,233,50.6%,22m
15722,1,[花园宝宝]小点点,2666,1534,76,53,129,58.9%,53m
15722,1,小星星,2666,1111,42,40,82,51.2%,1h
15722,3,TeamBomb,2666,813,31,33,64,48.4%,19m
15722,1,两仪式,2666,329,13,9,22,59.1%,1h
15722,3,[ESKT]darling,2666,340,12,13,25,48.0%,14m
15722,1,不二阿,2666,317,10,17,27,37.0%,29m
15722,1,傲之雷神,2666,284,8,9,17,47.1%,1h
15722,1,aaa,2666,242,8,9,17,47.1%,7m
15722,2,刺客,2666,203,6,6,12,50.0%,1h
15722,3,[Nostop]Never,2666,146,5,12,17,29.4%,27m
15722,2,明月松间照,2666,0,4,2,6,66.7%,1h
15722,1,银色重炮,2666,114,4,6,10,40.0%,16m
15722,3,月读,2666,0,2,3,5,40.0%,1h
15722,3,万法从心,2666,30,2,4,6,33.3%,27m
15722,2,荠菜蟹黄虾肉馄饨,2666,30,2,12,14,14.3%,14m
15722,2,llllllllll,2666,0,1,0,1,100.0%,1h
15722,3,Stats,2666,0,1,0,1,100.0%,5m
15722,1,东方月初,2666,0,1,1,2,50.0%,57m
15722,1,肖生克的九叔,2666,0,1,2,3,33.3%,43m
15722,1,完犊子啦,2666,0,0,1,1,0.0%,59m
15743,3,抱抱小熊尼,2665,1012,109,100,209,52.2%,22m
15743,3,无招胜有招,2665,799,51,46,97,52.6%,19m
15743,1,菲尼克斯,2665,1253,47,44,91,51.6%,22m
15743,1,暴躁的风,2665,1006,35,33,68,51.5%,7m
15743,3,她与疾风都是过客,2665,726,28,30,58,48.3%,19m
15743,2,Gai,2665,442,18,7,25,72.0%,1h
15743,1,杰尼丶杰尼,2665,442,18,15,33,54.5%,1h
15743,2,[Slowly]Hazer,2665,347,14,24,38,36.8%,47m
15743,3,RainyPond,2665,298,10,16,26,38.5%,49m
15743,2,[星海惡霸]凝仙,2665,124,8,11,19,42.1%,7m
15743,3,田鼓之丶,2665,242,8,15,23,34.8%,11m
15743,1,甘之若饴,2665,177,6,2,8,75.0%,28m
15743,1,[文韬武略]雅比斯,2665,193,6,6,12,50.0%,1h
15743,2,haveaguess,2665,173,5,4,9,55.6%,1h
15743,2,[浴火银河]取颅者,2665,137,3,1,4,75.0%,46m
15743,3,fredcool,2665,121,3,4,7,42.9%,1h
15743,2,雨中节奏,2665,92,2,0,2,100.0%,1h
15743,3,[伊瑟蓓拉]御坂美琴,2665,0,2,3,5,40.0%,4m
15743,3,king,2665,0,2,3,5,40.0%,4m
15743,2,驱逐船,2665,0,1,0,1,100.0%,32m
15743,3,蝴蝶忍,2665,0,0,1,1,0.0%,22m
15743,1,不内战,2665,0,0,2,2,0.0%,33m
15743,1,[西红柿炒]煎蛋,2665,0,0,2,2,0.0%,37m
15743,3,[一卵最多三条]了然,2665,0,0,3,3,0.0%,1h
15767,1,春开那夜,2664,1095,87,77,164,53.0%,47m
15767,3,鎶嘚膞説,2664,812,28,34,62,45.2%,16m
15767,1,夏未妖,2664,417,15,10,25,60.0%,55m
15767,2,[双神教小主教]神秘,2664,308,11,5,16,68.8%,10m
15767,2,喵喵喵,2664,268,9,6,15,60.0%,57m
15767,1,[GO天鸟分队]IamOnlyTale,2664,239,9,7,16,56.2%,43m
15767,1,果缤纷,2664,258,9,8,17,52.9%,50m
15767,3,Eilsh,2664,254,9,14,23,39.1%,7m
15767,1,一米,2664,232,6,6,12,50.0%,45m
15767,2,KTFlash,2664,156,5,4,9,55.6%,47m
15767,3,Ghost,2664,0,4,1,5,80.0%,1h
15767,2,sleepyhead,2664,94,4,3,7,57.1%,56m
15767,1,[学习]夜狼,2664,118,3,1,4,75.0%,47m
15767,2,[是我赢了]bht,2664,66,3,1,4,75.0%,16m
15767,3,[浮夸的]雨休,2664,0,2,3,5,40.0%,1h
15767,2,[谐星光子炮台]Relativity,2664,0,1,0,1,100.0%,46m
15767,2,RWBY,2664,0,1,0,1,100.0%,51m
15767,1,乏善虚名,2664,0,1,1,2,50.0%,33m
15767,1,sin,2664,36,1,3,4,25.0%,5m
15786,3,zerokikyo,2663,1525,194,185,379,51.2%,19m
15786,1,吕布,2663,1095,102,90,192,53.1%,11m
15786,1,魂殇,2663,227,43,37,80,53.8%,36m
15786,2,即将爆发,2663,252,9,13,22,40.9%,17m
15786,2,决不投降,2663,86,4,1,5,80.0%,16m
15786,2,Kirito,2663,88,4,7,11,36.4%,1h
15786,2,[彡基佬之家]鸿博的春天,2663,0,1,0,1,100.0%,1h
15786,2,星际第一钢琴家,2663,0,1,1,2,50.0%,30m
15786,2,jianVShao,2663,0,0,1,1,0.0%,7m
15786,1,萌新玩星际,2663,0,0,4,4,0.0%,1h
15786,1,Tao,2663,0,0,4,4,0.0%,1h
15797,1,黄缘,2662,1496,261,265,526,49.6%,44m
15797,3,[fvv]点点是只狗,2662,1275,255,234,489,52.1%,15m
15797,3,林小政,2662,1424,62,65,127,48.8%,11m
15797,3,KAER,2662,720,26,33,59,44.1%,27m
15797,1,随便玩会,2662,594,19,22,41,46.3%,29m
15797,2,[斯巴达血战团]意欲捕鸣蝉,2662,452,16,13,29,55.2%,36m
15797,3,任吗,2662,446,16,20,36,44.4%,18m
15797,2,雨点,2662,364,14,12,26,53.8%,1h
15797,1,我是鸡,2662,430,13,16,29,44.8%,19m
15797,1,[呵你妹啊]Ben,2662,133,10,10,20,50.0%,16m
15797,2,[社交学教员]枫落,2662,205,10,10,20,50.0%,1h
15797,2,[粑粑雄吃粑粑]realbird,2662,274,10,16,26,38.5%,1h
15797,1,[KPG2]慕白,2662,248,8,8,16,50.0%,19m
15797,1,你的背影遥不可及,2662,138,7,2,9,77.8%,22m
15797,1,坟葬,2662,214,7,12,19,36.8%,43m
15797,2,[白鸦]ylainiya,2662,178,6,0,6,100.0%,1h
15797,3,patrick,2662,167,5,5,10,50.0%,4m
15797,1,[埃蒙调教员]DIS,2662,190,4,7,11,36.4%,45m
15797,2,JustICE,2662,90,3,3,6,50.0%,31m
15797,1,PFUN,2662,80,3,4,7,42.9%,7m
15797,2,LJF,2662,30,3,4,7,42.9%,18m
15797,3,[C90506]闪电速度,2662,40,3,4,7,42.9%,1h
15797,3,yamucha,2662,121,3,4,7,42.9%,1h
15797,1,[KN]thetastar,2662,87,2,1,3,66.7%,19m
15797,3,蔚蓝之境,2662,0,2,4,6,33.3%,24m
15797,3,huqingmin,2662,40,2,4,6,33.3%,1h
15797,2,[黑手团]我即虫群,2662,0,1,0,1,100.0%,37m
15797,3,玄虚,2662,0,1,0,1,100.0%,1h
15797,1,阿布,2662,0,1,1,2,50.0%,1h
15797,2,枫阑干,2662,32,1,1,2,50.0%,1h
15797,3,死魂忏悔,2662,0,1,1,2,50.0%,60m
15797,1,[神必]死魂,2662,36,1,3,4,25.0%,1h
15797,2,哥们玩玩而已,2662,0,0,1,1,0.0%,1h
15797,3,孙子涵我喜欢你,2662,0,0,1,1,0.0%,1h
15797,1,parking,2662,0,0,2,2,0.0%,38m
15832,1,oooooooooooo,2661,1055,44,42,86,51.2%,52m
15832,2,[丨SLT丨]aim,2661,613,28,17,45,62.2%,51m
15832,3,庞白,2661,533,22,20,42,52.4%,7m
15832,2,sky,2661,620,19,29,48,39.6%,3m
15832,3,[IGS]王者,2661,282,9,14,23,39.1%,20m
15832,1,[WWS]永夜的极光,2661,258,7,6,13,53.8%,1h
15832,2,[暴雪我是你爹]古明地盆,2661,133,5,5,10,50.0%,1h
15832,1,玩游戏生气不值得,2661,106,4,4,8,50.0%,38m
15832,1,[1703]saaf,2661,157,3,4,7,42.9%,29m
15832,1,Tim,2661,0,3,6,9,33.3%,1h
15832,1,卡车备胎,2661,97,3,7,10,30.0%,31m
15832,1,Immortanbird,2661,89,2,1,3,66.7%,33m
15832,2,zhang,2661,30,2,1,3,66.7%,1h
15832,2,超级无敌范范范,2661,0,1,0,1,100.0%,8m
15832,1,[Emc2]爱美的究极小迷妹,2661,0,1,1,2,50.0%,45m
15832,1,SkyHunter,2661,0,1,1,2,50.0%,1h
15848,1,血夜晨曦,2660,913,60,54,114,52.6%,33m
15848,3,TimeShiftt,2660,730,27,27,54,50.0%,6m
15848,1,梁唐晋汉周,2660,619,21,21,42,50.0%,34m
15848,3,IIIIIIIIII,2660,617,20,24,44,45.5%,28m
15848,2,耗自为汁,2660,351,11,18,29,37.9%,1h
15848,1,[西瓜撞地球]LigntElf,2660,241,10,8,18,55.6%,1h
15848,2,RBQ,2660,259,10,11,21,47.6%,1h
15848,1,咫尺天涯,2660,316,10,12,22,45.5%,22m
15848,2,watch,2660,267,9,6,15,60.0%,1h
15848,2,群殴无敌菜鸟,2660,254,9,7,16,56.2%,46m
15848,2,好小一只妍妍,2660,174,7,4,11,63.6%,1h
15848,2,ChinaDragon,2660,216,6,3,9,66.7%,29m
15848,1,Sinkin,2660,227,6,3,9,66.7%,1h
15848,2,[不知不觉天亮]CoyZhiv,2660,90,4,2,6,66.7%,14m
15848,3,[傲世战队]拿着小棍挑粪玩,2660,30,4,3,7,57.1%,27m
15848,3,socialsure,2660,97,3,3,6,50.0%,1h
15848,1,chole,2660,34,2,2,4,50.0%,55m
15848,2,[神奇的海螺]Dearsuger,2660,0,1,0,1,100.0%,29m
15848,2,eternal,2660,0,1,0,1,100.0%,59m
15848,3,乌拉,2660,0,1,1,2,50.0%,34m
15848,3,WZIM,2660,0,0,1,1,0.0%,1h
15869,1,EDGLOVER,2659,1676,138,138,276,50.0%,1h
15869,2,leiyifan,2659,641,27,30,57,47.4%,5m
15869,1,[XCode]无限非概率驱动,2659,598,23,21,44,52.3%,1h
15869,2,就硬冲,2659,292,11,3,14,78.6%,1h
15869,2,[天才画家]艺术天才画家,2659,176,7,6,13,53.8%,47m
15869,3,binbin,2659,97,4,6,10,40.0%,1h
15869,2,Gio,2659,88,4,7,11,36.4%,15m
15869,3,倾城色狼,2659,170,4,9,13,30.8%,48m
15869,3,风吹屁屁菊花凉,2659,155,3,1,4,75.0%,1h
15869,3,猎户星座,2659,60,3,7,10,30.0%,14m
15869,3,青臣,2659,0,2,3,5,40.0%,1h
15869,3,LSH,2659,0,1,1,2,50.0%,44m
15869,1,[暴雪家族]橘子,2659,38,1,4,5,20.0%,1h
15869,2,简单难度电脑,2659,0,0,1,1,0.0%,1h
15869,2,银色闪光亚丝娜,2659,0,0,1,1,0.0%,37m
15869,3,aaaa,2659,0,0,2,2,0.0%,1h
15869,1,[萌新深冬]魔法少女柠檬酱,2659,0,0,3,3,0.0%,1h
15886,3,RUBEN,2658,1569,159,161,320,49.7%,27m
15886,2,高山流水,2658,440,26,22,48,54.2%,3m
15886,3,lost,2658,610,22,27,49,44.9%,49m
15886,3,IIIIIIIIIIII,2658,518,20,23,43,46.5%,22m
15886,2,[四宮辉夜]KAOfish,2658,148,5,3,8,62.5%,1h
15886,2,离殇,2658,0,4,2,6,66.7%,25m
15886,1,[Tov]贾维斯,2658,114,4,4,8,50.0%,16m
15886,2,月亮不睡我不睡,2658,0,3,4,7,42.9%,1h
15886,1,Shootmeplz,2658,94,3,4,7,42.9%,1h
15886,2,nigular,2658,64,2,1,3,66.7%,49m
15886,1,[CPT]刘丽楠,2658,108,2,2,4,50.0%,1h
15886,3,liopion,2658,0,2,2,4,50.0%,52m
15886,1,[萌新来袭]CEO,2658,97,2,3,5,40.0%,39m
15886,3,活好不粘人,2658,0,2,3,5,40.0%,1h
15886,3,[CHP]aklhwek,2658,0,2,4,6,33.3%,1h
15886,1,[幻想舰队]炎丨虎,2658,0,1,0,1,100.0%,1h
15902,3,[悠久的风]星际丶小康爷,2657,874,39,48,87,44.8%,17m
15902,3,[吼吼]灬愤怒的玉米灬,2657,776,31,32,63,49.2%,7m
15902,1,[Potato]SCA,2657,510,16,15,31,51.6%,34m
15902,3,KOY,2657,358,15,14,29,51.7%,25m
15902,2,LiWeQin,2657,418,14,11,25,56.0%,13m
15902,1,雪漫,2657,413,12,13,25,48.0%,1h
15902,1,手术刀,2657,296,10,29,39,25.6%,27m
15902,2,回归平凡,2657,292,9,6,15,60.0%,51m
15902,1,[作弊人机]安眠,2657,260,8,8,16,50.0%,21m
15902,1,Naplean,2657,282,7,9,16,43.8%,3m
15902,3,[敌人正在]撕碎我的部队,2657,191,6,5,11,54.5%,38m
15902,2,[天羽不榖]休比,2657,136,3,2,5,60.0%,1h
15902,1,[秋毫]IIIIIIIIIIII,2657,102,3,6,9,33.3%,34m
15902,2,林熙熙,2657,32,2,1,3,66.7%,1h
15902,3,北海道的一股清流,2657,0,2,3,5,40.0%,1h
15902,3,新手,2657,0,2,3,5,40.0%,1h
15902,3,Vabessa,2657,97,2,4,6,33.3%,44m
15902,2,风之迷沙,2657,0,0,1,1,0.0%,10m
15902,2,[狂风暴风雨]llllllll,2657,0,0,1,1,0.0%,31m
15921,3,雪花飘,2656,689,39,36,75,52.0%,19m
15921,3,长安李不白,2656,463,26,21,47,55.3%,7m
15921,1,征服之翼,2656,532,25,16,41,61.0%,1h
15921,1,IIIIIIIIIIII,2656,471,23,15,38,60.5%,16m
15921,2,MagicBlue,2656,408,18,18,36,50.0%,25m
15921,1,鱼塘女选手,2656,86,10,10,20,50.0%,24m
15921,3,ShadowBoy,2656,311,10,12,22,45.5%,50m
15921,3,哦列哇可挖诺噶,2656,212,7,16,23,30.4%,50m
15921,3,[YR]SaRo,2656,88,4,9,13,30.8%,15m
15921,2,[怀念曾经温柔]Ghost,2656,150,4,11,15,26.7%,19m
15921,1,[谐就是一切]Daeva,2656,68,3,3,6,50.0%,45m
15921,3,[帝国Aeon]虚竹桓木,2656,121,3,4,7,42.9%,1h
15921,1,吾爱,2656,89,2,1,3,66.7%,57m
15921,3,FocusU,2656,0,2,3,5,40.0%,1h
15921,1,RichardX,2656,40,2,3,5,40.0%,5m
15921,3,XIAOAIXING,2656,0,2,4,6,33.3%,52m
15921,3,沈辛苦,2656,94,2,4,6,33.3%,28m
15921,3,[狂想曲]尼玛,2656,97,1,1,2,50.0%,1h
15921,2,ALERT,2656,0,0,1,1,0.0%,47m
15940,3,[C28]菲德罗,2655,1468,176,192,368,47.8%,15m
15940,1,南宁永鑫战队,2655,1668,67,56,123,54.5%,47m
15940,1,PIMBAZIMBA,2655,827,65,59,124,52.4%,57m
15940,1,MCzz,2655,1040,48,33,81,59.3%,33m
15940,1,超级课程表,2655,662,31,18,49,63.3%,46m
15940,2,Revolution,2655,218,8,4,12,66.7%,1h
15940,1,[CPT]蛋疼的极品奶爸,2655,211,7,4,11,63.6%,47m
15940,3,卑微的异虫玩家,2655,0,4,1,5,80.0%,1h
15940,3,Tjf,2655,30,3,4,7,42.9%,1h
15940,3,xuzewaini,2655,120,3,5,8,37.5%,47m
15940,1,紫川,2655,34,2,2,4,50.0%,1h
15940,1,czc,2655,108,2,2,4,50.0%,11m
15940,3,[北境]Tyrant,2655,0,2,3,5,40.0%,1h
15940,3,范真人,2655,0,2,3,5,40.0%,1h
15940,3,陶松鼠科技执行官,2655,0,2,3,5,40.0%,22m
15940,1,元魔再临,2655,0,1,1,2,50.0%,1h
15940,2,Rivers,2655,0,1,1,2,50.0%,1h
15940,2,[玩个虫子]踏歌,2655,0,0,1,1,0.0%,13m
15940,2,[人类天下第一]邪亿杰,2655,0,0,1,1,0.0%,26m
15940,3,uifh,2655,0,0,1,1,0.0%,1h
15940,1,逼嘴辣啊,2655,0,0,2,2,0.0%,1h
15940,1,德莉大聪明,2655,0,0,3,3,0.0%,16m
15962,2,[第八舰队丶]玩神族狗人司马,2654,1537,235,231,466,50.4%,21m
15962,1,快乐知足,2654,1581,150,151,301,49.8%,45m
15962,2,星期三,2654,956,114,97,211,54.0%,25m
15962,3,[残雪映月]潘二狗,2654,856,30,42,72,41.7%,8m
15962,3,生猛哥,2654,245,20,19,39,51.3%,29m
15962,3,[跳虫可以吃吗]又练回去了,2654,363,13,14,27,48.1%,29m
15962,1,[TeamGB]loveDd,2654,332,12,10,22,54.5%,1h
15962,1,咸聪,2654,186,7,9,16,43.8%,1h
15962,1,[notd专家]拉夫十二,2654,155,6,3,9,66.7%,46m
15962,3,寒菁,2654,182,6,5,11,54.5%,13m
15962,2,啊过,2654,134,4,2,6,66.7%,51m
15962,2,hamber,2654,44,4,5,9,44.4%,1h
15962,1,[C09]手游废宅,2654,116,3,3,6,50.0%,1h
15962,2,西行寺焚岚,2654,36,2,1,3,66.7%,1h
15962,3,YGYGYG,2654,0,2,3,5,40.0%,1h
15962,3,LoveLuLU,2654,0,1,0,1,100.0%,1h
15962,1,IDarkMoon,2654,88,1,2,3,33.3%,52m
15962,1,lllllllllll,2654,30,1,4,5,20.0%,1h
15962,3,Gues,2654,0,0,1,1,0.0%,6m
15962,1,[艾尔之巅]QAQ,2654,0,0,2,2,0.0%,35m
15962,1,Fate,2654,0,0,3,3,0.0%,1h
15983,3,偷家吃粑粑吧,2653,1183,212,208,420,50.5%,17m
15983,1,悲情七月,2653,1258,70,67,137,51.1%,23m
15983,1,佳丨落寞,2653,1179,50,44,94,53.2%,1h
15983,1,血沸,2653,637,44,36,80,55.0%,1h
15983,2,IIIIIII,2653,708,24,40,64,37.5%,14m
15983,1,[看我朵蜜你]阿尔托莉雅,2653,535,20,19,39,51.3%,1h
15983,1,Gary,2653,291,20,20,40,50.0%,1h
15983,2,[TPZTPZ]abc,2653,407,17,6,23,73.9%,1h
15983,1,mylifefaiur,2653,415,17,10,27,63.0%,5m
15983,2,伏羲,2653,344,12,7,19,63.2%,51m
15983,1,[镜花水月丨]霸气的辰哥,2653,364,12,11,23,52.2%,47m
15983,2,alltheplayer,2653,242,9,2,11,81.8%,17m
15983,3,[暴雪二十二队]丿拂灬晓丨,2653,0,4,1,5,80.0%,44m
15983,2,疯狂搞事的小鸡,2653,46,3,6,9,33.3%,1h
15983,3,[爆虫抵抗联盟]谁在呼叫舰队,2653,58,2,11,13,15.4%,23m
15983,2,[哔哩哔哩乾杯]NaIve,2653,0,1,0,1,100.0%,1h
15983,3,孤山之中一老衲,2653,0,1,1,2,50.0%,1h
15983,1,Emotion,2653,0,1,1,2,50.0%,36m
15983,1,哥特么就是贱,2653,36,1,3,4,25.0%,11m
15983,2,爱刷牙的侦探,2653,0,0,1,1,0.0%,36m
15983,2,saber,2653,0,0,1,1,0.0%,47m
16004,2,Junli,2652,1519,179,187,366,48.9%,50m
16004,2,默默然,2652,1145,45,52,97,46.4%,10m
16004,2,paymanNB,2652,902,41,33,74,55.4%,1h
16004,3,成墨,2652,157,26,28,54,48.1%,8m
16004,2,燃烧我的卡路里,2652,238,8,6,14,57.1%,1h
16004,1,TERRAN,2652,202,6,10,16,37.5%,1h
16004,3,谈笑间,2652,170,6,10,16,37.5%,15m
16004,2,Forlove,2652,92,4,1,5,80.0%,56m
16004,3,[中华何平]快食用猩猩充饥,2652,0,4,1,5,80.0%,1h
16004,2,[XZZJ]萌新人机,2652,0,4,2,6,66.7%,1h
16004,1,天际贼星,2652,153,4,3,7,57.1%,16m
16004,3,平安保险,2652,44,4,3,7,57.1%,4m
16004,1,日天库里,2652,167,4,4,8,50.0%,7m
16004,1,你大表哥,2652,68,3,5,8,37.5%,1h
16004,2,[lll巨坑]SCV,2652,30,2,0,2,100.0%,32m
16004,3,xiaye,2652,0,2,2,4,50.0%,22m
16004,2,三少,2652,0,1,0,1,100.0%,49m
16004,2,在厕所里吃饭,2652,0,1,0,1,100.0%,1h
16004,3,暗中感染,2652,0,1,1,2,50.0%,18m
16004,2,面壁者泰勒奥瑞斯,2652,0,0,1,1,0.0%,1h
16004,1,春风得意马蹄琴,2652,0,0,1,1,0.0%,7m
16004,1,暴力严,2652,0,0,4,4,0.0%,36m
16026,3,十二月的肖邦,2651,1337,348,340,688,50.6%,27m
16026,3,[我菜请打队友]懒猫,2651,1042,83,71,154,53.9%,23m
16026,1,一白,2651,1100,44,35,79,55.7%,52m
16026,1,kerouac,2651,379,22,12,34,64.7%,33m
16026,2,MaGejiI,2651,347,12,8,20,60.0%,18m
16026,2,手慢的笨比,2651,191,11,1,12,91.7%,46m
16026,1,[四叶草]RainySky,2651,312,11,12,23,47.8%,37m
16026,3,hanxiaozhi,2651,148,9,10,19,47.4%,9m
16026,1,阿史那特勤,2651,286,9,12,21,42.9%,45m
16026,3,皇家胜利者盖本,2651,192,5,7,12,41.7%,36m
16026,2,不停若风,2651,120,4,4,8,50.0%,47m
16026,1,忆流年,2651,94,3,7,10,30.0%,1h
16026,3,银剑,2651,0,2,3,5,40.0%,4m
16026,2,DogEyes,2651,0,1,0,1,100.0%,8m
16026,2,渡苦恶,2651,0,1,1,2,50.0%,1h
16026,2,[CQWS]好文文,2651,42,1,3,4,25.0%,31m
16026,1,Sharks,2651,0,0,2,2,0.0%,33m
16026,2,[太美]崎岖之行,2651,0,0,2,2,0.0%,1h
16026,2,[酿酒]皿夕,2651,0,0,2,2,0.0%,37m
16045,2,dyg,2650,1522,330,325,655,50.4%,22m
16045,3,毛线球,2650,1503,319,332,651,49.0%,12m
16045,3,寒江独钓,2650,1463,72,71,143,50.3%,8m
16045,3,半城半埃落,2650,599,25,29,54,46.3%,48m
16045,1,DiaryLiang,2650,468,20,12,32,62.5%,33m
16045,1,[在下菜鸡一只]某不知名路人,2650,343,16,5,21,76.2%,16m
16045,2,阳灰,2650,273,11,3,14,78.6%,1h
16045,1,[6G芯片研發]开罗宣言,2650,289,9,7,16,56.2%,47m
16045,3,kinou,2650,250,9,14,23,39.1%,15m
16045,2,jbk,2650,172,6,6,12,50.0%,1h
16045,2,[荣耀归于我主]三玖天下第一,2650,203,5,0,5,100.0%,1h
16045,1,封鱼大大咸,2650,130,4,2,6,66.7%,1h
16045,2,虫群之主,2650,136,4,7,11,36.4%,1h
16045,1,[暴雪五队]square,2650,92,2,1,3,66.7%,23m
16045,3,阿立给爷爬,2650,0,2,3,5,40.0%,34m
16045,1,星际世界,2650,71,2,5,7,28.6%,16m
16045,1,杨晏,2650,0,1,1,2,50.0%,1h
16045,1,raynish,2650,89,1,2,3,33.3%,29m
16045,2,[狂风暴风雨]顾小志,2650,0,0,1,1,0.0%,8m
16064,1,[鸡会友狗服人]chenyongboy,2649,1512,356,366,722,49.3%,10m
16064,1,zyhunter,2649,1562,93,91,184,50.5%,1h
16064,1,[式神]卖萌的魔方,2649,1132,85,74,159,53.5%,37m
16064,2,蹦霸尔波,2649,1370,66,71,137,48.2%,25m
16064,1,[CPT]不雷斯,2649,282,9,10,19,47.4%,44m
16064,1,单调涂鸦,2649,210,7,9,16,43.8%,15m
16064,3,etccc,2649,133,6,1,7,85.7%,27m
16064,1,[小狗赛高]鸡弟遭到公鸡,2649,204,6,11,17,35.3%,3m
16064,1,崇明,2649,46,4,7,11,36.4%,33m
16064,1,艾米莉亚,2649,141,3,2,5,60.0%,24m
16064,2,我菜我骄傲,2649,94,3,2,5,60.0%,1h
16064,3,Joka,2649,0,3,2,5,60.0%,27m
16064,3,IMPBlade,2649,0,2,3,5,40.0%,1h
16064,3,时倾丶王若男,2649,0,2,3,5,40.0%,1h
16064,1,八月,2649,64,2,4,6,33.3%,46m
16064,3,LEO,2649,0,2,4,6,33.3%,1h
16064,1,凉城依稀,2649,0,1,1,2,50.0%,1h
16064,1,boy,2649,0,1,1,2,50.0%,53m
16064,1,游蛇出海,2649,0,1,2,3,33.3%,1h
16064,2,kdfpa,2649,0,0,2,2,0.0%,1h
16064,1,逃避,2649,0,0,3,3,0.0%,46m
16085,1,[KO]SCGHOST,2648,1030,70,68,138,50.7%,5m
16085,1,[潮人]我擦,2648,1455,51,51,102,50.0%,34m
16085,1,[哔翻天梯鸡]盖世垃圾,2648,1211,48,41,89,53.9%,55m
16085,1,hkbhkb,2648,594,23,20,43,53.5%,1h
16085,1,IVANSSS,2648,417,17,17,34,50.0%,29m
16085,1,小张贝贝,2648,234,8,11,19,42.1%,51m
16085,1,leonero,2648,255,7,8,15,46.7%,19m
16085,1,[秋千千秋]lavender,2648,222,7,9,16,43.8%,16m
16085,1,这也在你计划中吗,2648,161,4,4,8,50.0%,52m
16085,3,[鱼板船锚]湊阿库娅,2648,169,4,5,9,44.4%,13m
16085,1,谐星要塞,2648,159,3,3,6,50.0%,4m
16085,3,[金枪手徐宁]Crazy,2648,38,2,0,2,100.0%,1h
16085,2,天使之缘,2648,58,2,1,3,66.7%,17m
16085,3,[MFJ]BQihead,2648,0,2,3,5,40.0%,10m
16085,2,scxjz,2648,0,1,0,1,100.0%,1h
16085,2,[NLYH]peter,2648,0,1,1,2,50.0%,7m
16085,3,[YMSB]飞啦小猪人,2648,0,1,3,4,25.0%,22m
16085,2,Jotaro,2648,0,0,1,1,0.0%,47m
16085,1,白仁一少林捂裆派,2648,0,0,3,3,0.0%,1h
16085,2,[综合酯法]KasuganoSora,2648,0,0,5,5,0.0%,47m
16085,2,tianzhiyi,2648,0,0,5,5,0.0%,27m
16106,1,瞎子不配打星际,2647,1002,58,51,109,53.2%,29m
16106,1,Wuno,2647,844,28,48,76,36.8%,12m
16106,3,[暗黑幻想]手速一飙八十八,2647,322,14,18,32,43.8%,50m
16106,1,Prismriver,2647,354,11,13,24,45.8%,45m
16106,1,队友都是铁废物,2647,274,9,11,20,45.0%,1h
16106,3,ghostswallow,2647,235,7,15,22,31.8%,28m
16106,3,炽昼微凉,2647,0,2,2,4,50.0%,1h
16106,2,Beatrice,2647,60,2,3,5,40.0%,8m
16106,1,Newhand,2647,40,2,3,5,40.0%,36m
16106,2,[火焰雷兽]skzhujin,2647,0,1,0,1,100.0%,46m
16106,3,无事忙,2647,0,1,0,1,100.0%,1h
16106,1,[鬼谷]Tianzai,2647,0,0,2,2,0.0%,57m
16106,1,[生物即是正义]佐手牵鼬手,2647,0,0,2,2,0.0%,1h
16119,2,[Rhusky]Shino,2646,1522,86,75,161,53.4%,38m
16119,2,[发扬中国文化]将军杨,2646,535,21,12,33,63.6%,1h
16119,2,[情谊至上]臭八八,2646,240,9,1,10,90.0%,47m
16119,1,[只会莽夫]山风几木,2646,185,8,8,16,50.0%,1h
16119,2,newbird,2646,122,7,11,18,38.9%,9m
16119,3,爱民如子乔弗里,2646,0,3,2,5,60.0%,53m
16119,1,[Beasty]道外流牙,2646,0,3,6,9,33.3%,18m
16119,3,[EOS]新手电脑,2646,0,2,4,6,33.3%,50m
16119,2,[Rhusky]ANKH,2646,0,1,0,1,100.0%,4m
16119,1,Chenb,2646,0,1,0,1,100.0%,31m
16119,1,nitai,2646,0,1,1,2,50.0%,48m
16119,1,白翼,2646,0,1,1,2,50.0%,11m
16119,3,自在极意功孙悟空,2646,0,0,1,1,0.0%,4m
16119,2,大虫天下,2646,0,0,1,1,0.0%,1h
16119,1,[笑笑]笑笑不说话,2646,0,0,3,3,0.0%,21m
16134,1,三嗦螺丝,2645,1554,210,204,414,50.7%,38m
16134,2,仲天骐夏之星,2645,1601,166,156,322,51.6%,44m
16134,1,YXXL,2645,942,92,78,170,54.1%,16m
16134,1,无人与我书半生,2645,538,65,53,118,55.1%,57m
16134,1,llllllllllll,2645,1488,55,61,116,47.4%,43m
16134,1,PIPIPIGD,2645,854,31,30,61,50.8%,1h
16134,1,学霸你要去哪里啊,2645,699,30,25,55,54.5%,39m
16134,3,吴主任,2645,372,22,26,48,45.8%,28m
16134,2,苏九,2645,444,21,3,24,87.5%,9m
16134,1,雨中漫步,2645,480,20,19,39,51.3%,1h
16134,1,[XXHZN1]方十里,2645,448,18,15,33,54.5%,1h
16134,1,[萌思课帝国]LikeSnowing,2645,406,14,15,29,48.3%,22m
16134,1,胖即是胖,2645,230,7,10,17,41.2%,55m
16134,2,RSAQ,2645,160,6,7,13,46.2%,1h
16134,3,[银河联邦舰队]救世主,2645,180,6,13,19,31.6%,6m
16134,1,[教父遇刺]BISU,2645,138,5,5,10,50.0%,1h
16134,3,[瘾大眼瞎]唐诗,2645,211,5,16,21,23.8%,26m
16134,1,IIIIIIIIIIII,2645,160,4,4,8,50.0%,23m
16134,1,[一个军的兵力]来呀崽子,2645,160,3,2,5,60.0%,18m
16134,1,阿毛叔,2645,146,3,4,7,42.9%,1h
16134,1,黎明,2645,76,3,5,8,37.5%,46m
16134,3,[YA]Kvold,2645,0,2,3,5,40.0%,1h
16134,1,无限,2645,40,2,3,5,40.0%,34m
16134,1,jerrymo,2645,72,2,4,6,33.3%,1h
16134,2,YTYTYT,2645,30,2,7,9,22.2%,8m
16134,2,[大同styl]afuk,2645,0,1,0,1,100.0%,46m
16134,2,亚特鲁,2645,0,1,1,2,50.0%,1h
16134,2,[金城江二中]大攻无私,2645,18,1,2,3,33.3%,1h
16134,2,苯巴比,2645,32,1,2,3,33.3%,47m
16134,1,神抖抖,2645,88,1,3,4,25.0%,29m
16134,2,冰霜之狗,2645,34,1,3,4,25.0%,4m
16134,2,望咩,2645,0,0,1,1,0.0%,44m
16134,3,皓月,2645,0,0,1,1,0.0%,49m
16134,1,Messi,2645,0,0,2,2,0.0%,1h
16134,1,浪无夜极星,2645,0,0,2,2,0.0%,1h
16169,1,kpkiss,2644,1378,98,89,187,52.4%,12m
16169,3,[火焰雷兽]豫竹方便面,2644,1402,65,70,135,48.1%,23m
16169,2,[洛水天依]卡拉是条狗,2644,660,40,40,80,50.0%,17m
16169,1,[鲁德欢]虚空来客,2644,887,32,28,60,53.3%,37m
16169,1,只会安装不会玩儿,2644,788,27,28,55,49.1%,1h
16169,2,垣根帝督,2644,413,22,7,29,75.9%,1h
16169,3,小猪乔治,2644,455,18,23,41,43.9%,27m
16169,1,[Hdl]Night,2644,247,17,8,25,68.0%,22m
16169,1,快练出来了,2644,142,7,11,18,38.9%,16m
16169,3,LOSTER,2644,172,7,12,19,36.8%,6m
16169,2,[秋毫第七分队]鸟哥开山大弟子,2644,166,5,1,6,83.3%,14m
16169,2,[神武骑士团]东皇阁下,2644,86,4,0,4,100.0%,56m
16169,2,噶姐的迷弟,2644,86,3,2,5,60.0%,1h
16169,2,[社交学超可爱]llllllllllll,2644,106,2,1,3,66.7%,1h
16169,3,小狂孩儿,2644,0,2,3,5,40.0%,1h
16169,3,驴哥,2644,0,2,3,5,40.0%,4m
16169,1,[Dracoi]sqrtthree,2644,32,2,6,8,25.0%,57m
16169,2,榴莲奶糖,2644,0,1,0,1,100.0%,1h
16169,2,BoyGaYo,2644,0,1,0,1,100.0%,8m
16169,2,反派较色,2644,0,1,0,1,100.0%,1h
16169,1,hxzz,2644,0,0,3,3,0.0%,19m
16190,3,终结者,2643,1101,46,41,87,52.9%,7m
16190,2,[白门楼拆迁组]好奇,2643,1051,41,46,87,47.1%,7m
16190,1,[HAOREN]勇士,2643,569,29,22,51,56.9%,22m
16190,3,llllllllllll,2643,720,27,26,53,50.9%,29m
16190,1,sdadasd,2643,575,24,24,48,50.0%,1h
16190,2,[水晶的眼泪]练家子,2643,392,15,13,28,53.6%,29m
16190,1,queenbee,2643,272,11,16,27,40.7%,39m
16190,3,夜袭蜗牛,2643,279,11,17,28,39.3%,7m
16190,2,杜威特校长,2643,248,10,6,16,62.5%,49m
16190,1,[爱之信仰]不一样的男人丶,2643,266,9,12,21,42.9%,33m
16190,2,[葛温王下骑士]正义的伙伴,2643,228,8,2,10,80.0%,36m
16190,1,Lovely,2643,122,4,8,12,33.3%,46m
16190,3,瘟疫之神,2643,153,3,2,5,60.0%,22m
16190,3,Sumrem,2643,97,3,2,5,60.0%,5m
16190,1,[哟哟哟]哟怎么哭了,2643,36,3,5,8,37.5%,48m
16190,2,[你的剑很美]本毒物,2643,102,3,5,8,37.5%,7m
16190,2,wine,2643,30,2,0,2,100.0%,1h
16190,2,Martin,2643,0,2,3,5,40.0%,1h
16190,3,汉卿足够温柔,2643,0,2,4,6,33.3%,1h
16190,3,MuSE,2643,0,1,0,1,100.0%,7m
16190,2,[OB丶]略略略,2643,0,1,1,2,50.0%,1h
16211,2,金将军,2642,1504,163,164,327,49.8%,21m
16211,1,[舰队训练营]孙逸枫,2642,797,72,51,123,58.5%,53m
16211,2,快叫爸爸,2642,980,52,49,101,51.5%,47m
16211,3,[五月花]DYDY,2642,1213,50,59,109,45.9%,8m
16211,2,Devilhunter,2642,671,31,36,67,46.3%,27m
16211,1,魔杀丶昊,2642,304,18,16,34,52.9%,1h
16211,2,[ljk]白小纯,2642,403,15,10,25,60.0%,9m
16211,2,DDJNeric,2642,320,14,19,33,42.4%,1h
16211,1,jack,2642,289,10,11,21,47.6%,33m
16211,3,我小子帅哥,2642,187,6,8,14,42.9%,16m
16211,2,枣阳孙一峰,2642,46,5,6,11,45.5%,1h
16211,1,易水之名,2642,142,4,8,12,33.3%,1h
16211,1,偷不成就投,2642,96,4,9,13,30.8%,21m
16211,1,[社交学小可爱]Together,2642,89,2,1,3,66.7%,21m
16211,1,星际云玩家,2642,38,2,3,5,40.0%,22m
16211,2,砍三刀,2642,0,1,0,1,100.0%,22m
16211,2,IIIIIIIIII,2642,0,1,0,1,100.0%,1h
16211,1,VoidMan,2642,30,1,4,5,20.0%,36m
16211,2,[大鸟]除膜道人,2642,0,0,1,1,0.0%,18m
16211,3,[守夜]枕边男友,2642,0,0,1,1,0.0%,44m
16211,2,[七里香的花海]神绮,2642,0,0,2,2,0.0%,57m
16232,2,[SC2战队]浪子无悔,2641,717,142,139,281,50.5%,11m
16232,3,[CPT]Magicterrani,2641,1591,122,109,231,52.8%,16m
16232,3,该用户不存在的,2641,1356,91,85,176,51.7%,29m
16232,2,[暴雪我是你爹]神龙大侠,2641,1590,90,84,174,51.7%,1h
16232,1,ciel,2641,968,89,90,179,49.7%,29m
16232,1,九命,2641,1005,69,51,120,57.5%,1h
16232,3,thelittle,2641,900,50,45,95,52.6%,17m
16232,1,alibaba,2641,351,27,23,50,54.0%,34m
16232,3,王小秋,2641,346,15,13,28,53.6%,11m
16232,1,[OUO]Shine,2641,286,13,15,28,46.4%,47m
16232,2,[Fe3o4]愿人类荣光永存,2641,354,12,9,21,57.1%,1h
16232,1,羲哥不要,2641,370,11,15,26,42.3%,57m
16232,1,[琴筝]IIIIIIIIIIII,2641,259,9,5,14,64.3%,47m
16232,2,sugarhe,2641,136,6,3,9,66.7%,37m
16232,2,[DMR]二旬不过你,2641,144,6,4,10,60.0%,49m
16232,1,[华科大]keepersecond,2641,109,6,7,13,46.2%,37m
16232,2,养乐多,2641,193,6,8,14,42.9%,1h
16232,2,[化学工厂]wwzz,2641,132,5,5,10,50.0%,15m
16232,2,空归不管旁人说,2641,154,5,7,12,41.7%,1h
16232,2,[七咕咕]Ulysses,2641,150,4,1,5,80.0%,8m
16232,1,七代加藤鹰,2641,202,4,4,8,50.0%,18m
16232,1,在下狄某,2641,0,3,5,8,37.5%,1h
16232,1,[狼牙盟]ICEY,2641,74,3,6,9,33.3%,21m
16232,3,家住迪拜,2641,0,2,3,5,40.0%,10m
16232,3,[雷霆半月斩]流觞,2641,0,2,4,6,33.3%,27m
16232,2,rdys,2641,0,0,1,1,0.0%,1h
16232,2,[混吃混喝]Jerry,2641,0,0,1,1,0.0%,46m
16232,2,大鹏飞起,2641,0,0,2,2,0.0%,1h
16260,3,追后天十,2640,1567,170,166,336,50.6%,18m
16260,3,[斯大林保卫战]小唐,2640,1492,95,82,177,53.7%,16m
16260,2,[暴雪我是你爹]GGnoRE,2640,246,10,15,25,40.0%,22m
16260,1,自无風之明日,2640,195,9,11,20,45.0%,15m
16260,3,甲壳布,2640,149,4,5,9,44.4%,18m
16260,3,海上升明月,2640,121,3,4,7,42.9%,1h
16260,2,盛春林,2640,0,3,4,7,42.9%,16m
16260,2,[WT]sPark,2640,30,2,0,2,100.0%,1h
16260,2,HaiLuenNa,2640,30,2,1,3,66.7%,9m
16260,2,炮灰,2640,30,2,1,3,66.7%,8m
16260,2,巨像能对空,2640,58,2,2,4,50.0%,8m
16260,1,Sonny,2640,32,2,3,5,40.0%,1h
16260,3,[下船了大主教]FIRE,2640,0,1,3,4,25.0%,1h
16260,2,[手残党那么好]我快解放,2640,0,0,1,1,0.0%,1h
16260,2,abclll,2640,0,0,1,1,0.0%,32m
16275,1,[不灭青铜]波粒二,2639,1617,145,135,280,51.8%,1h
16275,3,[暴雪二十六队]只玩神族的新人,2639,1309,116,114,230,50.4%,26m
16275,2,一个小人物,2639,1638,100,85,185,54.1%,1h
16275,3,IGJACKlove,2639,1393,92,98,190,48.4%,16m
16275,1,[嘤嘤嘤啊]光芒,2639,1093,63,42,105,60.0%,1h
16275,2,[TZJ]LaoYang,2639,240,36,45,81,44.4%,4m
16275,1,draco,2639,1004,31,52,83,37.3%,10m
16275,2,諸位的萌王,2639,703,29,17,46,63.0%,1h
16275,2,[虚拟歌手团体]Goldwatch,2639,747,29,22,51,56.9%,1h
16275,1,她听着他说话,2639,246,20,14,34,58.8%,23m
16275,2,Stevte,2639,307,12,4,16,75.0%,7m
16275,3,Jerry,2639,258,10,12,22,45.5%,15m
16275,2,[听山雨欲来]诸葛村夫,2639,207,7,5,12,58.3%,7m
16275,2,PVvvv,2639,168,6,9,15,40.0%,59m
16275,3,刘老三,2639,225,6,12,18,33.3%,18m
16275,2,架完坦克投枪兵,2639,196,6,18,24,25.0%,23m
16275,1,汝父在此,2639,114,3,1,4,75.0%,36m
16275,1,[冒险者谐会]长沙孙一峰,2639,136,3,3,6,50.0%,1h
16275,1,[LKJ789]坏坏的小猪,2639,64,3,6,9,33.3%,45m
16275,2,发育狂,2639,30,2,0,2,100.0%,1h
16275,3,[菜鸡球带]TOM,2639,121,2,1,3,66.7%,1h
16275,3,小芒果,2639,0,2,3,5,40.0%,1h
16275,3,雅格威尔,2639,0,2,3,5,40.0%,1h
16298,1,摔烂的西瓜,2638,815,51,49,100,51.0%,21m
16298,1,[慢手e族]过来我给你说,2638,776,26,30,56,46.4%,43m
16298,1,[XXHZ30]下岗的屠户,2638,638,22,22,44,50.0%,48m
16298,1,折折折折折,2638,359,11,12,23,47.8%,39m
16298,2,ookk,2638,226,9,7,16,56.2%,17m
16298,2,你还真是个天才,2638,184,8,5,13,61.5%,1h
16298,1,Danger,2638,194,7,8,15,46.7%,22m
16298,2,BWL,2638,142,5,3,8,62.5%,7m
16298,1,JinYukihira,2638,167,5,4,9,55.6%,1h
16298,1,Lucky,2638,108,4,5,9,44.4%,22m
16298,2,jiuewang,2638,68,2,2,4,50.0%,47m
16298,2,FRannnnnnnNK,2638,0,2,5,7,28.6%,18m
16298,2,[星之所在RI]古明地云毅,2638,0,1,1,2,50.0%,1h
16298,3,阿巴怪,2638,0,1,1,2,50.0%,5m
16298,2,syw,2638,0,0,1,1,0.0%,1h
16298,2,新之助,2638,0,0,2,2,0.0%,9m
16314,2,nDaye,2637,1612,109,83,192,56.8%,1h
16314,1,老东西,2637,1390,93,88,181,51.4%,39m
16314,3,[31CM]风暴机枪兵,2637,1505,55,58,113,48.7%,16m
16314,1,上官同学,2637,1163,51,47,98,52.0%,57m
16314,2,[最菜战队]一边甩飞龙一边哭,2637,316,11,10,21,52.4%,47m
16314,1,落心之痕,2637,269,8,9,17,47.1%,31m
16314,2,仙男,2637,172,6,2,8,75.0%,38m
16314,2,[歌者II]茗翎之媛,2637,186,5,7,12,41.7%,13m
16314,2,[九尾]mooncowboy,2637,90,4,1,5,80.0%,1h
16314,1,[狼与羊]大白猪,2637,140,4,3,7,57.1%,19m
16314,2,[江城十三少]后羿射日,2637,114,4,6,10,40.0%,1h
16314,2,creepsama,2637,32,2,0,2,100.0%,32m
16314,2,[内蒙星际联盟]不讲武德年轻人,2637,58,2,2,4,50.0%,4m
16314,3,掠影,2637,0,2,2,4,50.0%,1h
16314,3,monoty,2637,0,2,3,5,40.0%,60m
16314,3,小屁孩,2637,38,2,5,7,28.6%,1h
16314,1,[火焰雷兽]oily,2637,64,2,5,7,28.6%,45m
16314,2,[天作之合]爱你不是两三天,2637,0,1,1,2,50.0%,1h
16314,2,[皇族]Foucs,2637,28,1,3,4,25.0%,31m
16314,3,[萌物狩猎者]諾森德,2637,0,0,1,1,0.0%,1h
16314,2,Zxl,2637,0,0,1,1,0.0%,1h
16335,1,[慢手e族]麝烟,2636,1627,136,122,258,52.7%,39m
16335,3,[战火PMC]烽火,2636,505,49,35,84,58.3%,16m
16335,1,街头赛跑,2636,632,29,15,44,65.9%,15m
16335,1,子沐淼,2636,580,23,19,42,54.8%,1h
16335,3,雪狼小飞,2636,403,23,29,52,44.2%,16m
16335,2,仗剑天涯,2636,263,15,13,28,53.6%,1h
16335,1,[我笑你阿巴阿]帅哥来了,2636,300,12,7,19,63.2%,23m
16335,1,[中华兄弟会]李永浩,2636,226,11,5,16,68.8%,47m
16335,2,Anqui,2636,314,11,8,19,57.9%,8m
16335,2,[全国修车]flydragon,2636,200,8,4,12,66.7%,49m
16335,1,Keenan,2636,260,7,8,15,46.7%,1h
16335,2,也是骚啊,2636,226,7,8,15,46.7%,14m
16335,1,左右田,2636,0,2,2,4,50.0%,1h
16335,1,秋丶風,2636,0,2,3,5,40.0%,8m
16335,2,大主教艾尔停电了,2636,96,2,3,5,40.0%,1h
16335,2,残影战魂,2636,0,1,0,1,100.0%,1h
16335,2,我在搞毛啊,2636,0,1,0,1,100.0%,4m
16335,3,Fallndown,2636,97,1,1,2,50.0%,7m
16335,1,迷茫,2636,0,1,3,4,25.0%,18m
16335,2,[东京小泽玛利]孙马茹,2636,0,0,1,1,0.0%,36m
16335,2,贤狼之诗,2636,0,0,1,1,0.0%,1h
16335,2,PaulGeorge,2636,0,0,1,1,0.0%,1h
16335,2,kqq,2636,0,0,1,1,0.0%,10m
16335,3,密奕,2636,0,0,1,1,0.0%,22m
16335,1,[菜鸡球带]黑王进军,2636,0,0,4,4,0.0%,53m
16360,2,MMYW,2635,456,45,32,77,58.4%,37m
16360,1,打不过就是不够多,2635,198,7,8,15,46.7%,57m
16360,2,IIIIIIIIII,2635,168,5,1,6,83.3%,14m
16360,3,人族的觉醒,2635,178,5,5,10,50.0%,5m
16360,2,[未来穗香]普陀谢广坤,2635,60,3,2,5,60.0%,56m
16360,3,[萝莉球]一看就是萌新,2635,38,3,4,7,42.9%,1h
16360,1,枯萎之壤,2635,0,3,5,8,37.5%,1h
16360,1,bigPiggy,2635,0,3,6,9,33.3%,1h
16360,3,[KZFANS]Wolfkisser,2635,0,2,4,6,33.3%,42m
16360,2,YrPissca,2635,0,1,0,1,100.0%,47m
16360,2,焱丶寒,2635,0,1,0,1,100.0%,1h
16360,2,personate,2635,38,1,1,2,50.0%,10m
16360,3,闲心,2635,38,1,1,2,50.0%,1h
16360,2,开学也要打游戏,2635,0,1,1,2,50.0%,37m
16360,2,[星歌]智勇双全秋风瑟,2635,0,0,1,1,0.0%,38m
16360,2,KSSK,2635,0,0,2,2,0.0%,1h
16360,1,[江南星际]fell,2635,0,0,5,5,0.0%,45m
16377,1,孙悟空的吊毛,2634,1202,51,37,88,58.0%,1h
16377,2,ncnbboy,2634,1176,48,37,85,56.5%,22m
16377,1,总想玩世不恭,2634,771,35,32,67,52.2%,1h
16377,1,陌欢,2634,413,21,9,30,70.0%,1h
16377,2,靠谱的红秋裤,2634,392,14,10,24,58.3%,34m
16377,1,[斧头帮OL]封魔,2634,379,13,12,25,52.0%,37m
16377,1,Astral,2634,257,9,9,18,50.0%,48m
16377,1,[五年二班]藤原文太,2634,175,7,12,19,36.8%,1h
16377,2,地表的宁静,2634,181,6,8,14,42.9%,1h
16377,1,[暴雪十二队]SeanGuo,2634,208,5,8,13,38.5%,48m
16377,2,今晚打老虎,2634,0,4,1,5,80.0%,9m
16377,2,下手轻点,2634,119,4,3,7,57.1%,57m
16377,1,icoke,2634,128,4,7,11,36.4%,23m
16377,1,victory,2634,0,3,2,5,60.0%,6m
16377,2,[菜有菜的道理]这游戏就离谱,2634,58,2,1,3,66.7%,1h
16377,2,[末世纪]无敌舰队,2634,0,1,0,1,100.0%,38m
16377,2,byunfan,2634,0,1,2,3,33.3%,1h
16394,3,邪蓝,2633,867,166,166,332,50.0%,48m
16394,2,[黄金战队]洛殿,2633,1573,75,65,140,53.6%,4m
16394,2,八意咏琳,2633,238,36,35,71,50.7%,1h
16394,1,[FsA]FsAxBurner,2633,695,30,28,58,51.7%,5m
16394,2,来搞基来搞基,2633,541,23,12,35,65.7%,1h
16394,1,changling,2633,310,23,17,40,57.5%,57m
16394,2,[GNMS]Maru,2633,511,20,30,50,40.0%,6m
16394,2,[阿斯塔特]黄金马桶上的干尸,2633,430,15,18,33,45.5%,1h
16394,3,Doug,2633,335,12,12,24,50.0%,1h
16394,1,人间不值得,2633,408,11,14,25,44.0%,57m
16394,1,priority,2633,270,10,8,18,55.6%,1h
16394,3,CFQ,2633,281,10,10,20,50.0%,17m
16394,2,glgjssy,2633,148,6,4,10,60.0%,1h
16394,2,汉尼拔河丶,2633,182,6,5,11,54.5%,23m
16394,1,Ramstein,2633,168,6,9,15,40.0%,38m
16394,2,hhq,2633,136,5,5,10,50.0%,57m
16394,1,Tamis,2633,0,4,1,5,80.0%,35m
16394,2,按兵不动,2633,140,4,6,10,40.0%,1h
16394,1,说声我爱你,2633,108,4,7,11,36.4%,53m
16394,2,[SC2战队]Deamehotl,2633,62,3,1,4,75.0%,60m
16394,1,吉格,2633,74,3,4,7,42.9%,22m
16394,1,熊二,2633,157,3,4,7,42.9%,1h
16394,1,小萌新,2633,75,3,7,10,30.0%,57m
16394,2,common,2633,30,2,0,2,100.0%,1h
16394,1,退休的阿斯塔特,2633,0,2,3,5,40.0%,9m
16394,1,RitaVrataski,2633,0,2,3,5,40.0%,12m
16394,2,llllllllllll,2633,0,0,1,1,0.0%,57m
16394,2,人族菜狗,2633,0,0,1,1,0.0%,10m
16422,3,[飞雷神]超越神一般的存在,2632,413,99,92,191,51.8%,18m
16422,1,[违章建筑多多]燎原号,2632,1226,94,76,170,55.3%,55m
16422,2,IIIIIIIIIIII,2632,1238,85,78,163,52.1%,37m
16422,2,[AVICNB]DustWind,2632,1535,66,57,123,53.7%,17m
16422,3,咸鱼塘塘主,2632,1175,42,45,87,48.3%,28m
16422,3,霸气外漏,2632,724,38,30,68,55.9%,25m
16422,2,[极限菜鸟]梦无形心相伴,2632,546,25,9,34,73.5%,1h
16422,1,[人族最强近战]魔狱,2632,449,18,13,31,58.1%,1h
16422,2,子木,2632,394,14,13,27,51.9%,1h
16422,2,露娜,2632,304,11,5,16,68.8%,1h
16422,1,[嘤嘤嘤怪集合]绮月樱,2632,296,11,10,21,52.4%,1h
16422,3,公子丿扶苏,2632,241,11,13,24,45.8%,1h
16422,1,一不小心,2632,168,9,11,20,45.0%,1h
16422,1,[64]shaonianyzc,2632,217,7,4,11,63.6%,1h
16422,2,隔壁王教练,2632,192,6,5,11,54.5%,1h
16422,1,[自由朝鲜]人间芭比郭德纲,2632,168,5,5,10,50.0%,1h
16422,3,马化腾,2632,0,4,2,6,66.7%,49m
16422,1,堕天灬冰,2632,97,3,4,7,42.9%,57m
16422,1,典最,2632,0,2,3,5,40.0%,12m
16422,3,space,2632,0,2,4,6,33.3%,1h
16422,2,billblack,2632,0,1,0,1,100.0%,46m
16422,2,[刺蛇互助社团]MrShadaw,2632,40,1,2,3,33.3%,8m
16422,1,忍忍,2632,0,1,4,5,20.0%,1h
16422,2,EvilGeniusLJ,2632,0,0,1,1,0.0%,47m
16422,2,QUZUYER,2632,0,0,1,1,0.0%,7m
16422,2,[南昌理工]雷诺游骑兵,2632,0,0,1,1,0.0%,57m
16422,1,回荡山谷,2632,0,0,5,5,0.0%,4m
16449,3,[白丝萝莉赛高]犬走椛,2631,1349,72,79,151,47.7%,11m
16449,1,阿萨大雪糕,2631,1286,62,59,121,51.2%,45m
16449,1,[LFY]南皇,2631,657,34,26,60,56.7%,22m
16449,2,[神圣的大佐]tangxp,2631,531,21,14,35,60.0%,37m
16449,1,mmmm,2631,426,17,16,33,51.5%,46m
16449,1,魑魅魍魉,2631,244,13,8,21,61.9%,22m
16449,1,[MKZ]nightwalk,2631,400,13,14,27,48.1%,22m
16449,2,兰戈,2631,354,13,17,30,43.3%,1h
16449,1,小小锤子,2631,334,11,14,25,44.0%,33m
16449,1,剑藏,2631,197,7,9,16,43.8%,1h
16449,3,百里奚,2631,133,5,1,6,83.3%,22m
16449,1,[玛德治杖]小耗,2631,176,5,10,15,33.3%,37m
16449,3,stanan,2631,149,4,1,5,80.0%,1h
16449,1,亚克西,2631,146,4,9,13,30.8%,44m
16449,2,[铁血蓝军]直隶总督,2631,88,2,6,8,25.0%,46m
16449,2,粉红喵喵拳,2631,0,1,0,1,100.0%,38m
16449,2,[五月花]叨呵特尔,2631,0,1,0,1,100.0%,1h
16466,3,[鸽德]LAOFE,2630,581,47,40,87,54.0%,8m
16466,1,福音,2630,688,24,26,50,48.0%,1h
16466,1,左灯右转,2630,531,21,12,33,63.6%,53m
16466,3,[loveMM]king,2630,556,20,24,44,45.5%,16m
16466,2,[世界树]雾雨星月,2630,440,17,9,26,65.4%,7m
16466,1,Quartet,2630,468,14,18,32,43.8%,55m
16466,2,徐凤年,2630,361,13,14,27,48.1%,10m
16466,2,dghsb,2630,319,12,13,25,48.0%,17m
16466,2,虫族就无敌,2630,275,10,3,13,76.9%,17m
16466,2,哇灬金色传说,2630,158,6,5,11,54.5%,1h
16466,1,甲士,2630,204,5,6,11,45.5%,48m
16466,2,人菜瘾还大,2630,114,4,3,7,57.1%,56m
16466,2,凉拌见手青,2630,78,3,3,6,50.0%,27m
16466,2,[牌面]死神,2630,30,2,0,2,100.0%,9m
16466,2,Ghost,2630,46,2,3,5,40.0%,20m
16466,3,战场原黑仪,2630,97,1,1,2,50.0%,1h
16466,1,[JNFLS]MatthU,2630,0,1,2,3,33.3%,1h
16466,2,逆火,2630,30,1,2,3,33.3%,17m
16466,1,Sayes,2630,0,1,2,3,33.3%,57m
16466,1,菜悔,2630,0,0,1,1,0.0%,1h
16466,2,我超萌超可爱,2630,0,0,1,1,0.0%,27m
16487,3,[失去理智]Rewriter,2629,1204,109,98,207,52.7%,16m
16487,1,MUZI,2629,1664,107,99,206,51.9%,1h
16487,2,SCV,2629,1323,99,91,190,52.1%,35m
16487,1,[csuDMO]EllaDaiSuki,2629,1537,93,91,184,50.5%,1h
16487,1,IIIIIIIIIIII,2629,1309,82,75,157,52.2%,1h
16487,1,[PNC]Flauros,2629,1235,58,56,114,50.9%,5m
16487,1,MORIARTY,2629,1101,51,48,99,51.5%,45m
16487,1,YYYYYaMn,2629,656,39,41,80,48.8%,5m
16487,2,[GFA]沉心,2629,607,25,40,65,38.5%,23m
16487,3,若风,2629,356,15,17,32,46.9%,6m
16487,1,阳聪,2629,364,13,13,26,50.0%,57m
16487,2,Ian,2629,293,12,8,20,60.0%,47m
16487,1,[CyS]摩尔夸克,2629,316,11,10,21,52.4%,37m
16487,1,让我骚一下,2629,275,10,8,18,55.6%,1h
16487,1,哦不住,2629,274,7,11,18,38.9%,24m
16487,1,lllllllll,2629,162,6,7,13,46.2%,1h
16487,2,[苏维埃的缔造]落曼帝达,2629,135,4,7,11,36.4%,1h
16487,3,FallenAngels,2629,97,3,4,7,42.9%,1h
16487,3,零点一度,2629,40,3,5,8,37.5%,1h
16487,3,[圣光指引你]TAT,2629,96,2,0,2,100.0%,1h
16487,2,[六十六面]秦心,2629,58,2,2,4,50.0%,49m
16487,3,batman,2629,0,2,4,6,33.3%,1h
16487,2,[萌萌哒萌萌哒]jiangXD,2629,0,1,0,1,100.0%,8m
16487,1,[可可萝]老年人想打星际,2629,0,1,3,4,25.0%,1h
16487,1,予你星河,2629,0,1,3,4,25.0%,1h
16487,2,ByuN,2629,0,0,1,1,0.0%,1h
16487,2,[天羽不榖]Ender,2629,0,0,2,2,0.0%,57m
16514,1,ZJC,2628,1651,172,174,346,49.7%,53m
16514,1,工地少年与砖,2628,1482,59,55,114,51.8%,1h
16514,2,椿生,2628,606,31,18,49,63.3%,8m
16514,1,再见宋哈娜,2628,658,21,24,45,46.7%,20m
16514,3,[我勒个去]BearMonkey,2628,438,18,21,39,46.2%,7m
16514,1,卡古拉魅啊,2628,340,16,12,28,57.1%,15m
16514,2,半世清秋丶瑜,2628,422,16,13,29,55.2%,29m
16514,1,[AirRay]一顾一倾城丶,2628,306,11,9,20,55.0%,36m
16514,2,多回首,2628,290,9,16,25,36.0%,3m
16514,1,DARKness,2628,254,8,12,20,40.0%,53m
16514,1,会飞的猪,2628,174,7,10,17,41.2%,57m
16514,1,[夜弑]死神永生,2628,128,4,3,7,57.1%,36m
16514,3,[886]叫大哥,2628,133,4,5,9,44.4%,5m
16514,3,[比那名居地子]地子,2628,97,3,3,6,50.0%,39m
16514,1,[东京有点热]蟑螂恶霸,2628,0,3,5,8,37.5%,1h
16514,2,Ezio,2628,60,2,1,3,66.7%,48m
16514,3,[孙某人上天队]凌光之刻,2628,97,2,1,3,66.7%,1h
16514,2,同卵,2628,30,2,2,4,50.0%,1h
16514,1,kirito,2628,48,2,5,7,28.6%,15m
16514,2,[300勇士]宇宙最帅就是我,2628,0,1,2,3,33.3%,17m
16514,3,淡定枫辰,2628,0,1,2,3,33.3%,1h
16514,3,[三四]哾鱼,2628,30,1,8,9,11.1%,7m
16514,2,小凯,2628,0,0,1,1,0.0%,1h
16514,2,半泽,2628,0,0,2,2,0.0%,49m
16538,1,长白山,2627,1364,101,89,190,53.2%,47m
16538,1,要煤的叉叉,2627,1493,60,55,115,52.2%,38m
16538,3,[Beasty]冷冷的笑,2627,579,37,34,71,52.1%,27m
16538,1,倒下的白门楼,2627,905,34,33,67,50.7%,46m
16538,2,[Booldy]今天真热啊,2627,346,12,10,22,54.5%,31m
16538,2,jocksmath,2627,220,8,7,15,53.3%,1h
16538,2,information,2627,152,7,7,14,50.0%,1h
16538,2,暗神梦魇,2627,168,4,2,6,66.7%,1h
16538,2,冷酷的电脑,2627,114,4,3,7,57.1%,22m
16538,3,[优纪]栗子要举高高,2627,30,3,3,6,50.0%,27m
16538,1,HomeSandMan,2627,36,3,5,8,37.5%,46m
16538,3,BTyzy,2627,97,2,0,2,100.0%,1h
16538,2,狐狸狂吃芋头,2627,27,2,1,3,66.7%,15m
16538,1,岁月长情,2627,87,2,1,3,66.7%,19m
16538,1,点点提,2627,46,2,3,5,40.0%,7m
16538,1,做作,2627,0,2,3,5,40.0%,39m
16538,3,[国服坑货]天空境界,2627,97,2,4,6,33.3%,1h
16538,2,吹风煮雪,2627,38,1,1,2,50.0%,1h
16538,2,投了,2627,0,1,1,2,50.0%,1h
16538,2,dazzle,2627,30,1,2,3,33.3%,47m
16538,2,tom,2627,30,1,2,3,33.3%,1h
16538,2,[白给丶兄弟]一百,2627,30,1,2,3,33.3%,32m
16538,1,[莽夫苟熊]shiroe,2627,38,1,7,8,12.5%,1h
16538,2,ForCeNiKunGe,2627,0,0,1,1,0.0%,1h
16538,2,Maxwell,2627,0,0,1,1,0.0%,1h
16563,2,[啦啦俩萌]霍克斯,2626,935,47,53,100,47.0%,23m
16563,2,野狼侦察连,2626,510,37,17,54,68.5%,60m
16563,1,努力打打,2626,714,23,27,50,46.0%,30m
16563,2,凤凰圣主,2626,526,19,16,35,54.3%,8m
16563,3,[荣耀丶殿堂]心空之一,2626,304,18,25,43,41.9%,20m
16563,2,[FOV]正气凛然沈老贪,2626,242,9,8,17,52.9%,49m
16563,1,ABANDON,2626,253,7,8,15,46.7%,33m
16563,2,鄙人是个文化人,2626,208,6,4,10,60.0%,35m
16563,2,黎明之刃,2626,120,5,2,7,71.4%,8m
16563,2,AINI,2626,44,5,5,10,50.0%,47m
16563,1,[红萌馆]毒奶黄旭东丶,2626,204,5,6,11,45.5%,33m
16563,2,YumeKara,2626,152,4,1,5,80.0%,1h
16563,2,阿尼慕斯菲亚,2626,90,4,2,6,66.7%,22m
16563,2,[百宝箱]二二得六,2626,66,3,1,4,75.0%,4m
16563,1,天坑一号,2626,70,3,4,7,42.9%,17m
16563,1,[星歌]喜欢幽幽子的迪奥,2626,121,3,4,7,42.9%,3m
16563,1,三天打鱼,2626,0,3,5,8,37.5%,6m
16563,2,[o不死不休o]小丶麒,2626,58,2,1,3,66.7%,4m
16563,1,踏马玩就玩别笑我,2626,0,2,3,5,40.0%,1h
16563,2,Spike,2626,0,2,5,7,28.6%,15m
16563,2,Choice,2626,0,0,1,1,0.0%,1h
16563,2,devil,2626,0,0,1,1,0.0%,31m
16585,3,jeke,2625,1324,56,54,110,50.9%,27m
16585,3,[最菜战队]scp,2625,1273,48,55,103,46.6%,20m
16585,2,[教父遇刺]innovat,2625,1060,38,52,90,42.2%,14m
16585,2,提耶拉,2625,512,18,20,38,47.4%,1h
16585,2,[鸡烈]tossboy,2625,411,17,10,27,63.0%,4m
16585,1,[风暴领主]Colossus,2625,451,17,15,32,53.1%,1h
16585,2,中超传奇本泽马,2625,239,8,5,13,61.5%,1h
16585,2,韦小宝,2625,180,5,7,12,41.7%,57m
16585,2,IIIIIIIIIIII,2625,94,4,3,7,57.1%,8m
16585,2,舞挽歌,2625,136,3,1,4,75.0%,1h
16585,2,颂伊雪,2625,60,3,2,5,60.0%,31m
16585,1,SJH,2625,0,2,2,4,50.0%,58m
16585,1,springroll,2625,38,2,6,8,25.0%,1h
16585,1,喜文乐剑,2625,0,1,0,1,100.0%,1h
16585,2,[小鸡屠宰场a]righthm,2625,0,1,0,1,100.0%,8m
16585,2,NjxxDT,2625,0,0,1,1,0.0%,10m
16585,2,[Globus]无敌的骚一,2625,0,0,1,1,0.0%,1h
16585,2,光棱坦克,2625,0,0,1,1,0.0%,1h
16585,1,[Dirge丶]孤狼的挽歌,2625,0,0,1,1,0.0%,43m
16585,2,屠夫,2625,0,0,2,2,0.0%,1h
16585,2,[基础楼]时空佛,2625,0,0,3,3,0.0%,1h
16606,3,雪菜包子,2624,1045,148,146,294,50.3%,11m
16606,1,TNT,2624,1660,142,137,279,50.9%,1h
16606,1,JIKOFGJ,2624,1486,121,117,238,50.8%,17m
16606,2,[ToGT]Lothar,2624,1324,60,41,101,59.4%,33m
16606,1,DNA,2624,829,50,56,106,47.2%,1h
16606,2,甲板清洁工,2624,783,48,49,97,49.5%,27m
16606,1,大舰巨炮,2624,717,29,26,55,52.7%,1h
16606,2,IIIIIIIIIIII,2624,543,25,16,41,61.0%,17m
16606,2,萌新一个,2624,525,23,15,38,60.5%,57m
16606,1,ben,2624,288,16,19,35,45.7%,3m
16606,2,稻壳岛,2624,405,15,18,33,45.5%,1h
16606,3,小萌新,2624,346,15,18,33,45.5%,6m
16606,1,轩轩轩轩,2624,205,12,7,19,63.2%,17m
16606,1,[Xanxus]小迷雾,2624,283,10,15,25,40.0%,1h
16606,1,[鱼跃此时海]帅气的东升,2624,225,7,7,14,50.0%,22m
16606,1,三岁就很帅,2624,208,6,4,10,60.0%,1h
16606,3,菜鸡本鸡,2624,208,5,3,8,62.5%,1h
16606,2,故事止于盛夏,2624,157,5,6,11,45.5%,18m
16606,2,点点滴滴,2624,96,4,3,7,57.1%,1h
16606,2,旭东大仙,2624,88,3,3,6,50.0%,1h
16606,2,啸书神侠,2624,90,3,4,7,42.9%,1h
16606,1,隔壁老王找儿子,2624,0,2,2,4,50.0%,13m
16606,2,luo,2624,60,2,3,5,40.0%,29m
16606,1,清江河豚,2624,0,2,3,5,40.0%,19m
16606,1,兔知君,2624,34,2,4,6,33.3%,48m
16606,2,Zly,2624,143,2,4,6,33.3%,51m
16606,1,喜欢你波,2624,66,2,5,7,28.6%,48m
16606,2,我是一条鱼,2624,0,1,0,1,100.0%,1h
16606,2,[上帝的叹息]Sen,2624,0,1,1,2,50.0%,1h
16606,1,[大姐酒家]蛤蟆,2624,30,1,4,5,20.0%,1h
16606,1,少帮主,2624,38,1,5,6,16.7%,1h
16606,1,戈本,2624,97,1,6,7,14.3%,1h
16606,2,sdffds,2624,0,0,1,1,0.0%,8m
16606,2,[菜鸡球带]未见天的小黄瓜,2624,0,0,1,1,0.0%,1h
16640,3,[黑丝即是正义]羽灰琥珀,2623,1525,152,153,305,49.8%,19m
16640,1,林诺诺,2623,503,77,75,152,50.7%,22m
16640,1,[电竞人贩子]哭哭哭哭泣,2623,515,41,34,75,54.7%,37m
16640,1,传说的图图,2623,531,21,20,41,51.2%,1h
16640,1,丿就是我的锅彡,2623,225,9,6,15,60.0%,1h
16640,2,[SteEng]最恨萌新,2623,186,6,3,9,66.7%,10m
16640,1,Lair,2623,168,6,7,13,46.2%,1h
16640,3,刁蛮二娃,2623,97,5,2,7,71.4%,13m
16640,1,小菜鸟,2623,0,3,2,5,60.0%,1h
16640,1,微笑的橙子,2623,76,3,8,11,27.3%,53m
16640,1,名称不可用,2623,0,2,3,5,40.0%,1h
16640,1,WOLF,2623,36,2,4,6,33.3%,21m
16640,2,TEwager,2623,0,1,0,1,100.0%,57m
16640,1,Maxmix,2623,88,1,4,5,20.0%,1h
16640,3,胡米,2623,0,1,4,5,20.0%,1h
16640,2,[镜花水月丶]Antelope,2623,0,0,1,1,0.0%,1h
16640,2,[CPT]起名还是这么难,2623,0,0,1,1,0.0%,27m
16657,3,夜雪独行,2622,1571,193,198,391,49.4%,27m
16657,3,Capricorn,2622,1472,91,80,171,53.2%,29m
16657,1,CavalryID,2622,300,59,45,104,56.7%,46m
16657,1,[NKTJ]AIcup,2622,572,51,48,99,51.5%,58m
16657,3,Harry,2622,1222,48,55,103,46.6%,18m
16657,3,lixy,2622,231,26,31,57,45.6%,18m
16657,2,[CGA]战出一片天地,2622,208,8,8,16,50.0%,1h
16657,1,[地瓜护卫队]不会爆兵啊,2622,207,6,8,14,42.9%,1h
16657,1,[DDOS傲世]humanking,2622,74,2,6,8,25.0%,22m
16657,2,星际一点也不快乐,2622,0,1,0,1,100.0%,1h
16657,1,[SFTRA3]舔我高跟鞋,2622,34,1,5,6,16.7%,5m
16657,1,qweasdqwe,2622,0,0,3,3,0.0%,1h
16669,1,不不不不,2621,966,46,25,71,64.8%,58m
16669,1,vivilove,2621,970,41,31,72,56.9%,48m
16669,1,我是邪恶的男孩,2621,748,29,24,53,54.7%,58m
16669,1,[刺蛇女装协会]IIIIIIIIIIII,2621,405,20,26,46,43.5%,1h
16669,2,[风暴来袭]不二佐助,2621,210,8,7,15,53.3%,45m
16669,3,[败犬孙一喵]Bunny,2621,133,8,17,25,32.0%,48m
16669,2,冰冰冰,2621,274,7,11,18,38.9%,1h
16669,1,[小鸡屠宰场7]我没呼叫舰队,2621,94,6,7,13,46.2%,28m
16669,2,我真的不是条码人,2621,44,4,3,7,57.1%,1h
16669,1,羌笛何须怨杨柳,2621,128,4,10,14,28.6%,37m
16669,3,YogSothoth,2621,97,3,4,7,42.9%,5m
16669,2,[TGMM]HumanRozz,2621,116,3,5,8,37.5%,27m
16669,2,RichardLii,2621,36,2,0,2,100.0%,1h
16669,2,Nopppp,2621,30,2,2,4,50.0%,17m
16669,1,云千千纤,2621,46,2,3,5,40.0%,1h
16669,1,SDEAFV,2621,0,2,3,5,40.0%,4m
16669,1,糊你一脸,2621,0,2,3,5,40.0%,13m
16669,1,南有乔木,2621,0,2,3,5,40.0%,1h
16669,2,我是修修,2621,0,1,1,2,50.0%,1h
16669,2,崎岖,2621,0,1,1,2,50.0%,8m
16669,3,potatoluo,2621,40,1,2,3,33.3%,1h
16669,1,大鸡肉一二一三八,2621,0,1,3,4,25.0%,4m
16691,2,Dasansan,2620,938,35,33,68,51.5%,45m
16691,1,[哀叹无悔]QWE,2620,244,14,11,25,56.0%,1h
16691,1,小琅,2620,353,13,15,28,46.4%,1h
16691,3,晨曦之海,2620,306,12,21,33,36.4%,20m
16691,3,同流合污,2620,246,10,13,23,43.5%,1h
16691,2,Tenet,2620,240,9,3,12,75.0%,1h
16691,2,瑞神,2620,296,9,10,19,47.4%,51m
16691,3,时雨泠月,2620,97,5,1,6,83.3%,23m
16691,2,[黑暗葬送者]黑冥魂一幽灵魅,2620,0,4,3,7,57.1%,1h
16691,2,RkKkgy,2620,44,4,6,10,40.0%,1h
16691,2,TYTY,2620,145,4,6,10,40.0%,1h
16691,2,zero,2620,138,3,2,5,60.0%,15m
16691,3,Frances,2620,36,3,5,8,37.5%,1h
16691,1,[GD地狱伞兵]铁甲威龙,2620,120,3,7,10,30.0%,3m
16691,2,无产阶级劳动人民,2620,30,2,0,2,100.0%,35m
16691,2,石原里美前男友,2620,58,2,2,4,50.0%,48m
16691,1,呵呵,2620,0,2,3,5,40.0%,1h
16691,1,威末,2620,0,2,3,5,40.0%,20m
16691,3,糖醋排骨,2620,0,2,4,6,33.3%,1h
16691,1,RUIRONG,2620,0,1,2,3,33.3%,1h
16691,2,ESEgva,2620,30,1,3,4,25.0%,1h
16691,1,暗殇雀羽,2620,34,1,4,5,20.0%,7m
16691,2,[五月花]佐仓枫,2620,0,0,2,2,0.0%,14m
16691,2,[嘤嘤樱]克里斯蒂娜,2620,0,0,2,2,0.0%,46m
16715,2,[GaHo]劳力士迪通拿,2619,1487,128,124,252,50.8%,8m
16715,3,TedLandrover,2619,629,125,116,241,51.9%,7m
16715,2,犹豫就会败北,2619,1091,42,50,92,45.7%,50m
16715,1,BillKiller,2619,694,34,21,55,61.8%,39m
16715,1,mgeji,2619,784,29,29,58,50.0%,1h
16715,1,hhhcookie,2619,720,25,25,50,50.0%,23m
16715,1,star,2619,336,11,14,25,44.0%,1h
16715,1,跟着风去旅行,2619,232,10,9,19,52.6%,60m
16715,2,随便玩玩,2619,227,8,4,12,66.7%,1h
16715,2,Masterh,2619,162,7,5,12,58.3%,47m
16715,2,[文丑之考验]张小白,2619,200,7,6,13,53.8%,1h
16715,2,[僵尸博士牛X]小小饼干,2619,187,6,3,9,66.7%,23m
16715,2,iuhiuhuhuiih,2619,144,6,4,10,60.0%,49m
16715,1,[天国之魔]GGmoonlight,2619,192,5,5,10,50.0%,32m
16715,1,[博云星际学院]Heven,2619,138,4,8,12,33.3%,1h
16715,3,落花不闻,2619,0,3,3,6,50.0%,1h
16715,1,EDGclearlove,2619,0,2,1,3,66.7%,39m
16715,2,可爱毒爆喵,2619,0,1,0,1,100.0%,37m
16715,3,[净土]Bigsmoke,2619,0,1,0,1,100.0%,1h
16715,3,渡鱼,2619,97,1,1,2,50.0%,1h
16715,1,LIUNA,2619,40,1,5,6,16.7%,11m
16715,2,DInana,2619,0,0,1,1,0.0%,1h
16737,3,kkaiez,2618,1378,99,95,194,51.0%,23m
16737,1,riderkabuto,2618,263,44,39,83,53.0%,17m
16737,3,LaYs,2618,994,36,43,79,45.6%,23m
16737,1,[GOTAL]soviet,2618,797,32,32,64,50.0%,11m
16737,2,lntianxiunl,2618,688,27,20,47,57.4%,37m
16737,1,[SUSTC]孤独狼,2618,680,23,24,47,48.9%,1h
16737,2,ZEON,2618,218,21,21,42,50.0%,13m
16737,3,[加州室内装修]那个二五仔,2618,484,19,21,40,47.5%,25m
16737,2,打星际你快乐吗,2618,178,6,1,7,85.7%,37m
16737,1,[GAGA]梦魇,2618,209,6,4,10,60.0%,1h
16737,1,冻住不准洗澡,2618,112,3,9,12,25.0%,30m
16737,2,阿斯塔特修士,2618,30,2,3,5,40.0%,45m
16737,1,长予天,2618,0,2,3,5,40.0%,12m
16737,2,御前带刀小飘,2618,0,1,1,2,50.0%,47m
16737,3,侧耳倾听,2618,97,1,1,2,50.0%,44m
16737,1,NatureMZR,2618,90,1,3,4,25.0%,46m
16737,2,[突变攻略组]白球带冲锋,2618,30,1,3,4,25.0%,56m
16737,2,战斗警报,2618,0,0,2,2,0.0%,1h
16737,3,[拱火]InnoVation,2618,0,0,2,2,0.0%,1h
16737,2,Scrappy,2618,0,0,3,3,0.0%,1h
16757,3,alerck,2617,1077,75,76,151,49.7%,28m
16757,1,海狸叔,2617,767,50,43,93,53.8%,48m
16757,1,simmom,2617,927,31,31,62,50.0%,5m
16757,3,人们,2617,760,31,32,63,49.2%,17m
16757,2,青眼的白龙,2617,616,22,19,41,53.7%,18m
16757,2,凌幽,2617,610,20,31,51,39.2%,5m
16757,1,[剑舞的饭团]泥石大沙壁,2617,590,18,26,44,40.9%,58m
16757,3,[傲世丨听雨轩]CcBingo,2617,235,10,8,18,55.6%,1h
16757,1,粪坑之王,2617,358,10,12,22,45.5%,21m
16757,1,[CPT]夏恋花火,2617,227,9,7,16,56.2%,15m
16757,2,sore,2617,276,9,20,29,31.0%,13m
16757,2,Austen,2617,0,4,1,5,80.0%,46m
16757,2,melody,2617,0,1,0,1,100.0%,1h
16757,2,小有名气,2617,32,1,3,4,25.0%,22m
16757,3,llllllllllll,2617,0,0,1,1,0.0%,28m
16757,2,蟑螂恶霸,2617,0,0,1,1,0.0%,1h
16773,3,工业党人,2616,1023,59,54,113,52.2%,28m
16773,3,战歌号舰载机,2616,650,45,43,88,51.1%,49m
16773,3,薛定谔的猫,2616,689,40,28,68,58.8%,23m
16773,1,火蛋,2616,335,34,35,69,49.3%,53m
16773,2,zha,2616,286,18,9,27,66.7%,56m
16773,2,[老油条战队]偷撒一滴泪,2616,364,15,27,42,35.7%,13m
16773,1,色蓝,2616,440,14,21,35,40.0%,53m
16773,2,蓝色星系,2616,295,12,5,17,70.6%,1h
16773,1,[我们是瞎子]老鼠特工,2616,352,12,14,26,46.2%,3m
16773,2,雪域迷城,2616,178,10,8,18,55.6%,8m
16773,1,KAkoo,2616,244,9,9,18,50.0%,1h
16773,1,SKY,2616,194,7,6,13,53.8%,30m
16773,2,雷利乌斯,2616,204,7,8,15,46.7%,57m
16773,2,Fire,2616,162,5,1,6,83.3%,60m
16773,1,杰哥,2616,106,4,6,10,40.0%,38m
16773,1,下手要狠,2616,0,3,2,5,60.0%,1h
16773,2,[四叶草]xyxyxyxyxy,2616,30,1,2,3,33.3%,1h
16790,1,虫猛人秀神挨揍,2615,1659,364,359,723,50.3%,11m
16790,1,Ericle,2615,1195,119,110,229,52.0%,1h
16790,2,[XXG]jameshhy,2615,701,25,27,52,48.1%,1h
16790,2,Michael,2615,546,23,17,40,57.5%,18m
16790,2,FDSTFD,2615,354,12,29,41,29.3%,18m
16790,1,有事躺下说,2615,300,10,9,19,52.6%,23m
16790,2,[疾风前行]ZewZewr,2615,114,5,3,8,62.5%,1h
16790,3,lovelive,2615,97,4,2,6,66.7%,42m
16790,1,刺刀,2615,148,4,5,9,44.4%,16m
16790,1,[不堪一击]afters,2615,164,4,10,14,28.6%,60m
16790,2,颐养岣岣,2615,30,2,3,5,40.0%,47m
16790,1,沉默之风暴,2615,0,2,3,5,40.0%,55m
16790,2,[吊打虫族]明恋菲,2615,0,1,0,1,100.0%,1h
16790,1,[在下菜鸡一只]probe,2615,0,1,1,2,50.0%,1h
16790,2,[社交学巨可爱]投降吧少年,2615,38,1,2,3,33.3%,1h
16790,1,[社交学大可爱]小刀,2615,0,1,3,4,25.0%,15m
16790,2,小魍魉丶,2615,0,0,1,1,0.0%,1h
16807,1,sky,2614,1383,56,57,113,49.6%,12m
16807,1,乞龍,2614,1097,42,47,89,47.2%,44m
16807,2,lxl,2614,530,22,12,34,64.7%,1h
16807,2,[你的剑很美]chong,2614,236,20,6,26,76.9%,1h
16807,1,千乘草,2614,328,16,13,29,55.2%,15m
16807,2,[XXHZ31]丢钱小楠,2614,438,14,14,28,50.0%,1h
16807,1,wsssd,2614,340,11,14,25,44.0%,3m
16807,3,knightt,2614,231,11,19,30,36.7%,22m
16807,2,[最后的晚餐]Repartee,2614,259,10,4,14,71.4%,1h
16807,2,莪希醉厉嗐的异虫,2614,242,10,14,24,41.7%,51m
16807,1,喵喵在干啥,2614,313,9,12,21,42.9%,1h
16807,2,久安嘉禾,2614,219,8,4,12,66.7%,15m
16807,3,菜逼,2614,232,7,5,12,58.3%,25m
16807,2,吹梦到西洲,2614,154,6,1,7,85.7%,60m
16807,3,半醒,2614,70,6,9,15,40.0%,59m
16807,2,[LeyFon]镜花雪月,2614,182,5,3,8,62.5%,8m
16807,2,[AGE19]HoMuRa,2614,136,5,7,12,41.7%,1h
16807,1,一昔,2614,156,3,6,9,33.3%,53m
16807,2,[队花探姬]风渡人影剑渡天,2614,58,2,3,5,40.0%,1h
16807,1,断剑绝城,2614,0,2,3,5,40.0%,1h
16807,2,wdijan,2614,30,1,1,2,50.0%,1h
16807,2,[X英雄圣域X]开水王子,2614,0,1,1,2,50.0%,15m
16807,1,陈大力超给力,2614,38,1,6,7,14.3%,47m
16807,3,[光明正大]两营长,2614,0,0,1,1,0.0%,1h
16831,3,Michaela,2613,703,25,29,54,46.3%,7m
16831,1,杨先生生生生,2613,522,20,24,44,45.5%,1h
16831,1,[MZZ]周之华语,2613,461,16,15,31,51.6%,48m
16831,1,救赎大道,2613,348,13,11,24,54.2%,1h
16831,2,大哥的二五仔,2613,341,13,17,30,43.3%,7m
16831,1,尤柏森,2613,336,12,15,27,44.4%,29m
16831,1,[能量]granger,2613,256,9,12,21,42.9%,1h
16831,2,justwesossos,2613,220,8,9,17,47.1%,18m
16831,2,苍颜轻尘,2613,155,7,2,9,77.8%,60m
16831,3,空白,2613,96,7,13,20,35.0%,45m
16831,2,[瘾大眼瞎]LCFino,2613,138,4,1,5,80.0%,38m
16831,3,陆走走,2613,97,4,1,5,80.0%,50m
16831,1,ergoutou,2613,0,4,1,5,80.0%,55m
16831,2,lunnarain,2613,102,4,5,9,44.4%,35m
16831,3,[C32406]NacKle,2613,97,2,1,3,66.7%,1h
16831,1,邢道荣,2613,30,2,4,6,33.3%,53m
16831,1,洗心革面,2613,70,2,6,8,25.0%,23m
16831,3,北风丨之神,2613,0,1,0,1,100.0%,1h
16831,1,玛格基贾德诺,2613,0,1,3,4,25.0%,1h
16831,1,lbhxy,2613,96,1,5,6,16.7%,1h
16831,2,[圣天堂]超级超神,2613,0,0,1,1,0.0%,38m
16852,2,十二月的扶桑,2612,1504,284,285,569,49.9%,11m
16852,2,bcoodjk,2612,1053,41,38,79,51.9%,9m
16852,2,BBK,2612,944,32,44,76,42.1%,14m
16852,2,[牌面]JavBUS,2612,809,30,27,57,52.6%,17m
16852,2,小面包啃起来,2612,432,19,15,34,55.9%,49m
16852,1,[找虐]泽拉瑞斯大主教,2612,496,17,19,36,47.2%,30m
16852,1,人菜瘾大,2612,322,12,15,27,44.4%,16m
16852,3,snake,2612,219,10,9,19,52.6%,9m
16852,2,[西伯利亚土豆]卫卫,2612,208,8,19,27,29.6%,47m
16852,2,贰丶,2612,138,5,4,9,55.6%,1h
16852,2,happy,2612,164,4,3,7,57.1%,9m
16852,1,yfx,2612,150,4,12,16,25.0%,36m
16852,1,秋风萧瑟,2612,119,3,4,7,42.9%,1h
16852,1,[Ameno]Tsubaki,2612,0,2,2,4,50.0%,14m
16852,1,[冬马和纱]nightmare,2612,0,2,3,5,40.0%,1h
16852,1,空城天空,2612,0,2,3,5,40.0%,4m
16852,1,[暴雪三十二隊]哀伤,2612,40,2,5,7,28.6%,1h
16852,3,rooney,2612,97,1,2,3,33.3%,1h
16852,1,我爱黄沙飞,2612,40,1,7,8,12.5%,36m
16852,3,探姬历险记,2612,0,0,1,1,0.0%,1h
16852,2,[TSOD]掠夺者饿狼,2612,0,0,4,4,0.0%,1h
16873,1,玩吧,2611,1041,49,42,91,53.8%,16m
16873,2,wangnamu,2611,724,28,24,52,53.8%,32m
16873,2,算命先生,2611,560,23,12,35,65.7%,46m
16873,2,硫代硫酸钠,2611,410,19,12,31,61.3%,38m
16873,2,英胸,2611,453,17,10,27,63.0%,32m
16873,2,庞紫,2611,262,9,6,15,60.0%,27m
16873,2,[哀木涕]小虾米,2611,247,8,3,11,72.7%,1h
16873,2,[TCP]Lupo,2611,215,6,2,8,75.0%,1h
16873,1,Timmy,2611,83,4,4,8,50.0%,44m
16873,3,猫里奥,2611,129,4,5,9,44.4%,1h
16873,2,[卖丶烂铁皮]SKTZX,2611,30,2,1,3,66.7%,8m
16873,1,[人类联盟军]厌世,2611,0,2,2,4,50.0%,13m
16873,2,夜里声最烦,2611,46,2,3,5,40.0%,1h
16873,3,WAZ,2611,0,2,4,6,33.3%,5m
16873,2,[社交学小可爱]战狼,2611,0,1,0,1,100.0%,1h
16873,2,[是二五仔鸭]麦克雷,2611,88,1,3,4,25.0%,1h
16873,2,GREE,2611,30,1,3,4,25.0%,37m
16873,2,无情的咕咕机器,2611,0,0,4,4,0.0%,7m
16891,1,夜魔,2610,1504,88,76,164,53.7%,1h
16891,2,Alexah,2610,1272,80,71,151,53.0%,1h
16891,1,[练市中学]艾蒙的勇士,2610,1182,68,63,131,51.9%,1h
16891,2,[社交学教练]溺水的鱼,2610,806,31,28,59,52.5%,27m
16891,2,东东啊,2610,616,24,22,46,52.2%,1h
16891,3,[无能弱鸡低下]REG,2610,492,18,22,40,45.0%,24m
16891,2,Mmmilor,2610,488,17,14,31,54.8%,1h
16891,2,Dominic,2610,356,12,10,22,54.5%,1h
16891,2,DowsonCole,2610,270,12,12,24,50.0%,1h
16891,2,without,2610,300,10,7,17,58.8%,1h
16891,3,云之遥,2610,288,9,18,27,33.3%,49m
16891,2,[五月花]骚啊马飞啊,2610,154,6,0,6,100.0%,1h
16891,2,[LOHs]llllllllllll,2610,142,3,2,5,60.0%,7m
16891,2,懵猩,2610,30,2,0,2,100.0%,17m
16891,2,STORM,2610,30,2,0,2,100.0%,1h
16891,1,Star,2610,0,2,2,4,50.0%,9m
16891,1,[孤独与烈酒]朱盛辉,2610,0,1,1,2,50.0%,43m
16891,3,RANDOM,2610,0,0,1,1,0.0%,1h
16891,2,[Beasty]三体执政圣堂武士,2610,0,0,2,2,0.0%,49m
16891,1,达哥,2610,0,0,2,2,0.0%,9m
16891,2,[TSR]背心猪头怪,2610,0,0,3,3,0.0%,10m
16891,2,keduoli,2610,0,0,3,3,0.0%,1h
16913,2,Unicorn,2609,978,34,46,80,42.5%,5m
16913,2,[懒散]onlyone,2609,234,7,8,15,46.7%,25m
16913,1,VICTORIA,2609,206,7,11,18,38.9%,45m
16913,1,刀锋女王,2609,232,6,9,15,40.0%,36m
16913,1,[琴瑟和鸣]雨行,2609,202,6,9,15,40.0%,44m
16913,3,陌城,2609,36,4,4,8,50.0%,19m
16913,1,CrushLI,2609,102,4,6,10,40.0%,33m
16913,2,rare,2609,109,3,2,5,60.0%,15m
16913,2,我爱你中国,2609,60,3,4,7,42.9%,35m
16913,2,[HHHH]IlIlIlIlIlIl,2609,30,2,0,2,100.0%,48m
16913,2,Deadpool,2609,90,2,1,3,66.7%,31m
16913,1,Maru,2609,96,2,4,6,33.3%,23m
16913,2,BOD,2609,0,1,1,2,50.0%,15m
16913,1,[鬼谷]你敬爱的宁哥哥,2609,32,1,5,6,16.7%,20m
16913,2,可能否,2609,0,0,1,1,0.0%,10m
16913,2,[mmpTib]tomqaz,2609,0,0,2,2,0.0%,22m
16913,1,EWFIYF,2609,0,0,5,5,0.0%,20m
16930,2,wtxj,2608,855,32,32,64,50.0%,1h
16930,1,[孤单枪手]前尘不共彩云飞,2608,575,21,26,47,44.7%,21m
16930,2,[GSL联赛]Dimension,2608,457,18,12,30,60.0%,18m
16930,1,迷失光谱,2608,554,18,20,38,47.4%,1h
16930,2,CQLyq,2608,0,4,4,8,50.0%,1h
16930,1,七月十二猫,2608,234,4,8,12,33.3%,1h
16930,3,这个名不简单,2608,153,4,10,14,28.6%,15m
16930,3,HALO,2608,97,3,3,6,50.0%,1h
16930,2,星际争霸真好玩,2608,86,3,3,6,50.0%,1h
16930,1,时分,2608,48,2,4,6,33.3%,42m
16930,2,thyme,2608,0,1,1,2,50.0%,4m
16930,2,[男人毁在右手]Hammer,2608,40,1,1,2,50.0%,31m
16930,1,[最牛的菜鸟队]NothingKing,2608,44,1,2,3,33.3%,1h
16930,2,我呐喊啊啊,2608,44,1,4,5,20.0%,1h
16930,3,RIFLE,2608,30,1,9,10,10.0%,12m
16930,2,灼眼夏娜,2608,0,0,1,1,0.0%,17m
16930,2,你皮,2608,0,0,1,1,0.0%,17m
16947,3,enhh,2607,1480,163,162,325,50.2%,28m
16947,1,[无敌之师]清净瑜伽,2607,687,59,56,115,51.3%,5m
16947,1,素质极差丶艾尔,2607,1255,56,41,97,57.7%,29m
16947,3,医生,2607,856,40,46,86,46.5%,48m
16947,1,疾风小索,2607,728,26,26,52,50.0%,47m
16947,3,[太微玉清宫]虚竹,2607,453,22,24,46,47.8%,17m
16947,2,[浴火银河]RamBo,2607,533,21,20,41,51.2%,47m
16947,1,紅蓮華,2607,413,17,10,27,63.0%,20m
16947,2,梦幻迷途之境,2607,321,12,8,20,60.0%,57m
16947,1,pimbaisuck,2607,328,11,15,26,42.3%,1h
16947,1,岁月如歌,2607,185,9,10,19,47.4%,36m
16947,2,乔娜李莎的微笑,2607,262,9,11,20,45.0%,18m
16947,2,我要曹哩啊,2607,191,7,2,9,77.8%,1h
16947,1,凯恩战纪,2607,163,4,5,9,44.4%,1h
16947,2,funny,2607,60,3,2,5,60.0%,1h
16947,3,KISS,2607,163,3,4,7,42.9%,1h
16947,3,[PY交易协会]BlackTtea,2607,38,3,5,8,37.5%,1h
16947,3,希尔瓦娜斯,2607,97,2,0,2,100.0%,5m
16947,3,迷路的麋鹿,2607,0,2,3,5,40.0%,1h
16947,2,骑士包子,2607,116,2,3,5,40.0%,1h
16947,3,冷锋,2607,0,2,4,6,33.3%,1h
16947,3,光与影的海里,2607,0,2,4,6,33.3%,1h
16947,1,打烂,2607,137,2,5,7,28.6%,1h
16947,2,[将军刽子手]放牛娃,2607,30,1,1,2,50.0%,1h
16947,2,[光明之国]虫群,2607,30,1,1,2,50.0%,46m
16947,1,永恒梦魇,2607,0,0,1,1,0.0%,36m
16973,3,[红发海贼团]枪炮与玫瑰,2606,425,17,21,38,44.7%,13m
16973,1,[琴筝]DARKPEACH,2606,253,11,6,17,64.7%,56m
16973,3,天空極緻,2606,224,7,12,19,36.8%,1h
16973,2,辣椒,2606,123,5,1,6,83.3%,1h
16973,1,OIer,2606,123,5,4,9,55.6%,1h
16973,2,生人不要尾随,2606,146,5,5,10,50.0%,1h
16973,1,YIBEN,2606,48,4,7,11,36.4%,1h
16973,2,james,2606,168,3,4,7,42.9%,25m
16973,2,风暴要火,2606,58,2,2,4,50.0%,17m
16973,1,Darklily,2606,0,2,3,5,40.0%,4m
16973,2,[ZLR]Zimba,2606,0,0,2,2,0.0%,1h
16984,1,月之泪,2605,1512,70,70,140,50.0%,1h
16984,1,llllllllllll,2605,181,22,43,65,33.8%,20m
16984,2,机枪者,2605,370,18,7,25,72.0%,17m
16984,2,环日暮月,2605,321,12,10,22,54.5%,1h
16984,2,年少不轻狂,2605,315,11,8,19,57.9%,1h
16984,2,Killua,2605,286,10,13,23,43.5%,32m
16984,2,执念,2605,351,10,13,23,43.5%,57m
16984,2,一氧化二氢,2605,86,4,2,6,66.7%,1h
16984,2,RippleYiKl,2605,107,4,6,10,40.0%,1h
16984,2,[Mayuki]sclllJinG,2605,178,4,14,18,22.2%,24m
16984,3,PrinceARcher,2605,97,3,4,7,42.9%,53m
16984,1,西湖蛟龙孙一鸡,2605,62,3,7,10,30.0%,33m
16984,2,[Igirls]BoNus,2605,95,2,1,3,66.7%,1h
16984,2,Iridium,2605,30,2,1,3,66.7%,1h
16984,2,贼阿扣,2605,30,2,1,3,66.7%,1h
16984,3,Guderian,2605,129,2,2,4,50.0%,6m
16984,1,AGENT,2605,0,2,3,5,40.0%,5m
16984,2,[XXHZ35]星界之主莱维尔德,2605,0,1,0,1,100.0%,1h
16984,2,山风,2605,30,1,4,5,20.0%,32m
16984,2,御坂美琴的妹夫,2605,0,0,1,1,0.0%,1h
16984,2,砸本,2605,0,0,1,1,0.0%,1h
17005,2,贷款借款,2604,788,147,152,299,49.2%,5m
17005,1,ZHB,2604,1642,104,95,199,52.3%,16m
17005,1,死亡天幕,2604,573,37,36,73,50.7%,45m
17005,1,东栀起音来落,2604,773,28,28,56,50.0%,1h
17005,2,MagiCProtoss,2604,278,23,12,35,65.7%,17m
17005,1,队友是战哥,2604,518,16,37,53,30.2%,46m
17005,1,酒訶,2604,259,14,13,27,51.9%,1h
17005,2,素履以往,2604,322,11,6,17,64.7%,1h
17005,2,曲鹏润,2604,182,8,5,13,61.5%,1h
17005,2,爱情,2604,200,7,7,14,50.0%,41m
17005,2,QwQ,2604,191,7,7,14,50.0%,1h
17005,2,HZH,2604,180,6,7,13,46.2%,57m
17005,2,孤独不败,2604,102,3,0,3,100.0%,4m
17005,3,[北有吾王]jessie,2604,114,2,2,4,50.0%,13m
17005,1,少年王朝,2604,0,2,3,5,40.0%,6m
17005,3,微笑,2604,30,2,9,11,18.2%,9m
17005,2,[我是安娜哟]无当飞将,2604,0,1,1,2,50.0%,56m
17005,2,音蕻故,2604,0,0,1,1,0.0%,48m
17005,2,[壮我大虫族]SkySlayer,2604,0,0,2,2,0.0%,35m
17005,2,[20CM]闲言碎语,2604,0,0,3,3,0.0%,31m
17025,3,热泽,2603,1527,372,359,731,50.9%,29m
17025,3,黑龙江前五,2603,1531,245,246,491,49.9%,28m
17025,3,XiaoOB,2603,1049,43,46,89,48.3%,8m
17025,2,斯文败类,2603,965,40,30,70,57.1%,27m
17025,1,太空马里奥,2603,407,37,40,77,48.1%,30m
17025,1,SnowLeaf,2603,508,32,25,57,56.1%,22m
17025,2,qdhwdhsufe,2603,736,31,23,54,57.4%,51m
17025,2,zzxixi,2603,561,23,23,46,50.0%,1h
17025,1,[迦南电竞]玻璃炖土豆,2603,281,21,15,36,58.3%,46m
17025,2,明月天涯,2603,482,19,17,36,52.8%,29m
17025,1,TIME,2603,478,16,19,35,45.7%,1h
17025,2,[葱芯]妖白,2603,233,11,5,16,68.8%,1h
17025,2,ZioKy,2603,325,10,11,21,47.6%,31m
17025,2,yAh,2603,204,8,7,15,53.3%,15m
17025,1,[FLDSCL]Flandre,2603,288,8,14,22,36.4%,1h
17025,1,[白丝黑丝萝莉]平尺淮,2603,208,4,7,11,36.4%,1h
17025,3,DarkTD,2603,0,3,4,7,42.9%,11m
17025,1,[江南不夜城]莽夫,2603,116,3,7,10,30.0%,22m
17025,2,scw,2603,30,2,1,3,66.7%,37m
17025,3,世界好大,2603,127,2,1,3,66.7%,1h
17025,2,星耀,2603,30,2,2,4,50.0%,29m
17025,3,[暴雪二十队]觉得阿萨距离首都,2603,36,2,3,5,40.0%,1h
17025,3,陌小兜,2603,0,2,4,6,33.3%,1h
17025,2,wovle,2603,90,1,1,2,50.0%,1h
17025,2,豆米宝宝,2603,30,1,2,3,33.3%,4m
17025,2,ssww,2603,0,1,2,3,33.3%,1h
17025,1,收割者,2603,0,0,1,1,0.0%,6m
17052,1,梅川内酷的超人,2602,1523,216,212,428,50.5%,14m
17052,1,神圣印记丿幸运,2602,1436,64,51,115,55.7%,1h
17052,1,山海一线,2602,1082,44,34,78,56.4%,33m
17052,3,沉睡的雄狮,2602,703,29,34,63,46.0%,16m
17052,3,AlbertMoses,2602,311,28,34,62,45.2%,24m
17052,1,彡彡爱,2602,350,10,12,22,45.5%,1h
17052,2,Sword,2602,92,7,9,16,43.8%,1h
17052,2,花落舞倾城,2602,140,5,0,5,100.0%,1h
17052,3,海伦,2602,121,5,3,8,62.5%,1h
17052,3,smallegg,2602,133,4,5,9,44.4%,1h
17052,3,蓝叔叔,2602,97,3,4,7,42.9%,1h
17052,2,凉木夏,2602,0,3,5,8,37.5%,1h
17052,3,[somax]blackcamel,2602,66,3,7,10,30.0%,1h
17052,2,Liar,2602,46,2,3,5,40.0%,16m
17052,3,蹦沙卡拉卡,2602,0,2,4,6,33.3%,39m
17052,3,秋梨膏,2602,97,1,1,2,50.0%,49m
17052,2,[上帝的叹息]邪王真眼是最强的,2602,42,1,3,4,25.0%,31m
17052,2,寒丶情殇,2602,0,0,1,1,0.0%,38m
17070,1,浪白条,2601,1626,134,140,274,48.9%,1h
17070,1,暴力美学,2601,918,52,53,105,49.5%,44m
17070,2,芊寻曦,2601,465,19,9,28,67.9%,1h
17070,1,[绝世高手]无糖加冰,2601,144,6,6,12,50.0%,8m
17070,1,[Timing]tjjporpork,2601,178,6,13,19,31.6%,3m
17070,1,[48K纯帅]丶你瞧瞧看,2601,0,3,2,5,60.0%,1h
17070,1,[风云神]Nidhogg,2601,106,3,7,10,30.0%,1h
17070,1,暴躁老凯,2601,34,1,7,8,12.5%,58m
17070,2,IIIIIIIIIIII,2601,0,0,1,1,0.0%,17m
17070,2,[超合金战队]魔虫激光,2601,0,0,1,1,0.0%,38m
17070,2,[天雪]随波逐流,2601,0,0,3,3,0.0%,49m
17070,2,误点的闹钟,2601,0,0,3,3,0.0%,13m
17070,2,醉酒迷人,2601,0,0,3,3,0.0%,15m
17083,1,战神,2600,1638,87,85,172,50.6%,1h
17083,1,[禽禽禽]enbiubiu,2600,676,32,30,62,51.6%,1h
17083,1,[菜鸟的聚集地]Beach,2600,455,27,35,62,43.5%,1h
17083,1,火遁凤仙火,2600,667,24,29,53,45.3%,1h
17083,2,Kyire,2600,610,22,23,45,48.9%,8m
17083,3,克里夫反抗军,2600,531,20,20,40,50.0%,6m
17083,2,[东大电竞]Saber,2600,413,19,5,24,79.2%,7m
17083,2,[实力非凡]ohmylove,2600,239,13,15,28,46.4%,1h
17083,2,阿炜,2600,370,13,15,28,46.4%,1h
17083,2,[SFeng]KDCKED,2600,292,11,6,17,64.7%,1h
17083,1,壮士你怀孕了,2600,315,11,11,22,50.0%,5m
17083,2,[在命运中挣扎]GGamer,2600,238,9,10,19,47.4%,48m
17083,3,百江渚与巴麻美,2600,118,2,1,3,66.7%,1h
17083,2,[基金会]轻狂书生,2600,62,2,3,5,40.0%,15m
17083,3,Rridger,2600,0,2,4,6,33.3%,1h
17083,2,[ssts]梦醒时分,2600,0,1,0,1,100.0%,49m
17083,2,WYP,2600,30,1,1,2,50.0%,9m
17083,3,unknown,2600,97,1,1,2,50.0%,1h
17083,3,MIKU,2600,0,0,1,1,0.0%,1h
17083,2,西雨听风,2600,0,0,2,2,0.0%,1h
17103,3,懒得,2599,748,259,243,502,51.6%,46m
17103,2,你的运营有点慢,2599,1501,162,153,315,51.4%,4m
17103,1,茉莉的小棉袄,2599,1379,55,56,111,49.5%,1h
17103,2,微电九七二,2599,712,29,19,48,60.4%,9m
17103,1,[老油条战队]killt,2599,575,23,23,46,50.0%,30m
17103,2,三里空,2599,472,18,19,37,48.6%,7m
17103,2,豪横,2599,360,15,7,22,68.2%,45m
17103,1,lcb,2599,431,15,18,33,45.5%,4m
17103,1,非镜,2599,273,12,7,19,63.2%,1h
17103,2,ByeDream,2599,306,11,15,26,42.3%,1h
17103,1,Bilibobo,2599,332,10,11,21,47.6%,48m
17103,1,[XXHZN3]jaty,2599,308,10,12,22,45.5%,1h
17103,2,Recalling,2599,203,6,4,10,60.0%,27m
17103,2,[EP]GRIMM,2599,112,4,7,11,36.4%,1h
17103,2,[BH06]向丶左,2599,138,3,2,5,60.0%,8m
17103,2,小刀爸爸,2599,90,3,5,8,37.5%,47m
17103,3,我嘞个顶你的肺,2599,82,3,10,13,23.1%,48m
17103,2,甜甜圈儿机枪兵,2599,34,2,1,3,66.7%,1h
17103,2,[之怒]Kprby,2599,30,2,3,5,40.0%,13m
17103,2,wfant,2599,0,2,3,5,40.0%,1h
17103,3,卡修斯,2599,97,2,6,8,25.0%,1h
17103,2,星云,2599,0,1,0,1,100.0%,31m
17103,2,你是猪,2599,0,1,0,1,100.0%,1h
17103,2,冤冤相报何时了,2599,0,1,0,1,100.0%,31m
17103,2,[白给难度]电脑,2599,30,1,1,2,50.0%,23m
17103,2,圣风无极,2599,0,1,3,4,25.0%,23m
17103,1,Dkyf,2599,0,1,4,5,20.0%,13m
17103,2,无边落木,2599,0,0,1,1,0.0%,1h
17131,3,风之神话,2598,1518,515,515,1030,50.0%,49m
17131,2,上局见过,2598,1634,203,193,396,51.3%,1h
17131,2,Perfect,2598,1068,44,32,76,57.9%,11m
17131,1,black,2598,803,34,31,65,52.3%,35m
17131,1,Journal,2598,537,25,14,39,64.1%,20m
17131,1,小干部,2598,340,13,11,24,54.2%,20m
17131,3,菜鸟也是鸟,2598,181,5,6,11,45.5%,23m
17131,2,Evel,2598,164,5,7,12,41.7%,35m
17131,1,大炮打蚊子,2598,141,5,8,13,38.5%,36m
17131,2,Sin,2598,148,3,2,5,60.0%,59m
17131,2,[暴雪养鸡场]森林里的大怪兽,2598,84,3,5,8,37.5%,38m
17131,2,[SC2战队]IIIIIIIIIIII,2598,30,2,0,2,100.0%,1h
17131,2,[浪啊浪]仁义无双野人王,2598,30,2,2,4,50.0%,1h
17131,1,虫族大军生生不息,2598,34,2,7,9,22.2%,47m
17131,2,[川桑]三角贸易协定,2598,0,1,0,1,100.0%,17m
17131,1,相位水晶充能完毕,2598,0,1,0,1,100.0%,5m
17131,2,阿社,2598,30,1,1,2,50.0%,1h
17131,2,[VirGo]溟水幽蓝,2598,30,1,4,5,20.0%,17m
17131,2,Juhe,2598,32,1,4,5,20.0%,9m
17131,1,[XC丨星创]打不死的小强,2598,0,1,4,5,20.0%,23m
17131,1,DIA,2598,0,1,4,5,20.0%,35m
17131,3,东风一号外加狂飙,2598,30,1,8,9,11.1%,59m
17131,1,萌新,2598,0,0,1,1,0.0%,39m
17131,2,吴翰,2598,0,0,1,1,0.0%,46m
17131,2,自由,2598,0,0,2,2,0.0%,1h
17131,2,[siebte]瓦尔基里,2598,0,0,4,4,0.0%,11m
17157,2,[Sc养老]垂死卧病惊坐起,2597,1401,109,98,207,52.7%,17m
17157,1,罗十一,2597,760,62,67,129,48.1%,1h
17157,2,[入侵地球]取上将首级,2597,1250,44,55,99,44.4%,23m
17157,2,[四叶草]他可是孙哥啊,2597,434,17,19,36,47.2%,58m
17157,1,进击的小学生,2597,211,7,8,15,46.7%,42m
17157,2,拉萨拉拉,2597,163,6,0,6,100.0%,13m
17157,2,[阿米娅是驴]今日绫波明日香,2597,148,5,7,12,41.7%,1h
17157,3,想一朵云来,2597,127,3,6,9,33.3%,21m
17157,2,[JD]HSX,2597,46,3,7,10,30.0%,1h
17157,2,阿基诺,2597,0,1,0,1,100.0%,27m
17157,2,星空咸鱼,2597,0,1,0,1,100.0%,16m
17157,2,jinhao,2597,0,1,0,1,100.0%,39m
17157,2,重新集结部队,2597,0,1,1,2,50.0%,29m
17157,2,[GO1]SonicZYX,2597,0,0,1,1,0.0%,4m
17157,2,[戊戌六君子]dimolto,2597,0,0,1,1,0.0%,1h
17157,1,剑豪,2597,0,0,1,1,0.0%,51m
17157,2,[幽明异路]HideOnBush,2597,0,0,3,3,0.0%,15m
17174,2,龙朱,2596,1274,47,46,93,50.5%,17m
17174,3,sunnyboy,2596,1033,47,54,101,46.5%,24m
17174,2,为灭你而战,2596,805,32,29,61,52.5%,7m
17174,1,plusplus,2596,341,25,24,49,51.0%,1h
17174,2,[ANS]ProZ,2596,620,23,21,44,52.3%,18m
17174,2,天天,2596,356,15,5,20,75.0%,27m
17174,2,天地会总舵,2596,260,10,10,20,50.0%,39m
17174,2,暴躁之鼬,2596,174,6,6,12,50.0%,1h
17174,2,少将师长,2596,190,6,7,13,46.2%,1h
17174,2,YourDaddy,2596,190,6,7,13,46.2%,41m
17174,3,Dragon,2596,154,5,15,20,25.0%,7m
17174,2,[Mentor]Sky,2596,131,4,3,7,57.1%,1h
17174,2,[絲特切污]我是传奇,2596,44,3,4,7,42.9%,15m
17174,2,夜袭寡妇村,2596,0,3,5,8,37.5%,47m
17174,2,是离泽丫,2596,30,2,3,5,40.0%,1h
17174,2,霸天橙子,2596,0,1,0,1,100.0%,27m
17174,3,油傻,2596,0,1,0,1,100.0%,1h
17174,3,[自创]Aster,2596,0,1,0,1,100.0%,1h
17174,2,[皮卡球]最后的御主,2596,0,1,0,1,100.0%,47m
17174,2,BananaSkin,2596,88,1,1,2,50.0%,17m
17174,1,fgfgfgfgfg,2596,0,0,1,1,0.0%,1h
17174,1,羽暮,2596,0,0,1,1,0.0%,1h
17174,2,[RSTAR]Leaf,2596,0,0,2,2,0.0%,1h
17197,1,手慢的英语老师,2595,478,54,56,110,49.1%,4m
17197,2,[社交学大可爱]AMG,2595,670,23,23,46,50.0%,29m
17197,2,AbAcUS,2595,356,22,17,39,56.4%,13m
17197,2,[hct]IIIIIIIIIIII,2595,329,13,7,20,65.0%,32m
17197,1,德国国防军,2595,384,12,15,27,44.4%,5m
17197,2,Kuroro,2595,114,3,1,4,75.0%,1h
17197,1,[MIKU初音]Jason,2595,105,3,2,5,60.0%,23m
17197,1,龙骑枪,2595,0,2,1,3,66.7%,1h
17197,2,HELLO,2595,0,1,0,1,100.0%,1h
17197,2,[xcdh]星空下无敌,2595,0,1,0,1,100.0%,1h
17197,2,诸葛王朗是也,2595,0,0,1,1,0.0%,47m
17197,2,楠枫流沐,2595,0,0,1,1,0.0%,7m
17197,3,eternal,2595,0,0,2,2,0.0%,1h
17210,2,Archon,2594,911,135,137,272,49.6%,32m
17210,3,晴空,2594,341,42,42,84,50.0%,28m
17210,2,凌舞雩,2594,338,13,16,29,44.8%,39m
17210,3,电竞乔北陆,2594,171,12,16,28,42.9%,18m
17210,2,[AFSC2]Mordecai,2594,200,7,3,10,70.0%,32m
17210,2,[ESKT]叫我万神,2594,122,4,6,10,40.0%,60m
17210,2,渐行渐远,2594,113,4,6,10,40.0%,1h
17210,2,[SS天羽]阿斯顿发生,2594,96,3,5,8,37.5%,34m
17210,2,Fadedflowers,2594,95,3,5,8,37.5%,1h
17210,3,Like,2594,30,3,5,8,37.5%,25m
17210,1,[cRn]shmily,2594,70,3,6,9,33.3%,1h
17210,1,VENREN,2594,115,2,1,3,66.7%,60m
17210,1,SAMURAI,2594,34,2,5,7,28.6%,1h
17210,2,[黑塔]露露缇雅,2594,0,1,0,1,100.0%,13m
17210,2,阿克苏次,2594,0,1,1,2,50.0%,1h
17210,2,哈洗拉马,2594,0,1,1,2,50.0%,31m
17210,2,ROOT,2594,30,1,4,5,20.0%,1h
17210,3,[我即是霸主]大主教已阵亡,2594,0,0,1,1,0.0%,8m
17210,2,赫卡,2594,0,0,1,1,0.0%,1h
17210,1,STARRAFT,2594,0,0,6,6,0.0%,53m
17230,2,woaiwolaopo,2593,541,21,18,39,53.8%,1h
17230,2,为了部落,2593,345,16,6,22,72.7%,1h
17230,1,[ESU二五仔]ELvis,2593,420,14,17,31,45.2%,16m
17230,2,[打死毛老板]风翼,2593,282,12,3,15,80.0%,1h
17230,1,地狱黄泉,2593,306,9,13,22,40.9%,5m
17230,2,明摆了坑货一个,2593,68,3,4,7,42.9%,35m
17230,2,[远坂世家]苏联,2593,30,2,3,5,40.0%,31m
17230,1,[南京何平]挖矿的农民,2593,0,1,3,4,25.0%,19m
17230,1,拒绝者,2593,0,1,4,5,20.0%,47m
17230,2,ZXCTTAIR,2593,0,0,1,1,0.0%,31m
17230,1,[北极光小组]我不是萌新,2593,0,0,1,1,0.0%,20m
17230,1,猎者之心从未遗弃,2593,0,0,1,1,0.0%,55m
17242,2,那份爱,2592,851,92,86,178,51.7%,35m
17242,2,苍之月,2592,337,14,9,23,60.9%,1h
17242,1,暴躁的浣熊,2592,454,14,17,31,45.2%,37m
17242,2,nigheman,2592,350,12,10,22,54.5%,58m
17242,1,李佳玉,2592,165,6,2,8,75.0%,1h
17242,2,南方老墨,2592,137,6,7,13,46.2%,1h
17242,1,成果的脑残粉,2592,208,6,11,17,35.3%,1h
17242,3,跳挑骑士,2592,120,4,3,7,57.1%,1h
17242,2,YRM,2592,114,4,4,8,50.0%,35m
17242,3,AzazeI,2592,0,3,4,7,42.9%,1h
17242,2,Jayce,2592,94,3,6,9,33.3%,38m
17242,2,[萝莉保护会]陌璃,2592,108,2,2,4,50.0%,41m
17242,3,撒旦,2592,0,2,4,6,33.3%,1h
17242,1,噬魂之心,2592,0,1,1,2,50.0%,10m
17242,2,[御神装勿忘]古明地觉,2592,32,1,2,3,33.3%,18m
17242,3,ziluojs,2592,0,0,1,1,0.0%,1h
17242,2,[肉鸡的饲养]Link,2592,0,0,2,2,0.0%,13m
17259,1,尹伊人,2591,1558,118,94,212,55.7%,20m
17259,1,透光,2591,835,78,73,151,51.7%,33m
17259,2,kevin,2591,982,49,59,108,45.4%,5m
17259,3,不死鸟,2591,1236,43,53,96,44.8%,47m
17259,1,Ironman,2591,414,33,31,64,51.6%,35m
17259,2,白音黑歌,2591,415,22,4,26,84.6%,9m
17259,2,dutchman,2591,456,20,16,36,55.6%,27m
17259,1,头号玩家,2591,318,18,12,30,60.0%,33m
17259,2,戏子,2591,234,9,8,17,52.9%,35m
17259,2,老年人手法,2591,132,8,9,17,47.1%,1h
17259,1,蓝天白菜,2591,167,4,1,5,80.0%,32m
17259,3,faker,2591,64,4,6,10,40.0%,23m
17259,2,[VCT]Ryta,2591,0,3,5,8,37.5%,1h
17259,3,家住海边喜欢浪,2591,48,3,6,9,33.3%,44m
17259,2,TheThe,2591,0,1,1,2,50.0%,51m
17259,2,IIlIlIIIIIll,2591,0,1,1,2,50.0%,47m
17259,3,[皇室联盟]永域天恒,2591,97,1,1,2,50.0%,1h
17276,2,[星际丨老男孩]星际宇,2590,896,95,83,178,53.4%,1h
17276,2,MVPhelp,2590,715,34,25,59,57.6%,29m
17276,3,天命,2590,642,33,35,68,48.5%,49m
17276,3,youlong,2590,606,28,37,65,43.1%,48m
17276,2,[帝都战神]Jimleinuo,2590,652,23,25,48,47.9%,32m
17276,2,[麻酱万岁]llllllllllll,2590,445,18,12,30,60.0%,1h
17276,2,点点,2590,210,12,9,21,57.1%,1h
17276,2,[白手团]功夫熊猫,2590,318,12,12,24,50.0%,35m
17276,2,[艾卫道特联盟]莱宁锡特,2590,267,11,5,16,68.8%,1h
17276,1,完美背后,2590,337,11,12,23,47.8%,1h
17276,2,山风流苏,2590,213,8,8,16,50.0%,25m
17276,3,不吃豆腐,2590,74,5,5,10,50.0%,1h
17276,1,风吹斜雨,2590,210,5,6,11,45.5%,43m
17276,1,Meody,2590,94,5,8,13,38.5%,1h
17276,2,玄门玄天,2590,150,4,3,7,57.1%,1h
17276,2,在下李某,2590,26,4,5,9,44.4%,15m
17276,2,永川纱夜,2590,114,3,1,4,75.0%,17m
17276,2,ads,2590,94,3,6,9,33.3%,1h
17276,1,[星际爱好者队]绫枫,2590,112,2,4,6,33.3%,5m
17276,3,电脑不好会闪退,2590,119,2,7,9,22.2%,10m
17276,2,[KakALU]入夜渐微凉,2590,88,1,1,2,50.0%,1h
17276,2,郭慢慢,2590,88,1,1,2,50.0%,51m
17276,2,[游骑兵联盟]千手修罗,2590,0,1,2,3,33.3%,1h
17276,3,stupidboy,2590,97,1,2,3,33.3%,1h
17276,2,青檀郎,2590,0,0,1,1,0.0%,11m
17276,2,地狱灬寒冰,2590,0,0,2,2,0.0%,1h
17276,2,魔羯座,2590,0,0,3,3,0.0%,23m
17276,2,[惩戒军团]天一炮,2590,0,0,4,4,0.0%,35m
17304,2,Superrui,2589,1267,198,210,408,48.5%,49m
17304,2,大德鲁伊袁,2589,1221,84,65,149,56.4%,9m
17304,2,[cestla]吉原哀歌,2589,854,36,26,62,58.1%,17m
17304,1,Biut,2589,453,36,29,65,55.4%,23m
17304,1,林加德,2589,864,30,33,63,47.6%,21m
17304,1,[do啊do]华昭,2589,500,22,16,38,57.9%,12m
17304,2,缱绻,2589,516,19,15,34,55.9%,1h
17304,2,随风,2589,340,13,8,21,61.9%,1h
17304,2,zzWinD,2589,286,10,8,18,55.6%,41m
17304,2,期待四川人,2589,183,9,5,14,64.3%,41m
17304,2,[秋毫]IIIIIIIIIIII,2589,232,9,8,17,52.9%,1h
17304,2,[你好我是萌新]ppppppppp,2589,219,8,5,13,61.5%,1h
17304,3,爆斌萌新,2589,212,6,7,13,46.2%,1h
17304,1,陌路,2589,142,5,9,14,35.7%,38m
17304,3,[五月花]yousa,2589,145,4,4,8,50.0%,44m
17304,2,[21CM]咸鱼冲撞,2589,115,4,6,10,40.0%,1h
17304,3,BOSsYu,2589,34,3,5,8,37.5%,1h
17304,2,[独立團]DDDDTao,2589,52,2,3,5,40.0%,1h
17304,1,JAY,2589,0,2,3,5,40.0%,19m
17304,1,vegetawinner,2589,78,2,9,11,18.2%,1h
17304,2,不将就,2589,0,1,3,4,25.0%,7m
17304,2,且风吟,2589,0,1,4,5,20.0%,56m
17304,3,[雪乃万岁]cHeNxIlFdY,2589,0,1,6,7,14.3%,1h
17304,3,[八爪鱼]本子成林,2589,93,1,7,8,12.5%,16m
17304,2,[Alexya]Tallnut,2589,0,0,1,1,0.0%,1h
17304,2,[1v1白给]武汉喵,2589,0,0,1,1,0.0%,47m
17304,2,Altber,2589,0,0,2,2,0.0%,58m
17331,3,牛宝宝,2588,1457,64,66,130,49.2%,50m
17331,1,[萌新萌萌哒]小太壹,2588,708,25,30,55,45.5%,1h
17331,2,Sparkling,2588,218,9,3,12,75.0%,23m
17331,1,史迪威万岁圣诞袜,2588,236,9,9,18,50.0%,42m
17331,2,luminary,2588,164,5,3,8,62.5%,1h
17331,2,[黎明]guiyeye,2588,116,5,4,9,55.6%,1h
17331,2,好烦好像摸鱼,2588,116,5,6,11,45.5%,9m
17331,2,枪兵突袭,2588,118,4,6,10,40.0%,31m
17331,3,[仙阁]Stave,2588,152,4,7,11,36.4%,1h
17331,2,[南昌一枝花]小色意,2588,60,3,3,6,50.0%,15m
17331,2,绫绫绫绫绫绫兔,2588,38,2,0,2,100.0%,1h
17331,2,zhandou,2588,0,2,3,5,40.0%,1h
17331,3,liweisi,2588,121,2,4,6,33.3%,13m
17331,2,[秋毫七队]致命之鼠,2588,88,1,1,2,50.0%,9m
17331,2,永恒的辉煌,2588,30,1,2,3,33.3%,1h
17331,2,丿丿丿丿,2588,0,1,2,3,33.3%,47m
17331,1,李艽梦,2588,0,1,3,4,25.0%,1h
17331,3,裂痕,2588,0,1,5,6,16.7%,44m
17331,1,泪决,2588,104,1,10,11,9.1%,1h
17350,1,[内急]Twistzz,2587,1086,96,65,161,59.6%,47m
17350,1,木头,2587,440,25,29,54,46.3%,21m
17350,1,dxbsd,2587,287,12,7,19,63.2%,1h
17350,2,[菜有菜的道理]幻虚无,2587,329,11,8,19,57.9%,51m
17350,1,卢本伟,2587,339,10,10,20,50.0%,4m
17350,1,聆听猫语,2587,243,7,5,12,58.3%,1h
17350,2,AIGAION,2587,202,6,4,10,60.0%,8m
17350,1,[亀山社中]缺舟一帆渡,2587,106,4,7,11,36.4%,1h
17350,2,[星河气象学院]胡天八月即飞雪,2587,93,3,5,8,37.5%,31m
17350,2,不菲的孤独,2587,0,1,0,1,100.0%,5m
17350,2,[远古战盟]回眸,2587,0,1,0,1,100.0%,37m
17350,2,fox,2587,30,1,2,3,33.3%,9m
17350,3,不二心,2587,0,0,1,1,0.0%,25m
17363,2,奥野田美咲,2586,1630,62,70,132,47.0%,23m
17363,2,三味书屋,2586,1294,51,43,94,54.3%,29m
17363,2,Spica,2586,922,34,32,66,51.5%,56m
17363,1,Will,2586,754,28,29,57,49.1%,30m
17363,2,哔哔小子,2586,618,25,17,42,59.5%,15m
17363,2,[Newton]Snap,2586,716,25,28,53,47.2%,5m
17363,2,悲情小文,2586,419,22,13,35,62.9%,1h
17363,2,IIIIIIIIIIII,2586,179,6,3,9,66.7%,1h
17363,1,[北京大学鸡协]vinsmoksanji,2586,203,6,6,12,50.0%,1h
17363,2,Minstrel,2586,130,5,0,5,100.0%,1h
17363,2,[在下菜鸡一只]Shan,2586,118,5,5,10,50.0%,1h
17363,1,WaiAndGe,2586,0,4,1,5,80.0%,1h
17363,1,烦恼的成长,2586,120,2,5,7,28.6%,32m
17363,1,爱莎公猪,2586,97,1,5,6,16.7%,1h
17363,2,[Mentor]飞龙骑脸怎么输,2586,0,0,1,1,0.0%,8m
17363,2,[小小怪怪]Antonio,2586,0,0,1,1,0.0%,17m
17363,2,[一般赢不了]白给永不放弃,2586,0,0,3,3,0.0%,23m
17380,2,tiger,2585,1547,100,95,195,51.3%,18m
17380,2,帝国影子,2585,672,27,21,48,56.2%,35m
17380,3,Masquerade,2585,700,25,30,55,45.5%,13m
17380,1,amwwzi,2585,273,13,7,20,65.0%,12m
17380,1,marufans,2585,388,13,13,26,50.0%,23m
17380,2,[李惠利]金明洙,2585,251,11,14,25,44.0%,37m
17380,2,monster,2585,257,10,16,26,38.5%,37m
17380,3,Joad,2585,181,6,11,17,35.3%,16m
17380,3,三三得三,2585,127,4,5,9,44.4%,28m
17380,2,殇逝琉璃,2585,60,3,3,6,50.0%,37m
17380,3,杨威利,2585,68,3,5,8,37.5%,60m
17380,2,不会运营只会斗狗,2585,36,2,1,3,66.7%,1h
17380,3,jianguihao,2585,0,2,4,6,33.3%,1h
17380,3,[永不灭的战火]zdmmin,2585,0,2,5,7,28.6%,1h
17380,2,苏宁宁炸柠檬,2585,0,1,2,3,33.3%,1h
17380,2,[XXHZ16]仇花徒花,2585,0,0,1,1,0.0%,1h
17380,2,无从下手,2585,0,0,1,1,0.0%,1h
17380,2,封心之恋,2585,0,0,1,1,0.0%,27m
17380,1,Timothy,2585,0,0,1,1,0.0%,4m
17380,2,面朝大海春暖花开,2585,0,0,3,3,0.0%,35m
17400,3,天才在这嘿嘿,2584,1333,340,336,676,50.3%,20m
17400,1,想想黄哥怎么做,2584,1602,210,206,416,50.5%,46m
17400,2,[YA]llllllllllll,2584,1466,120,129,249,48.2%,22m
17400,1,坚挺乱放炮,2584,1330,47,56,103,45.6%,1h
17400,2,Hatenn,2584,710,39,27,66,59.1%,38m
17400,2,abandon,2584,769,31,43,74,41.9%,23m
17400,3,风残追忆,2584,484,29,30,59,49.2%,20m
17400,2,[慢手e族]小艾尔,2584,616,28,15,43,65.1%,1h
17400,1,东方月初,2584,411,15,20,35,42.9%,1h
17400,2,达死你,2584,221,12,7,19,63.2%,8m
17400,1,Ghost,2584,274,9,13,22,40.9%,1h
17400,3,ForeverEgg,2584,290,9,19,28,32.1%,20m
17400,2,[MDT]火翼,2584,224,8,4,12,66.7%,1h
17400,2,[21CM]llllllllllll,2584,198,7,4,11,63.6%,1h
17400,2,人族之王,2584,227,7,7,14,50.0%,47m
17400,3,爱民如子明灯大帝,2584,194,6,6,12,50.0%,1h
17400,2,雨落倾城微微凉,2584,168,5,2,7,71.4%,8m
17400,2,[帝王江山如画]wqe,2584,140,5,3,8,62.5%,8m
17400,2,车芃,2584,116,3,2,5,60.0%,17m
17400,2,Abuse,2584,96,3,4,7,42.9%,1h
17400,3,二火,2584,38,3,5,8,37.5%,1h
17400,2,[赛博朋克]Magiczerg,2584,30,2,2,4,50.0%,1h
17400,3,BIGBOSSSSSSS,2584,0,2,4,6,33.3%,35m
17400,2,[King丶]死亡指环,2584,0,1,0,1,100.0%,47m
17400,2,Rainbow,2584,88,1,1,2,50.0%,1h
17400,2,和我黑贞贴贴,2584,0,1,1,2,50.0%,60m
17400,2,[高达]占戈哥欠走己,2584,88,1,1,2,50.0%,11m
17400,1,残花碎梦,2584,0,1,4,5,20.0%,6m
17400,1,浅梦无岸,2584,0,0,1,1,0.0%,39m
17400,1,御坂美琴,2584,0,0,6,6,0.0%,56m
17400,1,zyde,2584,0,0,6,6,0.0%,7m
17431,3,布鲁仛,2583,808,37,43,80,46.2%,8m
17431,2,leonidas,2583,210,10,8,18,55.6%,1h
17431,2,真理之云,2583,193,8,4,12,66.7%,8m
17431,1,Darkness,2583,32,4,5,9,44.4%,33m
17431,1,[横槊赋诗1]Rorschach,2583,138,3,2,5,60.0%,15m
17431,2,[java]人族无敌,2583,102,2,1,3,66.7%,58m
17431,1,星姬争爸,2583,0,2,3,5,40.0%,1h
17431,3,色彩,2583,0,2,4,6,33.3%,1h
17431,2,WYZMilan,2583,0,1,0,1,100.0%,1h
17431,2,舰长文森上将,2583,0,1,0,1,100.0%,11m
17431,2,LJsquirrel,2583,46,1,5,6,16.7%,41m
17431,2,lixin,2583,0,0,1,1,0.0%,30m
17431,2,我永远喜欢,2583,0,0,3,3,0.0%,1h
17444,2,老成来了,2582,1576,150,132,282,53.2%,1h
17444,2,我吃红苹果,2582,1478,105,95,200,52.5%,1h
17444,3,国宝食铁兽,2582,940,40,34,74,54.1%,9m
17444,2,[襄铃]黑虎阿福,2582,643,25,18,43,58.1%,1h
17444,2,aawd,2582,560,23,14,37,62.2%,1h
17444,2,[七咕咕]时之主,2582,392,15,17,32,46.9%,1h
17444,2,葬灭,2582,330,12,14,26,46.2%,1h
17444,1,aurora,2582,306,11,12,23,47.8%,1h
17444,1,YIE,2582,338,11,16,27,40.7%,20m
17444,3,laizi,2582,146,6,13,19,31.6%,20m
17444,2,nrxqwe,2582,113,5,6,11,45.5%,1h
17444,2,[CPT]我是长颈鹿,2582,92,4,4,8,50.0%,17m
17444,2,爱私藏的松鼠,2582,64,3,2,5,60.0%,35m
17444,3,[南建盟]灭叶幻枫,2582,0,3,4,7,42.9%,1h
17444,2,[Sc养老]装逼无止尽,2582,88,2,0,2,100.0%,1h
17444,2,[人生有梦]sun,2582,92,2,0,2,100.0%,1h
17444,1,就是这个味,2582,0,2,3,5,40.0%,13m
17444,2,[YA]鱼丸酱,2582,66,2,4,6,33.3%,1h
17444,2,FunkySaber,2582,0,1,0,1,100.0%,8m
17444,2,[净化者]Soup,2582,0,1,0,1,100.0%,1h
17444,3,liazz,2582,0,1,1,2,50.0%,18m
17444,2,沙福林大人,2582,30,1,3,4,25.0%,1h
17444,1,樱幻,2582,46,1,3,4,25.0%,1h
17444,2,[C97]chrolum,2582,0,0,1,1,0.0%,1h
17444,2,[CHNIII]金戈沉铁号诸侯,2582,0,0,1,1,0.0%,1h
17469,1,[专治格种不服]NuuuuuuudaJJ,2581,322,41,37,78,52.6%,1h
17469,2,打不过怎么办,2581,907,36,39,75,48.0%,1h
17469,2,爱静茹的好鱼亲,2581,174,15,15,30,50.0%,14m
17469,3,丨丨丨丨丨丨丨丨,2581,308,11,21,32,34.4%,27m
17469,2,丶过敏世界,2581,261,8,9,17,47.1%,1h
17469,2,[JKkkkk]星际争霸嘴上过,2581,166,7,1,8,87.5%,1h
17469,1,Arthistorian,2581,143,6,6,12,50.0%,51m
17469,3,小学神,2581,186,6,17,23,26.1%,49m
17469,2,[这谁懂]带我下地狱,2581,186,5,1,6,83.3%,8m
17469,2,好皇帝,2581,166,5,4,9,55.6%,30m
17469,2,[EC]黑猫,2581,128,4,2,6,66.7%,9m
17469,2,[Ompc]安芸伦也,2581,114,3,1,4,75.0%,32m
17469,2,fire,2581,135,2,4,6,33.3%,25m
17469,2,星际争霸权哥,2581,0,1,0,1,100.0%,1h
17469,2,Ranger,2581,88,1,1,2,50.0%,14m
17469,2,[紫晶]HUHU,2581,32,1,2,3,33.3%,39m
17469,3,神很坑爹,2581,34,1,3,4,25.0%,6m
17469,2,[miku守护]LXF,2581,0,0,1,1,0.0%,32m
17469,2,[XXS]awsl,2581,0,0,2,2,0.0%,1h
17469,2,LIA,2581,0,0,2,2,0.0%,1h
17469,2,蘑菇蹲,2581,0,0,2,2,0.0%,1h
17490,1,周周不是周周,2580,1584,194,175,369,52.6%,1h
17490,2,[坑爹军团]小木,2580,1462,74,63,137,54.0%,18m
17490,3,[小仙女上线啦]哥叫马华藤,2580,908,49,48,97,50.5%,28m
17490,2,[KORSC2]CvMAX,2580,540,44,10,54,81.5%,1h
17490,2,Simon,2580,396,24,16,40,60.0%,1h
17490,2,[天羽不榖]AlbertShen,2580,593,21,18,39,53.8%,1h
17490,2,Mingyez,2580,380,15,9,24,62.5%,51m
17490,3,[草草草草草草]我是格鲁特,2580,392,15,20,35,42.9%,30m
17490,3,哀怨的一生,2580,281,12,22,34,35.3%,48m
17490,2,寻思学家,2580,253,8,11,19,42.1%,47m
17490,2,其实我真的是高手,2580,243,8,15,23,34.8%,30m
17490,2,[白银联盟]雷诺的小迷妹,2580,180,6,3,9,66.7%,47m
17490,1,zzpp,2580,161,6,8,14,42.9%,46m
17490,1,[有组织无纪录]sdrcf,2580,200,5,9,14,35.7%,15m
17490,2,ANKER,2580,102,3,1,4,75.0%,32m
17490,3,诸神黄昏,2580,46,3,5,8,37.5%,1h
17490,2,星辰下的我们,2580,114,2,2,4,50.0%,37m
17490,3,[闭嘴基佬]SDDDDDDDDDGG,2580,137,2,3,5,40.0%,1h
17490,2,[8kmage]风逸,2580,30,2,6,8,25.0%,1h
17490,3,[绝世高手]TamamonoMae,2580,0,1,0,1,100.0%,1h
17490,3,trever,2580,97,1,1,2,50.0%,1h
17490,2,phh,2580,0,1,2,3,33.3%,1h
17490,2,千夜,2580,92,1,2,3,33.3%,1h
17490,1,新手电脑,2580,96,1,8,9,11.1%,1h
17490,3,空战英豪老萨米,2580,0,0,1,1,0.0%,1h
17490,2,电磁步枪波纹疾走,2580,0,0,2,2,0.0%,1h
17516,2,老唐,2579,652,25,28,53,47.2%,1h
17516,2,梅哥,2579,639,24,22,46,52.2%,1h
17516,1,[123猫猫]名词是名字,2579,643,23,28,51,45.1%,13m
17516,1,[东十字军]Miraitowa,2579,508,22,15,37,59.5%,37m
17516,2,见贤不思齐,2579,524,19,20,39,48.7%,35m
17516,1,[鲁德欢]sixsixsixjun,2579,395,13,13,26,50.0%,58m
17516,2,杞人忧天丶,2579,261,9,8,17,52.9%,1h
17516,3,飯鍥叁碗,2579,284,9,21,30,30.0%,23m
17516,2,Nothing,2579,243,6,9,15,40.0%,52m
17516,2,SEED,2579,148,5,2,7,71.4%,47m
17516,1,[征服之海]我得重新集结部队,2579,161,5,4,9,55.6%,1h
17516,2,鸡儿,2579,116,3,1,4,75.0%,35m
17516,1,老将,2579,0,3,2,5,60.0%,13m
17516,3,夕阳下的落叶,2579,0,3,4,7,42.9%,1h
17516,1,蜡笔小酸,2579,93,2,3,5,40.0%,22m
17516,1,大千自道,2579,0,2,3,5,40.0%,1h
17516,2,WODE,2579,0,1,1,2,50.0%,11m
17516,2,走自己的路,2579,30,1,2,3,33.3%,1h
17516,2,一骑红尘妃子笑,2579,0,0,1,1,0.0%,1h
17516,1,DTpony,2579,0,0,1,1,0.0%,1h
17516,1,[白银联盟]我要空调房,2579,0,0,2,2,0.0%,49m
17516,2,[是我赢了]BuryTheLight,2579,0,0,3,3,0.0%,31m
17516,1,[大叔同盟]素衣白裙,2579,0,0,5,5,0.0%,35m
17539,2,allies,2578,1076,156,130,286,54.5%,37m
17539,2,将粪坑进行到底,2578,706,45,28,73,61.6%,1h
17539,3,yuangon,2578,1096,40,46,86,46.5%,29m
17539,1,[悲雨叹风]疯不觉,2578,780,31,31,62,50.0%,40m
17539,2,风萧萧兮易水寒,2578,789,30,28,58,51.7%,39m
17539,2,死亡守望,2578,680,23,26,49,46.9%,49m
17539,2,[彼岸之花]Ray,2578,354,18,4,22,81.8%,1h
17539,2,EmptyCity,2578,386,13,18,31,41.9%,1h
17539,1,[JRS]白给之神,2578,232,12,9,21,57.1%,1h
17539,1,[XYFANS]尼哥,2578,368,11,17,28,39.3%,1h
17539,2,三明治,2578,266,10,10,20,50.0%,46m
17539,2,[兆景埋土大学]无常夏日与幽灵,2578,250,8,7,15,53.3%,52m
17539,1,ZHT,2578,257,8,9,17,47.1%,29m
17539,2,DaDaoKK,2578,290,8,18,26,30.8%,39m
17539,1,你的妈妈好棒啊,2578,190,6,4,10,60.0%,50m
17539,1,Leslie,2578,162,6,9,15,40.0%,4m
17539,2,[MS13战术]citybaboon,2578,156,5,4,9,55.6%,14m
17539,2,我了个西八皮,2578,110,5,6,11,45.5%,18m
17539,1,我杀我自己,2578,48,4,2,6,66.7%,13m
17539,1,[假的战队]king,2578,0,4,6,10,40.0%,19m
17539,2,暗夜之魂,2578,44,4,6,10,40.0%,1h
17539,3,IIIIIIIIIIII,2578,97,2,2,4,50.0%,44m
17539,2,doreen,2578,27,2,3,5,40.0%,31m
17539,2,[l同化完成l]phantom,2578,0,1,1,2,50.0%,1h
17539,2,[男人该干男人]该干的事,2578,32,1,3,4,25.0%,23m
17539,3,马栏山孙一峰,2578,0,1,6,7,14.3%,5m
17539,3,ISSPolaris,2578,0,0,1,1,0.0%,6m
17539,2,[wlay]寒冰,2578,0,0,1,1,0.0%,8m
17567,2,itboy,2577,1502,279,275,554,50.4%,21m
17567,2,爬墙等红杏,2577,1505,224,210,434,51.6%,8m
17567,1,[火焰雷兽]xuanily,2577,1155,87,86,173,50.3%,33m
17567,2,率洒俄方面,2577,742,78,63,141,55.3%,31m
17567,2,呵呵的熊,2577,724,51,43,94,54.3%,38m
17567,1,BORK,2577,648,33,33,66,50.0%,7m
17567,2,[白给不要钱]新手,2577,234,9,8,17,52.9%,1h
17567,3,虽无冕仍为王,2577,49,8,17,25,32.0%,23m
17567,2,[CPT]啥啊你们在哪,2577,154,6,1,7,85.7%,1h
17567,2,[文韬武略]恩泽,2577,186,6,4,10,60.0%,60m
17567,2,EzioAuditore,2577,142,5,2,7,71.4%,46m
17567,2,[但若花开如初]LuRen,2577,193,5,5,10,50.0%,38m
17567,2,[暴雪二十八队]kirito,2577,88,4,3,7,57.1%,8m
17567,2,想要害你的就是我,2577,94,4,6,10,40.0%,1h
17567,2,哲哲小黄瓜,2577,116,3,1,4,75.0%,38m
17567,2,[黄旭东说]你的优势很大,2577,96,3,4,7,42.9%,23m
17567,2,爱笑的大哥哥,2577,125,3,6,9,33.3%,10m
17567,2,明月几时有,2577,102,2,1,3,66.7%,23m
17567,2,[聚变打鸡就绪]歪比巴卜,2577,93,2,2,4,50.0%,1h
17567,2,[傲世丨听雨轩]Tysone,2577,0,2,4,6,33.3%,1h
17567,2,步伐,2577,60,2,5,7,28.6%,1h
17567,2,开小伞的名字真长,2577,88,1,1,2,50.0%,38m
17567,2,玄禹,2577,0,0,2,2,0.0%,1h
17590,2,孙一峰是我大哥,2576,1441,101,114,215,47.0%,16m
17590,2,Edison,2576,1576,76,67,143,53.1%,33m
17590,1,泉水指挥官,2576,760,32,25,57,56.1%,45m
17590,1,seoccc,2576,607,26,27,53,49.1%,4m
17590,1,[千一]Atroheim,2576,142,6,11,17,35.3%,1h
17590,2,澄风化雨,2576,152,5,3,8,62.5%,1h
17590,2,Monika,2576,116,4,5,9,44.4%,57m
17590,3,Alan,2576,74,4,6,10,40.0%,13m
17590,2,SYQ,2576,0,1,0,1,100.0%,27m
17590,1,[你好抱歉]绫濑川修也,2576,44,1,1,2,50.0%,53m
17590,2,shijy,2576,0,1,1,2,50.0%,39m
17590,1,BoredMosters,2576,0,1,1,2,50.0%,53m
17590,2,blacksheep,2576,32,1,2,3,33.3%,31m
17590,2,fnsafl,2576,30,1,3,4,25.0%,5m
17590,2,[北有吾王]衮神强,2576,0,0,1,1,0.0%,49m
17605,3,碎嘴头子,2575,994,101,105,206,49.0%,18m
17605,1,[大爱星际二]火抢,2575,1005,98,99,197,49.7%,21m
17605,2,十月,2575,1519,66,50,116,56.9%,17m
17605,3,[浮世清欢]锐步,2575,1066,51,57,108,47.2%,24m
17605,2,[嗑药小分队]为了虫族,2575,564,26,27,53,49.1%,1h
17605,2,长岛冰茶,2575,598,22,21,43,51.2%,15m
17605,2,政政必拿奥斯卡,2575,425,17,19,36,47.2%,17m
17605,2,[菜有菜的道理]农夫一拳,2575,312,12,5,17,70.6%,46m
17605,1,青铜炮灰,2575,313,12,10,22,54.5%,1h
17605,2,明天的你,2575,179,8,6,14,57.1%,1h
17605,2,WeiWeiWeiWei,2575,95,3,6,9,33.3%,1h
17605,1,[繁花落尽]西行寺幽幽子,2575,0,2,1,3,66.7%,22m
17605,1,[太微玉清宫]玉清圣境元始天尊,2575,0,2,3,5,40.0%,9m
17605,2,飞龙骑脸,2575,0,1,1,2,50.0%,1h
17605,2,Enloop,2575,0,0,1,1,0.0%,1h
17605,3,暗裔丶剑魔,2575,0,0,1,1,0.0%,49m
17605,2,彡唯美丶旋律,2575,0,0,3,3,0.0%,1h
17605,2,[IamK]Asurun,2575,0,0,3,3,0.0%,1h
17623,1,半个菜鸡,2574,1579,197,182,379,52.0%,16m
17623,2,庐山升龙霸,2574,972,58,73,131,44.3%,12m
17623,1,[富贵不存在]夏步,2574,550,35,41,76,46.1%,7m
17623,2,AMCC,2574,541,21,22,43,48.8%,10m
17623,2,NoobKing,2574,461,18,16,34,52.9%,1h
17623,2,[虚拟歌手团体]逗比的战舰,2574,376,16,7,23,69.6%,1h
17623,2,[花妈真可爱]KaguyaOwO,2574,431,16,18,34,47.1%,32m
17623,2,太平洋的天空,2574,399,15,14,29,51.7%,1h
17623,2,白酱油,2574,316,12,14,26,46.2%,48m
17623,3,SWORD,2574,232,6,13,19,31.6%,15m
17623,2,[荒芜岁月]迷失的小孩,2574,122,5,5,10,50.0%,18m
17623,2,XXBEST,2574,129,5,8,13,38.5%,1h
17623,2,[西伯利亚土豆]Probe,2574,154,4,4,8,50.0%,45m
17623,2,风吹蛋凉,2574,102,3,0,3,100.0%,1h
17623,2,吃豆子的鱼,2574,58,3,2,5,60.0%,39m
17623,3,Experate,2574,0,3,3,6,50.0%,1h
17623,1,清风析雨,2574,0,2,1,3,66.7%,39m
17623,2,[RUADIU]EnTaroRedT,2574,114,2,2,4,50.0%,37m
17623,2,[嗜魂舰队]卡尔哦皮,2574,30,2,5,7,28.6%,35m
17623,3,fuyixin,2574,0,1,0,1,100.0%,1h
17623,2,撕裂光芒,2574,88,1,2,3,33.3%,30m
17623,2,[DDOS傲世]魅影,2574,0,0,1,1,0.0%,14m
17623,1,zzz,2574,0,0,1,1,0.0%,5m
17646,1,diaobulaji,2573,1638,263,258,521,50.5%,21m
17646,2,[虚空守望]bacteria,2573,572,22,17,39,56.4%,35m
17646,2,水滴,2573,510,20,21,41,48.8%,17m
17646,1,流动红旗,2573,441,20,24,44,45.5%,37m
17646,2,[初来闸刀]samyang,2573,490,17,16,33,51.5%,1h
17646,2,[要啥没啥爱咋]driverxdw,2573,420,15,17,32,46.9%,1h
17646,2,小坦克,2573,242,14,12,26,53.8%,8m
17646,2,sochralar,2573,343,12,11,23,52.2%,1h
17646,2,燃帝,2573,298,11,11,22,50.0%,1h
17646,1,fearless,2573,287,10,10,20,50.0%,4m
17646,3,雪糕,2573,114,4,1,5,80.0%,13m
17646,2,跳跳气球,2573,120,4,6,10,40.0%,1h
17646,2,[浪啊浪]野人王,2573,86,3,3,6,50.0%,1h
17646,2,大哉乾元,2573,90,3,5,8,37.5%,8m
17646,2,[战旗第9分队]大花,2573,42,2,2,4,50.0%,1h
17646,1,萌太奇,2573,76,2,9,11,18.2%,30m
17646,3,[鲁德欢]次元骇客,2573,0,1,0,1,100.0%,15m
17646,3,ANT,2573,0,1,1,2,50.0%,1h
17646,3,水轉雪中冰,2573,0,0,1,1,0.0%,1h
17646,3,[黑森峰卐学院]弃坑菜鸟,2573,0,0,1,1,0.0%,37m
17646,3,酒冷烛跋,2573,0,0,1,1,0.0%,1h
17646,2,[眼一闭]大海,2573,0,0,2,2,0.0%,1h
17668,3,[探索]邪恶的大狼,2572,1494,89,90,179,49.7%,5m
17668,2,cwcr,2572,829,36,32,68,52.9%,48m
17668,2,[小小怪怪]ghostin,2572,986,35,39,74,47.3%,27m
17668,2,不热的热水很冷,2572,578,24,16,40,60.0%,1h
17668,2,HeidiQ,2572,480,18,19,37,48.6%,58m
17668,1,[M416]微风,2572,415,16,21,37,43.2%,30m
17668,1,[KOKOKO]苍井空,2572,474,14,18,32,43.8%,56m
17668,2,[学生妹]我是酷弟,2572,369,13,15,28,46.4%,52m
17668,1,奇奇怪怪的人,2572,303,10,12,22,45.5%,59m
17668,1,[重新集结虫群]wer,2572,317,10,12,22,45.5%,5m
17668,3,Thornfield,2572,177,9,2,11,81.8%,1h
17668,2,[翔安小分队]oGsMC,2572,140,5,3,8,62.5%,1h
17668,2,长生,2572,32,5,7,12,41.7%,31m
17668,3,时光修补匠托奇,2572,86,4,0,4,100.0%,29m
17668,3,[帝国反叛军]人族最强近战,2572,162,4,1,5,80.0%,45m
17668,2,物种,2572,173,4,5,9,44.4%,1h
17668,2,shana,2572,118,3,1,4,75.0%,38m
17668,2,白鼠的丢人进度,2572,131,3,2,5,60.0%,27m
17668,2,上官若曦,2572,0,3,5,8,37.5%,1h
17668,2,Gemini,2572,0,3,7,10,30.0%,47m
17668,3,ElecTricKiss,2572,36,2,2,4,50.0%,1h
17668,3,答禄所罗,2572,0,2,4,6,33.3%,25m
17668,3,风暴之灵,2572,30,1,1,2,50.0%,1h
17668,3,蓝紫色的云,2572,0,0,1,1,0.0%,19m
17668,3,[HTW]boycott,2572,0,0,1,1,0.0%,1h
17668,1,舰队争霸,2572,0,0,7,7,0.0%,40m
17694,1,fairwinner,2571,1638,116,117,233,49.8%,1h
17694,1,花钱日下死,2571,179,18,21,39,46.2%,37m
17694,3,Tohka,2571,145,4,5,9,44.4%,11m
17694,2,OHMAZIO,2571,137,4,7,11,36.4%,1h
17694,3,UEDugalle,2571,58,3,0,3,100.0%,39m
17694,1,youyou,2571,92,2,0,2,100.0%,32m
17694,3,blue,2571,30,1,1,2,50.0%,1h
17694,3,[龙宫礼奈]yuanyuan,2571,30,1,1,2,50.0%,1h
17694,3,[火焰钱赞企]过期瓶装酱油,2571,30,1,1,2,50.0%,38m
17694,3,siru,2571,0,1,3,4,25.0%,1h
17694,2,ckmanliilll,2571,30,1,4,5,20.0%,1h
17694,1,欢零的回忆,2571,0,0,1,1,0.0%,8m
17694,2,皇家坑队友,2571,0,0,2,2,0.0%,5m
17694,3,[8K白丝弱音]Allen,2571,0,0,3,3,0.0%,1h
17694,2,猫王,2571,0,0,5,5,0.0%,1h
17709,1,yooooo,2570,1532,238,231,469,50.7%,54m
17709,3,狂奔的蜗牛,2570,681,151,145,296,51.0%,1h
17709,2,六把尺子,2570,1473,136,130,266,51.1%,1h
17709,2,彭立辉,2570,1281,62,57,119,52.1%,38m
17709,2,KLOSE,2570,327,13,9,22,59.1%,52m
17709,2,笑容背后丶乐逍遥,2570,176,5,4,9,55.6%,1h
17709,3,我其实不是菜鸟,2570,40,2,2,4,50.0%,7m
17709,1,zhizhi,2570,115,2,3,5,40.0%,1h
17709,2,打我死全家,2570,64,2,4,6,33.3%,49m
17709,2,[DMRe]DARKSOULS,2570,0,1,1,2,50.0%,1h
17709,3,游戏界的二哈,2570,30,1,1,2,50.0%,20m
17709,2,我好菜啊,2570,32,1,5,6,16.7%,1h
17709,3,[津富会]祈灬,2570,0,0,1,1,0.0%,19m
17709,2,[拍大片]甲方爸爸,2570,0,0,2,2,0.0%,1h
17723,1,llllllllllll,2569,564,93,104,197,47.2%,15m
17723,3,灭霸,2569,427,67,58,125,53.6%,8m
17723,2,[DSE]啵啵鸡,2569,1233,56,49,105,53.3%,1h
17723,2,[龙语冰川]龙语者冰兰,2569,680,31,21,52,59.6%,1h
17723,1,一杯百事汽水,2569,596,21,22,43,48.8%,12m
17723,1,swanzn,2569,549,21,26,47,44.7%,1h
17723,1,暗玉,2569,476,20,21,41,48.8%,1h
17723,2,mdc,2569,454,16,19,35,45.7%,1h
17723,3,冀夜,2569,211,16,25,41,39.0%,30m
17723,2,[广州美术学院]中华古拳法,2569,314,13,6,19,68.4%,1h
17723,2,游侠小学生,2569,307,13,10,23,56.5%,1h
17723,1,刘哥,2569,344,13,17,30,43.3%,46m
17723,2,die,2569,291,11,9,20,55.0%,27m
17723,2,[工程萌男]月曲,2569,84,5,4,9,55.6%,50m
17723,3,成小雨哥,2569,147,5,12,17,29.4%,28m
17723,3,[mafia2]theologian,2569,88,4,1,5,80.0%,19m
17723,3,西湖孙一峰的迷弟,2569,97,2,0,2,100.0%,19m
17723,2,二零二零脱单成功,2569,76,2,1,3,66.7%,1h
17723,3,lllllllll,2569,30,2,1,3,66.7%,8m
17723,1,大叉马,2569,0,2,3,5,40.0%,39m
17723,3,[XYFANS]你们别过来,2569,0,2,4,6,33.3%,1h
17723,1,[科普卢拆迁办]一叶一菩提,2569,97,2,5,7,28.6%,12m
17723,3,不会玩别来贰打贰,2569,38,2,5,7,28.6%,39m
17723,3,smaerdteews,2569,0,1,0,1,100.0%,19m
17723,2,糖果屋,2569,88,1,2,3,33.3%,60m
17723,2,[死宅同盟会]三闯虎牢关,2569,0,1,4,5,20.0%,8m
17723,3,[专业de团队]泰伦永远在白给,2569,0,0,1,1,0.0%,54m
17723,2,AFU,2569,0,0,2,2,0.0%,9m
17723,1,JACK,2569,0,0,7,7,0.0%,30m
17752,2,[我好冷]鲁哥威武,2568,822,116,109,225,51.6%,1h
17752,2,[tyyt]天依,2568,1609,107,103,210,51.0%,9m
17752,2,确实离谱,2568,545,38,34,72,52.8%,37m
17752,2,那个啥棒槌,2568,845,35,31,66,53.0%,17m
17752,1,AAA,2568,486,21,25,46,45.7%,30m
17752,2,MitakeBot,2568,240,9,6,15,60.0%,18m
17752,3,Sky,2568,145,7,2,9,77.8%,5m
17752,2,Diors,2568,169,6,5,11,54.5%,60m
17752,3,[飞院]金属狂潮,2568,88,4,1,5,80.0%,27m
17752,3,清濁,2568,72,4,6,10,40.0%,7m
17752,3,少林功夫好真滴好,2568,104,4,10,14,28.6%,5m
17752,2,[电气游龙]暗隐羿,2568,60,3,5,8,37.5%,1h
17752,3,其实我是中国人,2568,40,3,5,8,37.5%,39m
17752,3,morning,2568,40,3,5,8,37.5%,28m
17752,1,提尔比茨,2568,103,3,6,9,33.3%,1h
17752,3,tension,2568,0,2,4,6,33.3%,14m
17752,3,xukong,2568,0,2,4,6,33.3%,1h
17752,3,[星际手残党]捞的嘛淌口水,2568,0,1,0,1,100.0%,14m
17752,3,[古明地嗪]黄豆奶油包,2568,0,1,0,1,100.0%,59m
17752,3,YuiHatano,2568,0,1,5,6,16.7%,28m
17752,3,[TZPer]liu,2568,0,0,1,1,0.0%,1h
17752,2,[乾龙]沐颜,2568,0,0,2,2,0.0%,27m
17774,1,[皮断腿]孝悌,2567,1556,83,89,172,48.3%,21m
17774,2,火车侠,2567,1404,55,59,114,48.2%,1h
17774,1,alexu,2567,966,45,46,91,49.5%,23m
17774,2,[鹌鹑带星]喔系小百兔,2567,821,37,24,61,60.7%,1h
17774,1,[AICa]PZdog,2567,613,28,29,57,49.1%,21m
17774,1,井矿盐,2567,481,18,18,36,50.0%,56m
17774,2,[幽冥之狼]spuerman,2567,348,12,13,25,48.0%,37m
17774,1,风居住的街道,2567,222,9,13,22,40.9%,1h
17774,2,yby,2567,233,7,8,15,46.7%,1h
17774,2,快抱抱豹豹宝宝,2567,218,7,10,17,41.2%,1h
17774,2,缘狮,2567,110,4,6,10,40.0%,1h
17774,3,zgc,2567,30,3,5,8,37.5%,49m
17774,1,Gostarship,2567,64,3,6,9,33.3%,1h
17774,1,芝麻果子,2567,0,2,3,5,40.0%,1h
17774,1,漫天飞舞,2567,0,1,3,4,25.0%,36m
17774,2,小李,2567,0,0,2,2,0.0%,1h
17774,2,only,2567,0,0,2,2,0.0%,23m
17774,2,helloKitty,2567,0,0,3,3,0.0%,39m
17792,2,少来烦我,2566,418,39,35,74,52.7%,8m
17792,1,寒辰飒沓,2566,634,33,34,67,49.3%,58m
17792,2,LoveCash,2566,368,22,21,43,51.2%,1h
17792,2,李朝阳自豪,2566,428,15,18,33,45.5%,18m
17792,2,栖奚,2566,348,12,17,29,41.4%,1h
17792,1,发胶过多,2566,182,6,11,17,35.3%,23m
17792,3,永恒,2566,190,5,2,7,71.4%,1h
17792,1,xiaoka,2566,86,5,8,13,38.5%,9m
17792,2,鱼鱼鱼鱼于,2566,114,3,1,4,75.0%,45m
17792,1,兰陵笑笑生,2566,48,3,3,6,50.0%,6m
17792,2,[魔法少女小屋]EXmachina,2566,126,3,4,7,42.9%,1h
17792,2,Mitterora,2566,46,2,4,6,33.3%,1h
17792,3,[CnNami]阿萨德,2566,0,1,0,1,100.0%,1h
17792,3,[FF2f1A]你的当当,2566,0,1,0,1,100.0%,1h
17792,3,陌七,2566,0,1,2,3,33.3%,1h
17792,2,[黑蝙蝠]啪啪啪,2566,0,1,4,5,20.0%,48m
17792,3,[童话]jikai,2566,0,0,1,1,0.0%,50m
17792,3,FFF,2566,0,0,1,1,0.0%,20m
17792,2,遗忘之沙,2566,0,0,2,2,0.0%,1h
17811,2,舒心雨,2565,1303,1350,1335,2685,50.3%,4m
17811,2,[中年城管兵团]cazi,2565,1719,619,617,1236,50.1%,47m
17811,1,右手爱人,2565,1541,389,384,773,50.3%,22m
17811,1,bumblebee,2565,1251,145,133,278,52.2%,48m
17811,2,shoWTIMe,2565,1484,67,63,130,51.5%,17m
17811,3,Xros,2565,1011,47,35,82,57.3%,9m
17811,1,阿库西斯教徒,2565,265,45,45,90,50.0%,45m
17811,2,停电了怎么办,2565,872,32,33,65,49.2%,60m
17811,1,parkchoron,2565,908,28,50,78,35.9%,20m
17811,3,[开军舰]ChrisCarrie,2565,470,18,18,36,50.0%,27m
17811,2,啦啦啦,2565,292,12,7,19,63.2%,17m
17811,3,[DTOC]LxVotre,2565,374,12,14,26,46.2%,1h
17811,3,[芜湖起飞飞]黑海之神,2565,331,11,13,24,45.8%,28m
17811,1,[永恒幻想乡]叶初夏,2565,264,9,10,19,47.4%,23m
17811,1,[第九舰队丶]小玉米面条,2565,200,7,11,18,38.9%,1h
17811,2,神的化身,2565,216,7,11,18,38.9%,1h
17811,2,tiges,2565,190,6,4,10,60.0%,1h
17811,3,年老老主宰,2565,214,6,6,12,50.0%,1h
17811,3,Croc,2565,122,4,3,7,57.1%,1h
17811,2,总有队友想害朕,2565,184,4,6,10,40.0%,1h
17811,2,[苏维埃红军]MUYU,2565,146,3,4,7,42.9%,59m
17811,1,软泥人,2565,0,2,3,5,40.0%,1h
17811,3,THEFORCE,2565,0,2,4,6,33.3%,1h
17811,3,Eric,2565,0,1,0,1,100.0%,1h
17811,3,我太难了,2565,0,1,0,1,100.0%,51m
17811,2,[Months]鸭子,2565,0,1,1,2,50.0%,31m
17811,3,njynw,2565,30,1,1,2,50.0%,1h
17811,3,成大大,2565,0,0,1,1,0.0%,21m
17811,3,[DNF]曦晨,2565,0,0,1,1,0.0%,1h
17811,3,[神辉天耀]某魔法的中野梓,2565,0,0,1,1,0.0%,25m
17811,1,叶逝羽,2565,0,0,1,1,0.0%,1h
17811,1,[追猎成员]清弃,2565,0,0,1,1,0.0%,36m
17811,2,jqylove,2565,0,0,3,3,0.0%,1h
17811,1,[HFV]月酱,2565,0,0,4,4,0.0%,17m
17845,3,[热能]catman,2564,1164,112,110,222,50.5%,26m
17845,2,大海的对面是敌人,2564,925,64,57,121,52.9%,30m
17845,2,SeverVenm,2564,886,43,24,67,64.2%,27m
17845,2,无头吃货三,2564,580,40,37,77,51.9%,46m
17845,2,白门楼卫星,2564,310,12,11,23,52.2%,35m
17845,2,[Borne]叶修,2564,276,9,8,17,52.9%,1h
17845,2,又菜又爱玩,2564,308,9,11,20,45.0%,46m
17845,2,Hyperion,2564,238,9,14,23,39.1%,1h
17845,1,有饭吃,2564,228,8,11,19,42.1%,51m
17845,2,HcyDD,2564,119,6,3,9,66.7%,35m
17845,2,深墨丶,2564,146,4,2,6,66.7%,31m
17845,2,战网,2564,0,3,5,8,37.5%,1h
17845,2,[大鸟]卡仕达,2564,88,2,1,3,66.7%,50m
17845,3,[萌的一笔]为了联盟,2564,30,1,1,2,50.0%,21m
17845,3,drakedog,2564,30,1,1,2,50.0%,1h
17845,1,Gloryforever,2564,42,1,10,11,9.1%,1h
17845,3,[KRG]追赶追赶者,2564,0,0,1,1,0.0%,1h
17845,2,[投降也不抵抗]yimq,2564,0,0,1,1,0.0%,1h
17845,3,东大宫不相信眼泪,2564,0,0,1,1,0.0%,59m
17864,2,wen,2563,1590,219,229,448,48.9%,28m
17864,2,[我们是无敌的]吴迪,2563,1527,57,67,124,46.0%,50m
17864,3,吾乃小凯乐,2563,782,55,38,93,59.1%,45m
17864,2,lalala,2563,620,23,20,43,53.5%,60m
17864,2,弱小的普洛陀斯,2563,411,16,21,37,43.2%,31m
17864,3,飞翔的小鸟,2563,398,15,10,25,60.0%,30m
17864,1,人渣,2563,352,14,15,29,48.3%,20m
17864,2,老子就是心软,2563,344,12,15,27,44.4%,1h
17864,3,[倥偬]Zangll,2563,278,10,9,19,52.6%,51m
17864,2,[莫缇纳]大侠,2563,250,8,7,15,53.3%,32m
17864,2,云无痕,2563,210,7,10,17,41.2%,35m
17864,1,XXjunshi,2563,164,5,5,10,50.0%,1h
17864,2,神杀殇,2563,20,4,6,10,40.0%,57m
17864,3,白银之影,2563,92,3,2,5,60.0%,10m
17864,3,黑白信仰,2563,40,3,5,8,37.5%,1h
17864,1,冰镇锦鲤,2563,108,3,7,10,30.0%,20m
17864,1,shiqiuning,2563,0,2,3,5,40.0%,9m
17864,3,[大主教后援团]梦瑞达,2563,0,1,1,2,50.0%,53m
17864,2,FLAME,2563,0,1,1,2,50.0%,47m
17864,1,超级指挥官,2563,0,1,4,5,20.0%,1h
17864,3,lllllllllwx,2563,97,1,6,7,14.3%,1h
17864,3,[战意不熄]叹云兮,2563,0,0,1,1,0.0%,43m
17886,2,超级爸爸,2562,1576,119,122,241,49.4%,48m
17886,2,[蓝天白云]未闻花名,2562,814,32,31,63,50.8%,52m
17886,1,榆垄,2562,626,21,30,51,41.2%,1h
17886,3,菜的真实,2562,483,20,4,24,83.3%,1h
17886,3,star,2562,359,13,9,22,59.1%,29m
17886,1,Wen,2562,195,13,13,26,50.0%,38m
17886,2,TriStone,2562,188,10,7,17,58.8%,58m
17886,2,AAAJOY,2562,128,4,2,6,66.7%,32m
17886,1,[小鸡屠宰场3]安泰孙一峰,2562,96,4,11,15,26.7%,37m
17886,3,九天玄尊,2562,86,3,1,4,75.0%,8m
17886,2,过犹不及,2562,114,3,2,5,60.0%,27m
17886,1,[暴雪三十一队]云狂风虐,2562,100,3,11,14,21.4%,1h
17886,3,Ein,2562,0,2,4,6,33.3%,11m
17886,2,庄周,2562,0,1,1,2,50.0%,31m
17886,2,WELLDONE,2562,42,1,3,4,25.0%,25m
17901,1,河南因脑为什,2561,1284,92,90,182,50.5%,34m
17901,1,拒当谐星,2561,1154,42,43,85,49.4%,48m
17901,1,iiiiiiiiiiii,2561,452,19,16,35,54.3%,48m
17901,1,明日,2561,532,17,23,40,42.5%,8m
17901,2,DarkParrot,2561,415,16,12,28,57.1%,1h
17901,3,KTunicorn,2561,440,16,17,33,48.5%,48m
17901,2,[就这就这]Cephedra,2561,122,6,8,14,42.9%,1h
17901,2,左手吃面条,2561,46,4,6,10,40.0%,1h
17901,3,[华夏何平]蓝冰浩,2561,30,2,0,2,100.0%,1h
17901,1,旅行家,2561,0,2,2,4,50.0%,1h
17901,2,[WLSA]TimWu,2561,42,2,3,5,40.0%,1h
17901,1,sakura,2561,0,2,3,5,40.0%,1h
17901,1,[暴雪线上实测]玩铁拳亲妈爆炸,2561,0,1,0,1,100.0%,43m
17901,2,GoldKiller,2561,0,0,4,4,0.0%,1h
17915,2,[TUF]魂牵冰点,2560,897,87,96,183,47.5%,6m
17915,3,ZNScudGT,2560,869,55,66,121,45.5%,48m
17915,3,泰伯尔同族体,2560,697,54,58,112,48.2%,16m
17915,3,THISISNPC,2560,799,51,54,105,48.6%,19m
17915,1,帷羡,2560,303,40,33,73,54.8%,23m
17915,1,茶树咕,2560,998,39,35,74,52.7%,1h
17915,2,AMDyes,2560,645,29,16,45,64.4%,19m
17915,3,[埃蒙打的好呀]炽天使之魂,2560,737,29,22,51,56.9%,20m
17915,1,[打死不修放空]雪铁龙,2560,670,27,23,50,54.0%,34m
17915,2,心若向阳何惧悲伤,2560,385,22,18,40,55.0%,35m
17915,2,[嗯哼嗯啊啊啊]夜问,2560,298,16,13,29,55.2%,1h
17915,3,[暴赱总司令]虚空结晶,2560,469,16,23,39,41.0%,28m
17915,2,开水,2560,400,14,12,26,53.8%,19m
17915,1,安康,2560,451,14,20,34,41.2%,20m
17915,3,GGGxxx,2560,292,12,7,19,63.2%,1h
17915,2,一切如风,2560,344,11,12,23,47.8%,45m
17915,1,统三族,2560,258,8,8,16,50.0%,1h
17915,2,我能咋整,2560,174,7,4,11,63.6%,1h
17915,2,KKAZ,2560,184,7,11,18,38.9%,56m
17915,3,JZY,2560,30,5,3,8,62.5%,39m
17915,1,極楓,2560,153,5,7,12,41.7%,12m
17915,3,你是不是个沙雕,2560,97,4,3,7,57.1%,19m
17915,3,SKTfaker,2560,122,4,5,9,44.4%,1h
17915,2,青铜连胜王,2560,110,4,6,10,40.0%,56m
17915,2,[夜烬十字]香烟陪伴我,2560,56,3,3,6,50.0%,31m
17915,2,Snow,2560,129,3,3,6,50.0%,1h
17915,3,[长夜将至]hehuaqi,2560,36,3,5,8,37.5%,35m
17915,1,天降暗星,2560,44,2,1,3,66.7%,37m
17915,2,[钢铁远征军]Falsec,2560,0,1,0,1,100.0%,48m
17915,3,暴雪爷爷,2560,0,1,1,2,50.0%,1h
17915,3,十七,2560,0,1,1,2,50.0%,25m
17915,3,陈镶羽,2560,0,0,1,1,0.0%,9m
17947,1,[傻妞]机械化说声我就退,2559,1549,150,152,302,49.7%,48m
17947,2,TywysogCymru,2559,1452,60,58,118,50.8%,19m
17947,1,卑鄙的我,2559,1027,40,40,80,50.0%,16m
17947,2,岛田二傻,2559,741,29,28,57,50.9%,27m
17947,2,jia,2559,597,24,29,53,45.3%,1h
17947,1,[FernaL]IllIIllllIlI,2559,373,14,19,33,42.4%,1h
17947,2,kerwin,2559,234,8,14,22,36.4%,52m
17947,3,凉着,2559,154,6,18,24,25.0%,15m
17947,2,[迷宫丨极限组]LWH,2559,194,5,4,9,55.6%,1h
17947,2,[PhoCo]PhoSelect,2559,140,4,3,7,57.1%,60m
17947,2,[QFD]网骗梅林,2559,30,2,2,4,50.0%,45m
17947,2,[萌新绞肉机]凯皇,2559,102,2,2,4,50.0%,35m
17947,2,何明涛,2559,30,1,3,4,25.0%,27m
17947,1,[花下]百合花下的剑士,2559,0,0,1,1,0.0%,1h
17947,1,BiliLake,2559,0,0,1,1,0.0%,1h
17962,2,龙与僵尸和骑士,2558,1310,149,155,304,49.0%,1h
17962,1,苍天心剑,2558,1562,117,119,236,49.6%,1h
17962,1,竖锯,2558,812,34,30,64,53.1%,1h
17962,1,战斧,2558,801,27,30,57,47.4%,37m
17962,3,辛格,2558,583,23,16,39,59.0%,39m
17962,1,[TFA]咬咬牙不说话,2558,543,19,24,43,44.2%,44m
17962,3,[最菜战队]Zerg,2558,441,17,8,25,68.0%,9m
17962,2,千羊斩谦卑,2558,366,14,13,27,51.9%,1h
17962,2,[T阴吧]开心的名字,2558,382,13,21,34,38.2%,26m
17962,2,风中凌乱,2558,216,7,13,20,35.0%,52m
17962,2,[小仙女已上线]分分钟钟,2558,128,4,2,6,66.7%,1h
17962,2,funeral,2558,46,4,7,11,36.4%,1h
17962,1,炸鱼没妈,2558,132,4,12,16,25.0%,20m
17962,1,阿离,2558,0,3,2,5,60.0%,1h
17962,2,[世界大战]飘零落英,2558,60,3,5,8,37.5%,1h
17962,1,铁血丶英魂,2558,0,1,0,1,100.0%,13m
17962,1,WEIKUN,2558,0,0,1,1,0.0%,1h
17979,2,mlfs,2557,1597,153,151,304,50.3%,27m
17979,2,adidas,2557,943,39,34,73,53.4%,46m
17979,1,五十二区,2557,771,31,32,63,49.2%,56m
17979,2,必哥,2557,664,26,21,47,55.3%,11m
17979,2,克哈,2557,626,25,22,47,53.2%,1h
17979,2,zeallaez,2557,197,14,11,25,56.0%,60m
17979,3,[镜花水月]独步,2557,310,14,11,25,56.0%,1h
17979,3,打死你个龟孙,2557,211,10,5,15,66.7%,38m
17979,2,阿姬伊莲,2557,207,8,8,16,50.0%,16m
17979,3,寒暄小冥,2557,196,6,6,12,50.0%,42m
17979,2,moon,2557,194,6,7,13,46.2%,47m
17979,3,我就是我嚼嚼,2557,32,5,3,8,62.5%,8m
17979,2,[软萌甜小萝莉]笛卡尔公式,2557,116,3,3,6,50.0%,1h
17979,3,[澪不法之徒]小哲爱丶玩游戏,2557,38,2,2,4,50.0%,1h
17979,3,梅赛施密特,2557,0,2,4,6,33.3%,1h
17979,1,[埃蒙保护所]皇家空军,2557,30,2,8,10,20.0%,15m
17979,2,希望之光,2557,0,1,1,2,50.0%,18m
17979,3,[生生不息]普通人机,2557,0,0,1,1,0.0%,1h
17979,3,[我最爱种土豆]英霸斯耐克,2557,0,0,1,1,0.0%,27m
17979,2,darkness,2557,0,0,2,2,0.0%,31m
17999,1,[六芒星]黑曼巴,2556,1515,198,202,400,49.5%,10m
17999,2,朝花夕拾,2556,527,26,27,53,49.1%,1h
17999,2,[CPT]ALTER,2556,446,17,17,34,50.0%,58m
17999,1,[艾尔之主]IIIIIIII,2556,438,15,22,37,40.5%,53m
17999,1,尔瓦夫,2556,208,8,9,17,47.1%,1h
17999,2,Ash,2556,143,4,7,11,36.4%,26m
17999,2,[HTW]海蓝鲸,2556,90,4,8,12,33.3%,1h
17999,1,WooHUKA,2556,130,3,1,4,75.0%,1h
17999,2,空军一号,2556,96,3,8,11,27.3%,8m
17999,3,训练有素的医生,2556,72,2,4,6,33.3%,1h
17999,3,RomanReigns,2556,0,2,4,6,33.3%,1h
17999,2,[去玩儿退欧]zero,2556,0,1,1,2,50.0%,48m
17999,3,敢杀我的马,2556,0,1,1,2,50.0%,1h
17999,1,溶于灵魂,2556,0,0,1,1,0.0%,21m
17999,3,随手乱打就是名字,2556,0,0,3,3,0.0%,45m
18014,3,FKsoon,2555,1716,485,513,998,48.6%,30m
18014,2,[星际大镖客]Nobody,2555,744,90,102,192,46.9%,26m
18014,1,阳哥,2555,1259,51,42,93,54.8%,48m
18014,3,银镞,2555,961,38,34,72,52.8%,27m
18014,2,武汉刘德华,2555,701,29,23,52,55.8%,56m
18014,1,jimmy,2555,688,29,30,59,49.2%,46m
18014,2,暮雨哀霜,2555,251,22,16,38,57.9%,30m
18014,2,FOX,2555,364,17,13,30,56.7%,37m
18014,3,奥八马,2555,224,7,3,10,70.0%,9m
18014,2,[Strike]一旦设定将无法更,2555,179,5,6,11,45.5%,11m
18014,3,梦醒时分醉清晨,2555,90,4,2,6,66.7%,5m
18014,3,[蓝鲸舰队]长笛一声人倚楼,2555,0,1,0,1,100.0%,21m
18014,1,skyfly,2555,0,0,2,2,0.0%,1h
18014,2,[OPD]ZAQ,2555,0,0,2,2,0.0%,1h
18014,2,咆哮的小花鸡,2555,0,0,3,3,0.0%,1h
18029,1,woshinba,2554,1615,243,222,465,52.3%,1h
18029,1,Caipc,2554,1040,38,40,78,48.7%,37m
18029,2,[斗鱼祁铭菌]wwwwwwwww,2554,897,35,31,66,53.0%,48m
18029,3,[小仙女上线啦]zyd,2554,725,31,19,50,62.0%,30m
18029,2,虚空无限,2554,363,31,24,55,56.4%,32m
18029,2,开错车的老司机,2554,336,23,23,46,50.0%,30m
18029,2,[银河舰队]巴西,2554,387,16,16,32,50.0%,18m
18029,2,赫赫战神,2554,345,15,10,25,60.0%,19m
18029,1,[西湖雅座]古地明恋,2554,324,9,18,27,33.3%,46m
18029,1,奉先,2554,269,7,9,16,43.8%,1h
18029,3,PurpleNight,2554,175,5,4,9,55.6%,23m
18029,1,[两千一次]援气少女液液酱,2554,145,3,4,7,42.9%,39m
18029,3,[女神惊叹]Lunamiracle,2554,30,2,0,2,100.0%,38m
18029,2,Country,2554,32,2,6,8,25.0%,35m
18029,3,raistlin,2554,0,1,0,1,100.0%,1h
18029,3,里擦的森,2554,0,1,1,2,50.0%,1h
18029,2,我是谁,2554,0,1,1,2,50.0%,1h
18029,2,西野七濑,2554,88,1,2,3,33.3%,1h
18029,3,黄芽菜,2554,0,0,1,1,0.0%,38m
18029,3,龙鸣熏,2554,0,0,1,1,0.0%,1h
18029,2,屋里超超,2554,0,0,5,5,0.0%,56m
18029,1,TwinShadows,2554,0,0,5,5,0.0%,4m
18051,2,圣域王者,2553,1596,189,182,371,50.9%,60m
18051,2,白给大主教,2553,1021,45,32,77,58.4%,8m
18051,2,摄血倾城,2553,806,29,33,62,46.8%,37m
18051,1,天上的二郎君,2553,582,27,18,45,60.0%,34m
18051,2,FIRE,2553,566,20,25,45,44.4%,1h
18051,3,IceCoco,2553,498,19,16,35,54.3%,21m
18051,1,DYLAN,2553,410,15,20,35,42.9%,1h
18051,3,飞垫,2553,388,14,25,39,35.9%,9m
18051,3,[TOKYO]Sakura,2553,212,13,10,23,56.5%,50m
18051,2,JXX,2553,336,11,14,25,44.0%,11m
18051,2,[一个菜鸡]索罗斯门徒,2553,178,7,7,14,50.0%,1h
18051,3,如月之恒,2553,140,6,3,9,66.7%,1h
18051,2,我的星空,2553,130,5,4,9,55.6%,9m
18051,1,Zaia,2553,154,4,4,8,50.0%,8m
18051,1,STONE,2553,0,3,2,5,60.0%,39m
18051,2,[loveMM]陈紫莹,2553,66,3,3,6,50.0%,1h
18051,3,Xiapopo,2553,0,2,3,5,40.0%,1h
18051,3,Yestin,2553,0,1,0,1,100.0%,38m
18051,3,zrt,2553,0,1,0,1,100.0%,27m
18051,3,tiansky,2553,97,1,2,3,33.3%,1h
18051,1,[丨SLT丨]memory,2553,95,1,3,4,25.0%,9m
18051,3,弃疗型熊猫,2553,0,0,1,1,0.0%,1h
18051,2,眇之鱼,2553,0,0,6,6,0.0%,1h
18074,1,[暴雪养鸡场]安妮海瑟云鹏,2552,1609,350,331,681,51.4%,30m
18074,2,dazazi,2552,1551,323,324,647,49.9%,1h
18074,2,ShadowWalker,2552,847,116,103,219,53.0%,19m
18074,1,刚到初夏,2552,1121,59,47,106,55.7%,48m
18074,2,[loveMM]邪气萌燃,2552,560,26,15,41,63.4%,48m
18074,1,[七宫智音]艾尔之霜,2552,590,24,19,43,55.8%,15m
18074,2,chinaNOone,2552,366,13,11,24,54.2%,37m
18074,3,顺顺,2552,329,12,9,21,57.1%,1h
18074,2,各位打扰了,2552,308,12,9,21,57.1%,1h
18074,3,战地豪猪,2552,200,8,5,13,61.5%,8m
18074,2,JOJO,2552,212,5,6,11,45.5%,1h
18074,2,唱跳蔡旭坤,2552,90,4,4,8,50.0%,8m
18074,3,张起咩,2552,146,4,4,8,50.0%,1h
18074,3,Lico,2552,64,3,1,4,75.0%,27m
18074,2,站到我身后,2552,86,3,5,8,37.5%,15m
18074,2,[某不知名鸡场]长歌之行点,2552,0,3,5,8,37.5%,1h
18074,2,萝莉控,2552,88,2,5,7,28.6%,10m
18074,2,帝王是迪亚波罗哒,2552,0,1,1,2,50.0%,31m
18074,2,镜鬼,2552,95,1,1,2,50.0%,10m
18074,1,conqueror,2552,48,1,1,2,50.0%,42m
18074,2,黑绫,2552,0,1,2,3,33.3%,1h
18074,2,八重樱,2552,36,1,3,4,25.0%,1h
18074,3,天秀哦,2552,0,0,1,1,0.0%,21m
18074,2,[Guraye]Gurayer,2552,0,0,2,2,0.0%,1h
18074,2,指尖的感觉,2552,0,0,2,2,0.0%,18m
18074,3,榨菜三号,2552,0,0,4,4,0.0%,1h
18100,1,飞行的竹子,2551,1662,381,371,752,50.7%,20m
18100,1,[极限菜鸟]DREAMOON,2551,1533,167,150,317,52.7%,39m
18100,3,snowcity,2551,1532,111,107,218,50.9%,49m
18100,1,Dwan,2551,1527,88,95,183,48.1%,1h
18100,3,天工,2551,857,38,30,68,55.9%,1h
18100,3,DOUBISME,2551,594,36,22,58,62.1%,39m
18100,2,Tiramisu,2551,341,35,28,63,55.6%,17m
18100,3,相濡以沫,2551,641,24,22,46,52.2%,20m
18100,3,Chen,2551,504,19,12,31,61.3%,59m
18100,2,masks,2551,430,18,12,30,60.0%,1h
18100,2,[502]广陵王之风,2551,279,10,9,19,52.6%,1h
18100,2,百晓路,2551,306,10,10,20,50.0%,5m
18100,1,[极限菜鸟]鸡饲料,2551,159,5,5,10,50.0%,52m
18100,2,help,2551,86,5,8,13,38.5%,38m
18100,3,我只会乱跑,2551,58,3,1,4,75.0%,8m
18100,3,fdstged,2551,133,3,1,4,75.0%,35m
18100,1,[纳兰皇族]温柔的炭治郎,2551,0,3,2,5,60.0%,15m
18100,2,[realY]bluefive,2551,114,2,4,6,33.3%,1h
18100,3,搞事专家,2551,0,1,0,1,100.0%,14m
18100,3,手残骚年,2551,30,1,1,2,50.0%,1h
18100,1,风靡,2551,0,0,2,2,0.0%,1h
18121,3,招风不招风,2550,997,142,152,294,48.3%,28m
18121,1,ssw,2550,1554,95,86,181,52.5%,1h
18121,2,老婆,2550,989,42,30,72,58.3%,1h
18121,2,newworld,2550,306,11,14,25,44.0%,47m
18121,3,醉西楼,2550,116,5,2,7,71.4%,1h
18121,2,天才小熊猫,2550,0,4,8,12,33.3%,1h
18121,2,KAMISAMANO,2550,94,3,6,9,33.3%,19m
18121,3,朝田诗乃,2550,34,2,3,5,40.0%,53m
18121,3,琉艺,2550,0,2,3,5,40.0%,1h
18121,3,沣少不会撩呀,2550,0,2,5,7,28.6%,1h
18121,3,doge,2550,30,1,1,2,50.0%,37m
18121,3,冷哥牛啊,2550,0,1,1,2,50.0%,1h
18121,3,CXL,2550,30,1,1,2,50.0%,44m
18121,2,sda,2550,0,1,4,5,20.0%,15m
18121,3,SouthKing,2550,0,0,1,1,0.0%,45m
18121,3,IIIIIII,2550,0,0,1,1,0.0%,59m
18121,3,GinToKI,2550,0,0,2,2,0.0%,1h
18138,3,花样的我,2549,1655,159,155,314,50.6%,16m
18138,2,烟不正,2549,1560,152,140,292,52.1%,1h
18138,1,[C97]DuangDuang,2549,1539,99,86,185,53.5%,56m
18138,1,eeeeeeeee,2549,1639,74,83,157,47.1%,15m
18138,2,大螺丝,2549,741,31,32,63,49.2%,11m
18138,1,不许黑大主教,2549,544,19,25,44,43.2%,1h
18138,3,[TeamGB]RainDrop,2549,391,15,18,33,45.5%,5m
18138,2,研月,2549,170,5,4,9,55.6%,59m
18138,2,Contra,2549,147,4,3,7,57.1%,1h
18138,1,holdyourfire,2549,0,2,3,5,40.0%,59m
18138,1,[萌佬同好会]暴君熊,2549,0,2,3,5,40.0%,48m
18138,3,[不朽殿堂]酒中坟,2549,0,1,1,2,50.0%,23m
18138,3,金孛孛,2549,0,1,1,2,50.0%,59m
18138,1,愤怒的奶牛,2549,94,1,2,3,33.3%,1h
18138,2,没有,2549,32,1,5,6,16.7%,15m
18138,3,[窃光]火蓝刀锋,2549,0,0,1,1,0.0%,1h
18138,3,成为凯瑞甘的男人,2549,0,0,1,1,0.0%,1h
18155,1,kevin,2548,1558,93,86,179,52.0%,17m
18155,2,TheEverLaS,2548,694,33,31,64,51.6%,58m
18155,2,TOTATM,2548,573,28,20,48,58.3%,8m
18155,2,未来的人族皇帝,2548,275,18,13,31,58.1%,50m
18155,3,狗我我就死,2548,366,13,13,26,50.0%,25m
18155,3,[头文字TB]TheGiao,2548,236,7,4,11,63.6%,1h
18155,3,[为了教父]疯猫,2548,171,7,5,12,58.3%,1h
18155,2,Otho,2548,152,6,11,17,35.3%,1h
18155,2,无敌的我,2548,179,5,8,13,38.5%,1h
18155,3,二泉映月,2548,102,5,8,13,38.5%,1h
18155,1,手打,2548,48,4,4,8,50.0%,11m
18155,3,IceTea,2548,142,3,1,4,75.0%,1h
18155,3,[626]艾尔,2548,86,3,2,5,60.0%,1h
18155,3,[麻酱罐]废柴麻酱,2548,30,2,0,2,100.0%,1h
18155,1,爱新觉罗轩爷,2548,0,2,1,3,66.7%,19m
18155,1,Nnnn,2548,0,2,3,5,40.0%,39m
18155,3,叫什么好了,2548,0,1,0,1,100.0%,53m
18155,2,伊诺,2548,0,1,2,3,33.3%,58m
18155,3,sirius,2548,0,0,1,1,0.0%,1h
18155,3,回眸往事丶叮叮,2548,0,0,1,1,0.0%,8m
18175,1,失明云玩家,2547,1249,111,110,221,50.2%,1h
18175,2,宝贝可欣,2547,1552,104,87,191,54.5%,17m
18175,3,聪明的蓝胖,2547,516,19,28,47,40.4%,19m
18175,2,RCzs,2547,482,16,21,37,43.2%,18m
18175,3,DaveXu,2547,328,12,7,19,63.2%,38m
18175,2,该用户非常懒,2547,254,11,10,21,52.4%,15m
18175,2,非世,2547,165,7,3,10,70.0%,39m
18175,2,[岩崩PMC]西域某宅,2547,175,6,3,9,66.7%,48m
18175,2,不准狗人,2547,122,5,8,13,38.5%,1h
18175,1,[Mtp]绝望中忘了使徒,2547,155,5,12,17,29.4%,1h
18175,3,alphaH,2547,74,4,7,11,36.4%,25m
18175,1,艾尔,2547,0,2,3,5,40.0%,36m
18175,3,[Sc养老]社会你烨哥,2547,0,1,0,1,100.0%,1h
18175,2,NoName,2547,32,1,6,7,14.3%,50m
18175,3,[宀窝斗宀]马浩僮,2547,0,0,1,1,0.0%,59m
18175,3,scv,2547,0,0,2,2,0.0%,1h
18175,3,超神的猪,2547,0,0,2,2,0.0%,30m
18175,2,lllilllillil,2547,0,0,2,2,0.0%,30m
18175,2,xxxx,2547,0,0,2,2,0.0%,1h
18175,2,[nmsLJP]Maru,2547,0,0,3,3,0.0%,1h
18195,1,Ghost,2546,1406,125,114,239,52.3%,46m
18195,2,CHUSHE,2546,1133,65,62,127,51.2%,38m
18195,3,LAOLI,2546,537,33,28,61,54.1%,19m
18195,2,哈喽卖地罚款,2546,678,27,23,50,54.0%,38m
18195,2,[loveMM]ruanoops,2546,342,13,12,25,52.0%,37m
18195,2,白夜,2546,237,11,6,17,64.7%,38m
18195,2,[BWP]DeltaT,2546,270,11,8,19,57.9%,37m
18195,1,[极限菜鸟]蚊子,2546,201,11,11,22,50.0%,17m
18195,2,遇见我就可以上分,2546,346,11,12,23,47.8%,1h
18195,2,[Flowex]这游戏没办法玩了,2546,235,8,8,16,50.0%,13m
18195,2,时崎狂三,2546,120,7,7,14,50.0%,1h
18195,3,[雅阁]虚空灬回忆,2546,157,4,7,11,36.4%,1h
18195,3,[传说萌鸡团]Leo,2546,58,3,2,5,60.0%,30m
18195,2,小新人,2546,102,3,2,5,60.0%,30m
18195,1,必睡团团,2546,0,3,2,5,60.0%,1h
18195,2,裴柱现你也杀,2546,94,3,8,11,27.3%,15m
18195,3,[舰队训练营]关晓琪,2546,30,2,0,2,100.0%,21m
18195,2,统一酸菜牛肉面,2546,88,2,1,3,66.7%,39m
18195,2,黄三二,2546,60,2,5,7,28.6%,58m
18195,3,帅怪我咯,2546,30,1,1,2,50.0%,30m
18195,1,[唯爱泰尼]浅唱似水柔情,2546,0,0,1,1,0.0%,1h
18195,3,叶子,2546,0,0,1,1,0.0%,27m
18195,1,禅智两字,2546,0,0,1,1,0.0%,1h
18195,2,被感染的探姬,2546,0,0,4,4,0.0%,47m
18219,2,超市热玉米,2545,1578,210,207,417,50.4%,31m
18219,3,白虎杰米杨,2545,1103,53,30,83,63.9%,1h
18219,2,[世界何平]毋忘,2545,929,48,38,86,55.8%,1h
18219,3,moshen,2545,738,34,40,74,45.9%,28m
18219,2,ATMHERO,2545,586,22,19,41,53.7%,9m
18219,1,[社交学小可爱]爱仕达,2545,528,19,25,44,43.2%,1h
18219,3,笑三少,2545,438,15,28,43,34.9%,14m
18219,2,[XCode]大鱼,2545,410,13,14,27,48.1%,39m
18219,1,草草丶,2545,235,10,12,22,45.5%,1h
18219,3,环彩羽,2545,266,8,5,13,61.5%,30m
18219,3,我是鸡,2545,189,6,1,7,85.7%,38m
18219,1,[死亡降临]火星骑士,2545,166,6,10,16,37.5%,53m
18219,3,[细水长流]幽星,2545,145,4,3,7,57.1%,1h
18219,3,sekai,2545,37,4,8,12,33.3%,19m
18219,3,艾萌酱,2545,30,3,5,8,37.5%,5m
18219,2,杭州热身皇帝,2545,0,3,6,9,33.3%,1h
18219,1,[共產星际]独立纵队先锋部队,2545,132,3,7,10,30.0%,1h
18219,3,[Sc养老]只要字多就有人读,2545,0,1,0,1,100.0%,21m
18219,2,[北极光小组]KingCrimson,2545,0,1,2,3,33.3%,15m
18219,3,塔达林高阶跳虫,2545,30,1,3,4,25.0%,20m
18219,2,萨迦西罗之剑,2545,0,1,3,4,25.0%,1h
18219,1,遗物,2545,0,0,1,1,0.0%,57m
18219,3,TMGHE,2545,0,0,1,1,0.0%,39m
18219,3,[笑傲江湖oL]寂寞空虚冷,2545,0,0,1,1,0.0%,37m
18219,3,[Airfv]夜神灬月,2545,0,0,5,5,0.0%,42m
18244,1,士官长泉本,2544,1567,267,261,528,50.6%,1h
18244,2,[媛气少女]不改一次浪费了,2544,1453,116,102,218,53.2%,1h
18244,3,[Tsing]友好邻居,2544,1379,85,86,171,49.7%,14m
18244,3,锦鸡舞,2544,815,47,41,88,53.4%,44m
18244,3,kivvf,2544,1206,47,54,101,46.5%,7m
18244,3,[暴雪二十二队]鸦之羽,2544,264,25,13,38,65.8%,1h
18244,2,青铜滴神,2544,441,19,17,36,52.8%,1h
18244,2,Tom,2544,384,15,12,27,55.6%,56m
18244,2,iwooo,2544,314,12,15,27,44.4%,1h
18244,2,混乱邪恶咕哒子,2544,265,9,12,21,42.9%,9m
18244,3,[虚无分部]天狼,2544,232,8,2,10,80.0%,1h
18244,2,[普残l攻略组]机械元首,2544,218,7,10,17,41.2%,10m
18244,3,[明教]爸爸,2544,190,6,1,7,85.7%,1h
18244,2,树街猫,2544,192,6,4,10,60.0%,1h
18244,3,[阿里巴巴战队]卧龙,2544,174,4,4,8,50.0%,1h
18244,2,Sawyer,2544,90,3,6,9,33.3%,1h
18244,3,你看我还有机会么,2544,36,3,6,9,33.3%,1h
18244,2,nihao,2544,151,3,7,10,30.0%,58m
18244,1,静默,2544,0,2,3,5,40.0%,21m
18244,1,[东京有点热]我是吓大的,2544,0,2,3,5,40.0%,39m
18244,1,风中的心情,2544,0,2,3,5,40.0%,5m
18244,3,GSDsx,2544,0,2,4,6,33.3%,1h
18244,3,洪荒,2544,0,2,5,7,28.6%,22m
18244,3,[小鸡屠宰场5]泪奔小波,2544,0,1,0,1,100.0%,1h
18244,1,GameMadmen,2544,0,1,4,5,20.0%,23m
18244,3,秒退都是孤儿,2544,0,0,1,1,0.0%,1h
18270,3,[火焰雷兽]啊哈哈啊哈哈,2543,983,67,60,127,52.8%,25m
18270,2,沉默之剑,2543,864,51,49,100,51.0%,1h
18270,1,[奶农]爷创造神话嗯,2543,453,16,24,40,40.0%,16m
18270,1,Dysun,2543,354,15,11,26,57.7%,23m
18270,2,hhhh,2543,222,14,13,27,51.9%,35m
18270,3,[OrzMM]baizer,2543,422,14,26,40,35.0%,48m
18270,2,haosijia,2543,195,6,4,10,60.0%,8m
18270,3,[王者归来]里斯,2543,143,4,0,4,100.0%,1h
18270,3,[孙宁FANS]MARU,2543,58,3,3,6,50.0%,45m
18270,3,IKE,2543,100,3,3,6,50.0%,1h
18270,2,[鬼谷]没门,2543,88,2,1,3,66.7%,23m
18270,3,狐灬纹列,2543,133,2,2,4,50.0%,1h
18270,1,零下,2543,44,2,4,6,33.3%,22m
18270,3,吞天鬼笑,2543,0,2,4,6,33.3%,1h
18270,1,银河落日,2543,0,1,0,1,100.0%,23m
18270,2,[菜鸡一起娱乐]小黑大王,2543,0,1,2,3,33.3%,35m
18270,3,厚黑,2543,30,1,2,3,33.3%,54m
18270,3,[violet]viyog,2543,30,1,3,4,25.0%,21m
18288,2,[丨萌新丨]giao,2542,1536,157,150,307,51.1%,39m
18288,3,[独立团钢炮]战逆丶,2542,497,18,11,29,62.1%,48m
18288,3,pitbul,2542,387,13,10,23,56.5%,20m
18288,1,像微笑丶,2542,374,12,22,34,35.3%,1h
18288,3,crocodile,2542,365,11,19,30,36.7%,49m
18288,2,盛世白莲,2542,216,9,5,14,64.3%,1h
18288,2,Heinrich,2542,241,9,9,18,50.0%,1h
18288,3,喝车不开酒,2542,194,6,8,14,42.9%,25m
18288,3,佐世保之时雨,2542,178,5,5,10,50.0%,53m
18288,3,[冷月美少女]月野兔,2542,194,5,6,11,45.5%,1h
18288,3,IIIIIIIIIIII,2542,58,3,1,4,75.0%,1h
18288,3,grsgsrgs,2542,120,2,2,4,50.0%,1h
18288,3,[多人皆可]言之严,2542,32,2,2,4,50.0%,1h
18288,1,wildforce,2542,48,2,2,4,50.0%,24m
18288,2,aeiou,2542,30,2,3,5,40.0%,48m
18288,3,愤怒的冰块块,2542,0,2,4,6,33.3%,14m
18288,2,ybltc,2542,62,2,9,11,18.2%,1h
18288,3,大神带带我,2542,0,1,0,1,100.0%,9m
18288,3,Frank,2542,30,1,1,2,50.0%,1h
18288,3,llllllllllll,2542,30,1,1,2,50.0%,19m
18288,3,你想集结部队吗,2542,30,1,1,2,50.0%,44m
18288,3,llllllllllll,2542,0,0,1,1,0.0%,9m
18288,3,靓仔,2542,0,0,1,1,0.0%,1h
18311,2,兜兜转转,2541,291,25,23,48,52.1%,30m
18311,2,[干磨]Gin,2541,548,21,22,43,48.8%,56m
18311,3,飞狐大神,2541,502,19,21,40,47.5%,1h
18311,3,关谷,2541,399,18,11,29,62.1%,21m
18311,3,[我骄傲我自豪]苏茵兵,2541,433,14,12,26,53.8%,21m
18311,2,[龙族战队]专属我用,2541,388,14,13,27,51.9%,60m
18311,2,[明帝国]ffjhdm,2541,204,6,7,13,46.2%,48m
18311,3,[浙江大学战队]LeSoleil,2541,171,6,8,14,42.9%,51m
18311,2,free,2541,124,6,8,14,42.9%,13m
18311,1,守夜人,2541,161,4,3,7,57.1%,1h
18311,1,[麻痹的青年]瘾大技术差,2541,0,3,2,5,60.0%,24m
18311,1,派星星,2541,48,3,2,5,60.0%,21m
18311,1,[刺蛇互助社团]神座出流,2541,0,2,1,3,66.7%,35m
18311,3,MUYAIX,2541,97,2,2,4,50.0%,1h
18311,1,琉璃月羽,2541,94,2,4,6,33.3%,1h
18311,2,Rainbow,2541,34,2,4,6,33.3%,47m
18311,3,瑞士短毛猫,2541,0,1,1,2,50.0%,1h
18311,3,[初音未来01]初音未来,2541,0,0,1,1,0.0%,1h
18311,3,nipqin,2541,0,0,2,2,0.0%,5m
18330,1,徐大大爱陶敏,2540,1545,152,144,296,51.4%,24m
18330,3,Sam,2540,1015,106,106,212,50.0%,46m
18330,1,heheda,2540,1544,94,89,183,51.4%,30m
18330,3,吧啦巴拉,2540,1493,60,52,112,53.6%,1h
18330,1,[小鸡屠宰场a]世间无我这般人,2540,570,19,26,45,42.2%,38m
18330,2,希尔伯特空间,2540,328,13,9,22,59.1%,1h
18330,2,[无花也浪漫]温琳羽,2540,233,9,6,15,60.0%,1h
18330,3,[世风第三帝国]一杆梅子酒,2540,143,4,0,4,100.0%,1h
18330,3,作止语默,2540,86,4,1,5,80.0%,39m
18330,3,蟑螂恶霸,2540,30,2,1,3,66.7%,4m
18330,2,[91二五仔]Jason,2540,62,2,4,6,33.3%,14m
18330,3,[上古之神]飞飞飞飞飞,2540,0,2,7,9,22.2%,24m
18330,2,[碰瓷小队]人族丶雷神灬,2540,90,1,1,2,50.0%,1h
18330,2,灵幻河谷,2540,91,1,3,4,25.0%,1h
18330,3,Kyrie,2540,0,0,1,1,0.0%,1h
18330,3,[专打嘤嘤怪]sLIKALIE,2540,0,0,1,1,0.0%,1h
18330,3,[黑暗]小孩丿有自尊,2540,0,0,2,2,0.0%,48m
18330,3,无影二哥,2540,0,0,2,2,0.0%,28m
18348,1,拾念韶华,2539,1517,352,346,698,50.4%,29m
18348,3,徐鸣人,2539,1484,179,163,342,52.3%,5m
18348,1,[瘾大眼瞎]一颗赛艇,2539,920,47,55,102,46.1%,38m
18348,1,王少,2539,466,20,17,37,54.1%,54m
18348,3,[生物即是正义]sjc,2539,538,19,21,40,47.5%,30m
18348,1,飞奔的绵羊,2539,202,13,16,29,44.8%,17m
18348,2,[YINGJI]HyperRich,2539,276,11,10,21,52.4%,15m
18348,2,zerymonster,2539,179,7,4,11,63.6%,1h
18348,3,[欧佩克]龙眼,2539,158,4,8,12,33.3%,23m
18348,3,霜哀,2539,30,2,1,3,66.7%,14m
18348,3,[几何伦理学]SkyingMe,2539,37,2,2,4,50.0%,21m
18348,3,云殇,2539,0,2,4,6,33.3%,11m
18348,3,苍穹,2539,0,1,0,1,100.0%,1h
18348,3,milk,2539,0,1,0,1,100.0%,1h
18348,1,[尤摩扬护国队]Alarak,2539,0,1,0,1,100.0%,5m
18348,3,[为了艾尔塔萨]北凉王人屠徐枭,2539,0,1,1,2,50.0%,16m
18348,3,七月与飞花,2539,18,1,1,2,50.0%,15m
18348,1,[海德单推协会]做虫虫好累鸭,2539,0,1,3,4,25.0%,59m
18348,1,磨舌,2539,0,1,4,5,20.0%,24m
18348,1,ZNEWER,2539,0,1,4,5,20.0%,42m
18348,3,[龙血]GeekAllianc,2539,0,0,1,1,0.0%,4m
18348,3,那谁,2539,0,0,1,1,0.0%,39m
18370,1,dofork,2538,496,52,39,91,57.1%,44m
18370,1,[我开矿了你呢]脑残必死,2538,789,37,36,73,50.7%,1h
18370,3,[金盾男科医院]杨医生,2538,266,9,3,12,75.0%,1h
18370,1,浪波涛,2538,273,9,15,24,37.5%,1h
18370,1,qianxun,2538,296,7,10,17,41.2%,19m
18370,2,roy,2538,192,5,11,16,31.2%,52m
18370,1,狼犬丹尼,2538,128,4,11,15,26.7%,48m
18370,3,[零感]你要咋个说,2538,68,3,3,6,50.0%,1h
18370,1,manlove,2538,134,3,8,11,27.3%,37m
18370,3,Tsunami,2538,58,2,1,3,66.7%,20m
18370,3,孔哥,2538,30,2,1,3,66.7%,23m
18370,3,[塔达林高坚果]mvt,2538,0,2,4,6,33.3%,1h
18370,2,IIIIIIIIIIII,2538,90,2,5,7,28.6%,16m
18370,3,[鸽子六发]欧阳琛,2538,0,1,1,2,50.0%,20m
18370,3,脸以下全是腿,2538,0,1,1,2,50.0%,45m
18370,3,Fashioniubi,2538,30,1,1,2,50.0%,5m
18370,3,SMILE,2538,0,0,1,1,0.0%,1h
18370,1,士道士织自攻自受,2538,0,0,1,1,0.0%,10m
18388,1,cuijun,2537,1393,117,116,233,50.2%,17m
18388,2,过段时间,2537,1104,56,44,100,56.0%,1h
18388,3,tmp,2537,736,45,46,91,49.5%,14m
18388,2,[最牛的菜鸟队]LOVEXZYY,2537,867,44,44,88,50.0%,33m
18388,2,专注妙可三十年,2537,1143,41,44,85,48.2%,5m
18388,3,[鸡层干部]MindSporeskl,2537,253,9,2,11,81.8%,1h
18388,2,[地嗪滞销]开门塔达林查地嗪,2537,225,8,11,19,42.1%,50m
18388,2,娄谋,2537,201,7,9,16,43.8%,1h
18388,1,[艾尔之巅]青山是哪只鸡,2537,167,6,2,8,75.0%,19m
18388,2,[暴雪养鸡场]流氓,2537,186,6,6,12,50.0%,1h
18388,2,[联合动物园]窃格瓦拉本人,2537,166,6,9,15,40.0%,1h
18388,2,呼呼一顿锤,2537,196,6,9,15,40.0%,1h
18388,3,[暴风雨]WEThello,2537,116,5,3,8,62.5%,1h
18388,3,kold,2537,60,2,3,5,40.0%,51m
18388,3,Mageblade,2537,0,1,0,1,100.0%,1h
18388,3,[晋升者]土豆丝,2537,0,0,1,1,0.0%,1h
18388,2,Ponder,2537,0,0,1,1,0.0%,26m
18388,3,[712下北泽]桂花糊骑士,2537,0,0,2,2,0.0%,28m
18406,2,[智商杯233]actfav,2536,1522,199,205,404,49.3%,37m
18406,1,wuukyuy,2536,1542,89,78,167,53.3%,1h
18406,2,霍的尼格,2536,1511,84,63,147,57.1%,17m
18406,2,[C51026]麦田,2536,1059,47,33,80,58.8%,9m
18406,2,[柳岩玩星际]山脉与海岛,2536,266,10,9,19,52.6%,1h
18406,3,AAAAACT,2536,72,5,5,10,50.0%,1h
18406,3,[埃辛诺斯战刃]likeddd,2536,185,5,8,13,38.5%,1h
18406,3,OOOOOO,2536,90,4,2,6,66.7%,44m
18406,2,zzzzx,2536,94,4,6,10,40.0%,32m
18406,3,ANTONICO,2536,72,4,7,11,36.4%,28m
18406,1,[kae]Nekoyami,2536,48,4,8,12,33.3%,1h
18406,1,[Beastp]bobeiya,2536,184,4,11,15,26.7%,12m
18406,3,尼大叶,2536,96,3,4,7,42.9%,39m
18406,3,[Strike]TheExileZAnd,2536,30,2,1,3,66.7%,1h
18406,1,KelvinsTem,2536,133,2,3,5,40.0%,37m
18406,2,[我们是无敌的]究极黑暗,2536,62,2,5,7,28.6%,45m
18406,2,[WESG决赛]Aoto,2536,114,2,5,7,28.6%,60m
18406,2,项城雅培,2536,58,2,8,10,20.0%,50m
18406,3,纯鼠标玩家,2536,0,1,0,1,100.0%,20m
18406,3,教主,2536,0,1,1,2,50.0%,21m
18406,2,[天国力学]你就是彩笔,2536,89,1,1,2,50.0%,1h
18406,1,魑魅魍魉魆,2536,0,0,1,1,0.0%,39m
18406,2,[为了胜利为了]风卷寒曦,2536,0,0,2,2,0.0%,1h
18429,3,[iandsf]asdasdasd,2535,1364,131,143,274,47.8%,30m
18429,2,[XXHZ35]羽宅一生,2535,645,37,49,86,43.0%,47m
18429,2,黑白配,2535,493,17,21,38,44.7%,1h
18429,2,仅余舟一芥,2535,275,8,16,24,33.3%,30m
18429,1,高党,2535,266,8,18,26,30.8%,8m
18429,3,会钓鱼的猫昕,2535,88,4,3,7,57.1%,1h
18429,2,我是大神仙,2535,118,4,5,9,44.4%,1h
18429,2,流浪,2535,93,4,5,9,44.4%,1h
18429,3,世界,2535,145,4,6,10,40.0%,22m
18429,2,摸仙小王,2535,60,3,6,9,33.3%,48m
18429,3,丶包子,2535,30,2,1,3,66.7%,1h
18429,1,醉烟痴,2535,97,2,2,4,50.0%,6m
18429,2,孤独守望者,2535,46,2,4,6,33.3%,16m
18429,1,[其徐如风]体温三十八度,2535,141,2,6,8,25.0%,53m
18429,1,马翦,2535,70,2,7,9,22.2%,17m
18429,3,NOGAMENOLIFE,2535,0,1,0,1,100.0%,9m
18429,3,只狼,2535,30,1,1,2,50.0%,10m
18446,1,诡狼,2534,1588,94,91,185,50.8%,1h
18446,2,[暴雪零队]SuperHero,2534,862,63,59,122,51.6%,47m
18446,1,aurelien,2534,687,48,42,90,53.3%,24m
18446,2,妙妙海里的鸡,2534,547,25,18,43,58.1%,1h
18446,1,专踹瘸子那条好腿,2534,414,14,18,32,43.8%,17m
18446,3,slayer,2534,310,11,8,19,57.9%,20m
18446,1,[罗马方标]BNEYE,2534,0,3,3,6,50.0%,6m
18446,2,时光新月,2534,142,3,6,9,33.3%,14m
18446,3,[疯狂掉分]zlxyxs,2534,0,1,0,1,100.0%,1h
18446,2,[YA]AFcstats,2534,0,1,0,1,100.0%,1h
18446,3,[日月之殇]喵之小明特留斯,2534,0,1,1,2,50.0%,30m
18446,3,新手,2534,30,1,1,2,50.0%,1h
18446,3,[射手大射手]随二紫柔,2534,0,1,1,2,50.0%,10m
18446,3,心跳减速,2534,0,0,1,1,0.0%,1h
18446,3,啊傻啊啊傻,2534,0,0,1,1,0.0%,38m
18446,3,少女的医生,2534,0,0,1,1,0.0%,15m
18462,1,AsceticBiSu,2533,1209,74,77,151,49.0%,30m
18462,2,Gone,2533,490,35,28,63,55.6%,1h
18462,3,apple,2533,546,20,17,37,54.1%,1h
18462,1,青铜王者,2533,370,20,18,38,52.6%,46m
18462,3,xyz,2533,371,14,8,22,63.6%,45m
18462,3,战争黎明,2533,325,13,3,16,81.2%,1h
18462,3,想太多,2533,276,12,14,26,46.2%,16m
18462,1,[混元体我女仆]我即天选更是唯一,2533,96,5,4,9,55.6%,1h
18462,3,树上有柠檬,2533,88,4,1,5,80.0%,9m
18462,3,Taichi,2533,0,4,2,6,66.7%,1h
18462,3,尘梦,2533,90,4,3,7,57.1%,51m
18462,3,[金鹰卡通]举世无双,2533,64,2,2,4,50.0%,37m
18462,1,Sandwich,2533,97,2,3,5,40.0%,1h
18462,2,星际白给宅,2533,58,2,6,8,25.0%,1h
18462,3,[ZSB铁憨憨]yuChen,2533,0,1,0,1,100.0%,1h
18462,3,这游戏太难了,2533,30,1,4,5,20.0%,1h
18462,2,[GTA]墨染伤城,2533,32,1,6,7,14.3%,32m
18462,3,无敌的我,2533,0,0,1,1,0.0%,9m
18462,3,[颂菩蚝]永恒时代,2533,0,0,1,1,0.0%,1h
18462,2,bigboss,2533,0,0,5,5,0.0%,48m
18482,3,[慢手e族]多多丸,2532,1126,115,111,226,50.9%,50m
18482,1,[CPT]圣剑可以不掉吗,2532,737,30,28,58,51.7%,8m
18482,1,梦里有你,2532,782,28,31,59,47.5%,46m
18482,3,player,2532,590,25,22,47,53.2%,27m
18482,1,jiangbumsetd,2532,660,25,27,52,48.1%,47m
18482,3,星之告白,2532,486,18,23,41,43.9%,51m
18482,3,六道飞起,2532,456,17,10,27,63.0%,54m
18482,2,FearX,2532,368,14,16,30,46.7%,1h
18482,3,ACMKTT,2532,336,12,14,26,46.2%,1h
18482,1,Reurlife,2532,298,11,12,23,47.8%,1h
18482,2,luludada,2532,252,8,3,11,72.7%,8m
18482,3,开起来的小字母,2532,217,7,6,13,53.8%,6m
18482,3,[加勒比海蓝]褐色的迷梦,2532,143,5,4,9,55.6%,1h
18482,2,菲亚特合同法,2532,154,5,4,9,55.6%,60m
18482,2,漂浮不定的鱼,2532,142,4,4,8,50.0%,18m
18482,3,斯巴鲁,2532,121,4,11,15,26.7%,48m
18482,3,waiTnight,2532,97,3,5,8,37.5%,1h
18482,1,ALiveME,2532,166,3,5,8,37.5%,13m
18482,3,[BGD]小蓝莓丶,2532,34,3,6,9,33.3%,1h
18482,3,sky,2532,0,2,3,5,40.0%,19m
18482,2,西安市最后的直男,2532,60,2,5,7,28.6%,45m
18482,3,中世纪的屑北海,2532,0,2,5,7,28.6%,23m
18482,3,小白上路,2532,0,1,1,2,50.0%,9m
18482,3,entaroadun,2532,30,1,1,2,50.0%,48m
18482,3,Brutal,2532,0,1,1,2,50.0%,20m
18482,3,vvvvvvvvrrr,2532,97,1,3,4,25.0%,14m
18482,1,我是你还是,2532,0,0,1,1,0.0%,1h
18482,2,菜鸟鸟,2532,0,0,4,4,0.0%,32m
18482,2,[传奇再现]supremezhu,2532,0,0,5,5,0.0%,60m
18511,2,维克上将,2531,1494,192,202,394,48.7%,17m
18511,1,小新,2531,1587,84,92,176,47.7%,17m
18511,2,占星,2531,1559,76,61,137,55.5%,1h
18511,2,[Encore]我爱米咪,2531,1167,54,47,101,53.5%,1h
18511,2,肥躁,2531,967,46,23,69,66.7%,17m
18511,1,fightero,2531,778,31,30,61,50.8%,1h
18511,3,changyebo,2531,350,21,13,34,61.8%,19m
18511,2,AlexWei,2531,243,17,18,35,48.6%,57m
18511,3,[ZLR]Bargon,2531,362,14,5,19,73.7%,20m
18511,1,[请先打我隊友]旌旗十万斩阎罗,2531,408,14,22,36,38.9%,4m
18511,2,[曾经一群兔子]快乐的菜鸟,2531,261,12,10,22,54.5%,1h
18511,1,lothric,2531,316,11,11,22,50.0%,1h
18511,3,hushw,2531,212,8,3,11,72.7%,27m
18511,2,[48K纯帅]电脑玩家普通,2531,250,7,9,16,43.8%,1h
18511,3,星空,2531,195,6,2,8,75.0%,1h
18511,2,[lmbaP]violet,2531,140,5,4,9,55.6%,1h
18511,2,追猎之魂,2531,86,4,5,9,44.4%,36m
18511,3,陌黑色,2531,88,2,2,4,50.0%,6m
18511,2,GgYy,2531,117,2,5,7,28.6%,31m
18511,3,斋藤飞鸟,2531,0,2,5,7,28.6%,5m
18511,1,[残日星宿]小恶魔鱼,2531,0,1,0,1,100.0%,1h
18511,3,enterprise,2531,0,1,2,3,33.3%,42m
18511,1,[Onceme]burnining,2531,0,1,4,5,20.0%,1h
18511,1,艺清晨,2531,0,1,6,7,14.3%,1h
18511,1,[最强战神]嘤嘤嘤,2531,0,0,2,2,0.0%,1h
18536,1,FLYINGWIG,2530,865,100,97,197,50.8%,1h
18536,3,SAWASAWU,2530,823,42,32,74,56.8%,1h
18536,1,sdfhfdghrj,2530,710,35,34,69,50.7%,47m
18536,3,tirble,2530,433,27,14,41,65.9%,51m
18536,3,刘艺控,2530,500,21,23,44,47.7%,1h
18536,2,[萌妹子来一发]心情乱了,2530,146,4,6,10,40.0%,1h
18536,3,Qies,2530,94,3,3,6,50.0%,1h
18536,1,young,2530,127,3,5,8,37.5%,1h
18536,3,KOCO,2530,30,3,5,8,37.5%,22m
18536,3,高处不胜寒,2530,0,2,4,6,33.3%,1h
18536,1,yfxh,2530,76,2,11,13,15.4%,34m
18536,3,张白给,2530,0,1,0,1,100.0%,1h
18536,1,befall,2530,48,1,1,2,50.0%,1h
18536,1,Nobody,2530,48,1,1,2,50.0%,1h
18536,3,自由之翼,2530,0,1,2,3,33.3%,8m
18536,2,去你的轻轻,2530,0,1,2,3,33.3%,32m
18536,2,shiyou,2530,30,1,4,5,20.0%,47m
18536,2,麦对有,2530,30,1,4,5,20.0%,14m
18536,2,[天津北洋大学]Line,2530,30,1,5,6,16.7%,48m
18536,3,qianli,2530,0,0,1,1,0.0%,8m
18556,2,十六夜,2529,1333,48,59,107,44.9%,5m
18556,1,[别害怕少年]蜗牛,2529,420,38,31,69,55.1%,35m
18556,2,时光似流水,2529,448,29,25,54,53.7%,47m
18556,1,古之舟,2529,575,26,29,55,47.3%,47m
18556,2,[干翻机械化]milk,2529,221,24,21,45,53.3%,60m
18556,2,优质阳光,2529,384,14,13,27,51.9%,1h
18556,1,[小仙女上线啦]天之蓝,2529,290,12,10,22,54.5%,43m
18556,3,渣渣,2529,255,9,3,12,75.0%,14m
18556,3,死亡轰炸,2529,224,7,27,34,20.6%,17m
18556,3,[APM59]Malloc,2529,183,6,2,8,75.0%,37m
18556,3,[星际联盟军团]Devilreturn,2529,97,4,4,8,50.0%,1h
18556,1,战天,2529,182,4,7,11,36.4%,45m
18556,1,墨初隋黎,2529,46,4,8,12,33.3%,1h
18556,3,新手变老鸟,2529,30,2,2,4,50.0%,51m
18556,1,冯文龙,2529,0,2,5,7,28.6%,1h
18556,3,[冷酷无情]lian,2529,0,1,0,1,100.0%,1h
18556,1,黑店,2529,0,1,0,1,100.0%,55m
18556,1,洛克昂,2529,0,1,1,2,50.0%,6m
18556,2,[银翼之光]畅爷,2529,0,1,4,5,20.0%,1h
18556,2,[OgiNA]蒜泥,2529,96,1,9,10,10.0%,1h
18556,3,旋律,2529,0,0,1,1,0.0%,1h
18556,2,[正太连萌]你我他,2529,0,0,5,5,0.0%,38m
18578,3,[NiuB]被坑怒坑,2528,1573,173,183,356,48.6%,30m
18578,2,自然大地板,2528,1365,105,88,193,54.4%,1h
18578,2,北峰吹海,2528,1572,96,100,196,49.0%,1h
18578,2,尘曦,2528,1516,92,89,181,50.8%,18m
18578,3,小心勺勺,2528,938,84,78,162,51.9%,30m
18578,2,剹弑,2528,1006,54,48,102,52.9%,1h
18578,2,煎烤叫兽,2528,793,32,34,66,48.5%,60m
18578,3,Daryal,2528,300,29,21,50,58.0%,1h
18578,2,FenGX,2528,741,27,35,62,43.5%,47m
18578,3,fanmoumo,2528,585,23,22,45,51.1%,1h
18578,2,[嘻哈战队]Zero,2528,531,22,13,35,62.9%,48m
18578,2,[DMR]expelliomos,2528,337,15,7,22,68.2%,10m
18578,2,Hades,2528,327,12,10,22,54.5%,1h
18578,3,Mars,2528,336,12,19,31,38.7%,4m
18578,1,[爱丽丝幻月]火焰猫,2528,160,6,10,16,37.5%,1h
18578,1,asdasd,2528,218,6,12,18,33.3%,35m
18578,3,alsaher,2528,192,5,3,8,62.5%,5m
18578,3,光头要日天,2528,184,5,3,8,62.5%,25m
18578,3,轻吟星语,2528,60,3,1,4,75.0%,1h
18578,1,自由香蕉君,2528,0,3,2,5,60.0%,1h
18578,3,ADLLB,2528,30,2,1,3,66.7%,1h
18578,1,[C06904]Creeper,2528,48,2,3,5,40.0%,1h
18578,3,[盲人协会]李雨桐,2528,60,2,4,6,33.3%,39m
18578,1,束默心,2528,0,0,1,1,0.0%,10m
18578,1,梦回天国,2528,0,0,1,1,0.0%,36m
18578,3,IIIIIIIIIIII,2528,0,0,1,1,0.0%,51m
18578,3,[星之所在RI]泥头车变形出击,2528,0,0,1,1,0.0%,10m
18578,2,盛世之樱,2528,0,0,4,4,0.0%,32m
18606,3,maobuyi,2527,1234,57,45,102,55.9%,4m
18606,1,萌萌哒等风来,2527,1054,44,41,85,51.8%,1h
18606,3,[国足救星]sunny,2527,509,34,45,79,43.0%,46m
18606,1,vincent,2527,685,24,26,50,48.0%,1h
18606,3,爱宝宝,2527,395,16,9,25,64.0%,19m
18606,3,SNRI,2527,244,14,12,26,53.8%,1h
18606,3,家住海边喜欢浪,2527,346,13,15,28,46.4%,15m
18606,2,AGiCE,2527,255,10,11,21,47.6%,57m
18606,2,健富开骑马射大雕,2527,159,10,13,23,43.5%,36m
18606,2,淡淡的蛋,2527,215,9,16,25,36.0%,52m
18606,2,[刺蛇互助协会]DeKu,2527,232,8,9,17,47.1%,1h
18606,3,白泽加奈惠的饼干,2527,219,7,3,10,70.0%,1h
18606,3,[LOHv]感觉瞬间,2527,0,5,4,9,55.6%,42m
18606,1,boby,2527,191,4,8,12,33.3%,1h
18606,1,Tom,2527,111,3,0,3,100.0%,1h
18606,1,[诺娃小姐姐]路过的假面骑士,2527,0,3,3,6,50.0%,7m
18606,2,半城烟沙,2527,30,2,3,5,40.0%,9m
18606,3,长木,2527,0,2,5,7,28.6%,19m
18606,3,Durlant,2527,0,2,5,7,28.6%,1h
18606,1,零夏,2527,136,2,10,12,16.7%,1h
18606,2,恶魂,2527,0,1,1,2,50.0%,1h
18606,1,冈野大尉,2527,0,1,4,5,20.0%,21m
18606,3,丁岩,2527,0,0,1,1,0.0%,22m
18606,3,[夜樱街道]SCV,2527,0,0,2,2,0.0%,42m
18606,1,[小河马无敌]wdnmd,2527,0,0,2,2,0.0%,1h
18606,3,Nectar,2527,0,0,3,3,0.0%,22m
18632,1,vdi,2526,1470,70,80,150,46.7%,30m
18632,1,Shark,2526,829,68,60,128,53.1%,8m
18632,1,核弹头批发商,2526,1435,67,55,122,54.9%,34m
18632,3,[Decemb]老子天下第一,2526,1068,48,43,91,52.7%,27m
18632,3,Edn,2526,474,21,28,49,42.9%,30m
18632,3,SiborAnju,2526,446,19,10,29,65.5%,19m
18632,3,大隆,2526,169,7,6,13,53.8%,30m
18632,3,[弱萌小队]我得重新集结部队,2526,231,7,6,13,53.8%,1h
18632,3,[i5]古盘山车神,2526,163,5,5,10,50.0%,51m
18632,3,[GGG第三代]我问问,2526,145,4,1,5,80.0%,20m
18632,2,火炎焱燚,2526,93,4,5,9,44.4%,1h
18632,3,Mmmilor,2526,58,3,2,5,60.0%,14m
18632,1,零度一下,2526,0,3,2,5,60.0%,1h
18632,3,[白丝黑丝萝莉]诺娃是我姐姐,2526,58,2,1,3,66.7%,1h
18632,1,青楼隐居,2526,0,2,2,4,50.0%,1h
18632,3,Aslanovich,2526,30,2,2,4,50.0%,8m
18632,3,沉沫灬迷茫,2526,0,0,1,1,0.0%,28m
18632,3,[时间错乱]ink,2526,0,0,1,1,0.0%,26m
18632,2,[神子]路明非,2526,0,0,1,1,0.0%,60m
18651,2,无所谓,2525,1378,96,87,183,52.5%,1h
18651,3,[宇宙永恒战队]品味艺术,2525,579,33,26,59,55.9%,44m
18651,1,掌握知识,2525,619,28,26,54,51.9%,58m
18651,2,[银翼之光]灵魂流转,2525,533,20,28,48,41.7%,18m
18651,3,铁锅炖萌新,2525,384,14,8,22,63.6%,59m
18651,3,一只海龟成功入水,2525,242,9,9,18,50.0%,44m
18651,1,[理工四皇]海南少岛主,2525,136,6,11,17,35.3%,12m
18651,2,[你有遗憾么]Gzi,2525,130,5,8,13,38.5%,32m
18651,1,phoenix,2525,136,5,11,16,31.2%,54m
18651,3,Live,2525,151,4,2,6,66.7%,28m
18651,3,杰作,2525,0,4,3,7,57.1%,45m
18651,3,[XYFANS]暮曙光,2525,60,3,2,5,60.0%,1h
18651,3,sirwrite,2525,30,2,0,2,100.0%,9m
18651,3,魅影凶灵,2525,0,2,5,7,28.6%,1h
18651,2,sCsC,2525,93,1,1,2,50.0%,1h
18651,1,[内华达数学系]CanVas,2525,0,1,1,2,50.0%,21m
18651,3,超神康,2525,30,1,2,3,33.3%,1h
18651,1,情殇,2525,0,0,1,1,0.0%,1h
18651,3,满院落叶,2525,0,0,3,3,0.0%,1h
18670,3,[iZest]IIIIIIIIIII,2524,855,35,24,59,59.3%,1h
18670,1,繁华遗尽空怀人,2524,459,33,37,70,47.1%,16m
18670,2,Yang,2524,858,32,33,65,49.2%,47m
18670,3,黑瞳紫发桐子酱,2524,618,26,23,49,53.1%,15m
18670,1,[基金会]大虾吃掉你,2524,689,25,30,55,45.5%,54m
18670,3,残裤,2524,553,21,17,38,55.3%,51m
18670,3,[23CM]神之左手,2524,318,12,13,25,48.0%,39m
18670,2,核动力小蜗牛,2524,310,11,11,22,50.0%,1h
18670,3,BOBOY,2524,311,10,7,17,58.8%,1h
18670,3,ydydm,2524,222,9,8,17,52.9%,27m
18670,2,不知道,2524,246,9,10,19,47.4%,39m
18670,3,入云龙,2524,228,8,7,15,53.3%,1h
18670,1,陨石落地,2524,223,7,10,17,41.2%,25m
18670,3,抗龙无悔,2524,194,6,9,15,40.0%,1h
18670,3,CounTingsTar,2524,166,5,2,7,71.4%,1h
18670,1,晓予,2524,168,3,8,11,27.3%,1h
18670,2,初夏沐微雨,2524,102,3,10,13,23.1%,1h
18670,1,Palette,2524,48,2,0,2,100.0%,36m
18670,1,我的长枪两米五,2524,0,2,1,3,66.7%,13m
18670,3,冷月冰霜,2524,0,2,4,6,33.3%,1h
18670,3,机械手,2524,0,1,1,2,50.0%,1h
18670,2,[NS2憋牛群]WinterFTTF,2524,42,1,2,3,33.3%,58m
18670,3,别闹,2524,0,1,4,5,20.0%,54m
18670,3,[乌拉拉啦啦啦]鑫爷,2524,0,0,1,1,0.0%,1h
18670,3,泰伦之光,2524,0,0,1,1,0.0%,1h
18670,3,[萌萌哒鸡]猪猪想吃饭,2524,0,0,1,1,0.0%,28m
18696,3,阿鲁方索,2523,1584,117,109,226,51.8%,38m
18696,3,Pimba,2523,687,92,107,199,46.2%,24m
18696,2,卡萨丁,2523,1328,82,86,168,48.8%,1h
18696,3,[不知不觉天亮]Horfey,2523,1032,41,37,78,52.6%,48m
18696,2,[兔兔之家]Poi,2523,996,36,42,78,46.2%,39m
18696,3,无悔孤玖,2523,728,33,26,59,55.9%,54m
18696,1,渣渣渣渣星人,2523,275,32,29,61,52.5%,1h
18696,1,雏凤峰,2523,587,30,27,57,52.6%,47m
18696,3,新桓结衣,2523,515,18,16,34,52.9%,30m
18696,3,轻巡洋舰,2523,388,14,11,25,56.0%,1h
18696,2,深海鱼,2523,334,11,16,27,40.7%,48m
18696,3,好大熊,2523,246,9,8,17,52.9%,1h
18696,1,LiiSimple,2523,205,6,12,18,33.3%,17m
18696,3,JasonTric,2523,146,5,5,10,50.0%,1h
18696,2,幽魂,2523,144,5,8,13,38.5%,47m
18696,3,归来,2523,0,4,2,6,66.7%,1h
18696,3,[旭东白丝圣奶]绘梨,2523,60,3,2,5,60.0%,44m
18696,3,IIIIIIIIIIII,2523,127,2,3,5,40.0%,1h
18696,2,旷工,2523,30,2,4,6,33.3%,5m
18696,1,随缘,2523,0,2,4,6,33.3%,1h
18696,1,Zero,2523,0,2,4,6,33.3%,21m
18696,3,MAXPLANK,2523,0,2,5,7,28.6%,5m
18696,3,wxx,2523,0,1,0,1,100.0%,1h
18696,3,丶潶眼圈,2523,0,1,2,3,33.3%,1h
18696,3,汪汪汪,2523,0,0,1,1,0.0%,60m
18721,2,[泉姐美如画]Dais,2522,1023,202,199,401,50.4%,45m
18721,1,wkwk,2522,841,146,139,285,51.2%,4m
18721,3,[抽爷]wwqlove,2522,551,83,70,153,54.2%,8m
18721,2,MGG,2522,614,21,26,47,44.7%,1h
18721,2,[社交学小可爱]gdfgrdfgdf,2522,355,14,11,25,56.0%,1h
18721,2,卫星今天点灯了吗,2522,388,14,14,28,50.0%,1h
18721,3,[征程星辰大海]轻尘逸龙,2522,332,12,12,24,50.0%,11m
18721,2,永恒的秩序,2522,266,9,12,21,42.9%,1h
18721,3,生死看淡不服就干,2522,202,7,8,15,46.7%,30m
18721,3,Disomak,2522,194,6,9,15,40.0%,8m
18721,1,[丨SLT丨]HowToWinZVT,2522,155,4,5,9,44.4%,23m
18721,2,[Fear]星际渣渣辉,2522,44,4,6,10,40.0%,58m
18721,2,sdf,2522,132,3,2,5,60.0%,21m
18721,3,放马子过来,2522,86,3,3,6,50.0%,1h
18721,3,wuge,2522,86,3,4,7,42.9%,1h
18721,2,工口新一,2522,88,3,6,9,33.3%,14m
18721,2,李欣怡,2522,60,3,8,11,27.3%,18m
18721,3,复仇流浪者,2522,0,2,4,6,33.3%,1h
18721,3,Seniafiled,2522,0,2,4,6,33.3%,28m
18721,3,mark,2522,30,1,3,4,25.0%,39m
18721,2,[哆拉ai梦]Sven,2522,30,1,4,5,20.0%,1h
18721,3,电竞没有张国荣,2522,0,0,1,1,0.0%,1h
18743,3,西里昂,2521,1653,153,143,296,51.7%,15m
18743,2,走在大漠,2521,309,94,86,180,52.2%,9m
18743,3,SWEG,2521,651,28,16,44,63.6%,1h
18743,1,Peter,2521,541,19,26,45,42.2%,56m
18743,1,nidhogg,2521,436,17,19,36,47.2%,1h
18743,1,圣吉列斯,2521,492,15,22,37,40.5%,1h
18743,2,[NICOS]欧派,2521,325,14,14,28,50.0%,1h
18743,3,pestak,2521,354,13,6,19,68.4%,30m
18743,3,[秋毫]Paradise,2521,159,8,9,17,47.1%,30m
18743,3,[桔梗花咲]拉扎尔苏,2521,168,7,4,11,63.6%,51m
18743,3,尐梓轩,2521,81,4,5,9,44.4%,44m
18743,2,[荣耀丶殿堂]天蔚湛蓝,2521,130,4,6,10,40.0%,1h
18743,1,艾尔之子,2521,119,3,4,7,42.9%,19m
18743,3,[西雅图咖啡店]bbx,2521,58,2,3,5,40.0%,20m
18743,3,请把滑稽还给我,2521,0,1,0,1,100.0%,1h
18743,3,eafewadw,2521,0,1,0,1,100.0%,1h
18743,3,天魂廖宇,2521,0,1,0,1,100.0%,45m
18743,1,FPSMaru,2521,0,1,2,3,33.3%,55m
18743,3,[RDFZsc]是盒盒盒子啊,2521,0,0,1,1,0.0%,30m
18743,3,风逸释然,2521,0,0,1,1,0.0%,16m
18743,3,我真的是好人,2521,0,0,2,2,0.0%,54m
18743,2,影战,2521,0,0,3,3,0.0%,1h
18765,3,获奖无数,2520,1516,152,143,295,51.5%,16m
18765,3,奢遮,2520,1563,125,131,256,48.8%,48m
18765,2,浑天伯爵,2520,1518,94,101,195,48.2%,32m
18765,1,沈明轩,2520,1344,76,79,155,49.0%,35m
18765,3,太阳不早起,2520,1008,52,35,87,59.8%,27m
18765,2,[黄金海舰队]tyrande,2520,951,35,39,74,47.3%,1h
18765,3,无聊的镜子,2520,694,28,26,54,51.9%,1h
18765,2,lemonjem,2520,727,28,27,55,50.9%,1h
18765,3,粉刷将,2520,691,27,19,46,58.7%,1h
18765,2,skyzo,2520,269,26,18,44,59.1%,1h
18765,2,[下手轻点ww]冲疯忎,2520,362,16,9,25,64.0%,1h
18765,1,swear,2520,450,15,24,39,38.5%,53m
18765,2,感性的大压腿,2520,279,12,7,19,63.2%,48m
18765,1,heyang,2520,348,11,17,28,39.3%,1h
18765,3,盼盼,2520,211,8,6,14,57.1%,26m
18765,3,[社交学学者]星光之耀,2520,190,6,6,12,50.0%,1h
18765,1,[皇室联盟]虎牙丶一帆风顺,2520,150,5,4,9,55.6%,32m
18765,3,FATE,2520,151,5,6,11,45.5%,1h
18765,1,[社交学导教]石声涛,2520,48,4,2,6,66.7%,1h
18765,3,SAG,2520,124,4,4,8,50.0%,1h
18765,2,[传说组]起司奶香喵,2520,119,4,4,8,50.0%,50m
18765,3,Macsed,2520,144,4,5,9,44.4%,1h
18765,1,[婆娑世界丶]赤鼻,2520,0,3,2,5,60.0%,48m
18765,3,风采依旧,2520,90,3,3,6,50.0%,1h
18765,3,[堂口]沙币神族憋,2520,72,3,3,6,50.0%,24m
18765,2,[TwSG]鸦羽,2520,78,3,3,6,50.0%,1h
18765,3,传说中的老张,2520,0,3,3,6,50.0%,1h
18765,3,今天没什么事,2520,88,3,4,7,42.9%,22m
18765,3,老猫,2520,30,2,2,4,50.0%,10m
18765,1,豪门霸爱西老爷,2520,0,2,4,6,33.3%,40m
18765,3,xiaoyi,2520,0,2,4,6,33.3%,50m
18765,3,Satori,2520,60,2,4,6,33.3%,51m
18765,1,啊啊啊啊啊啊啊,2520,0,2,4,6,33.3%,21m
18765,2,[不知不觉天亮]door,2520,114,2,5,7,28.6%,50m
18765,3,Icclin,2520,0,1,1,2,50.0%,16m
18765,1,武学凯萨兰德,2520,0,0,1,1,0.0%,36m
18765,3,蔷智沙莎,2520,0,0,1,1,0.0%,1h
18765,1,lhy,2520,0,0,4,4,0.0%,37m
18803,1,印尼战舰,2519,1594,182,178,360,50.6%,6m
18803,3,错误,2519,562,85,71,156,54.5%,38m
18803,3,IIIIIIIIIIII,2519,203,38,36,74,51.4%,11m
18803,2,Romanbanker,2519,541,22,21,43,51.2%,1h
18803,3,[联合指挥区]Ares,2519,524,21,11,32,65.6%,44m
18803,3,[小剑人]长沙孙一峰,2519,446,18,24,42,42.9%,26m
18803,3,爪巴行者,2519,430,16,18,34,47.1%,4m
18803,2,[五月花]终焉南瓜派,2519,394,15,15,30,50.0%,19m
18803,3,我是新手别打我,2519,383,14,14,28,50.0%,30m
18803,2,负心汗,2519,404,14,15,29,48.3%,11m
18803,3,OKIAMAHERO,2519,279,10,3,13,76.9%,9m
18803,3,九班马龙,2519,179,6,5,11,54.5%,1h
18803,3,Vlikiss,2519,30,5,4,9,55.6%,1h
18803,3,MARKWANG,2519,104,5,7,12,41.7%,22m
18803,1,未来道具研究所,2519,0,3,7,10,30.0%,43m
18803,3,Eteernity,2519,0,2,2,4,50.0%,1h
18803,1,long,2519,0,2,3,5,40.0%,1h
18803,1,StrongMan,2519,0,2,4,6,33.3%,1h
18803,1,水册,2519,97,2,4,6,33.3%,40m
18803,3,bomb,2519,0,2,8,10,20.0%,51m
18803,3,栗子要举高高,2519,0,1,1,2,50.0%,26m
18803,3,苏柒,2519,30,1,2,3,33.3%,26m
18803,2,卢思烨,2519,0,1,7,8,12.5%,58m
18803,3,[战旗丶月无双]我虎真,2519,0,0,1,1,0.0%,19m
18803,2,[杨永信]滚滚红尘,2519,0,0,1,1,0.0%,1h
18803,3,[苏联红军]斯大林,2519,0,0,1,1,0.0%,1h
18829,1,[C92331]要你命三千,2518,1533,79,84,163,48.5%,54m
18829,3,sain,2518,910,76,67,143,53.1%,48m
18829,1,灭团之星火车王,2518,1395,68,62,130,52.3%,46m
18829,3,你拿什么感同身受,2518,910,47,23,70,67.1%,1h
18829,1,丑二桨,2518,714,31,31,62,50.0%,37m
18829,3,[萌萌的探机]喵喵喵,2518,424,17,7,24,70.8%,30m
18829,1,[DaYun]风神花月,2518,338,12,17,29,41.4%,48m
18829,3,simon,2518,302,10,7,17,58.8%,54m
18829,3,超神菜鸟,2518,204,9,9,18,50.0%,20m
18829,2,火车吧,2518,166,6,7,13,46.2%,1h
18829,3,Smile,2518,177,5,2,7,71.4%,1h
18829,3,盛开妖姬,2518,114,5,3,8,62.5%,1h
18829,3,打雷下雨,2518,190,5,3,8,62.5%,60m
18829,2,Wersn,2518,140,5,7,12,41.7%,18m
18829,2,真的是你,2518,150,4,9,13,30.8%,1h
18829,3,[请停止攻击]本客机里面没人,2518,118,3,5,8,37.5%,1h
18829,3,落叶飞翔,2518,30,2,0,2,100.0%,1h
18829,3,除却巫山不是云,2518,0,1,0,1,100.0%,8m
18829,3,XRay,2518,95,1,1,2,50.0%,54m
18829,3,天青,2518,30,1,1,2,50.0%,28m
18829,1,[Aos菜鸡队]小小,2518,97,1,1,2,50.0%,7m
18829,3,panxh,2518,30,1,2,3,33.3%,9m
18829,3,风待葬灬垩,2518,30,1,3,4,25.0%,1h
18829,3,秃头汤姆,2518,0,0,1,1,0.0%,1h
18829,3,华丽转身,2518,0,0,1,1,0.0%,1h
18829,3,Miilon,2518,0,0,2,2,0.0%,1h
18855,2,阿尔法猫,2517,1171,46,51,97,47.4%,11m
18855,3,QWBB,2517,593,24,23,47,51.1%,1h
18855,3,三白羽,2517,285,10,6,16,62.5%,1h
18855,3,[爆杀]烛之武,2517,211,9,6,15,60.0%,1h
18855,3,funck,2517,105,5,4,9,55.6%,11m
18855,1,枉叹之,2517,227,5,7,12,41.7%,1h
18855,3,blaze,2517,88,4,2,6,66.7%,1h
18855,2,[上海理工BY]LAJIAOREN,2517,151,4,4,8,50.0%,30m
18855,1,费莲诺艾尔,2517,0,2,4,6,33.3%,23m
18855,3,[Strike]okay,2517,0,1,0,1,100.0%,30m
18855,3,knighttheone,2517,0,0,1,1,0.0%,26m
18855,3,[哀伤]ArdynSama,2517,0,0,1,1,0.0%,51m
18855,3,三千世界,2517,0,0,1,1,0.0%,1h
18855,3,[最菜战队]Cthulhu,2517,0,0,1,1,0.0%,30m
18869,2,panic,2516,1052,69,66,135,51.1%,1h
18869,3,[火焰雷兽]淑二,2516,1146,66,56,122,54.1%,1h
18869,1,柒陆,2516,839,59,58,117,50.4%,58m
18869,1,[AKC]deltagogogo,2516,1210,56,63,119,47.1%,1h
18869,2,kasers,2516,920,52,46,98,53.1%,11m
18869,2,[一个死肥宅]重生之我是川建国,2516,443,18,15,33,54.5%,1h
18869,1,[暴雪养鸡场]地痞,2516,369,17,2,19,89.5%,1m
18869,3,哭啼紫薇,2516,334,14,9,23,60.9%,4m
18869,3,陌东,2516,235,8,3,11,72.7%,1h
18869,2,[哔哩哔哩乾杯]旧下殷弘,2516,218,6,10,16,37.5%,48m
18869,2,好的,2516,84,5,7,12,41.7%,24m
18869,3,nfnfnf,2516,62,4,6,10,40.0%,1h
18869,3,[虚空闪烁]萤火虫满天,2516,58,3,3,6,50.0%,16m
18869,3,烟雨满城,2516,74,3,5,8,37.5%,14m
18869,3,十八岁头号,2516,90,3,6,9,33.3%,44m
18869,3,FlyCreeper,2516,97,2,0,2,100.0%,5m
18869,3,[A2B]lanius,2516,30,2,3,5,40.0%,44m
18869,2,喵苏鲁的呼唤,2516,58,2,6,8,25.0%,1h
18869,3,梦魇,2516,0,1,0,1,100.0%,1h
18869,3,秋月满星空,2516,0,1,0,1,100.0%,1h
18869,3,虚幻之光,2516,0,0,1,1,0.0%,1h
18869,3,[菜鸡联盟]他们的诉说,2516,0,0,1,1,0.0%,26m
18869,3,浅岚色,2516,0,0,1,1,0.0%,22m
18869,3,SuperExp,2516,0,0,2,2,0.0%,38m
18869,2,Moon,2516,0,0,6,6,0.0%,33m
18894,3,FSMoryi,2515,404,29,23,52,55.8%,22m
18894,3,诺娃上过黄金,2515,504,20,13,33,60.6%,44m
18894,2,清欢,2515,426,16,17,33,48.5%,19m
18894,2,[黑白条神教]亚顿,2515,333,10,16,26,38.5%,1h
18894,1,易空,2515,175,9,9,18,50.0%,1h
18894,1,[此用户已成仙]晓之车,2515,278,9,15,24,37.5%,47m
18894,3,[学不完了]模拟电路基础,2515,224,8,8,16,50.0%,1h
18894,2,Gaspanic,2515,249,8,9,17,47.1%,30m
18894,1,[万龙之眼]龙之眼,2515,181,7,2,9,77.8%,1h
18894,3,GGKING,2515,245,7,6,13,53.8%,20m
18894,1,单节十九分先生,2515,278,7,11,18,38.9%,29m
18894,3,[开心战队]我是爸爸,2515,191,5,3,8,62.5%,60m
18894,3,铉晔,2515,46,3,6,9,33.3%,6m
18894,1,我不是谐星,2515,142,3,8,11,27.3%,43m
18894,3,一个人的故事,2515,30,2,1,3,66.7%,4m
18894,1,听雨,2515,0,2,3,5,40.0%,7m
18894,2,放学后别走,2515,30,1,5,6,16.7%,1h
18894,3,[天云宫]问乾蟑螂比输本多,2515,0,0,1,1,0.0%,1h
18894,3,wxl,2515,0,0,1,1,0.0%,1h
18894,3,[奔驰何平]战无不胜,2515,0,0,1,1,0.0%,44m
18894,1,[你们都是渣]嘿嘿嘿,2515,0,0,1,1,0.0%,20m
18894,3,[真实星际玩家]牧丿,2515,0,0,2,2,0.0%,45m
18916,1,尸之东偶,2514,832,32,32,64,50.0%,47m
18916,1,老班长,2514,564,18,26,44,40.9%,40m
18916,3,一懒一,2514,274,15,12,27,55.6%,1h
18916,3,[EnTorn]非正常人类研究所,2514,256,14,11,25,56.0%,37m
18916,3,[TNH]chengqinxi,2514,344,13,6,19,68.4%,1h
18916,3,骆驼乌龟,2514,184,12,8,20,60.0%,1h
18916,2,SESESE,2514,316,12,9,21,57.1%,15m
18916,3,[艾尔之巅]新手无虐,2514,289,12,11,23,52.2%,1h
18916,3,hiro,2514,213,7,8,15,46.7%,1h
18916,2,Nobody,2514,148,5,11,16,31.2%,50m
18916,3,[蠢萌呆]萌萌的小喵喵,2514,88,4,3,7,57.1%,51m
18916,1,zhuowei,2514,0,3,2,5,60.0%,1h
18916,3,[祭零社]祭零小白,2514,30,2,1,3,66.7%,37m
18916,1,[为了虫群zz]是的长官,2514,0,2,2,4,50.0%,19m
18916,3,白耶,2514,30,2,3,5,40.0%,8m
18916,3,[斯大林保卫战]干就完了,2514,58,2,4,6,33.3%,51m
18916,3,虾之哀伤,2514,0,1,0,1,100.0%,30m
18916,3,教主滕格尔,2514,0,1,0,1,100.0%,1h
18916,2,飞天野味柯镇恶,2514,0,1,1,2,50.0%,1h
18916,2,[天地會分舵]夕照,2514,30,1,6,7,14.3%,1h
18916,3,微震天,2514,0,0,2,2,0.0%,9m
18916,3,[小菜逼]xixili,2514,0,0,2,2,0.0%,1h
18938,3,股王被套,2513,1295,386,391,777,49.7%,26m
18938,3,我不是二五仔,2513,1576,80,76,156,51.3%,15m
18938,2,[透一下清酒]老天师,2513,1366,70,67,137,51.1%,9m
18938,2,[你选的嘛偶像]跟我拽丶你不够格,2513,1068,49,35,84,58.3%,9m
18938,1,yourgrace,2513,867,35,36,71,49.3%,46m
18938,2,风味餐,2513,334,21,20,41,51.2%,9m
18938,3,心态爆炸选手,2513,540,19,19,38,50.0%,1h
18938,3,白菜菜,2513,373,17,10,27,63.0%,27m
18938,3,令狐冲,2513,360,12,10,22,54.5%,11m
18938,3,[逗比神教]涛涛好可爱呀,2513,259,10,1,11,90.9%,22m
18938,2,无知无畏,2513,253,9,6,15,60.0%,1h
18938,3,陌路同行,2513,268,9,20,29,31.0%,16m
18938,3,[暴雪我是你爹]Wirard,2513,198,7,10,17,41.2%,37m
18938,1,WON,2513,190,4,9,13,30.8%,1h
18938,2,[曾经一群兔子]Storm,2513,51,3,5,8,37.5%,1h
18938,3,[天使部]纸芯德蝶,2513,60,2,3,5,40.0%,44m
18938,3,住友金属,2513,0,1,0,1,100.0%,16m
18938,3,未晨,2513,0,1,0,1,100.0%,27m
18938,3,佩奇,2513,0,1,1,2,50.0%,19m
18938,1,杰兰特,2513,96,1,2,3,33.3%,9m
18938,2,NevErToss,2513,40,1,3,4,25.0%,11m
18938,2,简单电脑,2513,0,1,4,5,20.0%,34m
18938,1,夜凌星,2513,0,1,5,6,16.7%,13m
18938,3,[NooBoy]lipid,2513,0,0,3,3,0.0%,44m
18962,3,[冲就完了]一航,2512,644,103,99,202,51.0%,14m
18962,3,[星际联盟军团]有本事打死我啊,2512,1578,90,82,172,52.3%,30m
18962,2,GHOSTA,2512,851,44,38,82,53.7%,1h
18962,3,tingyang,2512,169,23,10,33,69.7%,11m
18962,2,langfantian,2512,544,22,23,45,48.9%,1h
18962,3,[专业de团队]群星,2512,523,18,16,34,52.9%,1h
18962,1,猛驴赛跑车,2512,375,14,18,32,43.8%,47m
18962,3,壹玖贰,2512,278,11,13,24,45.8%,21m
18962,3,overload,2512,55,4,2,6,66.7%,21m
18962,1,徐小会,2512,127,3,1,4,75.0%,1h
18962,3,FSDASD,2512,123,3,2,5,60.0%,1h
18962,3,小丑竟是我自己,2512,92,3,3,6,50.0%,1h
18962,3,[ESKT]悠然凌风,2512,30,2,1,3,66.7%,1h
18962,1,kuhako,2512,0,2,1,3,66.7%,1h
18962,3,老司机,2512,30,2,3,5,40.0%,28m
18962,3,[废物乐园]OkayDK,2512,60,2,3,5,40.0%,10m
18962,3,闪现大龙,2512,0,2,5,7,28.6%,26m
18962,3,Layoomiety,2512,0,1,0,1,100.0%,44m
18962,3,[浮生醉清风]白灯,2512,0,1,0,1,100.0%,16m
18962,3,云珩,2512,0,1,2,3,33.3%,1h
18962,3,夏一可赛艇,2512,97,1,3,4,25.0%,1h
18962,3,安阳君,2512,0,0,1,1,0.0%,1h
18962,2,弗拉基米尔,2512,0,0,1,1,0.0%,34m
18962,3,[magua]翅膀团耗子,2512,0,0,1,1,0.0%,1h
18962,3,[腥基佬男骸]极客大会,2512,0,0,1,1,0.0%,38m
18962,3,Garrey,2512,0,0,2,2,0.0%,28m
18962,3,邹思铭,2512,0,0,3,3,0.0%,51m
18989,2,被鸽的悲歌,2511,1029,60,47,107,56.1%,23m
18989,2,Boxer,2511,405,35,35,70,50.0%,1h
18989,3,[C21605]Mousko,2511,434,25,16,41,61.0%,9m
18989,1,jxws,2511,571,24,22,46,52.2%,12m
18989,3,[wyb205]pWrOyMisE,2511,514,22,14,36,61.1%,22m
18989,3,安稳,2511,528,18,21,39,46.2%,1h
18989,2,星际小霸王,2511,438,17,16,33,51.5%,1h
18989,3,我的妈呀,2511,163,9,9,18,50.0%,21m
18989,3,凉一丶,2511,167,6,5,11,54.5%,14m
18989,3,flynife,2511,237,6,12,18,33.3%,54m
18989,3,Marine,2511,30,2,2,4,50.0%,26m
18989,1,三宅,2511,139,2,5,7,28.6%,1h
18989,2,泡哥威武,2511,114,2,6,8,25.0%,1h
18989,3,xdcgfvhbhjnk,2511,0,1,0,1,100.0%,1h
18989,3,孤独莫,2511,0,1,2,3,33.3%,1h
18989,3,alphafly,2511,36,1,2,3,33.3%,7m
18989,3,[Sir]常屹,2511,0,0,1,1,0.0%,16m
19006,3,五木,2510,1571,131,134,265,49.4%,44m
19006,3,密度泛函是啥,2510,1512,109,105,214,50.9%,1h
19006,2,明辉昊苍,2510,1336,56,51,107,52.3%,30m
19006,2,光头哥,2510,1105,43,45,88,48.9%,39m
19006,3,混子先锋丢人界,2510,974,37,37,74,50.0%,1h
19006,3,[菜鸡喵]森木下士,2510,525,29,38,67,43.3%,23m
19006,3,心空无语,2510,418,17,10,27,63.0%,6m
19006,3,DIGDONW,2510,382,14,15,29,48.3%,1h
19006,1,KnightRL,2510,285,11,12,23,47.8%,1h
19006,3,[Solo]对人虫使用炎拳,2510,216,6,4,10,60.0%,1h
19006,3,哈麻批,2510,64,4,4,8,50.0%,43m
19006,3,义乌山鸡姬,2510,133,4,6,10,40.0%,1h
19006,3,Ruin,2510,135,3,2,5,60.0%,26m
19006,3,[AFSC2]Stats,2510,146,3,4,7,42.9%,26m
19006,1,LUAN,2510,0,2,3,5,40.0%,1h
19006,3,[123489]zero,2510,0,2,4,6,33.3%,14m
19006,3,庐山升龙霸,2510,0,0,1,1,0.0%,1h
19006,3,[南京何平]Rainnie,2510,0,0,1,1,0.0%,20m
19006,3,小乔,2510,0,0,1,1,0.0%,60m
19006,3,自抱自泣,2510,0,0,1,1,0.0%,1h
19006,3,[晋升者]玛萨拉星的老酒鬼,2510,0,0,1,1,0.0%,1h
19006,3,BigFighter,2510,0,0,3,3,0.0%,1h
19028,2,玩星际泡小妞,2509,1531,141,126,267,52.8%,1h
19028,2,cqzzj,2509,1634,126,125,251,50.2%,1h
19028,1,streethirty,2509,1486,105,98,203,51.7%,30m
19028,2,不要狗打运营,2509,1480,64,66,130,49.2%,37m
19028,1,[Dcboy]PartinG,2509,623,28,37,65,43.1%,58m
19028,1,血月,2509,278,13,20,33,39.4%,48m
19028,3,白特帅,2509,316,12,10,22,54.5%,11m
19028,3,Robin,2509,156,8,8,16,50.0%,19m
19028,2,[肉鸡的饲养]魔法少女苏苏酱,2509,90,4,7,11,36.4%,1h
19028,3,[s黑色孤儿s]帝国军,2509,60,2,4,6,33.3%,30m
19028,3,菜的抠脚,2509,0,1,0,1,100.0%,11m
19028,3,[镇魂现世]进击的中国,2509,0,0,2,2,0.0%,19m
19028,3,鸟抛花语丸丸落,2509,0,0,2,2,0.0%,30m
19028,3,[蓝鲸舰队]时佐斗,2509,0,0,3,3,0.0%,26m
19042,3,月玄,2508,1536,67,64,131,51.1%,30m
19042,1,chenzx,2508,1291,47,52,99,47.5%,1h
19042,3,[暴雪二队]dolf,2508,645,27,16,43,62.8%,54m
19042,2,[天际线]龙狮,2508,235,23,22,45,51.1%,1h
19042,3,[半个菜鸟]IlilI,2508,392,15,14,29,51.7%,45m
19042,3,IMMVP,2508,287,11,16,27,40.7%,20m
19042,3,小雨下大了,2508,263,10,6,16,62.5%,44m
19042,2,腓特烈大帝,2508,280,9,10,19,47.4%,46m
19042,3,叫我官人丶,2508,234,8,10,18,44.4%,14m
19042,3,[为了泰伦tt]凤羽珩,2508,195,7,7,14,50.0%,1h
19042,1,Copy,2508,238,7,16,23,30.4%,24m
19042,2,YKHD,2508,177,5,5,10,50.0%,1h
19042,3,[Sc养老]蕾姆我的你们吃屁,2508,58,3,1,4,75.0%,1h
19042,2,[软萌]炽热天空,2508,30,2,0,2,100.0%,1h
19042,3,一笑法奈,2508,30,2,2,4,50.0%,54m
19042,3,ZEUS,2508,30,2,3,5,40.0%,1h
19042,1,全村的希望,2508,0,2,3,5,40.0%,14m
19042,3,McMing,2508,0,2,5,7,28.6%,1h
19042,3,蒙圈猛犬,2508,0,1,0,1,100.0%,1h
19042,3,Aingkong,2508,0,0,1,1,0.0%,51m
19042,3,[咪神咪神]xingfuyishen,2508,0,0,1,1,0.0%,16m
19042,3,火神,2508,0,0,1,1,0.0%,20m
19042,3,[泰瑞亚]FKLQ,2508,0,0,2,2,0.0%,44m
19042,3,神奇的嘤嘤怪,2508,0,0,3,3,0.0%,1h
19066,3,chuck,2507,1503,92,90,182,50.5%,1h
19066,3,与之爽爽,2507,1081,40,40,80,50.0%,54m
19066,2,[星战分部]thewolfwolf,2507,804,36,25,61,59.0%,1h
19066,3,泰木人道,2507,608,23,21,44,52.3%,11m
19066,3,wuyuqyq,2507,450,18,12,30,60.0%,1h
19066,3,[XXHZ21]安琛,2507,421,15,14,29,51.7%,1h
19066,3,乳法第一名,2507,284,10,7,17,58.8%,54m
19066,1,小星,2507,248,10,10,20,50.0%,37m
19066,2,Dio,2507,294,9,6,15,60.0%,1h
19066,3,戏十六,2507,262,9,11,20,45.0%,1h
19066,3,[FKA]DTSknanLP,2507,192,8,5,13,61.5%,1h
19066,3,HappyTime,2507,188,6,2,8,75.0%,54m
19066,3,[暖吃翔就是干]TianGeLiya,2507,96,5,8,13,38.5%,1h
19066,1,曹流弊,2507,0,3,2,5,60.0%,56m
19066,3,傲月寒霜,2507,113,3,3,6,50.0%,39m
19066,2,[艾尔之主]风相,2507,102,3,4,7,42.9%,5m
19066,3,[火焰雷兽]为你而战,2507,60,2,3,5,40.0%,27m
19066,1,[阴死艾尔]丶豆瓣,2507,0,2,4,6,33.3%,1h
19066,2,Happydoog,2507,60,2,9,11,18.2%,1h
19066,1,verygood,2507,0,1,1,2,50.0%,1h
19066,2,秃鹫猎鹰,2507,0,0,5,5,0.0%,1h
19087,2,[十三音]炒炒炒炒炒饭,2506,719,81,68,149,54.4%,9m
19087,3,[菜有菜的道理]理查德伊卡洛斯,2506,1341,66,64,130,50.8%,1h
19087,3,鸽王,2506,703,31,21,52,59.6%,27m
19087,2,煤炭里的黑猫,2506,489,20,17,37,54.1%,1h
19087,3,笑看,2506,542,20,23,43,46.5%,54m
19087,2,Elnino,2506,317,14,5,19,73.7%,17m
19087,3,不会开矿,2506,388,14,13,27,51.9%,1h
19087,2,和我无关的猫,2506,382,14,19,33,42.4%,5m
19087,3,SAM,2506,250,9,9,18,50.0%,14m
19087,3,[DSE]IIIIIIIIiI,2506,256,8,8,16,50.0%,44m
19087,2,zbcazbc,2506,130,7,8,15,46.7%,35m
19087,3,南初寒霜,2506,184,6,3,9,66.7%,16m
19087,3,[别杀我农民]万花丛过叶不沾身,2506,111,5,4,9,55.6%,39m
19087,3,LuckyZc,2506,127,4,7,11,36.4%,11m
19087,2,[Umaru2]SAI,2506,126,4,12,16,25.0%,1h
19087,2,Assussin,2506,92,3,9,12,25.0%,14m
19087,3,木偶,2506,30,2,0,2,100.0%,1h
19087,3,墨迪,2506,58,2,2,4,50.0%,44m
19087,1,给个大腿让你抱,2506,0,2,3,5,40.0%,59m
19087,1,星际毒奶王,2506,97,2,4,6,33.3%,1h
19087,1,BestSaber,2506,0,2,4,6,33.3%,10m
19087,3,小志,2506,0,1,0,1,100.0%,1h
19087,3,张全蛋,2506,0,1,0,1,100.0%,19m
19087,3,[拯救凯瑞甘]灵之龙玄,2506,30,1,1,2,50.0%,21m
19087,3,[SCASS]Heiwater,2506,30,1,2,3,33.3%,8m
19087,3,电脑,2506,97,1,2,3,33.3%,1h
19087,1,Joker,2506,0,0,2,2,0.0%,43m
19114,2,MASS,2505,772,30,29,59,50.8%,28m
19114,2,[PlTB]IIIIIIIIIIII,2505,818,29,32,61,47.5%,5m
19114,2,不羡仙,2505,806,29,33,62,46.8%,1h
19114,3,[暴民永不低头]绯想天,2505,359,13,12,25,52.0%,27m
19114,3,多萨达,2505,350,12,15,27,44.4%,30m
19114,2,[大漢]粉毛小兔兔,2505,327,11,4,15,73.3%,1h
19114,3,[狼牙盟]Wnyfl,2505,182,11,10,21,52.4%,30m
19114,3,[等我到十费]黑幕冥王,2505,156,7,4,11,63.6%,1h
19114,2,唐心羽,2505,174,7,13,20,35.0%,1h
19114,1,[TAPC]zny,2505,261,6,13,19,31.6%,39m
19114,2,[XXHZ36]ian,2505,185,5,4,9,55.6%,58m
19114,3,瞎打,2505,90,4,2,6,66.7%,4m
19114,3,[雾雨魔法森林]空空空,2505,88,4,4,8,50.0%,55m
19114,3,black,2505,118,4,5,9,44.4%,19m
19114,3,贝克沃尔,2505,144,4,6,10,40.0%,6m
19114,3,掠夺者一大队,2505,140,3,1,4,75.0%,1h
19114,2,忆久弗哀,2505,160,3,1,4,75.0%,1h
19114,3,雪融,2505,118,2,1,3,66.7%,1h
19114,2,胡家果果,2505,117,2,6,8,25.0%,21m
19114,1,希夫,2505,48,2,6,8,25.0%,20m
19114,3,[Nostop]达芬奇奇奇奇奇奇,2505,30,1,1,2,50.0%,1h
19114,3,你好核平,2505,0,1,1,2,50.0%,14m
19114,3,[cmfans]大草莓天下第一,2505,0,1,2,3,33.3%,7m
19114,3,水月,2505,30,1,3,4,25.0%,1h
19114,1,夜白,2505,0,1,4,5,20.0%,15m
19114,3,富贵儿,2505,30,1,10,11,9.1%,19m
19114,3,黑毛黑死你,2505,0,0,1,1,0.0%,22m
19114,3,情話,2505,0,0,1,1,0.0%,52m
19114,2,[四叶草]科罗帝舞,2505,0,0,6,6,0.0%,10m
19143,1,snoppy,2504,1072,80,76,156,51.3%,17m
19143,2,HAPPY,2504,445,43,37,80,53.8%,9m
19143,2,苏家炮娘,2504,563,23,25,48,47.9%,1h
19143,3,[喵喵]滍语,2504,313,11,7,18,61.1%,10m
19143,1,Stibium,2504,252,7,8,15,46.7%,33m
19143,2,冰之羽翼,2504,95,3,6,9,33.3%,1h
19143,3,暮烟,2504,93,2,0,2,100.0%,30m
19143,1,MrJoker,2504,0,2,3,5,40.0%,43m
19143,3,天地噬魂,2504,0,1,0,1,100.0%,14m
19143,3,[Rhusky]RhuGuWen,2504,0,1,0,1,100.0%,29m
19143,3,[自由的气息]南非之王,2504,0,0,1,1,0.0%,28m
19143,3,Vector,2504,0,0,1,1,0.0%,24m
19155,1,[NVKR]双峰贯耳搬拦捶,2503,1598,174,178,352,49.4%,17m
19155,1,光耀星痕,2503,687,83,87,170,48.8%,54m
19155,3,zik,2503,368,26,13,39,66.7%,20m
19155,2,[茶队星分部]Ehino,2503,267,11,9,20,55.0%,1h
19155,3,克哈机动队,2503,279,10,3,13,76.9%,1h
19155,1,科普卢钢铁堡堡长,2503,158,6,2,8,75.0%,7m
19155,3,JiESON,2503,97,5,2,7,71.4%,1h
19155,3,[人人人]SRay,2503,94,5,7,12,41.7%,1h
19155,1,川耀战队舰队长,2503,144,4,6,10,40.0%,48m
19155,2,Zioaasasd,2503,46,4,8,12,33.3%,1h
19155,1,[休伯利亚号]lyj,2503,0,3,3,6,50.0%,1h
19155,3,Redblo,2503,131,3,3,6,50.0%,54m
19155,3,[月之所在RI]Anchor,2503,30,2,2,4,50.0%,8m
19155,3,Insomnia,2503,60,2,5,7,28.6%,37m
19155,3,AslanWu,2503,0,1,0,1,100.0%,28m
19155,3,Kel,2503,30,1,1,2,50.0%,1h
19155,2,[达拉姆查卡拉]Ken,2503,0,1,1,2,50.0%,1h
19155,3,法国穷光蛋,2503,0,1,2,3,33.3%,1h
19155,3,lbh,2503,0,1,3,4,25.0%,30m
19155,2,南方文,2503,30,1,7,8,12.5%,50m
19155,3,redmoon,2503,0,0,1,1,0.0%,30m
19155,3,hang,2503,0,0,1,1,0.0%,16m
19155,3,[请先打我隊友]红叶知弦,2503,0,0,1,1,0.0%,10m
19155,1,七夕,2503,0,0,1,1,0.0%,22m
19155,2,彭霸天,2503,0,0,2,2,0.0%,48m
19155,3,XIAOMING,2503,0,0,2,2,0.0%,19m
19155,3,泰伦快乐,2503,0,0,2,2,0.0%,52m
19182,3,iiiiiiiiiiii,2502,1655,630,633,1263,49.9%,8m
19182,3,这里是少爷广场,2502,1335,146,154,300,48.7%,1h
19182,3,风羽翼之,2502,899,37,31,68,54.4%,1h
19182,1,rhythm,2502,542,33,38,71,46.5%,31m
19182,3,智麟,2502,522,20,16,36,55.6%,39m
19182,2,JackLandrin,2502,448,19,25,44,43.2%,9m
19182,2,[司马恒星]IIIIIIIIIIII,2502,407,18,16,34,52.9%,1h
19182,2,汤达人,2502,518,17,22,39,43.6%,32m
19182,3,黄两球,2502,454,16,13,29,55.2%,1h
19182,2,Cuertain,2502,435,16,17,33,48.5%,1h
19182,3,TIAN,2502,171,7,4,11,63.6%,29m
19182,3,翊神,2502,216,7,7,14,50.0%,1h
19182,3,我觉得我优势很大,2502,162,6,18,24,25.0%,6m
19182,2,[帝王蟹]骉骉骉,2502,158,5,1,6,83.3%,1h
19182,3,[道友你先死]素质教育漏网之鱼,2502,189,5,3,8,62.5%,38m
19182,2,走出泥沼,2502,104,5,7,12,41.7%,10m
19182,1,借我十年心一,2502,0,4,1,5,80.0%,15m
19182,1,HankeyRan,2502,167,4,3,7,57.1%,5m
19182,3,竟然又,2502,116,4,6,10,40.0%,1h
19182,1,骑士丶噬,2502,48,3,4,7,42.9%,36m
19182,3,在仇与恨的地狱中,2502,0,2,3,5,40.0%,24m
19182,2,BarbatosVvv,2502,36,2,7,9,22.2%,47m
19182,3,FateOP,2502,0,1,1,2,50.0%,1h
19182,1,[NS]我是琳喵你敢信,2502,48,1,6,7,14.3%,58m
19182,3,King,2502,0,0,2,2,0.0%,26m
19182,3,祈祷她被温柔所爱,2502,0,0,2,2,0.0%,1h
19182,3,zjp,2502,0,0,2,2,0.0%,1h
19182,3,lwzyzj,2502,0,0,2,2,0.0%,1h
19182,1,[lBuGl]CAPTAIN,2502,0,0,11,11,0.0%,37m
19211,1,菜鸟先飞,2501,1480,182,168,350,52.0%,16m
19211,3,柠檬味布丁,2501,1565,104,119,223,46.6%,9m
19211,1,Mvp,2501,1282,45,55,100,45.0%,1h
19211,3,星河探险,2501,292,29,28,57,50.9%,21m
19211,3,[第三駆逐鑑隊]高阶犯罪者,2501,236,12,8,20,60.0%,1h
19211,3,[太玄]勇士不灭,2501,341,12,13,25,48.0%,1h
19211,3,谐星,2501,233,8,5,13,61.5%,28m
19211,2,[CPT]棒棒,2501,156,7,10,17,41.2%,1h
19211,3,[暴雪零队]霖霄,2501,146,6,7,13,46.2%,1h
19211,3,[你们的皇帝]先打张瑞林,2501,176,5,1,6,83.3%,10m
19211,1,咸鱼王,2501,144,5,2,7,71.4%,1h
19211,3,奥利奥奥奥,2501,191,5,3,8,62.5%,20m
19211,3,Leslie,2501,192,5,5,10,50.0%,44m
19211,3,藐视对面一头犬,2501,86,3,7,10,30.0%,1h
19211,3,[X英雄圣域X]休闲人士,2501,122,2,3,5,40.0%,2m
19211,1,[丷国民情夫丷]霸霸,2501,0,1,0,1,100.0%,43m
19211,3,墨璃,2501,0,1,0,1,100.0%,21m
19211,3,[火影何平]burst,2501,30,1,1,2,50.0%,49m
19211,3,mind,2501,0,1,2,3,33.3%,1h
19211,3,[青城烧麦]War,2501,30,1,5,6,16.7%,1h
19211,3,人族英霸,2501,0,0,1,1,0.0%,28m
19211,1,Genious,2501,0,0,2,2,0.0%,9m
19211,1,Sunephone,2501,0,0,4,4,0.0%,36m
19211,2,再见小强,2501,0,0,5,5,0.0%,1h
19235,3,Meihuo,2500,1165,154,142,296,52.0%,30m
19235,2,akk,2500,995,39,40,79,49.4%,1h
19235,2,帝国之鹰,2500,480,17,22,39,43.6%,1h
19235,3,Hmaxly,2500,351,12,8,20,60.0%,28m
19235,3,巴瑞斯特,2500,294,11,17,28,39.3%,1h
19235,1,[萌新在下挨打]雷诺五十块,2500,171,6,9,15,40.0%,1h
19235,2,avota,2500,136,6,10,16,37.5%,1h
19235,3,[ZSXR]专门放战术,2500,136,4,0,4,100.0%,1h
19235,3,[金陵十二钗]左脸较大,2500,145,4,7,11,36.4%,22m
19235,3,淡淡的奶香味,2500,0,3,4,7,42.9%,1h
19235,3,[Hdl]estarvs,2500,97,2,0,2,100.0%,1h
19235,1,姚东西,2500,97,2,1,3,66.7%,14m
19235,3,[途吉狂魔]凉薄少女梦,2500,30,2,2,4,50.0%,39m
19235,3,[火猫哥斯拉]战旗,2500,0,2,5,7,28.6%,1h
19235,3,[Rush丿]天丶才,2500,0,1,0,1,100.0%,51m
19235,3,Sandwitch,2500,0,1,1,2,50.0%,1h
19235,2,我是神棍,2500,0,1,1,2,50.0%,1h
19235,3,[耗子尾之]你的星冰乐,2500,0,1,1,2,50.0%,52m
19235,2,[小鸡屠宰场9]可口可乐,2500,88,1,5,6,16.7%,1h
19235,3,[星际丶老男孩]淡忘的会议,2500,0,0,1,1,0.0%,1h
19235,1,[嘤遍全球]MINO,2500,0,0,6,6,0.0%,1h
19256,1,同一个服,2499,1633,131,134,265,49.4%,39m
19256,2,ProphetZ,2499,1404,108,102,210,51.4%,9m
19256,2,不知谐为何物,2499,1029,73,65,138,52.9%,1h
19256,3,iogoibko,2499,393,15,26,41,36.6%,13m
19256,3,医生姐姐来了,2499,308,13,12,25,52.0%,46m
19256,2,初吻给了奶嘴,2499,356,13,19,32,40.6%,1h
19256,3,vlllll,2499,129,9,8,17,52.9%,30m
19256,3,你我开心哦,2499,289,9,10,19,47.4%,27m
19256,3,混独之人,2499,181,9,11,20,45.0%,1h
19256,1,kokodayo,2499,239,7,10,17,41.2%,7m
19256,3,[彼岸鸽友会]yukikaze,2499,169,6,0,6,100.0%,20m
19256,3,童话里的王子,2499,192,6,3,9,66.7%,27m
19256,2,[秋毫]ldakka,2499,154,6,5,11,54.5%,14m
19256,2,CandLes,2499,190,6,5,11,54.5%,1h
19256,1,[摸鱼探姬]爱衣丶休伯利安,2499,219,5,6,11,45.5%,54m
19256,2,桐人姥爷,2499,181,5,8,13,38.5%,1h
19256,1,凡九,2499,0,3,2,5,60.0%,20m
19256,3,pandaxia,2499,88,3,4,7,42.9%,52m
19256,2,IIIIIIIIIII,2499,116,3,5,8,37.5%,1h
19256,1,[X英雄圣域X]骚年,2499,160,3,11,14,21.4%,1h
19256,1,不许黑大主教,2499,0,2,4,6,33.3%,36m
19256,3,[别看了就你了]你必定会输,2499,0,1,1,2,50.0%,1h
19256,2,LXF,2499,36,1,4,5,20.0%,48m
19256,1,Eric,2499,0,0,1,1,0.0%,1m
19256,2,[秋毫]cccc,2499,0,0,6,6,0.0%,16m
19281,2,流星,2498,807,51,51,102,50.0%,9m
19281,1,[一刀屠天下]一只菜狗,2498,988,36,43,79,45.6%,23m
19281,1,orangesixone,2498,815,30,33,63,47.6%,1h
19281,3,凯爷快乐星际,2498,541,25,10,35,71.4%,1h
19281,1,Antony,2498,591,21,28,49,42.9%,30m
19281,3,无状态,2498,122,16,6,22,72.7%,21m
19281,2,[泉姐美如画]攻城坦克,2498,308,13,11,24,54.2%,36m
19281,2,三重秋,2498,325,12,17,29,41.4%,1h
19281,3,阿鲁巴,2498,278,9,7,16,56.2%,10m
19281,3,战神,2498,256,8,16,24,33.3%,7m
19281,3,[芭芭拉冲压]苍山雪,2498,163,6,5,11,54.5%,1h
19281,3,sillyTong,2498,211,6,6,12,50.0%,1h
19281,2,[曲终人散]wlxcy,2498,89,2,0,2,100.0%,1h
19281,3,Ghost,2498,0,2,5,7,28.6%,35m
19281,3,tydall,2498,0,2,5,7,28.6%,6m
19281,3,[西瓜撞地球]平等的权利,2498,0,1,1,2,50.0%,15m
19281,3,这个游戏好难啊,2498,95,1,1,2,50.0%,19m
19281,1,游戏呢,2498,0,0,2,2,0.0%,1h
19281,2,捷足的阿基琉斯,2498,0,0,4,4,0.0%,1h
19300,1,[DMRc]修罗,2497,1446,72,77,149,48.3%,22m
19300,2,夜喵子,2497,1419,57,57,114,50.0%,5m
19300,3,YSHG,2497,346,11,14,25,44.0%,28m
19300,2,Darren,2497,165,8,11,19,42.1%,1h
19300,2,SKY,2497,191,7,8,15,46.7%,1h
19300,1,轰毛,2497,249,7,10,17,41.2%,1h
19300,2,黑芝麻布丁巧克力,2497,124,5,11,16,31.2%,36m
19300,2,欧铮,2497,0,3,5,8,37.5%,60m
19300,2,芦笋单推人,2497,98,3,10,13,23.1%,39m
19300,3,疯狂的小兔,2497,60,2,3,5,40.0%,11m
19300,1,faker,2497,0,2,3,5,40.0%,21m
19300,1,[FlyH]极度拽拽,2497,0,2,4,6,33.3%,36m
19300,3,[哲学an复兴]俗人,2497,30,1,1,2,50.0%,1h
19300,3,TANKE,2497,0,0,4,4,0.0%,1h
19314,1,含泪甩飞龙,2496,1572,259,275,534,48.5%,1h
19314,1,论持久战,2496,356,162,155,317,51.1%,1h
19314,3,雪漫,2496,1212,71,69,140,50.7%,1h
19314,2,大亮哥,2496,644,49,48,97,50.5%,39m
19314,2,三阶魔方,2496,863,35,37,72,48.6%,1h
19314,1,您的智商已欠费,2496,700,29,25,54,53.7%,37m
19314,2,LacusClyne,2496,394,17,12,29,58.6%,1h
19314,3,[衡水中学]飞氘,2496,351,13,12,25,52.0%,1h
19314,3,羽翼,2496,304,9,10,19,47.4%,1h
19314,3,闪灵小侠,2496,190,7,2,9,77.8%,1h
19314,2,狗肉,2496,200,7,9,16,43.8%,16m
19314,2,[柠檬保护协会]老子是傻币,2496,226,7,9,16,43.8%,33m
19314,2,voice,2496,76,4,10,14,28.6%,32m
19314,3,仰望星空,2496,36,3,2,5,60.0%,30m
19314,1,wuswh,2496,0,3,3,6,50.0%,5m
19314,3,Unknown,2496,90,3,5,8,37.5%,1h
19314,3,Safer,2496,0,1,2,3,33.3%,1h
19314,1,乌龟,2496,0,0,1,1,0.0%,1h
19332,1,[旺旺战士]大意没有闪,2495,1527,198,204,402,49.3%,4m
19332,3,多来狗招锻炼一下,2495,1051,106,93,199,53.3%,15m
19332,1,[KNAT]zhegufly,2495,1393,63,67,130,48.5%,48m
19332,2,光辉之翼,2495,1415,59,59,118,50.0%,23m
19332,3,FCL,2495,643,40,38,78,51.3%,44m
19332,1,sun,2495,690,35,37,72,48.6%,6m
19332,3,ggqwer,2495,730,26,26,52,50.0%,15m
19332,3,[PRTS]歪臀猿比尔,2495,472,20,9,29,69.0%,52m
19332,1,克拉克肯特,2495,410,14,22,36,38.9%,8m
19332,3,耗子,2495,196,10,10,20,50.0%,9m
19332,3,Aldrich,2495,200,7,8,15,46.7%,1h
19332,3,蔷薇,2495,198,7,11,18,38.9%,10m
19332,2,Alex,2495,205,6,9,15,40.0%,1h
19332,2,绝活多线送兵,2495,178,6,11,17,35.3%,46m
19332,3,zuofeng,2495,114,4,5,9,44.4%,28m
19332,1,地狱裁决,2495,106,3,12,15,20.0%,39m
19332,1,某人,2495,97,2,0,2,100.0%,1h
19332,1,强的一匹,2495,0,2,3,5,40.0%,36m
19332,2,刘宇晨的爹,2495,114,2,5,7,28.6%,1h
19332,3,DEMO,2495,95,1,1,2,50.0%,20m
19332,1,BlackWhiteMK,2495,0,1,4,5,20.0%,24m
19332,2,简单活,2495,0,1,5,6,16.7%,1h
19332,3,[不说话装高手]ZARD,2495,0,0,1,1,0.0%,31m
19332,3,冰菓,2495,0,0,2,2,0.0%,1h
19356,3,空投挖掘机,2494,1180,50,35,85,58.8%,30m
19356,3,星际渣渣,2494,176,48,30,78,61.5%,1h
19356,3,你二大爷,2494,452,21,13,34,61.8%,46m
19356,3,三十七摄氏度,2494,440,19,17,36,52.8%,1h
19356,2,[我们是无敌的]呆呆,2494,409,17,16,33,51.5%,1h
19356,2,娱乐至上,2494,423,16,20,36,44.4%,1h
19356,3,北平以北,2494,464,16,20,36,44.4%,60m
19356,1,Innovation,2494,373,16,26,42,38.1%,18m
19356,2,gujingbo,2494,412,14,20,34,41.2%,46m
19356,3,voos,2494,287,11,6,17,64.7%,17m
19356,1,[科普卢星系]故宫里的大怪兽,2494,226,8,14,22,36.4%,1h
19356,3,[天才mvp]RHO,2494,116,5,8,13,38.5%,1h
19356,3,[风雪]日夕,2494,120,4,5,9,44.4%,28m
19356,3,KKUANGBIAO,2494,95,2,0,2,100.0%,9m
19356,1,[XFU02]blackmusic,2494,0,2,2,4,50.0%,15m
19356,3,[新星AKA]何家盛世,2494,116,2,2,4,50.0%,55m
19356,2,天灾领主,2494,106,2,4,6,33.3%,1h
19356,1,倾城浮云,2494,0,2,4,6,33.3%,15m
19356,3,你拿个杯,2494,0,1,1,2,50.0%,30m
19356,3,战辉,2494,0,1,1,2,50.0%,9m
19356,3,[第四駆逐鑑隊]爱听听的大傻子,2494,0,0,1,1,0.0%,11m
19356,1,颇黎,2494,0,0,1,1,0.0%,5m
19356,3,iiiiiiiiii,2494,0,0,2,2,0.0%,19m
19379,2,宙斯之劫,2493,1621,228,217,445,51.2%,1h
19379,3,不要打我要倒霉的,2493,1450,213,209,422,50.5%,10m
19379,3,AlenCreed,2493,1599,144,132,276,52.2%,1h
19379,1,一只小猫,2493,1554,79,79,158,50.0%,48m
19379,3,LILITH,2493,1091,76,72,148,51.4%,28m
19379,3,[loopf2]BangBOOM,2493,1606,68,52,120,56.7%,1h
19379,2,IIIIIIIIIIII,2493,351,15,18,33,45.5%,3m
19379,3,明月出天山,2493,280,11,16,27,40.7%,44m
19379,2,DoflaminGo,2493,225,8,9,17,47.1%,17m
19379,2,[一拳一个萌新]星际,2493,230,7,10,17,41.2%,1h
19379,2,[嫩爽口美鲍鱼]咸湿大叔,2493,228,7,10,17,41.2%,21m
19379,3,[染之炼狱]yuko,2493,185,6,7,13,46.2%,17m
19379,1,David,2493,190,6,12,18,33.3%,22m
19379,3,[社交学大可爱]醒醒,2493,141,4,2,6,66.7%,52m
19379,1,[马家沟白给王]DECADE,2493,96,4,8,12,33.3%,22m
19379,3,IarmMan,2493,121,3,1,4,75.0%,1h
19379,1,好兄弟,2493,48,3,5,8,37.5%,1h
19379,3,wwei,2493,95,2,0,2,100.0%,1h
19379,1,东皇焚天,2493,96,2,2,4,50.0%,15m
19379,3,斯托科夫,2493,60,2,3,5,40.0%,1h
19379,3,[狂风暴风雨]llllllllllll,2493,30,2,4,6,33.3%,1h
19379,1,AngraMainyuu,2493,0,2,4,6,33.3%,19m
19379,1,[自由审判军]SCDOG,2493,76,1,4,5,20.0%,37m
19379,1,[社交学巨可爱]mest,2493,0,0,1,1,0.0%,10m
19403,1,[AH64A]区域分割,2492,1545,137,141,278,49.3%,18m
19403,2,TDFYYGS,2492,173,84,76,160,52.5%,9m
19403,3,Group,2492,1251,74,60,134,55.2%,30m
19403,1,义武奋扬,2492,1389,61,50,111,55.0%,1h
19403,3,[SRE]稗说,2492,830,48,39,87,55.2%,46m
19403,2,[银翼之光]好人难当,2492,877,36,41,77,46.8%,1h
19403,3,黑子,2492,415,35,32,67,52.2%,1h
19403,3,输了也爱,2492,784,30,32,62,48.4%,1h
19403,3,QFS,2492,446,17,13,30,56.7%,10m
19403,3,eagle,2492,462,17,19,36,47.2%,6m
19403,3,女孩为什么穿内内,2492,402,15,14,29,51.7%,49m
19403,3,玩星际你快乐吗,2492,322,13,11,24,54.2%,1h
19403,3,[SoloAs]python,2492,290,11,14,25,44.0%,11m
19403,3,拂晓黎明,2492,190,5,5,10,50.0%,28m
19403,3,[秘封俱樂部]Devil,2492,90,4,5,9,44.4%,51m
19403,3,[孙哥的海鲜]乱紫沉烟,2492,171,4,6,10,40.0%,6m
19403,1,[极限菜鸟]TUSKIN,2492,121,3,0,3,100.0%,59m
19403,3,莱州六中暗黑势力,2492,60,2,4,6,33.3%,60m
19403,3,訾璇,2492,0,1,0,1,100.0%,10m
19403,1,第五晓杰,2492,0,1,0,1,100.0%,55m
19403,3,game,2492,0,1,1,2,50.0%,51m
19403,3,火影劫,2492,30,1,4,5,20.0%,1h
19403,3,Drabbit,2492,0,0,1,1,0.0%,1h
19403,3,fastlorde,2492,0,0,1,1,0.0%,60m
19403,2,橙子味的风,2492,0,0,1,1,0.0%,39m
19428,1,[哦哟喂呀]路虎揽胜,2491,1439,89,92,181,49.2%,54m
19428,2,吕宇宁还钱,2491,222,32,40,72,44.4%,1h
19428,3,YBW,2491,806,31,28,59,52.5%,20m
19428,3,SakuraMiko,2491,558,23,20,43,53.5%,1h
19428,1,Takizzz,2491,498,17,23,40,42.5%,22m
19428,3,超级菜鸟,2491,343,12,9,21,57.1%,20m
19428,2,Quinlan,2491,290,11,16,27,40.7%,39m
19428,2,大明帝国征服世界,2491,220,8,13,21,38.1%,9m
19428,3,sImpleQAQ,2491,92,5,8,13,38.5%,1h
19428,3,Emperor,2491,117,3,1,4,75.0%,30m
19428,3,[我们是无敌的]莱茵守望者,2491,60,3,4,7,42.9%,1h
19428,3,[Gj]风花雪月,2491,30,2,1,3,66.7%,1h
19428,1,LOVETT,2491,120,2,1,3,66.7%,36m
19428,1,九城,2491,0,2,2,4,50.0%,1h
19428,3,二傻兔子,2491,95,2,4,6,33.3%,1h
19428,3,YIDASI,2491,0,2,5,7,28.6%,20m
19428,1,TzKing,2491,0,1,4,5,20.0%,56m
19445,3,平凡人生,2490,581,54,50,104,51.9%,10m
19445,3,口巾,2490,1052,52,34,86,60.5%,1h
19445,1,[超神给你看哦]Expecto,2490,1141,43,47,90,47.8%,45m
19445,3,此生虚度年华,2490,606,32,21,53,60.4%,55m
19445,3,llllmlll,2490,500,26,14,40,65.0%,6m
19445,3,SCPLAYER,2490,600,22,30,52,42.3%,8m
19445,1,慢走不送,2490,304,10,12,22,45.5%,23m
19445,3,我叉叉,2490,240,7,7,14,50.0%,1h
19445,3,[随峰飘]冻土狼魂,2490,232,7,7,14,50.0%,1h
19445,2,[安排到位]BoJack,2490,237,7,11,18,38.9%,28m
19445,2,雨何时停,2490,194,7,12,19,36.8%,58m
19445,3,星宇,2490,175,6,7,13,46.2%,31m
19445,1,[stan]泓锦,2490,168,4,3,7,57.1%,25m
19445,3,[最菜战队]枫辰,2490,97,3,0,3,100.0%,51m
19445,3,群星璀璨之时,2490,121,3,5,8,37.5%,1h
19445,3,诺兰斯,2490,121,2,3,5,40.0%,14m
19445,2,四地尅,2490,30,2,4,6,33.3%,9m
19445,3,scp,2490,0,2,5,7,28.6%,1h
19445,3,星际小高,2490,0,2,5,7,28.6%,1h
19445,3,[大宇恩]支持正版,2490,0,1,0,1,100.0%,52m
19445,3,[TOD死神]聚义城,2490,0,1,0,1,100.0%,16m
19445,3,waajisdfgihj,2490,30,1,3,4,25.0%,1h
19467,1,[校园谐恶势力]wikings,2489,1563,179,174,353,50.7%,40m
19467,3,老虎打武松,2489,1484,104,91,195,53.3%,55m
19467,3,[NanTeS]IIIIIIIIII,2489,632,29,23,52,55.8%,1h
19467,2,凉城旧爱已不再,2489,497,22,22,44,50.0%,46m
19467,3,虹宇,2489,356,19,13,32,59.4%,28m
19467,1,朱五四,2489,494,19,25,44,43.2%,57m
19467,3,[是我赢了]季淼,2489,450,17,16,33,51.5%,38m
19467,3,lbwnb,2489,382,16,9,25,64.0%,1h
19467,3,albo,2489,363,14,15,29,48.3%,38m
19467,2,[CET6]秋名山老翻车,2489,340,13,8,21,61.9%,12m
19467,3,[CCHX]快手三岁成,2489,322,12,8,20,60.0%,17m
19467,3,一个热爱暴雪玩家,2489,374,12,12,24,50.0%,14m
19467,3,Moyu,2489,252,11,2,13,84.6%,28m
19467,2,铁男,2489,170,7,9,16,43.8%,1h
19467,2,infinity,2489,135,7,12,19,36.8%,1h
19467,3,mmyyf,2489,182,5,3,8,62.5%,6m
19467,1,Qdoctor,2489,193,4,5,9,44.4%,14m
19467,3,LSTX,2489,179,4,5,9,44.4%,1h
19467,2,[四叶草]俯首甘为孺子牛,2489,44,4,7,11,36.4%,1h
19467,1,曾能混,2489,48,3,5,8,37.5%,1h
19467,3,[暴雪三十二隊]夜半松风,2489,97,3,5,8,37.5%,1h
19467,3,战圣,2489,72,2,4,6,33.3%,1h
19467,3,[我即是霸主]残火之鸢,2489,93,1,1,2,50.0%,1h
19467,3,杰明,2489,0,1,2,3,33.3%,9m
19467,3,Clack,2489,30,1,3,4,25.0%,1h
19467,3,蒙恬,2489,0,0,1,1,0.0%,28m
19467,1,[帝国炮灰队]眼瞎手慢脑子笨,2489,0,0,1,1,0.0%,59m
19467,3,洛洛历险记,2489,0,0,1,1,0.0%,1h
19495,2,kevin,2488,1359,123,113,236,52.1%,39m
19495,2,宝宝,2488,1453,79,79,158,50.0%,39m
19495,3,LyHa,2488,1469,67,56,123,54.5%,30m
19495,3,厉飞羽,2488,1509,64,61,125,51.2%,1h
19495,2,[老油条战队]dfgde,2488,1020,50,52,102,49.0%,19m
19495,2,请叫我魏玉鹏,2488,595,24,23,47,51.1%,14m
19495,3,蒹葭苍茫猪猪侠,2488,512,22,13,35,62.9%,1h
19495,3,NightRaid,2488,500,22,14,36,61.1%,1h
19495,3,啸平,2488,503,21,12,33,63.6%,30m
19495,3,[TNT]nicole,2488,334,18,23,41,43.9%,21m
19495,1,[大宇宙时代]安德,2488,522,17,22,39,43.6%,47m
19495,2,[南信大小萌新]跟我的影子打拳吧,2488,331,14,8,22,63.6%,1h
19495,3,龙少若星,2488,298,10,7,17,58.8%,1h
19495,2,我最可爱啦啦啦,2488,221,9,8,17,52.9%,1h
19495,3,crossbow,2488,221,7,5,12,58.3%,60m
19495,3,killerQueen,2488,205,7,5,12,58.3%,1h
19495,2,rua,2488,190,6,8,14,42.9%,40m
19495,3,久昀,2488,216,6,8,14,42.9%,21m
19495,3,血瑟弥漫,2488,90,4,4,8,50.0%,1h
19495,3,[诺克萨斯]fchbvg,2488,116,4,7,11,36.4%,1h
19495,1,[NsfzSc]Rual,2488,185,3,9,12,25.0%,5m
19495,3,tyuzyyf,2488,30,2,2,4,50.0%,31m
19495,1,juhao,2488,97,2,4,6,33.3%,19m
19495,3,[1900]无敌小子,2488,62,2,5,7,28.6%,1h
19495,3,知秋一叶,2488,0,2,5,7,28.6%,1h
19495,3,由比滨结衣,2488,95,1,5,6,16.7%,1h
19495,3,海之仪,2488,0,0,1,1,0.0%,44m
19495,3,[QO]扒衣灬贱君姐,2488,0,0,1,1,0.0%,1h
19495,3,[惠妻知我]普残遇疯子就退,2488,0,0,2,2,0.0%,1h
19495,3,[真就白给啊]llllllllll,2488,0,0,2,2,0.0%,1h
19525,1,不要玩游戏,2487,1498,201,199,400,50.2%,17m
19525,3,可哥可妻孙一峰,2487,1054,46,36,82,56.1%,1h
19525,3,MRchen,2487,979,42,42,84,50.0%,1h
19525,3,Tonysee,2487,484,41,32,73,56.2%,1h
19525,1,一统天下,2487,807,34,38,72,47.2%,24m
19525,3,[五堰]快乐的板栗,2487,628,22,36,58,37.9%,13m
19525,3,坏宝宝,2487,261,20,15,35,57.1%,14m
19525,3,beast,2487,419,17,9,26,65.4%,1h
19525,2,朱傛基,2487,326,17,12,29,58.6%,46m
19525,3,婉转流逸,2487,345,13,12,25,52.0%,16m
19525,2,[在下萌新一只]有星际好玩吗,2487,259,9,9,18,50.0%,1h
19525,3,风潇雨落,2487,261,9,16,25,36.0%,10m
19525,3,天下人,2487,221,8,7,15,53.3%,1h
19525,1,混子,2487,118,6,7,13,46.2%,1h
19525,3,胡萝卜与面包,2487,116,3,0,3,100.0%,1h
19525,3,CARN,2487,97,3,4,7,42.9%,1h
19525,3,木毛野獸神楽夸,2487,30,1,2,3,33.3%,1h
19525,3,joker,2487,0,1,4,5,20.0%,1h
19525,2,有幸遇到,2487,88,1,5,6,16.7%,1h
19525,3,[C91509]兰哥,2487,0,0,1,1,0.0%,37m
19525,1,[DRI]幽灵,2487,0,0,2,2,0.0%,13m
19525,3,SHtossfnione,2487,0,0,2,2,0.0%,1h
19525,3,[Shawk]生命如风,2487,0,0,3,3,0.0%,52m
19525,3,xiaoliu,2487,0,0,4,4,0.0%,6m
19549,2,星际争霸执政官,2486,1394,205,192,397,51.6%,1h
19549,2,天空中的彩虹,2486,1021,128,127,255,50.2%,49m
19549,3,一切都在手,2486,1577,84,78,162,51.9%,16m
19549,3,国见比吕,2486,1411,65,54,119,54.6%,1h
19549,3,[贝贝龙]梦蝶蝶蝶蝶蝶,2486,242,29,11,40,72.5%,1h
19549,2,心平气核,2486,180,6,2,8,75.0%,1h
19549,3,Snoopy,2486,166,6,6,12,50.0%,1h
19549,3,听说你还睡觉,2486,109,5,10,15,33.3%,1h
19549,3,William,2486,110,3,0,3,100.0%,28m
19549,1,fish,2486,0,3,2,5,60.0%,40m
19549,1,切莫自白,2486,0,3,2,5,60.0%,58m
19549,3,[丨SLT丨]下雨不愁的头,2486,58,3,5,8,37.5%,14m
19549,1,大闲人,2486,48,3,5,8,37.5%,36m
19549,3,happyday,2486,38,3,6,9,33.3%,1h
19549,3,[咸鱼谐会]HUCSummer,2486,58,2,3,5,40.0%,60m
19549,2,一曲相思,2486,82,2,6,8,25.0%,1h
19549,1,[艾蒙是弟弟]冰封,2486,0,1,1,2,50.0%,10m
19549,3,一一一一,2486,30,1,2,3,33.3%,51m
19549,2,[超会玩]IIIIIIII,2486,0,1,2,3,33.3%,1h
19549,3,一权,2486,30,1,2,3,33.3%,44m
19549,1,[bei暴打]凡人,2486,44,1,5,6,16.7%,1h
19549,2,[混吃混喝]能不能别打探机啊,2486,0,0,1,1,0.0%,1h
19571,1,daixiao,2485,1588,85,88,173,49.1%,46m
19571,2,象郡龙生,2485,1573,84,86,170,49.4%,28m
19571,1,没有感情的菠萝头,2485,593,80,87,167,47.9%,18m
19571,2,falllllde,2485,1239,76,74,150,50.7%,49m
19571,3,皮黑投资小项宰,2485,1431,62,64,126,49.2%,1h
19571,3,无耻狗逼,2485,592,25,21,46,54.3%,16m
19571,3,樱田妮妮,2485,430,16,18,34,47.1%,10m
19571,3,furin,2485,262,10,8,18,55.6%,1h
19571,3,HSS,2485,262,8,6,14,57.1%,1h
19571,2,stoP,2485,188,6,8,14,42.9%,1h
19571,3,任飞,2485,145,4,1,5,80.0%,24m
19571,3,[冲击分队]大和骑脸怎么输,2485,121,3,0,3,100.0%,2m
19571,3,[桃家帮]布兜丁丶,2485,60,3,2,5,60.0%,10m
19571,1,究极抗韩,2485,124,3,6,9,33.3%,50m
19571,3,嘿哈,2485,30,3,6,9,33.3%,1h
19571,3,[傲世丨听雨轩]夜雨秋寒,2485,129,3,7,10,30.0%,1h
19571,3,[我们都是渣渣]HUO,2485,95,2,0,2,100.0%,10m
19571,3,派大星,2485,114,2,1,3,66.7%,44m
19571,2,小嘴凉飕飕,2485,92,2,3,5,40.0%,1h
19571,1,丶灬错待,2485,0,2,4,6,33.3%,58m
19571,3,[乾龙]好哥哥别打我,2485,0,1,0,1,100.0%,26m
19571,1,紫泪洛墨,2485,0,1,2,3,33.3%,5m
19571,3,Driai,2485,0,0,1,1,0.0%,55m
19571,1,就你叫夏洛呀,2485,0,0,1,1,0.0%,19m
19571,1,任日生,2485,0,0,4,4,0.0%,40m
19596,3,fdrgdfgfthth,2484,1502,98,98,196,50.0%,1h
19596,2,handsome,2484,1452,88,88,176,50.0%,3m
19596,3,龙剑道,2484,1297,79,66,145,54.5%,1h
19596,3,追上我,2484,672,29,24,53,54.7%,28m
19596,3,苏联政委,2484,317,27,22,49,55.1%,31m
19596,2,无敌,2484,517,21,24,45,46.7%,1h
19596,3,[逐梦之影]不弃,2484,204,13,7,20,65.0%,1h
19596,3,Jocker,2484,352,12,10,22,54.5%,1h
19596,2,HotShotttLee,2484,232,7,11,18,38.9%,1h
19596,3,Anqui,2484,148,6,6,12,50.0%,11m
19596,3,春去无踪,2484,134,3,1,4,75.0%,17m
19596,3,光环,2484,109,2,1,3,66.7%,1h
19596,2,[灵猫]大体快乐偶尔难,2484,91,2,1,3,66.7%,48m
19596,3,无情土木狗,2484,116,2,2,4,50.0%,28m
19596,3,IIIIIIIIIIII,2484,0,0,1,1,0.0%,6m
19596,3,刘博士,2484,0,0,2,2,0.0%,1h
19612,3,大苏打,2483,1566,209,198,407,51.4%,1h
19612,3,[少女的梦]人族正常开,2483,1573,64,55,119,53.8%,20m
19612,2,盛誉,2483,1144,56,56,112,50.0%,14m
19612,2,什么什么大菜鸟,2483,696,47,47,94,50.0%,36m
19612,3,荀文若,2483,856,39,26,65,60.0%,1h
19612,3,何某航,2483,965,36,33,69,52.2%,31m
19612,3,[TAPC]Kingsman,2483,646,28,20,48,58.3%,44m
19612,2,地球无敌舰队,2483,494,18,22,40,45.0%,32m
19612,3,哥是传说,2483,381,15,10,25,60.0%,44m
19612,3,[花开彼岸天]高傲的玉树人,2483,332,12,8,20,60.0%,1h
19612,1,evangelioner,2483,180,8,12,20,40.0%,1h
19612,3,[唐延路夜宵组]Stan,2483,204,7,2,9,77.8%,14m
19612,1,[244]绝雪天泠,2483,207,5,5,10,50.0%,33m
19612,3,七叔贼啦菜,2483,145,4,3,7,57.1%,1h
19612,1,龍子嘲風,2483,120,2,2,4,50.0%,43m
19612,3,[神武骑士团]Calm,2483,30,2,3,5,40.0%,1h
19612,3,[醋拌刺蛇头]暗影,2483,0,1,1,2,50.0%,1h
19612,1,zero,2483,0,1,1,2,50.0%,1h
19612,2,[菜的没人带]机壳路径灵,2483,44,1,4,5,20.0%,50m
19612,3,[sc谐盟]库平斯基,2483,0,0,1,1,0.0%,1h
19612,3,[专打嘤嘤怪]温柔的爱,2483,0,0,1,1,0.0%,40m
19633,2,wear,2482,1563,89,88,177,50.3%,8m
19633,1,Tsubasa,2482,698,53,55,108,49.1%,1h
19633,3,[CPT]吃牛排住大豪宅,2482,580,50,29,79,63.3%,10m
19633,2,[玛戈几泰伦]有本事打正面,2482,1327,50,52,102,49.0%,5m
19633,3,BigJJCaptain,2482,802,39,30,69,56.5%,55m
19633,2,silent,2482,601,25,19,44,56.8%,10m
19633,3,红门馆,2482,362,16,19,35,45.7%,1h
19633,3,jack,2482,354,15,13,28,53.6%,22m
19633,3,[DSE]RHTRU,2482,284,11,8,19,57.9%,16m
19633,3,蛋疼弹蛋,2482,293,11,14,25,44.0%,38m
19633,2,[神龍鬥士]九九天,2482,232,7,10,17,41.2%,1h
19633,3,[星际官网战队]田惠宇,2482,151,5,0,5,100.0%,1h
19633,1,[猪猪大家庭]aaaaaaaaaaa,2482,182,5,6,11,45.5%,20m
19633,3,[实地]缺啥找啥,2482,154,5,10,15,33.3%,10m
19633,3,suika,2482,114,4,5,9,44.4%,1h
19633,3,萌新,2482,120,4,9,13,30.8%,38m
19633,3,lijikai,2482,129,3,3,6,50.0%,43m
19633,3,[月见]项羽,2482,90,3,5,8,37.5%,1h
19633,3,[斩翼]圣殿的审判,2482,93,2,0,2,100.0%,26m
19633,1,[最爱酸菜面]金坷垃种庄稼,2482,0,2,3,5,40.0%,1h
19633,1,ZZbzghost,2482,0,2,3,5,40.0%,1h
19633,3,[霍霍酷铁锤]友谊之船上的死神,2482,0,1,0,1,100.0%,38m
19633,3,[DMRc]cry,2482,95,1,2,3,33.3%,40m
19633,3,[永恒星域]变形金刚,2482,0,0,1,1,0.0%,49m
19633,3,殇善,2482,0,0,1,1,0.0%,60m
19633,3,[呜呜呜嘤嘤]IIIIIIIIIIII,2482,0,0,1,1,0.0%,1h
19633,1,星际王,2482,0,0,2,2,0.0%,1h
19660,3,KKKKKKK,2481,1572,306,311,617,49.6%,27m
19660,2,紫火,2481,1567,237,239,476,49.8%,18m
19660,3,超级小鳴,2481,1416,150,158,308,48.7%,21m
19660,1,bingbing,2481,1194,115,117,232,49.6%,1h
19660,2,Mukkus,2481,1587,110,104,214,51.4%,32m
19660,2,折纸,2481,1402,86,77,163,52.8%,40m
19660,3,周欲为,2481,1017,60,53,113,53.1%,10m
19660,1,吕小布,2481,777,32,37,69,46.4%,36m
19660,2,小纯洁啊,2481,579,23,19,42,54.8%,1h
19660,3,安哥,2481,427,18,8,26,69.2%,1h
19660,2,AFK,2481,100,7,6,13,53.8%,1h
19660,2,[天羽不榖]淇侍,2481,202,7,14,21,33.3%,36m
19660,3,[虫子觉醒]隐三叶,2481,146,5,8,13,38.5%,1h
19660,3,[CPT]狂战天下,2481,120,5,20,25,20.0%,9m
19660,3,[雷蛇]开膛手灬洛萨,2481,118,4,5,9,44.4%,1h
19660,3,michael,2481,142,3,3,6,50.0%,1h
19660,3,[DMR]石头,2481,58,3,5,8,37.5%,1h
19660,3,[虫王巢]幽羽,2481,60,2,3,5,40.0%,37m
19660,3,晶耀,2481,0,2,5,7,28.6%,7m
19660,3,[红烧跳虫]Power,2481,0,1,0,1,100.0%,20m
19660,3,zero,2481,0,1,1,2,50.0%,1h
19660,3,吉姆雷偌,2481,95,1,1,2,50.0%,38m
19660,1,[12D专业]影墨,2481,32,1,11,12,8.3%,1h
19660,3,SliveR,2481,0,0,1,1,0.0%,1h
19660,1,天纵,2481,0,0,1,1,0.0%,40m
19660,3,SooMing,2481,0,0,1,1,0.0%,10m
19660,3,橘子橙,2481,0,0,2,2,0.0%,1h
19660,3,ccewo,2481,0,0,3,3,0.0%,1h
19688,2,[HeroZP]Superman,2480,630,67,62,129,51.9%,10m
19688,2,虐杀,2480,658,25,25,50,50.0%,1h
19688,2,nixnix,2480,640,25,28,53,47.2%,1h
19688,1,真实的菜鸡,2480,358,10,12,22,45.5%,22m
19688,1,Blood,2480,261,10,14,24,41.7%,1h
19688,1,OOOOO,2480,230,7,12,19,36.8%,51m
19688,3,周淑怡小宝贝,2480,36,3,6,9,33.3%,1h
19688,2,[天津理工大学]城市星辰,2480,88,3,9,12,25.0%,14m
19688,1,cdy,2480,145,2,1,3,66.7%,23m
19688,3,[C84665]OrangeLarge,2480,95,2,3,5,40.0%,1h
19688,1,lenbusi,2480,0,2,3,5,40.0%,5m
19688,1,[暗星X]买米当卡,2480,0,1,0,1,100.0%,9m
19688,3,嗨丶杰克,2480,0,1,1,2,50.0%,1h
19688,1,[KENNEL]Pulannis,2480,0,0,1,1,0.0%,12m
19688,3,老板来碗大姨妈,2480,0,0,2,2,0.0%,55m
19703,3,在家睡觉,2479,1243,99,105,204,48.5%,47m
19703,2,我是赖皮虫,2479,515,53,49,102,52.0%,57m
19703,1,一心一祎,2479,1376,49,38,87,56.3%,1m
19703,3,fash,2479,744,28,30,58,48.3%,20m
19703,3,一脸肱三头,2479,546,21,22,43,48.8%,1h
19703,3,狂暴小山猪,2479,456,15,19,34,44.1%,21m
19703,1,斗鹰,2479,450,12,8,20,60.0%,51m
19703,3,玖拾肆,2479,274,9,8,17,52.9%,1h
19703,3,恋慕伴侣步惊云,2479,161,7,4,11,63.6%,6m
19703,1,新手,2479,140,4,5,9,44.4%,1h
19703,1,玛利亚,2479,86,3,0,3,100.0%,37m
19703,3,黑衣剑士,2479,146,3,3,6,50.0%,30m
19703,1,克哈老子,2479,48,3,4,7,42.9%,19m
19703,3,PirateKing,2479,97,1,1,2,50.0%,1h
19703,3,[CNB]无色十二月,2479,0,1,3,4,25.0%,46m
19703,3,君子剑,2479,0,0,1,1,0.0%,40m
19703,1,不朽爹,2479,0,0,1,1,0.0%,1h
19703,1,[Rdx]彩虹,2479,0,0,1,1,0.0%,1h
19703,1,kira,2479,0,0,1,1,0.0%,1h
19703,3,WPM,2479,0,0,3,3,0.0%,1h
19723,2,波林高手,2478,674,128,124,252,50.8%,36m
19723,2,IIIIIIIIIIII,2478,796,27,33,60,45.0%,39m
19723,2,洪映妮,2478,647,25,24,49,51.0%,28m
19723,1,[致逝去的青春]坎博,2478,676,20,12,32,62.5%,1h
19723,2,knightkami,2478,379,12,15,27,44.4%,19m
19723,2,琉璃殿主,2478,184,7,11,18,38.9%,3m
19723,3,[阿力]我来说晚安,2478,120,5,5,10,50.0%,1h
19723,3,[ceeeeb]陆夯,2478,0,4,3,7,57.1%,22m
19723,3,[萌萌哒鸡]芳香的猪,2478,58,3,2,5,60.0%,1h
19723,3,上条当麻,2478,97,3,4,7,42.9%,26m
19723,2,我很温柔的,2478,114,3,14,17,17.6%,2m
19723,1,不朽攻城坦克,2478,82,2,1,3,66.7%,34m
19723,1,蟲战丶,2478,120,2,1,3,66.7%,23m
19723,3,[慢手e族]名丨罪过,2478,114,2,3,5,40.0%,44m
19723,1,红白的梦想结界,2478,0,1,1,2,50.0%,48m
19723,3,MYMlost,2478,0,1,1,2,50.0%,52m
19723,1,古树,2478,48,1,1,2,50.0%,23m
19723,1,第三年的见异思迁,2478,0,0,1,1,0.0%,1h
19723,1,[fanche]科洛桑的霓虹,2478,0,0,1,1,0.0%,1h
19723,1,STARS,2478,0,0,1,1,0.0%,1h
19723,1,[全给老子死]杨超越,2478,0,0,1,1,0.0%,1h
19723,1,STONE,2478,0,0,1,1,0.0%,1h
19723,3,[在下萌新一只]永恒即逝,2478,0,0,2,2,0.0%,1h
19746,3,RRxh,2477,1395,110,91,201,54.7%,1h
19746,3,爸爸,2477,355,18,8,26,69.2%,21m
19746,3,ICboom,2477,438,17,21,38,44.7%,1h
19746,2,留住冬天,2477,281,15,19,34,44.1%,9m
19746,1,Lrassion,2477,412,13,19,32,40.6%,45m
19746,3,kevinzx,2477,222,9,8,17,52.9%,40m
19746,3,霸气,2477,199,6,9,15,40.0%,1h
19746,1,百战秋铭,2477,164,5,2,7,71.4%,23m
19746,3,[Rhusky]王蝈蝈,2477,30,2,2,4,50.0%,1h
19746,1,城市化天下无双,2477,0,2,3,5,40.0%,40m
19746,1,筱枫丿恋,2477,0,1,0,1,100.0%,1h
19746,1,[妹子嘿嘿嘿]小天之影,2477,0,1,0,1,100.0%,18m
19746,1,cqcqcq,2477,0,0,1,1,0.0%,18m
19746,1,[北极光之旅]jyt,2477,0,0,1,1,0.0%,44m
19746,3,本尼迪克特赵四,2477,0,0,1,1,0.0%,22m
19746,3,jin,2477,0,0,2,2,0.0%,1h
19762,3,GTR,2476,718,38,37,75,50.7%,10m
19762,1,[温柔兔公主]llllllllllll,2476,633,23,10,33,69.7%,1h
19762,2,[英雄协会]骑士的称号,2476,459,16,19,35,45.7%,1h
19762,1,小仙女,2476,417,14,20,34,41.2%,31m
19762,2,硬汉,2476,396,13,21,34,38.2%,32m
19762,2,[美少女萬華鏡]顶级萝莉控,2476,128,2,3,5,40.0%,19m
19762,1,刻于新月之铭,2476,0,2,3,5,40.0%,56m
19762,1,无聊,2476,96,2,4,6,33.3%,1h
19762,3,Antony,2476,58,2,5,7,28.6%,30m
19762,1,BoundlessG,2476,0,1,3,4,25.0%,40m
19762,1,[SCMIW]我打不赢就投诉,2476,0,0,1,1,0.0%,44m
19762,1,战恶灬善,2476,0,0,1,1,0.0%,1h
19762,1,[天枢]DFG,2476,0,0,1,1,0.0%,48m
19762,2,影子,2476,0,0,3,3,0.0%,1h
19776,1,[killer]暴走族,2475,1421,203,205,408,49.8%,46m
19776,3,Shadow,2475,1015,60,57,117,51.3%,28m
19776,2,NIGHTMARE,2475,1327,56,56,112,50.0%,32m
19776,3,[世风第三帝国]风剑雪,2475,1282,54,42,96,56.2%,1h
19776,3,大赫,2475,1039,51,59,110,46.4%,1h
19776,2,迷茫骑士,2475,1195,47,52,99,47.5%,1h
19776,2,[小鸡屠宰场b]really,2475,668,46,48,94,48.9%,30m
19776,2,又菜又爱玩的菜鸡,2475,687,29,25,54,53.7%,32m
19776,1,飞天的拉拉,2475,543,19,24,43,44.2%,6m
19776,1,尛梦,2475,500,16,17,33,48.5%,53m
19776,1,枫溪风兮,2475,489,13,6,19,68.4%,8m
19776,3,火药枪丶,2475,248,13,12,25,52.0%,40m
19776,3,白面馒头,2475,371,12,12,24,50.0%,1h
19776,3,sugerrrrrr,2475,307,11,8,19,57.9%,55m
19776,3,[今天天气真好]薄荷喵呜,2475,262,9,10,19,47.4%,1h
19776,3,哥是星际,2475,211,6,5,11,54.5%,1h
19776,2,[星际爱好者队]karsa,2475,154,5,3,8,62.5%,18m
19776,1,khvgfd,2475,48,4,3,7,57.1%,1h
19776,3,猪油拌饭,2475,165,4,4,8,50.0%,40m
19776,1,初代,2475,94,2,4,6,33.3%,1h
19776,1,jiangshiken,2475,0,0,1,1,0.0%,1h
19776,1,罗杰,2475,0,0,1,1,0.0%,1h
19776,3,[摸爆]隐雷湮覡,2475,0,0,2,2,0.0%,1h
19799,2,for,2474,1523,119,119,238,50.0%,1h
19799,2,[打得很水]诗诗小可爱,2474,1290,74,72,146,50.7%,30m
19799,3,pimba,2474,440,24,21,45,53.3%,51m
19799,3,皮球导弹,2474,423,15,13,28,53.6%,1h
19799,1,[暴雪五队]Dawn,2474,275,14,12,26,53.8%,25m
19799,3,国宝大熊猫,2474,34,5,5,10,50.0%,1h
19799,3,小小的牢饭,2474,70,4,6,10,40.0%,1h
19799,1,十二丶门狂,2474,74,2,1,3,66.7%,44m
19799,3,九槑,2474,96,2,1,3,66.7%,21m
19799,3,浮夸的人,2474,30,2,2,4,50.0%,30m
19799,3,玄冥级战列巡洋舰,2474,0,1,1,2,50.0%,1h
19799,1,bawang,2474,0,1,1,2,50.0%,10m
19799,1,呜呜机,2474,0,0,1,1,0.0%,1h
19799,3,nothing,2474,0,0,2,2,0.0%,17m
19799,3,bunnyMoXuan,2474,0,0,4,4,0.0%,9m
19814,3,[俺是新来的]刘力铭,2473,1524,58,66,124,46.8%,1h
19814,2,杜祥明,2473,1186,50,50,100,50.0%,10m
19814,3,我是新手,2473,958,49,33,82,59.8%,17m
19814,3,梦幻,2473,727,33,24,57,57.9%,1h
19814,3,[CPT]喵喵爱恰小鱼干,2473,679,29,22,51,56.9%,30m
19814,3,DrIV,2473,438,18,15,33,54.5%,1h
19814,3,黑夜传说,2473,455,18,20,38,47.4%,6m
19814,2,[2000年]夜樱,2473,218,8,12,20,40.0%,50m
19814,2,神风者,2473,189,7,6,13,53.8%,4m
19814,2,[斯卡哈]貌美如花斯卡哈,2473,108,4,12,16,25.0%,12m
19814,3,吟瘾怪,2473,67,3,5,8,37.5%,21m
19814,1,扑街,2473,0,2,4,6,33.3%,36m
19814,3,[Join]两船兵,2473,30,2,4,6,33.3%,51m
19814,3,HFF,2473,60,2,5,7,28.6%,1h
19814,1,龙兔,2473,40,1,1,2,50.0%,1h
19814,3,林登万,2473,96,1,2,3,33.3%,30m
19814,1,kongbai,2473,0,0,1,1,0.0%,1h
19814,2,小鱼易联,2473,0,0,1,1,0.0%,14m
19814,3,JUSTCOM,2473,0,0,2,2,0.0%,6m
19833,1,[CPT]MIROCLE,2472,1568,235,251,486,48.4%,1h
19833,1,没有名字不能玩,2472,1572,136,120,256,53.1%,1h
19833,1,我要瓦斯,2472,1516,92,88,180,51.1%,57m
19833,1,Hesher,2472,1578,77,90,167,46.1%,21m
19833,3,刚下星际没两天,2472,1256,64,69,133,48.1%,20m
19833,1,GCU,2472,1556,51,60,111,45.9%,1h
19833,3,SCV,2472,456,23,20,43,53.5%,1h
19833,3,taiking,2472,335,13,15,28,46.4%,1h
19833,3,史彼得羊,2472,295,9,10,19,47.4%,16m
19833,3,[ANTARE]Asita,2472,180,6,8,14,42.9%,1h
19833,1,DearJohn,2472,97,3,3,6,50.0%,1h
19833,3,[皇权天命]白衣卿相,2472,146,3,4,7,42.9%,1h
19833,3,谁在乱叫舰队,2472,169,3,5,8,37.5%,1h
19833,3,[经常一起玩的]诺亚,2472,97,2,2,4,50.0%,1h
19833,3,[银河第一舰队]血性小哥,2472,120,2,3,5,40.0%,22m
19833,1,暗鱼,2472,0,1,0,1,100.0%,45m
19833,1,[唯爱彦神]战巡舰掌柜,2472,0,0,1,1,0.0%,45m
19850,2,涿鹿群雄,2471,987,49,41,90,54.4%,1h
19850,1,路飞,2471,252,36,37,73,49.3%,54m
19850,1,阿斯塔罗特,2471,841,32,36,68,47.1%,40m
19850,1,不会吧不会吧,2471,638,23,23,46,50.0%,1h
19850,1,琴魔,2471,546,16,10,26,61.5%,1h
19850,2,[shangd]白衣贼,2471,380,14,14,28,50.0%,31m
19850,2,BILIZARDqin,2471,319,11,18,29,37.9%,1h
19850,3,为别人的事灬哭泣,2471,206,7,8,15,46.7%,6m
19850,1,最菜的菜鸟,2471,253,6,4,10,60.0%,16m
19850,3,[我菜请打队友]攻破癌症,2471,48,5,5,10,50.0%,1h
19850,3,KingOfTempo,2471,192,5,6,11,45.5%,1h
19850,1,破晓,2471,76,3,0,3,100.0%,1h
19850,3,xvrrd,2471,131,3,2,5,60.0%,22m
19850,1,SCPLAYER,2471,0,3,3,6,50.0%,1h
19850,3,打装机,2471,60,3,3,6,50.0%,26m
19850,1,杭州少女想打电竞,2471,115,3,4,7,42.9%,1h
19850,3,Nickychang,2471,30,1,6,7,14.3%,30m
19850,1,[社交学教授]wdnmd,2471,0,0,1,1,0.0%,1h
19850,3,石头儿,2471,0,0,2,2,0.0%,1h
19869,3,ltaaa,2470,1540,168,180,348,48.3%,1h
19869,1,[最菜战队]骑着浮云看羊驼,2470,1542,140,148,288,48.6%,1h
19869,1,[第七駆逐鑑隊]小马哥哥,2470,1539,125,126,251,49.8%,1h
19869,2,Sparkingfire,2470,1358,82,88,170,48.2%,3m
19869,3,[TLGD]sss,2470,654,45,54,99,45.5%,14m
19869,2,修行的小刚,2470,299,20,22,42,47.6%,1h
19869,1,DYZ,2470,293,9,4,13,69.2%,13m
19869,2,存钱买宝马,2470,302,9,15,24,37.5%,31m
19869,2,salad,2470,288,9,16,25,36.0%,1h
19869,3,Fenrisfult,2470,166,5,2,7,71.4%,1h
19869,2,AIRBORNE,2470,128,5,11,16,31.2%,3m
19869,2,[知乎战队]快看有逗逼,2470,200,5,12,17,29.4%,10m
19869,1,浪味仙,2470,0,4,1,5,80.0%,36m
19869,3,THEFOOL,2470,36,4,6,10,40.0%,1h
19869,3,遥夜,2470,122,4,10,14,28.6%,21m
19869,3,你看我吊吗,2470,150,3,5,8,37.5%,29m
19869,1,城市化建筑师,2470,96,3,6,9,33.3%,1h
19869,1,[如梦山河]今晚梦见我,2470,97,2,4,6,33.3%,6m
19869,1,llllllllllll,2470,48,2,7,9,22.2%,1h
19869,1,jokness,2470,0,1,0,1,100.0%,1h
19869,1,阎魔爱,2470,0,1,0,1,100.0%,1h
19869,3,登哥,2470,95,1,2,3,33.3%,22m
19869,3,rulebreaker,2470,95,1,2,3,33.3%,6m
19869,1,[Sakiii]IllIlllIlIIl,2470,0,1,4,5,20.0%,1h
19869,1,[黑粉头子]skr,2470,0,0,1,1,0.0%,1h
19869,1,jim,2470,0,0,1,1,0.0%,33m
19869,1,偷吃你家大米,2470,0,0,1,1,0.0%,51m
19869,3,毓文大帝,2470,0,0,2,2,0.0%,44m
19897,1,我爱吃土豆,2469,1309,181,185,366,49.5%,18m
19897,2,ilili,2469,1310,54,47,101,53.5%,24m
19897,2,最强男人黎力,2469,674,22,27,49,44.9%,1h
19897,1,serral,2469,374,12,9,21,57.1%,43m
19897,1,全村最好的剑,2469,294,8,18,26,30.8%,47m
19897,3,IIIIIIIIIII,2469,88,4,4,8,50.0%,1h
19897,1,中国全球第一,2469,0,2,4,6,33.3%,1h
19897,3,[CPT]神族舰队都没傻,2469,0,1,1,2,50.0%,21m
19897,1,dhaeaws,2469,0,1,4,5,20.0%,20m
19897,1,初阳的猫,2469,0,0,1,1,0.0%,1h
19897,3,[甜茶]十九黎,2469,0,0,2,2,0.0%,1h
19897,3,[永不白给]夜探青楼,2469,0,0,2,2,0.0%,30m
19909,3,cook,2468,466,43,43,86,50.0%,9m
19909,2,白驹过隙,2468,866,40,27,67,59.7%,1h
19909,3,不理不理左卫门,2468,887,33,45,78,42.3%,29m
19909,3,RoAYakov,2468,605,22,23,45,48.9%,1h
19909,3,好麻烦,2468,468,18,21,39,46.2%,46m
19909,3,RaymandUN,2468,542,18,23,41,43.9%,1h
19909,3,随便玩玩,2468,363,12,13,25,48.0%,46m
19909,3,Death,2468,308,11,9,20,55.0%,37m
19909,1,樱璃花,2468,213,11,11,22,50.0%,1h
19909,3,[猫神教教会]MARU,2468,232,8,4,12,66.7%,1h
19909,3,[巴楚文化广场]楚歌只因风起,2468,169,7,8,15,46.7%,1h
19909,3,不可名状之物,2468,96,2,1,3,66.7%,28m
19909,3,受打击了,2468,40,2,8,10,20.0%,1h
19909,3,莎拉雷诺,2468,0,1,2,3,33.3%,1h
19909,2,宇宙星神,2468,0,1,3,4,25.0%,16m
19909,3,nbhahaha,2468,32,1,4,5,20.0%,1h
19909,1,有种轰趴我,2468,0,0,1,1,0.0%,37m
19909,3,sorry,2468,0,0,3,3,0.0%,11m
19927,1,乳此可怕,2467,1503,100,104,204,49.0%,1h
19927,3,[小鸡屠宰场a]丁铁军,2467,1331,76,66,142,53.5%,1h
19927,1,霜冻之国足,2467,1352,68,95,163,41.7%,15m
19927,3,大漠孤烟,2467,993,54,47,101,53.5%,28m
19927,3,[第三駆逐鑑隊]孤独,2467,181,27,18,45,60.0%,37m
19927,3,零度冰寒,2467,509,18,20,38,47.4%,1h
19927,2,尼德霍格,2467,460,17,24,41,41.5%,9m
19927,2,sdasdasd,2467,413,15,17,32,46.9%,38m
19927,3,hyfguyf,2467,167,7,5,12,58.3%,6m
19927,1,冰镇大西瓜,2467,179,5,7,12,41.7%,23m
19927,1,沃夫曼,2467,192,4,6,10,40.0%,9m
19927,1,不露也锋芒,2467,0,2,4,6,33.3%,25m
19927,3,艾伦,2467,0,2,5,7,28.6%,1h
19927,1,零度,2467,48,2,5,7,28.6%,21m
19927,3,老牛总是爱吃草,2467,0,2,5,7,28.6%,1h
19927,3,llllllllllll,2467,30,1,7,8,12.5%,1h
19927,3,[风云神]nade,2467,0,0,1,1,0.0%,1h
19927,1,lrs,2467,0,0,1,1,0.0%,60m
19927,1,淮安孙一峰,2467,0,0,1,1,0.0%,1h
19927,1,萌新瑟瑟发抖,2467,0,0,1,1,0.0%,22m
19927,3,国民老公张宇宸,2467,0,0,2,2,0.0%,1h
19948,1,OceanFox,2466,1278,314,311,625,50.2%,6m
19948,1,建筑二院姚日天,2466,1562,279,275,554,50.4%,40m
19948,1,Jack,2466,1452,54,59,113,47.8%,1h
19948,1,愚钝小丑,2466,1320,44,42,86,51.2%,23m
19948,3,大革命,2466,864,37,33,70,52.9%,28m
19948,1,Arhan,2466,529,21,25,46,45.7%,40m
19948,1,胡鹏好友,2466,528,19,28,47,40.4%,1h
19948,3,[暴雪嘉年华]星际争爸,2466,356,13,11,24,54.2%,1h
19948,1,[抢矿小分队]芝士,2466,390,12,12,24,50.0%,37m
19948,1,PalmehrNath,2466,371,12,14,26,46.2%,10m
19948,3,mmmmk,2466,269,9,8,17,52.9%,4m
19948,1,嗜血,2466,339,9,18,27,33.3%,54m
19948,3,[是我赢了]loschristmas,2466,138,7,9,16,43.8%,11m
19948,1,建文帝,2466,204,6,0,6,100.0%,37m
19948,1,[这个是神魔恋]GOODTIME,2466,164,5,1,6,83.3%,52m
19948,1,克苏鲁之信徒,2466,96,4,3,7,57.1%,12m
19948,1,[哔哩哔哩杯乾]带一胶布,2466,139,3,8,11,27.3%,1h
19948,1,等风的云,2466,42,2,0,2,100.0%,22m
19948,1,fairy,2466,0,2,3,5,40.0%,14m
19948,3,[PHP最好]Trowar,2466,60,2,4,6,33.3%,44m
19948,1,RegretForYou,2466,0,1,0,1,100.0%,35m
19948,3,Revenger,2466,97,1,2,3,33.3%,20m
19948,3,Firewhere,2466,30,1,3,4,25.0%,4m
19948,1,ORChailly,2466,81,1,5,6,16.7%,44m
19948,2,sham,2466,0,0,1,1,0.0%,1h
19948,3,[皇子]昊昊,2466,0,0,2,2,0.0%,1h
19948,3,内心,2466,0,0,3,3,0.0%,1h
19975,2,hujiehui,2465,1527,64,65,129,49.6%,1h
19975,3,火雨,2465,857,37,27,64,57.8%,44m
19975,2,周小时,2465,664,24,26,50,48.0%,46m
19975,1,我今天三岁了,2465,651,20,11,31,64.5%,23m
19975,1,天蓝,2465,362,12,13,25,48.0%,1h
19975,2,BBcoffee,2465,191,7,10,17,41.2%,1h
19975,3,越玩越菜,2465,172,4,6,10,40.0%,1h
19975,3,盘旋于星海的雀鹰,2465,0,1,1,2,50.0%,28m
19975,1,送死先锋,2465,0,0,1,1,0.0%,37m
19975,1,附着,2465,0,0,1,1,0.0%,43m
19975,3,嘴臭的爬,2465,0,0,2,2,0.0%,1h
19986,3,KID,2464,1553,184,173,357,51.5%,55m
19986,3,Sinan,2464,1542,74,55,129,57.4%,1h
19986,3,Skura,2464,1440,71,64,135,52.6%,55m
19986,2,星星不会玩,2464,1556,69,80,149,46.3%,9m
19986,2,吕晓是狗,2464,1020,60,56,116,51.7%,49m
19986,2,最美是回忆丶,2464,503,53,34,87,60.9%,3m
19986,3,猴子,2464,507,38,30,68,55.9%,37m
19986,2,放开我队友冲我来,2464,1002,38,38,76,50.0%,32m
19986,3,鬼哭狼嚎,2464,735,29,27,56,51.8%,51m
19986,2,[ETT]deadlycool,2464,640,28,30,58,48.3%,15m
19986,2,我是新手,2464,466,19,22,41,46.3%,39m
19986,3,[000101]decade,2464,353,15,14,29,51.7%,10m
19986,3,邪魔之神,2464,398,14,12,26,53.8%,1h
19986,3,小智,2464,335,14,18,32,43.8%,1h
19986,3,[只会刚正面]Minerva,2464,142,9,9,18,50.0%,31m
19986,3,[LYB灬星际]二神,2464,214,7,7,14,50.0%,1h
19986,3,hjj,2464,149,5,6,11,45.5%,1h
19986,3,[SC嘤嘤嘤]Cry,2464,58,3,5,8,37.5%,1h
19986,3,ZELAIODASC,2464,97,3,5,8,37.5%,19m
19986,1,[DJTCG]BEILIDADI,2464,144,3,5,8,37.5%,56m
19986,3,藤田刚,2464,32,3,6,9,33.3%,36m
19986,1,简单电脑,2464,44,2,1,3,66.7%,8m
19986,3,andeler,2464,115,2,2,4,50.0%,1h
19986,1,CaptainJacky,2464,97,2,4,6,33.3%,16m
19986,3,CJF,2464,0,1,1,2,50.0%,1h
19986,3,OVO,2464,0,1,1,2,50.0%,31m
19986,3,[Sc养老]KdirDin,2464,30,1,6,7,14.3%,44m
19986,1,zjy,2464,0,0,1,1,0.0%,1h
19986,2,菜鸟列兵,2464,0,0,1,1,0.0%,58m
19986,3,[甘肃学院]OCforever,2464,0,0,3,3,0.0%,28m
19986,3,向风偏笑艳阳人,2464,0,0,3,3,0.0%,1h
19986,1,Camelocurry,2464,0,0,6,6,0.0%,54m
20018,1,[13BES]Yoeir,2463,1236,264,255,519,50.9%,41m
20018,3,Leopard,2463,701,162,154,316,51.3%,1h
20018,3,zhy,2463,803,60,54,114,52.6%,49m
20018,3,MrMao,2463,1225,58,47,105,55.2%,10m
20018,2,[一起9]红尘灬落日,2463,883,36,30,66,54.5%,16m
20018,3,thomasKing,2463,648,27,21,48,56.2%,1h
20018,1,退役熬夜员,2463,647,23,12,35,65.7%,13m
20018,1,[一戰成名]BAIGEZI,2463,642,17,18,35,48.6%,35m
20018,1,仰望,2463,381,13,16,29,44.8%,1h
20018,1,sniper,2463,193,8,15,23,34.8%,1h
20018,3,[神魔降临]薯条,2463,216,7,11,18,38.9%,6m
20018,1,[C90830]查理斯王子,2463,176,6,1,7,85.7%,1h
20018,3,nemo,2463,199,5,4,9,55.6%,22m
20018,1,熊熊铁拳,2463,216,5,6,11,45.5%,20m
20018,2,qwecindy,2463,155,5,8,13,38.5%,14m
20018,1,永恒不归,2463,48,4,3,7,57.1%,56m
20018,3,[Crus]Miroslav,2463,145,4,4,8,50.0%,1h
20018,2,雏村,2463,112,4,8,12,33.3%,32m
20018,2,战争风暴,2463,78,3,5,8,37.5%,48m
20018,1,黑白,2463,94,2,2,4,50.0%,13m
20018,1,[夕日坂]艾莉希尔,2463,0,2,3,5,40.0%,21m
20018,3,恐龙跳跳,2463,0,2,6,8,25.0%,1h
20018,1,Rayzli,2463,0,1,0,1,100.0%,17m
20018,1,李子树,2463,0,1,1,2,50.0%,20m
20018,3,奇利艾,2463,0,1,1,2,50.0%,29m
20018,1,陈先生,2463,0,1,2,3,33.3%,1h
20018,3,[不狗]河川,2463,30,1,3,4,25.0%,1h
20018,3,wzy,2463,0,1,3,4,25.0%,1h
20018,1,大宝剑,2463,0,1,4,5,20.0%,25m
20018,1,悟饭饭,2463,0,0,3,3,0.0%,6m
20048,2,[远洋纪元]倒吊人,2462,1262,84,80,164,51.2%,53m
20048,3,[混元体我女仆]笨笨喂你吃糖糖,2462,527,25,18,43,58.1%,44m
20048,2,ssssssssssss,2462,578,22,25,47,46.8%,24m
20048,3,骑着蜗牛追飞机,2462,295,10,9,19,52.6%,1h
20048,3,秦汉唐明,2462,287,9,8,17,52.9%,6m
20048,1,七夜天道,2462,319,8,7,15,53.3%,45m
20048,2,[打铁自身硬]Destory,2462,263,8,12,20,40.0%,16m
20048,3,XieRongHua,2462,168,6,5,11,54.5%,1h
20048,3,丿打个锤子,2462,189,6,6,12,50.0%,1h
20048,3,沄之风岚,2462,90,4,6,10,40.0%,28m
20048,1,迈向星际的大坑,2462,86,2,4,6,33.3%,9m
20048,1,唯美丶红颜伴君笑,2462,0,1,1,2,50.0%,20m
20048,2,阿炜不俊,2462,0,1,3,4,25.0%,1h
20048,1,不纯骚年,2462,48,1,5,6,16.7%,1h
20062,1,[梦瑾空人心]天使之翼,2461,1515,164,153,317,51.7%,24m
20062,1,YukiChan,2461,1329,50,63,113,44.2%,59m
20062,2,奎尔萨拉斯骑士,2461,1203,45,49,94,47.9%,49m
20062,2,渔夫,2461,867,43,45,88,48.9%,1h
20062,3,再见送哈哪,2461,521,32,44,76,42.1%,25m
20062,1,lovewill,2461,846,31,41,72,43.1%,1h
20062,3,[极限菜鸟]年轻人不讲武德,2461,361,30,23,53,56.6%,20m
20062,2,龙与地下城,2461,378,12,18,30,40.0%,1h
20062,3,hownice,2461,325,11,9,20,55.0%,1h
20062,3,封道巫吕,2461,112,11,12,23,47.8%,1h
20062,3,CMOON,2461,268,10,8,18,55.6%,16m
20062,3,追梦的酗酒蜗牛,2461,261,9,6,15,60.0%,22m
20062,3,hqd,2461,114,7,5,12,58.3%,1h
20062,1,请把狗狗还给我,2461,169,6,11,17,35.3%,1h
20062,3,白给一号,2461,144,4,4,8,50.0%,28m
20062,3,无敌寂寞,2461,146,4,9,13,30.8%,29m
20062,1,guang,2461,0,3,2,5,60.0%,1h
20062,3,[迷宫丨极限组]堕落的凯帝,2461,97,2,1,3,66.7%,1h
20062,3,吾持青灯锁万魂,2461,0,2,5,7,28.6%,1h
20062,1,[小埋]阿曼达,2461,0,1,0,1,100.0%,2m
20062,3,[爪巴]艾尔知耻,2461,0,1,1,2,50.0%,31m
20062,3,Frost,2461,30,1,3,4,25.0%,14m
20062,1,KINGKONG,2461,0,1,4,5,20.0%,9m
20062,1,Rooter,2461,0,0,1,1,0.0%,1h
20086,2,spril,2460,1537,93,84,177,52.5%,28m
20086,3,ovo,2460,1101,89,87,176,50.6%,22m
20086,2,孙哥起峰了,2460,840,65,53,118,55.1%,1h
20086,1,梓菡,2460,559,19,11,30,63.3%,1h
20086,2,无爱式回忆,2460,562,19,27,46,41.3%,1h
20086,3,HULI,2460,343,17,15,32,53.1%,28m
20086,3,废物玩一对一,2460,411,14,20,34,41.2%,17m
20086,1,[谐新部落]狂奔的西瓜,2460,388,13,14,27,48.1%,1h
20086,3,[科普鲁苏维埃]永蒂,2460,324,12,14,26,46.2%,1h
20086,2,[蟹堡王]咬嘴,2460,213,11,9,20,55.0%,2m
20086,2,REDBULLHAO,2460,273,10,9,19,52.6%,32m
20086,3,NOe,2460,189,6,5,11,54.5%,1h
20086,2,不可休思,2460,159,5,2,7,71.4%,26m
20086,3,[红莲骑士团]Freedom,2460,172,5,7,12,41.7%,6m
20086,1,[哔翻天梯鸡]咸鱼之王,2460,164,4,4,8,50.0%,30m
20086,3,卡布奇诺,2460,30,2,5,7,28.6%,14m
20086,3,mercury,2460,0,2,6,8,25.0%,1h
20086,1,kcyclever,2460,0,1,0,1,100.0%,1h
20086,1,[文韬武略]浪子,2460,0,1,0,1,100.0%,2m
20086,3,[萌神]GGGGGGGGGGGG,2460,94,1,3,4,25.0%,49m
20086,3,墨染之樱,2460,30,1,3,4,25.0%,11m
20086,1,Fenix,2460,48,1,7,8,12.5%,40m
20086,1,胡较瘦,2460,0,0,1,1,0.0%,6m
20086,1,[天堂之魔]laomao,2460,0,0,2,2,0.0%,1h
20086,1,asdhwh,2460,0,0,2,2,0.0%,25m
20086,3,亡灵,2460,0,0,2,2,0.0%,1h
20112,3,逐风,2459,1575,111,125,236,47.0%,2m
20112,3,[龙帝星系]peter,2459,846,60,57,117,51.3%,1h
20112,3,Microwing,2459,290,50,45,95,52.6%,46m
20112,2,逗我呢哈哈哈,2459,272,13,16,29,44.8%,1h
20112,3,带带我,2459,325,11,11,22,50.0%,1h
20112,3,心中无女人,2459,214,7,8,15,46.7%,28m
20112,3,你杨嗲嗲,2459,204,6,9,15,40.0%,43m
20112,3,Aixuexi,2459,97,4,4,8,50.0%,1h
20112,1,妈个鸡遭重了,2459,82,3,1,4,75.0%,50m
20112,1,[charol]zhou,2459,48,3,2,5,60.0%,1h
20112,1,雷爆,2459,96,2,4,6,33.3%,1h
20112,1,快乐的小猫,2459,96,2,4,6,33.3%,56m
20112,1,haozi,2459,48,2,5,7,28.6%,1h
20112,3,玻璃人,2459,0,2,5,7,28.6%,6m
20112,3,死神永生,2459,0,1,1,2,50.0%,9m
20112,3,[旺旺战士]sickly,2459,0,1,2,3,33.3%,1h
20112,3,vito,2459,84,1,2,3,33.3%,7m
20112,1,leolian,2459,0,1,4,5,20.0%,14m
20112,1,小兵,2459,0,1,4,5,20.0%,1h
20112,1,Thr,2459,0,0,1,1,0.0%,1h
20112,1,我既是虫群,2459,0,0,1,1,0.0%,56m
20112,1,[星灵充电宝]浑身腐男,2459,0,0,1,1,0.0%,19m
20112,3,彼得拉米雷斯,2459,0,0,1,1,0.0%,1h
20112,3,[BGD]surfing,2459,0,0,2,2,0.0%,1h
20136,2,文明游戏,2458,1616,223,220,443,50.3%,1h
20136,1,查尔慈善组织,2458,1102,133,149,282,47.2%,1h
20136,3,爱丽丝狗王,2458,1577,83,83,166,50.0%,1h
20136,2,轻松玩游戏,2458,1192,47,50,97,48.5%,28m
20136,3,jmdmke,2458,700,28,26,54,51.9%,1h
20136,2,NanXv,2458,171,23,33,56,41.1%,10m
20136,3,干碎大司马的眼镜,2458,392,16,15,31,51.6%,1h
20136,1,晦暗男爵,2458,321,13,11,24,54.2%,40m
20136,1,大地堡小地堡,2458,460,12,24,36,33.3%,1h
20136,1,丿染年灬,2458,294,9,19,28,32.1%,1h
20136,1,艾尔难民头子,2458,42,5,5,10,50.0%,16m
20136,1,[呆萌小萝莉]Der,2458,128,4,4,8,50.0%,51m
20136,1,狂风扫落叶,2458,0,3,4,7,42.9%,19m
20136,1,WaltGrimes,2458,120,3,5,8,37.5%,43m
20136,1,[混元太极门]马保国,2458,44,2,1,3,66.7%,1h
20136,3,巴掌扇去,2458,97,1,4,5,20.0%,9m
20136,1,Ares,2458,0,0,1,1,0.0%,26m
20136,2,vin,2458,0,0,2,2,0.0%,1h
20136,3,干切葱油萝卜,2458,0,0,3,3,0.0%,1h
20155,2,NEVERLAND,2457,1621,143,150,293,48.8%,50m
20155,1,[暴雪三队]简单电脑,2457,1506,107,109,216,49.5%,13m
20155,1,不要修我地堡,2457,1482,71,85,156,45.5%,1h
20155,2,[007号探机]北京大兴谢霆锋,2457,985,53,45,98,54.1%,38m
20155,3,凯文杜兰特,2457,1040,43,35,78,55.1%,1h
20155,3,明日之子,2457,811,35,34,69,50.7%,1h
20155,3,萌萌哒的小熊猫,2457,407,26,21,47,55.3%,60m
20155,2,人武,2457,532,19,25,44,43.2%,1h
20155,3,飞的岳,2457,172,12,13,25,48.0%,14m
20155,3,盖世闲鱼,2457,356,12,14,26,46.2%,1h
20155,3,pvoid,2457,296,10,10,20,50.0%,1h
20155,3,mihotel,2457,247,8,7,15,53.3%,52m
20155,3,浅风丶迷离,2457,202,7,9,16,43.8%,52m
20155,1,阿拉刚,2457,169,5,4,9,55.6%,1h
20155,3,赵日天,2457,159,4,6,10,40.0%,10m
20155,3,[428NB]襄阳洪世贤,2457,125,3,1,4,75.0%,1h
20155,1,[执氏]一生只爱绘梨衣,2457,0,3,3,6,50.0%,19m
20155,1,小东西往哪跑,2457,130,3,4,7,42.9%,1h
20155,1,xylograph,2457,0,2,1,3,66.7%,25m
20155,2,Twilight,2457,30,2,7,9,22.2%,1h
20155,1,qwer,2457,88,2,8,10,20.0%,45m
20155,1,[虚空守望]子曰非日,2457,0,1,0,1,100.0%,1h
20155,1,龙翼,2457,0,1,2,3,33.3%,9m
20155,1,fanshod,2457,0,0,1,1,0.0%,1h
20155,1,[快乐谐星go]你过来啊,2457,0,0,2,2,0.0%,1h
20155,1,[二次元萌军]小原,2457,0,0,2,2,0.0%,58m
20155,3,可哥可妻孙一封,2457,0,0,3,3,0.0%,6m
20182,2,凤飞九天,2456,1595,227,231,458,49.6%,53m
20182,3,杀猪刀,2456,1613,162,152,314,51.6%,51m
20182,2,渡鸦一二三四五,2456,1270,50,58,108,46.3%,46m
20182,3,河山正美,2456,1156,44,47,91,48.4%,22m
20182,3,陆战队,2456,547,21,26,47,44.7%,55m
20182,3,莽夫,2456,403,14,18,32,43.8%,30m
20182,1,shazna,2456,306,10,20,30,33.3%,5m
20182,2,蟒暴动,2456,186,7,6,13,53.8%,46m
20182,2,dog,2456,211,7,11,18,38.9%,9m
20182,1,[礼义仁智信]老麦克,2456,193,6,2,8,75.0%,51m
20182,2,Still,2456,178,5,10,15,33.3%,19m
20182,1,月夜绯叶,2456,122,4,1,5,80.0%,33m
20182,1,墨雨,2456,96,4,6,10,40.0%,48m
20182,1,搭不搭,2456,167,3,1,4,75.0%,19m
20182,1,快跑有猫子,2456,48,2,7,9,22.2%,13m
20182,1,[STROOM]ahwhzc,2456,0,1,1,2,50.0%,14m
20182,1,[探机之怒]单眼工蜂,2456,0,1,4,5,20.0%,1h
20182,3,猎魔蝎,2456,0,0,1,1,0.0%,26m
20182,1,晚来天欲雪,2456,0,0,1,1,0.0%,1h
20201,1,张白给,2455,1499,78,88,166,47.0%,31m
20201,3,哒哒哒哒哒哒哒,2455,279,39,29,68,57.4%,20m
20201,3,两块冰,2455,697,26,26,52,50.0%,1h
20201,1,我柜子动了,2455,282,7,8,15,46.7%,53m
20201,1,黄老板救我,2455,142,4,7,11,36.4%,9m
20201,3,lychnis,2455,121,2,2,4,50.0%,1h
20201,1,匙锁无双,2455,0,2,3,5,40.0%,1h
20201,1,[XCode]你也是傻子吗,2455,0,2,4,6,33.3%,13m
20201,1,梦随忧雨,2455,90,2,8,10,20.0%,2m
20201,1,[黑粉头子]静静看你装逼,2455,0,1,0,1,100.0%,37m
20201,1,小叮当,2455,0,1,0,1,100.0%,1h
20201,1,星剑,2455,0,1,0,1,100.0%,1h
20201,1,[这并非河里]羽沧,2455,0,1,1,2,50.0%,35m
20201,1,繁花似锦,2455,0,1,4,5,20.0%,23m
20201,2,这怎么玩啊,2455,30,1,8,9,11.1%,1h
20201,1,[鸣上悠]五十岚星空,2455,0,0,1,1,0.0%,50m
20201,1,[入侵地球]DGLJL,2455,0,0,1,1,0.0%,9m
20218,2,playerliang,2454,1446,351,341,692,50.7%,19m
20218,1,星黑,2454,1387,70,65,135,51.9%,33m
20218,1,兜兜,2454,1027,39,44,83,47.0%,55m
20218,2,[银河喵波隆]歌然,2454,375,29,25,54,53.7%,1h
20218,3,APangstrong,2454,311,14,10,24,58.3%,1h
20218,1,真心玩不动了,2454,342,12,15,27,44.4%,2m
20218,2,玉米晓夫,2454,176,10,9,19,52.6%,59m
20218,3,Elf,2454,242,8,7,15,53.3%,38m
20218,3,晓美焰,2454,94,5,10,15,33.3%,1h
20218,3,ZeroTwo,2454,185,4,6,10,40.0%,1h
20218,1,[sc谐盟]人王时代,2454,100,3,5,8,37.5%,45m
20218,1,AShAnGA,2454,0,2,3,5,40.0%,1h
20218,3,qazwsxedcrty,2454,60,2,6,8,25.0%,26m
20218,1,[miku守护]通天塔神,2454,0,1,0,1,100.0%,23m
20218,1,[葫芦娃救艾尔]艾尔高阶跳虫,2454,0,1,0,1,100.0%,56m
20218,2,寒流,2454,0,1,1,2,50.0%,1h
20218,3,zzz,2454,30,1,3,4,25.0%,1h
20218,3,[内蒙第一舰队]EMP,2454,30,1,4,5,20.0%,1h
20218,1,星际入坑玩家,2454,0,0,1,1,0.0%,20m
20218,1,还有谁,2454,0,0,6,6,0.0%,1h
20238,2,[Onceme]竹林飘雨,2453,1586,108,112,220,49.1%,1h
20238,3,[混元体我女仆]勤天,2453,1442,104,104,208,50.0%,1h
20238,3,RiderStr,2453,550,51,48,99,51.5%,46m
20238,3,长桥猎人,2453,864,43,48,91,47.3%,46m
20238,1,[我怎么没兵了]死神爱吃苹果,2453,384,13,12,25,52.0%,39m
20238,3,Supertom,2453,358,11,14,25,44.0%,52m
20238,1,timbagg,2453,350,10,15,25,40.0%,1h
20238,3,盖伦德尔,2453,182,6,2,8,75.0%,1h
20238,3,[萌蛋组合]IIIIIIIIIIII,2453,178,5,7,12,41.7%,46m
20238,1,SoSooo,2453,238,4,5,9,44.4%,1h
20238,1,[天地會总舵]四方茉莉,2453,188,3,2,5,60.0%,19m
20238,3,XXXOOXXX,2453,58,3,8,11,27.3%,38m
20238,3,时空与土豆,2453,0,2,5,7,28.6%,2m
20238,1,不吃鱼的猫,2453,0,1,4,5,20.0%,6m
20238,1,拗不过时光的荏苒,2453,0,0,1,1,0.0%,1h
20238,1,你说谎的样子,2453,0,0,1,1,0.0%,20m
20254,3,maruke,2452,1220,182,192,374,48.7%,29m
20254,3,星际,2452,1260,58,48,106,54.7%,1h
20254,3,wds,2452,1143,46,45,91,50.5%,1h
20254,3,芒斯特小国王,2452,516,33,30,63,52.4%,22m
20254,3,瑞文戴尔,2452,570,23,22,45,51.1%,38m
20254,3,麻烦啊,2452,491,18,15,33,54.5%,6m
20254,1,[0D]BoB,2452,570,17,14,31,54.8%,44m
20254,1,木须,2452,456,15,17,32,46.9%,33m
20254,2,飞翔的荷兰人号,2452,386,15,21,36,41.7%,53m
20254,3,野心,2452,94,10,8,18,55.6%,40m
20254,3,[软萌甜小萝莉]Nevermeet,2452,218,7,10,17,41.2%,38m
20254,3,[六芒星s]spaceair,2452,170,6,8,14,42.9%,1h
20254,2,[星河气象学院]健将,2452,170,5,9,14,35.7%,38m
20254,1,秀儿蹦霸尒僰,2452,0,4,1,5,80.0%,36m
20254,3,NightGhost,2452,145,4,1,5,80.0%,50m
20254,1,[YINGJI]屈子策,2452,0,4,1,5,80.0%,1h
20254,1,喵琪吖,2452,0,4,3,7,57.1%,1h
20254,1,军阶零零七,2452,0,3,3,6,50.0%,1h
20254,1,bilibiliYGWD,2452,0,3,3,6,50.0%,1h
20254,3,龍頭,2452,30,3,6,9,33.3%,1h
20254,1,超绝可爱孙珍妮,2452,144,3,9,12,25.0%,23m
20254,3,[1v1白给]北阿拉纳克,2452,30,2,5,7,28.6%,40m
20254,1,Lucky,2452,90,2,8,10,20.0%,2m
20254,1,邪神,2452,0,1,0,1,100.0%,1h
20254,1,岩谷卫桐,2452,0,1,0,1,100.0%,10m
20254,1,[C43833]扯淡的青春,2452,0,1,3,4,25.0%,36m
20254,1,佳義,2452,0,1,4,5,20.0%,1h
20254,1,星际秋风,2452,0,0,1,1,0.0%,33m
20254,1,wutong,2452,0,0,1,1,0.0%,1h
20254,1,sprite,2452,0,0,2,2,0.0%,10m
20284,2,NewRomantics,2451,984,37,40,77,48.1%,11m
20284,1,[烧酒的胖次]疾如岛风,2451,808,27,36,63,42.9%,1h
20284,3,sarnath,2451,356,14,7,21,66.7%,10m
20284,3,[黄金战队]MCSAFS,2451,267,11,16,27,40.7%,1h
20284,1,小宅,2451,352,11,21,32,34.4%,1h
20284,2,此生绝非打工人,2451,256,10,9,19,52.6%,35m
20284,1,苦痴,2451,329,10,18,28,35.7%,39m
20284,1,第一高手,2451,295,8,3,11,72.7%,2m
20284,1,ipanne,2451,156,5,1,6,83.3%,1h
20284,2,刘一璋,2451,152,4,2,6,66.7%,17m
20284,1,SSS,2451,93,3,1,4,75.0%,1h
20284,1,[菜鸟降落区]中野三玖我媳妇,2451,48,3,3,6,50.0%,23m
20284,3,[异度黑核侵蚀]工口烧酒一伊莉雅,2451,121,3,6,9,33.3%,1h
20284,3,BlueSteel,2451,30,2,0,2,100.0%,1h
20284,2,[只会xx一波]只会光子炮台一波,2451,104,2,1,3,66.7%,1h
20284,1,一石,2451,0,1,1,2,50.0%,37m
20284,3,乌喵王大人,2451,0,1,3,4,25.0%,22m
20284,2,[谁不服]Innovation,2451,0,1,4,5,20.0%,1h
20284,1,[幻想神社]MorinoSeika,2451,0,0,1,1,0.0%,45m
20284,1,老烟斗,2451,0,0,1,1,0.0%,14m
20304,2,Championtao,2450,1443,172,163,335,51.3%,47m
20304,3,NihaihuiLaiM,2450,1132,52,50,102,51.0%,17m
20304,2,BlackSheep,2450,306,35,37,72,48.6%,36m
20304,3,[联合动物园]哥伦比亚老树懒,2450,922,33,37,70,47.1%,1h
20304,2,[萌新养老呢]人皇,2450,642,26,34,60,43.3%,1h
20304,2,萌新,2450,300,13,14,27,48.1%,11m
20304,1,[安技科]Moody,2450,402,12,27,39,30.8%,1h
20304,3,困难电脑,2450,261,9,6,15,60.0%,1h
20304,3,周大福豆腐干,2450,270,9,9,18,50.0%,46m
20304,2,梅山宋仲基,2450,208,6,12,18,33.3%,1h
20304,3,白浮尘,2450,150,4,4,8,50.0%,1h
20304,3,hikn,2450,30,4,6,10,40.0%,1h
20304,1,你的花露水,2450,48,2,0,2,100.0%,20m
20304,3,杰森,2450,122,2,6,8,25.0%,1h
20304,3,[老年组新秀]诺丶洛,2450,62,2,6,8,25.0%,60m
20304,2,Deacrer,2450,84,2,12,14,14.3%,60m
20304,1,moren,2450,0,1,0,1,100.0%,2m
20304,2,[RR]RrNJCGC,2450,0,0,1,1,0.0%,51m
20304,3,Meteor,2450,0,0,2,2,0.0%,1h
20323,1,[透一下清酒]不能的许愿机,2449,1667,66,57,123,53.7%,1h
20323,3,zero,2449,1277,47,50,97,48.5%,31m
20323,1,愤怒者,2449,1308,44,40,84,52.4%,1h
20323,3,第五种力,2449,407,20,23,43,46.5%,20m
20323,3,我很菜但我喜爱,2449,484,17,18,35,48.6%,1h
20323,3,色皮头子,2449,403,14,13,27,51.9%,1h
20323,1,战神罗米,2449,0,3,2,5,60.0%,30m
20323,3,joke,2449,115,2,3,5,40.0%,1h
20323,3,昵称都什么鬼,2449,112,2,3,5,40.0%,1h
20323,3,冀北小蛇蛇,2449,30,2,6,8,25.0%,1h
20323,2,不断出现,2449,0,2,7,9,22.2%,1h
20323,1,[学姐赛高]木雨巳,2449,0,1,0,1,100.0%,24m
20323,3,zhu,2449,0,1,0,1,100.0%,1h
20323,1,[暴雪家族]夜里小帆,2449,42,1,1,2,50.0%,1h
20323,3,极光之舞的斥候,2449,0,1,2,3,33.3%,7m
20323,1,wuzhicheng,2449,0,1,3,4,25.0%,1h
20323,1,果仁小黑,2449,0,1,4,5,20.0%,56m
20323,3,[起名难]零初撒嘛,2449,0,0,1,1,0.0%,7m
20323,3,[星际穿梭]小橘子,2449,0,0,4,4,0.0%,29m
20342,1,[暴tou]Lukatin,2448,1578,350,339,689,50.8%,1h
20342,2,[CPT]小鸡,2448,1070,179,184,363,49.3%,24m
20342,2,流川枫,2448,422,43,42,85,50.6%,10m
20342,2,[ZGA]LionelKay,2448,936,39,42,81,48.1%,36m
20342,3,[TheUED]克哈炮王,2448,763,32,24,56,57.1%,1h
20342,2,兄弟们给我上,2448,864,31,38,69,44.9%,1h
20342,1,我和婷婷,2448,277,28,34,62,45.2%,1h
20342,3,李萧萧,2448,574,21,23,44,47.7%,1h
20342,1,迅捷微风,2448,477,20,19,39,51.3%,1h
20342,1,[CPT]虚空之王,2448,475,15,14,29,51.7%,45m
20342,1,李培楠的媳妇儿,2448,417,11,4,15,73.3%,30m
20342,2,没什么大不了,2448,272,8,6,14,57.1%,1h
20342,3,ccleon,2448,242,8,9,17,47.1%,40m
20342,2,我是一只小小鸟,2448,180,6,14,20,30.0%,39m
20342,1,小金,2448,0,2,4,6,33.3%,1h
20342,3,凡尘星际,2448,0,2,5,7,28.6%,1h
20342,2,八月鸿羽,2448,30,2,7,9,22.2%,19m
20342,1,[Accre]Tony,2448,0,1,0,1,100.0%,1h
20342,1,veryGood,2448,0,1,0,1,100.0%,8m
20342,1,llllllllll,2448,0,1,0,1,100.0%,33m
20342,3,魂祭一雪舞,2448,0,1,1,2,50.0%,1h
20342,1,康斯坦丁,2448,0,1,1,2,50.0%,6m
20342,2,时雨,2448,90,1,4,5,20.0%,32m
20342,1,Aan,2448,0,1,4,5,20.0%,7m
20342,1,天命,2448,0,0,1,1,0.0%,1h
20367,3,倾城公子,2447,1247,61,40,101,60.4%,16m
20367,1,[联合动物园]苏维埃狗熊,2447,917,29,27,56,51.8%,22m
20367,2,time,2447,632,23,29,52,44.2%,36m
20367,3,[埃蒙调教团]freedom,2447,444,15,18,33,45.5%,1h
20367,2,sorry,2447,486,15,22,37,40.5%,1h
20367,1,Headreaper,2447,354,12,12,24,50.0%,10m
20367,3,雪树下等你,2447,247,9,7,16,56.2%,1h
20367,3,魔法少女,2447,173,6,7,13,46.2%,1h
20367,1,无敌老剑客,2447,113,4,0,4,100.0%,1h
20367,1,维度,2447,158,4,1,5,80.0%,33m
20367,1,越狱,2447,170,4,3,7,57.1%,50m
20367,1,soleil,2447,0,2,4,6,33.3%,14m
20367,3,Zyme,2447,60,2,6,8,25.0%,1h
20367,1,温柔如他,2447,97,1,1,2,50.0%,1h
20367,1,[BGD]桶哥,2447,0,0,1,1,0.0%,1h
20367,3,Shirleyz,2447,0,0,1,1,0.0%,40m
20367,1,[九尾]颤栗森林萌新,2447,0,0,1,1,0.0%,1h
20367,1,妳微笑时好美,2447,0,0,1,1,0.0%,16m
20367,1,[社交学导教]你看我吊吗,2447,0,0,2,2,0.0%,22m
20386,1,SuPRe,2446,1438,60,72,132,45.5%,34m
20386,3,休伯利安理工男,2446,347,32,35,67,47.8%,31m
20386,3,刘呵呵,2446,469,29,34,63,46.0%,20m
20386,3,吮吸我的脚趾,2446,275,21,20,41,51.2%,10m
20386,1,击毁王,2446,628,18,19,37,48.6%,52m
20386,3,Natsuki,2446,318,13,15,28,46.4%,45m
20386,1,[XXHZ0]Garfield,2446,189,6,3,9,66.7%,2m
20386,1,篮球女郎蔡徐坤,2446,0,4,1,5,80.0%,1h
20386,1,[快乐白给]里奇,2446,160,4,2,6,66.7%,1h
20386,1,真好,2446,48,4,3,7,57.1%,16m
20386,3,[辐射小马国]beholder,2446,60,3,3,6,50.0%,39m
20386,1,清纯玉女苍井空,2446,130,2,1,3,66.7%,5m
20386,3,星际刺客,2446,0,2,5,7,28.6%,15m
20386,1,星鸡争霸,2446,0,2,5,7,28.6%,6m
20386,1,听风,2446,0,1,1,2,50.0%,9m
20386,3,战五渣,2446,30,1,5,6,16.7%,9m
20386,1,[萌盟]我的卡拉有点萌,2446,0,0,1,1,0.0%,1h
20386,1,月色年华,2446,0,0,1,1,0.0%,1h
20386,1,桔梦,2446,0,0,1,1,0.0%,45m
20405,2,丁大款,2445,1497,283,291,574,49.3%,32m
20405,2,[第三国际]守护琅,2445,1294,50,52,102,49.0%,49m
20405,2,米兰,2445,860,32,36,68,47.1%,9m
20405,1,[凝结核]马航机长,2445,549,30,29,59,50.8%,5m
20405,3,ABOUY,2445,503,20,22,42,47.6%,1h
20405,3,umisonoda,2445,409,16,13,29,55.2%,10m
20405,3,[给力嗷]zydbb,2445,339,14,9,23,60.9%,29m
20405,2,faker,2445,188,7,11,18,38.9%,4m
20405,1,Raphael,2445,225,5,7,12,41.7%,33m
20405,1,松果,2445,166,4,4,8,50.0%,1h
20405,1,弱小艾尔求加强,2445,86,3,1,4,75.0%,22m
20405,1,[爽快]轩辕神健,2445,84,2,1,3,66.7%,1h
20405,1,[天猴之国]我的天,2445,0,2,3,5,40.0%,1h
20405,3,Halo,2445,30,2,3,5,40.0%,1h
20405,1,千月,2445,0,2,4,6,33.3%,56m
20405,1,Chost,2445,97,2,5,7,28.6%,7m
20405,3,我是大怪物,2445,30,1,8,9,11.1%,1h
20405,3,[小鸡屠宰场a]鬼魂之龙,2445,0,0,1,1,0.0%,20m
20405,2,king,2445,0,0,6,6,0.0%,25m
20424,3,CNzhanshen,2444,929,188,190,378,49.7%,26m
20424,3,leopards,2444,943,40,35,75,53.3%,16m
20424,2,[童话小镇]大战三百合,2444,443,37,37,74,50.0%,1h
20424,1,神无,2444,406,13,9,22,59.1%,37m
20424,3,[风暴ING]武动乾坤,2444,321,13,12,25,52.0%,15m
20424,3,Hydra,2444,286,10,7,17,58.8%,29m
20424,3,路人甲,2444,223,7,10,17,41.2%,1h
20424,1,飞翔的五花肉,2444,141,5,10,15,33.3%,9m
20424,3,[DMRe]泰伦之光,2444,167,4,6,10,40.0%,38m
20424,3,lililililili,2444,120,4,7,11,36.4%,1h
20424,2,不羁的风,2444,132,4,9,13,30.8%,1h
20424,3,无所事事,2444,115,3,2,5,60.0%,1h
20424,1,月下骑士,2444,34,2,0,2,100.0%,60m
20424,3,茶锁,2444,60,2,5,7,28.6%,1h
20424,1,azen,2444,0,1,0,1,100.0%,7m
20424,1,幼稚园杀手,2444,44,1,2,3,33.3%,1h
20424,3,[永不灭的战火]火元素,2444,30,1,5,6,16.7%,1h
20424,1,[鸡家军]农民打全场,2444,0,0,1,1,0.0%,22m
20424,1,永夜,2444,0,0,1,1,0.0%,1h
20424,1,葬爱青春,2444,0,0,2,2,0.0%,44m
20424,1,Leo,2444,0,0,2,2,0.0%,1h
20424,3,变能骑士,2444,0,0,3,3,0.0%,1h
20446,3,菠萝,2443,1581,392,409,801,48.9%,24m
20446,2,呼啸战神,2443,1081,83,76,159,52.2%,1h
20446,3,胡大爷,2443,1276,62,58,120,51.7%,1h
20446,3,阳阳,2443,849,58,47,105,55.2%,44m
20446,3,fantasybug,2443,1148,46,50,96,47.9%,31m
20446,2,ChristopherM,2443,792,38,37,75,50.7%,38m
20446,1,无名的函数,2443,1007,36,33,69,52.2%,1h
20446,3,飞花逐月,2443,179,25,37,62,40.3%,50m
20446,3,星空下的猫,2443,324,12,6,18,66.7%,1h
20446,3,[为星光而战]KING,2443,361,12,16,28,42.9%,1h
20446,1,[鬓已星星也]Rffu,2443,187,11,9,20,55.0%,9m
20446,3,手速一百的选手,2443,223,6,9,15,40.0%,1h
20446,3,LovelyVi,2443,184,5,8,13,38.5%,1h
20446,1,王的誓言,2443,0,3,3,6,50.0%,6m
20446,2,暗夜临,2443,0,3,6,9,33.3%,11m
20446,3,ALMOND,2443,30,2,3,5,40.0%,9m
20446,1,[B站常驻人员]落尘一晨曦,2443,48,2,5,7,28.6%,56m
20446,3,sideeffect,2443,0,2,5,7,28.6%,1h
20446,1,前方有巨型外星生,2443,0,1,0,1,100.0%,1h
20446,1,暗霄白虹,2443,0,1,0,1,100.0%,6m
20446,1,糟糕是心动的感觉,2443,0,1,1,2,50.0%,6m
20446,1,[暴雪三十二隊]王中王,2443,40,1,1,2,50.0%,1h
20446,3,处幽,2443,0,0,1,1,0.0%,1h
20446,1,模因,2443,0,0,2,2,0.0%,1h
20470,3,iiiiiiii,2442,1577,132,120,252,52.4%,20m
20470,3,快乐的兔子,2442,886,95,94,189,50.3%,44m
20470,3,基努里维斯,2442,1055,87,87,174,50.0%,1h
20470,3,Vant,2442,400,32,23,55,58.2%,45m
20470,3,大凉皮先生,2442,174,14,14,28,50.0%,15m
20470,3,quyunhao,2442,231,10,11,21,47.6%,20m
20470,2,努尔哈赤校长,2442,312,10,12,22,45.5%,1h
20470,2,余生,2442,254,9,13,22,40.9%,1h
20470,3,COLOFUR,2442,192,6,2,8,75.0%,6m
20470,2,[0216]AFKL,2442,160,6,16,22,27.3%,46m
20470,3,STARDUST,2442,150,5,8,13,38.5%,9m
20470,2,吴昊昊哥,2442,145,5,8,13,38.5%,1h
20470,3,铁齿铜牙塔西格,2442,120,5,10,15,33.3%,1h
20470,1,油水,2442,169,4,3,7,57.1%,1h
20470,1,诸子诸侯王,2442,0,3,2,5,60.0%,48m
20470,3,Overmind,2442,122,3,6,9,33.3%,20m
20470,3,[九班久伴]facker,2442,97,2,2,4,50.0%,1h
20470,1,geez,2442,84,2,5,7,28.6%,5m
20470,1,大声点告诉我,2442,0,1,4,5,20.0%,6m
20470,1,FZZH,2442,0,1,4,5,20.0%,20m
20470,1,死缠烂打,2442,0,0,1,1,0.0%,1h
20470,1,hdajsdf,2442,0,0,1,1,0.0%,1h
20470,3,ToT,2442,0,0,4,4,0.0%,1h
20493,2,低调的虫族,2441,1103,86,89,175,49.1%,38m
20493,3,[sakurr]ulemon,2441,443,46,36,82,56.1%,1h
20493,1,zhangyy,2441,1022,31,33,64,48.4%,1h
20493,3,承教于诺偌,2441,580,24,29,53,45.3%,1h
20493,1,风轻云淡,2441,189,21,1,22,95.5%,2m
20493,2,YeHo,2441,296,20,28,48,41.7%,49m
20493,3,瑞瑞生气气,2441,406,16,12,28,57.1%,38m
20493,1,starlion,2441,268,8,3,11,72.7%,13m
20493,3,冰冷的森林,2441,170,7,9,16,43.8%,51m
20493,1,IIIIIIIIIIII,2441,211,6,5,11,54.5%,1h
20493,1,[插爆一切]菜鸡,2441,106,4,1,5,80.0%,8m
20493,1,zxz,2441,126,4,3,7,57.1%,33m
20493,1,名字的名字是名字,2441,158,4,4,8,50.0%,13m
20493,3,CHARLIE,2441,58,4,7,11,36.4%,29m
20493,2,河子滨,2441,44,4,8,12,33.3%,1h
20493,1,[法夫娜议事厅]春风十里不如你,2441,0,3,2,5,60.0%,19m
20493,3,老逗到此一游,2441,0,3,5,8,37.5%,1h
20493,1,[纳兰皇族]夜之恒心,2441,42,2,0,2,100.0%,1h
20493,2,口腔的溃疡,2441,38,2,2,4,50.0%,39m
20493,2,要你命一万,2441,113,2,3,5,40.0%,1h
20493,1,烟淡风轻,2441,88,2,4,6,33.3%,5m
20493,3,IIIIIIIIIIII,2441,0,1,3,4,25.0%,1h
20493,1,克哈战车道泽泰玩,2441,0,1,4,5,20.0%,60m
20493,1,小芹快跑,2441,0,0,1,1,0.0%,13m
20493,1,先天圣体道胎,2441,0,0,1,1,0.0%,33m
20493,1,[人衣一体]国家级炼铜术士,2441,0,0,1,1,0.0%,1h
20519,3,Pinkman,2440,1551,228,212,440,51.8%,51m
20519,3,mucike,2440,1117,115,112,227,50.7%,28m
20519,1,SOS,2440,1294,64,76,140,45.7%,35m
20519,3,[only丶]灰太狼,2440,446,16,13,29,55.2%,39m
20519,2,名字太长,2440,388,13,16,29,44.8%,53m
20519,2,[极限菜鸟]国产级菜狗,2440,194,6,2,8,75.0%,1h
20519,3,[小仙女上线啦]不能一错再错,2440,175,6,9,15,40.0%,12m
20519,2,fishhan,2440,73,4,8,12,33.3%,32m
20519,1,完美小琪二号,2440,76,3,1,4,75.0%,18m
20519,3,吃瓜群众,2440,145,3,5,8,37.5%,39m
20519,1,rgsse,2440,0,1,0,1,100.0%,1h
20519,1,可还行,2440,48,1,1,2,50.0%,37m
20519,1,galaxy,2440,0,0,2,2,0.0%,60m
20532,1,风行者,2439,634,37,27,64,57.8%,1h
20532,2,[酒池肉林]看到高富帅要低头,2439,387,25,23,48,52.1%,36m
20532,3,[miku守护]enborn,2439,422,15,15,30,50.0%,1h
20532,1,IIIIIIIIIIII,2439,343,12,7,19,63.2%,51m
20532,1,Sugar,2439,377,11,4,15,73.3%,1h
20532,3,killerqueen,2439,313,11,11,22,50.0%,31m
20532,1,[战场之巅]尊丨逍遥,2439,283,10,16,26,38.5%,51m
20532,3,Fyr,2439,218,9,3,12,75.0%,1h
20532,1,无路赛,2439,270,8,7,15,53.3%,13m
20532,2,正负根号二,2439,239,7,13,20,35.0%,1h
20532,1,幻灭,2439,0,4,1,5,80.0%,1h
20532,3,没没有借口,2439,58,4,7,11,36.4%,1h
20532,3,fit,2439,60,4,7,11,36.4%,24m
20532,1,IIIIIIIII,2439,0,2,3,5,40.0%,8m
20532,1,ALPred,2439,0,2,4,6,33.3%,1h
20532,1,蝰哥,2439,0,1,0,1,100.0%,1h
20532,1,zzzzzzzzzzzz,2439,97,1,2,3,33.3%,19m
20532,1,徐凤年,2439,0,1,4,5,20.0%,10m
20532,3,幻剑之灵,2439,0,0,1,1,0.0%,12m
20532,1,echO,2439,0,0,2,2,0.0%,33m
20532,3,哄着自己玩,2439,0,0,5,5,0.0%,1h
20553,3,中华军魂,2438,1450,171,171,342,50.0%,1h
20553,3,SOHIGH,2438,1399,101,95,196,51.5%,1h
20553,1,pcchen,2438,898,32,24,56,57.1%,45m
20553,3,越共探头,2438,200,17,14,31,54.8%,15m
20553,3,春大神,2438,406,17,17,34,50.0%,16m
20553,1,人生似碗酒,2438,576,16,17,33,48.5%,1h
20553,3,炸鱼妈早死,2438,355,14,8,22,63.6%,44m
20553,3,闲散惯了,2438,237,11,2,13,84.6%,44m
20553,3,逗闷子的砖家,2438,341,11,11,22,50.0%,1h
20553,3,[失去理智]OnlyDream,2438,225,9,16,25,36.0%,49m
20553,3,king,2438,259,8,9,17,47.1%,1h
20553,3,[谐星与鸡]圣爹亚伯拉罕,2438,187,7,2,9,77.8%,1h
20553,1,胜多负少,2438,250,7,12,19,36.8%,1h
20553,1,感染枪兵,2438,132,4,8,12,33.3%,1h
20553,3,八倍不屏息机枪兵,2438,86,4,9,13,30.8%,29m
20553,1,哥布林叶,2438,78,3,2,5,60.0%,13m
20553,3,IIIIIIIIIIII,2438,97,3,3,6,50.0%,6m
20553,1,dio,2438,48,3,5,8,37.5%,7m
20553,1,神之制造,2438,0,3,7,10,30.0%,37m
20553,3,[南昌一枝花]始终茹一,2438,30,2,3,5,40.0%,1h
20553,1,kevin,2438,48,2,6,8,25.0%,1h
20553,1,[哔哩哔哩肝杯]雄霸天下,2438,0,1,0,1,100.0%,26m
20553,1,Ruasen,2438,0,1,0,1,100.0%,44m
20553,3,[Hist]梦幻拉面,2438,0,1,2,3,33.3%,49m
20553,1,无双的哥哥,2438,0,0,1,1,0.0%,1h
20553,1,[DDOS浪漫]至尊超薄,2438,0,0,2,2,0.0%,1h
20553,1,[星之所在RI]黯琉汐,2438,0,0,2,2,0.0%,30m
20553,1,辉哥,2438,0,0,2,2,0.0%,33m
20553,1,万国航达,2438,0,0,3,3,0.0%,40m
20582,3,austin,2437,1434,63,53,116,54.3%,55m
20582,1,倔强的小火鱼,2437,630,23,19,42,54.8%,30m
20582,2,Satellite,2437,373,19,21,40,47.5%,9m
20582,3,川普的川普,2437,208,6,7,13,46.2%,23m
20582,3,别被游戏玩了,2437,141,5,2,7,71.4%,1h
20582,1,邪狼,2437,198,5,4,9,55.6%,1h
20582,1,Clear,2437,138,5,8,13,38.5%,52m
20582,1,benn,2437,84,3,3,6,50.0%,33m
20582,1,凡人歌,2437,86,3,4,7,42.9%,5m
20582,1,乖巧新手求调教,2437,46,3,5,8,37.5%,22m
20582,1,[雾之湖红萌馆]天才少女琪露诺,2437,42,2,1,3,66.7%,20m
20582,3,萧箫,2437,30,2,2,4,50.0%,15m
20582,1,gesila,2437,0,1,0,1,100.0%,37m
20582,3,张口闭眼男,2437,0,1,5,6,16.7%,1h
20582,3,[推荐艺人]安吉拉逼逼,2437,0,0,4,4,0.0%,1h
20582,2,阿萨姆,2437,0,0,5,5,0.0%,25m
20598,2,CrazyDiamond,2436,953,56,52,108,51.9%,53m
20598,3,Luciferw,2436,1189,55,52,107,51.4%,39m
20598,3,[运大星际系]明帝,2436,530,19,24,43,44.2%,1h
20598,3,叶哥太强了,2436,403,18,18,36,50.0%,40m
20598,2,[瘾大眼瞎]烬鑫,2436,524,18,28,46,39.1%,36m
20598,3,[BGA]BiGAcO,2436,432,15,20,35,42.9%,22m
20598,3,[看星星咯]梦露,2436,172,5,3,8,62.5%,1h
20598,2,FANTASTIC,2436,44,5,6,11,45.5%,1h
20598,3,Starry,2436,180,5,7,12,41.7%,1h
20598,3,KOI,2436,66,4,9,13,30.8%,1h
20598,3,上古遗迹,2436,144,3,2,5,60.0%,51m
20598,1,[呼叫舰队按2]隐的不是身是寂寞,2436,84,2,1,3,66.7%,33m
20598,2,[Fetter]NexusNoah,2436,38,2,6,8,25.0%,49m
20598,1,雨笙,2436,0,1,0,1,100.0%,5m
20598,2,sakura,2436,0,1,1,2,50.0%,1h
20598,1,zxl,2436,97,1,2,3,33.3%,1h
20598,1,独饮半生,2436,0,0,1,1,0.0%,56m
20598,2,断背山之咖喱饭,2436,0,0,1,1,0.0%,1h
20616,3,[星舰与太阳x]ValeRossi,2435,1113,88,76,164,53.7%,1h
20616,3,IIIIIIBoreas,2435,565,23,18,41,56.1%,1h
20616,2,瑞文呀,2435,387,15,16,31,48.4%,12m
20616,3,Patrick,2435,178,7,12,19,36.8%,46m
20616,1,cityhunter,2435,238,6,6,12,50.0%,1h
20616,3,caodashuai,2435,62,3,5,8,37.5%,45m
20616,1,没有战术直接莽,2435,36,2,1,3,66.7%,23m
20616,1,[花园宝宝]布西迪希,2435,96,2,4,6,33.3%,40m
20616,3,霸王,2435,0,2,5,7,28.6%,1h
20616,1,蒜头牛蛙,2435,0,0,1,1,0.0%,33m
20616,1,sdfa,2435,0,0,1,1,0.0%,1h
20616,1,[白斩鸡]Tam,2435,0,0,1,1,0.0%,1h
20616,3,张元媛的爸爸,2435,0,0,4,4,0.0%,52m
20629,1,稻壳岛,2434,1210,108,110,218,49.5%,25m
20629,3,[CPT]般若,2434,1185,86,81,167,51.5%,21m
20629,2,xiaoz,2434,536,38,44,82,46.3%,1h
20629,2,[蓝星远征军]Skywalker,2434,833,30,38,68,44.1%,32m
20629,1,苒汐,2434,349,13,14,27,48.1%,44m
20629,1,五庄观偷吃人参果,2434,363,12,3,15,80.0%,1h
20629,1,星际争霸,2434,332,10,9,19,52.6%,40m
20629,3,kuang,2434,196,8,7,15,53.3%,8m
20629,2,迟暮,2434,277,7,10,17,41.2%,1h
20629,3,无情三连,2434,190,6,6,12,50.0%,29m
20629,2,concrete,2434,220,6,8,14,42.9%,1h
20629,2,lynne,2434,30,5,6,11,45.5%,32m
20629,3,随机怎么样,2434,30,3,6,9,33.3%,7m
20629,1,隐身打核弹,2434,82,2,2,4,50.0%,1h
20629,2,[随机团]IIIIIIIIIIII,2434,91,2,2,4,50.0%,48m
20629,1,灰色的猫,2434,0,2,4,6,33.3%,58m
20629,1,恶人,2434,0,1,1,2,50.0%,51m
20629,1,TossGirl,2434,44,1,2,3,33.3%,1h
20629,1,屡败屡战,2434,46,1,3,4,25.0%,37m
20629,2,Henry,2434,0,1,4,5,20.0%,1h
20629,2,cycc,2434,44,1,7,8,12.5%,39m
20629,1,[紫槿]volunteer,2434,0,0,1,1,0.0%,1h
20651,2,无敌兔,2433,922,47,49,96,49.0%,46m
20651,2,[瑞兽]拿女盆友换糖,2433,336,10,16,26,38.5%,1h
20651,2,崇宫澪,2433,201,9,7,16,56.2%,1h
20651,1,Greenday,2433,208,6,5,11,54.5%,38m
20651,1,季末灬,2433,96,4,5,9,44.4%,40m
20651,1,伟哥唉,2433,0,3,4,7,42.9%,43m
20651,2,[这是个陷阱啊]凉凉了,2433,92,2,2,4,50.0%,9m
20651,1,[啊里奎]Lking,2433,0,2,5,7,28.6%,36m
20651,2,[7BR]Ploenaz,2433,0,1,0,1,100.0%,49m
20651,1,沉默之剑,2433,42,1,1,2,50.0%,51m
20651,2,shashen,2433,0,1,4,5,20.0%,1h
20662,1,只想打虫族,2432,1785,104,101,205,50.7%,53m
20662,1,无情小魔仙,2432,1386,57,53,110,51.8%,1h
20662,3,帅哥,2432,942,36,39,75,48.0%,46m
20662,1,风间琉璃,2432,906,33,39,72,45.8%,1h
20662,3,[火影何平]lxc,2432,655,28,32,60,46.7%,22m
20662,3,fyq,2432,325,26,27,53,49.1%,12m
20662,1,星耀九天,2432,460,17,13,30,56.7%,17m
20662,1,Shannon,2432,540,17,32,49,34.7%,49m
20662,2,小小模型师,2432,224,8,10,18,44.4%,1h
20662,3,爱茹,2432,60,6,4,10,60.0%,6m
20662,3,[XXHZ25]战术老王,2432,201,6,7,13,46.2%,31m
20662,3,水封,2432,192,6,8,14,42.9%,8m
20662,1,[胡杨]星星小欢,2432,0,2,3,5,40.0%,13m
20662,1,[冰封天下]子衿,2432,0,1,1,2,50.0%,20m
20662,3,Lewis,2432,30,1,3,4,25.0%,22m
20662,2,dianming,2432,0,1,4,5,20.0%,14m
20662,2,星辰,2432,0,1,4,5,20.0%,1h
20662,1,锴锴锴,2432,0,0,1,1,0.0%,1h
20680,1,War,2431,1087,72,63,135,53.3%,20m
20680,3,[HNU]Bigman,2431,922,65,66,131,49.6%,31m
20680,2,霄霄帅过吴彦祖,2431,951,51,53,104,49.0%,1h
20680,3,Reurl,2431,681,27,28,55,49.1%,55m
20680,2,蓦然天下,2431,627,23,29,52,44.2%,48m
20680,3,孤独的狼,2431,405,17,14,31,54.8%,1h
20680,3,[汉堡FANS]常德郭富城,2431,348,12,14,26,46.2%,1h
20680,2,[没有闪]我是菜鸡泰伦,2431,210,7,22,29,24.1%,1h
20680,1,CHHHHHHHH,2431,96,4,6,10,40.0%,8m
20680,3,马保国,2431,160,4,7,11,36.4%,29m
20680,1,Jerry,2431,86,3,1,4,75.0%,53m
20680,1,IllIIIIlIIIl,2431,48,3,3,6,50.0%,1h
20680,2,[肉鸡的饲养]魔法少女鸭鸭酱,2431,0,1,0,1,100.0%,27m
20680,1,xzx,2431,0,1,1,2,50.0%,1h
20680,1,[谴责dod]BBZstone,2431,32,1,2,3,33.3%,8m
20680,3,白茶,2431,0,0,1,1,0.0%,1h
20680,1,king,2431,0,0,1,1,0.0%,22m
20680,3,huangruren,2431,0,0,5,5,0.0%,1h
20698,2,[点到为止]张伟,2430,1481,215,212,427,50.4%,33m
20698,2,小辉,2430,648,117,121,238,49.2%,53m
20698,3,金基德,2430,797,85,70,155,54.8%,21m
20698,1,cyc,2430,1271,52,55,107,48.6%,1h
20698,2,备胎哥,2430,1042,38,46,84,45.2%,1h
20698,3,蚂蚱也是肉,2430,428,19,23,42,45.2%,1h
20698,1,太空军校生,2430,484,15,8,23,65.2%,54m
20698,3,是打算打算打打死,2430,261,13,11,24,54.2%,20m
20698,3,杨浮有怪云,2430,330,13,20,33,39.4%,1h
20698,3,点点,2430,324,12,17,29,41.4%,20m
20698,1,[L11W]AlGaE,2430,360,11,5,16,68.8%,54m
20698,2,Salvation,2430,294,10,13,23,43.5%,1h
20698,2,SCk,2430,286,10,13,23,43.5%,1h
20698,1,[猫神]苏打冻柠绿,2430,232,9,11,20,45.0%,18m
20698,1,奇怪的香瓜,2430,229,8,8,16,50.0%,1h
20698,1,AOE,2430,211,8,11,19,42.1%,1h
20698,3,zxcxz,2430,243,7,9,16,43.8%,8m
20698,1,纱雾,2430,48,3,6,9,33.3%,6m
20698,3,[公主联盟]本公主不菜,2430,60,2,8,10,20.0%,10m
20698,1,[哔哩哔哩乾杯]归海寒湘,2430,0,1,1,2,50.0%,25m
20698,1,[北极光小组]雷诺的游击队,2430,0,1,2,3,33.3%,1h
20698,1,TOT,2430,0,1,4,5,20.0%,40m
20698,3,牛奶味的小萝莉,2430,30,1,6,7,14.3%,1h
20698,2,电脑困难,2430,0,0,1,1,0.0%,1h
20722,1,codyvon,2429,1333,140,138,278,50.4%,1h
20722,3,Demonbird,2429,1020,56,62,118,47.5%,51m
20722,1,[专业收尸队]白衬衫,2429,634,29,20,49,59.2%,1h
20722,3,TheShy,2429,326,11,16,27,40.7%,22m
20722,1,YangWool,2429,322,9,6,15,60.0%,1h
20722,1,[伢伢乐]lngtiam,2429,320,9,10,19,47.4%,1h
20722,3,将蕊,2429,212,7,5,12,58.3%,31m
20722,3,[屯溪]孤战,2429,140,6,6,12,50.0%,15m
20722,3,[Milan1]CrisKa,2429,155,5,3,8,62.5%,1h
20722,3,大菜鸡,2429,151,5,7,12,41.7%,1h
20722,3,Yewa,2429,127,4,7,11,36.4%,1h
20722,1,[YD]BIGGUN,2429,48,3,4,7,42.9%,20m
20722,3,[24CM]大黄不懦弱,2429,120,3,4,7,42.9%,17m
20722,3,[我队伍很强大]ADWDAWD,2429,62,3,6,9,33.3%,45m
20722,3,布莱迪,2429,90,3,8,11,27.3%,6m
20722,2,金田路彭于晏,2429,0,2,2,4,50.0%,1h
20722,3,严涵,2429,62,2,7,9,22.2%,22m
20722,1,渣哥,2429,0,0,1,1,0.0%,1h
20722,2,日月星光,2429,0,0,1,1,0.0%,53m
20722,1,巨讨厌虫族,2429,0,0,2,2,0.0%,37m
20722,1,[最喜欢芽衣了]唐恩重,2429,0,0,3,3,0.0%,1h
20743,3,solids,2428,1603,187,182,369,50.7%,17m
20743,3,光头哥,2428,1209,120,121,241,49.8%,1h
20743,3,Solitude,2428,1131,74,70,144,51.4%,49m
20743,3,[不可视战线]时钟之眼倒流,2428,1237,55,45,100,55.0%,1h
20743,3,哈哈,2428,788,43,36,79,54.4%,1h
20743,1,[GGWW]破灭的希望,2428,360,23,23,46,50.0%,1h
20743,3,快跑啊大和来了,2428,652,23,26,49,46.9%,12m
20743,1,塔兰托之夜,2428,236,6,5,11,54.5%,1h
20743,1,迁就,2428,236,5,7,12,41.7%,20m
20743,1,火之高兴,2428,94,2,2,4,50.0%,56m
20743,2,我欲封天,2428,93,2,3,5,40.0%,27m
20743,1,DIO,2428,84,2,4,6,33.3%,17m
20743,1,晓风肆雪,2428,0,1,0,1,100.0%,20m
20743,1,天一,2428,0,1,0,1,100.0%,9m
20743,2,windysky,2428,0,1,2,3,33.3%,1h
20743,2,曲率驱动执行官,2428,0,1,2,3,33.3%,32m
20743,3,Poseidon,2428,0,1,5,6,16.7%,1h
20743,3,[知乎战队]为了艾尔,2428,0,0,1,1,0.0%,1h
20743,1,魑魅魍魉,2428,0,0,2,2,0.0%,1h
20762,1,[胖虎稽查队]Zerg,2427,1546,117,127,244,48.0%,47m
20762,3,Lingxin,2427,1536,77,62,139,55.4%,31m
20762,1,斯巴拉西,2427,770,24,19,43,55.8%,1h
20762,1,[王者重现]康乾盛世,2427,504,16,8,24,66.7%,1h
20762,1,东风流心,2427,425,12,7,19,63.2%,1h
20762,1,俗人,2427,294,10,15,25,40.0%,8m
20762,3,决战青铜王,2427,297,9,11,20,45.0%,1h
20762,1,朱纳尔多,2427,162,6,8,14,42.9%,10m
20762,1,[可爱的你们]群星知心,2427,238,5,1,6,83.3%,1h
20762,3,[白给WUST]太虚,2427,113,5,8,13,38.5%,15m
20762,2,[基金会]还木有,2427,0,3,2,5,60.0%,1h
20762,1,[柒堇年华]SoulWind,2427,110,3,2,5,60.0%,2m
20762,2,[乳主头子]星际小子,2427,52,3,6,9,33.3%,11m
20762,1,MagicTragic,2427,0,2,5,7,28.6%,37m
20762,1,叫我首富,2427,97,2,5,7,28.6%,1h
20762,1,孤寂,2427,0,1,1,2,50.0%,45m
20762,1,蓝爵萨凯,2427,0,1,1,2,50.0%,1h
20762,3,bdsf,2427,97,1,2,3,33.3%,1h
20762,2,ASKJ,2427,0,0,1,1,0.0%,32m
20762,1,[建着玩儿]favouriteHXB,2427,0,0,1,1,0.0%,22m
20762,1,昆仑玉,2427,0,0,1,1,0.0%,5m
20762,1,[丶幸存丶]凌绮枫,2427,0,0,2,2,0.0%,44m
20762,2,周星星,2427,0,0,3,3,0.0%,10m
20785,1,[狗哥NO01]Hunter,2426,1071,82,92,174,47.1%,1h
20785,3,Tist,2426,802,34,24,58,58.6%,1h
20785,1,HItian,2426,772,27,37,64,42.2%,59m
20785,3,恋蝶无邪,2426,655,25,35,60,41.7%,1h
20785,3,OptiMissTake,2426,519,22,15,37,59.5%,1h
20785,1,东马,2426,558,20,21,41,48.8%,1h
20785,1,莫语,2426,158,17,22,39,43.6%,39m
20785,1,公瑾的忧郁,2426,459,16,16,32,50.0%,30m
20785,1,[OwenSS]杀戮间,2426,318,11,8,19,57.9%,1h
20785,3,带帽子的猫,2426,195,6,8,14,42.9%,1h
20785,3,葛泥王,2426,121,3,3,6,50.0%,1h
20785,3,随性,2426,30,3,6,9,33.3%,1h
20785,3,JINHON,2426,147,3,6,9,33.3%,1h
20785,1,吖灭跌,2426,42,2,0,2,100.0%,51m
20785,1,轩轩来,2426,97,2,5,7,28.6%,1h
20785,1,英勇无比查理斯,2426,0,1,0,1,100.0%,1h
20785,1,[智乃超可爱w]圆桌的骑士,2426,0,1,0,1,100.0%,1h
20785,1,颌言,2426,0,1,0,1,100.0%,23m
20785,1,[Xbox]dada,2426,0,1,0,1,100.0%,1h
20785,1,qqgeshiwo,2426,44,1,2,3,33.3%,1h
20785,1,[星舰与太阳x]小橘,2426,42,1,3,4,25.0%,38m
20785,3,[XXHZN2]stone,2426,0,0,6,6,0.0%,1h
20807,3,[魔法少女小屋]哥谭,2425,1346,154,147,301,51.2%,1h
20807,3,农夫山泉有点甜,2425,1544,72,76,148,48.6%,52m
20807,3,FLY,2425,1485,66,67,133,49.6%,1h
20807,3,红尘劫,2425,753,37,18,55,67.3%,28m
20807,3,[18th]君铭帝龙,2425,573,22,20,42,52.4%,26m
20807,1,功宝宝,2425,355,20,19,39,51.3%,1h
20807,3,skywalker,2425,507,19,14,33,57.6%,45m
20807,1,[大佬请把鞋给]小骷髅,2425,565,18,12,30,60.0%,1h
20807,3,黄乾川,2425,183,10,9,19,52.6%,45m
20807,1,[哨兵信条]无语,2425,224,8,10,18,44.4%,1h
20807,3,feel,2425,271,8,11,19,42.1%,1h
20807,1,[四叶草]RichardSK,2425,157,5,5,10,50.0%,1h
20807,1,[酶丽芙]yhyh,2425,82,3,2,5,60.0%,20m
20807,1,玛格特罗伊德,2425,126,3,3,6,50.0%,30m
20807,3,[导引者]ICanFly,2425,0,1,0,1,100.0%,1h
20807,2,[MagicT]MagicVainglo,2425,0,1,0,1,100.0%,25m
20807,1,亿万分之一的相遇,2425,0,1,0,1,100.0%,60m
20807,1,[潸然丶那些年]HLyx,2425,0,1,1,2,50.0%,44m
20807,2,[Killyo]优秀势力,2425,40,1,2,3,33.3%,42m
20807,3,[镜花水月]OhmaZio,2425,97,1,2,3,33.3%,24m
20807,1,说啥我都是最帅,2425,44,1,3,4,25.0%,44m
20807,3,[世纪之舟]jimmy,2425,0,1,4,5,20.0%,21m
20807,2,蜂巢传说,2425,0,1,4,5,20.0%,56m
20807,1,巨蟹之钳,2425,0,0,1,1,0.0%,2m
20807,1,岱玹他姓孙,2425,0,0,1,1,0.0%,50m
20832,3,land,2424,1042,87,80,167,52.1%,15m
20832,3,林夕河畔,2424,725,55,53,108,50.9%,38m
20832,1,重庆孙一峰,2424,1431,52,48,100,52.0%,1h
20832,2,SONGWEI,2424,1172,45,49,94,47.9%,31m
20832,1,bleach,2424,634,19,18,37,51.4%,13m
20832,3,砍人就对了,2424,358,13,9,22,59.1%,5m
20832,3,Reo,2424,212,11,15,26,42.3%,1h
20832,3,speeder,2424,298,10,9,19,52.6%,1h
20832,3,对酒当歌,2424,200,7,12,19,36.8%,1h
20832,1,[斗鱼祁铭菌]iiiiiiiiiiii,2424,238,6,2,8,75.0%,1h
20832,1,Nidhogg,2424,161,6,3,9,66.7%,1h
20832,1,sona,2424,230,5,2,7,71.4%,56m
20832,1,lovelypea,2424,160,5,5,10,50.0%,39m
20832,3,起灵,2424,38,5,6,11,45.5%,7m
20832,3,蛮力之枭,2424,170,5,8,13,38.5%,29m
20832,1,BULAT,2424,120,4,1,5,80.0%,24m
20832,1,鬼魅星煞,2424,145,3,3,6,50.0%,1h
20832,2,[带大师兄]北柠呐,2424,0,3,7,10,30.0%,26m
20832,1,小菜鸡,2424,38,2,0,2,100.0%,5m
20832,1,幸运之翼,2424,96,2,4,6,33.3%,60m
20832,1,[极限菜鸟]Jack,2424,42,1,3,4,25.0%,23m
20832,2,雷恩上校,2424,0,1,4,5,20.0%,11m
20832,1,NKC,2424,0,1,5,6,16.7%,1h
20832,1,汤家豪,2424,0,0,1,1,0.0%,40m
20856,3,豪亚索,2423,803,77,70,147,52.4%,1h
20856,1,杰克,2423,1314,52,50,102,51.0%,1h
20856,3,BazonM,2423,954,41,30,71,57.7%,10m
20856,3,最讨厌神族一波,2423,551,19,19,38,50.0%,29m
20856,3,blackrose,2423,216,18,17,35,51.4%,52m
20856,1,[征服之海]嬉水的鱼,2423,548,15,20,35,42.9%,33m
20856,1,奶爸上线,2423,344,9,9,18,50.0%,20m
20856,1,[黑粉头子]STONE,2423,164,5,5,10,50.0%,35m
20856,3,我不会玩,2423,166,4,1,5,80.0%,36m
20856,1,此刻丿尽丝滑,2423,158,4,3,7,57.1%,2m
20856,1,Life,2423,97,3,2,5,60.0%,43m
20856,1,[虚空闪烁]GREENERGY,2423,0,1,1,2,50.0%,13m
20856,1,我不叫狐狸,2423,0,1,1,2,50.0%,1h
20856,1,bigbang,2423,46,1,8,9,11.1%,23m
20856,1,[怎么脏怎么来]谈少,2423,0,0,1,1,0.0%,13m
20856,3,空白,2423,0,0,1,1,0.0%,7m
20856,2,[渣男团体]土间埋,2423,0,0,2,2,0.0%,59m
20873,1,Whoisyou,2422,1295,227,226,453,50.1%,1h
20873,3,[我觉得不行]我觉得我行,2422,989,37,39,76,48.7%,28m
20873,1,嘟嘟嘟了,2422,915,31,31,62,50.0%,1h
20873,3,BlackLotus,2422,606,22,27,49,44.9%,16m
20873,2,无上至尊,2422,514,18,22,40,45.0%,1h
20873,2,凯瑞甘的小断牙,2422,409,18,24,42,42.9%,29m
20873,3,逐云浪客,2422,319,14,17,31,45.2%,20m
20873,1,[小小泰伦人]清明雨上泪拆两行,2422,358,10,7,17,58.8%,22m
20873,3,kIndlInG,2422,178,6,9,15,40.0%,45m
20873,1,国中教兽,2422,48,5,3,8,62.5%,1h
20873,1,永暗无尽,2422,202,4,2,6,66.7%,39m
20873,3,战狼钟汉良,2422,135,4,6,10,40.0%,1h
20873,1,[花笙]霁野,2422,97,2,4,6,33.3%,1h
20873,3,太极丨八卦丨搬拦,2422,47,2,6,8,25.0%,1h
20873,3,槐葵,2422,0,2,6,8,25.0%,1h
20873,1,[小黄人]满村就我不会玩,2422,0,1,0,1,100.0%,1h
20873,1,[TAPC]求求大佬放过我,2422,0,1,1,2,50.0%,24m
20873,2,wscl,2422,0,1,4,5,20.0%,32m
20873,2,[托非入欧]超次元海王星,2422,0,0,1,1,0.0%,54m
20892,3,大米特,2421,1057,79,75,154,51.3%,1h
20892,1,记者把我批判一番,2421,948,31,55,86,36.0%,18m
20892,2,ASDFF,2421,695,24,33,57,42.1%,24m
20892,1,喵喵喵,2421,560,19,18,37,51.4%,1h
20892,1,lzj,2421,584,17,18,35,48.6%,10m
20892,1,二狗,2421,472,14,13,27,51.9%,44m
20892,3,风风呀,2421,362,13,13,26,50.0%,1h
20892,1,aseqws,2421,412,12,6,18,66.7%,38m
20892,1,[大韩剧]五河士道,2421,301,11,7,18,61.1%,1h
20892,3,cctv,2421,258,8,2,10,80.0%,12m
20892,1,[思乡]Cream,2421,226,7,3,10,70.0%,2m
20892,1,虎爸爸,2421,280,7,8,15,46.7%,17m
20892,1,带刺蛇,2421,218,6,6,12,50.0%,1h
20892,1,[TDB]颂太祖,2421,96,4,5,9,44.4%,37m
20892,1,扫地焚香,2421,186,4,18,22,18.2%,59m
20892,1,SoapMac,2421,0,1,1,2,50.0%,1h
20892,1,一介书生,2421,0,1,1,2,50.0%,22m
20892,1,Sora,2421,0,0,1,1,0.0%,1h
20892,1,练起来,2421,0,0,1,1,0.0%,25m
20892,1,[太鸡了]参议将军,2421,0,0,2,2,0.0%,23m
20912,2,lise,2420,1355,261,261,522,50.0%,39m
20912,1,IIIIIIIIIIII,2420,1060,162,177,339,47.8%,24m
20912,2,叫我光头哥,2420,380,26,31,57,45.6%,10m
20912,2,斐多悖论,2420,727,24,32,56,42.9%,24m
20912,3,Creativity,2420,451,16,20,36,44.4%,5m
20912,1,伞兵一号卢本伟,2420,289,7,6,13,53.8%,1h
20912,2,小小菜,2420,208,7,12,19,36.8%,1h
20912,1,ATD,2420,194,6,3,9,66.7%,44m
20912,2,mkzhao,2420,104,6,11,17,35.3%,17m
20912,2,[西湖底安保队]西湖保安队长,2420,133,4,9,13,30.8%,20m
20912,1,顾言,2420,116,3,4,7,42.9%,1h
20912,1,zumar,2420,96,3,7,10,30.0%,40m
20912,1,OFE,2420,144,2,1,3,66.7%,9m
20912,2,ZHAOSI,2420,88,2,2,4,50.0%,25m
20912,1,[XXHZN2]萌萌小正太,2420,48,2,5,7,28.6%,14m
20912,1,sSS,2420,97,2,5,7,28.6%,1h
20928,3,kily,2419,1496,72,74,146,49.3%,1h
20928,1,忧郁的蓝领,2419,1511,57,48,105,54.3%,30m
20928,1,Olivvver,2419,708,28,24,52,53.8%,24m
20928,3,源老,2419,551,22,17,39,56.4%,49m
20928,1,tklbp,2419,575,18,15,33,54.5%,1h
20928,3,光芒万丈陈彦祖,2419,320,11,11,22,50.0%,1h
20928,1,以核为贵,2419,312,9,14,23,39.1%,1h
20928,3,叮叮当当,2419,198,7,9,16,43.8%,1h
20928,1,[15CM]你好菜,2419,208,6,0,6,100.0%,5m
20928,1,开普勒泰坦,2419,225,5,11,16,31.2%,1h
20928,1,有钱的钢铁侠,2419,80,2,2,4,50.0%,1h
20928,1,隆美尔,2419,96,2,2,4,50.0%,49m
20928,3,老男人学友,2419,121,2,3,5,40.0%,9m
20928,3,cary,2419,60,2,7,9,22.2%,29m
20928,3,杜渝成,2419,0,1,0,1,100.0%,43m
20928,1,hhh,2419,48,1,3,4,25.0%,1h
20928,1,明过江南,2419,0,0,1,1,0.0%,1h
20928,1,君莫笑,2419,0,0,2,2,0.0%,23m
20946,2,盐烧秋刀鱼,2418,1498,99,101,200,49.5%,15m
20946,3,[HFUOT]Sarrel,2418,953,42,34,76,55.3%,15m
20946,2,yyf,2418,916,37,44,81,45.7%,24m
20946,1,人族从入门到入土,2418,862,26,25,51,51.0%,1h
20946,1,[ELSD]神族玩家死全家,2418,509,18,15,33,54.5%,1h
20946,1,好好向前,2418,427,13,7,20,65.0%,1h
20946,2,暗物质,2418,0,2,3,5,40.0%,1h
20946,3,keke,2418,0,2,6,8,25.0%,1h
20946,1,MagicLing,2418,0,1,0,1,100.0%,14m
20946,2,陈阳阳,2418,0,1,0,1,100.0%,1h
20946,3,[虚拟歌手团体]白狐,2418,0,1,2,3,33.3%,1h
20946,2,NFxianzhi,2418,0,1,4,5,20.0%,53m
20946,2,[ZSG]TSbucket,2418,0,1,4,5,20.0%,1h
20946,2,[完了卡人口了]那咋整啊,2418,0,0,2,2,0.0%,1h
20946,2,fontens,2418,0,0,5,5,0.0%,11m
20961,3,阿逵不砍第二刀,2417,916,105,92,197,53.3%,6m
20961,1,Gunner,2417,1358,59,50,109,54.1%,2m
20961,3,[菜有菜的道理]与正,2417,548,53,46,99,53.5%,1h
20961,3,tassder,2417,637,25,25,50,50.0%,20m
20961,2,Ryan,2417,327,24,27,51,47.1%,15m
20961,1,ohlyshiu,2417,376,13,7,20,65.0%,1h
20961,1,老子就是菜怎么了,2417,379,13,14,27,48.1%,6m
20961,2,人间之屑,2417,256,9,9,18,50.0%,16m
20961,3,[沙雕枢纽斗士]方冷,2417,196,8,8,16,50.0%,23m
20961,1,Glove,2417,296,7,8,15,46.7%,1h
20961,1,[坦克36D]MagicTeddy,2417,164,5,3,8,62.5%,17m
20961,1,长歌,2417,145,4,6,10,40.0%,1h
20961,3,[神罚]小星星,2417,66,4,8,12,33.3%,24m
20961,1,三生一意,2417,78,3,1,4,75.0%,1h
20961,2,落叶随风,2417,106,3,5,8,37.5%,1h
20961,1,[LED]最帅的我,2417,42,2,0,2,100.0%,1h
20961,1,妖刀,2417,0,2,5,7,28.6%,8m
20961,2,原来是阿阳呀,2417,0,1,4,5,20.0%,1h
20961,1,恋你的温柔,2417,0,0,1,1,0.0%,1h
20961,1,缘之空,2417,0,0,1,1,0.0%,10m
20981,3,小学生玩星际,2416,1332,101,89,190,53.2%,17m
20981,1,[YINGJI]霸气华哥,2416,942,68,58,126,54.0%,17m
20981,1,[大连民大]CPPmonk,2416,532,21,9,30,70.0%,53m
20981,3,[東方心念語]比那名居桃子,2416,540,20,23,43,46.5%,15m
20981,3,影杰裕可里,2416,537,19,21,40,47.5%,28m
20981,2,WildRage,2416,406,15,21,36,41.7%,1h
20981,1,[萌新小菜鸡]momo,2416,313,8,5,13,61.5%,6m
20981,2,前排前排起,2416,203,7,5,12,58.3%,1h
20981,1,iYifei,2416,192,7,6,13,53.8%,1h
20981,2,shuyi,2416,168,5,9,14,35.7%,1h
20981,3,[腥基佬男骸]疯瘤老煜哥,2416,169,4,1,5,80.0%,20m
20981,2,[Hdl]Assam,2416,148,4,8,12,33.3%,1h
20981,1,摸金校尉,2416,76,2,2,4,50.0%,1h
20981,1,无敌小旋风,2416,97,2,5,7,28.6%,40m
20981,2,无名的人,2416,0,1,4,5,20.0%,1h
20981,1,Evolution,2416,48,1,4,5,20.0%,1h
20981,1,飞翔的企鹅,2416,42,1,4,5,20.0%,20m
20981,2,linoson,2416,0,1,4,5,20.0%,1h
20981,2,goma,2416,0,1,4,5,20.0%,37m
20981,3,昕之所向,2416,0,0,1,1,0.0%,24m
20981,1,yifei,2416,0,0,2,2,0.0%,1h
20981,1,[菜的徐坤都怕]拳打南山养老院,2416,0,0,3,3,0.0%,1h
21003,2,[帝都战神]出门一波,2415,1189,89,92,181,49.2%,1h
21003,2,[老油条战队]SkyofKen,2415,1448,85,94,179,47.5%,59m
21003,3,[时光与酒oc]被太子虐的人机,2415,980,46,34,80,57.5%,31m
21003,3,aswcd,2415,460,19,23,42,45.2%,20m
21003,1,天下,2415,444,16,14,30,53.3%,13m
21003,1,异虫是食物,2415,478,16,23,39,41.0%,1h
21003,2,ThezGAgayY,2415,267,9,8,17,52.9%,4m
21003,1,山头村峰哥,2415,272,7,7,14,50.0%,1h
21003,3,Perfect,2415,193,6,8,14,42.9%,1h
21003,3,帝国上将军,2415,224,6,11,17,35.3%,45m
21003,3,[镜花水月]爱吃面包的索菲,2415,142,5,10,15,33.3%,1h
21003,3,感受世界的痛苦,2415,90,4,9,13,30.8%,1h
21003,1,[瘾大眼瞎]大马罗,2415,118,3,5,8,37.5%,2m
21003,2,Panic,2415,140,3,7,10,30.0%,4m
21003,1,Belial,2415,70,2,2,4,50.0%,1h
21003,2,半夜摸咪咪,2415,0,2,3,5,40.0%,1h
21003,1,[埃蒙好可爱]会飞的老鼠,2415,0,1,0,1,100.0%,54m
21003,1,[ma个鸡泰伦]Shaw,2415,40,1,2,3,33.3%,1h
21003,1,[阿瓦隆之斩]乄灬冰梦乀,2415,48,1,2,3,33.3%,14m
21003,1,月瞳,2415,0,1,3,4,25.0%,7m
21003,1,storm,2415,0,1,4,5,20.0%,1h
21024,2,[犹豫就会败北]bigboss,2414,533,21,30,51,41.2%,33m
21024,1,[RKT]Thor,2414,680,19,21,40,47.5%,51m
21024,1,Endpageups,2414,489,16,21,37,43.2%,1h
21024,1,小怪兽其乐无穷,2414,304,9,8,17,52.9%,26m
21024,1,自由在召唤,2414,332,9,9,18,50.0%,1h
21024,3,火殇逝流年,2414,193,7,8,15,46.7%,1h
21024,3,vegae,2414,152,5,8,13,38.5%,1h
21024,1,奈亚拉图提普,2414,42,2,1,3,66.7%,38m
21024,1,[大元师]messiise,2414,42,2,1,3,66.7%,33m
21024,1,[风起云涌0]skjason,2414,46,2,4,6,33.3%,9m
21024,1,哦豁,2414,0,2,4,6,33.3%,1h
21024,1,暗中观察,2414,0,1,0,1,100.0%,1h
21024,2,包子,2414,0,1,0,1,100.0%,59m
21024,1,XiaoMing,2414,0,1,1,2,50.0%,33m
21024,2,Sakura,2414,88,1,2,3,33.3%,32m
21024,3,刀锋,2414,0,1,2,3,33.3%,9m
21024,1,[XXS]啊音啊啊啊啊乃啊,2414,0,1,2,3,33.3%,14m
21024,1,surrenda,2414,48,1,4,5,20.0%,45m
21042,3,hahaha,2413,1224,148,151,299,49.5%,29m
21042,1,王大头,2413,1090,56,50,106,52.8%,1h
21042,2,YUKINO,2413,1341,52,51,103,50.5%,12m
21042,1,WarMach,2413,1009,36,38,74,48.6%,1h
21042,3,神州一浩,2413,701,30,23,53,56.6%,1h
21042,1,[天青车道]杰克南瓜,2413,360,21,12,33,63.6%,45m
21042,3,月落星辰,2413,418,14,19,33,42.4%,40m
21042,3,return,2413,414,14,20,34,41.2%,55m
21042,3,[开饭了]田教授,2413,199,6,7,13,46.2%,1h
21042,1,海月,2413,242,5,2,7,71.4%,1h
21042,1,白虎,2413,126,4,3,7,57.1%,1h
21042,1,上杉绘梨衣,2413,118,3,3,6,50.0%,1h
21042,3,[大洋彼岸团队]面对现实,2413,150,3,7,10,30.0%,6m
21042,1,木橘子,2413,0,1,1,2,50.0%,10m
21042,1,魔羽,2413,42,1,2,3,33.3%,1h
21042,1,后期,2413,0,1,3,4,25.0%,5m
21042,3,犬走椛,2413,0,0,1,1,0.0%,1h
21042,2,枫叶,2413,0,0,2,2,0.0%,1h
21060,3,云天之翼,2412,626,34,30,64,53.1%,9m
21060,1,Mihawk,2412,557,16,21,37,43.2%,1h
21060,1,[28CM]进击的懒骨头,2412,341,10,6,16,62.5%,41m
21060,2,[戊戌六菜鸡]game,2412,283,10,8,18,55.6%,1h
21060,3,小虎丶,2412,256,8,11,19,42.1%,1h
21060,2,ghost,2412,211,6,14,20,30.0%,4m
21060,1,想想菲斯会怎么做,2412,184,5,0,5,100.0%,1h
21060,3,动力火车,2412,176,5,3,8,62.5%,1h
21060,1,Smilence,2412,113,3,2,5,60.0%,33m
21060,2,北婉霂,2412,0,3,2,5,60.0%,54m
21060,1,IIIIIIIIIII,2412,122,3,5,8,37.5%,1h
21060,1,为所欲为异灵术,2412,48,3,5,8,37.5%,1h
21060,1,CloudZ,2412,40,2,1,3,66.7%,2m
21060,1,永恒梦魇的袭击,2412,36,2,1,3,66.7%,2m
21060,1,有趣君,2412,42,2,3,5,40.0%,19m
21060,1,[曾经一群兔子]小学生,2412,0,2,5,7,28.6%,10m
21060,1,Carmen,2412,97,2,5,7,28.6%,8m
21060,1,天璇灵韵,2412,0,1,0,1,100.0%,8m
21060,1,用户名为空,2412,42,1,1,2,50.0%,54m
21060,1,厄而东瓜,2412,97,1,1,2,50.0%,14m
21060,1,荆宇,2412,0,1,2,3,33.3%,1h
21060,2,Alen,2412,0,1,4,5,20.0%,1h
21060,1,[情谊至上]九月中,2412,0,0,1,1,0.0%,10m
21060,1,最后的风之子,2412,0,0,1,1,0.0%,1h
21084,1,哈啥,2411,1459,62,60,122,50.8%,6m
21084,1,TheRock,2411,1056,54,40,94,57.4%,6m
21084,2,玫瑰公子,2411,1145,41,53,94,43.6%,58m
21084,2,Revolv,2411,756,35,36,71,49.3%,24m
21084,1,末了滴丶夜饭,2411,852,26,25,51,51.0%,1h
21084,1,[最强战神]蓄意一卖萌,2411,593,21,13,34,61.8%,1h
21084,1,[黄金舰队GA]恶霸山大王,2411,242,7,6,13,53.8%,2m
21084,1,XIALI,2411,150,6,14,20,30.0%,1h
21084,3,柠檬茶,2411,64,4,8,12,33.3%,1h
21084,3,asjhduobg,2411,60,3,6,9,33.3%,10m
21084,3,秋矢菊,2411,145,3,9,12,25.0%,7m
21084,2,尘埃,2411,0,2,3,5,40.0%,1h
21084,1,[妈个小鸡]菜鸡小戴,2411,0,1,0,1,100.0%,1h
21084,1,billy,2411,0,1,1,2,50.0%,40m
21084,2,狄跃,2411,0,1,1,2,50.0%,1h
21084,2,wudi,2411,0,1,4,5,20.0%,51m
21084,1,Ghost,2411,44,1,5,6,16.7%,1h
21084,3,MiniTitan,2411,0,0,1,1,0.0%,1h
21084,2,魂魄妖夢,2411,0,0,1,1,0.0%,59m
21103,3,[林落秋过]晓筱,2410,462,17,15,32,53.1%,1h
21103,1,beworth,2410,390,14,17,31,45.2%,44m
21103,2,[ELC]Dalaran,2410,358,13,23,36,36.1%,1h
21103,3,[失去理智]加州丶,2410,284,10,9,19,52.6%,1h
21103,1,angelos,2410,303,8,4,12,66.7%,1h
21103,1,[四叶草]Faliscr,2410,266,8,6,14,57.1%,44m
21103,3,CHNtuy,2410,208,8,11,19,42.1%,39m
21103,1,[雪松]盲人玩家,2410,178,7,14,21,33.3%,1h
21103,1,萌新求放过,2410,191,6,5,11,54.5%,1h
21103,1,呆呆兽,2410,96,4,8,12,33.3%,20m
21103,1,vold,2410,118,3,3,6,50.0%,44m
21103,1,[兴欣网吧]一叶之秋,2410,97,2,2,4,50.0%,22m
21103,1,卷子,2410,0,1,0,1,100.0%,20m
21103,2,ZMS,2410,0,1,4,5,20.0%,1h
21103,2,读着倒子傻有总,2410,0,0,1,1,0.0%,1h
21103,1,[维和舰队]笑丶,2410,0,0,2,2,0.0%,33m
21103,1,梅巛内酷,2410,0,0,2,2,0.0%,1h
21120,3,[菜有菜的道理]松果弹抖闪电鞭,2409,1372,102,89,191,53.4%,28m
21120,1,万里云,2409,1736,69,50,119,58.0%,1h
21120,1,秋米,2409,1098,44,50,94,46.8%,1h
21120,1,[这是队标唔姆]异灵术的迷弟,2409,1073,39,39,78,50.0%,1h
21120,1,RMB,2409,1077,36,32,68,52.9%,1h
21120,1,[妖妖梦]Wasted,2409,1011,32,29,61,52.5%,6m
21120,1,夏夜银辉,2409,700,23,22,45,51.1%,11m
21120,1,一个小机枪,2409,358,20,19,39,51.3%,1h
21120,1,倾尽天下,2409,624,19,14,33,57.6%,33m
21120,2,冷漠突击,2409,448,16,22,38,42.1%,1h
21120,3,流星,2409,285,13,19,32,40.6%,1h
21120,1,[神子]诸神黄昏,2409,308,11,15,26,42.3%,1h
21120,2,Frost,2409,149,5,2,7,71.4%,1h
21120,1,浅夏染柒,2409,195,4,3,7,57.1%,39m
21120,1,[打啊]萌王殿下,2409,172,4,4,8,50.0%,1h
21120,3,SHOWTIME,2409,58,3,7,10,30.0%,1h
21120,3,[半夏]森下下士,2409,0,2,6,8,25.0%,20m
21120,3,[月黑雁飞高]KKLDMKLOJID,2409,92,1,1,2,50.0%,7m
21120,1,sdsdas,2409,0,1,1,2,50.0%,1h
21120,1,klero,2409,40,1,4,5,20.0%,1h
21120,2,[C17874]zxzxz,2409,0,1,4,5,20.0%,1h
21120,1,lihaoxuan,2409,95,1,4,5,20.0%,33m
21120,1,色法记者,2409,44,1,4,5,20.0%,20m
21120,1,BOSS,2409,0,0,1,1,0.0%,13m
21144,2,kas,2408,1555,225,221,446,50.4%,1h
21144,3,Skywalker,2408,1596,70,74,144,48.6%,28m
21144,1,知之甚远,2408,931,31,26,57,54.4%,23m
21144,1,牛旭蓬,2408,591,17,15,32,53.1%,41m
21144,1,[风云神]sundd,2408,204,12,9,21,57.1%,38m
21144,3,珂学赛高,2408,173,6,9,15,40.0%,1h
21144,1,浮影孤鸿,2408,212,5,7,12,41.7%,38m
21144,1,BirdMartin,2408,170,4,1,5,80.0%,11m
21144,1,[柏林军事学院]冰冻粽子,2408,0,4,2,6,66.7%,15m
21144,1,情窦初殇,2408,40,2,2,4,50.0%,1h
21144,1,PIGKING,2408,42,2,2,4,50.0%,13m
21144,2,傻得可爱,2408,0,2,2,4,50.0%,55m
21144,2,[黑暗在翻騰]MISSxiaodi,2408,0,2,3,5,40.0%,1h
21144,3,JloveL,2408,97,2,6,8,25.0%,1h
21144,1,一只萌新,2408,0,1,0,1,100.0%,20m
21144,1,[世界树]难受,2408,0,1,0,1,100.0%,38m
21144,2,[就是输]最高指挥官,2408,0,1,4,5,20.0%,1h
21144,1,MAMO,2408,44,1,4,5,20.0%,23m
21144,2,deepblue,2408,0,1,4,5,20.0%,16m
21144,3,[BLZSC2]神话哥哥,2408,0,0,1,1,0.0%,1h
21144,1,冷沫,2408,0,0,1,1,0.0%,1h
21165,2,cheng,2407,1067,59,68,127,46.5%,1h
21165,1,第五绝柔,2407,631,22,14,36,61.1%,41m
21165,2,墨铭,2407,568,22,29,51,43.1%,39m
21165,1,西洒街吴彦祖,2407,480,16,10,26,61.5%,44m
21165,3,[谈笑间灭你]我爱彪彪,2407,400,16,24,40,40.0%,1h
21165,3,[旋转撸管管]熊猫,2407,280,11,14,25,44.0%,46m
21165,2,眯眼看世界,2407,279,9,13,22,40.9%,3m
21165,3,暗夜雨,2407,214,7,12,19,36.8%,9m
21165,3,萌新不会玩,2407,203,6,9,15,40.0%,1h
21165,1,hhh,2407,208,4,3,7,57.1%,53m
21165,1,Kirito,2407,130,4,4,8,50.0%,46m
21165,2,卑微小小泰伦,2407,176,4,5,9,44.4%,39m
21165,1,[混元丨星际]五湖四海孙建国,2407,82,2,1,3,66.7%,41m
21165,1,[萌新启发会]洛基山狼,2407,36,2,2,4,50.0%,1h
21165,3,SkyS,2407,58,2,8,10,20.0%,39m
21165,2,大主教,2407,0,1,1,2,50.0%,1h
21165,1,[为了人类]没错是奶牛,2407,0,0,1,1,0.0%,1h
21182,2,强魔气,2406,1547,64,69,133,48.1%,33m
21182,3,xmc,2406,1012,45,38,83,54.2%,29m
21182,3,[神子]一个可爱的队友,2406,605,23,45,68,33.8%,19m
21182,1,Stats,2406,373,16,5,21,76.2%,54m
21182,3,[乱世]FCG,2406,239,8,9,17,47.1%,28m
21182,1,渐行渐远,2406,132,6,5,11,54.5%,1h
21182,3,HDZYAKKO,2406,195,6,8,14,42.9%,28m
21182,1,stee,2406,208,5,4,9,55.6%,36m
21182,3,[青风堂]又长又诡异,2406,147,5,8,13,38.5%,1h
21182,3,SlavKing,2406,145,4,2,6,66.7%,7m
21182,3,远道,2406,0,4,3,7,57.1%,1h
21182,1,keng,2406,145,3,5,8,37.5%,7m
21182,3,[诛心]圣彼德温,2406,58,3,6,9,33.3%,1h
21182,2,baofushehui,2406,114,2,3,5,40.0%,1h
21182,2,惜落,2406,0,2,3,5,40.0%,1h
21182,1,[暴雪一队]人前显贵人后受罪,2406,0,2,5,7,28.6%,56m
21182,2,[单人行动对吧]大智若憨,2406,0,1,4,5,20.0%,59m
21182,1,[亲爱的队友]潇枫哥哥,2406,0,1,6,7,14.3%,54m
21182,3,一只被舔狗的萌新,2406,0,0,2,2,0.0%,15m
21182,1,RBQ,2406,0,0,2,2,0.0%,20m
21182,1,田纳,2406,0,0,3,3,0.0%,8m
21203,2,秋夜君,2405,942,92,88,180,51.1%,10m
21203,2,大石碎胸口,2405,1481,82,90,172,47.7%,29m
21203,3,[Iowa]宇宙战舰衣阿华,2405,753,80,81,161,49.7%,1h
21203,1,星空猎人小鱼儿,2405,1461,60,60,120,50.0%,17m
21203,1,[海湾特殊队]发拉利嗨,2405,1146,59,58,117,50.4%,45m
21203,2,snowery,2405,538,52,56,108,48.1%,19m
21203,3,KIRA,2405,1182,48,47,95,50.5%,49m
21203,1,莫待无花空折枝,2405,690,33,19,52,63.5%,45m
21203,2,堕落天使,2405,413,26,31,57,45.6%,37m
21203,1,风舞者,2405,606,21,15,36,58.3%,1h
21203,3,菠萝蜜汁叉烧包,2405,286,20,22,42,47.6%,31m
21203,2,iiiiiiiiiiii,2405,356,19,25,44,43.2%,1h
21203,1,[喜欢香香]冰尊帝影,2405,336,15,14,29,51.7%,38m
21203,1,[8v1玩泥巴]香风智乃,2405,384,14,12,26,53.8%,45m
21203,3,[xy饲料厂]鸟哥的小迷妹,2405,400,14,18,32,43.8%,31m
21203,2,[猩猩人]XZZC,2405,162,14,19,33,42.4%,59m
21203,1,[伊瓦隆]亚科斯特,2405,396,12,7,19,63.2%,33m
21203,1,[WYF]草莓芝士卷,2405,314,9,6,15,60.0%,13m
21203,1,[DX战队]奶油少女丶萌妹子,2405,258,9,16,25,36.0%,33m
21203,2,熊炮灰,2405,142,6,7,13,46.2%,1h
21203,2,黄某人,2405,206,6,8,14,42.9%,1h
21203,1,古道西风瘦马,2405,165,5,5,10,50.0%,37m
21203,1,凌霜傲雪,2405,209,5,7,12,41.7%,37m
21203,1,槐序十六,2405,173,4,2,6,66.7%,1h
21203,1,[蓝星远征军]ABYSSANGEL,2405,128,4,4,8,50.0%,1h
21203,1,叫我官人,2405,120,3,5,8,37.5%,11m
21203,1,BENZ,2405,145,3,5,8,37.5%,24m
21203,1,lingtingzhe,2405,80,2,5,7,28.6%,9m
21203,2,Apmzhiyouwu,2405,46,2,6,8,25.0%,28m
21203,3,一脚踢死贝尔,2405,0,2,6,8,25.0%,24m
21203,3,heianmanyan,2405,74,2,8,10,20.0%,52m
21203,1,jintong,2405,40,1,4,5,20.0%,1h
21203,2,[仁义礼智信]夏风灬,2405,0,1,4,5,20.0%,53m
21203,1,冰可枯,2405,0,0,1,1,0.0%,1h
21203,3,不知道叫啥,2405,0,0,1,1,0.0%,24m
21203,2,邱诚,2405,0,0,1,1,0.0%,1h
21203,1,[Elite]咸鱼迪胖胖六六六,2405,0,0,2,2,0.0%,1h
21203,1,admiral,2405,0,0,2,2,0.0%,1h
21203,1,Phoneix,2405,0,0,2,2,0.0%,5m
21203,2,懒狗,2405,0,0,3,3,0.0%,16m
21243,1,Xavier,2404,1617,77,78,155,49.7%,33m
21243,1,[NightL]NMZL,2404,1757,64,59,123,52.0%,1h
21243,3,菜石子,2404,396,42,43,85,49.4%,1h
21243,1,我爱范思哲,2404,989,34,44,78,43.6%,1h
21243,3,aaaaaa,2404,576,24,15,39,61.5%,1h
21243,1,[你在教我做事]早睡早起规律生活,2404,292,13,15,28,46.4%,13m
21243,2,ZHULU,2404,303,11,6,17,64.7%,32m
21243,1,[CPT]kindles,2404,332,11,12,23,47.8%,6m
21243,1,[秋毫]Delight,2404,165,7,7,14,50.0%,2m
21243,3,斧乃木余接,2404,195,6,7,13,46.2%,10m
21243,1,[胸大自然萌灬]Aaaaa,2404,124,4,3,7,57.1%,45m
21243,1,何苦,2404,96,3,2,5,60.0%,1h
21243,1,[星舰与太阳x]周白鸡之父,2404,48,3,4,7,42.9%,1h
21243,3,[红莲骑士团]阳光校长,2404,58,3,6,9,33.3%,31m
21243,3,[烽火长歌]千万人吾往矣,2404,30,2,5,7,28.6%,1h
21243,1,[博云星际学院]帕秋莉诺蕾姬,2404,0,1,1,2,50.0%,44m
21243,1,行者,2404,38,1,1,2,50.0%,38m
21243,1,parkhj,2404,48,1,2,3,33.3%,14m
21243,2,战云飞,2404,0,1,4,5,20.0%,1h
21243,1,lei,2404,0,1,5,6,16.7%,1h
21243,1,六二六号罪犯,2404,0,0,2,2,0.0%,1h
21264,2,枫丹白露的月光,2403,1513,514,539,1053,48.8%,52m
21264,3,JIN,2403,1398,72,67,139,51.8%,28m
21264,1,琪琪,2403,1481,53,45,98,54.1%,33m
21264,1,观阴大湿,2403,1022,48,58,106,45.3%,55m
21264,1,Smile,2403,826,33,23,56,58.9%,1h
21264,3,喜欢殴打虫族,2403,511,33,36,69,47.8%,31m
21264,1,再没有你的冬眠,2403,676,20,22,42,47.6%,24m
21264,3,[NLYH]冰封王兽,2403,116,5,8,13,38.5%,1h
21264,1,king,2403,156,4,1,5,80.0%,11m
21264,1,[Octoca]cuibty,2403,160,4,2,6,66.7%,13m
21264,3,郭泽辉的大号,2403,137,4,4,8,50.0%,55m
21264,2,Rebelxy,2403,84,4,9,13,30.8%,33m
21264,2,猪猪兰,2403,92,3,7,10,30.0%,1h
21264,2,atmaly,2403,0,1,4,5,20.0%,30m
21264,2,神一梦魇,2403,0,1,4,5,20.0%,1h
21264,1,[平常心人族]DcQseVen,2403,0,0,1,1,0.0%,24m
21264,3,雪霁,2403,0,0,1,1,0.0%,15m
21264,1,游戏毁灭者,2403,0,0,1,1,0.0%,45m
21264,2,田家酱,2403,0,0,1,1,0.0%,1h
21264,2,[悬溺堕星河]夜竹星夕,2403,0,0,5,5,0.0%,32m
21284,3,IIIIIIIIIIII,2402,1548,147,143,290,50.7%,1h
21284,1,不动如山,2402,1069,42,42,84,50.0%,20m
21284,3,[我们是害虫1]RohanKishibe,2402,815,28,32,60,46.7%,1h
21284,3,[快乐谐星go]PetterZHU,2402,676,25,28,53,47.2%,52m
21284,2,[中华何平]夜行者,2402,571,24,30,54,44.4%,49m
21284,3,IIIIIIIIIII,2402,408,21,8,29,72.4%,27m
21284,3,默默的蹲在墙角,2402,582,21,24,45,46.7%,1h
21284,1,感谢太多人工作,2402,547,18,20,38,47.4%,1h
21284,1,红枫,2402,309,12,14,26,46.2%,1h
21284,1,IIIIIIIIIIII,2402,412,11,8,19,57.9%,1h
21284,1,无名菜鸡,2402,263,9,4,13,69.2%,1h
21284,2,我是王军娃儿,2402,193,7,10,17,41.2%,1h
21284,3,孤城,2402,199,5,5,10,50.0%,1h
21284,1,[SCVsr]奇迹,2402,189,5,5,10,50.0%,40m
21284,2,poi,2402,175,4,3,7,57.1%,49m
21284,1,Renhuang,2402,48,4,7,11,36.4%,1h
21284,1,Sparrow,2402,158,4,8,12,33.3%,19m
21284,1,IAMACN,2402,143,3,6,9,33.3%,1h
21284,1,[某不知名鸡场]人族败类,2402,46,2,5,7,28.6%,6m
21284,1,[我是萌新Q]罪人,2402,0,1,0,1,100.0%,12m
21284,1,我爱昵,2402,48,1,2,3,33.3%,37m
21284,2,[旋风游骑兵]桃华月惮,2402,0,1,4,5,20.0%,1h
21284,1,[中华何平]豹子头丶零充,2402,0,0,1,1,0.0%,1h
21307,3,Polaris,2401,1172,106,93,199,53.3%,28m
21307,1,吾问无为谓,2401,1099,39,37,76,51.3%,6m
21307,3,Maru,2401,791,30,33,63,47.6%,1h
21307,3,asdas,2401,276,18,20,38,47.4%,1h
21307,1,[公子世无双]浅幕之年我定逆天,2401,481,16,11,27,59.3%,1h
21307,1,[燕大SC]人活着就为伊莉雅,2401,246,7,5,12,58.3%,1h
21307,1,天不生我徐默然丶,2401,44,2,0,2,100.0%,23m
21307,1,galax,2401,42,2,2,4,50.0%,35m
21307,1,ICE,2401,92,2,4,6,33.3%,20m
21307,2,[星际公社]落英絮语,2401,46,2,4,6,33.3%,1h
21307,3,水余三金石,2401,0,1,0,1,100.0%,7m
21307,3,sirinceSYF,2401,30,1,3,4,25.0%,36m
21307,2,Lucifer,2401,30,1,5,6,16.7%,40m
21307,1,乜你不要理由,2401,0,0,1,1,0.0%,1h
21307,1,梁梁,2401,0,0,2,2,0.0%,37m
21307,1,天天开心,2401,0,0,3,3,0.0%,1h
21323,2,猴哥布琳布琳,2400,970,77,88,165,46.7%,17m
21323,1,MaGeJeTerran,2400,457,17,10,27,63.0%,1h
21323,1,高冷的喵先生,2400,442,13,11,24,54.2%,52m
21323,3,虫鸣,2400,371,13,12,25,52.0%,1h
21323,3,[日爆德哈卡]kangkang,2400,295,10,15,25,40.0%,1h
21323,3,wangmouren,2400,274,9,8,17,52.9%,5m
21323,1,陶渊明,2400,271,8,3,11,72.7%,45m
21323,3,CierraRunis,2400,240,7,7,14,50.0%,6m
21323,1,为泽叔封刀,2400,242,7,14,21,33.3%,39m
21323,1,shxje,2400,190,6,2,8,75.0%,44m
21323,1,edenbot,2400,48,5,5,10,50.0%,60m
21323,1,世间之寂寞丶,2400,166,4,4,8,50.0%,2m
21323,1,莫凡,2400,82,3,1,4,75.0%,1h
21323,1,barkcat,2400,136,3,8,11,27.3%,5m
21323,2,森宝的战争,2400,95,3,8,11,27.3%,1h
21323,3,[妮妮专属]Antonerl,2400,97,2,2,4,50.0%,15m
21323,1,堕落血天使,2400,82,2,3,5,40.0%,45m
21323,2,大云,2400,0,2,3,5,40.0%,1h
21323,2,PROTOSS,2400,46,2,4,6,33.3%,32m
21323,3,yisan,2400,0,2,6,8,25.0%,1h
21323,1,[科普卢老车队]你的机枪兵死光啦,2400,0,1,0,1,100.0%,1h
21323,1,槿月巷,2400,0,1,0,1,100.0%,23m
21323,2,wdnmd,2400,0,1,4,5,20.0%,51m
21323,2,信徒,2400,0,1,4,5,20.0%,1h
21347,1,Hunter,2399,514,19,11,30,63.3%,52m
21347,1,shockingblue,2399,427,17,16,33,51.5%,33m
21347,3,[XXHZ30]村长他哥,2399,438,15,18,33,45.5%,6m
21347,1,[平家boys]VanDarkholme,2399,181,7,7,14,50.0%,1h
21347,3,coco,2399,94,4,5,9,44.4%,39m
21347,3,[暗黑破坏神3]DuskSam,2399,60,3,4,7,42.9%,39m
21347,3,[小鸡屠宰场3]saiwen,2399,62,3,9,12,25.0%,17m
21347,1,ojqaefiojoi,2399,42,2,1,3,66.7%,2m
21347,1,只会修地堡,2399,0,2,4,6,33.3%,1h
21347,1,[海王星舰队]Sakura,2399,40,1,2,3,33.3%,1h
21347,2,埃蒙,2399,0,1,4,5,20.0%,1h
21347,1,Boogiepop,2399,0,0,2,2,0.0%,1h
21347,1,驾鹤望浮云,2399,0,0,2,2,0.0%,23m
21360,2,[北有唔王]星际菜鸟,2398,1556,307,300,607,50.6%,29m
21360,2,[XXHZ32]梦毒,2398,1551,136,144,280,48.6%,34m
21360,1,ATsDaytime,2398,1158,65,58,123,52.8%,1h
21360,1,[探姬联萌]踏雪,2398,393,32,48,80,40.0%,18m
21360,1,浪言,2398,836,29,30,59,49.2%,11m
21360,3,[大呲花]不死强,2398,786,28,31,59,47.5%,45m
21360,3,[仓鼠党]Ciar,2398,494,18,25,43,41.9%,12m
21360,1,司音,2398,417,13,11,24,54.2%,30m
21360,1,胡说八道,2398,48,4,5,9,44.4%,1h
21360,3,冲锋是胜利荣光,2398,102,4,12,16,25.0%,24m
21360,2,不是吧,2398,0,3,2,5,60.0%,1h
21360,2,mDay,2398,60,3,12,15,20.0%,49m
21360,1,[你已经死啦]JAKEGE,2398,38,2,0,2,100.0%,1h
21360,1,Reinhard,2398,40,2,2,4,50.0%,38m
21360,1,[湾区社会人]JohnsonQ,2398,80,2,5,7,28.6%,52m
21360,1,叹息之墙,2398,40,1,3,4,25.0%,1h
21360,2,飞达艺术团带动,2398,0,1,3,4,25.0%,26m
21360,1,[Beasty]路漫漫,2398,46,1,4,5,20.0%,24m
21360,1,雪泪寒,2398,0,0,1,1,0.0%,1h
21360,1,[谁能教我做人]洗心革面重新做人,2398,0,0,1,1,0.0%,38m
21360,1,[黑冰]清欢,2398,0,0,2,2,0.0%,1h
21360,2,王之殇罗辑,2398,0,0,2,2,0.0%,14m
21382,1,[昆明RANK]Gwagen,2397,1506,61,75,136,44.9%,48m
21382,1,[天下布武丶]君莫笑,2397,842,37,35,72,51.4%,52m
21382,3,Accelevector,2397,833,33,32,65,50.8%,16m
21382,3,SCPLAYER,2397,633,23,27,50,46.0%,45m
21382,3,manzuzhiwang,2397,447,18,21,39,46.2%,40m
21382,1,王飞,2397,484,14,15,29,48.3%,1h
21382,1,ImProVise,2397,409,11,7,18,61.1%,38m
21382,1,人族小玩家,2397,276,8,4,12,66.7%,1h
21382,3,不上钻石不改名,2397,156,7,11,18,38.9%,40m
21382,3,魔术星际,2397,204,7,12,19,36.8%,1h
21382,2,[Salt]Satou,2397,166,5,5,10,50.0%,18m
21382,1,[地球特勤局]天蝎,2397,98,3,3,6,50.0%,53m
21382,2,木西,2397,0,3,7,10,30.0%,25m
21382,1,[HPT]Cat,2397,42,2,0,2,100.0%,1h
21382,3,[星际旅游团]asgardking,2397,34,2,3,5,40.0%,1h
21382,1,[ZTSCAP]JOKE,2397,0,1,1,2,50.0%,1h
21382,1,开飞机的梳子,2397,40,1,1,2,50.0%,17m
21382,1,[德哈卡神教]戏中人,2397,0,1,1,2,50.0%,1h
21382,1,筱儿呢,2397,40,1,2,3,33.3%,50m
21382,1,[我怎么没兵了]我还没造兵呢,2397,93,1,4,5,20.0%,1h
21382,2,pro,2397,0,1,4,5,20.0%,51m
21382,1,[SC2战队]昆阿圭罗,2397,0,0,1,1,0.0%,1h
21404,3,hellowj,2396,580,57,54,111,51.4%,1h
21404,3,[这是什么玩意]老王是真的帅,2396,818,50,47,97,51.5%,23m
21404,1,terraier,2396,1011,40,34,74,54.1%,38m
21404,1,yzyxc,2396,546,17,17,34,50.0%,1h
21404,3,旧的假的剃须刀,2396,375,14,22,36,38.9%,39m
21404,2,[天下何平]陶陶,2396,337,10,16,26,38.5%,40m
21404,1,阿尔文,2396,322,9,7,16,56.2%,1h
21404,1,[COMBN]萝卜,2396,274,8,7,15,53.3%,38m
21404,1,坑爹的人族,2396,204,5,4,9,55.6%,38m
21404,1,[电竟毒奶]坠落凡尘,2396,124,4,3,7,57.1%,45m
21404,1,tesla,2396,166,4,6,10,40.0%,38m
21404,1,舔狗必死,2396,48,4,6,10,40.0%,20m
21404,1,Ivan,2396,169,3,3,6,50.0%,24m
21404,1,阿尔卡中尉,2396,40,2,0,2,100.0%,11m
21404,3,我的五十块,2396,121,2,1,3,66.7%,1h
21404,1,STOP,2396,97,2,3,5,40.0%,41m
21404,1,优越之翼,2396,96,2,5,7,28.6%,37m
21404,1,DJzelot,2396,0,1,1,2,50.0%,1h
21404,3,火狐,2396,0,1,3,4,25.0%,1h
21404,2,我躺尸你凯瑞,2396,0,1,4,5,20.0%,1h
21404,1,一只白狐狸,2396,0,0,1,1,0.0%,8m
21404,1,acetylCoA,2396,0,0,1,1,0.0%,5m
21426,1,[社交学导师]阿久,2395,1721,102,101,203,50.2%,35m
21426,1,[人间动物园]熊中熊熊,2395,1461,61,46,107,57.0%,8m
21426,1,白给真善美,2395,196,59,65,124,47.6%,1h
21426,1,放青松,2395,1094,49,50,99,49.5%,8m
21426,1,吧哩吧哩库呷库呷,2395,862,27,29,56,48.2%,38m
21426,3,我们必胜,2395,585,20,23,43,46.5%,9m
21426,1,无名少年,2395,259,6,7,13,46.2%,1h
21426,1,一兜黄芽白,2395,188,5,0,5,100.0%,1h
21426,1,祈风,2395,146,5,4,9,55.6%,38m
21426,1,陈年起司,2395,48,4,4,8,50.0%,6m
21426,3,[凯露天下第一]高性能亚托莉,2395,92,4,7,11,36.4%,10m
21426,1,[女武神的餐厅]在下御四使,2395,38,2,0,2,100.0%,2m
21426,1,[白上丨吹雪]九洛大少主,2395,96,2,0,2,100.0%,24m
21426,1,阿克图尔斯蒙斯克,2395,116,2,2,4,50.0%,14m
21426,2,王甘木,2395,46,2,4,6,33.3%,32m
21426,1,不知火殇,2395,0,1,0,1,100.0%,23m
21426,1,[绝世高手]须佐之男,2395,48,1,2,3,33.3%,1h
21426,1,佛眼看天,2395,40,1,3,4,25.0%,1h
21426,1,HUWAWEI,2395,0,0,1,1,0.0%,1h
21426,1,玉衡,2395,0,0,1,1,0.0%,1h
21426,1,凯瑞甘首席女弟子,2395,0,0,1,1,0.0%,1h
21447,3,Corby,2394,1571,174,175,349,49.9%,29m
21447,3,小小伟,2394,1396,99,97,196,50.5%,1h
21447,3,sadfdsdfasfg,2394,1149,52,43,95,54.7%,27m
21447,2,西湖底风景真好,2394,272,9,12,21,42.9%,1h
21447,3,shiro,2394,218,8,10,18,44.4%,1h
21447,3,DJhuang,2394,100,7,7,14,50.0%,8m
21447,2,[上分全靠送]万物逆旅,2394,46,5,7,12,41.7%,51m
21447,1,只是打酱油的,2394,113,4,1,5,80.0%,50m
21447,3,[bibiDI]宝宝,2394,0,4,4,8,50.0%,1h
21447,3,[突变攻略组]NES,2394,38,4,6,10,40.0%,1h
21447,1,Hugeotter,2394,78,3,0,3,100.0%,24m
21447,1,HoLLoWSTRING,2394,82,3,2,5,60.0%,44m
21447,1,[这里该有张图]明日之羽,2394,42,2,2,4,50.0%,1h
21447,2,[joster]Pluto,2394,102,2,5,7,28.6%,20m
21447,1,卢法斯,2394,96,2,5,7,28.6%,1h
21447,1,亚修,2394,0,1,0,1,100.0%,1h
21447,1,[最后的呼吸]風神,2394,0,1,1,2,50.0%,38m
21447,3,TinTin,2394,0,1,4,5,20.0%,39m
21447,2,第二十笼年糕,2394,0,1,4,5,20.0%,32m
21447,2,焊接工伟哥,2394,48,1,5,6,16.7%,1h
21447,1,Zerdxue,2394,0,0,2,2,0.0%,24m
21447,1,混三第二帅,2394,0,0,3,3,0.0%,1h
21469,3,悲剧男,2393,1595,109,115,224,48.7%,6m
21469,2,出虚空司马,2393,837,61,65,126,48.4%,1h
21469,1,叫爸不打你农民,2393,1360,47,54,101,46.5%,1h
21469,1,疾风,2393,302,12,17,29,41.4%,5m
21469,1,[火焰雷兽]落单的枪兵,2393,387,11,6,17,64.7%,1h
21469,1,[湖狸]墨染青衣颜,2393,325,10,4,14,71.4%,1h
21469,1,pmk,2393,290,9,17,26,34.6%,31m
21469,2,许你青丝白发,2393,290,9,17,26,34.6%,10m
21469,3,疾风之狼,2393,268,8,5,13,61.5%,52m
21469,2,djckawf,2393,268,8,10,18,44.4%,3m
21469,1,水果沙拉勇士,2393,240,7,3,10,70.0%,20m
21469,1,[秋毫]胖呼呼,2393,158,5,2,7,71.4%,20m
21469,3,北有疑兵,2393,142,5,10,15,33.3%,1h
21469,1,小灰机,2393,126,4,3,7,57.1%,41m
21469,3,[暴雪二十二队]小佳哥们,2393,150,4,6,10,40.0%,1h
21469,1,浅行之鲤,2393,82,3,1,4,75.0%,38m
21469,1,[19CM]死望,2393,116,3,10,13,23.1%,23m
21469,1,把把机械化,2393,82,2,2,4,50.0%,1h
21469,1,Untitled,2393,44,2,3,5,40.0%,8m
21469,1,[SUPSC]sadiest,2393,82,2,4,6,33.3%,1h
21469,1,[29CM]白嫖到底,2393,0,2,4,6,33.3%,1h
21469,2,Chimare,2393,118,2,4,6,33.3%,22m
21469,1,亚托克斯,2393,40,1,5,6,16.7%,23m
21469,1,二马,2393,0,0,1,1,0.0%,30m
21469,1,Eeason,2393,0,0,1,1,0.0%,1h
21469,2,战神,2393,0,0,1,1,0.0%,1h
21469,1,闹闹爱你,2393,0,0,2,2,0.0%,38m
21496,1,[我为何这么谐]流星丿半醉巴黎,2392,200,17,4,21,81.0%,45m
21496,1,microSHlT,2392,502,15,21,36,41.7%,1h
21496,1,没名,2392,337,14,8,22,63.6%,1h
21496,1,我叼尼玛的名,2392,169,11,6,17,64.7%,1h
21496,3,FAFAFA,2392,203,9,15,24,37.5%,1h
21496,1,jokepolk,2392,145,3,4,7,42.9%,37m
21496,1,神仙树下抚琴人,2392,94,3,6,9,33.3%,14m
21496,1,杀戮天使灬彦,2392,40,2,0,2,100.0%,1h
21496,1,龙之晨曦,2392,82,2,5,7,28.6%,38m
21496,3,一只小思子,2392,0,2,6,8,25.0%,9m
21496,3,[浙大战队]德玛西亚,2392,97,1,2,3,33.3%,1h
21496,2,Vince,2392,0,1,4,5,20.0%,25m
21496,1,silmy,2392,0,0,1,1,0.0%,1h
21496,3,zhangge,2392,0,0,1,1,0.0%,1h
21496,1,[天国力学]NTZWDX,2392,0,0,2,2,0.0%,38m
21511,3,zimba,2391,473,29,19,48,60.4%,7m
21511,1,酱油酱,2391,629,21,16,37,56.8%,23m
21511,3,自在轻狂,2391,287,17,18,35,48.6%,1h
21511,1,mfq,2391,327,11,4,15,73.3%,8m
21511,1,longwang,2391,344,10,10,20,50.0%,1h
21511,1,[XXHZ32]通通顺顺,2391,210,7,6,13,53.8%,2m
21511,3,被小学生殴打一号,2391,212,7,10,17,41.2%,21m
21511,3,三是也,2391,215,6,9,15,40.0%,1h
21511,1,[1萌新大军1]希绪费斯,2391,122,4,3,7,57.1%,1h
21511,3,[北有吾王3队]葬仙,2391,86,4,8,12,33.3%,1h
21511,3,IIIIIIIIIIII,2391,62,3,3,6,50.0%,20m
21511,1,[i5]Bigbee,2391,40,2,2,4,50.0%,2m
21511,1,NickZGN,2391,48,2,2,4,50.0%,44m
21511,1,[蓝色小锤]Boomerang,2391,96,2,5,7,28.6%,1h
21511,3,Ricky,2391,30,2,5,7,28.6%,9m
21511,1,海沙之尾,2391,0,1,0,1,100.0%,1h
21511,1,[FMY]座山雕,2391,0,1,0,1,100.0%,38m
21511,3,Zing,2391,0,1,2,3,33.3%,8m
21511,2,[玖天揽玥]卧槽,2391,0,1,3,4,25.0%,25m
21511,1,sukara,2391,0,0,2,2,0.0%,1h
21531,1,[JAXOLA]REJAX,2390,1688,95,79,174,54.6%,23m
21531,3,Goooo,2390,1565,79,82,161,49.1%,1h
21531,1,[XXHZ1]留下遗产,2390,512,16,13,29,55.2%,41m
21531,3,Musketeer,2390,469,16,19,35,45.7%,1h
21531,1,xqh,2390,463,15,9,24,62.5%,2m
21531,2,[DDOS浪漫]ForGG,2390,293,13,19,32,40.6%,4m
21531,3,夜雨蔚蓝,2390,341,12,13,25,48.0%,1h
21531,1,[菜有菜的道理]关关超爱,2390,194,11,7,18,61.1%,1h
21531,1,[YM]SprinG,2390,272,8,7,15,53.3%,38m
21531,2,kimo,2390,161,8,9,17,47.1%,51m
21531,1,[热能]我是桦桦坨哟,2390,244,7,8,15,46.7%,1h
21531,3,打死不投降,2390,217,6,5,11,54.5%,1h
21531,2,[花田纵火犯]hxd,2390,228,6,11,17,35.3%,1h
21531,1,风在指间,2390,188,5,3,8,62.5%,11m
21531,3,奀萝莉控奀,2390,148,5,7,12,41.7%,23m
21531,1,丿小石頭灬靖,2390,240,5,8,13,38.5%,1h
21531,1,今夕何夕,2390,108,4,2,6,66.7%,2m
21531,1,杨蛤蜊,2390,141,4,4,8,50.0%,20m
21531,1,SeanHsiung,2390,78,3,2,5,60.0%,24m
21531,1,lzx,2390,124,3,3,6,50.0%,1h
21531,1,[菜鸡球带]DSASDADA,2390,42,2,3,5,40.0%,38m
21531,1,吃喝拉撒打埃蒙,2390,71,2,3,5,40.0%,44m
21531,2,最强手残玩家,2390,0,1,0,1,100.0%,1h
21531,1,最后的希望,2390,0,1,0,1,100.0%,1h
21531,1,[爱国]炮灰,2390,96,1,1,2,50.0%,41m
21531,1,奶茶香芋,2390,40,1,4,5,20.0%,24m
21531,2,vinyl,2390,0,1,4,5,20.0%,37m
21558,3,会幻想的树,2389,1208,192,191,383,50.1%,21m
21558,2,gLs,2389,1421,185,193,378,48.9%,1h
21558,3,郭小斧,2389,1480,142,140,282,50.4%,28m
21558,1,知白守黑,2389,1535,99,92,191,51.8%,1h
21558,3,老仙奶我人生不顺,2389,506,18,18,36,50.0%,1h
21558,1,知足常乐贴近生活,2389,450,15,21,36,41.7%,23m
21558,1,QUTI,2389,289,13,1,14,92.9%,1h
21558,1,LJF,2389,261,8,5,13,61.5%,8m
21558,3,[肆季]斯卡洛尔,2389,225,8,7,15,53.3%,46m
21558,3,函然如怡,2389,114,5,12,17,29.4%,29m
21558,3,[斯大林保卫战]指挥官战刃,2389,122,4,10,14,28.6%,15m
21558,1,hhhhhhhhhhhh,2389,97,3,5,8,37.5%,1h
21558,1,[武道专家]遥遥無期,2389,80,2,3,5,40.0%,6m
21558,1,Logan,2389,0,2,4,6,33.3%,60m
21558,1,是希儿不是希尔,2389,0,1,1,2,50.0%,1h
21558,2,阿帕奇,2389,0,1,4,5,20.0%,1h
21558,1,MrPrincess,2389,0,0,1,1,0.0%,24m
21558,1,疯狂铁憨憨,2389,0,0,1,1,0.0%,37m
21576,2,串烧飞剑,2388,1485,138,140,278,49.6%,19m
21576,3,楉忆生,2388,1242,48,47,95,50.5%,27m
21576,2,[DDOS传奇]快乐菜鸟,2388,1108,39,50,89,43.8%,20m
21576,3,Magicterran,2388,485,18,23,41,43.9%,10m
21576,3,BQJIq,2388,251,13,14,27,48.1%,1h
21576,1,兵主,2388,309,9,5,14,64.3%,20m
21576,3,月夜见,2388,274,8,6,14,57.1%,1h
21576,1,[20CM]HFserral,2388,212,6,2,8,75.0%,1h
21576,1,电酱,2388,160,5,2,7,71.4%,38m
21576,1,塞拉菲姆,2388,108,4,1,5,80.0%,34m
21576,1,流年易素心,2388,36,3,4,7,42.9%,41m
21576,1,IIIIII,2388,131,3,5,8,37.5%,1h
21576,3,苗木诚,2388,149,3,7,10,30.0%,1h
21576,1,[脑虫执政官]SLRaven,2388,48,2,1,3,66.7%,10m
21576,1,[兆景埋土大学]HotDog,2388,0,1,0,1,100.0%,24m
21576,1,[Iam鶸]塔达林高阶坚果,2388,40,1,1,2,50.0%,1h
21576,2,冕神,2388,0,1,4,5,20.0%,51m
21576,1,云太白,2388,42,1,5,6,16.7%,1h
21576,3,意大利炮,2388,30,1,6,7,14.3%,22m
21576,3,Fun,2388,0,0,1,1,0.0%,1h
21576,1,留意,2388,0,0,1,1,0.0%,1h
21576,1,赵龟孙,2388,0,0,1,1,0.0%,52m
21598,3,[JFW]骑乘位,2387,1078,99,106,205,48.3%,17m
21598,1,Nirvana,2387,693,23,26,49,46.9%,6m
21598,2,[想日扎加拉]啊哈我是新手,2387,294,10,8,18,55.6%,35m
21598,3,THooo,2387,195,7,9,16,43.8%,1h
21598,3,[新的蜜蜂]辛二公威,2387,58,4,8,12,33.3%,36m
21598,1,亿往夕,2387,130,3,3,6,50.0%,38m
21598,2,lang,2387,0,3,3,6,50.0%,15m
21598,2,Alan,2387,118,3,4,7,42.9%,1h
21598,1,单手捏西瓜,2387,58,3,5,8,37.5%,1h
21598,3,圈住那个斯巴达,2387,121,2,4,6,33.3%,1h
21598,1,紫极冰恋,2387,0,1,0,1,100.0%,11m
21598,1,哈巴龟给爷爬,2387,0,1,0,1,100.0%,20m
21598,1,橘猫,2387,40,1,2,3,33.3%,9m
21598,1,拉啊啦啦啦啦,2387,0,0,1,1,0.0%,1h
21598,1,咕咕鸮,2387,0,0,1,1,0.0%,1h
21598,1,八奇传人,2387,0,0,1,1,0.0%,1h
21598,1,[OwenSS]凝云未散,2387,0,0,2,2,0.0%,1h
21598,1,zzddpat,2387,0,0,3,3,0.0%,24m
21616,1,神经不是病,2386,1393,51,40,91,56.0%,1h
21616,2,得得得得得得得,2386,934,32,42,74,43.2%,34m
21616,3,路过的酱油党,2386,688,29,28,57,50.9%,1h
21616,1,[极限菜鸟]战王,2386,748,27,17,44,61.4%,53m
21616,1,醉鬼炎,2386,518,15,13,28,53.6%,3m
21616,1,vovo,2386,398,14,7,21,66.7%,24m
21616,1,成都霸主,2386,448,13,10,23,56.5%,1h
21616,1,Night,2386,347,12,15,27,44.4%,34m
21616,3,爱鬼混,2386,270,11,18,29,37.9%,45m
21616,1,[龙王氵]弃辰,2386,359,10,7,17,58.8%,35m
21616,2,[Bishop]Adolph,2386,139,8,16,24,33.3%,4m
21616,1,[翼年代记]Vancleave,2386,208,7,6,13,53.8%,1h
21616,1,Coilrain,2386,212,6,6,12,50.0%,1h
21616,3,死亡灬弥漫,2386,171,6,7,13,46.2%,41m
21616,1,[望月]圣灵,2386,174,5,3,8,62.5%,34m
21616,1,[KK开]TianYa,2386,188,5,6,11,45.5%,44m
21616,1,Vakys,2386,48,3,5,8,37.5%,1h
21616,1,青悠子呤,2386,42,2,2,4,50.0%,1h
21616,1,郁金香,2386,44,2,3,5,40.0%,2m
21616,1,[辱主的都得死]耍帅的小啊天,2386,0,2,5,7,28.6%,14m
21616,2,南村群童扛把子,2386,0,1,1,2,50.0%,1h
21616,1,凌凡,2386,0,0,1,1,0.0%,19m
21616,2,切开闹,2386,0,0,3,3,0.0%,11m
21639,3,林中逍遥,2385,1535,123,125,248,49.6%,1h
21639,3,alohahong,2385,870,44,47,91,48.4%,17m
21639,1,Zero,2385,1133,39,40,79,49.4%,53m
21639,2,dvakxy,2385,971,36,42,78,46.2%,1h
21639,3,TLforeverYY,2385,336,14,21,35,40.0%,1h
21639,3,kiro,2385,352,12,20,32,37.5%,1h
21639,1,白鸯,2385,266,8,5,13,61.5%,1h
21639,3,不会玩,2385,132,7,10,17,41.2%,7m
21639,1,稻教始祖,2385,236,5,9,14,35.7%,41m
21639,1,[星际飙车王]御史神风,2385,82,3,2,5,60.0%,1h
21639,3,精致绽蓝,2385,0,2,6,8,25.0%,1h
21639,1,leifeng,2385,0,1,1,2,50.0%,40m
21639,3,stdooc,2385,0,1,2,3,33.3%,15m
21639,2,嫩么气质,2385,0,1,2,3,33.3%,55m
21639,1,也无风雨也无晴,2385,0,1,3,4,25.0%,1h
21639,3,UtahaSaber,2385,0,1,3,4,25.0%,8m
21639,2,啊吖,2385,0,1,4,5,20.0%,53m
21639,1,三局为限,2385,0,0,1,1,0.0%,1h
21639,1,ALLEN,2385,0,0,5,5,0.0%,8m
21639,1,爱得痛了,2385,0,0,8,8,0.0%,24m
21659,3,OSlaozhao,2384,1453,70,67,137,51.1%,1h
21659,1,[菜有菜的道理]dibao,2384,1170,42,41,83,50.6%,53m
21659,1,棋子,2384,652,26,28,54,48.1%,1h
21659,1,[快星际乐]Taburiss,2384,625,19,23,42,45.2%,1h
21659,1,铭睇似,2384,427,16,19,35,45.7%,1h
21659,3,就是艾斯特了,2384,378,14,15,29,48.3%,1h
21659,1,David,2384,353,11,16,27,40.7%,1h
21659,1,zbw,2384,273,8,3,11,72.7%,5m
21659,2,Adele,2384,170,5,5,10,50.0%,1h
21659,3,[青铜大宗]Alpha,2384,174,5,14,19,26.3%,1h
21659,3,巴黎野玫瑰,2384,98,4,9,13,30.8%,9m
21659,1,滑稽使者,2384,119,3,6,9,33.3%,1h
21659,3,angel,2384,30,3,7,10,30.0%,1h
21659,3,奈亚拉托提普,2384,97,2,0,2,100.0%,1h
21659,1,虫朱执信,2384,38,2,2,4,50.0%,20m
21659,1,我还活着,2384,40,2,2,4,50.0%,38m
21659,1,Satellite,2384,0,1,1,2,50.0%,55m
21659,2,[开心最重要嘛]嘀嘟,2384,0,1,2,3,33.3%,22m
21659,3,Satellite,2384,36,1,4,5,20.0%,55m
21659,2,木叶的柱间,2384,0,1,4,5,20.0%,1h
21659,2,jinkela,2384,0,1,4,5,20.0%,16m
21659,1,[百年好合]爱星际,2384,0,0,4,4,0.0%,26m
21681,1,cyqc,2383,1034,48,35,83,57.8%,1h
21681,3,MAAAAAAAN,2383,1074,44,46,90,48.9%,1h
21681,1,[崔之公司超市]崔之,2383,1038,40,28,68,58.8%,46m
21681,1,从头再来,2383,997,39,30,69,56.5%,23m
21681,2,[极限菜鸟]onlooker,2383,680,39,41,80,48.8%,37m
21681,3,[第六護衛艦]護衛艦隊總督,2383,647,23,29,52,44.2%,38m
21681,1,孤独的假面,2383,448,19,16,35,54.3%,1h
21681,1,[在下菜鸡一只]大叔,2383,453,16,10,26,61.5%,34m
21681,2,可是雨天,2383,292,12,10,22,54.5%,1h
21681,1,菜鸟,2383,323,12,13,25,48.0%,55m
21681,1,[NEAU]满眼星辰只为见你,2383,233,9,4,13,69.2%,24m
21681,1,[艾尔之名]IIIIIIIIIIII,2383,275,8,6,14,57.1%,1h
21681,3,目田,2383,195,7,10,17,41.2%,1h
21681,1,poisonkiss,2383,205,6,6,12,50.0%,26m
21681,2,[瓦伦]修之,2383,130,4,11,15,26.7%,4m
21681,1,清华浮梦,2383,94,3,7,10,30.0%,1h
21681,1,九个草莓,2383,0,0,1,1,0.0%,1h
21698,2,风险投资公司,2382,1515,425,440,865,49.1%,49m
21698,1,zero,2382,1766,120,116,236,50.8%,1h
21698,3,SKYss,2382,1230,82,76,158,51.9%,1h
21698,1,黄礼智粉丝,2382,1400,57,45,102,55.9%,13m
21698,1,戈尔巴乔夫,2382,758,29,32,61,47.5%,1h
21698,1,一行瑠璃,2382,762,26,26,52,50.0%,1h
21698,3,Fate,2382,527,23,22,45,51.1%,1h
21698,1,老吴,2382,354,11,12,23,47.8%,1h
21698,3,念你初心不负,2382,309,11,15,26,42.3%,46m
21698,3,菜鸟,2382,266,9,6,15,60.0%,7m
21698,3,山坡上的牛,2382,92,5,9,14,35.7%,7m
21698,1,李咏浩,2382,135,4,2,6,66.7%,1h
21698,1,兰色祈祷,2382,190,4,5,9,44.4%,1h
21698,1,同学,2382,96,4,7,11,36.4%,15m
21698,1,[OwenSS]站在马路上,2382,123,3,0,3,100.0%,1h
21698,1,[在途的聚变打]我今天想生气,2382,118,3,3,6,50.0%,1h
21698,1,丿三年丶起步,2382,0,2,4,6,33.3%,1h
21698,1,Jormungandr,2382,0,1,0,1,100.0%,41m
21698,1,星灵,2382,0,1,0,1,100.0%,1h
21698,1,lvsanjaer,2382,0,1,1,2,50.0%,13m
21698,1,[暴雪十七队]丢蜗牛的白鼠,2382,42,1,2,3,33.3%,1h
21698,1,[XXHZ33]榫卯结构的大和,2382,35,1,2,3,33.3%,44m
21698,1,[刺蛇互助社团]辘轳的路芦,2382,36,1,3,4,25.0%,23m
21698,2,[菜花花]兴奋的西红柿,2382,0,1,4,5,20.0%,32m
21698,2,talorswift,2382,0,0,1,1,0.0%,52m
21698,1,星辰大海,2382,0,0,3,3,0.0%,16m
21724,1,blackjack,2381,1770,86,90,176,48.9%,52m
21724,3,asdcvzxgtjy,2381,647,76,81,157,48.4%,52m
21724,1,二五仔,2381,994,32,32,64,50.0%,38m
21724,1,[KK开]tonight,2381,720,25,23,48,52.1%,2m
21724,3,[沙星部]Star,2381,511,20,25,45,44.4%,1h
21724,1,雪姬,2381,222,16,9,25,64.0%,45m
21724,3,fanys,2381,490,15,23,38,39.5%,1h
21724,3,尼古拉杰克,2381,356,12,20,32,37.5%,1h
21724,2,[龙背上的骑兵]erhsen,2381,267,10,12,22,45.5%,1h
21724,3,一如既往,2381,258,9,12,21,42.9%,1h
21724,3,子弹上膛,2381,170,5,9,14,35.7%,1h
21724,2,阿里来打星,2381,0,4,1,5,80.0%,54m
21724,1,风画清颜,2381,156,4,6,10,40.0%,1h
21724,3,WUXI,2381,60,3,2,5,60.0%,1h
21724,1,悄悄的,2381,126,3,6,9,33.3%,34m
21724,1,UMR,2381,95,2,5,7,28.6%,1h
21724,1,[秒灬表]中原,2381,0,1,0,1,100.0%,20m
21724,2,[五色丿战队]Halo,2381,0,1,4,5,20.0%,1h
21724,1,[66668]逆光,2381,0,0,1,1,0.0%,1h
21724,1,镂空之眼,2381,0,0,1,1,0.0%,1h
21724,1,xiaofeng,2381,0,0,2,2,0.0%,1h
21724,1,[三玖第一]花落凡间,2381,0,0,2,2,0.0%,23m
21724,1,LBJ,2381,0,0,2,2,0.0%,1h
21724,1,[91秦先生]哎呦卧槽,2381,0,0,3,3,0.0%,1h
21748,3,[西安交通大学]fungi,2380,1025,40,42,82,48.8%,17m
21748,1,MagicX,2380,676,29,27,56,51.8%,1h
21748,1,YZY,2380,641,18,16,34,52.9%,1h
21748,1,[三族同萌会]MonsTeR,2380,320,9,5,14,64.3%,46m
21748,1,夏日的木府风云,2380,296,8,5,13,61.5%,35m
21748,1,OMO,2380,238,6,8,14,42.9%,1h
21748,1,山河妄入梦,2380,154,5,2,7,71.4%,1h
21748,1,老男孩,2380,136,4,3,7,57.1%,20m
21748,1,soap,2380,155,4,7,11,36.4%,60m
21748,1,Trialed,2380,78,3,1,4,75.0%,1h
21748,1,fredning,2380,110,3,3,6,50.0%,11m
21748,1,XLZERO,2380,137,3,3,6,50.0%,1h
21748,1,白日星辰,2380,40,2,3,5,40.0%,44m
21748,1,Mitheril,2380,97,2,5,7,28.6%,37m
21748,1,InPieces,2380,48,2,6,8,25.0%,1h
21748,1,[绝不白给]司离,2380,0,1,0,1,100.0%,1h
21748,1,[GG准备就绪]ForMoney,2380,0,0,1,1,0.0%,34m
21748,1,Wlchforever,2380,0,0,1,1,0.0%,1h
21748,1,因此,2380,0,0,1,1,0.0%,1h
21748,1,[青莲剑阁]召南,2380,0,0,3,3,0.0%,38m
21768,3,[visher]segarp,2379,861,51,48,99,51.5%,29m
21768,1,皮皮费尸,2379,310,35,8,43,81.4%,23m
21768,1,[AF]Qily,2379,697,27,27,54,50.0%,23m
21768,1,wpf,2379,534,18,17,35,51.4%,24m
21768,1,SCPLAYER,2379,440,14,11,25,56.0%,30m
21768,1,[社交学大可爱]伊卡洛斯,2379,418,14,15,29,48.3%,1h
21768,1,[弑神]汤姆不是猫,2379,238,7,8,15,46.7%,1h
21768,2,乐凡,2379,92,6,1,7,85.7%,55m
21768,1,虫虫争爹,2379,236,6,3,9,66.7%,52m
21768,1,逛窑者,2379,145,3,6,9,33.3%,1h
21768,1,吃货,2379,38,2,3,5,40.0%,13m
21768,3,唐小宝,2379,38,2,4,6,33.3%,20m
21768,1,wznddb,2379,89,2,4,6,33.3%,8m
21768,2,乌瑟尔,2379,0,1,0,1,100.0%,1h
21768,2,MeleeCreeps,2379,0,1,4,5,20.0%,59m
21768,2,红豆稀饭,2379,0,1,5,6,16.7%,4m
21768,2,Morathi,2379,0,1,6,7,14.3%,1h
21768,1,asuerhao,2379,0,0,1,1,0.0%,8m
21768,1,爆裂独眼脓,2379,0,0,1,1,0.0%,21m
21768,1,[荒芜岁月]青田九爷,2379,0,0,2,2,0.0%,44m
21768,1,Spike,2379,0,0,2,2,0.0%,38m
21768,1,愤怒的小鸡,2379,0,0,2,2,0.0%,1h
21768,1,[100T7]CCJOY,2379,0,0,3,3,0.0%,1h
21791,2,斜风,2378,1512,291,300,591,49.2%,20m
21791,2,mmp,2378,1489,235,245,480,49.0%,37m
21791,2,飙风王子,2378,1212,128,114,242,52.9%,1h
21791,3,LBJ,2378,1536,86,90,176,48.9%,28m
21791,1,sakura,2378,917,55,44,99,55.6%,1h
21791,1,[DMRe]FLASH,2378,355,20,12,32,62.5%,38m
21791,3,工蜂,2378,272,9,12,21,42.9%,53m
21791,3,[为了地球]永恒烈火,2378,182,6,12,18,33.3%,1h
21791,1,丶冰丨,2378,144,5,5,10,50.0%,44m
21791,1,[美国黑人的命]白银之鹰,2378,78,2,3,5,40.0%,1h
21791,2,Eurus,2378,46,2,4,6,33.3%,15m
21791,1,overdose,2378,0,2,4,6,33.3%,41m
21791,1,正义黎明,2378,0,1,0,1,100.0%,35m
21791,1,三鹿比,2378,0,1,0,1,100.0%,1h
21791,2,海纳百川,2378,0,1,2,3,33.3%,15m
21791,2,无尽战意,2378,0,1,4,5,20.0%,52m
21791,2,[X英雄圣域X]TIM,2378,0,1,4,5,20.0%,1h
21791,2,satam,2378,0,0,1,1,0.0%,1h
21809,1,WCCD,2377,1142,86,90,176,48.9%,1h
21809,1,吃猫鼠,2377,601,38,34,72,52.8%,1h
21809,1,[DMR]亚里士没有德,2377,901,36,23,59,61.0%,23m
21809,2,xingxinghi,2377,394,13,23,36,36.1%,37m
21809,1,[老班干]螽斯,2377,370,10,11,21,47.6%,1h
21809,3,protoss,2377,267,9,12,21,42.9%,38m
21809,2,Badwoman,2377,187,7,10,17,41.2%,10m
21809,1,[爆杀]紫荆茶天,2377,168,5,4,9,55.6%,41m
21809,1,BiBo,2377,88,3,1,4,75.0%,1h
21809,1,min,2377,96,3,1,4,75.0%,7m
21809,1,银河系坏叔叔,2377,98,3,2,5,60.0%,8m
21809,1,GHNUT,2377,84,2,5,7,28.6%,5m
21809,3,天下无敌可爱,2377,0,2,6,8,25.0%,27m
21809,1,帅赢天下,2377,84,2,7,9,22.2%,2m
21809,1,llllllllll,2377,0,1,2,3,33.3%,1h
21809,2,Kano,2377,0,1,4,5,20.0%,1h
21809,1,[反恐战士]勿忘勿念勿想,2377,0,0,1,1,0.0%,1h
21809,1,佐佐木绯叶,2377,0,0,1,1,0.0%,1h
21809,1,[太阳]潇潇雨歇灬抬望眼,2377,0,0,2,2,0.0%,34m
21809,1,包谷米米,2377,0,0,3,3,0.0%,2m
21829,3,狐狸渔鸥,2376,1421,191,188,379,50.4%,1h
21829,1,DarkHunter,2376,1104,40,37,77,51.9%,1h
21829,1,九帝他还在,2376,904,27,30,57,47.4%,1h
21829,3,至尊黑铁,2376,380,15,20,35,42.9%,1h
21829,1,[秋毫]谪仙,2376,222,8,1,9,88.9%,34m
21829,1,[Vco]FLF,2376,235,5,8,13,38.5%,21m
21829,3,xianren,2376,177,5,12,17,29.4%,1h
21829,1,小杨,2376,217,4,8,12,33.3%,41m
21829,1,hgdahs,2376,0,1,1,2,50.0%,38m
21829,1,lhlaahf,2376,48,1,2,3,33.3%,1h
21829,1,菜鸟菌,2376,0,0,2,2,0.0%,1h
21829,2,MonsterXo,2376,0,0,3,3,0.0%,25m
21841,1,[老头星际]GGBreaker,2375,731,34,16,50,68.0%,46m
21841,1,nick,2375,798,28,20,48,58.3%,1h
21841,1,日泥马暴雪退钱,2375,556,17,18,35,48.6%,40m
21841,1,[优酱真可爱]优克莉伍德,2375,324,9,10,19,47.4%,40m
21841,1,勇敢地开拓着,2375,135,6,7,13,46.2%,38m
21841,3,被强煎的蛋,2375,148,5,8,13,38.5%,31m
21841,1,[小菜逼]烧玻璃爱好者,2375,97,2,6,8,25.0%,1h
21841,1,孙灬东民,2375,40,1,1,2,50.0%,34m
21849,1,Silence,2374,1354,119,125,244,48.8%,1h
21849,1,LiquidClem,2374,1483,74,79,153,48.4%,50m
21849,3,[魂祀]清风,2374,434,15,20,35,42.9%,1h
21849,1,陌上冬暖,2374,238,5,5,10,50.0%,49m
21849,3,皇恪,2374,160,5,7,12,41.7%,22m
21849,3,孤胆剑客,2374,146,5,8,13,38.5%,1h
21849,1,[萌佬同好会]杼寒丶,2374,184,4,3,7,57.1%,1h
21849,3,乱把白云碾碎,2374,60,4,9,13,30.8%,1h
21849,3,[GCT]cooooooool,2374,123,3,2,5,60.0%,1h
21849,1,[WT]sPark,2374,80,3,3,6,50.0%,34m
21849,2,兄弟你苞皮掉了,2374,111,3,5,8,37.5%,18m
21849,1,ydchenyj,2374,42,2,1,3,66.7%,45m
21849,1,和山门过日子,2374,0,1,0,1,100.0%,1h
21849,1,nihenqiang,2374,0,1,0,1,100.0%,38m
21849,1,长廊,2374,48,1,1,2,50.0%,1h
21849,1,[马保国]实验狗招专用号,2374,0,0,1,1,0.0%,38m
21849,1,兔百万和汤圆,2374,0,0,1,1,0.0%,34m
21849,1,圣骑士,2374,0,0,2,2,0.0%,1h
21849,1,luobowen,2374,0,0,2,2,0.0%,2m
21868,3,[星际爱好者队]无敌芊宝,2373,1455,320,323,643,49.8%,9m
21868,1,至尊玉,2373,374,19,20,39,48.7%,1h
21868,3,燕笑语兮,2373,506,18,20,38,47.4%,7m
21868,1,Ling,2373,377,14,8,22,63.6%,8m
21868,3,THOOO,2373,304,13,6,19,68.4%,20m
21868,1,Clement,2373,355,9,17,26,34.6%,53m
21868,1,IIIIIIIIIIII,2373,210,6,8,14,42.9%,1h
21868,1,[東佰往事]泛希腊太守,2373,234,6,9,15,40.0%,23m
21868,3,[老年之家]欧青辣少,2373,178,6,10,16,37.5%,1h
21868,1,[温柔兔公主]虎皮猫猫,2373,233,5,6,11,45.5%,20m
21868,3,[嘤嘤嘤呜呜]IIIIIIIIIIII,2373,174,5,10,15,33.3%,1h
21868,2,青春无敌楼蛋蛋,2373,130,5,10,15,33.3%,1h
21868,1,Myth,2373,83,4,7,11,36.4%,1h
21868,1,[GDG]asjfajwafjf,2373,82,3,5,8,37.5%,1h
21868,1,玉衡,2373,0,1,0,1,100.0%,3m
21868,3,蛤蟆怪,2373,0,1,0,1,100.0%,51m
21868,1,龙在渊,2373,40,1,1,2,50.0%,38m
21868,1,wire,2373,0,1,3,4,25.0%,44m
21868,2,域外神,2373,0,0,1,1,0.0%,1h
21887,1,诺尔维斯,2372,875,111,122,233,47.6%,48m
21887,2,raven,2372,1350,104,102,206,50.5%,1h
21887,3,蒜这小子后劲大,2372,1271,82,73,155,52.9%,47m
21887,1,[秋毫]军火,2372,1730,59,62,121,48.8%,41m
21887,3,innovation,2372,689,47,44,91,51.6%,20m
21887,1,Blacksheep,2372,775,40,22,62,64.5%,11m
21887,1,嗯嗯嗯呢,2372,1119,39,37,76,51.3%,1h
21887,1,[无魂之鸭]齐峰大帅比,2372,926,37,36,73,50.7%,13m
21887,3,星际,2372,410,33,37,70,47.1%,21m
21887,2,[祝你们好运]森下下士,2372,942,33,42,75,44.0%,59m
21887,3,抢救虫洞,2372,833,32,35,67,47.8%,1h
21887,2,收到货不么无人,2372,630,28,42,70,40.0%,1h
21887,1,绝园的暴风雨,2372,452,21,20,41,51.2%,1h
21887,1,嬲嬲袅袅汝水,2372,621,19,25,44,43.2%,1h
21887,1,[佳宏]bseryseuysrn,2372,505,18,13,31,58.1%,6m
21887,1,不过一场少年梦,2372,306,8,8,16,50.0%,23m
21887,1,[化学工厂]小羊咩咩,2372,196,5,2,7,71.4%,2m
21887,3,暗影空间,2372,122,5,10,15,33.3%,21m
21887,1,节操战士,2372,118,4,4,8,50.0%,1h
21887,1,Feng,2372,156,4,5,9,44.4%,40m
21887,1,IIIIIIIIIII,2372,74,3,1,4,75.0%,1h
21887,2,[出兵大战萌新]hlyg,2372,88,2,1,3,66.7%,3m
21887,1,[谁在呼叫舰队]逼格之王,2372,40,2,1,3,66.7%,8m
21887,1,Architext,2372,42,2,1,3,66.7%,1h
21887,1,[DSE]浪里小白糖,2372,125,2,2,4,50.0%,1h
21887,1,[乌拉拉啦啦啦]四慌,2372,72,2,4,6,33.3%,34m
21887,1,言七丶,2372,97,2,6,8,25.0%,41m
21887,1,谁都五五开,2372,0,1,0,1,100.0%,2m
21887,2,裆中巨物,2372,0,1,2,3,33.3%,55m
21887,1,和弦,2372,0,0,1,1,0.0%,21m
21887,1,小豆芽,2372,0,0,3,3,0.0%,1h
21918,1,[鸡姆雷日天]大忽悠,2371,492,30,39,69,43.5%,32m
21918,1,Legend,2371,635,20,17,37,54.1%,38m
21918,2,潵馓馓鏾,2371,262,11,12,23,47.8%,22m
21918,1,Andres,2371,311,9,4,13,69.2%,1h
21918,3,提携玉龙为卿死,2371,216,6,2,8,75.0%,13m
21918,1,aini,2371,226,6,9,15,40.0%,1h
21918,1,星宇,2371,182,4,2,6,66.7%,1h
21918,3,魈待葬,2371,141,3,2,5,60.0%,1h
21918,3,谭谭,2371,97,2,1,3,66.7%,1h
21918,1,StormyWine,2371,76,2,2,4,50.0%,53m
21918,1,END,2371,103,2,3,5,40.0%,1h
21918,1,红尘炼心,2371,0,1,1,2,50.0%,40m
21918,1,OLDSHEEP,2371,97,1,2,3,33.3%,8m
21918,1,黯灭焰,2371,40,1,3,4,25.0%,45m
21918,1,谢大发明家,2371,105,1,4,5,20.0%,52m
21918,2,皇家侍卫,2371,0,1,4,5,20.0%,32m
21918,1,[TheUED]可鲁,2371,42,1,7,8,12.5%,19m
21918,1,世界太疯狂,2371,0,0,1,1,0.0%,14m
21918,1,[星辰大海无限]折纸的夜刀神十香,2371,0,0,1,1,0.0%,8m
21918,2,鬼冢,2371,0,0,5,5,0.0%,25m
21938,3,[DNF]IIIIIIIIIIII,2370,880,38,32,70,54.3%,1h
21938,2,[SS天羽]怀有兴趣,2370,878,31,43,74,41.9%,10m
21938,3,星辰的硝烟,2370,453,27,32,59,45.8%,29m
21938,1,可惜她把它当做他,2370,751,26,26,52,50.0%,2m
21938,1,koslk,2370,425,12,13,25,48.0%,5m
21938,2,倾卿,2370,247,10,7,17,58.8%,20m
21938,3,乾心,2370,276,10,22,32,31.2%,45m
21938,3,无敌小草,2370,218,9,9,18,50.0%,1h
21938,3,不讲武德,2370,167,5,8,13,38.5%,1h
21938,1,Moonlight,2370,126,4,2,6,66.7%,1h
21938,1,小忽悠,2370,124,4,3,7,57.1%,1h
21938,2,大头哥哥,2370,0,4,5,9,44.4%,1h
21938,2,[肝坏死]Kurumi,2370,0,3,3,6,50.0%,53m
21938,1,资深吃货,2370,144,3,7,10,30.0%,8m
21938,1,[铃兰男子高校]StarMalison,2370,130,2,1,3,66.7%,1h
21938,1,伤与劫,2370,92,2,3,5,40.0%,41m
21938,3,风云飞,2370,60,2,9,11,18.2%,1h
21938,1,YOYO,2370,0,1,0,1,100.0%,1h
21938,1,[CPT]法海老儿毁我童年,2370,42,1,2,3,33.3%,34m
21938,1,织梦猫,2370,0,1,2,3,33.3%,25m
21938,1,瓦伦里安,2370,0,0,2,2,0.0%,20m
21938,1,applefly,2370,0,0,3,3,0.0%,24m
21960,1,BONELADEN,2369,1706,66,66,132,50.0%,1h
21960,3,艾萨克,2369,961,54,56,110,49.1%,1h
21960,2,SmileMilo,2369,676,27,32,59,45.8%,1h
21960,1,我的脚下就是国门,2369,575,23,14,37,62.2%,45m
21960,1,致残打击,2369,538,21,13,34,61.8%,1h
21960,3,Ricardo,2369,453,16,20,36,44.4%,20m
21960,3,[大佬别打我]noone,2369,268,10,16,26,38.5%,1h
21960,3,临冬城指挥官,2369,221,8,8,16,50.0%,8m
21960,3,Bomd,2369,143,8,14,22,36.4%,1h
21960,1,电脑,2369,231,7,2,9,77.8%,24m
21960,3,我们中出了神,2369,155,6,8,14,42.9%,52m
21960,1,光暗之墓,2369,154,5,1,6,83.3%,5m
21960,1,风中人,2369,156,5,3,8,62.5%,1h
21960,2,铁头,2369,93,5,6,11,45.5%,1h
21960,3,杉先生,2369,121,2,1,3,66.7%,52m
21960,1,厂狗叶,2369,0,1,0,1,100.0%,41m
21960,1,茅野爱衣,2369,0,1,0,1,100.0%,1h
21960,1,兔子斯比德,2369,0,1,0,1,100.0%,1h
21960,1,[玄門]Chins,2369,48,1,2,3,33.3%,1h
21960,1,东北偏北,2369,42,1,4,5,20.0%,14m
21960,2,PPan,2369,0,1,4,5,20.0%,25m
21960,3,Valhalla,2369,0,0,1,1,0.0%,52m
21960,1,炸鱼,2369,0,0,1,1,0.0%,25m
21960,1,Wonder,2369,0,0,3,3,0.0%,1h
21984,3,sssa,2368,1304,86,82,168,51.2%,1h
21984,1,萨博,2368,1529,78,77,155,50.3%,48m
21984,2,wwwwwwwwwwww,2368,952,34,40,74,45.9%,37m
21984,1,红鼻子小黑,2368,857,32,28,60,53.3%,45m
21984,3,[HUC前衛]Timothy,2368,441,17,28,45,37.8%,1h
21984,1,RMonster,2368,370,12,18,30,40.0%,53m
21984,1,jijighotert,2368,215,7,5,12,58.3%,1h
21984,1,芝麻通鉴,2368,0,3,2,5,60.0%,55m
21984,1,ootttoo,2368,116,3,4,7,42.9%,13m
21984,1,[传说萌娘团]人生何处不青山,2368,144,3,10,13,23.1%,11m
21984,2,碾碎星辰,2368,0,1,4,5,20.0%,11m
21984,2,Joker,2368,0,1,4,5,20.0%,1h
21984,1,[异度黑核侵蚀]luoluo,2368,0,0,1,1,0.0%,1h
21984,1,[秀气男孩]炮炮打在菌毯上,2368,0,0,1,1,0.0%,1h
21984,2,OnCountDown,2368,0,0,2,2,0.0%,26m
21984,1,炎日当空,2368,0,0,3,3,0.0%,45m
22000,3,[6G芯片研發]TonyStark,2367,1574,145,136,281,51.6%,1h
22000,1,猥琐表被动,2367,806,28,27,55,50.9%,38m
22000,3,一念无量劫,2367,511,22,27,49,44.9%,52m
22000,1,GIAO,2367,532,20,15,35,57.1%,14m
22000,1,骷髅乞丐,2367,328,10,10,20,50.0%,1h
22000,1,GreenXN,2367,312,8,10,18,44.4%,6m
22000,1,豆子能吃,2367,210,7,4,11,63.6%,1h
22000,1,[EP]eric,2367,245,6,4,10,60.0%,1h
22000,1,[丨F2A丨]捣蛋亲王,2367,210,5,3,8,62.5%,10m
22000,3,[生吃个人]天下第一逗,2367,143,4,5,9,44.4%,1h
22000,3,[社交学超可爱]夕灬年,2367,70,4,9,13,30.8%,1h
22000,1,tangmen,2367,48,2,0,2,100.0%,1h
22000,1,达斯乐高,2367,48,2,6,8,25.0%,1h
22000,1,樱高三年二班,2367,0,1,2,3,33.3%,52m
22000,3,sponsor,2367,0,1,2,3,33.3%,7m
22000,2,星星飞啊飞,2367,0,1,4,5,20.0%,26m
22000,2,乌合之众,2367,0,1,4,5,20.0%,32m
22000,1,HotDog,2367,0,0,1,1,0.0%,1h
22000,1,苍白,2367,0,0,1,1,0.0%,20m
22000,2,[瘾大眼瞎]桐予,2367,0,0,2,2,0.0%,33m
22020,2,阿斯顿,2366,1008,180,186,366,49.2%,1h
22020,3,[极限菜鸟]云游散人,2366,1107,130,123,253,51.4%,21m
22020,1,kubehui,2366,472,124,141,265,46.8%,37m
22020,2,minamoto,2366,1088,42,50,92,45.7%,13m
22020,1,猩鸡争霸,2366,1010,39,38,77,50.6%,1h
22020,1,[断后中队]叶戈尔,2366,1044,35,42,77,45.5%,51m
22020,1,AICE,2366,892,30,26,56,53.6%,23m
22020,2,倒走,2366,75,23,26,49,46.9%,4m
22020,3,[没了呀]我躺这行吗,2366,593,21,23,44,47.7%,31m
22020,1,沐浴龙血,2366,536,19,29,48,39.6%,1h
22020,1,希多,2366,367,13,8,21,61.9%,1h
22020,3,那里不可以吖,2366,210,13,16,29,44.8%,45m
22020,1,冰冻菠萝油,2366,326,9,12,21,42.9%,52m
22020,1,[最菜战队]Eugene,2366,144,6,7,13,46.2%,1h
22020,1,ViSmith,2366,136,4,0,4,100.0%,8m
22020,1,ParTing,2366,38,2,2,4,50.0%,8m
22020,2,微微一笑辣眼睛,2366,0,1,4,5,20.0%,15m
22020,1,泽迪,2366,0,1,5,6,16.7%,10m
22020,1,huang,2366,0,0,1,1,0.0%,34m
22020,1,dsz,2366,0,0,1,1,0.0%,1h
22040,1,小小黎,2365,406,61,61,122,50.0%,52m
22040,3,蔡假仙,2365,1239,52,50,102,51.0%,1h
22040,1,布洛瓦,2365,1101,47,43,90,52.2%,52m
22040,1,sjwolf,2365,775,23,22,45,51.1%,3m
22040,1,valian,2365,367,15,9,24,62.5%,23m
22040,1,末日杀神,2365,444,11,19,30,36.7%,38m
22040,1,[GCT]Windness,2365,252,8,9,17,47.1%,1h
22040,3,innovationss,2365,146,5,13,18,27.8%,32m
22040,3,名字叫爱,2365,127,5,13,18,27.8%,11m
22040,1,吴某某,2365,82,3,4,7,42.9%,45m
22040,1,[乱世]afsfa,2365,119,3,6,9,33.3%,41m
22040,3,[24CM]Ves,2365,32,2,0,2,100.0%,1h
22040,2,Lky,2365,0,2,4,6,33.3%,1h
22040,3,[念羽]墙头草,2365,0,1,0,1,100.0%,1h
22040,2,真相,2365,0,1,1,2,50.0%,29m
22040,2,宫水三叶,2365,0,1,1,2,50.0%,4m
22040,1,[GSC]剑破军,2365,0,1,2,3,33.3%,6m
22040,1,扎古仨,2365,0,0,1,1,0.0%,23m
22040,1,无情的采矿农民,2365,0,0,1,1,0.0%,15m
22040,1,战争,2365,0,0,1,1,0.0%,24m
22040,2,梦魇风神,2365,0,0,1,1,0.0%,36m
22040,1,aleeshan,2365,0,0,3,3,0.0%,20m
22062,2,手残小萌新,2364,1510,66,72,138,47.8%,40m
22062,3,网老腻,2364,1086,46,51,97,47.4%,7m
22062,1,哥用哥的菊花,2364,1079,41,31,72,56.9%,6m
22062,1,[贪得无厌]爱喝冰峰,2364,826,34,35,69,49.3%,1h
22062,1,[新手保护协会]IlluSioN,2364,570,22,13,35,62.9%,1h
22062,3,[蓝鲸何平]buai,2364,308,10,10,20,50.0%,1h
22062,1,卢大大,2364,153,9,10,19,47.4%,38m
22062,1,雷老师,2364,237,8,7,15,53.3%,52m
22062,1,[风趣幽默]IIInazuma,2364,192,6,13,19,31.6%,1h
22062,1,acdmusic,2364,185,5,9,14,35.7%,1h
22062,2,魔儿,2364,80,5,10,15,33.3%,1h
22062,1,烟乄舞,2364,131,4,1,5,80.0%,34m
22062,1,[极限菜鸟]杀破天,2364,0,2,5,7,28.6%,10m
22062,1,路明非,2364,0,1,0,1,100.0%,1h
22062,1,我是菜鸟啊啊啊啊,2364,0,1,2,3,33.3%,1h
22062,1,xjjxz,2364,0,1,5,6,16.7%,1h
22062,2,[尼玛还健在吗]艾尔法瑞斯,2364,0,0,1,1,0.0%,1h
22062,2,炎诀丷,2364,0,0,2,2,0.0%,11m
22080,1,菜的抠脚的系统,2363,1721,71,62,133,53.4%,1h
22080,3,马列的红茶,2363,1335,60,62,122,49.2%,45m
22080,1,高数干离散,2363,1176,41,54,95,43.2%,22m
22080,1,[20CM]雅琦小可耐丶,2363,588,20,20,40,50.0%,40m
22080,1,你的农民被屠了,2363,497,16,11,27,59.3%,24m
22080,1,千里走单骑,2363,505,15,11,26,57.7%,1h
22080,3,Andrick,2363,200,7,13,20,35.0%,1h
22080,3,ease,2363,202,6,5,11,54.5%,1h
22080,1,洛宸,2363,200,6,6,12,50.0%,1h
22080,3,北冥有牛,2363,188,6,9,15,40.0%,1h
22080,1,[48K纯帅]llllllllllll,2363,80,5,7,12,41.7%,1h
22080,1,[大毛无与伦比]二毛,2363,122,4,7,11,36.4%,1h
22080,1,igtheshy,2363,140,3,4,7,42.9%,1h
22080,1,[纸飞机的梦想]王你码命运共同体,2363,42,2,1,3,66.7%,45m
22080,3,djw,2363,0,2,6,8,25.0%,41m
22080,1,[我队伍很强大]Vad,2363,0,1,1,2,50.0%,21m
22080,2,[贤者也]贤者,2363,0,1,2,3,33.3%,25m
22080,3,欧曼娃醒的一路,2363,0,1,4,5,20.0%,1h
22080,2,漂流王,2363,0,1,4,5,20.0%,52m
22080,1,WangDF,2363,0,0,1,1,0.0%,20m
22080,1,厨房千夫长,2363,0,0,2,2,0.0%,8m
22080,1,ttyttty,2363,0,0,2,2,0.0%,1h
22102,1,[吼吼吼]sonny,2362,981,41,32,73,56.2%,1h
22102,1,无语了哈,2362,712,34,37,71,47.9%,8m
22102,3,[恶劣玩家]loyal,2362,194,13,22,35,37.1%,22m
22102,2,MrRen,2362,289,12,5,17,70.6%,16m
22102,3,韬略,2362,240,9,17,26,34.6%,1h
22102,1,开车撞丈母娘,2362,248,7,7,14,50.0%,26m
22102,1,NURAIL,2362,200,6,6,12,50.0%,1h
22102,1,[天地會分舵]风吹蛋蛋凉,2362,82,3,4,7,42.9%,24m
22102,1,小熊宝,2362,120,3,5,8,37.5%,1h
22102,1,雷刃,2362,48,2,2,4,50.0%,57m
22102,3,戮世魔罗,2362,0,2,7,9,22.2%,7m
22102,2,贾师傅好舒服,2362,0,1,3,4,25.0%,1h
22102,2,ccccc,2362,0,1,4,5,20.0%,1h
22115,1,周仕贤的爸爸,2361,1761,132,128,260,50.8%,1h
22115,1,[半个菜鸟II]miaowumiao,2361,1319,66,82,148,44.6%,37m
22115,1,萌萌萌萌新,2361,1297,52,46,98,53.1%,21m
22115,1,哈利路亚,2361,279,19,15,34,55.9%,1h
22115,1,IIIIIIIIIIII,2361,383,10,8,18,55.6%,1h
22115,1,神兽镜,2361,234,7,7,14,50.0%,10m
22115,3,狂野爸爸,2361,90,5,9,14,35.7%,7m
22115,3,诸神毁灭者,2361,86,4,9,13,30.8%,1h
22115,3,daiguipeng,2361,98,4,10,14,28.6%,1h
22115,1,大主教万岁,2361,128,3,0,3,100.0%,26m
22115,1,SCBOY,2361,80,3,1,4,75.0%,21m
22115,2,purion,2361,88,2,2,4,50.0%,1h
22115,1,狂男,2361,40,2,2,4,50.0%,24m
22115,1,幻城丶倩轩,2361,80,2,3,5,40.0%,23m
22115,1,小明,2361,86,2,3,5,40.0%,17m
22115,1,[十班好星际]NeverSNever,2361,0,1,0,1,100.0%,45m
22115,1,邓林,2361,0,1,0,1,100.0%,24m
22115,1,芜湖,2361,0,1,1,2,50.0%,1h
22115,2,老狼,2361,0,1,4,5,20.0%,16m
22115,1,[东皇峥嵘]黎明十二乐章,2361,0,0,1,1,0.0%,26m
22135,2,[西伯利亚土豆]窝里斗,2360,1487,146,141,287,50.9%,1h
22135,1,长岛海参,2360,1134,43,34,77,55.8%,1h
22135,2,夜愿,2360,754,30,38,68,44.1%,40m
22135,3,[GIE]少年你肥皂掉了,2360,352,25,25,50,50.0%,52m
22135,1,[旺旺战士]藤条焖雷兽,2360,578,21,16,37,56.8%,2m
22135,1,[沙漠皇帝]Kasotanst,2360,319,11,8,19,57.9%,1h
22135,1,LWH,2360,330,11,12,23,47.8%,3m
22135,3,天尊杨戬,2360,357,11,16,27,40.7%,11m
22135,1,红杉,2360,324,9,9,18,50.0%,53m
22135,2,曾来过,2360,203,8,13,21,38.1%,1h
22135,3,咸鱼王小梦,2360,198,7,10,17,41.2%,1h
22135,1,星际征霸,2360,155,6,5,11,54.5%,23m
22135,1,小好丶,2360,282,5,7,12,41.7%,1h
22135,1,创世者大军,2360,159,4,1,5,80.0%,8m
22135,2,麻瓜,2360,44,4,3,7,57.1%,1h
22135,1,郎中,2360,40,2,0,2,100.0%,2m
22135,1,[折磨星际]Iron,2360,0,1,0,1,100.0%,1h
22135,1,神秘小伙在线被锤,2360,0,1,1,2,50.0%,1h
22135,2,dsdsf,2360,0,1,5,6,16.7%,1h
22135,1,若见花的彼岸,2360,0,0,1,1,0.0%,44m
22135,2,大航海时代,2360,0,0,1,1,0.0%,26m
22135,1,HUIHUI,2360,0,0,2,2,0.0%,3m
22135,1,呵呵神,2360,0,0,2,2,0.0%,23m
22135,1,集结部队,2360,0,0,2,2,0.0%,1h
22135,3,三刀,2360,0,0,3,3,0.0%,1h
22160,2,zxy,2359,1538,73,66,139,52.5%,10m
22160,1,[大白护卫队]开小号必没妈,2359,1307,56,57,113,49.6%,53m
22160,1,龙猫,2359,804,47,45,92,51.1%,1h
22160,1,qsqsqs,2359,1054,40,34,74,54.1%,1h
22160,1,光明战神,2359,840,31,40,71,43.7%,50m
22160,3,[上官秋月]Kangvins,2359,511,20,26,46,43.5%,39m
22160,1,[QWQa]相逢会心一笑,2359,476,16,17,33,48.5%,1h
22160,3,hggh,2359,315,11,6,17,64.7%,1h
22160,1,[Deepdk]你说浚爷啊,2359,256,7,7,14,50.0%,11m
22160,1,[六道]ENT,2359,176,6,6,12,50.0%,52m
22160,1,[CARMYS]劫凌殇,2359,120,4,5,9,44.4%,45m
22160,3,COa,2359,114,4,6,10,40.0%,1h
22160,1,Joker,2359,48,4,6,10,40.0%,1h
22160,1,InnoVation,2359,123,3,0,3,100.0%,1h
22160,1,bldg,2359,0,3,4,7,42.9%,1h
22160,1,burNing,2359,0,1,0,1,100.0%,3m
22160,1,落月潇潇,2359,0,1,0,1,100.0%,1h
22160,1,[在下萌新一只]xfrzrcj,2359,42,1,4,5,20.0%,21m
22160,2,戴佳伟,2359,0,1,4,5,20.0%,33m
22160,2,bule,2359,0,1,4,5,20.0%,54m
22160,1,创世之战,2359,0,1,5,6,16.7%,1h
22160,3,向华为磕头,2359,0,0,1,1,0.0%,30m
22160,1,百合濑莉莉奈,2359,0,0,1,1,0.0%,57m
22160,1,Butcher,2359,0,0,1,1,0.0%,3m
22160,1,混沌骑士帝国,2359,0,0,2,2,0.0%,41m
22160,1,凉小白丶,2359,0,0,3,3,0.0%,2m
22160,2,[LYFANS]尚文上门,2359,0,0,3,3,0.0%,16m
22187,1,小奕妍,2358,1739,436,442,878,49.7%,1h
22187,1,Ehud,2358,1639,102,96,198,51.5%,55m
22187,1,王不留行,2358,822,24,26,50,48.0%,23m
22187,1,[Fiend]别杀队友,2358,393,15,17,32,46.9%,1h
22187,3,king,2358,407,15,20,35,42.9%,17m
22187,1,阿道夫叔叔,2358,468,13,14,27,48.1%,1h
22187,1,恐怖者,2358,332,11,12,23,47.8%,1h
22187,1,李嘉图,2358,374,10,15,25,40.0%,1h
22187,1,[闪电5连鞭]包子,2358,264,8,8,16,50.0%,3m
22187,3,汝之斗者,2358,242,8,15,23,34.8%,11m
22187,1,NIJAT,2358,144,3,4,7,42.9%,1h
22187,2,飞度,2358,113,3,9,12,25.0%,1h
22187,3,月影依风,2358,0,2,7,9,22.2%,1h
22187,1,Bomeslza,2358,48,2,7,9,22.2%,57m
22187,1,[PMC]WDNMD,2358,0,1,0,1,100.0%,30m
22187,1,邪恶丶小处男,2358,0,1,0,1,100.0%,1h
22187,1,Kierwing,2358,0,1,0,1,100.0%,44m
22187,1,[初始]岩弟,2358,0,1,1,2,50.0%,20m
22187,1,[乌尔兰的舰队]奇点,2358,46,1,3,4,25.0%,1h
22187,2,黄铀猫,2358,0,1,3,4,25.0%,1h
22187,2,danjiang,2358,0,1,4,5,20.0%,30m
22187,1,破碎杯垫,2358,0,1,5,6,16.7%,1h
22187,2,早晚要秃的玉龙,2358,0,0,1,1,0.0%,55m
22210,1,Hammer,2357,1705,185,186,371,49.9%,1h
22210,1,[极限菜鸟]东东东东东丶,2357,724,30,22,52,57.7%,1h
22210,1,灬飒爽英姿灬,2357,846,25,26,51,49.0%,1h
22210,3,Yeeleaf,2357,466,17,26,43,39.5%,7m
22210,1,[极限菜鸟]dawn,2357,348,14,7,21,66.7%,1h
22210,1,孤独的猫,2357,167,3,2,5,60.0%,41m
22210,1,UchihaMonroe,2357,44,2,1,3,66.7%,1h
22210,1,ZEROCOOL,2357,34,2,1,3,66.7%,1h
22210,1,war,2357,48,1,3,4,25.0%,1h
22210,1,[ZERO00]给大佬递茶,2357,97,1,4,5,20.0%,37m
22210,2,轱手语,2357,0,1,4,5,20.0%,11m
22210,1,丶归宿丶,2357,0,1,5,6,16.7%,1h
22210,1,[飞跃来]银河,2357,0,0,1,1,0.0%,52m
22210,1,Chelsea,2357,0,0,2,2,0.0%,20m
22224,3,Savior,2356,1471,261,256,517,50.5%,50m
22224,3,暗夜天使,2356,680,55,71,126,43.7%,52m
22224,3,[克哈的女团]许大大,2356,1114,49,55,104,47.1%,1h
22224,1,SCBOX,2356,701,26,23,49,53.1%,1h
22224,1,[306NB]五好学生,2356,638,23,30,53,43.4%,23m
22224,1,[暗月之剑]hgc,2356,521,15,12,27,55.6%,1h
22224,1,星空虫族,2356,438,14,18,32,43.8%,1h
22224,1,一个新手,2356,196,7,4,11,63.6%,3m
22224,3,sdfevz,2356,219,7,10,17,41.2%,41m
22224,1,流云,2356,61,3,3,6,50.0%,1h
22224,2,ForeverCD,2356,118,3,5,8,37.5%,1h
22224,1,Onland,2356,167,3,10,13,23.1%,57m
22224,3,IIIIIIIIII,2356,98,3,25,28,10.7%,21m
22224,1,一生一式一起走,2356,40,2,1,3,66.7%,51m
22224,3,moonwimd,2356,0,1,0,1,100.0%,1h
22224,2,偏心,2356,0,1,4,5,20.0%,1h
22224,1,wjc,2356,0,0,1,1,0.0%,19m
22241,2,眺望远方,2355,1228,91,97,188,48.4%,20m
22241,2,圣吉列斯,2355,1043,67,60,127,52.8%,41m
22241,1,[无上荣耀]青云林弑,2355,1366,51,52,103,49.5%,1h
22241,3,躺赢少年,2355,939,46,45,91,50.5%,1h
22241,1,NONO,2355,1264,45,44,89,50.6%,1h
22241,1,Nameless,2355,210,12,4,16,75.0%,38m
22241,1,[暴雪十队]haot,2355,265,7,6,13,53.8%,1h
22241,1,[小鸡屠宰场9]晓看风云,2355,255,6,12,18,33.3%,3m
22241,1,开普勒斯,2355,255,5,5,10,50.0%,44m
22241,1,[天坑a]血战到底,2355,0,3,3,6,50.0%,1h
22241,1,幼稚鬼,2355,84,3,8,11,27.3%,1h
22241,1,狂战风暴,2355,145,3,8,11,27.3%,14m
22241,1,花水雨离子,2355,96,2,1,3,66.7%,1h
22241,1,[总司令]xpy,2355,0,1,0,1,100.0%,1h
22241,1,行云流水,2355,0,1,0,1,100.0%,2m
22241,1,[第一戦門舰隊]阿巴,2355,0,1,1,2,50.0%,57m
22241,1,[虚拟歌手团体]钻石鸡苦练运营,2355,44,1,4,5,20.0%,38m
22241,2,MissX,2355,0,1,4,5,20.0%,16m
22241,2,清酒,2355,0,1,5,6,16.7%,1h
22260,2,很难赢一把,2354,1596,89,97,186,47.8%,51m
22260,3,moxie,2354,1505,76,83,159,47.8%,27m
22260,3,执魔,2354,1050,69,78,147,46.9%,1h
22260,1,Selenium,2354,1548,66,54,120,55.0%,1h
22260,1,Ahab,2354,1384,53,59,112,47.3%,1h
22260,1,最爱,2354,1080,52,54,106,49.1%,45m
22260,1,MRLIEW,2354,877,30,33,63,47.6%,1h
22260,1,爱福了友,2354,757,23,25,48,47.9%,1h
22260,1,[浪得虚名]CXS,2354,693,22,25,47,46.8%,13m
22260,1,[神奇海螺]月下行梦人,2354,573,19,21,40,47.5%,14m
22260,3,快乐白给,2354,407,16,15,31,51.6%,1h
22260,1,[黑丝小幼女]诗妙音,2354,384,12,8,20,60.0%,1h
22260,1,czg,2354,388,11,8,19,57.9%,38m
22260,1,斟月饮,2354,313,9,8,17,52.9%,45m
22260,1,[XXHZ18]GVYS,2354,204,6,2,8,75.0%,23m
22260,1,Kkhumous,2354,243,6,5,11,54.5%,1h
22260,1,流光,2354,212,6,7,13,46.2%,30m
22260,1,年少轻狂,2354,171,4,2,6,66.7%,38m
22260,1,孤岛,2354,148,4,5,9,44.4%,40m
22260,1,木之下和也,2354,134,3,6,9,33.3%,16m
22260,1,织藤信红,2354,76,2,0,2,100.0%,14m
22260,1,IIIIIIII,2354,40,2,1,3,66.7%,1h
22260,1,先生夺仁,2354,96,2,6,8,25.0%,1h
22260,1,光之逝影,2354,120,2,8,10,20.0%,1h
22260,1,[秋毫第五分队]怪盗,2354,0,1,1,2,50.0%,1h
22260,1,微睡,2354,0,1,1,2,50.0%,1h
22260,2,NOTHINGTOALL,2354,0,1,4,5,20.0%,1h
22260,3,IIIIIIIIIII,2354,0,1,7,8,12.5%,53m
22260,1,[天门]生涯,2354,0,0,2,2,0.0%,3m
22260,3,艾尔最富探姬,2354,0,0,2,2,0.0%,41m
22290,1,[miku守护]chck,2353,1402,722,739,1461,49.4%,23m
22290,3,宇宙无敌之辣鸡,2353,546,62,58,120,51.7%,1h
22290,1,逆星,2353,1082,53,41,94,56.4%,6m
22290,1,[团队必须赢]dafeng,2353,386,53,56,109,48.6%,38m
22290,1,[萌萌哒鸡]血骑,2353,686,43,40,83,51.8%,1h
22290,1,机甲机甲,2353,757,26,22,48,54.2%,1h
22290,1,[极限菜鸟]姚周宜,2353,559,22,18,40,55.0%,1h
22290,1,[无欲则刚]酋长,2353,464,21,22,43,48.8%,35m
22290,1,[诺娃的隐身衣]那双眼动人,2353,625,19,18,37,51.4%,44m
22290,1,Nate,2353,451,19,18,37,51.4%,11m
22290,3,[loveMM]阿道夫特朗普,2353,466,16,23,39,41.0%,1h
22290,3,毛炉饿鸿,2353,328,11,11,22,50.0%,1h
22290,1,LittleTime,2353,312,8,12,20,40.0%,1h
22290,1,发奋邱温泉莫芬,2353,232,7,8,15,46.7%,1h
22290,1,TheSTaR,2353,216,6,9,15,40.0%,13m
22290,1,神圣光灵,2353,138,5,0,5,100.0%,1h
22290,2,nozomi,2353,0,4,1,5,80.0%,1h
22290,1,人不猥琐枉少年,2353,38,2,1,3,66.7%,1h
22290,1,光明的力量,2353,44,2,2,4,50.0%,52m
22290,1,啊啊啊啊啊岚,2353,48,2,6,8,25.0%,15m
22290,2,Gates,2353,0,1,0,1,100.0%,54m
22290,1,FEI,2353,0,1,0,1,100.0%,1h
22290,1,fcchen,2353,0,0,1,1,0.0%,21m
22290,1,模型仔,2353,0,0,4,4,0.0%,1h
22314,1,恶霸一号,2352,1750,102,101,203,50.2%,24m
22314,1,川建国,2352,1517,98,112,210,46.7%,1h
22314,3,[Losers]惆怅啊惆怅,2352,1326,49,55,104,47.1%,5m
22314,3,愤怒的机枪兵,2352,678,44,46,90,48.9%,21m
22314,1,李玄飞,2352,880,34,26,60,56.7%,24m
22314,2,[我们为了粉丝]larryou,2352,807,31,42,73,42.5%,1h
22314,1,星空下的少年,2352,595,26,20,46,56.5%,1h
22314,1,dream,2352,662,22,18,40,55.0%,38m
22314,1,Eureka,2352,710,21,22,43,48.8%,1h
22314,3,[航母已经离港]浪漫第七星座,2352,510,19,23,42,45.2%,21m
22314,2,[大帝重工]楪祈,2352,490,16,27,43,37.2%,1h
22314,1,伴皖,2352,416,15,12,27,55.6%,26m
22314,1,谨言慎行,2352,280,11,13,24,45.8%,52m
22314,1,GRANDpapapa,2352,197,11,15,26,42.3%,46m
22314,1,wug,2352,302,10,8,18,55.6%,1h
22314,2,IGXY,2352,133,5,3,8,62.5%,59m
22314,1,高阶圣堂武士,2352,94,4,6,10,40.0%,1h
22314,3,一朵菊花香,2352,173,4,10,14,28.6%,21m
22314,1,我们故事起于星海,2352,126,2,3,5,40.0%,1h
22314,1,永远忘记开分矿,2352,0,1,0,1,100.0%,40m
22314,1,橘白,2352,90,1,5,6,16.7%,30m
22314,1,[weilai]冷斌,2352,0,0,1,1,0.0%,8m
22314,1,OneKey,2352,0,0,1,1,0.0%,55m
22314,1,横笛,2352,0,0,1,1,0.0%,13m
22314,1,人生寂寞可快乐,2352,0,0,2,2,0.0%,8m
22314,1,YTN,2352,0,0,2,2,0.0%,1h
22340,2,[CPT]索斯塔里斯,2351,1341,88,89,177,49.7%,1h
22340,3,関羽在此,2351,1570,76,87,163,46.6%,1h
22340,1,WODEMA,2351,588,27,16,43,62.8%,8m
22340,3,[GNRNG]习惯落寞,2351,582,22,26,48,45.8%,1h
22340,1,再也无她,2351,567,20,23,43,46.5%,21m
22340,1,SQS,2351,339,12,17,29,41.4%,1h
22340,1,iiiiiiiiiiii,2351,402,11,15,26,42.3%,1h
22340,1,子非鱼网,2351,211,8,6,14,57.1%,1h
22340,1,Smar,2351,217,6,4,10,60.0%,3m
22340,1,渡鸦靈,2351,210,6,7,13,46.2%,1h
22340,2,dawn,2351,119,4,11,15,26.7%,40m
22340,1,field,2351,84,3,5,8,37.5%,26m
22340,3,wryyyyyyyyyy,2351,30,2,1,3,66.7%,1h
22340,1,虚无浮云,2351,68,2,2,4,50.0%,54m
22340,3,lovelyleilei,2351,0,1,0,1,100.0%,15m
22340,3,[Beasty]关灯吃面,2351,0,1,1,2,50.0%,1h
22340,1,枫叶浮生残雪,2351,40,1,3,4,25.0%,1h
22340,2,燃灯节红色,2351,0,1,3,4,25.0%,1h
22340,2,Bryuner,2351,0,1,4,5,20.0%,26m
22340,1,mimhji,2351,0,0,1,1,0.0%,21m
22340,1,一乘寺贤,2351,0,0,1,1,0.0%,34m
22361,1,血影,2350,1657,65,68,133,48.9%,41m
22361,1,帅死的骆驼比马大,2350,1059,62,58,120,51.7%,26m
22361,3,Blackmagic,2350,312,56,69,125,44.8%,22m
22361,3,黑色梦魇,2350,211,19,26,45,42.2%,52m
22361,3,TomoyaAki,2350,360,14,27,41,34.1%,27m
22361,1,万能的萝卜,2350,342,12,14,26,46.2%,14m
22361,1,[冬予]scarcely,2350,366,12,16,28,42.9%,21m
22361,1,手残神族,2350,316,9,6,15,60.0%,1h
22361,1,[小鸡屠宰场b]柠檬红茶,2350,319,8,7,15,53.3%,1h
22361,3,会睡觉的超人,2350,239,8,10,18,44.4%,8m
22361,1,[在下菜鸡一只]钢铁雨,2350,228,7,9,16,43.8%,1h
22361,3,change,2350,145,3,4,7,42.9%,1h
22361,1,FFFsate,2350,34,2,2,4,50.0%,21m
22361,1,[镇魂]UFine,2350,0,1,0,1,100.0%,1h
22361,1,iiiiii,2350,0,1,0,1,100.0%,40m
22361,2,Cloud,2350,0,1,2,3,33.3%,1h
22361,2,暴雪停机场,2350,0,1,3,4,25.0%,11m
22361,1,美美哒的小黑,2350,0,0,1,1,0.0%,1h
22361,1,[超会玩]一马平川,2350,0,0,1,1,0.0%,51m
22361,2,QINEtt,2350,0,0,1,1,0.0%,11m
22361,2,艾尔,2350,0,0,1,1,0.0%,60m
22361,1,白板花梨,2350,0,0,2,2,0.0%,1h
22361,1,SilverKey,2350,0,0,2,2,0.0%,1h
22384,3,就叫你莫邪吧,2349,768,80,83,163,49.1%,1h
22384,1,IIIIIIIIIIII,2349,886,55,56,111,49.5%,1h
22384,3,小胖子,2349,372,34,45,79,43.0%,1h
22384,1,九天剑庄一幽冥,2349,772,27,25,52,51.9%,23m
22384,1,[人族最强近战]小红帽的大镰刀,2349,474,15,14,29,51.7%,38m
22384,1,六位帝皇玩,2349,222,10,8,18,55.6%,1h
22384,1,[我太帅]不良人,2349,181,6,3,9,66.7%,1h
22384,1,深渊,2349,162,6,8,14,42.9%,1h
22384,1,[笨比杀手]justinxue,2349,226,6,9,15,40.0%,52m
22384,1,狍子吃栗子,2349,162,5,8,13,38.5%,9m
22384,1,片甲不留,2349,191,4,3,7,57.1%,9m
22384,1,GFGS,2349,157,3,3,6,50.0%,6m
22384,2,letemps,2349,92,3,5,8,37.5%,1h
22384,3,[黄金萌新战舰]墨羽,2349,97,2,3,5,40.0%,1h
22384,1,[星灵王]菊爆大队,2349,80,2,5,7,28.6%,1h
22384,1,[风暴ING]夜月青云,2349,0,1,2,3,33.3%,41m
22384,1,于潇然,2349,44,1,3,4,25.0%,1h
22384,2,[欧佩克]鳄鱼,2349,0,1,4,5,20.0%,1h
22384,1,张作翔,2349,0,1,5,6,16.7%,9m
22384,2,落幕,2349,42,1,6,7,14.3%,49m
22384,2,LegendFirst,2349,0,0,3,3,0.0%,55m
22405,1,打不过是你自己菜,2348,1651,166,180,346,48.0%,1h
22405,1,faj,2348,1396,61,56,117,52.1%,40m
22405,3,zzzzz,2348,739,37,38,75,49.3%,11m
22405,1,[SFSF]比蒙巨兽,2348,551,20,21,41,48.8%,1h
22405,1,weixiao,2348,399,18,12,30,60.0%,54m
22405,1,tyrant,2348,533,17,19,36,47.2%,1h
22405,1,[DMRe]夜雨初晴,2348,485,15,22,37,40.5%,38m
22405,1,ShawyuS,2348,360,12,10,22,54.5%,53m
22405,1,[暴雪二十队]茸茸,2348,366,10,12,22,45.5%,51m
22405,1,莫相离,2348,191,7,7,14,50.0%,1h
22405,3,良先生,2348,148,4,4,8,50.0%,1h
22405,1,[北有唔王]皮皮兔,2348,97,2,5,7,28.6%,11m
22405,1,William,2348,96,2,6,8,25.0%,11m
22405,1,[地下大坟墓]希姿德尔塔,2348,92,1,3,4,25.0%,1h
22405,2,[暴雪五队]无冕,2348,0,0,1,1,0.0%,55m
22405,3,Erebus,2348,0,0,1,1,0.0%,1h
22405,1,[沙逼]喝毒奶长大的,2348,0,0,4,4,0.0%,1h
22422,1,[干翻机械化]tong,2347,1513,59,63,122,48.4%,45m
22422,1,熊爷,2347,492,20,18,38,52.6%,31m
22422,3,[EVILDE]Sakura,2347,376,15,13,28,53.6%,56m
22422,1,[老色痞]人生何处不青山,2347,371,14,8,22,63.6%,46m
22422,1,love,2347,296,9,16,25,36.0%,1h
22422,3,Dylan,2347,197,6,5,11,54.5%,8m
22422,3,别射嘴里面,2347,126,6,11,17,35.3%,15m
22422,1,核去核从,2347,150,5,5,10,50.0%,1h
22422,1,[鸡家军]CatalChao,2347,116,4,3,7,57.1%,45m
22422,1,STARXF,2347,106,3,0,3,100.0%,55m
22422,1,[灰冥]摔下二楼的杰洛特,2347,144,3,5,8,37.5%,1h
22422,1,少时诵诗书所,2347,124,3,6,9,33.3%,1h
22422,1,夏云,2347,121,2,2,4,50.0%,7m
22422,1,Antonio,2347,0,1,1,2,50.0%,26m
22422,1,[pg高达]深蓝大海,2347,0,1,1,2,50.0%,23m
22422,2,七点山人,2347,0,1,4,5,20.0%,1h
22422,1,[泰伦白给王]Careful,2347,0,0,1,1,0.0%,1h
22422,2,夕阳下的贪吃蛇,2347,0,0,1,1,0.0%,26m
22422,1,[C94941]zhou,2347,0,0,2,2,0.0%,1h
22441,1,洗手间风暴,2346,1748,236,247,483,48.9%,46m
22441,3,军师,2346,586,42,49,91,46.2%,21m
22441,1,TTNB,2346,816,26,34,60,43.3%,8m
22441,1,虎虎虎,2346,679,25,21,46,54.3%,1h
22441,1,DUAN,2346,788,24,29,53,45.3%,6m
22441,3,北洋水师,2346,560,23,25,48,47.9%,1h
22441,1,ZIYANG,2346,363,10,8,18,55.6%,38m
22441,1,[奥利给857]别喷我行么,2346,140,5,8,13,38.5%,41m
22441,1,[老黑客]陌行,2346,137,3,2,5,60.0%,1h
22441,1,[elixir]雷泽,2346,90,2,0,2,100.0%,34m
22441,3,huangdi,2346,97,2,1,3,66.7%,1h
22441,1,来我白给,2346,82,2,5,7,28.6%,1h
22441,1,[HPH]秀才的书,2346,80,2,5,7,28.6%,53m
22441,2,别打我可以吗,2346,42,2,5,7,28.6%,52m
22441,2,泰坦,2346,0,1,4,5,20.0%,1h
22441,2,星盟,2346,0,1,4,5,20.0%,1h
22441,2,[瘾大眼瞎]小徐,2346,0,0,1,1,0.0%,1h
22441,1,一叶知秋,2346,0,0,1,1,0.0%,1h
22459,1,么么哒小兔兔,2345,1651,205,202,407,50.4%,6m
22459,1,先死后生,2345,731,62,48,110,56.4%,1h
22459,1,怡舞,2345,329,25,21,46,54.3%,44m
22459,1,zxhwd,2345,589,23,23,46,50.0%,8m
22459,1,张张,2345,430,18,13,31,58.1%,1h
22459,1,也无风雨也无晴,2345,378,14,9,23,60.9%,24m
22459,1,DonColt,2345,191,7,24,31,22.6%,22m
22459,2,占占,2345,158,5,10,15,33.3%,1h
22459,3,刺客辣条,2345,143,4,2,6,66.7%,1h
22459,3,脑壳菜包,2345,60,4,8,12,33.3%,25m
22459,3,[华研国际]小鬼,2345,0,1,3,4,25.0%,1h
22459,2,土鳖,2345,0,1,4,5,20.0%,1h
22459,2,[最强战神]阿巴阿巴,2345,0,1,4,5,20.0%,16m
22459,1,敷衍,2345,0,1,4,5,20.0%,1h
22459,1,黑暗迪恩,2345,0,1,5,6,16.7%,1h
22459,1,dyjsws,2345,0,0,1,1,0.0%,1h
22459,1,wddks,2345,0,0,1,1,0.0%,45m
22459,1,司徒爱劝七,2345,0,0,3,3,0.0%,1h
22477,1,zhong,2344,1578,90,88,178,50.6%,1h
22477,1,SadAngel,2344,1281,55,43,98,56.1%,1h
22477,1,只会运营怎么办,2344,1020,32,39,71,45.1%,24m
22477,3,扣扣大有,2344,162,15,12,27,55.6%,53m
22477,2,卖鱼强蕉太郎,2344,159,6,11,17,35.3%,1h
22477,1,Jesenme,2344,156,5,9,14,35.7%,45m
22477,1,[暗00星]奔四的男人,2344,144,4,2,6,66.7%,55m
22477,1,BLADE,2344,48,4,5,9,44.4%,11m
22477,1,反光滑稽,2344,96,4,7,11,36.4%,20m
22477,2,[愚蠢的君子姬]心里无波动想暴毙,2344,88,2,3,5,40.0%,1h
22477,1,全球冰淇淋,2344,0,1,0,1,100.0%,17m
22477,1,希尔洛拿破仑,2344,0,1,4,5,20.0%,38m
22477,2,[新手玩家]恰柠檬的单身狗,2344,0,1,4,5,20.0%,38m
22477,1,[田中姬铃木雏]逗逼,2344,0,0,1,1,0.0%,1h
22477,1,暗影之叶的猫头鹰,2344,0,0,1,1,0.0%,1h
22477,1,[皇室联盟]凉介,2344,0,0,2,2,0.0%,46m
22477,2,kee,2344,0,0,2,2,0.0%,26m
22477,1,撸一发,2344,0,0,3,3,0.0%,1h
22495,1,药丸,2343,1744,114,109,223,51.1%,24m
22495,3,与孤独相吻,2343,1194,82,68,150,54.7%,1h
22495,1,INst,2343,419,30,15,45,66.7%,1h
22495,1,HJknight,2343,684,23,28,51,45.1%,51m
22495,2,风愿影尘,2343,568,18,33,51,35.3%,4m
22495,1,不讲武德,2343,522,16,36,52,30.8%,35m
22495,1,Darkchief,2343,426,13,13,26,50.0%,38m
22495,1,LOVEMLL,2343,220,10,6,16,62.5%,1h
22495,3,释明空牧师,2343,239,9,12,21,42.9%,1h
22495,2,HYH,2343,228,7,12,19,36.8%,12m
22495,3,eve,2343,169,6,10,16,37.5%,10m
22495,3,星空月之舞,2343,145,5,6,11,45.5%,1h
22495,1,[HYsc]SHTossBoy,2343,130,3,1,4,75.0%,1h
22495,1,毁灭与新生,2343,139,3,2,5,60.0%,20m
22495,1,[GaGaga]匠人金,2343,96,3,3,6,50.0%,11m
22495,2,丿幻丶梦姬,2343,0,3,3,6,50.0%,30m
22495,1,机灵鬼,2343,88,2,0,2,100.0%,3m
22495,1,枕头,2343,40,2,2,4,50.0%,1h
22495,1,[虫群永不休止]IIIIIIIIIIII,2343,97,1,2,3,33.3%,11m
22495,2,isnslr,2343,97,1,5,6,16.7%,16m
22495,1,LSOLATOR,2343,0,0,1,1,0.0%,1h
22495,1,[大元师]HaoBOSS,2343,0,0,1,1,0.0%,46m
22495,3,的神色,2343,0,0,1,1,0.0%,1h
22495,1,[怎么脏怎么来]标哥来了,2343,0,0,1,1,0.0%,1h
22495,1,木九,2343,0,0,1,1,0.0%,59m
22495,3,咿呦咿呦,2343,0,0,6,6,0.0%,1h
22521,1,[萌工蜂]RedSun,2342,1353,67,65,132,50.8%,1h
22521,1,tandy,2342,1118,44,44,88,50.0%,23m
22521,1,STR,2342,387,35,27,62,56.5%,45m
22521,1,狂怒,2342,656,27,32,59,45.8%,1h
22521,1,凛凛凛世水色感情,2342,331,26,22,48,54.2%,1h
22521,1,[纵丨横]冰菓,2342,628,26,23,49,53.1%,46m
22521,1,StevenChen,2342,678,24,29,53,45.3%,18m
22521,3,money,2342,186,9,16,25,36.0%,10m
22521,1,[单人模拟战]沉默之风暴,2342,156,4,2,6,66.7%,1h
22521,1,蛤是大,2342,108,3,1,4,75.0%,1h
22521,1,rainstorm,2342,118,3,4,7,42.9%,1h
22521,3,Strawberry,2342,149,3,11,14,21.4%,1h
22521,3,咸鱼八宝粥,2342,97,2,1,3,66.7%,21m
22521,1,嘉文,2342,0,1,0,1,100.0%,18m
22521,1,[此花亭]星河,2342,48,1,2,3,33.3%,1h
22521,1,信仰圣光吧,2342,0,0,3,3,0.0%,1h
22537,3,HHHHHHHHHHHH,2341,1489,129,133,262,49.2%,1h
22537,3,神龙百威,2341,1452,58,64,122,47.5%,56m
22537,1,[来送分的]Archen,2341,703,42,31,73,57.5%,1h
22537,1,wmzwmz,2341,614,32,39,71,45.1%,46m
22537,1,柳柳柳柳柳,2341,503,24,16,40,60.0%,6m
22537,3,[七星]迷糊的跳虫,2341,660,23,30,53,43.4%,1h
22537,1,[北极光小组]雷神,2341,396,11,13,24,45.8%,1h
22537,1,[梁佳河抗麦队]SlumberPeng,2341,273,10,10,20,50.0%,1h
22537,1,[北有吾王3队]哈尼哈,2341,308,9,6,15,60.0%,46m
22537,3,荣光照耀艾尔,2341,201,8,9,17,47.1%,22m
22537,1,[Ts涂山]星际流浪者,2341,283,7,6,13,53.8%,1h
22537,1,[白给丶兄弟]麦麦的春紫苑,2341,188,6,6,12,50.0%,1h
22537,1,wlgc,2341,239,6,7,13,46.2%,7m
22537,1,安卡诺,2341,214,5,8,13,38.5%,57m
22537,3,来你的哇,2341,187,5,11,16,31.2%,18m
22537,1,虫群无穷无尽,2341,151,4,3,7,57.1%,34m
22537,1,EASYpeazzzyy,2341,179,4,3,7,57.1%,1h
22537,2,[凌云志]人类永垂不朽,2341,42,4,3,7,57.1%,1h
22537,1,吴彦祖,2341,97,3,5,8,37.5%,44m
22537,1,天雅,2341,48,2,7,9,22.2%,59m
22537,3,[黑魔导女孩]梦回远古,2341,0,2,7,9,22.2%,37m
22537,1,哦西吧,2341,0,1,0,1,100.0%,1h
22537,2,隔壁你王叔,2341,0,1,1,2,50.0%,1h
22537,2,沐浴弥勒,2341,0,1,4,5,20.0%,52m
22537,1,神之王王之手,2341,0,1,5,6,16.7%,1h
22562,3,yyyyccccc,2340,1548,266,264,530,50.2%,1h
22562,1,brown,2340,631,26,22,48,54.2%,1h
22562,1,爹哋,2340,336,11,14,25,44.0%,1h
22562,1,[50块好狗子]小黑,2340,278,9,9,18,50.0%,1h
22562,3,小胖子,2340,254,8,10,18,44.4%,7m
22562,1,香辣鸡腿堡,2340,253,8,15,23,34.8%,14m
22562,1,半夏,2340,297,7,7,14,50.0%,46m
22562,1,来哥丶我小唐,2340,220,7,11,18,38.9%,1h
22562,2,烟花君,2340,112,6,13,19,31.6%,10m
22562,1,悠扬,2340,206,5,8,13,38.5%,22m
22562,1,[CPT]墓志铭结婚时代,2340,158,4,6,10,40.0%,51m
22562,1,[星际爱好者队]小龙龙,2340,157,4,7,11,36.4%,1h
22562,2,黑色地狱,2340,96,3,3,6,50.0%,26m
22562,1,卑微的单推人,2340,110,3,4,7,42.9%,1h
22562,1,[大疯狗]灰色原来是哀伤,2340,114,3,4,7,42.9%,1h
22562,3,爱情合作,2340,30,3,7,10,30.0%,1h
22562,1,BLUE,2340,76,2,3,5,40.0%,38m
22562,1,小白兔,2340,0,2,5,7,28.6%,59m
22562,1,Blown,2340,0,2,6,8,25.0%,41m
22562,1,俊老头爱打手虫,2340,48,2,7,9,22.2%,1h
22562,2,朱向飞,2340,0,1,1,2,50.0%,1h
22562,1,夜孤城,2340,0,0,1,1,0.0%,1h
22562,1,STRAWARLORD,2340,0,0,2,2,0.0%,1h
22585,1,skill,2339,910,63,67,130,48.5%,7m
22585,2,duck,2339,1298,57,69,126,45.2%,1h
22585,1,[争霸306]西北土狗教父,2339,571,26,21,47,55.3%,21m
22585,3,小萌新丨琉璃,2339,355,21,21,42,50.0%,1h
22585,1,心忧风铃,2339,544,17,13,30,56.7%,3m
22585,1,训练有素的废柴,2339,449,15,13,28,53.6%,10m
22585,3,小可,2339,324,12,11,23,52.2%,52m
22585,1,天天,2339,277,7,5,12,58.3%,21m
22585,1,domon,2339,289,7,7,14,50.0%,11m
22585,1,[睾能瓦斯不足]天际线,2339,220,7,8,15,46.7%,51m
22585,1,vikitay,2339,148,5,5,10,50.0%,1h
22585,1,[TLGD]SuperMary,2339,125,4,1,5,80.0%,40m
22585,2,小白,2339,76,4,5,9,44.4%,40m
22585,1,这是坏人,2339,96,3,8,11,27.3%,21m
22585,1,AndreHsu,2339,0,1,1,2,50.0%,1h
22585,2,euojinjin,2339,0,1,4,5,20.0%,55m
22585,2,IIIIIIII,2339,0,1,4,5,20.0%,54m
22585,1,巨炮者,2339,0,0,2,2,0.0%,24m
22585,3,CCCP,2339,0,0,3,3,0.0%,7m
22604,1,小马哥,2338,1256,86,83,169,50.9%,14m
22604,1,hedgehog,2338,984,57,61,118,48.3%,1h
22604,1,数鑫航,2338,1270,52,39,91,57.1%,1h
22604,3,我不想乱来,2338,952,52,67,119,43.7%,2m
22604,3,night,2338,333,13,17,30,43.3%,1h
22604,1,软泥人,2338,454,12,15,27,44.4%,1h
22604,1,优雅的天秤,2338,259,7,9,16,43.8%,19m
22604,1,拳拳,2338,142,4,5,9,44.4%,1h
22604,3,小发,2338,0,2,7,9,22.2%,3m
22604,1,changechange,2338,0,1,0,1,100.0%,34m
22604,1,[浮世清欢]死亡之翼,2338,0,1,1,2,50.0%,1h
22604,2,欧罗路,2338,0,1,5,6,16.7%,26m
22604,1,膜法泰伦,2338,0,0,1,1,0.0%,38m
22604,1,[16CM]甲方据卡机,2338,0,0,2,2,0.0%,1h
22604,1,[白给就对了]nopcl,2338,0,0,7,7,0.0%,41m
22619,1,LOL,2337,1541,154,166,320,48.1%,48m
22619,1,[XYG]未来,2337,1588,54,59,113,47.8%,23m
22619,3,FDR,2337,711,29,38,67,43.3%,23m
22619,3,臭鞋子蜀黍,2337,454,19,29,48,39.6%,1h
22619,1,林朝雨,2337,96,5,8,13,38.5%,21m
22619,2,ScaretCarson,2337,0,4,1,5,80.0%,1h
22619,1,我知道你不爱我,2337,116,4,4,8,50.0%,1h
22619,1,Weneedaniel,2337,132,4,6,10,40.0%,1h
22619,2,你才萝卜,2337,111,2,3,5,40.0%,1h
22619,1,[DWGDC]加藤惠惠惠惠惠惠,2337,72,2,10,12,16.7%,52m
22619,1,[黄旭东我老婆]萌萌哒小李子,2337,0,1,0,1,100.0%,1h
22619,3,[你好可爱]QinG,2337,0,1,1,2,50.0%,1h
22619,2,LienMero,2337,0,1,4,5,20.0%,33m
22619,2,[陈诞苑]宙司,2337,0,0,1,1,0.0%,1h
22619,1,七友,2337,0,0,2,2,0.0%,1h
22619,1,vanvanta,2337,0,0,2,2,0.0%,1h
22635,1,[LOHs]asdfiujhs,2336,938,59,57,116,50.9%,38m
22635,1,Logic,2336,611,17,19,36,47.2%,1h
22635,1,miracle,2336,465,15,13,28,53.6%,1h
22635,1,年轻人不讲武德,2336,325,12,14,26,46.2%,1h
22635,3,菜鸟,2336,362,12,16,28,42.9%,5m
22635,1,SCV,2336,280,8,12,20,40.0%,1h
22635,2,[耀世姚熙]暴雪的爹,2336,133,8,17,25,32.0%,60m
22635,3,凉凝,2336,189,7,9,16,43.8%,25m
22635,1,DesertEagle,2336,127,4,7,11,36.4%,38m
22635,2,高手父亲,2336,0,2,4,6,33.3%,1h
22635,2,独孤天问,2336,0,1,0,1,100.0%,1h
22635,2,白夜行,2336,0,1,1,2,50.0%,26m
22635,2,ZYHtaBB,2336,0,1,4,5,20.0%,55m
22635,1,[穿梭]电竞喜羊羊,2336,0,0,1,1,0.0%,14m
22635,1,克洛佐斯的喵喵酱,2336,0,0,2,2,0.0%,7m
22635,1,[你单刷我躺啦]scrooge,2336,0,0,3,3,0.0%,3m
22651,2,[CPT]yolime,2335,709,29,37,66,43.9%,1h
22651,1,Melt,2335,465,27,18,45,60.0%,46m
22651,1,BombardingT,2335,450,15,21,36,41.7%,1h
22651,1,[嫩爽口美鲍鱼]离三,2335,368,13,16,29,44.8%,9m
22651,1,weichen,2335,165,5,2,7,71.4%,44m
22651,1,Miraitowa,2335,158,4,9,13,30.8%,53m
22651,2,我的心你不懂,2335,0,1,1,2,50.0%,26m
22651,2,[努力到最强]柏林慕雪,2335,0,1,4,5,20.0%,1h
22651,1,[暴雪十八队]我爸刚弄死他,2335,0,0,1,1,0.0%,14m
22651,2,蛟龙号,2335,0,0,1,1,0.0%,55m
22651,1,走资派,2335,0,0,1,1,0.0%,1h
22651,1,扭曲的懒虫,2335,0,0,1,1,0.0%,38m
22651,2,苏洛,2335,0,0,1,1,0.0%,1h
22651,2,第九号,2335,0,0,2,2,0.0%,1h
22651,1,[抽风机]林享,2335,0,0,3,3,0.0%,1h
22666,1,[荣耀归来]帝皇侠,2334,1406,342,352,694,49.3%,1h
22666,3,[绝世双谐]Kevin,2334,1064,52,45,97,53.6%,5m
22666,1,mind,2334,789,30,28,58,51.7%,21m
22666,1,黎明的银狼,2334,477,19,15,34,55.9%,1h
22666,1,sohol,2334,464,18,14,32,56.2%,24m
22666,1,星辰,2334,508,18,21,39,46.2%,1h
22666,1,五秒真男人,2334,209,18,24,42,42.9%,1h
22666,1,WECOMER,2334,499,17,21,38,44.7%,14m
22666,1,GOGOGO,2334,387,12,14,26,46.2%,1h
22666,3,[沙星部]sanzy,2334,170,5,3,8,62.5%,1h
22666,1,[暴雪二十九队]闪电,2334,198,5,9,14,35.7%,45m
22666,2,左千铭,2334,44,4,3,7,57.1%,17m
22666,1,数据链接中,2334,149,4,5,9,44.4%,6m
22666,1,[北有唔王]人间万年,2334,107,3,2,5,60.0%,1h
22666,1,帅气的组长,2334,0,2,6,8,25.0%,1h
22666,1,天真恶魔,2334,0,1,0,1,100.0%,38m
22666,1,JustBecause,2334,0,1,7,8,12.5%,41m
22666,1,柠檬不萌,2334,0,0,1,1,0.0%,1h
22666,1,Laughing,2334,0,0,6,6,0.0%,34m
22685,1,大卫浩,2333,1388,83,86,169,49.1%,14m
22685,1,默裔,2333,1642,57,59,116,49.1%,24m
22685,1,suoluo,2333,400,33,25,58,56.9%,10m
22685,1,haha,2333,599,19,25,44,43.2%,6m
22685,1,[白银联盟]夜雨霖辰,2333,344,14,14,28,50.0%,38m
22685,1,[天境]楠爵一九九一,2333,330,9,11,20,45.0%,53m
22685,3,[鸡饲料一堆]Voldemort,2333,0,1,0,1,100.0%,52m
22685,2,道一,2333,0,0,1,1,0.0%,1h
22693,1,不死鸟之花盛开时,2332,250,20,11,31,64.5%,36m
22693,1,[暴雪三十一队]老油子,2332,479,16,13,29,55.2%,21m
22693,2,对面等着没吧,2332,284,10,14,24,41.7%,43m
22693,1,撷枝红豆,2332,230,7,4,11,63.6%,3m
22693,1,JIANG,2332,278,7,10,17,41.2%,46m
22693,3,村头一枝鸭,2332,147,4,2,6,66.7%,1h
22693,1,Recur,2332,0,3,7,10,30.0%,35m
22693,3,thorsky,2332,34,3,8,11,27.3%,1h
22693,1,[彳亍不彳亍]Hitwilight,2332,46,2,1,3,66.7%,1h
22693,1,RENDERS,2332,48,2,1,3,66.7%,15m
22693,2,wangbaba,2332,114,2,4,6,33.3%,33m
22693,2,破碎的小明,2332,0,1,0,1,100.0%,1h
22693,2,[二战武鉴阁]我是小狗嘿嘿嘿,2332,0,1,0,1,100.0%,26m
22693,1,Mylove,2332,48,1,2,3,33.3%,7m
22693,3,好闲闲闲啊,2332,0,0,1,1,0.0%,15m
22693,2,[混吃混喝]郭哥,2332,0,0,2,2,0.0%,1h
22693,1,东方千月,2332,0,0,3,3,0.0%,1h
22710,1,玩这游戏素质真低,2331,960,50,54,104,48.1%,1h
22710,1,KARITO,2331,863,35,31,66,53.0%,1h
22710,1,Scboy,2331,645,23,19,42,54.8%,1h
22710,1,神王变,2331,438,22,20,42,52.4%,1h
22710,3,Lamar,2331,330,12,18,30,40.0%,29m
22710,1,蔑时间,2331,210,7,14,21,33.3%,1h
22710,1,[渡零]零点幽灵,2331,208,5,4,9,55.6%,3m
22710,1,Finsh,2331,191,4,2,6,66.7%,14m
22710,1,大帅哥,2331,97,4,3,7,57.1%,11m
22710,1,宇宇,2331,133,4,3,7,57.1%,1h
22710,2,海边的曼彻斯特,2331,130,4,5,9,44.4%,5m
22710,1,是非自有分辨,2331,119,2,4,6,33.3%,1h
22710,1,Julianweigl,2331,30,1,3,4,25.0%,1h
22710,2,初音,2331,0,1,4,5,20.0%,1h
22710,2,你杰哥,2331,0,1,4,5,20.0%,15m
22710,2,无情的白给机器,2331,0,1,4,5,20.0%,54m
22710,2,神仙哥,2331,0,1,5,6,16.7%,60m
22710,1,funtion,2331,0,1,5,6,16.7%,13m
22710,2,HELLO,2331,0,0,1,1,0.0%,33m
22710,2,雾隐云山,2331,0,0,1,1,0.0%,15m
22710,1,初级城市规划师,2331,0,0,2,2,0.0%,34m
22710,1,MagejiTerran,2331,0,0,2,2,0.0%,1h
22710,2,仰望星辰,2331,0,0,3,3,0.0%,1h
22733,3,哈哈,2330,1523,155,173,328,47.3%,1h
22733,1,zsfzjslj,2330,417,17,15,32,53.1%,1h
22733,1,[北有吾王2队]你好帅,2330,234,7,9,16,43.8%,1h
22733,2,功夫咖,2330,174,7,17,24,29.2%,1h
22733,2,这游戏不能鬼啊,2330,153,6,7,13,46.2%,1h
22733,3,黑袍,2330,171,5,9,14,35.7%,10m
22733,3,噜咔,2330,88,5,10,15,33.3%,1m
22733,3,tanshi,2330,143,3,1,4,75.0%,1h
22733,1,[天羽不榖]花情丶,2330,122,3,2,5,60.0%,1h
22733,2,IIIIIIIIIII,2330,0,3,7,10,30.0%,1h
22733,1,[摇起来]我叫香辣蟹,2330,70,3,9,12,25.0%,6m
22733,1,神王剑神,2330,0,1,1,2,50.0%,38m
22733,1,gavin,2330,0,1,1,2,50.0%,55m
22733,1,[最菜战队]京烟忘宇,2330,90,1,2,3,33.3%,1h
22733,2,CLOCK,2330,46,1,2,3,33.3%,26m
22733,1,我吃橘子你吃史,2330,40,1,3,4,25.0%,46m
22733,2,BIGbigger,2330,0,1,4,5,20.0%,1h
22733,2,[sc协会]慕周,2330,0,0,1,1,0.0%,29m
22733,2,路明非,2330,0,0,1,1,0.0%,1h
22733,2,含笑半步癫,2330,0,0,2,2,0.0%,1h
22733,1,Nekoko,2330,0,0,3,3,0.0%,1h
22754,2,[冲就完了]hads,2329,1489,247,255,502,49.2%,50m
22754,3,[CNEB]星际之霸,2329,1586,169,166,335,50.4%,1h
22754,2,duanlian,2329,1595,149,152,301,49.5%,1h
22754,3,[久美子足浴城]DearFriendSp,2329,1094,60,59,119,50.4%,50m
22754,2,阿扎霄晓,2329,596,47,39,86,54.7%,27m
22754,1,风折残灵,2329,678,20,21,41,48.8%,1h
22754,1,兮兮柳知,2329,632,19,20,39,48.7%,46m
22754,2,maoku,2329,398,16,19,35,45.7%,33m
22754,2,[HustSC]Otin,2329,296,10,9,19,52.6%,1h
22754,1,BlackPinkJ,2329,332,10,11,21,47.6%,1h
22754,1,[MGT谐星会]玉米包包,2329,270,8,9,17,47.1%,3m
22754,1,东南汽车值得拥有,2329,191,6,4,10,60.0%,1h
22754,2,纯洁滴神棍,2329,127,5,11,16,31.2%,1h
22754,1,WDSDD,2329,118,4,12,16,25.0%,38m
22754,2,艾尔明灯大主教,2329,62,3,1,4,75.0%,1h
22754,2,[GOTAL]轴心国,2329,0,1,0,1,100.0%,1h
22754,2,[柒堇年华]远汀,2329,30,1,1,2,50.0%,1h
22754,1,llllllllllll,2329,0,1,1,2,50.0%,1h
22754,1,赛特斯,2329,0,1,4,5,20.0%,1h
22754,1,黑星,2329,42,1,5,6,16.7%,1h
22754,2,白金之星,2329,0,0,1,1,0.0%,40m
22754,1,Maybe,2329,0,0,3,3,0.0%,1h
22754,1,[Elite]邬小贤,2329,0,0,4,4,0.0%,1h
22777,3,敢采于部,2328,1467,187,203,390,47.9%,11m
22777,2,松骨峰英雄连,2328,1025,87,97,184,47.3%,1h
22777,1,枯木逢春,2328,458,19,13,32,59.4%,1h
22777,2,boxin,2328,324,16,9,25,64.0%,1h
22777,1,黄浦张大胆,2328,480,15,17,32,46.9%,1h
22777,1,[浙大战队]失去单身的幽忧,2328,450,12,17,29,41.4%,51m
22777,3,帅呆呆,2328,241,10,9,19,52.6%,16m
22777,1,ZooEy,2328,298,9,10,19,47.4%,21m
22777,3,小五,2328,227,8,12,20,40.0%,1h
22777,2,[KUMA28]山川赋,2328,214,6,3,9,66.7%,1h
22777,2,[SC2战队]郭山炮你怕不,2328,92,5,3,8,62.5%,55m
22777,1,次了个瓜,2328,135,4,1,5,80.0%,21m
22777,2,最强黄金,2328,0,3,2,5,60.0%,54m
22777,1,fenix,2328,120,3,6,9,33.3%,1h
22777,2,一丫一丫,2328,0,2,1,3,66.7%,54m
22777,2,Altoria,2328,92,2,4,6,33.3%,1h
22777,3,[i5]醉里挑灯看剑,2328,0,2,6,8,25.0%,1h
22777,3,梦幻影,2328,0,2,7,9,22.2%,25m
22777,1,RicaroMLU,2328,0,1,1,2,50.0%,1h
22777,2,一千年以后,2328,0,0,1,1,0.0%,26m
22797,1,HUASE,2327,1350,122,123,245,49.8%,1h
22797,3,Joyspace,2327,1508,51,66,117,43.6%,1h
22797,2,塞缪尔白白,2327,466,20,14,34,58.8%,27m
22797,1,BTCtotheMoon,2327,459,18,11,29,62.1%,1h
22797,3,[成电鸡协]行不得也呵呵,2327,429,16,16,32,50.0%,1h
22797,2,云狼,2327,310,11,8,19,57.9%,5m
22797,1,MoMoSed,2327,260,7,12,19,36.8%,24m
22797,1,[单人行动对吧]chen,2327,192,6,7,13,46.2%,46m
22797,1,[正经企鹅]back,2327,238,6,7,13,46.2%,1h
22797,1,SitalyHS,2327,0,2,4,6,33.3%,37m
22797,1,juma,2327,0,1,1,2,50.0%,1h
22797,2,流浪泰伦,2327,46,1,2,3,33.3%,38m
22797,2,leizhouxi,2327,0,1,4,5,20.0%,33m
22797,2,沉默的羔羊,2327,0,1,5,6,16.7%,1h
22797,2,BKLOVE,2327,0,0,1,1,0.0%,48m
22797,2,丘山日辰,2327,0,0,1,1,0.0%,1h
22797,1,sfdawdaf,2327,0,0,2,2,0.0%,1h
22814,1,[Neeb]wanglei,2326,644,37,29,66,56.1%,34m
22814,1,wgz,2326,728,32,30,62,51.6%,1h
22814,1,ulysses,2326,750,24,23,47,51.1%,51m
22814,1,HeIsHero,2326,582,17,22,39,43.6%,3m
22814,1,[YG2020]伍迪,2326,477,16,14,30,53.3%,1h
22814,1,[我意凌云]殇丶櫖,2326,286,9,10,19,47.4%,9m
22814,1,peanut,2326,264,8,7,15,53.3%,1h
22814,1,XIYUAN,2326,143,3,7,10,30.0%,14m
22814,2,卷毛丶丶,2326,46,2,2,4,50.0%,54m
22814,1,绝尘,2326,42,2,3,5,40.0%,39m
22814,1,隐姓埋名,2326,48,2,3,5,40.0%,59m
22814,1,佛图关,2326,30,2,5,7,28.6%,41m
22814,2,[纯净的]BIGFIOWER,2326,46,2,5,7,28.6%,26m
22814,2,禁锢之灵,2326,0,1,0,1,100.0%,1h
22814,2,[开心战队]泪了嚄刀,2326,0,1,0,1,100.0%,1h
22814,2,zjc,2326,0,1,0,1,100.0%,1h
22814,2,王蛇人,2326,0,1,1,2,50.0%,1h
22814,2,殇筱曦,2326,0,0,1,1,0.0%,1h
22814,1,狄丽斯上校,2326,0,0,2,2,0.0%,1h
22814,1,ljx,2326,0,0,4,4,0.0%,1h
22834,1,神兵,2325,1334,46,48,94,48.9%,1h
22834,1,QAQ,2325,907,33,26,59,55.9%,34m
22834,3,[对战之队]星际争霸,2325,371,14,19,33,42.4%,1h
22834,1,宇宙风行者,2325,463,13,15,28,46.4%,1h
22834,1,一笑,2325,281,12,6,18,66.7%,1h
22834,1,幽灵报道,2325,160,9,14,23,39.1%,36m
22834,3,SDsd,2325,249,8,9,17,47.1%,37m
22834,2,wero,2325,120,5,0,5,100.0%,1h
22834,3,YCLTFans,2325,181,5,9,14,35.7%,16m
22834,1,三色院堇子,2325,169,4,7,11,36.4%,1h
22834,2,小菜鸟,2325,74,3,0,3,100.0%,12m
22834,2,MrTodd,2325,60,3,1,4,75.0%,33m
22834,3,LXY,2325,30,2,4,6,33.3%,1h
22834,1,[考遁辣仙根]单挑谁怕谁,2325,96,2,6,8,25.0%,21m
22834,1,只会这一招,2325,0,1,1,2,50.0%,23m
22834,1,sosoosss,2325,46,1,3,4,25.0%,40m
22834,3,HYx,2325,0,1,6,7,14.3%,1h
22834,2,星星,2325,0,0,1,1,0.0%,1h
22834,1,中尉副官,2325,0,0,1,1,0.0%,15m
22834,2,[绘梨依]路明非,2325,0,0,1,1,0.0%,1h
22834,2,万军一剑挡,2325,0,0,1,1,0.0%,1h
22834,2,浮生俗世,2325,0,0,5,5,0.0%,26m
22856,1,[冲就完了]makeldld,2324,1601,80,67,147,54.4%,1h
22856,1,yyyct,2324,600,20,25,45,44.4%,6m
22856,1,River,2324,606,19,19,38,50.0%,3m
22856,1,[TG1]RED,2324,495,17,14,31,54.8%,34m
22856,3,深渊,2324,287,8,14,22,36.4%,22m
22856,1,Mize,2324,236,6,9,15,40.0%,34m
22856,1,ILXI,2324,187,5,4,9,55.6%,1h
22856,1,夏有森光暖无疑,2324,238,4,4,8,50.0%,15m
22856,3,LOVE,2324,120,3,3,6,50.0%,1h
22856,1,[曾经一群兔兔]曾经有一只兔子,2324,48,2,1,3,66.7%,1h
22856,1,立华奏,2324,48,2,4,6,33.3%,1h
22856,2,[亮出光刄]无情帅哥,2324,46,2,5,7,28.6%,26m
22856,2,机械狼人,2324,0,1,1,2,50.0%,26m
22856,2,喜欢虫人,2324,0,1,2,3,33.3%,11m
22856,2,小郭哥哥,2324,0,0,1,1,0.0%,59m
22856,2,猫忍者,2324,0,0,1,1,0.0%,30m
22856,1,血染你的卫生棉,2324,0,0,2,2,0.0%,1h
22873,1,酸菜鱼在线挨打,2323,773,30,29,59,50.8%,1h
22873,1,[氕氘氚]感化不如火化,2323,312,14,6,20,70.0%,1h
22873,1,高档豆腐,2323,320,9,12,21,42.9%,1h
22873,1,[达拉姆内务部]我的王之力,2323,107,7,10,17,41.2%,1h
22873,1,洋气的羊,2323,179,6,3,9,66.7%,45m
22873,1,夜雨风声,2323,139,5,4,9,55.6%,3m
22873,1,zelatu,2323,194,4,5,9,44.4%,3m
22873,1,圣枪游侠奥巴马,2323,96,4,5,9,44.4%,1h
22873,1,Tian,2323,146,4,8,12,33.3%,15m
22873,2,[对标是什么]白殇,2323,60,3,2,5,60.0%,1h
22873,2,消逝的锋芒,2323,137,3,6,9,33.3%,59m
22873,1,[哦哟喂呀]乐风大帝,2323,0,1,1,2,50.0%,40m
22873,2,咕哒夫,2323,0,1,2,3,33.3%,52m
22873,2,哎呦喂,2323,0,1,4,5,20.0%,11m
22873,2,[loveMM]阳光虫,2323,0,1,4,5,20.0%,1h
22873,2,[哔哩哔哩乾杯]何三木,2323,0,0,1,1,0.0%,40m
22873,2,夜魅影之泪,2323,0,0,1,1,0.0%,1h
22873,1,酷拉小皮卡,2323,0,0,2,2,0.0%,1h
22891,2,眉如远山,2322,1428,121,134,255,47.5%,1h
22891,2,命缘,2322,1172,49,46,95,51.6%,1h
22891,1,郎朗,2322,1073,41,44,85,48.2%,46m
22891,2,暮光闪闪,2322,913,39,22,61,63.9%,1h
22891,3,[孤傲就完事]大帅比琴酒,2322,386,39,43,82,47.6%,1h
22891,1,如年渡日,2322,853,38,31,69,55.1%,1h
22891,1,Gaige,2322,741,25,26,51,49.0%,1h
22891,1,GHL,2322,510,21,16,37,56.8%,1h
22891,1,Cerberus,2322,507,15,17,32,46.9%,6m
22891,2,奥特曼,2322,386,12,18,30,40.0%,54m
22891,2,ssad,2322,263,11,14,25,44.0%,1h
22891,3,[彼岸之花]小天才,2322,108,4,9,13,30.8%,10m
22891,1,血鹰小昊昊,2322,127,3,4,7,42.9%,52m
22891,1,[闪电伍连鞭]你伟大的爹,2322,38,2,2,4,50.0%,1h
22891,2,[电气游龙]小周不姓小,2322,138,2,5,7,28.6%,30m
22891,1,UZI,2322,70,2,8,10,20.0%,3m
22891,2,[无花也浪漫]修地堡没个妈,2322,0,1,0,1,100.0%,1h
22891,1,[初音守护二队]花爷,2322,0,1,1,2,50.0%,1h
22891,1,霸下,2322,0,1,1,2,50.0%,1h
22891,2,扫地僧,2322,32,1,1,2,50.0%,26m
22891,3,fcwei,2322,0,1,3,4,25.0%,7m
22891,1,忒修斯之船,2322,36,1,3,4,25.0%,1h
22891,1,混元形意太极官,2322,38,1,4,5,20.0%,11m
22891,2,haha,2322,0,1,4,5,20.0%,1h
22891,1,请叫爸爸,2322,0,1,7,8,12.5%,41m
22891,1,lile,2322,0,0,2,2,0.0%,1h
22891,1,哇哈哈哈哈,2322,0,0,2,2,0.0%,1h
22891,1,天下羽化尘,2322,0,0,3,3,0.0%,27m
22919,3,战影,2321,1409,60,57,117,51.3%,18m
22919,1,坏脾气的爱,2321,955,55,61,116,47.4%,1h
22919,2,弹幕永恒,2321,814,47,55,102,46.1%,1h
22919,1,疾风剑豪,2321,925,39,34,73,53.4%,1h
22919,2,RyanHuang,2321,530,20,14,34,58.8%,18m
22919,2,决定,2321,308,14,11,25,56.0%,22m
22919,1,啥也不会,2321,253,8,5,13,61.5%,14m
22919,3,爷新在此,2321,241,8,11,19,42.1%,1h
22919,2,储浩,2321,171,6,9,15,40.0%,15m
22919,1,FROST,2321,183,5,3,8,62.5%,39m
22919,2,言笑,2321,128,5,4,9,55.6%,1h
22919,2,凯文因缺斯汀,2321,58,2,1,3,66.7%,33m
22919,1,[gost]斟酒对无言,2321,0,2,2,4,50.0%,1h
22919,1,初春飾利,2321,42,2,6,8,25.0%,1h
22919,1,[星歌]Yeochen,2321,0,1,0,1,100.0%,1h
22919,2,寒舞,2321,30,1,2,3,33.3%,1h
22919,2,罗小逗,2321,94,1,2,3,33.3%,26m
22919,2,average,2321,0,1,4,5,20.0%,1h
22937,1,[极限菜鸟]hollykaka,2320,1050,99,92,191,51.8%,1h
22937,1,新年好可爱小迷妹,2320,1004,35,38,73,47.9%,1h
22937,1,哔哩哔哩放电妹,2320,514,16,19,35,45.7%,3m
22937,1,野嘎大王,2320,562,16,26,42,38.1%,1h
22937,3,佟明,2320,407,15,23,38,39.5%,29m
22937,1,冬风听雨,2320,421,13,10,23,56.5%,1h
22937,2,蛇皮少年,2320,351,13,11,24,54.2%,48m
22937,3,[中二疯人院]刷叉就完事了,2320,405,13,19,32,40.6%,11m
22937,1,嘟嘟粑粑,2320,256,11,9,20,55.0%,1h
22937,1,你妻任我骑,2320,244,8,5,13,61.5%,14m
22937,1,simon,2320,245,8,8,16,50.0%,14m
22937,1,TrafalgarLaw,2320,286,7,12,19,36.8%,25m
22937,1,[大主教后援团]欧尼酱,2320,179,6,2,8,75.0%,27m
22937,2,HANDHOME,2320,177,5,7,12,41.7%,3m
22937,1,大帥,2320,144,4,4,8,50.0%,11m
22937,1,giao,2320,144,4,7,11,36.4%,1h
22937,1,LYSFATHER,2320,103,3,3,6,50.0%,1h
22937,1,[smile]阿斯兰不死鸟,2320,120,3,6,9,33.3%,6m
22937,3,我滴明治叫老八,2320,157,3,8,11,27.3%,1h
22937,1,[晋升者]IIIIIIIIIIII,2320,96,2,1,3,66.7%,1h
22937,1,[DVL]Tianyl,2320,30,2,2,4,50.0%,45m
22937,2,MengQi,2320,0,1,0,1,100.0%,1h
22937,1,冰封,2320,36,1,5,6,16.7%,1h
22937,1,Sam,2320,0,0,3,3,0.0%,1h
22961,1,[奈落]高桥凉介,2319,824,70,62,132,53.0%,14m
22961,1,炸鱼,2319,1137,44,43,87,50.6%,10m
22961,3,lovelove,2319,643,39,42,81,48.1%,1h
22961,1,张横大帅比,2319,563,27,22,49,55.1%,9m
22961,1,好人啊啊,2319,286,11,9,20,55.0%,23m
22961,3,aaaaaaaa,2319,262,10,9,19,52.6%,1h
22961,3,忧丶零少,2319,287,10,10,20,50.0%,7m
22961,1,萝卜慝,2319,324,10,11,21,47.6%,41m
22961,1,诡狼杀,2319,318,8,13,21,38.1%,3m
22961,2,天尊杨戬,2319,216,6,3,9,66.7%,40m
22961,1,龍少爷,2319,212,6,5,11,54.5%,3m
22961,1,[老班干]灰太郎,2319,176,6,10,16,37.5%,1h
22961,2,[DMR]candy,2319,152,5,2,7,71.4%,52m
22961,3,莲华,2319,88,5,10,15,33.3%,25m
22961,3,永远有多远嘞,2319,153,3,16,19,15.8%,25m
22961,2,[萌的一笔]李嘉图,2319,58,2,1,3,66.7%,48m
22961,3,[犹豫12败北]白给少年,2319,60,2,6,8,25.0%,16m
22961,2,逍遥天境,2319,0,1,0,1,100.0%,50m
22961,2,玩乐高的星际玩家,2319,0,1,0,1,100.0%,1h
22961,1,骷髅凯撒,2319,48,1,1,2,50.0%,11m
22961,2,MinimiZeD,2319,0,1,5,6,16.7%,38m
22961,2,来自上帝的微笑,2319,0,0,1,1,0.0%,5m
22983,1,泡泡茶壶,2318,1737,90,84,174,51.7%,25m
22983,1,lianchao,2318,1231,66,71,137,48.2%,41m
22983,1,我是新手,2318,952,53,63,116,45.7%,26m
22983,1,龙魂英豪,2318,1140,37,41,78,47.4%,1h
22983,1,Beta,2318,547,15,21,36,41.7%,1h
22983,1,终是一厢情愿,2318,337,11,7,18,61.1%,34m
22983,1,[Mentor]龙骨,2318,398,11,11,22,50.0%,1h
22983,3,Pretend,2318,296,10,14,24,41.7%,7m
22983,2,[X英雄圣域X]dooooog,2318,244,8,13,21,38.1%,1h
22983,1,望玥愁断肠,2318,326,7,10,17,41.2%,15m
22983,3,Chailinge,2318,147,5,9,14,35.7%,1h
22983,2,[TCP]帕克斯顿,2318,118,4,4,8,50.0%,18m
22983,1,钛合金,2318,0,3,3,6,50.0%,1h
22983,2,sneakysquid,2318,0,1,0,1,100.0%,40m
22983,2,[彼岸之花]Leo,2318,0,1,0,1,100.0%,40m
22983,1,香蕉红了,2318,0,1,2,3,33.3%,1h
22983,2,队长哈哈哈,2318,0,1,3,4,25.0%,56m
22983,2,战神天狼星,2318,0,1,5,6,16.7%,56m
22983,1,番茄,2318,0,1,5,6,16.7%,17m
22983,2,[Evolos]无惘微光,2318,0,0,1,1,0.0%,1h
23003,1,红衣纳迪娜,2317,987,58,55,113,51.3%,1h
23003,1,星衰,2317,372,14,12,26,53.8%,14m
23003,2,Silence,2317,354,12,26,38,31.6%,12m
23003,3,義小樂,2317,221,9,10,19,47.4%,1h
23003,1,是有遗憾吧,2317,302,8,14,22,36.4%,54m
23003,1,澐氺氷蘫,2317,278,7,13,20,35.0%,39m
23003,3,faker,2317,187,6,11,17,35.3%,1h
23003,3,asdadf,2317,166,5,5,10,50.0%,1h
23003,1,吃光你家米,2317,144,5,9,14,35.7%,1h
23003,2,隔壁池塘的鱼,2317,201,5,11,16,31.2%,1h
23003,1,xiaoxia,2317,106,3,3,6,50.0%,46m
23003,1,不会玩,2317,144,3,5,8,37.5%,1h
23003,2,给你一万只熊,2317,92,3,7,10,30.0%,1h
23003,1,怒吼天尊,2317,38,2,2,4,50.0%,1h
23003,2,赵昱江,2317,0,2,3,5,40.0%,54m
23003,1,微笑心灵,2317,0,2,4,6,33.3%,17m
23003,2,逍遥子,2317,0,1,0,1,100.0%,33m
23003,2,傻傻呀,2317,0,1,0,1,100.0%,1h
23003,1,start,2317,0,1,1,2,50.0%,25m
23003,2,[光井琉璃]亚璃子丶,2317,30,1,1,2,50.0%,43m
23003,2,[超实验级的]magicmarine,2317,44,1,1,2,50.0%,1h
23003,1,刀巴小猫,2317,0,1,2,3,33.3%,1h
23003,2,淦淦,2317,0,1,4,5,20.0%,38m
23003,2,凡吊毛,2317,0,1,4,5,20.0%,1h
23003,2,sssss,2317,0,0,3,3,0.0%,38m
23028,1,爆三样,2316,1265,104,102,206,50.5%,1h
23028,1,我是菜鸡,2316,520,28,20,48,58.3%,34m
23028,2,九泉,2316,295,15,4,19,78.9%,1h
23028,1,同化完成了,2316,338,14,19,33,42.4%,1h
23028,3,RAYNOR,2316,144,9,10,19,47.4%,21m
23028,3,斯雷因,2316,240,7,14,21,33.3%,1h
23028,1,[aeahz]IIINNOVATION,2316,112,6,11,17,35.3%,45m
23028,3,Never,2316,168,5,2,7,71.4%,1h
23028,2,送你个核弹,2316,192,5,2,7,71.4%,1h
23028,1,天上的声名,2316,231,5,8,13,38.5%,21m
23028,1,GQZ,2316,142,4,3,7,57.1%,44m
23028,1,笑话,2316,114,4,7,11,36.4%,1h
23028,2,MAN,2316,0,3,2,5,60.0%,1h
23028,1,[咕咕学院]iik,2316,80,3,3,6,50.0%,23m
23028,3,TCPGHY,2316,58,3,5,8,37.5%,1h
23028,2,简单电脑,2316,0,1,0,1,100.0%,1h
23028,1,泷十八,2316,48,1,4,5,20.0%,26m
23028,2,康桥之风,2316,0,1,4,5,20.0%,26m
23028,1,你好,2316,0,0,2,2,0.0%,1h
23047,1,[犀利颤抖机]比比啾,2315,1266,161,156,317,50.8%,1h
23047,1,TerRin,2315,1046,81,74,155,52.3%,14m
23047,1,Jiao,2315,989,64,68,132,48.5%,39m
23047,1,Stormy,2315,1208,48,47,95,50.5%,1h
23047,1,[A死你]小虾米,2315,843,27,28,55,49.1%,3m
23047,1,Bluecat,2315,552,23,21,44,52.3%,1h
23047,1,John,2315,464,17,22,39,43.6%,1h
23047,3,胡子,2315,314,14,10,24,58.3%,30m
23047,3,Caesar,2315,243,13,18,31,41.9%,21m
23047,1,ttaab,2315,274,11,17,28,39.3%,1h
23047,1,huige,2315,336,10,12,22,45.5%,27m
23047,3,[北境]独立团李云龙,2315,277,9,14,23,39.1%,1h
23047,3,阿斯达,2315,265,8,8,16,50.0%,1h
23047,1,[howare]小怪兽,2315,180,5,4,9,55.6%,1h
23047,3,安因兹乌尔贡,2315,92,5,9,14,35.7%,1h
23047,1,佛挡杀佛,2315,160,4,3,7,57.1%,45m
23047,2,second,2315,134,4,4,8,50.0%,1h
23047,2,[荣耀归来]房子大地方,2315,93,1,3,4,25.0%,1h
23047,1,lbwnb,2315,0,1,7,8,12.5%,41m
23047,2,[星际合作群]银翼,2315,0,0,1,1,0.0%,60m
23047,1,路明非,2315,0,0,1,1,0.0%,38m
23047,3,caret,2315,0,0,4,4,0.0%,25m
23069,3,明天吃啥,2314,724,90,88,178,50.6%,23m
23069,1,流觞,2314,543,24,23,47,51.1%,46m
23069,1,doctor,2314,595,20,16,36,55.6%,1h
23069,1,salazals,2314,373,20,18,38,52.6%,1h
23069,1,Freedom,2314,445,18,16,34,52.9%,21m
23069,1,柯西不等式,2314,423,17,15,32,53.1%,46m
23069,1,白泽,2314,275,14,12,26,53.8%,23m
23069,3,llllllllllll,2314,379,13,24,37,35.1%,27m
23069,3,浅念,2314,259,12,9,21,57.1%,1h
23069,1,[旋风游骑兵]克己,2314,296,9,7,16,56.2%,1h
23069,2,老鐵木真的假的,2314,272,9,8,17,52.9%,1h
23069,1,喵帕斯哈,2314,257,9,18,27,33.3%,21m
23069,1,川耀战队机枪海,2314,186,5,11,16,31.2%,25m
23069,2,无视对方,2314,48,4,3,7,57.1%,11m
23069,1,kobe,2314,74,3,6,9,33.3%,1h
23069,3,凋谢的尘埃,2314,97,2,0,2,100.0%,1h
23069,1,Eatlich,2314,95,2,1,3,66.7%,1h
23069,1,Edith,2314,76,2,5,7,28.6%,1h
23069,2,优秀乄张野迪,2314,0,1,4,5,20.0%,33m
23069,2,[白楼门]普普通通的叉叉兵,2314,0,0,1,1,0.0%,1h
23069,1,我的名字叫法,2314,0,0,2,2,0.0%,20m
23090,1,efsfsd,2313,1201,50,50,100,50.0%,3m
23090,2,[星辰舰队]理解器,2313,292,38,30,68,55.9%,1h
23090,1,掌心的温差,2313,981,37,32,69,53.6%,1h
23090,1,BLIce,2313,647,25,28,53,47.2%,25m
23090,3,黑丝白丝爱丽丝,2313,487,20,26,46,43.5%,1h
23090,1,[织田家的]Anyway,2313,394,12,17,29,41.4%,46m
23090,1,各安天命,2313,407,11,12,23,47.8%,1h
23090,2,喜悦的源头,2313,46,4,3,7,57.1%,1h
23090,2,killer,2313,0,3,2,5,60.0%,55m
23090,1,卡密尔,2313,116,3,3,6,50.0%,1h
23090,3,hkjhj,2313,122,3,4,7,42.9%,1h
23090,1,[励志第一]香脆杏仁饼,2313,103,2,2,4,50.0%,1h
23090,1,未遂,2313,40,1,3,4,25.0%,41m
23090,2,AnthonyJhon,2313,0,0,1,1,0.0%,1h
23090,2,恋凡伴逸仙,2313,0,0,1,1,0.0%,1h
23090,2,[yeshi]缘来如些,2313,0,0,1,1,0.0%,1h
23090,1,彩虹达人丶,2313,0,0,5,5,0.0%,3m
23107,1,菜鸟之路,2312,1536,52,58,110,47.3%,14m
23107,1,ZDZ,2312,755,36,23,59,61.0%,1h
23107,1,[星际之夜]啸傲林泉,2312,530,16,20,36,44.4%,3m
23107,2,莫凡,2312,416,14,16,30,46.7%,1h
23107,2,[摸锤子]御坂美琴,2312,269,11,1,12,91.7%,17m
23107,2,gsfm,2312,317,10,17,27,37.0%,1h
23107,1,buwanmei,2312,151,9,7,16,56.2%,1h
23107,1,流泪的铁罐,2312,258,8,11,19,42.1%,3m
23107,2,[纸鸢i]猪儿虫,2312,223,7,14,21,33.3%,28m
23107,1,隔壁老王,2312,102,3,1,4,75.0%,1h
23107,1,Canaan,2312,0,3,4,7,42.9%,21m
23107,1,[日日]这里不是日日吖,2312,125,3,4,7,42.9%,25m
23107,1,娄艺潇,2312,0,3,7,10,30.0%,1h
23107,2,[Ymur]IlIlIlIlIlIl,2312,40,2,1,3,66.7%,60m
23107,2,andnald,2312,0,2,4,6,33.3%,1h
23107,3,听不见,2312,60,2,5,7,28.6%,1h
23107,1,舔我的迪奥,2312,48,2,7,9,22.2%,11m
23107,2,[斯巴达血战团]sunshine,2312,0,1,0,1,100.0%,1h
23107,2,你要回城了,2312,0,0,1,1,0.0%,12m
23107,1,茫然,2312,0,0,2,2,0.0%,6m
23127,1,yingfengxiza,2311,1571,102,103,205,49.8%,1h
23127,1,GoguoBor,2311,598,44,59,103,42.7%,26m
23127,1,free,2311,785,38,34,72,52.8%,51m
23127,2,dutys,2311,825,31,32,63,49.2%,1h
23127,1,天黑了你怕了吗,2311,763,31,34,65,47.7%,23m
23127,3,indexsss,2311,568,22,31,53,41.5%,29m
23127,2,scud,2311,484,20,25,45,44.4%,40m
23127,3,只会流氓舰队啊,2311,268,9,11,20,45.0%,1h
23127,2,雷小兵,2311,151,8,9,17,47.1%,40m
23127,1,ttt,2311,274,7,15,22,31.8%,52m
23127,1,[贰伍仔集中营]多读读书,2311,139,5,12,17,29.4%,25m
23127,3,回忆凋零,2311,154,4,2,6,66.7%,1h
23127,1,刘宇耶,2311,96,3,3,6,50.0%,25m
23127,1,紫星会,2311,80,3,4,7,42.9%,55m
23127,3,Zikp,2311,0,3,7,10,30.0%,27m
23127,3,红宝石,2311,0,2,4,6,33.3%,41m
23127,1,来呀打我呀,2311,0,1,1,2,50.0%,21m
23127,2,只是蝴蝶不愿意,2311,0,1,1,2,50.0%,15m
23127,2,DonaL,2311,0,1,1,2,50.0%,1h
23127,1,[星际情侣]宇宙第一帅,2311,0,1,3,4,25.0%,11m
23127,2,艾尔之光,2311,0,1,4,5,20.0%,54m
23127,2,[YMSB]三角队,2311,0,0,1,1,0.0%,1h
23127,1,一个六零,2311,0,0,3,3,0.0%,1h
23150,1,真夏夜的野兽先辈,2310,1497,58,54,112,51.8%,1h
23150,1,寻找减肥的朱古力,2310,858,56,58,114,49.1%,1h
23150,1,遗忘的利刃,2310,614,30,15,45,66.7%,1h
23150,1,Destroyer,2310,362,14,19,33,42.4%,21m
23150,2,maomao,2310,366,12,14,26,46.2%,59m
23150,1,scv,2310,218,6,5,11,54.5%,1h
23150,1,FXY,2310,194,6,11,17,35.3%,1h
23150,1,xiaojie,2310,206,5,6,11,45.5%,25m
23150,1,llllllllllll,2310,114,4,3,7,57.1%,1h
23150,2,IIIIIIIIIIII,2310,86,3,1,4,75.0%,29m
23150,1,Tamaki,2310,112,3,2,5,60.0%,1h
23150,2,BackPacker,2310,90,3,3,6,50.0%,15m
23150,1,色柚,2310,97,2,6,8,25.0%,1h
23150,1,吾恋椿楸,2310,97,2,6,8,25.0%,59m
23150,2,游埠流浪汉,2310,0,1,0,1,100.0%,15m
23150,2,dajiba,2310,0,1,0,1,100.0%,22m
23150,2,ZhangTianyan,2310,96,1,1,2,50.0%,52m
23150,1,[七宫智音]冬瓜你个茄子,2310,0,1,1,2,50.0%,10m
23150,1,FrozenHeart,2310,0,1,1,2,50.0%,41m
23150,2,win,2310,0,1,2,3,33.3%,1h
23150,2,石头头,2310,0,0,1,1,0.0%,1h
23150,2,[暴风雨]布死甜汤,2310,0,0,1,1,0.0%,1h
23150,2,帅泽,2310,0,0,2,2,0.0%,1h
23150,1,[社交学大可爱]探姬遭到公鸡,2310,0,0,3,3,0.0%,9m
23174,2,monenx,2309,1355,87,92,179,48.6%,1h
23174,3,年少无知,2309,586,25,26,51,49.0%,1h
23174,2,nameless,2309,580,20,21,41,48.8%,1h
23174,1,[Ryon榕]超能勇士,2309,472,14,14,28,50.0%,1h
23174,3,要会娇喘女森,2309,187,6,6,12,50.0%,1h
23174,1,ulrezal,2309,200,4,6,10,40.0%,3m
23174,1,八云暗,2309,111,3,2,5,60.0%,24m
23174,1,llllllllllll,2309,78,3,3,6,50.0%,1h
23174,1,[LDP]summer,2309,138,3,4,7,42.9%,36m
23174,3,since,2309,147,3,6,9,33.3%,9m
23174,2,飞野,2309,0,1,4,5,20.0%,1h
23174,2,Waitforlove,2309,0,1,5,6,16.7%,1h
23174,2,sie,2309,0,0,1,1,0.0%,27m
23174,2,入戏太深,2309,0,0,1,1,0.0%,54m
23174,2,[理想的幻想乡]死亡之咒,2309,0,0,2,2,0.0%,1h
23174,1,新手小杨,2309,0,0,2,2,0.0%,45m
23174,1,palladium,2309,0,0,2,2,0.0%,10m
23191,3,弯兔睡狗,2308,788,184,192,376,48.9%,1h
23191,1,AlwaysYng,2308,1260,103,115,218,47.2%,14m
23191,1,[光影双修]BJayW,2308,1280,48,52,100,48.0%,21m
23191,1,[通灵女孩]絕歌,2308,941,38,39,77,49.4%,9m
23191,1,怪盗基德,2308,720,26,26,52,50.0%,3m
23191,1,JerkJ,2308,691,22,27,49,44.9%,1h
23191,1,[爱哭一把泪]申易,2308,649,21,21,42,50.0%,19m
23191,1,wdnmd,2308,456,13,22,35,37.1%,51m
23191,1,[输赢靠我旭东]EVIL,2308,355,12,8,20,60.0%,1h
23191,1,云影舒月,2308,158,5,2,7,71.4%,1h
23191,1,我是钢浪,2308,148,4,6,10,40.0%,23m
23191,2,alpziz,2308,66,3,0,3,100.0%,12m
23191,2,BotMan,2308,72,2,7,9,22.2%,1h
23191,3,www,2308,0,2,8,10,20.0%,37m
23191,2,TianMei,2308,0,1,0,1,100.0%,54m
23191,2,为了艾尔,2308,0,1,0,1,100.0%,31m
23191,2,ChengYang,2308,32,1,3,4,25.0%,1h
23191,2,每期,2308,0,1,5,6,16.7%,1h
23191,2,错的是世界啊,2308,0,0,2,2,0.0%,59m
23191,1,大野爹,2308,0,0,3,3,0.0%,1h
23211,1,空白,2307,1534,76,67,143,53.1%,34m
23211,1,礼品卡为阿见,2307,1043,38,42,80,47.5%,39m
23211,3,XIAOXAIO,2307,585,33,44,77,42.9%,1m
23211,1,[慢手e族]TUT,2307,869,29,33,62,46.8%,38m
23211,1,Freedom,2307,606,18,24,42,42.9%,6m
23211,1,[二刺螈肥宅]微叼丝丿,2307,631,17,24,41,41.5%,1h
23211,3,驴毛,2307,367,13,17,30,43.3%,5m
23211,1,天之河,2307,337,12,9,21,57.1%,55m
23211,1,快乐小车车,2307,327,12,10,22,54.5%,14m
23211,2,[113]电脑,2307,352,11,14,25,44.0%,1h
23211,1,SHowMaKer,2307,326,10,12,22,45.5%,36m
23211,2,三月初三,2307,236,9,4,13,69.2%,1h
23211,2,[吃饭不吃菜]KotchiaSanae,2307,114,5,1,6,83.3%,33m
23211,3,阿呆,2307,97,4,6,10,40.0%,1h
23211,2,STY,2307,168,4,7,11,36.4%,1h
23211,2,[DMRc]瓦尔基里之约,2307,0,1,0,1,100.0%,1h
23211,1,[我爱屠鸡]decade,2307,0,1,2,3,33.3%,18m
23211,2,黄金舰队,2307,0,1,2,3,33.3%,1h
23211,2,[跑山鸡]世界青年,2307,0,0,1,1,0.0%,27m
23211,2,江瘤儿,2307,0,0,1,1,0.0%,54m
23211,2,dogbases,2307,0,0,1,1,0.0%,56m
23211,2,AiurProtoss,2307,0,0,3,3,0.0%,1h
23233,1,帅气,2306,1134,76,77,153,49.7%,34m
23233,1,uraNus,2306,948,33,41,74,44.6%,25m
23233,1,军力,2306,597,23,17,40,57.5%,18m
23233,1,眼瞎玩家,2306,437,19,13,32,59.4%,21m
23233,1,[铸剑为犁]CouRage,2306,374,12,9,21,57.1%,38m
23233,1,九亿少女的梦,2306,248,8,7,15,53.3%,15m
23233,3,king,2306,225,7,13,20,35.0%,13m
23233,2,倰思,2306,68,6,11,17,35.3%,1h
23233,1,战魂,2306,183,5,8,13,38.5%,46m
23233,1,上白泽慧音,2306,136,4,5,9,44.4%,44m
23233,1,一个小塞图,2306,145,3,7,10,30.0%,57m
23233,1,nibaba,2306,96,3,8,11,27.3%,38m
23233,2,你大哥一不小心,2306,94,2,4,6,33.3%,33m
23233,1,幸福的茄子,2306,0,1,0,1,100.0%,14m
23233,2,[NewV]foyes,2306,0,1,0,1,100.0%,1h
23233,2,[灰冥]Isshin,2306,0,1,0,1,100.0%,60m
23233,2,胆怯的泽法,2306,0,0,1,1,0.0%,50m
23233,2,[你瞧不起我吗]alll,2306,0,0,2,2,0.0%,1h
23233,2,嘤嘤怪,2306,0,0,3,3,0.0%,1h
23252,1,波波,2305,1387,49,56,105,46.7%,53m
23252,2,寻夜忆平,2305,718,25,20,45,55.6%,1h
23252,2,五十块好兄弟,2305,273,11,12,23,47.8%,33m
23252,3,你想拘泥,2305,243,10,9,19,52.6%,1h
23252,2,斯卡蒂,2305,277,9,16,25,36.0%,33m
23252,3,乔桑,2305,199,6,6,12,50.0%,41m
23252,2,夜航星,2305,88,4,1,5,80.0%,1h
23252,1,卢本伟,2305,140,4,7,11,36.4%,1h
23252,1,[YMSX]hacker,2305,0,2,4,6,33.3%,38m
23252,1,[白丝至高]无情峰某人,2305,0,2,4,6,33.3%,11m
23252,2,雪茄狐,2305,0,1,0,1,100.0%,33m
23252,2,[工蜂]小萌新,2305,0,1,0,1,100.0%,15m
23252,2,萌新威望肝出血,2305,30,1,1,2,50.0%,12m
23252,1,[五月花]bodliu,2305,0,1,1,2,50.0%,1h
23252,1,玩腻,2305,0,1,2,3,33.3%,54m
23252,1,[765事务所]箱崎星梨花,2305,0,0,1,1,0.0%,1h
23252,2,[花飞水剪]SkyNuke,2305,0,0,1,1,0.0%,12m
23252,2,[X英雄圣域X]有人吗,2305,0,0,1,1,0.0%,15m
23252,2,优雅永不过时,2305,0,0,6,6,0.0%,1h
23271,1,德玛西亚,2304,1734,197,196,393,50.1%,1h
23271,1,叁月丶初四,2304,1058,58,50,108,53.7%,1h
23271,1,wound,2304,587,27,23,50,54.0%,19m
23271,1,Steppenwolf,2304,798,25,30,55,45.5%,1h
23271,1,[HNNDS]lye,2304,522,18,22,40,45.0%,1h
23271,3,易小函,2304,309,10,13,23,43.5%,24m
23271,3,llllllllllll,2304,249,7,12,19,36.8%,13m
23271,1,黑岩的塞巴斯,2304,185,5,4,9,55.6%,1h
23271,1,沉默之风暴,2304,211,5,4,9,55.6%,17m
23271,3,想取骚名不知取啥,2304,172,4,7,11,36.4%,7m
23271,3,YuMian,2304,144,3,4,7,42.9%,10m
23271,2,BRYANT,2304,48,2,4,6,33.3%,54m
23271,1,[科普鲁苏维埃]Spectre,2304,96,1,1,2,50.0%,37m
23271,1,[修仙大队]忘川的引渡人,2304,97,1,2,3,33.3%,26m
23271,2,哇哇哇,2304,0,1,2,3,33.3%,26m
23271,2,电脑简单,2304,0,1,4,5,20.0%,1h
23271,2,RPG,2304,0,0,1,1,0.0%,1h
23271,3,dark,2304,0,0,2,2,0.0%,21m
23289,3,Jack,2303,896,161,180,341,47.2%,16m
23289,1,掠天之翼,2303,724,24,23,47,51.1%,27m
23289,1,落夜悠伤,2303,682,22,29,51,43.1%,54m
23289,1,arthas,2303,507,21,27,48,43.8%,3m
23289,1,焦糖,2303,565,18,24,42,42.9%,46m
23289,1,茗人晓,2303,482,14,19,33,42.4%,14m
23289,2,干饭人,2303,311,13,12,25,52.0%,52m
23289,2,士兵官,2303,297,10,17,27,37.0%,1h
23289,2,yuezhouzhou,2303,192,8,3,11,72.7%,52m
23289,2,[天羽不榖]玩家武将,2303,174,7,2,9,77.8%,29m
23289,2,[Nightm]八云华,2303,142,6,1,7,85.7%,40m
23289,1,小枫,2303,104,3,1,4,75.0%,10m
23289,1,掠影丨星河,2303,118,3,5,8,37.5%,1h
23289,2,爷傲奶我何,2303,46,2,5,7,28.6%,60m
23289,1,Drrey,2303,97,2,6,8,25.0%,26m
23289,2,平淡淡,2303,0,1,0,1,100.0%,26m
23289,1,wongrong,2303,0,1,2,3,33.3%,1h
23289,1,蒙斯克,2303,48,1,2,3,33.3%,41m
23289,1,Destroy,2303,0,1,3,4,25.0%,1h
23289,2,[暴雪三十二隊]伤之何殇,2303,0,1,5,6,16.7%,1h
23289,2,[老大哥]张市长,2303,0,0,1,1,0.0%,12m
23289,2,某科学的咖喱棒,2303,0,0,1,1,0.0%,50m
23289,1,tianxuan,2303,0,0,1,1,0.0%,1h
23289,3,apostle,2303,0,0,1,1,0.0%,16m
23313,1,老六,2302,299,10,8,18,55.6%,1h
23313,1,Alicy,2302,322,9,11,20,45.0%,6m
23313,2,[雾雨魔法森林]自闭人,2302,130,4,0,4,100.0%,4m
23313,2,纯白的熊猫,2302,0,1,5,6,16.7%,11m
23317,1,粉红少女郭德纲,2301,1186,58,49,107,54.2%,3m
23317,1,仁义大都督,2301,902,57,60,117,48.7%,1h
23317,1,OneHappySCV,2301,545,34,38,72,47.2%,1h
23317,1,麦克米兰中士,2301,565,21,21,42,50.0%,31m
23317,1,法规汇,2301,370,14,10,24,58.3%,9m
23317,1,小探机,2301,265,10,7,17,58.8%,34m
23317,1,[hddys]远杂技,2301,164,5,4,9,55.6%,1h
23317,1,[倚栏夜听雨]BreathlnG,2301,166,5,5,10,50.0%,53m
23317,2,electronic,2301,122,4,2,6,66.7%,18m
23317,1,你不行啊,2301,84,4,5,9,44.4%,39m
23317,1,星齐,2301,96,4,9,13,30.8%,1h
23317,3,DYc,2301,66,4,12,16,25.0%,1h
23317,1,[清帝国]FREE,2301,145,3,8,11,27.3%,12m
23317,1,邻危不救过河吃桥,2301,61,2,11,13,15.4%,51m
23317,2,旧时读心者,2301,0,1,0,1,100.0%,1h
23317,2,柳益没有妈,2301,0,1,0,1,100.0%,12m
23317,2,落魄中的崛起,2301,0,1,0,1,100.0%,1h
23317,2,wad,2301,0,1,1,2,50.0%,10m
23317,1,超吉尔雷鶸,2301,48,1,5,6,16.7%,1h
23317,2,devil,2301,0,1,5,6,16.7%,38m
23317,2,热心怒,2301,0,0,1,1,0.0%,1h
23317,2,接班人,2301,0,0,1,1,0.0%,1h
23317,3,[Esper]一蓑烟雨任平生,2301,0,0,1,1,0.0%,1h
23317,2,[新的蜜蜂]Summit,2301,0,0,2,2,0.0%,1h
23317,1,和纱的愚忠分子,2301,0,0,2,2,0.0%,21m
23342,1,[极限菜鸟]渣渣,2300,1624,114,101,215,53.0%,3m
23342,1,[酒池肉林]Sky,2300,1038,48,49,97,49.5%,1h
23342,1,ShallowDream,2300,394,40,35,75,53.3%,24m
23342,1,南邮码王,2300,428,32,27,59,54.2%,1h
23342,2,唐宋元明清,2300,690,28,20,48,58.3%,49m
23342,1,最佳男配角,2300,568,17,18,35,48.6%,34m
23342,2,halt,2300,376,14,5,19,73.7%,17m
23342,1,[嗑药小分队]一小远一,2300,193,7,7,14,50.0%,41m
23342,2,carlon,2300,154,6,3,9,66.7%,18m
23342,2,Hernt,2300,183,6,3,9,66.7%,1h
23342,1,sincejuly,2300,147,5,6,11,45.5%,1h
23342,3,天地上乘有顶天,2300,177,5,7,12,41.7%,41m
23342,1,攸宁,2300,144,4,6,10,40.0%,1h
23342,1,高老庄里没有她,2300,96,4,7,11,36.4%,1h
23342,1,布布吃饱了,2300,173,4,8,12,33.3%,41m
23342,3,这小伙子很帅,2300,121,4,9,13,30.8%,25m
23342,2,HALAJIS,2300,60,2,2,4,50.0%,41m
23342,2,大帅兽,2300,0,1,0,1,100.0%,1h
23342,2,[UNSCC]凌寒,2300,46,1,1,2,50.0%,1h
23342,1,Peter,2300,95,1,1,2,50.0%,41m
23342,2,飞龙骑脸,2300,0,1,5,6,16.7%,1h
23342,2,窈窕淑女号,2300,0,0,1,1,0.0%,1h
23342,2,[皇族]Ililillliiil,2300,0,0,2,2,0.0%,1h
23342,1,Drunk,2300,0,0,3,3,0.0%,36m
23342,2,怕死的毒爆,2300,0,0,5,5,0.0%,54m
23342,1,good,2300,0,0,7,7,0.0%,1h
23368,1,独自两人,2299,797,27,24,51,52.9%,25m
23368,1,殇月,2299,313,12,10,22,54.5%,1h
23368,1,[长征小白]沙加在世,2299,389,11,11,22,50.0%,6m
23368,2,啦啦啦,2299,266,10,3,13,76.9%,1h
23368,1,doge,2299,234,7,11,18,38.9%,1h
23368,1,好吧搏命,2299,232,5,7,12,41.7%,10m
23368,1,winfrog,2299,0,4,3,7,57.1%,57m
23368,1,MAXOPG,2299,132,3,4,7,42.9%,1h
23368,2,从零开始玩天梯,2299,60,2,7,9,22.2%,1h
23368,2,[电脑l难度]专家,2299,0,1,0,1,100.0%,56m
23368,1,wang,2299,96,1,1,2,50.0%,16m
23368,2,程晓阳,2299,32,1,2,3,33.3%,50m
23368,1,派大蒙,2299,0,1,3,4,25.0%,25m
23381,1,YJG,2298,1084,53,62,115,46.1%,1h
23381,1,Normer,2298,842,32,36,68,47.1%,1h
23381,2,[DGL丿茗门]埃尔德尼亚,2298,471,19,12,31,61.3%,1h
23381,2,灵笼,2298,514,18,24,42,42.9%,1h
23381,2,郑郭,2298,273,17,8,25,68.0%,52m
23381,3,云天自在,2298,470,16,37,53,30.2%,23m
23381,1,XiaoM,2298,339,9,4,13,69.2%,1h
23381,1,Fraud,2298,261,9,15,24,37.5%,24m
23381,1,悲伤啥吊,2298,218,8,17,25,32.0%,39m
23381,1,kingForNight,2298,269,7,8,15,46.7%,1h
23381,1,专杀小贼,2298,96,5,8,13,38.5%,21m
23381,1,除非包吃包住,2298,90,4,7,11,36.4%,38m
23381,2,KUANG,2298,86,3,1,4,75.0%,1h
23381,1,[战旗娱乐圈]小刃,2298,114,3,2,5,60.0%,1h
23381,2,蒙古水师,2298,0,3,10,13,23.1%,28m
23381,2,呆毛王,2298,0,1,0,1,100.0%,1h
23381,2,塔克架大河,2298,0,1,0,1,100.0%,33m
23381,1,星际之遗,2298,0,1,3,4,25.0%,39m
23381,2,博丽灵梦,2298,0,1,5,6,16.7%,33m
23381,2,[一King一]人身很漫长,2298,0,1,5,6,16.7%,1h
23381,1,梦比优斯,2298,0,1,6,7,14.3%,1h
23381,1,江江,2298,0,1,7,8,12.5%,26m
23381,2,一瞬间,2298,0,0,1,1,0.0%,1h
23381,2,[我们是瞎子]影刃,2298,0,0,2,2,0.0%,12m
23381,1,蜘蛛,2298,0,0,3,3,0.0%,51m
23406,1,剪剪风,2297,1720,217,216,433,50.1%,1h
23406,2,[NVKR]欢颜,2297,1434,88,86,174,50.6%,1h
23406,1,[绵阳黄旭东]碧绿,2297,1033,68,63,131,51.9%,52m
23406,1,[慢手e族]bang,2297,883,53,49,102,52.0%,1h
23406,2,大梦小半,2297,663,51,46,97,52.6%,18m
23406,1,流星,2297,608,23,30,53,43.4%,3m
23406,2,余江第一帅,2297,419,17,15,32,53.1%,1h
23406,1,华丽凯歌,2297,398,14,12,26,53.8%,10m
23406,1,honglu,2297,167,4,5,9,44.4%,6m
23406,1,IIIIIIIIIIII,2297,140,4,12,16,25.0%,1h
23406,2,[SFF]pig,2297,64,2,4,6,33.3%,1h
23406,1,IIIIIIIIIIII,2297,48,2,5,7,28.6%,1h
23406,1,Lex,2297,96,2,7,9,22.2%,59m
23406,2,qiange,2297,0,1,1,2,50.0%,10m
23406,1,[爱国]天下,2297,0,1,2,3,33.3%,3m
23406,2,CAT,2297,0,1,3,4,25.0%,56m
23422,1,夜月月黑,2296,1294,249,284,533,46.7%,3m
23422,1,上官灬冷风,2296,1156,46,34,80,57.5%,1h
23422,1,[最菜战队]adssdfffwqq,2296,430,26,26,52,50.0%,19m
23422,2,kindknight,2296,249,15,14,29,51.7%,1h
23422,1,御坂钢琴,2296,314,10,13,23,43.5%,46m
23422,3,[GANK]嗜血魔神,2296,121,4,8,12,33.3%,2m
23422,2,半世修情半世修爱,2296,0,1,0,1,100.0%,1h
23422,2,nimazha,2296,0,1,0,1,100.0%,5m
23422,1,llllllllllll,2296,0,1,0,1,100.0%,1h
23422,1,[博学者]好名字都被狗取了,2296,0,1,2,3,33.3%,14m
23422,2,xiaohhhhh,2296,0,1,4,5,20.0%,12m
23422,2,icecream,2296,0,0,1,1,0.0%,49m
23422,2,专门打击胖子,2296,0,0,1,1,0.0%,41m
23422,2,wyj,2296,0,0,2,2,0.0%,1h
23422,1,[99ms]QTboom,2296,0,0,4,4,0.0%,1h
23437,1,TZero,2295,1690,119,119,238,50.0%,53m
23437,3,花生芽,2295,1296,80,84,164,48.8%,13m
23437,1,星际三少,2295,854,27,34,61,44.3%,9m
23437,1,[菜有菜的道理]叶修,2295,320,13,9,22,59.1%,7m
23437,2,sasaas,2295,250,9,6,15,60.0%,28m
23437,2,[TNLet]Solar,2295,198,8,3,11,72.7%,26m
23437,1,荣耀指引我,2295,258,8,8,16,50.0%,42m
23437,1,我是小芋头,2295,144,6,8,14,42.9%,1h
23437,2,gdfbh,2295,130,4,4,8,50.0%,33m
23437,2,qianlibiaoHR,2295,0,2,3,5,40.0%,26m
23437,2,[一拳人族]黑羽幻,2295,46,2,5,7,28.6%,33m
23437,2,GeorgeMikan,2295,34,1,2,3,33.3%,1h
23437,1,狌先生,2295,34,1,3,4,25.0%,3m
23437,1,马尔科罗伊斯,2295,0,1,4,5,20.0%,38m
23437,2,请安静,2295,0,1,4,5,20.0%,1h
23437,2,寒玖生,2295,0,0,2,2,0.0%,34m
23453,1,BEISHANG,2294,1038,84,84,168,50.0%,18m
23453,1,[CPT]齐齐啪啪,2294,1619,80,68,148,54.1%,1h
23453,2,无情,2294,412,27,19,46,58.7%,1h
23453,1,别问大炮,2294,632,25,26,51,49.0%,24m
23453,1,fast,2294,475,15,21,36,41.7%,1h
23453,1,[绝世高手]夜影林灵,2294,378,13,14,27,48.1%,46m
23453,1,大哥别打我,2294,342,13,18,31,41.9%,3m
23453,2,MMMAAAAAA,2294,258,7,7,14,50.0%,5m
23453,1,爆裂赤诚,2294,250,7,12,19,36.8%,46m
23453,2,[极限菜鸟]鸿鹄飞鹰,2294,148,5,3,8,62.5%,1h
23453,2,TANGUAN,2294,124,5,4,9,55.6%,18m
23453,1,无畏,2294,182,5,9,14,35.7%,1h
23453,1,奶油小生,2294,122,3,3,6,50.0%,1h
23453,1,[TAPC]Rain,2294,102,3,7,10,30.0%,53m
23453,1,zzl,2294,80,3,7,10,30.0%,52m
23453,1,[机器猫]我的脚下就是艾尔,2294,40,2,3,5,40.0%,1h
23453,2,Lavie,2294,64,2,4,6,33.3%,1h
23453,1,zwzwzwz,2294,0,1,5,6,16.7%,6m
23453,2,[老as联盟]血红校尉,2294,88,1,5,6,16.7%,41m
23453,1,天荐,2294,0,0,1,1,0.0%,1h
23453,2,极速等级,2294,0,0,2,2,0.0%,60m
23453,1,[天气]廉价旅行者,2294,0,0,7,7,0.0%,25m
23475,1,[拨云见日]凤雏,2293,1311,204,222,426,47.9%,45m
23475,3,[拨云见日]卧龙,2293,882,41,49,90,45.6%,30m
23475,2,[在下萌新一只]piaopiao,2293,819,31,29,60,51.7%,15m
23475,2,kira,2293,538,18,21,39,46.2%,1h
23475,1,[1232]月葉抹茶,2293,306,13,6,19,68.4%,46m
23475,2,二五仔,2293,227,6,14,20,30.0%,1h
23475,2,骚人就是我,2293,58,3,0,3,100.0%,60m
23475,2,还记的夏弥吗,2293,96,3,4,7,42.9%,60m
23475,1,Rakujitsu,2293,118,3,8,11,27.3%,1h
23475,1,[鲁德欢]LOGO,2293,101,2,2,4,50.0%,1h
23475,2,[九条命的狐狸]霜星,2293,32,1,3,4,25.0%,1h
23475,3,是你得不到的爷爷,2293,0,1,3,4,25.0%,1h
23475,1,timing,2293,0,1,4,5,20.0%,1h
23475,1,ZHANG,2293,38,1,5,6,16.7%,40m
23475,2,XIBA,2293,0,0,2,2,0.0%,1h
23490,2,DarJumpKing,2292,1375,51,74,125,40.8%,13m
23490,1,黑芒,2292,712,23,24,47,48.9%,40m
23490,2,流氓兔耍流氓,2292,370,13,12,25,52.0%,1h
23490,2,[遗忘之痕]辄爵,2292,255,10,5,15,66.7%,1h
23490,3,[宫水神社]宫水三叶,2292,124,5,12,17,29.4%,13m
23490,1,沉木,2292,48,4,5,9,44.4%,26m
23490,2,[0710]Lollipop,2292,122,4,7,11,36.4%,1h
23490,1,Fate,2292,97,2,6,8,25.0%,1h
23490,1,星际菜鸟,2292,86,2,11,13,15.4%,1h
23490,2,樱九,2292,0,1,0,1,100.0%,50m
23490,2,Nidhhog,2292,0,1,0,1,100.0%,56m
23490,1,[怕个虫子]加藤惠,2292,48,1,5,6,16.7%,1h
23490,2,[收正常人]GIXA,2292,0,1,5,6,16.7%,1h
23503,1,[CPT]丁冬在线,2291,985,39,49,88,44.3%,52m
23503,2,乱乱乱乱,2291,612,22,23,45,48.9%,1h
23503,2,[浙江大学战队]DAAD,2291,605,22,24,46,47.8%,1h
23503,1,RobiN,2291,560,19,19,38,50.0%,11m
23503,1,卑微小跳虫,2291,252,8,10,18,44.4%,1h
23503,3,QueenSea,2291,60,5,8,13,38.5%,1h
23503,2,不讲武德,2291,0,3,2,5,60.0%,31m
23503,2,[叫我兔本]成都孙一峰,2291,144,3,5,8,37.5%,26m
23503,1,枭雄,2291,94,3,14,17,17.6%,1h
23503,3,爱在西元前,2291,34,2,3,5,40.0%,1h
23503,2,飞雨,2291,58,2,4,6,33.3%,26m
23503,3,[咕咕学院]雪溢,2291,0,1,0,1,100.0%,1h
23503,1,[为萝莉而战]Freedomlala,2291,0,1,0,1,100.0%,1h
23503,2,奥德姆修斯,2291,0,1,0,1,100.0%,1h
23503,2,小鹿包,2291,0,1,1,2,50.0%,21m
23503,2,埃蒙的部队,2291,46,1,2,3,33.3%,54m
23503,2,[萌基幻想]youdachi,2291,0,0,2,2,0.0%,60m
23503,2,孤星白云,2291,0,0,2,2,0.0%,1h
23521,1,广开兮天门,2290,1190,54,51,105,51.4%,18m
23521,1,[亡命之魂]lllllllllll,2290,1360,54,54,108,50.0%,34m
23521,1,[VLK]怡乐汽水,2290,1348,50,48,98,51.0%,1h
23521,3,牛子哥,2290,780,32,39,71,45.1%,18m
23521,2,Innovation,2290,594,24,18,42,57.1%,21m
23521,2,疯子,2290,479,20,10,30,66.7%,18m
23521,1,Russi,2290,569,20,23,43,46.5%,25m
23521,3,[赤色卐中轴]VICTORY,2290,434,17,29,46,37.0%,1h
23521,1,JosephIvan,2290,231,14,13,27,51.9%,6m
23521,1,为你而生为你而在,2290,379,13,13,26,50.0%,10m
23521,1,Raylee,2290,400,11,11,22,50.0%,40m
23521,2,shy,2290,291,10,15,25,40.0%,60m
23521,2,於樱枝同学,2290,152,5,5,10,50.0%,4m
23521,2,MillatgarElz,2290,134,5,7,12,41.7%,1h
23521,1,Lsz,2290,90,4,14,18,22.2%,1h
23521,2,白门楼,2290,30,2,2,4,50.0%,41m
23521,1,独角兽,2290,34,2,5,7,28.6%,21m
23521,1,Duke,2290,0,1,0,1,100.0%,1h
23521,2,驾猪西去,2290,0,1,3,4,25.0%,1h
23521,2,[人类防卫阵线]小怪兽,2290,30,1,3,4,25.0%,1h
23521,2,看海,2290,0,1,5,6,16.7%,33m
23521,1,蹲下抱头,2290,0,0,1,1,0.0%,57m
23543,3,类地行星外星人,2289,938,38,48,86,44.2%,23m
23543,3,小兵传奇,2289,1016,37,46,83,44.6%,32m
23543,1,[蕾丝同好会]巴斯光年,2289,792,34,43,77,44.2%,1h
23543,1,伊蕾娜,2289,796,26,25,51,51.0%,1h
23543,1,XYfans,2289,542,18,19,37,48.6%,9m
23543,2,[大元师]可以不可以,2289,420,17,15,32,53.1%,1h
23543,1,dtMAGA,2289,265,7,3,10,70.0%,25m
23543,3,[Banned]MoeKotoki,2289,220,7,12,19,36.8%,7m
23543,3,[暴雪三十二隊]People,2289,98,5,11,16,31.2%,41m
23543,1,IIIIIIIIII,2289,116,4,6,10,40.0%,1h
23543,1,Blink,2289,165,4,6,10,40.0%,9m
23543,1,[XXHZ11]柠檬茶泡饭,2289,193,4,10,14,28.6%,1h
23543,1,流音月樱,2289,96,3,7,10,30.0%,1h
23543,1,孤独的人生,2289,96,2,2,4,50.0%,1h
23543,2,路边的一粒灰,2289,72,2,2,4,50.0%,1h
23543,2,悄世,2289,58,2,2,4,50.0%,1h
23543,2,backgwy,2289,137,2,6,8,25.0%,1h
23543,1,慢半拍的简晓夏,2289,48,2,7,9,22.2%,1h
23543,2,神般暴走,2289,0,1,0,1,100.0%,54m
23543,2,菜鸟,2289,88,1,2,3,33.3%,1h
23543,2,[鲁德欢]令尊曰,2289,0,1,4,5,20.0%,60m
23564,3,Bin,2288,566,22,35,57,38.6%,10m
23564,2,魔魇,2288,511,21,16,37,56.8%,1h
23564,2,子鹅,2288,493,20,24,44,45.5%,10m
23564,1,海底有针,2288,376,17,19,36,47.2%,9m
23564,2,[生气了吗]KOBE,2288,190,16,21,37,43.2%,60m
23564,1,神如海,2288,356,15,11,26,57.7%,14m
23564,1,青尢,2288,384,11,17,28,39.3%,39m
23564,2,[菜有菜的道理]酒辛,2288,287,9,9,18,50.0%,36m
23564,1,谁不是小学生,2288,156,7,14,21,33.3%,1h
23564,2,风花雪夜,2288,111,5,6,11,45.5%,1h
23564,1,烦了小太爷,2288,180,5,6,11,45.5%,34m
23564,1,[丰县一霸]应天的梦,2288,165,5,8,13,38.5%,26m
23564,1,忘川,2288,0,4,3,7,57.1%,1h
23564,1,xxxx,2288,150,4,8,12,33.3%,52m
23564,2,雨天启,2288,46,2,5,7,28.6%,1h
23564,2,[火焰刀]不讲武德,2288,0,1,0,1,100.0%,1h
23564,2,Amsterdam,2288,0,1,1,2,50.0%,1h
23564,1,[31CM]华为,2288,0,0,3,3,0.0%,38m
23582,3,Maxs,2287,1485,102,130,232,44.0%,53m
23582,1,多想再见你,2287,503,20,27,47,42.6%,1h
23582,1,[我们是害虫之]星落黎明,2287,497,18,13,31,58.1%,3m
23582,1,asdas,2287,504,17,19,36,47.2%,10m
23582,1,future,2287,277,11,10,21,52.4%,1h
23582,3,梁月,2287,292,9,12,21,42.9%,51m
23582,1,wpss,2287,263,7,11,18,38.9%,3m
23582,2,是梦终空,2287,120,4,2,6,66.7%,1h
23582,1,[最强大佬]Hongtangfrog,2287,143,3,7,10,30.0%,1h
23582,2,jiangguangyi,2287,32,2,3,5,40.0%,1h
23582,1,超人,2287,0,1,0,1,100.0%,44m
23582,2,Yrq,2287,48,1,1,2,50.0%,60m
23582,2,BlackNoire,2287,0,1,4,5,20.0%,1h
23582,2,陈半仙,2287,0,1,5,6,16.7%,1h
23582,2,启元,2287,0,0,1,1,0.0%,28m
23582,2,纯属虚构,2287,0,0,1,1,0.0%,34m
23582,1,旧梦一相故城,2287,0,0,2,2,0.0%,1h
23582,1,BigGoldWatch,2287,0,0,4,4,0.0%,10m
23600,1,长风,2286,1500,62,58,120,51.7%,31m
23600,1,[VIC]shunshun,2286,583,20,19,39,51.3%,1h
23600,2,蜗牛君,2286,286,10,5,15,66.7%,36m
23600,2,[休闲疗养院]phoenix,2286,178,10,8,18,55.6%,1h
23600,3,訫狐,2286,267,9,13,22,40.9%,47m
23600,1,lancer,2286,316,9,17,26,34.6%,3m
23600,2,hughes,2286,142,6,1,7,85.7%,1h
23600,1,[温柔兔公主]曲无忆,2286,154,6,4,10,60.0%,1h
23600,2,干不掉我,2286,142,6,4,10,60.0%,1h
23600,3,佬魚,2286,161,5,10,15,33.3%,23m
23600,1,八狐狸,2286,116,4,3,7,57.1%,45m
23600,1,吴彦祖,2286,90,3,0,3,100.0%,1h
23600,2,imbalance,2286,60,3,3,6,50.0%,1h
23600,1,飞火流星,2286,78,3,4,7,42.9%,1h
23600,2,[达拉姆万岁]kyousuke,2286,102,2,1,3,66.7%,52m
23600,2,路下友人,2286,48,2,6,8,25.0%,1h
23600,3,永燃的瞳术师,2286,0,2,7,9,22.2%,1h
23600,2,CzarTech,2286,32,1,2,3,33.3%,1h
23600,2,永言堂,2286,0,1,4,5,20.0%,26m
23600,2,哇哇,2286,93,1,5,6,16.7%,26m
23600,2,模式,2286,0,1,5,6,16.7%,1h
23600,1,[战网电竞]一只飞机别,2286,0,0,1,1,0.0%,12m
23600,2,[先行者议会]羽田真言,2286,0,0,1,1,0.0%,11m
23600,2,NoEzGame,2286,0,0,1,1,0.0%,26m
23600,2,ricardo,2286,0,0,2,2,0.0%,18m
23625,1,[慢手e族]水晶蛋蛋,2285,1722,144,142,286,50.3%,1h
23625,1,WANG,2285,955,29,35,64,45.3%,1h
23625,1,蓉阿蓉,2285,564,18,18,36,50.0%,53m
23625,2,sewwt,2285,426,14,10,24,58.3%,10m
23625,2,一只小公举,2285,314,11,5,16,68.8%,41m
23625,1,[神圣路易帝国]doge,2285,266,8,10,18,44.4%,1h
23625,3,TeRiRi,2285,254,8,13,21,38.1%,1h
23625,1,奶糖,2285,233,7,7,14,50.0%,8m
23625,1,这人有亿点下饭,2285,207,6,7,13,46.2%,3m
23625,3,Mashtyx,2285,205,6,10,16,37.5%,24m
23625,1,CZH,2285,162,5,9,14,35.7%,1h
23625,2,[何平]艾尔,2285,153,5,10,15,33.3%,21m
23625,1,Ngwwzq,2285,140,4,4,8,50.0%,36m
23625,1,[Pt小贴士]PuPuLAHa,2285,144,3,1,4,75.0%,1h
23625,1,块钱的好兄弟,2285,0,3,4,7,42.9%,1h
23625,2,肥皂,2285,46,2,0,2,100.0%,1h
23625,2,txtoto,2285,30,2,1,3,66.7%,1h
23625,1,万归藏,2285,0,2,6,8,25.0%,9m
23625,2,[1VA]MagicProtoss,2285,0,1,0,1,100.0%,1h
23625,2,[北有吾王1队]反对大师傅撒旦,2285,0,1,1,2,50.0%,5m
23625,2,Dengk,2285,30,1,2,3,33.3%,1h
23625,2,万受无疆,2285,0,0,1,1,0.0%,1h
23625,2,Ferdinand,2285,0,0,1,1,0.0%,1h
23625,2,粗粗带你飞,2285,0,0,2,2,0.0%,1h
23649,2,氖酆,2284,856,30,38,68,44.1%,1h
23649,2,[慢手e族]消逝的光芒,2284,477,25,20,45,55.6%,28m
23649,1,Ristar,2284,541,23,13,36,63.9%,34m
23649,3,软饭硬吃曹达华,2284,415,15,19,34,44.1%,1h
23649,2,圣灵天启,2284,358,14,12,26,53.8%,1h
23649,1,小气的呆头,2284,280,8,13,21,38.1%,1h
23649,2,疯狂阿行,2284,222,7,6,13,53.8%,1h
23649,2,星际正义使者,2284,153,5,12,17,29.4%,1h
23649,2,Air,2284,118,4,4,8,50.0%,1h
23649,2,[上海大学]欢迎报考上海大学,2284,185,4,6,10,40.0%,60m
23649,2,[敢犯我河南者]kamijo,2284,86,3,2,5,60.0%,5m
23649,2,面壁,2284,0,3,3,6,50.0%,52m
23649,1,[KPG2]我是新手让让我啊,2284,48,3,8,11,27.3%,1h
23649,2,娟娟,2284,144,2,6,8,25.0%,1h
23649,3,cjlovecj,2284,0,2,7,9,22.2%,3m
23649,1,流浪,2284,48,2,7,9,22.2%,9m
23649,2,大别山游击,2284,30,1,2,3,33.3%,33m
23649,1,[加州室内装修]才鸡,2284,0,1,3,4,25.0%,34m
23649,2,[丨CRH丨]你好我叫高天伦,2284,0,0,1,1,0.0%,1h
23649,1,幽魂霸王龙,2284,0,0,2,2,0.0%,1h
23669,1,[四佑]打不死的电工,2283,1503,1058,1124,2182,48.5%,1h
23669,3,大灰狼,2283,1555,238,239,477,49.9%,22m
23669,1,黑夜刺刀,2283,1719,96,98,194,49.5%,1h
23669,1,水墨青花,2283,1525,61,55,116,52.6%,54m
23669,3,半壶纱,2283,1282,53,61,114,46.5%,1h
23669,1,[KDA]星桀,2283,1003,52,54,106,49.1%,1h
23669,1,无发书生,2283,663,41,45,86,47.7%,34m
23669,1,爸爸,2283,764,25,27,52,48.1%,53m
23669,1,神田太宇,2283,173,9,15,24,37.5%,1h
23669,2,驣龖,2283,145,6,3,9,66.7%,1h
23669,2,[给婉儿洗澡]午夜,2283,94,4,4,8,50.0%,41m
23669,2,yfdterhrg,2283,141,3,5,8,37.5%,56m
23669,2,多想再见她回眸,2283,151,3,6,9,33.3%,54m
23669,1,小王子皓皓,2283,84,3,7,10,30.0%,39m
23669,2,[K2]风见幽香,2283,30,2,1,3,66.7%,50m
23669,2,nogamenolife,2283,30,2,1,3,66.7%,50m
23669,3,RCV,2283,121,2,2,4,50.0%,1h
23669,1,可怜的人,2283,144,2,3,5,40.0%,11m
23669,2,陈年老菜鸟,2283,0,1,0,1,100.0%,1h
23669,3,浮云落叶,2283,0,1,1,2,50.0%,44m
23669,2,[东方众]Drsfjo,2283,0,0,1,1,0.0%,1h
23669,2,日了狗了,2283,0,0,1,1,0.0%,28m
23669,2,[菜有菜的道理]plum,2283,0,0,1,1,0.0%,18m
23669,2,[三大队三人行]黑暗顾问,2283,0,0,2,2,0.0%,1h
23693,1,不要你觉得,2282,1222,250,255,505,49.5%,1h
23693,2,傻瓜,2282,689,129,140,269,48.0%,35m
23693,3,[北京幇]坦克轰死你,2282,1320,50,54,104,48.1%,1h
23693,3,人类之子,2282,492,37,45,82,45.1%,1h
23693,3,大枫歌,2282,495,34,41,75,45.3%,1h
23693,2,我永远喜欢间桐樱,2282,459,20,14,34,58.8%,13m
23693,2,妈个鸡泰伦,2282,472,17,18,35,48.6%,52m
23693,3,[杭州鱼市]嗪沁恋恋,2282,260,9,12,21,42.9%,1h
23693,2,时俞,2282,259,7,15,22,31.8%,33m
23693,1,bjtide,2282,175,5,5,10,50.0%,1h
23693,1,Star,2282,234,5,10,15,33.3%,26m
23693,3,蜂衣,2282,48,4,9,13,30.8%,1h
23693,1,[牵丝戏]橙会飞丶,2282,0,3,4,7,42.9%,17m
23693,2,[TAPC]龙迪,2282,46,1,2,3,33.3%,26m
23693,2,HEYBOLUR,2282,0,0,1,1,0.0%,33m
23693,1,虚空之遗,2282,0,0,2,2,0.0%,21m
23709,2,[科学养猪]llllllllllll,2281,1539,104,117,221,47.1%,1h
23709,1,啊曦,2281,688,52,64,116,44.8%,48m
23709,1,[樱夏]保时捷喵式,2281,1522,47,69,116,40.5%,34m
23709,2,Misiz,2281,1122,42,45,87,48.3%,5m
23709,1,佳佳,2281,556,38,37,75,50.7%,51m
23709,1,名字,2281,360,12,11,23,52.2%,53m
23709,1,Alkelis,2281,240,8,9,17,47.1%,57m
23709,2,[i5]幽馨抉择,2281,0,3,2,5,60.0%,1h
23709,2,[武形秘仪]上雨旁风,2281,0,3,2,5,60.0%,1h
23709,1,Laputa,2281,80,3,7,10,30.0%,45m
23709,1,挖掘机哪家强,2281,128,2,5,7,28.6%,21m
23709,1,河北盲流郭德纲,2281,97,2,6,8,25.0%,50m
23709,2,机关枪哒哒哒哒哒,2281,0,1,0,1,100.0%,21m
23709,2,唯独在大地,2281,0,1,2,3,33.3%,1h
23709,2,叔叔半夜劫个色,2281,0,0,1,1,0.0%,5m
23709,2,码科,2281,0,0,2,2,0.0%,1h
23725,3,Gujo,2280,147,118,136,254,46.5%,32m
23725,1,[团长]猫神芒果酱,2280,634,19,26,45,42.2%,47m
23725,2,[旺旺战士]Waltery,2280,232,8,8,16,50.0%,34m
23725,1,DAWN,2280,142,4,10,14,28.6%,15m
23725,2,[嘤嘤嘤呜呜]時崎,2280,92,3,3,6,50.0%,1h
23725,1,余秋,2280,144,3,8,11,27.3%,9m
23725,2,[我是大哥大]贵族灬逆袭,2280,30,2,3,5,40.0%,1h
23725,1,老羊,2280,40,2,4,6,33.3%,46m
23725,2,cloudCNG,2280,93,2,9,11,18.2%,4m
23725,2,[列克星顿]overlord,2280,0,1,1,2,50.0%,1h
23725,2,Answer,2280,32,1,1,2,50.0%,1h
23725,2,死者丿神生者,2280,0,0,1,1,0.0%,1h
23737,1,小北,2279,617,65,56,121,53.7%,55m
23737,3,[TWV]Lyal,2279,1135,63,65,128,49.2%,10m
23737,1,鸡饲料,2279,820,28,31,59,47.5%,54m
23737,1,叶子,2279,550,23,26,49,46.9%,27m
23737,2,橘子要挑软的捏,2279,452,18,20,38,47.4%,1h
23737,1,[请帮我嘴交谢]南呱头,2279,580,17,22,39,43.6%,24m
23737,1,HUAWEI,2279,486,16,21,37,43.2%,38m
23737,1,九天一,2279,263,14,19,33,42.4%,39m
23737,1,清洁攻,2279,436,14,20,34,41.2%,1h
23737,1,[艾尔黑恶势力]ntyz,2279,236,12,12,24,50.0%,38m
23737,1,星际玩家,2279,287,11,17,28,39.3%,1h
23737,3,享受小苍热爱生活,2279,204,9,13,22,40.9%,24m
23737,2,zyzy,2279,253,9,16,25,36.0%,1h
23737,3,辰帥,2279,286,9,21,30,30.0%,1h
23737,3,[极限菜鸟]黑暗之的舞,2279,180,8,12,20,40.0%,7m
23737,1,[提莫1234]Queeniorz,2279,176,8,13,21,38.1%,1h
23737,1,西柳儿德,2279,186,6,10,16,37.5%,1h
23737,3,烽烟,2279,94,4,6,10,40.0%,1h
23737,2,didiid,2279,84,2,1,3,66.7%,1h
23737,2,[酒池肉林]zbcsb,2279,0,1,0,1,100.0%,28m
23737,2,小菜毛腿,2279,0,1,0,1,100.0%,10m
23737,2,RicardoMLu,2279,0,1,2,3,33.3%,1h
23737,2,超级凶鹅,2279,0,1,5,6,16.7%,33m
23737,1,换世门生,2279,0,1,6,7,14.3%,1h
23737,2,Silicon,2279,0,0,1,1,0.0%,1h
23737,1,我是你爹,2279,0,0,2,2,0.0%,1h
23763,1,[爽一下]YjMars,2278,1685,363,379,742,48.9%,1h
23763,3,Sumail,2278,1529,260,281,541,48.1%,22m
23763,1,[糊撸baby]钢娃,2278,1626,130,128,258,50.4%,9m
23763,3,我是神,2278,1373,109,128,237,46.0%,6m
23763,1,朱颜辞镜花辞树,2278,357,76,74,150,50.7%,1h
23763,1,[死鹿特小公主]Onemy,2278,706,26,22,48,54.2%,1h
23763,2,雪洁大人,2278,358,15,6,21,71.4%,1h
23763,2,少齐,2278,412,14,15,29,48.3%,1h
23763,1,不知道,2278,446,14,16,30,46.7%,25m
23763,1,beau,2278,363,14,18,32,43.8%,1h
23763,3,zHao,2278,216,8,11,19,42.1%,1h
23763,1,Quetzalcoatl,2278,162,6,6,12,50.0%,1h
23763,3,XUEYAN,2278,118,3,2,5,60.0%,7m
23763,2,[游戏风云OL]主宰虫群之星,2278,30,2,2,4,50.0%,23m
23763,2,执政,2278,0,2,3,5,40.0%,52m
23763,2,[喵内噶]樱木雨音,2278,95,2,4,6,33.3%,1h
23763,1,[F2ANB]大河之贱,2278,46,2,7,9,22.2%,11m
23763,2,黑桃水果刀,2278,0,1,1,2,50.0%,12m
23763,2,[秋毫]迟来的缠,2278,30,1,3,4,25.0%,13m
23763,2,若翔零一,2278,0,1,3,4,25.0%,1h
23763,1,[萌萌哒鸡]化斋不是要饭,2278,88,1,4,5,20.0%,7m
23763,2,臣服或毁灭,2278,0,1,4,5,20.0%,15m
23763,2,我永远喜欢蕾西亚,2278,0,1,6,7,14.3%,1h
23786,3,我能,2277,1528,194,206,400,48.5%,27m
23786,1,谜雾,2277,776,60,60,120,50.0%,20m
23786,1,[CPT]木枫,2277,1096,38,41,79,48.1%,46m
23786,1,[NVKR]十二年秋,2277,1144,38,46,84,45.2%,46m
23786,1,神之天使,2277,745,35,29,64,54.7%,46m
23786,1,StarGodemon,2277,521,20,24,44,45.5%,1h
23786,2,北倚晚窗,2277,176,8,13,21,38.1%,43m
23786,1,HFDX,2277,202,5,7,12,41.7%,46m
23786,2,王小亮,2277,86,4,5,9,44.4%,26m
23786,2,黑翼,2277,92,3,6,9,33.3%,1h
23786,2,yyfhyy,2277,58,2,1,3,66.7%,5m
23786,1,violience,2277,38,2,4,6,33.3%,25m
23786,2,我不打星际,2277,0,1,1,2,50.0%,12m
23786,2,[幽灵闪现wo]sdfdsf,2277,30,1,3,4,25.0%,33m
23786,3,[死亡的空隙]星际魔龙,2277,0,0,1,1,0.0%,1h
23786,2,admkw,2277,0,0,2,2,0.0%,1h
23802,1,古锐,2276,663,43,41,84,51.2%,24m
23802,1,[M8]暴躁之鼬,2276,548,30,23,53,56.6%,56m
23802,1,余潋骅是我弟弟,2276,481,17,23,40,42.5%,12m
23802,1,ghs,2276,425,15,16,31,48.4%,21m
23802,3,少师,2276,332,11,25,36,30.6%,1h
23802,1,DeadlyCalm,2276,360,10,14,24,41.7%,46m
23802,2,大肌霸,2276,178,7,3,10,70.0%,1h
23802,2,[天际线]子非鱼,2276,118,6,1,7,85.7%,1h
23802,2,加多宝凉茶,2276,142,6,5,11,54.5%,1h
23802,3,怀念科比布莱恩特,2276,125,3,6,9,33.3%,21m
23802,1,既然已经离去,2276,0,2,6,8,25.0%,50m
23802,1,hsp,2276,96,2,6,8,25.0%,1h
23802,2,JEFF,2276,30,1,1,2,50.0%,13m
23802,1,[我的三体]世界属于三体,2276,0,0,1,1,0.0%,1h
23802,2,甜橙味的猫,2276,0,0,1,1,0.0%,11m
23817,2,dstfghgaserg,2275,1086,39,54,93,41.9%,49m
23817,1,汐下,2275,647,22,25,47,46.8%,27m
23817,1,[社交学学者]Foxpattern,2275,263,10,9,19,52.6%,6m
23817,2,[SLZ]死侍,2275,208,8,5,13,61.5%,28m
23817,1,钢甲铁拳,2275,228,6,14,20,30.0%,39m
23817,2,[舜志满天下]舜志科技,2275,115,4,3,7,57.1%,11m
23817,2,Hess,2275,120,4,4,8,50.0%,1h
23817,1,异虫,2275,121,4,7,11,36.4%,8m
23817,2,我叫李俊英,2275,136,3,4,7,42.9%,17m
23817,2,天人合一,2275,64,2,1,3,66.7%,16m
23817,2,VISAy,2275,30,1,2,3,33.3%,1h
23817,2,linyun,2275,0,1,4,5,20.0%,55m
23817,2,空和白,2275,0,1,4,5,20.0%,54m
23817,2,DeMonBlesSME,2275,93,1,5,6,16.7%,1h
23817,2,江东老油条,2275,94,1,5,6,16.7%,54m
23817,2,饼干,2275,0,0,3,3,0.0%,55m
23833,1,彼得潘,2274,1665,184,188,372,49.5%,45m
23833,1,[全国修车]qch,2274,1065,52,53,105,49.5%,21m
23833,1,slybrunier,2274,1018,33,40,73,45.2%,46m
23833,1,MRsheep,2274,560,18,28,46,39.1%,1h
23833,2,伪战士,2274,409,15,9,24,62.5%,1h
23833,1,高级坑人顾问,2274,265,11,12,23,47.8%,1h
23833,1,杰基洛夫,2274,346,9,8,17,52.9%,12m
23833,1,[慢手e族]菜鸟达拉姆之刃,2274,235,9,9,18,50.0%,1h
23833,1,Jason,2274,220,8,10,18,44.4%,60m
23833,1,[暮Licht]Ichigao,2274,226,6,10,16,37.5%,1h
23833,1,水月,2274,96,4,9,13,30.8%,41m
23833,3,haott,2274,153,4,10,14,28.6%,1h
23833,2,白给少年永不为奴,2274,86,3,2,5,60.0%,5m
23833,2,我们中出了个叛徒,2274,68,3,3,6,50.0%,21m
23833,3,naichachaa,2274,0,2,7,9,22.2%,8m
23833,2,德黑兰,2274,0,1,0,1,100.0%,1h
23833,2,魔鬼,2274,0,1,5,6,16.7%,1h
23833,3,骑鲨的小黄鱼,2274,0,0,1,1,0.0%,7m
23833,3,殇之痕,2274,0,0,2,2,0.0%,1h
23833,3,阿桔才不是受,2274,0,0,3,3,0.0%,24m
23853,3,不可战胜,2273,938,65,75,140,46.4%,2m
23853,1,次元游者,2273,1416,59,60,119,49.6%,25m
23853,3,乱世小熊,2273,434,20,25,45,44.4%,40m
23853,2,信仰,2273,337,14,12,26,53.8%,1h
23853,2,白给二号,2273,214,8,7,15,53.3%,1h
23853,1,拥抱八二,2273,238,6,16,22,27.3%,39m
23853,1,和天下,2273,144,5,11,16,31.2%,9m
23853,2,狼牙冰狼,2273,96,3,5,8,37.5%,26m
23853,2,明天的我,2273,0,1,3,4,25.0%,56m
23853,2,断迷,2273,0,0,2,2,0.0%,1h
23863,2,MUA,2272,1416,106,113,219,48.4%,16m
23863,2,最喜欢小雨了,2272,390,15,18,33,45.5%,34m
23863,2,[清华大学战队]南斯拉夫,2272,272,10,6,16,62.5%,16m
23863,3,赫赫呵呵喝喝,2272,163,4,3,7,57.1%,7m
23863,2,咕叽咕叽,2272,44,3,4,7,42.9%,1h
23863,2,林厶卿,2272,116,3,4,7,42.9%,1h
23863,2,风火连城,2272,40,2,1,3,66.7%,33m
23863,1,soldier,2272,36,2,2,4,50.0%,45m
23863,2,spue,2272,30,2,4,6,33.3%,28m
23863,1,夹得很紧紧的一逼,2272,0,1,0,1,100.0%,1h
23863,2,墨染雪,2272,0,1,0,1,100.0%,52m
23863,2,[317]快乐建筑师,2272,0,1,5,6,16.7%,1h
23875,2,ShawnZhu,2271,1620,98,99,197,49.7%,13m
23875,2,漩涡鸣人,2271,331,11,18,29,37.9%,1h
23875,2,我噼里啪啦,2271,196,9,6,15,60.0%,1h
23875,1,流霜华,2271,245,9,12,21,42.9%,1h
23875,1,六六六古德盖姆,2271,302,8,9,17,47.1%,1h
23875,1,AdolphaShaco,2271,285,8,12,20,40.0%,1h
23875,1,生活总是这样,2271,219,7,7,14,50.0%,39m
23875,2,艾尔永恒,2271,174,6,3,9,66.7%,1h
23875,3,帝皇的多恩酱,2271,169,5,3,8,62.5%,4m
23875,1,gzz,2271,157,5,7,12,41.7%,25m
23875,2,AmaZing,2271,128,4,6,10,40.0%,26m
23875,2,独唱,2271,0,2,2,4,50.0%,1h
23875,2,塔桑尼斯列车,2271,64,2,4,6,33.3%,1h
23875,2,[ducang]hting,2271,0,1,0,1,100.0%,1h
23875,2,[歌者II]最后的萨尔那加,2271,0,1,1,2,50.0%,13m
23875,2,[在下萌新一只]痞少,2271,30,1,4,5,20.0%,1h
23875,2,断水流大师兄,2271,97,1,5,6,16.7%,1h
23875,2,[优信]优信集团优信集团,2271,0,0,3,3,0.0%,1h
23893,3,[神煞]深红水晶,2270,1612,1350,1358,2708,49.9%,21m
23893,1,[HUC铭心]潇洒猪,2270,1460,118,138,256,46.1%,32m
23893,2,HeHe,2270,1564,96,105,201,47.8%,50m
23893,1,pzx,2270,985,39,42,81,48.1%,39m
23893,1,[HUC铭心]你站好,2270,631,22,24,46,47.8%,40m
23893,1,祁轩铭,2270,447,21,21,42,50.0%,39m
23893,1,Jack,2270,412,18,11,29,62.1%,46m
23893,1,[113]达文西,2270,597,17,21,38,44.7%,36m
23893,1,WonderFul,2270,502,16,32,48,33.3%,50m
23893,3,[世界需要英雄]宁度丿幻想,2270,287,12,11,23,52.2%,1h
23893,1,[浪啊浪]PAIPAIYUE,2270,362,11,16,27,40.7%,1h
23893,1,[暴雪家族]幻痛,2270,274,10,13,23,43.5%,9m
23893,1,CHINASmallXY,2270,249,7,10,17,41.2%,1h
23893,3,[OTAKU丨]昏君夏夏夏炎,2270,60,4,9,13,30.8%,22m
23893,1,angry,2270,118,3,1,4,75.0%,50m
23893,3,photoboyben,2270,44,3,10,13,23.1%,16m
23893,2,扯火,2270,134,2,6,8,25.0%,1h
23893,1,鸿蒙,2270,0,2,6,8,25.0%,15m
23893,2,Ohyes,2270,0,1,1,2,50.0%,1h
23893,2,维我余,2270,0,0,1,1,0.0%,26m
23913,1,休闲的菜鸟,2269,1484,654,714,1368,47.8%,10m
23913,2,GuoL,2269,1187,93,112,205,45.4%,17m
23913,1,胡汉三,2269,950,36,30,66,54.5%,1h
23913,1,拒绝者,2269,414,13,17,30,43.3%,34m
23913,1,[社交学教练]空空落落,2269,345,10,9,19,52.6%,58m
23913,2,liumo,2269,166,7,1,8,87.5%,1h
23913,2,Kblink,2269,196,7,10,17,41.2%,33m
23913,2,新手,2269,102,5,1,6,83.3%,1h
23913,2,厄普西隆某异教,2269,60,3,1,4,75.0%,1h
23913,2,[AOAOA]刘佩剑,2269,0,2,4,6,33.3%,12m
23913,1,小桃吃不饱,2269,90,2,6,8,25.0%,54m
23913,2,[智乃超可爱w]我躺了,2269,0,1,0,1,100.0%,52m
23913,2,[ZSG]professorY,2269,0,1,0,1,100.0%,1h
23913,2,落霞孤鹜,2269,0,1,1,2,50.0%,1h
23913,2,[透一下清酒]永远喜欢着鹿乃,2269,30,1,2,3,33.3%,1h
23913,2,IPromise,2269,0,1,4,5,20.0%,1h
23913,2,弘阳不动产,2269,0,1,5,6,16.7%,1h
23913,2,母兔,2269,0,0,1,1,0.0%,1h
23913,2,冰之影,2269,0,0,1,1,0.0%,18m
23913,2,雲雲雲,2269,0,0,2,2,0.0%,33m
23913,2,GCL,2269,0,0,3,3,0.0%,1h
23934,1,拾柒丨钟情一生,2268,1734,106,118,224,47.3%,1h
23934,1,IMA,2268,814,50,45,95,52.6%,3m
23934,2,三贴哥,2268,1207,48,51,99,48.5%,1h
23934,2,Ruin,2268,682,27,31,58,46.6%,1h
23934,2,[WJY]林博洋,2268,584,22,19,41,53.7%,30m
23934,2,香蕉面,2268,532,18,18,36,50.0%,5m
23934,2,[带带师]高坂穗乃果,2268,417,16,13,29,55.2%,60m
23934,2,星际远航,2268,380,16,14,30,53.3%,28m
23934,2,橙橙橙橙橙子,2268,311,11,11,22,50.0%,43m
23934,2,声闻于天,2268,324,11,13,24,45.8%,1h
23934,2,[疾风E有归途]归期,2268,290,10,6,16,62.5%,4m
23934,1,sky,2268,129,10,17,27,37.0%,6m
23934,1,修地堡死全家,2268,245,7,9,16,43.8%,15m
23934,2,[XXHZ20]一目意山河,2268,200,6,2,8,75.0%,18m
23934,2,SANGVISFERR,2268,62,3,3,6,50.0%,28m
23934,2,神威,2268,96,3,3,6,50.0%,1h
23934,1,皇冠之冠,2268,122,3,8,11,27.3%,1h
23934,2,LRWBwhiteInk,2268,30,2,1,3,66.7%,1h
23934,2,仁口上帝之手,2268,0,2,3,5,40.0%,38m
23934,2,[战无不胜攻无]情缘二号,2268,0,1,1,2,50.0%,13m
23934,2,丨丨丨,2268,0,1,1,2,50.0%,1h
23934,2,缓流弹道,2268,0,1,2,3,33.3%,1h
23934,2,Rocinante,2268,0,1,5,6,16.7%,52m
23934,2,dfgr,2268,0,0,1,1,0.0%,21m
23958,3,李逍遥,2267,1016,87,95,182,47.8%,1h
23958,1,KongLongYvY,2267,1419,69,65,134,51.5%,31m
23958,1,Lovetf,2267,577,18,19,37,48.6%,45m
23958,1,最后的风之子,2267,291,14,20,34,41.2%,36m
23958,1,亚闹武冲,2267,361,10,13,23,43.5%,1h
23958,2,污污,2267,280,10,13,23,43.5%,1h
23958,1,[左右骁卫]于嗟麟兮,2267,296,8,15,23,34.8%,3m
23958,1,Chris,2267,210,5,10,15,33.3%,1h
23958,1,[樱之岛]IIIIIIIIIIII,2267,110,4,8,12,33.3%,1h
23958,1,xiaopengzai,2267,121,4,8,12,33.3%,42m
23958,1,[明帝国]kranbst,2267,120,3,7,10,30.0%,45m
23958,2,夜尽,2267,44,2,0,2,100.0%,1h
23958,1,OrzJerry,2267,36,2,4,6,33.3%,1h
23958,1,ggg,2267,96,2,4,6,33.3%,26m
23958,2,Daddyjyh,2267,0,1,0,1,100.0%,1h
23958,2,[为了菲女王]星幻,2267,0,1,1,2,50.0%,1h
23958,2,音无寒暄,2267,0,1,5,6,16.7%,1h
23958,2,绝对衰,2267,93,1,5,6,16.7%,1h
23958,2,[天际线]Shang,2267,0,0,1,1,0.0%,54m
23958,2,[非一般的帅]vagary,2267,0,0,1,1,0.0%,1h
23958,2,幽灵死侍,2267,0,0,1,1,0.0%,4m
23958,3,[不知不觉天亮]supercandy,2267,0,0,3,3,0.0%,56m
23958,1,州重口味,2267,0,0,4,4,0.0%,9m
23981,2,战神,2266,811,28,34,62,45.2%,18m
23981,1,RooPanes,2266,716,24,26,50,48.0%,1h
23981,1,VDVD,2266,763,24,28,52,46.2%,1h
23981,2,[Cuv]aaaa,2266,333,13,5,18,72.2%,19m
23981,2,[基尼太美]柠檬怪兽,2266,234,7,1,8,87.5%,55m
23981,2,werewolf,2266,232,7,6,13,53.8%,1h
23981,1,[华溪岛]八重桜,2266,48,5,5,10,50.0%,1h
23981,3,[慕吾云端]星海小菜,2266,153,5,9,14,35.7%,26m
23981,3,jjjssss,2266,124,5,10,15,33.3%,41m
23981,2,[看星星咯]远坂时臣,2266,0,1,0,1,100.0%,49m
23981,1,iliiilllliii,2266,0,1,1,2,50.0%,17m
23981,2,连花清瘟胶囊,2266,0,1,3,4,25.0%,1h
23981,2,Vempire,2266,94,1,4,5,20.0%,1h
23981,2,小萌新,2266,0,0,1,1,0.0%,1h
23981,1,糯米糍粑,2266,0,0,1,1,0.0%,1h
23981,1,[TSR]林磊,2266,0,0,2,2,0.0%,1h
23981,2,抹茶可可新冰意,2266,0,0,5,5,0.0%,38m
23998,3,冰琦霖棒棒糖,2265,1493,126,123,249,50.6%,30m
23998,2,别恶心我呀,2265,1095,96,101,197,48.7%,18m
23998,2,爱哭的毛毛虫,2265,648,49,32,81,60.5%,33m
23998,1,hfg,2265,945,35,34,69,50.7%,46m
23998,1,[极限菜鸟]Alan,2265,750,28,39,67,41.8%,54m
23998,2,泰山,2265,327,17,18,35,48.6%,50m
23998,1,无为而治,2265,439,14,18,32,43.8%,12m
23998,1,Bosco,2265,149,13,8,21,61.9%,51m
23998,2,Cryingknight,2265,295,10,9,19,52.6%,1h
23998,2,清湖,2265,278,9,6,15,60.0%,1h
23998,1,eslks,2265,345,9,12,21,42.9%,46m
23998,2,小鸡炖蘑菇,2265,309,8,15,23,34.8%,30m
23998,2,SakuraLU,2265,225,7,14,21,33.3%,10m
23998,1,[舰队已抵达]小小害,2265,204,6,7,13,46.2%,1h
23998,2,[小仙女上线啦]vicky,2265,58,3,1,4,75.0%,1h
23998,2,[小破站干杯]江流酒,2265,66,3,2,5,60.0%,1h
23998,1,星际灬遨游,2265,0,2,6,8,25.0%,13m
23998,2,[在下菜鸡一只]DSADSADA,2265,30,1,2,3,33.3%,41m
23998,3,[秋毫]梦与叶樱,2265,0,1,4,5,20.0%,1h
23998,3,[幻想崩坏]娜丽塔雅,2265,0,0,1,1,0.0%,1h
23998,2,[浙大战队]mogrli,2265,0,0,1,1,0.0%,1h
24019,2,WSTLYTT,2264,857,39,44,83,47.0%,1h
24019,2,墨水,2264,786,35,31,66,53.0%,41m
24019,1,你的手速真快啊,2264,369,16,16,32,50.0%,24m
24019,1,mlgcc,2264,522,16,22,38,42.1%,45m
24019,1,lucifer,2264,388,12,14,26,46.2%,12m
24019,1,李嘉林,2264,335,9,8,17,52.9%,60m
24019,1,Harmmer,2264,308,9,15,24,37.5%,1h
24019,2,pig,2264,182,7,10,17,41.2%,1h
24019,2,[CPT]SYCQ,2264,174,6,1,7,85.7%,1h
24019,1,尾戒,2264,192,6,8,14,42.9%,15m
24019,3,谢尔比亚瑟,2264,208,6,11,17,35.3%,1h
24019,2,damai,2264,30,2,1,3,66.7%,41m
24019,2,故国有明,2264,0,2,4,6,33.3%,1h
24019,2,wenjun,2264,60,2,5,7,28.6%,41m
24019,2,无赦,2264,46,2,6,8,25.0%,27m
24019,2,采花大盗,2264,0,0,3,3,0.0%,18m
24019,2,realsatan,2264,0,0,3,3,0.0%,60m
24019,1,战火纷飞,2264,0,0,4,4,0.0%,1h
24019,2,Flare,2264,0,0,4,4,0.0%,1h
24038,1,NONONO,2263,913,45,41,86,52.3%,1h
24038,2,[小仙女已上线]毒爆,2263,505,40,37,77,51.9%,1h
24038,2,星际菜鸟来了,2263,296,19,11,30,63.3%,1h
24038,2,赢无翳,2263,309,16,18,34,47.1%,34m
24038,1,[专业收尸队]迷情哑剧,2263,417,15,19,34,44.1%,35m
24038,1,[横扫沙漠]钢七连的野狼,2263,152,13,13,26,50.0%,1h
24038,3,Kooiple,2263,293,9,14,23,39.1%,1h
24038,1,Lemonmilk,2263,214,8,14,22,36.4%,46m
24038,1,清水明山,2263,283,7,10,17,41.2%,1h
24038,2,躺着混,2263,168,6,6,12,50.0%,34m
24038,1,胜利红石,2263,241,5,9,14,35.7%,26m
24038,3,BenjaminYC,2263,171,5,12,17,29.4%,1h
24038,3,第一性原理,2263,30,3,8,11,27.3%,1h
24038,3,狄拉克之海,2263,30,2,0,2,100.0%,1h
24038,2,HarrisDing,2263,30,2,0,2,100.0%,1h
24038,2,钻石的剑,2263,102,2,1,3,66.7%,38m
24038,1,Skay,2263,0,1,0,1,100.0%,13m
24038,2,BestChina,2263,38,1,2,3,33.3%,18m
24038,2,Crown,2263,0,1,5,6,16.7%,54m
24038,2,吃火锅的卡卡,2263,0,0,2,2,0.0%,36m
24038,2,二乃,2263,0,0,2,2,0.0%,31m
24059,1,爱丽丝人仙,2262,1049,41,43,84,48.8%,54m
24059,1,哭泣的无奈,2262,982,33,40,73,45.2%,1h
24059,2,看灰机,2262,593,31,37,68,45.6%,18m
24059,1,红山茶,2262,758,25,35,60,41.7%,1h
24059,2,[暴雪二队]凶残的二娃,2262,239,23,21,44,52.3%,1h
24059,2,哈哈你猜我是吹,2262,444,16,12,28,57.1%,1h
24059,2,何不入我神教,2262,351,12,15,27,44.4%,1h
24059,1,挽楓,2262,173,8,6,14,57.1%,1h
24059,1,老炮大枪干,2262,210,7,11,18,38.9%,1h
24059,3,祁星,2262,58,6,7,13,46.2%,16m
24059,1,铅笔,2262,280,6,11,17,35.3%,1h
24059,2,宝贝孙一喵,2262,126,5,4,9,55.6%,1h
24059,1,Kneio,2262,158,4,6,10,40.0%,1h
24059,2,我既迷茫还懵批,2262,58,3,1,4,75.0%,1h
24059,2,[最牛的菜鸟队]totalden,2262,0,2,3,5,40.0%,1h
24059,1,[宇宙第一帅]我来杀杀,2262,0,2,7,9,22.2%,1h
24059,2,Moonquake,2262,0,1,0,1,100.0%,55m
24059,2,invincible,2262,0,1,2,3,33.3%,18m
24059,2,[菜有菜的道理]戈隆尔,2262,0,0,1,1,0.0%,1h
24059,2,广哥猛炸了,2262,0,0,1,1,0.0%,1h
24059,1,朱远从,2262,0,0,2,2,0.0%,1h
24080,2,xincg,2261,1329,92,102,194,47.4%,50m
24080,2,tangzong,2261,1299,80,76,156,51.3%,34m
24080,1,狼某,2261,1164,45,38,83,54.2%,18m
24080,2,nuclear,2261,964,35,36,71,49.3%,1h
24080,2,撸到天荒地老,2261,433,30,27,57,52.6%,21m
24080,2,淹神,2261,693,28,19,47,59.6%,1h
24080,1,[KIT6]skywings,2261,834,28,34,62,45.2%,1h
24080,1,[CPT]小龙飞天,2261,507,26,28,54,48.1%,1h
24080,2,[不打GG]Lovecraft,2261,776,26,34,60,43.3%,1h
24080,1,[invtio]肤白人美大长腿,2261,276,8,12,20,40.0%,20m
24080,3,[Deepdk]Gustav,2261,235,8,14,22,36.4%,1h
24080,2,knight,2261,148,6,4,10,60.0%,18m
24080,1,angelxing,2261,196,6,7,13,46.2%,11m
24080,2,寒城子,2261,128,4,2,6,66.7%,21m
24080,1,[黑光虫族]刀锋主宰,2261,138,3,7,10,30.0%,1h
24080,1,小受,2261,121,3,7,10,30.0%,17m
24080,3,Zest,2261,30,2,0,2,100.0%,1h
24080,3,舒小魅,2261,97,2,1,3,66.7%,1h
24080,1,[KUEL]llllllllllll,2261,97,2,2,4,50.0%,1h
24080,3,求你了别建兵营了,2261,0,1,0,1,100.0%,1h
24080,2,DURM,2261,32,1,1,2,50.0%,1h
24080,2,Kanna,2261,0,1,1,2,50.0%,28m
24080,2,[久美子小卖部]我想大乱过五立,2261,0,1,4,5,20.0%,55m
24080,2,吊儿郎当,2261,0,1,5,6,16.7%,1h
24104,2,eaglechan,2260,1262,52,46,98,53.1%,1h
24104,2,流云辰,2260,640,26,23,49,53.1%,16m
24104,3,阿卡卡,2260,638,24,32,56,42.9%,18m
24104,1,IDWLL,2260,434,18,25,43,41.9%,1h
24104,1,手拿菜刀向天笑,2260,346,11,16,27,40.7%,1h
24104,3,不死不休至死方休,2260,231,8,13,21,38.1%,13m
24104,2,[幻海奇妙夜]Lexington,2260,146,6,6,12,50.0%,36m
24104,3,回忆虫子,2260,164,5,1,6,83.3%,9m
24104,2,LYB,2260,160,5,3,8,62.5%,1h
24104,2,星际波霸,2260,30,2,1,3,66.7%,1h
24104,2,一贱穿鸡,2260,0,1,0,1,100.0%,1h
24104,2,Herbert,2260,0,1,5,6,16.7%,31m
24116,3,[童话]梦中,2259,1567,176,164,340,51.8%,28m
24116,1,FMbudan,2259,1670,105,103,208,50.5%,1h
24116,1,转角遇到打劫地,2259,1514,84,88,172,48.8%,31m
24116,2,永夜之星,2259,1110,48,38,86,55.8%,1h
24116,2,可可爱,2259,920,40,26,66,60.6%,36m
24116,1,FRIYU,2259,558,36,33,69,52.2%,1h
24116,2,红叶,2259,673,28,22,50,56.0%,36m
24116,2,[星际之夜]Meepo,2259,612,22,20,42,52.4%,1h
24116,1,蜜蜂部队,2259,349,16,14,30,53.3%,45m
24116,3,yyp,2259,279,16,30,46,34.8%,46m
24116,1,菲尼克斯,2259,393,15,14,29,51.7%,1h
24116,3,lmlmlml,2259,281,9,6,15,60.0%,9m
24116,1,gtyfyf,2259,231,7,7,14,50.0%,42m
24116,1,[各种混子]混子,2259,167,4,3,7,57.1%,1h
24116,1,流羽,2259,178,4,3,7,57.1%,26m
24116,2,[老年特战队]幸福中学狗批校长,2259,93,3,3,6,50.0%,1h
24116,1,桐谷和人,2259,48,3,8,11,27.3%,1h
24116,2,比美团还能送,2259,0,2,3,5,40.0%,1h
24116,2,砂布,2259,0,1,0,1,100.0%,18m
24116,2,匣于橘,2259,0,0,1,1,0.0%,19m
24136,1,[CPT]仙师完败,2258,1695,158,155,313,50.5%,1h
24136,1,肌儿邦硬,2258,1251,49,48,97,50.5%,18m
24136,2,暴躁金,2258,1021,37,51,88,42.0%,10m
24136,1,Dlsertam,2258,427,24,11,35,68.6%,1h
24136,2,轩宇,2258,472,17,19,36,47.2%,34m
24136,2,sun,2258,405,16,7,23,69.6%,4m
24136,2,Einstein,2258,154,12,12,24,50.0%,1h
24136,1,科恩,2258,305,11,14,25,44.0%,1h
24136,3,nigulasiyue,2258,289,10,10,20,50.0%,1h
24136,1,[LOHv]蓝山,2258,164,7,14,21,33.3%,1h
24136,2,苏州老仙,2258,88,5,4,9,55.6%,16m
24136,2,[SUPER2]鱼慕凤鸾,2258,94,3,8,11,27.3%,52m
24136,1,巴扎嘿叁陆壹贰,2258,52,2,11,13,15.4%,53m
24136,2,sheeping,2258,0,1,0,1,100.0%,1h
24136,2,dadada,2258,0,1,1,2,50.0%,21m
24136,3,流浪泰伦,2258,0,1,2,3,33.3%,1h
24136,1,吾本爱媚,2258,0,0,1,1,0.0%,1h
24136,2,[四剑客]光兮,2258,0,0,2,2,0.0%,1h
24154,1,[网瘾督导官]ALLCHOBO,2257,1607,186,208,394,47.2%,49m
24154,1,znn,2257,1430,174,182,356,48.9%,42m
24154,1,鎿弾弓弾伱脳瓜鏰,2257,1701,133,134,267,49.8%,25m
24154,1,臭弟弟,2257,877,102,111,213,47.9%,1h
24154,1,[大宇恩]羊头金钟罩,2257,799,81,88,169,47.9%,27m
24154,1,天国悲鸿,2257,1051,67,65,132,50.8%,1h
24154,1,[为了虫群zz]qiaomm,2257,1454,54,56,110,49.1%,1h
24154,1,白首卧,2257,929,33,36,69,47.8%,1h
24154,1,时之末页,2257,639,21,26,47,44.7%,14m
24154,2,半根烟,2257,378,18,30,48,37.5%,52m
24154,2,宇智波赵四,2257,468,17,18,35,48.6%,1h
24154,2,榛果,2257,79,6,4,10,60.0%,1h
24154,1,saber,2257,191,6,8,14,42.9%,8m
24154,2,[蝎子]长歌夜醉,2257,128,5,3,8,62.5%,1h
24154,2,少女偶像,2257,195,4,8,12,33.3%,36m
24154,1,青年,2257,138,4,12,16,25.0%,42m
24154,1,天霸动霸墥,2257,97,2,2,4,50.0%,1h
24154,2,艾薇儿,2257,0,1,1,2,50.0%,1h
24154,2,游王子讴歌,2257,34,1,1,2,50.0%,1h
24154,2,eternity,2257,0,0,1,1,0.0%,1h
24174,1,爱拍小贤,2256,764,29,35,64,45.3%,56m
24174,2,不会,2256,584,21,26,47,44.7%,30m
24174,1,xyz,2256,157,14,11,25,56.0%,46m
24174,1,PlayerWYZ,2256,414,12,19,31,38.7%,3m
24174,2,[B11313]老歌与陈酒,2256,174,6,5,11,54.5%,1h
24174,2,仙仙,2256,67,5,6,11,45.5%,34m
24174,1,[爱国]wangshi,2256,132,5,8,13,38.5%,45m
24174,1,[战争结束了]麻薯,2256,144,4,6,10,40.0%,45m
24174,1,湛冰,2256,140,3,6,9,33.3%,1h
24174,2,[盖达林]胖子传奇,2256,30,2,3,5,40.0%,10m
24174,1,rabit,2256,96,2,6,8,25.0%,1h
24174,1,死灵生和,2256,48,2,8,10,20.0%,8m
24174,2,[暴雪三队]别追了人家还小,2256,0,1,0,1,100.0%,50m
24174,2,LlllII,2256,0,1,0,1,100.0%,13m
24174,2,克维奥,2256,0,1,0,1,100.0%,1h
24174,2,[相爱一家亲]上善若水,2256,0,1,0,1,100.0%,5m
24174,2,kmert,2256,0,1,2,3,33.3%,1h
24174,2,我只想守护你,2256,30,1,3,4,25.0%,1h
24174,1,GiannisX,2256,48,1,5,6,16.7%,1h
24174,1,简单的许叔叔,2256,0,1,6,7,14.3%,1h
24174,2,吃饱喝足去干批,2256,0,0,1,1,0.0%,1h
24195,2,mdzz,2255,1306,97,97,194,50.0%,4m
24195,2,super,2255,768,28,30,58,48.3%,52m
24195,2,[TLFKR]东野青皮龟,2255,715,25,27,52,48.1%,49m
24195,2,自个的牛牛,2255,294,22,17,39,56.4%,43m
24195,2,[看我朵蜜你]luoaotian,2255,579,22,21,43,51.2%,1h
24195,2,萌新求放过,2255,595,21,22,43,48.8%,1h
24195,1,wabmandyou,2255,459,18,18,36,50.0%,1h
24195,2,歪嘴战神赵老四,2255,355,14,16,30,46.7%,19m
24195,2,赞美太阳,2255,176,8,9,17,47.1%,1h
24195,1,[Shawk]dark,2255,207,7,4,11,63.6%,1h
24195,2,[魔灵圣域]菜鸡梓峰,2255,93,4,2,6,66.7%,1h
24195,3,日落,2255,0,4,5,9,44.4%,1h
24195,2,[o唔姆o]MaGeJiTerran,2255,60,3,2,5,60.0%,1h
24195,2,骚扰我必诛之,2255,30,2,0,2,100.0%,60m
24195,2,晨芒,2255,0,2,3,5,40.0%,1h
24195,2,蛮枭,2255,108,2,5,7,28.6%,1h
24195,2,[GEE]POLARIS,2255,0,0,1,1,0.0%,1h
24195,2,小怪兽先生,2255,0,0,1,1,0.0%,56m
24195,3,skkkyyy,2255,0,0,6,6,0.0%,1h
24214,3,llllllllllll,2254,1325,108,119,227,47.6%,1h
24214,3,小七阿,2254,1498,97,111,208,46.6%,53m
24214,2,Fury,2254,941,56,51,107,52.3%,34m
24214,2,皮皮虾,2254,990,52,59,111,46.8%,60m
24214,2,deeew,2254,642,29,27,56,51.8%,34m
24214,2,九黎之殇,2254,671,28,24,52,53.8%,1h
24214,1,皮皮虾,2254,410,15,18,33,45.5%,24m
24214,2,[特工]繁简繁,2254,300,10,8,18,55.6%,21m
24214,2,超能正在灿,2254,222,7,14,21,33.3%,13m
24214,1,车车架大炮,2254,240,6,9,15,40.0%,12m
24214,2,我从虚空中降临,2254,0,1,0,1,100.0%,34m
24214,1,佛爷,2254,0,1,0,1,100.0%,1h
24214,3,QIQI,2254,30,1,1,2,50.0%,53m
24214,2,唯有墨花,2254,0,1,6,7,14.3%,1h
24214,1,[SS天羽]段方毅,2254,0,1,7,8,12.5%,38m
24214,2,进化之主,2254,0,0,1,1,0.0%,5m
24214,3,[TG战队]月下清酒,2254,0,0,2,2,0.0%,37m
24214,2,[欢迎萌新]开开心心,2254,0,0,2,2,0.0%,5m
24214,2,呆阿龙,2254,0,0,3,3,0.0%,1h
24233,1,DAHE,2253,1238,83,86,169,49.1%,53m
24233,3,[Aegean]Quincy,2253,1575,77,96,173,44.5%,1h
24233,3,caixin,2253,1475,69,76,145,47.6%,22m
24233,1,最好的疯疯,2253,644,27,25,52,51.9%,1h
24233,2,Please,2253,436,16,11,27,59.3%,1h
24233,3,快乐奶牛,2253,263,9,14,23,39.1%,30m
24233,1,Griffithgouf,2253,112,6,6,12,50.0%,1h
24233,1,[菜鸡球带]Tim,2253,136,6,7,13,46.2%,60m
24233,2,WOOD,2253,100,4,4,8,50.0%,1h
24233,2,我最帅了,2253,46,4,5,9,44.4%,55m
24233,1,sotheworldto,2253,186,4,8,12,33.3%,1h
24233,2,CesareK,2253,58,3,0,3,100.0%,1h
24233,2,iuiu,2253,60,3,3,6,50.0%,1h
24233,2,[镜花水月丨]本人空气,2253,30,2,0,2,100.0%,1h
24233,2,HHHGGGFFF,2253,30,2,0,2,100.0%,1h
24233,2,龙渊,2253,30,2,1,3,66.7%,28m
24233,2,shui,2253,46,2,5,7,28.6%,1h
24233,2,[CMCC]zcx,2253,0,1,1,2,50.0%,1h
24233,2,天涯无尽,2253,30,1,3,4,25.0%,1h
24233,2,dixiao,2253,0,0,1,1,0.0%,1h
24253,1,[终极咸鱼]阔少,2252,1686,122,114,236,51.7%,35m
24253,2,[TCP]CtCt,2252,1609,91,102,193,47.2%,30m
24253,2,七七小可爱吖,2252,440,17,9,26,65.4%,44m
24253,1,Hunter,2252,225,10,5,15,66.7%,42m
24253,1,百战成金,2252,168,6,8,14,42.9%,8m
24253,1,深海鲨鱼王,2252,226,6,11,17,35.3%,1h
24253,1,吉祥,2252,189,4,8,12,33.3%,16m
24253,2,彳亍不彳亍,2252,44,2,1,3,66.7%,27m
24253,2,婕妤,2252,30,2,2,4,50.0%,1h
24253,1,[星际爱好者队]别再揍我了,2252,0,2,6,8,25.0%,42m
24253,2,冥界,2252,18,1,1,2,50.0%,1h
24253,1,天际浮云,2252,96,1,2,3,33.3%,9m
24253,2,[四叶草]树人,2252,30,1,2,3,33.3%,1h
24253,1,依伶听风,2252,0,0,3,3,0.0%,1h
24253,1,终焉时刻,2252,0,0,4,4,0.0%,50m
24253,1,阡陌流萤,2252,0,0,4,4,0.0%,1h
24269,3,疯魂,2251,1238,47,60,107,43.9%,53m
24269,1,ihdcdream,2251,875,36,34,70,51.4%,31m
24269,2,绝翼丶皇族,2251,921,32,37,69,46.4%,1h
24269,1,卖鱼最疯狂,2251,808,27,30,57,47.4%,39m
24269,1,独行狼,2251,343,17,12,29,58.6%,51m
24269,3,单行道上的旅行者,2251,287,10,13,23,43.5%,4m
24269,1,随风,2251,326,10,18,28,35.7%,39m
24269,2,[菜有菜的道理]哒嗳,2251,236,8,7,15,53.3%,16m
24269,2,绘梨衣小怪兽,2251,269,8,17,25,32.0%,1h
24269,1,小魔王,2251,247,7,10,17,41.2%,38m
24269,2,赤风,2251,137,5,3,8,62.5%,34m
24269,3,[人族最强近战]AnNbis,2251,148,4,4,8,50.0%,1h
24269,1,井上川雄,2251,193,4,6,10,40.0%,1h
24269,2,PatrickStar,2251,42,4,9,13,30.8%,1h
24269,2,bibi,2251,96,3,7,10,30.0%,13m
24269,2,墨西哥鸡肉卷,2251,74,2,2,4,50.0%,1h
24269,2,LANGXING,2251,32,2,4,6,33.3%,1h
24269,1,鲱鱼王,2251,72,2,7,9,22.2%,35m
24269,2,[GNMS]单手鼠标玩家,2251,48,2,8,10,20.0%,1h
24269,2,天天飘雪,2251,30,1,1,2,50.0%,1h
24269,1,CLF,2251,0,1,6,7,14.3%,22m
24269,2,寂寞惹的祸,2251,0,0,1,1,0.0%,5m
24269,2,紫幽浩,2251,0,0,1,1,0.0%,1h
24292,1,擎天柱,2250,1614,105,106,211,49.8%,1h
24292,2,Moyan,2250,801,48,56,104,46.2%,44m
24292,1,lolxxs,2250,904,40,43,83,48.2%,1h
24292,2,stdio,2250,832,35,29,64,54.7%,1h
24292,1,IGXY,2250,604,21,27,48,43.8%,3m
24292,2,出久生,2250,570,21,29,50,42.0%,1h
24292,2,SakuiS,2250,258,11,2,13,84.6%,10m
24292,1,一天一夜,2250,294,10,20,30,33.3%,14m
24292,2,lueyattaa,2250,209,5,7,12,41.7%,1h
24292,1,胡萝卜三快钱,2250,141,4,9,13,30.8%,16m
24292,2,绮陌红楼,2250,60,2,1,3,66.7%,1h
24292,2,[G868G]wryl,2250,30,2,2,4,50.0%,21m
24292,2,[ILYSK]天雷怒战,2250,0,1,0,1,100.0%,1h
24292,2,MESSI,2250,0,1,0,1,100.0%,1h
24292,2,叛逆者,2250,34,1,2,3,33.3%,18m
24292,1,我是一个诗人,2250,0,1,3,4,25.0%,1h
24292,2,我好菜啊,2250,0,0,1,1,0.0%,1h
24292,1,[送葬]德川家康,2250,0,0,4,4,0.0%,7m
24310,1,Rudolf,2249,1143,45,47,92,48.9%,6m
24310,1,健康的吴先生,2249,726,35,38,73,47.9%,1h
24310,1,浮尘,2249,818,25,35,60,41.7%,1h
24310,1,[miku守护]殇之恋,2249,582,19,28,47,40.4%,9m
24310,2,LongSY,2249,350,13,15,28,46.4%,1h
24310,1,[闺蜜的军械库]纯爱战士天下第一,2249,394,12,14,26,46.2%,12m
24310,1,小音無,2249,246,8,10,18,44.4%,39m
24310,2,LemonBlum,2249,245,6,5,11,54.5%,1h
24310,1,扶我起来我还能送,2249,120,4,7,11,36.4%,1h
24310,1,傲娇的学妹,2249,172,4,8,12,33.3%,7m
24310,1,上古,2249,122,3,6,9,33.3%,1h
24310,1,[八重嘤]fanzy,2249,151,3,7,10,30.0%,1h
24310,1,Aellose,2249,121,3,7,10,30.0%,1h
24310,1,游牧,2249,48,2,1,3,66.7%,1h
24310,1,为了巫妖王,2249,97,2,5,7,28.6%,16m
24310,1,小疯子哥哥,2249,116,2,8,10,20.0%,46m
24310,2,[草滩帝国大学]天地孤影,2249,0,1,0,1,100.0%,1h
24310,2,TONY,2249,0,1,5,6,16.7%,31m
24328,2,易灬,2248,740,82,92,174,47.1%,1h
24328,1,随缘,2248,507,22,15,37,59.5%,27m
24328,2,业余玩家,2248,399,17,14,31,54.8%,1h
24328,2,安度因小王子,2248,454,16,15,31,51.6%,41m
24328,1,有道之士,2248,245,16,16,32,50.0%,36m
24328,1,别野兵营了,2248,484,15,19,34,44.1%,39m
24328,2,[Fnova]泰伦鸡饲料,2248,346,12,15,27,44.4%,13m
24328,3,苍穹之光,2248,300,10,8,18,55.6%,56m
24328,2,[幼女萝莉同好]phantasma,2248,232,9,9,18,50.0%,28m
24328,1,你的资源不足,2248,344,9,13,22,40.9%,1h
24328,1,[scbaby]CSCEC,2248,282,9,16,25,36.0%,1h
24328,2,大虾饶命,2248,227,8,3,11,72.7%,1h
24328,2,白猫吃橘子,2248,184,7,6,13,53.8%,13m
24328,1,[神乐nana]Reading,2248,245,7,9,16,43.8%,24m
24328,3,diamond,2248,201,6,10,16,37.5%,1h
24328,2,骚话卡在嘴边,2248,156,4,1,5,80.0%,60m
24328,2,蝰蛇,2248,162,4,7,11,36.4%,1h
24328,2,达达怪,2248,86,3,2,5,60.0%,1h
24328,2,天际浩劫,2248,90,2,3,5,40.0%,27m
24328,2,菜鸡麻酱,2248,30,1,1,2,50.0%,1h
24328,2,wmy,2248,95,1,1,2,50.0%,31m
24328,2,[父子兵]LORA,2248,30,1,2,3,33.3%,50m
24328,1,Edward,2248,48,1,6,7,14.3%,25m
24351,3,HOMER,2247,1063,151,152,303,49.8%,1h
24351,2,ARTHURWONG,2247,1591,112,110,222,50.5%,34m
24351,1,[oneny]国民老婆孙一峰,2247,695,32,39,71,45.1%,1h
24351,2,长沙人,2247,490,22,21,43,51.2%,1h
24351,2,[神圣路易帝国]DOLLsel,2247,439,19,20,39,48.7%,1h
24351,1,[不会散枪兵丶]Halfedcookie,2247,421,13,15,28,46.4%,7m
24351,2,大佬请教我玩星际,2247,318,13,17,30,43.3%,60m
24351,2,[美少女萬華鏡]久遠寺有珠,2247,206,8,6,14,57.1%,1h
24351,2,bbg,2247,158,6,8,14,42.9%,28m
24351,1,凉介,2247,241,5,11,16,31.2%,17m
24351,2,闪亮之翼,2247,0,1,0,1,100.0%,1h
24351,2,pook,2247,0,1,0,1,100.0%,53m
24351,2,天佑之罗,2247,46,1,1,2,50.0%,16m
24351,2,Computer,2247,30,1,1,2,50.0%,1h
24351,2,FORMER,2247,0,1,5,6,16.7%,1h
24351,2,Scarlett,2247,0,0,1,1,0.0%,1h
24351,2,efe,2247,0,0,1,1,0.0%,19m
24351,2,Nick,2247,0,0,1,1,0.0%,1h
24369,3,[東風快递]FORWARDWANG,2246,1504,169,186,355,47.6%,1h
24369,1,GaB,2246,585,84,90,174,48.3%,3m
24369,1,江湖乘舟,2246,1562,70,65,135,51.9%,3m
24369,3,洛燨,2246,1172,69,79,148,46.6%,1h
24369,1,peter,2246,1569,63,68,131,48.1%,1h
24369,1,[南京何平]发哥,2246,489,32,37,69,46.4%,3m
24369,3,[小小怪怪]Dark,2246,798,25,43,68,36.8%,1h
24369,1,holmes,2246,390,23,25,48,47.9%,20m
24369,1,Lavie,2246,520,17,25,42,40.5%,20m
24369,1,红花山,2246,444,16,18,34,47.1%,1h
24369,1,壹世,2246,408,15,23,38,39.5%,25m
24369,1,不太会内战,2246,396,12,16,28,42.9%,3m
24369,2,[神圣纪元]皮特洛,2246,225,10,18,28,35.7%,5m
24369,1,神盾局局长,2246,283,8,11,19,42.1%,1h
24369,2,[浴火银河]众神之光,2246,90,4,4,8,50.0%,1h
24369,3,blackapple,2246,145,3,4,7,42.9%,1h
24369,2,北朝,2246,62,2,5,7,28.6%,16m
24369,1,Fox,2246,96,2,5,7,28.6%,58m
24369,2,零落浮华,2246,0,1,0,1,100.0%,60m
24369,2,听风,2246,0,1,1,2,50.0%,1h
24369,2,[LOHs]wdymbc,2246,0,1,1,2,50.0%,44m
24369,2,[献祭阁]一只小小的哼唧怪,2246,0,1,1,2,50.0%,34m
24369,2,[DDOS疾风]Brambles,2246,92,1,5,6,16.7%,16m
24369,3,[往事如风]胖虎,2246,97,1,5,6,16.7%,1h
24369,2,笑若扶风,2246,0,1,5,6,16.7%,26m
24369,2,jim,2246,0,0,2,2,0.0%,60m
24369,2,[Achill]持久输出,2246,0,0,4,4,0.0%,1h
24396,1,[WND]消遣,2245,1620,98,108,206,47.6%,46m
24396,1,nonochen,2245,1004,58,54,112,51.8%,21m
24396,1,DTON,2245,533,24,24,48,50.0%,1h
24396,2,[碰碰纽币]局外人,2245,577,21,19,40,52.5%,5m
24396,1,JunDi,2245,481,20,14,34,58.8%,12m
24396,2,我就是我自己,2245,304,17,29,46,37.0%,51m
24396,1,himan,2245,353,10,12,22,45.5%,54m
24396,2,三赖子,2245,178,7,6,13,53.8%,41m
24396,2,大和牛到爆,2245,188,5,4,9,55.6%,34m
24396,3,拉布拉多,2245,42,5,13,18,27.8%,1h
24396,2,jia,2245,88,2,2,4,50.0%,1h
24396,2,[比心老子爱你]KILLER,2245,0,1,0,1,100.0%,18m
24396,2,[看我朵蜜你]芝华士里有芝士,2245,0,1,1,2,50.0%,50m
24396,3,村子里的文化仔,2245,0,1,1,2,50.0%,1h
24396,3,冬雨冬雨不下雨,2245,0,0,1,1,0.0%,8m
24396,1,史正翔,2245,0,0,2,2,0.0%,16m
24412,1,郁子,2244,1193,134,144,278,48.2%,24m
24412,1,迦拉克隆,2244,581,25,30,55,45.5%,1h
24412,2,高育良,2244,588,22,27,49,44.9%,1h
24412,2,朝歌晚酒,2244,468,17,14,31,54.8%,1h
24412,2,魔力风云,2244,242,9,9,18,50.0%,1h
24412,2,CLOWN,2244,95,5,6,11,45.5%,28m
24412,1,又菜又爱玩,2244,142,4,5,9,44.4%,1h
24412,1,秋刀鱼,2244,135,3,6,9,33.3%,54m
24412,2,livathan,2244,32,2,2,4,50.0%,18m
24412,2,[混元极意星际]我说了算,2244,0,1,0,1,100.0%,31m
24412,2,小飞,2244,0,1,1,2,50.0%,53m
24412,2,xzlqz,2244,30,1,1,2,50.0%,18m
24412,2,miracle,2244,0,1,4,5,20.0%,56m
24412,2,[使劲tao]想一想,2244,0,1,5,6,16.7%,1h
24412,2,神之虫族使者好,2244,0,0,1,1,0.0%,1h
24412,2,Hardess,2244,0,0,1,1,0.0%,1h
24412,2,月半青柠,2244,0,0,1,1,0.0%,54m
24412,2,诸神,2244,0,0,1,1,0.0%,60m
24412,2,mars,2244,0,0,2,2,0.0%,50m
24412,2,asketer,2244,0,0,2,2,0.0%,56m
24412,2,桃兒,2244,0,0,3,3,0.0%,1h
24433,1,Dominique,2243,1373,93,96,189,49.2%,39m
24433,1,[KPG2]单矿飞机王,2243,1558,60,58,118,50.8%,1h
24433,1,dboo,2243,1044,50,50,100,50.0%,1h
24433,1,ZERO,2243,1002,32,38,70,45.7%,1h
24433,1,破碎流星,2243,651,30,28,58,51.7%,54m
24433,3,打工戦士,2243,314,17,32,49,34.7%,23m
24433,2,听她,2243,282,11,9,20,55.0%,30m
24433,2,天梦,2243,321,10,8,18,55.6%,1h
24433,1,smalltank,2243,165,5,8,13,38.5%,22m
24433,2,死亡之翼,2243,114,4,6,10,40.0%,1h
24433,2,疯子不加血,2243,88,3,4,7,42.9%,1h
24433,1,[世风第三帝国]汗水宝宝,2243,46,2,2,4,50.0%,1h
24433,2,jxlq,2243,44,2,6,8,25.0%,1h
24433,2,似色非空,2243,0,1,2,3,33.3%,5m
24433,2,[爱你丶T]爱睡觉的熊,2243,32,1,3,4,25.0%,13m
24433,2,齐忌,2243,0,1,4,5,20.0%,1h
24433,2,arsilang,2243,0,0,1,1,0.0%,1h
24433,2,[卐二五仔]三生,2243,0,0,1,1,0.0%,1h
24433,1,[凤姐迎亲团]有党性没人性,2243,0,0,2,2,0.0%,1h
24433,2,[TPLINK]没名字取了,2243,0,0,2,2,0.0%,1h
24433,2,hammer,2243,0,0,4,4,0.0%,31m
24454,1,笙宝马卡龙,2242,1273,78,81,159,49.1%,15m
24454,1,笑天下,2242,608,20,34,54,37.0%,21m
24454,1,ZYHeart,2242,381,17,11,28,60.7%,25m
24454,1,Ancestor,2242,467,16,27,43,37.2%,1h
24454,1,惠葱先生,2242,398,13,16,29,44.8%,1h
24454,2,[KPG]春风拂兰露华浓,2242,318,12,7,19,63.2%,16m
24454,1,Sunway,2242,123,12,13,25,48.0%,46m
24454,3,灭世修罗,2242,225,9,4,13,69.2%,1h
24454,1,MAPLE,2242,264,7,15,22,31.8%,1h
24454,2,为了军团,2242,188,6,4,10,60.0%,34m
24454,2,[NLHR]小四,2242,110,4,7,11,36.4%,1h
24454,2,foreverwz,2242,92,3,4,7,42.9%,10m
24454,1,对王之王,2242,144,3,8,11,27.3%,9m
24454,2,安好不谈情,2242,50,2,2,4,50.0%,18m
24454,2,[秋毫]drsg,2242,0,1,0,1,100.0%,56m
24454,2,pinor,2242,0,1,1,2,50.0%,1h
24454,2,van,2242,0,1,2,3,33.3%,1h
24471,2,余大人,2241,1439,109,116,225,48.4%,1h
24471,1,Bozsen,2241,1142,47,52,99,47.5%,3m
24471,2,csc,2241,435,16,19,35,45.7%,1h
24471,2,酷巴哥,2241,340,13,17,30,43.3%,1h
24471,1,海之泪,2241,388,12,15,27,44.4%,1h
24471,3,[天天跪吃咸鱼]天边的一朵云,2241,80,7,9,16,43.8%,1h
24471,2,寒阳雪,2241,118,5,5,10,50.0%,18m
24471,3,诶嘿嘿嘿,2241,105,5,9,14,35.7%,1h
24471,2,Christopher,2241,58,3,1,4,75.0%,1h
24471,2,乔乔的奇妙战斗,2241,58,3,1,4,75.0%,50m
24471,2,[基金会]sky,2241,38,2,3,5,40.0%,50m
24471,2,学种田,2241,114,2,3,5,40.0%,1h
24471,2,[真理卐高中]为你微笑,2241,0,1,0,1,100.0%,28m
24471,2,杨俣,2241,48,1,2,3,33.3%,11m
24471,2,[嘟嘟嘟噜]最不会起名字了,2241,0,0,1,1,0.0%,1h
24486,3,mrmvp,2240,1514,114,120,234,48.7%,1h
24486,3,FLY,2240,1519,78,95,173,45.1%,48m
24486,2,[老色批联盟]宇宙无敌人族王,2240,1195,53,44,97,54.6%,1h
24486,2,[886]kingwwww,2240,1327,50,52,102,49.0%,1h
24486,2,CCLssr,2240,952,39,35,74,52.7%,4m
24486,1,[ALSN]白里云天,2240,391,13,15,28,46.4%,1h
24486,1,[薄暮之光]萌哒哒的尤迪安,2240,366,13,21,34,38.2%,14m
24486,2,Whisper,2240,260,9,15,24,37.5%,1h
24486,2,MaRk,2240,153,8,8,16,50.0%,34m
24486,2,吉迈器楽行,2240,143,5,7,12,41.7%,1h
24486,1,天大自在,2240,139,4,2,6,66.7%,13m
24486,2,[萌王赛高]时崎狂三,2240,90,4,4,8,50.0%,44m
24486,1,爱雯子真是太好啦,2240,180,4,6,10,40.0%,60m
24486,2,[loveMM]moyu,2240,88,2,0,2,100.0%,1h
24486,3,人类冒出来了,2240,121,2,5,7,28.6%,47m
24486,2,饿的福瑞迪,2240,68,2,8,10,20.0%,1h
24486,2,[Ducks]郑州神王,2240,0,1,0,1,100.0%,1h
24486,2,Vilsk,2240,30,1,2,3,33.3%,19m
24486,2,蓝色天空,2240,0,1,5,6,16.7%,17m
24486,2,colowahaha,2240,0,0,1,1,0.0%,1h
24486,2,幽灵,2240,0,0,1,1,0.0%,5m
24486,1,你个憨逼,2240,0,0,1,1,0.0%,1h
24508,1,[鹌鹑带星]呀哈哈,2239,545,70,70,140,50.0%,1h
24508,2,[极限菜鸟]bujingyunha,2239,1124,67,67,134,50.0%,13m
24508,3,粉红喵喵拳,2239,667,27,33,60,45.0%,8m
24508,1,白泽约束,2239,398,14,14,28,50.0%,3m
24508,2,啊樂,2239,386,13,20,33,39.4%,1h
24508,2,沈一,2239,360,13,26,39,33.3%,1h
24508,2,独角兽,2239,286,9,8,17,52.9%,23m
24508,2,阳阳,2239,268,9,10,19,47.4%,17m
24508,1,永恒,2239,142,7,9,16,43.8%,1h
24508,1,Vestal,2239,280,6,11,17,35.3%,1h
24508,2,天罚,2239,178,5,4,9,55.6%,1h
24508,3,[辉煌华夏]喝奶不舔盖儿,2239,80,4,6,10,40.0%,10m
24508,1,KYsoulF,2239,148,4,15,19,21.1%,3m
24508,2,[miku守护]Yunyu,2239,30,1,3,4,25.0%,5m
24508,2,德利傻,2239,48,1,4,5,20.0%,39m
24508,2,nightRMR,2239,0,1,5,6,16.7%,17m
24508,1,Alex,2239,0,1,10,11,9.1%,1h
24508,2,智叟,2239,0,0,1,1,0.0%,1h
24508,2,半城蘩华半城傷,2239,0,0,2,2,0.0%,1h
24508,2,[琴筝]天羽,2239,0,0,3,3,0.0%,1h
24528,2,悟空,2238,1429,135,150,285,47.4%,19m
24528,2,vismaster,2238,1353,55,58,113,48.7%,10m
24528,1,SoWhat,2238,439,53,79,132,40.2%,1h
24528,1,孙天我能让你,2238,581,24,23,47,51.1%,1h
24528,1,老鹰,2238,618,20,32,52,38.5%,1h
24528,2,Acre,2238,285,11,17,28,39.3%,34m
24528,2,小铁驴,2238,282,9,9,18,50.0%,18m
24528,1,小奶狗,2238,211,6,8,14,42.9%,16m
24528,1,llllllllllll,2238,234,6,10,16,37.5%,1h
24528,2,SSSSSnake,2238,183,5,7,12,41.7%,52m
24528,1,HSSSS,2238,239,5,11,16,31.2%,1h
24528,2,[爱是一道光哦]KLin,2238,150,5,26,31,16.1%,1h
24528,3,kelvin,2238,44,3,9,12,25.0%,42m
24528,2,青铜水平请多包涵,2238,0,1,0,1,100.0%,12m
24528,2,sdf,2238,0,1,1,2,50.0%,34m
24528,2,Distillation,2238,0,0,1,1,0.0%,27m
24528,1,[野马星际]KingStar,2238,0,0,1,1,0.0%,1h
24528,2,简爱,2238,0,0,2,2,0.0%,27m
24546,1,danziyigedia,2237,1095,41,39,80,51.2%,36m
24546,2,SayKing,2237,696,26,29,55,47.3%,50m
24546,1,马孔多,2237,446,21,19,40,52.5%,1h
24546,2,DivineJudge,2237,469,20,8,28,71.4%,17m
24546,2,歌本哈根的星球,2237,566,18,22,40,45.0%,1h
24546,2,雪惊风,2237,272,10,5,15,66.7%,1h
24546,2,steve,2237,0,3,3,6,50.0%,1h
24546,1,使命必达,2237,121,2,3,5,40.0%,1h
24546,1,霸气小漏,2237,0,2,4,6,33.3%,50m
24546,2,殇年忆,2237,46,2,6,8,25.0%,1h
24546,2,[红莲骑士团]小哥哥,2237,0,1,1,2,50.0%,1h
24557,2,Freedom,2236,1442,179,196,375,47.7%,41m
24557,1,魔兽争霸,2236,867,57,66,123,46.3%,53m
24557,2,妖零,2236,1021,52,46,98,53.1%,1h
24557,1,红尘入梦邀故人,2236,1343,51,53,104,49.0%,1h
24557,2,星辰大海黎明之光,2236,905,38,31,69,55.1%,49m
24557,3,[s黑色玫瑰s]贤贤易色,2236,640,19,49,68,27.9%,50m
24557,1,鸿信,2236,520,17,28,45,37.8%,1h
24557,2,[我真的是萌新]SFC,2236,346,10,15,25,40.0%,1h
24557,2,丿悟死灬参玄,2236,158,5,1,6,83.3%,1h
24557,1,啦啦啦啦,2236,95,4,4,8,50.0%,42m
24557,3,cloudddds,2236,0,3,2,5,60.0%,1h
24557,2,zest,2236,94,3,3,6,50.0%,1h
24557,2,机械承,2236,30,2,0,2,100.0%,1h
24557,2,[暴雪十七队]默珏,2236,0,1,0,1,100.0%,1h
24557,2,[巴楚文化广场]小史有毒,2236,0,1,1,2,50.0%,56m
24557,1,xaiyubai,2236,97,1,2,3,33.3%,60m
24557,2,粪海狂蛆,2236,0,1,6,7,14.3%,1h
24557,2,Simper,2236,0,0,1,1,0.0%,4m
24557,2,夜愿之子,2236,0,0,1,1,0.0%,1h
24557,1,Cyber,2236,0,0,3,3,0.0%,1h
24557,2,奉我为主,2236,0,0,3,3,0.0%,18m
24578,2,小白,2235,1003,50,40,90,55.6%,1h
24578,1,凡华吖,2235,728,28,26,54,51.9%,47m
24578,1,LLDD,2235,719,28,34,62,45.2%,1h
24578,1,亚克斯,2235,329,15,15,30,50.0%,15m
24578,2,革命军领袖李佳楠,2235,253,9,10,19,47.4%,34m
24578,3,鸡你太美,2235,195,6,14,20,30.0%,37m
24578,1,[ODST25]Maverick,2235,89,3,11,14,21.4%,52m
24578,2,伊藤诚,2235,0,1,0,1,100.0%,1h
24578,2,树梢的影子,2235,0,1,0,1,100.0%,49m
24578,2,sxsxaz,2235,0,1,0,1,100.0%,41m
24578,2,乔尔和艾莉,2235,0,1,1,2,50.0%,60m
24578,3,虚空之门,2235,0,1,4,5,20.0%,1h
24578,1,[RD彩虹小马]丶丶丶,2235,38,1,8,9,11.1%,14m
24591,1,[RTSGo]东宝,2234,1421,100,106,206,48.5%,46m
24591,2,小俊,2234,1192,48,45,93,51.6%,1h
24591,3,极品渣男,2234,772,31,38,69,44.9%,1h
24591,1,AggressivKin,2234,567,22,23,45,48.9%,54m
24591,2,[社交学超可爱]叶玄,2234,576,20,17,37,54.1%,1h
24591,3,lugg,2234,190,20,26,46,43.5%,33m
24591,1,Fredrica,2234,502,16,20,36,44.4%,1h
24591,3,[TS嘉年华]Morlan,2234,164,4,3,7,57.1%,1h
24591,2,ptu,2234,124,4,4,8,50.0%,1h
24591,2,没法,2234,98,4,6,10,40.0%,52m
24591,3,啥都不懂的萌新,2234,30,3,8,11,27.3%,1h
24591,1,[黄金海舰队]丨雨泽丨,2234,96,2,6,8,25.0%,1h
24591,1,llllllllllll,2234,0,1,0,1,100.0%,1h
24591,2,桐人,2234,0,0,2,2,0.0%,1h
24591,2,给我生个孩子好吗,2234,0,0,3,3,0.0%,13m
24606,2,流浪汉,2233,971,34,40,74,45.9%,1h
24606,2,necoarc,2233,736,30,28,58,51.7%,1h
24606,2,[园神凛祢]剑心,2233,479,17,14,31,54.8%,1h
24606,2,[BOF丶佛堂]达斯坦王子,2233,478,17,15,32,53.1%,13m
24606,2,hook,2233,458,17,16,33,51.5%,1h
24606,1,想要跳舞,2233,280,8,17,25,32.0%,12m
24606,3,[纵丨横]SKY,2233,179,6,12,18,33.3%,1h
24606,3,我生已晚,2233,182,5,5,10,50.0%,1h
24606,2,Star,2233,122,4,8,12,33.3%,1h
24606,1,宝瓜,2233,120,3,7,10,30.0%,15m
24606,1,[小鸡屠宰场b]毒液,2233,60,2,25,27,7.4%,56m
24606,2,[查尔养鸡场]罗辑,2233,0,0,1,1,0.0%,1h
24606,2,圣城旅纵队指挥官,2233,0,0,1,1,0.0%,1h
24606,1,徐龙伟,2233,0,0,2,2,0.0%,1h
24606,2,白庚辰,2233,73,0,2,2,0.0%,1h
24621,2,向前看,2232,1436,55,57,112,49.1%,13m
24621,1,[白给丶兄弟]Unnamed,2232,293,30,29,59,50.8%,4m
24621,2,九秋,2232,531,20,22,42,47.6%,19m
24621,2,水银灯,2232,320,14,12,26,53.8%,1h
24621,2,假如有昵称,2232,363,13,14,27,48.1%,1h
24621,2,刘莉莉的哈士奇,2232,305,12,7,19,63.2%,17m
24621,2,Hello,2232,201,12,8,20,60.0%,1h
24621,3,神奇的小二,2232,303,10,12,22,45.5%,56m
24621,1,zenomee,2232,202,9,14,23,39.1%,35m
24621,2,自由的小鸟,2232,198,7,7,14,50.0%,5m
24621,1,重生,2232,181,7,7,14,50.0%,1h
24621,1,ExC,2232,267,6,14,20,30.0%,39m
24621,1,[血战艾蒙]在劫难逃,2232,160,5,10,15,33.3%,11m
24621,2,hohoho,2232,0,4,6,10,40.0%,34m
24621,2,[暗黑战皇]邪王真眼,2232,64,3,2,5,60.0%,4m
24621,2,Nebula,2232,48,3,5,8,37.5%,39m
24621,2,死神之歌,2232,0,0,1,1,0.0%,41m
24621,2,吉姆雷诺,2232,0,0,1,1,0.0%,1h
24639,1,[综合酯法]东风快递,2231,1471,65,63,128,50.8%,1h
24639,2,就是红,2231,848,49,6,55,89.1%,1h
24639,2,致死的哥特黑猫,2231,807,31,31,62,50.0%,17m
24639,2,空夸张,2231,552,29,38,67,43.3%,1h
24639,1,小毒狼,2231,184,7,7,14,50.0%,1h
24639,1,liurxe,2231,124,4,7,11,36.4%,1h
24639,3,[29CM]宜选月冷风清,2231,116,3,4,7,42.9%,1h
24639,1,Cherry,2231,46,2,3,5,40.0%,50m
24639,2,银斧头,2231,58,2,6,8,25.0%,1h
24639,2,zhoyu,2231,0,1,0,1,100.0%,1h
24639,2,我渴望被殴打,2231,30,1,1,2,50.0%,10m
24639,2,[虎牙小金直播]金嫂是我的,2231,0,1,1,2,50.0%,1h
24639,2,jiayimiao,2231,32,1,2,3,33.3%,41m
24639,1,星际魔人,2231,97,1,4,5,20.0%,1h
24639,2,djfiifigoif,2231,0,0,1,1,0.0%,1h
24639,1,fair,2231,73,0,5,5,0.0%,1h
24655,1,Chicken,2230,915,69,74,143,48.3%,1h
24655,1,KEN,2230,604,19,29,48,39.6%,9m
24655,2,mengmengbe,2230,328,12,15,27,44.4%,17m
24655,2,[暴雪二十八队]dunima,2230,360,12,17,29,41.4%,18m
24655,2,他马的,2230,284,9,16,25,36.0%,1h
24655,2,WeekEnd,2230,184,6,1,7,85.7%,1h
24655,1,丿神谕,2230,236,6,10,16,37.5%,22m
24655,1,霸气你晨哥,2230,195,6,10,16,37.5%,22m
24655,1,红白,2230,197,5,8,13,38.5%,11m
24655,2,打死小强,2230,118,4,3,7,57.1%,10m
24655,2,丨魄,2230,0,3,3,6,50.0%,56m
24655,1,母舰骑脸,2230,48,1,1,2,50.0%,25m
24655,2,Starry,2230,0,1,5,6,16.7%,56m
24655,2,大漠孤烟,2230,0,0,1,1,0.0%,56m
24655,2,[爱国]origin,2230,0,0,1,1,0.0%,12m
24655,2,一只小菜鸟,2230,0,0,2,2,0.0%,1h
24671,1,AlphaMoMO,2229,1588,159,164,323,49.2%,1h
24671,1,罗宾,2229,1578,134,131,265,50.6%,1h
24671,1,德一甲师医疗兵,2229,1637,82,87,169,48.5%,24m
24671,1,ghost,2229,1210,47,47,94,50.0%,3m
24671,1,影藏,2229,918,31,37,68,45.6%,35m
24671,1,我是人间惆怅客,2229,568,17,26,43,39.5%,35m
24671,1,kojhsiuq,2229,474,14,18,32,43.8%,1h
24671,2,碟祈,2229,358,11,11,22,50.0%,13m
24671,2,RMKL,2229,359,11,16,27,40.7%,1h
24671,2,mmm,2229,208,8,10,18,44.4%,60m
24671,2,抽刀断水水更流,2229,112,5,2,7,71.4%,1h
24671,1,逝去的羽翼,2229,183,4,9,13,30.8%,7m
24671,2,老崔天下无敌,2229,58,3,1,4,75.0%,1h
24671,2,[呆萌小萝莉]小饼干,2229,30,2,0,2,100.0%,1h
24671,2,[NZNZ]狄克推多,2229,112,2,1,3,66.7%,1h
24671,1,[星海争霸二]zhuang,2229,95,2,1,3,66.7%,60m
24671,2,jkgyrtfy,2229,116,2,3,5,40.0%,56m
24671,1,传国灬玺,2229,142,2,4,6,33.3%,16m
24671,1,xiaochen,2229,96,2,7,9,22.2%,17m
24671,2,[清风秋色如歌]与清歌同梦,2229,0,0,1,1,0.0%,16m
24671,2,IIIIIIIIIIII,2229,0,0,1,1,0.0%,50m
24671,2,[糯米丸子]萌新不想成瞎子,2229,0,0,1,1,0.0%,1h
24671,2,wwww,2229,0,0,1,1,0.0%,56m
24694,2,Allander,2228,840,31,30,61,50.8%,10m
24694,2,[CPT]帅帅的我,2228,374,20,22,42,47.6%,50m
24694,1,只会憋航母,2228,626,19,24,43,44.2%,35m
24694,2,LXF,2228,526,17,21,38,44.7%,1h
24694,2,[你已经死啦]可怜孩子在线虐人,2228,73,1,1,2,50.0%,50m
24694,2,喜欢三年八班沈颜,2228,0,1,5,6,16.7%,60m
24694,2,桐生战兔,2228,0,0,1,1,0.0%,23m
24694,2,江门古天乐,2228,0,0,1,1,0.0%,1h
24694,2,QEQIO,2228,0,0,2,2,0.0%,1h
24694,2,不想取名,2228,0,0,4,4,0.0%,1h
24704,2,真空快递员,2227,309,13,4,17,76.5%,1h
24704,2,linespace,2227,293,13,12,25,52.0%,13m
24704,1,[单推小狐狸]雨玲珑,2227,349,13,15,28,46.4%,3m
24704,2,我即是虫群,2227,334,12,7,19,63.2%,37m
24704,1,上山虎,2227,378,12,23,35,34.3%,24m
24704,2,Renka,2227,297,10,9,19,52.6%,1h
24704,2,[艾尔之主]Aiospg,2227,242,7,4,11,63.6%,52m
24704,2,TBS,2227,174,6,3,9,66.7%,1h
24704,3,冰封之星,2227,222,6,11,17,35.3%,1h
24704,1,sirius,2227,100,5,12,17,29.4%,39m
24704,2,跳跳的犀牛,2227,96,4,3,7,57.1%,1h
24704,3,朱彦卿,2227,168,4,4,8,50.0%,1h
24704,2,[Months]花花公子,2227,134,4,5,9,44.4%,1h
24704,2,[第一国际]苏维埃太空军,2227,111,3,1,4,75.0%,26m
24704,1,多弗朗明戈,2227,141,3,8,11,27.3%,8m
24704,2,战争之王,2227,93,2,0,2,100.0%,1h
24704,1,xingkong,2227,46,2,1,3,66.7%,1h
24704,3,[谁在呼叫舰队]LEO,2227,121,2,1,3,66.7%,47m
24704,1,队长别开枪,2227,80,2,11,13,15.4%,7m
24704,2,[极限菜鸟]freend,2227,32,1,2,3,33.3%,23m
24704,1,爱你的名字,2227,48,1,2,3,33.3%,13m
24704,2,[Ikuns]桃喰莉莉佳,2227,30,1,4,5,20.0%,1h
24704,2,AssassinZ,2227,0,1,5,6,16.7%,1h
24704,2,专业作死,2227,0,1,5,6,16.7%,34m
24704,2,[吊打虫族]给你动词你怎么办,2227,0,1,6,7,14.3%,1h
24704,2,裤裆有杀气丶,2227,0,0,1,1,0.0%,60m
24704,2,Lcso,2227,0,0,2,2,0.0%,1h
24731,2,[田中姬铃木雏]艾尔吴彦祖,2226,934,38,35,73,52.1%,1h
24731,2,老寒腿怎么治,2226,738,26,29,55,47.3%,1h
24731,1,[高街村]下水道里的老鼠人,2226,373,13,14,27,48.1%,1h
24731,2,撒撒撒,2226,210,8,8,16,50.0%,1h
24731,2,这一刀叫两断,2226,132,5,5,10,50.0%,5m
24731,1,北工大机枪兵,2226,216,5,11,16,31.2%,23m
24731,2,起航吧青春,2226,150,4,2,6,66.7%,23m
24731,2,张三链子,2226,120,4,7,11,36.4%,19m
24731,3,[东方舰娘共荣]JulY,2226,159,4,16,20,20.0%,1h
24731,2,gan,2226,0,3,3,6,50.0%,1h
24731,2,[CHNova]嬲嬲嬲嬲嬲,2226,66,3,4,7,42.9%,19m
24731,2,Zerg,2226,30,2,2,4,50.0%,34m
24731,2,Mayvac,2226,0,1,0,1,100.0%,1h
24731,1,我说了我是瑪维,2226,0,1,1,2,50.0%,1h
24731,2,[猫耳娘]米娜桑,2226,0,1,5,6,16.7%,1h
24731,3,求求你们别脏,2226,0,0,1,1,0.0%,28m
24747,1,[七咕咕]LoneGG,2225,1679,250,261,511,48.9%,1h
24747,2,IIIIIIII,2225,1587,205,216,421,48.7%,5m
24747,2,难堪,2225,837,59,70,129,45.7%,48m
24747,2,离家楚竹,2225,1086,54,56,110,49.1%,10m
24747,2,天意,2225,595,21,18,39,53.8%,41m
24747,1,[RKT]Vanir,2225,142,5,9,14,35.7%,1h
24747,2,黄哥的小飞机,2225,122,4,5,9,44.4%,10m
24747,1,湖边树,2225,86,4,7,11,36.4%,35m
24747,2,[镜花水月丨]VOX,2225,34,2,2,4,50.0%,44m
24747,2,[MUL]浮觞百夜珅,2225,46,2,2,4,50.0%,1h
24747,3,Clover,2225,0,1,4,5,20.0%,1h
24747,2,大力三,2225,0,1,5,6,16.7%,17m
24747,1,金色战士,2225,0,0,3,3,0.0%,1h
24760,1,班声动而北风起,2224,901,122,133,255,47.8%,24m
24760,1,linsantu,2224,629,77,84,161,47.8%,11m
24760,3,无双天道,2224,1399,71,88,159,44.7%,1h
24760,2,万年老中医,2224,433,70,88,158,44.3%,50m
24760,1,ooo,2224,1350,66,77,143,46.2%,1h
24760,1,Kintz,2224,856,51,49,100,51.0%,27m
24760,1,星星电灯,2224,848,27,40,67,40.3%,7m
24760,2,文兄,2224,436,26,17,43,60.5%,1h
24760,2,Timber,2224,204,7,3,10,70.0%,5m
24760,3,[昏夜渡鸦]弦梦夜曲,2224,143,4,0,4,100.0%,1h
24760,1,Leslie,2224,159,4,9,13,30.8%,1h
24760,3,LiZhi,2224,0,3,2,5,60.0%,1h
24760,3,逆风好残,2224,147,3,4,7,42.9%,45m
24760,2,gzq,2224,30,2,0,2,100.0%,1h
24760,1,[mkb]HAOHANXINGKO,2224,30,2,7,9,22.2%,35m
24760,3,终结者,2224,30,2,9,11,18.2%,9m
24760,2,彼岸,2224,0,1,0,1,100.0%,1h
24760,2,浮夸半生,2224,48,1,1,2,50.0%,1h
24760,2,虚晃,2224,38,1,3,4,25.0%,13m
24760,1,画心,2224,0,1,6,7,14.3%,1h
24780,2,夜雨声繁,2223,1554,80,74,154,51.9%,1h
24780,2,暗裔蚊子,2223,503,28,32,60,46.7%,1h
24780,2,我就是道德的化身,2223,569,19,20,39,48.7%,1h
24780,1,staim,2223,468,14,22,36,38.9%,24m
24780,2,[sdadad]小朋友友友友,2223,306,12,9,21,57.1%,13m
24780,1,ZRQE,2223,215,6,9,15,40.0%,1h
24780,2,[嗑药小分队]肥波,2223,58,3,1,4,75.0%,1h
24780,2,嚼口香糖的恶魔,2223,62,3,2,5,60.0%,1h
24780,2,新手放过我,2223,68,3,3,6,50.0%,1h
24780,1,[尼禄]兰伯特丿晓宇,2223,142,3,3,6,50.0%,45m
24780,2,voida,2223,94,3,5,8,37.5%,19m
24780,2,[暴雪十五队]敢达天盾,2223,60,2,2,4,50.0%,34m
24780,1,xiaoleishou,2223,0,1,0,1,100.0%,12m
24780,2,张韩子轩,2223,30,1,1,2,50.0%,19m
24780,2,胡啦呼啦,2223,94,1,2,3,33.3%,1h
24780,1,笑容太野,2223,0,1,3,4,25.0%,25m
24780,1,[神奇的星际哦]rangwolai,2223,0,0,1,1,0.0%,1h
24797,2,矿骡王子,2222,1477,124,140,264,47.0%,19m
24797,2,黑之宣告,2222,446,20,22,42,47.6%,28m
24797,1,[混吃混喝]无法选择,2222,363,19,18,37,51.4%,1h
24797,2,[谁不服]Jarvis,2222,308,9,13,22,40.9%,1h
24797,1,LuoLe,2222,244,7,16,23,30.4%,1h
24797,3,[YINGJI]沐渊,2222,151,5,10,15,33.3%,56m
24797,1,复活的灵魂,2222,167,4,9,13,30.8%,22m
24797,3,荒包子,2222,121,3,2,5,60.0%,11m
24797,3,漓殇,2222,34,3,10,13,23.1%,1h
24797,2,Jat,2222,0,1,0,1,100.0%,53m
24797,2,就是这个样子,2222,0,1,1,2,50.0%,1h
24797,1,llbe,2222,97,1,4,5,20.0%,12m
24797,2,[贪玩星际]补丁哥,2222,0,1,5,6,16.7%,12m
24797,2,[你瞧不起我吗]暗墓,2222,0,0,1,1,0.0%,56m
24797,2,言和,2222,0,0,1,1,0.0%,53m
24797,2,隐秘之兽,2222,0,0,3,3,0.0%,1h
24797,2,wzk,2222,0,0,4,4,0.0%,1h
24814,1,干就对了,2221,1146,71,74,145,49.0%,4m
24814,3,冰雪狂神,2221,1443,55,59,114,48.2%,22m
24814,2,阿斯巴甜,2221,1078,46,33,79,58.2%,1h
24814,2,Wingkyo,2221,379,14,20,34,41.2%,44m
24814,1,风筝,2221,346,8,13,21,38.1%,16m
24814,2,meekiller,2221,152,6,6,12,50.0%,30m
24814,2,[剑所指心所向]秋夏,2221,232,6,8,14,42.9%,1h
24814,1,MFRctA,2221,192,6,12,18,33.3%,1h
24814,3,hyy,2221,0,3,8,11,27.3%,26m
24814,2,伟锅,2221,30,2,0,2,100.0%,41m
24814,2,范思哲,2221,0,2,4,6,33.3%,60m
24814,2,叶子,2221,88,2,4,6,33.3%,39m
24814,3,游龙当归海,2221,0,2,9,11,18.2%,42m
24814,2,射的远,2221,0,1,0,1,100.0%,1h
24814,2,[暴雪养鸡场]RONIN,2221,0,1,1,2,50.0%,1h
24814,2,sssnnnn,2221,46,1,2,3,33.3%,53m
24814,2,啊欢卖萌,2221,44,1,3,4,25.0%,55m
24814,2,熊大,2221,89,1,4,5,20.0%,60m
24814,1,无法超越的神,2221,46,1,5,6,16.7%,11m
24814,2,[Msp]丶灵猫,2221,96,1,6,7,14.3%,56m
24814,1,[黑粉头子]刘真,2221,0,0,1,1,0.0%,45m
24814,2,十二岁天才少年,2221,0,0,1,1,0.0%,28m
24814,2,饿过才知道,2221,0,0,6,6,0.0%,1h
24837,1,依旧第三,2220,1282,47,59,106,44.3%,1h
24837,2,neo,2220,886,34,28,62,54.8%,1h
24837,1,DreanmSzs,2220,662,21,29,50,42.0%,41m
24837,1,小天,2220,308,15,23,38,39.5%,1h
24837,2,[五月花]养朱刘老根,2220,303,11,17,28,39.3%,1h
24837,2,星海,2220,192,7,3,10,70.0%,1h
24837,1,denaif,2220,162,4,3,7,57.1%,1h
24837,2,physicalsoul,2220,112,3,0,3,100.0%,1h
24837,1,cow,2220,191,3,3,6,50.0%,16m
24837,1,博深,2220,0,3,5,8,37.5%,9m
24837,3,一剑碎影,2220,30,2,4,6,33.3%,1h
24848,2,[Bias]白石,2219,146,5,6,11,45.5%,1h
24848,2,[今生必干花开]皮卡丘大萌新,2219,112,3,1,4,75.0%,34m
24848,2,lobos,2219,111,3,4,7,42.9%,26m
24848,3,涂山苏苏,2219,30,3,8,11,27.3%,2m
24848,1,蒙斯克大帝,2219,114,3,12,15,20.0%,1h
24848,2,[香槟神教]邪能小黄人,2219,64,2,6,8,25.0%,28m
24848,1,[第七駆逐鑑隊]小菜喵,2219,97,2,7,9,22.2%,9m
24848,1,萌新一条,2219,97,1,2,3,33.3%,1h
24848,2,rose,2219,34,1,6,7,14.3%,1h
24848,2,布置球衣依旧浓,2219,0,1,6,7,14.3%,1h
24848,2,玛格特罗依德,2219,0,0,1,1,0.0%,1h
24848,2,[wdnmd茄]笑晨,2219,0,0,1,1,0.0%,1h
24848,2,最爱佩琪,2219,0,0,1,1,0.0%,27m
24848,3,落叶风,2219,0,0,2,2,0.0%,1h
24848,1,风间琉璃,2219,0,0,2,2,0.0%,16m
24863,1,泰因蒂,2218,1607,132,136,268,49.3%,1h
24863,2,Sue,2218,214,8,9,17,47.1%,41m
24863,2,黄掰掰,2218,64,6,8,14,42.9%,1h
24863,2,Rachel,2218,76,2,7,9,22.2%,1h
24863,2,[糸色]LOVExiong,2218,0,1,0,1,100.0%,1h
24863,2,深攻鲍,2218,0,1,1,2,50.0%,1h
24863,2,guaiguai,2218,0,1,1,2,50.0%,12m
24863,2,哈哈,2218,91,1,5,6,16.7%,55m
24863,2,[FYXZ]TANK,2218,0,0,1,1,0.0%,1h
24863,2,[出生开始单推]xwj,2218,0,0,2,2,0.0%,1h
24873,1,狙击手仍在,2217,1343,136,135,271,50.2%,1h
24873,1,这是信仰啊,2217,1127,112,118,230,48.7%,1h
24873,2,卖核弹的小女孩,2217,1041,66,66,132,50.0%,34m
24873,2,[暴雪养鸡场]七分熟宽粉,2217,1339,54,48,102,52.9%,1h
24873,2,王兰花秀丽,2217,1217,43,52,95,45.3%,19m
24873,1,零五二四,2217,613,26,27,53,49.1%,41m
24873,1,每天走走,2217,439,13,17,30,43.3%,25m
24873,2,梧桐影,2217,284,9,8,17,52.9%,1h
24873,2,包疲拿来,2217,282,9,8,17,52.9%,34m
24873,2,阿银灬,2217,239,6,7,13,46.2%,60m
24873,1,悲伤的红烧猪蹄,2217,144,6,9,15,40.0%,27m
24873,2,[CPT]啦啦啦拉拉阿拉,2217,160,5,2,7,71.4%,1h
24873,2,最臭的臭臭琪,2217,126,4,3,7,57.1%,12m
24873,2,我是新手请多关照,2217,0,1,0,1,100.0%,13m
24873,2,CelestialBe,2217,88,1,1,2,50.0%,1h
24873,2,jsxh,2217,36,1,2,3,33.3%,1h
24873,1,忘开啦,2217,0,1,6,7,14.3%,1h
24890,1,CcKiLe,2216,1622,74,84,158,46.8%,14m
24890,2,仙女倩,2216,1019,57,71,128,44.5%,21m
24890,3,acrosol,2216,139,34,36,70,48.6%,22m
24890,3,侍奉死亡,2216,171,5,12,17,29.4%,1h
24890,2,YSW,2216,114,4,4,8,50.0%,1h
24890,1,耶梦加得,2216,48,2,10,12,16.7%,1h
24890,2,[尤摩扬科研军]叼着棒棒糖闯天下,2216,32,1,1,2,50.0%,1h
24897,2,西瓜,2215,1318,55,43,98,56.1%,1h
24897,2,铁血老牛,2215,1066,49,44,93,52.7%,16m
24897,2,时下郡,2215,1046,39,41,80,48.8%,1h
24897,2,人类最强毒奶,2215,533,26,20,46,56.5%,1h
24897,1,爱狂三,2215,582,19,23,42,45.2%,25m
24897,2,菩提树,2215,451,15,16,31,48.4%,49m
24897,1,剑所天成,2215,460,15,20,35,42.9%,45m
24897,1,ADSE,2215,405,14,18,32,43.8%,1h
24897,1,成成盛胖胖,2215,264,7,13,20,35.0%,1h
24897,2,虫哥,2215,196,6,6,12,50.0%,1h
24897,3,zhx,2215,70,6,7,13,46.2%,42m
24897,3,老菜,2215,174,5,6,11,45.5%,26m
24897,2,我萌新我很坑,2215,154,5,7,12,41.7%,1h
24897,2,肃杀之秋,2215,116,4,5,9,44.4%,28m
24897,2,地狱燃烧,2215,92,4,6,10,40.0%,60m
24897,3,Clown,2215,62,4,13,17,23.5%,1h
24897,2,[嘤遍全球]我的枪兵不会甩,2215,58,3,1,4,75.0%,11m
24897,3,jjh,2215,121,3,3,6,50.0%,56m
24897,2,Ashsnow,2215,30,2,0,2,100.0%,34m
24897,1,新手,2215,94,2,1,3,66.7%,1h
24897,2,我是新手,2215,58,2,3,5,40.0%,30m
24897,2,[玄学开道]Evens,2215,76,2,5,7,28.6%,1h
24897,2,[柏林功德殿]迎风脱裤吹雀雀丶,2215,30,2,5,7,28.6%,1h
24897,2,[出兵大战萌新]Edison,2215,0,1,0,1,100.0%,34m
24897,2,我不在乎掉分,2215,0,1,0,1,100.0%,1h
24897,2,bsjda,2215,0,1,5,6,16.7%,49m
24897,1,[白银联盟]王的力量,2215,0,0,1,1,0.0%,8m
24897,2,自由之翼,2215,0,0,1,1,0.0%,50m
24925,1,hhxjzb,2214,1571,78,98,176,44.3%,1h
24925,2,ddss,2214,1404,50,59,109,45.9%,1h
24925,2,正义少年狩眸之逊,2214,906,36,38,74,48.6%,1h
24925,2,奔跑的蜗牛,2214,688,24,26,50,48.0%,5m
24925,1,ggggg,2214,716,22,30,52,42.3%,1h
24925,2,弹痕,2214,478,17,15,32,53.1%,21m
24925,1,梦旅者,2214,504,17,23,40,42.5%,27m
24925,2,朱警官,2214,256,9,6,15,60.0%,28m
24925,2,无敌脑袋,2214,140,5,8,13,38.5%,1h
24925,2,[asq后援团]Pudding,2214,90,4,2,6,66.7%,1h
24925,2,BOSS,2214,88,4,2,6,66.7%,1h
24925,3,llllllllllll,2214,0,3,2,5,60.0%,37m
24925,2,静若水,2214,80,3,5,8,37.5%,13m
24925,1,幽幽,2214,0,3,5,8,37.5%,15m
24925,2,都几点,2214,88,3,7,10,30.0%,55m
24925,2,yuyutfy,2214,0,1,0,1,100.0%,1h
24925,3,苏卡不列,2214,48,1,5,6,16.7%,53m
24925,2,Alice,2214,0,0,1,1,0.0%,1h
24925,1,泡泡鹏,2214,0,0,1,1,0.0%,15m
24925,2,[暴雪二十九队]眉目似星辰,2214,0,0,2,2,0.0%,5m
24925,1,战神色打,2214,0,0,4,4,0.0%,1h
24946,2,机智苍老师,2213,1052,40,40,80,50.0%,5m
24946,2,[盲人协会]跗阳筑宾,2213,768,28,31,59,47.5%,1h
24946,2,[装大佬的鸡]蟹黄,2213,438,20,11,31,64.5%,19m
24946,2,飞翔的蜻蜓,2213,463,17,14,31,54.8%,49m
24946,2,fsy,2213,294,11,14,25,44.0%,28m
24946,2,CterranM,2213,239,10,3,13,76.9%,1h
24946,1,哇哇咔,2213,244,7,16,23,30.4%,1h
24946,2,北极星,2213,128,6,6,12,50.0%,1h
24946,2,木瓜,2213,199,6,7,13,46.2%,1h
24946,2,白夜,2213,110,5,2,7,71.4%,1h
24946,2,drttyj,2213,114,5,3,8,62.5%,1h
24946,2,擎天一柱万妾尝丶,2213,95,3,4,7,42.9%,60m
24946,1,NoBle,2213,96,3,6,9,33.3%,11m
24946,1,我伟大,2213,48,2,4,6,33.3%,58m
24946,2,[不朽灵魂]晒蛋王子,2213,0,1,0,1,100.0%,19m
24946,2,抱着笨鱼数月亮,2213,30,1,4,5,20.0%,1h
24946,2,startO,2213,0,0,1,1,0.0%,50m
24946,2,刺蛇真的很溜,2213,0,0,1,1,0.0%,1h
24946,2,狂妄的英雄,2213,0,0,1,1,0.0%,1h
24946,1,[菜鸡联盟]马上就来,2213,0,0,3,3,0.0%,1h
24966,2,[PinkS]PinkSCV,2212,625,35,34,69,50.7%,60m
24966,1,TKcoco,2212,613,21,23,44,47.7%,7m
24966,1,大发鳝心,2212,142,21,24,45,46.7%,52m
24966,2,艾尔之子七夜,2212,267,10,8,18,55.6%,1h
24966,1,[红色锤镰]zwerto,2212,299,9,20,29,31.0%,1h
24966,3,lllllllllll,2212,30,3,8,11,27.3%,1h
24966,2,[Rhusky]有用就行,2212,30,2,0,2,100.0%,1h
24966,2,MDDsmile,2212,30,2,1,3,66.7%,1h
24966,1,名字叫没名字,2212,0,2,6,8,25.0%,1h
24966,2,[是我赢了]惩戒王者,2212,0,1,2,3,33.3%,1h
24966,2,nhr,2212,30,1,3,4,25.0%,1h
24977,3,[F2ANB]允执厥中,2211,1497,395,436,831,47.5%,18m
24977,2,HelloStar,2211,477,45,44,89,50.6%,1h
24977,1,KOO,2211,467,13,19,32,40.6%,56m
24977,1,窝号帅,2211,357,13,22,35,37.1%,25m
24977,2,给你两个大嘴巴子,2211,321,11,15,26,42.3%,34m
24977,1,hjmr,2211,143,4,8,12,33.3%,50m
24977,1,lojgdfs,2211,96,4,9,13,30.8%,50m
24977,2,略略略丶丶,2211,46,2,6,8,25.0%,1h
24977,2,arnold,2211,0,1,0,1,100.0%,1h
24977,2,[黄金海舰队]江南狗王孙哈娜,2211,0,1,1,2,50.0%,1h
24977,2,脑斧凶猛,2211,0,1,1,2,50.0%,1h
24977,1,GOLD,2211,0,1,4,5,20.0%,1h
24977,2,假条,2211,0,0,2,2,0.0%,44m
24977,3,夜尽天明,2211,0,0,2,2,0.0%,18m
24991,1,NoobBest,2210,1281,104,110,214,48.6%,3m
24991,1,狗撵摩托,2210,872,69,76,145,47.6%,22m
24991,1,胜者为王,2210,1060,47,54,101,46.5%,25m
24991,1,ShowTime,2210,936,37,32,69,53.6%,1h
24991,1,DarkPirates,2210,733,27,26,53,50.9%,25m
24991,2,[HQU战队]IIIIIIIIIIII,2210,706,26,24,50,52.0%,1h
24991,2,笛卡尔,2210,638,24,26,50,48.0%,60m
24991,2,[DNYt1]东南亚第一锤,2210,422,17,19,36,47.2%,18m
24991,2,谁家的那小谁,2210,345,13,12,25,52.0%,1h
24991,3,Cmwh,2210,144,4,4,8,50.0%,16m
24991,2,丿殇灬魅影,2210,120,4,5,9,44.4%,1h
24991,1,跳跳虫,2210,86,3,2,5,60.0%,8m
24991,2,BFW,2210,30,2,0,2,100.0%,28m
24991,3,[幻羽阁]幻羽,2210,0,1,0,1,100.0%,6m
24991,2,撒旦的尴尬,2210,0,1,0,1,100.0%,39m
24991,2,[琴筝]阳阳嘿,2210,0,1,1,2,50.0%,52m
24991,1,铁锹战神王老七,2210,0,1,2,3,33.3%,17m
24991,1,插眼踢裆石灰粉,2210,0,1,5,6,16.7%,15m
24991,3,别闹忙着呢,2210,38,1,5,6,16.7%,18m
24991,2,一杯大可,2210,0,0,1,1,0.0%,6m
24991,2,威尼斯特安,2210,0,0,1,1,0.0%,55m
24991,2,aiqw,2210,0,0,1,1,0.0%,13m
24991,2,[大越]大禹王族法斗,2210,0,0,2,2,0.0%,39m
25014,2,漓江塔塔主,2209,1389,94,96,190,49.5%,1h
25014,3,etc,2209,905,33,41,74,44.6%,1h
25014,2,幕后,2209,272,9,13,22,40.9%,13m
25014,1,子凉,2209,355,9,13,22,40.9%,11m
25014,3,李宇炫,2209,265,9,15,24,37.5%,8m
25014,2,奥特是蛋,2209,224,7,9,16,43.8%,5m
25014,2,kkkkkkkkkkkk,2209,66,3,4,7,42.9%,1h
25014,2,IIIIIIIIIII,2209,58,3,5,8,37.5%,28m
25014,3,[星灵充电宝]大林,2209,0,1,1,2,50.0%,1h
25014,2,LansloT,2209,30,1,2,3,33.3%,1h
25014,1,勿忘秦岭,2209,0,0,2,2,0.0%,1h
25014,2,[元苜会]德意志王古德里安,2209,0,0,3,3,0.0%,1h
25026,1,青宇,2208,1562,84,92,176,47.7%,1h
25026,2,小和尚,2208,1102,49,40,89,55.1%,41m
25026,2,哼哼呃啊啊啊啊啊,2208,776,29,30,59,49.2%,13m
25026,2,[F2ANB]雪月,2208,360,15,14,29,51.7%,1h
25026,2,大萝北,2208,222,8,9,17,47.1%,4m
25026,2,我是兔子,2208,234,8,11,19,42.1%,1h
25026,1,酥麻凤蝶,2208,296,8,15,23,34.8%,52m
25026,2,Alxer,2208,264,7,11,18,38.9%,1h
25026,2,孤星,2208,174,6,2,8,75.0%,1h
25026,2,[战旗第十分队]wuyuwoqunima,2208,169,4,4,8,50.0%,49m
25026,2,逸方,2208,121,3,1,4,75.0%,18m
25026,1,本人素质极差,2208,0,3,7,10,30.0%,1h
25026,2,晴明,2208,60,2,6,8,25.0%,34m
25026,2,玛卡巴卡,2208,44,2,7,9,22.2%,1h
25026,3,秀起来呐,2208,0,1,1,2,50.0%,1h
25026,1,[桃园结义]风吟情,2208,0,0,1,1,0.0%,16m
25026,2,马五一,2208,0,0,1,1,0.0%,53m
25026,2,电竞未来,2208,0,0,1,1,0.0%,1h
25044,1,随风飘飘,2207,1581,66,67,133,49.6%,35m
25044,2,[13BES]zhl,2207,475,59,55,114,51.8%,28m
25044,1,黑翼舞者,2207,1269,50,50,100,50.0%,3m
25044,2,大鸟老,2207,846,35,29,64,54.7%,1h
25044,2,帝国的未来,2207,724,26,26,52,50.0%,60m
25044,1,多少刁民要害朕,2207,396,14,21,35,40.0%,45m
25044,1,蒙召者,2207,322,10,20,30,33.3%,45m
25044,2,易水,2207,188,7,9,16,43.8%,28m
25044,1,半夜,2207,142,5,6,11,45.5%,38m
25044,3,浮生若梦,2207,125,5,15,20,25.0%,1h
25044,3,此生不悔,2207,143,4,1,5,80.0%,31m
25044,2,战小菜鸟,2207,141,3,7,10,30.0%,27m
25044,2,踏雪无痕,2207,0,2,4,6,33.3%,34m
25044,3,奇怪的家伙,2207,0,1,2,3,33.3%,1h
25044,3,heiheihei,2207,0,0,1,1,0.0%,18m
25044,1,小眼睛,2207,0,0,2,2,0.0%,12m
25060,2,星舰指挥官,2206,1531,153,157,310,49.4%,1h
25060,1,披风大虾,2206,1049,60,68,128,46.9%,35m
25060,1,[熊与猫]doublestrong,2206,172,16,26,42,38.1%,10m
25060,2,Tricker,2206,196,7,4,11,63.6%,1h
25060,2,[SASSA]ksky,2206,149,7,6,13,53.8%,16m
25060,2,[遇雨语余]疏鱼影,2206,158,5,6,11,45.5%,1h
25060,1,SKY,2206,225,5,12,17,29.4%,1h
25060,2,carry,2206,92,4,5,9,44.4%,1h
25060,2,鱼玄机,2206,92,4,5,9,44.4%,26m
25060,1,呵呵,2206,94,3,3,6,50.0%,1h
25060,1,[克哈防卫军]落叶依兰,2206,143,3,9,12,25.0%,1h
25060,2,[华夏何平]sudashui,2206,30,1,5,6,16.7%,1h
25060,2,萌新夫特曼,2206,0,0,1,1,0.0%,1h
25060,2,水火枫,2206,0,0,1,1,0.0%,1h
25074,3,大宇宙巫神呼啦,2205,1589,161,171,332,48.5%,19m
25074,2,耀星,2205,1344,93,89,182,51.1%,1h
25074,1,狡诈妖怪,2205,1558,77,85,162,47.5%,39m
25074,1,少女德纲,2205,810,48,56,104,46.2%,10m
25074,3,TitorJ,2205,1012,44,60,104,42.3%,2m
25074,2,兽医,2205,470,23,20,43,53.5%,1h
25074,2,zhuxiaopeng,2205,195,21,29,50,42.0%,41m
25074,3,神坑小学生,2205,280,10,12,22,45.5%,1h
25074,2,qwad,2205,175,8,3,11,72.7%,1h
25074,2,风语者,2205,274,8,8,16,50.0%,50m
25074,2,[千古大唐]小滴,2205,214,7,11,18,38.9%,1h
25074,2,谁在呼叫舰队,2205,189,6,3,9,66.7%,1h
25074,2,[达拉姆内务部]hanyu,2205,144,6,6,12,50.0%,1h
25074,1,碧水疾风,2205,132,5,10,15,33.3%,1h
25074,2,吃橙子,2205,143,4,3,7,57.1%,1h
25074,1,用脚打就够了,2205,186,4,6,10,40.0%,1h
25074,2,辉天,2205,88,2,0,2,100.0%,18m
25074,2,[想过平静生活]我还是喜欢她,2205,30,2,1,3,66.7%,1h
25074,2,小展展,2205,114,2,2,4,50.0%,1h
25074,2,星夜,2205,62,2,6,8,25.0%,34m
25074,1,[Mentor]队友呢快救我,2205,0,1,0,1,100.0%,12m
25074,2,[最菜战队]不知春去,2205,0,1,0,1,100.0%,17m
25074,2,engeleli,2205,0,1,2,3,33.3%,1h
25074,2,飞扬呵呵呵,2205,42,1,4,5,20.0%,21m
25074,2,forest,2205,0,0,1,1,0.0%,1h
25074,2,司夜,2205,0,0,5,5,0.0%,16m
25074,2,SOMA,2205,0,0,7,7,0.0%,12m
25101,2,樱粟,2204,926,60,76,136,44.1%,33m
25101,2,[哔翻天梯鸡]Uniquenann,2204,1474,57,71,128,44.5%,1h
25101,1,viper,2204,470,21,27,48,43.8%,47m
25101,2,IIIIIIIIIIII,2204,281,15,34,49,30.6%,17m
25101,2,天翼之影,2204,370,12,13,25,48.0%,1h
25101,2,国服人族,2204,214,9,4,13,69.2%,34m
25101,1,yinjian,2204,212,6,13,19,31.6%,22m
25101,2,BAEBAE,2204,200,4,5,9,44.4%,5m
25101,2,天牙,2204,106,3,0,3,100.0%,1h
25101,3,[社交学导教]染陌离,2204,0,1,4,5,20.0%,59m
25101,2,寒芒,2204,0,1,6,7,14.3%,1h
25101,1,[刺蛇保护协会]Pendragon,2204,0,0,2,2,0.0%,1h
25101,2,小峰峰,2204,0,0,2,2,0.0%,1h
25114,1,横刀向天笑,2203,1300,54,51,105,51.4%,1h
25114,1,WDDW,2203,678,36,43,79,45.6%,1h
25114,2,史蒂夫,2203,473,31,27,58,53.4%,1h
25114,2,ZGNB,2203,322,26,27,53,49.1%,34m
25114,2,[大乔无惨]gunima,2203,476,17,22,39,43.6%,1h
25114,1,星际迷雾,2203,291,7,13,20,35.0%,1h
25114,2,Stellaris,2203,81,5,7,12,41.7%,1h
25114,1,天棋,2203,0,3,5,8,37.5%,42m
25114,1,菜鸟,2203,96,2,0,2,100.0%,1h
25114,2,乌贼,2203,0,1,0,1,100.0%,31m
25114,2,渣鱼,2203,0,0,1,1,0.0%,1h
25114,2,caoqi,2203,0,0,2,2,0.0%,27m
25114,2,为执念染白尘,2203,0,0,2,2,0.0%,1h
25114,2,我是野人王儿子,2203,0,0,2,2,0.0%,1h
25128,2,白丁小学生,2202,712,30,26,56,53.6%,1h
25128,1,战狼出击,2202,349,11,17,28,39.3%,47m
25128,2,[淬淬鲨]淬火的老八,2202,154,6,5,11,54.5%,1h
25128,2,萌新,2202,105,5,1,6,83.3%,34m
25128,2,攻势级战裂舰,2202,163,5,5,10,50.0%,1h
25128,3,TheLeader,2202,0,2,9,11,18.2%,42m
25128,2,iiiiiiiiii,2202,0,1,0,1,100.0%,50m
25128,2,[秋毫]听风,2202,93,1,2,3,33.3%,27m
25128,3,大哥再此,2202,0,1,3,4,25.0%,1h
25128,2,究极莽子皮怪,2202,0,0,1,1,0.0%,1h
25128,2,噬神者,2202,0,0,2,2,0.0%,1h
25128,2,解放,2202,0,0,3,3,0.0%,1h
25140,1,IIIIIIII,2201,1633,87,93,180,48.3%,25m
25140,1,截拳道,2201,628,78,79,157,49.7%,1h
25140,3,随鸡硬变,2201,505,68,74,142,47.9%,1h
25140,2,Terran,2201,961,54,56,110,49.1%,1h
25140,2,小王没技术,2201,551,18,25,43,41.9%,19m
25140,1,[旺旺战士]帅气哒刘小汪,2201,598,18,27,45,40.0%,27m
25140,2,Deep,2201,280,10,8,18,55.6%,1h
25140,2,一念山河成,2201,252,9,12,21,42.9%,1h
25140,3,随心所欲,2201,211,8,13,21,38.1%,1h
25140,2,泥劳紫,2201,121,5,8,13,38.5%,34m
25140,2,[太微玉清宫]QWQ,2201,136,2,2,4,50.0%,1h
25140,2,liting,2201,0,2,4,6,33.3%,1h
25140,2,saber,2201,30,2,5,7,28.6%,19m
25140,1,斯托克夫中将,2201,96,2,6,8,25.0%,38m
25140,2,KAi,2201,0,1,0,1,100.0%,41m
25140,2,苍穹之光,2201,88,1,1,2,50.0%,16m
25140,2,[干就完事]没落丶瞄,2201,0,1,2,3,33.3%,1h
25140,2,星尘,2201,0,0,1,1,0.0%,6m
25140,2,diannapaap,2201,0,0,1,1,0.0%,17m
25140,3,降价,2201,0,0,1,1,0.0%,14m
25140,2,[sss女帝]无能狂怒孙一峰,2201,0,0,3,3,0.0%,19m
25161,1,[Brzide]逆风尘,2200,1644,166,180,346,48.0%,47m
25161,2,刚爷,2200,934,131,141,272,48.2%,1h
25161,1,人菜瘾大还瞎,2200,1459,52,61,113,46.0%,1h
25161,2,李先森,2200,606,31,40,71,43.7%,1h
25161,2,姗姗来迟,2200,584,24,27,51,47.1%,28m
25161,2,苍玄,2200,548,19,23,42,45.2%,28m
25161,2,[萌大喵的日常]笑丿神箜,2200,452,14,20,34,41.2%,1h
25161,2,让我杀一个人,2200,356,12,19,31,38.7%,1h
25161,1,孤寂的卫星,2200,137,6,5,11,54.5%,27m
25161,2,战火风飞,2200,88,2,4,6,33.3%,1h
25161,2,默笙,2200,0,2,4,6,33.3%,34m
25161,2,longturn,2200,0,2,4,6,33.3%,1h
25161,2,andlue,2200,139,2,7,9,22.2%,34m
25161,1,CheetoR,2200,97,2,8,10,20.0%,11m
25161,2,疣梦里,2200,0,1,0,1,100.0%,1h
25161,2,胖头鱼,2200,44,1,3,4,25.0%,56m
25161,2,加缪,2200,0,1,5,6,16.7%,27m
25161,2,[我笑]夜雨声烦,2200,0,0,2,2,0.0%,1h
25161,1,夏弥,2200,0,0,3,3,0.0%,16m
25180,3,冰火之舞,2199,1280,147,151,298,49.3%,24m
25180,2,电脑一简单难度,2199,233,44,35,79,55.7%,16m
25180,2,Joker,2199,607,25,21,46,54.3%,5m
25180,1,wwt,2199,551,23,25,48,47.9%,1h
25180,2,星际路行者,2199,570,22,25,47,46.8%,11m
25180,2,炽心,2199,304,11,11,22,50.0%,30m
25180,3,月迷津渡,2199,287,10,14,24,41.7%,53m
25180,2,城市化特牛,2199,202,7,4,11,63.6%,41m
25180,2,廷哥哥,2199,230,7,6,13,53.8%,1h
25180,2,[我菜请打队友]Emperor,2199,126,3,3,6,50.0%,1h
25180,1,新手,2199,48,3,7,10,30.0%,1h
25180,2,子子谦,2199,30,2,4,6,33.3%,1h
25180,2,[蓝色雨]半只恐龙,2199,0,2,4,6,33.3%,34m
25180,2,lsdalSDASD,2199,60,2,4,6,33.3%,1h
25180,2,jazzw,2199,62,2,8,10,20.0%,1h
25180,1,独孤求败,2199,0,1,0,1,100.0%,1h
25180,2,时光骆驼,2199,88,1,1,2,50.0%,1h
25180,2,普罗米修斯,2199,0,1,3,4,25.0%,44m
25180,2,走神的阿业,2199,0,0,1,1,0.0%,1h
25180,2,优秀宝宝,2199,0,0,1,1,0.0%,1h
25180,1,欢迎加入,2199,0,0,2,2,0.0%,1h
25201,2,咩咩,2198,1020,42,38,80,52.5%,41m
25201,2,[新手保护协会]发现世界,2198,566,31,25,56,55.4%,1h
25201,2,十六夜咲夜,2198,472,21,24,45,46.7%,1h
25201,2,QAQ,2198,471,19,23,42,45.2%,1h
25201,2,时光机阿斗,2198,389,14,11,25,56.0%,1h
25201,2,[虐杀琉森]Copper,2198,240,9,8,17,52.9%,50m
25201,2,EmperorTFR,2198,212,7,4,11,63.6%,1h
25201,2,con,2198,128,6,6,12,50.0%,1h
25201,2,大白胖胖,2198,130,5,2,7,71.4%,1h
25201,3,[神子]机械之狼,2198,184,5,6,11,45.5%,1h
25201,2,隔壁老王在线求虐,2198,142,4,3,7,57.1%,1h
25201,1,restp,2198,144,4,10,14,28.6%,1h
25201,2,兔子的豆子,2198,114,3,1,4,75.0%,27m
25201,2,[Chain]麒麟萌,2198,30,2,2,4,50.0%,1h
25201,2,[北有吾王]灭神,2198,60,2,5,7,28.6%,1h
25201,2,HuangMinJian,2198,0,1,1,2,50.0%,1h
25201,1,幻行暮雨,2198,0,1,1,2,50.0%,23m
25201,2,是双霜呀,2198,0,1,1,2,50.0%,13m
25201,2,南夕,2198,0,0,1,1,0.0%,1h
25201,1,罗德岛刀客塔,2198,0,0,2,2,0.0%,1h
25221,2,太阳宫野人,2197,971,115,127,242,47.5%,28m
25221,2,永远效忠,2197,893,35,29,64,54.7%,50m
25221,2,ANan,2197,844,33,39,72,45.8%,23m
25221,1,罗卍空,2197,596,28,34,62,45.2%,39m
25221,2,[1sA]Diallo,2197,474,19,23,42,45.2%,1h
25221,2,术士司马懿,2197,356,13,10,23,56.5%,13m
25221,2,你的对手,2197,268,10,7,17,58.8%,1h
25221,1,一星独烁,2197,347,8,21,29,27.6%,24m
25221,1,茶子子,2197,230,5,11,16,31.2%,1h
25221,2,孙龘,2197,76,5,13,18,27.8%,1h
25221,2,我画往事,2197,128,4,2,6,66.7%,1h
25221,3,蛋蛋爱仔仔,2197,34,3,11,14,21.4%,10m
25221,3,kui,2197,122,2,9,11,18.2%,9m
25221,2,[江南暮雪]执政官吉姆雷诺,2197,0,1,0,1,100.0%,49m
25221,3,光明主宰,2197,0,1,0,1,100.0%,1h
25221,2,kljbnlkj,2197,0,1,5,6,16.7%,1h
25221,3,winner,2197,38,1,5,6,16.7%,1h
25221,2,GGGGGGGGGG,2197,0,1,6,7,14.3%,55m
25221,2,[不落]未闻花名,2197,0,0,1,1,0.0%,27m
25221,2,丷明月丷,2197,0,0,1,1,0.0%,56m
25221,3,zhangjieni,2197,0,0,5,5,0.0%,1h
25242,1,SearchAI,2196,890,56,57,113,49.6%,4m
25242,2,apocalypse,2196,611,31,36,67,46.3%,1h
25242,2,爱越,2196,485,17,25,42,40.5%,1h
25242,1,dkJAZK,2196,454,15,22,37,40.5%,39m
25242,2,史子僚,2196,350,11,12,23,47.8%,1h
25242,2,Kleman,2196,292,8,8,16,50.0%,1h
25242,3,自由射手,2196,125,5,7,12,41.7%,1h
25242,2,IIIIIIII,2196,0,1,0,1,100.0%,1h
25242,2,雷昊,2196,88,1,1,2,50.0%,34m
25242,1,sora,2196,0,1,1,2,50.0%,15m
25242,3,阿尔萨斯,2196,0,1,4,5,20.0%,52m
25242,2,冰糖,2196,97,1,7,8,12.5%,1h
25242,2,朱者赤,2196,0,0,1,1,0.0%,1h
25242,2,[暴雪二十二队]挤一挤,2196,0,0,1,1,0.0%,6m
25242,1,星空,2196,0,0,3,3,0.0%,23m
25257,1,熊猫道人,2195,1620,148,153,301,49.2%,25m
25257,2,暗黑大帝,2195,1370,100,116,216,46.3%,1h
25257,2,热化了的猫,2195,1032,39,49,88,44.3%,53m
25257,2,KAZ,2195,524,31,27,58,53.4%,1h
25257,2,独刀走天涯,2195,552,21,21,42,50.0%,19m
25257,2,高福帅,2195,414,15,20,35,42.9%,4m
25257,2,田小秋,2195,384,14,11,25,56.0%,21m
25257,2,奥特小魔仙,2195,347,10,12,22,45.5%,1h
25257,2,海拉鲁老流氓,2195,262,8,7,15,53.3%,28m
25257,2,[荣耀指引我]萌王赛高,2195,155,5,2,7,71.4%,49m
25257,1,wwqi,2195,145,5,9,14,35.7%,16m
25257,1,[纵丨横]BYL,2195,191,4,10,14,28.6%,39m
25257,2,[星际联盟战队]闷骚的花生,2195,131,3,6,9,33.3%,1h
25257,2,[GL0HF]拥之则安,2195,62,3,6,9,33.3%,34m
25257,1,[呦反手掏]萨克友,2195,90,3,7,10,30.0%,1h
25257,1,TGak,2195,0,2,8,10,20.0%,1h
25257,2,[追逐梦想]整合运动塔露拉,2195,88,1,1,2,50.0%,1h
25257,2,fingerdancer,2195,0,0,1,1,0.0%,1h
25257,2,[飞跃来]忆年少所爱之人,2195,0,0,2,2,0.0%,1h
25257,1,HideOnBush,2195,0,0,3,3,0.0%,58m
25257,2,[恶劣玩家]就偶尔有,2195,0,0,4,4,0.0%,1h
25257,3,了不起的盖茨比,2195,0,0,5,5,0.0%,53m
25279,3,eoz,2194,1157,156,170,326,47.9%,12m
25279,2,无名书生,2194,1596,94,98,192,49.0%,50m
25279,2,kiva,2194,1321,58,55,113,51.3%,1h
25279,2,阿无驴,2194,518,21,15,36,58.3%,1h
25279,2,TNEX,2194,402,21,20,41,51.2%,60m
25279,1,DXK,2194,484,16,19,35,45.7%,24m
25279,2,[CPT]我没喝水这局能赢,2194,200,6,5,11,54.5%,11m
25279,2,mycry,2194,207,6,7,13,46.2%,1h
25279,2,haniiii,2194,176,6,7,13,46.2%,1h
25279,2,[XXHZ30]pang,2194,172,6,8,14,42.9%,1h
25279,1,funshion,2194,226,6,17,23,26.1%,1h
25279,2,时光,2194,174,5,3,8,62.5%,1h
25279,1,是耿良辰呐,2194,234,5,11,16,31.2%,21m
25279,3,无限单通,2194,102,5,13,18,27.8%,1h
25279,2,爱情小鸟,2194,128,3,3,6,50.0%,34m
25279,2,[接受洗礼吧]灭却,2194,62,3,6,9,33.3%,1h
25279,1,星际小菜鸟,2194,97,2,8,10,20.0%,1h
25279,1,逍遥北洛,2194,0,1,0,1,100.0%,8m
25279,1,谁都像她但不是她,2194,0,1,0,1,100.0%,25m
25279,1,暗影之龙,2194,0,1,0,1,100.0%,1h
25279,2,dadfafda,2194,30,1,2,3,33.3%,1h
25279,2,FPSCANQU,2194,30,1,3,4,25.0%,1h
25279,2,[萌萌鸡小队]小小热狗,2194,0,0,1,1,0.0%,1h
25279,2,[疯狂的虫族]憨批,2194,0,0,1,1,0.0%,1h
25279,3,leo,2194,0,0,5,5,0.0%,23m
25304,2,[DSE]mao,2193,1394,48,56,104,46.2%,34m
25304,2,潍莅,2193,549,25,35,60,41.7%,1h
25304,2,Kenxzn,2193,456,16,14,30,53.3%,1h
25304,2,橘子,2193,351,13,17,30,43.3%,1h
25304,2,大金,2193,222,8,8,16,50.0%,1h
25304,2,醉人心弦,2193,173,6,5,11,54.5%,56m
25304,2,小鲸鱼子酱,2193,30,2,5,7,28.6%,34m
25304,1,一花一世界,2193,94,1,3,4,25.0%,60m
25304,3,菊花侠,2193,0,1,4,5,20.0%,1h
25304,2,抽风的小弟,2193,0,0,1,1,0.0%,1h
25304,2,master,2193,0,0,1,1,0.0%,50m
25304,1,通天,2193,0,0,3,3,0.0%,58m
25316,2,huaji,2192,1250,60,61,121,49.6%,1h
25316,2,[野蛮猫骑士]依然,2192,498,35,31,66,53.0%,28m
25316,1,Rdyle,2192,927,34,37,71,47.9%,12m
25316,2,frank,2192,492,20,18,38,52.6%,53m
25316,1,黯淡的星光,2192,568,19,24,43,44.2%,1h
25316,1,牙膏,2192,520,16,27,43,37.2%,4m
25316,2,熬然祭品,2192,195,11,14,25,44.0%,1h
25316,2,Maxwell,2192,113,10,12,22,45.5%,1h
25316,1,豪风破魔虫,2192,136,4,12,16,25.0%,20m
25316,2,龙的传人,2192,88,2,0,2,100.0%,27m
25316,3,[神武骑士团]kimi,2192,0,2,3,5,40.0%,1h
25316,2,maru,2192,64,2,5,7,28.6%,1h
25316,2,老咸鱼,2192,0,1,0,1,100.0%,19m
25316,3,铁片,2192,0,1,0,1,100.0%,1h
25316,2,naxxramas,2192,30,1,3,4,25.0%,19m
25316,2,[ROST]千年老妖,2192,99,1,3,4,25.0%,41m
25316,1,[为了核平]巅峰时刻让啊,2192,0,0,3,3,0.0%,14m
25333,1,十七,2191,551,20,29,49,40.8%,1h
25333,1,[rushhh]什么鬼,2191,262,7,4,11,63.6%,1h
25333,2,[NiVi]Simple,2191,0,4,1,5,80.0%,34m
25333,1,Hugo,2191,92,4,9,13,30.8%,50m
25333,2,小宇宙之丸,2191,119,3,1,4,75.0%,50m
25333,1,LIEBKNECHT,2191,96,3,2,5,60.0%,11m
25333,2,carefly,2191,94,3,5,8,37.5%,1h
25333,2,ChinaYz,2191,46,3,6,9,33.3%,1h
25333,2,风城歌舞诗,2191,88,1,1,2,50.0%,1h
25333,1,焦思宇,2191,48,1,5,6,16.7%,1h
25333,2,EvolTo,2191,0,0,1,1,0.0%,1h
25333,2,[怪盗军团]至尊盗亡拉法姆,2191,0,0,1,1,0.0%,13m
25333,2,SCPLAYER,2191,0,0,2,2,0.0%,1h
25333,2,随风行,2191,0,0,2,2,0.0%,44m
25347,1,[极限菜鸟]zamg,2190,1622,150,167,317,47.3%,1h
25347,1,火山爆发砼之魔泪,2190,1533,70,75,145,48.3%,1h
25347,2,[七咕咕]Death,2190,1421,58,64,122,47.5%,1h
25347,2,[梨花与浅月]浅月落幽,2190,311,35,29,64,54.7%,28m
25347,2,LRJYYR,2190,444,15,16,31,48.4%,1h
25347,2,[曾经一群兔子]LAER,2190,419,15,21,36,41.7%,1h
25347,2,巅云,2190,321,13,9,22,59.1%,1h
25347,2,loushan,2190,126,7,8,15,46.7%,1h
25347,2,[SHNU]凤雏,2190,216,7,11,18,38.9%,21m
25347,1,路人甲,2190,215,5,11,16,31.2%,14m
25347,2,牛牛玩星际,2190,96,3,5,8,37.5%,13m
25347,3,MRJOKE,2190,121,3,5,8,37.5%,10m
25347,2,葛将军,2190,0,1,0,1,100.0%,27m
25347,2,[UA3作死队]小豆芽,2190,0,1,5,6,16.7%,18m
25347,2,阿巴阿巴,2190,0,1,5,6,16.7%,56m
25347,1,[C17079]PluKevin,2190,0,0,1,1,0.0%,18m
25347,2,空心,2190,0,0,2,2,0.0%,1h
25364,2,[自沉西湖底]教父又遇刺了,2189,1569,84,83,167,50.3%,34m
25364,1,[暴雪养鸡场]老年人休闲星际,2189,504,46,50,96,47.9%,1h
25364,2,LOMO,2189,788,28,31,59,47.5%,1h
25364,2,[神子]lbwnb,2189,625,27,20,47,57.4%,1h
25364,2,bigdickman,2189,349,11,19,30,36.7%,1h
25364,3,雪夜光辉,2189,276,10,13,23,43.5%,10m
25364,2,AVENGERFFF,2189,251,9,7,16,56.2%,1h
25364,2,leathersofa,2189,237,8,16,24,33.3%,19m
25364,1,才开始玩的萌新,2189,190,7,9,16,43.8%,12m
25364,2,时方知,2189,196,5,14,19,26.3%,13m
25364,1,Jimmy,2189,48,2,4,6,33.3%,11m
25364,2,[JJBANG]阿达放,2189,0,1,1,2,50.0%,34m
25364,2,水色鸢尾,2189,48,1,2,3,33.3%,1h
25364,2,咸鱼王,2189,30,1,3,4,25.0%,1h
25364,2,[太微玉清宫]尘心,2189,46,1,7,8,12.5%,55m
25364,2,诺亚方舟,2189,0,0,1,1,0.0%,34m
25364,2,大刺蛇爱小刺蛇,2189,0,0,1,1,0.0%,1h
25364,3,scott,2189,0,0,5,5,0.0%,1h
25364,3,visitttm,2189,0,0,5,5,0.0%,1h
25383,1,wangcheng,2188,1486,82,81,163,50.3%,26m
25383,2,队长大剑,2188,1373,56,65,121,46.3%,1h
25383,2,梦幻唐朝,2188,601,31,28,59,52.5%,28m
25383,2,片甲不留,2188,282,10,10,20,50.0%,34m
25383,2,潇墨,2188,151,5,14,19,26.3%,41m
25383,2,珈百璃,2188,60,2,5,7,28.6%,34m
25383,1,CHINACHEN,2188,96,2,7,9,22.2%,16m
25383,3,白刃血,2188,0,1,2,3,33.3%,9m
25383,3,番茄,2188,0,0,1,1,0.0%,53m
25383,2,伱灬衡爺,2188,0,0,4,4,0.0%,28m
25393,1,[北有吾王1队]mengfengwu,2187,1453,102,99,201,50.7%,1h
25393,2,huning,2187,213,46,44,90,51.1%,1h
25393,2,Leview,2187,669,27,32,59,45.8%,1h
25393,2,太阳果果,2187,158,8,4,12,66.7%,27m
25393,2,[WYHJT]爱理,2187,126,5,6,11,45.5%,1h
25393,2,渣渣张很努力啊,2187,94,5,10,15,33.3%,13m
25393,2,偏爱小单,2187,138,4,2,6,66.7%,27m
25393,1,雏菊,2187,109,4,5,9,44.4%,53m
25393,1,研仔,2187,96,4,10,14,28.6%,1h
25393,3,天际浮云,2187,30,3,9,12,25.0%,26m
25393,3,Soulink,2187,0,2,3,5,40.0%,1h
25393,2,有着梦想的小短腿,2187,60,2,5,7,28.6%,50m
25393,2,唔知丶寒,2187,30,1,5,6,16.7%,1h
25393,2,Pensede,2187,0,1,6,7,14.3%,55m
25393,2,DaGgg,2187,0,0,3,3,0.0%,1h
25408,2,winwalker,2186,1085,44,44,88,50.0%,19m
25408,2,辽东经略,2186,956,38,37,75,50.7%,1h
25408,2,余生优优,2186,468,17,14,31,54.8%,16m
25408,2,徐挺,2186,384,15,21,36,41.7%,1h
25408,2,Demon,2186,286,9,11,20,45.0%,1h
25408,2,llllllllllll,2186,229,8,8,16,50.0%,1h
25408,2,你是不是傻,2186,135,5,4,9,55.6%,27m
25408,2,璟儿瑜儿,2186,120,5,8,13,38.5%,1h
25408,3,洛语,2186,30,2,0,2,100.0%,24m
25408,3,Zebra,2186,0,0,1,1,0.0%,1h
25418,2,狂屠,2185,453,25,16,41,61.0%,1h
25418,3,[Only]未名白,2185,369,15,5,20,75.0%,1h
25418,2,[花月]诺晨奶奶,2185,398,15,12,27,55.6%,1h
25418,1,畅畅的小跟班,2185,298,13,12,25,52.0%,7m
25418,2,亦庄,2185,256,10,6,16,62.5%,37m
25418,2,紫枫叶秋桦,2185,122,9,8,17,52.9%,13m
25418,1,残月,2185,187,5,10,15,33.3%,1h
25418,3,蜜饯掉进糖罐里,2185,149,3,5,8,37.5%,1h
25418,3,再见赛特兰蒂斯,2185,0,1,0,1,100.0%,1h
25418,3,IGlin,2185,34,1,3,4,25.0%,37m
25418,2,Kin,2185,0,1,6,7,14.3%,1h
25418,1,[远坂世家]和泉纱雾,2185,0,0,1,1,0.0%,45m
25430,1,谨幸,2184,1653,68,68,136,50.0%,1h
25430,1,darktigerafu,2184,597,20,27,47,42.6%,10m
25430,1,marsduke,2184,390,11,16,27,40.7%,54m
25430,2,卡拉赞,2184,124,6,7,13,46.2%,34m
25430,1,杨徐慧,2184,156,4,9,13,30.8%,58m
25430,3,小飞鼠,2184,88,3,2,5,60.0%,52m
25430,3,sbear,2184,0,1,0,1,100.0%,1h
25430,2,asddg,2184,0,1,5,6,16.7%,12m
25430,2,[吕布保护协会]她的温暖像海洋,2184,0,1,6,7,14.3%,1h
25430,2,[XXHZ12]暗夜云海,2184,0,1,7,8,12.5%,57m
25430,3,[十年s]铁柱,2184,0,0,1,1,0.0%,18m
25441,1,wlf,2183,1452,59,60,119,49.6%,22m
25441,2,[正义灬必胜]死亡老留氓,2183,682,42,38,80,52.5%,1h
25441,1,GVNDN,2183,1005,40,45,85,47.1%,10m
25441,3,王者无敌,2183,314,12,13,25,48.0%,1h
25441,3,库尔提拉斯海军,2183,261,9,16,25,36.0%,10m
25441,2,liu,2183,290,8,10,18,44.4%,1h
25441,1,SKT,2183,229,8,11,19,42.1%,60m
25441,1,ccc,2183,192,7,11,18,38.9%,1h
25441,3,行侠仗义安度因,2183,158,7,15,22,31.8%,2m
25441,1,不可不信缘,2183,251,7,15,22,31.8%,9m
25441,2,第七天堂,2183,94,4,8,12,33.3%,1h
25441,2,李瞬生,2183,138,3,5,8,37.5%,1h
25441,1,WEWe,2183,145,3,9,12,25.0%,45m
25441,2,poem,2183,64,2,4,6,33.3%,44m
25441,1,[ducang]week,2183,0,1,0,1,100.0%,1h
25441,3,[電脑难度]新手,2183,30,1,1,2,50.0%,1h
25441,1,暗夜骑士,2183,95,1,3,4,25.0%,1h
25441,2,杀伐之心,2183,0,1,5,6,16.7%,27m
25441,3,[背锅行者]晴天,2183,0,0,1,1,0.0%,1h
25441,3,[哔哩哔哩图奇]zero,2183,0,0,1,1,0.0%,1h
25441,1,最爱大云云,2183,0,0,1,1,0.0%,21m
25441,2,小泽有个玛利鸭,2183,0,0,2,2,0.0%,1h
25463,2,穆勒,2182,725,27,27,54,50.0%,1h
25463,2,LUTIANYU,2182,486,23,18,41,56.1%,1h
25463,2,[牡丹]牡丹,2182,539,23,21,44,52.3%,1h
25463,1,Blindperso,2182,349,11,16,27,40.7%,1h
25463,3,骑猫过海的鱼,2182,76,6,11,17,35.3%,1h
25463,1,余音之时,2182,142,5,10,15,33.3%,12m
25463,2,您的电竞孙红雷,2182,136,4,3,7,57.1%,1h
25463,2,Mrsheng,2182,90,3,8,11,27.3%,31m
25463,2,[我方黄金舰队]久久六批,2182,48,2,1,3,66.7%,1h
25463,2,月饼,2182,0,2,4,6,33.3%,1h
25463,2,你的机枪兵,2182,0,1,1,2,50.0%,1h
25463,2,南苏,2182,88,1,2,3,33.3%,16m
25463,2,橘子指挥官,2182,44,1,3,4,25.0%,12m
25463,2,[暴打假萌新]转身看你,2182,0,0,1,1,0.0%,1h
25463,3,死神麒麟,2182,0,0,3,3,0.0%,1h
25463,1,哟哦,2182,0,0,4,4,0.0%,21m
25479,1,戮默,2181,560,93,102,195,47.7%,1h
25479,2,puretest,2181,562,25,16,41,61.0%,1h
25479,2,情灬兽,2181,158,15,20,35,42.9%,1h
25479,1,林夜秋,2181,227,6,2,8,75.0%,50m
25479,2,玲珑玺笙,2181,107,6,4,10,60.0%,1h
25479,1,[手残80後]TankSir,2181,208,6,9,15,40.0%,39m
25479,2,cookieBro,2181,160,5,9,14,35.7%,1h
25479,2,[XXHZ32]黑面小潘安,2181,137,4,6,10,40.0%,53m
25479,1,whishaw,2181,48,3,8,11,27.3%,1h
25479,2,冬季快递,2181,88,2,1,3,66.7%,1h
25479,1,神恩造物,2181,139,2,3,5,40.0%,1h
25479,3,[月见]虞姬,2181,0,1,0,1,100.0%,1h
25479,2,卡尔萨斯,2181,30,1,3,4,25.0%,1h
25479,3,小小胖,2181,0,1,4,5,20.0%,52m
25479,1,嗜血鳞蝰,2181,0,0,2,2,0.0%,39m
25479,3,至圣意志,2181,0,0,5,5,0.0%,1h
25495,2,[长征小白]难兄难弟,2180,1277,48,47,95,50.5%,1h
25495,1,可乐,2180,934,35,38,73,47.9%,4m
25495,2,[XXMNML]Lovelin,2180,768,25,36,61,41.0%,50m
25495,1,[ICHYI]风云崛起,2180,223,7,12,19,36.8%,1h
25495,2,一生所爱,2180,166,5,4,9,55.6%,1h
25495,2,一笑生花宋哈娜,2180,30,2,5,7,28.6%,1h
25495,3,小田,2180,30,1,1,2,50.0%,1h
25495,2,WEnightwalk,2180,0,1,3,4,25.0%,1h
25495,3,Eight,2180,0,0,1,1,0.0%,28m
25504,2,[慢手e族]JABARI,2179,1508,89,88,177,50.3%,1h
25504,3,[不灭青铜]萧萧,2179,1201,43,112,155,27.7%,51m
25504,2,[风吹屁凉]风吹头发凉,2179,846,38,38,76,50.0%,1h
25504,2,[NHSD]DavidGin,2179,951,37,39,76,48.7%,1h
25504,2,[极限菜鸟]消灭消灭,2179,910,32,39,71,45.1%,16m
25504,2,ASUNA,2179,773,30,29,59,50.8%,50m
25504,2,白色死神,2179,469,17,14,31,54.8%,44m
25504,1,带我我贼菜丷,2179,239,9,11,20,45.0%,1h
25504,3,Skywalker,2179,240,7,12,19,36.8%,4m
25504,2,asd,2179,142,6,7,13,46.2%,1h
25504,2,奥利给,2179,94,2,1,3,66.7%,1h
25504,2,leon,2179,30,2,5,7,28.6%,34m
25504,2,闩鉴,2179,0,1,1,2,50.0%,1h
25504,2,xlm,2179,0,1,2,3,33.3%,1h
25504,2,Mikko,2179,0,1,8,9,11.1%,27m
25504,3,地瓜,2179,0,0,1,1,0.0%,52m
25504,3,简熠设计,2179,0,0,1,1,0.0%,8m
25504,1,雷日天,2179,0,0,3,3,0.0%,39m
25522,2,会飞的猪噜噜,2178,1157,47,48,95,49.5%,49m
25522,1,我的战争,2178,860,39,37,76,51.3%,1h
25522,1,啦啦啦啦啦,2178,252,7,4,11,63.6%,21m
25522,1,[CPT]泰晤斯古梅特,2178,68,5,8,13,38.5%,1h
25522,1,自毁雷,2178,221,5,12,17,29.4%,1h
25522,3,鱼干超可爱,2178,115,3,1,4,75.0%,11m
25522,3,墨时,2178,0,3,2,5,60.0%,23m
25522,1,火力全开,2178,0,1,0,1,100.0%,1h
25522,2,没有大名,2178,0,1,1,2,50.0%,1h
25522,2,落叶,2178,0,1,2,3,33.3%,1h
25522,2,华灯初上,2178,0,1,2,3,33.3%,1h
25522,2,TiMe,2178,0,0,2,2,0.0%,1h
25522,3,人生几何,2178,0,0,3,3,0.0%,14m
25535,2,肉松包子,2177,1450,90,84,174,51.7%,4m
25535,2,[听雨轩]杨哈哈,2177,172,8,9,17,47.1%,34m
25535,2,qgh,2177,128,4,2,6,66.7%,18m
25535,2,Trust,2177,96,4,7,11,36.4%,1h
25535,2,[留在我身旁]甘蔗,2177,64,3,6,9,33.3%,1h
25535,2,无敌人类,2177,88,2,1,3,66.7%,19m
25535,2,[iLy]JaKeHan,2177,42,2,6,8,25.0%,27m
25535,3,[人间残渣]小小心意,2177,0,1,0,1,100.0%,1h
25535,3,阿力,2177,30,1,1,2,50.0%,1h
25535,2,[妹子万岁]冥心,2177,88,1,2,3,33.3%,1h
25535,2,jiajiashiDL,2177,0,0,3,3,0.0%,6m
25546,2,dxc,2176,1595,165,177,342,48.2%,51m
25546,2,TomDan,2176,963,36,45,81,44.4%,41m
25546,2,HarukA,2176,368,31,28,59,52.5%,13m
25546,1,发胶手,2176,684,23,27,50,46.0%,1h
25546,2,于谦父亲,2176,216,15,9,24,62.5%,13m
25546,1,星海深诺,2176,318,11,21,32,34.4%,35m
25546,1,黄塞肉,2176,248,7,4,11,63.6%,22m
25546,1,Pellca,2176,212,6,6,12,50.0%,1h
25546,2,狡猾,2176,0,4,2,6,66.7%,16m
25546,2,[mggr]奇葩六子,2176,88,1,2,3,33.3%,1h
25546,2,蔷薇之殇,2176,95,1,4,5,20.0%,1h
25546,3,您的萌友遭到公鸡,2176,0,0,1,1,0.0%,3m
25546,2,wangling,2176,0,0,2,2,0.0%,53m
25559,1,书生,2175,626,20,29,49,40.8%,7m
25559,2,叼距老,2175,358,19,4,23,82.6%,29m
25559,3,安洁莉娜,2175,321,16,31,47,34.0%,33m
25559,2,YSL,2175,420,14,14,28,50.0%,1h
25559,2,AColdFront,2175,404,14,19,33,42.4%,19m
25559,3,[王者重现]诺亚方舟,2175,145,11,11,22,50.0%,1h
25559,1,嘤嘤叶,2175,304,9,10,19,47.4%,45m
25559,2,[旺旺战士]芹菜肉片,2175,254,9,11,20,45.0%,1h
25559,1,想想看,2175,316,8,10,18,44.4%,1h
25559,2,无名,2175,180,7,10,17,41.2%,60m
25559,2,yewa,2175,206,7,11,18,38.9%,1h
25559,2,战神哥哥,2175,88,4,4,8,50.0%,1h
25559,2,冷灬弑,2175,90,3,5,8,37.5%,19m
25559,2,RubberPig,2175,109,2,5,7,28.6%,1h
25559,1,LAIN,2175,95,1,1,2,50.0%,1h
25559,3,瘟疫之源致命污染,2175,30,1,3,4,25.0%,8m
25559,2,lllllIIIlIlI,2175,0,1,5,6,16.7%,1h
25559,2,简单的电脑,2175,0,0,1,1,0.0%,1h
25559,3,鲨鱼辣椒,2175,0,0,2,2,0.0%,1h
25559,3,符璃,2175,0,0,5,5,0.0%,18m
25559,3,Joker,2175,0,0,5,5,0.0%,1h
25580,1,乱竹疏影,2174,1574,63,67,130,48.5%,15m
25580,2,Penapple,2174,543,25,17,42,59.5%,1h
25580,2,[诅咒]小小傲岸,2174,393,18,8,26,69.2%,6m
25580,3,菜是这样的,2174,292,11,10,21,52.4%,1h
25580,2,[VCT]建大一棵草,2174,246,9,13,22,40.9%,1h
25580,3,loyal,2174,259,9,14,23,39.1%,10m
25580,2,[乱世]萌呆二哈,2174,233,7,8,15,46.7%,41m
25580,2,baye,2174,168,6,3,9,66.7%,23m
25580,3,cccc,2174,144,5,4,9,55.6%,8m
25580,2,熊万春,2174,124,5,8,13,38.5%,1h
25580,1,[D3D]小月,2174,91,4,9,13,30.8%,27m
25580,2,莫湫,2174,88,3,1,4,75.0%,1h
25580,2,喜欢打人机,2174,62,3,3,6,50.0%,1h
25580,1,不落之翼,2174,0,1,0,1,100.0%,1h
25580,2,[日最野的狗]wqdsfgf,2174,30,1,3,4,25.0%,13m
25580,1,流光溢彩,2174,0,0,1,1,0.0%,1h
25580,2,大铁人,2174,0,0,1,1,0.0%,55m
25580,3,Sun,2174,0,0,1,1,0.0%,23m
25598,1,FUSION,2173,1621,226,232,458,49.3%,1h
25598,3,雷克萨,2173,949,69,80,149,46.3%,41m
25598,2,deg,2173,980,41,41,82,50.0%,1h
25598,2,[杜瓦可因]龙骑士尹志平,2173,799,32,40,72,44.4%,1h
25598,2,潮水,2173,340,22,22,44,50.0%,11m
25598,1,四角吞金兽,2173,428,13,20,33,39.4%,55m
25598,2,给霸霸趴下,2173,316,12,16,28,42.9%,18m
25598,1,是阿睿呀,2173,304,8,11,19,42.1%,8m
25598,3,千门,2173,48,1,2,3,33.3%,1h
25598,3,[CDSC]DINOSAUR,2173,0,1,4,5,20.0%,1h
25598,2,没意义,2173,0,1,4,5,20.0%,16m
25598,2,ADcarry,2173,0,1,6,7,14.3%,16m
25598,2,Ning,2173,94,1,6,7,14.3%,18m
25598,3,totoies,2173,0,0,1,1,0.0%,1h
25598,1,半个鸟黑,2173,0,0,1,1,0.0%,14m
25598,3,逗比小分队,2173,0,0,2,2,0.0%,10m
25598,2,星靖,2173,0,0,4,4,0.0%,13m
25615,2,Lindon,2172,736,36,31,67,53.7%,1h
25615,2,逐风,2172,517,22,14,36,61.1%,1h
25615,2,古董,2172,655,22,34,56,39.3%,1h
25615,2,黑夜骑士,2172,495,17,24,41,41.5%,44m
25615,1,狂虐芳,2172,410,13,33,46,28.3%,1h
25615,3,烟花真人,2172,248,10,4,14,71.4%,52m
25615,2,专业猎陈人,2172,102,10,10,20,50.0%,1h
25615,2,lifezbb,2172,232,10,11,21,47.6%,27m
25615,2,糖宝,2172,230,9,14,23,39.1%,44m
25615,3,宇宙大帝,2172,166,6,3,9,66.7%,17m
25615,3,evillog,2172,0,3,1,4,75.0%,53m
25615,2,亚山大陆,2172,30,2,2,4,50.0%,60m
25615,1,MoYu,2172,0,0,1,1,0.0%,21m
25615,2,潜行之鲷,2172,0,0,2,2,0.0%,50m
25615,3,tears,2172,0,0,5,5,0.0%,53m
25630,1,[其实是虎牢关]王勇,2171,1183,77,99,176,43.8%,52m
25630,1,Fox,2171,1197,48,44,92,52.2%,15m
25630,2,Phoenix,2171,715,38,24,62,61.3%,1h
25630,2,点点鼠标,2171,805,33,36,69,47.8%,1h
25630,3,泽拉图,2171,237,8,13,21,38.1%,1h
25630,1,dwefwef,2171,192,6,11,17,35.3%,1h
25630,2,平凡虫撅徒,2171,134,5,7,12,41.7%,34m
25630,3,珺珹珹,2171,100,3,3,6,50.0%,1h
25630,2,[萌新萌新萌]秋月爱莉,2171,142,3,7,10,30.0%,34m
25630,2,莱因哈特,2171,30,2,4,6,33.3%,41m
25630,3,某一,2171,0,1,0,1,100.0%,7m
25630,3,Monster,2171,0,1,4,5,20.0%,1h
25630,2,hym,2171,0,1,7,8,12.5%,1h
25630,3,[嘤嘤嘤呜呜]DAN,2171,0,0,1,1,0.0%,1h
25630,2,[阿里巴巴战队]拔剑四顾心已凉,2171,0,0,1,1,0.0%,27m
25630,2,南浦,2171,0,0,6,6,0.0%,1h
25646,1,淼沐,2170,1378,142,159,301,47.2%,1h
25646,1,sellence,2170,1589,89,86,175,50.9%,56m
25646,2,龙城狂霸拽少,2170,921,85,97,182,46.7%,6m
25646,1,五马路,2170,1442,59,73,132,44.7%,1h
25646,2,hualala,2170,1085,41,49,90,45.6%,13m
25646,1,热爱星际,2170,739,26,30,56,46.4%,1h
25646,2,Sugar,2170,483,19,15,34,55.9%,34m
25646,2,[不成功变成仁]罪恶之神,2170,481,19,23,42,45.2%,49m
25646,3,丶超哥哥,2170,403,17,12,29,58.6%,48m
25646,2,走火的小鸟枪,2170,430,15,20,35,42.9%,29m
25646,2,Firmiana,2170,364,12,14,26,46.2%,1h
25646,2,[妮妮尔大使团]salacious,2170,172,8,8,16,50.0%,34m
25646,3,向问天,2170,114,5,0,5,100.0%,17m
25646,3,wdnmd,2170,78,4,3,7,57.1%,18m
25646,2,皇家拉莫斯,2170,102,3,1,4,75.0%,1h
25646,2,djaslkjd,2170,72,3,4,7,42.9%,44m
25646,2,少大刀,2170,0,2,5,7,28.6%,1h
25646,2,滑稽的咸鱼,2170,0,1,0,1,100.0%,12m
25646,2,天下,2170,0,1,1,2,50.0%,53m
25646,3,stvx,2170,0,0,1,1,0.0%,42m
25646,2,Northtundra,2170,0,0,3,3,0.0%,1h
25667,2,wwwwwwwwwwww,2169,767,34,29,63,54.0%,60m
25667,1,虾仁还要猪心,2169,671,23,26,49,46.9%,1h
25667,2,浪荡,2169,284,10,14,24,41.7%,1h
25667,2,咸鱼,2169,172,7,7,14,50.0%,1h
25667,2,wolaidh,2169,86,4,5,9,44.4%,1h
25667,2,寒九泉,2169,95,2,1,3,66.7%,16m
25667,3,Seliver,2169,60,2,3,5,40.0%,52m
25667,3,hhhh,2169,30,1,1,2,50.0%,1h
25667,3,Cczd,2169,30,1,1,2,50.0%,14m
25667,2,随机,2169,91,1,1,2,50.0%,57m
25667,2,[大秦万世]为了地球,2169,0,1,2,3,33.3%,44m
25667,2,[MTO]吴美怡你爱我吗,2169,30,1,5,6,16.7%,41m
25667,2,蜗牜,2169,0,1,6,7,14.3%,32m
25667,3,[二五仔们上啊]破晓,2169,0,0,1,1,0.0%,22m
25667,3,[邪恶的郁金香]文西,2169,0,0,5,5,0.0%,1h
25682,1,分手不带锅,2168,1193,48,53,101,47.5%,4m
25682,3,lengfengqiao,2168,388,33,40,73,45.2%,1h
25682,2,慕羽兰花,2168,692,30,24,54,55.6%,1h
25682,2,言传,2168,684,25,25,50,50.0%,1h
25682,2,[搞大事]bob,2168,372,14,16,30,46.7%,22m
25682,3,[啊呜哒]deJager,2168,237,8,10,18,44.4%,1h
25682,2,[惊不惊喜]快的让你窒息,2168,192,7,14,21,33.3%,53m
25682,1,流水,2168,236,6,10,16,37.5%,22m
25682,3,孙一喵是我大哥喵,2168,109,4,2,6,66.7%,52m
25682,3,[紫罗兰之都]bai,2168,86,3,1,4,75.0%,14m
25682,2,雪雨清风,2168,72,3,4,7,42.9%,1h
25682,2,[埃蒙帝国]雷诺指挥官,2168,30,2,4,6,33.3%,6m
25682,2,花水月,2168,60,2,7,9,22.2%,34m
25682,3,stilling,2168,0,1,0,1,100.0%,1h
25682,3,鹤柒荔,2168,30,1,1,2,50.0%,1h
25682,3,易言浮生,2168,30,1,1,2,50.0%,1h
25682,2,我很社会,2168,88,1,2,3,33.3%,1h
25682,3,烈风,2168,0,1,4,5,20.0%,18m
25682,2,哥比钻石还炫耀,2168,0,1,6,7,14.3%,55m
25682,1,[肉鸡的饲养]魔法骚女凯露酱,2168,0,0,1,1,0.0%,12m
25682,3,埃蒙小弟,2168,0,0,1,1,0.0%,37m
25682,2,道士,2168,0,0,3,3,0.0%,1h
25682,3,MeGsMaru,2168,0,0,5,5,0.0%,23m
25682,3,vivacraft,2168,0,0,5,5,0.0%,18m
25706,1,icebear,2167,1618,205,217,422,48.6%,1h
25706,2,农村革命根据地,2167,418,16,20,36,44.4%,16m
25706,2,[浦大]KeeLimoon,2167,428,13,20,33,39.4%,28m
25706,3,[你已经死啦]唷林口,2167,157,9,16,25,36.0%,22m
25706,2,白给,2167,245,7,8,15,46.7%,19m
25706,3,长风,2167,220,7,15,22,31.8%,1h
25706,2,[GalArC]永远的巫女,2167,160,5,4,9,55.6%,60m
25706,2,[插爆一切]csyun,2167,116,5,5,10,50.0%,1h
25706,3,mayiming,2167,160,5,17,22,22.7%,51m
25706,2,放弃离开地方,2167,165,4,2,6,66.7%,12m
25706,2,末日宝藏,2167,92,4,7,11,36.4%,16m
25706,2,NarthurE,2167,50,3,8,11,27.3%,34m
25706,3,我谁也打不过,2167,0,1,0,1,100.0%,53m
25706,2,傲骨飞扬,2167,0,1,1,2,50.0%,50m
25706,1,[XXHZ1]我来了,2167,0,1,1,2,50.0%,1h
25706,3,[暴雪二十五队]猛虎一号,2167,0,0,1,1,0.0%,28m
25706,2,潞溍,2167,0,0,2,2,0.0%,13m
25706,1,天宅,2167,0,0,3,3,0.0%,27m
25724,1,Leoyyyyyy,2166,462,45,48,93,48.4%,4m
25724,3,我就是一个肋骨,2166,1131,41,42,83,49.4%,1h
25724,2,SuperJoyc,2166,391,13,19,32,40.6%,1h
25724,2,[鸡饲料加工厂]余辉,2166,310,12,17,29,41.4%,1h
25724,2,xxingjk,2166,76,5,5,10,50.0%,18m
25724,3,[四叶草]IIIIIIIIIIII,2166,114,4,3,7,57.1%,10m
25724,1,serral,2166,30,3,7,10,30.0%,26m
25724,3,格纳,2166,30,2,0,2,100.0%,17m
25724,2,[四月一日]君寻,2166,34,2,3,5,40.0%,19m
25724,3,人族,2166,0,1,0,1,100.0%,1h
25724,3,叶子,2166,0,0,2,2,0.0%,1h
25735,1,flybug,2165,1372,120,128,248,48.4%,53m
25735,2,Find,2165,750,30,29,59,50.8%,50m
25735,2,风飞过得地方,2165,546,19,22,41,46.3%,1h
25735,2,asas,2165,264,16,18,34,47.1%,27m
25735,2,麦克雷,2165,446,15,16,31,48.4%,19m
25735,2,[随心所欲]tank,2165,388,11,23,34,32.4%,1h
25735,3,qxy,2165,202,8,7,15,53.3%,1h
25735,2,sgh,2165,244,8,11,19,42.1%,1h
25735,3,[32CM]对着阿巴瑟冲一发,2165,264,8,17,25,32.0%,52m
25735,2,杀我王虫跟你拼命,2165,210,6,4,10,60.0%,1h
25735,2,心是荒芜的城,2165,197,6,6,12,50.0%,1h
25735,1,[柠檬保护协会]国宝熊猫,2165,233,4,7,11,36.4%,1h
25735,3,伞兵一号卢本伟,2165,30,2,1,3,66.7%,48m
25735,2,泪染墨香,2165,90,2,1,3,66.7%,53m
25749,2,夜色桀,2164,392,14,21,35,40.0%,1h
25749,1,anders,2164,159,12,16,28,42.9%,53m
25749,3,KIing,2164,178,7,5,12,58.3%,1h
25749,3,[CPT]恶魔之王,2164,206,7,6,13,53.8%,1h
25749,2,这是个问题,2164,126,7,17,24,29.2%,1h
25749,3,河间胖猫,2164,114,4,3,7,57.1%,1h
25749,1,[风水]Motmece,2164,93,2,1,3,66.7%,1h
25749,3,SecretLemon,2164,0,2,4,6,33.3%,1h
25749,1,南中焦少,2164,0,0,1,1,0.0%,60m
25749,3,shiyurui,2164,0,0,1,1,0.0%,42m
25749,3,KKlhz,2164,0,0,2,2,0.0%,22m
25749,2,[西北]小铭同学,2164,0,0,3,3,0.0%,1h
25749,3,龙腾,2164,0,0,5,5,0.0%,59m
25749,1,[我是你爹1]地煞,2164,73,0,6,6,0.0%,1h
25763,3,我爱你,2163,508,17,12,29,58.6%,1h
25763,1,[猫神撅后山]smile,2163,483,17,21,38,44.7%,10m
25763,2,我爱加藤惠,2163,404,14,17,31,45.2%,44m
25763,2,我是你坝坝,2163,178,7,12,19,36.8%,1h
25763,2,你携秋水揽星河,2163,228,7,13,20,35.0%,1h
25763,2,Asgard,2163,186,5,3,8,62.5%,27m
25763,2,徐凤年,2163,48,5,4,9,55.6%,18m
25763,2,[50块好狗子]似水流年,2163,170,5,9,14,35.7%,1h
25763,2,ssds,2163,138,3,2,5,60.0%,12m
25763,3,糟老头子,2163,46,3,5,8,37.5%,1h
25763,3,是御姐偏要装可爱,2163,58,2,2,4,50.0%,53m
25763,2,LinSou,2163,114,2,3,5,40.0%,11m
25763,2,[HaNaDa]IIIIIII,2163,58,2,4,6,33.3%,1h
25763,1,听雨,2163,48,2,8,10,20.0%,60m
25763,1,[HustSC]涅普姬雅,2163,0,1,0,1,100.0%,24m
25763,3,可能吧,2163,0,1,0,1,100.0%,26m
25763,2,SuperJustice,2163,0,1,2,3,33.3%,12m
25763,2,笨笨陀,2163,0,0,3,3,0.0%,1h
25781,2,WBM,2162,848,126,144,270,46.7%,41m
25781,2,Sincere,2162,669,45,36,81,55.6%,34m
25781,3,[CPT]NASA,2162,1017,37,42,79,46.8%,1h
25781,2,炸天帮徐缺,2162,628,34,36,70,48.6%,1h
25781,1,罗伯斯庇尔,2162,679,21,36,57,36.8%,1h
25781,3,千刃,2162,156,6,5,11,54.5%,52m
25781,3,泥巴怪,2162,170,6,5,11,54.5%,22m
25781,3,启灵,2162,38,4,2,6,66.7%,1h
25781,3,美国屠熊高手,2162,144,4,10,14,28.6%,1h
25781,2,我是大神,2162,121,3,2,5,60.0%,23m
25781,1,TSG,2162,135,3,3,6,50.0%,1h
25781,3,molecular,2162,30,2,7,9,22.2%,1h
25781,2,[时令]零时雨,2162,0,1,1,2,50.0%,1h
25781,2,Asuna,2162,0,1,2,3,33.3%,1h
25795,1,人族无敌,2161,1190,87,91,178,48.9%,4m
25795,3,[魔法少女小屋]WDNMD,2161,858,37,27,64,57.8%,1h
25795,2,我不是废材,2161,558,20,24,44,45.5%,1h
25795,1,Rockfeller,2161,620,18,34,52,34.6%,1h
25795,2,酒后单杀丈母娘,2161,90,3,8,11,27.3%,53m
25795,2,[鲁德欢]轰隆隆,2161,91,2,1,3,66.7%,1h
25795,2,ericome,2161,114,2,6,8,25.0%,1h
25795,2,封神智力,2161,0,0,1,1,0.0%,1h
25795,3,胡豆芽,2161,0,0,5,5,0.0%,1h
25804,2,果子营,2160,444,43,35,78,55.1%,51m
25804,2,轩轩轩,2160,1132,40,49,89,44.9%,1h
25804,3,[万事俱来香]SCV,2160,756,28,22,50,56.0%,1h
25804,1,万古霉素,2160,713,24,27,51,47.1%,1h
25804,3,[极限菜鸟]小车,2160,370,13,12,25,52.0%,1h
25804,3,令狐巷雨,2160,212,8,6,14,57.1%,22m
25804,3,flash,2160,249,8,14,22,36.4%,1h
25804,2,万无一失,2160,182,6,9,15,40.0%,1h
25804,3,MWMWMWMMWMWM,2160,116,5,1,6,83.3%,1h
25804,3,慢的叫吞吞,2160,168,5,5,10,50.0%,22m
25804,2,五月,2160,188,5,8,13,38.5%,19m
25804,1,望帝,2160,236,5,12,17,29.4%,27m
25804,2,安营肿么生成矿,2160,94,4,8,12,33.3%,6m
25804,1,楚子航,2160,152,4,15,19,21.1%,54m
25804,2,减肥的开个会,2160,112,3,2,5,60.0%,1h
25804,2,lingo,2160,172,3,6,9,33.3%,1h
25804,3,少昊哥哥,2160,70,2,10,12,16.7%,1h
25804,2,年少轻灬狂,2160,0,1,0,1,100.0%,27m
25804,3,永不完结的梦,2160,0,1,0,1,100.0%,1h
25804,2,Qfly,2160,0,1,0,1,100.0%,1h
25804,2,没错我是小刘,2160,0,1,1,2,50.0%,1h
25804,3,眉毛凯凯,2160,0,0,5,5,0.0%,60m
25826,3,西蜀诸葛亮,2159,1543,607,675,1282,47.3%,1h
25826,2,丛林友情狼,2159,1008,40,47,87,46.0%,18m
25826,1,[TLGD]Bomb,2159,375,11,19,30,36.7%,1h
25826,3,[晒职联合会]老萝卜两千型,2159,191,6,0,6,100.0%,1h
25826,2,米卢猫,2159,242,5,11,16,31.2%,13m
25826,1,king,2159,161,4,1,5,80.0%,39m
25826,1,苍澜星寒,2159,38,4,6,10,40.0%,26m
25826,2,yaha,2159,119,2,2,4,50.0%,18m
25826,3,颜大神,2159,42,2,2,4,50.0%,4m
25826,3,lalallaalll,2159,70,2,5,7,28.6%,1h
25826,3,卡拉克斯,2159,30,1,2,3,33.3%,9m
25826,2,[灰玖]玖狸,2159,0,1,3,4,25.0%,1h
25826,2,血狼,2159,30,1,4,5,20.0%,5m
25826,2,行者,2159,0,1,5,6,16.7%,1h
25826,3,艾尔之光蔡徐坤,2159,0,0,1,1,0.0%,3m
25826,3,[C19149]奥巴马惊呆了,2159,0,0,1,1,0.0%,31m
25826,1,Joeone,2159,0,0,1,1,0.0%,10m
25826,2,[洛水天依]Scarlett,2159,0,0,3,3,0.0%,16m
25826,3,静夜里的僵尸,2159,0,0,3,3,0.0%,8m
25845,1,星际脆皮,2158,1645,117,128,245,47.8%,37m
25845,2,我顶你个肺,2158,857,35,37,72,48.6%,50m
25845,3,IIIIIIIIIII,2158,687,34,25,59,57.6%,1h
25845,1,黑泽泽,2158,262,8,19,27,29.6%,1h
25845,1,小龙君,2158,142,6,10,16,37.5%,8m
25845,1,smile,2158,283,6,13,19,31.6%,22m
25845,2,[DSA]尘丶戏子,2158,190,6,14,20,30.0%,6m
25845,3,[暴雪家族]zhiyouzhe,2158,116,4,5,9,44.4%,1h
25845,1,大天使之怒,2158,85,4,6,10,40.0%,1h
25845,3,LUPIN,2158,30,2,0,2,100.0%,45m
25845,3,Kone,2158,44,2,4,6,33.3%,1h
25845,1,ZhuoY,2158,118,2,6,8,25.0%,24m
25845,3,长安一醉,2158,0,1,1,2,50.0%,22m
25845,1,魔君殿下,2158,97,1,6,7,14.3%,1h
25845,3,[满腹离骚]NEXUS,2158,0,0,1,1,0.0%,1h
25860,2,咖喱棒,2157,580,25,27,52,48.1%,1h
25860,2,村子里的风筝,2157,560,20,28,48,41.7%,1h
25860,2,快乐星际,2157,568,19,30,49,38.8%,51m
25860,2,[NLHR]艾尔,2157,146,6,6,12,50.0%,1h
25860,2,再追老子砍死你丶,2157,90,6,6,12,50.0%,1h
25860,3,鲍之晨,2157,102,5,2,7,71.4%,1h
25860,1,樱井智树,2157,122,3,3,6,50.0%,1h
25860,1,Shakespeare,2157,76,2,16,18,11.1%,46m
25860,3,[EDR]六颗星,2157,0,1,1,2,50.0%,1h
25860,2,LZY,2157,80,1,3,4,25.0%,27m
25860,2,[舰队训练营]Ryzen,2157,0,1,3,4,25.0%,1h
25860,3,刘小丁,2157,0,1,5,6,16.7%,1h
25860,3,rewggwwt,2157,0,0,1,1,0.0%,1h
25860,3,初心,2157,0,0,2,2,0.0%,14m
25860,2,吉瑞之兆,2157,0,0,3,3,0.0%,44m
25875,1,[汐雅]流眄,2156,1332,249,260,509,48.9%,1h
25875,2,条西,2156,364,12,19,31,38.7%,1h
25875,2,硝鼠粮碴,2156,0,4,3,7,57.1%,1h
25875,2,雷麒麟,2156,88,3,7,10,30.0%,57m
25875,2,上官静儿,2156,0,1,0,1,100.0%,27m
25875,1,Dash,2156,0,1,7,8,12.5%,16m
25875,1,路明非,2156,0,1,7,8,12.5%,1h
25875,2,星际小展,2156,0,1,7,8,12.5%,55m
25875,2,残雨,2156,0,0,1,1,0.0%,27m
25875,2,[埃蒙的勇士们]埃蒙,2156,0,0,1,1,0.0%,1h
25875,2,帝国幽灵,2156,0,0,1,1,0.0%,1h
25886,2,梦醒丨时光流逝,2155,1392,223,225,448,49.8%,1h
25886,1,VGjade,2155,608,102,106,208,49.0%,53m
25886,3,pushdozer,2155,1553,73,86,159,45.9%,1h
25886,2,我大和呢我不到啊,2155,628,22,28,50,44.0%,1h
25886,1,永夜,2155,281,10,10,20,50.0%,42m
25886,3,力宝,2155,114,4,2,6,66.7%,22m
25886,2,总有刁民想害朕,2155,199,4,10,14,28.6%,1h
25886,2,天帝,2155,96,3,8,11,27.3%,5m
25886,3,浪子回头金,2155,0,2,3,5,40.0%,1h
25886,2,神圣黑鸡,2155,0,1,2,3,33.3%,1h
25886,1,昊穹,2155,0,1,3,4,25.0%,51m
25886,1,碳烤皮皮虾,2155,0,1,3,4,25.0%,1h
25886,2,四灵,2155,46,1,7,8,12.5%,34m
25886,1,[大熊猫]路灯下萌一萌,2155,46,1,14,15,6.7%,1h
25900,1,毛毛虫只吃肉,2154,1444,76,69,145,52.4%,47m
25900,3,键客行,2154,906,33,33,66,50.0%,1h
25900,3,WSF,2154,716,28,28,56,50.0%,54m
25900,2,复仇邪神,2154,471,19,17,36,52.8%,41m
25900,1,眼冰,2154,545,19,28,47,40.4%,47m
25900,2,专业坑爹三十年,2154,604,19,28,47,40.4%,44m
25900,3,剑与远征,2154,273,17,15,32,53.1%,1h
25900,2,[鲜血蔷薇]人深,2154,470,16,19,35,45.7%,1h
25900,1,[ffnn]encounter,2154,482,15,24,39,38.5%,28m
25900,3,asterope,2154,338,12,11,23,52.2%,1h
25900,2,邵子康,2154,378,12,12,24,50.0%,1h
25900,1,坦克叁佰,2154,272,9,14,23,39.1%,42m
25900,1,[科普卢之耻]北风啸,2154,284,8,9,17,47.1%,1h
25900,1,阎鹏的父亲,2154,181,7,1,8,87.5%,1h
25900,3,fake,2154,146,7,8,15,46.7%,1h
25900,3,oasis,2154,217,6,6,12,50.0%,26m
25900,2,橘子皮哥哥,2154,30,2,3,5,40.0%,1h
25900,3,宝宝宝云,2154,0,2,3,5,40.0%,18m
25900,3,LuBenwei,2154,0,2,9,11,18.2%,1h
25900,2,[埃蒙好可爱]社会你泽哥,2154,0,1,0,1,100.0%,27m
25900,3,风之吟唱,2154,0,1,4,5,20.0%,53m
25900,2,NICEgood,2154,97,1,6,7,14.3%,18m
25900,3,[CPT]星爵,2154,0,0,1,1,0.0%,1h
25900,3,[异端审判庭]斗神瑞尔斯,2154,0,0,1,1,0.0%,1h
25900,3,鲨掉东西,2154,0,0,2,2,0.0%,1h
25900,3,[LHZ]kuma,2154,0,0,2,2,0.0%,28m
25926,1,在水一方,2153,991,62,74,136,45.6%,46m
25926,2,lafee,2153,524,17,23,40,42.5%,42m
25926,1,落鸿,2153,307,10,17,27,37.0%,1h
25926,1,神族玩家死爹妈,2153,231,8,3,11,72.7%,1h
25926,2,大地图,2153,212,7,6,13,53.8%,34m
25926,2,existence,2153,84,3,6,9,33.3%,1h
25926,2,速三升本,2153,86,3,7,10,30.0%,39m
25926,2,狗东西,2153,137,3,7,10,30.0%,12m
25926,3,dsfasdfas,2153,24,3,11,14,21.4%,22m
25926,2,GreenGreen,2153,175,3,13,16,18.8%,37m
25926,2,PartinG,2153,18,2,3,5,40.0%,34m
25926,2,睢声,2153,48,2,7,9,22.2%,1h
25926,2,淡雅,2153,0,1,0,1,100.0%,53m
25926,2,chirstom,2153,0,1,1,2,50.0%,1h
25926,2,干脆面,2153,88,1,4,5,20.0%,1h
25926,3,天才,2153,0,1,4,5,20.0%,59m
25942,3,我也很中二在一起,2152,1620,97,114,211,46.0%,14m
25942,2,该死的温柔,2152,414,76,81,157,48.4%,1h
25942,3,稻道盗,2152,1373,63,71,134,47.0%,1h
25942,2,Eagle,2152,252,9,8,17,52.9%,1h
25942,2,stdent,2152,133,9,10,19,47.4%,1h
25942,1,[CPT]约束,2152,214,7,6,13,53.8%,45m
25942,1,式以京,2152,182,5,8,13,38.5%,1h
25942,3,黑武士,2152,114,4,1,5,80.0%,26m
25942,1,lemon,2152,97,3,5,8,37.5%,22m
25942,1,梦千秋,2152,94,2,3,5,40.0%,58m
25942,3,achao,2152,0,2,3,5,40.0%,1h
25942,3,[肉鸡的饲养]仙筝,2152,0,0,1,1,0.0%,59m
25954,2,帝国皇帝陛下,2151,1544,136,146,282,48.2%,1h
25954,2,Queen,2151,512,62,59,121,51.2%,1h
25954,2,[瘾大眼瞎]路易法,2151,827,30,34,64,46.9%,1h
25954,1,[顾得拜]枪兵就是正义,2151,956,30,40,70,42.9%,7m
25954,3,小小胖,2151,293,11,13,24,45.8%,31m
25954,3,伞兵一号,2151,314,11,17,28,39.3%,1h
25954,2,莲湖泛舟客,2151,338,10,19,29,34.5%,1h
25954,2,及死连线,2151,282,8,10,18,44.4%,27m
25954,2,月色有山河,2151,210,6,10,16,37.5%,1h
25954,2,国服第一骚的人,2151,164,5,4,9,55.6%,1h
25954,2,[最菜战队]名字,2151,97,5,8,13,38.5%,27m
25954,1,黑将,2151,112,4,6,10,40.0%,39m
25954,2,寂寞先生,2151,42,4,12,16,25.0%,34m
25954,3,Savior,2151,98,3,1,4,75.0%,54m
25954,2,逛逛,2151,58,3,8,11,27.3%,1h
25954,2,幻海,2151,0,1,1,2,50.0%,57m
25954,1,人类孤坟,2151,0,1,3,4,25.0%,1h
25954,3,无面万相,2151,0,0,1,1,0.0%,1h
25954,2,蔓蔓青萝,2151,0,0,1,1,0.0%,57m
25954,2,[艾尔之主]指挥官,2151,0,0,2,2,0.0%,1h
25954,1,[MGnb]LIAOYUAN,2151,0,0,5,5,0.0%,1h
25954,3,恰逢山诉闲,2151,0,0,5,5,0.0%,1h
25976,2,[慕灬小冷]烂分大师,2150,1188,58,49,107,54.2%,1h
25976,2,星际霸主,2150,1325,52,52,104,50.0%,1h
25976,2,llllllllllll,2150,924,39,39,78,50.0%,1h
25976,2,老爱,2150,259,37,36,73,50.7%,1h
25976,2,什锦虫餐,2150,400,15,23,38,39.5%,1h
25976,3,枫歪歪,2150,198,11,12,23,47.8%,26m
25976,2,swedcx,2150,296,9,11,20,45.0%,1h
25976,3,[昆明RANK]一个比较浪漫的人,2150,185,5,17,22,22.7%,24m
25976,2,神龙虾米,2150,168,4,7,11,36.4%,1h
25976,1,大魔王,2150,0,3,5,8,37.5%,1h
25976,3,[闪电5连鞭]西园寺世界,2150,0,2,2,4,50.0%,60m
25976,1,凤屿,2150,97,2,8,10,20.0%,14m
25976,1,diewithpain,2150,10,2,10,12,16.7%,46m
25976,3,喜欢吃橘子的汤汤,2150,0,1,4,5,20.0%,56m
25976,3,阿铁姆,2150,0,0,1,1,0.0%,17m
25976,3,归棹来,2150,0,0,2,2,0.0%,48m
25976,2,神虫,2150,0,0,3,3,0.0%,1h
25993,2,呆萌兽,2149,1432,56,52,108,51.9%,1h
25993,1,Hubei,2149,917,32,48,80,40.0%,1h
25993,3,vhkjsr,2149,305,12,15,27,44.4%,38m
25993,2,王小七,2149,274,9,27,36,25.0%,1h
25993,1,论农场中猪的革命,2149,227,6,9,15,40.0%,39m
25993,2,没办法就是玩,2149,124,5,10,15,33.3%,1h
25993,3,星空,2149,114,4,2,6,66.7%,1h
25993,3,起始之空,2149,30,2,0,2,100.0%,1h
25993,3,[暴雪十九队]夜影枫,2149,30,2,0,2,100.0%,4m
25993,3,alberteinste,2149,0,2,3,5,40.0%,1h
25993,3,Sickle,2149,0,1,2,3,33.3%,1h
25993,3,業煋,2149,34,1,3,4,25.0%,53m
25993,2,昨夜一支开,2149,0,1,4,5,20.0%,1h
25993,3,mikeway,2149,0,0,1,1,0.0%,1h
25993,2,舔下霸娼,2149,0,0,1,1,0.0%,1h
26008,2,龙旋风,2148,273,92,94,186,49.5%,1h
26008,2,猥琐不玩,2148,1085,62,65,127,48.8%,5m
26008,2,WinterS,2148,754,29,34,63,46.0%,1h
26008,2,你是一口井,2148,341,18,29,47,38.3%,53m
26008,2,觉得纠结,2148,427,14,14,28,50.0%,1h
26008,1,重塑,2148,260,13,6,19,68.4%,1h
26008,3,MOK,2148,140,6,1,7,85.7%,1h
26008,3,digitalray,2148,88,3,5,8,37.5%,48m
26008,3,阿福,2148,30,2,0,2,100.0%,1h
26008,2,大芳香脚,2148,60,2,5,7,28.6%,1h
26008,3,kent,2148,0,1,0,1,100.0%,1h
26008,2,空游,2148,0,1,2,3,33.3%,13m
26008,2,COOKIECC,2148,0,1,6,7,14.3%,13m
26008,2,他需要一把刀,2148,0,0,3,3,0.0%,1h
26022,2,你的帅爸爸,2147,1135,59,71,130,45.4%,34m
26022,3,沐枫,2147,376,13,13,26,50.0%,1h
26022,2,coop,2147,128,7,16,23,30.4%,22m
26022,2,weisatx,2147,152,6,12,18,33.3%,1h
26022,2,咕噜咕噜鸡,2147,128,4,3,7,57.1%,5m
26022,3,[秋毫第五分队]幽冥流沙,2147,0,2,4,6,33.3%,1h
26022,2,NAMCO,2147,46,2,6,8,25.0%,1h
26022,3,了不起的盖茨比,2147,62,2,6,8,25.0%,1h
26022,2,腹黑熊,2147,0,1,1,2,50.0%,1h
26022,1,ZYM,2147,0,1,1,2,50.0%,1h
26022,3,神受,2147,0,0,2,2,0.0%,25m
26022,3,一穷二白,2147,0,0,5,5,0.0%,1h
26034,2,战皇,2146,566,25,23,48,52.1%,1h
26034,2,封易,2146,445,16,20,36,44.4%,24m
26034,2,Davis,2146,335,13,18,31,41.9%,1h
26034,1,她说万幸得以相识,2146,350,13,22,35,37.1%,15m
26034,1,xxxxu,2146,362,13,26,39,33.3%,1h
26034,2,宋国的江山,2146,241,12,21,33,36.4%,1h
26034,2,噼里啪啦大怪鸡,2146,251,9,9,18,50.0%,1h
26034,3,大主鸡,2146,114,5,5,10,50.0%,25m
26034,2,herobrine,2146,159,5,5,10,50.0%,13m
26034,1,科比,2146,46,3,10,13,23.1%,42m
26034,1,kevin,2146,48,2,4,6,33.3%,1h
26034,3,康康,2146,0,0,1,1,0.0%,1h
26034,2,水下放电,2146,0,0,2,2,0.0%,1h
26047,3,小乔迎,2145,1248,49,50,99,49.5%,1h
26047,2,Abyss,2145,908,35,39,74,47.3%,37m
26047,2,麦卡修,2145,770,31,39,70,44.3%,53m
26047,2,资深渣男韩某,2145,574,25,28,53,47.2%,37m
26047,3,hcxixi,2145,362,14,11,25,56.0%,1h
26047,2,哈哈哈,2145,340,12,20,32,37.5%,1h
26047,2,Ahoyan,2145,274,11,10,21,52.4%,18m
26047,3,ARSO,2145,308,11,14,25,44.0%,1h
26047,3,那句晚安你听了吗,2145,313,11,16,27,40.7%,8m
26047,2,Winter,2145,342,11,18,29,37.9%,1h
26047,3,卑劣的优雅,2145,92,5,13,18,27.8%,45m
26047,3,大禹,2145,60,3,1,4,75.0%,31m
26047,3,屿梒,2145,122,3,11,14,21.4%,54m
26047,3,左武卫中郎将,2145,0,2,3,5,40.0%,1h
26047,3,从一过来,2145,0,2,3,5,40.0%,1h
26047,2,qwe,2145,30,1,5,6,16.7%,1h
26047,3,一个人,2145,0,0,1,1,0.0%,26m
26047,2,波波多喝糖水,2145,0,0,4,4,0.0%,14m
26047,3,[北有吾王1队]霸王别姬,2145,0,0,5,5,0.0%,1h
26066,2,速推的死全家,2144,1262,50,48,98,51.0%,30m
26066,2,起初的相遇,2144,1297,47,59,106,44.3%,1h
26066,2,怯战蜥蜴斯嘎尔,2144,702,29,29,58,50.0%,30m
26066,2,erww,2144,533,19,22,41,46.3%,1h
26066,3,[一起9]被遗忘者,2144,300,14,12,26,53.8%,31m
26066,2,滑天下之大稽,2144,331,13,10,23,56.5%,1h
26066,2,啦啦啦啦啦啦啦,2144,313,12,19,31,38.7%,13m
26066,3,yanchixia,2144,245,11,8,19,57.9%,1h
26066,3,光明之锤,2144,231,9,6,15,60.0%,1h
26066,2,[老头星际]梦想超级牛,2144,234,9,13,22,40.9%,51m
26066,1,风后九耀,2144,229,8,2,10,80.0%,1h
26066,2,[Sky翱翔]枪在副驾驶,2144,198,6,11,17,35.3%,39m
26066,3,王廷煜,2144,86,3,1,4,75.0%,1h
26066,3,[哔翻天梯鸡]YangYang,2144,0,2,3,5,40.0%,1h
26066,3,HHZROM,2144,60,2,5,7,28.6%,48m
26066,2,追风逐月,2144,112,2,7,9,22.2%,1h
26066,2,一战,2144,0,1,0,1,100.0%,1h
26066,3,众生皆蝼蚁,2144,0,0,1,1,0.0%,1h
26066,3,[gobee]luckyX,2144,0,0,2,2,0.0%,23m
26066,3,猎神龙,2144,0,0,3,3,0.0%,1h
26066,3,LaoGe,2144,0,0,5,5,0.0%,60m
26066,3,我为欣欣上王者,2144,0,0,5,5,0.0%,18m
26088,3,豪的精彩,2143,911,49,67,116,42.2%,1h
26088,2,船到桥头自然沉,2143,995,43,51,94,45.7%,34m
26088,3,围巾,2143,496,23,22,45,51.1%,9m
26088,3,是土豆呀,2143,436,16,12,28,57.1%,1h
26088,2,[寒绯樱]隐刀,2143,384,14,16,30,46.7%,1h
26088,2,kingbomb,2143,290,12,13,25,48.0%,6m
26088,1,掠夺并占有,2143,360,12,28,40,30.0%,20m
26088,3,豆大官人,2143,294,10,7,17,58.8%,8m
26088,1,arthas,2143,194,5,18,23,21.7%,1h
26088,3,世界小好星,2143,30,2,2,4,50.0%,1h
26088,3,坏男人,2143,62,2,3,5,40.0%,48m
26088,1,xjmxhh,2143,0,2,5,7,28.6%,39m
26088,3,那就到处开火,2143,64,2,6,8,25.0%,1h
26088,3,卓耿,2143,30,1,1,2,50.0%,17m
26088,3,最弱二五仔,2143,0,1,2,3,33.3%,1h
26088,3,tic,2143,30,1,2,3,33.3%,26m
26088,3,Raeghar,2143,30,1,3,4,25.0%,11m
26088,3,YTY,2143,0,0,1,1,0.0%,45m
26088,2,随心而动,2143,0,0,2,2,0.0%,1h
26107,2,[冈田平板]冈田奈奈,2142,1235,101,105,206,49.0%,1h
26107,1,独立团李云龙,2142,1381,77,80,157,49.0%,1h
26107,2,swing,2142,1407,55,58,113,48.7%,42m
26107,1,遥远的文明,2142,1006,41,50,91,45.1%,47m
26107,2,[灵猫]小百事,2142,606,35,31,66,53.0%,35m
26107,2,没毛沙兔子,2142,478,30,30,60,50.0%,1h
26107,2,美凌格,2142,372,15,13,28,53.6%,1h
26107,2,Brumar,2142,286,10,15,25,40.0%,1h
26107,3,风中雨行,2142,244,9,6,15,60.0%,17m
26107,1,神之领域,2142,253,6,14,20,30.0%,25m
26107,2,LGD,2142,0,1,2,3,33.3%,1h
26107,2,今晚打老虎,2142,30,1,7,8,12.5%,1h
26107,3,最冷的昨天,2142,0,0,1,1,0.0%,8m
26107,3,丹尼尔,2142,0,0,1,1,0.0%,1h
26121,3,水手辛巴达,2141,1508,68,73,141,48.2%,1h
26121,2,[御神装勿忘]蕾米莉亚斯卡雷特,2141,615,34,39,73,46.6%,50m
26121,2,龙挚剑,2141,321,18,21,39,46.2%,1h
26121,2,疯狂聪聪,2141,473,17,24,41,41.5%,1h
26121,2,[我是萌新Q]小智,2141,309,13,11,24,54.2%,34m
26121,2,十月初八,2141,287,9,19,28,32.1%,1h
26121,2,lzh,2141,276,7,10,17,41.2%,42m
26121,3,剑圣,2141,142,5,4,9,55.6%,1h
26121,3,陈大大,2141,102,4,2,6,66.7%,1h
26121,2,剪舌麻雀,2141,154,4,2,6,66.7%,1h
26121,2,[青龙帮]晨晨啊啊啊,2141,90,3,9,12,25.0%,1h
26121,3,来吧,2141,97,3,11,14,21.4%,1h
26121,3,UDI,2141,58,2,3,5,40.0%,1h
26121,1,草原老猛逼,2141,48,2,8,10,20.0%,1h
26121,2,我也不知道取啥名,2141,0,0,2,2,0.0%,16m
26121,3,英俊靓仔,2141,0,0,5,5,0.0%,59m
26137,1,[TAPC]TITANS,2140,1301,95,100,195,48.7%,1h
26137,1,星河揽阅,2140,589,45,48,93,48.4%,21m
26137,2,[风之灵]小龙,2140,730,25,33,58,43.1%,34m
26137,2,不讲五德,2140,479,15,28,43,34.9%,37m
26137,3,[31CM]NICK,2140,389,12,13,25,48.0%,38m
26137,1,黑马王子,2140,397,11,11,22,50.0%,39m
26137,2,神探狄仁杰,2140,205,9,6,15,60.0%,11m
26137,2,黑旗舰队,2140,256,8,8,16,50.0%,1h
26137,2,齐兴龙,2140,180,7,10,17,41.2%,1h
26137,2,ppsuc,2140,131,6,4,10,60.0%,32m
26137,3,朝思暮想冰,2140,179,5,14,19,26.3%,1h
26137,2,刀削炸酱面,2140,182,4,11,15,26.7%,1h
26137,2,lkxx,2140,129,2,8,10,20.0%,1h
26137,1,铭楼,2140,48,2,9,11,18.2%,14m
26137,3,鲁大师逢狼时刻,2140,0,2,9,11,18.2%,1h
26137,3,Dennis,2140,30,1,1,2,50.0%,14m
26137,1,清泉,2140,46,1,2,3,33.3%,39m
26137,2,你在逗我吗,2140,30,1,5,6,16.7%,1h
26137,1,qwer,2140,0,1,8,9,11.1%,1h
26137,3,JachinVan,2140,0,0,5,5,0.0%,37m
26157,3,暗影兵神,2139,1200,47,45,92,51.1%,1h
26157,2,纵横之,2139,577,19,22,41,46.3%,44m
26157,1,哥就是浪,2139,390,17,8,25,68.0%,1h
26157,3,lorenli,2139,343,11,18,29,37.9%,1h
26157,1,yanlua,2139,228,8,15,23,34.8%,10m
26157,3,上海雅树展览有限,2139,145,3,6,9,33.3%,8m
26157,1,[都是兄贵]战争型四系乃,2139,141,3,8,11,27.3%,24m
26157,3,sdasjkldhasj,2139,0,2,4,6,33.3%,23m
26157,2,星际虎,2139,0,1,0,1,100.0%,55m
26157,3,Threefire,2139,30,1,1,2,50.0%,1h
26157,1,CCCP,2139,0,1,7,8,12.5%,16m
26157,3,[爱国]wuyu,2139,0,0,1,1,0.0%,1h
26157,3,BuringArice,2139,0,0,2,2,0.0%,45m
26157,2,防暴队小花,2139,0,0,2,2,0.0%,34m
26157,2,[CcDd]云雾茶,2139,0,0,4,4,0.0%,34m
26172,2,kzbl,2138,1534,173,194,367,47.1%,1h
26172,3,Jerry,2138,1315,105,133,238,44.1%,29m
26172,2,LoveTQF,2138,1258,71,78,149,47.7%,51m
26172,2,骑辰,2138,1353,51,61,112,45.5%,14m
26172,3,残阳下望着窗外,2138,560,30,18,48,62.5%,54m
26172,2,Thunder,2138,430,20,18,38,52.6%,1h
26172,2,梦魇之都,2138,511,20,20,40,50.0%,34m
26172,2,[麻酱罐]未完木偶,2138,507,16,20,36,44.4%,19m
26172,2,到位,2138,63,11,17,28,39.3%,1h
26172,1,烟雨,2138,240,7,12,19,36.8%,1h
26172,2,peko,2138,174,5,5,10,50.0%,1h
26172,2,索恩灬,2138,147,5,6,11,45.5%,12m
26172,2,神不在的星期天,2138,120,5,9,14,35.7%,34m
26172,2,酆都范无救,2138,155,4,3,7,57.1%,12m
26172,2,[抬棺送走你]小龙神,2138,123,3,6,9,33.3%,51m
26172,3,魂僧,2138,0,0,1,1,0.0%,1h
26172,2,Dempsey,2138,0,0,4,4,0.0%,16m
26189,2,郝百文,2137,1276,242,252,494,49.0%,1h
26189,1,[菜有菜的道理]wyr,2137,1151,56,60,116,48.3%,47m
26189,2,林仙,2137,740,28,28,56,50.0%,6m
26189,2,Cloudz,2137,739,25,30,55,45.5%,6m
26189,1,[无魂之鸭]暴打狗儿,2137,544,20,33,53,37.7%,11m
26189,1,朝夕,2137,523,17,27,44,38.6%,10m
26189,1,我寻思着我很帅,2137,268,7,12,19,36.8%,1h
26189,1,早睡早起,2137,259,5,9,14,35.7%,12m
26189,1,我去抓老鼠,2137,0,4,4,8,50.0%,1h
26189,3,無念,2137,0,1,0,1,100.0%,23m
26189,3,xsx,2137,0,1,4,5,20.0%,1h
26189,3,[嘤嘤嘤喵喵喵]小时代嚼炫迈,2137,0,0,2,2,0.0%,56m
26201,1,子午线,2136,1430,71,83,154,46.1%,1h
26201,2,吴璐璐,2136,413,31,35,66,47.0%,6m
26201,3,CNM,2136,763,28,34,62,45.2%,1h
26201,2,偏见之僧,2136,471,22,16,38,57.9%,18m
26201,2,沦落,2136,573,21,24,45,46.7%,34m
26201,3,[璀璨群星之刃]八级大狂风,2136,306,11,10,21,52.4%,1h
26201,1,秋水浮萍,2136,137,4,3,7,57.1%,1h
26201,3,lingk,2136,30,2,1,3,66.7%,1h
26201,1,[M8]晁宇昕,2136,48,2,2,4,50.0%,11m
26201,3,[谁呼叫乱舰队]默丿汐,2136,68,2,4,6,33.3%,1h
26201,2,boss,2136,60,2,7,9,22.2%,50m
26201,1,啥也不会的萌新,2136,0,1,1,2,50.0%,38m
26201,2,[浴火银河]你神爸丿我在此丶,2136,92,1,3,4,25.0%,1h
26201,3,小六子丶,2136,0,0,2,2,0.0%,1h
26215,2,我很菜,2135,1514,71,77,148,48.0%,1h
26215,3,小反弹,2135,266,9,9,18,50.0%,1h
26215,2,忧伤的马币,2135,98,4,8,12,33.3%,1h
26215,2,小米,2135,58,3,4,7,42.9%,1h
26215,2,袭胸龙抓手,2135,0,1,0,1,100.0%,1h
26215,3,ETO,2135,0,1,4,5,20.0%,1h
26215,3,绘梨衣的小黄鸭,2135,0,1,5,6,16.7%,1h
26215,3,Past,2135,0,0,1,1,0.0%,8m
26215,3,[ATLS]啧啧啧沼泽,2135,0,0,1,1,0.0%,3m
26215,3,九个太阳,2135,0,0,3,3,0.0%,42m
26225,3,微澜止水,2134,1592,109,130,239,45.6%,1h
26225,3,Campfire,2134,559,55,70,125,44.0%,11m
26225,2,只会人族,2134,341,12,18,30,40.0%,1h
26225,3,周王朝,2134,42,2,1,3,66.7%,53m
26225,3,木马,2134,0,1,4,5,20.0%,1h
26225,3,饕餮,2134,0,0,1,1,0.0%,1h
26231,3,sniper,2133,251,41,39,80,51.2%,1h
26231,2,久域,2133,397,16,18,34,47.1%,30m
26231,2,蜜糖小气球,2133,297,12,10,22,54.5%,1h
26231,3,Mrsluo,2133,221,7,6,13,53.8%,25m
26231,1,这些天,2133,185,4,2,6,66.7%,22m
26231,3,白羽静风尘,2133,58,3,2,5,60.0%,29m
26231,1,姐夫,2133,138,3,8,11,27.3%,38m
26231,3,Timing,2133,30,2,2,4,50.0%,25m
26231,1,飞来鱼,2133,48,2,4,6,33.3%,39m
26231,1,pbisharp,2133,93,1,2,3,33.3%,1h
26231,3,我是谁你不知道,2133,0,0,1,1,0.0%,1h
26231,3,钱穆父,2133,0,0,2,2,0.0%,26m
26231,3,[一块晶体矿]旋律空灵,2133,0,0,2,2,0.0%,1h
26231,2,SEVEN,2133,0,0,7,7,0.0%,55m
26245,1,[SKO丶M]来互相伤害啊,2132,1091,41,56,97,42.3%,22m
26245,1,apofh,2132,737,34,49,83,41.0%,1h
26245,2,窝窝头一块钱四个,2132,828,28,38,66,42.4%,1h
26245,1,血吼部落,2132,261,6,7,13,46.2%,22m
26245,1,宝宝熊,2132,180,5,16,21,23.8%,37m
26245,2,LHY,2132,163,4,3,7,57.1%,1h
26245,1,水浴,2132,138,3,3,6,50.0%,1h
26245,2,[绘梨依]Edgar,2132,40,2,3,5,40.0%,55m
26245,3,jwk,2132,0,2,4,6,33.3%,1h
26245,1,孤独的九爷,2132,97,2,5,7,28.6%,1h
26245,2,[就是打不过]Solong,2132,0,1,4,5,20.0%,13m
26245,3,花落情未断,2132,0,1,5,6,16.7%,59m
26245,3,六颗核弹,2132,0,0,1,1,0.0%,1h
26245,3,爸爸轻点,2132,0,0,1,1,0.0%,11m
26245,2,章大大皇帝,2132,0,0,2,2,0.0%,1h
26260,2,嗯哼,2131,538,23,28,51,45.1%,27m
26260,1,[玩个虫子]帅猫,2131,414,16,28,44,36.4%,4m
26260,1,灬死神丿千军万马,2131,182,8,9,17,47.1%,1h
26260,2,血染姬发,2131,226,8,10,18,44.4%,1h
26260,3,csw,2131,180,6,6,12,50.0%,1h
26260,2,血狂张岩,2131,189,4,6,10,40.0%,18m
26260,3,[极限菜鸟]活死人,2131,30,2,1,3,66.7%,11m
26260,3,[菜有菜的道理]广告推销商,2131,58,2,3,5,40.0%,26m
26260,2,虞者大人,2131,30,2,4,6,33.3%,16m
26260,3,大白菜,2131,0,1,0,1,100.0%,1h
26260,3,[辣个大主机]LeFTIME,2131,30,1,2,3,33.3%,1h
26260,2,OIFRG,2131,0,0,6,6,0.0%,53m
26272,1,我本闲鱼,2130,1175,48,59,107,44.9%,1h
26272,3,[白给QAQ]七秒鱼,2130,410,16,13,29,55.2%,1h
26272,2,zheng,2130,113,6,4,10,60.0%,27m
26272,2,RENZU,2130,42,3,8,11,27.3%,1h
26272,2,么子洲,2130,134,2,1,3,66.7%,1h
26272,3,[O0OoO]邪恶人生,2130,30,1,1,2,50.0%,1h
26272,2,Mars,2130,0,1,6,7,14.3%,57m
26272,3,[Hdl]风衅,2130,0,0,1,1,0.0%,1h
26272,2,暗刃,2130,0,0,3,3,0.0%,34m
26281,2,[鲲之大]一一,2129,887,35,35,70,50.0%,1h
26281,2,RogueFour,2129,263,7,12,19,36.8%,1h
26281,2,[旺旺战士]前列腺小哥哥,2129,36,5,7,12,41.7%,1h
26281,3,llllllllllll,2129,124,4,5,9,44.4%,1h
26281,2,[爱国]反馈图,2129,119,2,1,3,66.7%,1h
26281,3,狗功夫,2129,60,2,3,5,40.0%,26m
26281,2,黑兔子王,2129,0,1,6,7,14.3%,1h
26281,2,悠悠水冷,2129,0,1,7,8,12.5%,16m
26281,3,shangyunkui,2129,0,0,1,1,0.0%,29m
26281,3,莫言无,2129,0,0,2,2,0.0%,1h
26291,1,十二审判,2128,1423,177,193,370,47.8%,35m
26291,2,[Marry]字数补丁是我,2128,1519,99,105,204,48.5%,1h
26291,2,旺仔小馒头,2128,1437,57,66,123,46.3%,1h
26291,3,炭烤银鳕鱼,2128,836,32,28,60,53.3%,17m
26291,2,雷霆嘎巴,2128,794,32,29,61,52.5%,37m
26291,2,薛鹏程,2128,717,27,44,71,38.0%,1h
26291,2,随风飘雪,2128,296,19,27,46,41.3%,1h
26291,1,[老头儿星际]歹徒,2128,490,18,40,58,31.0%,37m
26291,1,扫比阿量,2128,243,8,11,19,42.1%,22m
26291,1,darkmaster,2128,184,5,5,10,50.0%,42m
26291,3,leon,2128,184,4,1,5,80.0%,8m
26291,3,[萌妹cute]忆雨,2128,86,4,1,5,80.0%,54m
26291,3,gggg,2128,86,4,2,6,66.7%,42m
26291,1,lies,2128,46,1,1,2,50.0%,16m
26291,2,低迷的芬芳,2128,0,1,6,7,14.3%,34m
26291,3,去远方,2128,0,0,1,1,0.0%,53m
26291,2,快乐就完了,2128,0,0,2,2,0.0%,57m
26291,1,GDXJ,2128,0,0,5,5,0.0%,9m
26291,3,Katou,2128,0,0,5,5,0.0%,18m
26291,2,falanke,2128,0,0,6,6,0.0%,1h
26311,1,慢攻小王子,2127,1012,97,115,212,45.8%,47m
26311,2,小龙,2127,771,32,35,67,47.8%,1h
26311,3,清晰,2127,310,26,21,47,55.3%,53m
26311,2,[KPG2]依然是一个明光,2127,634,26,27,53,49.1%,34m
26311,2,收费的口味,2127,402,19,22,41,46.3%,11m
26311,1,[艾尔之名]tangzhongyi,2127,132,8,15,23,34.8%,10m
26311,2,llllllllllll,2127,240,6,11,17,35.3%,16m
26311,2,沉痛的梦伤,2127,150,5,10,15,33.3%,55m
26311,1,[湛江一中培才]TKckd,2127,95,2,1,3,66.7%,1h
26311,3,清欢,2127,58,2,1,3,66.7%,48m
26311,2,求求你别杀我,2127,0,1,0,1,100.0%,18m
26311,3,CCG,2127,0,1,0,1,100.0%,1h
26311,3,旅店老板,2127,0,1,1,2,50.0%,1h
26311,3,疯当当,2127,0,1,4,5,20.0%,1h
26311,3,可以吗,2127,0,0,1,1,0.0%,18m
26326,2,李子豪,2126,971,40,32,72,55.6%,1h
26326,2,浪迹天涯,2126,436,21,20,41,51.2%,1h
26326,2,Windy,2126,312,13,10,23,56.5%,35m
26326,1,新疆玛纳斯,2126,283,8,14,22,36.4%,1h
26326,1,别打我了,2126,188,8,21,29,27.6%,55m
26326,1,四宫辉夜,2126,176,6,11,17,35.3%,1h
26326,3,gjv,2126,120,5,6,11,45.5%,53m
26326,3,星际小菜鸟,2126,173,4,1,5,80.0%,31m
26326,2,核爆,2126,125,4,11,15,26.7%,42m
26326,3,GOGOL,2126,102,3,3,6,50.0%,1h
26326,2,宇航员,2126,30,2,3,5,40.0%,1h
26326,3,[ExpDrv]Gekkoma,2126,0,1,0,1,100.0%,1h
26326,3,[田中姬铃木雏]GHOST,2126,0,1,1,2,50.0%,8m
26326,1,kks,2126,46,1,4,5,20.0%,1h
26326,2,风爆炎,2126,0,0,1,1,0.0%,32m
26341,2,涟漪灬,2125,788,36,34,70,51.4%,1h
26341,3,[猫猫咪咪]JackGh,2125,806,33,36,69,47.8%,1h
26341,2,布莱克翰,2125,300,18,23,41,43.9%,27m
26341,3,溟色貂夜,2125,376,14,19,33,42.4%,4m
26341,3,clp,2125,264,9,16,25,36.0%,9m
26341,2,dsfs,2125,171,5,8,13,38.5%,16m
26341,2,[慢手e族]吾非空,2125,128,3,6,9,33.3%,34m
26341,1,弑神,2125,145,3,10,13,23.1%,1h
26341,3,醉丶宠珊,2125,34,2,0,2,100.0%,1h
26341,3,[旧日塔罗会]道格拉斯冯巩,2125,58,2,2,4,50.0%,54m
26341,3,Destroy,2125,0,1,0,1,100.0%,1h
26341,2,aaaaee,2125,0,1,5,6,16.7%,1h
26341,2,沐风林轩,2125,0,1,6,7,14.3%,1h
26341,2,ggwp,2125,0,0,1,1,0.0%,57m
26341,1,Dream,2125,0,0,5,5,0.0%,1h
26341,3,sads,2125,0,0,5,5,0.0%,1h
26357,2,无药之竞,2124,795,51,63,114,44.7%,44m
26357,3,[久美子足浴城]星际霸王,2124,406,15,13,28,53.6%,17m
26357,2,starcarrot,2124,354,13,15,28,46.4%,1h
26357,2,暗影之龙,2124,281,9,9,18,50.0%,1h
26357,3,hhhhhh,2124,72,4,4,8,50.0%,8m
26357,3,[高坚果护卫团]普莱斯中尉,2124,58,2,1,3,66.7%,9m
26357,3,惺惺惜惺惺,2124,60,2,3,5,40.0%,17m
26357,2,虎切切,2124,0,1,6,7,14.3%,1h
26357,1,查尔的爪牙,2124,0,0,1,1,0.0%,1h
26357,3,乾锋,2124,0,0,1,1,0.0%,1h
26357,3,shuzi,2124,0,0,1,1,0.0%,60m
26357,3,SoraKage,2124,0,0,2,2,0.0%,1h
26357,1,音律,2124,0,0,2,2,0.0%,1h
26370,2,你问皎白月空,2123,734,31,29,60,51.7%,1h
26370,3,awei,2123,734,25,30,55,45.5%,45m
26370,3,风中凌乱,2123,631,24,26,50,48.0%,1h
26370,1,[love西瓜]yesisca,2123,330,13,20,33,39.4%,21m
26370,2,[人族最强近战]Falcon,2123,232,9,15,24,37.5%,41m
26370,2,御坂美琴我的我的,2123,120,4,1,5,80.0%,1h
26370,2,迟疑,2123,132,4,5,9,44.4%,29m
26370,2,降到一级,2123,136,4,10,14,28.6%,53m
26370,3,那只猪,2123,0,2,1,3,66.7%,18m
26370,2,天天,2123,127,2,8,10,20.0%,32m
26370,2,禾郢,2123,46,1,2,3,33.3%,39m
26370,3,DYSD,2123,0,0,5,5,0.0%,60m
26382,2,娜娜小云,2122,1508,108,126,234,46.2%,1h
26382,2,星灵之遗,2122,994,44,54,98,44.9%,51m
26382,2,月色撩人,2122,951,38,44,82,46.3%,1h
26382,1,jiaomujun,2122,489,38,55,93,40.9%,1h
26382,3,星际常胜将军,2122,654,32,37,69,46.4%,17m
26382,3,我帅的一死虐服,2122,639,22,35,57,38.6%,38m
26382,3,唐小饶,2122,288,19,20,39,48.7%,1h
26382,3,李梓涵,2122,477,17,17,34,50.0%,38m
26382,2,[黑暗幻想]任我行,2122,407,16,17,33,48.5%,20m
26382,2,CRaZy,2122,278,10,21,31,32.3%,1h
26382,2,殇秋,2122,244,9,11,20,45.0%,1h
26382,3,[炸天帮万岁]扬了你的奶粉,2122,236,8,2,10,80.0%,1h
26382,2,紫魁星的使者,2122,170,6,5,11,54.5%,1h
26382,2,RED,2122,187,6,17,23,26.1%,1h
26382,1,[YG2020]龑殇梦之泪,2122,159,3,1,4,75.0%,1h
26382,1,你可真是个鬼才,2122,48,2,0,2,100.0%,1h
26382,3,jume,2122,30,2,0,2,100.0%,3m
26382,3,[津富会]爱的飞行日记,2122,58,2,1,3,66.7%,1h
26382,3,Badwoman,2122,0,1,0,1,100.0%,57m
26382,2,JACKHE,2122,34,1,9,10,10.0%,1h
26382,3,alexguo,2122,0,0,1,1,0.0%,1h
26382,3,天涯,2122,0,0,2,2,0.0%,37m
26404,3,[白丝黑丝萝莉]风吹雪,2121,1108,39,39,78,50.0%,25m
26404,3,开展,2121,746,29,36,65,44.6%,45m
26404,3,bluralight,2121,314,12,10,22,54.5%,1h
26404,2,[HDU]无敌趴爷,2121,242,9,14,23,39.1%,22m
26404,3,宬扬,2121,150,7,3,10,70.0%,1h
26404,3,喵星人,2121,88,6,7,13,46.2%,1h
26404,3,[萌新保护协议]岚君,2121,60,2,2,4,50.0%,48m
26404,3,取经西天,2121,0,1,0,1,100.0%,1h
26404,3,[童话小镇]马卡龙,2121,0,1,1,2,50.0%,1h
26404,2,白绝,2121,0,1,3,4,25.0%,1h
26404,2,YYAKK,2121,0,1,7,8,12.5%,1h
26404,3,[APM25]全村人的希望,2121,0,0,1,1,0.0%,1h
26404,3,贝奇,2121,0,0,1,1,0.0%,1h
26404,1,机械之忍,2121,0,0,4,4,0.0%,1h
26418,1,宇胖大王,2120,1630,124,137,261,47.5%,1h
26418,2,ertw,2120,1433,93,103,196,47.4%,1h
26418,2,您别急来打后期,2120,464,30,27,57,52.6%,50m
26418,2,[内蒙第一舰队]初小賎,2120,474,14,17,31,45.2%,24m
26418,2,FallenScars,2120,258,14,28,42,33.3%,27m
26418,3,[底特律KAR]香蕉君,2120,315,11,12,23,47.8%,1h
26418,2,[爱国]绝望吧,2120,236,8,8,16,50.0%,57m
26418,1,firstfirm,2120,0,3,5,8,37.5%,43m
26418,3,电脑玩家森破,2120,48,3,5,8,37.5%,1h
26418,3,星际新手玩家,2120,30,2,1,3,66.7%,45m
26418,1,PokeYourFace,2120,95,2,2,4,50.0%,1h
26418,1,叶湘伦,2120,0,2,8,10,20.0%,1h
26418,3,MrLynn,2120,30,1,1,2,50.0%,8m
26418,2,呕八,2120,0,1,6,7,14.3%,53m
26432,1,[WIE]帝俊,2119,1478,70,78,148,47.3%,1h
26432,3,[落魄山]manman,2119,1036,45,42,87,51.7%,57m
26432,2,亡者之魂,2119,1131,44,47,91,48.4%,1h
26432,2,[OhNo]IIIIIIIIIIII,2119,535,32,28,60,53.3%,1h
26432,2,虚空之影,2119,660,27,29,56,48.2%,1h
26432,2,child,2119,261,26,25,51,51.0%,53m
26432,3,阿西吧,2119,604,21,29,50,42.0%,1h
26432,3,虞美人,2119,518,20,19,39,51.3%,54m
26432,3,黑哥,2119,494,19,13,32,59.4%,10m
26432,3,橙子,2119,351,13,8,21,61.9%,1h
26432,3,我得天啊啊啊,2119,228,9,5,14,64.3%,45m
26432,1,破月,2119,226,8,7,15,53.3%,43m
26432,3,黑暗的孤独者,2119,217,8,15,23,34.8%,1h
26432,2,你的四个老婆,2119,178,6,4,10,60.0%,1h
26432,2,Jeff,2119,0,4,3,7,57.1%,1h
26432,3,[GG666]泪洒洗车,2119,58,3,2,5,60.0%,57m
26432,3,SKTNO,2119,51,3,4,7,42.9%,53m
26432,3,asfargsergs,2119,40,1,3,4,25.0%,18m
26432,3,llllllllllll,2119,0,0,1,1,0.0%,1h
26432,3,[XXHZ30]艾雪,2119,0,0,1,1,0.0%,1h
26432,3,cvsdvxchcfds,2119,0,0,2,2,0.0%,17m
26432,3,[新手玩家]被打的小兔,2119,0,0,5,5,0.0%,1h
26454,2,jianshen,2118,1229,72,66,138,52.2%,50m
26454,3,[异度黑核侵蚀]黑猫,2118,86,4,2,6,66.7%,1h
26454,2,viey,2118,44,3,6,9,33.3%,18m
26454,3,凤仙,2118,30,2,2,4,50.0%,1h
26454,2,remember,2118,0,1,8,9,11.1%,1h
26454,3,[绝世之神帝]傲世丶霸皇之剑圣,2118,0,0,1,1,0.0%,1h
26454,2,[世界何平]迷彩旅,2118,0,0,1,1,0.0%,1h
26454,3,[古代毒瘤协会]好名全让我取了,2118,0,0,2,2,0.0%,57m
26454,3,[是我赢了]和呈,2118,0,0,2,2,0.0%,9m
26463,1,[慢手e族]天箭,2117,495,90,97,187,48.1%,53m
26463,3,徐哥,2117,696,26,31,57,45.6%,54m
26463,2,ATV,2117,323,21,17,38,55.3%,19m
26463,3,zhaodanzaixi,2117,512,17,19,36,47.2%,29m
26463,2,空无,2117,385,13,16,29,44.8%,44m
26463,2,sin,2117,245,7,2,9,77.8%,27m
26463,2,BERR,2117,190,6,7,13,46.2%,6m
26463,3,时空意识,2117,152,5,6,11,45.5%,25m
26463,2,心怀暖阳,2117,170,5,9,14,35.7%,14m
26463,2,[九尾]战烛,2117,193,5,9,14,35.7%,24m
26463,3,[终极蛇皮队]考拉,2117,118,4,6,10,40.0%,1h
26463,3,dwjijdwj,2117,122,2,2,4,50.0%,1h
26463,3,杀神幽魂,2117,58,2,2,4,50.0%,22m
26463,3,NeKong,2117,60,2,7,9,22.2%,1h
26463,1,我即是巅峰,2117,94,2,7,9,22.2%,39m
26463,3,不存在的梅达尔多,2117,0,1,0,1,100.0%,1h
26463,3,EnTaroAdun,2117,34,1,6,7,14.3%,1h
26463,1,轩辕,2117,0,0,1,1,0.0%,1h
26463,3,看见,2117,0,0,2,2,0.0%,42m
26482,1,一止,2116,1055,63,76,139,45.3%,1h
26482,3,melucky,2116,756,38,43,81,46.9%,1h
26482,2,KINGofSC,2116,505,18,25,43,41.9%,41m
26482,3,久远,2116,421,15,15,30,50.0%,26m
26482,2,吴彦祖,2116,430,13,17,30,43.3%,1h
26482,3,Wind,2116,204,6,4,10,60.0%,1h
26482,2,王亦轩,2116,142,5,11,16,31.2%,1h
26482,2,[绿水一叶清]雪狐,2116,131,4,5,9,44.4%,1h
26482,3,[衣带诏舰队]水鱼容忍,2116,60,3,4,7,42.9%,1h
26482,3,Ulquiorra,2116,92,3,6,9,33.3%,1h
26482,2,[底特律KAR]Scalpel,2116,62,3,12,15,20.0%,1h
26482,3,新梦大狼,2116,46,3,12,15,20.0%,1h
26482,3,钟然,2116,58,2,4,6,33.3%,9m
26482,3,暮光薄凉,2116,30,1,2,3,33.3%,60m
26482,3,[星际老嘎嘎]虚空老嘎嘎,2116,0,1,4,5,20.0%,1h
26482,3,咸鱼,2116,0,0,1,1,0.0%,1h
26482,3,[SkWing]UnkidMan,2116,0,0,1,1,0.0%,1h
26482,3,ROOR,2116,0,0,2,2,0.0%,22m
26500,2,小饭,2115,427,13,22,35,37.1%,1h
26500,2,WQLT,2115,86,5,7,12,41.7%,16m
26500,3,fnjksxzth,2115,58,3,0,3,100.0%,1h
26500,1,墨影孤韵,2115,48,3,10,13,23.1%,22m
26500,2,一只毒爆,2115,0,1,0,1,100.0%,27m
26500,1,无处流浪,2115,0,0,2,2,0.0%,39m
26500,3,文武之道,2115,0,0,3,3,0.0%,1h
26500,3,神之长子接班人,2115,0,0,5,5,0.0%,54m
26508,2,qiqi,2114,1522,60,69,129,46.5%,34m
26508,2,平常心,2114,886,33,36,69,47.8%,51m
26508,2,gshot,2114,158,17,23,40,42.5%,27m
26508,2,莫名其妙,2114,170,5,7,12,41.7%,1h
26508,1,Mrs,2114,142,5,12,17,29.4%,1h
26508,2,我玩神族只搞后期,2114,72,4,14,18,22.2%,34m
26508,3,[埃蒙好可爱]和泉纱雾,2114,0,3,3,6,50.0%,1h
26508,1,花钱阅下,2114,0,3,13,16,18.8%,25m
26508,1,lIIIllllllII,2114,96,2,3,5,40.0%,1h
26508,2,兰斯洛特,2114,0,2,4,6,33.3%,1h
26508,2,银妖,2114,0,1,0,1,100.0%,1h
26508,3,木心,2114,30,1,1,2,50.0%,54m
26508,3,[墨氏孤朝]墨天寒,2114,0,1,4,5,20.0%,59m
26508,2,靠骗靠噢偷袭,2114,88,1,5,6,16.7%,1h
26508,3,小迪迪,2114,0,0,1,1,0.0%,1h
26508,3,Babypig,2114,0,0,1,1,0.0%,1h
26524,2,天下有敌,2113,1563,123,137,260,47.3%,29m
26524,3,[迷宫丨极限组]deadangel,2113,1057,41,47,88,46.6%,1h
26524,3,牛子哥,2113,785,32,30,62,51.6%,5m
26524,2,[良人]请叫我男神,2113,626,25,33,58,43.1%,6m
26524,3,马哈马哈酷奇,2113,316,14,7,21,66.7%,1h
26524,1,gou,2113,281,7,15,22,31.8%,39m
26524,3,MouseKing,2113,98,6,5,11,54.5%,1h
26524,3,QSHAN,2113,132,6,10,16,37.5%,9m
26524,3,SmallQiang,2113,86,4,1,5,80.0%,1h
26524,2,[Shawk]Keter,2113,86,3,2,5,60.0%,1h
26524,3,浩哥,2113,60,3,3,6,50.0%,1h
26524,2,一字曰心,2113,60,3,9,12,25.0%,1h
26524,3,我的虫虫不打前期,2113,48,2,10,12,16.7%,1h
26524,3,ARTR,2113,0,1,0,1,100.0%,10m
26524,2,柳肥宅,2113,32,1,3,4,25.0%,28m
26524,1,疯狂吊人,2113,93,1,3,4,25.0%,1h
26524,3,一大坨坨坨,2113,0,0,1,1,0.0%,1h
26524,3,[冰之国度]LSS,2113,0,0,1,1,0.0%,57m
26524,2,咩咩咩羊,2113,0,0,2,2,0.0%,1h
26524,3,[韩服宗师组]小静悄悄,2113,0,0,3,3,0.0%,60m
26524,1,忘了,2113,0,0,4,4,0.0%,1h
26545,2,无情商的自恋狂,2112,927,53,48,101,52.5%,1h
26545,2,腾皇,2112,704,41,47,88,46.6%,34m
26545,3,[EDGNB]书航教你口吐莲花,2112,335,13,16,29,44.8%,29m
26545,2,Charles,2112,252,9,11,20,45.0%,1h
26545,3,老狗,2112,202,8,8,16,50.0%,1h
26545,3,飓风狂飙,2112,271,8,10,18,44.4%,1h
26545,3,天行者,2112,238,7,4,11,63.6%,1h
26545,1,UVKT,2112,219,7,11,18,38.9%,16m
26545,1,[Mikon]没人气的咕哒夫,2112,219,5,5,10,50.0%,46m
26545,3,不知名的老猫蛋儿,2112,78,4,13,17,23.5%,14m
26545,3,烈焰,2112,68,2,3,5,40.0%,1h
26545,3,[QWQa]Rain,2112,60,2,4,6,33.3%,53m
26545,3,超级绒毛鸡,2112,0,0,1,1,0.0%,1h
26545,1,假装笨,2112,0,0,1,1,0.0%,1h
26545,2,zxh,2112,0,0,3,3,0.0%,13m
26560,2,三木,2111,1491,91,83,174,52.3%,1h
26560,1,小怪兽,2111,803,91,106,197,46.2%,28m
26560,2,赤情已是修念,2111,1420,57,66,123,46.3%,41m
26560,1,木匠和小怪物,2111,288,8,11,19,42.1%,1h
26560,3,星际霸主,2111,174,8,20,28,28.6%,1h
26560,2,kiss,2111,231,7,9,16,43.8%,56m
26560,3,北冥一只鲲,2111,114,5,2,7,71.4%,22m
26560,3,语录,2111,128,4,5,9,44.4%,1h
26560,3,只会苟,2111,60,3,1,4,75.0%,27m
26560,3,寒兰,2111,60,3,4,7,42.9%,1h
26560,2,逍遥自在,2111,153,3,9,12,25.0%,32m
26560,3,unicorn,2111,0,2,4,6,33.3%,54m
26560,2,主宰,2111,0,1,0,1,100.0%,55m
26560,3,瞳临,2111,0,1,0,1,100.0%,9m
26560,3,王蕴明,2111,30,1,1,2,50.0%,1h
26560,2,[可爱的你们]ShenGunLH,2111,91,1,7,8,12.5%,16m
26560,3,tic,2111,0,0,1,1,0.0%,9m
26560,3,淡笑岁月尘,2111,0,0,1,1,0.0%,1h
26578,1,大白梨,2110,797,39,50,89,43.8%,47m
26578,2,宣凰,2110,569,20,27,47,42.6%,1h
26578,2,JamesRyan,2110,438,14,26,40,35.0%,1h
26578,2,metropolis,2110,332,11,10,21,52.4%,1h
26578,2,[NLHR]fluito,2110,321,10,12,22,45.5%,1h
26578,3,爱吃七岁的三岁,2110,199,6,2,8,75.0%,8m
26578,3,虎背熊腰萝莉心,2110,114,5,2,7,71.4%,23m
26578,1,SUZUKI,2110,188,4,5,9,44.4%,8m
26578,2,[吕布保护集团]magejiterran,2110,164,4,8,12,33.3%,20m
26578,3,刀锋战皇,2110,30,2,1,3,66.7%,1h
26578,2,咖啡中的爱,2110,92,1,2,3,33.3%,1h
26578,3,明哥,2110,0,0,1,1,0.0%,59m
26578,3,[暴雪二十队]直死魔眼根源式,2110,0,0,1,1,0.0%,1h
26578,3,Frodog,2110,0,0,5,5,0.0%,1h
26578,3,阿龙,2110,0,0,5,5,0.0%,52m
26593,1,鸡儿炸了,2109,836,91,107,198,46.0%,7m
26593,1,南鱼不做人辣,2109,239,7,8,15,46.7%,1h
26593,2,[新手学堂]Lsnd,2109,72,5,13,18,27.8%,35m
26593,3,Ugly,2109,116,4,6,10,40.0%,1h
26593,2,[宝贝趴好]吻吻我的小舌头,2109,68,3,8,11,27.3%,1h
26593,2,jsrTBB,2109,168,3,9,12,25.0%,1h
26593,3,dede,2109,66,2,1,3,66.7%,24m
26593,1,少北鹤囍,2109,48,2,3,5,40.0%,51m
26593,2,老班,2109,0,2,5,7,28.6%,53m
26593,3,一言难尽,2109,58,2,6,8,25.0%,1h
26593,3,killer,2109,30,1,5,6,16.7%,1h
26593,3,[肥宅快乐叉]新手电脑,2109,0,1,5,6,16.7%,52m
26593,3,QAQ,2109,42,1,6,7,14.3%,1h
26593,3,[RKT]子鱼不是鱼,2109,34,1,6,7,14.3%,38m
26593,2,gly,2109,0,1,6,7,14.3%,1h
26593,3,coliver,2109,0,0,1,1,0.0%,54m
26593,3,[24CM]萌新中的萌新,2109,0,0,1,1,0.0%,1h
26593,3,冬拾,2109,0,0,1,1,0.0%,1h
26593,2,[XXHZ1]泰坦,2109,0,0,2,2,0.0%,1h
26612,3,教主,2108,360,15,9,24,62.5%,14m
26612,3,神州符华,2108,284,10,11,21,47.6%,1h
26612,1,阿巴阿巴打夺夺,2108,322,10,15,25,40.0%,26m
26612,2,星星点灯,2108,138,6,8,14,42.9%,1h
26612,2,[受死吧喵星人]风暴之怒,2108,148,5,9,14,35.7%,1h
26612,2,SMME,2108,141,3,3,6,50.0%,13m
26612,2,虎头山的少当家,2108,128,3,6,9,33.3%,1h
26612,3,MDMDXXS,2108,0,1,0,1,100.0%,1h
26612,3,在劫难逃终流影,2108,0,1,1,2,50.0%,1h
26612,1,WINGG,2108,0,1,3,4,25.0%,39m
26612,2,笨笨大侠,2108,97,1,7,8,12.5%,1h
26612,3,[Cytus]cello,2108,0,0,1,1,0.0%,1h
26612,3,[星际国民校草]风华绝代张国荣丶,2108,0,0,1,1,0.0%,1h
26625,3,知心小白,2107,1327,52,49,101,51.5%,48m
26625,2,YAN,2107,774,39,51,90,43.3%,50m
26625,2,frankin,2107,559,22,30,52,42.3%,1h
26625,2,尹沛爹,2107,547,22,33,55,40.0%,1h
26625,3,雷偌九五二七,2107,505,18,24,42,42.9%,42m
26625,2,QuitMing,2107,259,18,25,43,41.9%,1h
26625,3,迪尔米莉,2107,335,12,15,27,44.4%,1h
26625,2,艾尔之子,2107,189,9,10,19,47.4%,53m
26625,3,轩神,2107,201,7,1,8,87.5%,1h
26625,3,羽落,2107,60,4,12,16,25.0%,1h
26625,2,谷恒条野,2107,30,4,13,17,23.5%,1h
26625,3,EXU,2107,100,3,2,5,60.0%,1h
26625,3,xcyrichard,2107,88,3,7,10,30.0%,26m
26625,2,[我是攻子]小花,2107,0,1,6,7,14.3%,1h
26625,3,ggwyym,2107,0,0,1,1,0.0%,1h
26625,3,hgdgh,2107,0,0,1,1,0.0%,1h
26625,3,飞哥,2107,0,0,5,5,0.0%,52m
26642,3,魔蝎星君,2106,1630,232,266,498,46.6%,1h
26642,2,方明大傻纸,2106,1047,39,47,86,45.3%,1h
26642,3,[西中街小学]Terry,2106,487,34,37,71,47.9%,1h
26642,3,WEwindinNEO,2106,547,21,27,48,43.8%,23m
26642,2,斯托蕾雅,2106,522,20,25,45,44.4%,1h
26642,3,lIIIIl,2106,481,16,17,33,48.5%,22m
26642,3,天下,2106,393,14,10,24,58.3%,1h
26642,2,吃瘪扑街都是我,2106,404,12,20,32,37.5%,18m
26642,3,星云影,2106,323,11,17,28,39.3%,1h
26642,3,Aerthas,2106,329,11,20,31,35.5%,23m
26642,2,[西冰库冰室]奈斯大夫,2106,179,10,11,21,47.6%,51m
26642,3,BAIYING,2106,202,8,7,15,53.3%,22m
26642,3,sgu,2106,154,5,9,14,35.7%,54m
26642,2,周末,2106,188,4,9,13,30.8%,17m
26642,3,LiquidClem,2106,58,3,2,5,60.0%,10m
26642,3,刺客伍六一,2106,42,2,2,4,50.0%,1h
26642,2,我比你帅,2106,0,1,3,4,25.0%,1h
26642,3,仰望星空,2106,0,0,1,1,0.0%,1h
26642,3,星河新星,2106,0,0,1,1,0.0%,59m
26642,1,龙的传人,2106,0,0,1,1,0.0%,8m
26642,3,快来救我豪哥,2106,0,0,6,6,0.0%,1h
26663,1,风灵音,2105,780,25,38,63,39.7%,1h
26663,2,打怪了,2105,207,18,21,39,46.2%,6m
26663,3,生化新手,2105,362,14,12,26,53.8%,53m
26663,2,Blong,2105,77,8,11,19,42.1%,29m
26663,1,PaulArgery,2105,207,6,8,14,42.9%,27m
26663,1,[xyjxyc]芜铭,2105,193,6,12,18,33.3%,43m
26663,3,alkb,2105,133,3,1,4,75.0%,42m
26663,1,[镜花水月丶]阿塔尼斯,2105,142,3,2,5,60.0%,22m
26663,3,败亡嘻嘻,2105,30,2,0,2,100.0%,1h
26663,2,AmazingX,2105,44,2,7,9,22.2%,27m
26663,2,kevinHU,2105,0,1,0,1,100.0%,12m
26663,1,Mrsimpler,2105,0,1,1,2,50.0%,1h
26663,1,曾经来过,2105,46,1,4,5,20.0%,22m
26663,2,jehtro,2105,0,1,5,6,16.7%,1h
26663,2,路爸爸,2105,30,1,8,9,11.1%,1h
26663,2,[TSR]紫林枫,2105,0,0,2,2,0.0%,39m
26679,2,璧驷,2104,1330,116,136,252,46.0%,1h
26679,3,VFGHJNXSWERT,2104,290,10,14,24,41.7%,48m
26679,1,DANDAN,2104,263,10,21,31,32.3%,41m
26679,2,[欢迎萌新]饭饭纸杯,2104,129,2,3,5,40.0%,1h
26679,3,夜雨声人,2104,0,1,1,2,50.0%,1h
26679,3,唧唧复唧唧,2104,38,1,3,4,25.0%,59m
26679,2,小火,2104,44,1,4,5,20.0%,55m
26679,3,折花赋予谁,2104,30,1,6,7,14.3%,3m
26679,3,以你之姓冠我之名,2104,0,0,2,2,0.0%,1h
26679,3,逆之筱天子,2104,0,0,3,3,0.0%,1h
26679,3,君子求诸己,2104,0,0,5,5,0.0%,7m
26690,3,[少女的梦]小强,2103,1581,87,93,180,48.3%,8m
26690,2,三五八团楚云飞,2103,1284,46,51,97,47.4%,1h
26690,3,不和谐,2103,942,44,46,90,48.9%,25m
26690,3,达达里氏,2103,164,14,23,37,37.8%,1h
26690,2,股贴蕾丝,2103,260,9,21,30,30.0%,1h
26690,3,安纳金,2103,86,3,2,5,60.0%,1h
26690,3,炎龙皇子,2103,32,3,10,13,23.1%,1h
26690,2,星际游侠,2103,60,2,8,10,20.0%,1h
26690,3,欧米伽,2103,0,1,0,1,100.0%,1h
26690,2,狼牙兽表示不服,2103,0,0,1,1,0.0%,28m
26690,3,当夜晚拥有星星,2103,0,0,1,1,0.0%,14m
26690,3,[琴筝]sdfsadad,2103,0,0,3,3,0.0%,1h
26702,3,无名法老王,2102,804,40,41,81,49.4%,1h
26702,2,[慢手e族]啊浩你可以的,2102,534,31,31,62,50.0%,1h
26702,3,master,2102,601,28,28,56,50.0%,1h
26702,3,ZergTP,2102,314,20,12,32,62.5%,23m
26702,1,飞哥,2102,233,8,12,20,40.0%,9m
26702,2,遇输临疯,2102,118,6,7,13,46.2%,14m
26702,2,带不动你的瑶,2102,82,5,6,11,45.5%,1h
26702,3,[ZJCLXF]skyzjc,2102,30,2,1,3,66.7%,11m
26702,3,舜杀,2102,72,2,4,6,33.3%,17m
26702,3,邓紫棋,2102,18,2,5,7,28.6%,48m
26702,3,夜光临风,2102,0,1,0,1,100.0%,1h
26702,2,逍遥兔,2102,0,1,0,1,100.0%,1h
26702,3,qqxu,2102,0,0,1,1,0.0%,1h
26702,3,LierDog,2102,0,0,5,5,0.0%,1h
26716,2,wings,2101,1250,48,60,108,44.4%,1h
26716,3,大家好,2101,234,7,18,25,28.0%,9m
26716,3,[追猎成员]鱼之乐,2101,86,4,3,7,57.1%,1h
26716,3,lazycat,2101,0,0,2,2,0.0%,17m
26716,3,一朵相似的花,2101,0,0,4,4,0.0%,1h
26716,3,ddd,2101,0,0,5,5,0.0%,7m
26722,2,瞎打,2100,1153,79,79,158,50.0%,37m
26722,2,星呈,2100,677,70,71,141,49.6%,1h
26722,3,[暴雪三十一队]青春,2100,370,13,5,18,72.2%,25m
26722,2,最爱波音柒四柒,2100,263,8,12,20,40.0%,1h
26722,3,[清华大学战队]七九,2100,226,6,5,11,54.5%,54m
26722,3,豆子人,2100,116,6,15,21,28.6%,22m
26722,3,Dracula,2100,96,2,0,2,100.0%,1h
26722,3,明日之后,2100,36,2,0,2,100.0%,18m
26722,3,花空,2100,60,2,3,5,40.0%,8m
26722,3,一注,2100,30,1,2,3,33.3%,1h
26722,2,冷心心,2100,0,0,1,1,0.0%,12m
26722,2,[星际铁憨憨]克鲁鲁,2100,0,0,1,1,0.0%,1h
26722,2,yilingsama,2100,0,0,1,1,0.0%,27m
26735,2,[NSFK]TGYB,2099,1538,80,83,163,49.1%,20m
26735,3,壹贰,2099,659,29,29,58,50.0%,1h
26735,2,智宇芳,2099,182,6,9,15,40.0%,1h
26735,3,热情小白菜,2099,159,4,13,17,23.5%,1h
26735,3,[干就完啦]纵横,2099,92,3,4,7,42.9%,1h
26735,1,Mandrin,2099,120,3,9,12,25.0%,1h
26735,2,DEICIDE,2099,0,3,11,14,21.4%,24m
26735,2,[开心战队]白枫,2099,107,2,3,5,40.0%,1h
26735,1,近地联盟,2099,116,2,5,7,28.6%,12m
26735,2,二傻子,2099,114,2,8,10,20.0%,34m
26735,2,刘锦钰是超神,2099,0,0,1,1,0.0%,55m
26735,3,哀亩皮,2099,0,0,3,3,0.0%,1h
26747,2,萝莉赛高,2098,859,32,41,73,43.8%,1h
26747,3,彭城祝公子,2098,355,14,11,25,56.0%,1h
26747,3,战役,2098,287,13,24,37,35.1%,48m
26747,2,kalo,2098,175,8,5,13,61.5%,1h
26747,3,wbyxy,2098,227,8,13,21,38.1%,1h
26747,3,不想发光的太阳,2098,246,7,6,13,53.8%,9m
26747,1,火力全开,2098,0,4,5,9,44.4%,18m
26747,2,Temptation,2098,112,4,6,10,40.0%,1h
26747,2,莫才法行,2098,78,2,6,8,25.0%,17m
26747,3,大仔仔,2098,0,0,1,1,0.0%,1h
26747,3,菜的只能玩合作,2098,0,0,1,1,0.0%,1h
26747,1,平行世界,2098,0,0,2,2,0.0%,1h
26747,3,流浪的岁月,2098,0,0,3,3,0.0%,1h
26747,3,ysooys,2098,0,0,4,4,0.0%,11m
26747,3,宗业普,2098,0,0,5,5,0.0%,1h
26747,3,敛余生,2098,0,0,5,5,0.0%,24m
26763,1,[我太帅]xiaoyang,2097,961,62,68,130,47.7%,52m
26763,3,执行,2097,550,23,20,43,53.5%,25m
26763,3,战斗弱鸡,2097,207,7,1,8,87.5%,1h
26763,1,幻夜浮屠,2097,193,5,7,12,41.7%,39m
26763,3,隆美尔,2097,98,4,5,9,44.4%,1h
26763,3,SOo,2097,58,3,2,5,60.0%,29m
26763,3,医疗兵贩卖商人,2097,0,1,0,1,100.0%,1h
26763,3,丛林小子,2097,0,1,1,2,50.0%,1h
26763,3,大爱绘梨衣,2097,0,0,1,1,0.0%,1h
26763,3,嘀嘀叭叭呜呜,2097,0,0,1,1,0.0%,1h
26763,1,[萌新总队]打死你个小瓜皮,2097,0,0,2,2,0.0%,1h
26763,2,小疯子,2097,0,0,3,3,0.0%,27m
26775,3,TDrzu,2096,503,55,55,110,50.0%,1h
26775,3,伪闲人,2096,1033,53,49,102,52.0%,3m
26775,2,得意忘形,2096,1114,52,58,110,47.3%,1h
26775,2,creep,2096,634,27,27,54,50.0%,1h
26775,3,万年野万年人族,2096,294,12,11,23,52.2%,1h
26775,2,UZL,2096,182,8,6,14,57.1%,55m
26775,3,明月,2096,36,5,7,12,41.7%,1h
26775,2,无理的文,2096,38,3,5,8,37.5%,1h
26775,3,Liu,2096,119,2,2,4,50.0%,17m
26775,2,[神子]HaiWuLiang,2096,120,2,8,10,20.0%,18m
26775,3,nilion,2096,0,1,1,2,50.0%,1h
26775,2,小白龙,2096,89,1,7,8,12.5%,27m
26775,3,孙一楠,2096,0,0,4,4,0.0%,23m
26775,2,随风如雨,2096,0,0,12,12,0.0%,1h
26789,2,兹拜因巴哈,2095,633,100,115,215,46.5%,35m
26789,3,周数壬,2095,970,49,49,98,50.0%,1h
26789,2,风吹鸡儿一边倒,2095,554,18,27,45,40.0%,24m
26789,3,NOR,2095,230,8,6,14,57.1%,29m
26789,3,魔方网表,2095,168,6,5,11,54.5%,1h
26789,2,留下你的人,2095,95,4,4,8,50.0%,1h
26789,3,syd,2095,78,4,5,9,44.4%,18m
26789,2,ACE,2095,30,2,2,4,50.0%,13m
26789,2,老过,2095,128,2,3,5,40.0%,1h
26789,3,deepcry,2095,0,1,0,1,100.0%,1h
26789,3,渣男圣剑,2095,0,1,1,2,50.0%,1h
26789,2,[CNgril]曦清梦,2095,0,1,1,2,50.0%,12m
26789,3,[爱国]小小指挥官,2095,30,1,2,3,33.3%,1h
26802,1,山木兮,2094,1551,134,159,293,45.7%,1h
26802,2,juwairen,2094,1445,107,129,236,45.3%,20m
26802,2,买哈达,2094,1275,66,80,146,45.2%,35m
26802,2,TVzxg,2094,1480,55,60,115,47.8%,29m
26802,3,灯霸,2094,517,24,16,40,60.0%,1h
26802,3,扶妁,2094,527,23,18,41,56.1%,5m
26802,2,五组组长,2094,558,19,31,50,38.0%,27m
26802,3,[XXHZN3]遥远的桥,2094,395,15,8,23,65.2%,1h
26802,3,[大爱星际二]我是你也八,2094,202,7,8,15,46.7%,48m
26802,3,[DX战队]神经科主任凯瑞甘,2094,212,7,9,16,43.8%,11m
26802,3,棱镜,2094,38,6,3,9,66.7%,1h
26802,1,慕容苏水,2094,197,6,12,18,33.3%,24m
26802,1,锃亮大保健,2094,207,5,4,9,55.6%,27m
26802,1,samoger,2094,144,5,11,16,31.2%,1h
26802,1,Muzi,2094,92,4,11,15,26.7%,10m
26802,3,雷小生,2094,30,1,2,3,33.3%,1h
26802,2,AnyingLW,2094,0,1,6,7,14.3%,1h
26819,3,怎么赢,2093,1147,39,45,84,46.4%,11m
26819,2,Estel,2093,441,37,52,89,41.6%,1h
26819,3,[喜欢就是干]aaaa,2093,174,23,24,47,48.9%,1h
26819,3,Mrsuper,2093,310,10,7,17,58.8%,22m
26819,3,铁马冰河古人,2093,280,8,6,14,57.1%,17m
26819,1,yhf,2093,270,8,14,22,36.4%,1h
26819,2,scv,2093,187,5,3,8,62.5%,32m
26819,3,[琴筝]笛卡尔,2093,60,3,3,6,50.0%,1h
26819,2,男子单打型选手,2093,140,3,8,11,27.3%,42m
26819,2,micha,2093,106,2,3,5,40.0%,27m
26819,3,忍者不爱切水果,2093,0,1,5,6,16.7%,60m
26819,2,海音棠,2093,0,1,7,8,12.5%,28m
26819,3,金黄枫叶,2093,0,0,5,5,0.0%,1h
26832,1,[枪兵叉叉狗]壹拾叁,2092,1012,123,129,252,48.8%,50m
26832,3,人族战五渣,2092,215,14,5,19,73.7%,1h
26832,3,周杰伦,2092,394,14,22,36,38.9%,1h
26832,3,[极限菜鸟]无敌华哥,2092,421,13,14,27,48.1%,14m
26832,3,打扫一个屋,2092,322,11,18,29,37.9%,1h
26832,2,夏之风,2092,192,5,10,15,33.3%,1h
26832,3,lightning,2092,86,3,4,7,42.9%,29m
26832,3,lxw,2092,0,1,1,2,50.0%,17m
26832,3,[爱国]平平平波王,2092,0,1,1,2,50.0%,1h
26832,3,[旺旺战士]龖靁魈,2092,30,1,3,4,25.0%,1h
26832,3,phstudywell,2092,0,0,1,1,0.0%,1h
26832,3,不过三,2092,0,0,5,5,0.0%,1h
26844,2,sding,2091,1533,448,491,939,47.7%,1h
26844,2,是的我是王,2091,360,13,28,41,31.7%,18m
26844,3,[olg]Hunter,2091,177,12,10,22,54.5%,22m
26844,3,快乐君,2091,302,11,4,15,73.3%,23m
26844,2,童学习,2091,267,9,12,21,42.9%,1h
26844,2,[XXHZ32]脱非入欧,2091,225,7,9,16,43.8%,1h
26844,3,灵异的虫虫蛋,2091,86,3,2,5,60.0%,54m
26844,3,hahahaha,2091,68,2,3,5,40.0%,1h
26844,3,战闪新星,2091,0,1,0,1,100.0%,1h
26844,3,新星陨落,2091,0,1,0,1,100.0%,31m
26844,2,[星际爱好者队]功夫熊猫,2091,34,1,5,6,16.7%,32m
26844,2,都都战神,2091,0,0,2,2,0.0%,1h
26856,2,wenijp,2090,471,111,115,226,49.1%,6m
26856,1,QQD,2090,814,33,38,71,46.5%,1h
26856,1,樱岛麻衣,2090,319,13,26,39,33.3%,1h
26856,1,lwbnb,2090,362,11,13,24,45.8%,9m
26856,3,好哥哥辉,2090,320,10,14,24,41.7%,9m
26856,3,帕拉瑞尔,2090,257,9,11,20,45.0%,17m
26856,3,asme,2090,146,6,4,10,60.0%,23m
26856,3,shaotianxiao,2090,58,3,3,6,50.0%,1h
26856,2,[荣耀归于我主]JmFei,2090,92,3,4,7,42.9%,1h
26856,2,张贤,2090,46,2,5,7,28.6%,13m
26856,3,亦可玩世不恭,2090,32,1,1,2,50.0%,1h
26856,2,斯巴达,2090,0,0,3,3,0.0%,32m
26868,2,floatdream,2089,618,23,22,45,51.1%,1h
26868,3,新手刚玩,2089,0,4,1,5,80.0%,1h
26868,1,道可缘,2089,112,3,0,3,100.0%,17m
26868,3,月下喝奶茶,2089,118,3,4,7,42.9%,14m
26868,1,爱笑的王浩浩,2089,190,3,7,10,30.0%,46m
26868,2,niubi,2089,42,2,3,5,40.0%,13m
26868,1,混合科技,2089,0,2,9,11,18.2%,17m
26868,1,天灾,2089,0,1,0,1,100.0%,8m
26868,2,睿哥最吊猖,2089,30,1,8,9,11.1%,45m
26868,3,hszhn,2089,0,0,1,1,0.0%,1h
26868,3,秋沐苏,2089,0,0,5,5,0.0%,1h
26868,3,第三代得到,2089,0,0,6,6,0.0%,1h
26880,2,[LSH]追梦的猪肘子,2088,1265,175,186,361,48.5%,24m
26880,3,EmoXpX,2088,669,35,30,65,53.8%,11m
26880,3,LavaBear,2088,544,21,22,43,48.8%,11m
26880,3,[F2ANB]上杉绘梨衣,2088,371,18,10,28,64.3%,25m
26880,1,chn,2088,340,10,26,36,27.8%,1h
26880,3,Sword,2088,60,3,1,4,75.0%,11m
26880,3,[为星光而战]达芬奇奇怪怪,2088,0,2,5,7,28.6%,18m
26880,2,黑色咏叹,2088,0,1,1,2,50.0%,1h
26880,3,蘑菇云,2088,0,0,1,1,0.0%,60m
26880,3,使命召唤,2088,0,0,2,2,0.0%,17m
26890,1,葱葱古古啊,2087,1052,40,48,88,45.5%,1h
26890,3,风随,2087,572,22,16,38,57.9%,1h
26890,2,[星际爱好者队]气质小卷毛,2087,120,4,10,14,28.6%,42m
26890,3,sbk,2087,30,3,5,8,37.5%,1h
26890,3,匿名玩家,2087,0,1,0,1,100.0%,7m
26890,1,开门暗影卫队,2087,0,0,1,1,0.0%,24m
26890,3,修罗,2087,0,0,5,5,0.0%,60m
26897,1,魔法少女郭德纲,2086,501,47,52,99,47.5%,1h
26897,3,冰雨,2086,600,23,23,46,50.0%,46m
26897,3,[你嘤尼玛呢]二狗子,2086,440,17,17,34,50.0%,1h
26897,3,[你已经死啦]黄子钰,2086,425,14,30,44,31.8%,1h
26897,2,[上学威龙]帝国每月最佳劳工,2086,310,11,13,24,45.8%,20m
26897,3,[二蛋带你飞]独白,2086,272,10,11,21,47.6%,1h
26897,3,雷鬼圣战士,2086,264,9,9,18,50.0%,1h
26897,3,zero,2086,208,9,12,21,42.9%,1h
26897,3,[暴雪三十队]遥远的拂晓,2086,223,7,3,10,70.0%,1h
26897,3,嚟暝,2086,114,5,5,10,50.0%,1h
26897,3,GAMA,2086,94,4,2,6,66.7%,1h
26897,2,飞刀,2086,157,4,4,8,50.0%,56m
26897,3,不是你的宝贝,2086,58,3,7,10,30.0%,24m
26897,3,[RyH键谈坊]蛆虫型玩家,2086,64,2,5,7,28.6%,24m
26897,2,伊莉雅酱,2086,116,1,6,7,14.3%,14m
26897,1,Azathoth,2086,0,1,8,9,11.1%,1h
26897,3,古德里安,2086,0,0,1,1,0.0%,1h
26897,3,aiaiai,2086,0,0,2,2,0.0%,54m
26897,3,young,2086,0,0,2,2,0.0%,1h
26916,2,[幽灵闪现wo]饿饿饿,2085,1489,82,104,186,44.1%,52m
26916,2,Animation,2085,741,47,59,106,44.3%,6m
26916,3,兼职睡神,2085,691,23,24,47,48.9%,54m
26916,3,死亡魅魔夜魇,2085,377,14,10,24,58.3%,1h
26916,3,卡其,2085,290,11,14,25,44.0%,5m
26916,3,[迷宫丨极限组]十一,2085,234,7,3,10,70.0%,48m
26916,2,钢铁小馒头,2085,232,7,14,21,33.3%,1h
26916,3,年轻人耗子尾汁,2085,213,6,2,8,75.0%,5m
26916,2,龙霸,2085,38,4,4,8,50.0%,1h
26916,3,vGRAv,2085,0,3,7,10,30.0%,1h
26916,2,银狼王,2085,128,3,9,12,25.0%,1h
26916,3,帅气的钻石,2085,0,1,0,1,100.0%,1h
26916,2,[667]杨修远,2085,91,1,2,3,33.3%,1h
26916,3,suoli,2085,34,1,6,7,14.3%,1h
26916,3,Horizon,2085,0,0,1,1,0.0%,1h
26916,1,罡罡子,2085,0,0,2,2,0.0%,1h
26932,3,金刚大头娃,2084,1281,50,58,108,46.3%,32m
26932,2,GGNS,2084,1004,44,46,90,48.9%,1h
26932,3,akira,2084,354,26,33,59,44.1%,1h
26932,3,sha,2084,562,21,27,48,43.8%,1h
26932,3,奇葩文学,2084,498,18,26,44,40.9%,32m
26932,3,嗷嗷嗷嗷警告,2084,363,13,13,26,50.0%,1h
26932,3,ZonFon,2084,266,10,18,28,35.7%,1h
26932,2,忘川,2084,257,9,8,17,52.9%,1h
26932,1,[谐星很忙]AlieZ,2084,170,7,11,18,38.9%,10m
26932,1,hbhfn,2084,228,6,13,19,31.6%,27m
26932,1,ESOTOES,2084,167,4,11,15,26.7%,1h
26932,3,老杨,2084,118,3,6,9,33.3%,60m
26932,1,Forever,2084,0,3,9,12,25.0%,1h
26932,3,[爱之信仰]IAmQbaby,2084,30,2,0,2,100.0%,1h
26932,3,[半藏为你效命]我既是虫群意为人,2084,30,2,2,4,50.0%,43m
26932,3,何为悔恨,2084,70,2,3,5,40.0%,1h
26932,2,[sc谐盟]大脸猫,2084,60,2,9,11,18.2%,14m
26932,3,llllllllllll,2084,30,1,3,4,25.0%,25m
26932,3,正义,2084,38,1,5,6,16.7%,48m
26932,2,情何以堪,2084,30,1,6,7,14.3%,28m
26932,3,无尽虚空,2084,0,0,1,1,0.0%,23m
26932,2,肖克,2084,0,0,1,1,0.0%,40m
26932,3,我太菜了,2084,0,0,1,1,0.0%,1h
26955,2,寒烟丶忆,2083,1526,299,327,626,47.8%,27m
26955,2,你在教我做事啊,2083,276,10,8,18,55.6%,1h
26955,1,人畜无害的月奏弦,2083,254,8,8,16,50.0%,1h
26955,2,[LSGA]新参者,2083,152,6,11,17,35.3%,1h
26955,3,爱笑怎么了,2083,58,3,0,3,100.0%,3m
26955,3,隐士道人,2083,0,1,0,1,100.0%,1h
26955,3,无敌奥丁,2083,0,1,3,4,25.0%,38m
26955,2,七秒木乀,2083,0,0,3,3,0.0%,1h
26963,1,布鲁斯打几把凯西,2082,763,32,35,67,47.8%,1h
26963,1,[晋升者]艾尔没电了,2082,328,7,11,18,38.9%,1h
26963,2,日川太阳希,2082,42,4,6,10,40.0%,57m
26963,1,GooDream,2082,94,3,12,15,20.0%,1h
26963,3,和索尔同样丰满,2082,60,2,3,5,40.0%,22m
26963,3,blblbl,2082,48,2,5,7,28.6%,1h
26963,2,星夜,2082,0,1,0,1,100.0%,1h
26963,3,[EDR]佳果果,2082,30,1,7,8,12.5%,46m
26963,3,[Go416]繁星,2082,0,0,1,1,0.0%,1h
26963,3,火星奶茶不加糖,2082,0,0,1,1,0.0%,27m
26963,3,麒麟惗步伶苍生,2082,0,0,6,6,0.0%,1h
26974,2,[mfans]sjzbphl,2081,967,96,115,211,45.5%,14m
26974,3,獨狼舞步,2081,780,29,31,60,48.3%,1h
26974,1,胡蛋蛋,2081,809,29,45,74,39.2%,46m
26974,3,[幽灵闪现wo]影庭,2081,562,21,25,46,45.7%,1h
26974,3,[最菜战队]wsglu,2081,398,14,17,31,45.2%,1h
26974,1,电脑难度一一新手,2081,244,9,14,23,39.1%,1h
26974,3,我本善良,2081,221,8,2,10,80.0%,54m
26974,3,寂寞列车,2081,144,5,6,11,45.5%,9m
26974,3,[小河马无敌]战神,2081,0,1,0,1,100.0%,1h
26974,3,[梦缘香阁]维特,2081,0,1,0,1,100.0%,29m
26974,3,fff,2081,30,1,3,4,25.0%,9m
26974,3,逝冰阎,2081,0,0,2,2,0.0%,5m
26974,3,ZENGKX,2081,0,0,2,2,0.0%,29m
26974,2,WABAGAZI,2081,0,0,2,2,0.0%,1h
26974,3,八坂神奈子,2081,0,0,5,5,0.0%,1h
26989,1,[雾雨魔法森林]birdman,2080,1494,110,130,240,45.8%,1h
26989,2,浅笑北凉歌,2080,1100,42,52,94,44.7%,45m
26989,3,小屁屁,2080,669,24,35,59,40.7%,9m
26989,3,神来了,2080,436,19,23,42,45.2%,1h
26989,2,投降输一半,2080,400,13,22,35,37.1%,19m
26989,2,TheGhostTown,2080,277,11,19,30,36.7%,1h
26989,3,驼驼帅,2080,146,4,7,11,36.4%,57m
26989,3,HJZ,2080,0,1,2,3,33.3%,1h
26989,3,miku,2080,0,0,1,1,0.0%,23m
26989,3,我不是山的那边,2080,0,0,1,1,0.0%,60m
26989,3,托尼,2080,0,0,1,1,0.0%,1h
26989,3,霸者,2080,0,0,2,2,0.0%,53m
26989,3,HONE,2080,0,0,4,4,0.0%,1h
26989,3,[帝国萌新联盟]MCwuyue,2080,0,0,6,6,0.0%,1h
27003,2,SSEstonis,2079,1249,53,54,107,49.5%,1h
27003,2,[小鸡屠宰场a]阿磊,2079,658,24,25,49,49.0%,1h
27003,3,mingxu,2079,203,24,25,49,49.0%,1h
27003,1,变态,2079,696,23,36,59,39.0%,16m
27003,3,春夜喜雨,2079,336,11,14,25,44.0%,1h
27003,2,[QWQa]swquyhiyu,2079,122,7,13,20,35.0%,14m
27003,3,甜橙,2079,30,1,5,6,16.7%,1h
27003,3,周晗橙,2079,0,0,1,1,0.0%,1h
27003,3,KingJackyXu,2079,0,0,1,1,0.0%,60m
27003,3,鳏螟貉,2079,0,0,4,4,0.0%,1h
27013,2,宪哥,2078,909,86,110,196,43.9%,60m
27013,2,天使情人,2078,577,19,31,50,38.0%,1h
27013,2,阿飞飞和我,2078,264,9,8,17,52.9%,12m
27013,3,无名之铭,2078,237,9,17,26,34.6%,1h
27013,3,[山东省大声道]终级神魔,2078,192,7,8,15,46.7%,1h
27013,3,xnono,2078,143,4,6,10,40.0%,17m
27013,2,夏又末,2078,80,3,9,12,25.0%,54m
27013,3,OVliver,2078,36,2,0,2,100.0%,1h
27013,3,iiiiiiiiiiii,2078,30,2,4,6,33.3%,29m
27013,3,[琴筝]xiongjiyang,2078,0,1,0,1,100.0%,23m
27013,3,赵宁,2078,0,0,5,5,0.0%,5m
27024,1,诺基亚,2077,1595,260,281,541,48.1%,23m
27024,3,星际神之神,2077,632,22,22,44,50.0%,1h
27024,3,奔驰,2077,443,16,18,34,47.1%,1h
27024,3,天空之城,2077,146,4,5,9,44.4%,5m
27024,3,ChongYue,2077,30,3,11,14,21.4%,27m
27024,3,[DMRe]圣龙小小龙,2077,0,1,0,1,100.0%,1h
27024,3,DASHENLAILA,2077,0,1,2,3,33.3%,1h
27024,3,JUN,2077,0,0,2,2,0.0%,10m
27024,2,叶寒,2077,0,0,3,3,0.0%,27m
27033,3,新人求虐待,2076,556,22,28,50,44.0%,1h
27033,3,劈叉舰长,2076,514,20,20,40,50.0%,17m
27033,3,连三月,2076,473,16,14,30,53.3%,57m
27033,3,skywalker,2076,456,15,23,38,39.5%,54m
27033,2,亚纪一烟,2076,426,14,23,37,37.8%,1h
27033,3,HauntGhost,2076,206,9,9,18,50.0%,57m
27033,3,羁旅猎刃,2076,215,6,4,10,60.0%,1h
27033,1,老海盗,2076,0,3,5,8,37.5%,59m
27033,1,dfwaf,2076,167,3,7,10,30.0%,8m
27033,3,十三个人,2076,0,1,1,2,50.0%,1h
27033,3,wdjmx,2076,0,0,1,1,0.0%,17m
27033,3,死亡之翼,2076,0,0,3,3,0.0%,48m
27033,3,[后新星]SNlolitahby,2076,0,0,5,5,0.0%,1h
27033,3,幸福的五花肉,2076,0,0,5,5,0.0%,7m
27047,3,仰天笑,2075,868,31,43,74,41.9%,1h
27047,1,没有瞎猫,2075,264,11,12,23,47.8%,10m
27047,3,Mercy,2075,214,8,14,22,36.4%,38m
27047,2,Regression,2075,202,5,7,12,41.7%,28m
27047,2,[TD不会玩]十文字,2075,93,5,9,14,35.7%,1h
27047,2,帅帅的硕硕,2075,158,5,10,15,33.3%,1h
27047,3,[琴筝]虫妖亚里莎,2075,122,4,9,13,30.8%,1h
27047,1,IIIIIIIIIII,2075,136,4,11,15,26.7%,1h
27047,2,WMAA,2075,0,1,1,2,50.0%,1h
27047,1,camille,2075,0,1,1,2,50.0%,58m
27047,3,[谐星联盟c]星云战争,2075,30,1,2,3,33.3%,1h
27047,1,东风快递,2075,96,1,3,4,25.0%,1h
27047,2,尼可莱,2075,0,1,7,8,12.5%,1h
27047,2,[猫神]嘿嘿你猜,2075,42,1,8,9,11.1%,55m
27047,2,李丁平,2075,0,0,1,1,0.0%,1h
27047,3,虎牙奶兔,2075,0,0,1,1,0.0%,19m
27063,2,甩一坨便便,2074,1251,315,377,692,45.5%,5m
27063,3,tank,2074,1274,47,59,106,44.3%,1h
27063,3,西酒,2074,603,24,22,46,52.2%,1h
27063,1,莎拉凯瑞甘,2074,186,6,8,14,42.9%,1h
27063,2,Rhapsody,2074,108,3,2,5,60.0%,57m
27063,3,Angelll,2074,30,2,0,2,100.0%,1h
27063,3,Cartian,2074,0,1,0,1,100.0%,27m
27063,2,shixixi,2074,0,1,8,9,11.1%,34m
27063,3,宙墨元黑山,2074,0,0,2,2,0.0%,1h
27072,3,[DBC]RouyToery,2073,872,35,43,78,44.9%,54m
27072,3,飞驰的熊猫,2073,300,11,8,19,57.9%,1h
27072,2,正在加载,2073,298,11,11,22,50.0%,5m
27072,3,毛毛是条狗,2073,181,5,14,19,26.3%,1h
27072,3,文德嗣,2073,143,4,0,4,100.0%,32m
27072,3,hermit,2073,58,3,3,6,50.0%,9m
27072,3,eee,2073,60,3,4,7,42.9%,54m
27072,1,goodluck,2073,108,2,6,8,25.0%,23m
27072,2,苏大爷,2073,133,2,8,10,20.0%,17m
27072,1,冰霜之森,2073,41,2,9,11,18.2%,1h
27072,2,Cuctuz,2073,0,1,2,3,33.3%,40m
27072,3,白衣渡江,2073,0,1,4,5,20.0%,1h
27072,3,瑞半神,2073,0,0,1,1,0.0%,54m
27085,2,金帛攻城狮,2072,1562,96,116,212,45.3%,35m
27085,3,赵日天,2072,683,42,46,88,47.7%,1h
27085,3,CAY,2072,367,13,12,25,52.0%,1h
27085,3,溜溜球,2072,359,12,10,22,54.5%,1h
27085,2,易鉨,2072,207,8,10,18,44.4%,1h
27085,3,SOS,2072,36,2,0,2,100.0%,60m
27085,3,紫杉,2072,30,2,2,4,50.0%,46m
27085,3,[糸色]BUTER,2072,30,1,1,2,50.0%,54m
27085,2,[生物即是正义]别给我机会,2072,40,1,2,3,33.3%,1h
27085,2,鸽式战斗姬,2072,0,0,1,1,0.0%,1h
27085,2,跃进,2072,0,0,1,1,0.0%,1h
27085,3,亦白,2072,0,0,1,1,0.0%,19m
27085,2,ZHOU,2072,0,0,3,3,0.0%,1h
27098,3,哥哥是神,2071,840,30,35,65,46.2%,1h
27098,1,Felix,2071,223,6,13,19,31.6%,1h
27098,3,无敌也能跟着,2071,114,4,5,9,44.4%,1h
27098,1,[我们是弟弟]开胃小菜,2071,97,2,2,4,50.0%,16m
27098,3,诗书礼易春秋,2071,68,2,4,6,33.3%,25m
27098,3,kan,2071,60,2,6,8,25.0%,17m
27098,1,gcb,2071,97,2,8,10,20.0%,27m
27098,3,大对门,2071,0,1,1,2,50.0%,5m
27098,3,LJZloveAVRIL,2071,0,1,2,3,33.3%,1h
27098,3,派大星,2071,0,0,1,1,0.0%,57m
27098,3,铃仙铃仙铃仙,2071,0,0,1,1,0.0%,60m
27098,2,无敌阿衡,2071,0,0,5,5,0.0%,17m
27098,3,万里长城,2071,0,0,5,5,0.0%,7m
27111,3,[谁在呼叫舰队]大和炮正在干蠢狼,2070,1548,71,79,150,47.3%,10m
27111,3,Knights,2070,447,15,27,42,35.7%,1h
27111,3,丁妮格菲儿,2070,229,10,10,20,50.0%,11m
27111,2,北魏孝文帝汉化组,2070,215,8,21,29,27.6%,1h
27111,3,阿修,2070,60,3,2,5,60.0%,29m
27111,3,CATERAN,2070,58,2,3,5,40.0%,1h
27111,3,apple,2070,58,2,4,6,33.3%,43m
27111,3,仙人板板,2070,0,1,0,1,100.0%,1h
27111,3,木与风之诗,2070,0,1,2,3,33.3%,1h
27111,3,花花啊,2070,0,1,5,6,16.7%,54m
27111,3,碳酰土豆,2070,0,0,3,3,0.0%,1h
27122,2,ufo,2069,863,188,201,389,48.3%,1h
27122,1,erbors,2069,1555,77,99,176,43.8%,1h
27122,1,我来了,2069,694,24,37,61,39.3%,25m
27122,3,善茬,2069,362,15,13,28,53.6%,1h
27122,3,东海大大,2069,300,11,12,23,47.8%,1h
27122,2,花花村乄村长,2069,247,6,6,12,50.0%,27m
27122,3,masterwade,2069,120,3,0,3,100.0%,5m
27122,3,TANXIAOKE,2069,62,3,2,5,60.0%,60m
27122,3,[DARKS]DarK,2069,62,2,6,8,25.0%,54m
27122,3,benV,2069,0,1,0,1,100.0%,1h
27122,3,ocean,2069,30,1,2,3,33.3%,25m
27122,3,净化大师,2069,30,1,2,3,33.3%,1h
27122,3,ZHANGYULU,2069,30,1,2,3,33.3%,46m
27122,3,灰太狼,2069,0,0,2,2,0.0%,24m
27122,3,史大仙,2069,0,0,3,3,0.0%,1h
27122,3,同往独归,2069,0,0,5,5,0.0%,1h
27138,3,横扫千军,2068,1533,158,183,341,46.3%,1h
27138,3,[万神归一]耶稣与玛丽锁,2068,742,28,23,51,54.9%,1h
27138,3,博物馆,2068,624,21,24,45,46.7%,1h
27138,3,黄金裤衩,2068,471,17,27,44,38.6%,1h
27138,3,Rorka,2068,415,16,17,33,48.5%,1h
27138,3,Moment,2068,364,14,18,32,43.8%,1h
27138,3,南京小马哥,2068,293,9,12,21,42.9%,1h
27138,2,[争霸天下]泠泠,2068,178,8,19,27,29.6%,51m
27138,3,云书雾廖,2068,240,7,8,15,46.7%,1h
27138,3,[萌新都是大佬]kilodear,2068,166,4,4,8,50.0%,32m
27138,3,TOTORO,2068,30,2,1,3,66.7%,1h
27138,3,此生必睡蔡萝莉,2068,30,2,3,5,40.0%,1h
27138,1,awl,2068,97,2,9,11,18.2%,1h
27138,1,自由之子,2068,0,0,1,1,0.0%,1h
27138,2,独龙,2068,0,0,2,2,0.0%,57m
27138,3,auroral,2068,0,0,3,3,0.0%,1h
27154,3,terrenking,2067,834,30,34,64,46.9%,1h
27154,3,神仙,2067,890,29,37,66,43.9%,1h
27154,3,紫竹琳,2067,782,26,41,67,38.8%,29m
27154,3,[XXHZN3]夜雨离殇,2067,396,16,11,27,59.3%,1h
27154,3,kaixinjiuhao,2067,440,15,21,36,41.7%,43m
27154,2,[峰吹起了过去]星际启示者,2067,185,6,6,12,50.0%,18m
27154,3,黎莫,2067,166,6,9,15,40.0%,1h
27154,1,kaka,2067,58,6,18,24,25.0%,10m
27154,1,龙的传人,2067,167,4,11,15,26.7%,13m
27154,1,[荒芜岁月]aks,2067,119,2,2,4,50.0%,46m
27154,3,草帽路飞,2067,60,2,2,4,50.0%,53m
27154,2,[世界最终戦论]我打的就是你,2067,78,2,3,5,40.0%,1h
27154,2,蓝色火焰,2067,116,2,8,10,20.0%,17m
27154,3,耶格尔,2067,0,1,0,1,100.0%,1h
27154,3,[混吃混喝]lhsLHS,2067,30,1,1,2,50.0%,17m
27154,3,堂堂,2067,0,1,3,4,25.0%,1h
27154,2,Yehutan,2067,0,1,6,7,14.3%,1h
27154,2,魔法海螺,2067,0,1,6,7,14.3%,57m
27154,3,玫瑰之宽恕,2067,0,0,1,1,0.0%,1h
27154,3,一哭二闹三上优亚,2067,0,0,1,1,0.0%,1h
27174,3,你可认识我是谁,2066,296,10,20,30,33.3%,48m
27174,2,Hou,2066,270,10,22,32,31.2%,1h
27174,2,Kotomi,2066,218,7,9,16,43.8%,1h
27174,3,rachel,2066,154,6,7,13,46.2%,1h
27174,1,[QwQYo]这个有点难,2066,142,3,10,13,23.1%,1h
27174,3,Gavin,2066,72,2,8,10,20.0%,53m
27174,1,我曾触碰星辰,2066,86,2,8,10,20.0%,1h
27174,2,[晋升者]llllllllllll,2066,0,1,0,1,100.0%,1h
27174,3,开始进行折磨,2066,0,1,1,2,50.0%,1h
27174,2,拆迁队,2066,0,0,3,3,0.0%,55m
27174,3,Rtsalden,2066,0,0,5,5,0.0%,53m
27185,1,袁团长,2065,1537,236,247,483,48.9%,4m
27185,3,made,2065,464,18,17,35,51.4%,1h
27185,3,[美少女萬華鏡]软泥熊,2065,223,7,11,18,38.9%,32m
27185,2,[哔翻天梯鸡]一叶障目,2065,260,7,14,21,33.3%,1h
27185,3,kevin,2065,138,5,2,7,71.4%,1h
27185,3,Seven,2065,140,5,6,11,45.5%,1h
27185,1,依雨念桐,2065,228,5,13,18,27.8%,1h
27185,3,[爱衣酱大胜利]Acgzc,2065,30,2,2,4,50.0%,1h
27185,3,海淀孙一峰,2065,0,2,3,5,40.0%,1h
27185,3,筱杰,2065,0,1,5,6,16.7%,1h
27185,3,汤圆,2065,32,1,5,6,16.7%,53m
27185,2,许小陌,2065,0,1,8,9,11.1%,1h
27185,3,艾尔沦陷研究者,2065,0,0,1,1,0.0%,1h
27185,3,haha,2065,0,0,5,5,0.0%,1h
27185,3,西班火腿黄金舰队,2065,0,0,5,5,0.0%,54m
27185,3,qwer,2065,0,0,5,5,0.0%,7m
27185,3,星际母虫,2065,0,0,5,5,0.0%,1h
27202,3,LPDAL,2064,813,34,25,59,57.6%,43m
27202,3,嘿嘿嘿,2064,582,23,21,44,52.3%,1h
27202,3,lijiang,2064,597,21,28,49,42.9%,1h
27202,3,XIAOXIONG,2064,347,17,27,44,38.6%,10m
27202,1,请叫我元王爷,2064,413,11,26,37,29.7%,8m
27202,3,啊这,2064,288,10,11,21,47.6%,38m
27202,3,游戏菜聊,2064,172,8,12,20,40.0%,11m
27202,3,MVP,2064,247,7,9,16,43.8%,1h
27202,3,habbby,2064,166,5,3,8,62.5%,1h
27202,3,风暴战神,2064,77,4,5,9,44.4%,11m
27202,2,哈诺,2064,139,3,11,14,21.4%,1h
27202,3,DJS,2064,58,2,5,7,28.6%,54m
27202,3,[CPT]绝望亚伦,2064,0,1,2,3,33.3%,1h
27202,3,宗师之鹰,2064,0,0,3,3,0.0%,1h
27202,3,八重桜,2064,0,0,5,5,0.0%,1h
27202,3,庆历七年,2064,0,0,5,5,0.0%,53m
27218,3,金环蛇,2063,1496,54,61,115,47.0%,1h
27218,2,爱玥团总,2063,887,41,40,81,50.6%,17m
27218,3,[凯成]WXG,2063,336,12,13,25,48.0%,1h
27218,1,huza,2063,238,7,14,21,33.3%,1h
27218,3,sOs,2063,118,5,6,11,45.5%,1h
27218,3,kitory,2063,0,4,6,10,40.0%,1h
27218,2,[极限菜鸟]雪豹周卫国,2063,84,3,8,11,27.3%,34m
27218,3,tgtgg,2063,0,1,5,6,16.7%,38m
27218,3,小学生,2063,0,0,5,5,0.0%,19m
27227,3,saber,2062,455,25,25,50,50.0%,57m
27227,2,hfgfdgdfh,2062,338,16,20,36,44.4%,1h
27227,3,linken,2062,337,13,11,24,54.2%,1h
27227,3,温柔似星水,2062,263,9,18,27,33.3%,1h
27227,3,烟泉,2062,147,4,2,6,66.7%,1h
27227,3,明璐式推进,2062,0,1,0,1,100.0%,1h
27227,3,Rex,2062,30,1,2,3,33.3%,17m
27227,3,天夜言,2062,44,1,2,3,33.3%,53m
27227,3,KevinLau,2062,0,1,4,5,20.0%,54m
27227,2,急什么,2062,94,1,7,8,12.5%,27m
27227,2,HAPPY,2062,0,0,1,1,0.0%,1h
27227,3,[追猎人]hhxj,2062,0,0,2,2,0.0%,9m
27239,1,skylueise,2061,1433,94,122,216,43.5%,11m
27239,3,类马儿,2061,439,16,20,36,44.4%,1h
27239,2,雪地,2061,167,6,7,13,46.2%,27m
27239,3,djsgh,2061,34,2,2,4,50.0%,60m
27239,2,陈律,2061,46,2,9,11,18.2%,1h
27239,3,灰常神奇,2061,97,1,6,7,14.3%,10m
27239,2,好人卡,2061,0,1,7,8,12.5%,32m
27239,2,拉铆螺母,2061,0,0,1,1,0.0%,27m
27239,2,svavdrg,2061,0,0,3,3,0.0%,32m
27239,3,zzh,2061,0,0,3,3,0.0%,1h
27249,3,随缘,2060,1474,60,73,133,45.1%,1h
27249,2,kilroy,2060,797,28,36,64,43.8%,1h
27249,3,千两狂死郎,2060,647,22,30,52,42.3%,1h
27249,3,我才不是萌新呢,2060,403,20,14,34,58.8%,1h
27249,3,Chris,2060,380,16,18,34,47.1%,1h
27249,2,[打造东软一流]mohoo,2060,452,16,22,38,42.1%,35m
27249,1,爱吃鱼的人,2060,208,5,9,14,35.7%,1h
27249,3,淡定的小萝卜,2060,32,2,5,7,28.6%,38m
27249,1,dragonzhe,2060,0,1,0,1,100.0%,16m
27249,3,[lajiji]actionstart,2060,30,1,2,3,33.3%,29m
27249,2,北慕,2060,0,1,2,3,33.3%,1h
27249,2,谜语人,2060,0,1,8,9,11.1%,1h
27249,2,夜刃,2060,0,0,1,1,0.0%,1h
27249,3,Vertigo,2060,0,0,5,5,0.0%,7m
27263,2,AZTZA,2059,1040,82,96,178,46.1%,1h
27263,1,治愈丶晨曦之光,2059,1494,64,84,148,43.2%,13m
27263,3,落叶一随风,2059,600,21,24,45,46.7%,1h
27263,3,[以君之名]zhoushijie,2059,264,10,10,20,50.0%,1h
27263,3,景三,2059,156,6,9,15,40.0%,1h
27263,1,安东尼大木,2059,246,6,15,21,28.6%,13m
27263,3,wlskflk,2059,188,5,3,8,62.5%,1h
27263,3,[like12]BLCK,2059,179,4,3,7,57.1%,1h
27263,2,six,2059,40,2,1,3,66.7%,1h
27263,1,anshi,2059,92,2,4,6,33.3%,17m
27263,2,沉默之剑,2059,44,2,8,10,20.0%,32m
27263,3,bitflying,2059,32,1,5,6,16.7%,1h
27263,2,一将功成万骨枯,2059,0,1,7,8,12.5%,1h
27263,3,承成,2059,0,0,1,1,0.0%,7m
27263,3,[社交学教官]biubiubiu,2059,0,0,2,2,0.0%,11m
27278,1,[暴雪二十六队]六哲兄,2058,1563,117,142,259,45.2%,1h
27278,2,红色文化,2058,1031,103,116,219,47.0%,1h
27278,3,dassd,2058,859,35,56,91,38.5%,1h
27278,3,StarBob,2058,486,28,35,63,44.4%,1h
27278,3,基洛夫报道,2058,215,7,6,13,53.8%,10m
27278,1,大干蒸,2058,232,5,12,17,29.4%,39m
27278,3,Antediluvian,2058,171,4,3,7,57.1%,1h
27278,3,一切不羁,2058,137,3,1,4,75.0%,23m
27278,2,xinmu,2058,113,2,3,5,40.0%,1h
27278,3,衣带沾花,2058,0,2,3,5,40.0%,5m
27278,3,[是我赢了]逐秋,2058,0,1,0,1,100.0%,1h
27278,3,LUWOZAI,2058,0,1,0,1,100.0%,48m
27278,3,徐大壮爱扫雷,2058,30,1,1,2,50.0%,1h
27278,2,鬼泣,2058,48,1,6,7,14.3%,13m
27278,2,盛先生,2058,0,0,6,6,0.0%,1h
27278,3,深圳市便利店联盟,2058,0,0,6,6,0.0%,1h
27294,2,IIIIIIIIIIII,2057,1479,120,119,239,50.2%,1h
27294,2,愤怒的小老虎,2057,805,39,47,86,45.3%,42m
27294,3,ZAKAQ,2057,459,15,22,37,40.5%,1h
27294,2,[纸君印刷厂]阿圣,2057,376,13,23,36,36.1%,1h
27294,3,[鲁德欢]梁凉,2057,349,12,11,23,52.2%,29m
27294,2,三角函数,2057,108,2,3,5,40.0%,1h
27294,2,班班班,2057,64,2,12,14,14.3%,1h
27294,3,小浩,2057,96,1,1,2,50.0%,1h
27294,2,stormfire,2057,42,1,6,7,14.3%,56m
27294,3,我爱梅老板,2057,0,0,1,1,0.0%,38m
27304,3,少年清秀执笔携香,2056,597,25,33,58,43.1%,5m
27304,3,[Micer]Daguanren,2056,401,17,12,29,58.6%,46m
27304,3,[Rhusky]李富贵,2056,388,16,16,32,50.0%,1h
27304,2,冬游花走,2056,241,6,12,18,33.3%,57m
27304,2,卢本伟,2056,256,6,13,19,31.6%,54m
27304,3,种花达瓦里希,2056,30,2,2,4,50.0%,9m
27304,3,蒋志伟杰尔玛,2056,0,1,0,1,100.0%,53m
27304,3,FOX,2056,0,0,2,2,0.0%,1h
27304,2,咖喱给给,2056,0,0,2,2,0.0%,1h
27304,3,赫小赫,2056,0,0,6,6,0.0%,1h
27314,3,Orion,2055,583,50,55,105,47.6%,1h
27314,1,以理服人,2055,1340,45,62,107,42.1%,26m
27314,3,地霸,2055,427,19,20,39,48.7%,1h
27314,3,八级大狂风,2055,371,16,24,40,40.0%,57m
27314,3,[暴雪养鸡场]Hsc,2055,364,14,16,30,46.7%,25m
27314,3,lewis,2055,182,8,18,26,30.8%,1h
27314,3,[暴雪二十八队]快播伴我入眠,2055,197,6,4,10,60.0%,10m
27314,3,Auotman,2055,174,5,5,10,50.0%,15m
27314,1,卢兹塔维尔,2055,175,5,14,19,26.3%,39m
27314,2,吴佳睿,2055,170,4,5,9,44.4%,1h
27314,2,sdflmoijg,2055,48,4,8,12,33.3%,1h
27314,3,好好的你,2055,118,3,1,4,75.0%,38m
27314,3,[GoTG]墮落迗使,2055,64,3,2,5,60.0%,53m
27314,3,PonyG,2055,0,3,2,5,60.0%,1h
27314,1,SaveME,2055,96,2,8,10,20.0%,1h
27314,3,来去自如,2055,0,1,0,1,100.0%,17m
27314,3,空游离殇,2055,0,1,0,1,100.0%,1h
27314,3,浪白,2055,42,1,7,8,12.5%,1h
27314,3,不造防空死全家,2055,0,0,1,1,0.0%,1h
27314,3,[QWQa]齐栋的爸爸,2055,0,0,1,1,0.0%,53m
27314,3,linglinabc,2055,0,0,1,1,0.0%,1h
27335,2,ALEX,2054,1527,161,185,346,46.5%,17m
27335,2,王宝贵,2054,814,59,63,122,48.4%,1h
27335,3,[LOHs]daniel,2054,330,13,17,30,43.3%,1h
27335,3,暗域,2054,350,13,19,32,40.6%,1h
27335,3,[镜花水月]无所限制,2054,299,10,16,26,38.5%,32m
27335,2,惊扰晨曦,2054,193,6,5,11,54.5%,56m
27335,3,ivan,2054,98,6,6,12,50.0%,1h
27335,1,庸人自吻,2054,155,5,1,6,83.3%,51m
27335,3,cyknowknow,2054,86,4,6,10,40.0%,57m
27335,3,VENNLIZST,2054,102,3,5,8,37.5%,1h
27335,2,小菜鸡,2054,120,3,7,10,30.0%,32m
27335,3,翻滚的仓鼠菌,2054,30,2,3,5,40.0%,10m
27335,2,莫言,2054,46,2,7,9,22.2%,57m
27335,1,风清鞅,2054,48,2,9,11,18.2%,22m
27335,3,布施明,2054,0,1,1,2,50.0%,9m
27335,3,一头猪在飞,2054,30,1,4,5,20.0%,1h
27335,3,谈谈,2054,0,0,1,1,0.0%,1h
27335,3,RYcooper,2054,0,0,5,5,0.0%,1h
27353,3,玉面飞龙,2053,491,18,14,32,56.2%,1h
27353,3,最佳损友,2053,339,14,6,20,70.0%,1h
27353,3,zxtian,2053,422,14,21,35,40.0%,17m
27353,2,十八禁,2053,293,8,13,21,38.1%,13m
27353,3,独立者号,2053,228,7,10,17,41.2%,1h
27353,1,ABC,2053,90,4,10,14,28.6%,12m
27353,3,猩猩爵士,2053,0,0,1,1,0.0%,1h
27353,3,花生糖,2053,0,0,6,6,0.0%,1h
27361,3,[基金会]可爱的小轩轩,2052,1562,224,238,462,48.5%,31m
27361,2,违反,2052,715,58,66,124,46.8%,1h
27361,3,战巡男孩,2052,229,10,9,19,52.6%,53m
27361,3,Sueter,2052,267,10,12,22,45.5%,1h
27361,2,红星,2052,256,5,13,18,27.8%,13m
27361,3,whiteking,2052,143,4,2,6,66.7%,1h
27361,2,疯狂的机顶盒,2052,163,4,9,13,30.8%,14m
27361,3,旅舟,2052,19,3,7,10,30.0%,1h
27361,1,MurphyGatsby,2052,62,3,15,18,16.7%,1h
27361,3,夏目大人,2052,96,2,0,2,100.0%,1h
27361,3,plaboy,2052,32,2,4,6,33.3%,1h
27361,2,尘辉,2052,0,1,0,1,100.0%,1h
27361,3,孙锐动画师,2052,0,1,2,3,33.3%,29m
27361,3,Arios,2052,0,1,3,4,25.0%,1h
27361,1,你比书好看,2052,96,1,4,5,20.0%,13m
27361,3,上线发呆,2052,0,0,1,1,0.0%,1h
27361,3,CYH,2052,0,0,2,2,0.0%,17m
27361,3,蓝书签,2052,0,0,2,2,0.0%,1h
27361,1,[花开彼岸天]Force,2052,0,0,5,5,0.0%,24m
27380,2,太阳,2051,1353,276,359,635,43.5%,1h
27380,3,cyz,2051,790,49,52,101,48.5%,54m
27380,3,[无魂之鸭]浮生六梦,2051,134,20,20,40,50.0%,1h
27380,3,小西瓜,2051,509,19,19,38,50.0%,29m
27380,3,武侯,2051,399,12,21,33,36.4%,22m
27380,3,shengli,2051,296,11,15,26,42.3%,23m
27380,3,猥琐达人,2051,306,10,4,14,71.4%,1h
27380,2,luo,2051,274,10,13,23,43.5%,35m
27380,2,引领星际,2051,213,7,6,13,53.8%,1h
27380,2,肖明,2051,44,2,8,10,20.0%,1h
27380,1,星子,2051,0,1,2,3,33.3%,1h
27380,3,大少,2051,0,1,4,5,20.0%,1h
27380,3,大白班长,2051,0,0,1,1,0.0%,24m
27380,3,amberkoon,2051,0,0,1,1,0.0%,1h
27394,3,眞露,2050,915,30,41,71,42.3%,1h
27394,3,演员,2050,576,24,24,48,50.0%,54m
27394,3,Center,2050,489,18,25,43,41.9%,1h
27394,1,哈雷克火葬之魔咒,2050,102,17,32,49,34.7%,1h
27394,3,倾酒笑苍天,2050,425,14,16,30,46.7%,1h
27394,3,悠悠,2050,243,9,18,27,33.3%,12m
27394,3,顾郢,2050,144,5,2,7,71.4%,1h
27394,1,opooopooo,2050,145,4,5,9,44.4%,13m
27394,2,芜湖航班,2050,90,2,1,3,66.7%,54m
27394,3,大本钟,2050,0,2,3,5,40.0%,24m
27394,3,[世界树]优衣对不起,2050,58,2,4,6,33.3%,25m
27394,3,地球星,2050,0,2,10,12,16.7%,1h
27394,3,HSHC,2050,0,1,1,2,50.0%,1h
27394,3,尖子山伯爵,2050,0,0,5,5,0.0%,1h
27408,3,[XXHZ37]都是弟弟,2049,1053,41,60,101,40.6%,9m
27408,2,我的天啊,2049,951,37,40,77,48.1%,1h
27408,1,shyan,2049,268,11,12,23,47.8%,39m
27408,3,妈个鸡泰伦,2049,292,9,19,28,32.1%,9m
27408,3,阿鹤,2049,139,7,8,15,46.7%,9m
27408,2,不羡仙,2049,217,7,12,19,36.8%,11m
27408,3,求奶我事业不顺,2049,183,6,15,21,28.6%,1h
27408,3,奈落,2049,46,1,4,5,20.0%,1h
27408,3,naqing,2049,0,0,1,1,0.0%,1h
27417,2,recluseschol,2048,1593,141,158,299,47.2%,24m
27417,3,相关部门,2048,967,41,49,90,45.6%,38m
27417,3,无畏冲锋,2048,984,37,39,76,48.7%,17m
27417,3,狗仙甜蜜酱,2048,699,29,27,56,51.8%,1h
27417,3,五月花,2048,468,20,22,42,47.6%,5m
27417,1,Marsc,2048,295,10,17,27,37.0%,18m
27417,3,[极限菜鸟]JAC,2048,233,8,9,17,47.1%,9m
27417,3,老电报员,2048,249,7,10,17,41.2%,48m
27417,2,寻梦到底,2048,30,2,2,4,50.0%,1h
27417,1,黑色星期天,2048,94,1,2,3,33.3%,8m
27417,3,NANANAN,2048,30,1,3,4,25.0%,10m
27417,3,[生气了吗]随心,2048,0,0,1,1,0.0%,60m
27429,2,军傲,2047,759,38,47,85,44.7%,14m
27429,3,[西伯利亚土豆]kindshen,2047,269,9,8,17,52.9%,48m
27429,3,夜晓鸿雁,2047,227,7,6,13,53.8%,1h
27429,3,lazycelika,2047,202,6,6,12,50.0%,1h
27429,3,[琴筝]骚哥,2047,96,4,1,5,80.0%,1h
27429,3,bszw,2047,0,1,0,1,100.0%,5m
27429,1,[酒池肉林]开心撒旦,2047,0,1,2,3,33.3%,17m
27429,3,nmsl,2047,0,1,5,6,16.7%,53m
27429,3,[GCL]九汐,2047,0,0,1,1,0.0%,1h
27429,3,龙之枪骑兵,2047,0,0,1,1,0.0%,24m
27439,2,[达拉姆督察]Juggernaut,2046,726,25,30,55,45.5%,20m
27439,3,星翰灿烂,2046,347,21,15,36,58.3%,25m
27439,3,lzr,2046,236,7,11,18,38.9%,29m
27439,1,FAUST,2046,166,4,9,13,30.8%,1h
27439,2,冷千秋,2046,0,2,6,8,25.0%,56m
27439,2,IIIIIIIIIII,2046,58,2,32,34,5.9%,1h
27439,3,TIANHR,2046,0,1,2,3,33.3%,57m
27439,2,Nova,2046,92,1,7,8,12.5%,57m
27439,3,夜取风狼,2046,0,0,1,1,0.0%,1h
27439,3,Gangster,2046,0,0,1,1,0.0%,1h
27439,3,[游戏风云OL]sdfasda,2046,0,0,1,1,0.0%,1h
27439,3,星辰大海,2046,0,0,2,2,0.0%,1h
27439,2,三宝殿,2046,0,0,3,3,0.0%,1h
27439,2,chinaT,2046,0,0,4,4,0.0%,1h
27453,2,lianxiyunyin,2045,733,72,82,154,46.8%,1h
27453,3,万物盒,2045,696,30,23,53,56.6%,38m
27453,3,xuNLu,2045,539,19,24,43,44.2%,1h
27453,1,srfes,2045,186,7,10,17,41.2%,12m
27453,3,风落有时,2045,169,4,4,8,50.0%,1h
27453,2,DarLing,2045,86,4,8,12,33.3%,1h
27453,2,peterzxl,2045,129,3,1,4,75.0%,1h
27453,3,[SCL]吉吉国王,2045,86,3,5,8,37.5%,27m
27453,2,一个时代的终结,2045,88,2,6,8,25.0%,17m
27453,3,萌小萌,2045,72,2,9,11,18.2%,7m
27453,3,[鲲之大]戴同学,2045,0,1,1,2,50.0%,1h
27453,3,qwesbb,2045,30,1,3,4,25.0%,1h
27453,1,失控的疯子祥子,2045,0,0,1,1,0.0%,1h
27453,3,阿翻,2045,0,0,1,1,0.0%,1h
27453,3,[中华何平]少帅,2045,0,0,2,2,0.0%,1h
27453,3,巅峰灬烈焰丶,2045,0,0,4,4,0.0%,53m
27453,3,toobemore,2045,0,0,6,6,0.0%,1h
27470,3,天叶丶,2044,1245,57,73,130,43.8%,9m
27470,3,宇飞,2044,190,7,11,18,38.9%,1h
27470,2,Jay,2044,172,6,7,13,46.2%,54m
27470,3,觉不醒,2044,32,5,2,7,71.4%,1h
27470,2,桃花醉梨花殇,2044,46,3,10,13,23.1%,1h
27470,3,[情谊至上]永丿灭灬,2044,118,2,1,3,66.7%,1h
27470,3,晴天水清,2044,30,2,3,5,40.0%,1h
27470,3,感悟,2044,96,1,1,2,50.0%,1h
27470,3,南乡,2044,30,1,8,9,11.1%,7m
27479,3,[叫我兔本]幻想乡的男性,2043,1347,105,115,220,47.7%,15m
27479,2,CSo,2043,486,44,59,103,42.7%,1h
27479,3,卡洛斯,2043,754,29,25,54,53.7%,1h
27479,3,Albert,2043,293,27,37,64,42.2%,1h
27479,3,伊斯利,2043,356,13,10,23,56.5%,1h
27479,3,sdfdsfas,2043,358,13,16,29,44.8%,1h
27479,3,[云师三骚]被绿了吗,2043,282,9,16,25,36.0%,15m
27479,3,[十月]楚木,2043,169,6,1,7,85.7%,22m
27479,2,alankvin,2043,124,4,5,9,44.4%,28m
27479,3,ThomasT,2043,126,4,9,13,30.8%,17m
27479,2,没人要的孩子,2043,124,3,7,10,30.0%,56m
27479,3,Jacob,2043,58,2,3,5,40.0%,9m
27479,3,麦克风的丢失,2043,0,1,1,2,50.0%,10m
27479,2,Frostwolf,2043,0,1,2,3,33.3%,1h
27479,3,数码猫,2043,0,0,2,2,0.0%,3m
27494,3,高某的星际,2042,602,66,76,142,46.5%,1h
27494,2,RIXTON,2042,1407,54,68,122,44.3%,1h
27494,3,好汉饶命,2042,582,45,62,107,42.1%,1h
27494,3,guangge,2042,1077,44,51,95,46.3%,23m
27494,3,andy,2042,704,30,34,64,46.9%,10m
27494,3,诚诚,2042,595,22,26,48,45.8%,27m
27494,2,[千古大唐]张参,2042,534,19,28,47,40.4%,24m
27494,1,霸王之怒,2042,193,10,13,23,43.5%,39m
27494,2,正在输入,2042,162,7,9,16,43.8%,32m
27494,2,[新的蜜蜂]Luka,2042,224,5,6,11,45.5%,1h
27494,2,hui,2042,139,4,3,7,57.1%,18m
27494,3,[暴雪零队]雨中莲,2042,119,2,2,4,50.0%,12m
27494,3,[白板]桃子吖,2042,123,2,3,5,40.0%,1h
27494,1,撒币欢乐多,2042,0,1,0,1,100.0%,28m
27494,3,何贱贱,2042,96,1,1,2,50.0%,27m
27494,2,小黄贼啦菜,2042,0,1,2,3,33.3%,57m
27494,3,justdoit,2042,30,1,7,8,12.5%,1h
27494,2,索普,2042,0,0,3,3,0.0%,28m
27494,3,星云,2042,0,0,5,5,0.0%,1h
27513,3,星际练习生,2041,1372,59,54,113,52.2%,22m
27513,1,它来了,2041,1287,47,64,111,42.3%,4m
27513,2,地保怪八零三,2041,348,17,24,41,41.5%,20m
27513,3,Ouking,2041,255,9,5,14,64.3%,5m
27513,3,许三世暖阳,2041,195,7,11,18,38.9%,23m
27513,1,Dis,2041,215,7,15,22,31.8%,9m
27513,3,你阿妈,2041,0,3,2,5,60.0%,53m
27513,1,龙舟,2041,88,3,9,12,25.0%,1h
27513,3,COMMANDER,2041,0,2,2,4,50.0%,1h
27513,3,qixia,2041,0,1,0,1,100.0%,1h
27513,2,糊糊涂涂小生活,2041,0,1,7,8,12.5%,57m
27524,1,沉默之剑,2040,1534,187,206,393,47.6%,1h
27524,1,BPD,2040,1460,165,217,382,43.2%,4m
27524,1,专家电脑,2040,1605,138,152,290,47.6%,48m
27524,3,醒醒吧大清亡了,2040,1377,56,56,112,50.0%,12m
27524,3,衰哥,2040,1196,45,57,102,44.1%,3m
27524,3,老唐,2040,500,35,26,61,57.4%,29m
27524,3,sfh,2040,643,35,47,82,42.7%,1h
27524,2,vincenta,2040,710,26,32,58,44.8%,31m
27524,2,过马路的蚂蚁,2040,377,15,18,33,45.5%,35m
27524,3,晚上吃啥,2040,361,12,16,28,42.9%,32m
27524,3,pass,2040,197,5,6,11,45.5%,1h
27524,2,念夕夏,2040,128,4,9,13,30.8%,51m
27524,2,水水水水,2040,48,2,3,5,40.0%,57m
27524,3,老黄,2040,96,1,1,2,50.0%,15m
27524,3,战神,2040,0,0,1,1,0.0%,24m
27539,2,WJP,2039,600,21,28,49,42.9%,20m
27539,3,奇妙哥,2039,128,10,15,25,40.0%,1h
27539,2,ZHANGYI,2039,148,5,0,5,100.0%,1h
27539,3,Rey,2039,114,5,4,9,55.6%,1h
27539,2,ObjectiveLaw,2039,103,3,2,5,60.0%,57m
27539,2,沉默者,2039,0,3,6,9,33.3%,1h
27539,1,与你同在,2039,96,3,9,12,25.0%,12m
27539,1,无畏花道,2039,46,1,1,2,50.0%,1h
27539,1,猫咪公主,2039,44,1,1,2,50.0%,22m
27548,2,阿卜杜拉阿巴斯,2038,646,84,91,175,48.0%,22m
27548,1,shannonpan,2038,1395,67,75,142,47.2%,25m
27548,3,敖德萨,2038,910,32,45,77,41.6%,1h
27548,3,[星舰与太阳x]法艰苦艰苦,2038,861,31,36,67,46.3%,54m
27548,2,洛清泽,2038,638,24,37,61,39.3%,1h
27548,2,一出手就是忧伤,2038,527,19,28,47,40.4%,1h
27548,3,半个菜鸟,2038,374,15,17,32,46.9%,9m
27548,3,[三国志群雄]大嘟嘟,2038,341,12,18,30,40.0%,25m
27548,2,Maple,2038,241,8,12,20,40.0%,13m
27548,3,浅凉一梦,2038,245,7,8,15,46.7%,32m
27548,3,IIIIIIIIIIII,2038,157,4,3,7,57.1%,1h
27548,3,我不是一般人,2038,128,3,2,5,60.0%,1h
27548,3,汉武帝,2038,0,1,2,3,33.3%,1h
27561,3,[WRQ]阿克琉斯,2037,516,19,19,38,50.0%,1h
27561,3,hungerF,2037,344,13,13,26,50.0%,1h
27561,3,雷神,2037,233,7,6,13,53.8%,1h
27561,3,风尘,2037,245,7,10,17,41.2%,27m
27561,2,EdwardCullen,2037,182,5,10,15,33.3%,1h
27561,3,魔欲,2037,144,4,5,9,44.4%,1h
27561,3,jytjtyutjtyy,2037,122,3,2,5,60.0%,48m
27561,1,loe,2037,0,2,9,11,18.2%,46m
27561,3,张同学,2037,30,1,1,2,50.0%,38m
27561,2,爱莹莹,2037,42,1,4,5,20.0%,1h
27571,3,半醒的灬狐狸,2036,611,33,34,67,49.3%,25m
27571,3,vmv,2036,863,31,35,66,47.0%,29m
27571,3,墨菲特,2036,756,27,35,62,43.5%,1h
27571,3,寒鸦之锋,2036,528,20,30,50,40.0%,3m
27571,3,彩虹,2036,538,17,25,42,40.5%,43m
27571,2,生而为人,2036,305,10,15,25,40.0%,1h
27571,3,[紫罗兰之都]工口爱丽丝,2036,70,3,8,11,27.3%,27m
27571,1,末夜,2036,0,0,1,1,0.0%,14m
27579,2,白星,2035,1337,53,60,113,46.9%,1h
27579,1,不傲,2035,359,15,12,27,55.6%,10m
27579,3,[DMRe]火云邪神,2035,280,10,7,17,58.8%,1h
27579,3,不乖橙,2035,163,4,5,9,44.4%,3m
27579,3,万树丛中一个林,2035,0,3,3,6,50.0%,1h
27579,3,聚羽为花,2035,0,1,3,4,25.0%,1h
27579,1,你家大白真黑,2035,0,0,1,1,0.0%,22m
27579,3,一样的月光,2035,0,0,2,2,0.0%,1h
27587,3,刚枪子成,2034,633,23,33,56,41.1%,1h
27587,2,一吊撂倒,2034,241,8,12,20,40.0%,57m
27587,3,Protomss,2034,147,4,6,10,40.0%,1h
27587,2,瞙駺,2034,143,3,10,13,23.1%,1h
27587,2,神秘先生,2034,0,1,0,1,100.0%,40m
27587,2,[暗黑星球]呵呵的坑,2034,0,1,1,2,50.0%,28m
27587,3,NPCjunyu,2034,0,1,1,2,50.0%,1h
27587,3,理查德,2034,0,1,5,6,16.7%,7m
27587,1,Charliepie,2034,0,0,1,1,0.0%,51m
27587,3,敛剑,2034,0,0,6,6,0.0%,1h
27597,3,啊这,2033,627,22,24,46,47.8%,1h
27597,3,WUDIWCY,2033,524,21,27,48,43.8%,27m
27597,3,Miracle,2033,247,12,23,35,34.3%,53m
27597,2,小白,2033,224,8,13,21,38.1%,35m
27597,1,行天渡,2033,151,5,8,13,38.5%,39m
27597,3,殇神,2033,30,2,1,3,66.7%,1h
27597,3,向我开炮,2033,48,2,6,8,25.0%,1h
27597,3,yan,2033,30,1,3,4,25.0%,1h
27597,1,海之回环,2033,48,1,4,5,20.0%,1h
27597,1,方霸,2033,0,0,1,1,0.0%,51m
27597,2,阿狸的李子,2033,0,0,1,1,0.0%,1h
27597,3,[一起9]暗星,2033,0,0,5,5,0.0%,1h
27609,1,大雨神,2032,820,23,34,57,40.4%,22m
27609,3,space,2032,409,14,15,29,48.3%,1h
27609,3,我来打酱油,2032,164,5,2,7,71.4%,25m
27609,3,KXL,2032,133,4,1,5,80.0%,1h
27609,2,SHYMF,2032,76,3,4,7,42.9%,40m
27609,2,wangboshen,2032,44,1,3,4,25.0%,1h
27609,3,路泽,2032,30,1,4,5,20.0%,1h
27609,1,LHGY,2032,0,0,1,1,0.0%,1h
27609,1,迷糊娃,2032,0,0,1,1,0.0%,1h
27609,1,lww,2032,0,0,1,1,0.0%,1h
27609,2,Tetris,2032,0,0,1,1,0.0%,32m
27620,3,风之旅人,2031,1141,43,52,95,45.3%,1h
27620,3,fuwct,2031,142,6,9,15,40.0%,1h
27620,3,long,2031,66,3,1,4,75.0%,1h
27620,3,[雾雨魔法森林]qwe,2031,58,3,3,6,50.0%,1h
27620,2,ZHC,2031,158,3,7,10,30.0%,1h
27620,3,[咬不断的粘痰]川军团血战到底,2031,38,1,3,4,25.0%,60m
27620,3,蓝雨冰雨,2031,0,0,5,5,0.0%,53m
27620,3,[星际拓荒者]我是猪队友多包涵,2031,0,0,8,8,0.0%,12m
27628,2,封枫,2030,214,11,18,29,37.9%,12m
27628,3,Hermetist,2030,30,5,3,8,62.5%,9m
27628,2,我是小灰灰,2030,126,4,11,15,26.7%,1h
27628,2,萌萌哒的小德,2030,180,4,11,15,26.7%,1h
27628,1,[菠萝蜜]隆多玩星际,2030,46,2,1,3,66.7%,1h
27628,3,人生茫茫需思雨,2030,34,1,5,6,16.7%,60m
27628,3,[XXHZ31]菲尼克,2030,0,0,1,1,0.0%,1h
27635,3,[CPT]yanghu,2029,1098,40,48,88,45.5%,17m
27635,3,次元战士,2029,416,17,10,27,63.0%,53m
27635,3,胜天,2029,467,16,16,32,50.0%,9m
27635,3,伏羲,2029,427,14,14,28,50.0%,46m
27635,2,丶任土豆丨,2029,362,13,20,33,39.4%,1h
27635,1,生活呢,2029,193,11,7,18,61.1%,1h
27635,3,风几许,2029,0,4,1,5,80.0%,1h
27635,2,JKL,2029,106,4,10,14,28.6%,28m
27635,2,BLLIZARD,2029,130,4,13,17,23.5%,1h
27635,2,无敌的大飞机,2029,0,1,2,3,33.3%,1h
27635,2,Wone,2029,0,1,7,8,12.5%,28m
27635,2,[HTW]我爱薇妹,2029,0,0,1,1,0.0%,1h
27635,3,[谐星手册]超高校级的中二病,2029,0,0,2,2,0.0%,54m
27635,3,[秋毫第五分队]盗梦,2029,0,0,4,4,0.0%,1h
27649,3,Reus,2028,1120,129,158,287,44.9%,1h
27649,2,GIGI,2028,322,10,12,22,45.5%,35m
27649,3,[恋战皇朝]丨魙丨,2028,94,4,6,10,40.0%,19m
27649,3,您敬爱的父亲,2028,133,3,2,5,60.0%,57m
27649,3,yhy,2028,83,2,1,3,66.7%,53m
27649,2,李明威,2028,0,1,9,10,10.0%,1h
27649,2,[Encore]星际娜,2028,0,0,1,1,0.0%,1h
27649,3,yjh,2028,0,0,6,6,0.0%,24m
27657,2,dalian,2027,575,27,49,76,35.5%,29m
27657,3,凹凸猛干,2027,676,25,31,56,44.6%,3m
27657,2,[一群谐星]Abelard,2027,271,20,21,41,48.8%,1h
27657,2,二四一七,2027,285,11,15,26,42.3%,1h
27657,3,vfhgjga,2027,0,4,1,5,80.0%,24m
27657,3,红豆天下第一,2027,48,2,1,3,66.7%,1h
27657,3,圣光忽悠着余,2027,0,1,3,4,25.0%,1h
27657,1,最后震惊了,2027,0,0,1,1,0.0%,13m
27657,3,暮心,2027,0,0,1,1,0.0%,1h
27657,3,[stgHJi]tarcy,2027,0,0,1,1,0.0%,60m
27667,2,阿范文,2026,1285,147,164,311,47.3%,5m
27667,3,天柚柚,2026,895,33,36,69,47.8%,46m
27667,3,大口喝大声笑,2026,324,14,16,30,46.7%,1h
27667,1,[至诚娱乐]李家沱西罗,2026,258,8,13,21,38.1%,28m
27667,3,[虎牙祁铭菌]天死灵,2026,198,6,7,13,46.2%,46m
27667,1,xiaoming,2026,281,6,15,21,28.6%,1h
27667,3,星际魔兽,2026,199,5,6,11,45.5%,1h
27667,2,[可爱的你们]我无敌,2026,46,2,8,10,20.0%,1h
27667,3,[经常一起玩的]盲盲目目打星际,2026,0,1,1,2,50.0%,54m
27667,2,jklln,2026,88,1,2,3,33.3%,40m
27667,3,沙砾,2026,0,0,1,1,0.0%,1h
27678,1,空对空露露对路,2025,270,7,4,11,63.6%,17m
27678,3,这啥啊,2025,0,4,3,7,57.1%,19m
27678,1,DanGeeeeee,2025,48,3,11,14,21.4%,1h
27678,2,飞行员舒克,2025,0,1,0,1,100.0%,1h
27678,2,[埃蒙好可爱]芬兰人民血战毛子,2025,38,1,3,4,25.0%,32m
27678,3,尔蜀,2025,0,0,1,1,0.0%,19m
27678,2,菜且爱玩,2025,0,0,4,4,0.0%,40m
27685,2,JHonlyone,2024,1028,44,55,99,44.4%,22m
27685,3,[imnoob]sugmadic,2024,587,22,30,52,42.3%,3m
27685,2,作曲家,2024,452,16,28,44,36.4%,38m
27685,3,骨灰级,2024,356,12,24,36,33.3%,1h
27685,3,文艺流氓,2024,241,7,7,14,50.0%,1h
27685,1,佩里奇死亡舰队,2024,164,5,9,14,35.7%,13m
27685,2,没赢过,2024,114,4,9,13,30.8%,58m
27685,2,[养驼大师]承德孙一峰,2024,201,4,12,16,25.0%,56m
27685,2,aYa,2024,92,2,1,3,66.7%,13m
27685,2,承诺,2024,139,2,3,5,40.0%,40m
27685,3,ZiHomeIIIIII,2024,78,2,3,5,40.0%,1h
27685,2,拉赛尔,2024,44,2,9,11,18.2%,1h
27685,1,北京公爵,2024,0,1,0,1,100.0%,39m
27685,1,随想,2024,0,1,0,1,100.0%,10m
27685,3,[衣钵之卫]看没灰机,2024,0,1,0,1,100.0%,1h
27685,1,[印度洋舰队]GYL,2024,0,0,1,1,0.0%,24m
27685,3,[七咕咕]归挽,2024,0,0,1,1,0.0%,1h
27685,1,别跑,2024,0,0,3,3,0.0%,1h
27685,3,TheTANK,2024,0,0,5,5,0.0%,38m
27704,2,[HOMOFU]试验品,2023,1419,46,74,120,38.3%,1h
27704,3,夕阳的刻痕,2023,542,18,21,39,46.2%,9m
27704,3,就叫蔡云梁,2023,520,15,33,48,31.2%,1h
27704,3,创始人,2023,286,10,16,26,38.5%,12m
27704,1,若水,2023,262,9,16,25,36.0%,12m
27704,3,[XXHZN3]toby,2023,233,7,8,15,46.7%,1h
27704,3,Hower,2023,132,5,7,12,41.7%,1h
27704,1,biubiu,2023,184,4,3,7,57.1%,1h
27704,3,冰月长安,2023,60,4,6,10,40.0%,1h
27704,1,马扎,2023,94,2,1,3,66.7%,9m
27704,3,周司令,2023,34,1,3,4,25.0%,1h
27704,2,耗子尾汁,2023,0,1,7,8,12.5%,28m
27704,3,[暴雪三队]贾德,2023,0,0,1,1,0.0%,1h
27717,3,生命永恒,2022,106,5,4,9,55.6%,1h
27717,1,Sumail,2022,0,0,1,1,0.0%,43m
27717,3,enterCylow,2022,0,0,1,1,0.0%,1h
27717,1,帝国之影,2022,0,0,1,1,0.0%,46m
27721,3,风雨中的炮灰,2021,216,8,9,17,47.1%,1h
27721,1,[荒唐社]Grye,2021,200,5,4,9,55.6%,1h
27721,3,红尘过客,2021,194,5,6,11,45.5%,9m
27721,1,[LED]qwas,2021,169,3,3,6,50.0%,1h
27721,3,jiaobaba,2021,30,2,2,4,50.0%,1h
27721,3,[三体第一舰队]Greeper,2021,0,0,1,1,0.0%,24m
27721,3,源忆梦,2021,0,0,1,1,0.0%,1h
27721,3,骄傲的少年,2021,0,0,3,3,0.0%,12m
27729,2,有空,2020,1507,89,105,194,45.9%,1h
27729,2,虫王重生,2020,1050,40,42,82,48.8%,42m
27729,3,[别杀我农民]一木,2020,486,26,26,52,50.0%,43m
27729,3,岗版日川,2020,337,12,17,29,41.4%,1h
27729,3,慈善你夜哥,2020,280,9,15,24,37.5%,11m
27729,1,简单电脑,2020,263,8,5,13,61.5%,10m
27729,1,未来任性,2020,223,7,2,9,77.8%,1h
27729,2,木有名字,2020,149,5,11,16,31.2%,56m
27729,2,longzai,2020,48,4,7,11,36.4%,13m
27729,3,卓伦,2020,96,2,2,4,50.0%,1h
27729,3,杀戮之影,2020,0,2,4,6,33.3%,7m
27729,1,[给国服带来爱]国服小马茹,2020,0,1,0,1,100.0%,43m
27729,2,vannelt,2020,93,1,4,5,20.0%,1h
27729,2,感受自由,2020,0,1,7,8,12.5%,1h
27729,2,[别看了就你了]八云紫,2020,0,0,2,2,0.0%,57m
27729,2,清灰,2020,0,0,3,3,0.0%,1h
27729,3,[大脑在震颤]ToTheSky,2020,0,0,4,4,0.0%,1h
27729,3,失引论,2020,0,0,5,5,0.0%,1h
27747,1,永远喜欢坂井泉水,2019,494,12,13,25,48.0%,12m
27747,3,ZSZSZS,2019,267,9,8,17,52.9%,15m
27747,2,黑米粥,2019,224,9,10,19,47.4%,1h
27747,3,三千青丝,2019,245,8,8,16,50.0%,1h
27747,3,[地图大咖]蓝天白云,2019,162,7,10,17,41.2%,10m
27747,2,passerly,2019,240,7,14,21,33.3%,1h
27747,1,人类帝国,2019,136,4,1,5,80.0%,39m
27747,3,傻咸鸭,2019,141,3,3,6,50.0%,27m
27747,3,Marlborol,2019,58,3,4,7,42.9%,1h
27747,3,TYTY,2019,88,3,9,12,25.0%,1h
27747,2,CHAOSHUAI,2019,96,3,16,19,15.8%,51m
27747,3,无上使命,2019,30,1,4,5,20.0%,10m
27747,3,谭颂,2019,0,0,2,2,0.0%,27m
27760,1,奔跑的小草鸡,2018,1573,249,285,534,46.6%,27m
27760,3,霸气淡定的路人王,2018,372,16,20,36,44.4%,27m
27760,3,你耶耶耶,2018,359,15,19,34,44.1%,1h
27760,1,一十七,2018,348,11,14,25,44.0%,1h
27760,3,致胜,2018,316,11,21,32,34.4%,18m
27760,3,名字好难起,2018,270,10,14,24,41.7%,46m
27760,1,珠珠侠,2018,290,9,15,24,37.5%,1h
27760,1,心无悔,2018,339,9,17,26,34.6%,12m
27760,3,从魔兽哪过来的,2018,279,9,17,26,34.6%,1h
27760,3,晨曦,2018,285,8,18,26,30.8%,1h
27760,3,无当飞军,2018,114,4,10,14,28.6%,10m
27760,3,离悸,2018,126,4,10,14,28.6%,1h
27760,1,神垃圾,2018,84,3,0,3,100.0%,59m
27760,1,Luomu,2018,35,1,1,2,50.0%,1h
27760,3,xiaokun,2018,0,0,1,1,0.0%,1h
27775,3,无聊啊,2017,978,36,39,75,48.0%,39m
27775,3,二的三次,2017,511,19,25,44,43.2%,32m
27775,3,wybdir,2017,270,16,19,35,45.7%,1h
27775,2,休闲,2017,345,12,19,31,38.7%,1h
27775,1,收到的风格,2017,350,9,7,16,56.2%,1h
27775,1,AAA,2017,198,6,6,12,50.0%,1h
27775,3,king,2017,178,6,13,19,31.6%,18m
27775,2,PsyOwl,2017,130,4,3,7,57.1%,1h
27775,3,世界的和平,2017,173,4,8,12,33.3%,1h
27775,1,熊猫大侠,2017,0,0,1,1,0.0%,9m
27775,3,冷枫,2017,0,0,5,5,0.0%,1h
27786,3,Gemini,2016,1472,69,89,158,43.7%,3m
27786,2,做发财梦,2016,1304,68,87,155,43.9%,1h
27786,3,秀村,2016,724,36,44,80,45.0%,25m
27786,3,[KOKOKO]相泽南,2016,426,23,25,48,47.9%,1h
27786,3,MAGA,2016,430,15,17,32,46.9%,1h
27786,3,程雪,2016,375,14,17,31,45.2%,1h
27786,2,Stats,2016,369,13,23,36,36.1%,1h
27786,3,绫小路,2016,190,6,5,11,54.5%,1h
27786,3,雷鸣闪电,2016,197,6,6,12,50.0%,1h
27786,1,TiMi,2016,205,5,7,12,41.7%,15m
27786,3,[暴雪三十二隊]jbdmsl,2016,44,2,7,9,22.2%,7m
27786,2,gfhshfjg,2016,0,1,0,1,100.0%,57m
27786,2,[四系乃啦啦啦]卓亦逊,2016,0,1,2,3,33.3%,1h
27786,1,优雅的秃废,2016,0,0,1,1,0.0%,1h
27786,1,路明非二,2016,0,0,1,1,0.0%,51m
27786,1,[雷霆半月斩]天天,2016,0,0,5,5,0.0%,51m
27786,3,暮雪秦川,2016,0,0,6,6,0.0%,7m
27803,1,[XXHZ23]影动,2015,1542,109,132,241,45.2%,8m
27803,3,勥氼,2015,1064,36,48,84,42.9%,1h
27803,3,Kinging,2015,336,11,24,35,31.4%,1h
27803,3,JINGSHU,2015,88,2,10,12,16.7%,19m
27803,3,[浙大战队]平凡的幻想,2015,0,1,3,4,25.0%,27m
27803,3,Tommy,2015,0,1,4,5,20.0%,1h
27803,2,差点不是帅哥,2015,0,0,1,1,0.0%,57m
27803,3,不死小强,2015,0,0,1,1,0.0%,60m
27803,1,无敌,2015,0,0,2,2,0.0%,1h
27803,1,始发港,2015,0,0,2,2,0.0%,13m
27803,3,SNOWANCE,2015,0,0,6,6,0.0%,1h
27803,1,Rebirth,2015,0,0,8,8,0.0%,17m
27815,3,攻主,2014,256,22,19,41,53.7%,23m
27815,3,[琴筝]泠鸢,2014,341,14,6,20,70.0%,32m
27815,3,YYDawn,2014,325,10,10,20,50.0%,1h
27815,3,DEIUXTHEMAX,2014,285,10,18,28,35.7%,15m
27815,3,九月的风,2014,184,6,9,15,40.0%,15m
27815,3,[XXHZN3]工具人,2014,0,2,3,5,40.0%,24m
27815,3,[Mentor]牛头人猎杀者,2014,61,2,8,10,20.0%,1h
27815,3,拉萨祝您身体健康,2014,40,1,1,2,50.0%,53m
27815,3,你大爷,2014,0,0,4,4,0.0%,7m
27824,2,霸天军团,2013,758,26,42,68,38.2%,1h
27824,1,重创神,2013,622,16,20,36,44.4%,17m
27824,3,斜风细雨不需归,2013,351,14,17,31,45.2%,1h
27824,2,Devil,2013,128,4,12,16,25.0%,35m
27824,1,Ghost,2013,121,2,8,10,20.0%,1h
27824,2,风吹胖次屁屁凉,2013,0,1,0,1,100.0%,56m
27824,1,菜鸟混星际,2013,0,1,1,2,50.0%,19m
27824,2,[逐光]北陆,2013,0,1,2,3,33.3%,56m
27824,3,AUGUSTUS,2013,0,0,5,5,0.0%,54m
27833,3,战略撤退,2012,931,50,56,106,47.2%,1h
27833,2,大眼仔,2012,534,43,49,92,46.7%,51m
27833,3,gaoziteng,2012,692,24,27,51,47.1%,1h
27833,1,剑灭苍穹,2012,274,8,18,26,30.8%,1h
27833,2,gsr,2012,76,3,3,6,50.0%,1h
27833,3,门神大大,2012,125,3,4,7,42.9%,29m
27833,1,vipee,2012,0,1,0,1,100.0%,1h
27833,2,卡斯巴尔,2012,0,1,3,4,25.0%,1h
27833,2,泉水战略指挥家,2012,90,1,4,5,20.0%,32m
27833,3,山石,2012,48,1,7,8,12.5%,1h
27833,2,VariFunc,2012,90,1,8,9,11.1%,40m
27833,1,机智昊,2012,0,0,1,1,0.0%,59m
27833,1,坦克,2012,0,0,1,1,0.0%,1h
27846,3,[QWQa]小雏菊,2011,789,33,40,73,45.2%,1h
27846,3,Eman,2011,50,3,5,8,37.5%,27m
27846,3,MARKSMAN,2011,70,2,3,5,40.0%,60m
27846,1,新手玩家,2011,0,1,1,2,50.0%,13m
27846,2,Versuchen,2011,42,1,4,5,20.0%,13m
27846,1,fovkor,2011,0,0,4,4,0.0%,46m
27846,3,天地正气,2011,0,0,5,5,0.0%,12m
27853,3,大萨达奥多,2010,362,18,23,41,43.9%,25m
27853,3,[瑶瑶公主]MAXFury,2010,298,10,15,25,40.0%,1h
27853,3,wuming,2010,187,6,6,12,50.0%,12m
27853,3,橘乃,2010,86,3,6,9,33.3%,1h
27853,3,叶丶花火,2010,78,2,9,11,18.2%,19m
27853,1,saxfc,2010,0,0,1,1,0.0%,1h
27853,1,机械狼人,2010,0,0,1,1,0.0%,9m
27853,2,虎牙弱猪,2010,0,0,3,3,0.0%,57m
27853,3,古怪叼专,2010,0,0,3,3,0.0%,19m
27862,2,Mldy,2009,831,34,39,73,46.6%,1h
27862,1,尼古拉斯张三,2009,820,28,39,67,41.8%,1h
27862,3,[是我赢了]芜湖,2009,314,11,16,27,40.7%,1h
27862,1,明非,2009,260,7,7,14,50.0%,16m
27862,3,LUBENWEI,2009,224,7,13,20,35.0%,54m
27862,1,kkeeyy,2009,228,6,4,10,60.0%,1h
27862,2,Siri,2009,142,3,4,7,42.9%,1h
27862,1,郎基努斯,2009,48,3,13,16,18.8%,16m
27862,1,天之涯海之南,2009,82,2,2,4,50.0%,1h
27862,2,猪头辉哈哈哈哈,2009,0,1,0,1,100.0%,1h
27862,1,奀奀,2009,0,1,2,3,33.3%,22m
27862,2,kkkkkkkkkkkk,2009,0,1,7,8,12.5%,1h
27862,3,wsx,2009,30,1,8,9,11.1%,49m
27875,3,tiger,2008,1341,54,53,107,50.5%,1h
27875,1,[不讲五德]北王,2008,530,20,12,32,62.5%,23m
27875,1,紫金花园,2008,315,11,15,26,42.3%,39m
27875,3,[玖天揽玥]hyc,2008,203,6,6,12,50.0%,29m
27875,1,ROMAINVICTA,2008,130,4,2,6,66.7%,13m
27875,3,星际穿越,2008,76,4,3,7,57.1%,54m
27875,3,是时候装一波了,2008,72,2,6,8,25.0%,17m
27875,2,[LOHv]彷徨亡者,2008,48,2,9,11,18.2%,56m
27875,1,一切战术皆换家,2008,48,1,2,3,33.3%,1h
27884,2,[wean]阿塔尼斯,2007,519,29,34,63,46.0%,1h
27884,2,鸟鸟,2007,506,17,29,46,37.0%,1h
27884,1,[CSJJ]快乐源源,2007,350,8,13,21,38.1%,1h
27884,3,薄荷,2007,133,4,4,8,50.0%,1h
27884,3,偏爱小单,2007,167,4,6,10,40.0%,1h
27884,1,[SC2战队]强森,2007,118,3,1,4,75.0%,13m
27884,2,我是你老头儿,2007,132,3,6,9,33.3%,28m
27884,3,可见光粉碎者,2007,0,1,1,2,50.0%,24m
27884,3,tmr,2007,30,1,3,4,25.0%,3m
27884,3,Snake,2007,0,0,3,3,0.0%,1h
27894,2,映客,2006,1443,125,150,275,45.5%,12m
27894,3,吃爸爸一炮,2006,307,28,24,52,53.8%,1h
27894,1,小树妖,2006,416,21,12,33,63.6%,59m
27894,3,星际,2006,422,14,17,31,45.2%,1h
27894,2,终日乾乾,2006,209,6,11,17,35.3%,1h
27894,2,夜半,2006,68,3,10,13,23.1%,1h
27894,1,asdzsdg,2006,0,0,1,1,0.0%,1h
27901,3,小唐小唐,2005,1058,103,128,231,44.6%,1h
27901,3,NAI,2005,689,26,30,56,46.4%,1h
27901,3,杰洛斯,2005,348,13,14,27,48.1%,1h
27901,3,Ruik,2005,328,13,16,29,44.8%,25m
27901,2,加列儿,2005,0,2,7,9,22.2%,1h
27901,1,hmy,2005,0,0,1,1,0.0%,1h
27901,2,[闪金镇守夜人]兰水,2005,0,0,1,1,0.0%,19m
27901,1,猫咪警长爱吃鱼,2005,0,0,3,3,0.0%,1h
27901,3,冷血动物,2005,0,0,6,6,0.0%,1h
27910,2,骑着看夕阳,2004,1244,74,81,155,47.7%,1h
27910,2,xday,2004,397,33,42,75,44.0%,20m
27910,1,安息,2004,856,23,23,46,50.0%,1h
27910,1,tian,2004,664,16,18,34,47.1%,1h
27910,3,萌萌哒的苏澈,2004,128,6,20,26,23.1%,9m
27910,3,Careerism,2004,108,3,4,7,42.9%,1h
27910,1,EVE,2004,142,3,6,9,33.3%,22m
27910,3,维特,2004,62,2,2,4,50.0%,60m
27910,1,[无魂之鸭]baixiao,2004,30,1,1,2,50.0%,13m
27910,3,宗依,2004,34,1,8,9,11.1%,1h
27910,3,bibi,2004,0,0,2,2,0.0%,1h
27910,2,赤壁怀古,2004,0,0,2,2,0.0%,1h
27922,3,江东小霸王,2003,1173,52,60,112,46.4%,1h
27922,2,旧爱难挡,2003,270,9,13,22,40.9%,56m
27922,3,武林神话,2003,102,4,7,11,36.4%,1h
27922,2,宸空与共,2003,40,1,5,6,16.7%,35m
27922,3,等等,2003,0,1,5,6,16.7%,1h
27922,1,cfy,2003,0,0,1,1,0.0%,59m
27928,1,巴西龟,2002,811,26,26,52,50.0%,39m
27928,1,[快乐风男]樱花亦落心亦凉,2002,710,18,18,36,50.0%,40m
27928,1,cccvvv,2002,495,11,15,26,42.3%,1h
27928,1,QING,2002,285,8,18,26,30.8%,19m
27928,3,foreverMY,2002,65,5,6,11,45.5%,1h
27928,2,JSHB,2002,125,3,9,12,25.0%,57m
27928,2,浅笑安然,2002,0,1,0,1,100.0%,1h
27928,3,市规划局长,2002,30,1,6,7,14.3%,11m
27928,3,高手很少,2002,44,1,8,9,11.1%,38m
27928,1,fate,2002,0,0,1,1,0.0%,25m
27928,3,子墨,2002,0,0,6,6,0.0%,1h
27939,3,心星,2001,1529,78,93,171,45.6%,29m
27939,3,所言尚早,2001,756,55,59,114,48.2%,10m
27939,2,siwofu,2001,268,10,5,15,66.7%,1h
27939,1,Kingslayer,2001,186,4,9,13,30.8%,13m
27939,1,自由一丶冷风,2001,130,3,3,6,50.0%,1h
27939,1,wenyongbing,2001,88,2,3,5,40.0%,1h
27939,3,霸主,2001,0,2,3,5,40.0%,1h
27939,1,十七,2001,0,2,10,12,16.7%,1h
27939,3,[DMR]爱你,2001,30,1,4,5,20.0%,1h
27939,3,老王档下龙,2001,0,0,1,1,0.0%,60m
27939,3,十四,2001,0,0,1,1,0.0%,1h
27950,3,萌萌哒鸡饲料,2000,659,25,27,52,48.1%,1h
27950,3,菜鸡,2000,370,13,19,32,40.6%,57m
27950,1,铁骑射手,2000,283,11,16,27,40.7%,1h
27950,3,老六大魔王,2000,154,7,18,25,28.0%,54m
27950,1,雨孤影,2000,208,5,6,11,45.5%,17m
27950,3,小白呀土豆,2000,120,3,2,5,60.0%,1h
27950,2,幻仙,2000,0,3,5,8,37.5%,28m
27950,1,MengDetong,2000,0,3,9,12,25.0%,26m
27950,3,我是小菜比,2000,30,2,7,9,22.2%,1h
27950,2,宿暮,2000,0,1,0,1,100.0%,19m
27950,3,waad,2000,34,1,1,2,50.0%,60m
27950,3,卡车不快,2000,0,0,1,1,0.0%,19m
27950,3,XXXXX,2000,0,0,2,2,0.0%,38m
27950,1,madman,2000,0,0,2,2,0.0%,16m
27950,1,[星际旅游团]心水,2000,0,0,3,3,0.0%,17m
27950,2,Unchanged,2000,0,0,4,4,0.0%,1h
27950,3,ceo,2000,0,0,6,6,0.0%,24m
27967,3,萌新,1999,1118,73,77,150,48.7%,1h
27967,3,llllllllllll,1999,979,39,43,82,47.6%,18m
27967,3,阿卜杜勒哈扎耶夫,1999,394,16,19,35,45.7%,1h
27967,3,[全国修车]CyrusYU,1999,482,16,19,35,45.7%,27m
27967,1,[皮皮世界]Fack,1999,280,8,5,13,61.5%,25m
27967,3,是丫丫酱呀,1999,242,8,14,22,36.4%,1h
27967,3,啊伟啦,1999,0,4,1,5,80.0%,60m
27967,1,老罗杰,1999,86,2,3,5,40.0%,1h
27967,1,超光速,1999,93,1,1,2,50.0%,1h
27967,1,南涩,1999,0,1,1,2,50.0%,59m
27967,3,DrBamboo,1999,0,1,2,3,33.3%,60m
27967,3,小锦鲤,1999,0,0,2,2,0.0%,1h
27967,2,Deity,1999,0,0,3,3,0.0%,1h
27980,1,宇宙之神,1998,248,8,15,23,34.8%,1h
27980,2,敬汝一壶酒,1998,134,5,8,13,38.5%,1h
27980,1,INTENID,1998,0,1,0,1,100.0%,40m
27980,2,smartbird,1998,0,1,0,1,100.0%,13m
27980,2,龙之遗迹,1998,0,1,7,8,12.5%,1h
27980,2,墨迹,1998,0,0,1,1,0.0%,1h
27980,1,将就生活,1998,0,0,2,2,0.0%,1h
27987,1,我是黑老大,1997,384,10,8,18,55.6%,1h
27987,3,蜂群,1997,218,6,8,14,42.9%,1h
27987,2,[刺蛇保护协会]斑马,1997,158,4,5,9,44.4%,13m
27987,3,[枉凝眉]青丞,1997,0,1,0,1,100.0%,60m
27987,1,小韩同学,1997,0,1,2,3,33.3%,1h
27987,3,[恶魔旗号队]冥王,1997,0,0,2,2,0.0%,1h
27987,2,[哔哩哔哩乾杯]洛兮,1997,0,0,4,4,0.0%,17m
27994,3,刀问今生,1996,552,18,26,44,40.9%,10m
27994,3,Torpedo,1996,332,11,19,30,36.7%,10m
27994,1,清梦之歌,1996,262,10,13,23,43.5%,1h
27997,1,虫潮,1995,1133,116,175,291,39.9%,13m
27997,3,菜鸟,1995,1090,41,47,88,46.6%,1h
27997,2,战神可拉斯,1995,996,38,57,95,40.0%,42m
27997,3,Azathoth,1995,410,17,26,43,39.5%,1h
27997,3,[暴雪二十六队]保护江西的小,1995,444,15,22,37,40.5%,9m
27997,3,UNDRDG,1995,365,14,10,24,58.3%,9m
27997,1,大狸子,1995,58,3,1,4,75.0%,13m
27997,2,繁星,1995,42,2,10,12,16.7%,28m
27997,3,[miku守护]刮板机,1995,0,1,0,1,100.0%,1h
27997,1,青海战魂,1995,44,1,2,3,33.3%,12m
27997,2,爱你如今的容颜,1995,0,0,2,2,0.0%,13m
28008,3,霸道小伙,1994,274,9,21,30,30.0%,1h
28008,3,SUY,1994,146,8,3,11,72.7%,1h
28008,1,xin,1994,0,1,1,2,50.0%,1h
28008,3,亚盾之茅,1994,0,1,4,5,20.0%,1h
28008,3,YSIR,1994,0,0,1,1,0.0%,1h
28008,3,[暗影囚]希灵洛狄忒,1994,0,0,3,3,0.0%,53m
28014,2,暴打雨涵,1993,1546,152,202,354,42.9%,24m
28014,3,shenlan,1993,1528,144,178,322,44.7%,18m
28014,3,狂暴的锋,1993,1592,86,87,173,49.7%,11m
28014,3,虎虎虎,1993,1412,73,76,149,49.0%,1h
28014,3,剑云在天,1993,960,51,65,116,44.0%,18m
28014,3,大天使,1993,397,24,30,54,44.4%,1h
28014,3,换家圣手,1993,271,17,19,36,47.2%,1h
28014,3,帅气的小伙,1993,363,12,18,30,40.0%,57m
28014,2,简单回忆,1993,244,10,26,36,27.8%,42m
28014,3,[琴筝]Shidi,1993,224,7,8,15,46.7%,1h
28014,1,[握槽皮好痒]防不来一波,1993,90,3,0,3,100.0%,13m
28014,2,孤狼一人,1993,0,3,8,11,27.3%,1h
28014,1,吾欲丶登天,1993,112,2,3,5,40.0%,1h
28014,1,MRKAML,1993,90,2,5,7,28.6%,23m
28014,3,[DLN]Zest,1993,0,1,5,6,16.7%,1h
28014,2,岚影,1993,0,1,9,10,10.0%,35m
28014,1,[为了二五仔]天罡星呼保义宋江,1993,0,0,2,2,0.0%,1h
28014,1,李锦书,1993,0,0,2,2,0.0%,1h
28014,3,MrGoblin,1993,0,0,4,4,0.0%,8m
28033,3,广龙弓,1992,1505,67,76,143,46.9%,1h
28033,1,看见你还是会心动,1992,470,12,11,23,52.2%,1h
28033,2,llllllllllll,1992,203,4,11,15,26.7%,58m
28033,1,Runru,1992,115,3,2,5,60.0%,13m
28033,1,[F2ANB]墨茗天悸,1992,94,3,12,15,20.0%,1h
28033,2,萊芬瑟圖,1992,42,2,9,11,18.2%,17m
28033,1,四月晚樱,1992,97,1,2,3,33.3%,1h
28033,3,nidhogg,1992,0,1,4,5,20.0%,53m
28033,2,星际神,1992,0,0,1,1,0.0%,1h
28042,3,狂少时光,1991,290,11,13,24,45.8%,15m
28042,3,shootyou,1991,124,5,17,22,22.7%,1h
28042,3,皮蛋,1991,163,4,11,15,26.7%,18m
28042,3,小小之怪,1991,40,1,5,6,16.7%,19m
28042,3,杀鸡取卵,1991,0,0,4,4,0.0%,38m
28042,3,sssddh,1991,0,0,6,6,0.0%,1h
28048,3,此生不娶,1990,681,46,57,103,44.7%,1h
28048,3,FINAL,1990,590,23,33,56,41.1%,49m
28048,1,qaqaqa,1990,628,17,14,31,54.8%,15m
28048,3,lalalala,1990,291,9,10,19,47.4%,29m
28048,3,有你什么事,1990,287,9,15,24,37.5%,39m
28048,1,[面条]小奥,1990,90,2,2,4,50.0%,9m
28048,2,夜宴,1990,42,2,10,12,16.7%,1h
28055,3,疑似到底,1989,448,20,22,42,47.6%,25m
28055,1,[北有吾王3队]爱的就是你,1989,330,8,6,14,57.1%,1h
28055,2,SOGEKING,1989,93,2,1,3,66.7%,56m
28055,3,诺亚方舟,1989,30,2,3,5,40.0%,1h
28055,3,鱼青,1989,0,2,3,5,40.0%,1h
28055,3,诸星当,1989,78,2,9,11,18.2%,1h
28055,3,[INC]Phoenix,1989,0,1,4,5,20.0%,1h
28055,2,gavinding,1989,0,0,1,1,0.0%,54m
28063,3,震荡时光,1988,1120,93,127,220,42.3%,1h
28063,3,[信仰圣光指引]动次哒次,1988,628,21,33,54,38.9%,9m
28063,1,角膜上撒胡椒粉,1988,563,16,23,39,41.0%,46m
28063,3,一锅炖不下的鲲,1988,120,5,8,13,38.5%,18m
28063,3,小游民,1988,40,1,7,8,12.5%,1h
28063,1,[HNU]SEDsteck,1988,0,0,1,1,0.0%,40m
28063,3,troublemoon,1988,0,0,1,1,0.0%,1h
28063,3,李力奇,1988,0,0,6,6,0.0%,60m
28071,3,DOCTORZhou,1987,478,16,19,35,45.7%,1h
28071,3,创世大麦哥,1987,114,12,15,27,44.4%,10m
28071,3,落叶飘香,1987,316,11,22,33,33.3%,1h
28071,3,小浮丫,1987,254,10,20,30,33.3%,1h
28071,3,塔兰塔,1987,174,7,6,13,53.8%,8m
28071,3,条形码,1987,0,1,2,3,33.3%,1h
28071,3,[M80]赛罗奥特曼,1987,0,1,4,5,20.0%,54m
28071,1,EarlyNine,1987,0,1,7,8,12.5%,1h
28071,1,维克多雨果,1987,0,0,1,1,0.0%,1h
28071,1,宫湦,1987,0,0,1,1,0.0%,22m
28071,1,TsuiLee,1987,0,0,2,2,0.0%,1h
28071,2,千魏尘里,1987,0,0,2,2,0.0%,28m
28083,1,上杉越,1986,645,24,25,49,49.0%,1h
28083,3,Kerrigan,1986,313,9,13,22,40.9%,1h
28083,2,ingory,1986,156,4,10,14,28.6%,28m
28083,3,我来自地狱,1986,0,3,3,6,50.0%,1h
28083,1,孙博父,1986,163,3,4,7,42.9%,40m
28083,2,不要按农民,1986,137,3,4,7,42.9%,19m
28083,1,TokyoVice,1986,44,2,2,4,50.0%,1h
28083,2,绝地闪电,1986,86,2,6,8,25.0%,1h
28083,3,SaVm,1986,0,2,6,8,25.0%,1h
28083,2,wowwowwow,1986,42,2,9,11,18.2%,1h
28083,3,sunchaser,1986,30,1,1,2,50.0%,60m
28083,3,清风浩存,1986,0,1,1,2,50.0%,1h
28083,1,风格国际,1986,0,0,1,1,0.0%,13m
28083,1,顾倩兮,1986,0,0,3,3,0.0%,16m
28097,3,YZT,1985,960,122,157,279,43.7%,1h
28097,3,热心网友小石,1985,969,117,166,283,41.3%,49m
28097,2,[VLK]上坎下离,1985,379,16,18,34,47.1%,1h
28097,3,Conan,1985,399,13,16,29,44.8%,9m
28097,2,WARS,1985,313,11,23,34,32.4%,52m
28097,3,晚安记得早睡,1985,192,6,7,13,46.2%,18m
28103,3,未闻狐,1984,1224,45,54,99,45.5%,9m
28103,1,落空的黎明,1984,996,26,33,59,44.1%,43m
28103,1,return,1984,451,11,8,19,57.9%,1h
28103,1,[WILLE]小灬千,1984,376,9,5,14,64.3%,1h
28103,1,[是我赢了]断罪者,1984,182,4,3,7,57.1%,46m
28103,3,那咋办嘛,1984,38,4,5,9,44.4%,1h
28103,2,fafa,1984,44,4,6,10,40.0%,1h
28103,1,迷途,1984,104,3,3,6,50.0%,15m
28103,1,Binbin,1984,138,3,4,7,42.9%,28m
28103,3,唯雨倾诚,1984,58,2,5,7,28.6%,1h
28103,3,六六,1984,74,2,9,11,18.2%,60m
28103,2,Caster,1984,0,1,1,2,50.0%,58m
28103,1,詩雲,1984,0,0,1,1,0.0%,16m
28103,3,[天门]你将如闪电般归来,1984,0,0,6,6,0.0%,1h
28117,1,JOJOFANSEN,1983,1569,64,91,155,41.3%,23m
28117,3,[21CM]玫瑰公子,1983,425,16,18,34,47.1%,1h
28117,3,绝地反击,1983,340,10,19,29,34.5%,1h
28117,1,穷思千里,1983,182,4,3,7,57.1%,17m
28117,3,长河,1983,80,4,6,10,40.0%,1h
28117,1,挚爱雄鑫,1983,90,3,0,3,100.0%,13m
28117,1,酒醉金迷小道士,1983,70,3,3,6,50.0%,1h
28117,3,野渡无人,1983,88,3,8,11,27.3%,4m
28117,1,pksolar,1983,46,3,12,15,20.0%,43m
28117,1,葛根夫,1983,36,2,2,4,50.0%,1h
28117,3,铃科百合子,1983,48,2,5,7,28.6%,10m
28117,3,大风起兮云飞扬,1983,0,0,5,5,0.0%,1h
28117,3,百城晓恺,1983,0,0,6,6,0.0%,19m
28117,3,[浑元星际派]孙保国,1983,0,0,6,6,0.0%,1h
28131,3,fakalo,1982,859,37,32,69,53.6%,1h
28131,3,我不说你猜,1982,206,8,7,15,53.3%,1h
28131,2,风骚浪荡醉,1982,153,5,9,14,35.7%,56m
28131,2,干净虫族,1982,160,4,7,11,36.4%,28m
28131,1,Manny,1982,191,4,12,16,25.0%,25m
28131,1,陌上人如玉,1982,88,4,13,17,23.5%,1h
28131,1,[Shawk]水迪迪,1982,138,3,3,6,50.0%,28m
28131,3,SsSsSsSsSsSs,1982,30,2,2,4,50.0%,1h
28131,3,雷霆嘎巴,1982,0,2,4,6,33.3%,24m
28131,2,锦鲤抄,1982,107,2,9,11,18.2%,1h
28131,3,[浙大战队]猴子逗比神,1982,0,0,2,2,0.0%,8m
28131,1,dfsfsfsf,1982,0,0,3,3,0.0%,1h
28143,3,掠夺者,1981,1238,76,97,173,43.9%,1h
28143,1,bardboy,1981,1176,36,41,77,46.8%,59m
28143,3,说书先生,1981,235,7,6,13,53.8%,1h
28143,3,Yuval,1981,0,2,3,5,40.0%,1h
28143,1,奶思的杰克,1981,115,2,5,7,28.6%,9m
28143,2,机甲世纪,1981,0,1,1,2,50.0%,54m
28143,3,whatsupDD,1981,24,1,1,2,50.0%,1h
28143,3,蔡争霸,1981,30,1,1,2,50.0%,60m
28143,3,[招D了]开心宝贝,1981,30,1,5,6,16.7%,57m
28143,2,瞌睡猫,1981,0,1,7,8,12.5%,56m
28143,1,丌异巳,1981,95,1,21,22,4.5%,1h
28143,1,小狂不会玩,1981,0,0,2,2,0.0%,9m
28143,3,Poseidon,1981,0,0,2,2,0.0%,1h
28156,1,standmaster,1980,24,1,2,3,33.3%,46m
28156,3,Ocpre,1980,0,0,1,1,0.0%,1h
28156,1,我是个抱大腿的,1980,0,0,2,2,0.0%,1h
28159,3,[七咕咕]皮卡期,1979,406,15,21,36,41.7%,18m
28159,2,[丹羽玖音]依然灬林白,1979,348,11,39,50,22.0%,39m
28159,1,sreuw,1979,316,7,9,16,43.8%,1h
28159,2,翩诺惊鸿,1979,0,1,1,2,50.0%,28m
28159,2,[虚拟歌手团体]洛天依我老婆,1979,0,0,1,1,0.0%,1h
28159,2,[各种少女的梦]百万少女梦,1979,0,0,1,1,0.0%,1h
28165,3,[你吗炸了]特困猪,1978,130,33,136,169,19.5%,52m
28165,1,小小白,1978,662,17,15,32,53.1%,1h
28165,1,RUhelmets,1978,481,15,19,34,44.1%,1h
28165,2,Lopren,1978,213,7,11,18,38.9%,1h
28165,1,我为狂三上王者,1978,315,6,8,14,42.9%,1h
28165,2,KAMIucius,1978,201,4,8,12,33.3%,1h
28165,1,[联防队谐警]alafmeister,1978,160,4,12,16,25.0%,1h
28165,1,[C82230]小爷是巴顿,1978,78,3,0,3,100.0%,23m
28165,3,有幸陪你走余生,1978,0,0,3,3,0.0%,8m
28174,1,FJKJG,1977,306,7,6,13,53.8%,1h
28174,1,jiulets,1977,150,5,7,12,41.7%,1h
28174,3,[奶牛独立团丶]不咋地,1977,119,2,5,7,28.6%,1h
28174,1,[广寒宫]狂傲丶空洞,1977,48,1,1,2,50.0%,43m
28174,2,暖树,1977,0,1,7,8,12.5%,13m
28179,3,有你晚安,1976,216,11,20,31,35.5%,53m
28179,3,AUAIT,1976,220,7,6,13,53.8%,9m
28179,3,CSSDFSDF,1976,0,2,4,6,33.3%,24m
28179,3,小小跳虫可笑可笑,1976,62,2,7,9,22.2%,38m
28183,3,卷裤脚苦苦,1975,179,10,11,21,47.6%,1h
28183,1,晓晓抹,1975,130,3,5,8,37.5%,1h
28183,3,[Fear]电脑,1975,0,1,0,1,100.0%,53m
28183,1,孤征殇,1975,0,1,2,3,33.3%,10m
28187,1,小宝儿,1974,1815,118,145,263,44.9%,1h
28187,3,月小修,1974,56,7,8,15,46.7%,19m
28187,2,[DMRc]ZIXan,1974,162,5,9,14,35.7%,28m
28187,1,纳森,1974,180,4,4,8,50.0%,1h
28187,1,han,1974,92,3,1,4,75.0%,1h
28187,3,达芬奇的画,1974,0,0,3,3,0.0%,60m
28187,3,深海鲨,1974,0,0,6,6,0.0%,1h
28194,3,hadrian,1973,685,23,29,52,44.2%,1h
28194,3,MONDERU,1973,515,19,27,46,41.3%,1h
28194,3,左将军曹参,1973,413,14,23,37,37.8%,32m
28194,1,xiAoqI,1973,442,12,21,33,36.4%,25m
28194,3,[兄弟和朋友]蛮力之枭,1973,227,6,8,14,42.9%,1h
28194,2,竹阁士道,1973,144,4,9,13,30.8%,28m
28194,2,成都亿诺,1973,159,3,5,8,37.5%,1h
28194,2,第五篇,1973,46,2,10,12,16.7%,40m
28194,2,[LGMG]风华寻安,1973,0,0,1,1,0.0%,1h
28194,3,zjy,1973,0,0,1,1,0.0%,53m
28194,1,旭明鸢,1973,0,0,4,4,0.0%,1h
28194,3,狐狸萨,1973,0,0,5,5,0.0%,1h
28206,1,IIIIIIIII,1972,1827,99,124,223,44.4%,1h
28206,2,hideonbush,1972,1387,91,93,184,49.5%,20m
28206,2,哈哈哈哈,1972,690,50,59,109,45.9%,1h
28206,3,过往的云,1972,366,14,22,36,38.9%,12m
28206,1,可乐,1972,214,5,13,18,27.8%,17m
28206,2,我是萌新很萌那种,1972,114,4,12,16,25.0%,28m
28206,2,FSDF,1972,197,4,12,16,25.0%,1h
28206,1,[大爱星际二]好男人越哥,1972,132,3,7,10,30.0%,16m
28206,3,宇智波阿飞,1972,0,0,1,1,0.0%,53m
28206,2,天不生林轩,1972,0,0,2,2,0.0%,13m
28206,1,未来之光,1972,0,0,3,3,0.0%,23m
28206,2,爸爸,1972,0,0,3,3,0.0%,13m
28218,1,尼古拉斯赵四,1971,692,34,54,88,38.6%,21m
28218,1,简单粗暴,1971,600,21,14,35,60.0%,1h
28218,3,死神的棒棒糖,1971,446,14,28,42,33.3%,1h
28218,1,[超合金战队]我在火星打星际,1971,46,2,1,3,66.7%,59m
28218,1,miss,1971,90,2,6,8,25.0%,43m
28218,3,梁永祺,1971,74,2,8,10,20.0%,1h
28218,1,[迷宫丨极限组]声音赛跑,1971,0,0,3,3,0.0%,15m
28225,1,bob,1970,1165,33,43,76,43.4%,11m
28225,1,小小程啊,1970,465,17,18,35,48.6%,1h
28225,2,无冬夜,1970,269,7,14,21,33.3%,28m
28225,1,dhj,1970,44,1,3,4,25.0%,1h
28225,3,[一块晶体矿]叶落花之梦,1970,30,1,4,5,20.0%,60m
28225,3,波斯曼大恐龙,1970,0,0,1,1,0.0%,38m
28225,3,从不移动的小探机,1970,0,0,2,2,0.0%,54m
28225,3,haha,1970,0,0,4,4,0.0%,1h
28233,1,王籽,1969,899,25,41,66,37.9%,1h
28233,1,北方的狼,1969,498,25,42,67,37.3%,1h
28233,1,是哥哥的小棉袄,1969,661,20,22,42,47.6%,46m
28233,3,时间,1969,240,10,7,17,58.8%,9m
28233,1,Irwin,1969,372,9,18,27,33.3%,1h
28233,3,fine,1969,0,1,4,5,20.0%,1h
28239,3,子凌,1968,1564,57,83,140,40.7%,1h
28239,3,wwe,1968,581,19,35,54,35.2%,1h
28239,1,天帝洛,1968,247,6,9,15,40.0%,43m
28239,2,拿破里奥尼,1968,210,6,17,23,26.1%,17m
28239,3,Zoeforheart,1968,44,2,5,7,28.6%,1h
28239,3,汀董掌晟,1968,30,1,4,5,20.0%,54m
28239,3,农民,1968,0,0,1,1,0.0%,1h
28239,3,坦克黄玉,1968,0,0,3,3,0.0%,8m
28247,3,[DSE]横刀立马向天笑,1967,177,12,14,26,46.2%,53m
28247,1,[永恒之环]darknessking,1967,308,7,5,12,58.3%,43m
28247,1,我爱物理,1967,201,5,4,9,55.6%,16m
28247,3,[WNM]星河将军,1967,126,5,10,15,33.3%,4m
28247,3,asd,1967,0,3,3,6,50.0%,19m
28247,2,仙人板板,1967,96,2,2,4,50.0%,1h
28253,1,星际,1966,372,9,13,22,40.9%,40m
28253,3,Qualony,1966,34,3,4,7,42.9%,1h
28253,1,我真的不会玩诺娃,1966,90,2,2,4,50.0%,40m
28253,1,起个名字要好久,1966,48,2,3,5,40.0%,18m
28253,3,辽宁舰,1966,0,2,3,5,40.0%,1h
28253,2,小可爱,1966,42,1,4,5,20.0%,1h
28259,3,insight,1965,323,21,25,46,45.7%,23m
28259,3,稚气老妈,1965,389,14,25,39,35.9%,57m
28259,3,[失落之光]木心,1965,58,2,6,8,25.0%,10m
28259,3,qwer,1965,30,2,7,9,22.2%,1h
28259,1,我女神叫夏小小,1965,0,1,0,1,100.0%,1h
28259,3,TeRiRi,1965,0,0,1,1,0.0%,1h
28265,1,MITO,1964,224,6,9,15,40.0%,15m
28265,3,金色利刃,1964,156,5,11,16,31.2%,1h
28265,1,Metaco,1964,172,4,5,9,44.4%,12m
28265,1,天翼,1964,44,2,4,6,33.3%,1h
28265,1,wyllkx,1964,0,0,1,1,0.0%,28m
28265,1,ASDV,1964,0,0,2,2,0.0%,28m
28265,1,JAlovestear,1964,0,0,3,3,0.0%,1h
28265,3,从来没有放弃,1964,0,0,4,4,0.0%,1h
28273,2,[CPT]sky,1963,1199,46,56,102,45.1%,35m
28273,3,阿巴,1963,616,28,45,73,38.4%,10m
28273,2,一方之鹏,1963,282,7,12,19,36.8%,40m
28273,3,山茶花爿元宵,1963,94,4,13,17,23.5%,39m
28273,1,[底特律KAR]你的时间归我了,1963,87,3,3,6,50.0%,1h
28273,1,海底的菠萝屋,1963,46,3,12,15,20.0%,39m
28273,1,李氏家族,1963,0,1,0,1,100.0%,1h
28280,3,小贾超凶哒,1962,484,16,18,34,47.1%,1h
28280,1,[星际2再见]空缺,1962,389,11,20,31,35.5%,28m
28280,1,faker,1962,135,2,5,7,28.6%,9m
28280,3,MarsRondldo,1962,30,1,1,2,50.0%,19m
28280,2,永恒天幕,1962,0,1,9,10,10.0%,56m
28280,3,阿玛歌,1962,0,0,1,1,0.0%,19m
28280,1,红军统帅,1962,0,0,1,1,0.0%,12m
28287,1,[键盘冒毒奶]三毛找托尼,1961,666,20,27,47,42.6%,59m
28287,1,[久美子文具店]鹏鹏,1961,602,19,27,46,41.3%,17m
28287,1,Gin,1961,271,6,15,21,28.6%,1h
28287,1,[KK开]大海幻想,1961,92,2,2,4,50.0%,39m
28287,3,斯大林,1961,0,1,1,2,50.0%,24m
28287,3,哈哈哈,1961,30,1,7,8,12.5%,27m
28287,3,榴莲炒饭,1961,38,1,7,8,12.5%,1h
28287,3,JUEhe,1961,0,0,5,5,0.0%,8m
28295,3,神之不和,1960,381,19,13,32,59.4%,29m
28295,2,[Galet]gosh,1960,468,19,30,49,38.8%,20m
28295,1,灭霸,1960,598,17,18,35,48.6%,1h
28295,1,元首大人,1960,590,15,23,38,39.5%,1h
28295,3,小小文姬的澜朋友,1960,46,2,6,8,25.0%,38m
28295,1,wait,1960,46,1,1,2,50.0%,9m
28301,3,九资河一哥,1959,940,30,48,78,38.5%,23m
28301,1,沉默的洒脱,1959,362,13,8,21,61.9%,59m
28301,1,Cynicism,1959,352,13,16,29,44.8%,23m
28301,1,虹桥,1959,409,13,20,33,39.4%,1h
28301,3,潜蛙影潮怒倾倒,1959,94,6,8,14,42.9%,1h
28301,3,无他,1959,74,4,9,13,30.8%,1h
28301,2,demaxiya,1959,84,3,5,8,37.5%,1h
28301,1,五道,1959,86,2,1,3,66.7%,12m
28301,3,星空下的传说,1959,30,2,7,9,22.2%,1h
28301,2,会飞的小子弹,1959,88,1,3,4,25.0%,57m
28301,3,飛天御妹流,1959,30,1,7,8,12.5%,1h
28301,3,神武冰锋,1959,0,0,6,6,0.0%,8m
28301,3,ciwomuli,1959,0,0,6,6,0.0%,54m
28314,3,[maijer]maijer,1958,790,27,45,72,37.5%,9m
28314,1,夕颜,1958,223,8,16,24,33.3%,46m
28314,1,摩诃萨,1958,218,5,6,11,45.5%,1h
28314,3,[667]巫雪禅,1958,190,5,8,13,38.5%,15m
28314,3,催眠联盟,1958,30,3,8,11,27.3%,19m
28314,2,真香,1958,48,2,10,12,16.7%,40m
28314,1,会喵叫的狐狸,1958,0,1,0,1,100.0%,14m
28314,3,白垩,1958,30,1,1,2,50.0%,60m
28314,1,丶花花,1958,44,1,2,3,33.3%,1h
28314,1,arduo,1958,46,1,8,9,11.1%,59m
28324,3,kisslove,1957,762,32,42,74,43.2%,1h
28324,3,毛哥不要钱,1957,354,12,16,28,42.9%,1h
28324,3,nzk,1957,237,10,14,24,41.7%,1h
28324,3,zichen,1957,204,8,20,28,28.6%,15m
28324,1,朱道宽,1957,264,7,5,12,58.3%,27m
28324,3,乖哈还能,1957,0,4,2,6,66.7%,1h
28324,2,一城,1957,146,3,9,12,25.0%,54m
28324,3,寂静如雨,1957,30,1,1,2,50.0%,1h
28324,2,辰未明,1957,0,0,1,1,0.0%,33m
28324,1,女装大佬吴天一,1957,0,0,1,1,0.0%,59m
28334,1,阿斯达,1956,462,11,11,22,50.0%,46m
28334,3,东海戴鱼,1956,243,8,10,18,44.4%,1h
28334,1,liget,1956,227,7,7,14,50.0%,12m
28334,2,无畏要塞,1956,209,5,13,18,27.8%,40m
28334,1,[自在清风]青缡绣,1956,142,4,5,9,44.4%,59m
28334,2,ACDC,1956,116,3,4,7,42.9%,1h
28334,3,[小仙女上线啦]漠视,1956,0,1,0,1,100.0%,1h
28334,1,哇咔咔哟哈哈,1956,0,0,2,2,0.0%,12m
28334,3,这姑娘真好看,1956,0,0,7,7,0.0%,12m
28343,3,乐言神族很菜,1955,1028,62,79,141,44.0%,10m
28343,1,六边形战士,1955,795,24,30,54,44.4%,1h
28343,3,余生,1955,484,21,31,52,40.4%,12m
28343,1,ghjdfjdj,1955,527,12,23,35,34.3%,28m
28343,1,乔锐,1955,362,9,11,20,45.0%,40m
28343,2,zhzalpha,1955,163,5,6,11,45.5%,54m
28343,1,[奈落]HNB,1955,44,2,0,2,100.0%,1h
28343,3,血族刀锋,1955,0,1,0,1,100.0%,1h
28343,1,[镜花水月]徐大爷,1955,48,1,3,4,25.0%,9m
28343,2,问题学生,1955,0,0,3,3,0.0%,1h
28353,3,我逆天,1954,1204,113,142,255,44.3%,18m
28353,2,舰队国际看门大爷,1954,1377,69,98,167,41.3%,1h
28353,3,肥硕的幻影,1954,407,37,49,86,43.0%,57m
28353,3,残云,1954,412,15,18,33,45.5%,27m
28353,1,Marshal,1954,0,1,1,2,50.0%,1h
28353,1,[燃烧的阴影]腾龙青月,1954,0,1,1,2,50.0%,13m
28353,2,agoin,1954,46,1,11,12,8.3%,1h
28353,1,带善人张三,1954,0,0,1,1,0.0%,11m
28353,3,弱音,1954,0,0,1,1,0.0%,1h
28353,1,LAOWANG,1954,0,0,1,1,0.0%,19m
28353,3,晚安,1954,0,0,5,5,0.0%,1h
28364,3,EvieFrye,1953,1091,40,60,100,40.0%,1h
28364,1,Zealot,1953,365,13,23,36,36.1%,1h
28364,1,haha,1953,242,7,7,14,50.0%,1h
28364,1,NJRR,1953,218,5,9,14,35.7%,1h
28364,3,快递员,1953,0,3,4,7,42.9%,1h
28364,2,JED,1953,157,3,5,8,37.5%,56m
28364,3,丁残臣,1953,30,1,2,3,33.3%,60m
28364,1,[17CM]snowman,1953,0,0,1,1,0.0%,40m
28372,3,冰雨的风暴,1952,388,13,27,40,32.5%,1h
28372,1,[菜有菜的道理]大点,1952,492,12,25,37,32.4%,17m
28372,2,[SC2战队]黄易堂,1952,336,11,31,42,26.2%,54m
28372,3,dadadad,1952,270,8,14,22,36.4%,57m
28372,2,fgghbdc,1952,154,3,8,11,27.3%,54m
28372,3,鱼朝奉,1952,78,2,11,13,15.4%,19m
28372,1,baqian,1952,44,1,1,2,50.0%,1h
28372,3,自由之翼,1952,0,1,1,2,50.0%,1h
28372,1,ttttt,1952,46,1,3,4,25.0%,18m
28372,1,是你的可爱多,1952,0,0,1,1,0.0%,1h
28382,1,万渊,1951,402,11,11,22,50.0%,1h
28382,3,卖萌傻桃子,1951,138,5,4,9,55.6%,1h
28382,1,[6211]张鱼丸,1951,218,5,9,14,35.7%,18m
28382,1,dad,1951,0,2,10,12,16.7%,25m
28382,2,鱼丸粗面,1951,0,1,7,8,12.5%,1h
28387,3,PPSUC,1950,688,29,49,78,37.2%,1h
28387,1,电脑非常困难,1950,937,26,33,59,44.1%,59m
28387,3,[明亮堂]ahahaha,1950,387,12,17,29,41.4%,1h
28387,2,神圣巨像,1950,257,9,9,18,50.0%,13m
28387,1,琛爷,1950,362,9,12,21,42.9%,40m
28387,1,龙皇,1950,202,4,1,5,80.0%,1h
28387,2,开心,1950,0,1,4,5,20.0%,1h
28387,2,[征服一切]伟伟大仙,1950,0,1,9,10,10.0%,1h
28387,3,墨痕丿未染,1950,0,0,1,1,0.0%,8m
28387,3,大橘喵,1950,0,0,6,6,0.0%,54m
28397,1,eazy,1949,288,7,5,12,58.3%,17m
28397,1,[天门]清风,1949,44,2,4,6,33.3%,18m
28397,1,cainingluan,1949,0,0,1,1,0.0%,59m
28400,3,狼群部落,1948,269,20,26,46,43.5%,1h
28400,2,丝瓜,1948,540,17,36,53,32.1%,20m
28400,2,丑陋躯壳,1948,213,7,5,12,58.3%,1h
28400,1,饮优,1948,78,2,4,6,33.3%,40m
28400,3,清天祭,1948,0,0,7,7,0.0%,1h
28405,3,yaobao,1947,134,5,7,12,41.7%,1h
28405,1,在此之间,1947,224,5,8,13,38.5%,15m
28405,3,[塑料兄弟情]SIRION,1947,30,1,5,6,16.7%,1h
28405,1,epicevent,1947,0,0,2,2,0.0%,27m
28405,3,小兵,1947,0,0,2,2,0.0%,1h
28410,2,斗武神,1946,1514,167,194,361,46.3%,27m
28410,3,游侠,1946,1502,123,153,276,44.6%,1h
28410,3,[Micer]surprised,1946,592,21,33,54,38.9%,29m
28410,1,nnggg,1946,316,8,10,18,44.4%,1h
28410,1,青灯锁禁天下魂,1946,134,5,15,20,25.0%,1h
28410,3,PAPAPA,1946,60,4,8,12,33.3%,53m
28410,1,[笙风]Scarlett,1946,144,3,10,13,23.1%,1h
28410,1,金灬金,1946,96,2,11,13,15.4%,1h
28410,2,要你命叁仟,1946,0,1,9,10,10.0%,1h
28410,1,sktdad,1946,0,0,3,3,0.0%,1h
28420,1,[大洋彼岸团队]jkljlj,1945,748,20,24,44,45.5%,13m
28420,1,凶狠的大鲨鱼,1945,281,7,20,27,25.9%,1h
28420,1,PSUCK,1945,138,4,6,10,40.0%,1h
28420,1,绝望中想起了换家,1945,132,3,7,10,30.0%,1h
28420,3,雨屋红胡子,1945,0,0,1,1,0.0%,60m
28420,2,wjjj,1945,0,0,1,1,0.0%,35m
28420,1,Storm,1945,0,0,1,1,0.0%,1h
28420,2,三族之王,1945,0,0,3,3,0.0%,58m
28428,3,紫月翼魂,1944,674,28,37,65,43.1%,1h
28428,1,哈哈哈,1944,405,13,23,36,36.1%,1h
28428,1,二分之一,1944,260,6,10,16,37.5%,43m
28428,3,GRV,1944,84,4,4,8,50.0%,1h
28428,3,Stelatin,1944,0,0,5,5,0.0%,1h
28433,3,水北流,1943,625,52,63,115,45.2%,1h
28433,2,[拯救孤独]我是卧底,1943,1017,45,59,104,43.3%,1h
28433,1,Make,1943,229,6,15,21,28.6%,40m
28433,1,Tioac,1943,122,3,4,7,42.9%,1h
28433,1,王者必秃,1943,0,0,1,1,0.0%,1h
28433,1,neal,1943,0,0,1,1,0.0%,1h
28439,1,鹏彭砰,1942,870,40,51,91,44.0%,47m
28439,1,卿晨不太白,1942,372,12,17,29,41.4%,59m
28439,1,似初,1942,358,10,8,18,55.6%,1h
28439,1,雷诺的爷爷,1942,387,10,10,20,50.0%,1h
28439,1,垃圾,1942,242,7,4,11,63.6%,13m
28439,3,吕玲琦,1942,0,1,0,1,100.0%,1h
28439,2,Malygos,1942,0,1,8,9,11.1%,35m
28446,2,今天礼拜七,1941,698,21,38,59,35.6%,1h
28446,1,沫小陌,1941,285,10,11,21,47.6%,1h
28446,3,[笙风]柠檬橘子说拜拜,1941,254,8,13,21,38.1%,1h
28446,1,看画听风雨,1941,302,7,11,18,38.9%,18m
28446,3,[慢手e族]MRABC,1941,112,3,11,14,21.4%,1h
28446,3,贵州普华制药,1941,0,1,0,1,100.0%,1h
28446,1,花田杏子,1941,0,0,1,1,0.0%,40m
28446,1,jimmyke,1941,0,0,2,2,0.0%,1h
28454,3,GHGG,1940,114,3,12,15,20.0%,1h
28454,3,翰林墨雨,1940,34,2,2,4,50.0%,1h
28454,2,Clarence,1940,0,0,2,2,0.0%,1h
28454,1,时光待我如旅人,1940,0,0,7,7,0.0%,40m
28458,2,trhuqq,1939,806,27,44,71,38.0%,52m
28458,2,星灵狂战士,1939,172,6,14,20,30.0%,28m
28458,1,桃司令,1939,162,5,5,10,50.0%,52m
28458,1,开心,1939,84,3,0,3,100.0%,23m
28458,1,[Seul]镀锌管,1939,88,3,5,8,37.5%,1h
28458,1,gejunyi,1939,0,1,1,2,50.0%,1h
28458,2,mieba,1939,0,1,7,8,12.5%,13m
28458,3,[秀播立昂号]人气主播茄碧萝,1939,0,0,6,6,0.0%,38m
28466,2,李嘉图,1938,195,5,12,17,29.4%,1h
28466,1,wangwangkan,1938,205,3,7,10,30.0%,1h
28466,2,温州骷髅,1938,102,3,9,12,25.0%,1h
28466,3,[城管精英]jacky,1938,0,0,1,1,0.0%,1h
28470,2,天下乌鸦,1937,1405,56,69,125,44.8%,1h
28470,1,新人轻点,1937,1628,48,68,116,41.4%,10m
28470,1,三无先生,1937,1055,34,37,71,47.9%,1h
28470,1,[XYFANS]识花认雪,1937,510,13,23,36,36.1%,1h
28470,3,孙悟空大战灭霸,1937,186,7,3,10,70.0%,54m
28470,2,小可爱咪咪,1937,161,5,12,17,29.4%,1h
28470,3,死神,1937,38,3,4,7,42.9%,53m
28470,2,[醉御江山]濯轩,1937,74,3,5,8,37.5%,35m
28470,3,史尔特尔永远滴神,1937,0,2,6,8,25.0%,1h
28470,1,洛德,1937,0,0,2,2,0.0%,1h
28480,3,外号非对称选手,1936,1529,183,258,441,41.5%,1h
28480,1,柔情狮子座,1936,627,17,28,45,37.8%,52m
28480,1,ddfh,1936,281,7,4,11,63.6%,27m
28480,2,kimc,1936,194,6,15,21,28.6%,28m
28480,1,Jopiter,1936,86,2,1,3,66.7%,1h
28480,3,陨侍尘,1936,76,2,6,8,25.0%,53m
28480,1,灭霸,1936,0,1,0,1,100.0%,16m
28480,3,淤白,1936,0,0,3,3,0.0%,1h
28480,1,[火焰雷兽]怪怪怪怪,1936,0,0,4,4,0.0%,1h
28489,1,三个点,1935,719,20,35,55,36.4%,13m
28489,3,LDZXM,1935,530,17,32,49,34.7%,11m
28489,1,尛夵,1935,530,13,20,33,39.4%,17m
28489,1,djwlk,1935,170,4,2,6,66.7%,40m
28489,2,星际小王子,1935,0,0,2,2,0.0%,1h
28489,3,深渊鸣雪,1935,0,0,5,5,0.0%,8m
28495,3,llllllllllll,1934,623,59,90,149,39.6%,27m
28495,2,Sunflower,1934,30,1,6,7,14.3%,33m
28497,3,宇宙大帝,1933,1490,101,110,211,47.9%,1h
28497,2,DZN,1933,205,6,6,12,50.0%,17m
28497,3,孤行,1933,175,5,9,14,35.7%,1h
28497,1,sunshine,1933,128,3,5,8,37.5%,1h
28497,1,天天向上,1933,114,2,4,6,33.3%,1h
28497,1,平凡,1933,0,1,0,1,100.0%,1h
28497,3,爱丢核弹的小男孩,1933,0,0,1,1,0.0%,19m
28497,1,暗影卫队,1933,0,0,1,1,0.0%,1h
28505,3,DASHEN,1932,456,18,31,49,36.7%,27m
28505,1,卵太痒,1932,317,7,19,26,26.9%,1h
28505,1,[斗鱼大纲]feng,1932,0,1,2,3,33.3%,9m
28505,3,斯蒂芬,1932,0,0,1,1,0.0%,54m
28505,3,太白丶,1932,0,0,2,2,0.0%,19m
28510,2,碧海长风,1931,84,3,9,12,25.0%,54m
28510,1,[学姐赛高]云玩家鲲鲲,1931,0,0,1,1,0.0%,40m
28510,1,AITAR,1931,0,0,4,4,0.0%,1h
28510,2,一生一世一双人,1931,0,0,4,4,0.0%,1h
28514,3,爱宁,1930,1078,157,202,359,43.7%,49m
28514,1,MacXYsed,1930,402,11,24,35,31.4%,46m
28514,2,DoctorM,1930,102,3,0,3,100.0%,19m
28514,1,蒙哥马利,1930,44,1,5,6,16.7%,13m
28514,3,嘟吧哒,1930,30,1,7,8,12.5%,1h
28514,1,[29CM]西伯利亚天狼星,1930,73,0,2,2,0.0%,52m
28520,3,七圣,1929,840,78,95,173,45.1%,9m
28520,2,SJHJDH,1929,120,3,0,3,100.0%,28m
28520,3,小傻,1929,0,0,9,9,0.0%,1h
28523,2,POPNEW,1928,218,5,14,19,26.3%,58m
28523,3,锡北上将,1928,70,3,2,5,60.0%,19m
28523,1,CNDA,1928,44,2,3,5,40.0%,1h
28523,2,电脑,1928,0,1,1,2,50.0%,1h
28523,3,drem,1928,30,1,9,10,10.0%,24m
28523,3,Schrodinger,1928,0,0,1,1,0.0%,60m
28529,1,执政官,1927,1354,45,63,108,41.7%,1h
28529,1,zqmanb,1927,950,26,34,60,43.3%,1h
28529,3,[小菜逼]鑫怀天下,1927,194,6,9,15,40.0%,9m
28529,3,一望便是蓬州,1927,0,2,3,5,40.0%,1h
28529,3,诺斯,1927,0,1,4,5,20.0%,1h
28529,1,粽子君,1927,0,0,1,1,0.0%,28m
28529,1,河东霸王龙,1927,0,0,1,1,0.0%,52m
28536,3,hhhh,1926,1506,56,82,138,40.6%,4m
28536,1,大须弥锤,1926,333,27,24,51,52.9%,12m
28536,3,怀恋小白,1926,156,12,19,31,38.7%,1h
28536,2,这个杀手不太冷,1926,90,3,9,12,25.0%,58m
28536,2,ppt,1926,46,2,10,12,16.7%,1h
28536,1,裂开,1926,0,1,2,3,33.3%,10m
28536,1,小白是总攻,1926,0,0,3,3,0.0%,15m
28543,3,她曾经来过,1925,389,17,24,41,41.5%,39m
28543,2,黑麦草,1925,82,3,11,14,21.4%,1h
28543,1,[CPT]xiaoliu,1925,44,2,7,9,22.2%,1h
28543,3,kokoa,1925,30,1,5,6,16.7%,1h
28543,2,GFDASGS,1925,0,0,6,6,0.0%,1h
28548,3,土豆指挥官,1924,1323,82,108,190,43.2%,1h
28548,2,菜鸡,1924,1387,56,73,129,43.4%,30m
28548,2,tassader,1924,225,8,11,19,42.1%,1h
28548,3,Laoyuuuuu,1924,99,7,13,20,35.0%,1h
28548,2,nmtg,1924,192,4,6,10,40.0%,56m
28548,3,[在下菜鸡一只]大源,1924,88,3,2,5,60.0%,1h
28548,3,默玄,1924,0,0,1,1,0.0%,1h
28548,3,星际,1924,0,0,1,1,0.0%,1h
28548,1,lxwforever,1924,0,0,9,9,0.0%,1h
28557,3,Zac,1923,601,22,37,59,37.3%,1h
28557,1,haohaochi,1923,588,14,21,35,40.0%,12m
28557,2,灵梦,1923,190,6,4,10,60.0%,1h
28557,2,冰霜闪耀之剑,1923,220,6,15,21,28.6%,54m
28557,1,[喵帕斯喵]AstroPU,1923,92,2,4,6,33.3%,1h
28557,1,心灵突稽队,1923,0,1,0,1,100.0%,59m
28557,3,低温,1923,30,1,1,2,50.0%,1h
28557,2,幻世如梦,1923,92,1,9,10,10.0%,1h
28557,1,mteu,1923,0,0,1,1,0.0%,1h
28557,3,服服服,1923,0,0,1,1,0.0%,1h
28557,1,ldqk,1923,0,0,2,2,0.0%,1h
28568,3,花哥哥在此,1922,236,9,22,31,29.0%,10m
28568,2,帝国,1922,191,5,12,17,29.4%,56m
28568,3,来辆劳斯莱斯,1922,90,5,17,22,22.7%,1h
28568,1,balance,1922,0,1,2,3,33.3%,1h
28568,3,为了自由,1922,0,0,1,1,0.0%,1h
28568,1,战神无敌,1922,0,0,2,2,0.0%,1h
28574,3,好男人,1921,556,21,23,44,47.7%,1h
28574,1,暗影之龙,1921,316,11,15,26,42.3%,52m
28574,1,车干轩,1921,362,9,14,23,39.1%,1h
28574,2,小板砖,1921,128,4,10,14,28.6%,56m
28574,1,aspid,1921,90,2,5,7,28.6%,13m
28574,2,家有小公举,1921,44,2,12,14,14.3%,35m
28574,1,[双刺]灵龟死不了,1921,96,1,6,7,14.3%,1h
28581,1,多肉动物,1920,172,5,3,8,62.5%,9m
28581,1,Citrus,1920,166,4,5,9,44.4%,15m
28581,1,[暴雪十队]野战军三团,1920,44,1,2,3,33.3%,1h
28581,2,荣耀,1920,0,1,9,10,10.0%,1h
28581,3,一个大炮,1920,0,0,6,6,0.0%,53m
28581,3,陌陌浅浅,1920,0,0,7,7,0.0%,1h
28587,1,蒋晓炜,1919,537,15,22,37,40.5%,46m
28587,1,[月之所在RI]阿狸,1919,321,9,12,21,42.9%,11m
28587,3,aeio,1919,162,5,8,13,38.5%,1h
28587,1,英雄连,1919,72,3,2,5,60.0%,18m
28587,3,新有灵犀一点通,1919,122,2,8,10,20.0%,39m
28587,1,伟强在线送分,1919,0,1,1,2,50.0%,10m
28587,2,君莫笑,1919,0,1,1,2,50.0%,28m
28587,1,宋瑞琦,1919,0,0,1,1,0.0%,17m
28595,1,无名氏,1918,1522,320,364,684,46.8%,41m
28595,1,[樱丘]srlre,1918,286,8,13,21,38.1%,1h
28595,3,[柑橘之息]白上吹雪,1918,228,7,14,21,33.3%,55m
28595,2,枫叶,1918,137,4,4,8,50.0%,56m
28595,1,[仓鼠党]小辣椒,1918,82,2,3,5,40.0%,1h
28595,3,Wzhong,1918,121,2,8,10,20.0%,23m
28595,1,就我,1918,44,1,4,5,20.0%,1h
28595,1,BingYou,1918,44,1,6,7,14.3%,40m
28595,2,[疯狂的农民]无边的海,1918,0,0,1,1,0.0%,54m
28595,3,羁绊,1918,0,0,1,1,0.0%,1h
28595,1,[KPG2]电竞蔡徐坤,1918,0,0,5,5,0.0%,1h
28595,3,落雨青衫,1918,0,0,6,6,0.0%,1h
28607,2,馒头就是力量,1917,1507,172,206,378,45.5%,14m
28607,3,SCBOY,1917,1328,82,109,191,42.9%,23m
28607,1,霸风云,1917,573,18,23,41,43.9%,1h
28607,1,不用怀疑不会,1917,326,10,13,23,43.5%,39m
28607,1,二手女人回收地,1917,264,6,19,25,24.0%,1h
28607,1,星际战神灬,1917,184,4,15,19,21.1%,52m
28607,3,艾尔之光,1917,0,0,2,2,0.0%,54m
28607,3,月亮捕手,1917,0,0,3,3,0.0%,1h
28607,1,牵着蜗牛去旅行,1917,0,0,5,5,0.0%,1h
28616,3,天恒,1916,1326,79,123,202,39.1%,1h
28616,1,[THRONE]killer,1916,1156,57,89,146,39.0%,1h
28616,2,TTTTTTTTTTT,1916,540,27,38,65,41.5%,30m
28616,1,林丑丑,1916,210,7,8,15,46.7%,1h
28616,2,TFX,1916,80,6,8,14,42.9%,1h
28616,1,热爱核平的人类,1916,105,3,5,8,37.5%,1h
28616,3,abbaa,1916,0,1,4,5,20.0%,1h
28623,3,颓废与堕落,1915,645,26,33,59,44.1%,1h
28623,1,pokuf,1915,782,24,35,59,40.7%,1h
28623,1,三角洲,1915,121,4,12,16,25.0%,1h
28623,1,努力努力上砖石,1915,48,1,6,7,14.3%,23m
28623,1,沉默的风暴,1915,0,0,2,2,0.0%,1h
28628,3,洪武级航空战舰,1914,75,7,9,16,43.8%,1h
28628,1,我大哥就爱喵喵喵,1914,46,2,4,6,33.3%,39m
28628,3,TIME,1914,30,1,2,3,33.3%,1h
28628,3,蛰龙已惊眠,1914,0,1,5,6,16.7%,1h
28628,3,discover,1914,0,0,6,6,0.0%,1h
28633,2,水卜樱,1913,1454,123,137,260,47.3%,31m
28633,3,千本樱丶翔月,1913,314,13,15,28,46.4%,27m
28633,3,撒大大缩短,1913,0,1,9,10,10.0%,55m
28636,1,初辰,1912,246,8,19,27,29.6%,1h
28636,2,jack,1912,115,2,4,6,33.3%,28m
28636,3,LoveKayla,1912,58,2,8,10,20.0%,1h
28636,3,啊杰,1912,0,1,2,3,33.3%,1h
28640,1,知时节,1911,549,13,16,29,44.8%,9m
28640,1,[菜有菜的道理]JOJO,1911,264,7,9,16,43.8%,12m
28640,1,leavers,1911,244,5,4,9,55.6%,1h
28640,1,gloryWang,1911,210,5,9,14,35.7%,1h
28640,2,ImiTation,1911,124,4,3,7,57.1%,33m
28640,2,花满楼,1911,0,3,6,9,33.3%,1h
28640,2,洛伊德,1911,36,2,5,7,28.6%,1h
28640,3,山东舰,1911,80,2,9,11,18.2%,1h
28640,1,求打,1911,48,1,2,3,33.3%,39m
28649,3,ASHBDAJDBK,1910,262,8,19,27,29.6%,1h
28649,1,刘大力,1910,250,6,10,16,37.5%,12m
28649,2,秦帅,1910,156,3,12,15,20.0%,56m
28649,3,龙剑,1910,0,0,1,1,0.0%,1h
28649,3,evil,1910,0,0,7,7,0.0%,53m
28649,3,一人行者逆风行,1910,0,0,7,7,0.0%,1h
28655,2,看见了看见了,1909,1510,371,477,848,43.8%,1h
28655,1,草原最美的狒,1909,761,22,40,62,35.5%,1h
28655,1,闽商,1909,381,11,21,32,34.4%,43m
28655,1,隐存,1909,241,10,11,21,47.6%,1h
28655,2,HsKTSV,1909,0,1,0,1,100.0%,17m
28655,1,八方大爷,1909,0,0,2,2,0.0%,14m
28661,3,rob,1908,618,40,52,92,43.5%,57m
28661,2,冬兵,1908,991,39,62,101,38.6%,15m
28661,1,youwillgoal,1908,647,22,39,61,36.1%,36m
28661,1,奶布不吃瓜,1908,467,18,17,35,51.4%,40m
28661,1,YFfinger,1908,297,9,16,25,36.0%,1h
28661,2,中国的玩家的未来,1908,202,4,10,14,28.6%,1h
28661,2,正字满大腿,1908,46,2,4,6,33.3%,33m
28661,1,[电竞杨永信1]Sakura,1908,0,1,2,3,33.3%,1h
28661,3,[東方心念語]屑之魔女,1908,0,0,1,1,0.0%,1h
28670,3,小强,1907,108,22,25,47,46.8%,9m
28670,3,ShiLing,1907,647,20,33,53,37.7%,9m
28670,3,[TTZ]lddeck,1907,154,5,6,11,45.5%,1h
28670,1,和矣上雄,1907,86,2,3,5,40.0%,1h
28670,3,青枫未染不知秋,1907,68,2,9,11,18.2%,1h
28675,2,肥牛,1906,234,7,14,21,33.3%,1h
28675,1,墨染素衣,1906,204,6,3,9,66.7%,13m
28675,3,ling,1906,71,6,19,25,24.0%,46m
28675,2,兰亭已矣,1906,40,1,6,7,14.3%,14m
28679,2,哇塞,1905,212,8,11,19,42.1%,1h
28679,1,新手屠夫,1905,243,7,4,11,63.6%,1h
28679,3,无名,1905,146,5,9,14,35.7%,1h
28679,3,石牌张学友,1905,154,5,10,15,33.3%,1h
28679,2,杨好好,1905,195,5,14,19,26.3%,1h
28679,2,暴雪公司,1905,0,2,8,10,20.0%,56m
28679,1,liberty,1905,0,1,0,1,100.0%,13m
28686,3,lunior,1904,1462,122,158,280,43.6%,1h
28686,1,一往无前,1904,408,11,20,31,35.5%,59m
28686,1,xiaofu,1904,249,7,10,17,41.2%,15m
28686,1,DEVIL,1904,254,7,18,25,28.0%,1h
28686,3,[暴雪二十九队]萌萌哒的灌汤包,1904,68,2,10,12,16.7%,53m
28686,3,超亿覆盖,1904,0,0,2,2,0.0%,1h
28692,3,王中王,1903,1191,46,55,101,45.5%,1h
28692,3,[似有似无]黑蝠魔皇,1903,768,38,45,83,45.8%,23m
28692,3,相忘于江湖,1903,681,23,35,58,39.7%,15m
28692,1,zONEz,1903,340,8,10,18,44.4%,1h
28692,1,[Legacy]TLRiesz,1903,296,8,21,29,27.6%,19m
28692,3,马化腾,1903,247,6,18,24,25.0%,12m
28692,3,Zachariah,1903,0,2,4,6,33.3%,8m
28692,3,上杉绘梨衣,1903,0,0,1,1,0.0%,1h
28700,3,LJb,1902,130,4,8,12,33.3%,1h
28700,1,Piporuakeiso,1902,0,0,1,1,0.0%,17m
28700,1,KZGtime,1902,0,0,1,1,0.0%,1h
28703,3,EASON,1901,705,22,42,64,34.4%,43m
28703,1,海盗神威,1901,222,6,4,10,60.0%,1h
28703,3,请勿理解,1901,30,3,5,8,37.5%,1h
28703,1,金得利,1901,86,3,6,9,33.3%,27m
28703,1,午夜鑫鑫,1901,0,3,8,11,27.3%,1h
28703,1,火炮队,1901,75,2,3,5,40.0%,1h
28703,3,Thebest,1901,0,1,1,2,50.0%,19m
28703,1,战神刑天,1901,44,1,3,4,25.0%,1h
28711,1,义公,1900,44,2,3,5,40.0%,1h
28711,3,[纵丨横]empor,1900,62,2,7,9,22.2%,1h
28711,3,hcx,1900,46,1,2,3,33.3%,1h
28711,2,呵呵哒,1900,93,1,3,4,25.0%,13m
28715,3,Gaizi,1899,809,91,124,215,42.3%,1h
28715,3,篮坛权志龙,1899,595,19,35,54,35.2%,43m
28715,1,一念山河成,1899,314,12,17,29,41.4%,43m
28715,3,玉秀,1899,122,3,12,15,20.0%,1h
28715,1,老狼大盘鸡,1899,0,0,1,1,0.0%,1h
28715,1,[古韵]猫塚千夜,1899,0,0,1,1,0.0%,59m
28715,1,中中航,1899,0,0,2,2,0.0%,1h
28722,1,Hknsg,1898,88,3,4,7,42.9%,1h
28722,3,konodioda,1898,32,1,7,8,12.5%,1h
28724,1,花开如梦,1897,0,1,0,1,100.0%,17m
28724,3,royi,1897,34,1,4,5,20.0%,1h
28724,3,TIMBA,1897,0,0,6,6,0.0%,1h
28727,3,暗影牧师,1896,553,23,30,53,43.4%,1h
28727,1,承太郎,1896,457,14,24,38,36.8%,27m
28727,1,yiy,1896,437,11,11,22,50.0%,1h
28727,1,凡凡龙,1896,46,1,2,3,33.3%,1h
28727,1,叫我女王大人,1896,0,0,2,2,0.0%,18m
28727,3,速度说得对,1896,0,0,2,2,0.0%,1h
28733,1,IOXOI,1895,677,19,38,57,33.3%,10m
28733,1,混沌领主,1895,363,11,21,32,34.4%,1h
28733,3,[烽夜长歌]清水之源,1895,0,1,4,5,20.0%,1h
28733,3,怡和,1895,0,0,3,3,0.0%,1h
28737,1,Kuoman,1894,478,13,24,37,35.1%,1h
28737,3,tzhai,1894,348,11,26,37,29.7%,18m
28737,2,天漠系居居,1894,281,10,14,24,41.7%,1h
28737,1,XIAOHUA,1894,128,4,4,8,50.0%,1h
28737,1,[飘洋过海]Enheng,1894,84,3,1,4,75.0%,23m
28737,1,圣菲里尼,1894,169,3,16,19,15.8%,19m
28737,1,周杰伦,1894,0,1,2,3,33.3%,17m
28744,3,逍遥睡神,1893,629,24,33,57,42.1%,1h
28744,1,司马岚溪,1893,397,11,7,18,61.1%,15m
28744,3,小小旺,1893,188,6,7,13,46.2%,1h
28744,2,AAAA,1893,260,6,15,21,28.6%,1h
28744,1,帅气的秦兆琪,1893,209,6,18,24,25.0%,1h
28744,1,[至尊皇朝]我带你们打,1893,0,0,2,2,0.0%,1h
28744,3,cresc,1893,0,0,2,2,0.0%,1h
28751,3,吊打雨涵,1892,1156,38,63,101,37.6%,49m
28751,1,Bruce,1892,702,19,26,45,42.2%,12m
28751,3,[菜有菜的道理]常总,1892,536,16,27,43,37.2%,1h
28751,1,霹雳神州战神,1892,512,12,17,29,41.4%,11m
28751,2,[大宇恩]炸鱼的废物,1892,135,4,10,14,28.6%,58m
28751,1,鸟飞绝,1892,48,2,12,14,14.3%,23m
28751,3,邢封,1892,0,0,5,5,0.0%,25m
28751,3,王者小疯子,1892,0,0,7,7,0.0%,1h
28751,3,[黑暗王者]skyboy,1892,0,0,7,7,0.0%,1h
28760,2,阿南,1891,741,24,50,74,32.4%,1h
28760,3,龙铃,1891,419,12,23,35,34.3%,1h
28760,1,乱武,1891,260,7,9,16,43.8%,13m
28760,1,岁月埋葬爱,1891,186,5,4,9,55.6%,59m
28760,3,LRH,1891,0,0,3,3,0.0%,1h
28765,1,fade,1890,274,10,20,30,33.3%,12m
28765,1,舒克,1890,346,10,22,32,31.2%,1h
28765,3,获野狄佳,1890,222,8,18,26,30.8%,9m
28765,2,狗吠桑树颠,1890,36,2,6,8,25.0%,28m
28765,2,[S0S]萧苩莬,1890,42,2,11,13,15.4%,1h
28765,3,筷子击穿敌方马桶,1890,0,1,3,4,25.0%,19m
28765,3,七色乱舞刃,1890,0,0,7,7,0.0%,1h
28772,1,不灭之神,1889,947,28,39,67,41.8%,1h
28772,2,赵大仙,1889,723,27,40,67,40.3%,23m
28772,3,张顺飞,1889,324,19,20,39,48.7%,1h
28772,1,xue,1889,84,3,1,4,75.0%,15m
28772,3,尘埃,1889,96,2,8,10,20.0%,1h
28777,1,超兽武装,1888,34,1,5,6,16.7%,1h
28777,3,栋栋,1888,0,0,1,1,0.0%,1h
28779,1,我是你九哥,1887,1548,47,59,106,44.3%,1h
28779,3,yky,1887,170,7,10,17,41.2%,1h
28779,1,乾坤界主,1887,144,7,23,30,23.3%,1h
28782,3,idest,1886,116,4,10,14,28.6%,19m
28782,1,剑神萧镇锋,1886,188,4,17,21,19.0%,1h
28782,1,萧然,1886,76,3,4,7,42.9%,13m
28782,1,八月,1886,86,3,6,9,33.3%,1h
28782,3,YCPetch,1886,30,2,5,7,28.6%,1h
28782,3,Demons,1886,30,1,4,5,20.0%,60m
28788,2,xxj,1885,1422,88,125,213,41.3%,17m
28788,1,XinShou,1885,633,73,94,167,43.7%,1h
28788,2,DEIOG,1885,333,9,11,20,45.0%,1h
28788,3,Albert,1885,30,1,2,3,33.3%,1h
28788,2,mengli,1885,0,0,1,1,0.0%,13m
28793,1,叶恋禅,1884,348,11,10,21,52.4%,18m
28793,3,绍兴你迅哥,1884,58,3,4,7,42.9%,1h
28795,2,大好形势有,1883,0,1,0,1,100.0%,56m
28795,3,红花会丶胖爷,1883,0,1,1,2,50.0%,38m
28795,3,[新的蜜蜂]SOS,1883,36,1,2,3,33.3%,55m
28795,1,比利,1883,0,0,1,1,0.0%,1h
28795,3,杀无赦,1883,0,0,3,3,0.0%,1h
28800,1,迎风布阵,1882,267,10,19,29,34.5%,43m
28800,3,Coldfire,1882,152,5,8,13,38.5%,1h
28800,3,执着是爱的痛,1882,0,0,1,1,0.0%,1h
28803,1,不失尴尬的微笑,1881,826,21,35,56,37.5%,1h
28803,1,一只探姬,1881,95,1,1,2,50.0%,13m
28805,2,satellite,1880,1231,113,151,264,42.8%,1h
28805,1,[南开202]忒丰丰,1880,435,42,67,109,38.5%,1h
28805,1,伤心啊但是,1880,46,1,1,2,50.0%,23m
28808,3,baconhhh,1879,140,7,6,13,53.8%,19m
28808,1,冰雪,1879,0,0,1,1,0.0%,43m
28808,1,九零后空巢老人,1879,0,0,1,1,0.0%,17m
28808,3,mmmmmm,1879,0,0,1,1,0.0%,1h
28808,3,小丑,1879,0,0,9,9,0.0%,1h
28813,2,[NLHR]papa,1878,1507,62,92,154,40.3%,1h
28813,1,[M8]微恋之风,1878,754,24,28,52,46.2%,52m
28813,1,沧桑狐妖,1878,481,13,14,27,48.1%,1h
28813,1,WDNMD,1878,341,10,17,27,37.0%,27m
28813,2,莫话离殇,1878,236,6,16,22,27.3%,1h
28813,1,[瀚海无双]wangce,1878,0,0,1,1,0.0%,1h
28813,1,大大怪将军,1878,0,0,1,1,0.0%,40m
28820,3,太空找手,1877,303,9,16,25,36.0%,26m
28820,1,问号,1877,212,7,10,17,41.2%,1h
28820,1,cwwudi,1877,60,2,6,8,25.0%,1h
28820,3,永恒,1877,0,1,6,7,14.3%,1h
28824,3,药石无医,1876,352,12,24,36,33.3%,15m
28824,1,Artorias,1876,308,9,15,24,37.5%,23m
28824,2,[幺幺]Lucky,1876,236,7,14,21,33.3%,17m
28824,3,捣蛋鬼特别行动队,1876,0,0,7,7,0.0%,25m
28828,1,青铜雨下,1875,0,1,1,2,50.0%,23m
28828,3,gcy,1875,0,0,2,2,0.0%,25m
28828,1,爱笑的张先生,1875,0,0,3,3,0.0%,14m
28831,1,CYBRYANT,1874,150,5,5,10,50.0%,1h
28831,1,SHE,1874,0,0,2,2,0.0%,1h
28831,3,漓江塔塔主,1874,0,0,7,7,0.0%,1h
28834,1,[滴滴打人集团]蚩尤大人,1873,382,10,25,35,28.6%,59m
28834,2,邪酒君之幻烨,1873,88,2,1,3,66.7%,1h
28834,3,半夜黑,1873,38,1,8,9,11.1%,8m
28834,3,马骏,1873,0,0,1,1,0.0%,55m
28838,1,[暴雪养鸡场]夜占寡妇村,1872,130,3,4,7,42.9%,1h
28838,1,落无尘,1872,73,1,2,3,33.3%,15m
28840,1,梅尔维布,1871,1302,57,117,174,32.8%,1h
28840,1,turris,1871,457,18,35,53,34.0%,18m
28840,1,daotagou,1871,332,11,7,18,61.1%,43m
28840,1,Ghost,1871,295,8,5,13,61.5%,15m
28840,2,AAAA,1871,263,7,16,23,30.4%,1h
28840,3,DAHUA,1871,100,4,12,16,25.0%,1h
28840,3,柒轩,1871,0,1,0,1,100.0%,38m
28847,3,cry,1870,692,24,47,71,33.8%,1h
28847,2,战斗格式,1870,96,1,5,6,16.7%,1h
28849,1,劉八竡,1869,0,1,0,1,100.0%,1h
28849,1,枯叶蝶,1869,0,1,0,1,100.0%,15m
28849,1,Zimba,1869,96,1,1,2,50.0%,17m
28849,1,君临,1869,0,1,2,3,33.3%,1h
28853,1,SuperChinese,1868,174,4,13,17,23.5%,1h
28854,1,别把我按地上捶哈,1867,357,12,19,31,38.7%,10m
28854,1,蓝银唐,1867,361,10,13,23,43.5%,1h
28854,2,堕落空间,1867,287,10,20,30,33.3%,1h
28854,1,暗光,1867,90,2,3,5,40.0%,1h
28854,3,不吃香菜,1867,0,0,8,8,0.0%,1h
28859,1,春雷滚滚,1866,768,30,41,71,42.3%,1h
28859,1,huan,1866,420,18,14,32,56.2%,40m
28859,1,小菜鸟,1866,338,10,16,26,38.5%,1h
28859,1,aimm,1866,72,2,3,5,40.0%,1h
28859,1,吕吕吕同学,1866,0,1,1,2,50.0%,13m
28859,3,TilnyReajy,1866,0,0,7,7,0.0%,38m
28865,3,LANREN,1865,260,39,63,102,38.2%,1h
28865,3,慕容紫宸,1865,839,28,49,77,36.4%,11m
28865,1,真就只会白给,1865,163,6,11,17,35.3%,1h
28865,1,初夏,1865,42,2,5,7,28.6%,27m
28869,3,[极限菜鸟]RobinWu,1864,1305,85,100,185,45.9%,26m
28869,3,QWER,1864,94,4,8,12,33.3%,60m
28869,1,阿韦没死,1864,0,0,1,1,0.0%,1h
28869,1,姓吴字三桂,1864,0,0,1,1,0.0%,1h
28869,1,TERRENCE,1864,0,0,3,3,0.0%,1h
28874,1,Demon,1863,1571,80,115,195,41.0%,25m
28874,3,你八十岁的老父亲,1863,156,5,13,18,27.8%,8m
28874,3,来了老弟,1863,32,1,9,10,10.0%,1h
28874,1,[baoxue]壹分,1863,0,0,1,1,0.0%,25m
28874,3,joe,1863,0,0,4,4,0.0%,1h
28879,2,无敌铲子嘴,1862,142,4,6,10,40.0%,1h
28879,3,孤狼,1862,0,1,6,7,14.3%,1h
28881,3,[aboth]乌鲁克斧王,1861,168,5,7,12,41.7%,1h
28881,1,杀了我吧,1861,0,1,1,2,50.0%,1h
28881,3,卡尔达利斯,1861,0,0,1,1,0.0%,1h
28884,3,磊在,1860,183,6,20,26,23.1%,1h
28884,1,[仲花家]酷跑,1860,48,2,4,6,33.3%,14m
28886,1,农民,1859,1459,53,84,137,38.7%,23m
28886,1,小河北,1859,511,18,25,43,41.9%,1h
28886,1,AODI,1859,225,9,9,18,50.0%,1h
28886,1,ndfghdfg,1859,302,9,20,29,31.0%,17m
28886,1,心比天黑十倍,1859,48,1,4,5,20.0%,1h
28891,2,Excalibur,1858,162,7,13,20,35.0%,56m
28891,3,qwe,1858,88,5,7,12,41.7%,38m
28891,3,打趴丶李九九,1858,76,5,8,13,38.5%,1h
28891,1,白衣凰,1858,44,1,5,6,16.7%,19m
28891,1,啊哈,1858,73,0,2,2,0.0%,1h
28891,3,我好,1858,0,0,3,3,0.0%,1h
28897,1,大佬救我,1857,264,11,18,29,37.9%,15m
28897,1,梦与现实,1857,114,2,1,3,66.7%,25m
28897,3,逝去的唯美记忆,1857,0,1,1,2,50.0%,19m
28900,1,Dingdang,1856,30,1,4,5,20.0%,13m
28901,1,弁天女士,1855,92,2,4,6,33.3%,17m
28901,3,UZI,1855,32,2,5,7,28.6%,1h
28901,3,提不起劲的单推人,1855,64,2,10,12,16.7%,1h
28901,1,JOKE,1855,0,0,3,3,0.0%,44m
28905,1,我爱平底锅,1854,864,24,41,65,36.9%,44m
28905,1,站在我后面,1854,757,22,33,55,40.0%,1h
28905,3,橘里,1854,190,8,6,14,57.1%,53m
28905,1,恋倾心,1854,92,3,4,7,42.9%,28m
28905,1,tianya,1854,78,2,5,7,28.6%,1h
28905,3,为什么逼汗,1854,0,0,5,5,0.0%,1h
28905,3,hismoon,1854,0,0,6,6,0.0%,1h
28912,2,HAHA,1853,94,7,9,16,43.8%,1h
28912,1,林中野狐,1853,167,4,8,12,33.3%,1h
28912,3,亚美蝶,1853,0,1,3,4,25.0%,1h
28915,1,白嫖老师,1852,458,13,16,29,44.8%,1h
28915,1,筱焺,1852,73,0,3,3,0.0%,1h
28917,1,zscl,1851,216,5,6,11,45.5%,1h
28917,3,Traviss,1851,0,2,4,6,33.3%,1h
28917,2,TDZH,1851,0,1,2,3,33.3%,14m
28917,3,sqska,1851,0,0,1,1,0.0%,1h
28917,3,战神大兜虫,1851,0,0,1,1,0.0%,1h
28917,3,阿尔萨斯王子,1851,0,0,1,1,0.0%,1h
28917,3,无聊与无言,1851,0,0,1,1,0.0%,1h
28924,3,King,1850,406,14,23,37,37.8%,1h
28924,1,SORRY,1850,102,3,0,3,100.0%,44m
28924,3,LOUIS,1850,90,3,4,7,42.9%,1h
28924,3,搬砖炸人,1850,0,1,0,1,100.0%,1h
28924,1,小旭旭,1850,18,1,8,9,11.1%,1h
28924,3,莫里亚蒂教授,1850,0,0,3,3,0.0%,8m
28930,3,youzi,1849,30,4,2,6,66.7%,1h
28930,1,自闭怪,1849,106,2,10,12,16.7%,40m
28930,2,asd,1849,44,2,11,13,15.4%,57m
28930,1,哈恰玛恰玛心,1849,88,1,1,2,50.0%,9m
28934,1,DDD,1848,314,9,21,30,30.0%,52m
28934,1,华夏联盟南宮塗山,1848,0,1,1,2,50.0%,13m
28936,2,Police,1847,187,4,8,12,33.3%,1h
28937,1,摩羯之心,1846,470,14,26,40,35.0%,1h
28937,1,量子二踢脚,1846,0,1,0,1,100.0%,1h
28937,1,因为是战神,1846,0,0,3,3,0.0%,15m
28940,2,sujing,1845,138,5,13,18,27.8%,57m
28940,1,瑞羽蒙,1845,97,2,1,3,66.7%,1h
28942,2,不知道为什么,1844,305,12,11,23,52.2%,1h
28942,1,光芒蔽日,1844,237,8,18,26,30.8%,40m
28942,1,墨风,1844,134,5,19,24,20.8%,1h
28942,1,jjkkll,1844,0,1,0,1,100.0%,40m
28942,2,子非鱼,1844,88,1,1,2,50.0%,19m
28947,1,醉酒生,1843,404,12,18,30,40.0%,1h
28947,3,hbx,1843,126,6,8,14,42.9%,39m
28947,3,豆腐干,1843,0,1,1,2,50.0%,1h
28947,3,[社交学巨可爱]只有影子,1843,30,1,5,6,16.7%,1h
28947,3,夜雨声烦,1843,0,0,1,1,0.0%,25m
28952,3,没落尘埃,1842,424,16,24,40,40.0%,1h
28952,1,[CPT]蓝色乌云,1842,97,1,3,4,25.0%,9m
28952,1,[小心我咬死你]墨海狂魔,1842,48,1,5,6,16.7%,9m
28955,3,我能反杀,1841,0,0,4,4,0.0%,1h
28955,3,輕浮小情緒,1841,0,0,6,6,0.0%,1h
28955,3,创建角色名称,1841,0,0,6,6,0.0%,1h
28958,2,坎坎坷坷,1840,96,4,13,17,23.5%,57m
28958,3,夜幕,1840,30,1,2,3,33.3%,1h
28960,3,bssss,1839,212,8,13,21,38.1%,1h
28960,2,诗涵,1839,48,2,2,4,50.0%,1h
28960,2,guccialessio,1839,0,1,4,5,20.0%,56m
28960,2,穆溪,1839,89,1,6,7,14.3%,1h
28960,3,[无情突变王]守护,1839,0,0,1,1,0.0%,19m
28960,3,Hellkey,1839,0,0,1,1,0.0%,1h
28966,2,木头,1838,270,9,10,19,47.4%,28m
28966,1,countingstar,1838,301,9,23,32,28.1%,1h
28966,1,[葫芦娃救艾尔]WRNDG,1838,112,3,5,8,37.5%,59m
28969,2,JGenou,1837,126,4,1,5,80.0%,1h
28969,2,一无所知者,1837,0,1,0,1,100.0%,1h
28971,3,纳西小米,1836,1398,68,83,151,45.0%,1h
28971,2,三井旵昶,1836,30,1,1,2,50.0%,54m
28973,2,我需要治疗,1835,1095,158,209,367,43.1%,22m
28973,2,JTR,1835,282,12,23,35,34.3%,1h
28973,3,打我没妈,1835,0,3,4,7,42.9%,1h
28973,1,风起,1835,76,3,15,18,16.7%,14m
28973,3,小猪小强,1835,0,0,1,1,0.0%,60m
28973,3,苗二狗,1835,0,0,2,2,0.0%,1h
28979,2,魔法之龟,1834,132,4,3,7,57.1%,1h
28979,2,[兄弟和朋友]尚群龙叔叔,1834,0,3,6,9,33.3%,14m
28979,3,定天下,1834,80,2,2,4,50.0%,19m
28979,3,[日月神教]clearlove,1834,58,2,4,6,33.3%,1h
28979,3,啊啊呵蔡,1834,0,0,1,1,0.0%,39m
28979,2,心想事成,1834,0,0,1,1,0.0%,1h
28985,1,[EC]歪嘴战神,1833,818,21,38,59,35.6%,44m
28985,3,无尽的任务,1833,162,5,14,19,26.3%,53m
28985,3,哮嚣,1833,0,1,5,6,16.7%,1h
28985,2,伍拾贰赫兹,1833,0,0,1,1,0.0%,29m
28985,2,[江南暮雪]傻钱的暴躁老妈,1833,0,0,1,1,0.0%,1h
28985,3,黑色玄衣,1833,0,0,2,2,0.0%,1h
28985,1,[芽衣]金蛇霸王,1833,0,0,2,2,0.0%,11m
28985,3,[极限菜鸟]dawn,1833,0,0,9,9,0.0%,1h
28993,1,xcdhtxzs,1832,570,24,15,39,61.5%,25m
28993,2,艾欧斯,1832,238,7,20,27,25.9%,35m
28993,3,御霄凌宇,1832,134,6,8,14,42.9%,1h
28993,3,[DSE]醉梦前尘,1832,30,1,4,5,20.0%,1h
28993,2,影风,1832,0,0,1,1,0.0%,29m
28998,1,血雨探花,1830,663,20,33,53,37.7%,1h
28999,3,humanwasdead,1829,189,4,33,37,10.8%,20m
28999,2,克斯啊啊啊,1829,0,1,0,1,100.0%,14m
29001,3,jianchao,1828,122,5,5,10,50.0%,1h
29001,1,LOK,1828,48,1,4,5,20.0%,9m
29003,2,琦多团,1827,195,6,13,19,31.6%,14m
29003,3,曼殊沙华,1827,86,3,5,8,37.5%,25m
29003,1,兰兰,1827,46,2,3,5,40.0%,1h
29006,3,穿过云层努力奔跑,1826,38,1,10,11,9.1%,25m
29007,2,贱骨头,1825,70,2,10,12,16.7%,1h
29007,1,[萌新酒吧]anyingfengba,1825,0,0,4,4,0.0%,25m
29007,3,小龍,1825,0,0,5,5,0.0%,39m
29010,3,黄大仙奶我不快乐,1824,44,5,17,22,22.7%,53m
29011,2,Alitalia,1823,100,4,16,20,20.0%,28m
29011,2,未设定,1823,114,2,4,6,33.3%,56m
29011,3,陈楠老公,1823,58,2,4,6,33.3%,8m
29011,2,damptrou,1823,102,2,13,15,13.3%,1h
29011,2,孤独大爷,1823,38,1,11,12,8.3%,1h
29016,1,文艺小青年儿,1822,210,6,6,12,50.0%,13m
29016,2,凯哥哥,1822,0,1,1,2,50.0%,1h
29016,2,[休闲养老]天空之怒,1822,0,1,9,10,10.0%,59m
29019,1,权权权权某,1821,759,23,36,59,39.0%,1h
29019,1,小飞侠,1821,483,13,19,32,40.6%,14m
29019,3,欧巴,1821,60,2,4,6,33.3%,1h
29022,1,allen,1820,278,9,11,20,45.0%,1h
29022,1,kvkli,1820,213,5,7,12,41.7%,18m
29022,1,蛋炒饭的魅力,1820,34,2,5,7,28.6%,1h
29022,2,awwudh,1820,0,0,1,1,0.0%,1h
29022,1,晓书童,1820,0,0,3,3,0.0%,15m
29022,1,uxkz,1820,0,0,5,5,0.0%,1h
29028,3,dhgjmlm,1819,210,7,13,20,35.0%,1h
29028,3,芜湖,1819,0,3,2,5,60.0%,1h
29028,3,[魔术]隔壁小孩,1819,0,0,2,2,0.0%,1h
29031,2,柏林陷落,1818,0,1,3,4,25.0%,1h
29032,1,QND,1817,200,5,8,13,38.5%,15m
29032,3,[天棋阁]我的剑早已放不下,1817,30,1,9,10,10.0%,60m
29032,2,[快乐白给]折断你丁丁,1817,0,0,1,1,0.0%,1h
29035,3,白烛葵,1816,704,24,49,73,32.9%,4m
29035,1,龙空,1816,302,8,19,27,29.6%,1h
29035,3,灵犀六指,1816,32,5,5,10,50.0%,1h
29035,1,清风流水,1816,108,3,7,10,30.0%,1h
29039,2,淘气之金龟子,1815,334,11,8,19,57.9%,19m
29039,2,MMSDKZ,1815,249,8,8,16,50.0%,1h
29039,1,枫神,1815,155,4,7,11,36.4%,1h
29039,3,Rabiet,1815,0,0,1,1,0.0%,1h
29043,1,HOHOHOHO,1814,547,18,25,43,41.9%,59m
29043,2,青衫,1814,0,1,10,11,9.1%,40m
29043,2,觉得很创建和删除,1814,0,0,1,1,0.0%,1h
29046,2,IIIIIIII,1813,0,0,1,1,0.0%,56m
29047,1,自然科学人文,1812,306,7,18,25,28.0%,1h
29047,2,夜礼服假面,1812,46,2,1,3,66.7%,33m
29047,3,Tank,1812,0,2,5,7,28.6%,8m
29047,2,xiaoxiaobai,1812,0,0,1,1,0.0%,56m
29051,1,诺言,1811,591,21,32,53,39.6%,1h
29051,1,天降大神,1811,658,17,35,52,32.7%,44m
29051,1,枫林落,1811,315,12,26,38,31.6%,1h
29054,2,瑶瑶公主,1810,125,6,9,15,40.0%,1h
29054,2,别打我打我的队友,1810,160,5,20,25,20.0%,1h
29054,3,[风空理雷冰]风之律者,1810,136,4,12,16,25.0%,60m
29054,3,zsc,1810,80,3,9,12,25.0%,1h
29054,2,[黑暗幻想]闪亮之翼,1810,0,0,1,1,0.0%,13m
29054,3,[敢死队]慈祥的资本家,1810,0,0,1,1,0.0%,1h
29054,3,范海辛,1810,0,0,7,7,0.0%,1h
29061,3,飞碟,1809,386,18,27,45,40.0%,1h
29061,1,kinghaohao,1809,371,13,19,32,40.6%,27m
29061,1,铜锣烧,1809,252,7,20,27,25.9%,13m
29061,2,Uranus,1809,201,5,9,14,35.7%,56m
29061,1,Dex,1809,158,5,17,22,22.7%,9m
29061,3,djs,1809,30,1,10,11,9.1%,25m
29067,1,deadpoll,1808,394,12,17,29,41.4%,1h
29067,3,血刃亲王,1808,120,4,13,17,23.5%,1h
29067,2,专家,1808,169,3,10,13,23.1%,1h
29070,1,天地长达,1807,240,7,15,22,31.8%,17m
29070,3,王者风范千寻,1807,114,5,7,12,41.7%,25m
29070,3,KAI,1807,44,3,9,12,25.0%,25m
29070,3,三斤,1807,30,2,5,7,28.6%,1h
29074,1,红唇烈酒,1806,626,20,41,61,32.8%,23m
29074,1,笙箫战神,1806,264,7,19,26,26.9%,1h
29074,3,烟雨,1806,66,3,6,9,33.3%,1h
29074,2,Hennessy,1806,0,0,2,2,0.0%,1h
29078,2,幽之浮丘,1805,538,16,33,49,32.7%,1h
29078,1,卧龙小诸葛,1805,0,1,3,4,25.0%,1h
29080,2,濏少奇,1804,70,3,3,6,50.0%,1h
29080,3,[爱国]彪悍的生活,1804,0,0,1,1,0.0%,19m
29082,2,流年弑水,1803,480,15,21,36,41.7%,1h
29083,3,幻想飞翔,1802,262,54,66,120,45.0%,1h
29083,1,神秘玩家,1802,351,10,25,35,28.6%,10m
29083,2,莱茵哈特,1802,162,6,17,23,26.1%,1h
29083,1,SkyFlyQQ,1802,128,3,5,8,37.5%,1h
29083,3,sandtosand,1802,0,0,1,1,0.0%,1h
29088,2,[死亡的空隙]xingjimi,1801,1060,70,107,177,39.5%,1h
29088,2,何必苦相思,1801,0,0,2,2,0.0%,1h
29088,3,文文文文,1801,0,0,7,7,0.0%,1h
29091,2,雷诺,1800,72,3,9,12,25.0%,35m
29091,1,此间少年,1800,88,2,9,11,18.2%,13m
29093,2,一毛钱,1799,58,3,12,15,20.0%,58m
29093,3,DOM,1799,0,1,1,2,50.0%,8m
29095,1,风倾颜,1798,240,5,9,14,35.7%,1h
29095,3,小阿善,1798,85,3,8,11,27.3%,1h
29095,3,烟尘荼縻,1798,92,3,15,18,16.7%,39m
29098,1,wslc,1796,472,13,19,32,40.6%,13m
29099,1,刀疤男爵,1795,0,3,8,11,27.3%,44m
29099,2,小韩,1795,0,0,1,1,0.0%,40m
29099,3,saonian,1795,0,0,1,1,0.0%,1h
29102,3,淄博小唐,1793,0,1,2,3,33.3%,8m
29103,2,星河战队,1792,252,7,9,16,43.8%,2m
29104,2,玛尔加德,1791,699,27,42,69,39.1%,1h
29104,3,[专业单一小组]南瓜,1791,658,22,47,69,31.9%,26m
29104,1,hhhhh,1791,333,14,18,32,43.8%,11m
29104,2,子系,1791,198,5,3,8,62.5%,1h
29104,2,Jacques,1791,86,4,6,10,40.0%,35m
29104,3,匣客,1791,0,3,3,6,50.0%,1h
29104,2,小呆呆,1791,86,3,5,8,37.5%,58m
29104,3,年少轻狂,1791,0,1,3,4,25.0%,1h
29104,3,[tmdzz]MintGirlBlue,1791,30,1,5,6,16.7%,1h
29113,1,罗罗不姓多,1790,286,9,23,32,28.1%,1h
29113,2,xjpfyc,1790,122,3,4,7,42.9%,1h
29113,3,君莫笑,1790,66,3,10,13,23.1%,39m
29113,1,gcup,1790,46,2,15,17,11.8%,47m
29117,2,罪孽深重,1789,240,7,8,15,46.7%,1h
29118,3,勇往直前,1788,30,3,4,7,42.9%,39m
29118,2,只为了娱乐刀塔二,1788,0,0,4,4,0.0%,1h
29120,2,孤风饮雪,1787,102,4,4,8,50.0%,1h
29120,2,米开朗芬奇,1787,96,2,6,8,25.0%,18m
29120,2,流星雨,1787,0,0,2,2,0.0%,1h
29123,3,dashabi,1784,62,3,3,6,50.0%,54m
29123,3,kamerin,1784,0,0,1,1,0.0%,1h
29125,2,德鲁大叔,1783,48,3,15,18,16.7%,1h
29125,2,黄金时代的遗族,1783,34,2,5,7,28.6%,13m
29127,3,MADE,1782,88,6,10,16,37.5%,54m
29127,1,万里挑花,1782,90,3,15,18,16.7%,27m
29129,3,最后防线,1781,60,4,11,15,26.7%,8m
29129,3,落月,1781,0,0,5,5,0.0%,1h
29131,1,[势在必得]祺祺儿,1780,0,1,6,7,14.3%,1h
29132,1,坚持就是胜利,1779,1493,76,109,185,41.1%,40m
29132,1,kkdo,1779,798,23,46,69,33.3%,1h
29132,3,雾岛之樱,1779,114,4,5,9,44.4%,1h
29132,2,火焰法师雷萨,1779,84,2,4,6,33.3%,1h
29132,3,泡泡茶壶,1779,78,2,6,8,25.0%,39m
29132,2,zyxr,1779,0,1,0,1,100.0%,19m
29132,2,皇家战队,1779,0,0,1,1,0.0%,2m
29139,1,[瘾大眼瞎]周星星,1778,1155,34,64,98,34.7%,6m
29139,2,风行者,1778,549,14,31,45,31.1%,1h
29139,3,sober,1778,0,2,6,8,25.0%,1h
29142,2,寂寞的小乐,1777,432,18,15,33,54.5%,19m
29142,1,问候,1777,400,17,18,35,48.6%,1h
29144,1,安徽小辣鸡,1776,1295,49,75,124,39.5%,24m
29144,2,matthew,1776,172,7,3,10,70.0%,58m
29144,2,winstonwang,1776,0,1,11,12,8.3%,1h
29144,2,Poppy,1776,0,0,8,8,0.0%,2m
29148,3,昭临苏子,1775,78,2,5,7,28.6%,1h
29149,2,刘培茄中将,1774,240,5,16,21,23.8%,58m
29149,2,womendshijie,1774,0,0,1,1,0.0%,1h
29151,1,沧海一声,1773,1226,35,68,103,34.0%,1h
29151,2,Azheng,1773,120,4,17,21,19.0%,33m
29151,3,久爱,1773,0,0,8,8,0.0%,1h
29154,1,[鲲之大]小萌新求师父,1772,1260,35,47,82,42.7%,1h
29154,2,PGuanW,1772,220,7,4,11,63.6%,58m
29154,2,境界的彼方,1772,86,2,5,7,28.6%,55m
29157,2,hkjhg,1771,82,2,12,14,14.3%,14m
29158,1,刘小帅爹,1770,775,20,41,61,32.8%,1h
29158,2,随风飞翔,1770,0,1,11,12,8.3%,58m
29158,3,kakak,1770,0,0,5,5,0.0%,1h
29161,3,无敌的鲨鱼鲨鱼,1769,0,0,1,1,0.0%,1h
29162,3,功夫那兔,1768,1259,43,69,112,38.4%,32m
29162,3,zest,1768,90,3,9,12,25.0%,1h
29164,3,[XXHZ0]sssss,1767,156,5,12,17,29.4%,1h
29165,2,战天下,1766,798,25,40,65,38.5%,29m
29166,1,勇者无惧,1765,476,16,27,43,37.2%,40m
29166,3,[Debu]莱纳你坐啊,1765,0,0,8,8,0.0%,1h
29168,2,GJJJ,1764,46,2,1,3,66.7%,1h
29169,2,chani,1763,64,3,3,6,50.0%,29m
29170,1,Cyf,1762,668,18,28,46,39.1%,1h
29170,2,中二领主高建国,1762,395,10,26,36,27.8%,1h
29172,1,开局退死妈,1761,346,11,28,39,28.2%,59m
29172,3,叫我士兵,1761,0,2,12,14,14.3%,1h
29174,3,linbinan,1759,30,1,2,3,33.3%,1h
29174,3,飙车努努,1759,0,0,1,1,0.0%,1h
29176,2,惟楚有才,1758,36,2,14,16,12.5%,1h
29177,3,伪善君子,1757,404,14,31,45,31.1%,1h
29177,2,初阳静,1757,102,3,6,9,33.3%,1h
29177,1,光明匕首,1757,30,1,6,7,14.3%,1h
29180,2,快乐小鸟,1756,134,3,4,7,42.9%,1h
29180,3,盟友正遭受攻击,1756,0,1,0,1,100.0%,8m
29182,3,一五期三,1754,36,2,2,4,50.0%,1h
29182,3,宇宙尽头的鱼,1754,0,1,5,6,16.7%,39m
29182,3,蟑螂恶霸,1754,0,0,1,1,0.0%,1m
29185,3,[XXHZ23]诗与远方,1753,0,0,5,5,0.0%,54m
29186,1,麒麟才子,1752,441,9,26,35,25.7%,14m
29186,2,学医救不了暴雪,1752,78,3,0,3,100.0%,1h
29188,2,wdnmd,1751,60,3,3,6,50.0%,1h
29188,2,PIMBA,1751,70,2,10,12,16.7%,19m
29190,1,[大战队]白银之鹰,1750,388,11,26,37,29.7%,47m
29190,2,MZB,1750,0,1,2,3,33.3%,1h
29192,3,左大大,1749,0,0,1,1,0.0%,1h
29193,2,人不食肉枉为人,1747,286,8,10,18,44.4%,13m
29193,2,BENNET,1747,0,1,1,2,50.0%,57m
29193,3,肾虚且不行,1747,30,1,3,4,25.0%,39m
29196,3,战争牧师,1745,60,2,11,13,15.4%,1h
29197,3,[最牛的菜鸟队]ershazi,1744,0,0,1,1,0.0%,39m
29198,3,晨曦,1743,0,1,5,6,16.7%,1h
29199,2,许诺,1741,173,4,21,25,16.0%,57m
29200,2,boynextdoor,1739,40,6,2,8,75.0%,1h
29201,2,孙一峰是我老公,1738,190,9,21,30,30.0%,1h
29201,2,TonyQwQ,1738,224,6,13,19,31.6%,18m
29203,2,打死你个龟儿子,1737,912,35,54,89,39.3%,18m
29203,3,卡塞尔校长,1737,0,0,1,1,0.0%,1h
29205,2,天火,1735,498,16,30,46,34.8%,1h
29205,2,定海,1735,302,7,23,30,23.3%,19m
29207,3,无知,1733,154,6,11,17,35.3%,54m
29207,2,战龙,1733,177,4,17,21,19.0%,28m
29207,3,逍遥小妖仙,1733,32,1,7,8,12.5%,1h
29210,3,[白给不要钱]仙人棒棒,1732,134,4,17,21,19.0%,1h
29210,3,神庄,1732,0,0,8,8,0.0%,1h
29212,1,魔域残梦,1731,446,12,32,44,27.3%,23m
29212,3,星辉,1731,0,0,1,1,0.0%,1h
29212,2,星空,1731,0,0,4,4,0.0%,58m
29215,2,修地堡转航母,1730,564,34,33,67,50.7%,1h
29215,3,wuyuwuqiu,1730,30,2,5,7,28.6%,8m
29215,3,[埃蒙帝国]幽竹烟雨,1730,30,1,5,6,16.7%,1h
29218,3,勋爵,1729,40,2,7,9,22.2%,39m
29219,2,[黄金海舰队]壮士请先打我队友,1728,185,5,9,14,35.7%,29m
29219,3,Compmgmt,1728,0,0,1,1,0.0%,1h
29219,3,言生语,1728,0,0,2,2,0.0%,1h
29222,2,[青龙帮]小贱,1726,244,7,10,17,41.2%,14m
29222,1,exiagundum,1726,40,1,12,13,7.7%,1h
29222,2,暴力公熊,1726,0,0,1,1,0.0%,13m
29225,2,山好共同,1725,138,7,13,20,35.0%,18m
29225,2,SHENGLZJ,1725,92,3,10,13,23.1%,2m
29225,3,上帅,1725,0,0,2,2,0.0%,1h
29228,2,[杀戮team]StarDiablo,1723,30,1,9,10,10.0%,1h
29229,1,虔诚寒冰,1720,90,4,19,23,17.4%,1h
29230,2,[新的蜜蜂]全世界最帅,1718,340,10,23,33,30.3%,1h
29230,3,[张三忏悔录]狂妄张三,1718,0,0,7,7,0.0%,1h
29232,3,沧桑年倦,1717,0,0,2,2,0.0%,8m
29233,3,[秋毫七队]老表白给,1716,0,1,1,2,50.0%,1h
29234,2,斗鱼丶痴情而落花,1715,467,13,29,42,31.0%,1h
29234,2,ANNDES,1715,0,1,0,1,100.0%,1h
29236,2,xjw,1714,146,6,5,11,54.5%,1h
29236,3,友利奈绪,1714,0,0,2,2,0.0%,19m
29236,3,[DSE]江湖夜雨十年灯,1714,0,0,4,4,0.0%,1m
29236,3,Ricardo,1714,0,0,6,6,0.0%,1h
29240,3,tsheep,1713,0,0,10,10,0.0%,1h
29241,3,星晨,1711,0,1,0,1,100.0%,1h
29241,2,ahhh,1711,0,0,5,5,0.0%,59m
29243,2,東海龍王,1710,86,4,5,9,44.4%,1h
29244,1,千虫纵横,1709,305,9,19,28,32.1%,60m
29245,2,燥动不安,1708,235,7,4,11,63.6%,41m
29245,3,帅霖,1708,0,0,4,4,0.0%,8m
29247,3,喔喔奶糖,1707,0,1,0,1,100.0%,1m
29248,3,[求狙击]最上启示,1705,606,19,41,60,31.7%,24m
29248,1,战胜之王,1705,207,8,22,30,26.7%,9m
29248,3,星宇,1705,156,7,12,19,36.8%,1m
29248,3,心云,1705,0,1,11,12,8.3%,39m
29252,2,白宇弟弟,1703,0,0,1,1,0.0%,1h
29253,3,who,1702,106,3,18,21,14.3%,1h
29254,3,[嘤嘤嘤呜呜]汤姆,1701,44,2,4,6,33.3%,1h
29255,3,白嫖大侠,1696,36,1,2,3,33.3%,3m
29256,2,丹哥抓住了阿巴瑟,1695,0,0,3,3,0.0%,1h
29257,3,ddwdadsad,1694,0,0,5,5,0.0%,1h
29258,2,[在下菜鸡一只]meiyanjiejie,1693,18,2,0,2,100.0%,1h
29258,3,[瘾大眼瞎]我也曾拥过她,1693,0,0,1,1,0.0%,1h
29260,2,nimi,1691,73,1,4,5,20.0%,19m
29260,2,[JAXOLA]伍德,1691,0,0,1,1,0.0%,1h
29262,2,大漠孤烟,1690,219,11,11,22,50.0%,29m
29262,3,山河,1690,0,0,5,5,0.0%,1h
29264,1,Chasel,1689,1745,146,235,381,38.3%,13m
29264,2,Bogus,1689,116,3,5,8,37.5%,1h
29266,2,指挥官,1688,446,17,47,64,26.6%,29m
29267,1,霸王龙杰克,1687,1752,238,431,669,35.6%,1h
29268,1,一一一,1685,304,9,26,35,25.7%,1h
29268,2,[baoxue]KALA,1685,0,0,1,1,0.0%,1h
29268,2,llllllllllll,1685,0,0,1,1,0.0%,1h
29271,2,[极限菜鸟]氨基酸,1683,102,2,10,12,16.7%,28m
29271,3,冰封,1683,0,0,6,6,0.0%,1m
29273,3,逝风,1681,0,0,8,8,0.0%,8m
29274,2,Joy,1678,30,1,1,2,50.0%,55m
29275,3,mchuanying,1675,94,5,10,15,33.3%,1h
29275,3,潇湘魂,1675,0,0,3,3,0.0%,39m
29277,3,superstar,1674,58,4,3,7,57.1%,1h
29278,2,我爱彭晓琴,1672,0,0,1,1,0.0%,13m
29279,2,Artaher,1671,437,18,42,60,30.0%,41m
29279,3,法道混沌,1671,0,0,1,1,0.0%,1h
29279,3,SSSLIANG,1671,0,0,12,12,0.0%,1h
29282,1,Gargantua,1667,202,21,39,60,35.0%,1h
29282,2,ETGH,1667,189,7,22,29,24.1%,1h
29284,2,唐三,1662,228,8,9,17,47.1%,58m
29285,2,INNOVATION,1660,1428,340,403,743,45.8%,1h
29286,3,全民祸害,1659,78,2,15,17,11.8%,1h
29287,2,hunter,1652,282,10,19,29,34.5%,1h
29287,3,聚鑫缘,1652,132,4,19,23,17.4%,3m
29287,3,凯欧布里鹏,1652,0,1,8,9,11.1%,39m
29290,2,[梦瑾空人心]狂领,1650,30,1,4,5,20.0%,58m
29290,3,阔脚裤呼呼,1650,0,1,9,10,10.0%,55m
29292,3,再世诸葛亮,1649,0,0,1,1,0.0%,39m
29293,1,[第九舰队丶]卖火宅的小火柴,1648,1080,33,67,100,33.0%,24m
29293,3,Genie,1648,30,2,1,3,66.7%,1h
29295,2,萧萧易水,1645,618,21,39,60,35.0%,1h
29295,2,大虾,1645,389,11,25,36,30.6%,13m
29297,2,部落好大哥,1644,88,1,2,3,33.3%,1h
29298,2,jiaoao,1642,89,2,1,3,66.7%,1h
29298,3,大雕王,1642,0,0,1,1,0.0%,25m
29300,2,zysd,1636,260,11,19,30,36.7%,1h
29301,3,土拨鼠,1635,0,0,10,10,0.0%,1m
29302,3,colinnnnnnnn,1633,30,2,1,3,66.7%,25m
29303,2,War,1632,404,19,36,55,34.5%,29m
29303,3,指挥官王二狗,1632,0,1,0,1,100.0%,20m
29305,3,怪怪憨,1630,30,1,13,14,7.1%,1h
29306,3,不是但是算了我的,1627,581,148,248,396,37.4%,1h
29307,3,huyou,1626,436,93,136,229,40.6%,12m
29308,3,新线广告,1625,295,12,41,53,22.6%,1h
29309,3,king,1623,60,5,6,11,45.5%,1h
29310,3,我科归来了,1622,70,3,10,13,23.1%,1h
29310,2,曙鸦,1622,88,2,5,7,28.6%,57m
29312,3,一切随风,1621,306,10,24,34,29.4%,55m
29313,3,namida,1618,66,4,14,18,22.2%,25m
29314,3,[彩加小天使]黑色夜猫君,1614,0,0,5,5,0.0%,1h
29315,2,长城,1607,100,3,4,7,42.9%,41m
29316,3,明水暗火,1606,0,1,1,2,50.0%,1h
29317,3,三玖天下第一,1604,0,0,3,3,0.0%,1h
29318,3,lemonade,1601,42,1,3,4,25.0%,20m
29319,3,Daiwei,1600,0,0,2,2,0.0%,3m
29320,3,daigo,1599,0,0,2,2,0.0%,55m
29321,3,luny,1597,0,0,1,1,0.0%,1h
29322,3,咕咕咕咕咕,1592,0,0,5,5,0.0%,55m
29322,3,剑影微笑,1592,0,0,7,7,0.0%,25m
29324,2,沐白苏,1591,315,9,23,32,28.1%,1h
29325,3,[撸啊撸]蔺杜德,1588,324,11,2,13,84.6%,1h
29326,3,lexwang,1587,221,9,14,23,39.1%,1m
29327,3,[HUC暴雪]梦幻武,1585,30,3,3,6,50.0%,55m
29328,2,星空伏地魔,1583,0,1,14,15,6.7%,1h
29329,3,[传说萌娘团]llllllllllll,1578,76,3,2,5,60.0%,55m
29330,3,明雨粥,1577,0,0,1,1,0.0%,1h
29331,3,天涯路远望卿珍重,1561,30,1,5,6,16.7%,1h
29332,2,[哈工大]Dorongrong,1556,1113,56,77,133,42.1%,36m
29333,3,[慢手e族]太子,1544,0,1,5,6,16.7%,39m
29334,3,辣椒恶魔,1533,420,14,61,75,18.7%,1h
29335,1,韩东飞,1529,308,8,35,43,18.6%,1h
29336,3,未来使者,1521,170,5,21,26,19.2%,1h
29336,3,[埃蒙保护局]AAA,1521,0,0,17,17,0.0%,1h
29338,1,表情大师,1516,1562,101,199,300,33.7%,15m
29339,3,楼下的建地堡,1513,0,0,1,1,0.0%,1h
29340,3,huige,1508,0,1,12,13,7.7%,39m
29341,3,aaa,1507,564,31,2,33,93.9%,1h
29342,3,[万物皆可白给]我的机械化白给了,1501,600,23,26,49,46.9%,1h
29343,2,HarryAlbs,1497,0,1,21,22,4.5%,1h
29344,2,shui,1484,1319,116,189,305,38.0%,1h
29345,3,[温柔兔公主]最帅的男人,1478,30,2,8,10,20.0%,1h
29346,3,冰糖干儿,1468,30,1,19,20,5.0%,1h
29347,3,萌新第十三天,1467,0,1,0,1,100.0%,55m
29348,3,痛苦的温暖,1461,30,1,7,8,12.5%,25m
29349,3,IIIIIIIIII,1452,0,0,3,3,0.0%,1h
29350,3,为啥谁也打不过,1413,226,8,4,12,66.7%,1h
29350,3,[万物皆可萌w]dfguhj,1413,0,3,2,5,60.0%,54m
29352,3,GGNeverBack,1406,58,2,2,4,50.0%,1h
29353,3,王牌猎人,1401,0,0,1,1,0.0%,39m
29354,3,园田海未,1396,58,2,5,7,28.6%,1h
29355,3,xxxxxx,1390,0,0,1,1,0.0%,20m
29356,3,开门丶社区送温暖,1388,0,1,0,1,100.0%,20m
29357,3,madfrogfov,1385,0,0,1,1,0.0%,1h
29358,1,[老废物乐园]lovata,1381,0,0,46,46,0.0%,55m
29359,3,[血盟骑士团k]桐谷直叶,1366,68,3,0,3,100.0%,1h
29360,3,分段的发顺嘿嘿,1347,0,1,1,2,50.0%,1h
29361,3,[孙岱玹]蟑螂舞姬,1341,246,7,19,26,26.9%,1h
29362,3,水原千鹤,1288,0,0,26,26,0.0%,1h
29363,3,天命皇权,1283,30,2,2,4,50.0%,3m
29364,3,HRC,983,0,1,0,1,100.0%,1h
29365,3,Patrick,925,400,11,47,58,19.0%,54m
29366,3,[传说萌娘团]还想更可爱的世界,596,0,1,1,2,50.0%,39m
29367,3,BrianBa,565,48,2,0,2,100.0%,1h
29368,3,黄旭东,467,0,0,1,1,0.0%,1h
29369,3,[暴雪养鸡场]菜鸡,442,114,4,2,6,66.7%,25m
